"chr1","13369279","13369378","chr11","61985367","61985463","17","48616088"
"chr1","26476407","26476718","chr13","94178205","94178498","64","67701798"
"chr1","106430384","106430644","chr11","67266200","67266446","57","39164184"
"chr1","30349","30667","chr10","16604742","16605052","80","16574393"
"chr1","76294","76574","chr5","18053181","18053445","95","17976887"
"chr1","302206","302507","chr13","67889167","67889448","54","67586961"
"chr1","513849","514011","chr4","190209315","190209476","40","189695466"
"chr1","611493","611727","chr5","121689731","121689952","76","121078238"
"chr1","749613","749914","chr13","68311984","68312282","38","67562371"
"chr1","780348","780654","chr1","11272743","11273038","78","10492395"
"chr1","942213","942445","chr1","213869685","213869919","55","212927472"
"chr1","985648","985903","chr13","68532040","68532305","41","67546392"
"chr1","1083604","1083731","chr7","30277884","30278017","31","29194280"
"chr1","1085374","1085668","chr13","68653870","68654167","52","67568496"
"chr1","1292819","1292939","chr7","44128291","44128409","25","42835472"
"chr1","1422438","1422683","chr10","18961406","18961660","63","17538968"
"chr1","1472554","1472685","chr3","267312","267456","35","1205242"
"chr1","2098379","2098515","chr18","20901830","20901975","44","18803451"
"chr1","2099811","2099966","chr22","8436942","8437088","34","6337131"
"chr1","2454188","2454498","chr20","4689670","4689984","72","2235482"
"chr1","2716393","2716731","chr13","70243508","70243846","47","67527115"
"chr1","2786128","2786421","chr13","70310475","70310777","56","67524347"
"chr1","3113316","3113599","chr13","70633038","70633333","48","67519722"
"chr1","3194253","3194559","chrX","2167494","2167799","66","1026759"
"chr1","3374665","3374778","chrX","49674314","49674431","24","46299649"
"chr1","3391141","3391303","chrX","119707772","119707943","49","116316631"
"chr1","3432035","3432343","chrX","136561630","136561940","72","133129595"
"chr1","3697427","3697703","chr13","71187194","71187475","46","67489767"
"chr1","3758328","3758580","chr13","71243391","71243682","62","67485063"
"chr1","3952054","3952346","chr7","86823502","86823797","64","82871448"
"chr1","4056040","4056109","chr1","130323203","130323271","20","126267163"
"chr1","4060313","4060556","chr4","144634989","144635257","76","140574676"
"chr1","4064661","4064972","chr11","72886530","72886827","78","68821869"
"chr1","4204664","4204949","chr10","92357674","92357946","72","88153010"
"chr1","4300077","4300171","chr1","32122749","32122841","24","27822672"
"chr1","4301649","4301993","chr11","118453898","118454232","96","114152249"
"chr1","4357221","4357512","chr13","71988334","71988625","48","67631113"
"chr1","4604848","4605037","chr7","155352310","155352493","48","150747462"
"chr1","4793674","4793969","chr3","26159019","26159313","66","21365345"
"chr1","4887550","4887838","chr3","131695355","131695636","68","126807805"
"chr1","4942871","4942946","chr4","4333939","4334013","13","608932"
"chr1","4963082","4963204","chr13","72631043","72631164","17","67667961"
"chr1","5079230","5079308","chr13","72750558","72750635","8","67671328"
"chr1","5108839","5109079","chr13","72781804","72782040","51","67672965"
"chr1","5460346","5460606","chr2A","63066965","63067232","67","57606619"
"chr1","5607726","5608011","chr13","73302508","73302814","53","67694782"
"chr1","5666159","5666380","chr18","11414523","11414756","63","5748364"
"chr1","5705128","5705426","chr13","73404102","73404400","26","67698974"
"chr1","5744224","5744340","chr13","73449316","73449432","14","67705092"
"chr1","5833579","5833869","chr13","73563891","73564189","44","67730312"
"chr1","5998524","5998820","chr13","73718157","73718472","56","67719633"
"chr1","6004301","6004548","chr1","9706976","9707222","68","3702675"
"chr1","6059003","6059286","chr13","73763332","73763613","57","67704329"
"chr1","6066435","6066552","chr8","129441534","129441654","26","123375099"
"chr1","6166820","6167118","chr15","22843984","22844276","70","16677164"
"chr1","6248650","6248730","chr13","73935916","73935998","16","67687266"
"chr1","6366953","6367240","chr1","43624160","43624442","58","37257207"
"chr1","6382846","6383041","chr7","73099312","73099507","44","66716466"
"chr1","6390464","6390748","chr22","16829014","16829297","39","10438550"
"chr1","6401128","6401240","chr22","16837226","16837336","15","10436098"
"chr1","6444580","6444877","chr13","74097583","74097876","49","67653003"
"chr1","6577187","6577477","chr13","74230778","74231072","34","67653591"
"chr1","6769993","6770300","chr13","74412404","74412694","62","67642411"
"chr1","6850442","6850705","chrX","117858944","117859204","72","111008502"
"chr1","6889558","6889875","chr6","12663883","12664188","75","5774325"
"chr1","6898221","6898530","chr13","74555879","74556197","41","67657658"
"chr1","7061276","7061606","chr10","29589731","29590055","82","22528455"
"chr1","7113843","7114089","chr5","41150341","41150568","66","34036498"
"chr1","7127873","7128178","chr13","74831548","74831836","55","67703675"
"chr1","7282565","7282729","chr13","74982639","74982809","27","67700074"
"chr1","7464311","7464377","chr13","75184203","75184269","5","67719892"
"chr1","7697690","7697963","chr13","75412443","75412718","39","67714753"
"chr1","7782487","7782789","chr16","29416091","29416388","66","21633604"
"chr1","7841178","7841340","chr2B","106023689","106023844","38","98182511"
"chr1","8011528","8011841","chr13","75713083","75713386","47","67701555"
"chr1","8085166","8085232","chr1","184127955","184128015","23","176042789"
"chr1","8085380","8085507","chr13","75787911","75788037","15","67702531"
"chr1","8115224","8115323","chr13","75820588","75820689","12","67705364"
"chr1","8116084","8116262","chr13","75821434","75821624","30","67705350"
"chr1","8135268","8135556","chr13","75842521","75842825","43","67707253"
"chr1","8154921","8155028","chr13","75860899","75861014","23","67705978"
"chr1","8264759","8265035","chr7","1708256","1708538","65","6556503"
"chr1","8355725","8356018","chr1","163867986","163868280","69","155512261"
"chr1","8358595","8358890","chr13","76068870","76069161","34","67710275"
"chr1","8360215","8360510","chr13","76070505","76070803","37","67710290"
"chr1","8367168","8367442","chr13","76076251","76076525","42","67709083"
"chr1","8485977","8486272","chr13","76197606","76197898","47","67711629"
"chr1","8537029","8537355","chr1","45223007","45223325","79","36685978"
"chr1","8573438","8573703","chr13","76295831","76296083","50","67722393"
"chr1","8693721","8694030","chr13","76422677","76422986","32","67728956"
"chr1","8764274","8764428","chr1","7841983","7842144","41","922291"
"chr1","8843586","8843902","chr13","76575555","76575855","47","67731969"
"chr1","8903192","8903475","chr13","76626426","76626704","58","67723234"
"chr1","9064139","9064449","chr14","40032010","40032318","65","30967871"
"chr1","9087346","9087582","chr14","10421615","10421834","60","1334269"
"chr1","9155397","9155680","chr13","76872083","76872372","35","67716686"
"chr1","9212643","9212950","chr13","76926127","76926395","74","67713484"
"chr1","9234760","9235052","chr13","76946728","76947020","31","67711968"
"chr1","9324251","9324541","chr13","77029248","77029547","38","67704997"
"chr1","9325439","9325725","chr13","77030468","77030751","32","67705029"
"chr1","9363859","9364168","chr13","77066615","77066925","41","67702756"
"chr1","9437447","9437726","chr8","97298853","97299135","49","87861406"
"chr1","9569612","9569813","chr3","45233841","45234045","45","35664229"
"chr1","9583924","9584148","chr5","16455911","16456134","60","6871987"
"chr1","9590253","9590368","chr10","89586333","89586448","24","79996080"
"chr1","9701724","9701852","chr13","77395976","77396108","24","67694252"
"chr1","9764571","9764615","chr3","48411878","48411928","9","38647307"
"chr1","9764688","9764812","chr8","103799790","103799921","36","94035102"
"chr1","9790302","9790577","chr13","77488304","77488581","35","67698002"
"chr1","9804239","9804535","chr13","77504715","77505011","44","67700476"
"chr1","9890372","9890482","chr4","71940021","71940126","24","62049649"
"chr1","9890973","9891110","chr3","38650177","38650318","31","28759204"
"chr1","9896976","9897251","chr13","77597345","77597629","24","67700369"
"chr1","9905896","9906150","chr13","77606875","77607140","38","67700979"
"chr1","9917448","9917571","chr13","77617984","77618110","13","67700536"
"chr1","9947429","9947554","chr20","3645405","3645538","32","6302024"
"chr1","9988782","9989049","chr13","77685127","77685408","54","67696345"
"chr1","10003800","10004082","chr5","26154281","26154566","53","16150481"
"chr1","10100395","10100639","chr9","114593914","114594168","68","104493519"
"chr1","10145869","10146089","chr6","91869790","91870005","53","81723921"
"chr1","10219984","10220107","chr10","85791325","85791447","16","75571341"
"chr1","10240286","10240451","chr16","40647579","40647743","41","30407293"
"chr1","10264385","10264656","chr13","77983351","77983629","24","67718966"
"chr1","10299226","10299343","chr5","35393713","35393830","19","25094487"
"chr1","10343926","10344228","chr13","78051614","78051919","47","67707688"
"chr1","10384604","10384705","chr9","119639420","119639532","35","109254816"
"chr1","10393091","10393172","chr1","95774692","95774774","14","85381601"
"chr1","10393712","10393782","chr12","122719017","122719091","15","112325305"
"chr1","10434211","10434477","chr13","78136591","78136881","52","67702380"
"chr1","10443500","10443797","chr13","78145829","78146130","40","67702329"
"chr1","10457826","10458116","chr3","125308982","125309274","54","114851156"
"chr1","10502257","10502564","chr13","78209517","78209817","48","67707260"
"chr1","10507008","10507313","chr13","78213336","78213638","45","67706328"
"chr1","10510763","10511064","chr2B","53629601","53629902","56","43118838"
"chr1","10523760","10523885","chr5","152649372","152649495","22","142125612"
"chr1","10529238","10529582","chr5","59121600","59121939","85","48592362"
"chr1","10541625","10541906","chr13","78258764","78259048","44","67717139"
"chr1","10547171","10547476","chr13","78268279","78268583","37","67721108"
"chr1","10551621","10551906","chr13","78273347","78273643","55","67721726"
"chr1","10568903","10569141","chr13","78287014","78287250","47","67718111"
"chr1","10570479","10570806","chr13","78288581","78288896","47","67718102"
"chr1","10575330","10575632","chr13","78293921","78294214","33","67718591"
"chr1","10637256","10637547","chr13","78345200","78345514","48","67707944"
"chr1","10697505","10697801","chr13","78390933","78391238","51","67693428"
"chr1","10719777","10719901","chr9","14164360","14164484","17","3444583"
"chr1","10745326","10745640","chr13","78442528","78442835","28","67697202"
"chr1","10748873","10749123","chr13","78446118","78446384","52","67697245"
"chr1","10840221","10840335","chrX","151139490","151139606","29","140299269"
"chr1","10850304","10850590","chr13","78572938","78573221","54","67722634"
"chr1","10864931","10865062","chr13","78604552","78604694","24","67739621"
"chr1","10934273","10934515","chr5","110284799","110285036","61","99350526"
"chr1","10934894","10935033","chr5","3296328","3296466","32","7638566"
"chr1","10944035","10944356","chr13","78712232","78712522","65","67768197"
"chr1","10998279","10998558","chr13","78771038","78771319","36","67772759"
"chr1","11080170","11080458","chr12","117093298","117093597","59","106013128"
"chr1","11106076","11106358","chr16","62639650","62639940","62","51533574"
"chr1","11161533","11161832","chr13","78907637","78907941","34","67746104"
"chr1","11217961","11218256","chr13","78961187","78961486","49","67743226"
"chr1","11236153","11236447","chr20","47709808","47710111","56","36473655"
"chr1","11243285","11243569","chr13","78988371","78988649","32","67745086"
"chr1","11289662","11289789","chr4","72697956","72698081","16","61408294"
"chr1","11314809","11314890","chr13","79059499","79059579","10","67744690"
"chr1","11576952","11577238","chr13","79306980","79307260","34","67730028"
"chr1","11642325","11642471","chr16","57816344","57816497","43","46174019"
"chr1","11720910","11721188","chr11","18129249","18129529","59","6408339"
"chr1","11808889","11809163","chr13","79555725","79556006","39","67746836"
"chr1","12110552","12110843","chr5","2886208","2886496","64","9224344"
"chr1","12269693","12269994","chr7","77009635","77009928","55","64739942"
"chr1","12454810","12455075","chr13","80220204","80220481","37","67765394"
"chr1","12497405","12497722","chr13","80261572","80261885","41","67764167"
"chr1","12596694","12596985","chr13","80357541","80357842","52","67760847"
"chr1","12635130","12635446","chr13","80397115","80397435","51","67761985"
"chr1","12658903","12659192","chr10","119264661","119264952","59","106605758"
"chr1","12693760","12694074","chr19","16978028","16978325","83","4284268"
"chr1","12868303","12868580","chr9","95660192","95660467","46","82791889"
"chr1","12872451","12872754","chr13","80579808","80580112","38","67707357"
"chr1","12956835","12957055","chr17","2634591","2634813","40","10322244"
"chr1","12979486","12979765","chr13","80685703","80685992","43","67706217"
"chr1","12983595","12983875","chr1","98624635","98624930","57","85641040"
"chr1","13048091","13048190","chr16","28410466","28410566","15","15362375"
"chr1","13076605","13076730","chr11","69147152","69147272","26","56070547"
"chr1","13079560","13079831","chrX","71230927","71231187","81","58151367"
"chr1","13105688","13105804","chr13","80804811","80804929","5","67699123"
"chr1","13112440","13112727","chr13","80810641","80810931","30","67698201"
"chr1","13154903","13154999","chr4","121283672","121283773","19","108128769"
"chr1","13160306","13160583","chr13","80859747","80860038","49","67699441"
"chr1","13233613","13233892","chr13","80928305","80928591","35","67694692"
"chr1","13252534","13252764","chr15","51004153","51004375","43","37751619"
"chr1","13295592","13295877","chr13","80992745","80993021","45","67697153"
"chr1","13300961","13301246","chr13","80998240","80998541","53","67697279"
"chr1","13308993","13309106","chr7","107591138","107591254","20","94282145"
"chr1","13329523","13329851","chr13","81026999","81027295","61","67697476"
"chr1","13337229","13337398","chr3","15276527","15276701","37","1939298"
"chr1","13340544","13340855","chr13","81037711","81038005","56","67697167"
"chr1","13368487","13368662","chrX","38198324","38198508","41","24829837"
"chr1","13381963","13382261","chr11","113466975","113467264","44","100085012"
"chr1","13453737","13454031","chr3","198778450","198778736","58","185324713"
"chr1","13481947","13482192","chr13","81169490","81169760","55","67687543"
"chr1","13521456","13521728","chr18","11328811","11329081","58","2192645"
"chr1","13528971","13529337","chr7","2974349","2974701","89","10554622"
"chr1","13543618","13543911","chr15","23614412","23614711","75","10070794"
"chr1","13567896","13568195","chr13","81251492","81251790","61","67683596"
"chr1","13577526","13577711","chr7","79054481","79054669","49","65476955"
"chr1","13586266","13586586","chr13","81267991","81268300","70","67681725"
"chr1","13589691","13589932","chr19","38408136","38408384","64","24818445"
"chr1","13612910","13613210","chr4","120387251","120387553","69","106774341"
"chr1","13625730","13626018","chr19","14886531","14886816","73","1260801"
"chr1","13680010","13680154","chr8","20885859","20886004","30","7205849"
"chr1","13706660","13706977","chr13","81374610","81374919","44","67667950"
"chr1","13738511","13738821","chr1","161593032","161593340","71","147854521"
"chr1","13773357","13773477","chr13","81435857","81435974","21","67662500"
"chr1","13777532","13777818","chr13","81439740","81440033","42","67662208"
"chr1","13798703","13798861","chr1","46234080","46234238","49","32435377"
"chr1","13799992","13800275","chr13","81458163","81458449","41","67658171"
"chr1","13806684","13806975","chr17","78397060","78397355","74","64590376"
"chr1","13821371","13821646","chr13","81489159","81489439","37","67667788"
"chr1","13859324","13859594","chr12","3219744","3220018","60","10639580"
"chr1","13866763","13867048","chr13","81529063","81529364","42","67662300"
"chr1","13869080","13869372","chr13","81531765","81532068","38","67662685"
"chr1","13884475","13884762","chr13","81547208","81547498","50","67662733"
"chr1","13894245","13894348","chr10","88544429","88544536","20","74650184"
"chr1","14086952","14087251","chr5","7626635","7626936","60","6460317"
"chr1","14092732","14092895","chr4","93589807","93589970","35","79497075"
"chr1","14103630","14103800","chrX","100740983","100741152","36","86637353"
"chr1","14266450","14266742","chr13","81958578","81958868","58","67692128"
"chr1","14267512","14267793","chr4","15029081","15029370","68","761569"
"chr1","14280547","14280817","chr13","81974229","81974508","41","67693682"
"chr1","14296683","14296927","chr15","8078541","8078783","62","6218142"
"chr1","14305790","14306110","chr13","82009837","82010125","56","67704047"
"chr1","14306940","14307243","chr13","82011002","82011313","43","67704062"
"chr1","14313411","14313738","chr9","16422052","16422351","52","2108641"
"chr1","14380950","14381231","chr13","82081716","82081998","48","67700766"
"chr1","14462496","14462805","chr5","57707603","57707903","68","43245107"
"chr1","14483294","14483574","chr13","82186516","82186791","37","67703222"
"chr1","14499134","14499359","chr13","82201257","82201482","21","67702123"
"chr1","14529547","14529772","chr6","36791131","36791360","48","22261584"
"chr1","14594050","14594321","chr13","82286695","82286978","33","67692645"
"chr1","14596937","14597236","chr13","82289617","82289903","53","67692680"
"chr1","14630859","14631123","chr13","82323649","82323916","30","67692790"
"chr1","14635089","14635375","chr13","82326426","82326728","59","67691337"
"chr1","14682559","14682857","chr13","82377822","82378128","42","67695263"
"chr1","14684039","14684314","chr13","82379298","82379575","31","67695259"
"chr1","14698353","14698618","chr5","40423226","40423496","71","25724873"
"chr1","14732160","14732408","chr14","58081151","58081402","52","43348991"
"chr1","14740358","14740636","chr13","82434308","82434586","26","67693950"
"chr1","14752230","14752506","chr13","82450295","82450565","30","67698065"
"chr1","14798863","14799136","chr4","163386875","163387148","66","148588012"
"chr1","14825583","14825865","chrX","118109145","118109434","61","103283562"
"chr1","14886126","14886258","chr13","82592097","82592229","15","67705971"
"chr1","14889911","14890160","chr7","57077622","57077873","53","42187711"
"chr1","14911038","14911240","chr4","196628561","196628759","52","181717523"
"chr1","14919441","14919740","chr6","4923303","4923592","67","9996138"
"chr1","14920647","14920933","chr13","82626668","82626964","31","67706021"
"chr1","14946108","14946409","chr13","82657327","82657629","27","67711219"
"chr1","14990591","14990718","chr9","92336564","92336690","16","77345973"
"chr1","14998822","14998967","chr18","77865542","77865689","30","62866720"
"chr1","15002207","15002359","chr5","156787834","156787995","32","141785627"
"chr1","15058566","15058834","chr13","82769516","82769781","30","67710950"
"chr1","15067227","15067369","chr13","1433575","1433714","32","13633652"
"chr1","15077270","15077515","chr7","127635564","127635807","54","112558294"
"chr1","15079718","15079869","chr10","49585047","49585201","30","34505329"
"chr1","15086284","15086630","chr13","82797557","82797901","51","67711273"
"chr1","15162402","15162712","chr6","36972459","36972767","63","21810057"
"chr1","15201844","15201989","chr18","20901830","20901975","35","5699986"
"chr1","15224028","15224349","chr13","82938753","82939075","54","67714725"
"chr1","15235904","15236168","chr13","82964118","82964399","45","67728214"
"chr1","15242247","15242489","chr13","82969519","82969780","49","67727272"
"chr1","15276002","15276162","chr16","27358384","27358547","36","12082382"
"chr1","15311351","15311644","chr7","76523012","76523308","50","61211661"
"chr1","15344533","15344795","chr13","83109696","83109970","61","67765163"
"chr1","15368508","15368688","chr10","90995787","90995979","43","75627279"
"chr1","15391579","15391858","chr13","83162293","83162578","45","67770714"
"chr1","15453049","15453307","chr5","2285853","2286114","66","13167196"
"chr1","15476367","15476679","chr3","13399534","13399844","71","2076833"
"chr1","15484612","15484772","chr14","72724722","72724884","32","57240110"
"chr1","15493194","15493507","chr15","23614412","23614711","69","8121218"
"chr1","15506075","15506360","chr13","83274518","83274817","52","67768443"
"chr1","15556792","15557056","chr13","83343775","83344062","49","67786983"
"chr1","15562397","15562715","chr16","64122904","64123217","65","48560507"
"chr1","15697162","15697336","chr6","17908557","17908726","37","2211395"
"chr1","15734869","15735085","chr7","151274486","151274696","69","135539617"
"chr1","15802155","15802402","chr13","83569023","83569282","39","67766868"
"chr1","15819265","15819432","chr7","74190896","74191062","29","58371631"
"chr1","15826592","15826869","chr13","83609637","83609912","42","67783045"
"chr1","15832674","15832940","chr13","83615384","83615673","63","67782710"
"chr1","15885859","15886147","chr13","83675470","83675759","67","67789611"
"chr1","15964282","15964406","chrX","95494066","95494189","17","79529784"
"chr1","15971350","15971653","chr12","76577893","76578201","51","60606543"
"chr1","15991115","15991414","chr13","83771164","83771432","69","67780049"
"chr1","16053923","16054094","chrX","49603242","49603412","45","33549319"
"chr1","16101191","16101400","chr13","83874466","83874700","46","67773275"
"chr1","16108814","16108978","chr14","22699961","22700127","33","6591147"
"chr1","16274268","16274442","chr5","16337364","16337541","42","63096"
"chr1","16817129","16817265","chrX","2886472","2886607","31","13930657"
"chr1","17015582","17015861","chr13","84734902","84735196","57","67719320"
"chr1","17046068","17046198","chr1","187726107","187726234","22","170680039"
"chr1","17213833","17214033","chr1","192036490","192036687","53","174822657"
"chr1","17396720","17397025","chr13","85008777","85009067","69","67612057"
"chr1","17401908","17402024","chr1","94267623","94267739","23","76865715"
"chr1","17458171","17458255","chr4","165652302","165652387","23","148194131"
"chr1","17458307","17458469","chr20","44858230","44858390","39","27399923"
"chr1","17702366","17702641","chr2B","8975642","8975921","62","8726724"
"chr1","17806074","17806338","chr13","85405853","85406118","30","67599779"
"chr1","17933915","17934199","chr13","85519494","85519793","54","67585579"
"chr1","17993432","17993718","chr13","85577797","85578078","24","67584365"
"chr1","18008360","18008659","chr13","85594826","85595136","38","67586466"
"chr1","18018907","18019183","chr13","85602659","85602956","48","67583752"
"chr1","18077541","18077827","chr13","85663475","85663758","47","67585934"
"chr1","18121713","18122000","chr1","133729720","133730008","81","115608007"
"chr1","18156451","18156749","chr13","85753078","85753379","42","67596627"
"chr1","18162023","18162149","chr5","54098889","54099012","17","35936866"
"chr1","18199694","18199907","chr13","85801083","85801295","43","67601389"
"chr1","18319567","18319835","chr13","85913788","85914068","46","67594221"
"chr1","18355821","18356115","chr13","85946777","85947084","43","67590956"
"chr1","18450717","18450839","chr13","86041333","86041445","20","67590616"
"chr1","18638122","18638423","chr13","86224441","86224743","44","67586319"
"chr1","18851502","18851803","chr12","68300782","68301077","58","49449280"
"chr1","18945113","18945396","chr16","48466883","48467157","79","29521770"
"chr1","18954409","18954472","chr10","131405890","131405951","17","112451481"
"chr1","18973044","18973342","chr13","86561556","86561853","39","67588512"
"chr1","19030757","19031052","chr13","86627930","86628214","56","67597173"
"chr1","19179118","19179230","chr2A","17077795","17077906","24","2101323"
"chr1","19283410","19283680","chr13","86892440","86892719","48","67609030"
"chr1","19407627","19407789","chr10","15743417","15743574","36","3664210"
"chr1","19431555","19431735","chr13","87062928","87063095","40","67631373"
"chr1","19545442","19545694","chr1","146463578","146463836","76","126918136"
"chr1","19559443","19559697","chr5","98682121","98682358","58","79122678"
"chr1","19572856","19572984","chr13","87252043","87252171","14","67679187"
"chr1","19670666","19670961","chr13","87347659","87347950","58","67676993"
"chr1","19679976","19680086","chr1","157655866","157655976","22","137975890"
"chr1","20078551","20078736","chr8","16705088","16705269","44","3373463"
"chr1","20122773","20123022","chr13","87791804","87792052","40","67669031"
"chr1","20145160","20145428","chr13","87820609","87820883","43","67675449"
"chr1","20325393","20325678","chr13","88013345","88013628","38","67687952"
"chr1","20614617","20614762","chr14","34631091","34631234","49","14016474"
"chr1","20717991","20718121","chr13","88394208","88394339","23","67676217"
"chr1","21001269","21001536","chr5","141078401","141078673","69","120077132"
"chr1","21184128","21184369","chr1","125572037","125572276","66","104387909"
"chr1","21283493","21283615","chr13","88973680","88973802","14","67690187"
"chr1","21298345","21298476","chr8","68416358","68416490","28","47118013"
"chr1","21509254","21509434","chr3","102655720","102655891","45","81146466"
"chr1","21585320","21585441","chr13","89287647","89287768","17","67702327"
"chr1","21607806","21608057","chr2A","83213067","83213316","79","61605261"
"chr1","21697655","21697938","chr13","89395442","89395734","37","67697787"
"chr1","21740952","21741083","chr14","44741725","44741854","22","23000773"
"chr1","21774147","21774436","chr1","43624160","43624442","63","21850013"
"chr1","21879238","21879361","chr13","89570816","89570937","19","67691578"
"chr1","21921017","21921160","chr10","108461325","108461484","41","86540308"
"chr1","21973752","21973956","chr13","89647323","89647538","36","67673571"
"chr1","22024596","22024905","chr13","89708246","89708563","49","67683650"
"chr1","22136872","22137017","chrX","71151088","71151230","34","49014216"
"chr1","22237954","22238244","chrX","19624419","19624715","65","2613535"
"chr1","22278526","22278756","chr8","67956056","67956297","63","45677530"
"chr1","22427781","22428056","chr19","32036596","32036869","65","9608815"
"chr1","22449910","22450021","chr13","90110952","90111073","16","67661042"
"chr1","22472393","22472680","chr13","90135860","90136139","60","67663467"
"chr1","22491653","22491826","chr13","90164472","90164644","20","67672819"
"chr1","22540326","22540401","chr7","39816425","39816500","15","17276099"
"chr1","22605406","22605597","chr7","150934994","150935168","45","128329588"
"chr1","22609712","22609988","chr13","90277246","90277512","48","67667534"
"chr1","22749496","22749660","chr7","152167110","152167278","36","129417614"
"chr1","22819079","22819371","chr20","4931387","4931673","65","17887692"
"chr1","22930173","22930465","chr13","90635952","90636295","83","67705779"
"chr1","22949737","22949932","chr13","90656224","90656410","44","67706487"
"chr1","23026144","23026253","chr5","32712867","32712982","31","9686723"
"chr1","23091992","23092281","chr13","90815362","90815667","41","67723370"
"chr1","23166575","23166861","chr20","30592696","30592988","72","7426121"
"chr1","23170686","23170985","chr13","90891559","90891852","49","67720873"
"chr1","23187879","23188195","chr13","90907451","90907766","30","67719572"
"chr1","23698075","23698365","chr4","15170386","15170676","82","8527689"
"chr1","23723310","23723579","chr13","91447561","91447821","34","67724251"
"chr1","23853459","23853669","chr12","118865454","118865663","52","95011995"
"chr1","23910843","23911144","chr13","91600128","91600433","32","67689285"
"chr1","23915980","23916093","chr6","37801775","37801890","19","13885795"
"chr1","24005647","24005922","chr13","91696910","91697206","66","67691263"
"chr1","24014625","24014901","chr13","91699569","91699846","35","67684944"
"chr1","24041396","24041652","chr12","2896452","2896728","72","21144944"
"chr1","24189130","24189412","chr5","96942875","96943163","64","72753745"
"chr1","24193243","24193403","chr10","29338384","29338545","32","5145141"
"chr1","24320860","24321147","chr13","91994781","91995087","50","67673921"
"chr1","24454703","24454991","chr13","92126960","92127250","46","67672257"
"chr1","24483234","24483507","chr13","92156204","92156499","48","67672970"
"chr1","24690436","24690699","chr13","92360732","92360995","43","67670296"
"chr1","25075875","25075964","chr21","8496784","8496874","17","16579091"
"chr1","25076190","25076201","chr4","124257742","124257752","5","99181552"
"chr1","25076509","25076701","chr13","92777017","92777200","29","67700508"
"chr1","25353526","25353611","chr13","93008461","93008546","7","67654935"
"chr1","25405651","25405947","chr13","93067867","93068181","47","67662216"
"chr1","25493934","25494255","chr15","47263678","47263989","77","21769744"
"chr1","25830020","25830324","chr13","93483410","93483719","44","67653390"
"chr1","25885574","25885822","chrX","154075409","154075657","56","128189835"
"chr1","25905795","25906109","chr13","93557039","93557350","47","67651244"
"chr1","25922634","25922928","chr4","120243844","120244136","56","94321210"
"chr1","25941029","25941320","chrX","39133182","39133470","59","13192153"
"chr1","25953785","25954059","chr17","1121786","1122053","68","24831999"
"chr1","25955219","25955306","chr1","17798378","17798465","14","8156841"
"chr1","25961479","25961596","chr6","18588428","18588554","39","7373051"
"chr1","25968949","25969157","chr4","40135562","40135772","51","14166613"
"chr1","26031661","26031817","chr4","201468523","201468681","36","175436862"
"chr1","26043735","26044037","chr13","93709999","93710311","43","67666264"
"chr1","26093490","26093754","chr11","86219823","86220099","65","60126333"
"chr1","26101337","26101617","chr13","93759616","93759895","43","67658279"
"chr1","26106783","26107083","chr20","32988113","32988400","60","6881330"
"chr1","26115182","26115475","chr13","93768600","93768887","39","67653418"
"chr1","26212137","26212374","chr7","56987869","56988101","56","30775732"
"chr1","26226324","26226586","chr18","11328811","11329081","71","14897513"
"chr1","26247736","26248002","chr13","93931084","93931358","37","67683348"
"chr1","26415490","26415775","chr13","94091892","94092177","47","67676402"
"chr1","26436800","26437069","chr13","94119915","94120176","44","67683115"
"chr1","26454068","26454368","chr13","94156134","94156442","34","67702066"
"chr1","26457452","26457729","chr13","94159549","94159837","52","67702097"
"chr1","26487109","26487375","chr12","95394002","95394266","65","68906893"
"chr1","26582775","26583062","chr13","94293113","94293395","51","67710338"
"chr1","27186735","27186915","chr13","29954448","29954629","44","2767713"
"chr1","27193443","27193602","chr4","40325999","40326159","34","13132556"
"chr1","27333509","27333742","chr13","94904887","94905127","43","67571378"
"chr1","27440217","27440324","chr12","8358601","8358709","28","19081616"
"chr1","27922651","27922927","chr13","95525879","95526162","44","67603228"
"chr1","28134848","28135081","chr12","37312978","37313210","63","9178130"
"chr1","28140880","28141169","chr13","95752441","95752725","33","67611561"
"chr1","28142244","28142505","chr13","95753870","95754150","54","67611626"
"chr1","28367821","28368123","chr13","96009767","96010083","51","67641946"
"chr1","28436024","28436330","chr13","96074609","96074909","36","67638585"
"chr1","28457900","28458230","chr3","195583731","195584055","88","167125831"
"chr1","28458845","28459137","chr3","124958693","124958983","64","96499848"
"chr1","28502377","28502588","chr14","12043109","12043314","62","16459268"
"chr1","28506580","28506700","chr21","30109301","30109422","21","1602721"
"chr1","28509122","28509405","chr13","96149505","96149765","45","67640383"
"chr1","28532409","28532708","chr13","96170293","96170590","37","67637884"
"chr1","28550103","28550405","chr13","96188769","96189063","52","67638666"
"chr1","28551982","28552178","chrX","71968567","71968766","42","43416585"
"chr1","28562692","28562812","chr13","96204653","96204769","11","67641961"
"chr1","28563628","28563753","chr5","44710296","44710425","20","16146668"
"chr1","28620564","28620843","chr5","9700825","9701104","69","18919739"
"chr1","28732065","28732341","chr13","96372461","96372738","64","67640396"
"chr1","28732348","28732511","chr5","9844539","9844705","34","18887809"
"chr1","28736975","28737141","chr13","96379221","96379388","22","67642246"
"chr1","28759703","28759942","chr13","96396213","96396455","31","67636510"
"chr1","28785878","28786164","chr13","96418598","96418885","36","67632720"
"chr1","28813586","28813866","chr7","75639989","75640267","67","46826403"
"chr1","28908590","28908864","chr10","63637009","63637283","58","34728419"
"chr1","29115334","29115598","chr3","24214337","24214606","63","4900997"
"chr1","29131029","29131378","chr13","96623755","96624108","79","67492726"
"chr1","29394774","29394813","chr6","155545700","155545734","11","126150926"
"chr1","29482440","29482754","chr13","97102010","97102294","65","67619570"
"chr1","29647889","29647995","chr6","2232358","2232462","34","27415531"
"chr1","29688362","29688468","chr6","2232358","2232462","34","27456004"
"chr1","29707049","29707337","chr13","67531021","67531316","34","37823972"
"chr1","29906933","29907085","chr11","57220311","57220464","36","27313378"
"chr1","30001010","30001303","chr9","68772874","68773157","67","38771864"
"chr1","30037240","30037470","chr13","67268142","67268369","34","37230902"
"chr1","30045767","30046049","chr13","67263949","67264245","46","37218182"
"chr1","30062894","30063182","chr5","33789269","33789555","66","3726375"
"chr1","30247335","30247628","chr13","67033863","67034162","33","36786528"
"chr1","30334470","30334594","chr1","27945947","27946072","22","2388523"
"chr1","30722372","30722679","chr13","66527684","66527990","35","35805312"
"chr1","30761131","30761188","chr22","23659593","23659647","15","7101538"
"chr1","30761281","30761470","chr13","66488489","66488680","22","35727208"
"chr1","30854488","30854788","chr13","66412231","66412561","64","35557743"
"chr1","30863738","30863801","chr6","159585740","159585805","25","128722002"
"chr1","30877060","30877405","chr13","66388714","66389042","41","35511654"
"chr1","30955873","30956157","chr13","66310219","66310500","56","35354346"
"chr1","30979290","30979540","chr13","66283254","66283497","59","35303964"
"chr1","31027641","31027802","chr10","49585047","49585201","38","18557406"
"chr1","31099557","31099851","chr13","66163253","66163544","43","35063696"
"chr1","31344153","31344440","chr10","5342646","5342936","64","26001507"
"chr1","31414743","31415020","chr13","65821867","65822141","53","34407124"
"chr1","31456374","31456636","chr13","65767471","65767757","68","34311097"
"chr1","31529417","31529739","chr14","37792490","37792795","74","6263073"
"chr1","31582412","31582705","chr12","11401619","11401933","62","20180793"
"chr1","31602307","31602584","chr22","2288950","2289233","44","29313357"
"chr1","31648362","31648654","chr12","11401619","11401933","60","20246743"
"chr1","31688813","31689108","chr1","191946453","191946748","76","160257640"
"chr1","31694944","31695205","chr6","121332078","121332356","77","89637134"
"chr1","31749366","31749526","chr7","76863731","76863897","41","45114365"
"chr1","32203737","32204024","chr9","91035693","91035982","59","58831956"
"chr1","32225581","32225727","chr20","48146953","48147106","37","15921372"
"chr1","32262945","32263245","chr13","64800388","64800697","57","32537443"
"chr1","32299740","32300038","chr13","64768447","64768728","53","32468707"
"chr1","32782344","32782608","chr6","28225288","28225554","73","4557056"
"chr1","32977460","32977700","chr13","64100661","64100891","35","31123201"
"chr1","33045100","33045396","chr13","64017567","64017857","38","30972467"
"chr1","33212755","33213048","chr13","63841413","63841699","44","30628658"
"chr1","33224177","33224492","chr13","63830120","63830409","78","30605943"
"chr1","33307428","33307708","chr10","29350372","29350655","79","3957056"
"chr1","33377224","33377535","chr13","63672588","63672887","48","30295364"
"chr1","33618247","33618518","chrX","54161113","54161388","70","20542866"
"chr1","33619020","33619180","chr15","23773713","23773873","43","9845307"
"chr1","33675776","33676040","chr9","77444877","77445136","74","43769101"
"chr1","33781761","33782074","chr13","63303161","63303454","50","29521400"
"chr1","34117029","34117146","chr13","62995177","62995295","6","28878148"
"chr1","34142827","34143091","chr13","62945099","62945378","39","28802272"
"chr1","34153522","34153682","chr5","51144248","51144411","30","16990726"
"chr1","34153784","34154072","chr13","62935020","62935311","43","28781236"
"chr1","34175278","34175455","chr19","16936576","16936741","39","17238702"
"chr1","34178927","34179239","chr13","62910496","62910817","57","28731569"
"chr1","34218372","34218482","chr13","62863429","62863544","16","28645057"
"chr1","34226458","34226713","chr13","62858706","62858949","46","28632248"
"chr1","34227212","34227439","chr13","62857960","62858191","37","28630748"
"chr1","34261733","34262039","chr7","72352382","72352691","60","38090649"
"chr1","34288362","34288655","chr13","62791302","62791598","56","28502940"
"chr1","34309119","34309258","chr16","30472207","30472337","26","3836912"
"chr1","34360197","34360373","chr10","8266247","8266432","46","26093950"
"chr1","34444283","34444495","chr13","62659900","62660100","47","28215617"
"chr1","34666808","34667108","chr13","62418492","62418808","56","27751684"
"chr1","34711715","34712016","chr9","92301916","92302208","68","57590201"
"chr1","34849539","34849833","chr13","62218837","62219133","42","27369298"
"chr1","34878244","34878543","chr7","76523012","76523308","68","41644768"
"chr1","34924070","34924376","chr13","62136990","62137288","42","27212920"
"chr1","34933467","34933718","chr13","62127572","62127850","57","27194105"
"chr1","34962189","34962473","chr13","62096090","62096351","50","27133901"
"chr1","35010132","35010423","chr13","62046261","62046557","44","27036129"
"chr1","35017031","35017287","chr12","65158130","65158373","84","30141099"
"chr1","35045769","35046052","chr13","62016865","62017157","48","26971096"
"chr1","35060551","35060828","chr13","62003952","62004228","43","26943401"
"chr1","35078482","35078560","chr13","61977486","61977571","13","26899004"
"chr1","35174274","35174335","chrX","48790902","48790957","15","13616628"
"chr1","35174543","35174703","chr5","2493450","2493615","38","32681093"
"chr1","35184902","35185200","chr13","61889230","61889529","43","26704328"
"chr1","35301396","35301727","chrX","23863187","23863499","88","11438209"
"chr1","35410448","35410756","chr13","61648336","61648640","84","26237888"
"chr1","35676658","35676954","chr3","131369946","131370239","71","95693288"
"chr1","35819361","35819659","chr13","61256303","61256610","44","25436942"
"chr1","35892958","35893081","chr7","26158438","26158564","33","9734520"
"chr1","35907161","35907463","chr13","61170456","61170751","58","25263295"
"chr1","36097259","36097544","chr22","33889558","33889842","65","2207701"
"chr1","36155545","36155823","chr13","60914415","60914718","62","24758870"
"chr1","36528676","36528825","chr13","60611200","60611335","29","24082524"
"chr1","36647791","36648069","chr13","60497546","60497835","43","23849755"
"chr1","36735412","36735714","chr12","98196946","98197249","64","61461534"
"chr1","36897862","36898143","chr12","52358939","52359219","65","15461077"
"chr1","36990544","36990857","chr13","60135373","60135680","48","23144829"
"chr1","37023554","37023842","chr13","60100320","60100599","36","23076766"
"chr1","37038781","37039038","chr11","71112307","71112559","69","34073526"
"chr1","37047814","37048094","chr2A","61220081","61220370","56","24172267"
"chr1","37054584","37054897","chr13","60070348","60070647","51","23015764"
"chr1","37113281","37113408","chr6","111603379","111603505","18","74490098"
"chr1","37127697","37127979","chr9","16633553","16633838","67","20494144"
"chr1","37128061","37128372","chr13","59997388","59997698","41","22869327"
"chr1","37173541","37173872","chr13","59929419","59929754","51","22755878"
"chr1","37192643","37192922","chr13","59919851","59920134","36","22727208"
"chr1","37294156","37294320","chr20","52492690","52492849","34","15198534"
"chr1","37303403","37303687","chr1","118046837","118047120","59","80743434"
"chr1","37308321","37308621","chr13","59790467","59790771","58","22482146"
"chr1","37354096","37354378","chr13","59743979","59744250","48","22389883"
"chr1","37373672","37373980","chr13","59724486","59724777","57","22350814"
"chr1","37473127","37473416","chr13","59626899","59627194","41","22153772"
"chr1","37501411","37501538","chr13","59595118","59595250","22","22093707"
"chr1","37536948","37537229","chr7","1708256","1708538","59","35828692"
"chr1","37652427","37652736","chr13","59404530","59404862","55","21752103"
"chr1","37694098","37694402","chr13","59352928","59353245","48","21658830"
"chr1","37702019","37702180","chr12","19312537","19312701","35","18389482"
"chr1","37734321","37734422","chr13","59314125","59314239","16","21579804"
"chr1","37781426","37781688","chr13","59265391","59265653","54","21483965"
"chr1","37867272","37867585","chr13","59181281","59181578","55","21314009"
"chr1","37967224","37967376","chr21","21500001","21500148","36","16467223"
"chr1","38121519","38121817","chr12","120660094","120660390","64","82538575"
"chr1","38398519","38398661","chr1","23727757","23727901","39","14670762"
"chr1","38398797","38398889","chr7","41949023","41949115","16","3550226"
"chr1","38399255","38399365","chr3","49718438","49718552","27","11319183"
"chr1","38938597","38938856","chr3","181037580","181037849","55","142098983"
"chr1","38992512","38992759","chr13","58109623","58109898","53","19117111"
"chr1","38998906","38999164","chr7","131081642","131081912","63","92082736"
"chr1","39044043","39044325","chr1","62692578","62692858","68","23648535"
"chr1","39050194","39050450","chrX","71847367","71847618","64","32797173"
"chr1","39109663","39109978","chr13","57983380","57983689","62","18873717"
"chr1","39115409","39115693","chrX","154341818","154342097","62","115226409"
"chr1","39189833","39190112","chr13","57899001","57899276","56","18709168"
"chr1","39234727","39235029","chr13","57850768","57851074","67","18616041"
"chr1","39305655","39305950","chr13","57776382","57776667","43","18470727"
"chr1","39317167","39317481","chr13","57765647","57765963","47","18448480"
"chr1","39357636","39357930","chr13","57714075","57714370","25","18356439"
"chr1","39394901","39395217","chr13","57675200","57675498","37","18280299"
"chr1","39406419","39406655","chr13","57659720","57659967","40","18253301"
"chr1","39444673","39444941","chr13","57614457","57614730","25","18169784"
"chr1","39453324","39453638","chr6","74589907","74590206","68","35136583"
"chr1","39834481","39834769","chr13","57189111","57189393","51","17354630"
"chr1","39840813","39841101","chr13","57178018","57178275","62","17337205"
"chr1","39860349","39860657","chr12","113139684","113139992","49","73279335"
"chr1","39873915","39874211","chr13","57145202","57145494","38","17271287"
"chr1","39876430","39876694","chr13","57142691","57142950","39","17266261"
"chr1","39890097","39890389","chr13","57129426","57129721","30","17239329"
"chr1","39947820","39948138","chr13","57070301","57070598","70","17122481"
"chr1","40060807","40061017","chr13","56967921","56968114","40","16907114"
"chr1","40096777","40097079","chr13","56943847","56944165","54","16847070"
"chr1","40118909","40119197","chr13","56912100","56912392","40","16793191"
"chr1","40204606","40204778","chr7","79675726","79675893","32","39471120"
"chr1","40254155","40254453","chr13","56753603","56753901","41","16499448"
"chr1","40303829","40304038","chr13","56703276","56703463","40","16399447"
"chr1","40374640","40374762","chr13","56632509","56632634","17","16257869"
"chr1","40530388","40530688","chr13","56482711","56483011","35","15952323"
"chr1","40601015","40601302","chr13","56422816","56423108","47","15821801"
"chr1","40624349","40624636","chr13","56399926","56400226","45","15775577"
"chr1","40679888","40680003","chr13","56355297","56355412","11","15675409"
"chr1","40844530","40844845","chr13","56196362","56196674","35","15351832"
"chr1","40972841","40973150","chr13","56081499","56081823","50","15108658"
"chr1","41009787","41010062","chr13","56041563","56041837","39","15031776"
"chr1","41068316","41068444","chrX","70173122","70173250","21","29104806"
"chr1","41133972","41134067","chr3","58857961","58858058","18","17723989"
"chr1","41136883","41136988","chr3","102852724","102852835","23","61715841"
"chr1","41172228","41172517","chr3","52654600","52654881","60","11482372"
"chr1","41203456","41203747","chr13","55837936","55838221","53","14634480"
"chr1","41307006","41307304","chr13","55728295","55728589","51","14421289"
"chr1","41378049","41378341","chr13","55659039","55659313","58","14280990"
"chr1","41378505","41378672","chr10","15743417","15743574","34","25635088"
"chr1","41379743","41380046","chr3","99047114","99047402","86","57667371"
"chr1","41409078","41409331","chr8","61880569","61880831","52","20471491"
"chr1","41442106","41442386","chr13","55595790","55596072","35","14153684"
"chr1","41481136","41481446","chr13","55558029","55558354","49","14076893"
"chr1","41499931","41500000","chr9","121032934","121032990","22","79533003"
"chr1","41540994","41541127","chr12","121650986","121651120","21","80109992"
"chr1","41546119","41546281","chr8","63696364","63696527","39","22150245"
"chr1","41558600","41558696","chr10","35698053","35698152","21","5860547"
"chr1","41581442","41581714","chr13","55453522","55453803","42","13872080"
"chr1","41617466","41617767","chr1","23622718","23623020","62","17994748"
"chr1","41625206","41625486","chr7","74375314","74375570","72","32750108"
"chr1","41635156","41635289","chr1","15347485","15347622","30","26287671"
"chr1","41647623","41647897","chr13","55380757","55381026","43","13733134"
"chr1","41652018","41652228","chr3","58659960","58660170","42","17007942"
"chr1","41660042","41660257","chr1","53733488","53733703","46","12073446"
"chr1","41681869","41682185","chr13","55349836","55350157","41","13667967"
"chr1","41684382","41684694","chr5","36408852","36409158","59","5275530"
"chr1","41711374","41711542","chr5","156787834","156787995","42","115076460"
"chr1","41711549","41711841","chr21","16683533","16683806","68","25028016"
"chr1","41756872","41757161","chr13","55289275","55289564","35","13532403"
"chr1","41825686","41825988","chr13","55231394","55231697","38","13405708"
"chr1","41880804","41880922","chr5","88631497","88631612","38","46750693"
"chr1","41905937","41906124","chr14","38078574","38078759","55","3827363"
"chr1","41940911","41941029","chr20","46080183","46080300","20","4139272"
"chr1","42043671","42043866","chr13","55026686","55026875","23","12983015"
"chr1","42117744","42117992","chr13","54943682","54943947","45","12825938"
"chr1","42198890","42199162","chr13","54862406","54862647","55","12663516"
"chr1","42450752","42450954","chr15","51083311","51083503","59","8632559"
"chr1","42451497","42451761","chr13","54618111","54618391","45","12166614"
"chr1","42488721","42488830","chr4","110273813","110273922","22","67785092"
"chr1","42558263","42558432","chr6","12560219","12560368","60","29998044"
"chr1","42616711","42616940","chr13","54463281","54463509","51","11846570"
"chr1","42711803","42711933","chr1","163633135","163633250","37","120921332"
"chr1","42716414","42716717","chr8","9095507","9095808","74","33620907"
"chr1","42806363","42806641","chr13","54292507","54292779","40","11486144"
"chr1","43026094","43026359","chr12","121923400","121923668","52","78897306"
"chr1","43029597","43029850","chr13","54071179","54071428","33","11041582"
"chr1","43084177","43084461","chr10","8078554","8078826","71","35005623"
"chr1","43110081","43110230","chr19","49723366","49723494","54","6613285"
"chr1","43144725","43145008","chr13","53967971","53968246","53","10823246"
"chr1","43168674","43168968","chr7","138250606","138250896","64","95081932"
"chr1","43497881","43498171","chr13","53605358","53605651","38","10107477"
"chr1","43677190","43677471","chr13","53411522","53411804","28","9734332"
"chr1","43774351","43774642","chr13","53344209","53344482","55","9569858"
"chr1","43925729","43925986","chr14","83779803","83780047","70","39854074"
"chr1","44164445","44164616","chr13","52984451","52984632","26","8820006"
"chr1","44164801","44164915","chr3","4560101","4560214","28","39604700"
"chr1","44206876","44206976","chr19","4106799","4106900","23","40100077"
"chr1","44207266","44207419","chr1","205548459","205548612","39","161341193"
"chr1","44420701","44420977","chr19","46701284","46701570","59","2280583"
"chr1","44427108","44427403","chrX","67640170","67640466","52","23213062"
"chr1","44465219","44465549","chr3","195583731","195584055","77","151118512"
"chr1","44652431","44652738","chr5","60813353","60813657","39","16160922"
"chr1","44692741","44692992","chr13","52458584","52458842","44","7765843"
"chr1","44904748","44905047","chr13","52272552","52272865","58","7367804"
"chr1","45077789","45077908","chr13","52095009","52095126","16","7017220"
"chr1","45081129","45081252","chr13","52088417","52088538","13","7007288"
"chr1","45121614","45121923","chr13","52049290","52049589","60","6927676"
"chr1","45253281","45253546","chr5","23795056","23795315","73","21458225"
"chr1","45259359","45259638","chr10","35719424","35719700","58","9539935"
"chr1","45302157","45302450","chr13","51903773","51904073","59","6601616"
"chr1","45306317","45306621","chr13","51899278","51899576","40","6592961"
"chr1","45330430","45330654","chr5","12187777","12188000","63","33142653"
"chr1","45386923","45387233","chr13","51806784","51807054","77","6419861"
"chr1","45525137","45525428","chr7","86823502","86823797","61","41298365"
"chr1","45533834","45534150","chr13","71482862","71483172","60","25949028"
"chr1","45807929","45808191","chr15","1342952","1343211","70","44464977"
"chr1","46068348","46068659","chr16","23667918","23668219","79","22400430"
"chr1","46230190","46230472","chr1","117768455","117768745","72","71538265"
"chr1","46421734","46421868","chr1","22298981","22299131","44","24122753"
"chr1","46634372","46634647","chr13","50517592","50517866","42","3883220"
"chr1","46729861","46730145","chr13","50402584","50402886","52","3672723"
"chr1","46815315","46815587","chr22","2288950","2289233","50","44526365"
"chr1","47135679","47135958","chr1","38001876","38002160","73","9133803"
"chr1","47137268","47137381","chr8","19325971","19326085","26","27811297"
"chr1","47158829","47159131","chr13","49988175","49988473","51","2829346"
"chr1","47333761","47333855","chr21","1076281","1076374","28","46257480"
"chr1","47377049","47377189","chr1","134652174","134652315","35","87275125"
"chr1","47449075","47449183","chr1","39325820","39325928","23","8123255"
"chr1","47626185","47626470","chr1","43180881","43181182","64","4445304"
"chr1","47812083","47812337","chr13","49285418","49285699","73","1473335"
"chr1","47913434","47913702","chr5","106659786","106660077","48","58746352"
"chr1","47930293","47930411","chr13","49114038","49114155","17","1183745"
"chr1","47989201","47989534","chr1","45032090","45032394","86","2957111"
"chr1","48146501","48146784","chr13","48897381","48897668","44","750880"
"chr1","48176641","48176917","chr13","48867539","48867821","62","690898"
"chr1","48307379","48307588","chr3","162535331","162535532","54","114227952"
"chr1","48311572","48311855","chr2A","14922187","14922472","63","33389385"
"chr1","48374382","48374465","chr1","28583783","28583866","17","19790599"
"chr1","48390611","48390897","chr19","34445150","34445426","57","13945461"
"chr1","48393831","48393996","chr6","113803458","113803626","34","65409627"
"chr1","48509029","48509334","chr5","38098279","38098585","75","10410750"
"chr1","48582708","48582903","chr13","48463169","48463348","38","119539"
"chr1","48648947","48649060","chr8","113484063","113484179","42","64835116"
"chr1","48649064","48649216","chr1","21701601","21701750","40","26947463"
"chr1","48705437","48705586","chr2A","24087441","24087597","41","24617996"
"chr1","48706526","48706669","chrX","118287303","118287446","42","69580777"
"chr1","48853025","48853120","chr5","161500183","161500278","16","112647158"
"chr1","48962578","48962873","chr13","48136158","48136460","46","826420"
"chr1","49384454","49384749","chr13","47785585","47785899","54","1598869"
"chr1","49476382","49476656","chr12","88716328","88716606","65","39239946"
"chr1","49717331","49717614","chr13","47463237","47463519","40","2254094"
"chr1","49765003","49765302","chr10","86751111","86751418","74","36986108"
"chr1","49772242","49772521","chr7","73083255","73083530","68","23311013"
"chr1","49773928","49774193","chr13","47398612","47398874","44","2375316"
"chr1","49846656","49846838","chr13","47309375","47309557","27","2537281"
"chr1","49914368","49914695","chr13","47251715","47252023","76","2662653"
"chr1","50003261","50003528","chr13","47119007","47119301","56","2884254"
"chr1","50198256","50198539","chr10","11943561","11943846","68","38254695"
"chr1","50363648","50363943","chr13","46782058","46782367","60","3581590"
"chr1","50497979","50498254","chr13","46662374","46662641","56","3835605"
"chr1","50542851","50542962","chr13","46621864","46621976","15","3920987"
"chr1","50628005","50628284","chr13","46533425","46533726","67","4094580"
"chr1","50732585","50732858","chr13","46435252","46435533","59","4297333"
"chr1","50749562","50749852","chr1","40331351","40331633","60","10418211"
"chr1","50753588","50753875","chr13","46415805","46416089","41","4337783"
"chr1","50847071","50847377","chr4","181246961","181247264","71","130399890"
"chr1","50972771","50972900","chr2B","94897282","94897419","38","43924511"
"chr1","51026937","51027178","chr20","3929006","3929254","51","47097931"
"chr1","51049681","51049976","chr13","46111394","46111695","46","4938287"
"chr1","51556007","51556165","chr13","45598608","45598771","17","5957399"
"chr1","51622393","51622698","chr4","6743889","6744194","73","44878504"
"chr1","52051346","52051507","chr3","49411661","49411824","40","2639685"
"chr1","52257832","52258132","chr19","37969853","37970147","67","14287979"
"chr1","52415684","52415969","chr15","54941698","54941989","71","2526014"
"chr1","52512567","52512851","chr13","44548042","44548319","45","7964525"
"chr1","52734076","52734199","chr2B","92011026","92011147","22","39276950"
"chr1","52802547","52802663","chr7","75017050","75017167","29","22214503"
"chr1","52862885","52863025","chr16","69212656","69212783","41","16349771"
"chr1","53002313","53002513","chr13","44023249","44023446","43","8979064"
"chr1","53298821","53299125","chr13","43731546","43731839","39","9567275"
"chr1","53307939","53308170","chr13","43716534","43716764","31","9591405"
"chr1","53310365","53310662","chr13","43714363","43714659","36","9596002"
"chr1","53690244","53690548","chr13","43275920","43276215","38","10414324"
"chr1","53696663","53696923","chr13","43269460","43269726","39","10427203"
"chr1","53785205","53785522","chr13","43171077","43171395","56","10614128"
"chr1","53799195","53799484","chr13","43157550","43157845","29","10641645"
"chr1","54313354","54313510","chr8","25523917","25524069","34","28789437"
"chr1","54398706","54398994","chr13","42685965","42686255","34","11712741"
"chr1","54446805","54447093","chr19","37241795","37242085","76","17205010"
"chr1","54516731","54517012","chr13","42514377","42514660","35","12002354"
"chr1","54648592","54648889","chr13","42396183","42396481","31","12252409"
"chr1","54811709","54812006","chr13","42235015","42235323","59","12576694"
"chr1","54820164","54820453","chr2A","97057312","97057598","62","42237148"
"chr1","54863128","54863463","chr13","42162362","42162675","91","12700766"
"chr1","54874954","54875237","chr13","42150725","42151038","59","12724229"
"chr1","54920303","54920549","chr13","42111712","42111982","47","12808591"
"chr1","54945352","54945665","chr13","42084543","42084850","54","12860809"
"chr1","55011653","55011863","chr7","78010541","78010758","48","22998888"
"chr1","55060487","55060608","chr13","41982186","41982307","7","13078301"
"chr1","55086306","55086583","chr13","41956820","41957116","59","13129486"
"chr1","55184314","55184597","chr13","41843630","41843915","37","13340684"
"chr1","55261207","55261491","chr10","8078554","8078826","60","47182653"
"chr1","55295005","55295252","chr6","44546586","44546829","52","10748419"
"chr1","55311635","55311918","chr13","41703855","41704127","39","13607780"
"chr1","55342244","55342386","chr13","41672269","41672412","13","13669975"
"chr1","55598096","55598415","chr19","947608","947921","75","54650488"
"chr1","55686919","55687058","chr2B","94897282","94897419","32","39210363"
"chr1","55885631","55885916","chr13","41124666","41124945","35","14760965"
"chr1","55910129","55910271","chr1","23727757","23727901","35","32182372"
"chr1","55964838","55965144","chr13","41059477","41059797","65","14905361"
"chr1","56191562","56191722","chr21","24720942","24721101","35","31470620"
"chr1","56351981","56352297","chr13","40678926","40679245","63","15673055"
"chr1","56409981","56410275","chr13","40614111","40614404","31","15795870"
"chr1","56474276","56474408","chr16","69212656","69212783","34","12738380"
"chr1","56591910","56592193","chr7","1708256","1708538","73","54883654"
"chr1","56659924","56660187","chr13","40342771","40343036","40","16317153"
"chr1","56839752","56840027","chr13","40136859","40137128","72","16702893"
"chr1","56873811","56874119","chr13","40099581","40099873","72","16774230"
"chr1","56969826","56969938","chr7","68275138","68275242","31","11305312"
"chr1","57170171","57170459","chr13","39817902","39818216","56","17352269"
"chr1","57238966","57239063","chr17","38532634","38532725","22","18706332"
"chr1","57317154","57317295","chr7","28901497","28901635","32","28415657"
"chr1","57380747","57380917","chr19","46051886","46052047","49","11328861"
"chr1","57520101","57520339","chr13","39480656","39480914","49","18039445"
"chr1","57745494","57745745","chr3","181037580","181037849","79","123292086"
"chr1","57855993","57856174","chr4","195550863","195551045","43","137694870"
"chr1","58180592","58180856","chr13","38791156","38791438","67","19389436"
"chr1","58718921","58719209","chr4","24938285","24938581","70","33780636"
"chr1","58967834","58967998","chr19","37034098","37034257","49","21933736"
"chr1","59011454","59011746","chr13","37972366","37972662","62","21039088"
"chr1","59368222","59368506","chr13","37545166","37545450","46","21823056"
"chr1","59461591","59461842","chr20","4243490","4243707","69","55218101"
"chr1","59572998","59573107","chr14","38155443","38155555","18","21417555"
"chr1","59676433","59676735","chr13","37263929","37264236","49","22412504"
"chr1","59975282","59975539","chr11","94503265","94503501","70","34527983"
"chr1","60055823","60056002","chr13","36888253","36888453","45","23167570"
"chr1","60078586","60078886","chr13","36867786","36868077","59","23210800"
"chr1","60117678","60117961","chr3","143837811","143838095","67","83720133"
"chr1","60141215","60141347","chr1","15302993","15303122","30","44838222"
"chr1","60146444","60146727","chr13","36771608","36771911","46","23374836"
"chr1","60173653","60173928","chr9","99256861","99257146","79","39083208"
"chr1","60223912","60224028","chr13","36679542","36679653","23","23544370"
"chr1","60237840","60238100","chr13","36661785","36662055","50","23576055"
"chr1","60375467","60375740","chr13","73365648","73365921","73","12990181"
"chr1","60437134","60437414","chr13","36424380","36424650","53","24012754"
"chr1","60633907","60634031","chr12","62964855","62964964","34","2330948"
"chr1","60636443","60636574","chr7","56839310","56839440","34","3797133"
"chr1","60816512","60816790","chr12","82308017","82308290","69","21491505"
"chr1","60853440","60853605","chr3","50824399","50824571","42","10029041"
"chr1","60858693","60859003","chr13","35995664","35995982","48","24863029"
"chr1","60984732","60985044","chr5","14704313","14704629","68","46280419"
"chr1","61332067","61332140","chr13","82008355","82008427","16","20676288"
"chr1","61485291","61485584","chr6","136587930","136588223","76","75102639"
"chr1","61504226","61504525","chr13","35366675","35366974","26","26137551"
"chr1","61527037","61527315","chr17","329250","329527","69","61197787"
"chr1","61800085","61800160","chr13","91442389","91442456","31","29642304"
"chr1","61800177","61800282","chr1","227412510","227412616","25","165612333"
"chr1","61829156","61829468","chr13","35078227","35078546","44","26750929"
"chr1","61899983","61900266","chr13","35012000","35012292","69","26887983"
"chr1","62007612","62007924","chr13","34898021","34898309","51","27109591"
"chr1","62019616","62019901","chr13","34885601","34885909","57","27134015"
"chr1","62052356","62052650","chr13","34855159","34855453","34","27197197"
"chr1","62090785","62091089","chr13","34815662","34815966","48","27275123"
"chr1","62194954","62195069","chr5","117765594","117765708","19","55570640"
"chr1","62353526","62353851","chr13","34556627","34556943","36","27796899"
"chr1","62358214","62358481","chr9","26080584","26080845","63","36277630"
"chr1","62363779","62364074","chr13","34546849","34547148","40","27816930"
"chr1","62365928","62366068","chr8","20885859","20886004","32","41480069"
"chr1","62376311","62376466","chr10","49585047","49585201","39","12791264"
"chr1","62378915","62379239","chr13","22707269","22707585","54","39671646"
"chr1","62381814","62381922","chr9","111757212","111757321","17","49375398"
"chr1","62401406","62401661","chr13","34502928","34503187","32","27898478"
"chr1","62407011","62407311","chr13","34497601","34497913","51","27909410"
"chr1","62434882","62435029","chrX","47980307","47980465","41","14454575"
"chr1","62437082","62437192","chr1","134625109","134625219","15","72188027"
"chr1","62437791","62438087","chr1","159332642","159332938","53","96894851"
"chr1","62536245","62536543","chr3","139168044","139168335","63","76631799"
"chr1","62699270","62699574","chr13","34110000","34110323","58","28589270"
"chr1","62702092","62702383","chr13","34108118","34108408","41","28593974"
"chr1","62715065","62715335","chr3","10553115","10553386","62","52161950"
"chr1","62739389","62739518","chr9","77794383","77794513","36","15054994"
"chr1","62741268","62741376","chr10","12475418","12475526","15","50265850"
"chr1","62758405","62758688","chr13","34014460","34014745","33","28743945"
"chr1","62812329","62812610","chr13","33925800","33926076","34","28886529"
"chr1","62825643","62825913","chr13","33939537","33939832","60","28886106"
"chr1","62838951","62839105","chr20","32123638","32123783","46","30715313"
"chr1","62851559","62851725","chr7","76863731","76863897","34","14012172"
"chr1","62884665","62884828","chr5","62885644","62885808","33","979"
"chr1","62905824","62905954","chr22","30338462","30338593","20","32567362"
"chr1","62927365","62927666","chr13","34012866","34013173","41","28914499"
"chr1","62929237","62929520","chr13","34014460","34014745","32","28914777"
"chr1","63007445","63007608","chr13","33812399","33812563","34","29195046"
"chr1","63068217","63068529","chr13","33751094","33751403","38","29317123"
"chr1","63199255","63199371","chr2A","35489286","35489401","26","27709969"
"chr1","63209949","63210060","chr8","99133490","99133603","13","35923541"
"chr1","63269973","63270106","chr15","57026888","57027018","24","6243085"
"chr1","63563901","63564183","chr13","33238079","33238377","48","30325822"
"chr1","63626377","63626654","chr10","103241518","103241801","63","39615141"
"chr1","63676659","63676941","chr13","33111003","33111290","45","30565656"
"chr1","63691821","63691976","chr19","17276844","17276987","40","46414977"
"chr1","63741127","63741242","chr13","33059335","33059451","17","30681792"
"chr1","63745204","63745481","chr13","33055189","33055483","45","30690015"
"chr1","63791093","63791377","chr13","32998522","32998828","52","30792571"
"chr1","63959446","63959621","chr13","80982524","80982704","48","17023078"
"chr1","64093080","64093337","chr13","32693665","32693944","54","31399415"
"chr1","64095529","64095649","chr5","40694224","40694348","23","23401305"
"chr1","64140950","64141159","chr11","76842944","76843158","48","12701994"
"chr1","64148966","64149062","chr13","32632763","32632859","8","31516203"
"chr1","64157783","64158031","chr12","36919580","36919828","60","27238203"
"chr1","64175096","64175405","chr13","32607336","32607624","63","31567760"
"chr1","64217496","64217600","chr8","54992128","54992237","23","9225368"
"chr1","64222137","64222431","chr13","32562532","32562834","40","31659605"
"chr1","64236718","64237021","chr13","32547954","32548249","32","31688764"
"chr1","64248016","64248302","chr13","32536807","32537114","48","31711209"
"chr1","64340070","64340254","chr8","98909960","98910147","42","34569890"
"chr1","64394231","64394495","chr13","32384846","32385114","32","32009385"
"chr1","64401837","64402112","chr13","32378755","32379037","49","32023082"
"chr1","64682911","64683188","chr13","32140162","32140457","50","32542749"
"chr1","64688368","64688489","chr8","131123097","131123217","35","66434729"
"chr1","64694923","64695238","chr13","32128590","32128905","46","32566333"
"chr1","64736201","64736457","chr11","71756217","71756469","56","7020016"
"chr1","64768266","64768480","chr19","17634994","17635169","71","47133272"
"chr1","64830333","64830603","chr13","31958223","31958500","36","32872110"
"chr1","64857239","64857475","chr11","7959406","7959650","63","56897833"
"chr1","64870439","64870741","chr10","142124022","142124308","77","77253583"
"chr1","64871538","64871813","chr13","31916039","31916319","49","32955499"
"chr1","64880250","64880519","chr14","54791229","54791504","58","10089021"
"chr1","64897722","64897924","chr10","92078511","92078706","51","27180789"
"chr1","64900974","64901282","chr13","31892424","31892732","35","33008550"
"chr1","64919501","64919790","chr19","4846428","4846713","57","60073073"
"chr1","64979880","64980176","chr13","31748931","31749229","57","33230949"
"chr1","65011409","65011705","chr13","31701658","31701954","40","33309751"
"chr1","65023803","65024084","chr13","31688092","31688377","35","33335711"
"chr1","65040525","65040764","chr13","31676804","31677042","36","33363721"
"chr1","65042863","65043161","chr13","31675642","31675947","38","33367221"
"chr1","65140047","65140338","chr7","127917187","127917476","56","62777140"
"chr1","65172465","65172670","chr13","31571365","31571587","39","33601100"
"chr1","65183051","65183248","chr1","146118969","146119169","49","80935918"
"chr1","65188589","65188832","chr13","31555855","31556098","31","33632734"
"chr1","65193613","65193933","chr13","31535176","31535474","56","33658437"
"chr1","65193945","65194068","chr10","25121161","25121285","17","40072784"
"chr1","65195224","65195526","chr13","31533367","31533666","37","33661857"
"chr1","65200947","65201222","chrX","38718222","38718507","64","26482725"
"chr1","65226631","65226935","chr5","156466426","156466718","62","91239795"
"chr1","65241436","65241584","chr15","28613492","28613648","39","36627944"
"chr1","65252116","65252388","chr13","31472554","31472846","52","33779562"
"chr1","65263614","65263780","chr19","16879306","16879475","32","48384308"
"chr1","65268158","65268434","chr1","8666943","8667208","56","56601215"
"chr1","65332154","65332449","chr13","31397271","31397558","48","33934883"
"chr1","65334093","65334368","chr13","31392604","31392864","44","33941489"
"chr1","65346365","65346656","chr12","8825436","8825723","58","56520929"
"chr1","65356819","65357114","chr16","60238828","60239122","58","5117991"
"chr1","65366733","65367036","chr13","31358236","31358555","56","34008497"
"chr1","65372839","65373127","chr13","31353946","31354239","70","34018893"
"chr1","65374314","65374631","chr13","31352073","31352367","63","34022241"
"chr1","65380751","65380895","chr18","56015793","56015935","42","9364958"
"chr1","65438631","65438908","chr13","31213237","31213490","48","34225394"
"chr1","65533859","65534096","chr13","31310290","31310531","33","34223569"
"chr1","65580484","65580558","chr13","31153911","31153987","9","34426573"
"chr1","65611575","65611697","chr16","49163191","49163312","22","16448384"
"chr1","65611707","65611761","chr22","23065623","23065672","16","42546084"
"chr1","65612079","65612332","chr13","31179441","31179704","35","34432638"
"chr1","65615100","65615354","chr13","31110949","31111202","43","34504151"
"chr1","65617139","65617448","chr7","37846658","37846957","58","27770481"
"chr1","65664114","65664399","chr13","31059641","31059932","30","34604473"
"chr1","65685043","65685159","chr13","31025221","31025335","14","34659822"
"chr1","65689587","65689891","chr13","31021416","31021709","33","34668171"
"chr1","65735079","65735203","chr1","187726107","187726234","21","121991028"
"chr1","65746760","65747042","chr13","30959113","30959392","27","34787647"
"chr1","65804221","65804402","chr19","15967693","15967882","40","49836528"
"chr1","65829522","65829790","chr16","49181420","49181682","65","16648102"
"chr1","65849077","65849230","chr19","5169265","5169417","37","60679812"
"chr1","65853156","65853452","chr1","185699026","185699311","64","119845870"
"chr1","65894356","65894650","chr13","30772612","30772892","41","35121744"
"chr1","66068733","66068778","chr2A","59530628","59530676","12","6538105"
"chr1","66069419","66069599","chr22","4243708","4243880","44","61825711"
"chr1","66132303","66132556","chr13","30505254","30505532","48","35627049"
"chr1","66166492","66166786","chrX","16470304","16470598","58","49696188"
"chr1","66224799","66225099","chr7","101393477","101393769","73","35168678"
"chr1","66244314","66244613","chr13","30392016","30392297","45","35852298"
"chr1","66268389","66268512","chr20","5021579","5021702","25","61246810"
"chr1","66291174","66291461","chr13","30344778","30345069","40","35946396"
"chr1","66314027","66314210","chr5","19730491","19730683","51","46583536"
"chr1","66338478","66338770","chr13","30330340","30330634","32","36008138"
"chr1","66338813","66339023","chr20","18133504","18133721","48","48205309"
"chr1","66359184","66359430","chr8","26841625","26841879","59","39517559"
"chr1","66374765","66375067","chrX","77641675","77641977","58","11266910"
"chr1","66431403","66431694","chr13","30238877","30239158","61","36192526"
"chr1","66457218","66457529","chr13","30212725","30213028","45","36244493"
"chr1","66484549","66484814","chr13","30185848","30186114","44","36298701"
"chr1","66492464","66492595","chr13","30177055","30177191","24","36315409"
"chr1","66503868","66503974","chr11","67337030","67337134","18","833162"
"chr1","66517838","66518118","chr13","30149280","30149559","41","36368558"
"chr1","66559430","66559710","chr5","10317469","10317748","59","56241961"
"chr1","66601697","66601853","chr7","96055065","96055220","32","29453368"
"chr1","66610459","66610747","chr5","34269216","34269495","59","32341243"
"chr1","66670838","66671166","chr1","177534288","177534600","88","110863450"
"chr1","66705929","66706185","chr9","12115701","12115949","51","54590228"
"chr1","66732300","66732610","chr13","31850276","31850573","48","34882024"
"chr1","66800981","66801286","chr13","29909056","29909354","43","36891925"
"chr1","66832143","66832442","chr12","21390242","21390534","59","45441901"
"chr1","66887404","66887713","chr6","113164881","113165184","68","46277477"
"chr1","66909279","66909400","chr13","29786452","29786576","19","37122827"
"chr1","67028177","67028492","chr5","135327295","135327606","70","68299118"
"chr1","67592076","67592335","chr16","28090554","28090811","69","39501522"
"chr1","68105667","68105962","chr10","143751926","143752218","55","75646259"
"chr1","68159444","68159735","chr13","28621046","28621347","42","39538398"
"chr1","68175220","68175429","chr9","83568654","83568859","42","15393434"
"chr1","68214368","68214532","chr7","79271528","79271684","39","11057160"
"chr1","68232104","68232224","chr1","213898466","213898589","21","145666362"
"chr1","68323545","68323765","chr5","61444275","61444489","55","6879270"
"chr1","68327116","68327265","chr2B","94897282","94897419","35","26570166"
"chr1","68346742","68347049","chr5","16157151","16157447","65","52189591"
"chr1","68497325","68497623","chr13","28257208","28257521","61","40240117"
"chr1","68520300","68520558","chr13","28237101","28237371","38","40283199"
"chr1","68627186","68627471","chr5","50922614","50922901","51","17704572"
"chr1","68634278","68634503","chr18","55165662","55165888","61","13468616"
"chr1","68641260","68641508","chr13","28111766","28112020","46","40529494"
"chr1","68683458","68683764","chr13","28074568","28074885","58","40608890"
"chr1","68703910","68704195","chr13","28053973","28054252","33","40649937"
"chr1","68704553","68704852","chrX","10432241","10432538","56","58272312"
"chr1","68893413","68893574","chr13","5474254","5474413","47","63419159"
"chr1","68929404","68929637","chr12","121099679","121099914","65","52170275"
"chr1","68953822","68954118","chr13","27802347","27802641","42","41151475"
"chr1","68960674","68960832","chr3","155594993","155595154","33","86634319"
"chr1","68976696","68976949","chr13","27781099","27781375","45","41195597"
"chr1","68981024","68981280","chr13","27776820","27777077","23","41204204"
"chr1","69126415","69126661","chr9","78696785","78697026","42","9570370"
"chr1","69166524","69166826","chr15","21383408","21383710","58","47783116"
"chr1","69166830","69166903","chr1","225279648","225279721","18","156112818"
"chr1","69170563","69170858","chrX","46819208","46819495","72","22351355"
"chr1","69190055","69190353","chr9","78752224","78752522","40","9562169"
"chr1","69200368","69200669","chr9","74826582","74826885","40","5626214"
"chr1","69287183","69287474","chr9","68494257","68494556","46","792926"
"chr1","69311372","69311594","chr1","114576431","114576639","63","45265059"
"chr1","69454204","69454508","chr7","72477384","72477690","63","3023180"
"chr1","69484403","69484635","chr13","7008373","7008614","62","62476030"
"chr1","69493673","69493962","chr9","68725819","68726120","55","767854"
"chr1","69581912","69582197","chr9","68806276","68806558","45","775636"
"chr1","69610378","69610533","chr1","14800532","14800692","36","54809846"
"chr1","69794351","69794676","chr9","69022858","69023187","35","771493"
"chr1","69979123","69979285","chr19","6609732","6609893","40","63369391"
"chr1","70118639","70118924","chr16","27510882","27511173","71","42607757"
"chr1","70127115","70127406","chr9","69348911","69349200","33","778204"
"chr1","70270057","70270175","chr6","37801775","37801890","18","32468282"
"chr1","70324605","70324909","chr9","69554235","69554540","38","770370"
"chr1","70352354","70352502","chr2B","27751482","27751639","36","42600872"
"chr1","70389830","70389986","chr1","148219593","148219735","39","77829763"
"chr1","70404278","70404397","chr7","33365727","33365846","23","37038551"
"chr1","70478133","70478428","chr9","69711566","69711864","60","766567"
"chr1","70586578","70586874","chr9","69834626","69834905","44","751952"
"chr1","70675631","70675885","chr7","156158674","156158932","63","85483043"
"chr1","70727087","70727314","chr14","47954834","47955057","66","22772253"
"chr1","70827591","70827871","chr9","72213371","72213660","48","1385780"
"chr1","71104691","71104999","chr9","72491994","72492299","54","1387303"
"chr1","71270482","71270623","chr14","86999208","86999349","39","15728726"
"chr1","71299725","71300014","chr9","72667542","72667834","36","1367817"
"chr1","71467081","71467358","chr9","72775391","72775686","43","1308310"
"chr1","71508445","71508553","chr19","15219953","15220058","26","56288492"
"chr1","71529430","71529658","chr9","72844036","72844274","27","1314606"
"chr1","71663931","71664215","chr19","38783871","38784152","67","32880060"
"chr1","71776320","71776482","chr20","6698702","6698848","44","65077618"
"chr1","71900163","71900489","chr9","73211480","73211788","50","1311317"
"chr1","71907475","71907531","chr2B","26931720","26931778","13","44975755"
"chr1","71908165","71908339","chr5","43474037","43474214","44","28434128"
"chr1","71976016","71976185","chr6","162551622","162551785","36","90575606"
"chr1","71997357","71997636","chr9","73308782","73309060","42","1311425"
"chr1","72004880","72005166","chr12","32032110","32032393","66","39972770"
"chr1","72008582","72008854","chr9","73321600","73321891","60","1313018"
"chr1","72018148","72018443","chr9","73332173","73332466","37","1314025"
"chr1","72069059","72069101","chrX","67984670","67984711","7","4084389"
"chr1","72069778","72070026","chr9","73390970","73391216","26","1321192"
"chr1","72117157","72117467","chr1","101615090","101615392","66","29497933"
"chr1","72189840","72190080","chr9","73495051","73495329","65","1305211"
"chr1","72193600","72193694","chr9","73497965","73498059","5","1304365"
"chr1","72205547","72205852","chr9","73508425","73508738","40","1302878"
"chr1","72273437","72273712","chr3","123479061","123479344","66","51205624"
"chr1","72373907","72374197","chr12","1569985","1570270","66","70803922"
"chr1","72382880","72383206","chr9","71943811","71944144","42","439069"
"chr1","72478926","72479082","chr11","47982935","47983093","28","24495991"
"chr1","72532250","72532357","chr13","9559854","9559959","19","62972396"
"chr1","72548449","72548746","chr7","127734527","127734826","72","55186078"
"chr1","72590727","72591041","chr20","2655219","2655520","57","69935508"
"chr1","72732088","72732211","chr9","70636318","70636444","10","2095770"
"chr1","72830705","72830838","chr1","109948107","109948236","25","37117402"
"chr1","72959541","72959597","chr19","46945886","46945935","19","26013655"
"chr1","72969760","72970061","chr9","70901518","70901779","73","2068242"
"chr1","73059368","73059541","chr9","35828180","35828355","32","37231188"
"chr1","73177181","73177392","chr9","71104768","71104986","35","2072413"
"chr1","73192555","73192825","chr10","142747807","142748078","70","69555252"
"chr1","73230424","73230544","chr4","190819336","190819447","27","117588912"
"chr1","73437025","73437178","chr17","4545169","4545326","37","68891856"
"chr1","73500458","73500747","chr9","71423845","71424130","24","2076613"
"chr1","73579846","73580134","chr9","71469435","71469728","40","2110411"
"chr1","73615496","73615783","chr9","71505939","71506239","52","2109557"
"chr1","73691415","73691699","chr9","71587385","71587666","31","2104030"
"chr1","73850118","73850344","chr9","71731504","71731720","37","2118614"
"chr1","73958840","73958913","chr4","4333939","4334013","21","69624901"
"chr1","74009180","74009416","chrX","71847367","71847618","64","2161813"
"chr1","74018526","74018831","chr9","74196927","74197218","49","178401"
"chr1","74031014","74031222","chr1","63280206","63280422","56","10750808"
"chr1","74036102","74036402","chr9","71469435","71469728","49","2566667"
"chr1","74050680","74050897","chr12","29993522","29993738","54","44057158"
"chr1","74142740","74142916","chr9","74235961","74236145","26","93221"
"chr1","74207227","74207509","chr1","62692578","62692858","62","11514649"
"chr1","74220833","74220953","chr6","48492641","48492762","21","25728192"
"chr1","74251284","74251394","chr9","74339745","74339861","20","88461"
"chr1","74301249","74301405","chr16","49017109","49017265","33","25284140"
"chr1","74301728","74301805","chr9","93927507","93927587","21","19625779"
"chr1","74341724","74342024","chr9","74421806","74422106","37","80082"
"chr1","74393300","74393579","chr9","74471217","74471496","37","77917"
"chr1","74408656","74408950","chr9","74486741","74487031","63","78085"
"chr1","74448006","74448293","chr9","74518698","74518977","32","70692"
"chr1","74464574","74464845","chr2B","125974533","125974809","56","51509959"
"chr1","74487138","74487266","chr13","11074766","11074892","25","63412372"
"chr1","74520762","74521013","chr9","74613737","74613987","28","92975"
"chr1","74526899","74527208","chr9","74619371","74619687","35","92472"
"chr1","74571884","74572016","chr10","34417594","34417723","21","40154290"
"chr1","74572491","74572658","chr5","51144248","51144411","37","23428243"
"chr1","74577918","74578043","chr2A","104115777","104115903","17","29537859"
"chr1","74589152","74589470","chr1","222885603","222885907","70","148296451"
"chr1","74593776","74594063","chr3","38996764","38997052","60","35597012"
"chr1","74813872","74814178","chr16","23250878","23251188","56","51562994"
"chr1","74884022","74884097","chr9","74215152","74215228","14","668870"
"chr1","74884123","74884194","chr10","114560318","114560388","12","39676195"
"chr1","74908442","74908728","chr2A","21942169","21942465","55","52966273"
"chr1","74977986","74978209","chr9","83258097","83258323","23","8280111"
"chr1","75069266","75069570","chr13","78087244","78087548","63","3017978"
"chr1","75075520","75075794","chr19","47860729","47861011","59","27214791"
"chr1","75080170","75080474","chr19","47856148","47856461","54","27224022"
"chr1","75109376","75109590","chr9","69974872","69975059","45","5134504"
"chr1","75164877","75164932","chr1","136856966","136857024","15","61692089"
"chr1","75165182","75165460","chr9","78884397","78884676","61","3719215"
"chr1","75175111","75175401","chr9","78870249","78870548","38","3695138"
"chr1","75257851","75258060","chr9","74922382","74922591","31","335469"
"chr1","75346364","75346660","chr2A","1334954","1335244","60","74011410"
"chr1","75405244","75405550","chr8","27920049","27920334","84","47485195"
"chr1","75415827","75416034","chr1","134620886","134621087","53","59205059"
"chr1","75453176","75453332","chr1","216330853","216331024","38","140877677"
"chr1","75466472","75466782","chr7","104942328","104942627","68","29475856"
"chr1","75475551","75475634","chr17","91800985","91801068","8","16325434"
"chr1","75512613","75512767","chr5","51144248","51144411","43","24368365"
"chr1","75525652","75525784","chr10","113081251","113081384","19","37555599"
"chr1","75526276","75526577","chr16","30950078","30950376","60","44576198"
"chr1","75531329","75531570","chr15","44838339","44838622","72","30692990"
"chr1","75533709","75533824","chr15","44835623","44835742","11","30698086"
"chr1","75543225","75543470","chr15","44826090","44826320","40","30717135"
"chr1","75550067","75550187","chr15","44819672","44819796","20","30730395"
"chr1","75562198","75562475","chr22","2288950","2289233","37","73273248"
"chr1","75575906","75576106","chr3","157327933","157328131","50","81752027"
"chr1","75645021","75645181","chr20","44858230","44858390","38","30786791"
"chr1","75645188","75645444","chr19","47342291","47342551","68","28302897"
"chr1","75690655","75690933","chr9","75090780","75091058","41","599875"
"chr1","75925243","75925369","chr12","111176332","111176452","27","35251089"
"chr1","75939607","75939893","chr5","125237108","125237400","77","49297501"
"chr1","75971623","75971817","chr12","110696507","110696698","47","34724884"
"chr1","76130827","76131113","chr9","75525826","75526108","41","605001"
"chr1","76132280","76132537","chr9","75527278","75527554","44","605002"
"chr1","76171442","76171743","chrX","118781113","118781410","51","42609671"
"chr1","76227088","76227236","chr5","29922331","29922474","43","46304757"
"chr1","76230005","76230129","chrX","49113443","49113558","31","27116562"
"chr1","76233350","76233614","chr13","579303","579594","61","75654047"
"chr1","76326153","76326445","chr11","9565482","9565789","75","66760671"
"chr1","76537026","76537141","chr13","4897189","4897304","21","71639837"
"chr1","76624078","76624383","chr9","76018393","76018685","46","605685"
"chr1","76646692","76646881","chr19","33569185","33569372","35","43077507"
"chr1","76754025","76754310","chr1","210738129","210738412","67","133984104"
"chr1","76805717","76806025","chr9","76176869","76177163","58","628848"
"chr1","76832812","76833080","chr8","119209106","119209366","65","42376294"
"chr1","76881801","76882078","chr20","45505365","45505648","53","31376436"
"chr1","76898510","76898792","chr14","76943072","76943349","60","44562"
"chr1","76918709","76918951","chr7","143454311","143454549","56","66535602"
"chr1","76981780","76982043","chr9","70095242","70095515","49","6886538"
"chr1","77053218","77053519","chr10","134948898","134949179","65","57895680"
"chr1","77105222","77105375","chrX","41476886","41477033","33","35628336"
"chr1","77126573","77126887","chr9","70167494","70167817","54","6959079"
"chr1","77177717","77177989","chr3","140583382","140583663","53","63405665"
"chr1","77194576","77194853","chr9","70215787","70216071","47","6978789"
"chr1","77250730","77250837","chr1","157655866","157655976","22","80405136"
"chr1","77259653","77259813","chr5","49653517","49653681","40","27606136"
"chr1","77262059","77262202","chr1","32730027","32730168","30","44532032"
"chr1","77272770","77273068","chr9","70289660","70289959","32","6983110"
"chr1","77278399","77278520","chr10","102152116","102152227","24","24873717"
"chr1","77324614","77324921","chr3","12972732","12973038","70","64351882"
"chr1","77361450","77361753","chr9","70390802","70391105","38","6970648"
"chr1","77378889","77379161","chr9","70408589","70408879","43","6970300"
"chr1","77414208","77414505","chr9","70442652","70442948","23","6971556"
"chr1","77466026","77466314","chr9","78870249","78870548","49","1404223"
"chr1","77476345","77476634","chr9","78884397","78884676","55","1408052"
"chr1","77476882","77476941","chr1","136856966","136857024","13","59380084"
"chr1","77545709","77545836","chr9","79102872","79102998","19","1557163"
"chr1","77625104","77625380","chr9","78611983","78612255","38","986879"
"chr1","77660052","77660193","chr1","193134715","193134856","34","115474663"
"chr1","77660560","77660672","chr7","45148945","45149056","27","32511615"
"chr1","77684194","77684506","chr9","76593924","76594203","79","1090270"
"chr1","77782531","77782789","chr2A","96269120","96269376","62","18486589"
"chr1","77823781","77823900","chr4","110276962","110277083","25","32453181"
"chr1","77881844","77882053","chr9","76763709","76763904","46","1118135"
"chr1","77885718","77886008","chr19","38511083","38511371","64","39374635"
"chr1","77970718","77970998","chr9","76836566","76836865","46","1134152"
"chr1","78009695","78009991","chr9","76876976","76877264","48","1132719"
"chr1","78011647","78011944","chr9","76878960","76879269","46","1132687"
"chr1","78040800","78040937","chr1","21535094","21535239","38","56505706"
"chr1","78136895","78137188","chr19","18871903","18872198","55","59264992"
"chr1","78163849","78164122","chr9","76996208","76996488","39","1167641"
"chr1","78315644","78315951","chr9","77141392","77141694","41","1174252"
"chr1","78317931","78318239","chr9","77143978","77144282","44","1173953"
"chr1","78376640","78376931","chr9","77202052","77202323","66","1174588"
"chr1","78393562","78393860","chr3","145246806","145247099","59","66853244"
"chr1","78411537","78411822","chr9","77235807","77236099","42","1175730"
"chr1","78415218","78415282","chr1","153172826","153172891","12","74757608"
"chr1","78415942","78416087","chr3","267312","267456","34","78148630"
"chr1","78498417","78498731","chr9","77331843","77332147","45","1166574"
"chr1","78500789","78501100","chr9","77334128","77334415","56","1166661"
"chr1","78509458","78509625","chr19","41804860","41805021","44","36704598"
"chr1","78524659","78524827","chr5","118399435","118399596","41","39874776"
"chr1","78530035","78530250","chr9","77368376","77368592","30","1161659"
"chr1","78566327","78566583","chr9","77401310","77401600","61","1165017"
"chr1","78609367","78609611","chr9","77444877","77445136","53","1164490"
"chr1","78674151","78674464","chr3","15699392","15699703","74","62974759"
"chr1","78679768","78680089","chr9","77517551","77517868","43","1162217"
"chr1","78713037","78713332","chr9","77549371","77549683","52","1163666"
"chr1","78720526","78720814","chr10","107125275","107125561","54","28404749"
"chr1","78743591","78743760","chr9","77577070","77577240","17","1166521"
"chr1","78814562","78814874","chr9","77641884","77642190","55","1172678"
"chr1","78857454","78857752","chr16","10963785","10964082","45","67893669"
"chr1","78898642","78898822","chr22","25276970","25277148","48","53621672"
"chr1","78988387","78988667","chr8","59850782","59851072","66","19137605"
"chr1","78988678","78988801","chr9","77826519","77826642","10","1162159"
"chr1","79019868","79020143","chr9","95660192","95660467","55","16640324"
"chr1","79076403","79076677","chr9","77929704","77929998","43","1146699"
"chr1","79164300","79164424","chr9","78013104","78013232","21","1151196"
"chr1","79205672","79205827","chr17","16419521","16419660","54","62786151"
"chr1","79318497","79318775","chr9","78162315","78162605","56","1156182"
"chr1","79323508","79323652","chr9","78167229","78167371","24","1156279"
"chr1","79323657","79323962","chr9","78167376","78167687","34","1156281"
"chr1","79332729","79332885","chr11","101841108","101841253","42","22508379"
"chr1","79348839","79349094","chr16","2556473","2556728","60","76792366"
"chr1","79369173","79369460","chr9","78209355","78209646","29","1159818"
"chr1","79403497","79403801","chr9","78238447","78238750","34","1165050"
"chr1","79459359","79459663","chr9","78290005","78290300","51","1169354"
"chr1","79476173","79476441","chr9","78302179","78302450","38","1173994"
"chr1","79503459","79503748","chr5","142005741","142006029","55","62502282"
"chr1","79509545","79509837","chr9","78335347","78335631","38","1174198"
"chr1","79525048","79525360","chr3","45828868","45829172","73","33696180"
"chr1","79551679","79551905","chr8","27540451","27540680","43","52011228"
"chr1","79625706","79625823","chr15","28873131","28873248","16","50752575"
"chr1","79632935","79633093","chr8","73679726","73679887","35","5953209"
"chr1","79633281","79633415","chr3","184961336","184961471","25","105328055"
"chr1","79670512","79670594","chr14","87252225","87252301","20","7581713"
"chr1","79671510","79671739","chr12","65334019","65334244","57","14337491"
"chr1","79677330","79677617","chr9","78397671","78397960","24","1279659"
"chr1","79706320","79706434","chr3","118942550","118942663","24","39236230"
"chr1","79718977","79719114","chr7","77000001","77000126","36","2718976"
"chr1","79736276","79736554","chr15","69717029","69717302","72","10019247"
"chr1","79750324","79750392","chr7","72484245","72484312","17","7266079"
"chr1","79751307","79751453","chr3","49034166","49034278","54","30717141"
"chr1","79755018","79755329","chr16","31576379","31576695","64","48178639"
"chr1","79762568","79762693","chr3","188313519","188313645","24","108550951"
"chr1","79766755","79767047","chr9","78477732","78478035","62","1289023"
"chr1","79772211","79772422","chr12","19328307","19328527","66","60443904"
"chr1","79782392","79782670","chr9","95660192","95660467","54","15877800"
"chr1","79793958","79794177","chr9","78508940","78509183","43","1285018"
"chr1","79864664","79864952","chr9","78576735","78577024","59","1287929"
"chr1","79869991","79870291","chr9","78582127","78582419","48","1287864"
"chr1","79872684","79872839","chr9","78584798","78584959","28","1287886"
"chr1","79891285","79891556","chr9","78602905","78603189","39","1288380"
"chr1","79895327","79895614","chr2B","131218260","131218552","65","51322933"
"chr1","79959473","79959733","chr9","78650999","78651275","35","1308474"
"chr1","79991137","79991440","chr9","79228400","79228703","45","762737"
"chr1","80018050","80018345","chr9","74806649","74806935","43","5211401"
"chr1","81021068","81021255","chr8","98909960","98910147","52","17888892"
"chr1","81028949","81029253","chr9","10761348","10761657","53","70267601"
"chr1","81067383","81067702","chr9","10738913","10739213","69","70328470"
"chr1","81073112","81073251","chr8","74775024","74775168","40","6298088"
"chr1","81154694","81154988","chr1","91019845","91020139","65","9865151"
"chr1","81500430","81500681","chr9","10299714","10299969","42","71200716"
"chr1","81531119","81531388","chr9","10269049","10269321","31","71262070"
"chr1","81620678","81620824","chr7","78925352","78925506","38","2695326"
"chr1","81620838","81620887","chr7","20142910","20142961","11","61477928"
"chr1","81621121","81621189","chr3","127686441","127686512","22","46065320"
"chr1","81633540","81633687","chr3","152725982","152726134","33","71092442"
"chr1","81964160","81964280","chr1","197387151","197387270","19","115422991"
"chr1","82056677","82056948","chr9","51919968","51920251","48","30136709"
"chr1","82069159","82069444","chr9","51937276","51937568","34","30131883"
"chr1","82252212","82252491","chr3","62210397","62210682","72","20041815"
"chr1","82307383","82307666","chr15","22753658","22753941","65","59553725"
"chr1","82309094","82309274","chr12","109322414","109322590","51","27013320"
"chr1","82317826","82317974","chr4","35802838","35802982","36","46514988"
"chr1","82391914","82392177","chr19","31483985","31484243","59","50907929"
"chr1","82434683","82434948","chr9","68010000","68010249","57","14424683"
"chr1","82449325","82449608","chr10","25303615","25303901","64","57145710"
"chr1","82457410","82457569","chr14","58946732","58946889","38","23510678"
"chr1","82486827","82486938","chr3","199536979","199537090","19","117050152"
"chr1","82544351","82544625","chr9","67790017","67790301","35","14754334"
"chr1","82548688","82548989","chr9","67779523","67779824","32","14769165"
"chr1","82561961","82562076","chr20","47655817","47655933","18","34906144"
"chr1","82600514","82600751","chr4","199123384","199123638","66","116522870"
"chr1","82670166","82670302","chrX","3940333","3940465","27","78729833"
"chr1","82690518","82690635","chr9","67657590","67657707","10","15032928"
"chr1","82966808","82967090","chr9","67374772","67375059","36","15592036"
"chr1","82982942","82983198","chr9","67359261","67359532","43","15623681"
"chr1","83610234","83610507","chr9","66733142","66733424","42","16877092"
"chr1","83741833","83741994","chr12","109514253","109514411","33","25772420"
"chr1","83759006","83759103","chr3","58857961","58858058","13","24901045"
"chr1","83760970","83761194","chr2A","43999433","43999654","54","39761537"
"chr1","83802286","83802516","chr11","8829622","8829856","58","74972664"
"chr1","83843628","83843918","chr4","109646943","109647235","71","25803315"
"chr1","83907249","83907376","chr9","66439330","66439458","22","17467919"
"chr1","83910733","83910953","chr11","107762988","107763204","46","23852255"
"chr1","83934069","83934172","chr2B","16451102","16451202","21","67482967"
"chr1","83937052","83937264","chr9","66402331","66402562","41","17534721"
"chr1","83951983","83952110","chr6","42542700","42542827","24","41409283"
"chr1","83976318","83976381","chr2B","5742542","5742608","16","78233776"
"chr1","83976799","83976852","chr11","60189868","60189921","17","23786931"
"chr1","84233678","84233875","chr3","186187771","186187981","48","101954093"
"chr1","84253414","84253727","chr1","23622718","23623020","75","60630696"
"chr1","84263170","84263340","chr10","8266247","8266432","49","75996923"
"chr1","84271576","84271829","chr9","66036002","66036265","38","18235574"
"chr1","84277508","84277813","chr9","66030793","66031093","40","18246715"
"chr1","84320788","84321110","chr12","70934636","70934937","85","13386152"
"chr1","84327568","84327766","chr9","65973269","65973486","35","18354299"
"chr1","84342239","84342505","chr9","65964978","65965253","30","18377261"
"chr1","84346975","84347100","chr3","17302178","17302302","22","67044797"
"chr1","84364177","84364456","chr11","9486577","9486862","56","74877600"
"chr1","84375833","84376126","chr17","95757781","95758073","61","11381948"
"chr1","84391826","84392127","chr9","67904810","67905098","44","16487016"
"chr1","84403981","84404271","chr9","67808102","67808398","37","16595879"
"chr1","84490237","84490363","chr16","21575308","21575433","22","62914929"
"chr1","84502835","84503115","chr9","10985253","10985514","73","73517582"
"chr1","84567706","84567991","chr13","33980388","33980688","71","50587318"
"chr1","84598575","84598865","chr1","159332642","159332938","49","74734067"
"chr1","84635383","84635545","chr1","44864963","44865126","33","39770420"
"chr1","84662761","84662949","chr14","53298368","53298558","49","31364393"
"chr1","84717961","84718077","chr9","65622669","65622782","14","19095292"
"chr1","84848775","84849049","chr9","65500869","65501136","41","19347906"
"chr1","85008132","85008255","chr16","59134844","59134968","22","25873288"
"chr1","85008837","85008962","chr8","21552086","21552212","24","63456751"
"chr1","85201413","85201569","chr15","28613492","28613648","37","56587921"
"chr1","85398732","85399043","chr9","64957917","64958232","52","20440815"
"chr1","85451534","85451625","chr9","64904016","64904108","10","20547518"
"chr1","85452594","85452670","chr5","98874822","98874900","10","13422228"
"chr1","85653560","85653877","chr9","64694981","64695275","67","20958579"
"chr1","85739862","85740126","chr5","61361286","61361549","70","24378576"
"chr1","86209565","86209835","chr9","64258656","64258942","42","21950909"
"chr1","86248633","86248924","chr9","64219237","64219502","53","22029396"
"chr1","86286629","86286703","chr11","125736175","125736246","15","39449546"
"chr1","86463287","86463553","chr11","8601673","8601936","68","77861614"
"chr1","86514231","86514539","chr9","63899436","63899726","40","22614795"
"chr1","86555797","86555917","chr5","42390323","42390448","31","44165474"
"chr1","86564174","86564459","chr9","63845715","63846008","45","22718459"
"chr1","86568965","86569276","chr9","63833973","63834277","39","22734992"
"chr1","86632050","86632339","chr15","18211091","18211376","59","68420959"
"chr1","86660522","86660807","chr19","16970928","16971204","69","69689594"
"chr1","86663059","86663203","chr3","24969012","24969139","36","61694047"
"chr1","86685162","86685437","chr9","63750889","63751187","59","22934273"
"chr1","86687509","86687620","chr9","91909520","91909629","18","5222011"
"chr1","86711856","86712022","chrX","9922284","9922452","33","76789572"
"chr1","86802808","86803109","chr18","12353458","12353757","64","74449350"
"chr1","86857246","86857541","chr22","33935616","33935903","81","52921630"
"chr1","86929764","86930056","chr4","151944849","151945132","64","65015085"
"chr1","86956568","86956838","chr3","181037580","181037849","56","94081012"
"chr1","87115217","87115330","chr9","63332416","63332532","17","23782801"
"chr1","87119990","87120103","chr2A","73166038","73166153","20","13953952"
"chr1","87325774","87326028","chrX","41932003","41932258","66","45393771"
"chr1","87340497","87340725","chr8","73513700","73513921","60","13826797"
"chr1","87568806","87569140","chr9","62958496","62958800","78","24610310"
"chr1","87631152","87631459","chr9","62869183","62869474","55","24761969"
"chr1","87701113","87701368","chr9","62775334","62775631","69","24925779"
"chr1","87701830","87702016","chr1","85990760","85990945","43","1711070"
"chr1","87739431","87739533","chr18","22807872","22807981","19","64931559"
"chr1","87741114","87741238","chr9","62736162","62736285","17","25004952"
"chr1","87769213","87769460","chr9","62695188","62695471","62","25074025"
"chr1","87942502","87942768","chr5","138770072","138770330","66","50827570"
"chr1","88020817","88021108","chr9","62378174","62378466","44","25642643"
"chr1","88042178","88042460","chr7","100964392","100964675","70","12922214"
"chr1","88285141","88285283","chr12","92990166","92990309","32","4705025"
"chr1","88345915","88346235","chr9","62022527","62022818","63","26323388"
"chr1","88361976","88362301","chr17","58963230","58963543","75","29398746"
"chr1","88424694","88424987","chr9","61963332","61963639","45","26461362"
"chr1","88429887","88430113","chr22","15757362","15757577","49","72672525"
"chr1","88629335","88629646","chr9","61748984","61749316","63","26880351"
"chr1","88678258","88678565","chr9","61698628","61698923","57","26979630"
"chr1","88761305","88761556","chr9","61621971","61622240","44","27139334"
"chr1","89375223","89375522","chr7","1708256","1708538","64","87666967"
"chr1","89523618","89523717","chr1","164304973","164305072","18","74781355"
"chr1","89529710","89529808","chr1","157737408","157737505","20","68207698"
"chr1","89553959","89554185","chr9","60774140","60774364","34","28779819"
"chr1","89608500","89608734","chr9","60718586","60718823","25","28889914"
"chr1","89634380","89634649","chr9","60679737","60680029","57","28954643"
"chr1","89659648","89659815","chr9","109735807","109735971","39","20076159"
"chr1","89745108","89745313","chr3","101529162","101529367","46","11784054"
"chr1","89960717","89961010","chr9","60332022","60332301","52","29628695"
"chr1","90070466","90070756","chr5","96942875","96943163","64","6872409"
"chr1","90099627","90099758","chr4","88581201","88581319","46","1518426"
"chr1","90102213","90102501","chr9","60176133","60176424","29","29926080"
"chr1","90119691","90119988","chr9","60161755","60162055","37","29957936"
"chr1","90135953","90136273","chr9","60145211","60145544","50","29990742"
"chr1","90138108","90138193","chr1","24679540","24679626","21","65458568"
"chr1","90144012","90144137","chr21","32443205","32443329","18","57700807"
"chr1","90153975","90154058","chr19","13152355","13152440","16","77001620"
"chr1","90196616","90196919","chr3","160820665","160820947","51","70624049"
"chr1","90216613","90216929","chr9","60118514","60118830","53","30098099"
"chr1","90237385","90237499","chr7","79291991","79292103","23","10945394"
"chr1","90265590","90265860","chr9","60070960","60071247","47","30194630"
"chr1","90271104","90271413","chr9","60065691","60065998","62","30205413"
"chr1","90368749","90368978","chr7","79015379","79015601","51","11353370"
"chr1","90383065","90383353","chr9","59939616","59939903","34","30443449"
"chr1","90465306","90465587","chr9","59838780","59839055","39","30626526"
"chr1","90540073","90540330","chr9","109523719","109523976","66","18983646"
"chr1","90574571","90574680","chr16","66053599","66053709","27","24520972"
"chr1","90581933","90582091","chr9","59723734","59723915","36","30858199"
"chr1","90582857","90583133","chr9","59724753","59725038","50","30858104"
"chr1","90583892","90584108","chr9","59723734","59723915","50","30860158"
"chr1","90636174","90636467","chr11","12728691","12728990","64","77907483"
"chr1","90696671","90696952","chr9","59627447","59627728","28","31069224"
"chr1","90708053","90708176","chr9","59616354","59616476","11","31091699"
"chr1","90760735","90760998","chr9","59569791","59570084","71","31190944"
"chr1","90834495","90834767","chr7","120833001","120833284","53","29998506"
"chr1","90837816","90838099","chr9","59495638","59495933","49","31342178"
"chr1","90846612","90846855","chr8","61880569","61880831","70","28966043"
"chr1","90853087","90853317","chr9","59481038","59481268","22","31372049"
"chr1","90913299","90913397","chr7","130080243","130080338","17","39166944"
"chr1","90984023","90984311","chr7","42566180","42566453","73","48417843"
"chr1","91050174","91050464","chr9","59288871","59289148","47","31761303"
"chr1","91125546","91125730","chr9","59226799","59226982","34","31898747"
"chr1","91142584","91142852","chr1","185329634","185329914","61","94187050"
"chr1","91204679","91204808","chr9","59152531","59152669","30","32052148"
"chr1","91229986","91230308","chr9","59127938","59128251","75","32102048"
"chr1","91253251","91253517","chr9","59099877","59100141","32","32153374"
"chr1","91265742","91266021","chr9","59086377","59086665","43","32179365"
"chr1","91300130","91300253","chr9","59046345","59046475","17","32253785"
"chr1","91303731","91303862","chr6","154239364","154239482","36","62935633"
"chr1","91347391","91347691","chr9","101273013","101273330","68","9925622"
"chr1","91425078","91425206","chr15","18218102","18218231","22","73206976"
"chr1","91467525","91467823","chr9","49977672","49977978","51","41489853"
"chr1","91537789","91538097","chr4","197668428","197668733","63","106130639"
"chr1","91556170","91556449","chr9","1611","1905","49","91554559"
"chr1","91616307","91616460","chr20","6698702","6698848","37","84917605"
"chr1","91620922","91621057","chr10","3133708","3133847","33","88487214"
"chr1","91717607","91717872","chr9","111715454","111715730","64","19997847"
"chr1","91722850","91723114","chr9","90981959","90982231","60","740891"
"chr1","91728451","91728765","chr9","58881324","58881643","43","32847127"
"chr1","91731219","91731512","chr9","58884287","58884580","46","32846932"
"chr1","91791234","91791391","chrX","41481899","41482051","48","50309335"
"chr1","91853286","91853444","chr6","44423704","44423873","37","47429582"
"chr1","91853526","91853635","chr7","95524560","95524670","18","3671034"
"chr1","91861880","91862045","chrX","9922284","9922452","36","81939596"
"chr1","91884147","91884268","chr3","49040009","49040134","22","42844138"
"chr1","91893533","91893671","chr1","211021343","211021484","35","119127810"
"chr1","92012597","92012880","chr9","58629792","58630080","33","33382805"
"chr1","92014041","92014307","chr9","58627317","58627586","41","33386724"
"chr1","92015437","92015744","chr10","102014048","102014355","79","9998611"
"chr1","92054192","92054491","chr9","58594884","58595182","33","33459308"
"chr1","92067156","92067315","chr13","4679163","4679332","41","87387993"
"chr1","92106849","92107054","chr6","91035512","91035718","37","1071337"
"chr1","92136975","92137269","chr3","9881757","9882055","51","82255218"
"chr1","92139511","92139729","chr1","125703513","125703723","47","33564002"
"chr1","92204781","92205055","chr1","207784207","207784465","76","115579426"
"chr1","92231142","92231394","chr9","58426472","58426758","64","33804670"
"chr1","92240365","92240596","chr9","58416083","58416317","27","33824282"
"chr1","92241261","92241314","chr5","56908669","56908722","12","35332592"
"chr1","92267195","92267492","chr9","58384664","58384965","40","33882531"
"chr1","92279645","92279928","chr9","58375496","58375777","27","33904149"
"chr1","92306437","92306750","chr9","58345104","58345401","42","33961333"
"chr1","92406806","92407086","chr9","58155247","58155534","37","34251559"
"chr1","92414677","92414928","chr9","114420965","114421219","58","22006288"
"chr1","92416888","92417138","chr2A","74440846","74441091","62","17976042"
"chr1","92421485","92421773","chr9","58155247","58155534","29","34266238"
"chr1","92429081","92429332","chr9","114420965","114421219","58","21991884"
"chr1","92431300","92431550","chr2A","74440846","74441091","61","17990454"
"chr1","92438093","92438367","chr9","58135268","58135550","51","34302825"
"chr1","92440084","92440197","chr10","90823450","90823563","22","1616634"
"chr1","92455992","92456299","chr9","58076710","58077021","56","34379282"
"chr1","92462702","92463003","chr9","58069939","58070223","50","34392763"
"chr1","92463559","92463683","chr5","10575967","10576091","17","81887592"
"chr1","92530604","92530873","chr9","58008421","58008710","66","34522183"
"chr1","92632081","92632365","chr3","125236842","125237124","69","32604761"
"chr1","92633423","92633689","chr9","57913967","57914235","32","34719456"
"chr1","92693177","92693464","chr1","221569715","221570002","52","128876538"
"chr1","92719224","92719468","chr6","2751331","2751549","77","89967893"
"chr1","92721281","92721573","chr9","57825903","57826191","32","34895378"
"chr1","92721981","92722102","chr7","6379157","6379273","27","86342824"
"chr1","92743089","92743384","chr9","57803691","57803992","44","34939398"
"chr1","92775509","92775806","chr1","191946453","191946748","57","99170944"
"chr1","92822299","92822565","chr15","31054936","31055214","75","61767363"
"chr1","92842127","92842407","chr1","116070442","116070738","68","23228315"
"chr1","93243069","93243214","chr3","267312","267456","34","92975757"
"chr1","93461146","93461263","chr9","57130284","57130398","18","36330862"
"chr1","93461522","93461629","chr10","105655931","105656038","18","12194409"
"chr1","93659456","93659748","chr9","56977425","56977711","40","36682031"
"chr1","93694239","93694521","chr16","14870080","14870365","60","78824159"
"chr1","93702662","93702964","chr9","56933681","56933959","59","36768981"
"chr1","93711772","93711903","chr9","56925032","56925170","19","36786740"
"chr1","93718598","93718895","chr5","46202801","46203098","59","47515797"
"chr1","93740654","93740964","chr5","157030304","157030609","68","63289650"
"chr1","93750001","93750138","chr2B","94897282","94897419","38","1147281"
"chr1","93787264","93787395","chr6","154239364","154239482","36","60452100"
"chr1","93791081","93791212","chr9","59046345","59046475","11","34744736"
"chr1","93991996","93992209","chr19","2810406","2810614","48","91181590"
"chr1","94029675","94029896","chr7","67519721","67519924","54","26509954"
"chr1","94031997","94032266","chr5","34710257","34710525","67","59321740"
"chr1","94045194","94045514","chr9","56875427","56875713","69","37169767"
"chr1","94051679","94051918","chr7","74375314","74375570","61","19676365"
"chr1","94068226","94068522","chr9","56855311","56855615","64","37212915"
"chr1","94076914","94077196","chr9","56847431","56847709","34","37229483"
"chr1","94099213","94099485","chr9","56823045","56823346","51","37276168"
"chr1","94131556","94131846","chr14","38538872","38539159","62","55592684"
"chr1","94190942","94191175","chr7","3138375","3138599","57","91052567"
"chr1","94209023","94209123","chr5","22128933","22129035","20","72080090"
"chr1","94226779","94227058","chr9","56686400","56686686","42","37540379"
"chr1","94233538","94233801","chr9","56682273","56682542","35","37551265"
"chr1","94254711","94254993","chr9","56646310","56646617","58","37608401"
"chr1","94269738","94269861","chr9","56631383","56631513","14","37638355"
"chr1","94289270","94289351","chr12","68696584","68696661","17","25592686"
"chr1","94317503","94317766","chr9","56575974","56576255","46","37741529"
"chr1","94454532","94454823","chr9","56440968","56441254","30","38013564"
"chr1","94818764","94819024","chr19","1508954","1509216","65","93309810"
"chr1","94921710","94922027","chr9","55909017","55909335","58","39012693"
"chr1","95073738","95073912","chr10","108461325","108461484","52","13387587"
"chr1","95073958","95074070","chr19","14292883","14292994","29","80781075"
"chr1","95331177","95331471","chr9","55474178","55474478","50","39856999"
"chr1","95398772","95399037","chr9","55404877","55405173","57","39993895"
"chr1","95488727","95488845","chr7","110589955","110590074","25","15101228"
"chr1","95536535","95536821","chr9","55266299","55266606","64","40270236"
"chr1","95551837","95551944","chr1","100475717","100475823","26","4923880"
"chr1","95725062","95725377","chr9","55085166","55085475","45","40639896"
"chr1","95756155","95756321","chr9","109650705","109650871","30","13894550"
"chr1","95866694","95866920","chr14","34026704","34026939","46","61839990"
"chr1","95936285","95936496","chr3","124560761","124560955","60","28624476"
"chr1","95958125","95958420","chr9","54883093","54883389","43","41075032"
"chr1","96007226","96007518","chr9","54830344","54830635","26","41176882"
"chr1","96032982","96033259","chr9","54796232","54796556","65","41236750"
"chr1","96360043","96360314","chr9","54437037","54437332","52","41923006"
"chr1","96475659","96475745","chr5","56160597","56160680","21","40315062"
"chr1","96479641","96479911","chr1","207780432","207780714","59","111300791"
"chr1","96514643","96514907","chr9","54299805","54300055","36","42214838"
"chr1","96518919","96519073","chr20","34414083","34414223","37","62104836"
"chr1","96747897","96748101","chr1","189712782","189712986","47","92964885"
"chr1","96922396","96922667","chr18","44347065","44347337","63","52575331"
"chr1","96956519","96956648","chr13","6354236","6354359","27","90602283"
"chr1","97008572","97008861","chr12","37420169","37420466","62","59588403"
"chr1","97134789","97135044","chr9","53687266","53687557","57","43447523"
"chr1","97186956","97187086","chr10","112111608","112111739","17","14924652"
"chr1","97211240","97211388","chr9","53612232","53612367","33","43599008"
"chr1","97255946","97256040","chr8","127464219","127464309","24","30208273"
"chr1","97258025","97258180","chr10","29754500","29754651","41","67503525"
"chr1","97258521","97258620","chr2B","16261383","16261481","18","80997138"
"chr1","97260697","97261000","chr9","53555161","53555442","59","43705536"
"chr1","97268763","97269021","chr9","53548306","53548572","38","43720457"
"chr1","97270320","97270605","chr9","53546710","53546998","39","43723610"
"chr1","97281566","97281783","chrX","120473041","120473260","50","23191475"
"chr1","97335996","97336288","chr9","53478230","53478530","41","43857766"
"chr1","97353874","97354155","chr9","53459023","53459310","37","43894851"
"chr1","97355624","97355921","chr9","53457395","53457696","42","43898229"
"chr1","97381360","97381666","chr9","53429978","53430282","34","43951382"
"chr1","97408681","97408975","chr9","53403049","53403351","46","44005632"
"chr1","97459771","97460083","chr3","119316065","119316367","62","21856294"
"chr1","97475111","97475407","chr5","4086513","4086809","73","93388598"
"chr1","97482665","97482828","chr9","53355007","53355174","21","44127658"
"chr1","97504130","97504418","chr9","53315513","53315790","47","44188617"
"chr1","97587208","97587478","chr1","185329634","185329914","67","87742426"
"chr1","97777481","97777593","chr9","53059801","53059915","21","44717680"
"chr1","97802882","97803022","chr12","108006205","108006353","45","10203323"
"chr1","97840397","97840694","chr12","30031492","30031777","74","67808905"
"chr1","97895464","97895750","chr10","108040748","108041024","59","10145284"
"chr1","98047333","98047606","chr9","52644775","52645076","59","45402558"
"chr1","98072368","98072668","chr9","52600992","52601281","38","45471376"
"chr1","98106929","98107190","chr9","52571097","52571378","65","45535832"
"chr1","98168390","98168665","chr9","52520244","52520522","42","45648146"
"chr1","98309066","98309140","chr9","52385430","52385511","8","45923636"
"chr1","98369943","98370218","chr7","138128976","138129243","68","39759033"
"chr1","98446465","98446756","chr9","52253700","52253991","60","46192765"
"chr1","98468549","98468809","chr9","75227699","75227977","64","23240850"
"chr1","98558838","98559120","chr2A","99034429","99034720","60","475591"
"chr1","98579074","98579373","chr21","30780520","30780822","64","67798554"
"chr1","98580771","98581074","chr9","52132717","52133016","43","46448054"
"chr1","98592264","98592521","chr9","52122599","52122880","56","46469665"
"chr1","98608457","98608585","chr9","52106737","52106857","20","46501720"
"chr1","98637953","98638230","chr3","176232001","176232264","75","77594048"
"chr1","98663875","98663957","chr19","56642109","56642191","11","42021766"
"chr1","98670569","98670674","chr11","49142293","49142400","19","49528276"
"chr1","98702943","98703239","chr9","52019218","52019510","42","46683725"
"chr1","98705458","98705736","chr4","197330561","197330854","55","98625103"
"chr1","98707722","98707844","chr9","52015066","52015188","8","46692656"
"chr1","98724711","98724969","chr9","51998555","51998812","27","46726156"
"chr1","98793239","98793539","chr9","51937276","51937568","34","46855963"
"chr1","98804713","98804984","chr9","51919968","51920251","48","46884745"
"chr1","98951298","98951582","chr9","51773850","51774131","36","47177448"
"chr1","99155086","99155364","chr1","19603881","19604162","57","79551205"
"chr1","99210764","99211057","chr9","51560379","51560674","45","47650385"
"chr1","99219651","99219849","chr12","92631767","92631957","66","6587884"
"chr1","99241569","99241866","chr9","51523809","51524097","36","47717760"
"chr1","99343181","99343460","chr9","51404448","51404753","59","47938733"
"chr1","99477059","99477236","chr7","45537514","45537680","40","53939545"
"chr1","99622829","99623129","chr9","51161492","51161803","41","48461337"
"chr1","99772396","99772660","chr1","22966072","22966323","73","76806324"
"chr1","99838490","99838781","chr9","50876607","50876901","40","48961883"
"chr1","99866200","99866494","chr9","50683466","50683770","37","49182734"
"chr1","99868444","99868576","chr9","50685674","50685807","5","49182770"
"chr1","99874308","99874422","chr13","10343678","10343792","27","89530630"
"chr1","99881957","99882097","chrX","71151088","71151230","36","28730869"
"chr1","99906328","99906392","chr3","126872406","126872470","17","26966078"
"chr1","99906546","99906656","chr19","39737280","39737393","19","60169266"
"chr1","99911895","99912178","chr20","45856042","45856327","55","54055853"
"chr1","99915804","99915956","chr3","51015997","51016148","34","48899807"
"chr1","99918076","99918155","chr6","36015376","36015456","21","63902700"
"chr1","99927846","99927978","chr9","95327897","95328021","23","4599949"
"chr1","99932775","99932947","chr5","156830395","156830571","40","56897620"
"chr1","99942220","99942541","chr9","50741723","50742042","41","49200497"
"chr1","99944972","99945264","chr5","50922614","50922901","59","49022358"
"chr1","99991371","99991501","chr9","50783372","50783496","17","49207999"
"chr1","99991702","99991873","chr19","2165168","2165341","31","97826534"
"chr1","100023369","100023645","chr4","198512577","198512855","65","98489208"
"chr1","100035552","100035820","chr9","50827767","50828040","44","49207785"
"chr1","100042360","100042627","chr9","50834441","50834706","46","49207919"
"chr1","100132281","100132602","chr8","45480198","45480509","57","54652083"
"chr1","100151110","100151346","chr4","121409588","121409818","56","21258478"
"chr1","100166094","100166348","chr5","107028476","107028728","55","6862382"
"chr1","100352125","100352422","chr9","50439025","50439317","38","49913100"
"chr1","100368023","100368192","chr7","76280107","76280268","38","24087916"
"chr1","100510905","100511190","chr9","50306525","50306812","75","50204380"
"chr1","100570491","100570748","chr14","33521216","33521465","65","67049275"
"chr1","100614167","100614462","chr18","4310093","4310394","60","96304074"
"chr1","100680405","100680711","chr9","73677715","73677997","47","27002690"
"chr1","100758183","100758470","chr9","73751747","73752053","66","27006436"
"chr1","100782533","100782802","chr9","73777661","73777927","30","27004872"
"chr1","100786647","100786959","chr9","73784014","73784324","51","27002633"
"chr1","100793154","100793443","chr9","73790737","73791025","39","27002417"
"chr1","100855209","100855507","chr9","73841915","73842213","42","27013294"
"chr1","100873679","100873976","chr9","73859048","73859345","34","27014631"
"chr1","100936376","100936645","chr9","73944041","73944304","34","26992335"
"chr1","100941721","100942007","chr13","3400330","3400626","58","97541391"
"chr1","101006679","101006969","chr9","74081687","74081982","44","26924992"
"chr1","101108982","101109104","chr9","68364091","68364212","10","32744891"
"chr1","101270678","101270954","chr9","68146118","68146416","49","33124560"
"chr1","101408493","101408709","chr3","101529162","101529367","44","120669"
"chr1","101517600","101517874","chr9","1611","1905","52","101515989"
"chr1","101531506","101531820","chr2A","97057312","97057598","78","4474194"
"chr1","101597463","101597760","chr9","49977672","49977978","52","51619791"
"chr1","101625315","101625437","chr4","202926705","202926829","13","101301390"
"chr1","101627890","101628008","chr4","202926705","202926829","22","101298815"
"chr1","101691693","101691862","chrX","119707772","119707943","47","18016079"
"chr1","101722466","101722735","chr9","1611","1905","52","101720855"
"chr1","101761444","101761660","chr12","107074085","107074296","44","5312641"
"chr1","101875815","101876107","chr9","49819653","49819937","46","52056162"
"chr1","101910507","101910818","chr9","49788713","49789016","47","52121794"
"chr1","101940829","101941137","chr9","49760875","49761208","56","52179954"
"chr1","101947216","101947314","chr2A","82688839","82688937","16","19258377"
"chr1","101954682","101954953","chr9","49746666","49746947","43","52208016"
"chr1","101965712","101966011","chr9","49735366","49735670","45","52230346"
"chr1","101981322","101981602","chr9","49717312","49717578","36","52264010"
"chr1","102005109","102005408","chr9","49703027","49703332","31","52302082"
"chr1","102087678","102087829","chr7","70035241","70035395","31","32052437"
"chr1","102088550","102088667","chr8","19325971","19326085","22","82762579"
"chr1","102121703","102121824","chr3","158353785","158353905","29","56232082"
"chr1","102152368","102152664","chr9","49555598","49555913","57","52596770"
"chr1","102168619","102168731","chr13","80804811","80804929","18","21363808"
"chr1","102171306","102171597","chr9","49534382","49534667","51","52636924"
"chr1","102190119","102190279","chr4","190209315","190209476","34","88019196"
"chr1","102192487","102192780","chr9","49513090","49513375","50","52679397"
"chr1","102229508","102229804","chr9","49468880","49469187","43","52760628"
"chr1","102249941","102250242","chr9","49449732","49450000","67","52800209"
"chr1","102266350","102266627","chr9","49430975","49431257","27","52835375"
"chr1","102282554","102282677","chr2B","121431366","121431483","21","19148812"
"chr1","102316707","102316980","chr3","124853187","124853457","60","22536480"
"chr1","102334102","102334207","chr11","119240910","119241012","22","16906808"
"chr1","102334770","102334819","chr9","47034334","47034381","13","55300436"
"chr1","102339957","102340256","chr9","49350402","49350717","57","52989555"
"chr1","102350113","102350321","chr9","49339194","49339396","28","53010919"
"chr1","102351487","102351621","chr7","77000001","77000126","41","25351486"
"chr1","102352403","102352527","chr10","39312861","39312978","32","63039542"
"chr1","102355817","102355967","chr7","18238538","18238683","45","84117279"
"chr1","102393486","102393689","chr9","49296886","49297088","25","53096600"
"chr1","102417007","102417273","chr9","49266080","49266370","52","53150927"
"chr1","102439405","102439690","chr9","49243835","49244121","38","53195570"
"chr1","102450989","102451270","chr9","49232504","49232813","47","53218485"
"chr1","102453064","102453345","chr10","107643936","107644216","64","5190872"
"chr1","102454328","102454439","chr8","85681193","85681293","36","16773135"
"chr1","102465809","102466145","chr9","49216688","49216976","85","53249121"
"chr1","102468124","102468421","chr16","21804986","21805284","58","80663138"
"chr1","102483455","102483753","chr9","49197360","49197653","42","53286095"
"chr1","102485452","102485667","chr19","35388522","35388736","48","67096930"
"chr1","102502650","102502946","chr9","49176614","49176912","38","53326036"
"chr1","102529059","102529354","chr9","49152569","49152876","42","53376490"
"chr1","102537932","102538229","chr9","49145143","49145433","52","53392789"
"chr1","102636976","102637247","chr9","49042543","49042842","58","53594433"
"chr1","102705541","102705745","chr9","48981970","48982181","32","53723571"
"chr1","102760488","102760763","chr9","48935088","48935365","29","53825400"
"chr1","102770839","102771139","chr9","48924450","48924744","40","53846389"
"chr1","102777731","102777896","chr1","23730717","23730881","40","79047014"
"chr1","102778111","102778242","chr15","57026888","57027018","18","45751223"
"chr1","102864178","102864305","chr9","48837906","48838033","15","54026272"
"chr1","102872402","102872661","chr9","48830155","48830424","47","54042247"
"chr1","102926545","102926805","chr9","48779738","48780011","56","54146807"
"chr1","103024577","103024914","chr9","48691842","48692156","75","54332735"
"chr1","103090083","103090368","chr9","48608017","48608316","43","54482066"
"chr1","103145747","103145873","chr19","11238460","11238588","26","91907287"
"chr1","103422386","103422516","chr2B","64192205","64192335","21","39230181"
"chr1","103422517","103422799","chrX","45067707","45067988","56","58354810"
"chr1","103582284","103582550","chr9","48108495","48108760","36","55473789"
"chr1","103699292","103699413","chr2B","92011026","92011147","17","11688266"
"chr1","103699426","103699706","chr2B","123929689","123929965","71","20230263"
"chr1","103805812","103806085","chr9","47900355","47900641","56","55905457"
"chr1","103828250","103828551","chr9","47880403","47880701","40","55947847"
"chr1","103870080","103870340","chr6","139164603","139164864","63","35294523"
"chr1","103888440","103888727","chr9","47829253","47829550","52","56059187"
"chr1","103932646","103932937","chr9","47799122","47799434","54","56133524"
"chr1","103954816","103954985","chr18","17909261","17909438","37","86045555"
"chr1","104045649","104045828","chr12","33079914","33080093","33","70965735"
"chr1","104154678","104154944","chr9","47563482","47563750","30","56591196"
"chr1","104155279","104155402","chr9","47563361","47563478","16","56591918"
"chr1","104306311","104306555","chr9","47419309","47419573","46","56887002"
"chr1","104389486","104389585","chr7","106936739","106936838","16","2547253"
"chr1","104391921","104392234","chr9","47339752","47340046","45","57052169"
"chr1","104420597","104420739","chr6","29534296","29534444","33","74886301"
"chr1","104469148","104469429","chr9","47263492","47263760","39","57205656"
"chr1","104538430","104538720","chr9","47183894","47184186","52","57354536"
"chr1","104546254","104546552","chr9","47176741","47177039","49","57369513"
"chr1","104552645","104552945","chr12","113782188","113782483","77","9229543"
"chr1","104560244","104560367","chr9","47162384","47162516","19","57397860"
"chr1","104566168","104566461","chr9","47156380","47156671","69","57409788"
"chr1","104582209","104582495","chr7","129054394","129054678","57","24472185"
"chr1","104601354","104601630","chr9","47121753","47122027","34","57479601"
"chr1","104619183","104619468","chr9","47100865","47101151","44","57518318"
"chr1","104668657","104668773","chr9","47055867","47055983","11","57612790"
"chr1","104710133","104710421","chr16","25421955","25422246","58","79288178"
"chr1","104778623","104778923","chr8","74425114","74425416","77","30353509"
"chr1","104911328","104911642","chr9","46872636","46872943","52","58038692"
"chr1","104995854","104996121","chr9","46768269","46768550","65","58227585"
"chr1","105100533","105100604","chr8","103872292","103872360","18","1228241"
"chr1","105126641","105126768","chr3","32169861","32169991","31","72956780"
"chr1","105127656","105127725","chr4","64471779","64471849","10","40655877"
"chr1","105200217","105200479","chr9","46564656","46564920","36","58635561"
"chr1","105221644","105221916","chr12","7772256","7772521","65","97449388"
"chr1","105230877","105231191","chr9","87686246","87686548","76","17544631"
"chr1","105263959","105264236","chr9","46485148","46485435","56","58778811"
"chr1","105315017","105315296","chr9","46406558","46406852","45","58908459"
"chr1","105317054","105317168","chr18","48326419","48326520","32","56990635"
"chr1","105408763","105408936","chr5","38089240","38089416","44","67319523"
"chr1","105424935","105425096","chr1","69180790","69180952","37","36244145"
"chr1","105689876","105690162","chrX","115576015","115576293","71","9886139"
"chr1","105830704","105830995","chr9","45909651","45909920","62","59921053"
"chr1","105831443","105831768","chr9","45908068","45908385","54","59923375"
"chr1","105977869","105978031","chr11","128247655","128247811","37","22269786"
"chr1","105979032","105979330","chr9","45767093","45767409","48","60211939"
"chr1","106029742","106030048","chr9","45716514","45716790","56","60313228"
"chr1","106202959","106203198","chrX","132585466","132585704","56","26382507"
"chr1","106204595","106204898","chr9","45544831","45545125","47","60659764"
"chr1","106222702","106222915","chr19","50710233","50710443","45","55512469"
"chr1","106243518","106243819","chr9","45509030","45509320","44","60734488"
"chr1","106291589","106291843","chr9","45451996","45452276","50","60839593"
"chr1","106311302","106311431","chr14","407636","407757","36","105903666"
"chr1","106327039","106327340","chr9","45396850","45397147","43","60930189"
"chr1","106327520","106327788","chrX","47367099","47367362","59","58960421"
"chr1","106338091","106338204","chr8","108964883","108965000","19","2626792"
"chr1","106347117","106347240","chr9","45379946","45380069","12","60967171"
"chr1","106363734","106363816","chr3","38428197","38428280","12","67935537"
"chr1","106391974","106392293","chr9","45325612","45325926","43","61066362"
"chr1","106410346","106410604","chr9","79411730","79411979","66","26998616"
"chr1","106423691","106423983","chr9","45291748","45292044","36","61131943"
"chr1","106429683","106429955","chr16","20718102","20718381","73","85711581"
"chr1","106453821","106454125","chr9","45261047","45261347","40","61192774"
"chr1","106464398","106464686","chr6","54208282","54208568","57","52256116"
"chr1","106475837","106476130","chr9","45230575","45230864","35","61245262"
"chr1","106491205","106491460","chr9","45213269","45213524","31","61277936"
"chr1","106504860","106504984","chr17","7830688","7830812","15","98674172"
"chr1","106507054","106507337","chr1","53359418","53359690","87","53147636"
"chr1","106509397","106509693","chr2A","32224699","32224992","81","74284698"
"chr1","106531235","106531383","chr7","64978792","64978960","32","41552443"
"chr1","106536385","106536657","chr7","64975179","64975466","65","41561206"
"chr1","106542748","106543031","chr16","44050487","44050771","71","62492261"
"chr1","106567367","106567555","chr5","74098231","74098420","51","32469136"
"chr1","106569911","106570041","chr10","31707646","31707778","26","74862265"
"chr1","106588729","106588844","chr18","8665328","8665444","23","97923401"
"chr1","106599357","106599565","chr9","45144063","45144269","36","61455294"
"chr1","106635329","106635369","chr11","13602606","13602649","4","93032723"
"chr1","106637782","106638082","chr9","45105320","45105632","54","61532462"
"chr1","106642161","106642341","chr19","2071335","2071516","36","104570826"
"chr1","106661472","106661618","chr21","24720942","24721101","37","81940530"
"chr1","106679365","106679649","chr9","45061210","45061518","54","61618155"
"chr1","106687853","106687948","chr9","45046711","45046803","10","61641142"
"chr1","106688344","106688650","chr9","45046049","45046355","54","61642295"
"chr1","106699438","106699725","chr9","76576351","76576638","69","30123087"
"chr1","106795032","106795308","chr6","25903846","25904123","65","80891186"
"chr1","106902639","106902913","chr9","44807961","44808228","41","62094678"
"chr1","107166544","107166826","chr9","44511700","44512008","61","62654844"
"chr1","107188882","107189008","chr7","64929838","64929961","24","42259044"
"chr1","107295012","107295319","chr9","44374746","44375036","59","62920266"
"chr1","107306681","107306848","chr8","145248990","145249154","27","37942309"
"chr1","107361915","107362032","chr10","85791325","85791447","21","21570590"
"chr1","107497118","107497406","chr9","44172321","44172618","34","63324797"
"chr1","107522751","107523040","chr5","23931488","23931783","72","83591263"
"chr1","107574335","107574552","chr11","69078087","69078316","53","38496248"
"chr1","107594812","107595084","chr1","45995615","45995872","64","61599197"
"chr1","107595523","107595602","chr16","12429378","12429458","15","95166145"
"chr1","107599422","107599714","chr9","44071691","44071999","45","63527731"
"chr1","107604948","107605261","chr9","44066789","44067098","34","63538159"
"chr1","107607143","107607266","chr7","84986442","84986563","21","22620701"
"chr1","107623571","107623776","chr4","1869667","1869859","43","105753904"
"chr1","107781126","107781279","chr8","56795337","56795503","34","50985789"
"chr1","107792114","107792398","chr9","43862288","43862579","35","63929826"
"chr1","107873178","107873472","chr9","43747146","43747442","62","64126032"
"chr1","107879873","107880106","chr3","20362997","20363230","54","87516876"
"chr1","107919530","107919809","chr9","43695933","43696217","47","64223597"
"chr1","107945920","107946239","chr9","43668116","43668418","64","64277804"
"chr1","107969561","107969810","chr12","122427040","122427297","70","14457479"
"chr1","107994385","107994694","chr9","43570581","43570903","39","64423804"
"chr1","108002006","108002290","chr18","28984661","28984932","76","79017345"
"chr1","108073397","108073669","chr9","43481603","43481876","39","64591794"
"chr1","108094889","108095161","chr9","43449734","43450030","70","64645155"
"chr1","108117882","108117990","chr18","48326419","48326520","34","59791463"
"chr1","108167429","108167537","chr7","72885461","72885558","26","35281968"
"chr1","108184481","108184785","chr14","79776557","79776845","65","28407924"
"chr1","108184923","108185120","chr19","9419595","9419809","57","98765328"
"chr1","108201725","108201987","chr9","43360916","43361188","51","64840809"
"chr1","108238003","108238201","chr16","21442396","21442597","54","86795607"
"chr1","108244055","108244161","chr1","184214169","184214281","27","75970114"
"chr1","108263598","108263716","chr9","43310383","43310501","11","64953215"
"chr1","108280467","108280598","chr19","2892959","2893081","34","105387508"
"chr1","108300030","108300304","chr2A","52745124","52745398","63","55554906"
"chr1","108309715","108310011","chr3","199581084","199581377","63","91271369"
"chr1","108320884","108321011","chr21","32443205","32443329","17","75877679"
"chr1","108321539","108321657","chr1","61407572","61407685","26","46913967"
"chr1","108327339","108327468","chr12","29897183","29897312","17","78430156"
"chr1","108378636","108378679","chr4","133498856","133498897","9","25120220"
"chr1","108390652","108390763","chr1","222234165","222234280","22","113843513"
"chr1","108424112","108424279","chr10","49585047","49585201","43","58839065"
"chr1","108491394","108491718","chr9","43059615","43059918","62","65431779"
"chr1","108498751","108499019","chr9","43053670","43053954","49","65445081"
"chr1","108556180","108556350","chr9","42992043","42992237","46","65564137"
"chr1","108573555","108573656","chr2A","10266630","10266736","26","98306925"
"chr1","108592196","108592464","chr9","42955152","42955443","61","65637044"
"chr1","108616076","108616196","chr15","37783011","37783134","21","70833065"
"chr1","108622112","108622226","chr3","187504297","187504409","28","78882185"
"chr1","108632163","108632259","chr7","101404390","101404484","14","7227773"
"chr1","108661392","108661662","chr9","42886265","42886535","36","65775127"
"chr1","108710126","108710250","chr7","77000001","77000126","35","31710125"
"chr1","108717461","108717611","chr20","13392558","13392708","38","95324903"
"chr1","108804782","108805059","chr9","42747698","42747971","71","66057084"
"chr1","108816964","108817216","chr19","8835301","8835534","71","99981663"
"chr1","108860120","108860204","chr10","142430183","142430266","17","33570063"
"chr1","108869222","108869498","chr1","48678196","48678468","72","60191026"
"chr1","108892728","108893029","chr14","10568757","10569063","74","98323971"
"chr1","108983571","108983791","chr9","42547921","42548141","25","66435650"
"chr1","109482663","109482926","chr9","42082518","42082798","47","67400145"
"chr1","109594836","109595119","chr1","185926758","185927043","58","76331922"
"chr1","109680713","109680884","chr9","41896796","41896941","44","67783917"
"chr1","109706064","109706377","chr9","41866031","41866332","62","67840033"
"chr1","109885923","109886217","chr9","41697778","41698079","29","68188145"
"chr1","109906034","109906130","chr1","17798378","17798465","28","92107656"
"chr1","110001248","110001399","chr3","40933011","40933169","41","69068237"
"chr1","110086820","110087113","chr9","41449377","41449667","37","68637443"
"chr1","110113734","110113991","chr9","41426148","41426409","39","68687586"
"chr1","110209313","110209606","chr9","41335319","41335621","51","68873994"
"chr1","110324140","110324450","chr9","41223408","41223726","53","69100732"
"chr1","110355951","110356249","chr8","74733114","74733411","58","35622837"
"chr1","110437000","110437158","chr9","41118205","41118377","33","69318795"
"chr1","110437432","110437538","chr8","21346151","21346257","18","89091281"
"chr1","110484754","110485047","chr4","117644182","117644473","61","7159428"
"chr1","110502321","110502621","chr9","41053870","41054157","74","69448451"
"chr1","110511351","110511472","chr6","154239364","154239482","31","43728013"
"chr1","110551532","110551846","chr9","113152170","113152487","75","2600638"
"chr1","110562509","110562800","chr9","41000780","41001062","68","69561729"
"chr1","110593155","110593452","chr9","40970972","40971288","49","69622183"
"chr1","110778705","110778903","chr9","40781626","40781829","28","69997079"
"chr1","110801562","110801649","chr9","40755417","40755504","12","70046145"
"chr1","110967945","110968205","chr9","40566483","40566754","48","70401462"
"chr1","111062448","111062745","chr22","7218508","7218804","59","103843940"
"chr1","111142406","111142676","chr9","40397460","40397745","114","70744946"
"chr1","111364659","111364958","chr12","43802996","43803296","70","67561663"
"chr1","111487712","111488000","chr10","25221654","25221935","52","86266058"
"chr1","111651356","111651646","chr9","39912503","39912806","44","71738853"
"chr1","111754423","111754640","chr17","7785586","7785814","67","103968837"
"chr1","112005179","112005457","chr9","39592351","39592640","58","72412828"
"chr1","112007875","112008132","chr9","39589509","39589754","41","72418366"
"chr1","112127264","112127373","chr9","39466520","39466632","14","72660744"
"chr1","112474943","112475229","chr9","39147177","39147460","47","73327766"
"chr1","112510659","112510929","chr9","39108228","39108492","52","73402431"
"chr1","112552479","112552712","chr6","44546586","44546829","58","68005893"
"chr1","112821777","112821902","chr9","47091358","47091484","37","65730419"
"chr1","113087155","113087329","chr17","18297789","18297962","48","94789366"
"chr1","113163929","113164009","chr4","25152829","25152907","13","88011100"
"chr1","113776260","113776559","chr7","126403895","126404200","86","12627635"
"chr1","113836251","113836363","chr8","19325971","19326085","19","94510280"
"chr1","114319365","114319494","chr3","50861258","50861390","23","63458107"
"chr1","114420849","114420998","chr3","9832740","9832889","34","104588109"
"chr1","114495062","114495350","chr10","110363193","110363481","67","4131869"
"chr1","114527885","114528183","chr9","37136372","37136673","52","77391513"
"chr1","114605189","114605294","chr11","67337030","67337134","20","47268159"
"chr1","114621828","114622060","chr9","37021947","37022163","54","77599881"
"chr1","114792753","114792959","chr9","36838520","36838730","26","77954233"
"chr1","115039896","115040184","chr9","36593502","36593792","27","78446394"
"chr1","115075567","115075870","chrX","3107828","3108119","67","111967739"
"chr1","115122122","115122436","chr1","227415933","227416230","79","112293811"
"chr1","115132164","115132361","chr9","36504101","36504308","36","78628063"
"chr1","115132411","115132705","chr9","36503752","36504051","38","78628659"
"chr1","115160295","115160597","chr9","36469552","36469852","35","78690743"
"chr1","115217697","115217981","chr9","36408737","36409024","34","78808960"
"chr1","115437825","115437949","chr9","36190794","36190918","13","79247031"
"chr1","115451913","115452172","chr9","36166880","36167127","42","79285033"
"chr1","115780598","115780860","chr12","125129033","125129295","54","9348435"
"chr1","115847447","115847730","chr5","38594739","38595018","68","77252708"
"chr1","115926342","115926546","chr7","1628669","1628874","45","114297673"
"chr1","115955293","115955552","chr9","35661837","35662115","52","80293456"
"chr1","115970701","115971006","chr3","122127376","122127674","69","6156675"
"chr1","115994948","115995218","chr9","35624013","35624293","36","80370935"
"chr1","116084665","116084897","chr19","11048502","11048729","55","105036163"
"chr1","116192892","116193185","chr9","35434378","35434686","53","80758514"
"chr1","116207076","116207357","chr9","35419828","35420104","45","80787248"
"chr1","116316735","116317007","chr9","35308548","35308831","46","81008187"
"chr1","116451329","116451633","chr1","53187433","53187717","76","63263896"
"chr1","116545868","116545968","chr12","82028007","82028106","25","34517861"
"chr1","116618630","116618878","chr9","34981742","34981989","40","81636888"
"chr1","116677045","116677166","chr17","25153179","25153301","16","91523866"
"chr1","116695800","116696090","chr9","34895300","34895593","49","81800500"
"chr1","116771477","116771739","chr9","34765779","34766060","51","82005698"
"chr1","116928045","116928221","chr16","42141805","42141981","49","74786240"
"chr1","116977735","116977963","chr16","11950876","11951125","65","105026859"
"chr1","117001871","117002043","chr7","106533466","106533634","32","10468405"
"chr1","117027915","117028177","chr5","489229","489478","69","116538686"
"chr1","117054334","117054653","chrX","13428640","13428953","68","103625694"
"chr1","117121153","117121363","chr9","34466887","34467072","42","82654266"
"chr1","117138563","117138863","chr1","183446128","183446434","70","66307565"
"chr1","117150432","117150750","chr3","2807718","2808023","65","114342714"
"chr1","117155299","117155470","chr16","58603366","58603536","31","58551933"
"chr1","117170324","117170623","chr9","34428715","34429004","35","82741609"
"chr1","117210996","117211292","chr7","76146308","76146602","62","41064688"
"chr1","117212062","117212353","chr9","34401975","34402275","50","82810087"
"chr1","117228401","117228611","chr9","34390022","34390248","43","82838379"
"chr1","117234464","117234738","chr19","12751754","12752021","58","104482710"
"chr1","117242962","117243249","chr9","34371441","34371731","18","82871521"
"chr1","117267408","117267503","chr15","37513750","37513848","19","79753658"
"chr1","117296534","117296837","chr9","34341828","34342132","42","82954706"
"chr1","117321331","117321609","chr9","34327321","34327603","34","82994010"
"chr1","117322752","117323045","chr15","64262336","64262638","66","53060416"
"chr1","117332264","117332558","chr9","34311939","34312237","29","83020325"
"chr1","117333606","117333683","chr12","93389419","93389505","20","23944187"
"chr1","117362453","117362579","chr3","116447673","116447800","34","914780"
"chr1","117379590","117379838","chr1","33558914","33559153","62","83820676"
"chr1","117393445","117393777","chr3","54573795","54574116","76","62819650"
"chr1","117400176","117400346","chr10","47374570","47374731","53","70025606"
"chr1","117418826","117419125","chr16","28305610","28305910","67","89113216"
"chr1","117421818","117422024","chr8","100864437","100864645","39","16557381"
"chr1","117437431","117437563","chr2B","3877502","3877626","31","113559929"
"chr1","117445068","117445363","chr22","5280059","5280359","67","112165009"
"chr1","117465288","117465557","chr7","72469394","72469669","53","44995894"
"chr1","117475890","117476179","chr9","34189320","34189612","35","83286570"
"chr1","117492582","117492895","chr9","34178722","34179013","49","83313860"
"chr1","117533244","117533366","chr7","68201010","68201132","24","49332234"
"chr1","117543141","117543382","chr16","65550642","65550881","57","51992499"
"chr1","117544211","117544369","chr9","34097335","34097494","13","83446876"
"chr1","117551862","117552089","chr9","34093096","34093348","58","83458766"
"chr1","117574089","117574368","chr3","49741493","49741779","60","67832596"
"chr1","117619028","117619333","chr9","34017527","34017827","44","83601501"
"chr1","117765375","117765687","chr9","33892116","33892436","51","83873259"
"chr1","117849416","117849670","chr9","33815641","33815906","31","84033775"
"chr1","117973641","117973804","chr4","190209315","190209476","33","72235674"
"chr1","118048938","118049098","chr7","74190896","74191062","26","43858042"
"chr1","118053353","118053480","chr16","69212656","69212783","25","48840697"
"chr1","118058956","118059146","chr1","146118969","146119169","51","28060013"
"chr1","118101055","118101194","chr1","68709407","68709549","30","49391648"
"chr1","118424830","118425054","chr9","33233661","33233872","35","85191169"
"chr1","118449840","118450144","chr9","33208290","33208592","47","85241550"
"chr1","118499360","118499479","chr6","36093674","36093792","26","82405686"
"chr1","118499554","118499712","chr17","56750472","56750625","36","61749082"
"chr1","118550053","118550202","chr11","62991394","62991536","34","55558659"
"chr1","118638064","118638320","chr3","154758853","154759095","65","36120789"
"chr1","118732209","118732334","chr9","32928997","32929118","17","85803212"
"chr1","118765213","118765494","chr15","60763853","60764137","73","58001360"
"chr1","118799121","118799414","chr11","56908571","56908866","64","61890550"
"chr1","118910348","118910655","chr9","32749195","32749497","39","86161153"
"chr1","118925994","118926287","chr1","200312247","200312541","59","81386253"
"chr1","119024815","119025112","chr12","95059058","95059354","63","23965757"
"chr1","119212987","119213237","chr17","93968774","93969019","65","25244213"
"chr1","119294873","119295159","chr9","32356774","32357073","52","86938099"
"chr1","119344681","119344886","chr9","32306994","32307193","26","87037687"
"chr1","119354918","119355229","chr9","32293763","32294057","52","87061155"
"chr1","119517466","119517750","chr9","32143513","32143797","55","87373953"
"chr1","119543768","119543917","chr1","46271276","46271424","32","73272492"
"chr1","119545661","119545943","chr12","30031492","30031777","60","89514169"
"chr1","119560050","119560286","chr7","73544309","73544553","59","46015741"
"chr1","119732287","119732561","chr9","31912059","31912335","61","87820228"
"chr1","119792085","119792371","chr9","31851623","31851915","41","87940462"
"chr1","119845553","119845752","chr11","64538800","64538996","44","55306753"
"chr1","119879778","119879891","chr2A","63435618","63435731","17","56444160"
"chr1","119906582","119906883","chr9","31746571","31746858","48","88160011"
"chr1","119946090","119946298","chr1","45115114","45115306","80","74830976"
"chr1","120057943","120058080","chr14","52842638","52842775","31","67215305"
"chr1","120160438","120160566","chr7","86126018","86126142","30","34034420"
"chr1","120239244","120239458","chr9","31412956","31413150","51","88826288"
"chr1","120239934","120240043","chr9","31412227","31412339","12","88827707"
"chr1","120284633","120284693","chr1","26659980","26660038","12","93624653"
"chr1","120293032","120293138","chr4","6007123","6007231","22","114285909"
"chr1","120294313","120294405","chr9","31341189","31341281","10","88953124"
"chr1","120368395","120368694","chr9","31242283","31242582","38","89126112"
"chr1","120371147","120371431","chr9","31239532","31239833","48","89131615"
"chr1","120400316","120400618","chr9","31210544","31210842","52","89189772"
"chr1","120447105","120447395","chr2A","42328182","42328485","60","78118923"
"chr1","120614154","120614439","chr11","64047067","64047357","65","56567087"
"chr1","120627387","120627711","chr9","30969771","30970091","57","89657616"
"chr1","120735907","120736140","chr9","30871746","30871996","45","89864161"
"chr1","120904356","120904577","chr9","30718691","30718893","42","90185665"
"chr1","120977437","120977562","chr9","30650236","30650373","23","90327201"
"chr1","120977864","120977893","chr16","4918139","4918164","7","116059725"
"chr1","120977967","120978081","chr3","25953481","25953598","23","95024486"
"chr1","121054289","121054395","chr9","56650849","56650964","17","64403440"
"chr1","121058582","121058884","chr9","56646310","56646617","43","64412272"
"chr1","121077935","121078236","chr9","30278100","30278408","65","90799835"
"chr1","121082499","121082585","chrX","47268046","47268133","17","73814453"
"chr1","121130204","121130442","chrX","39568727","39568951","66","81561477"
"chr1","121167870","121168171","chr9","30278100","30278408","72","90889770"
"chr1","121192446","121192696","chr6","150466535","150466786","55","29274089"
"chr1","121204387","121204600","chr9","30314201","30314429","45","90890186"
"chr1","121224440","121224730","chr15","59014237","59014527","61","62210203"
"chr1","121224838","121225151","chr9","30334416","30334712","50","90890422"
"chr1","121233923","121234039","chr22","14821499","14821616","14","106412424"
"chr1","121251950","121252050","chr9","30363368","30363466","20","90888582"
"chr1","121282396","121282562","chr22","34031915","34032078","39","87250481"
"chr1","121292393","121292703","chr9","30394812","30395111","55","90897581"
"chr1","121299271","121299544","chr9","30401211","30401465","38","90898060"
"chr1","121303540","121303700","chr5","2409784","2409944","44","118893756"
"chr1","121306625","121306740","chr9","30406518","30406635","16","90900107"
"chr1","121353314","121353383","chr7","139801348","139801412","18","18448034"
"chr1","121361175","121361340","chr6","58479882","58480048","39","62881293"
"chr1","121373620","121373779","chr5","20163803","20163972","43","101209817"
"chr1","121377979","121378112","chr7","77000001","77000126","34","44377978"
"chr1","121381084","121381246","chr21","24720942","24721101","42","96660142"
"chr1","121383472","121383598","chr19","38753694","38753826","22","82629778"
"chr1","121431079","121431416","chrX","136968693","136969014","91","15537614"
"chr1","121453885","121453976","chr9","30549689","30549780","12","90904196"
"chr1","121459238","121459510","chr9","30555122","30555389","46","90904116"
"chr1","121460975","121461259","chr9","30556894","30557163","47","90904081"
"chr1","121471167","121471280","chrX","151208603","151208709","26","29737436"
"chr1","121472791","121473071","chrX","16470304","16470598","63","105002487"
"chr1","121475361","121475641","chr14","38464803","38465083","69","83010558"
"chr1","121478273","121478387","chrX","151208603","151208709","29","29730330"
"chr1","121480634","121480914","chr16","58177781","58178050","62","63302853"
"chr1","121483375","121483637","chr6","108822625","108822885","65","12660750"
"chr1","121491500","121491801","chr9","30580151","30580455","40","90911349"
"chr1","121493076","121493148","chr9","30581750","30581822","8","90911326"
"chr1","121494261","121494544","chr3","131695355","131695636","63","10201094"
"chr1","121498747","121498855","chr9","30587421","30587529","10","90911326"
"chr1","121506724","121507007","chr3","23601459","23601740","61","97905265"
"chr1","121511281","121511389","chr9","30587421","30587529","11","90923860"
"chr1","121536500","121536799","chr1","204108132","204108414","81","82571632"
"chr1","121606862","121606974","chr7","72008463","72008589","27","49598399"
"chr1","121636063","121636351","chr9","30150782","30151060","42","91485281"
"chr1","121676877","121677179","chr9","30109991","30110292","55","91566886"
"chr1","121779430","121779642","chr9","30014964","30015189","41","91764466"
"chr1","121791889","121791998","chr16","48023200","48023306","26","73768689"
"chr1","122006202","122006404","chr20","21176538","21176727","55","100829664"
"chr1","122096240","122096380","chr2B","132342636","132342758","41","10246396"
"chr1","122100263","122100487","chr1","217294594","217294821","57","95194331"
"chr1","122119483","122119783","chr9","29604534","29604836","53","92514949"
"chr1","122195426","122195570","chr1","63752999","63753145","33","58442427"
"chr1","122228247","122228362","chr7","64738088","64738205","24","57490159"
"chr1","122228481","122228657","chr16","4337437","4337612","43","117891044"
"chr1","122304779","122305058","chr9","29409583","29409858","39","92895196"
"chr1","122307176","122307442","chr14","33523430","33523700","64","88783746"
"chr1","122360625","122360749","chr16","69212656","69212783","31","53147969"
"chr1","122420091","122420381","chr9","29295271","29295561","30","93124820"
"chr1","122442370","122442640","chr9","29271216","29271474","46","93171154"
"chr1","122471910","122472224","chr9","29240185","29240500","41","93231725"
"chr1","122481023","122481308","chrX","41989959","41990237","65","80491064"
"chr1","122487907","122488103","chr9","29224463","29224679","47","93263444"
"chr1","122615242","122615518","chr9","29090855","29091165","63","93524387"
"chr1","122664324","122664447","chr17","26242812","26242935","16","96421512"
"chr1","122673770","122673980","chr9","29029183","29029392","30","93644587"
"chr1","122698058","122698343","chr9","29015644","29015929","44","93682414"
"chr1","122710292","122710416","chrX","21754043","21754166","22","100956249"
"chr1","122726860","122726976","chr1","32298703","32298816","17","90428157"
"chr1","122727009","122727099","chr12","75687572","75687645","31","47039437"
"chr1","122727687","122727755","chr4","151163399","151163474","23","28435712"
"chr1","122727991","122728123","chrX","55211726","55211859","25","67516265"
"chr1","122737496","122737788","chr9","28974417","28974708","32","93763079"
"chr1","122745097","122745358","chr9","28966594","28966861","35","93778503"
"chr1","122748401","122748686","chr9","28962917","28963187","58","93785484"
"chr1","122768986","122769085","chr7","75095171","75095269","22","47673815"
"chr1","122860223","122860516","chr9","28847337","28847630","38","94012886"
"chr1","122972012","122972290","chr9","28725353","28725651","50","94246659"
"chr1","123090181","123090273","chr5","91851283","91851375","20","31238898"
"chr1","123150968","123151254","chr9","28565546","28565824","43","94585422"
"chr1","123224661","123224916","chr9","28519831","28520107","52","94704830"
"chr1","123246224","123246330","chr10","88544429","88544536","25","34701795"
"chr1","123299225","123299399","chr5","115483544","115483721","37","7815681"
"chr1","123408465","123408729","chr9","28159765","28160014","44","95248700"
"chr1","123486812","123487092","chr5","52985134","52985425","65","70501678"
"chr1","123523963","123524112","chr1","53190096","53190253","41","70333867"
"chr1","123574032","123574317","chr9","28009341","28009632","34","95564691"
"chr1","123694663","123694964","chr9","27895420","27895710","41","95799243"
"chr1","123741342","123741634","chr6","113132995","113133298","61","10608347"
"chr1","123987930","123988205","chr9","27604537","27604814","35","96383393"
"chr1","124070961","124071128","chr8","145835658","145835822","41","21764697"
"chr1","124428427","124428720","chr3","126400409","126400694","77","1971982"
"chr1","124460465","124460582","chrX","49113443","49113558","30","75347022"
"chr1","124626913","124627196","chr9","26777525","26777813","55","97849388"
"chr1","124673431","124673545","chr1","129719798","129719915","25","5046367"
"chr1","125011589","125011859","chr22","8311524","8311782","76","116700065"
"chr1","125233940","125234236","chr9","26201398","26201700","52","99032542"
"chr1","125321811","125322114","chr6","38348546","38348845","68","86973265"
"chr1","125420103","125420225","chr10","86956281","86956404","21","38463822"
"chr1","125572682","125572962","chr12","93141903","93142193","63","32430779"
"chr1","125583478","125583763","chr20","20585467","20585743","63","104998011"
"chr1","125651404","125651663","chr1","125664243","125664525","76","12839"
"chr1","125688098","125688382","chr9","25757760","25758059","57","99930338"
"chr1","125688494","125688815","chr7","102451990","102452277","105","23236504"
"chr1","125714706","125714851","chr10","91030263","91030393","39","34684443"
"chr1","125727319","125727447","chr19","41275833","41275962","39","84451486"
"chr1","125926804","125927090","chr9","25500480","25500782","39","100426324"
"chr1","125933957","125934243","chr9","25493031","25493333","63","100440926"
"chr1","125943438","125943714","chr9","25484793","25485074","52","100458645"
"chr1","126119682","126119980","chr9","25282120","25282411","43","100837562"
"chr1","126162475","126162763","chr4","41978078","41978359","72","84184397"
"chr1","126167139","126167229","chr12","88653459","88653551","19","37513680"
"chr1","126170641","126170902","chr2A","64651674","64651938","66","61518967"
"chr1","126208640","126208920","chr9","25189768","25190050","48","101018872"
"chr1","126310599","126310721","chr18","20916035","20916155","24","105394564"
"chr1","126431504","126431803","chr12","59183821","59184112","72","67247683"
"chr1","126681230","126681574","chr9","24603298","24603596","85","102077932"
"chr1","126882788","126883096","chr19","34817747","34818053","67","92065041"
"chr1","127031362","127031651","chr9","24311994","24312303","63","102719368"
"chr1","127119989","127120124","chrX","2794957","2795096","30","124325032"
"chr1","127484167","127484459","chr9","23890192","23890481","61","103593975"
"chr1","127553025","127553307","chr9","23830269","23830553","50","103722756"
"chr1","127558490","127558628","chr15","18620321","18620458","31","108938169"
"chr1","127741410","127741706","chr1","27341382","27341674","57","100400028"
"chr1","128095798","128095928","chr14","52842638","52842775","37","75253160"
"chr1","128403872","128404178","chr9","23049576","23049852","63","105354296"
"chr1","128718377","128718668","chr9","22785013","22785301","33","105933364"
"chr1","128731796","128732075","chr9","22772381","22772665","33","105959415"
"chr1","128748600","128748677","chr12","122719017","122719091","12","6029583"
"chr1","128832348","128832511","chr5","2493450","2493615","44","126338898"
"chr1","128868501","128868615","chr12","111176332","111176452","19","17692169"
"chr1","128934279","128934396","chr3","50531111","50531231","25","78403168"
"chr1","128949104","128949389","chr9","22591081","22591353","45","106358023"
"chr1","128958130","128958434","chr2A","13798192","13798490","68","115159938"
"chr1","128980715","128980789","chr2B","5742542","5742608","21","123238173"
"chr1","128981483","128981701","chr7","68387823","68388038","54","60593660"
"chr1","129004944","129005272","chr5","53825604","53825900","88","75179340"
"chr1","129084338","129084623","chr9","22480871","22481160","23","106603467"
"chr1","129132624","129132902","chr9","22431476","22431769","38","106701148"
"chr1","129142822","129143183","chr9","22420946","22421244","91","106721876"
"chr1","129146791","129147059","chr3","10434413","10434682","71","118712378"
"chr1","129203787","129204056","chr9","22340540","22340808","32","106863247"
"chr1","129309967","129310262","chr5","48822089","48822382","69","80487878"
"chr1","129368853","129369125","chr1","205414460","205414739","62","76045607"
"chr1","129436643","129436956","chr9","22108446","22108783","68","107328197"
"chr1","129626446","129626732","chr9","21914247","21914547","52","107712199"
"chr1","129934507","129934792","chr9","21625169","21625446","54","108309338"
"chr1","130064321","130064436","chr9","21508421","21508542","19","108555900"
"chr1","130745130","130745449","chr9","20823448","20823766","38","109921682"
"chr1","130846587","130846706","chrX","49113443","49113558","37","81733144"
"chr1","130864496","130864671","chr9","20714539","20714685","41","110149957"
"chr1","131417366","131417591","chr9","20172490","20172720","34","111244876"
"chr1","131455898","131456015","chr9","20147685","20147808","19","111308213"
"chr1","131653739","131653853","chr9","91203145","91203259","16","40450594"
"chr1","131661442","131661730","chr22","25971576","25971863","55","105689866"
"chr1","131716591","131716897","chr11","12728691","12728990","71","118987900"
"chr1","131926602","131926722","chr7","135190693","135190812","22","3264091"
"chr1","131958740","131958813","chr16","65390615","65390689","17","66568125"
"chr1","132088716","132089029","chr10","17607862","17608158","80","114480854"
"chr1","132163873","132164025","chr2B","94897282","94897419","34","37266591"
"chr1","132164101","132164365","chr7","73083255","73083530","70","59080846"
"chr1","132195139","132195412","chr9","19435321","19435620","61","112759818"
"chr1","133035546","133035754","chr5","22991858","22992070","49","110043688"
"chr1","133042281","133042580","chr9","17788513","17788814","39","115253768"
"chr1","133225192","133225478","chr5","63510276","63510559","75","69714916"
"chr1","133362687","133362973","chr9","18079443","18079728","28","115283244"
"chr1","133366855","133367122","chr9","18083707","18084010","60","115283148"
"chr1","133505981","133506237","chr20","15104219","15104470","65","118401762"
"chr1","133668883","133669180","chr9","18401361","18401635","64","115267522"
"chr1","133829718","133829858","chr9","17642346","17642487","26","116187372"
"chr1","133874694","133875012","chr13","10151658","10151980","98","123723036"
"chr1","134098011","134098144","chr4","16451557","16451695","34","117646454"
"chr1","134098408","134098524","chr14","47226762","47226881","21","86871646"
"chr1","134445937","134446090","chr20","55353732","55353890","33","79092205"
"chr1","134476863","134477171","chr9","17104168","17104476","30","117372695"
"chr1","134497882","134498173","chr12","113369447","113369739","59","21128435"
"chr1","134505604","134505869","chr3","158870077","158870333","65","24364473"
"chr1","134515963","134516218","chr9","17054361","17054643","52","117461602"
"chr1","134516546","134516647","chr4","121283672","121283773","16","13232874"
"chr1","134541414","134541486","chr5","123976410","123976480","12","10565004"
"chr1","134541515","134541646","chr6","135248431","135248563","31","706916"
"chr1","134548219","134548386","chr7","76863731","76863897","38","57684488"
"chr1","134594677","134594807","chr9","16968062","16968192","10","117626615"
"chr1","134602515","134602826","chr9","16959703","16959998","64","117642812"
"chr1","134608329","134608607","chr9","16953500","16953795","46","117654829"
"chr1","134608609","134608703","chr1","134242923","134243019","22","365686"
"chr1","134622727","134622849","chr9","16939039","16939161","16","117683688"
"chr1","134656109","134656411","chr9","16915344","16915666","74","117740765"
"chr1","134657306","134657416","chr9","16914262","16914375","14","117743044"
"chr1","134658568","134658856","chr9","16912745","16913049","48","117745823"
"chr1","134667256","134667563","chr9","16903784","16904082","47","117763472"
"chr1","134670353","134670649","chr9","16900983","16901289","58","117769370"
"chr1","134716836","134717052","chr9","16858307","16858526","27","117858529"
"chr1","134749676","134749850","chrX","119758170","119758333","39","14991506"
"chr1","134832058","134832363","chr9","16710640","16710936","45","118121418"
"chr1","134833641","134833954","chr9","16709094","16709404","47","118124547"
"chr1","134890354","134890569","chrX","154182968","154183182","40","19292614"
"chr1","134908787","134908917","chr9","16646219","16646350","13","118262568"
"chr1","134923043","134923321","chr9","16633553","16633838","47","118289490"
"chr1","134923340","134923467","chr19","7798413","7798535","25","127124927"
"chr1","134935948","134936240","chr9","16622193","16622460","49","118313755"
"chr1","135016624","135016843","chr5","138456121","138456337","40","3439497"
"chr1","135030060","135030321","chr9","16506412","16506701","66","118523648"
"chr1","135038075","135038199","chr9","16494334","16494457","9","118543741"
"chr1","135040041","135040156","chr8","8957635","8957751","17","126082406"
"chr1","135041299","135041591","chr9","16490755","16491056","48","118550544"
"chr1","135090265","135090411","chr15","55444248","55444397","26","79646017"
"chr1","135131308","135131440","chr15","57026888","57027018","20","78104420"
"chr1","135135670","135135833","chr21","34056187","34056352","29","101079483"
"chr1","135136465","135136591","chr4","24802775","24802902","25","110333690"
"chr1","135159116","135159405","chr9","16352040","16352351","50","118807076"
"chr1","135160943","135161238","chr2A","45843775","45844068","58","89317168"
"chr1","135184783","135184929","chr9","16328024","16328174","30","118856759"
"chr1","135186082","135186378","chr9","16326602","16326900","36","118859480"
"chr1","135189914","135190167","chr9","16322745","16322996","28","118867169"
"chr1","135214709","135214981","chr15","51341922","51342201","69","83872787"
"chr1","135227360","135227465","chr9","53531542","53531646","26","81695818"
"chr1","135237556","135237833","chr2A","70182385","70182669","54","65055171"
"chr1","135241757","135242054","chr9","16274697","16274984","38","118967060"
"chr1","135268821","135269041","chr1","217294594","217294821","59","82025773"
"chr1","135289922","135290175","chr9","16219478","16219762","64","119070444"
"chr1","135326699","135326943","chr1","210903286","210903544","65","75576587"
"chr1","135354598","135354892","chr9","16160527","16160828","37","119194071"
"chr1","135355771","135355915","chr3","186215816","186215959","26","50860045"
"chr1","135372684","135372849","chr9","16141749","16141926","31","119230935"
"chr1","135374503","135374777","chr9","16139568","16139855","54","119234935"
"chr1","135438290","135438514","chrX","107587018","107587232","57","27851272"
"chr1","135445022","135445325","chr1","24714709","24715017","57","110730313"
"chr1","135484836","135485116","chr15","15136106","15136390","66","120348730"
"chr1","135485757","135486044","chr9","16028790","16029097","57","119456967"
"chr1","135503813","135504038","chr9","16012860","16013121","61","119490953"
"chr1","135534172","135534245","chr12","130223742","130223812","15","5310430"
"chr1","135575815","135576110","chr9","15624848","15625142","31","119950967"
"chr1","135600989","135601290","chr12","15629472","15629768","62","119971517"
"chr1","135610216","135610318","chr3","43325748","43325848","23","92284468"
"chr1","135621458","135621556","chr6","57992206","57992306","22","77629252"
"chr1","135627210","135627343","chr21","28456093","28456225","26","107171117"
"chr1","135704785","135705050","chr9","15502087","15502361","50","120202698"
"chr1","135708262","135708427","chr10","27981419","27981584","33","107726843"
"chr1","135709198","135709499","chr9","15498936","15499233","35","120210262"
"chr1","135719549","135719848","chr9","15489614","15489921","52","120229935"
"chr1","135720878","135721174","chr9","15488435","15488731","44","120232443"
"chr1","135726276","135726396","chr4","186160023","186160141","20","50433747"
"chr1","135735947","135736237","chr9","15475287","15475604","60","120260660"
"chr1","135757969","135758063","chr3","51336754","51336851","25","84421215"
"chr1","135774807","135775047","chr9","15443712","15443978","55","120331095"
"chr1","135780321","135780435","chrX","132733314","132733428","24","3047007"
"chr1","135790056","135790350","chr1","45032090","45032394","72","90757966"
"chr1","135791075","135791340","chr7","6101267","6101524","67","129689808"
"chr1","135803342","135803623","chr9","15414981","15415275","56","120388361"
"chr1","135838912","135839204","chr9","15384445","15384733","45","120454467"
"chr1","135842392","135842680","chr9","15376638","15376892","52","120465754"
"chr1","135842683","135842971","chr9","15376340","15376635","54","120466343"
"chr1","135874522","135874832","chr1","45666650","45666951","65","90207872"
"chr1","135890220","135890510","chr2A","21112630","21112931","76","114777590"
"chr1","135937484","135937755","chr3","99899132","99899401","66","36038352"
"chr1","135937770","135937867","chr10","117001518","117001614","21","18936252"
"chr1","135957975","135958189","chr11","8985766","8985986","48","126972209"
"chr1","135958580","135958737","chr5","80662612","80662778","44","55295968"
"chr1","135965537","135965639","chr13","9559854","9559959","20","126405683"
"chr1","135991079","135991389","chr2B","69584574","69584877","55","66406505"
"chr1","135997215","135997512","chr12","108745776","108746083","59","27251439"
"chr1","136009045","136009126","chr5","36110533","36110617","10","99898512"
"chr1","136009549","136009838","chr9","15262534","15262836","48","120747015"
"chr1","136054067","136054351","chr9","15218285","15218599","54","120835782"
"chr1","136059255","136059368","chr21","22410706","22410824","26","113648549"
"chr1","136070945","136071241","chr1","9960396","9960695","68","126110549"
"chr1","136084800","136085099","chr1","129667961","129668256","57","6416839"
"chr1","136090182","136090457","chr9","15176361","15176646","55","120913821"
"chr1","136091918","136092203","chr14","58916089","58916385","72","77175829"
"chr1","136096312","136096615","chr12","901136","901435","42","135195176"
"chr1","136118249","136118517","chr1","175819165","175819436","75","39700916"
"chr1","136133127","136133226","chr13","39761960","39762063","26","96371167"
"chr1","136150675","136150957","chr9","15105154","15105448","48","121045521"
"chr1","136166178","136166298","chr3","50254177","50254297","25","85912001"
"chr1","136210316","136210439","chr9","15046836","15046960","11","121163480"
"chr1","136213302","136213591","chr9","15043290","15043588","27","121170012"
"chr1","136217250","136217545","chr10","124980454","124980759","52","11236796"
"chr1","136223351","136223657","chr9","15031693","15031992","35","121191658"
"chr1","136249558","136249840","chr9","15005778","15006062","27","121243780"
"chr1","136304182","136304463","chr5","15761590","15761861","63","120542592"
"chr1","136310087","136310298","chr12","118865454","118865663","32","17444633"
"chr1","136374180","136374461","chr9","14871638","14871926","48","121502542"
"chr1","136412152","136412450","chr9","14835217","14835517","39","121576935"
"chr1","136435231","136435538","chr9","14805817","14806132","41","121629414"
"chr1","136474368","136474479","chr16","40500610","40500729","27","95973758"
"chr1","136476127","136476237","chr9","80788918","80789032","33","55687209"
"chr1","136477112","136477228","chr16","59161632","59161745","19","77315480"
"chr1","136542678","136543000","chr9","14726871","14727171","69","121815807"
"chr1","136572685","136572971","chr2A","9717831","9718124","66","126854854"
"chr1","136587218","136587527","chr9","14669980","14670284","38","121917238"
"chr1","136686235","136686461","chr9","14503455","14503688","25","122182780"
"chr1","136736151","136736273","chr20","57693813","57693936","19","79042338"
"chr1","136736331","136736631","chr9","14442722","14443005","47","122293609"
"chr1","136802449","136802749","chr9","14371235","14371529","35","122431214"
"chr1","136808014","136808090","chr1","215499639","215499714","12","78691625"
"chr1","136808199","136808434","chr9","14365839","14366092","41","122442360"
"chr1","136809502","136809787","chr9","14364777","14365062","32","122444725"
"chr1","136890226","136890489","chr9","14274695","14274958","33","122615531"
"chr1","136891917","136892199","chr9","14272907","14273188","29","122619010"
"chr1","136893206","136893472","chr9","14271962","14272249","64","122621244"
"chr1","136916855","136917145","chr9","14224876","14225168","33","122691979"
"chr1","136954103","136954297","chr9","14185084","14185291","36","122769019"
"chr1","136963921","136964058","chr3","49735473","49735605","26","87228448"
"chr1","136971906","136972029","chr9","14164360","14164484","12","122807546"
"chr1","137020065","137020376","chr9","14113518","14113806","51","122906547"
"chr1","137027258","137027534","chr9","14106766","14107043","25","122920492"
"chr1","137039928","137040094","chr8","56795337","56795503","39","80244591"
"chr1","137065875","137066195","chr9","14072552","14072870","40","122993323"
"chr1","137118938","137119056","chr4","125095292","125095415","23","12023646"
"chr1","137122841","137123161","chr7","80060311","80060624","67","57062530"
"chr1","137149059","137149360","chr9","14007500","14007802","41","123141559"
"chr1","137180340","137180457","chr12","10007664","10007786","23","127172676"
"chr1","137210965","137211087","chr9","13964743","13964867","18","123246222"
"chr1","137244484","137244785","chr16","40437471","40437776","71","96807013"
"chr1","137310918","137311233","chr9","13904463","13904782","41","123406455"
"chr1","137312568","137312691","chr5","10575967","10576091","19","126736601"
"chr1","137323028","137323278","chr2A","18685518","18685775","56","118637510"
"chr1","137378755","137379060","chr9","13835097","13835402","49","123543658"
"chr1","137383161","137383464","chr9","13830516","13830811","39","123552645"
"chr1","137406033","137406321","chr9","13808576","13808888","56","123597457"
"chr1","137424702","137425002","chr6","111005103","111005405","57","26419599"
"chr1","137425034","137425315","chr12","133331086","133331362","66","4093948"
"chr1","137440788","137441093","chr2A","79717022","79717315","52","57723766"
"chr1","137641072","137641231","chr19","15955029","15955193","35","121686043"
"chr1","137682245","137682556","chr9","13595690","13596021","49","124086555"
"chr1","137688367","137688570","chr9","13591023","13591225","30","124097344"
"chr1","137726515","137726817","chr14","77945121","77945424","65","59781394"
"chr1","137737983","137738134","chr9","108241495","108241645","30","29496488"
"chr1","137768476","137768785","chr9","13508403","13508697","52","124260073"
"chr1","137823375","137823673","chr6","20660276","20660575","70","117163099"
"chr1","137835421","137835701","chr9","13470470","13470760","43","124364951"
"chr1","137842315","137842439","chr3","58490628","58490750","20","79351687"
"chr1","137850883","137851129","chr9","76607259","76607509","62","61243624"
"chr1","137853549","137853641","chrX","17859115","17859206","14","119994434"
"chr1","137905360","137905634","chr9","13403882","13404169","46","124501478"
"chr1","137906169","137906447","chr16","25190782","25191063","62","112715387"
"chr1","137956875","137957175","chr9","13357471","13357772","39","124599404"
"chr1","137960513","137960817","chr9","13355134","13355459","55","124605379"
"chr1","137969058","137969232","chr1","88597734","88597909","32","49371324"
"chr1","137986844","137987145","chr3","199465011","199465308","71","61478167"
"chr1","138000819","138000933","chr20","48111352","48111469","27","89889467"
"chr1","138058368","138058630","chr5","40471033","40471294","63","97587335"
"chr1","138085471","138085540","chr9","80084364","80084438","19","58001107"
"chr1","138085625","138085933","chr9","13210728","13211034","30","124874897"
"chr1","138086434","138086562","chr10","15454692","15454818","25","122631742"
"chr1","138127907","138128247","chr9","22420946","22421244","82","115706961"
"chr1","138145177","138145446","chr9","22340540","22340808","32","115804637"
"chr1","138165163","138165456","chr9","22382204","22382494","31","115782959"
"chr1","138180151","138180370","chr4","141002317","141002532","48","2822166"
"chr1","138185895","138186029","chr7","28901497","28901635","35","109284398"
"chr1","138191485","138191778","chr9","13195030","13195323","40","124996455"
"chr1","138232527","138232796","chr9","13149464","13149737","59","125083063"
"chr1","138271179","138271449","chr9","13113551","13113841","60","125157628"
"chr1","138275654","138275964","chr9","13108225","13108513","61","125167429"
"chr1","138359269","138359540","chr5","34518283","34518568","65","103840986"
"chr1","138390110","138390237","chr9","12990465","12990587","20","125399645"
"chr1","138418415","138418630","chr6","110612092","110612302","51","27806323"
"chr1","138441607","138441828","chr7","67519721","67519924","54","70921886"
"chr1","138444974","138445243","chr12","34819641","34819909","67","103625333"
"chr1","138466955","138467092","chr5","156687101","156687239","34","18220146"
"chr1","138474817","138474987","chr6","58098458","58098635","35","80376359"
"chr1","138492235","138492518","chr9","12902395","12902683","48","125589840"
"chr1","138510483","138510785","chr9","12868576","12868873","43","125641907"
"chr1","138511454","138511736","chr9","12868056","12868351","41","125643398"
"chr1","138583946","138584042","chr16","62589759","62589857","19","75994187"
"chr1","138655388","138655673","chr3","192196395","192196679","64","53541007"
"chr1","138692193","138692364","chr1","32690171","32690334","40","106002022"
"chr1","138859432","138859653","chr9","12532981","12533206","32","126326451"
"chr1","138894202","138894358","chr14","35145745","35145882","48","103748457"
"chr1","138900624","138900907","chr9","12489488","12489782","39","126411136"
"chr1","138974713","138975018","chr9","12406898","12407202","33","126567815"
"chr1","138982331","138982437","chr9","12399019","12399125","9","126583312"
"chr1","138986063","138986169","chr7","63270574","63270690","30","75715489"
"chr1","139020422","139020549","chr16","26009514","26009638","19","113010908"
"chr1","139027297","139027560","chr9","12354632","12354903","32","126672665"
"chr1","139031031","139031361","chr1","209267285","209267596","110","70236254"
"chr1","139038708","139039001","chr9","12345187","12345476","36","126693521"
"chr1","139069239","139069536","chr9","12316444","12316739","22","126752795"
"chr1","139075507","139075782","chr7","71995239","71995523","62","67080268"
"chr1","139118319","139118547","chr9","12263544","12263784","56","126854775"
"chr1","139189652","139189936","chr15","28698469","28698760","61","110491183"
"chr1","139198530","139198823","chr16","44829201","44829482","66","94369329"
"chr1","139211808","139212025","chr9","12157163","12157372","28","127054645"
"chr1","139222076","139222388","chr9","12146340","12146649","37","127075736"
"chr1","139251406","139251674","chr9","12115701","12115949","48","127135705"
"chr1","139253294","139253426","chr16","24967291","24967423","25","114286003"
"chr1","139286412","139286725","chr9","12072767","12073086","30","127213645"
"chr1","139292080","139292376","chr9","12069883","12070181","37","127222197"
"chr1","139296434","139296727","chr9","12067016","12067317","40","127229418"
"chr1","139298245","139298409","chr7","106533466","106533634","30","32764779"
"chr1","139316617","139316943","chr4","182052332","182052639","71","42735715"
"chr1","139320306","139320611","chr9","12043414","12043700","51","127276892"
"chr1","139339272","139339380","chr7","111701302","111701412","19","27637970"
"chr1","139360376","139360642","chr9","12013683","12013937","55","127346693"
"chr1","139395904","139396191","chr9","11996274","11996558","29","127399630"
"chr1","139402068","139402353","chr9","11985215","11985486","67","127416853"
"chr1","139407444","139407704","chr9","11981454","11981735","46","127425990"
"chr1","139441614","139441742","chr19","14415022","14415148","23","125026592"
"chr1","139469659","139469955","chr1","163867986","163868280","52","24398327"
"chr1","139517790","139518071","chr9","11853322","11853596","61","127664468"
"chr1","139551096","139551390","chr9","11823501","11823807","32","127727595"
"chr1","139584830","139585033","chr9","11801477","11801691","52","127783353"
"chr1","139638883","139638999","chr2B","84261119","84261234","8","55377764"
"chr1","139687227","139687381","chr18","77876014","77876168","31","61811213"
"chr1","139716289","139716583","chr5","12089540","12089848","42","127626749"
"chr1","139722062","139722154","chr17","38532634","38532725","16","101189428"
"chr1","139722436","139722731","chr9","11677625","11677929","57","128044811"
"chr1","139722875","139722997","chr19","46547524","46547634","32","93175351"
"chr1","139748409","139748532","chr1","38068772","38068896","27","101679637"
"chr1","139770465","139770679","chr7","82681491","82681731","69","57088974"
"chr1","139786745","139787023","chr9","11623340","11623617","37","128163405"
"chr1","139806388","139806695","chr9","11595991","11596299","35","128210397"
"chr1","139827931","139828041","chr4","2528135","2528243","24","137299796"
"chr1","140001807","140002107","chr9","11401715","11401997","46","128600092"
"chr1","140111576","140111680","chr4","110753866","110753969","18","29357710"
"chr1","140124744","140125039","chr9","11288944","11289230","54","128835800"
"chr1","140138314","140138443","chr5","124432264","124432393","26","15706050"
"chr1","140308328","140308609","chr1","163867986","163868280","67","23559658"
"chr1","140309375","140309635","chr9","11080916","11081168","41","129228459"
"chr1","140343803","140344095","chr9","11014778","11015076","41","129329025"
"chr1","140351013","140351322","chr9","11004477","11004777","39","129346536"
"chr1","140357363","140357655","chr11","47728330","47728629","60","92629033"
"chr1","140365818","140366119","chr9","10988424","10988715","54","129377394"
"chr1","140370117","140370254","chr2B","94897282","94897419","34","45472835"
"chr1","140376015","140376156","chr11","101364804","101364938","33","39011211"
"chr1","140378454","140378749","chr4","164092787","164093085","69","23714333"
"chr1","140400626","140400736","chr9","10944607","10944716","9","129456019"
"chr1","140403116","140403240","chr16","25258310","25258432","32","115144806"
"chr1","140428075","140428309","chr5","38347057","38347291","48","102081018"
"chr1","140574430","140574721","chr9","79520482","79520769","29","61053948"
"chr1","140579847","140580143","chr9","79525956","79526246","32","61053891"
"chr1","140644835","140645132","chr5","57804017","57804310","57","82840818"
"chr1","140820894","140821237","chr9","79785639","79785975","43","61035255"
"chr1","140832757","140833040","chr19","4744372","4744649","68","136088385"
"chr1","140845059","140845332","chr9","79811401","79811694","42","61033658"
"chr1","140859915","140860215","chr9","79825574","79825873","28","61034341"
"chr1","140908671","140908786","chr7","26158438","26158564","30","114750233"
"chr1","140933410","140933581","chr14","72724722","72724884","38","68208688"
"chr1","140950167","140950426","chr9","79916531","79916798","35","61033636"
"chr1","140953585","140953896","chr9","79919611","79919921","39","61033974"
"chr1","140983864","140984166","chr9","79949246","79949572","45","61034618"
"chr1","140990960","140991269","chr13","81267991","81268300","65","59722969"
"chr1","140995198","140995524","chr1","54866194","54866532","93","86129004"
"chr1","141014720","141014959","chr6","37978460","37978685","61","103036260"
"chr1","141030319","141030622","chr4","161340990","161341295","59","20310671"
"chr1","141033699","141033998","chr9","79987245","79987549","33","61046454"
"chr1","141075166","141075466","chr9","80035700","80035985","53","61039466"
"chr1","141080726","141080933","chr9","113935755","113935963","44","27144971"
"chr1","141102560","141102848","chr9","80050055","80050355","46","61052505"
"chr1","141161813","141162110","chr9","80111572","80111860","40","61050241"
"chr1","141192078","141192343","chr9","80146651","80146935","52","61045427"
"chr1","141193801","141194097","chr9","80152499","80152804","40","61041302"
"chr1","141226574","141226721","chr5","121351074","121351220","41","19875500"
"chr1","141247110","141247373","chr9","80187336","80187608","40","61059774"
"chr1","141249395","141249591","chr12","94566398","94566587","49","46682997"
"chr1","141269735","141270019","chr9","80208483","80208759","40","61061252"
"chr1","141276173","141276277","chr4","15029692","15029801","20","126246481"
"chr1","141280014","141280247","chr6","110331265","110331491","49","30948749"
"chr1","141285607","141285879","chr2B","125994039","125994312","53","15291568"
"chr1","141302629","141302905","chr9","80241861","80242145","41","61060768"
"chr1","141304821","141305046","chr9","113807290","113807518","61","27497531"
"chr1","141310749","141310860","chr8","19325971","19326085","23","121984778"
"chr1","141352914","141353213","chr9","80291973","80292260","40","61060941"
"chr1","141354436","141354729","chr4","197330561","197330854","53","55976125"
"chr1","141382243","141382574","chr9","80315263","80315567","53","61066980"
"chr1","141400116","141400375","chr9","80332503","80332791","70","61067613"
"chr1","141414867","141414992","chr20","30238448","30238572","25","111176419"
"chr1","141420053","141420213","chr4","94318314","94318473","41","47101739"
"chr1","141525578","141525877","chr9","80447508","80447803","35","61078070"
"chr1","141566634","141566935","chr9","80484853","80485163","40","61081781"
"chr1","141573774","141574057","chr1","221569715","221570002","50","79995941"
"chr1","141639226","141639505","chrX","119152069","119152344","53","22487157"
"chr1","141702516","141702825","chr9","80635583","80635894","38","61066933"
"chr1","141703813","141703947","chr6","44927054","44927185","36","96776759"
"chr1","141723757","141724037","chr9","80656523","80656822","44","61067234"
"chr1","141752664","141752984","chr9","80672666","80672982","43","61079998"
"chr1","141755815","141755972","chr12","8768282","8768448","45","132987533"
"chr1","141771167","141771449","chr9","80737554","80737843","39","61033613"
"chr1","141783438","141783739","chr12","110756931","110757228","67","31026507"
"chr1","141820822","141821115","chr9","80787553","80787855","62","61033269"
"chr1","141953946","141954243","chr9","80914511","80914814","33","61039435"
"chr1","141964920","141965046","chr8","144957651","144957776","35","2992731"
"chr1","141987223","141987459","chr9","80950531","80950766","27","61036692"
"chr1","142043639","142043845","chr9","120998014","120998226","49","21045625"
"chr1","142053683","142053881","chr19","6085105","6085297","43","135968578"
"chr1","142058945","142059247","chr9","81022313","81022621","32","61036632"
"chr1","142085569","142085858","chr5","51674902","51675165","76","90410667"
"chr1","142086384","142086639","chr2B","60973482","60973740","54","81112902"
"chr1","142181022","142181338","chr3","50836842","50837153","68","91344180"
"chr1","142199712","142200003","chr9","81176368","81176669","39","61023344"
"chr1","142244042","142244213","chr1","226479927","226480090","39","84235885"
"chr1","142311307","142311534","chr1","217294594","217294821","50","74983287"
"chr1","142344520","142344651","chr5","165100447","165100576","31","22755927"
"chr1","142369284","142369450","chr9","81326442","81326628","41","61042842"
"chr1","142577311","142577609","chr9","81539694","81539997","36","61037617"
"chr1","142641310","142641587","chr9","81603872","81604139","39","61037438"
"chr1","142684091","142684300","chr9","81658671","81658871","34","61025420"
"chr1","142701214","142701505","chr9","81675575","81675869","45","61025639"
"chr1","142779041","142779370","chr9","81751470","81751778","57","61027571"
"chr1","142927444","142927736","chr9","81902682","81902989","49","61024762"
"chr1","142933692","142933968","chr9","81909344","81909634","40","61024348"
"chr1","142971555","142971778","chr20","3247317","3247532","47","139724238"
"chr1","142977950","142978099","chr15","5454904","5455056","34","137523046"
"chr1","143012626","143012754","chr5","157089909","157090042","25","14077283"
"chr1","143033888","143034176","chr9","82003193","82003505","50","61030695"
"chr1","143040356","143040665","chr9","82010361","82010661","45","61029995"
"chr1","143044939","143045205","chr9","82014371","82014637","26","61030568"
"chr1","143104318","143104529","chr17","53230347","53230558","37","89873971"
"chr1","143124734","143124998","chr9","82099849","82100156","64","61024885"
"chr1","143144451","143144580","chr1","23480685","23480816","19","119663766"
"chr1","143241684","143241883","chr3","162535331","162535532","54","19293647"
"chr1","143262685","143262950","chr9","82250659","82250933","40","61012026"
"chr1","143296400","143296704","chr9","82296394","82296698","40","61000006"
"chr1","143298796","143299096","chr9","82298520","82298818","41","61000276"
"chr1","143395125","143395235","chr1","68350841","68350951","23","75044284"
"chr1","143395780","143395875","chr12","46140363","46140469","28","97255417"
"chr1","143456159","143456246","chr2B","74186352","74186439","10","69269807"
"chr1","143496969","143497246","chr7","74954016","74954295","60","68542953"
"chr1","143497925","143498001","chr1","134428562","134428634","19","9069363"
"chr1","143538027","143538294","chr9","82526679","82526991","73","61011348"
"chr1","143542932","143543247","chr9","82532279","82532582","45","61010653"
"chr1","143551173","143551463","chr9","82539883","82540158","56","61011290"
"chr1","143589488","143589796","chr15","63455586","63455888","79","80133902"
"chr1","143638438","143638522","chr9","82628469","82628553","10","61009969"
"chr1","143698273","143698546","chr9","82692886","82693154","33","61005387"
"chr1","143730740","143730943","chr15","12469941","12470151","55","131260799"
"chr1","143735838","143735928","chr4","112859931","112860023","14","30875907"
"chr1","143776253","143776555","chr9","82743940","82744231","48","61032313"
"chr1","143830798","143830913","chr14","57065277","57065395","23","86765521"
"chr1","143840402","143840535","chr7","56839310","56839440","31","87001092"
"chr1","144086861","144087128","chr10","29441110","29441370","62","114645751"
"chr1","144103210","144103524","chr9","83054854","83055166","41","61048356"
"chr1","144127167","144127470","chrX","70068494","70068793","61","74058673"
"chr1","144304171","144304486","chr8","11749389","11749701","63","132554782"
"chr1","144353730","144354031","chr9","83391755","83392060","34","60961975"
"chr1","144448270","144448393","chr9","83471002","83471125","15","60977268"
"chr1","144485901","144486015","chr6","7105611","7105725","17","137380290"
"chr1","144500177","144500475","chr5","38164910","38165205","72","106335267"
"chr1","144525736","144525953","chr9","83568654","83568859","33","60957082"
"chr1","144649401","144649554","chr10","27964289","27964440","34","116685112"
"chr1","144685451","144685757","chr9","91214209","91214520","50","53471242"
"chr1","144687086","144687376","chr9","91212006","91212292","43","53475080"
"chr1","144693902","144694195","chr9","91205031","91205314","49","53488871"
"chr1","144695917","144696055","chr3","33691327","33691462","26","111004590"
"chr1","144873804","144873876","chr16","59229107","59229174","20","85644697"
"chr1","144977378","144977458","chr9","83918373","83918454","13","61059005"
"chr1","145087921","145088172","chr9","84040495","84040744","44","61047426"
"chr1","145237844","145237960","chr9","84204145","84204262","24","61033699"
"chr1","145670303","145670396","chr14","41346776","41346870","25","104323527"
"chr1","145670431","145670552","chrX","74105539","74105664","23","71564892"
"chr1","145721960","145722268","chr9","84671057","84671366","46","61050903"
"chr1","145837129","145837439","chr12","43792218","43792528","65","102044911"
"chr1","145903263","145903396","chr7","56839310","56839440","34","89063953"
"chr1","146227277","146227549","chr10","26450680","26450951","80","119776597"
"chr1","146312545","146312816","chr9","85223111","85223391","47","61089434"
"chr1","146323840","146323975","chr7","76360858","76360988","25","69962982"
"chr1","146401964","146402266","chr9","85312889","85313184","48","61089075"
"chr1","146434966","146435193","chr10","12466220","12466463","62","133968746"
"chr1","146443374","146443530","chr2A","97441991","97442142","44","49001383"
"chr1","146454378","146454682","chr9","85378918","85379229","44","61075460"
"chr1","146471342","146471623","chr9","15174646","15174929","62","131296696"
"chr1","146522097","146522418","chr9","85433893","85434165","76","61088204"
"chr1","146891400","146891523","chr3","54036399","54036522","17","92855001"
"chr1","147254332","147254644","chr9","86166721","86167017","50","61087611"
"chr1","147305850","147305967","chr5","22710618","22710735","12","124595232"
"chr1","147450911","147451166","chr1","13854532","13854791","58","133596379"
"chr1","147514962","147515080","chr8","34750032","34750149","18","112764930"
"chr1","147637474","147637622","chr7","67575615","67575768","33","80061859"
"chr1","147723010","147723129","chr9","86685643","86685764","15","61037367"
"chr1","147768013","147768236","chr9","86726517","86726738","40","61041496"
"chr1","147897409","147897675","chr18","19682444","19682705","72","128214965"
"chr1","147990831","147991120","chr9","86949303","86949588","34","61041528"
"chr1","147995778","147995899","chr13","82394645","82394770","21","65601133"
"chr1","148151063","148151354","chr9","87092451","87092743","32","61058612"
"chr1","148195557","148195798","chr9","87134838","87135113","51","61060719"
"chr1","148205023","148205295","chr9","87145090","87145374","43","61059933"
"chr1","148232364","148232495","chr9","87160418","87160537","27","61071946"
"chr1","148246685","148246922","chr19","13001825","13002050","58","135244860"
"chr1","148255794","148256107","chr9","87184663","87184966","38","61071131"
"chr1","148305056","148305217","chr12","19312537","19312701","35","128992519"
"chr1","148356564","148356857","chr16","66288435","66288718","65","82068129"
"chr1","148440214","148440393","chr1","78644010","78644184","43","69796204"
"chr1","148441000","148441114","chr7","79291991","79292103","23","69149009"
"chr1","148441276","148441428","chr3","39881249","39881395","38","108560027"
"chr1","148461189","148461458","chr20","51602843","51603122","71","96858346"
"chr1","148528249","148528515","chr9","87350406","87350676","40","61177843"
"chr1","148540345","148540623","chr9","87361410","87361740","82","61178935"
"chr1","148544148","148544266","chr20","30238448","30238572","22","118305700"
"chr1","148544646","148544787","chr20","3990165","3990306","34","144554481"
"chr1","148575249","148575338","chr5","7846452","7846538","17","140728797"
"chr1","148577828","148578110","chr9","87393751","87394031","58","61184077"
"chr1","148605417","148605693","chr9","87416173","87416467","51","61189244"
"chr1","148625948","148626224","chr2A","64425600","64425873","63","84200348"
"chr1","148657818","148658126","chr9","87468819","87469120","37","61188999"
"chr1","148675520","148675809","chr9","87487055","87487349","35","61188465"
"chr1","148696992","148697266","chr9","87508168","87508463","50","61188824"
"chr1","148712322","148712599","chr9","87520515","87520820","55","61191807"
"chr1","148775913","148775987","chr4","82318361","82318431","28","66457552"
"chr1","148776145","148776274","chr1","27808249","27808381","20","120967896"
"chr1","148779580","148779862","chr9","87591113","87591406","34","61188467"
"chr1","148805141","148805278","chrX","2794957","2795096","30","146010184"
"chr1","148864433","148864739","chr9","87682666","87682974","34","61181767"
"chr1","148896443","148896736","chr9","87719283","87719588","59","61177160"
"chr1","148909363","148909428","chr22","26052406","26052470","11","122856957"
"chr1","148920916","148921196","chr4","24691467","24691751","60","124229449"
"chr1","148959397","148959705","chr9","87795351","87795658","43","61164046"
"chr1","148969498","148969793","chr12","123096820","123097105","57","25872678"
"chr1","149001596","149001715","chr9","93166403","93166525","14","55835193"
"chr1","149010989","149011126","chrX","119153867","119153996","20","29857122"
"chr1","149087905","149088188","chr9","87902382","87902674","36","61185523"
"chr1","149331381","149331665","chr9","88169075","88169353","47","61162306"
"chr1","150189777","150190069","chr10","28577029","28577316","69","121612748"
"chr1","150202135","150202404","chr9","89023849","89024160","67","61178286"
"chr1","150326011","150326142","chr9","89173618","89173747","14","61152393"
"chr1","150556130","150556388","chr4","98284874","98285126","70","52271256"
"chr1","150654345","150654610","chr16","19318637","19318917","62","131335708"
"chr1","150683666","150683963","chr9","89561397","89561678","53","61122269"
"chr1","150796214","150796510","chr2A","79717022","79717315","49","71079192"
"chr1","150819810","150819949","chr2B","94897282","94897419","29","55922528"
"chr1","150844881","150845002","chr9","104384645","104384763","29","46460236"
"chr1","150847721","150847853","chr9","89749609","89749733","37","61098112"
"chr1","150856230","150856520","chr9","89757532","89757838","47","61098698"
"chr1","150858037","150858308","chr15","53787943","53788211","59","97070094"
"chr1","150892535","150892830","chr5","28852325","28852622","60","122040210"
"chr1","150937636","150937725","chr12","19210697","19210789","20","131726939"
"chr1","150939408","150939504","chr1","186122233","186122334","22","35182825"
"chr1","150939701","150939857","chrX","71151088","71151230","40","79788613"
"chr1","150940300","150940596","chrX","40660160","40660460","52","110280140"
"chr1","150955203","150955383","chr9","89844965","89845126","39","61110238"
"chr1","150955384","150955588","chr9","89845127","89845325","41","61110257"
"chr1","150999063","150999149","chr9","89886891","89886976","10","61112172"
"chr1","151047630","151047761","chr7","74162660","74162783","33","76884970"
"chr1","151084312","151084598","chr4","72814690","72814977","70","78269622"
"chr1","151108349","151108474","chr1","208810115","208810240","21","57701766"
"chr1","151249499","151249654","chr3","49669891","49670052","33","101579608"
"chr1","151255657","151255771","chr19","39728467","39728583","17","111527190"
"chr1","151263443","151263634","chr14","50979257","50979448","43","100284186"
"chr1","151624037","151624334","chr9","90491781","90492084","44","61132256"
"chr1","151635072","151635196","chr1","91956065","91956192","18","59679007"
"chr1","151886246","151886538","chr9","90759750","90760042","52","61126496"
"chr1","151951381","151951533","chr12","28669233","28669390","35","123282148"
"chr1","152070397","152070687","chr9","90975878","90976183","46","61094519"
"chr1","152076609","152076887","chr9","90981959","90982231","58","61094650"
"chr1","152092801","152092914","chr17","63212955","63213066","23","88879846"
"chr1","152134927","152135221","chr9","91035693","91035982","33","61099234"
"chr1","152145975","152146243","chr18","49464633","49464900","58","102681342"
"chr1","152312060","152312354","chr9","91205031","91205314","51","61107029"
"chr1","152312433","152312715","chr19","3011800","3012083","63","149300633"
"chr1","152318557","152318848","chr9","91212006","91212292","39","61106551"
"chr1","152320828","152321141","chr9","91214209","91214520","45","61106619"
"chr1","152369777","152370073","chr9","91294765","91295077","39","61075012"
"chr1","152454953","152455220","chr10","14148508","14148787","81","138306445"
"chr1","152455330","152455626","chr21","8638372","8638666","61","143816958"
"chr1","152480268","152480571","chr9","91424527","91424823","41","61055741"
"chr1","152488387","152488509","chr4","24738984","24739103","22","127749403"
"chr1","152490667","152490952","chr9","91435547","91435838","32","61055120"
"chr1","152510745","152511030","chr5","38746639","38746929","69","113764106"
"chr1","152538226","152538528","chr3","68038681","68038974","69","84499545"
"chr1","152564146","152564290","chr10","59648007","59648153","34","92916139"
"chr1","152613117","152613424","chr9","91557516","91557817","46","61055601"
"chr1","152617114","152617234","chrX","49113443","49113558","24","103503671"
"chr1","152617326","152617458","chrX","12360522","12360653","18","140256804"
"chr1","152656463","152656753","chr9","91597425","91597714","34","61059038"
"chr1","152662673","152662791","chr3","59535512","59535636","23","93127161"
"chr1","152674369","152674680","chr1","160332533","160332842","62","7658164"
"chr1","152716331","152716612","chr9","91652048","91652328","56","61064283"
"chr1","152729170","152729470","chr9","91671870","91672164","35","61057300"
"chr1","152744254","152744558","chr9","91694047","91694335","58","61050207"
"chr1","152746908","152747204","chr9","91696718","91697015","38","61050190"
"chr1","152760220","152760332","chr6","14397538","14397657","22","138362682"
"chr1","152767506","152767781","chr3","140583382","140583663","59","12184124"
"chr1","152778565","152778860","chr9","91725273","91725585","46","61053292"
"chr1","152783030","152783304","chr6","91636326","91636609","71","61146704"
"chr1","152786641","152786810","chr1","9880179","9880343","38","142906462"
"chr1","152791178","152791486","chr9","91735973","91736284","44","61055205"
"chr1","152791730","152791953","chr5","52696452","52696680","49","100095278"
"chr1","152793110","152793390","chr5","139426874","139427147","58","13366236"
"chr1","152801982","152802095","chr9","91746687","91746807","13","61055295"
"chr1","152813248","152813412","chr22","24435516","24435686","39","128377732"
"chr1","152827805","152828097","chr19","29654539","29654825","52","123173266"
"chr1","152830632","152830931","chr9","91775517","91775819","53","61055115"
"chr1","152852654","152852939","chr9","91798435","91798720","30","61054219"
"chr1","152861924","152862195","chr9","108313768","108314055","83","44548156"
"chr1","152864534","152864824","chr1","54720418","54720702","65","98144116"
"chr1","152906045","152906340","chr9","91853141","91853434","45","61052904"
"chr1","152924947","152925131","chr15","23396259","23396443","39","129528688"
"chr1","152960674","152960942","chr1","205183384","205183667","63","52222710"
"chr1","152963817","152963928","chr9","91909520","91909629","14","61054297"
"chr1","152967751","152968051","chr9","91913606","91913901","42","61054145"
"chr1","153007601","153007904","chr9","91946952","91947250","51","61060649"
"chr1","153008486","153008782","chr16","43095644","43095939","63","109912842"
"chr1","153050311","153050576","chr9","91986049","91986338","54","61064262"
"chr1","153114412","153114711","chr3","58957473","58957766","71","94156939"
"chr1","153114745","153114891","chr12","103907179","103907319","45","49207566"
"chr1","153122432","153122743","chr9","92052049","92052358","55","61070383"
"chr1","153253264","153253407","chr8","8495688","8495834","39","144757576"
"chr1","153270810","153271110","chr9","92192735","92193030","34","61078075"
"chr1","153286769","153286910","chr1","32478284","32478418","34","120808485"
"chr1","153334171","153334442","chr5","997797","998069","60","152336374"
"chr1","153374788","153375094","chr9","92304866","92305171","54","61069922"
"chr1","153417339","153417502","chr5","51144248","51144411","35","102273091"
"chr1","153471388","153471495","chr1","28475167","28475273","19","124996221"
"chr1","153471602","153471883","chr4","2738910","2739200","83","150732692"
"chr1","153518232","153518536","chr21","24800389","24800693","51","128717843"
"chr1","153548154","153548462","chr9","92500897","92501182","61","61047257"
"chr1","153551556","153551886","chr19","13372106","13372431","66","140179450"
"chr1","153641102","153641341","chr3","49738899","49739127","56","103902203"
"chr1","153646599","153646886","chr9","92596920","92597200","61","61049679"
"chr1","153661968","153662262","chr9","92611310","92611601","29","61050658"
"chr1","153708908","153709031","chrX","70594684","70594808","25","83114224"
"chr1","153755842","153755956","chr9","92714929","92715046","14","61040913"
"chr1","153773649","153773944","chr9","92741261","92741542","31","61032388"
"chr1","153775863","153776176","chrX","19757362","19757679","71","134018501"
"chr1","153788093","153788413","chr3","50239937","50240261","118","103548156"
"chr1","153947929","153948234","chr13","73035185","73035482","58","80912744"
"chr1","153953246","153953400","chr1","188967838","188967994","29","35014592"
"chr1","153958866","153959153","chr9","92933333","92933624","55","61025533"
"chr1","153965399","153965704","chr9","92941309","92941616","41","61024090"
"chr1","154131118","154131402","chr5","36791239","36791527","66","117339879"
"chr1","154175854","154175977","chr9","14164360","14164484","17","140011494"
"chr1","154242914","154242996","chr11","106359869","106359951","23","47883045"
"chr1","154352476","154352779","chr1","85514015","85514311","65","68838461"
"chr1","154380235","154380547","chr9","93404425","93404717","58","60975810"
"chr1","154454553","154454670","chr9","93477317","93477443","20","60977236"
"chr1","154461194","154461324","chrX","54962735","54962865","21","99498459"
"chr1","154500990","154501303","chr9","93524344","93524639","53","60976646"
"chr1","154507615","154507750","chr12","32479446","32479581","27","122028169"
"chr1","154519628","154519718","chr14","54873414","54873500","25","99646214"
"chr1","154567072","154567173","chr9","93595351","93595452","9","60971721"
"chr1","154569037","154569238","chr1","147322624","147322822","46","7246413"
"chr1","154569666","154569787","chr9","93597600","93597720","10","60972066"
"chr1","154602184","154602463","chr8","119213440","119213724","54","35388744"
"chr1","154701329","154701496","chr7","79675726","79675893","26","75025603"
"chr1","154744584","154744846","chr9","93761781","93762056","39","60982803"
"chr1","154766335","154766595","chr5","59045335","59045595","63","95721000"
"chr1","154824732","154825025","chr9","93840928","93841231","41","60983804"
"chr1","154907843","154907923","chr9","93927507","93927587","18","60980336"
"chr1","154926592","154926721","chr9","93946723","93946841","20","60979869"
"chr1","154999434","154999747","chr9","94019863","94020163","52","60979571"
"chr1","155001153","155001427","chr9","94021576","94021861","53","60979577"
"chr1","155005200","155005474","chr9","94026460","94026732","32","60978740"
"chr1","155039949","155040095","chr3","51130162","51130304","37","103909787"
"chr1","155040162","155040237","chr7","74047710","74047783","11","80992452"
"chr1","155041614","155041924","chr1","180063335","180063645","59","25021721"
"chr1","155076788","155076890","chr9","94088719","94088816","17","60988069"
"chr1","155099147","155099263","chr9","94117946","94118069","19","60981201"
"chr1","155129530","155129834","chr9","94161912","94162199","65","60967618"
"chr1","155168004","155168289","chr9","94207868","94208148","40","60960136"
"chr1","155171876","155172016","chr1","32730027","32730168","36","122441849"
"chr1","155180434","155180655","chr9","94219039","94219255","28","60961395"
"chr1","155301226","155301295","chr12","123755259","123755337","18","31545967"
"chr1","155306431","155306743","chr4","84173798","84174105","60","71132633"
"chr1","155333239","155333526","chr9","94352389","94352694","41","60980850"
"chr1","155358250","155358379","chr9","94388113","94388242","11","60970137"
"chr1","155390593","155390722","chr9","94416764","94416894","9","60973829"
"chr1","155429201","155429313","chr16","48023200","48023306","29","107406001"
"chr1","155459518","155459771","chr18","9023248","9023495","63","146436270"
"chr1","155500478","155500808","chr9","94510901","94511241","40","60989577"
"chr1","155503332","155503477","chr20","4922306","4922451","27","150581026"
"chr1","155522529","155522666","chr9","94537302","94537440","15","60985227"
"chr1","155565655","155565941","chr9","107625580","107625871","63","47940075"
"chr1","155576144","155576433","chr9","94588754","94589055","41","60987390"
"chr1","155587953","155588224","chr9","94599259","94599536","49","60988694"
"chr1","155599879","155600199","chr9","94610507","94610807","52","60989372"
"chr1","155613217","155613465","chr9","94620179","94620429","28","60993038"
"chr1","155630944","155631217","chr5","39961684","39961962","55","115669260"
"chr1","155633048","155633334","chr9","94638856","94639157","42","60994192"
"chr1","155654421","155654482","chr1","139458147","139458202","17","16196274"
"chr1","155654903","155655131","chr9","94660614","94660828","45","60994289"
"chr1","155661916","155662184","chr9","94667288","94667570","39","60994628"
"chr1","155662184","155662406","chr9","94667571","94667797","31","60994613"
"chr1","155677006","155677302","chr9","94683747","94684053","55","60993259"
"chr1","155678308","155678436","chr18","75492763","75492883","34","80185545"
"chr1","155680129","155680252","chr1","24815947","24816071","20","130864182"
"chr1","155726215","155726332","chr9","94735117","94735234","12","60991098"
"chr1","155728377","155728692","chr9","94736994","94737286","60","60991383"
"chr1","155737707","155737978","chr10","130138881","130139148","64","25598826"
"chr1","155742771","155743056","chr9","94749836","94750141","52","60992935"
"chr1","155801640","155801823","chr1","183223511","183223687","45","27421871"
"chr1","155811567","155811719","chr19","5169265","5169417","32","150642302"
"chr1","155848407","155848682","chr7","5095566","5095848","60","150752841"
"chr1","155873983","155874240","chr9","94913040","94913289","40","60960943"
"chr1","155881342","155881653","chr9","94920292","94920603","36","60961050"
"chr1","155888593","155888900","chr3","58573842","58574144","72","97314751"
"chr1","155889763","155889921","chr14","72724722","72724884","31","83165041"
"chr1","155919786","155920095","chr9","94956658","94956968","31","60963128"
"chr1","155956262","155956340","chr9","94983938","94984021","9","60972324"
"chr1","155969475","155969777","chr6","153473499","153473782","71","2495976"
"chr1","155981880","155982161","chr9","95003373","95003659","38","60978507"
"chr1","155992069","155992312","chr9","95013596","95013862","49","60978473"
"chr1","156028109","156028227","chr9","95065872","95065996","19","60962237"
"chr1","156072642","156072932","chr9","95103236","95103513","40","60969406"
"chr1","156095056","156095293","chr10","39326084","39326320","54","116768972"
"chr1","156098358","156098656","chr9","95134763","95135063","63","60963595"
"chr1","156114383","156114685","chr9","95147831","95148140","45","60966552"
"chr1","156135024","156135227","chr9","95161454","95161657","28","60973570"
"chr1","156162584","156162884","chr9","95194002","95194331","56","60968582"
"chr1","156163402","156163612","chr1","183206609","183206818","40","27043207"
"chr1","156171323","156171604","chr9","95202486","95202772","41","60968837"
"chr1","156177818","156178099","chr9","95211529","95211825","35","60966289"
"chr1","156178935","156179232","chr16","19469295","19469595","63","136709640"
"chr1","156180075","156180376","chr3","17777511","17777806","69","138402564"
"chr1","156183651","156183760","chr9","95216557","95216669","9","60967094"
"chr1","156191022","156191319","chr9","95223156","95223445","30","60967866"
"chr1","156196603","156196726","chr9","95228567","95228690","13","60968036"
"chr1","156228103","156228216","chr6","37801775","37801890","17","118426328"
"chr1","156232828","156233159","chr5","117849116","117849402","97","38383712"
"chr1","156234004","156234163","chr8","73860998","73861155","38","82373006"
"chr1","156251747","156252046","chr9","95289376","95289689","47","60962371"
"chr1","156291667","156291955","chr9","95331109","95331393","34","60960558"
"chr1","156299528","156299719","chr9","95336862","95337050","21","60962666"
"chr1","156337730","156337821","chr11","93233737","93233830","20","63103993"
"chr1","156364227","156364538","chr9","95392165","95392457","54","60972062"
"chr1","156371468","156371808","chr9","95399194","95399519","57","60972274"
"chr1","156372104","156372354","chr9","95399822","95400072","37","60972282"
"chr1","156374323","156374613","chr9","95402221","95402514","70","60972102"
"chr1","156375175","156375458","chr9","95403068","95403361","46","60972107"
"chr1","156377182","156377328","chr6","36782155","36782293","39","119595027"
"chr1","156436604","156436889","chr9","95485461","95485754","46","60951143"
"chr1","156482616","156482925","chr6","110147312","110147624","50","46335304"
"chr1","156523961","156524264","chr9","95676298","95676603","36","60847663"
"chr1","156557870","156558013","chr9","95642678","95642820","17","60915192"
"chr1","156576933","156577236","chr9","95676298","95676603","38","60900635"
"chr1","156641615","156641870","chr19","50010806","50011072","60","106630809"
"chr1","156649078","156649331","chr9","95774131","95774406","38","60874947"
"chr1","156661417","156661758","chr1","111746820","111747135","81","44914597"
"chr1","156662482","156662798","chr9","95787800","95788096","52","60874682"
"chr1","156698093","156698189","chr9","95823383","95823479","14","60874710"
"chr1","156705414","156705589","chr11","48149026","48149195","50","108556388"
"chr1","156757064","156757297","chr9","95876813","95877050","37","60880251"
"chr1","156766425","156766656","chr7","78958687","78958912","54","77807738"
"chr1","156767191","156767256","chr18","1426253","1426315","15","155340938"
"chr1","156784275","156784397","chr10","18828471","18828593","16","137955804"
"chr1","156798762","156798905","chr5","29922331","29922474","36","126876431"
"chr1","156825616","156825729","chr19","14388120","14388239","18","142437496"
"chr1","156828885","156828998","chr14","47174431","47174547","18","109654454"
"chr1","156858256","156858566","chr9","95971703","95972007","47","60886553"
"chr1","156888818","156889135","chr9","96011708","96012023","33","60877110"
"chr1","156908566","156908860","chr9","96033142","96033440","42","60875424"
"chr1","156910508","156910686","chr1","184720130","184720300","40","27809622"
"chr1","156923082","156923323","chr10","25867381","25867626","57","131055701"
"chr1","157040230","157040545","chr9","96167486","96167789","50","60872744"
"chr1","157091077","157091339","chr9","96214947","96215202","31","60876130"
"chr1","157103423","157103538","chr1","224675871","224675985","19","67572448"
"chr1","157118242","157118483","chr17","20886878","20887094","50","136231364"
"chr1","157155666","157155823","chr9","96284950","96285110","15","60870716"
"chr1","157209583","157209692","chr16","5288189","5288299","24","151921394"
"chr1","157268739","157269024","chr9","96404014","96404311","43","60864725"
"chr1","157297796","157298088","chr9","96433411","96433718","47","60864385"
"chr1","157329626","157329869","chr9","96466232","96466493","36","60863394"
"chr1","157432077","157432342","chr9","96567967","96568236","43","60864110"
"chr1","157479019","157479314","chr9","96613926","96614220","31","60865093"
"chr1","157616804","157617087","chr8","73725770","73726054","48","83891034"
"chr1","157784082","157784311","chr9","97010673","97010951","71","60773409"
"chr1","157855950","157856243","chr9","97084305","97084610","54","60771645"
"chr1","157904315","157904629","chr9","97128676","97128981","53","60775639"
"chr1","157936377","157936691","chr12","118948112","118948410","69","38988265"
"chr1","157952388","157952694","chr9","97171580","97171900","52","60780808"
"chr1","157966478","157966742","chr16","21508031","21508289","63","136458447"
"chr1","157966783","157966910","chr9","97198469","97198592","22","60768314"
"chr1","157983457","157983541","chr4","158363458","158363540","20","380001"
"chr1","157989326","157989603","chr9","97222895","97223175","33","60766431"
"chr1","158005285","158005565","chr3","58326549","58326835","60","99678736"
"chr1","158007802","158008067","chr10","112825253","112825514","58","45182549"
"chr1","158016594","158016722","chr4","163028449","163028575","18","5011855"
"chr1","158019910","158020034","chr7","129330579","129330704","24","28689331"
"chr1","158030663","158030974","chr9","97253571","97253886","42","60777092"
"chr1","158056979","158057288","chr9","97280869","97281151","55","60776110"
"chr1","158066259","158066536","chr7","67797692","67797969","59","90268567"
"chr1","158145642","158145931","chr20","36316461","36316730","70","121829181"
"chr1","158339705","158339992","chr9","97532023","97532325","55","60807682"
"chr1","158373455","158373758","chr10","17607862","17608158","60","140765593"
"chr1","158390537","158390842","chr5","18788933","18789228","54","139601604"
"chr1","158709900","158710044","chr19","5169265","5169417","34","153540635"
"chr1","158733922","158734219","chr9","97900199","97900500","50","60833723"
"chr1","158957296","158957564","chr9","98157120","98157393","42","60800176"
"chr1","158959087","158959390","chr9","98158568","98158877","46","60800519"
"chr1","159015733","159016060","chr9","98213144","98213489","59","60802589"
"chr1","159459508","159459804","chr9","98595332","98595641","46","60864176"
"chr1","159705488","159705734","chr22","3237265","3237529","66","156468223"
"chr1","159819140","159819231","chr9","98991171","98991264","9","60827969"
"chr1","159831432","159831574","chr6","36782155","36782293","34","123049277"
"chr1","159915401","159915597","chr9","99083859","99084056","23","60831542"
"chr1","159950727","159950963","chr3","174459824","174460061","60","14509097"
"chr1","160002682","160003045","chr5","125383678","125383997","95","34619004"
"chr1","160058938","160059004","chr10","13656722","13656785","19","146402216"
"chr1","160059059","160059288","chr3","134709848","134710073","50","25349211"
"chr1","160091029","160091340","chrX","5484030","5484330","83","154606999"
"chr1","160161533","160161732","chr6","81713475","81713674","49","78448058"
"chr1","160275870","160276125","chr9","99432516","99432792","44","60843354"
"chr1","160311766","160312051","chr9","99473544","99473839","50","60838222"
"chr1","160316053","160316372","chr9","99477820","99478127","39","60838233"
"chr1","160341345","160341549","chr10","17903164","17903367","47","142438181"
"chr1","160346016","160346336","chr9","99506668","99506993","52","60839348"
"chr1","160358448","160358601","chr9","99519533","99519696","26","60838915"
"chr1","160421195","160421326","chr4","1284161","1284293","25","159137034"
"chr1","160534159","160534449","chr9","99679745","99680033","42","60854414"
"chr1","160638224","160638521","chr9","99779158","99779453","41","60859066"
"chr1","160724269","160724483","chr9","99863168","99863410","56","60861101"
"chr1","160881062","160881227","chr1","14800532","14800692","44","146080530"
"chr1","161039941","161040248","chr9","100173594","100173899","54","60866347"
"chr1","161047801","161048122","chr9","100181372","100181650","70","60866429"
"chr1","161064417","161064688","chr9","100198137","100198419","45","60866280"
"chr1","161073701","161073836","chr7","4493273","4493418","27","156580428"
"chr1","161518961","161519084","chrX","22996372","22996496","19","138522589"
"chr1","161525571","161525705","chr6","44927054","44927185","28","116598517"
"chr1","161608938","161609239","chr6","113451094","113451391","56","48157844"
"chr1","161654603","161654907","chr9","100845746","100846038","40","60808857"
"chr1","161747712","161748021","chr20","729693","730003","69","161018019"
"chr1","161958316","161958485","chr11","16757153","16757312","48","145201163"
"chr1","162071710","162072006","chr9","101273013","101273330","78","60798697"
"chr1","162102642","162102763","chr10","25079142","25079264","28","137023500"
"chr1","162164240","162164520","chr9","101346836","101347104","49","60817404"
"chr1","162265870","162266151","chr1","91059171","91059456","77","71206699"
"chr1","162292230","162292534","chr9","101500731","101501026","57","60791499"
"chr1","162320848","162321124","chr20","36316461","36316730","57","126004387"
"chr1","162521257","162521544","chr9","101737382","101737684","60","60783875"
"chr1","162689701","162689849","chr12","84561144","84561294","38","78128557"
"chr1","162757971","162758245","chr16","31489882","31490140","69","131268089"
"chr1","162930687","162930979","chr9","102131279","102131578","32","60799408"
"chr1","163097103","163097399","chr9","102292397","102292679","53","60804706"
"chr1","163223856","163224133","chr9","102410109","102410421","60","60813747"
"chr1","163307702","163308004","chr10","41661369","41661662","61","121646333"
"chr1","163454327","163454579","chr9","102636879","102637143","47","60817448"
"chr1","163744684","163744982","chr9","102922821","102923107","43","60821863"
"chr1","163914303","163914604","chr9","103098249","103098576","58","60816054"
"chr1","164003735","164003842","chr3","65778113","65778219","18","98225622"
"chr1","164051778","164051903","chr9","103249877","103250002","16","60801901"
"chr1","164094140","164094446","chr9","103286536","103286847","29","60807604"
"chr1","164135976","164136254","chr9","103328294","103328570","35","60807682"
"chr1","164170240","164170521","chr9","103363109","103363407","52","60807131"
"chr1","164170914","164171190","chr1","109988709","109988999","85","54182205"
"chr1","164172500","164172802","chr9","103365028","103365330","35","60807472"
"chr1","164176722","164176887","chr4","171210900","171211065","37","7034178"
"chr1","164213113","164213240","chr5","687856","687980","18","163525257"
"chr1","164249044","164249195","chr9","103432459","103432628","35","60816585"
"chr1","164271752","164272057","chr9","103457451","103457754","38","60814301"
"chr1","164348119","164348408","chr9","103516079","103516389","49","60832040"
"chr1","164389084","164389246","chr20","44858230","44858390","30","119530854"
"chr1","164392104","164392390","chr5","164101373","164101668","63","290731"
"chr1","164455494","164455709","chr19","50710233","50710443","53","113745261"
"chr1","164463813","164464068","chr9","103648032","103648282","42","60815781"
"chr1","164517325","164517591","chr9","103702283","103702536","34","60815042"
"chr1","164537001","164537295","chr9","103717841","103718141","37","60819160"
"chr1","164545770","164546055","chr9","103727685","103727963","47","60818085"
"chr1","164552038","164552333","chr14","74950919","74951212","63","89601119"
"chr1","164571684","164571978","chr4","135388417","135388716","76","29183267"
"chr1","164606546","164606833","chr2A","97057312","97057598","55","67549234"
"chr1","164655975","164656110","chr12","121653769","121653904","24","43002206"
"chr1","164743889","164744011","chr9","103925137","103925259","11","60818752"
"chr1","164796061","164796327","chr9","103979684","103979949","46","60816377"
"chr1","164808764","164809066","chr9","103991903","103992201","49","60816861"
"chr1","164825567","164825712","chr1","118874267","118874413","41","45951300"
"chr1","164828749","164828847","chr5","14549205","14549303","17","150279544"
"chr1","164873476","164873629","chr1","22298981","22299131","33","142574495"
"chr1","164888603","164888899","chr9","104072096","104072381","37","60816507"
"chr1","165004355","165004628","chr9","104202446","104202720","36","60801909"
"chr1","165009575","165009770","chr7","78056069","78056266","52","86953506"
"chr1","165021188","165021490","chr5","63928435","63928737","66","101092753"
"chr1","165030492","165030779","chr9","104240509","104240810","33","60789983"
"chr1","165080913","165081213","chr1","118660831","118661126","63","46420082"
"chr1","165094466","165094727","chr6","140953173","140953444","60","24141293"
"chr1","165185736","165186012","chr18","1313785","1314066","58","163871951"
"chr1","165217218","165217484","chr2A","37162582","37162851","60","128054636"
"chr1","165269100","165269350","chrX","10343138","10343395","57","154925962"
"chr1","165273447","165273717","chr9","104373700","104373978","28","60899747"
"chr1","165279352","165279615","chr18","6547502","6547765","56","158731850"
"chr1","165336263","165336545","chr8","49256423","49256714","59","116079840"
"chr1","165342439","165342736","chr1","227415933","227416230","58","62073494"
"chr1","165349181","165349499","chr9","104452385","104452692","42","60896796"
"chr1","165353870","165354076","chr2B","60285303","60285525","48","105068567"
"chr1","165417942","165418234","chr9","104522099","104522384","46","60895843"
"chr1","165588339","165588655","chr22","15546894","15547189","83","150041445"
"chr1","165600993","165601286","chr9","104704190","104704479","34","60896803"
"chr1","165624457","165624755","chr9","104727790","104728088","50","60896667"
"chr1","165648513","165648789","chr9","104749065","104749350","40","60899448"
"chr1","165649878","165650029","chr1","134652174","134652315","37","30997704"
"chr1","165776418","165776698","chr9","104870441","104870734","37","60905977"
"chr1","165790267","165790544","chr22","12099236","12099502","66","153691031"
"chr1","165832465","165832574","chr16","68805794","68805900","17","97026671"
"chr1","165922698","165922960","chr16","24479337","24479588","62","141443361"
"chr1","166008154","166008271","chr1","162178307","162178426","17","3829847"
"chr1","166018035","166018222","chr2B","134783878","134784074","48","31234157"
"chr1","166034295","166034514","chr9","105603454","105603680","30","60430841"
"chr1","166051530","166051825","chr9","105617541","105617849","34","60433989"
"chr1","166077268","166077513","chr9","105634492","105634751","41","60442776"
"chr1","166085831","166086022","chr9","105640100","105640296","26","60445731"
"chr1","166105111","166105399","chr9","105659381","105659677","38","60445730"
"chr1","166122037","166122251","chr1","94545356","94545569","44","71576681"
"chr1","166124933","166125047","chr9","105677904","105678024","17","60447029"
"chr1","166130816","166131130","chr9","105683840","105684143","44","60446976"
"chr1","166167436","166167745","chr9","105717545","105717848","50","60449891"
"chr1","166171592","166171875","chr9","105721213","105721528","54","60450379"
"chr1","166309239","166309527","chrX","39133182","39133470","57","127176057"
"chr1","166416755","166416815","chr2B","84663","84724","17","166332092"
"chr1","166462641","166462773","chrX","98370325","98370459","23","68092316"
"chr1","166506343","166506641","chr9","106003406","106003701","49","60502937"
"chr1","166606945","166607242","chr14","59664431","59664717","75","106942514"
"chr1","166659466","166659544","chrX","123657668","123657747","20","43001798"
"chr1","166674971","166675107","chr1","68709407","68709549","37","97965564"
"chr1","166726992","166727109","chr19","1361744","1361862","20","165365248"
"chr1","166727256","166727451","chr3","50933267","50933464","46","115793989"
"chr1","166749612","166749887","chr19","2739038","2739315","67","164010574"
"chr1","166777301","166777590","chr7","36337538","36337828","61","130439763"
"chr1","166869092","166869396","chr9","106411272","106411573","29","60457820"
"chr1","166889021","166889332","chr9","106429686","106429995","45","60459335"
"chr1","166889463","166889641","chr20","34004640","34004810","47","132884823"
"chr1","166897100","166897406","chr9","106437085","106437385","42","60460015"
"chr1","166978172","166978470","chr16","27339320","27339617","57","139638852"
"chr1","166989332","166989453","chr9","106535784","106535908","17","60453548"
"chr1","167014064","167014343","chr9","106564543","106564836","40","60449521"
"chr1","167043516","167043797","chr9","106596234","106596534","76","60447282"
"chr1","167058402","167058682","chr9","106612544","106612802","49","60445858"
"chr1","167060216","167060496","chr9","106613990","106614284","53","60446226"
"chr1","167128683","167128777","chr9","73497965","73498059","16","93630718"
"chr1","167134212","167134356","chr19","37526707","37526833","48","129607505"
"chr1","167134545","167134841","chr9","106690880","106691172","31","60443665"
"chr1","167147447","167147699","chr9","106704680","106704932","32","60442767"
"chr1","167147899","167148190","chr9","106705128","106705420","37","60442771"
"chr1","167166687","167166993","chr9","106726584","106726895","48","60440103"
"chr1","167172163","167172265","chr11","67337030","67337134","13","99835133"
"chr1","167217006","167217164","chr1","23183624","23183790","37","144033382"
"chr1","167304133","167304441","chr9","106863200","106863512","43","60440933"
"chr1","167312002","167312278","chr1","155024123","155024384","59","12287879"
"chr1","167337825","167337967","chr19","37746124","37746279","37","129591701"
"chr1","167364850","167365114","chr9","106925938","106926221","53","60438912"
"chr1","167383059","167383178","chr20","42362568","42362686","23","125020491"
"chr1","167435937","167436160","chr11","82561528","82561749","53","84874409"
"chr1","167537382","167537639","chr7","50363453","50363711","58","117173929"
"chr1","167537736","167537888","chr9","107098839","107098994","16","60438897"
"chr1","167659184","167659306","chr9","107212685","107212807","10","60446499"
"chr1","167686213","167686345","chr3","33691327","33691462","26","133994886"
"chr1","167686933","167687058","chr10","12650705","12650831","27","155036228"
"chr1","167715839","167716117","chr8","103638243","103638532","66","64077596"
"chr1","167716807","167717093","chr1","68093289","68093580","52","99623518"
"chr1","167753522","167753707","chr5","152603830","152604006","48","15149692"
"chr1","167758301","167758505","chr20","40480485","40480683","57","127277816"
"chr1","167763972","167764266","chr9","107317192","107317504","47","60446780"
"chr1","167770487","167770771","chr9","107323508","107323810","45","60446979"
"chr1","167807006","167807160","chr1","23727757","23727901","38","144079249"
"chr1","167845731","167846035","chr9","107398819","107399137","55","60446912"
"chr1","167863129","167863409","chr9","95392165","95392457","56","72470964"
"chr1","167885347","167885639","chr9","107440303","107440602","47","60445044"
"chr1","167895803","167896099","chr9","107449334","107449624","38","60446469"
"chr1","167900964","167901103","chr15","78004255","78004392","34","89896709"
"chr1","167914378","167914512","chr8","144957651","144957776","35","22956727"
"chr1","167944627","167944931","chr20","2655219","2655520","57","165289408"
"chr1","167970134","167970264","chr9","107529253","107529386","20","60440881"
"chr1","168019495","168019795","chr12","43802996","43803296","54","124216499"
"chr1","168048404","168048710","chr9","107614517","107614823","51","60433887"
"chr1","168064684","168064976","chr16","30950078","30950376","62","137114606"
"chr1","168110573","168110739","chr5","51144248","51144411","34","116966325"
"chr1","168196797","168197094","chr9","107771458","107771755","40","60425339"
"chr1","168218028","168218326","chr9","107792131","107792433","54","60425897"
"chr1","168229700","168230027","chr9","107805093","107805427","42","60424607"
"chr1","168246709","168246977","chr5","79883377","79883636","63","88363332"
"chr1","168249209","168249493","chr12","32032110","32032393","56","136217099"
"chr1","168273857","168274134","chr9","107845581","107845864","32","60428276"
"chr1","168361191","168361319","chr10","25121161","25121285","19","143240030"
"chr1","168406184","168406463","chr5","38174480","38174763","57","130231704"
"chr1","168409791","168409993","chr9","108004448","108004663","38","60405343"
"chr1","168417438","168417749","chr9","108010591","108010891","51","60406847"
"chr1","168418959","168419249","chr9","108012136","108012440","44","60406823"
"chr1","168434891","168435148","chr10","97916927","97917190","66","70517964"
"chr1","168445330","168445448","chr9","108031189","108031307","9","60414141"
"chr1","168462972","168463111","chr7","65637766","65637894","31","102825206"
"chr1","168468135","168468438","chr9","108063245","108063541","52","60404890"
"chr1","168501524","168501821","chr1","17177063","17177349","71","151324461"
"chr1","168518650","168518923","chr9","108112935","108113225","55","60405715"
"chr1","168521006","168521142","chr7","26158438","26158564","31","142362568"
"chr1","168533213","168533529","chr9","108124989","108125300","50","60408224"
"chr1","168534090","168534379","chr9","108125672","108125966","37","60408418"
"chr1","168537199","168537372","chr17","26409381","26409548","40","142127818"
"chr1","168599260","168599566","chr9","108206333","108206637","37","60392927"
"chr1","168656094","168656260","chr6","162551622","162551785","40","6104472"
"chr1","168656506","168656635","chr9","108257045","108257177","22","60399461"
"chr1","168733004","168733289","chr9","108337934","108338202","59","60395070"
"chr1","168739581","168739856","chr3","140823475","140823736","64","27916106"
"chr1","168765568","168765733","chr3","10866047","10866211","39","157899521"
"chr1","168777695","168777983","chr6","160957547","160957837","70","7820148"
"chr1","168785502","168785748","chr9","108374163","108374412","33","60411339"
"chr1","168798509","168798799","chr9","108387014","108387303","24","60411495"
"chr1","168815360","168815660","chr14","48403355","48403647","52","120412005"
"chr1","168821056","168821181","chr9","108426286","108426411","15","60394770"
"chr1","168839405","168839682","chr11","43753371","43753651","66","125086034"
"chr1","168848062","168848320","chr17","89620209","89620446","79","79227853"
"chr1","168853701","168853974","chr7","1708256","1708538","57","167145445"
"chr1","168913793","168914062","chr9","108506589","108506872","55","60407204"
"chr1","168927316","168927446","chr2B","60771641","60771760","35","108155675"
"chr1","168931709","168931870","chrX","130137391","130137550","40","38794318"
"chr1","168937071","168937368","chr12","120444345","120444641","66","48492726"
"chr1","168947069","168947345","chr9","68772874","68773157","59","100174195"
"chr1","168989034","168989220","chr9","108576803","108577000","28","60412231"
"chr1","169001586","169001867","chr19","2117277","2117563","55","166884309"
"chr1","169005068","169005182","chr9","108594642","108594756","6","60410426"
"chr1","169008534","169008827","chr11","93771848","93772142","66","75236686"
"chr1","169010764","169011055","chr9","108598743","108599073","69","60412021"
"chr1","169068522","169068788","chr9","108659054","108659353","64","60409468"
"chr1","169069981","169070089","chr9","108657443","108657565","18","60412538"
"chr1","169095905","169096155","chr3","13810051","13810291","64","155285854"
"chr1","169113416","169113604","chr20","13871202","13871372","47","155242214"
"chr1","169124508","169124645","chr5","93805099","93805228","31","75319409"
"chr1","169125223","169125518","chr9","108718598","108718906","54","60406625"
"chr1","169126955","169127234","chr9","108720205","108720478","56","60406750"
"chr1","169168237","169168394","chr15","67737918","67738076","42","101430319"
"chr1","169195010","169195315","chr15","1818448","1818748","59","167376562"
"chr1","169211265","169211382","chr16","25391347","25391463","13","143819918"
"chr1","169211512","169211822","chr5","140931146","140931451","59","28280366"
"chr1","169212164","169212398","chr15","70139169","70139407","53","99072995"
"chr1","169216396","169216698","chr8","49256423","49256714","50","119959973"
"chr1","169221121","169221253","chr5","124432264","124432393","24","44788857"
"chr1","169235353","169235626","chr9","108818980","108819270","45","60416373"
"chr1","169236485","169236616","chr3","59117856","59117982","21","110118629"
"chr1","169255674","169255873","chr9","108840447","108840646","31","60415227"
"chr1","169300716","169300833","chr9","108894770","108894890","18","60405946"
"chr1","169330033","169330305","chr9","108930005","108930277","22","60400028"
"chr1","169333730","169333859","chr2A","104115777","104115903","21","65217953"
"chr1","169336880","169337165","chr9","108938852","108939101","66","60398028"
"chr1","169346430","169346690","chr9","108948937","108949206","67","60397493"
"chr1","169347654","169347955","chr9","108949879","108950151","69","60397775"
"chr1","169364252","169364526","chr9","108968051","108968328","32","60396201"
"chr1","169405097","169405384","chr9","109005586","109005863","49","60399511"
"chr1","169424347","169424632","chr15","59606084","59606377","64","109818263"
"chr1","169515731","169516013","chr12","123096820","123097105","53","46418911"
"chr1","169520885","169521149","chr22","8311524","8311782","67","161209361"
"chr1","169603127","169603230","chr5","22128933","22129035","18","147474194"
"chr1","169616650","169616795","chr5","156687101","156687239","36","12929549"
"chr1","169619963","169620210","chr9","109215911","109216183","48","60404052"
"chr1","169711278","169711389","chr18","953349","953460","30","168757929"
"chr1","169743096","169743353","chr5","163833147","163833399","74","5909949"
"chr1","169789652","169789925","chr3","135595373","135595651","59","34194279"
"chr1","169808780","169808950","chr19","16879306","16879475","25","152929474"
"chr1","169846683","169846973","chr16","57006861","57007152","58","112839822"
"chr1","169928845","169929099","chr9","109486844","109487104","38","60442001"
"chr1","169962187","169962442","chr9","109523719","109523976","20","60438468"
"chr1","169986217","169986512","chr9","109545162","109545468","49","60441055"
"chr1","169989631","169989760","chr3","187172507","187172634","36","17182876"
"chr1","170008894","170009039","chr9","43167512","43167660","31","126841382"
"chr1","170084852","170085035","chr22","14051804","14052003","41","156033048"
"chr1","170126631","170126926","chr9","109692333","109692638","53","60434298"
"chr1","170172021","170172241","chr2B","124612315","124612533","47","45559706"
"chr1","170184182","170184314","chr16","12003452","12003583","21","158180730"
"chr1","170184326","170184395","chr16","25652983","25653050","24","144531343"
"chr1","170187860","170188135","chr12","123096820","123097105","62","47091040"
"chr1","170190098","170190336","chr3","153945061","153945310","73","16245037"
"chr1","170335331","170335612","chr1","210738129","210738412","60","40402798"
"chr1","170355789","170355922","chr9","109909177","109909311","21","60446612"
"chr1","170434113","170434251","chr6","18588428","18588554","33","151845685"
"chr1","170469036","170469363","chr9","107289367","107289687","78","63179669"
"chr1","170475284","170475574","chr1","227415933","227416230","55","56940649"
"chr1","170480933","170481231","chr3","143449072","143449369","59","27031861"
"chr1","170628979","170629209","chr1","217294594","217294821","47","46665615"
"chr1","170659038","170659196","chr14","58580963","58581123","33","112078075"
"chr1","170659444","170659566","chr1","46141139","46141264","32","124518305"
"chr1","170710144","170710439","chr12","121913892","121914192","51","48796252"
"chr1","170797472","170797564","chr12","33255012","33255105","25","137542460"
"chr1","170825955","170826248","chrX","19199530","19199816","63","151626425"
"chr1","170857218","170857363","chr7","28901497","28901635","28","141955721"
"chr1","170934061","170934207","chr9","110484126","110484271","26","60449935"
"chr1","170942085","170942373","chr9","110492194","110492478","31","60449891"
"chr1","170952337","170952572","chr10","139830648","139830887","60","31121689"
"chr1","171097679","171097960","chr9","110658182","110658464","44","60439497"
"chr1","171130306","171130604","chr9","110683573","110683879","39","60446733"
"chr1","171133322","171133468","chr5","40623768","40623915","28","130509554"
"chr1","171162361","171162680","chr9","110714147","110714448","53","60448214"
"chr1","171163785","171164056","chr9","110715544","110715806","43","60448241"
"chr1","171231647","171231780","chr9","110772368","110772501","13","60459279"
"chr1","171242649","171242753","chr7","130946373","130946473","26","40296276"
"chr1","171280146","171280314","chr5","62885644","62885808","48","108394502"
"chr1","171295201","171295326","chr10","88849823","88849949","21","82445378"
"chr1","171298230","171298355","chr10","88849823","88849949","21","82448407"
"chr1","171299806","171299920","chr1","32298703","32298816","19","139001103"
"chr1","171317722","171317866","chr1","68709407","68709549","34","102608315"
"chr1","171334147","171334278","chr14","59241749","59241879","20","112092398"
"chr1","171364312","171364420","chr6","37801775","37801890","24","133562537"
"chr1","171385072","171385340","chr6","154214606","154214866","67","17170466"
"chr1","171390628","171390791","chr6","15264957","15265121","28","156125671"
"chr1","171429988","171430283","chr4","162741400","162741665","69","8688588"
"chr1","171430360","171430544","chr15","23396259","23396443","37","148034101"
"chr1","171494176","171494483","chr14","84069529","84069831","65","87424647"
"chr1","171500285","171500480","chr9","111055276","111055449","38","60445009"
"chr1","171501757","171501885","chr12","29897183","29897312","24","141604574"
"chr1","171504388","171504665","chr21","28347900","28348179","59","143156488"
"chr1","171511158","171511483","chr4","165854546","165854834","103","5656612"
"chr1","171524707","171524812","chr8","2348531","2348635","25","169176176"
"chr1","171577935","171578017","chr20","7957406","7957489","13","163620529"
"chr1","171624189","171624429","chr9","111177400","111177649","37","60446789"
"chr1","171687286","171687551","chr14","56411872","56412145","70","115275414"
"chr1","171730399","171730662","chr19","16930672","16930946","59","154799727"
"chr1","171734132","171734206","chr10","50433693","50433769","12","121300439"
"chr1","171734680","171734832","chr9","23434201","23434353","36","148300479"
"chr1","171766876","171766983","chr3","124234294","124234409","26","47532582"
"chr1","171782062","171782314","chr8","26824011","26824266","61","144958051"
"chr1","171824197","171824413","chr7","148348401","148348614","50","23475796"
"chr1","171913838","171913955","chr8","108964883","108965000","19","62948955"
"chr1","171944091","171944379","chr14","44842497","44842783","65","127101594"
"chr1","171949400","171949687","chr5","63163254","63163546","54","108786146"
"chr1","171950270","171950376","chr7","62465679","62465785","27","109484591"
"chr1","171954448","171954565","chr9","111483436","111483553","9","60471012"
"chr1","171969050","171969201","chr14","10155920","10156077","28","161813130"
"chr1","171976441","171976600","chr7","79271528","79271684","31","92704913"
"chr1","172016318","172016597","chr9","111549342","111549632","51","60466976"
"chr1","172053653","172053938","chr15","5858427","5858717","55","166195226"
"chr1","172063114","172063374","chr12","64769409","64769680","63","107293705"
"chr1","172104946","172105294","chr3","189139960","189140297","97","17035014"
"chr1","172145783","172145907","chr8","101452679","101452803","15","70693104"
"chr1","172146545","172146706","chr22","20635435","20635596","28","151511110"
"chr1","172164174","172164287","chr9","111707051","111707173","16","60457123"
"chr1","172164608","172164728","chr4","112780763","112780884","19","59383845"
"chr1","172172999","172173307","chr12","132649388","132649693","65","39523611"
"chr1","172204574","172204806","chr2B","51397947","51398186","50","120806627"
"chr1","172224751","172224840","chr2B","74186352","74186439","13","98038399"
"chr1","172229260","172229530","chr4","200891825","200892096","70","28662565"
"chr1","172242374","172242525","chr7","130371217","130371368","32","41871157"
"chr1","172243505","172243616","chr1","39325820","39325928","23","132917685"
"chr1","172343582","172343782","chr11","7277099","7277287","61","165066483"
"chr1","172357017","172357294","chr1","7780893","7781182","60","164576124"
"chr1","172376096","172376442","chr7","157165268","157165598","69","15210828"
"chr1","172394446","172394578","chr13","31826426","31826561","28","140568020"
"chr1","172395363","172395502","chr3","144565076","144565219","33","27830287"
"chr1","172396169","172396283","chr6","36093674","36093792","19","136302495"
"chr1","172423155","172423325","chr9","111948543","111948720","31","60474612"
"chr1","172427106","172427414","chr3","48227902","48228204","58","124199204"
"chr1","172431807","172431963","chr15","28613492","28613648","34","143818315"
"chr1","172434760","172434833","chr7","110713195","110713268","12","61721565"
"chr1","172447126","172447282","chr7","2387634","2387796","37","170059492"
"chr1","172454336","172454425","chr3","3160236","3160328","18","169294100"
"chr1","172459490","172459815","chr1","132973247","132973559","75","39486243"
"chr1","172467690","172467908","chr5","45579962","45580181","42","126887728"
"chr1","172485855","172485998","chr2B","126639395","126639541","29","45846460"
"chr1","172528452","172528580","chr9","47369076","47369207","21","125159376"
"chr1","172534889","172535181","chr9","112052944","112053267","66","60481945"
"chr1","172579083","172579342","chr3","48014309","48014562","56","124564774"
"chr1","172596601","172596772","chr7","137814342","137814508","36","34782259"
"chr1","172599347","172599473","chr10","112243800","112243926","30","60355547"
"chr1","172601702","172601973","chr15","51341922","51342201","69","121259780"
"chr1","172603931","172604201","chr9","112116695","112116967","42","60487236"
"chr1","172614024","172614365","chr1","227415933","227416230","103","54801909"
"chr1","172685564","172685742","chr22","25490059","25490239","33","147195505"
"chr1","172696436","172696565","chr1","109948107","109948236","18","62748329"
"chr1","172721399","172721564","chr20","44858230","44858390","31","127863169"
"chr1","172722176","172722275","chr9","112252272","112252374","14","60469904"
"chr1","172786857","172787014","chr11","65955607","65955759","33","106831250"
"chr1","172794636","172794751","chr18","57245881","57245993","28","115548755"
"chr1","172795216","172795399","chr8","98909960","98910147","35","73885256"
"chr1","172799102","172799389","chr9","112342736","112343022","58","60456366"
"chr1","172800115","172800374","chr4","169077403","169077661","59","3722712"
"chr1","172834304","172834611","chr5","96942875","96943163","75","75891429"
"chr1","172886558","172886859","chr8","142639267","142639561","68","30247291"
"chr1","172898362","172898658","chr9","112440383","112440679","56","60457979"
"chr1","172899311","172899596","chr9","112441336","112441619","60","60457975"
"chr1","172900641","172900786","chr9","112442514","112442655","21","60458127"
"chr1","172907746","172907894","chr3","131060432","131060584","39","41847314"
"chr1","172929702","172929772","chr22","26263377","26263447","15","146666325"
"chr1","172973813","172973938","chr19","44130576","44130707","20","128843237"
"chr1","173010744","173010873","chr9","112549317","112549449","12","60461427"
"chr1","173128398","173128651","chr9","112616437","112616693","30","60511961"
"chr1","173130578","173130846","chr9","112618662","112618927","47","60511916"
"chr1","173145729","173145835","chr4","196402447","196402553","20","23256718"
"chr1","173148081","173148367","chr17","78401865","78402148","52","94746216"
"chr1","173158735","173158852","chr9","91203145","91203259","17","81955590"
"chr1","173195288","173195598","chr9","112736755","112737071","45","60458533"
"chr1","173207942","173208262","chr1","35310984","35311311","91","137896958"
"chr1","173212108","173212404","chr1","7654423","7654722","61","165557685"
"chr1","173227804","173227949","chr7","77554623","77554768","29","95673181"
"chr1","173243365","173243494","chr7","133945804","133945932","21","39297561"
"chr1","173248947","173249240","chr9","112781651","112781946","34","60467296"
"chr1","173285454","173285781","chr9","112816772","112817101","44","60468682"
"chr1","173301418","173301688","chr9","112832793","112833085","55","60468625"
"chr1","173318873","173319042","chr15","48793529","48793684","42","124525344"
"chr1","173328439","173328728","chr5","117495376","117495645","70","55833063"
"chr1","173337143","173337225","chr9","112863837","112863920","13","60473306"
"chr1","173407358","173407607","chr9","112935780","112936041","36","60471578"
"chr1","173410707","173410859","chr1","68709407","68709549","33","104701300"
"chr1","173507617","173507915","chr12","6358294","6358591","62","167149323"
"chr1","173515565","173515697","chr7","26158438","26158564","28","147357127"
"chr1","173516364","173516657","chr1","227415933","227416230","67","53899569"
"chr1","173517985","173518279","chr9","113037716","113038019","41","60480269"
"chr1","173519187","173519315","chr20","30238448","30238572","21","143280739"
"chr1","173603276","173603385","chr9","113124674","113124790","18","60478602"
"chr1","173608840","173609040","chr22","31924605","31924798","53","141684235"
"chr1","173610815","173611063","chr9","113131256","113131504","23","60479559"
"chr1","173684819","173685098","chr9","113200451","113200746","42","60484368"
"chr1","173777117","173777406","chr14","10214536","10214827","66","163562581"
"chr1","173800067","173800279","chr9","113308983","113309195","33","60491084"
"chr1","173826298","173826537","chr4","41166281","41166533","56","132660017"
"chr1","173829430","173829733","chr12","54439061","54439357","90","119390369"
"chr1","173839059","173839327","chr14","22175096","22175370","58","151663963"
"chr1","173853218","173853352","chrX","2794957","2795096","32","171058261"
"chr1","173912294","173912520","chr11","8985766","8985986","54","164926528"
"chr1","173918114","173918396","chr9","113432269","113432569","41","60485845"
"chr1","173935057","173935370","chr7","76616805","76617110","66","97318252"
"chr1","173972148","173972447","chr9","113486023","113486331","45","60486125"
"chr1","173981063","173981349","chr3","9343044","9343335","61","164638019"
"chr1","174009211","174009315","chr9","113522635","113522739","10","60486576"
"chr1","174016278","174016584","chr9","113529449","113529760","48","60486829"
"chr1","174028236","174028521","chr1","189902282","189902563","54","15874046"
"chr1","174060548","174060849","chr9","113563026","113563337","67","60497522"
"chr1","174082014","174082299","chr22","19585665","19585957","64","154496349"
"chr1","174098718","174098877","chr1","17427941","17428102","36","156670777"
"chr1","174112184","174112311","chr17","16125182","16125306","19","157987002"
"chr1","174112341","174112662","chr3","150127743","150128060","84","23984598"
"chr1","174114276","174114565","chr9","113621391","113621668","37","60492885"
"chr1","174158601","174158931","chr9","113668100","113668433","49","60490501"
"chr1","174175040","174175188","chr1","45150496","45150639","32","129024544"
"chr1","174202787","174203083","chr9","113711525","113711816","28","60491262"
"chr1","174203869","174204011","chr14","22486801","22486939","38","151717068"
"chr1","174228661","174228885","chr3","33206295","33206521","43","141022366"
"chr1","174302015","174302250","chr9","114615846","114616073","61","59686169"
"chr1","174365293","174365451","chr9","113779755","113779931","39","60585538"
"chr1","174395261","174395482","chr9","113807290","113807518","29","60587971"
"chr1","174427933","174428135","chrX","70798785","70798992","53","103629148"
"chr1","174438453","174438765","chr9","113827247","113827562","33","60611206"
"chr1","174491548","174491810","chr9","113876250","113876527","48","60615298"
"chr1","174492590","174492877","chr9","113877316","113877622","45","60615274"
"chr1","174495525","174495830","chr9","113880259","113880565","28","60615266"
"chr1","174510336","174510578","chr15","13903143","13903377","68","160607193"
"chr1","174510998","174511207","chr9","113893853","113894067","27","60617145"
"chr1","174645905","174646093","chr2B","53444415","53444599","53","121201490"
"chr1","174652176","174652307","chr9","114010465","114010595","21","60641711"
"chr1","174683380","174683497","chr14","80502510","80502627","19","94180870"
"chr1","174685280","174685573","chr22","24598382","24598677","58","150086898"
"chr1","174701795","174701902","chr9","114050761","114050871","19","60651034"
"chr1","174703820","174703983","chr22","18949009","18949179","38","155754811"
"chr1","174761919","174762224","chr9","114110396","114110705","44","60651523"
"chr1","174792910","174793181","chr9","92202923","92203198","66","82589987"
"chr1","174832886","174833133","chr9","114186997","114187251","56","60645889"
"chr1","174857171","174857472","chr1","227415933","227416230","55","52558762"
"chr1","174869946","174870066","chr4","72250506","72250629","21","102619440"
"chr1","174892813","174893095","chr3","71140834","71141113","56","103751979"
"chr1","174893798","174893878","chr9","114242305","114242382","7","60651493"
"chr1","174912805","174913102","chr6","169320865","169321152","83","5591940"
"chr1","174923861","174924144","chr9","114282249","114282532","41","60641612"
"chr1","174960467","174960744","chr13","9475981","9476254","72","165484486"
"chr1","175055315","175055482","chr1","46347211","46347384","41","128708104"
"chr1","175060773","175061100","chr19","18083884","18084197","85","156976889"
"chr1","175080200","175080269","chr7","72484245","72484312","22","102595955"
"chr1","175087757","175088050","chr9","114433821","114434122","43","60653936"
"chr1","175129015","175129316","chr9","114476539","114476837","39","60652476"
"chr1","175136298","175136593","chr9","114483046","114483331","42","60653252"
"chr1","175144701","175144996","chr9","114490905","114491222","57","60653796"
"chr1","175178553","175178792","chrX","55077182","55077423","62","120101371"
"chr1","175207481","175207753","chr5","77703498","77703786","66","97503983"
"chr1","175264302","175264568","chr7","128027283","128027543","49","47237019"
"chr1","175280260","175280570","chr9","114637465","114637769","52","60642795"
"chr1","175318293","175318572","chr15","49507629","49507914","62","125810664"
"chr1","175322295","175322605","chr9","114675984","114676278","49","60646311"
"chr1","175380005","175380255","chr9","114743352","114743626","47","60636653"
"chr1","175429466","175429590","chr13","31826426","31826561","34","143603040"
"chr1","175430519","175430727","chr19","10916881","10917096","45","164513638"
"chr1","175454530","175454833","chr9","114824515","114824823","37","60630015"
"chr1","175499118","175499406","chr16","30796207","30796494","69","144702911"
"chr1","175512641","175512799","chr10","49585047","49585201","35","125927594"
"chr1","175513060","175513179","chr9","114903647","114903775","18","60609413"
"chr1","175544196","175544290","chr5","138834799","138834894","20","36709397"
"chr1","175617983","175618272","chr20","6888393","6888681","59","168729590"
"chr1","175629532","175629633","chr16","68805794","68805900","19","106823738"
"chr1","175630021","175630174","chr15","38005326","38005481","44","137624695"
"chr1","175651068","175651191","chr22","3302139","3302269","27","172348929"
"chr1","175677826","175678017","chr15","4514901","4515083","41","171162925"
"chr1","175699403","175699642","chr9","115106014","115106250","30","60593389"
"chr1","175729186","175729282","chr3","141171020","141171103","28","34558166"
"chr1","175785120","175785397","chr19","29654539","29654825","70","146130581"
"chr1","175796629","175796848","chr9","115236474","115236690","43","60560155"
"chr1","175828564","175828872","chr9","115269894","115270213","40","60558670"
"chr1","175829534","175829818","chr9","115270993","115271299","53","60558541"
"chr1","175956270","175956557","chr9","115381726","115382027","41","60574544"
"chr1","175992000","175992240","chr9","115417873","115418132","57","60574127"
"chr1","176080912","176081147","chr19","37794171","37794401","53","138286741"
"chr1","176123095","176123390","chr9","115548419","115548717","34","60574676"
"chr1","176173614","176173772","chr4","40325999","40326159","36","135847615"
"chr1","176177771","176178073","chr3","140583382","140583663","82","35594389"
"chr1","176181127","176181387","chr9","115613635","115613896","35","60567492"
"chr1","176208343","176208494","chr1","43058775","43058926","40","133149568"
"chr1","176223717","176224007","chr9","115650733","115651023","26","60572984"
"chr1","176279795","176280081","chr9","115708669","115708953","37","60571126"
"chr1","176376279","176376567","chr9","115797569","115797868","43","60578710"
"chr1","176385210","176385509","chr9","115813336","115813639","27","60571874"
"chr1","176424839","176425058","chr12","118865454","118865663","54","57559385"
"chr1","176453448","176453725","chr2B","75840781","75841056","59","100612667"
"chr1","176456717","176456956","chr1","182827858","182828098","55","6371141"
"chr1","176481980","176482268","chr9","115905926","115906209","39","60576054"
"chr1","176512993","176513293","chr9","115935434","115935749","54","60577559"
"chr1","176578369","176578655","chr9","115999316","115999631","60","60579053"
"chr1","176606741","176606995","chr9","116026935","116027185","29","60579806"
"chr1","176635499","176635702","chr6","91869790","91870005","38","84765709"
"chr1","176638289","176638401","chr7","63270574","63270690","20","113367715"
"chr1","176750122","176750414","chr5","26154281","26154566","55","150595841"
"chr1","176824097","176824390","chr9","116242870","116243158","45","60581227"
"chr1","176827551","176827704","chr18","18262050","18262192","38","158565501"
"chr1","176917017","176917196","chr1","130297384","130297555","47","46619633"
"chr1","176929774","176930072","chr9","116304909","116305222","37","60624865"
"chr1","176933696","176933979","chr9","34098327","34098616","60","142835369"
"chr1","177013834","177014121","chr9","116386070","116386370","30","60627764"
"chr1","177036432","177036736","chr9","116410874","116411181","51","60625558"
"chr1","177050677","177050932","chr9","116424623","116424899","51","60626054"
"chr1","177051344","177051642","chr1","227415933","227416230","56","50364589"
"chr1","177053009","177053236","chr14","38177392","38177606","60","138875617"
"chr1","177055645","177055812","chr1","209026756","209026919","36","31971111"
"chr1","177060616","177060927","chr9","116451521","116451828","41","60609095"
"chr1","177066488","177066801","chr9","116457100","116457411","50","60609388"
"chr1","177078553","177078643","chr20","10565694","10565786","12","166512859"
"chr1","177078812","177079021","chr7","30342540","30342745","52","146736272"
"chr1","177112538","177112849","chr9","116501800","116502118","37","60610738"
"chr1","177131144","177131424","chr9","116535445","116535761","55","60595699"
"chr1","177132999","177133254","chr1","9577323","9577580","64","167555676"
"chr1","177259274","177259546","chr9","116651844","116652117","37","60607430"
"chr1","177283980","177284198","chr19","18271347","18271565","64","159012633"
"chr1","177337617","177337931","chr13","2140798","2141104","66","175196819"
"chr1","177359635","177359928","chr9","116747461","116747755","46","60612174"
"chr1","177390710","177390957","chr11","32996546","32996817","76","144394164"
"chr1","177418570","177418829","chr9","116790852","116791115","38","60627718"
"chr1","177430725","177430918","chr9","116771547","116771744","31","60659178"
"chr1","177433268","177433546","chr9","116769272","116769581","57","60663996"
"chr1","177449618","177449877","chr9","10985253","10985514","65","166464365"
"chr1","177502660","177502806","chr9","116893494","116893633","25","60609166"
"chr1","177519869","177520165","chr9","116913128","116913431","41","60606741"
"chr1","177544225","177544517","chr8","26781712","26781997","71","150762513"
"chr1","177555205","177555510","chr12","43802996","43803296","60","133752209"
"chr1","177589545","177589674","chr20","61211065","61211200","32","116378480"
"chr1","177598804","177599107","chr9","116983958","116984259","41","60614846"
"chr1","177636053","177636335","chr9","117023234","117023513","39","60612819"
"chr1","177740481","177740755","chr9","117129196","117129484","37","60611285"
"chr1","177835697","177836006","chr18","55552997","55553303","63","122282700"
"chr1","177875081","177875385","chr9","117264200","117264508","46","60610881"
"chr1","177995400","177995699","chr9","117372873","117373185","46","60622527"
"chr1","178043196","178043326","chr9","117425025","117425161","23","60618171"
"chr1","178154377","178154549","chr8","98557445","98557616","39","79596932"
"chr1","178155438","178155678","chr9","117549908","117550147","31","60605530"
"chr1","178171938","178172143","chr1","28313248","28313460","65","149858690"
"chr1","178201760","178201876","chr6","25416407","25416521","15","152785353"
"chr1","178242224","178242512","chr9","117642017","117642305","54","60600207"
"chr1","178260125","178260443","chr8","60636630","60636912","91","117623495"
"chr1","178295436","178295712","chr16","65843164","65843438","71","112452272"
"chr1","178296722","178296882","chr12","123366786","123366946","32","54929936"
"chr1","178323863","178324020","chr9","114558735","114558891","31","63765128"
"chr1","178388142","178388422","chr9","117769461","117769748","41","60618681"
"chr1","178403024","178403310","chr9","117783952","117784242","38","60619072"
"chr1","178619000","178619171","chr7","96747376","96747548","38","81871624"
"chr1","178674821","178675095","chr9","118057509","118057797","46","60617312"
"chr1","179559774","179560073","chr9","118900330","118900624","39","60659444"
"chr1","179624621","179624919","chr9","118996590","118996903","38","60628031"
"chr1","179652407","179652719","chr2A","62868142","62868438","67","116784265"
"chr1","179731030","179731289","chr14","84062484","84062754","51","95668546"
"chr1","179776680","179776897","chr9","119130361","119130577","29","60646319"
"chr1","179825801","179825924","chr1","21719374","21719497","24","158106427"
"chr1","179865493","179865787","chr9","119246054","119246356","37","60619439"
"chr1","179881675","179881961","chr7","73176547","73176832","62","106705128"
"chr1","179975311","179975390","chr9","119362413","119362492","7","60612898"
"chr1","179984502","179984634","chr3","131714172","131714304","25","48270330"
"chr1","180020575","180020858","chr9","119400367","119400651","33","60620208"
"chr1","180038370","180038665","chr8","98967491","98967789","51","81070879"
"chr1","180051546","180051782","chr16","24243301","24243544","54","155808245"
"chr1","180061837","180061943","chr5","26761731","26761826","30","153300106"
"chr1","180064909","180065200","chr9","119435888","119436176","45","60629021"
"chr1","180067618","180067926","chr9","119439446","119439750","37","60628172"
"chr1","180102990","180103263","chr19","17000555","17000830","60","163102435"
"chr1","180121096","180121398","chr10","137156788","137157075","66","42964308"
"chr1","180139691","180139979","chr9","119513843","119514121","45","60625848"
"chr1","180153514","180153664","chr16","38955159","38955317","42","141198355"
"chr1","180194750","180195054","chr7","66774175","66774478","50","113420575"
"chr1","180213334","180213504","chr19","5318412","5318579","38","174894922"
"chr1","180263052","180263308","chr4","199241173","199241439","68","18978121"
"chr1","180269063","180269366","chr9","119638508","119638818","62","60630555"
"chr1","180271016","180271178","chr16","58805438","58805600","28","121465578"
"chr1","180314544","180314836","chr9","119692022","119692303","61","60622522"
"chr1","180353054","180353365","chr9","119725344","119725639","53","60627710"
"chr1","180421107","180421223","chr1","94267623","94267739","14","86153484"
"chr1","180442518","180442806","chr15","18815160","18815448","59","161627358"
"chr1","180445545","180445833","chr15","18815160","18815448","59","161630385"
"chr1","180467059","180467182","chr9","119806250","119806373","14","60660809"
"chr1","180511092","180511254","chr12","84561144","84561294","50","95949948"
"chr1","180536579","180536881","chr9","119868916","119869207","51","60667663"
"chr1","180595239","180595544","chr9","119934471","119934780","38","60660768"
"chr1","180603039","180603339","chr14","56459389","56459701","64","124143650"
"chr1","180740842","180741127","chr5","6548917","6549207","67","174191925"
"chr1","180769324","180769629","chr9","120092705","120093003","51","60676619"
"chr1","180835361","180835603","chr10","37439324","37439560","59","143396037"
"chr1","180863000","180863149","chr6","172043667","172043823","36","8819333"
"chr1","180956520","180956657","chr7","26158438","26158564","36","154798082"
"chr1","181069995","181070232","chr7","3178634","3178870","53","177891361"
"chr1","181095400","181095669","chr9","120420121","120420405","61","60675279"
"chr1","181116014","181116286","chr9","120438970","120439269","58","60677044"
"chr1","181163204","181163483","chr22","11013118","11013389","56","170150086"
"chr1","181191897","181192000","chr9","27513534","27513642","15","153678363"
"chr1","181251740","181252007","chr9","120548764","120549022","34","60702976"
"chr1","181471261","181471532","chr1","186696603","186696870","68","5225342"
"chr1","181487008","181487241","chr9","120825012","120825242","25","60661996"
"chr1","181487369","181487530","chr19","18112321","18112488","39","163375048"
"chr1","181568722","181569044","chr16","80411520","80411834","73","101157202"
"chr1","181570984","181571211","chr9","120885340","120885561","36","60685644"
"chr1","181627552","181627659","chr3","182376414","182376521","34","748862"
"chr1","181627896","181628142","chr11","16812413","16812636","71","164815483"
"chr1","181666477","181666690","chr9","120998014","120998226","26","60668463"
"chr1","181735917","181736013","chr21","1076281","1076374","25","180659636"
"chr1","181736033","181736085","chr3","33280987","33281035","15","148455046"
"chr1","181759529","181759795","chr9","121090889","121091169","57","60668640"
"chr1","181782177","181782294","chr13","62995177","62995295","16","118787000"
"chr1","181782982","181783094","chr9","56650849","56650964","23","125132133"
"chr1","181814089","181814238","chr8","25523917","25524069","32","156290172"
"chr1","181817690","181817984","chr9","121155329","121155620","46","60662361"
"chr1","181825868","181826137","chr2B","63925476","63925768","70","117900392"
"chr1","181841093","181841219","chr9","121179642","121179766","18","60661451"
"chr1","181859665","181859969","chr9","121196724","121197034","39","60662941"
"chr1","181866496","181866602","chr9","121203702","121203809","15","60662794"
"chr1","181883112","181883231","chr17","20104830","20104952","21","161778282"
"chr1","181883246","181883444","chr10","14735402","14735605","53","167147844"
"chr1","181939520","181939823","chr9","121279427","121279701","59","60660093"
"chr1","181963941","181964044","chr4","110753866","110753969","23","71210075"
"chr1","181968464","181968749","chr9","121311418","121311712","61","60657046"
"chr1","182013375","182013626","chr2B","1165821","1166081","55","180847554"
"chr1","182019991","182020035","chr19","46954980","46955029","9","135065011"
"chr1","182040836","182040963","chr9","121389119","121389248","23","60651717"
"chr1","182182727","182183034","chrX","15931050","15931351","57","166251677"
"chr1","182238482","182238807","chr5","134055379","134055694","72","48183103"
"chr1","182241728","182242028","chr9","121570122","121570445","55","60671606"
"chr1","182363890","182364187","chr16","57212544","57212846","68","125151346"
"chr1","182381879","182382027","chr6","152102969","152103107","36","30278910"
"chr1","182391173","182391457","chr22","856284","856562","45","181534889"
"chr1","182391749","182392021","chr17","25061201","25061452","78","157330548"
"chr1","182399529","182399631","chr10","10255974","10256074","23","172143555"
"chr1","182401677","182401798","chr22","871256","871377","4","181530421"
"chr1","182436844","182437102","chr3","131303192","131303447","78","51133652"
"chr1","182464579","182464735","chr13","7680664","7680828","38","174783915"
"chr1","182466125","182466357","chr1","90824306","90824543","57","91641819"
"chr1","182479233","182479500","chr22","927734","928000","41","181551499"
"chr1","182494516","182494797","chr22","939642","939925","33","181554874"
"chr1","182508003","182508126","chr2A","20545290","20545415","32","161962713"
"chr1","182508319","182508442","chr7","129330579","129330704","25","53177740"
"chr1","182511958","182512184","chr3","175097069","175097300","56","7414889"
"chr1","182549942","182550063","chr22","1034787","1034912","20","181515155"
"chr1","182587926","182588059","chr1","204247352","204247486","24","21659426"
"chr1","182613585","182613859","chr10","13510465","13510749","67","169103120"
"chr1","182640960","182641197","chr22","1124737","1124985","47","181516223"
"chr1","182646892","182647013","chr22","1131010","1131130","15","181515882"
"chr1","182669416","182669722","chr22","1156463","1156769","54","181512953"
"chr1","182672122","182672200","chr5","98874822","98874900","12","83797300"
"chr1","182673094","182673369","chr22","1160375","1160657","50","181512719"
"chr1","182685548","182685807","chr22","1171725","1171995","48","181513823"
"chr1","182687645","182687900","chr1","148896609","148896878","67","33791036"
"chr1","182693754","182694025","chr22","1181063","1181353","49","181512691"
"chr1","182709471","182709770","chr22","1196172","1196473","50","181513299"
"chr1","182712158","182712282","chr7","7518910","7519027","30","175193248"
"chr1","182715584","182715714","chr22","1200687","1200816","20","181514897"
"chr1","182760504","182760735","chr17","21575490","21575709","58","161185014"
"chr1","182775623","182775767","chr1","29224358","29224506","37","153551265"
"chr1","182780182","182780459","chr22","1257105","1257395","52","181523077"
"chr1","182828169","182828299","chr1","205765363","205765491","26","22937194"
"chr1","182828937","182829074","chr5","34700212","34700348","34","148128725"
"chr1","182836727","182836860","chr22","1306024","1306142","37","181530703"
"chr1","182845496","182845682","chrX","1560993","1561166","54","181284503"
"chr1","182849912","182850071","chr22","1327733","1327889","19","181522179"
"chr1","182909683","182909953","chr8","86173675","86173941","62","96736008"
"chr1","182926134","182926406","chr22","1393929","1394206","33","181532205"
"chr1","182930306","182930498","chr8","76898662","76898867","69","106031644"
"chr1","182942040","182942321","chr3","126400409","126400694","60","56541631"
"chr1","182943817","182944107","chr22","1411896","1412195","40","181531921"
"chr1","182977525","182977789","chr14","89454618","89454881","55","93522907"
"chr1","183049676","183049940","chr14","47813247","47813510","59","135236429"
"chr1","183061900","183062179","chr22","1536705","1536995","47","181525195"
"chr1","183077290","183077430","chr6","36782155","36782293","30","146295135"
"chr1","183108217","183108511","chr9","93792225","93792514","63","89315992"
"chr1","183114373","183114662","chr9","49037740","49038035","52","134076633"
"chr1","183150171","183150332","chrX","6176848","6177011","34","176973323"
"chr1","183201367","183201677","chr22","6782499","6782804","39","176418868"
"chr1","183214844","183214996","chr2B","126639395","126639541","41","56575449"
"chr1","183220154","183220447","chr22","1750144","1750421","40","181470010"
"chr1","183249200","183249369","chr6","65214403","65214579","37","118034797"
"chr1","183256401","183256680","chr11","113401179","113401455","65","69855222"
"chr1","183319774","183320057","chr22","1861613","1861895","40","181458161"
"chr1","183343728","183344029","chr22","3777641","3777941","36","179566087"
"chr1","183348111","183348395","chr7","1353782","1354071","65","181994329"
"chr1","183361320","183361604","chr10","35801343","35801624","64","147559977"
"chr1","183377492","183377775","chr12","110578462","110578750","64","72799030"
"chr1","183378378","183378678","chr22","4615595","4615901","34","178762783"
"chr1","183379587","183379688","chr5","14822723","14822826","25","168556864"
"chr1","183380023","183380081","chr12","41105677","41105730","13","142274346"
"chr1","183397033","183397316","chr3","151311593","151311885","70","32085440"
"chr1","183397931","183398216","chr22","4615595","4615901","54","178782336"
"chr1","183400296","183400573","chr4","185933944","185934222","67","2533648"
"chr1","183424137","183424400","chr22","662607","662878","46","182761530"
"chr1","183483339","183483648","chr22","2345462","2345758","46","181137877"
"chr1","183488349","183488411","chr22","2351628","2351690","5","181136721"
"chr1","183489774","183490058","chr22","2353061","2353355","46","181136713"
"chr1","183500477","183500753","chr7","152264648","152264930","64","31235829"
"chr1","183549922","183550200","chr7","73083255","73083530","58","110466667"
"chr1","183559012","183559175","chr10","110154408","110154563","27","73404604"
"chr1","183563532","183563791","chr22","3237265","3237529","74","180326267"
"chr1","183569257","183569523","chr22","15736295","15736592","62","167832962"
"chr1","183570752","183571037","chr22","15736295","15736592","45","167834457"
"chr1","183592991","183593289","chr14","11232386","11232682","70","172360605"
"chr1","183594332","183594498","chrX","17937151","17937313","38","165657181"
"chr1","183637932","183638040","chr4","196402447","196402553","16","12764515"
"chr1","183660535","183660608","chr7","72323128","72323205","21","111337407"
"chr1","183661344","183661537","chr22","2503095","2503293","20","181158249"
"chr1","183666345","183666500","chr19","5169265","5169417","33","178497080"
"chr1","183693487","183693638","chr5","18057976","18058128","37","165635511"
"chr1","183750188","183750307","chr22","2616426","2616541","10","181133762"
"chr1","183782574","183782698","chr11","85979780","85979903","20","97802794"
"chr1","183807154","183807272","chr1","94267623","94267739","16","89539531"
"chr1","183848442","183848500","chr7","71171698","71171760","15","112676744"
"chr1","183855226","183855377","chr9","108241495","108241645","33","75613731"
"chr1","183856891","183857145","chr22","2727685","2727956","61","181129206"
"chr1","183895817","183896038","chr8","45358865","45359076","52","138536952"
"chr1","183948254","183948573","chr22","2815296","2815606","42","181132958"
"chr1","183950234","183950345","chr5","35258156","35258271","22","148692078"
"chr1","183954251","183954537","chr22","2828188","2828488","49","181126063"
"chr1","183964415","183964704","chr22","2835590","2835901","55","181128825"
"chr1","183968830","183968962","chr20","3645405","3645538","39","180323425"
"chr1","183993618","183993888","chr22","2863217","2863491","39","181130401"
"chr1","184002667","184002981","chr8","86057034","86057346","64","97945633"
"chr1","184005383","184005697","chr22","2876531","2876841","44","181128852"
"chr1","184013328","184013624","chr22","2884236","2884525","36","181129092"
"chr1","184019519","184019695","chr22","2890506","2890688","35","181129013"
"chr1","184023381","184023502","chr8","129441534","129441654","22","54581847"
"chr1","184032516","184032678","chr15","21950673","21950831","30","162081843"
"chr1","184044749","184045042","chr22","2920919","2921218","36","181123830"
"chr1","184048381","184048670","chr22","2924458","2924753","39","181123923"
"chr1","184062379","184062550","chr2B","99098487","99098651","35","84963892"
"chr1","184104918","184105226","chr19","13956002","13956298","73","170148916"
"chr1","184155567","184155842","chr22","3025020","3025302","51","181130547"
"chr1","184192048","184192335","chr19","2117277","2117563","57","182074771"
"chr1","184193544","184193807","chr1","163471667","163471927","51","20721877"
"chr1","184210493","184210705","chr10","22722922","22723125","58","161487571"
"chr1","184210923","184211175","chr22","3084316","3084573","27","181126607"
"chr1","184228621","184228867","chr22","3103215","3103461","18","181125406"
"chr1","184249797","184250106","chr22","3119123","3119432","41","181130674"
"chr1","184253102","184253391","chr22","3121823","3122107","54","181131279"
"chr1","184256823","184257128","chr1","163452177","163452485","51","20804646"
"chr1","184326801","184326940","chr14","52842638","52842775","30","131484163"
"chr1","184361321","184361573","chr5","60787675","60787923","65","123573646"
"chr1","184376820","184376945","chr7","73180510","73180632","22","111196310"
"chr1","184378937","184379073","chr3","267312","267456","38","184111625"
"chr1","184392094","184392336","chr22","3237265","3237529","45","181154829"
"chr1","184467645","184467916","chr19","13663933","13664211","64","170803712"
"chr1","184487979","184488213","chr4","95879034","95879272","57","88608945"
"chr1","184510549","184510712","chr22","21698794","21698953","38","162811755"
"chr1","184521029","184521254","chr22","3358830","3359044","55","181162199"
"chr1","184533966","184534049","chr22","3369882","3369965","10","181164084"
"chr1","184566962","184567243","chr22","3399660","3399951","50","181167302"
"chr1","184591342","184591506","chr15","44203197","44203360","37","140388145"
"chr1","184614173","184614432","chr22","3455076","3455341","47","181159097"
"chr1","184618199","184618523","chr22","3459503","3459811","56","181158696"
"chr1","184694169","184694486","chr22","3526129","3526415","71","181168040"
"chr1","184717781","184718074","chr12","58134686","58134970","69","126583095"
"chr1","184726854","184727147","chr12","58134686","58134970","69","126592168"
"chr1","184761420","184761636","chr22","2198084","2198302","43","182563336"
"chr1","184808380","184808646","chr22","3436962","3437226","77","181371418"
"chr1","184839944","184840241","chr7","2958204","2958490","66","181881740"
"chr1","184845005","184845135","chr2B","2669140","2669261","38","182175865"
"chr1","184850966","184851339","chr12","76199613","76199956","126","108651353"
"chr1","184853034","184853335","chr2A","41973375","41973685","60","142879659"
"chr1","184882503","184882659","chr5","1396444","1396592","34","183486059"
"chr1","184899767","184900066","chr22","7736969","7737262","47","177162798"
"chr1","184909939","184910098","chr16","5179253","5179420","38","179730686"
"chr1","184976099","184976211","chr1","216103240","216103352","23","31127141"
"chr1","184992398","184992611","chr2A","20932383","20932602","47","164060015"
"chr1","185002624","185002927","chr15","42383255","42383555","64","142619369"
"chr1","185006092","185006142","chr3","63124979","63125032","12","121881113"
"chr1","185010910","185011224","chr16","48491470","48491779","70","136519440"
"chr1","185018411","185018682","chr1","185926758","185927043","76","908347"
"chr1","185022091","185022259","chr22","4456158","4456355","48","180565933"
"chr1","185028501","185028712","chr8","87201274","87201491","64","97827227"
"chr1","185030160","185030437","chr22","4484154","4484423","46","180546006"
"chr1","185033196","185033353","chr22","4010583","4010743","34","181022613"
"chr1","185033967","185034268","chr22","4480839","4481138","36","180553128"
"chr1","185035658","185035864","chr22","21358145","21358344","60","163677513"
"chr1","185037492","185037716","chr7","151896545","151896758","53","33140947"
"chr1","185048683","185048800","chr1","43805914","43806031","19","141242769"
"chr1","185051842","185052140","chr22","4464774","4465069","36","180587068"
"chr1","185052933","185053231","chr6","72114770","72115070","59","112938163"
"chr1","185087653","185087816","chr21","24720942","24721101","33","160366711"
"chr1","185089705","185089803","chr1","36354985","36355078","19","148734720"
"chr1","185091323","185091425","chr7","106461202","106461303","17","78630121"
"chr1","185128438","185128741","chr9","95464496","95464806","76","89663942"
"chr1","185139080","185139192","chr22","4380539","4380654","18","180758541"
"chr1","185147739","185147863","chrX","95494066","95494189","16","89653673"
"chr1","185176738","185177049","chr2B","53629601","53629902","63","131547137"
"chr1","185185106","185185385","chr22","4342345","4342649","53","180842761"
"chr1","185195240","185195381","chr11","62991394","62991536","31","122203846"
"chr1","185196474","185196592","chr13","10985294","10985413","21","174211180"
"chr1","185207276","185207381","chr4","86873798","86873900","32","98333478"
"chr1","185211912","185212033","chr20","14231616","14231738","22","170980296"
"chr1","185213894","185213979","chr4","196368015","196368103","16","11154121"
"chr1","185247050","185247164","chr12","93713225","93713347","23","91533825"
"chr1","185254833","185255113","chr22","4275476","4275752","37","180979357"
"chr1","185289955","185290244","chr6","92155233","92155530","56","93134722"
"chr1","185307419","185307700","chr2A","79927072","79927352","69","105380347"
"chr1","185361304","185361613","chr22","4155799","4156114","52","181205505"
"chr1","185386842","185387114","chr5","156476837","156477135","72","28910005"
"chr1","185398674","185398830","chr16","76317400","76317554","28","109081274"
"chr1","185400334","185400511","chr1","183223511","183223687","37","2176823"
"chr1","185402853","185402951","chr5","56160597","56160680","32","129242256"
"chr1","185438335","185438629","chr22","4804567","4804853","45","180633768"
"chr1","185527812","185527932","chr1","17358799","17358917","23","168169013"
"chr1","185545558","185545858","chr7","76523012","76523308","60","109022546"
"chr1","185549026","185549140","chr7","68275138","68275242","29","117273888"
"chr1","185563799","185564129","chr22","4983172","4983462","67","180580627"
"chr1","185587933","185588203","chr11","113401179","113401455","66","72186754"
"chr1","185589514","185589667","chr19","5169265","5169417","35","180420249"
"chr1","185609258","185609403","chr2B","94897282","94897419","42","90711976"
"chr1","185610726","185610877","chr1","138968329","138968481","33","46642397"
"chr1","185626961","185627226","chr22","27324965","27325228","71","158301996"
"chr1","185638744","185639043","chr4","165626465","165626758","63","20012279"
"chr1","185678870","185679141","chr22","5094280","5094555","41","180584590"
"chr1","185682296","185682573","chr22","5097781","5098082","51","180584515"
"chr1","185704921","185705227","chr22","5115952","5116255","38","180588969"
"chr1","185705482","185705551","chr6","152291348","152291416","17","33414134"
"chr1","185708322","185708631","chr22","5118979","5119275","46","180589343"
"chr1","185773013","185773171","chr4","120946284","120946435","31","64826729"
"chr1","185829844","185829927","chrX","55892234","55892317","13","129937610"
"chr1","185834710","185834945","chr22","5251648","5251887","23","180583062"
"chr1","185859281","185859578","chr5","23931488","23931783","56","161927793"
"chr1","185898723","185899020","chr22","5324196","5324509","56","180574527"
"chr1","185922664","185922971","chr22","5349146","5349432","67","180573518"
"chr1","185935713","185935824","chr22","5361523","5361634","9","180574190"
"chr1","185938872","185939141","chr21","35196272","35196535","51","150742600"
"chr1","185976386","185976493","chr1","33221527","33221624","26","152754859"
"chr1","185993681","185993810","chr7","74128008","74128137","30","111865673"
"chr1","186041521","186041674","chr10","49585047","49585201","34","136456474"
"chr1","186084243","186084367","chr1","94182758","94182881","30","91901485"
"chr1","186112413","186112701","chr1","159332642","159332938","62","26779771"
"chr1","186141021","186141367","chr6","108710229","108710557","111","77430792"
"chr1","186168057","186168173","chr22","5891560","5891676","15","180276497"
"chr1","186172742","186173065","chr22","5892003","5892330","47","180280739"
"chr1","186497602","186497828","chrX","932956","933164","63","185564646"
"chr1","186502930","186503238","chr22","6306224","6306529","38","180196706"
"chr1","186560419","186560696","chr1","138976328","138976601","68","47584091"
"chr1","186570070","186570379","chr9","80914511","80914814","59","105655559"
"chr1","186612266","186612483","chr22","6404314","6404532","28","180207952"
"chr1","186627805","186627934","chr22","6419225","6419360","16","180208580"
"chr1","186718413","186718623","chr22","6510951","6511159","36","180207462"
"chr1","186720404","186720709","chr22","6512911","6513215","46","180207493"
"chr1","186722104","186722255","chr7","66276952","66277104","39","120445152"
"chr1","186724494","186724784","chr22","6520916","6521205","36","180203578"
"chr1","186730823","186731130","chr22","6527197","6527509","57","180203626"
"chr1","186737944","186738260","chr22","6534090","6534395","59","180203854"
"chr1","186742617","186742918","chr7","76523012","76523308","69","110219605"
"chr1","186751198","186751495","chr6","20689530","20689838","66","166061668"
"chr1","186758163","186758458","chr22","6553622","6553919","41","180204541"
"chr1","186780776","186781061","chr22","6574762","6575036","54","180206014"
"chr1","186794980","186795208","chr22","6589640","6589876","33","180205340"
"chr1","186929863","186930177","chr3","184404235","184404557","78","2525628"
"chr1","186946116","186946217","chr7","75095171","75095269","27","111850945"
"chr1","186961466","186961687","chr1","191419760","191419990","66","4458294"
"chr1","186962691","186962822","chr22","7738309","7738432","17","179224382"
"chr1","186967464","186967735","chr22","7742590","7742869","39","179224874"
"chr1","187035865","187035986","chr22","22003453","22003576","21","165032412"
"chr1","187063291","187063451","chr5","51144248","51144411","29","135919043"
"chr1","187127410","187127719","chr7","76899862","76900176","65","110227548"
"chr1","187131489","187131783","chr22","7906716","7907005","40","179224773"
"chr1","187149703","187149989","chr22","7927429","7927711","57","179222274"
"chr1","187154612","187154885","chr1","189902282","189902563","57","2747670"
"chr1","187186304","187186578","chr22","7958462","7958746","35","179227842"
"chr1","187224613","187224916","chr22","7994773","7995086","37","179229840"
"chr1","187230451","187230759","chr22","7998655","7998954","45","179231796"
"chr1","187266374","187266470","chr22","7047789","7047885","6","180218585"
"chr1","187279830","187280133","chr22","2012854","2013135","42","185266976"
"chr1","187286799","187286902","chr1","186122233","186122334","19","1164566"
"chr1","187305101","187305356","chr6","44546586","44546829","73","142758515"
"chr1","187327539","187327801","chr22","7651410","7651687","43","179676129"
"chr1","187328862","187329160","chr22","7649987","7650298","38","179678875"
"chr1","187434488","187434766","chr22","7548696","7548998","45","179885792"
"chr1","187479065","187479351","chr8","18200102","18200384","57","169278963"
"chr1","187479602","187479916","chr22","7506802","7507116","43","179972800"
"chr1","187493547","187493675","chr15","52764054","52764186","29","134729493"
"chr1","187496000","187496273","chr22","7488537","7488823","53","180007463"
"chr1","187511269","187511520","chr22","7473013","7473266","27","180038256"
"chr1","187530583","187530880","chr22","7451778","7452080","70","180078805"
"chr1","187534260","187534535","chr22","7448689","7448937","54","180085571"
"chr1","187553971","187554107","chr1","215271336","215271467","30","27717365"
"chr1","187564753","187565049","chr7","2958204","2958490","71","184606549"
"chr1","187570700","187570951","chr22","7412190","7412442","47","180158510"
"chr1","187576200","187576501","chr5","49587043","49587344","72","137989157"
"chr1","187577347","187577648","chr22","20116029","20116339","62","167461318"
"chr1","187598090","187598226","chr8","79865622","79865759","30","107732468"
"chr1","187613177","187613470","chr22","15736295","15736592","40","171876882"
"chr1","187625659","187625795","chr8","79865622","79865759","29","107760037"
"chr1","187660805","187661064","chr22","3237265","3237529","66","184423540"
"chr1","187665991","187666284","chr22","15736295","15736592","40","171929696"
"chr1","187725420","187725505","chr14","54873414","54873500","19","132852006"
"chr1","187729503","187729626","chr16","69212656","69212783","31","118516847"
"chr1","187729816","187729939","chr2A","96740314","96740438","20","90989502"
"chr1","187733438","187733667","chr5","4811443","4811668","52","182921995"
"chr1","187735427","187735718","chr22","991451","991745","31","186743976"
"chr1","187870415","187870713","chr22","8297599","8297901","32","179572816"
"chr1","187879260","187879502","chr22","8311524","8311782","46","179567736"
"chr1","187897248","187897521","chr22","8334478","8334755","36","179562770"
"chr1","187909111","187909210","chr22","8350496","8350590","22","179558615"
"chr1","187971664","187971910","chr1","28926797","28927043","57","159044867"
"chr1","187977475","187977744","chr22","8408725","8409012","49","179568750"
"chr1","187990507","187990803","chr22","8419797","8420098","46","179570710"
"chr1","188007452","188007718","chr14","14318251","14318491","71","173689201"
"chr1","188046913","188047178","chr21","33616174","33616442","47","154430739"
"chr1","188072771","188073063","chr3","12700490","12700774","71","175372281"
"chr1","188082788","188083082","chr22","8510083","8510372","42","179572705"
"chr1","188142027","188142342","chr22","8561662","8561964","49","179580365"
"chr1","188156410","188156579","chr15","63612157","63612324","48","124544253"
"chr1","188194803","188195095","chr22","8613688","8613982","41","179581115"
"chr1","188275258","188275598","chr22","8683474","8683807","43","179591784"
"chr1","188286702","188286999","chr22","8693613","8693912","49","179593089"
"chr1","188299310","188299595","chr22","8706875","8707165","58","179592435"
"chr1","188303520","188303791","chr22","8711176","8711459","51","179592344"
"chr1","188328497","188328788","chr22","8737787","8738084","41","179590710"
"chr1","188370206","188370511","chr14","60732725","60733031","60","127637481"
"chr1","188454764","188455036","chr22","8779056","8779328","35","179675708"
"chr1","188477295","188477573","chr22","9118924","9119219","55","179358371"
"chr1","188514082","188514361","chr1","7480351","7480627","57","181033731"
"chr1","188534031","188534328","chr22","9167717","9168022","59","179366314"
"chr1","188537934","188538232","chr22","9174580","9174906","62","179363354"
"chr1","188553891","188554153","chr15","35447472","35447736","61","153106419"
"chr1","188557172","188557451","chr18","1313785","1314066","57","187243387"
"chr1","188571391","188571674","chr1","95045674","95045960","58","93525717"
"chr1","188656296","188656566","chr2A","61087686","61087956","59","127568610"
"chr1","188658581","188658889","chr22","9299496","9299804","52","179359085"
"chr1","188768122","188768427","chr22","9404929","9405256","61","179363193"
"chr1","188806397","188806655","chr22","9441823","9442104","45","179364574"
"chr1","188852690","188852919","chr22","9484219","9484463","37","179368471"
"chr1","188905979","188906268","chr22","9532152","9532453","54","179373827"
"chr1","189015082","189015395","chr22","9639232","9639525","49","179375850"
"chr1","189059714","189060017","chr22","9691874","9692168","38","179367840"
"chr1","189079730","189079983","chr20","48652874","48653120","71","140426856"
"chr1","189095922","189096173","chr3","124682825","124683084","75","64413097"
"chr1","189115031","189115323","chr22","9739402","9739703","48","179375629"
"chr1","189214045","189214279","chr10","25463245","25463491","49","163750800"
"chr1","189253934","189254108","chr11","134060642","134060809","35","55193292"
"chr1","189263697","189263996","chr22","9871214","9871520","44","179392483"
"chr1","189271741","189271960","chr2B","111360403","111360623","50","77911338"
"chr1","189272842","189272964","chr22","9878539","9878661","7","179394303"
"chr1","189273373","189273697","chr22","9879035","9879334","53","179394338"
"chr1","189299280","189299458","chr22","9907423","9907619","40","179391857"
"chr1","189320139","189320424","chr22","9925363","9925648","52","179394776"
"chr1","189324756","189325011","chr17","89053843","89054101","46","100270913"
"chr1","189345010","189345315","chr22","9953833","9954134","27","179391177"
"chr1","189362124","189362289","chr6","137736682","137736850","29","51625442"
"chr1","189372322","189372633","chr3","15730383","15730693","69","173641939"
"chr1","189372729","189372849","chr21","20105778","20105890","27","169266951"
"chr1","189389251","189389418","chr19","18112321","18112488","33","171276930"
"chr1","189423179","189423375","chr22","10038095","10038286","34","179385084"
"chr1","189435432","189435706","chr22","10049315","10049603","52","179386117"
"chr1","189482898","189483234","chr10","41661369","41661662","88","147821529"
"chr1","189490535","189490696","chr22","34031915","34032078","33","155458620"
"chr1","189495609","189495738","chr22","10102192","10102321","16","179393417"
"chr1","189510379","189510679","chr22","10116920","10117223","30","179393459"
"chr1","189551298","189551576","chr22","10153235","10153514","69","179398063"
"chr1","189646792","189647025","chr22","10241659","10241886","44","179405133"
"chr1","189697912","189698152","chr22","10283089","10283346","42","179414823"
"chr1","189766668","189766999","chr1","207949331","207949645","85","18182663"
"chr1","189768063","189768196","chr1","187726107","187726234","21","2041956"
"chr1","189819142","189819430","chr22","10400118","10400424","51","179419024"
"chr1","189828761","189829058","chr22","10409437","10409712","50","179419324"
"chr1","189835826","189836102","chr22","10416026","10416307","36","179419800"
"chr1","189868594","189868867","chr6","157163273","157163545","63","32705321"
"chr1","189995084","189995360","chr4","74466295","74466566","56","115528789"
"chr1","190024359","190024653","chr22","10594046","10594327","53","179430313"
"chr1","190077468","190077785","chr22","10647273","10647576","55","179430195"
"chr1","190096290","190096566","chr22","10669230","10669521","51","179427060"
"chr1","190097438","190097735","chr18","19399048","19399341","56","170698390"
"chr1","190135241","190135531","chr22","10709974","10710265","54","179425267"
"chr1","190171998","190172288","chr22","10747549","10747830","42","179424449"
"chr1","190315069","190315217","chr8","86046244","86046385","33","104268825"
"chr1","190320275","190320564","chr8","68142682","68142965","53","122177593"
"chr1","190419063","190419211","chr16","80955590","80955736","41","109463473"
"chr1","190446871","190447175","chr22","11039828","11040126","45","179407043"
"chr1","190457058","190457246","chr15","51083311","51083503","43","139373747"
"chr1","190457293","190457371","chr11","72080341","72080419","18","118376952"
"chr1","190478734","190479032","chr22","11070635","11070942","44","179408099"
"chr1","190534587","190534771","chr11","7995472","7995656","35","182539115"
"chr1","190586729","190586804","chr20","60503715","60503794","14","130083014"
"chr1","190608342","190608477","chr7","77000001","77000126","27","113608341"
"chr1","190619960","190620217","chr22","11214904","11215158","44","179405056"
"chr1","190641234","190641538","chr10","25675089","25675374","76","164966145"
"chr1","190641857","190641975","chr22","11238987","11239110","17","179402870"
"chr1","190652126","190652394","chr22","11249078","11249349","45","179403048"
"chr1","190689688","190689980","chr22","11291870","11292176","57","179397818"
"chr1","190733977","190734264","chr22","11333218","11333516","61","179400759"
"chr1","190800696","190800842","chr5","130959094","130959245","38","59841602"
"chr1","190816758","190817045","chr22","11424318","11424611","49","179392440"
"chr1","190818554","190818849","chr12","87602994","87603287","62","103215560"
"chr1","190853222","190853513","chr22","11461260","11461542","50","179391962"
"chr1","190855085","190855275","chr5","165314807","165314988","43","25540278"
"chr1","190864619","190864925","chr6","31725434","31725739","71","159139185"
"chr1","190903968","190904246","chr16","40943947","40944205","73","149960021"
"chr1","190929710","190929954","chr5","79883377","79883636","64","111046333"
"chr1","190983421","190983568","chr8","20885859","20886004","34","170097562"
"chr1","191021395","191021574","chr7","45537514","45537680","38","145483881"
"chr1","191044701","191044999","chr22","11665624","11665919","35","179379077"
"chr1","191066687","191066797","chr3","187504297","187504409","18","3562390"
"chr1","191101865","191102141","chr12","62282656","62282936","57","128819209"
"chr1","191107749","191107870","chr7","140174758","140174882","17","50932991"
"chr1","191110227","191110342","chr22","11729622","11729735","23","179380605"
"chr1","191213087","191213371","chr22","11823631","11823906","56","179389456"
"chr1","191221339","191221629","chr22","11831486","11831774","31","179389853"
"chr1","191244254","191244552","chr22","11850947","11851227","55","179393307"
"chr1","191245446","191245736","chr22","11849795","11850092","42","179395651"
"chr1","191298917","191299120","chr9","80041537","80041739","54","111257380"
"chr1","191313980","191314291","chr22","11921829","11922139","40","179392151"
"chr1","191322570","191322703","chr22","11930696","11930830","15","179391874"
"chr1","191387905","191388188","chr22","11995566","11995855","54","179392339"
"chr1","191438526","191438748","chr22","12048888","12049108","32","179389638"
"chr1","191439089","191439401","chr4","164092787","164093085","76","27346302"
"chr1","191455406","191455719","chr8","23631274","23631579","71","167824132"
"chr1","191490293","191490546","chr22","12099236","12099502","41","179391057"
"chr1","191507799","191507923","chr22","12116783","12116906","12","179391016"
"chr1","191512165","191512317","chr1","205548459","205548612","30","14036294"
"chr1","191512329","191512428","chr22","12121367","12121465","15","179390962"
"chr1","191528147","191528271","chr22","12128531","12128655","15","179399616"
"chr1","191531164","191531440","chr9","75566020","75566287","61","115965144"
"chr1","191554017","191554329","chrX","25221939","25222243","72","166332078"
"chr1","191589232","191589395","chr10","58638831","58638996","38","132950401"
"chr1","191589729","191589848","chr22","12189738","12189869","20","179399991"
"chr1","191654897","191655038","chr22","12258258","12258388","25","179396639"
"chr1","191658199","191658284","chr6","113438680","113438764","17","78219519"
"chr1","191659641","191659934","chr22","12264480","12264780","36","179395161"
"chr1","191661157","191661455","chr16","10963785","10964082","55","180697372"
"chr1","191678451","191678737","chr7","5830379","5830666","56","185848072"
"chr1","191698102","191698145","chr20","1444000","1444039","11","190254102"
"chr1","191698202","191698409","chr17","82000001","82000214","64","109698201"
"chr1","191702519","191702763","chr22","12306381","12306666","59","179396138"
"chr1","191718194","191718293","chr18","48326419","48326520","28","143391775"
"chr1","191737411","191737664","chr22","12345490","12345743","34","179391921"
"chr1","191745054","191745290","chr22","12351360","12351620","44","179393694"
"chr1","191750157","191750449","chr22","12355792","12356104","59","179394365"
"chr1","191764119","191764372","chr22","12379822","12380088","44","179384297"
"chr1","191769141","191769446","chr22","12384069","12384367","37","179385072"
"chr1","191799832","191799985","chr22","12413426","12413589","19","179386406"
"chr1","191862961","191863238","chr22","12479682","12479978","60","179383279"
"chr1","191885674","191885946","chr22","12503273","12503563","48","179382401"
"chr1","191907144","191907434","chr8","82803707","82803993","86","109103437"
"chr1","191909249","191909529","chr22","12525245","12525522","23","179384004"
"chr1","191912870","191913177","chr22","12529140","12529424","66","179383730"
"chr1","191914210","191914363","chr10","49585047","49585201","38","142329163"
"chr1","191915661","191915883","chr22","12532089","12532312","34","179383572"
"chr1","191952656","191952951","chr22","12569594","12569910","45","179383062"
"chr1","191962072","191962200","chr10","12650705","12650831","30","179311367"
"chr1","191967007","191967233","chr7","2733732","2733965","68","189233275"
"chr1","191972009","191972308","chr22","12589564","12589863","36","179382445"
"chr1","191978490","191978801","chr22","12595959","12596266","55","179382531"
"chr1","191981765","191981917","chr10","92108530","92108678","29","99873235"
"chr1","192000052","192000332","chrX","45067707","45067988","65","146932345"
"chr1","192001731","192002008","chr22","12618065","12618338","48","179383666"
"chr1","192045594","192045904","chr22","12669690","12669992","35","179375904"
"chr1","192077511","192077820","chr22","12726594","12726897","40","179350917"
"chr1","192085169","192085476","chr7","79073505","79073807","49","113011664"
"chr1","192105984","192106136","chr15","69740012","69740164","28","122365972"
"chr1","192114892","192115180","chr22","12764379","12764671","47","179350513"
"chr1","192123817","192124140","chr22","12773412","12773738","53","179350405"
"chr1","192124314","192124609","chr22","12773903","12774201","34","179350411"
"chr1","192133699","192134026","chr22","10033716","10034042","87","182099983"
"chr1","192135426","192135719","chr1","227415933","227416230","59","35280507"
"chr1","192137793","192138090","chr22","12786838","12787159","61","179350955"
"chr1","192157656","192157937","chr22","12804448","12804747","52","179353208"
"chr1","192191330","192191577","chr14","59160382","59160624","67","133030948"
"chr1","192251150","192251349","chr22","12897920","12898118","42","179353230"
"chr1","192277238","192277557","chr2B","57212410","57212729","59","135064828"
"chr1","192293401","192293698","chr22","12928512","12928807","27","179364889"
"chr1","192325568","192325658","chr22","12999667","12999759","6","179325901"
"chr1","192338821","192339097","chr3","131227515","131227806","67","61111306"
"chr1","192357718","192358026","chr11","78977979","78978275","72","113379739"
"chr1","192363990","192364145","chr13","871735","871882","39","191492255"
"chr1","192367177","192367461","chr22","13036746","13037043","36","179330431"
"chr1","192370194","192370317","chr11","92397185","92397307","19","99973009"
"chr1","192377659","192377965","chr18","44192753","44193047","81","148184906"
"chr1","192391986","192392293","chr22","13065993","13066303","25","179325993"
"chr1","192461576","192461756","chr19","34709362","34709535","31","157752214"
"chr1","192465078","192465369","chr10","118181249","118181538","62","74283829"
"chr1","192465386","192465660","chr12","4145040","4145316","54","188320346"
"chr1","192483529","192483827","chr22","13153181","13153483","50","179330348"
"chr1","192488607","192488888","chr22","13159656","13159949","50","179328951"
"chr1","192588458","192588746","chr22","13254703","13255000","56","179333755"
"chr1","192618314","192618634","chr22","13287174","13287490","32","179331140"
"chr1","192644206","192644565","chr18","18502950","18503265","106","174141256"
"chr1","192645266","192645389","chr20","43708602","43708725","19","148936664"
"chr1","192651709","192651973","chr17","9567584","9567855","66","183084125"
"chr1","192653623","192653769","chr1","32730027","32730168","41","159923596"
"chr1","192684184","192684528","chr15","58842155","58842477","90","133842029"
"chr1","192696439","192696725","chr22","13354218","13354522","48","179342221"
"chr1","192703034","192703307","chr22","13360901","13361174","40","179342133"
"chr1","192717084","192717380","chr22","13374155","13374462","37","179342929"
"chr1","192726121","192726381","chr22","13381201","13381462","24","179344920"
"chr1","192729578","192729723","chr2A","96268428","96268571","32","96461150"
"chr1","192745125","192745230","chr1","140325532","140325641","27","52419593"
"chr1","192745515","192745662","chr1","46271276","46271424","31","146474239"
"chr1","192754550","192754848","chr22","13407403","13407699","46","179347147"
"chr1","192761864","192762159","chr22","13414000","13414299","53","179347864"
"chr1","192782416","192782723","chr22","13453139","13453443","58","179329277"
"chr1","192803540","192803817","chr13","22537737","22538018","74","170265803"
"chr1","192812398","192812712","chr22","13494133","13494462","69","179318265"
"chr1","192813308","192813578","chr2A","63306129","63306401","58","129507179"
"chr1","192815627","192815776","chr9","94234680","94234832","42","98580947"
"chr1","192840077","192840366","chr6","153473499","153473782","69","39366578"
"chr1","192863213","192863520","chr22","13547036","13547343","33","179316177"
"chr1","192871608","192871887","chr1","189232436","189232704","71","3639172"
"chr1","192915347","192915622","chr19","32753008","32753279","63","160162339"
"chr1","192924992","192925047","chr1","52138720","52138778","9","140786272"
"chr1","192926534","192926750","chr4","12140689","12140908","64","180785845"
"chr1","192926785","192927061","chr17","11490190","11490476","67","181436595"
"chr1","192943241","192943572","chr15","55185914","55186230","75","137757327"
"chr1","192999202","192999499","chr2B","53629601","53629902","75","139369601"
"chr1","193073637","193073929","chr22","13738009","13738299","37","179335628"
"chr1","193075678","193075982","chr22","13740382","13740685","38","179335296"
"chr1","193077682","193077994","chr22","13742429","13742732","52","179335253"
"chr1","193080413","193080530","chrX","16504327","16504444","16","176576086"
"chr1","193086194","193086481","chr22","13751094","13751383","60","179335100"
"chr1","193093466","193093759","chr22","13760142","13760440","35","179333324"
"chr1","193120939","193121218","chr7","43971191","43971463","52","149149748"
"chr1","193145957","193146167","chr12","123580605","123580806","54","69565352"
"chr1","193146468","193146542","chr9","95884781","95884857","12","97261687"
"chr1","193178219","193178393","chr1","184720130","184720300","44","8458089"
"chr1","193182573","193182670","chr7","101404390","101404484","19","91778183"
"chr1","193182805","193183028","chr19","13464945","13465167","43","179717860"
"chr1","193218107","193218332","chr22","13873485","13873714","40","179344622"
"chr1","193221542","193221695","chr16","61002772","61002916","34","132218770"
"chr1","193284901","193285199","chrX","47433933","47434217","75","145850968"
"chr1","193286139","193286424","chr22","13939988","13940273","42","179346151"
"chr1","193301416","193301540","chr16","49069004","49069126","20","144232412"
"chr1","193316144","193316441","chr22","13992761","13993055","39","179323383"
"chr1","193320759","193321056","chr22","13997368","13997658","39","179323391"
"chr1","193327163","193327458","chr22","14003825","14004115","36","179323338"
"chr1","193342821","193343117","chr22","14009285","14009599","55","179333536"
"chr1","193353443","193353748","chr22","14043715","14044004","41","179309728"
"chr1","193354989","193355291","chr10","14758261","14758543","76","178596728"
"chr1","193357560","193357858","chr22","14048126","14048428","39","179309434"
"chr1","193376038","193376097","chr12","81693462","81693520","18","111682576"
"chr1","193399605","193399910","chr22","14109699","14109988","43","179289906"
"chr1","193428860","193429163","chr1","132730429","132730720","71","60698431"
"chr1","193493125","193493409","chr22","14185574","14185851","38","179307551"
"chr1","193535872","193536191","chr7","129496935","129497243","67","64038937"
"chr1","193541878","193541951","chr7","73553554","73553614","21","119988324"
"chr1","193542346","193542462","chr5","53544845","53544957","22","139997501"
"chr1","193552147","193552457","chr22","14259086","14259389","44","179293061"
"chr1","193554362","193554486","chr10","112111608","112111739","21","81442754"
"chr1","193590431","193590717","chr7","72306531","72306825","55","121283900"
"chr1","193638494","193638779","chr22","14349999","14350284","22","179288495"
"chr1","193647194","193647516","chr22","14358206","14358527","39","179288988"
"chr1","193665660","193665959","chr22","14373801","14374109","32","179291859"
"chr1","193671754","193672040","chr11","117339541","117339831","68","76332213"
"chr1","193682503","193682807","chr11","36550949","36551258","60","157131554"
"chr1","193729653","193729939","chr22","14431501","14431801","39","179298152"
"chr1","193748402","193748677","chr7","1708256","1708538","63","192040146"
"chr1","193845557","193845692","chr22","14539017","14539163","27","179306540"
"chr1","193850898","193851193","chr14","38455412","38455707","61","155395486"
"chr1","193860289","193860570","chr22","14575042","14575320","39","179285247"
"chr1","193862816","193863128","chr22","14576923","14577237","49","179285893"
"chr1","193877624","193877925","chr22","14601548","14601852","44","179276076"
"chr1","193890750","193891032","chr16","39756042","39756324","71","154134708"
"chr1","193895165","193895467","chr15","1045425","1045714","38","192849740"
"chr1","193895565","193895823","chr11","72474255","72474514","67","121421310"
"chr1","193903218","193903396","chr9","35828180","35828355","37","158075038"
"chr1","193978158","193978443","chr22","14711993","14712268","51","179266165"
"chr1","193984534","193984814","chr22","14718259","14718560","58","179266275"
"chr1","193997293","193997422","chr22","14730929","14731055","15","179266364"
"chr1","194024298","194024573","chr22","14762357","14762628","34","179261941"
"chr1","194024577","194024682","chr8","79737740","79737854","28","114286837"
"chr1","194078815","194078942","chr22","14821499","14821616","27","179257316"
"chr1","194081330","194081588","chr22","14824182","14824466","49","179257148"
"chr1","194121907","194122078","chr6","5317435","5317603","38","188804472"
"chr1","194143088","194143288","chr22","14880445","14880660","29","179262643"
"chr1","194183690","194183986","chr12","121913892","121914192","56","72269798"
"chr1","194191242","194191359","chr6","112896960","112897078","24","81294282"
"chr1","194197959","194198223","chrX","107733647","107733908","70","86464312"
"chr1","194207813","194208072","chr15","80267478","80267747","80","113940335"
"chr1","194242919","194243215","chr12","121913892","121914192","56","72329027"
"chr1","194285289","194285586","chr8","59850782","59851072","55","134434507"
"chr1","194292130","194292398","chr3","200217150","200217415","73","5925020"
"chr1","194294298","194294386","chr14","89632041","89632129","20","104662257"
"chr1","194294725","194294883","chr7","72728894","72729062","42","121565831"
"chr1","194299671","194299967","chr22","15045243","15045546","44","179254428"
"chr1","194308932","194309025","chr7","77785333","77785419","29","116523599"
"chr1","194359287","194359370","chr3","24236501","24236584","21","170122786"
"chr1","194360179","194360268","chr6","93151520","93151604","26","101208659"
"chr1","194366607","194366898","chr22","15115782","15116086","51","179250825"
"chr1","194367607","194367958","chr2B","131420231","131420582","107","62947376"
"chr1","194369666","194369957","chrX","118822166","118822454","64","75547500"
"chr1","194383915","194384034","chr22","15128852","15128979","23","179255063"
"chr1","194387710","194387995","chr19","42687418","42687715","59","151700292"
"chr1","194428278","194428564","chr22","15164473","15164763","35","179263805"
"chr1","194466184","194466430","chr2B","101016968","101017219","63","93449216"
"chr1","194507770","194508066","chr20","33313506","33313802","60","161194264"
"chr1","194534792","194535071","chr1","9536480","9536773","77","184998312"
"chr1","194535184","194535409","chr14","41954959","41955193","54","152580225"
"chr1","194545790","194545943","chr3","144003939","144004095","28","50541851"
"chr1","194594399","194594649","chr19","47251420","47251686","59","147342979"
"chr1","194602899","194603208","chr22","15349853","15350173","54","179253046"
"chr1","194621682","194621751","chr10","40725944","40726010","14","153895738"
"chr1","194623815","194624083","chr22","15369288","15369598","64","179254527"
"chr1","194638451","194638697","chr7","44645393","44645629","66","149993058"
"chr1","194649869","194650026","chr14","57594861","57595020","32","137055008"
"chr1","194680848","194680970","chr9","95884443","95884549","44","98796405"
"chr1","194683197","194683482","chr22","15420863","15421143","26","179262334"
"chr1","194687932","194688053","chr22","7569684","7569804","29","187118248"
"chr1","194707699","194707991","chr22","15441984","15442285","50","179265715"
"chr1","194755485","194755850","chr11","29315517","29315890","103","165439968"
"chr1","194762471","194762774","chr22","15494290","15494582","37","179268181"
"chr1","194767826","194768137","chr22","15498583","15498895","50","179269243"
"chr1","194783228","194783527","chr22","15512353","15512641","45","179270875"
"chr1","194804857","194805166","chr22","15533478","15533782","36","179271379"
"chr1","194808570","194808846","chr22","15536547","15536832","50","179272023"
"chr1","194818999","194819148","chr1","17928928","17929072","27","176890071"
"chr1","194819727","194819854","chr1","109948107","109948236","23","84871620"
"chr1","194853234","194853533","chr22","15598457","15598752","30","179254777"
"chr1","194857944","194858062","chr16","60850347","60850468","23","134007597"
"chr1","194860200","194860506","chr22","15590023","15590332","44","179270177"
"chr1","194899173","194899297","chr22","15623558","15623681","14","179275615"
"chr1","194900880","194901173","chr22","15626090","15626365","59","179274790"
"chr1","194905209","194905501","chr22","15630459","15630752","34","179274750"
"chr1","194907636","194907862","chr22","15632853","15633088","28","179274783"
"chr1","194911254","194911571","chr22","15635859","15636169","38","179275395"
"chr1","194912460","194912758","chr22","15636707","15637002","64","179275753"
"chr1","194928514","194928819","chr22","15650987","15651288","45","179277527"
"chr1","194942758","194942872","chr10","94303073","94303184","21","100639685"
"chr1","194970566","194970822","chr12","112953087","112953353","69","82017479"
"chr1","194978988","194979235","chr22","16005104","16005376","57","178973884"
"chr1","194981492","194981765","chr1","129938193","129938472","63","65043299"
"chr1","194984989","194985262","chr1","129938193","129938472","63","65046796"
"chr1","195003526","195003708","chr22","8578148","8578333","57","186425378"
"chr1","195023357","195023468","chr16","1757502","1757610","19","193265855"
"chr1","195024510","195024769","chr22","16037678","16037974","55","178986832"
"chr1","195032185","195032472","chr22","16050917","16051211","36","178981268"
"chr1","195038920","195039226","chr22","16058376","16058678","38","178980544"
"chr1","195065053","195065204","chr20","13392558","13392708","40","181672495"
"chr1","195065209","195065322","chr16","16438347","16438462","22","178626862"
"chr1","195088046","195088162","chr22","16106433","16106554","13","178981613"
"chr1","195099668","195099941","chr6","160957547","160957837","59","34142121"
"chr1","195125376","195125553","chr13","32055352","32055524","34","163070024"
"chr1","195126430","195126735","chr11","111601911","111602211","63","83524519"
"chr1","195130788","195130906","chr22","16164413","16164531","22","178966375"
"chr1","195138896","195139183","chr10","91154877","91155160","64","103984019"
"chr1","195180106","195180430","chr22","16220885","16221201","53","178959221"
"chr1","195202800","195203088","chr22","16250012","16250319","62","178952788"
"chr1","195210537","195210822","chr1","162663508","162663787","71","32547029"
"chr1","195279064","195279373","chr22","16330233","16330533","63","178948831"
"chr1","195451397","195451592","chr3","50933267","50933464","36","144518130"
"chr1","195465579","195465876","chr22","16528917","16529217","28","178936662"
"chr1","195495770","195496056","chr22","16565342","16565648","50","178930428"
"chr1","195512621","195512888","chr5","141078401","141078673","54","54434220"
"chr1","195518997","195519299","chr22","16582849","16583158","50","178936148"
"chr1","195562014","195562300","chr22","16629929","16630224","57","178932085"
"chr1","195756554","195756843","chr3","50158457","50158742","66","145598097"
"chr1","195951488","195951776","chr22","17108381","17108669","43","178843107"
"chr1","195961355","195961536","chr7","2363764","2363952","39","193597591"
"chr1","195982070","195982169","chr5","26761731","26761826","38","169220339"
"chr1","196081948","196082245","chr1","78330569","78330867","51","117751379"
"chr1","196158964","196159219","chr5","126374457","126374723","69","69784507"
"chr1","196257193","196257377","chr7","72734196","72734382","43","123522997"
"chr1","196411903","196412031","chr5","161623549","161623680","26","34788354"
"chr1","196490994","196491265","chr22","18217917","18218180","40","178273077"
"chr1","196519407","196519703","chr22","18181616","18181928","50","178337791"
"chr1","196702091","196702380","chr22","18018883","18019169","31","178683208"
"chr1","196768833","196769108","chr1","191294315","191294590","67","5474518"
"chr1","197035315","197035621","chr22","17707116","17707402","49","179328199"
"chr1","197414641","197414943","chr22","18567979","18568281","28","178846662"
"chr1","197678245","197678538","chr1","114123479","114123769","68","83554766"
"chr1","197708962","197709205","chr19","11048502","11048729","66","186660460"
"chr1","197737843","197738075","chr22","18887682","18887912","23","178850161"
"chr1","197743230","197743444","chr22","18896559","18896768","31","178846671"
"chr1","197752403","197752688","chr7","28488397","28488687","61","169264006"
"chr1","197755311","197755431","chr22","18906466","18906584","17","178848845"
"chr1","197755811","197756116","chr22","18906939","18907255","45","178848872"
"chr1","197763574","197763843","chr22","18914850","18915145","61","178848724"
"chr1","197801896","197802083","chr16","19960233","19960421","31","177841663"
"chr1","197802550","197802647","chr1","33221527","33221624","19","164581023"
"chr1","197831101","197831225","chr22","18978096","18978220","8","178853005"
"chr1","197832036","197832331","chr4","120243844","120244136","61","77588192"
"chr1","197853417","197853706","chr22","19000628","19000935","44","178852789"
"chr1","197854758","197854870","chr8","8957635","8957751","24","188897123"
"chr1","197866299","197866377","chr7","137563832","137563911","11","60302467"
"chr1","197869066","197869338","chr12","123570594","123570856","59","74298472"
"chr1","197888178","197888482","chr22","19033069","19033367","41","178855109"
"chr1","197894429","197894545","chr22","19040109","19040226","14","178854320"
"chr1","197949951","197950220","chr22","19110684","19110964","53","178839267"
"chr1","197956116","197956208","chr11","61985367","61985463","22","135970749"
"chr1","197959350","197959457","chr10","88882589","88882699","18","109076761"
"chr1","197967363","197967640","chr3","13740798","13741082","60","184226565"
"chr1","198211250","198211559","chr22","19368331","19368627","50","178842919"
"chr1","198256653","198256829","chr9","13555365","13555534","43","184701288"
"chr1","198272470","198272756","chr16","4377241","4377525","57","193895229"
"chr1","198280562","198280839","chr20","46273521","46273802","60","152007041"
"chr1","198324426","198324724","chr7","5095566","5095848","75","193228860"
"chr1","198326116","198326332","chr3","73505934","73506159","53","124820182"
"chr1","198331000","198331314","chr6","4964540","4964849","80","193366460"
"chr1","198343649","198343754","chr22","19512383","19512487","15","178831266"
"chr1","198353550","198353871","chr22","19521310","19521629","41","178832240"
"chr1","198356089","198356349","chr22","19521717","19521967","58","178834372"
"chr1","198379162","198379475","chr22","19555926","19556259","54","178823236"
"chr1","198425151","198425440","chr22","19599101","19599374","40","178826050"
"chr1","198471075","198471190","chr1","55247395","55247512","20","143223680"
"chr1","198541142","198541217","chr1","26634024","26634094","18","171907118"
"chr1","198542381","198542492","chr9","15404693","15404807","21","183137688"
"chr1","198571712","198571778","chr6","117254013","117254072","15","81317699"
"chr1","198606141","198606414","chr22","19756140","19756414","31","178850001"
"chr1","198634364","198634626","chr22","19862076","19862323","43","178772288"
"chr1","198639467","198639755","chr3","186984243","186984545","44","11655224"
"chr1","198667984","198668247","chr16","31649333","31649595","55","167018651"
"chr1","198674277","198674407","chr22","19965259","19965383","24","178709018"
"chr1","198675153","198675372","chr22","12742474","12742687","46","185932679"
"chr1","198705987","198706276","chr22","19993661","19993971","53","178712326"
"chr1","198710110","198710388","chr14","47093015","47093296","51","151617095"
"chr1","198738172","198738499","chr22","20026645","20026966","55","178711527"
"chr1","198741678","198741780","chr22","20030181","20030290","26","178711497"
"chr1","198792587","198792894","chr22","20077217","20077539","50","178715370"
"chr1","198795702","198795816","chr22","20083070","20083191","16","178712632"
"chr1","198816004","198816167","chr3","10866047","10866211","31","187949957"
"chr1","198834505","198834627","chr14","73624548","73624670","21","125209957"
"chr1","198876874","198877173","chr6","39361368","39361664","61","159515506"
"chr1","198904285","198904444","chr5","51144248","51144411","31","147760037"
"chr1","198918273","198918581","chr22","20225896","20226202","36","178692377"
"chr1","199026420","199026590","chr19","35504339","35504505","41","163522081"
"chr1","199027649","199027933","chr2A","97057312","97057598","58","101970337"
"chr1","199072236","199072559","chr22","20349794","20350081","70","178722442"
"chr1","199085806","199086102","chr22","20362147","20362446","24","178723659"
"chr1","199090649","199090938","chr22","20367286","20367549","60","178723363"
"chr1","199248664","199248932","chr2B","51385798","51386076","65","147862866"
"chr1","199311444","199311591","chr11","129038829","129038978","44","70272615"
"chr1","199368860","199369030","chr7","72728894","72729062","35","126639966"
"chr1","199421224","199421397","chr19","9557140","9557304","54","189864084"
"chr1","199741028","199741244","chr20","44716602","44716819","44","155024426"
"chr1","199873761","199873925","chr21","24720942","24721101","35","175152819"
"chr1","199882422","199882632","chrX","2373526","2373743","44","197508896"
"chr1","199886861","199887073","chr6","867263","867478","60","199019598"
"chr1","199892786","199893006","chr7","148537607","148537823","45","51355179"
"chr1","199907767","199908070","chr22","21167717","21168021","26","178740050"
"chr1","199940906","199941107","chr1","147322624","147322822","48","52618282"
"chr1","199958625","199958874","chr11","77125337","77125596","59","122833288"
"chr1","199958894","199958964","chr6","135259069","135259142","14","64699825"
"chr1","200035587","200035885","chr22","22652870","22653175","32","177382717"
"chr1","200142723","200143001","chr22","21308818","21309096","33","178833905"
"chr1","200146725","200146915","chr20","33755627","33755812","49","166391098"
"chr1","200161722","200161894","chr11","71910867","71911040","35","128250855"
"chr1","200171805","200172069","chr22","21331231","21331487","40","178840574"
"chr1","200318446","200318708","chr22","21465888","21466163","62","178852558"
"chr1","200320137","200320208","chr9","30581750","30581822","16","169738387"
"chr1","200325446","200325650","chr7","1810491","1810660","60","198514955"
"chr1","200349113","200349424","chr8","98755171","98755484","53","101593942"
"chr1","200411425","200411733","chr7","77009635","77009928","77","123401790"
"chr1","200443864","200443946","chr3","24236501","24236584","12","176207363"
"chr1","200483611","200483738","chr12","105188804","105188922","39","95294807"
"chr1","200484986","200485281","chr22","21632134","21632440","38","178852852"
"chr1","200491301","200491602","chr7","77009635","77009928","62","123481666"
"chr1","200495961","200496275","chr8","24398432","24398723","76","176097529"
"chr1","200580694","200580992","chr4","99195972","99196262","50","101384722"
"chr1","200634560","200634639","chr12","2987479","2987560","17","197647081"
"chr1","200637710","200638003","chr16","57212544","57212846","59","143425166"
"chr1","200651681","200651926","chr22","21757745","21757988","21","178893936"
"chr1","200670784","200671043","chr16","58758445","58758698","73","141912339"
"chr1","200671388","200671461","chr3","173043241","173043305","25","27628147"
"chr1","200783054","200783271","chr1","1334974","1335184","46","199448080"
"chr1","200825856","200825982","chr22","22003453","22003576","20","178822403"
"chr1","200836824","200836993","chr6","17908557","17908726","44","182928267"
"chr1","200855771","200856072","chr12","124809424","124809721","67","76046347"
"chr1","200874692","200874835","chr1","138968329","138968481","34","61906363"
"chr1","200886972","200887262","chrX","96537513","96537800","65","104349459"
"chr1","200889171","200889293","chr22","22065231","22065353","21","178823940"
"chr1","200906885","200907155","chr2A","82649063","82649341","65","118257822"
"chr1","200952559","200952824","chr18","11328811","11329081","61","189623748"
"chr1","200962802","200962918","chr4","34521070","34521186","17","166441732"
"chr1","200966870","200967153","chr22","22154987","22155278","33","178811883"
"chr1","200999697","200999829","chr1","180349547","180349672","26","20650150"
"chr1","201003351","201003559","chr5","165315827","165316033","48","35687524"
"chr1","201003653","201003745","chr7","75602882","75602972","24","125400771"
"chr1","201032448","201032713","chr13","17348700","17348967","58","183683748"
"chr1","201059561","201059839","chr9","66358592","66358884","48","134700969"
"chr1","201103263","201103559","chr19","18992894","18993192","56","182110369"
"chr1","201114972","201115089","chr1","94334371","94334487","18","106780601"
"chr1","201184194","201184498","chr20","355426","355733","54","200828768"
"chr1","201337156","201337458","chr22","4615595","4615901","45","196721561"
"chr1","201348326","201348637","chr10","46224519","46224822","65","155123807"
"chr1","201416268","201416426","chr8","56795337","56795503","34","144620931"
"chr1","201470179","201470477","chr22","24294083","24294388","44","177176096"
"chr1","201478352","201478643","chr22","24302017","24302321","47","177176335"
"chr1","201481575","201481846","chr1","221950059","221950334","59","20468484"
"chr1","201497388","201497623","chr22","24320302","24320527","34","177177086"
"chr1","201502927","201503059","chr19","44604353","44604482","20","156898574"
"chr1","201507346","201507461","chr6","110414278","110414393","18","91093068"
"chr1","201522844","201522940","chr6","36400779","36400869","21","165122065"
"chr1","201541363","201541622","chr22","24365779","24366041","28","177175584"
"chr1","201559558","201559822","chr15","46793365","46793626","67","154766193"
"chr1","201583586","201583796","chr22","24404707","24404925","33","177178879"
"chr1","201599021","201599324","chr16","16090183","16090488","57","185508838"
"chr1","201599786","201600076","chr22","24418585","24418870","47","177181201"
"chr1","201610411","201610546","chr2B","94897282","94897419","30","106713129"
"chr1","201616215","201616348","chr1","68709407","68709549","31","132906808"
"chr1","201626339","201626472","chr20","49805105","49805234","25","151821234"
"chr1","201626568","201626735","chr3","177436033","177436201","33","24190535"
"chr1","201626807","201627084","chr22","24447216","24447505","35","177179591"
"chr1","201631247","201631343","chr1","46605351","46605452","24","155025896"
"chr1","201631589","201631798","chr17","1429564","1429780","40","200202025"
"chr1","201640552","201640847","chr22","24447939","24448236","37","177192613"
"chr1","201678781","201678932","chr18","18077286","18077437","28","183601495"
"chr1","201710974","201711278","chr22","24524830","24525137","41","177186144"
"chr1","201736907","201737196","chr12","30354259","30354546","62","171382648"
"chr1","201752681","201752850","chr22","24594738","24594916","29","177157943"
"chr1","201758147","201758449","chr22","24599083","24599396","45","177159064"
"chr1","201810226","201810508","chr22","24642907","24643177","50","177167319"
"chr1","201810531","201810641","chr3","127187671","127187781","22","74622860"
"chr1","201812556","201812803","chr22","24644958","24645243","70","177167598"
"chr1","201817999","201818266","chr22","24650086","24650352","27","177167913"
"chr1","201856985","201857107","chr18","47420379","47420493","28","154436606"
"chr1","201864923","201865193","chr1","27882391","27882663","71","173982532"
"chr1","201866668","201866911","chr22","24706988","24707266","61","177159680"
"chr1","201882606","201882837","chr5","45924297","45924518","63","155958309"
"chr1","201885902","201886051","chr8","45239445","45239607","35","156646457"
"chr1","201903976","201904269","chr22","24737772","24738032","74","177166204"
"chr1","201935185","201935469","chr22","24764887","24765182","43","177170298"
"chr1","201967972","201968137","chr3","10866047","10866211","35","191101925"
"chr1","201983484","201983783","chr22","24809554","24809858","39","177173930"
"chr1","202004796","202005091","chr1","227415933","227416230","57","25411137"
"chr1","202050545","202050836","chr22","24874114","24874424","51","177176431"
"chr1","202108229","202108519","chr1","94631747","94632049","73","107476482"
"chr1","202130474","202130741","chr7","128027283","128027543","57","74103191"
"chr1","202156944","202157055","chr22","24990473","24990595","23","177166471"
"chr1","202166171","202166294","chr5","121921600","121921724","22","80244571"
"chr1","202231902","202232156","chr22","25061065","25061348","55","177170837"
"chr1","202239628","202239864","chr22","25069114","25069380","57","177170514"
"chr1","202304383","202304530","chr20","32123638","32123783","24","170180745"
"chr1","202322675","202322939","chr1","159711180","159711445","54","42611495"
"chr1","202389619","202389874","chr7","127613518","127613768","71","74776101"
"chr1","202408001","202408146","chr15","69740012","69740164","34","132667989"
"chr1","202440514","202440637","chr3","125378751","125378875","18","77061763"
"chr1","202468577","202468639","chr22","26052406","26052470","6","176416171"
"chr1","202477024","202477217","chr2B","125358792","125358990","43","77118232"
"chr1","202479621","202479796","chr1","210449448","210449598","56","7969827"
"chr1","202483237","202483425","chr1","125661553","125661746","47","76821684"
"chr1","202487713","202487988","chr12","32842272","32842558","76","169645441"
"chr1","202493992","202494259","chrX","10667579","10667853","59","191826413"
"chr1","202499396","202499553","chr19","54305228","54305386","37","148194168"
"chr1","202588811","202588942","chr3","15286672","15286801","17","187302139"
"chr1","202589624","202589778","chr7","78925352","78925506","35","123664272"
"chr1","202627034","202627293","chr22","26190305","26190570","53","176436729"
"chr1","202632524","202632783","chr22","26190305","26190570","51","176442219"
"chr1","202664588","202664817","chr15","10716093","10716334","69","191948495"
"chr1","202668893","202669046","chr10","90071080","90071242","35","112597813"
"chr1","202679741","202679786","chr3","169444492","169444534","8","33235249"
"chr1","202691448","202691644","chr1","211129502","211129681","57","8438054"
"chr1","202702705","202702826","chr17","19532121","19532242","24","183170584"
"chr1","202724641","202724842","chr1","192036490","192036687","43","10688151"
"chr1","202725738","202725837","chr12","123283368","123283474","25","79442370"
"chr1","202749040","202749330","chr22","26329077","26329371","46","176419963"
"chr1","202756859","202757152","chr22","26336354","26336662","51","176420505"
"chr1","202762341","202762495","chr19","51781571","51781725","33","150980770"
"chr1","202763531","202763662","chr11","115680345","115680475","22","87083186"
"chr1","202765126","202765409","chr22","26342848","26343149","43","176422278"
"chr1","202777737","202777934","chr22","26351697","26351901","28","176426040"
"chr1","202777935","202778040","chr3","124652697","124652800","32","78125238"
"chr1","202816158","202816337","chr7","4828552","4828727","38","197987606"
"chr1","202847716","202848014","chr22","26429138","26429448","35","176418578"
"chr1","202915383","202915675","chr2B","9130073","9130360","63","193785310"
"chr1","202971053","202971327","chr14","54791229","54791504","68","148179824"
"chr1","202992335","202992653","chr3","139056809","139057112","77","63935526"
"chr1","203021113","203021372","chr10","86440089","86440353","68","116581024"
"chr1","203026414","203026699","chr22","15736295","15736592","47","187290119"
"chr1","203042106","203042398","chr3","186984243","186984545","39","16057863"
"chr1","203068135","203068360","chr6","146361614","146361839","47","56706521"
"chr1","203086007","203086284","chr12","123570594","123570856","57","79515413"
"chr1","203142041","203142331","chr12","131165372","131165653","56","71976669"
"chr1","203144011","203144111","chr11","18250271","18250372","19","184893740"
"chr1","203175771","203176081","chr22","26689935","26690245","37","176485836"
"chr1","203177514","203177646","chr22","26692900","26693034","17","176484614"
"chr1","203354517","203354746","chr6","113806159","113806380","58","89548358"
"chr1","203712372","203712644","chr1","7480351","7480627","57","196232021"
"chr1","203718145","203718446","chr22","27241483","27241785","32","176476662"
"chr1","203746348","203746475","chr16","21575308","21575433","16","182171040"
"chr1","203747620","203747743","chr6","48492641","48492762","18","155254979"
"chr1","203841678","203841944","chr22","27324965","27325228","31","176516713"
"chr1","203870712","203871016","chr22","27427385","27427691","31","176443327"
"chr1","203955345","203955619","chr22","27518988","27519273","34","176436357"
"chr1","203986808","203987114","chr22","27551709","27552019","41","176435099"
"chr1","203993454","203993755","chr22","27558833","27559133","57","176434621"
"chr1","204030056","204030125","chr2B","5742542","5742608","11","198287514"
"chr1","204030610","204030848","chr19","37794171","37794401","57","166236439"
"chr1","204200782","204200941","chr3","170205579","170205742","35","33995203"
"chr1","204237070","204237352","chrX","6801013","6801292","66","197436057"
"chr1","204246847","204247015","chr5","152603830","152604006","44","51643017"
"chr1","204406848","204407090","chr3","102853527","102853751","63","101553321"
"chr1","204415723","204415866","chr18","20901830","20901975","34","183513893"
"chr1","204466047","204466359","chr1","23208757","23209065","63","181257290"
"chr1","204542964","204543260","chr22","28473945","28474243","33","176069019"
"chr1","204552046","204552200","chr5","118399435","118399596","37","86152611"
"chr1","204598433","204598710","chr12","38220574","38220851","62","166377859"
"chr1","204634649","204634889","chr22","28583063","28583343","61","176051586"
"chr1","204710344","204710450","chr4","6007123","6007231","21","198703221"
"chr1","204711764","204712061","chr22","28666220","28666521","35","176045544"
"chr1","204717386","204717483","chr1","203014873","203014973","26","1702513"
"chr1","204734261","204734385","chr14","60352578","60352701","32","144381683"
"chr1","204753678","204753939","chr5","160755148","160755395","56","43998530"
"chr1","204776484","204776726","chr22","28714625","28714882","59","176061859"
"chr1","204787831","204788080","chr22","28726346","28726615","67","176061485"
"chr1","204793032","204793217","chrX","48104352","48104537","41","156688680"
"chr1","204804453","204804743","chr22","28748910","28749199","43","176055543"
"chr1","204813741","204813864","chr1","94182758","94182881","21","110630983"
"chr1","204813877","204813969","chr5","26761731","26761826","25","178052146"
"chr1","204849723","204850010","chr2B","94932795","94933081","48","109916928"
"chr1","204893509","204893635","chr8","110146039","110146162","33","94747470"
"chr1","204901863","204901996","chr1","215271336","215271467","24","10369473"
"chr1","204972159","204972323","chr8","73679726","73679887","29","131292433"
"chr1","205014879","205015150","chr5","141078401","141078673","54","63936478"
"chr1","205026450","205026704","chr22","28841142","28841406","43","176185308"
"chr1","205036100","205036378","chr12","111654480","111654770","57","93381620"
"chr1","205058950","205059078","chr1","187726107","187726234","20","17332843"
"chr1","205083649","205083808","chr14","13978622","13978781","35","191105027"
"chr1","205084690","205084853","chrX","130137391","130137550","35","74947299"
"chr1","205090463","205090764","chr8","95190080","95190372","63","109900383"
"chr1","205107966","205108153","chr22","28917579","28917781","40","176190387"
"chr1","205182987","205183258","chr1","27882391","27882663","60","177300596"
"chr1","205194553","205194671","chr22","28983869","28983985","15","176210684"
"chr1","205261155","205261287","chr6","18588428","18588554","38","186672727"
"chr1","205358217","205358326","chr10","88882589","88882699","22","116475628"
"chr1","205401964","205402247","chr1","191294315","191294590","59","14107649"
"chr1","205415994","205416281","chr22","29236610","29236902","40","176179384"
"chr1","205422500","205422622","chr7","11248117","11248241","15","194174383"
"chr1","205463867","205464160","chr22","29282120","29282417","26","176181747"
"chr1","205465052","205465345","chr22","29282120","29282417","26","176182932"
"chr1","205465891","205466196","chr22","29283721","29284023","39","176182170"
"chr1","205501548","205501852","chr22","29317212","29317529","60","176184336"
"chr1","205545855","205546124","chr5","28117505","28117776","74","177428350"
"chr1","205556666","205556792","chr3","65193379","65193500","19","140363287"
"chr1","205646338","205646512","chr7","21503014","21503194","39","184143324"
"chr1","205649314","205649609","chr22","29529899","29530206","49","176119415"
"chr1","205650386","205650555","chr16","21019777","21019933","46","184630609"
"chr1","205872115","205872411","chrX","133855012","133855314","71","72017103"
"chr1","205902383","205902695","chr22","29814747","29815047","60","176087636"
"chr1","205915469","205915708","chr19","7781825","7782069","61","198133644"
"chr1","205959742","205959865","chr22","29869836","29869959","11","176089906"
"chr1","205978046","205978357","chr22","29884420","29884736","42","176093626"
"chr1","206092462","206092734","chr22","29991543","29991825","41","176100919"
"chr1","206096859","206097155","chrX","119401800","119402094","61","86695059"
"chr1","206108107","206108382","chr22","30006997","30007285","46","176101110"
"chr1","206108762","206108863","chr22","24695562","24695662","25","181413200"
"chr1","206148052","206148334","chr22","2260581","2260867","35","203887471"
"chr1","206238942","206239257","chr22","30123483","30123790","49","176115459"
"chr1","206246143","206246406","chr7","4754701","4754955","62","201491442"
"chr1","206248797","206249063","chr7","4754701","4754955","62","201494096"
"chr1","206291290","206291575","chr18","19949790","19950070","53","186341500"
"chr1","206320107","206320405","chr22","30195151","30195450","27","176124956"
"chr1","206393215","206393380","chr14","54909398","54909558","40","151483817"
"chr1","206561379","206561507","chr6","25352056","25352181","19","181209323"
"chr1","206699769","206700035","chr12","91667609","91667873","54","115032160"
"chr1","206882323","206882438","chr22","30722083","30722197","15","176160240"
"chr1","207042771","207043055","chr22","30921687","30921967","36","176121084"
"chr1","207142908","207143210","chr22","31145666","31145964","31","175997242"
"chr1","207336108","207336237","chr7","74643014","74643130","30","132693094"
"chr1","207704492","207704669","chr22","31603170","31603350","43","176101322"
"chr1","207712731","207712845","chr13","9559854","9559959","29","198152877"
"chr1","208048592","208048725","chr9","91746687","91746807","37","116301905"
"chr1","208048928","208049007","chr5","36110533","36110617","15","171938395"
"chr1","208239573","208239865","chr22","32164956","32165234","54","176074617"
"chr1","209021255","209021536","chrX","134453409","134453684","61","74567846"
"chr1","209265695","209265870","chr10","140245600","140245778","33","69020095"
"chr1","209389579","209389721","chr15","35101273","35101404","38","174288306"
"chr1","209390556","209390784","chr6","110331265","110331491","47","99059291"
"chr1","209394139","209394362","chr7","79015379","79015601","52","130378760"
"chr1","209414592","209414865","chr6","108788963","108789228","73","100625629"
"chr1","209416935","209417224","chr22","33772028","33772329","59","175644907"
"chr1","209418217","209418338","chr22","33773397","33773518","18","175644820"
"chr1","209447083","209447355","chr22","33807783","33808068","54","175639300"
"chr1","209456072","209456198","chr7","77000001","77000126","34","132456071"
"chr1","209459451","209459612","chr5","51144248","51144411","27","158315203"
"chr1","209461498","209461784","chr22","33821197","33821475","47","175640301"
"chr1","209536854","209537120","chr13","57876082","57876367","70","151660772"
"chr1","209568884","209569059","chr14","74004180","74004352","35","135564704"
"chr1","209592758","209592927","chr22","34021970","34022141","31","175570788"
"chr1","209620054","209620327","chrX","154341818","154342097","54","55278236"
"chr1","209621418","209621555","chr7","76532502","76532636","17","133088916"
"chr1","209622912","209623168","chr2A","81492519","81492778","58","128130393"
"chr1","209634802","209635085","chr22","33992131","33992434","43","175642671"
"chr1","209642076","209642218","chr6","158178221","158178360","34","51463855"
"chr1","209665416","209665568","chr21","24574752","24574903","31","185090664"
"chr1","209675716","209675884","chr22","34031915","34032078","21","175643801"
"chr1","209682461","209682603","chr1","215271336","215271467","44","5588875"
"chr1","209721194","209721324","chr6","154239364","154239482","40","55481830"
"chr1","209860618","209860767","chr12","106911911","106912059","34","102948707"
"chr1","209882263","209882567","chr9","15043290","15043588","64","194838973"
"chr1","209896732","209896885","chr18","2763372","2763540","38","207133360"
"chr1","209901407","209901671","chrX","53682177","53682448","67","156219230"
"chr1","209905167","209905326","chr10","108461325","108461484","46","101443842"
"chr1","209908843","209909012","chr6","118855023","118855193","36","91053820"
"chr1","209932295","209932431","chr7","105919947","105920079","28","104012348"
"chr1","210000308","210000433","chr13","82394645","82394770","24","127605663"
"chr1","210024379","210024480","chr7","137657037","137657144","25","72367342"
"chr1","210058924","210059143","chr22","34423530","34423748","25","175635394"
"chr1","210083681","210083992","chr4","776004","776286","84","209307677"
"chr1","210111144","210111420","chrX","151079126","151079396","60","59032018"
"chr1","210202185","210202262","chr1","52720253","52720332","13","157481932"
"chr1","210234736","210235045","chr22","34581431","34581731","55","175653305"
"chr1","210305982","210306143","chr3","14267985","14268147","37","196037997"
"chr1","210325881","210326128","chr7","62910013","62910278","53","147415868"
"chr1","210343387","210343681","chr7","40298604","40298898","25","170044783"
"chr1","210343712","210343829","chr3","195430646","195430763","12","14913066"
"chr1","210345500","210345621","chr2A","59484557","59484680","22","150860943"
"chr1","210348612","210348908","chr7","64692898","64693200","39","145655714"
"chr1","210349324","210349615","chr7","65790336","65790637","51","144558988"
"chr1","210350153","210350271","chr7","64691543","64691651","20","145658610"
"chr1","210352010","210352294","chr1","202592673","202592956","43","7759337"
"chr1","210353159","210353458","chr7","65786962","65787261","58","144566197"
"chr1","210356461","210356755","chr7","74675945","74676251","60","135680516"
"chr1","210370785","210371076","chr7","74678319","74678629","60","135692466"
"chr1","210388491","210388527","chr14","58573189","58573234","11","151815302"
"chr1","210388712","210388782","chr2B","62475177","62475250","17","147913535"
"chr2","34733871","34734176","chr5","121352562","121352869","35","86618691"
"chr2","52821891","52822025","chr6","92231625","92231742","34","39409734"
"chr2","63176637","63176937","chr4","159943162","159943459","58","96766525"
"chr2","159907805","159908099","chr17","51910717","51911024","38","107997088"
"chr2","182320974","182321272","chr12","108862749","108863042","80","73458225"
"chr2","19164","19231","chr7","74749784","74749855","18","74730620"
"chr2","19258","19359","chr14","41346776","41346870","30","41327518"
"chr2","20002","20062","chr7","140209225","140209286","18","140189223"
"chr2","53664","53950","chr7","74678319","74678629","64","74624655"
"chr2","60065","60349","chr7","64708983","64709272","38","64648918"
"chr2","61290","61523","chr1","375147","375386","52","313857"
"chr2","62121","62425","chr7","64724033","64724333","32","64661912"
"chr2","88727","88818","chr1","157737408","157737505","19","157648681"
"chr2","106379","106504","chr3","99737926","99738037","25","99631547"
"chr2","115854","116155","chr7","40298604","40298898","37","40182750"
"chr2","117473","117757","chr7","64708983","64709272","39","64591510"
"chr2","119924","120195","chr4","130414026","130414325","60","130294102"
"chr2","133152","133458","chr7","65255439","65255737","44","65122287"
"chr2","135752","136041","chr19","3146406","3146696","70","3010654"
"chr2","138271","138538","chr21","27771184","27771449","59","27632913"
"chr2","145036","145160","chr16","33997666","33997792","21","33852630"
"chr2","146558","146799","chr7","44645393","44645629","53","44498835"
"chr2","147443","147539","chr3","58419028","58419121","35","58271585"
"chr2","147707","147837","chrX","2794957","2795096","31","2647250"
"chr2","156620","156923","chr7","64761641","64761956","51","64605021"
"chr2","180782","180914","chr12","58083402","58083534","24","57902620"
"chr2","182956","183102","chr19","17276844","17276987","48","17093888"
"chr2","205871","205991","chr16","11662327","11662451","15","11456456"
"chr2","255667","255787","chr16","11662327","11662451","15","11406660"
"chr2","297691","297881","chr1","128515373","128515560","43","128217682"
"chr2","298529","298813","chr16","11765519","11765793","49","11466990"
"chr2","315916","316023","chr11","67337030","67337134","22","67021114"
"chr2","328472","328528","chr8","84889204","84889263","17","84560732"
"chr2","336641","336745","chr20","29999827","29999928","34","29663186"
"chr2","337431","337585","chr16","29999340","29999496","37","29661909"
"chr2","369436","369698","chr12","48393325","48393593","61","48023889"
"chr2","600681","600802","chr16","11662327","11662451","18","11061646"
"chr2","666861","667121","chr7","63718518","63718800","58","63051657"
"chr2","732653","732773","chr19","19802762","19802880","29","19070109"
"chr2","799831","800121","chr19","23013640","23013944","66","22213809"
"chr2","883756","883881","chr17","7830688","7830812","22","6946932"
"chr2","956058","956184","chr7","64739810","64739946","20","63783752"
"chr2","1074371","1074657","chr7","65125213","65125516","54","64050842"
"chr2","1084128","1084430","chr1","150808926","150809223","63","149724798"
"chr2","1098423","1098709","chr7","65096200","65096484","33","63997777"
"chr2","1104051","1104175","chr11","61771478","61771601","18","60667427"
"chr2","1113905","1114181","chr14","21204794","21205060","66","20090889"
"chr2","1121921","1122089","chr11","58592944","58593112","34","57471023"
"chr2","1123036","1123099","chr19","35392753","35392810","14","34269717"
"chr2","1125305","1125589","chr16","16871349","16871642","72","15746044"
"chr2","1141321","1141608","chr7","65073808","65074098","56","63932487"
"chr2","1146361","1146484","chr6","154239364","154239482","34","153093003"
"chr2","1152238","1152541","chr7","65057314","65057620","46","63905076"
"chr2","1153756","1153922","chr8","56795337","56795503","31","55641581"
"chr2","1160184","1160274","chr1","113839333","113839427","16","112679149"
"chr2","1161703","1162008","chr12","95059058","95059354","67","93897355"
"chr2","1164369","1164635","chr3","123479061","123479344","77","122314692"
"chr2","1224911","1225036","chr7","64929838","64929961","17","63704927"
"chr2","1225367","1225603","chr7","64930304","64930550","45","63704937"
"chr2","1244000","1244167","chr15","26042936","26043107","30","24798936"
"chr2","1255792","1255997","chr11","58619029","58619230","50","57363237"
"chr2","1280769","1280990","chr6","27460925","27461127","50","26180156"
"chr2","1282097","1282339","chr1","21872293","21872542","49","20590196"
"chr2","1289267","1289342","chr7","5047912","5047980","28","3758645"
"chr2","1307797","1308092","chr7","64824415","64824714","46","63516618"
"chr2","1324672","1324953","chr7","87784694","87784974","72","86460022"
"chr2","1332176","1332455","chr5","26154281","26154566","62","24822105"
"chr2","1347223","1347368","chr7","64785908","64786052","25","63438685"
"chr2","1353257","1353358","chr16","40500758","40500859","18","39147501"
"chr2","1368297","1368615","chr7","64761641","64761956","43","63393344"
"chr2","1379355","1379655","chr7","64752571","64752861","46","63373216"
"chr2","1381099","1381222","chrX","151139490","151139606","29","149758391"
"chr2","1396225","1396521","chr7","65505788","65506061","51","64109563"
"chr2","1398802","1399087","chr6","5241708","5241991","70","3842906"
"chr2","1400549","1400673","chr7","64736385","64736513","19","63335836"
"chr2","1402793","1402918","chr7","11248117","11248241","21","9845324"
"chr2","1404052","1404317","chr16","31649333","31649595","65","30245281"
"chr2","1416568","1416858","chr7","64733446","64733744","47","63316878"
"chr2","1422916","1423207","chr7","64724033","64724333","39","63301117"
"chr2","1423476","1423556","chr5","134435512","134435582","25","133012036"
"chr2","1423794","1424065","chr1","202556093","202556392","51","201132299"
"chr2","1425067","1425329","chr7","57139485","57139751","40","55714418"
"chr2","1426387","1426683","chr7","74655700","74655993","34","73229313"
"chr2","1426718","1426836","chr3","195430646","195430763","19","194003928"
"chr2","1428573","1428787","chr7","56490261","56490482","40","55061688"
"chr2","1428839","1429001","chr5","2493450","2493615","30","1064611"
"chr2","1443752","1443992","chr2A","41941827","41942076","62","40498075"
"chr2","1444704","1444951","chr22","12487200","12487457","66","11042496"
"chr2","1445814","1445890","chr10","49625796","49625873","14","48179982"
"chr2","1448009","1448301","chr7","65290235","65290525","54","63842226"
"chr2","1471334","1471527","chr4","130334249","130334435","33","128862915"
"chr2","1483900","1484101","chr9","56757377","56757578","61","55273477"
"chr2","1484135","1484422","chr7","65530658","65530956","64","64046523"
"chr2","1484442","1484573","chr7","65530976","65531103","15","64046534"
"chr2","1488046","1488140","chr7","65534890","65534985","11","64046844"
"chr2","1489354","1489499","chr7","65571374","65571524","16","64082020"
"chr2","1501874","1502168","chr7","65547996","65548308","62","64046122"
"chr2","1514419","1514528","chr1","30716726","30716837","19","29202307"
"chr2","1530324","1530440","chr7","65485159","65485276","20","63954835"
"chr2","1600984","1601186","chr10","17903164","17903367","47","16302180"
"chr2","1623073","1623361","chr7","65855666","65855955","45","64232593"
"chr2","1626710","1626984","chr7","65859600","65859872","26","64232890"
"chr2","1631798","1632109","chr16","23250878","23251188","65","21619080"
"chr2","1635591","1635684","chr7","65870834","65870931","14","64235243"
"chr2","1638554","1638706","chr4","131467906","131468050","31","129829352"
"chr2","1649343","1649645","chr11","43581074","43581350","80","41931731"
"chr2","1654686","1654814","chr7","65911255","65911384","16","64256569"
"chr2","1655823","1655911","chr5","40734755","40734844","21","39078932"
"chr2","1669045","1669334","chr7","65925976","65926271","57","64256931"
"chr2","1671631","1671943","chr7","65927360","65927673","51","64255729"
"chr2","1674783","1675044","chr7","71752162","71752431","48","70077379"
"chr2","1678209","1678492","chr7","71749413","71749714","46","70071204"
"chr2","1696468","1696777","chr7","71728303","71728613","38","70031835"
"chr2","1727456","1727712","chr7","71705249","71705504","27","69977793"
"chr2","1729621","1729847","chr5","162792574","162792786","59","161062953"
"chr2","1742862","1743174","chr7","65978974","65979271","44","64236112"
"chr2","1763670","1763981","chr12","43802996","43803296","58","42039326"
"chr2","1790164","1790416","chr7","71640412","71640675","38","69850248"
"chr2","1802867","1803157","chr7","66052550","66052843","56","64249683"
"chr2","1812160","1812468","chr7","71608552","71608858","59","69796392"
"chr2","1819482","1819633","chr17","19718712","19718873","40","17899230"
"chr2","1830435","1830651","chr5","137395548","137395757","61","135565113"
"chr2","1845297","1845611","chr7","71563654","71563960","48","69718357"
"chr2","1872669","1873024","chr3","195583731","195584055","106","193711062"
"chr2","1895311","1895600","chr7","71528371","71528672","48","69633060"
"chr2","1911879","1912171","chr7","71495347","71495641","37","69583468"
"chr2","1922875","1923135","chr5","79883377","79883636","54","77960502"
"chr2","1948035","1948293","chr7","71438922","71439195","51","69490887"
"chr2","1948663","1948903","chr7","71438272","71438525","38","69489609"
"chr2","1953779","1953982","chr7","71433066","71433271","24","69479287"
"chr2","1958544","1958698","chr7","71408534","71408701","30","69449990"
"chr2","1959619","1959674","chr7","71408192","71408250","12","69448573"
"chr2","1959721","1960012","chr7","71407856","71408159","50","69448135"
"chr2","1983677","1983949","chr7","71381940","71382243","65","69398263"
"chr2","1985389","1985605","chr7","71380794","71381011","32","69395405"
"chr2","1988264","1988571","chr7","71378872","71379190","65","69390608"
"chr2","1988889","1988962","chr1","224822809","224822879","21","222833920"
"chr2","1989398","1989625","chr18","55165662","55165888","64","53176264"
"chr2","1991570","1991853","chr7","71375461","71375762","52","69383891"
"chr2","1995876","1996100","chr7","71371439","71371678","46","69375563"
"chr2","1996348","1996634","chr7","71370919","71371186","48","69374571"
"chr2","2024460","2024733","chr18","2290499","2290770","66","266039"
"chr2","2033079","2033257","chr19","17316411","17316606","48","15283332"
"chr2","2038780","2039036","chr16","29812981","29813238","61","27774201"
"chr2","2045726","2046017","chr7","71298655","71298940","46","69252929"
"chr2","2080189","2080483","chr7","71265690","71265982","41","69185501"
"chr2","2086626","2086947","chr7","71257393","71257705","62","69170767"
"chr2","2104061","2104353","chr4","200945382","200945675","62","198841321"
"chr2","2108509","2108765","chr19","4744372","4744649","66","2635863"
"chr2","2113487","2113757","chr7","71226257","71226531","43","69112770"
"chr2","2114246","2114546","chr7","71225482","71225779","40","69111236"
"chr2","2136794","2137098","chr2B","124328401","124328713","59","122191607"
"chr2","2145427","2145647","chr5","4427940","4428166","46","2282513"
"chr2","2151733","2152014","chr7","1708256","1708538","66","443477"
"chr2","2160374","2160676","chr7","71182532","71182838","35","69022158"
"chr2","2166273","2166573","chr7","71177328","71177616","63","69011055"
"chr2","2167801","2168075","chr7","71175769","71176042","51","69007968"
"chr2","2171659","2171888","chr11","33850820","33851043","58","31679161"
"chr2","2180446","2180578","chr7","71160722","71160855","24","68980276"
"chr2","2181841","2182125","chr7","71158559","71158843","42","68976718"
"chr2","2185342","2185645","chr7","71154982","71155281","49","68969640"
"chr2","2200629","2200933","chr10","31508695","31508998","79","29308066"
"chr2","2204139","2204434","chr7","71135149","71135440","46","68931010"
"chr2","2215466","2215744","chr2B","123974923","123975196","59","121759457"
"chr2","2230312","2230437","chr1","44892994","44893123","35","42662682"
"chr2","2230601","2230681","chr6","108167255","108167324","29","105936654"
"chr2","2236870","2237081","chr18","53808221","53808435","47","51571351"
"chr2","2245852","2246015","chr4","190209315","190209476","34","187963463"
"chr2","2264861","2265153","chr7","71060451","71060745","59","68795590"
"chr2","2276181","2276259","chr7","5928715","5928794","15","3652534"
"chr2","2276262","2276368","chr5","14822723","14822826","27","12546461"
"chr2","2288471","2288785","chr1","43334172","43334483","68","41045701"
"chr2","2290231","2290531","chr7","71036574","71036885","49","68746343"
"chr2","2291860","2291988","chr16","12003452","12003583","20","9711592"
"chr2","2304662","2304775","chr4","8171547","8171660","19","5866885"
"chr2","2315661","2315970","chr7","71011122","71011428","52","68695461"
"chr2","2323313","2323608","chr19","3146406","3146696","65","823093"
"chr2","2324723","2324854","chr9","112841011","112841143","21","110516288"
"chr2","2345797","2346022","chrX","77183292","77183528","69","74837495"
"chr2","2355919","2356225","chr7","70979087","70979375","51","68623168"
"chr2","2356730","2357024","chr7","70977951","70978224","55","68621221"
"chr2","2364319","2364486","chr7","70966511","70966672","31","68602192"
"chr2","2365048","2365317","chr7","70965687","70965946","53","68600639"
"chr2","2373174","2373422","chr7","74375314","74375570","58","72002140"
"chr2","2382186","2382453","chr1","139768169","139768436","51","137385983"
"chr2","2397502","2397811","chr7","70932325","70932637","47","68534823"
"chr2","2399867","2399997","chr10","29641490","29641621","32","27241623"
"chr2","2400696","2400997","chr7","70922176","70922480","44","68521480"
"chr2","2414173","2414427","chr7","70907006","70907258","31","68492833"
"chr2","2415840","2416152","chr7","70905233","70905540","53","68489393"
"chr2","2438390","2438681","chr17","3743215","3743513","64","1304825"
"chr2","2448543","2448795","chr7","70866806","70867070","47","68418263"
"chr2","2454255","2454507","chr7","70861509","70861765","31","68407254"
"chr2","2501613","2501886","chr7","70823739","70823992","49","68322126"
"chr2","2515257","2515541","chr7","70811237","70811523","44","68295980"
"chr2","2518219","2518506","chr1","163867986","163868280","54","161349767"
"chr2","2540605","2540845","chr1","28917331","28917589","69","26376726"
"chr2","2552486","2552802","chr1","2285941","2286239","92","266545"
"chr2","2553919","2554035","chr1","22816031","22816147","18","20262112"
"chr2","2554431","2554571","chr1","17368221","17368352","33","14813790"
"chr2","2576879","2577163","chrX","3276567","3276828","88","699688"
"chr2","2578858","2579075","chr7","70734024","70734244","34","68155166"
"chr2","2590617","2590860","chr7","70722391","70722655","54","68131774"
"chr2","2593527","2593732","chr7","70720639","70720850","34","68127112"
"chr2","2627574","2627897","chr7","70696907","70697185","91","68069333"
"chr2","2665069","2665200","chr2A","38252267","38252397","29","35587198"
"chr2","2669752","2670050","chr7","70687318","70687625","38","68017566"
"chr2","2671430","2671717","chr7","70685600","70685891","63","68014170"
"chr2","2684382","2684691","chr1","2285941","2286239","65","398441"
"chr2","2706681","2706956","chr9","189871","190152","50","2516810"
"chr2","2708320","2708622","chr7","70641580","70641883","38","67933260"
"chr2","2730312","2730428","chr3","9547020","9547137","19","6816708"
"chr2","2751325","2751629","chr7","70613165","70613470","49","67861840"
"chr2","2765623","2765702","chr4","107973325","107973400","19","105207702"
"chr2","2766095","2766166","chr6","159585740","159585805","23","156819645"
"chr2","2767232","2767501","chr19","4570608","4570877","60","1803376"
"chr2","2770112","2770383","chr12","125129033","125129295","58","122358921"
"chr2","2788169","2788445","chr7","70573929","70574210","27","67785760"
"chr2","2798032","2798319","chr10","34930325","34930616","62","32132293"
"chr2","2804747","2804858","chr1","105602976","105603094","32","102798229"
"chr2","2822320","2822607","chr7","70547183","70547482","52","67724863"
"chr2","2823832","2824147","chr7","70545476","70545778","46","67721644"
"chr2","2838420","2838632","chr7","70530366","70530576","25","67691946"
"chr2","2842846","2843120","chr7","70526178","70526469","47","67683332"
"chr2","2846375","2846538","chr13","11997588","11997744","37","9151213"
"chr2","2850043","2850320","chr1","114215175","114215449","72","111365132"
"chr2","2856410","2856704","chr14","48510671","48510969","67","45654261"
"chr2","2858444","2858745","chr7","70511301","70511609","49","67652857"
"chr2","2860389","2860673","chr7","70509045","70509332","48","67648656"
"chr2","2880831","2881105","chr7","70487907","70488190","35","67607076"
"chr2","2887662","2887862","chr10","30668470","30668672","45","27780808"
"chr2","2889269","2889589","chr1","219609006","219609318","66","216719737"
"chr2","2894643","2894855","chrX","115499798","115500000","59","112605155"
"chr2","2939414","2939706","chr7","70427211","70427507","41","67487797"
"chr2","2940346","2940646","chr7","70426271","70426567","41","67485925"
"chr2","2943461","2943756","chr7","70423280","70423591","52","67479819"
"chr2","2945212","2945496","chr7","70421639","70421932","41","67476427"
"chr2","2949144","2949411","chr7","70417616","70417896","47","67468472"
"chr2","2959725","2960092","chr7","70406964","70407255","101","67447239"
"chr2","2960100","2960221","chr1","111861160","111861287","22","108901060"
"chr2","2960879","2960997","chr7","64929838","64929961","23","61968959"
"chr2","2962837","2963137","chr7","70404241","70404545","48","67441404"
"chr2","2974278","2974379","chr8","21495495","21495575","34","18521217"
"chr2","2999189","2999479","chr7","2791295","2791587","62","207894"
"chr2","3012107","3012398","chr7","70354531","70354844","67","67342424"
"chr2","3025898","3026193","chr7","5230390","5230685","60","2204492"
"chr2","3040969","3041228","chr7","70324430","70324719","58","67283461"
"chr2","3044749","3045067","chr9","91580829","91581132","72","88536080"
"chr2","3065675","3065903","chr12","117939199","117939428","57","114873524"
"chr2","3066591","3066851","chr7","70303146","70303419","46","67236555"
"chr2","3078187","3078492","chr7","70294533","70294831","39","67216346"
"chr2","3080675","3080797","chr5","115357306","115357430","21","112276631"
"chr2","3110385","3110666","chrX","124943987","124944282","67","121833602"
"chr2","3112649","3112917","chr7","70260180","70260457","39","67147531"
"chr2","3127133","3127430","chr7","70245705","70246003","40","67118572"
"chr2","3135300","3135564","chr12","113199761","113200025","59","110064461"
"chr2","3139642","3139717","chr11","20340853","20340926","10","17201211"
"chr2","3142425","3142692","chr7","70228987","70229260","40","67086562"
"chr2","3144395","3144655","chr7","70227198","70227459","24","67082803"
"chr2","3180312","3180571","chr7","70188601","70188881","53","67008289"
"chr2","3185154","3185455","chr7","70183490","70183784","47","66998336"
"chr2","3192793","3193090","chr7","70176451","70176751","38","66983658"
"chr2","3206710","3206952","chr12","34227463","34227682","72","31020753"
"chr2","3210587","3210894","chr7","70158629","70158919","50","66948042"
"chr2","3213395","3213693","chr7","70155570","70155865","44","66942175"
"chr2","3215829","3216113","chr20","442593","442877","56","2773236"
"chr2","3218266","3218542","chr1","19992694","19992978","58","16774428"
"chr2","3227761","3228047","chr7","70136625","70136910","59","66908864"
"chr2","3253005","3253318","chr22","5006921","5007232","88","1753916"
"chr2","3254541","3254825","chr18","1313785","1314066","51","1940756"
"chr2","3260259","3260522","chr7","70100918","70101164","56","66840659"
"chr2","3279060","3279354","chr7","70085074","70085365","51","66806014"
"chr2","3298357","3298507","chr13","871735","871882","40","2426622"
"chr2","3303903","3304030","chrX","49113443","49113558","26","45809540"
"chr2","3304353","3304484","chr3","59117856","59117982","21","55813503"
"chr2","3305935","3306215","chr7","70054715","70055009","77","66748780"
"chr2","3308937","3309213","chr7","70052039","70052309","34","66743102"
"chr2","3312332","3312436","chr19","7469095","7469199","19","4156763"
"chr2","3317939","3318103","chr8","56795337","56795503","39","53477398"
"chr2","3364112","3364291","chr14","57274880","57275056","32","53910768"
"chr2","3365870","3366178","chr7","70007069","70007376","40","66641199"
"chr2","3370891","3371201","chr7","70002900","70003197","52","66632009"
"chr2","3373493","3373805","chr7","69999656","69999947","61","66626163"
"chr2","3374544","3374816","chr5","13122526","13122799","58","9747982"
"chr2","3377049","3377344","chr7","69996331","69996605","60","66619282"
"chr2","3387916","3388202","chr16","40763944","40764221","70","37376028"
"chr2","3402303","3402436","chr7","69965789","69965928","23","66563486"
"chr2","3404123","3404246","chr7","69962968","69963091","15","66558845"
"chr2","3463865","3463963","chr7","69898656","69898765","23","66434791"
"chr2","3468394","3468531","chr10","89029688","89029831","35","85561294"
"chr2","3468661","3468777","chr10","93040219","93040335","17","89571558"
"chr2","3469046","3469343","chr7","69894804","69895119","55","66425758"
"chr2","3475352","3475661","chr7","69888625","69888928","43","66413273"
"chr2","3477024","3477300","chr7","69886735","69886992","46","66409711"
"chr2","3478337","3478628","chr7","69885407","69885697","37","66407070"
"chr2","3484747","3485021","chr7","69879970","69880267","53","66395223"
"chr2","3487290","3487568","chr7","69865666","69865963","49","66378376"
"chr2","3488715","3488831","chr7","69864357","69864476","15","66375642"
"chr2","3510948","3511223","chr7","69839773","69840052","33","66328825"
"chr2","3517278","3517481","chr7","72991039","72991241","53","69473761"
"chr2","3524068","3524194","chr17","29865518","29865644","25","26341450"
"chr2","3524504","3524807","chr5","164101373","164101668","75","160576869"
"chr2","3525839","3526135","chr7","69824494","69824774","42","66298655"
"chr2","3536052","3536215","chr18","48327345","48327513","37","44791293"
"chr2","3536951","3537042","chr7","69800457","69800550","10","66263506"
"chr2","3546463","3546742","chr21","8537747","8538014","73","4991284"
"chr2","3564420","3564685","chr7","69764210","69764496","55","66199790"
"chr2","3581398","3581707","chr9","30199381","30199689","72","26617983"
"chr2","3588204","3588503","chr7","69735587","69735866","53","66147383"
"chr2","3604932","3605237","chr19","12449605","12449905","53","8844673"
"chr2","3608648","3608911","chr1","146463578","146463836","56","142854930"
"chr2","3614187","3614482","chr7","69702682","69702995","55","66088495"
"chr2","3647746","3648015","chr16","29812981","29813238","68","26165235"
"chr2","3671289","3671571","chr16","78473737","78474021","62","74802448"
"chr2","3691529","3691616","chrX","47268046","47268133","18","43576517"
"chr2","3691631","3691919","chr7","69615493","69615786","57","65923862"
"chr2","3774686","3774971","chr7","69538149","69538439","39","65763463"
"chr2","3802989","3803180","chr7","69511983","69512198","47","65708994"
"chr2","3820651","3820958","chr7","69494521","69494818","42","65673870"
"chr2","3833356","3833636","chr8","48018378","48018670","68","44185022"
"chr2","3852241","3852528","chr3","48874992","48875286","55","45022751"
"chr2","3879453","3879730","chr6","45950422","45950707","69","42070969"
"chr2","3937329","3937609","chr7","69368127","69368423","53","65430798"
"chr2","3958902","3959065","chr16","10635903","10636067","29","6677001"
"chr2","3971754","3972046","chr7","69333747","69334038","32","65361993"
"chr2","4027362","4027498","chr1","32730027","32730168","33","28702665"
"chr2","4053090","4053391","chr7","69253290","69253594","59","65200200"
"chr2","4083068","4083355","chr7","69221427","69221723","40","65138359"
"chr2","4086613","4086876","chr7","69217212","69217459","46","65130599"
"chr2","4163679","4163948","chr19","57650693","57650963","72","53487014"
"chr2","4197697","4197959","chr15","46793365","46793626","74","42595668"
"chr2","4204659","4204952","chr1","65853095","65853405","71","61648436"
"chr2","4206616","4206892","chr8","74851704","74851993","74","70645088"
"chr2","4284485","4284715","chr7","69049824","69050055","32","64765339"
"chr2","4316596","4316877","chr7","69023904","69024192","46","64707308"
"chr2","4362085","4362342","chr7","69007041","69007278","52","64644956"
"chr2","4378144","4378267","chr7","68991025","68991145","11","64612881"
"chr2","4438152","4438477","chr7","68934435","68934761","38","64496283"
"chr2","4443842","4444126","chr7","68929331","68929635","56","64485489"
"chr2","4487102","4487391","chr7","68887839","68888142","43","64400737"
"chr2","4556953","4557158","chr12","68675053","68675263","52","64118100"
"chr2","4591656","4591879","chr1","1334974","1335184","54","3256682"
"chr2","4642466","4642740","chr7","68745779","68746073","57","64103313"
"chr2","4652081","4652383","chr7","68736127","68736425","39","64084046"
"chr2","4653082","4653206","chr7","68735289","68735413","14","64082207"
"chr2","4665513","4665766","chr7","68721989","68722250","46","64056476"
"chr2","4668008","4668319","chr7","68719744","68720048","60","64051736"
"chr2","4674342","4674443","chr4","121283672","121283773","11","116609330"
"chr2","4675888","4676180","chr7","68712369","68712652","41","64036481"
"chr2","4685195","4685316","chr13","7095404","7095527","23","2410209"
"chr2","4710259","4710546","chr7","68685975","68686272","35","63975716"
"chr2","4813633","4813932","chr7","68585776","68586072","47","63772143"
"chr2","4821668","4821952","chr7","68578882","68579181","42","63757214"
"chr2","4836330","4836452","chr7","68568064","68568196","30","63731734"
"chr2","4844716","4844829","chr9","86429492","86429602","20","81584776"
"chr2","4846977","4847262","chr7","68557706","68557989","37","63710729"
"chr2","4872510","4872705","chr19","40006029","40006215","48","35133519"
"chr2","4875447","4875733","chr7","68525958","68526255","44","63650511"
"chr2","4882906","4883199","chr15","44322063","44322351","75","39439157"
"chr2","4896174","4896447","chr7","68514603","68514891","44","63618429"
"chr2","4897681","4897987","chr7","68512429","68512734","43","63614748"
"chr2","4900797","4901107","chr7","68507960","68508281","41","63607163"
"chr2","4906079","4906356","chr10","39090773","39091051","65","34184694"
"chr2","4907197","4907488","chr7","68502371","68502652","38","63595174"
"chr2","4909825","4910122","chr15","67073000","67073294","62","62163175"
"chr2","4913227","4913519","chr7","68495959","68496249","34","63582732"
"chr2","4914108","4914390","chr7","68495116","68495407","53","63581008"
"chr2","4927763","4928014","chr1","78274306","78274550","60","73346543"
"chr2","4932378","4932685","chr10","27891124","27891423","71","22958746"
"chr2","4948676","4948783","chr7","45148945","45149056","21","40200269"
"chr2","4948822","4949119","chr7","68461392","68461676","39","63512570"
"chr2","4953285","4953531","chr1","162435147","162435391","51","157481862"
"chr2","4956846","4957128","chr8","25785882","25786167","61","20829036"
"chr2","4958347","4958440","chr12","111845659","111845746","19","106887312"
"chr2","4962864","4963170","chr16","28423894","28424195","65","23461030"
"chr2","4972142","4972445","chr7","68432832","68433158","62","63460690"
"chr2","4974971","4975096","chr7","68430416","68430544","11","63455445"
"chr2","4991892","4992171","chr7","68410325","68410623","59","63418433"
"chr2","4996785","4997073","chr10","27155950","27156240","61","22159165"
"chr2","5009245","5009497","chr19","49374004","49374245","55","44364759"
"chr2","5010295","5010340","chr6","91664857","91664899","10","86654562"
"chr2","5010624","5010895","chr10","112353682","112353965","72","107343058"
"chr2","5014573","5014864","chr7","68384072","68384383","61","63369499"
"chr2","5021545","5021837","chr8","126354471","126354762","67","121332926"
"chr2","5022887","5023175","chr7","68375792","68376093","51","63352905"
"chr2","5037902","5038068","chr4","143548207","143548378","34","138510305"
"chr2","5038481","5038592","chr1","204358159","204358274","25","199319678"
"chr2","5038920","5039222","chr7","68358778","68359093","42","63319858"
"chr2","5040016","5040302","chr7","68357686","68357973","39","63317670"
"chr2","5043232","5043518","chr6","11562062","11562332","63","6518830"
"chr2","5045946","5046278","chr7","68351218","68351543","60","63305272"
"chr2","5049977","5050139","chr10","8310997","8311164","33","3261020"
"chr2","5057026","5057329","chr7","68335095","68335397","46","63278069"
"chr2","5061351","5061632","chr7","68326916","68327235","72","63265565"
"chr2","5077340","5077647","chr7","68312320","68312626","43","63234980"
"chr2","5082180","5082452","chr18","19949790","19950070","57","14867610"
"chr2","5091856","5092059","chr7","68291963","68292165","34","63200107"
"chr2","5096564","5096835","chr19","31035474","31035744","59","25938910"
"chr2","5104312","5104492","chr5","25320187","25320372","40","20215875"
"chr2","5109025","5109309","chr7","68274011","68274295","41","63164986"
"chr2","5115537","5115840","chr7","68267021","68267326","52","63151484"
"chr2","5121603","5121890","chr10","129217595","129217874","59","124095992"
"chr2","5122785","5123043","chr7","68260045","68260338","58","63137260"
"chr2","5128166","5128477","chr7","68255243","68255559","43","63127077"
"chr2","5133213","5133411","chrX","31105155","31105351","50","25971942"
"chr2","5135474","5135779","chr7","68249604","68249924","46","63114130"
"chr2","5137754","5137869","chr10","105130162","105130278","16","99992408"
"chr2","5142612","5142975","chr7","68242688","68242973","101","63100076"
"chr2","5146686","5146954","chr7","68233598","68233878","43","63086912"
"chr2","5147665","5147967","chr7","68232568","68232872","32","63084903"
"chr2","5154079","5154308","chr7","68228407","68228635","26","63074328"
"chr2","5159999","5160280","chr7","68219159","68219449","43","63059160"
"chr2","5161944","5162163","chr11","63449576","63449792","61","58287632"
"chr2","5171163","5171250","chr7","68212337","68212424","6","63041174"
"chr2","5173835","5173992","chr10","49585047","49585201","29","44411212"
"chr2","5174613","5174891","chr7","68208631","68208921","50","63034018"
"chr2","5181967","5182255","chr12","67468323","67468606","75","62286356"
"chr2","5182290","5182356","chr3","126872406","126872470","16","121690116"
"chr2","5182458","5182515","chr9","34456289","34456345","12","29273831"
"chr2","5183176","5183463","chr7","68200029","68200338","52","63016853"
"chr2","5184251","5184515","chr14","77606245","77606511","59","72421994"
"chr2","5202507","5202809","chr7","68177847","68178142","40","62975340"
"chr2","5204444","5204752","chr7","57203363","57203652","55","51998919"
"chr2","5215067","5215372","chr7","68153626","68153916","48","62938559"
"chr2","5221339","5221640","chr7","68158551","68158849","35","62937212"
"chr2","5231351","5231647","chr7","56919262","56919581","57","51687911"
"chr2","5245721","5246012","chr7","68117308","68117608","58","62871587"
"chr2","5249110","5249220","chr9","91909520","91909629","17","86660410"
"chr2","5260048","5260339","chr7","68094556","68094846","36","62834508"
"chr2","5279010","5279111","chr3","124652697","124652800","26","119373687"
"chr2","5279112","5279402","chr1","91059171","91059456","53","85780059"
"chr2","5279548","5279710","chr19","17679884","17680046","47","12400336"
"chr2","5281934","5282229","chr7","68072813","68073097","48","62790879"
"chr2","5290125","5290429","chr7","68064686","68064988","38","62774561"
"chr2","5295053","5295348","chr7","68060504","68060793","45","62765451"
"chr2","5304879","5305185","chr7","68046660","68046974","60","62741781"
"chr2","5314037","5314324","chr13","32515949","32516233","62","27201912"
"chr2","5315928","5316060","chr20","33646691","33646820","22","28330763"
"chr2","5316669","5316817","chr1","52325310","52325464","27","47008641"
"chr2","5325849","5326145","chr7","68023637","68023904","55","62697788"
"chr2","5327433","5327592","chr3","10866047","10866211","45","5538614"
"chr2","5328865","5329024","chr3","10866047","10866211","35","5537182"
"chr2","5335654","5335913","chrX","156319225","156319483","53","150983571"
"chr2","5339557","5339850","chr7","68010801","68011101","31","62671244"
"chr2","5347832","5348109","chr19","7726876","7727158","54","2379044"
"chr2","5348835","5349121","chr7","67997559","67997830","43","62648724"
"chr2","5379384","5379687","chr7","67964485","67964777","38","62585101"
"chr2","5381705","5381989","chr7","67962143","67962437","53","62580438"
"chr2","5387592","5387811","chr6","45626172","45626405","67","40238580"
"chr2","5390157","5390460","chr7","67947800","67948097","45","62557643"
"chr2","5391629","5391688","chr10","115667778","115667834","9","110276149"
"chr2","5391764","5391855","chr7","67946656","67946746","7","62554892"
"chr2","5392483","5392599","chr12","121640784","121640892","24","116248301"
"chr2","5399717","5399985","chr7","67939857","67940153","60","62540140"
"chr2","5439376","5439492","chr7","68275138","68275242","34","62835762"
"chr2","5444346","5444640","chr7","129054394","129054678","63","123610048"
"chr2","5446471","5446745","chr7","67881759","67882022","42","62435288"
"chr2","5462178","5462457","chr6","17529995","17530282","51","12067817"
"chr2","5463456","5463725","chr7","70227198","70227459","56","64763742"
"chr2","5470379","5470553","chr6","35277961","35278135","50","29807582"
"chr2","5473747","5474038","chrX","103981721","103982018","64","98507974"
"chr2","5474454","5474764","chr7","67852439","67852749","25","62377985"
"chr2","5487073","5487385","chr19","13014558","13014854","81","7527485"
"chr2","5517332","5517636","chr7","67783113","67783412","45","62265781"
"chr2","5521877","5522178","chr7","67779993","67780289","38","62258116"
"chr2","5574127","5574416","chr20","45505365","45505648","60","39931238"
"chr2","5580188","5580450","chr2A","98714637","98714885","55","93134449"
"chr2","5582833","5582995","chr16","38955159","38955317","30","33372326"
"chr2","5586139","5586438","chr7","67653710","67654010","44","62067571"
"chr2","5592477","5592771","chr15","18380996","18381285","75","12788519"
"chr2","5599668","5599832","chr8","56795337","56795503","37","51195669"
"chr2","5600176","5600456","chr7","67668327","67668601","40","62068151"
"chr2","5618950","5619166","chr6","140190358","140190573","51","134571408"
"chr2","5654200","5654486","chr7","67624713","67625010","43","61970513"
"chr2","5676118","5676242","chr7","67599559","67599684","14","61923441"
"chr2","5685114","5685388","chr7","67590128","67590413","32","61905014"
"chr2","5709340","5709614","chr7","67565918","67566177","46","61856578"
"chr2","5733633","5733756","chr6","138352473","138352596","24","132618840"
"chr2","5766473","5766598","chr11","66969190","66969309","30","61202717"
"chr2","5777679","5777964","chr7","67507880","67508180","49","61730201"
"chr2","5780458","5780774","chr7","67504983","67505291","41","61724525"
"chr2","5782907","5783228","chr7","67502537","67502856","53","61719630"
"chr2","5823956","5824070","chr11","10614493","10614603","21","4790537"
"chr2","5825570","5825887","chr7","67455903","67456222","42","61630333"
"chr2","5853922","5854210","chr7","67428296","67428605","51","61574374"
"chr2","5856250","5856542","chr7","67426277","67426559","42","61570027"
"chr2","5859120","5859415","chr7","67418120","67418418","37","61559000"
"chr2","5862772","5862894","chr7","67398270","67398392","13","61535498"
"chr2","5873764","5874047","chr7","67396563","67396853","57","61522799"
"chr2","5885345","5885625","chr7","67389197","67389485","51","61503852"
"chr2","5905948","5906274","chr9","34311939","34312237","86","28405991"
"chr2","5939603","5939859","chr15","57460766","57461023","61","51521163"
"chr2","5954169","5954281","chr18","44251108","44251218","23","38296939"
"chr2","6003052","6003351","chr3","144506386","144506689","58","138503334"
"chr2","6022887","6023124","chr1","18869598","18869838","50","12846711"
"chr2","6040259","6040543","chr7","67219648","67219939","48","61179389"
"chr2","6041115","6041265","chr1","138968329","138968481","37","132927214"
"chr2","6063774","6064068","chr7","67186084","67186375","40","61122310"
"chr2","6073476","6073599","chr7","67173227","67173353","18","61099751"
"chr2","6090065","6090357","chrX","9053170","9053463","55","2963105"
"chr2","6092800","6093106","chr1","197648144","197648445","69","191555344"
"chr2","6098996","6099163","chr4","90125338","90125502","49","84026342"
"chr2","6144990","6145292","chr4","120336534","120336832","59","114191544"
"chr2","6150604","6150775","chr6","5317435","5317603","38","833169"
"chr2","6154347","6154453","chr3","65778113","65778219","24","59623766"
"chr2","6154494","6154613","chr1","224475401","224475502","37","218320907"
"chr2","6162066","6162355","chr7","67091200","67091510","54","60929134"
"chr2","6171901","6172165","chr7","67077614","67077882","36","60905713"
"chr2","6177690","6177957","chr1","52173557","52173828","59","45995867"
"chr2","6188939","6189248","chr1","160332533","160332842","59","154143594"
"chr2","6191174","6191441","chr7","67062753","67063037","46","60871579"
"chr2","6206869","6206987","chr7","67041556","67041685","29","60834687"
"chr2","6225900","6226169","chr7","67006809","67007082","39","60780909"
"chr2","6227745","6228049","chr7","67008662","67008970","47","60780917"
"chr2","6237545","6237648","chr1","157737408","157737505","29","151499863"
"chr2","6254923","6255216","chr2A","20770290","20770580","68","14515367"
"chr2","6260908","6261153","chr7","82681491","82681731","44","76420583"
"chr2","6267327","6267628","chr7","62531823","62532105","58","56264496"
"chr2","6269138","6269276","chr7","62529375","62529508","14","56260237"
"chr2","6271683","6271990","chr7","66963332","66963634","51","60691649"
"chr2","6284346","6284600","chr1","227579082","227579323","63","221294736"
"chr2","6295581","6295668","chr2B","30266651","30266734","14","23971070"
"chr2","6295796","6295839","chr11","118541895","118541933","9","112246099"
"chr2","6300417","6300697","chr7","66936555","66936843","52","60636138"
"chr2","6314005","6314312","chr9","92851113","92851416","64","86537108"
"chr2","6314349","6314690","chr7","66915341","66915702","72","60600992"
"chr2","6325995","6326280","chr7","66905353","66905646","41","60579358"
"chr2","6343039","6343341","chr7","66888443","66888743","34","60545404"
"chr2","6358492","6358638","chr8","20885859","20886004","32","14527367"
"chr2","6366268","6366360","chr16","4902857","4902937","28","1463411"
"chr2","6390145","6390444","chr6","10596717","10597014","61","4206572"
"chr2","6396656","6396922","chr14","89454618","89454881","66","83057962"
"chr2","6416181","6416500","chr7","66774175","66774478","41","60357994"
"chr2","6430710","6431010","chr7","5329845","5330131","54","1100865"
"chr2","6436472","6436762","chr7","63288313","63288607","49","56851841"
"chr2","6438281","6438518","chr7","66725133","66725371","30","60286852"
"chr2","6446626","6446788","chr8","63696364","63696527","38","57249738"
"chr2","6457175","6457459","chr9","108837592","108837873","50","102380417"
"chr2","6479559","6479741","chr7","66693335","66693504","29","60213776"
"chr2","6482895","6483144","chr7","66678557","66678824","68","60195662"
"chr2","6485375","6485474","chr5","14822723","14822826","31","8337348"
"chr2","6490600","6490868","chr5","37189814","37190073","64","30699214"
"chr2","6495460","6495784","chr7","66663793","66664092","66","60168333"
"chr2","6496001","6496293","chr7","66663278","66663588","60","60167277"
"chr2","6496533","6496816","chr20","6888393","6888681","61","391860"
"chr2","6500528","6500651","chr18","20235847","20235969","17","13735319"
"chr2","6500672","6500973","chr12","111044355","111044654","64","104543683"
"chr2","6530082","6530361","chr20","36316461","36316730","65","29786379"
"chr2","6531420","6531680","chr10","29441110","29441370","61","22909690"
"chr2","6540681","6541061","chr14","75480242","75480614","120","68939561"
"chr2","6541438","6541551","chr7","66609546","66609660","19","60068108"
"chr2","6543493","6543783","chr19","5006911","5007207","52","1536582"
"chr2","6554038","6554147","chr16","1757502","1757610","22","4796536"
"chr2","6558813","6559115","chr7","66593216","66593525","62","60034403"
"chr2","6563961","6564268","chr7","66588929","66589234","32","60024968"
"chr2","6566905","6566966","chr2B","26931720","26931778","11","20364815"
"chr2","6568792","6568853","chr2B","26931720","26931778","11","20362928"
"chr2","6583541","6583844","chr7","66572305","66572604","52","59988764"
"chr2","6607653","6607948","chr7","66550320","66550600","73","59942667"
"chr2","6608006","6608113","chr7","7121117","7121223","22","513111"
"chr2","6636833","6637033","chr7","73383055","73383272","59","66746222"
"chr2","6637967","6638258","chr7","138289243","138289533","51","131651276"
"chr2","6653744","6654056","chr7","2930292","2930597","63","3723452"
"chr2","6656467","6656758","chr9","54002621","54002918","65","47346154"
"chr2","6658167","6658454","chr13","18731503","18731785","59","12073336"
"chr2","6690630","6690781","chr1","110449660","110449808","35","103759030"
"chr2","6701897","6702138","chr7","66485171","66485420","27","59783274"
"chr2","6704133","6704433","chr7","66482664","66482966","52","59778531"
"chr2","6716980","6717287","chr4","74510465","74510774","68","67793485"
"chr2","6734674","6734967","chr7","72939200","72939496","60","66204526"
"chr2","6739008","6739282","chr2B","116870882","116871140","73","110131874"
"chr2","6769889","6770090","chr12","120996947","120997138","48","114227058"
"chr2","6780699","6780793","chr10","90231830","90231924","20","83451131"
"chr2","6798157","6798465","chr7","66369456","66369758","67","59571299"
"chr2","6798972","6799264","chr18","77858974","77859266","55","71060002"
"chr2","6800480","6800782","chr7","66367825","66368135","43","59567345"
"chr2","6834669","6834965","chr7","66337407","66337705","42","59502738"
"chr2","6836133","6836413","chr5","26464690","26464978","66","19628557"
"chr2","6844399","6844652","chr7","66327306","66327535","58","59482907"
"chr2","6848321","6848446","chr1","41775122","41775245","24","34926801"
"chr2","6856212","6856541","chr7","66317936","66318245","48","59461724"
"chr2","6868877","6869180","chrX","141243829","141244130","59","134374952"
"chr2","6876143","6876409","chr7","76312181","76312445","58","69436038"
"chr2","6911305","6911598","chr7","66287090","66287384","35","59375785"
"chr2","6916626","6916932","chr7","66278883","66279203","46","59362257"
"chr2","6919166","6919280","chr8","59909119","59909239","23","52989953"
"chr2","6922642","6922966","chr7","23287279","23287598","79","16364637"
"chr2","6935906","6936191","chr7","66269197","66269487","43","59333291"
"chr2","6938243","6938548","chr7","66267480","66267781","46","59329237"
"chr2","6940082","6940332","chr1","42507228","42507472","57","35567146"
"chr2","6945964","6946123","chr3","49411661","49411824","34","42465697"
"chr2","6949854","6949921","chr9","112801477","112801541","17","105851623"
"chr2","6950638","6950833","chr6","13625719","13625924","58","6675081"
"chr2","6961147","6961426","chr7","66238183","66238486","63","59277036"
"chr2","6970386","6970647","chr9","103702283","103702536","62","96731897"
"chr2","6971083","6971192","chr3","127187671","127187781","19","120216588"
"chr2","6975322","6975620","chr1","76760615","76760914","63","69785293"
"chr2","6992090","6992357","chr12","46193453","46193708","79","39201363"
"chr2","6998168","6998485","chr5","44676145","44676455","73","37677977"
"chr2","7001256","7001537","chr19","13903269","13903547","68","6902013"
"chr2","7007636","7007940","chr1","94169124","94169424","60","87161488"
"chr2","7013343","7013485","chr20","13392558","13392708","38","6379215"
"chr2","7013971","7014263","chr18","9467619","9467909","68","2453648"
"chr2","7016021","7016321","chr7","73575900","73576213","48","66559879"
"chr2","7027915","7028147","chr19","46780007","46780236","53","39752092"
"chr2","7029203","7029483","chr11","113401179","113401455","58","106371976"
"chr2","7037448","7037741","chr7","77819595","77819879","39","70782147"
"chr2","7040085","7040355","chr19","11027025","11027300","70","3986940"
"chr2","7042675","7042971","chr11","47088821","47089121","62","40046146"
"chr2","7046612","7046890","chr7","73605371","73605659","46","66558759"
"chr2","7059139","7059434","chr2A","18986462","18986752","68","11927323"
"chr2","7059578","7059689","chr15","31886115","31886229","26","24826537"
"chr2","7062252","7062550","chr7","76523012","76523308","58","69460760"
"chr2","7063503","7063787","chr7","73621576","73621874","43","66558073"
"chr2","7092295","7092574","chr7","73655054","73655363","62","66562759"
"chr2","7100873","7101140","chr16","40943947","40944205","71","33843074"
"chr2","7105309","7105565","chr7","73667673","73667932","62","66562364"
"chr2","7106699","7107001","chr7","73669110","73669393","58","66562411"
"chr2","7113689","7113988","chr7","73676209","73676526","48","66562520"
"chr2","7138571","7138792","chr7","73456387","73456600","25","66317816"
"chr2","7139888","7140053","chr12","116378437","116378611","34","109238549"
"chr2","7142281","7142479","chr1","93483563","93483753","51","86341282"
"chr2","7151174","7151444","chr6","120575412","120575680","67","113424238"
"chr2","7158683","7158966","chr7","73734095","73734386","58","66575412"
"chr2","7165140","7165421","chr7","152720666","152720956","60","145555526"
"chr2","7228390","7228648","chr12","65692195","65692461","61","58463805"
"chr2","7250808","7251088","chr7","73313367","73313641","36","66062559"
"chr2","7279993","7280277","chr7","73278564","73278869","69","65998571"
"chr2","7296262","7296564","chr7","73261721","73262010","50","65965459"
"chr2","7297827","7297931","chr15","23730288","23730394","18","16432461"
"chr2","7311150","7311264","chr6","25416407","25416521","16","18105257"
"chr2","7312577","7312692","chr17","7683396","7683506","27","370819"
"chr2","7315481","7315771","chr7","73245292","73245578","42","65929811"
"chr2","7335277","7335521","chr7","73232545","73232820","53","65897268"
"chr2","7345613","7345847","chr10","37439324","37439560","47","30093711"
"chr2","7351266","7351544","chr7","73211317","73211601","35","65860051"
"chr2","7369362","7369414","chr16","63676489","63676541","14","56307127"
"chr2","7369415","7369503","chr17","88932292","88932378","21","81562877"
"chr2","7369786","7369966","chr19","47964993","47965173","38","40595207"
"chr2","7374048","7374341","chr7","739220","739515","61","6634828"
"chr2","7379601","7379731","chr7","73180510","73180632","20","65800909"
"chr2","7385830","7386126","chr7","73175463","73175782","65","65789633"
"chr2","7392439","7392733","chr7","65413069","65413376","43","58020630"
"chr2","7414463","7414759","chr7","74758778","74759074","32","67344315"
"chr2","7430647","7430813","chr18","14541461","14541626","30","7110814"
"chr2","7431360","7431471","chr10","12591333","12591447","23","5159973"
"chr2","7432119","7432423","chr7","73127295","73127604","30","65695176"
"chr2","7433764","7433894","chr2A","20545290","20545415","29","13111526"
"chr2","7435227","7435535","chr7","73124423","73124727","44","65689196"
"chr2","7458428","7458571","chr14","35145745","35145882","32","27687317"
"chr2","7459219","7459361","chr7","73098497","73098636","18","65639278"
"chr2","7464251","7464592","chr7","73094022","73094326","81","65629771"
"chr2","7464759","7465035","chr7","73093548","73093839","56","65628789"
"chr2","7473683","7473977","chr7","73086673","73086966","27","65612990"
"chr2","7478728","7479027","chr7","73079574","73079879","40","65600846"
"chr2","7482617","7482886","chr7","73075855","73076127","31","65593238"
"chr2","7509599","7509887","chr7","134895914","134896196","71","127386315"
"chr2","7510413","7510530","chr2B","1264581","1264698","18","6245832"
"chr2","7513469","7513809","chr7","73047533","73047848","58","65534064"
"chr2","7515405","7515584","chr8","129201910","129202089","41","121686505"
"chr2","7515844","7515935","chr1","23037520","23037611","20","15521676"
"chr2","7524879","7525157","chr17","41528187","41528463","65","34003308"
"chr2","7526727","7527019","chr1","91059171","91059456","56","83532444"
"chr2","7529071","7529343","chr3","67605870","67606144","70","60076799"
"chr2","7538321","7538480","chr5","51144248","51144411","33","43605927"
"chr2","7548652","7548925","chr7","73004464","73004743","35","65455812"
"chr2","7551948","7552065","chr1","205296362","205296479","15","197744414"
"chr2","7557688","7557815","chr13","10278120","10278248","22","2720432"
"chr2","7565395","7565687","chr7","72984915","72985212","57","65419520"
"chr2","7583892","7584091","chrX","2663878","2664074","42","4920014"
"chr2","7584223","7584294","chr22","26052406","26052470","19","18468183"
"chr2","7587078","7587382","chr7","72961267","72961564","48","65374189"
"chr2","7589526","7589834","chr7","72958765","72959073","43","65369239"
"chr2","7596573","7596813","chr15","69097106","69097359","52","61500533"
"chr2","7616304","7616597","chr7","72925232","72925535","43","65308928"
"chr2","7625127","7625431","chr1","227415933","227416230","60","219790806"
"chr2","7631131","7631395","chr7","72910309","72910591","52","65279178"
"chr2","7637226","7637428","chr7","101408227","101408429","44","93771001"
"chr2","7646671","7646941","chr5","8734711","8734988","56","1088040"
"chr2","7648303","7648582","chr7","72893344","72893633","43","65245041"
"chr2","7650222","7650358","chr15","28256836","28256968","25","20606614"
"chr2","7659532","7659784","chr3","51831969","51832230","64","44172437"
"chr2","7660938","7661230","chr19","49470801","49471093","57","41809863"
"chr2","7670064","7670332","chr16","14907479","14907738","74","7237415"
"chr2","7683738","7684011","chr19","19434477","19434752","46","11750739"
"chr2","7691698","7691971","chr19","19434477","19434752","46","11742779"
"chr2","7699276","7699589","chr7","72854948","72855284","64","65155672"
"chr2","7700555","7700857","chr7","72853668","72853967","50","65153113"
"chr2","7732632","7732904","chr7","72829692","72829971","62","65097060"
"chr2","7765210","7765339","chr11","69147152","69147272","38","61381942"
"chr2","7765743","7765840","chr10","120796978","120797068","22","113031235"
"chr2","7797024","7797306","chr7","72610900","72611198","52","64813876"
"chr2","7805982","7806180","chr17","1116972","1117163","41","6689010"
"chr2","7812242","7812565","chr1","209135328","209135633","79","201323086"
"chr2","7822905","7823194","chr7","72583717","72583985","55","64760812"
"chr2","7824980","7825274","chr7","65567837","65568132","50","57742857"
"chr2","7850796","7851055","chr7","65620807","65621103","58","57770011"
"chr2","7866714","7867017","chr7","72542086","72542388","40","64675372"
"chr2","7875480","7875586","chr19","7469095","7469199","22","406385"
"chr2","7881264","7881418","chr10","49585047","49585201","34","41703783"
"chr2","7882561","7882860","chr7","72517683","72517987","39","64635122"
"chr2","7908532","7908597","chr7","72484245","72484312","7","64575713"
"chr2","7913878","7914166","chr7","72477384","72477690","42","64563506"
"chr2","7922971","7923266","chr7","72467474","72467775","44","64544503"
"chr2","7938336","7938617","chr7","72455520","72455820","52","64517184"
"chr2","7939436","7939732","chr7","72454724","72455008","48","64515288"
"chr2","7955852","7956133","chr7","72434471","72434740","46","64478619"
"chr2","7963565","7963856","chr7","72429048","72429345","39","64465483"
"chr2","7971496","7971789","chr7","72420666","72420967","58","64449170"
"chr2","7972638","7972923","chr5","38104922","38105205","60","30132284"
"chr2","7982853","7983163","chr7","72410809","72411117","43","64427956"
"chr2","7984432","7984730","chr7","72408929","72409224","39","64424497"
"chr2","7984747","7985024","chr7","72408621","72408912","57","64423874"
"chr2","7989020","7989126","chr1","39325820","39325928","17","31336800"
"chr2","8004812","8004935","chr2B","63048762","63048885","16","55043950"
"chr2","8015277","8015505","chr1","223440729","223440957","51","215425452"
"chr2","8017259","8017560","chr7","72368729","72369029","52","64351470"
"chr2","8019839","8020132","chr7","72366431","72366728","45","64346592"
"chr2","8027484","8027641","chr11","129038829","129038978","46","121011345"
"chr2","8034404","8034707","chr7","72355239","72355549","68","64320835"
"chr2","8063754","8063989","chr7","72326671","72326929","46","64262917"
"chr2","8071127","8071420","chr7","72317121","72317422","34","64245994"
"chr2","8075062","8075348","chr16","4899207","4899497","55","3175855"
"chr2","8087850","8087992","chr7","72303000","72303129","22","64215150"
"chr2","8088194","8088336","chr10","92108530","92108678","31","84020336"
"chr2","8101108","8101411","chr7","72288083","72288357","60","64186975"
"chr2","8104780","8105097","chr7","72284701","72285005","47","64179921"
"chr2","8105933","8106045","chr7","72283764","72283879","16","64177831"
"chr2","8136394","8136675","chr12","1651377","1651661","64","6485017"
"chr2","8167339","8167478","chr6","77626450","77626592","30","69459111"
"chr2","8169692","8169976","chr7","42837499","42837786","64","34667807"
"chr2","8171096","8171225","chr18","59279952","59280077","27","51108856"
"chr2","8176656","8176814","chr7","72212072","72212237","24","64035416"
"chr2","8178759","8179061","chr21","30780520","30780822","51","22601761"
"chr2","8187103","8187376","chr7","72201337","72201626","40","64014234"
"chr2","8193083","8193399","chrX","108444073","108444399","66","100250990"
"chr2","8204320","8204472","chr15","69740012","69740164","25","61535692"
"chr2","8205906","8206038","chr7","72185771","72185904","10","63979865"
"chr2","8208278","8208538","chr7","72183402","72183682","49","63975124"
"chr2","8209130","8209443","chr7","72182017","72182333","59","63972887"
"chr2","8212310","8212508","chr19","42939421","42939618","50","34727111"
"chr2","8212990","8213086","chr10","117001518","117001614","10","108788528"
"chr2","8213749","8214046","chr20","15940176","15940482","52","7726427"
"chr2","8221612","8221914","chrX","70068494","70068793","56","61846882"
"chr2","8225089","8225290","chr6","91035512","91035718","40","82810423"
"chr2","8229690","8229818","chr7","85668796","85668925","32","77439106"
"chr2","8231554","8231826","chr7","72161714","72161993","49","63930160"
"chr2","8234211","8234461","chr7","72159249","72159523","65","63925038"
"chr2","8238382","8238491","chr3","73771204","73771315","25","65532822"
"chr2","8241549","8241659","chr2A","17078641","17078752","20","8837092"
"chr2","8245876","8246000","chr16","63831786","63831911","17","55585910"
"chr2","8257804","8257917","chr7","72138280","72138402","20","63880476"
"chr2","8263310","8263413","chr19","4106799","4106900","17","4156511"
"chr2","8277303","8277602","chr7","72121055","72121346","57","63843752"
"chr2","8280203","8280321","chr16","68913600","68913726","21","60633397"
"chr2","8286341","8286625","chr7","72112239","72112549","57","63825898"
"chr2","8301535","8301686","chr7","74116130","74116280","43","65814595"
"chr2","8322522","8322644","chr17","40401343","40401464","25","32078821"
"chr2","8323067","8323377","chr7","72078083","72078388","52","63755016"
"chr2","8339512","8339632","chr12","10007664","10007786","21","1668152"
"chr2","8345303","8345610","chr7","72056888","72057204","39","63711585"
"chr2","8346560","8346726","chr3","10866047","10866211","35","2519487"
"chr2","8346887","8347009","chr11","116928328","116928450","22","108581441"
"chr2","8347739","8347968","chr7","72054128","72054373","36","63706389"
"chr2","8351963","8352268","chr7","72049152","72049458","41","63697189"
"chr2","8353738","8354035","chr1","114123479","114123769","60","105769741"
"chr2","8380271","8380400","chr15","18620321","18620458","48","10240050"
"chr2","8386933","8387220","chr7","72019136","72019439","50","63632203"
"chr2","8395176","8395405","chr5","62627109","62627333","61","54231933"
"chr2","8403187","8403486","chr2B","26908318","26908614","51","18505131"
"chr2","8406934","8407240","chr7","71991706","71992012","34","63584772"
"chr2","8424295","8424558","chr7","74029574","74029854","48","65605279"
"chr2","8443165","8443342","chr14","57274880","57275056","45","48831715"
"chr2","8453931","8454201","chr7","71946178","71946467","49","63492247"
"chr2","8472025","8472149","chr7","72008463","72008589","14","63536438"
"chr2","8477157","8477457","chr7","71921364","71921648","52","63444207"
"chr2","8478819","8479100","chr19","10147775","10148050","69","1668956"
"chr2","8480107","8480378","chr7","71918458","71918744","49","63438351"
"chr2","8483193","8483416","chr10","12495988","12496203","47","4012795"
"chr2","8485649","8485765","chr18","18587481","18587600","18","10101832"
"chr2","8490079","8490154","chr12","130224589","130224659","14","121734510"
"chr2","8495538","8495853","chr7","71908093","71908398","42","63412555"
"chr2","8500846","8501118","chr7","74047821","74048110","44","65546975"
"chr2","8541642","8541792","chr10","92108530","92108678","31","83566888"
"chr2","8560428","8560580","chr12","118592097","118592252","27","110031669"
"chr2","8561170","8561429","chr12","109681397","109681665","64","101120227"
"chr2","8566111","8566385","chr5","20142932","20143200","58","11576821"
"chr2","8567476","8567760","chr7","71850034","71850309","60","63282558"
"chr2","8567761","8567909","chr7","71849853","71850013","35","63282092"
"chr2","8569984","8570268","chr16","79765355","79765643","56","71195371"
"chr2","8580214","8580336","chr6","10812725","10812842","18","2232511"
"chr2","8586967","8587089","chr1","133332217","133332341","17","124745250"
"chr2","8590412","8590704","chr15","55372921","55373213","62","46782509"
"chr2","8591525","8591820","chr5","19031856","19032155","64","10440331"
"chr2","8592003","8592291","chr7","74202807","74203094","35","65610804"
"chr2","8600881","8601043","chr19","18112321","18112488","41","9511440"
"chr2","8601048","8601322","chr4","25527811","25528088","71","16926763"
"chr2","8603760","8603978","chr12","107513589","107513806","44","98909829"
"chr2","8605917","8606208","chr7","72709911","72710193","42","64103994"
"chr2","8606592","8606883","chr7","74212070","74212383","51","65605478"
"chr2","8607968","8608180","chr16","58051831","58052042","63","49443863"
"chr2","8609285","8609518","chr9","114615846","114616073","52","106006561"
"chr2","8609601","8609750","chr1","68709407","68709549","33","60099806"
"chr2","8612258","8612556","chr7","74218247","74218545","40","65605989"
"chr2","8614559","8614870","chr7","74219754","74220065","39","65605195"
"chr2","8624555","8624804","chr7","74230981","74231255","56","65606426"
"chr2","8626747","8626900","chr16","21019777","21019933","36","12393030"
"chr2","8627867","8627984","chrX","47876058","47876170","20","39248191"
"chr2","8628829","8629138","chr7","74234107","74234420","56","65605278"
"chr2","8644341","8644624","chr19","2295672","2295968","70","6348669"
"chr2","8648807","8649004","chr10","42667519","42667723","38","34018712"
"chr2","8660228","8660525","chr7","74264727","74265006","50","65604499"
"chr2","8662238","8662494","chr7","74266061","74266339","45","65603823"
"chr2","8669168","8669457","chr7","74271733","74271999","48","65602565"
"chr2","8672626","8672891","chr20","6257705","6257990","67","2414921"
"chr2","8679163","8679410","chr7","74280690","74280953","38","65601527"
"chr2","8684956","8685271","chr7","74285430","74285749","42","65600474"
"chr2","8698748","8698833","chr7","74299604","74299688","12","65600856"
"chr2","8703738","8703962","chr7","74304306","74304526","32","65600568"
"chr2","8711277","8711578","chr7","74313125","74313424","47","65601848"
"chr2","8713196","8713441","chr9","113131256","113131504","57","104418060"
"chr2","8719239","8719502","chr16","49181420","49181682","49","40462181"
"chr2","8721722","8721994","chr7","74321412","74321710","68","65599690"
"chr2","8727934","8728125","chr2B","111370102","111370287","52","102642168"
"chr2","8733574","8733807","chr17","90028014","90028251","52","81294440"
"chr2","8734277","8734570","chr3","131369946","131370239","61","122635669"
"chr2","8747037","8747118","chr1","9729337","9729420","15","982300"
"chr2","8752779","8753084","chr19","31483985","31484243","84","22731206"
"chr2","8764223","8764582","chr19","7121510","7121860","92","1642713"
"chr2","8766097","8766461","chr5","57828804","57829160","101","49062707"
"chr2","8769601","8769894","chr5","142005741","142006029","49","133236140"
"chr2","8771704","8771778","chr4","17253747","17253818","21","8482043"
"chr2","8773317","8773616","chr1","139924460","139924755","64","131151143"
"chr2","8780264","8780561","chr7","76966352","76966647","59","68186088"
"chr2","8786826","8787047","chr7","49020001","49020225","48","40233175"
"chr2","8787864","8787996","chr7","44519677","44519808","25","35731813"
"chr2","8792216","8792501","chr12","123395674","123395957","70","114603458"
"chr2","8798814","8798971","chr1","226479927","226480090","38","217681113"
"chr2","8799027","8799312","chr12","116476550","116476841","56","107677523"
"chr2","8806279","8806608","chr17","771187","771496","65","8035092"
"chr2","8807696","8807848","chr10","49585047","49585201","30","40777351"
"chr2","8811391","8811602","chr1","44706672","44706875","51","35895281"
"chr2","8812617","8812724","chr5","79630137","79630243","18","70817520"
"chr2","8830577","8830830","chr19","15993949","15994198","58","7163372"
"chr2","8837534","8837663","chr7","76360858","76360988","19","67523324"
"chr2","8866955","8867057","chr2B","111810110","111810218","21","102943155"
"chr2","8868640","8868924","chr7","71210042","71210328","57","62341402"
"chr2","8871714","8871864","chr2B","27751482","27751639","25","18879768"
"chr2","8873981","8874259","chr7","74371577","74371880","54","65497596"
"chr2","8875959","8876246","chr19","1462647","1462943","58","7413312"
"chr2","8888287","8888487","chr6","160275074","160275273","39","151386787"
"chr2","8893837","8894120","chr7","74403252","74403551","48","65509415"
"chr2","8915404","8915528","chr20","30238448","30238572","14","21323044"
"chr2","8919470","8919760","chr7","74446160","74446465","62","65526690"
"chr2","8935038","8935174","chr14","52842638","52842775","31","43907600"
"chr2","8940858","8941086","chr7","44555416","44555635","44","35614558"
"chr2","8945737","8946044","chr7","74471264","74471579","47","65525527"
"chr2","8947150","8947253","chr11","129606474","129606576","19","120659324"
"chr2","8962861","8963158","chr7","74492267","74492562","57","65529406"
"chr2","8977793","8978036","chr1","206480269","206480516","60","197502476"
"chr2","8982602","8982767","chr1","157455741","157455909","37","148473139"
"chr2","8995095","8995381","chr20","45612195","45612482","81","36617100"
"chr2","9003837","9004127","chr7","74539965","74540263","45","65536128"
"chr2","9007459","9007765","chr7","74542962","74543282","53","65535503"
"chr2","9013067","9013282","chr7","74548643","74548888","67","65535576"
"chr2","9039692","9039959","chr21","34315420","34315703","65","25275728"
"chr2","9040380","9040553","chrX","19843652","19843828","27","10803272"
"chr2","9045883","9046181","chr7","74584862","74585169","45","65538979"
"chr2","9048734","9049010","chr3","192630736","192631006","69","183582002"
"chr2","9063093","9063408","chr7","74599744","74600057","40","65536651"
"chr2","9064319","9064469","chr16","29999340","29999496","26","20935021"
"chr2","9065008","9065120","chr19","4399344","4399454","21","4665664"
"chr2","9068402","9068632","chr7","74604786","74604968","72","65536384"
"chr2","9084722","9085007","chr1","15580747","15581032","70","6496025"
"chr2","9092747","9092894","chr21","27354717","27354867","35","18261970"
"chr2","9108166","9108459","chrX","19199530","19199816","65","10091364"
"chr2","9112349","9112505","chr15","30625249","30625411","33","21512900"
"chr2","9129509","9129595","chr1","35497701","35497787","14","26368192"
"chr2","9132797","9132921","chr20","30238448","30238572","16","21105651"
"chr2","9136613","9136899","chr7","74795524","74795834","55","65658911"
"chr2","9148838","9149091","chr14","22119343","22119588","62","12970505"
"chr2","9151575","9151689","chr18","22807872","22807981","20","13656297"
"chr2","9159128","9159437","chr7","74818855","74819163","43","65659727"
"chr2","9166027","9166296","chr16","58758445","58758698","71","49592418"
"chr2","9178855","9179157","chr7","74841302","74841599","36","65662447"
"chr2","9182459","9182726","chr7","74845123","74845412","65","65662664"
"chr2","9190378","9190487","chr12","1702","1809","15","9188676"
"chr2","9200459","9200775","chr7","74861437","74861734","59","65660978"
"chr2","9222698","9223013","chr7","74881534","74881834","47","65658836"
"chr2","9228988","9229288","chr7","74884092","74884395","54","65655104"
"chr2","9235198","9235438","chr17","7888015","7888253","54","1347183"
"chr2","9235800","9235926","chr3","59535512","59535636","20","50299712"
"chr2","9237042","9237138","chr10","35698053","35698152","30","26461011"
"chr2","9243240","9243533","chr3","130817601","130817900","84","121574361"
"chr2","9244409","9244531","chr8","45313442","45313566","18","36069033"
"chr2","9245730","9245874","chr6","31539130","31539272","41","22293400"
"chr2","9249588","9249875","chr7","74901795","74902097","59","65652207"
"chr2","9250112","9250216","chr19","32091896","32092001","30","22841784"
"chr2","9257626","9257932","chr7","74907674","74907978","52","65650048"
"chr2","9266271","9266373","chr9","112252272","112252374","18","102986001"
"chr2","9267482","9267787","chr8","78021588","78021898","68","68754106"
"chr2","9275141","9275382","chr8","26786171","26786388","73","17511030"
"chr2","9300816","9301092","chr7","74949274","74949556","47","65648458"
"chr2","9305903","9306009","chr6","13090658","13090763","28","3784755"
"chr2","9307671","9307943","chr7","74955611","74955904","48","65647940"
"chr2","9307949","9308075","chr5","22134012","22134133","22","12826063"
"chr2","9308504","9308615","chr19","4399344","4399454","16","4909160"
"chr2","9318288","9318492","chr7","74966275","74966478","25","65647987"
"chr2","9324812","9325119","chr5","18526854","18527152","71","9202042"
"chr2","9325130","9325432","chr7","74973664","74973967","63","65648534"
"chr2","9330361","9330593","chr20","3929006","3929254","58","5401355"
"chr2","9332023","9332164","chr3","155574758","155574899","34","146242735"
"chr2","9332624","9332729","chr7","74980288","74980400","20","65647664"
"chr2","9354088","9354205","chr8","145313247","145313365","16","135959159"
"chr2","9357787","9357903","chr7","75017050","75017167","10","65659263"
"chr2","9362111","9362389","chr5","38104922","38105205","56","28742811"
"chr2","9365947","9366229","chr19","42330161","42330445","67","32964214"
"chr2","9386257","9386454","chr7","75473100","75473300","26","66086843"
"chr2","9399852","9399991","chr1","1440193","1440328","31","7959659"
"chr2","9403039","9403304","chr7","75052392","75052656","67","65649353"
"chr2","9420338","9420612","chr7","75068427","75068724","57","65648089"
"chr2","9427369","9427672","chr7","75505238","75505547","54","66077869"
"chr2","9431468","9431761","chr1","145899390","145899681","52","136467922"
"chr2","9432247","9432519","chr19","40031378","40031647","78","30599131"
"chr2","9434388","9434670","chr2A","97057312","97057598","57","87622924"
"chr2","9457548","9457789","chr22","20364309","20364570","56","10906761"
"chr2","9470861","9471048","chr20","48649327","48649514","40","39178466"
"chr2","9495987","9496108","chr1","46429301","46429422","20","36933314"
"chr2","9498252","9498565","chr7","44573926","44574231","35","35075674"
"chr2","9501603","9501821","chr16","27636156","27636376","41","18134553"
"chr2","9507190","9507316","chr3","115387942","115388069","21","105880752"
"chr2","9511853","9512138","chr5","55611132","55611425","76","46099279"
"chr2","9512735","9512838","chr1","46605351","46605452","25","37092616"
"chr2","9512940","9513101","chr9","20714539","20714685","43","11201599"
"chr2","9519884","9520102","chr7","101427651","101427866","25","91907767"
"chr2","9520898","9521093","chr12","109090099","109090301","47","99569201"
"chr2","9541939","9542235","chr18","44352958","44353255","46","34811019"
"chr2","9546644","9546950","chr20","42536113","42536422","60","32989469"
"chr2","9550820","9550914","chr7","101404390","101404484","6","91853570"
"chr2","9554907","9555157","chr7","44649384","44649655","42","35094477"
"chr2","9557513","9557814","chr12","113089057","113089352","69","103531544"
"chr2","9560211","9560511","chr14","89141565","89141868","75","79581354"
"chr2","9560781","9561059","chr7","44626147","44626456","53","35065366"
"chr2","9571818","9572131","chr2A","74967956","74968209","99","65396138"
"chr2","9572525","9572812","chr6","43892414","43892691","71","34319889"
"chr2","9588591","9588743","chr12","38993633","38993795","35","29405042"
"chr2","9596378","9596527","chr8","8495688","8495834","31","1100690"
"chr2","9611112","9611375","chr9","75566020","75566287","60","65954908"
"chr2","9627103","9627383","chr7","75613330","75613622","64","65986227"
"chr2","9634380","9634493","chr18","22807872","22807981","15","13173492"
"chr2","9643762","9644028","chr7","75624900","75625191","63","65981138"
"chr2","9653989","9654122","chr1","1546294","1546427","22","8107695"
"chr2","9659441","9659571","chr7","74790659","74790791","18","65131218"
"chr2","9665361","9665659","chr7","75648379","75648670","32","65983018"
"chr2","9673773","9674057","chr7","75654997","75655288","36","65981224"
"chr2","9687635","9687869","chr17","21279650","21279885","49","11592015"
"chr2","9696590","9696852","chr7","72693029","72693296","65","62996439"
"chr2","9698612","9698743","chr12","29897183","29897312","17","20198571"
"chr2","9704532","9704806","chr12","123570594","123570856","63","113866062"
"chr2","9704968","9705274","chrX","48161010","48161318","50","38456042"
"chr2","9710428","9710556","chr7","75726104","75726232","20","66015676"
"chr2","9711296","9711494","chrX","48129374","48129565","57","38418078"
"chr2","9729205","9729511","chr1","2285941","2286239","56","7443264"
"chr2","9774332","9774615","chr1","19603881","19604162","61","9829549"
"chr2","9790013","9790287","chr7","75816208","75816491","45","66026195"
"chr2","9793524","9793654","chr7","78772323","78772456","22","68978799"
"chr2","9797267","9797548","chr16","1554262","1554542","57","8243005"
"chr2","9800494","9800715","chr15","51004153","51004375","45","41203659"
"chr2","9809965","9810171","chr6","142055496","142055712","61","132245531"
"chr2","9811924","9812092","chr9","94824992","94825159","34","85013068"
"chr2","9812699","9812917","chr19","3699724","3699924","49","6112975"
"chr2","9821941","9822247","chr2B","53629601","53629902","53","43807660"
"chr2","9823817","9824028","chr7","75849254","75849465","26","66025437"
"chr2","9839124","9839411","chr19","38441498","38441794","58","28602374"
"chr2","9845520","9845800","chr7","1708256","1708538","62","8137264"
"chr2","9854978","9855275","chr7","76523012","76523308","58","66668034"
"chr2","9869218","9869352","chr8","35001751","35001882","29","25132533"
"chr2","9879665","9879867","chr14","80660819","80661014","53","70781154"
"chr2","9881608","9881877","chr14","75167404","75167682","59","65285796"
"chr2","9892098","9892226","chr7","75912897","75913032","19","66020799"
"chr2","9902967","9903122","chr6","89356333","89356484","33","79453366"
"chr2","9906999","9907278","chr7","75925509","75925814","56","66018510"
"chr2","9916500","9916603","chr5","38734073","38734175","18","28817573"
"chr2","9929366","9929490","chr10","86956281","86956404","18","77026915"
"chr2","9933386","9933666","chr7","75949476","75949789","60","66016090"
"chr2","9955414","9955629","chrX","1292864","1293059","58","8662550"
"chr2","9957899","9958208","chr7","75972746","75973062","53","66014847"
"chr2","9968830","9969126","chr1","25934923","25935212","66","15966093"
"chr2","9969667","9969781","chr6","14397538","14397657","19","4427871"
"chr2","9982339","9982615","chr3","159696352","159696632","62","149714013"
"chr2","9987127","9987214","chr14","54873414","54873500","18","44886287"
"chr2","9997349","9997483","chr7","76013572","76013714","33","66016223"
"chr2","10001304","10001610","chr7","76017546","76017847","50","66016242"
"chr2","10013538","10013643","chr3","65778113","65778219","21","55764575"
"chr2","10041157","10041257","chr7","76063703","76063805","22","66022546"
"chr2","10066386","10066675","chr7","76087521","76087827","57","66021135"
"chr2","10072970","10073237","chr7","76092450","76092732","55","66019480"
"chr2","10085992","10086278","chr7","76104030","76104316","34","66018038"
"chr2","10091398","10091682","chr3","58326549","58326835","71","48235151"
"chr2","10096420","10096716","chrX","118332011","118332303","60","108235591"
"chr2","10130587","10130869","chr7","76146308","76146602","52","66015721"
"chr2","10132139","10132264","chr5","47354990","47355113","24","37222851"
"chr2","10132278","10132561","chr1","163867986","163868280","57","153735708"
"chr2","10134348","10134475","chr19","14140998","14141130","19","4006650"
"chr2","10143552","10143593","chr7","76159190","76159232","7","66015638"
"chr2","10143603","10143645","chr7","76159190","76159232","6","66015587"
"chr2","10143654","10143696","chr7","76159190","76159232","3","66015536"
"chr2","10143807","10143848","chr7","76159190","76159232","7","66015383"
"chr2","10143858","10143900","chr7","76159190","76159232","3","66015332"
"chr2","10143909","10143968","chr7","76159291","76159348","9","66015382"
"chr2","10158252","10158537","chr9","52411699","52411997","68","42253447"
"chr2","10166807","10167102","chr7","76179300","76179596","36","66012493"
"chr2","10168393","10168711","chr7","76180972","76181276","48","66012579"
"chr2","10171769","10172019","chr21","30248071","30248324","57","20076302"
"chr2","10185114","10185369","chr19","1508954","1509216","69","8676160"
"chr2","10194821","10194909","chr8","48887049","48887138","20","38692228"
"chr2","10197971","10198257","chr7","76207555","76207836","45","66009584"
"chr2","10210465","10210564","chr7","76220793","76220893","14","66010328"
"chr2","10210976","10211284","chr7","76221341","76221652","53","66010365"
"chr2","10212062","10212367","chr7","76221877","76222179","61","66009815"
"chr2","10226304","10226564","chr2A","104135534","104135782","58","93909230"
"chr2","10231447","10231748","chr7","76241977","76242289","45","66010530"
"chr2","10249472","10249730","chr7","76262092","76262361","37","66012620"
"chr2","10258042","10258319","chr11","113401179","113401455","64","103143137"
"chr2","10261954","10262257","chr1","45145246","45145545","59","34883292"
"chr2","10264216","10264526","chr7","76274476","76274779","32","66010260"
"chr2","10271299","10271575","chr7","76284855","76285130","42","66013556"
"chr2","10274834","10275127","chr7","76288158","76288449","47","66013324"
"chr2","10277081","10277204","chr7","76291861","76291982","25","66014780"
"chr2","10282293","10282423","chr7","46394335","46394459","42","36112042"
"chr2","10284473","10284636","chr7","74190896","74191062","29","63906423"
"chr2","10288127","10288249","chr2A","56811303","56811424","15","46523176"
"chr2","10288683","10288861","chr5","32602465","32602640","39","22313782"
"chr2","10293841","10294069","chr7","76313833","76314064","38","66019992"
"chr2","10297091","10297374","chr7","76316716","76317005","41","66019625"
"chr2","10298943","10299230","chr7","76318037","76318343","54","66019094"
"chr2","10306138","10306434","chr5","55653971","55654269","54","45347833"
"chr2","10310491","10310763","chr7","76329426","76329705","39","66018935"
"chr2","10320394","10320686","chr2A","79717022","79717315","57","69396628"
"chr2","10322146","10322263","chr1","40324226","40324341","35","30002080"
"chr2","10322724","10322851","chr9","47369076","47369207","23","37046352"
"chr2","10322960","10323274","chr7","76336588","76336893","50","66013628"
"chr2","10327282","10327591","chr7","76339369","76339676","44","66012087"
"chr2","10330359","10330508","chr9","108232885","108233040","34","97902526"
"chr2","10331405","10331711","chr15","41361915","41362221","75","31030510"
"chr2","10334064","10334340","chrX","16516361","16516636","58","6182297"
"chr2","10338906","10339115","chr17","16313244","16313455","65","5974338"
"chr2","10372119","10372415","chr7","76379278","76379584","51","66007159"
"chr2","10374435","10374719","chr7","76381638","76381937","55","66007203"
"chr2","10385784","10385953","chr3","159263100","159263275","39","148877316"
"chr2","10394595","10394877","chr12","8890987","8891276","60","1503608"
"chr2","10397013","10397309","chr9","96048991","96049275","56","85651978"
"chr2","10400318","10400609","chr12","117948200","117948484","66","107547882"
"chr2","10402620","10402900","chr4","202747043","202747319","73","192344423"
"chr2","10404981","10405143","chr12","19312537","19312701","30","8907556"
"chr2","10405792","10405908","chr20","24295182","24295298","22","13889390"
"chr2","10413948","10414238","chr7","76427604","76427889","46","66013656"
"chr2","10419497","10419789","chr4","105640836","105641122","56","95221339"
"chr2","10429840","10429996","chr15","69740012","69740164","34","59310172"
"chr2","10431083","10431109","chr4","61947297","61947320","10","51516214"
"chr2","10431119","10431243","chr3","65193379","65193500","18","54762260"
"chr2","10431782","10432080","chr7","76444148","76444448","52","66012366"
"chr2","10436931","10437236","chr7","76448973","76449269","48","66012042"
"chr2","10448136","10448444","chr7","76460127","76460416","57","66011991"
"chr2","10454256","10454520","chr7","76467472","76467760","51","66013216"
"chr2","10459287","10459436","chr5","55206517","55206666","40","44747230"
"chr2","10462182","10462498","chr7","76475375","76475688","37","66013193"
"chr2","10479540","10479669","chr6","6554953","6555078","30","3924587"
"chr2","10479993","10480177","chr2B","23300019","23300214","55","12820026"
"chr2","10481089","10481345","chr7","76494964","76495235","59","66013875"
"chr2","10484886","10485168","chr7","76499691","76499996","55","66014805"
"chr2","10500849","10501133","chr19","11027025","11027300","64","526176"
"chr2","10510581","10510862","chr7","73083255","73083530","50","62572674"
"chr2","10517788","10518070","chr18","19949790","19950070","54","9432002"
"chr2","10535231","10535427","chr7","76552980","76553176","29","66017749"
"chr2","10538065","10538362","chr7","76555466","76555759","45","66017401"
"chr2","10539974","10540280","chr19","2376897","2377192","59","8163077"
"chr2","10545274","10545408","chr9","89173618","89173747","21","78628344"
"chr2","10549753","10550002","chr7","76569889","76570155","43","66020136"
"chr2","10568513","10568695","chr14","50979257","50979448","35","40410744"
"chr2","10586185","10586472","chr16","5063959","5064250","77","5522226"
"chr2","10608053","10608364","chr7","76633772","76634087","35","66025719"
"chr2","10624812","10624990","chr7","79675726","79675893","39","69050914"
"chr2","10627679","10627802","chr7","140174758","140174882","20","129547079"
"chr2","10631283","10631582","chr7","79293631","79293923","71","68662348"
"chr2","10632299","10632582","chr2A","97057312","97057598","67","86425013"
"chr2","10633256","10633555","chr7","76655249","76655549","37","66021993"
"chr2","10644802","10644917","chr7","76940267","76940373","30","66295465"
"chr2","10652671","10652792","chr7","76674829","76674951","15","66022158"
"chr2","10662548","10662669","chr14","41702979","41703101","17","31040431"
"chr2","10663244","10663403","chr7","79271528","79271684","31","68608284"
"chr2","10664847","10664966","chr13","30018936","30019060","19","19354089"
"chr2","10666167","10666451","chr7","76687550","76687842","44","66021383"
"chr2","10670139","10670416","chr7","151367295","151367567","71","140697156"
"chr2","10676063","10676355","chr18","1313785","1314066","61","9362278"
"chr2","10685690","10685821","chr9","112841011","112841143","20","102155321"
"chr2","10687860","10688078","chr8","142073255","142073460","53","131385395"
"chr2","10689114","10689385","chr7","76706766","76707033","39","66017652"
"chr2","10693630","10693756","chr17","1096341","1096466","30","9597289"
"chr2","10693822","10694105","chr10","95338417","95338705","54","84644595"
"chr2","10703532","10703755","chr1","217294594","217294821","51","206591062"
"chr2","10707815","10708054","chr7","76736031","76736260","41","66028216"
"chr2","10708057","10708361","chr7","76735720","76736015","47","66027663"
"chr2","10714299","10714408","chr6","7105611","7105725","23","3608688"
"chr2","10723927","10724092","chr7","76752983","76753142","24","66029056"
"chr2","10726479","10726779","chr16","60238828","60239122","46","49512349"
"chr2","10730005","10730136","chr16","59134844","59134968","26","48404839"
"chr2","10743937","10744195","chr1","1901464","1901742","81","8842473"
"chr2","10752490","10752661","chr16","11732349","11732525","44","979859"
"chr2","10757207","10757350","chr7","46511554","46511696","16","35754347"
"chr2","10782065","10782228","chr10","116742672","116742834","36","105960607"
"chr2","10782757","10782849","chr4","121963017","121963106","16","111180260"
"chr2","10785088","10785402","chr5","115727508","115727811","64","104942420"
"chr2","10795071","10795175","chr2A","69417701","69417807","17","58622630"
"chr2","10795889","10796052","chr4","190209315","190209476","41","179413426"
"chr2","10814882","10815188","chr7","76851595","76851902","51","66036713"
"chr2","10818688","10818973","chr1","125278211","125278509","70","114459523"
"chr2","10825432","10825727","chr7","76861627","76861925","40","66036195"
"chr2","10829696","10829843","chr1","68709407","68709549","39","57879711"
"chr2","10833064","10833192","chr7","72008463","72008589","20","61175399"
"chr2","10835813","10835979","chr19","16683811","16683973","36","5847998"
"chr2","10843545","10843836","chr7","76879463","76879749","41","66035918"
"chr2","10873334","10873599","chr22","20364309","20364570","54","9490975"
"chr2","10889490","10889808","chr7","76918426","76918742","25","66028936"
"chr2","10894423","10894705","chr14","41627283","41627568","58","30732860"
"chr2","10908941","10909229","chr7","76936791","76937082","38","66027850"
"chr2","10912208","10912326","chr6","154239364","154239482","30","143327156"
"chr2","10912625","10912681","chr5","143902810","143902872","18","132990185"
"chr2","10912813","10912934","chr1","21719374","21719497","20","10806561"
"chr2","10914858","10915172","chr7","76942649","76942948","46","66027791"
"chr2","10929219","10929515","chr7","76958317","76958623","51","66029098"
"chr2","10932563","10932869","chr11","73325139","73325444","57","62392576"
"chr2","10934108","10934395","chr3","9222529","9222816","60","1711579"
"chr2","10936990","10937284","chr7","76966352","76966647","35","66029362"
"chr2","10955335","10955619","chr7","76982810","76983097","44","66027475"
"chr2","10959520","10959646","chr1","187726107","187726234","20","176766587"
"chr2","10969601","10969769","chr5","49653517","49653681","37","38683916"
"chr2","10971305","10971532","chr21","16740531","16740770","55","5769226"
"chr2","10974383","10974672","chr7","21577710","21578003","76","10603327"
"chr2","10982594","10982750","chr5","47411513","47411657","36","36428919"
"chr2","10982886","10983021","chr7","26158438","26158564","35","15175552"
"chr2","10987700","10987977","chr9","68750041","68750323","58","57762341"
"chr2","10987978","10988131","chr7","148755651","148755798","34","137767673"
"chr2","10998231","10998545","chr7","77028363","77028665","53","66030132"
"chr2","11017730","11017777","chr11","13602606","13602649","14","2584876"
"chr2","11018011","11018326","chr7","77055591","77055873","60","66037580"
"chr2","11033521","11033788","chr17","1647779","1648044","46","9385742"
"chr2","11036278","11036564","chr6","4984341","4984620","56","6051937"
"chr2","11040271","11040539","chrX","20229622","20229871","71","9189351"
"chr2","11042702","11042993","chr7","77094487","77094775","26","66051785"
"chr2","11045022","11045312","chr7","77099512","77099803","35","66054490"
"chr2","11059391","11059609","chr3","186187771","186187981","54","175128380"
"chr2","11060802","11061088","chr7","77113108","77113387","56","66052306"
"chr2","11082369","11082679","chr7","77143645","77143976","52","66061276"
"chr2","11147718","11147769","chr11","114841124","114841176","10","103693406"
"chr2","11184054","11184369","chr8","98755171","98755484","60","87571117"
"chr2","11185417","11185703","chr7","77264922","77265223","55","66079505"
"chr2","11202803","11202997","chr7","77280091","77280263","45","66077288"
"chr2","11203707","11203901","chr7","77280091","77280263","45","66076384"
"chr2","11204558","11204857","chr7","77280791","77281098","51","66076233"
"chr2","11205660","11205932","chr7","77281852","77282143","62","66076192"
"chr2","11206573","11206726","chr5","50931655","50931808","30","39725082"
"chr2","11209665","11209978","chr7","77286370","77286688","45","66076705"
"chr2","11211218","11211517","chr7","77289487","77289784","30","66078269"
"chr2","11213467","11213766","chr7","77289487","77289784","30","66076020"
"chr2","11214172","11214297","chr7","77290105","77290230","14","66075933"
"chr2","11217432","11217737","chr17","3743215","3743513","56","7474217"
"chr2","11218161","11218453","chr7","77293050","77293363","54","66074889"
"chr2","11233901","11234191","chrX","103981721","103982018","59","92747820"
"chr2","11239774","11239898","chr1","210013612","210013734","17","198773838"
"chr2","11240438","11240593","chr16","49017109","49017265","27","37776671"
"chr2","11242904","11243194","chr7","152763832","152764123","54","141520928"
"chr2","11248951","11249069","chr6","36093674","36093792","24","24844723"
"chr2","11250358","11250636","chr7","77315970","77316254","41","66065612"
"chr2","11254811","11254934","chr15","20319268","20319390","19","9064457"
"chr2","11261382","11261681","chr1","21215958","21216257","54","9954576"
"chr2","11268519","11268644","chr7","77337715","77337839","16","66069196"
"chr2","11269090","11269353","chr8","82738815","82739079","72","71469725"
"chr2","11272781","11273053","chr7","77347999","77348287","47","66075218"
"chr2","11275917","11276185","chr7","77350823","77351076","49","66074906"
"chr2","11279266","11279533","chr7","77350823","77351076","44","66071557"
"chr2","11280698","11280767","chr18","59137071","59137140","24","47856373"
"chr2","11282185","11282481","chr6","36200370","36200672","66","24918185"
"chr2","11291807","11292100","chr7","65620807","65621103","64","54329000"
"chr2","11301841","11302136","chr11","118557030","118557323","62","107255189"
"chr2","11309701","11310000","chr7","79261257","79261554","68","67951556"
"chr2","11312329","11312498","chr10","115667294","115667466","31","104354965"
"chr2","11319644","11319948","chr7","77392127","77392432","55","66072483"
"chr2","11325156","11325257","chr1","162595768","162595870","26","151270612"
"chr2","11338157","11338265","chr22","8033820","8033916","34","3304337"
"chr2","11350425","11350551","chr3","134832407","134832530","17","123481982"
"chr2","11351474","11351590","chr1","197987006","197987122","19","186635532"
"chr2","11355777","11355953","chrX","19928223","19928402","43","8572446"
"chr2","11355978","11356067","chr8","85109736","85109837","27","73753758"
"chr2","11357043","11357153","chr12","1702","1809","18","11355341"
"chr2","11368391","11368507","chr7","77444935","77445051","19","66076544"
"chr2","11380976","11381189","chr7","77456523","77456719","41","66075547"
"chr2","11387724","11388005","chr19","18551543","18551820","57","7163819"
"chr2","11420008","11420289","chr3","48274420","48274698","72","36854412"
"chr2","11424418","11424531","chr1","88668872","88668989","16","77244454"
"chr2","11431209","11431521","chr7","77502492","77502790","63","66071283"
"chr2","11432736","11433049","chr7","77503715","77504010","43","66070979"
"chr2","11503188","11503502","chr7","77578591","77578888","62","66075403"
"chr2","11504141","11504447","chr7","77579667","77579976","51","66075526"
"chr2","11509100","11509267","chr8","56795337","56795503","39","45286237"
"chr2","11516133","11516435","chr7","77589810","77590117","39","66073677"
"chr2","11523342","11523655","chr7","68214231","68214545","62","56690889"
"chr2","11526455","11526766","chr7","77596147","77596463","39","66069692"
"chr2","11544057","11544318","chr12","108756231","108756496","57","97212174"
"chr2","11545699","11545957","chr3","127863015","127863278","72","116317316"
"chr2","11563088","11563209","chr7","77628701","77628822","15","66065613"
"chr2","11563498","11563823","chr7","77629004","77629335","61","66065506"
"chr2","11568693","11569011","chr12","78771466","78771775","63","67202773"
"chr2","11573082","11573249","chr8","57340018","57340181","47","45766936"
"chr2","11577574","11577872","chr10","17607862","17608158","60","6030288"
"chr2","11580736","11580884","chr6","36782155","36782293","43","25201419"
"chr2","11586254","11586418","chr19","8002464","8002630","39","3583790"
"chr2","11588253","11588369","chr7","77649158","77649289","22","66060905"
"chr2","11590706","11590998","chr7","77651016","77651313","40","66060310"
"chr2","11593419","11593688","chr7","77655679","77655961","37","66062260"
"chr2","11596750","11597078","chr7","77659452","77659765","67","66062702"
"chr2","11714693","11715009","chr7","75671615","75671929","49","63956922"
"chr2","11723471","11723737","chr7","76312181","76312445","63","64588710"
"chr2","11730178","11730490","chr7","77909729","77910039","45","66179551"
"chr2","11730540","11730745","chr16","21816315","21816532","44","10085775"
"chr2","11739064","11739364","chr17","80556235","80556533","36","68817171"
"chr2","11749500","11749710","chr12","121197174","121197386","49","109447674"
"chr2","11753467","11753780","chr7","77927503","77927816","42","66174036"
"chr2","11783429","11783775","chr12","119444444","119444759","110","107661015"
"chr2","11785793","11785913","chr7","77954192","77954314","21","66168399"
"chr2","11790561","11790823","chr2A","96781258","96781516","63","84990697"
"chr2","11793513","11793642","chr19","32149204","32149333","20","20355691"
"chr2","11804468","11804762","chr7","77973559","77973872","53","66169091"
"chr2","11811943","11812059","chr6","38593130","38593246","23","26781187"
"chr2","11829046","11829185","chr1","23727757","23727901","29","11898711"
"chr2","11833679","11833987","chr7","77998188","77998487","51","66164509"
"chr2","11836434","11836678","chr4","175002498","175002742","55","163166064"
"chr2","11855858","11856096","chr8","25110012","25110252","55","13254154"
"chr2","11861678","11861869","chr7","78019323","78019524","30","66157645"
"chr2","11870172","11870387","chr1","94415288","94415510","52","82545116"
"chr2","11877504","11877820","chr1","121702735","121703046","77","109825231"
"chr2","11877831","11877957","chr1","24815947","24816071","21","12938116"
"chr2","11878787","11878967","chr3","9289110","9289290","54","2589677"
"chr2","11892636","11892762","chr6","18588428","18588554","33","6695792"
"chr2","11893449","11893669","chr7","78056069","78056266","42","66162620"
"chr2","11896085","11896352","chr1","10929819","10930083","61","966266"
"chr2","11928508","11928809","chr7","78085856","78086159","44","66157348"
"chr2","11951193","11951447","chr7","76783691","76783954","34","64832498"
"chr2","11957398","11957700","chr20","47885543","47885844","73","35928145"
"chr2","11975143","11975408","chr16","49181420","49181682","58","37206277"
"chr2","12025188","12025470","chr7","78181871","78182154","46","66156683"
"chr2","12105639","12105724","chr5","82419171","82419254","12","70313532"
"chr2","12224226","12224530","chr2A","62868142","62868438","70","50643916"
"chr2","12297454","12297749","chrX","119401800","119402094","54","107104346"
"chr2","12306195","12306449","chr7","78487093","78487334","43","66180898"
"chr2","12321101","12321390","chr7","78495579","78495877","44","66174478"
"chr2","12322490","12322772","chr7","78496984","78497275","30","66174494"
"chr2","12323175","12323440","chr8","43033341","43033599","58","30710166"
"chr2","12340035","12340329","chr9","34785895","34786158","62","22445860"
"chr2","12346721","12346833","chr7","6893885","6894001","13","5452836"
"chr2","12361806","12361933","chr2A","82138107","82138230","20","69776301"
"chr2","12373490","12373770","chr3","9895412","9895695","51","2478078"
"chr2","12379275","12379571","chr7","78818816","78819119","57","66439541"
"chr2","12392615","12392918","chr7","78578629","78578894","66","66186014"
"chr2","12396380","12396438","chr18","6114293","6114352","10","6282087"
"chr2","12405633","12405914","chrX","52046393","52046686","62","39640760"
"chr2","12418067","12418348","chr7","66246986","66247273","61","53828919"
"chr2","12434766","12434969","chr5","8577350","8577557","43","3857416"
"chr2","12473055","12473228","chr5","97346864","97347036","38","84873809"
"chr2","12487108","12487256","chr5","40245998","40246150","37","27758890"
"chr2","12487722","12487855","chr1","119604336","119604462","31","107116614"
"chr2","12488469","12488753","chr7","78673213","78673517","56","66184744"
"chr2","12570858","12571172","chr7","78707764","78708081","59","66136906"
"chr2","12581799","12581942","chr1","32730027","32730168","32","20148228"
"chr2","12581967","12582265","chr9","58594884","58595182","60","46012917"
"chr2","12584642","12584918","chr7","78716924","78717186","48","66132282"
"chr2","12590077","12590370","chr5","43518355","43518652","67","30928278"
"chr2","12591331","12591441","chr5","42790276","42790386","19","30198945"
"chr2","12596899","12597182","chr7","78731417","78731699","34","66134518"
"chr2","12597995","12598123","chrX","129814256","129814386","27","117216261"
"chr2","12605145","12605259","chr20","46080183","46080300","13","33475038"
"chr2","12608216","12608402","chr1","163632639","163632827","43","151024423"
"chr2","12609827","12609992","chr7","37371403","37371567","37","24761576"
"chr2","12611857","12612105","chr7","78747499","78747761","36","66135642"
"chr2","12615428","12615695","chr7","78753787","78754056","58","66138359"
"chr2","12623304","12623619","chr7","78759996","78760306","54","66136692"
"chr2","12625162","12625457","chr7","78761970","78762281","45","66136808"
"chr2","12636420","12636548","chr7","78772323","78772456","11","66135903"
"chr2","12638710","12638984","chr5","133131289","133131554","58","120492579"
"chr2","12645591","12645790","chr10","37961866","37962063","40","25316275"
"chr2","12646836","12646931","chr7","78781782","78781873","11","66134946"
"chr2","12661683","12661974","chr7","78796340","78796632","40","66134657"
"chr2","12667191","12667494","chr19","54961036","54961343","63","42293845"
"chr2","12669814","12669937","chr7","77000001","77000126","30","64330187"
"chr2","12670397","12670699","chr7","78804142","78804456","47","66133745"
"chr2","12672099","12672413","chr7","78805532","78805844","43","66133433"
"chr2","12675129","12675404","chr7","78808540","78808807","47","66133411"
"chr2","12676750","12677014","chr7","72218881","72219133","84","59542131"
"chr2","12687434","12687751","chr7","78818816","78819119","46","66131382"
"chr2","12691808","12692081","chr22","12888040","12888318","56","196232"
"chr2","12695700","12695990","chr7","78824729","78825012","34","66129029"
"chr2","12705049","12705324","chr7","78831084","78831356","41","66126035"
"chr2","12711995","12712263","chr2B","60973482","60973740","68","48261487"
"chr2","12727120","12727427","chr7","78852825","78853141","42","66125705"
"chr2","12732432","12732533","chr19","15219953","15220058","25","2487521"
"chr2","12744936","12745218","chr7","78868475","78868756","37","66123539"
"chr2","12748739","12749044","chr7","78872120","78872424","47","66123381"
"chr2","12750325","12750446","chr8","45313442","45313566","18","32563117"
"chr2","12752250","12752562","chr7","78875895","78876201","34","66123645"
"chr2","12755563","12755873","chr1","160332533","160332842","58","147576970"
"chr2","12758831","12759160","chr7","68214231","68214545","68","55455400"
"chr2","12778596","12778660","chr1","26634024","26634094","14","13855428"
"chr2","12778670","12778913","chr7","78895241","78895477","46","66116571"
"chr2","12782979","12783283","chr7","78902197","78902494","33","66119218"
"chr2","12783292","12783411","chr1","94267470","94267597","29","81484178"
"chr2","12787303","12787595","chr1","227415933","227416230","57","214628630"
"chr2","12790337","12790630","chr7","78909336","78909639","51","66118999"
"chr2","12792481","12792774","chr7","78911733","78912012","49","66119252"
"chr2","12797363","12797645","chr7","72469394","72469669","60","59672031"
"chr2","12805538","12805658","chr7","78923196","78923313","13","66117658"
"chr2","12807427","12807568","chr7","78925352","78925506","27","66117925"
"chr2","12817963","12818099","chr1","222303578","222303712","31","209485615"
"chr2","12829922","12830225","chr7","78947944","78948236","66","66118022"
"chr2","12832801","12833091","chr1","130048013","130048302","57","117215212"
"chr2","12836619","12836768","chr1","46271276","46271424","29","33434657"
"chr2","12840176","12840357","chr6","25632918","25633092","42","12792742"
"chr2","12841220","12841446","chr7","78958687","78958912","33","66117467"
"chr2","12848139","12848418","chr7","78966337","78966619","44","66118198"
"chr2","12849344","12849630","chr7","78967844","78968118","48","66118500"
"chr2","12850638","12850847","chr7","78968695","78968914","27","66118057"
"chr2","12854380","12854670","chr6","18109970","18110261","53","5255590"
"chr2","12867735","12867995","chr7","78984933","78985185","23","66117198"
"chr2","12879120","12879398","chr2B","64908023","64908299","52","52028903"
"chr2","12883844","12884061","chr20","36084199","36084404","60","23200355"
"chr2","12927538","12927732","chr1","163632639","163632827","47","150705101"
"chr2","12941461","12941748","chr7","79047675","79047980","53","66106214"
"chr2","12946890","12947191","chr7","79053236","79053515","51","66106346"
"chr2","12948438","12948736","chrX","103981721","103982018","56","91033283"
"chr2","12955250","12955532","chr7","79064426","79064728","44","66109176"
"chr2","12964549","12964826","chr16","11169771","11170042","48","1794778"
"chr2","12970177","12970276","chr14","48812060","48812162","21","35841883"
"chr2","12995716","12995855","chr20","36705924","36706059","33","23710208"
"chr2","13031219","13031511","chr7","79146308","79146601","46","66115089"
"chr2","13054783","13055064","chr7","79169317","79169602","40","66114534"
"chr2","13108932","13109054","chr6","38593130","38593246","22","25484198"
"chr2","13112733","13113037","chr7","79208415","79208728","41","66095682"
"chr2","13115929","13116219","chr5","96942875","96943163","58","83826946"
"chr2","13124140","13124446","chr1","44801547","44801840","63","31677407"
"chr2","13137647","13137928","chr4","139844033","139844321","57","126706386"
"chr2","13143610","13143864","chr7","79240989","79241250","41","66097379"
"chr2","13143894","13144174","chr7","79241273","79241561","45","66097379"
"chr2","13145379","13145609","chrX","71066264","71066485","50","57920885"
"chr2","13157766","13158091","chr7","79255589","79255899","50","66097823"
"chr2","13159474","13159763","chr1","214289016","214289307","51","201129542"
"chr2","13160948","13161244","chr7","79258257","79258556","50","66097309"
"chr2","13163680","13163987","chr7","79261257","79261554","60","66097577"
"chr2","13172812","13173097","chr5","144183635","144183922","55","131010823"
"chr2","13178940","13179212","chr11","47006876","47007157","47","33827936"
"chr2","13184844","13185005","chr20","43287655","43287814","33","30102811"
"chr2","13185790","13185912","chr4","15319434","15319556","25","2133644"
"chr2","13192600","13192714","chr7","79291991","79292103","13","66099391"
"chr2","13194675","13194946","chr7","79293631","79293923","54","66098956"
"chr2","13205391","13205576","chr15","23396259","23396443","35","10190868"
"chr2","13210472","13210627","chr20","3130222","3130380","37","10080250"
"chr2","13212814","13213097","chr12","123096820","123097105","66","109884006"
"chr2","13221537","13221832","chr8","98967491","98967789","58","85745954"
"chr2","13226899","13227111","chr6","169957830","169958043","45","156730931"
"chr2","13230517","13230803","chr4","15029081","15029370","57","1798564"
"chr2","13239910","13240205","chr1","53759185","53759481","68","40519275"
"chr2","13240539","13240826","chr2A","4856156","4856444","58","8384383"
"chr2","13258255","13258550","chr17","26278033","26278331","61","13019778"
"chr2","13260093","13260404","chr5","36408852","36409158","52","23148759"
"chr2","13275656","13275898","chr21","33958325","33958573","56","20682669"
"chr2","13315585","13315865","chr18","33700661","33700944","60","20385076"
"chr2","13330401","13330532","chr10","12650705","12650831","25","679696"
"chr2","13332408","13332724","chr7","79401065","79401366","50","66068657"
"chr2","13336209","13336506","chr2A","82593951","82594258","64","69257742"
"chr2","13367358","13367482","chr7","79429219","79429349","14","66061861"
"chr2","13372504","13372807","chr3","73800681","73800984","65","60428177"
"chr2","13374324","13374608","chr8","59850782","59851072","63","46476458"
"chr2","13387719","13387839","chr2A","89185427","89185551","18","75797708"
"chr2","13387852","13388154","chr12","35651704","35652010","54","22263852"
"chr2","13406721","13406928","chr7","79468343","79468557","22","66061622"
"chr2","13408120","13408324","chr7","79469749","79469955","23","66061629"
"chr2","13412093","13412404","chr7","79474043","79474354","46","66061950"
"chr2","13416556","13416837","chr7","79477925","79478213","41","66061369"
"chr2","13418983","13419267","chr7","79480428","79480728","48","66061445"
"chr2","13424073","13424347","chr7","79484482","79484764","43","66060409"
"chr2","13425857","13426145","chr7","79486261","79486547","33","66060404"
"chr2","13441253","13441547","chr7","79503652","79503962","50","66062399"
"chr2","13442934","13443207","chr14","34312153","34312433","56","20869219"
"chr2","13443219","13443349","chr7","72152252","72152381","21","58709033"
"chr2","13443371","13443634","chr1","27556866","27557137","55","14113495"
"chr2","13450211","13450488","chr7","79512309","79512602","57","66062098"
"chr2","13458887","13459173","chr12","28126504","28126789","56","14667617"
"chr2","13474097","13474368","chr3","196516058","196516321","56","183041961"
"chr2","13477925","13478217","chr5","26464690","26464978","75","12986765"
"chr2","13479034","13479332","chr7","79541491","79541791","35","66062457"
"chr2","13490908","13491200","chr7","79556382","79556681","44","66065474"
"chr2","13491586","13491872","chr7","79557010","79557276","47","66065424"
"chr2","13492423","13492553","chr20","3645405","3645538","30","9847018"
"chr2","13495033","13495250","chr7","79571826","79572051","35","66076793"
"chr2","13495252","13495311","chr8","28548049","28548105","12","15052797"
"chr2","13495781","13495872","chr2A","7219562","7219651","17","6276219"
"chr2","13498706","13498991","chr4","17352936","17353221","62","3854230"
"chr2","13502885","13503136","chr5","24574460","24574716","63","11071575"
"chr2","13506230","13506336","chr7","79585668","79585775","15","66079438"
"chr2","13506995","13507172","chr5","156830395","156830571","35","143323400"
"chr2","13516255","13516543","chr7","79595414","79595715","52","66079159"
"chr2","13517766","13518061","chr1","91059171","91059456","58","77541405"
"chr2","13541582","13541789","chr9","94955322","94955526","43","81413740"
"chr2","13547918","13548221","chr7","79620689","79621003","70","66072771"
"chr2","13551366","13551611","chr8","74772775","74773004","65","61221409"
"chr2","13554314","13554626","chr7","56981139","56981412","73","43426825"
"chr2","13556051","13556312","chr1","43147842","43148118","61","29591791"
"chr2","13560458","13560742","chr7","79635485","79635790","58","66075027"
"chr2","13581963","13582245","chr7","46531036","46531327","54","32949073"
"chr2","13587275","13587578","chr7","79655318","79655626","41","66068043"
"chr2","13589589","13589907","chr7","79657252","79657565","35","66067663"
"chr2","13589993","13590164","chr7","79657650","79657818","16","66067657"
"chr2","13598526","13598626","chr15","28217108","28217206","14","14618582"
"chr2","13637195","13637322","chr9","47369076","47369207","16","33731881"
"chr2","13696027","13696323","chr15","64262336","64262638","70","50566309"
"chr2","13708354","13708622","chr12","111724732","111725004","52","98016378"
"chr2","13710013","13710296","chr7","79769765","79770074","52","66059752"
"chr2","13714658","13714942","chr7","79776396","79776672","35","66061738"
"chr2","13724412","13724542","chr5","55288318","55288450","32","41563906"
"chr2","13724983","13725136","chr16","49017109","49017265","31","35292126"
"chr2","13726022","13726138","chr5","42790276","42790386","27","29064254"
"chr2","13743217","13743478","chr7","79804794","79805064","45","66061577"
"chr2","13745560","13745803","chr15","13143077","13143320","56","602483"
"chr2","13746816","13747111","chr7","79808105","79808396","56","66061289"
"chr2","13763727","13763988","chr7","79821007","79821287","50","66057280"
"chr2","13766548","13766685","chr2B","94897282","94897419","36","81130734"
"chr2","13781619","13781901","chr7","79837443","79837719","45","66055824"
"chr2","13799783","13800018","chr6","146361614","146361839","50","132561831"
"chr2","13803759","13804070","chr10","7645193","7645494","58","6158566"
"chr2","13828533","13828822","chr7","79886320","79886618","34","66057787"
"chr2","13839534","13839653","chr10","25896416","25896533","20","12056882"
"chr2","13842222","13842346","chr7","79899627","79899751","12","66057405"
"chr2","13869262","13869419","chr5","18057976","18058128","30","4188714"
"chr2","13890980","13891259","chr7","79952814","79953129","62","66061834"
"chr2","13900762","13901030","chr7","79963614","79963905","49","66062852"
"chr2","13903131","13903412","chrX","118718918","118719200","55","104815787"
"chr2","13910226","13910537","chr4","165118395","165118704","63","151208169"
"chr2","13922712","13923011","chr7","79988030","79988332","45","66065318"
"chr2","13937124","13937418","chr7","80003575","80003869","34","66066451"
"chr2","13941915","13942196","chr19","7252987","7253269","48","6688928"
"chr2","13943382","13943504","chr5","687856","687980","17","13255526"
"chr2","13947356","13947629","chr15","27134497","27134773","65","13187141"
"chr2","13952409","13952704","chr7","80033054","80033359","42","66080645"
"chr2","13959065","13959365","chr5","18526854","18527152","66","4567789"
"chr2","13960181","13960457","chr14","76134498","76134771","62","62174317"
"chr2","13966139","13966428","chr16","14458717","14458998","58","492578"
"chr2","13977760","13977884","chr6","138934164","138934288","20","124956404"
"chr2","13986179","13986459","chr22","12503273","12503563","56","1482906"
"chr2","13992928","13993215","chr12","113855221","113855507","72","99862293"
"chr2","13994190","13994488","chr7","80060311","80060624","52","66066121"
"chr2","14007668","14007966","chr12","121101371","121101664","55","107093703"
"chr2","14010933","14011207","chr7","80073710","80073983","37","66062777"
"chr2","14012487","14012669","chr19","57373584","57373756","51","43361097"
"chr2","14017713","14017812","chr5","32909203","32909296","20","18891490"
"chr2","14017814","14018073","chr7","80079488","80079767","49","66061674"
"chr2","14022806","14023088","chr7","80082433","80082706","42","66059627"
"chr2","14024408","14024696","chr5","53825604","53825900","58","39801196"
"chr2","14025205","14025495","chr4","120243844","120244136","51","106218639"
"chr2","14044354","14044611","chr10","115750225","115750498","59","101705871"
"chr2","14067953","14068240","chr7","80121719","80122005","32","66053766"
"chr2","14070459","14070774","chr7","6638932","6639245","55","7431527"
"chr2","14073668","14073956","chr1","216367084","216367370","60","202293416"
"chr2","14075278","14075418","chr5","62768285","62768417","26","48693007"
"chr2","14079438","14079611","chr11","129039284","129039464","35","114959846"
"chr2","14086997","14087260","chr7","6624566","6624830","35","7462431"
"chr2","14096887","14097124","chr7","7644382","7644601","59","6452505"
"chr2","14098516","14098682","chr7","5757557","5757738","35","8340959"
"chr2","14101333","14101453","chr7","5629067","5629182","28","8472266"
"chr2","14110448","14110713","chr9","75566020","75566287","59","61455572"
"chr2","14118938","14119213","chr9","75566020","75566287","64","61447082"
"chr2","14127934","14128222","chr20","34956566","34956856","61","20828632"
"chr2","14132258","14132572","chr1","45223007","45223325","74","31090749"
"chr2","14143175","14143470","chr1","45145246","45145545","54","31002071"
"chr2","14149884","14149967","chr7","6560606","6560691","12","7589278"
"chr2","14152436","14152737","chr7","6557954","6558261","35","7594482"
"chr2","14177038","14177202","chrX","53585501","53585670","35","39408463"
"chr2","14183376","14183498","chrUn_CABD030132034v1","1249","1372","19","14182127"
"chr2","14199455","14199586","chr6","44927054","44927185","23","30727599"
"chr2","14207167","14207478","chr7","5859039","5859347","32","8348128"
"chr2","14221959","14222258","chr6","37968425","37968721","57","23746466"
"chr2","14222731","14222921","chr19","6085105","6085297","52","8137626"
"chr2","14226588","14226670","chr12","111226739","111226819","22","97000151"
"chr2","14231770","14231930","chr10","9092798","9092964","35","5138972"
"chr2","14245450","14245567","chr8","77616166","77616282","16","63370716"
"chr2","14284971","14285164","chr5","162070840","162071039","44","147785869"
"chr2","14285451","14285525","chr16","25465080","25465156","11","11179629"
"chr2","14314441","14314726","chr7","5948149","5948430","30","8366292"
"chr2","14315050","14315229","chr1","5722040","5722227","43","8593010"
"chr2","14316004","14316275","chr3","135417240","135417523","72","121101236"
"chr2","14321650","14321916","chr7","67191406","67191666","70","52869756"
"chr2","14348325","14348494","chr12","117952092","117952251","39","103603767"
"chr2","14382046","14382326","chr5","34269216","34269495","65","19887170"
"chr2","14386183","14386344","chr1","62033164","62033324","42","47646981"
"chr2","14386447","14386747","chr7","6018954","6019248","40","8367493"
"chr2","14393074","14393355","chr7","6024441","6024760","76","8368633"
"chr2","14404481","14404601","chr11","116940502","116940607","34","102536021"
"chr2","14436197","14436462","chr7","6065983","6066255","48","8370214"
"chr2","14443477","14443797","chr7","6075063","6075382","46","8368414"
"chr2","14454013","14454319","chr7","78818816","78819119","61","64364803"
"chr2","14458175","14458439","chr7","6088806","6089085","40","8369369"
"chr2","14473543","14473849","chr7","6100233","6100533","50","8373310"
"chr2","14478290","14478584","chr7","6105119","6105425","51","8373171"
"chr2","14480182","14480288","chr7","6106710","6106834","28","8373472"
"chr2","14480567","14480863","chr7","6106912","6107199","43","8373655"
"chr2","14481014","14481051","chr10","89039244","89039288","13","74558230"
"chr2","14481075","14481278","chr5","7737463","7737648","50","6743612"
"chr2","14485213","14485503","chr7","6112103","6112391","29","8373110"
"chr2","14491990","14492113","chr17","26242812","26242935","20","11750822"
"chr2","14496906","14497194","chr12","113271042","113271331","70","98774136"
"chr2","14523441","14523735","chr11","72886530","72886827","70","58363089"
"chr2","14523958","14524096","chr19","18272738","18272873","29","3748780"
"chr2","14528914","14529105","chr20","33755627","33755812","51","19226713"
"chr2","14532663","14532968","chr7","6148815","6149116","39","8383848"
"chr2","14544214","14544507","chr6","44490688","44490979","71","29946474"
"chr2","14545917","14546026","chr7","77421111","77421221","24","62875194"
"chr2","14554294","14554466","chr7","6162087","6162257","21","8392207"
"chr2","14554559","14554689","chr7","107774197","107774327","23","93219638"
"chr2","14559431","14559762","chr7","6170916","6171227","60","8388515"
"chr2","14560223","14560450","chr7","6172015","6172237","27","8388208"
"chr2","14575650","14575960","chr7","6189339","6189650","59","8386311"
"chr2","14583324","14583547","chr10","131831607","131831827","50","117248283"
"chr2","14593766","14593897","chr7","85668796","85668925","37","71075030"
"chr2","14637280","14637401","chr4","163028449","163028575","23","148391169"
"chr2","14656928","14657074","chr3","267312","267456","29","14389616"
"chr2","14657749","14657870","chr11","46952682","46952804","17","32294933"
"chr2","14658717","14658871","chr21","37457419","37457581","38","22798702"
"chr2","14664502","14664612","chr7","6273843","6273955","15","8390659"
"chr2","14673583","14673906","chr7","6289460","6289786","38","8384123"
"chr2","14688778","14689061","chr7","6304141","6304392","61","8384637"
"chr2","14698849","14698978","chr2B","44606898","44607016","30","29908049"
"chr2","14699195","14699337","chr14","52842638","52842775","37","38143443"
"chr2","14702716","14702842","chr2A","17602188","17602313","31","2899472"
"chr2","14702891","14702964","chr3","58615362","58615437","23","43912471"
"chr2","14712558","14712829","chr7","6328163","6328440","34","8384395"
"chr2","14741492","14741748","chr17","9567584","9567855","61","5173908"
"chr2","14741772","14742046","chr15","57373619","57373904","66","42631847"
"chr2","14746559","14746858","chr4","87402636","87402937","58","72656077"
"chr2","14750847","14751138","chr14","34397701","34398000","58","19646854"
"chr2","14754044","14754357","chr7","6372007","6372316","34","8382037"
"chr2","14762924","14763055","chr6","160196567","160196700","17","145433643"
"chr2","14770298","14770391","chr9","91757945","91758035","20","76987647"
"chr2","14771037","14771120","chr14","41346776","41346870","24","26575739"
"chr2","14771674","14771928","chr7","6390530","6390785","36","8381144"
"chr2","14774657","14774921","chr7","6393260","6393527","37","8381397"
"chr2","14779808","14780070","chr7","6399005","6399278","56","8380803"
"chr2","14781900","14782178","chr6","48539838","48540114","74","33757938"
"chr2","14782973","14783245","chr1","210738129","210738412","56","195955156"
"chr2","14785482","14785772","chr20","18881434","18881726","59","4095952"
"chr2","14792727","14792820","chr14","73617503","73617594","15","58824776"
"chr2","14795547","14795657","chr1","157655866","157655976","19","142860319"
"chr2","14806612","14806776","chr7","96055065","96055220","36","81248453"
"chr2","14812763","14813063","chr8","40404449","40404742","57","25591686"
"chr2","14816399","14816550","chr10","101988216","101988372","39","87171817"
"chr2","14819095","14819368","chr7","6424140","6424437","55","8394955"
"chr2","14826867","14827159","chr1","68093289","68093580","53","53266422"
"chr2","14828841","14829135","chr7","6431784","6432078","36","8397057"
"chr2","14842712","14842998","chr7","78875895","78876201","64","64033183"
"chr2","14897746","14897909","chr1","162716672","162716841","32","147818926"
"chr2","14925552","14925835","chr7","4848312","4848594","21","10077240"
"chr2","14927732","14928016","chr7","4846362","4846645","48","10081370"
"chr2","14936950","14937176","chr16","28658110","28658328","56","13721160"
"chr2","14941861","14941975","chr20","49914948","49915055","24","34973087"
"chr2","14946184","14946490","chr7","4854357","4854647","61","10091827"
"chr2","14948803","14949120","chr3","54114706","54115016","64","39165903"
"chr2","14949690","14949757","chr20","33472303","33472374","14","18522613"
"chr2","14950950","14951243","chr7","56830178","56830472","57","41879228"
"chr2","14951262","14951381","chr7","5628069","5628189","20","9323193"
"chr2","15002334","15002579","chr7","5571741","5572023","64","9430593"
"chr2","15032968","15033220","chr12","62511631","62511885","56","47478663"
"chr2","15048678","15048842","chr3","43594842","43594998","35","28546164"
"chr2","15104236","15104530","chr7","5521038","5521346","60","9583198"
"chr2","15106071","15106339","chr7","5502086","5502337","50","9603985"
"chr2","15139289","15139557","chr7","5451217","5451515","52","9688072"
"chr2","15173713","15173856","chr6","77626450","77626592","30","62452737"
"chr2","15174934","15175080","chr20","13392558","13392708","36","1782376"
"chr2","15177536","15177664","chr7","5415964","5416096","12","9761572"
"chr2","15203393","15203538","chr15","52764054","52764186","36","37560661"
"chr2","15238555","15238843","chr7","5357891","5358187","47","9880664"
"chr2","15241823","15241999","chr1","184720130","184720300","38","169478307"
"chr2","15251411","15251719","chr7","5344324","5344626","35","9907087"
"chr2","15254978","15255127","chrX","2794957","2795096","28","12460021"
"chr2","15258731","15258949","chr11","128206721","128206940","44","112947990"
"chr2","15268435","15268713","chr7","5329845","5330131","39","9938590"
"chr2","15269189","15269456","chr1","94463809","94464075","64","79194620"
"chr2","15269932","15270172","chr5","121689731","121689952","66","106419799"
"chr2","15270175","15270396","chrX","48678555","48678774","49","33408380"
"chr2","15270397","15270568","chr19","5926401","5926542","63","9343996"
"chr2","15293466","15293765","chr7","5307062","5307364","45","9986404"
"chr2","15303498","15303792","chr7","5297360","5297657","43","10006138"
"chr2","15307601","15307898","chr7","5292436","5292740","59","10015165"
"chr2","15319767","15320026","chr7","5284078","5284374","59","10035689"
"chr2","15342940","15343234","chr7","5264009","5264318","55","10078931"
"chr2","15376403","15376527","chr7","5232976","5233101","15","10143427"
"chr2","15377893","15378198","chr7","5230390","5230685","37","10147503"
"chr2","15381318","15381611","chr7","5225980","5226271","41","10155338"
"chr2","15382419","15382692","chr7","5225466","5225754","55","10156953"
"chr2","15386612","15386887","chr5","8734711","8734988","54","6651901"
"chr2","15389273","15389556","chr7","5218110","5218380","57","10171163"
"chr2","15407642","15407889","chr7","71705249","71705504","65","56297607"
"chr2","15446485","15446604","chr14","60352578","60352701","22","44906093"
"chr2","15446753","15446913","chr15","21950673","21950831","29","6503920"
"chr2","15450895","15451190","chr7","5151702","5151998","40","10299193"
"chr2","15454668","15454961","chr7","5149086","5149391","41","10305582"
"chr2","15465928","15466234","chr9","80914511","80914814","66","65448583"
"chr2","15469456","15469622","chr1","132661743","132661910","33","117192287"
"chr2","15484828","15485006","chr5","4857045","4857220","48","10627783"
"chr2","15495512","15495777","chr7","5020758","5021040","45","10474754"
"chr2","15497617","15497815","chr7","5683379","5683562","48","9814238"
"chr2","15518122","15518246","chr3","125378751","125378875","15","109860629"
"chr2","15526734","15527013","chr7","5095566","5095848","44","10431168"
"chr2","15537821","15538122","chr7","5086727","5087027","50","10451094"
"chr2","15543277","15543585","chr7","5082358","5082666","57","10460919"
"chr2","15565634","15565899","chr7","5020758","5021040","45","10544876"
"chr2","15571384","15571506","chr7","5677173","5677296","19","9894211"
"chr2","15578651","15578832","chr4","39615393","39615568","51","24036742"
"chr2","15584749","15584849","chr1","90050036","90050137","24","74465287"
"chr2","15597954","15598166","chr1","14883371","14883564","69","714583"
"chr2","15608383","15608609","chr16","22296344","22296566","57","6687961"
"chr2","15609187","15609254","chr15","35370793","35370862","16","19761606"
"chr2","15611173","15611468","chr16","37169836","37170132","75","21558663"
"chr2","15617589","15617851","chr7","4956677","4956943","33","10660912"
"chr2","15634726","15634844","chr7","71842255","71842378","18","56207529"
"chr2","15653155","15653269","chr3","187504297","187504409","24","171851142"
"chr2","15654172","15654455","chr12","32032110","32032393","52","16377938"
"chr2","15655240","15655302","chr12","59624929","59624987","21","43969689"
"chr2","15663076","15663211","chr1","39341659","39341785","33","23678583"
"chr2","15665595","15665711","chr12","75323667","75323785","16","59658072"
"chr2","15668952","15669246","chr3","133625823","133626121","53","117956871"
"chr2","15673637","15673755","chr16","19747838","19747947","36","4074201"
"chr2","15674569","15674702","chr7","76360858","76360988","24","60686289"
"chr2","15681225","15681383","chr2A","20052296","20052456","33","4371071"
"chr2","15687739","15687995","chr7","4801436","4801706","46","10886303"
"chr2","15694240","15694519","chr7","4795500","4795789","50","10898740"
"chr2","15727621","15727843","chr5","4427940","4428166","61","11299681"
"chr2","15734765","15735040","chr7","4758358","4758634","53","10976407"
"chr2","15737371","15737647","chrX","119498447","119498725","63","103761076"
"chr2","15738818","15738918","chr1","65149414","65149509","21","49410596"
"chr2","15739604","15739770","chr1","85340747","85340918","35","69601143"
"chr2","15748036","15748309","chr7","4746853","4747133","48","11001183"
"chr2","15763120","15763356","chr7","44645393","44645629","58","28882273"
"chr2","15775500","15775788","chr7","4719602","4719886","61","11055898"
"chr2","15786635","15786940","chrX","70801924","70802234","70","55015289"
"chr2","15794650","15794967","chr11","123331225","123331535","59","107536575"
"chr2","15812085","15812348","chr7","5333796","5334045","58","10478289"
"chr2","15821245","15821561","chr7","5082358","5082666","62","10738887"
"chr2","15825696","15825988","chr7","4993615","4993907","45","10832081"
"chr2","15833945","15834232","chr7","5677961","5678250","45","10155984"
"chr2","15851817","15852099","chr3","49090792","49091064","62","33238975"
"chr2","15852550","15852850","chr7","4655831","4656140","58","11196719"
"chr2","15872183","15872310","chr1","15380953","15381076","21","491230"
"chr2","15876962","15877227","chr7","4633788","4634052","28","11243174"
"chr2","15884580","15884845","chr7","4625848","4626132","59","11258732"
"chr2","15886043","15886326","chr7","4624751","4625025","51","11261292"
"chr2","15899962","15900179","chr12","29993522","29993738","55","14093560"
"chr2","15901720","15901845","chr10","25121161","25121285","18","9219441"
"chr2","15905695","15906003","chr7","4605129","4605434","41","11300566"
"chr2","15913704","15913910","chr8","83719990","83720200","55","67806286"
"chr2","15916229","15916478","chr7","4594490","4594752","50","11321739"
"chr2","15928132","15928201","chr1","204304706","204304776","16","188376574"
"chr2","15937059","15937237","chr10","16109750","16109920","36","172691"
"chr2","15942656","15942921","chr7","4569907","4570170","35","11372749"
"chr2","15983161","15983315","chr16","49017109","49017265","29","33033948"
"chr2","15988029","15988317","chr1","81293918","81294210","62","65305889"
"chr2","15988745","15988853","chr2A","95736091","95736198","16","79747346"
"chr2","15997668","15997970","chr18","4359369","4359662","58","11638299"
"chr2","15999887","15999990","chr17","8060698","8060798","19","7939189"
"chr2","16000949","16001214","chr7","4534069","4534368","67","11466880"
"chr2","16001579","16001882","chr7","4533492","4533780","54","11468087"
"chr2","16014348","16014508","chr5","118399435","118399596","33","102385087"
"chr2","16023871","16024156","chr19","38511083","38511371","57","22487212"
"chr2","16025246","16025493","chr7","4504621","4504896","61","11520625"
"chr2","16031523","16031758","chr9","113807290","113807518","62","97775767"
"chr2","16032481","16032752","chr7","4500355","4500634","53","11532126"
"chr2","16036443","16036687","chr17","31430781","31431025","55","15394338"
"chr2","16037171","16037234","chr7","71171698","71171760","17","55134527"
"chr2","16048259","16048593","chr7","4488522","4488824","79","11559737"
"chr2","16075646","16075950","chr2A","18986462","18986752","68","2910816"
"chr2","16078802","16079051","chr7","4439882","4440131","29","11638920"
"chr2","16080537","16080758","chr5","8883344","8883550","57","7197193"
"chr2","16083050","16083296","chr7","4435328","4435577","37","11647722"
"chr2","16093765","16094071","chr19","5049029","5049342","80","11044736"
"chr2","16099409","16099591","chr15","23396259","23396443","31","7296850"
"chr2","16101269","16101432","chr4","201366234","201366398","32","185264965"
"chr2","16111053","16111158","chr7","4412431","4412544","18","11698622"
"chr2","16114051","16114297","chr7","4409467","4409676","65","11704584"
"chr2","16123361","16123625","chr7","4397033","4397299","27","11726328"
"chr2","16130028","16130145","chr7","4387599","4387716","9","11742429"
"chr2","16138827","16139139","chr5","9692972","9693274","46","6445855"
"chr2","16140694","16140931","chr7","4372212","4372459","44","11768482"
"chr2","16151001","16151339","chr7","4362885","4363227","59","11788116"
"chr2","16162100","16162409","chr7","4349251","4349530","58","11812849"
"chr2","16165609","16165892","chr7","4345921","4346203","37","11819688"
"chr2","16201331","16201437","chr12","47420373","47420483","20","31219042"
"chr2","16215108","16215399","chr7","4289642","4289938","41","11925466"
"chr2","16223825","16224122","chr7","4285953","4286256","35","11937872"
"chr2","16242707","16243000","chr1","22944257","22944554","61","6701550"
"chr2","16248216","16248506","chr7","4258411","4258705","41","11989805"
"chr2","16268535","16268749","chr10","113204015","113204227","59","96935480"
"chr2","16268780","16268902","chr20","43708602","43708725","19","27439822"
"chr2","16298646","16298977","chr12","109533374","109533691","82","93234728"
"chr2","16316448","16316680","chr7","4188257","4188502","48","12128191"
"chr2","16321715","16322004","chr7","4182976","4183265","35","12138739"
"chr2","16323672","16323941","chr7","4180756","4181020","60","12142916"
"chr2","16346583","16346732","chr1","52325310","52325464","37","35978727"
"chr2","16372876","16372999","chr3","198553531","198553653","15","182180655"
"chr2","16377108","16377389","chr7","4115105","4115414","53","12262003"
"chr2","16392923","16393191","chr5","34798948","34799233","70","18406025"
"chr2","16459871","16460166","chr7","4032684","4032953","65","12427187"
"chr2","16466166","16466412","chr7","4026174","4026424","41","12439992"
"chr2","16545794","16546071","chr7","3953856","3954131","50","12591938"
"chr2","16579969","16580240","chr7","2959934","2960208","59","13620035"
"chr2","16627932","16628042","chr4","71940021","71940126","20","55312089"
"chr2","16665678","16665979","chr7","3824506","3824807","30","12841172"
"chr2","16726661","16726951","chr7","3764083","3764370","40","12962578"
"chr2","16749531","16749825","chr7","3742991","3743286","31","13006540"
"chr2","16807027","16807338","chr7","3682215","3682516","52","13124812"
"chr2","16812678","16812918","chr5","24284905","24285142","68","7472227"
"chr2","16851218","16851429","chr7","75849254","75849465","45","58998036"
"chr2","16893799","16894100","chr7","3595908","3596196","43","13297891"
"chr2","16981632","16981929","chr7","3524781","3525094","65","13456851"
"chr2","16985553","16985830","chr7","3520053","3520331","25","13465500"
"chr2","17009014","17009292","chr15","68280441","68280724","58","51271427"
"chr2","17058861","17059194","chr7","3448019","3448338","63","13610842"
"chr2","17109300","17109582","chr7","3419871","3420148","78","13689429"
"chr2","17176652","17176912","chr7","3359108","3359392","53","13817544"
"chr2","17242715","17242805","chr12","132206770","132206861","11","114964055"
"chr2","17246443","17246748","chr7","3252660","3252963","49","13993783"
"chr2","17278506","17278756","chr3","80419615","80419872","73","63141109"
"chr2","17293324","17293627","chr1","38363389","38363689","65","21070065"
"chr2","17326566","17326821","chr7","3178634","3178870","60","14147932"
"chr2","17346576","17346682","chr2A","10266630","10266736","19","7079946"
"chr2","17347022","17347228","chr7","3156522","3156723","30","14190500"
"chr2","17351833","17352129","chr1","227415933","227416230","51","210064100"
"chr2","17366689","17367007","chr3","23987720","23988019","68","6621031"
"chr2","17401034","17401308","chr7","3108711","3109000","56","14292323"
"chr2","17408482","17408790","chr7","3100153","3100456","51","14308329"
"chr2","17419216","17419505","chr7","3091507","3091802","36","14327709"
"chr2","17430541","17430849","chr19","5860383","5860693","53","11570158"
"chr2","17433035","17433351","chr7","3084366","3084668","47","14348669"
"chr2","17440386","17440496","chr7","3080839","3080951","12","14359547"
"chr2","17447098","17447395","chr22","3118787","3119094","57","14328311"
"chr2","17450949","17451243","chr13","96074609","96074909","66","78623660"
"chr2","17455285","17455393","chr4","72175486","72175600","26","54720201"
"chr2","17492145","17492446","chr7","3015748","3016037","43","14476397"
"chr2","17502877","17503170","chr7","3005083","3005380","41","14497794"
"chr2","17516688","17516961","chr11","123875047","123875316","53","106358359"
"chr2","17533367","17533674","chr7","2977255","2977562","67","14556112"
"chr2","17539438","17539743","chr7","2971810","2972119","46","14567628"
"chr2","17548357","17548646","chr7","2962231","2962539","59","14586126"
"chr2","17551152","17551432","chr7","2958204","2958490","53","14592948"
"chr2","17568954","17569220","chr7","2940568","2940854","52","14628386"
"chr2","17580955","17581259","chr10","118530035","118530339","58","100949080"
"chr2","17584916","17585212","chr7","2924425","2924732","43","14660491"
"chr2","17600456","17600756","chrX","41438165","41438458","51","23837709"
"chr2","17604982","17605274","chr7","2909980","2910279","48","14695002"
"chr2","17613915","17614193","chrX","119498447","119498725","56","101884532"
"chr2","17619895","17620149","chr16","30810267","30810530","66","13190372"
"chr2","17620649","17620761","chr7","153373536","153373649","35","135752887"
"chr2","17623696","17623966","chr7","2892849","2893139","50","14730847"
"chr2","17627792","17627908","chr5","55377785","55377903","15","37749993"
"chr2","17633301","17633587","chr7","2884717","2885007","58","14748584"
"chr2","17635295","17635576","chr7","2883021","2883304","29","14752274"
"chr2","17637189","17637456","chr7","2881049","2881326","42","14756140"
"chr2","17637790","17638071","chr7","2880734","2881026","51","14757056"
"chr2","17641094","17641422","chr7","2877481","2877797","44","14763613"
"chr2","17658937","17659244","chr7","2861053","2861354","49","14797884"
"chr2","17659365","17659439","chr14","75436417","75436490","14","57777052"
"chr2","17680461","17680570","chr4","110273813","110273922","21","92593352"
"chr2","17680615","17680802","chrX","19928223","19928402","43","2247608"
"chr2","17686315","17686579","chr7","2833793","2834081","60","14852522"
"chr2","17703995","17704153","chr3","48698665","48698819","35","30994670"
"chr2","17746680","17746975","chr7","2779711","2779993","71","14966969"
"chr2","17755981","17756122","chr3","186215816","186215959","29","168459835"
"chr2","17759839","17760124","chr7","2764354","2764642","46","14995485"
"chr2","17762723","17763020","chr7","2761494","2761795","37","15001229"
"chr2","17764689","17764967","chr7","2759244","2759519","56","15005445"
"chr2","17773840","17774165","chr7","2749634","2749962","36","15024206"
"chr2","17782170","17782448","chr7","2741591","2741886","45","15040579"
"chr2","17782648","17782764","chr7","2741273","2741388","13","15041375"
"chr2","17790495","17790731","chr7","2733732","2733965","37","15056763"
"chr2","17808100","17808396","chr1","227415933","227416230","57","209607833"
"chr2","17814351","17814662","chr7","2712221","2712537","50","15102130"
"chr2","17814922","17815078","chrX","17937151","17937313","34","122229"
"chr2","17825590","17825743","chr5","156787834","156787995","33","138962244"
"chr2","17826082","17826183","chr19","15338289","15338389","27","2487793"
"chr2","17828301","17828443","chr3","187425335","187425481","34","169597034"
"chr2","17862892","17863218","chr7","2673003","2673319","65","15189889"
"chr2","17867022","17867188","chr3","10866047","10866211","33","7000975"
"chr2","17885722","17886006","chr7","2643710","2643995","30","15242012"
"chr2","17894605","17894898","chr7","2633988","2634283","45","15260617"
"chr2","17901501","17901754","chr18","11328811","11329081","75","6572690"
"chr2","17902714","17902913","chr8","18127927","18128121","42","225213"
"chr2","17904205","17904509","chr7","2625204","2625474","62","15279001"
"chr2","17931599","17931914","chr1","227415933","227416230","60","209484334"
"chr2","17949373","17949649","chr13","81565282","81565572","57","63615909"
"chr2","17951789","17952065","chr13","81565282","81565572","58","63613493"
"chr2","17954935","17955218","chr7","2470903","2471170","51","15484032"
"chr2","17963569","17963889","chr5","123610162","123610480","74","105646593"
"chr2","17966060","17966361","chr7","2480249","2480545","45","15485811"
"chr2","17973213","17973450","chr4","71665586","71665814","49","53692373"
"chr2","17976999","17977264","chr5","139426874","139427147","55","121449875"
"chr2","18000715","18000865","chr21","37140540","37140698","39","19139825"
"chr2","18012856","18012961","chr1","191377103","191377214","24","173364247"
"chr2","18027251","18027538","chr5","140892681","140892984","53","122865430"
"chr2","18052235","18052350","chr3","32490927","32491044","16","14438692"
"chr2","18075698","18075787","chrX","27651738","27651825","21","9576040"
"chr2","18076040","18076157","chr12","34765799","34765924","26","16689759"
"chr2","18077311","18077413","chr5","140951370","140951469","12","122874059"
"chr2","18077421","18077540","chr5","140951477","140951595","12","122874056"
"chr2","18088216","18088346","chr1","130889305","130889428","25","112801089"
"chr2","18093148","18093217","chr15","35370793","35370862","13","17277645"
"chr2","18110858","18110987","chr12","29897183","29897312","21","11786325"
"chr2","18122577","18122717","chr7","105919947","105920079","39","87797370"
"chr2","18127269","18127353","chr5","10365804","10365890","16","7761465"
"chr2","18146558","18146859","chr7","128436828","128437114","68","110290270"
"chr2","18148330","18148636","chr1","163867986","163868280","62","145719656"
"chr2","18212295","18212409","chr15","43065241","43065351","35","24852946"
"chr2","18222985","18223242","chr19","40370912","40371163","49","22147927"
"chr2","18259463","18259584","chr17","26242812","26242935","19","7983349"
"chr2","18437412","18437545","chr5","141300954","141301086","14","122863542"
"chr2","18442239","18442514","chr5","141304364","141304645","35","122862125"
"chr2","18450460","18450683","chr1","28313248","28313460","60","9862788"
"chr2","18476594","18476753","chr4","190209315","190209476","38","171732721"
"chr2","18511944","18512223","chr14","11036231","11036534","58","7475713"
"chr2","18549705","18549851","chr10","29754500","29754651","34","11204795"
"chr2","18550569","18550646","chr8","85773266","85773342","8","67222697"
"chr2","18651735","18652034","chr2B","61386645","61386939","66","42734910"
"chr2","18702909","18703212","chr5","141522310","141522623","39","122819401"
"chr2","18709489","18709612","chr4","81992546","81992669","21","63283057"
"chr2","18719171","18719451","chr5","26154281","26154566","54","7435110"
"chr2","18784641","18784929","chr5","141609207","141609499","40","122824566"
"chr2","18833663","18833876","chr5","141656001","141656229","52","122822338"
"chr2","18846684","18846778","chr21","1076281","1076374","25","17770403"
"chr2","18870817","18870950","chr3","199463674","199463811","37","180592857"
"chr2","18894689","18894767","chr11","106359869","106359951","21","87465180"
"chr2","18897187","18897340","chr14","72724722","72724884","35","53827535"
"chr2","18908463","18908754","chr5","141743246","141743540","34","122834783"
"chr2","18951521","18951862","chr5","141788227","141788536","86","122836706"
"chr2","19001557","19001693","chr2A","21072743","21072884","36","2071186"
"chr2","19020711","19021000","chr5","141858595","141858908","45","122837884"
"chr2","19037510","19037617","chr3","102852724","102852835","21","83815214"
"chr2","19049721","19050013","chr5","141883853","141884152","44","122834132"
"chr2","19061069","19061304","chr5","141896060","141896286","33","122834991"
"chr2","19196840","19197137","chr5","142005741","142006029","51","122808901"
"chr2","19266816","19267136","chr5","142085354","142085670","53","122818538"
"chr2","19339562","19339856","chr5","142161085","142161376","31","122821523"
"chr2","19341368","19341673","chr5","142162913","142163209","44","122821545"
"chr2","19688480","19688777","chr5","142471657","142471960","47","122783177"
"chr2","19734897","19735199","chr5","142509820","142510131","55","122774923"
"chr2","19775471","19775593","chr7","68275138","68275242","33","48499667"
"chr2","19813728","19814022","chr5","142579965","142580260","52","122766237"
"chr2","19904770","19905049","chr5","142666166","142666452","43","122761396"
"chr2","20011975","20012164","chr9","35828180","35828355","41","15816205"
"chr2","20181858","20182137","chr5","142930170","142930446","41","122748312"
"chr2","20254205","20254492","chr5","143021000","143021283","31","122766795"
"chr2","20275284","20275443","chr1","205548459","205548612","36","185273175"
"chr2","20276657","20276885","chr5","143049158","143049391","31","122772501"
"chr2","20301643","20301940","chr5","143072627","143072923","44","122770984"
"chr2","20339128","20339438","chr5","143102982","143103274","42","122763854"
"chr2","20361808","20362097","chr5","143125707","143126008","55","122763899"
"chr2","20394092","20394311","chr3","131030044","131030263","54","110635952"
"chr2","20438649","20438880","chr5","143201731","143201970","33","122763082"
"chr2","20444989","20445242","chr14","79748369","79748624","56","59303380"
"chr2","20445799","20446099","chr4","120336534","120336832","57","99890735"
"chr2","20484225","20484501","chr5","143255615","143255913","55","122771390"
"chr2","20495789","20495933","chr12","43808866","43809010","35","23313077"
"chr2","20545375","20545492","chr5","143321554","143321671","12","122776179"
"chr2","20609148","20609440","chrX","50431440","50431734","66","29822292"
"chr2","20675917","20676197","chr5","143458245","143458540","57","122782328"
"chr2","20911308","20911407","chr5","143677012","143677105","16","122765704"
"chr2","21024756","21025067","chr4","74572451","74572763","64","53547695"
"chr2","21025752","21026032","chr5","143788790","143789101","54","122763038"
"chr2","21063827","21063952","chr5","134510526","134510649","19","113446699"
"chr2","21074539","21074634","chr8","27454109","27454202","18","6379570"
"chr2","21081808","21082099","chr1","163867986","163868280","58","142786178"
"chr2","21086398","21086695","chr5","143848520","143848821","34","122762122"
"chr2","21094854","21094929","chr13","78290388","78290468","19","57195534"
"chr2","21095434","21095662","chr10","116004252","116004480","50","94908818"
"chr2","21100604","21100910","chr5","143860623","143860933","33","122760019"
"chr2","21101854","21102158","chr16","30950078","30950376","64","9848224"
"chr2","21106584","21106913","chr8","45444010","45444324","99","24337426"
"chr2","21124576","21124693","chr5","39151097","39151212","19","18026521"
"chr2","21151624","21151937","chr5","143913562","143913870","51","122761938"
"chr2","21197420","21197729","chr5","143948911","143949222","43","122751491"
"chr2","21213885","21214166","chr5","143963937","143964204","46","122750052"
"chr2","21224141","21224433","chr8","98958788","98959071","71","77734647"
"chr2","21224618","21224805","chr15","10317583","10317761","50","10907035"
"chr2","21225363","21225441","chr1","224822809","224822879","28","203597446"
"chr2","21252682","21252836","chr17","567390","567550","31","20685292"
"chr2","21288510","21288830","chr18","33297211","33297525","81","12008701"
"chr2","21313887","21314023","chr7","56839310","56839440","36","35525423"
"chr2","21343086","21343396","chr5","144073895","144074182","60","122730809"
"chr2","21367863","21368128","chr5","144102946","144103226","53","122735083"
"chr2","21402433","21402606","chr11","71910867","71911040","32","50508434"
"chr2","21409011","21409333","chr5","144144516","144144822","49","122735505"
"chr2","21425769","21426052","chr4","151944849","151945132","55","130519080"
"chr2","21455711","21455998","chr8","73459268","73459568","90","52003557"
"chr2","21478870","21479161","chr5","144183635","144183922","32","122704765"
"chr2","21521334","21521625","chr5","144227369","144227658","37","122706035"
"chr2","21591743","21592011","chr5","144288482","144288757","43","122696739"
"chr2","21637940","21638226","chr2B","44290735","44291029","63","22652795"
"chr2","21664699","21664823","chr10","13841692","13841817","26","7823007"
"chr2","21693549","21693657","chr7","6379157","6379273","30","15314392"
"chr2","21880403","21880698","chr15","46902398","46902705","79","25021995"
"chr2","22053446","22053663","chr1","94415288","94415510","57","72361842"
"chr2","22118830","22118958","chr12","116758058","116758184","27","94639228"
"chr2","22398471","22398759","chr5","145066224","145066515","38","122667753"
"chr2","22405905","22406032","chr18","953349","953460","32","21452556"
"chr2","22446514","22446764","chr5","145118452","145118698","58","122671938"
"chr2","22563888","22564192","chr2B","71035214","71035513","61","48471326"
"chr2","22609389","22609687","chr2A","59048433","59048732","58","36439044"
"chr2","22646607","22646870","chr5","145318143","145318412","44","122671536"
"chr2","22983178","22983462","chr5","145679207","145679508","50","122696029"
"chr2","23206904","23207206","chr5","145898389","145898666","62","122691485"
"chr2","23254337","23254613","chr5","145940908","145941210","60","122686571"
"chr2","23265829","23266126","chr5","145958575","145958878","48","122692746"
"chr2","23305456","23305739","chr3","46024834","46025115","66","22719378"
"chr2","23419468","23419758","chr10","107321470","107321758","84","83902002"
"chr2","23587565","23587672","chr5","146308760","146308874","17","122721195"
"chr2","23673289","23673577","chr5","146397618","146397907","32","122724329"
"chr2","23700599","23700732","chr2B","88580506","88580637","32","64879907"
"chr2","23894681","23894945","chr3","53239919","53240186","57","29345238"
"chr2","23914704","23914998","chr10","15423252","15423543","72","8491452"
"chr2","24249884","24250191","chr5","147029475","147029793","46","122779591"
"chr2","24375122","24375409","chr5","147145382","147145665","41","122770260"
"chr2","24381670","24381969","chr5","147157826","147158120","51","122776156"
"chr2","24451503","24451774","chr5","147236166","147236433","30","122784663"
"chr2","24542046","24542323","chr5","147326868","147327161","47","122784822"
"chr2","24602277","24602521","chr1","41046990","41047239","71","16444713"
"chr2","24636853","24637128","chr20","10448273","10448546","57","14188580"
"chr2","24673874","24674110","chr13","14231204","14231443","57","10442670"
"chr2","24765580","24765881","chr5","147539252","147539587","54","122773672"
"chr2","24841416","24841690","chr5","147613276","147613550","27","122771860"
"chr2","25046324","25046620","chr5","147795770","147796072","38","122749446"
"chr2","25303880","25304173","chr5","148054753","148055069","71","122750873"
"chr2","25831110","25831411","chr5","148561523","148561850","70","122730413"
"chr2","25873904","25874177","chr15","57198929","57199201","60","31325025"
"chr2","25929333","25929454","chr3","24059298","24059420","25","1870035"
"chr2","26016913","26017198","chr14","48720660","48720941","69","22703747"
"chr2","26064087","26064381","chr5","148781916","148782225","55","122717829"
"chr2","26256196","26256346","chr16","6330633","6330790","35","19925563"
"chr2","26529908","26529994","chr21","8496784","8496874","21","18033124"
"chr2","26602958","26603088","chr1","17166499","17166627","24","9436459"
"chr2","26662498","26662816","chr5","149395812","149396129","77","122733314"
"chr2","26667390","26667684","chr5","149400910","149401215","44","122733520"
"chr2","26781744","26782034","chr1","32451497","32451790","82","5669753"
"chr2","26834956","26835263","chr5","149555031","149555353","62","122720075"
"chr2","26902280","26902413","chr1","9271571","9271700","33","17630709"
"chr2","26912040","26912338","chr5","149636737","149637051","56","122724697"
"chr2","27004803","27005102","chr5","149727457","149727755","59","122722654"
"chr2","27407432","27407590","chr3","59350634","59350793","37","31943202"
"chr2","27495729","27495855","chr5","150258918","150259044","9","122763189"
"chr2","27600467","27600754","chr5","150362647","150362939","36","122762180"
"chr2","27616464","27616740","chr5","150375647","150375945","60","122759183"
"chr2","27619687","27619983","chr5","150378591","150378905","49","122758904"
"chr2","27648978","27649282","chr5","150413444","150413755","51","122764466"
"chr2","27651884","27652179","chr5","150417084","150417385","49","122765200"
"chr2","27691368","27691622","chr5","150456659","150456924","41","122765291"
"chr2","27878466","27878743","chr5","150616045","150616325","38","122737579"
"chr2","27969641","27969939","chr7","103954890","103955192","68","75985249"
"chr2","27977095","27977421","chr12","43802996","43803296","74","15825901"
"chr2","27991048","27991345","chr1","45145246","45145545","62","17154198"
"chr2","27997144","27997452","chr5","150737565","150737869","41","122740421"
"chr2","28007498","28007785","chr5","150749640","150749934","38","122742142"
"chr2","28049031","28049324","chr5","150788669","150788965","48","122739638"
"chr2","28118474","28118596","chr10","108054123","108054246","19","79935649"
"chr2","28219652","28219782","chr15","22019347","22019478","27","6200305"
"chr2","28219799","28219872","chr7","866135","866210","23","27353664"
"chr2","28276227","28276530","chr5","151009115","151009435","54","122732888"
"chr2","28383996","28384256","chr7","64852523","64852793","72","36468527"
"chr2","28444383","28444547","chr5","51144248","51144411","37","22699865"
"chr2","28646414","28646489","chr5","55281420","55281479","27","26635006"
"chr2","28753692","28753990","chr5","151512170","151512484","64","122758478"
"chr2","28966431","28966716","chr21","32589182","32589474","67","3622751"
"chr2","29134638","29134761","chr5","151899742","151899865","19","122765104"
"chr2","29158109","29158322","chr14","51852749","51852956","48","22694640"
"chr2","29244406","29244671","chr5","35568316","35568581","60","6323910"
"chr2","29276106","29276230","chr5","152044567","152044690","19","122768461"
"chr2","29443354","29443628","chr5","152238479","152238763","36","122795125"
"chr2","29609495","29609646","chr5","152394893","152395049","25","122785398"
"chr2","29641448","29641500","chr3","179324147","179324199","13","149682699"
"chr2","29648267","29648552","chr5","152433419","152433695","43","122785152"
"chr2","29667848","29668159","chr5","152453154","152453447","46","122785306"
"chr2","29682832","29682919","chr2A","69591800","69591886","14","39908968"
"chr2","29698096","29698381","chr5","152481484","152481776","35","122783388"
"chr2","29734420","29734637","chr5","152511030","152511221","41","122776610"
"chr2","29738344","29738686","chr5","152514570","152514864","94","122776226"
"chr2","29746341","29746458","chrX","109736253","109736371","16","79989912"
"chr2","29753454","29753565","chr5","152528003","152528109","17","122774549"
"chr2","29790023","29790292","chr10","91348059","91348322","63","61558036"
"chr2","29795389","29795658","chr5","152557180","152557450","36","122761791"
"chr2","29797503","29797575","chr4","72000001","72000076","19","42202498"
"chr2","29800572","29800848","chr5","152566617","152566893","27","122766045"
"chr2","29816932","29817199","chr5","152585016","152585284","35","122768084"
"chr2","29823222","29823549","chr5","152590727","152591017","65","122767505"
"chr2","29826374","29826611","chr5","152593953","152594196","46","122767579"
"chr2","29835802","29835982","chr5","152603830","152604006","29","122768028"
"chr2","29839780","29839879","chr5","46000117","46000225","33","16160337"
"chr2","29840730","29841060","chr7","76684207","76684531","83","46843477"
"chr2","29878032","29878312","chr12","8922143","8922434","67","20955889"
"chr2","29882998","29883114","chr5","152649372","152649495","16","122766374"
"chr2","29885582","29885862","chr5","152653001","152653307","49","122767419"
"chr2","29885933","29886054","chr14","52104689","52104808","25","22218756"
"chr2","29895210","29895324","chr6","38593130","38593246","22","8697920"
"chr2","29934865","29935160","chr2A","38255626","38255922","56","8320761"
"chr2","29996202","29996487","chrX","70757717","70758005","60","40761515"
"chr2","30036601","30036914","chr5","152822301","152822599","44","122785700"
"chr2","30196348","30196454","chr5","152981583","152981699","18","122785235"
"chr2","30281642","30281715","chr11","106359869","106359951","24","76078227"
"chr2","30386814","30387094","chr5","153164637","153164929","37","122777823"
"chr2","30413507","30413765","chr5","153190916","153191201","55","122777409"
"chr2","30514786","30515081","chr5","153286899","153287201","42","122772113"
"chr2","30613357","30613654","chr5","153382654","153382963","29","122769297"
"chr2","30696578","30696879","chr5","153455172","153455486","54","122758594"
"chr2","30759858","30760116","chr1","60034453","60034701","53","29274595"
"chr2","30821709","30821983","chr5","153555496","153555783","43","122733787"
"chr2","30855703","30855955","chr5","60787675","60787923","55","29931972"
"chr2","30856322","30856575","chr8","21321579","21321831","68","9534743"
"chr2","30856728","30857044","chr5","153592430","153592739","48","122735702"
"chr2","30875876","30876127","chr5","153611750","153612000","27","122735874"
"chr2","30954267","30954574","chr6","168299675","168299980","47","137345408"
"chr2","31012845","31013158","chr5","117715100","117715415","42","86702255"
"chr2","31028453","31028773","chr16","55822983","55823307","89","24794530"
"chr2","31029870","31030131","chr5","117740601","117740875","38","86710731"
"chr2","31043272","31043394","chr1","130889305","130889428","24","99846033"
"chr2","31052885","31053169","chr8","24737260","24737543","51","6315625"
"chr2","31060016","31060302","chr5","145325549","145325836","60","114265533"
"chr2","31064191","31064486","chr5","117784274","117784574","48","86720083"
"chr2","31079019","31079297","chr5","117797958","117798249","49","86718939"
"chr2","31085545","31085851","chr7","77306579","77306892","61","46221034"
"chr2","31094856","31094970","chr18","22643681","22643795","11","8451175"
"chr2","31108743","31108917","chr15","12089962","12090129","49","19018781"
"chr2","31113313","31113427","chr5","18458596","18458708","19","12654717"
"chr2","31129640","31129801","chr5","157205261","157205424","31","126075621"
"chr2","31151855","31152149","chr5","117865734","117866019","73","86713879"
"chr2","31158951","31159229","chr5","117871697","117871995","55","86712746"
"chr2","31211333","31211493","chr21","24720942","24721101","36","6490391"
"chr2","31229897","31230017","chr5","117921987","117922110","10","86692090"
"chr2","31235097","31235238","chr6","18588428","18588554","38","12646669"
"chr2","31271948","31272225","chr5","117966836","117967110","34","86694888"
"chr2","31281520","31281658","chr6","151293518","151293653","29","120011998"
"chr2","31290768","31291093","chr5","117982744","117983058","43","86691976"
"chr2","31353682","31353954","chr5","118042814","118043100","50","86689132"
"chr2","31353962","31354251","chr3","11752386","11752679","59","19601576"
"chr2","31365808","31365960","chr1","46271276","46271424","34","14905468"
"chr2","31375861","31376156","chr1","45145246","45145545","63","13769385"
"chr2","31377665","31377934","chr3","126328788","126329066","64","94951123"
"chr2","31389443","31389717","chr5","118080918","118081193","46","86691475"
"chr2","31389994","31390114","chr5","118081470","118081594","13","86691476"
"chr2","31410125","31410361","chr14","24730745","24730969","67","6679380"
"chr2","31422411","31422690","chr5","118108109","118108400","42","86685698"
"chr2","31425162","31425456","chr5","118109703","118109991","32","86684541"
"chr2","31426966","31427173","chr6","22597991","22598206","46","8828975"
"chr2","31427765","31427972","chr6","22597991","22598206","46","8829774"
"chr2","31435409","31435708","chr5","118141448","118141748","38","86706039"
"chr2","31443332","31443609","chr5","118147813","118148091","30","86704481"
"chr2","31448174","31448456","chr5","118153810","118154099","51","86705636"
"chr2","31459159","31459460","chr6","77087930","77088224","67","45628771"
"chr2","31461038","31461338","chr5","118169179","118169484","35","86708141"
"chr2","31467393","31467696","chr10","85082966","85083267","67","53615573"
"chr2","31496258","31496552","chr3","145246806","145247099","69","113750548"
"chr2","31538318","31538489","chr10","35698454","35698615","49","4160136"
"chr2","31581028","31581121","chr8","27454109","27454202","16","4126919"
"chr2","31581147","31581177","chr5","4167585","4167615","13","27413562"
"chr2","31589419","31589723","chr5","118285762","118286062","62","86696343"
"chr2","31590749","31590962","chr5","118287099","118287321","35","86696350"
"chr2","31613264","31613393","chr18","8511013","8511141","37","23102251"
"chr2","31648558","31648849","chr19","2376897","2377192","65","29271661"
"chr2","31656487","31656685","chr11","1181282","1181489","62","30475205"
"chr2","31674804","31674882","chr2B","62150719","62150796","17","30475915"
"chr2","31687886","31688184","chr1","205372394","205372695","56","173684508"
"chr2","31691196","31691475","chr5","118385861","118386145","34","86694665"
"chr2","31702606","31702895","chr5","118399926","118400215","24","86697320"
"chr2","31728327","31728611","chr18","33700661","33700944","55","1972334"
"chr2","31735882","31736168","chr11","12728691","12728990","68","19007191"
"chr2","31743939","31744121","chr8","18127927","18128121","49","13616012"
"chr2","31755487","31755783","chr5","118431586","118431865","49","86676099"
"chr2","32147393","32147689","chr5","118800577","118800883","36","86653184"
"chr2","32177241","32177412","chr5","15507352","15507524","32","16669889"
"chr2","32580793","32581073","chr16","10990129","10990417","44","21590664"
"chr2","32678104","32678413","chr5","119367836","119368144","45","86689732"
"chr2","32720478","32720627","chr7","79271528","79271684","33","46551050"
"chr2","32776550","32776665","chr15","2141128","2141240","20","30635422"
"chr2","32878476","32878599","chr9","119806250","119806373","22","86927774"
"chr2","32894647","32894953","chr1","182794147","182794442","68","149899500"
"chr2","33219023","33219300","chr1","135651531","135651807","62","102432508"
"chr2","33336301","33336425","chr6","112856828","112856953","22","79520527"
"chr2","33336784","33337068","chr7","76467472","76467760","61","43130688"
"chr2","33690916","33691079","chr4","171210900","171211065","36","137519984"
"chr2","33691446","33691573","chr7","72722712","72722838","31","39031266"
"chr2","33701066","33701333","chr5","120385744","120386037","64","86684678"
"chr2","33744941","33745069","chr19","41275833","41275962","35","7530892"
"chr2","33809568","33809700","chr5","120504650","120504778","16","86695082"
"chr2","33884150","33884446","chr2A","73519394","73519717","69","39635244"
"chr2","33936114","33936235","chr5","156507270","156507393","20","122571156"
"chr2","34215894","34216183","chr5","120894947","120895244","41","86679053"
"chr2","34268536","34268822","chr5","120946655","120946942","58","86678119"
"chr2","34393475","34393738","chr5","121031596","121031866","35","86638121"
"chr2","34629372","34629497","chr15","22795538","22795661","25","11833834"
"chr2","34632444","34632734","chr5","121273058","121273373","55","86640614"
"chr2","34638111","34638395","chr11","47006876","47007157","61","12368765"
"chr2","34640796","34640862","chr9","53517094","53517157","18","18876298"
"chr2","34677629","34677927","chr5","121304108","121304407","40","86626479"
"chr2","34700296","34700594","chr10","116165116","116165408","71","81464820"
"chr2","34703403","34703630","chr5","121327895","121328127","28","86624492"
"chr2","34729705","34729843","chr5","121351074","121351220","24","86621369"
"chr2","34738866","34739162","chr12","113271042","113271331","76","78532176"
"chr2","34767884","34768212","chr5","121384646","121384940","66","86616762"
"chr2","34793188","34793325","chr2A","37107556","37107687","29","2314368"
"chr2","34809029","34809181","chr19","2131166","2131319","39","32677863"
"chr2","34814541","34814578","chr12","117752730","117752764","8","82938189"
"chr2","34815416","34815691","chr5","121436742","121436993","53","86621326"
"chr2","34818607","34818905","chr5","121439686","121439982","30","86621079"
"chr2","34835868","34836133","chr5","121455867","121456144","59","86619999"
"chr2","34858431","34858700","chr6","43023707","43023985","65","8165276"
"chr2","34873535","34873658","chr6","138934164","138934288","23","104060629"
"chr2","34887058","34887359","chr5","121512483","121512761","50","86625425"
"chr2","34889431","34889588","chr2A","83048818","83048974","31","48159387"
"chr2","34897187","34897480","chr5","121520023","121520321","45","86622836"
"chr2","34913576","34913826","chr16","23962681","23962924","59","10950895"
"chr2","34919181","34919337","chr1","68709407","68709549","37","33790226"
"chr2","34938746","34938898","chr3","187249118","187249274","35","152310372"
"chr2","34953311","34953359","chrX","131722366","131722413","10","96769055"
"chr2","34957779","34958022","chr20","40357293","40357553","74","5399514"
"chr2","34973942","34974239","chr5","121609495","121609800","45","86635553"
"chr2","34984455","34984580","chr7","26158438","26158564","32","8826017"
"chr2","34985229","34985376","chr13","27199846","27199982","27","7785383"
"chr2","34988023","34988314","chr5","121621221","121621525","41","86633198"
"chr2","34988569","34988766","chr5","121621682","121621881","33","86633113"
"chr2","35012783","35012910","chr3","113215459","113215581","24","78202676"
"chr2","35013378","35013454","chr5","121643612","121643688","7","86630234"
"chr2","35015777","35016039","chr21","33028091","33028356","60","1987686"
"chr2","35029032","35029117","chr4","140522276","140522358","19","105493244"
"chr2","35040541","35040728","chr5","121669068","121669262","24","86628527"
"chr2","35042837","35043105","chr7","1505895","1506160","56","33536942"
"chr2","35062134","35062432","chr5","121688450","121688751","35","86626316"
"chr2","35083866","35084109","chr10","29433835","29434077","70","5650031"
"chr2","35098553","35098683","chr7","26158438","26158564","28","8940115"
"chr2","35104207","35104522","chr5","121730489","121730800","56","86626282"
"chr2","35112622","35112839","chr12","19205060","19205283","59","15907562"
"chr2","35131269","35131567","chr12","65857390","65857691","56","30726121"
"chr2","35132660","35132920","chr5","121757984","121758270","58","86625324"
"chr2","35157091","35157252","chr9","99519533","99519696","40","64362442"
"chr2","35174151","35174465","chr20","50806482","50806789","72","15632331"
"chr2","35178315","35178557","chr5","121800614","121800894","68","86622299"
"chr2","35190843","35190975","chr4","99244189","99244326","35","64053346"
"chr2","35209238","35209524","chr5","121830045","121830351","58","86620807"
"chr2","35278246","35278378","chr5","121907407","121907528","20","86629161"
"chr2","35288217","35288504","chr5","121918017","121918308","48","86629800"
"chr2","35291833","35291992","chr20","43332910","43333066","42","8041077"
"chr2","35311944","35312103","chr14","72724722","72724884","43","37412778"
"chr2","35320334","35320599","chr2A","96679327","96679587","61","61358993"
"chr2","35386932","35387241","chr20","729693","730003","62","34657239"
"chr2","35415698","35415980","chr5","122036050","122036327","43","86620352"
"chr2","35437016","35437305","chr4","151944849","151945132","68","116507833"
"chr2","35489317","35489556","chr5","144078498","144078733","62","108589181"
"chr2","35528569","35528844","chr5","122146999","122147258","46","86618430"
"chr2","35533757","35534032","chr5","122146999","122147258","46","86613242"
"chr2","35548620","35548911","chr5","122160916","122161203","44","86612296"
"chr2","35573919","35574042","chr1","16767798","16767921","22","18806121"
"chr2","35580675","35580856","chr5","97346864","97347036","38","61766189"
"chr2","35580896","35581018","chr10","89586333","89586448","29","54005437"
"chr2","35591290","35591403","chr11","55532017","55532133","21","19940727"
"chr2","35598197","35598322","chr5","122233960","122234093","20","86635763"
"chr2","35599518","35599634","chr6","38593130","38593246","19","2993612"
"chr2","35624673","35624948","chr5","122263222","122263525","59","86638549"
"chr2","35632387","35632621","chr17","7785586","7785814","72","27846801"
"chr2","35638742","35638907","chr15","40738239","40738406","37","5099497"
"chr2","35674558","35674861","chr5","122318277","122318574","43","86643719"
"chr2","35698943","35699116","chr7","2282512","2282679","45","33416431"
"chr2","35726947","35727263","chr5","122366721","122367033","45","86639774"
"chr2","35728410","35728528","chr5","122367885","122368002","13","86639475"
"chr2","35774406","35774672","chr11","3656147","3656406","74","32118259"
"chr2","35780709","35780972","chr5","122419080","122419338","48","86638371"
"chr2","35875711","35875997","chr11","47728330","47728629","62","11852619"
"chr2","35882639","35882759","chr5","122520498","122520618","6","86637859"
"chr2","35884180","35884305","chr1","54804667","54804793","17","18920487"
"chr2","35904216","35904391","chr7","79723256","79723431","38","43819040"
"chr2","35905111","35905230","chr8","25705853","25705966","30","10199258"
"chr2","35922118","35922402","chr5","122556075","122556376","68","86633957"
"chr2","35949980","35950087","chr6","154239364","154239482","31","118289384"
"chr2","35967150","35967445","chr5","122598404","122598697","59","86631254"
"chr2","36005490","36005721","chr5","122634749","122634988","45","86629259"
"chr2","36016684","36016957","chr5","122646080","122646377","51","86629396"
"chr2","36022012","36022265","chr15","23758421","23758667","65","12263591"
"chr2","36045721","36046018","chr5","122706730","122707035","37","86661009"
"chr2","36058238","36058535","chr5","122718458","122718764","29","86660220"
"chr2","36063498","36063785","chr5","122722859","122723142","35","86659361"
"chr2","36090750","36091043","chr5","122747174","122747505","63","86656424"
"chr2","36091199","36091309","chr5","122747650","122747760","10","86656451"
"chr2","36091414","36091530","chr2A","10416670","10416787","18","25674744"
"chr2","36107286","36107506","chr5","122762759","122762972","29","86655473"
"chr2","36212579","36212709","chr14","10258854","10258979","24","25953725"
"chr2","36318415","36318716","chr4","48603524","48603825","64","12285109"
"chr2","36345807","36346085","chr5","122983011","122983295","53","86637204"
"chr2","36416399","36416548","chr19","37034098","37034257","37","617699"
"chr2","36427006","36427200","chr5","123088456","123088651","33","86661450"
"chr2","36455926","36456238","chr5","123109220","123109508","52","86653294"
"chr2","36465817","36466094","chr2B","78096607","78096892","61","41630790"
"chr2","36482962","36483256","chr5","123129183","123129475","36","86646221"
"chr2","36501606","36501914","chr5","123146076","123146373","46","86644470"
"chr2","36505542","36505843","chr14","38466723","38467018","60","1961181"
"chr2","36591097","36591236","chr1","209023025","209023155","30","172431928"
"chr2","36635247","36635545","chr5","123276534","123276838","53","86641287"
"chr2","36658327","36658595","chr5","123298708","123298971","23","86640381"
"chr2","36703316","36703620","chr5","123343657","123343968","40","86640341"
"chr2","36763852","36763963","chr4","153106200","153106312","13","116342348"
"chr2","36889106","36889395","chr5","123522138","123522424","28","86633032"
"chr2","36971286","36971578","chr5","123610162","123610480","50","86638876"
"chr2","37075394","37075507","chr5","123707224","123707337","9","86631830"
"chr2","37080637","37080922","chr5","123713502","123713808","48","86632865"
"chr2","37123980","37124279","chr1","92607449","92607742","62","55483469"
"chr2","37167707","37167992","chr1","207123303","207123589","68","169955596"
"chr2","37172787","37173088","chr5","123790028","123790333","40","86617241"
"chr2","37212704","37212882","chr9","53594947","53595140","54","16382243"
"chr2","37225624","37225750","chr5","123840387","123840512","16","86614763"
"chr2","37230593","37230860","chr5","123846888","123847162","37","86616295"
"chr2","37261857","37262029","chr5","32602465","32602640","45","4659392"
"chr2","37266132","37266302","chr21","24720942","24721101","35","12545190"
"chr2","37285782","37286058","chr5","118021477","118021751","68","80735695"
"chr2","37287335","37287655","chr1","111746820","111747135","74","74459485"
"chr2","37290395","37290564","chr14","75665234","75665401","38","38374839"
"chr2","37317234","37317516","chr8","125625271","125625551","77","88308037"
"chr2","37325514","37325808","chr5","23931488","23931783","56","13394026"
"chr2","37328851","37329153","chrX","46819208","46819495","76","9490357"
"chr2","37351873","37351943","chr5","123976410","123976480","13","86624537"
"chr2","37352163","37352305","chr14","52842638","52842775","39","15490475"
"chr2","37354336","37354533","chr5","123978972","123979172","29","86624636"
"chr2","37360929","37361236","chr5","123991446","123991755","42","86630517"
"chr2","37395003","37395078","chr5","124022935","124023011","6","86627932"
"chr2","37406172","37406283","chr5","124033669","124033784","10","86627497"
"chr2","37415034","37415423","chr6","16333500","16333852","120","21081534"
"chr2","37415905","37416196","chr4","151944849","151945132","61","114528944"
"chr2","37441267","37441555","chr4","12932886","12933177","54","24508381"
"chr2","37563474","37563635","chr6","5317435","5317603","49","32246039"
"chr2","37571361","37571561","chr5","124192533","124192731","33","86621172"
"chr2","37590894","37591012","chr5","124211955","124212077","17","86621061"
"chr2","37604923","37605038","chr5","124233457","124233577","20","86628534"
"chr2","37620298","37620417","chrX","95494066","95494189","26","57873768"
"chr2","37677579","37677755","chr6","36413281","36413458","47","1264298"
"chr2","37737747","37737972","chr7","44645393","44645629","64","6907646"
"chr2","37740610","37740734","chr13","9559854","9559959","42","28180756"
"chr2","37751660","37751966","chr5","124375420","124375733","47","86623760"
"chr2","37775237","37775349","chr5","124397453","124397565","11","86622216"
"chr2","37775494","37775641","chr8","113150725","113150860","37","75375231"
"chr2","37780145","37780270","chr5","124402405","124402530","11","86622260"
"chr2","37788533","37788764","chr5","124411253","124411491","33","86622720"
"chr2","37897741","37897948","chr1","114576431","114576639","44","76678690"
"chr2","37926182","37926290","chr5","124537219","124537329","20","86611037"
"chr2","37926730","37926903","chr1","45967100","45967270","39","8040370"
"chr2","37938816","37938939","chr5","124550249","124550372","6","86611433"
"chr2","37974667","37974937","chr5","124585450","124585735","40","86610783"
"chr2","37997220","37997299","chr5","124605677","124605751","17","86608457"
"chr2","38000072","38000172","chr14","77111840","77111940","21","39111768"
"chr2","38009470","38009583","chr9","13555565","13555673","18","24453905"
"chr2","38009690","38009843","chr10","112563918","112564071","27","74554228"
"chr2","38011772","38011864","chr1","12177184","12177264","28","25834588"
"chr2","38043556","38043857","chr5","124646927","124647211","41","86603371"
"chr2","38049181","38049465","chr5","124655382","124655664","36","86606201"
"chr2","38157545","38157669","chr12","70933341","70933463","19","32775796"
"chr2","38256753","38256988","chr4","71665586","71665814","47","33408833"
"chr2","38266126","38266255","chr1","39740505","39740640","28","1474379"
"chr2","38336642","38336773","chr7","56839310","56839440","30","18502668"
"chr2","38340232","38340533","chr5","124918049","124918335","72","86577817"
"chr2","38369136","38369373","chr5","124946771","124947011","29","86577635"
"chr2","38374655","38374923","chr5","124953488","124953738","52","86578833"
"chr2","38417537","38417831","chr7","6247668","6247965","52","32169869"
"chr2","38423893","38424185","chr5","125006048","125006347","39","86582155"
"chr2","38430016","38430316","chr5","125012060","125012379","46","86582044"
"chr2","38464800","38465072","chr5","153806977","153807253","61","115342177"
"chr2","38491893","38492104","chr3","45233841","45234045","49","6741948"
"chr2","38498073","38498372","chr5","125073615","125073911","68","86575542"
"chr2","38499694","38499807","chr1","163723566","163723682","19","125223872"
"chr2","38500002","38500155","chr14","48531182","48531343","38","10031180"
"chr2","38574591","38574757","chr5","62885644","62885808","31","24311053"
"chr2","38604737","38605028","chr5","125187577","125187868","38","86582840"
"chr2","38770181","38770492","chr5","125341379","125341682","53","86571198"
"chr2","38793793","38794081","chr5","125363682","125363987","49","86569889"
"chr2","38898195","38898356","chr7","65066683","65066847","29","26168488"
"chr2","38967218","38967505","chr5","125523460","125523742","28","86556242"
"chr2","38967549","38967711","chr12","122117318","122117466","40","83149769"
"chr2","38978454","38978728","chr15","22785351","22785638","70","16193103"
"chr2","38990764","38991067","chr5","125544648","125544976","62","86553884"
"chr2","38997518","38997804","chr5","125550984","125551273","47","86553466"
"chr2","39027026","39027106","chrX","411658","411734","23","38615368"
"chr2","39027832","39027973","chr20","24234554","24234683","34","14793278"
"chr2","39050862","39051150","chr5","125637320","125637623","50","86586458"
"chr2","39051759","39052046","chr5","125638286","125638594","63","86586527"
"chr2","39063942","39064059","chr14","45229440","45229558","27","6165498"
"chr2","39064852","39064969","chr14","45229440","45229558","24","6164588"
"chr2","39086327","39086633","chr5","125674479","125674789","48","86588152"
"chr2","39095354","39095664","chr12","109584318","109584623","71","70488964"
"chr2","39117209","39117484","chr5","125708594","125708870","31","86591385"
"chr2","39167987","39168310","chr5","125758124","125758448","37","86590137"
"chr2","39188928","39189060","chr5","125778132","125778264","22","86589204"
"chr2","39232122","39232423","chr5","125824351","125824646","46","86592229"
"chr2","39233954","39234178","chr5","125826654","125826878","41","86592700"
"chr2","39252463","39252627","chr15","5372654","5372815","42","33879809"
"chr2","39303212","39303534","chr5","125891495","125891819","63","86588283"
"chr2","39367043","39367197","chr5","83899371","83899523","47","44532328"
"chr2","39368092","39368353","chr5","125955379","125955664","64","86587287"
"chr2","39403918","39404204","chr5","125987927","125988228","54","86584009"
"chr2","39465733","39466028","chr5","126045971","126046260","43","86580238"
"chr2","39636131","39636426","chr1","28044541","28044825","60","11591590"
"chr2","39686768","39687022","chr20","49617065","49617314","72","9930297"
"chr2","39748145","39748297","chr1","52325310","52325464","40","12577165"
"chr2","39791151","39791271","chr5","126356997","126357123","22","86565846"
"chr2","39798883","39799007","chr4","151890631","151890748","26","112091748"
"chr2","39808702","39808968","chr5","126374457","126374723","26","86565755"
"chr2","39983716","39984026","chr2A","41973375","41973685","64","1989659"
"chr2","40017397","40017716","chr5","129500126","129500434","77","89482729"
"chr2","40039962","40040045","chr5","126607895","126607978","8","86567933"
"chr2","40104757","40105055","chr5","126666053","126666341","68","86561296"
"chr2","40192205","40192512","chr5","126751039","126751343","52","86558834"
"chr2","40205162","40205240","chr4","82318431","82318510","14","42113269"
"chr2","40314784","40315055","chr5","51674902","51675165","73","11360118"
"chr2","40355414","40355682","chr5","126903718","126903997","43","86548304"
"chr2","40396921","40397040","chr16","37103044","37103155","36","3293877"
"chr2","40418535","40418824","chr5","126968744","126969039","34","86550209"
"chr2","40481814","40482114","chr5","127032566","127032870","39","86550752"
"chr2","40496741","40496864","chr5","127050081","127050204","7","86553340"
"chr2","40513038","40513120","chr5","127064053","127064135","9","86551015"
"chr2","40628488","40628632","chr4","94320345","94320488","32","53691857"
"chr2","40703158","40703430","chr5","127248778","127249058","47","86545620"
"chr2","40843641","40843946","chr5","127366847","127367153","27","86523206"
"chr2","40865061","40865177","chr5","127384740","127384856","16","86519679"
"chr2","41041956","41042252","chr5","127550523","127550822","31","86508567"
"chr2","41255000","41255323","chr5","127759094","127759395","75","86504094"
"chr2","41291653","41291960","chr5","127794738","127795041","38","86503085"
"chr2","41528856","41528977","chr10","116118501","116118622","25","74589645"
"chr2","41804693","41804942","chr8","95744432","95744688","69","53939739"
"chr2","41881877","41882181","chr5","128360129","128360445","64","86478252"
"chr2","41928576","41928769","chr6","26570902","26571102","61","15357674"
"chr2","41971813","41972062","chr1","43292210","43292456","64","1320397"
"chr2","42080833","42081084","chr5","128553938","128554204","40","86473105"
"chr2","42136497","42136791","chr5","128619880","128620155","55","86483383"
"chr2","42142481","42142800","chr5","128624494","128624805","50","86482013"
"chr2","42146636","42146753","chr5","156968572","156968689","17","114821936"
"chr2","42321703","42322022","chr5","128797013","128797323","46","86475310"
"chr2","42409065","42409346","chr5","128890788","128891076","52","86481723"
"chr2","42538778","42538877","chr19","16749128","16749228","19","25789650"
"chr2","42844022","42844318","chr5","129299932","129300224","29","86455910"
"chr2","42879692","42879831","chr3","200924257","200924376","46","158044565"
"chr2","42898178","42898302","chr5","41673794","41673918","22","1224384"
"chr2","42921282","42921552","chr9","14642736","14642998","67","28278546"
"chr2","42953910","42954226","chr5","129411008","129411299","67","86457098"
"chr2","42990624","42990889","chr8","42194748","42195024","65","795876"
"chr2","43045435","43045758","chr5","129471144","129471448","53","86425709"
"chr2","43114342","43114520","chr5","129529187","129529341","43","86414845"
"chr2","43123641","43123817","chr3","72124181","72124360","36","29000540"
"chr2","43219107","43219353","chr16","28040060","28040316","61","15179047"
"chr2","43271000","43271298","chr2A","96407502","96407796","55","53136502"
"chr2","43311356","43311472","chr5","129709315","129709437","14","86397959"
"chr2","43312612","43312896","chr6","28225288","28225554","64","15087324"
"chr2","43349191","43349305","chr18","74651723","74651838","15","31302532"
"chr2","43368935","43369227","chr7","76146308","76146602","60","32777373"
"chr2","43370924","43371203","chr13","12146318","12146602","50","31224606"
"chr2","43402585","43402691","chr15","46133130","46133239","24","2730545"
"chr2","43412327","43412637","chr5","129799231","129799550","52","86386904"
"chr2","43428239","43428554","chr5","129815473","129815762","63","86387234"
"chr2","43451349","43451646","chr5","7517732","7518038","69","35933617"
"chr2","43503585","43503771","chr1","184720130","184720300","47","141216545"
"chr2","43552861","43553025","chr3","102655720","102655891","37","59102859"
"chr2","43556700","43557004","chr5","129949576","129949871","39","86392876"
"chr2","43585153","43585321","chr5","129975200","129975392","41","86390047"
"chr2","43625370","43625560","chr4","162630929","162631119","49","119005559"
"chr2","43664038","43664319","chr5","130051602","130051888","45","86387564"
"chr2","43674804","43675071","chr5","130062257","130062543","64","86387453"
"chr2","43687258","43687535","chr5","130075535","130075825","46","86388277"
"chr2","43698494","43698762","chr14","65806712","65806990","82","22108218"
"chr2","43703312","43703631","chr5","130091913","130092234","48","86388601"
"chr2","43973568","43973847","chr5","130371498","130371777","30","86397930"
"chr2","43979054","43979280","chr5","7234798","7235025","40","36744256"
"chr2","44029619","44029890","chr7","72763654","72763933","63","28734035"
"chr2","44116454","44116597","chr10","59274803","59274933","33","15158349"
"chr2","44337937","44338009","chr10","27743515","27743588","18","16594422"
"chr2","44430884","44431195","chr5","130819224","130819541","41","86388340"
"chr2","44511353","44511661","chr5","130918564","130918894","53","86407211"
"chr2","44512913","44513219","chr5","130925432","130925741","49","86412519"
"chr2","44759393","44759674","chr9","34086046","34086328","71","10673347"
"chr2","44761276","44761538","chr5","131148306","131148583","55","86387030"
"chr2","44948974","44949265","chr1","32492113","32492407","57","12456861"
"chr2","45038496","45038781","chr5","131405725","131406014","45","86367229"
"chr2","45162096","45162381","chr5","131529292","131529597","51","86367196"
"chr2","45254124","45254237","chr1","183791729","183791842","25","138537605"
"chr2","45424966","45425233","chr5","131741920","131742196","31","86316954"
"chr2","45467903","45468025","chr5","131812240","131812366","11","86344337"
"chr2","45489118","45489212","chr1","225199355","225199447","21","179710237"
"chr2","45557903","45558018","chr11","47126899","47127015","18","1568996"
"chr2","45562317","45562447","chr7","64785908","64786052","31","19223591"
"chr2","45803965","45804223","chr5","132015778","132016033","30","86211813"
"chr2","45918078","45918345","chr5","132132118","132132410","63","86214040"
"chr2","46180808","46181058","chr5","132444766","132445017","46","86263958"
"chr2","46191259","46191548","chr5","132455588","132455884","38","86264329"
"chr2","46312785","46313030","chr5","132587747","132588022","52","86274962"
"chr2","46350264","46350420","chr5","132635678","132635820","30","86285414"
"chr2","46511603","46511871","chr18","20332403","20332673","61","26179200"
"chr2","46681971","46682283","chr5","132950065","132950377","45","86268094"
"chr2","46727405","46727694","chr5","132995340","132995637","36","86267935"
"chr2","46848426","46848526","chr12","35988727","35988830","22","10859699"
"chr2","46944354","46944662","chr9","116247341","116247634","90","69302987"
"chr2","47024306","47024570","chr5","133276071","133276330","36","86251765"
"chr2","47104298","47104434","chr10","23966464","23966591","30","23137834"
"chr2","47108036","47108308","chr5","133349443","133349724","46","86241407"
"chr2","47120192","47120362","chr4","190209315","190209476","43","143089123"
"chr2","47146723","47147007","chr5","133386436","133386738","66","86239713"
"chr2","47148602","47148897","chr5","133387995","133388280","45","86239393"
"chr2","47168609","47168796","chr5","133410378","133410566","16","86241769"
"chr2","47178048","47178337","chr13","12122949","12123227","71","35055099"
"chr2","47218303","47218542","chr5","133461759","133462004","30","86243456"
"chr2","47265370","47265646","chr4","181849875","181850132","76","134584505"
"chr2","47276969","47277263","chr5","133519729","133520044","53","86242760"
"chr2","47308145","47308440","chr5","133549449","133549761","51","86241304"
"chr2","47313389","47313687","chr5","133554587","133554887","25","86241198"
"chr2","47321391","47321638","chr5","133560951","133561198","29","86239560"
"chr2","47328754","47328897","chr2B","94897282","94897419","36","47568528"
"chr2","47340795","47340969","chrX","119758170","119758333","36","72417375"
"chr2","47342894","47343180","chr4","105640836","105641122","61","58297942"
"chr2","47343432","47343728","chr5","133582595","133582887","38","86239163"
"chr2","47360727","47360836","chr10","12475418","12475526","18","34885309"
"chr2","47371491","47371583","chr10","117533278","117533373","19","70161787"
"chr2","47372704","47372828","chr20","30238448","30238572","14","17134256"
"chr2","47385323","47385448","chr16","59134844","59134968","18","11749521"
"chr2","47386686","47386995","chr6","113656859","113657163","68","66270173"
"chr2","47403813","47403968","chr1","205957994","205958155","34","158554181"
"chr2","47409712","47409999","chr5","133647855","133648154","54","86238143"
"chr2","47410882","47411194","chr16","4290823","4291132","67","43120059"
"chr2","47436164","47436468","chr5","133676260","133676553","45","86240096"
"chr2","47481727","47482028","chr5","133723033","133723314","45","86241306"
"chr2","47510393","47510694","chr5","133749186","133749501","54","86238793"
"chr2","47608058","47608225","chr15","5454904","5455056","40","42153154"
"chr2","47733647","47733926","chr8","21918475","21918757","57","25815172"
"chr2","47750945","47751093","chr22","8436942","8437088","23","39314003"
"chr2","47820353","47820538","chr6","36413281","36413458","47","11407072"
"chr2","47889787","47890086","chr5","134110706","134111016","53","86220919"
"chr2","47899121","47899427","chr20","30201399","30201697","67","17697722"
"chr2","47924838","47925138","chr1","159721369","159721668","72","111796531"
"chr2","47961314","47961437","chr9","83471002","83471125","20","35509688"
"chr2","47961661","47961826","chrX","130137391","130137550","39","82175730"
"chr2","47991044","47991334","chr3","34465261","34465539","73","13525783"
"chr2","48003069","48003378","chr5","134211720","134212005","54","86208651"
"chr2","48017487","48017767","chr7","129446111","129446395","61","81428624"
"chr2","48047198","48047487","chr5","134255900","134256190","44","86208702"
"chr2","48052495","48052637","chr3","267312","267456","30","47785183"
"chr2","48084930","48085143","chr19","18271347","18271565","49","29813583"
"chr2","48177596","48177696","chr9","75915145","75915233","23","27737549"
"chr2","48185127","48185194","chr3","75070680","75070747","12","26885553"
"chr2","48185242","48185341","chr18","48326419","48326520","23","141177"
"chr2","48225976","48226162","chr8","98909960","98910147","35","50683984"
"chr2","48285594","48285881","chr5","134499432","134499729","44","86213838"
"chr2","48324196","48324480","chr1","54994232","54994533","84","6670036"
"chr2","48331246","48331530","chr7","64975179","64975466","37","16643933"
"chr2","48337653","48337950","chrX","103549996","103550279","71","55212343"
"chr2","48342234","48342529","chr6","139104542","139104842","64","90762308"
"chr2","48347343","48347600","chr7","64959965","64960227","28","16612622"
"chr2","48409365","48409655","chrX","115407272","115407563","67","66997907"
"chr2","48557411","48557687","chr5","134745992","134746282","61","86188581"
"chr2","48561110","48561385","chr5","134748691","134748960","37","86187581"
"chr2","48668001","48668118","chr5","134872775","134872891","13","86204774"
"chr2","48680236","48680300","chr12","1071420","1071483","15","47608816"
"chr2","48695229","48695469","chr4","81280041","81280287","72","32584812"
"chr2","48703858","48704138","chr9","11981454","11981735","61","36722404"
"chr2","48708248","48708545","chr5","122175905","122176210","64","73467657"
"chr2","48715238","48715538","chr9","12868576","12868873","76","35846662"
"chr2","48719981","48720264","chr7","64975179","64975466","38","16255198"
"chr2","48734388","48734651","chr5","134933079","134933372","66","86198691"
"chr2","48735783","48736090","chr14","75061283","75061585","63","26325500"
"chr2","48774636","48774842","chr5","134965817","134966028","34","86191181"
"chr2","48814319","48814606","chr5","135002016","135002302","33","86187697"
"chr2","48846091","48846388","chr20","30733949","30734249","60","18112142"
"chr2","48883680","48883963","chr6","154019996","154020283","59","105136316"
"chr2","48893881","48894193","chr5","135072482","135072789","39","86178601"
"chr2","48901918","48902227","chr5","135078734","135079042","40","86176816"
"chr2","48939954","48940151","chr12","133024874","133025071","51","84084920"
"chr2","48993168","48993406","chr12","35202861","35203112","61","13790307"
"chr2","49058972","49059257","chr5","135162562","135162854","52","86103590"
"chr2","49198270","49198439","chr5","135294687","135294849","31","86096417"
"chr2","49231304","49231590","chr5","135327295","135327606","51","86095991"
"chr2","49258268","49258383","chr10","93040219","93040335","18","43781951"
"chr2","49282742","49282865","chr1","16767798","16767921","26","32514944"
"chr2","49283382","49283541","chr4","40325999","40326159","28","8957383"
"chr2","49286251","49286410","chr1","69180790","69180952","33","19894539"
"chr2","49310010","49310319","chr8","133074473","133074771","45","83764463"
"chr2","49320216","49320470","chr10","139830648","139830887","55","90510432"
"chr2","49326424","49326606","chr4","112683460","112683629","43","63357036"
"chr2","49327671","49327883","chr4","40096448","40096655","37","9231223"
"chr2","49331616","49331890","chr19","7535412","7535680","41","41796204"
"chr2","49333106","49333383","chr17","78401865","78402148","58","29068759"
"chr2","49335914","49336232","chr1","181256651","181256946","70","131920737"
"chr2","49336326","49336608","chr19","7528877","7529174","45","41807449"
"chr2","49355206","49355498","chr19","7512809","7513099","29","41842397"
"chr2","49356554","49356713","chr21","37457419","37457581","34","11899135"
"chr2","49361908","49362042","chr5","45910561","45910692","29","3451347"
"chr2","49402234","49402347","chr4","34521070","34521186","22","14881164"
"chr2","49430919","49431203","chr5","135463237","135463516","48","86032318"
"chr2","49441200","49441362","chr9","108232885","108233040","41","58791685"
"chr2","49441833","49441944","chr7","33303948","33304057","31","16137885"
"chr2","49444969","49445272","chr5","135477702","135478009","44","86032733"
"chr2","49471493","49471789","chr10","118474409","118474715","70","69002916"
"chr2","49484760","49484932","chr18","17744589","17744753","39","31740171"
"chr2","49484967","49485025","chr1","46905561","46905614","13","2579406"
"chr2","49498258","49498546","chr5","135545424","135545712","34","86047166"
"chr2","49524046","49524179","chr5","135570972","135571104","16","86046926"
"chr2","49581973","49582254","chr5","135621858","135622135","29","86039885"
"chr2","49654315","49654442","chr5","135682718","135682845","15","86028403"
"chr2","49711822","49712109","chr5","135745349","135745638","43","86033527"
"chr2","49797829","49797916","chr2B","74186352","74186439","8","24388523"
"chr2","49895642","49895883","chr5","135907075","135907333","50","86011433"
"chr2","50210803","50211100","chr5","136217143","136217439","37","86006340"
"chr2","50216958","50217062","chr13","9559854","9559959","15","40657104"
"chr2","50307230","50307373","chr22","15246103","15246254","38","35061127"
"chr2","50326724","50327017","chr5","136334063","136334336","53","86007339"
"chr2","50633701","50633956","chr10","85764392","85764649","59","35130691"
"chr2","50979477","50979765","chr5","136925286","136925581","57","85945809"
"chr2","51087570","51087857","chr5","77703498","77703786","63","26615928"
"chr2","51213905","51214152","chr5","137171834","137172081","25","85957929"
"chr2","51351742","51351865","chr5","137305960","137306084","9","85954218"
"chr2","51382935","51383240","chr5","137336034","137336343","44","85953099"
"chr2","51438506","51438623","chr11","122983640","122983757","19","71545134"
"chr2","51438630","51438708","chr1","224822809","224822879","22","173384179"
"chr2","51590893","51591029","chr9","47369076","47369207","27","4221817"
"chr2","51902161","51902335","chr7","66848548","66848722","45","14946387"
"chr2","51970387","51970508","chr5","137794963","137795091","16","85824576"
"chr2","51986650","51986932","chr5","137812937","137813203","53","85826287"
"chr2","52042699","52042988","chr5","137870104","137870413","57","85827405"
"chr2","52086103","52086263","chr1","44864963","44865126","37","7221140"
"chr2","52137964","52138124","chr6","141835904","141836066","39","89697940"
"chr2","52138458","52138787","chr5","137957138","137957458","43","85818680"
"chr2","52194538","52194661","chr5","138014491","138014614","9","85819953"
"chr2","52213900","52214203","chr5","138036788","138037071","52","85822888"
"chr2","52216179","52216296","chrX","115325701","115325818","19","63109522"
"chr2","52227330","52227536","chr19","50710233","50710443","42","1517097"
"chr2","52230869","52231171","chr5","138054347","138054661","38","85823478"
"chr2","52242388","52242688","chr5","53582716","53583015","71","1340328"
"chr2","52307363","52307658","chr5","138118543","138118834","34","85811180"
"chr2","52352292","52352581","chr5","138164195","138164484","31","85811903"
"chr2","52381814","52382107","chr5","138192501","138192788","36","85810687"
"chr2","52397195","52397477","chr5","102241438","102241724","54","49844243"
"chr2","52446685","52446999","chr5","138269303","138269617","33","85822618"
"chr2","52513697","52513909","chrUn_CABD030132010v1","2950","3162","47","52510747"
"chr2","52514034","52514340","chr5","138326534","138326850","40","85812500"
"chr2","52544052","52544290","chr5","98682121","98682358","71","46138069"
"chr2","52566424","52566580","chr15","69740012","69740164","42","17173588"
"chr2","52578124","52578207","chr18","2291137","2291219","22","50286987"
"chr2","52611061","52611262","chr18","55236793","55236976","48","2625732"
"chr2","52621041","52621314","chr7","2959934","2960208","58","49661107"
"chr2","52642930","52643046","chr15","28873131","28873248","25","23769799"
"chr2","52650734","52651045","chr5","138457628","138457943","51","85806894"
"chr2","52654327","52654519","chr5","138461203","138461409","31","85806876"
"chr2","52660996","52661302","chr2A","15907459","15907755","44","36753537"
"chr2","52677192","52677487","chr5","138481804","138482101","34","85804612"
"chr2","52680584","52680868","chr7","66246986","66247273","60","13566402"
"chr2","52703455","52703578","chr5","138503463","138503586","8","85800008"
"chr2","52703806","52703919","chr5","138503811","138503927","25","85800005"
"chr2","52708585","52708852","chr5","138512524","138512798","45","85803939"
"chr2","52714022","52714153","chr5","138517874","138518014","27","85803852"
"chr2","52762811","52763093","chr8","25517714","25517991","64","27245097"
"chr2","52786262","52786509","chr15","51058541","51058785","67","1727721"
"chr2","52789033","52789309","chr5","138604334","138604596","50","85815301"
"chr2","52795710","52796023","chr5","138608099","138608405","59","85812389"
"chr2","52807414","52807528","chr2A","10416670","10416787","18","42390744"
"chr2","52810694","52810835","chr5","138625163","138625322","39","85814469"
"chr2","52812265","52812552","chr5","138626670","138626960","48","85814405"
"chr2","52817272","52817567","chr5","138631246","138631551","55","85813974"
"chr2","52821582","52821641","chr1","33883628","33883686","14","18937954"
"chr2","52839280","52839394","chr1","157737408","157737505","31","104898128"
"chr2","52851161","52851459","chr4","94010013","94010316","61","41158852"
"chr2","52851506","52851795","chr15","23614412","23614711","55","29237094"
"chr2","52870927","52871217","chrX","133536215","133536510","68","80665288"
"chr2","52874901","52875130","chr5","138691341","138691578","34","85816440"
"chr2","52878120","52878284","chr12","117952092","117952251","35","65073972"
"chr2","52881090","52881395","chr5","138697443","138697750","41","85816353"
"chr2","52892450","52892727","chr5","138708775","138709077","52","85816325"
"chr2","52906631","52906916","chr5","138723887","138724141","59","85817256"
"chr2","52909677","52909793","chr6","161684019","161684134","15","108774342"
"chr2","52921456","52921736","chr3","38496509","38496806","70","14424947"
"chr2","52924941","52925209","chr5","138742544","138742840","52","85817603"
"chr2","52976886","52977142","chr5","138770072","138770330","25","85793186"
"chr2","53003372","53003553","chr5","138802718","138802911","32","85799346"
"chr2","53189521","53189649","chr7","26158438","26158564","37","27031083"
"chr2","53263228","53263519","chr5","139038611","139038910","36","85775383"
"chr2","53328777","53329082","chr5","139103793","139104126","52","85775016"
"chr2","53356011","53356245","chr7","64790817","64791051","58","11434806"
"chr2","53549122","53549415","chr5","139309731","139310027","45","85760609"
"chr2","53670556","53670831","chr5","139426874","139427147","21","85756318"
"chr2","53673520","53673820","chr4","75152621","75152923","62","21479101"
"chr2","53684023","53684318","chr15","45983082","45983387","55","7700941"
"chr2","53831698","53831964","chr6","5743300","5743560","66","48088398"
"chr2","53901479","53901750","chr5","139625212","139625507","55","85723733"
"chr2","53941263","53941512","chr5","139669133","139669398","60","85727870"
"chr2","53941926","53942182","chr5","139669133","139669398","72","85727207"
"chr2","54043658","54043960","chr1","200389038","200389346","66","146345380"
"chr2","54043965","54044097","chrX","117998585","117998717","21","63954620"
"chr2","54162166","54162471","chr5","139848320","139848628","28","85686154"
"chr2","54260775","54261073","chr5","139951226","139951520","42","85690451"
"chr2","54362893","54363026","chr1","215271336","215271467","31","160908443"
"chr2","54367478","54367764","chr5","140053195","140053481","51","85685717"
"chr2","54416449","54416606","chr11","16757153","16757312","36","37659296"
"chr2","54488895","54489199","chr5","140178837","140179130","59","85689942"
"chr2","54606451","54606738","chr5","140306103","140306392","38","85699652"
"chr2","54635291","54635567","chr5","140340442","140340723","43","85705151"
"chr2","54776276","54776545","chr5","140470467","140470752","50","85694191"
"chr2","54914831","54915113","chr5","40059053","40059344","77","14855778"
"chr2","55005200","55005476","chrX","41989959","41990237","54","13015241"
"chr2","55012312","55012511","chr5","140653814","140654002","35","85641502"
"chr2","55025902","55026214","chr5","140667485","140667763","71","85641583"
"chr2","55049356","55049642","chr5","140689077","140689360","64","85639721"
"chr2","55050965","55051267","chr5","140690678","140690984","25","85639713"
"chr2","55121218","55121428","chr2A","42657171","42657380","41","12464047"
"chr2","55131165","55131279","chr8","32315073","32315184","25","22816092"
"chr2","55131297","55131389","chr14","41346776","41346870","26","13784521"
"chr2","55188603","55188702","chr3","51336754","51336851","19","3851849"
"chr2","55236238","55236495","chr10","89684007","89684263","56","34447769"
"chr2","55237227","55237351","chr10","144324605","144324728","20","89087378"
"chr2","55247691","55247944","chr10","22723191","22723461","72","32524500"
"chr2","55253520","55253637","chr9","93151090","93151202","21","37897570"
"chr2","55354492","55354762","chr7","2407454","2407706","47","52947038"
"chr2","55370715","55370998","chr20","34974014","34974292","55","20396701"
"chr2","55373541","55373673","chr5","124432264","124432393","21","69058723"
"chr2","55401999","55402310","chr19","34817747","34818053","51","20584252"
"chr2","55419548","55419831","chr7","2344192","2344462","51","53075356"
"chr2","55420922","55421182","chr4","26702666","26702913","52","28718256"
"chr2","55428787","55429045","chr3","174333930","174334189","53","118905143"
"chr2","55433253","55433519","chr7","2330840","2331092","31","53102413"
"chr2","55437669","55437844","chr5","1405612","1405782","41","54032057"
"chr2","55443888","55444168","chr7","2317175","2317443","37","53126713"
"chr2","55461340","55461638","chr5","33600599","33600900","68","21860741"
"chr2","55470071","55470184","chr4","110273813","110273922","23","54803742"
"chr2","55508501","55508604","chr9","32872423","32872525","27","22636078"
"chr2","55524748","55524872","chr15","52764054","52764186","34","2760694"
"chr2","55524961","55525140","chr7","2282512","2282679","34","53242449"
"chr2","55527191","55527263","chr5","17567425","17567501","15","37959766"
"chr2","55529732","55529844","chr1","22816031","22816147","29","32713701"
"chr2","55530434","55530553","chr3","65193379","65193500","16","9662945"
"chr2","55539495","55539693","chr7","2363764","2363952","42","53175731"
"chr2","55542930","55543212","chr4","6703003","6703295","66","48839927"
"chr2","55545265","55545387","chr5","79787865","79787982","28","24242600"
"chr2","55547003","55547294","chr22","13341637","13341938","64","42205366"
"chr2","55547855","55547928","chr14","75436417","75436490","14","19888562"
"chr2","55565035","55565219","chr7","6535199","6535380","34","49029836"
"chr2","55568765","55568852","chr1","9729337","9729420","17","45839428"
"chr2","55575341","55575493","chr1","22733138","22733296","34","32842203"
"chr2","55578278","55578471","chr1","5722040","5722227","44","49856238"
"chr2","55578606","55578700","chr6","110466889","110466990","23","54888283"
"chr2","55582074","55582381","chr7","79073505","79073807","64","23491431"
"chr2","55583522","55583644","chr7","2236178","2236303","16","53347344"
"chr2","55588911","55588956","chr1","2091491","2091535","15","53497420"
"chr2","55588982","55589220","chr10","124815838","124816064","54","69226856"
"chr2","55593412","55593717","chr7","2223741","2224038","45","53369671"
"chr2","55607730","55608019","chr2A","18986462","18986752","56","36621268"
"chr2","55635039","55635276","chr4","88765602","88765846","64","33130563"
"chr2","55642150","55642467","chr7","2174738","2175023","66","53467412"
"chr2","55643240","55643359","chr7","74643014","74643130","31","18999774"
"chr2","55648182","55648358","chr1","25357047","25357228","37","30291135"
"chr2","55666063","55666157","chr19","16749128","16749228","16","38916935"
"chr2","55710845","55711152","chr7","2116225","2116517","46","53594620"
"chr2","55733373","55733533","chr7","2100985","2101148","31","53632388"
"chr2","55877675","55877824","chr15","69740012","69740164","34","13862337"
"chr2","55984933","55985211","chr7","1847138","1847436","67","54137795"
"chr2","55990791","55991082","chr4","196591305","196591597","67","140600514"
"chr2","56006882","56007164","chr7","1826726","1827030","59","54180156"
"chr2","56021173","56021347","chr7","1810491","1810660","27","54210682"
"chr2","56076018","56076280","chr22","6811667","6811941","59","49264351"
"chr2","56120549","56120836","chr7","1708256","1708538","34","54412293"
"chr2","56123192","56123502","chr1","52583861","52584165","69","3539331"
"chr2","56132440","56132710","chr12","123570594","123570856","55","67438154"
"chr2","56139305","56139601","chr19","47768747","47769045","50","8370558"
"chr2","56140356","56140666","chr1","101170066","101170368","75","45029710"
"chr2","56200292","56200529","chr20","44761539","44761777","49","11438753"
"chr2","56202312","56202426","chr17","63212955","63213066","26","7010643"
"chr2","56211931","56212216","chr7","1615367","1615654","46","54596564"
"chr2","56215692","56215967","chr7","1611346","1611636","48","54604346"
"chr2","56217130","56217399","chr7","1609910","1610181","31","54607220"
"chr2","56237512","56237724","chr7","1590088","1590307","35","54647424"
"chr2","56241965","56242259","chr16","25226234","25226529","46","31015731"
"chr2","56242993","56243286","chr18","57431040","57431334","57","1188047"
"chr2","56252013","56252308","chr16","1924805","1925097","62","54327208"
"chr2","56273331","56273627","chr7","1546157","1546469","48","54727174"
"chr2","56316488","56316750","chr7","1505895","1506160","40","54810593"
"chr2","56318390","56318679","chr19","16313771","16314065","54","40004619"
"chr2","56319270","56319568","chr7","1503070","1503382","47","54816200"
"chr2","56327596","56327895","chr3","183634142","183634443","46","127306546"
"chr2","56331733","56332054","chrX","52207646","52207964","64","4124087"
"chr2","56344896","56344997","chr7","1480068","1480167","15","54864828"
"chr2","56374363","56374490","chr7","1456788","1456918","14","54917575"
"chr2","56380529","56380791","chr16","49181420","49181682","54","7199109"
"chr2","56383514","56383600","chr1","168221433","168221510","26","111837919"
"chr2","56390216","56390366","chr7","1441145","1441307","30","54949071"
"chr2","56397035","56397173","chr10","12650705","12650831","27","43746330"
"chr2","56401999","56402153","chr11","122766167","122766327","39","66364168"
"chr2","56446164","56446303","chr16","60028463","60028597","29","3582299"
"chr2","56477493","56477770","chr7","1353782","1354071","42","55123711"
"chr2","56481332","56481595","chr7","1350224","1350507","48","55131108"
"chr2","56504719","56505012","chr7","1333186","1333476","33","55171533"
"chr2","56507524","56507645","chr11","110265467","110265590","19","53757943"
"chr2","56507727","56507920","chr5","60713979","60714170","44","4206252"
"chr2","56527769","56527993","chr7","1313445","1313668","32","55214324"
"chr2","56536688","56536963","chr1","101702737","101703010","58","45166049"
"chr2","56537934","56538191","chr19","2464971","2465216","73","54072963"
"chr2","56543108","56543379","chr4","152323211","152323483","58","95780103"
"chr2","56560836","56561095","chr3","15155559","15155829","63","41405277"
"chr2","56564540","56564870","chr1","28013491","28013819","75","28551049"
"chr2","56581855","56582143","chr2A","51840898","51841187","60","4740957"
"chr2","56585617","56585920","chrX","71194736","71195040","66","14609119"
"chr2","56602985","56603252","chr7","1230204","1230488","48","55372781"
"chr2","56633525","56633815","chr4","2134462","2134746","62","54499063"
"chr2","56649432","56649695","chr7","1187943","1188204","43","55461489"
"chr2","56660053","56660269","chr2B","69781648","69781868","43","13121595"
"chr2","56706907","56707248","chr1","161737058","161737374","77","105030151"
"chr2","56726607","56726874","chr18","11328811","11329081","70","45397796"
"chr2","56730875","56731100","chr12","29993522","29993738","45","26737353"
"chr2","56751079","56751377","chr6","75486123","75486422","61","18735044"
"chr2","56761766","56761889","chr7","1091997","1092120","10","55669769"
"chr2","56769723","56769947","chr1","132570842","132571055","48","75801119"
"chr2","56772862","56773140","chr15","53039375","53039657","62","3733487"
"chr2","56781309","56781617","chr7","1069193","1069490","44","55712116"
"chr2","56781860","56782150","chr7","1068649","1068958","49","55713211"
"chr2","56784967","56785262","chr15","67073000","67073294","60","10288033"
"chr2","56787656","56787960","chr7","76523012","76523308","62","19735356"
"chr2","56799376","56799526","chr1","216102838","216102968","41","159303462"
"chr2","56800860","56801129","chr7","2470097","2470360","72","54330763"
"chr2","56883226","56883486","chr8","61880569","61880831","54","4997343"
"chr2","56897962","56898118","chr5","156787834","156787995","35","99889872"
"chr2","56912420","56912529","chr6","154239364","154239482","34","97326944"
"chr2","56930174","56930420","chr1","45699471","45699711","45","11230703"
"chr2","56948748","56949036","chr7","4258411","4258705","64","52690337"
"chr2","56951491","56951798","chr7","890981","891279","54","56060510"
"chr2","56983445","56983711","chr4","93446357","93446627","56","36462912"
"chr2","56986040","56986217","chr19","28770260","28770434","41","28215780"
"chr2","57002087","57002362","chr1","210738129","210738412","61","153736042"
"chr2","57089231","57089544","chr7","759789","760085","56","56329442"
"chr2","57100435","57100727","chr5","627876","628165","82","56472559"
"chr2","57100971","57101240","chr19","2413150","2413424","59","54687821"
"chr2","57108301","57108610","chr7","739220","739515","52","56369081"
"chr2","57114067","57114224","chr20","55353732","55353890","29","1760335"
"chr2","57127141","57127381","chr12","106838535","106838776","61","49711394"
"chr2","57159012","57159295","chr3","197997358","197997647","76","140838346"
"chr2","57159653","57159951","chr12","121932972","121933272","68","64773319"
"chr2","57161551","57161698","chr20","13392558","13392708","35","43768993"
"chr2","57196667","57196912","chr4","81280041","81280287","72","24083374"
"chr2","57199904","57200009","chrX","8958249","8958367","27","48241655"
"chr2","57346523","57346680","chr14","58946732","58946889","32","1600209"
"chr2","57348850","57349151","chr5","165163723","165164021","44","107814873"
"chr2","57362521","57362803","chr3","152949296","152949579","64","95586775"
"chr2","57389761","57389838","chr1","7559387","7559466","19","49830374"
"chr2","57400652","57400971","chr12","113177334","113177630","87","55776682"
"chr2","57428755","57428852","chr2B","16261383","16261481","22","41167372"
"chr2","57439460","57439707","chr7","630879","631139","46","56808581"
"chr2","57468857","57468938","chrX","15596602","15596685","16","41872255"
"chr2","57496141","57496434","chr7","566849","567129","47","56929292"
"chr2","57497682","57497950","chr7","565148","565435","68","56932534"
"chr2","57514982","57515276","chr11","30219574","30219871","56","27295408"
"chr2","57520358","57520680","chr7","541542","541858","42","56978816"
"chr2","57539464","57539769","chr7","525885","526186","40","57013579"
"chr2","57552193","57552478","chr7","516517","516799","38","57035676"
"chr2","57560432","57560564","chr1","54685417","54685547","32","2875015"
"chr2","57569144","57569429","chr7","496333","496629","54","57072811"
"chr2","57594760","57595084","chr7","472960","473279","54","57121800"
"chr2","57645263","57645528","chr7","422837","423065","58","57222426"
"chr2","57651889","57652180","chr12","68300782","68301077","61","10648893"
"chr2","57652401","57652667","chr7","415851","416125","45","57236550"
"chr2","57701558","57701864","chr7","138861353","138861665","61","81159795"
"chr2","57707095","57707395","chr16","49114092","49114378","77","8593003"
"chr2","58786978","58787105","chr9","47369076","47369207","24","11417902"
"chr2","58798990","58799117","chr9","47369076","47369207","24","11429914"
"chr2","58903550","58903680","chr5","38725528","38725658","20","20178022"
"chr2","58928213","58928491","chr5","164643807","164644102","46","105715594"
"chr2","58948366","58948484","chr5","164623320","164623450","23","105674954"
"chr2","58964987","58965296","chr5","164607765","164608078","36","105642778"
"chr2","58989510","58989737","chr5","164585755","164585998","48","105596245"
"chr2","58990721","58990893","chr7","2838990","2839180","49","56151731"
"chr2","59042647","59042884","chr12","35343544","35343773","55","23699103"
"chr2","59083967","59084258","chr5","163593590","163593881","60","104509623"
"chr2","59181803","59182064","chr5","35412908","35413166","66","23768895"
"chr2","59185666","59185926","chr7","78501300","78501572","55","19315634"
"chr2","59213087","59213246","chr1","162595581","162595737","35","103382494"
"chr2","59243270","59243436","chr5","163706316","163706482","15","104463046"
"chr2","59249932","59250057","chr5","163688784","163688915","18","104438852"
"chr2","59251308","59251674","chr3","195583731","195584055","110","136332423"
"chr2","59254154","59254451","chr10","41520862","41521151","69","17733292"
"chr2","59268110","59268238","chr5","163723326","163723457","18","104455216"
"chr2","59322941","59322995","chr2B","26931720","26931778","13","32391221"
"chr2","59340593","59340924","chr16","29800438","29800767","82","29540155"
"chr2","59376881","59377158","chr1","14744037","14744316","58","44632844"
"chr2","59399528","59399780","chr5","163833147","163833399","33","104433619"
"chr2","59402123","59402416","chr1","33080474","33080764","66","26321649"
"chr2","59540023","59540200","chr1","184720130","184720300","36","125180107"
"chr2","59560458","59560589","chr7","74790659","74790791","17","15230201"
"chr2","59606565","59606693","chr5","164033534","164033664","20","104426969"
"chr2","59660414","59660521","chr18","22807872","22807981","18","36852542"
"chr2","59664973","59665124","chr6","42223007","42223159","34","17441966"
"chr2","59675919","59676204","chr5","164101373","164101668","40","104425454"
"chr2","59724747","59725031","chr5","102241438","102241724","64","42516691"
"chr2","59728350","59728646","chr5","164145375","164145667","53","104417025"
"chr2","59754146","59754426","chr5","164158417","164158690","37","104404271"
"chr2","59832173","59832483","chr14","21291740","21292040","58","38540433"
"chr2","59885633","59885796","chr5","164265935","164266103","18","104380302"
"chr2","59906496","59906785","chr5","164285887","164286178","40","104379391"
"chr2","59952247","59952382","chr2A","53033809","53033953","38","6918438"
"chr2","59986008","59986132","chr7","129330579","129330704","17","69344571"
"chr2","60016416","60016678","chr8","85788206","85788483","79","25771790"
"chr2","60108637","60108754","chr5","52418630","52418747","19","7690007"
"chr2","60127540","60127855","chr1","48475572","48475878","74","11651968"
"chr2","60138818","60139068","chr4","106944926","106945168","63","46806108"
"chr2","60190637","60190764","chr9","47369076","47369207","24","12821561"
"chr2","60235362","60235636","chr12","91667609","91667873","64","31432247"
"chr2","60256279","60256412","chr4","40758424","40758547","41","19497855"
"chr2","60257833","60258105","chr5","116092903","116093174","66","55835070"
"chr2","60274737","60274855","chr3","17302178","17302302","22","42972559"
"chr2","60280962","60281240","chr5","163845492","163845764","56","103564530"
"chr2","60283735","60283946","chr4","195424098","195424294","63","135140363"
"chr2","60297030","60297101","chrX","69210771","69210843","16","8913741"
"chr2","60310918","60311213","chr5","165255694","165255963","58","104944776"
"chr2","60324360","60324458","chr5","165268683","165268788","22","104944323"
"chr2","60377765","60377873","chr1","39325820","39325928","24","21051945"
"chr2","60405799","60405989","chr4","23369414","23369615","45","37036385"
"chr2","60429583","60429811","chr6","110612092","110612302","58","50182509"
"chr2","60434428","60434724","chr5","165111514","165111805","39","104677086"
"chr2","60437403","60437522","chr6","158041844","158041964","21","97604441"
"chr2","60441835","60442131","chr6","31214889","31215180","65","29226946"
"chr2","60444502","60444798","chr5","165103313","165103583","59","104658811"
"chr2","60447475","60447607","chr5","165100447","165100576","15","104652972"
"chr2","60454993","60455208","chr5","165089147","165089373","39","104634154"
"chr2","60637175","60637340","chr14","72724722","72724884","37","12087547"
"chr2","60647001","60647219","chr3","146505008","146505225","61","85858007"
"chr2","60669940","60670021","chr2B","110194182","110194264","15","49524242"
"chr2","60673602","60673857","chr22","8311524","8311782","66","52362078"
"chr2","60675228","60675522","chr5","6001853","6002154","50","54673375"
"chr2","60696640","60696775","chr15","281768","281894","40","60414872"
"chr2","60699588","60699720","chrX","41696248","41696379","16","19003340"
"chr2","60722877","60723195","chr5","6041790","6042088","54","54681087"
"chr2","60738533","60738847","chr12","93203428","93203732","75","32464895"
"chr2","60760246","60760510","chr5","162904038","162904319","49","102143792"
"chr2","60852241","60852539","chr5","162976814","162977126","55","102124573"
"chr2","60859515","60859809","chr5","162984895","162985203","50","102125380"
"chr2","60909693","60909981","chr5","163043025","163043322","36","102133332"
"chr2","60928073","60928250","chr6","118855023","118855193","43","57926950"
"chr2","60966430","60966707","chr5","163098845","163099124","44","102132415"
"chr2","60990913","60991153","chr16","47158584","47158805","58","13832329"
"chr2","61074038","61074187","chr20","30759910","30760061","39","30314128"
"chr2","61086145","61086442","chr5","163232863","163233180","50","102146718"
"chr2","61141296","61141431","chr6","158178221","158178360","35","97036925"
"chr2","61201246","61201533","chr5","163348106","163348406","44","102146860"
"chr2","61203384","61203646","chr5","163350387","163350652","30","102147003"
"chr2","61272067","61272378","chr5","163416412","163416725","35","102144345"
"chr2","61377753","61378115","chr5","163529982","163530316","72","102152229"
"chr2","61385098","61385197","chr1","160301284","160301387","15","98916186"
"chr2","61397856","61398130","chr5","163553929","163554208","35","102156073"
"chr2","61404640","61404860","chr1","224121078","224121302","53","162716438"
"chr2","61431306","61431496","chr7","74619806","74619995","39","13188500"
"chr2","61435094","61435394","chr2B","53629601","53629902","56","7805493"
"chr2","61438012","61438316","chr7","64975179","64975466","56","3537167"
"chr2","61442356","61442654","chr12","1651377","1651661","73","59790979"
"chr2","61452872","61453129","chr7","64959965","64960227","26","3507093"
"chr2","61473664","61473948","chr1","54994232","54994533","84","6479432"
"chr2","61476632","61476919","chr5","24161497","24161793","39","37315135"
"chr2","61550222","61550504","chr7","45544878","45545162","63","16005344"
"chr2","61555221","61555524","chr7","76749610","76749901","49","15194389"
"chr2","61583098","61583228","chr7","64967493","64967624","21","3384395"
"chr2","61583734","61583854","chr7","57613918","57614035","21","3969816"
"chr2","61583895","61584040","chr7","57591750","57591905","43","3992145"
"chr2","61586884","61586983","chr7","65870834","65870931","27","4283950"
"chr2","61596061","61596175","chr22","7099064","7099184","19","54496997"
"chr2","61598800","61599105","chr12","43802996","43803296","66","17795804"
"chr2","61604259","61604546","chr7","63270230","63270515","41","1665971"
"chr2","61615796","61616098","chr5","161655668","161655944","56","100039872"
"chr2","61647851","61647982","chr5","161623549","161623680","12","99975698"
"chr2","61681843","61682150","chr5","161590629","161590930","33","99908786"
"chr2","61709380","61709668","chr5","161566012","161566320","55","99856632"
"chr2","61771462","61771624","chr1","14800532","14800692","51","46970930"
"chr2","61777423","61777627","chr5","161500583","161500780","41","99723160"
"chr2","61835405","61835651","chr7","139554502","139554732","56","77719097"
"chr2","61860159","61860399","chr17","54464786","54465039","74","7395373"
"chr2","61918323","61918513","chr7","67519721","67519924","54","5601398"
"chr2","61953334","61953621","chr5","161340674","161340949","44","99387340"
"chr2","61988454","61988751","chr7","138707841","138708122","65","76719387"
"chr2","61998030","61998275","chr5","161282918","161283156","38","99284888"
"chr2","62017492","62017776","chr1","210738129","210738412","63","148720637"
"chr2","62018123","62018204","chr7","105707204","105707286","20","43689081"
"chr2","62041358","62041596","chr5","161244419","161244664","39","99203061"
"chr2","62042146","62042316","chr3","48411396","48411566","51","13630750"
"chr2","62049880","62050166","chr5","161238828","161239118","43","99188948"
"chr2","62067077","62067282","chr19","2810406","2810614","44","59256671"
"chr2","62074445","62074607","chr14","83476931","83477090","32","21402486"
"chr2","62081982","62082336","chr6","35032995","35033331","112","27048987"
"chr2","62091494","62091763","chr5","161197134","161197407","52","99105640"
"chr2","62132156","62132352","chr5","161162386","161162592","32","99030230"
"chr2","62150863","62151150","chr16","31597935","31598219","57","30552928"
"chr2","62193327","62193618","chr5","161115198","161115476","38","98921871"
"chr2","62214235","62214313","chr6","85524761","85524840","18","23310526"
"chr2","62234782","62235070","chr22","7100241","7100534","51","55134541"
"chr2","62236273","62236581","chr9","59055928","59056227","75","3180345"
"chr2","62240114","62240366","chr3","199487793","199488055","58","137247679"
"chr2","62255871","62256178","chr5","161069211","161069538","48","98813340"
"chr2","62272967","62273085","chr11","69147152","69147272","30","6874185"
"chr2","62318720","62319017","chr5","161027511","161027812","43","98708791"
"chr2","62394444","62394611","chr6","15264957","15265121","37","47129487"
"chr2","62474492","62474728","chr20","5927363","5927600","61","56547129"
"chr2","62495338","62495522","chr11","44694637","44694827","44","17800701"
"chr2","62526752","62527065","chr5","160855042","160855362","44","98328290"
"chr2","62549212","62549330","chr5","160835845","160835975","24","98286633"
"chr2","62568666","62568968","chr5","160816694","160817001","36","98248028"
"chr2","62630231","62630539","chr16","76829181","76829477","77","14198950"
"chr2","62637712","62637957","chr5","160755148","160755395","31","98117436"
"chr2","62652627","62652797","chr5","160740522","160740695","33","98087895"
"chr2","62654575","62654736","chr7","79271528","79271684","42","16616953"
"chr2","62662554","62662881","chr11","58986415","58986731","69","3676139"
"chr2","62688106","62688398","chr5","160699334","160699638","48","98011228"
"chr2","62730525","62730789","chr5","160654343","160654636","60","97923818"
"chr2","62737955","62738106","chr10","49585047","49585201","27","13152908"
"chr2","62828797","62828994","chr7","2363764","2363952","38","60465033"
"chr2","62832465","62832753","chr5","160547855","160548155","54","97715390"
"chr2","62850681","62850754","chr16","65390615","65390689","18","2539934"
"chr2","62867501","62867783","chr7","45544878","45545162","58","17322623"
"chr2","62895392","62895631","chr9","108406244","108406492","70","45510852"
"chr2","62932174","62932475","chr4","164092787","164093085","73","101160613"
"chr2","62936368","62936528","chr7","74190896","74191062","34","11254528"
"chr2","62950203","62950354","chr12","123494135","123494294","32","60543932"
"chr2","62961943","62962237","chr5","160314378","160314671","38","97352435"
"chr2","62978204","62978513","chr5","161750102","161750402","36","98771898"
"chr2","63002688","63002959","chr5","161712564","161712865","59","98709876"
"chr2","63005931","63006208","chr19","33400022","33400302","56","29605909"
"chr2","63014121","63014243","chr5","160403653","160403782","16","97389532"
"chr2","63026757","63027077","chr2A","100322474","100322774","86","37295717"
"chr2","63063840","63064120","chr19","19300830","19301110","67","43763010"
"chr2","63083209","63083333","chr8","79737740","79737854","36","16654531"
"chr2","63103008","63103085","chr10","90697834","90697910","15","27594826"
"chr2","63111777","63112058","chr5","160495716","160495971","66","97383939"
"chr2","63142011","63142104","chr7","130080243","130080338","17","66938232"
"chr2","63173115","63173340","chr6","37978460","37978685","56","25194655"
"chr2","63174801","63174933","chr5","162131929","162132058","19","98957128"
"chr2","63178591","63178847","chr5","162135444","162135709","45","98956853"
"chr2","63187499","63187727","chr7","79272098","79272338","57","16084599"
"chr2","63204752","63204870","chr1","51731967","51732088","21","11472785"
"chr2","63212512","63212802","chr5","161911779","161912075","39","98699267"
"chr2","63228057","63228240","chr10","115667294","115667466","38","52439237"
"chr2","63262287","63262582","chr5","162219504","162219801","56","98957217"
"chr2","63338291","63338521","chr3","126441844","126442070","45","63103553"
"chr2","63342572","63342729","chr12","19312537","19312701","31","44030035"
"chr2","63369430","63369641","chr5","162333181","162333396","21","98963751"
"chr2","63461990","63462257","chr7","129054394","129054678","62","65592404"
"chr2","63472646","63472787","chr1","46271276","46271424","34","17201370"
"chr2","63552009","63552313","chr5","162499264","162499587","50","98947255"
"chr2","63607301","63607447","chr5","4001877","4002032","41","59605424"
"chr2","63625799","63625978","chr18","70037968","70038128","53","6412169"
"chr2","63705197","63705474","chr5","162662739","162663020","54","98957542"
"chr2","63767632","63767797","chr5","2409784","2409944","31","61357848"
"chr2","63854921","63855139","chr5","162792574","162792786","28","98937653"
"chr2","63904286","63904444","chr1","162716672","162716841","33","98812386"
"chr2","63941195","63941347","chr1","205548459","205548612","30","141607264"
"chr2","63998226","63998490","chr5","162904038","162904319","46","98905812"
"chr2","64027742","64027981","chr5","86646685","86646926","27","22618943"
"chr2","64074977","64075269","chr14","6126697","6126995","62","57948280"
"chr2","64088360","64088516","chr10","108854405","108854560","27","44766045"
"chr2","64145790","64145956","chr3","131117277","131117446","45","66971487"
"chr2","64219422","64219681","chr16","22314623","22314875","73","41904799"
"chr2","64230504","64230795","chr5","159837143","159837439","42","95606639"
"chr2","64241831","64242095","chr5","159825904","159826155","33","95584073"
"chr2","64275430","64275735","chr5","159793986","159794281","44","95518556"
"chr2","64345416","64345736","chr5","159726275","159726574","62","95380859"
"chr2","64500626","64500919","chr5","159576199","159576503","39","95075573"
"chr2","64570160","64570448","chr5","159516111","159516442","67","94945951"
"chr2","64720403","64720658","chr7","127613518","127613768","69","62893115"
"chr2","64745423","64745706","chr5","159379318","159379606","39","94633895"
"chr2","64905764","64905886","chr18","46891062","46891193","21","18014702"
"chr2","64947197","64947475","chr5","159225443","159225738","52","94278246"
"chr2","65034524","65034819","chr5","159151088","159151391","50","94116564"
"chr2","65089628","65089827","chr5","159062430","159062621","30","93972802"
"chr2","65147894","65148151","chr5","158921576","158921840","37","93773682"
"chr2","65191594","65191892","chr5","158869472","158869768","53","93677878"
"chr2","65194614","65194880","chr13","31449850","31450110","56","33744764"
"chr2","65248720","65248900","chr10","35054340","35054550","55","30194380"
"chr2","65248921","65249114","chr7","127819212","127819413","44","62570291"
"chr2","65295111","65295397","chr5","158777429","158777728","43","93482318"
"chr2","65306528","65306660","chr5","158768271","158768399","19","93461743"
"chr2","65308166","65308313","chr1","17928928","17929072","30","47379238"
"chr2","65308695","65308911","chr2A","12723249","12723464","51","52585446"
"chr2","65308919","65308996","chr14","2826922","2826999","16","62481997"
"chr2","65326323","65326578","chr5","158745880","158746137","32","93419557"
"chr2","65451320","65451440","chr14","48412966","48413089","22","17038354"
"chr2","65464031","65464320","chr5","158604294","158604601","60","93140263"
"chr2","65465033","65465328","chr3","49249231","49249531","63","16215802"
"chr2","65536747","65537051","chr2B","71035214","71035513","64","5498467"
"chr2","65610232","65610351","chr5","147429151","147429265","25","81818919"
"chr2","65762008","65762317","chr5","158324946","158325235","50","92562938"
"chr2","65875187","65875433","chr16","10930020","10930265","66","54945167"
"chr2","65944554","65944674","chr6","154239364","154239482","33","88294810"
"chr2","65971084","65971388","chr5","158133592","158133874","54","92162508"
"chr2","65973169","65973470","chr5","158131453","158131756","48","92158284"
"chr2","65999350","65999608","chr12","125129033","125129295","55","59129683"
"chr2","66021616","66021876","chr3","102042147","102042399","69","36020531"
"chr2","66111476","66111741","chr9","22226686","22226957","70","43884790"
"chr2","66128674","66128870","chr5","158013385","158013591","29","91884711"
"chr2","66150991","66151152","chr4","190209315","190209476","31","124058324"
"chr2","66251753","66252033","chr2A","79465894","79466171","61","13214141"
"chr2","66259840","66260121","chr5","157885034","157885317","57","91625194"
"chr2","66293916","66294216","chr5","157850644","157850947","34","91556728"
"chr2","66305286","66305526","chr5","157840180","157840457","55","91534894"
"chr2","66537226","66537351","chr5","157684138","157684261","27","91146912"
"chr2","66606529","66606753","chr5","157637435","157637657","26","91030906"
"chr2","66786803","66786925","chr5","157498046","157498168","14","90711243"
"chr2","66798800","66798928","chr5","157490059","157490190","16","90691259"
"chr2","66799041","66799323","chr5","157489656","157489940","35","90690615"
"chr2","66799399","66799717","chr5","157489251","157489577","42","90689852"
"chr2","66807446","66807570","chr5","157478249","157478373","13","90670803"
"chr2","66880815","66881107","chr1","157303438","157303720","48","90422623"
"chr2","66901564","66901865","chr14","33040429","33040734","62","33861135"
"chr2","66904271","66904582","chr5","157392558","157392875","40","90488287"
"chr2","66905366","66905494","chr12","110536869","110536993","18","43631503"
"chr2","66905884","66906124","chr5","157390987","157391229","34","90485103"
"chr2","66963655","66963817","chr1","183223511","183223687","44","116259856"
"chr2","67022774","67023051","chr7","76092450","76092732","75","9069676"
"chr2","67040333","67040507","chr10","112563918","112564071","49","45523585"
"chr2","67098514","67098794","chr21","16557949","16558241","62","50540565"
"chr2","67103045","67103320","chr18","1313785","1314066","54","65789260"
"chr2","67123790","67124069","chr5","157180660","157180936","39","90056870"
"chr2","67140763","67141007","chr5","157163855","157164099","22","90023092"
"chr2","67146031","67146146","chr9","70213476","70213592","17","3067445"
"chr2","67154502","67154798","chr5","157149741","157150034","46","89995239"
"chr2","67177918","67178201","chr3","155396550","155396837","62","88218632"
"chr2","67184957","67185245","chr5","157126895","157127175","42","89941938"
"chr2","67190429","67190526","chr6","15156813","15156907","21","52033616"
"chr2","67192798","67192906","chr14","79580252","79580364","27","12387454"
"chr2","67193033","67193312","chr5","157118879","157119168","36","89925846"
"chr2","67198523","67198815","chr5","157113304","157113600","50","89914781"
"chr2","67209052","67209332","chr5","157102432","157102719","36","89893380"
"chr2","67223926","67224091","chr3","130637612","130637782","38","63413686"
"chr2","67224105","67224176","chr1","191065956","191066019","15","123841851"
"chr2","67278927","67279084","chr12","28669233","28669390","35","38609694"
"chr2","67293992","67294299","chr5","157015051","157015365","36","89721059"
"chr2","67295169","67295483","chr5","157014190","157014485","51","89719021"
"chr2","67299540","67299843","chr19","5813832","5814137","64","61485708"
"chr2","67351017","67351283","chr5","156969230","156969516","47","89618213"
"chr2","67351526","67351640","chr5","156968572","156968689","8","89617046"
"chr2","67414089","67414379","chr5","156904584","156904874","18","89490495"
"chr2","67430359","67430444","chr5","156886616","156886701","6","89456257"
"chr2","67593773","67594061","chr12","32032110","32032393","63","35561663"
"chr2","67624209","67624355","chr5","156687101","156687239","22","89062892"
"chr2","67690016","67690253","chr15","13143077","13143320","56","54546939"
"chr2","67705687","67705988","chr3","10057169","10057465","62","57648518"
"chr2","67760242","67760486","chr5","64541639","64541892","64","3218603"
"chr2","67768511","67768750","chrX","41962102","41962338","48","25806409"
"chr2","67779241","67779523","chr5","156540896","156541178","40","88761655"
"chr2","67829185","67829454","chr5","156476837","156477135","55","88647652"
"chr2","67836483","67836765","chr5","156469930","156470212","27","88633447"
"chr2","67837854","67838142","chr5","156468836","156469118","39","88630982"
"chr2","67840533","67840827","chr5","156466426","156466718","32","88625893"
"chr2","67905392","67905509","chr5","156407028","156407145","6","88501636"
"chr2","67912778","67913053","chr16","75796161","75796439","53","7883383"
"chr2","67934222","67934392","chr2A","18676559","18676734","41","49257663"
"chr2","67940453","67940571","chr1","162595768","162595870","41","94655315"
"chr2","67988899","67989189","chr5","156336736","156337035","56","88347837"
"chr2","68027759","68027839","chr20","60503715","60503794","19","7524044"
"chr2","68100970","68101273","chr7","75590459","75590765","65","7489489"
"chr2","68173261","68173329","chr3","24777677","24777748","16","43395584"
"chr2","68186270","68186325","chr1","127641618","127641669","13","59455348"
"chr2","68186508","68186724","chr3","50845391","50845604","50","17341117"
"chr2","68204537","68204822","chr5","3183876","3184181","71","65020661"
"chr2","68282858","68283130","chr3","152364414","152364685","63","84081556"
"chr2","68320744","68321051","chr5","156095981","156096292","83","87775237"
"chr2","68321054","68321162","chr5","156095859","156095980","20","87774805"
"chr2","68332642","68332792","chr7","26169140","26169297","35","42163502"
"chr2","68368169","68368464","chr3","68905857","68906160","69","537688"
"chr2","68372447","68372747","chr12","131671028","131671332","60","63298581"
"chr2","68383533","68383823","chr5","156032683","156032964","67","87649150"
"chr2","68384864","68385131","chr5","156031374","156031685","70","87646510"
"chr2","68430901","68431137","chr5","155985640","155985868","49","87554739"
"chr2","68455410","68455540","chr9","112841011","112841143","21","44385601"
"chr2","68464363","68464590","chr5","134965817","134966028","73","66501454"
"chr2","68733323","68733485","chr8","386779","386948","31","68346544"
"chr2","68780367","68780666","chr9","13508403","13508697","62","55271964"
"chr2","68812031","68812177","chr22","15473787","15473944","38","53338244"
"chr2","68821446","68821763","chr5","12929269","12929575","68","55892177"
"chr2","68883007","68883325","chr7","26144029","26144335","66","42738978"
"chr2","68883477","68883735","chr13","31179441","31179704","55","37704036"
"chr2","68941528","68941707","chr2B","8177980","8178161","48","60763548"
"chr2","68944716","68944808","chr2A","63084317","63084409","17","5860399"
"chr2","68963285","68963407","chr4","73463953","73464076","27","4500668"
"chr2","68968483","68968691","chr3","101529162","101529367","51","32560679"
"chr2","68986168","68986204","chr13","71500234","71500270","6","2514066"
"chr2","69020476","69020592","chr5","155415567","155415684","6","86395091"
"chr2","69058594","69058878","chr5","155378549","155378832","38","86319955"
"chr2","69072310","69072409","chr10","37636709","37636809","17","31435601"
"chr2","69124789","69125075","chr5","38104922","38105205","58","31019867"
"chr2","69224651","69224943","chr12","95002240","95002523","67","25777589"
"chr2","69750784","69751074","chr5","154682086","154682389","57","84931302"
"chr2","69763702","69764014","chr5","154670106","154670429","39","84906404"
"chr2","69803294","69803444","chr5","154630148","154630297","24","84826854"
"chr2","69887685","69887977","chr5","154487418","154487688","63","84599733"
"chr2","69932015","69932310","chr5","154442638","154442935","44","84510623"
"chr2","69955412","69955699","chr5","154420745","154421029","32","84465333"
"chr2","69976074","69976368","chr5","154398797","154399094","34","84422723"
"chr2","70068895","70069179","chr5","154300218","154300514","46","84231323"
"chr2","70357216","70357477","chr12","123570594","123570856","58","53213378"
"chr2","70377238","70377394","chr10","92108530","92108678","43","21731292"
"chr2","70457896","70458186","chr5","153904533","153904826","41","83446637"
"chr2","70515947","70516246","chr5","153835802","153836123","57","83319855"
"chr2","70521826","70522131","chr5","153830539","153830832","38","83308713"
"chr2","70679025","70679315","chr5","153714795","153715089","34","83035770"
"chr2","70682458","70682613","chr6","43540486","43540645","35","27141972"
"chr2","70683954","70684072","chr14","74639249","74639368","25","3955295"
"chr2","70698363","70698500","chr6","18588428","18588554","31","52109935"
"chr2","70907634","70907761","chr1","207694682","207694814","27","136787048"
"chr2","70908106","70908410","chr1","161737058","161737374","40","90828952"
"chr2","70938360","70938483","chr10","101248189","101248315","26","30309829"
"chr2","70995304","70995551","chr1","207791885","207792134","40","136796581"
"chr2","71022289","71022399","chr5","28160440","28160550","20","42861849"
"chr2","71029791","71030070","chr5","117774036","117774315","53","46744245"
"chr2","71030100","71030386","chr11","48082083","48082366","57","22948017"
"chr2","71033608","71033731","chr8","34872656","34872779","21","36160952"
"chr2","71036209","71036369","chr5","156687101","156687239","54","85650892"
"chr2","71047115","71047398","chr5","117740601","117740875","39","46693486"
"chr2","71048469","71048618","chr19","3179387","3179533","37","67869082"
"chr2","71048678","71048805","chr5","83591516","83591648","24","12542838"
"chr2","71056914","71057045","chr5","117723997","117724127","12","46667083"
"chr2","71064386","71064689","chr5","117715100","117715415","36","46650714"
"chr2","71108786","71108985","chr5","117677178","117677363","31","46568392"
"chr2","71143790","71143955","chr4","171210900","171211065","33","100067110"
"chr2","71154310","71154410","chr9","112252272","112252374","20","41097962"
"chr2","71182557","71182857","chr5","117604227","117604526","41","46421670"
"chr2","71198997","71199223","chr5","117588043","117588269","30","46389046"
"chr2","71218724","71219013","chr8","78653790","78654078","52","7435066"
"chr2","71230293","71230580","chr5","117554933","117555221","38","46324640"
"chr2","71268888","71269009","chr2A","45657659","45657776","22","25611229"
"chr2","71332757","71332914","chr3","184741818","184741981","29","113409061"
"chr2","71333530","71333650","chr1","130889305","130889428","24","59555775"
"chr2","71855704","71856005","chr5","117001767","117002038","67","45146063"
"chr2","72184492","72184799","chr5","116703525","116703837","35","44519033"
"chr2","72242329","72242597","chr5","116646252","116646501","55","44403923"
"chr2","72327532","72327693","chr16","58399534","58399693","34","13927998"
"chr2","72372079","72372350","chr16","30496381","30496654","62","41875698"
"chr2","72373329","72373637","chr5","116529404","116529721","62","44156075"
"chr2","72418952","72419077","chr5","116495701","116495824","19","44076749"
"chr2","72444348","72444446","chr2A","50477157","50477250","22","21967191"
"chr2","72448581","72448852","chr12","11463774","11464044","64","60984807"
"chr2","72467938","72468240","chr5","116443509","116443788","58","43975571"
"chr2","72492036","72492254","chr5","116424697","116424916","21","43932661"
"chr2","72492775","72493072","chr5","129500126","129500434","70","57007351"
"chr2","72503966","72504082","chr3","199536979","199537090","23","127033013"
"chr2","72529212","72529506","chr5","116385604","116385912","50","43856392"
"chr2","72534000","72534305","chr10","88350554","88350862","73","15816554"
"chr2","72537948","72538250","chrX","133276519","133276823","59","60738571"
"chr2","72545536","72545820","chr5","116372486","116372767","55","43826950"
"chr2","72617267","72617563","chr6","35485428","35485707","79","37131839"
"chr2","72625978","72626104","chr6","151826571","151826692","27","79200593"
"chr2","72626118","72626189","chr6","108167255","108167324","25","35541137"
"chr2","72634135","72634433","chr7","104942328","104942627","54","32308193"
"chr2","72659993","72660119","chr1","59521947","59522063","43","13138046"
"chr2","72671172","72671477","chr5","116256130","116256432","51","43584958"
"chr2","72739855","72740169","chr5","116189678","116189994","53","43449823"
"chr2","72749614","72749723","chr5","116179201","116179320","23","43429587"
"chr2","72798767","72799075","chr1","46825028","46825336","55","25973739"
"chr2","72837913","72838165","chr5","116092903","116093174","40","43254990"
"chr2","73003386","73003679","chr5","115904741","115905022","39","42901355"
"chr2","73088506","73088592","chrUn_CABD030131139v1","486","573","17","73088020"
"chr2","73126954","73127249","chr9","110714147","110714448","58","37587193"
"chr2","73193241","73193543","chr5","115727508","115727811","40","42534267"
"chr2","73225700","73225975","chr5","115695452","115695754","52","42469752"
"chr2","73276743","73276859","chr5","115650473","115650589","10","42373730"
"chr2","73308334","73308636","chr5","115607422","115607717","44","42299088"
"chr2","73384193","73384492","chr5","115522864","115523156","44","42138671"
"chr2","73426168","73426324","chr5","115483544","115483721","35","42057376"
"chr2","73604915","73605194","chr9","108814804","108815078","56","35209889"
"chr2","73630775","73631073","chr1","227415933","227416230","57","153785158"
"chr2","73643257","73643582","chr20","2572214","2572527","71","71071043"
"chr2","73674288","73674573","chr5","115356769","115357077","52","41682481"
"chr2","73700576","73700890","chr5","115314445","115314740","60","41613869"
"chr2","73721099","73721181","chr10","96261490","96261572","17","22540391"
"chr2","73721919","73722147","chr19","55715229","55715446","58","18006690"
"chr2","73723949","73724229","chr5","115260071","115260368","45","41536122"
"chr2","73762953","73763100","chr1","22298981","22299131","36","51463972"
"chr2","73779114","73779353","chr6","58596137","58596387","66","15182977"
"chr2","73785869","73786154","chr5","115191348","115191633","27","41405479"
"chr2","73837113","73837271","chr10","49585047","49585201","32","24252066"
"chr2","73888392","73888502","chr4","34521070","34521186","27","39367322"
"chr2","73888717","73888916","chr12","119805659","119805848","55","45916942"
"chr2","73934322","73934617","chr5","115069983","115070272","47","41135661"
"chr2","73939722","73939988","chr16","1697268","1697527","72","72242454"
"chr2","74009867","74010062","chr19","17191583","17191792","59","56818284"
"chr2","74033792","74034078","chr5","114982262","114982553","37","40948470"
"chr2","74057119","74057330","chr5","114962815","114963016","27","40905696"
"chr2","74063637","74063760","chr5","114955482","114955589","27","40891845"
"chr2","74075338","74075609","chr5","114943586","114943854","46","40868248"
"chr2","74119523","74119810","chr5","114899083","114899366","48","40779560"
"chr2","74159427","74159675","chrX","40833613","40833882","75","33325814"
"chr2","74195922","74196222","chr5","114860432","114860734","35","40664510"
"chr2","74221418","74221547","chr14","55187426","55187557","24","19033992"
"chr2","74293700","74293999","chr1","40430488","40430784","62","33863212"
"chr2","74340967","74341119","chr7","70842983","70843136","29","3497984"
"chr2","74360434","74360736","chr5","114671341","114671662","65","40310907"
"chr2","74431699","74431865","chr6","118855023","118855193","31","44423324"
"chr2","74471773","74471929","chr15","67737918","67738076","35","6733855"
"chr2","74523870","74524146","chr5","114514149","114514425","28","39990279"
"chr2","74601520","74601725","chr5","138455898","138456111","44","63854378"
"chr2","74949632","74949899","chr5","114153566","114153837","30","39203934"
"chr2","74984956","74985240","chr5","114095401","114095690","46","39110445"
"chr2","74986719","74986860","chr10","30690604","30690743","37","44296115"
"chr2","74992246","74992412","chr7","151692218","151692384","38","76699972"
"chr2","75321725","75321849","chr21","30439891","30440018","27","44881834"
"chr2","75354677","75354771","chr12","101108883","101108973","28","25754206"
"chr2","75560023","75560332","chr5","113599334","113599633","39","38039311"
"chr2","75613378","75613657","chr2B","63672808","63673089","68","11940570"
"chr2","75780175","75780336","chr19","37034098","37034257","37","38746077"
"chr2","75818491","75818790","chr5","113377924","113378205","52","37559433"
"chr2","75836405","75836658","chr5","113360312","113360578","46","37523907"
"chr2","75983461","75983755","chr11","50191636","50191937","72","25791825"
"chr2","76364261","76364503","chr7","2407454","2407706","76","73956807"
"chr2","76389699","76389979","chr5","112729997","112730292","59","36340298"
"chr2","76394048","76394277","chr5","112725980","112726219","43","36331932"
"chr2","76824542","76824774","chr5","112409523","112409765","44","35584981"
"chr2","76945424","76945719","chr5","112326886","112327189","44","35381462"
"chr2","77050035","77050150","chr5","112230612","112230727","13","35180577"
"chr2","77236594","77236735","chr6","36782155","36782293","33","40454439"
"chr2","77255282","77255533","chr12","125200621","125200875","65","47945339"
"chr2","77493657","77493926","chr5","111755364","111755637","46","34261707"
"chr2","77610885","77611180","chr1","227415933","227416230","59","149805048"
"chr2","77617499","77617789","chr6","75486123","75486422","67","2131376"
"chr2","77628531","77628640","chr5","111627084","111627193","15","33998553"
"chr2","77635763","77636072","chr10","142926143","142926445","74","65290380"
"chr2","77639814","77640086","chr5","111614668","111614919","68","33974854"
"chr2","77705069","77705356","chr5","111538003","111538296","47","33832934"
"chr2","77757511","77757820","chr5","111486015","111486330","72","33728504"
"chr2","77835707","77836000","chr4","15717900","15718198","65","62117807"
"chr2","77936636","77936755","chr7","56839310","56839440","37","21097326"
"chr2","78012526","78012802","chr5","111263004","111263305","63","33250478"
"chr2","78031307","78031548","chr7","64790817","64791051","67","13240490"
"chr2","78040589","78040870","chr5","111234260","111234546","35","33193671"
"chr2","78140600","78140905","chr18","18913916","18914216","62","59226684"
"chr2","78449425","78449723","chrX","1466855","1467150","76","76982570"
"chr2","78487672","78487790","chr14","45229440","45229558","27","33258232"
"chr2","78574543","78574837","chr5","110672905","110673198","34","32098362"
"chr2","78736355","78736637","chr5","110508138","110508394","61","31771783"
"chr2","78788569","78788841","chr5","110485954","110486227","26","31697385"
"chr2","78967870","78968107","chr5","110284799","110285036","25","31316929"
"chr2","79094941","79095220","chr8","20440778","20441079","60","58654163"
"chr2","79150317","79150423","chr4","81546410","81546517","22","2396093"
"chr2","79203860","79203989","chr5","110026546","110026670","19","30822686"
"chr2","79355987","79356281","chr5","109867605","109867898","40","30511618"
"chr2","79389107","79389379","chr5","161115198","161115476","71","81726091"
"chr2","79401684","79401972","chr5","109831322","109831611","36","30429638"
"chr2","79412209","79412364","chr19","7784006","7784166","34","71628203"
"chr2","79412378","79412480","chr4","195001113","195001216","24","115588735"
"chr2","79413538","79413568","chr2A","36559648","36559678","8","42853890"
"chr2","79436633","79436775","chr3","199463674","199463811","34","120027041"
"chr2","79484677","79484965","chr5","109725371","109725644","53","30240694"
"chr2","79486718","79486930","chr17","1429564","1429780","39","78057154"
"chr2","79624531","79624819","chr10","34187701","34187983","64","45436830"
"chr2","79663026","79663180","chr3","121513710","121513864","36","41850684"
"chr2","79957338","79957637","chr4","94010013","94010316","67","14052675"
"chr2","80193700","80193828","chr5","109065637","109065760","15","28871937"
"chr2","80618826","80619130","chr5","108671508","108671812","25","28052682"
"chr2","80640414","80640532","chr7","4387599","4387716","16","76252815"
"chr2","80654112","80654434","chr5","108635836","108636135","72","27981724"
"chr2","80765496","80765777","chr5","108543316","108543616","66","27777820"
"chr2","80886934","80887097","chr5","108419289","108419468","37","27532355"
"chr2","81082703","81083012","chr8","98755171","98755484","59","17672468"
"chr2","81093071","81093358","chr22","14349999","14350284","59","66743072"
"chr2","81096817","81096932","chr8","42463764","42463882","28","38633053"
"chr2","81117066","81117374","chr12","36641891","36642186","70","44475175"
"chr2","81158711","81158941","chr5","108125860","108126086","37","26967149"
"chr2","81167924","81168069","chr7","28901497","28901635","37","52266427"
"chr2","81170726","81171011","chr5","108114107","108114365","60","26943381"
"chr2","81173238","81173539","chrX","129818883","129819179","65","48645645"
"chr2","81224042","81224182","chr7","107774197","107774327","26","26550155"
"chr2","81226886","81227221","chr5","108062744","108063062","64","26835858"
"chr2","81234661","81234954","chr5","108054865","108055164","48","26820204"
"chr2","81346007","81346296","chr5","107939960","107940250","32","26593953"
"chr2","81358340","81358392","chr17","15489363","15489414","15","65868977"
"chr2","81366385","81366657","chr5","107921240","107921513","34","26554855"
"chr2","81427886","81428043","chr1","188967838","188967994","32","107539952"
"chr2","81439381","81439668","chr5","107853182","107853475","49","26413801"
"chr2","81450184","81450471","chr5","107840353","107840650","42","26390169"
"chr2","81464510","81464676","chr8","27394262","27394430","31","54070248"
"chr2","81468722","81469011","chr5","107820299","107820607","41","26351577"
"chr2","81605571","81605740","chr6","109323282","109323447","34","27717711"
"chr2","81611218","81611511","chr5","107676318","107676619","51","26065100"
"chr2","81646530","81646666","chr9","14717932","14718063","24","66928598"
"chr2","81723113","81723278","chr12","8768282","8768448","32","72954831"
"chr2","81749972","81750270","chr17","30268308","30268606","67","51481664"
"chr2","81760758","81761044","chr5","107525551","107525828","44","25764793"
"chr2","81771342","81771642","chr5","107514974","107515282","48","25743632"
"chr2","81922515","81922786","chr5","107365159","107365440","38","25442644"
"chr2","81947392","81947692","chr7","101393477","101393769","64","19446085"
"chr2","82445510","82445633","chr5","106909085","106909205","11","24463575"
"chr2","82494334","82494495","chr5","106826128","106826290","20","24331794"
"chr2","82521896","82522204","chr5","106799095","106799408","44","24277199"
"chr2","82567659","82567771","chr5","106754419","106754531","17","24186760"
"chr2","82607711","82608000","chr5","106697867","106698175","47","24090156"
"chr2","82982113","82982267","chr11","129038829","129038978","36","46056716"
"chr2","83055617","83055861","chr1","153903351","153903586","70","70847734"
"chr2","83197949","83198226","chr5","106158722","106159017","42","22960773"
"chr2","83208684","83208912","chr3","57997401","57997617","55","25211283"
"chr2","83226244","83226543","chr5","106126502","106126797","52","22900258"
"chr2","83231256","83231531","chr5","52613711","52613994","62","30617545"
"chr2","83249139","83249418","chr5","106101853","106102143","40","22852714"
"chr2","83293432","83293522","chr16","65628887","65628978","18","17664545"
"chr2","83302928","83303211","chr5","106039814","106040098","31","22736886"
"chr2","83320148","83320279","chr7","74790659","74790791","24","8529489"
"chr2","83383178","83383309","chr5","105948056","105948188","25","22564878"
"chr2","83413731","83414019","chr1","91059171","91059456","62","7645440"
"chr2","83473403","83473651","chr1","42507228","42507472","62","40966175"
"chr2","83551677","83551965","chr5","105761391","105761663","39","22209714"
"chr2","83555531","83555838","chr5","105757500","105757805","41","22201969"
"chr2","83584774","83584868","chr17","84755477","84755569","15","1170703"
"chr2","83659879","83660172","chr5","105644490","105644790","50","21984611"
"chr2","83698245","83698538","chr5","105606161","105606453","44","21907916"
"chr2","83706186","83706437","chr5","105598627","105598910","56","21892441"
"chr2","83716729","83716855","chr5","105587554","105587678","13","21870825"
"chr2","83724138","83724372","chr7","69049824","69050055","59","14674314"
"chr2","83955499","83955747","chr3","13810051","13810291","50","70145448"
"chr2","83997334","83997616","chr5","105296698","105296983","35","21299364"
"chr2","83998905","83999022","chr5","105295286","105295393","18","21296381"
"chr2","84010386","84010679","chrX","55043565","55043849","66","28966821"
"chr2","84015318","84015585","chr17","93038314","93038566","84","9022996"
"chr2","84236944","84237209","chr5","105072153","105072422","38","20835209"
"chr2","84629539","84629844","chr5","104707311","104707616","43","20077772"
"chr2","84930351","84930632","chr5","104422198","104422484","45","19491847"
"chr2","84952936","84953217","chr20","39682251","39682537","58","45270685"
"chr2","84991084","84991399","chr5","104387076","104387390","49","19395992"
"chr2","85071535","85071647","chr9","93151090","93151202","26","8079555"
"chr2","85147017","85147305","chr5","104240919","104241211","36","19093902"
"chr2","85427266","85427504","chr5","104074821","104075079","63","18647555"
"chr2","85443276","85443592","chr5","104048733","104049040","52","18605457"
"chr2","85544860","85545139","chr5","103956728","103956994","43","18411868"
"chr2","85765805","85765917","chr5","103770770","103770883","11","18004965"
"chr2","85816734","85816813","chr20","37407182","37407258","16","48409552"
"chr2","85825944","85826214","chr5","103702504","103702767","32","17876560"
"chr2","85833218","85833507","chr5","103696343","103696647","50","17863125"
"chr2","86047212","86047482","chr5","103518408","103518675","43","17471196"
"chr2","86288635","86288906","chr16","25844409","25844683","63","60444226"
"chr2","86338918","86339062","chr5","103294073","103294210","35","16955155"
"chr2","86370622","86370935","chr5","103272859","103273147","56","16902237"
"chr2","86555213","86555505","chr5","103088038","103088343","53","16532825"
"chr2","86635352","86635638","chr5","17952279","17952566","62","68683073"
"chr2","86718265","86718525","chr16","27968732","27968979","64","58749533"
"chr2","86757846","86758122","chr5","102890274","102890556","43","16132428"
"chr2","86770706","86771013","chr7","77306579","77306892","77","9464127"
"chr2","86783109","86783249","chr5","3296328","3296466","39","83486781"
"chr2","86823707","86824020","chr5","102836714","102837029","54","16013007"
"chr2","86842064","86842348","chr5","102824854","102825140","33","15982790"
"chr2","86996484","86996639","chr7","6009067","6009222","41","80987417"
"chr2","87018692","87018821","chr7","26316442","26316573","22","60702250"
"chr2","87026651","87026801","chr3","267312","267456","42","86759339"
"chr2","87081880","87082182","chr5","48822089","48822382","66","38259791"
"chr2","87093589","87093913","chr5","102585055","102585348","64","15491466"
"chr2","87105878","87106163","chr18","54011856","54012142","68","33094022"
"chr2","87155941","87156101","chr5","51144248","51144411","34","36011693"
"chr2","87159046","87159311","chr19","12751754","12752021","57","74407292"
"chr2","87163515","87163821","chr5","102516127","102516439","45","15352612"
"chr2","87271197","87271322","chr5","102423851","102423975","14","15152654"
"chr2","87338475","87338782","chr5","102360717","102361003","57","15022242"
"chr2","87389822","87389944","chr1","111861160","111861287","21","24471338"
"chr2","87405153","87405449","chr5","102307302","102307607","40","14902149"
"chr2","87409384","87409635","chr5","102302797","102303065","40","14893413"
"chr2","87411591","87411885","chr5","102299949","102300247","47","14888358"
"chr2","87427640","87427754","chr1","22785325","22785439","18","64642315"
"chr2","87435641","87435949","chr10","130138881","130139148","83","42703240"
"chr2","87435961","87436071","chr16","37103044","37103155","27","50332917"
"chr2","87436078","87436167","chr12","12775256","12775351","27","74660822"
"chr2","87436566","87436717","chr11","128247655","128247811","36","40811089"
"chr2","87448395","87448467","chr5","102250057","102250129","13","14801662"
"chr2","87449259","87449373","chr10","108952743","108952857","26","21503484"
"chr2","87462521","87462809","chr5","102241438","102241724","31","14778917"
"chr2","87468101","87468402","chr5","102234726","102235021","41","14766625"
"chr2","87469422","87469614","chr8","98909960","98910147","46","11440538"
"chr2","87525147","87525246","chr12","114830969","114831073","27","27305822"
"chr2","87567969","87568240","chr8","20959195","20959465","68","66608774"
"chr2","87589924","87590044","chr10","118546726","118546841","30","30956802"
"chr2","87602907","87603138","chr10","34868348","34868583","65","52734559"
"chr2","87641602","87641652","chr8","54578577","54578627","10","33063025"
"chr2","87696397","87696688","chr1","91059171","91059456","61","3362774"
"chr2","87718910","87719187","chr5","47923147","47923419","51","39795763"
"chr2","87724625","87724728","chr5","101996497","101996603","10","14271872"
"chr2","87737892","87738105","chrX","25240126","25240343","45","62497766"
"chr2","87764152","87764314","chr9","108496639","108496796","42","20732487"
"chr2","87912608","87912770","chr19","33656894","33657048","47","54255714"
"chr2","88010897","88011182","chr5","101770302","101770586","44","13759405"
"chr2","88146067","88146194","chr15","44810384","44810508","21","43335683"
"chr2","88262515","88262799","chr11","47006876","47007157","62","41255639"
"chr2","88321470","88321771","chr10","94613763","94614066","36","6292293"
"chr2","88321962","88322265","chr10","94614259","94614546","53","6292297"
"chr2","88603053","88603334","chr5","101182284","101182576","46","12579231"
"chr2","88750719","88750975","chr5","100932861","100933110","39","12182142"
"chr2","88768734","88768885","chr11","46895118","46895263","35","41873616"
"chr2","88821724","88821855","chr13","9281695","9281824","28","79540029"
"chr2","89200811","89200963","chr1","23727757","23727901","41","65473054"
"chr2","89220573","89220868","chr5","100590982","100591276","44","11370409"
"chr2","89617728","89618004","chr5","100236538","100236826","54","10618810"
"chr2","89737344","89737426","chr6","115879924","115880007","10","26142580"
"chr2","89740297","89740595","chr5","100136443","100136755","51","10396146"
"chr2","89811145","89811403","chr5","100074283","100074561","52","10263138"
"chr2","89858183","89858310","chr8","144957651","144957776","36","55099468"
"chr2","89859004","89859312","chr5","100028346","100028659","49","10169342"
"chr2","89883105","89883396","chr4","165626465","165626758","64","75743360"
"chr2","90146458","90146721","chr5","99732353","99732634","43","9585895"
"chr2","90290935","90291003","chr3","126860282","126860349","14","36569347"
"chr2","90291394","90291533","chr12","110108425","110108564","40","19817031"
"chr2","90292757","90293050","chr5","99583465","99583764","47","9290708"
"chr2","90378135","90378279","chr5","99492746","99492890","21","9114611"
"chr2","90548668","90548791","chr5","45910561","45910692","27","44638107"
"chr2","90582878","90583176","chr14","36624079","36624371","68","53958799"
"chr2","90583201","90583478","chr2A","59380769","59381049","76","31202432"
"chr2","90839492","90839794","chr5","99069747","99070047","41","8230255"
"chr2","90849866","90849993","chr5","99059269","99059390","19","8209403"
"chr2","90966926","90967211","chr5","98955460","98955752","46","7988534"
"chr2","90991943","90992240","chr5","98929324","98929619","35","7937381"
"chr2","91050879","91051040","chr6","5020344","5020506","38","86030535"
"chr2","91052165","91052327","chr20","44858230","44858390","28","46193935"
"chr2","91143799","91144085","chr7","5948149","5948430","70","85195650"
"chr2","91145624","91145915","chr8","78414509","78414797","63","12731115"
"chr2","91147717","91148047","chr7","72939200","72939496","85","18208517"
"chr2","91161194","91161490","chr10","6235515","6235801","54","84925679"
"chr2","91162171","91162353","chr10","116525266","116525447","42","25363095"
"chr2","91293402","91293700","chr5","98674043","98674343","45","7380641"
"chr2","91397223","91397542","chr7","94053318","94053616","51","2656095"
"chr2","91493393","91493686","chr11","111734073","111734360","57","20240680"
"chr2","91542117","91542400","chr5","98428409","98428697","45","6886292"
"chr2","91627025","91627378","chr13","18692023","18692332","99","72935002"
"chr2","91724179","91724451","chr5","98250847","98251139","56","6526668"
"chr2","91730699","91730982","chr5","98245394","98245677","33","6514695"
"chr2","91748824","91748955","chr5","98224970","98225102","15","6476146"
"chr2","91766055","91766344","chr5","98206295","98206593","53","6440240"
"chr2","91856698","91857003","chr5","52040637","52040935","65","39816061"
"chr2","92124581","92124633","chr10","46630120","46630171","9","45494461"
"chr2","92395945","92396236","chr5","97563151","97563442","36","5167206"
"chr2","92439312","92439608","chr5","97520660","97520932","64","5081348"
"chr2","92868698","92868838","chr19","47379993","47380130","31","45488705"
"chr2","92887590","92887728","chr1","68709407","68709549","38","24178183"
"chr2","93053138","93053262","chr20","42362568","42362686","26","50690570"
"chr2","93088127","93088437","chr5","96942875","96943163","49","3854748"
"chr2","93089178","93089319","chr3","155574758","155574899","27","62485580"
"chr2","93123243","93123494","chr5","96911072","96911321","32","3787829"
"chr2","93222694","93222816","chr19","32420356","32420484","27","60802338"
"chr2","93223487","93223677","chr10","90995787","90995979","44","2227700"
"chr2","93235583","93235829","chr5","96772286","96772532","33","3536703"
"chr2","93249552","93249698","chr10","30690604","30690743","39","62558948"
"chr2","93249982","93250165","chr3","32429400","32429571","41","60820582"
"chr2","93322533","93322834","chrX","133855012","133855314","70","40532479"
"chr2","93344975","93345280","chr5","96691151","96691453","40","3346176"
"chr2","93352708","93352867","chr2B","27751482","27751639","39","65601226"
"chr2","93373193","93373490","chr1","133729720","133730008","54","40356527"
"chr2","93385646","93385928","chr5","96651772","96652090","54","3266126"
"chr2","93464883","93465023","chr19","41295266","41295409","38","52169617"
"chr2","93509934","93510234","chr11","72251845","72252150","59","21258089"
"chr2","93519149","93519448","chr9","16232960","16233249","62","77286189"
"chr2","93532158","93532441","chr5","96491188","96491492","56","2959030"
"chr2","93565268","93565537","chr5","96455644","96455890","61","2890376"
"chr2","93731212","93731483","chr5","96289622","96289920","55","2558410"
"chr2","93832101","93832384","chr5","96197752","96198049","59","2365651"
"chr2","93843604","93843817","chr5","96186940","96187160","30","2343336"
"chr2","93939118","93939284","chr5","96084042","96084204","26","2144924"
"chr2","93939529","93939678","chr2B","94897282","94897419","36","957753"
"chr2","93964129","93964422","chr5","96070337","96070634","44","2106208"
"chr2","93988923","93989233","chr1","159721369","159721668","75","65732446"
"chr2","93990500","93990785","chr5","96051569","96051851","53","2061069"
"chr2","94038484","94038761","chr7","71210042","71210328","62","22828442"
"chr2","94052504","94052776","chr5","95983758","95984013","53","1931254"
"chr2","94057191","94057316","chr3","33473122","33473242","33","60584069"
"chr2","94057358","94057521","chr10","49585047","49585201","32","44472311"
"chr2","94063980","94064183","chr5","95971954","95972158","23","1907974"
"chr2","94077460","94077562","chr15","28217108","28217206","18","65860352"
"chr2","94110027","94110276","chr1","217102109","217102356","57","122992082"
"chr2","94148375","94148632","chr5","95891970","95892222","62","1743595"
"chr2","94152376","94152628","chr5","95888213","95888471","48","1735837"
"chr2","94168910","94169046","chr1","114541144","114541275","40","20372234"
"chr2","94288400","94288714","chr5","95760557","95760865","50","1472157"
"chr2","94308978","94309056","chr16","1896892","1896971","13","92412086"
"chr2","94309648","94309938","chr16","73314762","73315069","73","20994886"
"chr2","94334684","94334808","chr6","126525785","126525907","25","32191101"
"chr2","94337483","94337789","chr1","65527838","65528144","59","28809645"
"chr2","94357550","94357840","chr5","95697149","95697443","36","1339599"
"chr2","94422378","94422588","chr5","95623325","95623521","31","1200947"
"chr2","94465556","94465800","chr5","95553887","95554136","43","1088331"
"chr2","94584127","94584271","chr7","78925352","78925506","41","15658775"
"chr2","94616885","94617167","chr5","95404353","95404652","42","787468"
"chr2","94674705","94674827","chr5","95357389","95357511","13","682684"
"chr2","94680614","94680907","chr5","95350913","95351189","52","670299"
"chr2","94723836","94724138","chr5","95308750","95309053","37","584914"
"chr2","94743586","94743876","chr2A","43810091","43810385","63","50933495"
"chr2","94761570","94761690","chr5","95280130","95280251","13","518560"
"chr2","94815292","94815582","chr1","110444357","110444639","72","15629065"
"chr2","94852018","94852272","chr8","63370653","63370919","61","31481365"
"chr2","94977473","94977637","chr4","40325999","40326159","34","54651474"
"chr2","95084953","95085024","chr20","49674431","49674497","14","45410522"
"chr2","95203497","95203780","chr5","94861526","94861792","51","341971"
"chr2","95207247","95207375","chr9","43610380","43610507","30","51596867"
"chr2","95209750","95210068","chr5","94855576","94855883","83","354174"
"chr2","95233087","95233387","chr3","50836842","50837153","57","44396245"
"chr2","95471384","95471493","chr19","14292883","14292994","27","81178501"
"chr2","95499658","95499963","chr5","94562822","94563131","45","936836"
"chr2","95520879","95521189","chr5","94542249","94542553","40","978630"
"chr2","95547236","95547511","chr5","94514900","94515188","33","1032336"
"chr2","95553672","95553957","chr5","94508709","94509005","37","1044963"
"chr2","95581043","95581323","chr19","47297718","47298010","63","48283325"
"chr2","95763030","95763140","chr6","918066","918176","21","94844964"
"chr2","95872635","95872751","chr16","28244621","28244735","32","67628014"
"chr2","96157950","96158077","chr16","69212656","69212783","35","26945294"
"chr2","96328788","96329080","chr5","93734719","93735022","63","2594069"
"chr2","96423832","96424065","chr13","61193434","61193668","56","35230398"
"chr2","96477357","96477651","chr5","93593389","93593685","53","2883968"
"chr2","96490964","96491264","chr5","93578890","93579184","45","2912074"
"chr2","96703078","96703333","chr5","93396501","93396743","76","3306577"
"chr2","97176002","97176187","chr2A","45425233","45425415","54","51750769"
"chr2","97290965","97291249","chr5","92856410","92856687","33","4434555"
"chr2","97318644","97318949","chr5","92824427","92824751","56","4494217"
"chr2","97324713","97324996","chrX","151814008","151814288","39","54489295"
"chr2","97378342","97378645","chr5","92766751","92767054","35","4611591"
"chr2","97395261","97395571","chr18","60490322","60490631","52","36904939"
"chr2","97463708","97463997","chr5","92675278","92675583","64","4788430"
"chr2","97531307","97531586","chr18","19949790","19950070","57","77581517"
"chr2","97538703","97538861","chr19","53259341","53259506","38","44279362"
"chr2","97543705","97544000","chr5","92587714","92588013","33","4955991"
"chr2","97633610","97633893","chr5","92495790","92496086","43","5137820"
"chr2","97691913","97692225","chr15","44244841","44245146","61","53447072"
"chr2","97720107","97720384","chr9","79107790","79108074","80","18612317"
"chr2","97756150","97756428","chr19","4570608","4570877","63","93185542"
"chr2","98186223","98186504","chr12","113566395","113566678","65","15380172"
"chr2","98281236","98281349","chr8","145313247","145313365","20","47032011"
"chr2","98295087","98295161","chr11","111871639","111871703","20","13576552"
"chr2","98319302","98319393","chrX","16134701","16134796","24","82184601"
"chr2","98346766","98346857","chr5","91851283","91851375","13","6495483"
"chr2","98364560","98364842","chr5","91841649","91841932","44","6522911"
"chr2","98413056","98413344","chr5","91791705","91792006","44","6621351"
"chr2","98450968","98451263","chr1","227415933","227416230","63","128964965"
"chr2","98480364","98480494","chr5","91730587","91730721","20","6749777"
"chr2","98490129","98490413","chr5","91718254","91718539","25","6771875"
"chr2","98494425","98494716","chr5","91713560","91713856","40","6780865"
"chr2","98501874","98501978","chr5","91706701","91706811","20","6795173"
"chr2","98595458","98595756","chr5","91634445","91634728","67","6961013"
"chr2","98601360","98601580","chr19","50710233","50710443","52","47891127"
"chr2","98609893","98610175","chr5","91617086","91617349","38","6992807"
"chr2","98677618","98677927","chr18","34048248","34048557","69","64629370"
"chr2","98693898","98694115","chr1","6771390","6771609","55","91922508"
"chr2","98696551","98696837","chr5","91524811","91525066","53","7171740"
"chr2","98704448","98704752","chr5","91482346","91482649","49","7222102"
"chr2","98706094","98706372","chr5","55183837","55184103","61","43522257"
"chr2","98707145","98707440","chr5","91485038","91485334","35","7222107"
"chr2","98744927","98745251","chr5","91358343","91358638","53","7386584"
"chr2","98770890","98771179","chr5","91332183","91332473","34","7438707"
"chr2","98812854","98813157","chr5","91290620","91290923","27","7522234"
"chr2","98891171","98891324","chr10","49585047","49585201","31","49306124"
"chr2","99014608","99014870","chr5","91078187","91078414","63","7936421"
"chr2","99219691","99219979","chr5","90899446","90899727","49","8320245"
"chr2","99267078","99267317","chr5","90852524","90852762","44","8414554"
"chr2","99341989","99342272","chr5","90779302","90779612","45","8562687"
"chr2","99505043","99505193","chr22","20635435","20635596","39","78869608"
"chr2","99506524","99506632","chr11","80418072","80418188","22","19088452"
"chr2","99550437","99550722","chr4","110418993","110419280","70","10868556"
"chr2","99624780","99625062","chr5","90517393","90517682","44","9107387"
"chr2","99665029","99665323","chr5","90472149","90472445","50","9192880"
"chr2","99679281","99679368","chr22","29962889","29962981","21","69716392"
"chr2","99679433","99679557","chrX","46380008","46380132","21","53299425"
"chr2","99801297","99801566","chr5","90336993","90337278","43","9464304"
"chr2","100155203","100155500","chr5","90002678","90002981","50","10152525"
"chr2","100208863","100209150","chr5","89958026","89958315","35","10250837"
"chr2","100313283","100313379","chr3","198810321","198810416","19","98497038"
"chr2","100384056","100384155","chr1","113839333","113839427","23","13455277"
"chr2","100617902","100618061","chrX","17937151","17937313","32","82680751"
"chr2","100618208","100618254","chr6","87910209","87910256","7","12707999"
"chr2","100650859","100651131","chr14","14955144","14955434","81","85695715"
"chr2","100758803","100759101","chr9","45291748","45292044","65","55467055"
"chr2","100775585","100775739","chr5","156787834","156787995","41","56012249"
"chr2","101101401","101101462","chr1","52138720","52138778","14","48962681"
"chr2","101126007","101126305","chr1","29573482","29573789","42","71552525"
"chr2","101280177","101280326","chr1","31462343","31462496","36","69817834"
"chr2","101378358","101378571","chr5","88848004","88848221","31","12530354"
"chr2","101569121","101569366","chr3","127334100","127334354","75","25764979"
"chr2","101635855","101635995","chr4","171981996","171982135","36","70346141"
"chr2","101684269","101684550","chr5","88585093","88585391","44","13099176"
"chr2","101766090","101766197","chr14","86655798","86655913","27","15110292"
"chr2","102060493","102060806","chr5","88158755","88159084","56","13901738"
"chr2","102092892","102093015","chr5","88126168","88126290","16","13966724"
"chr2","102221820","102221928","chrX","49113443","49113558","27","53108377"
"chr2","102221934","102222061","chr6","36903926","36904055","25","65318008"
"chr2","102340207","102340422","chr5","87845940","87846162","29","14494267"
"chr2","102363233","102363456","chr5","87815862","87816095","44","14547371"
"chr2","102535580","102535889","chr1","16246484","16246765","90","86289096"
"chr2","102551773","102552084","chr16","41177911","41178209","73","61373862"
"chr2","102698586","102698872","chr5","87536682","87536990","49","15161904"
"chr2","103185905","103186212","chr5","87093348","87093659","47","16092557"
"chr2","103386002","103386277","chr5","86887277","86887569","58","16498725"
"chr2","103481310","103481599","chr1","40331351","40331633","69","63149959"
"chr2","103655600","103655842","chr5","86646685","86646926","29","17008915"
"chr2","103708355","103708647","chr5","86589006","86589297","40","17119349"
"chr2","103870799","103871091","chr5","86405315","86405614","47","17465484"
"chr2","103900573","103900865","chr18","74699165","74699460","68","29201408"
"chr2","104019983","104020281","chr5","86275303","86275592","49","17744680"
"chr2","104031585","104031722","chr1","21301496","21301630","37","82730089"
"chr2","104095251","104095372","chr1","61407572","61407685","33","42687679"
"chr2","104134159","104134456","chr5","86150524","86150822","26","17983635"
"chr2","104154367","104154681","chr5","86132501","86132818","56","18021866"
"chr2","104255648","104255922","chr19","47251420","47251686","54","57004228"
"chr2","104308513","104308809","chr5","85986251","85986535","55","18322262"
"chr2","104429407","104429698","chr5","85855285","85855573","40","18574122"
"chr2","104565575","104565840","chr16","31649333","31649595","51","72916242"
"chr2","104574534","104574653","chr4","89648080","89648203","24","14926454"
"chr2","104854928","104855224","chr16","14575570","14575864","62","90279358"
"chr2","104908260","104908404","chr1","110280511","110280665","38","5372251"
"chr2","104942263","104942556","chr5","85334941","85335253","53","19607322"
"chr2","105027801","105027915","chr5","85265565","85265685","18","19762236"
"chr2","105044603","105044686","chr2B","106023545","106023629","18","978942"
"chr2","105046511","105046680","chr15","69406665","69406835","50","35639846"
"chr2","105061939","105062203","chr16","74955214","74955488","69","30106725"
"chr2","105109397","105109689","chr5","85188311","85188614","52","19921086"
"chr2","105161809","105161886","chrX","45266747","45266826","13","59895062"
"chr2","105161911","105162018","chr7","68275138","68275242","28","36886773"
"chr2","105412287","105412559","chr5","84844076","84844353","33","20568211"
"chr2","105440466","105440717","chr5","84823116","84823338","54","20617350"
"chr2","105675386","105675500","chr9","92714929","92715046","20","12960457"
"chr2","105721009","105721299","chr5","84545611","84545896","57","21175398"
"chr2","105839527","105839829","chr5","84441425","84441718","62","21398102"
"chr2","105916330","105916596","chr3","38885464","38885724","76","67030866"
"chr2","105966987","105967158","chr2A","103770599","103770776","46","2196388"
"chr2","106018392","106018672","chr5","84239806","84240094","49","21778586"
"chr2","106020035","106020164","chr2A","53681480","53681606","27","52338555"
"chr2","106590481","106590600","chr15","62835430","62835550","25","43755051"
"chr2","106607210","106607507","chr5","83575486","83575789","41","23031724"
"chr2","107226357","107226635","chr6","170605547","170605810","91","63379190"
"chr2","107340819","107340958","chr5","143871700","143871840","33","36530881"
"chr2","108121223","108121492","chr4","94451130","94451398","65","13670093"
"chr2","108180733","108181029","chr5","83086700","83087016","52","25094033"
"chr2","108315135","108315401","chr5","82275083","82275358","51","26040052"
"chr2","108336160","108336323","chr5","82260553","82260707","32","26075607"
"chr2","108681534","108681842","chr4","40024168","40024472","69","68657366"
"chr2","108694334","108694623","chr4","48083262","48083568","68","60611072"
"chr2","108724431","108724539","chr12","121105622","121105732","15","12381191"
"chr2","108750437","108750730","chr4","41244247","41244538","58","67506190"
"chr2","108757608","108757892","chr5","82003657","82003945","38","26753951"
"chr2","108760166","108760291","chr5","82001255","82001379","11","26758911"
"chr2","108761728","108761890","chr6","162551622","162551785","39","53789894"
"chr2","108789906","108790053","chr1","205548459","205548612","32","96758553"
"chr2","108794140","108794255","chr1","130889305","130889428","24","22095165"
"chr2","108795186","108795351","chr10","58638831","58638996","39","50156355"
"chr2","108800933","108801237","chr5","81946877","81947191","53","26854056"
"chr2","108817658","108817761","chr6","13090658","13090763","19","95727000"
"chr2","108828136","108828257","chr5","81940022","81940139","12","26888114"
"chr2","108895284","108895586","chr5","81874982","81875304","51","27020302"
"chr2","108978503","108978811","chr5","81796489","81796777","56","27182014"
"chr2","109066977","109067092","chr5","81720508","81720629","25","27346469"
"chr2","109083665","109083822","chr12","92392920","92393081","35","16690745"
"chr2","109100063","109100216","chr16","58417063","58417214","32","50683000"
"chr2","109115995","109116303","chr5","81627677","81627971","47","27488318"
"chr2","109166379","109166683","chr1","205812273","205812575","70","96645894"
"chr2","109221331","109221422","chr3","189257046","189257140","21","80035715"
"chr2","109227475","109227601","chr16","43765373","43765497","18","65462102"
"chr2","109493123","109493434","chr5","81268968","81269267","54","28224155"
"chr2","109512256","109512368","chr6","54568968","54569085","19","54943288"
"chr2","109639823","109640128","chr7","68214231","68214545","73","41425592"
"chr2","109665936","109666098","chr3","10866047","10866211","37","98799889"
"chr2","109705166","109705289","chr14","45368777","45368900","22","64336389"
"chr2","109745442","109745741","chr5","81012845","81013146","65","28732597"
"chr2","109814945","109815166","chr5","80943577","80943795","44","28871368"
"chr2","109955888","109955994","chr10","27439136","27439242","21","82516752"
"chr2","109973290","109973414","chr5","80785479","80785603","19","29187811"
"chr2","110022761","110023052","chr5","80748535","80748823","33","29274226"
"chr2","110060608","110060929","chr5","80675286","80675597","41","29385322"
"chr2","110104850","110105157","chr5","80637781","80638066","54","29467069"
"chr2","110308015","110308305","chr5","80428663","80428961","51","29879352"
"chr2","110317224","110317530","chr8","61200178","61200482","64","49117046"
"chr2","110405678","110405802","chr5","80273709","80273834","23","30131969"
"chr2","110447335","110447459","chr5","80208930","80209053","14","30238405"
"chr2","110454000","110454314","chr19","33330588","33330902","74","77123412"
"chr2","110523932","110524242","chr5","80121711","80122025","41","30402221"
"chr2","110678633","110678912","chr5","79973288","79973580","32","30705345"
"chr2","110769359","110769660","chr22","4369027","4369327","74","106400332"
"chr2","110769798","110769926","chr1","23480685","23480816","27","87289113"
"chr2","110800564","110800869","chr5","79856024","79856312","43","30944540"
"chr2","110804527","110804842","chr13","77246564","77246876","59","33557963"
"chr2","110850505","110850640","chr1","68709407","68709549","33","42141098"
"chr2","110850783","110850901","chr5","79787865","79787982","10","31062918"
"chr2","110899980","110900271","chr10","51367781","51368081","38","59532199"
"chr2","111011255","111011364","chr1","221790148","221790254","24","110778893"
"chr2","111011560","111011765","chr17","1429564","1429780","44","109581996"
"chr2","111016452","111016651","chr5","79684738","79684936","25","31331714"
"chr2","111030652","111030956","chr19","2366218","2366516","62","108664434"
"chr2","111076203","111076303","chr5","79630137","79630243","10","31446066"
"chr2","111169707","111169968","chr5","51674902","51675165","64","59494805"
"chr2","111222281","111222325","chr3","169444492","169444534","11","58222211"
"chr2","111222525","111222658","chr15","22019347","22019478","26","89203178"
"chr2","111284729","111284872","chr5","79386832","79386975","11","31897897"
"chr2","111613136","111613244","chr5","79026120","79026226","17","32587016"
"chr2","111617166","111617282","chr7","135190693","135190812","27","23573527"
"chr2","111624425","111624690","chr5","79006616","79006880","28","32617809"
"chr2","111652899","111653208","chr5","78977031","78977325","49","32675868"
"chr2","111690030","111690147","chr5","78941167","78941287","20","32748863"
"chr2","111694012","111694281","chr5","78937335","78937609","41","32756677"
"chr2","111716680","111716985","chr5","78913348","78913642","50","32803332"
"chr2","111719851","111720127","chr5","78909733","78910003","25","32810118"
"chr2","111733952","111734235","chr7","1708256","1708538","48","110025696"
"chr2","111779637","111779893","chr5","78848921","78849201","49","32930716"
"chr2","111844542","111844699","chr21","37140540","37140698","33","74704002"
"chr2","111907071","111907339","chr5","78730880","78731150","41","33176191"
"chr2","112017677","112017969","chr5","78612198","78612510","52","33405479"
"chr2","112023451","112023728","chr5","78606157","78606412","57","33417294"
"chr2","112106881","112107165","chr5","78520725","78521014","40","33586156"
"chr2","112147189","112147336","chr7","72465626","72465775","36","39681563"
"chr2","112258950","112259240","chrX","27099434","27099725","59","85159516"
"chr2","112329514","112329627","chr1","112995255","112995372","28","665741"
"chr2","112329955","112330217","chr5","78326926","78327181","33","34003029"
"chr2","112363265","112363558","chr19","57516560","57516855","64","54846705"
"chr2","112445883","112446012","chr20","30226146","30226280","31","82219737"
"chr2","112562084","112562380","chr5","78101096","78101402","50","34460988"
"chr2","112744280","112744412","chr22","30338462","30338593","19","82405818"
"chr2","112809218","112809496","chr10","108040748","108041024","60","4768470"
"chr2","112867969","112868268","chr1","219563213","219563498","73","106695244"
"chr2","112946513","112946849","chr7","100177078","100177417","106","12769435"
"chr2","112968307","112968440","chr20","36705924","36706059","31","76262383"
"chr2","113085110","113085406","chr5","77576270","77576564","60","35508840"
"chr2","113090669","113090950","chr2A","14658362","14658631","70","98432307"
"chr2","113105418","113105638","chr1","21058477","21058695","48","92046941"
"chr2","113145779","113146068","chr5","77492040","77492312","57","35653739"
"chr2","113177903","113178196","chr5","77457649","77457954","45","35720254"
"chr2","113244328","113244561","chr5","77379346","77379583","31","35864982"
"chr2","113359638","113359971","chr14","36436081","36436394","75","76923557"
"chr2","113367054","113367350","chr5","77229551","77229843","30","36137503"
"chr2","113421383","113421659","chr5","77172734","77173010","29","36248649"
"chr2","113496759","113496927","chr5","46596649","46596821","35","66900110"
"chr2","113526793","113527084","chr4","200583850","200584138","65","87057057"
"chr2","113543706","113543983","chr5","77059685","77059944","63","36484021"
"chr2","113651830","113651993","chr18","14541461","14541626","35","99110369"
"chr2","113731384","113731685","chr5","76839059","76839351","56","36892325"
"chr2","113800826","113801139","chr5","76761781","76762074","70","37039045"
"chr2","113923234","113923528","chr5","76652677","76652948","55","37270557"
"chr2","113944192","113944396","chr6","132100375","132100579","47","18156183"
"chr2","114017964","114018221","chr5","76558293","76558549","33","37459671"
"chr2","114029663","114029945","chr5","76540214","76540508","55","37489449"
"chr2","114121638","114121943","chr5","76455415","76455684","69","37666223"
"chr2","114124734","114125020","chr6","17529995","17530282","60","96594739"
"chr2","114243580","114243708","chr9","56631383","56631513","26","57612197"
"chr2","114243998","114244288","chr9","15217563","15217854","57","99026435"
"chr2","114321079","114321201","chr2B","132342636","132342758","19","18021557"
"chr2","114603562","114603790","chr7","32821026","32821256","57","81782536"
"chr2","114955888","114955970","chr5","75695411","75695493","9","39260477"
"chr2","115002700","115002989","chr5","75646282","75646576","34","39356418"
"chr2","115237034","115237228","chr15","61589063","61589258","57","53647971"
"chr2","115432416","115432649","chr5","75241598","75241855","65","40190818"
"chr2","115756028","115756295","chr5","74916428","74916687","39","40839600"
"chr2","115784522","115784796","chr9","111951914","111952192","70","3832608"
"chr2","115982171","115982472","chr11","127439040","127439341","74","11456869"
"chr2","116078919","116079124","chr4","97856771","97856985","55","18222148"
"chr2","116079199","116079295","chr19","49971385","49971478","28","66107814"
"chr2","116080160","116080406","chr18","5462028","5462280","55","110618132"
"chr2","116185998","116186293","chr5","74469859","74470146","43","41716139"
"chr2","116233788","116233880","chr2B","74186352","74186439","21","42047436"
"chr2","116353937","116354164","chr5","74305769","74305998","35","42048168"
"chr2","116369756","116370035","chr5","36272938","36273210","71","80096818"
"chr2","116427451","116427567","chr5","74230813","74230930","11","42196638"
"chr2","116496527","116496771","chr17","22186961","22187252","71","94309566"
"chr2","116537370","116537664","chr5","74135314","74135609","39","42402056"
"chr2","116545300","116545627","chr10","27733001","27733303","100","88812299"
"chr2","116606962","116607257","chr5","74067549","74067848","31","42539413"
"chr2","116615451","116615746","chr5","74059192","74059484","29","42556259"
"chr2","116619529","116619661","chr19","37785588","37785721","23","78833941"
"chr2","116703000","116703178","chr3","12729954","12730128","38","103973046"
"chr2","116760165","116760425","chr5","73919731","73920005","46","42840434"
"chr2","116768752","116769042","chr1","45616536","45616828","57","71152216"
"chr2","116789318","116789614","chr5","73894324","73894619","33","42894994"
"chr2","116812949","116813249","chr5","73875657","73875958","35","42937292"
"chr2","116843451","116843619","chr5","73849002","73849165","32","42994449"
"chr2","116883682","116883941","chr5","73817277","73817532","31","43066405"
"chr2","116898762","116899028","chr7","148971292","148971566","69","32072530"
"chr2","116900403","116900651","chr5","73801484","73801732","23","43098919"
"chr2","116941374","116941671","chr5","73767660","73767954","35","43173714"
"chr2","117035447","117035749","chr5","73665136","73665423","52","43370311"
"chr2","117052982","117053262","chr5","73648221","73648484","47","43404761"
"chr2","117059581","117059720","chr5","73641525","73641679","29","43418056"
"chr2","117133001","117133238","chr5","73551802","73552039","33","43581199"
"chr2","117138202","117138487","chr5","73546531","73546815","25","43591671"
"chr2","117167471","117167747","chr6","99295390","99295672","67","17872081"
"chr2","117173739","117174008","chr5","73503014","73503298","48","43670725"
"chr2","117242615","117242912","chr5","73446600","73446890","49","43796015"
"chr2","117258714","117258946","chr7","3178634","3178870","64","114080080"
"chr2","117287631","117287905","chr12","120585921","120586203","73","3298290"
"chr2","117334832","117335137","chr5","73352761","73353055","47","43982071"
"chr2","117414937","117415095","chr4","61055093","61055253","33","56359844"
"chr2","117438802","117439118","chr5","73259149","73259470","46","44179653"
"chr2","117484309","117484608","chr5","73233027","73233333","43","44251282"
"chr2","117515966","117516088","chr5","73199885","73200008","16","44316081"
"chr2","117550208","117550506","chr5","73167014","73167324","51","44383194"
"chr2","117681191","117681489","chr11","77085607","77085905","61","40595584"
"chr2","117686815","117687130","chr2B","19221731","19222038","84","98465084"
"chr2","118031324","118031635","chr11","32496306","32496601","90","85535018"
"chr2","118095026","118095318","chr5","72643460","72643757","27","45451566"
"chr2","118138086","118138172","chr5","126607895","126607978","19","8469809"
"chr2","118422819","118423148","chr16","11742890","11743208","82","106679929"
"chr2","118498905","118499191","chr1","227415933","227416230","72","108917028"
"chr2","118675797","118675983","chr5","72087915","72088113","41","46587882"
"chr2","118959452","118959767","chr5","71806368","71806678","80","47153084"
"chr2","119030890","119031195","chr8","86057034","86057346","82","32973856"
"chr2","119136247","119136517","chr5","71621984","71622261","31","47514263"
"chr2","119223573","119223875","chr5","71534856","71535155","41","47688717"
"chr2","119237209","119237512","chr1","23594497","23594788","68","95642712"
"chr2","119617184","119617427","chr1","71050546","71050792","51","48566638"
"chr2","119653788","119653952","chr5","51144248","51144411","35","68509540"
"chr2","119693740","119694028","chr5","71098679","71098948","52","48595061"
"chr2","119699569","119699726","chr9","111094911","111095071","37","8604658"
"chr2","119706402","119706559","chr19","6609732","6609893","37","113096670"
"chr2","119726624","119726744","chr5","71063942","71064062","13","48662682"
"chr2","119744167","119744293","chr5","71040521","71040653","22","48703646"
"chr2","119760789","119761046","chr5","71024904","71025176","44","48735885"
"chr2","119767026","119767331","chr5","71019057","71019374","45","48747969"
"chr2","119779635","119779735","chr20","44186454","44186552","24","75593181"
"chr2","119882769","119882874","chr4","1726627","1726733","18","118156142"
"chr2","119912168","119912462","chr5","70875827","70876119","37","49036341"
"chr2","120190899","120191082","chr5","70554648","70554844","37","49636251"
"chr2","120219146","120219259","chr12","32532668","32532780","18","87686478"
"chr2","120571031","120571137","chr6","101864292","101864398","21","18706739"
"chr2","120742112","120742405","chr5","70072295","70072600","50","50669817"
"chr2","120800433","120800741","chr1","207939864","207940172","60","87139431"
"chr2","120822054","120822342","chr5","69990590","69990889","37","50831464"
"chr2","120830322","120830606","chr5","69985492","69985788","46","50844830"
"chr2","120831964","120832096","chr5","69983749","69983882","19","50848215"
"chr2","120854404","120854489","chr7","72771713","72771797","14","48082691"
"chr2","120885040","120885121","chr5","69921029","69921110","11","50964011"
"chr2","121024210","121024491","chr5","69781675","69781968","45","51242535"
"chr2","121085738","121086026","chr5","69723777","69724064","55","51361961"
"chr2","121189797","121190088","chr5","69618222","69618516","45","51571575"
"chr2","121200545","121200684","chr20","32123638","32123783","40","89076907"
"chr2","121272721","121273039","chr5","69505345","69505658","49","51767376"
"chr2","121382828","121383127","chr5","69396901","69397195","63","51985927"
"chr2","121469262","121469541","chr3","140583382","140583663","68","19114120"
"chr2","121617801","121618088","chr5","69157348","69157624","47","52460453"
"chr2","121850988","121851159","chr6","5317435","5317603","46","116533553"
"chr2","121954025","121954311","chr5","68763575","68763870","73","53190450"
"chr2","121955408","121955551","chr5","68762264","68762403","21","53193144"
"chr2","121979306","121979517","chr2B","24386095","24386301","54","97593211"
"chr2","122151177","122151475","chr5","68614599","68614920","67","53536578"
"chr2","122336145","122336269","chr4","39402464","39402586","21","82933681"
"chr2","122595461","122595722","chr3","102615240","102615514","69","19980221"
"chr2","122646682","122646895","chr13","59755272","59755493","43","62891410"
"chr2","122781700","122781891","chr5","67948105","67948287","47","54833595"
"chr2","123159417","123159609","chr5","67567361","67567566","45","55592056"
"chr2","123477883","123478147","chr5","67241281","67241550","66","56236602"
"chr2","123565593","123565874","chr6","159403852","159404118","66","35838259"
"chr2","123672260","123672399","chr19","54938369","54938502","28","68733891"
"chr2","123821250","123821569","chr5","66887392","66887697","57","56933858"
"chr2","123827216","123827493","chr8","24737260","24737543","64","99089956"
"chr2","124010339","124010598","chr5","95553887","95554136","68","28456452"
"chr2","124065831","124066094","chr5","66577636","66577898","41","57488195"
"chr2","124391584","124391784","chr11","58619029","58619230","42","65772555"
"chr2","124633589","124633908","chr5","66031022","66031318","64","58602567"
"chr2","124677647","124677970","chr5","65991634","65991933","61","58686013"
"chr2","124698584","124698722","chr9","47369076","47369207","26","77329508"
"chr2","124835330","124835606","chr5","65831769","65832073","64","59003561"
"chr2","124942694","124943018","chr5","65684202","65684526","31","59258492"
"chr2","124973316","124973473","chr1","223894247","223894395","40","98920931"
"chr2","125027814","125027944","chr3","144886878","144887008","25","19859064"
"chr2","125028170","125028313","chr6","72877221","72877366","33","52150949"
"chr2","125169226","125169526","chr5","65477322","65477618","38","59691904"
"chr2","125282493","125282784","chrX","13738396","13738688","66","111544097"
"chr2","125384124","125384244","chr12","34294149","34294270","26","91089975"
"chr2","125659954","125660258","chr5","65028241","65028542","31","60631713"
"chr2","125797318","125797451","chr20","12427300","12427431","25","113370018"
"chr2","125867046","125867136","chr5","4826063","4826153","29","121040983"
"chr2","125871123","125871435","chr2A","15320386","15320690","69","110550737"
"chr2","125881133","125881423","chr5","64806239","64806553","51","61074894"
"chr2","125947258","125947429","chrX","24172773","24172936","37","101774485"
"chr2","125965378","125965455","chr7","137563832","137563911","20","11598454"
"chr2","125976501","125976628","chr5","64722167","64722289","26","61254334"
"chr2","126004982","126005098","chr5","64698061","64698189","22","61306921"
"chr2","126060817","126060940","chr2B","3859236","3859359","20","122201581"
"chr2","126098074","126098348","chr16","40536206","40536485","62","85561868"
"chr2","126124044","126124346","chr5","64574234","64574530","41","61549810"
"chr2","126151046","126151291","chr5","64541639","64541892","31","61609407"
"chr2","126155099","126155248","chr7","129057843","129057995","41","2902744"
"chr2","126246319","126246614","chr5","64455340","64455634","30","61790979"
"chr2","126387098","126387389","chr6","38634704","38634994","61","87752394"
"chr2","126761125","126761235","chr6","89356169","89356280","28","37404956"
"chr2","126775379","126775656","chr10","129217595","129217874","57","2442216"
"chr2","126785774","126786066","chr4","26142235","26142519","71","100643539"
"chr2","126809719","126809967","chr5","63885553","63885802","34","62924166"
"chr2","126815105","126815392","chr5","63880405","63880711","48","62934700"
"chr2","126847357","126847486","chr6","42782331","42782460","24","84065026"
"chr2","126876242","126876550","chr16","4522321","4522629","65","122353921"
"chr2","127003049","127003347","chr1","45145246","45145545","61","81857803"
"chr2","127021521","127021813","chr5","63679675","63679976","37","63341846"
"chr2","127200106","127200392","chr5","63510276","63510559","35","63689830"
"chr2","127232646","127232948","chr5","63484067","63484387","45","63748579"
"chr2","127234177","127234311","chr5","63482186","63482320","6","63751991"
"chr2","127465407","127465550","chr5","3296328","3296466","36","124169079"
"chr2","127475152","127475439","chr5","63257097","63257371","34","64218055"
"chr2","127485936","127486131","chr9","94824992","94825159","59","32660944"
"chr2","127497382","127497674","chr13","76851128","76851422","68","50646254"
"chr2","127524955","127525078","chr5","63216431","63216559","20","64308524"
"chr2","127535412","127535702","chr12","125247508","125247799","62","2287904"
"chr2","127624196","127624454","chr9","108374163","108374412","67","19250033"
"chr2","127634071","127634296","chrX","154804305","154804526","46","27170234"
"chr2","127646281","127646404","chr1","131922955","131923079","20","4276674"
"chr2","127690602","127690906","chr17","15917650","15917958","42","111772952"
"chr2","127698313","127698596","chr17","15926415","15926710","41","111771898"
"chr2","127722429","127722539","chr3","50276245","50276352","21","77446184"
"chr2","127745174","127745460","chr17","15958321","15958596","42","111786853"
"chr2","127746385","127746676","chr17","15959500","15959794","40","111786885"
"chr2","127751018","127751296","chr7","66323316","66323582","78","61427702"
"chr2","127777594","127777895","chr17","15997707","15998013","40","111779887"
"chr2","127789219","127789504","chr17","16007723","16008026","45","111781496"
"chr2","127811173","127811484","chr17","16037867","16038178","27","111773306"
"chr2","127816929","127817224","chr17","16043316","16043624","50","111773613"
"chr2","127861191","127861484","chr17","16098358","16098669","52","111762833"
"chr2","127871328","127871624","chr17","16111561","16111855","42","111759767"
"chr2","127877756","127877903","chr7","1328733","1328881","27","126549023"
"chr2","127879977","127880050","chrX","39391833","39391905","17","88488144"
"chr2","127925557","127925690","chr7","26158438","26158564","32","101767119"
"chr2","128009781","128009976","chrX","48026975","48027157","56","79982806"
"chr2","128022150","128022424","chr19","44463058","44463331","65","83559092"
"chr2","128043608","128043884","chr7","1708256","1708538","59","126335352"
"chr2","128068289","128068403","chr17","16297892","16298008","20","111770397"
"chr2","128084432","128084695","chr5","40471033","40471294","70","87613399"
"chr2","128090356","128090404","chr10","46630120","46630171","13","81460236"
"chr2","128091606","128091777","chr19","18112321","18112488","34","109979285"
"chr2","128109761","128110085","chr17","16337009","16337311","64","111772752"
"chr2","128123080","128123361","chr17","16351666","16351956","34","111771414"
"chr2","128124296","128124446","chr6","36782155","36782293","28","91342141"
"chr2","128128830","128129124","chr17","16357354","16357646","55","111771476"
"chr2","128155219","128155382","chr12","123193562","123193727","41","4961657"
"chr2","128297920","128298214","chr17","16525212","16525506","35","111772708"
"chr2","128315738","128315932","chr17","16549587","16549784","34","111766151"
"chr2","128380740","128380855","chrX","137809594","137809710","21","9428854"
"chr2","128392569","128392657","chr16","38639741","38639826","24","89752828"
"chr2","128393909","128394035","chr1","9649520","9649644","34","118744389"
"chr2","128396660","128396950","chr17","16628505","16628799","36","111768155"
"chr2","128400297","128400593","chr10","34420389","34420685","53","93979908"
"chr2","128414271","128414399","chr19","2762388","2762514","19","125651883"
"chr2","128438589","128438668","chr17","16669035","16669119","13","111769554"
"chr2","128470277","128470573","chr17","16733712","16734018","48","111736565"
"chr2","128504920","128505214","chr17","16771564","16771853","41","111733356"
"chr2","128554667","128554951","chr17","16822464","16822767","48","111732203"
"chr2","128573147","128573332","chr17","16838712","16838914","38","111734435"
"chr2","128578683","128578979","chrX","20042577","20042864","62","108536106"
"chr2","128613823","128614102","chr9","71434336","71434622","67","57179487"
"chr2","128702581","128702852","chr17","16987110","16987375","44","111715471"
"chr2","128711209","128711488","chr17","16995025","16995318","47","111716184"
"chr2","128729149","128729432","chr17","17003670","17003970","70","111725479"
"chr2","128747943","128748230","chr7","71995239","71995523","59","56752704"
"chr2","128759355","128759480","chr17","17033511","17033640","16","111725844"
"chr2","128765736","128766046","chr17","17039925","17040224","41","111725811"
"chr2","128808598","128808909","chr17","17083364","17083642","63","111725234"
"chr2","128846557","128846837","chr4","8568976","8569269","67","120277581"
"chr2","128847529","128847818","chr17","17115824","17116121","49","111731705"
"chr2","128850134","128850445","chr6","1282587","1282891","66","127567547"
"chr2","128852781","128853070","chr17","17120915","17121196","43","111731866"
"chr2","128854167","128854391","chr14","75108898","75109124","43","53745269"
"chr2","128854888","128855188","chrX","45312486","45312789","56","83542402"
"chr2","128875932","128876196","chr12","23452142","23452409","60","105423790"
"chr2","128876629","128876903","chr14","76943072","76943349","58","51933557"
"chr2","128892947","128893233","chr17","17133515","17133804","34","111759432"
"chr2","128927477","128927602","chr19","8384377","8384500","20","120543100"
"chr2","128945631","128945747","chr17","17180914","17181029","22","111764717"
"chr2","128963698","128963949","chr1","66995914","66996176","61","61967784"
"chr2","128968061","128968342","chr17","17204249","17204528","36","111763812"
"chr2","128982264","128982389","chr1","61407572","61407685","36","67574692"
"chr2","128983125","128983276","chr22","20288134","20288276","45","108694991"
"chr2","128995442","128995638","chr19","15967693","15967882","41","113027749"
"chr2","129019750","129020025","chr17","17241251","17241540","57","111778499"
"chr2","129048009","129048107","chr12","1916245","1916355","24","127131764"
"chr2","129048906","129049183","chr17","17272668","17272946","25","111776238"
"chr2","129056653","129056816","chr15","67737918","67738076","32","61318735"
"chr2","129076729","129077004","chr17","17302691","17302976","41","111774038"
"chr2","129080653","129080922","chr11","47743928","47744196","65","81336725"
"chr2","129086687","129086838","chr16","80955590","80955736","34","48131097"
"chr2","129095131","129095474","chr7","72538541","72538855","95","56556590"
"chr2","129140118","129140417","chr17","17366543","17366811","61","111773575"
"chr2","129152537","129152747","chr1","128515373","128515560","52","637164"
"chr2","129196698","129196997","chr17","17408180","17408461","44","111788518"
"chr2","129393087","129393276","chr2B","62135321","62135506","41","67257766"
"chr2","129417605","129417903","chr11","61234762","61235056","58","68182843"
"chr2","129438786","129439095","chr19","46062191","46062484","62","83376595"
"chr2","129471462","129471757","chr17","17638959","17639256","47","111832503"
"chr2","129501895","129502011","chr1","182798095","182798212","16","53296200"
"chr2","129502216","129502509","chr7","76725084","76725378","65","52777132"
"chr2","129516961","129517252","chr3","143449072","143449369","60","13932111"
"chr2","129553956","129554258","chr17","17713259","17713558","38","111840697"
"chr2","129591913","129591993","chr1","215499639","215499714","22","85907726"
"chr2","129604149","129604283","chr17","17762548","17762672","18","111841601"
"chr2","129624040","129624332","chr17","17798840","17799151","63","111825200"
"chr2","129631785","129632083","chr17","17790424","17790726","43","111841361"
"chr2","129701814","129702093","chr16","44950318","44950595","61","84751496"
"chr2","129762723","129763024","chr17","17937854","17938154","28","111824869"
"chr2","129821785","129822098","chr17","17997091","17997416","54","111824694"
"chr2","129878022","129878309","chr17","18074798","18075105","53","111803224"
"chr2","129900496","129900621","chr17","18096857","18096982","16","111803639"
"chr2","129926929","129927121","chr1","14883371","14883564","36","115043558"
"chr2","130037197","130037504","chr17","18185751","18186052","31","111851446"
"chr2","130057970","130058269","chr17","18206085","18206362","44","111851885"
"chr2","130178031","130178294","chr17","18317947","18318228","45","111860084"
"chr2","130258165","130258448","chr3","23601459","23601740","60","106656706"
"chr2","130337837","130338094","chr16","14907479","14907738","58","115430358"
"chr2","130420818","130421112","chr16","10963785","10964082","60","119457033"
"chr2","130461188","130461373","chr6","15594489","15594666","32","114866699"
"chr2","130523718","130524012","chr17","18689434","18689736","40","111834284"
"chr2","130528308","130528391","chrX","49516530","49516615","12","81011778"
"chr2","130549363","130549484","chr7","11248117","11248241","22","119301246"
"chr2","130549637","130549794","chr6","172043667","172043823","41","41494030"
"chr2","130574264","130574556","chr7","154281233","154281526","64","23706969"
"chr2","130623945","130624231","chr17","18779390","18779677","25","111844555"
"chr2","130642308","130642458","chr22","8436942","8437088","31","122205366"
"chr2","130727387","130727647","chr17","18891773","18892045","40","111835614"
"chr2","130766533","130766649","chr6","38593130","38593246","24","92173403"
"chr2","130903222","130903337","chr22","14821499","14821616","17","116081723"
"chr2","131173644","131173761","chr6","139329970","139330083","20","8156326"
"chr2","131221843","131222128","chr6","136146862","136147150","47","4925019"
"chr2","131258967","131259259","chr20","33902113","33902397","71","97356854"
"chr2","131263034","131263311","chr6","87606836","87607116","53","43656198"
"chr2","131307785","131308083","chr17","19426711","19427016","39","111881074"
"chr2","131320823","131320939","chr17","19439034","19439142","15","111881789"
"chr2","131340440","131340748","chr17","19461210","19461507","49","111879230"
"chr2","131359910","131360218","chr17","19484772","19485086","56","111875138"
"chr2","131439086","131439361","chr16","58599239","58599519","65","72839847"
"chr2","131457275","131457596","chr10","115003423","115003724","59","16453852"
"chr2","131457608","131457893","chr2A","44197048","44197328","58","87260560"
"chr2","131458027","131458333","chr17","19638053","19638358","52","111819974"
"chr2","131459077","131459203","chr17","19639339","19639471","19","111819738"
"chr2","131497777","131498022","chr17","19689636","19689920","61","111808141"
"chr2","131532123","131532424","chr17","19727158","19727461","35","111804965"
"chr2","131541561","131541804","chr9","30401211","30401465","68","101140350"
"chr2","131547064","131547241","chr7","129723493","129723673","56","1823571"
"chr2","131575997","131576287","chrX","72345135","72345425","62","59230862"
"chr2","131590472","131590757","chr17","19782125","19782421","52","111808347"
"chr2","131602171","131602342","chr2A","68861570","68861739","38","62740601"
"chr2","131659036","131659322","chr17","19841045","19841346","54","111817991"
"chr2","131669812","131670106","chr10","135894099","135894399","71","4224287"
"chr2","131752733","131753043","chr17","19922575","19922866","51","111830158"
"chr2","131806246","131806510","chr13","62079632","62079885","72","69726614"
"chr2","131822017","131822317","chr1","64637364","64637674","71","67184653"
"chr2","131840825","131841118","chr17","20016858","20017168","50","111823967"
"chr2","131860570","131860704","chrX","2794957","2795096","32","129065613"
"chr2","131878193","131878489","chr7","72961267","72961564","69","58916926"
"chr2","131930093","131930215","chr17","20104830","20104952","14","111825263"
"chr2","131944501","131944799","chr1","227388363","227388665","62","95443862"
"chr2","131970913","131971176","chrX","68277774","68278045","62","63693139"
"chr2","131974419","131974734","chr17","20148774","20149085","56","111825645"
"chr2","131990141","131990302","chr5","118399435","118399596","36","13590706"
"chr2","131998299","131998417","chrX","43772988","43773106","17","88225311"
"chr2","132018596","132018761","chr18","68328783","68328941","33","63689813"
"chr2","132038333","132038602","chr17","20215534","20215806","37","111822799"
"chr2","132056003","132056278","chr16","10990129","10990417","62","121065874"
"chr2","132106063","132106354","chr17","20279673","20279992","59","111826390"
"chr2","132145873","132145964","chr12","111845659","111845746","21","20300214"
"chr2","132203277","132203551","chr19","15372801","15373074","60","116830476"
"chr2","132205141","132205436","chr1","191202899","191203180","58","58997758"
"chr2","132227606","132227891","chr17","20394137","20394429","57","111833469"
"chr2","132505398","132505478","chr5","36110533","36110617","21","96394865"
"chr2","132556372","132556514","chr1","39740056","39740201","36","92816316"
"chr2","132649927","132650042","chr17","20812714","20812836","14","111837213"
"chr2","132662347","132662456","chr17","20826934","20827045","11","111835413"
"chr2","132728819","132729137","chr17","20883370","20883650","61","111845449"
"chr2","132739413","132739589","chrX","19843652","19843828","33","112895761"
"chr2","132740517","132740633","chr5","22710618","22710735","21","110029899"
"chr2","132759397","132759707","chr20","31950072","31950384","59","100809325"
"chr2","132774701","132775006","chr17","20939691","20939989","42","111835010"
"chr2","132777549","132777841","chr17","20942539","20942825","43","111835010"
"chr2","132815833","132816134","chr17","20987707","20988016","48","111828126"
"chr2","132818840","132819142","chr17","20990436","20990741","35","111828404"
"chr2","132829011","132829301","chr17","20999310","20999597","36","111829701"
"chr2","132832571","132832759","chr6","58562821","58563005","59","74269750"
"chr2","132835445","132835569","chr4","99016771","99016893","22","33818674"
"chr2","132835576","132835632","chr7","23547259","23547322","20","109288317"
"chr2","132838581","132838850","chr2B","9535794","9536067","54","123302787"
"chr2","132854115","132854410","chr17","21019337","21019600","71","111834778"
"chr2","132868921","132869024","chr7","40123307","40123412","21","92745614"
"chr2","132915354","132915644","chr1","29519160","29519451","77","103396194"
"chr2","132944276","132944570","chr6","172320100","172320391","58","39375824"
"chr2","132949996","132950214","chr16","76201808","76202028","57","56748188"
"chr2","132961298","132961581","chr17","21147650","21147918","54","111813648"
"chr2","132985448","132985744","chr17","21146583","21146854","61","111838865"
"chr2","132998167","132998388","chr17","21176141","21176354","37","111822026"
"chr2","133000562","133000837","chr17","21178534","21178821","37","111822028"
"chr2","133001929","133002231","chr17","21179649","21179930","65","111822280"
"chr2","133022908","133023111","chr17","21200801","21200997","38","111822107"
"chr2","133027858","133028146","chr11","46939397","46939683","61","86088461"
"chr2","133072455","133072582","chr14","50725807","50725931","23","82346648"
"chr2","133072998","133073146","chr5","4272991","4273140","36","128800007"
"chr2","133212680","133212969","chr17","21401571","21401869","39","111811109"
"chr2","133343500","133343789","chr17","21504533","21504838","54","111838967"
"chr2","133377178","133377477","chr17","21546638","21546937","36","111830540"
"chr2","133418969","133419258","chr1","227415933","227416230","66","93996964"
"chr2","133454782","133455081","chr4","48442309","48442620","71","85012473"
"chr2","133518671","133518994","chr9","99118383","99118692","84","34400288"
"chr2","133521409","133521567","chr3","3806627","3806782","34","129714782"
"chr2","133535624","133535927","chr1","101615090","101615392","52","31920534"
"chr2","133672790","133673075","chr17","21804150","21804438","55","111868640"
"chr2","133700077","133700364","chr2A","57136071","57136340","57","76564006"
"chr2","133728798","133728940","chr17","21879393","21879536","11","111849405"
"chr2","133740848","133741147","chr1","102664060","102664355","57","31076788"
"chr2","133743361","133743468","chr10","105655931","105656038","23","28087430"
"chr2","133743762","133743842","chr19","17142871","17142952","19","116600891"
"chr2","133798615","133798901","chr17","21948226","21948513","33","111850389"
"chr2","133812740","133813071","chr17","21961807","21962113","59","111850933"
"chr2","133814595","133814715","chr17","21963958","21964078","17","111850637"
"chr2","133825565","133825661","chr1","134242923","134243019","23","417358"
"chr2","133826178","133826298","chrX","49113443","49113558","26","84712735"
"chr2","133835670","133835962","chr17","21983085","21983375","29","111852585"
"chr2","133859778","133860113","chr17","22006876","22007190","51","111852902"
"chr2","134117885","134118170","chr17","22327909","22328194","31","111789976"
"chr2","134152778","134153096","chr17","22361135","22361430","64","111791643"
"chr2","134154890","134155060","chr19","11025315","11025473","38","123129575"
"chr2","134245936","134246227","chr17","22454875","22455165","41","111791061"
"chr2","134353888","134354170","chr17","22552793","22553073","40","111801095"
"chr2","134355248","134355532","chr17","22554167","22554449","36","111801081"
"chr2","134357578","134357881","chr17","22556879","22557215","68","111800699"
"chr2","134485723","134485853","chr9","14717932","14718063","20","119767791"
"chr2","134681667","134681789","chr17","22872187","22872309","8","111809480"
"chr2","134695117","134695422","chr17","22885583","22885908","51","111809534"
"chr2","134712958","134713123","chr1","184720130","184720300","33","50007172"
"chr2","134762425","134762513","chr13","55457905","55457998","21","79304520"
"chr2","134763246","134763357","chr15","46133130","46133239","19","88630116"
"chr2","134781431","134781597","chr7","45537514","45537680","31","89243917"
"chr2","134849430","134849730","chr17","23033909","23034210","35","111815521"
"chr2","134857920","134858217","chr17","23043133","23043447","46","111814787"
"chr2","134886875","134887038","chr19","44491689","44491848","28","90395186"
"chr2","134908251","134908534","chr4","8568976","8569269","71","126339275"
"chr2","134929445","134929614","chr2A","64805346","64805507","38","70124099"
"chr2","134930912","134931012","chr1","32974775","32974881","26","101956137"
"chr2","134968334","134968480","chr1","68709407","68709549","38","66258927"
"chr2","134973186","134973272","chr4","162578637","162578721","32","27605451"
"chr2","134973598","134973703","chr1","57002295","57002402","18","77971303"
"chr2","134981530","134981792","chr15","61699539","61699802","58","73281991"
"chr2","135123456","135123754","chr17","23295344","23295638","42","111828112"
"chr2","135147989","135148279","chr17","23307560","23307867","48","111840429"
"chr2","135232803","135232921","chr19","48021635","48021754","38","87211168"
"chr2","135303356","135303624","chr17","23494320","23494585","54","111809036"
"chr2","135407701","135407858","chr3","267312","267456","43","135140389"
"chr2","135465039","135465338","chr17","23649028","23649339","49","111816011"
"chr2","135489393","135489497","chr5","22128933","22129035","18","113360460"
"chr2","135506763","135507011","chr12","106672293","106672548","67","28834470"
"chr2","135514428","135514542","chr16","17601043","17601160","17","117913385"
"chr2","135517047","135517335","chr18","6450516","6450818","67","129066531"
"chr2","135530493","135530619","chr16","69212656","69212783","33","66317837"
"chr2","135545976","135546246","chr17","23750698","23750982","34","111795278"
"chr2","135555242","135555505","chr16","14907479","14907738","58","120647763"
"chr2","135595104","135595215","chr17","23795445","23795558","24","111799659"
"chr2","135606102","135606373","chr17","23807357","23807627","39","111798745"
"chr2","135619635","135619904","chr17","23821140","23821383","62","111798495"
"chr2","135684536","135684829","chr17","23881534","23881831","26","111803002"
"chr2","135781474","135781773","chr17","23966846","23967145","57","111814628"
"chr2","135914311","135914612","chr17","24066679","24066984","34","111847632"
"chr2","136075002","136075273","chr17","24214295","24214584","44","111860707"
"chr2","136171872","136172117","chr5","124953488","124953738","65","11218384"
"chr2","136215890","136216177","chr17","24352268","24352570","48","111863622"
"chr2","136255389","136255655","chr12","109785099","109785363","66","26470290"
"chr2","136284253","136284359","chr1","118130752","118130853","25","18153501"
"chr2","136298617","136298782","chr19","18112321","18112488","36","118186296"
"chr2","136310552","136310810","chr11","66752239","66752505","55","69558313"
"chr2","136318820","136318934","chr17","24443683","24443798","8","111875137"
"chr2","136320160","136320427","chr17","24445058","24445327","20","111875102"
"chr2","136321566","136321780","chr17","24446468","24446686","23","111875098"
"chr2","136418747","136419024","chr17","24541648","24541905","44","111877099"
"chr2","136436492","136436604","chr7","6379157","6379273","31","130057335"
"chr2","136441319","136441627","chr15","44244841","44245146","62","92196478"
"chr2","136507311","136507433","chr9","87584262","87584385","28","48923049"
"chr2","136530435","136530689","chr14","34588858","34589105","62","101941577"
"chr2","136617193","136617473","chr7","68557706","68557989","57","68059487"
"chr2","136744514","136744789","chr17","24834944","24835235","42","111909570"
"chr2","136753628","136753748","chr3","101361956","101362077","24","35391672"
"chr2","136753929","136754057","chr2B","44606898","44607016","36","92147031"
"chr2","136849946","136850021","chr1","53450150","53450224","18","83399796"
"chr2","136858949","136859079","chr3","102709147","102709280","23","34149802"
"chr2","136873706","136873989","chr17","24941255","24941553","40","111932451"
"chr2","136930154","136930275","chr8","79737740","79737854","32","57192414"
"chr2","136948172","136948295","chrX","123943785","123943908","27","13004387"
"chr2","136966354","136966472","chr6","161778482","161778599","24","24812128"
"chr2","137003339","137003640","chr16","10963785","10964082","63","126039554"
"chr2","137007500","137007778","chr17","25061201","25061452","54","111946299"
"chr2","137007779","137007941","chr5","51144248","51144411","38","85863531"
"chr2","137026426","137026490","chr3","126872406","126872470","17","10154020"
"chr2","137030262","137030518","chr11","67266200","67266446","57","69764062"
"chr2","137034922","137035063","chr5","26663357","26663492","37","110371565"
"chr2","137068971","137069096","chr17","25124129","25124253","16","111944842"
"chr2","137069941","137070219","chr20","2588424","2588706","65","134481517"
"chr2","137079046","137079311","chrX","156319225","156319483","61","19240179"
"chr2","137112856","137112980","chr17","25153179","25153301","14","111959677"
"chr2","137115176","137115343","chr6","162551622","162551785","33","25436446"
"chr2","137115971","137116087","chr3","188544536","188544653","19","51428565"
"chr2","137133907","137134197","chr16","31386008","31386296","59","105747899"
"chr2","137149281","137149586","chr12","93741800","93742110","77","43407481"
"chr2","137160801","137160877","chr4","90244789","90244868","14","46916012"
"chr2","137164248","137164560","chr17","25194449","25194741","56","111969799"
"chr2","137180899","137181087","chr1","21302681","21302872","59","115878218"
"chr2","137203503","137203622","chr3","152425041","152425159","27","15221538"
"chr2","137217226","137217513","chr7","45549863","45550148","72","91667363"
"chr2","137265847","137266140","chr6","153473499","153473782","72","16207652"
"chr2","137275179","137275301","chr17","25449244","25449376","18","111825935"
"chr2","137291924","137292216","chr10","97041170","97041464","36","40250754"
"chr2","137305282","137305338","chr17","62088624","62088682","16","75216658"
"chr2","137305664","137305771","chr22","24304660","24304763","29","113001004"
"chr2","137305879","137306010","chr13","12308899","12309030","25","124996980"
"chr2","137309584","137309677","chr16","4656999","4657091","16","132652585"
"chr2","137310079","137310299","chr3","138125518","138125737","52","815439"
"chr2","137318864","137318988","chr5","134065012","134065132","22","3253852"
"chr2","137337403","137337681","chr17","25804826","25805133","68","111532577"
"chr2","137355056","137355186","chr17","26211407","26211538","18","111143649"
"chr2","137363004","137363119","chr17","25495954","25496070","11","111867050"
"chr2","137367436","137367730","chrX","137737993","137738282","74","370557"
"chr2","137404571","137404867","chr17","25456233","25456532","32","111948338"
"chr2","137422483","137422785","chr17","26147090","26147393","51","111275393"
"chr2","137428531","137428815","chr10","39637675","39637950","61","97790856"
"chr2","137461382","137461505","chr10","40852185","40852313","20","96609197"
"chr2","137461843","137462042","chr15","33506413","33506609","52","103955430"
"chr2","137472295","137472601","chr17","26195601","26195893","60","111276694"
"chr2","137477627","137477911","chr5","144183635","144183922","53","6706008"
"chr2","137484001","137484119","chr3","130546249","130546365","34","6937752"
"chr2","137485646","137485930","chr17","26214411","26214717","52","111271235"
"chr2","137510178","137510332","chr10","49585047","49585201","31","87925131"
"chr2","137513976","137514088","chr17","26242812","26242935","19","111271164"
"chr2","137514234","137514525","chr19","47688068","47688363","51","89826166"
"chr2","137534315","137534431","chr5","33145295","33145413","20","104389020"
"chr2","137537003","137537201","chr3","139090342","139090542","54","1553339"
"chr2","137556131","137556381","chr3","187941466","187941722","60","50385335"
"chr2","137560431","137560612","chr2A","13571221","13571397","42","123989210"
"chr2","137586177","137586305","chr17","26313464","26313592","12","111272713"
"chr2","137589535","137589819","chrX","19199530","19199816","50","118390005"
"chr2","137591833","137592133","chr6","7594942","7595236","60","129996891"
"chr2","137593049","137593361","chr20","48487515","48487824","43","89105534"
"chr2","137599068","137599373","chr22","13742429","13742732","52","123856639"
"chr2","137601825","137602094","chr7","151367295","151367567","57","13765470"
"chr2","137607279","137607565","chr20","48205900","48206196","39","89401379"
"chr2","137629170","137629470","chr16","60238828","60239122","59","77390342"
"chr2","137630636","137630946","chr20","48487515","48487824","44","89143121"
"chr2","137636654","137636957","chr1","151028018","151028322","51","13391364"
"chr2","137646973","137647262","chr20","48205900","48206196","44","89441073"
"chr2","137660829","137660936","chrX","118338466","118338573","27","19322363"
"chr2","137690891","137691185","chr5","45088510","45088801","46","92602381"
"chr2","137693302","137693458","chr19","5169265","5169417","29","132524037"
"chr2","137693827","137694130","chr6","139671446","139671732","68","1977619"
"chr2","137698796","137699106","chr4","4517769","4518079","72","133181027"
"chr2","137713517","137713717","chr19","16533797","16533987","51","121179720"
"chr2","137715508","137715757","chr17","26353158","26353393","48","111362350"
"chr2","137739716","137739854","chr7","69965789","69965928","25","67773927"
"chr2","137740827","137741148","chr8","78488834","78489147","71","59251993"
"chr2","137755517","137755814","chr2B","58080652","58080954","61","79674865"
"chr2","137763486","137763810","chr21","35108163","35108481","71","102655323"
"chr2","137770808","137770977","chr1","152885383","152885548","44","15114575"
"chr2","137789536","137789823","chr17","26407681","26407990","47","111381855"
"chr2","137791057","137791343","chr16","5856487","5856766","50","131934570"
"chr2","137802502","137802796","chr10","142926143","142926445","77","5123641"
"chr2","137804742","137804877","chr1","215271336","215271467","37","77466594"
"chr2","137818767","137819053","chr8","24737260","24737543","62","113081507"
"chr2","137819655","137819964","chr20","30599181","30599483","63","107220474"
"chr2","137822749","137823048","chr11","12243294","12243588","65","125579455"
"chr2","137837849","137838132","chr1","62692578","62692858","75","75145271"
"chr2","137851051","137851265","chr1","1334974","1335184","49","136516077"
"chr2","137853205","137853337","chr17","26463563","26463701","21","111389642"
"chr2","137858606","137858905","chr11","12728691","12728990","60","125129915"
"chr2","137861625","137861705","chr5","2060567","2060649","30","135801058"
"chr2","137863999","137864115","chr17","26472199","26472320","14","111391800"
"chr2","137865413","137865664","chr5","110284799","110285036","65","27580614"
"chr2","137872086","137872190","chr17","26480241","26480342","9","111391845"
"chr2","137886177","137886300","chr17","26512515","26512639","14","111373662"
"chr2","137898635","137898942","chr3","143837811","143838095","78","5939176"
"chr2","137905188","137905305","chr2A","81276067","81276185","13","56629121"
"chr2","137952029","137952301","chr11","101798828","101799102","64","36153201"
"chr2","137981165","137981296","chr17","26615751","26615884","19","111365414"
"chr2","138012641","138012942","chr17","26645780","26646087","51","111366861"
"chr2","138411500","138411789","chrX","54099268","54099560","54","84312232"
"chr2","138438043","138438348","chr19","30766905","30767207","65","107671138"
"chr2","138503758","138504040","chr17","27112808","27113091","31","111390950"
"chr2","138585252","138585542","chr17","27193486","27193793","46","111391766"
"chr2","138628215","138628437","chr17","27234709","27234929","23","111393506"
"chr2","138633960","138634133","chr17","27240274","27240446","15","111393686"
"chr2","138855783","138856075","chr18","9467619","9467909","54","129388164"
"chr2","138982140","138982258","chr17","27575360","27575471","20","111406780"
"chr2","139026926","139027092","chr5","6383321","6383494","39","132643605"
"chr2","139062301","139062586","chr17","27687719","27688017","42","111374582"
"chr2","139299519","139299797","chr17","27953314","27953604","41","111346205"
"chr2","139755404","139755682","chr17","28401896","28402171","41","111353508"
"chr2","139771520","139771817","chrX","54081472","54081761","63","85690048"
"chr2","139787210","139787443","chr17","28427913","28428148","36","111359297"
"chr2","139972695","139972953","chr17","28642597","28642852","28","111330098"
"chr2","139989181","139989468","chr17","28655931","28656216","40","111333250"
"chr2","140047587","140047867","chr17","28713957","28714244","36","111333630"
"chr2","140162514","140162800","chr15","28698469","28698760","73","111464045"
"chr2","140183282","140183585","chr17","28873797","28874093","31","111309485"
"chr2","140331920","140332206","chr17","29016491","29016771","45","111315429"
"chr2","140427230","140427494","chr17","29107217","29107503","52","111320013"
"chr2","140429828","140429942","chr17","29109829","29109945","15","111319999"
"chr2","140487094","140487333","chr7","102494368","102494607","54","37992726"
"chr2","140517319","140517579","chr17","29166732","29166991","22","111350587"
"chr2","140599459","140599748","chr17","29290449","29290743","34","111309010"
"chr2","140626372","140626483","chr21","26963940","26964052","20","113662432"
"chr2","140638022","140638327","chr17","29320519","29320823","50","111317503"
"chr2","140791492","140791764","chr17","29455896","29456172","58","111335596"
"chr2","140864021","140864150","chr3","123554311","123554442","25","17309710"
"chr2","140871734","140872031","chr17","29547220","29547522","41","111324514"
"chr2","140889513","140889805","chr17","29564189","29564477","42","111325324"
"chr2","140940238","140940498","chr17","29611029","29611294","29","111329209"
"chr2","140949169","140949460","chr5","58779562","58779857","56","82169607"
"chr2","140952577","140952874","chr17","29620369","29620670","42","111332208"
"chr2","140964179","140964498","chr17","29633200","29633490","55","111330979"
"chr2","140989533","140989648","chr17","29661300","29661421","19","111328233"
"chr2","140990753","140991026","chr1","64948806","64949080","63","76041947"
"chr2","141003040","141003327","chr17","29672080","29672362","50","111330960"
"chr2","141008766","141009020","chr5","20456815","20457063","62","120551951"
"chr2","141011983","141012117","chr4","71931988","71932119","19","69079995"
"chr2","141035752","141035860","chr18","14150011","14150117","22","126885741"
"chr2","141056296","141056511","chr1","86159635","86159843","53","54896661"
"chr2","141065484","141065810","chr12","125049405","125049721","64","16016079"
"chr2","141082227","141082382","chr18","18262050","18262192","36","122820177"
"chr2","141083309","141083432","chr16","45976798","45976922","18","95106511"
"chr2","141094497","141094782","chr9","75566020","75566287","61","65528477"
"chr2","141127912","141128227","chr17","29810799","29811103","51","111317113"
"chr2","141130564","141130855","chr6","110528982","110529284","62","30601582"
"chr2","141145161","141145284","chr17","29827949","29828073","9","111317212"
"chr2","141151084","141151349","chr17","29834331","29834598","21","111316753"
"chr2","141153881","141154021","chr3","267312","267456","30","140886569"
"chr2","141154349","141154470","chr10","119055864","119055986","19","22098485"
"chr2","141174253","141174594","chr17","29854752","29855069","57","111319501"
"chr2","141180829","141180947","chr5","10623279","10623396","23","130557550"
"chr2","141185613","141185706","chr17","29869611","29869708","23","111316002"
"chr2","141185817","141186097","chr17","29869803","29870082","30","111316014"
"chr2","141198006","141198305","chr17","29881326","29881643","50","111316680"
"chr2","141204302","141204611","chr17","29892088","29892394","48","111312214"
"chr2","141204828","141205137","chr17","29892921","29893238","46","111311907"
"chr2","141222369","141222696","chr1","129813968","129814281","77","11408401"
"chr2","141242150","141242410","chr6","18531346","18531609","63","122710804"
"chr2","141276438","141276736","chr17","29965335","29965633","32","111311103"
"chr2","141291779","141292155","chr19","35320368","35320703","111","105971411"
"chr2","141305085","141305328","chr17","4871551","4871796","63","136433534"
"chr2","141307598","141307881","chr17","29993980","29994271","47","111313618"
"chr2","141309062","141309177","chr17","29995406","29995528","23","111313656"
"chr2","141330188","141330470","chr2B","103084029","103084317","61","38246159"
"chr2","141332839","141333133","chr17","30029935","30030225","28","111302904"
"chr2","141344025","141344270","chr14","33598658","33598916","62","107745367"
"chr2","141351012","141351312","chr13","10431901","10432204","66","130919111"
"chr2","141397809","141398118","chr17","30102904","30103194","60","111294905"
"chr2","141431582","141431864","chr7","5095566","5095848","64","136336016"
"chr2","141433983","141434156","chr17","30120000","30120181","28","111313983"
"chr2","141436418","141436538","chr17","30122483","30122613","20","111313935"
"chr2","141437440","141437710","chr17","30123195","30123492","54","111314245"
"chr2","141455394","141455636","chr19","49501443","49501682","54","91953951"
"chr2","141497718","141498003","chr17","30170374","30170669","45","111327344"
"chr2","141500001","141500262","chr4","27037729","27037994","60","114462272"
"chr2","141521151","141521309","chr5","4272991","4273140","40","137248160"
"chr2","141549609","141549747","chr17","30241970","30242109","12","111307639"
"chr2","141557366","141557606","chr2B","64345227","64345472","56","77212139"
"chr2","141597475","141597593","chr17","30304467","30304589","12","111293008"
"chr2","141650981","141651153","chr1","225275741","225275914","40","83624760"
"chr2","141672685","141672998","chr17","30374191","30374484","51","111298494"
"chr2","141727751","141728051","chr3","26701514","26701800","78","115026237"
"chr2","141788028","141788321","chr17","30479273","30479554","48","111308755"
"chr2","141869740","141870020","chr17","30559973","30560261","60","111309767"
"chr2","141940221","141940440","chr14","75438790","75439009","50","66501431"
"chr2","141953813","141953925","chr9","31412227","31412339","23","110541586"
"chr2","141990444","141990552","chr7","77602371","77602485","21","64388073"
"chr2","142111882","142112150","chr17","30798579","30798845","29","111313303"
"chr2","142155394","142155702","chr17","30838769","30839092","57","111316625"
"chr2","142370160","142370408","chr17","5135575","5135828","50","137234585"
"chr2","142543887","142544018","chr17","31178117","31178250","19","111365770"
"chr2","142566866","142567034","chr19","45429799","45429961","66","97137067"
"chr2","142711322","142711609","chr10","24918256","24918534","60","117793066"
"chr2","142731022","142731301","chr17","31335930","31336224","44","111395092"
"chr2","142881077","142881314","chr17","31430781","31431025","41","111450296"
"chr2","142970499","142970611","chr17","31508779","31508904","23","111461720"
"chr2","143038094","143038389","chr17","31563357","31563647","25","111474737"
"chr2","143046021","143046317","chr22","10116920","10117223","70","132929101"
"chr2","143066643","143066952","chr17","31591402","31591712","48","111475241"
"chr2","143325900","143326206","chr17","31874555","31874863","42","111451345"
"chr2","143408846","143409111","chr2B","117873469","117873739","81","25535377"
"chr2","143460861","143461164","chr4","24306767","24307065","57","119154094"
"chr2","143549376","143549617","chrX","50137939","50138173","60","93411437"
"chr2","143753235","143753522","chr17","32248221","32248511","34","111505014"
"chr2","143843272","143843545","chr17","32335311","32335597","40","111507961"
"chr2","144473194","144473484","chr17","32934930","32935219","31","111538264"
"chr2","144533748","144534043","chr17","32998755","32999046","48","111534993"
"chr2","144616222","144616489","chr10","38048647","38048923","61","106567575"
"chr2","144616607","144616890","chr17","33067435","33067706","41","111549172"
"chr2","144673217","144673491","chr1","78869810","78870106","70","65803407"
"chr2","144772118","144772424","chr2A","21812708","21813015","41","122959410"
"chr2","144809175","144809410","chr8","74772775","74773004","60","70036400"
"chr2","144809923","144810210","chr7","138250606","138250896","67","6559317"
"chr2","144828721","144828991","chr17","33263313","33263581","37","111565408"
"chr2","144832682","144832995","chrX","44010049","44010345","73","100822633"
"chr2","144861361","144861654","chr17","33297991","33298273","53","111563370"
"chr2","144867826","144868004","chr22","3865049","3865217","44","141002777"
"chr2","144878146","144878375","chrX","140400261","140400492","65","4477885"
"chr2","144893304","144893551","chr17","33331345","33331624","61","111561959"
"chr2","144900913","144901208","chr17","33336219","33336510","33","111564694"
"chr2","144907328","144907625","chr1","163867986","163868280","77","18960658"
"chr2","144921938","144922252","chr17","33355116","33355414","53","111566822"
"chr2","144958156","144958267","chrX","47876058","47876170","19","97082098"
"chr2","144966028","144966158","chr17","33399589","33399719","20","111566439"
"chr2","144966161","144966442","chr17","33399720","33400016","51","111566441"
"chr2","144985365","144985684","chr17","33418535","33418808","72","111566830"
"chr2","145055427","145055595","chr15","57303400","57303566","51","87752027"
"chr2","145055688","145055961","chr1","27556866","27557137","56","117498822"
"chr2","145112997","145113121","chr20","36705924","36706059","36","108407073"
"chr2","145175541","145175780","chr5","114497350","114497591","61","30678191"
"chr2","145200794","145201114","chr17","33627240","33627557","43","111573554"
"chr2","145260920","145261211","chr17","33687572","33687862","51","111573348"
"chr2","145299024","145299180","chr7","78925352","78925506","40","66373672"
"chr2","145521229","145521472","chr17","33916312","33916546","38","111604917"
"chr2","145559580","145559821","chr19","14194080","14194318","59","131365500"
"chr2","145868877","145869048","chr2B","99098487","99098651","43","46770390"
"chr2","145869113","145869262","chr9","90023492","90023634","31","55845621"
"chr2","145870313","145870619","chr17","34239663","34239974","35","111630650"
"chr2","145872923","145873045","chr17","34242117","34242244","17","111630806"
"chr2","145885796","145886060","chr2B","56337074","56337323","76","89548722"
"chr2","145899178","145899423","chr17","34267966","34268241","61","111631212"
"chr2","145941709","145942013","chr7","72420666","72420967","68","73521043"
"chr2","146030993","146031287","chr17","34397919","34398219","48","111633074"
"chr2","146078568","146078879","chr17","34447680","34447993","49","111630888"
"chr2","146087372","146087666","chr17","34456661","34456953","47","111630711"
"chr2","146087958","146088264","chr17","34457247","34457544","43","111630711"
"chr2","146091809","146091961","chr4","162494707","162494861","39","16402898"
"chr2","146151044","146151321","chr17","34515961","34516239","38","111635083"
"chr2","146155299","146155573","chr17","34520276","34520564","54","111635023"
"chr2","146164942","146165091","chr11","65955607","65955759","33","80209335"
"chr2","146176612","146176908","chr6","146251348","146251655","69","74736"
"chr2","146184988","146185112","chr17","34548898","34549021","18","111636090"
"chr2","146196559","146196685","chr15","78004255","78004392","35","68192304"
"chr2","146199484","146199767","chr7","138250606","138250896","71","7948878"
"chr2","146215022","146215359","chr1","150808926","150809223","94","4593904"
"chr2","146229109","146229402","chr17","34590156","34590440","60","111638953"
"chr2","146239276","146239420","chr3","38650177","38650318","34","107589099"
"chr2","146307546","146307838","chr17","34660473","34660773","45","111647073"
"chr2","146362350","146362640","chr17","34708026","34708316","39","111654324"
"chr2","146400500","146400798","chr17","34739763","34740077","49","111660737"
"chr2","146484675","146484977","chr17","34822718","34823036","42","111661957"
"chr2","146571021","146571317","chr17","34897109","34897390","50","111673912"
"chr2","146617656","146617951","chr17","34941639","34941937","40","111676017"
"chr2","146643182","146643483","chr17","34979195","34979489","45","111663987"
"chr2","146655482","146655763","chr17","34991235","34991546","55","111664247"
"chr2","146755163","146755276","chr3","24378715","24378829","21","122376448"
"chr2","146817024","146817231","chr17","35154533","35154755","30","111662491"
"chr2","146992480","146992742","chr12","111724732","111725004","53","35267748"
"chr2","146997444","146997740","chr17","35343805","35344099","44","111653639"
"chr2","147024606","147024914","chr8","26793783","26794085","73","120230823"
"chr2","147085453","147085610","chr7","79271528","79271684","34","67813925"
"chr2","147138710","147138985","chr1","110708666","110708942","59","36430044"
"chr2","147580916","147581002","chr1","150935395","150935475","20","3354479"
"chr2","147581335","147581480","chr1","68709407","68709549","28","78871928"
"chr2","147792291","147792577","chr17","36119772","36120044","42","111672519"
"chr2","148083303","148083597","chr7","6450288","6450581","60","141633015"
"chr2","148098138","148098407","chr3","199487793","199488055","81","51389655"
"chr2","148271930","148272235","chr17","36603768","36604066","47","111668162"
"chr2","148274196","148274461","chr2A","21838782","21839044","66","126435414"
"chr2","148274536","148274803","chr17","36606476","36606738","52","111668060"
"chr2","148317488","148317775","chr17","36649315","36649616","47","111668173"
"chr2","148359892","148360185","chr17","36687119","36687398","46","111672773"
"chr2","148370948","148371071","chr17","36696783","36696909","13","111674165"
"chr2","148415515","148415789","chr17","36748960","36749230","40","111666555"
"chr2","148458967","148459270","chr17","36781536","36781847","49","111677431"
"chr2","148468127","148468382","chr17","36789251","36789508","44","111678876"
"chr2","148629790","148629913","chr17","36950956","36951080","15","111678834"
"chr2","148880885","148881183","chr17","37179694","37180002","45","111701191"
"chr2","149060047","149060267","chr17","37372079","37372292","50","111687968"
"chr2","149080744","149081045","chr17","37391615","37391930","51","111689129"
"chr2","149081057","149081180","chr17","37391942","37392065","16","111689115"
"chr2","149134367","149134672","chrX","48161010","48161318","64","100973357"
"chr2","149187133","149187264","chr1","227459174","227459308","23","78272041"
"chr2","149197398","149197675","chr7","128527661","128527933","67","20669737"
"chr2","149226356","149226644","chr17","37545084","37545374","38","111681272"
"chr2","149684893","149685176","chrX","118718918","118719200","55","30965975"
"chr2","149705017","149705300","chr17","38009724","38010014","40","111695293"
"chr2","149885082","149885375","chr17","38202074","38202367","39","111683008"
"chr2","150251090","150251181","chr17","38532634","38532725","14","111718456"
"chr2","150275641","150275928","chr17","38561455","38561745","42","111714186"
"chr2","150366504","150366621","chr20","5780776","5780893","20","144585728"
"chr2","150369558","150369670","chr17","38658621","38658743","15","111710937"
"chr2","150397988","150398253","chr17","38687575","38687848","44","111710413"
"chr2","150402428","150402722","chr17","38691627","38691916","72","111710801"
"chr2","150404251","150404385","chr17","38694023","38694152","20","111710228"
"chr2","150405269","150405567","chr17","38695331","38695609","56","111709938"
"chr2","150410266","150410367","chr8","124716221","124716323","18","25694045"
"chr2","150436513","150436610","chr10","117001518","117001614","17","33434995"
"chr2","150448317","150448401","chrX","41792790","41792876","25","108655527"
"chr2","150496910","150497224","chr17","38797013","38797309","59","111699897"
"chr2","150512369","150512667","chr12","21390242","21390534","53","129122127"
"chr2","150512814","150513078","chr17","38826864","38827123","28","111685950"
"chr2","150558571","150558649","chr10","28632698","28632776","16","121925873"
"chr2","150581547","150581783","chr17","21279650","21279885","62","129301897"
"chr2","150598613","150598879","chr5","13122526","13122799","60","137476087"
"chr2","150617646","150617778","chr17","38927604","38927736","11","111690042"
"chr2","150630389","150630511","chr1","46026245","46026369","15","104604144"
"chr2","150651844","150651995","chr13","3468265","3468414","29","147183579"
"chr2","150677314","150677609","chr17","38993558","38993854","30","111683756"
"chr2","150708063","150708191","chr17","39025261","39025390","19","111682802"
"chr2","150714387","150714619","chr3","49738899","49739127","49","100975488"
"chr2","150736968","150737254","chr17","39056208","39056492","37","111680760"
"chr2","150812397","150812698","chr17","39128775","39129083","46","111683622"
"chr2","151072829","151073028","chr2B","131325014","131325217","42","19747815"
"chr2","151102850","151103131","chr17","39399256","39399538","42","111703594"
"chr2","151214048","151214351","chr9","87445998","87446299","57","63768050"
"chr2","151435856","151435972","chr21","34616573","34616688","24","116819283"
"chr2","151472738","151473047","chr17","39786698","39786978","55","111686040"
"chr2","151499455","151499581","chr2B","128679677","128679799","17","22819778"
"chr2","151529824","151530152","chr17","39839889","39840214","45","111689935"
"chr2","151533100","151533228","chrX","17936976","17937103","20","133596124"
"chr2","151556284","151556598","chr5","137995613","137995921","56","13560671"
"chr2","151558703","151558925","chr17","39862720","39862927","46","111695983"
"chr2","151575730","151575983","chr18","25648636","25648888","73","125927094"
"chr2","151578806","151579073","chr1","27882391","27882663","63","123696415"
"chr2","151620496","151620608","chr5","25268578","25268694","23","126351918"
"chr2","151644134","151644385","chr17","39931282","39931529","33","111712852"
"chr2","151658423","151658715","chr17","39942595","39942876","42","111715828"
"chr2","151674914","151675027","chr1","11020903","11021015","24","140654011"
"chr2","151677063","151677182","chr17","39959903","39960028","17","111717160"
"chr2","151697355","151697513","chr6","162551622","162551785","44","10854267"
"chr2","151701805","151702039","chr17","39988565","39988833","58","111713240"
"chr2","151728038","151728238","chr17","40009485","40009691","37","111718553"
"chr2","151739782","151740068","chr17","40015968","40016259","37","111723814"
"chr2","151812931","151813161","chr17","40095736","40095971","33","111717195"
"chr2","151871079","151871350","chr17","40163486","40163768","38","111707593"
"chr2","151884522","151884649","chr17","40174478","40174604","21","111710044"
"chr2","151894399","151894693","chr17","40177476","40177775","36","111716923"
"chr2","151914225","151914461","chr17","40192735","40192984","38","111721490"
"chr2","151942202","151942515","chr2B","26826864","26827156","73","125115338"
"chr2","151952092","151952370","chr17","40223876","40224162","44","111728216"
"chr2","151980268","151980479","chr17","40229497","40229712","27","111750771"
"chr2","152000502","152000642","chr8","86658419","86658554","40","65342083"
"chr2","152005280","152005583","chr17","40245750","40246069","49","111759530"
"chr2","152010596","152010899","chr17","40250957","40251264","35","111759639"
"chr2","152019114","152019222","chr1","134625109","134625219","15","17394005"
"chr2","152032123","152032431","chr17","40276726","40277030","51","111755397"
"chr2","152086650","152086926","chr17","40337755","40338051","52","111748895"
"chr2","152112639","152112948","chr17","40359734","40360042","66","111752905"
"chr2","152113483","152113618","chr1","133233823","133233957","25","18879660"
"chr2","152133935","152134115","chr17","40384169","40384352","24","111749766"
"chr2","152159945","152160253","chr16","11903517","11903815","69","140256428"
"chr2","152160282","152160407","chr17","40401343","40401464","15","111758939"
"chr2","152184208","152184498","chr17","40415415","40415705","32","111768793"
"chr2","152191788","152192076","chr17","40421156","40421446","45","111770632"
"chr2","152218155","152218408","chr13","74965210","74965465","65","77252945"
"chr2","152233911","152234188","chr17","40466594","40466890","55","111767317"
"chr2","152256937","152257205","chr21","23414956","23415212","61","128841981"
"chr2","152288829","152289112","chr17","40532403","40532716","65","111756426"
"chr2","152295712","152295995","chr7","2959934","2960208","66","149335778"
"chr2","152336203","152336506","chr17","40579788","40580097","37","111756415"
"chr2","152364896","152365185","chr17","40611596","40611869","37","111753300"
"chr2","152453766","152454010","chr13","5089152","5089392","59","147364614"
"chr2","152454346","152454406","chr16","37297382","37297437","15","115156964"
"chr2","152461798","152462003","chr16","27370729","27370928","47","125091069"
"chr2","152467397","152467647","chr17","40706445","40706695","33","111760952"
"chr2","152485578","152485852","chr17","40724611","40724902","40","111760967"
"chr2","152528505","152528622","chr5","133578375","133578499","21","18950130"
"chr2","152536761","152536962","chr17","40774044","40774247","23","111762717"
"chr2","152556563","152556683","chr13","50013490","50013610","34","102543073"
"chr2","152569682","152569991","chr1","62174894","62175177","76","90394788"
"chr2","152653114","152653395","chr11","56613895","56614208","55","96039219"
"chr2","152886496","152886777","chr22","14051297","14051569","76","138835199"
"chr2","153115971","153116111","chr18","20901830","20901975","35","132214141"
"chr2","153153879","153154145","chr3","10553115","10553386","62","142600764"
"chr2","153179774","153179932","chr1","62623007","62623176","41","90556767"
"chr2","153250671","153250948","chr17","41514512","41514777","45","111736159"
"chr2","153253057","153253149","chr11","93233737","93233830","20","60019320"
"chr2","153260979","153261274","chr17","41528187","41528463","53","111732792"
"chr2","153332913","153333250","chr17","41604555","41604875","70","111728358"
"chr2","153379084","153379339","chr17","41659048","41659313","61","111720036"
"chr2","153430310","153430589","chr1","15594429","15594701","76","137835881"
"chr2","153527236","153527399","chr2A","33677905","33678061","37","119849331"
"chr2","153527703","153527844","chr19","44358723","44358854","27","109168980"
"chr2","153543536","153543813","chr17","41816940","41817229","41","111726596"
"chr2","153679647","153679914","chr17","41951553","41951808","47","111728094"
"chr2","153681149","153681413","chr4","120652076","120652337","66","33029073"
"chr2","153685605","153685892","chr2B","83992100","83992385","55","69693505"
"chr2","153686376","153686701","chr17","41958676","41958991","54","111727700"
"chr2","153737003","153737156","chr9","43167512","43167660","35","110569491"
"chr2","153797430","153797560","chr16","12415428","12415559","21","141382002"
"chr2","153804657","153804959","chr17","42085311","42085610","63","111719346"
"chr2","153824978","153825270","chr17","42106583","42106883","43","111718395"
"chr2","153943008","153943179","chr18","55236793","55236976","37","98706215"
"chr2","153946086","153946289","chr17","42254434","42254632","27","111691652"
"chr2","153972361","153972477","chr17","42279774","42279888","12","111692587"
"chr2","154000398","154000703","chr17","42322218","42322532","44","111678180"
"chr2","154034629","154034945","chr17","42359402","42359711","40","111675227"
"chr2","154186419","154186719","chr1","181256651","181256946","64","27070232"
"chr2","154231771","154232077","chr17","42559718","42560041","50","111672053"
"chr2","154315824","154316081","chr17","42625953","42626237","53","111689871"
"chr2","154320106","154320390","chr5","34518283","34518568","63","119801823"
"chr2","154356333","154356598","chr17","42666165","42666436","32","111690168"
"chr2","154545971","154546258","chr17","42892700","42892977","41","111653271"
"chr2","154614349","154614655","chr17","42951381","42951653","67","111662968"
"chr2","154657234","154657488","chr17","42993337","42993590","26","111663897"
"chr2","154696367","154696632","chr16","40555825","40556088","57","114140542"
"chr2","155171284","155171527","chr17","43560502","43560747","31","111610782"
"chr2","155232816","155233128","chr17","43652907","43653220","40","111579909"
"chr2","155367688","155367978","chr17","43780397","43780717","64","111587291"
"chr2","155656353","155656482","chr17","44067710","44067835","17","111588643"
"chr2","155763437","155763745","chr17","44178961","44179264","35","111584476"
"chr2","155775449","155775734","chr17","44192978","44193273","55","111582471"
"chr2","156306054","156306339","chr17","44688609","44688895","34","111617445"
"chr2","156308786","156309068","chr17","44691535","44691828","51","111617251"
"chr2","156344936","156345157","chr17","44731660","44731883","27","111613276"
"chr2","156668533","156668658","chr1","210867840","210867970","29","54199307"
"chr2","156762878","156763155","chr17","45150362","45150637","38","111612516"
"chr2","156767950","156768259","chr17","45141835","45142146","39","111626115"
"chr2","156910881","156911155","chr16","4415567","4415837","59","152495314"
"chr2","156919409","156919683","chr17","45305750","45306030","49","111613659"
"chr2","156951410","156951692","chr12","32032110","32032393","58","124919300"
"chr2","156961063","156961247","chr17","45346481","45346661","24","111614582"
"chr2","156966996","156967257","chr17","45348996","45349277","51","111618000"
"chr2","157001703","157001996","chr8","104009958","104010262","79","52991745"
"chr2","157036741","157036932","chr8","94295905","94296096","43","62740836"
"chr2","157061168","157061330","chr7","4551943","4552104","32","152509225"
"chr2","157120737","157120882","chr8","11525805","11525955","30","145594932"
"chr2","157274287","157274572","chr17","45686616","45686893","30","111587671"
"chr2","157286054","157286252","chrUn_CABD030131125v1","3811","4006","33","157282243"
"chr2","157304049","157304212","chr21","34565547","34565708","38","122738502"
"chr2","157343962","157344128","chr1","68708950","68709107","46","88635012"
"chr2","157344710","157344809","chr2A","59446083","59446186","29","97898627"
"chr2","157496527","157496660","chr15","22019347","22019478","22","135477180"
"chr2","157510952","157511216","chr1","129439777","129440040","76","28071175"
"chr2","157679302","157679601","chr17","49614690","49614962","60","108064612"
"chr2","157680975","157681089","chr19","46547524","46547634","24","111133451"
"chr2","157754442","157754569","chr17","49699444","49699572","12","108054998"
"chr2","157783340","157783621","chr17","49735722","49736005","33","108047618"
"chr2","157832838","157833108","chr17","49782343","49782607","37","108050495"
"chr2","157914854","157915157","chr14","61318114","61318412","77","96596740"
"chr2","158439098","158439284","chr17","50471926","50472113","18","107967172"
"chr2","158485815","158486101","chr17","50523071","50523366","51","107962744"
"chr2","158538803","158539056","chr17","50578414","50578666","29","107960389"
"chr2","158623469","158623777","chr2A","18712846","18713155","63","139910623"
"chr2","159014518","159014672","chr17","51057718","51057869","24","107956800"
"chr2","159423630","159423919","chr19","46062191","46062484","67","113361439"
"chr2","159563314","159563402","chr17","51562278","51562363","12","108001036"
"chr2","159790952","159791261","chr17","51779492","51779771","61","108011460"
"chr2","159838588","159838670","chr4","82318431","82318510","18","77520157"
"chr2","159845961","159846270","chr17","51843007","51843302","47","108002954"
"chr2","159902452","159902772","chr17","51904756","51905071","44","107997696"
"chr2","159938248","159938539","chr17","51939272","51939585","48","107998976"
"chr2","159954110","159954369","chr3","71319936","71320213","63","88634174"
"chr2","159974775","159975069","chr17","51974801","51975099","47","107999974"
"chr2","159975906","159975980","chr10","65435545","65435621","10","94540361"
"chr2","159988241","159988448","chr15","29740733","29740952","43","130247508"
"chr2","160002318","160002580","chr17","52010043","52010312","57","107992275"
"chr2","160064799","160064931","chr17","52101607","52101739","13","107963192"
"chr2","160102797","160102861","chr2A","81721082","81721140","17","78381715"
"chr2","160103735","160103873","chr4","73031199","73031333","46","87072536"
"chr2","160124456","160124731","chr16","64670529","64670805","67","95453927"
"chr2","160130741","160131029","chr12","121101371","121101664","54","39029370"
"chr2","160156136","160156451","chr10","132003577","132003889","67","28152559"
"chr2","160171109","160171418","chr6","82179864","82180170","75","77991245"
"chr2","160220739","160220946","chr17","52252330","52252549","37","107968409"
"chr2","160255494","160255603","chr17","52273088","52273195","16","107982406"
"chr2","160259087","160259215","chr17","52276403","52276525","17","107982684"
"chr2","160336888","160337177","chr1","227415933","227416230","58","67079045"
"chr2","160389823","160390135","chr2A","41973375","41973685","73","118416448"
"chr2","160399867","160400148","chr17","52340417","52340725","64","108059450"
"chr2","160415679","160415836","chr5","921340","921480","51","159494339"
"chr2","160509893","160510161","chr14","40023553","40023821","64","120486340"
"chr2","160705397","160705695","chr4","40694555","40694844","80","120010842"
"chr2","161183584","161183845","chr17","53126733","53127001","43","108056851"
"chr2","161498657","161498823","chr5","165290789","165290951","46","3792132"
"chr2","161517742","161518032","chr17","53386843","53387128","31","108130899"
"chr2","161536413","161536660","chr17","53406743","53407017","55","108129670"
"chr2","161556208","161556487","chr17","53424318","53424617","50","108131890"
"chr2","161656430","161656540","chr12","62964855","62964964","22","98691575"
"chr2","161722944","161723206","chr17","53598318","53598581","60","108124626"
"chr2","162149041","162149326","chr17","54025186","54025491","54","108123855"
"chr2","162420845","162420941","chr7","44654252","44654346","22","117766593"
"chr2","162462562","162462850","chr17","54324313","54324616","56","108138249"
"chr2","162534921","162535055","chr11","62991394","62991536","37","99543527"
"chr2","162537156","162537436","chr6","17059236","17059519","77","145477920"
"chr2","162548456","162548761","chr17","54414068","54414373","41","108134388"
"chr2","162551241","162551536","chr17","54421455","54421756","46","108129786"
"chr2","162573576","162573742","chr17","54442101","54442270","22","108131475"
"chr2","162588572","162588826","chr17","54464786","54465039","32","108123786"
"chr2","162629443","162629719","chr20","35513905","35514188","62","127115538"
"chr2","162632258","162632427","chr7","79657650","79657818","46","82974608"
"chr2","162662436","162662719","chr17","54543656","54543941","32","108118780"
"chr2","162668044","162668334","chr15","56908496","56908788","64","105759548"
"chr2","162711357","162711634","chr17","54582767","54583039","47","108128590"
"chr2","162718408","162718532","chr2A","56811303","56811424","21","105907105"
"chr2","162767800","162768112","chr17","54648121","54648430","38","108119679"
"chr2","162771857","162772160","chr20","58447018","58447322","78","104324839"
"chr2","162779107","162779305","chr3","46423650","46423852","53","116355457"
"chr2","163118792","163119083","chr17","54966092","54966381","42","108152700"
"chr2","163154776","163155041","chr17","54996425","54996697","39","108158351"
"chr2","163480734","163481015","chr17","55333513","55333759","57","108147221"
"chr2","163678298","163678419","chr13","6354236","6354359","27","157324062"
"chr2","163709422","163709729","chr17","55574621","55574930","61","108134801"
"chr2","163711214","163711300","chr15","75513083","75513170","14","88198131"
"chr2","163776635","163776937","chr17","55654190","55654483","56","108122445"
"chr2","163787371","163787603","chr5","41150341","41150568","65","122637030"
"chr2","163943553","163943823","chr16","59528062","59528344","61","104415491"
"chr2","164228527","164228830","chr17","56104227","56104536","40","108124300"
"chr2","164238310","164238594","chr17","56112329","56112641","50","108125981"
"chr2","164256337","164256613","chr16","24689650","24689929","72","139566687"
"chr2","164353740","164354085","chr14","8247014","8247358","97","156106726"
"chr2","164362810","164362927","chr17","56236350","56236468","10","108126460"
"chr2","164410053","164410388","chr17","56277057","56277381","75","108132996"
"chr2","164414504","164414634","chr7","26158438","26158564","35","138256066"
"chr2","164596855","164597107","chr1","94618535","94618785","62","69978320"
"chr2","164613174","164613325","chr11","117041215","117041360","35","47571959"
"chr2","164614199","164614269","chr1","185716354","185716426","17","21102155"
"chr2","164654758","164655058","chr17","56526141","56526436","44","108128617"
"chr2","164682656","164682899","chr5","143843601","143843848","73","20839055"
"chr2","165285646","165285764","chr12","1702","1809","19","165283944"
"chr2","165422737","165422860","chr17","57284218","57284341","10","108138519"
"chr2","165455030","165455339","chr17","57315764","57316076","31","108139266"
"chr2","165597912","165598197","chr5","38456038","38456329","55","127141874"
"chr2","165639400","165639707","chr17","57480213","57480524","50","108159187"
"chr2","165940462","165940672","chr17","57756939","57757151","22","108183523"
"chr2","165997439","165997636","chr17","57822372","57822568","25","108175067"
"chr2","165998215","165998290","chr17","57822907","57822985","13","108175308"
"chr2","166072057","166072363","chr17","57917865","57918180","47","108154192"
"chr2","166076157","166076284","chr17","57933106","57933233","13","108143051"
"chr2","166079825","166079936","chr7","95524560","95524670","21","70555265"
"chr2","166084003","166084301","chr17","57940368","57940681","63","108143635"
"chr2","166167483","166167773","chr16","29363935","29364227","73","136803548"
"chr2","166180240","166180314","chr1","67766603","67766677","11","98413637"
"chr2","166183057","166183326","chr17","58026796","58027070","56","108156261"
"chr2","166192952","166193237","chr17","58036893","58037178","39","108156059"
"chr2","166212306","166212611","chr6","141632765","141633056","58","24579541"
"chr2","166236936","166237168","chr16","24243301","24243544","54","141993635"
"chr2","166237785","166237875","chr9","41357951","41358038","16","124879834"
"chr2","166261174","166261379","chr5","165315827","165316033","48","945347"
"chr2","166277812","166277919","chr2A","95736091","95736198","21","70541721"
"chr2","166329778","166330069","chr17","58153872","58154173","38","108175906"
"chr2","166337243","166337528","chr17","58160298","58160593","42","108176945"
"chr2","166369481","166369775","chr17","58179122","58179425","56","108190359"
"chr2","166370258","166370481","chr17","58179627","58179861","35","108190631"
"chr2","166449401","166449502","chrX","41993891","41993987","25","124455510"
"chr2","166456264","166456369","chr20","5768812","5768914","15","160687452"
"chr2","166471151","166471423","chr17","58274998","58275267","32","108196153"
"chr2","166494151","166494454","chr17","58297228","58297529","32","108196923"
"chr2","166512717","166513015","chr17","58310217","58310523","38","108202500"
"chr2","166531414","166531527","chr17","63212955","63213066","34","103318459"
"chr2","166544595","166544725","chr20","3645405","3645538","30","162899190"
"chr2","166676019","166676254","chr6","38297871","38298088","58","128378148"
"chr2","166678607","166678801","chr1","36042325","36042518","34","130636282"
"chr2","166801992","166802291","chr17","58583370","58583666","43","108218622"
"chr2","166819807","166820096","chr17","58600218","58600510","25","108219589"
"chr2","166862254","166862535","chr6","18735017","18735306","60","148127237"
"chr2","166939583","166939904","chr20","33313506","33313802","74","133626077"
"chr2","167000904","167001187","chr1","133729720","133730008","57","33271184"
"chr2","167069727","167069844","chr17","58854412","58854529","7","108215315"
"chr2","167193368","167193667","chr17","58963230","58963543","53","108230138"
"chr2","167324880","167325196","chr17","59068136","59068439","55","108256744"
"chr2","167534522","167534798","chr7","154174781","154175063","66","13359741"
"chr2","167597502","167597806","chr17","59373306","59373610","52","108224196"
"chr2","167758392","167758699","chr17","59536686","59536986","37","108221706"
"chr2","167814910","167815200","chr15","28698469","28698760","57","139116441"
"chr2","167872910","167873143","chr17","59637386","59637613","30","108235524"
"chr2","168123803","168124117","chr17","59868694","59869007","41","108255109"
"chr2","168201577","168201872","chr5","26464690","26464978","60","141736887"
"chr2","168264315","168264617","chr19","18992894","18993192","63","149271421"
"chr2","168266895","168267185","chr12","65857390","65857691","58","102409505"
"chr2","168288438","168288735","chr17","60038769","60039071","42","108249669"
"chr2","168709921","168710161","chr17","60457999","60458247","45","108251922"
"chr2","168737941","168738078","chr12","116696765","116696890","24","52041176"
"chr2","168793951","168794222","chr17","60527991","60528267","45","108265960"
"chr2","168814975","168815072","chr17","60552862","60552959","10","108262113"
"chr2","168876330","168876500","chr5","96068736","96068907","45","72807594"
"chr2","168877560","168877674","chr17","60605431","60605544","12","108272129"
"chr2","168890784","168890923","chr7","129625488","129625626","31","39265296"
"chr2","168913153","168913458","chr17","60635392","60635705","38","108277761"
"chr2","168928018","168928308","chr17","60649855","60650147","52","108278163"
"chr2","168934975","168935265","chr17","60654961","60655261","46","108280014"
"chr2","168975306","168975585","chr17","60700735","60701040","64","108274571"
"chr2","168987340","168987632","chr4","109694485","109694780","58","59292855"
"chr2","169040614","169040843","chr5","138456121","138456337","75","30584493"
"chr2","169149975","169150262","chr5","19135984","19136272","61","150013991"
"chr2","169340199","169340348","chr6","36782155","36782293","37","132558044"
"chr2","169349008","169349289","chr17","61346254","61346547","61","108002754"
"chr2","169478855","169479175","chr17","61469371","61469683","50","108009484"
"chr2","169490182","169490335","chr14","87099754","87099910","34","82390428"
"chr2","169545917","169546244","chr17","61520818","61521128","58","108025099"
"chr2","169547054","169547141","chr3","10699791","10699878","20","158847263"
"chr2","169639443","169639633","chr17","61616739","61616931","28","108022704"
"chr2","169678854","169678952","chr7","75095171","75095269","25","94583683"
"chr2","169749508","169749572","chr10","13656722","13656785","17","156092786"
"chr2","169750343","169750544","chr5","22991858","22992070","55","146758485"
"chr2","169754837","169755130","chr17","61731562","61731855","33","108023275"
"chr2","169795887","169796182","chr18","44352958","44353255","62","125442929"
"chr2","169802621","169802890","chr17","61823283","61823565","27","107979338"
"chr2","169818474","169818627","chr7","70035241","70035395","37","99783233"
"chr2","169820466","169820566","chr7","106936739","106936838","17","62883727"
"chr2","169834224","169834400","chr6","58098458","58098635","39","111735766"
"chr2","169853473","169853718","chr15","53802494","53802717","69","116050979"
"chr2","169871434","169871722","chr17","61899175","61899480","51","107972259"
"chr2","169875941","169876227","chr17","61905333","61905628","37","107970608"
"chr2","169914301","169914572","chr17","61930681","61930934","63","107983620"
"chr2","170111710","170111957","chr11","71756217","71756469","55","98355493"
"chr2","170113566","170113844","chr2A","61220081","61220370","58","108893485"
"chr2","170234184","170234424","chr17","62239132","62239389","39","107995052"
"chr2","170243364","170243536","chr17","62246753","62246929","34","107996611"
"chr2","170243548","170243799","chr17","62246933","62247211","57","107996615"
"chr2","170310169","170310470","chr18","11882842","11883148","81","158427327"
"chr2","170528932","170529043","chr13","9559854","9559959","27","160969078"
"chr2","170588090","170588250","chr17","62626813","62626973","24","107961277"
"chr2","170694853","170695124","chr17","62778431","62778712","47","107916422"
"chr2","170736545","170736865","chr17","62821388","62821705","46","107915157"
"chr2","170786898","170787198","chr17","62868287","62868586","55","107918611"
"chr2","170789813","170789929","chr17","63212955","63213066","27","107576858"
"chr2","170808199","170808489","chr11","47829543","47829829","66","122978656"
"chr2","170855875","170855988","chr3","65193379","65193500","23","105662496"
"chr2","170868485","170868783","chr17","62936349","62936666","74","107932136"
"chr2","170929588","170929865","chr17","62995165","62995444","55","107934423"
"chr2","170932821","170933154","chr11","14443649","14443947","99","156489172"
"chr2","170995239","170995542","chr17","63070937","63071241","38","107924302"
"chr2","171042262","171042556","chr17","63114509","63114810","42","107927753"
"chr2","171057018","171057278","chr12","111159327","111159583","61","59897691"
"chr2","171080124","171080420","chr17","63150406","63150714","46","107929718"
"chr2","171131572","171131829","chr19","13088789","13089051","72","158042783"
"chr2","171132059","171132145","chr1","214800376","214800461","23","43668317"
"chr2","171140176","171140259","chr19","8080718","8080794","18","163059458"
"chr2","171145200","171145461","chr17","63221561","63221833","35","107923639"
"chr2","171184972","171185027","chr12","107948364","107948415","12","63236608"
"chr2","171185165","171185285","chr11","3117679","3117792","32","168067486"
"chr2","171235888","171236133","chr16","24020613","24020850","59","147215275"
"chr2","171272172","171272460","chr17","63364209","63364512","41","107907963"
"chr2","171280176","171280304","chr1","27945947","27946072","22","143334229"
"chr2","171329933","171330209","chr17","63419637","63419912","42","107910296"
"chr2","171411025","171411189","chr10","88822362","88822526","41","82588663"
"chr2","171456572","171456881","chr17","63558004","63558312","42","107898568"
"chr2","171475863","171475998","chr17","63573886","63574021","9","107901977"
"chr2","171476152","171476267","chr7","80237665","80237788","28","91238487"
"chr2","171486899","171487186","chr17","63583315","63583620","46","107903584"
"chr2","171533540","171533845","chr17","63631003","63631310","33","107902537"
"chr2","171544412","171544592","chr22","25490059","25490239","44","146054353"
"chr2","171634458","171634751","chr17","63719621","63719916","43","107914837"
"chr2","171643709","171643989","chr17","63728032","63728310","41","107915677"
"chr2","171696813","171697032","chr17","63775190","63775420","37","107921623"
"chr2","171779577","171779850","chr17","63849660","63849929","60","107929917"
"chr2","171782215","171782485","chr3","130875383","130875636","66","40906832"
"chr2","171795234","171795467","chr17","63859546","63859769","40","107935688"
"chr2","171812527","171812644","chr3","123061433","123061549","17","48751094"
"chr2","171819549","171819842","chr17","63881751","63882049","36","107937798"
"chr2","171852559","171852869","chr17","63904734","63905025","55","107947825"
"chr2","171886149","171886436","chr17","63938937","63939223","25","107947212"
"chr2","171887361","171887590","chr5","118145796","118146018","60","53741565"
"chr2","171894948","171895225","chr17","63947096","63947377","44","107947852"
"chr2","171902945","171903234","chr17","63955431","63955713","43","107947514"
"chr2","171941647","171941903","chr3","16043315","16043565","61","155898332"
"chr2","171989042","171989342","chr17","64040647","64040925","61","107948395"
"chr2","172003691","172003961","chr3","109596935","109597203","53","62406756"
"chr2","172004928","172005028","chr1","36354985","36355078","16","135649943"
"chr2","172042674","172042937","chr17","64095782","64096081","66","107946892"
"chr2","172213667","172213953","chr17","64260585","64260884","41","107953082"
"chr2","172433972","172434117","chr12","91805211","91805359","41","80628761"
"chr2","172502456","172502767","chr17","64527264","64527584","47","107975192"
"chr2","172557257","172557543","chr17","64576972","64577269","67","107980285"
"chr2","172611535","172611698","chr17","64624335","64624506","24","107987200"
"chr2","172612526","172612839","chr17","64625362","64625668","58","107987164"
"chr2","172628663","172628833","chr17","64646027","64646204","22","107982636"
"chr2","172678651","172678787","chr17","64689068","64689185","33","107989583"
"chr2","172771560","172771739","chrX","100740983","100741152","48","72030577"
"chr2","172784464","172784644","chr6","36640552","36640719","54","136143912"
"chr2","172870802","172871083","chr17","64893019","64893301","43","107977783"
"chr2","172882842","172883132","chr17","64904794","64905103","55","107978048"
"chr2","173134749","173135018","chr17","65198444","65198722","59","107936305"
"chr2","173216244","173216537","chr17","65305988","65306276","42","107910256"
"chr2","173458659","173458999","chr17","65547539","65547840","90","107911120"
"chr2","173873987","173874278","chr7","57102915","57103193","82","116771072"
"chr2","173878674","173878969","chr17","65961282","65961585","62","107917392"
"chr2","173952247","173952531","chr17","66057377","66057660","48","107894870"
"chr2","174100676","174100976","chr12","37008661","37008946","87","137092015"
"chr2","174151740","174151854","chr1","39323331","39323445","29","134828409"
"chr2","174151978","174152190","chr7","77328663","77328875","60","96823315"
"chr2","174209193","174209275","chr17","66327472","66327551","21","107881721"
"chr2","174625907","174626086","chr17","66734163","66734373","46","107891744"
"chr2","174656892","174657179","chr16","37628731","37629010","79","137028161"
"chr2","174684939","174685163","chr17","66793664","66793893","37","107891275"
"chr2","174699173","174699446","chr17","66808977","66809258","44","107890196"
"chr2","174870696","174870933","chr6","3026087","3026331","61","171844609"
"chr2","174970738","174971043","chr17","67094168","67094458","61","107876570"
"chr2","175097899","175098035","chr14","35145745","35145882","36","139952154"
"chr2","175098333","175098621","chr17","67197653","67197944","39","107900680"
"chr2","175254785","175255074","chr14","87966934","87967222","67","87287851"
"chr2","175316555","175316868","chr20","30650986","30651299","65","144665569"
"chr2","175318686","175318861","chrX","54070249","54070425","43","121248437"
"chr2","175372648","175372704","chr1","46905561","46905614","14","128467087"
"chr2","175373453","175373593","chr2B","100228303","100228432","48","75145150"
"chr2","175689164","175689386","chrX","24030319","24030529","61","151658845"
"chr2","175721863","175722084","chr3","80995134","80995360","73","94726729"
"chr2","175918675","175918996","chr17","67976090","67976406","48","107942585"
"chr2","176194155","176194441","chr17","68237883","68238170","35","107956272"
"chr2","176206272","176206569","chr17","68249474","68249779","48","107956798"
"chr2","176240000","176240109","chr12","114837003","114837106","23","61402997"
"chr2","176299492","176299799","chr16","60701456","60701752","81","115598036"
"chr2","176429545","176429840","chr12","120660094","120660390","74","55769451"
"chr2","176512658","176512780","chr5","54098889","54099012","26","122413769"
"chr2","176633609","176633725","chr7","76940267","76940373","37","99693342"
"chr2","176633955","176634267","chr17","68671049","68671363","50","107962906"
"chr2","176749421","176749682","chr17","68787870","68788130","45","107961551"
"chr2","176759992","176760247","chr11","72474255","72474514","71","104285737"
"chr2","176770861","176771131","chr17","68804437","68804731","68","107966424"
"chr2","176864472","176864760","chr17","68908757","68909046","76","107955715"
"chr2","177054787","177055095","chr17","69103576","69103879","63","107951211"
"chr2","177255658","177255756","chr7","138217164","138217262","23","39038494"
"chr2","177428164","177428383","chr4","86572621","86572845","62","90855543"
"chr2","177532265","177532559","chr17","69540022","69540312","54","107992243"
"chr2","177549721","177549934","chr19","40628449","40628648","62","136921272"
"chr2","177726481","177726693","chr14","8519742","8519948","43","169206739"
"chr2","177931340","177931608","chr1","8581988","8582235","77","169349352"
"chr2","178359478","178359765","chr17","70373419","70373710","48","107986059"
"chr2","178407327","178407603","chr17","70418196","70418471","43","107989131"
"chr2","178464948","178465141","chr17","70472100","70472325","55","107992848"
"chr2","178577529","178577826","chr17","70586780","70587072","48","107990749"
"chr2","178731859","178731967","chr17","70726124","70726232","9","108005735"
"chr2","178772119","178772159","chr1","168512526","168512562","11","10259593"
"chr2","178772316","178772422","chr1","54554829","54554937","27","124217487"
"chr2","178901300","178901573","chr17","70891613","70891906","51","108009687"
"chr2","178929254","178929379","chr15","36011885","36012015","30","142917369"
"chr2","179056458","179056770","chr17","71062749","71063052","48","107993709"
"chr2","179126746","179127037","chr17","71134434","71134746","62","107992312"
"chr2","179152502","179152671","chr1","53190096","53190253","39","125962406"
"chr2","179486038","179486314","chr10","101163008","101163284","79","78323030"
"chr2","179643917","179644209","chr17","71753464","71753760","39","107890453"
"chr2","179754420","179754554","chr6","152102969","152103107","34","27651451"
"chr2","179830356","179830635","chr17","71936428","71936707","55","107893928"
"chr2","180097145","180097303","chr8","101392540","101392700","38","78704605"
"chr2","180204330","180204617","chr17","72343671","72343975","56","107860659"
"chr2","180233545","180233849","chr17","72379265","72379542","65","107854280"
"chr2","180237802","180238079","chr17","72384078","72384385","73","107853724"
"chr2","180420074","180420392","chr17","72544009","72544362","85","107876065"
"chr2","180629601","180629715","chr5","140930738","140930847","30","39698863"
"chr2","180777223","180777348","chr9","91930518","91930644","22","88846705"
"chr2","180902109","180902290","chr20","47965895","47966095","60","132936214"
"chr2","180970641","180970939","chr17","73079279","73079573","60","107891362"
"chr2","181009955","181010251","chr17","73116691","73117005","55","107893264"
"chr2","181077191","181077491","chr8","124654735","124655037","72","56422456"
"chr2","181297828","181298081","chr1","207183322","207183566","74","25885494"
"chr2","181446450","181446561","chr1","159238201","159238311","20","22208249"
"chr2","181480095","181480388","chr22","7540730","7541023","84","173939365"
"chr2","181555716","181555831","chr17","73642852","73642967","12","107912864"
"chr2","181559425","181559654","chrX","119761313","119761537","68","61798112"
"chr2","181573656","181573792","chr20","3645405","3645538","38","177928251"
"chr2","181764838","181764923","chr3","138424456","138424539","15","43340382"
"chr2","181859494","181859750","chr17","73954384","73954650","33","107905110"
"chr2","181980727","181980849","chr17","74132980","74133102","14","107847747"
"chr2","181995142","181995208","chr20","49674431","49674497","9","132320711"
"chr2","182012817","182013105","chr3","9222529","9222816","57","172790288"
"chr2","182046034","182046342","chr17","25788138","25788436","68","156257896"
"chr2","182125072","182125238","chr8","99225284","99225456","38","82899788"
"chr2","182127574","182127832","chr17","74179738","74180032","71","107947836"
"chr2","182345003","182345289","chr17","74417196","74417454","72","107927807"
"chr2","182505184","182505344","chr3","129419871","129420045","44","53085313"
"chr2","182727711","182727865","chr20","47776340","47776493","33","134951371"
"chr2","182984105","182984240","chr2B","94897282","94897419","35","88086823"
"chr2","183091955","183092039","chr17","75094496","75094582","10","107997459"
"chr2","183322659","183322939","chr17","75293189","75293465","30","108029470"
"chr2","183372405","183372705","chr17","75345304","75345635","62","108027101"
"chr2","183372818","183373156","chr1","150743963","150744290","95","32628855"
"chr2","183572197","183572349","chr17","75562284","75562438","19","108009913"
"chr2","183602317","183602401","chr1","140044636","140044720","25","43557681"
"chr2","183602617","183602828","chr19","10952873","10953079","47","172649744"
"chr2","183984183","183984357","chr17","75989476","75989653","24","107994707"
"chr2","184316587","184316807","chr5","14883892","14884110","53","169432695"
"chr2","184477608","184477883","chr12","65531316","65531597","67","118946292"
"chr2","184490503","184490642","chr4","114869510","114869641","46","69620993"
"chr2","184537795","184538092","chr17","76539959","76540240","49","107997836"
"chr2","184551967","184552250","chr17","76557296","76557572","45","107994671"
"chr2","184736983","184737203","chr17","76727155","76727386","38","108009828"
"chr2","184914761","184914876","chr1","215247941","215248058","23","30333180"
"chr2","184933029","184933153","chr17","77014114","77014242","20","107918915"
"chr2","184969886","184970183","chr17","77047163","77047450","46","107922723"
"chr2","184988169","184988414","chr19","6979832","6980089","69","178008337"
"chr2","185087653","185087876","chr2B","36330481","36330717","66","148757172"
"chr2","185148051","185148309","chr10","84926162","84926417","65","100221889"
"chr2","185156532","185156745","chr17","77234089","77234304","25","107922443"
"chr2","185215215","185215490","chr17","77293332","77293630","55","107921883"
"chr2","185250258","185250557","chr5","20442035","20442333","66","164808223"
"chr2","185453862","185454069","chr17","77552721","77552939","48","107901141"
"chr2","185593435","185593720","chr17","77699010","77699301","40","107894425"
"chr2","185661304","185661583","chr17","77765292","77765584","50","107896012"
"chr2","185704321","185704625","chr17","77812660","77812960","30","107891661"
"chr2","185725309","185725606","chr17","77825339","77825644","52","107899970"
"chr2","185843930","185844060","chr2A","17602188","17602313","37","168241742"
"chr2","185856062","185856349","chr17","78064361","78064651","50","107791701"
"chr2","185902887","185903159","chr10","141165937","141166211","61","44736950"
"chr2","185997455","185997762","chrX","55092704","55093010","67","130904751"
"chr2","186136995","186137111","chr15","37309851","37309968","18","148827144"
"chr2","186178999","186179282","chr2B","95772119","95772394","69","90406880"
"chr2","186204683","186204960","chr17","78382255","78382534","32","107822428"
"chr2","186254512","186254653","chr9","111231034","111231174","33","75023478"
"chr2","186264399","186264701","chr2B","53629601","53629902","59","132634798"
"chr2","186279482","186279801","chr17","78455858","78456159","54","107823624"
"chr2","186285160","186285277","chr7","48815343","48815460","13","137469817"
"chr2","186295203","186295301","chr16","30116131","30116226","18","156179072"
"chr2","186349276","186349581","chr6","39361368","39361664","66","146987908"
"chr2","186376577","186376694","chr8","28600846","28600965","18","157775731"
"chr2","186384606","186384885","chr17","78570891","78571161","51","107813715"
"chr2","186415960","186416252","chr17","78599799","78600103","43","107816161"
"chr2","186483347","186483623","chr12","119302733","119303013","58","67180614"
"chr2","186500065","186500347","chr1","61909366","61909638","76","124590699"
"chr2","186526679","186526973","chr17","78723045","78723317","55","107803634"
"chr2","186528658","186528760","chr1","90050036","90050137","22","96478622"
"chr2","186528765","186528894","chr21","16681946","16682077","25","169846819"
"chr2","186544673","186544766","chr7","67070764","67070858","22","119473909"
"chr2","186580339","186580643","chr17","78768743","78769050","34","107811596"
"chr2","186584932","186585080","chr12","105294886","105295035","31","81290046"
"chr2","186646014","186646308","chr7","102781710","102781998","54","83864304"
"chr2","186688295","186688412","chr16","37103044","37103155","29","149585251"
"chr2","186751015","186751220","chr13","31758150","31758354","51","154992865"
"chr2","186753059","186753391","chr1","76760615","76760914","85","109992444"
"chr2","186810066","186810371","chr17","78971889","78972192","36","107838177"
"chr2","187014553","187014846","chr17","79171044","79171335","46","107843509"
"chr2","187101244","187101389","chr20","21387138","21387289","34","165714106"
"chr2","187161686","187161826","chr1","188967838","188967994","39","1806152"
"chr2","187493031","187493315","chr12","113369447","113369739","64","74123584"
"chr2","187521862","187522153","chrX","120114409","120114704","72","67407453"
"chr2","187631780","187632058","chr14","76943072","76943349","55","110688708"
"chr2","187661400","187661701","chrX","114324443","114324737","62","73336957"
"chr2","187796094","187796387","chr4","99599591","99599886","69","88196503"
"chr2","187811551","187811865","chr17","79978894","79979203","40","107832657"
"chr2","187822234","187822525","chr17","79987736","79988030","41","107834498"
"chr2","188234913","188235181","chr17","80363226","80363489","37","107871687"
"chr2","188375469","188375545","chr4","48706794","48706865","17","139668675"
"chr2","188388108","188388386","chr17","80500082","80500384","57","107888026"
"chr2","188489307","188489614","chr1","216504542","216504847","59","28015235"
"chr2","188520112","188520393","chr12","123096820","123097105","57","65423292"
"chr2","188536485","188536770","chr20","61699406","61699695","54","126837079"
"chr2","188600502","188600588","chr8","85399383","85399472","20","103201119"
"chr2","188602159","188602466","chr17","80653516","80653806","49","107948643"
"chr2","188607412","188607665","chr6","91694307","91694564","65","96913105"
"chr2","188619568","188619858","chr12","113369447","113369739","60","75250121"
"chr2","188712794","188713076","chr17","80777043","80777332","48","107935751"
"chr2","188869990","188870216","chr17","80920691","80920923","36","107949299"
"chr2","188871120","188871417","chr17","80921762","80922048","43","107949358"
"chr2","188953663","188953780","chr19","15219953","15220058","31","173733710"
"chr2","189004947","189005027","chrX","411658","411734","17","188593289"
"chr2","189005187","189005282","chr10","90231830","90231924","25","98773357"
"chr2","189005384","189005513","chr8","78141063","78141187","21","110864321"
"chr2","189041621","189041934","chr17","81119766","81120080","45","107921855"
"chr2","189045730","189046029","chr10","129217595","129217874","64","59828135"
"chr2","189097466","189097567","chr6","119933784","119933888","25","69163682"
"chr2","189098537","189098647","chr1","133923244","133923350","27","55175293"
"chr2","189140412","189140550","chr7","109842246","109842373","36","79298166"
"chr2","189156502","189156646","chr20","37546011","37546154","35","151610491"
"chr2","189247919","189248206","chr7","77009635","77009928","72","112238284"
"chr2","189327002","189327287","chr2A","97057312","97057598","57","92269690"
"chr2","189331601","189331892","chr22","1750144","1750421","78","187581457"
"chr2","189347468","189347728","chr17","81399294","81399580","57","107948174"
"chr2","189358739","189358966","chr15","53802494","53802717","53","135556245"
"chr2","189383819","189384151","chr17","81433042","81433357","59","107950777"
"chr2","189443363","189443473","chrX","137745880","137745982","31","51697483"
"chr2","189443647","189443757","chr18","22807872","22807981","21","166635775"
"chr2","189443947","189444144","chr5","26184119","26184312","55","163259828"
"chr2","189446851","189447126","chr17","81495846","81496122","32","107951005"
"chr2","189458201","189458503","chr17","81505675","81505967","42","107952526"
"chr2","189472492","189472762","chr17","81519917","81520189","26","107952575"
"chr2","189489112","189489396","chr17","81530598","81530886","27","107958514"
"chr2","189502652","189502807","chr1","188967838","188967994","36","534814"
"chr2","189604359","189604579","chr17","81633006","81633230","42","107971353"
"chr2","189616127","189616272","chr1","68709407","68709549","32","120906720"
"chr2","189617525","189617819","chr5","45088510","45088801","53","144529015"
"chr2","189628671","189628959","chr17","81655561","81655862","40","107973110"
"chr2","189656579","189656868","chr9","14275444","14275739","56","175381135"
"chr2","189689807","189689935","chr17","81722863","81722986","19","107966944"
"chr2","189750063","189750337","chr17","81798876","81799172","49","107951187"
"chr2","189986745","189987000","chr17","5144237","5144498","58","184842508"
"chr2","190012215","190012513","chr17","82021080","82021374","57","107991135"
"chr2","190021649","190021925","chr17","82029991","82030278","46","107991658"
"chr2","190081595","190081713","chr17","82101719","82101842","13","107979876"
"chr2","190288188","190288404","chr17","82344025","82344242","35","107944163"
"chr2","190337517","190337718","chrX","48129374","48129565","57","142208143"
"chr2","190633865","190633959","chr17","82688232","82688325","15","107945633"
"chr2","190658706","190658826","chr12","2895244","2895364","16","187763462"
"chr2","190872255","190872552","chrX","19199530","19199816","87","171672725"
"chr2","191041971","191042240","chr19","4570608","4570877","77","186471363"
"chr2","191443925","191444069","chr10","92108530","92108678","37","99335395"
"chr2","191478127","191478433","chr17","83342110","83342434","52","108136017"
"chr2","191575537","191575848","chr17","83431233","83431522","56","108144304"
"chr2","191644982","191645295","chr2B","1674464","1674768","83","189970518"
"chr2","191975295","191975586","chr17","83795159","83795445","43","108180136"
"chr2","192039056","192039172","chr17","83847309","83847433","17","108191747"
"chr2","192216019","192216359","chr17","84011012","84011310","90","108205007"
"chr2","192232294","192232456","chr10","92108530","92108678","39","100123764"
"chr2","192330814","192331119","chr17","84121280","84121593","52","108209534"
"chr2","192354268","192354483","chr17","84143438","84143671","42","108210830"
"chr2","192381955","192382119","chr5","2493450","2493615","29","189888505"
"chr2","192406919","192407154","chr17","84190688","84190926","25","108216231"
"chr2","192458541","192458835","chr17","84241332","84241619","43","108217209"
"chr2","192546300","192546611","chr17","84310977","84311270","51","108235323"
"chr2","192588964","192589214","chr15","67260007","67260256","52","125328957"
"chr2","192589653","192589806","chrX","71299329","71299487","38","121290324"
"chr2","192646900","192647052","chr19","5169265","5169417","25","187477635"
"chr2","193313794","193314084","chr17","85030749","85031051","42","108283045"
"chr2","193347228","193347518","chr7","28366007","28366296","58","164981221"
"chr2","193378885","193379189","chr17","85092234","85092555","40","108286651"
"chr2","193383136","193383437","chr17","85096483","85096787","32","108286653"
"chr2","193430512","193430668","chr1","52325310","52325464","39","141105202"
"chr2","193453006","193453126","chr2A","51365225","51365343","19","142087781"
"chr2","193468189","193468504","chr17","85171371","85171686","59","108296818"
"chr2","193479994","193480281","chrX","70757717","70758005","48","122722277"
"chr2","193560596","193560694","chr10","11937949","11938048","28","181622647"
"chr2","193562356","193562651","chr17","85259332","85259623","39","108303024"
"chr2","193566867","193566983","chr17","85263588","85263710","22","108303279"
"chr2","193597441","193597556","chr17","85294714","85294830","11","108302727"
"chr2","193603409","193603570","chr5","49653517","49653681","37","143949892"
"chr2","193663732","193663925","chr2B","131325014","131325217","55","62338718"
"chr2","193687145","193687444","chr17","85379874","85380175","63","108307271"
"chr2","193718325","193718609","chr11","6054673","6054962","72","187663652"
"chr2","193740495","193740777","chr17","85426954","85427249","41","108313541"
"chr2","193780719","193780834","chr8","79737740","79737854","30","114042979"
"chr2","193864902","193865021","chr17","85537619","85537741","11","108327283"
"chr2","193880369","193880500","chrX","115736644","115736777","26","78143725"
"chr2","193953130","193953421","chr17","85626380","85626697","47","108326750"
"chr2","194363439","194363750","chr6","149430874","149431182","68","44932565"
"chr2","194407811","194407900","chr5","40734755","40734844","21","153673056"
"chr2","194477930","194478040","chrX","151208603","151208709","21","43269327"
"chr2","194494546","194494841","chr17","86086187","86086504","53","108408359"
"chr2","194518987","194519259","chr14","80158557","80158836","72","114360430"
"chr2","194720908","194721207","chr17","86309869","86310175","54","108411039"
"chr2","194912556","194912870","chr17","86504172","86504468","54","108408384"
"chr2","194948411","194948535","chr17","86539431","86539556","11","108408980"
"chr2","195196218","195196500","chr17","86793265","86793579","60","108402953"
"chr2","195335712","195335772","chr8","26632687","26632747","16","168703025"
"chr2","195335791","195335952","chr7","130371217","130371368","43","64964574"
"chr2","195387512","195387811","chr17","87002393","87002671","60","108385119"
"chr2","195824633","195824917","chr17","87472826","87473128","53","108351807"
"chr2","195867624","195867922","chr17","87518909","87519217","50","108348715"
"chr2","196093017","196093136","chr17","87669682","87669801","18","108423335"
"chr2","196128472","196128740","chr5","51674902","51675165","65","144453570"
"chr2","196189716","196189787","chr7","111850751","111850824","12","84338965"
"chr2","196202119","196202400","chr7","5095566","5095848","62","191106553"
"chr2","196553408","196553712","chr1","22239695","22239995","66","174313713"
"chr2","196720391","196720530","chr1","31279143","31279286","30","165441248"
"chr2","196735481","196735537","chr17","88243556","88243612","4","108491925"
"chr2","196760419","196760504","chr16","16288626","16288712","16","180471793"
"chr2","196804648","196804763","chr6","87517319","87517435","22","109287329"
"chr2","196887671","196887974","chr1","204577487","204577786","71","7689816"
"chr2","196936300","196936409","chr17","88453835","88453949","21","108482465"
"chr2","196990621","196990928","chr17","88523453","88523777","56","108467168"
"chr2","197059040","197059310","chr6","136621385","136621664","72","60437655"
"chr2","197198443","197198751","chr17","88745324","88745622","39","108453119"
"chr2","197277092","197277322","chr5","157637435","157637657","64","39639657"
"chr2","197517191","197517407","chr17","89007689","89007908","48","108509502"
"chr2","197520153","197520424","chr3","115450334","115450627","77","82069819"
"chr2","197521501","197521775","chr17","89012134","89012437","49","108509367"
"chr2","197523765","197524041","chr2B","27065408","27065684","35","170458357"
"chr2","197574110","197574405","chr17","89061262","89061555","47","108512848"
"chr2","197871766","197872021","chr7","29622332","29622582","63","168249434"
"chr2","197920467","197920758","chr17","89433614","89433933","57","108486853"
"chr2","197971464","197971617","chr9","20714539","20714685","45","177256925"
"chr2","198232486","198232673","chr20","62188034","62188219","46","136044452"
"chr2","198544132","198544371","chr17","90028014","90028251","45","108516118"
"chr2","198769781","198770101","chr17","90271377","90271688","40","108498404"
"chr2","198887123","198887411","chr17","90398531","90398827","46","108488592"
"chr2","198892807","198893118","chr17","90403939","90404262","51","108488868"
"chr2","199097971","199098262","chr17","90607063","90607358","31","108490908"
"chr2","199336966","199337262","chr17","90814261","90814538","45","108522705"
"chr2","199423693","199423915","chr17","90893400","90893621","33","108530293"
"chr2","200279037","200279145","chr17","91702698","91702822","24","108576339"
"chr2","200432908","200433036","chr12","51310862","51310985","24","149122046"
"chr2","200479666","200479818","chr10","92108530","92108678","30","108371136"
"chr2","200527402","200527640","chr16","31649333","31649595","68","168878069"
"chr2","200636721","200637018","chr17","92034297","92034602","47","108602424"
"chr2","200815997","200816276","chr1","23745534","23745807","72","177070463"
"chr2","200855500","200855616","chr22","14821499","14821616","17","186034001"
"chr2","201286478","201286593","chr5","112230612","112230727","20","89055866"
"chr2","201321933","201322233","chr17","92684461","92684747","58","108637472"
"chr2","201698252","201698552","chr11","64151943","64152241","62","137546309"
"chr2","201776332","201776601","chr17","93107449","93107742","53","108668883"
"chr2","201848241","201848405","chrX","20217061","20217227","39","181631180"
"chr2","202206504","202206649","chr19","32368694","32368817","42","169837810"
"chr2","202256059","202256217","chr21","24720942","24721101","36","177535117"
"chr2","202434971","202435255","chr17","93729980","93730268","39","108704991"
"chr2","202681953","202682087","chr1","44892994","44893123","28","157788959"
"chr2","203102510","203102812","chr16","57212544","57212846","59","145889966"
"chr2","203278714","203278999","chr14","73949286","73949565","70","129329428"
"chr2","203284881","203285154","chr10","85728500","85728775","59","117556381"
"chr2","203534687","203534818","chr4","71931988","71932119","27","131602699"
"chr2","203562579","203562885","chr17","94948454","94948769","58","108614125"
"chr2","203594251","203594403","chr10","92108530","92108678","30","111485721"
"chr2","203650565","203650693","chr1","9271571","9271700","29","194378994"
"chr2","203659703","203659828","chr1","96447703","96447827","30","107212000"
"chr2","203678062","203678158","chr19","15219953","15220058","28","188458109"
"chr2","203762527","203762682","chr4","45373065","45373214","54","158389462"
"chr2","203851087","203851390","chr19","2366218","2366516","66","201484869"
"chr2","203882958","203883099","chr17","95350636","95350789","47","108532322"
"chr2","204030038","204030288","chr6","44546586","44546829","64","159483452"
"chr2","204139315","204139403","chr17","95637245","95637338","13","108502070"
"chr2","204147116","204147405","chr18","20530306","20530599","69","183616810"
"chr2","204179306","204179554","chr20","49617065","49617314","71","154562241"
"chr2","204234967","204235267","chr17","95754840","95755145","51","108480127"
"chr3","121634710","121634996","chr4","83892895","83893209","67","37741815"
"chr3","81133532","81133834","chr4","124009348","124009645","61","42875816"
"chr3","150863721","150864013","chr9","49037740","49038035","51","101825981"
"chr3","184680371","184680670","chr4","6915949","6916249","36","177764422"
"chr3","67689","67977","chr20","29618752","29619041","54","29551063"
"chr3","180206","180496","chr4","202765773","202766073","53","202585567"
"chr3","197974","198246","chr4","202747043","202747319","28","202549069"
"chr3","246070","246324","chr3","46408861","46409117","68","46162791"
"chr3","371513","371816","chr4","202513998","202514307","57","202142485"
"chr3","381439","381715","chr16","30507685","30507953","81","30126246"
"chr3","558297","558579","chr4","202206911","202207221","59","201648614"
"chr3","565341","565613","chr4","202193935","202194202","45","201628594"
"chr3","570119","570418","chr4","202189169","202189468","39","201619050"
"chr3","692831","693117","chr4","202025877","202026163","44","201333046"
"chr3","779186","779493","chr4","201886647","201886926","69","201107461"
"chr3","1022270","1022563","chr1","11272743","11273038","79","10250473"
"chr3","1159946","1160077","chr7","11248117","11248241","27","10088171"
"chr3","1391049","1391334","chr11","18417240","18417530","72","17026191"
"chr3","1496566","1496866","chr4","200967894","200968185","60","199471328"
"chr3","1515377","1515535","chr12","19312537","19312701","42","17797160"
"chr3","1533931","1534212","chr6","157988523","157988810","52","156454592"
"chr3","1605684","1606038","chrX","136257569","136257932","112","134651885"
"chr3","1607482","1607652","chr1","184720130","184720300","31","183112648"
"chr3","1637835","1638135","chr4","200820579","200820879","46","199182744"
"chr3","1645241","1645510","chr4","200813079","200813373","71","199167838"
"chr3","1965321","1965611","chr1","45376642","45376922","90","43411321"
"chr3","1974324","1974598","chr4","200475590","200475862","49","198501266"
"chr3","2242365","2242651","chr9","108814804","108815078","74","106572439"
"chr3","2294865","2295156","chr4","200152479","200152759","46","197857614"
"chr3","2356533","2356815","chr4","200083355","200083634","76","197726822"
"chr3","2375281","2375517","chr7","102352933","102353173","44","99977652"
"chr3","2511951","2512144","chr9","49558353","49558544","48","47046402"
"chr3","2512843","2512949","chr20","29999827","29999928","20","27486984"
"chr3","2687460","2687742","chr9","92596920","92597200","58","89909460"
"chr3","2758691","2758986","chr10","132003577","132003889","69","129244886"
"chr3","2781716","2782022","chr4","199665852","199666146","37","196884136"
"chr3","2816385","2816512","chr20","30238448","30238572","23","27422063"
"chr3","2825396","2825669","chr4","199619184","199619474","58","196793788"
"chr3","2867014","2867320","chr4","199576395","199576683","49","196709381"
"chr3","2883067","2883378","chr4","199562526","199562840","57","196679459"
"chr3","2900356","2900540","chr1","183809138","183809317","47","180908782"
"chr3","2976759","2977007","chr4","199470229","199470478","40","196493470"
"chr3","2987767","2987886","chr3","38105418","38105547","25","35117651"
"chr3","3001675","3001991","chr4","199444864","199445198","61","196443189"
"chr3","3006188","3006495","chr7","126860755","126861058","69","123854567"
"chr3","3040302","3040573","chr4","199399064","199399344","55","196358762"
"chr3","3051727","3051842","chr12","110890537","110890653","16","107838810"
"chr3","3054016","3054289","chr4","199363736","199364014","49","196309720"
"chr3","3070902","3071198","chr4","199336530","199336802","54","196265628"
"chr3","3086979","3087280","chr7","77009635","77009928","60","73922656"
"chr3","3138357","3138589","chr4","199241173","199241439","57","196102816"
"chr3","3187372","3187595","chr19","18271347","18271565","58","15083975"
"chr3","3200096","3200320","chr5","19004132","19004370","67","15804036"
"chr3","3219387","3219643","chr4","199123384","199123638","28","195903997"
"chr3","3335056","3335342","chr4","198989554","198989841","39","195654498"
"chr3","3362183","3362471","chr4","198957250","198957557","47","195595067"
"chr3","3367951","3368249","chr4","198952610","198952900","34","195584659"
"chr3","3444916","3445204","chr4","198873310","198873613","69","195428394"
"chr3","3457920","3458158","chr19","16521553","16521779","56","13063633"
"chr3","3509631","3509794","chr21","34056187","34056352","40","30546556"
"chr3","3517870","3517995","chr4","198792096","198792220","22","195274226"
"chr3","3524496","3524639","chr1","23727757","23727901","32","20203261"
"chr3","3729989","3730136","chr4","120847527","120847667","41","117117538"
"chr3","3788183","3788351","chr10","115667294","115667466","32","111879111"
"chr3","3792127","3792160","chr16","59139351","59139386","8","55347224"
"chr3","3792447","3792557","chr7","69801927","69802033","27","66009480"
"chr3","3793117","3793235","chr16","40500610","40500729","29","36707493"
"chr3","3811162","3811438","chr4","198512577","198512855","23","194701415"
"chr3","3812361","3812650","chr2A","415376","415662","70","3396985"
"chr3","3923653","3923931","chr21","24524140","24524409","53","20600487"
"chr3","3970435","3970494","chr7","69801570","69801625","12","65831135"
"chr3","4008817","4009100","chr4","198308169","198308459","35","194299352"
"chr3","4054896","4055181","chr16","53556605","53556888","62","49501709"
"chr3","4111554","4111839","chr6","25348899","25349180","67","21237345"
"chr3","4149520","4149650","chr2A","3551885","3552014","24","597635"
"chr3","4155725","4155994","chr4","198180595","198180865","38","194024870"
"chr3","4168244","4168319","chr4","198165064","198165140","12","193996820"
"chr3","4241506","4241776","chr9","75566020","75566287","78","71324514"
"chr3","4277108","4277161","chr19","54410527","54410577","16","50133419"
"chr3","4278098","4278317","chr12","117939199","117939428","72","113661101"
"chr3","4287100","4287185","chr9","112863837","112863920","19","108576737"
"chr3","4287214","4287259","chrX","67984670","67984711","13","63697456"
"chr3","4287292","4287337","chrX","67984670","67984711","13","63697378"
"chr3","4329930","4330039","chr4","94047750","94047860","24","89717820"
"chr3","4367259","4367563","chr4","197983347","197983668","38","193616088"
"chr3","4411579","4411872","chr4","197940293","197940594","52","193528714"
"chr3","4434522","4434639","chr4","197913419","197913536","9","193478897"
"chr3","4437321","4437589","chr14","21204794","21205060","68","16767473"
"chr3","4458808","4459086","chr4","197890545","197890818","24","193431737"
"chr3","4503833","4503906","chr1","202567190","202567268","15","198063357"
"chr3","4549475","4549727","chr8","95036611","95036876","67","90487136"
"chr3","4564313","4564443","chr12","121933292","121933423","17","117368979"
"chr3","4627419","4627703","chr7","75980804","75981088","63","71353385"
"chr3","4671112","4671392","chr4","197626886","197627170","53","192955774"
"chr3","4729715","4729833","chr12","32518023","32518141","28","27788308"
"chr3","4779079","4779337","chr7","74375314","74375570","48","69596235"
"chr3","4827417","4827500","chr4","197483205","197483285","9","192655788"
"chr3","4874623","4874890","chr16","24982239","24982485","62","20107616"
"chr3","4907747","4908038","chr4","197420934","197421233","58","192513187"
"chr3","4918629","4918780","chr1","28338594","28338747","29","23419965"
"chr3","4931466","4931749","chr4","197400975","197401260","49","192469509"
"chr3","4934224","4934501","chr7","1708256","1708538","64","3225968"
"chr3","4987562","4987865","chr4","94010013","94010316","68","89022451"
"chr3","4996694","4996985","chr4","197330561","197330854","35","192333867"
"chr3","5000499","5000797","chr2B","53629601","53629902","68","48629102"
"chr3","5012017","5012339","chr14","58316895","58317188","93","53304878"
"chr3","5077131","5077435","chr4","197252806","197253090","46","192175675"
"chr3","5113349","5113648","chr4","197211689","197212010","51","192098340"
"chr3","5137583","5137729","chr4","186155842","186155989","32","181018259"
"chr3","5248432","5248517","chr14","54873414","54873500","15","49624982"
"chr3","5335938","5336220","chr1","91059171","91059456","54","85723233"
"chr3","5354512","5354768","chr7","74375314","74375570","53","69020802"
"chr3","5404737","5404869","chr5","124432264","124432393","22","119027527"
"chr3","5405746","5405877","chr7","77000001","77000126","32","71594255"
"chr3","5424989","5425229","chr4","196971662","196971898","36","191546673"
"chr3","5549913","5550208","chr4","196848519","196848815","36","191298606"
"chr3","5552639","5552945","chr4","196845403","196845717","54","191292764"
"chr3","5576078","5576230","chr10","29754500","29754651","37","24178422"
"chr3","5619079","5619374","chr4","196786448","196786744","48","191167369"
"chr3","5641273","5641573","chr4","196766313","196766626","46","191125040"
"chr3","5644027","5644127","chr4","196764055","196764142","23","191120028"
"chr3","5644490","5644716","chr4","196763141","196763373","43","191118651"
"chr3","5653686","5653960","chr4","196754253","196754532","30","191100567"
"chr3","5691078","5691351","chr10","144997752","144998019","75","139306674"
"chr3","5715462","5715566","chr19","17944871","17944975","28","12229409"
"chr3","5731947","5732231","chr3","37375904","37376188","69","31643957"
"chr3","5758354","5758609","chr4","196672817","196673105","61","190914463"
"chr3","5771521","5771824","chr7","73621576","73621874","60","67850055"
"chr3","5791044","5791317","chr4","196637463","196637744","34","190846419"
"chr3","5800539","5800661","chr1","101899772","101899895","17","96099233"
"chr3","5800948","5801136","chr4","196628561","196628759","27","190827613"
"chr3","5801429","5801469","chr14","10484579","10484626","8","4683150"
"chr3","5826433","5826721","chrX","101157934","101158208","73","95331501"
"chr3","5880248","5880533","chr4","196553731","196554039","55","190673483"
"chr3","5892434","5892522","chr11","129504754","129504840","18","123612320"
"chr3","5899335","5899633","chr4","196536060","196536352","54","190636725"
"chr3","5907081","5907379","chr4","196529019","196529338","53","190621938"
"chr3","5921202","5921475","chr4","196511407","196511673","37","190590205"
"chr3","5949862","5950140","chr4","196471693","196471968","30","190521831"
"chr3","5969048","5969329","chr1","11383012","11383296","55","5413964"
"chr3","5976390","5976554","chr1","9880179","9880343","41","3903789"
"chr3","5976626","5976760","chr16","59134844","59134968","39","53158218"
"chr3","6048949","6049034","chr4","196406230","196406315","8","190357281"
"chr3","6053573","6053695","chr10","18828471","18828593","19","12774898"
"chr3","6090816","6090904","chr4","196368015","196368103","7","190277199"
"chr3","6100004","6100292","chr4","196358819","196359109","34","190258815"
"chr3","6110681","6110777","chr21","4837821","4837916","24","1272860"
"chr3","6155921","6156199","chr4","196287780","196288040","34","190131859"
"chr3","6177302","6177546","chr19","40602950","40603177","64","34425648"
"chr3","6216081","6216368","chr4","196230890","196231176","39","190014809"
"chr3","6268216","6268300","chr19","44457165","44457246","20","38188949"
"chr3","6268715","6268859","chr20","37546011","37546154","33","31277296"
"chr3","6284351","6284662","chr4","196169415","196169724","33","189885064"
"chr3","6305086","6305373","chr4","196150826","196151108","34","189845740"
"chr3","6333127","6333405","chr4","196129212","196129499","64","189796085"
"chr3","6386383","6386497","chr8","87223424","87223537","16","80837041"
"chr3","6394150","6394282","chr14","57284316","57284449","15","50890166"
"chr3","6396718","6396843","chr6","18588428","18588554","28","12191710"
"chr3","6409347","6409656","chr4","196047186","196047504","40","189637839"
"chr3","6411234","6411354","chr8","143940123","143940247","22","137528889"
"chr3","6414346","6414467","chr7","68201010","68201132","18","61786664"
"chr3","6439294","6439585","chr9","110167879","110168150","73","103728585"
"chr3","6440745","6441044","chr1","129801098","129801391","62","123360353"
"chr3","6472332","6472634","chr4","196001557","196001846","43","189529225"
"chr3","6498770","6499062","chr18","1439558","1439848","64","5059212"
"chr3","6533686","6533971","chr4","195923665","195923980","48","189389979"
"chr3","6548192","6548506","chr5","79524474","79524776","79","72976282"
"chr3","6557284","6557572","chr5","77621588","77621877","75","71064304"
"chr3","6634675","6634815","chr16","67446140","67446290","38","60811465"
"chr3","6635536","6635614","chr4","195829051","195829127","10","189193515"
"chr3","6643134","6643408","chr4","195826493","195826787","65","189183359"
"chr3","6654197","6654258","chr10","39125423","39125481","8","32471226"
"chr3","6876716","6876991","chr4","195567213","195567496","44","188690497"
"chr3","6895901","6896049","chr1","45825944","45826093","47","38930043"
"chr3","6896102","6896232","chr3","188313519","188313645","25","181417417"
"chr3","6936764","6936870","chr8","8957635","8957751","30","2020871"
"chr3","6936991","6937293","chr7","138981355","138981648","62","132044364"
"chr3","6940855","6941150","chr4","195504649","195504949","40","188563794"
"chr3","6961997","6962271","chr4","195490012","195490310","57","188528015"
"chr3","7025262","7025522","chr4","195431405","195431646","45","188406143"
"chr3","7025960","7026194","chr4","195430410","195430638","26","188404450"
"chr3","7041839","7042136","chr4","195415290","195415590","39","188373451"
"chr3","7205734","7206018","chr4","195244103","195244392","45","188038369"
"chr3","7243667","7243954","chr4","195206338","195206631","55","187962671"
"chr3","7376708","7376976","chr4","195075599","195075887","60","187698891"
"chr3","7396546","7396803","chr2A","74626001","74626285","48","67229455"
"chr3","7400517","7400723","chr4","40096448","40096655","46","32695931"
"chr3","7414718","7415017","chr2A","74607422","74607721","35","67192704"
"chr3","7429870","7430174","chr16","53968524","53968798","53","46538654"
"chr3","7486537","7486819","chr4","195031106","195031379","31","187544569"
"chr3","7509475","7509769","chr4","195012065","195012370","43","187502590"
"chr3","7588053","7588319","chr2A","83494806","83495066","67","75906753"
"chr3","7667879","7668163","chr4","194848174","194848469","45","187180295"
"chr3","7708471","7708573","chr7","76940267","76940373","32","69231796"
"chr3","7742517","7742806","chr4","194776955","194777238","48","187034438"
"chr3","7763787","7764042","chr4","194755980","194756234","33","186992193"
"chr3","7788955","7789116","chr4","94534991","94535146","51","86746036"
"chr3","7793242","7793502","chr4","194736027","194736284","30","186942785"
"chr3","7867532","7867848","chr4","194667977","194668301","54","186800445"
"chr3","7954354","7954655","chr20","49877225","49877532","71","41922871"
"chr3","8003604","8003815","chr4","194524228","194524462","49","186520624"
"chr3","8038739","8038893","chr7","72558608","72558760","36","64519869"
"chr3","8072475","8072775","chr4","194450070","194450361","46","186377595"
"chr3","8079751","8079918","chr19","13310072","13310233","40","5230321"
"chr3","8131950","8132239","chr6","139671446","139671732","69","131539496"
"chr3","8245053","8245321","chr1","148480572","148480828","62","140235519"
"chr3","8263086","8263171","chr9","94237891","94237976","15","85974805"
"chr3","8263256","8263466","chr7","94612339","94612548","51","86349083"
"chr3","8368177","8368473","chr4","194149780","194150094","64","185781603"
"chr3","8389647","8389762","chr7","17083001","17083115","30","8693354"
"chr3","8409221","8409446","chr4","194112054","194112280","25","185702833"
"chr3","8497944","8498060","chr4","194019882","194019996","14","185521938"
"chr3","8519776","8520051","chr4","193996620","193996881","50","185476844"
"chr3","8640999","8641314","chr4","193864559","193864878","58","185223560"
"chr3","8661628","8661919","chr4","193844991","193845268","43","185183363"
"chr3","8679872","8680060","chr3","156401326","156401515","43","147721454"
"chr3","8737285","8737576","chr4","193767346","193767641","50","185030061"
"chr3","8738935","8739151","chr8","27368919","27369147","59","18629984"
"chr3","8794677","8794796","chr16","40805378","40805498","19","32010701"
"chr3","8803913","8804235","chr4","193702540","193702844","68","184898627"
"chr3","8817414","8817642","chr10","32491868","32492084","50","23674454"
"chr3","8827342","8827626","chr4","193677906","193678188","42","184850564"
"chr3","8898048","8898324","chr4","40586549","40586827","65","31688501"
"chr3","8930269","8930592","chr4","193572388","193572709","71","184642119"
"chr3","8941070","8941360","chr7","73138013","73138311","69","64196943"
"chr3","8952933","8953237","chr9","68344938","68345238","71","59392005"
"chr3","8979939","8980239","chr4","193527307","193527596","45","184547368"
"chr3","9004788","9004902","chr14","55024813","55024933","20","46020025"
"chr3","9055036","9055320","chr4","193453948","193454235","38","184398912"
"chr3","9062265","9062558","chr3","23991779","23992069","64","14929514"
"chr3","9062616","9062671","chr1","45292686","45292743","12","36230070"
"chr3","9107578","9107699","chr4","193407498","193407624","23","184299920"
"chr3","9186523","9186822","chr4","193328894","193329192","41","184142371"
"chr3","9187959","9188079","chr10","12650705","12650831","26","3462746"
"chr3","9188983","9189107","chr5","118113142","118113264","17","108924159"
"chr3","9223562","9223787","chr5","19086795","19087019","57","9863233"
"chr3","9258982","9259306","chr4","193252076","193252369","56","183993094"
"chr3","9308175","9308410","chr6","44546586","44546829","63","35238411"
"chr3","9318747","9319063","chr4","193198035","193198335","57","183879288"
"chr3","9396387","9396694","chr4","193124463","193124777","45","183728076"
"chr3","9476333","9476618","chr2B","62928542","62928811","74","53452209"
"chr3","9490351","9490477","chr4","193018889","193019013","18","183528538"
"chr3","9588417","9588707","chr4","192931236","192931539","62","183342819"
"chr3","9636332","9636621","chr10","30370353","30370654","75","20734021"
"chr3","9708877","9709054","chr5","37112145","37112316","48","27403268"
"chr3","9986973","9987271","chr4","192517277","192517575","33","182530304"
"chr3","10146310","10146583","chr1","216731191","216731452","65","206584881"
"chr3","10155135","10155360","chr4","183873671","183873898","68","173718536"
"chr3","10186653","10186944","chr4","192289631","192289928","63","182102978"
"chr3","10207008","10207308","chr4","192271056","192271333","57","182064048"
"chr3","10275144","10275225","chr3","177055012","177055093","24","166779868"
"chr3","10285213","10285505","chr4","192204819","192205099","46","181919606"
"chr3","10295818","10295935","chr8","108964883","108965000","23","98669065"
"chr3","10501477","10501623","chr18","20901830","20901975","36","10400353"
"chr3","10713091","10713391","chr1","206300643","206300936","64","195587552"
"chr3","10778277","10778440","chr19","13310072","13310233","38","2531795"
"chr3","10867053","10867237","chr22","25490059","25490239","41","14623006"
"chr3","11075772","11076072","chr4","191376514","191376824","45","180300742"
"chr3","11076575","11076863","chr8","24737260","24737543","74","13660685"
"chr3","11169998","11170293","chr4","191096514","191096797","64","179926516"
"chr3","11210657","11210935","chr4","191163776","191164081","60","179953119"
"chr3","11477092","11477357","chr4","190960874","190961126","56","179483782"
"chr3","11534999","11535073","chr14","36173800","36173875","16","24638801"
"chr3","11535191","11535367","chr7","2282512","2282679","52","9252679"
"chr3","11585367","11585670","chr4","190837364","190837679","58","179251997"
"chr3","11707374","11707636","chr4","190712847","190713107","54","179005473"
"chr3","11769902","11770198","chr4","190652646","190652945","47","178882744"
"chr3","11848316","11848618","chr4","190573919","190574221","54","178725603"
"chr3","11874524","11874656","chr14","54547555","54547673","40","42673031"
"chr3","12068303","12068606","chr4","190353153","190353461","68","178284850"
"chr3","12074911","12075063","chr12","12319155","12319307","37","244244"
"chr3","12075470","12075622","chr3","267312","267456","39","11808158"
"chr3","12075919","12076021","chr13","5023158","5023268","25","7052761"
"chr3","12111851","12112106","chr7","140457648","140457905","58","128345797"
"chr3","12115285","12115330","chrX","47925056","47925101","9","35809771"
"chr3","12161355","12161438","chr9","91641539","91641621","16","79480184"
"chr3","12191537","12191821","chr4","190220847","190221148","42","178029310"
"chr3","12253370","12253475","chr16","20134082","20134187","28","7880712"
"chr3","12266401","12266720","chr11","33078129","33078435","98","20811728"
"chr3","12271586","12271894","chr4","190143524","190143831","40","177871938"
"chr3","12285337","12285648","chr4","190131208","190131492","58","177845871"
"chr3","12307184","12307405","chr4","190101156","190101380","27","177793972"
"chr3","12379823","12379945","chr2B","62240327","62240449","27","49860504"
"chr3","12577655","12577899","chr19","49541565","49541819","53","36963910"
"chr3","12776974","12777088","chr4","189663982","189664095","12","176887008"
"chr3","12839629","12839889","chr19","31483985","31484243","56","18644356"
"chr3","12972386","12972674","chr8","76122420","76122709","85","63150034"
"chr3","12972707","12972853","chr4","189487563","189487718","23","176514856"
"chr3","13003837","13003936","chr12","111845659","111845746","30","98841822"
"chr3","13033573","13033620","chr6","110852585","110852633","11","97819012"
"chr3","13033688","13033784","chr1","205691004","205691099","26","192657316"
"chr3","13062878","13063175","chr4","189395534","189395828","49","176332656"
"chr3","13079200","13079478","chr4","189380240","189380526","51","176301040"
"chr3","13345372","13345713","chr4","189083612","189083944","43","175738240"
"chr3","13432751","13433033","chr9","92741261","92741542","69","79308510"
"chr3","13527108","13527381","chr4","188910705","188910971","50","175383597"
"chr3","13528350","13528644","chr4","188909462","188909734","63","175381112"
"chr3","13531154","13531444","chr4","188905511","188905809","61","175374357"
"chr3","13540269","13540421","chr9","112773743","112773894","60","99233474"
"chr3","13571011","13571305","chr4","188865918","188866234","65","175294907"
"chr3","13626918","13627204","chr10","91501298","91501572","68","77874380"
"chr3","13731085","13731351","chr12","37592681","37592945","65","23861596"
"chr3","13736042","13736278","chr19","49388334","49388576","63","35652292"
"chr3","13803114","13803388","chr17","29455896","29456172","64","15652782"
"chr3","13823221","13823510","chr4","188629536","188629825","28","174806315"
"chr3","13891875","13892168","chr4","188558077","188558352","45","174666202"
"chr3","13931129","13931416","chr12","75922836","75923111","70","61991707"
"chr3","13946963","13947265","chr19","3242003","3242298","75","10704960"
"chr3","14090207","14090496","chr4","188346703","188347013","59","174256496"
"chr3","14298039","14298334","chr4","188144136","188144446","60","173846097"
"chr3","14369787","14370078","chr4","187972667","187972963","42","173602880"
"chr3","14588200","14588496","chr4","187689077","187689372","41","173100877"
"chr3","14643203","14643355","chr10","108461325","108461484","49","93818122"
"chr3","14643509","14643636","chr1","215648878","215649005","26","201005369"
"chr3","14825885","14826194","chr1","158365862","158366158","80","143539977"
"chr3","14895358","14895571","chr4","187371705","187371933","44","172476347"
"chr3","14896677","14896971","chr4","187370377","187370688","59","172473700"
"chr3","14933182","14933464","chr5","164483646","164483925","55","149550464"
"chr3","14963107","14963356","chr1","219902103","219902351","69","204938996"
"chr3","14973081","14973363","chr10","90821089","90821368","64","75848008"
"chr3","14983734","14984021","chr4","187278293","187278578","49","172294559"
"chr3","14995680","14995979","chr4","187262877","187263168","34","172267197"
"chr3","15001033","15001110","chr12","12170019","12170097","19","2831014"
"chr3","15070736","15070972","chr4","187190741","187190968","32","172120005"
"chr3","15087369","15087531","chr3","49411661","49411824","32","34324292"
"chr3","15091673","15091797","chr6","90942219","90942343","28","75850546"
"chr3","15100942","15101193","chr1","217102109","217102356","73","202001167"
"chr3","15110670","15110978","chr4","187162535","187162848","43","172051865"
"chr3","15114667","15114993","chr4","187158969","187159269","87","172044302"
"chr3","15218242","15218533","chr4","187044206","187044497","58","171825964"
"chr3","15235209","15235331","chr4","187027491","187027606","17","171792282"
"chr3","15236800","15237060","chr12","36935807","36936067","50","21699007"
"chr3","15346406","15346682","chr4","186914793","186915097","64","171568387"
"chr3","15347642","15347954","chr3","45828868","45829172","75","30481226"
"chr3","15373529","15373741","chr3","182151159","182151370","45","166777630"
"chr3","15710525","15710822","chr4","186555105","186555410","61","170844580"
"chr3","15770753","15771062","chr4","186510031","186510320","62","170739278"
"chr3","15798543","15798838","chr4","186487284","186487595","45","170688741"
"chr3","15896051","15896175","chr13","11074766","11074892","23","4821285"
"chr3","16002092","16002380","chr12","119924890","119925172","75","103922798"
"chr3","16077588","16077876","chr10","116030993","116031276","65","99953405"
"chr3","16087222","16087520","chr4","186229628","186229929","38","170142406"
"chr3","16092062","16092360","chr4","186226801","186227099","47","170134739"
"chr3","16159362","16159474","chr4","186160023","186160141","19","170000661"
"chr3","16162428","16162658","chr3","57019808","57020030","56","40857380"
"chr3","16215248","16215563","chr4","186113399","186113710","37","169898151"
"chr3","16294832","16295126","chr4","186032592","186032876","37","169737760"
"chr3","16366155","16366451","chr4","185964705","185965013","42","169598550"
"chr3","16408307","16408585","chr4","185933944","185934222","29","169525637"
"chr3","16435713","16435984","chr1","94463809","94464075","80","78028096"
"chr3","16561750","16561876","chr17","63212955","63213066","33","46651205"
"chr3","16608818","16609103","chr4","185733322","185733618","40","169124504"
"chr3","16622730","16623037","chr4","185738002","185738292","56","169115272"
"chr3","17091303","17091587","chr4","185284337","185284616","40","168193034"
"chr3","17119057","17119364","chr4","185257337","185257663","57","168138280"
"chr3","17120667","17120989","chr4","185255908","185256204","61","168135241"
"chr3","17131392","17131699","chr5","21461222","21461528","62","4329830"
"chr3","17202816","17202925","chr7","14967118","14967225","37","2235698"
"chr3","17438507","17438769","chr17","13198418","13198657","71","4240089"
"chr3","17521402","17521665","chr4","184879606","184879869","29","167358204"
"chr3","17533769","17534017","chr4","184864507","184864780","65","167330738"
"chr3","17639675","17639843","chr6","137736682","137736850","31","120097007"
"chr3","17687684","17687891","chr4","184713112","184713322","27","167025428"
"chr3","17693973","17694251","chr4","184706729","184707011","35","167012756"
"chr3","17725206","17725485","chr4","184670094","184670381","46","166944888"
"chr3","17753255","17753559","chr4","120336534","120336832","66","102583279"
"chr3","17803135","17803418","chr9","34327321","34327603","61","16524186"
"chr3","17833093","17833212","chr4","112780763","112780884","28","94947670"
"chr3","17835902","17836036","chr1","8534968","8535103","36","9300934"
"chr3","17840229","17840519","chrX","96537513","96537800","71","78697284"
"chr3","17858474","17858679","chr4","184530777","184530979","36","166672303"
"chr3","17859920","17860203","chr4","184529408","184529691","42","166669488"
"chr3","18051166","18051389","chr19","47222654","47222887","62","29171488"
"chr3","18138670","18138955","chr4","184306429","184306719","37","166167759"
"chr3","18157630","18157924","chr13","77606875","77607140","88","59449245"
"chr3","18349283","18349582","chr4","184119222","184119514","41","165769939"
"chr3","18604911","18605201","chr16","64417853","64418132","77","45812942"
"chr3","18617099","18617327","chr4","183873671","183873898","23","165256572"
"chr3","19031446","19031589","chr6","110183338","110183492","44","91151892"
"chr3","19179678","19179964","chr4","183321711","183321993","36","164142033"
"chr3","19227805","19227907","chr3","135601790","135601888","23","116373985"
"chr3","19228014","19228116","chr15","43039727","43039821","22","23811713"
"chr3","19589197","19589314","chr1","197987006","197987122","15","178397809"
"chr3","19622966","19623128","chr6","15264957","15265121","34","4358009"
"chr3","19651044","19651345","chr4","182825341","182825633","53","163174297"
"chr3","19722322","19722586","chr4","182739171","182739431","33","163016849"
"chr3","19781561","19781680","chr10","39817913","39818037","21","20036352"
"chr3","19793165","19793263","chr7","7587303","7587406","23","12205862"
"chr3","19803349","19803622","chr4","182663997","182664287","38","162860648"
"chr3","19821440","19821588","chr4","182641032","182641181","17","162819592"
"chr3","19833601","19833892","chr19","16576878","16577161","61","3256723"
"chr3","19834460","19834782","chr4","182627329","182627642","43","162792869"
"chr3","19855444","19855636","chr16","60381597","60381800","53","40526153"
"chr3","19858185","19858302","chr12","69436089","69436209","23","49577904"
"chr3","19863500","19863706","chr5","52550422","52550634","62","32686922"
"chr3","19873260","19873530","chr4","182578241","182578526","42","162704981"
"chr3","19911162","19911303","chr1","32906926","32907068","36","12995764"
"chr3","19983584","19983877","chr2A","42403475","42403771","51","22419891"
"chr3","19994289","19994586","chr4","15446892","15447188","63","4547397"
"chr3","20012477","20012665","chr9","34728925","34729115","26","14716448"
"chr3","20033900","20034196","chr9","34710345","34710606","71","14676445"
"chr3","20040398","20040605","chr4","182421064","182421288","37","162380666"
"chr3","20041551","20041845","chr4","182419819","182420126","56","162378268"
"chr3","20058257","20058554","chr16","22298600","22298892","65","2240343"
"chr3","20094684","20094969","chr8","25743065","25743351","65","5648381"
"chr3","20097268","20097537","chr4","182361677","182361980","55","162264409"
"chr3","20102728","20103059","chr7","85090260","85090565","90","64987532"
"chr3","20110008","20110283","chr4","182346755","182347051","47","162236747"
"chr3","20138376","20138668","chr7","127917187","127917476","55","107778811"
"chr3","20175769","20176058","chr4","182310178","182310490","63","162134409"
"chr3","20223061","20223321","chr4","182243331","182243617","60","162020270"
"chr3","20253573","20253803","chr6","131844092","131844319","50","111590519"
"chr3","20260986","20261253","chr4","182205867","182206150","38","161944881"
"chr3","20265728","20265850","chr3","43550794","43550917","24","23285066"
"chr3","20281411","20281696","chr4","182197806","182198079","40","161916395"
"chr3","20283821","20283943","chr4","73463953","73464076","20","53180132"
"chr3","20284474","20284677","chr6","91035512","91035718","49","70751038"
"chr3","20292818","20293101","chr10","56909028","56909299","55","36616210"
"chr3","20312092","20312371","chr4","182173274","182173557","38","161861182"
"chr3","20324871","20325159","chr4","182169598","182169909","50","161844727"
"chr3","20333783","20334070","chr4","182161839","182162117","32","161828056"
"chr3","20338554","20338826","chr20","17791358","17791638","55","2547196"
"chr3","20393211","20393348","chr7","74987888","74988024","23","54594677"
"chr3","20410825","20411128","chr4","182052332","182052639","32","161641507"
"chr3","20440417","20440708","chr4","182023191","182023485","50","161582774"
"chr3","20461783","20461885","chr18","77841068","77841169","16","57379285"
"chr3","20520446","20520622","chr4","181949629","181949816","34","161429183"
"chr3","20520973","20521057","chr7","4939048","4939129","17","15581925"
"chr3","20537786","20538021","chr21","26544763","26544999","50","6006977"
"chr3","20573743","20573874","chr4","181901418","181901541","13","161327675"
"chr3","20610048","20610322","chrX","24116204","24116475","52","3506156"
"chr3","20628728","20628854","chr8","9176979","9177104","29","11451749"
"chr3","20628944","20629061","chr20","46080183","46080300","17","25451239"
"chr3","20647693","20647971","chr4","181832038","181832307","46","161184345"
"chr3","20666458","20666772","chr4","181813579","181813890","37","161147121"
"chr3","20668896","20669192","chr15","64262336","64262638","59","43593440"
"chr3","20679567","20679842","chr4","181799223","181799499","37","161119656"
"chr3","20685017","20685180","chrX","17937151","17937313","30","2747866"
"chr3","20696479","20696775","chr6","172537406","172537700","65","151840927"
"chr3","20723068","20723361","chr4","6703003","6703295","61","14020065"
"chr3","20839283","20839573","chr4","181651238","181651537","47","160811955"
"chr3","20905540","20905835","chr4","181583759","181584041","47","160678219"
"chr3","20923627","20923903","chr4","181566992","181567266","26","160643365"
"chr3","20934029","20934286","chr4","181556187","181556460","49","160622158"
"chr3","20947244","20947522","chr20","9640953","9641236","68","11306291"
"chr3","20949420","20949554","chrX","2794957","2795096","34","18154463"
"chr3","20949911","20950035","chr2A","64428266","64428391","17","43478355"
"chr3","20954980","20955104","chrX","67999852","67999976","18","47044872"
"chr3","21001787","21001882","chr4","181486363","181486463","18","160484576"
"chr3","21077974","21078299","chr16","40146461","40146771","73","19068487"
"chr3","21112763","21113065","chr4","181382810","181383114","36","160270047"
"chr3","21146498","21146776","chr4","181349335","181349616","40","160202837"
"chr3","21194430","21194712","chr4","151944849","151945132","62","130750419"
"chr3","21269499","21269573","chr4","110476772","110476847","18","89207273"
"chr3","21276296","21276613","chr5","31806518","31806817","83","10530222"
"chr3","21286026","21286328","chr4","181237835","181238147","37","159951809"
"chr3","21310240","21310351","chr8","85941093","85941209","28","64630853"
"chr3","21336012","21336175","chr5","118399435","118399596","41","97063423"
"chr3","21408401","21408663","chr4","181127885","181128142","36","159719484"
"chr3","21505513","21505651","chr19","47379993","47380130","26","25874480"
"chr3","21850363","21850625","chr8","95036611","95036876","58","73186248"
"chr3","21934134","21934408","chr4","180640317","180640587","55","158706183"
"chr3","22133189","22133442","chr2A","74967956","74968209","75","52834767"
"chr3","22313320","22313636","chr4","180323780","180324096","54","158010460"
"chr3","22344766","22345020","chr4","180306647","180306901","34","157961881"
"chr3","22760226","22760527","chr4","179962429","179962747","61","157202203"
"chr3","22865705","22865944","chr4","179873307","179873547","39","157007602"
"chr3","23038679","23038960","chr4","179754534","179754817","52","156715855"
"chr3","23242353","23242656","chr4","179639559","179639865","43","156397206"
"chr3","23278587","23278872","chrX","24116204","24116475","73","837617"
"chr3","23334030","23334317","chr4","179561362","179561636","55","156227332"
"chr3","23414314","23414604","chr4","179516220","179516527","60","156101906"
"chr3","23458784","23458935","chr6","77626450","77626592","43","54167666"
"chr3","25323631","25323945","chr4","178731436","178731745","35","153407805"
"chr3","25333554","25333825","chr8","105430611","105430872","61","80097057"
"chr3","25429203","25429483","chr12","8922143","8922434","64","16507060"
"chr3","25505195","25505438","chr7","126954151","126954393","57","101448956"
"chr3","25563560","25563867","chr4","178485229","178485538","35","152921669"
"chr3","25685277","25685387","chr4","178366782","178366894","20","152681505"
"chr3","25989588","25989799","chr22","26216898","26217118","56","227310"
"chr3","25990361","25990462","chr1","224475401","224475502","24","198485040"
"chr3","26022141","26022435","chr4","178091301","178091621","55","152069160"
"chr3","26037747","26037997","chr4","178077906","178078146","48","152040159"
"chr3","26080195","26080485","chr4","178042990","178043300","57","151962795"
"chr3","26085042","26085324","chr1","15670329","15670615","61","10414713"
"chr3","26140739","26141019","chr5","139426874","139427147","61","113286135"
"chr3","26242508","26242632","chr16","69212656","69212783","30","42970148"
"chr3","26285470","26285594","chr20","5021579","5021702","20","21263891"
"chr3","26292421","26292700","chr2B","62123696","62123980","61","35831275"
"chr3","26298090","26298217","chr20","30238448","30238572","22","3940358"
"chr3","26298343","26298506","chr8","73679726","73679887","33","47381383"
"chr3","26309435","26309539","chr4","121283672","121283773","24","94974237"
"chr3","26315399","26315536","chr10","12396902","12397037","21","13918497"
"chr3","26337256","26337370","chr5","157253554","157253671","17","130916298"
"chr3","26345646","26345948","chr12","123557834","123558136","66","97212188"
"chr3","26355478","26355828","chr11","29989382","29989709","103","3633904"
"chr3","26395703","26395829","chr10","12650705","12650831","29","13744998"
"chr3","26430005","26430294","chr4","177726532","177726817","46","151296527"
"chr3","26436312","26436391","chr12","111226739","111226819","23","84790427"
"chr3","26450480","26450607","chr4","177714745","177714872","21","151264265"
"chr3","26455271","26455362","chr1","22458308","22458399","16","3996963"
"chr3","26461942","26462046","chr2B","88390704","88390808","19","61928762"
"chr3","26557340","26557596","chr4","177647070","177647343","45","151089730"
"chr3","26605178","26605465","chr4","177595723","177596014","73","150990545"
"chr3","26616950","26617257","chr4","177588967","177589272","55","150972017"
"chr3","26618823","26618929","chr12","114830969","114831073","19","88212146"
"chr3","26643279","26643445","chr2A","64805346","64805507","38","38162067"
"chr3","26680608","26680870","chr16","24479337","24479588","64","2201271"
"chr3","26767631","26767927","chr4","177460403","177460716","47","150692772"
"chr3","26887179","26887470","chr22","4785897","4786183","73","22101282"
"chr3","27030659","27030804","chr22","8436942","8437088","36","18593717"
"chr3","27666922","27667188","chr1","216731191","216731452","54","189064269"
"chr3","27882411","27882725","chr7","56987126","56987434","75","29104715"
"chr3","27969395","27969678","chr12","61975094","61975386","71","34005699"
"chr3","28074415","28074530","chr6","161684019","161684134","21","133609604"
"chr3","28191194","28191479","chr10","63726053","63726351","69","35534859"
"chr3","28217194","28217466","chr10","14090497","14090769","71","14126697"
"chr3","28291345","28291467","chr22","5184977","5185101","19","23106368"
"chr3","28373732","28374027","chr4","176061660","176061957","28","147687928"
"chr3","28379399","28379671","chr19","57650693","57650963","62","29271294"
"chr3","28416056","28416185","chr4","176019815","176019947","16","147603759"
"chr3","28439641","28439755","chr18","46434429","46434545","22","17994788"
"chr3","28467957","28468235","chr4","175961223","175961498","39","147493266"
"chr3","28510715","28511014","chr4","175924450","175924730","60","147413735"
"chr3","28524401","28524696","chr4","175912540","175912839","39","147388139"
"chr3","28602548","28602675","chrX","45026169","45026298","26","16423621"
"chr3","28641084","28641383","chr4","175790052","175790342","38","147148968"
"chr3","28647674","28647798","chr4","175784148","175784268","21","147136474"
"chr3","28647933","28648090","chr4","187312955","187313109","31","158665022"
"chr3","28721613","28721761","chr15","69740012","69740164","42","41018399"
"chr3","28834849","28834970","chr4","88853038","88853160","20","60018189"
"chr3","29002340","29002623","chr4","175522053","175522343","42","146519713"
"chr3","29067221","29067431","chrX","104171764","104171968","51","75104543"
"chr3","29094732","29095054","chr4","175441069","175441369","79","146346337"
"chr3","29149843","29150079","chr3","49738899","49739127","52","20589056"
"chr3","29361798","29362085","chr4","175189886","175190175","48","145828088"
"chr3","29427019","29427271","chr4","175119764","175120025","48","145692745"
"chr3","29885010","29885215","chr7","7644382","7644601","62","22240628"
"chr3","30174393","30174668","chr4","174435617","174435909","45","144261224"
"chr3","30237111","30237418","chr4","174383882","174384186","49","144146771"
"chr3","30270647","30270763","chr16","37103044","37103155","25","6832397"
"chr3","30355747","30356026","chrX","96537513","96537800","78","66181766"
"chr3","30440757","30441059","chr4","174204508","174204809","47","143763751"
"chr3","30854298","30854500","chr6","867263","867478","58","29987035"
"chr3","31031861","31032020","chr2A","13681359","13681534","53","17350502"
"chr3","31310544","31310843","chr4","173316403","173316705","48","142005859"
"chr3","31460206","31460335","chr20","5017270","5017399","26","26442936"
"chr3","31511903","31512182","chr4","173112987","173113285","65","141601084"
"chr3","32021299","32021535","chr16","15244242","15244482","44","16777057"
"chr3","32257773","32258078","chr4","172396574","172396879","52","140138801"
"chr3","32384094","32384409","chr4","172286639","172286979","73","139902545"
"chr3","32437174","32437451","chr4","172242146","172242437","44","139804972"
"chr3","32487824","32487978","chr20","52655766","52655919","37","20167942"
"chr3","32703615","32703729","chr4","172023957","172024072","13","139320342"
"chr3","32729899","32730161","chr4","171984036","171984297","34","139254137"
"chr3","32733059","32733329","chr4","171981097","171981361","25","139248038"
"chr3","32737444","32737613","chr9","49190144","49190309","41","16452700"
"chr3","32737614","32737907","chr19","46807689","46807981","52","14070075"
"chr3","32738113","32738229","chr8","108964883","108965000","20","76226770"
"chr3","32742063","32742322","chr4","171973692","171973978","55","139231629"
"chr3","32752766","32752895","chrX","45621362","45621486","22","12868596"
"chr3","32756004","32756209","chr1","181467874","181468072","46","148711870"
"chr3","32772115","32772413","chr4","171940303","171940595","35","139168188"
"chr3","32812023","32812302","chr9","49534382","49534667","67","16722359"
"chr3","32831683","32831985","chr4","171880659","171880940","60","139048976"
"chr3","32865051","32865175","chr5","5020376","5020500","25","27844675"
"chr3","32928039","32928342","chr18","5198270","5198556","77","27729769"
"chr3","32981138","32981443","chr4","171736222","171736532","67","138755084"
"chr3","33024542","33024671","chr10","12650705","12650831","30","20373837"
"chr3","33056377","33056686","chr4","171676496","171676797","49","138620119"
"chr3","33075424","33075725","chr4","171657062","171657350","45","138581638"
"chr3","33079090","33079252","chr18","5568484","5568639","33","27510606"
"chr3","33098199","33098495","chr12","6311804","6312103","55","26786395"
"chr3","33105643","33105937","chr4","171632732","171633007","50","138527089"
"chr3","33122131","33122425","chr4","171619315","171619591","56","138497184"
"chr3","33143073","33143172","chr5","14822723","14822826","25","18320350"
"chr3","33157630","33157694","chr4","171574356","171574418","5","138416726"
"chr3","33163246","33163531","chr4","171569586","171569875","39","138406340"
"chr3","33166003","33166124","chr11","95657018","95657142","20","62491015"
"chr3","33191922","33192050","chr1","9271571","9271700","39","23920351"
"chr3","33229963","33230055","chr5","138623546","138623638","17","105393583"
"chr3","33231227","33231523","chr4","171503469","171503768","33","138272242"
"chr3","33232708","33232924","chr10","27117159","27117365","49","6115549"
"chr3","33280307","33280408","chr4","131793073","131793163","26","98512766"
"chr3","33330205","33330509","chr4","171387213","171387498","68","138057008"
"chr3","33351569","33351882","chr4","171371918","171372226","36","138020349"
"chr3","33354381","33354661","chr4","171369103","171369389","38","138014722"
"chr3","33361232","33361530","chr4","171362735","171363037","41","138001503"
"chr3","33401915","33402201","chr5","129782995","129783290","56","96381080"
"chr3","33412983","33413236","chr16","31649333","31649595","57","1763650"
"chr3","33430209","33430497","chr4","171302629","171302925","48","137872420"
"chr3","33448872","33448980","chr19","17944871","17944975","19","15504001"
"chr3","33469050","33469320","chr4","171259242","171259530","48","137790192"
"chr3","33485622","33485915","chr4","171241576","171241876","32","137755954"
"chr3","33498617","33498763","chr1","68709407","68709549","41","35210790"
"chr3","33504117","33504159","chr1","165141492","165141538","9","131637375"
"chr3","33508579","33508738","chr5","2493450","2493615","31","31015129"
"chr3","33510418","33510701","chr3","158594820","158595107","60","125084402"
"chr3","33519100","33519413","chr4","171201409","171201716","48","137682309"
"chr3","33542697","33542987","chr7","76460127","76460416","69","42917430"
"chr3","33552310","33552602","chr4","171168038","171168328","48","137615728"
"chr3","33570838","33571127","chr4","171157301","171157560","58","137586463"
"chr3","33575498","33575793","chr4","171151206","171151497","31","137575708"
"chr3","33700984","33701104","chr3","134832407","134832530","22","101131423"
"chr3","33741850","33741975","chr14","33356766","33356889","24","385084"
"chr3","33789952","33790241","chr4","170908229","170908537","53","137118277"
"chr3","33843942","33844232","chr1","110444357","110444639","59","76600415"
"chr3","33847344","33847655","chr4","170849891","170850191","60","137002547"
"chr3","33848528","33848821","chr4","170848740","170849035","30","137000212"
"chr3","33850942","33851213","chr4","170844562","170844855","46","136993620"
"chr3","33896912","33897193","chr4","170787780","170788057","43","136890868"
"chr3","33916176","33916259","chr5","36110533","36110617","18","2194357"
"chr3","34020542","34020815","chrX","134691154","134691436","63","100670612"
"chr3","34090418","34090693","chr16","9119227","9119507","68","24971191"
"chr3","34213958","34214209","chr4","170504643","170504896","30","136290685"
"chr3","34551452","34551744","chr4","170197417","170197709","48","135645965"
"chr3","34599790","34600067","chrX","23951798","23952091","74","10647992"
"chr3","34708633","34708926","chr2B","131262446","131262745","71","96553813"
"chr3","34771235","34771497","chr2A","18685518","18685775","68","16085717"
"chr3","34989057","34989332","chr4","169797434","169797729","60","134808377"
"chr3","35090837","35091101","chr2A","64113168","64113430","61","29022331"
"chr3","35141724","35141862","chr4","169626375","169626527","31","134484651"
"chr3","35161768","35161937","chr14","45424688","45424875","51","10262920"
"chr3","35242310","35242578","chr4","169530522","169530785","35","134288212"
"chr3","35341210","35341527","chr4","169433740","169434048","49","134092530"
"chr3","35349528","35349827","chr4","169426127","169426416","63","134076599"
"chr3","35360059","35360203","chr10","29754500","29754651","38","5605559"
"chr3","35390518","35390795","chr2A","45175182","45175467","68","9784664"
"chr3","35411999","35412116","chr22","14821499","14821616","26","20590500"
"chr3","35416302","35416364","chr4","169358962","169359023","8","133942660"
"chr3","35555746","35556031","chr20","18607514","18607796","72","16948232"
"chr3","35685700","35685825","chr6","18588428","18588554","38","17097272"
"chr3","35732806","35733082","chr4","169077403","169077661","61","133344597"
"chr3","35981226","35981351","chr4","168856019","168856144","15","132874793"
"chr3","36119831","36120119","chr4","168711450","168711728","38","132591619"
"chr3","36206506","36206585","chr5","70986883","70986964","28","34780377"
"chr3","36232410","36232694","chr4","168599146","168599449","52","132366736"
"chr3","36401835","36402143","chr4","168475963","168476271","48","132074128"
"chr3","36589475","36589590","chr4","168304598","168304708","19","131715123"
"chr3","36723795","36724098","chr4","168178029","168178327","34","131454234"
"chr3","36728786","36729040","chr4","168171760","168172029","54","131442974"
"chr3","36745640","36745900","chr4","168151995","168152277","65","131406355"
"chr3","36844192","36844387","chr4","168054242","168054454","53","131210050"
"chr3","36908928","36909064","chr6","63224295","63224425","23","26315367"
"chr3","37016637","37016920","chr4","167940772","167941058","34","130924135"
"chr3","37029533","37029815","chr4","167934179","167934476","55","130904646"
"chr3","37031749","37032026","chr5","56077513","56077785","52","19045764"
"chr3","37039872","37039992","chr10","39624808","39624930","17","2584936"
"chr3","37187581","37187727","chr1","22298981","22299131","27","14888600"
"chr3","37346907","37347182","chr22","2288950","2289233","42","35057957"
"chr3","37407928","37408220","chr4","167576278","167576573","51","130168350"
"chr3","37479130","37479397","chr22","2288950","2289233","55","35190180"
"chr3","37488411","37488684","chr9","108814804","108815078","69","71326393"
"chr3","37494249","37494536","chr12","11401040","11401325","58","26093209"
"chr3","37494817","37495103","chr12","11401619","11401933","66","26093198"
"chr3","37605905","37606178","chr4","167403519","167403771","42","129797614"
"chr3","37701330","37701608","chr4","167312130","167312411","26","129610800"
"chr3","37738034","37738319","chr4","167271087","167271348","63","129533053"
"chr3","37781880","37782195","chr4","167234671","167234965","51","129452791"
"chr3","37784426","37784568","chr1","21447351","21447502","34","16337075"
"chr3","37824304","37824408","chr22","11451503","11451609","22","26372801"
"chr3","37826246","37826555","chr11","77921399","77921718","66","40095153"
"chr3","37873297","37873600","chr4","15446892","15447188","59","22426405"
"chr3","37881020","37881175","chr1","52325310","52325464","40","14444290"
"chr3","37907848","37907963","chr4","167095103","167095219","15","129187255"
"chr3","37940906","37941210","chr5","9692972","9693274","63","28247934"
"chr3","37952555","37952850","chr11","58771612","58771896","67","20819057"
"chr3","37971331","37971636","chr4","167001322","167001625","63","129029991"
"chr3","37991284","37991564","chr11","64538382","64538654","71","26547098"
"chr3","38004595","38004718","chrX","118297985","118298107","24","80293390"
"chr3","38042128","38042392","chr7","27109219","27109487","86","10932909"
"chr3","38060365","38060656","chr5","98713924","98714222","57","60653559"
"chr3","38066782","38067072","chr4","166923024","166923331","46","128856242"
"chr3","38163625","38163793","chr6","137736682","137736850","37","99573057"
"chr3","38164661","38164909","chr2B","101016968","101017219","63","62852307"
"chr3","38655179","38655404","chr4","166317397","166317621","21","127662218"
"chr3","38774091","38774215","chr8","45313442","45313566","20","6539351"
"chr3","38817802","38817894","chr4","166113444","166113536","7","127295642"
"chr3","38822327","38822396","chr1","179535363","179535435","19","140713036"
"chr3","38823124","38823334","chr18","42945821","42946028","45","4122697"
"chr3","38844338","38844636","chr4","166092415","166092714","45","127248077"
"chr3","38942140","38942422","chr15","38060224","38060516","47","881916"
"chr3","38949807","38949916","chr19","15219953","15220058","38","23729854"
"chr3","38991681","38991971","chr10","13294329","13294605","61","25697352"
"chr3","38997769","38998069","chr1","160332533","160332842","64","121334764"
"chr3","38998079","38998378","chr10","40867615","40867906","62","1869536"
"chr3","39003593","39003895","chr1","23622718","23623020","67","15380875"
"chr3","39003898","39004195","chr12","116633770","116634069","62","77629872"
"chr3","39015253","39015537","chr4","165949526","165949831","66","126934273"
"chr3","39033574","39033894","chr18","34048248","34048557","62","4985326"
"chr3","39049295","39049451","chr11","72697839","72697980","40","33648544"
"chr3","39053487","39053779","chr4","165914040","165914352","58","126860553"
"chr3","39065833","39066094","chr4","105190280","105190543","72","66124447"
"chr3","39070796","39071049","chr11","65897088","65897326","65","26826292"
"chr3","39107729","39107994","chr4","165869845","165870126","57","126762116"
"chr3","39110495","39110811","chr4","165867379","165867683","43","126756884"
"chr3","39111022","39111304","chr4","165866871","165867179","58","126755849"
"chr3","39218447","39218638","chr1","47843988","47844174","56","8625541"
"chr3","39253890","39254202","chr10","117717196","117717505","68","78463306"
"chr3","39267833","39268122","chr4","165702401","165702699","51","126434568"
"chr3","39278979","39279262","chr4","165689630","165689923","36","126410651"
"chr3","39284330","39284493","chr4","40325999","40326159","39","1041669"
"chr3","39287209","39287483","chr4","165681868","165682142","25","126394659"
"chr3","39300412","39300692","chr4","165671661","165671944","35","126371249"
"chr3","39351933","39352101","chr4","165627449","165627600","34","126275516"
"chr3","39352435","39352728","chr4","165626465","165626758","44","126274030"
"chr3","39367304","39367398","chr10","60207101","60207197","18","20839797"
"chr3","39367476","39367734","chr4","165612252","165612546","58","126244776"
"chr3","39368027","39368293","chr4","165611697","165611973","38","126243670"
"chr3","39368893","39369163","chr13","28463419","28463690","59","10905474"
"chr3","39377223","39377501","chr4","165601023","165601310","46","126223800"
"chr3","39385187","39385475","chr15","63461342","63461627","64","24076155"
"chr3","39406993","39407124","chr1","114541144","114541275","38","75134151"
"chr3","39407220","39407495","chr4","165562253","165562540","40","126155033"
"chr3","39442471","39442553","chr13","93008461","93008546","13","53565990"
"chr3","39443089","39443303","chr3","120860154","120860365","49","81417065"
"chr3","39459541","39459739","chr4","165513247","165513443","18","126053706"
"chr3","39490849","39490974","chr4","165483513","165483636","17","125992664"
"chr3","39509799","39510085","chr4","165465522","165465833","61","125955723"
"chr3","39515407","39515710","chr4","165408562","165408851","39","125893155"
"chr3","39551409","39551663","chr4","165376314","165376583","44","125824905"
"chr3","39555631","39555905","chr4","165372049","165372328","27","125816418"
"chr3","39563631","39563741","chr4","165364803","165364913","13","125801172"
"chr3","39574492","39574796","chr4","165354309","165354621","48","125779817"
"chr3","39761712","39761972","chr4","165170804","165171056","42","125409092"
"chr3","39781661","39781926","chr4","165144922","165145214","55","125363261"
"chr3","39792772","39793067","chr1","63018151","63018449","53","23225379"
"chr3","39794504","39794777","chr4","165131340","165131612","30","125336836"
"chr3","39893053","39893178","chr6","18588428","18588554","38","21304625"
"chr3","39893261","39893446","chrX","10512272","10512441","53","29380989"
"chr3","39896464","39896762","chr4","165038815","165039113","32","125142351"
"chr3","39967124","39967437","chr4","164969094","164969404","57","125001970"
"chr3","39988496","39988663","chr8","49491094","49491265","38","9502598"
"chr3","40013066","40013353","chr4","164927356","164927640","39","124914290"
"chr3","40036078","40036351","chr7","44334451","44334729","56","4298373"
"chr3","40067283","40067547","chr4","164882999","164883270","50","124815716"
"chr3","40085399","40085688","chr4","164864012","164864303","43","124778613"
"chr3","40123773","40123889","chr2B","63312351","63312469","19","23188578"
"chr3","40269750","40270042","chr4","164688310","164688609","37","124418560"
"chr3","40281719","40282005","chr4","164676910","164677191","46","124395191"
"chr3","40303821","40303964","chr4","164655123","164655255","29","124351302"
"chr3","40367299","40367544","chr1","31488966","31489220","61","8878333"
"chr3","40449385","40449673","chr4","164497811","164498100","49","124048426"
"chr3","40458274","40458577","chr12","6332659","6332960","69","34125615"
"chr3","40666550","40666837","chr4","164292600","164292882","36","123626050"
"chr3","40710548","40710827","chr4","164249545","164249828","30","123538997"
"chr3","40775767","40776054","chr4","164182946","164183231","34","123407179"
"chr3","40800710","40800985","chr6","25113270","25113543","66","15687440"
"chr3","40865130","40865406","chr4","164101743","164102013","72","123236613"
"chr3","40884695","40885009","chr4","164081175","164081494","43","123196480"
"chr3","40941025","40941331","chr4","164029768","164030073","36","123088743"
"chr3","41068222","41068508","chr4","163916508","163916806","63","122848286"
"chr3","41069752","41069979","chr4","163914768","163914986","44","122845016"
"chr3","41091509","41091800","chrX","119401800","119402094","55","78310291"
"chr3","41092724","41093013","chr4","163889301","163889577","42","122796577"
"chr3","41127688","41128015","chr20","31950072","31950384","66","9177616"
"chr3","41138898","41139190","chr4","163840816","163841108","35","122701918"
"chr3","41142239","41142531","chr4","163837771","163838070","40","122695532"
"chr3","41164482","41164792","chr4","163826334","163826648","37","122661852"
"chr3","41171913","41172151","chr4","163813229","163813464","33","122641316"
"chr3","41194213","41194378","chr3","49411661","49411824","36","8217448"
"chr3","41220497","41220782","chr4","163769088","163769386","70","122548591"
"chr3","41239142","41239424","chr8","10961164","10961451","51","30277978"
"chr3","41258441","41258691","chr4","163727211","163727477","50","122468770"
"chr3","41259305","41259612","chr4","163725982","163726288","43","122466677"
"chr3","41259684","41259781","chr2B","16451102","16451202","20","24808582"
"chr3","41266597","41266738","chr1","31279143","31279286","36","9987454"
"chr3","41272260","41272435","chr20","13871202","13871372","41","27401058"
"chr3","41273055","41273224","chr1","7841983","7842144","47","33431072"
"chr3","41284121","41284419","chr2A","38255626","38255922","64","3028495"
"chr3","41309760","41310069","chr4","163688186","163688481","44","122378426"
"chr3","41311156","41311447","chr4","163686488","163686784","50","122375332"
"chr3","41329391","41329688","chr4","163668483","163668781","65","122339092"
"chr3","41331392","41331660","chr4","163666423","163666699","35","122335031"
"chr3","41338418","41338689","chr4","163659884","163660149","33","122321466"
"chr3","41341323","41341496","chr7","1810491","1810660","30","39530832"
"chr3","41342768","41342896","chr14","10279108","10279238","19","31063660"
"chr3","41343719","41343875","chr22","20635435","20635596","29","20708284"
"chr3","41352983","41353266","chr5","23931488","23931783","63","17421495"
"chr3","41379366","41379490","chr4","163613606","163613730","15","122234240"
"chr3","41399801","41399969","chr3","10866047","10866211","37","30533754"
"chr3","41437378","41437670","chr2A","98094679","98094957","66","56657301"
"chr3","41441096","41441356","chr4","163551818","163552072","43","122110722"
"chr3","41479036","41479320","chr4","163516895","163517194","47","122037859"
"chr3","41480601","41480812","chr4","163515377","163515586","50","122034776"
"chr3","41488059","41488169","chr4","163508827","163508943","17","122020768"
"chr3","41494932","41495234","chr4","163502581","163502887","40","122007649"
"chr3","41512905","41513184","chr10","35801343","35801624","51","5711562"
"chr3","41514203","41514365","chr10","121446686","121446848","40","79932483"
"chr3","41516792","41517057","chr7","44576271","44576545","65","3059479"
"chr3","41527769","41527873","chr1","39325820","39325928","21","2201949"
"chr3","41527901","41528090","chr4","1869667","1869859","42","39658234"
"chr3","41532437","41532565","chr12","29897183","29897312","24","11635254"
"chr3","41583228","41583346","chr7","107591138","107591254","21","66007910"
"chr3","41598548","41598709","chr21","34565547","34565708","35","7033001"
"chr3","41612587","41612687","chrX","20209988","20210094","22","21402599"
"chr3","41619358","41619626","chr4","163386875","163387148","55","121767517"
"chr3","41626827","41626991","chr3","131117277","131117446","47","89490450"
"chr3","41637589","41637871","chr4","163365851","163366132","67","121728262"
"chr3","41645789","41646065","chr4","163357894","163358175","38","121712105"
"chr3","41646577","41646696","chr3","59535512","59535636","21","17888935"
"chr3","41669170","41669286","chr4","163340426","163340543","11","121671256"
"chr3","41673961","41674231","chr5","13122526","13122799","59","28551435"
"chr3","41712714","41713026","chr4","163306376","163306673","43","121593662"
"chr3","41777794","41778018","chr5","35605178","35605402","61","6172616"
"chr3","41833542","41833834","chr4","163197022","163197308","34","121363480"
"chr3","41845986","41846265","chr4","163186042","163186345","55","121340056"
"chr3","41863087","41863208","chr11","131745024","131745138","39","89881937"
"chr3","41864857","41864944","chr19","1037543","1037635","24","40827314"
"chr3","41928692","41928973","chr3","74966229","74966505","59","33037537"
"chr3","41944023","41944298","chr12","58134686","58134970","72","16190663"
"chr3","41974602","41974832","chr3","136033443","136033686","61","94058841"
"chr3","41980284","41980578","chr4","163067709","163068006","39","121087425"
"chr3","42021764","42021888","chr4","163028449","163028575","16","121006685"
"chr3","42068354","42068662","chr13","14994534","14994828","75","27073820"
"chr3","42133577","42133878","chr4","162911701","162911993","50","120778124"
"chr3","42166368","42166621","chr4","162875237","162875504","36","120708869"
"chr3","42228963","42229253","chr14","75080552","75080837","68","32851589"
"chr3","42242265","42242534","chr4","162796441","162796729","47","120554176"
"chr3","42263229","42263442","chr19","18271347","18271565","58","23991882"
"chr3","42275611","42275899","chr4","162769907","162770196","45","120494296"
"chr3","42327239","42327514","chr4","162729830","162730106","20","120402591"
"chr3","42352315","42352615","chr4","162705808","162706103","73","120353493"
"chr3","42386759","42387034","chr4","162670841","162671119","28","120284082"
"chr3","42416699","42416988","chr8","144786356","144786646","51","102369657"
"chr3","42426385","42426697","chr4","162631124","162631432","37","120204739"
"chr3","42431044","42431305","chr12","23452142","23452409","62","18978902"
"chr3","42447879","42448145","chr4","162609844","162610083","65","120161965"
"chr3","42476759","42477049","chr12","111233152","111233437","56","68756393"
"chr3","42479888","42480017","chr15","52764054","52764186","29","10284166"
"chr3","42480925","42481010","chr4","162578637","162578721","17","120097712"
"chr3","42488081","42488369","chr15","44322063","44322351","60","1833982"
"chr3","42509975","42510258","chr5","4577321","4577606","55","37932654"
"chr3","42515775","42516057","chr2A","45097646","45097933","63","2581871"
"chr3","42516136","42516412","chr4","162544091","162544367","37","120027955"
"chr3","42525907","42526230","chr6","143392360","143392685","66","100866453"
"chr3","42528342","42528628","chr4","162532329","162532617","42","120003987"
"chr3","42583001","42583287","chr4","133833387","133833671","66","91250386"
"chr3","42699981","42700278","chr4","162375560","162375859","35","119675579"
"chr3","42721002","42721320","chrX","70068494","70068793","75","27347492"
"chr3","42752941","42753242","chr1","91059171","91059456","70","48306230"
"chr3","42917298","42917361","chr21","36798710","36798760","14","6118588"
"chr3","42939504","42939609","chr5","14822723","14822826","26","28116781"
"chr3","43085322","43085602","chr19","29654539","29654825","58","13430783"
"chr3","43378776","43379056","chr4","161737365","161737645","38","118358589"
"chr3","43487189","43487355","chr8","17729083","17729255","49","25758106"
"chr3","43570763","43571057","chrX","40887647","40887932","79","2683116"
"chr3","43581851","43582064","chr19","18237823","18238040","44","25344028"
"chr3","43883758","43884083","chr4","161210119","161210423","65","117326361"
"chr3","43902376","43902620","chr19","37049465","37049693","68","6852911"
"chr3","43955306","43955522","chr7","67519721","67519924","51","23564415"
"chr3","44003306","44003581","chr11","14504274","14504554","60","29499032"
"chr3","44015970","44016252","chr1","40657052","40657349","58","3358918"
"chr3","44032690","44032998","chr1","96308137","96308446","76","52275447"
"chr3","44098561","44098891","chr4","103428114","103428444","85","59329553"
"chr3","44191635","44191921","chr4","198957250","198957557","62","154765615"
"chr3","44196634","44196886","chr5","26236271","26236532","74","17960363"
"chr3","44252728","44253013","chr4","160848818","160849103","30","116596090"
"chr3","44278738","44279024","chr4","160821791","160822084","37","116543053"
"chr3","44338635","44338915","chr7","132085631","132085914","72","87746996"
"chr3","44465988","44466288","chr4","160645814","160646106","34","116179826"
"chr3","44528706","44528978","chr4","160586150","160586448","56","116057444"
"chr3","44542629","44542902","chr4","160573024","160573310","57","116030395"
"chr3","44784281","44784398","chr4","160305948","160306065","14","115521667"
"chr3","44801412","44801696","chr4","160289207","160289499","48","115487795"
"chr3","44823199","44823425","chr7","32821026","32821256","53","12002173"
"chr3","44842417","44842531","chr6","154239364","154239482","32","109396947"
"chr3","44944519","44944791","chr4","160170297","160170578","36","115225778"
"chr3","44993255","44993554","chr4","160107251","160107545","45","115113996"
"chr3","44997606","44997884","chr4","160102702","160103003","63","115105096"
"chr3","45015919","45016205","chr4","160090280","160090554","42","115074361"
"chr3","45068109","45068326","chr1","53733488","53733703","47","8665379"
"chr3","45074970","45075244","chr16","40088504","40088786","63","4986466"
"chr3","45091428","45091732","chr4","160041514","160041819","43","114950086"
"chr3","45096613","45096912","chr4","160031504","160031821","53","114934891"
"chr3","45098227","45098523","chr4","160029616","160029894","58","114931389"
"chr3","45115946","45116222","chr4","160010417","160010698","37","114894471"
"chr3","45127364","45127651","chr4","195244103","195244392","68","150116739"
"chr3","45136235","45136485","chr3","171026331","171026572","66","125890096"
"chr3","45154119","45154355","chr4","159984152","159984393","27","114830033"
"chr3","45188209","45188315","chr2A","44501449","44501563","19","686760"
"chr3","45227062","45227373","chr4","159916281","159916592","43","114689219"
"chr3","45273111","45273392","chr1","12051012","12051291","60","33222099"
"chr3","45274657","45274938","chr6","151737674","151737940","76","106463017"
"chr3","45301585","45301715","chr7","78772323","78772456","29","33470738"
"chr3","45364105","45364250","chr4","118287115","118287260","35","72923010"
"chr3","45398610","45398900","chr3","131369946","131370239","49","85971336"
"chr3","45410109","45410428","chr4","159742699","159743021","57","114332590"
"chr3","45450186","45450474","chr4","159704251","159704547","30","114254065"
"chr3","45523942","45524100","chr5","2409784","2409944","28","43114158"
"chr3","45750858","45750989","chr14","76132211","76132343","19","30381353"
"chr3","45768958","45769119","chr12","35974023","35974184","42","9794935"
"chr3","45861266","45861413","chrX","71151088","71151230","34","25289822"
"chr3","46005104","46005232","chr5","133578375","133578499","32","87573271"
"chr3","46160932","46161224","chr2B","125542999","125543288","66","79382067"
"chr3","46187841","46188110","chr4","159035437","159035736","58","112847596"
"chr3","46296107","46296304","chr3","127712167","127712361","50","81416060"
"chr3","46306779","46307065","chr5","102241438","102241724","54","55934659"
"chr3","46373096","46373311","chr16","43700342","43700557","53","2672754"
"chr3","46415945","46416200","chr10","116949348","116949602","56","70533403"
"chr3","46438229","46438487","chr4","158807270","158807555","47","112369041"
"chr3","46478159","46478444","chr4","158764491","158764786","43","112286332"
"chr3","46499522","46499653","chr4","158747353","158747478","14","112247831"
"chr3","46620306","46620605","chr4","158640815","158641086","49","112020509"
"chr3","46643922","46644210","chr4","158626903","158627199","37","111982981"
"chr3","46721165","46721307","chr7","67511405","67511552","32","20790240"
"chr3","46771999","46772109","chr4","158506925","158507045","21","111734926"
"chr3","46849491","46849795","chr4","158429288","158429573","52","111579797"
"chr3","46867376","46867538","chr19","7784006","7784166","34","39083370"
"chr3","46909733","46909826","chr1","225199355","225199447","19","178289622"
"chr3","46928237","46928529","chr4","158343913","158344213","45","111415676"
"chr3","46941254","46941524","chr4","158338391","158338683","71","111397137"
"chr3","46967601","46967887","chr4","158326348","158326653","58","111358747"
"chr3","47085404","47085707","chr4","158210773","158211087","49","111125369"
"chr3","47089975","47090137","chr11","71879210","71879377","40","24789235"
"chr3","47131031","47131342","chr4","158162836","158163143","54","111031805"
"chr3","47244539","47244761","chrX","120473041","120473260","40","73228502"
"chr3","47267381","47267672","chr4","158009512","158009806","36","110742131"
"chr3","47283243","47283454","chr8","100864437","100864645","52","53581194"
"chr3","47411654","47411951","chr4","157839234","157839537","46","110427580"
"chr3","47420646","47420813","chr12","116125223","116125388","33","68704577"
"chr3","47476343","47476622","chr7","1708256","1708538","65","45768087"
"chr3","47520253","47520519","chr4","157722966","157723233","43","110202713"
"chr3","47872937","47873105","chr2A","78661834","78661994","55","30788897"
"chr3","47874042","47874196","chr14","10155920","10156077","36","37718122"
"chr3","47892006","47892122","chr7","72131524","72131640","15","24239518"
"chr3","47892916","47893032","chr4","157344060","157344175","16","109451144"
"chr3","47899971","47900244","chr4","157335964","157336259","61","109435993"
"chr3","47935068","47935192","chr4","157301288","157301417","19","109366220"
"chr3","47952900","47953153","chr4","157286175","157286422","61","109333275"
"chr3","48320500","48320792","chr4","156890188","156890486","37","108569688"
"chr3","48758174","48758457","chr4","156412784","156413058","56","107654610"
"chr3","48814909","48815202","chr4","156210277","156210567","28","107395368"
"chr3","48984191","48984500","chr4","155920877","155921178","39","106936686"
"chr3","49006484","49006790","chr4","155905648","155905947","42","106899164"
"chr3","49017420","49017717","chr3","126518855","126519148","57","77501435"
"chr3","49048519","49048813","chr4","155848908","155849173","55","106800389"
"chr3","49060962","49061243","chr4","155829988","155830256","41","106769026"
"chr3","49062695","49062812","chr6","10586432","10586548","26","38476263"
"chr3","49062833","49062968","chr12","108006205","108006353","34","58943372"
"chr3","49096174","49096464","chr4","155798200","155798482","44","106702026"
"chr3","49119484","49119781","chr4","155776204","155776490","51","106656720"
"chr3","49147611","49147900","chr9","30109991","30110292","64","19037620"
"chr3","49294820","49295034","chr4","155583519","155583720","31","106288699"
"chr3","49314909","49315170","chr16","31649333","31649595","53","17665576"
"chr3","49327682","49327785","chr11","67337030","67337134","21","18009348"
"chr3","49354293","49354363","chr4","155524692","155524758","10","106170399"
"chr3","49378224","49378493","chr4","155504177","155504459","41","106125953"
"chr3","49395653","49395953","chr7","76041457","76041753","55","26645804"
"chr3","49439916","49440039","chrX","70594684","70594808","20","21154768"
"chr3","49441578","49441835","chr1","78966022","78966292","60","29524444"
"chr3","49892761","49893061","chr4","155050400","155050703","50","105157639"
"chr3","49958963","49959194","chr17","21575490","21575709","55","28383473"
"chr3","50314927","50315080","chr7","96055065","96055220","38","45740138"
"chr3","50645636","50645915","chr4","154323344","154323629","48","103677708"
"chr3","50655719","50655843","chr4","40155438","40155567","28","10500281"
"chr3","50688180","50688304","chr4","154288520","154288647","22","103600340"
"chr3","51027897","51028009","chr4","153962935","153963048","13","102935038"
"chr3","51177041","51177317","chr15","28698469","28698760","68","22478572"
"chr3","51300661","51300794","chrX","154858889","154859018","18","103558228"
"chr3","51301403","51301547","chr10","49585047","49585201","33","1716356"
"chr3","51350130","51350447","chr4","153679938","153680228","62","102329808"
"chr3","51443432","51443549","chr4","153590945","153591062","18","102147513"
"chr3","51530952","51531226","chr10","8078554","8078826","74","43452398"
"chr3","51744124","51744167","chr3","169444492","169444534","11","117700368"
"chr3","51786992","51787286","chr4","153264649","153264938","45","101477657"
"chr3","51829089","51829235","chr20","47776340","47776493","37","4052749"
"chr3","51845768","51846049","chr3","102703814","102704087","61","50858046"
"chr3","51849404","51849707","chr4","153205653","153205956","34","101356249"
"chr3","52041695","52041998","chr4","153034048","153034359","50","100992353"
"chr3","52064513","52064824","chr4","153014742","153015047","35","100950229"
"chr3","52073489","52073783","chr4","153012343","153012646","62","100938854"
"chr3","52082922","52083053","chr7","11248117","11248241","22","40834805"
"chr3","52083473","52083598","chr1","205765363","205765491","22","153681890"
"chr3","52083932","52084021","chr2A","7219562","7219651","17","44864370"
"chr3","52145578","52145884","chr4","152928291","152928604","45","100782713"
"chr3","52146107","52146315","chr4","152927849","152928056","25","100781742"
"chr3","52148963","52149139","chr4","152925457","152925631","18","100776494"
"chr3","52150537","52150830","chr4","152924077","152924386","43","100773540"
"chr3","52168839","52168953","chr4","152909433","152909548","10","100740594"
"chr3","52185618","52185895","chr3","38442872","38443175","66","13742746"
"chr3","52189079","52189201","chr4","152891205","152891329","25","100702126"
"chr3","52204524","52204822","chr4","152876063","152876367","58","100671539"
"chr3","52205868","52206165","chr4","152874718","152875010","37","100668850"
"chr3","52238690","52238968","chr4","152848521","152848801","39","100609831"
"chr3","52424016","52424158","chrX","2794957","2795096","36","49629059"
"chr3","52449404","52449562","chr5","51144248","51144411","36","1305156"
"chr3","52453135","52453410","chr4","152623716","152623981","43","100170581"
"chr3","52654851","52655104","chr22","7240538","7240774","63","45414313"
"chr3","52685813","52686096","chr4","152446136","152446429","38","99760323"
"chr3","52687592","52687641","chr12","34059510","34059561","14","18628082"
"chr3","52687657","52687811","chr10","98601650","98601805","30","45913993"
"chr3","52694408","52694693","chr4","152438070","152438365","51","99743662"
"chr3","52698982","52699263","chr4","152433553","152433791","67","99734571"
"chr3","52702620","52702749","chrX","70984964","70985090","27","18282344"
"chr3","52722063","52722256","chr4","152410235","152410445","38","99688172"
"chr3","52735492","52735745","chr3","143011557","143011810","63","90276065"
"chr3","52763040","52763302","chr2B","126361584","126361859","67","73598544"
"chr3","52778127","52778251","chr5","68460490","68460616","29","15682363"
"chr3","52778598","52778814","chr4","152343248","152343464","30","99564650"
"chr3","52788208","52788345","chr4","181487521","181487654","34","128699313"
"chr3","52790112","52790265","chr7","70842983","70843136","33","18052871"
"chr3","52813575","52813698","chr4","152323642","152323765","16","99510067"
"chr3","52867720","52867799","chr11","43550790","43550868","11","9316930"
"chr3","52902217","52902426","chr4","152241780","152241970","36","99339563"
"chr3","52938904","52939207","chr4","152208849","152209141","53","99269945"
"chr3","53050620","53050872","chr7","57139485","57139751","48","4088865"
"chr3","53093399","53093719","chr4","152093079","152093391","46","98999680"
"chr3","53176144","53176433","chr4","152013404","152013708","39","98837260"
"chr3","53223875","53224138","chr4","151969074","151969379","64","98745199"
"chr3","53261854","53261967","chr1","46130276","46130392","19","7131578"
"chr3","53291130","53291416","chr4","151899036","151899305","49","98607906"
"chr3","53308109","53308412","chr4","151882231","151882533","54","98574122"
"chr3","53317829","53317950","chr1","203906318","203906440","16","150588489"
"chr3","53344791","53345079","chr4","151850563","151850860","47","98505772"
"chr3","53345754","53346004","chr4","151849589","151849868","55","98503835"
"chr3","53374625","53374923","chr4","151811881","151812186","37","98437256"
"chr3","53409331","53409530","chr4","151779163","151779386","45","98369832"
"chr3","53415651","53415790","chr12","36778250","36778388","33","16637401"
"chr3","53416171","53416273","chr19","33408831","33408938","25","20007340"
"chr3","53444831","53445070","chr12","1167259","1167504","66","52277572"
"chr3","53462765","53463057","chr4","151727085","151727399","62","98264320"
"chr3","53538746","53539059","chr12","112193938","112194249","67","58655192"
"chr3","53548627","53548751","chr15","67201372","67201506","27","13652745"
"chr3","53583207","53583502","chr16","30950078","30950376","61","22633129"
"chr3","53644269","53644567","chr4","151560186","151560496","54","97915917"
"chr3","53646609","53646969","chr20","17538131","17538456","93","36108478"
"chr3","53688329","53688606","chr4","151515489","151515763","60","97827160"
"chr3","53696744","53696867","chr4","151511144","151511267","20","97814400"
"chr3","53697625","53697753","chr15","57026888","57027018","24","3329263"
"chr3","53712302","53712589","chr4","151502335","151502622","38","97790033"
"chr3","53735914","53736125","chr4","151478725","151478936","29","97742811"
"chr3","53737255","53737496","chr4","26702666","26702913","61","27034589"
"chr3","53762960","53763222","chr13","82636350","82636620","61","28873390"
"chr3","53767643","53767929","chr4","151450789","151451075","24","97683146"
"chr3","53771887","53772131","chr4","151446499","151446767","44","97674612"
"chr3","53772815","53773101","chr4","151445327","151445626","53","97672512"
"chr3","53785582","53785807","chr1","43997572","43997802","50","9788010"
"chr3","53853751","53853866","chr1","58749475","58749587","26","4895724"
"chr3","53877748","53878045","chr4","151341825","151342121","22","97464077"
"chr3","53906904","53907161","chr4","151324081","151324341","30","97417177"
"chr3","53912367","53912480","chr4","151318886","151319003","11","97406519"
"chr3","53946547","53946829","chr4","151289479","151289771","36","97342932"
"chr3","53953971","53954131","chr13","5474254","5474413","42","48479717"
"chr3","53960504","53960789","chr12","32032110","32032393","66","21928394"
"chr3","53963888","53964010","chr4","151270988","151271109","18","97307100"
"chr3","53972994","53973297","chr4","151262647","151262934","63","97289653"
"chr3","53988616","53988840","chr4","151250851","151251085","38","97262235"
"chr3","53989075","53989195","chr6","38693252","38693373","19","15295823"
"chr3","54016216","54016368","chr10","49585047","49585201","30","4431169"
"chr3","54018749","54019028","chr4","151218870","151219176","64","97200121"
"chr3","54052180","54052300","chr4","151189182","151189306","21","97137002"
"chr3","54058885","54059194","chr4","151184251","151184565","33","97125366"
"chr3","54071116","54071280","chr1","162716672","162716841","45","108645556"
"chr3","54072213","54072499","chr4","151168784","151169067","35","97096571"
"chr3","54073976","54074195","chr4","151167687","151167902","35","97093711"
"chr3","54093955","54094041","chr3","38428197","38428280","13","15665758"
"chr3","54097592","54097901","chr2B","131262446","131262745","57","77164854"
"chr3","54171935","54172245","chr4","151064992","151065302","48","96893057"
"chr3","54294328","54294623","chr4","150951521","150951821","43","96657193"
"chr3","54749275","54749515","chr4","150495802","150496063","56","95746527"
"chr3","54814126","54814412","chr10","108986202","108986482","64","54172076"
"chr3","55095554","55095706","chr12","118592097","118592252","36","63496543"
"chr3","55499037","55499287","chr2B","17473898","17474146","75","38025139"
"chr3","55578866","55579173","chr4","149761685","149761997","49","94182819"
"chr3","55706336","55706631","chr4","149626380","149626661","38","93920044"
"chr3","55764386","55764506","chr1","47188069","47188189","21","8576317"
"chr3","55826483","55826545","chr1","134523119","134523182","21","78696636"
"chr3","55927059","55927353","chr4","149407997","149408271","63","93480938"
"chr3","55991864","55992175","chr4","149349917","149350231","49","93358053"
"chr3","56000487","56000773","chr4","149341398","149341685","70","93340911"
"chr3","56024313","56024518","chr4","149314232","149314451","36","93289919"
"chr3","56094127","56094369","chr8","45450177","45450413","65","10643950"
"chr3","56287556","56287688","chr9","112549317","112549449","23","56261761"
"chr3","56370749","56370879","chr4","148970687","148970804","22","92599938"
"chr3","56490713","56491023","chr6","113877732","113878039","76","57387019"
"chr3","56621889","56621987","chr1","96121866","96121964","16","39499977"
"chr3","56701244","56701408","chr7","1810491","1810660","40","54890753"
"chr3","56714647","56714782","chr7","149344946","149345080","23","92630299"
"chr3","56764565","56764727","chrX","6176848","6177011","35","50587717"
"chr3","56973781","56973962","chr16","59554717","59554895","34","2580936"
"chr3","56973984","56974272","chr4","148384841","148385126","41","91410857"
"chr3","57109098","57109139","chr16","49547173","49547215","9","7561925"
"chr3","57169744","57170019","chr4","148193487","148193764","56","91023743"
"chr3","57269311","57269573","chr4","148084401","148084674","44","90815090"
"chr3","57653398","57653690","chr1","111668107","111668390","78","54014709"
"chr3","57787573","57787814","chr4","147543413","147543673","62","89755840"
"chr3","57940128","57940397","chr2A","45069842","45070107","73","12870286"
"chr3","58062565","58062736","chr2A","33677905","33678061","43","24384660"
"chr3","58063218","58063349","chr4","147272303","147272424","20","89209085"
"chr3","58085656","58085779","chr4","133893763","133893889","28","75808107"
"chr3","58204590","58204896","chr4","147121002","147121297","61","88916412"
"chr3","58558526","58558690","chr12","116378437","116378611","37","57819911"
"chr3","58594502","58594780","chr20","32843128","32843405","64","25751374"
"chr3","58606201","58606493","chr4","146703449","146703747","33","88097248"
"chr3","58669292","58669507","chr11","7277099","7277287","71","51392193"
"chr3","59030992","59031261","chr4","146296889","146297166","41","87265897"
"chr3","59086426","59086630","chr4","146236879","146237079","32","87150453"
"chr3","59136422","59136498","chr4","146204983","146205070","20","87068561"
"chr3","59262855","59262950","chr2A","46311605","46311701","24","12951250"
"chr3","59313999","59314106","chr1","28475167","28475273","26","30838832"
"chr3","59486687","59486783","chr4","145863650","145863748","16","86376963"
"chr3","59535747","59536019","chr4","145807355","145807629","60","86271608"
"chr3","59579343","59579646","chr4","145756462","145756799","67","86177119"
"chr3","59668542","59668814","chr4","145673763","145674026","43","86005221"
"chr3","59695750","59696032","chr15","52196243","52196533","63","7499507"
"chr3","59792599","59792679","chr4","145503466","145503546","6","85710867"
"chr3","60158125","60158360","chr19","37049465","37049693","52","23108660"
"chr3","60431198","60431468","chr4","144870120","144870404","40","84438922"
"chr3","60692963","60693235","chr4","144634989","144635257","54","83942026"
"chr3","60809333","60809571","chr14","34243378","34243613","69","26565955"
"chr3","60809924","60809989","chr12","117188968","117189030","13","56379044"
"chr3","60810871","60811162","chrX","54081472","54081761","68","6729399"
"chr3","60836623","60836920","chr4","144507176","144507456","56","83670553"
"chr3","61031607","61031891","chr4","144293375","144293675","69","83261768"
"chr3","61279591","61279918","chr4","144104996","144105329","37","82825405"
"chr3","61377975","61378230","chr10","111895683","111895929","71","50517708"
"chr3","61675864","61676168","chr4","143677595","143677879","68","82001731"
"chr3","61829649","61829763","chr1","160028610","160028719","27","98198961"
"chr3","62009664","62009976","chr4","143293958","143294256","58","81284294"
"chr3","62023147","62023317","chr4","143270637","143270815","32","81247490"
"chr3","62040971","62041260","chr11","116859838","116860126","74","54818867"
"chr3","62110358","62110645","chr4","143189027","143189325","63","81078669"
"chr3","62115470","62115747","chr4","143185438","143185716","34","81069968"
"chr3","62124941","62125056","chr1","47275032","47275145","24","14849909"
"chr3","62179577","62179689","chr4","143115964","143116078","22","80936387"
"chr3","62189140","62189401","chr14","12282917","12283185","70","49906223"
"chr3","62275051","62275322","chr4","143043644","143043897","61","80768593"
"chr3","62291013","62291163","chr18","5568484","5568639","41","56722529"
"chr3","62405551","62405812","chr11","49609458","49609734","77","12796093"
"chr3","62446277","62446376","chr4","142879162","142879248","22","80432885"
"chr3","62556215","62556491","chr1","205928774","205929060","87","143372559"
"chr3","62587464","62587575","chr5","14822723","14822826","31","47764741"
"chr3","62589827","62590126","chr4","142726819","142727118","40","80136992"
"chr3","62671253","62671443","chr22","25650191","25650380","51","37021062"
"chr3","62708180","62708467","chr4","142605837","142606110","62","79897657"
"chr3","62907186","62907492","chr4","99195972","99196262","68","36288786"
"chr3","62926992","62927255","chr9","110492719","110492981","73","47565727"
"chr3","62934622","62934775","chr20","37546011","37546154","42","25388611"
"chr3","62956238","62956519","chr10","66477249","66477541","62","3521011"
"chr3","63273003","63273126","chr14","13851777","13851900","19","49421226"
"chr3","63373253","63373495","chr4","141978307","141978553","45","78605054"
"chr3","63427157","63427437","chr4","141910719","141911003","47","78483562"
"chr3","63492207","63492449","chr16","10930020","10930265","54","52562187"
"chr3","63549830","63550124","chr4","141817367","141817652","44","78267537"
"chr3","63612796","63613089","chr4","141748080","141748384","49","78135284"
"chr3","63631577","63631808","chr12","125637221","125637456","63","62005644"
"chr3","63693494","63693796","chr4","141663885","141664200","63","77970391"
"chr3","63830748","63831041","chr12","121101371","121101664","61","57270623"
"chr3","64154160","64154437","chr4","141278640","141278929","50","77124480"
"chr3","64180544","64180867","chr4","141249154","141249432","69","77068610"
"chr3","64248182","64248490","chr1","54502945","54503253","63","9745237"
"chr3","64370429","64370691","chrX","154075409","154075657","67","89704980"
"chr3","64371278","64371536","chr5","138344220","138344480","66","73972942"
"chr3","64372638","64372906","chr16","58515572","58515856","69","5857066"
"chr3","64378770","64378895","chr2A","20545290","20545415","26","43833480"
"chr3","64381965","64382251","chrX","1990500","1990780","55","62391465"
"chr3","64406138","64406305","chr1","29050884","29051047","33","35355254"
"chr3","64407176","64407287","chr5","32701018","32701136","23","31706158"
"chr3","64411324","64411593","chr3","102741099","102741386","72","38329775"
"chr3","64756136","64756392","chr1","32228090","32228342","77","32528046"
"chr3","64764689","64764907","chr4","40234789","40235011","37","24529900"
"chr3","64765767","64766060","chr4","140825876","140826177","33","76060109"
"chr3","64821061","64821233","chr10","15087422","15087589","60","49733639"
"chr3","64870298","64870606","chr4","140734377","140734672","59","75864079"
"chr3","64883991","64884101","chr7","6379157","6379273","30","58504834"
"chr3","64997025","64997256","chr20","49661226","49661456","56","15335799"
"chr3","65015488","65015793","chr4","140593385","140593668","59","75577897"
"chr3","65044508","65044796","chr5","1834999","1835301","63","63209509"
"chr3","65197837","65198150","chr4","140416477","140416768","58","75218640"
"chr3","65245968","65246217","chr3","102881381","102881627","64","37635413"
"chr3","65327475","65327759","chr4","140298979","140299278","63","74971504"
"chr3","65385657","65385775","chr4","140247771","140247889","9","74862114"
"chr3","65438577","65438876","chr16","10963785","10964082","55","54474792"
"chr3","65448997","65449114","chr4","140198632","140198749","8","74749635"
"chr3","65460365","65460645","chr4","140189603","140189883","33","74729238"
"chr3","65474774","65475048","chr4","140177369","140177676","80","74702595"
"chr3","65484805","65485098","chr4","140170087","140170391","44","74685282"
"chr3","65508105","65508372","chr4","140153896","140154195","54","74645791"
"chr3","65510649","65510862","chr4","140151411","140151632","31","74640762"
"chr3","65512504","65512626","chr4","140149981","140150107","11","74637477"
"chr3","65531931","65532217","chr4","140131250","140131501","57","74599319"
"chr3","65579975","65580093","chr5","62181964","62182088","25","3398011"
"chr3","65644252","65644465","chr4","140030537","140030758","36","74386285"
"chr3","65654111","65654390","chr7","33270606","33270890","52","32383505"
"chr3","65655849","65656123","chr4","140017535","140017826","47","74361686"
"chr3","65733473","65733769","chr4","139944236","139944533","40","74210763"
"chr3","65739456","65739582","chr8","6344091","6344218","17","59395365"
"chr3","65745047","65745328","chr7","1708256","1708538","67","64036791"
"chr3","65763160","65763443","chr4","139909278","139909565","50","74146118"
"chr3","65867180","65867469","chr4","139859662","139859947","31","73992482"
"chr3","65892250","65892535","chr4","139833788","139834093","49","73941538"
"chr3","65914259","65914538","chr4","139820103","139820394","41","73905844"
"chr3","65921923","65922158","chr4","139809764","139810020","50","73887841"
"chr3","65972482","65972782","chr4","139773406","139773709","33","73800924"
"chr3","65983016","65983295","chr4","139763409","139763699","48","73780393"
"chr3","66025810","66026130","chr4","139725609","139725931","28","73699799"
"chr3","66072834","66073117","chr4","139676197","139676488","63","73603363"
"chr3","66114916","66115191","chr4","139641645","139641906","48","73526729"
"chr3","66127376","66127611","chr19","39503298","39503534","68","26624078"
"chr3","66404877","66405087","chr4","139388738","139388956","34","72983861"
"chr3","66406406","66406517","chr4","139387628","139387737","15","72981222"
"chr3","66632355","66632513","chr6","15264957","15265121","34","51367398"
"chr3","66655727","66656026","chr4","139165208","139165495","46","72509481"
"chr3","66751098","66751397","chr4","139061177","139061461","58","72310079"
"chr3","66770091","66770384","chr4","139043544","139043832","35","72273453"
"chr3","66946046","66946161","chr4","138886459","138886578","22","71940413"
"chr3","67021241","67021533","chr4","138821413","138821713","49","71800172"
"chr3","67067397","67067575","chr1","216419895","216420062","44","149352498"
"chr3","67212738","67213037","chr4","138626086","138626377","46","71413348"
"chr3","67318444","67318754","chr4","138504892","138505189","56","71186448"
"chr3","67326673","67326939","chr5","22706770","22707062","58","44619903"
"chr3","67494038","67494216","chr16","11732349","11732525","47","55761689"
"chr3","67825390","67825687","chr4","138010225","138010536","51","70184835"
"chr3","68010530","68010662","chr7","105919947","105920079","36","37909417"
"chr3","68592738","68592855","chr4","137273070","137273191","15","68680332"
"chr3","68649520","68649799","chr4","137209952","137210242","47","68560432"
"chr3","68684144","68684464","chr4","137166591","137166904","48","68482447"
"chr3","68807469","68807781","chr4","137062039","137062342","47","68254570"
"chr3","69262274","69262564","chr4","133833387","133833671","67","64571113"
"chr3","69603262","69603603","chr4","136351306","136351607","74","66748044"
"chr3","69891933","69892065","chr7","69965789","69965928","32","73856"
"chr3","69922389","69922659","chr4","136064780","136065070","63","66142391"
"chr3","69971158","69971371","chr4","136021850","136022074","37","66050692"
"chr3","70090809","70091088","chr12","62282656","62282936","63","7808153"
"chr3","70128947","70129147","chr4","135877890","135878103","29","65748943"
"chr3","70169892","70170141","chr4","135834114","135834399","60","65664222"
"chr3","70260046","70260332","chr4","135747667","135747984","58","65487621"
"chr3","70306700","70306810","chr18","22807872","22807981","14","47498828"
"chr3","70414766","70415064","chr5","96942875","96943163","54","26528109"
"chr3","70427438","70427719","chr4","135560343","135560632","39","65132905"
"chr3","70443559","70443846","chr4","135545114","135545422","47","65101555"
"chr3","70471782","70472017","chr4","135526780","135527032","48","65054998"
"chr3","70503658","70503888","chr4","135491487","135491720","17","64987829"
"chr3","70523656","70523969","chrX","13343874","13344175","68","57179782"
"chr3","70563435","70563716","chr4","135434291","135434558","37","64870856"
"chr3","70564655","70564989","chr4","135433043","135433343","53","64868388"
"chr3","70599364","70599671","chr4","135388417","135388716","79","64789053"
"chr3","70652940","70653218","chr7","128027283","128027543","73","57374343"
"chr3","70662420","70662726","chr4","135325152","135325453","52","64662732"
"chr3","70779435","70779734","chr4","135197615","135197929","45","64418180"
"chr3","70864319","70864612","chr4","135107036","135107344","48","64242717"
"chr3","70951981","70952295","chr4","134958154","134958454","62","64006173"
"chr3","70971961","70972227","chr10","144929935","144930215","75","73957974"
"chr3","70978540","70978826","chr4","134934670","134934954","33","63956130"
"chr3","71087968","71088247","chr3","9780596","9780870","68","61307372"
"chr3","71218935","71219238","chr4","134685710","134686012","43","63466775"
"chr3","71380417","71380726","chr4","134495438","134495715","48","63115021"
"chr3","71417300","71417408","chr19","8138520","8138637","26","63278780"
"chr3","71503756","71503922","chr10","49585047","49585201","32","21918709"
"chr3","71509971","71510130","chr10","108461325","108461484","36","36951354"
"chr3","71614666","71614966","chr4","134219244","134219541","30","62604578"
"chr3","71645228","71645528","chr4","134190331","134190611","45","62545103"
"chr3","71651797","71652046","chr4","134183889","134184138","35","62532092"
"chr3","71729226","71729449","chr4","134114563","134114744","78","62385337"
"chr3","71976067","71976193","chr1","17368221","17368352","32","54607846"
"chr3","71976412","71976525","chr3","123061433","123061549","15","51085021"
"chr3","72043476","72043758","chr1","135651531","135651807","57","63608055"
"chr3","72094823","72094954","chr4","40155438","40155567","23","31939385"
"chr3","72095364","72095518","chr9","42544571","42544737","43","29550793"
"chr3","72107442","72107529","chr4","133784712","133784797","13","61677270"
"chr3","72127360","72127669","chr4","133759359","133759657","53","61631999"
"chr3","72143430","72143735","chr4","133726072","133726379","40","61582642"
"chr3","72390414","72390542","chr4","133498922","133499041","20","61108508"
"chr3","72662809","72663127","chr9","95923564","95923862","81","23260755"
"chr3","72671325","72671610","chr4","133214965","133215263","49","60543640"
"chr3","72716811","72716883","chr2A","78517875","78517944","14","5801064"
"chr3","72858552","72858872","chr4","133018223","133018547","61","60159671"
"chr3","72957573","72957884","chr5","120619493","120619807","58","47661920"
"chr3","72977832","72978117","chr4","132921833","132922131","47","59944001"
"chr3","72981771","72982077","chr4","132919368","132919642","61","59937597"
"chr3","73015463","73015725","chr4","132893553","132893839","44","59878090"
"chr3","73025579","73025865","chr1","154743896","154744180","60","81718317"
"chr3","73031889","73032182","chr4","132884281","132884566","46","59852392"
"chr3","73097650","73097949","chr4","132805404","132805705","38","59707754"
"chr3","73105423","73105734","chr14","36624079","36624371","76","36481344"
"chr3","73172718","73172966","chr4","132748045","132748299","33","59575327"
"chr3","73296820","73297128","chr19","32772206","32772514","82","40524614"
"chr3","73476288","73476596","chr4","132424161","132424465","47","58947873"
"chr3","73610784","73611066","chr2A","15104772","15105050","73","58506012"
"chr3","73985986","73986115","chr10","99892477","99892606","26","25906491"
"chr3","74031265","74031459","chr4","131802389","131802573","36","57771124"
"chr3","74058700","74058825","chr6","106910886","106911009","20","32852186"
"chr3","74219723","74220036","chr4","131572951","131573251","54","57353228"
"chr3","74241559","74241743","chr13","8736030","8736202","47","65505529"
"chr3","74268931","74269214","chr4","131522154","131522414","62","57253223"
"chr3","74285410","74285727","chr9","91725273","91725585","70","17439863"
"chr3","74327256","74327474","chr5","33118787","33119001","45","41208469"
"chr3","74371424","74371716","chr4","131422655","131422957","80","57051231"
"chr3","74443542","74443814","chr4","131350779","131351060","33","56907237"
"chr3","74544009","74544311","chr4","131140960","131141267","39","56596951"
"chr3","74561128","74561243","chr4","131127606","131127719","15","56566478"
"chr3","74566935","74567231","chr4","131122118","131122407","43","56555183"
"chr3","74612641","74612899","chr4","131088677","131088926","50","56476036"
"chr3","74641870","74642158","chr7","89988219","89988498","64","15346349"
"chr3","74701781","74702090","chr8","85537141","85537442","64","10835360"
"chr3","74825928","74826043","chr4","130849738","130849853","13","56023810"
"chr3","74936408","74936718","chr4","130738181","130738501","37","55801773"
"chr3","74940217","74940492","chr4","130733625","130733922","49","55793408"
"chr3","74953560","74953817","chr4","130723835","130724095","25","55770275"
"chr3","75026831","75027125","chr7","75624900","75625191","66","598069"
"chr3","75031669","75031941","chr4","130626720","130627020","57","55595051"
"chr3","75062625","75062914","chr4","130589103","130589382","39","55526478"
"chr3","75103172","75103306","chr4","130544883","130545007","26","55441711"
"chr3","75205286","75205557","chr16","11154412","11154689","65","64050874"
"chr3","75216392","75216532","chr4","130109401","130109534","20","54893009"
"chr3","75216771","75217087","chr4","130108833","130109152","36","54892062"
"chr3","75246120","75246435","chr4","130084872","130085190","36","54838752"
"chr3","75270313","75270616","chr4","130061440","130061723","50","54791127"
"chr3","75270928","75271242","chr4","130060791","130061105","33","54789863"
"chr3","75313865","75314182","chr3","50836842","50837153","59","24477023"
"chr3","75380362","75380671","chr4","129973913","129974216","34","54593551"
"chr3","75468919","75469066","chr1","16851947","16852100","39","58616972"
"chr3","75495651","75495810","chr15","21950673","21950831","32","53544978"
"chr3","75715874","75715983","chr12","46140363","46140469","30","29575511"
"chr3","76339992","76340300","chr9","48691842","48692156","72","27648150"
"chr3","76359584","76359739","chr12","122117318","122117466","38","45757734"
"chr3","76511604","76511760","chr5","161141472","161141625","36","84629868"
"chr3","76520119","76520245","chr4","128732975","128733101","16","52212856"
"chr3","76728429","76728695","chr4","128539168","128539481","75","51810739"
"chr3","77116580","77116721","chr22","4901161","4901308","46","72215419"
"chr3","77140032","77140330","chr21","22245354","22245649","76","54894678"
"chr3","77455302","77455378","chr19","52729308","52729383","18","24725994"
"chr3","77542323","77542621","chr6","156805667","156805951","74","79263344"
"chr3","77668244","77668531","chr4","127547618","127547905","43","49879374"
"chr3","77900355","77900479","chr9","114196210","114196334","19","36295855"
"chr3","78344127","78344426","chr1","42985512","42985800","69","35358615"
"chr3","78369209","78369438","chr12","7128362","7128610","72","71240847"
"chr3","78478010","78478307","chr4","126681793","126682084","52","48203783"
"chr3","78487199","78487505","chr4","126673592","126673907","52","48186393"
"chr3","78817689","78818001","chr4","126372231","126372535","51","47554542"
"chr3","78825276","78825403","chr22","20608659","20608785","23","58216617"
"chr3","78850013","78850121","chr7","76940267","76940373","31","1909746"
"chr3","78876561","78876837","chrX","135073291","135073556","74","56196730"
"chr3","78947321","78947594","chr4","126259597","126259869","70","47312276"
"chr3","79112069","79112178","chr4","41705996","41706106","24","37406073"
"chr3","79231403","79231709","chr4","125960812","125961111","48","46729409"
"chr3","79309211","79309328","chr4","125881088","125881210","19","46571877"
"chr3","79359288","79359571","chr5","117762477","117762761","68","38403189"
"chr3","79546217","79546436","chr4","125590571","125590776","38","46044354"
"chr3","79579179","79579337","chr19","51781571","51781725","39","27797608"
"chr3","79601437","79601653","chr4","125527325","125527528","30","45925888"
"chr3","79645924","79646224","chr5","48822089","48822382","75","30823835"
"chr3","79664148","79664296","chr1","205548459","205548612","31","125884311"
"chr3","79767140","79767377","chr8","86080660","86080885","51","6313520"
"chr3","79837577","79837887","chr12","110695737","110696041","73","30858160"
"chr3","79856697","79857002","chr4","125282095","125282395","48","45425398"
"chr3","79946298","79946610","chr4","125165089","125165415","49","45218791"
"chr3","80016943","80017091","chr5","4272991","4273140","31","75743952"
"chr3","80053460","80053585","chr17","7830688","7830812","17","72222772"
"chr3","80135290","80135580","chr4","124983725","124984037","62","44848435"
"chr3","80235271","80235353","chr6","5911953","5912036","22","74323318"
"chr3","80274748","80275031","chr4","124824999","124825280","42","44550251"
"chr3","80324606","80324903","chr4","124777949","124778247","39","44453343"
"chr3","80376449","80376733","chr4","124721923","124722224","49","44345474"
"chr3","80624687","80624971","chr4","124504513","124504794","45","43879826"
"chr3","80745933","80746239","chr4","120387251","120387553","65","39641318"
"chr3","80809720","80809935","chr2B","123245609","123245813","71","42435889"
"chr3","80858205","80858493","chr19","38511083","38511371","63","42347122"
"chr3","80891679","80891971","chr12","1651377","1651661","64","79240302"
"chr3","80892793","80892875","chr10","96261490","96261572","16","15368697"
"chr3","80966517","80966616","chr4","124173781","124173881","15","43207264"
"chr3","80966627","80966837","chr7","16589445","16589655","45","64377182"
"chr3","81007931","81008229","chr4","124118895","124119202","41","43110964"
"chr3","81028749","81029051","chr3","111241099","111241414","66","30212350"
"chr3","81040814","81040935","chr3","54036399","54036522","21","27004415"
"chr3","81067978","81068260","chr7","5830379","5830666","66","75237599"
"chr3","81092342","81092466","chr6","74653208","74653329","23","6439134"
"chr3","81093374","81093462","chr2A","46311605","46311701","31","34781769"
"chr3","81106947","81107018","chr6","108167255","108167324","27","27060308"
"chr3","81107019","81107142","chr4","124034380","124034503","11","42927361"
"chr3","81230160","81230416","chr1","221474426","221474683","58","140244266"
"chr3","81281138","81281339","chr4","123878969","123879184","42","42597831"
"chr3","81338170","81338481","chr2A","32798527","32798827","69","48539643"
"chr3","81350538","81350832","chr2A","78488386","78488675","65","2862152"
"chr3","81411421","81411710","chr4","123757439","123757714","43","42346018"
"chr3","81495597","81495709","chr2A","5592839","5592953","17","75902758"
"chr3","81519495","81519618","chr4","123645023","123645147","20","42125528"
"chr3","81644793","81645089","chr4","123552387","123552680","34","41907594"
"chr3","81709231","81709390","chr18","5568484","5568639","33","76140747"
"chr3","81796099","81796203","chr4","1726627","1726733","19","80069472"
"chr3","81815991","81816061","chr8","59313025","59313096","20","22502966"
"chr3","81816380","81816584","chr7","33343402","33343596","52","48472978"
"chr3","81985216","81985502","chr7","77301357","77301628","85","4683859"
"chr3","81990310","81990445","chr8","103799790","103799921","43","21809480"
"chr3","82511582","82511893","chr16","48548762","48549073","68","33962820"
"chr3","82628784","82629079","chr20","18881434","18881726","71","63747350"
"chr3","82798875","82799153","chr15","27134497","27134773","78","55664378"
"chr3","83102840","83103099","chr4","122110075","122110342","42","39007235"
"chr3","83121389","83121684","chr4","122092788","122093082","47","38971399"
"chr3","83154104","83154216","chr4","122055618","122055731","14","38901514"
"chr3","83169413","83169702","chr3","131369946","131370239","65","48200533"
"chr3","83269462","83269551","chr7","62563087","62563176","15","20706375"
"chr3","83269698","83269827","chr16","8990415","8990539","37","74279283"
"chr3","83300612","83300865","chr4","121912213","121912483","43","38611601"
"chr3","83330915","83331132","chr4","121808559","121808776","25","38477644"
"chr3","83370233","83370377","chr13","1433575","1433714","33","81936658"
"chr3","83373028","83373254","chr4","121765067","121765297","28","38392039"
"chr3","83387658","83387942","chr4","121749410","121749696","44","38361752"
"chr3","83390508","83390762","chr4","121747212","121747464","44","38356704"
"chr3","83394336","83394602","chr4","121743266","121743528","56","38348930"
"chr3","83403912","83404211","chr10","35883775","35884063","81","47520137"
"chr3","83411270","83411401","chr4","121717703","121717835","17","38306433"
"chr3","83411726","83411874","chr1","205548459","205548612","33","122136733"
"chr3","83412309","83412405","chr4","121716802","121716889","13","38304493"
"chr3","83473614","83473903","chr4","121666609","121666895","33","38192995"
"chr3","83495230","83495533","chr4","121645886","121646180","52","38150656"
"chr3","83533131","83533415","chr4","121624136","121624421","28","38091005"
"chr3","83549517","83549633","chr4","121600894","121601018","22","38051377"
"chr3","83628533","83628823","chrX","122829588","122829875","58","39201055"
"chr3","83645174","83645441","chr4","162741400","162741665","62","79096226"
"chr3","83648502","83648836","chr8","16716241","16716540","92","66932261"
"chr3","83654817","83655086","chr4","121490475","121490764","50","37835658"
"chr3","83691489","83691774","chr14","59109356","59109639","59","24582133"
"chr3","83732692","83732824","chr1","27808249","27808381","18","55924443"
"chr3","83770323","83770612","chr4","121388143","121388425","36","37617820"
"chr3","83771732","83772033","chr20","31950072","31950384","62","51821660"
"chr3","83776881","83777149","chr7","138128976","138129243","75","54352095"
"chr3","83878876","83879165","chr4","121276870","121277158","38","37397994"
"chr3","83976530","83976806","chr4","121183955","121184210","53","37207425"
"chr3","83990478","83990768","chr4","121175518","121175811","46","37185040"
"chr3","83995423","83995713","chr11","12728691","12728990","59","71266732"
"chr3","84037334","84037450","chr6","87517319","87517435","19","3479985"
"chr3","84037843","84038006","chr3","134506775","134506940","31","50468932"
"chr3","84074752","84075044","chr4","121109402","121109688","45","37034650"
"chr3","84133152","84133441","chr5","88632023","88632310","61","4498871"
"chr3","84160655","84160928","chr4","121010078","121010375","47","36849423"
"chr3","84169646","84169957","chr22","4220075","4220384","60","79949571"
"chr3","84209555","84209862","chr6","31725434","31725739","67","52484121"
"chr3","84223746","84223871","chr4","61265266","61265389","20","22958480"
"chr3","84241476","84241692","chr12","115283385","115283591","47","31041909"
"chr3","84252294","84252510","chr4","120918532","120918755","35","36666238"
"chr3","84253185","84253459","chr4","120917240","120917525","47","36664055"
"chr3","84265674","84265944","chr4","120905602","120905892","39","36639928"
"chr3","84266608","84266936","chrX","103981721","103982018","76","19715113"
"chr3","84281972","84282136","chr5","151470871","151471036","40","67188899"
"chr3","84282185","84282346","chr2B","71913627","71913796","57","12368558"
"chr3","84309210","84309477","chr4","120871098","120871362","31","36561888"
"chr3","84325073","84325188","chr2A","63435618","63435731","12","20889455"
"chr3","84382310","84382439","chr8","103317535","103317663","27","18935225"
"chr3","84399389","84399676","chr4","120803593","120803892","56","36404204"
"chr3","84549269","84549495","chr3","129101728","129101964","59","44552459"
"chr3","84551784","84552106","chr1","17494226","17494540","74","67057558"
"chr3","84598323","84598588","chr4","120493097","120493363","26","35894774"
"chr3","84695708","84696003","chr4","120387251","120387553","51","35691543"
"chr3","84749390","84749695","chr4","120336534","120336832","45","35587144"
"chr3","84788867","84789110","chr4","120298859","120299103","36","35509992"
"chr3","84797554","84797857","chr4","120289967","120290260","46","35492413"
"chr3","84810970","84811261","chr4","120284862","120285159","37","35473892"
"chr3","84846375","84846658","chr5","133131289","133131554","64","48284914"
"chr3","84858400","84858695","chr4","120248543","120248841","46","35390143"
"chr3","84864846","84865142","chr4","120243844","120244136","29","35378998"
"chr3","84887708","84887846","chr4","120223106","120223238","18","35335398"
"chr3","84966334","84966428","chr16","4656999","4657091","21","80309335"
"chr3","85002793","85003113","chr4","120097790","120098104","62","35094997"
"chr3","85079020","85079315","chr4","120032257","120032551","35","34953237"
"chr3","85094129","85094402","chr4","25783837","25784109","63","59310292"
"chr3","85114090","85114395","chr19","13082818","13083131","68","72031272"
"chr3","85115666","85115967","chr4","120005534","120005833","53","34889868"
"chr3","85195670","85195992","chr7","104942328","104942627","65","19746658"
"chr3","85219189","85219492","chr4","119893408","119893717","46","34674219"
"chr3","85222267","85222539","chr12","35482809","35483087","59","49739458"
"chr3","85335876","85336117","chr3","134709848","134710073","72","49373972"
"chr3","85369219","85369381","chr2A","97441991","97442142","40","12072772"
"chr3","85419856","85420157","chr4","119665402","119665705","36","34245546"
"chr3","85439999","85440165","chr16","27925975","27926135","38","57514024"
"chr3","85489179","85489281","chr3","124652697","124652800","30","39163518"
"chr3","85489294","85489434","chr15","33725141","33725274","34","51764153"
"chr3","85496086","85496378","chr4","119586550","119586850","28","34090464"
"chr3","85740425","85740711","chr4","119297627","119297906","44","33557202"
"chr3","85769860","85770135","chr1","227415933","227416230","62","141646073"
"chr3","85848007","85848280","chr4","119199820","119200081","46","33351813"
"chr3","85902834","85903047","chr4","119141527","119141754","44","33238693"
"chr3","86414936","86415189","chr4","118695116","118695394","44","32280180"
"chr3","86540348","86540483","chr4","118576624","118576756","19","32036276"
"chr3","87175331","87175621","chrX","39133182","39133470","58","48042149"
"chr3","87207503","87207758","chr4","117865611","117865861","32","30658108"
"chr3","87271491","87271606","chr18","57245881","57245993","34","30025610"
"chr3","87374369","87374490","chr16","40500610","40500729","31","46873759"
"chr3","87388516","87388644","chr4","117684721","117684845","11","30296205"
"chr3","87420980","87421082","chr4","117654563","117654667","17","30233583"
"chr3","87429782","87430072","chr4","117644182","117644473","35","30214400"
"chr3","87717775","87718082","chr4","117414902","117415223","60","29697127"
"chr3","87748204","87748512","chr4","117383989","117384294","39","29635785"
"chr3","87820777","87821053","chr7","44334451","44334729","52","43486326"
"chr3","87889903","87890030","chr1","160113916","160114047","24","72224013"
"chr3","87910906","87911187","chr4","117232402","117232682","27","29321496"
"chr3","87929041","87929323","chr4","117223240","117223558","72","29294199"
"chr3","88023385","88023682","chr1","189896243","189896544","50","101872858"
"chr3","88054406","88054644","chr4","117097562","117097796","28","29043156"
"chr3","88171805","88171924","chr1","162057776","162057891","21","73885971"
"chr3","88172227","88172412","chr4","116955521","116955704","19","28783294"
"chr3","88222850","88223132","chr4","116894853","116895138","31","28672003"
"chr3","88285010","88285302","chr4","116829357","116829632","48","28544347"
"chr3","88295197","88295490","chr4","116818860","116819152","37","28523663"
"chr3","88401370","88401679","chr4","116685711","116685997","58","28284341"
"chr3","88881254","88881478","chr16","43063316","43063533","49","45817938"
"chr3","89089521","89089808","chr4","116019595","116019910","64","26930074"
"chr3","89159899","89160211","chr4","115943554","115943881","58","26783655"
"chr3","89266766","89267102","chr4","115842202","115842502","78","26575436"
"chr3","89758521","89758817","chr4","115414997","115415298","44","25656476"
"chr3","89833634","89833929","chr4","115316540","115316837","42","25482906"
"chr3","89851052","89851331","chr4","115292905","115293197","49","25441853"
"chr3","90036007","90036332","chr4","115114583","115114919","56","25078576"
"chr3","90160109","90160401","chr4","114977094","114977380","45","24816985"
"chr3","90219020","90219152","chr4","114869510","114869641","11","24650490"
"chr3","90232837","90233091","chr2A","7180960","7181208","64","83051877"
"chr3","90329481","90329758","chr15","72759722","72760012","77","17569759"
"chr3","90525574","90525699","chr3","39132279","39132405","24","51393295"
"chr3","90580821","90580916","chr1","132938881","132938975","20","42358060"
"chr3","90589235","90589450","chr9","108754435","108754665","43","18165200"
"chr3","90643865","90643987","chr8","45313442","45313566","21","45330423"
"chr3","90729767","90730024","chr16","32367047","32367299","69","58362720"
"chr3","90763487","90763773","chr4","114262504","114262788","43","23499017"
"chr3","90800030","90800288","chr4","114225415","114225690","43","23425385"
"chr3","90806999","90807245","chr1","62952641","62952900","59","27854358"
"chr3","90807997","90808288","chr15","37312788","37313079","68","53495209"
"chr3","90935610","90935899","chr4","114062517","114062822","48","23126907"
"chr3","90945365","90945675","chr4","114052074","114052395","39","23106709"
"chr3","91059786","91060109","chr4","113956027","113956369","74","22896241"
"chr3","91063149","91063303","chr12","6713811","6713970","25","84349338"
"chr3","91095576","91095846","chr6","99295390","99295672","75","8199814"
"chr3","91174871","91175168","chr4","113847073","113847362","39","22672202"
"chr3","91235904","91236227","chr4","113791586","113791907","47","22555682"
"chr3","91255486","91255690","chr4","113769922","113770135","32","22514436"
"chr3","91349901","91350215","chr4","113670382","113670685","48","22320481"
"chr3","91397322","91397443","chr3","125378751","125378875","19","33981429"
"chr3","91397550","91397705","chr20","44858230","44858390","38","46539320"
"chr3","91533002","91533303","chr3","131369946","131370239","71","39836944"
"chr3","91557781","91558071","chr4","113455048","113455343","33","21897267"
"chr3","91617064","91617342","chr4","113400259","113400524","74","21783195"
"chr3","91821158","91821267","chrX","136750413","136750529","20","44929255"
"chr3","92022324","92022605","chr4","41250322","41250604","60","50772002"
"chr3","92335161","92335477","chr4","112718815","112719132","48","20383654"
"chr3","92369249","92369551","chr7","74771689","74771991","67","17597560"
"chr3","92392342","92392576","chr4","112660810","112661070","59","20268468"
"chr3","92394611","92394783","chr5","125000001","125000173","41","32605390"
"chr3","92462483","92462745","chr4","112593544","112593812","41","20131061"
"chr3","92464175","92464450","chr4","112591783","112592061","55","20127608"
"chr3","92499722","92499938","chr16","41676490","41676700","46","50823232"
"chr3","92523536","92523868","chr4","112531682","112532004","53","20008146"
"chr3","92530705","92530995","chr4","112524716","112525018","63","19994011"
"chr3","92541836","92542122","chr4","112514362","112514666","51","19972526"
"chr3","92694405","92694691","chr4","112352259","112352540","45","19657854"
"chr3","92767589","92767880","chr1","203793902","203794196","72","111026313"
"chr3","92950561","92950859","chr1","207607505","207607814","61","114656944"
"chr3","92954373","92954476","chr4","112062133","112062253","28","19107760"
"chr3","92968828","92968936","chrX","123500866","123500984","32","30532038"
"chr3","93102859","93103150","chr4","111923321","111923582","64","18820462"
"chr3","93110261","93110424","chr5","51144248","51144411","35","41966013"
"chr3","93113059","93113204","chr2A","33465835","33465981","34","59647224"
"chr3","93142747","93143075","chr6","113703828","113704124","83","20561081"
"chr3","93271831","93272147","chr4","111760755","111761062","69","18488924"
"chr3","93388369","93388666","chr4","111623414","111623726","56","18235045"
"chr3","93521503","93521739","chr4","111502732","111502978","34","17981229"
"chr3","93523969","93524263","chr4","111500294","111500588","30","17976325"
"chr3","93611783","93612065","chr4","111387981","111388267","43","17776198"
"chr3","93672509","93672807","chr4","111343717","111344016","45","17671208"
"chr3","93701280","93701592","chr4","111303739","111304047","38","17602459"
"chr3","93720909","93721190","chr11","36052938","36053229","61","57667971"
"chr3","93722286","93722395","chr4","111291290","111291395","18","17569004"
"chr3","93766019","93766293","chr4","111244061","111244336","25","17478042"
"chr3","93799046","93799166","chr4","111211759","111211888","21","17412713"
"chr3","93814085","93814393","chr4","111195392","111195699","30","17381307"
"chr3","93828380","93828606","chr4","111181057","111181276","29","17352677"
"chr3","93864876","93865176","chr7","104942328","104942627","61","11077452"
"chr3","93916042","93916321","chr4","111085698","111086010","60","17169656"
"chr3","93933479","93933804","chr1","150808926","150809223","73","56875447"
"chr3","94064373","94064669","chr4","110905905","110906209","48","16841532"
"chr3","94173872","94174099","chr4","110795697","110795930","38","16621825"
"chr3","94186313","94186426","chr4","110785057","110785181","19","16598744"
"chr3","94277235","94277462","chr4","110679114","110679341","14","16401879"
"chr3","94507403","94507507","chr1","45273792","45273898","28","49233611"
"chr3","94557182","94557493","chr4","110443449","110443730","59","15886267"
"chr3","94599689","94599972","chr4","110418993","110419280","35","15819304"
"chr3","94669170","94669432","chr4","110351076","110351331","37","15681906"
"chr3","94694820","94694995","chr1","23183624","23183790","48","71511196"
"chr3","94725421","94725728","chr4","110279425","110279748","53","15554004"
"chr3","94762101","94762399","chr4","110234395","110234702","53","15472294"
"chr3","94826700","94826985","chr4","110168433","110168723","42","15341733"
"chr3","94870219","94870338","chr4","110133393","110133510","18","15263174"
"chr3","94893042","94893336","chr4","110112464","110112757","26","15219422"
"chr3","94918775","94918887","chr6","7020185","7020299","27","87898590"
"chr3","94946524","94946640","chr4","110067076","110067191","13","15120552"
"chr3","94950120","94950388","chr4","110065544","110065826","36","15115424"
"chr3","94962715","94963015","chr4","110051254","110051557","24","15088539"
"chr3","95039827","95040116","chr4","110000507","110000814","51","14960680"
"chr3","95090376","95090663","chr4","109961732","109962031","36","14871356"
"chr3","95093067","95093377","chr4","109959057","109959371","35","14865990"
"chr3","95142170","95142432","chr4","109919285","109919568","47","14777115"
"chr3","95301740","95301868","chr4","109768935","109769058","14","14467195"
"chr3","95310810","95311105","chr12","110756931","110757228","55","15446121"
"chr3","95320800","95321081","chr4","109748563","109748845","48","14427763"
"chr3","95374209","95374508","chr4","109694485","109694780","37","14320276"
"chr3","95376607","95376735","chr4","109692248","109692374","11","14315641"
"chr3","95441517","95441796","chr4","109646943","109647235","54","14205426"
"chr3","95443041","95443321","chr4","109645412","109645702","52","14202371"
"chr3","95467550","95467846","chr12","121101371","121101664","53","25633821"
"chr3","95512858","95513141","chr4","109594264","109594543","40","14081406"
"chr3","95538090","95538391","chr4","109574603","109574917","54","14036513"
"chr3","95543242","95543547","chr4","109568478","109568779","46","14025236"
"chr3","95617926","95618210","chr4","109486461","109486756","54","13868535"
"chr3","95630682","95630975","chr4","109474065","109474355","39","13843383"
"chr3","95644268","95644390","chr4","109458965","109459088","16","13814697"
"chr3","95644653","95644816","chr4","109458542","109458705","19","13813889"
"chr3","95665398","95665635","chr10","11972781","11973018","53","83692617"
"chr3","96061464","96061735","chr9","65960638","65960935","81","30100826"
"chr3","97135030","97135111","chr4","107973325","107973400","11","10838295"
"chr3","97317055","97317352","chr4","107793146","107793453","46","10476091"
"chr3","97661971","97662271","chr4","107458843","107459139","42","9796872"
"chr3","97684115","97684404","chr10","37433502","37433797","65","60250613"
"chr3","97705485","97705780","chr4","107418402","107418691","46","9712917"
"chr3","97736375","97736540","chr4","130132827","130132999","38","32396452"
"chr3","97814199","97814508","chr4","107298354","107298650","54","9484155"
"chr3","97845814","97846114","chr5","23931488","23931783","62","73914326"
"chr3","98162324","98162576","chr4","106944926","106945168","44","8782602"
"chr3","98168613","98168892","chr4","106938874","106939153","34","8770261"
"chr3","98253852","98254002","chr16","66636103","66636254","44","31617749"
"chr3","98396777","98397036","chr4","106695353","106695608","29","8298576"
"chr3","98401894","98402194","chr4","106690199","106690473","67","8288305"
"chr3","98409827","98410121","chr1","180457953","180458240","65","82048126"
"chr3","98460783","98461093","chr4","106628523","106628806","56","8167740"
"chr3","98461462","98461724","chr4","106627869","106628135","52","8166407"
"chr3","98490204","98490430","chr6","22061432","22061659","59","76428772"
"chr3","98501889","98502206","chr4","106583656","106583971","29","8081767"
"chr3","98503085","98503375","chr4","106582477","106582765","50","8079392"
"chr3","98504448","98504742","chr4","106581043","106581339","40","8076595"
"chr3","98530163","98530373","chr9","113308983","113309195","51","14778820"
"chr3","98568990","98569288","chr4","106515311","106515620","50","7946321"
"chr3","98580633","98580958","chr4","106503742","106504056","77","7923109"
"chr3","98624745","98625029","chrX","39133182","39133470","59","59491563"
"chr3","98642581","98642873","chr7","76523012","76523308","57","22119569"
"chr3","98717677","98717778","chr12","33025892","33025996","26","65691785"
"chr3","98748872","98749034","chr1","205548459","205548612","31","106799587"
"chr3","98823187","98823469","chr4","106267998","106268286","40","7444811"
"chr3","98840848","98841012","chrX","53987861","53988030","39","44852987"
"chr3","98849845","98850179","chr4","106239865","106240191","52","7390020"
"chr3","98855605","98855865","chr4","106234584","106234849","34","7378979"
"chr3","98876903","98877225","chr4","106212062","106212354","61","7335159"
"chr3","98977039","98977321","chr7","74230981","74231255","67","24746058"
"chr3","99048362","99048635","chr4","106050227","106050507","37","7001865"
"chr3","99056860","99057161","chr4","106042481","106042792","50","6985621"
"chr3","99062917","99063206","chr4","106036120","106036420","46","6973203"
"chr3","99096872","99097148","chr15","53039375","53039657","64","46057497"
"chr3","99192692","99192995","chr4","105929277","105929591","68","6736585"
"chr3","99194597","99194894","chr4","105927012","105927320","52","6732415"
"chr3","99243733","99244046","chr4","105878118","105878428","57","6634385"
"chr3","99283372","99283669","chr4","105840886","105841180","29","6557514"
"chr3","99412310","99412612","chr4","105710489","105710793","36","6298179"
"chr3","99420428","99420730","chr4","105703278","105703561","44","6282850"
"chr3","99456711","99456995","chr4","105666264","105666553","52","6209553"
"chr3","99465172","99465417","chr4","105658340","105658584","23","6193168"
"chr3","99478397","99478679","chr4","105643298","105643568","49","6164901"
"chr3","99480963","99481267","chr4","105640836","105641122","46","6159873"
"chr3","99508956","99509242","chr4","105621721","105622015","42","6112765"
"chr3","99710867","99710986","chr1","224675871","224675985","19","124965004"
"chr3","99716320","99716617","chr4","105420062","105420363","47","5703742"
"chr3","99728254","99728471","chr6","91869790","91870005","47","7858464"
"chr3","99777975","99778235","chr2A","81492519","81492778","63","18285456"
"chr3","99865005","99865175","chr22","4243708","4243880","35","95621297"
"chr3","99867900","99868205","chr4","105240777","105241066","48","5372877"
"chr3","99926846","99927144","chr4","105184469","105184762","41","5257623"
"chr3","100010921","100011105","chr11","58619029","58619230","49","41391892"
"chr3","100466689","100466982","chr4","104670557","104670845","51","4203868"
"chr3","100500711","100500981","chr4","104639850","104640133","52","4139139"
"chr3","100542764","100543022","chr4","104603570","104603863","58","4060806"
"chr3","100927247","100927546","chr4","104201574","104201874","40","3274327"
"chr3","101111136","101111443","chr7","72248885","72249183","76","28862251"
"chr3","101190363","101190677","chr4","103954929","103955244","47","2764566"
"chr3","101206637","101206927","chr4","103939177","103939462","55","2732540"
"chr3","101291137","101291255","chr3","45215966","45216083","17","56075171"
"chr3","101844493","101844782","chr4","103332568","103332857","50","1488075"
"chr3","102146732","102147021","chr11","120498831","120499121","62","18352099"
"chr3","102229241","102229387","chr10","29754500","29754651","48","72474741"
"chr3","102274033","102274361","chr4","102931361","102931685","45","657328"
"chr3","102789098","102789384","chr4","102286457","102286750","48","502641"
"chr3","102954297","102954574","chr4","102125809","102126113","60","828488"
"chr3","102967951","102968221","chr4","102112549","102112829","49","855402"
"chr3","103136940","103137228","chr5","24602386","24602684","66","78534554"
"chr3","103219993","103220145","chr3","9832740","9832889","32","93387253"
"chr3","103221177","103221444","chr4","105643298","105643568","62","2422121"
"chr3","103369298","103369420","chr3","198553531","198553653","23","95184233"
"chr3","103369424","103369480","chr7","23547259","23547322","17","79822165"
"chr3","103529347","103529639","chr4","101567891","101568190","46","1961456"
"chr3","103533109","103533173","chr4","101563918","101563982","7","1969191"
"chr3","103556601","103556890","chr4","101542379","101542665","46","2014222"
"chr3","103615132","103615360","chr4","101489276","101489480","46","2125856"
"chr3","103672227","103672514","chr18","1313785","1314066","69","102358442"
"chr3","103679383","103679677","chr2B","71035214","71035513","64","32644169"
"chr3","103692657","103692771","chr14","74632755","74632871","24","29059902"
"chr3","103693390","103693703","chr4","101392423","101392734","35","2300967"
"chr3","103750070","103750368","chr4","101333324","101333613","49","2416746"
"chr3","103765234","103765382","chr4","184296640","184296791","45","80531406"
"chr3","103767228","103767391","chr3","49411661","49411824","29","54355567"
"chr3","104213316","104213630","chr9","33163563","33163849","78","71049753"
"chr3","104257098","104257356","chr4","100865058","100865324","44","3392040"
"chr3","104391723","104391992","chr4","100731860","100732129","43","3659863"
"chr3","104547661","104547940","chr19","35491223","35491503","58","69056438"
"chr3","104569814","104570082","chr4","100593132","100593403","39","3976682"
"chr3","104658433","104658714","chr4","100537947","100538240","48","4120486"
"chr3","104839526","104839840","chr4","100369119","100369414","51","4470407"
"chr3","104844643","104844934","chr4","100364406","100364688","43","4480237"
"chr3","104920896","104921085","chr4","100288876","100289065","14","4632020"
"chr3","104988928","104989283","chr4","100220183","100220543","45","4768745"
"chr3","105003014","105003288","chr4","100201244","100201543","60","4801770"
"chr3","105032035","105032125","chr7","62563087","62563176","21","42468948"
"chr3","105064126","105064422","chr4","100145682","100145970","38","4918444"
"chr3","105111962","105112239","chr4","100118190","100118476","64","4993772"
"chr3","105200424","105200748","chr11","72251845","72252150","75","32948579"
"chr3","105230391","105230577","chr4","100002108","100002292","18","5228283"
"chr3","105240881","105241153","chr4","99987461","99987737","28","5253420"
"chr3","105416867","105417173","chr2B","66923633","66923944","66","38493234"
"chr3","105475247","105475505","chr4","99744190","99744450","30","5731057"
"chr3","105520042","105520322","chr9","92741261","92741542","59","12778781"
"chr3","105542183","105542293","chr8","45313442","45313566","30","60228741"
"chr3","105545621","105545907","chr4","93823664","93823946","62","11721957"
"chr3","105601510","105601807","chr4","99622594","99622892","41","5978916"
"chr3","105612303","105612613","chr4","99610538","99610836","58","6001765"
"chr3","105623566","105623872","chr4","99599591","99599886","38","6023975"
"chr3","105693052","105693358","chr4","99545137","99545463","52","6147915"
"chr3","105705008","105705125","chr20","5077172","5077289","17","100627836"
"chr3","105732453","105732752","chr4","99506851","99507156","47","6225602"
"chr3","105770906","105771178","chr4","99452683","99452950","40","6318223"
"chr3","105777320","105777487","chrX","77447510","77447676","39","28329810"
"chr3","105778731","105779000","chr2A","52952739","52953012","69","52825992"
"chr3","105789510","105789755","chr3","140823475","140823736","68","35033965"
"chr3","105794861","105795145","chr4","99438106","99438400","33","6356755"
"chr3","105800797","105801106","chr4","99431787","99432086","65","6369010"
"chr3","105809613","105809830","chr4","99423510","99423730","38","6386103"
"chr3","105810064","105810192","chr4","99423137","99423267","14","6386927"
"chr3","105837979","105838095","chr20","18397026","18397142","14","87440953"
"chr3","105850024","105850300","chr4","99361426","99361717","57","6488598"
"chr3","105854855","105855004","chr10","132069915","132070070","36","26215060"
"chr3","105858286","105858563","chr4","99356606","99356895","38","6501680"
"chr3","105869576","105869690","chr10","88748074","88748188","20","17121502"
"chr3","105875486","105875649","chr6","137736682","137736850","29","31861196"
"chr3","105893487","105893786","chr8","16716241","16716540","74","89177246"
"chr3","105952904","105953026","chr4","99257715","99257838","12","6695189"
"chr3","105954628","105954927","chr4","99255504","99255796","44","6699124"
"chr3","105956034","105956198","chr1","23183624","23183790","32","82772410"
"chr3","105959523","105959639","chr4","99254244","99254353","14","6705279"
"chr3","105981344","105981626","chr14","40084286","40084566","73","65897058"
"chr3","105987537","105987641","chr7","77602371","77602485","19","28385166"
"chr3","105992886","105993126","chr4","99211014","99211260","37","6781872"
"chr3","106008303","106008595","chr12","21390242","21390534","53","84618061"
"chr3","106039833","106040123","chr4","99168864","99169152","47","6870969"
"chr3","106044212","106044494","chr4","99164390","99164695","60","6879822"
"chr3","106047879","106048123","chr4","99160740","99160982","38","6887139"
"chr3","106137132","106137390","chr4","99053889","99054160","41","7083243"
"chr3","106146671","106146754","chr19","50873526","50873609","14","55273145"
"chr3","106162249","106162378","chr4","99016771","99016893","12","7145478"
"chr3","106343067","106343350","chr4","98866744","98867034","35","7476323"
"chr3","106434721","106434826","chr6","13090658","13090763","23","93344063"
"chr3","106507953","106508083","chr4","98692607","98692739","14","7815346"
"chr3","106637405","106637713","chr18","34048248","34048557","55","72589157"
"chr3","106644205","106644494","chr4","98548198","98548492","43","8096007"
"chr3","106709657","106709967","chr4","98490342","98490651","33","8219315"
"chr3","106717559","106717809","chr4","76833639","76833893","58","29883920"
"chr3","106722129","106722250","chr9","93158531","93158645","31","13563598"
"chr3","106722388","106722705","chr4","98475068","98475404","68","8247320"
"chr3","106740901","106741198","chr4","98465335","98465641","46","8275566"
"chr3","106783697","106783830","chr4","98422633","98422766","5","8361064"
"chr3","106806600","106806895","chr20","34695668","34695959","73","72110932"
"chr3","106810016","106810146","chr3","11802689","11802818","22","95007327"
"chr3","106818164","106818448","chr4","98375984","98376299","56","8442180"
"chr3","106860566","106860689","chr7","130385023","130385131","37","23524457"
"chr3","106880027","106880310","chr4","98312388","98312676","49","8567639"
"chr3","106907780","106908074","chr4","98286747","98287053","39","8621033"
"chr3","106922459","106922765","chr4","98276826","98277134","45","8645633"
"chr3","106927600","106927913","chr4","98272789","98273103","50","8654811"
"chr3","106937708","106938008","chr4","98263286","98263608","52","8674422"
"chr3","106941237","106941499","chr4","98259721","98259991","40","8681516"
"chr3","107040749","107040963","chr4","98162384","98162575","46","8878365"
"chr3","107062836","107063126","chr4","98140180","98140476","30","8922656"
"chr3","107106842","107107074","chr4","98095839","98096061","33","9011003"
"chr3","107126747","107127025","chr6","13658495","13658767","71","93468252"
"chr3","107145673","107145846","chr10","129030607","129030775","30","21884934"
"chr3","107155221","107155532","chrX","119401800","119402094","69","12246579"
"chr3","107171010","107171165","chr5","152394893","152395049","30","45223883"
"chr3","107171999","107172137","chr4","39144610","39144753","30","68027389"
"chr3","107208536","107208711","chr8","98909960","98910147","41","8298576"
"chr3","107208761","107208996","chr11","111758061","111758289","56","4549300"
"chr3","107214261","107214566","chr8","74388545","74388840","78","32825716"
"chr3","107222257","107222406","chr8","20885859","20886004","31","86336398"
"chr3","107223445","107223607","chr10","110693634","110693804","42","3470189"
"chr3","107243430","107243728","chr4","97943348","97943668","63","9300082"
"chr3","107258243","107258535","chr4","97931033","97931318","38","9327210"
"chr3","107334802","107335084","chr4","97850632","97850926","42","9484170"
"chr3","107363906","107364198","chr20","52580894","52581182","72","54783012"
"chr3","107386243","107386528","chr4","97796711","97796994","32","9589532"
"chr3","107487399","107487673","chr4","97691225","97691511","40","9796174"
"chr3","107507399","107507685","chr4","97672333","97672620","25","9835066"
"chr3","107511363","107511488","chr4","97667961","97668103","28","9843402"
"chr3","107525865","107526172","chr16","57212544","57212846","67","50313321"
"chr3","107559029","107559328","chr4","97618861","97619162","46","9940168"
"chr3","107578998","107579285","chr4","97602053","97602332","39","9976945"
"chr3","107638525","107638639","chr10","25896416","25896533","22","81742109"
"chr3","107662856","107663155","chr4","97517359","97517665","43","10145497"
"chr3","107698793","107699014","chr18","14450511","14450736","24","93248282"
"chr3","107762940","107763205","chr10","86440089","86440353","63","21322851"
"chr3","108003806","108004108","chr4","97161441","97161757","45","10842365"
"chr3","108061576","108061832","chr1","159711180","159711445","52","51649604"
"chr3","108262866","108263158","chr4","96896688","96896984","29","11366178"
"chr3","108399733","108400036","chr4","96750994","96751298","33","11648739"
"chr3","108442668","108442822","chr2B","126639395","126639541","43","18196727"
"chr3","108613100","108613265","chr12","116125223","116125388","34","7512123"
"chr3","108689713","108689942","chr4","96471238","96471457","33","12218475"
"chr3","108857011","108857312","chr3","139403148","139403455","70","30546137"
"chr3","108899878","108900180","chr4","96159531","96159825","55","12740347"
"chr3","109063025","109063148","chr7","5677173","5677296","18","103385852"
"chr3","109063394","109063691","chr4","96038459","96038756","48","13024935"
"chr3","109131887","109132172","chr4","95958148","95958426","45","13173739"
"chr3","109154131","109154368","chr4","95932964","95933191","28","13221167"
"chr3","109201731","109201946","chr4","95879034","95879272","50","13322697"
"chr3","109322691","109322803","chr4","26065671","26065786","22","83257020"
"chr3","109335071","109335363","chr4","95745183","95745463","50","13589888"
"chr3","109353319","109353479","chr17","4104875","4105033","36","105248444"
"chr3","109365981","109366277","chr9","33082995","33083289","55","76282986"
"chr3","109366654","109366777","chr4","95723835","95723960","13","13642819"
"chr3","109412726","109413032","chr4","95658611","95658892","61","13754115"
"chr3","109477784","109477906","chr20","43708602","43708725","18","65769182"
"chr3","109503359","109503615","chr14","56889960","56890217","62","52613399"
"chr3","109513242","109513551","chr22","8346659","8346962","60","101166583"
"chr3","109547822","109548083","chr6","118636124","118636382","70","9088302"
"chr3","109553046","109553345","chr16","14575570","14575864","72","94977476"
"chr3","109581997","109582293","chr4","95535576","95535863","34","14046421"
"chr3","109683737","109684009","chrX","119498447","119498725","56","9814710"
"chr3","109728981","109729072","chr10","18977165","18977250","31","90751816"
"chr3","109729875","109730000","chr4","117131638","117131769","48","7401763"
"chr3","109847161","109847456","chr4","95255012","95255327","54","14592149"
"chr3","109949184","109949459","chr8","28570096","28570375","56","81379088"
"chr3","109955348","109955504","chr12","120615585","120615740","37","10660237"
"chr3","110239950","110240226","chr8","35983334","35983613","41","74256616"
"chr3","110522715","110522867","chr1","93518499","93518655","33","17004216"
"chr3","110572742","110573025","chr4","94622715","94622981","50","15950027"
"chr3","110643890","110644038","chr1","54878096","54878240","33","55765794"
"chr3","110644329","110644421","chr3","24236501","24236584","26","86407828"
"chr3","110645171","110645240","chr1","224822809","224822879","20","114177638"
"chr3","110647714","110648000","chr4","94538579","94538866","25","16109135"
"chr3","110657147","110657265","chr6","137163506","137163623","26","26506359"
"chr3","110684575","110684697","chr8","17178149","17178269","17","93506426"
"chr3","110706221","110706467","chr4","94460452","94460743","67","16245769"
"chr3","110732500","110732720","chr4","94432958","94433179","34","16299542"
"chr3","110737117","110737405","chr4","94428315","94428591","44","16308802"
"chr3","110738802","110739074","chr4","94426623","94426888","43","16312179"
"chr3","110745031","110745210","chr4","94420950","94421138","37","16324081"
"chr3","110749460","110749756","chr4","94409902","94410204","24","16339558"
"chr3","110752720","110752864","chr4","94406450","94406595","21","16346270"
"chr3","110777857","110778057","chr4","94385286","94385490","28","16392571"
"chr3","110789796","110790098","chr4","94374563","94374864","59","16415233"
"chr3","110793649","110793767","chr1","93145168","93145283","15","17648481"
"chr3","110853705","110854002","chr4","94322974","94323266","39","16530731"
"chr3","110854334","110854638","chr1","19377983","19378282","71","91476351"
"chr3","110856476","110856598","chr16","8990415","8990539","27","101866061"
"chr3","110871920","110872187","chr4","94306714","94306980","24","16565206"
"chr3","110886482","110886593","chr7","14967118","14967225","31","95919364"
"chr3","110902673","110902978","chr4","94280810","94281119","42","16621863"
"chr3","110935413","110935540","chr10","15454692","15454818","16","95480721"
"chr3","110948749","110948928","chr6","107347099","107347272","57","3601650"
"chr3","110949113","110949191","chr2B","117499922","117500000","12","6550809"
"chr3","110960845","110961143","chr6","6955846","6956141","59","104004999"
"chr3","111073991","111074288","chr4","94138900","94139197","35","16935091"
"chr3","111088312","111088616","chr4","94117300","94117605","57","16971012"
"chr3","111129703","111129800","chr10","117001518","117001614","14","5871815"
"chr3","111130292","111130372","chr9","80084364","80084438","23","31045928"
"chr3","111140472","111140747","chr5","10684242","10684515","70","100456230"
"chr3","111175667","111175788","chr1","19220608","19220728","15","91955059"
"chr3","111197344","111197562","chr1","86159635","86159843","64","25037709"
"chr3","111237653","111237869","chr4","93981984","93982206","37","17255669"
"chr3","111264259","111264490","chr9","113807290","113807518","49","2543031"
"chr3","111319549","111319810","chr5","160755148","160755395","70","49435599"
"chr3","111330943","111331202","chr4","93902470","93902756","59","17428473"
"chr3","111341953","111342066","chr6","42762167","42762282","18","68579786"
"chr3","111366755","111367009","chr4","93882304","93882550","35","17484451"
"chr3","111377635","111377933","chr4","93871505","93871806","50","17506130"
"chr3","111424624","111424887","chr19","31601615","31601874","59","79823009"
"chr3","111497472","111497753","chr4","93752089","93752382","40","17745383"
"chr3","111522299","111522602","chr4","93728601","93728909","42","17793698"
"chr3","111541660","111541811","chr1","68709407","68709549","38","42832253"
"chr3","111542726","111542887","chr13","5474254","5474413","38","106068472"
"chr3","111562838","111563096","chr5","164210812","164211052","67","52647974"
"chr3","111634020","111634327","chr4","93618966","93619273","31","18015054"
"chr3","111639680","111639972","chr4","93613176","93613473","34","18026504"
"chr3","111685325","111685478","chr20","43332910","43333066","45","68352415"
"chr3","111731667","111731902","chr20","49661226","49661456","56","62070441"
"chr3","111736268","111736392","chr2A","82138107","82138230","16","29598161"
"chr3","111754763","111754976","chr4","93490054","93490268","17","18264709"
"chr3","111798419","111798621","chr4","93459450","93459643","39","18338969"
"chr3","111807586","111807873","chr4","93452951","93453255","57","18354635"
"chr3","111815781","111816091","chr20","33460181","33460482","56","78355600"
"chr3","111817472","111817585","chr3","124234294","124234409","21","12416822"
"chr3","111817824","111818100","chrX","132565024","132565315","61","20747200"
"chr3","111858930","111859195","chr11","73005996","73006265","72","38852934"
"chr3","111890644","111890882","chr18","28798620","28798851","77","83092024"
"chr3","111905339","111905608","chr4","93362130","93362406","48","18543209"
"chr3","111970537","111970840","chr4","93261757","93262041","56","18708780"
"chr3","112006916","112007081","chr1","7841983","7842144","44","104164933"
"chr3","112016660","112016904","chr4","93223768","93224009","31","18792892"
"chr3","112140811","112141073","chr7","158450342","158450643","63","46309531"
"chr3","112151177","112151286","chr1","103455628","103455743","22","8695549"
"chr3","112157586","112157873","chr7","158432731","158433034","55","46275145"
"chr3","112191753","112191877","chr4","93123539","93123663","14","19068214"
"chr3","112446119","112446403","chr4","92895916","92896200","32","19550203"
"chr3","112499782","112500000","chrX","154182968","154183182","47","41683186"
"chr3","112615112","112615241","chr2A","51428234","51428361","22","61186878"
"chr3","112634690","112634985","chr4","92720249","92720514","63","19914441"
"chr3","112641785","112641911","chr1","21301496","21301630","35","91340289"
"chr3","112848255","112848403","chr22","20288134","20288276","39","92560121"
"chr3","112868562","112868840","chr4","92513375","92513666","59","20355187"
"chr3","112885885","112885989","chr4","196402447","196402553","22","83516562"
"chr3","112935291","112935517","chr6","36811583","36811831","63","76123708"
"chr3","112956763","112957002","chr15","8078541","8078783","52","104878222"
"chr3","112957065","112957143","chr8","121939032","121939107","15","8981967"
"chr3","112990047","112990342","chr4","92390844","92391140","31","20599203"
"chr3","113163050","113163176","chr4","92220515","92220636","19","20942535"
"chr3","113184993","113185204","chr7","75849254","75849465","41","37335739"
"chr3","113291733","113292031","chr15","44244841","44245146","56","69046892"
"chr3","113309710","113310006","chr4","92063681","92063949","66","21246029"
"chr3","113469401","113469698","chr4","91923778","91924072","99","21545623"
"chr3","113793097","113793197","chr13","84762664","84762764","15","29030433"
"chr3","113830189","113830477","chr9","103292788","103293071","93","10537401"
"chr3","113929735","113930025","chr4","91513557","91513848","40","22416178"
"chr3","114011532","114011698","chr18","17744589","17744753","41","96266943"
"chr3","114235157","114235272","chr1","26982259","26982376","20","87252898"
"chr3","114247295","114247612","chr1","181256651","181256946","69","67009356"
"chr3","114251027","114251364","chr4","91217302","91217614","81","23033725"
"chr3","114254058","114254349","chr4","91213912","91214223","70","23040146"
"chr3","114265990","114266281","chr2A","62522516","62522814","62","51743474"
"chr3","114344485","114344786","chr4","91132666","91132961","68","23211819"
"chr3","114415611","114415726","chr6","87517319","87517435","21","26898292"
"chr3","114416874","114417147","chr4","91070200","91070472","38","23346674"
"chr3","114478503","114478803","chr4","91017489","91017765","57","23461014"
"chr3","114535144","114535298","chr10","49585047","49585201","34","64950097"
"chr3","114573966","114574128","chr21","24720942","24721101","40","89853024"
"chr3","114574268","114574408","chr3","144275153","144275288","36","29700885"
"chr3","114749968","114750276","chr4","90756070","90756384","44","23993898"
"chr3","115098988","115099309","chr4","90419798","90420093","61","24679190"
"chr3","115225893","115226199","chr4","90295013","90295311","43","24930880"
"chr3","115370995","115371105","chr4","93672465","93672581","20","21698530"
"chr3","115371230","115371379","chr15","69740012","69740164","44","45631218"
"chr3","115384484","115384647","chr4","90125338","90125502","22","25259146"
"chr3","115480249","115480512","chr4","90016409","90016678","37","25463840"
"chr3","115555586","115555728","chr5","16883880","16884017","48","98671706"
"chr3","115555729","115555773","chr11","34035207","34035254","11","81520522"
"chr3","115595318","115595552","chr12","121197174","121197386","65","5601856"
"chr3","115626184","115626472","chr4","89876427","89876702","45","25749757"
"chr3","115629016","115629143","chr15","67738102","67738224","17","47890914"
"chr3","115716530","115716808","chr4","89777781","89778073","40","25938749"
"chr3","115741789","115741906","chr4","89766869","89766986","6","25974920"
"chr3","115742458","115742602","chr1","205945800","205945944","38","90203342"
"chr3","115760977","115761098","chr4","89750194","89750314","16","26010783"
"chr3","115767483","115767782","chr4","89743966","89744265","43","26023517"
"chr3","115771034","115771177","chr1","32478284","32478418","35","83292750"
"chr3","115792238","115792538","chr4","89717686","89717998","43","26074552"
"chr3","115804573","115804822","chr4","89706193","89706471","55","26098380"
"chr3","115837500","115837813","chr4","89665757","89666071","51","26171743"
"chr3","115846843","115847126","chr4","89655237","89655516","38","26191606"
"chr3","115856982","115857105","chr4","89648080","89648203","8","26208902"
"chr3","115873508","115873818","chr4","89631607","89631904","48","26241901"
"chr3","115886602","115886866","chr4","89620340","89620630","47","26266262"
"chr3","115952948","115953241","chr7","76041457","76041753","66","39911491"
"chr3","116034183","116034386","chr6","35112653","35112849","44","80921530"
"chr3","116199301","116199589","chr4","89339563","89339856","36","26859738"
"chr3","116219637","116219906","chr12","65117421","65117705","68","51102216"
"chr3","116588587","116588898","chr4","88934833","88935139","59","27653754"
"chr3","116594938","116595042","chr13","9559854","9559959","24","107035084"
"chr3","116662838","116663116","chr4","88860411","88860678","42","27802427"
"chr3","116664673","116664938","chr5","26487404","26487672","75","90177269"
"chr3","116672259","116672550","chrX","119401800","119402094","57","2729541"
"chr3","116696783","116697071","chr4","88827290","88827590","36","27869493"
"chr3","116777211","116777478","chr4","88765602","88765846","48","28011609"
"chr3","116777626","116777926","chr4","88765158","88765449","65","28012468"
"chr3","116785733","116786015","chr4","88748789","88749101","56","28036944"
"chr3","116827984","116828279","chr15","8265879","8266174","57","108562105"
"chr3","116886354","116886656","chr4","88661644","88661949","32","28224710"
"chr3","116977826","116978117","chr19","47070303","47070597","61","69907523"
"chr3","117020750","117021024","chr8","73655457","73655739","70","43365293"
"chr3","117055028","117055334","chr4","88464730","88465030","38","28590298"
"chr3","117450844","117451147","chr4","88107915","88108216","41","29342929"
"chr3","117456720","117456833","chr4","88102140","88102266","21","29354580"
"chr3","117465964","117466249","chr4","88093444","88093728","27","29372520"
"chr3","117471139","117471464","chr11","3203278","3203575","93","114267861"
"chr3","117504348","117504641","chr4","88049869","88050175","42","29454479"
"chr3","117514109","117514371","chr1","8080959","8081236","62","109433150"
"chr3","117515875","117516095","chr4","88042317","88042543","24","29473558"
"chr3","117523228","117523334","chr12","110737468","110737573","14","6785760"
"chr3","117529535","117529782","chr10","26364668","26364905","68","91164867"
"chr3","117532125","117532403","chr4","88019858","88020122","59","29512267"
"chr3","117555910","117556189","chr4","87994945","87995233","42","29560965"
"chr3","117605314","117605475","chr6","32201728","32201890","30","85403586"
"chr3","117662126","117662224","chr5","23513112","23513208","23","94149014"
"chr3","117680036","117680318","chr4","87860319","87860606","70","29819717"
"chr3","117681138","117681437","chr4","87859184","87859457","45","29821954"
"chr3","117712649","117712918","chr4","87832283","87832564","33","29880366"
"chr3","117712938","117713232","chr2A","59667083","59667378","63","58045855"
"chr3","117786892","117787184","chr4","87769317","87769620","43","30017575"
"chr3","117812638","117812921","chr4","87741462","87741760","39","30071176"
"chr3","117862009","117862179","chrX","55202006","55202169","30","62660003"
"chr3","117903058","117903207","chr4","83983716","83983868","29","33919342"
"chr3","117966800","117967089","chr4","87602648","87602933","37","30364152"
"chr3","117980118","117980421","chr4","87589913","87590218","38","30390205"
"chr3","118065996","118066291","chr4","87494017","87494295","47","30571979"
"chr3","118158287","118158583","chr4","87413578","87413862","48","30744709"
"chr3","118167354","118167649","chr4","87402636","87402937","36","30764718"
"chr3","118211118","118211227","chr4","87356281","87356398","18","30854837"
"chr3","118225315","118225439","chr4","124129514","124129638","20","5904199"
"chr3","118226354","118226645","chr4","87342793","87343094","45","30883561"
"chr3","118247120","118247179","chr19","4557710","4557767","14","113689410"
"chr3","118268567","118268807","chr4","87305554","87305822","51","30963013"
"chr3","118270552","118270840","chr7","137755873","137756162","58","19485321"
"chr3","118350614","118350735","chr4","87244516","87244638","17","31106098"
"chr3","118397661","118397943","chr1","68093289","68093580","69","50304372"
"chr3","118412914","118413161","chr17","81533727","81533977","61","36879187"
"chr3","118434128","118434428","chr1","53540789","53541084","65","64893339"
"chr3","118441532","118441696","chr3","10866047","10866211","32","107575485"
"chr3","118442200","118442312","chr17","78738034","78738137","28","39704166"
"chr3","118463503","118463795","chr4","87151675","87151964","36","31311828"
"chr3","118508588","118508753","chr18","14541461","14541626","36","103967127"
"chr3","118511492","118511778","chr4","87112172","87112465","40","31399320"
"chr3","118522191","118522454","chr12","21322563","21322830","64","97199628"
"chr3","118562729","118563038","chr4","87063484","87063823","67","31499245"
"chr3","118575373","118575666","chr10","5342646","5342936","54","113232727"
"chr3","118594149","118594420","chr4","87044634","87044931","46","31549515"
"chr3","118596245","118596353","chr6","7105611","7105725","17","111490634"
"chr3","118611482","118611763","chr4","87028127","87028413","37","31583355"
"chr3","118634614","118634827","chr4","87013877","87014102","25","31620737"
"chr3","118700570","118700739","chr8","29136673","29136845","34","89563897"
"chr3","118730614","118730874","chr1","215917747","215918023","75","97187133"
"chr3","118737328","118737633","chr4","86929082","86929365","53","31808246"
"chr3","118743599","118743854","chr4","86922702","86922964","45","31820897"
"chr3","118776367","118776654","chr4","86891218","86891500","37","31885149"
"chr3","118781786","118782041","chr22","21331231","21331487","52","97450555"
"chr3","118791722","118791982","chr4","86876974","86877259","52","31914748"
"chr3","118795311","118795410","chr4","86873798","86873900","15","31921513"
"chr3","118814383","118814653","chr10","29441110","29441370","68","89373273"
"chr3","118816774","118816911","chr8","103799790","103799921","23","15016984"
"chr3","118839995","118840122","chr4","86829943","86830069","5","32010052"
"chr3","118842300","118842550","chr15","46793365","46793626","66","72048935"
"chr3","118994338","118994630","chr4","86681405","86681687","45","32312933"
"chr3","119011372","119011650","chr18","1313785","1314066","64","117697587"
"chr3","119013868","119014072","chr1","128855067","128855266","43","9841199"
"chr3","119034327","119034599","chr4","86644685","86644958","33","32389642"
"chr3","119058460","119058739","chr16","44829201","44829482","67","74229259"
"chr3","119080602","119080909","chr16","31190986","31191288","56","87889616"
"chr3","119082162","119082317","chr3","155574758","155574899","39","36492596"
"chr3","119122770","119122931","chr9","23434201","23434353","35","95688569"
"chr3","119123091","119123398","chr6","28347395","28347714","34","90775696"
"chr3","119145956","119146247","chr4","86537588","86537882","24","32608368"
"chr3","119151246","119151537","chr4","86531903","86532205","36","32619343"
"chr3","119291800","119291919","chr8","7759150","7759271","24","111532650"
"chr3","119377450","119377581","chr2A","97947049","97947173","25","21430401"
"chr3","119399642","119399898","chr4","86356310","86356559","37","33043332"
"chr3","119491404","119491694","chr4","86261390","86261682","35","33230014"
"chr3","119495056","119495180","chr9","70213476","70213592","22","49281580"
"chr3","119495213","119495502","chr4","86257588","86257880","41","33237625"
"chr3","119602809","119602897","chr5","26761731","26761826","29","92841078"
"chr3","119634984","119635320","chr4","86084630","86084928","84","33550354"
"chr3","119658772","119658856","chr16","60258756","60258841","22","59400016"
"chr3","119816152","119816401","chr1","217102109","217102356","71","97285957"
"chr3","119875856","119876007","chr10","49585047","49585201","28","70290809"
"chr3","119950347","119950443","chr14","73617503","73617594","24","46332844"
"chr3","119994189","119994474","chr1","183947223","183947512","64","63953034"
"chr3","120094705","120094990","chr7","68142125","68142405","57","51952580"
"chr3","120152720","120152946","chr5","55614784","55615027","73","64537936"
"chr3","120403632","120403925","chr1","28254794","28255088","71","92148838"
"chr3","120406848","120407142","chr22","1222516","1222802","69","119184332"
"chr3","120663052","120663175","chr11","69147152","69147272","30","51515900"
"chr3","120911088","120911374","chr4","84646674","84646961","61","36264414"
"chr3","121195305","121195442","chr5","26663357","26663492","50","94531948"
"chr3","121329979","121330275","chr4","84210597","84210900","46","37119382"
"chr3","121336856","121337136","chr16","25190782","25191063","62","96146074"
"chr3","121384174","121384467","chr4","84173798","84174105","39","37210376"
"chr3","121384580","121384693","chr4","84173589","84173703","18","37210991"
"chr3","121398166","121398465","chr4","84161031","84161344","56","37237135"
"chr3","121402568","121402863","chr4","84157097","84157393","28","37245471"
"chr3","121507509","121507807","chr4","84065717","84066009","52","37441792"
"chr3","121513916","121514184","chr4","84032491","84032777","54","37481425"
"chr3","121558968","121559116","chrX","80441361","80441488","40","41117607"
"chr3","121578410","121578688","chr4","83951385","83951655","52","37627025"
"chr3","121610376","121610539","chr19","16621051","16621221","40","104989325"
"chr3","121626476","121626636","chr8","56795337","56795503","34","64831139"
"chr3","121633631","121633794","chr12","35974023","35974184","39","85659608"
"chr3","121644035","121644161","chr7","77000001","77000126","27","44644034"
"chr3","121664816","121664932","chr20","46080183","46080300","20","75584633"
"chr3","121732776","121732907","chr4","83817192","83817322","14","37915584"
"chr3","122330252","122330369","chr1","101621131","101621248","18","20709121"
"chr3","122601478","122601769","chr4","82890471","82890769","48","39711007"
"chr3","122731957","122732165","chr4","82747077","82747296","40","39984880"
"chr3","122932952","122933228","chr4","82537139","82537414","35","40395813"
"chr3","123175194","123175271","chr4","82318431","82318510","9","40856763"
"chr3","123486254","123486556","chr4","82025945","82026248","40","41460309"
"chr3","123521165","123521271","chr3","186615177","186615282","18","63094012"
"chr3","123588518","123588823","chr4","81922518","81922810","55","41666000"
"chr3","123592683","123592907","chr4","81911226","81911449","30","41681457"
"chr3","123625176","123625478","chr12","119664186","119664491","69","3960990"
"chr3","123632616","123632901","chr11","74285147","74285435","57","49347469"
"chr3","123663203","123663489","chr5","26154281","26154566","57","97508922"
"chr3","123665614","123665901","chr1","102664060","102664355","69","21001554"
"chr3","123694439","123694583","chr3","187947741","187947875","39","64253302"
"chr3","123694586","123694830","chr19","18542605","18542851","69","105151981"
"chr3","123718430","123718592","chr5","51144248","51144411","37","72574182"
"chr3","123724642","123724940","chr20","43157775","43158073","75","80566867"
"chr3","123729178","123729377","chr4","81752460","81752664","31","41976718"
"chr3","123733894","123734196","chr4","81746700","81747024","56","41987194"
"chr3","123739881","123740146","chr9","75566020","75566287","58","48173861"
"chr3","123745692","123745836","chr1","23727757","23727901","31","100017935"
"chr3","123760317","123760405","chr4","81725956","81726044","8","42034361"
"chr3","123785611","123785741","chr12","99742737","99742860","21","24042874"
"chr3","123791209","123791335","chr4","81681476","81681596","20","42109733"
"chr3","123805544","123805664","chr4","81658736","81658865","25","42146808"
"chr3","123808920","123809217","chr4","81654201","81654485","45","42154719"
"chr3","123814786","123815083","chr11","72251845","72252150","54","51562941"
"chr3","123853983","123854148","chr15","30066662","30066823","43","93787321"
"chr3","123860125","123860241","chr4","81624302","81624415","10","42235823"
"chr3","123871441","123871716","chr4","81612190","81612494","62","42259251"
"chr3","123895251","123895552","chr4","81586294","81586577","51","42308957"
"chr3","123914237","123914532","chr4","81569375","81569661","49","42344862"
"chr3","124168642","124168911","chr4","81319519","81319800","52","42849123"
"chr3","124222196","124222249","chr13","34189614","34189664","13","90032582"
"chr3","124310468","124310751","chr4","81225321","81225603","40","43085147"
"chr3","124336253","124336536","chr19","31962850","31963132","63","92373403"
"chr3","124449342","124449445","chr4","81113645","81113740","20","43335697"
"chr3","124532529","124532611","chr16","12429378","12429458","28","112103151"
"chr3","124532740","124532873","chrX","19843213","19843351","33","104689527"
"chr3","124537143","124537252","chr17","4486487","4486596","35","120050656"
"chr3","124662777","124663076","chr16","9180274","9180567","58","115482503"
"chr3","124719643","124719883","chr4","80827588","80827847","50","43892055"
"chr3","124747185","124747226","chr4","2116357","2116395","12","122630828"
"chr3","124908459","124908612","chr20","32123638","32123783","39","92784821"
"chr3","124912488","124912604","chr3","144866863","144866979","27","19954375"
"chr3","124917427","124917507","chr4","183280578","183280656","19","58363151"
"chr3","124931434","124931711","chr4","93823664","93823946","69","31107770"
"chr3","124932845","124933115","chr4","80582463","80582756","63","44350382"
"chr3","124936062","124936346","chr3","131630293","131630578","72","6694231"
"chr3","125030672","125030973","chr4","80495847","80496149","36","44534825"
"chr3","125038716","125038937","chr4","80483249","80483468","35","44555467"
"chr3","125394953","125395251","chr4","82025945","82026248","54","43369008"
"chr3","125401954","125402253","chr6","45220708","45220995","66","80181246"
"chr3","125451172","125451365","chr2A","103878031","103878209","55","21573141"
"chr3","125506633","125506903","chr4","59562465","59562747","56","65944168"
"chr3","125545252","125545374","chr10","125374372","125374495","25","170880"
"chr3","125561341","125561641","chr4","60152428","60152729","36","65408913"
"chr3","125694983","125695205","chr4","59912112","59912342","33","65782871"
"chr3","125786200","125786459","chr4","60324363","60324621","38","65461837"
"chr3","125835468","125835759","chr4","60370708","60371001","57","65464760"
"chr3","125879309","125879591","chr4","60423891","60424173","33","65455418"
"chr3","125883998","125884116","chr4","60428357","60428476","11","65455641"
"chr3","125955423","125955550","chr2A","4936383","4936508","27","121019040"
"chr3","126050160","126050296","chr11","117613154","117613293","34","8437006"
"chr3","126121252","126121548","chr17","3818868","3819165","60","122302384"
"chr3","126144472","126144572","chr2B","2272901","2273006","28","123871571"
"chr3","126145904","126146205","chr7","79532995","79533296","60","46612909"
"chr3","126203135","126203375","chr4","60798594","60798872","66","65404541"
"chr3","126231865","126232177","chr7","74393381","74393674","82","51838484"
"chr3","126246692","126246814","chr4","60843220","60843343","10","65403472"
"chr3","126269708","126269915","chr4","60865702","60865907","30","65404006"
"chr3","126296318","126296612","chr4","60891337","60891618","42","65404981"
"chr3","126447469","126447744","chr4","61062068","61062346","41","65385401"
"chr3","126481610","126481903","chr4","61097925","61098216","42","65383685"
"chr3","126541291","126541406","chr8","98228551","98228666","24","28312740"
"chr3","126644802","126644925","chr4","61265266","61265389","14","65379536"
"chr3","126667909","126668091","chr5","62065429","62065605","48","64602480"
"chr3","127085332","127085594","chr4","61723432","61723691","41","65361900"
"chr3","127199639","127199913","chr1","215374689","215374982","70","88175050"
"chr3","127206795","127206915","chr4","61846164","61846285","19","65360631"
"chr3","127275859","127275998","chrX","54854170","54854313","30","72421689"
"chr3","127303752","127303987","chr7","73567020","73567265","58","53736732"
"chr3","127527763","127527878","chr6","13214418","13214534","20","114313345"
"chr3","127700118","127700246","chr3","24451219","24451346","29","103248899"
"chr3","127927765","127928045","chr2A","41374002","41374285","67","86553763"
"chr3","128199394","128199688","chr4","62866514","62866805","58","65332880"
"chr3","128209365","128209499","chr16","69212656","69212783","35","58996709"
"chr3","128210097","128210193","chr18","2107838","2107935","31","126102259"
"chr3","128282595","128282888","chr4","62954772","62955068","61","65327823"
"chr3","128296077","128296419","chr4","62967688","62968033","64","65328389"
"chr3","128486019","128486218","chr6","80639163","80639347","53","47846856"
"chr3","128617681","128617859","chr5","163217430","163217605","48","34599749"
"chr3","128764961","128765272","chr4","63456520","63456832","57","65308441"
"chr3","128941609","128941731","chr14","13851777","13851900","21","115089832"
"chr3","129001646","129001893","chr4","63700879","63701164","61","65300767"
"chr3","129509631","129509719","chrX","27651738","27651825","34","101857893"
"chr3","129509747","129509873","chr19","44030026","44030143","31","85479721"
"chr3","130089641","130089925","chr4","64910396","64910675","52","65179245"
"chr3","130097491","130097630","chr8","42822730","42822873","36","87274761"
"chr3","130332786","130332930","chr1","68709407","68709549","43","61623379"
"chr3","130375793","130376058","chr4","65293518","65293779","63","65082275"
"chr3","130406437","130406747","chr1","65033130","65033403","97","65373307"
"chr3","130585311","130585421","chr7","79291991","79292103","21","51293320"
"chr3","130595023","130595343","chr4","65625935","65626239","64","64969088"
"chr3","130819937","130820021","chrX","4277787","4277864","26","126542150"
"chr3","130820910","130821041","chr12","94605571","94605703","24","36215339"
"chr3","131053759","131054059","chr4","66103727","66104027","49","64950032"
"chr3","131190363","131190657","chr4","66220825","66221128","45","64969538"
"chr3","131223637","131223897","chr12","66100201","66100459","75","65123436"
"chr3","131237176","131237299","chr7","90104149","90104265","42","41133027"
"chr3","131392663","131392895","chrX","132585466","132585704","66","1192803"
"chr3","131405045","131405349","chr4","66449118","66449422","43","64955927"
"chr3","131444917","131445190","chr4","66505784","66506047","51","64939133"
"chr3","131476050","131476339","chr4","66538159","66538458","44","64937891"
"chr3","131548903","131549028","chr4","66589364","66589487","21","64959539"
"chr3","131552326","131552609","chr4","66592986","66593272","42","64959340"
"chr3","131745104","131745377","chr12","123570594","123570856","60","8174510"
"chr3","131751846","131752134","chr4","66795249","66795549","56","64956597"
"chr3","131830766","131831045","chr4","66882301","66882583","42","64948465"
"chr3","131893878","131894220","chr4","66947351","66947669","72","64946527"
"chr3","131924570","131924828","chr14","84062484","84062754","79","47862086"
"chr3","131950130","131950379","chr4","66997648","66997892","56","64952482"
"chr3","131976073","131976374","chr7","73100304","73100605","75","58875769"
"chr3","131976388","131976511","chr11","119855024","119855146","23","12121364"
"chr3","132019791","132019888","chr10","90231830","90231924","30","41787961"
"chr3","132019914","132019981","chr7","23547259","23547322","21","108472655"
"chr3","132031770","132031874","chr7","44654252","44654346","21","87377518"
"chr3","132039775","132039903","chr13","7095404","7095527","21","124944371"
"chr3","132097260","132097566","chr5","129500126","129500434","78","2597134"
"chr3","132099320","132099451","chr9","112841011","112841143","20","19258309"
"chr3","132147002","132147286","chr4","67208856","67209162","58","64938146"
"chr3","132153583","132153906","chr4","67215175","67215484","54","64938408"
"chr3","132199219","132199513","chr4","67260205","67260486","53","64939014"
"chr3","132221508","132221766","chr7","116519090","116519354","63","15702418"
"chr3","132233229","132233350","chr13","62995177","62995295","21","69238052"
"chr3","132313303","132313594","chr4","67377797","67378089","46","64935506"
"chr3","132449633","132449898","chr4","67515344","67515606","62","64934289"
"chr3","132493947","132494078","chr4","67559559","67559693","18","64934388"
"chr3","132498229","132498566","chr4","67562753","67563051","81","64935476"
"chr3","132614930","132615208","chr20","48848955","48849237","65","83765975"
"chr3","132662141","132662241","chr4","67718678","67718783","23","64943463"
"chr3","132662269","132662576","chr3","4269429","4269727","84","128392840"
"chr3","132776491","132776818","chr4","67836855","67837186","84","64939636"
"chr3","132782464","132782773","chr4","67842861","67843167","40","64939603"
"chr3","132798607","132798904","chr4","67859025","67859319","72","64939582"
"chr3","132816534","132816811","chr4","67875891","67876178","50","64940643"
"chr3","132902634","132902912","chr4","67968354","67968620","53","64934280"
"chr3","132961924","132962192","chr16","48469927","48470183","72","84491997"
"chr3","133206116","133206406","chr15","28698469","28698760","58","104507647"
"chr3","133209314","133209612","chr2A","51840898","51841187","60","81368416"
"chr3","133269822","133270137","chr4","68331257","68331571","74","64938565"
"chr3","133646845","133647135","chr4","68745363","68745652","35","64901482"
"chr3","133672245","133672551","chr4","68769207","68769509","51","64903038"
"chr3","133724099","133724408","chr4","68812856","68813165","76","64911243"
"chr3","133982012","133982304","chr4","69104810","69105100","68","64877202"
"chr3","134190982","134191273","chr4","69334050","69334314","66","64856932"
"chr3","134394634","134394715","chr14","72357306","72357388","20","62037328"
"chr3","134599928","134600205","chr8","103136896","103137185","74","31463032"
"chr3","134791306","134791597","chr4","70022982","70023285","55","64768324"
"chr3","134967049","134967170","chr7","5677173","5677296","19","129289876"
"chr3","134999108","134999395","chr1","7480351","7480627","79","127518757"
"chr3","135025793","135026076","chr4","70264947","70265255","59","64760846"
"chr3","135039499","135039773","chr15","67578808","67579085","61","67460691"
"chr3","135083562","135083869","chr22","12998437","12998739","64","122085125"
"chr3","135272715","135273017","chr4","70539504","70539772","82","64733211"
"chr3","135419908","135420202","chr4","70690488","70690796","47","64729420"
"chr3","135699756","135700056","chr4","70970191","70970495","36","64729565"
"chr3","135755595","135755739","chr3","187425335","187425481","28","51669740"
"chr3","135863022","135863186","chr6","15264957","15265121","37","120598065"
"chr3","136309447","136309738","chr5","24602386","24602684","65","111707061"
"chr3","136346635","136346763","chr1","134146195","134146326","22","2200440"
"chr3","136383755","136384017","chr4","71643007","71643264","47","64740748"
"chr3","136406540","136406744","chr17","51965345","51965552","39","84441195"
"chr3","136411179","136411479","chr4","71669423","71669722","31","64741756"
"chr3","136440114","136440286","chr20","5564246","5564411","42","130875868"
"chr3","136440654","136440774","chr4","15319434","15319556","21","121121220"
"chr3","136442889","136443194","chr16","31213333","31213639","61","105229556"
"chr3","136458868","136459163","chr4","71713421","71713719","29","64745447"
"chr3","136474973","136475274","chr4","71728892","71729194","41","64746081"
"chr3","136480390","136480544","chr20","44858230","44858390","30","91622160"
"chr3","136511970","136512069","chr3","58857961","58858058","26","77654009"
"chr3","136526432","136526552","chr6","132205914","132206037","20","4320518"
"chr3","136573193","136573310","chr4","71807651","71807768","13","64765542"
"chr3","136581038","136581328","chr20","13995706","13996002","55","122585332"
"chr3","136587825","136587939","chr19","15858781","15858891","26","120729044"
"chr3","136599485","136599580","chr21","4837821","4837916","19","131761664"
"chr3","136612217","136612335","chr6","36093674","36093792","19","100518543"
"chr3","136639050","136639175","chr2B","124989668","124989787","29","11649382"
"chr3","136655060","136655362","chr4","71905373","71905671","46","64749687"
"chr3","136661820","136662096","chr4","71914040","71914318","57","64747780"
"chr3","136713846","136713962","chr7","64738088","64738205","14","71975758"
"chr3","136733803","136733923","chr1","182799317","182799435","20","46065514"
"chr3","136748559","136748684","chr2B","125909637","125909758","20","10838922"
"chr3","136749412","136749532","chr4","71984148","71984263","15","64765264"
"chr3","136754335","136754453","chr8","101431374","101431489","33","35322961"
"chr3","136755387","136755508","chr4","71983291","71983411","17","64772096"
"chr3","136773557","136773671","chr11","118881232","118881340","26","17892325"
"chr3","136773909","136774026","chr16","31521392","31521512","18","105252517"
"chr3","136774345","136774651","chr7","79073505","79073807","69","57700840"
"chr3","136821456","136821731","chr4","72042049","72042342","49","64779407"
"chr3","136827804","136828113","chr4","72048749","72049052","47","64779055"
"chr3","136893731","136894047","chr4","72123971","72124294","40","64769760"
"chr3","136961633","136961910","chr4","72192753","72193032","32","64768880"
"chr3","136966902","136967179","chr4","72197190","72197466","32","64769712"
"chr3","136972244","136972508","chr4","72205817","72206105","49","64766427"
"chr3","136978202","136978317","chr1","46059103","46059218","20","90919099"
"chr3","136987872","136987985","chr17","548707","548821","19","136439165"
"chr3","137006427","137006679","chr16","8503343","8503569","82","128503084"
"chr3","137018148","137018459","chr7","4605129","4605434","77","132413019"
"chr3","137058553","137058725","chr18","20070447","20070624","35","116988106"
"chr3","137124825","137125110","chr4","24938285","24938581","70","112186540"
"chr3","137162972","137163093","chr1","135152329","135152453","22","2010643"
"chr3","137166663","137166950","chr7","120833001","120833284","60","16333662"
"chr3","137169101","137169398","chr4","72403547","72403845","40","64765554"
"chr3","137186693","137186955","chr4","72427923","72428219","63","64758770"
"chr3","137225640","137225932","chr14","76943072","76943349","57","60282568"
"chr3","137230302","137230586","chr4","72475022","72475314","51","64755280"
"chr3","137237196","137237467","chr4","72482248","72482476","59","64754948"
"chr3","137248784","137249066","chr12","125243117","125243401","72","12005667"
"chr3","137309792","137310062","chr4","72537957","72538226","43","64771835"
"chr3","137312472","137312762","chr1","140088508","140088802","61","2776036"
"chr3","137324085","137324364","chr4","72555208","72555503","33","64768877"
"chr3","137332987","137333299","chr12","29966071","29966356","83","107366916"
"chr3","137347050","137347331","chr4","72574123","72574415","41","64772927"
"chr3","137380826","137381107","chr4","72607953","72608240","37","64772873"
"chr3","137401276","137401569","chr4","72630235","72630529","37","64771041"
"chr3","137408008","137408285","chr4","72637155","72637447","68","64770853"
"chr3","137420709","137420978","chr1","43624160","43624442","67","93796549"
"chr3","137423805","137423975","chr19","3603453","3603632","42","133820352"
"chr3","137425753","137425877","chr3","54036399","54036522","18","83389354"
"chr3","137451323","137451589","chr5","48941654","48941913","66","88509669"
"chr3","137467040","137467351","chr4","72686173","72686495","58","64780867"
"chr3","137479068","137479189","chr4","72697956","72698081","10","64781112"
"chr3","137494105","137494270","chr1","93560424","93560585","41","43933681"
"chr3","137498135","137498423","chr8","83196108","83196399","62","54302027"
"chr3","137520142","137520283","chr1","23727757","23727901","36","113792385"
"chr3","137521289","137521583","chr9","96033142","96033440","65","41488147"
"chr3","137537647","137537927","chr4","72758269","72758558","46","64779378"
"chr3","137560345","137560645","chr9","15043290","15043588","56","122517055"
"chr3","137580861","137581130","chr4","72805017","72805280","35","64775844"
"chr3","137649168","137649483","chr4","72901420","72901711","57","64747748"
"chr3","137657677","137657986","chr4","72909065","72909359","48","64748612"
"chr3","137663465","137663643","chr2A","79722390","79722577","39","57941075"
"chr3","137704541","137704808","chr1","12051012","12051291","65","125653529"
"chr3","137728899","137729185","chr22","33935616","33935903","61","103793283"
"chr3","137742367","137742688","chr4","72992698","72993014","42","64749669"
"chr3","137746990","137747242","chr17","89053843","89054101","52","48693147"
"chr3","137792150","137792444","chr4","73046118","73046423","55","64746032"
"chr3","137805152","137805238","chr8","11775107","11775193","17","126030045"
"chr3","137899694","137900012","chr4","73167237","73167550","48","64732457"
"chr3","137939483","137939596","chr9","91909520","91909629","15","46029963"
"chr3","137983919","137984217","chr4","73256521","73256823","41","64727398"
"chr3","138037205","138037403","chr4","73288913","73289122","33","64748292"
"chr3","138069084","138069244","chr7","6009067","6009222","30","132060017"
"chr3","138122847","138123147","chr13","81563788","81564080","62","56559059"
"chr3","138144787","138145069","chr4","73407608","73407886","44","64737179"
"chr3","138157247","138157423","chr12","121559906","121560083","34","16597341"
"chr3","138165704","138166004","chr4","73426551","73426852","34","64739153"
"chr3","138196299","138196471","chr3","58296999","58297170","34","79899300"
"chr3","138213673","138213795","chr4","73463953","73464076","9","64749720"
"chr3","138218868","138219140","chr4","73467725","73468001","38","64751143"
"chr3","138246939","138247222","chr4","73508076","73508371","47","64738863"
"chr3","138260964","138261255","chr4","73511095","73511401","56","64749869"
"chr3","138291959","138292249","chr4","73547893","73548206","75","64744066"
"chr3","138349068","138349381","chr4","73609302","73609597","52","64739766"
"chr3","138362985","138363286","chr4","73620389","73620685","53","64742596"
"chr3","138404494","138404618","chr4","73679304","73679429","15","64725190"
"chr3","138446980","138447025","chr17","20548496","20548538","11","117898484"
"chr3","138475442","138475747","chr4","73738461","73738749","50","64736981"
"chr3","138513261","138513520","chr7","2330840","2331092","55","136182421"
"chr3","138526144","138526276","chr4","73804561","73804693","20","64721583"
"chr3","138536078","138536351","chr4","73814082","73814378","55","64721996"
"chr3","138651899","138652088","chr11","44694637","44694827","46","93957262"
"chr3","138707853","138707927","chr16","75373235","75373308","20","63334618"
"chr3","138708024","138708075","chr4","153305910","153305962","13","14597886"
"chr3","138708321","138708476","chr7","130371217","130371368","30","8337104"
"chr3","138948160","138948452","chr4","74146428","74146737","62","64801732"
"chr3","138963292","138963431","chr4","74161249","74161380","24","64802043"
"chr3","139037189","139037328","chr4","74232115","74232256","17","64805074"
"chr3","139096324","139096610","chr4","74298343","74298639","50","64797981"
"chr3","139192935","139193068","chr19","755242","755381","37","138437693"
"chr3","139194406","139194695","chr4","74398419","74398728","49","64795987"
"chr3","139213795","139214015","chr19","49970880","49971100","67","89242915"
"chr3","139258195","139258515","chr4","74440033","74440356","53","64818162"
"chr3","139288131","139288421","chr4","74466295","74466566","39","64821836"
"chr3","139334392","139334705","chr4","74510465","74510774","37","64823927"
"chr3","139343730","139344039","chr4","74520429","74520743","47","64823301"
"chr3","139372664","139372907","chr5","110284799","110285036","47","29087865"
"chr3","139390440","139390730","chrX","118718918","118719200","65","20671522"
"chr3","139394766","139395070","chr4","74572451","74572763","44","64822315"
"chr3","139404572","139404852","chr4","74581477","74581748","47","64823095"
"chr3","139451988","139452149","chr4","74626841","74627000","21","64825147"
"chr3","139469554","139469701","chr7","65275713","65275860","35","74193841"
"chr3","139540059","139540135","chr15","19199587","19199665","19","120340472"
"chr3","139580124","139580378","chr7","75838225","75838477","70","63741899"
"chr3","139706942","139707211","chr4","74913879","74914152","43","64793063"
"chr3","139842510","139842737","chr4","75076070","75076325","59","64766440"
"chr3","139921134","139921427","chr4","75152621","75152923","33","64768513"
"chr3","139922347","139922591","chr4","75153830","75154099","53","64768517"
"chr3","139929863","139930157","chr1","94087392","94087679","67","45842471"
"chr3","139970335","139970593","chr1","128541751","128542014","56","11428584"
"chr3","139998736","139999052","chr4","75243444","75243754","43","64755292"
"chr3","140037256","140037513","chr19","31483985","31484243","68","108553271"
"chr3","140128324","140128559","chr17","21575490","21575709","62","118552834"
"chr3","140152359","140152651","chr4","75386617","75386914","42","64765742"
"chr3","140216142","140216428","chr7","57543825","57544133","70","82672317"
"chr3","140241175","140241472","chr4","75466482","75466749","67","64774693"
"chr3","140271903","140272023","chr10","12230370","12230493","25","128041533"
"chr3","140309053","140309358","chr4","75527705","75528009","34","64781348"
"chr3","140334253","140334365","chr4","75570918","75571033","17","64763335"
"chr3","140407721","140408010","chr4","75652494","75652770","33","64755227"
"chr3","140563467","140563589","chr10","25313308","25313429","26","115250159"
"chr3","140610385","140610667","chr4","75875835","75876122","36","64734550"
"chr3","140622530","140622814","chr4","75888770","75889076","47","64733760"
"chr3","140728381","140728668","chr4","76013100","76013386","33","64715281"
"chr3","140731335","140731637","chr6","138561723","138562025","67","2169612"
"chr3","140762672","140762786","chr3","131690026","131690140","17","9072646"
"chr3","140774117","140774266","chr3","74033646","74033790","31","66740471"
"chr3","140828159","140828439","chr4","76134785","76135080","57","64693374"
"chr3","140834309","140834603","chr4","76140900","76141219","58","64693409"
"chr3","140840442","140840739","chr4","40329871","40330153","75","100510571"
"chr3","140842590","140842821","chr1","15109565","15109784","57","125733025"
"chr3","140842830","140843133","chr18","32942280","32942575","62","107900550"
"chr3","140892005","140892069","chr10","13656722","13656785","19","127235283"
"chr3","140892388","140892516","chr4","76197283","76197408","20","64695105"
"chr3","140970478","140970637","chr6","12560219","12560368","45","128410259"
"chr3","140984415","140984701","chr3","143449072","143449369","64","2464657"
"chr3","141104230","141104389","chr2B","27751482","27751639","33","113352748"
"chr3","141154718","141155012","chr10","132107490","132107786","61","9047228"
"chr3","141449146","141449443","chr16","30950078","30950376","74","110499068"
"chr3","141469790","141470013","chr5","41150341","41150568","56","100319449"
"chr3","141521407","141521687","chr7","79261257","79261554","73","62260150"
"chr3","141720756","141721043","chr4","48888862","48889131","47","92831894"
"chr3","141774423","141774709","chr6","108244210","108244502","58","33530213"
"chr3","141807695","141807812","chr8","77616166","77616282","18","64191529"
"chr3","141810173","141810467","chr14","44842497","44842783","60","96967676"
"chr3","141811612","141811742","chr1","181726088","181726220","29","39914476"
"chr3","141844647","141844929","chr4","48789406","48789686","24","93055241"
"chr3","141847303","141847478","chr2B","99098487","99098651","46","42748816"
"chr3","141847968","141848106","chr10","30690604","30690743","24","111157364"
"chr3","141874923","141875219","chr1","118602336","118602628","59","23272587"
"chr3","141902196","141902284","chr12","107949202","107949292","17","33952994"
"chr3","141926040","141926285","chr4","48689159","48689440","65","93236881"
"chr3","141929967","141930246","chr4","48685359","48685642","56","93244608"
"chr3","141951770","141951876","chr9","91909520","91909629","25","50042250"
"chr3","141957463","141957675","chr4","48659928","48660144","44","93297535"
"chr3","141965876","141966178","chr4","48650875","48651179","61","93315001"
"chr3","141976178","141976459","chr4","48638071","48638341","41","93338107"
"chr3","142006697","142006996","chr4","48603524","48603825","24","93403173"
"chr3","142014606","142014899","chr4","48597985","48598276","28","93416621"
"chr3","142017378","142017633","chr3","80419615","80419872","63","61597763"
"chr3","142032189","142032476","chr4","24808117","24808398","55","117224072"
"chr3","142163321","142163500","chr7","139141055","139141227","46","3022266"
"chr3","142180373","142180664","chr4","48442309","48442620","47","93738064"
"chr3","142240946","142241100","chr14","10155920","10156077","35","132085026"
"chr3","142284411","142284527","chr10","88748074","88748188","21","53536337"
"chr3","142284814","142284957","chrX","47447396","47447553","40","94837418"
"chr3","142321256","142321380","chr4","48308663","48308790","11","94012593"
"chr3","142364963","142365154","chr6","117317944","117318126","55","25047019"
"chr3","142368391","142368574","chr19","11965647","11965835","48","130402744"
"chr3","142374628","142374756","chr4","48257209","48257333","15","94117419"
"chr3","142398183","142398490","chr12","117299455","117299756","59","25098728"
"chr3","142448355","142448616","chr4","48205189","48205436","60","94243166"
"chr3","142515509","142515831","chr4","48137472","48137798","33","94378037"
"chr3","142571010","142571297","chr14","72146188","72146466","66","70424822"
"chr3","142571887","142572138","chr3","135079534","135079772","56","7492353"
"chr3","142574005","142574302","chr4","48083262","48083568","28","94490743"
"chr3","142653639","142653745","chr18","48326419","48326520","31","94327220"
"chr3","142716668","142716941","chr10","132224847","132225125","57","10491821"
"chr3","142737713","142737996","chr4","47906920","47907202","46","94830793"
"chr3","142740024","142740269","chr16","30452822","30453066","60","112287202"
"chr3","142761852","142762060","chr18","12205066","12205280","39","130556786"
"chr3","142844942","142845223","chr4","47774936","47775224","40","95070006"
"chr3","142856472","142856763","chr4","47763831","47764110","45","95092641"
"chr3","142885518","142885816","chr4","47735688","47736000","53","95149830"
"chr3","143095487","143095661","chr12","8768282","8768448","39","134327205"
"chr3","143100211","143100341","chr4","47541444","47541571","17","95558767"
"chr3","143190119","143190379","chr1","94618535","94618785","65","48571584"
"chr3","143348768","143349065","chr4","47282422","47282716","29","96066346"
"chr3","143373153","143373454","chr3","135967906","135968198","72","7405247"
"chr3","143617837","143618156","chr4","47010398","47010705","50","96607439"
"chr3","143644282","143644576","chr12","93822981","93823269","74","49821301"
"chr3","143645546","143645831","chr4","46986446","46986740","42","96659100"
"chr3","143765682","143765821","chr10","118317144","118317270","29","25448538"
"chr3","143796273","143796542","chr4","46873222","46873486","43","96923051"
"chr3","144485264","144485565","chr4","46111008","46111319","55","98374256"
"chr3","144735691","144735826","chr5","32957444","32957578","33","111778247"
"chr3","144805318","144805483","chr5","62239275","62239449","43","82566043"
"chr3","145130909","145131163","chr4","45467412","45467671","33","99663497"
"chr3","145226689","145226826","chr8","9901944","9902090","46","135324745"
"chr3","145813058","145813162","chr4","44826866","44826985","21","100986192"
"chr3","145813795","145813946","chr4","44826407","44826566","31","100987388"
"chr3","146024674","146024956","chr4","44613069","44613360","50","101411605"
"chr3","146088463","146088640","chr4","44536641","44536836","43","101551822"
"chr3","146246649","146246856","chr3","129669467","129669677","57","16577182"
"chr3","146478825","146479126","chr4","44170857","44171142","63","102307968"
"chr3","146508718","146508858","chr20","61211065","61211200","38","85297653"
"chr3","146510078","146510386","chr19","52912701","52913012","63","93597377"
"chr3","146516024","146516333","chr4","44122360","44122665","47","102393664"
"chr3","146686138","146686296","chr5","80666348","80666508","35","66019790"
"chr3","146686399","146686460","chr4","171574356","171574418","16","24887957"
"chr3","146790000","146790277","chr4","43823862","43824169","61","102966138"
"chr3","147155175","147155341","chrX","5284798","5284967","39","141870377"
"chr3","147293680","147293971","chr4","43246277","43246561","48","104047403"
"chr3","147503577","147503851","chr4","43463396","43463672","34","104040181"
"chr3","147720666","147720897","chr2B","114500886","114501110","59","33219780"
"chr3","148232408","148232711","chr4","42393064","42393370","54","105839344"
"chr3","148276657","148276972","chr6","20689530","20689838","68","127587127"
"chr3","148319165","148319481","chr8","95718365","95718676","74","52600800"
"chr3","148439406","148439523","chr4","42184384","42184500","20","106255022"
"chr3","148446737","148446992","chr5","57566902","57567164","62","90879835"
"chr3","148482749","148483024","chr4","42133905","42134189","36","106348844"
"chr3","148484726","148484855","chr3","49127558","49127687","26","99357168"
"chr3","148493387","148493658","chr1","6140515","6140798","69","142352872"
"chr3","148523732","148524024","chr4","42114143","42114456","40","106409589"
"chr3","148559143","148559446","chr4","42076516","42076810","46","106482627"
"chr3","148563079","148563289","chr10","139464258","139464467","45","9098821"
"chr3","148653556","148653848","chr4","42000575","42000871","39","106652981"
"chr3","148655514","148655781","chr4","41998442","41998736","42","106657072"
"chr3","148676151","148676453","chr4","41979465","41979779","58","106696686"
"chr3","148677445","148677727","chr4","41978078","41978359","28","106699367"
"chr3","148749000","148749282","chr2B","99151631","99151918","67","49597369"
"chr3","148772579","148772879","chr4","41877707","41878002","56","106894872"
"chr3","148780038","148780313","chr4","41868984","41869270","33","106911054"
"chr3","148785281","148785580","chr7","76523012","76523308","60","72262269"
"chr3","148827178","148827459","chr18","20249356","20249636","56","128577822"
"chr3","148861701","148861998","chr8","22481999","22482294","72","126379702"
"chr3","148872252","148872547","chr4","41781941","41782233","33","107090311"
"chr3","148900113","148900396","chr4","41749222","41749507","34","107150891"
"chr3","148943509","148943582","chr7","72323128","72323205","13","76620381"
"chr3","148962329","148962607","chr1","62692578","62692858","72","86269751"
"chr3","149001264","149001431","chr5","6383321","6383494","35","142617943"
"chr3","149061005","149061129","chr5","165196444","165196568","26","16135439"
"chr3","149061190","149061373","chr13","5786923","5787096","40","143274267"
"chr3","149137191","149137306","chr1","65862925","65863041","23","83274266"
"chr3","149214745","149215056","chr4","41424732","41425057","42","107790013"
"chr3","149327789","149328068","chr4","41315472","41315765","48","108012317"
"chr3","149401787","149402069","chr4","41250322","41250604","34","108151465"
"chr3","149438158","149438281","chr4","41210073","41210197","14","108228085"
"chr3","149464257","149464556","chr4","41178008","41178328","48","108286249"
"chr3","149470050","149470345","chr2B","94932795","94933081","53","54537255"
"chr3","149477217","149477458","chr4","41166281","41166533","50","108310936"
"chr3","149483554","149483784","chr4","41160141","41160366","33","108323413"
"chr3","149484033","149484089","chr4","171500441","171500495","13","22016408"
"chr3","149504688","149504987","chr4","41150346","41150651","39","108354342"
"chr3","149588397","149588689","chr4","41073702","41073991","42","108514695"
"chr3","149636044","149636163","chr6","154239364","154239482","26","4603320"
"chr3","149671583","149671889","chr18","4359369","4359662","68","145312214"
"chr3","149685647","149686034","chr4","40992786","40993134","102","108692861"
"chr3","149743431","149743598","chr17","4104875","4105033","48","145638556"
"chr3","149783066","149783368","chr4","40880946","40881274","53","108902120"
"chr3","149811249","149811381","chr1","44892994","44893123","22","104918255"
"chr3","149822766","149823035","chr4","40846661","40846935","51","108976105"
"chr3","149857645","149857911","chr4","40808382","40808679","58","109049263"
"chr3","149861432","149861526","chr1","157737408","157737505","17","7875976"
"chr3","149861629","149861902","chr4","40804737","40805021","39","109056892"
"chr3","149861919","149862052","chr4","40804574","40804736","41","109057345"
"chr3","149863356","149863664","chr4","40802555","40802866","52","109060801"
"chr3","149899097","149899374","chr4","40768254","40768549","57","109130843"
"chr3","149955921","149956211","chr4","40713074","40713383","51","109242847"
"chr3","149974463","149974565","chr10","11937949","11938048","18","138036514"
"chr3","149996116","149996231","chr6","25416407","25416521","21","124579709"
"chr3","150037999","150038285","chr20","34469467","34469750","62","115568532"
"chr3","150052353","150052520","chr19","15955029","15955193","30","134097324"
"chr3","150081255","150081533","chr4","40603006","40603286","26","109478249"
"chr3","150088247","150088523","chr12","110096929","110097208","56","39991318"
"chr3","150091312","150091604","chr4","40590109","40590405","49","109501203"
"chr3","150115442","150115757","chr4","40554169","40554447","69","109561273"
"chr3","150185808","150185914","chr3","88784173","88784279","21","61401635"
"chr3","150190524","150190788","chr7","2592743","2593011","60","147597781"
"chr3","150194284","150194570","chr1","130048013","130048302","53","20146271"
"chr3","150220865","150220982","chr10","93040219","93040335","16","57180646"
"chr3","150234103","150234376","chr3","77257064","77257337","61","72977039"
"chr3","150258048","150258254","chr3","46351841","46352049","48","103906207"
"chr3","150267639","150267759","chr7","69849325","69849449","19","80418314"
"chr3","150270849","150271147","chr4","40401228","40401536","36","109869621"
"chr3","150281582","150281890","chr16","23608253","23608564","59","126673329"
"chr3","150291041","150291330","chr4","40381032","40381339","48","109910009"
"chr3","150299960","150300077","chr1","129462012","129462130","16","20837948"
"chr3","150331889","150332157","chr2A","97057312","97057598","57","53274577"
"chr3","150352303","150352573","chr15","59556607","59556877","67","90795696"
"chr3","150368522","150368615","chr6","18535653","18535731","30","131832869"
"chr3","150369416","150369548","chr19","4857121","4857252","20","145512295"
"chr3","150390032","150390110","chr1","226874011","226874096","25","76483979"
"chr3","150393460","150393741","chr5","125523460","125523742","67","24870000"
"chr3","150416803","150416967","chr7","151692218","151692384","29","1275415"
"chr3","150511088","150511329","chrX","1328529","1328783","59","149182559"
"chr3","150517928","150518177","chr4","40144786","40145035","19","110373142"
"chr3","150533560","150533684","chr4","5441032","5441154","21","145092528"
"chr3","150548357","150548453","chr6","121255312","121255398","27","29293045"
"chr3","150554280","150554580","chr4","40109694","40110004","54","110444586"
"chr3","150648312","150648605","chr7","76041457","76041753","57","74606855"
"chr3","150655520","150655761","chr3","20312727","20312956","54","130342793"
"chr3","150661027","150661150","chr7","140174758","140174882","20","10486269"
"chr3","150704464","150704680","chr10","89679604","89679810","44","61024860"
"chr3","150721018","150721171","chr4","181479263","181479409","49","30758245"
"chr3","150721274","150721509","chr10","37439324","37439560","47","113281950"
"chr3","150765316","150765439","chr4","1726627","1726733","36","149038689"
"chr3","150783112","150783386","chr4","39890506","39890810","60","110892606"
"chr3","150792535","150792809","chr2A","97348280","97348542","61","53444255"
"chr3","150794127","150794241","chr4","39880797","39880914","18","110913330"
"chr3","150800106","150800204","chr1","134242923","134243019","18","16557183"
"chr3","150801149","150801358","chr4","39873336","39873547","30","110927813"
"chr3","150865084","150865274","chr3","46315863","46316044","48","104549221"
"chr3","150871478","150871788","chr3","108852137","108852440","66","42019341"
"chr3","150874572","150874883","chr12","43802996","43803296","62","107071576"
"chr3","150876515","150876750","chr9","109298485","109298719","50","41578030"
"chr3","150892006","150892122","chr5","52418630","52418747","20","98473376"
"chr3","150895679","150895951","chr10","118276529","118276820","70","32619150"
"chr3","150901272","150901495","chrX","39568727","39568951","59","111332545"
"chr3","150951240","150951525","chr14","88115223","88115518","76","62836017"
"chr3","150956513","150956819","chr4","15717164","15717461","73","135239349"
"chr3","150967247","150967548","chr4","39702931","39703227","53","111264316"
"chr3","150991040","150991089","chr4","39681738","39681791","11","111309302"
"chr3","150991144","150991253","chr1","130349691","130349809","20","20641453"
"chr3","150991867","150992141","chr4","39680567","39680869","60","111311300"
"chr3","151012429","151012719","chr4","39661354","39661662","69","111351075"
"chr3","151048894","151049182","chr15","44104450","44104739","57","106944444"
"chr3","151051619","151051752","chr1","17368221","17368352","30","133683398"
"chr3","151069149","151069472","chr2B","117230826","117231147","78","33838323"
"chr3","151085329","151085444","chr9","92012130","92012241","29","59073199"
"chr3","151095291","151095485","chr1","24174788","24174998","50","126920503"
"chr3","151100316","151100591","chr1","207780432","207780714","72","56680116"
"chr3","151110319","151110490","chr7","74780134","74780307","30","76330185"
"chr3","151113881","151113990","chr4","39553645","39553754","17","111560236"
"chr3","151122476","151122626","chr3","187425335","187425481","36","36302859"
"chr3","151143348","151143470","chr3","65193379","65193500","23","85949969"
"chr3","151157507","151157657","chr22","8436942","8437088","21","142720565"
"chr3","151157714","151157838","chr4","39512792","39512909","22","111644922"
"chr3","151165960","151166069","chr5","22128933","22129035","23","129037027"
"chr3","151196214","151196516","chr4","39462416","39462704","41","111733798"
"chr3","151200404","151200663","chr4","39458067","39458356","60","111742337"
"chr3","151212771","151213021","chr4","39435903","39436153","34","111776868"
"chr3","151219383","151219527","chr2B","125176369","125176510","33","26043014"
"chr3","151220572","151220666","chr5","38734073","38734175","18","112486499"
"chr3","151236452","151236779","chrX","47676937","47677248","71","103559515"
"chr3","151239411","151239546","chr4","39402464","39402586","22","111836947"
"chr3","151246906","151247018","chr6","18901462","18901559","41","132345444"
"chr3","151250594","151250870","chr17","9721401","9721681","63","141529193"
"chr3","151262252","151262388","chr11","62991394","62991536","32","88270858"
"chr3","151273876","151274010","chr3","184961336","184961471","22","33687460"
"chr3","151274805","151274952","chr8","86297324","86297472","31","64977481"
"chr3","151288061","151288226","chr20","44858230","44858390","33","106429831"
"chr3","151288995","151289079","chr1","133357926","133358010","14","17931069"
"chr3","151299156","151299439","chrX","9466026","9466312","63","141833130"
"chr3","151304996","151305268","chr4","39347843","39348135","48","111957153"
"chr3","151308838","151308974","chr7","64409802","64409935","32","86899036"
"chr3","151327315","151327609","chr4","39319761","39320069","49","112007554"
"chr3","151329129","151329420","chr7","6325681","6325971","57","145003448"
"chr3","151333341","151333649","chr1","183759641","183759940","66","32426300"
"chr3","151373091","151373188","chr2B","16451102","16451202","16","134921989"
"chr3","151374366","151374600","chr3","126229807","126230045","61","25144559"
"chr3","151416150","151416239","chr7","74838508","74838593","26","76577642"
"chr3","151416347","151416476","chr1","199445143","199445271","26","48028796"
"chr3","151416556","151416724","chr7","79675726","79675893","32","71740830"
"chr3","151421515","151421794","chr4","39175494","39175788","39","112246021"
"chr3","151441447","151441529","chr14","33005125","33005208","17","118436322"
"chr3","151441588","151441787","chr6","5000449","5000640","50","146441139"
"chr3","151549198","151549304","chr1","91527692","91527800","24","60021506"
"chr3","151553117","151553238","chr7","44128291","44128409","22","107424826"
"chr3","151553361","151553683","chr12","109302239","109302561","82","42251122"
"chr3","151556110","151556396","chr1","91059171","91059456","67","60496939"
"chr3","151559119","151559414","chr4","38995105","38995403","30","112564014"
"chr3","151576036","151576132","chr7","150610740","150610823","26","965296"
"chr3","151576226","151576381","chr4","195577197","195577355","37","44000971"
"chr3","151634000","151634133","chr5","43443514","43443643","30","108190486"
"chr3","151634135","151634248","chr15","46133130","46133239","19","105501005"
"chr3","151634615","151634640","chr19","11241455","11241481","5","140393160"
"chr3","151643643","151643757","chr4","38896093","38896209","12","112747550"
"chr3","151668588","151668662","chr12","118378111","118378184","11","33290477"
"chr3","151669517","151669829","chr1","191946453","191946748","73","40276936"
"chr3","151679602","151679849","chr1","206480269","206480516","58","54800667"
"chr3","151692929","151693220","chr5","129980112","129980378","78","21712817"
"chr3","151708401","151708696","chr4","38839053","38839370","56","112869348"
"chr3","151759274","151759593","chr5","23931488","23931783","83","127827786"
"chr3","151778827","151779115","chr4","38779522","38779796","45","112999305"
"chr3","151786324","151786613","chr4","38777134","38777427","34","113009190"
"chr3","151822752","151823039","chr4","38735855","38736142","25","113086897"
"chr3","151836143","151836270","chr1","114541144","114541275","35","37294999"
"chr3","151858422","151858502","chr4","38669203","38669283","14","113189219"
"chr3","151930205","151930501","chr4","38610487","38610783","38","113319718"
"chr3","152002743","152003030","chr4","38530536","38530834","44","113472207"
"chr3","152046768","152046892","chr4","38498509","38498633","13","113548259"
"chr3","152101172","152101438","chr4","38449951","38450237","56","113651221"
"chr3","152226994","152227310","chr10","14639437","14639745","70","137587557"
"chr3","152279750","152280065","chr18","8656938","8657231","82","143622812"
"chr3","152317419","152317716","chr4","38248395","38248706","46","114069024"
"chr3","152333567","152333853","chr4","38233462","38233750","72","114100105"
"chr3","152347969","152348179","chr4","38220414","38220639","39","114127555"
"chr3","152362706","152363028","chr1","11039400","11039714","73","141323306"
"chr3","152412493","152412815","chr13","33357085","33357414","80","119055408"
"chr3","152432412","152432666","chr4","88755873","88756114","70","63676539"
"chr3","152588803","152588933","chr6","138997396","138997527","22","13591407"
"chr3","152624228","152624396","chr5","62885644","62885808","43","89738584"
"chr3","152630067","152630342","chr8","85193362","85193643","62","67436705"
"chr3","152643745","152644016","chr4","37911714","37912000","55","114732031"
"chr3","152787537","152787817","chr8","42418111","42418386","61","110369426"
"chr3","152888158","152888458","chr3","115521794","115522100","59","37366364"
"chr3","152914211","152914351","chr20","32123638","32123783","28","120790573"
"chr3","152920421","152920674","chr4","37645599","37645865","51","115274822"
"chr3","153101104","153101360","chr4","169077403","169077661","49","15976299"
"chr3","153106814","153107085","chr6","42450473","42450747","58","110656341"
"chr3","153130113","153130225","chr8","145313247","145313365","18","7816866"
"chr3","153190815","153191111","chr4","37373092","37373388","49","115817723"
"chr3","153202406","153202702","chr4","37361707","37362003","40","115840699"
"chr3","153215807","153216106","chr4","37345961","37346230","53","115869846"
"chr3","153216555","153216870","chr4","37344583","37344908","43","115871972"
"chr3","153252035","153252165","chr5","22981936","22982065","22","130270099"
"chr3","153637919","153638023","chr13","9559854","9559959","15","144078065"
"chr3","153882461","153882584","chr4","36668873","36668996","14","117213588"
"chr3","153942250","153942513","chr6","13888874","13889142","73","140053376"
"chr3","153989261","153989404","chr20","4922306","4922451","41","149066955"
"chr3","154120458","154120746","chr4","36401005","36401283","60","117719453"
"chr3","154407009","154407132","chr6","106910886","106911009","22","47496123"
"chr3","154463696","154463833","chr6","36782155","36782293","36","117681541"
"chr3","154609787","154609908","chr10","90957398","90957520","17","63652389"
"chr3","154659650","154659954","chr4","35821645","35821930","51","118838005"
"chr3","154794365","154794531","chr19","43910784","43910948","36","110883581"
"chr3","154873777","154873848","chr1","185716354","185716426","16","30842577"
"chr3","154917341","154917599","chr4","35565823","35566103","54","119351518"
"chr3","154989763","154990027","chr2A","89011734","89011984","78","65978029"
"chr3","155053852","155053943","chr4","35407890","35407987","15","119645962"
"chr3","155139050","155139334","chr9","107980608","107980898","79","47158442"
"chr3","155395874","155396154","chr6","100933140","100933423","78","54462734"
"chr3","155714465","155714681","chr4","34764947","34765165","23","120949518"
"chr3","155912549","155912628","chr6","107993043","107993126","19","47919506"
"chr3","156015037","156015105","chr2A","45130084","45130152","15","110884953"
"chr3","156015153","156015290","chr1","46271276","46271424","36","109743877"
"chr3","156091254","156091369","chr22","14821499","14821616","18","141269755"
"chr3","156258319","156258582","chr3","47797843","47798091","71","108460476"
"chr3","156379376","156379667","chr1","79147904","79148202","71","77231472"
"chr3","156392996","156393101","chr7","66699501","66699609","26","89693495"
"chr3","156775243","156775489","chr4","33760810","33761042","40","123014433"
"chr3","156843564","156843839","chr1","38001876","38002160","66","118841688"
"chr3","156856647","156856768","chr5","133578375","133578499","34","23278272"
"chr3","156857360","156857538","chr3","197361022","197361208","48","40503662"
"chr3","156906477","156906614","chr3","155574758","155574899","40","1331719"
"chr3","156946166","156946277","chr19","46547524","46547634","34","110398642"
"chr3","156990278","156990440","chr4","33549432","33549601","45","123440846"
"chr3","157074611","157074735","chr4","33456029","33456153","14","123618582"
"chr3","157129328","157129580","chr3","37559200","37559458","78","119570128"
"chr3","157296937","157297235","chr4","33236965","33237285","59","124059972"
"chr3","157319073","157319353","chr21","35390505","35390778","65","121928568"
"chr3","157401701","157401986","chr8","55053392","55053685","77","102348309"
"chr3","157413131","157413347","chr8","100864437","100864645","57","56548694"
"chr3","157440757","157441028","chr2A","64538464","64538725","71","92902293"
"chr3","157569605","157569912","chr4","32982612","32982911","58","124586993"
"chr3","157795285","157795563","chr4","32728939","32729198","66","125066346"
"chr3","157892077","157892324","chr4","32638188","32638451","50","125253889"
"chr3","157893641","157893751","chr18","44478146","44478256","19","113415495"
"chr3","157970126","157970325","chr1","224283143","224283338","50","66313017"
"chr3","158033157","158033431","chr4","32499748","32500000","52","125533409"
"chr3","158766642","158766911","chr4","31809995","31810296","60","126956647"
"chr3","158966528","158966839","chr4","31632133","31632443","36","127334395"
"chr3","159650266","159650528","chr8","125241774","125242030","73","34408492"
"chr3","159664972","159665232","chr4","30897006","30897287","49","128767966"
"chr3","159684108","159684352","chr4","30881460","30881716","61","128802648"
"chr3","159893153","159893443","chr4","30660283","30660576","37","129232870"
"chr3","160019123","160019350","chr4","30536620","30536849","22","129482503"
"chr3","160060879","160061176","chr4","30495203","30495507","61","129565676"
"chr3","160062091","160062371","chr4","30493961","30494256","42","129568130"
"chr3","160111026","160111320","chr4","30451869","30452161","48","129659157"
"chr3","160691218","160691522","chr7","66774175","66774478","73","93917043"
"chr3","160811981","160812222","chr4","29765809","29766051","35","131046172"
"chr3","160943909","160944108","chr16","40258919","40259124","54","120684990"
"chr3","161081505","161081791","chr7","4993615","4993907","73","156087890"
"chr3","161157716","161157844","chr10","12650705","12650831","32","148507011"
"chr3","161380961","161381255","chr4","29124387","29124685","62","132256574"
"chr3","161503369","161503655","chr8","59850782","59851072","52","101652587"
"chr3","161554448","161554745","chr4","28967775","28968073","69","132586673"
"chr3","161722425","161722722","chr4","28811742","28812023","48","132910683"
"chr3","161762354","161762476","chr9","16418719","16418847","36","145343635"
"chr3","161907259","161907379","chr16","40500610","40500729","32","121406649"
"chr3","161922642","161922906","chr4","28610852","28611130","62","133311790"
"chr3","162214558","162214862","chr12","113369447","113369739","74","48845111"
"chr3","162562993","162563126","chr22","24326066","24326200","22","138236927"
"chr3","162743212","162743515","chr4","27829742","27830071","67","134913470"
"chr3","162777488","162777581","chr1","113839333","113839427","20","48938155"
"chr3","162779506","162779652","chr12","94617715","94617852","30","68161791"
"chr3","163109686","163109827","chr1","52325310","52325464","34","110784376"
"chr3","163308591","163308879","chr4","27291391","27291680","32","136017200"
"chr3","163311868","163311979","chr1","39325820","39325928","19","123986048"
"chr3","163419733","163420012","chr4","27189714","27190021","63","136230019"
"chr3","163524822","163525121","chr4","27116246","27116556","41","136408576"
"chr3","163530321","163530619","chr4","27110938","27111241","49","136419383"
"chr3","163545923","163546173","chr4","27089848","27090121","49","136456075"
"chr3","163605599","163605900","chr4","27059431","27059725","42","136546168"
"chr3","163634805","163635067","chr4","27037729","27037994","40","136597076"
"chr3","163713314","163713603","chr4","26933240","26933533","41","136780074"
"chr3","163972311","163972505","chrX","53628878","53629071","43","110343433"
"chr3","163972536","163972651","chr11","32300724","32300838","17","131671812"
"chr3","164017851","164017983","chr12","37490064","37490192","21","126527787"
"chr3","164067669","164067793","chr8","129441534","129441654","20","34626135"
"chr3","164079445","164079729","chr4","26579885","26580168","42","137499560"
"chr3","164217054","164217346","chr14","76943072","76943349","60","87273982"
"chr3","164254618","164254920","chr4","26384521","26384824","34","137870097"
"chr3","164447679","164447966","chr4","26167109","26167386","42","138280570"
"chr3","164475721","164475901","chr8","21554359","21554548","55","142921362"
"chr3","164503230","164503532","chr4","26114795","26115094","42","138388435"
"chr3","164539840","164540138","chr4","26079527","26079832","44","138460313"
"chr3","164603382","164603498","chr4","26015770","26015887","8","138587612"
"chr3","164621152","164621287","chr19","37785588","37785721","24","126835564"
"chr3","164650935","164651220","chr4","25961102","25961409","51","138689833"
"chr3","164662463","164662734","chr4","25951712","25951976","43","138710751"
"chr3","164674629","164674883","chr3","9092860","9093120","67","155581769"
"chr3","164678611","164678859","chr4","116886659","116886911","58","47791952"
"chr3","164699564","164699847","chr7","72183402","72183682","70","92516162"
"chr3","164711167","164711462","chr4","25898442","25898757","58","138812725"
"chr3","164721797","164722114","chr4","25888257","25888584","59","138833540"
"chr3","164734354","164734433","chr1","203147520","203147598","21","38413166"
"chr3","164734464","164734719","chr2A","1849325","1849582","60","162885139"
"chr3","164736792","164737076","chrX","48281662","48281943","59","116455130"
"chr3","164779601","164779688","chr20","2859616","2859698","16","161919985"
"chr3","164785634","164785734","chr18","48326419","48326520","22","116459215"
"chr3","164786124","164786226","chr3","65778113","65778219","23","99008011"
"chr3","164867948","164868240","chr4","25739237","25739553","56","139128711"
"chr3","164913325","164913525","chr4","25696022","25696243","46","139217303"
"chr3","164952377","164952696","chr4","25657269","25657556","69","139295108"
"chr3","164983748","164984035","chr19","39824594","39824884","58","125159154"
"chr3","165041256","165041571","chr4","25577651","25577939","56","139463605"
"chr3","165050943","165051230","chr4","25568507","25568805","56","139482436"
"chr3","165056580","165056867","chr4","25562351","25562654","47","139494229"
"chr3","165070743","165071040","chr4","25549819","25550106","44","139520924"
"chr3","165092440","165092729","chr4","25527811","25528088","49","139564629"
"chr3","165138351","165138625","chr4","25482957","25483234","67","139655394"
"chr3","165144635","165144938","chr4","25477341","25477660","49","139667294"
"chr3","165168299","165168436","chr6","18588428","18588554","35","146579871"
"chr3","165168881","165168973","chr1","22458308","22458399","16","142710573"
"chr3","165188989","165189274","chr4","25433355","25433620","63","139755634"
"chr3","165212373","165212445","chr12","118378111","118378184","8","46834262"
"chr3","165236995","165237287","chr12","901136","901435","61","164335859"
"chr3","165358473","165358771","chr2A","79717022","79717315","50","85641451"
"chr3","165371541","165371695","chr2B","71832618","71832771","39","93538923"
"chr3","165379391","165379668","chr4","25280731","25281041","54","140098660"
"chr3","165390550","165390704","chr2B","71832618","71832771","42","93557932"
"chr3","165408536","165408817","chr4","25280731","25281041","56","140127805"
"chr3","165472854","165473103","chr4","25230933","25231200","51","140241921"
"chr3","165477317","165477619","chr5","4073876","4074174","67","161403441"
"chr3","165483403","165483601","chr4","25220517","25220722","51","140262886"
"chr3","165493848","165493961","chr12","110132732","110132848","18","55361116"
"chr3","165495215","165495506","chr4","25207511","25207808","51","140287704"
"chr3","165516799","165517060","chr4","25184478","25184748","46","140332321"
"chr3","165540098","165540221","chr1","94267470","94267597","29","71272628"
"chr3","165559586","165559747","chr10","49585047","49585201","38","115974539"
"chr3","165583116","165583399","chr4","25127477","25127765","57","140455639"
"chr3","165586389","165586454","chr8","28408889","28408956","11","137177500"
"chr3","165609229","165609375","chr1","148219593","148219735","38","17389636"
"chr3","165651583","165651913","chr6","4964540","4964849","95","160687043"
"chr3","165669886","165670171","chr13","6846267","6846552","61","158823619"
"chr3","165687653","165687806","chr19","5169265","5169417","33","160518388"
"chr3","165687813","165688106","chr10","90821089","90821368","67","74866724"
"chr3","165690923","165691158","chr4","25038554","25038796","45","140652369"
"chr3","165693734","165693918","chr8","78126042","78126225","39","87567692"
"chr3","165776254","165776529","chr2B","27065408","27065684","39","138710846"
"chr3","165836404","165836717","chr4","24903796","24904107","43","140932608"
"chr3","165848591","165848871","chr4","24888544","24888825","51","140960047"
"chr3","165861941","165862094","chr1","210449448","210449598","36","44587507"
"chr3","165862507","165862644","chrX","148647293","148647431","31","17215214"
"chr3","165876802","165877096","chr22","14043715","14044004","69","151833087"
"chr3","165883114","165883413","chr4","24851380","24851675","31","141031734"
"chr3","165889160","165889443","chr4","24836416","24836736","76","141052744"
"chr3","165918552","165918843","chr4","24796522","24796816","27","141122030"
"chr3","165920048","165920351","chr4","24794663","24794955","38","141125385"
"chr3","165930236","165930342","chrX","118338466","118338573","23","47591770"
"chr3","166087987","166088110","chr6","154239364","154239482","32","11848623"
"chr3","166088778","166089051","chr4","24606717","24607008","48","141482061"
"chr3","166094900","166095194","chr4","24635763","24636076","61","141459137"
"chr3","166167791","166168101","chr4","24559786","24560078","50","141608005"
"chr3","166182827","166183150","chr14","56469259","56469565","85","109713568"
"chr3","166326866","166327159","chr4","24396780","24397065","44","141930086"
"chr3","166348045","166348327","chr10","8078554","8078826","50","158269491"
"chr3","166355414","166355689","chr4","24373112","24373403","46","141982302"
"chr3","166586143","166586448","chr4","24157265","24157549","64","142428878"
"chr3","166599429","166599701","chr4","24143070","24143365","58","142456359"
"chr3","166636163","166636439","chr4","24106083","24106378","47","142530080"
"chr3","166668624","166668908","chr4","24070947","24071233","48","142597677"
"chr3","166701641","166701896","chr4","24039179","24039461","54","142662462"
"chr3","166707036","166707326","chr4","24033435","24033723","36","142673601"
"chr3","166734121","166734439","chr4","24006227","24006537","52","142727894"
"chr3","166768579","166768701","chr4","23972153","23972276","10","142796426"
"chr3","166840176","166840468","chr4","23894553","23894855","42","142945623"
"chr3","166885679","166885967","chr4","23853098","23853388","31","143032581"
"chr3","166956119","166956423","chr4","23782924","23783215","50","143173195"
"chr3","166998500","166998800","chr9","59827398","59827704","66","107171102"
"chr3","167085859","167086183","chr4","23663939","23664259","34","143421920"
"chr3","167234070","167234357","chr4","23517236","23517527","41","143716834"
"chr3","167313908","167314211","chr4","23436113","23436413","27","143877795"
"chr3","167430041","167430326","chr4","23313618","23313907","55","144116423"
"chr3","167459709","167460006","chr18","48130004","48130295","55","119329705"
"chr3","167469798","167470102","chr4","23268802","23269091","45","144200996"
"chr3","167478004","167478208","chr4","23262084","23262300","46","144215920"
"chr3","167490923","167491198","chr4","23247728","23248004","31","144243195"
"chr3","167552091","167552362","chr4","23174335","23174626","53","144377756"
"chr3","167755941","167756212","chr4","22977973","22978257","49","144777968"
"chr3","168161175","168161491","chr10","142141388","142141695","68","26019787"
"chr3","168635828","168636132","chr4","22110386","22110685","46","146525442"
"chr3","168649878","168650148","chr4","22096857","22097139","51","146553021"
"chr3","168679936","168680098","chr6","15264957","15265121","35","153414979"
"chr3","168684027","168684111","chr2B","9371450","9371533","14","159312577"
"chr3","168684620","168684815","chr14","76663130","76663317","50","92021490"
"chr3","168779370","168779665","chr12","121913892","121914192","60","46865478"
"chr3","168817525","168817804","chr4","21939297","21939579","40","146878228"
"chr3","168864039","168864313","chr4","21905302","21905594","40","146958737"
"chr3","169117980","169118178","chr9","13591023","13591225","50","155526957"
"chr3","169258193","169258297","chrX","137745880","137745982","27","31512313"
"chr3","169293566","169293719","chr14","57543403","57543552","33","111750163"
"chr3","169458896","169459176","chr3","122406432","122406720","66","47052464"
"chr3","169474587","169474699","chr7","76686264","76686381","28","92788323"
"chr3","169475050","169475169","chr14","60352578","60352701","36","109122472"
"chr3","169555993","169556103","chr13","9559854","9559959","27","159996139"
"chr3","169558641","169558968","chr4","21250226","21250555","39","148308415"
"chr3","169753769","169754058","chr4","6773427","6773719","58","162980342"
"chr3","169767586","169767884","chr4","21041586","21041887","38","148726000"
"chr3","169768468","169768738","chr12","108424118","108424383","59","61344350"
"chr3","169771185","169771498","chr4","21041586","21041887","50","148729599"
"chr3","169850103","169850403","chr4","20958947","20959240","51","148891156"
"chr3","170021553","170021626","chr4","20775943","20776015","13","149245610"
"chr3","170066426","170066724","chr7","104942328","104942627","59","65124098"
"chr3","170474306","170474414","chr17","63212955","63213066","32","107261351"
"chr3","170510923","170511035","chr20","46080183","46080300","24","124430740"
"chr3","170511547","170511693","chr10","127956492","127956637","35","42555055"
"chr3","170877855","170877977","chr4","19886786","19886908","13","150991069"
"chr3","170884281","170884496","chr4","72683822","72684028","59","98200459"
"chr3","170924198","170924486","chr4","19843444","19843714","59","151080754"
"chr3","171032524","171032773","chr4","19736752","19737001","37","151295772"
"chr3","171286376","171286604","chr6","32481328","32481546","58","138805048"
"chr3","171346895","171347180","chr4","19464099","19464393","43","151882796"
"chr3","171491108","171491387","chr4","19263313","19263595","58","152227795"
"chr3","171681338","171681604","chr6","18531346","18531609","60","153149992"
"chr3","172355272","172355562","chr4","18432968","18433278","52","153922304"
"chr3","172791899","172792143","chr4","18026956","18027214","39","154764943"
"chr3","172799143","172799347","chr16","27370729","27370928","59","145428414"
"chr3","172969796","172969905","chr13","24214159","24214273","22","148755637"
"chr3","172970284","172970439","chr17","4104875","4105033","31","168865409"
"chr3","172990197","172990456","chr4","17851225","17851492","44","155138972"
"chr3","173214043","173214315","chr1","225071048","225071303","75","51857005"
"chr3","173288097","173288247","chr1","28338594","28338747","35","144949503"
"chr3","173317940","173318194","chr4","17532933","17533183","35","155785007"
"chr3","173320565","173320864","chr4","17529731","17530032","61","155790834"
"chr3","173457395","173457684","chr3","201059548","201059837","60","27602153"
"chr3","173472662","173472939","chr4","17386093","17386370","58","156086569"
"chr3","173493532","173493702","chr2A","81940659","81940835","40","91552873"
"chr3","173496346","173496572","chr4","17365356","17365602","45","156130990"
"chr3","173505474","173505752","chr4","17352936","17353221","64","156152538"
"chr3","173519856","173520120","chr4","17337479","17337765","55","156182377"
"chr3","173525544","173525677","chr4","17331909","17332039","18","156193635"
"chr3","173556116","173556416","chr4","17301422","17301701","50","156254694"
"chr3","173562095","173562211","chr4","71807651","71807768","13","101754444"
"chr3","173562364","173562658","chr4","17295413","17295718","44","156266951"
"chr3","173585041","173585325","chr1","38001876","38002160","59","135583165"
"chr3","173600403","173600703","chr1","227415933","227416230","56","53815530"
"chr3","173628986","173629289","chr4","17209187","17209491","37","156419799"
"chr3","173653323","173653615","chr4","17197149","17197440","43","156456174"
"chr3","173656823","173656948","chr11","130563626","130563750","17","43093197"
"chr3","173660339","173660639","chr4","17191341","17191640","40","156468998"
"chr3","173696309","173696625","chr4","17151702","17152020","58","156544607"
"chr3","173700760","173700914","chr4","17147339","17147509","32","156553421"
"chr3","173763652","173763895","chr4","17068234","17068465","42","156695418"
"chr3","173775738","173775923","chr20","4601852","4602032","49","169173886"
"chr3","173783099","173783390","chr8","144786356","144786646","69","28996743"
"chr3","173793130","173793442","chr4","17043177","17043451","72","156749953"
"chr3","173808632","173808935","chr4","17028803","17029090","56","156779829"
"chr3","173824924","173825197","chr4","17018272","17018551","40","156806652"
"chr3","173834099","173834383","chr1","206504099","206504390","68","32670000"
"chr3","173863393","173863623","chr6","36791131","36791360","53","137072262"
"chr3","173873335","173873629","chr11","14443649","14443947","50","159429686"
"chr3","173913253","173913513","chr4","16930635","16930897","33","156982618"
"chr3","173939922","173940204","chr4","16904328","16904602","51","157035594"
"chr3","173992140","173992343","chr4","25210847","25211053","53","148781293"
"chr3","174092415","174092708","chr4","16759596","16759896","43","157332819"
"chr3","174290470","174290747","chr5","1376594","1376882","64","172913876"
"chr3","174395897","174396044","chr4","16451557","16451695","27","157944340"
"chr3","174441419","174441692","chr12","111724732","111725004","56","62716687"
"chr3","174452160","174452324","chr5","164265935","164266103","35","10186225"
"chr3","174558346","174558463","chr17","63212955","63213066","30","111345391"
"chr3","174601696","174601846","chr7","74116130","74116280","35","100485566"
"chr3","174642835","174642995","chr7","74190896","74191062","38","100451939"
"chr3","174643686","174643787","chr4","195001113","195001216","21","20357427"
"chr3","174721884","174722137","chr6","92309240","92309487","55","82412644"
"chr3","174785547","174785863","chr4","16081004","16081309","44","158704543"
"chr3","174934627","174934922","chr4","15918791","15919088","33","159015836"
"chr3","175094569","175094863","chr1","159807678","159807940","89","15286891"
"chr3","175142479","175142760","chr4","15717164","15717461","43","159425315"
"chr3","175189406","175189584","chr4","15671925","15672098","25","159517481"
"chr3","175203077","175203229","chr21","24720942","24721101","32","150482135"
"chr3","175224175","175224490","chr4","15636608","15636913","70","159587567"
"chr3","175229994","175230275","chr4","15630981","15631263","42","159599013"
"chr3","175282657","175282939","chr14","13785018","13785301","63","161497639"
"chr3","175302798","175303039","chr4","15561748","15561993","29","159741050"
"chr3","175346191","175346317","chr4","15523667","15523793","11","159822524"
"chr3","175420773","175421093","chr4","15446892","15447188","49","159973881"
"chr3","175444299","175444613","chr10","31867393","31867701","61","143576906"
"chr3","175490457","175490716","chr1","60034453","60034701","62","115456004"
"chr3","175555104","175555226","chr4","15319434","15319556","13","160235670"
"chr3","175602620","175602926","chr4","15271656","15271961","38","160330964"
"chr3","175628902","175629202","chr4","15246522","15246827","39","160382380"
"chr3","175673754","175673874","chr4","15194167","15194288","9","160479587"
"chr3","175702364","175702652","chr4","15182872","15183171","43","160519492"
"chr3","175714554","175714858","chr4","15170386","15170676","44","160544168"
"chr3","175721931","175722228","chr4","15162550","15162853","49","160559381"
"chr3","175760118","175760433","chr4","15116604","15116919","73","160643514"
"chr3","175796832","175796956","chr5","41673794","41673918","14","134123038"
"chr3","175805452","175805757","chr18","14719814","14720115","54","161085638"
"chr3","175841739","175842027","chr4","15024855","15025143","36","160816884"
"chr3","175862674","175862929","chr4","14996355","14996611","28","160866319"
"chr3","175941736","175941866","chr1","111861160","111861287","22","64080576"
"chr3","176240254","176240430","chr19","18112321","18112488","36","158127933"
"chr3","176353937","176354197","chr4","14427669","14427934","48","161926268"
"chr3","176354894","176355010","chr14","47174431","47174547","18","129180463"
"chr3","176501332","176501409","chr9","95884781","95884857","13","80616551"
"chr3","176545082","176545357","chr4","14236953","14237226","41","162308129"
"chr3","176678236","176678511","chr1","63817889","63818160","70","112860347"
"chr3","176806702","176806844","chr15","69740012","69740164","37","107066690"
"chr3","176852060","176852182","chr4","13939670","13939793","19","162912390"
"chr3","176876126","176876264","chr4","13911101","13911244","20","162965025"
"chr3","176914593","176914890","chr4","13870004","13870288","58","163044589"
"chr3","177309788","177309906","chr4","71807651","71807768","27","105502137"
"chr3","177485163","177485291","chr4","13252385","13252504","27","164232778"
"chr3","177485589","177485746","chr16","49017109","49017265","36","128468480"
"chr3","177768546","177768817","chr4","12986918","12987176","53","164781628"
"chr3","177769058","177769339","chr4","12986399","12986697","51","164782659"
"chr3","177829401","177829679","chr4","12932886","12933177","45","164896515"
"chr3","177846559","177846844","chr4","12915645","12915942","59","164930914"
"chr3","177928546","177928703","chr3","144003939","144004095","42","33924607"
"chr3","177930200","177930507","chr4","12824346","12824631","58","165105854"
"chr3","178106316","178106608","chr4","12628291","12628583","26","165478025"
"chr3","178243512","178243801","chr4","12499428","12499718","49","165744084"
"chr3","178445849","178445973","chr4","12339940","12340064","9","166105909"
"chr3","178706814","178707094","chr4","12065288","12065558","46","166641526"
"chr3","178791789","178791943","chr4","11973728","11973890","27","166818061"
"chr3","178818174","178818451","chr19","50354803","50355091","64","128463371"
"chr3","178977738","178978019","chr4","11778742","11779039","51","167198996"
"chr3","178978573","178978858","chr4","11777910","11778198","41","167200663"
"chr3","179027923","179028084","chr10","106623894","106624059","45","72404029"
"chr3","179110543","179110822","chr4","11649400","11649678","43","167461143"
"chr3","179318976","179319137","chr4","40325999","40326159","36","138992977"
"chr3","179401673","179401859","chr13","77285476","77285638","58","102116197"
"chr3","179507732","179508014","chr4","11251310","11251591","44","168256422"
"chr3","179547271","179547579","chr4","11212488","11212800","44","168334783"
"chr3","179575807","179576090","chr11","12833630","12833897","70","166742177"
"chr3","179605064","179605192","chr4","11159326","11159457","18","168445738"
"chr3","179905881","179906020","chr1","134652174","134652315","35","45253707"
"chr3","180089149","180089431","chr4","10660338","10660624","55","169428811"
"chr3","180102846","180103122","chr4","10650172","10650450","39","169452674"
"chr3","180163027","180163309","chr4","10603335","10603614","40","169559692"
"chr3","180395596","180395898","chrX","118822166","118822454","68","61573430"
"chr3","180587823","180588100","chr11","118311440","118311714","68","62276383"
"chr3","180676490","180676630","chr15","69740012","69740164","33","110936478"
"chr3","180677057","180677160","chr7","138137307","138137413","17","42539750"
"chr3","180873059","180873326","chr13","13722210","13722502","56","167150849"
"chr3","180909344","180909467","chr1","125655523","125655645","20","55253821"
"chr3","180913545","180913657","chr9","14615063","14615184","32","166298482"
"chr3","181565947","181566237","chr2A","21942169","21942465","54","159623778"
"chr3","181569218","181569342","chr11","99025522","99025642","36","82543696"
"chr3","181571026","181571191","chr2A","91847652","91847812","33","89723374"
"chr3","181795510","181795787","chr4","9161148","9161410","33","172634362"
"chr3","181845891","181845967","chr11","43550790","43550868","14","138295101"
"chr3","181918874","181919082","chr6","169286751","169286969","53","12632123"
"chr3","181929996","181930300","chr4","4304869","4305185","69","177625127"
"chr3","181957748","181957877","chr18","46855960","46856085","27","135101788"
"chr3","181980588","181980755","chr10","115667294","115667466","38","66313294"
"chr3","181983547","181983766","chr4","4357387","4357599","35","177626160"
"chr3","182026641","182026709","chr4","171574356","171574418","12","10452285"
"chr3","182028486","182028745","chrX","2651110","2651379","65","179377376"
"chr3","182049549","182049746","chr11","34313715","34313906","51","147735834"
"chr3","182072648","182072940","chr4","4439238","4439549","62","177633410"
"chr3","182082586","182082898","chr4","4448970","4449277","46","177633616"
"chr3","182104146","182104420","chr15","47590205","47590472","58","134513941"
"chr3","182125401","182125674","chr5","53283865","53284143","59","128841536"
"chr3","182159683","182159856","chr13","9350755","9350924","36","172808928"
"chr3","182160037","182160146","chr1","160028610","160028719","21","22131427"
"chr3","182199491","182199694","chr4","4539792","4539999","27","177659699"
"chr3","182223990","182224287","chr4","4567074","4567369","35","177656916"
"chr3","182230938","182231236","chr4","4574027","4574309","54","177656911"
"chr3","182272387","182272643","chr19","40370912","40371163","73","141901475"
"chr3","182473676","182473791","chr3","24378715","24378829","21","158094961"
"chr3","182488331","182488596","chr4","4824498","4824762","30","177663833"
"chr3","182549759","182550039","chr4","4875228","4875523","37","177674531"
"chr3","182592555","182592684","chr11","126925243","126925368","18","55667312"
"chr3","182603652","182603934","chr4","4926602","4926897","58","177677050"
"chr3","182640559","182640847","chr4","4963095","4963387","59","177677464"
"chr3","182689065","182689354","chr4","5010990","5011278","30","177678075"
"chr3","182718670","182718960","chr4","5042412","5042711","40","177676258"
"chr3","182794072","182794357","chr4","5113258","5113555","45","177680814"
"chr3","182856391","182856705","chr4","5170772","5171072","50","177685619"
"chr3","182869527","182869729","chr4","5181316","5181541","44","177688211"
"chr3","182920899","182921193","chr4","5227002","5227279","46","177693897"
"chr3","182925484","182925613","chr4","5230896","5231025","13","177694588"
"chr3","183033607","183033899","chr4","5342959","5343252","33","177690648"
"chr3","183134839","183134972","chr6","35351831","35351966","20","147783008"
"chr3","183530297","183530426","chr4","5838660","5838783","11","177691637"
"chr3","183538992","183539281","chr6","84341710","84341991","65","99197282"
"chr3","183546628","183546913","chr4","5850870","5851168","40","177695758"
"chr3","183552891","183553176","chr4","5850870","5851168","40","177702021"
"chr3","183726380","183726642","chr11","94870018","94870300","65","88856362"
"chr3","184060934","184061222","chr3","131369946","131370239","60","52690988"
"chr3","184086736","184087056","chr4","6365416","6365723","38","177721320"
"chr3","184093824","184094118","chr4","6372973","6373268","29","177720851"
"chr3","184101099","184101372","chr7","2959934","2960208","65","181141165"
"chr3","184108167","184108351","chr7","78019323","78019524","49","106088844"
"chr3","184448113","184448395","chr4","6703003","6703295","41","177745110"
"chr3","184478658","184478754","chr1","119481412","119481493","28","64997246"
"chr3","184511488","184511794","chr21","23520012","23520319","63","160991476"
"chr3","184524404","184524693","chr21","8726004","8726294","62","175798400"
"chr3","184555499","184555768","chr16","40555825","40556088","55","143999674"
"chr3","184557755","184558049","chr4","6809143","6809449","43","177748612"
"chr3","184609370","184609525","chr18","77876014","77876168","25","106733356"
"chr3","184631958","184632250","chr4","6871186","6871464","55","177760772"
"chr3","184641865","184642177","chr4","6878592","6878885","58","177763273"
"chr3","184661566","184661816","chr4","6895359","6895637","54","177766207"
"chr3","184676650","184676920","chr17","15958321","15958596","63","168718329"
"chr3","184680017","184680280","chr4","6915580","6915847","42","177764437"
"chr3","184713041","184713329","chr7","150505728","150506016","65","34207313"
"chr3","184715492","184715803","chr2A","79871723","79872029","63","104843769"
"chr3","184718256","184718559","chr7","4605129","4605434","60","180113127"
"chr3","184737757","184737912","chr15","23773713","23773873","34","160964044"
"chr3","184833838","184834039","chr4","7078360","7078569","26","177755478"
"chr3","184835156","184835469","chr4","167934179","167934476","73","16900977"
"chr3","184836017","184836208","chr16","3725352","3725539","40","181110665"
"chr3","184848747","184849040","chr4","7091802","7092093","41","177756945"
"chr3","184925054","184925182","chr4","7165242","7165367","22","177759812"
"chr3","184938229","184938517","chr7","66246986","66247273","63","118691243"
"chr3","185029589","185029891","chr4","7275746","7276057","51","177753843"
"chr3","185029956","185030238","chr4","7276126","7276415","42","177753830"
"chr3","185083276","185083568","chr4","7337128","7337424","41","177746148"
"chr3","185238005","185238136","chr4","7483170","7483302","13","177754835"
"chr3","185361352","185361458","chr4","7589545","7589651","20","177771807"
"chr3","185481032","185481286","chr4","7702094","7702366","49","177778938"
"chr3","185576404","185576702","chr4","7800527","7800836","63","177775877"
"chr3","185842818","185842987","chr7","65716406","65716564","40","120126412"
"chr3","185850479","185850626","chr19","14033980","14034138","31","171816499"
"chr3","185854565","185854790","chr6","38297871","38298088","68","147556694"
"chr3","185886561","185886845","chrX","141574119","141574411","60","44312442"
"chr3","185904558","185904837","chr4","8112849","8113146","62","177791709"
"chr3","185913944","185914055","chr6","38593130","38593246","21","147320814"
"chr3","185917572","185917886","chr4","8125261","8125554","63","177792311"
"chr3","185974970","185975262","chr9","30785116","30785418","60","155189854"
"chr3","186006568","186006842","chr14","6082819","6083088","53","179923749"
"chr3","186023746","186024042","chr4","8211236","8211535","32","177812510"
"chr3","186040651","186040956","chr1","227415933","227416230","54","41375282"
"chr3","186060497","186060799","chr4","8252453","8252752","45","177808044"
"chr3","186079432","186079738","chr4","8288413","8288721","42","177791019"
"chr3","186079871","186079985","chr4","8288884","8288996","14","177790987"
"chr3","186230440","186230565","chr16","68913600","68913726","22","117316840"
"chr3","186294529","186294828","chr4","8485685","8485984","45","177808844"
"chr3","186337678","186337966","chr4","8515621","8515919","45","177822057"
"chr3","186390474","186390774","chr4","8568976","8569269","48","177821498"
"chr3","186408577","186408770","chr19","6085105","6085297","51","180323472"
"chr3","186437626","186437738","chr20","56331396","56331511","21","130106230"
"chr3","186456704","186456819","chr19","14388120","14388239","25","172068584"
"chr3","186469353","186469462","chr10","12475418","12475526","18","173993935"
"chr3","186522930","186523230","chr4","8707316","8707618","38","177815614"
"chr3","186540666","186540969","chr4","8722207","8722529","54","177818459"
"chr3","186669212","186669452","chr19","37794171","37794401","69","148875041"
"chr3","186673583","186673874","chr4","8844727","8845023","42","177828856"
"chr3","187161495","187161778","chr2A","64753924","64754221","67","122407571"
"chr3","187238764","187239051","chr12","30354259","30354546","66","156884505"
"chr3","187282045","187282305","chr19","738219","738484","78","186543826"
"chr3","187285526","187285672","chr1","138968329","138968481","44","48317197"
"chr3","187288671","187288801","chr8","103799790","103799921","40","83488881"
"chr3","187497290","187497556","chr2A","80994984","80995255","52","106502306"
"chr3","187504518","187504616","chr18","60849673","60849771","28","126654845"
"chr3","187505194","187505299","chr19","15338289","15338389","26","172166905"
"chr3","187525060","187525339","chr4","3267538","3267855","63","184257522"
"chr3","187643317","187643613","chr4","3162584","3162886","58","184480733"
"chr3","187645001","187645282","chr4","3160604","3160906","57","184484397"
"chr3","187674219","187674500","chr4","3124917","3125214","58","184549302"
"chr3","187718454","187718745","chr4","3075609","3075912","52","184642845"
"chr3","187740108","187740412","chr4","3050567","3050872","47","184689541"
"chr3","187743369","187743664","chr4","3047418","3047706","45","184695951"
"chr3","187747056","187747215","chr7","79271528","79271684","38","108475528"
"chr3","187756147","187756273","chr16","69212656","69212783","31","118543491"
"chr3","187766102","187766379","chr11","102552698","102553008","55","85213404"
"chr3","187766946","187767221","chr15","42248207","42248483","63","145518739"
"chr3","187841447","187841741","chr4","2985816","2986106","52","184855631"
"chr3","187865467","187865548","chr10","142430183","142430266","9","45435284"
"chr3","187896881","187897001","chr12","111176332","111176452","28","76720549"
"chr3","187933063","187933356","chr5","122583358","122583654","57","65349705"
"chr3","187966540","187966677","chr6","35062432","35062567","40","152904108"
"chr3","187975070","187975352","chr4","2823870","2824146","44","185151200"
"chr3","188003620","188003836","chr4","2801516","2801742","37","185202104"
"chr3","188007866","188008146","chr19","45627063","45627351","72","142380803"
"chr3","188103589","188103872","chr16","30796207","30796494","69","157307382"
"chr3","188129152","188129440","chr4","2700662","2700981","58","185428490"
"chr3","188168950","188169094","chr5","160387610","160387743","36","27781340"
"chr3","188169384","188169435","chr4","2674664","2674714","7","185494720"
"chr3","188169436","188169494","chr9","22416946","22417010","22","165752490"
"chr3","188171174","188171388","chr4","2672031","2672249","38","185499143"
"chr3","188176533","188176814","chr7","66293568","66293857","56","121882965"
"chr3","188190197","188190494","chr4","2648235","2648518","52","185541962"
"chr3","188217487","188217635","chr9","76928083","76928199","49","111289404"
"chr3","188217761","188217964","chrX","24030319","24030529","46","164187442"
"chr3","188229569","188229817","chrX","156319225","156319483","67","31910344"
"chr3","188248408","188248705","chr4","2612334","2612633","41","185636074"
"chr3","188283363","188283485","chr4","2577939","2578059","17","185705424"
"chr3","188310514","188310798","chr4","2551445","2551738","38","185759069"
"chr3","188319242","188319527","chr7","1708256","1708538","62","186610986"
"chr3","188321820","188321941","chr7","26158438","26158564","29","162163382"
"chr3","188336335","188336488","chr8","28498858","28499014","30","159837477"
"chr3","188340140","188340446","chr4","2529512","2529816","42","185810628"
"chr3","188364691","188364967","chr19","35299717","35299995","62","153064974"
"chr3","188366389","188366512","chr7","11248117","11248241","22","177118272"
"chr3","188370199","188370488","chr4","120243844","120244136","65","68126355"
"chr3","188378193","188378276","chr6","34879053","34879133","28","153499140"
"chr3","188454808","188454973","chr7","79271528","79271684","35","109183280"
"chr3","188469975","188470267","chr14","87389273","87389563","58","101080702"
"chr3","188471752","188471827","chr4","48336526","48336599","14","140135226"
"chr3","188477992","188478113","chr7","128608551","128608674","15","59869441"
"chr3","188488084","188488255","chr1","184720130","184720300","37","3767954"
"chr3","188538254","188538558","chr4","2323564","2323851","55","186214690"
"chr3","188557094","188557237","chr6","77626450","77626592","29","110930644"
"chr3","188573562","188573723","chr20","44858230","44858390","40","143715332"
"chr3","188586660","188586943","chr4","2278273","2278575","45","186308387"
"chr3","188589035","188589324","chr4","2275741","2276036","41","186313294"
"chr3","188597138","188597435","chr4","2268040","2268351","46","186329098"
"chr3","188621558","188621876","chr4","2248781","2249099","51","186372777"
"chr3","188698456","188698727","chr4","199336530","199336802","66","10638074"
"chr3","188714606","188714855","chr4","2164003","2164277","53","186550603"
"chr3","188738797","188739068","chr4","2139960","2140252","43","186598837"
"chr3","188744598","188744889","chr4","2134462","2134746","44","186610136"
"chr3","188745796","188746098","chr4","2134462","2134746","51","186611334"
"chr3","188761193","188761225","chr12","117752730","117752764","5","71008463"
"chr3","188790064","188790362","chr4","2090886","2091186","36","186699178"
"chr3","188808600","188808846","chr12","106838535","106838776","65","81970065"
"chr3","188936330","188936615","chr4","1929171","1929459","43","187007159"
"chr3","188938805","188939101","chr4","1925303","1925600","51","187013502"
"chr3","188975151","188975281","chr2A","37107556","37107687","22","151867595"
"chr3","188976002","188976174","chr8","140832015","140832188","34","48143987"
"chr3","189002150","189002262","chr7","140174758","140174882","26","48827392"
"chr3","189014285","189014447","chr10","101988216","101988372","51","87026069"
"chr3","189023996","189024285","chr4","1843105","1843389","38","187180891"
"chr3","189031677","189031950","chr4","1835405","1835678","46","187196272"
"chr3","189037249","189037548","chr9","34098327","34098616","66","154938922"
"chr3","189060631","189060926","chr6","119275377","119275655","83","69785254"
"chr3","189070765","189071063","chr4","1804849","1805152","65","187265916"
"chr3","189078898","189079181","chr22","24598382","24598677","63","164480516"
"chr3","189170773","189170936","chr2B","126162282","126162438","36","63008491"
"chr3","189186323","189186600","chr13","12181424","12181710","70","177004899"
"chr3","189193467","189193619","chrX","55031365","55031517","35","134162102"
"chr3","189244690","189244830","chr1","205548459","205548612","45","16303769"
"chr3","189319210","189319505","chr4","1542682","1542974","31","187776528"
"chr3","189470919","189471226","chr3","58092842","58093150","64","131378077"
"chr3","189474586","189474754","chr22","7986787","7986953","39","181487799"
"chr3","189505762","189505881","chr7","69801927","69802033","29","119703835"
"chr3","189505882","189506191","chr4","1368021","1368336","43","188137861"
"chr3","189506192","189506350","chr5","68013915","68014074","28","121492277"
"chr3","189508133","189508427","chr4","1365372","1365673","42","188142761"
"chr3","189566053","189566323","chr4","100593132","100593403","52","88972921"
"chr3","189594494","189594625","chr21","16681946","16682077","19","172912548"
"chr3","189609438","189609537","chr17","7683396","7683506","29","181926042"
"chr3","189617956","189618108","chr19","37746124","37746279","36","151871832"
"chr3","189620617","189620880","chr11","123875047","123875316","62","65745570"
"chr3","189628366","189628664","chr10","118567499","118567804","67","71060867"
"chr3","189640134","189640433","chr4","1240967","1241279","55","188399167"
"chr3","189642660","189642965","chr1","11272743","11273038","75","178369917"
"chr3","189644913","189645217","chr1","11272743","11273038","74","178372170"
"chr3","189708134","189708333","chr4","1176467","1176650","53","188531667"
"chr3","189790594","189790851","chr5","57595969","57596232","78","132194625"
"chr3","189849194","189849337","chr5","103372455","103372595","35","86476739"
"chr3","189935655","189935957","chr7","78881334","78881631","73","111054321"
"chr3","189943913","189944233","chr4","970376","970684","51","188973537"
"chr3","189978102","189978402","chr4","938348","938652","50","189039754"
"chr3","190030092","190030378","chr4","890598","890872","53","189139494"
"chr3","190055607","190055875","chr5","997797","998069","62","189057810"
"chr3","190138749","190139037","chr16","49507014","49507304","64","140631735"
"chr3","190175643","190175934","chr4","753919","754202","43","189421724"
"chr3","190438217","190438523","chr4","517852","518157","34","189920365"
"chr3","190475619","190475745","chr4","482751","482877","12","189992868"
"chr3","190477176","190477391","chr4","481067","481286","29","189996109"
"chr3","190537786","190537851","chr4","266376","266440","10","190271410"
"chr3","190573405","190573455","chr17","88243556","88243612","15","102329849"
"chr3","190582801","190582915","chr10","93040219","93040335","21","97542582"
"chr3","190636796","190637088","chr4","332805","333097","34","190303991"
"chr3","190644664","190644956","chr4","332805","333097","33","190311859"
"chr3","190676192","190676483","chr13","21290520","21290799","69","169385672"
"chr3","190828813","190829108","chr7","74675945","74676251","59","116152868"
"chr3","190832067","190832349","chr7","74671404","74671697","45","116160663"
"chr3","190833229","190833517","chr1","202592673","202592956","50","11759444"
"chr3","190835489","190835569","chrX","53217590","53217668","14","137617899"
"chr3","190836137","190836399","chr3","144951950","144952225","70","45884187"
"chr3","190836804","190837053","chr16","28090554","28090811","71","162746250"
"chr3","190837436","190837708","chr7","64852523","64852793","67","125984913"
"chr3","190838114","190838410","chr7","65791041","65791342","37","125047073"
"chr4","8388483","8388796","chr9","45291748","45292044","72","36903265"
"chr4","655244","655562","chr6","28973346","28973641","55","28318102"
"chr4","10223368","10223670","chr6","18954865","18955162","39","8731497"
"chr4","30932835","30933042","chr2A","35472471","35472672","39","4539636"
"chr4","58851147","58851443","chrX","39133182","39133470","49","19717965"
"chr4","66322302","66322549","chr6","69980736","69980980","53","3658434"
"chr4","104464226","104464514","chr6","107305560","107305849","40","2841334"
"chr4","108658490","108658902","chr6","111280554","111280901","101","2622064"
"chr4","109838143","109838373","chr19","40602950","40603177","53","69235193"
"chr4","128843626","128843922","chr6","131028211","131028512","43","2184585"
"chr4","211975","212106","chr12","29897183","29897312","22","29685208"
"chr4","221868","222006","chr6","29534296","29534444","26","29312428"
"chr4","234418","234512","chr6","29524830","29524924","10","29290412"
"chr4","241188","241404","chr6","29514234","29514460","40","29273046"
"chr4","347865","348180","chr16","22102863","22103155","97","21754998"
"chr4","432559","432645","chr21","8496784","8496874","17","8064225"
"chr4","490544","490676","chr1","103455628","103455743","37","102965084"
"chr4","501957","502257","chr6","29152685","29152992","41","28650728"
"chr4","536763","537033","chr6","29119663","29119945","48","28582900"
"chr4","618540","618704","chr5","16337364","16337541","37","15718824"
"chr4","648222","648493","chr6","28993159","28993459","70","28344937"
"chr4","677996","678295","chr6","28947051","28947343","34","28269055"
"chr4","711813","712048","chr6","28905884","28906132","43","28194071"
"chr4","728605","728721","chr1","41445703","41445820","17","40717098"
"chr4","732438","732701","chr6","28893106","28893386","57","28160668"
"chr4","745121","745238","chr18","8665328","8665444","25","7920207"
"chr4","746613","746923","chr6","28879774","28880083","45","28133161"
"chr4","758439","758550","chr5","39965598","39965710","22","39207159"
"chr4","837000","837145","chr1","223894247","223894395","33","223057247"
"chr4","837533","837652","chr10","90957398","90957520","25","90119865"
"chr4","886998","887279","chr6","28725761","28726062","44","27838763"
"chr4","888134","888347","chr19","2131451","2131664","56","1243317"
"chr4","895914","896084","chr8","56795337","56795503","37","55899423"
"chr4","901433","901724","chr8","77145033","77145331","81","76243600"
"chr4","968858","969165","chr6","28560187","28560484","43","27591329"
"chr4","1101124","1101291","chr13","96379221","96379388","63","95278097"
"chr4","1105110","1105278","chr13","96379221","96379388","66","95274111"
"chr4","1119429","1119735","chr7","105862386","105862686","64","104742957"
"chr4","1170281","1170326","chrX","47925056","47925101","6","46754775"
"chr4","1238465","1238741","chr3","57847114","57847393","60","56608649"
"chr4","1320337","1320568","chr6","28165533","28165784","47","26845196"
"chr4","1399081","1399182","chr19","36874606","36874712","25","35475525"
"chr4","1402482","1402727","chr1","185539250","185539490","61","184136768"
"chr4","1432598","1432899","chr6","28029768","28030069","33","26597170"
"chr4","1441297","1441547","chr6","28022642","28022897","37","26581345"
"chr4","1452074","1452364","chr16","48298396","48298687","56","46846322"
"chr4","1663320","1663552","chr6","27725188","27725439","53","26061868"
"chr4","1701899","1702150","chr6","27691717","27691969","31","25989818"
"chr4","1720734","1720844","chr16","68805794","68805900","19","67085060"
"chr4","1736334","1736635","chrX","49580978","49581241","85","47844644"
"chr4","1870773","1871042","chr5","124481067","124481338","59","122610294"
"chr4","1891494","1891574","chr16","10977384","10977466","18","9085890"
"chr4","1907285","1907563","chr19","38108398","38108676","59","36201113"
"chr4","1942697","1942977","chr6","27208660","27208947","49","25265963"
"chr4","2052065","2052281","chr6","27023285","27023480","55","24971220"
"chr4","2097883","2098184","chr6","26981594","26981892","56","24883711"
"chr4","2163652","2163918","chr6","26899928","26900199","32","24736276"
"chr4","2172413","2172507","chr12","59073283","59073378","27","56900870"
"chr4","2190617","2190919","chr5","21531616","21531908","90","19340999"
"chr4","2325616","2325859","chr6","26730125","26730338","75","24404509"
"chr4","2327924","2327973","chr3","199690887","199690936","15","197362963"
"chr4","2328351","2328523","chr1","184720130","184720300","44","182391779"
"chr4","2351691","2351814","chr7","77000001","77000126","27","74648310"
"chr4","2355388","2355526","chr19","16812734","16812866","31","14457346"
"chr4","2416310","2416586","chr6","26583453","26583739","50","24167143"
"chr4","2440801","2441051","chr6","26553243","26553509","38","24112442"
"chr4","2468045","2468163","chrX","153179863","153179981","20","150711818"
"chr4","2473665","2473956","chr6","26517790","26518083","61","24044125"
"chr4","2513122","2513408","chr6","26474037","26474336","53","23960915"
"chr4","2541451","2541719","chr6","26449883","26450150","30","23908432"
"chr4","2599596","2599864","chr1","93231546","93231817","67","90631950"
"chr4","2691264","2691478","chr20","32094122","32094337","50","29402858"
"chr4","2695634","2695927","chr6","25853051","25853339","48","23157417"
"chr4","2714799","2715104","chr5","1271941","1272242","59","1442858"
"chr4","2725294","2725564","chr10","40984914","40985194","63","38259620"
"chr4","2751406","2751729","chr6","25897658","25897947","78","23146252"
"chr4","2757534","2757810","chr6","25903846","25904123","34","23146312"
"chr4","2792126","2792407","chr6","25937774","25938068","72","23145648"
"chr4","2793289","2793550","chr6","36932206","36932446","74","34138917"
"chr4","2822573","2822858","chr6","25972011","25972329","76","23149438"
"chr4","2847351","2847630","chr6","25997885","25998175","55","23150534"
"chr4","2880438","2880630","chr6","26026637","26026822","26","23146199"
"chr4","2920117","2920331","chr6","26062833","26063046","29","23142716"
"chr4","2926944","2927086","chr1","23727757","23727901","31","20800813"
"chr4","2967294","2967556","chr6","26088291","26088559","39","23120997"
"chr4","2970663","2970940","chr6","26145191","26145488","52","23174528"
"chr4","3024877","3025176","chr6","26202558","26202878","48","23177681"
"chr4","3045868","3046170","chr6","26223604","26223894","54","23177736"
"chr4","3049039","3049177","chr16","60028463","60028597","34","56979424"
"chr4","3142675","3142873","chr6","25824709","25824908","36","22682034"
"chr4","3146007","3146293","chr11","134193516","134193804","63","131047509"
"chr4","3353027","3353306","chr1","189232436","189232704","66","185879409"
"chr4","3391122","3391366","chr6","25606157","25606430","47","22215035"
"chr4","3400088","3400375","chr6","25595826","25596101","54","22195738"
"chr4","3498227","3498481","chr7","56755419","56755669","68","53257192"
"chr4","3567579","3567700","chr21","30109301","30109422","21","26541722"
"chr4","3567759","3567920","chr16","29831921","29832088","47","26264162"
"chr4","3626793","3626995","chr3","190633112","190633302","58","187006319"
"chr4","3633534","3633829","chr6","25425287","25425591","53","21791753"
"chr4","3634959","3635238","chr6","25422977","25423258","42","21788018"
"chr4","3645170","3645277","chr5","41356577","41356687","16","37711407"
"chr4","3662437","3662696","chr6","25400484","25400775","63","21738047"
"chr4","3692418","3692762","chr17","10319818","10320132","87","6627400"
"chr4","3700388","3700600","chr3","63851273","63851482","45","60150885"
"chr4","3742158","3742438","chr6","25324936","25325209","33","21582778"
"chr4","3776798","3777016","chr5","35605178","35605402","47","31828380"
"chr4","3785816","3786078","chr6","35525971","35526244","55","31740155"
"chr4","3791155","3791259","chrX","118203593","118203697","13","114412438"
"chr4","3826563","3826723","chr15","30625249","30625411","34","26798686"
"chr4","3856488","3856731","chr5","110284799","110285036","62","106428311"
"chr4","3856875","3857010","chr6","25209537","25209670","21","21352662"
"chr4","3863750","3863951","chr18","42945821","42946028","42","39082071"
"chr4","3913139","3913257","chr2B","58435909","58436028","24","54522770"
"chr4","3932907","3933053","chr12","106911911","106912059","39","102979004"
"chr4","3959583","3959878","chr6","25119471","25119794","62","21159888"
"chr4","3967241","3967403","chr9","109650705","109650871","31","105683464"
"chr4","3980971","3981187","chr15","58732298","58732524","53","54751327"
"chr4","3993162","3993285","chr6","25091066","25091188","14","21097904"
"chr4","3995054","3995312","chr6","25089026","25089276","58","21093972"
"chr4","4078639","4078942","chr1","46825028","46825336","61","42746389"
"chr4","4084668","4084873","chr4","41174967","41175160","70","37090299"
"chr4","4084883","4085003","chr21","32122423","32122543","30","28037540"
"chr4","4117444","4117730","chr6","24961871","24962179","51","20844427"
"chr4","4128393","4128684","chr12","43802996","43803296","67","39674603"
"chr4","4177881","4178183","chr6","24916940","24917244","67","20739059"
"chr4","4232790","4233091","chr6","24872288","24872585","42","20639498"
"chr4","4446607","4446906","chr6","24640948","24641223","61","20194341"
"chr4","4476185","4476497","chr6","24616319","24616625","52","20140134"
"chr4","4891078","4891306","chr2B","44812346","44812565","50","39921268"
"chr4","5554247","5554414","chr6","23451315","23451508","46","17897068"
"chr4","5573245","5573550","chr14","61318114","61318412","76","55744869"
"chr4","5673265","5673544","chr6","23328919","23329204","62","17655654"
"chr4","5681167","5681331","chr3","14267985","14268147","38","8586818"
"chr4","5753541","5753706","chr10","90071080","90071242","34","84317539"
"chr4","5802553","5802843","chr6","23202197","23202489","37","17399644"
"chr4","5924484","5924761","chr6","23065239","23065526","44","17140755"
"chr4","5960028","5960194","chrX","17937151","17937313","50","11977123"
"chr4","5964581","5964693","chr1","216103240","216103352","25","210138659"
"chr4","6076481","6076758","chr6","22888559","22888865","70","16812078"
"chr4","6195064","6195357","chr6","22783502","22783808","65","16588438"
"chr4","6225159","6225317","chr2A","64805346","64805507","36","58580187"
"chr4","6376782","6376983","chr6","22617770","22618004","49","16240988"
"chr4","6398353","6398558","chr6","22597991","22598206","32","16199638"
"chr4","6399834","6400142","chr1","163867986","163868280","64","157468152"
"chr4","6401630","6401916","chr6","22594885","22595186","57","16193255"
"chr4","6454024","6454288","chr2B","6489772","6490027","57","35748"
"chr4","6454950","6455072","chr7","26158438","26158564","33","19703488"
"chr4","6474927","6475115","chr8","103953814","103954012","41","97478887"
"chr4","6489383","6489623","chr6","22514177","22514446","68","16024794"
"chr4","6494991","6495267","chr6","22510067","22510353","44","16015076"
"chr4","6591048","6591280","chr6","22413590","22413815","31","15822542"
"chr4","6637810","6637911","chr18","48326419","48326520","23","41688609"
"chr4","6650004","6650300","chr6","22354196","22354489","36","15704192"
"chr4","6688540","6688830","chr20","3412425","3412718","64","3276115"
"chr4","6705957","6706120","chr1","188967838","188967994","37","182261881"
"chr4","6724647","6724792","chr3","267312","267456","32","6457335"
"chr4","6735809","6735959","chr15","5454904","5455056","31","1280905"
"chr4","6777827","6777956","chr6","22235417","22235556","30","15457590"
"chr4","6827031","6827200","chr11","71910867","71911040","39","65083836"
"chr4","6834630","6834906","chr7","43528915","43529193","75","36694285"
"chr4","6835740","6836028","chr9","92361467","92361757","40","85525727"
"chr4","6840073","6840369","chr6","22176377","22176687","52","15336304"
"chr4","6956637","6956920","chr6","22068839","22069129","40","15112202"
"chr4","6986771","6986927","chr1","9880179","9880343","44","2893408"
"chr4","7024006","7024299","chr6","22004304","22004592","32","14980298"
"chr4","7122522","7122823","chr6","21900759","21901066","46","14778237"
"chr4","7298282","7298584","chr6","21760667","21760973","40","14462385"
"chr4","7302791","7303065","chr6","21756156","21756429","45","14453365"
"chr4","7337476","7337781","chr6","21723042","21723359","47","14385566"
"chr4","7339406","7339704","chr6","21721723","21722030","54","14382317"
"chr4","7366019","7366230","chr6","21694896","21695105","28","14328877"
"chr4","7396492","7396783","chr11","46419704","46419999","69","39023212"
"chr4","7428299","7428599","chr6","21633360","21633676","59","14205061"
"chr4","7471855","7471982","chr6","21592368","21592495","14","14120513"
"chr4","7472043","7472362","chr6","21591998","21592308","45","14119955"
"chr4","7568943","7569243","chr6","21504155","21504433","63","13935212"
"chr4","7584954","7585125","chr7","4828552","4828727","40","2756402"
"chr4","7606766","7606889","chr1","205458434","205458554","23","197851668"
"chr4","7685018","7685295","chr6","21386620","21386901","49","13701602"
"chr4","7735550","7735660","chrX","20209988","20210094","27","12474438"
"chr4","7743794","7743942","chr8","42822730","42822873","41","35078936"
"chr4","7744055","7744085","chr3","50194672","50194694","9","42450617"
"chr4","7788359","7788642","chr6","21297248","21297544","45","13508889"
"chr4","7799491","7799800","chr6","21286578","21286916","58","13487087"
"chr4","7904588","7904878","chr6","21194527","21194838","57","13289939"
"chr4","7952081","7952162","chr6","21137452","21137527","21","13185371"
"chr4","8010292","8010572","chr16","60238828","60239122","63","52228536"
"chr4","8026609","8026733","chr7","11248117","11248241","23","3221508"
"chr4","8027236","8027527","chr7","129054394","129054678","61","121027158"
"chr4","8050384","8050503","chr6","21005094","21005213","14","12954710"
"chr4","8064328","8064451","chr6","20991228","20991351","10","12926900"
"chr4","8064496","8064842","chr1","92681466","92681789","96","84616970"
"chr4","8089036","8089326","chr4","120243844","120244136","59","112154808"
"chr4","8092260","8092553","chr19","43960111","43960398","69","35867851"
"chr4","8139736","8140022","chrX","19199530","19199816","56","11059794"
"chr4","8141321","8141440","chr6","20944032","20944155","18","12802711"
"chr4","8165474","8165625","chr2B","126639395","126639541","40","118473921"
"chr4","8189542","8189820","chr6","20900678","20900967","42","12711136"
"chr4","8197779","8197928","chr20","13392558","13392708","47","5194779"
"chr4","8214633","8214931","chr6","20876054","20876332","54","12661421"
"chr4","8214941","8215052","chr8","87397828","87397940","23","79182887"
"chr4","8239427","8239727","chr6","20855684","20855981","47","12616257"
"chr4","8284236","8284365","chr6","20810098","20810227","12","12525862"
"chr4","8289616","8289910","chr6","20804685","20804980","39","12515069"
"chr4","8317324","8317422","chr6","20764156","20764245","19","12446832"
"chr4","8347747","8348017","chr6","20733563","20733828","44","12385816"
"chr4","8348983","8349264","chr6","20732619","20732901","51","12383636"
"chr4","8390274","8390568","chr6","20689530","20689838","48","12299256"
"chr4","8420282","8420572","chr6","20660276","20660575","38","12239994"
"chr4","8490805","8491106","chr6","20611928","20612223","44","12121123"
"chr4","8498127","8498415","chr6","20604584","20604895","52","12106457"
"chr4","8530802","8531103","chr6","20611928","20612223","43","12081126"
"chr4","8540183","8540468","chr6","20604584","20604895","59","12064401"
"chr4","8569301","8569400","chr6","27614098","27614199","18","19044797"
"chr4","8720020","8720103","chr10","144050807","144050895","24","135330787"
"chr4","9065271","9065577","chr6","20105490","20105784","56","11040219"
"chr4","9185400","9185713","chr6","19958039","19958342","53","10772639"
"chr4","9426325","9426613","chr6","19714487","19714770","40","10288162"
"chr4","9519574","9519672","chr15","37513750","37513848","25","27994176"
"chr4","9519802","9519966","chr5","38816301","38816460","42","29296499"
"chr4","9524511","9524847","chr6","19622067","19622383","57","10097556"
"chr4","9544434","9544702","chr21","30692896","30693148","69","21148462"
"chr4","9597365","9597671","chr6","19556832","19557155","54","9959467"
"chr4","9735582","9735890","chrX","119348383","119348688","63","109612801"
"chr4","9823862","9824063","chr6","19347993","19348203","30","9524131"
"chr4","9826399","9826694","chr5","19587686","19587955","79","9761287"
"chr4","9873808","9874086","chr6","19305882","19306160","43","9432074"
"chr4","9906494","9906778","chr6","19269105","19269379","42","9362611"
"chr4","9979552","9979816","chr3","45293683","45293950","60","35314131"
"chr4","10078190","10078475","chr13","80959297","80959583","72","70881107"
"chr4","10105055","10105302","chr16","39868511","39868768","65","29763456"
"chr4","10124671","10124973","chr18","32258742","32259038","64","22134071"
"chr4","10172776","10172919","chr8","20885859","20886004","30","10713083"
"chr4","10213947","10214278","chr8","7902324","7902635","91","2311623"
"chr4","10280019","10280350","chr7","472960","473279","82","9807059"
"chr4","10281307","10281613","chr11","60975515","60975808","61","50694208"
"chr4","10286893","10286962","chrX","9714395","9714467","10","572498"
"chr4","10302417","10302706","chr6","18878233","18878518","62","8575816"
"chr4","10304519","10304786","chr6","18876151","18876418","43","8571632"
"chr4","10326835","10327073","chr6","18853952","18854174","45","8527117"
"chr4","10333991","10334295","chr6","18847461","18847769","45","8513470"
"chr4","10339253","10339539","chr7","79293631","79293923","56","68954378"
"chr4","10353426","10353671","chr6","18827612","18827862","35","8474186"
"chr4","10355027","10355309","chrX","118718918","118719200","48","108363891"
"chr4","10359345","10359468","chr6","18821204","18821328","12","8461859"
"chr4","10359933","10360245","chr6","18820395","18820711","59","8460462"
"chr4","10373002","10373121","chr4","112780763","112780884","23","102407761"
"chr4","10398641","10398941","chr1","32062408","32062709","59","21663767"
"chr4","10412394","10412573","chr6","18768070","18768251","42","8355676"
"chr4","10422402","10422479","chr5","121643612","121643688","15","111221210"
"chr4","10433442","10433735","chr6","18742405","18742706","43","8308963"
"chr4","10440641","10440930","chr6","18735017","18735306","43","8294376"
"chr4","10441006","10441308","chr6","18734637","18734948","45","8293631"
"chr4","10441833","10441992","chr16","38955159","38955317","33","28513326"
"chr4","10444819","10444948","chr6","18730913","18731043","11","8286094"
"chr4","10462425","10462551","chr5","152649372","152649495","30","142186947"
"chr4","10465834","10466124","chr6","18706854","18707155","53","8241020"
"chr4","10468928","10469136","chrX","24030319","24030529","48","13561391"
"chr4","10471543","10471666","chr6","18701904","18702028","14","8230361"
"chr4","10487886","10488173","chr6","18692096","18692383","32","8204210"
"chr4","10488782","10488928","chr1","148219593","148219735","38","137730811"
"chr4","10505137","10505315","chr6","18678659","18678856","35","8173522"
"chr4","10505819","10506032","chr6","18677995","18678216","29","8172176"
"chr4","10508478","10508733","chr6","18675304","18675581","48","8166826"
"chr4","10531075","10531204","chr1","27808249","27808381","20","17277174"
"chr4","10532118","10532391","chr6","18651544","18651813","43","8119426"
"chr4","10557410","10557676","chr5","122777482","122777749","54","112220072"
"chr4","10586649","10586806","chr14","72724722","72724884","36","62138073"
"chr4","10629527","10629619","chr5","10515836","10515928","20","113691"
"chr4","10667451","10667670","chr18","12205066","12205280","52","1537615"
"chr4","10671846","10672173","chr6","18477123","18477436","50","7805277"
"chr4","10692578","10692872","chr1","46744720","46745014","61","36052142"
"chr4","10699553","10699830","chr16","25190782","25191063","60","14491229"
"chr4","10743673","10743969","chr6","18403344","18403639","34","7659671"
"chr4","10746329","10746586","chr15","42634878","42635139","68","31888549"
"chr4","10762298","10762595","chr6","18384786","18385069","43","7622488"
"chr4","10810583","10810706","chr6","18341068","18341189","15","7530485"
"chr4","10824232","10824444","chrX","154182968","154183182","52","143358736"
"chr4","10834385","10834678","chr4","87112172","87112465","61","76277787"
"chr4","10843270","10843511","chr6","18305672","18305899","41","7462402"
"chr4","10844750","10845046","chr6","18304093","18304398","59","7459343"
"chr4","10858175","10858297","chr6","18291409","18291533","18","7433234"
"chr4","10863251","10863408","chr19","16563994","16564154","39","5700743"
"chr4","10902555","10902838","chr6","66795113","66795392","44","55892558"
"chr4","10950379","10950510","chr6","18248960","18249095","17","7298581"
"chr4","10951928","10952196","chr12","532336","532601","57","10419592"
"chr4","10983961","10984241","chr3","131695355","131695636","59","120711394"
"chr4","11005466","11005752","chr6","18183987","18184261","60","7178521"
"chr4","11017087","11017359","chr6","18171820","18172106","42","7154733"
"chr4","11018969","11019278","chr16","59389149","59389458","65","48370180"
"chr4","11021755","11022027","chr11","46584404","46584678","82","35562649"
"chr4","11022720","11022998","chr6","18161402","18161682","66","7138682"
"chr4","11117024","11117330","chr3","74046897","74047199","59","62929873"
"chr4","11119437","11119709","chr6","18056414","18056686","42","6936977"
"chr4","11138453","11138777","chr6","18024055","18024376","51","6885602"
"chr4","11202201","11202501","chr10","91152725","91153005","71","79950524"
"chr4","11295948","11296228","chr10","37420281","37420572","64","26124333"
"chr4","11337546","11337817","chr6","17753933","17754231","58","6416387"
"chr4","11355727","11356032","chr6","17736146","17736444","39","6380419"
"chr4","11361468","11361752","chr12","12928520","12928788","72","1567052"
"chr4","11364245","11364555","chr6","17725472","17725782","33","6361227"
"chr4","11393471","11393750","chrX","73707130","73707403","68","62313659"
"chr4","11398444","11398733","chr14","87389273","87389563","60","75990829"
"chr4","11418803","11419109","chr6","17664868","17665181","41","6246065"
"chr4","11424638","11424769","chr6","17659930","17660055","20","6235292"
"chr4","11429557","11429812","chr1","45872669","45872920","63","34443112"
"chr4","11448115","11448398","chr14","34476124","34476405","57","23028009"
"chr4","11555355","11555660","chr9","95923564","95923862","70","84368209"
"chr4","11675481","11675766","chr6","17391922","17392200","54","5716441"
"chr4","11694240","11694511","chr6","17366683","17366959","30","5672443"
"chr4","11701152","11701459","chr6","39080249","39080559","69","27379097"
"chr4","11747987","11748282","chr6","17325042","17325346","45","5577055"
"chr4","11761307","11761654","chr6","17310907","17311198","86","5549600"
"chr4","11794188","11794297","chr10","12475418","12475526","15","681230"
"chr4","11837313","11837436","chr12","7736838","7736961","17","4100475"
"chr4","11844253","11844544","chr6","17204312","17204613","46","5360059"
"chr4","11891153","11891427","chr16","65389384","65389648","69","53498231"
"chr4","11912842","11912930","chr12","108043594","108043676","16","96130752"
"chr4","11918836","11918999","chr10","49585047","49585201","31","37666211"
"chr4","11969010","11969300","chr6","17101584","17101874","61","5132574"
"chr4","11971101","11971398","chr6","17098669","17098969","42","5127568"
"chr4","11975753","11976050","chr22","13742429","13742732","58","1766676"
"chr4","11977767","11978075","chr6","17092452","17092762","42","5114685"
"chr4","11989526","11989821","chr6","17083881","17084182","45","5094355"
"chr4","11994238","11994536","chr16","16090183","16090488","51","4095945"
"chr4","12014975","12015142","chr9","94824992","94825159","33","82810017"
"chr4","12028105","12028401","chr6","17045898","17046205","52","5017793"
"chr4","12123586","12123695","chr6","16958472","16958585","15","4834886"
"chr4","12138208","12138338","chr6","16935322","16935452","12","4797114"
"chr4","12169345","12169616","chr6","16904597","16904897","55","4735252"
"chr4","12183873","12184079","chr6","16888730","16888934","24","4704857"
"chr4","12203208","12203510","chr5","124656784","124657083","57","112453576"
"chr4","12208184","12208390","chr9","95161454","95161657","39","82953270"
"chr4","12234653","12234945","chr6","16838282","16838584","53","4603629"
"chr4","12263625","12263868","chr4","152507312","152507548","59","140243687"
"chr4","12272827","12273136","chr6","16803176","16803488","51","4530349"
"chr4","12324878","12324993","chr6","16758429","16758545","13","4433551"
"chr4","12329078","12329192","chr6","16752628","16752749","17","4423550"
"chr4","12371890","12372166","chr6","16709409","16709671","50","4337519"
"chr4","12383333","12383658","chr1","212084822","212085134","75","199701489"
"chr4","12388509","12388725","chr16","15732552","15732769","40","3344043"
"chr4","12393786","12394059","chrX","134453409","134453684","56","122059623"
"chr4","12442861","12443127","chr6","35525971","35526244","44","23083110"
"chr4","12444694","12444965","chr5","6057821","6058082","65","6386873"
"chr4","12472566","12472637","chr20","49674431","49674497","17","37201865"
"chr4","12538062","12538171","chrX","41908481","41908594","20","29370419"
"chr4","12658598","12658877","chr6","16447847","16448133","41","3789249"
"chr4","12679030","12679312","chr20","442593","442877","51","12236437"
"chr4","12713100","12713305","chr2B","9266549","9266754","52","3446551"
"chr4","12993528","12993711","chr5","140653814","140654002","54","127660286"
"chr4","13035099","13035274","chr12","109322414","109322590","44","96287315"
"chr4","13056006","13056182","chr12","109322414","109322590","46","96266408"
"chr4","13243011","13243296","chr6","15916048","15916331","43","2673037"
"chr4","13259349","13259683","chr6","15900218","15900558","62","2640869"
"chr4","13287609","13287910","chr6","15880110","15880387","61","2592501"
"chr4","13291381","13291496","chrX","132733314","132733428","21","119441933"
"chr4","13326693","13326858","chr6","15841250","15841429","45","2514557"
"chr4","13420621","13420745","chr7","67398270","67398392","19","53977649"
"chr4","13427292","13427559","chr6","15728527","15728820","65","2301235"
"chr4","13446329","13446615","chr6","15706850","15707186","98","2260521"
"chr4","13452962","13453124","chr1","54206456","54206614","36","40753494"
"chr4","13490431","13490557","chr2A","51365225","51365343","27","37874794"
"chr4","13492349","13492506","chr8","386779","386948","36","13105570"
"chr4","13504121","13504257","chr2B","94897282","94897419","29","81393161"
"chr4","13505065","13505219","chr10","108461325","108461484","34","94956260"
"chr4","13510777","13510896","chr10","87751001","87751121","28","74240224"
"chr4","13511398","13511486","chr5","62223480","62223570","25","48712082"
"chr4","13519335","13519482","chr11","129038829","129038978","39","115519494"
"chr4","13519647","13519762","chr2A","80620532","80620650","21","67100885"
"chr4","13534028","13534169","chr1","30924840","30924975","27","17390812"
"chr4","13541029","13541305","chr10","90821089","90821368","51","77280060"
"chr4","13558314","13558594","chr1","189902282","189902563","55","176343968"
"chr4","13573472","13573762","chr6","15587922","15588221","48","2014450"
"chr4","13606704","13606996","chr6","15539719","15540006","46","1933015"
"chr4","13608255","13608526","chr6","15528726","15528981","59","1920471"
"chr4","13617277","13617335","chr2B","26931720","26931778","10","13314443"
"chr4","13661120","13661223","chr18","48326419","48326520","28","34665299"
"chr4","13661243","13661409","chr15","22466080","22466248","35","8804837"
"chr4","13661909","13662038","chr7","76360858","76360988","21","62698949"
"chr4","13688748","13689035","chr14","34995836","34996117","62","21307088"
"chr4","13691060","13691361","chr5","51767440","51767739","64","38076380"
"chr4","13695118","13695407","chr16","72655413","72655696","69","58960295"
"chr4","13704923","13705017","chr2A","87265301","87265405","26","73560378"
"chr4","13710212","13710333","chr16","8990415","8990539","31","4719797"
"chr4","13728041","13728192","chr1","210449448","210449598","39","196721407"
"chr4","13729892","13729995","chr12","1702","1809","22","13728190"
"chr4","13737672","13737946","chr10","8078554","8078826","59","5659118"
"chr4","13764140","13764435","chr6","15373808","15374104","38","1609668"
"chr4","13785217","13785465","chr6","15354876","15355158","61","1569659"
"chr4","13804565","13804675","chr6","15334694","15334803","11","1530129"
"chr4","13833731","13833998","chr6","15305975","15306270","70","1472244"
"chr4","13860389","13860521","chr7","77000001","77000126","30","63139612"
"chr4","13863243","13863539","chr6","15276355","15276660","45","1413112"
"chr4","13887296","13887581","chr6","15254944","15255236","44","1367648"
"chr4","13901614","13901921","chr7","79602044","79602356","72","65700430"
"chr4","13948300","13948582","chr6","15198625","15198910","44","1250325"
"chr4","13980474","13980785","chr6","15170424","15170746","44","1189950"
"chr4","13983378","13983615","chr11","7959406","7959650","46","6023972"
"chr4","13985242","13985528","chr6","6033957","6034247","62","7951285"
"chr4","14006783","14007067","chr1","130048013","130048302","58","116041230"
"chr4","14146844","14147134","chr1","42327988","42328270","71","28181144"
"chr4","14195092","14195262","chr5","51144248","51144411","40","36949156"
"chr4","14244071","14244164","chr3","49848619","49848712","18","35604548"
"chr4","14283450","14283614","chr7","45531422","45531588","36","31247972"
"chr4","14335547","14335845","chr6","14805643","14805966","49","470096"
"chr4","14381795","14382084","chr5","133062115","133062405","77","118680320"
"chr4","14440927","14441204","chr6","14690386","14690667","33","249459"
"chr4","14494091","14494363","chr3","9770891","9771165","56","4723200"
"chr4","14554741","14555029","chr15","15136106","15136390","59","581365"
"chr4","14604832","14604947","chr1","197987006","197987122","16","183382174"
"chr4","14618078","14618372","chr6","14505931","14506198","49","112147"
"chr4","14673080","14673374","chr6","14449618","14449929","46","223462"
"chr4","14714047","14714169","chr6","14402153","14402277","14","311894"
"chr4","14719922","14720039","chr6","14397538","14397657","16","322384"
"chr4","14814197","14814493","chr6","14325577","14325901","57","488620"
"chr4","14867552","14867825","chr6","14251560","14251858","58","615992"
"chr4","14871485","14871669","chr11","44694637","44694827","32","29823152"
"chr4","14894014","14894130","chr6","14222641","14222757","13","671373"
"chr4","14894151","14894318","chr2B","95198022","95198192","27","80303871"
"chr4","14898343","14898618","chr7","2959934","2960208","55","11938409"
"chr4","14956463","14956579","chr6","14159434","14159551","14","797029"
"chr4","15035383","15035467","chr19","2723880","2723967","23","12311503"
"chr4","15075606","15075893","chr6","14020498","14020793","46","1055108"
"chr4","15092717","15093003","chr6","14002660","14002951","44","1090057"
"chr4","15127683","15127979","chr6","13975288","13975582","40","1152395"
"chr4","15137235","15137477","chr6","13966443","13966705","47","1170792"
"chr4","15168382","15168583","chr16","11932844","11933058","56","3235538"
"chr4","15185484","15185768","chr6","13778064","13778339","39","1407420"
"chr4","15246956","15247246","chr6","13840653","13840946","52","1406303"
"chr4","15262841","15263111","chr6","13857430","13857707","33","1405411"
"chr4","15298985","15299271","chr6","13898069","13898366","44","1400916"
"chr4","15315343","15315668","chrX","110092717","110093024","81","94777374"
"chr4","15334964","15335113","chr2B","82193926","82194071","42","66858962"
"chr4","15336661","15336947","chr7","102781710","102781998","58","87445049"
"chr4","15465322","15465583","chr6","13658495","13658767","35","1806827"
"chr4","15579331","15579494","chr3","43594842","43594998","31","28015511"
"chr4","15601378","15601647","chr6","13536086","13536383","53","2065292"
"chr4","15617166","15617400","chr21","26739014","26739241","53","11121848"
"chr4","15644570","15644849","chr6","13490409","13490701","51","2154161"
"chr4","15663248","15663542","chr6","13472559","13472861","40","2190689"
"chr4","15693744","15694007","chr6","13441705","13441979","51","2252039"
"chr4","15772747","15773043","chr6","13354441","13354737","44","2418306"
"chr4","15809580","15809844","chr6","13316979","13317258","41","2492601"
"chr4","15813864","15814168","chr9","91580829","91581132","62","75766965"
"chr4","15855877","15856164","chr7","1708256","1708538","58","14147621"
"chr4","15876034","15876326","chr6","13199768","13200051","51","2676266"
"chr4","15889679","15889852","chr6","13221325","13221496","17","2668354"
"chr4","15924319","15924543","chr7","64790817","64791051","66","48866498"
"chr4","15991732","15992011","chr8","143095541","143095825","68","127103809"
"chr4","16000868","16001157","chr2B","94932795","94933081","67","78931927"
"chr4","16025168","16025227","chr7","62856195","62856245","18","46831027"
"chr4","16025466","16025576","chr6","13090658","13090763","16","2934808"
"chr4","16052282","16052607","chr2A","39609592","39609910","78","23557310"
"chr4","16054997","16055283","chr6","13054121","13054414","42","3000876"
"chr4","16138402","16138690","chr6","12958497","12958785","42","3179905"
"chr4","16155555","16155852","chr10","15292751","15293048","65","862804"
"chr4","16183941","16184063","chr4","109768935","109769058","18","93584994"
"chr4","16328258","16328383","chr6","12727138","12727269","22","3601120"
"chr4","16379056","16379369","chr6","12663883","12664188","35","3715173"
"chr4","16403647","16403940","chr6","12639035","12639354","45","3764612"
"chr4","16446109","16446407","chr6","12577970","12578293","65","3868139"
"chr4","16467721","16468042","chr17","4985839","4986140","76","11481882"
"chr4","16498035","16498202","chr9","80049051","80049202","46","63551016"
"chr4","16501431","16501554","chr3","42751996","42752119","20","26250565"
"chr4","16508875","16508992","chr7","7518910","7519027","15","8989965"
"chr4","16541318","16541599","chr6","12471585","12471868","35","4069733"
"chr4","16572569","16572836","chr18","11328811","11329081","84","5243758"
"chr4","16698198","16698452","chr7","5138811","5139068","60","11559387"
"chr4","16747452","16747591","chr8","84889028","84889173","35","68141576"
"chr4","16784357","16784442","chr11","15026412","15026497","16","1757945"
"chr4","16862943","16863262","chr7","105771857","105772177","62","88908914"
"chr4","16942499","16942823","chr1","208140428","208140731","85","191197929"
"chr4","16961896","16962124","chr6","12005908","12006132","31","4955988"
"chr4","17011859","17012108","chr6","11941193","11941437","38","5070666"
"chr4","17077104","17077247","chr11","62991394","62991536","36","45914290"
"chr4","17083533","17083834","chr6","11868489","11868790","36","5215044"
"chr4","17227937","17228057","chr7","138263854","138263978","17","121035917"
"chr4","17262013","17262185","chr17","9391102","9391269","33","7870911"
"chr4","17368706","17368969","chrX","134313139","134313411","73","116944433"
"chr4","17465245","17465542","chr6","11478844","11479131","43","5986401"
"chr4","17478969","17479087","chr11","69147152","69147272","32","51668183"
"chr4","17644213","17644395","chrX","48026975","48027157","46","30382762"
"chr4","17683638","17683934","chr1","45145246","45145545","62","27461608"
"chr4","17691459","17691679","chr1","26183728","26183951","70","8492269"
"chr4","17725347","17725635","chr6","11187523","11187809","51","6537824"
"chr4","17727767","17728056","chr21","8726004","8726294","60","9001763"
"chr4","17827144","17827441","chr6","11047719","11048003","59","6779425"
"chr4","17836831","17837122","chr6","11020375","11020672","45","6816456"
"chr4","17842272","17842598","chr8","34560554","34560875","64","16718282"
"chr4","17844809","17845190","chr15","71586933","71587316","108","53742124"
"chr4","17881401","17881725","chr12","124780093","124780403","63","106898692"
"chr4","17884557","17884976","chr8","55167445","55167830","133","37282888"
"chr4","17906580","17906880","chr1","163867986","163868280","61","145961406"
"chr4","17918701","17918989","chr6","10908238","10908523","40","7010463"
"chr4","17952734","17953034","chr6","10873400","10873696","41","7079334"
"chr4","17955608","17955887","chr17","13045832","13046119","68","4909776"
"chr4","17973332","17973619","chr6","10908238","10908523","33","7065094"
"chr4","17973641","17973802","chr6","10908051","10908218","19","7065590"
"chr4","18005475","18005772","chr6","10873400","10873696","42","7132075"
"chr4","18029260","18029560","chrX","48161010","48161318","68","30131750"
"chr4","18039112","18039406","chr6","10840628","10840930","35","7198484"
"chr4","18064909","18065059","chr2B","27215557","27215713","28","9150648"
"chr4","18078432","18078736","chrX","48161010","48161318","65","30082578"
"chr4","18119852","18119969","chr6","10812725","10812842","16","7307127"
"chr4","18148255","18148538","chr1","32344927","32345203","73","14196672"
"chr4","18171881","18172167","chr6","10717685","10717985","47","7454196"
"chr4","18190008","18190294","chr6","10717685","10717985","44","7472323"
"chr4","18253490","18253776","chr6","10656601","10656902","57","7596889"
"chr4","18273582","18273887","chr6","10637240","10637539","54","7636342"
"chr4","18279173","18279541","chr6","10631065","10631429","39","7648108"
"chr4","18328534","18328670","chr10","30690604","30690743","31","12362070"
"chr4","18460103","18460221","chr6","10403385","10403502","15","8056718"
"chr4","18512935","18513038","chr2A","32890737","32890837","18","14377802"
"chr4","18648576","18648888","chr6","10194230","10194553","53","8454346"
"chr4","18779414","18779703","chr6","10036391","10036678","25","8743023"
"chr4","18972154","18972311","chr1","138968329","138968481","34","119996175"
"chr4","19158518","19158825","chr6","9633459","9633728","80","9525059"
"chr4","19162196","19162442","chr8","55208634","55208892","74","36046438"
"chr4","19221349","19221661","chr6","9557233","9557498","71","9664116"
"chr4","19333436","19333691","chr3","32336937","32337197","71","13003501"
"chr4","19630882","19631094","chr6","9054911","9055073","69","10575971"
"chr4","19845127","19845409","chr6","8809867","8810151","41","11035260"
"chr4","19909520","19909812","chr6","8746667","8746963","45","11162853"
"chr4","19916403","19916700","chr6","8739945","8740246","46","11176458"
"chr4","20043422","20043540","chrX","16504327","16504444","20","3539095"
"chr4","20085800","20086075","chr2B","1165821","1166081","70","18919979"
"chr4","20164246","20164577","chr6","8483571","8483880","49","11680675"
"chr4","20231834","20232124","chr6","8389208","8389507","43","11842626"
"chr4","20251163","20251395","chr6","8375248","8375478","28","11875915"
"chr4","20256708","20256950","chr6","8369671","8369922","36","11887037"
"chr4","20269063","20269333","chr19","11027025","11027300","61","9242038"
"chr4","20298829","20299133","chr6","8329655","8329967","58","11969174"
"chr4","20506373","20506676","chr6","8130720","8131025","32","12375653"
"chr4","20551454","20551600","chr18","33792155","33792279","42","13240701"
"chr4","20575897","20576201","chr7","78818816","78819119","65","58242919"
"chr4","20600703","20600977","chrX","24116204","24116475","69","3515501"
"chr4","20620650","20620930","chr6","8007624","8007903","35","12613026"
"chr4","20669079","20669364","chr6","7935039","7935330","48","12734040"
"chr4","20723359","20723482","chr10","12650705","12650831","32","8072654"
"chr4","20745401","20745537","chr12","11398071","11398205","32","9347330"
"chr4","20758083","20758379","chr6","7836518","7836791","44","12921565"
"chr4","20820658","20820919","chr6","7783590","7783852","47","13037068"
"chr4","20826331","20826606","chr3","140823475","140823736","64","119997144"
"chr4","20846705","20847050","chr6","7759263","7759613","47","13087442"
"chr4","20892745","20893029","chr13","85577797","85578078","62","64685052"
"chr4","20896778","20897080","chr6","42796916","42797238","49","21900138"
"chr4","20973245","20973515","chr6","7710952","7711223","35","13262293"
"chr4","20996188","20996477","chr19","13906464","13906745","72","7089724"
"chr4","21010400","21010504","chr4","15029692","15029801","22","5980708"
"chr4","21056629","21056772","chr1","193134715","193134856","35","172078086"
"chr4","21056832","21057121","chr18","44352958","44353255","57","23296126"
"chr4","21078569","21078870","chr5","38814652","38814947","71","17736083"
"chr4","21091791","21092088","chr6","7617277","7617575","38","13474514"
"chr4","21112470","21112760","chr6","7594942","7595236","29","13517528"
"chr4","21118420","21118714","chr6","7590116","7590420","45","13528304"
"chr4","21140615","21140933","chr6","7570696","7570989","49","13569919"
"chr4","21152961","21153104","chr6","101541116","101541235","55","80388155"
"chr4","21164378","21164665","chr6","7553335","7553615","40","13611043"
"chr4","21172331","21172590","chr6","7541238","7541501","31","13631093"
"chr4","21194142","21194415","chr6","7508993","7509266","33","13685149"
"chr4","21233732","21233885","chr2A","17347236","17347397","44","3886496"
"chr4","21243945","21244232","chr6","7448390","7448682","43","13795555"
"chr4","21270751","21271028","chr6","7424380","7424668","43","13846371"
"chr4","21279786","21280093","chr8","9109840","9110131","59","12169946"
"chr4","21291144","21291247","chr5","73068853","73068957","31","51777709"
"chr4","21291277","21291404","chr16","24603067","24603195","36","3311790"
"chr4","21314708","21314930","chr2A","41631786","41632002","55","20317078"
"chr4","21342571","21342684","chr10","91291144","91291253","25","69948573"
"chr4","21384457","21384751","chr6","7288477","7288763","52","14095980"
"chr4","21388867","21389109","chr11","109263352","109263599","51","87874485"
"chr4","21442607","21442913","chr6","7233995","7234295","48","14208612"
"chr4","21487206","21487287","chr5","82419171","82419254","11","60931965"
"chr4","21499104","21499381","chr4","116894853","116895138","66","95395749"
"chr4","21528621","21528735","chr10","93040219","93040335","19","71511598"
"chr4","21575014","21575308","chr6","7110613","7110926","52","14464401"
"chr4","21580437","21580548","chr6","7105611","7105725","10","14474826"
"chr4","21583484","21583821","chr6","7102321","7102609","73","14481163"
"chr4","21587309","21587627","chr1","45032090","45032394","60","23444781"
"chr4","21594576","21594863","chr14","75080552","75080837","56","53485976"
"chr4","21618059","21618380","chr6","7068495","7068810","61","14549564"
"chr4","21620868","21620988","chr5","36443274","36443394","24","14822406"
"chr4","21632730","21633013","chr6","7055336","7055624","36","14577394"
"chr4","21680790","21680908","chr2B","95597592","95597708","18","73916802"
"chr4","21690643","21690762","chr17","58216621","58216738","31","36525978"
"chr4","21714092","21714243","chr5","24543631","24543781","32","2829539"
"chr4","21723624","21723885","chr6","6976402","6976676","34","14747222"
"chr4","21733524","21733776","chr14","12685673","12685921","55","9047851"
"chr4","21740653","21740778","chr10","12650705","12650831","37","9089948"
"chr4","21772588","21772701","chr11","63361264","63361380","31","41588676"
"chr4","21802930","21803034","chr4","87969008","87969113","20","66166078"
"chr4","21806223","21806327","chr5","141874614","141874722","20","120068391"
"chr4","21865934","21866231","chr6","6833771","6834070","53","15032163"
"chr4","21909855","21910149","chr6","6791541","6791835","44","15118314"
"chr4","21918705","21918913","chr6","6783432","6783633","29","15135273"
"chr4","21955071","21955347","chr1","33490889","33491174","65","11535818"
"chr4","22049940","22050247","chr6","6650155","6650468","47","15399785"
"chr4","22052807","22052954","chr12","91805211","91805359","35","69752404"
"chr4","22083131","22083416","chr6","6610599","6610864","57","15472532"
"chr4","22111060","22111183","chr6","6591151","6591273","15","15519909"
"chr4","22285557","22285821","chr6","6415389","6415657","41","15870168"
"chr4","22375812","22376078","chr6","6328602","6328881","43","16047210"
"chr4","22424997","22425097","chr11","129606474","129606576","22","107181477"
"chr4","22433610","22433711","chr16","21862680","21862783","16","570930"
"chr4","22662646","22662932","chr6","6033957","6034247","38","16628689"
"chr4","22689871","22690029","chr7","79271528","79271684","35","56581657"
"chr4","22760118","22760201","chr6","5911953","5912036","7","16848165"
"chr4","22864536","22864741","chr6","5808428","5808637","28","17056108"
"chr4","22898010","22898101","chrX","47268046","47268133","22","24370036"
"chr4","22899081","22899367","chr6","5772596","5772866","47","17126485"
"chr4","22924141","22924394","chr6","5743300","5743560","27","17180841"
"chr4","22941702","22942018","chr13","2804614","2804920","48","20137088"
"chr4","22971598","22971740","chr10","30690604","30690743","35","7719006"
"chr4","23035088","23035364","chr6","5586912","5587205","51","17448176"
"chr4","23162736","23162882","chr2B","94897282","94897419","33","71734546"
"chr4","23169666","23169956","chr6","5457565","5457876","47","17712101"
"chr4","23260570","23260707","chr5","36819199","36819339","46","13558629"
"chr4","23359973","23360119","chr16","76317400","76317554","39","52957427"
"chr4","23360723","23361023","chr20","32567324","32567616","65","9206601"
"chr4","23385020","23385300","chr6","5241708","5241991","44","18143312"
"chr4","23437674","23437960","chr6","5183746","5184033","30","18253928"
"chr4","23440553","23440862","chr6","42969052","42969358","72","19528499"
"chr4","23506180","23506473","chr6","5118835","5119132","35","18387345"
"chr4","23562639","23562890","chr4","164504402","164504650","58","140941763"
"chr4","23564988","23565113","chrX","24150920","24151040","18","585932"
"chr4","23568071","23568364","chr6","5056860","5057153","30","18511211"
"chr4","23597631","23597757","chr6","5025129","5025255","18","18572502"
"chr4","23600190","23600536","chr6","5022637","5023000","71","18577553"
"chr4","23604175","23604321","chrX","71151088","71151230","27","47546913"
"chr4","23606656","23606948","chr6","5018308","5018597","44","18588348"
"chr4","23616605","23616929","chr6","5008869","5009167","74","18607736"
"chr4","23696902","23697077","chr6","4941206","4941378","19","18755696"
"chr4","23721398","23721701","chr6","4923303","4923592","59","18798095"
"chr4","23788683","23789016","chr13","57765647","57765963","86","33976964"
"chr4","23850441","23850620","chr6","4813918","4814094","29","19036523"
"chr4","23852804","23853111","chr6","4811422","4811719","50","19041382"
"chr4","23894206","23894481","chr6","4758908","4759199","42","19135298"
"chr4","23961802","23961906","chr5","79026120","79026226","17","55064318"
"chr4","23964995","23965291","chr6","4701881","4702179","33","19263114"
"chr4","23965751","23966037","chr6","4701138","4701427","31","19264613"
"chr4","23977360","23977655","chr6","4688100","4688400","38","19289260"
"chr4","23989333","23989553","chr6","4677872","4678098","34","19311461"
"chr4","23994521","23994793","chr6","4673153","4673443","58","19321368"
"chr4","24000259","24000563","chr6","4667506","4667815","41","19332753"
"chr4","24023035","24023337","chr6","4641925","4642223","33","19381110"
"chr4","24034678","24034878","chr10","27117159","27117365","45","3082481"
"chr4","24079406","24079713","chr8","74017379","74017682","69","49937973"
"chr4","24097073","24097367","chr1","27341382","27341674","51","3244309"
"chr4","24106196","24106493","chr6","4562410","4562706","37","19543786"
"chr4","24126152","24126457","chr6","4530012","4530308","41","19596140"
"chr4","24138904","24139166","chr6","4517302","4517557","25","19621602"
"chr4","24181277","24181387","chrX","47966335","47966445","17","23785058"
"chr4","24220784","24221052","chr1","205414460","205414739","59","181193676"
"chr4","24235824","24235974","chr5","41656639","41656778","46","17420815"
"chr4","24249920","24250215","chr6","4415605","4415923","53","19834315"
"chr4","24283547","24283707","chr4","83983716","83983868","35","59700169"
"chr4","24483179","24483462","chr6","4202349","4202640","47","20280830"
"chr4","24526628","24526885","chr6","4170930","4171187","23","20355698"
"chr4","24541724","24542060","chr12","100493327","100493639","94","75951603"
"chr4","24678432","24678658","chr6","4035709","4035932","33","20642723"
"chr4","24686846","24687083","chr8","85713029","85713267","69","61026183"
"chr4","24687551","24687614","chr13","61631585","61631645","16","36944034"
"chr4","24689600","24689894","chr6","4024318","4024614","51","20665282"
"chr4","24820129","24820358","chr19","37049465","37049693","45","12229336"
"chr4","24985599","24985891","chr6","3807992","3808285","37","21177607"
"chr4","25052554","25052811","chr5","50563478","50563729","62","25510924"
"chr4","25055119","25055270","chr7","100549835","100549986","32","75494716"
"chr4","25058897","25059172","chr6","3743939","3744215","33","21314958"
"chr4","25148624","25148884","chr6","3635021","3635292","43","21513603"
"chr4","25175266","25175540","chr6","3613654","3613946","61","21561612"
"chr4","25230442","25230679","chr10","37439324","37439560","63","12208882"
"chr4","25249245","25249461","chr6","3536963","3537182","15","21712282"
"chr4","25269706","25269906","chr7","2363764","2363952","51","22905942"
"chr4","25363846","25364150","chr5","9692972","9693274","74","15670874"
"chr4","25428472","25428764","chr2A","67807116","67807408","59","42378644"
"chr4","25543826","25544126","chr5","40597225","40597528","55","15053399"
"chr4","25695238","25695323","chr3","184897069","184897159","20","159201831"
"chr4","25736047","25736355","chr6","3061202","3061514","44","22674845"
"chr4","25745036","25745187","chr1","22298981","22299131","35","3446055"
"chr4","25775400","25775664","chr6","3026087","3026331","59","22749313"
"chr4","25790758","25790913","chr2B","27751482","27751639","35","1960724"
"chr4","25794816","25795078","chr6","3005496","3005772","40","22789320"
"chr4","25807530","25807604","chr10","50433693","50433769","12","24626163"
"chr4","25808095","25808254","chr3","10866047","10866211","36","14942048"
"chr4","25840655","25840961","chr6","2957686","2957965","62","22882969"
"chr4","25913010","25913154","chr5","4272991","4273140","32","21640019"
"chr4","25944064","25944314","chr15","7741184","7741421","73","18202880"
"chr4","25956320","25956617","chr9","82724396","82724682","59","56768076"
"chr4","25965422","25965493","chr20","49674431","49674497","18","23709009"
"chr4","26024856","26024965","chr7","72466171","72466282","21","46441315"
"chr4","26026043","26026152","chrX","41908481","41908594","20","15882438"
"chr4","26081869","26082141","chr6","2804623","2804905","36","23277246"
"chr4","26138135","26138358","chr6","2751331","2751549","29","23386804"
"chr4","26148151","26148336","chr14","37788052","37788225","46","11639901"
"chr4","26154904","26155063","chr1","35990433","35990582","31","9835529"
"chr4","26184120","26184415","chr6","2713684","2713989","44","23470436"
"chr4","26227453","26227566","chr1","40024521","40024624","33","13797068"
"chr4","26273364","26273683","chr6","2631118","2631434","51","23642246"
"chr4","26399416","26399676","chr6","18531346","18531609","53","7868070"
"chr4","26434461","26434765","chr6","2499159","2499466","41","23935302"
"chr4","26541019","26541169","chr1","31279143","31279286","36","4738124"
"chr4","26542345","26542659","chr6","2404950","2405277","79","24137395"
"chr4","26543495","26543664","chr6","3491038","3491211","50","23052457"
"chr4","26544056","26544273","chr16","28658110","28658328","40","2114054"
"chr4","26570880","26571168","chr7","4970487","4970775","58","21600393"
"chr4","26636746","26637033","chr6","2301123","2301424","50","24335623"
"chr4","26714854","26715016","chr5","51144248","51144411","40","24429394"
"chr4","26795199","26795498","chr6","2153184","2153494","52","24642015"
"chr4","26810581","26810878","chr6","2137355","2137673","57","24673226"
"chr4","26816503","26816755","chr6","2131625","2131875","35","24684878"
"chr4","26880092","26880375","chr6","2064068","2064362","50","24816024"
"chr4","26930770","26930943","chr6","2006020","2006194","23","24924750"
"chr4","26931343","26931475","chr10","112111608","112111739","21","85180265"
"chr4","26981548","26981665","chr20","46080183","46080300","15","19098635"
"chr4","26998439","26998736","chr6","1926002","1926299","29","25072437"
"chr4","27031239","27031474","chr16","8503343","8503569","65","18527896"
"chr4","27041317","27041610","chr6","1891593","1891898","62","25149724"
"chr4","27050930","27051102","chr2B","126162282","126162438","42","99111352"
"chr4","27093689","27093979","chr6","1834679","1834972","35","25259010"
"chr4","27187783","27188086","chr6","1758564","1758873","54","25429219"
"chr4","27191136","27191438","chr6","1755761","1756066","42","25435375"
"chr4","27292459","27292736","chr6","1654209","1654492","38","25638250"
"chr4","27322836","27323109","chr6","1627571","1627857","48","25695265"
"chr4","27339516","27339796","chr2A","33497435","33497720","64","6157919"
"chr4","27447403","27447697","chr6","1510437","1510734","41","25936966"
"chr4","27493590","27493886","chr6","1464243","1464548","55","26029347"
"chr4","27548692","27548967","chr6","1443065","1443372","53","26105627"
"chr4","27571270","27571579","chr6","1427438","1427734","54","26143832"
"chr4","27580985","27581098","chr2B","16261383","16261481","28","11319602"
"chr4","27605587","27605892","chr7","1730368","1730668","62","25875219"
"chr4","27616179","27616489","chr6","1386551","1386861","41","26229628"
"chr4","27705798","27705895","chr1","39325820","39325928","23","11620022"
"chr4","27718548","27718663","chr1","94267623","94267739","19","66549075"
"chr4","27724406","27724702","chr6","1282587","1282891","39","26441819"
"chr4","27829552","27829844","chr6","1187817","1188105","45","26641735"
"chr4","27968213","27968500","chr6","1082323","1082616","39","26885890"
"chr4","28074839","28075122","chr6","979269","979561","68","27095570"
"chr4","28110610","28110887","chr6","932036","932316","46","27178574"
"chr4","28127535","28127641","chr6","918066","918176","17","27209469"
"chr4","28187370","28187578","chr6","867263","867478","24","27320107"
"chr4","28220780","28221070","chr6","832781","833073","45","27387999"
"chr4","28301930","28302199","chr6","744473","744750","45","27557457"
"chr4","28339097","28339208","chr6","706490","706604","18","27632607"
"chr4","28494482","28494787","chr6","571905","572203","51","27922577"
"chr4","28494933","28495094","chr7","66572608","66572761","35","38077675"
"chr4","28577788","28578084","chr6","499190","499501","53","28078598"
"chr4","28697290","28697428","chr1","193134715","193134856","32","164437425"
"chr4","28744654","28744880","chr6","348211","348443","41","28396443"
"chr4","28862608","28862919","chr5","79524474","79524776","70","50661866"
"chr4","29005810","29006042","chr6","106576","106810","35","28899234"
"chr4","30042196","30042478","chr6","30226152","30226407","62","183956"
"chr4","30194207","30194490","chr6","31956176","31956467","60","1761969"
"chr4","30373053","30373172","chr8","9176979","9177104","32","21196074"
"chr4","30388071","30388191","chr6","30777634","30777755","17","389563"
"chr4","30512268","30512515","chr6","30876774","30877041","43","364506"
"chr4","30551686","30551963","chr1","139768169","139768436","72","109216483"
"chr4","30591602","30591892","chr6","30995666","30995943","50","404064"
"chr4","30732717","30733021","chr14","48510671","48510969","63","17777954"
"chr4","30763643","30763795","chr10","49585047","49585201","34","18821404"
"chr4","30773048","30773311","chr1","27882391","27882663","67","2890657"
"chr4","30788146","30788270","chr12","1498656","1498783","43","29289490"
"chr4","30822673","30822771","chr6","31109978","31110091","26","287305"
"chr4","30864489","30864615","chr16","69212656","69212783","31","38348167"
"chr4","30866809","30866911","chr4","8625041","8625142","26","22241768"
"chr4","30885448","30885746","chr12","108745776","108746083","58","77860328"
"chr4","30891272","30891436","chr7","106533466","106533634","31","75642194"
"chr4","30900295","30900603","chr6","31193367","31193651","53","293072"
"chr4","30922049","30922340","chr6","31214889","31215180","49","292840"
"chr4","30987808","30988086","chr5","157102432","157102719","69","126114624"
"chr4","31005929","31006200","chr3","109596935","109597203","66","78591006"
"chr4","31006206","31006333","chr12","93713225","93713347","24","62707019"
"chr4","31080306","31080448","chr6","31326571","31326726","26","246265"
"chr4","31125774","31125931","chr14","67825056","67825217","51","36699282"
"chr4","31129675","31129802","chr6","31372912","31373042","14","243237"
"chr4","31147797","31147922","chr2A","20545290","20545415","26","10602507"
"chr4","31173930","31173983","chr16","40176661","40176715","13","9002731"
"chr4","31174780","31175042","chr19","40370912","40371163","57","9196132"
"chr4","31176314","31176612","chr6","31419152","31419457","43","242838"
"chr4","31183716","31184018","chr8","49256423","49256714","61","18072707"
"chr4","31210230","31210350","chr6","31451801","31451920","20","241571"
"chr4","31230888","31231083","chr6","31470288","31470484","17","239400"
"chr4","31233297","31233572","chr6","31472639","31472915","40","239342"
"chr4","31243634","31243929","chr6","31485621","31485928","48","241987"
"chr4","31256234","31256515","chr6","31496092","31496363","75","239858"
"chr4","31280404","31280710","chr6","31523535","31523845","37","243131"
"chr4","31422948","31423057","chr4","71940021","71940126","21","40517073"
"chr4","31437379","31437640","chr6","31651647","31651897","57","214268"
"chr4","31496942","31497236","chr6","31712558","31712854","38","215616"
"chr4","31501314","31501609","chr6","31712558","31712854","42","211244"
"chr4","31517962","31518245","chr6","31725434","31725739","54","207472"
"chr4","31519515","31519634","chr10","91176792","91176912","27","59657277"
"chr4","31533357","31533478","chr5","150258918","150259044","27","118725561"
"chr4","31546649","31546928","chr2A","74156596","74156872","79","42609947"
"chr4","31713371","31713664","chr6","31956176","31956467","48","242805"
"chr4","31729830","31730088","chr12","111795351","111795600","72","80065521"
"chr4","31814813","31814928","chr14","45229440","45229558","25","13414627"
"chr4","31817517","31817652","chr6","31988955","31989088","22","171438"
"chr4","31872034","31872329","chr6","31956176","31956467","45","84142"
"chr4","31895572","31895681","chr20","30141940","30142059","19","1753632"
"chr4","31935527","31935674","chr2B","27215557","27215713","32","4719970"
"chr4","32015289","32015436","chr1","26307080","26307228","33","5708209"
"chr4","32072759","32073032","chr6","32149119","32149384","43","76360"
"chr4","32118826","32119109","chr6","32190052","32190339","32","71226"
"chr4","32148239","32148526","chr10","85082966","85083267","59","52934727"
"chr4","32149657","32149783","chr19","7798413","7798535","33","24351244"
"chr4","32151989","32152115","chr10","40874912","40875038","19","8722923"
"chr4","32164016","32164309","chr6","32213703","32214000","34","49687"
"chr4","32290902","32291050","chr5","3296328","3296466","35","28994574"
"chr4","32319629","32319712","chr10","142430183","142430266","8","110110554"
"chr4","32367975","32368097","chr6","37801775","37801890","22","5433800"
"chr4","32369807","32370107","chr3","58326549","58326835","62","25956742"
"chr4","32418355","32418647","chr6","32454689","32454982","59","36334"
"chr4","32423322","32423459","chr8","103799790","103799921","38","71376468"
"chr4","32429261","32429410","chr10","49585047","49585201","41","17155786"
"chr4","32429770","32429883","chr19","39922165","39922281","29","7492395"
"chr4","32430630","32430908","chr4","39833293","39833578","49","7402663"
"chr4","32434898","32435170","chr5","41849869","41850150","65","9414971"
"chr4","32449305","32449614","chr6","32477129","32477411","58","27824"
"chr4","32453033","32453247","chr6","32481328","32481546","24","28295"
"chr4","32510605","32510870","chr3","120656330","120656597","62","88145725"
"chr4","32510903","32511207","chr6","32522542","32522851","36","11639"
"chr4","32512873","32513138","chr3","120656330","120656597","62","88143457"
"chr4","32513171","32513475","chr6","32522542","32522851","37","9371"
"chr4","32571676","32571999","chr7","77306579","77306892","69","44734903"
"chr4","32611071","32611201","chr18","46891062","46891193","14","14279991"
"chr4","32624592","32624902","chr6","32665561","32665846","63","40969"
"chr4","32651010","32651329","chr6","32682044","32682346","51","31034"
"chr4","32669888","32670182","chr6","32700376","32700669","26","30488"
"chr4","32673038","32673329","chr6","32701768","32702076","45","28730"
"chr4","32682017","32682129","chr17","20045897","20046009","18","12636120"
"chr4","32705426","32705632","chr16","59663520","59663732","42","26958094"
"chr4","32707511","32707782","chr12","108542193","108542464","55","75834682"
"chr4","32750736","32750841","chr10","27439136","27439242","19","5311600"
"chr4","32808760","32808977","chr6","32829438","32829657","28","20678"
"chr4","32864757","32865055","chr6","32902518","32902820","36","37761"
"chr4","32893104","32893398","chr6","32926343","32926627","47","33239"
"chr4","32907701","32907917","chr6","32940697","32940907","31","32996"
"chr4","32933321","32933613","chr6","32975930","32976239","54","42609"
"chr4","33018870","33018969","chr19","4106799","4106900","19","28912071"
"chr4","33241385","33241698","chr6","33299890","33300195","41","58505"
"chr4","33250603","33250897","chr6","33307782","33308071","63","57179"
"chr4","33308222","33308535","chr20","35781259","35781569","70","2473037"
"chr4","33405532","33405676","chr6","81874403","81874546","32","48468871"
"chr4","33421296","33421576","chr12","32032110","32032393","65","1389186"
"chr4","33433797","33434041","chr10","28106344","28106596","70","5327453"
"chr4","33445946","33446241","chr9","82724396","82724682","58","49278450"
"chr4","33448395","33448677","chr6","11187523","11187809","47","22260872"
"chr4","33511546","33511768","chr13","55517881","55518099","69","22006335"
"chr4","33526833","33527151","chr5","22886770","22887072","77","10640063"
"chr4","33576510","33576809","chr6","33307782","33308071","70","268728"
"chr4","33592017","33592318","chr14","83303649","83303949","64","49711632"
"chr4","33617905","33618196","chr6","33453262","33453554","43","164643"
"chr4","33646023","33646278","chr6","33480758","33481036","58","165265"
"chr4","33647982","33648119","chr20","34414083","34414223","31","766101"
"chr4","33733627","33733794","chrX","41480605","41480763","41","7746978"
"chr4","33836463","33836707","chr6","33655236","33655473","32","181227"
"chr4","33837007","33837287","chr6","33655751","33656046","39","181256"
"chr4","33846493","33846677","chr5","51190788","51190964","53","17344295"
"chr4","34020930","34021052","chr6","33879824","33879945","13","141106"
"chr4","34026890","34027187","chr6","33886250","33886544","37","140640"
"chr4","34058888","34059059","chr3","159263100","159263275","38","125204212"
"chr4","34135686","34135808","chr1","37936932","37937055","25","3801246"
"chr4","34151772","34151898","chr16","59134844","59134968","27","24983072"
"chr4","34158227","34158513","chr8","124654735","124655037","68","90496508"
"chr4","34159116","34159414","chr6","34025204","34025508","47","133912"
"chr4","34274357","34274467","chr1","135266736","135266847","26","100992379"
"chr4","34310810","34311108","chr6","34138683","34138976","39","172127"
"chr4","34313806","34313920","chr6","34141216","34141339","19","172590"
"chr4","34316371","34316667","chr6","34143692","34143992","36","172679"
"chr4","34320593","34320874","chr5","8734711","8734988","61","25585882"
"chr4","34321721","34322022","chr6","34149899","34150205","33","171822"
"chr4","34325587","34325698","chr8","19325971","19326085","24","14999616"
"chr4","34366754","34367084","chr11","5453929","5454236","99","28912825"
"chr4","34380420","34380716","chr1","133729720","133730008","59","99349300"
"chr4","34385231","34385523","chr1","186884878","186885162","66","152499647"
"chr4","34428408","34428701","chr18","7114626","7114918","56","27313782"
"chr4","34440653","34440758","chr13","9559854","9559959","19","24880799"
"chr4","34476543","34476676","chr6","34309270","34309400","15","167273"
"chr4","34558587","34558859","chr6","115732401","115732684","60","81173814"
"chr4","34593103","34593394","chr16","11426989","11427288","65","23166114"
"chr4","34630029","34630342","chr6","34458960","34459259","51","171069"
"chr4","34830310","34830592","chr6","34617476","34617762","31","212834"
"chr4","34837669","34837953","chr6","34624400","34624704","63","213269"
"chr4","34847440","34847563","chr17","26472199","26472320","20","8375241"
"chr4","34869145","34869422","chr6","34655724","34656023","52","213421"
"chr4","34878780","34878815","chr22","3220321","3220359","6","31658459"
"chr4","34894139","34894416","chr6","34655724","34656023","52","238415"
"chr4","34903253","34903304","chr3","64494131","64494181","8","29590878"
"chr4","35000262","35000543","chr6","34766348","34766629","25","233914"
"chr4","35053032","35053301","chr9","111503064","111503349","63","76450032"
"chr4","35092970","35093248","chr4","116685711","116685997","61","81592741"
"chr4","35102933","35103009","chr12","123755259","123755337","19","88652326"
"chr4","35160542","35160804","chr19","4570608","4570877","73","30589934"
"chr4","35165216","35165332","chr5","8107226","8107342","15","27057990"
"chr4","35166661","35166770","chr14","54877920","54878035","24","19711259"
"chr4","35181800","35181958","chr19","39910881","39911043","43","4729081"
"chr4","35188388","35188656","chr6","34963914","34964198","46","224474"
"chr4","35192684","35192803","chr6","34972723","34972842","12","219961"
"chr4","35201988","35202268","chr6","34981942","34982224","38","220046"
"chr4","35204497","35204644","chr12","110108425","110108564","40","74903928"
"chr4","35207259","35207543","chr1","226599133","226599412","60","191391874"
"chr4","35222276","35222564","chr6","35003477","35003789","57","218799"
"chr4","35237403","35237562","chr10","49585047","49585201","32","14347644"
"chr4","35244691","35244935","chr6","35018897","35019132","37","225794"
"chr4","35251084","35251236","chr10","49585047","49585201","38","14333963"
"chr4","35260195","35260533","chr6","35032995","35033331","48","227200"
"chr4","35263519","35263643","chr1","9666032","9666156","20","25597487"
"chr4","35265745","35266023","chr14","38438003","38438290","67","3172258"
"chr4","35268815","35268983","chr1","86726894","86727049","40","51458079"
"chr4","35283754","35283835","chr12","120844835","120844914","18","85561081"
"chr4","35290191","35290359","chrUn_CABD030133067v1","1994","2155","44","35288197"
"chr4","35291327","35291465","chr5","22719283","22719416","30","12572044"
"chr4","35292211","35292516","chr6","35063438","35063740","42","228773"
"chr4","35293887","35294025","chr5","22719283","22719416","42","12574604"
"chr4","35314000","35314260","chr12","104861943","104862206","65","69547943"
"chr4","35329332","35329551","chr3","57997401","57997617","44","22668069"
"chr4","35337552","35337830","chrX","70757717","70758005","60","35420165"
"chr4","35338193","35338244","chr16","41615599","41615643","19","6277406"
"chr4","35338382","35338627","chr7","3178634","3178870","58","32159748"
"chr4","35350512","35350808","chr4","72417885","72418179","58","37067373"
"chr4","35364882","35365195","chr16","24038891","24039196","59","11325991"
"chr4","35380966","35381269","chr6","35137142","35137438","35","243824"
"chr4","35390384","35390554","chr3","10866047","10866211","39","24524337"
"chr4","35391240","35391287","chr7","79558509","79558556","8","44167269"
"chr4","35447919","35448046","chr6","35200294","35200426","12","247625"
"chr4","35456264","35456526","chr6","35208590","35208876","45","247674"
"chr4","35481734","35482026","chr6","35235331","35235637","37","246403"
"chr4","35497966","35498248","chr2B","124806974","124807268","62","89309008"
"chr4","35506456","35506700","chr5","31802541","31802781","51","3703915"
"chr4","35521181","35521348","chr6","35277961","35278135","33","243220"
"chr4","35550107","35550421","chr6","35305858","35306165","54","244249"
"chr4","35550460","35550713","chr9","108406244","108406492","64","72855784"
"chr4","35557125","35557283","chr3","140680766","140680922","35","105123641"
"chr4","35560889","35561157","chr17","81519917","81520189","65","45959028"
"chr4","35572899","35573106","chr9","12157163","12157372","48","23415736"
"chr4","35580682","35580955","chr7","132085631","132085914","68","96504949"
"chr4","35581098","35581313","chr20","18133504","18133721","44","17447594"
"chr4","35584250","35584545","chr6","35337865","35338165","47","246385"
"chr4","35592471","35592737","chr11","123875047","123875316","64","88282576"
"chr4","35600352","35600486","chr6","35351831","35351966","10","248521"
"chr4","35608224","35608334","chr9","91909520","91909629","21","56301296"
"chr4","35617158","35617429","chr6","35370760","35371050","40","246398"
"chr4","35617593","35617865","chr6","15607697","15607964","59","20009896"
"chr4","35617886","35618143","chr6","35371350","35371612","60","246536"
"chr4","35630847","35631109","chr19","5675913","5676180","76","29954934"
"chr4","35637577","35637745","chr14","72724722","72724884","39","37087145"
"chr4","35646115","35646342","chr6","35402118","35402370","63","243997"
"chr4","35647701","35647982","chr5","133062115","133062405","79","97414414"
"chr4","35650363","35650684","chr20","932951","933253","79","34717412"
"chr4","35652267","35652461","chr1","207842341","207842548","48","172190074"
"chr4","35666530","35666629","chr5","79630137","79630243","29","43963607"
"chr4","35666689","35666832","chr10","112111608","112111739","35","76444919"
"chr4","35667755","35667849","chr7","43501911","43502007","27","7834156"
"chr4","35697765","35698032","chr6","35454257","35454532","33","243508"
"chr4","35707491","35707785","chr6","35471341","35471636","48","236150"
"chr4","35727869","35728014","chr5","130959094","130959245","33","95231225"
"chr4","35737415","35737699","chr19","45627063","45627351","66","9889648"
"chr4","35745111","35745399","chr11","85242672","85242963","54","49497561"
"chr4","35754448","35754714","chr6","35525971","35526244","39","228477"
"chr4","35782248","35782542","chr1","7654423","7654722","66","28127825"
"chr4","35789012","35789299","chr6","35562738","35563024","43","226274"
"chr4","35799470","35799752","chr6","35572715","35573011","41","226755"
"chr4","35801270","35801544","chr6","35574229","35574502","32","227041"
"chr4","35814646","35814929","chr6","35589443","35589722","48","225203"
"chr4","35885217","35885533","chr6","35674367","35674677","38","210850"
"chr4","35925753","35925903","chr1","52325310","52325464","38","16399557"
"chr4","35998982","35999284","chr7","3036346","3036648","46","32962636"
"chr4","36016576","36016872","chr12","116633770","116634069","64","80617194"
"chr4","36021503","36021788","chr1","91019845","91020139","60","54998342"
"chr4","36030064","36030351","chr7","5095566","5095848","55","30934498"
"chr4","36043235","36043524","chr6","35789089","35789379","40","254146"
"chr4","36050888","36051174","chr6","35798780","35799078","49","252108"
"chr4","36076278","36076583","chr6","35823029","35823334","34","253249"
"chr4","36105708","36105760","chr19","46945886","46945935","15","10840178"
"chr4","36126517","36126807","chr5","2142069","2142357","58","33984448"
"chr4","36144156","36144455","chr6","35887988","35888295","42","256168"
"chr4","36190788","36191107","chr6","35937375","35937682","53","253413"
"chr4","36191247","36191380","chr19","57927252","57927388","33","21736005"
"chr4","36198316","36198589","chr6","35945059","35945358","53","253257"
"chr4","36200100","36200402","chr6","35946879","35947188","38","253221"
"chr4","36220205","36220514","chr6","35967313","35967618","63","252892"
"chr4","36234477","36234786","chr6","35967313","35967618","63","267164"
"chr4","36261923","36262296","chr7","56989457","56989782","119","20727534"
"chr4","36263719","36263902","chr19","2165168","2165341","46","34098551"
"chr4","36302740","36303028","chr11","12051039","12051342","73","24251701"
"chr4","36340036","36340310","chr3","189972673","189972963","76","153632637"
"chr4","36356165","36356435","chr18","19949790","19950070","51","16406375"
"chr4","36405000","36405324","chr6","36118047","36118363","44","286953"
"chr4","36410839","36410956","chr22","14821499","14821616","17","21589340"
"chr4","36434615","36434694","chr7","5928715","5928794","25","30505900"
"chr4","36449073","36449333","chr6","26449883","26450150","69","9999190"
"chr4","36458932","36459034","chr16","20230072","20230173","23","16228860"
"chr4","36472088","36472398","chr6","36173376","36173688","51","298712"
"chr4","36474380","36474669","chr12","109576143","109576435","62","73101763"
"chr4","36478459","36478728","chr6","36179955","36180225","28","298504"
"chr4","36497572","36497863","chr6","36199208","36199510","46","298364"
"chr4","36508877","36509162","chr6","36211094","36211387","46","297783"
"chr4","36511674","36511979","chr6","36213674","36213980","48","298000"
"chr4","36519193","36519307","chr16","37103044","37103155","24","583851"
"chr4","36520467","36520655","chr6","36221535","36221737","36","298932"
"chr4","36536785","36537056","chr6","36237205","36237478","35","299580"
"chr4","36542901","36543053","chr6","36243350","36243511","34","299551"
"chr4","36565508","36565630","chr22","19703833","19703956","20","16861675"
"chr4","36568400","36568523","chr20","30238448","30238572","20","6329952"
"chr4","36582394","36582706","chr6","36283687","36283995","31","298707"
"chr4","36583399","36583607","chr6","36285005","36285249","57","298394"
"chr4","36590421","36590707","chr2B","18972545","18972822","76","17617876"
"chr4","36594518","36594732","chrX","133674647","133674857","54","97080129"
"chr4","36604231","36604453","chr18","55165662","55165888","54","18561431"
"chr4","36613665","36613781","chr12","110132732","110132848","15","73519067"
"chr4","36625738","36626034","chr6","36316087","36316382","33","309651"
"chr4","36631123","36631306","chr3","45185357","45185533","37","8554234"
"chr4","36632139","36632447","chr6","36321603","36321891","51","310536"
"chr4","36633488","36633792","chr6","36322954","36323254","39","310534"
"chr4","36638137","36638460","chr6","36327708","36328034","50","310429"
"chr4","36649534","36649827","chr6","36339192","36339474","42","310342"
"chr4","36665310","36665514","chr1","146118969","146119169","50","109453659"
"chr4","36718035","36718130","chr1","157737408","157737505","19","121019373"
"chr4","36720475","36720732","chr20","49617065","49617314","66","12896590"
"chr4","36720758","36721012","chr6","36413480","36413735","35","307278"
"chr4","36728844","36728968","chr3","162991924","162992048","24","126263080"
"chr4","36744145","36744447","chr6","36434428","36434727","26","309717"
"chr4","36801640","36801936","chr12","119615680","119615968","49","82814040"
"chr4","36847864","36848148","chr1","221569715","221570002","61","184721851"
"chr4","36862479","36862772","chr6","36555339","36555630","56","307140"
"chr4","36880978","36881257","chr7","129054394","129054678","54","92173416"
"chr4","36915220","36915393","chr3","42799984","42800158","35","5884764"
"chr4","36925972","36926100","chr6","154295698","154295815","43","117369726"
"chr4","36961381","36961545","chr6","36640552","36640719","25","320829"
"chr4","36962776","36962929","chr18","19703130","19703280","29","17259646"
"chr4","37022213","37022376","chr6","36709133","36709299","23","313080"
"chr4","37062955","37063133","chr2B","64407403","64407576","45","27344448"
"chr4","37070551","37070702","chr3","40933011","40933169","33","3862460"
"chr4","37102393","37102506","chr14","57074506","57074623","30","19972113"
"chr4","37111486","37111638","chr9","108241495","108241645","32","71130009"
"chr4","37114262","37114489","chr6","36791131","36791360","26","323131"
"chr4","37128324","37128635","chr14","59486336","59486644","59","22358012"
"chr4","37131495","37131813","chr6","36814672","36814972","48","316823"
"chr4","37190595","37190719","chr7","79700768","79700899","23","42510173"
"chr4","37249968","37250272","chr6","36923533","36923827","47","326435"
"chr4","37290884","37291189","chr6","36972459","36972767","40","318425"
"chr4","37345210","37345340","chr11","69147152","69147272","32","31801942"
"chr4","37375363","37375658","chr1","91019845","91020139","74","53644482"
"chr4","37382254","37382385","chr4","125510855","125510989","29","88128601"
"chr4","37384664","37384946","chr1","28877322","28877596","57","8507342"
"chr4","37392643","37392939","chr6","37050938","37051233","26","341705"
"chr4","37418683","37418842","chr19","15955029","15955193","33","21463654"
"chr4","37456990","37457284","chr12","121913892","121914192","62","84456902"
"chr4","37471721","37471994","chr6","37148099","37148390","45","323622"
"chr4","37495108","37495365","chr12","111159327","111159583","61","73664219"
"chr4","37502297","37502451","chr18","70037968","70038128","37","32535671"
"chr4","37503622","37503785","chr21","34056187","34056352","33","3447435"
"chr4","37504834","37505107","chr6","37177935","37178237","64","326899"
"chr4","37519926","37520224","chr13","23521366","23521659","52","13998560"
"chr4","37530443","37530567","chr7","11248117","11248241","18","26282326"
"chr4","37546855","37547025","chr5","55037275","55037442","38","17490420"
"chr4","37563272","37563515","chr6","37232340","37232610","62","330932"
"chr4","37567900","37567961","chr17","11652108","11652166","16","25915792"
"chr4","37568502","37568538","chr7","2700776","2700806","12","34867726"
"chr4","37568565","37568668","chr3","124652697","124652800","29","87084132"
"chr4","37578050","37578310","chr6","37246538","37246796","56","331512"
"chr4","37581152","37581257","chr4","196402447","196402553","21","158821295"
"chr4","37627466","37627675","chr6","37291594","37291805","39","335872"
"chr4","37671018","37671305","chr11","73672149","73672437","66","36001131"
"chr4","37760684","37760990","chr6","37418532","37418872","70","342152"
"chr4","37822071","37822334","chr13","1388453","1388725","51","36433618"
"chr4","37841795","37841915","chr6","37492694","37492814","11","349101"
"chr4","37851969","37852243","chr2B","68664933","68665206","64","30812964"
"chr4","37881435","37881709","chr6","37532937","37533221","46","348498"
"chr4","37889299","37889583","chr6","37610021","37610302","42","279278"
"chr4","37896300","37896557","chr6","37616504","37616761","25","279796"
"chr4","37904449","37904704","chr6","37624671","37624933","31","279778"
"chr4","37933689","37933959","chr6","37646079","37646348","39","287610"
"chr4","37967460","37967772","chr8","98755171","98755484","63","60787711"
"chr4","37979748","37979975","chr9","114615846","114616073","48","76636098"
"chr4","37982679","37982987","chr6","20689530","20689838","66","17293149"
"chr4","38015295","38015593","chr6","37723786","37724077","46","291509"
"chr4","38042368","38042490","chr3","125378751","125378875","12","87336383"
"chr4","38043043","38043344","chr6","37748244","37748543","41","294799"
"chr4","38048345","38048605","chr6","37753140","37753410","43","295205"
"chr4","38076842","38076912","chr10","12916598","12916671","15","25160244"
"chr4","38118085","38118239","chr6","89356333","89356484","36","51238248"
"chr4","38118586","38118645","chr22","25301738","25301802","16","12816848"
"chr4","38119158","38119227","chr11","117007677","117007748","11","78888519"
"chr4","38120486","38120601","chr10","88748074","88748188","18","50627588"
"chr4","38120675","38120820","chr14","86999208","86999349","29","48878533"
"chr4","38121163","38121279","chr1","182798095","182798212","15","144676932"
"chr4","38124138","38124463","chr10","34577896","34578191","74","3546242"
"chr4","38139902","38140061","chr19","12403025","12403187","38","25736877"
"chr4","38143325","38143504","chr16","72178217","72178410","44","34034892"
"chr4","38148377","38148665","chr3","73899347","73899635","61","35750970"
"chr4","38168122","38168414","chr1","224688853","224689152","56","186520731"
"chr4","38169565","38169845","chr4","151944849","151945132","62","113775284"
"chr4","38181529","38181819","chr6","37853789","37854091","35","327740"
"chr4","38190018","38190174","chr15","38005326","38005481","34","184692"
"chr4","38248781","38248890","chr3","39499383","39499487","35","1250602"
"chr4","38249549","38249745","chr16","19467323","19467540","54","18782226"
"chr4","38260859","38261140","chr6","37933212","37933510","41","327647"
"chr4","38270900","38271196","chr22","24598382","24598677","56","13672518"
"chr4","38271321","38271618","chr6","37944119","37944423","43","327202"
"chr4","38296541","38296803","chr6","37968425","37968721","60","328116"
"chr4","38299764","38299900","chr1","94267470","94267597","33","55967706"
"chr4","38308187","38308422","chr6","37978460","37978685","35","329727"
"chr4","38379144","38379405","chr6","38044280","38044551","36","334864"
"chr4","38382810","38382935","chr19","38385145","38385272","20","2335"
"chr4","38384151","38384275","chr2A","33601363","33601487","19","4782788"
"chr4","38387960","38388204","chr1","162435147","162435391","62","124047187"
"chr4","38388217","38388341","chr6","38052357","38052481","15","335860"
"chr4","38425640","38425935","chr19","47833553","47833844","52","9407913"
"chr4","38554112","38554423","chr6","38189900","38190202","44","364212"
"chr4","38565693","38566000","chr6","38200161","38200467","31","365532"
"chr4","38599190","38599353","chr7","1810491","1810660","43","36788699"
"chr4","38646539","38646832","chr5","96942875","96943163","59","58296336"
"chr4","38692711","38693002","chr19","7007610","7007884","84","31685101"
"chr4","38702101","38702464","chr6","7759263","7759613","103","30942838"
"chr4","38735880","38736163","chr15","78533208","78533502","70","39797328"
"chr4","38736692","38736995","chr6","38365563","38365876","42","371129"
"chr4","38741907","38742134","chr6","38370247","38370468","34","371660"
"chr4","38742139","38742247","chr18","57245881","57245993","26","18503742"
"chr4","38752637","38752812","chr6","38379548","38379718","21","373089"
"chr4","38756691","38756989","chr16","25214461","25214758","62","13542230"
"chr4","38794454","38794748","chrX","41024366","41024656","60","2229912"
"chr4","38882694","38882810","chr6","38528994","38529102","24","353700"
"chr4","38901379","38901679","chr1","40430488","40430784","72","1529109"
"chr4","39025178","39025455","chr1","180457953","180458240","60","141432775"
"chr4","39072285","39072579","chr16","27228803","27229094","76","11843482"
"chr4","39079183","39079379","chr1","163632639","163632827","55","124553456"
"chr4","39136033","39136342","chr6","38783830","38784163","54","352203"
"chr4","39151507","39151789","chr6","38795030","38795319","39","356477"
"chr4","39171544","39171824","chr6","38811918","38812190","49","359626"
"chr4","39256711","39256991","chr6","38893022","38893319","43","363689"
"chr4","39275196","39275421","chr16","27636156","27636376","44","11639040"
"chr4","39285431","39285719","chr6","38918920","38919205","35","366511"
"chr4","39290027","39290228","chr6","38924074","38924270","30","365953"
"chr4","39292231","39292533","chr1","27953308","27953607","62","11338923"
"chr4","39294434","39294676","chr6","38929072","38929335","41","365362"
"chr4","39295929","39296201","chr6","38930585","38930869","53","365344"
"chr4","39315806","39316050","chr6","38953072","38953315","24","362734"
"chr4","39353206","39353477","chr6","38994463","38994741","40","358743"
"chr4","39392554","39392844","chr19","1510634","1510923","52","37881920"
"chr4","39401786","39401867","chr5","75695411","75695493","11","36293625"
"chr4","39402472","39402774","chr6","39032130","39032414","44","370342"
"chr4","39404510","39404776","chr6","39034140","39034445","74","370370"
"chr4","39425503","39425806","chr6","39051402","39051717","50","374101"
"chr4","39466231","39466342","chr5","22710618","22710735","20","16755613"
"chr4","39473018","39473300","chr6","39102390","39102685","48","370628"
"chr4","39473326","39473611","chr7","71049501","71049771","63","31576175"
"chr4","39499905","39499997","chr1","186301749","186301846","27","146801844"
"chr4","39500002","39500178","chr4","198307161","198307333","50","158807159"
"chr4","39511754","39512041","chr12","1651377","1651661","63","37860377"
"chr4","39514292","39514371","chr6","39150247","39150326","6","364045"
"chr4","39517491","39517603","chr15","63623501","63623614","12","24106010"
"chr4","39542770","39542926","chr3","46437495","46437660","32","6894725"
"chr4","39599909","39600049","chr6","39281175","39281318","26","318734"
"chr4","39643824","39644131","chr6","39339915","39340217","31","303909"
"chr4","39664490","39664821","chr6","39360974","39361333","70","303516"
"chr4","39729936","39730228","chr4","8159027","8159316","54","31570909"
"chr4","39765849","39766117","chr6","39455944","39456215","31","309905"
"chr4","39771013","39771143","chr6","39460737","39460865","17","310276"
"chr4","39783266","39783541","chr3","23601459","23601740","59","16181807"
"chr4","39808454","39808743","chr3","145246806","145247099","60","105438352"
"chr4","39852709","39852864","chr19","17654369","17654530","30","22198340"
"chr4","39897304","39897572","chr6","39570732","39571016","53","326572"
"chr4","40163568","40163872","chr6","39810379","39810677","50","353189"
"chr4","40193671","40193883","chr8","103055546","103055760","54","62861875"
"chr4","40305389","40305494","chr1","45273792","45273898","24","4968403"
"chr4","40307146","40307496","chr6","39945901","39946263","55","361245"
"chr4","40430789","40431077","chr6","40110321","40110603","56","320468"
"chr4","40467745","40468039","chr6","40140043","40140343","36","327702"
"chr4","40682750","40683056","chrX","41847868","41848170","66","1165118"
"chr4","40752807","40753042","chr6","40439965","40440207","29","312842"
"chr4","40884254","40884543","chr6","40541031","40541331","59","343223"
"chr4","41087707","41087978","chr6","91293876","91294158","66","50206169"
"chr4","41386481","41386798","chr6","41024336","41024651","35","362145"
"chr4","41421291","41421339","chr9","56600489","56600534","16","15179198"
"chr4","41421430","41421669","chr19","14194080","14194318","53","27227350"
"chr4","41441323","41441483","chrX","101077801","101077950","58","59636478"
"chr4","41566167","41566438","chr6","41200069","41200349","37","366098"
"chr4","41593420","41593576","chr5","49653517","49653681","39","8060097"
"chr4","41597295","41597594","chr6","41225939","41226253","55","371356"
"chr4","41852074","41852376","chr3","70045616","70045917","68","28193542"
"chr4","41864087","41864373","chr6","41468577","41468873","43","395510"
"chr4","41869170","41869330","chr7","140343570","140343733","37","98474400"
"chr4","42456843","42457188","chr6","42049269","42049571","84","407574"
"chr4","42529666","42529826","chr5","151470871","151471036","42","108941205"
"chr4","42562968","42563201","chr5","20456815","20457063","67","22106153"
"chr4","42564832","42565116","chr1","94467761","94468044","68","51902929"
"chr4","42633644","42633763","chr2A","80620532","80620650","20","37986888"
"chr4","42737344","42737643","chr1","212084822","212085134","72","169347478"
"chr4","42850316","42850469","chr6","42371994","42372147","31","478322"
"chr4","42935136","42935416","chr6","42450473","42450747","44","484663"
"chr4","42978403","42978556","chr10","29754500","29754651","38","13223903"
"chr4","42979018","42979138","chr7","44128291","44128409","18","1149273"
"chr4","43022022","43022316","chr6","42538392","42538690","31","483630"
"chr4","43025128","43025212","chr6","42541522","42541606","8","483606"
"chr4","43026307","43026420","chr12","19445243","19445358","18","23581064"
"chr4","43032575","43032689","chr9","15394099","15394221","17","27638476"
"chr4","43033118","43033201","chr6","4705174","4705263","18","38327944"
"chr4","43098419","43098552","chr3","15286672","15286801","21","27811747"
"chr4","43146550","43146782","chr6","42679307","42679570","44","467243"
"chr4","43147939","43148230","chr6","42680073","42680381","50","467866"
"chr4","43184162","43184281","chr4","5230896","5231025","28","37953266"
"chr4","43184546","43184737","chr6","119878272","119878462","50","76693726"
"chr4","43191961","43192235","chr6","42721575","42721852","35","470386"
"chr4","43194269","43194354","chr19","44457165","44457246","15","1262896"
"chr4","43204117","43204311","chr6","42732279","42732477","36","471838"
"chr4","43248271","43248477","chr2A","28015269","28015472","68","15233002"
"chr4","43277028","43277315","chr8","82443687","82443966","55","39166659"
"chr4","43330570","43330851","chr7","66246986","66247273","56","22916416"
"chr4","43333884","43334083","chr9","106169411","106169607","46","62835527"
"chr4","43339600","43339726","chr9","112841011","112841143","19","69501411"
"chr4","43366019","43366290","chr6","42905346","42905623","40","460673"
"chr4","43460645","43460792","chr12","105294886","105295035","28","61834241"
"chr4","43475242","43475475","chr1","7606342","7606560","59","35868900"
"chr4","43476794","43477080","chr6","43001524","43001806","36","475270"
"chr4","43480216","43480333","chr6","43005328","43005445","19","474888"
"chr4","43497776","43498054","chr6","43023707","43023985","28","474069"
"chr4","43524261","43524530","chr6","43049960","43050228","46","474301"
"chr4","43611029","43611181","chr19","5169265","5169417","22","38441764"
"chr4","43659804","43660081","chr19","13956002","13956298","70","29703802"
"chr4","43685838","43686166","chr6","43195789","43196122","53","490049"
"chr4","43702448","43702729","chr6","43205782","43206055","37","496666"
"chr4","43709272","43709566","chr6","43212241","43212536","39","497031"
"chr4","43736751","43736871","chr6","43239524","43239644","13","497227"
"chr4","43742985","43743269","chr6","43243098","43243387","42","499887"
"chr4","43795922","43796227","chr3","129506194","129506492","60","85710272"
"chr4","43836463","43836568","chr5","26761731","26761826","34","17074732"
"chr4","43858312","43858618","chr6","43363524","43363826","65","494788"
"chr4","43873327","43873622","chr15","17921731","17922006","73","25951596"
"chr4","43889132","43889443","chr6","43399181","43399500","62","489951"
"chr4","43936105","43936404","chr12","121913892","121914192","53","77977787"
"chr4","43947976","43948066","chr6","5911953","5912036","23","38036023"
"chr4","43953438","43953558","chr5","133578375","133578499","27","89624937"
"chr4","43970423","43970733","chr6","43490621","43490943","48","479802"
"chr4","43979814","43979895","chr6","43500464","43500539","15","479350"
"chr4","44008488","44008618","chr6","18588428","18588554","32","25420060"
"chr4","44034972","44035275","chr6","43542648","43542948","34","492324"
"chr4","44061905","44062206","chr6","43567977","43568256","59","493928"
"chr4","44104408","44104611","chr6","43604987","43605197","32","499421"
"chr4","44132920","44133214","chr13","10895308","10895590","65","33237612"
"chr4","44140514","44140805","chr1","206504099","206504390","68","162363585"
"chr4","44194775","44194896","chr6","154239364","154239482","27","110044589"
"chr4","44295436","44295547","chr5","48966184","48966302","37","4670748"
"chr4","44301269","44301369","chr1","157737408","157737505","20","113436139"
"chr4","44303875","44304154","chr6","75659339","75659640","52","31355464"
"chr4","44313355","44313653","chr1","45145246","45145545","60","831891"
"chr4","44323769","44324085","chr15","78950552","78950861","69","34626783"
"chr4","44379269","44379484","chr6","43865183","43865401","20","514086"
"chr4","44410339","44410605","chr6","43892414","43892691","39","517925"
"chr4","44422350","44422638","chr6","43912813","43913115","50","509537"
"chr4","44427255","44427579","chr6","146323295","146323593","77","101896040"
"chr4","44450095","44450221","chr2B","51273719","51273843","15","6823624"
"chr4","44452060","44452222","chr1","24245703","24245864","31","20206357"
"chr4","44466126","44466434","chr6","43962752","43963025","60","503374"
"chr4","44509868","44510131","chr6","43995705","43995952","53","514163"
"chr4","44542178","44542302","chr16","40500610","40500729","29","4041568"
"chr4","44545389","44545490","chr9","108579895","108579992","25","64034506"
"chr4","44546014","44546247","chr6","44026702","44026934","61","519312"
"chr4","44555118","44555356","chr20","36318739","36318983","58","8236379"
"chr4","44558996","44559293","chr6","2940940","2941235","80","41618056"
"chr4","44565076","44565185","chr6","42638893","42639005","17","1926183"
"chr4","44607465","44607595","chr2A","38252267","38252397","25","6355198"
"chr4","44668162","44668448","chrX","134453409","134453684","64","89785247"
"chr4","44674589","44674883","chrX","119967705","119967998","56","75293116"
"chr4","44675748","44675920","chr22","4177717","4177888","39","40498031"
"chr4","44710638","44710843","chr16","28877155","28877367","51","15833483"
"chr4","44712650","44712941","chr6","44183941","44184223","52","528709"
"chr4","44725542","44725676","chr6","44197016","44197162","23","528526"
"chr4","44725689","44725991","chr6","44197173","44197474","51","528516"
"chr4","44727184","44727466","chr6","44197952","44198240","47","529232"
"chr4","44749330","44749460","chr15","35101273","35101404","28","9648057"
"chr4","44784289","44784597","chr3","124080996","124081293","58","79296707"
"chr4","44830579","44830860","chr6","44304077","44304398","68","526502"
"chr4","44885172","44885483","chr14","89141565","89141868","61","44256393"
"chr4","44907397","44907705","chr6","44385197","44385502","51","522200"
"chr4","44915448","44915698","chr1","10693512","10693765","69","34221936"
"chr4","44925602","44925864","chr6","44402595","44402893","68","523007"
"chr4","44934069","44934224","chr2B","5744235","5744389","33","39189834"
"chr4","44937429","44937686","chr6","44413327","44413612","63","524102"
"chr4","44949702","44949850","chr1","36426414","36426560","38","8523288"
"chr4","44979814","44979881","chrX","119987004","119987070","15","75007190"
"chr4","44979993","44980124","chr10","117906468","117906600","25","72926475"
"chr4","45033634","45033691","chr9","15751490","15751550","14","29282144"
"chr4","45070717","45070975","chr6","44546586","44546829","40","524131"
"chr4","45172936","45173045","chr15","46133130","46133239","21","960194"
"chr4","45177014","45177336","chr6","44650252","44650556","67","526762"
"chr4","45186728","45187028","chr6","44660328","44660614","53","526400"
"chr4","45332025","45332139","chr20","36397703","36397818","23","8934322"
"chr4","45430148","45430260","chr5","39965598","39965710","20","5464550"
"chr4","45433050","45433285","chr6","44926555","44926804","40","506495"
"chr4","45433502","45433672","chr13","32055352","32055524","36","13378150"
"chr4","45434253","45434534","chr6","44927769","44928070","37","506484"
"chr4","45498131","45498431","chr6","44979007","44979305","36","519124"
"chr4","45515900","45516137","chr6","44998391","44998633","30","517509"
"chr4","45516139","45516249","chr12","46140363","46140469","27","624224"
"chr4","45531009","45531228","chr6","29011077","29011285","47","16519932"
"chr4","45531775","45532070","chr6","45013150","45013441","62","518625"
"chr4","45542350","45542450","chr10","34149086","34149190","24","11393264"
"chr4","45543129","45543288","chr16","38955159","38955317","25","6587970"
"chr4","45571549","45571848","chr6","45045113","45045419","41","526436"
"chr4","45576269","45576595","chr6","45047558","45047854","64","528711"
"chr4","45584763","45585061","chr1","63358617","63358915","53","17773854"
"chr4","45606585","45606873","chrX","118718918","118719200","51","73112333"
"chr4","45655233","45655384","chr5","42752401","42752550","33","2902832"
"chr4","45669822","45670126","chr7","74202807","74203094","80","28532985"
"chr4","45710466","45710767","chr6","45182547","45182845","36","527919"
"chr4","45717203","45717519","chr6","45190272","45190565","57","526931"
"chr4","45722113","45722317","chr1","146118969","146119169","44","100396856"
"chr4","45722603","45722711","chr6","45196326","45196435","14","526277"
"chr4","45765046","45765334","chr6","45235749","45236025","35","529297"
"chr4","45769738","45770024","chr19","36118505","36118788","66","9651233"
"chr4","45778997","45779292","chr6","45250038","45250337","35","528959"
"chr4","45780260","45780374","chr6","45250962","45251084","19","529298"
"chr4","45830004","45830128","chr6","45291574","45291698","17","538430"
"chr4","45920147","45920407","chr6","45385344","45385624","42","534803"
"chr4","45937654","45937957","chr6","45403153","45403447","43","534501"
"chr4","45966869","45967095","chr5","52696452","52696680","53","6729583"
"chr4","45986325","45986584","chr7","2330840","2331092","65","43655485"
"chr4","46163087","46163302","chr6","45626172","45626405","40","536915"
"chr4","46174300","46174571","chr6","45668420","45668730","67","505880"
"chr4","46184992","46185272","chr3","131695355","131695636","57","85510363"
"chr4","46188660","46188978","chr6","45683090","45683376","59","505570"
"chr4","46191404","46191685","chr6","45685818","45686101","21","505586"
"chr4","46192726","46193014","chr6","45687170","45687459","30","505556"
"chr4","46236780","46236901","chr17","26472199","26472320","24","19764581"
"chr4","46290396","46290676","chr7","104356984","104357264","77","58066588"
"chr4","46293796","46294106","chr6","45788813","45789109","59","504983"
"chr4","46353509","46353798","chr13","85913788","85914068","69","39560279"
"chr4","46356599","46356904","chrX","137494501","137494804","74","91137902"
"chr4","46382311","46382619","chr6","45875854","45876146","44","506457"
"chr4","46428696","46428989","chr6","45921020","45921292","65","507676"
"chr4","46448519","46448759","chr11","65253779","65254016","56","18805260"
"chr4","46536036","46536324","chr6","46027306","46027585","43","508730"
"chr4","46540027","46540297","chr6","46031061","46031346","48","508966"
"chr4","46593012","46593274","chr6","46079506","46079774","42","513506"
"chr4","46609577","46609863","chr11","123256135","123256428","58","76646558"
"chr4","46710585","46710662","chr16","28608077","28608150","12","18102508"
"chr4","46712868","46713161","chr6","46229596","46229891","33","483272"
"chr4","46730765","46730920","chr6","15264957","15265121","37","31465808"
"chr4","46761033","46761334","chr6","46310004","46310312","53","451029"
"chr4","46797950","46798249","chr6","46345516","46345824","59","452434"
"chr4","46871697","46871978","chr6","46418302","46418592","38","453395"
"chr4","46925463","46925732","chr6","46469032","46469301","30","456431"
"chr4","46937613","46937870","chr6","46481263","46481515","35","456350"
"chr4","46972004","46972319","chr10","29589731","29590055","76","17382273"
"chr4","47047881","47048093","chr6","110169683","110169896","47","63121802"
"chr4","47094614","47094888","chr6","46681192","46681460","57","413422"
"chr4","47414128","47414263","chr6","77626450","77626592","28","30212322"
"chr4","47467469","47467703","chr4","201575142","201575368","63","154107673"
"chr4","47548557","47548804","chr6","47120847","47121132","65","427710"
"chr4","47597998","47598283","chr1","2285941","2286239","67","45312057"
"chr4","47612439","47612729","chr4","120243844","120244136","62","72631405"
"chr4","47757256","47757401","chr20","32123638","32123783","30","15633618"
"chr4","47858809","47858934","chr16","17601043","17601160","33","30257766"
"chr4","47887170","47887477","chr6","47427913","47428216","47","459257"
"chr4","48373859","48374185","chr6","47915941","47916252","73","457918"
"chr4","48404914","48405136","chr5","21362175","21362395","60","27042739"
"chr4","48501009","48501313","chr6","48044658","48044966","41","456351"
"chr4","48570030","48570279","chr6","48111856","48112091","63","458174"
"chr4","48620027","48620309","chr6","48153921","48154225","50","466106"
"chr4","48691121","48691355","chr8","98888922","98889156","69","50197801"
"chr4","48764458","48764736","chr13","55152440","55152714","58","6387982"
"chr4","48831009","48831042","chr10","85713787","85713817","9","36882778"
"chr4","48831801","48831895","chrX","46325766","46325860","21","2506035"
"chr4","48831913","48832066","chr11","71289441","71289597","43","22457528"
"chr4","48860532","48860828","chr14","53007445","53007743","57","4146913"
"chr4","48865930","48866252","chr14","61976761","61977057","96","13110831"
"chr4","48869151","48869462","chr3","133625823","133626121","70","84756672"
"chr4","48870513","48870787","chr4","151515489","151515763","76","102644976"
"chr4","48889013","48889127","chr6","154239364","154239482","26","105350351"
"chr4","48903510","48903622","chr6","48488461","48488583","22","415049"
"chr4","48907709","48907830","chr6","48492641","48492762","5","415068"
"chr4","48922154","48922278","chr20","43708602","43708725","27","5213552"
"chr4","48930875","48931024","chr8","42822730","42822873","43","6108145"
"chr4","48943884","48944176","chr7","5329845","5330131","66","43614039"
"chr4","48958062","48958300","chr6","48536138","48536392","54","421924"
"chr4","48967861","48968125","chr6","48539838","48540114","37","428023"
"chr4","49023693","49023983","chrX","53757535","53757836","78","4733842"
"chr4","49053686","49053981","chr6","48624023","48624316","36","429663"
"chr4","49068347","49068655","chr6","48637604","48637905","61","430743"
"chr4","49085706","49086003","chr7","73334125","73334415","80","24248419"
"chr4","49093349","49093650","chr6","48662809","48663121","35","430540"
"chr4","49130397","49130563","chr19","16879306","16879475","43","32251091"
"chr4","49130846","49130963","chrX","155639917","155640033","17","106509071"
"chr4","49265959","49266261","chr6","48833353","48833636","61","432606"
"chr4","49404652","49404936","chr6","48974929","48975221","45","429723"
"chr4","49430075","49430344","chr6","49002356","49002660","63","427719"
"chr4","49602576","49602860","chr6","49186670","49186963","47","415906"
"chr4","49620515","49620730","chr20","36084199","36084404","71","13536316"
"chr4","49675553","49675831","chr6","49269012","49269297","45","406541"
"chr4","49769666","49769972","chr2B","69738439","69738736","76","19968773"
"chr4","49960462","49960574","chr6","49637062","49637189","29","323400"
"chr4","50179113","50179373","chr16","31649333","31649595","74","18529780"
"chr4","50192017","50192274","chr6","91471610","91471882","74","41279593"
"chr4","50359696","50359941","chr9","15376638","15376892","66","34983058"
"chr4","50383890","50384162","chr2B","125946116","125946397","67","75562226"
"chr4","50513256","50513548","chr6","50335122","50335416","48","178134"
"chr4","50516770","50517069","chr6","50341128","50341428","73","175642"
"chr4","50610137","50610376","chr14","34026704","34026939","61","16583433"
"chr4","50778676","50778965","chr6","50618480","50618747","69","160196"
"chr4","50819369","50819477","chrX","49674314","49674431","28","1145055"
"chr4","50874426","50874548","chr6","36689294","36689414","11","14185132"
"chr4","50966595","50966894","chr7","78818816","78819119","74","27852221"
"chr4","51195784","51196079","chr6","108244210","108244502","73","57048426"
"chr4","51323504","51323727","chr4","96471238","96471457","57","45147734"
"chr4","51435789","51436060","chr7","65859600","65859872","64","14423811"
"chr4","51592315","51592569","chr6","51532467","51532734","60","59848"
"chr4","51652972","51653229","chrX","154312614","154312857","81","102659642"
"chr4","51671952","51672259","chr4","94287671","94287968","79","42615719"
"chr4","51738409","51738696","chr6","51675003","51675286","48","63406"
"chr4","51838519","51838689","chr2A","13681359","13681534","50","38157160"
"chr4","51849191","51849474","chr6","51780263","51780527","56","68928"
"chr4","51852970","51853248","chr6","51784046","51784327","35","68924"
"chr4","51995072","51995352","chr6","51914336","51914645","59","80736"
"chr4","52050968","52051251","chr6","51968498","51968783","32","82470"
"chr4","52123485","52123782","chr6","52031625","52031905","45","91860"
"chr4","52127991","52128150","chr5","62885644","62885808","39","10757653"
"chr4","52144706","52144999","chr6","52055948","52056243","40","88758"
"chr4","52282501","52282735","chr6","52184977","52185211","29","97524"
"chr4","52313244","52313608","chr6","52212260","52212552","111","100984"
"chr4","52409515","52409782","chr6","52232171","52232471","64","177344"
"chr4","52976821","52976935","chr6","52748404","52748518","15","228417"
"chr4","53097872","53098111","chr4","155891372","155891602","53","102793500"
"chr4","53259628","53259951","chr6","52980023","52980333","43","279605"
"chr4","53373709","53374024","chr6","53082642","53082947","42","291067"
"chr4","53431788","53432020","chr6","53129857","53130094","41","301931"
"chr4","53493802","53494086","chr6","53189998","53190278","43","303804"
"chr4","53506632","53506721","chr6","59500001","59500090","21","5993369"
"chr4","53506752","53506919","chr16","12221155","12221315","43","41285597"
"chr4","53513993","53514298","chr6","53210416","53210727","45","303577"
"chr4","53535360","53535636","chr6","53233257","53233548","45","302103"
"chr4","53545773","53545903","chr7","26158438","26158564","34","27387335"
"chr4","53568910","53569199","chr6","53262359","53262654","39","306551"
"chr4","53636298","53636584","chr6","53330709","53330994","39","305589"
"chr4","53638286","53638587","chr6","53333318","53333618","38","304968"
"chr4","53667208","53667485","chr1","40331351","40331633","55","13335857"
"chr4","53673170","53673467","chr3","71281382","71281674","80","17608212"
"chr4","53685209","53685506","chr6","53374339","53374637","57","310870"
"chr4","53738872","53739174","chr6","53430011","53430316","42","308861"
"chr4","53775737","53776030","chr14","51291421","51291711","70","2484316"
"chr4","53799755","53800053","chr6","53470766","53471055","40","328989"
"chr4","53939628","53939933","chr6","53601419","53601717","52","338209"
"chr4","53970248","53970553","chr6","53631899","53632207","33","338349"
"chr4","54016990","54017226","chr6","35525971","35526244","62","18491019"
"chr4","54116819","54117104","chr4","162741400","162741665","61","108624581"
"chr4","54119576","54119883","chr6","53929455","53929769","40","190121"
"chr4","54196755","54197034","chr6","53998577","53998846","69","198178"
"chr4","54225034","54225302","chr3","127356553","127356832","69","73131519"
"chr4","54295165","54295455","chr6","54075411","54075707","45","219754"
"chr4","54297982","54298286","chr6","54078237","54078535","45","219745"
"chr4","54323337","54323572","chr6","54097121","54097356","27","226216"
"chr4","54340756","54340883","chr2A","64428266","64428391","22","10087510"
"chr4","54348715","54348993","chr6","54122914","54123200","48","225801"
"chr4","54400671","54400807","chr6","54185068","54185203","18","215603"
"chr4","54426745","54427030","chr15","18736365","18736646","77","35690380"
"chr4","54448227","54448386","chr8","14833580","14833735","35","39614647"
"chr4","54489050","54489264","chr6","110612092","110612302","44","56123042"
"chr4","54531825","54532050","chr8","78076907","78077132","57","23545082"
"chr4","54546345","54546634","chr19","34850731","34851015","59","19695614"
"chr4","54604015","54604120","chr1","221790148","221790254","25","167186133"
"chr4","54715877","54716139","chr6","54479760","54480006","60","236117"
"chr4","54786828","54786909","chr6","54568201","54568281","6","218627"
"chr4","54787573","54787688","chr6","54568968","54569085","17","218605"
"chr4","54834508","54834796","chr4","72417885","72418179","55","17583377"
"chr4","54921052","54921190","chr6","77626450","77626592","36","22705398"
"chr4","54922027","54922136","chr5","61088728","61088837","21","6166701"
"chr4","54942620","54942735","chr8","8138565","8138683","30","46804055"
"chr4","55008123","55008376","chr3","199806453","199806703","59","144798330"
"chr4","55068682","55068828","chr6","54854335","54854487","25","214347"
"chr4","55123860","55124135","chr6","54905912","54906188","33","217948"
"chr4","55157334","55157561","chr2A","80566646","80566861","69","25409312"
"chr4","55173080","55173216","chr1","134756500","134756633","25","79583420"
"chr4","55431541","55431670","chr1","208797989","208798118","25","153366448"
"chr4","55573304","55573629","chr6","55304371","55304688","80","268933"
"chr4","55838482","55838788","chr6","55574137","55574429","47","264345"
"chr4","55857196","55857478","chr12","32584711","32584994","61","23272485"
"chr4","55973550","55973750","chr18","74436813","74437020","49","18463263"
"chr4","56108818","56109086","chr12","113199761","113200025","56","57090943"
"chr4","56202691","56202734","chr9","45108452","45108492","9","11094239"
"chr4","56266205","56266354","chr14","58946732","58946889","32","2680527"
"chr4","56345345","56345466","chr14","54877920","54878035","27","1467425"
"chr4","56394699","56395004","chr6","56109317","56109636","55","285382"
"chr4","56457369","56457574","chr14","73980614","73980818","49","17523245"
"chr4","56511730","56511975","chr6","56248726","56248995","66","263004"
"chr4","56588947","56589064","chr5","111619245","111619362","32","55030298"
"chr4","57137314","57137579","chr6","56761268","56761549","44","376046"
"chr4","57153676","57153811","chr6","18588428","18588554","38","38565248"
"chr4","57205538","57205660","chr6","56817136","56817258","10","388402"
"chr4","57560007","57560309","chr6","57164481","57164773","51","395526"
"chr4","57703127","57703440","chr6","57286431","57286730","56","416696"
"chr4","57714457","57714722","chr5","125523460","125523742","66","67809003"
"chr4","57727133","57727415","chr6","57310460","57310744","35","416673"
"chr4","57877929","57878139","chr6","57442555","57442764","29","435374"
"chr4","58043797","58044087","chr7","28366007","28366296","57","29677790"
"chr4","58045104","58045194","chr8","85681193","85681293","22","27636089"
"chr4","58054153","58054428","chr6","57641432","57641706","41","412721"
"chr4","58095109","58095343","chr5","98682121","98682358","74","40587012"
"chr4","58125103","58125400","chr1","205872389","205872688","61","147747286"
"chr4","58188744","58189024","chr6","57776186","57776458","45","412558"
"chr4","58234429","58234724","chr6","57821279","57821586","41","413150"
"chr4","58247391","58247683","chr6","57833981","57834275","49","413410"
"chr4","58277588","58277867","chr1","227415933","227416230","62","169138345"
"chr4","58283075","58283343","chr7","74202807","74203094","62","15919732"
"chr4","58327748","58327841","chr12","107234513","107234609","21","48906765"
"chr4","58331108","58331394","chr6","57900129","57900408","36","430979"
"chr4","58397078","58397350","chr1","140616451","140616717","73","82219373"
"chr4","58401669","58401947","chr6","57970556","57970851","49","431113"
"chr4","58402196","58402407","chr6","57971096","57971308","26","431100"
"chr4","58403105","58403161","chr4","171500441","171500495","14","113097336"
"chr4","58426367","58426475","chr6","57992206","57992306","16","434161"
"chr4","58455382","58455512","chr11","56295752","56295881","18","2159630"
"chr4","58490267","58490553","chr6","58053590","58053887","40","436677"
"chr4","58498620","58498901","chr15","71884735","71885021","68","13386115"
"chr4","58517613","58517905","chr6","58081066","58081356","45","436547"
"chr4","58535490","58535684","chr6","58098458","58098635","36","437032"
"chr4","58582261","58582343","chr10","144050807","144050895","25","85468546"
"chr4","58595289","58595594","chr6","58157463","58157738","67","437826"
"chr4","58614898","58615226","chrX","16339935","16340261","76","42274963"
"chr4","58688859","58688956","chr10","117001518","117001614","19","58312659"
"chr4","58735370","58735662","chr6","58261312","58261598","41","474058"
"chr4","58756624","58756945","chr6","58284910","58285200","83","471714"
"chr4","58793655","58793927","chrX","103978893","103979160","54","45185238"
"chr4","58876172","58876484","chr11","85632161","85632468","65","26755989"
"chr4","58946384","58946590","chr6","58483080","58483309","48","463304"
"chr4","58990342","58990530","chr1","92700081","92700256","54","33709739"
"chr4","58997876","58997999","chr1","91956065","91956192","24","32958189"
"chr4","59016489","59016750","chr1","135207339","135207594","72","76190850"
"chr4","59064879","59065157","chr6","58656613","58656885","36","408266"
"chr4","59267888","59268169","chr10","85928599","85928878","63","26660711"
"chr4","59299022","59299325","chr6","58946535","58946830","57","352487"
"chr4","59318037","59318332","chr6","59486734","59487029","39","168697"
"chr4","59360714","59360829","chr8","60679504","60679616","18","1318790"
"chr4","59424926","59425240","chr6","59555134","59555438","55","130208"
"chr4","59451356","59451637","chr2B","64733776","64734053","62","5282420"
"chr4","59471938","59472105","chr3","10866047","10866211","35","48605891"
"chr4","59541392","59541511","chr11","27468160","27468279","15","32073232"
"chr4","59765471","59765737","chr15","27134497","27134773","62","32630974"
"chr4","59878006","59878141","chr6","63224295","63224425","17","3346289"
"chr4","59932913","59933206","chr6","63270858","63271158","49","3337945"
"chr4","60106816","60107055","chr17","7785586","7785814","62","52321230"
"chr4","60321993","60322204","chr6","63684202","63684444","57","3362209"
"chr4","60419723","60420023","chr6","63753086","63753380","49","3333363"
"chr4","60457944","60458211","chr6","63788062","63788337","60","3330118"
"chr4","61412696","61413001","chr6","64776655","64776969","52","3363959"
"chr4","61432349","61432642","chr18","19692377","19692667","58","41739972"
"chr4","61652221","61652504","chr6","65008507","65008779","37","3356286"
"chr4","61667074","61667353","chr6","65023243","65023510","49","3356169"
"chr4","61754928","61755239","chr8","78488834","78489147","69","16733906"
"chr4","61755519","61755786","chr6","65131467","65131734","41","3375948"
"chr4","61756979","61757200","chr6","65132951","65133179","37","3375972"
"chr4","61761659","61761894","chr8","74772775","74773004","65","13011116"
"chr4","61801853","61801967","chr6","37492694","37492814","23","24309159"
"chr4","61812012","61812237","chr6","65196344","65196569","26","3384332"
"chr4","61819870","61820187","chr6","157098761","157099075","72","95278891"
"chr4","61827017","61827321","chr4","124931915","124932208","58","63104898"
"chr4","61827348","61827604","chr6","90914254","90914495","68","29086906"
"chr4","61984319","61984437","chr6","65380351","65380474","24","3396032"
"chr4","62031296","62031597","chr6","65428832","65429129","34","3397536"
"chr4","62507911","62507996","chr6","65876507","65876592","6","3368596"
"chr4","62789431","62789724","chr5","102241438","102241724","72","39452007"
"chr4","62948516","62948822","chr6","66284329","66284639","48","3335813"
"chr4","63018824","63019108","chr6","66357496","66357768","47","3338672"
"chr4","63030835","63031001","chr3","126718238","126718408","42","63687403"
"chr4","63284524","63284824","chr6","66620045","66620343","42","3335521"
"chr4","63465991","63466291","chr6","66833929","66834231","44","3367938"
"chr4","63525649","63525863","chr6","66887231","66887440","39","3361582"
"chr4","63830630","63830935","chr6","67185049","67185360","48","3354419"
"chr4","63871324","63871619","chr6","67223010","67223299","46","3351686"
"chr4","63922060","63922262","chr6","67270340","67270563","44","3348280"
"chr4","63968293","63968408","chr6","67324808","67324921","15","3356515"
"chr4","64095775","64095906","chr6","140226866","140226994","27","76131091"
"chr4","64096754","64096929","chr7","44520122","44520298","50","19576632"
"chr4","64340725","64340954","chr6","67689252","67689491","40","3348527"
"chr4","64410222","64410438","chr6","67752325","67752553","39","3342103"
"chr4","64453824","64454119","chr6","67787248","67787549","47","3333424"
"chr4","64505930","64506178","chr4","199123384","199123638","71","134617454"
"chr4","64597341","64597660","chr6","67951105","67951404","74","3353764"
"chr4","65015508","65015628","chr7","26158438","26158564","29","38857070"
"chr4","65033358","65033612","chr4","163978101","163978355","41","98944743"
"chr4","65137726","65138004","chr7","129054394","129054678","68","63916668"
"chr4","65750016","65750190","chr7","91000002","91000175","54","25249986"
"chr4","65811939","65812213","chr6","26735212","26735499","68","39076727"
"chr4","65922851","65922967","chr20","47828353","47828471","25","18094498"
"chr4","66128863","66128946","chr7","72673757","72673835","25","6544894"
"chr4","66157264","66157529","chr2A","14658362","14658631","70","51498902"
"chr4","66386325","66386620","chr6","70068725","70069022","37","3682400"
"chr4","66401666","66401971","chr6","70084286","70084568","60","3682620"
"chr4","66979073","66979382","chr6","70688765","70689082","48","3709692"
"chr4","67124373","67124670","chr6","70833576","70833864","56","3709203"
"chr4","67286545","67286629","chr6","70981870","70981962","18","3695325"
"chr4","67387414","67387685","chr6","71108585","71108872","44","3721171"
"chr4","67556301","67556605","chr6","71262186","71262494","34","3705885"
"chr4","67687734","67688018","chr6","71374201","71374480","51","3686467"
"chr4","67761250","67761361","chr13","10343678","10343792","21","57417572"
"chr4","67761576","67761623","chr1","78812290","78812331","15","11050714"
"chr4","68358385","68358704","chr5","129500126","129500434","61","61141741"
"chr4","68692823","68692935","chr2A","63435618","63435731","19","5257205"
"chr4","68763604","68763739","chr2A","21072743","21072884","33","47690861"
"chr4","68764745","68765043","chr6","72389704","72389995","50","3624959"
"chr4","68821279","68821397","chr8","79737740","79737854","25","10916461"
"chr4","68836738","68837024","chr6","72464428","72464722","62","3627690"
"chr4","68844571","68844829","chr6","72471859","72472122","46","3627288"
"chr4","68948229","68948339","chr6","72571753","72571865","14","3623524"
"chr4","68960130","68960433","chr6","72583136","72583449","54","3623006"
"chr4","69094879","69094975","chr6","110466889","110466990","24","41372010"
"chr4","69100378","69100682","chr6","72685489","72685794","39","3585111"
"chr4","69103722","69103831","chr6","51973244","51973356","28","17130478"
"chr4","69103859","69103948","chr9","68061684","68061764","24","1042175"
"chr4","69338581","69338824","chr6","72931861","72932096","30","3593280"
"chr4","69703196","69703496","chr6","73334325","73334637","52","3631129"
"chr4","69772260","69772416","chr11","47982935","47983093","36","21789325"
"chr4","70185541","70185654","chr6","73792013","73792126","15","3606472"
"chr4","70297984","70298297","chr6","73897481","73897786","52","3599497"
"chr4","70365857","70366155","chr11","111527997","111528292","61","41162140"
"chr4","70384796","70385081","chr6","74013013","74013296","28","3628217"
"chr4","70530623","70530926","chr6","74173269","74173559","55","3642646"
"chr4","70643185","70643260","chr6","74285083","74285168","14","3641898"
"chr4","70736798","70737102","chr6","74372148","74372441","60","3635350"
"chr4","70756142","70756425","chrX","137816061","137816343","68","67059919"
"chr4","70820491","70820689","chr6","10930268","10930466","47","59890223"
"chr4","70871832","70871955","chr6","74541324","74541447","12","3669492"
"chr4","70929082","70929377","chr6","74599963","74600270","63","3670881"
"chr4","70992545","70992666","chr6","74653208","74653329","13","3660663"
"chr4","71027163","71027411","chr16","31649333","31649595","58","39377830"
"chr4","71115156","71115425","chr6","74769577","74769814","62","3654421"
"chr4","71172336","71172613","chr6","74823623","74823928","53","3651287"
"chr4","71177403","71177691","chr4","170848740","170849035","70","99671337"
"chr4","71285105","71285208","chr17","63212955","63213066","30","8072150"
"chr4","71288765","71288878","chrX","151208603","151208709","19","79919838"
"chr4","71293416","71293512","chrX","6395378","6395475","22","64898038"
"chr4","71362412","71362687","chr7","129411119","129411390","65","58048707"
"chr4","71431471","71431760","chr6","75088096","75088393","54","3656625"
"chr4","71510848","71511139","chr6","75134330","75134623","45","3623482"
"chr4","71512386","71512674","chr6","75136203","75136503","32","3623817"
"chr4","71568631","71568889","chr6","75207718","75207987","46","3639087"
"chr4","71577233","71577549","chr6","75220176","75220485","69","3642943"
"chr4","71613539","71613812","chr6","75253276","75253552","31","3639737"
"chr4","71621235","71621524","chr6","75324947","75325252","47","3703712"
"chr4","71639795","71639888","chr2A","63084317","63084409","19","8555478"
"chr4","71640964","71641164","chr9","108278735","108278934","55","36637771"
"chr4","71643357","71643481","chr7","26158438","26158564","36","45484919"
"chr4","71652702","71652998","chr15","51724953","51725244","72","19927749"
"chr4","71655561","71655829","chr3","57847114","57847393","54","13808447"
"chr4","71663907","71664034","chr19","54938369","54938502","18","16725538"
"chr4","71664257","71664390","chr4","151185074","151185207","11","79520817"
"chr4","71670954","71671223","chr6","75377578","75377854","52","3706624"
"chr4","71704756","71705036","chr3","198778450","198778736","66","127073694"
"chr4","71709157","71709268","chr8","101958021","101958135","22","30248864"
"chr4","71722466","71722607","chr20","43375752","43375889","44","28346714"
"chr4","71722973","71723096","chr22","2546777","2546899","21","69176196"
"chr4","71744538","71744787","chr1","18869598","18869838","74","52874940"
"chr4","71760774","71761083","chr6","75452567","75452849","66","3691793"
"chr4","71761559","71761681","chr6","75453356","75453479","14","3691797"
"chr4","71768209","71768519","chr6","75460185","75460475","58","3691976"
"chr4","71782127","71782339","chr12","30425615","30425828","54","41356512"
"chr4","71816272","71816559","chr6","75515298","75515589","38","3699026"
"chr4","71828036","71828136","chr8","24323998","24324099","19","47504038"
"chr4","71832319","71832615","chr6","75540565","75540810","74","3708246"
"chr4","71845895","71846061","chr1","152885383","152885548","32","81039488"
"chr4","71848907","71849025","chr6","75549334","75549455","12","3700427"
"chr4","71866025","71866325","chr6","75563847","75564146","52","3697822"
"chr4","71872118","71872244","chr6","75570342","75570470","16","3698224"
"chr4","71931678","71931816","chr6","75691103","75691238","18","3759425"
"chr4","71963170","71963442","chr9","75566020","75566287","66","3602850"
"chr4","71992243","71992539","chr7","72964520","72964817","68","972277"
"chr4","71995167","71995468","chr6","75745781","75746070","48","3750614"
"chr4","72050971","72051037","chr6","42805373","42805434","12","29245598"
"chr4","72063877","72064137","chr6","75805292","75805557","36","3741415"
"chr4","72557567","72557654","chr4","131793073","131793163","20","59235506"
"chr4","73048878","73049142","chrX","134972656","134972920","61","61923778"
"chr4","73343319","73343616","chr6","77097640","77097929","35","3754321"
"chr4","73486384","73486687","chr6","77221059","77221353","42","3734675"
"chr4","73488449","73488727","chr1","191202899","191203180","64","117714450"
"chr4","73599885","73600188","chr12","901136","901435","65","72698749"
"chr4","73601703","73601811","chr6","77332770","77332882","16","3731067"
"chr4","73659556","73659685","chr6","77412369","77412499","17","3752813"
"chr4","73693021","73693167","chr1","31279143","31279286","39","42413878"
"chr4","73734330","73734647","chr6","77487047","77487383","59","3752717"
"chr4","73734740","73735030","chr6","77487475","77487772","51","3752735"
"chr4","73796133","73796410","chr6","77535247","77535516","36","3739114"
"chr4","73837131","73837342","chr9","45100902","45101116","41","28736229"
"chr4","73856883","73857088","chr6","77581365","77581564","26","3724482"
"chr4","73863661","73863776","chr8","108964883","108965000","19","35101222"
"chr4","73885969","73886155","chr15","23396259","23396443","41","50489710"
"chr4","73922907","73923013","chr7","65408798","65408903","25","8514109"
"chr4","73930148","73930377","chrX","34453222","34453455","51","39476926"
"chr4","73940811","73941090","chr6","77660616","77660911","51","3719805"
"chr4","73950013","73950122","chr19","42721971","42722077","25","31228042"
"chr4","73960529","73960831","chr6","77676629","77676923","56","3716100"
"chr4","73977377","73977612","chr6","77698097","77698311","48","3720720"
"chr4","74007768","74007864","chr1","19347264","19347356","29","54660504"
"chr4","74008484","74008585","chrX","3394860","3394959","19","70613624"
"chr4","74023418","74023564","chr1","26646523","26646657","39","47376895"
"chr4","74028034","74028168","chr12","93911417","93911546","23","19883383"
"chr4","74031925","74032216","chr6","77755776","77756083","54","3723851"
"chr4","74049505","74049766","chr6","77771961","77772235","39","3722456"
"chr4","74053153","74053370","chr6","169286751","169286969","44","95233598"
"chr4","74053795","74053852","chr4","171500441","171500495","9","97446646"
"chr4","74064884","74064998","chr9","111553054","111553162","19","37488170"
"chr4","74081851","74082003","chr2A","24087441","24087597","45","49994410"
"chr4","74090994","74091112","chr6","77821198","77821315","10","3730204"
"chr4","74098708","74099009","chr6","77829330","77829635","34","3730622"
"chr4","74101295","74101472","chr1","183223511","183223687","38","109122216"
"chr4","74109751","74110045","chr6","77839133","77839435","48","3729382"
"chr4","74144204","74144485","chr6","77882227","77882517","44","3738023"
"chr4","74145494","74145787","chr6","77883506","77883807","46","3738012"
"chr4","74146693","74146994","chr6","77884718","77885045","44","3738025"
"chr4","74298596","74298888","chr6","78029736","78030035","40","3731140"
"chr4","74364931","74365226","chr15","44244841","44245146","65","30120090"
"chr4","74517319","74517602","chr6","78223077","78223351","44","3705758"
"chr4","74555516","74555664","chr6","78241042","78241206","28","3685526"
"chr4","74557289","74557586","chr6","78243800","78244096","27","3686511"
"chr4","74805100","74805380","chr20","43604384","43604662","65","31200716"
"chr4","75072525","75072827","chr6","78756646","78756919","55","3684121"
"chr4","75176818","75177113","chr1","53759185","53759481","60","21417633"
"chr4","75285006","75285271","chr2B","99527218","99527476","76","24242212"
"chr4","75639976","75640129","chr4","194385971","194386131","39","118745995"
"chr4","75727669","75727887","chr6","79470342","79470557","41","3742673"
"chr4","75778006","75778095","chr1","17798378","17798465","19","57979628"
"chr4","75993662","75993877","chr1","137153393","137153601","64","61159731"
"chr4","76106980","76107254","chr6","79855364","79855626","50","3748384"
"chr4","76304094","76304381","chr6","80053272","80053563","41","3749178"
"chr4","76324257","76324563","chr15","21383408","21383710","63","54940849"
"chr4","76713761","76713933","chr7","74619806","74619995","53","2093955"
"chr4","76840933","76841239","chr6","80555997","80556305","51","3715064"
"chr4","76872552","76872827","chr6","80591318","80591590","68","3718766"
"chr4","76917578","76917821","chr9","49969983","49970234","56","26947595"
"chr4","77313297","77313592","chr6","81015941","81016201","69","3702644"
"chr4","77318978","77319210","chr6","81021080","81021347","55","3702102"
"chr4","77441176","77441482","chr6","81152093","81152418","72","3710917"
"chr4","77497427","77497716","chr6","81195957","81196256","65","3698530"
"chr4","77641154","77641429","chr6","81320680","81320967","36","3679526"
"chr4","77675874","77676052","chr22","24435516","24435686","42","53240358"
"chr4","77688074","77688350","chr14","76277962","76278233","59","1410112"
"chr4","77917067","77917366","chr6","81598380","81598655","63","3681313"
"chr4","77919141","77919411","chr6","81598380","81598655","36","3679239"
"chr4","77961924","77962218","chr1","204700975","204701271","73","126739051"
"chr4","78001511","78001648","chr1","31279143","31279286","37","46722368"
"chr4","78052619","78052875","chr4","7054541","7054778","68","70998078"
"chr4","78103241","78103359","chr4","71807651","71807768","16","6295590"
"chr4","78170216","78170524","chr6","81839203","81839506","55","3668987"
"chr4","78185201","78185493","chr6","81856066","81856375","47","3670865"
"chr4","78238975","78239085","chr6","81915500","81915610","15","3676525"
"chr4","78253466","78253769","chr6","81933096","81933399","45","3679630"
"chr4","78307111","78307391","chr6","81975843","81976121","46","3668732"
"chr4","78402167","78402448","chr6","82049105","82049382","50","3646938"
"chr4","78437233","78437519","chr6","82086444","82086730","36","3649211"
"chr4","78462351","78462648","chr1","121202614","121202910","72","42740263"
"chr4","78471725","78471844","chr6","82117492","82117611","13","3645767"
"chr4","78500997","78501257","chr6","82140104","82140377","49","3639107"
"chr4","78554022","78554231","chr13","7976473","7976675","50","70577549"
"chr4","78589105","78589413","chr6","82208026","82208321","59","3618921"
"chr4","78599360","78599647","chr6","82215275","82215555","41","3615915"
"chr4","78621367","78621471","chr1","160301284","160301387","22","81679917"
"chr4","78630518","78630827","chr6","82251702","82252013","50","3621184"
"chr4","78720335","78720643","chr6","82310170","82310462","52","3589835"
"chr4","78811622","78811900","chr14","22175096","22175370","65","56636526"
"chr4","79013617","79013727","chr6","82585748","82585864","21","3572131"
"chr4","79238293","79238419","chr6","82819282","82819404","17","3580989"
"chr4","79292091","79292372","chr6","82875995","82876268","41","3583904"
"chr4","79312215","79312486","chr6","82896020","82896302","56","3583805"
"chr4","79445928","79446204","chr13","10895308","10895590","82","68550620"
"chr4","79642738","79642960","chr8","126212894","126213119","53","46570156"
"chr4","79690667","79690944","chr6","83265303","83265575","48","3574636"
"chr4","79729292","79729592","chr6","83296931","83297226","61","3567639"
"chr4","79790592","79790818","chr6","83351711","83351966","62","3561119"
"chr4","79807346","79807626","chr6","83358909","83359196","53","3551563"
"chr4","79931044","79931353","chr19","8392088","8392388","75","71538956"
"chr4","80176366","80176618","chr6","83715095","83715307","63","3538729"
"chr4","80218292","80218508","chr6","39171411","39171640","65","41046881"
"chr4","80291921","80292189","chr21","8413468","8413714","75","71878453"
"chr4","80397006","80397045","chr6","155545700","155545734","12","75148694"
"chr4","80426340","80426627","chr6","83956396","83956687","59","3530056"
"chr4","80427150","80427343","chr6","83957214","83957415","49","3530064"
"chr4","80684421","80684536","chr6","84180099","84180214","10","3495678"
"chr4","80729540","80729658","chr6","84228379","84228496","12","3498839"
"chr4","80837040","80837157","chr6","84314018","84314136","16","3476978"
"chr4","80995033","80995114","chr6","115879924","115880007","14","34884891"
"chr4","81210825","81211142","chr6","84734541","84734840","71","3523716"
"chr4","81309943","81310262","chr2A","79618574","79618885","62","1691369"
"chr4","81337949","81338077","chr6","84856171","84856294","22","3518222"
"chr4","81471328","81471591","chr6","84970801","84971062","21","3499473"
"chr4","81635674","81635958","chr6","85102208","85102491","43","3466534"
"chr4","81677315","81677432","chr6","37801775","37801890","23","43875540"
"chr4","81706806","81707057","chr15","26961987","26962243","63","54744819"
"chr4","81740555","81740790","chr5","34080259","34080490","60","47660296"
"chr4","81772893","81773178","chr6","85236882","85237149","51","3463989"
"chr4","81830429","81830611","chr8","106049916","106050090","38","24219487"
"chr4","81835561","81835827","chr6","85294377","85294663","42","3458816"
"chr4","81917977","81918285","chr6","85379581","85379887","40","3461604"
"chr4","82045259","82045442","chr5","43474037","43474214","38","38571222"
"chr4","82058389","82058544","chr9","49643215","49643373","38","32415174"
"chr4","82060222","82060343","chr1","76661211","76661333","26","5399011"
"chr4","82144202","82144487","chr16","22322690","22322973","75","59821512"
"chr4","82165302","82165389","chr3","48006470","48006559","16","34158832"
"chr4","82194337","82194616","chr6","85631336","85631635","53","3436999"
"chr4","82197914","82198113","chr6","85634909","85635100","26","3436995"
"chr4","82206579","82206883","chr6","85642740","85643035","50","3436161"
"chr4","82215247","82215470","chr6","85651413","85651641","32","3436166"
"chr4","82223601","82223815","chr20","48240040","48240252","49","33983561"
"chr4","82224053","82224267","chr19","18237823","18238040","59","63986230"
"chr4","82232970","82233247","chr6","85674479","85674768","28","3441509"
"chr4","82248856","82248971","chr6","85690676","85690791","7","3441820"
"chr4","82278660","82278955","chr6","85729677","85729979","42","3451017"
"chr4","82279344","82279650","chr6","85730363","85730667","46","3451019"
"chr4","82301587","82301886","chr6","85753840","85754169","60","3452253"
"chr4","82311633","82311788","chr3","187249118","187249274","36","104937485"
"chr4","82428740","82428865","chr6","85885772","85885904","14","3457032"
"chr4","82455753","82456055","chr19","57516560","57516855","71","24939193"
"chr4","82456211","82456490","chr19","4731659","4731944","61","77724552"
"chr4","82532301","82532592","chr6","85986447","85986741","51","3454146"
"chr4","82560221","82560603","chr6","86005667","86005974","103","3445446"
"chr4","82594507","82594788","chrX","115407272","115407563","61","32812765"
"chr4","82601728","82602029","chr6","86053703","86054002","61","3451975"
"chr4","82608198","82608507","chr6","86060043","86060356","33","3451845"
"chr4","82622480","82622762","chr6","86069707","86070000","41","3447227"
"chr4","82635848","82635989","chr20","6698702","6698848","30","75937146"
"chr4","82638941","82639225","chr7","66936555","66936843","62","15702386"
"chr4","82642832","82642963","chr20","24234554","24234683","20","58408278"
"chr4","82682057","82682176","chr4","34521070","34521186","22","48160987"
"chr4","82753871","82754112","chr14","34026704","34026939","60","48727167"
"chr4","82893040","82893313","chr6","86328472","86328770","69","3435432"
"chr4","82981035","82981299","chr6","86408396","86408655","48","3427361"
"chr4","83094085","83094379","chr6","86487933","86488235","47","3393848"
"chr4","83334350","83334612","chr1","114013856","114014132","65","30679506"
"chr4","83467576","83467872","chr6","86854888","86855172","47","3387312"
"chr4","83712833","83712953","chr6","171994433","171994555","23","88281600"
"chr4","83713104","83713257","chr12","29807232","29807384","31","53905872"
"chr4","83727141","83727424","chrX","3060625","3060912","24","80666516"
"chr4","83728138","83728430","chrX","3061626","3061924","43","80666512"
"chr4","84138407","84138562","chr20","55353732","55353890","34","28784675"
"chr4","84296904","84297207","chr6","87567752","87568057","37","3270848"
"chr4","84305838","84306131","chr6","87580770","87581067","45","3274932"
"chr4","84387938","84388252","chr6","87670582","87670868","54","3282644"
"chr4","84407087","84407230","chr6","39842910","39843057","30","44564177"
"chr4","84474817","84475101","chr11","60927984","60928261","64","23546833"
"chr4","84542851","84543056","chr6","87787235","87787436","46","3244384"
"chr4","84543310","84543426","chr6","87787716","87787839","21","3244406"
"chr4","84544581","84544881","chr4","71728892","71729194","61","12815689"
"chr4","84638803","84639053","chr18","35498384","35498632","73","49140419"
"chr4","84648952","84649230","chr6","87875255","87875539","34","3226303"
"chr4","84659653","84659938","chr6","87885400","87885680","50","3225747"
"chr4","84692279","84692401","chr6","87914960","87915083","8","3222681"
"chr4","84737379","84737594","chrX","24030319","24030529","53","60707060"
"chr4","84772317","84772432","chr6","87974068","87974179","16","3201751"
"chr4","84872281","84872394","chr6","21652989","21653103","16","63219292"
"chr4","85032324","85032572","chr10","25463245","25463491","74","59569079"
"chr4","85498741","85498870","chr6","88647687","88647810","18","3148946"
"chr4","85603259","85603504","chr12","57243563","57243807","67","28359696"
"chr4","85665646","85665745","chrX","4255329","4255428","22","81410317"
"chr4","85771044","85771148","chr19","14292883","14292994","28","71478161"
"chr4","85899776","85900043","chr6","89089611","89089890","51","3189835"
"chr4","86096365","86096629","chr6","89254900","89255181","39","3158535"
"chr4","86113651","86113965","chr6","89278140","89278451","37","3164489"
"chr4","86213847","86214140","chr1","206300643","206300936","64","120086796"
"chr4","86227051","86227335","chr6","89406925","89407216","42","3179874"
"chr4","86252083","86252356","chr6","89436711","89436987","38","3184628"
"chr4","86320505","86320662","chr14","48531182","48531343","39","37789323"
"chr4","86370317","86370633","chr10","111663063","111663360","71","25292746"
"chr4","86372243","86372508","chr6","89565897","89566164","37","3193654"
"chr4","86373544","86373637","chr5","6920692","6920778","30","79452852"
"chr4","86412563","86412807","chr6","89602058","89602306","22","3189495"
"chr4","86436759","86436926","chr10","27981419","27981584","38","58455340"
"chr4","86470178","86470454","chr6","89648279","89648547","41","3178101"
"chr4","86585357","86585655","chr6","89734513","89734805","45","3149156"
"chr4","86651817","86652083","chr6","89791288","89791572","56","3139471"
"chr4","86658637","86658928","chr8","83196108","83196399","77","3462529"
"chr4","86659050","86659345","chr16","19046304","19046596","73","67612746"
"chr4","86671776","86671876","chr11","67337030","67337134","23","19334746"
"chr4","86672308","86672423","chr2A","63435618","63435731","20","23236690"
"chr4","86674040","86674205","chr12","9544290","9544459","32","77129750"
"chr4","86703014","86703323","chr10","29930332","29930631","48","56772682"
"chr4","86722536","86722698","chr3","10866047","10866211","32","75856489"
"chr4","86792855","86793146","chr7","56830178","56830472","59","29962677"
"chr4","86795038","86795155","chr6","89944015","89944138","20","3148977"
"chr4","86797147","86797263","chr6","89945840","89945957","19","3148693"
"chr4","86804379","86804606","chr6","89955602","89955855","49","3151223"
"chr4","86815116","86815428","chr6","89970348","89970673","40","3155232"
"chr4","86875661","86875914","chr14","57809436","57809683","69","29066225"
"chr4","87006755","87006879","chr6","90146475","90146599","8","3139720"
"chr4","87569374","87569632","chr19","13072219","13072500","54","74497155"
"chr4","87662803","87663093","chr6","90842426","90842744","53","3179623"
"chr4","87709524","87709823","chr1","205482501","205482795","53","117772977"
"chr4","87746941","87747231","chr11","56908571","56908866","66","30838370"
"chr4","87764901","87765025","chr6","90942219","90942343","10","3177318"
"chr4","87766896","87767160","chr7","116356738","116357011","72","28589842"
"chr4","87778448","87778573","chr6","90955941","90956067","11","3177493"
"chr4","87779395","87779696","chr6","90957189","90957489","35","3177794"
"chr4","87787571","87787858","chr6","90965745","90966017","55","3178174"
"chr4","87801750","87802047","chr6","90978647","90978938","42","3176897"
"chr4","87843737","87843948","chr6","91035512","91035718","15","3191775"
"chr4","87883465","87883579","chr6","91071848","91071964","10","3188383"
"chr4","87888474","87888760","chr6","91077265","91077561","36","3188791"
"chr4","87918429","87918705","chr12","98465934","98466215","56","10547505"
"chr4","87950095","87950212","chr6","91127951","91128067","13","3177856"
"chr4","87993597","87993755","chr10","49585047","49585201","32","38408550"
"chr4","88003947","88004254","chr6","91208417","91208710","62","3204470"
"chr4","88010299","88010570","chr1","159711180","159711445","58","71700881"
"chr4","88013584","88013844","chr6","91221331","91221618","54","3207747"
"chr4","88023040","88023313","chr6","91228848","91229119","25","3205808"
"chr4","88024264","88024554","chr6","91230120","91230438","63","3205856"
"chr4","88026434","88026715","chr6","91233977","91234263","51","3207543"
"chr4","88040557","88040704","chr3","175179402","175179547","41","87138845"
"chr4","88070078","88070183","chr11","100545535","100545642","16","12475457"
"chr4","88081106","88081229","chr2B","50169176","50169299","21","37911930"
"chr4","88086438","88086742","chrX","23951798","23952091","58","64134640"
"chr4","88090935","88091047","chr2A","63435618","63435731","18","24655317"
"chr4","88128649","88128907","chr6","91333571","91333810","60","3204922"
"chr4","88135455","88135578","chr3","65193379","65193500","18","22942076"
"chr4","88138477","88138599","chr6","74653208","74653329","18","13485269"
"chr4","88158324","88158516","chr5","36264771","36264973","46","51893553"
"chr4","88161590","88161880","chr6","91359416","91359733","52","3197826"
"chr4","88162066","88162355","chr4","99195972","99196262","56","11033906"
"chr4","88163612","88163923","chr1","40331351","40331633","85","47832261"
"chr4","88182213","88182336","chr3","65193379","65193500","17","22988834"
"chr4","88190092","88190216","chr20","34631402","34631525","11","53558690"
"chr4","88201733","88202031","chr7","71964750","71965042","67","16236983"
"chr4","88209388","88209549","chr16","76317400","76317554","36","11891988"
"chr4","88217560","88217752","chr19","10952873","10953079","46","77264687"
"chr4","88268784","88268910","chr7","106644788","106644907","21","18376004"
"chr4","88275648","88275932","chr6","91471610","91471882","44","3195962"
"chr4","88304973","88305297","chr6","91494064","91494385","37","3189091"
"chr4","88337636","88337755","chr8","144957651","144957776","37","56620015"
"chr4","88337999","88338137","chr8","29136237","29136372","24","59201762"
"chr4","88351069","88351273","chr9","12157163","12157372","42","76193906"
"chr4","88355513","88355666","chr6","91552715","91552881","27","3197202"
"chr4","88370374","88370664","chr6","91564119","91564417","37","3193745"
"chr4","88382700","88382864","chr1","23183624","23183790","33","65199076"
"chr4","88392375","88392669","chr6","91585416","91585710","27","3193041"
"chr4","88412941","88413232","chr6","91604798","91605102","48","3191857"
"chr4","88439318","88439580","chr6","91636326","91636609","52","3197008"
"chr4","88476526","88476817","chr6","91673572","91673868","52","3197046"
"chr4","88493799","88494054","chr6","91694307","91694564","23","3200508"
"chr4","88519265","88519516","chr5","134765411","134765653","61","46246146"
"chr4","88519913","88520207","chr6","91718581","91718874","32","3198668"
"chr4","88523822","88524106","chr6","91721734","91722009","28","3197912"
"chr4","88550955","88551233","chr6","91746719","91746992","36","3195764"
"chr4","88558785","88559016","chr6","91754350","91754581","28","3195565"
"chr4","88567870","88568155","chr6","91760532","91760843","49","3192662"
"chr4","88578658","88578981","chr4","167934179","167934476","68","79355521"
"chr4","88606673","88606955","chr9","78650999","78651275","58","9955674"
"chr4","88607315","88607414","chr22","12441645","12441741","28","76165670"
"chr4","88642278","88642480","chr7","30981186","30981407","67","57661092"
"chr4","88672435","88672700","chr6","91862246","91862513","39","3189811"
"chr4","88692796","88693108","chr6","91886897","91887206","39","3194101"
"chr4","88702997","88703282","chr6","91895854","91896151","35","3192857"
"chr4","88735057","88735323","chr16","17553819","17554095","49","71181238"
"chr4","88769632","88769722","chr20","39240694","39240783","22","49528938"
"chr4","88769753","88769933","chr7","4828552","4828727","43","83941201"
"chr4","88780355","88780646","chr3","131630293","131630578","69","42849938"
"chr4","88788388","88788633","chr6","91983655","91983926","54","3195267"
"chr4","88818347","88818636","chr7","4179063","4179350","58","84639284"
"chr4","88846355","88846492","chr22","8436942","8437088","32","80409413"
"chr4","88919280","88919373","chr6","92102952","92103048","12","3183672"
"chr4","88956561","88956848","chr6","92155233","92155530","43","3198672"
"chr4","88967558","88967688","chr1","132573702","132573836","34","43606144"
"chr4","88968866","88968996","chrX","2794957","2795096","36","86173909"
"chr4","88989275","88989566","chr6","92184401","92184710","64","3195126"
"chr4","89002192","89002354","chr5","2493450","2493615","35","86508742"
"chr4","89002487","89002567","chr1","192664798","192664872","29","103662311"
"chr4","89004491","89004619","chr5","59969496","59969625","31","29034995"
"chr4","89005146","89005242","chr11","61985367","61985463","16","27019779"
"chr4","89031274","89031389","chr6","92231625","92231742","9","3200351"
"chr4","89104866","89105164","chr6","92301985","92302268","50","3197119"
"chr4","89109607","89109736","chr6","92306790","92306915","15","3197183"
"chr4","89153549","89153838","chr6","92349588","92349889","32","3196039"
"chr4","89174655","89174823","chr8","98458896","98459060","39","9284241"
"chr4","89271829","89272132","chr6","92462267","92462582","57","3190438"
"chr4","89336668","89336964","chr13","508685","508977","58","88827983"
"chr4","89367644","89367926","chr6","92547249","92547537","32","3179605"
"chr4","89400906","89401008","chrX","70296179","70296280","20","19104727"
"chr4","89673872","89674000","chr6","92827613","92827744","16","3153741"
"chr4","89674042","89674256","chr7","77328663","77328875","46","12345379"
"chr4","89733613","89733736","chr6","92882392","92882515","10","3148779"
"chr4","90005216","90005500","chr19","38040095","38040378","69","51965121"
"chr4","90148858","90149150","chrX","39133182","39133470","66","51015676"
"chr4","90467810","90468088","chr6","93606296","93606577","56","3138486"
"chr4","90861143","90861233","chr6","118317766","118317852","27","27456623"
"chr4","90861240","90861481","chr8","100694182","100694407","65","9832942"
"chr4","90876662","90876930","chr6","94017551","94017825","57","3140889"
"chr4","91036435","91036737","chr8","21062701","21063003","65","69973734"
"chr4","91135401","91135535","chr6","18588428","18588554","37","72546973"
"chr4","91276085","91276278","chr6","94402193","94402387","26","3126108"
"chr4","92043035","92043275","chr6","95265751","95266017","65","3222716"
"chr4","92071205","92071451","chr6","95290575","95290823","31","3219370"
"chr4","92136042","92136330","chr6","95352360","95352649","38","3216318"
"chr4","92186813","92186938","chr6","95419248","95419373","14","3232435"
"chr4","92230311","92230421","chr16","12411781","12411898","20","79818530"
"chr4","92248692","92248779","chr1","183811752","183811829","23","91563060"
"chr4","92249259","92249449","chr1","7985084","7985272","50","84264175"
"chr4","92320335","92320497","chr6","95539514","95539664","37","3219179"
"chr4","92385353","92385645","chr1","183409867","183410163","65","91024514"
"chr4","92473778","92474020","chr6","95689232","95689466","43","3215454"
"chr4","92548594","92548788","chr3","50043092","50043292","56","42505502"
"chr4","92566229","92566526","chr2A","82649063","82649341","71","9917166"
"chr4","92721441","92721711","chr5","118116998","118117266","54","25395557"
"chr4","92726943","92727225","chr8","44872810","44873091","81","47854133"
"chr4","92742479","92742598","chr2B","126177961","126178078","17","33435482"
"chr4","93078078","93078396","chr6","96287273","96287566","79","3209195"
"chr4","93210110","93210416","chr13","34855159","34855453","83","58354951"
"chr4","93285485","93285602","chr6","96464395","96464513","10","3178910"
"chr4","93511540","93511827","chr5","38104922","38105205","69","55406618"
"chr4","93655126","93655393","chr2B","27065408","27065684","38","66589718"
"chr4","93782872","93783187","chr19","8392088","8392388","75","85390784"
"chr4","93856789","93857057","chr6","97027501","97027788","59","3170712"
"chr4","93918865","93919136","chr18","46694498","46694766","76","47224367"
"chr4","94394027","94394344","chr7","101116048","101116360","84","6722021"
"chr4","94500001","94500293","chr7","32503379","32503656","79","61996622"
"chr4","94639420","94639721","chr6","97482263","97482570","41","2842843"
"chr4","94790182","94790393","chr6","97663767","97663966","36","2873585"
"chr4","94897157","94897452","chrX","40660160","40660460","70","54236997"
"chr4","95024286","95024574","chr6","97885142","97885443","63","2860856"
"chr4","95181728","95182005","chr6","98047338","98047629","48","2865610"
"chr4","95226785","95226984","chr10","7421667","7421862","48","87805118"
"chr4","95239109","95239385","chr4","106130103","106130387","75","10890994"
"chr4","95376537","95376815","chr6","98239864","98240132","49","2863327"
"chr4","95552898","95553193","chr6","98441525","98441828","34","2888627"
"chr4","95735233","95735501","chr6","98604512","98604812","57","2869279"
"chr4","95840528","95840814","chr6","98734606","98734892","37","2894078"
"chr4","95860817","95860914","chr11","34460079","34460175","13","61400738"
"chr4","95891236","95891352","chr8","34750032","34750149","20","61141204"
"chr4","95891447","95891581","chr1","223894247","223894395","33","128002800"
"chr4","95975362","95975665","chr6","98880074","98880374","41","2904712"
"chr4","96045012","96045319","chr6","98948611","98948900","36","2903599"
"chr4","96115403","96115610","chr6","99019363","99019576","31","2903960"
"chr4","96134117","96134222","chr16","48023200","48023306","22","48110917"
"chr4","96139175","96139477","chr6","99049551","99049845","40","2910376"
"chr4","96361123","96361414","chr6","99276389","99276688","45","2915266"
"chr4","96375867","96376143","chr6","99291341","99291632","57","2915474"
"chr4","96405157","96405466","chr6","99318300","99318605","37","2913143"
"chr4","96409515","96409788","chr6","99322317","99322601","38","2912802"
"chr4","96429503","96429800","chr20","35019625","35019919","85","61409878"
"chr4","96735229","96735502","chr6","99649131","99649409","41","2913902"
"chr4","96735992","96736279","chr22","3943306","3943590","70","92792686"
"chr4","96786451","96786741","chr7","28366007","28366296","64","68420444"
"chr4","96827548","96827759","chr18","12205066","12205280","50","84622482"
"chr4","96951082","96951401","chr5","121478135","121478431","70","24527053"
"chr4","96955745","96955859","chr6","99871892","99872007","8","2916147"
"chr4","97276227","97276431","chr1","65289204","65289398","54","31987023"
"chr4","97795084","97795372","chr6","100701752","100702030","48","2906668"
"chr4","97869351","97869500","chr6","100766733","100766887","23","2897382"
"chr4","97887675","97887952","chr7","148971292","148971566","64","51083617"
"chr4","97920798","97920941","chr12","110108425","110108564","37","12187627"
"chr4","97931668","97931965","chr21","8638372","8638666","63","89293296"
"chr4","98054847","98055115","chr6","100933140","100933423","34","2878293"
"chr4","98087580","98087700","chr6","154239364","154239482","30","56151784"
"chr4","98277440","98277665","chr5","45081913","45082128","56","53195527"
"chr4","98413944","98414242","chr6","101263894","101264184","35","2849950"
"chr4","98528831","98529125","chr7","138981355","138981648","65","40452524"
"chr4","98545319","98545439","chr2B","123303964","123304085","20","24758645"
"chr4","98590178","98590482","chr6","101455154","101455476","52","2864976"
"chr4","98595988","98596210","chrX","154182968","154183182","45","55586980"
"chr4","98629281","98629602","chr6","101492940","101493232","79","2863659"
"chr4","98631787","98632031","chr6","101495681","101495932","30","2863894"
"chr4","98656255","98656504","chr7","57201613","57201845","64","41454642"
"chr4","98673373","98673489","chr22","14821499","14821616","17","83851874"
"chr4","98719266","98719628","chr6","101580268","101580576","101","2861002"
"chr4","98723632","98723744","chr6","101584991","101585103","21","2861359"
"chr4","98740936","98741049","chr16","48023200","48023306","31","50717736"
"chr4","98741367","98741656","chr1","125528862","125529159","64","26787495"
"chr4","98930203","98930476","chr6","101784441","101784725","49","2854238"
"chr4","98939415","98939703","chr7","138981355","138981648","62","40041940"
"chr4","99052598","99052704","chr6","101864292","101864398","16","2811694"
"chr4","99062020","99062337","chr10","115445054","115445361","74","16383034"
"chr4","99085974","99086252","chr6","101915508","101915792","48","2829534"
"chr4","99118831","99119140","chr6","101948196","101948513","64","2829365"
"chr4","99513875","99514088","chr6","102328167","102328370","49","2814292"
"chr4","99524605","99524848","chr1","52115582","52115816","80","47409023"
"chr4","99677011","99677309","chr6","102489739","102490004","70","2812728"
"chr4","99692027","99692261","chr6","102503567","102503813","35","2811540"
"chr4","99744431","99744731","chr6","102561170","102561464","37","2816739"
"chr4","99788188","99788475","chr6","102605637","102605946","58","2817449"
"chr4","99829915","99830184","chr6","102625371","102625642","43","2795456"
"chr4","99848203","99848512","chr16","47336132","47336436","86","52512071"
"chr4","100008005","100008289","chr6","102773562","102773852","70","2765557"
"chr4","100050554","100050849","chr6","102840644","102840944","38","2790090"
"chr4","100068852","100069014","chrX","17937151","17937313","39","82131701"
"chr4","100096931","100097217","chr6","102882266","102882565","42","2785335"
"chr4","100138580","100138843","chr6","102951473","102951735","31","2812893"
"chr4","100152026","100152294","chr6","102964039","102964345","65","2812013"
"chr4","100167241","100167354","chr6","102985143","102985259","13","2817902"
"chr4","100181177","100181475","chr6","102999149","102999448","42","2817972"
"chr4","100281012","100281146","chr6","103092591","103092726","21","2811579"
"chr4","100342075","100342346","chr6","103153031","103153322","57","2810956"
"chr4","100615161","100615288","chr3","144886878","144887008","20","44271717"
"chr4","100636303","100636508","chr10","35054340","35054550","47","65581963"
"chr4","100636538","100636694","chr19","7784006","7784166","32","92852532"
"chr4","100990201","100990425","chr3","23601152","23601365","62","77389049"
"chr4","101009942","101010232","chr9","91035693","91035982","63","9974249"
"chr4","101032654","101032925","chr3","140823475","140823736","65","39790821"
"chr4","101073194","101073450","chr14","20451618","20451885","65","80621576"
"chr4","101152146","101152422","chr6","103945700","103946006","58","2793554"
"chr4","101193669","101193802","chr14","52842638","52842775","31","48351031"
"chr4","101434818","101434921","chrX","107611093","107611200","22","6176275"
"chr4","101532961","101533209","chr6","104290507","104290772","62","2757546"
"chr4","101534276","101534398","chr6","104291536","104291654","18","2757260"
"chr4","101589305","101589406","chr5","79630137","79630243","26","21959168"
"chr4","101606445","101606703","chr6","35402118","35402370","73","66204327"
"chr4","101910358","101910601","chr6","104664944","104665189","21","2754586"
"chr4","101910685","101910796","chr7","112506150","112506258","22","10595465"
"chr4","101931081","101931359","chr6","104694915","104695226","81","2763834"
"chr4","101975046","101975315","chr6","104773535","104773807","71","2798489"
"chr4","102102248","102102372","chr2A","56811303","56811424","23","45290945"
"chr4","102452427","102452709","chr6","105217133","105217433","67","2764706"
"chr4","102470113","102470329","chr6","105233846","105234101","55","2763733"
"chr4","102519099","102519401","chr6","105287002","105287315","53","2767903"
"chr4","102911025","102911106","chr1","224255650","224255731","16","121344625"
"chr4","103180943","103181070","chr7","140269187","140269315","26","37088244"
"chr4","103241251","103241411","chrX","130137391","130137550","36","26896140"
"chr4","103241443","103241516","chr1","225279648","225279721","22","122038205"
"chr4","103496152","103496403","chr1","20976804","20977054","64","82519348"
"chr4","103833644","103833943","chr6","106580120","106580419","25","2746476"
"chr4","103934043","103934322","chr6","106758347","106758632","40","2824304"
"chr4","103950407","103950704","chr6","106797876","106798175","41","2847469"
"chr4","104052604","104052825","chr22","10567928","10568155","60","93484676"
"chr4","104075637","104075760","chr6","106910886","106911009","11","2835249"
"chr4","104105800","104106073","chr6","106942799","106943060","36","2836999"
"chr4","104154492","104154791","chr15","37975486","37975784","67","66179006"
"chr4","104159114","104159400","chr6","107023755","107024042","32","2864641"
"chr4","104184450","104184567","chr7","26158438","26158564","33","78026012"
"chr4","104185178","104185474","chr6","91685908","91686202","65","12499270"
"chr4","104192848","104193103","chr6","107059341","107059596","35","2866493"
"chr4","104243586","104243883","chr6","107111310","107111600","34","2867724"
"chr4","104289722","104290020","chr6","107151243","107151546","37","2861521"
"chr4","104399273","104399550","chr6","107204085","107204366","41","2804812"
"chr4","104400019","104400285","chr6","107205734","107205990","43","2805715"
"chr4","104408853","104408968","chr6","107229454","107229569","12","2820601"
"chr4","104476777","104477004","chr5","59493106","59493323","51","44983671"
"chr4","104500842","104501124","chr10","64492720","64493000","60","40008122"
"chr4","104506114","104506384","chr6","37193649","37193919","68","67312465"
"chr4","104519408","104519683","chr7","65859600","65859872","64","38659808"
"chr4","104523745","104524048","chr6","107357738","107358014","62","2833993"
"chr4","104536934","104537243","chr6","107369799","107370113","45","2832865"
"chr4","104599679","104599978","chr6","107421554","107421849","41","2821875"
"chr4","104875122","104875356","chr6","107675476","107675701","33","2800354"
"chr4","104917886","104918007","chr6","7002095","7002216","20","97915791"
"chr4","105044617","105044900","chr6","107829311","107829607","43","2784694"
"chr4","105161496","105161778","chr6","107962113","107962408","50","2800617"
"chr4","105195951","105196034","chr6","107993043","107993126","12","2797092"
"chr4","105333835","105334134","chr11","117190617","117190922","68","11856782"
"chr4","105377295","105377587","chr12","121101371","121101664","61","15724076"
"chr4","105435033","105435148","chr7","69801927","69802033","25","35633106"
"chr4","105435935","105436125","chr1","23336753","23336932","53","82099182"
"chr4","105457241","105457394","chr16","76317400","76317554","36","29139841"
"chr4","105470550","105470846","chr6","108255719","108256033","62","2785169"
"chr4","105483662","105483923","chr6","108268510","108268775","36","2784848"
"chr4","105549066","105549353","chr3","197687724","197688008","61","92138658"
"chr4","105737286","105737563","chr6","108503891","108504187","48","2766605"
"chr4","105842553","105842675","chr6","152459435","152459561","18","46616882"
"chr4","105848743","105849023","chr7","1708256","1708538","50","104140487"
"chr4","105849574","105849854","chr7","73075855","73076127","71","32773719"
"chr4","105853601","105853909","chr6","108600095","108600410","50","2746494"
"chr4","105960673","105960809","chr1","225047988","225048129","39","119087315"
"chr4","105974831","105975060","chr3","49738899","49739127","47","56235932"
"chr4","106062394","106062642","chr6","108788963","108789228","50","2726569"
"chr4","106085128","106085255","chrX","19963073","19963204","25","86122055"
"chr4","106094619","106094875","chr6","108822625","108822885","42","2728006"
"chr4","106150133","106150436","chr6","108877665","108877954","37","2727532"
"chr4","106189198","106189253","chr8","54578577","54578627","10","51610621"
"chr4","106198856","106199147","chr6","108926501","108926793","40","2727645"
"chr4","106252229","106252449","chrX","154182968","154183182","48","47930739"
"chr4","106314075","106314321","chr6","109073918","109074151","39","2759843"
"chr4","106326739","106326852","chr4","87356281","87356398","24","18970458"
"chr4","106353112","106353269","chr15","43571096","43571253","31","62782016"
"chr4","106366244","106366484","chr5","145429105","145429385","60","39062861"
"chr4","106388740","106389034","chr9","107625580","107625871","55","1236840"
"chr4","106390908","106391227","chr12","110876937","110877251","69","4486029"
"chr4","106407839","106408119","chrX","73707130","73707403","56","32700709"
"chr4","106431254","106431545","chr12","32032110","32032393","61","74399144"
"chr4","106439283","106439560","chr7","78911233","78911515","74","27528050"
"chr4","106499064","106499346","chr17","78401865","78402148","52","28097199"
"chr4","106533281","106533549","chr16","49181420","49181682","65","57351861"
"chr4","106543737","106543873","chr8","145782306","145782445","35","39238569"
"chr4","106557589","106557704","chr7","44128291","44128409","25","62429298"
"chr4","106559218","106559330","chr6","109228283","109228400","11","2669065"
"chr4","106574854","106575160","chr6","109237512","109237816","36","2662658"
"chr4","106580260","106580405","chr4","5043914","5044066","39","101536346"
"chr4","106588955","106589154","chr6","35041942","35042157","56","71547013"
"chr4","106605483","106605764","chr8","21992040","21992312","72","84613443"
"chr4","106622539","106622619","chr1","49485714","49485797","11","57136825"
"chr4","106633709","106633974","chr6","109292670","109292948","48","2658961"
"chr4","106639809","106639925","chr10","88748074","88748188","16","17891735"
"chr4","106661029","106661193","chrX","47509836","47510002","27","59151193"
"chr4","106663371","106663666","chr11","111789946","111790242","56","5126575"
"chr4","106675024","106675304","chr6","109335846","109336125","26","2660822"
"chr4","106710506","106710580","chr4","195829051","195829127","14","89118545"
"chr4","106736637","106736997","chr10","134547692","134547996","103","27811055"
"chr4","106754543","106754825","chr16","11513470","11513750","63","95241073"
"chr4","106760150","106760250","chr19","4106799","4106900","22","102653351"
"chr4","106761693","106761848","chrX","136605678","136605815","42","29843985"
"chr4","106763184","106763482","chr6","109426385","109426699","44","2663201"
"chr4","106782649","106782921","chrX","134959891","134960163","71","28177242"
"chr4","106803017","106803303","chr6","109469702","109469984","34","2666685"
"chr4","106818737","106819030","chr6","109485684","109485971","41","2666947"
"chr4","106881920","106882202","chr9","16633553","16633838","56","90248367"
"chr4","106895278","106895576","chr16","48298396","48298687","54","58596882"
"chr4","106896914","106897201","chr6","109563493","109563781","33","2666579"
"chr4","106902961","106903212","chr1","13854532","13854791","60","93048429"
"chr4","106932595","106932719","chr6","109618662","109618784","13","2686067"
"chr4","106940877","106941001","chr11","69147152","69147272","30","37793725"
"chr4","106992266","106992556","chr1","190065982","190066274","58","83073716"
"chr4","107030804","107031021","chr6","109714649","109714903","51","2683845"
"chr4","107084455","107084696","chr6","109767409","109767650","47","2682954"
"chr4","107117908","107118132","chr18","5378557","5378787","62","101739351"
"chr4","107152198","107152322","chr6","154239364","154239482","33","47087166"
"chr4","107308194","107308279","chr9","94237891","94237976","17","13070303"
"chr4","107311208","107311488","chr6","109995181","109995485","53","2683973"
"chr4","107321332","107321601","chr7","5721894","5722171","67","101599438"
"chr4","107343982","107344273","chr4","110418993","110419280","65","3075011"
"chr4","107349820","107349948","chr6","110053499","110053624","16","2703679"
"chr4","107375484","107375742","chr6","110082075","110082339","34","2706591"
"chr4","107375874","107376133","chr5","47450998","47451263","72","59924876"
"chr4","107425233","107425519","chr6","110134849","110135157","58","2709616"
"chr4","107443170","107443480","chr6","110147312","110147624","34","2704142"
"chr4","107452664","107452936","chr5","60862750","60863030","64","46589914"
"chr4","107468924","107469176","chr20","3188038","3188307","68","104280886"
"chr4","107475251","107475408","chr6","110183338","110183492","27","2708087"
"chr4","107489249","107489364","chr1","219799608","219799721","21","112310359"
"chr4","107489418","107489701","chr19","10370114","10370397","57","97119304"
"chr4","107490361","107490421","chr18","6114293","6114352","11","101376068"
"chr4","107594524","107594650","chr3","125378751","125378875","24","17784227"
"chr4","107636465","107636789","chr6","110332505","110332834","78","2696040"
"chr4","107648569","107648893","chr6","110342833","110343149","68","2694264"
"chr4","107657917","107657962","chr6","110378457","110378507","7","2720540"
"chr4","107658014","107658176","chr1","91527866","91528037","40","16130148"
"chr4","107666767","107667052","chr6","110388221","110388511","36","2721454"
"chr4","107722177","107722409","chr11","7880596","7880819","67","99841581"
"chr4","107731395","107731684","chr6","110403738","110404059","63","2672343"
"chr4","107733690","107733902","chr7","101408227","101408429","49","6325463"
"chr4","107742621","107742721","chr4","40213680","40213777","27","67528941"
"chr4","107751988","107752136","chr16","80955590","80955736","36","26796398"
"chr4","107760666","107760926","chr10","106957591","106957848","62","803075"
"chr4","107761921","107762236","chr6","110434933","110435224","59","2673012"
"chr4","107771842","107772111","chr6","110442894","110443182","45","2671052"
"chr4","107794136","107794447","chr6","110453582","110453890","38","2659446"
"chr4","107805006","107805122","chr11","64366187","64366304","17","43438819"
"chr4","107815324","107815547","chr9","12532981","12533206","77","95282343"
"chr4","107828300","107828382","chr10","142430183","142430266","13","34601883"
"chr4","107831179","107831495","chr6","110489016","110489343","43","2657837"
"chr4","107846270","107846401","chr6","110503373","110503508","17","2657103"
"chr4","107851181","107851484","chr6","110506853","110507133","48","2655672"
"chr4","107853620","107853736","chr6","110509314","110509432","16","2655694"
"chr4","107858751","107859052","chr6","110513787","110514075","41","2655036"
"chr4","107875261","107875560","chr6","110525503","110525798","33","2650242"
"chr4","107882696","107882987","chr6","110528982","110529284","40","2646286"
"chr4","107917591","107917861","chr6","110562646","110562945","58","2645055"
"chr4","107949912","107950023","chr12","44603933","44604043","20","63345979"
"chr4","107955881","107956251","chr14","75480242","75480614","104","32475639"
"chr4","107965808","107965994","chr1","5722040","5722227","44","102243768"
"chr4","107990900","107991193","chr5","1893830","1894113","61","106097070"
"chr4","108068088","108068388","chr1","158721814","158722109","56","50653726"
"chr4","108071130","108071207","chr6","110723783","110723860","8","2652653"
"chr4","108082024","108082311","chr6","110735006","110735268","61","2652982"
"chr4","108097127","108097350","chr6","110748523","110748766","36","2651396"
"chr4","108132391","108132542","chr10","14055566","14055724","36","94076825"
"chr4","108210604","108210895","chr6","110859586","110859884","43","2648982"
"chr4","108259063","108259245","chrX","19928223","19928402","35","88330840"
"chr4","108337377","108337678","chr6","110966829","110967131","39","2629452"
"chr4","108361459","108361791","chr2A","82593951","82594258","69","25767508"
"chr4","108427094","108427212","chr4","37764421","37764538","16","70662673"
"chr4","108430378","108430667","chr6","111068738","111069037","40","2638360"
"chr4","108441073","108441194","chr9","104384645","104384763","29","4056428"
"chr4","108502237","108502524","chr9","113776027","113776319","54","5273790"
"chr4","108512380","108512673","chr6","111144488","111144776","35","2632108"
"chr4","108518160","108518299","chr6","111148008","111148147","12","2629848"
"chr4","108519699","108519801","chr10","66507605","66507710","21","42012094"
"chr4","108530835","108531068","chr6","111175417","111175699","66","2644582"
"chr4","108561721","108561854","chr1","209023025","209023155","19","100461304"
"chr4","108579933","108580230","chr6","111213670","111213955","31","2633737"
"chr4","108595489","108595773","chr6","111219746","111220021","35","2624257"
"chr4","108649842","108650140","chr6","111272877","111273181","45","2623035"
"chr4","108759253","108759565","chr6","111399365","111399673","31","2640112"
"chr4","108805725","108805977","chr13","11480315","11480566","62","97325410"
"chr4","108844968","108845129","chr3","59350634","59350793","34","49494334"
"chr4","108863144","108863440","chr6","111501286","111501585","43","2638142"
"chr4","108897069","108897334","chr5","79883377","79883636","55","29013692"
"chr4","108983701","108983964","chr1","23236866","23237122","60","85746835"
"chr4","108983968","108984249","chr6","111603940","111604223","48","2619972"
"chr4","109025142","109025305","chr6","111646694","111646858","14","2621552"
"chr4","109034673","109034965","chr14","87389273","87389563","61","21645400"
"chr4","109037006","109037310","chr6","111664428","111664741","47","2627422"
"chr4","109065187","109065336","chr12","1479524","1479650","40","107585663"
"chr4","109072519","109072802","chr6","111710499","111710780","31","2637980"
"chr4","109197094","109197396","chr6","111814925","111815206","49","2617831"
"chr4","109208233","109208530","chr6","111829689","111829997","38","2621456"
"chr4","109336484","109336805","chr6","111949222","111949522","49","2612738"
"chr4","109444281","109444582","chr6","112077181","112077506","69","2632900"
"chr4","109498099","109498232","chr6","112135948","112136071","17","2637849"
"chr4","109544309","109544570","chr6","112169073","112169356","50","2624764"
"chr4","109610980","109611262","chr3","59773901","59774184","63","49837079"
"chr4","109883659","109883736","chr19","39955024","39955097","16","69928635"
"chr4","109883900","109884046","chr1","23727757","23727901","34","86156143"
"chr4","109903627","109903851","chr5","9569972","9570193","43","100333655"
"chr4","110031090","110031242","chr1","51916540","51916691","40","58114550"
"chr4","110057667","110057930","chr6","112646127","112646408","47","2588460"
"chr4","110098776","110099099","chr6","112692846","112693177","57","2594070"
"chr4","110117550","110117648","chr1","17798378","17798465","32","92319172"
"chr4","110123623","110123737","chr5","122150034","122150150","19","12026411"
"chr4","110180225","110180531","chr6","112764664","112764997","61","2584439"
"chr4","110207424","110207685","chr3","127863015","127863278","69","17655591"
"chr4","110233175","110233278","chr1","39325820","39325928","14","70907355"
"chr4","110264479","110264783","chr6","112824998","112825318","53","2560519"
"chr4","110304365","110304476","chr4","15029692","15029801","21","95274673"
"chr4","110309178","110309473","chr6","112862184","112862492","41","2553006"
"chr4","110334039","110334147","chr2A","61393161","61393275","18","48940878"
"chr4","110352266","110352462","chr11","121562900","121563097","48","11210634"
"chr4","110370855","110371146","chrX","70757717","70758005","56","39613138"
"chr4","110384234","110384348","chr6","112936160","112936273","15","2551926"
"chr4","110388904","110389183","chr6","112941355","112941636","29","2552451"
"chr4","110403048","110403344","chr1","130048013","130048302","67","19644965"
"chr4","110428082","110428362","chr10","16646176","16646453","83","93781906"
"chr4","110437466","110437755","chr6","112984611","112984897","35","2547145"
"chr4","110444345","110444460","chr5","48966184","48966302","33","61478161"
"chr4","110470151","110470467","chr6","113042883","113043176","95","2572732"
"chr4","110474858","110474912","chr1","127641618","127641669","15","17166760"
"chr4","110475325","110475475","chr14","48294182","48294322","32","62181143"
"chr4","110478061","110478183","chr20","40735237","40735359","16","69742824"
"chr4","110478540","110478695","chr10","49585047","49585201","30","60893493"
"chr4","110484056","110484217","chr10","49585047","49585201","32","60899009"
"chr4","110489986","110490260","chr7","44334451","44334729","57","66155535"
"chr4","110506488","110506711","chrX","31308573","31308814","62","79197915"
"chr4","110511534","110511644","chr12","121105622","121105732","15","10594088"
"chr4","110521012","110521213","chr3","12982849","12983055","47","97538163"
"chr4","110527094","110527226","chr11","3722528","3722657","22","106804566"
"chr4","110543469","110543708","chr10","25463245","25463491","59","85080224"
"chr4","110564168","110564289","chr20","48923609","48923731","22","61640559"
"chr4","110565155","110565234","chr12","73284670","73284743","21","37280485"
"chr4","110574799","110575134","chr6","113122426","113122720","71","2547627"
"chr4","110585880","110586076","chr18","4964755","4964952","50","105621125"
"chr4","110593174","110593319","chr16","81282748","81282889","34","29310426"
"chr4","110599449","110599606","chr10","49585047","49585201","31","61014402"
"chr4","110605245","110605358","chr6","113150546","113150663","20","2545301"
"chr4","110612355","110612621","chr6","157876454","157876729","52","47264099"
"chr4","110635489","110635783","chrX","103981721","103982018","57","6653768"
"chr4","110709282","110709463","chr1","101627475","101627654","42","9081807"
"chr4","110711477","110711637","chr4","40325999","40326159","36","70385478"
"chr4","110753579","110753882","chr6","113290013","113290314","49","2536434"
"chr4","110771449","110771576","chr13","10278120","10278248","18","100493329"
"chr4","110809480","110809784","chr11","74482537","74482838","64","36326943"
"chr4","110812416","110812539","chr6","113351932","113352055","9","2539516"
"chr4","110814003","110814202","chr6","21054340","21054547","51","89759663"
"chr4","110814403","110814622","chr6","113353704","113353943","44","2539301"
"chr4","110824536","110824822","chr6","113363599","113363899","50","2539063"
"chr4","110858066","110858376","chr6","113376134","113376422","43","2518068"
"chr4","110861511","110861634","chr6","113379836","113379949","31","2518325"
"chr4","110863755","110863973","chr18","12205066","12205280","49","98658689"
"chr4","110880487","110880603","chr5","143321554","143321671","19","32441067"
"chr4","110949324","110949640","chr6","113445647","113445961","27","2496323"
"chr4","110977506","110977615","chr7","75603267","75603378","25","35374239"
"chr4","110986828","110986941","chr3","25953481","25953598","15","85033347"
"chr4","110987245","110987528","chr5","96942875","96943163","71","14044370"
"chr4","110989019","110989299","chr22","2258699","2258984","60","108730320"
"chr4","110993184","110993294","chr1","68350841","68350951","32","42642343"
"chr4","111028810","111029089","chr6","113519580","113519865","54","2490770"
"chr4","111059504","111059629","chr6","38593130","38593246","24","72466374"
"chr4","111070235","111070532","chr6","113565250","113565558","50","2495015"
"chr4","111073265","111073515","chr6","113568052","113568328","50","2494787"
"chr4","111086970","111087270","chr6","113582047","113582351","55","2495077"
"chr4","111110982","111111087","chr6","113596399","113596498","19","2485417"
"chr4","111136071","111136230","chr19","5169265","5169417","34","105966806"
"chr4","111162836","111163000","chr3","51303448","51303606","33","59859388"
"chr4","111163047","111163072","chr6","33819844","33819869","3","77343203"
"chr4","111173678","111173979","chr20","35019625","35019919","58","76154053"
"chr4","111175215","111175506","chr6","113656859","113657163","50","2481644"
"chr4","111178744","111178853","chr1","134625109","134625219","21","23446365"
"chr4","111216917","111217080","chr9","111774807","111774960","48","557890"
"chr4","111224593","111224887","chr6","113703828","113704124","41","2479235"
"chr4","111247750","111248059","chr6","113726183","113726489","56","2478433"
"chr4","111299616","111299930","chr6","113785539","113785842","42","2485923"
"chr4","111369962","111370240","chr6","113854106","113854395","44","2484144"
"chr4","111378799","111379093","chr6","113863165","113863459","33","2484366"
"chr4","111381965","111382161","chr18","42945821","42946028","38","68436144"
"chr4","111392923","111393026","chr7","68275138","68275242","22","43117785"
"chr4","111393444","111393744","chr6","113877732","113878039","39","2484288"
"chr4","111588598","111588802","chr1","148246595","148246762","61","36657997"
"chr4","111732834","111733111","chr6","114233738","114234021","34","2500904"
"chr4","111845230","111845426","chr6","114349346","114349545","23","2504116"
"chr4","111858021","111858317","chr1","227415933","227416230","54","115557912"
"chr4","112064932","112065111","chr2B","16949622","16949798","44","95115310"
"chr4","112187292","112187584","chr6","114668024","114668310","40","2480732"
"chr4","112326356","112326660","chr6","114789149","114789443","66","2462793"
"chr4","112592431","112592718","chr6","115066913","115067205","28","2474482"
"chr4","112677030","112677332","chr10","91021561","91021852","66","21655469"
"chr4","112681670","112681813","chr1","138968329","138968481","35","26286659"
"chr4","113192807","113193048","chr7","29622332","29622582","63","83570475"
"chr4","113328183","113328316","chr10","34417594","34417723","23","78910589"
"chr4","113375081","113375371","chr6","115810173","115810461","42","2435092"
"chr4","113378619","113378858","chr4","194112054","194112280","66","80733435"
"chr4","113430604","113430875","chr6","115864691","115864984","59","2434087"
"chr4","113440672","113440743","chr12","130223742","130223812","10","16783070"
"chr4","113444880","113445195","chr6","115868409","115868719","41","2423529"
"chr4","113448963","113449275","chr6","115887415","115887718","39","2438452"
"chr4","113473691","113473812","chr9","74574934","74575056","20","38898757"
"chr4","113475773","113476053","chr6","115910456","115910756","47","2434683"
"chr4","113489315","113489544","chr1","217294594","217294821","46","103805279"
"chr4","113502648","113502765","chr6","115938371","115938487","12","2435723"
"chr4","113503494","113503633","chr10","116675386","116675527","37","3171892"
"chr4","113504656","113504741","chr9","98991171","98991264","16","14513485"
"chr4","113526306","113526549","chr9","78696785","78697026","61","34829521"
"chr4","113573358","113573667","chr6","116011114","116011419","54","2437756"
"chr4","113592677","113592963","chr6","116032726","116033030","56","2440049"
"chr4","113599286","113599565","chr6","116039152","116039445","46","2439866"
"chr4","113628997","113629305","chr6","116068536","116068856","47","2439539"
"chr4","113638827","113639046","chr19","32863106","32863338","48","80775721"
"chr4","113720294","113720605","chr6","116171691","116172017","55","2451397"
"chr4","113729644","113729863","chr19","18237823","18238040","67","95491821"
"chr4","113774775","113775032","chr6","116217295","116217560","49","2442520"
"chr4","113810408","113810635","chr12","121099679","121099914","66","7289271"
"chr4","113850560","113850667","chr1","90050036","90050137","23","23800524"
"chr4","113851005","113851078","chr4","151163399","151163474","15","37312394"
"chr4","113866649","113866723","chr7","23493420","23493497","16","90373229"
"chr4","113918956","113919012","chr6","116360538","116360594","4","2441582"
"chr4","113954526","113954824","chr7","79293631","79293923","65","34660895"
"chr4","114107845","114108133","chr2B","82555771","82556044","78","31552074"
"chr4","114119227","114119510","chr6","116523538","116523837","45","2404311"
"chr4","114181565","114181675","chr9","93151090","93151202","26","21030475"
"chr4","114207204","114207487","chr14","6124249","6124538","54","108082955"
"chr4","114274687","114274962","chr6","116679789","116680083","63","2405102"
"chr4","114766093","114766394","chr2B","66241494","66241783","72","48524599"
"chr4","115156160","115156373","chrX","72935930","72936137","57","42220230"
"chr4","115287000","115287126","chr6","117621921","117622051","17","2334921"
"chr4","115369558","115369863","chr12","65857390","65857691","72","49512168"
"chr4","115655026","115655148","chr6","117970725","117970847","11","2315699"
"chr4","115660318","115660597","chr22","29879824","29880101","63","85780494"
"chr4","115679701","115679985","chr6","118020819","118021084","45","2341118"
"chr4","115752982","115753076","chr5","7846452","7846538","21","107906530"
"chr4","115843174","115843297","chr18","20235847","20235969","19","95607327"
"chr4","115852224","115852557","chr6","118216687","118217018","54","2364463"
"chr4","115862449","115862666","chr6","118225232","118225447","24","2362783"
"chr4","115885697","115885736","chr6","155545700","155545734","12","39660003"
"chr4","116077471","116077666","chr1","178888015","178888218","65","62810544"
"chr4","116234154","116234282","chr16","69212656","69212783","26","47021498"
"chr4","116255708","116255964","chr6","118636124","118636382","28","2380416"
"chr4","116340750","116341043","chr6","118725130","118725403","50","2384380"
"chr4","116364423","116364550","chr14","57384963","57385086","23","58979460"
"chr4","116434002","116434308","chr6","118844012","118844297","54","2410010"
"chr4","116443018","116443307","chr7","2959934","2960208","76","113483084"
"chr4","116488171","116488325","chrX","18892778","18892934","43","97595393"
"chr4","116514218","116514487","chr6","118928204","118928488","54","2413986"
"chr4","116541578","116541677","chr6","118957398","118957498","17","2415820"
"chr4","116549618","116549908","chr6","118967495","118967789","43","2417877"
"chr4","116585221","116585502","chr14","24915480","24915757","56","91669741"
"chr4","116789747","116790051","chr6","119203521","119203832","44","2413774"
"chr4","116822562","116822854","chr6","119237242","119237545","57","2414680"
"chr4","116839554","116839665","chr6","119254205","119254317","9","2414651"
"chr4","116861239","116861511","chr6","119275377","119275655","31","2414138"
"chr4","117005614","117005902","chr6","119438531","119438813","34","2432917"
"chr4","117365780","117366075","chr6","119789041","119789327","47","2423261"
"chr4","117404496","117404783","chr8","103159670","103159965","65","14244826"
"chr4","117406528","117406834","chr10","129597817","129598123","82","12191289"
"chr4","117418401","117418696","chr6","119837490","119837783","41","2419089"
"chr4","117454084","117454199","chr1","129719798","129719915","16","12265714"
"chr4","117480720","117480988","chr6","119913040","119913312","45","2432320"
"chr4","117506854","117507144","chr20","30853523","30853808","71","86653331"
"chr4","117531375","117531659","chr6","119964622","119964909","39","2433247"
"chr4","117533227","117533519","chr6","119966227","119966532","43","2433000"
"chr4","117575143","117575423","chr6","120020581","120020868","45","2445438"
"chr4","117768479","117768769","chr6","120214703","120214975","52","2446224"
"chr4","117959496","117959719","chr2A","37509994","37510218","52","80449502"
"chr4","117971252","117971421","chr3","32429400","32429571","38","85541852"
"chr4","117993683","117993967","chr6","120458894","120459189","44","2465211"
"chr4","118038057","118038156","chr1","33221527","33221624","27","84816530"
"chr4","118043766","118044050","chr6","120509761","120510058","50","2465995"
"chr4","118059220","118059458","chr1","225272789","225273028","60","107213569"
"chr4","118074352","118074640","chr16","40088504","40088786","63","77985848"
"chr4","118166781","118167011","chr6","37978460","37978685","53","80188321"
"chr4","118386681","118386814","chrX","3940333","3940465","22","114446348"
"chr4","118451794","118452066","chr6","120887726","120888025","65","2435932"
"chr4","118488364","118488471","chr10","60207101","60207197","29","58281263"
"chr4","118561090","118561198","chr1","11234515","11234622","17","107326575"
"chr4","118571288","118571595","chr2A","10363424","10363727","58","108207864"
"chr4","118582559","118582862","chr10","92343686","92343991","68","26238873"
"chr4","118591485","118591753","chr5","22619178","22619445","64","95972307"
"chr4","118592817","118592900","chr6","121029314","121029397","8","2436497"
"chr4","118613558","118613702","chr6","7052554","7052708","30","111561004"
"chr4","118613832","118613908","chr16","58838188","58838267","14","59775644"
"chr4","118635093","118635239","chr11","62991394","62991536","40","55643699"
"chr4","118689826","118690139","chr6","121127308","121127627","50","2437482"
"chr4","118725515","118725795","chr1","189902282","189902563","73","71176767"
"chr4","118747965","118748225","chr5","26236271","26236532","70","92511694"
"chr4","118749036","118749330","chr7","138250606","138250896","56","19501570"
"chr4","118785831","118786004","chr13","30048450","30048618","40","88737381"
"chr4","118796446","118796725","chr6","121164374","121164674","58","2367928"
"chr4","118829606","118829727","chr12","93947745","93947865","24","24881861"
"chr4","118836324","118836474","chr18","39993589","39993745","39","78842735"
"chr4","118841224","118841462","chr10","125036786","125037017","69","6195562"
"chr4","118855568","118855813","chr16","57633211","57633456","52","61222357"
"chr4","118936176","118936279","chr12","23767651","23767752","21","95168525"
"chr4","118969884","118970140","chr6","121332078","121332356","74","2362194"
"chr4","119014781","119015048","chr10","8078554","8078826","56","110936227"
"chr4","119035179","119035295","chr6","121392443","121392558","10","2357264"
"chr4","119044830","119045104","chr5","34269216","34269495","63","84775614"
"chr4","119152974","119153127","chr7","72465626","72465775","34","46687348"
"chr4","119162156","119162447","chr6","121505631","121505931","43","2343475"
"chr4","119227364","119227663","chr6","121576390","121576674","48","2349026"
"chr4","119404156","119404273","chr4","110133393","110133510","21","9270763"
"chr4","119534959","119535260","chr6","121831880","121832163","58","2296921"
"chr4","119689099","119689222","chr17","63212955","63213066","33","56476144"
"chr4","119724463","119724598","chr6","122009849","122009969","25","2285386"
"chr4","119820730","119820987","chr16","80413014","80413280","76","39407716"
"chr4","119829092","119829407","chr6","122121786","122122095","36","2292694"
"chr4","119869247","119869552","chr4","904538","904827","77","118964709"
"chr4","120501571","120501731","chr2A","80477392","80477553","37","40024179"
"chr4","120530231","120530329","chr6","15156813","15156907","24","105373418"
"chr4","120877900","120878185","chr11","31129243","31129527","61","89748657"
"chr4","120955383","120955684","chr6","123161735","123162026","66","2206352"
"chr4","121037556","121037791","chr6","123239578","123239798","41","2202022"
"chr4","121352560","121352847","chr6","123606741","123607025","31","2254181"
"chr4","121399459","121399762","chr6","123664835","123665137","45","2265376"
"chr4","121428014","121428318","chr6","123683943","123684247","25","2255929"
"chr4","121452536","121452638","chr9","60128518","60128618","19","61324018"
"chr4","121469132","121469251","chr6","123722512","123722635","21","2253380"
"chr4","121483713","121484003","chr6","123737133","123737443","57","2253420"
"chr4","121488833","121489113","chr1","182694157","182694451","72","61205324"
"chr4","121498716","121498834","chr3","159742695","159742817","26","38243979"
"chr4","121500771","121501086","chr6","123753667","123753977","36","2252896"
"chr4","121529448","121529753","chr6","123783819","123784130","48","2254371"
"chr4","121550859","121551157","chr6","123802785","123803090","39","2251926"
"chr4","121554256","121554402","chr20","31007808","31007951","31","90546448"
"chr4","121575254","121575578","chr6","123825826","123826125","58","2250572"
"chr4","121582709","121582832","chr8","14021148","14021273","34","107561561"
"chr4","121588034","121588156","chr6","123837598","123837728","23","2249564"
"chr4","121630142","121630427","chr3","42430324","42430620","64","79199818"
"chr4","121632198","121632351","chr10","49585047","49585201","33","72047151"
"chr4","121637575","121637875","chr6","123883810","123884111","64","2246235"
"chr4","121643236","121643340","chr11","10004268","10004364","28","111638968"
"chr4","121651092","121651213","chr6","123895754","123895875","11","2244662"
"chr4","121656799","121656918","chr6","123901007","123901131","13","2244208"
"chr4","121671279","121671575","chr6","123958114","123958408","44","2286835"
"chr4","121675490","121675634","chr7","105919947","105920079","39","15755543"
"chr4","121675716","121675761","chrX","47925056","47925101","10","73750660"
"chr4","121683523","121683617","chr6","123947626","123947717","19","2264103"
"chr4","121689077","121689298","chr6","123941053","123941272","27","2251976"
"chr4","121702697","121702821","chr10","42065201","42065323","24","79637496"
"chr4","121708932","121709061","chr22","11230112","11230236","28","110478820"
"chr4","121744303","121744575","chr17","33418535","33418808","63","88325768"
"chr4","121824573","121824875","chr6","124064439","124064756","52","2239866"
"chr4","121843587","121843818","chr6","124080417","124080645","43","2236830"
"chr4","121861121","121861397","chr21","17232333","17232604","60","104628788"
"chr4","121876321","121876618","chr1","16913454","16913751","73","104962867"
"chr4","121889629","121889924","chr6","124125122","124125421","49","2235493"
"chr4","121896102","121896411","chr6","124131160","124131478","45","2235058"
"chr4","122030674","122030790","chr4","177917580","177917697","22","55886906"
"chr4","122167987","122168250","chr6","124408895","124409183","57","2240908"
"chr4","122177831","122178142","chr6","124416049","124416357","47","2238218"
"chr4","122365572","122365877","chr6","124583252","124583555","41","2217680"
"chr4","122711649","122711936","chr8","43457959","43458246","59","79253690"
"chr4","122790066","122790196","chr6","124973033","124973159","21","2182967"
"chr4","122888834","122889038","chr5","122762759","122762972","42","126075"
"chr4","122959711","122959993","chr7","69538149","69538439","70","53421562"
"chr4","123369780","123370067","chr5","130109934","130110238","73","6740154"
"chr4","123432844","123432931","chr12","111845659","111845746","24","11587185"
"chr4","123571091","123571375","chr6","125719579","125719874","61","2148488"
"chr4","123872463","123872721","chr6","125996675","125996916","43","2124212"
"chr4","123940704","123940995","chr1","38001876","38002160","62","85938828"
"chr4","124143795","124144099","chr6","126282237","126282551","56","2138442"
"chr4","124258506","124258647","chr1","32730027","32730168","39","91528479"
"chr4","124284113","124284342","chr6","126418443","126418676","37","2134330"
"chr4","124338585","124338878","chr6","126459376","126459676","52","2120791"
"chr4","124375411","124375715","chr1","10662137","10662426","81","113713274"
"chr4","124876502","124876658","chr1","28338594","28338747","39","96537908"
"chr4","124969477","124969588","chr6","127112885","127113005","20","2143408"
"chr4","125175853","125175909","chr10","39125423","39125481","17","86050430"
"chr4","125449112","125449242","chr10","112111608","112111739","21","13337504"
"chr4","125483499","125483780","chr6","127637445","127637732","41","2153946"
"chr4","125532532","125532651","chr5","69983749","69983882","28","55548783"
"chr4","125601385","125601509","chr5","58474733","58474857","17","67126652"
"chr4","125762041","125762327","chr19","46062191","46062484","69","79699850"
"chr4","126028952","126029251","chr6","128218236","128218535","44","2189284"
"chr4","126060996","126061257","chr6","128246192","128246479","67","2185196"
"chr4","126068531","126068844","chr6","128253464","128253797","58","2184933"
"chr4","126103535","126103826","chr5","16481467","16481764","59","109622068"
"chr4","126175357","126175637","chr6","128353621","128353892","33","2178264"
"chr4","126185751","126185935","chr11","44694637","44694827","34","81491114"
"chr4","126200864","126201183","chr6","128379373","128379715","63","2178509"
"chr4","126272534","126272833","chr6","128453111","128453399","36","2180577"
"chr4","126285707","126285847","chr7","42050251","42050392","37","84235456"
"chr4","126294719","126295017","chr11","78977979","78978275","71","47316740"
"chr4","126565720","126565805","chr6","82075859","82075947","20","44489861"
"chr4","126996736","126997009","chr6","129247110","129247376","33","2250374"
"chr4","127120814","127121097","chr12","67905192","67905480","68","59215622"
"chr4","127356562","127356722","chr7","74656895","74657048","45","52699667"
"chr4","127518508","127518779","chr6","129759358","129759648","64","2240850"
"chr4","127561816","127562118","chr19","49497422","49497731","67","78064394"
"chr4","128084753","128085034","chr1","52543287","52543561","62","75541466"
"chr4","128161680","128161901","chr6","130383758","130383988","28","2222078"
"chr4","128211981","128212048","chr10","13656722","13656785","17","114555259"
"chr4","128212220","128212452","chr1","217294594","217294821","56","89082374"
"chr4","128245608","128245920","chr6","130464714","130465023","41","2219106"
"chr4","128303730","128303802","chr4","4333939","4334013","13","123969791"
"chr4","128402915","128403186","chr7","130610319","130610598","72","2207404"
"chr4","128403905","128404022","chr12","114534900","114535017","21","13869005"
"chr4","128502724","128503020","chr6","130715201","130715496","44","2212477"
"chr4","128619193","128619480","chr6","130819456","130819766","56","2200263"
"chr4","128645889","128646184","chr4","16081004","16081309","72","112564885"
"chr4","128771084","128771229","chr1","32730027","32730168","36","96041057"
"chr4","129078185","129078478","chr6","131257684","131257970","40","2179499"
"chr4","129182962","129183260","chr6","131364288","131364593","52","2181326"
"chr4","129278736","129279032","chr6","131456289","131456561","57","2177553"
"chr4","129648348","129648578","chr6","131844092","131844319","32","2195744"
"chr4","129672675","129672784","chr6","131870449","131870558","11","2197774"
"chr4","129697438","129697549","chr2A","48942992","48943105","20","80754446"
"chr4","129731465","129731763","chr6","131924883","131925182","44","2193418"
"chr4","129847123","129847415","chr6","132040232","132040525","56","2193109"
"chr4","129865034","129865339","chr6","132057944","132058250","34","2192910"
"chr4","129904622","129904910","chrX","42739293","42739569","79","87165329"
"chr4","129910873","129911070","chr6","132100375","132100579","21","2189502"
"chr4","129929414","129929723","chr6","132130815","132131127","41","2201401"
"chr4","130009468","130009752","chr6","132209613","132209881","47","2200145"
"chr4","130023534","130023834","chr7","138327063","138327364","59","8303529"
"chr4","130038123","130038270","chr10","49585047","49585201","34","80453076"
"chr4","130042479","130042577","chr6","132241886","132241982","8","2199407"
"chr4","130049196","130049481","chr2A","4856156","4856444","57","125193040"
"chr4","130054400","130054708","chr6","132250391","132250700","43","2195991"
"chr4","130074983","130075265","chr6","132271936","132272194","54","2196953"
"chr4","130101973","130102099","chr3","24059298","24059420","16","106042675"
"chr4","130108347","130108585","chr5","102445772","102446020","71","27662575"
"chr4","130160820","130160951","chr6","6591151","6591273","34","123569669"
"chr4","130162608","130162900","chr1","227415933","227416230","70","97253325"
"chr4","130168581","130168874","chr6","132364607","132364916","43","2196026"
"chr4","130194872","130195184","chr6","132378757","132379080","40","2183885"
"chr4","130207957","130208100","chr6","132391906","132392074","43","2183949"
"chr4","130270591","130270845","chr6","132453247","132453495","32","2182656"
"chr4","130319889","130320177","chr1","227415933","227416230","65","97096044"
"chr4","130443330","130443446","chr17","63212955","63213066","30","67230375"
"chr4","130481475","130481776","chr6","132658704","132658989","60","2177229"
"chr4","130488182","130488395","chr11","119369882","119370095","53","11118300"
"chr4","130496376","130496668","chr6","132673494","132673804","63","2177118"
"chr4","130661900","130662068","chr7","33097594","33097757","34","97564306"
"chr4","130725180","130725410","chr4","130394551","130394779","67","330629"
"chr4","130840867","130841100","chr6","133021688","133021932","51","2180821"
"chr4","130977331","130977613","chr6","133125892","133126190","48","2148561"
"chr4","130982247","130982478","chr12","97040885","97041149","74","33941362"
"chr4","131074562","131074846","chr6","133213828","133214114","42","2139266"
"chr4","131075320","131075593","chr6","133214602","133214877","41","2139282"
"chr4","131079772","131080079","chr6","133218480","133218782","61","2138708"
"chr4","131340082","131340383","chr1","216269319","216269611","72","84929237"
"chr4","131379657","131379964","chr6","133492488","133492791","34","2112831"
"chr4","131389841","131390110","chr8","67956056","67956297","70","63433785"
"chr4","131424076","131424378","chr6","133540722","133541027","59","2116646"
"chr4","131439737","131440028","chr6","133552716","133553041","69","2112979"
"chr4","131457432","131457768","chr19","57827183","57827506","80","73630249"
"chr4","131466738","131466857","chr5","115357306","115357430","32","16109432"
"chr4","131500755","131500873","chr6","133621678","133621796","11","2120923"
"chr4","131514244","131514370","chr3","116447673","116447800","29","15066571"
"chr4","131569362","131569659","chr6","133684459","133684769","55","2115097"
"chr4","131613188","131613388","chr2B","107927029","107927228","41","23686159"
"chr4","131628620","131628698","chr18","12310575","12310655","20","119318045"
"chr4","131629577","131629782","chr15","60169201","60169405","39","71460376"
"chr4","131645135","131645436","chr6","133765611","133765911","31","2120476"
"chr4","131682869","131683145","chr6","133810909","133811181","46","2128040"
"chr4","131701600","131701720","chr6","133833624","133833742","17","2132024"
"chr4","131748873","131749165","chr6","133879677","133879964","28","2130804"
"chr4","131894962","131895262","chr6","134043417","134043706","38","2148455"
"chr4","131956639","131956938","chr6","134103911","134104207","51","2147272"
"chr4","131975117","131975234","chr4","71807651","71807768","13","60167466"
"chr4","131979825","131979892","chr12","1071420","1071483","18","130908405"
"chr4","131979893","131980158","chr14","34476124","34476405","63","97503769"
"chr4","131988096","131988241","chr8","103799790","103799921","43","28188306"
"chr4","131988799","131988965","chr5","125000001","125000173","37","6988798"
"chr4","131996965","131997228","chr10","106276895","106277164","61","25720070"
"chr4","131997638","131997761","chr6","134123812","134123930","14","2126174"
"chr4","132000798","132001094","chr6","134126543","134126840","39","2125745"
"chr4","132012399","132012536","chr6","134141778","134141904","25","2129379"
"chr4","132034984","132035266","chr6","134165198","134165495","49","2130214"
"chr4","132113577","132113869","chr5","133258761","133259055","65","1145184"
"chr4","132133701","132133994","chr2A","18986462","18986752","62","113147239"
"chr4","132155881","132155986","chr6","134279999","134280096","18","2124118"
"chr4","132189166","132189416","chr6","134313908","134314159","24","2124742"
"chr4","132205157","132205449","chr6","134330212","134330515","39","2125055"
"chr4","132254985","132255291","chr6","134384306","134384610","56","2129321"
"chr4","132572766","132573015","chr1","60382106","60382350","61","72190660"
"chr4","132717084","132717340","chr6","134828862","134829112","48","2111778"
"chr4","132803593","132803881","chr14","34312153","34312433","61","98491440"
"chr4","132941976","132942258","chr6","135047187","135047462","35","2105211"
"chr4","132945904","132946206","chr6","135050781","135051053","68","2104877"
"chr4","133002663","133002830","chr5","55037275","55037442","35","77965388"
"chr4","133125650","133125946","chr6","135204394","135204677","43","2078744"
"chr4","133169234","133169365","chr6","135248431","135248563","15","2079197"
"chr4","133173323","133173581","chr6","135252612","135252878","32","2079289"
"chr4","133264480","133264790","chr6","135344515","135344826","48","2080035"
"chr4","133266662","133266932","chr10","24985338","24985616","74","108281324"
"chr4","133440637","133440747","chr6","135526279","135526397","22","2085642"
"chr4","133485282","133485578","chr6","135567329","135567636","41","2082047"
"chr4","133554472","133554726","chr6","135640903","135641180","61","2086431"
"chr4","133563084","133563386","chr6","135649078","135649377","37","2085994"
"chr4","133591433","133591739","chrX","70775723","70776010","70","62815710"
"chr4","133593497","133593751","chr6","135677448","135677723","55","2083951"
"chr4","133611518","133611827","chr6","135696555","135696867","48","2085037"
"chr4","133628115","133628397","chrX","68457640","68457911","71","65170475"
"chr4","133883995","133884260","chr6","135967609","135967886","38","2083614"
"chr4","134086801","134087066","chr6","136175330","136175606","45","2088529"
"chr4","134097816","134098094","chr9","108814804","108815078","55","25283012"
"chr4","134182036","134182156","chr6","136243247","136243367","22","2061211"
"chr4","134237332","134237614","chr6","136280820","136281090","61","2043488"
"chr4","134253703","134253831","chr11","30233671","30233800","9","104020032"
"chr4","134274051","134274178","chr10","12650705","12650831","28","121623346"
"chr4","134550715","134551015","chr6","136587930","136588223","39","2037215"
"chr4","134555908","134555994","chrX","110842491","110842575","17","23713417"
"chr4","134566853","134566992","chr6","136603803","136603949","26","2036950"
"chr4","134592482","134592764","chr10","140094597","140094882","66","5502115"
"chr4","134697437","134697553","chrX","9347869","9347986","15","125349568"
"chr4","134718034","134718326","chrX","54081472","54081761","61","80636562"
"chr4","134726641","134726922","chr4","163379359","163379612","74","28652718"
"chr4","134732123","134732404","chr6","136747585","136747887","61","2015462"
"chr4","134733614","134733902","chr4","75875835","75876122","61","58857779"
"chr4","134739282","134739402","chr6","136758288","136758408","14","2019006"
"chr4","134746502","134746642","chr11","62991394","62991536","27","71755108"
"chr4","134761091","134761281","chr2B","62135321","62135506","46","72625770"
"chr4","134764348","134764667","chr4","4517769","4518079","65","130246579"
"chr4","134781618","134781923","chr6","136808404","136808696","57","2026786"
"chr4","134787339","134787486","chr15","69740012","69740164","31","65047327"
"chr4","134793424","134793709","chr6","136819599","136819884","24","2026175"
"chr4","134794270","134794398","chr13","31826426","31826561","37","102967844"
"chr4","134794472","134794596","chr9","103249877","103250002","24","31544595"
"chr4","134804827","134805103","chr6","136829597","136829876","48","2024770"
"chr4","134806500","134806833","chr6","136831600","136831903","62","2025100"
"chr4","134833218","134833373","chrX","6176848","6177011","29","128656370"
"chr4","134837859","134837974","chr11","129880710","129880825","22","4957149"
"chr4","134843995","134844088","chr4","165652302","165652387","18","30808307"
"chr4","134856403","134856505","chr6","136878620","136878730","20","2022217"
"chr4","134858043","134858341","chr6","136880264","136880570","54","2022221"
"chr4","134880599","134880898","chr6","136903151","136903446","39","2022552"
"chr4","134914928","134915048","chr12","111176332","111176452","28","23738596"
"chr4","134928063","134928254","chr10","18855315","18855496","56","116072748"
"chr4","134930502","134930775","chr6","136910546","136910829","40","1980044"
"chr4","134942075","134942380","chr6","136974328","136974626","39","2032253"
"chr4","134947125","134947233","chr12","107135674","107135780","24","27811451"
"chr4","135033470","135033771","chr7","78875895","78876201","66","56157575"
"chr4","135057299","135057595","chr18","45237266","45237573","58","89820033"
"chr4","135073731","135073965","chr6","137085279","137085506","32","2011548"
"chr4","135146251","135146403","chr8","25523917","25524069","37","109622334"
"chr4","135148550","135148677","chr6","152459435","152459561","19","17310885"
"chr4","135154569","135154689","chr2B","51412589","51412700","33","83741980"
"chr4","135241723","135242038","chr6","137259864","137260173","43","2018141"
"chr4","135246670","135246742","chr7","76406351","76406427","14","58840319"
"chr4","135247073","135247225","chr11","47982935","47983093","41","87264138"
"chr4","135310313","135310637","chr6","137332637","137332954","55","2022324"
"chr4","135317399","135317673","chr6","137339186","137339466","39","2021787"
"chr4","135390133","135390419","chr6","137414415","137414700","37","2024282"
"chr4","135396397","135396510","chr6","137420265","137420394","23","2023868"
"chr4","135404536","135404817","chr6","137427413","137427692","39","2022877"
"chr4","135452019","135452329","chr6","137473626","137473910","49","2021607"
"chr4","135475675","135475967","chr6","137497417","137497727","40","2021742"
"chr4","135498973","135499256","chr6","137522396","137522683","45","2023423"
"chr4","135618912","135619000","chrX","310871","310961","24","135308041"
"chr4","135633058","135633297","chr15","54848395","54848635","75","80784663"
"chr4","135664667","135664960","chr6","137668297","137668608","51","2003630"
"chr4","135673742","135673869","chr3","115387942","115388069","24","20285800"
"chr4","135676357","135676647","chr1","158422804","158423089","60","22746447"
"chr4","135690698","135690999","chr6","137692609","137692922","41","2001911"
"chr4","135712981","135713281","chr6","137715788","137716095","38","2002807"
"chr4","135738455","135738745","chr6","137738789","137739087","39","2000334"
"chr4","135745458","135745735","chr6","137746810","137747105","52","2001352"
"chr4","135765560","135765837","chr6","137763491","137763772","25","1997931"
"chr4","135770708","135770980","chr1","25427446","25427715","55","110343262"
"chr4","135774047","135774347","chr6","137769844","137770147","37","1995797"
"chr4","135778170","135778381","chr6","137773992","137774228","52","1995822"
"chr4","135822207","135822330","chr6","137822449","137822575","19","2000242"
"chr4","135825855","135826174","chr6","137826031","137826344","37","2000176"
"chr4","135889169","135889445","chr6","137877341","137877616","31","1988172"
"chr4","135921810","135922115","chr6","137908096","137908406","39","1986286"
"chr4","135925048","135925269","chr5","108026774","108026991","44","27898274"
"chr4","136108456","136108737","chr1","45314424","45314698","61","90794032"
"chr4","136164121","136164246","chr3","68517776","68517899","20","67646345"
"chr4","136169238","136169522","chr4","8514659","8514942","72","127654579"
"chr4","136180955","136181241","chr6","138127302","138127581","34","1946347"
"chr4","136382867","136383018","chr1","183378064","183378219","34","46995197"
"chr4","136383256","136383388","chr1","187726107","187726234","26","51342851"
"chr4","136402371","136402650","chr6","138329509","138329789","30","1927138"
"chr4","136552558","136552803","chr6","138466165","138466411","38","1913607"
"chr4","136630127","136630422","chr6","138561723","138562025","38","1931596"
"chr4","136646658","136646948","chr6","138579394","138579687","50","1932736"
"chr4","136731719","136731986","chr6","138669677","138669945","30","1937958"
"chr4","136758385","136758671","chr6","138699534","138699827","58","1941149"
"chr4","136769923","136770200","chr6","138711451","138711732","39","1941528"
"chr4","136771194","136771387","chr6","138712531","138712726","22","1941337"
"chr4","136775477","136775777","chr6","138716813","138717122","47","1941336"
"chr4","136781312","136781588","chr6","138721818","138722093","28","1940506"
"chr4","136782806","136783103","chr2A","37302401","37302686","77","99480405"
"chr4","136804334","136804612","chr6","138744242","138744528","50","1939908"
"chr4","136857253","136857382","chr2A","20545290","20545415","24","116311963"
"chr4","136882030","136882071","chr17","52033312","52033357","9","84848718"
"chr4","136882756","136882877","chr20","463061","463172","41","136419695"
"chr4","136898964","136899125","chr10","51696255","51696416","23","85202709"
"chr4","136899141","136899396","chr10","51696431","51696700","46","85202710"
"chr4","136913202","136913300","chr16","62589759","62589857","20","74323443"
"chr4","136917426","136917738","chr6","138859440","138859742","53","1942014"
"chr4","136930567","136930860","chr6","138865589","138865887","44","1935022"
"chr4","136935212","136935335","chr14","10547372","10547486","24","126387840"
"chr4","136969510","136969822","chr6","138903842","138904137","65","1934332"
"chr4","136995673","136995973","chr3","145246806","145247099","63","8251133"
"chr4","137015036","137015339","chr6","138955372","138955657","69","1940336"
"chr4","137054970","137055251","chr2B","53629601","53629902","56","83425369"
"chr4","137058574","137058705","chr6","138997396","138997527","12","1938822"
"chr4","137065092","137065375","chr6","139003392","139003678","38","1938300"
"chr4","137067774","137068074","chr6","139005827","139006123","50","1938053"
"chr4","137080391","137080684","chr6","92155233","92155530","58","44925158"
"chr4","137089914","137090038","chr3","125378751","125378875","22","11711163"
"chr4","137103609","137103903","chr6","139041886","139042206","53","1938277"
"chr4","137136886","137137169","chr6","139075092","139075375","31","1938206"
"chr4","137141651","137141953","chr6","139080118","139080395","53","1938467"
"chr4","137143362","137143686","chr3","39779613","39779925","81","97363749"
"chr4","137215326","137215590","chr6","139147566","139147858","48","1932240"
"chr4","137257727","137258025","chr6","139187690","139187980","53","1929963"
"chr4","137273002","137273291","chr6","139203555","139203856","44","1930553"
"chr4","137275815","137276105","chr6","139208642","139208935","44","1932827"
"chr4","137294250","137294548","chr6","139224942","139225238","36","1930692"
"chr4","137306517","137306758","chr20","2115422","2115666","59","135191095"
"chr4","137313014","137313334","chr6","139242207","139242525","35","1929193"
"chr4","137322810","137323103","chr6","139252510","139252800","29","1929700"
"chr4","137326441","137326749","chr6","139256194","139256473","52","1929753"
"chr4","137334629","137334817","chr8","98909960","98910147","38","38424669"
"chr4","137352635","137352930","chr1","126514064","126514360","71","10838571"
"chr4","137367001","137367213","chr1","125703513","125703723","44","11663488"
"chr4","137379971","137380284","chr6","139309462","139309782","45","1929491"
"chr4","137392005","137392283","chr6","139321487","139321778","69","1929482"
"chr4","137402249","137402542","chr7","4753502","4753792","71","132648747"
"chr4","137455723","137455922","chr12","109697331","109697532","46","27758392"
"chr4","137489439","137489524","chr1","17798378","17798465","22","119691061"
"chr4","137527194","137527496","chr6","139449609","139449905","36","1922415"
"chr4","137538054","137538159","chr19","37923532","37923635","28","99614522"
"chr4","137538172","137538295","chr20","34631402","34631525","16","102906770"
"chr4","137548379","137548674","chr6","139471809","139472102","44","1923430"
"chr4","137641766","137642076","chr6","139559062","139559364","59","1917296"
"chr4","137646974","137647256","chr6","139563998","139564293","51","1917024"
"chr4","137656243","137656526","chr6","139573455","139573729","50","1917212"
"chr4","137735616","137735936","chr1","126514064","126514360","88","11221552"
"chr4","137740316","137740607","chr12","59990652","59990942","70","77749664"
"chr4","137742116","137742210","chr1","36354985","36355078","22","101387131"
"chr4","137744855","137745014","chr6","139676439","139676618","33","1931584"
"chr4","137828339","137828633","chr19","17723353","17723654","66","120104986"
"chr4","137874350","137874645","chr6","139814809","139815103","32","1940459"
"chr4","138023500","138023721","chr3","45233841","45234045","59","92789659"
"chr4","138222332","138222547","chr6","140190358","140190573","19","1968026"
"chr4","138262623","138262750","chr16","30480444","30480558","26","107782179"
"chr4","138305667","138305776","chr12","1702","1809","17","138303965"
"chr4","138314566","138314695","chr20","33771665","33771797","25","104542901"
"chr4","138375769","138375955","chr6","25632918","25633092","39","112742851"
"chr4","138376548","138376621","chr19","19226670","19226742","10","119149878"
"chr4","138416215","138416502","chr6","140390717","140391012","45","1974502"
"chr4","138419889","138420165","chr6","140394241","140394524","29","1974352"
"chr4","138469897","138470190","chr6","140446672","140446969","36","1976775"
"chr4","138527180","138527470","chr6","140510524","140510812","41","1983344"
"chr4","138556513","138556699","chr3","74130100","74130269","53","64426413"
"chr4","138573919","138574077","chr6","140572653","140572825","30","1998734"
"chr4","138761964","138762078","chr20","46080183","46080300","18","92681781"
"chr4","138895606","138895871","chr6","140890423","140890715","52","1994817"
"chr4","138942052","138942169","chr1","182798095","182798212","20","43856043"
"chr4","138954057","138954340","chr6","140946064","140946365","46","1992007"
"chr4","138956980","138957104","chr17","26242812","26242935","25","112714168"
"chr4","138960173","138960377","chr15","61589063","61589258","49","77371110"
"chr4","138975601","138975899","chr6","140981693","140981986","41","2006092"
"chr4","139070441","139070572","chr6","141063604","141063722","28","1993163"
"chr4","139090010","139090262","chr6","141083537","141083797","35","1993527"
"chr4","139110660","139110952","chr6","141105080","141105390","59","1994420"
"chr4","139152117","139152433","chr6","141145887","141146168","60","1993770"
"chr4","139154492","139154786","chr6","141147835","141148139","43","1993343"
"chr4","139164260","139164544","chr6","141157418","141157702","31","1993158"
"chr4","139169079","139169331","chr6","141161745","141162004","36","1992666"
"chr4","139202421","139202703","chr6","141193021","141193299","36","1990600"
"chr4","139205550","139205758","chr6","141197392","141197604","23","1991842"
"chr4","139236200","139236496","chr6","141228372","141228656","40","1992172"
"chr4","139245421","139245717","chr6","141237152","141237455","38","1991731"
"chr4","139260707","139260810","chr1","227412510","227412616","22","88151803"
"chr4","139282549","139282661","chr11","119279810","119279917","28","20002739"
"chr4","139288453","139288523","chr10","107119420","107119486","13","32169033"
"chr4","139293820","139294097","chr6","141288169","141288443","38","1994349"
"chr4","139302811","139303125","chr8","61962855","61963167","59","77339956"
"chr4","139337983","139338288","chr10","118530035","118530339","56","20807948"
"chr4","139340806","139341066","chr6","141323581","141323862","45","1982775"
"chr4","139343448","139343531","chr3","127535773","127535861","29","11807675"
"chr4","139343771","139343919","chr5","18057976","18058128","37","121285795"
"chr4","139374066","139374336","chr6","141357537","141357825","57","1983471"
"chr4","139378310","139378591","chr6","141362312","141362605","41","1984002"
"chr4","139439702","139439882","chr8","63354407","63354585","25","76085295"
"chr4","139445377","139445655","chr10","118196113","118196383","63","21249264"
"chr4","139489217","139489334","chrX","111886886","111887003","17","27602331"
"chr4","139545370","139545689","chr6","141523105","141523413","39","1977735"
"chr4","139604006","139604295","chr9","16633553","16633838","71","122970453"
"chr4","139608837","139608991","chr1","188967838","188967994","31","49359001"
"chr4","139667606","139667887","chr6","141643945","141644220","40","1976339"
"chr4","139671843","139671914","chr5","123976410","123976480","16","15695433"
"chr4","139755108","139755380","chr13","59743979","59744250","62","80011129"
"chr4","139850923","139851188","chrX","77365213","77365479","73","62485710"
"chr4","139876530","139876719","chr6","36640552","36640719","49","103235978"
"chr4","139911459","139911726","chr6","141895448","141895743","47","1983989"
"chr4","139996180","139996484","chr1","45032090","45032394","55","94964090"
"chr4","140026514","140026807","chr6","142007950","142008232","46","1981436"
"chr4","140077810","140078024","chr6","142055496","142055712","39","1977686"
"chr4","140098019","140098127","chr5","81940022","81940139","18","58157997"
"chr4","140098483","140098638","chr9","108241495","108241645","40","31856988"
"chr4","140207459","140207749","chr22","25856818","25857103","82","114350641"
"chr4","140444390","140444661","chr4","74466295","74466566","73","65978095"
"chr4","140735871","140736161","chr6","142677883","142678207","65","1942012"
"chr4","140902174","140902285","chr19","17944871","17944975","19","122957303"
"chr4","140933075","140933312","chr8","10531060","10531313","89","130402015"
"chr4","140936239","140936365","chr7","26158438","26158564","30","114777801"
"chr4","141020463","141020691","chr6","36791131","36791360","65","104229332"
"chr4","141179540","141179648","chr7","130520334","130520431","34","10659206"
"chr4","141338956","141339073","chr3","140789821","140789937","19","549135"
"chr4","141443957","141444250","chr6","143392360","143392685","56","1948403"
"chr4","141566835","141567081","chr1","86262467","86262717","66","55304368"
"chr4","141569052","141569265","chr19","52452184","52452398","68","89116868"
"chr4","141588998","141589116","chr1","17358799","17358917","19","124230199"
"chr4","141756433","141756543","chr6","143714412","143714520","14","1957979"
"chr4","141756951","141757109","chr3","10866047","10866211","38","130890904"
"chr4","141768460","141768592","chr6","143727940","143728082","17","1959480"
"chr4","141789239","141789533","chr6","143744956","143745269","50","1955717"
"chr4","141792732","141792846","chr6","36093674","36093792","18","105699058"
"chr4","141963083","141963198","chr8","8957635","8957751","20","133005448"
"chr4","142033577","142033705","chr20","5893261","5893384","34","136140316"
"chr4","142110818","142110964","chrX","47447396","47447553","39","94663422"
"chr4","142113529","142113653","chr9","50783372","50783496","25","91330157"
"chr4","142138247","142138377","chr2A","37212950","37213081","27","104925297"
"chr4","142204633","142204894","chr6","5772596","5772866","68","136432037"
"chr4","142274009","142274329","chr12","43802996","43803296","67","98471013"
"chr4","142400361","142400688","chr6","144372322","144372632","54","1971961"
"chr4","142428817","142429085","chr1","196488135","196488410","73","54059318"
"chr4","142783028","142783136","chr5","61088728","61088837","19","81694300"
"chr4","142794724","142794821","chr6","144757983","144758076","10","1963259"
"chr4","142834127","142834439","chr6","144788669","144788956","64","1954542"
"chr4","142942279","142942377","chr1","11234515","11234622","25","131707764"
"chr4","143065676","143065818","chr19","41295266","41295409","37","101770410"
"chr4","143095281","143095563","chr6","145038771","145039082","54","1943490"
"chr4","143119777","143119896","chr22","5184977","5185101","28","137934800"
"chr4","143131518","143131799","chr6","145075425","145075717","39","1943907"
"chr4","143345002","143345298","chr6","145272340","145272658","65","1927338"
"chr4","143370224","143370493","chr6","145303521","145303833","64","1933297"
"chr4","143425384","143425660","chr6","145355565","145355861","43","1930181"
"chr4","143443072","143443385","chr11","113895376","113895691","61","29547696"
"chr4","143458167","143458251","chr3","38428197","38428280","16","105029970"
"chr4","143495463","143495730","chr6","145428997","145429274","49","1933534"
"chr4","143528320","143528423","chr4","87969008","87969113","22","55559312"
"chr4","143528606","143528787","chr3","200071024","200071194","53","56542418"
"chr4","143644129","143644430","chr20","58805203","58805504","58","84838926"
"chr4","143775015","143775310","chr1","93131332","93131627","70","50643683"
"chr4","143782957","143783241","chr6","145739057","145739353","40","1956100"
"chr4","143792361","143792650","chr6","145751647","145751939","35","1959286"
"chr4","143829990","143830244","chr16","31649333","31649595","62","112180657"
"chr4","143839493","143839610","chr6","145800968","145801085","15","1961475"
"chr4","143885455","143885606","chr15","69740012","69740164","21","74145443"
"chr4","143909795","143909960","chr3","15628717","15628877","33","128281078"
"chr4","143956247","143956506","chr6","145938428","145938683","37","1982181"
"chr4","144048961","144049255","chr6","146042620","146042922","65","1993659"
"chr4","144055998","144056270","chr6","146048739","146049041","57","1992741"
"chr4","144073946","144074249","chr6","146068351","146068659","59","1994405"
"chr4","144157380","144157639","chr6","146147876","146148132","35","1990496"
"chr4","144164213","144164476","chr2A","64651674","64651938","59","79512539"
"chr4","144165202","144165446","chr8","45610169","45610420","65","98555033"
"chr4","144173934","144174135","chr10","144183743","144183945","43","9809"
"chr4","144186804","144187114","chr6","146179568","146179886","36","1992764"
"chr4","144190460","144190588","chr10","12650705","12650831","25","131539755"
"chr4","144217969","144218279","chr12","108745776","108746083","65","35472193"
"chr4","144251134","144251432","chr6","146251348","146251655","36","2000214"
"chr4","144259212","144259404","chr5","34152918","34153115","51","110106294"
"chr4","144317662","144317970","chr6","146316194","146316510","58","1998532"
"chr4","144325488","144325771","chr6","146323295","146323593","42","1997807"
"chr4","144340222","144340523","chr6","146339685","146339980","38","1999463"
"chr4","144419130","144419443","chr6","146420191","146420508","60","2001061"
"chr4","144466953","144467237","chr19","475704","475988","54","143991249"
"chr4","144471122","144471246","chr8","102210620","102210743","22","42260502"
"chr4","144471794","144471917","chr12","32518023","32518141","23","111953771"
"chr4","144484010","144484312","chr6","146481979","146482281","19","1997969"
"chr4","144489589","144489889","chr6","146493539","146493828","51","2003950"
"chr4","144502366","144502497","chr7","11181123","11181256","25","133321243"
"chr4","144514411","144514536","chr6","146521607","146521732","13","2007196"
"chr4","144588778","144589087","chr6","146609015","146609327","48","2020237"
"chr4","144597993","144598267","chr6","146625917","146626186","42","2027924"
"chr4","144688824","144689136","chr6","146714239","146714564","52","2025415"
"chr4","144720494","144720810","chr1","46744720","46745014","71","97975774"
"chr4","144919421","144919710","chr6","146929737","146930025","26","2010316"
"chr4","144993837","144993960","chr16","12415428","12415559","27","132578409"
"chr4","145024074","145024362","chr8","78414509","78414797","56","66609565"
"chr4","145026245","145026543","chr7","120833001","120833284","70","24193244"
"chr4","145072260","145072553","chr6","147139756","147140037","36","2067496"
"chr4","145228605","145228890","chr6","147299043","147299329","27","2070438"
"chr4","145239485","145239796","chr4","135197615","135197929","72","10041870"
"chr4","145337246","145337511","chr6","147402269","147402538","39","2065023"
"chr4","145420475","145420774","chr6","147484553","147484835","55","2064078"
"chr4","145442135","145442429","chr6","147507893","147508184","45","2065758"
"chr4","145465380","145465630","chr6","147528850","147529132","60","2063470"
"chr4","145558943","145559151","chr3","125995297","125995489","54","19563646"
"chr4","145559730","145559814","chr19","49971385","49971478","25","95588345"
"chr4","145589366","145589493","chr9","114196210","114196334","24","31393156"
"chr4","145788394","145788698","chr6","147841912","147842211","28","2053518"
"chr4","146117928","146118222","chr6","148157828","148158128","45","2039900"
"chr4","146342728","146343005","chr6","148422223","148422499","50","2079495"
"chr4","146482083","146482353","chr6","148578487","148578767","42","2096404"
"chr4","146502124","146502406","chr6","148601965","148602237","41","2099841"
"chr4","146569291","146569614","chr6","148667454","148667749","70","2098163"
"chr4","146606580","146606700","chr6","148702927","148703059","27","2096347"
"chr4","146620120","146620350","chr11","111758061","111758289","57","34862059"
"chr4","146620947","146621021","chr19","18194834","18194910","21","128426113"
"chr4","146689090","146689247","chr12","34433861","34434020","51","112255229"
"chr4","146772469","146772746","chr6","148861864","148862138","51","2089395"
"chr4","146960468","146960699","chr1","15467687","15467900","63","131492781"
"chr4","146965968","146966260","chr6","149041424","149041706","52","2075456"
"chr4","147000010","147000245","chr8","49062052","49062276","53","97937958"
"chr4","147083077","147083217","chr4","94320345","94320488","31","52762732"
"chr4","147083663","147083784","chr5","164747978","164748101","26","17664315"
"chr4","147155741","147155917","chr6","149205454","149205625","28","2049713"
"chr4","147381499","147381794","chr6","149430874","149431182","61","2049375"
"chr4","147571356","147571648","chr1","130563571","130563869","57","17007785"
"chr4","147828120","147828411","chr6","149865214","149865513","37","2037094"
"chr4","147870943","147871195","chr6","149906472","149906707","41","2035529"
"chr4","147977497","147977779","chr19","35491223","35491503","69","112486274"
"chr4","147996886","147997182","chr19","46062191","46062484","60","101934695"
"chr4","148080998","148081266","chr6","150118641","150118920","47","2037643"
"chr4","148098872","148099071","chr16","27370729","27370928","53","120728143"
"chr4","148149896","148150173","chr6","150180730","150181021","38","2030834"
"chr4","148245602","148245874","chr6","150267853","150268122","46","2022251"
"chr4","148315247","148315349","chr1","45273792","45273898","29","103041455"
"chr4","148345563","148345868","chr6","150371720","150372005","48","2026157"
"chr4","148543931","148544238","chr6","150575266","150575556","59","2031335"
"chr4","148620825","148620930","chr1","16142247","16142345","30","132478578"
"chr4","148902767","148903046","chr6","150918057","150918342","47","2015290"
"chr4","148936467","148936586","chr10","83258744","83258863","22","65677723"
"chr4","148992438","148992740","chr6","151006510","151006834","49","2014072"
"chr4","148992865","148993015","chr5","42752401","42752550","36","106240464"
"chr4","149041040","149041326","chr6","151049337","151049610","45","2008297"
"chr4","149069085","149069374","chr17","5812969","5813256","70","143256116"
"chr4","149078871","149079018","chr4","163306835","163306988","37","14227964"
"chr4","149100794","149101020","chr10","90969382","90969594","63","58131412"
"chr4","149206168","149206471","chr2B","69641574","69641885","70","79564594"
"chr4","149267185","149267301","chr5","133578375","133578499","36","15688810"
"chr4","149274090","149274387","chr6","151244422","151244703","49","1970332"
"chr4","149404120","149404342","chr6","151375150","151375351","44","1971030"
"chr4","149519151","149519294","chr7","72465626","72465775","35","77053525"
"chr4","149559508","149559670","chr7","74190896","74191062","32","75368612"
"chr4","149602811","149602944","chr6","151585021","151585153","20","1982210"
"chr4","149653656","149653812","chr5","4272991","4273140","36","145380665"
"chr4","149657235","149657474","chr1","189824051","189824287","51","40166816"
"chr4","149747265","149747568","chr1","125277549","125277854","53","24469716"
"chr4","149781622","149781944","chr1","45223007","45223325","79","104558615"
"chr4","149825345","149825489","chr12","110108425","110108564","34","39716920"
"chr4","149831419","149831541","chrX","71685983","71686106","16","78145436"
"chr4","149832870","149833007","chr3","155574758","155574899","30","5741888"
"chr4","149903481","149903591","chrX","49674314","49674431","21","100229167"
"chr4","149919117","149919418","chr6","151920009","151920313","44","2000892"
"chr4","150007128","150007289","chr6","152003191","152003346","17","1996063"
"chr4","150023874","150024179","chr6","152019148","152019455","27","1995274"
"chr4","150043633","150043946","chr10","86028496","86028809","77","64015137"
"chr4","150061841","150062159","chr6","152053807","152054108","45","1991966"
"chr4","150074895","150075043","chr6","36782155","36782293","38","113292740"
"chr4","150087778","150087941","chr6","152077034","152077204","31","1989256"
"chr4","150097002","150097290","chr6","152086589","152086868","41","1989587"
"chr4","150110188","150110489","chr16","44050487","44050771","61","106059701"
"chr4","150136745","150137013","chr1","205828794","205829055","71","55692049"
"chr4","150187180","150187492","chr6","152174381","152174687","43","1987201"
"chr4","150188021","150188295","chr6","152175201","152175492","41","1987180"
"chr4","150262292","150262607","chr16","24796964","24797274","67","125465328"
"chr4","150268806","150269023","chr6","152237675","152237889","38","1968869"
"chr4","150283441","150283738","chr6","152252567","152252870","45","1969126"
"chr4","150314980","150315271","chr5","52040637","52040935","71","98274343"
"chr4","150363888","150364021","chr6","152322420","152322551","16","1958532"
"chr4","150415320","150415619","chr18","77617597","77617900","60","72797723"
"chr4","150415879","150416170","chr6","152377523","152377818","25","1961644"
"chr4","150463404","150463701","chr6","152407985","152408293","41","1944581"
"chr4","150488743","150489046","chr6","152437876","152438184","45","1949133"
"chr4","150499133","150499203","chr12","130223742","130223812","17","20275391"
"chr4","150499668","150499750","chr11","107468919","107469000","17","43030749"
"chr4","150503214","150503352","chr10","8158944","8159077","22","142344270"
"chr4","150521639","150521753","chr6","152482153","152482274","16","1960514"
"chr4","150527743","150527854","chr1","3482957","3483068","20","147044786"
"chr4","150556225","150556402","chr1","183809138","183809317","36","33252913"
"chr4","150561600","150561884","chr6","152523508","152523792","30","1961908"
"chr4","150594206","150594496","chr6","152560885","152561177","47","1966679"
"chr4","150618251","150618547","chr2A","45843775","45844068","57","104774476"
"chr4","150621044","150621154","chr5","18458596","18458708","20","132162448"
"chr4","150681496","150681642","chr2B","126639395","126639541","40","24042101"
"chr4","150899823","150900104","chr19","5657127","5657405","59","145242696"
"chr4","150952517","150952802","chr15","67073000","67073294","66","83879517"
"chr4","151029745","151030035","chr6","152959206","152959512","59","1929461"
"chr4","151046425","151046721","chr6","152975643","152975947","59","1929218"
"chr4","151053005","151053220","chr1","178888015","178888218","67","27835010"
"chr4","151133870","151134041","chr9","34097335","34097494","51","117036535"
"chr4","151145351","151145648","chr6","153067549","153067863","62","1922198"
"chr4","151162641","151162947","chrX","72260365","72260668","69","78902276"
"chr4","151176643","151176779","chrX","2794957","2795096","30","148381686"
"chr4","151194107","151194399","chrX","12722242","12722548","62","138471865"
"chr4","151277962","151278094","chr5","122160222","122160351","21","29117740"
"chr4","151351839","151352154","chr6","153286638","153286957","58","1934799"
"chr4","151380474","151380758","chr6","153317528","153317826","54","1937054"
"chr4","151408921","151409203","chr6","153347629","153347915","42","1938708"
"chr4","151446670","151446987","chr19","14921121","14921440","56","136525549"
"chr4","151569294","151569581","chr6","153499575","153499869","41","1930281"
"chr4","151574549","151574838","chr6","153504300","153504592","37","1929751"
"chr4","151607015","151607314","chr12","68300782","68301077","53","83306233"
"chr4","151648594","151648866","chr16","19705654","19705935","64","131942940"
"chr4","151692924","151693147","chr1","217294594","217294821","54","65601670"
"chr4","151727537","151727801","chr6","153652982","153653226","49","1925445"
"chr4","151760312","151760528","chr8","77253477","77253687","59","74506835"
"chr4","151810235","151810529","chr6","153725247","153725545","46","1915012"
"chr4","151859216","151859330","chr6","153776778","153776887","18","1917562"
"chr4","151864311","151864422","chr6","153785817","153785931","17","1921506"
"chr4","151870173","151870481","chr6","153790118","153790419","39","1919945"
"chr4","151910524","151910650","chr12","99742737","99742860","19","52167787"
"chr4","151959635","151959922","chr12","64075854","64076150","73","87883781"
"chr4","151996077","151996194","chr18","55131551","55131668","13","96864526"
"chr4","152002049","152002180","chr10","30690604","30690743","30","121311445"
"chr4","152013224","152013344","chr6","7105611","7105725","18","144907613"
"chr4","152017679","152017975","chr3","10089160","10089459","65","141928519"
"chr4","152018962","152019273","chr11","10225308","10225627","71","141793654"
"chr4","152020915","152021209","chr7","72306531","72306825","61","79714384"
"chr4","152037835","152038134","chrX","22046650","22046950","51","129991185"
"chr4","152056817","152057121","chr8","101634429","101634729","58","50422388"
"chr4","152063964","152064228","chr6","153994860","153995144","51","1930896"
"chr4","152066217","152066442","chr6","153997102","153997335","36","1930885"
"chr4","152075630","152075931","chr6","154005115","154005429","45","1929485"
"chr4","152093617","152093902","chr10","107514964","107515257","61","44578653"
"chr4","152101409","152101569","chr15","69740012","69740164","43","82361397"
"chr4","152102334","152102483","chr16","21019777","21019933","43","131082557"
"chr4","152123302","152123437","chr6","154056816","154056948","18","1933514"
"chr4","152145293","152145416","chr1","24815947","24816071","15","127329346"
"chr4","152155103","152155346","chr6","154087048","154087294","36","1931945"
"chr4","152157580","152157705","chr8","144957651","144957776","30","7199929"
"chr4","152177986","152178293","chr14","50786396","50786709","79","101391590"
"chr4","152182460","152182710","chr6","154124525","154124743","59","1942065"
"chr4","152183831","152184115","chr6","154126114","154126392","37","1942283"
"chr4","152213422","152213735","chr12","35651704","35652010","65","116561718"
"chr4","152247127","152247259","chr6","157026433","157026567","19","4779306"
"chr4","152275361","152275655","chr9","56771646","56771949","34","95503715"
"chr4","152305080","152305236","chr5","2409784","2409944","33","149895296"
"chr4","152309720","152309906","chr6","154226047","154226233","14","1916327"
"chr4","152312111","152312261","chr5","4272991","4273140","34","148039120"
"chr4","152313121","152313310","chr6","154223242","154223431","23","1910121"
"chr4","152329749","152329899","chr1","150838576","150838726","36","1491173"
"chr4","152333265","152333555","chrX","119498447","119498725","57","32834818"
"chr4","152337571","152337840","chr7","73206807","73207080","64","79130764"
"chr4","152369541","152369839","chr6","154288292","154288594","37","1918751"
"chr4","152376432","152376724","chr6","154291700","154292011","61","1915268"
"chr4","152386207","152386332","chr2A","80250486","80250611","17","72135721"
"chr4","152404175","152404434","chr6","154320318","154320577","39","1916143"
"chr4","152516674","152516944","chr6","154419799","154420055","46","1903125"
"chr4","152712403","152712672","chr7","127368178","127368446","60","25344225"
"chr4","152753799","152754062","chr12","119601286","119601556","55","33152513"
"chr4","152764123","152764381","chr6","154580246","154580504","56","1816123"
"chr4","152788808","152789089","chr6","154607058","154607342","36","1818250"
"chr4","153058640","153058936","chr6","154902752","154903051","38","1844112"
"chr4","153154363","153154658","chr6","154997092","154997390","49","1842729"
"chr4","153261986","153262260","chr1","134541898","134542172","59","18720088"
"chr4","153290756","153291056","chr6","155126103","155126410","50","1835347"
"chr4","153352341","153352636","chr6","155175091","155175386","50","1822750"
"chr4","153372923","153373173","chr11","85415764","85416020","73","67957159"
"chr4","153375737","153375867","chr6","155201144","155201272","17","1825407"
"chr4","153378713","153379004","chr6","155204415","155204701","38","1825702"
"chr4","153405623","153405920","chr6","155230507","155230821","46","1824884"
"chr4","153414665","153414718","chr20","47923234","47923272","18","105491431"
"chr4","153415272","153415392","chr5","52448639","52448758","22","100966633"
"chr4","153492763","153493032","chr6","155321275","155321537","36","1828512"
"chr4","153544939","153545233","chr6","155371763","155372050","45","1826824"
"chr4","153684521","153684600","chr11","43550790","43550868","10","110133731"
"chr4","153702189","153702464","chr6","155515028","155515327","60","1812839"
"chr4","153801906","153802208","chr6","155625649","155625947","55","1823743"
"chr4","153881254","153881382","chr7","26158438","26158564","32","127722816"
"chr4","154088797","154088978","chr6","155908973","155909144","33","1820176"
"chr4","154236516","154236823","chr6","156048392","156048682","42","1811876"
"chr4","154607131","154607413","chr21","33726760","33727043","70","120880371"
"chr4","154674189","154674340","chr2B","126162282","126162438","39","28511907"
"chr4","154679185","154679456","chr6","156550978","156551269","57","1871793"
"chr4","154853350","154853654","chr6","156758872","156759151","56","1905522"
"chr4","154856258","154856541","chr6","156761444","156761738","41","1905186"
"chr4","154968844","154968975","chr12","62965019","62965148","24","92003825"
"chr4","154969887","154970142","chr7","6546616","6546876","67","148423271"
"chr4","155033026","155033130","chr1","39325820","39325928","23","115707206"
"chr4","155053718","155053881","chr6","156953379","156953553","34","1899661"
"chr4","155144132","155144436","chr16","4875562","4875862","67","150268570"
"chr4","155147171","155147433","chr6","157048848","157049107","38","1901677"
"chr4","155151548","155151844","chr6","157053065","157053352","30","1901517"
"chr4","155154827","155154944","chr6","157056854","157056971","16","1902027"
"chr4","155156906","155157187","chr6","157059026","157059322","43","1902120"
"chr4","155165628","155165751","chr6","157067537","157067658","13","1901909"
"chr4","155173304","155173580","chr20","24655136","24655403","72","130518168"
"chr4","155185422","155185709","chr6","157085361","157085659","46","1899939"
"chr4","155187811","155188103","chr14","87397924","87398217","58","67789887"
"chr4","155191553","155191840","chr6","157088975","157089258","32","1897422"
"chr4","155200101","155200272","chr10","88822362","88822526","34","66377739"
"chr4","155217734","155217844","chr22","2031843","2031947","28","153185891"
"chr4","155217896","155218003","chr5","34094250","34094358","23","121123646"
"chr4","155226788","155227059","chr6","157142939","157143235","55","1916151"
"chr4","155259048","155259320","chr6","157163273","157163545","27","1904225"
"chr4","155261945","155262070","chr3","125378751","125378875","19","29883194"
"chr4","155270567","155270876","chr10","142926143","142926445","61","12344424"
"chr4","155280562","155280846","chr12","75753838","75754120","59","79526724"
"chr4","155298827","155299118","chr6","157204930","157205244","55","1906103"
"chr4","155321560","155321821","chr6","157227585","157227857","33","1906025"
"chr4","155325512","155325815","chr6","157231001","157231304","37","1905489"
"chr4","155340723","155340840","chr5","124152960","124153079","20","31187763"
"chr4","155354201","155354358","chr2A","88394171","88394332","36","66960030"
"chr4","155386638","155386927","chr6","157288219","157288534","59","1901581"
"chr4","155434056","155434209","chr1","53190096","53190253","32","102243960"
"chr4","155434626","155434890","chr12","113199761","113200025","59","42234865"
"chr4","155443279","155443589","chr19","35619853","35620153","62","119823426"
"chr4","155459286","155459571","chr6","157327219","157327515","41","1867933"
"chr4","155475030","155475316","chr6","157340485","157340775","43","1865455"
"chr4","155481563","155481707","chr2B","94897282","94897419","35","60584281"
"chr4","155516799","155517049","chr6","157387492","157387760","42","1870693"
"chr4","155611731","155612018","chr4","165626465","165626758","71","10014734"
"chr4","155619666","155619966","chr20","932951","933253","62","154686715"
"chr4","155623618","155623880","chr6","157477669","157477933","34","1854051"
"chr4","155624042","155624329","chr3","131369946","131370239","59","24254096"
"chr4","155633234","155633500","chr2A","83494806","83495066","58","72138428"
"chr4","155634753","155635042","chr6","157487230","157487522","37","1852477"
"chr4","155640257","155640549","chr6","157495039","157495351","48","1854782"
"chr4","155657209","155657389","chr16","57706400","57706579","51","97950809"
"chr4","155679354","155679564","chr6","157541258","157541481","43","1861904"
"chr4","155694631","155694918","chr6","157556721","157557023","48","1862090"
"chr4","155730267","155730564","chr9","78735288","78735592","70","76994979"
"chr4","155748191","155748515","chr10","92164597","92164886","91","63583594"
"chr4","155761826","155762126","chr1","227415933","227416230","57","71654107"
"chr4","155785035","155785345","chr6","157644451","157644752","48","1859416"
"chr4","155811926","155812216","chr6","157670024","157670323","42","1858098"
"chr4","155818740","155818861","chr6","157674116","157674239","18","1855376"
"chr4","155846729","155846844","chr6","157700823","157700932","14","1854094"
"chr4","155860869","155860960","chr6","157715459","157715554","19","1854590"
"chr4","155866696","155866972","chr16","44050487","44050771","61","111816209"
"chr4","155870919","155871214","chr3","119028533","119028825","75","36842386"
"chr4","155909931","155910054","chr19","2045926","2046042","31","153864005"
"chr4","155933451","155933747","chr7","30249538","30249830","52","125683913"
"chr4","155944683","155944986","chr18","72082653","72082941","60","83862030"
"chr4","155958878","155959006","chr16","8990415","8990539","29","146968463"
"chr4","155984316","155984606","chr6","157826302","157826594","34","1841986"
"chr4","155993882","155994000","chr6","157835856","157835971","10","1841974"
"chr4","155998147","155998254","chr6","157840919","157841026","17","1842772"
"chr4","156000589","156000881","chr6","157843241","157843552","51","1842652"
"chr4","156014648","156014818","chr5","2409784","2409944","38","153604864"
"chr4","156044175","156044485","chr6","157895806","157896105","50","1851631"
"chr4","156096537","156096802","chr6","157941788","157942069","50","1845251"
"chr4","156120454","156120571","chr8","87397828","87397940","23","68722626"
"chr4","156146434","156146727","chr6","157988523","157988810","31","1842089"
"chr4","156155162","156155435","chr7","69824494","69824774","58","86330668"
"chr4","156200787","156200925","chr4","81660718","81660851","22","74540069"
"chr4","156242874","156242989","chr6","158082195","158082308","10","1839321"
"chr4","156477600","156477842","chr6","158290282","158290536","48","1812682"
"chr4","156536117","156536393","chr6","158340181","158340484","45","1804064"
"chr4","156933802","156934106","chr6","158731638","158731953","52","1797836"
"chr4","157008179","157008473","chr6","158805407","158805698","61","1797228"
"chr4","157134786","157135091","chr6","158930398","158930702","48","1795612"
"chr4","157281602","157281718","chr6","159088268","159088384","12","1806666"
"chr4","157301469","157301759","chr6","159108972","159109278","44","1807503"
"chr4","157462272","157462573","chr6","159257547","159257854","51","1795275"
"chr4","157492061","157492179","chr6","159284888","159285009","12","1792827"
"chr4","157492298","157492368","chr15","16444783","16444854","14","141047515"
"chr4","157527675","157527803","chr6","159331330","159331455","14","1803655"
"chr4","157587222","157587533","chr6","159389684","159389985","44","1802462"
"chr4","157611445","157611624","chr8","73261791","73261959","48","84349654"
"chr4","157650060","157650212","chr10","112202304","112202461","43","45447756"
"chr4","157723404","157723703","chr7","79073505","79073807","57","78649899"
"chr4","157735840","157736145","chr6","159536355","159536662","44","1800515"
"chr4","157742566","157742699","chr7","77000001","77000126","31","80742565"
"chr4","157748326","157748601","chr21","35390505","35390778","59","122357821"
"chr4","157754356","157754632","chr6","159553224","159553507","36","1798868"
"chr4","157784518","157784721","chr6","159585191","159585399","25","1800673"
"chr4","157785069","157785133","chr6","159585740","159585805","9","1800671"
"chr4","157785318","157785594","chr6","159586000","159586271","36","1800682"
"chr4","157793988","157794268","chr7","71673989","71674270","58","86119999"
"chr4","157820281","157820570","chr6","159623418","159623709","38","1803137"
"chr4","157821167","157821435","chr6","159624311","159624580","55","1803144"
"chr4","157833397","157833628","chr6","159635893","159636146","55","1802496"
"chr4","157862505","157862731","chr19","18237823","18238040","47","139624682"
"chr4","157955018","157955313","chr16","20718102","20718381","83","137236916"
"chr4","157958204","157958463","chr10","8078554","8078826","59","149879650"
"chr4","157971783","157972077","chr6","159804637","159804965","80","1832854"
"chr4","158008896","158009173","chr19","4744372","4744649","59","153264524"
"chr4","158013204","158013500","chr10","25804036","25804327","64","132209168"
"chr4","158084565","158084849","chr6","159916722","159917017","52","1832157"
"chr4","158137637","158137754","chr20","5893261","5893384","28","152244376"
"chr4","158178083","158178321","chr6","160008765","160008998","16","1830682"
"chr4","158181786","158182077","chr6","160012797","160013106","59","1831011"
"chr4","158208672","158208934","chr6","160036992","160037279","59","1828320"
"chr4","158239280","158239570","chr6","160066722","160067015","41","1827442"
"chr4","158242211","158242506","chr6","160070027","160070309","41","1827816"
"chr4","158246901","158247204","chr22","30041205","30041507","66","128205696"
"chr4","158290898","158291181","chr20","34667343","34667627","58","123623555"
"chr4","158329398","158329707","chr6","160108812","160109103","61","1779414"
"chr4","158333050","158333304","chr6","108788963","108789228","69","49544087"
"chr4","158391152","158391427","chr6","160174091","160174384","55","1782939"
"chr4","158399261","158399323","chr4","192088463","192088526","17","33689202"
"chr4","158400254","158400437","chr19","11965647","11965835","42","146434607"
"chr4","158413735","158413860","chr6","160196567","160196700","15","1782832"
"chr4","158448495","158448799","chr6","160231237","160231550","45","1782742"
"chr4","158480667","158480955","chr21","18050908","18051197","60","140429759"
"chr4","158534181","158534292","chrX","47876058","47876170","22","110658123"
"chr4","158622400","158622529","chr20","32200418","32200551","32","126421982"
"chr4","158622893","158623068","chr6","160406733","160406910","27","1783840"
"chr4","158752126","158752203","chr6","160538506","160538583","3","1786380"
"chr4","158786185","158786420","chr20","5927363","5927600","54","152858822"
"chr4","158817872","158818165","chr1","210616081","210616372","62","51798209"
"chr4","158847070","158847382","chr6","160633645","160633942","50","1786575"
"chr4","158881829","158881990","chrX","119758170","119758333","33","39123659"
"chr4","158945993","158946160","chr12","19312537","19312701","23","139633456"
"chr4","158988713","158989002","chr6","160803320","160803594","47","1814607"
"chr4","159002020","159002156","chr7","77000001","77000126","28","82002019"
"chr4","159091460","159091750","chr6","160898066","160898363","33","1806606"
"chr4","159115469","159115811","chr6","160927120","160927455","55","1811651"
"chr4","159135635","159135876","chr1","45872669","45872920","55","113262966"
"chr4","159151737","159152036","chr6","160957547","160957837","49","1805810"
"chr4","159156006","159156086","chr6","160961997","160962076","8","1805991"
"chr4","159158002","159158184","chrX","139738489","139738668","35","19419513"
"chr4","159166458","159166747","chr6","160974261","160974532","53","1807803"
"chr4","159179808","159180102","chr6","160985157","160985479","58","1805349"
"chr4","159184104","159184317","chr6","91869790","91870005","40","67314314"
"chr4","159224786","159224891","chr12","66108789","66108885","31","93115997"
"chr4","159256608","159256745","chr15","18620321","18620458","29","140636287"
"chr4","159274334","159274622","chr11","130147978","130148263","62","29126356"
"chr4","159274667","159274865","chr14","89303980","89304172","55","69970687"
"chr4","159297470","159297765","chr6","161098168","161098465","43","1800698"
"chr4","159302374","159302560","chr10","105984505","105984693","52","53317869"
"chr4","159332137","159332440","chr6","161131438","161131737","34","1799301"
"chr4","159381556","159381834","chr6","161191105","161191406","49","1809549"
"chr4","159405372","159405637","chr6","161219496","161219756","38","1814124"
"chr4","159476082","159476370","chr6","161264772","161265049","32","1788690"
"chr4","159484514","159484785","chr6","161274107","161274387","41","1789593"
"chr4","159520141","159520272","chr6","111603379","111603505","26","47916762"
"chr4","159525127","159525427","chr6","161312837","161313123","52","1787710"
"chr4","159525471","159525712","chr15","23086019","23086265","62","136439452"
"chr4","159537356","159537639","chr6","161325683","161325965","41","1788327"
"chr4","159563901","159564166","chr6","161357956","161358251","63","1794055"
"chr4","159566503","159566795","chr6","161359196","161359482","44","1792693"
"chr4","159594118","159594403","chr6","12565990","12566285","58","147028128"
"chr4","159652794","159653071","chr6","161430146","161430434","44","1777352"
"chr4","159660716","159660993","chr6","161435059","161435346","43","1774343"
"chr4","159690318","159690592","chr6","161458101","161458381","42","1767783"
"chr4","159709484","159709687","chr10","144183743","144183945","64","15525741"
"chr4","159793096","159793346","chr6","161575826","161576034","60","1782730"
"chr4","159803740","159803979","chr6","161586751","161587003","40","1783011"
"chr4","159808170","159808424","chr7","77338336","77338599","62","82469834"
"chr4","159849962","159850249","chr7","2791295","2791587","51","157058667"
"chr4","159865959","159866225","chr6","161646144","161646411","27","1780185"
"chr4","159886038","159886290","chr6","161663674","161663953","52","1777636"
"chr4","159889129","159889430","chr6","161667390","161667684","54","1778261"
"chr4","159901918","159902201","chr4","2064692","2064977","56","157837226"
"chr4","159915458","159915564","chr8","53809640","53809732","32","106105818"
"chr4","159933568","159933692","chr2A","79573426","79573549","19","80360142"
"chr4","159935329","159935467","chr1","148219593","148219735","34","11715736"
"chr4","160007725","160008021","chr11","12728691","12728990","57","147279034"
"chr4","160018618","160018735","chr6","161778482","161778599","7","1759864"
"chr4","160031834","160032112","chr1","61909366","61909638","63","98122468"
"chr4","160077954","160078061","chr19","10975092","10975198","22","149102862"
"chr4","160091410","160091708","chr6","161868598","161868894","36","1777188"
"chr4","160094302","160094416","chr6","161871172","161871289","12","1776870"
"chr4","160167866","160168156","chr7","130610319","130610598","69","29557547"
"chr4","160317558","160317844","chr6","162112027","162112320","40","1794469"
"chr4","160437657","160437958","chr16","23729892","23730191","68","136707765"
"chr4","160442940","160443249","chr6","162256640","162256932","49","1813700"
"chr4","160535310","160535605","chr4","24306767","24307065","53","136228543"
"chr4","160554416","160554668","chr6","44546586","44546829","63","116007830"
"chr4","160579602","160579929","chr15","38290100","38290434","85","122289502"
"chr4","160607852","160608134","chr6","162399703","162400001","46","1791851"
"chr4","160671825","160671981","chrX","2794957","2795096","40","157876868"
"chr4","160686109","160686360","chr5","37683186","37683436","70","123002923"
"chr4","160706497","160706792","chr6","108244210","108244502","58","52462287"
"chr4","160710608","160710687","chr11","106359869","106359951","21","54350739"
"chr4","160721107","160721399","chr6","162489924","162490233","46","1768817"
"chr4","160746743","160747019","chr6","162517490","162517782","39","1770747"
"chr4","160775568","160775867","chr16","23597002","23597303","67","137178566"
"chr4","160777083","160777189","chr6","162552382","162552495","18","1775299"
"chr4","160777520","160777754","chr6","67270340","67270563","53","93507180"
"chr4","160777755","160777907","chr1","86102156","86102316","35","74675599"
"chr4","160786916","160787225","chr6","162568262","162568581","37","1781346"
"chr4","160816815","160817078","chr12","122427040","122427297","63","38389775"
"chr4","160825755","160825880","chr2A","17602188","17602313","45","143223567"
"chr4","160830169","160830441","chr6","5772596","5772866","63","155057573"
"chr4","160836296","160836578","chr6","162615395","162615675","57","1779099"
"chr4","160859080","160859234","chr1","76726531","76726685","33","84132549"
"chr4","160862270","160862552","chr6","162638989","162639269","43","1776719"
"chr4","160863565","160863786","chr6","162640341","162640568","51","1776776"
"chr4","160869959","160870229","chr1","28824673","28824958","69","132045286"
"chr4","160870243","160870539","chr6","162648556","162648854","42","1778313"
"chr4","160897769","160898058","chr6","162673475","162673767","33","1775706"
"chr4","160911821","160912066","chr5","60787675","60787923","66","100124146"
"chr4","160913344","160913654","chr10","36858720","36859016","78","124054624"
"chr4","160938225","160938531","chr9","115619132","115619433","57","45319093"
"chr4","160983735","160983895","chr11","65955607","65955759","35","95028128"
"chr4","161005009","161005283","chr6","162756001","162756271","33","1750992"
"chr4","161058867","161059144","chr2A","83000376","83000663","77","78058491"
"chr4","161159919","161160229","chr6","162909223","162909514","63","1749304"
"chr4","161179736","161179849","chr6","162931004","162931117","15","1751268"
"chr4","161272173","161272479","chr3","126400409","126400694","75","34871764"
"chr4","161707531","161707835","chr13","12463602","12463911","63","149243929"
"chr4","161708041","161708343","chr6","163826301","163826602","40","2118260"
"chr4","161735325","161735513","chrX","8706018","8706215","48","153029307"
"chr4","161800558","161800629","chr6","34878937","34879006","21","126921621"
"chr4","161907809","161908097","chr22","25856818","25857103","58","136050991"
"chr4","161922816","161922938","chr4","165930090","165930211","20","4007274"
"chr4","161930404","161930640","chr5","118145796","118146018","53","43784608"
"chr4","162112028","162112296","chr6","164203148","164203428","76","2091120"
"chr4","162279781","162280070","chr6","164321195","164321478","45","2041414"
"chr4","162449093","162449175","chr9","94983938","94984021","15","67465155"
"chr4","162532577","162532770","chr11","107804904","107805090","39","54727673"
"chr4","162626166","162626459","chr12","64769409","64769680","71","97856757"
"chr4","162666445","162666674","chr6","164677894","164678147","50","2011449"
"chr4","162689279","162689563","chr6","164700881","164701174","44","2011602"
"chr4","162707410","162707538","chr6","133517551","133517684","34","29189859"
"chr4","162722559","162722675","chr1","24167961","24168077","25","138554598"
"chr4","162852753","162853047","chr1","27665779","27666088","45","135186974"
"chr4","162857521","162857640","chr16","50327042","50327161","23","112530479"
"chr4","162925425","162925650","chr16","47158584","47158805","54","115766841"
"chr4","162949199","162949483","chrX","41306710","41306987","65","121642489"
"chr4","163022095","163022404","chr6","165004723","165005022","62","1982628"
"chr4","163207860","163208104","chr1","94682687","94682935","68","68525173"
"chr4","163208778","163209085","chr18","39868282","39868580","90","123340496"
"chr4","163225709","163225958","chr6","165199517","165199746","51","1973808"
"chr4","163372562","163372698","chr6","165333391","165333531","17","1960829"
"chr4","163492432","163492563","chr6","165468260","165468393","14","1975828"
"chr4","163501214","163501296","chr6","165472311","165472393","7","1971097"
"chr4","163524912","163525198","chr6","165493818","165494135","58","1968906"
"chr4","163605372","163605667","chr6","165571334","165571642","52","1965962"
"chr4","163625025","163625303","chr6","165590541","165590817","50","1965516"
"chr4","163746425","163746715","chr6","165733036","165733323","40","1986611"
"chr4","163786036","163786198","chr2B","63602760","63602933","36","100183276"
"chr4","163928753","163929033","chr5","63094517","63094772","69","100834236"
"chr4","163941950","163942163","chr6","165926451","165926660","23","1984501"
"chr4","163965388","163965550","chr6","165943831","165943988","37","1978443"
"chr4","164116904","164117148","chr3","154758853","154759095","70","9358051"
"chr4","164203418","164203727","chr6","166187516","166187825","44","1984098"
"chr4","164273824","164274095","chr16","65153920","65154194","67","99119904"
"chr4","164316146","164316308","chr19","43910784","43910948","34","120405362"
"chr4","164371129","164371420","chr6","166360472","166360772","40","1989343"
"chr4","164433313","164433580","chr6","166415469","166415739","34","1982156"
"chr4","164456608","164456881","chr6","166439910","166440206","57","1983302"
"chr4","164661448","164661753","chr6","166625464","166625786","54","1964016"
"chr4","164683308","164683587","chr3","14865317","14865574","73","149817991"
"chr4","164761395","164761705","chr6","166737090","166737389","40","1975695"
"chr4","164775705","164775982","chr6","166750979","166751288","64","1975274"
"chr4","164819854","164820129","chr6","166797226","166797495","38","1977372"
"chr4","164898290","164898414","chr19","8154934","8155056","35","156743356"
"chr4","164962369","164962632","chr21","37516607","37516861","79","127445762"
"chr4","165132770","165133091","chr6","167093421","167093713","59","1960651"
"chr4","165173373","165173653","chr6","167126458","167126750","55","1953085"
"chr4","165233374","165233685","chr5","63739457","63739769","66","101493917"
"chr4","165416077","165416364","chr6","167374926","167375224","42","1958849"
"chr4","165710065","165710344","chr6","167693526","167693828","55","1983461"
"chr4","165779666","165779824","chr1","31261239","31261397","33","134518427"
"chr4","165798280","165798563","chr20","45505365","45505648","54","120292915"
"chr4","165895762","165896029","chr10","91348784","91349047","67","74546978"
"chr4","165937164","165937238","chr1","215193663","215193734","14","49256499"
"chr4","166262777","166262966","chr6","35112653","35112849","52","131150124"
"chr4","166396171","166396478","chr6","168299675","168299980","46","1903504"
"chr4","166659636","166659912","chr6","168543525","168543802","48","1883889"
"chr4","166793289","166793551","chr16","41047715","41047984","64","125745574"
"chr4","167000133","167000227","chr3","127131145","127131235","20","39868988"
"chr4","167038995","167039280","chr6","168907447","168907749","53","1868452"
"chr4","167264046","167264316","chr6","169154793","169155067","45","1890747"
"chr4","167310360","167310473","chr6","169206324","169206470","39","1895964"
"chr4","167311051","167311167","chr1","22816031","22816147","16","144495020"
"chr4","167462997","167463252","chr6","169320865","169321152","54","1857868"
"chr4","167564720","167565019","chr6","169432406","169432693","46","1867686"
"chr4","167621600","167621909","chr6","169480494","169480792","42","1858894"
"chr4","167754107","167754229","chr10","119055864","119055986","20","48698243"
"chr4","167769903","167770189","chr1","131025547","131025825","78","36744356"
"chr4","167898484","167898777","chr12","105614814","105615109","62","62283670"
"chr4","167914302","167914495","chr6","169756255","169756472","44","1841953"
"chr4","167952100","167952388","chr6","169787398","169787677","41","1835298"
"chr4","167978664","167978993","chr13","91606637","91606964","76","76372027"
"chr4","168046747","168047028","chr6","169878038","169878336","60","1831291"
"chr4","168083837","168083878","chr1","161275474","161275516","11","6808363"
"chr4","168103539","168103835","chr1","150808926","150809223","72","17294613"
"chr4","168119605","168119815","chr1","204178269","204178477","55","36058664"
"chr4","168421389","168421668","chr6","170297814","170298101","54","1876425"
"chr4","168555315","168555595","chr9","34327321","34327603","57","134227994"
"chr4","168683535","168683875","chr16","61380736","61381088","111","107302799"
"chr4","168705284","168705494","chr17","7785586","7785814","53","160919698"
"chr4","168717681","168717939","chr6","170424173","170424456","55","1706492"
"chr4","168974059","168974169","chr2B","51828970","51829076","24","117145089"
"chr4","169089287","169089573","chr6","170791940","170792236","43","1702653"
"chr4","169104900","169105162","chr6","170808049","170808340","68","1703149"
"chr4","169388692","169388972","chr2A","58967829","58968116","61","110420863"
"chr4","169521245","169521515","chrX","24358585","24358865","73","145162660"
"chr4","169533443","169533706","chr6","171270286","171270567","49","1736843"
"chr4","169750363","169750620","chr16","49181420","49181682","58","120568943"
"chr4","169811158","169811293","chr1","7801459","7801595","33","162009699"
"chr4","169811372","169811475","chr7","151693715","151693828","29","18117657"
"chr4","169845856","169846151","chr12","113369447","113369739","67","56476409"
"chr4","169932163","169932468","chrX","1380982","1381280","69","168551181"
"chr4","170563579","170563865","chr6","172273087","172273367","42","1709508"
"chr4","170656230","170656501","chr7","128027283","128027543","50","42628947"
"chr4","170776728","170777006","chrX","47125526","47125835","54","123651202"
"chr4","170836935","170837250","chr6","172493044","172493349","43","1656109"
"chr4","170882531","170882844","chr1","45223007","45223325","60","125659524"
"chr4","170897387","170897658","chr3","50488243","50488521","62","120409144"
"chr4","170997618","170997904","chr19","43910014","43910306","63","127087604"
"chr4","171160270","171160425","chr6","172751725","172751903","39","1591455"
"chr4","171160766","171160887","chr17","26472199","26472320","27","144688567"
"chr4","171304767","171305056","chr19","35394402","35394690","67","135910365"
"chr4","171346398","171346685","chr6","172952649","172952956","57","1606251"
"chr4","171375278","171375590","chr6","172976436","172976751","66","1601158"
"chr4","171530370","171530507","chr7","45193364","45193496","24","126337006"
"chr4","171530576","171530754","chr15","46482405","46482571","45","125048171"
"chr4","171577793","171577901","chr4","2528135","2528243","25","169049658"
"chr4","171585745","171586037","chr16","48731873","48732160","79","122853872"
"chr4","171593224","171593519","chr6","173216734","173217046","53","1623510"
"chr5","3145723","3145966","chr20","32819975","32820214","32","29674252"
"chr5","8781781","8781899","chr20","2869109","2869227","11","5912672"
"chr5","9305892","9306194","chr16","48344919","48345204","73","39039027"
"chr5","44302310","44302614","chr20","49284353","49284656","40","4982043"
"chr5","88866794","88866937","chr20","32123638","32123783","37","56743156"
"chr5","146276071","146276368","chr1","224219009","224219297","74","77942938"
"chr5","37070","37174","chr7","75095171","75095269","22","75058101"
"chr5","44446","44566","chr6","154239364","154239482","26","154194918"
"chr5","47687","47969","chr10","64492720","64493000","51","64445033"
"chr5","100284","100579","chr20","35797259","35797569","55","35696975"
"chr5","106206","106486","chr9","95660192","95660467","62","95553986"
"chr5","107179","107393","chr3","101529162","101529367","46","101421983"
"chr5","187495","187797","chr20","35700475","35700773","40","35512980"
"chr5","229954","230014","chr17","25454121","25454182","15","25224167"
"chr5","230294","230575","chr18","44187041","44187311","70","43956747"
"chr5","230628","230906","chr18","11967859","11968133","77","11737231"
"chr5","242046","242340","chr2B","124806974","124807268","55","124564928"
"chr5","242747","243025","chr20","35617996","35618274","41","35375249"
"chr5","255453","255763","chr20","35612930","35613221","46","35357477"
"chr5","255796","256094","chr8","146432727","146433026","61","146176931"
"chr5","266801","266871","chr11","107529886","107529957","15","107263085"
"chr5","270640","270938","chr20","35595931","35596217","46","35325291"
"chr5","273661","273819","chr18","20901830","20901975","35","20628169"
"chr5","282863","282941","chr19","54225750","54225827","19","53942887"
"chr5","282956","283121","chr3","10866047","10866211","43","10583091"
"chr5","287576","287869","chr20","35578597","35578903","65","35291021"
"chr5","321554","321762","chr8","100864437","100864645","39","100542883"
"chr5","321962","322076","chr10","23782135","23782252","16","23460173"
"chr5","328720","328854","chr5","52467300","52467433","24","52138580"
"chr5","341924","342209","chr15","67073000","67073294","69","66731076"
"chr5","342336","342451","chr20","35517957","35518066","16","35175621"
"chr5","342951","343140","chr18","55236793","55236976","41","54893842"
"chr5","346507","346792","chr19","55306712","55306993","58","54960205"
"chr5","354527","354798","chr3","46408861","46409117","72","46054334"
"chr5","417643","417898","chr19","43770926","43771182","79","43353283"
"chr5","425947","426249","chr16","66000448","66000748","57","65574501"
"chr5","428106","428366","chr16","29799848","29800117","59","29371742"
"chr5","438640","438945","chr20","35439470","35439777","45","35000830"
"chr5","438947","439061","chr17","4486487","4486596","26","4047540"
"chr5","458574","458872","chr2A","59048433","59048732","60","58589859"
"chr5","465317","465607","chr20","35407137","35407427","34","34941820"
"chr5","481446","481663","chrX","1292864","1293059","49","811418"
"chr5","482643","482759","chr14","54877920","54878035","27","54395277"
"chr5","484738","485010","chr20","35387458","35387746","44","34902720"
"chr5","502447","502558","chr18","57245881","57245993","30","56743434"
"chr5","512172","512448","chr20","35367697","35367981","51","34855525"
"chr5","517547","517653","chr8","27749355","27749457","33","27231808"
"chr5","518319","518602","chr14","57525257","57525533","64","57006938"
"chr5","526579","526862","chr20","35349143","35349431","28","34822564"
"chr5","534782","535050","chr2A","83724786","83725059","56","83190004"
"chr5","543929","544232","chr5","38104922","38105205","72","37560993"
"chr5","555410","555596","chr20","35320032","35320173","66","34764622"
"chr5","555956","556109","chr20","35319433","35319589","21","34763477"
"chr5","559714","560008","chr20","35316296","35316590","31","34756582"
"chr5","601735","602004","chr18","2089832","2090112","64","1488097"
"chr5","611154","611251","chr4","196406230","196406315","29","195795076"
"chr5","623557","623672","chr7","18024900","18025015","17","17401343"
"chr5","642382","642483","chr12","54107428","54107525","23","53465046"
"chr5","649537","649669","chr1","17583170","17583302","26","16933633"
"chr5","653814","653911","chr10","11937949","11938048","30","11284135"
"chr5","672639","672756","chr7","64738088","64738205","19","64065449"
"chr5","683953","684247","chr20","35206660","35206962","36","34522707"
"chr5","690151","690208","chr12","53446024","53446079","12","52755873"
"chr5","690461","690569","chr15","22463670","22463776","28","21773209"
"chr5","696330","696447","chr16","23488866","23488983","17","22792536"
"chr5","709693","709988","chr20","35187197","35187488","55","34477504"
"chr5","709991","710143","chr13","1388300","1388452","49","678309"
"chr5","710614","710725","chr8","25225900","25226012","32","24515286"
"chr5","727561","727822","chr20","35169933","35170205","45","34442372"
"chr5","755838","756136","chr12","133398994","133399295","63","132643156"
"chr5","773066","773358","chrX","9680155","9680441","56","8907089"
"chr5","779435","779552","chr6","7105611","7105725","21","6326176"
"chr5","780382","780394","chr5","102281481","102281494","2","101501099"
"chr5","780689","780835","chr1","39740056","39740201","25","38959367"
"chr5","799808","800100","chr20","35104115","35104431","53","34304307"
"chr5","809872","810072","chr20","35088629","35088835","29","34278757"
"chr5","836048","836278","chr20","37575496","37575723","51","36739448"
"chr5","836281","836565","chr20","35060690","35060975","30","34224409"
"chr5","846069","846318","chr20","35051375","35051637","37","34205306"
"chr5","872444","872671","chr10","131831607","131831827","43","130959163"
"chr5","879801","879876","chr1","168221433","168221510","24","167341632"
"chr5","879927","880098","chr10","40389689","40389851","36","39509762"
"chr5","904641","904917","chr20","34974014","34974292","27","34069373"
"chr5","922019","922309","chr20","34956566","34956856","26","34034547"
"chr5","932393","932627","chr20","44761539","44761777","48","43829146"
"chr5","933786","934092","chr19","3676668","3676974","71","2742882"
"chr5","1074965","1075242","chr20","34809140","34809439","49","33734175"
"chr5","1103586","1103885","chr20","34780543","34780851","47","33676957"
"chr5","1133014","1133206","chr5","8804647","8804834","44","7671633"
"chr5","1138062","1138244","chr10","35982547","35982746","43","34844485"
"chr5","1156127","1156423","chr20","34728626","34728926","52","33572499"
"chr5","1183935","1184232","chr20","34695668","34695959","41","33511733"
"chr5","1191340","1191626","chr20","34689058","34689332","36","33497718"
"chr5","1202077","1202366","chr20","34677424","34677723","49","33475347"
"chr5","1207994","1208281","chr7","76041457","76041753","64","74833463"
"chr5","1230738","1230866","chr20","34631402","34631525","14","33400664"
"chr5","1247541","1247794","chr7","72578921","72579180","62","71331380"
"chr5","1265205","1265466","chr10","35619261","35619547","67","34354056"
"chr5","1278874","1279129","chr7","139800493","139800754","71","138521619"
"chr5","1279723","1279857","chr20","34576125","34576263","17","33296402"
"chr5","1306039","1306331","chr19","1510634","1510923","51","204595"
"chr5","1326773","1327004","chr21","8420008","8420263","72","7093235"
"chr5","1341024","1341332","chr20","34512031","34512338","24","33171007"
"chr5","1349362","1349663","chr2A","1334954","1335244","74","14408"
"chr5","1355402","1355696","chr20","34499370","34499668","40","33143968"
"chr5","1360142","1360405","chr2B","135211367","135211620","60","133851225"
"chr5","1366794","1367090","chr20","34486848","34487142","41","33120054"
"chr5","1373542","1373615","chr22","24726477","24726553","12","23352935"
"chr5","1373732","1373793","chr2B","26931720","26931778","13","25557988"
"chr5","1403339","1403484","chr22","8436942","8437088","32","7033603"
"chr5","1425684","1425940","chr20","34424426","34424687","33","32998742"
"chr5","1438413","1438567","chr20","34414083","34414223","28","32975670"
"chr5","1450100","1450210","chr1","219799608","219799721","23","218349508"
"chr5","1453432","1453682","chr20","34396684","34396916","56","32943252"
"chr5","1482993","1483081","chr14","5148975","5149063","21","3665982"
"chr5","1483910","1483971","chr12","107948364","107948415","21","106464454"
"chr5","1529763","1530051","chr20","34345400","34345699","55","32815637"
"chr5","1612623","1612874","chr14","56421797","56422045","68","54809174"
"chr5","1616782","1617057","chr2B","93860427","93860697","53","92243645"
"chr5","1629810","1630114","chr20","32567324","32567616","62","30937514"
"chr5","1639791","1639892","chr1","191377103","191377214","20","189737312"
"chr5","1707897","1708197","chr20","34190315","34190627","40","32482418"
"chr5","1723053","1723199","chr5","156687101","156687239","36","154964048"
"chr5","1725357","1725561","chr20","34184777","34184998","48","32459420"
"chr5","1733111","1733271","chr19","44491689","44491848","33","42758578"
"chr5","1762438","1762664","chr5","4811443","4811668","46","3049005"
"chr5","1768961","1769151","chr7","6704986","6705176","56","4936025"
"chr5","1769484","1769648","chr13","5474254","5474413","36","3704770"
"chr5","1781020","1781306","chr11","64962545","64962832","48","63181525"
"chr5","1786544","1786826","chr20","34124148","34124430","46","32337604"
"chr5","1789888","1789970","chr6","54568201","54568281","16","52778313"
"chr5","1789994","1790133","chr1","32730027","32730168","29","30940033"
"chr5","1817353","1817610","chr9","44913398","44913659","60","43096045"
"chr5","1828462","1828750","chr20","34086964","34087254","35","32258502"
"chr5","1834486","1834646","chrX","71299329","71299487","37","69464843"
"chr5","1848377","1848674","chr20","34072429","34072732","41","32224052"
"chr5","1866176","1866459","chr20","34052886","34053175","53","32186710"
"chr5","1873127","1873426","chr20","34048945","34049257","53","32175818"
"chr5","1890378","1890671","chr20","34035812","34036116","56","32145434"
"chr5","1908463","1908749","chr20","34017599","34017893","38","32109136"
"chr5","1942731","1942861","chr20","33988192","33988322","14","32045461"
"chr5","1963718","1963816","chr12","59073283","59073378","26","57109565"
"chr5","1964321","1964612","chr2B","53629601","53629902","56","51665280"
"chr5","1970249","1970361","chr20","33959310","33959427","15","31989061"
"chr5","1992155","1992442","chr20","33935903","33936196","30","31943748"
"chr5","2019391","2019689","chr20","33909240","33909546","39","31889849"
"chr5","2089917","2090204","chr1","181687800","181688090","70","179597883"
"chr5","2094182","2094402","chr7","78885397","78885606","51","76791215"
"chr5","2138608","2138822","chr2A","45293448","45293673","39","43154840"
"chr5","2163080","2163194","chr20","33768665","33768785","20","31605585"
"chr5","2179796","2180019","chr7","8020665","8020904","69","5840869"
"chr5","2205339","2205628","chr20","33724033","33724345","58","31518694"
"chr5","2236858","2237139","chr5","18695293","18695567","79","16458435"
"chr5","2284418","2284546","chr20","33646691","33646820","19","31362273"
"chr5","2293866","2293949","chr20","33638127","33638223","20","31344261"
"chr5","2302640","2302782","chr18","77865542","77865689","25","75562902"
"chr5","2303260","2303384","chr10","88849823","88849949","23","86546563"
"chr5","2303641","2303766","chr6","36093674","36093792","21","33790033"
"chr5","2356869","2357059","chr3","49761396","49761592","49","47404527"
"chr5","2357541","2357849","chr10","37146351","37146646","53","34788810"
"chr5","2363162","2363278","chrX","27829704","27829819","18","25466542"
"chr5","2372275","2372415","chr20","33558466","33558606","20","31186191"
"chr5","2387959","2388257","chr20","33543476","33543768","45","31155517"
"chr5","2456075","2456241","chrX","9628850","9629012","40","7172775"
"chr5","2464509","2464762","chr9","79182975","79183222","72","76718466"
"chr5","2492053","2492318","chr20","33448710","33448959","47","30956657"
"chr5","2502293","2502575","chr19","2117277","2117563","63","385016"
"chr5","2503181","2503478","chr7","76936791","76937082","54","74433610"
"chr5","2586736","2586840","chr8","11839283","11839387","20","9252547"
"chr5","2587246","2587539","chr20","33356180","33356460","40","30768934"
"chr5","2615203","2615357","chr10","29754500","29754651","37","27139297"
"chr5","2616038","2616136","chr10","117001518","117001614","14","114385480"
"chr5","2621110","2621394","chr20","33327658","33327924","49","30706548"
"chr5","2623248","2623459","chr20","33325567","33325781","21","30702319"
"chr5","2633314","2633481","chr20","33310316","33310495","24","30677002"
"chr5","2652737","2653036","chr20","33289016","33289313","38","30636279"
"chr5","2680404","2680589","chr20","33257231","33257423","26","30576827"
"chr5","2706194","2706311","chr2B","63312351","63312469","18","60606157"
"chr5","2707009","2707112","chr11","67337030","67337134","14","64630021"
"chr5","2721120","2721242","chr6","154239364","154239482","33","151518244"
"chr5","2721614","2721684","chr14","52999928","53000000","15","50278314"
"chr5","2774928","2775027","chr7","138217164","138217262","16","135442236"
"chr5","2777185","2777469","chr20","33165281","33165550","47","30388096"
"chr5","2790164","2790447","chrX","39133182","39133470","66","36343018"
"chr5","2790518","2790766","chr20","33147085","33147330","28","30356567"
"chr5","2827503","2827780","chr20","33106693","33106969","29","30279190"
"chr5","2841046","2841161","chr4","140198632","140198749","22","137357586"
"chr5","2842754","2843057","chr1","46744720","46745014","81","43901966"
"chr5","2873615","2873921","chr14","61318114","61318412","71","58444499"
"chr5","2896283","2896400","chr20","33038573","33038689","12","30142290"
"chr5","2914695","2914822","chr6","18588428","18588554","36","15673733"
"chr5","2915170","2915297","chr21","32443205","32443329","21","29528035"
"chr5","2918475","2918681","chr6","81713475","81713674","53","78795000"
"chr5","2972786","2973077","chr19","49621533","49621829","66","46648747"
"chr5","3002674","3002932","chr1","9940626","9940869","65","6937952"
"chr5","3021239","3021405","chr1","24245703","24245864","33","21224464"
"chr5","3026897","3027167","chr1","40183621","40183888","61","37156724"
"chr5","3045111","3045412","chr10","137527138","137527440","64","134482027"
"chr5","3056942","3057075","chr20","32870242","32870375","8","29813300"
"chr5","3101290","3101592","chr20","32843128","32843405","46","29741838"
"chr5","3122803","3123091","chr20","32828654","32828944","33","29705851"
"chr5","3131408","3131560","chr10","49585047","49585201","31","46453639"
"chr5","3132945","3133253","chr2B","43511936","43512236","68","40378991"
"chr5","3133650","3133921","chr16","80997155","80997432","58","77863505"
"chr5","3139781","3140048","chr3","109596935","109597203","63","106457154"
"chr5","3163528","3163809","chr9","113876250","113876527","69","110712722"
"chr5","3164113","3164270","chr10","49585047","49585201","37","46420934"
"chr5","3184398","3184706","chr3","37965690","37965995","75","34781292"
"chr5","3192750","3193062","chr20","32760072","32760388","40","29567322"
"chr5","3202748","3203007","chr20","32750350","32750622","40","29547602"
"chr5","3214397","3214524","chr20","32739616","32739743","11","29525219"
"chr5","3242948","3243059","chr4","72175486","72175600","23","68932538"
"chr5","3255314","3255615","chr20","32694071","32694370","40","29438757"
"chr5","3298915","3299196","chr20","32649506","32649799","43","29350591"
"chr5","3328738","3328880","chr2B","94897282","94897419","34","91568544"
"chr5","3338068","3338369","chr20","32618309","32618613","34","29280241"
"chr5","3374771","3375053","chr20","32567324","32567616","44","29192553"
"chr5","3380601","3380890","chr11","119184748","119185041","52","115804147"
"chr5","3390560","3390842","chr20","32549502","32549771","40","29158942"
"chr5","3393667","3393985","chr10","15292751","15293048","70","11899084"
"chr5","3398330","3398608","chr20","32539783","32540056","35","29141453"
"chr5","3439988","3440286","chr20","32496515","32496812","54","29056527"
"chr5","3446232","3446518","chr20","32489886","32490186","37","29043654"
"chr5","3455403","3455511","chr13","9559854","9559959","23","6104451"
"chr5","3474296","3474412","chr20","32461738","32461854","15","28987442"
"chr5","3480992","3481285","chr20","32454734","32455036","47","28973742"
"chr5","3489949","3490240","chr20","32443816","32444124","44","28953867"
"chr5","3491637","3491922","chr20","32441854","32442144","32","28950217"
"chr5","3514605","3514728","chr20","32422403","32422527","19","28907798"
"chr5","3522721","3522834","chr20","32409720","32409833","9","28886999"
"chr5","3527910","3528200","chr4","163427930","163428220","58","159900020"
"chr5","3542981","3543294","chr3","73720695","73721005","57","70177714"
"chr5","3557454","3557723","chr20","32372548","32372837","49","28815094"
"chr5","3561428","3561683","chr14","43971167","43971409","68","40409739"
"chr5","3577191","3577492","chr5","23931488","23931783","58","20354297"
"chr5","3580018","3580161","chr2B","126639395","126639541","40","123059377"
"chr5","3589261","3589357","chr19","4106799","4106900","21","517538"
"chr5","3599084","3599371","chr2A","97057312","97057598","68","93458228"
"chr5","3627926","3628079","chr1","28338594","28338747","32","24710668"
"chr5","3663049","3663337","chr9","92320936","92321208","39","88657887"
"chr5","3683819","3684138","chr19","5860383","5860693","67","2176564"
"chr5","3765247","3765524","chr20","32201334","32201623","35","28436087"
"chr5","3775380","3775615","chr5","4427940","4428166","72","652560"
"chr5","3781761","3781893","chr13","27199846","27199982","21","23418085"
"chr5","3782270","3782442","chrX","19843652","19843828","34","16061382"
"chr5","3785285","3785513","chr22","15757362","15757577","49","11972077"
"chr5","3800309","3800598","chr20","32171273","32171581","50","28370964"
"chr5","3809298","3809587","chr10","12453992","12454286","80","8644694"
"chr5","3854911","3855066","chr12","28669233","28669390","35","24814322"
"chr5","3858403","3858602","chr11","8779959","8780165","59","4921556"
"chr5","3909441","3909655","chr1","46502072","46502289","52","42592631"
"chr5","3911981","3912080","chr5","18160572","18160673","25","14248591"
"chr5","3916929","3917170","chr5","98682121","98682358","61","94765192"
"chr5","3928436","3928615","chr10","115667294","115667466","38","111738858"
"chr5","3934764","3934920","chr16","58399534","58399693","36","54464770"
"chr5","3984073","3984379","chr1","63018151","63018449","63","59034078"
"chr5","4013427","4013722","chr16","31062776","31063053","75","27049349"
"chr5","4031524","4031734","chr17","51965345","51965552","46","47933821"
"chr5","4044065","4044225","chr20","44858230","44858390","31","40814165"
"chr5","4051998","4052301","chr1","227415933","227416230","57","223363935"
"chr5","4172987","4173261","chr20","31837546","31837821","28","27664559"
"chr5","4207974","4208291","chr20","31759129","31759437","63","27551155"
"chr5","4292671","4292897","chr13","64607162","64607377","54","60314491"
"chr5","4314731","4315048","chr20","31655769","31656105","55","27341038"
"chr5","4368924","4369228","chr20","31573095","31573397","21","27204171"
"chr5","4402470","4402709","chr11","65253779","65254016","63","60851309"
"chr5","4421107","4421401","chr16","71066467","71066739","70","66645360"
"chr5","4432975","4433253","chr20","31502157","31502439","31","27069182"
"chr5","4453129","4453270","chr10","148313017","148313156","29","143859888"
"chr5","4479374","4479650","chr11","93061320","93061602","66","88581946"
"chr5","4494901","4495116","chr20","31435730","31435952","33","26940829"
"chr5","4499688","4500000","chr20","31430631","31430938","51","26930943"
"chr5","4544293","4544383","chr7","52746993","52747083","24","48202700"
"chr5","4564627","4564892","chr2A","33516022","33516278","65","28951395"
"chr5","4589059","4589353","chr20","31341126","31341414","45","26752067"
"chr5","4596142","4596303","chr16","27358384","27358547","27","22762242"
"chr5","4604602","4604838","chr1","8023285","8023514","49","3418683"
"chr5","4623951","4624109","chr8","25551358","25551514","37","20927407"
"chr5","4634323","4634537","chr1","132570842","132571055","39","127936519"
"chr5","4640387","4640690","chr20","31294583","31294902","62","26654196"
"chr5","4659515","4659781","chr14","7223292","7223558","64","2563777"
"chr5","4665060","4665353","chr20","31269805","31270089","50","26604745"
"chr5","4692486","4692839","chr16","70089039","70089374","105","65396553"
"chr5","4717598","4717781","chr3","9607552","9607735","36","4889954"
"chr5","4732098","4732387","chr20","31208217","31208517","33","26476119"
"chr5","4776722","4777001","chr20","31170484","31170773","56","26393762"
"chr5","4778544","4778822","chr1","6316466","6316734","59","1537922"
"chr5","4802284","4802589","chr20","31148142","31148440","38","26345858"
"chr5","4816787","4816903","chr20","31135853","31135981","23","26319066"
"chr5","4856693","4856938","chr21","16740531","16740770","59","11883838"
"chr5","4878677","4878969","chr9","96761784","96762084","66","91883107"
"chr5","4887476","4887606","chr20","31066887","31067019","23","26179411"
"chr5","4907473","4907775","chr20","31047634","31047930","46","26140161"
"chr5","4925388","4925665","chr20","31025250","31025525","30","26099862"
"chr5","4935299","4935559","chr20","31014659","31014906","46","26079360"
"chr5","4943424","4943725","chr20","31007129","31007426","30","26063705"
"chr5","4950535","4950829","chr1","140088508","140088802","63","135137973"
"chr5","4954995","4955266","chr6","3894551","3894817","52","1060444"
"chr5","4973626","4973911","chr20","30971671","30971972","50","25998045"
"chr5","4983280","4983424","chr1","68709407","68709549","36","63726127"
"chr5","4994670","4994944","chr1","52520693","52520963","62","47526023"
"chr5","4995769","4996075","chr20","30950445","30950754","37","25954676"
"chr5","5002371","5002488","chr5","124152960","124153079","18","119150589"
"chr5","5032266","5032389","chr1","44892994","44893123","23","39860728"
"chr5","5040651","5040946","chr1","45482465","45482772","65","40441814"
"chr5","5044409","5044698","chr12","36052788","36053091","60","31008379"
"chr5","5056935","5057201","chr3","127863015","127863278","63","122806080"
"chr5","5070364","5070640","chrX","40833613","40833882","57","35763249"
"chr5","5074838","5075001","chr15","23773713","23773873","42","18698875"
"chr5","5078268","5078553","chr20","30880614","30880904","35","25802346"
"chr5","5084086","5084378","chr1","130563571","130563869","61","125479485"
"chr5","5091977","5092276","chrX","39133182","39133470","66","34041205"
"chr5","5106252","5106533","chr20","30853523","30853808","35","25747271"
"chr5","5120737","5121042","chr20","30840314","30840607","57","25719577"
"chr5","5136872","5137169","chr20","30825390","30825690","54","25688518"
"chr5","5147691","5147980","chr20","30814713","30815026","49","25667022"
"chr5","5174540","5174672","chr20","5893261","5893384","33","718721"
"chr5","5178130","5178398","chr5","43641504","43641768","60","38463374"
"chr5","5190057","5190180","chr3","46470481","46470595","33","41280424"
"chr5","5190975","5191095","chr1","146377235","146377358","21","141186260"
"chr5","5199703","5199838","chr8","144957651","144957776","34","139757948"
"chr5","5201286","5201575","chr2A","59048433","59048732","59","53847147"
"chr5","5260260","5260377","chr10","107089327","107089443","18","101829067"
"chr5","5291264","5291469","chr20","30680774","30680973","20","25389510"
"chr5","5300040","5300353","chr20","30672659","30672967","32","25372619"
"chr5","5310307","5310603","chr20","30662986","30663274","37","25352679"
"chr5","5324585","5324767","chr20","30649412","30649598","24","25324827"
"chr5","5376386","5376666","chr20","30594934","30595228","56","25218548"
"chr5","5379023","5379284","chr7","70861509","70861765","58","65482486"
"chr5","5386107","5386284","chr5","38842935","38843119","50","33456828"
"chr5","5406880","5407204","chr20","30558365","30558670","47","25151485"
"chr5","5412249","5412526","chr20","30552905","30553207","53","25140656"
"chr5","5416458","5416761","chr19","57516560","57516855","60","52100102"
"chr5","5433521","5433680","chrX","47756294","47756424","54","42322773"
"chr5","5470492","5470775","chr20","30491842","30492126","42","25021350"
"chr5","5514255","5514516","chr20","30451126","30451398","30","24936871"
"chr5","5527697","5528001","chr20","30439897","30440194","37","24912200"
"chr5","5552134","5552418","chr3","58106113","58106395","63","52553979"
"chr5","5561253","5561420","chr8","41765150","41765321","43","36203897"
"chr5","5573128","5573408","chr20","30394765","30395033","43","24821637"
"chr5","5613010","5613295","chr20","30348699","30348993","47","24735689"
"chr5","5615528","5615609","chr7","137563832","137563911","11","131948304"
"chr5","5620423","5620749","chr10","41464826","41465146","97","35844403"
"chr5","5622772","5622897","chr20","30340126","30340247","16","24717354"
"chr5","5646520","5646761","chr20","30316295","30316539","29","24669775"
"chr5","5652611","5652843","chr1","32303807","32304042","51","26651196"
"chr5","5664211","5664282","chr15","2661348","2661415","16","3002863"
"chr5","5689767","5690023","chr16","40555825","40556088","61","34866058"
"chr5","5722668","5722969","chr1","181256651","181256946","78","175533983"
"chr5","5739700","5740026","chr20","30221715","30222024","64","24482015"
"chr5","5760365","5760630","chr10","50245186","50245465","58","44484821"
"chr5","5782366","5782655","chr20","30180059","30180360","46","24397693"
"chr5","5797626","5797768","chr20","30162006","30162152","14","24364380"
"chr5","5809453","5809661","chr3","127712167","127712361","58","121902714"
"chr5","5813815","5813935","chr20","30141940","30142059","7","24328125"
"chr5","5853175","5853409","chr1","25188732","25188960","66","19335557"
"chr5","5853553","5853785","chr7","102352933","102353173","41","96499380"
"chr5","5858775","5858854","chrX","53217590","53217668","22","47358815"
"chr5","5906099","5906270","chr5","118399435","118399596","34","112493336"
"chr5","5910151","5910460","chr20","30049477","30049775","50","24139326"
"chr5","5915243","5915532","chr20","30067369","30067659","59","24152126"
"chr5","5953639","5953854","chr20","30039885","30040085","32","24086246"
"chr5","5965983","5966265","chr20","30027348","30027637","37","24061365"
"chr5","5981142","5981243","chr20","29999827","29999928","4","24018685"
"chr5","6147176","6147308","chr1","126775319","126775448","29","120628143"
"chr5","6160044","6160189","chr1","31279143","31279286","36","25119099"
"chr5","6190079","6190389","chr20","243393","243701","39","5946686"
"chr5","6203627","6203923","chr20","255963","256257","45","5947664"
"chr5","6207554","6207858","chr20","259782","260091","48","5947772"
"chr5","6223009","6223322","chr10","49576385","49576680","75","43353376"
"chr5","6252954","6253244","chr20","302045","302342","43","5950909"
"chr5","6254274","6254385","chr8","44775255","44775370","16","38520981"
"chr5","6261108","6261274","chr7","41568711","41568873","38","35307603"
"chr5","6321983","6322284","chr11","17140040","17140338","68","10818057"
"chr5","6336266","6336555","chr1","227415933","227416230","58","221079667"
"chr5","6381512","6381779","chr20","426930","427230","61","5954582"
"chr5","6385859","6385995","chr20","431645","431766","26","5954214"
"chr5","6390564","6390843","chr20","439678","439954","36","5950886"
"chr5","6393590","6393866","chr20","442593","442877","35","5950997"
"chr5","6407859","6408151","chr20","456991","457287","39","5950868"
"chr5","6413513","6413789","chr20","462751","463045","41","5950762"
"chr5","6420137","6420292","chr1","68709407","68709549","36","62289270"
"chr5","6427622","6427918","chr1","213172739","213173027","59","206745117"
"chr5","6436443","6436594","chr10","92108530","92108678","27","85672087"
"chr5","6448373","6448695","chr4","168680326","168680631","73","162231953"
"chr5","6450942","6451262","chr5","22893248","22893546","81","16442306"
"chr5","6474700","6475000","chr20","513666","513957","51","5961034"
"chr5","6493200","6493492","chr20","527478","527777","35","5965722"
"chr5","6494816","6494892","chr9","95884781","95884857","14","89389965"
"chr5","6528160","6528505","chr20","560955","561278","60","5967205"
"chr5","6553971","6554272","chr20","586333","586635","37","5967638"
"chr5","6563490","6563794","chr20","594975","595288","48","5968515"
"chr5","6571182","6571490","chr20","602540","602843","52","5968642"
"chr5","6581062","6581354","chr19","3998811","3999102","70","2582251"
"chr5","6582987","6583184","chr7","73099312","73099507","52","66516325"
"chr5","6586942","6587242","chr20","616600","616901","48","5970342"
"chr5","6630089","6630411","chr20","657967","658273","71","5972122"
"chr5","6647080","6647361","chr5","10317469","10317748","60","3670389"
"chr5","6666792","6667079","chr6","120354957","120355251","59","113688165"
"chr5","6796549","6796843","chr20","835585","835899","57","5960964"
"chr5","6887517","6887814","chr20","946339","946650","43","5941178"
"chr5","6897176","6897477","chr20","963672","963979","60","5933504"
"chr5","6937252","6937398","chr14","86881535","86881670","31","79944283"
"chr5","7023879","7024083","chr20","1103338","1103555","35","5920541"
"chr5","7034158","7034379","chr1","214185129","214185349","44","207150971"
"chr5","7068456","7068594","chr5","3296328","3296466","36","3772128"
"chr5","7096321","7096574","chr20","1173537","1173799","40","5922784"
"chr5","7124986","7125266","chr1","130048013","130048302","54","122923027"
"chr5","7194945","7195227","chr20","1259814","1260084","40","5935131"
"chr5","7253187","7253500","chr20","1312472","1312777","32","5940715"
"chr5","7543087","7543187","chr8","127464219","127464309","28","119921132"
"chr5","7559770","7559855","chr5","36110533","36110617","20","28550763"
"chr5","7669848","7670132","chr20","1821445","1821739","62","5848403"
"chr5","7705992","7706142","chr10","92108530","92108678","27","84402538"
"chr5","7773404","7773687","chr20","1924892","1925206","58","5848512"
"chr5","7776119","7776396","chr14","13906603","13906883","52","6130484"
"chr5","7883855","7884097","chr20","2036002","2036252","26","5847853"
"chr5","7892605","7892733","chr19","39316958","39317085","20","31424353"
"chr5","7893244","7893323","chrX","148083058","148083141","27","140189814"
"chr5","7902519","7902823","chr20","2054413","2054718","43","5848106"
"chr5","7958057","7958219","chr7","41568711","41568873","33","33610654"
"chr5","8035570","8035686","chr20","2183553","2183669","8","5852017"
"chr5","8091358","8091652","chr8","124654735","124655037","66","116563377"
"chr5","8111266","8111384","chr19","46547524","46547634","27","38436258"
"chr5","8118499","8118628","chr7","11248117","11248241","25","3129618"
"chr5","8168749","8168877","chr15","18218102","18218231","19","10049353"
"chr5","8250892","8251039","chr11","62991394","62991536","34","54740502"
"chr5","8281492","8281528","chr2A","45841801","45841836","3","37560309"
"chr5","8281695","8281827","chr1","17368221","17368352","31","9086526"
"chr5","8310801","8311085","chr20","2369337","2369623","42","5941464"
"chr5","8454871","8455074","chr15","53387395","53387596","46","44932524"
"chr5","8465229","8465456","chr20","2559496","2559700","46","5905733"
"chr5","8465490","8465697","chr17","9295468","9295676","52","829978"
"chr5","8471655","8471952","chr20","2572214","2572527","51","5899441"
"chr5","8485517","8485823","chr20","2588424","2588706","46","5897093"
"chr5","8486690","8486843","chr8","25523917","25524069","31","17037227"
"chr5","8499859","8499998","chr16","24603067","24603195","38","16103208"
"chr5","8526988","8527278","chr19","46062191","46062484","49","37535203"
"chr5","8554794","8555087","chr20","2655219","2655520","35","5899575"
"chr5","8578352","8578555","chr18","74436813","74437020","45","65858461"
"chr5","8596213","8596525","chr20","2701721","2702042","55","5894492"
"chr5","8618992","8619281","chr16","30314290","30314572","62","21695298"
"chr5","8646445","8646715","chr20","2752482","2752757","57","5893963"
"chr5","8647152","8647311","chr16","38955159","38955317","33","30308007"
"chr5","8655584","8655877","chr20","2761295","2761594","44","5894289"
"chr5","8684191","8684274","chr20","2787119","2787194","20","5897072"
"chr5","8772192","8772273","chr20","2859616","2859698","15","5912576"
"chr5","8784634","8784931","chr6","139618486","139618777","78","130833852"
"chr5","8790114","8790409","chr20","2877339","2877651","46","5912775"
"chr5","8792828","8792956","chr20","2879835","2879964","17","5912993"
"chr5","8891001","8891294","chr16","14876830","14877115","66","5985829"
"chr5","8921923","8922135","chrX","1292864","1293059","50","7629059"
"chr5","8933880","8934102","chr15","56089994","56090218","52","47156114"
"chr5","9000645","9000822","chr7","74989955","74990147","47","65989310"
"chr5","9009200","9009354","chr10","116742672","116742834","33","107733472"
"chr5","9027399","9027619","chr6","111508894","111509126","59","102481495"
"chr5","9041234","9041470","chr20","3131293","3131536","30","5909941"
"chr5","9054715","9054900","chrX","19928223","19928402","42","10873508"
"chr5","9058683","9058928","chrX","20229622","20229871","68","11170939"
"chr5","9095630","9095920","chr20","3188038","3188307","41","5907592"
"chr5","9108877","9109006","chr5","34173856","34173985","22","25064979"
"chr5","9134351","9134635","chr20","3219975","3220260","34","5914376"
"chr5","9157758","9158060","chr19","18871903","18872198","58","9714145"
"chr5","9167000","9167264","chr22","8311524","8311782","66","855476"
"chr5","9182688","9182964","chr20","3274947","3275225","27","5907741"
"chr5","9188250","9188526","chr20","3281456","3281733","40","5906794"
"chr5","9210143","9210438","chr6","10742837","10743124","58","1532694"
"chr5","9217667","9217784","chr5","117817000","117817115","13","108599333"
"chr5","9221188","9221471","chr14","75240899","75241188","52","66019711"
"chr5","9226284","9226500","chr6","109134214","109134431","40","99907930"
"chr5","9235111","9235419","chr16","31213333","31213639","72","21978222"
"chr5","9247537","9247830","chr14","52084361","52084649","58","42836824"
"chr5","9286216","9286512","chr20","3327595","3327896","28","5958621"
"chr5","9293176","9293296","chr7","11248117","11248241","19","1954941"
"chr5","9314994","9315109","chr1","196508846","196508961","19","187193852"
"chr5","9315915","9316198","chr20","3378067","3378332","61","5937848"
"chr5","9344349","9344624","chr20","3404354","3404644","43","5939995"
"chr5","9421621","9421931","chr20","3473755","3474059","26","5947866"
"chr5","9448974","9449278","chr20","3499258","3499554","33","5949716"
"chr5","9503456","9503737","chr20","3551150","3551430","52","5952306"
"chr5","9516574","9516690","chr5","7768919","7769036","18","1747655"
"chr5","9542414","9542682","chr20","3574379","3574667","54","5968035"
"chr5","9544812","9544963","chr19","56020333","56020483","30","46475521"
"chr5","9556560","9556842","chr9","56847431","56847709","62","47290871"
"chr5","9616810","9617107","chr8","74425114","74425416","69","64808304"
"chr5","9636032","9636138","chr11","105933772","105933875","24","96297740"
"chr5","9654054","9654309","chr20","3688793","3689046","36","5965261"
"chr5","9675467","9675745","chr20","3711393","3711659","65","5964074"
"chr5","9681910","9682196","chr1","19377983","19378282","56","9696073"
"chr5","9689925","9690115","chr20","3725293","3725494","31","5964632"
"chr5","9691302","9691491","chrX","19928223","19928402","41","10236921"
"chr5","9695804","9696087","chr20","3730041","3730325","44","5965763"
"chr5","9732252","9732394","chr1","134652174","134652315","33","124919922"
"chr5","9732646","9732781","chr20","3760411","3760552","21","5972235"
"chr5","9775879","9776124","chr3","14810964","14811203","60","5035085"
"chr5","9797550","9797817","chr16","28090554","28090811","69","18293004"
"chr5","9815916","9816210","chr20","3850423","3850732","55","5965493"
"chr5","9863406","9863519","chr1","226821956","226822073","21","216958550"
"chr5","9887377","9887663","chr20","3913266","3913567","37","5974111"
"chr5","9898223","9898526","chr20","3924408","3924704","39","5973815"
"chr5","9919951","9920130","chr20","3948631","3948813","35","5971320"
"chr5","9931794","9932074","chr20","3962946","3963255","61","5968848"
"chr5","9957259","9957534","chr19","11027025","11027300","68","1069766"
"chr5","9959053","9959320","chr4","93804248","93804518","79","83845195"
"chr5","9963008","9963140","chr1","27808249","27808381","19","17845241"
"chr5","9992832","9993117","chr15","71893623","71893917","67","61900791"
"chr5","9993989","9994142","chr2A","98004158","98004312","31","88010169"
"chr5","10030978","10031281","chr20","4059964","4060260","45","5971014"
"chr5","10035260","10035575","chr20","4065889","4066197","54","5969371"
"chr5","10273969","10274244","chr20","4346596","4346881","42","5927373"
"chr5","10392745","10392938","chr4","162630929","162631119","62","152238184"
"chr5","10421390","10421698","chr20","4508384","4508687","53","5913006"
"chr5","10514305","10514429","chr9","114196210","114196334","18","103681905"
"chr5","10561976","10562292","chr6","111195753","111196055","72","100633777"
"chr5","10583601","10583886","chr20","4671006","4671297","44","5912595"
"chr5","10585419","10585707","chr20","4673037","4673326","25","5912382"
"chr5","10597949","10598235","chr19","38040095","38040378","58","27442146"
"chr5","10685175","10685470","chr20","4776934","4777231","36","5908241"
"chr5","10708651","10708777","chr11","61771478","61771601","17","51062827"
"chr5","10713518","10713644","chr20","4804225","4804349","13","5909293"
"chr5","10717300","10717428","chr12","118074267","118074391","26","107356967"
"chr5","10732363","10732673","chr5","132995340","132995637","86","122262977"
"chr5","10784463","10784656","chr20","4882999","4883173","40","5901464"
"chr5","10785074","10785200","chr3","54948165","54948289","27","44163091"
"chr5","10788797","10788908","chr16","48023200","48023306","28","37234403"
"chr5","10819985","10820292","chr1","125570783","125571085","59","114750798"
"chr5","10836676","10836963","chr20","4941095","4941399","50","5895581"
"chr5","10851480","10851638","chr15","21950673","21950831","24","11099193"
"chr5","10856395","10856570","chr20","4960443","4960622","20","5895952"
"chr5","10914850","10915157","chr18","20530306","20530599","68","9615456"
"chr5","10915747","10916053","chr15","44244841","44245146","59","33329094"
"chr5","10928290","10928398","chr20","5032914","5033023","7","5895376"
"chr5","10951180","10951485","chr20","5054952","5055254","33","5896228"
"chr5","10972356","10972472","chr5","121570312","121570429","22","110597956"
"chr5","10986532","10986652","chr15","37499620","37499743","22","26513088"
"chr5","10987640","10987764","chr10","12650705","12650831","31","1663065"
"chr5","10999843","10999994","chr6","89356333","89356484","32","78356490"
"chr5","11060711","11060997","chr20","5186292","5186582","45","5874419"
"chr5","11089922","11090208","chr20","5236938","5237224","35","5852984"
"chr5","11157781","11158038","chr20","5324030","5324285","32","5833751"
"chr5","11193572","11193887","chrX","119472230","119472549","68","108278658"
"chr5","11210533","11210729","chr5","26184119","26184312","51","14973586"
"chr5","11214109","11214242","chr7","109842246","109842373","39","98628137"
"chr5","11239774","11240080","chr17","16098358","16098669","65","4858584"
"chr5","11291623","11291939","chr15","63373448","63373759","73","52081825"
"chr5","11312883","11313231","chr6","89970348","89970673","94","78657465"
"chr5","11375703","11375834","chr7","74242105","74242234","23","62866402"
"chr5","11376892","11377171","chr1","38001876","38002160","60","26624984"
"chr5","11380445","11380674","chr8","74772775","74773004","60","63392330"
"chr5","11381340","11381631","chr20","5615062","5615353","24","5766278"
"chr5","11384917","11385226","chr20","5620072","5620380","39","5764845"
"chr5","11392801","11392965","chr5","2493450","2493615","37","8899351"
"chr5","11425111","11425397","chr20","5655179","5655462","46","5769932"
"chr5","11445188","11445496","chr20","5693550","5693863","25","5751638"
"chr5","11452157","11452455","chr20","5709409","5709718","54","5742748"
"chr5","11471238","11471396","chr8","25551358","25551514","38","14080120"
"chr5","11495014","11495311","chr9","113200451","113200746","50","101705437"
"chr5","11508778","11509043","chr1","139768169","139768436","63","128259391"
"chr5","11513912","11514219","chr20","5759493","5759802","33","5754419"
"chr5","11541103","11541227","chr17","26242812","26242935","13","14701709"
"chr5","11542273","11542442","chrX","100740983","100741152","41","89198710"
"chr5","11546694","11546964","chr7","2592743","2593011","62","8953951"
"chr5","11601163","11601453","chr20","5887174","5887462","39","5713989"
"chr5","11604667","11604980","chr20","5891370","5891673","42","5713297"
"chr5","11658992","11659272","chr22","13738009","13738299","69","2079017"
"chr5","11660660","11660939","chr18","1313785","1314066","60","10346875"
"chr5","11670198","11670491","chr20","5959637","5959942","42","5710561"
"chr5","11714355","11714634","chr20","5998539","5998829","52","5715816"
"chr5","11725584","11725845","chr20","6008053","6008296","45","5717531"
"chr5","11855452","11855730","chrX","70757717","70758005","61","58902265"
"chr5","11931940","11932021","chr1","184326758","184326852","22","172394818"
"chr5","11968811","11969074","chr20","6257705","6257990","49","5711106"
"chr5","12031537","12031812","chr1","223946755","223947039","64","211915218"
"chr5","12128857","12129173","chr20","6411355","6411668","44","5717502"
"chr5","12296354","12296640","chr20","6597800","6598089","36","5698554"
"chr5","12304573","12304703","chr20","6606125","6606250","24","5698448"
"chr5","12372885","12373187","chr20","6672824","6673127","64","5700061"
"chr5","12395724","12396002","chrX","49715338","49715602","82","37319614"
"chr5","12476982","12477281","chr20","6769327","6769631","42","5707655"
"chr5","12481275","12481565","chr4","141278640","141278929","71","128797365"
"chr5","12501620","12501740","chr11","69147152","69147272","34","56645532"
"chr5","12502318","12502398","chr20","6790140","6790223","12","5712178"
"chr5","12597376","12597649","chr20","6885892","6886170","44","5711484"
"chr5","12685326","12685600","chr20","6980116","6980393","48","5705210"
"chr5","12720488","12720751","chr20","7015192","7015457","39","5705296"
"chr5","12743135","12743242","chr20","7035537","7035646","7","5707598"
"chr5","12850910","12851228","chr20","7161348","7161651","60","5689562"
"chr5","12876832","12877078","chr20","7194416","7194676","58","5682416"
"chr5","12907670","12907953","chr20","7223335","7223611","50","5684335"
"chr5","13203968","13204260","chr20","7528568","7528871","57","5675400"
"chr5","13343824","13344109","chr20","7696374","7696655","38","5647450"
"chr5","13409600","13409900","chr5","36983395","36983700","75","23573795"
"chr5","13567289","13567370","chr20","7957406","7957489","12","5609883"
"chr5","13568128","13568252","chr17","27545127","27545251","23","13976999"
"chr5","13820930","13821240","chr7","78758416","78758719","67","64937486"
"chr5","13828224","13828507","chr16","24962383","24962677","71","11134159"
"chr5","13883517","13883773","chr20","8302438","8302697","50","5581079"
"chr5","13975425","13975710","chr20","8400095","8400337","65","5575330"
"chr5","14089681","14089964","chr5","8734711","8734988","73","5354970"
"chr5","14103243","14103349","chr2B","129637929","129638039","21","115534686"
"chr5","14118670","14118897","chrX","39568727","39568951","68","25450057"
"chr5","14178341","14178631","chr20","8596924","8597233","50","5581417"
"chr5","14182173","14182482","chr20","8601176","8601488","38","5580997"
"chr5","14327846","14327965","chr20","8743029","8743155","16","5584817"
"chr5","14406534","14406821","chr5","6812559","6812842","63","7593975"
"chr5","14425431","14425595","chr8","56795337","56795503","32","42369906"
"chr5","14487165","14487308","chr3","267312","267456","34","14219853"
"chr5","14518103","14518411","chr9","58336046","58336354","64","43817943"
"chr5","14631864","14632129","chr2B","99235982","99236260","68","84604118"
"chr5","14754872","14754996","chr1","215648878","215649005","37","200894006"
"chr5","14783418","14783700","chr20","9190350","9190628","56","5593068"
"chr5","14844037","14844331","chr20","9253728","9254013","52","5590309"
"chr5","14918953","14919288","chr20","9331394","9331724","27","5587559"
"chr5","15025468","15025760","chr20","9440626","9440937","46","5584842"
"chr5","15140067","15140353","chr7","1708256","1708538","61","13431811"
"chr5","15154238","15154309","chr14","75436417","75436490","15","60282179"
"chr5","15170193","15170463","chr20","9597069","9597363","59","5573124"
"chr5","15208645","15208909","chr22","20364309","20364570","62","5155664"
"chr5","15212735","15213018","chr20","9640953","9641236","68","5571782"
"chr5","15245582","15245892","chr16","19682226","19682534","65","4436644"
"chr5","15316067","15316364","chr1","38001876","38002160","59","22685809"
"chr5","15326916","15327227","chr10","124980454","124980759","72","109653538"
"chr5","15350387","15350673","chr20","9782978","9783280","54","5567409"
"chr5","15362684","15362830","chrX","71151088","71151230","31","55788404"
"chr5","15362895","15363076","chr6","58098458","58098635","53","42735563"
"chr5","15377454","15377571","chr11","122983640","122983757","16","107606186"
"chr5","15425216","15425491","chr20","9858912","9859190","26","5566304"
"chr5","15495342","15495472","chr5","48966184","48966302","39","33470842"
"chr5","15517481","15517796","chr20","9997064","9997356","64","5520417"
"chr5","15725294","15725592","chr5","55653971","55654269","54","39928677"
"chr5","15730852","15730971","chr1","15391687","15391807","28","339165"
"chr5","15784388","15784693","chr20","10287607","10287914","30","5496781"
"chr5","15940744","15941037","chr20","10448273","10448546","50","5492471"
"chr5","16006926","16007049","chr3","65193379","65193500","21","49186453"
"chr5","16020162","16020467","chr20","10532335","10532645","42","5487827"
"chr5","16029582","16029870","chr7","72178783","72179073","64","56149201"
"chr5","16117145","16117394","chr20","10616067","10616325","41","5501078"
"chr5","16235289","16235588","chr5","120619493","120619807","56","104384204"
"chr5","16310322","16310613","chr20","10836454","10836749","36","5473868"
"chr5","16403449","16403733","chrX","6566340","6566625","63","9837109"
"chr5","16462631","16462829","chr3","9892579","9892770","40","6570052"
"chr5","16702788","16703024","chr20","11225399","11225644","37","5477389"
"chr5","17374272","17374512","chr7","139554502","139554732","61","122180230"
"chr5","17394027","17394255","chr20","11941189","11941413","37","5452838"
"chr5","17480904","17481169","chr20","12028898","12029183","46","5452006"
"chr5","17571567","17571824","chr20","12104761","12105024","42","5466806"
"chr5","17584218","17584379","chr7","39782467","39782629","42","22198249"
"chr5","17585059","17585200","chr10","100878482","100878619","25","83293423"
"chr5","17618939","17619264","chr11","117213354","117213666","67","99594415"
"chr5","17645895","17646151","chr20","12178734","12179014","56","5467161"
"chr5","17667015","17667301","chr5","26464690","26464978","76","8797675"
"chr5","17797940","17798231","chr20","12335176","12335486","61","5462764"
"chr5","17922344","17922498","chr17","4104875","4105033","38","13817469"
"chr5","17956297","17956593","chr20","12525729","12526023","47","5430568"
"chr5","17967918","17968066","chr18","77865542","77865689","26","59897624"
"chr5","18048797","18048924","chrX","70594684","70594808","20","52545887"
"chr5","18071696","18071859","chr10","49585047","49585201","35","31513351"
"chr5","18175695","18175976","chr20","12762249","12762528","39","5413446"
"chr5","18227412","18227723","chr20","12828281","12828596","69","5399131"
"chr5","18237867","18238166","chr9","78650999","78651275","82","60413132"
"chr5","18316071","18316214","chr12","110108425","110108564","32","91792354"
"chr5","18316251","18316336","chr7","68212337","68212424","19","49896086"
"chr5","18480888","18481010","chr16","11662327","11662451","18","6818561"
"chr5","18493961","18494217","chr7","137794792","137795067","67","119300831"
"chr5","18513454","18513555","chr18","77841068","77841169","19","59327614"
"chr5","18514848","18515151","chr7","65505788","65506061","60","46990940"
"chr5","18517278","18517574","chr5","123828259","123828546","66","105310981"
"chr5","18518337","18518496","chr7","62908928","62909091","31","44390591"
"chr5","18519734","18520035","chr7","65255439","65255737","50","46735705"
"chr5","18676623","18676938","chr8","27699021","27699320","66","9022398"
"chr5","18689829","18689953","chr19","14415022","14415148","25","4274807"
"chr5","18872066","18872364","chr7","17907526","17907821","58","964540"
"chr5","18882429","18882546","chrX","49113443","49113558","21","30231014"
"chr5","18884381","18884683","chr20","13394534","13394850","41","5489847"
"chr5","18939335","18939642","chr20","13463001","13463312","36","5476334"
"chr5","19054872","19055120","chr14","41954959","41955193","53","22900087"
"chr5","19192116","19192349","chr20","13758061","13758320","50","5434055"
"chr5","19240057","19240138","chr2A","104121129","104121209","21","84881072"
"chr5","19373292","19373567","chr3","138604884","138605158","56","119231592"
"chr5","19428268","19428578","chr20","14016697","14016992","52","5411571"
"chr5","19561947","19562064","chr20","14147889","14148004","13","5414058"
"chr5","19589514","19589784","chr20","14174966","14175247","51","5414548"
"chr5","19646280","19646402","chr20","14231616","14231738","7","5414664"
"chr5","19708599","19708910","chr20","14292439","14292746","43","5416160"
"chr5","19710518","19710790","chr20","14295215","14295494","39","5415303"
"chr5","19855203","19855357","chr19","5169265","5169417","35","14685938"
"chr5","19964929","19965226","chr20","14541371","14541678","54","5423558"
"chr5","19970170","19970450","chr9","75227699","75227977","49","55257529"
"chr5","20010793","20011080","chr20","14590918","14591209","34","5419875"
"chr5","20196599","20196827","chr21","27930650","27930878","43","7734051"
"chr5","20260917","20261190","chr6","157477669","157477933","58","137216752"
"chr5","20311837","20311924","chr1","119481412","119481493","27","99169575"
"chr5","20373830","20373947","chr20","14936449","14936566","11","5437381"
"chr5","20374574","20374686","chr1","134625109","134625219","23","114250535"
"chr5","20521146","20521427","chr20","15082106","15082400","43","5439040"
"chr5","20523175","20523447","chr20","15084136","15084420","43","5439039"
"chr5","20538476","20538754","chr12","124084428","124084703","53","103545952"
"chr5","20542488","20542770","chr6","4984341","4984620","64","15558147"
"chr5","20568937","20569061","chr14","45229440","45229558","33","24660503"
"chr5","20590562","20590668","chr20","15167270","15167375","18","5423292"
"chr5","20634738","20634891","chr20","15194731","15194870","26","5440007"
"chr5","20761254","20761556","chr20","15333290","15333586","66","5427964"
"chr5","20778345","20778615","chr20","15352798","15353057","39","5425547"
"chr5","20788738","20789002","chr20","15362951","15363216","34","5425787"
"chr5","20977805","20978096","chr20","15542134","15542426","42","5435671"
"chr5","20978419","20978719","chr20","15542760","15543064","44","5435659"
"chr5","21024079","21024391","chr20","15586316","15586635","40","5437763"
"chr5","21027504","21027794","chr20","15589810","15590098","37","5437694"
"chr5","21086821","21087110","chr20","15645797","15646087","50","5441024"
"chr5","21129210","21129333","chr20","15687083","15687215","20","5442127"
"chr5","21148397","21148626","chr3","144785359","144785571","73","123636962"
"chr5","21216696","21216799","chr5","152528003","152528109","21","131311307"
"chr5","21311822","21312121","chr20","15889152","15889447","76","5422670"
"chr5","21355341","21355625","chr20","15940176","15940482","69","5415165"
"chr5","21413277","21413585","chr20","15993005","15993300","46","5420272"
"chr5","21455319","21455520","chr20","16032569","16032780","41","5422750"
"chr5","21472731","21472838","chr10","118546726","118546841","30","97073995"
"chr5","21472856","21473007","chr10","27171084","27171237","32","5698228"
"chr5","21564231","21564530","chr20","16110382","16110679","44","5453849"
"chr5","21778930","21779211","chr22","29879824","29880101","65","8100894"
"chr5","21839551","21839679","chr19","44358723","44358854","18","22519172"
"chr5","21883721","21883805","chr20","16428943","16429024","11","5454778"
"chr5","22165279","22165439","chr3","49669891","49670052","31","27504612"
"chr5","22187612","22187909","chr4","196591305","196591597","65","174403693"
"chr5","22226969","22227269","chr20","16777017","16777300","58","5449952"
"chr5","22240801","22241001","chr16","60381597","60381800","51","38140796"
"chr5","22255095","22255386","chr20","16802798","16803079","51","5452297"
"chr5","22302636","22302935","chr20","16838475","16838786","52","5464161"
"chr5","22303370","22303488","chr2A","42261370","42261491","17","19958000"
"chr5","22337083","22337377","chr7","78495579","78495877","70","56158496"
"chr5","22379900","22380025","chr20","16916805","16916937","19","5463095"
"chr5","22458453","22458761","chr20","16995192","16995473","53","5463261"
"chr5","22495925","22496051","chr20","17032876","17033001","26","5463049"
"chr5","22519542","22519599","chr4","171500441","171500495","12","148980899"
"chr5","22519739","22519924","chr16","40487498","40487681","45","17967759"
"chr5","22548344","22548629","chrX","45067707","45067988","61","22519363"
"chr5","22550840","22551131","chr3","160981754","160982039","87","138430914"
"chr5","22564754","22565038","chr20","17116838","17117136","39","5447916"
"chr5","22893370","22893690","chr20","17491108","17491382","73","5402262"
"chr5","22946062","22946363","chr20","17538131","17538456","53","5407931"
"chr5","22971980","22972261","chr19","31962850","31963132","58","8990870"
"chr5","22992038","22992334","chr20","17580179","17580470","38","5411859"
"chr5","23003513","23003728","chr20","17592145","17592357","22","5411368"
"chr5","23004855","23005153","chr20","17593768","17594069","36","5411087"
"chr5","23050835","23051126","chr20","17649114","17649397","47","5401721"
"chr5","23132575","23132882","chr20","17739644","17739953","41","5392931"
"chr5","23146476","23146601","chr5","133578375","133578499","33","110431899"
"chr5","23163969","23164131","chr8","44894947","44895105","47","21730978"
"chr5","23174304","23174601","chr20","17774429","17774724","44","5399875"
"chr5","23177173","23177309","chr8","103799790","103799921","33","80622617"
"chr5","23179301","23179559","chr10","91348059","91348322","61","68168758"
"chr5","23185213","23185367","chr16","49017109","49017265","30","25831896"
"chr5","23188791","23189073","chr20","17791358","17791638","41","5397433"
"chr5","23190408","23190703","chr20","17794336","17794640","42","5396072"
"chr5","23205492","23205784","chr20","17808887","17809178","65","5396605"
"chr5","23216520","23216730","chr1","189712782","189712986","48","166496262"
"chr5","23297503","23297631","chr20","17896236","17896367","21","5401267"
"chr5","23313109","23313394","chr20","17914484","17914778","36","5398625"
"chr5","23313663","23313965","chr20","17915060","17915345","59","5398603"
"chr5","23351843","23351942","chr20","17944129","17944232","9","5407714"
"chr5","23361049","23361187","chr5","3296328","3296466","33","20064721"
"chr5","23400265","23400415","chrX","71299329","71299487","35","47899064"
"chr5","23415212","23415503","chr20","18007531","18007828","49","5407681"
"chr5","23427321","23427473","chr20","18019610","18019770","18","5407711"
"chr5","23428085","23428387","chr20","18020378","18020676","38","5407707"
"chr5","23438027","23438314","chr20","18030643","18030929","16","5407384"
"chr5","23439137","23439445","chr20","18031774","18032069","40","5407363"
"chr5","23454154","23454494","chr1","2285941","2286239","95","21168213"
"chr5","23476375","23476659","chr20","18072373","18072648","55","5404002"
"chr5","23478786","23479075","chr19","46701284","46701570","60","23222498"
"chr5","23489864","23490159","chr7","127734527","127734826","67","104244663"
"chr5","23506040","23506152","chr16","14452873","14452985","17","9053167"
"chr5","23506201","23506365","chr7","45537514","45537680","34","22031313"
"chr5","23509755","23510010","chr20","18100398","18100654","29","5409357"
"chr5","23513516","23513820","chr9","103732852","103733150","60","80219336"
"chr5","23532632","23532920","chr20","18123462","18123748","31","5409170"
"chr5","23546690","23546976","chr20","18142414","18142715","51","5404276"
"chr5","23570718","23570952","chr18","19991629","19991880","64","3579089"
"chr5","23602390","23602642","chr6","145938428","145938683","67","122336038"
"chr5","23604789","23604939","chr20","13392558","13392708","32","10212231"
"chr5","23612645","23612956","chr8","78488834","78489147","55","54876189"
"chr5","23617190","23617399","chr19","37724259","37724478","42","14107069"
"chr5","23715018","23715298","chr12","133154511","133154782","69","109439493"
"chr5","23772141","23772362","chr3","57997401","57997617","46","34225260"
"chr5","23782255","23782448","chrX","38198324","38198508","48","14416069"
"chr5","23801604","23801730","chr19","51208089","51208213","23","27406485"
"chr5","23832964","23833081","chr6","87517319","87517435","22","63684355"
"chr5","23847345","23847638","chr20","18456148","18456445","34","5391197"
"chr5","23900231","23900502","chr19","31962850","31963132","62","8062619"
"chr5","23924095","23924198","chr11","3117679","3117792","21","20806416"
"chr5","23945073","23945203","chr10","97808152","97808279","21","73863079"
"chr5","23945942","23946034","chr18","45581155","45581245","22","21635213"
"chr5","23946664","23946865","chr16","13176016","13176190","52","10770648"
"chr5","24016226","24016397","chr16","44723366","44723534","37","20707140"
"chr5","24016405","24016675","chr20","18607514","18607796","39","5408891"
"chr5","24085967","24086049","chr10","144050807","144050895","25","119964840"
"chr5","24122455","24122628","chrX","19843652","19843828","38","4278803"
"chr5","24128923","24129047","chr5","134968150","134968266","23","110839227"
"chr5","24144674","24144839","chr15","46482405","46482571","31","22337731"
"chr5","24170169","24170377","chr20","18779150","18779367","37","5391019"
"chr5","24195938","24196068","chr14","86999208","86999349","31","62803270"
"chr5","24237626","24237943","chr12","108745776","108746083","65","84508150"
"chr5","24252679","24252859","chr6","160406733","160406910","38","136154054"
"chr5","24273037","24273327","chr20","18904682","18904961","47","5368355"
"chr5","24278633","24278911","chrX","45067707","45067988","55","20789074"
"chr5","24436037","24436348","chr20","19071044","19071352","39","5364993"
"chr5","24476591","24476846","chrX","48206334","48206597","52","23729743"
"chr5","24552775","24553073","chr20","19193893","19194193","50","5358882"
"chr5","24600652","24600877","chr20","19242108","19242349","50","5358544"
"chr5","24601581","24601653","chr2B","38975158","38975220","20","14373577"
"chr5","24628920","24629220","chr15","28396808","28397111","63","3767888"
"chr5","24643892","24644171","chr20","19287666","19287966","46","5356226"
"chr5","24650443","24650732","chr20","19292343","19292650","50","5358100"
"chr5","24687898","24688029","chr12","7894899","7895028","29","16792999"
"chr5","24779778","24779901","chrX","140759324","140759452","24","115979546"
"chr5","24792915","24793134","chr20","19457188","19457416","39","5335727"
"chr5","24835710","24835995","chr20","19496581","19496865","38","5339129"
"chr5","24855420","24855691","chr20","19518806","19519087","41","5336614"
"chr5","25098551","25098675","chr7","5677173","5677296","17","19421378"
"chr5","25098890","25099050","chr4","40325999","40326159","34","15227109"
"chr5","25197295","25197548","chr2A","64538464","64538725","56","39341169"
"chr5","25271192","25271443","chr4","9161148","9161410","63","16110044"
"chr5","25401704","25401990","chr20","20065195","20065496","46","5336509"
"chr5","25406924","25407183","chr14","77895055","77895321","64","52488131"
"chr5","25444716","25444953","chr20","20107135","20107366","33","5337581"
"chr5","25453971","25454271","chr20","20116311","20116618","43","5337660"
"chr5","25457711","25458011","chr4","181423438","181423737","69","155965727"
"chr5","25471988","25472159","chr8","56795337","56795503","37","31323349"
"chr5","25472167","25472398","chr19","13001825","13002050","45","12470342"
"chr5","25481457","25481752","chr20","20134991","20135290","40","5346466"
"chr5","25492043","25492158","chr20","20145261","20145376","15","5346782"
"chr5","25503795","25504123","chr20","20156789","20157123","50","5347006"
"chr5","25515175","25515385","chr1","189712782","189712986","43","164197607"
"chr5","25529986","25530120","chr20","20182414","20182534","24","5347572"
"chr5","25530328","25530450","chr20","20182764","20182885","21","5347564"
"chr5","25593304","25593421","chrX","9020584","9020704","19","16572720"
"chr5","25607267","25607575","chr20","20249289","20249592","49","5357978"
"chr5","25612617","25612736","chr7","74643014","74643130","34","49030397"
"chr5","25617501","25617604","chr11","3117679","3117792","20","22499822"
"chr5","25829451","25829570","chr20","20460559","20460684","18","5368892"
"chr5","25906893","25907148","chr20","20523584","20523859","51","5383309"
"chr5","25965933","25965985","chr11","114841124","114841176","10","88875191"
"chr5","25986047","25986341","chr20","20589323","20589601","44","5396724"
"chr5","25989131","25989445","chr6","36199208","36199510","60","10210077"
"chr5","26075010","26075312","chr20","20668496","20668798","51","5406514"
"chr5","26078507","26078805","chr11","12728691","12728990","58","13349816"
"chr5","26130664","26130815","chr19","17771963","17772116","31","8358701"
"chr5","26277130","26277442","chr20","20875908","20876212","41","5401222"
"chr5","26406791","26407068","chr20","20988904","20989189","41","5417887"
"chr5","26414084","26414274","chr8","18127927","18128121","51","8286157"
"chr5","26415854","26415951","chr19","4106799","4106900","17","22309055"
"chr5","26416294","26416460","chr20","20998208","20998379","37","5418086"
"chr5","26450458","26450713","chr20","21031349","21031624","59","5419109"
"chr5","26464427","26464535","chr3","187504297","187504409","16","161039870"
"chr5","26464906","26465057","chr1","68709407","68709549","40","42244501"
"chr5","26477320","26477617","chr6","45950422","45950707","75","19473102"
"chr5","26489056","26489352","chr1","163867986","163868280","59","137378930"
"chr5","26555481","26555732","chr20","21119861","21120118","47","5435620"
"chr5","26580977","26581101","chr12","113253661","113253784","15","86672684"
"chr5","26581856","26581937","chr16","30817725","30817803","18","4235869"
"chr5","26613233","26613346","chr17","63212955","63213066","32","36599722"
"chr5","26668524","26668850","chr3","2277190","2277501","77","24391334"
"chr5","26673306","26673425","chr2B","14476412","14476528","17","12196894"
"chr5","26723653","26723953","chr20","21276519","21276817","35","5447134"
"chr5","26742650","26742916","chr3","187941466","187941722","59","161198816"
"chr5","26785656","26785966","chr20","21340716","21341004","56","5444940"
"chr5","26789207","26789496","chr4","151450789","151451075","75","124661582"
"chr5","26853540","26853824","chr20","21394400","21394679","47","5459140"
"chr5","26855953","26856260","chr5","6024656","6024968","69","20831297"
"chr5","26935424","26935718","chr20","21506168","21506458","43","5429256"
"chr5","26981545","26981846","chr20","21553273","21553590","43","5428272"
"chr5","27062982","27063278","chr20","21628990","21629299","51","5433992"
"chr5","27121919","27122140","chr20","21688436","21688656","28","5433483"
"chr5","27132439","27132567","chr20","21698230","21698366","22","5434209"
"chr5","27148857","27149168","chr20","21715951","21716265","55","5432906"
"chr5","27188417","27188585","chr9","93530403","93530565","41","66341986"
"chr5","27196318","27196431","chr14","74639249","74639368","25","47442931"
"chr5","27221018","27221305","chr20","21782080","21782390","45","5438938"
"chr5","27258995","27259163","chr7","137814342","137814508","36","110555347"
"chr5","27259516","27259645","chr9","121389119","121389248","21","94129603"
"chr5","27276434","27276704","chr5","161115198","161115476","61","133838764"
"chr5","27285591","27285861","chrX","47949032","47949310","68","20663441"
"chr5","27300205","27300295","chrX","148083058","148083141","31","120782853"
"chr5","27300317","27300429","chr4","196402447","196402553","25","169102130"
"chr5","27319326","27319629","chr20","21869337","21869640","47","5449989"
"chr5","27340772","27340931","chr19","11025315","11025473","36","16315457"
"chr5","27352614","27352786","chr1","134509217","134509393","43","107156603"
"chr5","27437488","27437765","chr20","21974913","21975203","40","5462575"
"chr5","27598681","27598986","chr20","22122511","22122815","47","5476170"
"chr5","27760289","27760543","chr20","22295882","22296141","38","5464407"
"chr5","27872946","27873244","chr1","27618659","27618962","64","254287"
"chr5","28108650","28108922","chr4","124666187","124666447","77","96557537"
"chr5","28195223","28195535","chr20","22748276","22748584","49","5446947"
"chr5","28246593","28246895","chr20","22796103","22796398","41","5450490"
"chr5","28277062","28277337","chr7","130610319","130610598","66","102333257"
"chr5","28339033","28339316","chr20","22897820","22898128","62","5441213"
"chr5","28426638","28426920","chr20","22993914","22994196","49","5432724"
"chr5","28429945","28430242","chr20","22996602","22996908","56","5433343"
"chr5","28469010","28469089","chr11","106359869","106359951","20","77890859"
"chr5","28498015","28498288","chr7","79223081","79223352","70","50725066"
"chr5","28621780","28622080","chr20","23191164","23191464","43","5430616"
"chr5","28710548","28710700","chr4","165048422","165048576","34","136337874"
"chr5","28714257","28714375","chr11","92397185","92397307","23","63682928"
"chr5","28852380","28852679","chr8","14936802","14937089","90","13915578"
"chr5","29037614","29037696","chr9","102960415","102960496","20","73922801"
"chr5","29079937","29080046","chrX","15471081","15471186","29","13608856"
"chr5","29080149","29080281","chr10","119055864","119055986","23","89975715"
"chr5","29130478","29130772","chr20","23687415","23687689","50","5443063"
"chr5","29227524","29227822","chrX","42244034","42244335","64","13016510"
"chr5","29357107","29357243","chr2A","20545290","20545415","41","8811817"
"chr5","29389627","29389900","chr20","23956249","23956536","36","5433378"
"chr5","29552319","29552603","chr20","24317237","24317534","43","5235082"
"chr5","29757774","29758058","chr20","24503878","24504189","53","5253896"
"chr5","29957565","29957632","chr2B","10110135","10110203","14","19847430"
"chr5","29996123","29996351","chr20","24741129","24741360","40","5254994"
"chr5","30032315","30032443","chr20","24778992","24779120","18","5253323"
"chr5","30534778","30535066","chr20","25451498","25451791","45","5083280"
"chr5","30562926","30563200","chr5","997797","998069","65","29565129"
"chr5","30567903","30568208","chr6","31725434","31725739","58","1157531"
"chr5","30570009","30570321","chr20","25485771","25486067","43","5084238"
"chr5","30619422","30619688","chr20","25540778","25541058","44","5078644"
"chr5","30672506","30672720","chr12","29993522","29993738","45","678984"
"chr5","30704899","30705170","chr1","163867986","163868280","88","133163087"
"chr5","30753126","30753426","chr19","4431570","4431870","70","26321556"
"chr5","30753430","30753642","chr20","25675056","25675270","30","5078374"
"chr5","30767473","30767751","chr20","25685608","25685859","63","5081865"
"chr5","30771386","30771438","chr6","112943007","112943059","17","82171621"
"chr5","30779492","30779712","chr17","21279650","21279885","52","9499842"
"chr5","30819626","30819924","chr20","25747492","25747789","63","5072134"
"chr5","30867862","30868176","chr11","11851520","11851821","62","19016342"
"chr5","30925841","30926118","chr11","71788914","71789195","57","40863073"
"chr5","30931828","30932137","chr1","182953932","182954226","67","152022104"
"chr5","30940829","30941092","chr8","68153815","68154082","52","37212986"
"chr5","30954881","30955075","chr20","25880238","25880431","30","5074643"
"chr5","30955076","30955303","chr20","25880432","25880663","35","5074644"
"chr5","30971023","30971141","chr4","177917580","177917697","15","146946557"
"chr5","30971762","30971909","chr1","41215550","41215700","43","10243788"
"chr5","31006908","31007227","chr6","137668297","137668608","72","106661389"
"chr5","31035603","31035891","chr2B","96226745","96227028","66","65191142"
"chr5","31045376","31045662","chr20","25983562","25983858","51","5061814"
"chr5","31080052","31080341","chr20","26025518","26025815","49","5054534"
"chr5","31110191","31110459","chr19","17786279","17786557","65","13323912"
"chr5","31158049","31158341","chr20","35877944","35878228","44","4719895"
"chr5","31159861","31160150","chr20","35879619","35879909","37","4719758"
"chr5","31168420","31168542","chr19","6249566","6249686","24","24918854"
"chr5","31173209","31173527","chr6","20689530","20689838","70","10483679"
"chr5","31174553","31174859","chr20","35894182","35894486","30","4719629"
"chr5","31183106","31183267","chr22","5376877","5377029","41","25806229"
"chr5","31191295","31191428","chr20","35910687","35910811","22","4719392"
"chr5","31191439","31191754","chr20","35910823","35911134","43","4719384"
"chr5","31194524","31194649","chr7","68089945","68090074","29","36895421"
"chr5","31195646","31195803","chr19","7784006","7784166","38","23411640"
"chr5","31218579","31218879","chr10","15385880","15386179","58","15832699"
"chr5","31232558","31232797","chr3","124045764","124046015","57","92813206"
"chr5","31236747","31236872","chr17","26242812","26242935","20","4993935"
"chr5","31238545","31238830","chr7","76146308","76146602","59","44907763"
"chr5","31243359","31243576","chr5","24829650","24829863","44","6413709"
"chr5","31247272","31247462","chr16","30447854","30448050","43","799418"
"chr5","31247995","31248145","chr1","52325310","52325464","35","21077315"
"chr5","31280489","31280736","chr6","44570126","44570373","43","13289637"
"chr5","31294679","31294819","chr20","36026368","36026502","17","4731689"
"chr5","31314160","31314470","chr20","36043478","36043785","50","4729318"
"chr5","31339780","31340001","chr7","32821026","32821256","54","1481246"
"chr5","31345445","31345630","chr5","58665127","58665321","40","27319682"
"chr5","31346870","31347146","chr1","15733941","15734215","64","15612929"
"chr5","31357516","31357714","chr20","36084199","36084404","27","4726683"
"chr5","31423428","31423588","chr16","29999340","29999496","31","1424088"
"chr5","31424437","31424576","chr12","7814448","7814584","29","23609989"
"chr5","31445992","31446242","chr20","36179352","36179629","51","4733360"
"chr5","31450441","31450748","chr20","36183190","36183498","39","4732749"
"chr5","31468478","31468759","chr20","36199679","36199986","58","4731201"
"chr5","31532774","31532921","chr5","143960091","143960234","37","112427317"
"chr5","31533347","31533643","chr11","75092590","75092889","57","43559243"
"chr5","31573255","31573409","chr5","83899371","83899523","40","52326116"
"chr5","31593838","31594109","chr7","45149736","45150014","63","13555898"
"chr5","31596441","31596679","chr20","36318739","36318983","29","4722298"
"chr5","31690843","31691132","chr22","19235015","19235299","56","12455828"
"chr5","31747111","31747370","chr20","36478446","36478706","36","4731335"
"chr5","31804427","31804630","chr1","9006546","9006728","58","22797881"
"chr5","31901867","31902028","chr2B","126034630","126034791","35","94132763"
"chr5","31904815","31905126","chr20","36647351","36647648","42","4742536"
"chr5","31939629","31939789","chr18","28705463","28705625","33","3234166"
"chr5","31967210","31967420","chr20","36713089","36713297","29","4745879"
"chr5","32052727","32052977","chr20","36799231","36799486","39","4746504"
"chr5","32082104","32082262","chr3","15628717","15628877","32","16453387"
"chr5","32107026","32107158","chr20","36861827","36861959","11","4754801"
"chr5","32126241","32126494","chr20","36881415","36881668","25","4755174"
"chr5","32130419","32130724","chr2B","28053453","28053751","75","4076966"
"chr5","32139130","32139399","chr20","36894397","36894680","38","4755267"
"chr5","32167379","32167640","chr20","36920320","36920582","32","4752941"
"chr5","32177385","32177672","chr20","36929904","36930214","61","4752519"
"chr5","32214093","32214384","chr20","36965008","36965327","50","4750915"
"chr5","32236144","32236419","chr20","36984283","36984547","56","4748139"
"chr5","32266203","32266347","chr15","69740012","69740164","28","37473809"
"chr5","32266955","32267093","chr20","24234554","24234683","32","8032401"
"chr5","32275635","32275772","chr1","7801459","7801595","22","24474176"
"chr5","32281154","32281433","chr20","37026795","37027085","42","4745641"
"chr5","32303482","32303778","chr20","37048755","37049057","22","4745273"
"chr5","32306238","32306523","chr20","37051176","37051488","52","4744938"
"chr5","32351000","32351111","chr20","37105529","37105642","18","4754529"
"chr5","32391012","32391120","chr16","28700829","28700940","19","3690183"
"chr5","32393482","32393725","chr11","102538602","102538848","50","70145120"
"chr5","32412470","32412581","chr6","152427255","152427377","25","120014785"
"chr5","32415732","32416018","chr6","4984341","4984620","60","27431391"
"chr5","32424836","32424976","chr8","103799790","103799921","35","71374954"
"chr5","32457311","32457542","chr20","37203363","37203605","32","4746052"
"chr5","32483687","32483806","chr5","19402858","19402978","23","13080829"
"chr5","32483979","32484141","chr3","10866047","10866211","34","21617932"
"chr5","32512856","32513087","chr20","37260677","37260889","43","4747821"
"chr5","32526795","32527119","chr5","121875015","121875319","103","89348220"
"chr5","32556094","32556226","chr1","134224162","134224296","29","101668068"
"chr5","32570901","32571201","chr20","37320510","37320810","35","4749609"
"chr5","32614936","32615225","chr20","37368277","37368583","48","4753341"
"chr5","32621832","32622135","chrX","41750026","41750320","61","9128194"
"chr5","32652602","32652670","chr4","2488200","2488266","7","30164402"
"chr5","32673821","32674115","chr20","37424907","37425212","46","4751086"
"chr5","32676894","32677201","chr20","37427403","37427705","41","4750509"
"chr5","32689191","32689488","chr20","37437026","37437336","38","4747835"
"chr5","32692419","32692682","chr14","79748369","79748624","65","47055950"
"chr5","32716229","32716520","chr20","37462221","37462515","45","4745992"
"chr5","32730047","32730262","chr3","58659960","58660170","43","25929913"
"chr5","32788904","32789222","chr19","15599409","15599722","64","17189495"
"chr5","32828405","32828703","chr4","41244247","41244538","83","8415842"
"chr5","32836388","32836603","chr20","37575496","37575723","36","4739108"
"chr5","32843906","32844038","chr20","37582787","37582918","11","4738881"
"chr5","32860095","32860410","chr10","86273826","86274140","70","53413731"
"chr5","32924874","32925039","chr8","56795337","56795503","35","23870463"
"chr5","33055753","33056038","chr20","37799046","37799317","42","4743293"
"chr5","33075399","33075584","chr8","78671294","78671472","67","45595895"
"chr5","33096110","33096404","chr20","37830036","37830349","63","4733926"
"chr5","33109013","33109354","chr1","10907015","10907304","110","22201998"
"chr5","33176895","33177212","chr20","37880930","37881235","51","4704035"
"chr5","33187542","33187882","chr20","37891691","37891994","85","4704149"
"chr5","33236845","33237119","chr20","37947694","37947968","22","4710849"
"chr5","33413895","33414158","chr12","114556281","114556543","71","81142386"
"chr5","33640681","33640963","chr12","11468643","11468934","69","22172038"
"chr5","33641357","33641475","chr20","38347046","38347168","15","4705689"
"chr5","33846355","33846668","chr20","38569341","38569640","73","4722986"
"chr5","33891704","33891913","chr15","37392823","37393034","47","3501119"
"chr5","33899028","33899316","chr20","38621904","38622207","45","4722876"
"chr5","33907626","33907936","chr4","4517769","4518079","60","29389857"
"chr5","34046901","34047186","chr20","38782083","38782378","57","4735182"
"chr5","34091921","34092166","chr20","38836855","38837104","64","4744934"
"chr5","34392507","34392631","chr14","52104689","52104808","19","17712182"
"chr5","34426628","34426838","chr2B","2330794","2331006","54","32095834"
"chr5","34487079","34487166","chrX","47268046","47268133","11","12780967"
"chr5","34542568","34542834","chr7","79040874","79041142","55","44498306"
"chr5","34555394","34555516","chr10","14128954","14129070","35","20426440"
"chr5","34598202","34598511","chr15","67589308","67589612","64","32991106"
"chr5","34789778","34790058","chr20","39522879","39523176","50","4733101"
"chr5","34844998","34845288","chr20","39574496","39574805","52","4729498"
"chr5","34877243","34877524","chr13","12122949","12123227","63","22754294"
"chr5","34890805","34891095","chr20","39625059","39625367","46","4734254"
"chr5","34896145","34896329","chr8","98909960","98910147","36","64013815"
"chr5","34951433","34951591","chr5","38476274","38476427","31","3524841"
"chr5","34957211","34957497","chr20","39682251","39682537","25","4725040"
"chr5","34986759","34987061","chr1","45032090","45032394","59","10045331"
"chr5","34988732","34988869","chrX","2886472","2886607","34","32102260"
"chr5","34988932","34989065","chrX","2794957","2795096","35","32193975"
"chr5","35027249","35027536","chr11","56824446","56824723","68","21797197"
"chr5","35068534","35068821","chr20","39788416","39788708","48","4719882"
"chr5","35165334","35165464","chr20","39890399","39890530","11","4725065"
"chr5","35168395","35168682","chr20","39893463","39893746","45","4725068"
"chr5","35213007","35213267","chr20","39935318","39935604","53","4722311"
"chr5","35230861","35230996","chr8","103799790","103799921","38","68568929"
"chr5","35346425","35346698","chr3","3841581","3841855","63","31504844"
"chr5","35353375","35353668","chr20","40081576","40081884","48","4728201"
"chr5","35416005","35416278","chr20","40143654","40143945","48","4727649"
"chr5","35423696","35423919","chr20","40151827","40152050","19","4728131"
"chr5","35423924","35424049","chr7","56839310","56839440","35","21415386"
"chr5","35424468","35424607","chr14","61100388","61100533","33","25675920"
"chr5","35471489","35471795","chr20","40195173","40195476","61","4723684"
"chr5","35510972","35511263","chr20","40229920","40230231","53","4718948"
"chr5","35656212","35656514","chr20","40391976","40392282","39","4735764"
"chr5","35695283","35695583","chr20","40426135","40426439","45","4730852"
"chr5","35729491","35729631","chr9","108241495","108241645","32","72512004"
"chr5","35746391","35746572","chr20","40480485","40480683","38","4734094"
"chr5","35774820","35775056","chr16","10554758","10555011","67","25220062"
"chr5","35914311","35914464","chr19","5169265","5169417","32","30745046"
"chr5","35966424","35966703","chr14","41627283","41627568","59","5660859"
"chr5","35983391","35983551","chr7","27780280","27780443","32","8203111"
"chr5","35994406","35994520","chr6","38593130","38593246","17","2598724"
"chr5","36114031","36114310","chr20","40852822","40853103","29","4738791"
"chr5","36397098","36397331","chr2A","37321978","37322207","53","924880"
"chr5","36400645","36400932","chr20","41105932","41106228","40","4705287"
"chr5","36439249","36439552","chr20","41141674","41141986","57","4702425"
"chr5","36470214","36470405","chr20","41169789","41169999","39","4699575"
"chr5","36533351","36533479","chr20","41233848","41233983","26","4700497"
"chr5","36541373","36541657","chr8","49256423","49256714","71","12715050"
"chr5","36588701","36588948","chr20","41283655","41283905","21","4694954"
"chr5","36679450","36679770","chr20","41372115","41372409","77","4692665"
"chr5","36694652","36694924","chr10","56909028","56909299","57","20214376"
"chr5","36812386","36812705","chr5","59937778","59938076","78","23125392"
"chr5","36969934","36970195","chr16","31649333","31649595","51","5320601"
"chr5","36979137","36979416","chr20","41676421","41676700","26","4697284"
"chr5","37072914","37073202","chr19","4570608","4570877","72","32502306"
"chr5","37207253","37207362","chr1","28402218","28402327","32","8805035"
"chr5","37252345","37252460","chr20","41926685","41926802","11","4674340"
"chr5","37252461","37252559","chr8","45002985","45003083","12","7750524"
"chr5","37351804","37352082","chr20","42014511","42014777","44","4662707"
"chr5","37429861","37429996","chrX","2794957","2795096","29","34634904"
"chr5","37430770","37430969","chr3","124850708","124850911","44","87419938"
"chr5","37441269","37441545","chr20","42103516","42103794","38","4662247"
"chr5","37443411","37443703","chr1","227415933","227416230","52","189972522"
"chr5","37507914","37508019","chr1","135447151","135447263","21","97939237"
"chr5","37533510","37533658","chr21","24720942","24721101","32","12812568"
"chr5","37543131","37543336","chr20","42218140","42218373","47","4675009"
"chr5","37546342","37546653","chr20","42220327","42220619","48","4673985"
"chr5","37552654","37552940","chr20","42226176","42226476","40","4673522"
"chr5","37576268","37576564","chr12","93203428","93203732","61","55627160"
"chr5","37587979","37588139","chr12","124842637","124842793","41","87254658"
"chr5","37591510","37591613","chr20","42260863","42260970","12","4669353"
"chr5","37612540","37612804","chr6","15607697","15607964","55","22004843"
"chr5","37620723","37620847","chr5","34139591","34139713","22","3481132"
"chr5","37637684","37637919","chr5","6396894","6397111","63","31240790"
"chr5","37638098","37638168","chr19","47522713","47522787","18","9884615"
"chr5","37643178","37643255","chr9","116919483","116919558","13","79276305"
"chr5","37652291","37652587","chr20","42326090","42326391","39","4673799"
"chr5","37672578","37672834","chr20","42345607","42345861","40","4673029"
"chr5","37690775","37690878","chr20","42362568","42362686","24","4671793"
"chr5","37705728","37705987","chr1","13854532","13854791","55","23851196"
"chr5","37716262","37716551","chr7","47520348","47520629","73","9804086"
"chr5","37733667","37733967","chr20","42401608","42401904","41","4667941"
"chr5","37760073","37760364","chr20","42432476","42432754","39","4672403"
"chr5","37764245","37764314","chr14","52999928","53000000","13","15235683"
"chr5","37765871","37766055","chrX","155644124","155644306","50","117878253"
"chr5","37769421","37769598","chr20","42442183","42442354","29","4672762"
"chr5","37783020","37783150","chr20","42456704","42456834","23","4673684"
"chr5","37789373","37789661","chr14","24364115","24364378","84","13425258"
"chr5","37795388","37795671","chr20","42473480","42473762","48","4678092"
"chr5","37800067","37800178","chr7","76940267","76940373","22","39140200"
"chr5","37823413","37823531","chr6","89162664","89162779","20","51339251"
"chr5","37824161","37824434","chr11","107710186","107710456","70","69886025"
"chr5","37837390","37837670","chr20","42518008","42518321","71","4680618"
"chr5","37839059","37839274","chr4","40096448","40096655","44","2257389"
"chr5","37872559","37872718","chr2A","56967550","56967706","31","19094991"
"chr5","37912853","37913161","chr20","42596958","42597265","40","4684105"
"chr5","37975234","37975317","chr5","53174739","53174812","25","15199505"
"chr5","37977396","37977478","chr11","106359869","106359951","23","68382473"
"chr5","38023676","38023830","chr15","69740012","69740164","37","31716336"
"chr5","38043157","38043264","chr5","14822723","14822826","33","23220434"
"chr5","38043436","38043541","chr5","141874614","141874722","19","103831178"
"chr5","38045404","38045709","chr20","42739737","42740044","41","4694333"
"chr5","38096298","38096558","chr9","106704680","106704932","57","68608382"
"chr5","38116514","38116707","chr16","49108907","49109103","38","10992393"
"chr5","38250324","38250458","chr16","4295792","4295924","22","33954532"
"chr5","38271851","38272139","chr20","42946943","42947235","26","4675092"
"chr5","38304418","38304707","chr2B","28011598","28011889","58","10292820"
"chr5","38409849","38409980","chr20","43090876","43091008","11","4681027"
"chr5","38413157","38413324","chr12","19312537","19312701","29","19100620"
"chr5","38424636","38424969","chr20","43118860","43119168","66","4694224"
"chr5","38444530","38444769","chr5","39539811","39540058","22","1095281"
"chr5","38465687","38465971","chr22","23337344","23337614","69","15128343"
"chr5","38482322","38482558","chr9","114615846","114616073","47","76133524"
"chr5","38493064","38493380","chr20","43182711","43183027","27","4689647"
"chr5","38498290","38498555","chr8","46648000","46648271","53","8149710"
"chr5","38503330","38503451","chr5","38846535","38846652","22","343205"
"chr5","38509135","38509312","chr12","121032828","121033006","40","82523693"
"chr5","38537665","38537954","chr20","43221497","43221808","53","4683832"
"chr5","38551554","38551856","chr20","43235527","43235841","50","4683973"
"chr5","38559246","38559557","chr20","43243296","43243607","32","4684050"
"chr5","38561131","38561352","chr14","41909960","41910181","49","3348829"
"chr5","38576382","38576688","chr20","43263902","43264211","40","4687520"
"chr5","38583091","38583374","chrX","103549996","103550279","61","64966905"
"chr5","38596133","38596443","chr8","98755171","98755484","62","60159038"
"chr5","38615710","38615829","chr14","33557431","33557546","35","5058279"
"chr5","38630507","38630803","chr20","43315535","43315831","45","4685028"
"chr5","38648618","38648781","chr20","43332910","43333066","25","4684292"
"chr5","38710191","38710315","chr3","65193379","65193500","22","26483188"
"chr5","38711612","38711896","chr20","43383982","43384269","27","4672370"
"chr5","38742609","38742733","chr2B","95896698","95896822","20","57154089"
"chr5","38795060","38795366","chr4","75979129","75979421","73","37184069"
"chr5","38805635","38805913","chr20","43478057","43478352","54","4672422"
"chr5","38809380","38809689","chr20","43481202","43481507","29","4671822"
"chr5","38822602","38822820","chr1","133209701","133209920","39","94387099"
"chr5","38860552","38860801","chr13","7008373","7008614","54","31852179"
"chr5","38927131","38927354","chrX","154182968","154183182","59","115255837"
"chr5","38962623","38962739","chr20","43641046","43641162","13","4678423"
"chr5","38980284","38980579","chr20","43654492","43654800","46","4674208"
"chr5","38981818","38981990","chr20","43656039","43656217","28","4674221"
"chr5","39031810","39031960","chr16","66636103","66636254","34","27604293"
"chr5","39047589","39047861","chr20","43725691","43725935","60","4678102"
"chr5","39069346","39069558","chr20","43745233","43745444","38","4675887"
"chr5","39078342","39078584","chr12","35343544","35343773","50","3734798"
"chr5","39086443","39086724","chr20","43752048","43752338","37","4665605"
"chr5","39132978","39133096","chr8","85941093","85941209","18","46808115"
"chr5","39140366","39140692","chr20","43810368","43810689","46","4670002"
"chr5","39141975","39142255","chr20","43811576","43811889","63","4669601"
"chr5","39176363","39176644","chr20","43846975","43847278","38","4670612"
"chr5","39423400","39423681","chr20","44087976","44088244","61","4664576"
"chr5","39431189","39431309","chr2B","16261383","16261481","33","23169806"
"chr5","39431394","39431545","chr3","152725982","152726134","31","113294588"
"chr5","39476957","39477229","chr6","44546586","44546829","70","5069629"
"chr5","39532966","39533252","chr20","44208800","44209102","42","4675834"
"chr5","39544837","39545111","chr20","44220485","44220757","41","4675648"
"chr5","39563787","39563906","chr7","64738088","64738205","24","25174301"
"chr5","39581346","39581470","chr10","103685868","103685992","16","64104522"
"chr5","39586154","39586421","chr20","44257674","44257941","42","4671520"
"chr5","39597147","39597425","chr20","44268055","44268357","61","4670908"
"chr5","39615293","39615545","chr19","40370912","40371163","54","755619"
"chr5","39618430","39618721","chr9","71434336","71434622","64","31815906"
"chr5","39655602","39655766","chr1","41590742","41590907","38","1935140"
"chr5","39667188","39667310","chr20","44355813","44355940","17","4688625"
"chr5","39820138","39820267","chr7","101396275","101396399","37","61576137"
"chr5","39823751","39824060","chr20","44634038","44634350","50","4810287"
"chr5","39831565","39831717","chr7","72465626","72465775","33","32634061"
"chr5","39870500","39870808","chr20","44684438","44684739","43","4813938"
"chr5","39872722","39872893","chr5","138623932","138624102","49","98751210"
"chr5","39877011","39877327","chr20","44689737","44690061","53","4812726"
"chr5","39884658","39884939","chr20","44697260","44697539","29","4812602"
"chr5","39890624","39890764","chr1","205548459","205548612","29","165657835"
"chr5","39892426","39892710","chr20","44704038","44704326","56","4811612"
"chr5","39893311","39893587","chr1","204634764","204635028","68","164741453"
"chr5","39899487","39899784","chr10","138327269","138327579","58","98427782"
"chr5","39913558","39913846","chr20","44724307","44724599","45","4810749"
"chr5","39926996","39927120","chr14","60352578","60352701","28","20425582"
"chr5","39946083","39946182","chr1","160301284","160301387","24","120355201"
"chr5","39949952","39950133","chr11","62871028","62871212","44","22921076"
"chr5","39970758","39970864","chr12","1702","1809","21","39969056"
"chr5","39974536","39974814","chr20","44785371","44785661","41","4810835"
"chr5","39976584","39976851","chr2B","28011598","28011889","63","11964986"
"chr5","39982451","39982691","chr15","55250430","55250671","66","15267979"
"chr5","40029433","40029493","chr20","44844482","44844542","5","4815049"
"chr5","40042292","40042586","chr20","44857011","44857287","56","4814719"
"chr5","40047168","40047340","chr20","62429817","62429995","40","22382649"
"chr5","40050524","40050822","chr20","44865959","44866268","42","4815435"
"chr5","40153114","40153399","chr20","44965296","44965582","32","4812182"
"chr5","40169034","40169158","chr20","44980040","44980164","16","4811006"
"chr5","40214089","40214378","chr20","45020859","45021154","23","4806770"
"chr5","40290709","40291008","chr20","45094877","45095182","39","4804168"
"chr5","40348345","40348622","chr11","60550349","60550620","64","20202004"
"chr5","40366506","40366797","chr20","45164523","45164814","32","4798017"
"chr5","40404940","40405251","chr20","45204881","45205195","52","4799941"
"chr5","40411784","40412079","chr4","165626465","165626758","59","125214681"
"chr5","40459286","40459592","chr20","45257644","45257933","43","4798358"
"chr5","40474977","40475259","chr20","45274200","45274484","25","4799223"
"chr5","40533450","40533746","chr16","60238828","60239122","62","19705378"
"chr5","40533751","40534046","chr1","110540289","110540565","73","70006538"
"chr5","40564667","40564947","chr3","140583382","140583663","59","100018715"
"chr5","40638024","40638121","chr10","117001518","117001614","17","76363494"
"chr5","40649162","40649436","chr20","45407759","45408060","62","4758597"
"chr5","40655864","40655931","chr20","45413945","45414012","8","4758081"
"chr5","40669754","40670023","chr20","45430588","45430867","47","4760834"
"chr5","40674697","40675016","chr20","45435429","45435720","59","4760732"
"chr5","40681183","40681492","chr20","45440812","45441120","55","4759629"
"chr5","40685968","40686126","chr3","49411661","49411824","37","8725693"
"chr5","40769738","40770061","chr20","45531560","45531859","94","4761822"
"chr5","40841147","40841399","chr20","45610645","45610902","35","4769498"
"chr5","40885568","40885840","chr3","54169795","54170080","54","13284227"
"chr5","40910629","40910902","chr5","52289773","52290029","75","11379144"
"chr5","40912777","40912876","chr8","15220773","15220864","22","25692004"
"chr5","40952801","40953063","chr20","45662678","45662945","52","4709877"
"chr5","41025721","41025855","chr19","37526707","37526833","37","3499014"
"chr5","41026035","41026208","chr12","131957243","131957412","35","90931208"
"chr5","41074701","41075012","chr20","45825363","45825681","35","4750662"
"chr5","41087002","41087147","chr11","62991394","62991536","31","21904392"
"chr5","41131508","41131784","chr20","45876673","45876960","32","4745165"
"chr5","41161068","41161365","chr20","45910042","45910339","55","4748974"
"chr5","41165120","41165395","chr20","45913331","45913576","55","4748211"
"chr5","41169646","41169885","chr20","45917850","45918095","31","4748204"
"chr5","41176938","41177230","chr20","45927120","45927416","42","4750182"
"chr5","41201010","41201302","chr20","45958953","45959247","52","4757943"
"chr5","41201764","41202052","chr5","25469036","25469313","64","15732728"
"chr5","41248463","41248771","chrX","22046650","22046950","65","19201813"
"chr5","41267248","41267442","chr1","51823505","51823703","45","10556257"
"chr5","41267745","41267823","chr1","8477806","8477881","17","32789939"
"chr5","41300427","41300674","chrX","19008809","19009055","55","22291618"
"chr5","41318775","41318941","chr7","45641217","45641385","36","4322442"
"chr5","41319228","41319532","chr20","46075469","46075761","65","4756241"
"chr5","41339462","41339588","chrX","49113443","49113558","32","7773981"
"chr5","41344284","41344568","chr7","33270606","33270890","60","8073678"
"chr5","41359782","41360106","chr20","46116783","46117078","62","4757001"
"chr5","41429927","41430118","chr7","72991482","72991668","51","31561555"
"chr5","41462990","41463276","chr2B","117896887","117897188","63","76433897"
"chr5","41467543","41467791","chr5","133131289","133131554","68","91663746"
"chr5","41470092","41470314","chr19","3148880","3149117","65","38321212"
"chr5","41470584","41470657","chr20","46225290","46225365","6","4754706"
"chr5","41471355","41471535","chr20","46225675","46225860","21","4754320"
"chr5","41477921","41478045","chr6","18588428","18588554","31","22889493"
"chr5","41482372","41482631","chr5","35568316","35568581","57","5914056"
"chr5","41484931","41485159","chr20","46238554","46238779","28","4753623"
"chr5","41498655","41498880","chr13","2315092","2315313","53","39183563"
"chr5","41517691","41517989","chr20","46269637","46269954","52","4751946"
"chr5","41522388","41522700","chr20","46273521","46273802","62","4751133"
"chr5","41537264","41537415","chrX","39769112","39769266","28","1768152"
"chr5","41562353","41562485","chr20","46297603","46297732","24","4735250"
"chr5","41570038","41570169","chr4","197353681","197353811","18","155783643"
"chr5","41570948","41571039","chr18","29375716","29375801","21","12195232"
"chr5","41588841","41589115","chr20","46319448","46319723","39","4730607"
"chr5","41620022","41620221","chr12","108531528","108531723","64","66911506"
"chr5","41628600","41628873","chr11","113401179","113401455","64","71772579"
"chr5","41637903","41638237","chr9","59837290","59837616","83","18199387"
"chr5","41647079","41647333","chr6","57776186","57776458","77","16129107"
"chr5","41651080","41651396","chr20","46391943","46392263","44","4740863"
"chr5","41668021","41668136","chr3","123061433","123061549","16","81393412"
"chr5","41669755","41670070","chr20","46416299","46416589","70","4746544"
"chr5","41730234","41730307","chr19","2159190","2159268","15","39571044"
"chr5","41759789","41759941","chr15","69740012","69740164","32","27980223"
"chr5","41773476","41773650","chr3","190221708","190221878","54","148448232"
"chr5","41807871","41808146","chr20","46564519","46564830","64","4756648"
"chr5","41816308","41816583","chr20","46574018","46574305","41","4757710"
"chr5","41844631","41844932","chr20","46602685","46602983","46","4758054"
"chr5","41857677","41857973","chr7","28366007","28366296","61","13491670"
"chr5","41923140","41923451","chr20","46705570","46705878","38","4782430"
"chr5","42079915","42080058","chr14","57543403","57543552","34","15463488"
"chr5","42099563","42099874","chr6","113877732","113878039","72","71778169"
"chr5","42104725","42104981","chr20","46908572","46908834","31","4803847"
"chr5","42137545","42137834","chr20","46935559","46935848","38","4798014"
"chr5","42161798","42161970","chr9","35828180","35828355","30","6333618"
"chr5","42163022","42163298","chr20","46964011","46964286","43","4800989"
"chr5","42172832","42173142","chr20","46992212","46992494","62","4819380"
"chr5","42208591","42208849","chr1","28917331","28917589","65","13291260"
"chr5","42268450","42268721","chr20","47101182","47101452","44","4832732"
"chr5","42317524","42317790","chr3","143011557","143011810","60","100694033"
"chr5","42365422","42365737","chr20","47204778","47205090","54","4839356"
"chr5","42385634","42385953","chr20","47223324","47223644","36","4837690"
"chr5","42418013","42418256","chr7","71054973","71055220","51","28636960"
"chr5","42441752","42442061","chr20","47289336","47289631","49","4847584"
"chr5","42472521","42472817","chr7","104942328","104942627","55","62469807"
"chr5","42635978","42636172","chr3","101529162","101529367","47","58893184"
"chr5","42678522","42678821","chr15","37580699","37580999","71","5097823"
"chr5","42707161","42707464","chr14","89141565","89141868","65","46434404"
"chr5","42756060","42756374","chr20","47606037","47606341","61","4849977"
"chr5","42767279","42767453","chr1","152885383","152885548","35","110118104"
"chr5","42837854","42838158","chr20","47685743","47686052","34","4847889"
"chr5","42863464","42863775","chr20","47709808","47710111","35","4846344"
"chr5","42873448","42873547","chr19","16749128","16749228","11","26124320"
"chr5","42874022","42874332","chr20","47719104","47719389","51","4845082"
"chr5","42875882","42876175","chr20","47720658","47720951","45","4844776"
"chr5","42879100","42879394","chrX","53628576","53628870","48","10749476"
"chr5","42890848","42890918","chr16","25652983","25653050","20","17237865"
"chr5","42893581","42893712","chr20","47736108","47736240","21","4842527"
"chr5","42896146","42896445","chr7","76146308","76146602","64","33250162"
"chr5","42909532","42909668","chr5","55561544","55561681","27","12652012"
"chr5","42924771","42924933","chr7","41568711","41568873","30","1356060"
"chr5","42928354","42928597","chr3","113865199","113865441","60","70936845"
"chr5","42935261","42935507","chrX","153885854","153886097","56","110950593"
"chr5","42953168","42953462","chr8","24737260","24737543","67","18215908"
"chr5","42955494","42955789","chr20","47810500","47810810","50","4855006"
"chr5","42957132","42957432","chr8","9109840","9110131","60","33847292"
"chr5","42977835","42977965","chr7","79700768","79700899","23","36722933"
"chr5","42981040","42981329","chr20","47831594","47831892","38","4850554"
"chr5","42982232","42982462","chr20","47832868","47833113","37","4850636"
"chr5","43049586","43049876","chr7","158708726","158709020","63","115659140"
"chr5","43057672","43057977","chr22","27278868","27279167","64","15778804"
"chr5","43063703","43063985","chr7","64852523","64852793","54","21788820"
"chr5","43069713","43070018","chr7","127734527","127734826","73","84664814"
"chr5","43071446","43071566","chr6","112856828","112856953","21","69785382"
"chr5","43072815","43073077","chr13","82450295","82450565","58","39377480"
"chr5","43076253","43076367","chr20","47933975","47934087","12","4857722"
"chr5","43076647","43076763","chr3","50531111","50531231","23","7454464"
"chr5","43087629","43087834","chr8","86155985","86156190","47","43068356"
"chr5","43087971","43088261","chr20","47946079","47946376","43","4858108"
"chr5","43092125","43092373","chr15","61699539","61699802","67","18607414"
"chr5","43101863","43102159","chr20","47959265","47959571","64","4857402"
"chr5","43111277","43111565","chr20","47967888","47968181","43","4856611"
"chr5","43121087","43121385","chr3","33532747","33533048","84","9588340"
"chr5","43152880","43153151","chr20","48005403","48005700","61","4852523"
"chr5","43153174","43153288","chr14","12658425","12658540","25","30494749"
"chr5","43171001","43171152","chr10","92108530","92108678","33","48937529"
"chr5","43208013","43208307","chr20","48069936","48070230","27","4861923"
"chr5","43210447","43210699","chr2A","96269120","96269376","47","53058673"
"chr5","43235798","43235964","chr1","200711181","200711342","25","157475383"
"chr5","43245277","43245580","chr12","43802996","43803296","49","557719"
"chr5","43255809","43256123","chr15","47263678","47263989","60","4007869"
"chr5","43259477","43259729","chr19","37429223","37429469","55","5830254"
"chr5","43273736","43273853","chr20","48111352","48111469","14","4837616"
"chr5","43284137","43284436","chr20","48122876","48123170","37","4838739"
"chr5","43300118","43300239","chr6","8143644","8143767","20","35156474"
"chr5","43312852","43312992","chr9","108241495","108241645","48","64928643"
"chr5","43313712","43313819","chr1","160028610","160028719","20","116714898"
"chr5","43335113","43335368","chr20","48180973","48181241","49","4845860"
"chr5","43369217","43369511","chrX","54323009","54323306","51","10953792"
"chr5","43372174","43372512","chr20","48242933","48243256","60","4870759"
"chr5","43389695","43389824","chr20","48260540","48260664","22","4870845"
"chr5","43392579","43392879","chr20","48263050","48263346","34","4870471"
"chr5","43402952","43403060","chr16","68805794","68805900","13","25402842"
"chr5","43453162","43453491","chr1","45223007","45223325","82","1769845"
"chr5","43498374","43498681","chr20","48487515","48487824","46","4989141"
"chr5","43500337","43500626","chr16","40803572","40803860","56","2696765"
"chr5","43503712","43504010","chr9","96033142","96033440","57","52529430"
"chr5","43510895","43511044","chr11","102853043","102853197","32","59342148"
"chr5","43545780","43546028","chr20","48524382","48524654","55","4978602"
"chr5","43550005","43550199","chr20","48527889","48528062","41","4977884"
"chr5","43550878","43551140","chr10","14148508","14148787","69","29402370"
"chr5","43572298","43572603","chr20","48550192","48550503","74","4977894"
"chr5","43580055","43580281","chr4","93981984","93982206","46","50401929"
"chr5","43609380","43609541","chr7","141817790","141817956","41","98208410"
"chr5","43633519","43633782","chr10","59917705","59917982","69","16284186"
"chr5","43644305","43644600","chr22","29105736","29106038","62","14538569"
"chr5","43676484","43676647","chr14","87251345","87251501","46","43574861"
"chr5","43682150","43682406","chr10","85764392","85764649","52","42082242"
"chr5","43704799","43704868","chr20","48682433","48682505","8","4977634"
"chr5","43726594","43726708","chr17","57665074","57665183","27","13938480"
"chr5","43740853","43741126","chr20","48709408","48709707","57","4968555"
"chr5","43773703","43773798","chr7","71755573","71755664","24","27981870"
"chr5","43779555","43779876","chr1","185329634","185329914","87","141550079"
"chr5","43797187","43797496","chr20","48763382","48763682","48","4966195"
"chr5","43799276","43799490","chr20","48766497","48766713","41","4967221"
"chr5","43801468","43801695","chr7","156830088","156830307","59","113028620"
"chr5","43811317","43811522","chr13","83493419","83493616","52","39682102"
"chr5","43829247","43829557","chr20","48807849","48808150","46","4978602"
"chr5","43876818","43876942","chr20","48863294","48863412","17","4986476"
"chr5","43882849","43882975","chr13","7095404","7095527","24","36787445"
"chr5","43889568","43889677","chr20","48878285","48878398","10","4988717"
"chr5","43897176","43897255","chr10","65435545","65435621","13","21538369"
"chr5","43899991","43900284","chr20","48889170","48889466","38","4989179"
"chr5","43923522","43923812","chr20","48913867","48914168","62","4990345"
"chr5","43936787","43936916","chr7","74242105","74242234","20","30305318"
"chr5","43952762","43952925","chr5","49653517","49653681","41","5700755"
"chr5","43958997","43959095","chrX","118203593","118203697","15","74244596"
"chr5","43961909","43962030","chr5","10879418","10879538","13","33082491"
"chr5","43962912","43963067","chr4","21061999","21062161","37","22900913"
"chr5","44019609","44019905","chr20","49002282","49002562","53","4982673"
"chr5","44071500","44071811","chr3","200749508","200749818","58","156678008"
"chr5","44073143","44073403","chr11","66752239","66752505","72","22679096"
"chr5","44078698","44078994","chr1","158721814","158722109","56","114643116"
"chr5","44127040","44127350","chr20","49122328","49122641","29","4995288"
"chr5","44152931","44153196","chr20","49145952","49146215","59","4993021"
"chr5","44154320","44154604","chr20","49147358","49147649","29","4993038"
"chr5","44174256","44174508","chr20","49166115","49166387","57","4991859"
"chr5","44179782","44180055","chr1","28877322","28877596","63","15302460"
"chr5","44259758","44259882","chr20","49242109","49242230","15","4982351"
"chr5","44297282","44297584","chr20","49279364","49279672","40","4982082"
"chr5","44312116","44312426","chr7","57763615","57763900","60","13451499"
"chr5","44334390","44334664","chr20","49321100","49321394","56","4986710"
"chr5","44337858","44337986","chr9","97528942","97529071","22","53191084"
"chr5","44403508","44403811","chr20","49391060","49391370","46","4987552"
"chr5","44450611","44450887","chr20","49434102","49434403","63","4983491"
"chr5","44465353","44465657","chr20","49447829","49448107","51","4982476"
"chr5","44469491","44469606","chr3","43539926","43540049","29","929565"
"chr5","44493581","44493876","chr20","49475169","49475474","47","4981588"
"chr5","44559275","44559341","chr20","49674431","49674497","8","5115156"
"chr5","44573146","44573437","chr19","33970199","33970496","69","10602947"
"chr5","44573438","44573623","chr18","55236793","55236976","40","10663355"
"chr5","44609772","44610064","chr20","49587733","49588045","52","4977961"
"chr5","44614610","44614831","chr20","49592306","49592527","27","4977696"
"chr5","44615197","44615309","chr6","138691257","138691371","19","94076060"
"chr5","44628408","44628707","chr20","49611981","49612279","40","4983573"
"chr5","44636668","44636925","chr20","49617065","49617314","32","4980397"
"chr5","44637525","44637670","chr1","193134715","193134856","35","148497190"
"chr5","44645666","44645794","chr12","120255183","120255309","21","75609517"
"chr5","44646394","44646550","chr15","69740012","69740164","33","25093618"
"chr5","44662484","44662587","chr7","7121117","7121223","21","37541367"
"chr5","44672605","44672726","chr20","49650394","49650523","22","4977789"
"chr5","44682536","44682765","chr20","49661226","49661456","20","4978690"
"chr5","44683475","44683692","chr16","31565044","31565261","46","13118431"
"chr5","44685805","44685938","chr5","133578375","133578499","42","88892570"
"chr5","44696051","44696346","chr19","18354117","18354417","63","26341934"
"chr5","44713219","44713387","chr9","108496639","108496796","39","63783420"
"chr5","44731778","44731933","chr10","49585047","49585201","27","4853269"
"chr5","44736818","44736952","chr8","95818105","95818237","23","51081287"
"chr5","44750075","44750349","chr14","47464441","47464716","54","2714366"
"chr5","44781565","44781768","chr12","35015764","35015949","54","9765801"
"chr5","44788138","44788437","chr1","22629899","22630197","62","22158239"
"chr5","44788516","44788637","chr6","75432032","75432147","35","30643516"
"chr5","44802324","44802551","chr7","65603038","65603269","60","20800714"
"chr5","44810173","44810313","chr6","158178221","158178360","35","113368048"
"chr5","44826941","44827226","chr9","15217563","15217854","58","29609378"
"chr5","44831747","44831997","chr20","49807675","49807917","40","4975928"
"chr5","44832060","44832378","chr5","137995613","137995921","75","93163553"
"chr5","44865245","44865372","chr15","77749043","77749171","32","32883798"
"chr5","44867823","44868055","chr20","49852075","49852335","53","4984252"
"chr5","44897953","44898219","chr20","49883930","49884181","48","4985977"
"chr5","44902418","44902470","chr1","141406303","141406358","9","96503885"
"chr5","44902667","44902781","chr16","5288189","5288299","27","39614478"
"chr5","44907439","44907699","chr20","49893358","49893627","34","4985919"
"chr5","44916894","44917177","chr20","49902948","49903248","53","4986054"
"chr5","44930530","44930659","chrX","107717987","107718116","22","62787457"
"chr5","44962506","44962813","chr5","7517732","7518038","55","37444774"
"chr5","44965750","44965992","chr20","49949887","49950123","40","4984137"
"chr5","45023146","45023438","chr20","50005313","50005608","42","4982167"
"chr5","45039533","45039669","chr20","50021233","50021367","12","4981700"
"chr5","45071688","45071899","chr19","16497701","16497912","46","28573987"
"chr5","45238215","45238511","chr20","50217411","50217714","36","4979196"
"chr5","45351086","45351383","chr20","50320285","50320606","50","4969199"
"chr5","45399279","45399563","chr1","43624160","43624442","58","1775119"
"chr5","45479788","45480065","chr20","50435495","50435780","60","4955707"
"chr5","45491631","45491944","chr20","50447168","50447494","44","4955537"
"chr5","45588189","45588383","chr20","50547776","50547966","25","4959587"
"chr5","45610953","45611263","chr4","119585170","119585476","73","73974217"
"chr5","45617171","45617376","chr8","63354407","63354585","55","17737236"
"chr5","45662348","45662643","chr2A","20636963","20637255","62","25025385"
"chr5","45676524","45676829","chr2A","86985791","86986101","69","41309267"
"chr5","45687401","45687503","chr3","54187936","54188036","22","8500535"
"chr5","45689852","45690137","chr7","76104969","76105262","65","30415117"
"chr5","45709377","45709494","chr20","50674539","50674656","14","4965162"
"chr5","45719791","45719857","chr8","129393004","129393067","18","83673213"
"chr5","45731136","45731409","chr10","134541461","134541734","65","88810325"
"chr5","45743202","45743490","chr1","68093289","68093580","61","22350087"
"chr5","45777355","45777602","chr18","61787491","61787728","71","16010136"
"chr5","45801209","45801484","chr1","78966022","78966292","55","33164813"
"chr5","45817074","45817209","chr8","103799790","103799921","32","57982716"
"chr5","45832949","45833072","chr20","50817750","50817867","18","4984801"
"chr5","45843972","45844243","chr4","152323211","152323483","56","106479239"
"chr5","45864865","45865129","chr1","41237559","41237826","58","4627306"
"chr5","45891576","45891880","chr20","50875393","50875699","37","4983817"
"chr5","45893528","45893736","chr10","37833913","37834126","54","8059615"
"chr5","45898892","45899118","chr20","50884653","50884899","47","4985761"
"chr5","45918310","45918602","chr6","169154793","169155067","78","123236483"
"chr5","45919105","45919229","chr3","65193379","65193500","18","19274274"
"chr5","45925048","45925348","chr1","163867986","163868280","63","117942938"
"chr5","45942902","45943197","chr20","50937944","50938246","49","4995042"
"chr5","45959059","45959169","chr9","13555565","13555673","20","32403494"
"chr5","45959437","45959575","chr10","114927293","114927433","37","68967856"
"chr5","45991758","45992032","chr20","50992442","50992729","44","5000684"
"chr5","46012332","46012457","chr17","5166081","5166204","19","40846251"
"chr5","46013240","46013362","chr9","14164360","14164484","17","31848880"
"chr5","46026064","46026188","chr20","46080183","46080300","21","54119"
"chr5","46027919","46028043","chr16","16438347","16438462","22","29589572"
"chr5","46035685","46035974","chr20","51030976","51031246","58","4995291"
"chr5","46098029","46098329","chr20","51114883","51115183","31","5016854"
"chr5","46106617","46106929","chr20","51123858","51124165","37","5017241"
"chr5","46117295","46117549","chr20","51147801","51148058","57","5030506"
"chr5","46122195","46122490","chr20","51156287","51156552","58","5034092"
"chr5","46128864","46129162","chr20","51164117","51164395","47","5035253"
"chr5","46162813","46163080","chr20","51197916","51198200","59","5035103"
"chr5","46186278","46186563","chr20","51224840","51225121","39","5038562"
"chr5","46192312","46192612","chr20","51231771","51232088","49","5039459"
"chr5","46199515","46199838","chr7","65058160","65058461","84","18858645"
"chr5","46356024","46356131","chr2B","16451102","16451202","19","29904922"
"chr5","46395571","46395814","chr20","51479452","51479672","37","5083881"
"chr5","46422916","46423218","chr20","51508493","51508809","54","5085577"
"chr5","46468072","46468386","chr20","51556079","51556390","36","5088007"
"chr5","46490527","46490817","chr20","51586905","51587197","36","5096378"
"chr5","46519990","46520304","chr20","51608155","51608446","48","5088165"
"chr5","46622564","46622852","chr20","51713930","51714217","45","5091366"
"chr5","46652174","46652472","chr3","15287667","15287961","64","31364507"
"chr5","46690258","46690552","chr8","124929520","124929816","69","78239262"
"chr5","46697641","46697947","chr16","64122904","64123217","69","17425263"
"chr5","46699091","46699369","chr16","1644503","1644782","53","45054588"
"chr5","46833067","46833363","chr2A","97057312","97057598","66","50224245"
"chr5","46973771","46974052","chr20","52064679","52064971","49","5090908"
"chr5","47065379","47065501","chr12","57869262","57869385","28","10803883"
"chr5","47103603","47103730","chrX","48716156","48716279","35","1612553"
"chr5","47113581","47113711","chr9","93151090","93151202","33","46037509"
"chr5","47144616","47144937","chr20","52234219","52234550","55","5089603"
"chr5","47148142","47148294","chr1","68709407","68709549","38","21561265"
"chr5","47161129","47161430","chr20","52250118","52250418","51","5088989"
"chr5","47170162","47170437","chr20","52258416","52258715","45","5088254"
"chr5","47186874","47187180","chr20","52274596","52274908","38","5087722"
"chr5","47228122","47228216","chr2A","63084317","63084409","21","15856195"
"chr5","47331290","47331389","chr7","75095171","75095269","20","27763881"
"chr5","47436975","47437103","chr5","120504650","120504778","25","73067675"
"chr5","47439121","47439392","chr20","52544058","52544339","46","5104937"
"chr5","47471029","47471315","chr20","52576441","52576715","49","5105412"
"chr5","47474141","47474403","chrX","156319225","156319483","57","108845084"
"chr5","47484367","47484588","chr7","44555416","44555635","42","2928951"
"chr5","47511527","47511801","chr20","52630503","52630801","63","5118976"
"chr5","47545271","47545547","chr20","52676388","52676687","58","5131117"
"chr5","47551330","47551628","chr13","96074609","96074909","57","48523279"
"chr5","47574088","47574208","chr20","52711282","52711402","9","5137194"
"chr5","47600924","47601200","chr4","123723229","123723506","60","76122305"
"chr5","47602312","47602604","chr3","49741493","49741779","53","2139181"
"chr5","47612374","47612552","chr3","9289110","9289290","56","38323264"
"chr5","47631992","47632101","chr10","91291144","91291253","22","43659152"
"chr5","47663853","47664125","chr19","4570608","4570877","59","43093245"
"chr5","47667643","47667854","chr12","75161946","75162159","49","27494303"
"chr5","47672141","47672430","chr2A","59579973","59580274","66","11907832"
"chr5","47686405","47686700","chr20","52815594","52815893","57","5129189"
"chr5","47688290","47688566","chr7","44334451","44334729","51","3353839"
"chr5","47704496","47704762","chr5","35568316","35568581","59","12136180"
"chr5","47710578","47710885","chr20","52840994","52841289","42","5130416"
"chr5","47748603","47748891","chr20","52887433","52887714","61","5138830"
"chr5","47761363","47761626","chr20","52900600","52900876","48","5139237"
"chr5","47782569","47782691","chr9","78547732","78547838","35","30765163"
"chr5","47816856","47817115","chr20","52952501","52952785","64","5135645"
"chr5","48039947","48040247","chr14","33040429","33040734","60","14999518"
"chr5","48226656","48226775","chr9","91746687","91746807","36","43520031"
"chr5","48239301","48239611","chr20","53372079","53372401","53","5132778"
"chr5","48246989","48247283","chr20","53380436","53380726","32","5133447"
"chr5","48342030","48342329","chr20","53482614","53482932","51","5140584"
"chr5","48343357","48343475","chr20","53483974","53484092","12","5140617"
"chr5","48397875","48398015","chr19","48021202","48021336","28","376673"
"chr5","48398018","48398310","chr20","53536315","53536620","54","5138297"
"chr5","48410464","48410768","chr7","85735990","85736299","57","37325526"
"chr5","48412872","48413178","chr20","53551855","53552148","55","5138983"
"chr5","48446713","48447012","chr20","53583245","53583548","39","5136532"
"chr5","48470769","48471027","chr20","53609639","53609907","37","5138870"
"chr5","48516950","48517208","chr20","53656682","53656963","55","5139732"
"chr5","48561171","48561469","chr20","53700607","53700919","61","5139436"
"chr5","48580019","48580134","chr17","16081237","16081345","30","32498782"
"chr5","48649112","48649403","chr20","53783842","53784140","49","5134730"
"chr5","48808136","48808441","chr20","53934902","53935197","42","5126766"
"chr5","48815378","48815659","chr20","53942173","53942468","58","5126795"
"chr5","48840374","48840654","chr20","53970719","53970984","61","5130345"
"chr5","48862389","48862684","chr20","53991580","53991874","33","5129191"
"chr5","48891912","48892209","chr20","54023491","54023792","41","5131579"
"chr5","48901563","48901892","chr20","54033126","54033448","50","5131563"
"chr5","49106231","49106525","chr20","10630725","10631018","66","38475506"
"chr5","49248828","49249094","chr20","54357124","54357413","49","5108296"
"chr5","49844076","49844360","chr20","54849188","54849486","44","5005112"
"chr5","49956706","49956967","chr20","54961712","54961979","40","5005006"
"chr5","49964816","49965106","chr20","54968446","54968726","54","5003630"
"chr5","49972751","49972868","chr20","54977172","54977289","13","5004421"
"chr5","50066839","50067117","chr20","55060565","55060842","34","4993726"
"chr5","50072159","50072422","chr20","55065328","55065620","58","4993169"
"chr5","50096466","50096748","chr20","55086276","55086556","35","4989810"
"chr5","50151002","50151188","chr20","55140788","55140976","25","4989786"
"chr5","50202018","50202275","chr5","43599168","43599429","57","6602850"
"chr5","50216810","50217115","chr20","55203893","55204200","45","4987083"
"chr5","50230912","50231040","chr20","55217424","55217547","18","4986512"
"chr5","50259778","50260065","chr13","22161680","22161965","55","28098098"
"chr5","50306399","50306515","chr1","65862925","65863041","19","15556526"
"chr5","50353942","50354234","chr20","55342830","55343123","55","4988888"
"chr5","50364305","50364405","chr5","14549205","14549303","17","35815100"
"chr5","50374888","50375201","chr5","90521817","90522135","63","40146929"
"chr5","50376969","50377256","chr20","55363584","55363884","41","4986615"
"chr5","50379384","50379667","chr20","55366356","55366633","36","4986972"
"chr5","50418842","50419129","chr20","55414559","55414853","42","4995717"
"chr5","50419875","50420179","chr20","55415590","55415894","35","4995715"
"chr5","50470454","50470737","chr1","132826671","132826953","73","82356217"
"chr5","50475674","50475925","chr20","55473934","55474194","34","4998260"
"chr5","50476330","50476626","chr20","55474607","55474894","41","4998277"
"chr5","50480815","50480893","chr15","19199587","19199665","15","31281228"
"chr5","50533191","50533349","chr19","15955029","15955193","37","34578162"
"chr5","50549723","50550005","chr5","28169949","28170217","65","22379774"
"chr5","50573118","50573230","chr8","94116849","94116964","18","43543731"
"chr5","50581387","50581551","chr12","35974023","35974184","35","14607364"
"chr5","50597633","50597771","chr20","32123638","32123783","33","18473995"
"chr5","50598885","50599054","chrX","130137391","130137550","34","79538506"
"chr5","50603340","50603634","chr6","25216455","25216748","63","25386885"
"chr5","50612226","50612351","chr20","55612906","55613032","25","5000680"
"chr5","50644275","50644418","chr1","23727757","23727901","30","26916518"
"chr5","50652789","50653101","chr20","55659926","55660230","76","5007137"
"chr5","50745292","50745577","chr1","27471506","27471790","73","23273786"
"chr5","50783360","50783609","chr22","21331231","21331487","56","29452129"
"chr5","50810525","50810791","chr20","55824851","55825115","33","5014326"
"chr5","50852821","50852934","chr20","55865429","55865549","13","5012608"
"chr5","50870971","50871182","chr22","14051804","14052003","49","36819167"
"chr5","50927613","50927914","chr12","117093298","117093597","60","66165685"
"chr5","50958264","50958502","chr6","115933568","115933803","64","64975304"
"chr5","50975859","50976145","chr20","55950191","55950473","39","4974332"
"chr5","50978078","50978414","chr20","55952492","55952801","60","4974414"
"chr5","50994840","50995123","chr14","34476124","34476405","56","16518716"
"chr5","51189479","51189787","chr1","27406360","27406661","68","23783119"
"chr5","51315718","51315995","chr20","56297308","56297609","54","4981590"
"chr5","51356520","51356724","chr1","93419001","93419206","50","42062481"
"chr5","51427197","51427332","chr17","58292250","58292383","26","6865053"
"chr5","51438967","51439247","chr9","108837592","108837873","59","57398625"
"chr5","51464155","51464425","chr6","8027833","8028094","64","43436322"
"chr5","51477254","51477484","chrX","119761313","119761537","66","68284059"
"chr5","51478560","51478842","chr20","56446033","56446338","51","4967473"
"chr5","51489482","51489599","chr5","39168474","39168591","20","12321008"
"chr5","51491187","51491496","chr11","85632161","85632468","59","34140974"
"chr5","51503954","51504077","chr20","56468432","56468555","12","4964478"
"chr5","51598062","51598350","chr20","56528936","56529233","56","4930874"
"chr5","51617456","51617708","chr20","56545055","56545322","35","4927599"
"chr5","51717952","51718267","chr20","56678229","56678529","49","4960277"
"chr5","51769956","51770256","chr20","56734482","56734774","45","4964526"
"chr5","51870309","51870433","chr1","221816570","221816688","28","169946261"
"chr5","51876019","51876317","chr20","2655219","2655520","59","49220800"
"chr5","51910106","51910389","chr15","68953531","68953821","33","17043425"
"chr5","51911775","51912073","chr2B","108054243","108054532","62","56142468"
"chr5","51988376","51988681","chr20","56955624","56955928","42","4967248"
"chr5","52170460","52170547","chr22","25998378","25998459","13","26172082"
"chr5","52271519","52271762","chr20","57193892","57194128","24","4922373"
"chr5","52305412","52305722","chr20","57228354","57228655","61","4922942"
"chr5","52351308","52351586","chr20","57268195","57268494","42","4916887"
"chr5","52423684","52423794","chr14","74639249","74639368","24","22215565"
"chr5","52435911","52436213","chr3","48874992","48875286","60","3560919"
"chr5","52449250","52449541","chr4","120032257","120032551","58","67583007"
"chr5","52561889","52562188","chr10","118474409","118474715","73","65912520"
"chr5","52647818","52648100","chr20","57555965","57556242","46","4908147"
"chr5","52709573","52709852","chr20","57621603","57621882","34","4912030"
"chr5","52909252","52909295","chr8","122999955","123000000","7","70090703"
"chr5","52909461","52909576","chr1","40324226","40324341","31","12585235"
"chr5","52962917","52963194","chrX","118344462","118344754","67","65381545"
"chr5","52992718","52992849","chr20","57912731","57912855","13","4920013"
"chr5","53089333","53089639","chr20","729693","730003","50","52359640"
"chr5","53139628","53139923","chr12","659824","660128","62","52479804"
"chr5","53309709","53310002","chr20","58202823","58203088","62","4893114"
"chr5","53318990","53319270","chr20","58211297","58211598","43","4892307"
"chr5","53335170","53335459","chr5","134255900","134256190","60","80920730"
"chr5","53352462","53352672","chr7","78885397","78885606","57","25532935"
"chr5","53419051","53419339","chr4","39358060","39358354","59","14060991"
"chr5","53511697","53511992","chr16","62003329","62003604","74","8491632"
"chr5","53613407","53613700","chr20","58528021","58528309","44","4914614"
"chr5","53691693","53692007","chr20","58607348","58607659","47","4915655"
"chr5","53803891","53803966","chr16","25465080","25465156","17","28338811"
"chr5","53804086","53804318","chr20","58774115","58774354","33","4970029"
"chr5","53834587","53834886","chr20","58805203","58805504","52","4970616"
"chr5","53935358","53935643","chr20","58889524","58889816","44","4954166"
"chr5","54099799","54100040","chr1","40296659","40296899","68","13803140"
"chr5","54181280","54181375","chr10","117001518","117001614","11","62820238"
"chr5","54221409","54221574","chr1","24245703","24245864","41","29975706"
"chr5","54223275","54223578","chr11","14363039","14363335","70","39860236"
"chr5","54360252","54360412","chr1","205548459","205548612","34","151188207"
"chr5","54369734","54370035","chr20","59357449","59357747","33","4987715"
"chr5","54388450","54388690","chr6","4632745","4632979","77","49755705"
"chr5","54681412","54681713","chr20","59663867","59664173","38","4982455"
"chr5","54876424","54876574","chr22","8436942","8437088","30","46439482"
"chr5","55161023","55161176","chr20","60165914","60166069","12","5004891"
"chr5","55178817","55179076","chr20","60179331","60179591","26","5000514"
"chr5","55180064","55180351","chr20","60180609","60180889","56","5000545"
"chr5","55515497","55515651","chr21","27354717","27354867","26","28160780"
"chr5","55552324","55552618","chr20","60554153","60554448","51","5001829"
"chr5","55867439","55867669","chrX","48678555","48678774","48","7188884"
"chr5","55870791","55871054","chr20","60866305","60866593","59","4995514"
"chr5","56053390","56053692","chr20","61058556","61058857","47","5005166"
"chr5","56060384","56060642","chr20","61066581","61066849","35","5006197"
"chr5","56091399","56091680","chr7","19662593","19662877","58","36428806"
"chr5","56110576","56110697","chr2B","93880272","93880394","22","37769696"
"chr5","56110715","56111014","chr20","61118121","61118415","35","5007406"
"chr5","56133494","56133785","chr20","61136753","61137070","49","5003259"
"chr5","56182652","56182945","chr7","149672270","149672558","73","93489618"
"chr5","56193915","56194192","chrX","49065792","49066067","68","7128123"
"chr5","56206978","56207251","chr20","9960415","9960681","58","46246563"
"chr5","56207928","56208202","chr1","110457031","110457318","74","54249103"
"chr5","56286136","56286431","chr13","33980388","33980688","67","22305748"
"chr5","56306345","56306571","chr9","119026785","119027009","55","62720440"
"chr5","56309142","56309432","chr20","61309334","61309631","28","5000192"
"chr5","56779153","56779438","chr20","61699406","61699695","41","4920253"
"chr5","56866338","56866614","chr6","10742837","10743124","61","46123501"
"chr5","56888010","56888326","chr1","40331351","40331633","76","16556659"
"chr5","56911397","56911684","chr20","61862982","61863277","39","4951585"
"chr5","56918668","56918943","chr3","120656330","120656597","65","63737662"
"chr5","56927016","56927161","chr1","214795835","214795974","41","157868819"
"chr5","57049570","57049740","chr19","18112321","18112488","33","38937249"
"chr5","57150609","57150919","chr20","62098610","62098910","49","4948001"
"chr5","57244256","57244335","chr20","62217480","62217567","12","4973224"
"chr5","57257467","57257646","chr5","51144248","51144411","47","6113219"
"chr5","57310123","57310329","chr1","51823505","51823703","42","5486618"
"chr5","57444841","57445102","chr7","131081642","131081912","71","73636801"
"chr5","57521587","57521795","chr20","48240040","48240252","55","9281547"
"chr5","57549347","57549633","chr1","139015008","139015300","68","81465661"
"chr5","57551837","57552126","chr20","39682251","39682537","59","17869586"
"chr5","57579883","57580185","chr20","62536538","62536841","43","4956655"
"chr5","57601413","57601719","chr20","62551293","62551604","32","4949880"
"chr5","57611724","57612016","chr3","145246806","145247099","58","87635082"
"chr5","57618169","57618444","chr16","39996110","39996390","78","17622059"
"chr5","57621412","57621705","chr3","49741493","49741779","54","7879919"
"chr5","57719742","57720020","chr6","153473499","153473782","68","95753757"
"chr5","57790828","57791090","chr6","108833342","108833608","60","51042514"
"chr5","57820116","57820335","chr18","42945821","42946028","43","14874295"
"chr5","57869422","57869535","chr7","75603267","75603378","33","17733845"
"chr5","57917554","57917806","chr1","146199738","146199993","77","88282184"
"chr5","57920599","57920861","chr14","55203290","55203573","74","2717309"
"chr5","57935821","57936110","chr20","62875670","62875944","47","4939849"
"chr5","57936114","57936388","chr20","62875948","62876201","58","4939834"
"chr5","57950809","57951093","chr1","207597026","207597312","72","149646217"
"chr5","57962521","57962641","chr20","62902475","62902593","19","4939954"
"chr5","57981120","57981418","chr20","62921296","62921606","42","4940176"
"chr5","58019921","58020208","chr20","62955284","62955589","55","4935363"
"chr5","58031728","58032035","chr20","62963544","62963841","46","4931816"
"chr5","58034200","58034478","chr20","62965894","62966163","55","4931694"
"chr5","59217273","59217507","chr7","31487805","31488036","63","27729468"
"chr5","59225301","59225599","chr17","547848","548148","32","58677453"
"chr5","59226980","59227291","chr1","225726625","225726930","65","166499645"
"chr5","59242316","59242589","chr17","587220","587492","46","58655096"
"chr5","59244250","59244353","chr17","587948","588051","17","58656302"
"chr5","59258585","59258700","chr18","8665328","8665444","24","50593257"
"chr5","59325017","59325101","chr7","130630543","130630629","19","71305526"
"chr5","59342887","59343022","chr1","37936932","37937055","30","21405955"
"chr5","59346506","59346653","chr1","21535094","21535239","44","37811412"
"chr5","59364809","59365102","chr17","725378","725685","61","58639431"
"chr5","59378104","59378408","chr17","740556","740838","58","58637548"
"chr5","59379509","59379789","chr12","132037180","132037463","73","72657671"
"chr5","59389210","59389438","chr1","25188732","25188960","47","34200478"
"chr5","59418113","59418271","chr14","58580963","58581123","32","837150"
"chr5","59441789","59442082","chr17","805668","805968","49","58636121"
"chr5","59466941","59467099","chr5","62885644","62885808","35","3418703"
"chr5","59488865","59489125","chr5","122419080","122419338","56","62930215"
"chr5","59581493","59581617","chr10","39817913","39818037","16","19763580"
"chr5","59605302","59605484","chr1","183809138","183809317","37","124203836"
"chr5","59629397","59629701","chr3","153973125","153973429","66","94343728"
"chr5","59651145","59651244","chr6","132241886","132241982","20","72590741"
"chr5","59679212","59679504","chr1","190065982","190066274","64","130386770"
"chr5","59691313","59691617","chr17","1072665","1072976","49","58618648"
"chr5","59715704","59715987","chr1","38001876","38002160","58","21713828"
"chr5","59724207","59724324","chr16","30480444","30480558","25","29243763"
"chr5","59769266","59769331","chr7","30158546","30158613","13","29610720"
"chr5","59827379","59827444","chr12","122926009","122926074","15","63098630"
"chr5","59856243","59856547","chr5","58535887","58536180","45","1320356"
"chr5","59938093","59938275","chr3","49125413","49125584","49","10812680"
"chr5","59952768","59953017","chr5","58592101","58592373","49","1360667"
"chr5","59977435","59977551","chr5","58622159","58622275","11","1355276"
"chr5","59982475","59982750","chr5","58627545","58627827","41","1354930"
"chr5","60004202","60004403","chr8","18127927","18128121","46","41876275"
"chr5","60056935","60057250","chr1","17494226","17494540","63","42562709"
"chr5","60072976","60073185","chr4","95624847","95625053","64","35551871"
"chr5","60150844","60150975","chr5","58715713","58715847","17","1435131"
"chr5","60153462","60153765","chr5","58727911","58728216","58","1425551"
"chr5","60221274","60221552","chr5","58777516","58777797","36","1443758"
"chr5","60223088","60223404","chr5","140931146","140931451","73","80708058"
"chr5","60295781","60296104","chr5","61670294","61670604","52","1374513"
"chr5","60366842","60366990","chrX","101077801","101077950","48","40710959"
"chr5","60379053","60379333","chr17","1121786","1122053","79","59257267"
"chr5","60435007","60435295","chr1","42327988","42328270","67","18107019"
"chr5","60504730","60505019","chr17","2831475","2831766","30","57673255"
"chr5","60518902","60519191","chr17","2814977","2815281","49","57703925"
"chr5","60523383","60523517","chr7","56839310","56839440","35","3684073"
"chr5","60534670","60534991","chr6","108554829","108555115","85","48020159"
"chr5","60604088","60604374","chr12","125792473","125792778","52","65188385"
"chr5","60623491","60623681","chr1","224283143","224283338","51","163659652"
"chr5","60654011","60654309","chr17","2662753","2663059","47","57991258"
"chr5","60680588","60680720","chr19","42775979","42776122","32","17904609"
"chr5","60683052","60683309","chr1","113155393","113155644","60","52472341"
"chr5","60695930","60696066","chr11","69147152","69147272","35","8451222"
"chr5","60750712","60750986","chr4","152323211","152323483","59","91572499"
"chr5","60754598","60754880","chrX","23883527","23883783","91","36871071"
"chr5","60756682","60756812","chr20","5893261","5893384","29","54863421"
"chr5","60757520","60757635","chr22","8738209","8738323","17","52019311"
"chr5","60771808","60771941","chr6","18588428","18588554","36","42183380"
"chr5","60788089","60788211","chr17","2518554","2518677","14","58269535"
"chr5","60811227","60811478","chr17","2500501","2500780","67","58310726"
"chr5","60828689","60828851","chr13","45598608","45598771","39","15230081"
"chr5","60870425","60870729","chr4","4517769","4518079","60","56352656"
"chr5","60883379","60883691","chr17","2441929","2442229","69","58441450"
"chr5","60885802","60886062","chrX","118858247","118858511","67","57972445"
"chr5","60893293","60893585","chr17","2430082","2430352","59","58463211"
"chr5","60897838","60898148","chr17","2425231","2425525","49","58472607"
"chr5","60911449","60911549","chr1","40734262","40734366","26","20177187"
"chr5","60911594","60911749","chr12","133431348","133431497","41","72519754"
"chr5","60932540","60932771","chr17","2393926","2394151","36","58538614"
"chr5","60941344","60941477","chr10","30690604","30690743","35","30250740"
"chr5","60965997","60966288","chr19","18369475","18369764","45","42596522"
"chr5","61017907","61018105","chr10","27117159","27117365","50","33900748"
"chr5","61020688","61020975","chr17","2356362","2356661","49","58664326"
"chr5","61058886","61059190","chr17","2311077","2311369","59","58747809"
"chr5","61101671","61101956","chr17","2271492","2271764","48","58830179"
"chr5","61127235","61127507","chr17","2247946","2248236","59","58879289"
"chr5","61129875","61130171","chr17","2244632","2244941","49","58885243"
"chr5","61135634","61135942","chr1","67628734","67629046","72","6493100"
"chr5","61186550","61186837","chr17","2189223","2189511","55","58997327"
"chr5","61201511","61201798","chr17","2176376","2176658","51","59025135"
"chr5","61206630","61206745","chr22","12403993","12404107","21","48802637"
"chr5","61230819","61231092","chr12","130908435","130908724","72","69677616"
"chr5","61254888","61255191","chr17","2131175","2131482","34","59123713"
"chr5","61285056","61285365","chr19","12449605","12449905","91","48835451"
"chr5","61285654","61285940","chr18","53467271","53467550","69","7818383"
"chr5","61297447","61297609","chr11","128247655","128247811","33","66950208"
"chr5","61304007","61304291","chr9","16633553","16633838","74","44670454"
"chr5","61305758","61305865","chr7","76940267","76940373","29","15634509"
"chr5","61310849","61310966","chr17","2078747","2078872","19","59232102"
"chr5","61337055","61337350","chr17","2049405","2049703","53","59287650"
"chr5","61356232","61356339","chr5","101630294","101630409","26","40274062"
"chr5","61357330","61357584","chrX","156319225","156319483","59","94961895"
"chr5","61364016","61364296","chr17","2018648","2018944","61","59345368"
"chr5","61392014","61392310","chr11","66746404","66746706","66","5354390"
"chr5","61394769","61394898","chr20","55440556","55440688","21","5954213"
"chr5","61395511","61395703","chr22","8049643","8049841","64","53345868"
"chr5","61452772","61453065","chr16","31245203","31245503","69","30207569"
"chr5","61490679","61490985","chr17","1890343","1890609","61","59600336"
"chr5","61510184","61510470","chr17","1872468","1872765","43","59637716"
"chr5","61520002","61520200","chr12","119805659","119805848","44","58285657"
"chr5","61529366","61529623","chr17","9567584","9567855","57","51961782"
"chr5","61575751","61576038","chr17","1810538","1810827","35","59765213"
"chr5","61578258","61578508","chr7","56499332","56499582","61","5078926"
"chr5","61597266","61597555","chr5","56082283","56082594","58","5514983"
"chr5","61618361","61618570","chr20","31234853","31235062","50","30383508"
"chr5","61638288","61638590","chr17","1767342","1767659","60","59870946"
"chr5","61644325","61644590","chr15","68599034","68599299","65","6954709"
"chr5","61650628","61650920","chr1","43624160","43624442","63","18026468"
"chr5","61660799","61660941","chr19","10673878","10674020","30","50986921"
"chr5","61661571","61661718","chr6","113404762","113404894","39","51743191"
"chr5","61666547","61666688","chr5","36026785","36026917","48","25639762"
"chr5","61673580","61673700","chr3","65193379","65193500","18","3519799"
"chr5","61673799","61674048","chr7","99649664","99649920","67","37975865"
"chr5","61677793","61678028","chr17","1725728","1726000","63","59952065"
"chr5","61681852","61682005","chr8","81861913","81862062","38","20180061"
"chr5","61685346","61685653","chr17","1716602","1716906","59","59968744"
"chr5","61690823","61690966","chr1","68709407","68709549","45","7018584"
"chr5","61692978","61693271","chr2B","19160505","19160784","74","42532473"
"chr5","61705114","61705224","chr8","79737740","79737854","32","18032626"
"chr5","61710176","61710301","chr13","6354236","6354359","19","55355940"
"chr5","61710749","61710784","chr16","69212135","69212167","10","7501386"
"chr5","61711538","61711656","chrX","49113443","49113558","29","12598095"
"chr5","61723895","61724161","chr7","5188127","5188404","70","56535768"
"chr5","61731137","61731300","chr1","41590742","41590907","32","20140395"
"chr5","61827661","61827917","chrX","1328529","1328783","64","60499132"
"chr5","61869655","61869938","chr17","1532271","1532568","58","60337384"
"chr5","61895643","61895741","chr9","27513534","27513642","26","34382109"
"chr5","61900915","61901212","chr22","29846473","29846773","62","32054442"
"chr5","61918043","61918330","chr17","1488544","1488849","53","60429499"
"chr5","61932622","61932702","chr17","1475276","1475358","13","60457346"
"chr5","61932909","61932992","chr16","31510822","31510907","13","30422087"
"chr5","61946784","61947068","chr17","1458288","1458594","53","60488496"
"chr5","61958912","61959209","chr12","124703250","124703551","61","62744338"
"chr5","61974471","61974716","chr2B","124730977","124731204","59","62756506"
"chr5","61997982","61998080","chr7","139312749","139312844","22","77314767"
"chr5","62019273","62019505","chr17","1384229","1384448","34","60635044"
"chr5","62036960","62037117","chr1","52325310","52325464","40","9711650"
"chr5","62037647","62037759","chr4","153106200","153106312","25","91068553"
"chr5","62086527","62086664","chr12","110108425","110108564","37","48021898"
"chr5","62087073","62087375","chr16","59902738","59903038","68","2184335"
"chr5","62087396","62087705","chr3","80653505","80653799","73","18566109"
"chr5","62091901","62092011","chr1","68350841","68350951","22","6258940"
"chr5","62093783","62093884","chr8","74379973","74380073","23","12286190"
"chr5","62104630","62104921","chr17","1302254","1302563","52","60802376"
"chr5","62109270","62109425","chr16","76317400","76317554","27","14208130"
"chr5","62130159","62130259","chr12","53659504","53659590","31","8470655"
"chr5","62156607","62156702","chr6","36400779","36400869","23","25755828"
"chr5","62164129","62164285","chr10","110154408","110154563","30","47990279"
"chr5","62208622","62208923","chr5","60183554","60183832","54","2025068"
"chr5","62209615","62209923","chr5","60182502","60182813","46","2027113"
"chr5","62261838","62262144","chr19","23773871","23774163","43","38487967"
"chr5","62303122","62303212","chr17","3365096","3365175","14","58938026"
"chr5","62304310","62304528","chr17","3365897","3366111","28","58938413"
"chr5","62371976","62372244","chr4","4722727","4722993","61","57649249"
"chr5","62416058","62416367","chr5","120619493","120619807","54","58203435"
"chr5","62417066","62417334","chr17","3449042","3449349","69","58968024"
"chr5","62431440","62431527","chr7","75602882","75602972","23","13171442"
"chr5","62432415","62432605","chr19","2810406","2810614","58","59622009"
"chr5","62441351","62441428","chr1","206078640","206078718","16","143637289"
"chr5","62483955","62484262","chr17","3509342","3509652","37","58974613"
"chr5","62538116","62538398","chr11","120618542","120618826","61","58080426"
"chr5","62565792","62566091","chr17","3596482","3596775","52","58969310"
"chr5","62567703","62567998","chr17","3598981","3599270","57","58968722"
"chr5","62574723","62575023","chr11","71102330","71102629","66","8527607"
"chr5","62670188","62670480","chr12","121913892","121914192","56","59243704"
"chr5","62692728","62692815","chr4","196368015","196368103","20","133675287"
"chr5","62706138","62706436","chr17","3754039","3754325","47","58952099"
"chr5","62744698","62744829","chr3","15286672","15286801","27","47458026"
"chr5","62771117","62771383","chr17","3818868","3819165","61","58952249"
"chr5","62802095","62802414","chr1","45145246","45145545","94","17656849"
"chr5","62804888","62805169","chr17","3860082","3860382","52","58944806"
"chr5","62859589","62859844","chr2A","1849325","1849582","58","61010264"
"chr5","62862828","62862998","chr2B","64018039","64018225","44","1155211"
"chr5","62901466","62901795","chr17","3956570","3956901","53","58944896"
"chr5","62932004","62932305","chr17","3984520","3984828","50","58947484"
"chr5","62952218","62952510","chr17","4005511","4005816","58","58946707"
"chr5","62958907","62959180","chr17","4012223","4012513","55","58946684"
"chr5","62969148","62969378","chr10","27991011","27991233","52","34978137"
"chr5","63056608","63056912","chr17","4126833","4127144","52","58929775"
"chr5","63067718","63068021","chr1","24714709","24715017","68","38353009"
"chr5","63088535","63088838","chr16","57212544","57212846","74","5875991"
"chr5","63115069","63115359","chr17","4199729","4200018","45","58915340"
"chr5","63131074","63131378","chr5","22893248","22893546","62","40237826"
"chr5","63132314","63132475","chrX","44644068","44644228","32","18488246"
"chr5","63142764","63142941","chr8","86658869","86659045","39","23516105"
"chr5","63196406","63196588","chr1","43132989","43133179","53","20063417"
"chr5","63203164","63203449","chr16","1644503","1644782","68","61558661"
"chr5","63218305","63218591","chr12","901136","901435","57","62317169"
"chr5","63230477","63230644","chr7","45537514","45537680","30","17692963"
"chr5","63402054","63402333","chr9","50652481","50652754","62","12749573"
"chr5","63508666","63508962","chr1","227415933","227416230","52","163907267"
"chr5","63512578","63512787","chr9","113935755","113935963","45","50423177"
"chr5","63527986","63528286","chr14","87463561","87463857","62","23935575"
"chr5","63563731","63564023","chr2A","15263258","15263551","72","48300473"
"chr5","63566156","63566431","chr6","932036","932316","63","62634120"
"chr5","63698394","63698681","chr21","35935820","35936111","62","27762574"
"chr5","63700252","63700301","chr22","15995309","15995356","13","47704943"
"chr5","63700330","63700457","chr4","88581201","88581319","35","24880871"
"chr5","63756918","63757204","chr5","60353038","60353313","44","3403880"
"chr5","63791407","63791694","chr5","61784021","61784313","37","2007386"
"chr5","63806946","63807074","chr5","18672118","18672243","20","45134828"
"chr5","63836076","63836378","chr5","37922772","37923085","54","25913304"
"chr5","63837254","63837381","chr5","18353008","18353128","17","45484246"
"chr5","63837387","63837523","chr6","35062432","35062567","39","28774955"
"chr5","63839317","63839507","chr13","83493419","83493616","38","19654102"
"chr5","63842624","63842724","chr17","57665074","57665183","26","6177550"
"chr5","63850163","63850332","chr14","72724722","72724884","36","8874559"
"chr5","63889195","63889378","chr8","63354407","63354585","43","534788"
"chr5","63932510","63932671","chr2A","33677905","33678061","37","30254605"
"chr5","63946786","63947049","chr3","82989281","82989541","61","19042495"
"chr5","64027353","64027589","chr5","59427038","59427303","52","4600315"
"chr5","64115226","64115510","chr5","59521385","59521686","53","4593841"
"chr5","64127050","64127154","chr5","59533245","59533349","10","4593805"
"chr5","64157048","64157344","chr5","59559845","59560124","47","4597203"
"chr5","64183496","64183744","chr19","9600675","9600939","67","54582821"
"chr5","64200073","64200188","chr5","59652754","59652872","19","4547319"
"chr5","64207947","64208098","chr19","14430631","14430788","26","49777316"
"chr5","64218088","64218367","chr19","475704","475988","59","63742384"
"chr5","64244789","64244920","chr6","126525785","126525907","32","62280996"
"chr5","64248274","64248527","chr19","18682322","18682588","54","45565952"
"chr5","64265938","64266280","chr19","18695880","18696187","70","45570058"
"chr5","64267480","64267667","chr1","183809138","183809317","45","119541658"
"chr5","64268606","64268730","chr5","59701703","59701836","20","4566903"
"chr5","64270919","64271144","chr13","27176064","27176300","41","37094855"
"chr5","64279827","64280158","chr19","57827183","57827506","91","6452644"
"chr5","64395120","64395242","chr6","111603379","111603505","18","47208259"
"chr5","64395356","64395534","chr19","16879306","16879475","30","47516050"
"chr5","64445850","64446136","chr12","35323607","35323897","52","29122243"
"chr5","64459091","64459206","chr5","59925617","59925733","14","4533474"
"chr5","64474797","64475105","chr1","44729751","44730066","57","19745046"
"chr5","64479947","64480245","chr19","32383221","32383523","64","32096726"
"chr5","64484256","64484570","chr5","59949605","59949893","62","4534651"
"chr5","64502318","64502456","chr8","8495688","8495834","39","56006630"
"chr5","64520809","64520939","chr5","60377164","60377300","17","4143645"
"chr5","64520988","64521134","chr5","60376976","60377117","26","4144012"
"chr5","64577403","64577518","chr7","6379157","6379273","28","58198246"
"chr5","64593039","64593353","chr9","81539694","81539997","61","16946655"
"chr5","64599307","64599473","chr4","40325999","40326159","32","24273308"
"chr5","64612021","64612177","chr19","5169265","5169417","40","59442756"
"chr5","64618104","64618415","chr12","106833600","106833908","61","42215496"
"chr5","64660424","64660476","chr16","63676489","63676541","10","983935"
"chr5","64665474","64665592","chr12","36233289","36233412","24","28432185"
"chr5","64671910","64672137","chr5","60446879","60447107","22","4225031"
"chr5","64673539","64673639","chr5","60449433","60449535","25","4224106"
"chr5","64696952","64697046","chr1","17798378","17798465","16","46898574"
"chr5","64697055","64697277","chr5","60475101","60475323","46","4221954"
"chr5","64706709","64706984","chr1","25823440","25823728","61","38883269"
"chr5","64758231","64758364","chr17","18469601","18469733","27","46288630"
"chr5","64759054","64759216","chr6","15264957","15265121","40","49494097"
"chr5","64769095","64769228","chr1","27808249","27808381","16","36960846"
"chr5","64776258","64776405","chr3","121513710","121513864","38","56737452"
"chr5","64861845","64862126","chr5","60633303","60633602","58","4228542"
"chr5","64882122","64882402","chr7","127858132","127858420","70","62976010"
"chr5","64915048","64915365","chr5","60688890","60689209","38","4226158"
"chr5","64923053","64923367","chr5","60698047","60698364","30","4225006"
"chr5","64975306","64975403","chr7","101404390","101404484","14","36429084"
"chr5","64976580","64976660","chr12","122719017","122719091","15","57742437"
"chr5","65008906","65009043","chr8","103799790","103799921","37","38790884"
"chr5","65012131","65012425","chr1","63920430","63920726","68","1091701"
"chr5","65032133","65032418","chr19","55306712","55306993","62","9725421"
"chr5","65048026","65048157","chr7","41602766","41602897","19","23445260"
"chr5","65054287","65054563","chr1","205414460","205414739","63","140360173"
"chr5","65065208","65065515","chr5","60813353","60813657","39","4251855"
"chr5","65069367","65069648","chr5","60817294","60817582","43","4252073"
"chr5","65110622","65110888","chr5","60862750","60863030","36","4247872"
"chr5","65140925","65141203","chr5","60892212","60892497","51","4248713"
"chr5","65173365","65173518","chr22","21698794","21698953","32","43474571"
"chr5","65245074","65245290","chr11","9058809","9059037","48","56186265"
"chr5","65278911","65279079","chr10","51452969","51453135","40","13825942"
"chr5","65280958","65281102","chr22","20288134","20288276","36","44992824"
"chr5","65328756","65329061","chr5","61072044","61072316","65","4256712"
"chr5","65368172","65368444","chr1","189902282","189902563","65","124534110"
"chr5","65443751","65444029","chr6","160093445","160093719","60","94649694"
"chr5","65582652","65582966","chr5","61315186","61315497","51","4267466"
"chr5","65630330","65630609","chr5","61361286","61361549","46","4269044"
"chr5","65649862","65650152","chr5","61371911","61372199","26","4277951"
"chr5","65721757","65722045","chr5","56082283","56082594","60","9639474"
"chr5","65749824","65749879","chr2A","64805570","64805630","16","944254"
"chr5","65750514","65750744","chr15","71833207","71833432","66","6082693"
"chr5","65775246","65775512","chr5","58241649","58241947","55","7533597"
"chr5","65821089","65821197","chr18","48326419","48326520","20","17494670"
"chr5","65889808","65889933","chr1","13536774","13536900","18","52353034"
"chr5","65899062","65899219","chr7","79271528","79271684","29","13372466"
"chr5","65899390","65899691","chr9","95923564","95923862","67","30024174"
"chr5","65914921","65915224","chr5","60099912","60100194","52","5815009"
"chr5","65921697","65921976","chr5","63082325","63082592","72","2839372"
"chr5","65953610","65953749","chr10","30690604","30690743","39","35263006"
"chr5","66098250","66098370","chr17","15770371","15770492","16","50327879"
"chr5","66098387","66098461","chr6","108167255","108167324","16","42068868"
"chr5","66119873","66120149","chr10","38048647","38048923","74","28071226"
"chr5","66260379","66260668","chr7","33543454","33543737","69","32716925"
"chr5","66274896","66275154","chr17","15598017","15598277","32","50676879"
"chr5","66293039","66293337","chr5","141756685","141756995","67","75463646"
"chr5","66362659","66362965","chr17","15510354","15510664","37","50852305"
"chr5","66379073","66379383","chr1","16923214","16923522","70","49455859"
"chr5","66541891","66542141","chr17","15319477","15319728","27","51222414"
"chr5","66556173","66556287","chr1","143921175","143921289","19","77365002"
"chr5","66649849","66650165","chr17","15200717","15201027","85","51449132"
"chr5","66857818","66857922","chr17","14991775","14991894","27","51866043"
"chr5","67130572","67130880","chr10","148073945","148074251","65","80943373"
"chr5","67212770","67212909","chr8","103799790","103799921","49","36587020"
"chr5","67224814","67225001","chr17","14602351","14602553","33","52622463"
"chr5","67343747","67344004","chr17","14441303","14441563","26","52902444"
"chr5","67346514","67346732","chr17","14438707","14438903","45","52907807"
"chr5","67376427","67376717","chr5","63144105","63144407","44","4232322"
"chr5","67377904","67378017","chr3","101163134","101163245","22","33785230"
"chr5","67444714","67445016","chr17","14333014","14333282","55","53111700"
"chr5","67470658","67470917","chr9","75566020","75566287","65","8095362"
"chr5","67511439","67511556","chr1","24167961","24168077","24","43343478"
"chr5","67517543","67517664","chr5","18160572","18160673","33","49356971"
"chr5","67569082","67569174","chr5","14822723","14822826","24","52746359"
"chr5","67569331","67569543","chr10","60317961","60318169","48","7251370"
"chr5","67652099","67652223","chr8","35161554","35161678","27","32490545"
"chr5","67652237","67652511","chr17","14121927","14122200","32","53530310"
"chr5","67654876","67655186","chr17","14119257","14119566","33","53535619"
"chr5","67664596","67664888","chr17","14109055","14109341","47","53555541"
"chr5","67734854","67735135","chr17","14029038","14029332","42","53705816"
"chr5","67801266","67801546","chr8","78039663","78039946","79","10238397"
"chr5","67996881","67997100","chr3","199868108","199868321","55","131871227"
"chr5","68225417","68225648","chr17","13581433","13581676","58","54643984"
"chr5","68341411","68341530","chr1","43481788","43481912","24","24859623"
"chr5","68360887","68361157","chr15","35447472","35447736","62","32913415"
"chr5","68420646","68420939","chr17","13385105","13385381","44","55035541"
"chr5","68447664","68447963","chr17","13359584","13359893","50","55088080"
"chr5","68454549","68454895","chr17","13339052","13339381","48","55115497"
"chr5","68508557","68508869","chr7","111157872","111158182","37","42649315"
"chr5","68534929","68535216","chr17","13262585","13262894","55","55272344"
"chr5","68564805","68565087","chr17","13230732","13231032","42","55334073"
"chr5","68586313","68586445","chr7","107774197","107774327","22","39187884"
"chr5","68728001","68728305","chr10","177681","177978","67","68550320"
"chr5","68735031","68735318","chr7","28366007","28366296","58","40369024"
"chr5","68752303","68752583","chr17","13045832","13046119","38","55706471"
"chr5","68760251","68760324","chr17","13038325","13038397","8","55721926"
"chr5","69001048","69001301","chr17","12802369","12802669","75","56198679"
"chr5","69179983","69180264","chr17","12638087","12638377","41","56541896"
"chr5","69229575","69229733","chr10","49585047","49585201","30","19644528"
"chr5","69309587","69309894","chrX","2400919","2401224","62","66908668"
"chr5","69371403","69371636","chr3","48834902","48835146","55","20536501"
"chr5","69437496","69437678","chr17","12392644","12392822","33","57044852"
"chr5","69478437","69478622","chr1","94264909","94265078","59","24786472"
"chr5","69491596","69491890","chr7","77009635","77009928","60","7518039"
"chr5","69491916","69492179","chr16","5326490","5326760","65","64165426"
"chr5","69516436","69516725","chr17","12322185","12322469","49","57194251"
"chr5","69559533","69559812","chr7","6444168","6444444","68","63115365"
"chr5","69583235","69583552","chr19","16097748","16098055","71","53485487"
"chr5","69621111","69621396","chr17","12208493","12208734","68","57412618"
"chr5","69652177","69652458","chr17","12177826","12178097","55","57474351"
"chr5","69668752","69669046","chr20","43157775","43158073","62","26510977"
"chr5","69746160","69746289","chr1","14879011","14879148","23","54867149"
"chr5","69792256","69792519","chr17","12037021","12037306","47","57755235"
"chr5","70053498","70053825","chr17","11827787","11828053","86","58225711"
"chr5","70068225","70068357","chr10","12650705","12650831","37","57417520"
"chr5","70104011","70104335","chr7","28488397","28488687","89","41615614"
"chr5","70157559","70157848","chr17","11727154","11727446","45","58430405"
"chr5","70237203","70237497","chr5","47561263","47561551","66","22675940"
"chr5","70275725","70275981","chr17","11612560","11612828","40","58663165"
"chr5","70283285","70283534","chr17","11604967","11605208","33","58678318"
"chr5","70312094","70312319","chr17","11580649","11580889","41","58731445"
"chr5","70318936","70319225","chr17","11572326","11572616","39","58746610"
"chr5","70336236","70336467","chr1","217294594","217294821","50","146958358"
"chr5","70400215","70400498","chr17","11490190","11490476","30","58910025"
"chr5","70572546","70572835","chr17","11325380","11325661","59","59247166"
"chr5","70697688","70697797","chr19","15219953","15220058","29","55477735"
"chr5","70698218","70698305","chr11","119917854","119917943","19","49219636"
"chr5","70950668","70950886","chr19","7520693","7520910","42","63429975"
"chr5","71021151","71021238","chr18","19456448","19456534","23","51564703"
"chr5","71051996","71052309","chr17","10831646","10831939","56","60220350"
"chr5","71054314","71054447","chr7","26316442","26316573","29","44737872"
"chr5","71129943","71130219","chr17","10758373","10758651","55","60371570"
"chr5","71207278","71207421","chr22","8436942","8437088","27","62770336"
"chr5","71209895","71209994","chr17","10674327","10674425","14","60535568"
"chr5","71264447","71264659","chr17","10615081","10615295","27","60649366"
"chr5","71376006","71376127","chr17","10502485","10502605","14","60873521"
"chr5","71480462","71480592","chr6","4543390","4543521","22","66937072"
"chr5","71481131","71481395","chr7","2959934","2960208","59","68521197"
"chr5","71497737","71497886","chr5","19551528","19551681","37","51946209"
"chr5","71536596","71536723","chr2B","96079060","96079187","29","24542464"
"chr5","71545518","71545628","chr6","140754653","140754765","18","69209135"
"chr5","71552153","71552433","chr14","47464441","47464716","49","24087712"
"chr5","71597652","71597939","chr7","4970487","4970775","56","66627165"
"chr5","71600414","71600729","chr17","10271967","10272302","52","61328447"
"chr5","71630432","71630555","chr16","33997666","33997792","29","37632766"
"chr5","71659362","71659489","chr19","14415022","14415148","19","57244340"
"chr5","71659490","71659635","chr22","24265326","24265459","40","47394164"
"chr5","71688320","71688618","chr17","10186394","10186692","39","61501926"
"chr5","71750297","71750576","chr17","10132668","10132958","46","61617629"
"chr5","71761538","71761725","chr6","32732275","32732450","41","39029263"
"chr5","71791901","71792195","chr4","93804248","93804518","77","22012347"
"chr5","71795402","71795516","chr9","13555565","13555673","17","58239837"
"chr5","71798345","71798651","chr17","10079044","10079339","43","61719301"
"chr5","71804384","71804548","chr12","19312537","19312701","27","52491847"
"chr5","71813413","71813716","chr17","14551369","14551668","92","57262044"
"chr5","71860131","71860280","chr18","65251585","65251732","41","6608546"
"chr5","71890347","71890658","chr17","9984236","9984547","37","61906111"
"chr5","71904229","71904554","chr18","47474806","47475107","76","24429423"
"chr5","71936857","71937100","chr17","9945424","9945695","58","61991433"
"chr5","71958699","71958996","chr5","63163254","63163546","60","8795445"
"chr5","71963530","71963639","chr12","1702","1809","19","71961828"
"chr5","71988915","71989027","chr17","9894160","9894272","11","62094755"
"chr5","71991323","71991533","chr13","7976473","7976675","49","64014850"
"chr5","72119577","72119863","chr15","28698469","28698760","60","43421108"
"chr5","72132138","72132436","chr17","9731302","9731602","29","62400836"
"chr5","72169981","72170071","chr20","37828381","37828471","9","34341600"
"chr5","72209658","72209867","chr20","48240040","48240252","64","23969618"
"chr5","72210079","72210323","chr14","34026704","34026939","74","38183375"
"chr5","72213175","72213474","chr17","9660229","9660534","43","62552946"
"chr5","72312486","72312757","chr5","20142932","20143200","63","52169554"
"chr5","72322753","72323055","chr1","7654423","7654722","66","64668330"
"chr5","72328802","72329046","chrX","15698086","15698335","62","56630716"
"chr5","72362767","72363051","chr17","9490939","9491214","37","62871828"
"chr5","72373505","72373626","chr17","9480187","9480304","20","62893318"
"chr5","72401232","72401451","chr12","95889570","95889785","57","23488338"
"chr5","72442071","72442375","chr3","39266897","39267198","67","33175174"
"chr5","72464611","72464910","chr7","26770554","26770850","82","45694057"
"chr5","72503132","72503206","chr4","182685766","182685841","14","110182634"
"chr5","72503381","72503533","chr1","52325310","52325464","40","20178071"
"chr5","72558255","72558456","chr13","62529676","62529881","41","10028579"
"chr5","72624138","72624432","chr1","28436567","28436854","65","44187571"
"chr5","72677271","72677487","chr13","1415086","1415297","37","71262185"
"chr5","72683031","72683263","chr7","64790817","64791051","60","7892214"
"chr5","72700234","72700520","chr17","9154503","9154805","52","63545731"
"chr5","72802168","72802431","chr17","9053954","9054244","47","63748214"
"chr5","72833568","72833876","chr17","9026162","9026451","42","63807406"
"chr5","72844736","72844864","chr8","110146039","110146162","33","37301303"
"chr5","72865663","72865960","chr7","28366007","28366296","49","44499656"
"chr5","72970634","72970918","chr17","8885897","8886195","49","64084737"
"chr5","72973816","72973992","chr3","129419871","129420045","31","56446055"
"chr5","73002231","73002508","chr17","8885897","8886195","51","64116334"
"chr5","73005374","73005547","chr2B","95198022","95198192","30","22192648"
"chr5","73069316","73069568","chr17","8830690","8830936","34","64238626"
"chr5","73088373","73088645","chr17","8798410","8798694","48","64289963"
"chr5","73096717","73096825","chr3","187504297","187504409","22","114407580"
"chr5","73160802","73161087","chr16","40803572","40803860","65","32357230"
"chr5","73189850","73190156","chr17","8697307","8697620","46","64492543"
"chr5","73315378","73315674","chr17","8571765","8572063","29","64743613"
"chr5","73346276","73346431","chr20","35484460","35484610","31","37861816"
"chr5","73346532","73346657","chr7","26158438","26158564","35","47188094"
"chr5","73368415","73368538","chr6","138352473","138352596","20","64984058"
"chr5","73401013","73401318","chr7","74464150","74464456","67","1063137"
"chr5","73425846","73426125","chr17","8456480","8456783","66","64969366"
"chr5","73467712","73468046","chr17","8419743","8420034","91","65047969"
"chr5","73480961","73481185","chrX","120473041","120473260","44","46992080"
"chr5","73501958","73502096","chr7","65535529","65535666","32","7966429"
"chr5","73503524","73503705","chr8","63354407","63354585","42","10149117"
"chr5","73504008","73504025","chr7","2388110","2388128","4","71115898"
"chr5","73504624","73504728","chr9","30363368","30363466","27","43141256"
"chr5","73517620","73517901","chr1","149989664","149989950","52","76472044"
"chr5","73537167","73537413","chr17","8343802","8344047","28","65193365"
"chr5","73540541","73540655","chr19","38752105","38752219","14","34788436"
"chr5","73549464","73549766","chr15","35707005","35707306","69","37842459"
"chr5","73572357","73572469","chr13","9559854","9559959","34","64012503"
"chr5","73587987","73588114","chr5","133578375","133578499","29","59990388"
"chr5","73607654","73607783","chr7","74790659","74790791","23","1183005"
"chr5","73608328","73608474","chr7","76986698","76986853","42","3378370"
"chr5","73666147","73666262","chr6","25338724","25338835","31","48327423"
"chr5","73671299","73671464","chr14","12358649","12358814","28","61312650"
"chr5","73673089","73673272","chr19","6085105","6085297","53","67587984"
"chr5","73674395","73674544","chr6","35713634","35713766","37","37960761"
"chr5","73706910","73707203","chr7","69538149","69538439","64","4168761"
"chr5","73735972","73736111","chr1","155333181","155333312","30","81597209"
"chr5","73856923","73857002","chr13","78290388","78290468","24","4433465"
"chr5","73857015","73857250","chr5","15770073","15770297","60","58086942"
"chr5","73861679","73861849","chr19","11025315","11025473","45","62836364"
"chr5","73865888","73865998","chr6","15334694","15334803","23","58531194"
"chr5","73872035","73872335","chr16","57212544","57212846","55","16659491"
"chr5","73888232","73888484","chr6","36932206","36932446","58","36956026"
"chr5","73889002","73889165","chr3","59350634","59350793","30","14538368"
"chr5","73976597","73976855","chr17","7888015","7888253","44","66088582"
"chr5","74011410","74011544","chr17","7843206","7843338","14","66168204"
"chr5","74043989","74044157","chr17","7803351","7803520","26","66240638"
"chr5","74157285","74157587","chr17","7703617","7703917","47","66453668"
"chr5","74159760","74160015","chr1","116375549","116375802","75","42215789"
"chr5","74161643","74161904","chr19","8344980","8345231","73","65816663"
"chr5","74165126","74165344","chrX","120473041","120473260","51","46307915"
"chr5","74191118","74191236","chr2A","20700217","20700335","37","53490901"
"chr5","74191669","74191764","chr5","22128933","22129035","15","52062736"
"chr5","74192402","74192482","chr19","38789641","38789716","23","35402761"
"chr5","74205788","74206086","chr17","7652110","7652413","35","66553678"
"chr5","74220189","74220340","chr7","73203527","73203668","36","1016662"
"chr5","74229176","74229397","chr1","132570842","132571055","53","58341666"
"chr5","74248751","74248978","chr7","2262341","2262558","55","71986410"
"chr5","74302968","74303272","chr17","7567861","7568169","39","66735107"
"chr5","74311514","74311822","chr10","118530035","118530339","59","44218521"
"chr5","74370067","74370196","chr17","7511003","7511129","22","66859064"
"chr5","74398338","74398432","chr17","7486089","7486187","15","66912249"
"chr5","74506481","74506647","chr17","7382855","7383031","24","67123626"
"chr5","74508173","74508295","chr17","7380354","7380475","12","67127819"
"chr5","74524281","74524565","chr17","7358264","7358564","42","67166017"
"chr5","74529594","74529881","chr17","7354135","7354431","41","67175459"
"chr5","74567646","74567958","chr17","7320102","7320423","61","67247544"
"chr5","74661200","74661275","chr10","90697834","90697910","13","16036634"
"chr5","74727290","74727442","chr22","15473787","15473944","35","59253503"
"chr5","74758714","74759019","chr7","78818816","78819119","63","4060102"
"chr5","74765017","74765145","chr1","43133490","43133625","21","31631527"
"chr5","74773162","74773316","chr18","5568484","5568639","39","69204678"
"chr5","74775783","74775948","chr7","79657650","79657818","37","4881867"
"chr5","74790156","74790212","chr12","107948364","107948415","17","33158208"
"chr5","74790817","74791075","chr7","23561622","23561854","86","51229195"
"chr5","74800292","74800587","chr19","7368404","7368703","64","67431888"
"chr5","74816539","74816820","chr5","34269216","34269495","63","40547323"
"chr5","74831981","74832268","chr10","14090497","14090769","70","60741484"
"chr5","74908195","74908285","chr14","87559113","87559202","17","12650918"
"chr5","75048715","75048804","chr8","75019141","75019232","17","29574"
"chr5","75049542","75049836","chr5","40792070","40792366","33","34257472"
"chr5","75050564","75050732","chr5","40791479","40791645","33","34259085"
"chr5","75069893","75070172","chr5","40771242","40771534","40","34298651"
"chr5","75070224","75070568","chr5","55712801","55713151","86","19357423"
"chr5","75071261","75071558","chr5","40769893","40770169","51","34301368"
"chr5","75080090","75080226","chr5","40759977","40760113","9","34320113"
"chr5","75082686","75082959","chr18","49541745","49542022","73","25540941"
"chr5","75083760","75083877","chr5","40756154","40756272","11","34327606"
"chr5","75088664","75088961","chr12","130860160","130860451","58","55771496"
"chr5","75100066","75100230","chr19","8427489","8427639","39","66672577"
"chr5","75116904","75117038","chr5","5739650","5739782","23","69377254"
"chr5","75141614","75141731","chr8","108964883","108965000","22","33823269"
"chr5","75151142","75151259","chr6","42493620","42493736","24","32657522"
"chr5","75179808","75180083","chr19","31932599","31932876","61","43247209"
"chr5","75180286","75180461","chr6","20772870","20773042","40","54407416"
"chr5","75181326","75181632","chr5","40663644","40663937","51","34517682"
"chr5","75190640","75190753","chr7","77000001","77000126","33","1809361"
"chr5","75191286","75191340","chr12","34059510","34059561","15","41131776"
"chr5","75195236","75195546","chr10","118530035","118530339","65","43334799"
"chr5","75215367","75215665","chr5","40629845","40630146","39","34585522"
"chr5","75217790","75218051","chr5","40628507","40628773","30","34589283"
"chr5","75223174","75223341","chrX","20106460","20106625","34","55116714"
"chr5","75223659","75223782","chr16","61134750","61134872","22","14088909"
"chr5","75230447","75230624","chr11","47724944","47725127","47","27505503"
"chr5","75238233","75238522","chr5","40610018","40610310","34","34628215"
"chr5","75251455","75251727","chr1","6833510","6833782","56","68417945"
"chr5","75332340","75332502","chr5","118399435","118399596","39","43067095"
"chr5","75346678","75346760","chr19","18194834","18194910","21","57151844"
"chr5","75346942","75347032","chr7","78781782","78781873","17","3434840"
"chr5","75375162","75375278","chrX","9347869","9347986","22","66027293"
"chr5","75381639","75381951","chr7","76204158","76204462","62","822519"
"chr5","75384480","75384794","chr1","94654128","94654439","56","19269648"
"chr5","75389846","75390004","chr8","81861913","81862062","35","6472067"
"chr5","75393423","75393740","chr9","115046558","115046863","52","39653135"
"chr5","75419382","75419508","chr19","830497","830626","38","74588885"
"chr5","75423479","75423731","chr5","40423226","40423496","41","35000253"
"chr5","75424466","75424757","chr5","40422199","40422496","37","35002267"
"chr5","75429862","75430146","chr9","35752711","35753015","69","39677151"
"chr5","75496251","75496308","chr1","127641618","127641669","17","52145367"
"chr5","75506536","75506699","chr5","2493450","2493615","36","73013086"
"chr5","75506769","75506899","chr1","15633612","15633739","35","59873157"
"chr5","75513477","75513651","chr5","49653517","49653681","36","25859960"
"chr5","75530301","75530588","chr5","40337239","40337537","49","35193062"
"chr5","75538655","75538961","chr5","40320225","40320527","65","35218430"
"chr5","75543746","75544026","chr14","72146188","72146466","56","3397558"
"chr5","75552497","75552589","chr2A","63084317","63084409","11","12468180"
"chr5","75552620","75552726","chr3","65778113","65778219","17","9774507"
"chr5","75589466","75589748","chr5","40271267","40271541","43","35318199"
"chr5","75591473","75591595","chr5","40269400","40269519","14","35322073"
"chr5","75593397","75593643","chr1","86262467","86262717","73","10669070"
"chr5","75598039","75598109","chr7","33146356","33146429","16","42451683"
"chr5","75612996","75613064","chr3","126872406","126872470","15","51259410"
"chr5","75619539","75619573","chr5","47339685","47339718","9","28279854"
"chr5","75619574","75619688","chr5","38237509","38237614","36","37382065"
"chr5","75620006","75620119","chr9","43552815","43552934","27","32067191"
"chr5","75620230","75620391","chr7","75038690","75038858","44","581540"
"chr5","75629944","75630243","chr5","40177674","40177974","30","35452270"
"chr5","75637895","75638206","chr12","37420169","37420466","68","38217726"
"chr5","75661818","75662078","chr5","40143673","40143941","30","35518145"
"chr5","75739854","75739985","chr1","45612630","45612758","22","30127224"
"chr5","75748956","75749117","chr12","8768282","8768448","27","66980674"
"chr5","75751784","75751945","chr12","8768282","8768448","27","66983502"
"chr5","75772075","75772276","chr20","36084199","36084404","50","39687876"
"chr5","75780824","75780945","chr11","113559705","113559828","20","37778881"
"chr5","75787612","75787922","chr11","65224812","65225117","66","10562800"
"chr5","75805327","75805617","chr16","49117823","49118116","61","26687504"
"chr5","75827571","75827737","chr17","9391102","9391269","39","66436469"
"chr5","75841495","75841815","chr19","53310705","53311010","62","22530790"
"chr5","75852283","75852574","chr5","39970242","39970539","48","35882041"
"chr5","75856785","75856902","chr4","39880797","39880914","17","35975988"
"chr5","75858695","75858848","chr5","51144248","51144411","34","24714447"
"chr5","75861766","75862025","chr5","39961684","39961962","49","35900082"
"chr5","75892908","75893208","chr1","65527838","65528144","61","10365070"
"chr5","75907175","75907460","chrX","154341818","154342097","64","78434643"
"chr5","75921068","75921303","chr19","49388334","49388576","59","26532734"
"chr5","75943433","75943559","chr5","39884938","39885058","14","36058495"
"chr5","75945432","75945725","chr9","87487055","87487349","55","11541623"
"chr5","75959519","75959819","chr5","39868503","39868808","38","36091016"
"chr5","75988463","75988585","chr2B","44606898","44607016","41","31381565"
"chr5","76018836","76018953","chr8","24356751","24356868","15","51662085"
"chr5","76033294","76033409","chr5","39787082","39787199","10","36246212"
"chr5","76049231","76049517","chr5","39769994","39770281","50","36279237"
"chr5","76057004","76057168","chr19","5016889","5017050","29","71040115"
"chr5","76069398","76069705","chr1","214649168","214649473","59","138579770"
"chr5","76070516","76070784","chr5","8734711","8734988","65","67335805"
"chr5","76074672","76074967","chr5","39750072","39750365","27","36324600"
"chr5","76182487","76182779","chr5","39640948","39641246","41","36541539"
"chr5","76182780","76182912","chr1","132573702","132573836","16","56390922"
"chr5","76190591","76190859","chr5","39633303","39633564","43","36557288"
"chr5","76202341","76202504","chr4","164659189","164659349","39","88456848"
"chr5","76219977","76220270","chr5","39601167","39601469","41","36618810"
"chr5","76309269","76309569","chr5","55238842","55239151","45","21070427"
"chr5","76338695","76338999","chr12","54439061","54439357","66","21899634"
"chr5","76349514","76349810","chr5","39476352","39476637","46","36873162"
"chr5","76355039","76355175","chr14","52842638","52842775","35","23512401"
"chr5","76357155","76357449","chrX","24247165","24247455","65","52109990"
"chr5","76409652","76409805","chrX","71299329","71299487","34","5110323"
"chr5","76412559","76412731","chr12","29590412","29590582","40","46822147"
"chr5","76418540","76418857","chr8","101118910","101119212","71","24700370"
"chr5","76474318","76474597","chr5","39339354","39339647","44","37134964"
"chr5","76523897","76524185","chr5","39291701","39292002","58","37232196"
"chr5","76529076","76529387","chr8","77710539","77710841","62","1181463"
"chr5","76547603","76547720","chr4","110133393","110133510","17","33585790"
"chr5","76583389","76583677","chr5","39235273","39235573","33","37348116"
"chr5","76617359","76617522","chr3","46313817","46313973","36","30303542"
"chr5","76639311","76639462","chr4","81668278","81668434","38","5028967"
"chr5","76648090","76648366","chr5","39170650","39170952","57","37477440"
"chr5","76660169","76660438","chr5","39153890","39154159","29","37506279"
"chr5","76662786","76662915","chr19","35545060","35545187","19","41117726"
"chr5","76771141","76771427","chr5","39048389","39048684","52","37722752"
"chr5","76797607","76797943","chr5","39021430","39021769","46","37776177"
"chr5","76799856","76800170","chr5","39018753","39019065","41","37781103"
"chr5","76810034","76810285","chr5","39008289","39008521","62","37801745"
"chr5","76811221","76811438","chr5","39007108","39007334","36","37804113"
"chr5","76816416","76816709","chr1","227415933","227416230","60","150599517"
"chr5","76834253","76834456","chr5","38993164","38993377","42","37841089"
"chr5","76845285","76845578","chr5","38980208","38980516","57","37865077"
"chr5","76852810","76852987","chr1","184720130","184720300","35","107867320"
"chr5","76859045","76859148","chr6","15156813","15156907","25","61702232"
"chr5","76860654","76860974","chr5","38963041","38963361","41","37897613"
"chr5","76863340","76863645","chr5","38955726","38956029","65","37907614"
"chr5","76891963","76892155","chr16","45207099","45207296","40","31684864"
"chr5","76894664","76894786","chr7","77000001","77000126","30","105337"
"chr5","76894809","76894933","chr5","18353008","18353128","14","58541801"
"chr5","76895689","76895993","chr5","37922772","37923085","59","38972917"
"chr5","76897557","76897678","chr5","36445327","36445446","24","40452230"
"chr5","76941182","76941461","chr3","17438033","17438313","65","59503149"
"chr5","76945044","76945295","chr20","46167056","46167295","78","30777988"
"chr5","76961435","76961708","chr5","38886815","38887110","54","38074620"
"chr5","76963884","76963997","chr3","45215966","45216083","14","31747918"
"chr5","76964516","76964806","chr5","38883136","38883427","33","38081380"
"chr5","76994838","76994953","chr5","38846535","38846652","9","38148303"
"chr5","76997419","76997506","chr7","74299604","74299688","22","2697815"
"chr5","77015959","77016235","chr5","61670294","61670604","67","15345665"
"chr5","77055572","77055711","chrX","71151088","71151230","35","5904484"
"chr5","77080379","77080680","chr7","56830178","56830472","58","20250201"
"chr5","77095800","77095934","chr1","27808249","27808381","21","49287551"
"chr5","77098977","77099294","chr5","59121600","59121939","44","17977377"
"chr5","77106589","77106682","chr6","29524830","29524924","18","47581759"
"chr5","77106804","77107003","chr12","130520815","130521010","42","53414011"
"chr5","77110431","77110723","chrX","41457234","41457532","56","35653197"
"chr5","77139857","77140111","chr5","59070836","59071126","67","18069021"
"chr5","77141810","77142104","chr5","59068761","59069065","43","18073049"
"chr5","77146037","77146348","chr5","59063259","59063570","37","18082778"
"chr5","77155878","77156137","chr5","59053365","59053644","39","18102513"
"chr5","77158453","77158705","chr5","59051466","59051720","35","18106987"
"chr5","77257727","77258023","chr5","58973862","58974160","34","18283865"
"chr5","77262304","77262438","chr16","60089728","60089858","24","17172576"
"chr5","77262495","77262639","chr12","110108425","110108564","37","32845930"
"chr5","77303152","77303442","chr5","58928884","58929178","31","18374268"
"chr5","77313579","77313700","chr19","40722922","40723044","17","36590657"
"chr5","77324008","77324211","chr9","111554287","111554482","50","34230279"
"chr5","77342569","77342859","chr5","58886834","58887130","33","18455735"
"chr5","77352529","77352647","chr19","33408831","33408938","32","43943698"
"chr5","77359456","77359510","chr1","36213130","36213186","16","41146326"
"chr5","77359836","77360061","chr2B","82558297","82558517","63","5198461"
"chr5","77419198","77419463","chr5","58816056","58816314","37","18603142"
"chr5","77428794","77429097","chr5","56082283","56082594","44","21346511"
"chr5","77432282","77432564","chr3","195430335","195430615","26","117998053"
"chr5","77432595","77432718","chr7","64710974","64711099","11","12721621"
"chr5","77463219","77463503","chr1","21948678","21948958","73","55514541"
"chr5","77471219","77471316","chr19","37923532","37923635","27","39547687"
"chr5","77471343","77471414","chr7","65299486","65299557","13","12171857"
"chr5","77506745","77506981","chr6","146361614","146361839","56","68854869"
"chr5","77579053","77579373","chr5","62151734","62152027","68","15427319"
"chr5","77579641","77579942","chr4","1661200","1661494","62","75918441"
"chr5","77603593","77603715","chr5","62181964","62182088","13","15421629"
"chr5","77604248","77604528","chr5","62182665","62182961","47","15421583"
"chr5","77610683","77610952","chr5","62188596","62188891","59","15422087"
"chr5","77749872","77750159","chr11","60927984","60928261","66","16821888"
"chr5","77790037","77790329","chr5","62355546","62355840","25","15434491"
"chr5","77800327","77800502","chr7","82971379","82971551","46","5171052"
"chr5","77825451","77825580","chr6","18588428","18588554","27","59237023"
"chr5","77831627","77831926","chr5","62394153","62394464","73","15437474"
"chr5","77860817","77861106","chr2A","20806321","20806621","54","57054496"
"chr5","77862528","77862652","chr10","90957398","90957520","11","13094870"
"chr5","77881954","77882070","chrX","111886886","111887003","16","34004932"
"chr5","77894507","77894585","chr1","224255650","224255731","13","146361143"
"chr5","77902161","77902288","chr5","62467453","62467573","22","15434708"
"chr5","77918799","77918928","chr10","88595136","88595266","31","10676337"
"chr5","77927397","77927671","chr5","62489084","62489368","53","15438313"
"chr5","77959743","77960026","chr12","131165372","131165653","53","53205629"
"chr5","77960045","77960164","chr5","133242958","133243077","27","55282913"
"chr5","77984659","77984960","chr7","74884092","74884395","70","3100567"
"chr5","77995608","77995901","chr5","62569250","62569551","38","15426358"
"chr5","78069838","78070029","chrX","81449532","81449713","47","3379694"
"chr5","78070482","78070781","chr5","62650493","62650791","35","15419989"
"chr5","78091916","78092029","chrX","137745880","137745982","32","59653964"
"chr5","78092842","78093141","chr5","62670665","62670968","49","15422177"
"chr5","78127894","78128206","chr5","62704329","62704634","35","15423565"
"chr5","78150445","78150750","chr3","125296992","125297287","69","47146547"
"chr5","78190518","78190621","chr18","48326419","48326520","22","29864099"
"chr5","78195546","78195809","chr5","34192040","34192286","62","44003506"
"chr5","78200764","78201050","chr5","62771970","62772276","53","15428794"
"chr5","78241290","78241516","chr6","147102161","147102385","58","68860871"
"chr5","78259315","78259604","chr11","63135747","63136038","55","15123568"
"chr5","78262022","78262318","chr5","62834998","62835290","34","15427024"
"chr5","78264103","78264220","chr7","5629067","5629182","32","72635036"
"chr5","78300142","78300433","chr13","56912100","56912392","62","21388042"
"chr5","78304881","78305157","chr5","58156185","58156470","52","20148696"
"chr5","78382071","78382219","chr6","153023561","153023706","36","74641490"
"chr5","78400439","78400611","chr8","56795337","56795503","36","21605102"
"chr5","78401053","78401212","chr20","43287655","43287814","43","35113398"
"chr5","78411416","78411538","chr7","77000001","77000126","30","1411415"
"chr5","78411557","78411681","chr5","18353008","18353128","17","60058549"
"chr5","78412558","78412860","chr5","37922772","37923085","54","40489786"
"chr5","78427678","78427955","chr12","34819641","34819909","58","43608037"
"chr5","78427981","78428269","chr5","38831718","38832013","36","39596263"
"chr5","78436577","78436911","chr7","29146226","29146559","79","49290351"
"chr5","78439331","78439603","chr1","139768169","139768436","62","61328838"
"chr5","78442364","78442556","chr5","19730491","19730683","54","58711873"
"chr5","78470895","78471123","chr5","38786369","38786597","25","39684526"
"chr5","78473571","78473850","chr10","133953649","133953923","84","55480078"
"chr5","78477111","78477428","chr5","38780929","38781242","48","39696182"
"chr5","78477774","78478055","chr19","6986454","6986735","69","71491320"
"chr5","78511492","78511780","chr5","38746639","38746929","37","39764853"
"chr5","78555065","78555161","chr5","38691176","38691284","17","39863889"
"chr5","78572520","78572777","chr5","38672086","38672357","43","39900434"
"chr5","78596832","78596975","chr22","20288134","20288276","41","58308698"
"chr5","78604703","78604977","chr7","1708256","1708538","54","76896447"
"chr5","78642593","78642866","chr8","25517714","25517991","72","53124879"
"chr5","78668163","78668465","chr7","72306531","72306825","66","6361632"
"chr5","78678959","78679127","chr2A","91847652","91847812","42","13168693"
"chr5","78679131","78679343","chr7","72162828","72163031","52","6516303"
"chr5","78682414","78682497","chr5","9945407","9945472","31","68737007"
"chr5","78682756","78682881","chr7","156595576","156595698","28","77912820"
"chr5","78694824","78694902","chrX","15596602","15596685","12","63098222"
"chr5","78701405","78701720","chr5","14754745","14755057","75","63946660"
"chr5","78702839","78703143","chr5","38552024","38552325","39","40150815"
"chr5","78713379","78713672","chr22","12998437","12998739","66","65714942"
"chr5","78744682","78744832","chr1","24245703","24245864","36","54498979"
"chr5","78748337","78748634","chr5","38509574","38509870","51","40238763"
"chr5","78805258","78805542","chr5","38456038","38456329","31","40349220"
"chr5","78846101","78846370","chr3","182568526","182568786","83","103722425"
"chr5","78849106","78849405","chr1","163867986","163868280","59","85018880"
"chr5","78852248","78852516","chr10","131845163","131845437","72","52992915"
"chr5","78887177","78887470","chr5","38386338","38386635","42","40500839"
"chr5","78896330","78896646","chr7","76899862","76900176","59","1996468"
"chr5","78906884","78907210","chr5","38367754","38368043","62","40539130"
"chr5","78922472","78922764","chr5","38354727","38355028","56","40567745"
"chr5","78931342","78931646","chr5","38346683","38346993","30","40584659"
"chr5","78933035","78933318","chr1","185329634","185329914","55","106396599"
"chr5","78949400","78949695","chr5","38323476","38323786","44","40625924"
"chr5","78955839","78956077","chr2A","64308674","64308931","68","14647165"
"chr5","78957762","78958039","chr5","38315992","38316308","73","40641770"
"chr5","78965421","78965669","chr5","38308670","38308936","44","40656751"
"chr5","78973407","78973535","chr1","150621233","150621357","23","71647826"
"chr5","78995453","78995584","chr5","38281300","38281445","32","40714153"
"chr5","79024355","79024485","chr5","38249159","38249288","18","40775196"
"chr5","79033506","79033789","chr17","63947096","63947377","67","15086410"
"chr5","79041141","79041341","chr1","134620886","134621087","48","55579745"
"chr5","79059688","79059844","chr5","38202123","38202291","32","40857565"
"chr5","79092053","79092331","chr5","38172909","38173190","41","40919144"
"chr5","79100121","79100410","chr5","38164910","38165205","47","40935211"
"chr5","79112765","79112889","chr1","46026245","46026369","17","33086520"
"chr5","79157332","79157599","chr4","152323211","152323483","63","73165879"
"chr5","79165399","79165695","chr5","38104922","38105205","38","41060477"
"chr5","79182706","79182869","chr5","38089240","38089416","41","41093466"
"chr5","79195278","79195568","chrX","53628576","53628870","54","25566702"
"chr5","79208368","79208481","chr6","54568968","54569085","19","24639400"
"chr5","79229643","79229949","chr13","55393211","55393518","60","23836432"
"chr5","79237377","79237665","chr5","38031815","38032114","54","41205562"
"chr5","79237883","79237989","chr19","14292883","14292994","29","64945000"
"chr5","79238832","79239138","chr5","38030646","38030954","45","41208186"
"chr5","79309606","79309903","chr12","121913892","121914192","52","42604286"
"chr5","79338299","79338597","chr5","37922772","37923085","48","41415527"
"chr5","79403855","79404134","chr6","150118641","150118920","61","70714786"
"chr5","79420415","79420684","chr11","123875047","123875316","58","44454632"
"chr5","79421293","79421447","chrX","133103256","133103415","45","53681963"
"chr5","79441916","79442209","chr5","36536621","36536902","56","42905295"
"chr5","79521203","79521498","chr7","65032587","65032882","60","14488616"
"chr5","79539997","79540289","chr5","36630407","36630715","43","42909590"
"chr5","79548039","79548314","chr5","36640451","36640738","48","42907588"
"chr5","79594674","79594972","chr5","36682820","36683118","29","42911854"
"chr5","79627494","79627777","chr1","9301448","9301737","52","70326046"
"chr5","79649124","79649252","chrX","137745880","137745982","47","58096756"
"chr5","79653871","79654182","chr5","36739710","36740003","52","42914161"
"chr5","79695549","79695745","chr6","27460925","27461127","50","52234624"
"chr5","79696229","79696526","chr5","36983395","36983700","36","42712834"
"chr5","79718715","79718866","chr5","36804238","36804393","27","42914477"
"chr5","79758358","79758669","chr5","36846710","36847016","50","42911648"
"chr5","79781149","79781458","chr5","37045890","37046207","51","42735259"
"chr5","79859231","79859537","chr5","37753713","37754031","54","42105518"
"chr5","79862084","79862381","chr5","37750915","37751206","47","42111169"
"chr5","79900354","79900673","chr5","37713063","37713382","43","42187291"
"chr5","79927388","79927657","chr5","37690099","37690386","51","42237289"
"chr5","79934821","79935061","chr5","37683186","37683436","35","42251635"
"chr5","80055984","80056273","chr7","33270606","33270890","66","46785378"
"chr5","80084496","80084796","chr5","37521102","37521413","43","42563394"
"chr5","80087810","80088082","chr11","134346915","134347190","52","54259105"
"chr5","80162970","80163239","chr5","37433167","37433434","45","42729803"
"chr5","80175156","80175417","chr15","26961987","26962243","71","53213169"
"chr5","80186030","80186321","chr1","227415933","227416230","47","147229903"
"chr5","80203089","80203227","chr15","53850985","53851123","37","26352104"
"chr5","80222580","80222810","chrX","9343961","9344191","53","70878619"
"chr5","80228806","80228920","chr19","13049324","13049440","24","67179482"
"chr5","80269748","80269885","chr7","6123940","6124085","30","74145808"
"chr5","80279813","80280095","chr1","17066845","17067125","79","63212968"
"chr5","80345367","80345481","chr7","72705929","72706046","16","7639438"
"chr5","80364801","80365080","chr6","115732401","115732684","63","35367600"
"chr5","80373871","80374002","chr14","86889668","86889802","21","6515797"
"chr5","80396252","80396377","chr2B","128679677","128679799","16","48283425"
"chr5","80396870","80396938","chr6","1766565","1766633","14","78630305"
"chr5","80425057","80425349","chr19","4731659","4731944","60","75693398"
"chr5","80432741","80432989","chr5","36391281","36391525","38","44041460"
"chr5","80433840","80434144","chr5","63928435","63928737","65","16505405"
"chr5","80435156","80435457","chr5","36388712","36389002","43","44046444"
"chr5","80449230","80449385","chr2B","27751482","27751639","32","52697748"
"chr5","80450362","80450492","chr10","34417594","34417723","25","46032768"
"chr5","80450583","80450860","chr2B","114230757","114231037","71","33780174"
"chr5","80463076","80463373","chr5","36356168","36356471","42","44106908"
"chr5","80463556","80463866","chr16","64122904","64123217","72","16340652"
"chr5","80477044","80477332","chr5","36350524","36350814","29","44126520"
"chr5","80491784","80492088","chr5","36337066","36337361","37","44154718"
"chr5","80521674","80521797","chr12","93713225","93713347","21","13191551"
"chr5","80525737","80525920","chr1","183809138","183809317","47","103283401"
"chr5","80533711","80533827","chr5","36296540","36296676","34","44237171"
"chr5","80558612","80558914","chrX","103981721","103982018","54","23423109"
"chr5","80566916","80567216","chr6","118542962","118543266","63","37976046"
"chr5","80611506","80611709","chr12","29993522","29993738","62","50617984"
"chr5","80631273","80631562","chr5","36202243","36202546","43","44429030"
"chr5","80650765","80651052","chr5","36178084","36178382","45","44472681"
"chr5","80679122","80679388","chr7","42566180","42566453","67","38112942"
"chr5","80979352","80979633","chrX","18545082","18545367","57","62434270"
"chr5","81033018","81033295","chr5","20948134","20948418","36","60084884"
"chr5","81037192","81037489","chr5","20945925","20946195","44","60091267"
"chr5","81056222","81056502","chr1","38001876","38002160","60","43054346"
"chr5","81058006","81058306","chr5","20926297","20926595","45","60131709"
"chr5","81062004","81062284","chr5","20922728","20923010","31","60139276"
"chr5","81062519","81062813","chr1","78330569","78330867","63","2731950"
"chr5","81089677","81089964","chr9","14086342","14086613","70","67003335"
"chr5","81114870","81114972","chr10","105655931","105656038","25","24541061"
"chr5","81126611","81126894","chr7","127846250","127846543","42","46719639"
"chr5","81139819","81139961","chr7","138790172","138790295","40","57650353"
"chr5","81178642","81178874","chr5","20800139","20800372","31","60378503"
"chr5","81183994","81184267","chr7","127911048","127911343","50","46727054"
"chr5","81192343","81192640","chr2A","79717022","79717315","58","1475321"
"chr5","81195582","81195751","chr7","56771797","56771964","37","24423785"
"chr5","81195754","81195833","chr1","7559387","7559466","20","73636367"
"chr5","81195836","81196032","chr4","1869667","1869859","49","79326169"
"chr5","81211195","81211489","chr5","20780202","20780479","46","60430993"
"chr5","81220034","81220355","chr18","34048248","34048557","67","47171786"
"chr5","81252922","81253037","chrX","47065028","47065145","19","34187894"
"chr5","81253380","81253537","chr19","16879306","16879475","33","64374074"
"chr5","81266238","81266504","chr12","38913457","38913718","66","42352781"
"chr5","81275482","81275603","chr6","74653208","74653329","22","6622274"
"chr5","81310874","81310999","chr5","20673002","20673124","16","60637872"
"chr5","81312472","81312754","chr5","20670016","20670300","37","60642456"
"chr5","81338599","81338891","chr3","12047317","12047601","69","69291282"
"chr5","81339343","81339601","chr12","125129033","125129295","53","43789690"
"chr5","81351243","81351549","chr5","20622565","20622880","49","60728678"
"chr5","81389416","81389664","chr5","20583483","20583731","34","60805933"
"chr5","81411707","81412009","chr22","13742429","13742732","49","67669278"
"chr5","81414428","81414716","chr5","20563274","20563558","40","60851154"
"chr5","81419711","81419832","chr13","9658073","9658197","19","71761638"
"chr5","81428659","81428906","chr12","33028192","33028453","66","48400467"
"chr5","81465732","81466001","chr5","20513193","20513475","45","60952539"
"chr5","81511580","81511707","chr6","132205914","132206037","23","50694334"
"chr5","81513467","81513632","chr5","21561888","21562053","31","59951579"
"chr5","81519098","81519390","chr5","20459590","20459895","46","61059508"
"chr5","81521770","81522027","chr5","20456815","20457063","44","61064955"
"chr5","81532402","81532688","chr5","20442035","20442333","40","61090367"
"chr5","81611543","81611842","chr4","39358060","39358354","53","42253483"
"chr5","81633707","81633991","chr5","20341324","20341605","25","61292383"
"chr5","81638577","81638894","chr5","20336075","20336390","39","61302502"
"chr5","81691827","81692107","chr5","20285690","20285978","39","61406137"
"chr5","81703638","81703929","chr5","20282357","20282649","37","61421281"
"chr5","81705784","81705893","chr5","20280367","20280480","17","61425417"
"chr5","81769769","81770074","chr5","20224415","20224726","44","61545354"
"chr5","81780178","81780470","chr6","87606836","87607116","61","5826658"
"chr5","81789985","81790123","chr12","113666166","113666298","42","31876181"
"chr5","81838114","81838404","chr12","58113170","58113450","73","23724944"
"chr5","81842764","81843055","chr5","20138247","20138538","33","61704517"
"chr5","81876806","81876921","chr9","56650849","56650964","28","25225957"
"chr5","81882280","81882572","chr5","20115804","20116098","43","61766476"
"chr5","81885881","81886123","chr16","20402877","20403119","60","61483004"
"chr5","81899546","81899846","chr5","20099085","20099376","41","61800461"
"chr5","81968293","81968580","chr5","20016972","20017267","53","61951321"
"chr5","81984825","81985101","chr5","20001307","20001574","41","61983518"
"chr5","82001502","82001799","chr5","19972535","19972821","46","62028967"
"chr5","82029906","82030126","chr6","118225232","118225447","47","36195326"
"chr5","82084492","82084655","chr7","41537090","41537238","44","40547402"
"chr5","82092659","82092839","chr16","29906789","29906969","39","52185870"
"chr5","82093002","82093107","chr3","127187671","127187781","23","45094669"
"chr5","82103977","82104252","chr5","19891797","19892075","26","62212180"
"chr5","82118405","82118715","chr5","19877637","19877954","50","62240768"
"chr5","82129921","82130207","chr5","19866615","19866936","60","62263306"
"chr5","82149483","82149750","chr7","154763373","154763639","54","72613890"
"chr5","82164843","82165135","chr5","19831788","19832088","49","62333055"
"chr5","82189064","82189203","chr3","267312","267456","33","81921752"
"chr5","82269275","82269644","chr5","19708770","19709094","81","62560505"
"chr5","82280902","82281121","chr5","137395548","137395757","63","55114646"
"chr5","82299517","82299808","chr1","95869211","95869496","59","13569694"
"chr5","82315929","82316047","chr5","19675847","19675961","17","62640082"
"chr5","82342769","82343061","chr5","19653374","19653652","53","62689395"
"chr5","82376356","82376641","chr5","19616691","19616987","51","62759665"
"chr5","82389017","82389093","chr1","215499639","215499714","18","133110622"
"chr5","82389146","82389370","chr7","78958687","78958912","49","3430459"
"chr5","82393885","82394166","chr5","19616691","19616987","50","62777194"
"chr5","82425094","82425145","chr5","59701333","59701382","15","22723761"
"chr5","82426075","82426142","chr4","196105278","196105349","21","113679203"
"chr5","82426956","82427238","chr5","19587686","19587955","46","62839270"
"chr5","82463805","82463938","chr10","30690604","30690743","29","51773201"
"chr5","82473989","82474121","chrX","115736644","115736777","22","33262655"
"chr5","82486807","82487096","chr1","91019845","91020139","57","8533038"
"chr5","82505703","82505991","chr5","19500167","19500459","59","63005536"
"chr5","82526060","82526345","chr5","19478616","19478905","50","63047444"
"chr5","82527412","82527526","chr5","19477803","19477922","22","63049609"
"chr5","82534890","82535177","chr5","19458285","19458594","66","63076605"
"chr5","82537216","82537484","chr5","19456233","19456505","46","63080983"
"chr5","82675733","82675823","chr7","44654252","44654346","17","38021481"
"chr5","82680788","82681091","chr5","19306357","19306662","34","63374431"
"chr5","82726675","82726950","chr5","19264344","19264633","56","63462331"
"chr5","82779092","82779397","chr5","19215254","19215566","33","63563838"
"chr5","82855418","82855738","chr16","64122904","64123217","70","18732514"
"chr5","82856524","82856814","chrX","133714512","133714801","79","50857988"
"chr5","82870914","82871035","chr10","39817913","39818037","20","43053001"
"chr5","82885677","82885938","chr17","1099040","1099291","73","81786637"
"chr5","82894986","82895274","chr1","42985512","42985800","60","39909474"
"chr5","82907308","82907540","chr5","19086795","19087019","32","63820513"
"chr5","82962962","82963272","chr5","19031856","19032155","43","63931106"
"chr5","82997069","82997380","chr16","25191656","25191948","74","57805413"
"chr5","82999591","82999887","chr5","18985472","18985779","44","64014119"
"chr5","83042654","83042975","chr5","18941200","18941517","34","64101454"
"chr5","83147319","83147695","chr5","18838745","18839089","84","64308574"
"chr5","83185660","83185783","chr5","18796099","18796221","18","64389561"
"chr5","83192959","83193243","chr5","18788933","18789228","49","64404026"
"chr5","83202861","83203144","chrX","19199530","19199816","54","64003331"
"chr5","83217381","83217641","chr1","38120488","38120747","64","45096893"
"chr5","83267372","83267481","chr11","67337030","67337134","23","15930342"
"chr5","83276220","83276486","chr5","18713920","18714185","52","64562300"
"chr5","83294106","83294385","chr5","18698139","18698410","46","64595967"
"chr5","83317418","83317572","chr16","38955159","38955317","33","44362259"
"chr5","83327980","83328284","chr9","13508403","13508697","62","69819577"
"chr5","83339607","83339877","chr1","11383012","11383296","65","71956595"
"chr5","83339908","83340044","chr1","55072146","55072276","25","28267762"
"chr5","83341340","83341468","chrX","42107446","42107558","34","41233894"
"chr5","83373063","83373364","chr5","18622091","18622397","40","64750972"
"chr5","83381793","83381962","chr7","144192683","144192845","52","60810890"
"chr5","83415564","83415817","chr5","18578604","18578882","60","64836960"
"chr5","83439340","83439489","chr2A","68938359","68938506","29","14500981"
"chr5","83444666","83444956","chr15","57373619","57373904","72","26071047"
"chr5","83459282","83459557","chr5","15047571","15047854","30","68411711"
"chr5","83463142","83463304","chr19","5196486","5196645","37","78266656"
"chr5","83463882","83463967","chr1","43387692","43387780","22","40076190"
"chr5","83516315","83516599","chr5","18470256","18470564","54","65046059"
"chr5","83524241","83524347","chr1","227412510","227412616","17","143888269"
"chr5","83569564","83569842","chr4","120894649","120894923","71","37325085"
"chr5","83569849","83570142","chr15","57251254","57251549","48","26318595"
"chr5","83613327","83613575","chr5","24422295","24422544","26","59191032"
"chr5","83636307","83636605","chr5","24404041","24404337","57","59232266"
"chr5","83642259","83642530","chr5","24399713","24399985","45","59242546"
"chr5","83657451","83657578","chr14","10279108","10279238","19","73378343"
"chr5","83657659","83657815","chr16","64951523","64951685","41","18706136"
"chr5","83660395","83660613","chr1","27635799","27636012","46","56024596"
"chr5","83673952","83674260","chr12","108745776","108746083","52","25071824"
"chr5","83687071","83687218","chr1","46271276","46271424","33","37415795"
"chr5","83696886","83697170","chr5","24340826","24341118","31","59356060"
"chr5","83730165","83730277","chr3","24378715","24378829","21","59351450"
"chr5","83737100","83737234","chr5","24308954","24309097","26","59428146"
"chr5","83831676","83831837","chr15","18799975","18800140","26","65031701"
"chr5","83894778","83894908","chr7","56839310","56839440","30","27055468"
"chr5","83914942","83915235","chr5","24145349","24145652","46","59769593"
"chr5","83922720","83923017","chr5","24134152","24134452","37","59788568"
"chr5","83936116","83936388","chr5","24120685","24120952","60","59815431"
"chr5","83953583","83953893","chr5","15687691","15688000","61","68265892"
"chr5","83980294","83980536","chr5","24085889","24086168","71","59894405"
"chr5","83981596","83981875","chr5","24084497","24084786","34","59897099"
"chr5","83984634","83984751","chr22","14821499","14821616","19","69163135"
"chr5","83989796","83989872","chr17","17184874","17184945","15","66804922"
"chr5","84025952","84026181","chr5","15476057","15476280","50","68549895"
"chr5","84036108","84036369","chr5","24018921","24019215","63","60017187"
"chr5","84110412","84110706","chr5","23936821","23937114","48","60173591"
"chr5","84149000","84149284","chr7","4857056","4857336","61","79291944"
"chr5","84156218","84156369","chr1","205548459","205548612","24","121392241"
"chr5","84174125","84174397","chr5","23860310","23860581","29","60313815"
"chr5","84174907","84175160","chr5","23858654","23858908","28","60316253"
"chr5","84198053","84198305","chr19","2464971","2465216","49","81733082"
"chr5","84236852","84237118","chr5","23802754","23803045","60","60434098"
"chr5","84244076","84244203","chr4","5838660","5838783","22","78405416"
"chr5","84264775","84265040","chr5","23341670","23341950","42","60923105"
"chr5","84335462","84335569","chr5","73802865","73802974","21","10532597"
"chr5","84415082","84415304","chr5","23640672","23640917","50","60774410"
"chr5","84428887","84429172","chr20","47744101","47744394","67","36684786"
"chr5","84430150","84430273","chr7","26158438","26158564","37","58271712"
"chr5","84440075","84440161","chr1","43387692","43387780","18","41052383"
"chr5","84442429","84442595","chr13","5474254","5474413","38","78968175"
"chr5","84457632","84457732","chr5","23598597","23598696","13","60859035"
"chr5","84463080","84463376","chr5","23592619","23592917","37","60870461"
"chr5","84476524","84476821","chr5","23580014","23580303","44","60896510"
"chr5","84480668","84480788","chr6","44409978","44410089","37","40070690"
"chr5","84484122","84484276","chr6","105952734","105952883","49","21468612"
"chr5","84487487","84487731","chr5","23568548","23568813","42","60918939"
"chr5","84565235","84565544","chr22","27278868","27279167","59","57286367"
"chr5","84589506","84589646","chr1","214795835","214795974","32","130206329"
"chr5","84599621","84599712","chr1","225199355","225199447","21","140599734"
"chr5","84609156","84609379","chrX","48678555","48678774","43","35930601"
"chr5","84619172","84619441","chr5","23447314","23447587","34","61171858"
"chr5","84621613","84621861","chr16","72318553","72318806","51","12303060"
"chr5","84623082","84623204","chr6","112856828","112856953","26","28233746"
"chr5","84630797","84631044","chr5","23439541","23439809","59","61191256"
"chr5","84638514","84638805","chr5","23430522","23430810","53","61207992"
"chr5","84664004","84664213","chr1","9362061","9362276","52","75301943"
"chr5","84712183","84712447","chr5","58084020","58084302","43","26628163"
"chr5","84714068","84714386","chr5","58082764","58083077","55","26631304"
"chr5","84766030","84766346","chr5","21111084","21111412","56","63654946"
"chr5","84807663","84807965","chr5","21150943","21151244","38","63656720"
"chr5","84825130","84825305","chr5","21180393","21180575","23","63644737"
"chr5","84850900","84851115","chr12","29993522","29993738","54","54857378"
"chr5","84853861","84854035","chr1","47843988","47844174","42","37009873"
"chr5","84904920","84905228","chr5","21247726","21247995","82","63657194"
"chr5","84950494","84950801","chr5","21304728","21305034","26","63645766"
"chr5","84951660","84951964","chr12","104448431","104448741","55","19496771"
"chr5","84960678","84960802","chr6","90942219","90942343","20","5981541"
"chr5","84998051","84998338","chr16","44208848","44209135","60","40789203"
"chr5","85008842","85009048","chr5","21362175","21362395","49","63646667"
"chr5","85074302","85074595","chr14","14195106","14195389","68","70879196"
"chr5","85111823","85112075","chr5","21463491","21463747","33","63648332"
"chr5","85169842","85170138","chr5","21531616","21531908","37","63638226"
"chr5","85200558","85200828","chr5","21570007","21570288","34","63630551"
"chr5","85226150","85226276","chr10","12650705","12650831","28","72575445"
"chr5","85226387","85226536","chr12","6889976","6890118","29","78336411"
"chr5","85260543","85260848","chr9","103752137","103752439","61","18491594"
"chr5","85275925","85276072","chr16","6330633","6330790","35","78945292"
"chr5","85288796","85289105","chr6","36213674","36213980","71","49075122"
"chr5","85304942","85305226","chr5","21658002","21658301","36","63646940"
"chr5","85355154","85355472","chr3","126350182","126350497","84","40995028"
"chr5","85379769","85380143","chr5","21730592","21730962","36","63649177"
"chr5","85494271","85494537","chr5","21827088","21827379","46","63667183"
"chr5","85514353","85514435","chr9","108660572","108660658","18","23146219"
"chr5","85579805","85580081","chr5","21907117","21907402","36","63672688"
"chr5","85601286","85601403","chr1","182798095","182798212","18","97196809"
"chr5","85693227","85693514","chr3","131369946","131370239","68","45676719"
"chr5","85695908","85696194","chr5","22026325","22026623","37","63669583"
"chr5","85721436","85721703","chr18","10889709","10889956","70","74831727"
"chr5","85731098","85731405","chr5","22066677","22066987","33","63664421"
"chr5","85733864","85733947","chr19","50873526","50873609","15","34860338"
"chr5","85749462","85749617","chr19","5169265","5169417","34","80580197"
"chr5","85757116","85757426","chr21","34846963","34847270","54","50910153"
"chr5","85769884","85770067","chr5","22107279","22107469","31","63662605"
"chr5","85780181","85780467","chr7","1708256","1708538","69","84071925"
"chr5","85801401","85801523","chr5","22134012","22134133","23","63667389"
"chr5","85822981","85823272","chr5","22158751","22159048","41","63664230"
"chr5","85870368","85870577","chr5","22199215","22199430","37","63671153"
"chr5","85894236","85894533","chr5","22221702","22222006","32","63672534"
"chr5","85994054","85994362","chr21","34846963","34847270","67","51147091"
"chr5","85995046","85995352","chr10","37002737","37003045","73","48992309"
"chr5","85998237","85998358","chr4","117684721","117684845","22","31686484"
"chr5","86043464","86043745","chr5","22347177","22347479","57","63696287"
"chr5","86056738","86057017","chr5","22358371","22358669","57","63698367"
"chr5","86061288","86061374","chr9","94983938","94984021","18","8922650"
"chr5","86107501","86107787","chr15","75420329","75420611","60","10687172"
"chr5","86131403","86131562","chr20","13392558","13392708","42","72738845"
"chr5","86137464","86137652","chr19","15967693","15967882","44","70169771"
"chr5","86184452","86184597","chr1","205945800","205945944","37","119761348"
"chr5","86191143","86191443","chr5","22477032","22477329","29","63714111"
"chr5","86233741","86234019","chr5","22526575","22526877","54","63707166"
"chr5","86235454","86235747","chr5","22534720","22535033","52","63700734"
"chr5","86261111","86261353","chr5","22560462","22560703","27","63700649"
"chr5","86261869","86262141","chr5","22561034","22561329","58","63700835"
"chr5","86269053","86269346","chr5","22571867","22572134","54","63697186"
"chr5","86276848","86276963","chr5","22580650","22580767","16","63696198"
"chr5","86304665","86304844","chr2B","95198022","95198192","38","8893357"
"chr5","86344158","86344326","chr2B","74460337","74460500","34","11883821"
"chr5","86373684","86373979","chr20","5717885","5718183","59","80655799"
"chr5","86374864","86374969","chr2B","114784824","114784937","25","28409960"
"chr5","86385350","86385454","chr10","66507605","66507710","22","19877745"
"chr5","86407419","86407673","chr1","216731191","216731452","53","130323772"
"chr5","86411702","86411978","chr5","22709967","22710246","27","63701735"
"chr5","86412144","86412256","chr5","22710618","22710735","16","63701526"
"chr5","86418067","86418345","chr5","22716355","22716628","33","63701712"
"chr5","86427806","86428088","chr5","91332183","91332473","59","4904377"
"chr5","86436389","86436679","chr5","22732420","22732707","36","63703969"
"chr5","86437547","86437707","chr1","212572329","212572488","40","126134782"
"chr5","86437963","86438102","chr12","22164235","22164369","28","64273728"
"chr5","86462476","86462635","chr2B","27751482","27751639","40","58710994"
"chr5","86466034","86466334","chr5","22762469","22762769","38","63703565"
"chr5","86469765","86470056","chr5","22766269","22766560","45","63703496"
"chr5","86487052","86487256","chr5","22780760","22780971","25","63706292"
"chr5","86487983","86488175","chr12","1231020","1231214","52","85256963"
"chr5","86491173","86491526","chr5","22784559","22784913","52","63706614"
"chr5","86492055","86492319","chr8","102004663","102004935","67","15512608"
"chr5","86500352","86500615","chr7","65859600","65859872","71","20640752"
"chr5","86565150","86565426","chr5","22865045","22865333","50","63700105"
"chr5","86579499","86579662","chr7","79657650","79657818","36","6921849"
"chr5","86592155","86592457","chr16","30950078","30950376","59","55642077"
"chr5","86602367","86602496","chr5","120504650","120504778","28","33902283"
"chr5","86604507","86604793","chr5","22893913","22894196","46","63710594"
"chr5","86606208","86606296","chr5","22896285","22896372","7","63709923"
"chr5","86618950","86619126","chr5","22910726","22910884","40","63708224"
"chr5","86620177","86620472","chr1","227415933","227416230","63","140795756"
"chr5","86624329","86624447","chr14","41702979","41703101","21","44921350"
"chr5","86634449","86634690","chr4","98225822","98226056","69","11591373"
"chr5","86636415","86636488","chr13","676901","676973","16","85959514"
"chr5","86642209","86642324","chr5","6863862","6863979","21","79778347"
"chr5","86665776","86666054","chr5","6315687","6315966","79","80350089"
"chr5","86668969","86669268","chr7","66161233","66161536","61","20507736"
"chr5","86696627","86696853","chr5","23004195","23004418","33","63692432"
"chr5","86713097","86713369","chr5","23029847","23030127","40","63683250"
"chr5","86745224","86745530","chr7","78953080","78953379","66","7792144"
"chr5","86759511","86759791","chr3","34329169","34329465","71","52430342"
"chr5","86798635","86798930","chr5","20979628","20979926","38","65819007"
"chr5","86801401","86801704","chr1","45145246","45145545","65","41656155"
"chr5","86820104","86820409","chr1","147835480","147835774","64","61015376"
"chr5","86824316","86824615","chr1","182618245","182618550","57","95793929"
"chr5","86847866","86847999","chr1","21301496","21301630","37","65546370"
"chr5","86899528","86899797","chr5","39350853","39351116","59","47548675"
"chr5","86934498","86934656","chr15","63288142","63288298","33","23646356"
"chr5","86959832","86960098","chr5","46893450","46893735","46","40066382"
"chr5","86992469","86992749","chrX","133533701","133533982","78","46541232"
"chr5","87012689","87012813","chr1","51303701","51303823","23","35708988"
"chr5","87060553","87060838","chr5","46795628","46795912","50","40264925"
"chr5","87083430","87083551","chr5","46771689","46771804","17","40311741"
"chr5","87111571","87111866","chr5","46719049","46719352","61","40392522"
"chr5","87197557","87197683","chr2B","94897282","94897419","34","7699725"
"chr5","87198288","87198417","chr7","77000001","77000126","34","10198287"
"chr5","87211433","87211549","chr8","24373931","24374050","22","62837502"
"chr5","87213308","87213583","chr5","46580578","46580874","50","40632730"
"chr5","87214053","87214346","chr5","46579731","46580032","25","40634322"
"chr5","87215620","87215927","chr5","46578012","46578327","53","40637608"
"chr5","87265769","87265862","chr1","40323439","40323520","32","46942330"
"chr5","87266013","87266114","chr5","14822723","14822826","26","72443290"
"chr5","87282334","87282627","chr5","46516655","46516952","49","40765679"
"chr5","87343246","87343561","chr5","46452349","46452657","44","40890897"
"chr5","87346596","87346712","chr6","21652989","21653103","20","65693607"
"chr5","87353148","87353268","chr3","1525144","1525272","31","85828004"
"chr5","87357637","87357767","chr6","18588428","18588554","31","68769209"
"chr5","87358209","87358340","chr9","116308853","116308988","22","28950644"
"chr5","87384844","87385163","chr5","46409777","46410096","46","40975067"
"chr5","87386795","87387089","chr5","46408096","46408393","33","40978699"
"chr5","87397219","87397450","chr5","46398241","46398473","32","40998978"
"chr5","87401993","87402277","chr5","46393379","46393668","38","41008614"
"chr5","87405708","87405861","chr5","162775438","162775602","37","75369730"
"chr5","87434646","87434735","chr12","111845659","111845746","27","24411013"
"chr5","87440474","87440788","chr1","207607505","207607814","65","120167031"
"chr5","87460111","87460219","chr2A","4429423","4429533","18","83030688"
"chr5","87467118","87467274","chr7","79271528","79271684","36","8195590"
"chr5","87490906","87491074","chr5","156787834","156787995","39","69296928"
"chr5","87529795","87529871","chr5","46264452","46264526","8","41265343"
"chr5","87531082","87531382","chr5","46263212","46263517","55","41267870"
"chr5","87540894","87541117","chr5","46253935","46254157","30","41286959"
"chr5","87541165","87541446","chr4","104639850","104640133","73","17098685"
"chr5","87569868","87569969","chr8","74379973","74380073","17","13189895"
"chr5","87582480","87582804","chr5","46214423","46214715","58","41368057"
"chr5","87587281","87587574","chr5","46209575","46209878","36","41377706"
"chr5","87613186","87613481","chr5","46183777","46184077","44","41429409"
"chr5","87618892","87619006","chr20","46080183","46080300","18","41538709"
"chr5","87672819","87672936","chr2A","83005446","83005563","13","4667373"
"chr5","87729021","87729259","chr3","25843071","25843300","50","61885950"
"chr5","87738999","87739159","chr16","38955159","38955317","33","48783840"
"chr5","87746684","87746802","chr5","46035056","46035174","14","41711628"
"chr5","87762888","87763007","chr5","46011429","46011539","18","41751459"
"chr5","87766269","87766574","chr5","46008318","46008625","51","41757951"
"chr5","87780534","87780842","chr5","45993741","45994034","46","41786793"
"chr5","87807093","87807359","chr5","45981829","45982102","38","41825264"
"chr5","87810745","87811030","chr22","33935616","33935903","61","53875129"
"chr5","87848818","87848924","chr3","199781635","199781741","20","111932817"
"chr5","87877131","87877340","chr5","45924297","45924518","42","41952834"
"chr5","87878531","87878686","chr5","155930754","155930923","39","68052223"
"chr5","87879611","87879713","chrX","3394860","3394959","16","84484751"
"chr5","87891330","87891447","chr17","63212955","63213066","29","24678375"
"chr5","87908941","87909251","chr5","45891003","45891288","61","42017938"
"chr5","87916004","87916185","chr11","47592267","47592453","51","40323737"
"chr5","87945764","87945988","chr5","45855038","45855258","47","42090726"
"chr5","87952114","87952412","chr5","45848466","45848755","49","42103648"
"chr5","87963457","87963716","chr5","45840675","45840953","42","42122782"
"chr5","87993838","87994068","chrX","9458116","9458346","70","78535722"
"chr5","88015205","88015424","chr5","45793015","45793256","39","42222190"
"chr5","88033084","88033380","chr16","40088504","40088786","65","47944580"
"chr5","88047881","88048111","chr5","45761011","45761208","57","42286870"
"chr5","88056144","88056420","chr10","8078554","8078826","67","79977590"
"chr5","88067654","88067954","chr2A","81180337","81180638","68","6887317"
"chr5","88080013","88080147","chr5","3296328","3296466","39","84783685"
"chr5","88084382","88084678","chr5","45726280","45726585","45","42358102"
"chr5","88093572","88093838","chr5","45718568","45718869","56","42375004"
"chr5","88101041","88101188","chr10","92108530","92108678","37","4007489"
"chr5","88175290","88175576","chr5","45637532","45637830","37","42537758"
"chr5","88210428","88210704","chr5","45601725","45601997","27","42608703"
"chr5","88252655","88252746","chr7","73286555","73286645","12","14966100"
"chr5","88302358","88302657","chr5","37495814","37496112","66","50806544"
"chr5","88322348","88322513","chr4","21061999","21062161","32","67260349"
"chr5","88448360","88448484","chr5","123948512","123948637","20","35500152"
"chr5","88450699","88451005","chr5","47252025","47252314","53","41198674"
"chr5","88541933","88542234","chr5","47376491","47376799","53","41165442"
"chr5","88619635","88619950","chr5","47454537","47454835","54","41165098"
"chr5","88622812","88623102","chr5","47458313","47458611","48","41164499"
"chr5","88623251","88623543","chr13","2482234","2482520","65","86141017"
"chr5","88631057","88631319","chr5","47467652","47467925","39","41163405"
"chr5","88691966","88692070","chr2B","88352441","88352553","29","339525"
"chr5","88699115","88699288","chr21","20061253","20061421","45","68637862"
"chr5","88719399","88719591","chr8","119674","119875","39","88599725"
"chr5","88867834","88868105","chr2B","49824060","49824327","56","39043774"
"chr5","88877495","88877800","chr7","79724597","79724900","62","9152898"
"chr5","88892922","88893205","chr15","68953531","68953821","35","19939391"
"chr5","88894835","88895130","chr4","151944849","151945132","66","63050014"
"chr5","88902484","88902766","chr14","89296736","89297025","70","394252"
"chr5","88915053","88915215","chr16","19690267","19690437","38","69224786"
"chr5","88943045","88943327","chr5","47561263","47561551","31","41381782"
"chr5","88967142","88967268","chr7","11248117","11248241","19","77719025"
"chr5","88967974","88968103","chr5","47586167","47586290","22","41381807"
"chr5","88986294","88986614","chr5","47605887","47606227","50","41380407"
"chr5","88995125","88995425","chr5","47618591","47618894","35","41376534"
"chr5","89016199","89016347","chr5","47641709","47641876","27","41374490"
"chr5","89059857","89060093","chr1","42507228","42507472","62","46552629"
"chr5","89064658","89064941","chr5","47690961","47691248","37","41373697"
"chr5","89068761","89068949","chr16","9328404","9328594","47","79740357"
"chr5","89076340","89076644","chr5","47701867","47702178","48","41374473"
"chr5","89109988","89110300","chr5","47733786","47734070","63","41376202"
"chr5","89122568","89122808","chrX","118391341","118391573","51","29268773"
"chr5","89142495","89142790","chr11","7817154","7817464","71","81325341"
"chr5","89177268","89177547","chr5","47957756","47958040","44","41219512"
"chr5","89181242","89181402","chr6","15264957","15265121","35","73916285"
"chr5","89193232","89193528","chr5","47973826","47974101","48","41219406"
"chr5","89195997","89196285","chr5","48031999","48032303","48","41163998"
"chr5","89241998","89242170","chr5","48083529","48083714","30","41158469"
"chr5","89287046","89287330","chr9","75566020","75566287","60","13721026"
"chr5","89290555","89290841","chr19","39428993","39429271","74","49861562"
"chr5","89295596","89295887","chr5","48159570","48159864","37","41136026"
"chr5","89309573","89309701","chr14","54547555","54547673","44","34762018"
"chr5","89310528","89310818","chr5","48174650","48174952","49","41135878"
"chr5","89348135","89348278","chr18","77865542","77865689","35","11482593"
"chr5","89414843","89414998","chr5","2409784","2409944","27","87005059"
"chr5","89429700","89429998","chr11","117190617","117190922","75","27760917"
"chr5","89462368","89462520","chr13","3468265","3468414","23","85994103"
"chr5","89493261","89493381","chr5","48344997","48345123","16","41148264"
"chr5","89543868","89544170","chr7","129496935","129497243","77","39953067"
"chr5","89557240","89557504","chr13","12503300","12503564","62","77053940"
"chr5","89558175","89558290","chr5","48396469","48396583","10","41161706"
"chr5","89565938","89566246","chr5","48404149","48404459","43","41161789"
"chr5","89674367","89674678","chr5","48512985","48513299","42","41161382"
"chr5","89811707","89811875","chr1","38009408","38009578","51","51802299"
"chr5","89851729","89852041","chr5","48687708","48688012","60","41164021"
"chr5","89909548","89909675","chr5","48736854","48736989","19","41172694"
"chr5","89911218","89911533","chr5","48738511","48738819","47","41172707"
"chr5","89959561","89959847","chr5","48781228","48781513","54","41178333"
"chr5","90120083","90120364","chr5","48941654","48941913","55","41178429"
"chr5","90123587","90123890","chr5","48944720","48945011","46","41178867"
"chr5","90147033","90147135","chr5","48966184","48966302","29","41180849"
"chr5","90442558","90442833","chr7","64852523","64852793","61","25590035"
"chr5","90463746","90464029","chr5","49345212","49345503","39","41118534"
"chr5","90626081","90626374","chr10","91512440","91512732","55","886359"
"chr5","90635761","90636043","chr5","49502211","49502500","49","41133550"
"chr5","90637873","90638155","chr5","49502211","49502500","49","41135662"
"chr5","90745966","90746056","chr5","49603515","49603607","11","41142451"
"chr5","90786786","90787066","chr5","49642160","49642463","51","41144626"
"chr5","90789363","90789495","chr3","196153062","196153190","25","105363699"
"chr5","90789591","90789749","chr7","110575418","110575579","36","19785827"
"chr5","90795808","90795947","chr1","21301496","21301630","35","69494312"
"chr5","90799306","90799445","chr6","77626450","77626592","29","13172856"
"chr5","90877392","90877530","chr5","49732079","49732211","20","41145313"
"chr5","90994795","90995089","chr5","49857697","49857966","54","41137098"
"chr5","91059605","91059895","chr5","49938922","49939228","50","41120683"
"chr5","91140842","91141146","chr5","50026379","50026676","39","41114463"
"chr5","91248845","91249124","chr5","50127805","50128096","47","41121040"
"chr5","91254244","91254369","chr20","43708602","43708725","17","47545642"
"chr5","91326009","91326324","chr6","20689530","20689838","63","70636479"
"chr5","91455739","91456042","chr5","50333937","50334233","40","41121802"
"chr5","91479855","91479984","chr12","94939804","94939932","20","3459949"
"chr5","91500286","91500558","chr5","3312715","3312996","62","88187571"
"chr5","91516472","91516768","chr5","50386902","50387213","44","41129570"
"chr5","91519730","91520004","chr5","50394401","50394698","55","41125329"
"chr5","91600666","91600837","chr19","34709362","34709535","32","56891304"
"chr5","91631258","91631554","chr5","50524718","50525018","56","41106540"
"chr5","91659193","91659316","chrX","95494066","95494189","16","3834873"
"chr5","91678922","91679235","chr10","142926143","142926445","63","51247221"
"chr5","91681651","91681927","chr18","38036634","38036911","61","53645017"
"chr5","91686810","91686971","chr1","23183624","23183790","35","68503186"
"chr5","91751642","91751764","chr9","87584262","87584385","28","4167380"
"chr5","91788894","91789193","chr5","50670050","50670356","44","41118844"
"chr5","91847423","91847726","chr5","50738686","50738990","34","41108737"
"chr5","91863140","91863456","chr5","50753752","50754042","63","41109388"
"chr5","91866956","91867240","chr16","25203534","25203830","62","66663422"
"chr5","91882894","91883182","chr5","10684242","10684515","68","81198652"
"chr5","91910866","91911160","chr5","50795987","50796295","47","41114879"
"chr5","91922026","91922297","chr5","50806974","50807268","59","41115052"
"chr5","91936961","91937261","chr5","50822545","50822839","41","41114416"
"chr5","91948303","91948584","chr5","50835252","50835542","32","41113051"
"chr5","91955850","91955982","chr16","69212656","69212783","35","22743194"
"chr5","91970638","91970914","chr5","50870741","50871019","66","41099897"
"chr5","91983359","91983680","chr5","50874453","50874771","43","41108906"
"chr5","92031215","92031565","chr5","50920890","50921247","42","41110325"
"chr5","92044654","92044936","chr7","66293568","66293857","57","25751086"
"chr5","92062803","92063099","chr11","56908571","56908866","58","35154232"
"chr5","92067387","92067675","chr1","163867986","163868280","73","71800599"
"chr5","92077073","92077341","chr16","47821574","47821842","65","44255499"
"chr5","92104653","92104954","chr5","51010475","51010769","51","41094178"
"chr5","92124123","92124269","chr3","267312","267456","35","91856811"
"chr5","92130792","92131007","chr5","51032134","51032355","34","41098658"
"chr5","92132703","92132995","chr5","51034273","51034568","39","41098430"
"chr5","92138490","92138779","chr5","51039051","51039347","50","41099439"
"chr5","92149937","92150225","chr3","13342813","13343102","69","78807124"
"chr5","92153315","92153576","chr6","139164603","139164864","63","47011288"
"chr5","92157052","92157310","chr5","51058459","51058732","41","41098593"
"chr5","92187467","92187784","chr5","51089523","51089817","70","41097944"
"chr5","92244961","92245123","chr5","51144248","51144411","25","41100713"
"chr5","92252868","92253159","chrX","39133182","39133470","58","53119686"
"chr5","92253819","92254109","chr4","182052332","182052639","72","89798513"
"chr5","92278551","92278859","chr5","51175216","51175528","41","41103335"
"chr5","92279918","92280041","chr4","61265266","61265389","18","31014652"
"chr5","92280846","92280977","chr7","76202444","76202578","36","16078402"
"chr5","92288054","92288306","chr5","51184841","51185090","31","41103213"
"chr5","92308056","92308349","chr5","51221766","51222058","41","41086290"
"chr5","92323830","92324109","chr5","51235490","51235784","34","41088340"
"chr5","92332141","92332365","chr15","53211959","53212179","38","39120182"
"chr5","92341767","92341892","chr5","52418630","52418747","19","39923137"
"chr5","92343538","92343659","chr9","15394099","15394221","16","76949439"
"chr5","92371201","92371489","chr3","49741493","49741779","59","42629708"
"chr5","92374823","92374955","chr5","52467300","52467433","15","39907523"
"chr5","92391488","92391759","chr4","132919368","132919642","68","40527880"
"chr5","92409582","92409875","chr5","52500021","52500318","31","39909561"
"chr5","92410186","92410396","chr5","35759968","35760183","42","56650218"
"chr5","92430156","92430440","chr5","52522372","52522657","25","39907784"
"chr5","92440164","92440426","chr5","52532777","52533040","41","39907387"
"chr5","92440431","92440555","chr5","52533046","52533171","15","39907385"
"chr5","92442612","92442761","chr4","163306835","163306988","33","70864223"
"chr5","92454830","92455038","chr5","52550422","52550634","28","39904408"
"chr5","92456829","92457128","chr5","52553152","52553434","59","39903677"
"chr5","92473032","92473147","chr1","65862925","65863041","23","26610107"
"chr5","92473743","92473870","chr5","45910561","45910692","34","46563182"
"chr5","92477744","92477960","chr3","12536963","12537185","47","79940781"
"chr5","92517529","92517786","chr5","52594251","52594517","50","39923278"
"chr5","92543181","92543465","chr9","75566020","75566287","74","16977161"
"chr5","92546444","92546647","chr5","52622669","52622887","38","39923775"
"chr5","92562108","92562405","chr5","52635614","52635910","36","39926494"
"chr5","92568483","92568610","chr2B","27006567","27006691","16","65561916"
"chr5","92570338","92570540","chr5","8577350","8577557","43","83992988"
"chr5","92590819","92591084","chr17","86728078","86728321","78","5862741"
"chr5","92605407","92605517","chr16","19747838","19747947","26","72857569"
"chr5","92611660","92611809","chr1","31279143","31279286","43","61332517"
"chr5","92611849","92612131","chr5","51409529","51409820","48","41202320"
"chr5","92614682","92614958","chr19","48177297","48177594","74","44437385"
"chr5","92628090","92628361","chr5","51435251","51435544","49","41192839"
"chr5","92629923","92630204","chr5","51436596","51436881","44","41193327"
"chr5","92654531","92654826","chr3","57847114","57847393","72","34807417"
"chr5","92715042","92715349","chr5","51502497","51502796","43","41212545"
"chr5","92783264","92783391","chr5","51562568","51562696","17","41220696"
"chr5","92799088","92799424","chr5","51582283","51582615","39","41216805"
"chr5","92807258","92807429","chr20","21558064","21558231","34","71249194"
"chr5","92811439","92811744","chr5","51597131","51597436","54","41214308"
"chr5","92845702","92846001","chr2B","37359392","37359678","66","55486310"
"chr5","92886219","92886503","chr5","51689191","51689499","58","41197028"
"chr5","92890060","92890356","chr11","66565132","66565428","53","26324928"
"chr5","92897322","92897477","chr10","40838711","40838864","47","52058611"
"chr5","92897613","92897728","chr10","14128954","14129070","30","78768659"
"chr5","92902976","92903286","chr7","79849134","79849443","60","13053842"
"chr5","92937953","92938068","chr3","32802222","32802346","26","60135731"
"chr5","92939444","92939749","chr5","51764323","51764630","35","41175121"
"chr5","92942250","92942549","chr5","51767440","51767739","52","41174810"
"chr5","92968465","92968774","chr1","207607505","207607814","69","114639040"
"chr5","92976661","92976971","chr5","51802583","51802894","30","41174078"
"chr5","92993985","92994293","chr5","51819741","51820044","44","41174244"
"chr5","93009310","93009444","chr5","51834513","51834646","18","41174797"
"chr5","93055600","93055640","chr10","112116377","112116415","15","19060777"
"chr5","93055992","93056084","chr14","60630991","60631086","22","32425001"
"chr5","93056859","93056928","chr4","4333939","4334013","14","88722920"
"chr5","93063157","93063281","chr3","9547020","9547137","22","83516137"
"chr5","93071378","93071668","chr14","41315913","41316194","51","51755465"
"chr5","93074295","93074454","chr5","73641525","73641679","39","19432770"
"chr5","93086379","93086658","chr5","51916629","51916925","55","41169750"
"chr5","93108233","93108551","chr5","51938133","51938452","40","41170100"
"chr5","93127084","93127374","chr5","51952891","51953181","28","41174193"
"chr5","93134489","93134639","chr8","20885859","20886004","35","72248630"
"chr5","93135035","93135181","chr20","34414083","34414223","31","58720952"
"chr5","93143427","93143728","chr1","150808926","150809223","53","57665499"
"chr5","93144978","93145295","chr5","51967559","51967848","55","41177419"
"chr5","93146846","93147066","chr5","123595724","123595933","60","30448878"
"chr5","93165655","93165829","chr1","160307583","160307752","43","67141928"
"chr5","93215865","93216038","chr17","18297789","18297962","32","74918076"
"chr5","93245569","93245846","chr22","9835330","9835585","80","83410239"
"chr5","93277289","93277559","chr3","140583382","140583663","58","47306093"
"chr5","93299888","93300002","chr15","899959","900072","8","92399929"
"chr5","93387707","93387992","chr7","1708256","1708538","60","91679451"
"chr5","93390162","93390438","chr5","45421619","45421923","54","47968543"
"chr5","93432387","93432672","chr1","46737891","46738177","71","46694496"
"chr5","93442982","93443110","chr9","47369076","47369207","21","46073906"
"chr5","93443779","93443898","chr5","52273168","52273294","26","41170611"
"chr5","93451619","93451795","chr16","13924788","13924974","59","79526831"
"chr5","93482504","93482799","chr5","52322590","52322884","32","41159914"
"chr5","93491376","93491511","chr16","61151245","61151382","32","32340131"
"chr5","93519575","93519831","chr5","52357878","52358134","29","41161697"
"chr5","93523032","93523341","chr5","52361549","52361864","39","41161483"
"chr5","93524088","93524267","chrX","119707772","119707943","57","26183684"
"chr5","93527977","93528276","chr19","48177297","48177594","67","45350680"
"chr5","93540631","93540911","chr5","56305390","56305681","62","37235241"
"chr5","93550873","93551154","chr5","52931490","52931772","37","40619383"
"chr5","93552708","93553003","chr5","52933331","52933641","43","40619377"
"chr5","93568028","93568325","chr5","52953621","52953922","47","40614407"
"chr5","93593753","93594050","chr5","52985134","52985425","48","40608619"
"chr5","93609638","93609841","chr1","6782842","6783038","58","86826796"
"chr5","93614945","93615235","chr5","53009080","53009376","36","40605865"
"chr5","93633498","93633782","chr5","53052527","53052816","26","40580971"
"chr5","93659035","93659320","chr10","46918114","46918393","54","46740921"
"chr5","93694874","93695050","chr3","53496963","53497131","49","40197911"
"chr5","93710579","93710858","chr5","53134696","53134986","34","40575883"
"chr5","93733641","93733847","chr15","43935081","43935266","61","49798560"
"chr5","93740885","93741102","chr7","44555416","44555635","49","49185469"
"chr5","93741366","93741445","chr19","18194834","18194910","20","75546532"
"chr5","93768630","93768940","chr5","53189402","53189660","77","40579228"
"chr5","93869167","93869439","chr5","53283865","53284143","30","40585302"
"chr5","93899509","93899555","chr10","85496323","85496373","9","8403186"
"chr5","93924685","93924958","chr5","53341585","53341839","69","40583100"
"chr5","93932038","93932273","chr8","85367582","85367802","71","8564456"
"chr5","93937721","93937999","chr5","53353887","53354201","60","40583834"
"chr5","93971278","93971413","chr15","47740161","47740299","33","46231117"
"chr5","93976646","93976958","chr8","49876349","49876656","73","44100297"
"chr5","94006250","94006530","chr3","45455705","45455977","61","48550545"
"chr5","94007306","94007622","chr5","53412411","53412709","53","40594895"
"chr5","94027174","94027374","chr11","12836569","12836773","46","81190605"
"chr5","94032034","94032313","chr5","53453235","53453511","29","40578799"
"chr5","94037117","94037262","chr2A","21072743","21072884","42","72964374"
"chr5","94039454","94039742","chr5","53483269","53483573","43","40556185"
"chr5","94052269","94052487","chr5","59229232","59229447","60","34823037"
"chr5","94076046","94076242","chr5","53523691","53523885","25","40552355"
"chr5","94079409","94079709","chr5","53526989","53527291","40","40552420"
"chr5","94079966","94080186","chr5","53527555","53527761","40","40552411"
"chr5","94080835","94081036","chr9","106169411","106169607","36","12088576"
"chr5","94108677","94108969","chr5","53539730","53540013","38","40568947"
"chr5","94114695","94114978","chr5","53546017","53546304","34","40568678"
"chr5","94133379","94133647","chr5","53564489","53564790","60","40568890"
"chr5","94149301","94149583","chr5","53578088","53578374","29","40571213"
"chr5","94152352","94152641","chr5","53580576","53580863","34","40571776"
"chr5","94164285","94164468","chr3","128457408","128457590","40","34293123"
"chr5","94183764","94184027","chr5","53618674","53618954","42","40565090"
"chr5","94248028","94248330","chr5","53687211","53687489","54","40560817"
"chr5","94253458","94253769","chr4","8844727","8845023","81","85408731"
"chr5","94256183","94256305","chr5","53694455","53694578","13","40561728"
"chr5","94260117","94260383","chr5","53699185","53699451","30","40560932"
"chr5","94260882","94261187","chr5","53699944","53700270","43","40560938"
"chr5","94292083","94292360","chr5","53738041","53738317","28","40554042"
"chr5","94293044","94293258","chr14","74553998","74554217","60","19739046"
"chr5","94375360","94375631","chr3","77257064","77257337","81","17118296"
"chr5","94382372","94382666","chr5","53821287","53821578","32","40561085"
"chr5","94397354","94397519","chr2A","43105214","43105373","39","51292140"
"chr5","94403729","94404009","chr5","53839244","53839545","55","40564485"
"chr5","94411598","94411823","chr3","129685422","129685638","61","35273824"
"chr5","94483975","94484242","chr5","53917578","53917853","53","40566397"
"chr5","94499231","94499517","chr5","53931706","53931998","38","40567525"
"chr5","94506853","94507078","chr5","53937592","53937817","31","40569261"
"chr5","94512043","94512306","chr5","53943028","53943312","46","40569015"
"chr5","94527586","94527858","chr3","174555271","174555553","72","80027685"
"chr5","94531847","94531922","chr2A","17566916","17566990","10","76964931"
"chr5","94546761","94547058","chr8","85614994","85615292","63","8931767"
"chr5","94563199","94563487","chr1","227415933","227416230","71","132852734"
"chr5","94564612","94564908","chr6","160475479","160475773","62","65910867"
"chr5","94584070","94584363","chr5","54010995","54011287","24","40573075"
"chr5","94591409","94591693","chr12","125351377","125351669","65","30759968"
"chr5","94599917","94600164","chr5","54021025","54021266","40","40578892"
"chr5","94624696","94624809","chr1","129719798","129719915","23","35095102"
"chr5","94660210","94660488","chr13","18247543","18247829","62","76412667"
"chr5","94671113","94671375","chr5","54086680","54086947","58","40584433"
"chr5","94674870","94675188","chr10","16534437","16534738","86","78140433"
"chr5","94684418","94684542","chr5","54098889","54099012","11","40585529"
"chr5","94694398","94694707","chr5","54111610","54111918","55","40582788"
"chr5","94699044","94699332","chr22","19585665","19585957","54","75113379"
"chr5","94699333","94699466","chr19","55794541","55794676","38","38904792"
"chr5","94748538","94748841","chr2B","53629601","53629902","66","41118937"
"chr5","94775059","94775356","chr16","25421955","25422246","67","69353104"
"chr5","94781869","94782178","chr3","58203092","58203388","70","36578777"
"chr5","94793401","94793675","chr5","54196536","54196828","64","40596865"
"chr5","94809670","94809925","chr4","98772403","98772639","72","3962733"
"chr5","94817406","94817511","chr4","40592737","40592842","23","54224669"
"chr5","94819289","94819510","chr10","12495988","12496203","65","82323301"
"chr5","94849159","94849466","chr5","54252666","54252969","43","40596493"
"chr5","94855008","94855109","chr10","117001518","117001614","13","22146510"
"chr5","94859067","94859363","chr1","227415933","227416230","58","132556866"
"chr5","94864197","94864493","chr5","54269821","54270101","56","40594376"
"chr5","94869988","94870276","chr5","54274551","54274840","42","40595437"
"chr5","94902613","94902893","chr5","54313599","54313891","36","40589014"
"chr5","94913580","94913851","chr19","57495657","57495940","73","37417923"
"chr5","94928384","94928485","chr4","8625041","8625142","20","86303343"
"chr5","94928563","94928580","chr5","102281481","102281494","5","7352918"
"chr5","94928847","94929006","chr7","65716406","65716564","31","29212441"
"chr5","94930941","94931208","chrX","24116204","24116475","73","70814737"
"chr5","95019942","95020112","chr15","67737918","67738076","41","27282024"
"chr5","95041510","95041605","chr11","10004268","10004364","21","85037242"
"chr5","95042215","95042495","chr5","54451250","54451566","54","40590965"
"chr5","95058538","95058834","chr5","54465665","54465966","51","40592873"
"chr5","95122269","95122503","chr5","54526907","54527173","54","40595362"
"chr5","95142437","95142719","chr5","54547340","54547598","60","40595097"
"chr5","95165873","95166099","chr5","54570253","54570482","32","40595620"
"chr5","95194804","95195089","chr5","54597380","54597678","43","40597424"
"chr5","95195846","95196127","chr5","147416279","147416565","60","52220433"
"chr5","95221430","95221557","chr2B","118258569","118258688","27","23037139"
"chr5","95225028","95225304","chr7","2959934","2960208","61","92265094"
"chr5","95231525","95231687","chr17","18297789","18297962","48","76933736"
"chr5","95240901","95241037","chr5","54643832","54643985","25","40597069"
"chr5","95242007","95242302","chr6","161460656","161460951","59","66218649"
"chr5","95259278","95259558","chr1","27556866","27557137","74","67702412"
"chr5","95270848","95271128","chr5","54669148","54669442","47","40601700"
"chr5","95279912","95280076","chr5","54678178","54678341","15","40601734"
"chr5","95289910","95290034","chr5","54686944","54687068","12","40602966"
"chr5","95295433","95295701","chr7","4754701","4754955","62","90540732"
"chr5","95341135","95341218","chr5","40734755","40734844","26","54606380"
"chr5","95353987","95354275","chr19","17067086","17067353","69","78286901"
"chr5","95363884","95364019","chr3","123554311","123554442","28","28190427"
"chr5","95416155","95416403","chr5","60787675","60787923","59","34628480"
"chr5","95454767","95455059","chr6","21022976","21023269","67","74431791"
"chr5","95467854","95468147","chr11","33063879","33064183","54","62403975"
"chr5","95554755","95555041","chr5","54906439","54906710","57","40648316"
"chr5","95579514","95579673","chr8","25551358","25551514","33","70028156"
"chr5","95588753","95589039","chr5","54939729","54940020","46","40649024"
"chr5","95643648","95643879","chr5","54994349","54994575","40","40649299"
"chr5","95698573","95698724","chr16","3502958","3503112","40","92195615"
"chr5","95714522","95714823","chr5","55064550","55064850","32","40649972"
"chr5","95720342","95720633","chr16","28072419","28072718","58","67647923"
"chr5","95831523","95831797","chr5","55183837","55184103","31","40647686"
"chr5","95838241","95838542","chr5","55190546","55190843","56","40647695"
"chr5","95847820","95848092","chr3","126715781","126716057","62","30867961"
"chr5","95850112","95850208","chr7","44654252","44654346","20","51195860"
"chr5","95850311","95850405","chr3","58857961","58858058","19","36992350"
"chr5","95868441","95868737","chr3","14630632","14630929","70","81237809"
"chr5","95870853","95871141","chr12","28126504","28126789","61","67744349"
"chr5","95887271","95887573","chr10","85082966","85083267","68","10804305"
"chr5","95926536","95926826","chr1","203176264","203176559","57","107249728"
"chr5","95958920","95959026","chr3","32558926","32559033","19","63399994"
"chr5","95959738","95959857","chr5","55377785","55377903","15","40581953"
"chr5","95978758","95978862","chr13","9559854","9559959","22","86418904"
"chr5","95996303","95996605","chrX","10384333","10384632","67","85611970"
"chr5","96021902","96022139","chr5","20800139","20800372","58","75221763"
"chr5","96031846","96032133","chr10","25303615","25303901","71","70728231"
"chr5","96085733","96085883","chr5","4272991","4273140","33","91812742"
"chr5","96086704","96086841","chr19","54938369","54938502","23","41148335"
"chr5","96095945","96096243","chr5","55499169","55499421","67","40596776"
"chr5","96096287","96096587","chr12","124770405","124770707","61","28674118"
"chr5","96102417","96102647","chr18","55165662","55165888","58","40936755"
"chr5","96141225","96141340","chr8","61788472","61788590","33","34352753"
"chr5","96141859","96141977","chr1","86998197","86998318","21","9143662"
"chr5","96145251","96145541","chr5","55539325","55539625","39","40605926"
"chr5","96153877","96154040","chr17","34542397","34542554","38","61611480"
"chr5","96173808","96174105","chr5","55567265","55567545","46","40606543"
"chr5","96177359","96177653","chr5","55572810","55573106","47","40604549"
"chr5","96216089","96216370","chr5","55611132","55611425","54","40604957"
"chr5","96255146","96255447","chr5","55671246","55671544","54","40583900"
"chr5","96269283","96269581","chr5","55684499","55684796","44","40584784"
"chr5","96309026","96309280","chr3","187890527","187890793","62","91581501"
"chr5","96309573","96309626","chr1","54581230","54581277","15","41728343"
"chr5","96354020","96354320","chr5","55878371","55878690","53","40475649"
"chr5","96419146","96419259","chr18","22807872","22807981","27","73611274"
"chr5","96423360","96423633","chr16","1554262","1554542","67","94869098"
"chr5","96502037","96502337","chr7","2791295","2791587","77","93710742"
"chr5","96512932","96513038","chr5","56030298","56030404","7","40482634"
"chr5","96517886","96518123","chr20","47832868","47833113","48","48685018"
"chr5","96532709","96532960","chr16","33262324","33262582","44","63270385"
"chr5","96571133","96571264","chr3","131714172","131714304","23","35143039"
"chr5","96580285","96580567","chr5","56120311","56120594","29","40459974"
"chr5","96586145","96586405","chr5","56114498","56114782","53","40471647"
"chr5","96594120","96594404","chr5","56134447","56134743","51","40459673"
"chr5","96613784","96614089","chr5","56134447","56134743","50","40479337"
"chr5","96639052","96639329","chr1","7809815","7810096","66","88829237"
"chr5","96675063","96675289","chr17","2634591","2634813","50","94040472"
"chr5","96687472","96687764","chr5","56210887","56211189","59","40476585"
"chr5","96701693","96701822","chr7","138263854","138263978","41","41562161"
"chr5","96702223","96702335","chr9","91909520","91909629","20","4792703"
"chr5","96702980","96703211","chr10","115547160","115547392","76","18844180"
"chr5","96755398","96755550","chr16","49017109","49017265","32","47738289"
"chr5","96765712","96765989","chr5","2886208","2886496","67","93879504"
"chr5","96813494","96813771","chr19","1510634","1510923","55","95302860"
"chr5","96817099","96817396","chr17","4630687","4630996","63","92186412"
"chr5","96898700","96899001","chr8","48140579","48140877","62","48758121"
"chr5","96900005","96900148","chrX","2794957","2795096","38","94105048"
"chr5","96917314","96917613","chr7","152605284","152605577","53","55687970"
"chr5","96973670","96973959","chr7","5095566","5095848","63","91878104"
"chr5","96993514","96993674","chr7","152167110","152167278","37","55173596"
"chr5","97013297","97013629","chr17","4815940","4816276","39","92197357"
"chr5","97106923","97107095","chr10","115667294","115667466","35","18560371"
"chr5","97108145","97108275","chr2B","69793689","69793817","20","27314456"
"chr5","97112910","97113017","chr1","134625109","134625219","18","37512199"
"chr5","97114867","97114953","chr17","4909869","4909953","11","92204998"
"chr5","97146145","97146304","chr16","40647579","40647743","36","56498566"
"chr5","97178259","97178395","chr17","4971601","4971740","22","92206658"
"chr5","97180829","97181124","chr6","108378315","108378616","54","11197486"
"chr5","97199127","97199438","chr3","200749508","200749818","55","103550381"
"chr5","97234395","97234692","chr17","5029009","5029309","40","92205386"
"chr5","97250102","97250223","chrX","151068414","151068537","21","53818312"
"chr5","97261155","97261461","chr22","13341637","13341938","60","83919518"
"chr5","97280412","97280524","chr6","7105611","7105725","18","90174801"
"chr5","97280964","97281225","chr17","5135829","5136108","51","92145135"
"chr5","97317085","97317393","chr17","5165310","5165606","49","92151775"
"chr5","97319021","97319139","chr17","5166081","5166204","12","92152940"
"chr5","97327273","97327559","chr17","5175857","5176154","33","92151416"
"chr5","97360075","97360231","chrX","17937151","17937313","30","79422924"
"chr5","97408699","97408985","chr11","43222913","43223197","59","54185786"
"chr5","97427540","97427730","chr5","38842935","38843119","53","58584605"
"chr5","97427801","97427863","chr3","48624750","48624811","23","48803051"
"chr5","97445280","97445435","chr16","27925975","27926135","51","69519305"
"chr5","97447144","97447343","chr6","91035512","91035718","46","6411632"
"chr5","97467906","97468205","chr17","5288475","5288769","46","92179431"
"chr5","97475176","97475472","chr9","49037740","49038035","60","48437436"
"chr5","97491161","97491492","chrX","209211","209508","78","97281950"
"chr5","97558225","97558527","chr17","5374657","5374955","38","92183568"
"chr5","97569150","97569348","chr17","5386056","5386249","30","92183094"
"chr5","97622389","97622504","chr17","5434439","5434554","14","92187950"
"chr5","97651261","97651363","chr4","153106200","153106312","18","55454939"
"chr5","97671648","97671792","chr3","13125313","13125458","36","84546335"
"chr5","97676361","97676513","chr14","9989811","9989964","39","87686550"
"chr5","97681883","97682166","chr21","35390505","35390778","64","62291378"
"chr5","97708552","97708844","chr6","27134047","27134337","71","70574505"
"chr5","97760330","97760640","chr17","5560505","5560804","45","92199825"
"chr5","97811302","97811427","chr17","5613806","5613929","18","92197496"
"chr5","97903887","97904154","chr17","5699835","5700101","38","92204052"
"chr5","97938066","97938358","chr4","152323211","152323483","70","54385145"
"chr5","97975841","97976131","chr1","163867986","163868280","59","65892145"
"chr5","98040593","98040731","chr5","3296328","3296466","36","94744265"
"chr5","98041314","98041434","chr17","5843488","5843608","18","92197826"
"chr5","98117890","98118191","chr5","56082283","56082594","41","42035607"
"chr5","98128529","98128814","chr5","56120311","56120594","29","42008218"
"chr5","98193502","98193762","chr17","5957080","5957354","51","92236422"
"chr5","98527811","98528109","chr19","40581565","40581864","60","57946246"
"chr5","98562606","98562834","chr17","6317225","6317461","30","92245381"
"chr5","98600357","98600627","chr17","6363168","6363424","44","92237189"
"chr5","98609094","98609335","chr17","6378338","6378573","57","92230756"
"chr5","98737893","98738197","chr7","126860755","126861058","61","28122862"
"chr5","98834613","98834902","chr17","6589469","6589752","50","92245144"
"chr5","98891462","98891749","chr5","25243474","25243763","33","73647988"
"chr5","98893223","98893522","chr10","130032377","130032685","47","31139154"
"chr5","98973927","98974208","chr17","29107217","29107503","61","69866710"
"chr5","98996039","98996251","chr12","109090099","109090301","53","10094060"
"chr5","98999284","98999403","chr1","88668872","88668989","19","10330412"
"chr5","99038563","99038841","chr2B","92785159","92785437","58","6253404"
"chr5","99042108","99042259","chr19","48705548","48705708","35","50336560"
"chr5","99067060","99067367","chr5","24602386","24602684","43","74464674"
"chr5","99073649","99073760","chr16","1757502","1757610","23","97316147"
"chr5","99088230","99088535","chr1","38463296","38463596","54","60624934"
"chr5","99092514","99092823","chr5","24602386","24602684","47","74490128"
"chr5","99097322","99097433","chr11","47286107","47286218","23","51811215"
"chr5","99104944","99105128","chr3","24563943","24564133","38","74541001"
"chr5","99150153","99150283","chr6","48492641","48492762","32","50657512"
"chr5","99159583","99159872","chr5","24695079","24695374","61","74464504"
"chr5","99164594","99164717","chr8","95563303","95563425","20","3601291"
"chr5","99284695","99284811","chr5","25268578","25268694","4","74016117"
"chr5","99288335","99288639","chr5","25271085","25271360","60","74017250"
"chr5","99348286","99348544","chr5","25333123","25333403","43","74015163"
"chr5","99366149","99366295","chr3","267312","267456","38","99098837"
"chr5","99366332","99366367","chrX","15471212","15471242","13","83895120"
"chr5","99409404","99409727","chr5","25393923","25394236","38","74015481"
"chr5","99446234","99446523","chr5","25432835","25433136","44","74013399"
"chr5","99447483","99447783","chr5","25434483","25434760","65","74013000"
"chr5","99481849","99482116","chr5","25469036","25469313","33","74012813"
"chr5","99515022","99515228","chr11","47592267","47592453","42","51922755"
"chr5","99542359","99542675","chr5","25529961","25530259","39","74012398"
"chr5","99546415","99546700","chr5","25534633","25534945","58","74011782"
"chr5","99552340","99552656","chr7","72575619","72575936","69","26976721"
"chr5","99555991","99556295","chr5","25543475","25543772","64","74012516"
"chr5","99691265","99691398","chr5","25669923","25670056","15","74021342"
"chr5","99703078","99703354","chr5","25681475","25681754","32","74021603"
"chr5","99734706","99734975","chrX","46258081","46258343","65","53476625"
"chr5","99779863","99779980","chr7","79632970","79633083","25","20146893"
"chr5","99800855","99801140","chr22","8408725","8409012","68","91392130"
"chr5","99941990","99942294","chr19","2366218","2366516","63","97575772"
"chr5","99953122","99953439","chr5","25924817","25925129","59","74028305"
"chr5","100012207","100012507","chr5","25986801","25987102","65","74025406"
"chr5","100080979","100081102","chr5","26052045","26052174","18","74028934"
"chr5","100093793","100094050","chr5","26064424","26064684","43","74029369"
"chr5","100115371","100115660","chr5","26085795","26086111","56","74029576"
"chr5","100127594","100127885","chr5","26098198","26098495","37","74029396"
"chr5","100174793","100175108","chr5","26144569","26144881","48","74030224"
"chr5","100185404","100185641","chr1","19646006","19646255","62","80539398"
"chr5","100213523","100213723","chr5","26184119","26184312","28","74029404"
"chr5","100213779","100213890","chr20","34541327","34541443","20","65672452"
"chr5","100244753","100245051","chr5","26213771","26214067","40","74030982"
"chr5","100253233","100253342","chr5","26222602","26222719","21","74030631"
"chr5","100280949","100281260","chr5","26250448","26250758","38","74030501"
"chr5","100310764","100311032","chr5","26279842","26280121","54","74030922"
"chr5","100348477","100348791","chr3","15699392","15699703","79","84649085"
"chr5","100352771","100353068","chr19","12480752","12481043","77","87872019"
"chr5","100361405","100361699","chr5","26326406","26326705","33","74034999"
"chr5","100368352","100368647","chr5","26334630","26334916","48","74033722"
"chr5","100380487","100380773","chr5","26343455","26343755","56","74037032"
"chr5","100380988","100381124","chr10","12650705","12650831","46","87730283"
"chr5","100383061","100383185","chr3","43539926","43540049","24","56843135"
"chr5","100389293","100389530","chr8","85713029","85713267","46","14676264"
"chr5","100410903","100411058","chr1","205548459","205548612","40","105137556"
"chr5","100412076","100412222","chr7","18238538","18238683","31","82173538"
"chr5","100412242","100412309","chr7","68088516","68088583","16","32323726"
"chr5","100420453","100420552","chr4","40213680","40213777","19","60206773"
"chr5","100422430","100422718","chr6","25903846","25904123","74","74518584"
"chr5","100435524","100435668","chr5","26401144","26401286","20","74034380"
"chr5","100491480","100491779","chr6","7590116","7590420","65","92901364"
"chr5","100509703","100510007","chr5","26487404","26487672","64","74022299"
"chr5","100535979","100536144","chr9","94824992","94825159","34","5710987"
"chr5","100536689","100536806","chr4","153009623","153009744","29","52472934"
"chr5","100603899","100604044","chr17","23227302","23227448","35","77376597"
"chr5","100685163","100685298","chr5","26663357","26663492","16","74021806"
"chr5","100694419","100694509","chr6","132241886","132241982","27","31547467"
"chr5","100701627","100701772","chr9","111000966","111001103","39","10299339"
"chr5","100723474","100723797","chr5","26701704","26702027","57","74021770"
"chr5","100731627","100731928","chr5","26713057","26713373","55","74018570"
"chr5","100745291","100745472","chr5","26726255","26726431","27","74019036"
"chr5","100815846","100816117","chr5","26798090","26798384","55","74017756"
"chr5","100859480","100859745","chr5","26840666","26840956","54","74018814"
"chr5","100883607","100883918","chr5","26861378","26861683","41","74022229"
"chr5","101009270","101009571","chr10","35128703","35128986","90","65880567"
"chr5","101119583","101119809","chr9","12532981","12533206","58","88586602"
"chr5","101170430","101170538","chr13","1340797","1340901","22","99829633"
"chr5","101236041","101236226","chr5","27220691","27220886","32","74015350"
"chr5","101320134","101320441","chr5","27298745","27299050","63","74021389"
"chr5","101324317","101324593","chr5","27303399","27303690","45","74020918"
"chr5","101372930","101373034","chr5","27358215","27358317","14","74014715"
"chr5","101528952","101529252","chr5","27556441","27556747","47","73972511"
"chr5","101626294","101626398","chr16","1757502","1757610","20","99868792"
"chr5","101722968","101723202","chr16","81310933","81311159","58","20412035"
"chr5","101776181","101776504","chr5","27828121","27828407","73","73948060"
"chr5","101781930","101782227","chr6","35572715","35573011","67","66209215"
"chr5","101786909","101787219","chr5","27850483","27850792","42","73936426"
"chr5","101812267","101812416","chr7","70842983","70843136","34","30969284"
"chr5","101830391","101830682","chr6","130836067","130836367","68","29005676"
"chr5","101837616","101837890","chr5","27893909","27894198","42","73943707"
"chr5","101841657","101841911","chr7","127635564","127635807","55","25793907"
"chr5","101851197","101851478","chr5","27909220","27909508","39","73941977"
"chr5","101862017","101862255","chr7","71812434","71812663","66","30049583"
"chr5","101863009","101863136","chr20","5893261","5893384","28","95969748"
"chr5","101871872","101872168","chr5","27939602","27939902","48","73932270"
"chr5","101910618","101910919","chr19","9663584","9663881","50","92247034"
"chr5","101944847","101945167","chr5","28014833","28015108","73","73930014"
"chr5","102022191","102022361","chr22","7262484","7262651","42","94759707"
"chr5","102027518","102027811","chr5","28093459","28093753","41","73934059"
"chr5","102087612","102087875","chr16","65421786","65422047","67","36665826"
"chr5","102102175","102102443","chr5","28169949","28170217","49","73932226"
"chr5","102168128","102168279","chr1","193134715","193134856","40","90966587"
"chr5","102182815","102183086","chr6","18651544","18651813","68","83531271"
"chr5","102209656","102209975","chr5","28265020","28265305","55","73944636"
"chr5","102252878","102252977","chr5","28334584","28334687","16","73918294"
"chr5","102273002","102273307","chr5","28355163","28355460","66","73917839"
"chr5","102300804","102301060","chr1","94463809","94464075","66","7836995"
"chr5","102341884","102341992","chr5","28425087","28425208","23","73916797"
"chr5","102369723","102369972","chr5","28457594","28457842","30","73912129"
"chr5","102377807","102378111","chr7","6450288","6450581","67","95927519"
"chr5","102515135","102515435","chr5","28590450","28590767","62","73924685"
"chr5","102666734","102667037","chr5","28730585","28730887","35","73936149"
"chr5","102733662","102733896","chr16","77454385","77454635","67","25279277"
"chr5","102877114","102877391","chr5","29006922","29007223","60","73870192"
"chr5","103367306","103367590","chr5","6548917","6549207","79","96818389"
"chr5","103499421","103499543","chr19","41275833","41275962","38","62223588"
"chr5","103499697","103499822","chr1","214163153","214163277","25","110663456"
"chr5","103551904","103552195","chr5","29673210","29673493","51","73878694"
"chr5","103742002","103742298","chr5","29865857","29866166","57","73876145"
"chr5","103803632","103803811","chr3","143883727","143883895","39","40080095"
"chr5","103894360","103894529","chr11","10692775","10692938","44","93201585"
"chr5","104089081","104089373","chr5","30187734","30188028","59","73901347"
"chr5","104622708","104622976","chr1","94463809","94464075","64","10158899"
"chr5","104625028","104625204","chr9","77577070","77577240","53","27047958"
"chr5","104674553","104674865","chr1","91059171","91059456","80","13615382"
"chr5","104761888","104762060","chr1","225275741","225275914","44","120513853"
"chr5","104997325","104997402","chr9","74215152","74215228","17","30782173"
"chr5","105046269","105046580","chr5","31044397","31044711","53","74001872"
"chr5","105093267","105093382","chrX","16504327","16504444","26","88588940"
"chr5","105093410","105093503","chr5","62223480","62223570","31","42869930"
"chr5","105199891","105200144","chr5","31199741","31200003","29","74000150"
"chr5","105210269","105210473","chr5","31209132","31209337","31","74001137"
"chr5","105336280","105336605","chr5","31318468","31318783","45","74017812"
"chr5","105571580","105571672","chr5","31538662","31538754","12","74032918"
"chr5","105572088","105572224","chr1","68709407","68709549","33","36862681"
"chr5","105669029","105669153","chr5","31630445","31630570","19","74038584"
"chr5","105820118","105820416","chr16","19927503","19927802","65","85892615"
"chr5","105914703","105915004","chr5","31777564","31777865","41","74137139"
"chr5","105926043","105926166","chr5","124432264","124432393","32","18506221"
"chr5","105948800","105949090","chr5","31806518","31806817","37","74142282"
"chr5","105980781","105981083","chr5","31830959","31831250","35","74149822"
"chr5","106001734","106002042","chr5","31845058","31845389","53","74156676"
"chr5","106078639","106078769","chr5","31916509","31916632","16","74162130"
"chr5","106105849","106106143","chr1","45473217","45473515","62","60632632"
"chr5","106126038","106126319","chr5","31939748","31940022","43","74186290"
"chr5","106129660","106129805","chr10","101988216","101988372","42","4141444"
"chr5","106156119","106156429","chr5","31963738","31964053","32","74192381"
"chr5","106216932","106217141","chr8","100864437","100864645","45","5352495"
"chr5","106291992","106292107","chr17","548707","548821","18","105743285"
"chr5","106346284","106346621","chr6","31412682","31412994","87","74933602"
"chr5","106349978","106350283","chr5","32178476","32178784","45","74171502"
"chr5","106354266","106354389","chr14","79270501","79270624","21","27083765"
"chr5","106354429","106354550","chr5","32182904","32183025","13","74171525"
"chr5","106357010","106357111","chr20","5609024","5609122","22","100747986"
"chr5","106380615","106380912","chr5","32204824","32205138","57","74175791"
"chr5","106387861","106388144","chr5","32212365","32212655","36","74175496"
"chr5","106414436","106414724","chr5","32226344","32226631","59","74188092"
"chr5","106419528","106419689","chr15","18799975","18800140","33","87619553"
"chr5","106445540","106445706","chr16","47186607","47186777","42","59258933"
"chr5","106497304","106497603","chr5","32310809","32311109","37","74186495"
"chr5","106515863","106516179","chr5","32338574","32338845","70","74177289"
"chr5","106531314","106531426","chr4","177917580","177917697","18","71386266"
"chr5","106533826","106534124","chr5","23931488","23931783","60","82602338"
"chr5","106564927","106565182","chr7","68499744","68499997","56","38065183"
"chr5","106565190","106565337","chr12","29807232","29807384","32","76757958"
"chr5","106571002","106571257","chr10","116949348","116949602","63","10378346"
"chr5","106572246","106572527","chr5","32393418","32393696","26","74178828"
"chr5","106608978","106609258","chr1","26778910","26779195","62","79830068"
"chr5","106611775","106612072","chr5","32430096","32430410","43","74181679"
"chr5","106670966","106671268","chr5","32497677","32497988","40","74173289"
"chr5","106674722","106674799","chr7","72323128","72323205","16","34351594"
"chr5","106696338","106696634","chr5","32525473","32525781","58","74170865"
"chr5","106749046","106749223","chr5","32582002","32582178","22","74167044"
"chr5","106750539","106750649","chr5","32583069","32583191","20","74167470"
"chr5","106781218","106781375","chr5","32621516","32621676","18","74159702"
"chr5","106798329","106798590","chr5","32633671","32633932","59","74164658"
"chr5","106856933","106857090","chr3","49411661","49411824","34","57445272"
"chr5","106878195","106878305","chr5","32701018","32701136","15","74177177"
"chr5","106909280","106909510","chr1","217294594","217294821","46","110385314"
"chr5","106916674","106916947","chr5","32736167","32736463","50","74180507"
"chr5","106967206","106967495","chr5","32789262","32789552","28","74177944"
"chr5","106989898","106990061","chr8","22102791","22102953","39","84887107"
"chr5","106991080","106991233","chr14","32253198","32253363","44","74737882"
"chr5","107074621","107074742","chr5","32890086","32890204","16","74184535"
"chr5","107085961","107086272","chr5","32901991","32902289","47","74183970"
"chr5","107105704","107105968","chr10","91253379","91253646","55","15852325"
"chr5","107159661","107159755","chr18","29375716","29375801","22","77783945"
"chr5","107161411","107161540","chr5","32990072","32990202","18","74171339"
"chr5","107165405","107165536","chr16","47930036","47930168","26","59235369"
"chr5","107176277","107176566","chr5","33011623","33011912","40","74164654"
"chr5","107178763","107179065","chr5","33014099","33014396","46","74164664"
"chr5","107201609","107201878","chr13","93599022","93599301","70","13602587"
"chr5","107203058","107203336","chr17","13045832","13046119","57","94157226"
"chr5","107236448","107236609","chr7","106533466","106533634","31","702982"
"chr5","107241074","107241364","chr5","33068247","33068551","41","74172827"
"chr5","107241428","107241474","chr2A","38801178","38801227","13","68440250"
"chr5","107242105","107242385","chr5","33069261","33069543","39","74172844"
"chr5","107247079","107247198","chr9","15394099","15394221","25","91852980"
"chr5","107282388","107282499","chr3","78872451","78872574","26","28409937"
"chr5","107317637","107317788","chr5","33166698","33166848","15","74150939"
"chr5","107327073","107327190","chr7","68275138","68275242","38","39051935"
"chr5","107339091","107339379","chr5","33187395","33187694","42","74151696"
"chr5","107344268","107344576","chr5","33237057","33237367","30","74107211"
"chr5","107394560","107394789","chr8","86080660","86080885","48","21313900"
"chr5","107418262","107418500","chr14","52619869","52620109","52","54798393"
"chr5","107457065","107457367","chrX","40660160","40660460","61","66796905"
"chr5","107466183","107466334","chr1","207187010","207187159","32","99720827"
"chr5","107576925","107577060","chr5","33512595","33512727","22","74064330"
"chr5","107592911","107593160","chr19","39991226","39991480","72","67601685"
"chr5","107611032","107611158","chr20","24234554","24234683","22","83376478"
"chr5","107635688","107635970","chr6","150118641","150118920","64","42482953"
"chr5","107636731","107637035","chr5","33581568","33581877","56","74055163"
"chr5","107638061","107638145","chr1","9729337","9729420","17","97908724"
"chr5","107657875","107658167","chr5","33600599","33600900","34","74057276"
"chr5","107661268","107661576","chr5","33602996","33603302","43","74058272"
"chr5","107672233","107672515","chr7","1708256","1708538","55","105963977"
"chr5","107691047","107691338","chr5","33630954","33631259","51","74060093"
"chr5","107718159","107718436","chr5","33657329","33657612","49","74060830"
"chr5","107793241","107793588","chr5","33733606","33733956","43","74059635"
"chr5","107811305","107811496","chr8","98909960","98910147","39","8901345"
"chr5","107849418","107849583","chr22","4243708","4243880","36","103605710"
"chr5","107853255","107853551","chr5","33789269","33789555","49","74063986"
"chr5","107984671","107984971","chr1","54994232","54994533","61","52990439"
"chr5","108005896","108006161","chr5","33942780","33943061","50","74063116"
"chr5","108017223","108017347","chr20","30238448","30238572","18","77778775"
"chr5","108050618","108050839","chr11","68057172","68057393","55","39993446"
"chr5","108059769","108060030","chr20","47805363","47805622","58","60254406"
"chr5","108072283","108072553","chr1","154743896","154744180","64","46671613"
"chr5","108098798","108099092","chr18","2335354","2335647","59","105763444"
"chr5","108147447","108147725","chr2A","21540939","21541208","67","86606508"
"chr5","108151857","108152071","chr5","34080259","34080490","35","74071598"
"chr5","108178413","108178688","chr5","34102576","34102853","38","74075837"
"chr5","108184723","108185013","chr5","34108408","34108711","46","74076315"
"chr5","108202053","108202170","chr16","9355889","9355998","27","98846164"
"chr5","108216059","108216362","chr5","34134119","34134403","56","74081940"
"chr5","108220823","108221121","chr10","114288749","114289045","55","6067926"
"chr5","108256876","108257145","chr15","46478157","46478423","61","61778719"
"chr5","108275182","108275429","chr5","34192040","34192286","42","74083142"
"chr5","108288361","108288655","chr5","34214832","34215136","32","74073529"
"chr5","108339819","108340115","chr5","34262323","34262621","51","74077496"
"chr5","108347254","108347405","chr7","77655981","77656136","30","30691273"
"chr5","108371689","108371803","chr6","20880454","20880561","29","87491235"
"chr5","108388332","108388470","chr13","1433575","1433714","33","106954757"
"chr5","108417501","108417754","chr5","34340671","34340941","37","74076830"
"chr5","108467071","108467388","chr5","34383894","34384205","46","74083177"
"chr5","108471623","108471863","chr11","9500001","9500246","66","98971622"
"chr5","108472482","108472595","chr5","34396929","34397042","14","74075553"
"chr5","108476002","108476228","chr6","39171411","39171640","49","69304591"
"chr5","108514784","108515053","chr5","34437485","34437759","38","74077299"
"chr5","108518042","108518319","chr5","34443625","34443892","48","74074417"
"chr5","108518471","108518595","chr1","215271336","215271467","29","106752865"
"chr5","108526376","108526672","chr5","34451913","34452216","54","74074463"
"chr5","108560774","108561048","chr5","40769893","40770169","65","67790881"
"chr5","108567222","108567384","chr20","55603343","55603508","33","52963879"
"chr5","108568853","108569124","chr5","34494723","34494992","52","74074130"
"chr5","108639255","108639488","chr6","38953072","38953315","60","69686183"
"chr5","108646453","108646583","chr5","34567595","34567712","25","74078858"
"chr5","108656710","108656817","chr5","34579349","34579456","6","74077361"
"chr5","108672485","108672605","chr7","94443174","94443301","25","14229311"
"chr5","108673509","108673636","chr12","85305505","85305637","25","23368004"
"chr5","108674730","108675025","chr1","225020203","225020489","57","116345473"
"chr5","108680712","108681021","chr5","34600645","34600948","66","74080067"
"chr5","108689202","108689496","chr5","34609007","34609301","59","74080195"
"chr5","108693592","108693892","chr12","106398759","106399020","101","2294833"
"chr5","108702466","108702710","chr5","34621219","34621482","42","74081247"
"chr5","108813864","108814157","chr5","34728084","34728368","43","74085780"
"chr5","108823207","108823401","chr5","63145603","63145814","61","45677604"
"chr5","108824649","108824952","chr20","30599181","30599483","62","78225468"
"chr5","108865671","108865783","chr12","123581119","123581230","16","14715448"
"chr5","108865929","108866117","chr5","26184119","26184312","43","82681810"
"chr5","108893531","108893692","chr19","5169265","5169417","39","103724266"
"chr5","108894481","108894607","chr3","188313519","188313645","19","79419038"
"chr5","109026350","109026516","chr4","61055093","61055253","34","47971257"
"chr5","109027492","109027798","chr10","124980454","124980759","62","15952962"
"chr5","109048388","109048680","chr7","70183490","70183784","69","38864898"
"chr5","109058437","109058736","chr5","34962978","34963278","39","74095459"
"chr5","109085849","109086155","chr6","108642142","108642442","65","443707"
"chr5","109090492","109090588","chr7","101404390","101404484","20","7686102"
"chr5","109097206","109097490","chr1","227415933","227416230","66","118318727"
"chr5","109099513","109099569","chr1","216816506","216816561","16","107716993"
"chr5","109104356","109104672","chr5","35005670","35005978","47","74098686"
"chr5","109119640","109119898","chr4","26702666","26702913","71","82416974"
"chr5","109146491","109146659","chrX","20106460","20106625","41","89040031"
"chr5","109174444","109174747","chr5","35076030","35076336","42","74098414"
"chr5","109253562","109253838","chr5","35152466","35152757","53","74101096"
"chr5","109282736","109283024","chr5","35180313","35180572","51","74102423"
"chr5","109292196","109292502","chr5","22122273","22122586","64","87169923"
"chr5","109301651","109301963","chr5","35202123","35202429","60","74099528"
"chr5","109334913","109335211","chr12","110974191","110974489","55","1639278"
"chr5","109389540","109389816","chr10","102004119","102004395","66","7385421"
"chr5","109461744","109461961","chr2A","91260160","91260375","41","18201584"
"chr5","109465616","109465959","chr5","35372883","35373220","40","74092733"
"chr5","109467303","109467614","chr8","98755171","98755484","52","10712132"
"chr5","109475161","109475394","chr7","65864668","65864898","59","43610493"
"chr5","109490804","109490943","chr7","26316442","26316573","23","83174362"
"chr5","109494794","109494916","chrX","107420734","107420856","24","2074060"
"chr5","109501312","109501592","chr14","86002350","86002625","67","23498962"
"chr5","109509073","109509331","chr5","35412908","35413166","26","74096165"
"chr5","109518541","109518839","chr5","35424658","35424966","52","74093883"
"chr5","109633474","109633598","chr20","5893261","5893384","29","103740213"
"chr5","109672597","109672865","chr16","30318017","30318281","44","79354580"
"chr5","109684957","109685272","chr5","35575554","35575848","56","74109403"
"chr5","109686488","109686777","chr18","33367015","33367331","66","76319473"
"chr5","109687955","109688107","chr3","43594842","43594998","35","66093113"
"chr5","109701114","109701410","chr5","35589901","35590199","40","74111213"
"chr5","109705304","109705415","chr12","123792699","123792816","18","14087395"
"chr5","109718595","109718879","chr7","44334451","44334729","62","65384144"
"chr5","109728601","109728813","chr13","7150448","7150655","37","102578153"
"chr5","109745777","109746078","chr5","35633372","35633695","50","74112405"
"chr5","109780725","109781028","chr10","17607862","17608158","57","92172863"
"chr5","109814662","109814786","chr14","44741725","44741854","27","65072937"
"chr5","109830602","109830890","chr5","35711247","35711524","52","74119355"
"chr5","109849642","109849807","chr16","73147198","73147345","35","36702444"
"chr5","109866914","109867180","chr5","35747236","35747525","45","74119678"
"chr5","109868772","109869063","chr5","35748603","35748902","49","74120169"
"chr5","109958500","109958648","chr10","27964289","27964440","37","81994211"
"chr5","109958968","109959087","chr12","120369817","120369938","30","10410849"
"chr5","109961448","109961680","chr8","24449342","24449564","78","85512106"
"chr5","109985210","109985374","chr5","35865708","35865877","23","74119502"
"chr5","110052752","110053058","chr5","45301285","45301584","44","64751467"
"chr5","110054516","110054674","chr4","61055093","61055253","39","48999423"
"chr5","110068512","110068816","chr10","46224519","46224822","58","63843993"
"chr5","110142348","110142623","chr5","45221573","45221857","45","64920775"
"chr5","110154958","110155220","chr5","36019675","36019943","33","74135283"
"chr5","110181201","110181469","chr1","43933727","43933985","72","66247474"
"chr5","110214572","110214879","chr5","45154468","45154759","59","65060104"
"chr5","110220669","110220967","chr3","138553037","138553310","76","28332368"
"chr5","110249520","110249657","chr7","26158438","26158564","38","84091082"
"chr5","110250267","110250511","chr20","4587965","4588229","65","105662302"
"chr5","110281852","110281930","chr1","52720253","52720332","14","57561599"
"chr5","110282145","110282345","chr8","18127927","18128121","46","92154218"
"chr5","110286466","110286750","chr5","45088510","45088801","28","65197956"
"chr5","110294517","110294674","chr16","49017109","49017265","30","61277408"
"chr5","110340708","110341041","chr16","30606251","30606568","81","79734457"
"chr5","110342533","110342829","chr16","31930062","31930353","60","78412471"
"chr5","110352186","110352348","chr5","62885644","62885808","32","47466542"
"chr5","110360898","110361186","chr16","33098955","33099251","54","77261943"
"chr5","110373314","110373663","chr12","108745776","108746083","97","1627538"
"chr5","110434327","110434455","chr19","37526707","37526833","34","72907620"
"chr5","110434558","110434746","chr1","6821264","6821455","39","103613294"
"chr5","110468209","110468331","chr5","44904529","44904653","17","65563680"
"chr5","110481781","110482080","chr10","40837780","40838076","65","69644001"
"chr5","110494339","110494507","chr1","185516369","185516543","36","75022030"
"chr5","110503288","110503500","chr10","60317961","60318169","54","50185327"
"chr5","110503654","110503848","chr18","17788739","17788927","66","92714915"
"chr5","110513784","110514060","chr1","27429340","27429617","71","83084444"
"chr5","110521944","110522230","chr2A","87128487","87128777","71","23393457"
"chr5","110526069","110526368","chr3","188755199","188755497","65","78229130"
"chr5","110548195","110548413","chr1","132634931","132635144","45","22086736"
"chr5","110631992","110632305","chr20","729693","730003","69","109902299"
"chr5","110667213","110667379","chr1","23183624","23183790","33","87483589"
"chr5","110794411","110794708","chr5","44589810","44590101","43","66204601"
"chr5","110796469","110796788","chr5","44588492","44588802","53","66207977"
"chr5","110799157","110799361","chr12","61523961","61524170","47","49275196"
"chr5","110823132","110823270","chr5","44563923","44564053","25","66259209"
"chr5","110836399","110836655","chr5","44540484","44540748","36","66295915"
"chr5","110838737","110839027","chr5","17722071","17722357","62","93116666"
"chr5","110861007","110861316","chr1","23622718","23623020","68","87238289"
"chr5","110864839","110865001","chr1","162716672","162716841","29","51851833"
"chr5","110867015","110867206","chr1","35418522","35418723","61","75448493"
"chr5","110868014","110868284","chr3","57847114","57847393","47","53020900"
"chr5","110876578","110876823","chr8","61511175","61511424","63","49365403"
"chr5","110896781","110897016","chr16","20402877","20403119","56","90493904"
"chr5","110911237","110911312","chr10","144050807","144050895","28","33139570"
"chr5","110914035","110914341","chr6","130836067","130836367","90","19922032"
"chr5","110916425","110916684","chr3","143011557","143011810","60","32095132"
"chr5","110929012","110929303","chr5","44414465","44414764","49","66514547"
"chr5","110932594","110932867","chr5","44410532","44410816","46","66522062"
"chr5","110950486","110950771","chr5","44390473","44390786","58","66560013"
"chr5","110963896","110964147","chrX","19008809","19009055","57","91955087"
"chr5","110992461","110992774","chr5","44349610","44349915","46","66642851"
"chr5","110995210","110995343","chr1","26306582","26306715","22","84688628"
"chr5","111003260","111003515","chr21","8413468","8413714","87","102589792"
"chr5","111003527","111003783","chr1","60034453","60034701","61","50969074"
"chr5","111033820","111033963","chr1","134652174","134652315","34","23618354"
"chr5","111034387","111034608","chr1","192240967","192241177","47","81206580"
"chr5","111042902","111043123","chr10","139464258","139464467","51","28421356"
"chr5","111090721","111090856","chr10","95976682","95976808","31","15114039"
"chr5","111094807","111094899","chr3","198810321","198810416","27","87715514"
"chr5","111109157","111109450","chr5","44319911","44320207","42","66789246"
"chr5","111133034","111133148","chr18","22807872","22807981","20","88325162"
"chr5","111133544","111133706","chr19","16163661","16163823","37","94969883"
"chr5","111145715","111145842","chr5","120504650","120504778","25","9358935"
"chr5","111163441","111163714","chr5","44185393","44185686","61","66978048"
"chr5","111167577","111167866","chr10","86678813","86679102","58","24488764"
"chr5","111171483","111171756","chr10","136766391","136766663","77","25594908"
"chr5","111172187","111172412","chr12","73082729","73082952","56","38089458"
"chr5","111173708","111173978","chr5","44179516","44179817","54","66994192"
"chr5","111175828","111176071","chr6","36932206","36932446","76","74243622"
"chr5","111179698","111179820","chr10","12650705","12650831","36","98528993"
"chr5","111182338","111182622","chr5","44154940","44155246","59","67027398"
"chr5","111186273","111186553","chr5","44147924","44148177","61","67038349"
"chr5","111192720","111193033","chr5","44139282","44139595","46","67053438"
"chr5","111193556","111193670","chr5","44137033","44137146","11","67056523"
"chr5","111212422","111212688","chr5","44116609","44116908","57","67095813"
"chr5","111212899","111213059","chr1","7841983","7842144","38","103370916"
"chr5","111222369","111222489","chr3","9817678","9817802","27","101404691"
"chr5","111223524","111223804","chr8","47441615","47441889","67","63781909"
"chr5","111255694","111256038","chrX","2604879","2605192","101","108650815"
"chr5","111266154","111266307","chr10","101988216","101988372","41","9277938"
"chr5","111266375","111266707","chr5","44055079","44055412","49","67211296"
"chr5","111305999","111306237","chr7","82681491","82681731","65","28624508"
"chr5","111327727","111327968","chr5","44008977","44009245","59","67318750"
"chr5","111338673","111338921","chr5","43996183","43996440","52","67342490"
"chr5","111351860","111352140","chr1","81137919","81138200","78","30213941"
"chr5","111370854","111371164","chr1","41517961","41518265","72","69852893"
"chr5","111373562","111373849","chr5","43964775","43965068","44","67408787"
"chr5","111412112","111412211","chr6","119933784","119933888","24","8521672"
"chr5","111412402","111412614","chr6","110612092","110612302","56","800310"
"chr5","111438059","111438334","chr5","43916062","43916346","46","67521997"
"chr5","111507129","111507278","chr1","23727757","23727901","34","87779372"
"chr5","111546736","111547039","chr16","22298600","22298892","64","89248136"
"chr5","111580404","111580711","chr5","43760776","43761080","39","67819628"
"chr5","111605039","111605337","chr5","43736536","43736846","48","67868503"
"chr5","111606312","111606605","chr4","151944849","151945132","54","40338537"
"chr5","111608401","111608695","chr5","43733012","43733306","35","67875389"
"chr5","111637879","111638160","chr5","43702361","43702643","52","67935518"
"chr5","111670604","111670890","chr5","43669891","43670176","38","68000713"
"chr5","111677203","111677546","chr6","110498313","110498630","87","1178890"
"chr5","111693235","111693529","chr5","43641504","43641768","57","68051731"
"chr5","111700850","111701154","chr5","43634555","43634854","47","68066295"
"chr5","111709196","111709526","chr5","43624713","43625023","71","68084483"
"chr5","111755111","111755408","chr5","152648476","152648757","68","40893365"
"chr5","111763554","111763751","chr5","121799363","121799555","41","10035809"
"chr5","111764269","111764384","chrX","71685983","71686106","28","40078286"
"chr5","111812587","111812794","chr11","20029701","20029921","51","91782886"
"chr5","111828850","111829027","chr4","154231770","154231939","54","42402920"
"chr5","112003178","112003303","chr8","42463764","42463882","30","69539414"
"chr5","112018649","112018952","chr1","190065982","190066274","29","78047333"
"chr5","112050951","112051244","chr1","227415933","227416230","54","115364982"
"chr5","112066272","112066388","chr5","57494948","57495065","10","54571324"
"chr5","112075916","112076089","chr6","21766192","21766365","33","90309724"
"chr5","112084219","112084530","chr20","36046566","36046877","70","76037653"
"chr5","112085366","112085616","chr1","20976804","20977054","58","91108562"
"chr5","112110303","112110606","chr5","43172944","43173247","39","68937359"
"chr5","112186940","112187081","chr18","77865542","77865689","34","34321398"
"chr5","112189662","112189929","chrX","70757717","70758005","65","41431945"
"chr5","112206410","112206707","chr5","43077352","43077635","53","69129058"
"chr5","112223988","112224252","chr5","43060291","43060576","52","69163697"
"chr5","112248624","112248824","chr2A","98206978","98207190","48","14041646"
"chr5","112254513","112254806","chr11","17140040","17140338","58","95114473"
"chr5","112299531","112299648","chr5","42980747","42980875","21","69318784"
"chr5","112299913","112300067","chr20","30914783","30914940","32","81385130"
"chr5","112326325","112326633","chr1","181256651","181256946","70","68930326"
"chr5","112416439","112416624","chr3","197878744","197878927","44","85462305"
"chr5","112430137","112430414","chr5","42859572","42859857","40","69570565"
"chr5","112442473","112442590","chr2B","15485142","15485259","16","96957331"
"chr5","112452754","112453052","chr5","42836833","42837136","31","69615921"
"chr5","112468907","112469123","chr1","132570842","132571055","43","20101935"
"chr5","112509692","112509809","chr5","42778148","42778265","16","69731544"
"chr5","112661279","112661393","chr1","45273792","45273898","27","67387487"
"chr5","112668413","112668539","chr5","42607072","42607197","7","70061341"
"chr5","112809894","112810195","chr5","42497252","42497550","36","70312642"
"chr5","113072184","113072308","chr8","63912885","63913012","20","49159299"
"chr5","113072312","113072399","chr4","100347100","100347178","28","12725212"
"chr5","113072831","113072904","chr15","51024493","51024560","18","62048338"
"chr5","113084074","113084229","chr9","11369504","11369664","34","101714570"
"chr5","113176757","113177048","chr11","45058847","45059131","57","68117910"
"chr5","113295279","113295431","chr16","49017109","49017265","34","64278170"
"chr5","113298371","113298636","chr5","41894776","41895051","35","71403595"
"chr5","113307853","113308179","chr5","41888764","41889087","39","71419089"
"chr5","113320389","113320653","chr5","41878236","41878513","35","71442153"
"chr5","113346374","113346654","chr5","41849869","41850150","37","71496505"
"chr5","113361270","113361562","chr2A","45843775","45844068","55","67517495"
"chr5","113434406","113434541","chr1","39714111","39714243","28","73720295"
"chr5","113452063","113452311","chr5","41542351","41542616","41","71909712"
"chr5","113466043","113466324","chr1","31199146","31199413","77","82266897"
"chr5","113466703","113467012","chr5","41524101","41524416","38","71942602"
"chr5","113476040","113476168","chr19","3164297","3164425","17","110311743"
"chr5","113476634","113476796","chr3","40933011","40933169","36","72543623"
"chr5","113488410","113488702","chr5","41504287","41504578","38","71984123"
"chr5","113505744","113505913","chr12","34663410","34663575","32","78842334"
"chr5","113530896","113531075","chr14","76663130","76663317","43","36867766"
"chr5","113540742","113540856","chr5","41459811","41459927","13","72080931"
"chr5","113583582","113583873","chr3","102743562","102743847","58","10840020"
"chr5","113588101","113588293","chr12","109531872","109532078","51","4056229"
"chr5","113597528","113597804","chr5","41408435","41408724","45","72189093"
"chr5","113625498","113625650","chr1","32730027","32730168","33","80895471"
"chr5","113674437","113674611","chr15","56973898","56974072","55","56700539"
"chr5","113675420","113675544","chr7","69849325","69849449","17","43826095"
"chr5","113678840","113679145","chr1","110519132","110519423","73","3159708"
"chr5","113699736","113700027","chr16","4899207","4899497","59","108800529"
"chr5","113743182","113743487","chr1","65527838","65528144","65","48215344"
"chr5","113771794","113772069","chr5","39961684","39961962","38","73810110"
"chr5","113808878","113809186","chr5","60183554","60183832","56","53625324"
"chr5","113826601","113826896","chr5","41281401","41281680","52","72545200"
"chr5","113834749","113834870","chr6","18588428","18588554","30","95246321"
"chr5","113878214","113878474","chr5","43641504","43641768","49","70236710"
"chr5","113886067","113886364","chr1","227415933","227416230","65","113529866"
"chr5","113890440","113890735","chr5","41221238","41221526","42","72669202"
"chr5","113914377","113914652","chr13","22161680","22161965","75","91752697"
"chr5","113975205","113975321","chr5","41142714","41142831","16","72832491"
"chr5","114062129","114062413","chr2B","131327591","131327879","60","17265462"
"chr5","114077909","114078068","chr21","37457419","37457581","29","76620490"
"chr5","114102659","114102837","chr7","77305459","77305631","53","36797200"
"chr5","114129751","114129907","chr19","4563176","4563336","29","109566575"
"chr5","114144945","114145107","chr2B","126162282","126162438","39","12017337"
"chr5","114156368","114156522","chr16","57816344","57816497","39","56340024"
"chr5","114172967","114173114","chr14","34631091","34631234","35","79541876"
"chr5","114216581","114216871","chr3","49090792","49091064","63","65125789"
"chr5","114220005","114220166","chr5","2493450","2493615","34","111726555"
"chr5","114220554","114220642","chr1","199930317","199930401","20","85709763"
"chr5","114220944","114220962","chr1","31280172","31280188","8","82940772"
"chr5","114222879","114223032","chr13","3468265","3468414","34","110754614"
"chr5","114225625","114225936","chr5","40895714","40896030","37","73329911"
"chr5","114284055","114284339","chr5","39970242","39970539","50","74313813"
"chr5","114289037","114289154","chr4","39880797","39880914","18","74408240"
"chr5","114290645","114290797","chrX","44644068","44644228","34","69646577"
"chr5","114340303","114340579","chr5","15880496","15880786","42","98459807"
"chr5","114345342","114345450","chr3","65778113","65778219","20","48567229"
"chr5","114401243","114401501","chrX","6023082","6023343","77","108378161"
"chr5","114426029","114426307","chr2B","94298954","94299236","63","20127075"
"chr5","114452197","114452421","chr7","4535741","4535964","50","109916456"
"chr5","114453187","114453308","chr5","15989110","15989227","14","98464077"
"chr5","114483790","114484096","chr10","25307799","25308095","70","89175991"
"chr5","114565414","114565532","chr8","18990211","18990330","18","95575203"
"chr5","114567491","114567806","chr22","12726594","12726897","57","101840897"
"chr5","114577691","114578005","chr5","16102330","16102636","34","98475361"
"chr5","114599127","114599413","chr5","16129495","16129787","40","98469632"
"chr5","114627003","114627298","chr5","16157151","16157447","47","98469852"
"chr5","114633341","114633632","chr5","16167798","16168094","32","98465543"
"chr5","114634787","114635077","chr19","46062191","46062484","49","68572596"
"chr5","114666186","114666341","chr5","118399435","118399596","30","3733249"
"chr5","114682786","114683071","chr5","16214816","16215112","55","98467970"
"chr5","114760348","114760624","chr5","16293257","16293537","40","98467091"
"chr5","114795930","114796216","chr17","81130958","81131254","59","33664972"
"chr5","114850267","114850556","chr12","117950588","117950884","58","3100321"
"chr5","114901852","114902143","chr5","16429830","16430117","67","98472022"
"chr5","114954903","114955223","chr5","16493854","16494179","40","98461049"
"chr5","115010233","115010492","chr19","10749116","10749372","70","104261117"
"chr5","115036023","115036295","chr19","16930672","16930946","65","98105351"
"chr5","115209632","115209897","chr2B","111881789","111882051","72","3327843"
"chr5","115231700","115231825","chr9","15394099","15394221","21","99837601"
"chr5","115239143","115239400","chr5","16797810","16798061","53","98441333"
"chr5","115275878","115276189","chr5","16833210","16833506","64","98442668"
"chr5","115279814","115280088","chr5","16840285","16840582","55","98439529"
"chr5","115280914","115281038","chrX","151139490","151139606","35","35858576"
"chr5","115285260","115285538","chr17","29672080","29672362","56","85613180"
"chr5","115330400","115330693","chr1","227018119","227018409","57","111687719"
"chr5","115332995","115333159","chr5","16896896","16897059","29","98436099"
"chr5","115344164","115344452","chr5","16909599","16909896","55","98434565"
"chr5","115367717","115367846","chr22","8209909","8210037","23","107157808"
"chr5","115564775","115565065","chr5","17148642","17148924","59","98416133"
"chr5","115566764","115567067","chr5","17151374","17151687","45","98415390"
"chr5","115624130","115624419","chr3","196706803","196707079","63","81082673"
"chr5","115625435","115625734","chr3","15946274","15946563","60","99679161"
"chr5","115636570","115636866","chr5","17227155","17227443","45","98409415"
"chr5","115875535","115875812","chr5","17405871","17406159","48","98469664"
"chr5","115977538","115977832","chr5","17517858","17518159","50","98459680"
"chr5","116083202","116083375","chr5","17607321","17607503","21","98475881"
"chr5","116176973","116177255","chr5","17747887","17748173","35","98429086"
"chr5","116267729","116267991","chr6","35525971","35526244","41","80741758"
"chr5","116283566","116283836","chr4","152323211","152323483","56","36039645"
"chr5","116292984","116293270","chr5","17868275","17868586","68","98424709"
"chr5","116321508","116321810","chr5","17882461","17882770","37","98439047"
"chr5","116329327","116329595","chr5","17888466","17888755","51","98440861"
"chr5","116428570","116428740","chr5","17948828","17948992","25","98479742"
"chr5","116514279","116514571","chr5","18088562","18088861","40","98425717"
"chr5","116514577","116514854","chr5","18088864","18089155","45","98425713"
"chr5","116533828","116534124","chr5","18104893","18105195","32","98428935"
"chr5","116534724","116534838","chr1","47275032","47275145","24","69259692"
"chr5","116549714","116549835","chr5","18116450","18116573","19","98433264"
"chr5","116553812","116554108","chr2A","59667083","59667378","58","56886729"
"chr5","116554641","116554906","chr5","18122147","18122419","64","98432494"
"chr5","116571339","116571484","chr8","20885859","20886004","35","95685480"
"chr5","116604353","116604469","chr10","88748074","88748188","20","27856279"
"chr5","116626150","116626274","chr5","14908589","14908717","17","101717561"
"chr5","116630535","116630713","chr20","13871202","13871372","34","102759333"
"chr5","116631986","116632283","chr5","18197596","18197862","67","98434390"
"chr5","116680683","116680735","chr3","50750974","50751020","14","65929709"
"chr5","116681110","116681229","chr6","28788882","28788987","38","87892228"
"chr5","116692166","116692261","chr2B","16451102","16451202","23","100241064"
"chr5","116692561","116692604","chr1","20595698","20595729","16","96096863"
"chr5","116692607","116692656","chr9","47034334","47034381","14","69658273"
"chr5","116696852","116697141","chr3","54024525","54024820","63","62672327"
"chr5","116725857","116726080","chr2A","104107196","104107411","49","12618661"
"chr5","116772785","116773074","chr11","64538382","64538654","68","52234403"
"chr5","116777470","116777593","chr5","14745856","14745979","14","102031614"
"chr5","116804465","116804761","chr5","14709838","14710131","40","102094627"
"chr5","116887720","116888021","chr5","14628147","14628446","40","102259573"
"chr5","116963572","116963687","chr5","157253554","157253671","17","40289982"
"chr5","116987833","116988130","chr12","123096820","123097105","69","6108987"
"chr5","117039511","117039806","chr5","14454352","14454649","31","102585159"
"chr5","117116662","117116792","chr12","29897183","29897312","16","87219479"
"chr5","117132211","117132371","chr4","165048422","165048576","45","47916211"
"chr5","117489424","117489714","chr5","13945534","13945821","51","103543890"
"chr5","117491503","117491594","chr5","13943605","13943686","15","103547898"
"chr5","117616119","117616274","chr22","2872683","2872842","40","114743436"
"chr5","117638859","117639142","chr5","13762585","13762873","65","103876274"
"chr5","117643534","117643811","chr5","13758019","13758310","50","103885515"
"chr5","117646012","117646152","chr10","3133708","3133847","40","114512304"
"chr5","117673551","117673672","chr10","117400","117523","21","117556151"
"chr5","117767208","117767489","chr5","13634904","13635195","34","104132304"
"chr5","117777172","117777461","chr7","78962742","78963032","63","38814430"
"chr5","117971589","117971859","chr5","13429857","13430139","53","104541732"
"chr5","117991936","117992234","chr19","18871903","18872198","67","99120033"
"chr5","118058279","118058570","chr5","13332881","13333169","34","104725398"
"chr5","118278892","118279020","chr2A","3551885","3552014","18","114727007"
"chr5","118301153","118301488","chr22","13571435","13571759","89","104729718"
"chr5","118303591","118303820","chr5","13120225","13120457","33","105183366"
"chr5","118448365","118448620","chr5","12988090","12988359","57","105460275"
"chr5","118486592","118486768","chr5","43474037","43474214","39","75012555"
"chr5","118486964","118487077","chr16","58213312","58213429","20","60273652"
"chr5","118636228","118636510","chr5","12797675","12797982","55","105838553"
"chr5","118721593","118721858","chr10","57454206","57454474","65","61267387"
"chr5","118925992","118926276","chr3","24362267","24362552","69","94563725"
"chr5","119140445","119140717","chr5","12300154","12300416","50","106840291"
"chr5","119409040","119409318","chr6","112984611","112984897","65","6424429"
"chr5","119433585","119433873","chr5","11999532","11999820","40","107434053"
"chr5","119608859","119608891","chr2B","109308532","109308566","9","10300327"
"chr5","119901740","119901839","chr4","195001113","195001216","21","75099373"
"chr5","119906039","119906307","chr1","13415110","13415378","75","106490929"
"chr5","119970133","119970217","chr13","73935916","73935998","14","46034217"
"chr5","120041556","120041857","chr8","8339468","8339758","68","111702088"
"chr5","120065734","120066022","chr17","11572326","11572616","62","108493408"
"chr5","120152602","120152913","chr5","11306100","11306407","64","108846502"
"chr5","120177088","120177362","chr5","11283525","11283800","65","108893563"
"chr5","120204902","120205182","chr9","46768269","46768550","68","73436633"
"chr5","120236928","120237049","chr5","11223414","11223543","21","109013514"
"chr5","120311955","120312260","chr5","11144852","11145154","42","109167103"
"chr5","120334517","120334795","chr5","11116878","11117165","42","109217639"
"chr5","120372260","120372570","chr4","197940293","197940594","79","77568033"
"chr5","120421743","120421978","chr5","11043140","11043394","43","109378603"
"chr5","120610280","120610361","chr2A","42021645","42021731","29","78588635"
"chr5","120610442","120610680","chr12","65102113","65102357","64","55508329"
"chr5","120645674","120645766","chr7","101404390","101404484","16","19241284"
"chr5","120645895","120646063","chr11","47592267","47592453","48","73053628"
"chr5","120675045","120675170","chr5","15774644","15774776","16","104900401"
"chr5","120681396","120681569","chr7","76954498","76954674","38","43726898"
"chr5","120691507","120691814","chr3","139056809","139057112","55","18365302"
"chr5","120740278","120740419","chr5","138503811","138503927","35","17763533"
"chr5","120740427","120740719","chr5","15711881","15712171","41","105028546"
"chr5","120765860","120766159","chr5","15687691","15688000","51","105078169"
"chr5","120776559","120776898","chr5","15676496","15676811","63","105100063"
"chr5","120782695","120782913","chr2A","82314588","82314806","49","38468107"
"chr5","120786376","120786672","chr1","133729720","133730008","54","12943344"
"chr5","120801401","120801629","chr5","15662810","15663068","60","105138591"
"chr5","120835050","120835325","chr5","15624478","15624745","52","105210572"
"chr5","120841173","120841467","chr5","15618980","15619283","41","105222193"
"chr5","120844447","120844716","chr5","15615788","15616061","52","105228659"
"chr5","120918848","120919152","chr5","15548294","15548591","45","105370554"
"chr5","120922853","120923154","chr5","15543729","15544025","59","105379124"
"chr5","120943113","120943389","chr13","55152440","55152714","50","65790673"
"chr5","120971035","120971325","chr5","15495568","15495864","76","105475467"
"chr5","120985651","120985774","chr1","24815947","24816071","20","96169704"
"chr5","121025830","121026115","chr19","38783871","38784152","64","82241959"
"chr5","121073557","121073661","chr9","112252272","112252374","19","8821285"
"chr5","121074394","121074623","chr2B","95737958","95738201","54","25336436"
"chr5","121075041","121075104","chr12","95179050","95179109","17","25895991"
"chr5","121079421","121079690","chr22","8779056","8779328","69","112300365"
"chr5","121092188","121092311","chr17","27545127","27545251","17","93547061"
"chr5","121097137","121097405","chr5","39991333","39991599","56","81105804"
"chr5","121123448","121123752","chr5","15332708","15333012","33","105790740"
"chr5","121126099","121126386","chr5","96942875","96943163","49","24183224"
"chr5","121127072","121127375","chr5","15329655","15329967","50","105797417"
"chr5","121128342","121128473","chr5","161501546","161501670","23","40373204"
"chr5","121128725","121128901","chr8","63354407","63354585","41","57774318"
"chr5","121135030","121135335","chr5","15323264","15323571","50","105811766"
"chr5","121137192","121137500","chr5","14932571","14932879","46","106204621"
"chr5","121148011","121148299","chr5","15302494","15302785","28","105845517"
"chr5","121158581","121158867","chr4","12932886","12933177","61","108225695"
"chr5","121196770","121196925","chr1","23727757","23727901","40","97469013"
"chr5","121218035","121218342","chr5","15234046","15234354","46","105983989"
"chr5","121223355","121223615","chr5","15229338","15229635","58","105994017"
"chr5","121234343","121234637","chr5","15215504","15215798","38","106018839"
"chr5","121278426","121278700","chr5","18259343","18259626","46","103019083"
"chr5","121289677","121289994","chr5","18256872","18257179","56","103032805"
"chr5","121334595","121334899","chr5","15109021","15109328","53","106225574"
"chr5","121361907","121362201","chr5","18470256","18470564","51","102891651"
"chr5","121386885","121386972","chr2B","74186352","74186439","8","47200533"
"chr5","121386973","121387074","chr4","60333236","60333341","22","61053737"
"chr5","121403839","121403950","chr5","10892274","10892385","7","110511565"
"chr5","121457918","121458212","chr5","10834721","10835021","45","110623197"
"chr5","121486963","121487275","chr5","10805376","10805672","58","110681587"
"chr5","121545279","121545526","chr5","10744102","10744390","62","110801177"
"chr5","121592309","121592619","chr5","10698329","10698625","46","110893980"
"chr5","121656728","121656844","chr5","10623279","10623396","13","111033449"
"chr5","121729383","121729687","chr11","46970026","46970324","63","74759357"
"chr5","121738276","121738363","chr18","3058264","3058354","14","118680012"
"chr5","121765192","121765465","chr5","10493505","10493786","35","111271687"
"chr5","121787434","121787741","chr5","10466512","10466804","47","111320922"
"chr5","121797958","121798229","chr5","10457094","10457382","52","111340864"
"chr5","121808542","121808832","chr14","87397924","87398217","55","34410618"
"chr5","121844855","121844982","chr5","10410368","10410498","13","111434487"
"chr5","121926221","121926336","chr1","46026245","46026369","24","75899976"
"chr5","121931580","121931889","chr5","10323534","10323843","48","111608046"
"chr5","121979056","121979193","chr1","1546294","1546427","29","120432762"
"chr5","122034448","122034768","chr12","901136","901435","67","121133312"
"chr5","122058433","122058552","chr16","40805378","40805498","16","81253055"
"chr5","122076630","122076823","chr10","7421667","7421862","45","114654963"
"chr5","122083383","122083693","chr5","10167729","10168037","46","111915654"
"chr5","122285389","122285660","chr3","182568526","182568786","60","60283137"
"chr5","122396343","122396510","chr7","70637835","70637997","38","51758508"
"chr5","122410741","122410981","chr5","9842786","9843038","36","112567955"
"chr5","122444846","122444965","chr16","24879876","24879993","22","97564970"
"chr5","122449772","122450036","chr8","125945513","125945774","60","3495741"
"chr5","122456450","122456597","chr1","39740056","39740201","28","82716394"
"chr5","122457200","122457285","chr9","11571473","11571561","21","110885727"
"chr5","122463544","122463655","chr5","9784884","9785008","22","112678660"
"chr5","122479176","122479457","chr1","45493522","45493796","76","76985654"
"chr5","122487543","122487838","chr5","9757618","9757929","59","112729925"
"chr5","122513524","122513814","chr5","116092903","116093174","87","6420621"
"chr5","122525017","122525320","chr5","9722280","9722598","60","112802737"
"chr5","122538519","122538663","chr3","115315740","115315885","35","7222779"
"chr5","122551175","122551471","chr5","9700825","9701104","43","112850350"
"chr5","122603794","122603933","chr7","71918824","71918957","27","50684970"
"chr5","122615189","122615488","chr9","106817720","106818017","58","15797469"
"chr5","122634557","122634690","chr5","9625752","9625887","15","113008805"
"chr5","122661715","122661979","chr5","9603611","9603877","27","113058104"
"chr5","122690606","122690908","chr5","9574936","9575246","43","113115670"
"chr5","122695574","122695790","chr5","9569972","9570193","38","113125602"
"chr5","122769583","122769895","chr5","9497673","9497969","58","113271910"
"chr5","122838605","122838925","chr5","9428493","9428802","47","113410112"
"chr5","122922759","122922913","chr19","5169265","5169417","30","117753494"
"chr5","122970986","122971279","chr19","44233950","44234235","72","78737036"
"chr5","123024811","123025119","chr12","62056702","62057011","80","60968109"
"chr5","123064058","123064318","chr5","9206713","9206977","34","113857345"
"chr5","123075669","123075793","chr5","9197723","9197847","21","113877946"
"chr5","123085053","123085367","chr5","9188774","9189065","62","113896279"
"chr5","123093171","123093473","chr5","9174418","9174717","42","113918753"
"chr5","123121543","123121652","chr12","46140363","46140469","30","76981180"
"chr5","123139286","123139580","chr7","152385296","152385589","56","29246010"
"chr5","123211888","123212025","chr2B","88580506","88580637","31","34631382"
"chr5","123242835","123243142","chr5","9026649","9026966","50","114216186"
"chr5","123273911","123274221","chr5","8996812","8997116","46","114277099"
"chr5","123357096","123357401","chr5","41366653","41366962","62","81990443"
"chr5","123398685","123398897","chr5","8883344","8883550","31","114515341"
"chr5","123408237","123408358","chr5","8873099","8873225","15","114535138"
"chr5","123441854","123441965","chr1","32298703","32298816","19","91143151"
"chr5","123459576","123459677","chr19","16749128","16749228","20","106710448"
"chr5","123474794","123475056","chr12","12768879","12769129","60","110705915"
"chr5","123521153","123521436","chr5","8759690","8760003","56","114761463"
"chr5","123534215","123534507","chr5","8748698","8749009","59","114785517"
"chr5","123536263","123536373","chr5","8746807","8746912","19","114789456"
"chr5","123544791","123545087","chr5","8734711","8734988","50","114810080"
"chr5","123598232","123598491","chr5","8690068","8690325","23","114908164"
"chr5","123607840","123607955","chr9","58147692","58147808","21","65460148"
"chr5","123620355","123620647","chr5","8669202","8669504","38","114951153"
"chr5","123629772","123630033","chr5","8657848","8658115","48","114971924"
"chr5","123638681","123638931","chr5","124953488","124953738","60","1314807"
"chr5","123644104","123644237","chr1","118130204","118130335","34","5513900"
"chr5","123648903","123649070","chr20","44858230","44858390","32","78790673"
"chr5","123649976","123650045","chr15","35370793","35370862","17","88279183"
"chr5","123650686","123650960","chr5","8632002","8632279","39","115018684"
"chr5","123663992","123664097","chr12","92598086","92598194","25","31065906"
"chr5","123712325","123712524","chr5","8577350","8577557","36","115134975"
"chr5","123727283","123727582","chr15","21383408","21383710","56","102343875"
"chr5","123808920","123809168","chr16","25684831","25685076","63","98124089"
"chr5","123873899","123874043","chr1","134652174","134652315","34","10778275"
"chr5","123907378","123907679","chr9","95229896","95230195","64","28677482"
"chr5","123911295","123911496","chr2A","32255515","32255716","37","91655780"
"chr5","123981437","123981547","chr11","44701254","44701367","19","79280183"
"chr5","124026275","124026582","chr5","8233679","8233972","61","115792596"
"chr5","124062191","124062502","chr16","40146461","40146771","55","83915730"
"chr5","124119899","124120051","chr19","56020333","56020483","31","68099566"
"chr5","124198555","124198670","chr15","28742654","28742771","20","95455901"
"chr5","124233902","124234190","chr5","142005741","142006029","59","17771839"
"chr5","124241110","124241215","chr8","94116849","94116964","33","30124261"
"chr5","124271910","124272262","chrX","130356055","130356350","111","6084145"
"chr5","124279171","124279459","chr5","7979636","7979929","32","116299535"
"chr5","124286197","124286465","chr5","7972045","7972293","48","116314152"
"chr5","124328845","124328901","chr1","52138720","52138778","8","72190125"
"chr5","124370138","124370412","chr5","7881087","7881368","45","116489051"
"chr5","124392075","124392232","chr7","66529181","66529333","39","57862894"
"chr5","124416052","124416138","chr5","7846452","7846538","14","116569600"
"chr5","124440237","124440482","chr5","7830835","7831088","31","116609402"
"chr5","124448440","124448592","chr14","48531182","48531343","35","75917258"
"chr5","124448695","124448844","chr14","9916978","9917124","33","114531717"
"chr5","124510182","124510299","chr5","7768919","7769036","9","116741263"
"chr5","124527040","124527166","chr6","112856828","112856953","20","11670212"
"chr5","124573771","124573888","chr5","7688243","7688360","11","116885528"
"chr5","124590861","124591089","chr20","49262695","49262907","55","75328166"
"chr5","124592506","124592785","chr5","7671036","7671334","53","116921470"
"chr5","124592800","124593072","chr5","7670758","7671033","36","116922042"
"chr5","124666270","124666466","chr4","1869667","1869859","44","122796603"
"chr5","124669997","124670264","chr5","7589547","7589843","47","117080450"
"chr5","124682203","124682517","chr5","7579522","7579835","36","117102681"
"chr5","124687309","124687448","chr5","60377164","60377300","29","64310145"
"chr5","124705371","124705675","chr12","108745776","108746083","66","15959595"
"chr5","124760838","124761162","chr5","7510160","7510460","49","117250678"
"chr5","124793142","124793410","chr5","7472654","7472912","41","117320488"
"chr5","124823654","124823769","chr1","182798095","182798212","18","57974441"
"chr5","124889393","124889678","chr5","7378479","7378764","64","117510914"
"chr5","124900558","124900826","chr16","25163413","25163683","58","99737145"
"chr5","124966452","124966585","chr7","26158438","26158564","33","98808014"
"chr5","124990366","124990646","chr16","40088504","40088786","57","84901862"
"chr5","125043552","125043856","chr3","101099262","101099554","42","23944290"
"chr5","125045875","125046133","chrX","54161113","54161388","65","70884762"
"chr5","125049419","125049685","chr5","7231572","7231866","54","117817847"
"chr5","125061239","125061324","chr1","325947","326035","30","124735292"
"chr5","125069201","125069360","chr7","74190896","74191062","30","50878305"
"chr5","125137791","125138017","chr2A","104107196","104107411","58","21030595"
"chr5","125170969","125171262","chr7","81305611","81305899","67","43865358"
"chr5","125196370","125196647","chr5","7091808","7092112","62","118104562"
"chr5","125209535","125209701","chr4","201366234","201366398","37","76156699"
"chr5","125297035","125297194","chr10","49585047","49585201","33","75711988"
"chr5","125335205","125335479","chr5","6957619","6957907","46","118377586"
"chr5","125344990","125345328","chr1","227415933","227416230","100","102070943"
"chr5","125376213","125376492","chr5","6922178","6922491","56","118454035"
"chr5","125469346","125469638","chrX","18957327","18957615","56","106512019"
"chr5","125476422","125476591","chr4","109329573","109329745","37","16146849"
"chr5","125486520","125486806","chr19","34850731","34851015","64","90635789"
"chr5","125500839","125501098","chr3","20224185","20224446","70","105276654"
"chr5","125529288","125529567","chr5","6758413","6758685","46","118770875"
"chr5","125564713","125564796","chr12","79050237","79050316","30","46514476"
"chr5","125577089","125577375","chrX","115407272","115407563","55","10169817"
"chr5","125599346","125599490","chr8","20885859","20886004","33","104713487"
"chr5","125622223","125622334","chr1","130229924","130230021","33","4607701"
"chr5","125622430","125622559","chr1","182164561","182164689","25","56542131"
"chr5","125639450","125639641","chr16","58098408","58098596","36","67541042"
"chr5","125641588","125641736","chr3","152725982","152726134","38","27084394"
"chr5","125669048","125669316","chr13","96242523","96242798","55","29426525"
"chr5","125693556","125693838","chr5","6592737","6593037","57","119100819"
"chr5","125697487","125697655","chr14","72724722","72724884","38","52972765"
"chr5","125786670","125786974","chr5","6510078","6510368","48","119276592"
"chr5","125801136","125801296","chr3","38711445","38711601","40","87089691"
"chr5","125811510","125811806","chr5","6481605","6481900","41","119329905"
"chr5","125837633","125837791","chr11","129038829","129038978","36","3201196"
"chr5","125861469","125861613","chr9","108232885","108233040","29","17628584"
"chr5","125885186","125885366","chr2A","70077395","70077576","47","55807791"
"chr5","125894722","125894831","chr2B","51412589","51412700","30","74482133"
"chr5","125945537","125945823","chr20","49778118","49778411","65","76167419"
"chr5","125946783","125946901","chr16","40500610","40500729","30","85446173"
"chr5","125979075","125979381","chr8","95777221","95777531","34","30201854"
"chr5","125985444","125985708","chr22","26104723","26104998","65","99880721"
"chr5","126011774","126011914","chr1","32730027","32730168","42","93281747"
"chr5","126093339","126093633","chr5","6189872","6190186","56","119903467"
"chr5","126103065","126103359","chr2B","111090217","111090517","60","15012848"
"chr5","126120004","126120282","chrX","3628787","3629069","66","122491217"
"chr5","126234796","126235108","chr5","6041790","6042088","52","120193006"
"chr5","126253577","126253810","chrX","20229622","20229871","64","106023955"
"chr5","126281154","126281443","chr5","6001853","6002154","48","120279301"
"chr5","126282677","126282970","chr5","6000488","6000800","50","120282189"
"chr5","126286427","126286508","chr16","12429378","12429458","13","113857049"
"chr5","126344409","126344681","chrX","54076893","54077171","66","72267516"
"chr5","126368247","126368341","chr7","130080243","130080338","15","3711996"
"chr5","126371185","126371481","chr13","34855159","34855453","56","91516026"
"chr5","126412968","126413279","chr4","187044206","187044497","92","60631238"
"chr5","126430276","126430572","chr5","5859711","5860020","47","120570565"
"chr5","126432806","126432990","chr11","44694637","44694827","38","81738169"
"chr5","126435030","126435299","chr5","5854971","5855242","54","120580059"
"chr5","126473845","126473983","chr15","18620321","18620458","32","107853524"
"chr5","126503805","126504096","chr11","59829","60112","56","126443976"
"chr5","126527774","126528062","chr5","5776603","5776903","53","120751171"
"chr5","126550392","126550663","chr13","1388453","1388725","62","125161939"
"chr5","126573331","126573513","chr16","11945801","11945979","37","114627530"
"chr5","126611666","126611805","chr15","52764054","52764186","30","73847612"
"chr5","126685412","126685731","chr5","8748698","8749009","59","117936714"
"chr5","126748123","126748405","chr5","5551515","5551799","44","121196608"
"chr5","126768431","126768546","chr10","105130162","105130278","18","21638269"
"chr5","126790377","126790650","chr5","5497811","5498089","34","121292566"
"chr5","126821560","126821864","chr10","25307799","25308095","54","101513761"
"chr5","126868597","126868884","chr5","5403566","5403867","59","121465031"
"chr5","126874285","126874565","chr5","5396068","5396328","55","121478217"
"chr5","126884840","126884963","chrX","95494066","95494189","19","31390774"
"chr5","126905847","126906131","chr5","5365600","5365894","52","121540247"
"chr5","127068232","127068452","chr20","42804863","42805083","45","84263369"
"chr5","127143954","127144203","chr5","5134025","5134293","56","122009929"
"chr5","127170823","127171063","chr5","5103641","5103888","32","122067182"
"chr5","127226539","127226761","chr5","5055023","5055240","22","122171516"
"chr5","127227142","127227367","chr3","126441844","126442070","46","785298"
"chr5","127238390","127238657","chr6","108788963","108789228","68","18449427"
"chr5","127245606","127245921","chr5","5034383","5034684","58","122211223"
"chr5","127253130","127253327","chr5","5027010","5027216","24","122226120"
"chr5","127340252","127340387","chr5","32957444","32957578","34","94382808"
"chr5","127352923","127353133","chr11","3414851","3415055","52","123938072"
"chr5","127370740","127371043","chr5","4905362","4905653","53","122465378"
"chr5","127374596","127374867","chr11","85350045","85350314","55","42024551"
"chr5","127397323","127397433","chr5","4879578","4879696","23","122517745"
"chr5","127397485","127397732","chr5","4878828","4879065","45","122518657"
"chr5","127412118","127412265","chr6","36782155","36782293","38","90629963"
"chr5","127441870","127442124","chr5","4833930","4834217","56","122607940"
"chr5","127453856","127454064","chr16","28798378","28798580","52","98655478"
"chr5","127476411","127476558","chr18","65251585","65251732","36","62224826"
"chr5","127482518","127482821","chr5","4793760","4794070","37","122688758"
"chr5","127485011","127485289","chr7","2959934","2960208","53","124525077"
"chr5","127486120","127486270","chr5","103372455","103372595","39","24113665"
"chr5","127517488","127517632","chr1","148219593","148219735","45","20702105"
"chr5","127563242","127563556","chr5","4711361","4711687","45","122851881"
"chr5","127625108","127625367","chr7","630879","631139","66","126994229"
"chr5","127630355","127630426","chr14","75436417","75436490","19","52193938"
"chr5","127633479","127633789","chr18","34048248","34048557","63","93585231"
"chr5","127649252","127649463","chr6","110169683","110169896","43","17479569"
"chr5","127651470","127651626","chr8","48316387","48316548","38","79335083"
"chr5","127705367","127705655","chrX","100828576","100828867","54","26876791"
"chr5","127722552","127722839","chr5","4561287","4561565","53","123161265"
"chr5","127724533","127724743","chr3","45233841","45234045","45","82490692"
"chr5","127738022","127738303","chr1","101702737","101703010","54","26035285"
"chr5","127743439","127743643","chr5","4546399","4546600","19","123197040"
"chr5","127789610","127789751","chr1","148219593","148219735","35","20429983"
"chr5","127796743","127797031","chrX","15190100","15190391","67","112606643"
"chr5","127811673","127811876","chr15","37524921","37525137","51","90286752"
"chr5","127880165","127880471","chr5","4415228","4415505","69","123464937"
"chr5","127910224","127910520","chr5","4372628","4372914","52","123537596"
"chr5","128006159","128006283","chr5","4260884","4261008","16","123745275"
"chr5","128017031","128017146","chr12","19489085","19489201","21","108527946"
"chr5","128020069","128020180","chr11","63361264","63361380","27","64658805"
"chr5","128021548","128021695","chr15","69740012","69740164","39","58281536"
"chr5","128030493","128030611","chr8","17178149","17178269","17","110852344"
"chr5","128032026","128032143","chr5","4235126","4235242","13","123796900"
"chr5","128041540","128041746","chr7","44555416","44555635","53","83486124"
"chr5","128043780","128044050","chr2A","98714886","98715149","77","29328894"
"chr5","128048929","128049097","chr3","40933011","40933169","43","87115918"
"chr5","128055722","128055775","chr14","56737211","56737261","17","71318511"
"chr5","128071941","128072188","chr10","139299285","139299523","73","11227344"
"chr5","128073752","128073883","chr6","18588428","18588554","37","109485324"
"chr5","128082968","128083283","chr5","4181505","4181825","68","123901463"
"chr5","128087007","128087155","chr1","150469602","150469756","40","22382595"
"chr5","128091751","128092032","chr5","4173784","4174066","73","123917967"
"chr5","128096514","128096632","chr7","113419042","113419161","20","14677472"
"chr5","128106883","128107105","chr6","36791131","36791360","46","91315752"
"chr5","128170452","128170594","chr7","76013572","76013714","34","52156880"
"chr5","128173053","128173366","chr5","4092201","4092508","32","124080852"
"chr5","128189863","128190149","chr5","4073876","4074174","48","124115987"
"chr5","128193202","128193322","chrX","118297985","118298107","30","9895217"
"chr5","128194055","128194238","chr5","4069554","4069718","31","124124501"
"chr5","128200908","128201173","chr12","69579850","69580122","54","58621058"
"chr5","128204966","128205230","chr1","189232436","189232704","65","61027470"
"chr5","128208602","128208757","chr5","60610592","60610756","42","67598010"
"chr5","128208776","128209084","chr5","4053252","4053543","51","124155524"
"chr5","128209230","128209340","chr16","48023200","48023306","33","80186030"
"chr5","128220760","128220954","chr8","21554359","21554548","59","106666401"
"chr5","128286629","128286914","chr5","3967066","3967366","33","124319563"
"chr5","128505277","128505591","chr5","3746434","3746763","57","124758843"
"chr5","128854887","128855166","chr14","75080552","75080837","63","53774335"
"chr5","128913910","128914221","chr1","91059171","91059456","61","37854739"
"chr5","128920571","128920664","chr7","41949023","41949115","17","86971548"
"chr5","128959770","128960061","chr6","110513787","110514075","59","18445983"
"chr5","128984458","128984765","chr5","3345074","3345379","48","125639384"
"chr5","129016382","129016663","chr5","3316704","3317012","53","125699678"
"chr5","129029817","129030075","chr6","38953072","38953315","60","90076745"
"chr5","129060682","129060942","chr12","29594727","29594976","81","99465955"
"chr5","129158148","129158352","chr1","1334974","1335184","50","127823174"
"chr5","129174276","129174595","chr5","3187386","3187695","52","125986890"
"chr5","129193224","129193525","chr9","15043290","15043588","57","114149934"
"chr5","129301264","129301547","chr5","3051316","3051620","71","126249948"
"chr5","129304736","129305045","chr14","73326948","73327247","61","55977788"
"chr5","129315286","129315455","chr8","78626005","78626166","39","50689281"
"chr5","129338123","129338378","chr19","38408136","38408384","68","90929987"
"chr5","129350562","129350867","chr15","35333020","35333327","82","94017542"
"chr5","129367659","129367822","chr1","180608999","180609165","31","51241340"
"chr5","129384548","129384837","chr4","120243844","120244136","58","9140704"
"chr5","129390015","129390292","chr5","2965658","2965929","43","126424357"
"chr5","129400543","129400708","chr11","66655614","66655779","26","62744929"
"chr5","129431793","129432055","chr7","2330840","2331092","71","127100953"
"chr5","129433297","129433599","chr7","74227485","74227789","67","55205812"
"chr5","129442243","129442557","chr5","2919691","2919966","69","126522552"
"chr5","129447505","129447716","chr5","2915691","2915903","41","126531814"
"chr5","129450158","129450373","chrX","48678555","48678774","61","80771603"
"chr5","129455009","129455307","chr5","2911758","2912045","34","126543251"
"chr5","129472053","129472352","chr5","2897322","2897620","60","126574731"
"chr5","129480024","129480316","chr5","2888105","2888398","29","126591919"
"chr5","129559628","129559788","chr16","76317400","76317554","38","53242228"
"chr5","129651887","129652092","chr5","2702747","2702939","34","126949140"
"chr5","129660885","129661156","chr16","69102206","69102491","70","60558679"
"chr5","129697796","129697939","chr1","32730027","32730168","31","96967769"
"chr5","129814634","129814811","chr6","118855023","118855193","41","10959611"
"chr5","129838843","129838903","chr9","34456289","34456345","14","95382554"
"chr5","129839184","129839401","chr20","5927363","5927600","66","123911821"
"chr5","129845788","129846028","chr7","64790817","64791051","59","65054971"
"chr5","129858712","129858872","chr5","2493450","2493615","24","127365262"
"chr5","129859039","129859146","chr1","100475717","100475823","19","29383322"
"chr5","129859384","129859493","chr5","2492982","2493087","22","127366402"
"chr5","129878119","129878412","chr5","2472617","2472896","44","127405502"
"chr5","129881832","129882099","chr12","123601833","123602111","68","6279999"
"chr5","129898342","129898417","chr12","39086298","39086370","15","90812044"
"chr5","129936749","129936825","chr5","2416698","2416773","12","127520051"
"chr5","129967779","129967971","chr15","63335218","63335406","39","66632561"
"chr5","129968651","129968785","chr12","12379017","12379147","24","117589634"
"chr5","129984837","129984968","chr1","55323203","55323336","19","74661634"
"chr5","130006403","130006597","chr22","22161614","22161809","52","107844789"
"chr5","130017417","130017687","chr12","123582446","123582716","68","6434971"
"chr5","130036484","130036781","chr5","2319444","2319744","39","127717040"
"chr5","130051123","130051266","chrX","104083539","104083685","38","25967584"
"chr5","130064138","130064289","chr10","92108530","92108678","33","37955608"
"chr5","130099152","130099277","chr5","42950118","42950242","23","87149034"
"chr5","130099285","130099582","chr5","2243051","2243342","46","127856234"
"chr5","130112046","130112158","chr4","110133393","110133510","20","19978653"
"chr5","130147980","130148245","chr14","23714548","23714818","64","106433432"
"chr5","130203332","130203623","chr5","2142069","2142357","34","128061263"
"chr5","130231515","130231818","chr5","2117080","2117377","56","128114435"
"chr5","130254388","130254683","chr8","142267606","142267878","73","12013218"
"chr5","130278997","130279051","chr3","46502105","46502156","11","83776892"
"chr5","130291398","130291555","chr16","76317400","76317554","33","53973998"
"chr5","130355561","130355862","chr5","1979868","1980165","43","128375693"
"chr5","130362170","130362452","chr16","30950078","30950376","64","99412092"
"chr5","130558644","130558825","chr5","1759174","1759361","26","128799470"
"chr5","130587577","130587710","chr7","26158438","26158564","33","104429139"
"chr5","130634803","130634922","chr1","40020849","40020966","29","90613954"
"chr5","130770274","130770532","chr6","110082075","110082339","68","20688199"
"chr5","130770733","130770941","chr9","120485003","120485210","61","10285730"
"chr5","130777436","130777723","chr1","15947145","15947439","64","114830291"
"chr5","130777972","130778099","chr8","103799790","103799921","41","26978182"
"chr5","130782275","130782422","chr12","104604246","104604399","31","26178029"
"chr5","130802968","130803108","chr12","116696765","116696890","40","14106203"
"chr5","130846872","130846993","chr7","11248117","11248241","22","119598755"
"chr5","130851579","130851779","chr4","40096448","40096655","48","90755131"
"chr5","130851866","130851957","chr4","1889740","1889828","19","128962126"
"chr5","130909016","130909255","chr19","35326449","35326681","67","95582567"
"chr5","130926131","130926433","chr5","1376594","1376882","52","129549537"
"chr5","130957215","130957503","chr5","1345817","1346113","53","129611398"
"chr5","131069974","131070273","chr5","52985134","52985425","62","78084840"
"chr5","131104292","131104612","chrX","114324443","114324737","88","16779849"
"chr5","131118381","131118653","chr13","55152440","55152714","69","75965941"
"chr5","131143670","131143866","chr11","7277099","7277287","61","123866571"
"chr5","131191240","131191333","chr18","2107838","2107935","26","129083402"
"chr5","131191761","131191942","chr7","152078771","152078957","42","20887010"
"chr5","131310223","131310507","chr5","997797","998069","48","130312426"
"chr5","131340670","131340979","chr5","965078","965396","37","130375592"
"chr5","131402750","131402893","chr5","921340","921480","14","130481410"
"chr5","131403831","131404146","chr5","920339","920649","48","130483492"
"chr5","131416274","131416375","chr10","37636709","37636809","20","93779565"
"chr5","131481391","131481752","chr9","16107266","16107602","93","115374125"
"chr5","131486043","131486176","chr1","17435795","17435930","27","114050248"
"chr5","131505718","131506026","chr10","115445054","115445361","59","16060664"
"chr5","131604908","131605194","chr7","76523012","76523308","62","55081896"
"chr5","131628776","131629070","chr5","716040","716348","49","130912736"
"chr5","131650646","131650919","chr5","699803","700099","62","130950843"
"chr5","131691850","131691950","chr1","160301284","160301387","20","28609434"
"chr5","131697323","131697589","chr5","648956","649235","46","131048367"
"chr5","131717863","131717937","chr7","72323128","72323205","15","59394735"
"chr5","131726813","131727106","chrX","19199530","19199816","61","112527283"
"chr5","131738418","131738683","chr5","595151","595424","46","131143267"
"chr5","131743947","131744120","chr4","12857600","12857767","39","118886347"
"chr5","131749537","131749840","chr5","582510","582803","52","131167027"
"chr5","131752244","131752472","chr5","579170","579401","31","131173074"
"chr5","131766662","131766870","chr16","28798378","28798580","44","102968284"
"chr5","131797101","131797408","chr16","11577899","11578203","74","120219202"
"chr5","131811834","131811951","chr5","520728","520848","22","131291106"
"chr5","131822555","131822815","chr19","3205542","3205801","55","128617013"
"chr5","131845203","131845502","chr5","485269","485566","54","131359934"
"chr5","131850029","131850162","chr5","483782","483920","24","131366247"
"chr5","131850536","131850681","chr1","21447351","21447502","33","110403185"
"chr5","131864239","131864366","chr6","154239364","154239482","34","22375125"
"chr5","131866885","131867151","chr5","24280392","24280662","65","107586493"
"chr5","131905628","131905945","chr7","72476964","72477281","82","59428664"
"chr5","131980744","131981014","chr5","340286","340543","40","131640458"
"chr5","132006829","132006988","chr4","195577197","195577355","37","63570368"
"chr5","132013270","132013392","chr2A","65558562","65558684","19","66454708"
"chr5","132042928","132043219","chr5","292309","292588","49","131750619"
"chr5","132082712","132082994","chr12","112234709","112234982","71","19848003"
"chr5","132100138","132100366","chr1","8023285","8023514","49","124076853"
"chr5","132329676","132329780","chr7","76220793","76220893","22","56108883"
"chr5","132361894","132362005","chr2B","96692107","96692217","24","35669787"
"chr5","132375961","132376250","chr11","111527997","111528292","55","20847964"
"chr5","132390000","132390286","chr1","217316497","217316780","63","84926497"
"chr5","132444597","132444879","chr2B","95220459","95220743","73","37224138"
"chr5","132577975","132578249","chr10","35816005","35816267","76","96761970"
"chr5","132764826","132765109","chr7","76982810","76983097","51","55782016"
"chr5","132774558","132774682","chr3","134832407","134832530","22","2057849"
"chr5","132792065","132792324","chr7","74767329","74767577","65","58024736"
"chr5","132792338","132792624","chr10","119264661","119264952","56","13527677"
"chr5","132824959","132825082","chr13","6568750","6568872","16","126256209"
"chr5","132845327","132845444","chr13","6116288","6116405","8","126729039"
"chr5","132846794","132847073","chr15","41858395","41858666","64","90988399"
"chr5","132851689","132851986","chr13","6108911","6109217","39","126742778"
"chr5","132853340","132853619","chr3","124225172","124225451","57","8628168"
"chr5","132854605","132854872","chr13","6106301","6106575","31","126748304"
"chr5","132885199","132885362","chr4","61055093","61055253","40","71830106"
"chr5","132897805","132898119","chr13","6065174","6065488","64","126832631"
"chr5","132898447","132898744","chr13","895685","895989","33","132002762"
"chr5","132911017","132911267","chr22","384123","384403","57","132526894"
"chr5","132913989","132914282","chr13","6571324","6571612","50","126342665"
"chr5","132952878","132953164","chr1","163867986","163868280","62","30915108"
"chr5","133004466","133004748","chr7","1708256","1708538","70","131296210"
"chr5","133061916","133062218","chr7","69333747","69334038","69","63728169"
"chr5","133068961","133069099","chr1","23727757","23727901","39","109341204"
"chr5","133070096","133070399","chr5","9692972","9693274","81","123377124"
"chr5","133077695","133077784","chr13","725916","726005","4","132351779"
"chr5","133079831","133080132","chr11","50191636","50191937","75","82888195"
"chr5","133084578","133084745","chr10","110693634","110693804","35","22390944"
"chr5","133086117","133086268","chr7","41537090","41537238","41","91549027"
"chr5","133091404","133091431","chr1","24882116","24882147","7","108209288"
"chr5","133091765","133091926","chr20","55353732","55353890","34","77738033"
"chr5","133097486","133097759","chr13","1324317","1324597","43","131773169"
"chr5","133116563","133116813","chr12","7210390","7210643","72","125906173"
"chr5","133141678","133142016","chr13","1356093","1356430","34","131785585"
"chr5","133171794","133171890","chr7","21503505","21503597","17","111668289"
"chr5","133172044","133172316","chr13","1388453","1388725","29","131783591"
"chr5","133174322","133174417","chr1","36354985","36355078","16","96819337"
"chr5","133189251","133189526","chr13","1400721","1401016","51","131788530"
"chr5","133191426","133191730","chr13","1405856","1406166","45","131785570"
"chr5","133201192","133201398","chr13","1415086","1415297","28","131786106"
"chr5","133210362","133210679","chr13","1422529","1422852","24","131787833"
"chr5","133244331","133244567","chr11","74217287","74217494","50","59027044"
"chr5","133265962","133266221","chr11","67266200","67266446","53","65999762"
"chr5","133289339","133289634","chr13","32762380","32762684","63","100526959"
"chr5","133317734","133317848","chr6","7105611","7105725","19","126212123"
"chr5","133321304","133321609","chr13","1528938","1529231","46","131792366"
"chr5","133346639","133346935","chr13","1553276","1553573","36","131793363"
"chr5","133382021","133382334","chr13","1592887","1593196","67","131789134"
"chr5","133382346","133382613","chr13","1593200","1593502","59","131789146"
"chr5","133420207","133420457","chr9","108406244","108406492","65","25013963"
"chr5","133481542","133481832","chr13","1696370","1696673","44","131785172"
"chr5","133500545","133500830","chr13","1715303","1715612","53","131785242"
"chr5","133554342","133554599","chr13","1767710","1768001","74","131786632"
"chr5","133585266","133585550","chr1","191202899","191203180","61","57617633"
"chr5","133629335","133629630","chr13","1845171","1845469","26","131784164"
"chr5","133676025","133676229","chr10","114625133","114625329","41","19050892"
"chr5","133690393","133690685","chr13","1906603","1906908","36","131783790"
"chr5","133703571","133703788","chr13","8301600","8301823","67","125401971"
"chr5","133840315","133840664","chr13","2058059","2058366","76","131782256"
"chr5","133879399","133879520","chr13","2099860","2099983","13","131779539"
"chr5","133890183","133890478","chr13","2110040","2110329","28","131780143"
"chr5","133922720","133923041","chr13","2142864","2143158","67","131779856"
"chr5","133937205","133937498","chr1","45974422","45974718","62","87962783"
"chr5","133950998","133951123","chr20","35113837","35113961","26","98837161"
"chr5","133964178","133964307","chr13","2196448","2196580","16","131767730"
"chr5","134049125","134049374","chr7","2330840","2331092","53","131718285"
"chr5","134088576","134088730","chr5","35384905","35385054","36","98703671"
"chr5","134095692","134095960","chr13","2323387","2323676","57","131772305"
"chr5","134216360","134216593","chr19","4894006","4894234","59","129322354"
"chr5","134222145","134222352","chr13","2452000","2452207","26","131770145"
"chr5","134245771","134245847","chr1","206078640","206078718","22","71832869"
"chr5","134246315","134246393","chr4","2960308","2960386","14","131286007"
"chr5","134330792","134331093","chr13","2557424","2557745","55","131773368"
"chr5","134341886","134342193","chr13","2568237","2568553","32","131773649"
"chr5","134345258","134345387","chr1","15302993","15303122","21","119042265"
"chr5","134366165","134366292","chr1","8475579","8475703","19","125890586"
"chr5","134376415","134376684","chr13","2599180","2599453","32","131777235"
"chr5","134383837","134384096","chr13","2606106","2606389","46","131777731"
"chr5","134428027","134428108","chr7","5928715","5928794","19","128499312"
"chr5","134435962","134436110","chr4","16451557","16451695","38","117984405"
"chr5","134436141","134436423","chr13","2651915","2652183","41","131784226"
"chr5","134453911","134454121","chr12","108822707","108822925","50","25631204"
"chr5","134473623","134473916","chr13","2687578","2687883","51","131786045"
"chr5","134474331","134474515","chr4","1869667","1869859","38","132604664"
"chr5","134478383","134478670","chr1","151117450","151117730","64","16639067"
"chr5","134510599","134510774","chr1","51754097","51754268","43","82756502"
"chr5","134510777","134510907","chr21","32443205","32443329","23","102067572"
"chr5","134511030","134511184","chr16","49017109","49017265","38","85493921"
"chr5","134514362","134514621","chr13","2716511","2716763","47","131797851"
"chr5","134516935","134517174","chr14","87495571","87495807","48","47021364"
"chr5","134573979","134574101","chr1","32298703","32298816","29","102275276"
"chr5","134640975","134641149","chr12","109322414","109322590","39","25318561"
"chr5","134667315","134667614","chr13","3054341","3054629","59","131612974"
"chr5","134702798","134702981","chr11","67630664","67630854","43","67072134"
"chr5","134758704","134758862","chr11","47982935","47983093","31","86775769"
"chr5","134782363","134782669","chr15","40250948","40251242","64","94531415"
"chr5","134786256","134786417","chr1","53760591","53760759","38","81025665"
"chr5","134853305","134853584","chr2B","126361584","126361859","49","8491721"
"chr5","134870166","134870440","chr13","3276465","3276762","71","131593701"
"chr5","134950950","134951266","chr13","3339496","3339785","59","131611454"
"chr5","134976376","134976668","chr7","5095566","5095848","64","129880810"
"chr5","135011684","135012001","chr4","25961102","25961409","74","109050582"
"chr5","135021984","135022255","chr13","3400330","3400626","46","131621654"
"chr5","135059089","135059369","chr1","154953718","154953996","59","19894629"
"chr5","135090377","135090582","chr5","16448661","16448873","46","118641716"
"chr5","135099891","135100176","chr8","124867005","124867294","56","10232886"
"chr5","135136531","135136841","chr13","3499504","3499805","65","131637027"
"chr5","135249933","135250085","chr10","49585047","49585201","34","85664886"
"chr5","135363366","135363653","chr13","3713278","3713580","70","131650088"
"chr5","135372537","135372809","chr3","138093185","138093457","71","2720648"
"chr5","135434030","135434233","chr13","3747344","3747544","26","131686686"
"chr5","135841115","135841208","chr1","17798378","17798465","21","118042737"
"chr5","135842291","135842517","chrX","45314660","45314880","64","90527631"
"chr5","136068145","136068388","chr13","4345039","4345316","55","131723106"
"chr5","136112478","136112594","chr4","37764421","37764538","15","98348057"
"chr5","136137236","136137530","chr15","43424188","43424482","65","92713048"
"chr5","136614827","136615041","chr16","59663520","59663732","45","76951307"
"chr5","136622519","136622752","chr20","1287716","1287951","66","135334803"
"chr5","136755682","136755995","chr13","5080005","5080333","61","131675677"
"chr5","136775116","136775288","chrX","119758170","119758333","38","17016946"
"chr5","136822199","136822457","chr13","5156486","5156730","47","131665713"
"chr5","136947014","136947300","chr13","5279815","5280101","54","131667199"
"chr5","136968337","136968492","chr15","69740012","69740164","33","67228325"
"chr5","136974050","136974340","chr2B","67858546","67858829","81","69115504"
"chr5","137103519","137103728","chr11","8779959","8780165","56","128323560"
"chr5","137127888","137128043","chr1","14800532","14800692","35","122327356"
"chr5","137156608","137156899","chr7","78576761","78577044","58","58579847"
"chr5","137163031","137163137","chr12","122832974","122833083","20","14330057"
"chr5","137188875","137189064","chr4","186358763","186358948","40","49169888"
"chr5","137193965","137194293","chr9","58140632","58140941","96","79053333"
"chr5","137211087","137211255","chr19","2466388","2466565","40","134744699"
"chr5","137217982","137218119","chr10","134256520","134256653","23","2961462"
"chr5","137226262","137226567","chr13","5917581","5917869","40","131308681"
"chr5","137250863","137251170","chr13","5891639","5891948","39","131359224"
"chr5","137253594","137253929","chr12","34870409","34870720","91","102383185"
"chr5","137289080","137289261","chr16","64951523","64951685","45","72337557"
"chr5","137305698","137305822","chr6","48492641","48492762","18","88813057"
"chr5","137336110","137336228","chr4","165930090","165930211","24","28593980"
"chr5","137490105","137490404","chr13","5622339","5622621","71","131867766"
"chr5","137491427","137491636","chr5","124345954","124346163","47","13145473"
"chr5","137498699","137498937","chr13","5610365","5610615","37","131888334"
"chr5","137512776","137512991","chr11","111758061","111758289","49","25754715"
"chr5","137609808","137610123","chr5","43322142","43322447","69","94287666"
"chr5","137623779","137623897","chr10","39312861","39312978","22","98310918"
"chr5","137647633","137647884","chr13","6293356","6293619","51","131354277"
"chr5","137671469","137671737","chr9","95660192","95660467","65","42011277"
"chr5","137710741","137710864","chr13","6354236","6354359","13","131356505"
"chr5","137801535","137801820","chr13","6408810","6409100","37","131392725"
"chr5","137809076","137809231","chr7","77655981","77656136","32","60153095"
"chr5","137835723","137836014","chr8","61836205","61836501","65","75999518"
"chr5","137953225","137953347","chr13","6568750","6568872","13","131384475"
"chr5","137997241","137997498","chr2B","99061086","99061351","60","38936155"
"chr5","137998593","137998886","chr13","7678095","7678388","54","130320498"
"chr5","138029724","138030012","chr13","6696750","6696999","75","131332974"
"chr5","138044397","138044634","chr13","6710977","6711225","42","131333420"
"chr5","138053833","138054143","chr13","6725437","6725732","54","131328396"
"chr5","138055624","138055922","chr13","6727961","6728257","27","131327663"
"chr5","138179217","138179342","chr6","25352056","25352181","20","112827161"
"chr5","138179387","138179669","chr13","6846267","6846552","33","131333120"
"chr5","138212103","138212223","chr8","23371457","23371574","25","114840646"
"chr5","138304221","138304534","chr20","48744868","48745174","72","89559353"
"chr5","138324367","138324647","chr13","6963231","6963512","27","131361136"
"chr5","138333317","138333605","chr16","22298600","22298892","57","116034717"
"chr5","138347343","138347635","chr13","6990699","6990991","29","131356644"
"chr5","138353472","138353676","chr1","114576431","114576639","49","23777041"
"chr5","138362120","138362411","chr13","7012390","7012703","47","131349730"
"chr5","138377314","138377607","chr13","7029612","7029902","40","131347702"
"chr5","138396056","138396360","chr13","7052184","7052490","27","131343872"
"chr5","138448602","138448858","chr13","7102834","7103088","45","131345768"
"chr5","138449226","138449355","chr13","7103461","7103581","24","131345765"
"chr5","138478357","138478516","chr14","83476931","83477090","32","55001426"
"chr5","138493243","138493555","chr13","7148222","7148532","47","131345021"
"chr5","138495433","138495646","chr13","7150448","7150655","22","131344985"
"chr5","138517372","138517577","chr6","867263","867478","48","137650109"
"chr5","138538140","138538440","chr13","7190055","7190368","53","131348085"
"chr5","138682266","138682392","chrX","48147386","48147512","24","90534880"
"chr5","138911969","138912053","chr2B","110194182","110194264","16","28717787"
"chr5","138946209","138946400","chr13","7574849","7575038","21","131371360"
"chr5","138969211","138969484","chr13","7597043","7597337","53","131372168"
"chr5","138995062","138995353","chr13","7623900","7624194","42","131371162"
"chr5","139023153","139023284","chr6","18588428","18588554","32","120434725"
"chr5","139136655","139136928","chr13","7839092","7839329","54","131297563"
"chr5","139173886","139174201","chr8","75463866","75464178","76","63710020"
"chr5","139191198","139191471","chr19","12751754","12752021","58","126439444"
"chr5","139228953","139229102","chr1","17928928","17929072","35","121300025"
"chr5","139229151","139229279","chr2A","7688549","7688677","23","131540602"
"chr5","139274897","139275176","chr6","1654209","1654492","76","137620688"
"chr5","139279533","139279724","chr13","7976473","7976675","30","131303060"
"chr5","139281133","139281253","chr13","7977824","7977947","11","131303309"
"chr5","139300371","139300594","chr6","109406591","109406814","67","29893780"
"chr5","139337471","139337722","chr13","8033875","8034114","42","131303596"
"chr5","139341544","139341791","chr13","8037487","8037733","23","131304057"
"chr5","139448560","139448869","chr13","8127658","8127942","59","131320902"
"chr5","139463448","139463744","chr7","76523012","76523308","57","62940436"
"chr5","139494163","139494477","chr11","36550949","36551258","68","102943214"
"chr5","139618400","139618607","chr12","109531872","109532078","43","30086528"
"chr5","139674759","139675036","chr13","8365030","8365303","46","131309729"
"chr5","139738763","139739100","chr13","8430428","8430739","56","131308335"
"chr5","139843587","139843894","chr13","8527217","8527522","41","131316370"
"chr5","139876964","139877081","chr12","109059002","109059125","24","30817962"
"chr5","139922015","139922311","chr13","8596229","8596519","46","131325786"
"chr5","139973469","139973730","chr13","8643717","8643976","28","131329752"
"chr5","139984184","139984500","chr13","8654329","8654646","35","131329855"
"chr5","140041463","140041725","chr13","8715856","8716124","40","131325607"
"chr5","140050687","140050812","chr9","66411487","66411609","29","73639200"
"chr5","140059139","140059430","chr1","22239695","22239995","58","117819444"
"chr5","140103625","140103919","chr13","8772868","8773169","31","131330757"
"chr5","140148230","140148506","chr9","111071857","111072138","55","29076373"
"chr5","140208531","140208681","chr8","25551358","25551514","36","114657173"
"chr5","140314036","140314332","chr13","8945844","8946128","46","131368192"
"chr5","140314353","140314549","chrX","53628878","53629071","41","86685475"
"chr5","140327998","140328113","chr20","46080183","46080300","27","94247815"
"chr5","140330365","140330672","chr13","8966278","8966576","49","131364087"
"chr5","140344309","140344599","chr2A","59048433","59048732","58","81295876"
"chr5","140347184","140347473","chr9","68772874","68773157","59","71574310"
"chr5","140349451","140349742","chr13","8983841","8984146","56","131365610"
"chr5","140362181","140362355","chr19","34709362","34709535","38","105652819"
"chr5","140407652","140407816","chr3","53169039","53169202","32","87238613"
"chr5","140412592","140412668","chr6","166694990","166695076","22","26282398"
"chr5","140413211","140413404","chr5","123706930","123707140","59","16706281"
"chr5","140440255","140440451","chr17","12392644","12392822","68","128047611"
"chr5","140440496","140440782","chr13","9070688","9070990","50","131369808"
"chr5","140446766","140447035","chr13","9077389","9077681","44","131369377"
"chr5","140464753","140464857","chr13","9103292","9103395","13","131361461"
"chr5","140468564","140468864","chr13","9107011","9107312","44","131361553"
"chr5","140469259","140469552","chr13","9107716","9108017","37","131361543"
"chr5","140483475","140483675","chr8","18127927","18128121","45","122355548"
"chr5","140517450","140517593","chr19","8474075","8474208","29","132043375"
"chr5","140600932","140601095","chr4","190209315","190209476","31","49608383"
"chr5","140601403","140601504","chr2A","95736091","95736198","23","44865312"
"chr5","140696909","140697193","chr13","9361706","9361993","32","131335203"
"chr5","140706832","140707113","chr3","32336937","32337197","70","108369895"
"chr5","140742800","140742911","chr13","9408000","9408111","9","131334800"
"chr5","140783619","140783912","chr13","9445342","9445650","58","131338277"
"chr5","140817593","140817876","chr13","9475981","9476254","39","131341612"
"chr5","140884425","140884712","chrX","70757717","70758005","64","70126708"
"chr5","140905137","140905296","chr15","19518412","19518568","38","121386725"
"chr5","140906095","140906393","chr13","9556082","9556380","32","131350013"
"chr5","140952679","140952819","chr1","32730027","32730168","29","108222652"
"chr5","140970159","140970286","chr4","40155438","40155567","23","100814721"
"chr5","140974568","140974849","chr20","39682251","39682537","53","101292317"
"chr5","140980691","140980947","chr13","9626438","9626721","46","131354253"
"chr5","140987466","140987582","chr1","40333767","40333884","20","100653699"
"chr5","141008869","141009130","chr13","9651234","9651509","39","131357635"
"chr5","141013037","141013332","chrX","42195739","42196023","66","98817298"
"chr5","141015846","141015971","chr7","11248117","11248241","14","129767729"
"chr5","141037000","141037149","chr13","9677868","9678017","15","131359132"
"chr5","141047291","141047408","chr1","65862925","65863041","19","75184366"
"chr5","141050500","141050798","chr13","9692532","9692835","42","131357968"
"chr5","141061741","141061957","chr12","95889570","95889785","53","45172171"
"chr5","141062041","141062252","chr14","35685336","35685541","43","105376705"
"chr5","141104521","141104729","chr13","9745377","9745566","34","131359144"
"chr5","141114630","141114712","chr1","150935395","150935475","23","9820765"
"chr5","141126268","141126359","chr2B","75126630","75126718","22","65999638"
"chr5","141137048","141137345","chr5","74133724","74134019","66","67003324"
"chr5","141142760","141142911","chr3","187249118","187249274","34","46106358"
"chr5","141159197","141159474","chr13","9799911","9800187","46","131359286"
"chr5","141167936","141168180","chr13","9807057","9807301","35","131360879"
"chr5","141170246","141170547","chr13","9808931","9809244","31","131361315"
"chr5","141182047","141182174","chr16","59134844","59134968","32","82047203"
"chr5","141193611","141193852","chr5","24284905","24285142","73","116908706"
"chr5","141196788","141196905","chr7","5629067","5629182","40","135567721"
"chr5","141207786","141208068","chr13","9853394","9853681","41","131354392"
"chr5","141219505","141219781","chr1","52409674","52409956","82","88809831"
"chr5","141258184","141258380","chr13","9900883","9901076","21","131357301"
"chr5","141322243","141322520","chr8","21173764","21174036","58","120148479"
"chr5","141383438","141383566","chr20","36705924","36706059","35","104677514"
"chr5","141418949","141419064","chr8","18215493","18215609","19","123203456"
"chr5","141425613","141425902","chr13","10082452","10082737","37","131343161"
"chr5","141482179","141482460","chr13","10138374","10138665","41","131343805"
"chr5","141528938","141529222","chr12","32032110","32032393","47","109496828"
"chr5","141533363","141533623","chr13","10191318","10191585","42","131342045"
"chr5","141534803","141534948","chr1","31279143","31279286","30","110255660"
"chr5","141564365","141564663","chr2A","18986462","18986752","64","122577903"
"chr5","141567721","141568027","chr13","10231029","10231331","36","131336692"
"chr5","141573013","141573322","chr13","10236786","10237092","32","131336227"
"chr5","141602928","141603050","chr13","10263370","10263504","19","131339558"
"chr5","141606856","141607124","chr13","10267422","10267689","25","131339434"
"chr5","141616992","141617100","chr15","46133130","46133239","15","95483862"
"chr5","141620577","141620846","chr4","94451130","94451398","53","47169447"
"chr5","141650198","141650455","chr13","10310688","10310949","53","131339510"
"chr5","141650650","141650915","chr22","8311524","8311782","65","133339126"
"chr5","141660210","141660498","chr13","10320820","10321109","42","131339390"
"chr5","141683185","141683319","chr10","106583754","106583888","21","35099431"
"chr5","141692561","141692850","chr14","41627283","41627568","56","100065278"
"chr5","141710949","141711134","chr2A","61355325","61355514","41","80355624"
"chr5","141711153","141711242","chr12","1865835","1865923","15","139845318"
"chr5","141711916","141712191","chr13","10374676","10374974","52","131337240"
"chr5","141726789","141727011","chr6","91869790","91870005","52","49856999"
"chr5","141754992","141755113","chr8","45313442","45313566","18","96441550"
"chr5","141758009","141758132","chr13","10427462","10427585","7","131330547"
"chr5","141761840","141762151","chr13","10431901","10432204","45","131329939"
"chr5","141850266","141850487","chr5","35374420","35374640","48","106475846"
"chr5","141916835","141917079","chr13","10560736","10560982","20","131356099"
"chr5","142042061","142042167","chr19","16749128","16749228","20","125292933"
"chr5","142265422","142265728","chr12","114808537","114808845","70","27456885"
"chr5","142326150","142326406","chr13","10889311","10889573","36","131436839"
"chr5","142332046","142332339","chr13","10895308","10895590","47","131436738"
"chr5","142360235","142360475","chr5","95553887","95554136","58","46806348"
"chr5","142416552","142416669","chr13","10985294","10985413","12","131431258"
"chr5","142479011","142479284","chr13","11053486","11053782","59","131425525"
"chr5","142575998","142576256","chr5","107028476","107028728","65","35547522"
"chr5","142621739","142622044","chr2A","98279927","98280227","69","44341812"
"chr5","142626976","142627287","chr13","11150150","11150465","41","131476826"
"chr5","142641956","142642256","chr13","11165022","11165313","41","131476934"
"chr5","142679559","142679841","chr6","109335846","109336125","65","33343713"
"chr5","142717914","142718007","chr4","112859931","112860023","16","29857983"
"chr5","142718426","142718617","chr3","131181946","131182128","52","11536480"
"chr5","142815134","142815427","chr13","11376889","11377212","53","131438245"
"chr5","142841094","142841381","chr15","46947623","46947922","67","95893471"
"chr5","142910220","142910431","chr11","108497144","108497351","46","34413076"
"chr5","143150156","143150445","chr13","11733386","11733662","42","131416770"
"chr5","143278888","143279170","chr13","11853194","11853481","33","131425694"
"chr5","143336044","143336349","chr13","11910427","11910727","46","131425617"
"chr5","143349624","143349946","chr10","108530375","108530685","73","34819249"
"chr5","143408580","143408734","chr8","74467980","74468139","32","68940600"
"chr5","143417995","143418135","chr13","11984875","11985011","19","131433120"
"chr5","143418463","143418583","chr5","124152960","124153079","22","19265503"
"chr5","143451990","143452081","chrX","3394860","3394959","24","140057130"
"chr5","143455407","143455683","chr14","54791229","54791504","57","88664178"
"chr5","143468327","143468624","chr13","12024951","12025246","35","131443376"
"chr5","143507939","143508300","chr13","12061828","12062129","101","131446111"
"chr5","143515183","143515312","chr13","12068167","12068296","15","131447016"
"chr5","143517919","143518214","chr13","12071196","12071495","47","131446723"
"chr5","143523330","143523501","chr19","13310072","13310233","40","130213258"
"chr5","143531871","143531958","chr20","7957406","7957489","18","135574465"
"chr5","143533032","143533153","chr13","12085792","12085915","6","131447240"
"chr5","143553336","143553513","chr4","101865859","101866026","43","41687477"
"chr5","143558676","143558974","chr13","12112276","12112578","49","131446400"
"chr5","143559507","143559777","chr13","83729108","83729370","76","59830399"
"chr5","143565447","143565575","chr6","18588428","18588554","33","124977019"
"chr5","143568543","143568805","chr13","12122949","12123227","34","131445594"
"chr5","143577293","143577424","chr5","26663357","26663492","36","116913936"
"chr5","143589820","143589958","chr13","12143497","12143628","22","131446323"
"chr5","143592591","143592897","chr13","12146318","12146602","50","131446273"
"chr5","143615154","143615275","chr13","12179291","12179406","21","131435863"
"chr5","143626886","143627184","chr13","12193053","12193361","43","131433833"
"chr5","143639647","143639949","chr13","12206769","12207066","43","131432878"
"chr5","143645243","143645367","chrX","95494066","95494189","17","48151177"
"chr5","143795661","143795897","chr13","12359380","12359631","32","131436281"
"chr5","143801906","143802050","chr9","41896796","41896941","31","101905110"
"chr5","143835464","143835751","chr12","98465934","98466215","64","45369530"
"chr5","143866678","143867000","chr13","12428070","12428361","61","131438608"
"chr5","143889600","143889896","chr13","12452791","12453096","40","131436809"
"chr5","143900923","143901233","chr13","12463602","12463911","32","131437321"
"chr5","143911144","143911454","chr13","12473801","12474122","55","131437343"
"chr5","143911632","143911704","chr1","179535363","179535435","11","35623731"
"chr5","143951979","143952294","chr13","12511978","12512273","58","131440001"
"chr5","143984616","143984919","chr13","12541480","12541788","46","131443136"
"chr5","144025108","144025406","chr19","56600116","56600403","70","87424992"
"chr5","144121279","144121568","chr13","12674768","12675059","22","131446511"
"chr5","144131186","144131452","chr5","98682121","98682358","71","45449065"
"chr5","144249296","144249420","chr13","12783373","12783514","37","131465923"
"chr5","144305299","144305611","chr13","12843715","12844018","76","131461584"
"chr5","144407875","144407996","chr13","12975319","12975440","13","131432556"
"chr5","144437565","144437839","chr13","13012107","13012383","42","131425458"
"chr5","144451919","144452141","chr6","169286751","169286969","41","24834832"
"chr5","144640347","144640651","chr13","13196845","13197147","48","131443502"
"chr5","144668518","144668788","chr13","13232793","13233088","54","131435725"
"chr5","144671650","144671922","chr13","13235928","13236217","47","131435722"
"chr5","144672278","144672570","chr13","13236584","13236873","37","131435694"
"chr5","144802914","144803163","chr13","13367083","13367334","32","131435831"
"chr5","144838096","144838390","chr13","13399555","13399852","38","131438541"
"chr5","144916226","144916514","chr13","13473313","13473607","33","131442913"
"chr5","145021271","145021566","chr13","13574620","13574917","33","131446651"
"chr5","145047891","145048192","chr13","13603776","13604074","52","131444115"
"chr5","145138706","145138822","chr13","13700524","13700643","9","131438182"
"chr5","145161304","145161590","chr13","13722210","13722502","48","131439094"
"chr5","145358943","145359202","chr5","137812937","137813203","62","7546006"
"chr5","145369847","145370144","chr13","13913175","13913473","31","131456672"
"chr5","145386603","145386896","chr1","91019845","91020139","60","54366758"
"chr5","145435336","145435444","chr3","186615177","186615282","22","41179841"
"chr5","145485887","145486199","chr13","14029769","14030079","51","131456118"
"chr5","145527542","145527670","chr6","140226866","140226994","24","5300676"
"chr5","145563217","145563497","chr8","47441615","47441889","58","98121602"
"chr5","145564962","145565072","chr16","80007307","80007417","20","65557655"
"chr5","145565518","145565709","chr12","119828488","119828678","43","25737030"
"chr5","145589079","145589372","chr19","13663933","13664211","67","131925146"
"chr5","145636275","145636546","chr13","14157527","14157811","56","131478748"
"chr5","145670074","145670192","chr13","14189995","14190109","18","131480079"
"chr5","145795114","145795372","chr13","14301990","14302263","55","131493124"
"chr5","145802971","145803282","chr12","129719028","129719334","67","16083943"
"chr5","145851130","145851407","chr13","14343899","14344182","37","131507231"
"chr5","145862125","145862393","chr13","14355055","14355318","38","131507070"
"chr5","145948690","145948994","chr13","14461443","14461752","50","131487247"
"chr5","145984731","145984947","chr13","14474052","14474264","28","131510679"
"chr5","146038593","146038898","chr13","14520537","14520837","35","131518056"
"chr5","146055714","146055882","chr1","129229734","129229887","45","16825980"
"chr5","146112927","146113219","chr13","14596723","14597014","30","131516204"
"chr5","146119209","146119519","chr13","14603114","14603408","46","131516095"
"chr5","146174806","146174936","chr18","53011243","53011373","25","93163563"
"chr5","146193209","146193275","chr12","95179050","95179109","18","51014159"
"chr5","146193276","146193324","chr8","107849029","107849079","15","38344247"
"chr5","146314934","146315238","chr16","23969667","23969975","62","122345267"
"chr5","146356378","146356686","chr12","117915036","117915337","59","28441342"
"chr5","146523768","146524022","chr2A","37321978","37322207","75","109201790"
"chr5","146546708","146547000","chr13","14994534","14994828","29","131552174"
"chr5","146559925","146560121","chr16","30447854","30448050","52","116112071"
"chr5","146562217","146562379","chr1","41590742","41590907","34","104971475"
"chr5","146605473","146605731","chr13","15053940","15054227","61","131551533"
"chr5","146645003","146645265","chr10","29463506","29463778","64","117181497"
"chr5","146704573","146704847","chr13","15180267","15180566","54","131524306"
"chr5","146718401","146718574","chr12","132916938","132917116","40","13801463"
"chr5","146726439","146726726","chr13","15205542","15205829","27","131520897"
"chr5","146796859","146797165","chr13","15285940","15286248","29","131510919"
"chr5","146801431","146801717","chr13","15288899","15289190","29","131512532"
"chr5","147111927","147112182","chr2A","64308674","64308931","71","82803253"
"chr5","147126116","147126391","chr5","129980112","129980378","56","17146004"
"chr5","147137322","147137549","chr13","15627433","15627683","47","131509889"
"chr5","147254767","147255049","chr13","15735932","15736232","43","131518835"
"chr5","147255287","147255575","chr4","196496668","196496955","71","49241381"
"chr5","147378023","147378311","chr13","15856494","15856778","48","131521529"
"chr5","147416703","147416993","chr19","29654539","29654825","65","117762164"
"chr5","147424351","147424666","chr13","15905571","15905878","40","131518780"
"chr5","147605195","147605456","chr19","9600675","9600939","75","138004520"
"chr5","147910983","147911272","chr9","16232960","16233249","64","131678023"
"chr5","148005020","148005259","chr5","39883101","39883349","63","108121919"
"chr5","148074952","148075247","chr8","24118205","24118491","65","123956747"
"chr5","148081828","148082126","chr16","48491470","48491779","68","99590358"
"chr5","148083841","148084123","chr13","16617719","16617996","38","131466122"
"chr5","148102772","148103037","chr1","41046990","41047239","72","107055782"
"chr5","148366694","148366992","chr13","16917414","16917707","30","131449280"
"chr5","148424710","148424938","chr1","43997572","43997802","54","104427138"
"chr5","148582424","148582738","chr13","17128357","17128671","40","131454067"
"chr5","148653507","148653762","chr13","17208952","17209208","34","131444555"
"chr5","148693822","148694125","chr13","17248484","17248784","41","131445338"
"chr5","148764819","148764945","chr13","17317044","17317167","18","131447775"
"chr5","148768618","148768745","chr13","17320819","17320946","14","131447799"
"chr5","148795661","148795908","chr13","17348700","17348967","57","131446961"
"chr5","148801897","148802173","chr13","17355242","17355529","40","131446655"
"chr5","148836794","148837063","chr2B","82555771","82556044","65","66281023"
"chr5","148870866","148871158","chr5","18973376","18973674","66","129897490"
"chr5","148877664","148877973","chr13","17433760","17434059","51","131443904"
"chr5","148885593","148885900","chr13","17441526","17441837","46","131444067"
"chr5","148917212","148917346","chr5","44710296","44710425","27","104206916"
"chr5","148937324","148937540","chr1","204178269","204178477","58","55240945"
"chr5","149013091","149013377","chr13","17565768","17566051","28","131447323"
"chr5","149020969","149021240","chr13","17573934","17574229","54","131447035"
"chr5","149053858","149054158","chr13","17606197","17606503","37","131447661"
"chr5","149104061","149104381","chr13","17636586","17636894","65","131467475"
"chr5","149117229","149117534","chr12","100493327","100493639","80","48623902"
"chr5","149130064","149130179","chr3","200179996","200180111","15","51049932"
"chr5","149367390","149367701","chr7","79073505","79073807","70","70293885"
"chr5","149423034","149423311","chr13","17939342","17939622","29","131483692"
"chr5","149437531","149437809","chr13","17954218","17954474","72","131483313"
"chr5","149440326","149440586","chr13","17956725","17956986","53","131483601"
"chr5","149477549","149477842","chr13","17983168","17983462","23","131494381"
"chr5","149574940","149575103","chr1","52325310","52325464","40","97249630"
"chr5","149587405","149587569","chr7","74190896","74191062","35","75396509"
"chr5","149698990","149699154","chr14","48531182","48531343","34","101167808"
"chr5","149794875","149795181","chr14","49331767","49332062","77","100463108"
"chr5","149954754","149955043","chr13","18461827","18462131","47","131492927"
"chr5","150003073","150003378","chr13","18513467","18513761","37","131489606"
"chr5","150035065","150035357","chr13","18568777","18569070","43","131466288"
"chr5","150039382","150039651","chr13","18573310","18573572","44","131466072"
"chr5","150040415","150040521","chr1","45273792","45273898","26","104766623"
"chr5","150122241","150122343","chr13","18653021","18653122","15","131469220"
"chr5","150123804","150124105","chr13","18654542","18654845","39","131469262"
"chr5","150155466","150155543","chr19","18194834","18194910","14","131960632"
"chr5","150156331","150156549","chrX","48678555","48678774","32","101477776"
"chr5","150170290","150170483","chr14","55573520","55573722","46","94596770"
"chr5","150171672","150171957","chr13","18710356","18710646","48","131461316"
"chr5","150195087","150195347","chr13","18731503","18731785","45","131463584"
"chr5","150197548","150197876","chr1","38725612","38725922","81","111471936"
"chr5","150324527","150324686","chr11","128247655","128247811","40","22076872"
"chr5","150365424","150365701","chr13","18894891","18895189","44","131470533"
"chr5","150500560","150500834","chr3","186752150","186752418","72","36251590"
"chr5","150595915","150596200","chr13","19159009","19159294","32","131436906"
"chr5","150773377","150773487","chr13","9408000","9408111","23","141365377"
"chr5","150873835","150874043","chrX","49057508","49057706","55","101816327"
"chr5","150917834","150917950","chr4","93672465","93672581","35","57245369"
"chr5","150990176","150990453","chr14","46667678","46667957","78","104322498"
"chr5","151235453","151235742","chr13","19834705","19834979","57","131400748"
"chr5","151415443","151415541","chr6","22044509","22044604","23","129370934"
"chr5","151415766","151415927","chr5","26365836","26366003","48","125049930"
"chr5","151633960","151634233","chr13","20195779","20196047","55","131438181"
"chr5","151710782","151710872","chr3","130502096","130502185","29","21208686"
"chr5","151814406","151814579","chr8","56795337","56795503","45","95019069"
"chr5","151854774","151855072","chr13","20410808","20411110","43","131443966"
"chr5","151862510","151862819","chr7","78875895","78876201","60","72986615"
"chr5","151894806","151895012","chr14","10759685","10759897","51","141135121"
"chr5","152028686","152028807","chr13","20539403","20539524","8","131489283"
"chr5","152130724","152131010","chr13","20679679","20679978","43","131451045"
"chr5","152443562","152443894","chr12","110876937","110877251","82","41566625"
"chr5","152463847","152464123","chr7","5095566","5095848","64","147368281"
"chr5","152527560","152527839","chr13","21065296","21065582","44","131462264"
"chr5","152631945","152632265","chr3","24259376","24259676","74","128372569"
"chr5","152641313","152641620","chr13","21183727","21184035","31","131457586"
"chr5","152693399","152693659","chr6","112499268","112499520","65","40194131"
"chr5","152747266","152747571","chr13","21290520","21290799","49","131456746"
"chr5","152784888","152785009","chr13","21332490","21332611","13","131452398"
"chr5","152792366","152792677","chr13","21340061","21340367","43","131452305"
"chr5","152816137","152816344","chr13","21363237","21363446","26","131452900"
"chr5","152858723","152858834","chr3","25953481","25953598","18","126905242"
"chr5","152877728","152878010","chr13","21445565","21445855","54","131432163"
"chr5","152887070","152887349","chr13","21451030","21451321","37","131436040"
"chr5","152889975","152890136","chr13","32055352","32055524","33","120834623"
"chr5","153107925","153108227","chr11","46356683","46356967","69","106751242"
"chr5","153109239","153109509","chr13","21664212","21664514","52","131445027"
"chr5","153134253","153134381","chr13","31826426","31826561","34","121307827"
"chr5","153339692","153339939","chr5","121538155","121538406","66","31801537"
"chr5","153366202","153366474","chr1","191294315","191294590","60","37928113"
"chr5","153473420","153473622","chr1","206109352","206109569","61","52635932"
"chr5","153508760","153508989","chr8","78732114","78732343","53","74776646"
"chr5","153529417","153529696","chr16","30314290","30314572","52","123215127"
"chr5","153604493","153604543","chr3","33280987","33281035","6","120323506"
"chr5","153604545","153604694","chr1","148219593","148219735","38","5384952"
"chr5","153622057","153622160","chr10","66507605","66507710","18","87114452"
"chr5","153622339","153622492","chr7","79271528","79271684","32","74350811"
"chr5","153649874","153649980","chr8","41272197","41272300","18","112377677"
"chr5","153704689","153704958","chr5","122777482","122777749","62","30927207"
"chr5","153735868","153736164","chr13","22282202","22282494","42","131453666"
"chr5","153834507","153834776","chr22","20701689","20701960","67","133132818"
"chr5","153864137","153864419","chr13","22425813","22426124","61","131438324"
"chr5","153875840","153875948","chr15","67195750","67195860","19","86680090"
"chr5","153916535","153916814","chr13","22477916","22478219","61","131438619"
"chr5","153927933","153928093","chr12","19312537","19312701","31","134615396"
"chr5","153961813","153962111","chr13","22518215","22518508","29","131443598"
"chr5","153975236","153975505","chr9","95834668","95834930","72","58140568"
"chr5","153990699","153990958","chr13","2828347","2828592","37","151162352"
"chr5","153996056","153996346","chr13","1107109","1107385","30","152888947"
"chr5","154028173","154028447","chr13","22584947","22585217","31","131443226"
"chr5","154047556","154047657","chr2B","16451102","16451202","20","137596454"
"chr5","154073466","154073586","chr14","60352578","60352701","28","93720888"
"chr5","154197999","154198129","chr1","113976725","113976855","27","40221274"
"chr5","154216090","154216290","chr5","125859037","125859236","40","28357053"
"chr5","154254008","154254215","chr13","22763950","22764155","26","131490058"
"chr5","154255722","154256038","chr5","28966719","28967020","66","125289003"
"chr5","154273247","154273548","chr13","22787714","22788014","39","131485533"
"chr5","154282656","154282907","chr13","22796576","22796818","59","131486080"
"chr5","154293149","154293469","chr13","22806718","22807042","34","131486431"
"chr5","154311688","154311967","chr13","22824611","22824915","47","131487077"
"chr5","154317790","154317949","chr3","14267985","14268147","34","140049805"
"chr5","154381396","154381627","chr10","102305206","102305417","49","52076190"
"chr5","154403688","154403990","chr13","22961825","22962112","49","131441863"
"chr5","154406690","154406805","chr6","127602471","127602587","24","26804219"
"chr5","154421657","154421802","chr3","155574758","155574899","31","1153101"
"chr5","154445027","154445312","chr13","23015073","23015359","34","131429954"
"chr5","154446281","154446396","chr13","23016626","23016731","19","131429655"
"chr5","154460744","154460895","chr13","3468265","3468414","37","150992479"
"chr5","154502916","154503112","chr3","45233841","45234045","45","109269075"
"chr5","154512714","154512991","chr1","111668107","111668390","68","42844607"
"chr5","154516105","154516259","chr7","101350172","101350327","34","53165933"
"chr5","154516569","154516687","chrX","8471635","8471753","21","146044934"
"chr5","154535982","154536098","chr13","23113998","23114114","13","131421984"
"chr5","154538790","154539083","chr1","227415933","227416230","53","72877143"
"chr5","154546641","154546922","chr13","23121768","23122061","37","131424873"
"chr5","154566070","154566243","chr1","140435853","140436033","40","14130217"
"chr5","154566473","154566672","chr6","169957830","169958043","43","15391357"
"chr5","154573813","154574080","chr13","23156453","23156725","30","131417360"
"chr5","154597324","154597522","chr10","7421667","7421862","42","147175657"
"chr5","154669149","154669271","chr6","154239364","154239482","25","429785"
"chr5","154672642","154672918","chr8","126696473","126696750","76","27976169"
"chr5","154693185","154693324","chr13","23348325","23348450","23","131344860"
"chr5","154747291","154747592","chr13","23405260","23405570","48","131342031"
"chr5","154751662","154751950","chr13","23409675","23409975","42","131341987"
"chr5","154813391","154813695","chr12","104448431","104448741","61","50364960"
"chr5","154860000","154860287","chr13","23521366","23521659","17","131338634"
"chr5","154969758","154970063","chr13","23652661","23652975","53","131317097"
"chr5","154980468","154980581","chr13","23666442","23666556","12","131314026"
"chr5","155161337","155161502","chr1","225047988","225048129","45","69886651"
"chr5","155193420","155193676","chr13","23861563","23861812","27","131331857"
"chr5","155198687","155198984","chr13","23866730","23867014","54","131331957"
"chr5","155203340","155203614","chr13","23870284","23870542","51","131333056"
"chr5","155204723","155204796","chr6","110723783","110723860","13","44480940"
"chr5","155211487","155211634","chr19","14904383","14904528","41","140307104"
"chr5","155301548","155301805","chr13","23959551","23959808","29","131341997"
"chr5","155315453","155315711","chr13","23975876","23976151","50","131339577"
"chr5","155324914","155325094","chr12","121559906","121560083","45","33765008"
"chr5","155326881","155327179","chr16","60238828","60239122","56","95088053"
"chr5","155360172","155360451","chr13","24013418","24013704","57","131346754"
"chr5","155390978","155391200","chr19","11632000","11632216","67","143758978"
"chr5","155405053","155405344","chr7","127917187","127917476","55","27487866"
"chr5","155412166","155412455","chr13","24061649","24061926","50","131350517"
"chr5","155444706","155444982","chr8","120899773","120900052","73","34544933"
"chr5","155546881","155547178","chr13","24181919","24182227","54","131364962"
"chr5","155602584","155602704","chr13","24220785","24220906","10","131381799"
"chr5","155650393","155650685","chr13","24329974","24330284","54","131320419"
"chr5","155702567","155702863","chr13","24329974","24330284","63","131372593"
"chr5","155812234","155812538","chr16","64618270","64618576","76","91193964"
"chr5","155832872","155833163","chr13","24464402","24464677","50","131368470"
"chr5","155848635","155848759","chr12","113288103","113288219","19","42560532"
"chr5","155892711","155893006","chr9","79520482","79520769","62","76372229"
"chr5","155961691","155961775","chr3","130502096","130502185","31","25459595"
"chr5","155961935","155962110","chr10","100293340","100293507","54","55668595"
"chr5","156011910","156012088","chr1","130297384","130297555","45","25714526"
"chr5","156063272","156063554","chr13","24683705","24684004","52","131379567"
"chr5","156139019","156139286","chr13","24748760","24749030","35","131390259"
"chr5","156145566","156145717","chr16","49011895","49012046","27","107133671"
"chr5","156257399","156257641","chr18","57396018","57396245","62","98861381"
"chr5","156262613","156262734","chr5","82672298","82672415","29","73590315"
"chr5","156803978","156804268","chr13","25374516","25374817","45","131429462"
"chr5","156851032","156851231","chr6","35112653","35112849","48","121738379"
"chr5","156857550","156857833","chr13","25423287","25423575","40","131434263"
"chr5","156916334","156916644","chr13","25477948","25478252","54","131438386"
"chr5","157050910","157051218","chr13","25607641","25607932","46","131443269"
"chr5","157235998","157236182","chr13","25732301","25732498","32","131503697"
"chr5","157263685","157263976","chr13","25750586","25750890","48","131513099"
"chr5","157274724","157274845","chr7","71842255","71842378","15","85432469"
"chr5","157580514","157580806","chr13","26073478","26073794","54","131507036"
"chr5","157631016","157631316","chr13","26122983","26123279","33","131508033"
"chr5","157677057","157677197","chr10","131562341","131562480","31","26114716"
"chr5","157702973","157703260","chr13","26190098","26190397","38","131512875"
"chr5","157703556","157703861","chr13","26190722","26191031","44","131512834"
"chr5","157709922","157710209","chr13","26198063","26198376","58","131511859"
"chr5","157743381","157743526","chr22","20288134","20288276","30","137455247"
"chr5","157839324","157839448","chr13","26320261","26320385","12","131519063"
"chr5","157840437","157840604","chr6","44423704","44423873","30","113416733"
"chr5","157864086","157864380","chr8","110138676","110138979","68","47725410"
"chr5","157914853","157914959","chr13","26397936","26398053","17","131516917"
"chr5","157988002","157988257","chr13","26503383","26503642","40","131484619"
"chr5","158104402","158104605","chr15","54901975","54902178","54","103202427"
"chr5","158113942","158114046","chr1","39325820","39325928","22","118788122"
"chr5","158135191","158135533","chr13","26641305","26641652","41","131493886"
"chr5","158186882","158187155","chrX","119498447","119498725","58","38688435"
"chr5","158206816","158206955","chr13","26705412","26705556","24","131501404"
"chr5","158231373","158231669","chr4","109931819","109932111","72","48299554"
"chr5","158255717","158255977","chrX","97580177","97580430","57","60675540"
"chr5","158278855","158279143","chr12","129157038","129157334","58","29121817"
"chr5","158325985","158326267","chr13","26817914","26818196","29","131508071"
"chr5","158379576","158379890","chr13","26871807","26872124","44","131507769"
"chr5","158382597","158382866","chr17","63221561","63221833","60","95161036"
"chr5","158395214","158395330","chr3","124652697","124652800","28","33742517"
"chr5","158395410","158395588","chr10","100293340","100293507","51","58102070"
"chr5","158476775","158476892","chr6","87517319","87517435","19","70959456"
"chr5","158527501","158527780","chr13","27007865","27008149","41","131519636"
"chr5","158541443","158541591","chr1","68709407","68709549","36","89832036"
"chr5","158583922","158584235","chr10","117592754","117593059","54","40991168"
"chr5","158612504","158612791","chr13","27104705","27104993","29","131507799"
"chr5","158659061","158659215","chr12","96146944","96147098","37","62512117"
"chr5","158682646","158682761","chr5","40694224","40694348","21","117988422"
"chr5","158725045","158725159","chr13","27308018","27308135","15","131417027"
"chr5","158775595","158775886","chr4","163427930","163428220","69","4652335"
"chr5","158776289","158776354","chr6","117254013","117254072","20","41522276"
"chr5","158931389","158931598","chr1","189712782","189712986","45","30781393"
"chr5","158972966","158973047","chr13","79059499","79059579","12","79913467"
"chr5","158989209","158989418","chr13","27503213","27503425","26","131485996"
"chr5","159056677","159056744","chr19","12619251","12619320","19","146437426"
"chr6","22151028","22151326","chr5","7510160","7510460","56","14640868"
"chr6","50462681","50462787","chr1","78884921","78885036","21","28422240"
"chr6","85065717","85065992","chr2B","26848692","26848957","45","58217025"
"chr6","115212250","115212555","chr2B","92658043","92658342","28","22554207"
"chr6","119144165","119144449","chr2B","96226745","96227028","33","22917420"
"chr6","141295371","141295656","chr2B","118024540","118024845","63","23270831"
"chr6","34194","34280","chr7","72673757","72673835","30","72639563"
"chr6","63157","63461","chr15","1733974","1734290","50","1670817"
"chr6","66052","66390","chr8","128038362","128038659","94","127972310"
"chr6","90056","90354","chr10","12275966","12276259","68","12185910"
"chr6","120936","121222","chr9","113776027","113776319","59","113655091"
"chr6","121223","121522","chr12","32451092","32451384","65","32329869"
"chr6","123813","123873","chr20","5437354","5437412","12","5313541"
"chr6","185806","186083","chr1","160259631","160259915","71","160073825"
"chr6","195881","196047","chr16","76317400","76317554","36","76121519"
"chr6","213206","213357","chr8","9901944","9902090","46","9688738"
"chr6","336795","337037","chr15","2306477","2306721","37","1969682"
"chr6","354553","354846","chr15","2329948","2330246","46","1975395"
"chr6","445502","445627","chr15","2408320","2408446","17","1962818"
"chr6","692361","692657","chr12","110756931","110757228","65","110064570"
"chr6","756785","757038","chr1","28926797","28927043","79","28170012"
"chr6","773022","773268","chr16","75415921","75416170","59","74642899"
"chr6","989252","989371","chr15","3360220","3360339","8","2370968"
"chr6","989545","989706","chr1","101627475","101627654","46","100637930"
"chr6","989848","989965","chr4","37764421","37764538","21","36774573"
"chr6","990530","990823","chr15","3361621","3361927","57","2371091"
"chr6","999253","999547","chr4","198220967","198221262","65","197221714"
"chr6","1015858","1016134","chr15","3384957","3385262","63","2369099"
"chr6","1044354","1044587","chr15","3418022","3418290","67","2373668"
"chr6","1092131","1092350","chr1","125661553","125661746","65","124569422"
"chr6","1167619","1167918","chr13","82626668","82626964","77","81459049"
"chr6","1198071","1198303","chr15","3566827","3567055","32","2368756"
"chr6","1245530","1245822","chr15","3605785","3606065","39","2360255"
"chr6","1453025","1453299","chr6","1660683","1660963","70","207658"
"chr6","1453321","1453395","chr11","106359869","106359951","23","104906548"
"chr6","1494508","1494728","chr15","3879407","3879623","34","2384899"
"chr6","1503640","1503885","chr15","3885790","3886068","59","2382150"
"chr6","1577893","1578077","chr15","3982348","3982542","34","2404455"
"chr6","1581342","1581623","chr15","3985299","3985578","33","2403957"
"chr6","1612204","1612486","chr10","14090497","14090769","76","12478293"
"chr6","1628654","1628776","chr2A","64428266","64428391","15","62799612"
"chr6","1692953","1693246","chr15","4154201","4154508","63","2461248"
"chr6","1748731","1748847","chr3","54400504","54400618","28","52651773"
"chr6","1764223","1764419","chr1","94804550","94804754","49","93040327"
"chr6","1770043","1770333","chr15","4232161","4232466","47","2462118"
"chr6","1798525","1798814","chr15","4270981","4271283","44","2472456"
"chr6","1813694","1814001","chr15","4292548","4292844","39","2478854"
"chr6","1859105","1859385","chr15","4337139","4337431","54","2478034"
"chr6","1861813","1861920","chr15","4341702","4341817","23","2479889"
"chr6","1872722","1872845","chr5","124432264","124432393","35","122559542"
"chr6","1909686","1909949","chr15","4421169","4421432","28","2511483"
"chr6","1913676","1913815","chr7","45193364","45193496","26","43279688"
"chr6","1955776","1956030","chr12","93833034","93833282","71","91877258"
"chr6","1970430","1970572","chr9","108497174","108497318","27","106526744"
"chr6","1975579","1975757","chr15","4514901","4515083","25","2539322"
"chr6","2033193","2033442","chr15","4602720","4602960","49","2569527"
"chr6","2151117","2151443","chr15","4712605","4712917","47","2561488"
"chr6","2208408","2208702","chr15","4825990","4826292","37","2617582"
"chr6","2346421","2346723","chr15","4971219","4971504","54","2624798"
"chr6","2383267","2383582","chr15","5019718","5020030","53","2636451"
"chr6","2397329","2397611","chr15","5031128","5031384","65","2633799"
"chr6","2414373","2414677","chr15","5047836","5048134","49","2633463"
"chr6","2420729","2420848","chrX","151068414","151068537","18","148647685"
"chr6","2445541","2445839","chr15","5094325","5094633","47","2648784"
"chr6","2486033","2486156","chr4","125095292","125095415","22","122609259"
"chr6","2486953","2487076","chr22","15623558","15623681","22","13136605"
"chr6","2491742","2491995","chr16","29812981","29813238","60","27321239"
"chr6","2540199","2540353","chr3","59350634","59350793","37","56810435"
"chr6","2598422","2598723","chr15","5246767","5247048","57","2648345"
"chr6","2614725","2615024","chr15","5261571","5261892","68","2646846"
"chr6","2673253","2673544","chr9","33082995","33083289","60","30409742"
"chr6","2696933","2697203","chr4","199241173","199241439","75","196544240"
"chr6","2707968","2708254","chr12","108187360","108187656","62","105479392"
"chr6","2809996","2810284","chr15","5469530","5469821","57","2659534"
"chr6","2930893","2931017","chr3","125378751","125378875","20","122447858"
"chr6","2940480","2940766","chr15","5590669","5590968","44","2650189"
"chr6","2954371","2954472","chr20","14083703","14083797","32","11129332"
"chr6","3027394","3027534","chr12","29807232","29807384","27","26779838"
"chr6","3029694","3029951","chr15","5694712","5694981","45","2665018"
"chr6","3187221","3187498","chr15","5886542","5886829","45","2699321"
"chr6","3188528","3188827","chr15","5896698","5896992","60","2708170"
"chr6","3315750","3316077","chr15","6023794","6024117","52","2708044"
"chr6","3318727","3319005","chr15","6027218","6027519","55","2708491"
"chr6","3648644","3648699","chr4","159906082","159906143","15","156257438"
"chr6","3686468","3686746","chr15","6473329","6473615","41","2786861"
"chr6","3722077","3722375","chr15","6519934","6520222","47","2797857"
"chr6","3735069","3735323","chr1","163471667","163471927","57","159736598"
"chr6","3795412","3795708","chrX","54099268","54099560","64","50303856"
"chr6","3812628","3812784","chr19","5169265","5169417","34","1356637"
"chr6","3875778","3875893","chr1","61407572","61407685","32","57531794"
"chr6","3939976","3940232","chrX","71273951","71274197","67","67333975"
"chr6","3967366","3967613","chr7","76312181","76312445","61","72344815"
"chr6","4044928","4045050","chr11","61771478","61771601","23","57726550"
"chr6","4046135","4046398","chr15","10020245","10020516","51","5974110"
"chr6","4600730","4600890","chr3","49411661","49411824","36","44810931"
"chr6","4675337","4675450","chr16","23488866","23488983","22","18813529"
"chr6","4716292","4716494","chr5","58665127","58665321","50","53948835"
"chr6","4719188","4719299","chr4","8171547","8171660","23","3452359"
"chr6","4892793","4893085","chr1","21215958","21216257","60","16323165"
"chr6","4909956","4910215","chr15","8959700","8959963","40","4049744"
"chr6","4920149","4920480","chr15","8950038","8950377","47","4029889"
"chr6","5147777","5148073","chr1","227415933","227416230","56","222268156"
"chr6","5201401","5201659","chr11","117886515","117886786","63","112685114"
"chr6","5351158","5351288","chr22","7738309","7738432","15","2387151"
"chr6","5378925","5379198","chr15","7320630","7320904","27","1941705"
"chr6","5421545","5421817","chr15","7371403","7371666","59","1949858"
"chr6","5508614","5508733","chr7","76940267","76940373","38","71431653"
"chr6","5519767","5520063","chr7","76467472","76467760","66","70947705"
"chr6","5533279","5533575","chr15","7477765","7478070","46","1944486"
"chr6","5538087","5538385","chr15","7483319","7483618","62","1945232"
"chr6","5557198","5557501","chr15","7503063","7503363","43","1945865"
"chr6","5678988","5679257","chr15","7662810","7663078","62","1983822"
"chr6","5736732","5737016","chr15","7705918","7706201","48","1969186"
"chr6","5770750","5770907","chr4","195577197","195577355","34","189806447"
"chr6","5771688","5771726","chr7","84086701","84086738","9","78315013"
"chr6","5775350","5775513","chr7","76406429","76406606","40","70631079"
"chr6","5828732","5828997","chr15","7804401","7804668","27","1975669"
"chr6","5907690","5907992","chr15","7882547","7882865","58","1974857"
"chr6","5910295","5910567","chrX","20448281","20448539","86","14537986"
"chr6","5911743","5911967","chrX","48678555","48678774","60","42766812"
"chr6","5938900","5939175","chr16","75796161","75796439","56","69857261"
"chr6","6111441","6111668","chr15","8078541","8078783","41","1967100"
"chr6","6132995","6133294","chr15","8105316","8105604","35","1972321"
"chr6","6157011","6157307","chr15","8129279","8129581","39","1972268"
"chr6","6287454","6287583","chr7","85668796","85668925","32","79381342"
"chr6","6501683","6501976","chr1","181256651","181256946","55","174754968"
"chr6","6550587","6550742","chr10","49585047","49585201","27","43034460"
"chr6","6591439","6591605","chr11","58592944","58593112","37","52001505"
"chr6","6651631","6651722","chr14","73617503","73617594","18","66965872"
"chr6","6653306","6653432","chr15","80288886","80289012","11","73635580"
"chr6","6715595","6715679","chr6","160538506","160538583","27","153822911"
"chr6","6821876","6821992","chr15","80159595","80159712","10","73337719"
"chr6","6823472","6823762","chr15","80157828","80158122","25","73334356"
"chr6","6825554","6825704","chr22","15473787","15473944","38","8648233"
"chr6","6846677","6846975","chr15","80124976","80125264","39","73278299"
"chr6","6855548","6855817","chr5","123044436","123044686","64","116188888"
"chr6","6930761","6930927","chr14","75665234","75665401","39","68734473"
"chr6","6961287","6961585","chr15","79994264","79994568","42","73032977"
"chr6","6972922","6973202","chr6","34763248","34763528","67","27790326"
"chr6","7072838","7072919","chr15","79878250","79878331","9","72805412"
"chr6","7170060","7170344","chr15","79777572","79777858","37","72607512"
"chr6","7274699","7274983","chr1","46737891","46738177","66","39463192"
"chr6","7280917","7281048","chr16","24603067","24603195","33","17322150"
"chr6","7328574","7328675","chr5","26761731","26761826","27","19433157"
"chr6","7336107","7336285","chr9","78357872","78358049","41","71021765"
"chr6","7352090","7352367","chr7","137603377","137603652","62","130251287"
"chr6","7395622","7395930","chr15","79552968","79553267","40","72157346"
"chr6","7425048","7425330","chr15","79518326","79518611","42","72093278"
"chr6","7474184","7474479","chr15","79455454","79455747","35","71981270"
"chr6","7509223","7509368","chr20","50702095","50702231","28","43192872"
"chr6","7509564","7509739","chr11","47151646","47151810","39","39642082"
"chr6","7650107","7650317","chr16","59663520","59663732","45","52013413"
"chr6","7705612","7705770","chr7","6009067","6009222","33","1696545"
"chr6","7842020","7842124","chr7","69801927","69802033","20","61959907"
"chr6","7842924","7843057","chr20","32123638","32123783","36","24280714"
"chr6","7888203","7888489","chr15","78980292","78980575","47","71092089"
"chr6","7893496","7893615","chr5","124033669","124033784","18","116140173"
"chr6","8051389","8051686","chr5","63163254","63163546","59","55111865"
"chr6","8145068","8145355","chr15","78533208","78533502","47","70388140"
"chr6","8150631","8150768","chr19","44604353","44604482","25","36453722"
"chr6","8316240","8316310","chrX","70521295","70521362","18","62205055"
"chr6","8356010","8356314","chr15","78305505","78305803","46","69949495"
"chr6","8372471","8372761","chr15","78289584","78289889","50","69917113"
"chr6","8379839","8379962","chr17","34242117","34242244","22","25862278"
"chr6","8472885","8473191","chr15","78172481","78172788","31","69699596"
"chr6","8570481","8570738","chr15","78081173","78081424","26","69510692"
"chr6","8597720","8598008","chr15","78053125","78053435","52","69455405"
"chr6","8625344","8625614","chr15","77535937","77536224","45","68910593"
"chr6","8627536","8627848","chr15","77537478","77537782","53","68909942"
"chr6","8665218","8665377","chr17","74040061","74040211","43","65374843"
"chr6","8677637","8677925","chr15","77585473","77585781","55","68907836"
"chr6","8722968","8723231","chr10","47735930","47736197","72","39012962"
"chr6","8769732","8770039","chr15","77682427","77682724","45","68912695"
"chr6","8843839","8844095","chr15","77746996","77747269","44","68903157"
"chr6","8874080","8874285","chr3","58659960","58660170","52","49785880"
"chr6","8903202","8903500","chr15","77804289","77804596","43","68901087"
"chr6","8930984","8931256","chr15","77832254","77832544","53","68901270"
"chr6","8931825","8932038","chr11","59466661","59466861","61","50534836"
"chr6","8936109","8936390","chr13","24022972","24023247","57","15086863"
"chr6","8962829","8963096","chr15","77859851","77860145","56","68897022"
"chr6","8963220","8963502","chr15","77860285","77860569","40","68897065"
"chr6","9033942","9034093","chr5","37563384","37563539","36","28529442"
"chr6","9044099","9044397","chr15","77943279","77943553","59","68899180"
"chr6","9120127","9120400","chr5","997797","998069","71","8122330"
"chr6","9124266","9124435","chr16","65706028","65706198","40","56581762"
"chr6","9125635","9125932","chr15","78011404","78011699","38","68885769"
"chr6","9142706","9142919","chr5","137395548","137395757","59","128252842"
"chr6","9261496","9261770","chr15","77409607","77409911","64","68148111"
"chr6","9295601","9295886","chr4","39462416","39462704","69","30166815"
"chr6","9581923","9582207","chr19","39756556","39756848","54","30174633"
"chr6","9699438","9699744","chr15","76882598","76882880","60","67183160"
"chr6","9920423","9920698","chr9","22226686","22226957","60","12306263"
"chr6","9930004","9930275","chr15","76638762","76639050","48","66708758"
"chr6","9978856","9979169","chr15","76586311","76586599","63","66607455"
"chr6","10109917","10110179","chr15","76396345","76396609","48","66286428"
"chr6","10157176","10157485","chr9","80914511","80914814","65","70757335"
"chr6","10258384","10258525","chr20","34414083","34414223","38","24155699"
"chr6","10296062","10296143","chr11","106359869","106359951","12","96063807"
"chr6","10439109","10439338","chr15","75971808","75972037","27","65532699"
"chr6","10461667","10461817","chr15","75939512","75939674","27","65477845"
"chr6","10469544","10469752","chr5","8577350","8577557","56","1892194"
"chr6","10509264","10509378","chr2A","35382406","35382521","19","24873142"
"chr6","10521642","10521950","chr15","75873158","75873489","73","65351516"
"chr6","10593626","10593939","chr15","75788443","75788751","43","65194817"
"chr6","10651932","10652083","chr20","34414083","34414223","37","23762151"
"chr6","10678662","10678973","chr15","75692260","75692571","37","65013598"
"chr6","10732769","10733048","chr15","75617670","75617963","37","64884901"
"chr6","10835313","10835403","chr15","75513083","75513170","12","64677770"
"chr6","10861421","10861698","chr15","75487993","75488276","54","64626572"
"chr6","10864858","10864941","chr15","75484690","75484773","14","64619832"
"chr6","10865939","10866222","chr1","210461944","210462231","68","199596005"
"chr6","10895487","10895641","chr1","51916540","51916691","39","41021053"
"chr6","10945871","10946188","chr6","90025425","90025748","78","79079554"
"chr6","10948487","10948789","chr15","75371665","75371961","55","64423178"
"chr6","10982019","10982294","chr15","75338791","75339071","35","64356772"
"chr6","10995538","10995697","chr12","44433332","44433490","35","33437794"
"chr6","11000006","11000245","chr11","93250124","93250357","57","82250118"
"chr6","11002899","11003176","chr15","75316187","75316465","30","64313288"
"chr6","11082117","11082270","chr7","72465626","72465775","36","61383509"
"chr6","11134636","11134951","chr15","75187939","75188240","51","64053303"
"chr6","11144788","11145042","chr15","75174914","75175196","58","64030126"
"chr6","11236188","11236290","chrX","47966335","47966445","23","36730147"
"chr6","11244006","11244152","chr3","186215816","186215959","25","174971810"
"chr6","11258378","11258693","chr10","49576385","49576680","77","38318007"
"chr6","11295594","11295881","chr15","75008508","75008789","34","63712914"
"chr6","11342205","11342485","chr6","157053065","157053352","70","145710860"
"chr6","11352038","11352339","chr15","74948474","74948781","42","63596436"
"chr6","11411701","11411835","chr10","84508776","84508900","31","73097075"
"chr6","11457423","11457584","chr7","62518851","62519018","40","51061428"
"chr6","11539330","11539631","chr15","74755717","74756013","46","63216387"
"chr6","11595162","11595408","chr15","74682129","74682354","61","63086967"
"chr6","11685803","11686115","chr15","74576748","74577060","46","62890945"
"chr6","11697224","11697388","chr9","109650705","109650871","40","97953481"
"chr6","11789683","11790005","chr22","23173119","23173434","75","11383436"
"chr6","11983558","11983852","chr15","74275882","74276195","51","62292324"
"chr6","12033233","12033533","chr15","74233373","74233687","61","62200140"
"chr6","12042365","12042611","chr15","74225708","74225941","45","62183343"
"chr6","12086976","12087267","chr15","74180619","74180917","48","62093643"
"chr6","12148128","12148434","chr15","74085722","74086043","64","61937594"
"chr6","12266271","12266569","chr15","73973987","73974282","52","61707716"
"chr6","12295269","12295565","chr15","73937436","73937720","65","61642167"
"chr6","12366725","12366831","chr12","46140363","46140469","27","33773638"
"chr6","12367058","12367239","chr15","21319339","21319522","52","8952281"
"chr6","12387138","12387415","chr15","73833502","73833792","50","61446364"
"chr6","12467072","12467120","chr1","165141492","165141538","11","152674420"
"chr6","12467173","12467309","chr1","32730027","32730168","30","20262854"
"chr6","12862228","12862529","chr15","73076667","73076944","49","60214439"
"chr6","13009482","13009668","chr15","72935286","72935455","34","59925804"
"chr6","13198076","13198360","chr3","74966229","74966505","64","61768153"
"chr6","13229501","13229791","chr15","63652173","63652463","55","50422672"
"chr6","13231180","13231498","chr19","56371390","56371688","72","43140210"
"chr6","13239542","13239835","chr11","18417240","18417530","58","5177698"
"chr6","13242712","13243018","chr15","63640613","63640926","49","50397901"
"chr6","13254218","13254548","chr22","15736295","15736592","70","2482077"
"chr6","13255956","13256070","chr8","44775255","44775370","20","31519299"
"chr6","13516491","13516790","chr15","72571160","72571477","52","59054669"
"chr6","13766047","13766366","chr15","72274792","72275109","48","58508745"
"chr6","13848112","13848396","chr15","72192415","72192697","55","58344303"
"chr6","13851979","13852290","chr15","72188534","72188824","59","58336555"
"chr6","13883334","13883643","chr15","72167231","72167549","48","58283897"
"chr6","13935999","13936301","chr5","32497677","32497988","41","18561678"
"chr6","13985275","13985557","chr15","72075160","72075439","35","58089885"
"chr6","14151679","14152002","chr15","71893623","71893917","62","57741944"
"chr6","14160027","14160301","chr12","21322563","21322830","65","7162536"
"chr6","14196880","14197180","chr15","71853580","71853875","40","57656700"
"chr6","14227894","14228146","chr15","71825999","71826238","41","57598105"
"chr6","14322781","14323091","chr15","71747487","71747780","55","57424706"
"chr6","14462644","14462941","chr1","227415933","227416230","71","212953289"
"chr6","14463536","14463754","chr5","160602169","160602372","51","146138633"
"chr6","14523294","14523597","chr15","71572092","71572395","24","57048798"
"chr6","14548668","14548960","chr7","45549863","45550148","71","31001195"
"chr6","14551585","14551882","chr15","71544451","71544755","41","56992866"
"chr6","14559389","14559673","chr15","71536827","71537093","51","56977438"
"chr6","14573207","14573491","chr15","71524433","71524726","49","56951226"
"chr6","14607537","14607803","chr15","71487424","71487704","34","56879887"
"chr6","14659059","14659361","chr22","13341637","13341938","62","1317422"
"chr6","14680567","14680710","chr19","41295266","41295409","40","26614699"
"chr6","14696929","14697059","chr1","20249918","20250050","17","5552989"
"chr6","14705111","14705387","chr15","71381246","71381528","46","56676135"
"chr6","14721821","14722122","chr15","71354048","71354348","25","56632227"
"chr6","14797266","14797331","chr3","173043241","173043305","13","158245975"
"chr6","14816036","14816149","chr6","87517319","87517435","22","72701283"
"chr6","14822599","14822901","chr16","30950078","30950376","56","16127479"
"chr6","14849302","14849573","chr15","71229662","71229952","68","56380360"
"chr6","15224364","15224480","chrX","47463075","47463191","21","32238711"
"chr6","15262250","15262528","chr15","70796100","70796383","50","55533850"
"chr6","15311318","15311559","chr15","70749336","70749578","33","55438018"
"chr6","15434354","15434464","chr3","73771204","73771315","24","58336850"
"chr6","15720557","15720850","chr15","70365720","70366002","59","54645163"
"chr6","15788074","15788361","chr15","70297542","70297814","52","54509468"
"chr6","15829842","15829883","chr1","161275474","161275516","8","145445632"
"chr6","15974026","15974144","chr4","15060604","15060721","18","913422"
"chr6","16012413","16012679","chr15","70070620","70070919","59","54058207"
"chr6","16044380","16044590","chr15","70036922","70037137","48","53992542"
"chr6","16078288","16078585","chr3","12047317","12047601","75","4030971"
"chr6","16180311","16180471","chr10","112563918","112564071","34","96383607"
"chr6","16180926","16181135","chr15","69867240","69867468","39","53686314"
"chr6","16233102","16233397","chr15","69813041","69813349","48","53579939"
"chr6","16236905","16237216","chr15","69809067","69809371","44","53572162"
"chr6","16259247","16259411","chr14","48531182","48531343","30","32271935"
"chr6","16318010","16318231","chr1","76614645","76614873","61","60296635"
"chr6","16328888","16329153","chr15","69717029","69717302","47","53388141"
"chr6","16330959","16331254","chr15","69714900","69715197","48","53383941"
"chr6","16361887","16362192","chr15","69683791","69684093","41","53321904"
"chr6","16392817","16393101","chr1","12051012","12051291","63","4341805"
"chr6","16396366","16396655","chr15","63894504","63894810","53","47498138"
"chr6","16443143","16443433","chr12","44124224","44124509","61","27681081"
"chr6","16449762","16450059","chr15","68691836","68692136","40","52242074"
"chr6","16472238","16472510","chr15","68716061","68716332","35","52243823"
"chr6","16477746","16478093","chr8","78040177","78040516","79","61562431"
"chr6","16495272","16495401","chr1","114541144","114541275","42","98045872"
"chr6","16497095","16497324","chr7","78674136","78674366","54","62177041"
"chr6","16497331","16497456","chr16","30472207","30472337","24","13974876"
"chr6","16611909","16612065","chr3","102845245","102845407","34","86233336"
"chr6","16629255","16629417","chr19","38472911","38473063","29","21843656"
"chr6","16630714","16631035","chr7","151074615","151074927","69","134443901"
"chr6","16694861","16694986","chrX","33802425","33802548","19","17107564"
"chr6","16702590","16702664","chr15","69569717","69569794","12","52867127"
"chr6","16722691","16722996","chr19","57516560","57516855","69","40793869"
"chr6","16749109","16749381","chr15","69519100","69519389","42","52769991"
"chr6","16765577","16765715","chr22","4901161","4901308","36","11864416"
"chr6","16799090","16799243","chr15","5454904","5455056","35","11344186"
"chr6","16819514","16819693","chr12","121559906","121560083","36","104740392"
"chr6","16851542","16851713","chr10","115667294","115667466","41","98815752"
"chr6","16853307","16853454","chr1","17928928","17929072","35","1075621"
"chr6","16853678","16853800","chr10","91776497","91776617","22","74922819"
"chr6","16893877","16894040","chr1","93560424","93560585","37","76666547"
"chr6","16901890","16902158","chr13","2249722","2250012","52","14652168"
"chr6","16920853","16921129","chr15","69363309","69363594","48","52442456"
"chr6","16945989","16946102","chr15","69338400","69338494","26","52392411"
"chr6","16948601","16948910","chr15","69335234","69335539","37","52386633"
"chr6","16954000","16954124","chr15","69326193","69326317","15","52372193"
"chr6","16955525","16955804","chr7","77655679","77655961","60","60700154"
"chr6","16956175","16956454","chr15","69322158","69322448","34","52365983"
"chr6","16971207","16971430","chr2B","73894702","73894925","66","56923495"
"chr6","16973515","16973799","chr15","69305691","69305980","26","52332176"
"chr6","16974096","16974227","chr11","9436292","9436424","19","7537804"
"chr6","16976583","16976883","chr7","76146308","76146602","63","59169725"
"chr6","16994220","16994358","chr1","134652174","134652315","38","117657954"
"chr6","17009173","17009220","chr17","20548496","20548538","12","3539323"
"chr6","17009731","17009956","chr12","104138056","104138287","60","87128325"
"chr6","17028924","17029046","chr11","124103083","124103207","27","107074159"
"chr6","17030316","17030486","chr19","2825784","2825952","34","14204532"
"chr6","17044362","17044653","chr1","132826671","132826953","59","115782309"
"chr6","17069978","17070116","chr15","69184080","69184216","12","52114102"
"chr6","17070140","17070443","chr15","69183745","69184060","45","52113605"
"chr6","17095472","17095684","chr15","69162381","69162595","27","52066909"
"chr6","17147106","17147386","chr15","7320630","7320904","56","9826476"
"chr6","17179489","17179559","chr1","215193663","215193734","15","198014174"
"chr6","17200057","17200295","chr15","69082702","69082924","51","51882645"
"chr6","17231217","17231490","chr8","56840897","56841189","53","39609680"
"chr6","17232490","17232784","chr15","69053891","69054168","53","51821401"
"chr6","17240233","17240526","chr12","30214103","30214395","37","12973870"
"chr6","17254306","17254414","chr12","46140363","46140469","27","28886057"
"chr6","17271128","17271377","chr15","69013631","69013884","39","51742503"
"chr6","17274851","17274969","chr15","69010311","69010436","17","51735460"
"chr6","17285557","17285854","chr2A","14502481","14502777","68","2783076"
"chr6","17293006","17293280","chr12","35323607","35323897","64","18030601"
"chr6","17304303","17304576","chrX","24116204","24116475","69","6811901"
"chr6","17312367","17312646","chr15","68975357","68975667","52","51662990"
"chr6","17320070","17320222","chr5","156687101","156687239","33","139367031"
"chr6","17328533","17328759","chr3","79978656","79978880","59","62650123"
"chr6","17339671","17339962","chr15","68925763","68926054","43","51586092"
"chr6","17341508","17341784","chr15","64310209","64310492","46","46968701"
"chr6","17347997","17348271","chr15","61266242","61266515","40","43918245"
"chr6","17367425","17367550","chr15","68645929","68646053","16","51278504"
"chr6","17381965","17382253","chr15","68632897","68633173","49","51250932"
"chr6","17412667","17412790","chr15","68606117","68606239","15","51193450"
"chr6","17433783","17434062","chr15","68573341","68573624","39","51139558"
"chr6","17438654","17438943","chr7","5329845","5330131","62","12108809"
"chr6","17456045","17456336","chr5","134119354","134119649","64","116663309"
"chr6","17493084","17493304","chr15","68515385","68515611","25","51022301"
"chr6","17517225","17517412","chr4","171210900","171211065","47","153693675"
"chr6","17607092","17607429","chr15","68403403","68403707","80","50796311"
"chr6","17630806","17631118","chr14","22793466","22793771","64","5162660"
"chr6","17643756","17644062","chr15","21095676","21095968","64","3451920"
"chr6","17660217","17660332","chr5","52418630","52418747","19","34758413"
"chr6","17661700","17661964","chr10","105465195","105465449","72","87803495"
"chr6","17704913","17705195","chr15","68298825","68299102","40","50593912"
"chr6","17718087","17718251","chrX","119758170","119758333","30","102040083"
"chr6","17720180","17720463","chr15","68280441","68280724","28","50560261"
"chr6","17724071","17724337","chr11","71179254","71179527","70","53455183"
"chr6","17728480","17728671","chr1","36042325","36042518","40","18313845"
"chr6","17788529","17788827","chr10","137156788","137157075","59","119368259"
"chr6","17792493","17792761","chr7","16951293","16951559","50","841200"
"chr6","17793662","17793942","chr15","68200241","68200530","45","50406579"
"chr6","17848891","17849188","chr15","57237062","57237365","69","39388171"
"chr6","17867108","17867274","chr16","27358384","27358547","36","9491276"
"chr6","17950831","17951128","chr15","68045883","68046179","44","50095052"
"chr6","18060917","18061193","chr15","67944250","67944528","55","49883333"
"chr6","18066383","18066690","chr15","67937398","67937709","45","49871015"
"chr6","18068736","18068977","chr17","81400274","81400514","68","63331538"
"chr6","18071154","18071278","chr2B","121061303","121061428","18","102990149"
"chr6","18073524","18073812","chr15","67930790","67931069","50","49857266"
"chr6","18102736","18102970","chr15","67902169","67902413","44","49799433"
"chr6","18143367","18143601","chr10","37439324","37439560","50","19295957"
"chr6","18145153","18145269","chr12","111176332","111176452","25","93031179"
"chr6","18156977","18157245","chrX","4331895","4332166","71","13825082"
"chr6","18171083","18171194","chr15","67843026","67843134","17","49671943"
"chr6","18209618","18209912","chr1","78869810","78870106","65","60660192"
"chr6","18223373","18223706","chr1","54687881","54688203","82","36464508"
"chr6","18242939","18243244","chr3","48511906","48512200","66","30268967"
"chr6","18245526","18245706","chr1","183434423","183434605","57","165188897"
"chr6","18245746","18245827","chr1","140044636","140044720","11","121798890"
"chr6","18246734","18246856","chr6","138352473","138352596","27","120105739"
"chr6","18265688","18265986","chr15","54941698","54941989","61","36676010"
"chr6","18304306","18304410","chr17","63212955","63213066","33","44908649"
"chr6","18305078","18305384","chr15","67696189","67696510","49","49391111"
"chr6","18353670","18353861","chr11","3902085","3902275","46","14451585"
"chr6","18354536","18354827","chr16","11765519","11765793","60","6589017"
"chr6","18367411","18367558","chr20","32123638","32123783","39","13756227"
"chr6","18437368","18437482","chrX","151139490","151139606","22","132702122"
"chr6","18443411","18443546","chr1","1433985","1434130","44","17009426"
"chr6","18446795","18447067","chr15","67578808","67579085","51","49132013"
"chr6","18528863","18529142","chr15","67482756","67483058","62","48953893"
"chr6","18548407","18548699","chr2A","64281763","64282047","59","45733356"
"chr6","18569590","18569799","chr16","59663520","59663732","50","41093930"
"chr6","18593410","18593702","chr15","67419643","67419920","42","48826233"
"chr6","18736620","18736865","chr15","67260007","67260256","30","48523387"
"chr6","18755294","18755584","chr15","67242356","67242670","58","48487062"
"chr6","18762093","18762370","chr15","67235979","67236250","37","48473886"
"chr6","18765401","18765620","chr15","67232926","67233148","32","48467525"
"chr6","18794868","18795019","chr9","108241495","108241645","32","89446627"
"chr6","18871536","18871689","chr19","11025315","11025473","42","7846221"
"chr6","18899236","18899525","chr1","91059171","91059456","59","72159935"
"chr6","18903293","18903453","chr12","123193562","123193727","33","104290269"
"chr6","18904576","18904858","chr15","67073000","67073294","34","48168424"
"chr6","18942615","18942920","chr15","67033328","67033643","44","48090713"
"chr6","18957800","18958106","chr5","126032849","126033138","74","107075049"
"chr6","18973933","18974063","chr1","182164561","182164689","25","163190628"
"chr6","19002079","19002375","chr6","146323295","146323593","53","127321216"
"chr6","19047805","19048120","chr15","66921802","66922117","35","47873997"
"chr6","19252587","19252735","chr6","89356333","89356484","31","70103746"
"chr6","19531397","19531687","chr5","8734711","8734988","67","10796686"
"chr6","19578553","19578771","chr15","66387150","66387369","27","46808597"
"chr6","19891606","19891832","chr12","95889570","95889785","68","75997964"
"chr6","19920967","19921266","chr15","66035908","66036221","53","46114941"
"chr6","19932678","19932967","chr15","66023020","66023320","57","46090342"
"chr6","20098706","20098986","chr7","5095566","5095848","61","15003140"
"chr6","20115283","20115531","chr20","51105642","51105914","61","30990359"
"chr6","20178658","20178845","chr11","44694637","44694827","47","24515979"
"chr6","20331372","20331679","chr9","65960638","65960935","82","45629266"
"chr6","20372734","20373012","chr7","44334451","44334729","58","23961717"
"chr6","20390439","20390685","chr17","28427913","28428148","65","8037474"
"chr6","20662943","20663039","chr4","85547016","85547115","21","64884073"
"chr6","20717761","20718035","chr15","65214641","65214925","40","44496880"
"chr6","20734078","20734362","chr1","40183621","40183888","75","19449543"
"chr6","21089377","21089631","chr12","106874607","106874866","66","85785230"
"chr6","21117515","21117791","chr15","64762728","64763014","48","43645213"
"chr6","21204976","21205282","chr15","64664036","64664339","60","43459060"
"chr6","21229821","21230045","chr11","7880596","7880819","69","13349225"
"chr6","21230725","21230794","chr15","51024493","51024560","18","29793768"
"chr6","21260195","21260461","chr7","79223081","79223352","66","57962886"
"chr6","21343380","21343636","chr15","64511926","64512211","57","43168546"
"chr6","21397011","21397329","chr15","64459911","64460232","34","43062900"
"chr6","21485025","21485308","chr15","64318205","64318510","57","42833180"
"chr6","21493504","21493786","chr15","64310209","64310492","36","42816705"
"chr6","21518112","21518410","chr15","64285151","64285435","44","42767039"
"chr6","21519394","21519661","chr15","64282932","64283200","42","42763538"
"chr6","21520579","21520868","chr15","64281708","64281951","66","42761129"
"chr6","21580035","21580302","chr15","64226112","64226377","29","42646077"
"chr6","21583419","21583719","chr7","76041457","76041753","72","54458038"
"chr6","21651322","21651563","chr15","64155634","64155881","55","42504312"
"chr6","21655918","21656179","chr1","40183621","40183888","60","18527703"
"chr6","21726053","21726340","chr15","64114670","64114963","50","42388617"
"chr6","21766178","21766301","chr15","63994901","63995024","10","42228723"
"chr6","21804610","21804896","chr9","78922235","78922551","67","57117625"
"chr6","21846798","21847067","chr15","63601316","63601592","47","41754518"
"chr6","21847828","21848113","chr3","127313849","127314145","65","105466021"
"chr6","21851251","21851542","chr2B","51269035","51269316","70","29417784"
"chr6","21890598","21890856","chr1","78274306","78274550","62","56383708"
"chr6","21922597","21922819","chr15","63523589","63523803","41","41600992"
"chr6","21942448","21942581","chr15","63501885","63502018","5","41559437"
"chr6","21946311","21946603","chr15","63498373","63498688","50","41552062"
"chr6","21976739","21976993","chr15","63471548","63471835","50","41494809"
"chr6","21987106","21987397","chr15","63461342","63461627","32","41474236"
"chr6","21989309","21989606","chr6","91233977","91234263","75","69244668"
"chr6","22001604","22001766","chr1","26977266","26977426","44","4975662"
"chr6","22029605","22029824","chr15","63420141","63420352","24","41390536"
"chr6","22044149","22044447","chr15","63405075","63405405","67","41360926"
"chr6","22044504","22044636","chr7","74128008","74128137","25","52083504"
"chr6","22060356","22060657","chr18","20530306","20530599","72","1530050"
"chr6","22064798","22065114","chr15","63387928","63388251","35","41323130"
"chr6","22079585","22079701","chr15","63378646","63378762","13","41299061"
"chr6","22100002","22100301","chr15","63354400","63354705","30","41254398"
"chr6","22108328","22108483","chr15","69740012","69740164","39","47631684"
"chr6","22108719","22108796","chr20","52590975","52591036","24","30482256"
"chr6","22252744","22253032","chr15","61465848","61466139","48","39213104"
"chr6","22301212","22301420","chr15","61516145","61516368","33","39214933"
"chr6","22378373","22378520","chr14","52842638","52842775","42","30464265"
"chr6","22427747","22427866","chr22","16106433","16106554","24","6321314"
"chr6","22479274","22479426","chr7","74116130","74116280","30","51636856"
"chr6","22506439","22506709","chr15","6959159","6959432","37","15547280"
"chr6","22523210","22523366","chr8","25523917","25524069","36","3000707"
"chr6","22653471","22653839","chr3","58702376","58702742","118","36048905"
"chr6","22655511","22655814","chr1","227415933","227416230","68","204760422"
"chr6","22688761","22689047","chr1","91059171","91059456","55","68370410"
"chr6","22723852","22724158","chr15","61924965","61925256","53","39201113"
"chr6","22724269","22724393","chr7","77000001","77000126","23","54275732"
"chr6","22789927","22790132","chr15","61992865","61993067","30","39202938"
"chr6","22794943","22795229","chr16","40803572","40803860","62","18008629"
"chr6","22811962","22812100","chr6","151293518","151293653","29","128481556"
"chr6","22877597","22877817","chr15","62081683","62081895","25","39204086"
"chr6","22984350","22984574","chr15","62190744","62190966","37","39206394"
"chr6","23055795","23056089","chr15","62269913","62270213","40","39214118"
"chr6","23086276","23086605","chr4","188977480","188977801","65","165891204"
"chr6","23089436","23089733","chr15","62311561","62311853","36","39222125"
"chr6","23097904","23098231","chr15","47215398","47215724","70","24117494"
"chr6","23142322","23142482","chr10","16962017","16962178","36","6180305"
"chr6","23317000","23317219","chr15","62566759","62566978","33","39249759"
"chr6","23531361","23531668","chr5","63733861","63734159","82","40202500"
"chr6","23533231","23533372","chr20","32123638","32123783","28","8590407"
"chr6","23574732","23574863","chr19","13539453","13539582","19","10035279"
"chr6","23715208","23715501","chr5","9692972","9693274","74","14022236"
"chr6","23823765","23823886","chr15","63015714","63015844","22","39191949"
"chr6","23828043","23828351","chr15","63025521","63025817","44","39197478"
"chr6","24023991","24024074","chr10","144050807","144050895","24","120026816"
"chr6","24104676","24104993","chr15","60804061","60804373","55","36699385"
"chr6","24143200","24143480","chr15","60763853","60764137","26","36620653"
"chr6","24258506","24258816","chr15","60670242","60670553","37","36411736"
"chr6","24279182","24279471","chr15","60654356","60654651","37","36375174"
"chr6","24294565","24294829","chr15","60628763","60629020","50","36334198"
"chr6","24307420","24307521","chrX","3394860","3394959","17","20912560"
"chr6","24449111","24449394","chr15","60428911","60429212","47","35979800"
"chr6","24496580","24496887","chrX","104187126","104187432","64","79690546"
"chr6","24527933","24528230","chr22","15736295","15736592","36","8791638"
"chr6","24533706","24533826","chr5","42778148","42778265","34","18244442"
"chr6","24551536","24551678","chr17","40760521","40760674","34","16208985"
"chr6","24551692","24551782","chr22","15324342","15324443","16","9227350"
"chr6","24752055","24752335","chr15","60175689","60175956","63","35423634"
"chr6","24757627","24757924","chr15","44244841","44245146","66","19487214"
"chr6","24827604","24827873","chr11","66752239","66752505","64","41924635"
"chr6","24848009","24848259","chr15","60076362","60076617","23","35228353"
"chr6","24904256","24904529","chr15","60016410","60016724","64","35112154"
"chr6","24911165","24911373","chr15","60009428","60009654","41","35098263"
"chr6","24984326","24984597","chr15","59922956","59923248","39","34938630"
"chr6","25012325","25012442","chr15","59895616","59895731","14","34883291"
"chr6","25031133","25031416","chr15","59876681","59876985","59","34845548"
"chr6","25087403","25087713","chr15","59786435","59786748","36","34699032"
"chr6","25121466","25121588","chr15","59798022","59798154","25","34676556"
"chr6","25126649","25126772","chr6","8143644","8143767","19","16983005"
"chr6","25128112","25128239","chr1","164415072","164415196","25","139286960"
"chr6","25258535","25258817","chr15","59653794","59654087","60","34395259"
"chr6","25312021","25312308","chr15","59606084","59606377","38","34294063"
"chr6","25352952","25353008","chr11","114841124","114841176","11","89488172"
"chr6","25359408","25359714","chrX","41017516","41017830","72","15658108"
"chr6","25360848","25361104","chr15","59556607","59556877","40","34195759"
"chr6","25372276","25372573","chr15","59544322","59544601","53","34172046"
"chr6","25388588","25388868","chr7","137613789","137614068","61","112225201"
"chr6","25390060","25390344","chr5","102241438","102241724","60","76851378"
"chr6","25413884","25414178","chr15","59499150","59499452","52","34085266"
"chr6","25425413","25425683","chr15","59484631","59484915","42","34059218"
"chr6","25430095","25430394","chr15","59473561","59473861","37","34043466"
"chr6","25457466","25457627","chr15","59453571","59453738","22","33996105"
"chr6","25458272","25458509","chr5","41150341","41150568","62","15692069"
"chr6","25462250","25462397","chr15","69740012","69740164","36","44277762"
"chr6","25470706","25470867","chrX","2794957","2795096","50","22675749"
"chr6","25481481","25481752","chr15","59424720","59424996","38","33943239"
"chr6","25487624","25487841","chrX","19833995","19834216","44","5653629"
"chr6","25501671","25501962","chr15","59406193","59406482","37","33904522"
"chr6","25516580","25516859","chr15","59384883","59385176","57","33868303"
"chr6","25624768","25625044","chr15","59273158","59273466","62","33648390"
"chr6","25625214","25625515","chr15","59272687","59272988","36","33647473"
"chr6","25757072","25757321","chr7","2330840","2331092","46","23426232"
"chr6","25811810","25812096","chr15","59044726","59045033","52","33232916"
"chr6","25910282","25910581","chr15","58931855","58932147","37","33021573"
"chr6","25933803","25934094","chr15","58899776","58900062","52","32965973"
"chr6","25968518","25968803","chr15","58847521","58847809","34","32879003"
"chr6","25972960","25973136","chr2B","63357907","63358099","49","37384947"
"chr6","25973623","25973934","chr1","24526530","24526837","41","1447093"
"chr6","26173832","26174127","chr15","58560284","58560579","31","32386452"
"chr6","26206655","26206775","chr1","210013612","210013734","17","183806957"
"chr6","26246527","26246668","chr20","32123638","32123783","29","5877111"
"chr6","26595753","26596049","chr22","15736295","15736592","39","10859458"
"chr6","26600154","26600274","chr5","42778148","42778265","34","16177994"
"chr6","26614827","26615123","chr22","15736295","15736592","38","10878532"
"chr6","26619117","26619237","chr5","42778148","42778265","33","16159031"
"chr6","26624742","26625010","chr9","32523283","32523554","70","5898541"
"chr6","26643328","26643418","chr22","15324342","15324443","19","11318986"
"chr6","26643432","26643574","chr17","40760521","40760674","34","14117089"
"chr6","26735150","26735272","chr1","221846628","221846752","26","195111478"
"chr6","26735405","26735579","chr7","96747376","96747548","41","70011971"
"chr6","26775319","26775414","chr11","93233737","93233830","16","66458418"
"chr6","26795413","26795725","chr15","58039477","58039788","43","31244064"
"chr6","26872968","26873100","chr8","103799790","103799921","29","76926822"
"chr6","26892133","26892350","chr12","75161946","75162159","41","48269813"
"chr6","26936516","26936808","chr15","57920413","57920707","29","30983897"
"chr6","27989266","27989532","chr9","44913398","44913659","73","16924132"
"chr6","28099942","28100224","chr10","148544556","148544855","48","120444614"
"chr6","28163243","28163353","chr7","71023301","71023412","20","42860058"
"chr6","28196593","28196704","chr7","71023301","71023412","19","42826708"
"chr6","28214922","28215170","chr1","32057675","32057919","57","3842753"
"chr6","28218516","28218801","chr7","74687926","74688201","70","46469410"
"chr6","28397719","28398017","chr20","17593768","17594069","35","10803951"
"chr6","28399140","28399356","chr20","17592145","17592357","27","10806995"
"chr6","28428651","28428950","chr7","110587199","110587493","62","82158548"
"chr6","28459479","28459642","chr19","15955029","15955193","47","12504450"
"chr6","28460072","28460158","chr2A","69591800","69591886","21","41131728"
"chr6","28489566","28489698","chr2B","22333997","22334126","13","6155569"
"chr6","28508729","28509015","chr4","160107251","160107545","63","131598522"
"chr6","28523914","28524070","chr5","129529187","129529341","28","101005273"
"chr6","28540050","28540335","chr9","107625580","107625871","58","79085530"
"chr6","28579936","28580028","chr2B","22521824","22521914","18","6058112"
"chr6","28740923","28741080","chr16","76317400","76317554","35","47576477"
"chr6","28899294","28899591","chr2B","22863042","22863335","31","6036252"
"chr6","28928512","28928797","chr2B","22893248","22893538","52","6035264"
"chr6","28964118","28964346","chr7","73383055","73383272","58","44418937"
"chr6","28964505","28964610","chr12","110737468","110737573","18","81772963"
"chr6","28977283","28977594","chr1","110196519","110196822","61","81219236"
"chr6","29028645","29028901","chr2B","22976891","22977123","59","6051754"
"chr6","29341339","29341644","chr10","26229322","26229632","64","3112017"
"chr6","29738349","29738641","chr2B","18385785","18386075","55","11352564"
"chr6","30257663","30257782","chr2B","17881090","17881212","15","12376573"
"chr6","30295662","30295960","chr3","54578713","54579010","64","24283051"
"chr6","30306495","30306784","chr10","34420389","34420685","60","4113894"
"chr6","30933124","30933271","chr5","157504500","157504647","36","126571376"
"chr6","30954037","30954353","chr2B","17210387","17210708","52","13743650"
"chr6","30969151","30969367","chr16","41676490","41676700","45","10707339"
"chr6","30972427","30972739","chr2B","17192559","17192855","52","13779868"
"chr6","30979893","30980003","chr10","29601597","29601708","28","1378296"
"chr6","31051853","31052146","chr2B","17129933","17130229","31","13921920"
"chr6","31071024","31071314","chr1","53815840","53816130","70","22744816"
"chr6","31074597","31074866","chr2B","17105691","17105966","47","13968906"
"chr6","31086408","31086701","chr2B","17094054","17094348","34","13992354"
"chr6","31132165","31132278","chr1","205691406","205691517","28","174559241"
"chr6","31135947","31136007","chr2B","17049685","17049743","5","14086262"
"chr6","31155162","31155433","chr2B","17036785","17037080","53","14118377"
"chr6","31164747","31164873","chr11","69147152","69147272","26","37982405"
"chr6","31170848","31170995","chr10","132416953","132417099","31","101246105"
"chr6","31171327","31171468","chr16","4747673","4747814","27","26423654"
"chr6","31236464","31236632","chr5","51144248","51144411","36","19907784"
"chr6","31261960","31262243","chrX","101018684","101018958","62","69756724"
"chr6","31270394","31270673","chr2B","16915177","16915450","44","14355217"
"chr6","31303601","31303866","chr1","189232436","189232704","66","157928835"
"chr6","31310522","31310682","chr3","12654887","12655050","38","18655635"
"chr6","31312613","31312896","chr2B","16878561","16878855","52","14434052"
"chr6","31321440","31321716","chr20","4346596","4346881","65","26974844"
"chr6","31323421","31323698","chr2B","16866741","16867002","51","14456680"
"chr6","31331316","31331595","chr2B","16859944","16860224","42","14471372"
"chr6","31366709","31366956","chr3","49738899","49739127","78","18372190"
"chr6","31373351","31373611","chr1","224416550","224416806","90","193043199"
"chr6","31433220","31433344","chr2A","104115777","104115903","22","72682557"
"chr6","31438374","31438519","chr3","267312","267456","35","31171062"
"chr6","31462601","31462891","chr2B","16745652","16745954","32","14716949"
"chr6","31474206","31474331","chr11","123223114","123223238","19","91748908"
"chr6","31480094","31480409","chr2B","16724133","16724455","39","14755961"
"chr6","31531916","31532187","chr2B","16673770","16674068","60","14858146"
"chr6","31534164","31534337","chr10","115667294","115667466","39","84133130"
"chr6","31534927","31535223","chr11","112103344","112103637","62","80568417"
"chr6","31543096","31543383","chr2B","16663029","16663327","40","14880067"
"chr6","31553334","31553610","chr2B","16654163","16654443","44","14899171"
"chr6","31564673","31564970","chr2B","16642781","16643069","40","14921892"
"chr6","31576343","31576502","chr1","23183624","23183790","40","8392719"
"chr6","31732603","31732727","chr6","18759950","18760073","21","12972653"
"chr6","31748495","31748773","chr2B","16437673","16437945","42","15310822"
"chr6","31760668","31760881","chr2B","16424736","16424949","31","15335932"
"chr6","31777645","31777753","chr4","110753866","110753969","23","78976221"
"chr6","31777886","31777985","chr2A","74960327","74960436","29","43182441"
"chr6","31783374","31783683","chr2B","16401849","16402159","39","15381525"
"chr6","31786283","31786459","chr22","14073147","14073316","46","17713136"
"chr6","31786780","31786849","chr3","75070680","75070747","15","43283900"
"chr6","31786856","31787144","chr7","66246986","66247273","63","34460130"
"chr6","31789752","31789971","chr2B","16395869","16396085","48","15393883"
"chr6","31911694","31911981","chr2B","16355175","16355457","36","15556519"
"chr6","32002061","32002144","chr7","101404390","101404484","20","69402329"
"chr6","32023186","32023445","chr22","8383166","8383423","59","23640020"
"chr6","32034370","32034658","chrX","115407272","115407563","62","83372902"
"chr6","32076980","32077290","chr1","227415933","227416230","66","195338953"
"chr6","32084514","32084791","chr2B","16164800","16165090","42","15919714"
"chr6","32098627","32098906","chr2B","16142545","16142828","35","15956082"
"chr6","32113293","32113583","chr2B","16124622","16124913","22","15988671"
"chr6","32126002","32126150","chr10","49585047","49585201","30","17459045"
"chr6","32133351","32133627","chr4","100593132","100593403","59","68459781"
"chr6","32134783","32135080","chr2B","16092592","16092890","44","16042191"
"chr6","32152003","32152152","chr2B","16077222","16077367","30","16074781"
"chr6","32228440","32228746","chr2B","15997219","15997524","37","16231221"
"chr6","32231650","32231949","chr2B","15994070","15994375","39","16237580"
"chr6","32236604","32236893","chr2B","15988708","15989006","39","16247896"
"chr6","32296869","32297022","chr15","69740012","69740164","30","37443143"
"chr6","32354590","32354692","chr5","23513112","23513208","22","8841478"
"chr6","32372905","32373026","chr5","133578375","133578499","26","101205470"
"chr6","32373451","32373615","chr3","49411661","49411824","27","17038210"
"chr6","32415085","32415201","chr6","152339917","152340034","21","119924832"
"chr6","32435739","32435844","chr8","44828793","44828887","32","12393054"
"chr6","32584922","32585114","chr12","120996947","120997138","46","88412025"
"chr6","32729769","32730045","chr2B","78357063","78357334","29","45627294"
"chr6","32800123","32800380","chr19","14070961","14071211","73","18729162"
"chr6","32911285","32911405","chr2B","78166211","78166332","17","45254926"
"chr6","32995632","32995903","chr2B","78114304","78114585","54","45118672"
"chr6","33046962","33047249","chr2B","78069239","78069531","57","45022277"
"chr6","33138401","33138524","chr2A","20545290","20545415","28","12593111"
"chr6","33139087","33139200","chr9","31412227","31412339","24","1726860"
"chr6","33305491","33305565","chr16","65390615","65390689","16","32085124"
"chr6","33306510","33306664","chr8","74467980","74468139","33","41161470"
"chr6","33362436","33362719","chr1","52409674","52409956","72","19047238"
"chr6","33366809","33367018","chr16","59663520","59663732","41","26296711"
"chr6","33689627","33689789","chr2B","77341246","77341395","36","43651619"
"chr6","33757451","33757583","chr7","107774197","107774327","24","74016746"
"chr6","33759010","33759293","chr2B","77266040","77266320","61","43507030"
"chr6","33984467","33984639","chr1","216330853","216331024","33","182346386"
"chr6","34457233","34457414","chr15","23396259","23396443","40","11060974"
"chr6","34911913","34912191","chr1","19992694","19992978","61","14919219"
"chr6","34958685","34958766","chr11","110196350","110196433","12","75237665"
"chr6","35239023","35239332","chr2B","75919439","75919755","37","40680416"
"chr6","35377652","35377813","chr5","118399435","118399596","37","83021783"
"chr6","35384203","35384482","chr12","107331972","107332235","74","71947769"
"chr6","35426474","35426738","chr2B","75723401","75723692","50","40296927"
"chr6","35453041","35453163","chr2B","75691662","75691784","13","40238621"
"chr6","35458174","35458395","chr22","26066880","26067115","75","9391294"
"chr6","35471891","35472006","chr2B","75669606","75669726","22","40197715"
"chr6","35686044","35686335","chr2B","75452886","75453167","44","39766842"
"chr6","35694461","35694723","chr2B","75444486","75444749","36","39750025"
"chr6","35731049","35731355","chr1","23298610","23298915","62","12432439"
"chr6","35832120","35832268","chr1","23727757","23727901","37","12104363"
"chr6","35924081","35924370","chr2B","75221971","75222266","34","39297890"
"chr6","36045687","36045800","chr1","95066040","95066156","19","59020353"
"chr6","36193410","36193703","chr2B","74972342","74972656","60","38778932"
"chr6","36230916","36231147","chr2B","74934833","74935039","50","38703917"
"chr6","36514015","36514305","chr2B","74627414","74627717","51","38113399"
"chr6","36584209","36584507","chr2B","74557151","74557453","32","37972942"
"chr6","36605993","36606075","chr2B","74533090","74533169","9","37927097"
"chr6","36612849","36613105","chr2B","74519298","74519532","62","37906449"
"chr6","36711846","36711908","chr7","79558509","79558556","24","42846663"
"chr6","36711923","36712053","chr6","25352056","25352181","19","11359867"
"chr6","36717027","36717301","chr18","4937294","4937571","63","31779733"
"chr6","36774821","36774997","chr3","126624645","126624825","42","89849824"
"chr6","36835973","36836243","chr5","8734711","8734988","62","28101262"
"chr6","36909683","36909985","chr2B","74279591","74279886","49","37369908"
"chr6","36948475","36948772","chr2B","74239468","74239765","41","37290993"
"chr6","37036250","37036357","chr12","121105622","121105732","20","84069372"
"chr6","37039467","37039627","chr9","111094911","111095071","33","74055444"
"chr6","37137341","37137633","chr8","73725770","73726054","68","36588429"
"chr6","37393060","37393229","chr2A","103770599","103770776","53","66377539"
"chr6","37414270","37414562","chr2B","73762477","73762766","53","36348207"
"chr6","37736071","37736407","chr15","51181882","51182215","81","13445811"
"chr6","37782965","37783127","chrX","119758170","119758333","48","81975205"
"chr6","37997333","37997599","chr2B","73115392","73115660","39","35118059"
"chr6","38266692","38266981","chr2B","72827237","72827511","39","34560545"
"chr6","38289581","38289903","chr2B","72803283","72803573","70","34513702"
"chr6","38398608","38398721","chr9","93151090","93151202","31","54752482"
"chr6","38398988","38399146","chr15","5454904","5455056","37","32944084"
"chr6","38627368","38627526","chr19","5169265","5169417","36","33458103"
"chr6","38916488","38916691","chr1","216750150","216750355","49","177833662"
"chr6","38975098","38975390","chr2B","71980865","71981155","47","33005767"
"chr6","38992506","38992614","chr9","86429492","86429602","23","47436986"
"chr6","39012317","39012440","chr19","39873746","39873869","20","861429"
"chr6","39012451","39012729","chr2B","71942808","71943087","60","32930357"
"chr6","39019211","39019378","chr2B","71913627","71913796","17","32894416"
"chr6","39020588","39020717","chrX","22996372","22996496","28","16024216"
"chr6","39023931","39024055","chr7","138263854","138263978","19","99239923"
"chr6","39095471","39095781","chr2B","71834507","71834803","54","32739036"
"chr6","39208565","39208719","chr19","37746124","37746279","31","1462441"
"chr6","39210954","39211244","chr2B","71702956","71703251","39","32492002"
"chr6","39263982","39264293","chr2B","71656904","71657210","55","32392922"
"chr6","39351899","39352032","chr2B","71535513","71535635","34","32183614"
"chr6","39462028","39462224","chr19","6085105","6085297","52","33376923"
"chr6","39530373","39530750","chr2B","71331063","71331372","104","31800690"
"chr6","39612478","39612765","chrX","19199530","19199816","52","20412948"
"chr6","39788561","39788946","chr2B","71063185","71063575","97","31274624"
"chr6","39811268","39811569","chrX","50083105","50083400","57","10271837"
"chr6","39817521","39817793","chr2B","71034713","71034983","40","31217192"
"chr6","39838203","39838495","chr1","98069783","98070075","59","58231580"
"chr6","39853335","39853623","chr2B","70997684","70997981","39","31144349"
"chr6","39888162","39888476","chr2B","70931054","70931360","45","31042892"
"chr6","39900585","39900901","chr2B","70928516","70928817","65","31027931"
"chr6","39902882","39903148","chr11","85350045","85350314","59","45447163"
"chr6","39930713","39930868","chr9","23434201","23434353","34","16496512"
"chr6","40020882","40021164","chr11","9093384","9093663","67","30927498"
"chr6","40072855","40073162","chr12","36052788","36053091","69","4020067"
"chr6","40128789","40128883","chr2B","70683997","70684094","10","30555208"
"chr6","40219578","40219855","chr2B","70132472","70132773","64","29912894"
"chr6","40230497","40230825","chr5","23866306","23866626","81","16364191"
"chr6","40256538","40256817","chr2B","70094413","70094677","47","29837875"
"chr6","40284399","40284713","chr2B","70066008","70066295","79","29781609"
"chr6","40377760","40377876","chr20","18397026","18397142","20","21980734"
"chr6","40442053","40442201","chr3","43594842","43594998","39","3152789"
"chr6","40476283","40476541","chr2A","1849325","1849582","52","38626958"
"chr6","40484957","40485067","chr4","94047750","94047860","19","53562793"
"chr6","40510876","40511101","chr1","27635799","27636012","50","12875077"
"chr6","40559721","40560009","chr2B","70571603","70571909","46","30011882"
"chr6","40643380","40643693","chr1","149803989","149804300","65","109160609"
"chr6","40643813","40644046","chr2B","70444671","70444924","45","29800858"
"chr6","40789680","40789958","chr2B","70318766","70319058","35","29529086"
"chr6","40839973","40840250","chr2B","70253566","70253855","39","29413593"
"chr6","40965330","40965626","chr2B","70132472","70132773","46","29167142"
"chr6","40976671","40976997","chr3","150127743","150128060","81","109151072"
"chr6","40979990","40980096","chr4","94047750","94047860","20","53067760"
"chr6","40984439","40984538","chr2B","69817672","69817772","7","28833233"
"chr6","40987356","40987415","chr2B","26931720","26931778","9","14055636"
"chr6","41003633","41003924","chr2B","69796219","69796507","45","28792586"
"chr6","41014808","41015081","chr1","162561876","162562152","66","121547068"
"chr6","41020439","41020750","chr11","85632161","85632468","62","44611722"
"chr6","41041428","41041618","chr14","50979257","50979448","44","9937829"
"chr6","41063698","41063975","chr2B","69738439","69738736","48","28674741"
"chr6","41066552","41066821","chr2B","69735349","69735630","41","28668797"
"chr6","41087388","41087632","chr3","184080027","184080307","72","142992639"
"chr6","41096469","41096779","chr2B","69690957","69691289","52","28594488"
"chr6","41139647","41139962","chr2B","69641574","69641885","50","28501927"
"chr6","41171689","41171954","chr1","96306179","96306450","57","55134490"
"chr6","41200638","41200932","chr2B","69584574","69584877","33","28383936"
"chr6","41325007","41325285","chr2B","69462031","69462317","40","28137024"
"chr6","41386465","41386757","chr2B","69397568","69397860","43","28011103"
"chr6","41697022","41697257","chr2B","69112028","69112255","38","27415006"
"chr6","41740575","41740723","chr1","32730027","32730168","30","9010548"
"chr6","41771996","41772266","chr2B","69039039","69039326","53","27267043"
"chr6","41788078","41788362","chr2B","69022713","69023013","46","27234635"
"chr6","41843026","41843233","chr3","46423650","46423852","43","4580624"
"chr6","42034122","42034419","chr2B","68753956","68754269","46","26719834"
"chr6","42082319","42082463","chr2B","68693729","68693872","15","26611410"
"chr6","42083115","42083274","chr15","35097655","35097816","26","6985460"
"chr6","42128846","42129011","chr1","23183624","23183790","32","18945222"
"chr6","42305278","42305394","chr6","144900821","144900941","26","102595543"
"chr6","42305633","42305786","chr4","165632252","165632405","41","123326619"
"chr6","42438178","42438465","chr2B","68308565","68308849","36","25870387"
"chr6","42544707","42544843","chr11","753831","753960","32","41790876"
"chr6","42582304","42582608","chr2B","68176790","68177095","50","25594486"
"chr6","42589077","42589218","chr3","114815475","114815616","41","72226398"
"chr6","42599248","42599549","chr2B","68158432","68158733","34","25559184"
"chr6","42605839","42605963","chr2B","68150637","68150761","9","25544798"
"chr6","42721923","42722052","chr1","215648878","215649005","32","172926955"
"chr6","42730498","42730588","chr2B","68015106","68015191","16","25284608"
"chr6","42921085","42921215","chr2B","88580506","88580637","26","45659421"
"chr6","42925789","42926073","chr2B","67858546","67858829","31","24932757"
"chr6","43057351","43057647","chr5","64455340","64455634","56","21397989"
"chr6","43206844","43207128","chr7","4970487","4970775","58","38236357"
"chr6","43231023","43231321","chr2B","67569600","67569880","72","24338577"
"chr6","43255726","43256016","chr2B","67544824","67545107","45","24289098"
"chr6","43272473","43272767","chr2B","67526332","67526613","44","24253859"
"chr6","43301755","43301907","chr5","55318846","55318997","42","12017091"
"chr6","43346053","43346340","chr11","47006876","47007157","66","3660823"
"chr6","43402628","43402791","chr3","10866047","10866211","29","32536581"
"chr6","43426863","43427174","chr2B","67366372","67366686","41","23939509"
"chr6","43457684","43457944","chr12","125129033","125129295","59","81671349"
"chr6","43467047","43467264","chr2B","67326373","67326639","67","23859326"
"chr6","43478653","43478735","chr6","118317766","118317852","23","74839113"
"chr6","43551358","43551619","chr19","40071487","40071745","58","3479871"
"chr6","43576753","43577054","chr2B","67215973","67216265","58","23639220"
"chr6","43582684","43582991","chr2B","67209619","67209927","33","23626935"
"chr6","43601018","43601298","chr2B","67190962","67191264","40","23589944"
"chr6","43672704","43672822","chr2B","67124288","67124405","10","23451584"
"chr6","43702745","43702884","chr6","36782155","36782293","38","6920590"
"chr6","43703035","43703113","chr19","17772423","17772485","24","25930612"
"chr6","43714766","43715056","chrX","40660160","40660460","64","3054606"
"chr6","43731185","43731484","chrX","40496035","40496339","67","3235150"
"chr6","43747011","43747288","chr3","74966229","74966505","55","31219218"
"chr6","43773419","43773706","chr2B","67048270","67048558","34","23274851"
"chr6","43797354","43797610","chr5","133461759","133462004","77","89664405"
"chr6","43832846","43833138","chr2B","66990618","66990907","33","23157772"
"chr6","43846765","43847057","chr2B","66977052","66977365","50","23130287"
"chr6","43884912","43885037","chr2B","66944893","66945017","25","23059981"
"chr6","43892089","43892399","chr2B","66937225","66937519","44","23045136"
"chr6","43951445","43951753","chr2B","66875233","66875559","67","22923788"
"chr6","43952200","43952311","chr18","48326419","48326520","27","4374219"
"chr6","44026953","44027262","chr2B","66784099","66784401","49","22757146"
"chr6","44029702","44029846","chr1","214795835","214795974","34","170766133"
"chr6","44062323","44062434","chr15","69301149","69301262","29","25238826"
"chr6","44113555","44113863","chr2B","66717383","66717688","44","22603828"
"chr6","44125477","44125605","chr1","134652174","134652315","43","90526697"
"chr6","44141027","44141393","chr6","30831453","30831795","112","13309574"
"chr6","44155516","44155640","chr3","59535512","59535636","13","15379996"
"chr6","44157985","44158281","chr8","8569066","8569361","69","35588919"
"chr6","44207885","44208193","chr2B","66636943","66637248","39","22429058"
"chr6","44225325","44225437","chr19","32893015","32893118","27","11332310"
"chr6","44247379","44247631","chr2B","66600588","66600874","53","22353209"
"chr6","44257611","44257928","chr2B","66590691","66591001","51","22333080"
"chr6","44288197","44288360","chr5","32621516","32621676","37","11666681"
"chr6","44324530","44324810","chr12","123096820","123097105","58","78772290"
"chr6","44353966","44354229","chr2B","66499711","66499961","29","22145745"
"chr6","44363797","44364101","chr10","149486","149795","79","44214311"
"chr6","44366230","44366342","chr4","37764421","37764538","15","6601809"
"chr6","44367646","44367805","chr10","49585047","49585201","29","5217401"
"chr6","44390254","44390389","chr1","38937065","38937185","42","5453189"
"chr6","44398610","44398904","chr2B","66453916","66454205","45","22055306"
"chr6","44436755","44437048","chr2B","66418962","66419261","40","21982207"
"chr6","44454815","44454940","chr2A","51428234","51428361","25","6973419"
"chr6","44482523","44482682","chr15","67737918","67738076","31","23255395"
"chr6","44526244","44526518","chr2B","66339490","66339733","68","21813246"
"chr6","44531470","44531588","chr17","63212955","63213066","27","18681485"
"chr6","44532024","44532131","chr2B","66334223","66334334","15","21802199"
"chr6","44540144","44540270","chr1","111861160","111861287","22","67321016"
"chr6","44547712","44548011","chr6","159549272","159549578","78","115001560"
"chr6","44593703","44593999","chr2B","66275186","66275471","38","21681483"
"chr6","44667797","44668085","chr12","11463774","11464044","69","33204023"
"chr6","44672020","44672333","chr3","124307379","124307684","61","79635359"
"chr6","44707002","44707286","chr10","101137241","101137530","73","56430239"
"chr6","44712547","44712834","chr2B","66168905","66169193","27","21456358"
"chr6","44788434","44788737","chr3","145246806","145247099","57","100458372"
"chr6","44937722","44937838","chr16","21142750","21142867","17","23794972"
"chr6","44997045","44997212","chr13","83077563","83077734","36","38080518"
"chr6","45019369","45019668","chr2B","65856949","65857241","34","20837580"
"chr6","45025767","45026049","chr2B","65849936","65850233","43","20824169"
"chr6","45101043","45101294","chr18","56933347","56933600","58","11832304"
"chr6","45102422","45102546","chr11","33058853","33058979","22","12043569"
"chr6","45105785","45105950","chr22","20635435","20635596","37","24470350"
"chr6","45120232","45120505","chr7","75781250","75781522","64","30661018"
"chr6","45153020","45153322","chr2B","65713666","65713975","40","20560646"
"chr6","45171482","45171607","chr9","107827822","107827945","18","62656340"
"chr6","45317815","45318138","chr12","93741800","93742110","76","48423985"
"chr6","45405681","45405816","chr8","35443264","35443398","38","9962417"
"chr6","45422705","45422897","chrX","141015925","141016112","49","95593220"
"chr6","45430673","45430926","chr2B","65482885","65483171","60","20052212"
"chr6","45467772","45468018","chr1","33558914","33559153","73","11908858"
"chr6","45523544","45523658","chr2B","65388375","65388489","10","19864831"
"chr6","45532425","45532732","chr2B","65380643","65380953","53","19848218"
"chr6","45546809","45547109","chr2B","65367321","65367604","53","19820512"
"chr6","45608090","45608389","chr12","108745776","108746083","62","63137686"
"chr6","45676600","45676884","chr2B","65244756","65245017","54","19568156"
"chr6","45683977","45684126","chr11","117041215","117041360","31","71357238"
"chr6","45718798","45719100","chr7","35722405","35722706","60","9996393"
"chr6","45726739","45727018","chr16","21923718","21924002","59","23803021"
"chr6","45734430","45734726","chr2B","65186213","65186495","39","19451783"
"chr6","45787881","45788012","chr1","187726107","187726234","19","141938226"
"chr6","45837145","45837451","chr2B","65078083","65078407","58","19240938"
"chr6","45838276","45838580","chr2B","65076911","65077192","68","19238635"
"chr6","45855355","45855495","chr2B","68386266","68386399","25","22530911"
"chr6","45866660","45866953","chr2B","65038696","65039002","42","19172036"
"chr6","45877537","45877859","chr2B","65030632","65030941","60","19153095"
"chr6","45943780","45943906","chr2B","64967910","64968024","22","19024130"
"chr6","46026645","46026917","chr2B","64908023","64908299","35","18881378"
"chr6","46034128","46034411","chr2B","64900008","64900296","41","18865880"
"chr6","46036271","46036574","chr9","96033142","96033440","60","49996871"
"chr6","46185202","46185491","chr1","193276600","193276880","68","147091398"
"chr6","46185704","46185985","chr2B","64754631","64754918","33","18568927"
"chr6","46221692","46221996","chr18","14719814","14720115","68","31501878"
"chr6","46224003","46224285","chr2B","64707710","64707995","43","18483707"
"chr6","46283162","46283280","chr19","46022230","46022346","28","260932"
"chr6","46283771","46283934","chr19","5016889","5017050","35","41266882"
"chr6","46303919","46304210","chr2B","64628496","64628792","54","18324577"
"chr6","46359235","46359416","chr7","47889561","47889742","36","1530326"
"chr6","46366973","46367075","chr1","111899996","111900096","18","65533023"
"chr6","46392635","46392926","chr2B","64539946","64540239","34","18147311"
"chr6","46503042","46503343","chr20","61111140","61111445","51","14608098"
"chr6","46535707","46535889","chr19","44481802","44481982","48","2053905"
"chr6","46561906","46562141","chr2B","64378708","64378949","41","17816802"
"chr6","46572136","46572357","chr3","24370786","24370980","82","22201350"
"chr6","46580577","46580871","chr2B","64361689","64361981","31","17781112"
"chr6","46598833","46599130","chr4","196848519","196848815","59","150249686"
"chr6","46623049","46623130","chr1","183811752","183811829","14","137188703"
"chr6","46623236","46623549","chr4","4517769","4518079","58","42105467"
"chr6","46623922","46624121","chr2B","64144942","64145140","45","17521020"
"chr6","46630878","46631178","chr2A","32683483","32683772","68","13947395"
"chr6","46634081","46634356","chr2B","64315052","64315353","67","17680971"
"chr6","46637280","46637571","chr2B","64311195","64311500","36","17673915"
"chr6","46685244","46685396","chr1","129229734","129229887","27","82544490"
"chr6","46740945","46741130","chr1","47843988","47844174","43","1103043"
"chr6","46747182","46747442","chr6","160803320","160803594","74","114056138"
"chr6","46770657","46770779","chr10","18536513","18536637","21","28234144"
"chr6","46778968","46779245","chr2B","64188766","64189049","30","17409798"
"chr6","46809506","46809821","chr14","89477715","89478026","66","42668209"
"chr6","46858395","46858661","chr2B","64101874","64102134","84","17243479"
"chr6","46864127","46864422","chr2B","64096586","64096882","33","17232459"
"chr6","46870865","46871199","chr17","36867242","36867559","92","10003623"
"chr6","46901932","46902213","chr2B","64068456","64068721","45","17166524"
"chr6","46910861","46911153","chr2B","64043073","64043365","44","17132212"
"chr6","46913884","46914147","chr2B","64039717","64039985","64","17125833"
"chr6","46915856","46916134","chr16","40536206","40536485","59","6379650"
"chr6","46933827","46934120","chr2B","64029366","64029674","41","17095539"
"chr6","46958835","46959005","chr12","106425440","106425609","44","59466605"
"chr6","47012395","47012524","chr2B","63959123","63959247","15","16946728"
"chr6","47044842","47044978","chr3","1525144","1525272","44","45519698"
"chr6","47052534","47052828","chr2B","63925476","63925768","44","16872942"
"chr6","47073246","47073370","chr2B","63904476","63904600","11","16831230"
"chr6","47096736","47096853","chr5","102112885","102113000","19","55016149"
"chr6","47100130","47100367","chr2B","63873338","63873587","48","16773208"
"chr6","47116404","47116681","chr2A","14922187","14922472","62","32194217"
"chr6","47152586","47152736","chr10","692142","692288","32","46460444"
"chr6","47170405","47170534","chr10","12650705","12650831","34","34519700"
"chr6","47171266","47171567","chr14","40167075","40167373","75","7004191"
"chr6","47177043","47177353","chr1","191202899","191203180","68","144025856"
"chr6","47187880","47187991","chr18","46434429","46434545","20","753451"
"chr6","47199976","47200214","chrX","48678555","48678774","61","1478579"
"chr6","47206784","47206938","chr2B","126639395","126639541","33","79432611"
"chr6","47226304","47226418","chr13","62995177","62995295","22","15768873"
"chr6","47267484","47267771","chr2B","63700399","63700697","57","16432915"
"chr6","47272766","47273069","chr2B","63695283","63695590","39","16422517"
"chr6","47292946","47293238","chr2B","63672808","63673089","39","16379862"
"chr6","47302315","47302421","chr2B","63664318","63664434","20","16362003"
"chr6","47303870","47304097","chr1","214185129","214185349","53","166881259"
"chr6","47358663","47358882","chr2B","63602442","63602662","20","16243779"
"chr6","47358887","47358999","chr19","38113594","38113699","33","9245293"
"chr6","47362732","47362824","chr14","54873414","54873500","18","7510682"
"chr6","47370926","47371068","chr6","77626450","77626592","26","30255524"
"chr6","47401423","47401705","chr2B","63565172","63565449","33","16163749"
"chr6","47444285","47444543","chr15","51297551","51297814","65","3853266"
"chr6","47446360","47446567","chr2B","63520301","63520510","20","16073941"
"chr6","47486770","47486899","chr2B","63483683","63483805","16","15996913"
"chr6","47564676","47564961","chr2B","63400314","63400599","45","15835638"
"chr6","47570546","47570726","chr15","23396259","23396443","38","24174287"
"chr6","47571005","47571114","chr15","4341702","4341817","23","43229303"
"chr6","47576190","47576490","chr2B","63387932","63388214","57","15811742"
"chr6","47579640","47579757","chr14","54877920","54878035","22","7298280"
"chr6","47599893","47600078","chr2B","63357907","63358099","29","15758014"
"chr6","47622212","47622513","chr2B","63334967","63335311","77","15712755"
"chr6","47630214","47630294","chr1","204101092","204101175","17","156470878"
"chr6","47631035","47631152","chr7","76172154","76172270","32","28541119"
"chr6","47631326","47631604","chr2B","63326006","63326295","48","15694680"
"chr6","47652035","47652327","chr2B","63292767","63293054","46","15640732"
"chr6","47669933","47670210","chr2B","63278140","63278435","59","15608207"
"chr6","47675547","47675827","chr2B","63272352","63272656","49","15596805"
"chr6","47684562","47684680","chr10","89586333","89586448","20","41901771"
"chr6","47698665","47698955","chr2B","63254029","63254327","38","15555364"
"chr6","47716425","47716721","chr9","58197818","58198111","52","10481393"
"chr6","47721812","47721943","chr12","12379017","12379147","20","35342795"
"chr6","47757349","47757623","chr2B","63195834","63196121","38","15438485"
"chr6","47762812","47763131","chr7","74219754","74220065","63","26456942"
"chr6","47785408","47785690","chr2B","63165522","63165797","45","15380114"
"chr6","47800074","47800368","chr2B","63150163","63150454","26","15350089"
"chr6","47883198","47883487","chr2B","63065202","63065499","45","15182004"
"chr6","47884187","47884348","chr2A","81614952","81615113","34","33730765"
"chr6","47897611","47897899","chr4","4963095","4963387","54","42934516"
"chr6","48009122","48009378","chr2B","62928542","62928811","48","14919420"
"chr6","48129643","48129926","chr16","65928575","65928859","53","17798932"
"chr6","48177995","48178265","chr2B","62773352","62773622","32","14595357"
"chr6","48187353","48187644","chr2B","62764030","62764321","25","14576677"
"chr6","48196707","48197023","chr2B","62755006","62755333","45","14558299"
"chr6","48210962","48211253","chr1","43624160","43624442","68","4586802"
"chr6","48313859","48314063","chr1","65289204","65289398","60","16975345"
"chr6","48411634","48411914","chr2B","62553752","62554051","54","14142118"
"chr6","48429213","48429507","chr2B","62530915","62531207","26","14101702"
"chr6","48469827","48469897","chr2B","62475177","62475250","6","14005350"
"chr6","48510726","48511031","chr2B","62428813","62429122","36","13918087"
"chr6","48530972","48531100","chr2B","62409952","62410079","16","13878980"
"chr6","48549107","48549212","chrX","41787655","41787753","33","6761452"
"chr6","48563563","48563863","chr2B","62389806","62390089","44","13826243"
"chr6","48563957","48564243","chr2B","62389414","62389704","33","13825457"
"chr6","48598776","48599075","chr2B","62358650","62358956","34","13759874"
"chr6","48624796","48625098","chr3","143449072","143449369","55","94824276"
"chr6","48641122","48641428","chr2B","62305259","62305561","35","13664137"
"chr6","48662884","48663186","chr2B","62283490","62283790","43","13620606"
"chr6","48687637","48687846","chr2B","62264322","62264544","49","13576685"
"chr6","48706515","48706860","chr5","59121600","59121939","91","10415085"
"chr6","48708943","48709196","chr2B","62241198","62241450","27","13532255"
"chr6","48709939","48710065","chr2B","62240327","62240449","19","13530388"
"chr6","48731698","48731951","chr18","35498384","35498632","65","13233314"
"chr6","48762191","48762490","chr3","144506386","144506689","65","95744195"
"chr6","48764456","48764753","chr2B","62174293","62174605","52","13409837"
"chr6","48779029","48779193","chr10","106623894","106624059","37","57844865"
"chr6","48781402","48781609","chr9","76686477","76686696","57","27905075"
"chr6","48791430","48791513","chr2B","62150719","62150796","17","13359289"
"chr6","48791771","48792078","chr5","150684344","150684649","49","101892573"
"chr6","48793554","48793833","chr2B","62147621","62147897","33","13354067"
"chr6","48802807","48803090","chr1","25279276","25279555","59","23523531"
"chr6","48803499","48803664","chr2B","62135321","62135506","36","13331822"
"chr6","48821885","48822163","chr2B","62117584","62117861","38","13295699"
"chr6","48835401","48835514","chr14","86210901","86211013","15","37375500"
"chr6","48850228","48850415","chr19","42939421","42939618","44","5910807"
"chr6","48862042","48862340","chr16","24319225","24319527","59","24542817"
"chr6","48867686","48867815","chr2B","62068254","62068385","17","13200568"
"chr6","48905184","48905308","chr6","165365596","165365720","21","116460412"
"chr6","48911784","48911900","chr2B","62022821","62022937","8","13111037"
"chr6","48958623","48958894","chr2B","61984674","61984956","46","13026051"
"chr6","48975965","48976115","chr1","148219593","148219735","43","99243628"
"chr6","48987165","48987339","chr7","64805738","64805905","40","15818573"
"chr6","49017143","49017269","chr1","160325204","160325326","24","111308061"
"chr6","49033926","49034082","chr1","205548459","205548612","40","156514533"
"chr6","49040133","49040459","chr5","19654858","19655148","104","29385275"
"chr6","49047435","49047737","chr7","81305611","81305899","64","32258176"
"chr6","49079041","49079354","chr2B","61861626","61861953","69","12782585"
"chr6","49083400","49083674","chr2B","61857232","61857508","31","12773832"
"chr6","49086277","49086394","chr22","14821499","14821616","17","34264778"
"chr6","49096882","49097171","chr2B","61844527","61844813","51","12747645"
"chr6","49101585","49101852","chr2B","61839416","61839701","48","12737831"
"chr6","49129517","49129808","chr2B","61823563","61823866","57","12694046"
"chr6","49130512","49130792","chr2B","61816257","61816553","44","12685745"
"chr6","49148043","49148227","chr22","17201375","17201550","52","31946668"
"chr6","49186120","49186454","chr14","74648542","74648869","77","25462422"
"chr6","49205187","49205304","chr2B","61711544","61711661","12","12506357"
"chr6","49245319","49245653","chr3","102884831","102885124","90","53639512"
"chr6","49270297","49270571","chr2B","61643799","61644065","38","12373502"
"chr6","49274509","49274763","chr2B","61639560","61639824","51","12365051"
"chr6","49280890","49281181","chr2B","61632913","61633209","47","12352023"
"chr6","49290318","49290578","chr2B","61621726","61621976","53","12331408"
"chr6","49440788","49441023","chr2B","78477329","78477567","29","29036541"
"chr6","49462444","49462735","chr1","227415933","227416230","47","177953489"
"chr6","49477198","49477473","chr12","8035964","8036234","61","41441234"
"chr6","49572526","49572769","chr19","5538091","5538345","48","44034435"
"chr6","49730658","49730775","chr2B","61240069","61240184","14","11509411"
"chr6","49740458","49740763","chr2A","68106280","68106583","51","18365822"
"chr6","49759665","49759947","chr8","10918408","10918679","82","38841257"
"chr6","49805198","49805450","chr9","73362132","73362391","60","23556934"
"chr6","49814312","49814599","chr2B","61159779","61160087","44","11345467"
"chr6","49832633","49832745","chr2B","61142588","61142704","12","11309955"
"chr6","49854468","49854755","chr2B","61126818","61127097","38","11272350"
"chr6","49884431","49884645","chr2B","61096029","61096239","32","11211598"
"chr6","49899980","49900255","chr1","16246484","16246765","67","33653496"
"chr6","49914204","49914514","chr2B","61070272","61070551","57","11156068"
"chr6","49941261","49941335","chr1","8477806","8477881","18","41463455"
"chr6","49941363","49941498","chr10","40852185","40852313","23","9089178"
"chr6","49977209","49977334","chr1","71170358","71170483","18","21193149"
"chr6","50063722","50063985","chr1","196488135","196488410","55","146424413"
"chr6","50100973","50101251","chr2B","60902600","60902909","59","10801627"
"chr6","50146042","50146159","chr2B","60859916","60860040","21","10713874"
"chr6","50199823","50200097","chr10","15931430","15931716","69","34268393"
"chr6","50201206","50201335","chr6","18588428","18588554","35","31612778"
"chr6","50254514","50254632","chr2B","60771641","60771760","19","10517127"
"chr6","50262464","50262607","chr13","31826426","31826561","34","18436038"
"chr6","50341484","50341773","chr2B","60670393","60670687","31","10328909"
"chr6","50346512","50346720","chr1","189564168","189564369","50","139217656"
"chr6","50348371","50348593","chr3","186125466","186125695","62","135777095"
"chr6","50366278","50366574","chr2B","60652886","60653187","32","10286608"
"chr6","50433600","50433885","chr2B","60595794","60596080","26","10162194"
"chr6","50447528","50447650","chr15","21221421","21221544","25","29226107"
"chr6","50478354","50478581","chr4","71665586","71665814","60","21187232"
"chr6","50560941","50561226","chr2B","60466421","60466707","49","9905480"
"chr6","50706025","50706109","chr19","733963","734045","17","49972062"
"chr6","50790604","50790679","chrX","411658","411734","18","50378946"
"chr6","50791305","50791364","chr7","71171698","71171760","17","20380393"
"chr6","50923371","50923520","chr10","27964289","27964440","34","22959082"
"chr6","51090521","51090838","chr2B","59925100","59925392","64","8834579"
"chr6","51250300","51250574","chr7","130625140","130625420","69","79374840"
"chr6","51291229","51291379","chr6","36782155","36782293","31","14509074"
"chr6","51354139","51354419","chr2B","59645070","59645353","47","8290931"
"chr6","51460948","51461211","chr2B","59540932","59541220","51","8079984"
"chr6","51495710","51495993","chr11","72679183","72679466","70","21183473"
"chr6","51639883","51640149","chr14","40139092","40139348","66","11500791"
"chr6","51672948","51673193","chr2B","59285885","59286129","33","7612937"
"chr6","51733814","51734115","chr2B","59232904","59233207","44","7499090"
"chr6","51774594","51774875","chr2B","59194612","59194889","32","7420018"
"chr6","52189005","52189118","chr18","48326419","48326520","29","3862586"
"chr6","52588009","52588123","chr1","16425827","16425944","21","36162182"
"chr6","52634128","52634401","chr2B","58389000","58389281","39","5754872"
"chr6","52640703","52640975","chr21","36202131","36202419","66","16438572"
"chr6","52649396","52649657","chr4","95390320","95390564","80","42740924"
"chr6","52682179","52682302","chr5","80208930","80209053","16","27526751"
"chr6","52724849","52724969","chr4","197619244","197619365","23","144894395"
"chr6","52807463","52807715","chr2B","58204455","58204708","34","5396992"
"chr6","52888558","52888848","chr2B","58114388","58114681","29","5225830"
"chr6","52940227","52940529","chr2B","58053821","58054126","52","5113594"
"chr6","52946629","52946736","chr14","77343208","77343315","22","24396579"
"chr6","52985215","52985487","chr2B","58014318","58014603","55","5029103"
"chr6","52997859","52997973","chr2B","58000512","58000625","19","5002653"
"chr6","53036019","53036298","chr2B","57961077","57961361","35","4925058"
"chr6","53069632","53069908","chr2B","57927580","57927868","50","4857948"
"chr6","53182220","53182421","chr10","13436622","13436834","54","39745598"
"chr6","53447048","53447213","chr6","5020344","5020506","41","48426704"
"chr6","53619341","53619642","chr2B","57378550","57378847","56","3759209"
"chr6","53642174","53642504","chr2B","57357438","57357749","57","3715264"
"chr6","53722684","53722966","chr2B","57285355","57285646","50","3562671"
"chr6","53745128","53745323","chr2B","57252658","57252853","19","3507530"
"chr6","53789528","53789830","chr2B","57212410","57212729","67","3422882"
"chr6","53802911","53803191","chr10","107074752","107075030","72","53271841"
"chr6","53804888","53805152","chr2B","57196033","57196335","67","3391145"
"chr6","53877180","53877282","chr20","17944129","17944232","20","35933051"
"chr6","53930312","53930388","chr9","45356989","45357065","19","8573323"
"chr6","53930604","53930727","chr2B","57065563","57065686","16","3134959"
"chr6","53955811","53956098","chr2B","57040762","57041064","45","3084951"
"chr6","53961457","53961620","chr19","8903155","8903318","48","45058302"
"chr6","54020080","54020241","chrX","130137391","130137550","34","76117311"
"chr6","54414649","54414939","chr2B","56580812","56581112","58","2166163"
"chr6","54635934","54636228","chr2B","56353245","56353527","47","1717311"
"chr6","54708252","54708379","chr2B","56279257","56279386","21","1571005"
"chr6","54795417","54795629","chr2B","56195547","56195747","45","1400130"
"chr6","54908597","54908882","chr2B","56072477","56072757","35","1163880"
"chr6","54963324","54963620","chr16","65810624","65810918","71","10847300"
"chr6","55155254","55155521","chr2B","55834859","55835124","42","679605"
"chr6","55162689","55162995","chr4","4517769","4518079","61","50644920"
"chr6","55282045","55282323","chr2B","55708772","55709050","50","426727"
"chr6","55369835","55370002","chr12","100161906","100162075","37","44792071"
"chr6","55471166","55471422","chr2B","55534532","55534817","59","63366"
"chr6","55486067","55486354","chr16","27978297","27978584","72","27507770"
"chr6","55924372","55924671","chr2A","74276713","74277013","75","18352341"
"chr6","56004268","56004540","chrX","48548877","48549159","39","7455391"
"chr6","56174717","56174830","chr8","44775255","44775370","15","11399462"
"chr6","56213776","56213850","chr6","32701574","32701648","16","23512202"
"chr6","56242416","56242730","chr2B","54826298","54826587","65","1416118"
"chr6","56287334","56287520","chr1","36042325","36042518","61","20245009"
"chr6","56443853","56443994","chr3","39881249","39881395","38","16562604"
"chr6","56708135","56708422","chr2B","54351708","54352010","49","2356427"
"chr6","56776940","56777243","chr2B","54289559","54289852","36","2487381"
"chr6","56890888","56891191","chr2B","54179806","54180098","45","2711082"
"chr6","56926327","56926602","chr2B","54139726","54140026","54","2786601"
"chr6","56968817","56969022","chr2B","54098166","54098375","26","2870651"
"chr6","56974125","56974404","chr2B","54093239","54093534","61","2880886"
"chr6","57238113","57238391","chr19","16930672","16930946","59","40307441"
"chr6","57319078","57319368","chr2B","53822374","53822684","50","3496704"
"chr6","57348099","57348215","chr2B","53796710","53796826","12","3551389"
"chr6","57420881","57421110","chr2B","53766809","53767038","29","3654072"
"chr6","57522837","57523115","chr2B","53688073","53688374","58","3834764"
"chr6","57572154","57572299","chr5","44182216","44182368","34","13389938"
"chr6","57587798","57588102","chr2B","53629601","53629902","29","3958197"
"chr6","57646219","57646495","chr18","43204867","43205129","78","14441352"
"chr6","57646665","57646952","chr2B","53538480","53538774","54","4108185"
"chr6","57799969","57800255","chr2B","53391572","53391885","59","4408397"
"chr6","57888302","57888598","chr5","32442653","32442945","67","25445649"
"chr6","57912717","57913018","chr2B","53280470","53280770","43","4632247"
"chr6","57917726","57918021","chr2B","53278476","53278788","59","4639250"
"chr6","57981821","57981918","chr2B","53217459","53217538","24","4764362"
"chr6","57982823","57983139","chr2B","53216565","53216878","37","4766258"
"chr6","58028780","58028913","chr11","117613154","117613293","30","59584374"
"chr6","58052296","58052583","chr2B","53150689","53151001","52","4901607"
"chr6","58057211","58057378","chr7","139769839","139770003","31","81712628"
"chr6","58057405","58057464","chr6","142056153","142056210","15","83998748"
"chr6","58378443","58378690","chr2B","52861749","52862004","58","5516694"
"chr6","58429349","58429703","chr8","131535204","131535561","91","73105855"
"chr6","58509151","58509274","chr11","108850796","108850918","19","50341645"
"chr6","58531963","58532260","chr2B","52719741","52720027","56","5812222"
"chr6","58534988","58535274","chr2B","52716711","52717013","46","5818277"
"chr6","58611211","58611546","chr4","195263548","195263867","91","136652337"
"chr6","58713908","58714150","chr2B","52537956","52538205","39","6175952"
"chr6","58726352","58726678","chr2B","52526098","52526381","75","6200254"
"chr6","58783611","58783836","chr8","107449516","107449741","58","48665905"
"chr6","58909942","58910041","chr8","27454109","27454202","21","31455833"
"chr6","59020484","59020775","chr2B","52188284","52188561","41","6832200"
"chr6","59039478","59039707","chr2B","52171478","52171722","31","6868000"
"chr6","59090023","59090322","chr2B","52129355","52129640","48","6960668"
"chr6","59155834","59155985","chr10","92108530","92108678","35","32952696"
"chr6","59169569","59169840","chr2B","52073192","52073481","49","7096377"
"chr6","59222514","59222799","chr2B","52029258","52029540","37","7193256"
"chr6","59231433","59231712","chr2B","52022653","52022947","40","7208780"
"chr6","59258892","59259012","chr2B","51999488","51999611","16","7259404"
"chr6","59271062","59271173","chr2B","51989761","51989883","23","7281301"
"chr6","59277083","59277368","chr7","46509339","46509619","68","12767744"
"chr6","59280502","59280808","chr2B","51977466","51977766","46","7303036"
"chr6","59282210","59282501","chr2B","51975814","51976103","35","7306396"
"chr6","59297076","59297169","chr1","66038338","66038434","18","6741262"
"chr6","59302297","59302576","chr2B","51954606","51954887","55","7347691"
"chr6","59310095","59310340","chr2B","51947991","51948263","55","7362104"
"chr6","59310689","59310804","chr8","8957635","8957751","22","50353054"
"chr6","59328990","59329275","chr3","34336277","34336558","65","24992713"
"chr6","59349597","59349858","chr16","31185625","31185888","65","28163972"
"chr6","59349866","59349983","chr17","58216621","58216738","29","1133245"
"chr6","59394735","59394832","chr16","62589759","62589857","15","3195024"
"chr6","59440776","59441012","chr10","26364668","26364905","54","33076108"
"chr6","59445154","59445245","chr9","75915145","75915233","19","16469991"
"chr6","59491264","59491549","chr2B","51799366","51799657","36","7691898"
"chr6","59522903","59523190","chr12","112473264","112473558","61","52950361"
"chr6","59524069","59524196","chr20","30238448","30238572","15","29285621"
"chr6","59536204","59536457","chr1","217102109","217102356","61","157565905"
"chr6","59559687","59559899","chrX","6965384","6965590","48","52594303"
"chr6","59560530","59560837","chr2B","51718276","51718584","52","7842254"
"chr6","59602335","59602641","chr2B","51673925","51674250","61","7928410"
"chr6","59618854","59618977","chr3","12861628","12861752","20","46757226"
"chr6","59640660","59640970","chr2B","51647248","51647553","49","7993412"
"chr6","59706947","59707226","chr2B","51599143","51599419","48","8107804"
"chr6","59720264","59720570","chr2B","51572269","51572567","37","8147995"
"chr6","59735438","59735725","chr2B","51556426","51556733","42","8179012"
"chr6","59771609","59771825","chr2B","51518031","51518250","30","8253578"
"chr6","59792538","59792827","chr19","37861592","37861881","60","21930946"
"chr6","59797297","59797449","chr18","77876014","77876168","36","18078717"
"chr6","59803731","59803855","chr1","161552896","161553018","23","101749165"
"chr6","59810504","59810820","chr2B","51494425","51494740","33","8316079"
"chr6","59812001","59812289","chr3","58326549","58326835","52","1485452"
"chr6","59812455","59812579","chr10","12650705","12650831","37","47161750"
"chr6","59834143","59834425","chr2B","51471583","51471883","60","8362560"
"chr6","59926165","59926463","chr2B","51384684","51384979","51","8541481"
"chr6","59932277","59932584","chr2B","51379106","51379386","52","8553171"
"chr6","59945256","59945386","chr2B","51365666","51365789","17","8579590"
"chr6","59976161","59976457","chr2B","51339334","51339650","53","8636827"
"chr6","60021282","60021567","chr2B","51290698","51290999","58","8730584"
"chr6","60033605","60033878","chr2B","51275049","51275314","53","8758556"
"chr6","60035428","60035552","chr2B","51273719","51273843","8","8761709"
"chr6","60040245","60040514","chr2B","51269035","51269316","35","8771210"
"chr6","60049021","60049122","chr4","121283672","121283773","18","61234651"
"chr6","60053373","60053676","chr1","24901701","24902008","70","35151672"
"chr6","60067211","60067336","chr3","123212809","123212928","33","63145598"
"chr6","60067917","60067978","chr20","35383347","35383404","14","24684570"
"chr6","60079496","60079712","chr2B","51222931","51223174","50","8856565"
"chr6","60100549","60100702","chr10","49585047","49585201","34","10515502"
"chr6","60102368","60102481","chr1","129643342","129643458","22","69540974"
"chr6","60115202","60115469","chr2B","51187416","51187682","31","8927786"
"chr6","60129314","60129442","chr2A","36295414","36295540","20","23833900"
"chr6","60161080","60161314","chr2B","51149473","51149698","35","9011607"
"chr6","60178838","60178990","chr16","6330633","6330790","37","53848205"
"chr6","60200091","60200380","chr2A","78488386","78488675","64","18288295"
"chr6","60201218","60201336","chr2B","51063003","51063130","24","9138215"
"chr6","60263041","60263199","chr9","11369504","11369664","33","48893537"
"chr6","60263486","60263775","chr8","144786356","144786646","63","84522870"
"chr6","60263799","60263872","chr10","107119420","107119486","18","46855621"
"chr6","60271782","60272088","chr2B","51001541","51001841","34","9270241"
"chr6","60313295","60313565","chr15","57089633","57089905","58","3223662"
"chr6","60477854","60477979","chr2B","50804074","50804199","6","9673780"
"chr6","60537887","60538182","chr2B","50747114","50747411","39","9790773"
"chr6","60551450","60551685","chr6","45626172","45626405","63","14925278"
"chr6","60599526","60599842","chr2B","50675915","50676230","43","9923611"
"chr6","60600719","60601005","chr2B","50674728","50675024","52","9925991"
"chr6","60624442","60624721","chr2B","50651014","50651308","52","9973428"
"chr6","60628704","60629003","chr5","8233679","8233972","69","52395025"
"chr6","60695866","60696038","chr2B","50592184","50592342","38","10103682"
"chr6","60768156","60768448","chr2B","50519043","50519354","43","10249113"
"chr6","60772328","60772452","chr4","124129514","124129638","19","63357186"
"chr6","61092241","61092534","chr2B","50227083","50227364","66","10865158"
"chr6","61117881","61118174","chr2B","50201322","50201618","23","10916559"
"chr6","61136641","61136931","chr1","132730429","132730720","61","71593788"
"chr6","61181409","61181691","chr7","76104969","76105262","54","14923560"
"chr6","61204328","61204422","chr7","1480068","1480167","22","59724260"
"chr6","61205397","61205519","chr7","131057815","131057935","20","69852418"
"chr6","61216676","61216977","chr2B","50109082","50109377","66","11107594"
"chr6","61240470","61240762","chr14","44599174","44599465","69","16641296"
"chr6","61245868","61245991","chr2B","100140280","100140403","17","38894412"
"chr6","61275644","61275781","chr11","69147152","69147272","42","7871508"
"chr6","61280090","61280360","chr21","35390505","35390778","61","25889585"
"chr6","61289591","61289838","chr2B","50037899","50038157","29","11251692"
"chr6","61533297","61533406","chr12","110164763","110164871","19","48631466"
"chr6","61580043","61580307","chr2B","49790979","49791234","55","11789064"
"chr6","61622733","61623012","chr2B","49761645","49761950","51","11861088"
"chr6","61644246","61644510","chr12","123845655","123845925","59","62201409"
"chr6","61659189","61659482","chr2B","49713819","49714120","33","11945370"
"chr6","61727328","61727615","chr2B","49659865","49660173","51","12067463"
"chr6","61772545","61772764","chr6","113806159","113806380","64","52033614"
"chr6","61816891","61817179","chr2B","49562171","49562465","42","12254720"
"chr6","61906899","61907205","chr12","115703385","115703691","68","53796486"
"chr6","61919281","61919494","chr19","54934633","54934840","55","6984648"
"chr6","62004591","62004880","chr1","95058437","95058732","71","33053846"
"chr6","62013086","62013381","chr2B","49364545","49364856","60","12648541"
"chr6","62271984","62272266","chr2B","49092166","49092441","57","13179818"
"chr6","62292078","62292214","chr1","39341659","39341785","46","22950419"
"chr6","62501129","62501293","chr5","51144248","51144411","32","11356881"
"chr6","62577260","62577540","chr8","142341052","142341351","62","79763792"
"chr6","62667886","62667998","chr2B","48706318","48706431","8","13961568"
"chr6","62716998","62717284","chr2B","48659387","48659670","44","14057611"
"chr6","62722471","62722761","chr16","27282347","27282648","71","35440124"
"chr6","62734665","62734778","chr12","95329202","95329317","18","32594537"
"chr6","62765284","62765567","chr10","140094597","140094882","67","77329313"
"chr6","62790660","62790912","chr2B","48600531","48600784","31","14190129"
"chr6","62790999","62791310","chr2B","48600142","48600444","31","14190857"
"chr6","62791984","62792280","chr12","75444482","75444776","82","12652498"
"chr6","62823645","62823726","chr7","4939048","4939129","21","57884597"
"chr6","62834182","62834457","chr19","2739038","2739315","57","60095144"
"chr6","63047066","63047199","chr12","7894899","7895028","33","55152167"
"chr6","63220652","63220805","chr2B","48175406","48175546","33","15045246"
"chr6","63253720","63254005","chr2B","48138665","48138951","30","15115055"
"chr6","63752566","63752679","chr14","54877920","54878035","27","8874646"
"chr6","64048470","64048763","chr2B","47354031","47354331","54","16694439"
"chr6","64230629","64230927","chr2B","47195017","47195315","43","17035612"
"chr6","64233211","64233339","chr4","40642807","40642931","36","23590404"
"chr6","64392858","64393145","chr2B","47021084","47021339","58","17371774"
"chr6","64615580","64615861","chr2B","46789923","46790223","61","17825657"
"chr6","64619133","64619408","chr2B","46786367","46786640","45","17832766"
"chr6","64739194","64739460","chr2B","46664080","46664359","52","18075114"
"chr6","64808972","64809276","chr2B","46598246","46598527","66","18210726"
"chr6","64930023","64930131","chr1","110927291","110927405","28","45997268"
"chr6","64930429","64930548","chr8","9176979","9177104","31","55753450"
"chr6","65089015","65089289","chr7","71049501","71049771","80","5960486"
"chr6","65136083","65136133","chr19","12975064","12975118","12","52161019"
"chr6","65243996","65244121","chr16","65399021","65399150","35","155025"
"chr6","65295903","65296175","chr1","128541751","128542014","75","63245848"
"chr6","65369714","65369882","chr10","49585047","49585201","45","15784667"
"chr6","65426264","65426567","chr2B","46075139","46075435","41","19351125"
"chr6","65464881","65465172","chr3","140583382","140583663","77","75118501"
"chr6","65828099","65828195","chr10","11937949","11938048","26","53890150"
"chr6","65952069","65952237","chr3","10866047","10866211","41","55086022"
"chr6","65980840","65981119","chr2B","45468718","45468999","42","20512122"
"chr6","66001355","66001619","chr8","20715446","20715705","65","45285909"
"chr6","66402467","66402729","chr4","130658954","130659205","75","64256487"
"chr6","66426370","66426431","chr1","33883628","33883686","15","32542742"
"chr6","66459699","66459990","chr2B","45017718","45018019","56","21441981"
"chr6","66492494","66492687","chr12","110696507","110696698","38","44204013"
"chr6","66557630","66557772","chr19","10535871","10536003","37","56021759"
"chr6","66601600","66601723","chr2B","44874258","44874381","15","21727342"
"chr6","66615986","66616154","chr13","11997588","11997744","48","54618398"
"chr6","66652151","66652472","chr15","44244841","44245146","58","22407310"
"chr6","66658868","66659079","chr2B","44812346","44812565","33","21846522"
"chr6","66754058","66754362","chr13","8725254","8725544","67","58028804"
"chr6","66772540","66772755","chr1","61837689","61837890","72","4934851"
"chr6","66869948","66870214","chr4","25615518","25615800","68","41254430"
"chr6","66870854","66870976","chrX","49113443","49113558","30","17757411"
"chr6","66871141","66871226","chr4","196406230","196406315","17","129535089"
"chr6","66876074","66876370","chr3","143449072","143449369","60","76572998"
"chr6","66898553","66898665","chr3","144866863","144866979","18","77968310"
"chr6","66899039","66899324","chr2B","44573367","44573665","54","22325672"
"chr6","66917878","66918001","chr4","41511483","41511606","27","25406395"
"chr6","67021132","67021439","chr1","217706889","217707180","83","150685757"
"chr6","67063454","67063762","chr2B","44460458","44460768","50","22602996"
"chr6","67065943","67066227","chr19","42808068","42808354","68","24257875"
"chr6","67077818","67077928","chr2B","62022821","62022937","22","5054997"
"chr6","67080327","67080621","chr1","91059171","91059456","66","23978844"
"chr6","67095721","67095894","chr15","14442316","14442493","37","52653405"
"chr6","67118605","67118718","chr2B","44396304","44396418","10","22722301"
"chr6","67150784","67150953","chr4","165048422","165048576","37","97897638"
"chr6","67157630","67157925","chr11","14443649","14443947","59","52713981"
"chr6","67189053","67189339","chrX","132744051","132744342","56","65554998"
"chr6","67206822","67207090","chr14","75002648","75002911","57","7795826"
"chr6","67254078","67254386","chr2B","44258861","44259153","52","22995217"
"chr6","67282541","67282809","chr2B","44225824","44226107","47","23056717"
"chr6","67286974","67287235","chr2B","44220764","44221032","36","23066210"
"chr6","67297714","67297995","chr2B","44211794","44212088","43","23085920"
"chr6","67299321","67299450","chr6","31988955","31989088","28","35310366"
"chr6","67307194","67307486","chr2B","44206900","44207207","57","23100294"
"chr6","67388997","67389277","chr9","92741261","92741542","63","25352264"
"chr6","67393898","67394165","chr2B","44135794","44136085","51","23258104"
"chr6","67408520","67408689","chr1","162716672","162716841","33","95308152"
"chr6","67465283","67465585","chr2B","44065188","44065504","55","23400095"
"chr6","67495377","67495692","chr2B","44053603","44053918","46","23441774"
"chr6","67513866","67514168","chr2B","44031795","44032084","41","23482071"
"chr6","67549392","67549679","chr2B","44011594","44011885","54","23537798"
"chr6","67561836","67562065","chr15","51004153","51004375","48","16557683"
"chr6","67599250","67599475","chr3","48292385","48292614","57","19306865"
"chr6","67613421","67613726","chr2B","43953895","43954194","55","23659526"
"chr6","67615523","67615824","chr2B","43951782","43952083","42","23663741"
"chr6","67675365","67675652","chr2B","43886143","43886454","51","23789222"
"chr6","67698859","67699151","chr10","102074027","102074319","58","34375168"
"chr6","67728280","67728404","chr4","93123539","93123663","22","25395259"
"chr6","67732881","67733180","chr2B","43833491","43833793","36","23899390"
"chr6","67791804","67792033","chr2B","43760004","43760226","32","24031800"
"chr6","67807207","67807477","chr2B","43744694","43744988","55","24062513"
"chr6","67942728","67942951","chr1","223440729","223440957","57","155498001"
"chr6","68008737","68009029","chr2B","43524667","43524960","60","24484070"
"chr6","68024052","68024352","chr2B","43511936","43512236","47","24512116"
"chr6","68044869","68045182","chr2B","43475387","43475691","42","24569482"
"chr6","68079993","68080115","chr2B","43445392","43445521","19","24634601"
"chr6","68119912","68120099","chrX","141015925","141016112","60","72896013"
"chr6","68145091","68145206","chr11","68175203","68175315","15","30112"
"chr6","68259488","68259773","chr7","65605329","65605613","61","2654159"
"chr6","68307514","68307830","chr7","74973664","74973967","90","6666150"
"chr6","68334785","68335066","chr2B","43218439","43218724","43","25116346"
"chr6","68561668","68561883","chr2B","43004174","43004380","27","25557494"
"chr6","68672875","68673021","chr10","92108530","92108678","34","23435655"
"chr6","68701948","68702224","chr2B","42867019","42867281","54","25834929"
"chr6","68804953","68805162","chr2B","42773205","42773413","35","26031748"
"chr6","68936203","68936444","chr2B","42645482","42645720","35","26290721"
"chr6","68941970","68942084","chr1","197987006","197987122","24","129045036"
"chr6","68970146","68970268","chr11","69147152","69147272","39","177006"
"chr6","69016877","69017168","chr12","75426391","75426673","63","6409514"
"chr6","69086356","69086389","chr14","22355825","22355862","6","46730531"
"chr6","69086822","69086895","chr12","129624083","129624153","22","60537261"
"chr6","69087187","69087250","chr19","10375635","10375699","17","58711552"
"chr6","69123740","69124051","chr2B","42456792","42457123","55","26666948"
"chr6","69264451","69264748","chr2B","42307742","42308047","51","26956709"
"chr6","69315459","69315734","chr2B","42251075","42251341","46","27064384"
"chr6","69507404","69507720","chr2B","42046667","42046976","55","27460737"
"chr6","70006027","70006314","chr12","66440809","66441094","63","3565218"
"chr6","70149189","70149272","chr5","126607895","126607978","11","56458706"
"chr6","70177965","70178260","chr2B","41538359","41538656","44","28639606"
"chr6","70238871","70239136","chr2B","41303652","41303939","62","28935219"
"chr6","70364317","70364631","chr2B","41198124","41198430","40","29166193"
"chr6","70453558","70453847","chr2B","41098076","41098357","47","29355482"
"chr6","70486958","70487263","chr2B","41061982","41062286","57","29424976"
"chr6","70595997","70596281","chr2B","40963141","40963426","36","29632856"
"chr6","70700660","70700966","chr2B","40866816","40867110","49","29833844"
"chr6","70722163","70722365","chr18","28646904","28647109","51","42075259"
"chr6","70737993","70738271","chr2B","40830017","40830307","49","29907976"
"chr6","70740688","70740790","chr2B","34893349","34893450","17","35847339"
"chr6","70746476","70746744","chr7","75722936","75723217","68","4976460"
"chr6","70792287","70792554","chr2B","40778808","40779071","41","30013479"
"chr6","70810094","70810254","chr1","205548459","205548612","27","134738365"
"chr6","70836717","70836962","chr2B","40719656","40719903","22","30117061"
"chr6","70845616","70845733","chr3","198763104","198763221","17","127917488"
"chr6","70933782","70933913","chrX","9604281","9604412","18","61329501"
"chr6","70953683","70953938","chr2B","40607260","40607515","36","30346423"
"chr6","71057189","71057503","chr2B","40513667","40513983","46","30543522"
"chr6","71079640","71079937","chr2B","40488103","40488401","45","30591537"
"chr6","71223325","71223540","chr3","126441844","126442070","48","55218519"
"chr6","71249723","71250006","chr2B","40323547","40323853","47","30926176"
"chr6","71256023","71256325","chr1","41517961","41518265","65","29738062"
"chr6","71258714","71258813","chr13","5789563","5789662","27","65469151"
"chr6","71277376","71277659","chrX","54076893","54077171","71","17200483"
"chr6","71282205","71282478","chr7","875713","875995","63","70406492"
"chr6","71308321","71308598","chr2B","40262504","40262778","36","31045817"
"chr6","71321940","71322054","chr18","30346010","30346126","17","40975930"
"chr6","71347174","71347285","chr8","79737740","79737854","31","8390566"
"chr6","71349064","71349251","chr8","98909960","98910147","40","27560896"
"chr6","71380135","71380240","chr12","35988727","35988830","25","35391408"
"chr6","71393899","71394204","chrX","77641675","77641977","65","6247776"
"chr6","71405559","71405685","chr6","90146475","90146599","20","18740916"
"chr6","71449448","71449724","chr2B","40104498","40104777","39","31344950"
"chr6","71473227","71473377","chr1","20250353","20250500","33","51222874"
"chr6","71534609","71534880","chr15","50098591","50098863","62","21436018"
"chr6","71563850","71563983","chr2B","39979729","39979859","16","31584121"
"chr6","71693193","71693488","chr2B","39855680","39855968","44","31837513"
"chr6","71717370","71717609","chr2B","39830665","39830927","53","31886705"
"chr6","71931402","71931692","chr2B","39613530","39613823","33","32317872"
"chr6","72009675","72009980","chr2B","39536567","39536880","48","32473108"
"chr6","72058871","72059169","chr3","48478840","48479140","63","23580031"
"chr6","72099069","72099178","chr9","91909520","91909629","20","19810451"
"chr6","72151279","72151583","chr2B","39396594","39396894","56","32754685"
"chr6","72441628","72441862","chr20","18133504","18133721","54","54308124"
"chr6","72497143","72497428","chr5","38104922","38105205","59","34392221"
"chr6","72738994","72739100","chr16","24570300","24570410","20","48168694"
"chr6","72746062","72746357","chr2B","38815935","38816258","65","33930127"
"chr6","72815448","72815747","chr2B","38744998","38745306","48","34070450"
"chr6","72821729","72821879","chr7","77484800","77484949","38","4663071"
"chr6","72917026","72917148","chr20","34631402","34631525","22","38285624"
"chr6","73045073","73045389","chr2B","38525110","38525424","79","34519963"
"chr6","73438861","73438950","chr4","165652302","165652387","18","92213441"
"chr6","73548827","73549110","chr2B","37940287","37940566","43","35608540"
"chr6","73582062","73582333","chr11","70439948","70440217","58","3142114"
"chr6","73645413","73645717","chr2B","37846573","37846871","45","35798840"
"chr6","73814257","73814510","chr8","74464427","74464686","61","650170"
"chr6","73814938","73815146","chr2B","37656241","37656448","29","36158697"
"chr6","73946647","73946770","chr21","32443205","32443329","20","41503442"
"chr6","74294016","74294305","chr14","74025045","74025332","70","268971"
"chr6","74296495","74296779","chr2B","37173960","37174234","44","37122535"
"chr6","74331602","74331853","chr2B","37138666","37138922","58","37192936"
"chr6","74632819","74633126","chr2B","36856114","36856399","63","37776705"
"chr6","74693837","74694116","chr2B","36803208","36803499","50","37890629"
"chr6","74882790","74883078","chr2B","36638943","36639242","40","38243847"
"chr6","74952145","74952271","chr6","42782331","42782460","30","32169814"
"chr6","74968600","74968747","chrX","47633507","47633660","42","27335093"
"chr6","74969670","74969827","chr17","38084410","38084569","42","36885260"
"chr6","74973784","74974013","chr2B","111420804","111421016","59","36447020"
"chr6","75093581","75093851","chr4","97528710","97528984","74","22435129"
"chr6","75108700","75108847","chr11","57220311","57220464","34","17888389"
"chr6","75135012","75135308","chrX","41024366","41024656","58","34110646"
"chr6","75226953","75227049","chr2B","36315281","36315382","15","38911672"
"chr6","75236515","75236813","chr2B","36306246","36306544","38","38930269"
"chr6","75348997","75349224","chr10","117644979","117645198","62","42295982"
"chr6","75353402","75353689","chr2B","36206206","36206492","32","39147196"
"chr6","75499018","75499268","chr2B","36057838","36058107","60","39441180"
"chr6","75624543","75624830","chr2B","35939966","35940251","29","39684577"
"chr6","75709198","75709407","chr13","7150448","7150655","42","68558750"
"chr6","75712509","75712736","chr19","14489398","14489637","69","61223111"
"chr6","75768387","75768676","chr2B","35789604","35789885","35","39978783"
"chr6","75907269","75907448","chr2B","35658967","35659149","27","40248302"
"chr6","75969622","75969673","chr8","84889204","84889263","15","8919582"
"chr6","75970160","75970479","chr2B","35605072","35605368","61","40365088"
"chr6","76121215","76121497","chr14","83423917","83424216","73","7302702"
"chr6","76220024","76220330","chr2B","35368340","35368639","47","40851684"
"chr6","76227163","76227303","chr15","18620321","18620458","35","57606842"
"chr6","76258445","76258678","chr2B","35330049","35330276","30","40928396"
"chr6","76378459","76378658","chr5","34152918","34153115","49","42225541"
"chr6","76396759","76397045","chr2B","35192713","35193001","59","41204046"
"chr6","76412313","76412428","chr10","93040219","93040335","18","16627906"
"chr6","76505661","76505942","chr8","24737260","24737543","66","51768401"
"chr6","76541141","76541454","chr2B","35055021","35055311","48","41486120"
"chr6","76560854","76561089","chr1","32303807","32304042","57","44257047"
"chr6","76576063","76576314","chr2B","35022935","35023173","48","41553128"
"chr6","76692486","76692761","chr2A","68698127","68698398","71","7994359"
"chr6","76736180","76736451","chr5","33396167","33396452","70","43340013"
"chr6","76748659","76748948","chr2B","34849427","34849718","53","41899232"
"chr6","76752303","76752556","chr20","32549502","32549771","71","44202801"
"chr6","76841248","76841561","chr2B","34753442","34753729","56","42087806"
"chr6","76976951","76977091","chr1","223894247","223894395","33","146917296"
"chr6","77166148","77166454","chr2B","34384575","34384892","53","42781573"
"chr6","77214386","77214637","chr2B","34338452","34338697","37","42875934"
"chr6","77272906","77273238","chr17","89222408","89222711","93","11949502"
"chr6","77375102","77375263","chr3","14267985","14268147","35","63107117"
"chr6","77748865","77749130","chr13","12503300","12503564","67","65245565"
"chr6","78008617","78008835","chr2B","33578143","33578345","46","44430474"
"chr6","78056661","78056797","chr7","74790659","74790791","28","3266002"
"chr6","78184213","78184507","chr2B","33402799","33403092","32","44781414"
"chr6","78216574","78216819","chr2B","33368254","33368498","55","44848320"
"chr6","78251674","78251847","chr6","36640552","36640719","45","41611122"
"chr6","78356974","78357259","chr2B","33233670","33233971","54","45123304"
"chr6","78365218","78365356","chr3","116806055","116806175","32","38440837"
"chr6","78615374","78615682","chr1","78869810","78870106","72","254436"
"chr6","78679877","78680184","chr2B","32918820","32919121","49","45761057"
"chr6","78802425","78802728","chr2B","32809428","32809735","43","45992997"
"chr6","78830562","78830854","chr2B","32783832","32784139","58","46046730"
"chr6","78898259","78898374","chr8","44775255","44775370","21","34123004"
"chr6","78931741","78931897","chr9","108241495","108241645","31","29309754"
"chr6","78950541","78950684","chr4","118287115","118287260","37","39336574"
"chr6","79016026","79016093","chr7","23547259","23547322","27","55468767"
"chr6","79211074","79211349","chr2B","32425547","32425840","55","46785527"
"chr6","79230179","79230447","chr2B","32400093","32400389","65","46830086"
"chr6","79328831","79329049","chr2B","32299797","32300011","25","47029034"
"chr6","79688634","79688828","chr2B","31921065","31921278","44","47767569"
"chr6","79719975","79720212","chr2B","31883568","31883799","36","47836407"
"chr6","79766176","79766473","chr2B","31836455","31836762","45","47929721"
"chr6","79767396","79767614","chr2A","63672984","63673197","59","16094412"
"chr6","79952387","79952540","chr6","36782155","36782293","45","43170232"
"chr6","79957870","79957970","chr16","20230072","20230173","18","59727798"
"chr6","79992799","79993082","chr2B","31617675","31617989","57","48375124"
"chr6","80017778","80017954","chr2B","31592607","31592785","21","48425171"
"chr6","80051743","80051862","chr2B","31557956","31558078","22","48493787"
"chr6","80639653","80639951","chr2B","30935571","30935868","31","49704082"
"chr6","80646563","80646690","chr3","126654073","126654202","32","46007510"
"chr6","80653875","80653925","chr15","35557409","35557458","16","45096466"
"chr6","80654625","80654678","chr10","89726825","89726876","15","9072200"
"chr6","80655017","80655123","chr18","48326419","48326520","23","32328598"
"chr6","80721485","80721770","chr2B","30839484","30839776","38","49882001"
"chr6","80769720","80769856","chr22","1200687","1200816","37","79569033"
"chr6","80772963","80773241","chr5","160755148","160755395","83","79982185"
"chr6","80806321","80806604","chr2B","30770957","30771234","53","50035364"
"chr6","80958345","80958650","chr16","26052078","26052381","65","54906267"
"chr6","81003889","81004175","chr2B","30569788","30570080","34","50434101"
"chr6","81088385","81088673","chr2B","30476774","30477094","61","50611611"
"chr6","81106276","81106391","chr2A","35382406","35382521","19","45723870"
"chr6","81106814","81106938","chr12","66413415","66413537","27","14693399"
"chr6","81142578","81142872","chr12","61501906","61502184","69","19640672"
"chr6","81227431","81227721","chr2B","30327870","30328190","65","50899561"
"chr6","81290512","81290595","chr4","140522276","140522358","8","59231764"
"chr6","81291457","81291748","chr2B","30265525","30265819","46","51025932"
"chr6","81340977","81341183","chr15","56618981","56619203","58","24721996"
"chr6","81447020","81447338","chr2B","30087505","30087815","62","51359515"
"chr6","81455255","81455407","chr16","15669840","15669995","41","65785415"
"chr6","81515742","81516020","chr1","55838471","55838752","73","25677271"
"chr6","81659687","81659816","chr1","26478986","26479115","20","55180701"
"chr6","81678762","81679050","chr21","4745517","4745818","60","76933245"
"chr6","81851484","81851735","chr2B","78477329","78477567","40","3374155"
"chr6","81880888","81881120","chr2B","78477329","78477567","34","3403559"
"chr6","82332770","82332875","chr12","46140363","46140469","27","36192407"
"chr6","82460463","82460709","chr14","51010174","51010423","65","31450289"
"chr6","82525632","82525952","chr17","26601649","26601949","74","55923983"
"chr6","82549022","82549311","chr14","52226491","52226776","58","30322531"
"chr6","82572454","82572670","chr2B","29193666","29193870","43","53378788"
"chr6","82587096","82587365","chr2B","29178465","29178738","48","53408631"
"chr6","82624956","82625234","chr2B","29138924","29139238","75","53486032"
"chr6","82690350","82690601","chr2B","29076146","29076400","33","53614204"
"chr6","82748245","82748340","chr12","29829704","29829797","29","52918541"
"chr6","82824525","82824826","chr2B","28930399","28930710","42","53894126"
"chr6","83100530","83100645","chr4","154936550","154936667","27","71836020"
"chr6","83134494","83134601","chr12","32494579","32494673","31","50639915"
"chr6","83221987","83222289","chr2B","28542507","28542808","34","54679480"
"chr6","83359410","83359704","chr2B","28403166","28403461","39","54956244"
"chr6","83361094","83361355","chr2B","28401478","28401740","34","54959616"
"chr6","83363147","83363255","chr1","179930648","179930753","30","96567501"
"chr6","83365892","83366190","chr2B","28396628","28396918","34","54969264"
"chr6","83450281","83450577","chr2B","28310865","28311166","51","55139416"
"chr6","83483744","83484045","chr1","23622718","23623020","63","59861026"
"chr6","83541349","83541643","chr2B","28224726","28225032","46","55316623"
"chr6","83629439","83629735","chr3","125296992","125297287","51","41667553"
"chr6","83659037","83659339","chr2B","28087399","28087703","33","55571638"
"chr6","83725176","83725300","chrX","137042831","137042952","31","53317655"
"chr6","83793801","83794104","chr2B","27941939","27942225","61","55851862"
"chr6","83812150","83812277","chr6","154239364","154239482","33","70427214"
"chr6","83878582","83878771","chr5","138601606","138601800","46","54723024"
"chr6","83926178","83926473","chr2B","27807296","27807588","34","56118882"
"chr6","83955569","83955707","chr1","21701601","21701750","40","62253968"
"chr6","83977341","83977614","chr19","13663933","13664211","59","70313408"
"chr6","83994274","83994395","chr11","92397185","92397307","24","8402911"
"chr6","83997737","83997852","chr2B","27762790","27762909","15","56234947"
"chr6","84040783","84040890","chr5","14822723","14822826","31","69218060"
"chr6","84046775","84046900","chr7","140174758","140174882","15","56127983"
"chr6","84093344","84093635","chr2B","27708601","27708901","47","56384743"
"chr6","84101476","84101754","chr2B","27699135","27699431","40","56402341"
"chr6","84133584","84133863","chr2A","41686413","41686698","67","42447171"
"chr6","84153649","84153932","chr11","25798337","25798635","74","58355312"
"chr6","84247816","84248090","chr3","127356553","127356832","74","43108737"
"chr6","84256874","84257160","chr2B","27649191","27649476","30","56607683"
"chr6","84265614","84265741","chr4","88581201","88581319","39","4315587"
"chr6","84372740","84373037","chr2B","27525982","27526276","46","56846758"
"chr6","84413910","84414187","chr12","103786305","103786586","59","19372395"
"chr6","84432355","84432473","chr14","42901407","42901528","21","41530948"
"chr6","84436035","84436184","chr7","28901497","28901635","40","55534538"
"chr6","84443117","84443419","chr2B","27462162","27462466","42","56980955"
"chr6","84466475","84466750","chr2B","27433656","27433936","44","57032819"
"chr6","84539254","84539543","chr2B","27361573","27361859","33","57177681"
"chr6","84540723","84540937","chr16","41676490","41676700","40","42864233"
"chr6","84588205","84588514","chr9","93938129","93938436","79","9349924"
"chr6","84593317","84593614","chr3","145246806","145247099","59","60653489"
"chr6","84606416","84606712","chr3","34329169","34329465","67","50277247"
"chr6","84646368","84646656","chrX","15190100","15190391","57","69456268"
"chr6","84661250","84661367","chr11","72628294","72628415","28","12032956"
"chr6","84666745","84666898","chr11","65955607","65955759","29","18711138"
"chr6","84678802","84678949","chr2B","27215557","27215713","22","57463245"
"chr6","84801102","84801382","chr2B","27095229","27095540","53","57705873"
"chr6","84819415","84819626","chr2B","27076214","27076420","41","57743201"
"chr6","84823504","84823801","chr2B","27067188","27067486","50","57756316"
"chr6","84850908","84851107","chr13","31758150","31758354","44","53092758"
"chr6","84852342","84852595","chr2B","25803853","25804105","52","59048489"
"chr6","84883230","84883297","chr2B","26999587","26999646","15","57883643"
"chr6","84928563","84928851","chr2B","26971937","26972228","40","57956626"
"chr6","84935106","84935331","chr2B","26965534","26965758","30","57969572"
"chr6","84959751","84960050","chr19","39375180","39375480","60","45584571"
"chr6","84963545","84963781","chr2B","26935842","26936078","22","58027703"
"chr6","84967965","84968020","chr2B","26931720","26931778","9","58036245"
"chr6","84968193","84968274","chrX","15596602","15596685","16","69371591"
"chr6","84970726","84970880","chr17","40760521","40760674","38","44210205"
"chr6","84984373","84984413","chr6","91664857","91664899","9","6680484"
"chr6","84984864","84985010","chr18","18262050","18262192","33","66722814"
"chr6","84986895","84987113","chr2B","26913709","26913931","25","58073186"
"chr6","84991260","84991566","chr2B","26908318","26908614","46","58082942"
"chr6","85073645","85073911","chr2B","26840227","26840516","55","58233418"
"chr6","85086056","85086357","chr2B","26826864","26827156","66","58259192"
"chr6","85144642","85144938","chr2B","26783245","26783536","32","58361397"
"chr6","85189072","85189355","chr2B","26738284","26738572","33","58450788"
"chr6","85206858","85206989","chr9","91735632","91735761","21","6528774"
"chr6","85331693","85331926","chr12","121099679","121099914","71","35767986"
"chr6","85339275","85339433","chr10","84917452","84917614","32","421823"
"chr6","85344501","85344723","chr2B","26580288","26580521","52","58764213"
"chr6","85443715","85443990","chr2B","26484588","26484874","39","58959127"
"chr6","85532977","85533275","chr2B","26398782","26399062","63","59134195"
"chr6","85581727","85582035","chr2B","26349519","26349796","62","59232208"
"chr6","85620556","85620718","chr3","186900912","186901083","36","101280356"
"chr6","85663300","85663597","chr2B","26267073","26267375","34","59396227"
"chr6","85742588","85742911","chr4","195263548","195263867","77","109520960"
"chr6","85799574","85799671","chrX","41993891","41993987","22","43805683"
"chr6","85862794","85862917","chr8","103799790","103799921","36","17936996"
"chr6","85888876","85889133","chr3","49458676","49458931","65","36430200"
"chr6","85906524","85906816","chr15","27016651","27016946","73","58889873"
"chr6","85942089","85942327","chr2B","25991135","25991370","23","59950954"
"chr6","85988440","85988644","chr1","219927830","219928035","43","133939390"
"chr6","86024637","86024924","chr2B","25911496","25911782","37","60113141"
"chr6","86122687","86122920","chr2B","25803853","25804105","41","60318834"
"chr6","86146347","86146633","chr2B","25780622","25780916","42","60365725"
"chr6","86351301","86351530","chr19","40602950","40603177","60","45748351"
"chr6","86438265","86438519","chr2B","25491560","25491805","48","60946705"
"chr6","86503947","86504208","chr3","70327034","70327296","55","16176913"
"chr6","86527841","86527944","chr2B","25396862","25396965","18","61130979"
"chr6","86632218","86632521","chr2B","25295928","25296210","44","61336290"
"chr6","86657331","86657643","chr2B","25268238","25268541","51","61389093"
"chr6","86774199","86774491","chr1","8662510","8662801","59","78111689"
"chr6","86895749","86896021","chr14","22175096","22175370","60","64720653"
"chr6","86937245","86937545","chr7","68315081","68315385","82","18622164"
"chr6","87006760","87007024","chr2A","96269120","96269376","70","9262360"
"chr6","87113078","87113332","chr2B","24800912","24801147","55","62312166"
"chr6","87167246","87167504","chr12","112234709","112234982","69","25067463"
"chr6","87372020","87372317","chr2B","24552510","24552800","60","62819510"
"chr6","87437844","87438109","chr2B","24492393","24492684","68","62945451"
"chr6","87454620","87454782","chr2B","24473845","24474015","29","62980775"
"chr6","87579906","87580057","chr13","5474254","5474413","40","82105652"
"chr6","87633656","87633969","chr2B","24297213","24297533","40","63336443"
"chr6","87655274","87655583","chr12","43802996","43803296","68","43852278"
"chr6","87686249","87686518","chr1","96306179","96306450","57","8619930"
"chr6","87696976","87697292","chr3","160056592","160056894","74","72359616"
"chr6","87739179","87739411","chr7","71812434","71812663","64","15926745"
"chr6","87746877","87747186","chr2B","2231567","2231868","41","85515310"
"chr6","87761679","87761949","chrX","49580978","49581241","60","38180701"
"chr6","87808696","87808985","chr2B","2449620","2449942","67","85359076"
"chr6","87818419","87818696","chr16","44950318","44950595","68","42868101"
"chr6","87862861","87863035","chr15","54090541","54090701","54","33772320"
"chr6","87879520","87879805","chr2B","2508931","2509233","60","85370589"
"chr6","87930358","87930554","chr4","195424098","195424294","47","107493740"
"chr6","87991239","87991530","chr2B","2597911","2598191","53","85393328"
"chr6","88071524","88071606","chr16","30080894","30080974","21","57990630"
"chr6","88071903","88072065","chr12","19312537","19312701","31","68759366"
"chr6","88103497","88103743","chr7","29622332","29622582","65","58481165"
"chr6","88399315","88399619","chr8","98967491","98967789","65","10568176"
"chr6","88620307","88620635","chr11","47195271","47195589","85","41425036"
"chr6","88885717","88885827","chr13","9559854","9559959","27","79325863"
"chr6","88887577","88887847","chr2B","3465112","3465371","44","85422465"
"chr6","88982818","88982940","chr14","50725807","50725931","31","38257011"
"chr6","89157264","89157547","chr2B","3745539","3745854","69","85411725"
"chr6","89189048","89189211","chr16","30763457","30763624","37","58425591"
"chr6","89273461","89273587","chr2B","3859236","3859359","17","85414225"
"chr6","89290931","89291067","chr2B","3877502","3877626","30","85413429"
"chr6","89329068","89329310","chr14","1576094","1576344","66","87752974"
"chr6","89382976","89383273","chr2B","3968564","3968862","37","85414412"
"chr6","89582988","89583303","chr2B","4161460","4161765","56","85421528"
"chr6","89592085","89592389","chr11","8439634","8439929","72","81152451"
"chr6","89649678","89649968","chr2B","4306932","4307237","45","85342746"
"chr6","89741592","89741877","chr2B","4415327","4415604","51","85326265"
"chr6","89771694","89771829","chr2B","4445211","4445344","14","85326483"
"chr6","90090622","90090918","chr2B","4764723","4765006","47","85325899"
"chr6","90149194","90149306","chr1","103455628","103455743","22","13306434"
"chr6","90449436","90449575","chrX","2794957","2795096","28","87654479"
"chr6","90534058","90534338","chr2B","5204178","5204456","41","85329880"
"chr6","90842216","90842334","chr16","19747838","19747947","33","71094378"
"chr6","90946200","90946365","chr12","8768282","8768448","41","82177918"
"chr6","90975468","90975624","chr7","79271528","79271684","44","11703940"
"chr6","91023135","91023343","chr16","61601257","61601482","54","29421878"
"chr6","91107041","91107252","chr11","117356871","117357084","47","26249830"
"chr6","91124285","91124543","chr2B","5760632","5760907","47","85363653"
"chr6","91183315","91183607","chr2B","5811516","5811804","45","85371799"
"chr6","91406874","91407156","chr2B","6033041","6033318","45","85373833"
"chr6","91575392","91575599","chr2B","6210870","6211086","46","85364522"
"chr6","91819746","91819886","chr12","59073410","59073552","32","32746336"
"chr6","91821636","91821930","chr2B","6483519","6483816","47","85338117"
"chr6","91827872","91828122","chr2B","6489772","6490027","29","85338100"
"chr6","91883092","91883326","chr11","96274927","96275159","64","4391835"
"chr6","91939994","91940117","chr10","116720048","116720171","18","24780054"
"chr6","91986906","91987214","chr2B","6674327","6674623","52","85312579"
"chr6","92027921","92028210","chr2B","6709689","6709991","52","85318232"
"chr6","92059603","92059879","chr2B","6732354","6732625","29","85327249"
"chr6","92106961","92107248","chr2B","6776808","6777094","37","85330153"
"chr6","92162935","92163137","chr2B","6832226","6832439","27","85330709"
"chr6","92250244","92250501","chr2B","6924700","6924959","37","85325544"
"chr6","92307706","92307860","chr1","110561686","110561849","42","18253980"
"chr6","92392332","92392445","chr2B","7048033","7048147","10","85344299"
"chr6","92460312","92460603","chr2B","7109680","7109968","38","85350632"
"chr6","92486923","92487197","chr2B","7138756","7139053","56","85348167"
"chr6","92489186","92489309","chr2B","7141038","7141162","14","85348148"
"chr6","92489777","92490080","chr2B","7141658","7141930","66","85348119"
"chr6","92687751","92688033","chr2B","7372197","7372481","40","85315554"
"chr6","92692841","92693127","chr2B","7377071","7377344","53","85315770"
"chr6","92700324","92700632","chr2B","7383941","7384246","52","85316383"
"chr6","92792022","92792152","chr9","113284887","113285018","39","20492865"
"chr6","92975721","92976013","chr2B","7709587","7709880","59","85266134"
"chr6","93149714","93149838","chr2B","7890591","7890716","18","85259123"
"chr6","93202929","93203030","chr7","106461202","106461303","21","13258273"
"chr6","93226104","93226284","chr6","36413281","36413458","42","56812823"
"chr6","93226733","93226850","chr16","65541536","65541653","27","27685197"
"chr6","93242934","93243045","chrX","136750413","136750529","22","43507479"
"chr6","93258020","93258097","chr2B","57729158","57729236","15","35528862"
"chr6","93264945","93265101","chr1","68709407","68709549","42","24555538"
"chr6","93297882","93298185","chr5","156113192","156113493","67","62815310"
"chr6","93324454","93324748","chr2B","8083602","8083896","42","85240852"
"chr6","93325334","93325635","chr2B","8084460","8084742","44","85240874"
"chr6","93326333","93326630","chr2B","117896887","117897188","55","24570554"
"chr6","93331478","93331762","chr2B","8092772","8093078","64","85238706"
"chr6","93360969","93361092","chr2B","8123364","8123486","13","85237605"
"chr6","93386791","93387098","chr2B","8148683","8148984","41","85238108"
"chr6","93437637","93437923","chr12","105166526","105166817","52","11728889"
"chr6","93437935","93438048","chr5","79787865","79787982","23","13650070"
"chr6","93438977","93439070","chr18","48326419","48326520","24","45112558"
"chr6","93439339","93439444","chr11","67337030","67337134","23","26102309"
"chr6","93442306","93442593","chr1","227415933","227416230","63","133973627"
"chr6","93456221","93456512","chr2B","8211561","8211852","41","85244660"
"chr6","93464319","93464605","chr2B","8217070","8217366","49","85247249"
"chr6","93477716","93477873","chr10","49585047","49585201","30","43892669"
"chr6","93478485","93478793","chr2B","8231159","8231477","50","85247326"
"chr6","93552501","93552658","chr5","62837108","62837270","31","30715393"
"chr6","93574635","93574939","chr2B","117896887","117897188","58","24322252"
"chr6","93599102","93599403","chr2B","8356563","8356856","38","85242539"
"chr6","93599658","93599750","chr14","5148975","5149063","21","88450683"
"chr6","93606025","93606345","chr2B","8362569","8362873","44","85243456"
"chr6","93642877","93643171","chr2B","8399327","8399620","33","85243550"
"chr6","93697836","93698151","chr2B","8457703","8457969","86","85240133"
"chr6","93698285","93698402","chr2B","8458103","8458220","11","85240182"
"chr6","93764773","93765065","chr2B","8529839","8530132","26","85234934"
"chr6","93766640","93766934","chr2B","8531383","8531684","32","85235257"
"chr6","93772391","93772683","chr2B","8539072","8539372","55","85233319"
"chr6","93774380","93774691","chr2B","8541383","8541695","48","85232997"
"chr6","93780883","93781193","chr2B","8548014","8548319","31","85232869"
"chr6","93839588","93839842","chr3","183887786","183888038","71","90048198"
"chr6","93872039","93872133","chr9","108579895","108579992","19","14707856"
"chr6","93873675","93873954","chr2B","8639247","8639546","66","85234428"
"chr6","93956439","93956735","chr2B","8708257","8708569","55","85248182"
"chr6","93971238","93971528","chr3","59339623","59339913","73","34631615"
"chr6","93981390","93981689","chr2B","8731237","8731550","43","85250153"
"chr6","94006352","94006570","chr2B","8755640","8755858","30","85250712"
"chr6","94012903","94013188","chr2B","8764817","8765102","39","85248086"
"chr6","94022149","94022246","chr16","30080894","30080974","32","63941255"
"chr6","94040507","94040798","chr2B","8790462","8790751","24","85250045"
"chr6","94053435","94053715","chr2B","8803545","8803843","55","85249890"
"chr6","94064362","94064689","chr1","164614156","164614483","58","70549794"
"chr6","94083560","94083675","chr2B","8830518","8830629","12","85253042"
"chr6","94083882","94084101","chr4","39526349","39526560","55","54557533"
"chr6","94097079","94097347","chr2B","8843424","8843692","42","85253655"
"chr6","94102398","94102520","chr14","57284832","57284954","20","36817566"
"chr6","94113490","94113788","chr2B","8859001","8859299","50","85254489"
"chr6","94118989","94119272","chr20","45856042","45856327","59","48262947"
"chr6","94121578","94121864","chr2B","8880666","8880947","45","85240912"
"chr6","94142329","94142608","chr11","113401179","113401455","54","19258850"
"chr6","94149610","94149858","chr16","31649333","31649595","58","62500277"
"chr6","94209159","94209451","chr2B","8958379","8958650","51","85250780"
"chr6","94215469","94215538","chr6","42805373","42805434","21","51410096"
"chr6","94216732","94217038","chr2B","8974937","8975217","62","85241795"
"chr6","94217414","94217685","chr2B","8975642","8975921","48","85241772"
"chr6","94251858","94251991","chrX","2794957","2795096","36","91456901"
"chr6","94320866","94321157","chr19","56600116","56600403","58","37720750"
"chr6","94386970","94387244","chr2B","9130073","9130360","44","85256897"
"chr6","94563201","94563484","chr2B","9306771","9307073","47","85256430"
"chr6","94591505","94591675","chr12","19312537","19312701","30","75278968"
"chr6","94622957","94623250","chr2B","9361573","9361866","25","85261384"
"chr6","94633242","94633326","chr2B","9371450","9371533","10","85261792"
"chr6","94724012","94724280","chr10","86440089","86440353","55","8283923"
"chr6","94726007","94726288","chr12","32535184","32535454","69","62190823"
"chr6","94749215","94749273","chr15","42731833","42731894","21","52017382"
"chr6","94749391","94749578","chr2B","9489455","9489640","19","85259936"
"chr6","94755394","94755517","chr2A","82138107","82138230","16","12617287"
"chr6","94796268","94796384","chr5","44710296","44710425","22","50085972"
"chr6","94817786","94817900","chr6","20880454","20880561","23","73937332"
"chr6","94868698","94868857","chr7","56771797","56771964","40","38096901"
"chr6","95091904","95092250","chr11","125580046","125580365","87","30488142"
"chr6","95094523","95094833","chr8","21674936","21675235","63","73419587"
"chr6","95106283","95106551","chr6","77896032","77896299","53","17210251"
"chr6","95170807","95171112","chr2B","9901840","9902137","58","85268967"
"chr6","95177111","95177382","chr2B","9908639","9908900","36","85268472"
"chr6","95177465","95177732","chr2B","66491682","66491960","57","28685783"
"chr6","95208058","95208360","chr2B","9939580","9939894","48","85268478"
"chr6","95355253","95355362","chr3","182376414","182376521","38","87021161"
"chr6","95372986","95373229","chr2B","10085072","10085286","54","85287914"
"chr6","95373422","95373594","chr8","140832015","140832188","36","45458593"
"chr6","95400102","95400170","chr2B","10110135","10110203","4","85289967"
"chr6","95415998","95416313","chr7","57543825","57544133","64","37872173"
"chr6","95423970","95424277","chr2B","10136931","10137215","56","85287039"
"chr6","95434439","95434558","chr7","26158438","26158564","30","69276001"
"chr6","95447023","95447318","chr2B","10170595","10170896","30","85276428"
"chr6","95454940","95455179","chr2B","10178927","10179182","34","85276013"
"chr6","95510559","95510725","chr14","12358649","12358814","33","83151910"
"chr6","95541046","95541252","chr3","46423650","46423852","52","49117396"
"chr6","95556847","95557143","chr2A","6168777","6169080","74","89388070"
"chr6","95559420","95559669","chr2B","10305870","10306134","44","85253550"
"chr6","95573467","95573749","chr2B","10321305","10321581","33","85252162"
"chr6","95635289","95635442","chr5","156787834","156787995","34","61152545"
"chr6","95730801","95730917","chr14","42586382","42586501","17","53144419"
"chr6","95741199","95741482","chr2B","10486679","10486966","33","85254520"
"chr6","95814431","95814733","chr1","45473217","45473515","59","50341214"
"chr6","95829129","95829307","chr3","50286714","50286893","39","45542415"
"chr6","95839489","95839791","chr1","45032090","45032394","62","50807399"
"chr6","95845688","95845974","chr2B","10636192","10636502","62","85209496"
"chr6","95907307","95907579","chr7","128707384","128707662","57","32800077"
"chr6","96079898","96080011","chr3","65193379","65193500","19","30886519"
"chr6","96119514","96119817","chr2B","10913024","10913315","42","85206490"
"chr6","96305472","96305774","chr2B","11099957","11100251","50","85205515"
"chr6","96373436","96373753","chr3","143837811","143838095","93","47464375"
"chr6","96504724","96505020","chr2B","11268806","11269107","41","85235918"
"chr6","96800190","96800302","chr4","181853095","181853207","19","85052905"
"chr6","96973239","96973322","chr12","5652902","5652983","15","91320337"
"chr6","97139478","97139771","chr2B","11873934","11874230","45","85265544"
"chr6","97322193","97322479","chr2B","12053334","12053623","46","85268859"
"chr6","97346096","97346371","chr1","206484326","206484603","75","109138230"
"chr6","97617062","97617186","chr12","69436089","69436209","18","28180973"
"chr6","97719108","97719379","chrX","70153201","70153486","68","27565907"
"chr6","97760350","97760644","chr2B","12496169","12496477","53","85264181"
"chr6","97956388","97956666","chr2B","12683360","12683623","57","85273028"
"chr6","97991022","97991147","chr5","138503463","138503586","21","40512441"
"chr6","98007597","98007680","chr7","137363140","137363222","21","39355543"
"chr6","98064474","98064760","chr2B","12789675","12789967","51","85274799"
"chr6","98076194","98076512","chr2B","12801411","12801722","43","85274783"
"chr6","98112360","98112674","chr17","3743215","3743513","65","94369145"
"chr6","98177828","98177950","chr3","65193379","65193500","28","32984449"
"chr6","98295340","98295629","chr2B","13041557","13041846","55","85253783"
"chr6","98309580","98309853","chr4","87028127","87028413","63","11281453"
"chr6","98332597","98332712","chr8","79737740","79737854","28","18594857"
"chr6","98333178","98333475","chr9","12489488","12489782","68","85843690"
"chr6","98352054","98352334","chr10","91071626","91071907","69","7280428"
"chr6","98362602","98362883","chr2B","13111750","13112038","42","85250852"
"chr6","98386356","98386480","chr15","14923196","14923316","31","83463160"
"chr6","98386613","98386746","chr1","205945800","205945944","41","107559187"
"chr6","98403696","98403927","chr2B","13165520","13165756","36","85238176"
"chr6","98437421","98437707","chr2B","13189740","13190020","43","85247681"
"chr6","98494958","98495096","chr12","94617715","94617852","32","3877243"
"chr6","98606042","98606323","chr2B","13357413","13357716","70","85248629"
"chr6","98660447","98660746","chr19","15981823","15982127","68","82678624"
"chr6","98666956","98667216","chr2B","13434233","13434494","58","85232723"
"chr6","98703155","98703440","chr2B","13470674","13470950","53","85232481"
"chr6","98714720","98714826","chr2A","10266630","10266736","29","88448090"
"chr6","98872937","98873201","chr2B","13640790","13641030","58","85232147"
"chr6","99021744","99022045","chr2B","13779052","13779364","44","85242692"
"chr6","99027778","99028061","chr7","138250606","138250896","66","39222828"
"chr6","99103813","99104078","chr2B","13873637","13873911","47","85230176"
"chr6","99347451","99347756","chr2B","14101676","14101972","53","85245775"
"chr6","99461973","99462094","chr2B","14211337","14211457","13","85250636"
"chr6","99576239","99576526","chr2B","14319180","14319465","33","85257059"
"chr6","99602959","99603229","chr2B","14342190","14342475","46","85260769"
"chr6","99819688","99820004","chr8","25123254","25123565","75","74696434"
"chr6","99858459","99858725","chr1","191202899","191203180","73","91344440"
"chr6","99911647","99911786","chr3","199463674","199463811","31","99552027"
"chr6","100119219","100119517","chr13","93483410","93483719","69","6635809"
"chr6","100369785","100370061","chr2B","15114682","15114970","44","85255103"
"chr6","100380531","100380806","chr20","17791358","17791638","64","82589173"
"chr6","100495333","100495602","chr2B","15227613","15227879","41","85267720"
"chr6","100578890","100579161","chr2B","15318872","15319154","44","85260018"
"chr6","100675694","100675995","chr2B","15404998","15405306","38","85270696"
"chr6","100709316","100709423","chr5","14822723","14822826","28","85886593"
"chr6","101225139","101225457","chr1","150808926","150809223","79","49583787"
"chr6","101228255","101228497","chr16","24020613","24020850","68","77207642"
"chr6","101420424","101420706","chr2B","79094553","79094843","44","22325871"
"chr6","101425397","101425529","chrX","2794957","2795096","35","98630440"
"chr6","101514214","101514489","chr2B","79176629","79176927","52","22337585"
"chr6","101609915","101610204","chr2B","79267173","79267454","36","22342742"
"chr6","101622894","101623152","chr2B","79280275","79280557","54","22342619"
"chr6","101704970","101705074","chr7","69801927","69802033","30","31903043"
"chr6","101729059","101729173","chr10","113101714","113101829","21","11372655"
"chr6","101756970","101757082","chr1","197987006","197987122","20","96230036"
"chr6","101790133","101790214","chr11","9195342","9195424","29","92594791"
"chr6","101790713","101790916","chr11","8779959","8780165","40","93010754"
"chr6","101791471","101791747","chr2B","79443765","79444035","36","22347706"
"chr6","101815056","101815360","chr2B","79465086","79465376","64","22349970"
"chr6","101906820","101907102","chr2B","79543339","79543626","33","22363481"
"chr6","102024236","102024489","chr2B","79647289","79647560","38","22376947"
"chr6","102069374","102069684","chr2B","79693733","79694037","42","22375641"
"chr6","102148680","102148794","chr16","28244621","28244735","32","73904059"
"chr6","102495843","102496128","chr2B","80052614","80052912","53","22443229"
"chr6","102542782","102543051","chr2B","80094049","80094333","63","22448733"
"chr6","102557605","102557931","chr2B","80110188","80110499","49","22447417"
"chr6","102639608","102639876","chr2B","80194502","80194764","57","22445106"
"chr6","102823680","102823841","chr3","184741818","184741981","39","81918138"
"chr6","102871055","102871123","chr11","20340853","20340926","14","82530202"
"chr6","102871814","102871982","chr16","17181767","17181934","31","85690047"
"chr6","102899107","102899223","chr8","86024536","86024652","22","16874571"
"chr6","102991215","102991514","chr16","23756696","23756999","66","79234519"
"chr6","103060604","103060884","chrX","118718918","118719200","66","15658314"
"chr6","103290770","103290894","chr10","86956281","86956404","21","16334489"
"chr6","103362266","103362389","chr2B","80960733","80960854","18","22401533"
"chr6","103373974","103374275","chr2B","80965809","80966112","58","22408165"
"chr6","103397563","103397839","chr7","5095566","5095848","73","98301997"
"chr6","103467370","103467687","chr2B","81022844","81023157","41","22444526"
"chr6","103559215","103559523","chr2B","81094859","81095191","58","22464356"
"chr6","103670499","103670628","chr14","22509224","22509352","23","81161275"
"chr6","104017095","104017277","chr12","33079914","33080093","47","70937181"
"chr6","104017799","104017921","chr5","80208930","80209053","21","23808869"
"chr6","104070583","104070833","chr2B","81515704","81515960","41","22554879"
"chr6","104077832","104078113","chr2B","81522184","81522493","57","22555648"
"chr6","104301816","104302100","chr2B","81787097","81787387","54","22514719"
"chr6","104339590","104339883","chr2B","81823418","81823722","40","22516172"
"chr6","104383099","104383377","chr2B","81862614","81862908","63","22520485"
"chr6","104416605","104416787","chr6","35277961","35278135","48","69138644"
"chr6","104472725","104472919","chr2B","81952310","81952504","23","22520415"
"chr6","104598238","104598397","chr21","34056187","34056352","37","70542051"
"chr6","104599320","104599609","chr2B","82127607","82127881","53","22471713"
"chr6","104622192","104622377","chr2B","82170206","82170404","27","22451986"
"chr6","104669053","104669169","chr6","28118840","28118957","19","76550213"
"chr6","104727071","104727359","chr2B","82271519","82271805","44","22455552"
"chr6","104900466","104900617","chr9","108232885","108233040","34","3332419"
"chr6","104917549","104917830","chr2B","82517345","82517613","54","22400204"
"chr6","104923709","104923830","chr8","143940123","143940247","23","39016414"
"chr6","104938689","104938963","chr2B","82538631","82538903","34","22400058"
"chr6","104943050","104943354","chr2B","82543032","82543344","54","22400018"
"chr6","104958202","104958281","chr4","182685766","182685841","21","77727564"
"chr6","105041069","105041201","chr19","37785588","37785721","24","67255481"
"chr6","105071023","105071057","chr13","61193681","61193715","5","43877342"
"chr6","105071159","105071413","chr15","67260007","67260256","58","37811152"
"chr6","105089376","105089664","chr2B","82676336","82676630","40","22413040"
"chr6","105338689","105338968","chr2B","82904313","82904598","54","22434376"
"chr6","105440526","105440823","chr14","89141565","89141868","68","16298961"
"chr6","105443399","105443686","chr2B","83007003","83007287","51","22436396"
"chr6","105480554","105480838","chr2B","83033468","83033745","53","22447086"
"chr6","105504905","105505199","chr2B","83055366","83055667","35","22449539"
"chr6","105563023","105563177","chr10","49585047","49585201","27","55977976"
"chr6","105579594","105579799","chr2B","83121432","83121638","15","22458162"
"chr6","105657257","105657474","chr2B","83192617","83192835","31","22464640"
"chr6","105768471","105768795","chr2B","83303040","83303339","58","22465431"
"chr6","105784172","105784331","chr19","7393399","7393567","33","98390773"
"chr6","105810284","105810560","chr2B","83337715","83338005","44","22472569"
"chr6","105830503","105830787","chr2B","83361545","83361835","31","22468958"
"chr6","105831145","105831407","chr2B","83354354","83354623","47","22476791"
"chr6","105912521","105912802","chr2B","83452727","83452999","43","22459794"
"chr6","105913878","105914054","chr1","25357047","25357228","46","80556831"
"chr6","106126732","106127021","chr2B","83658641","83658923","35","22468091"
"chr6","106226432","106226729","chr11","66882276","66882581","65","39344156"
"chr6","106303564","106303864","chr2B","83864460","83864763","56","22439104"
"chr6","106310699","106311001","chr2B","83871666","83871960","48","22439033"
"chr6","106445357","106445609","chr19","2464971","2465216","57","103980386"
"chr6","106491758","106492069","chr2B","83966344","83966662","51","22525414"
"chr6","106492653","106492952","chr12","32032110","32032393","66","74460543"
"chr6","106508836","106509143","chr2B","83977771","83978076","27","22531065"
"chr6","106510029","106510297","chr2B","83978657","83978928","39","22531372"
"chr6","106523505","106523815","chr2B","83992100","83992385","46","22531405"
"chr6","106546775","106547050","chr2B","84013690","84013973","55","22533085"
"chr6","106793711","106793827","chr2B","84261119","84261234","11","22532592"
"chr6","106871243","106871337","chr11","61985367","61985463","19","44885876"
"chr6","106885962","106886274","chr2B","84341086","84341399","47","22544876"
"chr6","106893792","106893919","chr5","20960097","20960215","34","85933695"
"chr6","106998269","106998566","chr7","152763832","152764123","72","45765563"
"chr6","107024129","107024427","chr13","96074609","96074909","62","10949520"
"chr6","107279715","107279995","chr1","135651531","135651807","57","28371816"
"chr6","107386805","107387069","chr2B","84824894","84825168","43","22561911"
"chr6","107554230","107554532","chr1","191946453","191946748","82","84392223"
"chr6","107881953","107882229","chr2B","85365810","85366083","33","22516143"
"chr6","107922949","107923027","chr2B","85422986","85423064","13","22499963"
"chr6","107958312","107958606","chr2B","85450711","85450988","61","22507601"
"chr6","108017593","108017698","chr10","11937949","11938048","28","96079644"
"chr6","108144829","108145149","chr1","71143330","71143630","73","37001499"
"chr6","108314066","108314274","chrX","119761313","119761537","73","11447247"
"chr6","108356499","108356642","chr2B","85901322","85901467","20","22455177"
"chr6","108421803","108422052","chr2B","85958525","85958777","42","22463278"
"chr6","108482420","108482635","chr6","169957830","169958043","55","61475410"
"chr6","108555848","108556132","chr2B","86098588","86098879","48","22457260"
"chr6","108925118","108925461","chr12","2911061","2911378","86","106014057"
"chr6","108986128","108986426","chr19","43370774","43371068","69","65615354"
"chr6","109508246","109508536","chr2B","87035428","87035731","63","22472818"
"chr6","109925969","109926252","chr2B","87422432","87422741","63","22503537"
"chr6","110596635","110596936","chr2B","88105474","88105792","52","22491161"
"chr6","110765667","110765881","chr1","132634931","132635144","54","21869264"
"chr6","110766319","110766609","chr2B","88216410","88216703","37","22549909"
"chr6","110777904","110778138","chr19","46780007","46780236","54","63997897"
"chr6","110780840","110781095","chr1","43109070","43109335","58","67671770"
"chr6","110831125","110831316","chr7","79657650","79657818","65","31173475"
"chr6","110839517","110839738","chr7","71415299","71415523","44","39424218"
"chr6","110857455","110857566","chr6","162552382","162552495","27","51694927"
"chr6","110885861","110886160","chr6","20689530","20689838","61","90196331"
"chr6","110905977","110906274","chr5","163127440","163127745","67","52221463"
"chr6","110907523","110907790","chr16","25163413","25163683","59","85744110"
"chr6","110920383","110920653","chr2B","88385522","88385803","44","22534861"
"chr6","110926685","110926789","chr2B","88390704","88390808","11","22535981"
"chr6","110934094","110934387","chr6","91233977","91234263","56","19700117"
"chr6","110974847","110974964","chr9","92714929","92715046","23","18259918"
"chr6","111004971","111005060","chr1","225199355","225199447","17","114194384"
"chr6","111140026","111140188","chr3","50824399","50824571","34","60315627"
"chr6","111283103","111283280","chr2B","88710140","88710308","25","22572963"
"chr6","111364608","111364708","chr2B","88790467","88790569","9","22574141"
"chr6","111368554","111368860","chr2B","88795764","88796045","63","22572790"
"chr6","111399508","111399785","chr2B","88824299","88824615","62","22575209"
"chr6","111539575","111539692","chrX","151139490","151139606","37","39599915"
"chr6","111601811","111602091","chr2B","89022597","89022848","56","22579214"
"chr6","111639647","111639936","chr2B","89061312","89061607","56","22578335"
"chr6","111655494","111655771","chr2B","89076403","89076706","49","22579091"
"chr6","111676261","111676549","chr2B","89097222","89097512","43","22579039"
"chr6","111685169","111685324","chr2B","89111731","89111909","34","22573438"
"chr6","111700571","111700852","chr2B","89126009","89126290","29","22574562"
"chr6","111749025","111749306","chr4","181566992","181567266","59","69817967"
"chr6","111790815","111791100","chr2B","89207358","89207637","38","22583457"
"chr6","111812348","111812624","chr2B","89226694","89226982","47","22585654"
"chr6","111832412","111832715","chr15","67073000","67073294","72","44759412"
"chr6","111926594","111926736","chr3","155574758","155574899","30","43648164"
"chr6","112098569","112098865","chr2B","89497640","89497941","34","22600929"
"chr6","112122537","112122840","chr2B","69018244","69018548","66","43104293"
"chr6","112143667","112143939","chr2B","89546254","89546536","32","22597413"
"chr6","112162447","112162762","chr2B","69018244","69018548","69","43144203"
"chr6","112252195","112252486","chr6","172320100","172320391","56","60067905"
"chr6","112339040","112339195","chr14","72724722","72724884","34","39614318"
"chr6","112352811","112352934","chr2B","89756406","89756521","16","22596405"
"chr6","112366298","112366562","chr2B","89776401","89776687","45","22589897"
"chr6","112512024","112512282","chr4","74466295","74466566","58","38045729"
"chr6","112526453","112526699","chr2B","89912749","89912997","19","22613704"
"chr6","112576788","112577053","chrX","124100824","124101089","60","11524036"
"chr6","112647777","112648086","chr20","58447018","58447322","64","54200759"
"chr6","112670268","112670429","chr2B","90070583","90070747","30","22599685"
"chr6","112695239","112695527","chr2B","90098792","90099088","43","22596447"
"chr6","112721206","112721426","chr8","94564100","94564307","61","18157106"
"chr6","112758019","112758086","chr1","191065956","191066019","15","78307937"
"chr6","112768153","112768436","chr2B","90169516","90169825","58","22598637"
"chr6","112791532","112791727","chr3","50824399","50824571","51","61967133"
"chr6","112802976","112803266","chr2B","90202244","90202539","26","22600732"
"chr6","112827657","112827754","chr10","64539743","64539845","25","48287914"
"chr6","112828122","112828446","chr7","6629257","6629561","66","106198865"
"chr6","112838120","112838236","chr7","6379157","6379273","30","106458963"
"chr6","112846613","112846884","chr2B","90240891","90241144","50","22605722"
"chr6","112852256","112852535","chr2B","90246179","90246466","44","22606077"
"chr6","112905928","112906059","chr5","117656195","117656323","30","4750267"
"chr6","112926206","112926297","chr2B","90344015","90344105","7","22582191"
"chr6","112939165","112939478","chr2B","90356162","90356451","63","22583003"
"chr6","112949686","112949987","chr2B","90377280","90377582","34","22572406"
"chr6","112964030","112964114","chr2B","90391959","90392043","7","22572071"
"chr6","113190406","113190695","chr2B","90591172","90591479","52","22599234"
"chr6","113361043","113361365","chr2B","90749214","90749535","31","22611829"
"chr6","113404111","113404395","chr1","191934965","191935241","60","78530854"
"chr6","113483602","113483658","chr3","199690887","199690936","14","86207285"
"chr6","113521246","113521540","chr2B","90892832","90893128","32","22628414"
"chr6","113532679","113532976","chr2B","90932994","90933279","43","22599685"
"chr6","113596807","113597094","chr1","11272743","11273038","58","102324064"
"chr6","113631746","113632056","chr2B","91020836","91021149","44","22610910"
"chr6","113780614","113780763","chr7","28901497","28901635","43","84879117"
"chr6","113780975","113781050","chrX","123731937","123732007","20","9950962"
"chr6","113870604","113870883","chr2B","91270724","91271017","49","22599880"
"chr6","114060159","114060312","chr9","108241495","108241645","31","5818664"
"chr6","114226700","114226825","chr7","28901497","28901635","37","85325203"
"chr6","114234114","114234405","chr2A","3622725","3623014","62","110611389"
"chr6","114528331","114528631","chr2B","91967952","91968260","44","22560379"
"chr6","114544788","114544956","chr8","25551358","25551514","41","88993430"
"chr6","114549249","114549381","chr10","112111608","112111739","18","2437641"
"chr6","114774305","114774365","chr3","179324147","179324199","17","64549842"
"chr6","114774721","114774926","chr22","10087501","10087702","41","104687220"
"chr6","114914024","114914324","chr5","101875867","101876165","61","13038157"
"chr6","114926576","114926874","chr2B","92372801","92373101","45","22553775"
"chr6","114955822","114956004","chrX","133464486","133464660","45","18508664"
"chr6","115039072","115039218","chr2B","94897282","94897419","36","20141790"
"chr6","115119305","115119594","chr2B","92569650","92569947","36","22549655"
"chr6","115132586","115132900","chr2B","92583666","92583984","31","22548920"
"chr6","115158909","115159188","chr2B","92607880","92608168","42","22551029"
"chr6","115192201","115192489","chr2B","92632398","92632690","39","22559803"
"chr6","115202932","115203219","chr3","55136828","55137119","57","60066104"
"chr6","115221496","115221806","chr15","44244841","44245146","52","70976655"
"chr6","115236012","115236277","chr2B","92683162","92683434","54","22552850"
"chr6","115256875","115257038","chr9","109650705","109650871","32","5606170"
"chr6","115293482","115293770","chr2B","92739121","92739419","35","22554361"
"chr6","115336096","115336216","chr2B","92779898","92780024","19","22556198"
"chr6","115342940","115343234","chr2B","92785989","92786295","40","22556951"
"chr6","115474798","115474958","chr3","10866047","10866211","40","104608751"
"chr6","115542618","115542871","chr16","62323415","62323667","57","53219203"
"chr6","115551638","115551950","chr2B","92989183","92989489","42","22562455"
"chr6","115555982","115556319","chr6","37065469","37065795","76","78490513"
"chr6","115672967","115673293","chr7","4179063","4179350","92","111493904"
"chr6","115735461","115735760","chr12","117950588","117950884","62","2215127"
"chr6","115741664","115741949","chr2B","93176636","93176935","52","22565028"
"chr6","115743715","115744023","chr7","104210669","104210971","62","11533046"
"chr6","115761984","115762235","chr1","132810920","132811182","64","17048936"
"chr6","115763261","115763549","chr2B","93198440","93198732","36","22564821"
"chr6","115765144","115765372","chr2B","93200320","93200542","33","22564824"
"chr6","115779055","115779341","chr2B","93215226","93215514","33","22563829"
"chr6","115796214","115796505","chr5","7038183","7038487","66","108758031"
"chr6","115872932","115873247","chr2B","93294666","93294984","38","22578266"
"chr6","115896447","115896735","chr6","107357738","107358014","73","8538709"
"chr6","115946708","115947023","chr2A","21560596","21560907","58","94386112"
"chr6","115960627","115960753","chr1","33127782","33127915","26","82832845"
"chr6","115965472","115965613","chr2B","94897282","94897419","35","21068190"
"chr6","115972679","115972957","chr2B","93390163","93390435","39","22582516"
"chr6","115987933","115988064","chr5","33954553","33954683","17","82033380"
"chr6","116250329","116250617","chr2B","93522081","93522379","45","22728248"
"chr6","116292330","116292616","chrX","22016229","22016515","56","94276101"
"chr6","116301484","116301731","chr2B","93570654","93570896","32","22730830"
"chr6","116306636","116306923","chr2B","93575497","93575802","40","22731139"
"chr6","116311814","116311897","chr10","142430183","142430266","16","26118369"
"chr6","116326509","116326801","chrX","23853310","23853594","64","92473199"
"chr6","116335164","116335436","chr2B","93602362","93602609","64","22732802"
"chr6","116377379","116377652","chr16","15127181","15127441","62","101250198"
"chr6","116388607","116388797","chr11","47724944","47725127","46","68663663"
"chr6","116389504","116389762","chr21","8413468","8413714","58","107976036"
"chr6","116390128","116390352","chr2B","93647792","93648035","48","22742336"
"chr6","116394859","116395157","chr2B","93650076","93650395","45","22744783"
"chr6","116401159","116401461","chr2B","93658364","93658663","62","22742795"
"chr6","116425406","116425594","chr20","20726208","20726380","47","95699198"
"chr6","116431790","116432048","chr2B","93690419","93690642","61","22741371"
"chr6","116438032","116438310","chr2B","93700035","93700312","37","22737997"
"chr6","116448755","116449048","chrX","155309049","155309344","68","38860294"
"chr6","116457541","116457666","chr16","26009514","26009638","16","90448027"
"chr6","116460482","116460709","chr5","35605178","35605402","45","80855304"
"chr6","116475292","116475433","chr6","36782155","36782293","32","79693137"
"chr6","116478755","116479014","chr2B","93735096","93735348","36","22743659"
"chr6","116516662","116516964","chr2B","93770863","93771179","47","22745799"
"chr6","116519767","116520039","chr2B","93773134","93773435","58","22746633"
"chr6","116535535","116535692","chr2B","93794909","93795054","24","22740626"
"chr6","116558956","116559162","chr2B","93828601","93828791","37","22730355"
"chr6","116567589","116567704","chr14","10547372","10547486","15","106020217"
"chr6","116574968","116575158","chr2A","81940659","81940835","41","34634309"
"chr6","116590010","116590301","chr2B","93857183","93857469","44","22732827"
"chr6","116602507","116602619","chr11","75777947","75778069","30","40824560"
"chr6","116606071","116606191","chr2B","93880272","93880394","15","22725799"
"chr6","116606202","116606494","chr2B","93880405","93880696","30","22725797"
"chr6","116613372","116613495","chr20","43708602","43708725","14","72904770"
"chr6","116655921","116656169","chr16","77454385","77454635","59","39201536"
"chr6","116666330","116666459","chr1","181726088","181726220","21","65059758"
"chr6","116679215","116679331","chr5","117921987","117922110","23","1242772"
"chr6","116697441","116697729","chr4","71621571","71621860","53","45075870"
"chr6","116727259","116727413","chr7","6009067","6009222","36","110718192"
"chr6","116735499","116735636","chr7","56839310","56839440","35","59896189"
"chr6","116736281","116736418","chr7","56839310","56839440","36","59896971"
"chr6","116738656","116738778","chr2B","94003771","94003893","11","22734885"
"chr6","116770859","116771152","chr2B","94032478","94032756","58","22738381"
"chr6","116786038","116786292","chr2B","94047285","94047539","29","22738753"
"chr6","116815395","116815688","chr2B","94124412","94124732","57","22690983"
"chr6","116824247","116824484","chr2B","94131057","94131310","34","22693190"
"chr6","116843817","116844124","chr2B","94149037","94149344","42","22694780"
"chr6","116924907","116925159","chr2B","94243549","94243799","44","22681358"
"chr6","116936297","116936562","chr2B","94256636","94256913","53","22679661"
"chr6","117010079","117010360","chr2B","94298954","94299236","27","22711125"
"chr6","117138949","117139227","chr2B","94356375","94356666","41","22782574"
"chr6","117180521","117180806","chr19","7726876","7727158","59","109453645"
"chr6","117205010","117205307","chr13","24011815","24012110","63","93193195"
"chr6","117251428","117251710","chr2B","94455127","94455391","50","22796301"
"chr6","117283761","117284057","chr1","2285941","2286239","68","114997820"
"chr6","117335364","117335487","chr22","19703833","19703956","20","97631531"
"chr6","117381718","117382021","chr2B","94576056","94576350","57","22805662"
"chr6","117390609","117390911","chr2B","94602203","94602489","53","22788406"
"chr6","117393682","117393789","chr16","48023200","48023306","27","69370482"
"chr6","117395037","117395295","chr1","24015036","24015275","64","93380001"
"chr6","117417626","117417923","chr1","227415933","227416230","57","109998307"
"chr6","117418072","117418249","chr5","45101617","45101779","52","72316455"
"chr6","117429291","117429598","chr2B","94641432","94641716","54","22787859"
"chr6","117459271","117459577","chr2B","94670128","94670428","42","22789143"
"chr6","117461386","117461673","chr5","28375193","28375469","64","89086193"
"chr6","117490814","117491090","chr2B","94703471","94703768","55","22787343"
"chr6","117534999","117535267","chr14","86002350","86002625","61","31532649"
"chr6","117619698","117619997","chr2B","94860535","94860828","44","22759163"
"chr6","117645282","117645403","chr14","60352578","60352701","24","57292704"
"chr6","117657052","117657374","chr2B","94890759","94891069","52","22766293"
"chr6","117663248","117663408","chr1","76726531","76726685","36","40936717"
"chr6","117665789","117665924","chr3","125378751","125378875","31","7712962"
"chr6","117700762","117700912","chr20","34630612","34630758","27","83070150"
"chr6","117729694","117729971","chr2B","94955254","94955539","42","22774440"
"chr6","117758449","117758583","chr1","76318977","76319108","24","41439472"
"chr6","117778937","117779237","chr8","124654735","124655037","69","6875798"
"chr6","117789838","117790142","chr2B","95033577","95033882","27","22756261"
"chr6","117791971","117792275","chr15","56331570","56331864","66","61460401"
"chr6","117818665","117818883","chr15","62081683","62081895","53","55736982"
"chr6","117859892","117860011","chr2B","44396304","44396418","24","73463588"
"chr6","117862913","117863211","chr1","216269319","216269611","64","98406406"
"chr6","117867551","117867648","chr2B","95108840","95108937","14","22758711"
"chr6","117868560","117868758","chr1","146118969","146119169","47","28250409"
"chr6","117876416","117876583","chr12","19312537","19312701","29","98563879"
"chr6","117885854","117885947","chr1","46605351","46605452","27","71280503"
"chr6","117923478","117923764","chr10","84051532","84051832","68","33871946"
"chr6","117933104","117933392","chr2B","95178588","95178859","44","22754516"
"chr6","117945473","117945762","chr10","35965290","35965589","71","81980183"
"chr6","117946291","117946457","chr12","28339289","28339463","41","89607002"
"chr6","117999088","117999381","chr2B","95239161","95239446","49","22759927"
"chr6","118010655","118010944","chr2B","95256940","95257220","39","22753715"
"chr6","118025822","118025938","chr2B","95272131","95272248","17","22753691"
"chr6","118048841","118049109","chr1","114013856","114014132","63","4034985"
"chr6","118051406","118051696","chr7","6450288","6450581","65","111601118"
"chr6","118063886","118064162","chr5","8734711","8734988","55","109329175"
"chr6","118085883","118086130","chr2B","95339856","95340105","40","22746027"
"chr6","118112557","118112728","chr19","16879306","16879475","30","101233251"
"chr6","118139499","118139631","chr9","47369076","47369207","19","70770423"
"chr6","118142854","118143001","chr2B","95395161","95395321","31","22747693"
"chr6","118143396","118143522","chr5","4260884","4261008","16","113882512"
"chr6","118165140","118165274","chr2B","95416873","95417004","14","22748267"
"chr6","118174869","118175171","chr1","44240066","44240365","63","73934803"
"chr6","118184630","118184915","chr2B","95435326","95435606","62","22749304"
"chr6","118229524","118229620","chr5","34762289","34762384","18","83467235"
"chr6","118243893","118243967","chr12","118378111","118378184","13","134218"
"chr6","118250203","118250490","chr2B","95501836","95502131","41","22748367"
"chr6","118262665","118262784","chr1","208877943","208878070","31","90615278"
"chr6","118291764","118292067","chr2B","95550028","95550344","44","22741736"
"chr6","118313167","118313467","chr7","75653413","75653711","69","42659754"
"chr6","118318985","118319293","chr2B","95577135","95577443","52","22741850"
"chr6","118323810","118324094","chr2B","95588616","95588889","41","22735194"
"chr6","118332687","118332803","chr2B","95597592","95597708","14","22735095"
"chr6","118383099","118383371","chr2B","95647074","95647378","62","22736025"
"chr6","118391406","118391512","chr2B","95654297","95654403","12","22737109"
"chr6","118417632","118417926","chr7","6247668","6247965","51","112169964"
"chr6","118447519","118447798","chr2B","95725138","95725434","51","22722381"
"chr6","118452361","118452743","chr2A","60665985","60666356","115","57786376"
"chr6","118458474","118458734","chr2B","95737958","95738201","46","22720516"
"chr6","118489748","118490024","chr1","114123479","114123769","76","4366269"
"chr6","118497016","118497297","chr2B","95771808","95772106","43","22725208"
"chr6","118513400","118513698","chr2B","95789678","95789989","42","22723722"
"chr6","118553053","118553332","chr2B","95827233","95827529","54","22725820"
"chr6","118559492","118559804","chr12","108745776","108746083","63","9813716"
"chr6","118569981","118570211","chr19","3448555","3448794","80","115121426"
"chr6","118570229","118570365","chr19","47379993","47380130","26","71190236"
"chr6","118573855","118574129","chr5","11942013","11942283","56","106631842"
"chr6","118597757","118598029","chr2B","95852373","95852661","41","22745384"
"chr6","118603004","118603305","chr2B","95862681","95862989","52","22740323"
"chr6","118615213","118615266","chr8","129138659","129138712","12","10523446"
"chr6","118615358","118615522","chr6","162551622","162551785","33","43936264"
"chr6","118646055","118646151","chr5","109760403","109760503","22","8885652"
"chr6","118651845","118652079","chr2B","95913842","95914078","33","22738003"
"chr6","118658385","118658551","chr2B","95920916","95921060","34","22737469"
"chr6","118658947","118659049","chrX","3394860","3394959","19","115264087"
"chr6","118688916","118689211","chr2B","95959340","95959613","51","22729576"
"chr6","118690959","118691244","chr2B","95961627","95961886","50","22729332"
"chr6","118698016","118698325","chr2B","95967052","95967362","65","22730964"
"chr6","118726169","118726442","chr2B","95997002","95997281","45","22729167"
"chr6","118734992","118735177","chr2A","36118439","36118636","48","82616553"
"chr6","118735189","118735477","chr2B","96005491","96005788","34","22729698"
"chr6","118851950","118852170","chr5","91078187","91078414","60","27773763"
"chr6","118877822","118878110","chr4","40148289","40148579","52","78729533"
"chr6","118888912","118889201","chr16","16668818","16669101","57","102220094"
"chr6","119014937","119015210","chr2B","96098031","96098299","40","22916906"
"chr6","119018944","119019258","chr2B","96106466","96106778","34","22912478"
"chr6","119023201","119023252","chr11","110234618","110234667","20","8788583"
"chr6","119023862","119023975","chr10","17908348","17908458","23","101115514"
"chr6","119025320","119025581","chr2B","96114464","96114745","53","22910856"
"chr6","119041307","119041548","chr2B","96130655","96130913","60","22910652"
"chr6","119048662","119048951","chr2B","96137951","96138240","19","22910711"
"chr6","119070806","119071114","chr19","9960716","9961031","75","109110090"
"chr6","119116728","119117025","chr2B","96202709","96203010","35","22914019"
"chr6","119124132","119124428","chr2B","96209559","96209871","49","22914573"
"chr6","119130623","119130894","chr5","114943586","114943854","66","4187037"
"chr6","119135001","119135275","chr8","42194748","42195024","54","76940253"
"chr6","119138434","119138543","chr5","61088728","61088837","15","58049706"
"chr6","119146332","119146618","chr18","6182224","6182514","65","112964108"
"chr6","119192596","119192854","chr1","225620453","225620725","61","106427857"
"chr6","119221699","119221978","chr12","125129033","125129295","67","5907334"
"chr6","119326032","119326304","chr1","45746719","45746999","62","73579313"
"chr6","119366954","119367246","chr2B","96428457","96428766","50","22938497"
"chr6","119371794","119372145","chr6","35032995","35033331","96","84338799"
"chr6","119441908","119442202","chr2B","96494775","96495068","37","22947133"
"chr6","119447648","119447937","chr2B","96501010","96501330","67","22946638"
"chr6","119533575","119533690","chr14","86210901","86211013","26","33322674"
"chr6","119559048","119559347","chr2B","96627742","96628039","35","22931306"
"chr6","119593022","119593227","chr9","108840447","108840646","41","10752575"
"chr6","119602473","119602741","chr2B","96668886","96669169","57","22933587"
"chr6","119633874","119634004","chr1","27808249","27808381","21","91825625"
"chr6","119679980","119680284","chr2B","96736139","96736425","50","22943841"
"chr6","119768285","119768596","chr2B","96819667","96819983","35","22948618"
"chr6","119846189","119846320","chr15","57026888","57027018","20","62819301"
"chr6","119859266","119859415","chr1","148219593","148219735","36","28360327"
"chr6","119888114","119888237","chr3","188313519","188313645","17","68425405"
"chr6","119912406","119912523","chr2B","96955677","96955793","17","22956729"
"chr6","120182257","120182374","chr2B","97225681","97225797","16","22956576"
"chr6","120254750","120255037","chr2B","97289800","97290089","29","22964950"
"chr6","120395274","120395617","chr2B","97436491","97436804","70","22958783"
"chr6","120565737","120566015","chr2B","97591872","97592150","32","22973865"
"chr6","120608866","120609139","chr4","154749915","154750182","57","34141049"
"chr6","120646642","120646948","chr2B","97675476","97675777","31","22971166"
"chr6","121086526","121086684","chr15","67737918","67738076","30","53348608"
"chr6","121184306","121184446","chr1","37853089","37853228","34","83331217"
"chr6","121425722","121425970","chr7","149992360","149992606","50","28566638"
"chr6","121500001","121500067","chr5","39305022","39305085","20","82194979"
"chr6","121549925","121550237","chr2B","98578333","98578662","44","22971592"
"chr6","121788413","121788680","chr4","135434291","135434558","60","13645878"
"chr6","121799370","121799621","chr5","34192040","34192286","55","87607330"
"chr6","121801849","121802023","chr1","45825944","45826093","68","75975905"
"chr6","121826046","121826333","chr12","113271042","113271331","66","8555004"
"chr6","121840481","121840792","chr2B","98843601","98843913","34","22996880"
"chr6","121887002","121887315","chr11","117213354","117213666","57","4673648"
"chr6","121904279","121904400","chrX","53838248","53838371","17","68066031"
"chr6","121947874","121948049","chr16","44723366","44723534","32","77224508"
"chr6","121961373","121961647","chr2B","98972933","98973220","58","22988440"
"chr6","121967907","121968210","chr2B","98977660","98977965","35","22990247"
"chr6","122030138","122030409","chr17","90814261","90814538","69","31215877"
"chr6","122037538","122037792","chr3","152364414","152364685","76","30326876"
"chr6","122046708","122046974","chr2B","99061086","99061351","23","22985622"
"chr6","122053594","122053868","chr2B","87717629","87717905","30","34335965"
"chr6","122063737","122063836","chr18","48326419","48326520","26","73737318"
"chr6","122063849","122063979","chr10","35585006","35585133","19","86478843"
"chr6","122070676","122070796","chr7","64929838","64929961","30","57140838"
"chr6","122078249","122078534","chr2B","99088170","99088471","68","22990079"
"chr6","122084983","122085266","chr2B","99094960","99095248","64","22990023"
"chr6","122098749","122099030","chr2B","99110105","99110399","44","22988644"
"chr6","122124388","122124490","chr9","20620142","20620249","29","101504246"
"chr6","122145404","122145704","chr2B","99151631","99151918","41","22993773"
"chr6","122153653","122153813","chr19","18112321","18112488","32","104041332"
"chr6","122184068","122184250","chr1","152885383","152885548","46","30701315"
"chr6","122188552","122188852","chr19","5860383","5860693","62","116328169"
"chr6","122194024","122194340","chr2B","99198676","99198997","44","22995348"
"chr6","122198304","122198591","chr2B","99202980","99203265","40","22995324"
"chr6","122287349","122287644","chr2B","99259363","99259662","37","23027986"
"chr6","122373486","122373793","chr2B","99394694","99394996","41","22978792"
"chr6","122381883","122381990","chrX","77356626","77356736","19","45025257"
"chr6","122382118","122382410","chr12","121101371","121101664","60","1280747"
"chr6","122382957","122383251","chr8","24737260","24737543","62","97645697"
"chr6","122437142","122437448","chr2B","99459703","99460001","45","22977439"
"chr6","122458821","122459096","chrX","38718222","38718507","64","83740599"
"chr6","122463169","122463289","chr2A","42261370","42261491","28","80201799"
"chr6","122501817","122502064","chr2B","99527218","99527476","39","22974599"
"chr6","122569399","122569685","chr2B","99594510","99594800","36","22974889"
"chr6","122590768","122591081","chr2B","99614739","99615051","26","22976029"
"chr6","122597818","122598105","chr2B","99622447","99622739","42","22975371"
"chr6","122605165","122605443","chr2B","99629609","99629879","41","22975556"
"chr6","122627339","122627612","chr2B","99654769","99655067","52","22972570"
"chr6","122637839","122638137","chr2B","99665438","99665738","27","22972401"
"chr6","122714917","122715119","chr16","3730662","3730884","70","118984255"
"chr6","122740427","122740638","chr2B","99759911","99760135","39","22980516"
"chr6","122761034","122761159","chr2A","104115777","104115903","17","18645257"
"chr6","122806918","122807139","chr2A","63363949","63364173","56","59442969"
"chr6","122867829","122868118","chr2B","99882405","99882697","26","22985424"
"chr6","122891557","122891831","chr2B","99907371","99907647","32","22984186"
"chr6","122940738","122941017","chr2B","99967156","99967458","48","22973582"
"chr6","123003931","123004218","chr2B","100031891","100032180","57","22972040"
"chr6","123113087","123113210","chr2B","100140280","100140403","11","22972807"
"chr6","123117729","123117856","chr1","208877943","208878070","22","85760214"
"chr6","123118536","123118692","chr2B","100146166","100146337","33","22972370"
"chr6","123149372","123149505","chr3","51015997","51016148","35","72133375"
"chr6","123176886","123176961","chr12","123755259","123755337","17","578373"
"chr6","123199852","123199975","chr2B","100228303","100228432","18","22971549"
"chr6","123384384","123384670","chr2B","100380930","100381215","28","23003454"
"chr6","123386923","123387216","chr21","5131849","5132134","33","118255074"
"chr6","123436593","123436915","chr2B","100434917","100435210","57","23001676"
"chr6","123447113","123447405","chr20","32567324","32567616","60","90879789"
"chr6","123462071","123462375","chr2B","100461322","100461631","38","23000749"
"chr6","123532060","123532150","chr1","225199355","225199447","21","101667295"
"chr6","123553951","123554109","chr7","150496990","150497154","51","26943039"
"chr6","123571492","123571697","chr4","195424098","195424294","53","71852606"
"chr6","123572397","123572468","chr1","8477806","8477881","20","115094591"
"chr6","123591175","123591489","chr12","6311804","6312103","78","117279371"
"chr6","123596722","123596864","chr7","78925352","78925506","35","44671370"
"chr6","123631991","123632275","chr1","117204708","117204995","68","6427283"
"chr6","123639510","123639664","chr15","67981734","67981881","43","55657776"
"chr6","123641607","123641656","chr1","141406303","141406358","10","17764696"
"chr6","123642687","123642820","chr2A","38639830","38639956","30","85002857"
"chr6","123656846","123657009","chr5","2493450","2493615","36","121163396"
"chr6","123693796","123694004","chr8","94564100","94564307","49","29129696"
"chr6","123739717","123740022","chr2B","100737910","100738218","23","23001807"
"chr6","123787457","123787766","chr12","68549114","68549420","76","55238343"
"chr6","123819453","123819757","chr2B","100805586","100805892","28","23013867"
"chr6","123855163","123855460","chr1","46328376","46328673","57","77526787"
"chr6","123877500","123877683","chr4","94318314","94318473","60","29559186"
"chr6","123928365","123928657","chr2B","100903081","100903381","36","23025284"
"chr6","123951575","123951901","chr2B","100922014","100922324","52","23029561"
"chr6","123962047","123962352","chr2B","100932387","100932705","44","23029660"
"chr6","123976136","123976431","chr2B","100946845","100947138","27","23029291"
"chr6","124001228","124001537","chr1","45145246","45145545","56","78855982"
"chr6","124019788","124019917","chr1","215648878","215649005","40","91629090"
"chr6","124024517","124024824","chr2B","100992030","100992350","51","23032487"
"chr6","124033426","124033533","chr2B","101000571","101000685","20","23032855"
"chr6","124034761","124035101","chr2B","101001911","101002201","92","23032850"
"chr6","124041017","124041128","chr5","39965598","39965710","19","84075419"
"chr6","124065253","124065419","chr9","108496639","108496796","32","15568614"
"chr6","124089792","124089922","chr2B","101058317","101058447","24","23031475"
"chr6","124236422","124236720","chr2B","101233848","101234141","44","23002574"
"chr6","124248882","124249005","chr12","7736838","7736961","15","116512044"
"chr6","124259144","124259263","chr2B","101248954","101249071","16","23010190"
"chr6","124271071","124271194","chr1","146377235","146377358","18","22106164"
"chr6","124275580","124275699","chr17","84207985","84208106","21","40067595"
"chr6","124328571","124328696","chr10","125321257","125321383","20","992686"
"chr6","124462688","124462796","chr2B","101438124","101438234","14","23024564"
"chr6","124833252","124833397","chr6","53640252","53640396","36","71193000"
"chr6","124833536","124833644","chr5","39965598","39965710","28","84867938"
"chr6","125064125","125064427","chr16","38424670","38424983","67","86639455"
"chr6","125132003","125132132","chr3","9813170","9813295","26","115318833"
"chr6","125199165","125199480","chr8","34979801","34980095","82","90219364"
"chr6","125226431","125226724","chr1","68093289","68093580","55","57133142"
"chr6","125235411","125235695","chr2B","82418178","82418479","53","42817233"
"chr6","125367260","125367555","chr9","13891484","13891767","72","111475776"
"chr6","125376327","125376598","chr5","134748691","134748960","63","9372364"
"chr6","125376906","125377173","chr13","661838","662104","66","124715068"
"chr6","125377242","125377523","chr22","4029090","4029381","58","121348152"
"chr6","125378898","125379194","chr2B","23318716","23319018","43","102060182"
"chr6","125382169","125382458","chr2B","19150598","19150895","47","106231571"
"chr6","125389559","125389842","chr2B","19146814","19147093","52","106242745"
"chr6","125396500","125396647","chr5","42752401","42752550","27","82644099"
"chr6","125415747","125415859","chr9","115022881","115022992","20","10392866"
"chr6","125429834","125430111","chr15","41932193","41932466","72","83497641"
"chr6","125503515","125503793","chr7","1708256","1708538","60","123795259"
"chr6","125563852","125564066","chr6","38297871","38298088","67","87265981"
"chr6","125642303","125642610","chr2B","102499671","102499963","44","23142632"
"chr6","125695636","125695849","chr2B","102551645","102551858","25","23143991"
"chr6","125724874","125724990","chr6","110170153","110170268","21","15554721"
"chr6","125725085","125725214","chr6","44927054","44927185","31","80798031"
"chr6","125737268","125737480","chr2B","102599185","102599392","21","23138083"
"chr6","125765264","125765482","chr2B","102633052","102633273","24","23132212"
"chr6","125771452","125771741","chr2B","102614422","102614706","32","23157030"
"chr6","125778427","125778702","chr2B","102646720","102647008","51","23131707"
"chr6","125874029","125874328","chr2B","102742534","102742850","50","23131495"
"chr6","125983753","125984062","chr2B","102835853","102836172","51","23147900"
"chr6","126084017","126084140","chr19","14415022","14415148","19","111668995"
"chr6","126088175","126088480","chr6","4024318","4024614","71","122063857"
"chr6","126109235","126109424","chr7","6704986","6705176","44","119404249"
"chr6","126152942","126153049","chr18","59145471","59145580","23","67007471"
"chr6","126180128","126180423","chr2B","103034789","103035091","39","23145339"
"chr6","126359225","126359531","chr2B","103212280","103212589","36","23146945"
"chr6","126373184","126373315","chr3","15286672","15286801","28","111086512"
"chr6","126463576","126463857","chr2B","103299084","103299379","53","23164492"
"chr6","126856227","126856471","chr2B","103741462","103741730","51","23114765"
"chr6","127334702","127334817","chr12","75323667","75323785","19","52011035"
"chr6","127464325","127464626","chr2B","104383166","104383446","60","23081159"
"chr6","127574844","127574960","chrX","16504327","16504444","21","111070517"
"chr6","127858889","127859184","chr6","157988523","157988810","73","30129634"
"chr6","127990049","127990185","chr7","70286090","70286232","34","57703959"
"chr6","128079852","128080138","chr2B","105001526","105001826","46","23078326"
"chr6","128086665","128086858","chr10","107151481","107151676","62","20935184"
"chr6","128090516","128090659","chr7","150022744","150022888","36","21932228"
"chr6","128111697","128111974","chr2B","105029724","105030005","47","23081973"
"chr6","128196733","128197007","chr16","58177781","58178050","68","70018952"
"chr6","128201792","128202068","chr5","71066617","71066897","68","57135175"
"chr6","128245780","128245976","chr10","113204015","113204227","57","15041765"
"chr6","128250014","128250310","chr2B","105160617","105160904","52","23089397"
"chr6","128277631","128277685","chr6","116360538","116360594","13","11917093"
"chr6","128298194","128298483","chr2A","97057312","97057598","62","31240882"
"chr6","128405795","128406088","chr2B","105325433","105325733","42","23080362"
"chr6","128590253","128590348","chr8","103440748","103440839","26","25149505"
"chr6","128732031","128732155","chr2B","105669432","105669556","10","23062599"
"chr6","128771384","128771669","chr5","23224646","23224936","60","105546738"
"chr6","128866734","128866820","chr2B","105789419","105789512","17","23077315"
"chr6","128883495","128883797","chr2B","105803791","105804103","49","23079704"
"chr6","129244013","129244302","chr2B","106165262","106165550","31","23078751"
"chr6","129292107","129292404","chr2B","106208641","106208949","59","23083466"
"chr6","129325877","129325973","chr14","60630991","60631086","27","68694886"
"chr6","129436879","129437215","chr2B","106361262","106361586","47","23075617"
"chr6","129450696","129450994","chr2B","106376859","106377166","52","23073837"
"chr6","129514319","129514622","chr2B","106435507","106435825","53","23078812"
"chr6","129826701","129827009","chr8","83518472","83518762","76","46308229"
"chr6","129846913","129847222","chr4","151683453","151683753","70","21836540"
"chr6","130036920","130037021","chr19","14292883","14292994","27","115744037"
"chr6","130266231","130266353","chr3","127021132","127021256","21","3245099"
"chr6","130418176","130418451","chr12","121277290","121277570","63","9140886"
"chr6","130522129","130522408","chr2B","107351479","107351760","49","23170650"
"chr6","130589452","130589746","chr2B","107428126","107428408","51","23161326"
"chr6","130709864","130710133","chr14","76398517","76398786","62","54311347"
"chr6","130946090","130946349","chr2B","107738297","107738591","72","23207793"
"chr6","130962759","130963036","chr2B","107758970","107759253","46","23203789"
"chr6","130980481","130980705","chr6","146361614","146361839","52","15381133"
"chr6","131064164","131064443","chr2B","107863822","107864100","31","23200342"
"chr6","131130391","131130587","chr2B","107927029","107927228","26","23203362"
"chr6","131138766","131139040","chr2B","107937190","107937479","48","23201576"
"chr6","131155831","131156123","chr2B","107951160","107951462","49","23204671"
"chr6","131196134","131196433","chr2B","107994552","107994855","40","23201582"
"chr6","131233246","131233552","chr2B","108034410","108034718","35","23198836"
"chr6","131258629","131258918","chr2B","108060318","108060608","35","23198311"
"chr6","131433907","131434128","chrX","25240126","25240343","51","106193781"
"chr6","131596318","131596548","chr2B","108382965","108383227","54","23213353"
"chr6","131597100","131597355","chr6","132517914","132518162","87","920814"
"chr6","131620758","131620911","chr14","58729205","58729349","39","72891553"
"chr6","131621308","131621476","chr2B","108415433","108415606","25","23205875"
"chr6","131721705","131721857","chr5","26217588","26217735","34","105504117"
"chr6","131721981","131722115","chr12","94939804","94939932","24","36782177"
"chr6","131781752","131781998","chr5","38347057","38347291","72","93434695"
"chr6","131967327","131967613","chr3","49741493","49741779","66","82225834"
"chr6","132014006","132014299","chr2B","108814652","108814937","48","23199354"
"chr6","132029919","132030226","chr2B","108830507","108830806","46","23199412"
"chr6","132054537","132054842","chr1","135673275","135673581","73","3618738"
"chr6","132115453","132115765","chr11","46939397","46939683","69","85176056"
"chr6","132314300","132314367","chr3","173043241","173043305","22","40728941"
"chr6","132436717","132436802","chr17","37591914","37591992","22","94844803"
"chr6","132443891","132444196","chr2B","109224186","109224491","76","23219705"
"chr6","132494554","132494842","chr15","16565024","16565307","66","115929530"
"chr6","132496946","132497115","chr3","10866047","10866211","37","121630899"
"chr6","132515953","132516036","chr2A","7219562","7219651","23","125296391"
"chr6","132516384","132516602","chr1","69350992","69351203","60","63165392"
"chr6","132596308","132596515","chr3","129862204","129862418","51","2734104"
"chr6","132672453","132672720","chr2B","109495894","109496163","29","23176559"
"chr6","132692333","132692623","chr2B","109518015","109518316","39","23174318"
"chr6","132697697","132697992","chr16","10963785","10964082","58","121733912"
"chr6","132767276","132767572","chr2B","109593793","109594095","35","23173483"
"chr6","132800227","132800514","chr2B","109623763","109624041","33","23176464"
"chr6","132822938","132823222","chr2B","109654077","109654372","42","23168861"
"chr6","132842192","132842316","chr5","41673794","41673918","22","91168398"
"chr6","132878877","132879176","chrX","65323432","65323722","72","67555445"
"chr6","132882346","132882633","chr2B","109713626","109713916","42","23168720"
"chr6","132930186","132930474","chr1","14112366","14112658","60","118817820"
"chr6","132939703","132939891","chr11","71910867","71911040","46","61028836"
"chr6","132948880","132949182","chr2B","109781286","109781586","37","23167594"
"chr6","133012959","133013126","chr20","5564246","5564411","35","127448713"
"chr6","133043816","133043999","chr7","66155808","66155994","46","66888008"
"chr6","133193799","133194104","chr2B","110042457","110042732","65","23151342"
"chr6","133344469","133344554","chr2B","110194182","110194264","12","23150287"
"chr6","133594872","133595173","chr2B","110421564","110421876","35","23173308"
"chr6","133695697","133695805","chr7","76940267","76940373","21","56755430"
"chr6","133728351","133728642","chr2B","110547696","110547999","57","23180655"
"chr6","133797326","133797637","chr2B","110625996","110626295","44","23171330"
"chr6","133819352","133819478","chr2B","110656540","110656665","13","23162812"
"chr6","134009390","134009683","chr2B","110832948","110833240","31","23176442"
"chr6","134145586","134145709","chr2B","110952474","110952597","14","23193112"
"chr6","134213261","134213594","chr2B","111018109","111018407","68","23195152"
"chr6","134216440","134216754","chr2B","111021229","111021542","42","23195211"
"chr6","134289740","134290026","chr2B","111090217","111090517","45","23199523"
"chr6","134476086","134476293","chr2B","111304599","111304799","28","23171487"
"chr6","134502944","134503228","chr2B","111355499","111355796","44","23147445"
"chr6","134514383","134514503","chr2B","89756406","89756521","25","44757977"
"chr6","134520776","134520970","chr2B","111370102","111370287","30","23150674"
"chr6","134533416","134533721","chr1","23622718","23623020","64","110910698"
"chr6","134567680","134567877","chr2B","111412208","111412416","29","23155472"
"chr6","134573684","134573872","chr2A","103770599","103770776","46","30803085"
"chr6","134573972","134574132","chr8","63696364","63696527","38","70877608"
"chr6","134593046","134593156","chr4","153106200","153106312","17","18513154"
"chr6","134596492","134596804","chr2B","111443378","111443693","37","23153114"
"chr6","134633975","134634318","chrX","123813177","123813510","76","10820798"
"chr6","134665023","134665322","chr9","121324912","121325219","63","13340111"
"chr6","134668461","134668748","chr16","48298396","48298687","59","86370065"
"chr6","134682110","134682245","chr15","18620321","18620458","26","116061789"
"chr6","134699308","134699509","chr22","26391320","26391521","37","108307988"
"chr6","134699804","134700018","chr4","123878969","123879184","55","10820835"
"chr6","134706150","134706239","chr2B","111549961","111550050","3","23156189"
"chr6","134739363","134739638","chr2B","111576990","111577287","53","23162373"
"chr6","134741640","134741939","chr12","119661162","119661454","63","15080478"
"chr6","134742226","134742346","chr2B","111578899","111579020","19","23163327"
"chr6","134742890","134743058","chr6","25632918","25633092","38","109109972"
"chr6","134837004","134837310","chr2B","111663731","111664055","46","23173273"
"chr6","134845404","134845526","chr20","30238448","30238572","14","104606956"
"chr6","134870263","134870561","chr21","36870934","36871231","56","97999329"
"chr6","134875495","134875620","chr11","69147152","69147272","33","65728343"
"chr6","134883262","134883540","chr2B","111712523","111712831","59","23170739"
"chr6","134883567","134883699","chr7","74918737","74918868","26","59964830"
"chr6","134891544","134891831","chr9","107625580","107625871","69","27265964"
"chr6","134902674","134902792","chr2B","111737717","111737831","15","23164957"
"chr6","134911957","134912249","chr2B","111748560","111748852","33","23163397"
"chr6","134962836","134963003","chr5","62885644","62885808","41","72077192"
"chr6","134963771","134963897","chr1","205765363","205765491","25","70801592"
"chr6","134970644","134970906","chr2B","111806022","111806283","40","23164622"
"chr6","134977963","134978085","chr2B","111817873","111817993","13","23160090"
"chr6","134982542","134982831","chr2B","111824549","111824838","20","23157993"
"chr6","134989212","134989506","chr20","47709808","47710111","53","87279404"
"chr6","135025883","135025998","chr7","76940267","76940373","27","58085616"
"chr6","135084664","135084953","chr2B","111930772","111931061","35","23153892"
"chr6","135093222","135093352","chr6","54252491","54252620","20","80840731"
"chr6","135101522","135101780","chr2B","111950246","111950511","36","23151276"
"chr6","135102527","135102822","chr2B","111951269","111951571","42","23151258"
"chr6","135107525","135107823","chr2B","111955726","111956029","40","23151799"
"chr6","135133967","135134242","chr2B","111982196","111982475","54","23151771"
"chr6","135293641","135293921","chr2B","112139632","112139924","51","23154009"
"chr6","135319700","135319858","chr1","33201600","33201755","40","102118100"
"chr6","135348364","135348671","chr2B","112195461","112195777","41","23152903"
"chr6","135383870","135384168","chr2B","112234793","112235108","58","23149077"
"chr6","135391972","135392283","chr2B","112238930","112239248","50","23153042"
"chr6","135403771","135404077","chrX","19774215","19774522","59","115629556"
"chr6","135460759","135461036","chr9","109984718","109984994","66","25476041"
"chr6","135477204","135477414","chr2B","112320402","112320624","35","23156802"
"chr6","135489954","135490218","chr5","21548121","21548389","55","113941833"
"chr6","135523186","135523487","chr2B","112357149","112357456","35","23166037"
"chr6","135545375","135545624","chr2B","112378802","112379065","39","23166573"
"chr6","135548524","135548634","chr2B","112381603","112381716","11","23166921"
"chr6","135561443","135561584","chrX","8341268","8341409","30","127220175"
"chr6","135659607","135659737","chr2B","112484821","112484955","22","23174786"
"chr6","135660302","135660484","chr4","74880682","74880856","48","60779620"
"chr6","135660948","135661082","chr15","47322410","47322539","23","88338538"
"chr6","135730472","135730682","chr22","12742474","12742687","46","122987998"
"chr6","135730843","135731135","chr2B","112547992","112548280","37","23182851"
"chr6","135744614","135744861","chr16","19120503","19120741","65","116624111"
"chr6","135784815","135784931","chr2B","112598935","112599059","21","23185880"
"chr6","135836303","135836595","chr2B","112657044","112657344","51","23179259"
"chr6","135915297","135915641","chr2B","112719339","112719680","42","23195958"
"chr6","135974682","135974965","chr1","203856395","203856678","55","67881713"
"chr6","136000140","136000305","chr1","138968329","138968481","44","2968189"
"chr6","136000798","136000922","chr12","89776756","89776879","28","46224042"
"chr6","136123761","136124072","chr2B","112938391","112938690","44","23185370"
"chr6","136254093","136254215","chr2B","113067128","113067250","12","23186965"
"chr6","136299459","136299750","chr2B","113108122","113108433","54","23191337"
"chr6","136413392","136413727","chr2B","113216994","113217322","57","23196398"
"chr6","136585297","136585594","chr2B","113386347","113386659","43","23198950"
"chr6","136791428","136791650","chr6","867263","867478","54","135924165"
"chr6","136932067","136932384","chr3","3551053","3551357","63","133381014"
"chr6","137009707","137010022","chr2B","113790450","113790770","50","23219257"
"chr6","137125324","137125610","chr2B","113907800","113908069","50","23217524"
"chr6","137135516","137135664","chr4","169626375","169626527","32","32490859"
"chr6","137144370","137144639","chr5","133131289","133131554","61","4013081"
"chr6","137378675","137378830","chr4","16451557","16451695","43","120927118"
"chr6","137448951","137449231","chr2B","114230757","114231037","31","23218194"
"chr6","137565926","137566007","chr2B","114340461","114340543","10","23225465"
"chr6","137736353","137736585","chr2B","114500886","114501110","26","23235467"
"chr6","137766924","137767213","chr2B","114530402","114530695","47","23236522"
"chr6","137774437","137774557","chr5","39168474","39168591","26","98605963"
"chr6","137978835","137979139","chr2B","114740972","114741266","54","23237863"
"chr6","138005714","138005996","chr1","210839162","210839441","68","72833448"
"chr6","138024139","138024276","chr1","55323203","55323336","22","82700936"
"chr6","138042513","138042813","chr2B","114803624","114803928","56","23238889"
"chr6","138083131","138083448","chr2B","114841094","114841410","43","23242037"
"chr6","138091849","138092094","chr2B","114849018","114849305","58","23242831"
"chr6","138113742","138114056","chr2B","114867795","114868107","36","23245947"
"chr6","138157728","138157882","chr13","96634202","96634358","43","41523526"
"chr6","138196182","138196476","chr2B","114949910","114950205","45","23246272"
"chr6","138255820","138256116","chr2B","115005303","115005605","46","23250517"
"chr6","138262860","138262975","chr2B","115010702","115010811","14","23252158"
"chr6","138265139","138265427","chr2B","115012973","115013282","45","23252166"
"chr6","138281777","138281976","chr2B","115031798","115031999","21","23249979"
"chr6","138381788","138382005","chr1","6771390","6771609","49","131610398"
"chr6","138495199","138495470","chr9","35042947","35043231","64","103452252"
"chr6","138607047","138607321","chr2B","115359555","115359845","40","23247492"
"chr6","138665572","138665851","chr2B","115416591","115416850","62","23248981"
"chr6","138742581","138742871","chr2B","115489610","115489900","30","23252971"
"chr6","138790733","138790783","chr10","37581904","37581959","12","101208829"
"chr6","138796169","138796252","chr4","117994626","117994709","23","20801543"
"chr6","138813391","138813669","chr2B","115561923","115562228","61","23251468"
"chr6","138909555","138909842","chr2B","115667082","115667379","47","23242473"
"chr6","138923967","138924100","chr1","133233823","133233957","24","5690144"
"chr6","138925014","138925109","chr7","75095171","75095269","23","63829843"
"chr6","138946010","138946325","chr2B","115696992","115697308","33","23249018"
"chr6","138955214","138955473","chr8","55208634","55208892","58","83746580"
"chr6","138956702","138956826","chr2B","115707223","115707347","18","23249479"
"chr6","138957480","138957604","chr2B","115707223","115707347","18","23250257"
"chr6","138975096","138975348","chr2B","115723796","115724048","32","23251300"
"chr6","138988901","138989185","chr2B","115736490","115736795","50","23252411"
"chr6","139014912","139015018","chrX","107611093","107611200","17","31403819"
"chr6","139021588","139021891","chr2B","115763996","115764301","44","23257592"
"chr6","139072120","139072252","chr9","114559319","114559448","11","24512801"
"chr6","139089306","139089448","chr1","32730027","32730168","34","106359279"
"chr6","139105570","139105766","chr11","44694637","44694827","54","94410933"
"chr6","139117977","139118264","chr2B","115845226","115845539","54","23272751"
"chr6","139147218","139147383","chr6","137736682","137736850","33","1410536"
"chr6","139243747","139244013","chr2B","115932510","115932796","45","23311237"
"chr6","139254605","139254647","chr6","69602844","69602888","11","69651761"
"chr6","139254718","139254872","chr4","94318314","94318473","36","44936404"
"chr6","139277848","139278158","chr2B","115959253","115959550","50","23318595"
"chr6","139283409","139283691","chr2B","115964815","115965095","36","23318594"
"chr6","139285344","139285620","chr2B","115967110","115967411","61","23318234"
"chr6","139286804","139286937","chr2B","115968653","115968778","21","23318151"
"chr6","139294129","139294255","chr2B","115984799","115984916","20","23309330"
"chr6","139328817","139329130","chr14","58086996","58087308","61","81241821"
"chr6","139353637","139353941","chr10","142926143","142926445","77","3572506"
"chr6","139427046","139427331","chr2B","116120535","116120816","53","23306511"
"chr6","139437388","139437620","chr2B","116131657","116131876","51","23305731"
"chr6","139453836","139454157","chr2B","116146869","116147193","43","23306967"
"chr6","139484618","139484896","chr2B","116170655","116170945","55","23313963"
"chr6","139537037","139537154","chr1","201801763","201801881","20","62264726"
"chr6","139619190","139619283","chr2B","116305192","116305285","14","23313998"
"chr6","139800948","139801107","chr10","49585047","49585201","41","90215901"
"chr6","139835675","139835984","chr8","86095871","86096179","78","53739804"
"chr6","139872921","139873178","chr2B","116591750","116591992","37","23281171"
"chr6","139952425","139952711","chr2B","116678499","116678792","46","23273926"
"chr6","140032521","140032688","chr8","98458896","98459060","42","41573625"
"chr6","140078263","140078550","chr2B","116790997","116791279","39","23287266"
"chr6","140095936","140096228","chr2B","116813436","116813739","39","23282500"
"chr6","140130443","140130692","chr17","89053843","89054101","51","51076600"
"chr6","140182291","140182596","chr2B","116880455","116880775","68","23301836"
"chr6","140193537","140193649","chr2B","116892892","116893004","16","23300645"
"chr6","140220314","140220605","chr8","27298719","27299011","51","112921595"
"chr6","140263315","140263529","chr2B","116960940","116961157","22","23302375"
"chr6","140295641","140295758","chr7","7518910","7519027","13","132776731"
"chr6","140325153","140325337","chr1","226368103","226368288","42","86042950"
"chr6","140325365","140325612","chr2B","123993529","123993764","59","16331836"
"chr6","140394491","140394608","chr1","7888979","7889095","15","132505512"
"chr6","140395201","140395311","chr2A","87161167","87161273","24","53234034"
"chr6","140423877","140424079","chr19","9579212","9579408","60","130844665"
"chr6","140479314","140479468","chr16","38955159","38955317","29","101524155"
"chr6","140519083","140519332","chr5","34192040","34192286","65","106327043"
"chr6","140529951","140530228","chr6","7410913","7411196","56","133119038"
"chr6","140545468","140545752","chr2B","117226169","117226457","44","23319299"
"chr6","140550044","140550350","chr2B","117230826","117231147","40","23319218"
"chr6","140804103","140804398","chr6","39361368","39361664","60","101442735"
"chr6","140874743","140874922","chr5","138623932","138624102","64","2250811"
"chr6","140879402","140879677","chr2B","117573615","117573908","41","23305787"
"chr6","140893126","140893243","chrX","43772988","43773106","19","97120138"
"chr6","140929926","140930179","chr2B","117623894","117624152","40","23306032"
"chr6","140940600","140940892","chr2B","117634949","117635249","49","23305651"
"chr6","140964315","140964573","chr2B","117657008","117657298","75","23307307"
"chr6","140977531","140977663","chr6","154077267","154077397","23","13099736"
"chr6","140982262","140982399","chr2A","21072743","21072884","39","119909519"
"chr6","141001218","141001535","chr2B","117687740","117688067","78","23313478"
"chr6","141017800","141018013","chr2B","117701782","117702002","34","23316018"
"chr6","141062661","141062944","chr2B","117750105","117750389","47","23312556"
"chr6","141097502","141097796","chr7","100979319","100979618","70","40118183"
"chr6","141106365","141106637","chr20","3498719","3499007","65","137607646"
"chr6","141181476","141181787","chr1","28107383","28107679","71","113074093"
"chr6","141201391","141201510","chr4","110785057","110785181","26","30416334"
"chr6","141212937","141213250","chr2B","117926855","117927158","35","23286082"
"chr6","141247961","141248269","chrX","54323009","54323306","66","86924952"
"chr6","141331469","141331731","chr2B","118060299","118060583","47","23271170"
"chr6","141486389","141486672","chr2B","118211193","118211472","37","23275196"
"chr6","141494406","141494574","chr1","69180790","69180952","43","72313616"
"chr6","141877931","141878213","chr2B","118639064","118639350","38","23238867"
"chr6","141882694","141882826","chr2B","118643880","118644013","19","23238814"
"chr6","141906507","141906781","chr2B","118668411","118668690","44","23238096"
"chr6","142022584","142022747","chr10","90071080","90071242","32","51951504"
"chr6","142037940","142038224","chr2B","118813391","118813679","38","23224549"
"chr6","142338693","142338776","chr2B","119127302","119127385","6","23211391"
"chr6","142828037","142828260","chr2B","119593971","119594200","45","23234066"
"chr6","142989357","142989653","chr2B","119732941","119733235","31","23256416"
"chr6","143067152","143067464","chr2B","119799625","119799942","51","23267527"
"chr6","143091840","143092140","chr2B","119829509","119829813","55","23262331"
"chr6","143158763","143158878","chr3","45215966","45216083","17","97942797"
"chr6","143194099","143194388","chr2B","119929508","119929798","38","23264591"
"chr6","143251199","143251465","chr2B","119986572","119986860","56","23264627"
"chr6","143286413","143286705","chr2B","120020953","120021245","37","23265460"
"chr6","143292752","143292977","chr3","194411444","194411684","66","51118692"
"chr6","143341734","143341995","chr2B","120077257","120077529","42","23264477"
"chr6","143376333","143376629","chr2B","120112079","120112371","37","23264254"
"chr6","143477815","143477933","chr2B","120213189","120213309","11","23264626"
"chr6","143586598","143586813","chr15","54140084","54140303","60","89446514"
"chr6","143608896","143609188","chr2B","120340948","120341251","52","23267948"
"chr6","143662825","143663126","chr6","13472559","13472861","68","130190266"
"chr6","143702638","143702905","chr18","3250273","3250547","67","140452365"
"chr6","143739855","143740115","chr2B","120478745","120479024","39","23261110"
"chr6","143801507","143801816","chr12","109310786","109311086","70","34490721"
"chr6","143896713","143896836","chrX","33802425","33802548","26","110094288"
"chr6","143908341","143908469","chr2B","120641460","120641588","15","23266881"
"chr6","143908477","143908751","chr2B","120641593","120641880","34","23266884"
"chr6","143921311","143921525","chr2B","120656940","120657160","27","23264371"
"chr6","143939961","143940273","chr2B","120675435","120675738","49","23264526"
"chr6","143986880","143987177","chr6","1654209","1654492","64","142332671"
"chr6","143990790","143990979","chr12","16556473","16556673","52","127434317"
"chr6","144017458","144017745","chr2B","120756580","120756875","45","23260878"
"chr6","144065192","144065352","chr8","145248990","145249154","40","1183798"
"chr6","144186138","144186259","chr19","41395980","41396103","21","102790158"
"chr6","144202120","144202243","chr11","82877143","82877273","24","61324977"
"chr6","144202994","144203154","chr19","15955029","15955193","46","128247965"
"chr6","144209417","144209709","chr8","97737791","97738085","62","46471626"
"chr6","144213943","144214217","chr2B","66916348","66916624","27","77297595"
"chr6","144230318","144230450","chr1","155333181","155333312","25","11102863"
"chr6","144230891","144231038","chr3","267312","267456","33","143963579"
"chr6","144239294","144239590","chr2B","120985775","120986074","42","23253519"
"chr6","144264835","144264984","chr5","161174221","161174370","30","16909386"
"chr6","144271533","144271662","chr2B","121013802","121013925","24","23257731"
"chr6","144273116","144273284","chr4","61055093","61055253","38","83218023"
"chr6","144292194","144292493","chr5","16095110","16095399","76","128197084"
"chr6","144314381","144314508","chr2B","121061303","121061428","17","23253078"
"chr6","144367786","144368065","chr2B","121118574","121118854","55","23249212"
"chr6","144369910","144370202","chrX","54081472","54081761","60","90288438"
"chr6","144447940","144448217","chr2B","121195919","121196193","24","23252021"
"chr6","144609599","144609882","chr5","1893830","1894113","59","142715769"
"chr6","144626564","144626858","chr2B","121409316","121409624","53","23217248"
"chr6","144646769","144647043","chr15","56772445","56772717","61","87874324"
"chr6","144766114","144766416","chr2B","121575088","121575398","55","23191026"
"chr6","144987356","144987646","chr2B","121814800","121815100","35","23172556"
"chr6","145213756","145214000","chr2B","122057938","122058202","51","23155818"
"chr6","145293409","145293712","chr2B","122159528","122159852","61","23133881"
"chr6","145350751","145351028","chr2B","122214358","122214661","53","23136393"
"chr6","145557773","145557946","chr2B","122427500","122427677","20","23130273"
"chr6","145661536","145661737","chr2B","122532582","122532789","43","23128954"
"chr6","145683515","145683648","chr13","7539757","7539880","35","138143758"
"chr6","145752329","145752587","chr10","18961406","18961660","63","126790923"
"chr6","145766878","145767108","chr2A","97132183","97132414","49","48634695"
"chr6","145911647","145911936","chr2B","122786077","122786369","32","23125570"
"chr6","145949391","145949692","chr2B","122815348","122815645","48","23134043"
"chr6","146165637","146165978","chr2B","123019189","123019520","44","23146448"
"chr6","146205152","146205265","chr17","58216621","58216738","28","87988531"
"chr6","146214785","146215086","chr2B","123062864","123063152","66","23151921"
"chr6","146244814","146245098","chr2B","123098142","123098434","43","23146672"
"chr6","146274866","146274919","chr2B","123127905","123127961","9","23146961"
"chr6","146295823","146295919","chr8","124716221","124716323","29","21579602"
"chr6","146317234","146317527","chr2B","123169008","123169309","35","23148226"
"chr6","146323233","146323478","chr2B","123175015","123175260","41","23148218"
"chr6","146346507","146346635","chr3","59535512","59535636","20","86810995"
"chr6","146387094","146387339","chr2B","123235441","123235692","46","23151653"
"chr6","146388709","146388997","chr2B","123237454","123237748","40","23151255"
"chr6","146412676","146412962","chr2B","123258289","123258579","37","23154387"
"chr6","146434459","146434582","chr5","2493300","2493423","24","143941159"
"chr6","146440451","146440731","chr2B","123282732","123283026","52","23157719"
"chr6","146440921","146441210","chr2B","123283202","123283494","43","23157719"
"chr6","146465782","146465905","chr2B","123303964","123304085","11","23161818"
"chr6","146473997","146474293","chr12","68300782","68301077","69","78173215"
"chr6","146499844","146499961","chr5","46035056","46035174","11","100464788"
"chr6","146527860","146528166","chr2B","123393206","123393514","41","23134654"
"chr6","146531533","146531853","chr2B","123390568","123390883","50","23140965"
"chr6","146546509","146546820","chr2B","123404871","123405187","25","23141638"
"chr6","146549885","146550158","chr4","89655237","89655516","59","56894648"
"chr6","146636211","146636524","chr2B","123499425","123499742","56","23136786"
"chr6","146756262","146756380","chr2B","123613625","123613743","17","23142637"
"chr6","146977105","146977399","chr7","130249252","130249545","68","16727853"
"chr6","147003365","147003647","chr3","131369946","131370239","61","15633419"
"chr6","147050136","147050415","chr3","42755596","42755871","53","104294540"
"chr6","147080910","147081025","chr2B","123959078","123959192","25","23121832"
"chr6","147081354","147081629","chr2B","123959514","123959811","57","23121840"
"chr6","147090130","147090376","chr2B","123993529","123993764","31","23096601"
"chr6","147091741","147091953","chr2B","123995114","123995314","38","23096627"
"chr6","147158734","147159003","chr2B","124058872","124059164","53","23099862"
"chr6","147165737","147166011","chr6","141038381","141038666","67","6127356"
"chr6","147209591","147209692","chr2B","124110459","124110560","13","23099132"
"chr6","147304277","147304493","chr2B","124205341","124205552","40","23098936"
"chr6","147346498","147346779","chr2B","124249834","124250131","57","23096664"
"chr6","147398830","147399142","chr1","11037530","11037829","66","136361300"
"chr6","147415570","147415711","chrX","2794957","2795096","29","144620613"
"chr6","147416443","147416713","chr2B","124328917","124329178","32","23087526"
"chr6","147428258","147428533","chr2B","124340116","124340399","60","23088142"
"chr6","147451878","147452206","chr2B","124363321","124363657","47","23088557"
"chr6","147530331","147530488","chr2B","109308072","109308232","38","38222259"
"chr6","147577790","147578007","chr5","16448661","16448873","63","131129129"
"chr6","147590552","147590814","chr12","116555557","116555828","66","31034995"
"chr6","147603528","147603829","chr6","36199208","36199510","71","111404320"
"chr6","147640550","147640724","chr2A","41066733","41066900","55","106573817"
"chr6","147656450","147656571","chr2B","124570614","124570731","21","23085836"
"chr6","147679440","147679717","chr2B","124590802","124591091","49","23088638"
"chr6","147695850","147696122","chr22","23337344","23337614","61","124358506"
"chr6","147760512","147760819","chr15","44244841","44245146","60","103515671"
"chr6","147787738","147787857","chr5","133578375","133578499","32","14209363"
"chr6","147797755","147798057","chr2B","124715564","124715862","39","23082191"
"chr6","147804106","147804393","chr9","113216912","113217203","64","34587194"
"chr6","147813869","147814001","chr10","113081251","113081384","19","34732618"
"chr6","147834208","147834373","chr12","8768282","8768448","25","139065926"
"chr6","147835941","147836216","chr1","189902282","189902563","58","42066341"
"chr6","147880486","147880776","chr2B","124806974","124807268","34","23073512"
"chr6","147890556","147890847","chr2B","1100223","1100516","60","146790333"
"chr6","147896960","147897191","chr2B","124821144","124821350","57","23075816"
"chr6","147928890","147929169","chr2B","124854234","124854527","50","23074656"
"chr6","147937370","147937502","chr10","30690604","30690743","38","117246766"
"chr6","147955885","147956125","chr3","199232685","199232931","67","51276800"
"chr6","148071636","148071763","chr5","156507270","156507393","20","8435634"
"chr6","148097534","148097802","chr2B","125011433","125011702","59","23086101"
"chr6","148136701","148137009","chr8","68142682","68142965","81","79994019"
"chr6","148157773","148157931","chr14","10155920","10156077","33","138001853"
"chr6","148161052","148161370","chr1","160332533","160332842","66","12171481"
"chr6","148186559","148186673","chr2B","125096350","125096467","12","23090209"
"chr6","148189270","148189571","chr7","79532995","79533296","63","68656275"
"chr6","148223984","148224226","chrX","71273951","71274197","63","76950033"
"chr6","148226839","148226970","chrX","106120555","106120681","23","42106284"
"chr6","148263468","148263764","chr2B","125154623","125154917","40","23108845"
"chr6","148282265","148282579","chr2B","125172268","125172583","59","23109997"
"chr6","148297040","148297317","chr20","32843128","32843405","59","115453912"
"chr6","148303075","148303238","chr16","39512779","39512943","35","108790296"
"chr6","148341071","148341230","chr5","157205261","157205424","31","8864190"
"chr6","148348144","148348255","chr17","7683396","7683506","29","140664748"
"chr6","148367218","148367481","chr2B","125273909","125274185","53","23093309"
"chr6","148401406","148401701","chr4","75875835","75876122","65","72525571"
"chr6","148445924","148446209","chr2B","125389345","125389621","36","23056579"
"chr6","148600223","148600510","chr2B","125542999","125543288","47","23057224"
"chr6","148600721","148600931","chr2B","126149514","126149708","59","22451207"
"chr6","148618216","148618501","chr2B","94932795","94933081","55","53685421"
"chr6","148620706","148620781","chr7","30158546","30158613","14","118462160"
"chr6","148650506","148650601","chr2B","125596875","125596969","16","23053631"
"chr6","148653204","148653509","chr10","27982447","27982748","75","120670757"
"chr6","148740011","148740322","chr2B","125665891","125666165","78","23074120"
"chr6","148753137","148753457","chr2B","125679130","125679431","52","23074007"
"chr6","148797205","148797459","chr3","139210208","139210469","71","9586997"
"chr6","148833666","148833865","chr6","71465043","71465251","69","77368623"
"chr6","148885596","148885898","chr2B","125818448","125818750","50","23067148"
"chr6","148887041","148887141","chr2B","125819557","125819660","6","23067484"
"chr6","148908613","148908911","chr4","60261622","60261889","85","88646991"
"chr6","148998876","148999010","chr5","124432264","124432393","22","24566612"
"chr6","149035809","149036092","chr1","221569715","221570002","51","72533906"
"chr6","149057102","149057390","chr1","15419484","15419769","64","133637618"
"chr6","149076586","149076847","chr2B","126013175","126013451","38","23063411"
"chr6","149077193","149077476","chr2B","126013485","126013767","37","23063708"
"chr6","149083726","149083998","chr2B","126020499","126020786","51","23063227"
"chr6","149098258","149098531","chr16","23627061","23627350","50","125471197"
"chr6","149100856","149101157","chr16","23624541","23624841","44","125476315"
"chr6","149108860","149109155","chr19","7368404","7368703","60","141740456"
"chr6","149110877","149111037","chr19","15955029","15955193","35","133155848"
"chr6","149143973","149144079","chr2B","126059741","126059851","14","23084232"
"chr6","149158418","149158708","chr2B","126074037","126074333","49","23084381"
"chr6","149178941","149179194","chr19","52899526","52899765","70","96279415"
"chr6","149181580","149181824","chr12","106838535","106838776","61","42343045"
"chr6","149215782","149216071","chr2B","126126985","126127277","28","23088797"
"chr6","149241029","149241166","chr7","77000001","77000126","30","72241028"
"chr6","149254312","149254474","chr2B","126162282","126162438","26","23092030"
"chr6","149266051","149266363","chr2B","126172722","126173020","63","23093329"
"chr6","149270468","149270621","chr2B","126162282","126162438","37","23108186"
"chr6","149270796","149270913","chr2B","126177961","126178078","12","23092835"
"chr6","149272219","149272517","chr9","13508403","13508697","65","135763816"
"chr6","149272916","149273039","chr6","8143644","8143767","22","141129272"
"chr6","149308899","149309149","chr3","122071338","122071584","65","27237561"
"chr6","149370958","149371259","chr2B","126271016","126271352","62","23099942"
"chr6","149444338","149444623","chr2B","126361584","126361859","30","23082754"
"chr6","149470332","149470375","chr7","79558509","79558556","11","69911823"
"chr6","149470518","149470609","chr5","117649002","117649092","15","31821516"
"chr6","149487333","149487626","chr2B","126407911","126408209","48","23079422"
"chr6","149587486","149587799","chr9","92105082","92105399","47","57482404"
"chr6","149603215","149603518","chr5","7626635","7626936","54","141976580"
"chr6","149645455","149645607","chr2B","126540049","126540201","19","23105406"
"chr6","149691192","149691469","chr2B","126596031","126596313","48","23095161"
"chr6","149713366","149713619","chr2B","126622485","126622750","54","23090881"
"chr6","149742190","149742469","chr2B","126648799","126649096","48","23093391"
"chr6","149745146","149745447","chr2B","126651327","126651624","41","23093819"
"chr6","149745627","149745743","chr6","149821285","149821400","23","75658"
"chr6","149751968","149752237","chr6","36413480","36413735","76","113338488"
"chr6","149810113","149810236","chr2B","83696713","83696837","25","66113400"
"chr6","149820504","149820779","chr16","78415460","78415734","63","71405044"
"chr6","149835988","149836264","chr2B","126744039","126744318","40","23091949"
"chr6","149847136","149847406","chr2B","126759843","126760141","53","23087293"
"chr6","149886700","149886858","chr12","35974023","35974184","37","113912677"
"chr6","149903588","149903704","chr1","164846002","164846118","18","14942414"
"chr6","149911516","149911776","chr2B","126826284","126826532","45","23085232"
"chr6","149930345","149930648","chr2B","126842337","126842642","32","23088008"
"chr6","150116298","150116485","chr2B","44289279","44289464","39","105827019"
"chr6","150144419","150144650","chr2B","127153772","127154006","41","22990647"
"chr6","150310546","150310860","chr2B","127319456","127319770","52","22991090"
"chr6","150471487","150471765","chr2B","127466077","127466325","70","23005410"
"chr6","150559617","150559694","chr5","30304298","30304382","22","120255319"
"chr6","150559735","150559889","chr10","49585047","49585201","30","100974688"
"chr6","150586569","150586864","chr2B","127571541","127571818","56","23015028"
"chr6","150754712","150755019","chr2B","127747551","127747853","40","23007161"
"chr6","150820288","150820554","chr8","26610476","26610744","67","124209812"
"chr6","150853375","150853684","chr2B","127832914","127833231","49","23020461"
"chr6","151135007","151135301","chr9","13508403","13508697","55","137626604"
"chr6","151156774","151157066","chr2B","128110845","128111130","40","23045929"
"chr6","151235927","151236231","chr2B","128194876","128195187","58","23041051"
"chr6","151281118","151281404","chr2B","128235355","128235655","46","23045763"
"chr6","151301215","151301499","chr2B","128263602","128263902","46","23037613"
"chr6","151315802","151316018","chr9","42547921","42548141","50","108767881"
"chr6","151445197","151445501","chr16","48491470","48491779","52","102953727"
"chr6","151458324","151458612","chr2B","128427776","128428081","52","23030548"
"chr6","151465717","151466021","chr2B","128435961","128436263","36","23029756"
"chr6","151483769","151484054","chr11","58771612","58771896","72","92712157"
"chr6","151493691","151493988","chr2B","128463051","128463344","51","23030640"
"chr6","151524682","151524952","chr14","22175096","22175370","59","129349586"
"chr6","151535930","151536225","chr9","15545758","15546046","61","135990172"
"chr6","151636885","151637035","chr19","56020333","56020483","30","95616552"
"chr6","151641160","151641397","chr2B","128614567","128614822","43","23026593"
"chr6","151693799","151694059","chr11","73906796","73907044","72","77787003"
"chr6","151778922","151779227","chr2B","128768544","128768858","58","23010378"
"chr6","151780213","151780356","chr10","30690604","30690743","28","121089609"
"chr6","151796660","151796961","chr2B","128789566","128789865","33","23007094"
"chr6","151845507","151845811","chr19","33428200","33428501","62","118417307"
"chr6","151891022","151891263","chr2B","128877459","128877704","37","23013563"
"chr6","151896880","151897141","chr2B","128883502","128883786","60","23013378"
"chr6","151986205","151986291","chr2B","128972112","128972198","9","23014093"
"chr6","152022778","152023089","chr2B","129007937","129008248","46","23014841"
"chr6","152077950","152078029","chr1","95774692","95774774","21","56303258"
"chr6","152153564","152153857","chr2B","129135763","129136073","65","23017801"
"chr6","152243218","152243311","chr3","55130611","55130698","20","97112607"
"chr6","152243971","152244069","chr4","86873798","86873900","31","65370173"
"chr6","152244379","152244675","chr2B","129221025","129221276","74","23023354"
"chr6","152283476","152283610","chr22","27261164","27261298","25","125022312"
"chr6","152432196","152432506","chr14","79799409","79799720","61","72632787"
"chr6","152443499","152443764","chr2B","129417802","129418077","39","23025697"
"chr6","152450876","152451160","chr18","20249356","20249636","63","132201520"
"chr6","152465260","152465384","chr3","47334191","47334314","21","105131069"
"chr6","152466963","152467282","chr2B","129439419","129439727","61","23027544"
"chr6","152468664","152468967","chr7","1730368","1730668","66","150738296"
"chr6","152475863","152476177","chr2B","129450775","129451077","62","23025088"
"chr6","152481530","152481801","chr3","143837811","143838095","60","8643719"
"chr6","152496896","152497208","chr1","180063335","180063645","78","27566439"
"chr6","152506593","152506964","chr2B","129488571","129488935","44","23018022"
"chr6","152518633","152518845","chr5","56175665","56175866","47","96342968"
"chr6","152542800","152542931","chr16","12003452","12003583","20","140539348"
"chr6","152625695","152625821","chr2B","129635263","129635389","15","22990432"
"chr6","152630079","152630344","chr7","116519090","116519354","63","36110989"
"chr6","152647478","152647721","chr2A","100855981","100856233","73","51791497"
"chr6","152721615","152721798","chr2B","129709592","129709775","27","23012023"
"chr6","152870894","152871051","chrX","9628850","9629012","33","143242044"
"chr6","153092505","153092787","chr2B","130065895","130066173","32","23026610"
"chr6","153373540","153373807","chr2B","130356664","130356953","55","23016876"
"chr6","153455096","153455172","chr11","64918932","64918998","21","88536164"
"chr6","153641460","153641590","chr2B","130613283","130613414","9","23028177"
"chr6","153837266","153837581","chrX","71262322","71262629","77","82574944"
"chr6","154042140","154042269","chr7","68089945","68090074","26","85952195"
"chr6","154092283","154092572","chr2B","131033272","131033546","56","23059011"
"chr6","154118324","154118626","chr2B","27113389","27113682","96","127004935"
"chr6","154132644","154132768","chr7","11248117","11248241","22","142884527"
"chr6","154148074","154148357","chr2B","131089945","131090227","38","23058129"
"chr6","154173269","154173402","chr2B","131110583","131110715","22","23062686"
"chr6","154201843","154202034","chr7","150934994","150935168","51","3266849"
"chr6","154255645","154255750","chr3","65778113","65778219","20","88477532"
"chr6","154301702","154302001","chr2B","131235996","131236318","47","23065706"
"chr6","154329110","154329233","chr2B","131267972","131268094","10","23061138"
"chr6","154388396","154388496","chr3","186615177","186615282","14","32226781"
"chr6","154419157","154419256","chr19","27660829","27660929","20","126758328"
"chr6","154436071","154436337","chr9","97010673","97010951","65","57425398"
"chr6","154452030","154452264","chr12","65102113","65102357","50","89349917"
"chr6","154540297","154540573","chr2B","131462460","131462725","35","23077837"
"chr6","154551495","154551799","chr2B","131474288","131474610","60","23077207"
"chr6","154605629","154605758","chr2B","131522176","131522307","14","23083453"
"chr6","154712893","154713146","chr11","96274927","96275159","73","58437966"
"chr6","154716557","154716847","chr2B","131614841","131615128","36","23101716"
"chr6","154724061","154724187","chr2B","131623141","131623267","13","23100920"
"chr6","154733657","154733928","chr2B","131635045","131635348","55","23098612"
"chr6","154735202","154735322","chr1","110004368","110004488","24","44730834"
"chr6","154767702","154767802","chr11","17011229","17011337","21","137756473"
"chr6","154926594","154926785","chr5","53523691","53523885","44","101402903"
"chr6","154926794","154926848","chr13","14426019","14426074","14","140500775"
"chr6","154958006","154958315","chr2B","131864356","131864678","49","23093650"
"chr6","155067757","155068024","chr7","72578921","72579180","53","82488836"
"chr6","155250395","155250716","chr17","8287889","8288203","75","146962506"
"chr6","155255705","155255995","chr9","54002621","54002918","67","101253084"
"chr6","155328168","155328373","chr16","27370729","27370928","54","127957439"
"chr6","155432252","155432373","chr2B","132342636","132342758","16","23089616"
"chr6","155597717","155598000","chrX","51306964","51307255","67","104290753"
"chr6","155691065","155691336","chr18","46694498","46694766","84","108996567"
"chr6","155915069","155915376","chr19","18871903","18872198","81","137043166"
"chr6","155941899","155942086","chr19","40006029","40006215","33","115935870"
"chr6","156088656","156088860","chr2B","132949374","132949589","31","23139282"
"chr6","156207824","156208108","chr2B","133064421","133064723","59","23143403"
"chr6","156399599","156399899","chr5","23931488","23931783","63","132468111"
"chr6","156485015","156485264","chr2B","133327022","133327289","49","23157993"
"chr6","156593705","156593825","chr10","12650705","12650831","33","143943000"
"chr6","156890148","156890295","chr2A","97441991","97442142","36","59448157"
"chr6","157056680","157056881","chr2B","133898384","133898592","31","23158296"
"chr6","157060467","157060668","chr2B","133898384","133898592","32","23162083"
"chr6","157062080","157062352","chr10","132224847","132225125","56","24837233"
"chr6","157158400","157158688","chr2B","133994075","133994387","58","23164325"
"chr6","157177901","157178193","chr2B","16124622","16124913","60","141053279"
"chr6","157275105","157275388","chr11","47006876","47007157","65","110268229"
"chr6","157589824","157590076","chr6","110748523","110748766","56","46841301"
"chr6","157663977","157664248","chr1","198313937","198314220","60","40649960"
"chr6","157695879","157696166","chr2B","134535856","134536152","34","23160023"
"chr6","157704280","157704591","chr2B","134542499","134542825","61","23161781"
"chr6","157753911","157754177","chr2A","59621440","59621694","76","98132471"
"chr6","157777731","157778006","chr2B","134628243","134628531","66","23149488"
"chr6","157789396","157789686","chr8","98967491","98967789","69","58821905"
"chr6","157822387","157822666","chr2B","134669318","134669603","39","23153069"
"chr6","157830815","157831035","chr2B","134678028","134678249","34","23152787"
"chr6","157837488","157837781","chr2B","134685969","134686283","72","23151519"
"chr6","157846367","157846647","chr2B","134694927","134695218","50","23151440"
"chr6","157857978","157858102","chr10","64502862","64502986","20","93355116"
"chr6","157867126","157867194","chr4","2488200","2488266","18","155378926"
"chr6","157885871","157886153","chr2B","134733096","134733399","62","23152775"
"chr6","157935343","157935626","chr17","11572326","11572616","74","146363017"
"chr6","157937619","157937826","chr2B","134783878","134784074","32","23153741"
"chr6","157949206","157949330","chr5","68460490","68460616","31","89488716"
"chr6","157953216","157953332","chr4","40758424","40758547","34","117194792"
"chr6","157954180","157954324","chr8","20885859","20886004","32","137068321"
"chr6","157986597","157986818","chr7","76279260","76279482","53","81707337"
"chr6","157994176","157994466","chrX","40887647","40887932","58","117106529"
"chr6","157996529","157996672","chr14","244793","244920","38","157751736"
"chr6","158000878","158001158","chr2B","134839123","134839398","61","23161755"
"chr6","158006363","158006657","chr2B","134844287","134844581","63","23162076"
"chr6","158039584","158039846","chr9","44913398","44913659","63","113126186"
"chr6","158075911","158075995","chr2A","44105633","44105718","16","113970278"
"chr6","158076014","158076313","chr14","44593762","44594052","76","113482252"
"chr6","158092535","158092773","chr12","36349425","36349679","61","121743110"
"chr6","158101363","158101521","chr16","29999340","29999496","29","128102023"
"chr6","158131117","158131399","chr2B","134975649","134975930","31","23155468"
"chr6","158145680","158145969","chr20","5236938","5237224","59","152908742"
"chr6","158162367","158162466","chr10","56113754","56113858","35","102048613"
"chr6","158172498","158172796","chr4","87402636","87402937","49","70769862"
"chr6","158179636","158179931","chr2B","135011025","135011334","46","23168611"
"chr6","158185647","158185774","chr3","1525144","1525272","36","156660503"
"chr6","158194334","158194617","chr12","36044865","36045157","78","122149469"
"chr6","158266749","158267055","chr2B","135093134","135093436","38","23173615"
"chr6","158295790","158295912","chr2A","20545290","20545415","34","137750500"
"chr6","158316293","158316402","chr19","14292883","14292994","26","144023410"
"chr6","158316447","158316576","chr16","2589794","2589924","27","155726653"
"chr6","158316611","158316702","chr1","17798378","17798465","22","140518233"
"chr6","158322009","158322293","chr1","91059171","91059456","74","67262838"
"chr7","12451605","12451883","chr10","14853742","14854035","56","2402137"
"chr7","87293805","87294067","chr1","53359418","53359690","49","33934387"
"chr7","124911383","124911663","chr12","65692195","65692461","59","59219188"
"chr7","67865","67990","chr2A","20545290","20545415","31","20477425"
"chr7","68717","69007","chr10","913886","914165","43","845169"
"chr7","74634","74899","chr13","8643717","8643976","84","8569083"
"chr7","116563","116834","chr19","10147775","10148050","57","10031212"
"chr7","238600","238768","chr10","84917452","84917614","31","84678852"
"chr7","271468","271762","chr17","26278033","26278331","55","26006565"
"chr7","421063","421114","chr20","42447140","42447183","13","42026077"
"chr7","421122","421209","chr2A","63070189","63070277","14","62649067"
"chr7","439891","440180","chr10","1324190","1324486","38","884299"
"chr7","452381","452674","chr1","140066641","140066941","70","139614260"
"chr7","498129","498299","chr16","21811837","21812014","57","21313708"
"chr7","693682","693808","chr5","133578375","133578499","33","132884693"
"chr7","1004124","1004434","chr10","1989161","1989471","34","985037"
"chr7","1074874","1075003","chr10","2072290","2072411","23","997416"
"chr7","1079221","1079334","chrX","132733314","132733428","18","131654093"
"chr7","1189924","1190222","chr10","2253673","2253971","49","1063749"
"chr7","1366220","1366511","chr10","2428310","2428585","55","1062090"
"chr7","1376054","1376227","chr3","197368139","197368318","49","195992085"
"chr7","1422321","1422586","chr10","2487401","2487679","56","1065080"
"chr7","1454760","1455072","chr10","2525842","2526138","49","1071082"
"chr7","1651246","1651545","chr8","25383705","25384004","67","23732459"
"chr7","1663143","1663341","chr1","224283143","224283338","45","222620000"
"chr7","1726103","1726402","chr10","2872857","2873138","63","1146754"
"chr7","1761923","1762051","chr5","37897568","37897684","35","36135645"
"chr7","1783139","1783467","chr11","116812027","116812341","78","115028888"
"chr7","1871403","1871579","chr5","165314807","165314988","48","163443404"
"chr7","1935747","1936040","chr10","3121991","3122307","70","1186244"
"chr7","1945080","1945160","chr12","111845659","111845746","25","109900579"
"chr7","1945180","1945313","chr1","23480685","23480816","23","21535505"
"chr7","1999413","1999708","chr16","11426989","11427288","68","9427576"
"chr7","2018547","2018819","chr10","32685702","32685979","63","30667155"
"chr7","2022548","2022868","chrX","48161010","48161318","71","46138462"
"chr7","2040061","2040339","chr15","16565024","16565307","70","14524963"
"chr7","2043033","2043273","chr5","60787675","60787923","55","58744642"
"chr7","2064229","2064292","chr2B","26931720","26931778","13","24867491"
"chr7","2159026","2159311","chr15","27134497","27134773","68","24975471"
"chr7","2180217","2180520","chr16","16090183","16090488","59","13909966"
"chr7","2206892","2206935","chr18","48747592","48747636","10","46540700"
"chr7","2211241","2211440","chr4","100288876","100289065","48","98077635"
"chr7","2265125","2265426","chr10","3442575","3442869","41","1177450"
"chr7","2524037","2524095","chr12","59624929","59624987","15","57100892"
"chr7","2524662","2524886","chr20","3247317","3247532","53","722655"
"chr7","2670126","2670241","chr10","3873241","3873346","25","1203115"
"chr7","2686714","2686970","chr3","153754362","153754614","68","151067648"
"chr7","2729707","2729985","chr10","3935369","3935668","44","1205662"
"chr7","2970000","2970296","chr3","143449072","143449369","82","140479072"
"chr7","3002847","3003098","chr10","4229704","4229951","39","1226857"
"chr7","3003099","3003199","chr10","4229952","4230052","10","1226853"
"chr7","3059539","3059727","chr10","4281826","4282023","35","1222287"
"chr7","3084299","3084577","chr10","4305050","4305334","48","1220751"
"chr7","3140463","3140595","chr10","4358516","4358648","21","1218053"
"chr7","3145807","3146015","chr10","4364243","4364455","38","1218436"
"chr7","3348404","3348530","chr19","49723366","49723494","44","46374962"
"chr7","3348544","3348676","chr12","121653769","121653904","27","118305225"
"chr7","3384945","3385229","chr10","4617841","4618124","32","1232896"
"chr7","3397054","3397338","chr10","4636022","4636302","58","1238968"
"chr7","3598500","3598783","chr8","77590570","77590855","63","73992070"
"chr7","3862788","3863068","chr1","191202899","191203180","66","187340111"
"chr7","4004331","4004495","chr12","24528851","24529006","36","20524520"
"chr7","4120510","4120695","chr14","54505607","54505787","48","50385097"
"chr7","4140202","4140320","chr2B","131338325","131338443","25","127198123"
"chr7","4161578","4161723","chr3","74034091","74034239","34","69872513"
"chr7","4224618","4224900","chr10","5733094","5733380","39","1508476"
"chr7","4268004","4268314","chr10","5770275","5770563","56","1502271"
"chr7","4279053","4279316","chr10","5779509","5779767","37","1500456"
"chr7","4298525","4298642","chr1","197987006","197987122","16","193688481"
"chr7","4299412","4299678","chr1","224731755","224732026","66","220432343"
"chr7","4334079","4334345","chr10","5837865","5838145","46","1503786"
"chr7","4340618","4340917","chr10","5843865","5844170","39","1503247"
"chr7","4346581","4346859","chr6","23652041","23652311","60","19305460"
"chr7","4356919","4357218","chr3","173931487","173931771","67","169574568"
"chr7","4397168","4397279","chr7","68275138","68275242","30","63877970"
"chr7","4398381","4398654","chr1","130907422","130907682","74","126509041"
"chr7","4404419","4404704","chr1","91059171","91059456","55","86654752"
"chr7","4508353","4508639","chr10","6017042","6017321","58","1508689"
"chr7","4529987","4530252","chr10","6036408","6036683","38","1506421"
"chr7","4543991","4544244","chr1","46247854","46248108","52","41703863"
"chr7","4605763","4605911","chr1","35990433","35990582","36","31384670"
"chr7","4612609","4612908","chr10","6128500","6128803","46","1515891"
"chr7","4660026","4660305","chr3","124853187","124853457","63","120193161"
"chr7","4680500","4680811","chr10","6164959","6165262","41","1484459"
"chr7","4698225","4698430","chr10","6188015","6188220","27","1489790"
"chr7","4705562","4705668","chr1","191377103","191377214","23","186671541"
"chr7","4706276","4706534","chr6","145502012","145502263","64","140795736"
"chr7","4711916","4712171","chr10","6202735","6202994","33","1490819"
"chr7","4714495","4714774","chr10","6206680","6206980","62","1492185"
"chr7","4726331","4726627","chr10","6219399","6219714","62","1493068"
"chr7","4730044","4730247","chr10","6222425","6222619","27","1492381"
"chr7","4730814","4730927","chr10","6223122","6223235","7","1492308"
"chr7","4750565","4750692","chr10","6239845","6239973","17","1489280"
"chr7","4751126","4751397","chr10","6240428","6240687","53","1489302"
"chr7","4757977","4758271","chr15","53739812","53740103","65","48981835"
"chr7","4779171","4779464","chr10","6268987","6269301","50","1489816"
"chr7","4781019","4781288","chr5","20142932","20143200","72","15361913"
"chr7","4865161","4865432","chr2B","94932795","94933081","52","90067634"
"chr7","4885282","4885573","chr10","25020000","25020294","57","20134718"
"chr7","4935088","4935357","chr10","6458791","6459074","55","1523703"
"chr7","5176421","5176506","chr10","6715852","6715940","9","1539431"
"chr7","5192518","5192603","chr19","17917515","17917595","22","12724997"
"chr7","5193805","5194091","chr10","6733701","6733981","58","1539896"
"chr7","5197054","5197360","chrUn_CABD030130950v1","210","514","60","5196844"
"chr7","5234271","5234538","chr10","6771397","6771667","32","1537126"
"chr7","5304974","5305098","chr11","115608100","115608226","18","110303126"
"chr7","5359826","5359940","chr7","107591138","107591254","20","102231312"
"chr7","5402185","5402332","chr20","32123638","32123783","39","26721453"
"chr7","5420502","5420708","chr10","6996337","6996548","30","1575835"
"chr7","5477457","5477725","chr10","7030255","7030544","58","1552798"
"chr7","5479803","5480060","chr10","7027927","7028199","42","1548124"
"chr7","5485273","5485432","chr14","86783603","86783763","42","81298330"
"chr7","5488918","5489057","chr10","29754500","29754651","35","24265582"
"chr7","5608266","5608531","chr10","7218792","7219078","54","1610526"
"chr7","5617937","5618231","chr10","7232725","7233022","30","1614788"
"chr7","5661555","5661847","chr10","7273717","7274037","68","1612162"
"chr7","5663724","5663790","chr16","31366418","31366485","10","25702694"
"chr7","5704538","5704666","chr14","50725807","50725931","21","45021269"
"chr7","5872336","5872563","chr4","194112054","194112280","47","188239718"
"chr7","5906768","5907050","chr10","7509110","7509396","40","1602342"
"chr7","5929009","5929291","chr10","7530020","7530319","54","1601011"
"chr7","5943025","5943148","chr10","7552915","7553038","6","1609890"
"chr7","5960667","5960949","chr10","7569605","7569899","45","1608938"
"chr7","6012408","6012632","chr10","7632730","7632953","28","1620322"
"chr7","6024037","6024323","chr10","7645193","7645494","54","1621156"
"chr7","6032056","6032345","chr10","7650602","7650894","38","1618546"
"chr7","6106873","6107169","chrX","53571544","53571840","60","47464671"
"chr7","6126115","6126404","chr4","93529939","93530229","52","87403824"
"chr7","6142753","6143011","chr16","16040147","16040417","73","9897394"
"chr7","6180273","6180558","chr10","7825256","7825556","45","1644983"
"chr7","6200631","6200945","chr7","73100304","73100605","64","66899673"
"chr7","6237681","6237815","chr10","7901069","7901210","23","1663388"
"chr7","6238312","6238437","chr10","7901263","7901392","19","1662951"
"chr7","6255970","6256049","chr10","7918701","7918780","9","1662731"
"chr7","6371382","6371506","chrX","70594684","70594808","20","64223302"
"chr7","6373400","6373699","chr3","144797380","144797676","64","138423980"
"chr7","6398892","6399167","chr17","21019337","21019600","82","14620445"
"chr7","6412232","6412398","chr19","2933468","2933646","40","3478764"
"chr7","6455807","6456123","chr10","8094024","8094309","66","1638217"
"chr7","6516787","6517078","chr10","8154938","8155245","59","1638151"
"chr7","6526264","6526431","chr7","105000143","105000306","32","98473879"
"chr7","6555298","6555468","chr3","10866047","10866211","42","4310749"
"chr7","6556251","6556382","chr2A","74544432","74544547","32","67988181"
"chr7","6611909","6612199","chr2A","2994032","2994323","69","3617877"
"chr7","6612834","6613135","chr5","32502657","32502958","63","25889823"
"chr7","6626017","6626165","chr4","182641032","182641181","36","176015015"
"chr7","6629154","6629455","chrX","10384333","10384632","55","3755179"
"chr7","6635188","6635429","chr7","102352933","102353173","65","95717745"
"chr7","6636136","6636440","chr10","8294993","8295300","52","1658857"
"chr7","6642991","6643264","chr9","33102896","33103182","70","26459905"
"chr7","6658018","6658290","chr10","8314612","8314893","40","1656594"
"chr7","6661698","6661815","chr10","8317790","8317908","17","1656092"
"chr7","6717329","6717581","chr10","8386114","8386398","60","1668785"
"chr7","6731762","6732073","chr1","121557174","121557489","74","114825412"
"chr7","6754719","6754976","chr10","8418135","8418375","50","1663416"
"chr7","6815439","6815710","chr2B","134839123","134839398","64","128023684"
"chr7","6825203","6825413","chr20","48240040","48240252","47","41414837"
"chr7","6871445","6871723","chr10","8534605","8534860","57","1663160"
"chr7","6872908","6873112","chr5","124192533","124192731","59","117319625"
"chr7","6875884","6876043","chr18","43216179","43216342","30","36340295"
"chr7","6888393","6888665","chr10","8550492","8550784","66","1662099"
"chr7","6890321","6890461","chr10","8552412","8552557","16","1662091"
"chr7","6893710","6893881","chr1","130297384","130297555","50","123403674"
"chr7","6897058","6897175","chr10","8562281","8562398","11","1665223"
"chr7","6913615","6913901","chr10","8582247","8582528","51","1668632"
"chr7","6932318","6932612","chr7","1615367","1615654","74","5316951"
"chr7","6942270","6942541","chr5","13122526","13122799","60","6180256"
"chr7","6944439","6944725","chr10","8613214","8613514","56","1668775"
"chr7","6955500","6955793","chr11","76832535","76832823","56","69877035"
"chr7","6983091","6983364","chr10","8652514","8652807","50","1669423"
"chr7","7019107","7019405","chr16","23756696","23756999","66","16737589"
"chr7","7093102","7093394","chr10","8770549","8770855","58","1677447"
"chr7","7136303","7136611","chr10","8899446","8899753","44","1763143"
"chr7","7295986","7296205","chr10","9076382","9076601","33","1780396"
"chr7","7309765","7310048","chr17","78401865","78402148","66","71092100"
"chr7","7476194","7476300","chr7","138217164","138217262","23","130740970"
"chr7","7498404","7498530","chr1","9666032","9666156","20","2167628"
"chr7","7545781","7546083","chr1","54508003","54508299","80","46962222"
"chr7","7567416","7567720","chr10","9319739","9320044","54","1752323"
"chr7","7695770","7695891","chrX","95494066","95494189","22","87798296"
"chr7","7847516","7847586","chr12","122719017","122719091","14","114871501"
"chr7","7888017","7888311","chr10","9685142","9685437","43","1797125"
"chr7","7957035","7957326","chr14","48403355","48403647","63","40446320"
"chr7","7967681","7967974","chr10","9781908","9782189","46","1814227"
"chr7","7978117","7978237","chr1","51303701","51303823","19","43325584"
"chr7","8167728","8168009","chr10","9998432","9998705","39","1830704"
"chr7","8209886","8210145","chr9","109523719","109523976","77","101313833"
"chr7","8257749","8258059","chr10","142926143","142926445","76","134668394"
"chr7","8287299","8287601","chr10","10118641","10118945","46","1831342"
"chr7","8292552","8292843","chr10","10123014","10123305","54","1830462"
"chr7","8295760","8295876","chr10","10126567","10126683","9","1830807"
"chr7","8299608","8299753","chr10","10131349","10131498","30","1831741"
"chr7","8409669","8409954","chr6","46305109","46305397","60","37895440"
"chr7","8410584","8410716","chr7","69965789","69965928","40","61555205"
"chr7","8433799","8433921","chr10","10266050","10266172","15","1832251"
"chr7","8541969","8542251","chr9","80035700","80035985","63","71493731"
"chr7","8612646","8612963","chr10","10407036","10407331","66","1794390"
"chr7","8834309","8834581","chr10","10661154","10661405","47","1826845"
"chr7","9071530","9071808","chr10","10901879","10902171","61","1830349"
"chr7","9082353","9082646","chr10","10918378","10918664","47","1836025"
"chr7","9098877","9099180","chr10","10933656","10933953","51","1834779"
"chr7","9101602","9101892","chr10","10936430","10936750","68","1834828"
"chr7","9130847","9131142","chr10","10968506","10968805","50","1837659"
"chr7","9133844","9134086","chr10","10971537","10971785","39","1837693"
"chr7","9288486","9288775","chr10","11119047","11119353","65","1830561"
"chr7","9299939","9300233","chr10","11132091","11132399","57","1832152"
"chr7","9310250","9310526","chr10","11142017","11142318","54","1831767"
"chr7","9340365","9340658","chr10","11168994","11169307","47","1828629"
"chr7","9342664","9342950","chr10","11170926","11171222","47","1828262"
"chr7","9357873","9358150","chr10","11185897","11186171","38","1828024"
"chr7","9365064","9365158","chr3","72686588","72686686","25","63321524"
"chr7","9432215","9432460","chr10","11258257","11258507","33","1826042"
"chr7","9439208","9439511","chr1","110457031","110457318","89","101017823"
"chr7","9503915","9504031","chr6","37801775","37801890","17","28297860"
"chr7","9522423","9522723","chr10","11354114","11354406","41","1831691"
"chr7","9596176","9596461","chr10","11427074","11427366","35","1830898"
"chr7","9737138","9737436","chr10","11570911","11571201","66","1833773"
"chr7","9752507","9752789","chr10","11584059","11584367","61","1831552"
"chr7","9753840","9754135","chr10","11585090","11585399","71","1831250"
"chr7","9778863","9779056","chrX","48129374","48129565","45","38350511"
"chr7","9833263","9833389","chr12","58025901","58026025","17","48192638"
"chr7","9865726","9865999","chr10","11707774","11708054","50","1842048"
"chr7","9887025","9887334","chr10","11726133","11726437","48","1839108"
"chr7","9904821","9904885","chr10","11743976","11744039","10","1839155"
"chr7","10051674","10051945","chr9","45651589","45651869","57","35599915"
"chr7","10054488","10054730","chr5","126873220","126873451","48","116818732"
"chr7","10074816","10075182","chr3","15105397","15105762","94","5030581"
"chr7","10078932","10079229","chr10","11902060","11902355","64","1823128"
"chr7","10080488","10080763","chr7","66311321","66311587","63","56230833"
"chr7","10092932","10093091","chr19","4563176","4563336","26","5529756"
"chr7","10116798","10117060","chrX","133361275","133361531","50","123244477"
"chr7","10130227","10130444","chr10","11972781","11973018","47","1842554"
"chr7","10163360","10163631","chr19","6569410","6569673","60","3593950"
"chr7","10172179","10172315","chrX","2794957","2795096","32","7377222"
"chr7","10206508","10206805","chr10","12073888","12074183","36","1867380"
"chr7","10215180","10215445","chr4","154749915","154750182","59","144534735"
"chr7","10246584","10246895","chr15","44244841","44245146","68","33998257"
"chr7","10268317","10268609","chr12","121101371","121101664","52","110833054"
"chr7","10288749","10288994","chr10","12158164","12158419","37","1869415"
"chr7","10294382","10294663","chr20","4972582","4972831","82","5321800"
"chr7","10328148","10328351","chrX","38198324","38198508","51","27870176"
"chr7","10328366","10328641","chr9","93719015","93719301","58","83390649"
"chr7","10352986","10353203","chr4","123992243","123992482","63","113639257"
"chr7","10357395","10357702","chr10","12223567","12223877","55","1866172"
"chr7","10359730","10360037","chr10","12223567","12223877","55","1863837"
"chr7","10383339","10383456","chr2B","14476412","14476528","17","4093073"
"chr7","10387644","10387753","chr9","91909520","91909629","25","81521876"
"chr7","10464754","10465043","chr10","12635067","12635350","71","2170313"
"chr7","10470092","10470374","chr17","23750698","23750982","61","13280606"
"chr7","10494459","10494748","chr10","12664220","12664508","39","2169761"
"chr7","10506156","10506467","chrX","130179882","130180178","61","119673726"
"chr7","10507964","10508286","chr19","47856148","47856461","66","37348184"
"chr7","10526370","10526640","chr10","12685632","12685900","38","2159262"
"chr7","10531711","10531835","chr10","12690841","12690970","19","2159130"
"chr7","10615002","10615304","chr7","79073505","79073807","76","68458503"
"chr7","10641257","10641563","chr10","12883027","12883328","36","2241770"
"chr7","10690113","10690158","chr19","52993169","52993217","10","42303056"
"chr7","10690183","10690462","chr11","64543933","64544209","49","53853750"
"chr7","10717289","10717571","chr10","12949660","12949943","28","2232371"
"chr7","10722634","10722784","chr8","68238865","68239026","44","57516231"
"chr7","10748481","10748770","chr10","13005085","13005385","41","2256604"
"chr7","10858336","10858620","chr12","124892445","124892734","57","114034109"
"chr7","10876037","10876324","chr10","13146469","13146756","48","2270432"
"chr7","10979251","10979534","chr15","52196243","52196533","62","41216992"
"chr7","11015217","11015417","chr6","119878272","119878462","56","108863055"
"chr7","11052731","11052993","chr10","13369473","13369765","56","2316742"
"chr7","11121088","11121399","chr17","61469371","61469683","56","50348283"
"chr7","11123391","11123608","chr6","123941053","123941272","47","112817662"
"chr7","11131703","11131818","chr10","13476774","13476892","19","2345071"
"chr7","11133867","11134148","chr5","47957756","47958040","66","36823889"
"chr7","11159323","11159602","chr16","16144083","16144372","58","4984760"
"chr7","11168387","11168677","chr10","27201330","27201627","58","16032943"
"chr7","11172688","11172965","chr9","78650999","78651275","62","67478311"
"chr7","11176786","11176939","chr5","2493450","2493615","36","8683336"
"chr7","11181788","11181975","chr7","2838990","2839180","50","8342798"
"chr7","11182767","11183055","chr8","74464427","74464686","79","63281660"
"chr7","11194064","11194361","chr17","38797013","38797309","76","27602949"
"chr7","11222037","11222142","chr1","39325820","39325928","26","28103783"
"chr7","11232005","11232089","chr5","13943605","13943686","20","2711600"
"chr7","11237674","11237975","chr10","13609691","13610013","64","2372017"
"chr7","11240153","11240470","chr7","79836707","79837020","55","68596554"
"chr7","11242883","11243043","chr1","138968329","138968481","36","127725446"
"chr7","11253236","11253523","chr10","13649420","13649703","38","2396184"
"chr7","11291464","11291754","chr8","74082411","74082664","83","62790947"
"chr7","11329589","11329698","chr4","99254244","99254353","18","87924655"
"chr7","11364002","11364257","chr10","13776874","13777147","53","2412872"
"chr7","11402220","11402512","chr10","13823223","13823522","36","2421003"
"chr7","11411243","11411369","chr4","163028449","163028575","19","151617206"
"chr7","11418276","11418443","chr16","65612512","65612678","38","54194236"
"chr7","11430767","11430916","chr1","21701601","21701750","39","10270834"
"chr7","11442635","11442926","chr1","163867986","163868280","56","152425351"
"chr7","11505802","11506085","chr10","13934298","13934589","47","2428496"
"chr7","11506717","11507025","chr10","13935669","13935975","50","2428952"
"chr7","11513580","11513871","chr10","13941901","13942218","59","2428321"
"chr7","11516887","11517187","chr10","13945267","13945569","53","2428380"
"chr7","11530638","11530928","chr15","26780342","26780631","58","15249704"
"chr7","11579145","11579463","chr10","14003244","14003561","37","2424099"
"chr7","11630683","11630988","chr4","182154112","182154409","64","170523429"
"chr7","11649333","11649623","chr10","14067137","14067431","50","2417804"
"chr7","11660390","11660663","chr10","14078898","14079166","34","2418508"
"chr7","11662463","11662629","chr3","15628717","15628877","40","3966254"
"chr7","11663655","11663759","chr1","30924447","30924538","28","19260792"
"chr7","11663847","11664011","chrX","71245243","71245415","44","59581396"
"chr7","11671965","11672239","chr10","14090497","14090769","25","2418532"
"chr7","11689477","11689774","chr10","14103034","14103316","57","2413557"
"chr7","11701036","11701325","chr14","57561011","57561306","64","45859975"
"chr7","11702635","11702813","chr12","29036989","29037166","39","17334354"
"chr7","11703061","11703341","chr1","190065982","190066274","58","178362921"
"chr7","11717891","11718014","chr10","14129614","14129735","15","2411723"
"chr7","11719176","11719426","chr10","14130937","14131212","60","2411761"
"chr7","11723552","11723667","chr1","183791729","183791842","18","172068177"
"chr7","11724978","11725110","chr1","94267470","94267597","33","82542492"
"chr7","11725414","11725486","chr6","30633559","30633630","16","18908145"
"chr7","11742970","11743271","chr1","23622718","23623020","69","11879748"
"chr7","11744332","11744456","chr10","14153007","14153131","15","2408675"
"chr7","11744478","11744767","chr10","14153151","14153443","42","2408673"
"chr7","11773412","11773669","chr10","14181139","14181394","32","2407727"
"chr7","11790243","11790366","chr20","40735237","40735359","19","28944994"
"chr7","11813993","11814266","chr10","14220968","14221241","41","2406975"
"chr7","11845284","11845580","chr12","8922143","8922434","65","2923141"
"chr7","11901488","11901757","chr10","14304840","14305118","40","2403352"
"chr7","11901786","11901922","chr20","36705924","36706059","26","24804138"
"chr7","11998928","11999218","chr10","14404570","14404869","38","2405642"
"chr7","12001369","12001688","chr10","14407027","14407312","63","2405658"
"chr7","12005121","12005427","chr10","14410342","14410651","34","2405221"
"chr7","12023620","12023892","chr10","14427541","14427811","42","2403921"
"chr7","12030345","12030617","chr10","14434263","14434538","43","2403918"
"chr7","12040233","12040536","chr10","14442251","14442545","71","2402018"
"chr7","12054059","12054341","chr12","131771894","131772192","59","119717835"
"chr7","12063408","12063717","chr10","14464802","14465124","44","2401394"
"chr7","12083145","12083371","chr10","14481244","14481479","36","2398099"
"chr7","12088109","12088233","chr8","45313442","45313566","18","33225333"
"chr7","12091075","12091382","chr14","53007445","53007743","65","40916370"
"chr7","12113950","12114042","chr6","133735666","133735760","18","121621716"
"chr7","12206004","12206127","chr7","26158438","26158564","34","13952434"
"chr7","12250551","12250860","chr10","14639437","14639745","57","2388886"
"chr7","12355113","12355383","chr10","14741011","14741294","39","2385898"
"chr7","12363909","12364181","chr10","14758261","14758543","36","2394352"
"chr7","12377627","12377894","chr9","78335347","78335631","56","65957720"
"chr7","12388549","12388827","chr5","13122526","13122799","59","733977"
"chr7","12441097","12441394","chr10","14841169","14841483","58","2400072"
"chr7","12458457","12458754","chr1","45145246","45145545","72","32686789"
"chr7","12458761","12458884","chr2B","96283166","96283291","15","83824405"
"chr7","12543701","12543977","chr10","14936751","14937052","44","2393050"
"chr7","12566120","12566411","chr10","14963914","14964199","52","2397794"
"chr7","12590677","12590955","chr10","14986367","14986658","48","2395690"
"chr7","12623790","12623919","chr10","12650705","12650831","32","26915"
"chr7","12638714","12638836","chr3","131181539","131181661","17","118542825"
"chr7","12645533","12645826","chr18","55179195","55179488","71","42533662"
"chr7","12664193","12664475","chr10","15060410","15060659","63","2396217"
"chr7","12678683","12678973","chr10","15076797","15077102","58","2398114"
"chr7","12688252","12688390","chr10","15087422","15087589","44","2399170"
"chr7","12730999","12731298","chr10","15130005","15130306","46","2399006"
"chr7","12733585","12733845","chr10","15133762","15134029","32","2400177"
"chr7","12800954","12801185","chr5","91107887","91108112","64","78306933"
"chr7","12820605","12820907","chr10","15226857","15227168","44","2406252"
"chr7","12822929","12823203","chr10","15228976","15229247","48","2406047"
"chr7","12825873","12826139","chr19","4570608","4570877","62","8255265"
"chr7","12833070","12833358","chr10","15284417","15284722","47","2451347"
"chr7","12851854","12851968","chr8","42061342","42061458","20","29209488"
"chr7","12866791","12867094","chr10","15292751","15293048","33","2425960"
"chr7","12870209","12870484","chr10","15296218","15296490","39","2426009"
"chr7","12882249","12882419","chr11","58592944","58593112","33","45710695"
"chr7","12885206","12885287","chr5","56160597","56160680","16","43275391"
"chr7","12899581","12899869","chr12","114462694","114462983","52","101563113"
"chr7","12944327","12944624","chrX","39133182","39133470","58","26188855"
"chr7","12945985","12946271","chr10","15371530","15371828","39","2425545"
"chr7","12953203","12953324","chr10","15377101","15377232","22","2423898"
"chr7","12961994","12962235","chr10","15386825","15387090","45","2424831"
"chr7","12974965","12975081","chr17","63212955","63213066","34","50237990"
"chr7","12984453","12984748","chr20","32988113","32988400","65","20003660"
"chr7","12991430","12991735","chr10","15418622","15418904","38","2427192"
"chr7","13001800","13002104","chr10","15431863","15432165","34","2430063"
"chr7","13003051","13003150","chrX","1561167","1561261","18","11441884"
"chr7","13017124","13017391","chr10","15446393","15446669","50","2429269"
"chr7","13025062","13025186","chr3","65193379","65193500","14","52168317"
"chr7","13042280","13042564","chr10","15471523","15471786","51","2429243"
"chr7","13046179","13046355","chr4","109329573","109329745","36","96283394"
"chr7","13066467","13066759","chr7","73605371","73605659","65","60538904"
"chr7","13082727","13082993","chr10","15517665","15517926","31","2434938"
"chr7","13108559","13108868","chr10","15539523","15539816","47","2430964"
"chr7","13111024","13111314","chr10","15541939","15542230","36","2430915"
"chr7","13138801","13139109","chr10","15567745","15568063","47","2428944"
"chr7","13142462","13142737","chr10","15571096","15571387","60","2428634"
"chr7","13227791","13228084","chr1","18442253","18442549","59","5214462"
"chr7","13230871","13231169","chr10","15672878","15673156","49","2442007"
"chr7","13242134","13242330","chr1","9006546","9006728","57","4235588"
"chr7","13263447","13263723","chr18","33131463","33131735","59","19868016"
"chr7","13295715","13296002","chr19","13591309","13591596","68","295594"
"chr7","13308850","13309010","chr10","15743417","15743574","23","2434567"
"chr7","13311236","13311527","chr10","15745775","15746024","76","2434539"
"chr7","13324699","13324850","chr14","58580963","58581123","34","45256264"
"chr7","13337369","13337682","chr10","15779435","15779730","54","2442066"
"chr7","13351620","13351717","chr16","72048827","72048929","19","58697207"
"chr7","13354077","13354165","chrX","41792790","41792876","23","28438713"
"chr7","13358022","13358294","chr6","9557233","9557498","67","3800789"
"chr7","13423158","13423447","chr1","163867986","163868280","47","150444828"
"chr7","13429361","13429647","chr10","15883551","15883856","52","2454190"
"chr7","13450091","13450381","chr6","172320100","172320391","58","158870009"
"chr7","13477611","13477893","chr10","15931430","15931716","43","2453819"
"chr7","13494420","13494706","chr10","15945754","15946020","48","2451334"
"chr7","13548083","13548369","chr10","15990598","15990872","54","2442515"
"chr7","13622580","13622686","chr12","122832974","122833083","23","109210394"
"chr7","13641815","13642095","chr10","16085069","16085372","71","2443254"
"chr7","13648976","13649175","chr16","57622879","57623086","56","43973903"
"chr7","13667100","13667283","chr10","16109750","16109920","35","2442650"
"chr7","13691342","13691618","chr10","16148284","16148585","67","2456942"
"chr7","13796488","13796610","chr10","16270780","16270902","15","2474292"
"chr7","13842675","13842955","chr10","16316624","16316903","41","2473949"
"chr7","13877743","13878045","chr10","16369178","16369478","45","2491435"
"chr7","13888719","13889029","chr10","16379803","16380107","32","2491084"
"chr7","14018604","14018893","chr10","16542151","16542440","43","2523547"
"chr7","14020823","14021073","chr5","34192040","34192286","67","20171217"
"chr7","14029543","14029661","chr3","46046317","46046436","22","32016774"
"chr7","14044912","14045173","chr8","61880569","61880831","56","47835657"
"chr7","14101509","14101673","chr1","110280511","110280665","44","96179002"
"chr7","14114561","14114810","chr10","16626536","16626819","60","2511975"
"chr7","14115807","14116112","chr10","16627837","16628130","59","2512030"
"chr7","14125855","14125974","chr1","20913241","20913363","23","6787386"
"chr7","14125996","14126267","chr3","124853187","124853457","64","110727191"
"chr7","14131189","14131453","chr10","16643778","16644039","46","2512589"
"chr7","14137724","14137970","chr10","16649323","16649554","40","2511599"
"chr7","14149482","14149652","chr7","74190896","74191062","31","60041414"
"chr7","14155906","14156189","chr10","16665392","16665674","46","2509486"
"chr7","14161870","14162147","chr10","16671170","16671455","44","2509300"
"chr7","14170046","14170352","chr10","38650449","38650747","69","24480403"
"chr7","14194543","14194658","chr11","63045373","63045489","22","48850830"
"chr7","14194936","14195094","chr2B","27215557","27215713","31","13020621"
"chr7","14195105","14195416","chr10","16703321","16703640","44","2508216"
"chr7","14221690","14221992","chr10","16729805","16730115","56","2508115"
"chr7","14242270","14242562","chr10","16751408","16751715","50","2509138"
"chr7","14262396","14262680","chr16","22102863","22103155","61","7840467"
"chr7","14307335","14307615","chr10","16815209","16815516","61","2507874"
"chr7","14312829","14312950","chr8","28600846","28600965","23","14288017"
"chr7","14317805","14317897","chr10","16825122","16825201","27","2507317"
"chr7","14325683","14325952","chr7","79505748","79506040","70","65180065"
"chr7","14363658","14363772","chr8","79737740","79737854","29","65374082"
"chr7","14363984","14364048","chr6","123849557","123849615","22","109485573"
"chr7","14364323","14364449","chr10","16914882","16915004","18","2550559"
"chr7","14372028","14372151","chr12","109059002","109059125","20","94686974"
"chr7","14374882","14375186","chr2A","83770250","83770541","65","69395368"
"chr7","14377818","14378117","chr5","23931488","23931783","67","9553670"
"chr7","14382947","14383227","chr2A","10594477","10594761","56","3788470"
"chr7","14386012","14386302","chr10","16891652","16891944","58","2505640"
"chr7","14436884","14437189","chr10","16945369","16945665","45","2508485"
"chr7","14459367","14459535","chr10","16962017","16962178","27","2502650"
"chr7","14478073","14478377","chr10","16979326","16979632","44","2501253"
"chr7","14483302","14483600","chr10","16984181","16984474","48","2500879"
"chr7","14546011","14546249","chr10","17043990","17044234","36","2497979"
"chr7","14574425","14574642","chr6","146361614","146361839","40","131787189"
"chr7","14606110","14606333","chr10","64819340","64819560","48","50213230"
"chr7","14635755","14635910","chr1","93560424","93560585","32","78924669"
"chr7","14636245","14636279","chr8","60307446","60307479","5","45671201"
"chr7","14737323","14737586","chr10","17241957","17242232","45","2504634"
"chr7","14846363","14846478","chr5","6863862","6863979","19","7982501"
"chr7","14872252","14872539","chr5","116072084","116072367","52","101199832"
"chr7","14987264","14987543","chr10","17500910","17501201","35","2513646"
"chr7","14988982","14989273","chr10","17502592","17502858","58","2513610"
"chr7","15001499","15001760","chr5","33582906","33583180","63","18581407"
"chr7","15013800","15014172","chr12","36138978","36139354","126","21125178"
"chr7","15018213","15018496","chr10","17531214","17531485","60","2513001"
"chr7","15030629","15030828","chr10","17549412","17549633","48","2518783"
"chr7","15042636","15042855","chr19","37724259","37724478","48","22681623"
"chr7","15075431","15075732","chr16","16635749","16636060","52","1560318"
"chr7","15095296","15095572","chr8","124780862","124781130","66","109685566"
"chr7","15109677","15109929","chr3","100597156","100597398","56","85487479"
"chr7","15130568","15130683","chr18","22643681","22643795","17","7513113"
"chr7","15140138","15140366","chr19","16521553","16521779","54","1381415"
"chr7","15151087","15151381","chr10","17607862","17608158","40","2456775"
"chr7","15156674","15156948","chr10","17611472","17611747","38","2454798"
"chr7","15224369","15224642","chr10","17679218","17679498","43","2454849"
"chr7","15275250","15275542","chr10","17725097","17725392","37","2449847"
"chr7","15295427","15295721","chr8","59850782","59851072","82","44555355"
"chr7","15309046","15309332","chr2B","61322106","61322397","67","46013060"
"chr7","15309910","15310033","chr7","11248117","11248241","21","4061793"
"chr7","15340616","15340896","chr7","1708256","1708538","53","13632360"
"chr7","15349417","15349689","chr10","17795075","17795346","41","2445658"
"chr7","15375120","15375401","chr10","17824670","17824958","46","2449550"
"chr7","15384188","15384312","chr7","68201010","68201132","23","52816822"
"chr7","15434169","15434423","chr9","81981758","81982015","53","66547589"
"chr7","15439626","15439736","chr10","17908348","17908458","16","2468722"
"chr7","15457535","15457833","chr10","17938088","17938384","37","2480553"
"chr7","15466116","15466388","chr10","17948384","17948657","55","2482268"
"chr7","15488690","15488973","chr10","17969326","17969613","58","2480636"
"chr7","15546971","15547167","chr6","32732275","32732450","58","17185304"
"chr7","15563756","15564037","chr10","18042509","18042801","44","2478753"
"chr7","15565251","15565560","chr17","58257566","58257871","62","42692315"
"chr7","15570070","15570309","chr10","138285835","138286073","58","122715765"
"chr7","15570926","15571193","chr3","127863015","127863278","59","112292089"
"chr7","15584544","15584840","chr10","18061962","18062263","37","2477418"
"chr7","15599534","15599816","chr16","40088504","40088786","75","24488970"
"chr7","15600745","15601045","chr10","25393735","25394026","67","9792990"
"chr7","15636078","15636362","chr10","18122406","18122700","42","2486328"
"chr7","15640031","15640305","chr10","18125519","18125799","34","2485488"
"chr7","15647496","15647799","chr14","58916089","58916385","71","43268593"
"chr7","15652481","15652605","chr6","106910886","106911009","21","91258405"
"chr7","15674553","15674843","chr2A","61220081","61220370","61","45545528"
"chr7","15683010","15683279","chr10","18167508","18167782","38","2484498"
"chr7","15695811","15695958","chr1","205548459","205548612","35","189852648"
"chr7","15700495","15700771","chr7","12486340","12486629","68","3214155"
"chr7","15731367","15731664","chr10","18213337","18213642","41","2481970"
"chr7","15734472","15734770","chr10","18216935","18217244","45","2482463"
"chr7","15771770","15771878","chr1","159238201","159238311","22","143466431"
"chr7","15788229","15788373","chr20","32123638","32123783","36","16335409"
"chr7","15789262","15789541","chr10","129217595","129217874","58","113428333"
"chr7","15794797","15795083","chr3","131369946","131370239","58","115575149"
"chr7","15796010","15796298","chr5","163098845","163099124","71","147302835"
"chr7","15828553","15828839","chr10","18456579","18456881","39","2628026"
"chr7","15869190","15869474","chr10","18503776","18504060","46","2634586"
"chr7","15909314","15909603","chr5","88632023","88632310","66","72722709"
"chr7","15913349","15913678","chr10","18562152","18562477","45","2648803"
"chr7","15983863","15984165","chr10","18632595","18632905","41","2648732"
"chr7","16003477","16003616","chr1","148219593","148219735","30","132216116"
"chr7","16017824","16018112","chr16","1554262","1554542","63","14463562"
"chr7","16029264","16029406","chr3","155574758","155574899","32","139545494"
"chr7","16086998","16087284","chr4","154749915","154750182","69","138662917"
"chr7","16166730","16166980","chr14","34588858","34589105","63","18422128"
"chr7","16179016","16179136","chr10","18828471","18828593","15","2649455"
"chr7","16183662","16183937","chr10","18834945","18835221","35","2651283"
"chr7","16186058","16186159","chr18","48326419","48326520","31","32140361"
"chr7","16196211","16196490","chr10","18846013","18846294","30","2649802"
"chr7","16209344","16209507","chr10","18855315","18855496","33","2645971"
"chr7","16223326","16223617","chr10","18870664","18870975","52","2647338"
"chr7","16233922","16234160","chr7","32821026","32821256","46","16587104"
"chr7","16263318","16263449","chr12","29897183","29897312","21","13633865"
"chr7","16264523","16264683","chr19","15955029","15955193","29","309494"
"chr7","16265121","16265329","chr10","18913194","18913391","36","2648073"
"chr7","16291983","16292127","chr14","86999208","86999349","36","70707225"
"chr7","16295056","16295332","chr7","5095566","5095848","61","11199490"
"chr7","16306836","16307093","chr10","18948656","18948908","40","2641820"
"chr7","16331265","16331564","chr12","109310786","109311086","78","92979521"
"chr7","16332680","16332964","chr10","18973691","18973973","60","2641011"
"chr7","16396215","16396318","chr12","1702","1809","17","16394513"
"chr7","16413651","16413988","chr10","19080029","19080375","56","2666378"
"chr7","16420141","16420426","chrUn_CABD030131081v1","5858","6133","72","16414283"
"chr7","16420744","16420882","chr15","47740161","47740299","28","31319417"
"chr7","16420892","16420972","chr9","95622048","95622129","20","79201156"
"chr7","16430795","16431079","chr10","19123501","19123791","45","2692706"
"chr7","16455219","16455383","chr19","18112321","18112488","34","1657102"
"chr7","16508983","16509265","chr10","19188627","19188907","32","2679644"
"chr7","16511927","16512224","chr22","19336980","19337272","63","2825053"
"chr7","16594199","16594506","chr10","19281678","19281984","42","2687479"
"chr7","16641026","16641113","chr19","54412613","54412687","22","37771587"
"chr7","16701113","16701337","chr1","217294594","217294821","51","200593481"
"chr7","16735172","16735270","chr15","37513750","37513848","14","20778578"
"chr7","16775004","16775112","chr10","91291144","91291253","20","74516140"
"chr7","16797448","16797754","chr10","19496520","19496817","54","2699072"
"chr7","16880279","16880557","chr10","19608333","19608631","51","2728054"
"chr7","16902869","16902999","chr10","19635885","19636013","18","2733016"
"chr7","16909271","16909542","chr10","19642320","19642596","48","2733049"
"chr7","17083814","17083935","chr10","22151655","22151780","18","5067841"
"chr7","17139363","17139644","chr7","1708256","1708538","60","15431107"
"chr7","17254548","17254673","chr3","188313519","188313645","27","171058971"
"chr7","17319093","17319403","chr9","95923564","95923862","68","78604471"
"chr7","17323604","17323906","chr10","22407748","22408051","35","5084144"
"chr7","17338353","17338671","chr10","22422102","22422398","56","5083749"
"chr7","17374363","17374619","chr10","22461658","22461918","26","5087295"
"chr7","17410945","17411223","chr10","22491877","22492150","33","5080932"
"chr7","17428181","17428284","chr19","15219953","15220058","27","2208228"
"chr7","17441312","17441599","chr10","22524178","22524481","44","5082866"
"chr7","17442449","17442748","chr10","22525315","22525625","47","5082866"
"chr7","17482991","17483093","chr1","45273792","45273898","27","27790801"
"chr7","17523680","17523891","chr7","152683704","152683910","45","135160024"
"chr7","17547470","17547770","chr14","58316895","58317188","69","40769425"
"chr7","17603017","17603157","chr15","69740012","69740164","37","52136995"
"chr7","17618435","17618600","chr6","118855023","118855193","37","101236588"
"chr7","17643893","17644218","chr1","200429277","200429592","72","182785384"
"chr7","17681507","17681795","chr4","196411576","196411860","63","178730069"
"chr7","17712031","17712346","chr10","22797041","22797377","71","5085010"
"chr7","17713511","17713638","chr7","72008463","72008589","18","54294952"
"chr7","17736908","17737154","chr20","2115422","2115666","64","15621486"
"chr7","17747330","17747626","chr10","22839376","22839662","55","5092046"
"chr7","17775481","17775772","chr10","22868673","22868963","35","5093192"
"chr7","17790612","17790901","chr10","22883809","22884099","40","5093197"
"chr7","17800405","17800717","chr10","22894930","22895241","68","5094525"
"chr7","18005984","18006284","chr10","23114553","23114852","53","5108569"
"chr7","18036711","18037004","chr6","31711452","31711745","69","13674741"
"chr7","18085033","18085324","chr10","23208644","23208949","49","5123611"
"chr7","18110860","18111161","chr1","44801547","44801840","65","26690687"
"chr7","18178246","18178515","chr10","23302742","23303015","31","5124496"
"chr7","18190402","18190682","chr10","23321404","23321699","42","5131002"
"chr7","18213878","18214031","chr7","78925352","78925506","27","60711474"
"chr7","18225086","18225327","chr10","23357194","23357469","71","5132108"
"chr7","18244377","18244489","chr12","113144463","113144580","21","94900086"
"chr7","18250790","18251088","chr1","204490393","204490705","70","186239603"
"chr7","18293614","18293738","chr10","23441195","23441319","15","5147581"
"chr7","18340072","18340393","chr10","23484268","23484581","45","5144196"
"chr7","18362276","18362544","chr10","23508681","23508963","55","5146405"
"chr7","18472060","18472339","chr10","23617203","23617489","51","5145143"
"chr7","18507491","18507775","chr5","52985134","52985425","58","34477643"
"chr7","18548227","18548516","chr10","23697224","23697528","50","5148997"
"chr7","18613009","18613305","chr10","23771396","23771689","54","5158387"
"chr7","18617470","18617789","chr10","23776219","23776525","48","5158749"
"chr7","18623065","18623360","chr10","23781470","23781766","38","5158405"
"chr7","18623731","18623848","chr10","23782135","23782252","7","5158404"
"chr7","18624581","18624894","chr10","23782690","23782989","61","5158109"
"chr7","18654449","18654729","chr10","23809062","23809342","33","5154613"
"chr7","18665216","18665516","chr10","23819107","23819422","36","5153891"
"chr7","18723890","18724172","chr10","23872629","23872912","41","5148739"
"chr7","18725911","18726163","chr4","92063681","92063949","64","73337770"
"chr7","18738488","18738780","chr10","23889028","23889327","46","5150540"
"chr7","18744808","18745076","chr10","23895352","23895626","48","5150544"
"chr7","18749761","18750043","chr10","23900198","23900476","42","5150437"
"chr7","18770251","18770556","chr10","23930277","23930588","39","5160026"
"chr7","18779410","18779571","chr10","101197297","101197462","36","82417887"
"chr7","18804345","18804467","chr10","23966464","23966591","23","5162119"
"chr7","18818792","18819007","chr6","161219496","161219756","78","142400704"
"chr7","18825194","18825482","chr10","23989285","23989584","41","5164091"
"chr7","18825589","18825671","chr17","1023175","1023259","19","17802414"
"chr7","18833933","18834203","chr12","647259","647523","66","18186674"
"chr7","18837366","18837670","chr10","24004653","24004949","49","5167287"
"chr7","18855167","18855464","chr3","158711856","158712151","59","139856689"
"chr7","18882373","18882550","chr16","19967842","19968013","45","1085469"
"chr7","18883436","18883599","chr22","20635435","20635596","37","1751999"
"chr7","18899682","18899976","chr10","29442051","29442345","58","10542369"
"chr7","18933149","18933359","chr12","118865454","118865663","35","99932305"
"chr7","18935161","18935449","chrX","154566937","154567220","62","135631776"
"chr7","18941201","18941437","chr10","24130772","24131008","38","5189571"
"chr7","18944353","18944601","chr13","23861563","23861812","90","4917210"
"chr7","18944952","18945244","chr10","24139042","24139344","45","5194090"
"chr7","18950426","18950667","chr10","24148167","24148415","32","5197741"
"chr7","18959893","18960186","chr10","24168998","24169300","42","5209105"
"chr7","18965926","18966106","chr14","9916497","9916673","34","9049429"
"chr7","18966554","18966856","chr1","91797771","91798062","54","72831217"
"chr7","18981286","18981592","chr10","24190380","24190674","46","5209094"
"chr7","18981881","18982153","chr10","24190949","24191230","37","5209068"
"chr7","18994724","18994938","chr10","117561039","117561252","51","98566315"
"chr7","18996466","18996747","chr7","73083255","73083530","55","54086789"
"chr7","19006205","19006498","chr10","24213667","24213976","48","5207462"
"chr7","19017516","19017815","chr2A","64149282","64149582","57","45131766"
"chr7","19039663","19039959","chr10","24252522","24252825","44","5212859"
"chr7","19040067","19040348","chr10","24252929","24253201","59","5212862"
"chr7","19040858","19041106","chr3","126229807","126230045","68","107188949"
"chr7","19044261","19044554","chr10","24259149","24259444","49","5214888"
"chr7","19044890","19045010","chr10","24260124","24260245","15","5215234"
"chr7","19058457","19058620","chr12","19312537","19312701","31","254080"
"chr7","19077498","19077615","chr2B","8458103","8458220","18","10619395"
"chr7","19165056","19165345","chr10","53417162","53417448","66","34252106"
"chr7","19174437","19174591","chr12","123366786","123366946","34","104192349"
"chr7","19191010","19191135","chr12","3303","3428","24","19187707"
"chr7","19213102","19213218","chr5","117817000","117817115","24","98603898"
"chr7","19216007","19216299","chr5","45496228","45496519","41","26280221"
"chr7","19216598","19216858","chr10","29441110","29441370","70","10224512"
"chr7","19220999","19221115","chr1","82573570","82573687","17","63352571"
"chr7","19221210","19221467","chr5","144026981","144027239","67","124805771"
"chr7","19236451","19236601","chr3","115315740","115315885","38","96079289"
"chr7","19257844","19258118","chr10","24465845","24466145","64","5208001"
"chr7","19286029","19286339","chrX","119498447","119498725","87","100212418"
"chr7","19309098","19309387","chr9","51937276","51937568","69","32628178"
"chr7","19314592","19314745","chr4","83983716","83983868","38","64669124"
"chr7","19320240","19320358","chr7","71918824","71918957","30","52598584"
"chr7","19340910","19341100","chr10","24535045","24535261","45","5194135"
"chr7","19357513","19357609","chrX","46325766","46325860","15","26968253"
"chr7","19365878","19366010","chr8","26248983","26249114","36","6883105"
"chr7","19376646","19376820","chr10","24570065","24570258","46","5193419"
"chr7","19378641","19378787","chr2A","97441991","97442142","36","78063350"
"chr7","19379471","19379752","chr10","24573218","24573476","64","5193747"
"chr7","19383477","19383683","chr18","74436813","74437020","55","55053336"
"chr7","19390864","19391012","chr9","51122441","51122590","33","31731577"
"chr7","19401197","19401322","chr1","19204659","19204783","32","196538"
"chr7","19414241","19414531","chr19","50100637","50100935","66","30686396"
"chr7","19421821","19422107","chr10","15446393","15446669","82","3975428"
"chr7","19435947","19436083","chr1","148219593","148219735","33","128783646"
"chr7","19675350","19675495","chr1","6184415","6184559","34","13490935"
"chr7","19675533","19675693","chr5","62837108","62837270","38","43161575"
"chr7","19680789","19680903","chr10","24878367","24878481","15","5197578"
"chr7","19702213","19702507","chr11","119544081","119544379","58","99841868"
"chr7","19710425","19710709","chr10","24918256","24918534","43","5207831"
"chr7","19760997","19761127","chr3","158353785","158353905","45","138592788"
"chr7","19762079","19762228","chr10","24972033","24972167","35","5209954"
"chr7","19765868","19766143","chr10","24985338","24985616","30","5219470"
"chr7","19771191","19771490","chr8","49032628","49032928","59","29261437"
"chr7","19774304","19774597","chr10","24994685","24994983","32","5220381"
"chr7","19792219","19792518","chr10","25008370","25008657","49","5216151"
"chr7","19804609","19804874","chrX","55058382","55058655","61","35253773"
"chr7","19805489","19805782","chr10","25020000","25020294","30","5214511"
"chr7","19819070","19819300","chr19","8835301","8835534","48","10983769"
"chr7","19834121","19834416","chr1","45616536","45616828","67","25782415"
"chr7","19843523","19843755","chr10","25056289","25056514","27","5212766"
"chr7","19868792","19868915","chr12","29025232","29025356","14","9156440"
"chr7","19883873","19884178","chr10","25093640","25093950","55","5209767"
"chr7","19887267","19887569","chr4","158626903","158627199","55","138739636"
"chr7","19888377","19888659","chr3","199533704","199533988","56","179645327"
"chr7","19902132","19902415","chr10","25111901","25112190","35","5209769"
"chr7","19918010","19918298","chr10","25136212","25136501","37","5218202"
"chr7","19986261","19986539","chr10","25224684","25224976","51","5238423"
"chr7","20001409","20001705","chr10","25239603","25239867","57","5238194"
"chr7","20005688","20005810","chr9","11678223","11678343","23","8327465"
"chr7","20026639","20026943","chr5","15880496","15880786","73","4146143"
"chr7","20061371","20061678","chr10","25303615","25303901","46","5242244"
"chr7","20062234","20062561","chr10","25304476","25304797","42","5242242"
"chr7","20065674","20065970","chr10","25307799","25308095","38","5242125"
"chr7","20067462","20067765","chr5","8034473","8034757","59","12032989"
"chr7","20071063","20071186","chr10","25313308","25313429","11","5242245"
"chr7","20092180","20092483","chr10","25333805","25334073","69","5241625"
"chr7","20093904","20094169","chr10","25335588","25335857","31","5241684"
"chr7","20099943","20100226","chr10","25345253","25345534","26","5245310"
"chr7","20108025","20108255","chr3","51729090","51729342","71","31621065"
"chr7","20110889","20111181","chr3","124647645","124647948","66","104536756"
"chr7","20117162","20117352","chr11","58619029","58619230","53","38501867"
"chr7","20119421","20119702","chr11","18129249","18129529","61","1990172"
"chr7","20153993","20154201","chrX","70798785","70798992","54","50644792"
"chr7","20155124","20155366","chr10","25377929","25378154","57","5222805"
"chr7","20170440","20170531","chr5","138623546","138623638","12","118453106"
"chr7","20216453","20216736","chr10","25451269","25451573","60","5234816"
"chr7","20224263","20224538","chr10","25463245","25463491","54","5238982"
"chr7","20227125","20227429","chr10","25465739","25466041","36","5238614"
"chr7","20258536","20258845","chr10","25493362","25493668","66","5234826"
"chr7","20264223","20264522","chr19","56214351","56214649","55","35950128"
"chr7","20269941","20270136","chrX","31105155","31105351","47","10835214"
"chr7","20281677","20281976","chr10","25518454","25518748","69","5236777"
"chr7","20295442","20295696","chr5","26236271","26236532","66","5940829"
"chr7","20306797","20306921","chr16","26009514","26009638","24","5702717"
"chr7","20306924","20306993","chr14","87252225","87252301","21","66945301"
"chr7","20308075","20308371","chr10","25545548","25545840","58","5237473"
"chr7","20309993","20310278","chr10","25547532","25547814","43","5237539"
"chr7","20324228","20324526","chr10","25562169","25562476","38","5237941"
"chr7","20328047","20328163","chr3","49034166","49034278","22","28706119"
"chr7","20329834","20330116","chr10","25567842","25568109","66","5238008"
"chr7","20340420","20340717","chr10","25580220","25580551","59","5239800"
"chr7","20341833","20341960","chr1","227015844","227015973","26","206674011"
"chr7","20345672","20345993","chr10","25585092","25585405","46","5239420"
"chr7","20346229","20346415","chr10","25585619","25585813","34","5239390"
"chr7","20358106","20358377","chr5","23795056","23795315","64","3436950"
"chr7","20358878","20359163","chr10","25595792","25596078","35","5236914"
"chr7","20378609","20378902","chr3","173048201","173048485","68","152669592"
"chr7","20394344","20394447","chr10","27439136","27439242","20","7044792"
"chr7","20406827","20407013","chr1","47843988","47844174","47","27437161"
"chr7","20407729","20407806","chr6","18295705","18295781","12","2112024"
"chr7","20431346","20431637","chr7","17907526","17907821","52","2523820"
"chr7","20436846","20436971","chr10","25679720","25679846","18","5242874"
"chr7","20462706","20462885","chr7","78958517","78958686","45","58495811"
"chr7","20474202","20474459","chr10","25716811","25717048","57","5242609"
"chr7","20521983","20522188","chr3","101529162","101529367","43","81007179"
"chr7","20522713","20523013","chr5","24080030","24080335","72","3557317"
"chr7","20607214","20607338","chr10","25862791","25862915","16","5255577"
"chr7","20675842","20676140","chr10","25933973","25934278","50","5258131"
"chr7","20762571","20762862","chr10","26012529","26012828","64","5249958"
"chr7","20776616","20776748","chr10","26035685","26035823","19","5259069"
"chr7","20798459","20798618","chr7","74190896","74191062","34","53392437"
"chr7","20798739","20798837","chr1","157737408","157737505","16","136938669"
"chr7","20798951","20799261","chr19","29702600","29702888","93","8903649"
"chr7","20833727","20834013","chr1","158365862","158366158","69","137532135"
"chr7","20863355","20863646","chr10","26134864","26135154","57","5271509"
"chr7","20875662","20875785","chr5","3204343","3204464","25","17671319"
"chr7","20879416","20879626","chr10","116999784","116999992","46","96120368"
"chr7","20879711","20879976","chr10","26159788","26160068","42","5280077"
"chr7","20905355","20905417","chr5","39305022","39305085","14","18399667"
"chr7","20907293","20907557","chr19","3205542","3205801","57","17701751"
"chr7","20912383","20912678","chr10","26195652","26195940","40","5283269"
"chr7","20915633","20915940","chr10","26198859","26199166","40","5283226"
"chr7","20920764","20921045","chr10","26203997","26204292","61","5283233"
"chr7","20942587","20942874","chr10","26228324","26228623","43","5285737"
"chr7","20943577","20943876","chr10","26229322","26229632","51","5285745"
"chr7","20950542","20950662","chr2A","89185427","89185551","20","68234885"
"chr7","20952489","20952629","chr22","14987426","14987566","23","5965063"
"chr7","20953807","20954108","chrX","9641509","9641809","69","11312298"
"chr7","20957693","20957978","chr10","26246269","26246549","31","5288576"
"chr7","20970678","20970970","chr12","121913892","121914192","55","100943214"
"chr7","20979189","20979491","chr10","26270522","26270830","42","5291333"
"chr7","20979571","20979866","chr8","144786356","144786646","62","123806785"
"chr7","20981943","20982070","chr8","9176979","9177104","31","11804964"
"chr7","20989421","20989730","chr10","26277502","26277813","59","5288081"
"chr7","20990226","20990362","chr1","30924840","30924975","25","9934614"
"chr7","20993394","20993476","chr1","49485714","49485797","16","28492320"
"chr7","20995692","20995955","chr10","26286313","26286609","60","5290621"
"chr7","21022909","21023218","chr11","130654963","130655260","74","109632054"
"chr7","21032096","21032379","chr10","26323442","26323721","51","5291346"
"chr7","21032397","21032502","chr9","114050761","114050871","22","93018364"
"chr7","21038912","21039237","chr10","26330074","26330395","40","5291162"
"chr7","21050769","21051070","chr10","26339290","26339596","40","5288521"
"chr7","21052261","21052548","chr10","26340830","26341116","25","5288569"
"chr7","21057513","21057820","chr10","26345784","26346092","39","5288271"
"chr7","21061010","21061312","chr10","26351932","26352229","45","5290922"
"chr7","21061703","21061964","chr10","26352917","26353178","55","5291214"
"chr7","21063168","21063450","chr10","26354360","26354650","53","5291192"
"chr7","21073158","21073460","chr3","58838518","58838809","83","37765360"
"chr7","21080418","21080719","chr1","11857637","11857938","64","9222781"
"chr7","21089813","21089903","chr10","26363865","26363960","16","5274052"
"chr7","21090645","21090793","chr1","68709407","68709549","33","47618762"
"chr7","21091285","21091598","chr10","26365425","26365735","53","5274140"
"chr7","21122293","21122585","chr10","26397638","26397925","43","5275345"
"chr7","21132771","21133110","chr12","124713628","124713954","86","103580857"
"chr7","21156686","21156980","chr10","26453722","26454032","43","5297036"
"chr7","21167904","21168210","chr6","36972459","36972767","69","15804555"
"chr7","21175651","21175771","chr10","26471495","26471617","14","5295844"
"chr7","21197428","21197720","chr10","26510873","26511165","32","5313445"
"chr7","21205595","21205887","chr7","76460127","76460416","63","55254532"
"chr7","21206407","21206527","chr7","11248117","11248241","20","9958290"
"chr7","21241420","21241723","chr10","26545498","26545803","36","5304078"
"chr7","21265947","21266230","chr10","26560599","26560893","47","5294652"
"chr7","21330953","21331269","chr10","26632223","26632512","53","5301270"
"chr7","21335798","21336072","chr7","28366007","28366296","63","7030209"
"chr7","21357412","21357639","chr9","119026785","119027009","58","97669373"
"chr7","21360704","21360842","chr5","34700212","34700348","22","13339508"
"chr7","21379777","21380080","chr10","26683098","26683408","45","5303321"
"chr7","21387423","21387674","chr10","26691237","26691489","28","5303814"
"chr7","21412015","21412099","chr10","26720681","26720773","14","5308666"
"chr7","21501514","21501824","chr10","26807415","26807693","57","5305901"
"chr7","21503216","21503492","chr10","26811108","26811388","29","5307892"
"chr7","21594287","21594600","chr10","26910621","26910938","40","5316334"
"chr7","21635682","21635943","chr10","26950208","26950471","39","5314526"
"chr7","21661596","21661905","chr10","26989040","26989331","77","5327444"
"chr7","21663370","21663651","chr10","26990485","26990768","31","5327115"
"chr7","21708340","21708635","chr10","27028290","27028585","33","5319950"
"chr7","21758816","21759122","chr7","78818816","78819119","70","57060000"
"chr7","21766167","21766443","chr10","27091197","27091480","44","5325030"
"chr7","21769252","21769565","chr10","27094282","27094592","59","5325030"
"chr7","21792898","21793202","chr10","27116158","27116462","40","5323260"
"chr7","21793891","21794101","chr10","27117159","27117365","34","5323268"
"chr7","21797184","21797475","chr10","27120547","27120826","58","5323363"
"chr7","21818713","21818837","chr9","114196210","114196334","20","92377497"
"chr7","21829679","21829843","chr9","111036888","111037053","30","89207209"
"chr7","21830920","21831225","chr10","27154824","27155108","60","5323904"
"chr7","21838316","21838432","chr10","27162996","27163114","15","5324680"
"chr7","21845812","21846144","chr10","27169589","27169907","60","5323777"
"chr7","21855947","21856071","chr10","86956281","86956404","18","65100334"
"chr7","21869956","21870255","chr10","27194382","27194689","40","5324426"
"chr7","21873683","21873978","chr10","27201330","27201627","34","5327647"
"chr7","21875085","21875289","chrX","48678555","48678774","55","26803470"
"chr7","21890595","21890711","chr8","145313247","145313365","15","123422652"
"chr7","21893903","21894034","chr7","109842246","109842373","40","87948343"
"chr7","21894755","21895023","chr10","27222647","27222917","38","5327892"
"chr7","21902590","21902875","chr10","27229578","27229877","52","5326988"
"chr7","21921197","21921477","chr10","27247431","27247718","36","5326234"
"chr7","21936059","21936355","chr10","27262097","27262410","54","5326038"
"chr7","21937235","21937554","chr10","27263327","27263652","66","5326092"
"chr7","21942652","21942922","chr10","27269114","27269409","67","5326462"
"chr7","21947732","21948003","chr1","225636386","225636668","49","203688654"
"chr7","21960406","21960702","chr10","27285075","27285397","63","5324669"
"chr7","21968092","21968374","chr10","87543228","87543511","56","65575136"
"chr7","22006568","22006872","chr10","27331152","27331440","53","5324584"
"chr7","22008399","22008464","chr9","112801477","112801541","17","90793078"
"chr7","22008687","22008862","chr7","78958517","78958686","53","56949830"
"chr7","22031074","22031376","chr6","146323295","146323593","56","124292221"
"chr7","22033223","22033535","chr10","27360448","27360767","45","5327225"
"chr7","22056376","22056662","chr10","27383612","27383908","54","5327236"
"chr7","22072183","22072472","chr10","27398296","27398578","57","5326113"
"chr7","22103072","22103313","chr7","103212390","103212635","65","81109318"
"chr7","22106882","22107179","chr10","27431362","27431654","39","5324480"
"chr7","22124322","22124635","chr2B","117131116","117131424","67","95006794"
"chr7","22168540","22168828","chr5","1893830","1894113","55","20274710"
"chr7","22219132","22219262","chr10","27559624","27559748","18","5340492"
"chr7","22230593","22230690","chr13","141037","141132","19","22089556"
"chr7","22270581","22270775","chr2B","134783878","134784074","49","112513297"
"chr7","22296686","22296949","chr2A","64538464","64538725","55","42241778"
"chr7","22303181","22303275","chr10","27648911","27649005","8","5345730"
"chr7","22304484","22304691","chr10","27650611","27650834","44","5346127"
"chr7","22306971","22307040","chr12","130224589","130224659","9","107917618"
"chr7","22325674","22325793","chr10","27677131","27677252","10","5351457"
"chr7","22334933","22335238","chr10","27688223","27688507","61","5353290"
"chr7","22342356","22342476","chr10","27696389","27696514","20","5354033"
"chr7","22343949","22344069","chr10","27698027","27698150","18","5354078"
"chr7","22357510","22357814","chr10","27710470","27710773","32","5352960"
"chr7","22369104","22369394","chr10","27722997","27723286","39","5353893"
"chr7","22372454","22372571","chr12","113288103","113288219","17","90915649"
"chr7","22376606","22376910","chr10","27744380","27744695","50","5367774"
"chr7","22399430","22399713","chr10","27763034","27763338","63","5363604"
"chr7","22400887","22400983","chr10","27764518","27764619","13","5363631"
"chr7","22401801","22402084","chr7","4624751","4625025","69","17777050"
"chr7","22406756","22407042","chr10","27769821","27770103","35","5363065"
"chr7","22412454","22412586","chr2A","20545290","20545415","39","1867164"
"chr7","22425920","22426084","chr10","27788003","27788167","23","5362083"
"chr7","22428162","22428426","chr4","4726233","4726503","57","17701929"
"chr7","22430754","22431061","chr9","102131279","102131578","71","79700525"
"chr7","22437954","22438200","chr19","201368","201610","51","22236586"
"chr7","22450086","22450387","chr1","24510394","24510695","60","2060308"
"chr7","22453231","22453352","chr1","129646866","129646990","20","107193635"
"chr7","22459490","22459753","chr10","27820579","27820844","44","5361089"
"chr7","22464366","22464526","chr2B","98890305","98890466","40","76425939"
"chr7","22484611","22484906","chr10","27856506","27856804","41","5371895"
"chr7","22491732","22492039","chr10","27864728","27865032","37","5372996"
"chr7","22493029","22493303","chr10","27865686","27865977","51","5372657"
"chr7","22503484","22503626","chr12","69428696","69428838","32","46925212"
"chr7","22518177","22518464","chr10","27891124","27891423","44","5372947"
"chr7","22551016","22551224","chr10","27919070","27919294","44","5368054"
"chr7","22582755","22583010","chr10","27954581","27954867","50","5371826"
"chr7","22595177","22595454","chr10","13294329","13294605","57","9300848"
"chr7","22608933","22609080","chr20","4922306","4922451","30","17686627"
"chr7","22637067","22637213","chr6","18561333","18561479","32","4075734"
"chr7","22648589","22648898","chr10","28025514","28025810","45","5376925"
"chr7","22659944","22660225","chr10","28023619","28023928","70","5363675"
"chr7","22692557","22692861","chr10","28063255","28063556","46","5370698"
"chr7","22700877","22701136","chr9","91685420","91685668","59","68984543"
"chr7","22706574","22706694","chr7","11248117","11248241","19","11458457"
"chr7","22712835","22712969","chr10","28089222","28089346","23","5376387"
"chr7","22769277","22769480","chr10","28150038","28150248","36","5380761"
"chr7","22811374","22811654","chr10","28203203","28203505","59","5391829"
"chr7","22861159","22861451","chr10","28249023","28249320","45","5387864"
"chr7","22867820","22868121","chr10","28255971","28256259","37","5388151"
"chr7","23030630","23030737","chr10","105655931","105656038","16","82625301"
"chr7","23095433","23095720","chr10","28404946","28405232","53","5309513"
"chr7","23260706","23260832","chr10","28573114","28573241","15","5312408"
"chr7","23264741","23265033","chr10","28577029","28577316","36","5312288"
"chr7","23269083","23269347","chr4","74466295","74466566","63","51197212"
"chr7","23288692","23288824","chr1","78122719","78122850","35","54834027"
"chr7","23290110","23290255","chr22","8436942","8437088","26","14853168"
"chr7","23388419","23388714","chr10","28706971","28707258","35","5318552"
"chr7","23400983","23401270","chr10","28723454","28723766","68","5322471"
"chr7","23499505","23499761","chr2A","89011734","89011984","66","65512229"
"chr7","23520024","23520255","chr14","89186226","89186465","58","65666202"
"chr7","23522584","23522873","chr2B","116532287","116532579","58","93009703"
"chr7","23534847","23534961","chr6","38593130","38593246","22","15058283"
"chr7","23588688","23588986","chr10","28913470","28913772","59","5324782"
"chr7","23595279","23595559","chr10","28926231","28926514","37","5330952"
"chr7","23614306","23614380","chr12","129624083","129624153","20","106009777"
"chr7","23678104","23678402","chr5","17581066","17581365","74","6097038"
"chr7","23686736","23687032","chr10","29045132","29045431","46","5358396"
"chr7","23798615","23798763","chr19","39910881","39911043","47","16112266"
"chr7","23798958","23799246","chr10","29158119","29158421","46","5359161"
"chr7","23819041","23819318","chr10","29177777","29178045","59","5358736"
"chr7","23884178","23884453","chr10","29240229","29240509","54","5356051"
"chr7","23898909","23899022","chr10","12591333","12591447","29","11307576"
"chr7","23937308","23937589","chr10","29292456","29292743","38","5355148"
"chr7","23954940","23955231","chr10","29318692","29318995","39","5363752"
"chr7","23967575","23967701","chr19","33560805","33560928","20","9593230"
"chr7","23978195","23978361","chr10","29338384","29338545","21","5360189"
"chr7","23979363","23979666","chr1","32451497","32451790","68","8472134"
"chr7","23986553","23986811","chr11","71756217","71756469","88","47769664"
"chr7","23989499","23989770","chr5","126463867","126464143","61","102474368"
"chr7","24000252","24000385","chr2A","32837534","32837666","23","8837282"
"chr7","24015263","24015554","chr10","29395604","29395905","36","5380341"
"chr7","24016558","24016859","chr10","29396840","29397147","38","5380282"
"chr7","24019019","24019301","chr10","29399097","29399387","42","5380078"
"chr7","24019865","24020070","chr10","29399930","29400133","40","5380065"
"chr7","24033286","24033576","chr10","29413671","29413987","54","5380385"
"chr7","24040387","24040664","chr10","29423333","29423626","49","5382946"
"chr7","24045450","24045651","chr13","7976473","7976675","35","16068977"
"chr7","24066667","24066794","chr10","29440372","29440489","21","5373705"
"chr7","24067357","24067605","chr10","29441110","29441370","51","5373753"
"chr7","24068279","24068575","chr10","29442051","29442345","40","5373772"
"chr7","24071169","24071452","chr10","29445310","29445592","21","5374141"
"chr7","24091174","24091255","chrX","76556826","76556908","18","52465652"
"chr7","24092083","24092249","chr1","23183624","23183790","31","908459"
"chr7","24110642","24110941","chr3","124958693","124958983","65","100848051"
"chr7","24115968","24116262","chr1","125528862","125529159","60","101412894"
"chr7","24124497","24124804","chr10","29505662","29505974","57","5381165"
"chr7","24128822","24128935","chr10","29528114","29528237","26","5399292"
"chr7","24131787","24131910","chr10","29531860","29531984","18","5400073"
"chr7","24134674","24134800","chr10","29852296","29852420","24","5717622"
"chr7","24137334","24137459","chr10","29525225","29525349","17","5387891"
"chr7","24140264","24140360","chrX","41787655","41787753","22","17647391"
"chr7","24143411","24143536","chr10","29525225","29525349","15","5381814"
"chr7","24162654","24162950","chr10","16534437","16534738","67","7628217"
"chr7","24170074","24170198","chr10","29531860","29531984","18","5361786"
"chr7","24172651","24172777","chr4","202926705","202926829","22","178754054"
"chr7","24180882","24181149","chr7","28949653","28949918","68","4768771"
"chr7","24181219","24181423","chr1","94804550","94804754","49","70623331"
"chr7","24227342","24227460","chr10","29626989","29627107","9","5399647"
"chr7","24239080","24239359","chr7","6328163","6328440","58","17910917"
"chr7","24252483","24252658","chrX","140700059","140700234","40","116447576"
"chr7","24260804","24261080","chr10","29663249","29663537","47","5402445"
"chr7","24278134","24278374","chr10","29681459","29681685","36","5403325"
"chr7","24317530","24317829","chr10","29718909","29719213","50","5401379"
"chr7","24332159","24332291","chr5","133578375","133578499","36","109246216"
"chr7","24337151","24337433","chr10","29738555","29738854","42","5401404"
"chr7","24337633","24337958","chr10","89207110","89207445","86","64869477"
"chr7","24367128","24367428","chr10","29765508","29765791","45","5398380"
"chr7","24376129","24376416","chr1","141431251","141431532","68","117055122"
"chr7","24385463","24385648","chr6","5000449","5000640","47","19385014"
"chr7","24424323","24424435","chr10","30131676","30131793","14","5707353"
"chr7","24424679","24424776","chr9","117372444","117372539","21","92947765"
"chr7","24430456","24430721","chr10","30122835","30123107","31","5692379"
"chr7","24435410","24435693","chr10","30117827","30118120","47","5682417"
"chr7","24467069","24467362","chr18","176312","176607","32","24290757"
"chr7","24477631","24477885","chr8","19323097","19323353","69","5154534"
"chr7","24478178","24478325","chr10","30076077","30076237","27","5597899"
"chr7","24503975","24504092","chr6","38593130","38593246","24","14089155"
"chr7","24529857","24530125","chr5","79883377","79883636","63","55353520"
"chr7","24552043","24552335","chr6","152053807","152054108","74","127501764"
"chr7","24558802","24559041","chr10","59734122","59734357","65","35175320"
"chr7","24569633","24569923","chr7","76146308","76146602","55","51576675"
"chr7","24574565","24574865","chr19","7209331","7209631","64","17365234"
"chr7","24576572","24576844","chrX","136289306","136289563","66","111712734"
"chr7","24585028","24585154","chr3","65193379","65193500","18","40608351"
"chr7","24606964","24607265","chr19","7209331","7209631","63","17397633"
"chr7","24608987","24609259","chrX","136289306","136289563","66","111680319"
"chr7","24613620","24613746","chr3","65193379","65193500","16","40579759"
"chr7","24692160","24692288","chr16","44372652","44372778","24","19680492"
"chr7","24692833","24692981","chr16","43974403","43974560","42","19281570"
"chr7","24706775","24706952","chr10","29926349","29926540","33","5219574"
"chr7","24726210","24726329","chr10","29528114","29528237","20","4801904"
"chr7","24729109","24729234","chr10","29531860","29531984","18","4802751"
"chr7","24742492","24742642","chr1","46271276","46271424","27","21528784"
"chr7","24761526","24761608","chr11","43550790","43550868","17","18789264"
"chr7","24762290","24762554","chr7","66323316","66323582","58","41561026"
"chr7","24770292","24770590","chr10","93432069","93432355","37","68661777"
"chr7","24812878","24813124","chr19","34498799","34499028","69","9685921"
"chr7","24847952","24848253","chrX","46332349","46332654","67","21484397"
"chr7","24855167","24855366","chr9","108840447","108840646","49","83985280"
"chr7","24872548","24872828","chr15","33570637","33570920","66","8698089"
"chr7","24903051","24903334","chr10","93283896","93284179","37","68380845"
"chr7","24903772","24904054","chr18","2916911","2917197","58","21986861"
"chr7","24906126","24906198","chr8","59313025","59313096","22","34406899"
"chr7","24906210","24906342","chr1","55323203","55323336","32","30416993"
"chr7","24916001","24916291","chr7","76460127","76460416","68","51544126"
"chr7","24923025","24923324","chr10","93261283","93261586","40","68338258"
"chr7","24946241","24946538","chr7","37846658","37846957","66","12900417"
"chr7","24964704","24965007","chr10","93222458","93222760","39","68257754"
"chr7","24973890","24974036","chr10","93212676","93212834","40","68238786"
"chr7","24986780","24987034","chr10","25867381","25867626","65","880601"
"chr7","25002763","25003064","chr10","93176167","93176454","62","68173404"
"chr7","25045959","25046248","chr10","93124872","93125174","64","68078913"
"chr7","25047322","25047607","chr10","93123789","93124073","33","68076467"
"chr7","25054534","25054770","chr1","43292210","43292456","64","18237676"
"chr7","25066940","25067248","chr10","118474409","118474715","61","93407469"
"chr7","25098275","25098390","chr1","197987006","197987122","18","172888731"
"chr7","25144356","25144664","chr17","38031448","38031745","85","12887092"
"chr7","25167618","25167848","chr1","33041163","33041387","48","7873545"
"chr7","25169807","25170079","chr10","92992487","92992764","32","67822680"
"chr7","25196572","25196780","chrX","154182968","154183182","48","128986396"
"chr7","25224136","25224411","chr10","92911810","92912081","31","67687674"
"chr7","25231420","25231736","chr10","92893242","92893552","62","67661822"
"chr7","25260823","25260919","chr10","30209828","30209923","12","4949005"
"chr7","25263003","25263331","chr10","30206949","30207265","48","4943946"
"chr7","25296226","25296540","chr10","30183886","30184196","53","4887660"
"chr7","25298576","25298704","chr10","92837549","92837670","17","67538973"
"chr7","25298872","25298951","chr11","106359869","106359951","21","81060997"
"chr7","25330116","25330388","chr10","92811884","92812174","46","67481768"
"chr7","25353966","25354083","chr10","92786373","92786490","13","67432407"
"chr7","25374649","25374774","chr10","92763870","92763990","17","67389221"
"chr7","25403544","25403833","chr10","92732770","92733070","44","67329226"
"chr7","25408307","25408452","chr19","5169265","5169417","35","20239042"
"chr7","25419662","25419957","chr10","92715555","92715846","45","67295893"
"chr7","25426461","25426697","chr4","95932964","95933191","64","70506503"
"chr7","25470950","25471068","chr16","28076839","28076959","29","2605889"
"chr7","25471295","25471460","chr14","48531182","48531343","34","23059887"
"chr7","25474051","25474367","chr1","111746820","111747135","89","86272769"
"chr7","25513647","25513935","chr7","69538149","69538439","56","44024502"
"chr7","25524263","25524541","chr10","92642553","92642809","50","67118290"
"chr7","25535824","25536081","chr10","92632418","92632689","38","67096594"
"chr7","25542754","25542990","chr6","22061432","22061659","69","3481322"
"chr7","25596790","25597067","chr10","92572537","92572812","40","66975747"
"chr7","25633002","25633273","chr10","92535292","92535574","43","66902290"
"chr7","25654820","25655137","chr10","92510994","92511305","38","66856174"
"chr7","25657636","25657929","chr10","92508990","92509278","41","66851354"
"chr7","25660644","25660782","chr5","22719283","22719416","36","2941361"
"chr7","25666877","25667034","chrX","49916830","49916985","30","24249953"
"chr7","25668448","25668724","chr10","92473710","92473974","38","66805262"
"chr7","25670162","25670444","chr7","76706766","76707033","70","51036604"
"chr7","25679578","25679877","chr1","158896818","158897116","61","133217240"
"chr7","25693748","25693879","chrX","74444074","74444203","23","48750326"
"chr7","25709082","25709241","chr11","129038829","129038978","44","103329747"
"chr7","25713929","25714206","chr10","92411465","92411753","49","66697536"
"chr7","25731251","25731544","chr10","92394256","92394557","52","66663005"
"chr7","25751237","25751547","chr10","92372315","92372616","49","66621078"
"chr7","25757465","25757587","chr3","65193379","65193500","21","39435914"
"chr7","25757604","25757896","chr5","9148842","9149146","72","16608762"
"chr7","25764944","25765233","chrX","70174791","70175090","62","44409847"
"chr7","25777953","25778181","chr19","13001825","13002050","50","12776128"
"chr7","25778356","25778397","chr17","20548496","20548538","9","5229860"
"chr7","25783537","25783848","chr10","92343686","92343991","45","66560149"
"chr7","25788966","25789262","chr4","69319673","69319963","64","43530707"
"chr7","25817834","25817999","chr10","92285932","92286095","27","66468098"
"chr7","25818860","25819138","chr10","92284771","92285062","39","66465911"
"chr7","25825781","25826088","chr4","182052332","182052639","82","156226551"
"chr7","25836422","25836722","chr10","92255071","92255374","66","66418649"
"chr7","25849917","25850215","chr10","92248370","92248663","46","66398453"
"chr7","25882506","25882772","chr10","92210727","92211000","63","66328221"
"chr7","25889522","25889627","chr10","92204494","92204596","12","66314972"
"chr7","25926420","25926550","chr10","92140972","92141103","16","66214552"
"chr7","25930385","25930648","chr10","92136340","92136621","47","66205955"
"chr7","25934163","25934289","chr10","112111608","112111739","28","86177445"
"chr7","25957843","25957937","chr10","92111320","92111412","8","66153477"
"chr7","25960746","25960910","chr12","19312537","19312701","28","6648209"
"chr7","25967370","25967682","chr10","92101769","92102080","49","66134399"
"chr7","25974866","25975172","chr10","92095404","92095715","32","66120538"
"chr7","25976107","25976412","chr14","86425091","86425386","58","60448984"
"chr7","25997675","25997804","chr10","92081563","92081691","7","66083888"
"chr7","26002749","26003059","chr7","80060311","80060624","55","54057562"
"chr7","26008043","26008217","chr2B","66973879","66974056","39","40965836"
"chr7","26011094","26011408","chr10","92069748","92070065","45","66058654"
"chr7","26015462","26015777","chr10","92063281","92063584","46","66047819"
"chr7","26016427","26016536","chr10","92062482","92062592","21","66046055"
"chr7","26039530","26039654","chr10","92029602","92029726","9","65990072"
"chr7","26040301","26040466","chr7","66847442","66847613","41","40807141"
"chr7","26044093","26044207","chr10","92026811","92026928","7","65982718"
"chr7","26050666","26050962","chr10","92020424","92020728","44","65969758"
"chr7","26067050","26067210","chr19","18112321","18112488","35","7954729"
"chr7","26067325","26067600","chr12","130971781","130972064","69","104904456"
"chr7","26068744","26069012","chr10","92003576","92003853","66","65934832"
"chr7","26072158","26072435","chr15","41858395","41858666","50","15786237"
"chr7","26086284","26086587","chr10","91981036","91981334","42","65894752"
"chr7","26104483","26104624","chr20","57600565","57600702","47","31496082"
"chr7","26106001","26106257","chr10","91962397","91962677","68","65856396"
"chr7","26114103","26114243","chr1","138968329","138968481","30","112854226"
"chr7","26115893","26116184","chr8","26896420","26896708","61","780527"
"chr7","26128575","26128859","chr4","2134462","2134746","63","23994113"
"chr7","26151050","26151292","chr7","72578921","72579180","66","46427871"
"chr7","26154047","26154321","chr10","91935552","91935854","54","65781505"
"chr7","26181835","26181934","chr3","193237409","193237508","16","167055574"
"chr7","26200084","26200300","chr19","18237823","18238040","45","7962261"
"chr7","26206629","26206877","chr1","225024053","225024303","67","198817424"
"chr7","26221381","26221691","chr10","91852975","91853277","38","65631594"
"chr7","26234860","26235157","chr10","91834650","91834948","54","65599790"
"chr7","26236217","26236517","chr10","91834650","91834948","42","65598433"
"chr7","26245042","26245263","chr10","91822054","91822275","36","65577012"
"chr7","26247633","26247945","chr10","91816478","91816792","47","65568845"
"chr7","26263599","26263901","chr10","91798074","91798369","55","65534475"
"chr7","26269630","26269740","chr18","48326419","48326520","29","22056789"
"chr7","26272503","26272695","chr10","91789912","91790105","23","65517409"
"chr7","26288017","26288326","chr10","91779118","91779419","67","65491101"
"chr7","26290792","26290912","chr10","91776497","91776617","14","65485705"
"chr7","26297265","26297570","chr7","68410325","68410623","54","42113060"
"chr7","26308490","26308780","chr10","91743998","91744296","59","65435508"
"chr7","26318570","26318854","chr3","28043176","28043464","61","1724606"
"chr7","26329398","26329498","chr1","46605351","46605452","23","20275953"
"chr7","26331696","26331977","chr10","91712206","91712487","34","65380510"
"chr7","26344621","26344909","chr10","91700210","91700513","52","65355589"
"chr7","26345801","26346082","chr16","40803572","40803860","66","14457771"
"chr7","26349136","26349458","chr10","91695302","91695610","58","65346166"
"chr7","26357738","26358038","chr5","36408852","36409158","61","10051114"
"chr7","26396282","26396586","chr10","91643404","91643720","52","65247122"
"chr7","26406226","26406479","chr10","91634730","91635002","47","65228504"
"chr7","26408733","26409020","chr1","43624160","43624442","63","17215427"
"chr7","26409649","26409896","chr10","91630758","91631003","62","65221109"
"chr7","26416661","26416802","chr20","34414083","34414223","34","7997422"
"chr7","26417174","26417276","chr2B","16261383","16261481","18","10155791"
"chr7","26419870","26420139","chr19","5202319","5202599","68","21217551"
"chr7","26421541","26421851","chr10","91619184","91619516","47","65197643"
"chr7","26438985","26439263","chr16","4415567","4415837","61","22023418"
"chr7","26456940","26457099","chr10","91585083","91585250","34","65128143"
"chr7","26459191","26459412","chr19","18271347","18271565","65","8187844"
"chr7","26492726","26492998","chr10","91578149","91578433","32","65085423"
"chr7","26537133","26537440","chr10","91532747","91533060","48","64995614"
"chr7","26540452","26540743","chr10","90187948","90188250","46","63647496"
"chr7","26559838","26559957","chr10","91510108","91510225","11","64950270"
"chr7","26566844","26567079","chr20","49737019","49737257","50","23170175"
"chr7","26581635","26581766","chr4","81992546","81992669","25","55410911"
"chr7","26588994","26589132","chr10","91472759","91472898","12","64883765"
"chr7","26634506","26634708","chr2A","32255515","32255716","43","5621009"
"chr7","26644128","26644426","chr10","91368936","91369239","53","64724808"
"chr7","26648710","26649019","chr11","13043421","13043728","58","13605289"
"chr7","26649025","26649224","chr10","91364059","91364256","23","64715034"
"chr7","26663429","26663693","chr10","91348059","91348322","28","64684630"
"chr7","26664889","26665164","chr10","91346680","91346948","50","64681791"
"chr7","26678557","26678841","chr9","67890720","67891007","58","41212163"
"chr7","26679443","26679572","chr13","10278120","10278248","25","16401323"
"chr7","26687225","26687516","chr10","90128454","90128745","36","63441229"
"chr7","26702731","26703048","chr10","90146855","90147170","57","63444124"
"chr7","26715581","26715880","chr10","91291503","91291808","43","64575922"
"chr7","26721213","26721510","chr10","91287176","91287482","42","64565963"
"chr7","26735051","26735306","chr5","64541639","64541892","56","37806588"
"chr7","26740690","26740995","chr10","91271255","91271557","50","64530565"
"chr7","26744288","26744373","chr2A","42021645","42021731","24","15277357"
"chr7","26744700","26744893","chr7","132609881","132610070","45","105865181"
"chr7","26770880","26771181","chr10","91237301","91237608","33","64466421"
"chr7","26771513","26771767","chr3","71140834","71141113","64","44369321"
"chr7","26773268","26773538","chr10","91234931","91235203","29","64461663"
"chr7","26785247","26785542","chr10","91221173","91221467","39","64435926"
"chr7","26789734","26789900","chr3","10866047","10866211","41","15923687"
"chr7","26807525","26807678","chr15","5454904","5455056","34","21352621"
"chr7","26812261","26812373","chr3","199536979","199537090","18","172724718"
"chr7","26824901","26825190","chr10","91187919","91188213","39","64363018"
"chr7","26848981","26849253","chr10","91157401","91157674","34","64308420"
"chr7","26851568","26851871","chr2B","127747551","127747853","58","100895983"
"chr7","26853988","26854270","chr10","91152725","91153005","39","64298737"
"chr7","26854707","26854912","chr10","91151761","91151966","32","64297054"
"chr7","26866075","26866369","chr10","91135148","91135412","56","64269073"
"chr7","26883061","26883331","chr10","91120909","91121174","41","64237848"
"chr7","26889554","26889822","chrX","118858247","118858511","65","91968693"
"chr7","26893421","26893712","chr10","91104789","91105095","35","64211368"
"chr7","26917826","26918111","chr10","91088975","91089261","39","64171149"
"chr7","26919362","26919530","chr9","53355007","53355174","48","26435645"
"chr7","26921606","26921902","chr10","91085006","91085302","40","64163400"
"chr7","26935032","26935322","chr10","91071626","91071907","41","64136594"
"chr7","26943487","26943604","chr6","38593130","38593246","22","11649643"
"chr7","26949029","26949312","chr12","92934221","92934505","60","65985192"
"chr7","26958513","26958813","chr10","91044577","91044876","32","64086064"
"chr7","26967115","26967245","chr10","91030263","91030393","8","64063148"
"chr7","27003271","27003550","chr10","90990867","90991165","52","63987596"
"chr7","27028415","27028651","chr10","90967450","90967697","40","63939035"
"chr7","27037561","27037706","chr10","90957398","90957520","31","63919837"
"chr7","27038700","27039020","chr10","90956101","90956428","53","63917401"
"chr7","27051956","27052202","chr15","51027343","51027583","67","23975387"
"chr7","27084734","27085017","chr10","90898856","90899140","36","63814122"
"chr7","27098446","27098546","chr3","58857961","58858058","15","31759515"
"chr7","27111727","27111877","chr1","68709407","68709549","35","41597680"
"chr7","27115426","27115727","chr10","90843562","90843866","50","63728136"
"chr7","27130445","27130755","chr10","90829423","90829734","48","63698978"
"chr7","27157764","27157889","chr6","18588428","18588554","34","8569336"
"chr7","27174794","27175064","chr10","90783612","90783873","41","63608818"
"chr7","27181471","27181745","chr10","90777377","90777668","49","63595906"
"chr7","27182439","27182734","chr10","90776398","90776706","47","63593959"
"chr7","27196016","27196316","chr2B","48650534","48650826","60","21454518"
"chr7","27200240","27200533","chr10","90761011","90761294","44","63560771"
"chr7","27220380","27220541","chr10","110421458","110421623","35","83201078"
"chr7","27228950","27229237","chr10","90733255","90733553","50","63504305"
"chr7","27238615","27238868","chr20","45973760","45974016","62","18735145"
"chr7","27260988","27261295","chr10","90702573","90702884","43","63441585"
"chr7","27265707","27265774","chr20","49674431","49674497","8","22408724"
"chr7","27266599","27266885","chr10","90696726","90697016","41","63430127"
"chr7","27279167","27279386","chr15","61589063","61589258","63","34309896"
"chr7","27291341","27291643","chr10","90675720","90676019","37","63384379"
"chr7","27309585","27309884","chr10","90645845","90646127","52","63336260"
"chr7","27319360","27319666","chr10","90635441","90635729","55","63316081"
"chr7","27326430","27326700","chr16","29395479","29395752","63","2069049"
"chr7","27331093","27331217","chr6","42503269","42503390","24","15172176"
"chr7","27332592","27332771","chr10","90624678","90624855","22","63292086"
"chr7","27344767","27345064","chr10","90610560","90610850","51","63265793"
"chr7","27355760","27355884","chr7","129330579","129330704","19","101974819"
"chr7","27381476","27381764","chr14","75080552","75080837","62","47699076"
"chr7","27381775","27381893","chr8","19325971","19326085","18","8055804"
"chr7","27438700","27438820","chr6","28118840","28118957","17","680140"
"chr7","27454656","27454952","chr2A","18986462","18986752","52","8468194"
"chr7","27464884","27465103","chr6","110169683","110169896","52","82704799"
"chr7","27478026","27478323","chr10","102116659","102116954","69","74638633"
"chr7","27491430","27491521","chr5","6920692","6920778","19","20570738"
"chr7","27492368","27492492","chr10","90370056","90370187","17","62877688"
"chr7","27497578","27497859","chr7","69538149","69538439","61","42040571"
"chr7","27500716","27500954","chr10","90362531","90362770","48","62861815"
"chr7","27505370","27505528","chrX","17937151","17937313","37","9568219"
"chr7","27515270","27515564","chr10","90349362","90349662","41","62834092"
"chr7","27516981","27517278","chr10","90344838","90345134","45","62827857"
"chr7","27525871","27526160","chr16","4899207","4899497","57","22626664"
"chr7","27543189","27543506","chr10","90829423","90829734","60","63286234"
"chr7","27558602","27558770","chr12","109514253","109514411","45","81955651"
"chr7","27575599","27575897","chr11","85632161","85632468","60","58056562"
"chr7","27602042","27602345","chr10","91426419","91426719","53","63824377"
"chr7","27620826","27620942","chr14","54877920","54878035","22","27257094"
"chr7","27623532","27623844","chr10","90202988","90203281","51","62579456"
"chr7","27627543","27627792","chr10","90192618","90192873","44","62565075"
"chr7","27631157","27631450","chr6","43907644","43907942","58","16276487"
"chr7","27650741","27651053","chr10","91303033","91303344","40","63652292"
"chr7","27679378","27679672","chr1","163867986","163868280","61","136188608"
"chr7","27684602","27684888","chr10","90107131","90107410","29","62422529"
"chr7","27691545","27691841","chr10","90091419","90091715","46","62399874"
"chr7","27701220","27701399","chr1","191480276","191480457","35","163779056"
"chr7","27702108","27702428","chr10","90081893","90082203","43","62379785"
"chr7","27703033","27703182","chrX","18264950","18265097","29","9438083"
"chr7","27715307","27715578","chr10","90067122","90067399","31","62351815"
"chr7","27722510","27722803","chr10","90060050","90060356","39","62337540"
"chr7","27732189","27732455","chr2B","99527218","99527476","68","71795029"
"chr7","27746967","27747249","chr17","58466050","58466337","70","30719083"
"chr7","27757048","27757316","chr7","128527661","128527933","57","100770613"
"chr7","27761983","27762280","chr10","90018206","90018492","50","62256223"
"chr7","27770705","27771003","chr16","48138048","48138347","60","20367343"
"chr7","27789443","27789758","chr10","89995475","89995788","34","62206032"
"chr7","27795892","27796165","chr10","89989025","89989302","46","62193133"
"chr7","27841423","27841713","chr10","89943559","89943845","30","62102136"
"chr7","27919064","27919357","chr10","89848169","89848434","59","61929105"
"chr7","27926802","27927100","chr10","89840015","89840301","54","61913213"
"chr7","27963172","27963458","chr10","89803548","89803854","51","61840376"
"chr7","27992171","27992457","chr20","39682251","39682537","61","11690080"
"chr7","28003112","28003373","chr1","28917331","28917589","62","914219"
"chr7","28004738","28004861","chr16","16777745","16777870","25","11226993"
"chr7","28004936","28005093","chr4","5043914","5044066","40","22961022"
"chr7","28020465","28020727","chr5","54877485","54877756","59","26857020"
"chr7","28029368","28029644","chr10","89731619","89731902","48","61702251"
"chr7","28036058","28036349","chr10","89722260","89722568","46","61686202"
"chr7","28049152","28049396","chr1","18869598","18869838","60","9179554"
"chr7","28055652","28055952","chr10","89699015","89699316","50","61643363"
"chr7","28056604","28056900","chr10","89698045","89698354","37","61641441"
"chr7","28059713","28059979","chr10","89695270","89695549","37","61635557"
"chr7","28078224","28078515","chr10","89677046","89677318","49","61598822"
"chr7","28083354","28083633","chr10","89672193","89672481","48","61588839"
"chr7","28114307","28114599","chr10","89635743","89636038","34","61521436"
"chr7","28134625","28134899","chr10","89612651","89612901","60","61478026"
"chr7","28138565","28138820","chr10","89609656","89609908","36","61471091"
"chr7","28148708","28149003","chr10","89600164","89600463","49","61451456"
"chr7","28160027","28160310","chr10","89588599","89588899","52","61428572"
"chr7","28162467","28162595","chr19","34610097","34610227","23","6447630"
"chr7","28187740","28187888","chr1","134652174","134652315","36","106464434"
"chr7","28197837","28198121","chr6","89169257","89169543","33","60971420"
"chr7","28205555","28205836","chr6","89176912","89177201","42","60971357"
"chr7","28235240","28235533","chr10","89490402","89490694","40","61255162"
"chr7","28289283","28289401","chr10","89432803","89432926","16","61143520"
"chr7","28364384","28364671","chr10","89365294","89365589","52","61000910"
"chr7","28469459","28469659","chr10","89271388","89271588","22","60801929"
"chr7","28497047","28497290","chr15","67260007","67260256","55","38762960"
"chr7","28518541","28518835","chr4","7224655","7224944","60","21293886"
"chr7","28641885","28642030","chr19","4940883","4941017","43","23701002"
"chr7","28642600","28642647","chr9","47034334","47034381","13","18391734"
"chr7","28657444","28657734","chr10","89059609","89059899","27","60402165"
"chr7","28663273","28663597","chr10","89050424","89050739","51","60387151"
"chr7","28666638","28666953","chr10","89047505","89047801","66","60380867"
"chr7","28674557","28674693","chr3","125195674","125195807","19","96521117"
"chr7","28684884","28685192","chr10","89028423","89028726","52","60343539"
"chr7","28688107","28688423","chr10","89025446","89025760","36","60337339"
"chr7","28692086","28692374","chr10","89021467","89021772","49","60329381"
"chr7","28705208","28705515","chr3","65689612","65689915","82","36984404"
"chr7","28705541","28705823","chr10","89014901","89015183","33","60309360"
"chr7","28719128","28719406","chr10","88989410","88989707","57","60270282"
"chr7","28724351","28724448","chr7","1480068","1480167","25","27244283"
"chr7","28762249","28762536","chr10","88939348","88939610","62","60177099"
"chr7","28765347","28765633","chr15","75174914","75175196","57","46409567"
"chr7","28817043","28817269","chr10","88878372","88878589","35","60061329"
"chr7","28824464","28824759","chr10","88871128","88871429","46","60046664"
"chr7","28837036","28837223","chr1","61837689","61837890","56","33000653"
"chr7","28838010","28838225","chr6","91869790","91870005","44","63031780"
"chr7","28844820","28844956","chr10","88851647","88851778","18","60006827"
"chr7","28849531","28849657","chr10","88849823","88849949","16","60000292"
"chr7","28872488","28872769","chr10","88815161","88815444","32","59942673"
"chr7","28903284","28903574","chr10","88774381","88774661","32","59871097"
"chr7","28959280","28959427","chr20","13392558","13392708","40","15566722"
"chr7","28977492","28977613","chr9","93151090","93151202","21","64173598"
"chr7","28982722","28983015","chr10","88658769","88659077","52","59676047"
"chr7","28998279","28998450","chr9","15140615","15140782","42","13857664"
"chr7","29001292","29001591","chr9","48924450","48924744","68","19923158"
"chr7","29018362","29018675","chr10","88612275","88612578","53","59593913"
"chr7","29035499","29035586","chr9","108660572","108660658","21","79625073"
"chr7","29035828","29036097","chr10","88560215","88560488","48","59524387"
"chr7","29036741","29036969","chr18","55165662","55165888","51","26128921"
"chr7","29038886","29039191","chr1","2285941","2286239","55","26752945"
"chr7","29055812","29056139","chr10","88512845","88513156","58","59457033"
"chr7","29056475","29056736","chr10","88510068","88510333","47","59453593"
"chr7","29081237","29081531","chr7","129446111","129446395","65","100364874"
"chr7","29145512","29145780","chr10","88417326","88417612","51","59271814"
"chr7","29152447","29152761","chr10","88409538","88409846","50","59257091"
"chr7","29198723","29198853","chr19","11238460","11238588","25","17960263"
"chr7","29232757","29233058","chr10","88350554","88350862","40","59117797"
"chr7","29240756","29241070","chr10","88341175","88341483","39","59100419"
"chr7","29242151","29242253","chr18","19517661","19517766","23","9724490"
"chr7","29450780","29450883","chr10","88133646","88133749","6","58682866"
"chr7","29790087","29790202","chr1","46089742","46089855","29","16299655"
"chr7","29800286","29800555","chr10","148223103","148223376","67","118422817"
"chr7","29805205","29805460","chr11","27116873","27117109","80","2688332"
"chr7","29834711","29834838","chr8","107725491","107725613","26","77890780"
"chr7","29837210","29837437","chr16","21816315","21816532","62","8020895"
"chr7","29851619","29851739","chr10","87751001","87751121","11","57899382"
"chr7","29853996","29854141","chr9","47618301","47618435","30","17764305"
"chr7","29861119","29861426","chr10","87740493","87740803","53","57879374"
"chr7","29873662","29873964","chr10","87729833","87730140","35","57856171"
"chr7","29885046","29885133","chr2B","74186352","74186439","7","44301306"
"chr7","29893740","29894051","chr10","87706853","87707158","44","57813113"
"chr7","29898005","29898295","chr10","87697157","87697444","52","57799152"
"chr7","29904083","29904355","chr10","87689165","87689429","30","57785082"
"chr7","29907970","29908239","chr1","135207339","135207594","65","105299369"
"chr7","29912633","29912924","chr10","87679745","87680049","42","57767112"
"chr7","29915386","29915492","chr1","186122233","186122334","22","156206847"
"chr7","29923916","29924200","chr10","87668603","87668877","44","57744687"
"chr7","29950119","29950369","chr16","31649333","31649595","56","1699214"
"chr7","29955740","29955873","chr3","144886878","144887008","24","114931138"
"chr7","29984921","29985225","chr19","947608","947921","63","29037313"
"chr7","30004142","30004449","chr10","87575348","87575664","42","57571206"
"chr7","30030528","30030814","chr1","227415933","227416230","66","197385405"
"chr7","30037555","30037837","chr10","87543228","87543511","43","57505673"
"chr7","30075561","30075876","chr10","87506710","87507019","42","57431149"
"chr7","30085241","30085399","chr10","87497419","87497577","22","57412178"
"chr7","30091487","30091810","chr10","87490938","87491258","45","57399451"
"chr7","30110874","30111167","chr10","87471173","87471460","34","57360299"
"chr7","30115252","30115551","chr10","87467072","87467369","30","57351820"
"chr7","30131923","30132211","chr10","87452490","87452769","59","57320567"
"chr7","30174774","30175076","chr10","87410836","87411134","45","57236062"
"chr7","30178434","30178653","chr10","87406552","87406771","27","57228118"
"chr7","30198715","30198972","chr16","71084469","71084733","63","40885754"
"chr7","30208281","30208569","chr10","87377130","87377412","33","57168849"
"chr7","30228164","30228423","chr8","18357630","18357879","33","11870534"
"chr7","30233949","30234258","chr11","32451700","32452008","71","2217751"
"chr7","30257951","30258119","chr16","29999340","29999496","45","258611"
"chr7","30276813","30277105","chr10","87311014","87311302","33","57034201"
"chr7","30280686","30281001","chr10","87307383","87307705","33","57026697"
"chr7","30303305","30303579","chr1","40331351","40331633","55","10028046"
"chr7","30309906","30310039","chr10","87276118","87276248","29","56966212"
"chr7","30341495","30341756","chr5","33582906","33583180","66","3241411"
"chr7","30372914","30373025","chr10","87199389","87199502","17","56826475"
"chr7","30373446","30373596","chr10","59648007","59648153","39","29274561"
"chr7","30397845","30398062","chr10","87172852","87173071","30","56775007"
"chr7","30407138","30407441","chr10","87158657","87158968","45","56751519"
"chr7","30415329","30415610","chr10","87145664","87145963","53","56730335"
"chr7","30478601","30478897","chr10","87076354","87076655","45","56597753"
"chr7","30481828","30482123","chr10","87072692","87072986","42","56590864"
"chr7","30486890","30487164","chr1","27882391","27882663","69","2604499"
"chr7","30506988","30507286","chr10","87041611","87041908","35","56534623"
"chr7","30568799","30569113","chr6","40140043","40140343","74","9571244"
"chr7","30585399","30585522","chr10","86956281","86956404","11","56370882"
"chr7","30613921","30614253","chr10","86928792","86929132","69","56314871"
"chr7","30624633","30624905","chr7","81190844","81191124","65","50566211"
"chr7","30644755","30644882","chr1","111861160","111861287","30","81216405"
"chr7","30645008","30645160","chr17","67386526","67386680","31","36741518"
"chr7","30667193","30667343","chr1","188967838","188967994","35","158300645"
"chr7","30685027","30685081","chr1","52138720","52138778","12","21453693"
"chr7","30685657","30685733","chr10","50433693","50433769","14","19748036"
"chr7","30692908","30693043","chr10","30690604","30690743","30","2304"
"chr7","30711961","30712227","chr10","86820952","86821254","69","56108991"
"chr7","30720812","30721137","chr10","86811937","86812272","53","56091125"
"chr7","30742215","30742522","chr10","86795739","86796027","69","56053524"
"chr7","30750110","30750389","chr2B","16538844","16539130","63","14211266"
"chr7","30752954","30753181","chr10","91563647","91563869","57","60810693"
"chr7","30766082","30766358","chr20","49893358","49893627","67","19127276"
"chr7","30813976","30814265","chr20","18881434","18881726","64","11932542"
"chr7","30820199","30820498","chr11","69678115","69678416","59","38857916"
"chr7","30831441","30831582","chrX","2794957","2795096","30","28036484"
"chr7","30834007","30834136","chr3","15286672","15286801","15","15547335"
"chr7","30834938","30835243","chr11","85632161","85632468","67","54797223"
"chr7","30839172","30839289","chr1","101621131","101621248","21","70781959"
"chr7","30844245","30844565","chr10","86727491","86727809","45","55883246"
"chr7","30856369","30856673","chr10","86678813","86679102","56","55822444"
"chr7","30866802","30867109","chr10","86659889","86660201","44","55793087"
"chr7","30894058","30894314","chr10","86632156","86632412","33","55738098"
"chr7","30904264","30904562","chr10","86622139","86622445","52","55717875"
"chr7","30909710","30909985","chr1","144485850","144486130","66","113576140"
"chr7","30913108","30913195","chr19","49971385","49971478","23","19058277"
"chr7","30913318","30913458","chr6","31424609","31424739","36","511291"
"chr7","30921350","30921651","chr1","197648144","197648445","54","166726794"
"chr7","30946157","30946281","chr5","133578375","133578499","38","102632218"
"chr7","30946278","30946349","chr15","16444783","16444854","13","14501495"
"chr7","30952654","30952765","chrX","45308661","45308773","18","14356007"
"chr7","30955518","30955825","chr10","86574931","86575231","56","55619413"
"chr7","30994774","30995058","chr10","86533900","86534187","30","55539126"
"chr7","31007011","31007124","chr10","86521589","86521709","13","55514578"
"chr7","31011502","31011597","chr8","130897351","130897448","25","99885849"
"chr7","31011767","31011870","chr19","52942324","52942424","26","21930557"
"chr7","31022965","31023257","chr7","56830178","56830472","62","25807213"
"chr7","31024757","31025040","chr10","86505586","86505874","44","55480829"
"chr7","31040030","31040178","chr10","86489416","86489583","30","55449386"
"chr7","31042088","31042212","chr8","61956859","61956983","18","30914771"
"chr7","31056558","31056859","chr10","86474001","86474311","41","55417443"
"chr7","31074620","31074861","chr10","86458281","86458523","28","55383661"
"chr7","31089675","31089791","chr10","86444722","86444836","12","55355047"
"chr7","31094463","31094728","chr1","58491658","58491920","62","27397195"
"chr7","31099219","31099455","chr1","133714054","133714271","77","102614835"
"chr7","31104861","31105146","chr10","86430591","86430878","41","55325730"
"chr7","31154824","31154929","chr1","3482957","3483068","26","27671867"
"chr7","31181726","31182000","chr10","86353375","86353668","64","55171649"
"chr7","31219134","31219171","chr5","39919106","39919141","9","8699972"
"chr7","31219217","31219410","chr1","93973386","93973572","39","62754169"
"chr7","31247021","31247296","chr11","118311440","118311714","79","87064419"
"chr7","31261919","31262229","chr10","86273826","86274140","39","55011907"
"chr7","31283581","31283856","chr10","86253528","86253826","62","54969947"
"chr7","31304331","31304628","chr10","86229620","86229906","60","54925289"
"chr7","31334812","31335065","chr6","109073918","109074151","70","77739106"
"chr7","31348227","31348509","chr10","86184750","86185032","40","54836523"
"chr7","31350127","31350417","chr10","86182863","86183133","44","54832736"
"chr7","31361874","31362190","chr10","86172558","86172867","69","54810684"
"chr7","31392982","31393135","chr16","76317400","76317554","32","44924418"
"chr7","31432129","31432419","chr10","86099955","86100234","55","54667826"
"chr7","31450201","31450317","chr2A","73166038","73166153","22","41715837"
"chr7","31465219","31465434","chr9","113807290","113807518","61","82342071"
"chr7","31471121","31471410","chr15","26780342","26780631","53","4690779"
"chr7","31503652","31503970","chr10","86038869","86039169","60","54535217"
"chr7","31512638","31512930","chr10","86031070","86031369","48","54518432"
"chr7","31515182","31515496","chr10","86028496","86028809","52","54513314"
"chr7","31531332","31531581","chr10","85994483","85994759","63","54463151"
"chr7","31533544","31533819","chr10","85996387","85996660","45","54462843"
"chr7","31542197","31542407","chr10","85988102","85988305","33","54445905"
"chr7","31549119","31549409","chr10","85974996","85975297","28","54425877"
"chr7","31551831","31552119","chr10","85972586","85972881","42","54420755"
"chr7","31553979","31554247","chr10","85970136","85970377","57","54416157"
"chr7","31575164","31575470","chr6","13801382","13801680","69","17773782"
"chr7","31579761","31580060","chr10","85951355","85951646","41","54371594"
"chr7","31597618","31597864","chr10","85934953","85935216","55","54337335"
"chr7","31598849","31598959","chr10","85934431","85934541","13","54335582"
"chr7","31603077","31603379","chr19","9663584","9663881","59","21939493"
"chr7","31605288","31605567","chr10","85928599","85928878","22","54323311"
"chr7","31606161","31606454","chr10","85927713","85928002","48","54321552"
"chr7","31613971","31614265","chr1","52487778","52488070","62","20873807"
"chr7","31627050","31627364","chr10","85908150","85908457","32","54281100"
"chr7","31630392","31630673","chr5","42859572","42859857","62","11229180"
"chr7","31634734","31634849","chr10","85903839","85903956","12","54269105"
"chr7","31649511","31649785","chr2B","83101868","83102134","55","51452357"
"chr7","31655693","31655852","chr3","40933011","40933169","31","9277318"
"chr7","31665898","31666196","chr10","85871088","85871390","41","54205190"
"chr7","31667147","31667416","chr10","85869860","85870108","44","54202713"
"chr7","31669757","31669908","chr19","5169265","5169417","29","26500492"
"chr7","31675142","31675413","chr10","85861574","85861862","48","54186432"
"chr7","31695380","31695531","chr16","49017109","49017265","36","17321729"
"chr7","31721536","31721835","chr19","50882665","50882968","56","19161129"
"chr7","31722567","31722733","chr14","72724722","72724884","40","41002155"
"chr7","31735770","31736049","chr10","85809462","85809750","44","54073692"
"chr7","31750245","31750504","chr8","11790498","11790761","59","19959747"
"chr7","31752358","31752488","chr6","42782331","42782460","33","11029973"
"chr7","31754125","31754447","chr5","7517732","7518038","68","24236393"
"chr7","31757631","31757894","chr10","85792812","85793094","56","54035181"
"chr7","31759545","31759674","chr18","22807872","22807981","36","8951673"
"chr7","31775537","31775840","chr16","48138048","48138347","76","16362511"
"chr7","31779966","31780070","chr11","100545535","100545642","24","68765569"
"chr7","31781281","31781579","chr15","23614412","23614711","55","8166869"
"chr7","31785205","31785457","chr10","85764392","85764649","30","53979187"
"chr7","31786155","31786266","chr14","10547372","10547486","19","21238783"
"chr7","31786311","31786508","chr19","6085105","6085297","48","25701206"
"chr7","31795742","31796019","chr6","11562062","11562332","82","20233680"
"chr7","31810365","31810652","chr10","85733871","85734153","37","53923506"
"chr7","31834390","31834596","chr10","85714117","85714326","29","53879727"
"chr7","31838089","31838400","chr10","132003577","132003889","57","100165488"
"chr7","31885037","31885161","chr6","111603379","111603505","24","79718342"
"chr7","31892226","31892337","chrX","47966335","47966445","20","16074109"
"chr7","31915499","31915716","chr10","85631806","85632008","44","53716307"
"chr7","31936285","31936576","chr10","85608311","85608600","41","53672026"
"chr7","31937583","31937891","chr10","85606936","85607234","57","53669353"
"chr7","31951803","31952019","chr19","2126852","2127058","44","29824951"
"chr7","31952851","31952990","chr4","94320345","94320488","37","62367494"
"chr7","31980915","31981184","chr14","10647151","10647421","59","21333764"
"chr7","32010387","32010504","chr7","64738088","64738205","16","32727701"
"chr7","32014499","32014781","chr10","85533586","85533888","42","53519087"
"chr7","32018186","32018346","chr12","125078910","125079070","34","93060724"
"chr7","32055999","32056277","chr10","85489486","85489766","39","53433487"
"chr7","32066733","32067026","chr10","85464813","85465115","47","53398080"
"chr7","32079325","32079607","chr10","85451171","85451465","43","53371846"
"chr7","32079902","32079985","chr5","30304298","30304382","14","1775604"
"chr7","32096027","32096331","chr12","38090793","38091095","58","5994766"
"chr7","32107623","32107916","chr10","85402035","85402335","39","53294412"
"chr7","32108266","32108563","chr10","85401382","85401670","42","53293116"
"chr7","32112244","32112516","chr10","85395141","85395435","52","53282897"
"chr7","32121560","32121840","chr10","85388406","85388700","57","53266846"
"chr7","32122368","32122655","chr10","85387594","85387881","32","53265226"
"chr7","32128573","32128705","chr11","101841108","101841253","35","69712535"
"chr7","32131097","32131199","chr7","137657037","137657144","35","105525940"
"chr7","32131396","32131458","chrX","119194156","119194210","16","87062760"
"chr7","32197154","32197278","chr3","59268164","59268289","24","27071010"
"chr7","32230525","32230818","chr9","49374277","49374582","70","17143752"
"chr7","32323453","32323741","chr10","85171003","85171291","41","52847550"
"chr7","32368934","32369244","chr10","85117592","85117912","58","52748658"
"chr7","32372466","32372570","chr10","85114263","85114362","12","52741797"
"chr7","32377423","32377702","chr10","85110391","85110669","50","52732968"
"chr7","32383995","32384289","chr10","85103610","85103920","53","52719615"
"chr7","32393337","32393652","chr10","85095143","85095460","49","52701806"
"chr7","32393672","32393917","chr10","25726645","25726902","62","6667027"
"chr7","32394862","32395127","chr15","46793365","46793626","67","14398503"
"chr7","32407951","32408218","chr10","85076418","85076699","43","52668467"
"chr7","32426823","32427083","chr2B","16670871","16671131","61","15755952"
"chr7","32428560","32428872","chr10","85056537","85056847","29","52627977"
"chr7","32451080","32451214","chr1","94911885","94912018","31","62460805"
"chr7","32453809","32454096","chrX","18545082","18545367","63","13908727"
"chr7","32455627","32455916","chr10","85036638","85036922","46","52581011"
"chr7","32457990","32458291","chr10","85034235","85034545","42","52576245"
"chr7","32467557","32467853","chr10","85016707","85017015","59","52549150"
"chr7","32508689","32508810","chr10","84967057","84967179","18","52458368"
"chr7","32520794","32521067","chr10","84952257","84952526","37","52431463"
"chr7","32523603","32523824","chr11","68057172","68057393","45","35533569"
"chr7","32529762","32530052","chr10","84943955","84944248","50","52414193"
"chr7","32547468","32547747","chr10","84926162","84926417","53","52378694"
"chr7","32554952","32555204","chr19","40370912","40371163","48","7815960"
"chr7","32585705","32586004","chr10","84887532","84887850","44","52301827"
"chr7","32596592","32596879","chr10","84876503","84876809","50","52279911"
"chr7","32602465","32602727","chr10","16643778","16644039","52","15958687"
"chr7","32606382","32606662","chr10","84867463","84867742","52","52261081"
"chr7","32611083","32611373","chr7","65338979","65339263","66","32727896"
"chr7","32625427","32625537","chr10","64970331","64970446","16","32344904"
"chr7","32636401","32636689","chr10","84832598","84832902","62","52196197"
"chr7","32639802","32640097","chr10","84829958","84830260","41","52190156"
"chr7","32649292","32649581","chr12","11468643","11468934","64","21180649"
"chr7","32655119","32655412","chr19","29654539","29654825","50","3000580"
"chr7","32674848","32675115","chr19","47342291","47342551","59","14667443"
"chr7","32690000","32690307","chr8","19990729","19991033","63","12699271"
"chr7","32690966","32691251","chr10","84780539","84780814","55","52089573"
"chr7","32691272","32691394","chrX","70594684","70594808","19","37903412"
"chr7","32709898","32710202","chr10","83078114","83078412","38","50368216"
"chr7","32738629","32738898","chr10","84736326","84736611","47","51997697"
"chr7","32770490","32770797","chr10","83262075","83262357","62","50491585"
"chr7","32774037","32774155","chr10","84704612","84704731","13","51930575"
"chr7","32798873","32799028","chr19","5169265","5169417","36","27629608"
"chr7","32808459","32808563","chr3","50258984","50259093","30","17450525"
"chr7","32843110","32843274","chr6","118855023","118855193","42","86011913"
"chr7","32949742","32949866","chr10","84508776","84508900","9","51559034"
"chr7","32984857","32985173","chr10","84473810","84474140","54","51488953"
"chr7","33046015","33046289","chr5","36275070","36275331","76","3229055"
"chr7","33104487","33104770","chr10","84337312","84337592","27","51232825"
"chr7","33109270","33109564","chr10","84330325","84330615","61","51221055"
"chr7","33148676","33148940","chr10","83109105","83109393","56","49960429"
"chr7","33181613","33181896","chr10","84246130","84246412","41","51064517"
"chr7","33307547","33307670","chr10","84110335","84110458","20","50802788"
"chr7","33366238","33366537","chr10","84040796","84041085","64","50674558"
"chr7","33498453","33498603","chr10","92108530","92108678","37","58610077"
"chr7","33596339","33596639","chr10","83822100","83822409","61","50225761"
"chr7","33614157","33614341","chr10","83809903","83810097","33","50195746"
"chr7","33625954","33626214","chr10","83799274","83799559","51","50173320"
"chr7","33684258","33684378","chr4","52602392","52602514","23","18918134"
"chr7","33746162","33746349","chr8","78126042","78126225","53","44379880"
"chr7","33909463","33909751","chr10","83408675","83408986","62","49499212"
"chr7","33914203","33914357","chr10","83404074","83404252","43","49489871"
"chr7","34013847","34014081","chr7","76783691","76783954","52","42769844"
"chr7","34016967","34017238","chr1","20713636","20713911","70","13303331"
"chr7","34077510","34077793","chrX","46819208","46819495","60","12741698"
"chr7","34112219","34112529","chr6","20689530","20689838","55","13422689"
"chr7","34118636","34118945","chr3","73800681","73800984","52","39682045"
"chr7","34151850","34151966","chr8","108964883","108965000","19","74813033"
"chr7","34165379","34165509","chr12","93911417","93911546","19","59746038"
"chr7","34172823","34173013","chr10","29926349","29926540","40","4246474"
"chr7","34213429","34213751","chr20","45656757","45657082","90","11443328"
"chr7","35222089","35222382","chr7","64692898","64693200","37","29470809"
"chr7","35222788","35223064","chr7","65790336","65790637","61","30567548"
"chr7","35223622","35223702","chrX","53217590","53217668","14","17993968"
"chr7","35225429","35225731","chr1","202592673","202592956","61","167367244"
"chr7","35226600","35226889","chr7","65786962","65787261","47","30560362"
"chr7","35229873","35230166","chr4","133955595","133955890","63","98725722"
"chr7","35244041","35244307","chr7","65290235","65290525","60","30046194"
"chr7","35256743","35256832","chr7","5928715","5928794","33","29328028"
"chr7","35256864","35257045","chr11","47592267","47592453","51","12335403"
"chr7","35330560","35330729","chr1","45242316","45242482","45","9911756"
"chr7","35338385","35338526","chr5","3296328","3296466","41","32042057"
"chr7","35345100","35345377","chr1","110218663","110218938","70","74873563"
"chr7","35400570","35400881","chr17","10319818","10320132","57","25080752"
"chr7","35617189","35617448","chr1","736740","737003","43","34880449"
"chr7","35618091","35618392","chr1","737275","737567","48","34880816"
"chr7","35623347","35623592","chr1","744789","745037","32","34878558"
"chr7","35671036","35671274","chr5","45081651","45081910","74","9410615"
"chr7","35730669","35730754","chr7","130630543","130630629","20","94899874"
"chr7","35732098","35732380","chr2B","43894043","43894333","56","8161945"
"chr7","35736177","35736484","chr4","196732424","196732732","70","160996247"
"chr7","35813689","35813979","chr1","950108","950408","58","34863581"
"chr7","35894834","35895098","chr17","9567584","9567855","68","26327250"
"chr7","35914538","35914775","chr1","1059402","1059640","46","34855136"
"chr7","35942894","35943043","chr1","216102838","216102968","50","180159944"
"chr7","35959352","35959646","chr1","1018309","1018589","50","34941043"
"chr7","35985452","35985736","chr1","1143611","1143900","47","34841841"
"chr7","35986057","35986322","chr7","16951293","16951559","59","19034764"
"chr7","36007991","36008240","chr19","7781825","7782069","72","28226166"
"chr7","36010353","36010618","chr10","62144731","62145008","72","26134378"
"chr7","36015930","36016004","chr12","73284670","73284743","16","37268740"
"chr7","36037212","36037431","chr17","1429564","1429780","45","34607648"
"chr7","36094685","36094951","chr2B","82555771","82556044","65","46461086"
"chr7","36106728","36106846","chr14","54547555","54547673","32","18440827"
"chr7","36127547","36127826","chr1","36962386","36962669","66","834839"
"chr7","36130712","36131021","chr1","114817238","114817547","67","78686526"
"chr7","36139581","36139736","chrX","49916830","49916985","33","13777249"
"chr7","36140512","36140628","chr3","198763104","198763221","19","162622592"
"chr7","36166481","36166688","chr6","153868912","153869122","71","117702431"
"chr7","36186036","36186178","chr1","1433985","1434130","24","34752051"
"chr7","36186461","36186653","chr8","1238748","1238944","28","34947713"
"chr7","36188712","36188992","chr1","182694157","182694451","69","146505445"
"chr7","36221225","36221490","chr1","1470353","1470616","34","34750872"
"chr7","36230651","36230948","chr1","1481516","1481810","38","34749135"
"chr7","36244435","36244536","chr4","114079087","114079196","28","77834652"
"chr7","36245303","36245586","chr1","1500359","1500628","51","34744944"
"chr7","36246234","36246383","chr10","92108530","92108678","31","55862296"
"chr7","36258320","36258613","chr16","33750440","33750732","70","2507880"
"chr7","36271075","36271331","chr1","1525498","1525770","61","34745577"
"chr7","36275195","36275490","chr14","73276928","73277226","77","37001733"
"chr7","36276959","36277246","chr11","77104742","77105042","68","40827783"
"chr7","36290728","36290892","chr5","51144248","51144411","27","14853520"
"chr7","36291257","36291385","chr5","34173856","34173985","25","2117401"
"chr7","36291673","36291924","chr16","7994491","7994752","82","28297182"
"chr7","36292875","36292990","chr2A","10416670","10416787","15","25876205"
"chr7","36359446","36359735","chr1","1609336","1609637","60","34750110"
"chr7","36424535","36424847","chr12","108745776","108746083","61","72321241"
"chr7","36440533","36440834","chr4","94460452","94460743","59","58019919"
"chr7","36449777","36450084","chr1","1695786","1696085","41","34753991"
"chr7","36536780","36537074","chrX","46258081","46258343","95","9721301"
"chr7","36573970","36574256","chr13","6846267","6846552","50","29727703"
"chr7","36580037","36580196","chr5","5469953","5470118","42","31110084"
"chr7","36594076","36594319","chr5","19004132","19004370","61","17589944"
"chr7","36630439","36630536","chr4","38435372","38435467","18","1804933"
"chr7","36658071","36658375","chr1","1901464","1901742","70","34756607"
"chr7","36793162","36793295","chr8","35001751","35001882","40","1791411"
"chr7","36822392","36822603","chr5","8577350","8577557","45","28245042"
"chr7","37061905","37062065","chr19","18112321","18112488","37","18949584"
"chr7","37065232","37065380","chr11","65955607","65955759","28","28890375"
"chr7","37502414","37502672","chr1","2949834","2950117","49","34552580"
"chr7","37551696","37552004","chr1","3010217","3010529","34","34541479"
"chr7","37658938","37659246","chr1","3115855","3116166","71","34543083"
"chr7","37823319","37823622","chr16","75497186","75497490","67","37673867"
"chr7","37894507","37894806","chr1","62034188","62034491","57","24139681"
"chr7","37968138","37968286","chr20","13392558","13392708","39","24575580"
"chr7","38017031","38017323","chr8","74436274","74436560","64","36419243"
"chr7","38072146","38072352","chr1","3521626","3521846","34","34550520"
"chr7","38161081","38161377","chr1","3609166","3609465","47","34551915"
"chr7","38189773","38189903","chr16","24603067","24603195","36","13586706"
"chr7","38217394","38217656","chr19","44508512","44508778","51","6291118"
"chr7","38345158","38345330","chr5","51144248","51144411","43","12799090"
"chr7","38411481","38411757","chr7","78576761","78577044","66","40165280"
"chr7","38461537","38461792","chr6","3233024","3233271","57","35228513"
"chr7","38724434","38724610","chr1","152885383","152885548","36","114160949"
"chr7","38835732","38836026","chr1","4253172","4253464","49","34582560"
"chr7","39073147","39073459","chr1","4485392","4485681","50","34587755"
"chr7","39224123","39224433","chr1","4638418","4638734","40","34585705"
"chr7","39238772","39239048","chr1","4652725","4653026","51","34586047"
"chr7","39253730","39254026","chr12","121913892","121914192","61","82660162"
"chr7","39286940","39287230","chr1","4697330","4697640","45","34589610"
"chr7","39382532","39382792","chr1","4777031","4777305","39","34605501"
"chr7","40121105","40121400","chr1","5491190","5491499","53","34629915"
"chr7","40131379","40131692","chr1","5501364","5501667","55","34630015"
"chr7","40303185","40303349","chr3","59350634","59350793","35","19047449"
"chr7","40306105","40306405","chr1","5713566","5713856","56","34592539"
"chr7","40307412","40307614","chr1","185016568","185016748","53","144709156"
"chr7","40315170","40315355","chr1","5722040","5722227","21","34593130"
"chr7","40361165","40361472","chr1","5768452","5768762","40","34592713"
"chr7","40399326","40399542","chr8","76898662","76898867","56","36499336"
"chr7","40399694","40399736","chr6","141467544","141467583","9","101067850"
"chr7","40525012","40525155","chr18","77876014","77876168","30","37351002"
"chr7","40549761","40550039","chr12","44124224","44124509","56","3574463"
"chr7","40559928","40560104","chr12","126043507","126043680","56","85483579"
"chr7","40581385","40581534","chr6","38533166","38533319","37","2048219"
"chr7","40606858","40606991","chrX","12360522","12360653","21","28246336"
"chr7","40636088","40636375","chr20","18881434","18881726","51","21754654"
"chr7","40664778","40664950","chr13","83077563","83077734","30","42412785"
"chr7","40699922","40700199","chr11","13292068","13292358","42","27407854"
"chr7","40769095","40769246","chr15","69740012","69740164","32","28970917"
"chr7","40784340","40784643","chr15","1818448","1818748","59","38965892"
"chr7","40822522","40822821","chr19","2376897","2377192","61","38445625"
"chr7","40911818","40911947","chr19","38753694","38753826","22","2158124"
"chr7","40943593","40943738","chr1","22298981","22299131","28","18644612"
"chr7","41000043","41000366","chr1","6236938","6237257","55","34763105"
"chr7","41003815","41004115","chr1","227415933","227416230","56","186412118"
"chr7","41012638","41012760","chr11","72628294","72628415","36","31615656"
"chr7","41013523","41013654","chr1","45612630","45612758","27","4599107"
"chr7","41028767","41028890","chr6","151826571","151826692","28","110797804"
"chr7","41056190","41056317","chr1","6284950","6285078","12","34771240"
"chr7","41083514","41083643","chr11","125643841","125643973","26","84560327"
"chr7","41088765","41088894","chr2A","37107556","37107687","17","3981209"
"chr7","41090062","41090354","chr1","6317355","6317654","49","34772707"
"chr7","41091413","41091713","chr1","6318733","6319008","61","34772680"
"chr7","41105965","41106133","chr6","9054911","9055073","47","32051054"
"chr7","41114456","41114765","chr1","6344790","6345100","34","34769666"
"chr7","41128541","41128683","chr1","7801459","7801595","29","33327082"
"chr7","41133804","41134087","chr10","7224012","7224277","72","33909792"
"chr7","41142147","41142432","chrX","119414489","119414773","52","78272342"
"chr7","41157155","41157465","chr1","6392580","6392874","56","34764575"
"chr7","41164813","41165103","chr12","127156277","127156565","73","85991464"
"chr7","41169082","41169362","chr3","34336277","34336558","61","6832805"
"chr7","41182427","41182724","chr1","6418551","6418858","56","34763876"
"chr7","41182738","41182895","chr8","95780191","95780349","39","54597453"
"chr7","41182959","41183233","chr1","6419100","6419398","49","34763859"
"chr7","41213718","41214043","chr1","6447882","6448205","55","34765836"
"chr7","41229973","41230100","chr11","69147152","69147272","38","27917179"
"chr7","41245744","41246035","chr1","6479207","6479499","37","34766537"
"chr7","41249106","41249375","chr1","6483352","6483634","44","34765754"
"chr7","41260482","41260759","chr1","6491005","6491290","42","34769477"
"chr7","41293883","41294165","chr1","6522935","6523220","47","34770948"
"chr7","41298096","41298399","chr19","34817747","34818053","65","6480349"
"chr7","41306381","41306689","chr1","6533410","6533714","43","34772971"
"chr7","41346032","41346309","chr1","131025547","131025825","66","89679515"
"chr7","41407564","41407870","chr1","6636197","6636503","41","34771367"
"chr7","41538540","41538835","chr6","36434428","36434727","53","5104112"
"chr7","41550222","41550433","chr1","6771390","6771609","45","34778832"
"chr7","41569903","41570112","chr12","109697331","109697532","43","68127428"
"chr7","41590598","41590862","chr7","30297669","30297922","72","11292929"
"chr7","41598784","41598921","chr20","32123638","32123783","34","9475146"
"chr7","41598928","41599133","chr10","42667519","42667723","33","1068591"
"chr7","41651812","41651942","chr20","24234554","24234683","21","17417258"
"chr7","41962292","41962483","chr12","119805659","119805848","53","77843367"
"chr7","42132775","42133050","chr5","18669856","18670140","55","23462919"
"chr7","42141884","42142188","chr3","16388804","16389104","54","25753080"
"chr7","42147624","42147842","chr6","75481027","75481235","48","33333403"
"chr7","42185531","42185819","chr4","15029081","15029370","50","27156450"
"chr7","42187647","42187792","chr6","36782155","36782293","34","5405492"
"chr7","42255803","42256109","chr1","7492009","7492309","32","34763794"
"chr7","42276491","42276772","chr1","7503659","7503959","49","34772832"
"chr7","42283392","42283637","chr19","29062117","29062376","69","13221275"
"chr7","42302768","42302899","chr15","52764054","52764186","32","10461286"
"chr7","42319004","42319299","chr1","7550880","7551175","38","34768124"
"chr7","42334964","42335253","chrX","13401559","13401850","54","28933405"
"chr7","42345693","42345905","chr13","7150448","7150655","38","35195245"
"chr7","42356157","42356445","chr1","7594348","7594638","39","34761809"
"chr7","42410271","42410557","chr1","7638604","7638904","49","34771667"
"chr7","42412212","42412497","chr1","7640881","7641165","33","34771331"
"chr7","42424604","42424906","chr1","7654423","7654722","31","34770181"
"chr7","42484663","42484789","chr1","24815947","24816071","18","17668716"
"chr7","42486306","42486436","chr3","162991924","162992048","25","120505618"
"chr7","42499119","42499249","chr1","7727821","7727943","19","34771298"
"chr7","42530569","42530871","chr1","7761224","7761536","37","34769345"
"chr7","42552880","42553023","chr8","20885859","20886004","28","21667021"
"chr7","42555803","42556050","chr1","7783224","7783501","63","34772579"
"chr7","42583640","42583937","chr1","7809815","7810096","37","34773825"
"chr7","42588593","42588895","chr12","123848633","123848932","61","81260040"
"chr7","42598006","42598155","chrX","41476886","41477033","30","1121120"
"chr7","42602938","42603112","chr5","34818252","34818426","44","7784686"
"chr7","42603735","42603804","chr3","126860282","126860349","12","84256547"
"chr7","42624137","42624341","chr7","79528701","79528905","52","36904564"
"chr7","42646701","42646892","chr17","464720","464906","39","42181981"
"chr7","42660691","42660951","chr1","7887359","7887650","54","34773332"
"chr7","42662637","42662790","chr12","19312537","19312701","37","23350100"
"chr7","42662894","42663039","chr15","35211030","35211174","39","7451864"
"chr7","42684832","42685041","chr16","41676490","41676700","48","1008342"
"chr7","42685045","42685341","chr1","7915531","7915827","40","34769514"
"chr7","42740581","42740842","chr6","112499268","112499520","54","69758687"
"chr7","42754891","42755006","chr16","9520625","9520740","23","33234266"
"chr7","42786244","42786490","chr1","8015052","8015315","49","34771192"
"chr7","42796633","42796848","chr1","8023285","8023514","32","34773348"
"chr7","42821404","42821660","chr20","51147801","51148058","78","8326397"
"chr7","42856358","42856459","chrX","134507081","134507185","18","91650723"
"chr7","42881098","42881227","chr11","122157777","122157907","25","79276679"
"chr7","42915348","42915565","chr20","44716602","44716819","48","1801254"
"chr7","42934890","42935015","chr10","111495083","111495208","19","68560193"
"chr7","42947887","42948027","chr19","37724136","37724258","54","5223751"
"chr7","42950867","42951152","chr1","8172824","8173099","62","34778043"
"chr7","42976116","42976228","chr6","32734587","32734699","20","10241529"
"chr7","42998136","42998252","chr1","8216823","8216939","19","34781313"
"chr7","43024893","43025187","chr1","8242984","8243280","36","34781909"
"chr7","43038824","43038969","chr6","6554953","6555078","40","36483871"
"chr7","43039035","43039130","chr3","127053966","127054064","25","84014931"
"chr7","43053135","43053438","chr1","8268319","8268618","52","34784816"
"chr7","43055459","43055736","chr14","24915480","24915757","68","18139979"
"chr7","43065622","43065895","chr3","49090792","49091064","66","6025170"
"chr7","43090615","43090724","chr7","14967118","14967225","28","28123497"
"chr7","43093461","43093752","chr1","8307744","8308027","37","34785717"
"chr7","43106883","43107209","chr8","103407624","103407946","75","60300741"
"chr7","43110980","43111137","chr2B","126639395","126639541","40","83528415"
"chr7","43115789","43115925","chr1","8331332","8331460","21","34784457"
"chr7","43131051","43131174","chr1","8349146","8349280","19","34781905"
"chr7","43157922","43158021","chr8","15220773","15220864","28","27937149"
"chr7","43179357","43179635","chr14","38438003","38438290","70","4741354"
"chr7","43211298","43211399","chr16","27681758","27681861","24","15529540"
"chr7","43240664","43240933","chr8","24118205","24118491","65","19122459"
"chr7","43246257","43246544","chr1","8452909","8453224","52","34793348"
"chr7","43272599","43272881","chr1","8484655","8484950","46","34787944"
"chr7","43289327","43289447","chr9","107827822","107827945","23","64538495"
"chr7","43292713","43292835","chr1","8503538","8503660","13","34789175"
"chr7","43315295","43315434","chr6","35062432","35062567","35","8252863"
"chr7","43325228","43325374","chr10","29754500","29754651","34","13570728"
"chr7","43327715","43327870","chr19","51781571","51781725","42","8453856"
"chr7","43329981","43330141","chr1","8537193","8537347","26","34792788"
"chr7","43356883","43357096","chr8","86155985","86156190","41","42799102"
"chr7","43376069","43376207","chr7","77000001","77000126","37","33623932"
"chr7","43381461","43381790","chr1","8595401","8595722","62","34786060"
"chr7","43400405","43400535","chr6","18588428","18588554","29","24811977"
"chr7","43441853","43442125","chr1","8668259","8668556","54","34773594"
"chr7","43444013","43444127","chrX","42166088","42166204","21","1277925"
"chr7","43445562","43445848","chr6","82086444","82086730","63","38640882"
"chr7","43464489","43464788","chr1","8691765","8692070","55","34772724"
"chr7","43483545","43483833","chr1","8709639","8709945","61","34773906"
"chr7","43486375","43486576","chr10","37833913","37834126","49","5652462"
"chr7","43492306","43492430","chr3","65193379","65193500","25","21701073"
"chr7","43502829","43502946","chr22","14821499","14821616","16","28681330"
"chr7","43502947","43503059","chr7","68275138","68275242","35","24772191"
"chr7","43508662","43508957","chr6","141448278","141448569","58","97939616"
"chr7","43510927","43511215","chr1","8736381","8736682","51","34774546"
"chr7","43518135","43518449","chr1","8739584","8739893","43","34778551"
"chr7","43568407","43568559","chr2B","106023689","106023844","32","62455282"
"chr7","43581924","43582238","chr1","8799558","8799846","50","34782366"
"chr7","43599266","43599391","chr1","8816144","8816269","10","34783122"
"chr7","43606359","43606653","chr1","8822130","8822415","47","34784229"
"chr7","43615231","43615522","chr1","8828495","8828801","49","34786736"
"chr7","43625392","43625538","chr2B","126639395","126639541","34","83014003"
"chr7","43628113","43628386","chr19","50010806","50011072","62","6382693"
"chr7","43675520","43675645","chr1","8880823","8880948","6","34794697"
"chr7","43737397","43737700","chrX","74228041","74228342","56","30490644"
"chr7","43769161","43769436","chr18","20530306","20530599","67","23238855"
"chr7","43790797","43790972","chr1","9002001","9002187","42","34788796"
"chr7","43795541","43795728","chr1","9006546","9006728","28","34788995"
"chr7","43990334","43990458","chr3","200179996","200180111","20","156189662"
"chr7","44012776","44013071","chr1","9195822","9196121","37","34816954"
"chr7","44084139","44084383","chr1","9279415","9279664","34","34804724"
"chr7","44105492","44105761","chr1","9301448","9301737","57","34804044"
"chr7","44117988","44118280","chr1","221569715","221570002","53","177451727"
"chr7","44127565","44127847","chr1","9318108","9318376","55","34809457"
"chr7","44176047","44176360","chr16","12448047","12448357","62","31728000"
"chr7","44219369","44219656","chr1","9399802","9400109","54","34819567"
"chr7","44226070","44226293","chr5","59809204","59809424","53","15583134"
"chr7","44275498","44275697","chr19","3699724","3699924","56","40575774"
"chr7","44361915","44362208","chr1","9536480","9536773","44","34825435"
"chr7","44407250","44407507","chr1","9577323","9577580","40","34829927"
"chr7","44407804","44408052","chr1","9577867","9578131","42","34829937"
"chr7","44421673","44421957","chr10","46918114","46918393","67","2496441"
"chr7","44430118","44430170","chr3","110859600","110859650","9","66429482"
"chr7","44433560","44433825","chr15","61699539","61699802","59","17265979"
"chr7","44435055","44435246","chr1","226368103","226368288","45","181933048"
"chr7","44472566","44472846","chr14","75080552","75080837","69","30607986"
"chr7","44506601","44506777","chr1","9665796","9665965","27","34840805"
"chr7","44507158","44507275","chr1","9666032","9666156","15","34841126"
"chr7","44510946","44511070","chr14","74639500","74639624","22","30128554"
"chr7","44515321","44515612","chr1","9677318","9677619","39","34838003"
"chr7","44557652","44557899","chr1","9706976","9707222","35","34850676"
"chr7","44580533","44580812","chr1","9730175","9730455","36","34850358"
"chr7","44605242","44605368","chr1","24815947","24816071","21","19789295"
"chr7","44606644","44606709","chr16","31366418","31366485","14","13240226"
"chr7","44607892","44608015","chr10","140207939","140208065","22","95600047"
"chr7","44609755","44609920","chr14","57972164","57972328","33","13362409"
"chr7","44610685","44610789","chr1","40314970","40315074","31","4295715"
"chr7","44627414","44627712","chr1","9774109","9774401","48","34853305"
"chr7","44635035","44635288","chr1","9781669","9781934","59","34853366"
"chr7","44652076","44652359","chr1","183947223","183947512","66","139295147"
"chr7","44739750","44739908","chr1","9880179","9880343","26","34859571"
"chr7","44769560","44769699","chr10","30690604","30690743","27","14078956"
"chr7","44776686","44776759","chr9","67862625","67862687","24","23085939"
"chr7","44776858","44777015","chrX","47980307","47980465","54","3203449"
"chr7","44786711","44787007","chr1","9935147","9935439","34","34851564"
"chr7","44792790","44793041","chr1","9940626","9940869","34","34852164"
"chr7","44806249","44806557","chr5","55653971","55654269","67","10847722"
"chr7","44815829","44816123","chr1","9961333","9961611","57","34854496"
"chr7","44821266","44821547","chr11","58771612","58771896","66","13950346"
"chr7","44930684","44930744","chr12","41105677","41105730","17","3825007"
"chr7","44931504","44931744","chr1","10069312","10069561","41","34862192"
"chr7","44941028","44941287","chr5","23795056","23795315","59","21145972"
"chr7","44950738","44951004","chr1","10083006","10083275","34","34867732"
"chr7","44952848","44953134","chr1","10085013","10085295","61","34867835"
"chr7","44968799","44969105","chr1","10102071","10102371","42","34866728"
"chr7","44971128","44971254","chr1","10104639","10104765","16","34866489"
"chr7","44972901","44973205","chr5","118169179","118169484","60","73196278"
"chr7","44978589","44978751","chrX","130137391","130137550","32","85158802"
"chr7","44999300","44999469","chr3","10866047","10866211","36","34133253"
"chr7","45004002","45004275","chr6","150118641","150118920","63","105114639"
"chr7","45045351","45045441","chr1","10175866","10175970","16","34869485"
"chr7","45046808","45047007","chr19","40006029","40006215","41","5040779"
"chr7","45059620","45059749","chr5","48966184","48966302","36","3906564"
"chr7","45064010","45064260","chr1","10196731","10197011","52","34867279"
"chr7","45068116","45068306","chr7","2363764","2363952","42","42704352"
"chr7","45080509","45080797","chr1","10217890","10218188","55","34862619"
"chr7","45126993","45127250","chr1","10263553","10263810","39","34863440"
"chr7","45148474","45148676","chr1","10285852","10286055","33","34862622"
"chr7","45158432","45158640","chr1","51823505","51823703","50","6665073"
"chr7","45492090","45492371","chr1","10625475","10625766","38","34866615"
"chr7","45531009","45531311","chr1","10662137","10662426","30","34868872"
"chr7","45570132","45570398","chr1","10701696","10701925","62","34868436"
"chr7","45585198","45585505","chr1","10721194","10721485","53","34864004"
"chr7","45593420","45593725","chr22","8691251","8691556","65","36902169"
"chr7","45597643","45597939","chr1","110467296","110467589","62","64869653"
"chr7","45616305","45616401","chr19","47910091","47910191","18","2293786"
"chr7","45650082","45650250","chr13","30048450","30048618","38","15601632"
"chr7","45668679","45668979","chr2A","21560596","21560907","62","24108083"
"chr7","45673110","45673356","chr5","38347057","38347291","56","7326053"
"chr7","45689025","45689299","chr15","44693190","44693446","69","995835"
"chr7","45690427","45690557","chr15","52764054","52764186","28","7073627"
"chr7","45694470","45694772","chr1","10819361","10819676","50","34875109"
"chr7","45696663","45696789","chr6","74653208","74653329","28","28956545"
"chr7","45701098","45701246","chr16","76317400","76317554","29","30616302"
"chr7","45768772","45769060","chr1","10904368","10904665","52","34864404"
"chr7","45771661","45771956","chr1","10907015","10907304","49","34864646"
"chr7","45775925","45776216","chr8","45924024","45924319","66","148099"
"chr7","45792756","45792861","chr1","17009703","17009809","26","28783053"
"chr7","45794012","45794259","chr1","10929819","10930083","48","34864193"
"chr7","45799530","45799893","chr1","10934607","10934990","63","34864923"
"chr7","45803832","45804114","chr1","10938574","10938856","26","34865258"
"chr7","45809113","45809372","chr1","10943610","10943882","43","34865503"
"chr7","45837898","45838042","chr12","91805211","91805359","37","45967313"
"chr7","45845390","45845520","chr19","44604353","44604482","18","1241037"
"chr7","45845620","45845784","chr3","143974755","143974928","39","98129135"
"chr7","45865655","45865763","chr3","186615177","186615282","12","140749522"
"chr7","45894660","45894897","chr18","3709205","3709449","52","42185455"
"chr7","45914118","45914233","chr1","11020903","11021015","10","34893215"
"chr7","45929870","45930155","chr1","11037530","11037829","35","34892340"
"chr7","45931739","45932035","chr1","11039400","11039714","60","34892339"
"chr7","45951731","45952038","chr1","11058598","11058907","33","34893133"
"chr7","45956019","45956240","chr19","37794171","37794401","49","8161848"
"chr7","45995457","45995754","chr6","107305560","107305849","62","61310103"
"chr7","46009765","46009932","chr14","72724722","72724884","31","26714957"
"chr7","46064826","46065138","chr1","32297765","32298068","69","13767061"
"chr7","46106655","46106804","chr16","3083675","3083826","32","43022980"
"chr7","46133008","46133299","chr9","15043290","15043588","69","31089718"
"chr7","46149586","46149857","chr1","11230596","11230876","28","34918990"
"chr7","46150896","46151153","chr5","143276648","143276920","63","97125752"
"chr7","46153139","46153249","chr1","11234515","11234622","10","34918624"
"chr7","46155564","46155718","chr10","49585047","49585201","31","3429483"
"chr7","46193972","46194104","chr8","144957651","144957776","32","98763679"
"chr7","46194898","46195023","chr9","89173618","89173747","22","42978720"
"chr7","46217290","46217564","chr1","11230596","11230876","33","34986694"
"chr7","46218622","46218901","chr1","11231943","11232238","55","34986679"
"chr7","46220854","46220964","chr1","11234515","11234622","14","34986339"
"chr7","46223239","46223415","chr1","11237280","11237475","42","34985959"
"chr7","46301951","46302215","chr1","11313450","11313724","36","34988501"
"chr7","46359637","46359925","chr1","11383012","11383296","33","34976625"
"chr7","46375777","46376068","chr1","11397115","11397380","56","34978662"
"chr7","46381625","46381790","chr7","79657650","79657818","48","33276025"
"chr7","46403394","46403568","chr1","11425956","11426132","27","34977438"
"chr7","46415412","46415713","chr1","11437535","11437833","33","34977877"
"chr7","46450407","46450631","chr1","11466029","11466251","33","34984378"
"chr7","46509766","46510059","chr1","11510429","11510699","48","34999337"
"chr7","46531230","46531325","chr5","109760403","109760503","24","63229173"
"chr7","46533310","46533625","chr1","11538463","11538786","45","34994847"
"chr7","46555915","46556045","chr10","12650705","12650831","26","33905210"
"chr7","46570692","46570982","chr1","11572620","11572899","47","34998072"
"chr7","46574229","46574516","chr1","11576173","11576487","52","34998056"
"chr7","46592231","46592549","chr1","11594608","11594920","45","34997623"
"chr7","46601496","46601821","chr4","2738910","2739200","99","43862586"
"chr7","46610492","46610742","chr6","35018897","35019132","69","11591595"
"chr7","46620909","46621032","chr4","133893763","133893889","17","87272854"
"chr7","46627569","46627868","chr1","11634672","11634975","44","34992897"
"chr7","46632119","46632247","chr7","75017050","75017167","31","28384931"
"chr7","46674307","46674650","chr1","11678224","11678540","61","34996083"
"chr7","46682336","46682461","chr10","12396902","12397037","25","34285434"
"chr7","46682476","46682721","chr1","11688353","11688594","31","34994123"
"chr7","46687082","46687395","chr1","11693307","11693627","53","34993775"
"chr7","46705089","46705389","chr1","11716459","11716768","45","34988630"
"chr7","46706596","46706927","chr3","58493380","58493699","85","11786784"
"chr7","46718051","46718271","chr2B","111420804","111421016","45","64702753"
"chr7","46724358","46724651","chr1","11734239","11734515","57","34990119"
"chr7","46759471","46759635","chr1","162178116","162178275","38","115418645"
"chr7","46760405","46760536","chr3","131714172","131714304","22","84953767"
"chr7","46800577","46800713","chr3","267312","267456","34","46533265"
"chr7","46919477","46919772","chr1","11928134","11928426","38","34991343"
"chr7","46946816","46947120","chr1","11955124","11955429","37","34991692"
"chr7","46969241","46969372","chr1","148219593","148219735","34","101250352"
"chr7","46975179","46975342","chr1","184720130","184720300","34","137744951"
"chr7","46986163","46986463","chr1","11989450","11989733","49","34996713"
"chr7","46996594","46996871","chr1","190065982","190066274","59","143069388"
"chr7","47001191","47001291","chr19","16749128","16749228","14","30252063"
"chr7","47069587","47069868","chr1","12051012","12051291","50","35018575"
"chr7","47071334","47071615","chr1","12051012","12051291","51","35020322"
"chr7","47072678","47072962","chr1","12052688","12052960","42","35019990"
"chr7","47102282","47102572","chr4","8159027","8159316","53","38943255"
"chr7","47113472","47113757","chr14","41627283","41627568","59","5486189"
"chr7","47124063","47124354","chr1","12098914","12099216","48","35025149"
"chr7","47143999","47144172","chr10","119220439","119220615","39","72076440"
"chr7","47318136","47318369","chr18","3709205","3709449","49","43608931"
"chr7","47318535","47318818","chr1","12284960","12285239","43","35033575"
"chr7","47327321","47327590","chr6","10933389","10933663","54","36393932"
"chr7","47334740","47334855","chr1","12303190","12303300","19","35031550"
"chr7","47339493","47339793","chr1","12306971","12307272","35","35032522"
"chr7","47350759","47350976","chr1","204553209","204553407","60","157202450"
"chr7","47351239","47351304","chr3","126860282","126860349","10","79509043"
"chr7","47367849","47368158","chr1","12331928","12332205","60","35035921"
"chr7","47369464","47369765","chr4","151944849","151945132","61","104575385"
"chr7","47384138","47384431","chr1","12344483","12344781","42","35039655"
"chr7","47392528","47392665","chr1","32730027","32730168","34","14662501"
"chr7","47393684","47393819","chr6","35062432","35062567","33","12331252"
"chr7","47400086","47400175","chr7","73286555","73286645","13","25886469"
"chr7","47457884","47458128","chr18","48100369","48100613","51","642485"
"chr7","47536409","47536637","chr19","31273085","31273303","49","16263324"
"chr7","47633602","47633922","chr1","12682588","12682874","73","34951014"
"chr7","47657672","47657928","chr1","205040659","205040909","93","157382987"
"chr7","47668804","47669104","chr16","60238828","60239122","57","12570024"
"chr7","47741896","47742208","chr1","150808926","150809223","77","103067030"
"chr7","47748747","47748858","chr1","13497947","13498057","20","34250800"
"chr7","47749678","47749953","chr16","40803572","40803860","60","6946106"
"chr7","47751083","47751209","chr22","4311510","4311636","18","43439573"
"chr7","47778712","47778834","chr1","13536774","13536900","15","34241938"
"chr7","47779902","47780173","chr1","13538010","13538282","39","34241892"
"chr7","47833921","47834219","chr12","98196946","98197249","58","50363025"
"chr7","47909113","47909326","chr1","13669102","13669317","25","34240011"
"chr7","47971444","47971754","chr1","13730394","13730713","74","34241050"
"chr7","48066649","48066944","chr1","13820850","13821145","26","34245799"
"chr7","48101414","48101542","chr6","18588428","18588554","27","29512986"
"chr7","48101765","48102009","chr1","13854532","13854791","44","34247233"
"chr7","48157683","48157807","chr1","13912257","13912382","11","34245426"
"chr7","48368087","48368373","chr1","14112366","14112658","39","34255721"
"chr7","48602233","48602347","chr5","25268578","25268694","20","23333655"
"chr7","48886535","48886826","chr1","204338414","204338705","56","155451879"
"chr7","48894435","48894753","chr1","14592581","14592877","68","34301854"
"chr7","48924193","48924318","chr8","9176979","9177104","22","39747214"
"chr7","48924343","48924397","chr3","199270190","199270238","17","150345847"
"chr7","48946917","48947228","chr1","14642981","14643290","35","34303936"
"chr7","48981441","48981740","chr1","14674546","14674851","29","34306895"
"chr7","48984233","48984502","chr1","14677031","14677314","50","34307202"
"chr7","48991453","48991741","chr1","14684301","14684591","35","34307152"
"chr7","48995400","48995577","chr1","130297384","130297555","46","81301984"
"chr7","49013760","49014049","chr13","10320820","10321109","66","38692940"
"chr7","49023168","49023457","chr1","14712210","14712514","56","34310958"
"chr7","49029168","49029438","chr7","140445656","140445924","55","91416488"
"chr7","49039618","49039735","chr16","60511290","60511407","19","11471672"
"chr7","49044163","49044441","chr1","14730073","14730342","62","34314090"
"chr7","49057782","49058060","chr1","14744037","14744316","32","34313745"
"chr7","49060024","49060336","chr1","14746306","14746619","43","34313718"
"chr7","49068570","49068851","chr11","7174181","7174466","59","41894389"
"chr7","49072255","49072423","chr4","163491292","163491465","29","114419037"
"chr7","49129127","49129375","chr12","117939199","117939428","62","68810072"
"chr7","49199329","49199451","chr10","25079142","25079264","18","24120187"
"chr7","49199796","49199958","chr1","14879462","14879620","22","34320334"
"chr7","49261096","49261384","chr1","206845090","206845371","63","157583994"
"chr7","49324460","49324683","chrX","71066264","71066485","55","21741804"
"chr7","49402510","49402823","chr1","15073263","15073568","42","34329247"
"chr7","49435169","49435277","chr1","15094606","15094723","18","34340563"
"chr7","49496499","49496778","chr1","15158694","15158970","37","34337805"
"chr7","49508935","49509234","chr13","5811459","5811755","48","43697476"
"chr7","49509663","49509966","chr1","15171368","15171680","40","34338295"
"chr7","49531150","49531444","chr7","76146308","76146602","52","26615158"
"chr7","49621113","49621240","chr3","102978268","102978398","17","53357155"
"chr7","49636107","49636411","chr1","94169124","94169424","60","44533017"
"chr7","49646995","49647256","chr22","20364309","20364570","56","29282686"
"chr7","49647395","49647498","chr11","67337030","67337134","15","17689635"
"chr7","49690785","49691074","chr1","15345538","15345825","35","34345247"
"chr7","49692667","49692800","chr1","15347485","15347622","14","34345182"
"chr7","49706141","49706434","chr1","15359303","15359597","36","34346838"
"chr7","49711458","49711755","chr1","15364312","15364609","28","34347146"
"chr7","49739050","49739174","chr1","15391687","15391807","11","34347363"
"chr7","49741509","49741815","chr1","15394193","15394504","31","34347316"
"chr7","49749481","49749844","chr1","15402124","15402471","72","34347357"
"chr7","49752574","49752883","chr1","15404403","15404720","47","34348171"
"chr7","49812031","49812323","chr1","15487053","15487336","35","34324978"
"chr7","49827413","49827674","chr1","15500359","15500621","31","34327054"
"chr7","49851106","49851204","chr1","15520474","15520571","14","34330632"
"chr7","49856891","49857181","chr1","15525339","15525636","34","34331552"
"chr7","49885309","49885607","chr1","15548688","15548995","42","34336621"
"chr7","49886174","49886282","chr12","1702","1809","20","49884472"
"chr7","49887002","49887184","chr3","115388837","115389025","38","65501835"
"chr7","49899566","49899894","chr1","15560916","15561244","61","34338650"
"chr7","49904646","49904954","chr1","129146150","129146448","64","79241504"
"chr7","49915944","49916327","chr1","15574317","15574689","51","34341627"
"chr7","49922379","49922668","chr1","15580747","15581032","40","34341632"
"chr7","49923136","49923404","chr1","15581429","15581685","40","34341707"
"chr7","49934231","49934524","chr1","15592316","15592625","63","34341915"
"chr7","49955430","49955552","chr1","15608396","15608519","12","34347034"
"chr7","49966660","49966792","chr9","110772368","110772501","33","60805708"
"chr7","49986105","49986163","chr5","14809059","14809114","10","35177046"
"chr7","50010131","50010437","chr1","15655632","15655938","27","34354499"
"chr7","50017236","50017547","chr15","45983082","45983387","67","4034154"
"chr7","50020562","50020870","chr1","15667256","15667572","53","34353306"
"chr7","50027224","50027339","chr1","15673118","15673244","19","34354106"
"chr7","50034498","50034781","chr1","15681500","15681784","31","34352998"
"chr7","50063189","50063391","chr1","15709709","15709913","25","34353480"
"chr7","50063887","50063996","chr1","15710547","15710657","16","34353340"
"chr7","50098036","50098147","chr1","15739682","15739798","18","34358354"
"chr7","50157971","50158207","chr1","15808192","15808468","69","34349779"
"chr7","50169418","50169555","chr5","46300557","46300688","41","3868861"
"chr7","50187001","50187298","chr5","96578970","96579251","88","46391969"
"chr7","50192118","50192430","chrX","110416524","110416832","77","60224406"
"chr7","50222742","50223010","chr5","152433419","152433695","57","102210677"
"chr7","50248692","50248968","chr6","160957547","160957837","60","110708855"
"chr7","50287685","50287885","chr16","48473681","48473875","59","1814004"
"chr7","50290215","50290361","chr20","13392558","13392708","31","36897657"
"chr7","50307968","50308257","chr1","15941208","15941520","50","34366760"
"chr7","50326475","50326694","chr19","18271347","18271565","63","32055128"
"chr7","50335536","50335801","chr3","187941466","187941722","61","137605930"
"chr7","50351095","50351381","chr6","36339192","36339474","74","14011903"
"chr7","50409202","50409476","chr1","16056511","16056765","49","34352691"
"chr7","50441197","50441326","chr12","29897183","29897312","21","20544014"
"chr7","50533917","50534136","chr1","16177944","16178143","33","34355973"
"chr7","50566871","50567169","chr1","16207361","16207665","44","34359510"
"chr7","50579746","50579870","chr3","49040009","49040134","19","1539737"
"chr7","50582677","50582932","chr1","16226914","16227188","37","34355763"
"chr7","50583779","50584087","chr1","16228191","16228507","43","34355588"
"chr7","50590282","50590433","chr1","16242440","16242579","34","34347842"
"chr7","50591395","50591683","chr1","16243909","16244210","53","34347486"
"chr7","50593981","50594274","chr1","16246484","16246765","35","34347497"
"chr7","50616918","50617201","chr1","16272876","16273180","48","34344042"
"chr7","50625676","50625965","chr1","16286424","16286688","58","34339252"
"chr7","50634429","50634551","chrX","53551068","53551188","28","2916639"
"chr7","50668261","50668447","chr14","22680689","22680870","43","27987572"
"chr7","50668844","50668972","chr13","93076612","93076743","21","42407768"
"chr7","50668973","50669151","chr1","16324874","16325033","52","34344099"
"chr7","50669507","50669676","chr1","16325426","16325608","37","34344081"
"chr7","50696927","50697206","chr1","77964005","77964286","63","27267078"
"chr7","50705095","50705237","chr1","223894247","223894395","33","173189152"
"chr7","50709518","50709811","chr1","16343801","16344089","54","34365717"
"chr7","50711588","50711895","chr1","16345719","16346025","61","34365869"
"chr7","50739410","50739719","chr1","16383018","16383323","35","34356392"
"chr7","50743552","50743856","chr1","16384957","16385284","50","34358595"
"chr7","50752240","50752503","chr1","16393135","16393410","42","34359105"
"chr7","50808756","50808902","chr2B","94897282","94897419","43","44088526"
"chr7","50809079","50809212","chr7","74790659","74790791","21","23981580"
"chr7","50829146","50829349","chr1","16788619","16788825","22","34040527"
"chr7","50857388","50857552","chr13","45598608","45598771","50","5258780"
"chr7","50900490","50900695","chr15","42691362","42691571","41","8209128"
"chr7","50911846","50911966","chr4","99016771","99016893","16","48104925"
"chr7","50915461","50915746","chr1","16871045","16871331","37","34044416"
"chr7","50926521","50926785","chr1","52520693","52520963","66","1594172"
"chr7","50933280","50933556","chr5","122986208","122986501","65","72052928"
"chr7","50949221","50949350","chr1","16901581","16901712","15","34047640"
"chr7","50960665","50960958","chr1","16913454","16913751","51","34047211"
"chr7","50971530","50971835","chr1","16923214","16923522","43","34048316"
"chr7","51005356","51005651","chr1","16963016","16963320","35","34042340"
"chr7","51024849","51025079","chr1","16986259","16986494","27","34038590"
"chr7","51031788","51032066","chr1","16992247","16992510","53","34039541"
"chr7","51050457","51050758","chr1","17010110","17010412","39","34040347"
"chr7","51113805","51114076","chr1","17066845","17067125","39","34046960"
"chr7","51117801","51117965","chr19","7784006","7784166","37","43333795"
"chr7","51133394","51133698","chr1","17085051","17085363","36","34048343"
"chr7","51159828","51160131","chr1","17114940","17115225","47","34044888"
"chr7","51189081","51189379","chr1","17134629","17134929","39","34054452"
"chr7","51191235","51191413","chr7","70403860","70404043","47","19212625"
"chr7","51208302","51208582","chr8","144786356","144786646","69","93578054"
"chr7","51221504","51221747","chr14","52619869","52620109","50","1398365"
"chr7","51229563","51229859","chr1","17177063","17177349","45","34052500"
"chr7","51270358","51270509","chr10","116483319","116483474","40","65212961"
"chr7","51276350","51276654","chr12","93916751","93917049","75","42640401"
"chr7","51366023","51366285","chr18","2290499","2290770","62","49075524"
"chr7","51400835","51400936","chr11","62728542","62728634","22","11327707"
"chr7","51417744","51418031","chr1","17354003","17354291","34","34063741"
"chr7","51435530","51435822","chr10","25095441","25095741","59","26340089"
"chr7","51445146","51445459","chr1","17379621","17379927","55","34065525"
"chr7","51451030","51451312","chr1","17384920","17385200","30","34066110"
"chr7","51660362","51660493","chr1","17583170","17583302","11","34077192"
"chr7","51713360","51713667","chr1","17632058","17632353","47","34081302"
"chr7","51740806","51740937","chr1","17659686","17659816","16","34081120"
"chr7","51752137","51752435","chr1","2285941","2286239","62","49466196"
"chr7","51816549","51816838","chr1","17722354","17722649","32","34094195"
"chr7","51835845","51836099","chr20","36881415","36881668","59","14954430"
"chr7","51878507","51878654","chr3","267312","267456","34","51611195"
"chr7","51889615","51889710","chr1","17798378","17798465","10","34091237"
"chr7","51891299","51891617","chr1","17800103","17800402","58","34091196"
"chr7","52324022","52324270","chr1","60034453","60034701","60","7710431"
"chr7","52379490","52379786","chr1","18273101","18273399","46","34106389"
"chr7","52404807","52404960","chr10","92108530","92108678","30","39703723"
"chr7","52413089","52413332","chr1","18307370","18307640","46","34105719"
"chr7","52437902","52438181","chr6","87606836","87607116","65","35168934"
"chr7","52474482","52474744","chr7","128027283","128027543","60","75552801"
"chr7","52524988","52525267","chr7","1708256","1708538","69","50816732"
"chr7","52564032","52564189","chr15","21950673","21950831","30","30613359"
"chr7","52577874","52578080","chr19","1552728","1552919","56","51025146"
"chr7","52586688","52586986","chr1","18466701","18466995","37","34119987"
"chr7","52609472","52609750","chr22","1222516","1222802","61","51386956"
"chr7","52657842","52658131","chr1","18536715","18537003","37","34121127"
"chr7","52697450","52697721","chr1","18576698","18576979","46","34120752"
"chr7","52825491","52825763","chr1","18703440","18703712","25","34122051"
"chr7","52856249","52856439","chr18","55236793","55236976","32","2380544"
"chr7","52856532","52856634","chr1","54054489","54054593","25","1197957"
"chr7","52912001","52912315","chr1","18782848","18783158","39","34129153"
"chr7","52966900","52967044","chr1","23727757","23727901","37","29239143"
"chr7","53047160","53047386","chr1","18904814","18905040","24","34142346"
"chr7","53050892","53051222","chr1","18907986","18908317","55","34142906"
"chr7","53065270","53065534","chr2B","64894894","64895158","59","11829624"
"chr7","53094894","53095175","chr1","18948142","18948416","67","34146752"
"chr7","53141718","53141848","chr4","181487521","181487654","33","128345803"
"chr7","53187089","53187380","chr7","56404364","56404655","66","3217275"
"chr7","53205965","53206136","chr12","8768282","8768448","46","44437683"
"chr7","53309804","53309930","chr10","12650705","12650831","40","40659099"
"chr7","53343645","53343768","chr1","19204659","19204783","14","34138986"
"chr7","53374928","53375235","chr1","19245025","19245324","47","34129903"
"chr7","53382027","53382137","chr4","94047750","94047860","15","40665723"
"chr7","53387286","53387506","chr16","47158584","47158805","55","6228702"
"chr7","53434854","53435107","chr1","19296843","19297102","36","34138011"
"chr7","53442144","53442425","chr5","997797","998069","60","52444347"
"chr7","53450025","53450301","chr1","19312002","19312271","48","34138023"
"chr7","53452621","53452743","chrX","41011045","41011167","20","12441576"
"chr7","53517576","53517871","chr1","19377983","19378282","31","34139593"
"chr7","53532489","53532791","chr16","10963785","10964082","62","42568704"
"chr7","53539470","53539680","chr5","59229232","59229447","58","5689762"
"chr7","53541670","53541871","chr19","18243616","18243815","48","35298054"
"chr7","53544576","53544749","chr10","115667294","115667466","39","62122718"
"chr7","53553565","53553794","chr15","62057793","62058006","52","8504228"
"chr7","53560431","53560706","chr4","120243844","120244136","65","66683413"
"chr7","53562815","53563107","chr4","181651238","181651537","64","128088423"
"chr7","53582519","53582805","chr5","96942875","96943163","63","43360356"
"chr7","53593314","53593473","chr3","10866047","10866211","31","42727267"
"chr7","53594240","53594393","chr15","67737918","67738076","31","14143678"
"chr7","53596211","53596511","chr1","19476074","19476376","35","34120137"
"chr7","53600067","53600174","chr4","195001113","195001216","22","141401046"
"chr7","53602844","53603146","chr9","121324912","121325219","60","67722068"
"chr7","53647560","53647686","chr4","194130642","194130769","22","140483082"
"chr7","53669577","53669865","chr10","35965290","35965589","72","17704287"
"chr7","53682622","53682912","chr1","19554947","19555237","44","34127675"
"chr7","53691040","53691286","chr19","31600852","31601110","63","22090188"
"chr7","53693664","53693926","chr1","19566686","19566955","39","34126978"
"chr7","53726152","53726426","chr1","19600461","19600739","39","34125691"
"chr7","53726455","53726638","chr1","19600740","19600946","40","34125715"
"chr7","53729123","53729494","chr5","122751402","122751765","103","69022279"
"chr7","53730961","53731088","chr1","19605658","19605788","20","34125303"
"chr7","53789467","53789777","chr1","19668231","19668539","52","34121236"
"chr7","53839418","53839698","chr1","19718098","19718378","39","34121320"
"chr7","53849303","53849431","chr1","19733518","19733644","9","34115785"
"chr7","53858287","53858580","chr10","118181249","118181538","49","64322962"
"chr7","53881122","53881419","chr1","19765157","19765456","42","34115965"
"chr7","53882595","53882723","chr3","144886878","144887008","21","91004283"
"chr7","53883200","53883321","chr7","6379157","6379273","32","47504043"
"chr7","53893163","53893276","chr15","18038800","18038916","21","35854363"
"chr7","53928687","53928960","chr1","19806127","19806405","64","34122560"
"chr7","53961284","53961578","chr1","19842367","19842669","38","34118917"
"chr7","54038456","54038587","chrX","3940333","3940465","24","50098123"
"chr7","54079009","54079133","chrX","70594684","70594808","21","16515675"
"chr7","54081686","54081959","chr1","19958057","19958337","38","34123629"
"chr7","54106861","54107158","chr13","34855159","34855453","52","19251702"
"chr7","54122783","54123081","chr1","19993703","19994014","56","34129080"
"chr7","54134559","54134601","chr3","4982612","4982655","11","49151947"
"chr7","54147576","54147719","chr5","3296328","3296466","36","50851248"
"chr7","54156198","54156426","chr1","20024792","20025035","48","34131406"
"chr7","54226789","54227104","chr1","45223007","45223325","63","9003782"
"chr7","54227215","54227478","chr1","20115284","20115567","52","34111931"
"chr7","54302192","54302482","chr1","20196724","20197025","49","34105468"
"chr7","54339660","54339972","chr1","20233750","20234058","46","34105910"
"chr7","54352521","54352818","chr1","20246139","20246464","55","34106382"
"chr7","54357621","54357880","chr19","19434477","19434752","60","34923144"
"chr7","54383563","54383821","chr7","2330840","2331092","57","52052723"
"chr7","54413853","54414083","chr22","29527054","29527285","64","24886799"
"chr7","54507926","54508224","chr1","20396149","20396459","44","34111777"
"chr7","54514530","54514782","chr1","20402684","20402964","48","34111846"
"chr7","54517599","54517900","chr1","20405755","20406064","53","34111844"
"chr7","54525426","54525709","chr1","20409489","20409777","38","34115937"
"chr7","54533483","54533750","chr19","808512","808780","59","53724971"
"chr7","54578378","54578602","chr6","146361614","146361839","47","91783236"
"chr7","54581886","54582012","chr16","24603067","24603195","34","29978819"
"chr7","54595149","54595453","chr15","21383408","21383710","66","33211741"
"chr7","54602025","54602159","chr10","108963494","108963624","21","54361469"
"chr7","54603439","54603741","chr12","121913892","121914192","55","67310453"
"chr7","54605725","54606006","chr1","20489273","20489552","32","34116452"
"chr7","54606410","54606711","chr1","20489928","20490239","48","34116482"
"chr7","54613886","54614178","chr1","20497310","20497617","45","34116576"
"chr7","54616115","54616390","chr17","52169985","52170256","63","2446130"
"chr7","54633826","54633938","chr6","140270045","140270160","17","85636219"
"chr7","54657997","54658288","chr1","20536110","20536388","57","34121887"
"chr7","54665650","54665915","chr1","20540590","20540852","28","34125060"
"chr7","54676373","54676706","chr1","20550689","20551021","39","34125684"
"chr7","54725004","54725302","chr1","20602613","20602915","43","34122391"
"chr7","54762782","54763094","chr1","20641160","20641440","57","34121622"
"chr7","54767676","54767959","chr1","20645135","20645433","62","34122541"
"chr7","54776817","54777094","chr6","13778064","13778339","67","40998753"
"chr7","54779362","54779668","chr1","20655931","20656237","36","34123431"
"chr7","54806842","54807131","chr1","227415933","227416230","64","172609091"
"chr7","54813512","54813800","chr1","20699914","20700195","44","34113598"
"chr7","54823124","54823398","chr1","20713636","20713911","24","34109488"
"chr7","54832814","54832885","chr4","4333939","4334013","15","50498875"
"chr7","54833215","54833433","chr8","101044165","101044379","45","46210950"
"chr7","54840453","54840749","chr21","34948778","34949073","76","19891675"
"chr7","54850243","54850543","chr1","20732875","20733173","33","34117368"
"chr7","54882569","54882908","chr1","153341510","153341826","84","98458941"
"chr7","54918714","54919001","chr1","20793359","20793648","43","34125355"
"chr7","54934253","54934531","chr16","1644503","1644782","54","53289750"
"chr7","54940520","54940809","chr1","20803649","20803937","38","34136871"
"chr7","54948038","54948323","chr1","20810987","20811263","44","34137051"
"chr7","54948861","54949134","chr1","20811835","20812137","57","34137026"
"chr7","54965459","54965615","chr15","69740012","69740164","35","14774553"
"chr7","54984276","54984568","chr1","132826671","132826953","69","77842395"
"chr7","55028641","55028914","chr1","20888482","20888768","43","34140159"
"chr7","55045054","55045355","chr1","20903425","20903723","47","34141629"
"chr7","55054959","55055081","chr1","20913241","20913363","11","34141718"
"chr7","55055352","55055642","chr1","20913602","20913921","52","34141750"
"chr7","55059610","55059903","chr1","20917556","20917859","36","34142054"
"chr7","55072794","55073065","chr1","20928611","20928903","55","34144183"
"chr7","55124281","55124534","chr1","20976804","20977054","33","34147477"
"chr7","55127583","55127854","chr1","20980138","20980406","40","34147445"
"chr7","55143214","55143323","chr6","87974068","87974179","20","32830854"
"chr7","55155888","55156170","chr1","21023266","21023528","53","34132622"
"chr7","55171168","55171458","chr3","124535831","124536121","69","69364663"
"chr7","55174086","55174406","chr1","21040798","21041093","58","34133288"
"chr7","55178695","55179004","chr1","21046796","21047086","46","34131899"
"chr7","55229105","55229375","chr19","9660371","9660656","67","45568734"
"chr7","55232210","55232501","chr12","11685079","11685376","60","43547131"
"chr7","55253712","55253873","chr12","8768282","8768448","25","46485430"
"chr7","55256656","55256792","chr1","21126295","21126440","28","34130361"
"chr7","55275599","55275720","chr1","21149543","21149662","9","34126056"
"chr7","55285982","55286121","chr11","62991394","62991536","35","7705412"
"chr7","55360777","55361087","chr1","21245852","21246138","57","34114925"
"chr7","55415441","55415669","chr8","98888922","98889156","63","43473481"
"chr7","55431697","55431823","chr1","217201101","217201227","22","161769404"
"chr7","55436696","55436793","chr7","6360911","6361015","28","49075785"
"chr7","55464043","55464315","chr8","124780862","124781130","60","69316819"
"chr7","55469292","55469368","chr14","87252225","87252301","17","31782933"
"chr7","55470291","55470345","chr7","74221609","74221660","8","18751318"
"chr7","55470650","55470788","chr12","62964855","62964964","44","7494205"
"chr7","55485729","55485873","chr3","47977184","47977318","38","7508545"
"chr7","55513265","55513528","chrX","55077182","55077423","73","436083"
"chr7","55545211","55545472","chr1","21524477","21524729","48","34020734"
"chr7","55555245","55555373","chr1","114541144","114541275","41","58985899"
"chr7","55563764","55564066","chr1","21543387","21543686","37","34020377"
"chr7","55572343","55572649","chr12","114808537","114808845","71","59236194"
"chr7","55613003","55613293","chr10","111723199","111723487","61","56110196"
"chr7","55613640","55613922","chr1","21593975","21594274","64","34019665"
"chr7","55663445","55663687","chr1","21646953","21647213","34","34016492"
"chr7","55670904","55671174","chr8","127844708","127844977","70","72173804"
"chr7","55680144","55680452","chr7","78818816","78819119","59","23138672"
"chr7","55683513","55683776","chr1","21667387","21667669","41","34016126"
"chr7","55688259","55688527","chr1","21672573","21672822","74","34015686"
"chr7","55692747","55693054","chr1","21676764","21677071","54","34015983"
"chr7","55700212","55700338","chr9","113284887","113285018","32","57584675"
"chr7","55714236","55714356","chr14","60352578","60352701","30","4638342"
"chr7","55714905","55714946","chr1","21702369","21702414","9","34012536"
"chr7","55752458","55752570","chr6","87517319","87517435","25","31764861"
"chr7","55755505","55755780","chr3","51715707","51715985","68","4039798"
"chr7","55777205","55777493","chr6","77870258","77870543","67","22093053"
"chr7","55781138","55781413","chr5","155488070","155488345","76","99706932"
"chr7","55825644","55825797","chr11","100440788","100440936","40","44615144"
"chr7","55858208","55858419","chr4","1978199","1978411","59","53880009"
"chr7","55899610","55899858","chr1","21872293","21872542","31","34027317"
"chr7","55922446","55922592","chr19","11025315","11025473","36","44897131"
"chr7","55928361","55928483","chr5","64722167","64722289","16","8793806"
"chr7","55951682","55951804","chr5","133578375","133578499","32","77626693"
"chr7","55952203","55952510","chr8","19990729","19991033","60","35961474"
"chr7","55966753","55966907","chr15","69740012","69740164","35","13773259"
"chr7","55975279","55975603","chr19","39995672","39996000","60","15979607"
"chr7","55979802","55980072","chr1","21982484","21982758","40","33997318"
"chr7","56023285","56023494","chr1","22019693","22019901","41","34003592"
"chr7","56038547","56038839","chr19","46062191","46062484","59","9976356"
"chr7","56149042","56149325","chr1","22149832","22150129","35","33999210"
"chr7","56222824","56223119","chr1","22222175","22222478","46","34000649"
"chr7","56239494","56239609","chr1","22237090","22237205","15","34002404"
"chr7","56242099","56242385","chr1","22239695","22239995","45","34002404"
"chr7","56289220","56289382","chr18","56296099","56296268","36","6879"
"chr7","56301991","56302113","chr1","22292154","22292272","19","34009837"
"chr7","56327292","56327580","chr12","112125010","112125288","64","55797718"
"chr7","56571332","56571620","chr1","22554854","22555135","44","34016478"
"chr7","56590894","56591019","chr16","19498080","19498202","16","37092814"
"chr7","56733844","56734144","chr1","22729244","22729559","61","34004600"
"chr7","56737624","56737791","chr1","22733138","22733296","29","34004486"
"chr7","56757317","56757618","chr1","22752684","22752980","50","34004633"
"chr7","56806236","56806404","chr1","22797485","22797657","31","34008751"
"chr7","56896292","56896440","chr3","186215816","186215959","32","129319524"
"chr7","56912588","56912878","chr1","22894355","22894655","37","34018233"
"chr7","56942567","56942876","chr1","22926598","22926914","59","34015969"
"chr7","56971765","56972056","chr6","162399703","162400001","64","105427938"
"chr7","56986417","56986670","chr1","22966072","22966323","37","34020345"
"chr7","56990067","56990340","chr1","22969300","22969573","24","34020767"
"chr7","57049640","57049934","chr5","37419040","37419338","62","19630600"
"chr7","57050768","57050989","chr6","22061432","22061659","63","34989336"
"chr7","57054878","57055023","chr1","23066651","23066798","14","33988227"
"chr7","57060185","57060444","chr3","127863015","127863278","59","70802830"
"chr7","57098988","57099104","chr1","23110691","23110808","11","33988297"
"chr7","57099203","57099517","chr1","23110981","23111278","64","33988222"
"chr7","57107565","57107653","chr1","23118895","23118983","13","33988670"
"chr7","57111501","57111781","chr1","23124187","23124459","44","33987314"
"chr7","57115993","57116270","chr1","23128470","23128745","55","33987523"
"chr7","57117341","57117623","chr1","23129535","23129825","39","33987806"
"chr7","57137987","57138294","chr1","23148065","23148359","60","33989922"
"chr7","57140013","57140290","chr15","55900680","55900959","63","1239333"
"chr7","57145575","57145707","chr19","35055551","35055660","38","22090024"
"chr7","57152696","57152946","chr1","23164654","23164913","39","33988042"
"chr7","57156952","57157062","chr8","21346151","21346257","25","35810801"
"chr7","57184815","57185086","chr1","23192337","23192609","47","33992478"
"chr7","57202163","57202431","chr2A","48360146","48360407","65","8842017"
"chr7","57205979","57206270","chr1","23206355","23206643","25","33999624"
"chr7","57206271","57206419","chr1","22733138","22733296","36","34473133"
"chr7","57207387","57207501","chr3","124234294","124234409","16","67026907"
"chr7","57233750","57233877","chr9","94117946","94118069","20","36884196"
"chr7","57239419","57239744","chr1","23240659","23240966","60","33998760"
"chr7","57241368","57241534","chr12","8768282","8768448","32","48473086"
"chr7","57251037","57251271","chr6","146361614","146361839","45","89110577"
"chr7","57252441","57252658","chr3","12981212","12981412","64","44271229"
"chr7","57259638","57259938","chr1","23260988","23261304","58","33998650"
"chr7","57284815","57285117","chr1","23280708","23281012","40","34004107"
"chr7","57289996","57290268","chr1","23287778","23288049","32","34002218"
"chr7","57295006","57295139","chr10","86260545","86260677","27","28965539"
"chr7","57301725","57301876","chr10","107986027","107986178","33","50684302"
"chr7","57325608","57325731","chr16","49069004","49069126","19","8256604"
"chr7","57385634","57385938","chr1","23384109","23384398","42","34001525"
"chr7","57430407","57430545","chr1","31279143","31279286","29","26151264"
"chr7","57446807","57446939","chr8","84889028","84889173","36","27442221"
"chr7","57464541","57464844","chr1","23468181","23468498","50","33996360"
"chr7","57488233","57488368","chr17","1103551","1103686","24","56384682"
"chr7","57520162","57520348","chr5","109837697","109837875","53","52317535"
"chr7","57521207","57521271","chr19","45742722","45742781","19","11778485"
"chr7","57530929","57531195","chr1","23527580","23527850","34","34003349"
"chr7","57546712","57547027","chr1","23540202","23540503","63","34006510"
"chr7","57553392","57553699","chr1","23544972","23545280","40","34008420"
"chr7","57577233","57577509","chr9","75566020","75566287","65","17988787"
"chr7","57579643","57579945","chr1","23571111","23571402","60","34008532"
"chr7","57605309","57605477","chr5","165314807","165314988","41","107709498"
"chr7","57628362","57628482","chr8","87092496","87092606","28","29464134"
"chr7","57634677","57634986","chr1","23622718","23623020","34","34011959"
"chr7","57644002","57644288","chr1","23629816","23630091","39","34014186"
"chr7","57647310","57647575","chr7","1187943","1188204","59","56459367"
"chr7","57674577","57674870","chr1","23658590","23658877","43","34015987"
"chr7","57694043","57694356","chr20","47709808","47710111","70","9984235"
"chr7","57713576","57713863","chr1","23714171","23714482","54","33999405"
"chr7","57727692","57727944","chr3","15966311","15966579","66","41761381"
"chr7","57729063","57729202","chr1","23727757","23727901","14","34001306"
"chr7","57731516","57731598","chr8","96844734","96844815","12","39113218"
"chr7","57734124","57734428","chr1","23732987","23733279","57","34001137"
"chr7","57782890","57782974","chr1","23776244","23776331","13","34006646"
"chr7","57783478","57783693","chr1","23776622","23776829","37","34006856"
"chr7","57785535","57785781","chr11","85415764","85416020","72","27630229"
"chr7","57793708","57794001","chr1","23786085","23786355","52","34007623"
"chr7","57851587","57851874","chr3","192630736","192631006","70","134779149"
"chr7","57857826","57858136","chr1","23849688","23849991","47","34008138"
"chr7","57860549","57860631","chr19","38862954","38863037","15","18997595"
"chr7","57867591","57867728","chr1","62385028","62385161","26","4517437"
"chr7","57867800","57867916","chr7","7518910","7519027","16","50348890"
"chr7","57877925","57878221","chr1","23883728","23884038","54","33994197"
"chr7","57898465","57898556","chr6","87837372","87837462","16","29938907"
"chr7","57903442","57903553","chr1","23909376","23909493","14","33994066"
"chr7","57910575","57910706","chr1","23915921","23916051","16","33994654"
"chr7","57922303","57922593","chr22","9394826","9395108","66","48527477"
"chr7","57926978","57927286","chr1","23933719","23934038","49","33993259"
"chr7","57929933","57930095","chr1","41590742","41590907","38","16339191"
"chr7","57936809","57937100","chr1","23965982","23966284","49","33970827"
"chr7","57967257","57967541","chr8","144786356","144786646","64","86819099"
"chr7","57984149","57984213","chr1","215193663","215193734","14","157209514"
"chr7","57984840","57985070","chr1","24015036","24015275","48","33969804"
"chr7","57991767","57991941","chr1","24026509","24026706","51","33965258"
"chr7","57992463","57992561","chrX","1561167","1561261","23","56431296"
"chr7","58006395","58006519","chr5","121921600","121921724","23","63915205"
"chr7","58032680","58032959","chr7","33270606","33270890","58","24762074"
"chr7","58100393","58100676","chr1","24134563","24134853","45","33965830"
"chr7","58102531","58102653","chr7","129939710","129939835","28","71837179"
"chr7","58138972","58139184","chr1","24174788","24174998","28","33964184"
"chr7","58173044","58173270","chr1","24209443","24209656","35","33963601"
"chr7","58186657","58186920","chr1","24219121","24219405","54","33967536"
"chr7","58201431","58201588","chr13","9677868","9678017","42","48523563"
"chr7","58208936","58209109","chr1","24240324","24240494","25","33968612"
"chr7","58209401","58209444","chr9","113601835","113601882","14","55392434"
"chr7","58210229","58210340","chr8","87223424","87223537","19","29013195"
"chr7","58214797","58215088","chr16","30923331","30923625","51","27291466"
"chr7","58251508","58251803","chr1","24270162","24270465","47","33981346"
"chr7","58272627","58272829","chr10","37959436","37959633","40","20313191"
"chr7","58291940","58292243","chr7","44626147","44626456","76","13665793"
"chr7","58302570","58302726","chr1","24314985","24315143","22","33987585"
"chr7","58304384","58304483","chr11","48046345","48046442","22","10258039"
"chr7","58304649","58304840","chrX","19928223","19928402","44","38376426"
"chr7","58358551","58358702","chr22","20288134","20288276","36","38070417"
"chr7","58417618","58417908","chrX","115407272","115407563","50","56989654"
"chr7","58427904","58428026","chr1","24449114","24449236","10","33978790"
"chr7","58466296","58466610","chr1","24488542","24488853","48","33977754"
"chr7","58472367","58472425","chr4","148126835","148126898","17","89654468"
"chr7","58472974","58473096","chr1","24495269","24495416","39","33977705"
"chr7","58495378","58495680","chr12","93916751","93917049","54","35421373"
"chr7","58500099","58500409","chr1","24510394","24510695","34","33989705"
"chr7","58505217","58505474","chr22","15881502","15881761","77","42623715"
"chr7","58515610","58515922","chr5","118800577","118800883","62","60284967"
"chr7","58531848","58531965","chr12","132943267","132943384","16","74411419"
"chr7","58544064","58544366","chr21","29908526","29908834","56","28635538"
"chr7","58547363","58547621","chr1","24552243","24552491","28","33995120"
"chr7","58579372","58579678","chr11","85632161","85632468","57","27052789"
"chr7","58591227","58591522","chr14","59109356","59109639","54","518129"
"chr7","58594999","58595155","chr4","40325999","40326159","33","18269000"
"chr7","58610524","58610690","chr4","154231770","154231939","49","95621246"
"chr7","58640363","58640660","chr20","52396911","52397211","61","6243452"
"chr7","58652014","58652331","chr1","24632196","24632513","36","34019818"
"chr7","58684701","58684821","chr1","24661645","24661757","24","34023056"
"chr7","58728034","58728151","chr1","24706111","24706231","24","34021923"
"chr7","58740805","58740948","chr22","8436942","8437088","28","50303863"
"chr7","58767617","58767783","chr3","192144889","192145062","43","133377272"
"chr7","58788028","58788129","chr9","86429492","86429602","35","27641464"
"chr7","58792916","58793077","chr1","24776371","24776540","29","34016545"
"chr7","58838712","58838847","chr1","24815947","24816071","22","34022765"
"chr7","58854524","58854750","chr19","37794171","37794401","51","21060353"
"chr7","58885482","58885755","chr1","24868149","24868435","30","34017333"
"chr7","58887776","58888082","chrX","70174791","70175090","69","11287015"
"chr7","58903240","58903532","chr1","24881229","24881527","45","34022011"
"chr7","58915940","58916249","chr20","30558365","30558670","53","28357575"
"chr7","58919750","58920054","chr1","24901701","24902008","31","34018049"
"chr7","58968033","58968333","chr1","24940421","24940721","31","34027612"
"chr7","59014120","59014426","chr12","43802996","43803296","70","15211124"
"chr7","59024808","59024932","chr1","147453878","147454002","19","88429070"
"chr7","59128293","59128581","chr12","1651377","1651661","64","57476916"
"chr7","59177291","59177516","chr1","25188732","25188960","22","33988559"
"chr7","59230842","59231139","chr1","25238815","25239116","49","33992027"
"chr7","59313812","59314100","chr1","25308740","25309015","82","34005072"
"chr7","59350296","59350589","chr1","25422602","25422886","55","33927694"
"chr7","59353617","59353780","chr3","14267985","14268147","30","45085632"
"chr7","59355151","59355311","chr19","16940961","16941115","43","42414190"
"chr7","59356141","59356449","chr1","25430547","25430834","46","33925594"
"chr7","59410600","59410811","chr1","25359641","25359851","27","34050959"
"chr7","59413230","59413418","chr1","25357047","25357228","31","34056183"
"chr7","59427509","59427800","chr8","24685787","24686084","63","34741722"
"chr7","59466828","59467127","chr1","25528964","25529280","49","33937864"
"chr7","59545880","59546160","chr1","25622134","25622412","32","33923746"
"chr7","59583050","59583346","chr1","25653913","25654207","38","33929137"
"chr7","59651599","59651905","chr10","118474409","118474715","68","58822810"
"chr7","59665930","59666216","chr1","25745028","25745329","51","33920902"
"chr7","59704318","59704609","chr1","25780698","25781001","34","33923620"
"chr7","59738825","59739114","chr1","25823440","25823728","17","33915385"
"chr7","59812600","59812885","chr18","12353458","12353757","67","47459142"
"chr7","59844596","59844879","chr1","25925125","25925414","55","33919471"
"chr7","59844965","59845217","chr1","25925506","25925792","55","33919459"
"chr7","59856746","59857036","chr6","39579587","39579870","59","20277159"
"chr7","59875923","59876189","chr21","23414956","23415212","55","36460967"
"chr7","59882166","59882286","chr1","25953576","25953697","15","33928590"
"chr7","59892297","59892595","chr1","25965273","25965572","26","33927024"
"chr7","59898302","59898604","chr6","7911524","7911833","62","51986778"
"chr7","59899373","59899653","chr1","25971811","25972095","34","33927562"
"chr7","59899690","59899803","chr2A","63435618","63435731","28","3535928"
"chr7","59902356","59902519","chr5","62837108","62837270","37","2934752"
"chr7","59908385","59908537","chr11","62991394","62991536","39","3083009"
"chr7","59913281","59913543","chr1","25982692","25982934","56","33930589"
"chr7","59934056","59934379","chr12","108809771","108810076","76","48875715"
"chr7","59940437","59940691","chr1","26010214","26010481","45","33930223"
"chr7","59954568","59954631","chr7","28901675","28901743","12","31052893"
"chr7","59959968","59960088","chr3","59608412","59608534","18","351556"
"chr7","59960102","59960414","chr11","9524062","9524355","74","50436040"
"chr7","59973228","59973536","chr1","210031013","210031322","62","150057785"
"chr7","59990659","59990969","chr1","26061207","26061509","36","33929452"
"chr7","59999613","59999915","chr1","26069275","26069582","47","33930338"
"chr7","60001078","60001365","chr2B","1653556","1653835","68","58347522"
"chr7","60019430","60019546","chr1","26088471","26088587","7","33930959"
"chr7","60032080","60032243","chr19","18112321","18112488","36","41919759"
"chr7","60044973","60045142","chr1","26111208","26111379","36","33933765"
"chr7","60092682","60093028","chr1","26148052","26148348","99","33944630"
