"chr1","1532969","1533279","chr8","95684731","95685034","71","94151762"
"chr1","1939447","1939951","chr4","142197158","142197554","197","140257711"
"chr1","2118435","2119056","chr14","102268297","102268694","290","100149862"
"chr1","2860306","2860870","chr12","123524031","123524395","257","120663725"
"chr1","4397161","4397810","chr8","137225928","137226325","310","132828767"
"chr1","7156346","7156842","chrX","104523190","104523567","198","97366844"
"chr1","8117499","8117748","chr1","220363627","220363867","21","212246128"
"chr1","9096413","9096974","chrX","104523190","104523567","238","95426777"
"chr1","12856323","12856920","chr17","73596440","73596809","281","60740117"
"chr1","16155666","16156106","chr4","25408053","25408388","195","9252387"
"chr1","16248676","16249210","chr11","47212880","47213240","249","30964204"
"chr1","16398059","16398659","chr17","73596440","73596809","290","57198381"
"chr1","18020382","18020945","chr19","42278043","42278419","253","24257661"
"chr1","18183812","18184415","chr14","102268297","102268694","289","84084485"
"chr1","19968911","19969512","chrX","104523190","104523567","277","84554279"
"chr1","19972748","19973270","chr4","142197158","142197554","222","122224410"
"chr1","21790074","21790580","chr12","62168603","62168983","207","40378529"
"chr1","22762357","22762573","chr12","63124514","63124711","53","40362157"
"chr1","23228235","23228610","chr16","56633341","56633645","126","33405106"
"chr1","23343595","23344190","chr12","123524031","123524395","278","100180436"
"chr1","23677671","23678311","chr4","142197158","142197554","309","118519487"
"chr1","23958178","23958776","chr8","137225928","137226325","275","113267750"
"chr1","24047829","24048465","chr14","102268297","102268694","317","78220468"
"chr1","25440895","25441771","chr14","102268297","102268694","513","76827402"
"chr1","26695451","26696060","chrX","104523190","104523567","278","77827739"
"chr1","31288532","31288807","chr1","197395197","197395471","42","166106665"
"chr1","36502747","36503065","chr17","67182584","67182895","69","30679837"
"chr1","36688935","36689552","chr8","137225928","137226325","293","100536993"
"chr1","37985349","37986588","chr4","186800340","186800751","845","148814991"
"chr1","42477240","42477572","chr1","186186951","186187258","36","143709711"
"chr1","43347209","43347791","chr12","123524031","123524395","267","80176822"
"chr1","44480442","44480998","chr3","54081847","54082222","257","9601405"
"chr1","45682848","45683413","chr4","142197158","142197554","253","96514310"
"chr1","45697759","45698271","chr4","142197158","142197554","190","96499399"
"chr1","45844597","45845574","chr4","186800340","186800751","614","140955743"
"chr1","47535328","47535933","chr8","137225928","137226325","279","89690600"
"chr1","47644320","47644933","chr8","137225928","137226325","279","89581608"
"chr1","48717402","48718017","chr22","20071849","20072232","293","28645553"
"chr1","58620689","58621007","chr2B","223231857","223232163","69","164611168"
"chr1","69606042","69606363","chr4","133125340","133125654","69","63519298"
"chr1","73961569","73961986","chr7","133582495","133582847","147","59620926"
"chr1","75874582","75875181","chr8","137225928","137226325","277","61351346"
"chr1","78858999","78860365","chr4","186800340","186800751","966","107941341"
"chr1","82732414","82732721","chr1","146018208","146018522","31","63285794"
"chr1","84817678","84818298","chr8","137225928","137226325","301","52408250"
"chr1","89183180","89183727","chrX","104523190","104523567","232","15340010"
"chr1","89649853","89650747","chr14","102268297","102268694","537","12618444"
"chr1","93601327","93601654","chr5","155070599","155070909","75","61469272"
"chr1","94264094","94264677","chr22","20071849","20072232","262","74192245"
"chr1","94517384","94518004","chr8","137225928","137226325","291","42708544"
"chr1","94566774","94567382","chr8","137225928","137226325","294","42659154"
"chr1","94958906","94959520","chr8","137225928","137226325","297","42267022"
"chr1","94976328","94976934","chr8","137225928","137226325","276","42249600"
"chr1","95007974","95008394","chr14","102079006","102079330","186","7071032"
"chr1","95390281","95390641","chr12","93137707","93138014","104","2252574"
"chr1","96451543","96451858","chr1","132539133","132539442","18","36087590"
"chr1","100008196","100008822","chr4","186800340","186800751","301","86792144"
"chr1","100223393","100223960","chrX","104523190","104523567","252","4299797"
"chr1","100317172","100317801","chr8","137225928","137226325","300","36908756"
"chr1","100541450","100542014","chr3","64785696","64786073","267","35755754"
"chr1","101419468","101419794","chr7","101681430","101681732","80","261962"
"chr1","105538823","105539126","chr7","54686180","54686475","79","50852643"
"chr1","107538552","107538865","chr1","117637600","117637904","20","10099048"
"chr1","110004243","110005018","chr4","186800340","186800751","427","76796097"
"chr1","112035567","112036516","chr8","137225928","137226325","593","25190361"
"chr1","113623486","113624081","chrX","104523190","104523567","272","9100296"
"chr1","113798380","113798898","chr4","142197158","142197554","208","28398778"
"chr1","114370064","114370646","chr8","137225928","137226325","274","22855864"
"chr1","116243514","116244118","chr8","137225928","137226325","272","20982414"
"chr1","117474232","117474544","chr1","37058662","37058970","85","80415570"
"chr1","117502888","117503195","chr1","109926187","109926476","30","7576701"
"chr1","117698988","117699634","chr4","142197158","142197554","314","24498170"
"chr1","126650376","126650972","chr3","54081847","54082222","282","72568529"
"chr1","127205839","127206322","chr2A","77554061","77554428","199","49651778"
"chr1","128808183","128808482","chr1","99055626","99055924","21","29752557"
"chr1","133783777","133784187","chr16","31143988","31144356","129","102639789"
"chr1","134526408","134526730","chr5","155340680","155340999","72","20814272"
"chr1","134714847","134715788","chr4","142197158","142197554","571","7482311"
"chr1","135056400","135056732","chr22","27451445","27451757","76","107604955"
"chr1","135223288","135223863","chr8","137225928","137226325","268","2002640"
"chr1","140922082","140922410","chr12","8842103","8842408","82","132079979"
"chr1","146158326","146158649","chr1","81861199","81861504","23","64297127"
"chr1","149346064","149346412","chr12","93643295","93643603","109","55702769"
"chr1","151612336","151613494","chr4","186800340","186800751","769","35188004"
"chr1","163369934","163370232","chr1","64723052","64723368","28","98646882"
"chr1","164031498","164031809","chr1","64054871","64055173","15","99976627"
"chr1","165269040","165269529","chr5","40037645","40038026","213","125231395"
"chr1","165582660","165583194","chr8","137225928","137226325","250","28356732"
"chr1","168447523","168447861","chr1","59651986","59652280","64","108795537"
"chr1","168802291","168802681","chr19","4180058","4180412","94","164622233"
"chr1","169487209","169487511","chr10","114321940","114322237","65","55165269"
"chr1","173070634","173071297","chr8","137225928","137226325","341","35844706"
"chr1","173559042","173559753","chr8","137225928","137226325","368","36333114"
"chr1","174429252","174429857","chr8","137225928","137226325","276","37203324"
"chr1","174603285","174603619","chr1","149516196","149516503","82","25087089"
"chr1","175145026","175145621","chr7","70063427","70063807","282","105081599"
"chr1","177110653","177111261","chr4","142197158","142197554","287","34913495"
"chr1","181376693","181377221","chr4","142197158","142197554","222","39179535"
"chr1","181864970","181865549","chr8","137225928","137226325","263","44639042"
"chr1","181873137","181873722","chr17","73596440","73596809","268","108276697"
"chr1","181915376","181915683","chr4","83973283","83973577","107","97942093"
"chr1","181950616","181951090","chr4","142197158","142197554","175","39753458"
"chr1","182002387","182002957","chr8","137225928","137226325","261","44776459"
"chr1","182014615","182015315","chr3","64785696","64786073","390","117228919"
"chr1","182086909","182087512","chr4","186800340","186800751","283","4713431"
"chr1","182107948","182108384","chr1","51760638","51760984","152","130347310"
"chr1","182326658","182327261","chr8","137225928","137226325","278","45100730"
"chr1","182432338","182432588","chr5","105308514","105308744","57","77123824"
"chr1","182893538","182894093","chr14","99948534","99948916","249","82945004"
"chr1","183016283","183016796","chr10","85991855","85992203","216","97024428"
"chr1","183099359","183099715","chr18","22287320","22287624","92","160812039"
"chr1","184016366","184016970","chr10","96920061","96920447","286","87096305"
"chr1","184097952","184098270","chr1","43904941","43905243","26","140193011"
"chr1","184326146","184326743","chr4","186800340","186800751","269","2474194"
"chr1","186441892","186442396","chrX","104523190","104523567","190","81918702"
"chr1","186980138","186981188","chr4","142197158","142197554","681","44782980"
"chr1","187047108","187047739","chr4","142197158","142197554","302","44849950"
"chr1","187897489","187898016","chr8","128208503","128208862","240","59688986"
"chr1","188284130","188284720","chr17","2569283","2569663","281","185714847"
"chr1","188345513","188346120","chr10","96920061","96920447","295","91425452"
"chr1","188903878","188904497","chr17","73596440","73596809","297","115307438"
"chr1","188947979","188948407","chr11","116310774","116311078","195","72637205"
"chr1","189959981","189961172","chr4","186800340","186800751","801","3159641"
"chr1","190056763","190057081","chr3","69186215","69186515","83","120870548"
"chr1","190075428","190076040","chrX","104523190","104523567","293","85552238"
"chr1","191124165","191124450","chr1","37058662","37058970","44","154065503"
"chr1","191529269","191529879","chr8","137225928","137226325","279","54303341"
"chr1","192132342","192132955","chr4","186800340","186800751","286","5332002"
"chr1","192303712","192304620","chr4","186800340","186800751","540","5503372"
"chr1","192667920","192668542","chr8","137225928","137226325","288","55441992"
"chr1","193549371","193549674","chr1","34625231","34625535","27","158924140"
"chr1","195402093","195402678","chr14","102268297","102268694","295","93133796"
"chr1","195442142","195442754","chr8","137225928","137226325","296","58216214"
"chr1","195708697","195709017","chr1","32422935","32423259","12","163285762"
"chr1","195927004","195927622","chr8","137225928","137226325","315","58701076"
"chr1","196799955","196800576","chr4","186800340","186800751","287","9999615"
"chr1","196888508","196889040","chr12","123524031","123524395","225","73364477"
"chr1","196917905","196918502","chrX","104523190","104523567","279","92394715"
"chr1","199038872","199039449","chr9","136886390","136886752","278","62152482"
"chr1","199390066","199390698","chr14","102268297","102268694","304","97121769"
"chr1","199417316","199417627","chr1","28685261","28685573","20","170732055"
"chr1","199455322","199455926","chr8","137225928","137226325","283","62229394"
"chr1","199513046","199513386","chr1","28583065","28583360","51","170929981"
"chr1","199624313","199624927","chr3","54081847","54082222","298","145542466"
"chr1","199719206","199719787","chr14","102268297","102268694","290","97450909"
"chr1","199828429","199828993","chrX","104523190","104523567","254","95305239"
"chr1","200412180","200412464","chr1","27673714","27673987","25","172738466"
"chr1","200659150","200659771","chr14","102268297","102268694","293","98390853"
"chr1","201035278","201036193","chr8","137225928","137226325","558","63809350"
"chr1","201321767","201322989","chr4","186800340","186800751","828","14521427"
"chr1","201590861","201591450","chr4","142197158","142197554","253","59393703"
"chr1","201728288","201728885","chrX","104523190","104523567","276","97205098"
"chr1","201746683","201747350","chr4","186800340","186800751","325","14946343"
"chr1","201903859","201904462","chr10","96920061","96920447","278","104983798"
"chr1","202566090","202566586","chr4","142197158","142197554","186","60368932"
"chr1","203733102","203733669","chr8","128208503","128208862","267","75524599"
"chr1","204354712","204355844","chr4","186800340","186800751","745","17554372"
"chr1","204677100","204677675","chr5","140548275","140548651","259","64128825"
"chr1","204782024","204782601","chr3","64785696","64786073","273","139996328"
"chr1","205396397","205397321","chr8","137225928","137226325","562","68170469"
"chr1","206627236","206627959","chr9","34516377","34516764","387","172110859"
"chr1","206664709","206665318","chr8","137225928","137226325","289","69438781"
"chr1","206951985","206952585","chr14","102268297","102268694","283","104683688"
"chr1","206959449","206960064","chr8","137225928","137226325","284","69733521"
"chr1","208340680","208341280","chr17","73596440","73596809","291","134744240"
"chr1","208357991","208358940","chr4","186800340","186800751","579","21557651"
"chr1","208796881","208797478","chr8","137225928","137226325","274","71570953"
"chr1","208891165","208891463","chr4","39604786","39605098","63","169286379"
"chr1","210099353","210099642","chr1","17885248","17885544","47","192214105"
"chr1","210543365","210543718","chr1","17446248","17446611","32","193097117"
"chr1","210676035","210676628","chr8","137225928","137226325","277","73450107"
"chr1","211023279","211023898","chr14","102268297","102268694","301","108754982"
"chr1","211044376","211045280","chr14","102268297","102268694","545","108776079"
"chr1","211843181","211843760","chr17","73596440","73596809","288","138246741"
"chr1","211995032","211995836","chr4","186800340","186800751","461","25194692"
"chr1","212463381","212463870","chr4","142197158","142197554","192","70266223"
"chr1","213633739","213634087","chr1","14797748","14798088","37","198835991"
"chr1","215190317","215190634","chr1","12937331","12937623","64","202252986"
"chr1","217055044","217055642","chr12","123524031","123524395","288","93531013"
"chr1","217543639","217544196","chr17","73596440","73596809","250","143947199"
"chr1","217563279","217564012","chr4","186800340","186800751","392","30762939"
"chr1","217670396","217670865","chr1","11126509","11126815","171","206543887"
"chr1","217713670","217714251","chr8","137225928","137226325","265","80487742"
"chr1","218194136","218195307","chr14","102268297","102268694","794","115925839"
"chr1","218212043","218212602","chr8","137225928","137226325","252","80986115"
"chr1","218256013","218256514","chr9","130993902","130994246","257","87262111"
"chr1","218441410","218442007","chr4","142197158","142197554","285","76244252"
"chr1","218691982","218692593","chr8","100964359","100964745","283","117727623"
"chr1","218812226","218812801","chr8","137225928","137226325","261","81586298"
"chr1","218884261","218885472","chr4","186800340","186800751","814","32083921"
"chr1","218955013","218955603","chr4","142197158","142197554","271","76757855"
"chr1","218993949","218994538","chr8","137225928","137226325","275","81768021"
"chr1","219005563","219006480","chr14","102268297","102268694","561","116737266"
"chr1","219175332","219175967","chr8","137225928","137226325","307","81949404"
"chr1","219513546","219514179","chr14","102268297","102268694","301","117245249"
"chr1","220814017","220814555","chr2A","77554061","77554428","232","143259956"
"chr1","222039030","222039645","chr8","137225928","137226325","289","84813102"
"chr1","222155547","222156149","chr22","19890514","19890897","285","202265033"
"chr1","222275491","222276027","chr9","130743724","130744098","226","91531767"
"chr1","222568729","222569348","chr4","142197158","142197554","289","80371571"
"chr1","226640574","226641202","chr8","137225928","137226325","301","89414646"
"chr3","5266347","5266636","chr12","114513188","114513483","62","109246841"
"chr3","8026472","8027117","chr8","137225928","137226325","307","129199456"
"chr3","8487199","8487766","chr14","102268297","102268694","239","93781098"
"chr3","9085103","9085706","chr8","137225928","137226325","279","128140825"
"chr3","10249883","10250390","chrX","104523190","104523567","217","94273307"
"chr3","12316615","12317213","chr4","142197158","142197554","271","129880543"
"chr3","14371935","14372537","chrX","104523190","104523567","283","90151255"
"chr3","15551255","15551846","chr4","142197158","142197554","276","126645903"
"chr3","16379422","16380030","chr14","102268297","102268694","303","85888875"
"chr3","18541007","18541228","chr12","110499589","110499805","44","91958582"
"chr3","23037626","23038346","chr4","186800340","186800751","392","163762714"
"chr3","28719224","28720153","chr4","186800340","186800751","559","158081116"
"chr3","28918194","28918789","chr5","140548275","140548651","271","111630081"
"chr3","29544997","29545525","chrX","104523190","104523567","225","74978193"
"chr3","36569820","36570371","chr8","137225928","137226325","238","100656108"
"chr3","48654357","48654683","chr3","87002591","87002915","25","38348234"
"chr3","52333869","52334172","chr3","90687101","90687390","23","38353232"
"chr3","54286033","54286643","chrX","104523190","104523567","290","50237157"
"chr3","55779805","55780416","chr10","96920061","96920447","286","41140256"
"chr3","55780816","55781396","chr17","2569283","2569663","282","53211533"
"chr3","55824099","55824682","chr8","137225928","137226325","299","81401829"
"chr3","55870816","55871342","chr15","90368366","90368743","233","34497550"
"chr3","55892870","55893226","chr10","72294471","72294797","100","16401601"
"chr3","55931252","55931875","chr14","102268297","102268694","290","46337045"
"chr3","61945367","61945998","chrX","41911355","41911741","304","20034012"
"chr3","63472130","63472733","chr17","73596440","73596809","294","10124310"
"chr3","68539593","68540232","chr22","19890514","19890897","320","48649079"
"chr3","68608490","68609088","chrX","104523190","104523567","274","35914700"
"chr3","68646413","68647048","chr8","137225928","137226325","310","68579515"
"chr3","69055800","69056136","chr19","15636326","15636636","100","53419474"
"chr3","71374646","71374951","chr3","71462776","71463083","41","88130"
"chr3","72367046","72367650","chr4","142197158","142197554","273","69830112"
"chr3","75106950","75107809","chr8","137225928","137226325","509","62118978"
"chr3","77843253","77843881","chr4","142197158","142197554","316","64353905"
"chr3","79670477","79670993","chrX","104523190","104523567","233","24852713"
"chr3","80183032","80183367","chr1","203425408","203425720","84","123242376"
"chr3","83281028","83281587","chr8","137225928","137226325","253","53944900"
"chr3","83338918","83339530","chr4","142197158","142197554","280","58858240"
"chr3","83728623","83729145","chrX","104523190","104523567","220","20794567"
"chr3","83995420","83995851","chr10","11959505","11959843","195","72035915"
"chr3","84684865","84685445","chr8","137225928","137226325","279","52541063"
"chr3","84885767","84886355","chrX","104523190","104523567","271","19637423"
"chr3","85361042","85361221","chr2B","206954824","206954998","51","121593782"
"chr3","88318494","88319085","chr8","137225928","137226325","270","48907434"
"chr3","88527738","88528341","chr16","19121252","19121638","284","69406486"
"chr3","89074278","89074747","chr1","202778179","202778550","231","113703901"
"chr3","90392917","90393512","chr8","137225928","137226325","275","46833011"
"chr3","91936184","91937720","chr4","186800340","186800751","1128","94864156"
"chr3","92539872","92540483","chr14","102268297","102268694","289","9728425"
"chr3","92860505","92860908","chr8","12207510","12207839","136","80652995"
"chr3","93169570","93170469","chr8","137225928","137226325","536","44056358"
"chr3","93518558","93519074","chr8","128208503","128208862","229","34689945"
"chr3","93920043","93920625","chr17","73596440","73596809","265","20323603"
"chr3","94137803","94138226","chr9","130743724","130744098","145","36605921"
"chr3","94147583","94148205","chr4","142197158","142197554","307","48049575"
"chr3","94311369","94312274","chr4","186800340","186800751","536","92488971"
"chr3","94734663","94735251","chr8","137225928","137226325","265","42491265"
"chr3","94807100","94807432","chr3","47797887","47798213","15","47009213"
"chr3","94830665","94831249","chr19","11495422","11495792","277","83335243"
"chr3","96972837","96973436","chr12","123524031","123524395","282","26551194"
"chr3","97040457","97041038","chr8","137225928","137226325","267","40185471"
"chr3","97551354","97551971","chr14","102268297","102268694","285","4716943"
"chr3","98593645","98594272","chr10","96920061","96920447","324","1673584"
"chr3","99967324","99967927","chr8","137225928","137226325","284","37258604"
"chr3","102614490","102615894","chr4","186800340","186800751","1001","84185850"
"chr3","103560558","103561145","chr14","102268297","102268694","263","1292261"
"chr3","104747972","104748283","chr12","107264018","107264307","83","2516046"
"chr3","108462527","108463116","chrX","104523190","104523567","273","3939337"
"chr3","109127556","109128045","chr4","142197158","142197554","181","33069602"
"chr3","114302784","114303111","chr3","185757808","185758121","73","71455024"
"chr3","114465385","114465965","chr8","137225928","137226325","254","22760543"
"chr3","115695440","115695765","chr3","26826093","26826408","22","88869347"
"chr3","126870172","126871505","chr4","186800340","186800751","937","59930168"
"chr3","131286444","131287062","chr8","137225928","137226325","296","5939484"
"chr3","133696319","133696837","chrX","104523190","104523567","206","29173129"
"chr3","133728795","133729310","chrX","104523190","104523567","204","29205605"
"chr3","135847950","135848546","chr17","73596440","73596809","289","62251510"
"chr3","139119738","139120321","chrX","104523190","104523567","259","34596548"
"chr3","139317356","139317950","chr14","102268297","102268694","267","37049059"
"chr3","147971066","147971989","chr4","186800340","186800751","565","38829274"
"chr3","153028089","153028707","chr8","137225928","137226325","293","15802161"
"chr3","157869160","157869757","chr4","142197158","142197554","282","15672002"
"chr3","168618294","168618571","chr1","13969667","13969926","64","154648627"
"chr3","170329355","170330272","chr4","142197158","142197554","549","28132197"
"chr3","175972913","175973157","chrX","2901348","2901569","92","173071565"
"chr3","181250091","181250706","chr8","137225928","137226325","287","44024163"
"chr3","181428745","181429372","chr4","142197158","142197554","299","39231587"
"chr3","181492870","181493430","chrX","104523190","104523567","247","76969680"
"chr3","181935718","181936327","chr4","142197158","142197554","287","39738560"
"chr3","193003534","193003847","chr18","57374752","57375064","70","135628782"
"chr4","2462311","2462922","chr8","137225928","137226325","293","134763617"
"chr4","2573823","2574499","chr14","102268297","102268694","351","99694474"
"chr4","2773218","2773536","chr1","121930135","121930439","78","119156917"
"chr4","3001382","3002619","chr4","186800340","186800751","838","183798958"
"chr4","6637855","6638521","chr8","100964359","100964745","350","94326504"
"chr4","11324692","11325005","chr1","37058662","37058970","101","25733970"
"chr4","16715570","16716337","chrX","41911355","41911741","432","25195785"
"chr4","16748847","16749763","chr14","102268297","102268694","563","85519450"
"chr4","16754597","16755205","chr8","137225928","137226325","284","120471331"
"chr4","17293348","17293636","chr22","19041834","19042116","80","1748486"
"chr4","18685776","18686093","chr1","16879808","16880121","82","1805968"
"chr4","20376312","20376653","chr4","21051755","21052093","39","675443"
"chr4","24877644","24878265","chr14","102268297","102268694","299","77390653"
"chr4","24950434","24951043","chr4","142197158","142197554","289","117246724"
"chr4","25023703","25024034","chr11","12714950","12715269","70","12308753"
"chr4","29203482","29203801","chr4","29786180","29786479","32","582698"
"chr4","34778178","34778487","chr1","31498006","31498312","83","3280172"
"chr4","37328784","37329113","chr2A","71095186","71095498","81","33766402"
"chr4","38732359","38732665","chr4","39145324","39145630","23","412965"
"chr4","38940644","38941139","chrX","156157295","156157655","213","117216651"
"chr4","39273347","39274207","chr8","137225928","137226325","516","97952581"
"chr4","39467831","39468408","chrX","104523190","104523567","278","65055359"
"chr4","39486116","39486674","chr8","128208503","128208862","269","88722387"
"chr4","40218428","40218987","chr4","142197158","142197554","249","101978730"
"chr4","46162278","46162862","chr4","142197158","142197554","280","96034880"
"chr4","46644241","46644548","chr8","37308471","37308782","65","9335770"
"chr4","48435279","48435597","chr15","81051824","81052130","74","32616545"
"chr4","61697621","61697839","chr12","63124514","63124711","67","1426893"
"chr4","64238332","64238937","chr4","142197158","142197554","280","77958826"
"chr4","66473162","66473426","chr4","61115518","61115776","20","5357644"
"chr4","66482111","66482734","chrX","41911355","41911741","324","24570756"
"chr4","67545742","67546053","chr4","61115518","61115776","76","6430224"
"chr4","68856194","68856472","chr14","33747462","33747721","69","35108732"
"chr4","70693763","70693998","chr12","16940051","16940282","74","53753712"
"chr4","71162399","71162686","chr3","105745883","105746178","64","34583484"
"chr4","73887412","73888348","chr4","186800340","186800751","570","112912928"
"chr4","74092094","74092690","chr8","137225928","137226325","279","63133834"
"chr4","81237730","81238042","chr19","55375893","55376180","80","25861837"
"chr4","85744148","85744648","chr12","110274118","110274475","211","24529970"
"chr4","86706864","86707511","chr14","102268297","102268694","337","15561433"
"chr4","86815243","86816094","chr8","137225928","137226325","497","50410685"
"chr4","90576850","90577147","chr9","27586811","27587100","74","62990039"
"chr4","97395415","97396004","chr4","142197158","142197554","265","44801743"
"chr4","97489104","97489710","chr14","102268297","102268694","284","4779193"
"chr4","99839457","99839730","chr4","103786548","103786815","10","3947091"
"chr4","108092388","108092673","chr4","111905250","111905540","15","3812862"
"chr4","108818469","108818813","chr11","71401809","71402140","71","37416660"
"chr4","116940033","116940225","chr4","120638799","120638971","33","3698766"
"chr4","120923712","120923983","chr4","124837084","124837343","31","3913372"
"chr4","121480448","121481052","chr4","142197158","142197554","283","20716710"
"chr4","141990223","141990831","chr8","137225928","137226325","273","4764295"
"chr4","144848406","144848747","chr4","42461507","42461836","78","102386899"
"chr4","152493992","152494442","chr4","142197158","142197554","148","10296834"
"chr4","157047807","157048133","chr3","128283872","128284183","76","28763935"
"chr4","158066390","158066982","chr14","102268297","102268694","270","55798093"
"chr4","167513088","167513444","chrX","20087693","20088003","93","147425395"
"chr4","179668498","179669123","chr4","186800340","186800751","289","7131842"
"chr4","182010912","182011435","chr12","123524031","123524395","238","58486881"
"chr5","1077374","1077979","chr8","137225928","137226325","282","136148554"
"chr5","10418299","10418903","chr4","186800340","186800751","276","176382041"
"chr5","17587349","17587770","chr17","79900019","79900354","172","62312670"
"chr5","32087473","32088092","chr8","137225928","137226325","300","105138455"
"chr5","32722789","32723387","chr3","54081847","54082222","280","21359058"
"chr5","33612635","33613224","chr8","137225928","137226325","277","103613293"
"chr5","34850928","34851240","chr9","124474630","124474926","85","89623702"
"chr5","35535003","35535586","chr14","102268297","102268694","262","66733294"
"chr5","37528174","37528665","chr4","142197158","142197554","186","104668984"
"chr5","40869527","40869813","chr5","74536530","74536809","34","33667003"
"chr5","54923407","54923758","chr15","30164849","30165182","126","24758558"
"chr5","54965817","54966460","chr7","70063427","70063807","324","15097610"
"chr5","59164188","59164696","chr4","142197158","142197554","195","83032970"
"chr5","59203568","59204077","chr4","142197158","142197554","195","82993590"
"chr5","63781276","63781979","chr22","20071849","20072232","378","43709427"
"chr5","67382433","67383046","chr4","186800340","186800751","284","119417907"
"chr5","67537413","67537719","chr5","45653657","45653957","21","21883756"
"chr5","67604694","67605311","chr14","102268297","102268694","284","34663603"
"chr5","67695354","67695964","chrX","104523190","104523567","288","36827836"
"chr5","67698662","67699248","chr4","142197158","142197554","281","74498496"
"chr5","68404089","68404691","chr8","137225928","137226325","276","68821839"
"chr5","71574820","71575144","chr5","40234526","40234878","42","31340294"
"chr5","71597959","71598566","chr8","137225928","137226325","279","65627969"
"chr5","71650378","71650914","chr12","122575470","122575851","231","50925092"
"chr5","74310745","74311340","chr17","73596440","73596809","268","714305"
"chr5","74376924","74377194","chr5","37452662","37452927","7","36924262"
"chr5","75583808","75584656","chr4","186800340","186800751","486","111216532"
"chr5","76143693","76144283","chr8","137225928","137226325","271","61082235"
"chr5","76380940","76381546","chr14","102268297","102268694","280","25887357"
"chr5","82216859","82217469","chr14","102268297","102268694","293","20051438"
"chr5","82883163","82883741","chr7","70063427","70063807","285","12819736"
"chr5","84305207","84305508","chr5","27654998","27655284","26","56650209"
"chr5","85901099","85901437","chr7","69975577","69975910","99","15925522"
"chr5","87884740","87885176","chr8","128208503","128208862","159","40323763"
"chr5","91217605","91218239","chr10","96920061","96920447","312","5702456"
"chr5","92162957","92163258","chr5","19765248","19765543","16","72397709"
"chr5","95637730","95638404","chr8","137225928","137226325","348","41588198"
"chr5","96679903","96680168","chr8","24535633","24535900","72","72144270"
"chr5","107058810","107059087","chr17","46565960","46566231","65","60492850"
"chr5","109156421","109156735","chr1","43981221","43981532","68","65175200"
"chr5","123870762","123871411","chr8","137225928","137226325","325","13355166"
"chr5","124757436","124757801","chr5","128208553","128208888","42","3451117"
"chr5","130197893","130198476","chr17","73596440","73596809","275","56601453"
"chr5","131436243","131436879","chr4","142197158","142197554","315","10760915"
"chr5","131648159","131648941","chr4","186800340","186800751","438","55152181"
"chr5","131963973","131964574","chr8","137225928","137226325","283","5261955"
"chr5","132004909","132005476","chr8","137225928","137226325","253","5221019"
"chr5","132122694","132123093","chr8","12207510","12207839","140","119915184"
"chr5","134702653","134702967","chr1","179173055","179173364","67","44470402"
"chr5","135369608","135370218","chr7","70063427","70063807","284","65306181"
"chr5","135592505","135593044","chr12","123524031","123524395","235","12068474"
"chr5","135744585","135745192","chr14","99948534","99948916","286","35796051"
"chr5","135952959","135953567","chr8","137225928","137226325","291","1272969"
"chr5","136036649","136037260","chr8","137225928","137226325","280","1189279"
"chr5","136704028","136704558","chr9","34516377","34516764","247","102187651"
"chr5","137327204","137327839","chr22","20071849","20072232","301","117255355"
"chr5","139470047","139470517","chr3","54081847","54082222","160","85388200"
"chr5","139671105","139671737","chr10","96920061","96920447","311","42751044"
"chr5","143857285","143857599","chr2A","15699460","15699768","76","128157825"
"chr5","144641484","144641787","chr5","148157765","148158077","50","3516281"
"chr5","147319795","147320251","chr5","40037645","40038026","161","107282150"
"chr5","147949954","147950531","chr8","137225928","137226325","260","10724026"
"chr5","149076642","149076983","chr12","117432198","117432511","77","31644444"
"chr5","149182584","149183205","chr8","137225928","137226325","283","11956656"
"chr5","149342297","149342677","chr19","4180058","4180412","96","145162239"
"chr5","152141828","152142144","chr5","155429920","155430219","25","3288092"
"chr5","152146410","152147306","chr4","186800340","186800751","526","34653930"
"chr5","152231349","152231970","chr8","137225928","137226325","287","15005421"
"chr5","152232800","152233424","chr22","20071849","20072232","293","132160951"
"chr5","152381573","152382391","chr8","137225928","137226325","464","15155645"
"chr5","152405621","152406508","chr4","186800340","186800751","529","34394719"
"chr5","152444746","152445210","chr4","142197158","142197554","160","10247588"
"chr5","153293032","153293657","chr8","137225928","137226325","298","16067104"
"chr5","154446723","154447038","chr7","11963534","11963832","73","142483189"
"chr5","157638618","157639254","chr14","102268297","102268694","304","55370321"
"chr5","157714887","157715751","chr8","137225928","137226325","506","20488959"
"chr5","158495507","158496166","chr4","186800340","186800751","336","28304833"
"chr5","169061692","169062283","chr15","90368366","90368743","297","78693326"
"chr5","169567868","169568173","chr3","74361692","74361982","93","95206176"
"chr5","169661496","169661835","chr20","51125433","51125760","78","118536063"
"chr5","169981098","169981697","chr8","137225928","137226325","273","32755170"
"chr5","170173600","170173903","chr5","173503177","173503482","22","3329577"
"chr5","170715720","170716026","chr5","174053407","174053699","29","3337687"
"chr5","170819470","170820067","chr14","102268297","102268694","278","68551173"
"chr5","173919518","173919784","chr22","48750006","48750276","78","125169512"
"chr5","174637245","174637908","chr8","137225928","137226325","331","37411317"
"chr5","175259352","175259980","chr4","142197158","142197554","301","33062194"
"chr5","177267320","177267930","chr8","137225928","137226325","295","40041392"
"chr5","177291229","177291834","chr8","137225928","137226325","287","40065301"
"chr5","177318255","177318844","chr8","137225928","137226325","266","40092327"
"chr5","177326717","177327018","chr5","180840015","180840309","22","3513298"
"chr5","177462711","177463325","chr8","137225928","137226325","296","40236783"
"chr5","179077648","179077972","chr1","39273623","39273906","109","139804025"
"chr6","2943586","2944105","chr10","96920061","96920447","208","93976475"
"chr6","2944129","2944579","chr1","20657112","20657459","190","17712983"
"chr6","2987814","2988509","chr14","102268297","102268694","360","99280483"
"chr6","4109899","4110533","chr4","186800340","186800751","297","182690441"
"chr6","4399264","4400283","chr4","186800340","186800751","645","182401076"
"chr6","5655219","5655804","chr8","137225928","137226325","267","131570709"
"chr6","6929909","6930505","chr8","137225928","137226325","266","130296019"
"chr6","6996776","6997393","chr17","73596440","73596809","294","66599664"
"chr6","7072753","7073385","chr17","73596440","73596809","300","66523687"
"chr6","7303625","7304228","chr22","20071849","20072232","278","12768224"
"chr6","10312951","10313555","chr8","137225928","137226325","284","126912977"
"chr6","12220716","12221189","chr4","142197158","142197554","172","129976442"
"chr6","13549223","13549881","chr14","102268297","102268694","318","88719074"
"chr6","15016497","15017160","chr8","137225928","137226325","322","122209431"
"chr6","15141361","15141986","chr8","137225928","137226325","296","122084567"
"chr6","18872150","18872444","chr6","19130845","19131139","12","258695"
"chr6","25336833","25337129","chr6","25551411","25551694","22","214578"
"chr6","26007096","26008185","chr4","186800340","186800751","717","160793244"
"chr6","26273448","26274034","chr8","137225928","137226325","273","110952480"
"chr6","27148222","27148679","chr12","123524031","123524395","175","96375809"
"chr6","27606909","27607418","chr17","73596440","73596809","224","45989531"
"chr6","27727780","27728453","chr4","186800340","186800751","356","159072560"
"chr6","30681918","30682522","chr17","73596440","73596809","294","42914522"
"chr6","31130181","31130771","chr12","123524031","123524395","272","92393850"
"chr6","31151696","31152126","chr11","116310774","116311078","194","85159078"
"chr6","31179626","31180162","chr12","62168603","62168983","226","30988977"
"chr6","31888807","31889413","chr8","137225928","137226325","288","105337121"
"chr6","32046894","32047515","chr8","137225928","137226325","292","105179034"
"chr6","32104090","32104698","chr8","137225928","137226325","280","105121838"
"chr6","33579254","33579766","chr19","60452658","60453024","238","26873404"
"chr6","33861152","33861437","chr1","214860523","214860784","73","180999371"
"chr6","36017232","36017575","chr9","133488074","133488404","105","97470842"
"chr6","36382976","36383890","chr4","186800340","186800751","540","150417364"
"chr6","36859917","36860543","chr4","142197158","142197554","312","105337241"
"chr6","36958015","36958520","chr12","123524031","123524395","199","86566016"
"chr6","37026651","37027273","chr8","137225928","137226325","293","100199277"
"chr6","37452382","37452957","chr8","137225928","137226325","260","99773546"
"chr6","38520024","38520640","chr8","137225928","137226325","286","98705904"
"chr6","42425054","42425645","chr8","137225928","137226325","276","94800874"
"chr6","42447333","42448264","chr4","186800340","186800751","566","144353007"
"chr6","43023062","43023691","chr7","70063427","70063807","303","27040365"
"chr6","43143726","43144614","chr4","186800340","186800751","524","143656614"
"chr6","43226335","43226771","chr18","4590417","4590744","162","38635918"
"chr6","43452303","43452893","chr4","142197158","142197554","276","98744855"
"chr6","43747284","43747677","chrX","156157295","156157655","111","112410011"
"chr6","45674194","45674775","chr17","73596440","73596809","271","27922246"
"chr6","46372381","46372704","chrX","13280748","13281062","72","33091633"
"chr6","47879863","47880419","chrX","104523190","104523567","254","56643327"
"chr6","57852900","57853522","chr4","186800340","186800751","287","128947440"
"chr6","70871079","70871646","chr4","186800340","186800751","261","115929261"
"chr6","81674697","81675342","chr4","186800340","186800751","351","105125643"
"chr6","82869679","82869992","chr11","42882342","42882658","85","39987337"
"chr6","87383552","87384206","chr9","34516377","34516764","339","52867175"
"chr6","88028124","88028733","chr8","137225928","137226325","286","49197804"
"chr6","95079894","95080150","chr1","27267953","27268192","83","67811941"
"chr6","97405134","97405291","chr14","49069239","49069399","36","48335895"
"chr6","98586508","98587103","chr4","142197158","142197554","279","43610650"
"chr6","103958797","103959435","chr10","96920061","96920447","323","7038736"
"chr6","104996320","104997268","chr4","186800340","186800751","579","81804020"
"chr6","105129457","105130066","chr4","186800340","186800751","285","81670883"
"chr6","106293666","106294270","chr10","96920061","96920447","297","9373605"
"chr6","106654094","106654394","chr12","100242437","100242740","85","6411657"
"chr6","108809369","108809950","chr4","142197158","142197554","264","33387789"
"chr6","109159815","109160237","chr8","128208503","128208862","148","19048688"
"chr6","109430835","109431436","chr17","73596440","73596809","283","35834395"
"chr6","109743110","109743625","chr4","142197158","142197554","216","32454048"
"chr6","112196264","112196804","chr14","102268297","102268694","226","9927967"
"chr6","124329354","124329975","chr8","137225928","137226325","283","12896574"
"chr6","128156891","128157217","chr16","56585111","56585422","71","71571780"
"chr6","133552463","133553329","chr8","137225928","137226325","512","3673465"
"chr6","135712196","135712795","chr8","137225928","137226325","268","1513732"
"chr6","137520965","137521464","chr4","142197158","142197554","194","4676193"
"chr6","137546600","137546952","chr11","12714950","12715269","84","124831650"
"chr6","148145346","148145979","chr9","34516377","34516764","303","113628969"
"chr6","148166198","148167117","chr4","186800340","186800751","546","38634142"
"chr6","153022491","153022796","chr12","108740203","108740506","78","44282288"
"chr6","157297169","157297751","chr14","102268297","102268694","260","55028872"
"chr6","166362453","166363078","chr8","137225928","137226325","299","29136525"
"chr6","167375176","167375689","chr14","60344252","60344605","226","107030924"
"chr6","168182429","168182731","chr5","150824228","150824530","68","17358201"
"chr6","169155609","169155917","chr6","172234676","172234978","16","3079067"
"chr7","255543","256177","chr8","137225928","137226325","323","136970385"
"chr7","435425","435992","chr8","137225928","137226325","255","136790503"
"chr7","778145","779099","chr4","186800340","186800751","590","186022195"
"chr7","1692029","1692677","chr8","137225928","137226325","341","135533899"
"chr7","2125318","2125836","chr8","137225928","137226325","211","135100610"
"chr7","2568581","2569189","chr8","137225928","137226325","285","134657347"
"chr7","2609251","2609862","chr8","137225928","137226325","275","134616677"
"chr7","2648630","2649281","chr17","73596440","73596809","336","70947810"
"chr7","3521477","3522270","chr8","137225928","137226325","450","133704451"
"chr7","3749305","3749855","chr8","137225928","137226325","227","133476623"
"chr7","3924398","3925372","chr4","186800340","186800751","603","182875942"
"chr7","4060782","4061366","chr8","137225928","137226325","264","133165146"
"chr7","4141412","4142026","chr8","137225928","137226325","290","133084516"
"chr7","4148843","4149485","chr14","102268297","102268694","311","98119454"
"chr7","4392173","4392765","chr4","142197158","142197554","277","137804985"
"chr7","4522072","4522658","chr8","137225928","137226325","274","132703856"
"chr7","4525555","4526168","chr4","142197158","142197554","292","137671603"
"chr7","4615116","4615561","chr11","121012159","121012487","170","116397043"
"chr7","4640019","4640626","chr14","102268297","102268694","285","97628278"
"chr7","4705116","4705725","chr17","73596440","73596809","296","68891324"
"chr7","4730561","4731157","chr8","137225928","137226325","290","132495367"
"chr7","4874723","4875251","chr4","142197158","142197554","229","137322435"
"chr7","5513198","5513614","chr7","102727244","102727545","131","97214046"
"chr7","5704123","5704748","chr22","20071849","20072232","296","14367726"
"chr7","6124119","6124473","chr7","76382228","76382581","21","70258109"
"chr7","6127452","6128056","chr8","137225928","137226325","277","131098476"
"chr7","6249588","6249905","chr7","73115612","73115929","64","66866024"
"chr7","6272610","6272834","chr7","65007084","65007305","12","58734474"
"chr7","6369883","6370442","chr4","142197158","142197554","248","135827275"
"chr7","6716882","6717485","chr8","137225928","137226325","279","130509046"
"chr7","7057140","7057755","chr17","73596440","73596809","300","66539300"
"chr7","7367909","7368508","chr14","102268297","102268694","282","94900388"
"chr7","7381391","7381712","chr7","73720445","73720777","22","66339054"
"chr7","7516041","7516652","chr22","20071849","20072232","278","12555808"
"chr7","7612036","7612632","chr17","2569283","2569663","290","5042753"
"chr7","7620865","7621191","chr4","133125340","133125654","80","125504475"
"chr7","7753617","7754097","chr4","142197158","142197554","172","134443541"
"chr7","7827756","7828063","chr7","73273582","73273877","18","65445826"
"chr7","7831948","7832313","chr16","12382875","12383153","185","4550927"
"chr7","8300044","8300642","chr17","21738873","21739256","282","13438829"
"chr7","8306638","8306918","chr20","33967873","33968134","64","25661235"
"chr7","8319640","8320264","chr4","142197158","142197554","303","133877518"
"chr7","8355778","8356393","chr4","186800340","186800751","281","178444562"
"chr7","8360357","8361004","chr10","96920061","96920447","316","88559704"
"chr7","8377655","8378222","chr10","96920061","96920447","246","88542406"
"chr7","8804051","8804687","chr8","137225928","137226325","310","128421877"
"chr7","8818280","8818523","chr22","44483146","44483371","62","35664866"
"chr7","8880140","8880744","chr8","137225928","137226325","276","128345788"
"chr7","8907986","8908588","chr8","137225928","137226325","272","128317942"
"chr7","9374976","9375589","chr8","137225928","137226325","270","127850952"
"chr7","10852621","10852928","chr3","127000616","127000926","86","116147995"
"chr7","11114657","11115247","chr4","142197158","142197554","278","131082501"
"chr7","11136526","11137111","chr14","102268297","102268694","259","91131771"
"chr7","11305477","11306101","chr8","137225928","137226325","288","125920451"
"chr7","12170292","12170855","chr8","137225928","137226325","247","125055636"
"chr7","12922240","12922614","chr6","73361831","73362154","122","60439591"
"chr7","13554917","13555556","chr10","96920061","96920447","313","83365144"
"chr7","13598110","13598692","chr19","60452658","60453024","277","46854548"
"chr7","14082214","14082789","chrX","104523190","104523567","253","90440976"
"chr7","14657044","14657338","chr1","85753152","85753436","64","71096108"
"chr7","14739072","14739694","chr14","102268297","102268694","298","87529225"
"chr7","14877716","14878341","chr4","186800340","186800751","297","171922624"
"chr7","15481578","15482193","chrX","104523190","104523567","287","89041612"
"chr7","15586271","15586858","chr10","96920061","96920447","267","81333790"
"chr7","15699180","15699787","chr8","137225928","137226325","287","121526748"
"chr7","15731804","15732410","chr8","137225928","137226325","285","121494124"
"chr7","15805160","15805771","chr8","137225928","137226325","289","121420768"
"chr7","15965371","15965975","chr4","142197158","142197554","282","126231787"
"chr7","17549585","17550183","chr8","137225928","137226325","283","119676343"
"chr7","17552325","17552912","chr4","142197158","142197554","274","124644833"
"chr7","17646601","17646936","chr20","2830345","2830636","71","14816256"
"chr7","18847433","18848059","chr22","20071849","20072232","295","1224416"
"chr7","19214149","19214743","chr10","113588554","113588931","296","94374405"
"chr7","23342884","23343201","chr7","48824796","48825109","36","25481912"
"chr7","23511181","23511785","chr9","34516377","34516764","306","11005196"
"chr7","28204351","28204679","chr20","43775534","43775839","77","15571183"
"chr7","28450485","28451086","chr8","137225928","137226325","272","108775443"
