"JH378105","575908","576204","chr14","80378701","80378996","49","79802793"
"JH378105","1261270","1261567","chr2","7727690","7727993","51","6466420"
"JH378105","1312118","1312424","chr12","72899340","72899646","38","71587222"
"JH378105","1362681","1362872","chr18","22772283","22772466","36","21409602"
"JH378105","1901956","1902242","chr14","75159045","75159335","49","73257089"
"JH378105","1981838","1982139","chr6","36288281","36288590","56","34306443"
"JH378105","2614181","2614479","chr23","80642893","80643191","49","78028712"
"JH378105","2903389","2903694","chr20","7876234","7876541","50","4972845"
"JH378105","3668275","3668506","chr23","79650541","79650766","39","75982266"
"JH378105","4210453","4210633","chr6","40853681","40853861","28","36643228"
"JH378105","6148139","6148398","chr2","66937766","66938027","39","60789627"
"JH378105","6738053","6738158","chr3","54517299","54517407","27","47779246"
"JH378105","7175703","7175999","chr12","101706953","101707248","39","94531250"
"JH378105","7228251","7228484","chr9","86755766","86756000","29","79527515"
"JH378105","7349927","7350221","chr16","57642435","57642739","39","50292508"
"JH378105","7560022","7560328","chr16","51524710","51525012","51","43964688"
"JH378105","7641920","7642225","chr26","2028130","2028430","47","5613790"
"JH378105","8126818","8127081","chr14","12717469","12717730","39","4590651"
"JH378105","8278547","8278870","chr18","70941881","70942195","58","62663334"
"JH378105","8804779","8805021","chr20","104477833","104478070","47","95673054"
"JH378105","8966012","8966312","chr12","78702042","78702334","48","69736030"
"JH378105","9809248","9809551","chr6","10613040","10613338","41","803792"
"JH378105","10223098","10223395","chr13","8089163","8089459","68","2133935"
"JH378105","10226422","10226570","chr25","6369752","6369893","27","3856670"
"JH378105","10274964","10275245","chr18","57613383","57613665","45","47338419"
"JH378105","10316773","10317083","chr16","30445850","30446151","44","20129077"
"JH378105","10336639","10336907","chr20","104293209","104293496","51","93956570"
"JH378105","11316042","11316334","chr26","15280964","15281257","40","3964922"
"JH378105","11385836","11386116","chr15","58145892","58146179","45","46760056"
"JH378105","11443518","11443692","chr10","61946373","61946539","31","50502855"
"JH378105","12241187","12241456","chrX","95626245","95626526","51","83385058"
"JH378105","12257678","12257951","chr9","99714018","99714298","42","87456340"
"JH378105","12266167","12266461","chr14","68489088","68489386","42","56222921"
"JH378105","13271227","13271503","chr11","62921553","62921824","60","49650326"
"JH378105","13298234","13298514","chr9","61444147","61444444","50","48145913"
"JH378105","13347788","13348090","chr10","88288814","88289117","36","74941026"
"JH378105","13382593","13382874","chr16","58327777","58328064","46","44945184"
"JH378105","13473655","13473831","chr26","40178880","40179052","33","26705225"
"JH378105","14933756","14934046","chr25","28558869","28559160","44","13625113"
"JH378105","15782978","15783267","chr29","9188440","9188729","30","6594538"
"JH378105","16642224","16642516","chr14","76834198","76834500","49","60191974"
"JH378105","17234794","17235088","chrX","43777377","43777676","41","26542583"
"JH378105","17759482","17759690","chr15","21276418","21276632","55","3516936"
"JH378105","18459860","18460099","chr21","56951498","56951751","62","38491638"
"JH378105","20144686","20144996","chr4","75730761","75731061","65","55586075"
"JH378105","20657345","20657649","chr3","30187575","30187872","59","9530230"
"JH378105","20928190","20928484","chr9","78073476","78073771","37","57145286"
"JH378105","21113268","21113394","chr10","113050222","113050344","27","91936954"
"JH378105","21244303","21244597","chr11","53710956","53711245","38","32466653"
"JH378105","21247851","21248152","chr3","30187575","30187872","43","8939724"
"JH378105","21261970","21262274","chrX","111147394","111147703","44","89885424"
"JH378105","21263994","21264114","chrX","49589459","49589586","26","28325465"
"JH378105","21791639","21791943","chr4","74750244","74750542","43","52958605"
"JH378105","22150533","22150758","chr17","45336545","45336772","43","23186012"
"JH378105","22252976","22253271","chr2","72075917","72076212","51","49822941"
"JH378105","22259522","22259614","chr7","27620515","27620606","22","5360993"
"JH378105","22431124","22431406","chr21","48106444","48106729","46","25675320"
"JH378105","22449595","22449900","chr15","2000778","2001083","34","20448817"
"JH378105","22713939","22714234","chr10","53802403","53802702","49","31088464"
"JH378105","22854584","22854889","chr26","33024367","33024673","59","10169783"
"JH378105","23049914","23050079","chr5","71122050","71122197","47","48072136"
"JH378105","23868493","23868779","chr1","67566937","67567228","50","43698444"
"JH378105","24246072","24246171","chr4","66655504","66655608","30","42409432"
"JH378105","24246394","24246596","chr16","62117476","62117671","41","37871082"
"JH378105","24601357","24601650","chr20","105708807","105709105","39","81107450"
"JH378105","26240048","26240339","chr12","41367876","41368167","42","15127828"
"JH378105","26783453","26783722","chr20","111949525","111949783","58","85166072"
"JH378105","30279835","30279943","chr2","12031294","12031409","20","18248541"
"JH378105","31161055","31161340","chr13","86323276","86323561","59","55162221"
"JH378105","35040397","35040697","chr6","40467631","40467923","46","5427234"
"JH378105","35145043","35145244","chr12","44011261","44011469","47","8866218"
"JH378105","35198833","35199112","chr11","42101160","42101440","49","6902327"
"JH378105","35262654","35262927","chr19","4180398","4180669","46","31082256"
"JH378105","35470837","35471136","chr16","24824595","24824890","43","10646242"
"JH378105","35539778","35539987","chr2","13316902","13317112","34","22222876"
"JH378105","35584765","35585074","chr15","2000778","2001083","47","33583987"
"JH378105","35608846","35609116","chr11","62921553","62921824","32","27312707"
"JH378105","35778695","35778986","chrX","28657995","28658281","41","7120700"
"JH378105","35999700","36000000","chr10","10812813","10813115","49","25186887"
"JH378105","36152932","36153226","chr28","15327544","15327835","37","20825388"
"JH378105","36698965","36699268","chr8","95859478","95859783","43","59160513"
"JH378105","36756251","36756538","chr6","31277843","31278132","49","5478408"
"JH378105","37593357","37593643","chr23","50149627","50149920","51","12556270"
"JH378105","37839016","37839292","chr2","33070354","33070635","53","4768662"
"JH378105","39482354","39482666","chr3","7473141","7473445","51","32009213"
"JH378105","40324134","40324437","chr11","114930921","114931227","55","74606787"
"JH378105","40619320","40619602","chrX","26479311","26479602","50","14140009"
"JH378105","41260451","41260766","chr14","86997958","86998245","75","45737507"
"JH378105","41824783","41825095","chr14","68029332","68029639","49","26204549"
"JH378105","42238787","42239093","chr6","10540061","10540366","47","31698726"
"JH378105","42937164","42937410","chr10","94020388","94020642","79","51083224"
"JH378105","43093763","43094059","chr8","43709944","43710222","57","616181"
"JH378105","43973261","43973571","chrX","29670774","29671076","48","14302487"
"JH378105","44004981","44005278","chr23","35735447","35735750","46","8269534"
"JH378105","44046044","44046339","chr4","75730761","75731061","47","31684717"
"JH378105","44081890","44082181","chr9","57921121","57921405","46","13839231"
"JH378105","45294174","45294483","chr22","67435237","67435541","55","22141063"
"JH378105","45294622","45294931","chr22","67435237","67435541","55","22140615"
"JH378105","45340700","45341011","chr1","125024996","125025302","48","79684296"
"JH378105","45871031","45871327","chr20","2854395","2854680","46","43016636"
"JH378105","45882300","45882599","chr26","24027927","24028229","36","21854373"
"JH378105","46041864","46042173","chr2","33362197","33362503","33","12679667"
"JH378105","47953466","47953725","chr3","25922879","25923130","45","22030587"
"JH378105","48141138","48141253","chr6","35661566","35661675","17","12479572"
"JH378105","48141882","48142180","chr4","74750244","74750542","54","26608362"
"JH378105","48839558","48839736","chr8","112629520","112629695","45","63789962"
"JH378105","49235450","49235689","chrX","92178511","92178733","44","42943061"
"JH378105","49242697","49242990","chr11","42708500","42708788","53","6534197"
"JH378105","49616514","49616722","chr24","40869921","40870127","43","8746593"
"JH378105","49691813","49692108","chr2","38962090","38962387","42","10729723"
"JH378105","50121035","50121339","chr12","3898076","3898379","42","46222959"
"JH378105","50516849","50517021","chr3","91778271","91778445","36","41261422"
"JH378105","50799663","50799854","chr7","131233865","131234062","38","80434202"
"JH378105","51463923","51464210","chr11","42708500","42708788","44","8755423"
"JH378105","51649061","51649356","chr1","9360845","9361141","33","42288216"
"JH378105","51681879","51682119","chr20","73604908","73605140","53","21923029"
"JH378105","51706614","51706912","chr10","55092261","55092557","38","3385647"
"JH378105","51785970","51786250","chr9","39487572","39487853","54","12298398"
"JH378105","51966248","51966508","chr26","38595395","38595663","58","13370853"
"JH378105","52311069","52311273","chr16","9005892","9006101","37","43305177"
"JH378105","52414170","52414470","chr12","62505268","62505568","51","10091098"
"JH378105","53640582","53640813","chrX","5651910","5652138","49","47988672"
"JH378105","53776713","53777006","chr9","119761241","119761543","48","65984528"
"JH378105","54554330","54554550","chr24","28053576","28053799","41","26500754"
"JH378105","54768081","54768330","chr1","2272506","2272749","56","52495575"
"JH378105","55537735","55538048","chr10","44221705","44222014","41","11316030"
"JH378105","55625766","55626060","chr23","51149623","51149911","46","4476143"
"JH378105","56178469","56178768","chr9","114669635","114669933","48","58491166"
"JH378105","56300850","56300954","chr1","19184037","19184145","24","37116813"
"JH378105","56391350","56391629","chr1","29294849","29295125","37","27096501"
"JH378105","56415926","56416231","chr23","71906236","71906536","37","15490310"
"JH378105","56571130","56571412","chr7","55740326","55740609","46","830804"
"JH378105","56622036","56622337","chr24","10677968","10678270","43","45944068"
"JH378105","56640356","56640645","chr9","78073476","78073771","47","21433120"
"JH378105","57295729","57296026","chr6","10613040","10613338","52","46682689"
"JH378105","57320717","57320987","chr12","56981284","56981548","52","339433"
"JH378105","57359087","57359373","chr20","87036350","87036638","30","29677263"
"JH378105","57667655","57667792","chr10","116871819","116871952","24","59204164"
"JH378105","57671007","57671121","chr26","11354204","11354323","27","46316803"
"JH378105","57672012","57672188","chr3","91778271","91778445","40","34106259"
"JH378105","58437313","58437529","chr11","127416029","127416256","51","68978716"
"JH378105","59072161","59072463","chr3","64952340","64952627","65","5880179"
"JH378105","59579753","59580046","chr2","61035797","61036096","47","1456044"
"JH378105","60324362","60324589","chr3","54097857","54098084","35","6226505"
"JH378105","60957768","60958057","chr23","63097278","63097570","51","2139510"
"JH378105","62365154","62365453","chr17","22605049","22605342","54","39760105"
"JH378105","67790648","67790946","chr12","101706953","101707248","41","33916305"
"JH378105","68030350","68030659","chr6","36288281","36288590","31","31742069"
"JH378105","68445068","68445372","chr6","47650116","47650422","42","20794952"
"JH378105","69203151","69203417","chr21","100655766","100656018","60","31452615"
"JH378105","69440821","69441111","chr12","103186024","103186315","38","33745203"
"JH378105","70768564","70768868","chr9","41529323","41529631","45","29239241"
"JH378105","70778965","70779255","chr19","4455651","4455943","33","66323314"
"JH378105","71655287","71655566","chr9","39487572","39487853","51","32167715"
"JH378105","72132920","72133211","chr28","8917006","8917294","36","63215914"
"JH378105","72147753","72147887","chr13","80405244","80405376","21","8257491"
"JH378106","168845","168964","chr7","111452262","111452389","23","111283417"
"JH378106","362847","363113","chr24","80508974","80509233","53","80146127"
"JH378106","739535","739825","chr16","72580947","72581238","39","71841412"
"JH378106","1387840","1387917","chr7","27620515","27620606","24","26232675"
"JH378106","1583924","1584053","chr24","67319758","67319887","15","65735834"
"JH378106","1614067","1614276","chr16","9005892","9006101","34","7391825"
"JH378106","1632926","1633153","chr19","24215041","24215262","41","22582115"
"JH378106","1776351","1776614","chr2","87954053","87954315","39","86177702"
"JH378106","2852036","2852277","chr17","6642467","6642719","51","3790431"
"JH378106","4636506","4636791","chr9","11828451","11828739","45","7191945"
"JH378106","4719794","4720015","chr5","12500001","12500225","37","7780207"
"JH378106","6233255","6233425","chr14","57070656","57070827","35","50837401"
"JH378106","6284376","6284671","chr20","8697119","8697417","40","2412743"
"JH378106","6413627","6413932","chr23","44164359","44164660","37","37750732"
"JH378106","6461446","6461724","chr17","41657157","41657445","52","35195711"
"JH378106","6613910","6614202","chr2_KE147940v1_random","21204","21502","38","6592706"
"JH378106","6741833","6742140","chr16","36007753","36008062","41","29265920"
"JH378106","8602316","8602443","chr17","18864767","18864901","20","10262451"
"JH378106","8631508","8631807","chr26","24027927","24028229","41","15396419"
"JH378106","8911691","8911989","chr11","116558393","116558699","56","107646702"
"JH378106","8942503","8942826","chr1","8696866","8697165","72","245637"
"JH378106","9193489","9193772","chr10","115555729","115556012","40","106362240"
"JH378106","9741987","9742037","chr9","67628980","67629015","24","57886993"
"JH378106","9742053","9742088","chrX","75025184","75025222","15","65283131"
"JH378106","9916951","9917133","chr8","92570169","92570339","37","82653218"
"JH378106","10086407","10086719","chr22","45546705","45547014","47","35460298"
"JH378106","10552577","10552690","chr8","40990809","40990921","19","30438232"
"JH378106","11314220","11314522","chrX","33027186","33027484","37","21712966"
"JH378106","11503419","11503599","chr2","68873500","68873683","44","57370081"
"JH378106","13045444","13045725","chr1","101516444","101516734","53","88471000"
"JH378106","13715238","13715518","chr12","31941379","31941656","44","18226141"
"JH378106","13910771","13910961","chr6","9550495","9550686","31","4360276"
"JH378106","14123563","14123662","chr1","19184037","19184145","25","5060474"
"JH378106","14171674","14171976","chr11","9736123","9736423","49","4435551"
"JH378106","14263106","14263327","chr21","106582007","106582232","38","92318901"
"JH378106","14317195","14317490","chr11","83560875","83561170","40","69243680"
"JH378106","15743691","15743983","chr12","46616697","46616968","78","30873006"
"JH378106","15838349","15838609","chr1","106079163","106079424","51","90240814"
"JH378106","16320628","16320923","chr17","36678048","36678335","51","20357420"
"JH378106","17214758","17215029","chr16","16583135","16583399","45","631623"
"JH378106","17547942","17548135","chr9","53409532","53409725","26","35861590"
"JH378106","20650235","20650530","chr24","42824289","42824580","54","22174054"
"JH378106","21209658","21209954","chr10","55092261","55092557","44","33882603"
"JH378106","21622511","21622803","chr28","15327544","15327835","41","6294967"
"JH378106","21728540","21728832","chr1","53767711","53767998","57","32039171"
"JH378106","21833761","21834069","chr24","80299811","80300120","32","58466050"
"JH378106","21907376","21907676","chr16","24824595","24824890","53","2917219"
"JH378106","21964672","21964958","chr15","58145892","58146179","41","36181220"
"JH378106","22002163","22002454","chr16","18299936","18300237","49","3702227"
"JH378106","22804383","22804683","chr9","86239175","86239476","44","63434792"
"JH378106","23111164","23111338","chr24","80445348","80445522","29","57334184"
"JH378106","24635905","24636208","chr6","29394044","29394346","44","4758139"
"JH378106","24759182","24759479","chr23","19522217","19522509","54","5236965"
"JH378106","25219481","25219737","chr24","80508974","80509233","61","55289493"
"JH378106","28263736","28264009","chr12","44174718","44174990","73","15910982"
"JH378106","28819870","28820171","chr1","109790831","109791123","54","80970961"
"JH378106","29628658","29628955","chr3","30187575","30187872","44","558917"
"JH378106","30452770","30453065","chr22","41272196","41272486","49","10819426"
"JH378106","30965314","30965444","chr28","12031940","12032076","25","18933374"
"JH378106","31509133","31509422","chr6","21119238","21119524","44","10389895"
"JH378106","33513570","33513852","chr11","90955909","90956196","43","57442339"
"JH378106","34620801","34621015","chr14","52996483","52996698","39","18375682"
"JH378106","34941642","34941929","chr18","48953277","48953567","50","14011635"
"JH378106","36473647","36473856","chrX","92178511","92178733","54","55704864"
"JH378106","36529053","36529201","chrY_KE148141v1_random","34148","34298","46","36494905"
"JH378106","37177257","37177536","chr23","16346527","16346792","57","20830730"
"JH378106","40104323","40104612","chr11","42708500","42708788","59","2604177"
"JH378106","40749282","40749575","chr21","122693272","122693565","39","81943990"
"JH378106","40812824","40813101","chr9","103138976","103139260","55","62326152"
"JH378106","40986159","40986476","chr12","62505268","62505568","56","21519109"
"JH378106","41028909","41029196","chr6","6217754","6218043","49","34811155"
"JH378106","41439064","41439221","chr24","65904734","65904875","44","24465670"
"JH378106","44617915","44618201","chr28","13713786","13714063","49","30904129"
"JH378106","45374257","45374554","chr20","7876234","7876541","49","37498023"
"JH378106","45487808","45487970","chr10","115848650","115848821","54","70360842"
"JH378106","46348496","46348797","chr18","44730857","44731152","50","1617639"
"JH378106","47426524","47426813","chr15","5798467","5798739","70","41628057"
"JH378106","47962984","47963145","chr6","43429100","43429261","28","4533884"
"JH378106","48662334","48662638","chr9","68644589","68644886","48","19982255"
"JH378106","49747429","49747543","chr8","88261673","88261783","24","38514244"
"JH378106","50141041","50141250","chr25","37711695","37711877","67","12429346"
"JH378106","50434567","50434792","chr7","57513437","57513664","34","7078870"
"JH378106","50714057","50714327","chr14","7740969","7741247","57","42973088"
"JH378106","52762500","52762795","chr25","25485107","25485403","46","27277393"
"JH378106","53775793","53776073","chr20","9842411","9842688","45","43933382"
"JH378106","54002206","54002448","chr17","41816726","41816966","38","12185480"
"JH378106","55562215","55562501","chr11","64950384","64950668","51","9388169"
"JH378106","56737721","56738017","chr4","74750244","74750542","40","18012523"
"JH378106","56854415","56854629","chr9","57732450","57732667","40","878035"
"JH378106","56922453","56922702","chr25","52946162","52946411","53","3976291"
"JH378106","57244406","57244693","chrX","94042142","94042438","51","36797736"
"JH378106","57695480","57695792","chr28","2478882","2479189","55","55216598"
"JH378106","58013996","58014282","chr12","98075663","98075941","50","40061667"
"JH378106","58034280","58034604","chr15","52586959","52587266","70","5447321"
"JH378106","58813673","58813978","chr19","12483703","12484011","37","46329970"
"JH378106","58845131","58845237","chr21","73874260","73874368","21","15029129"
"JH378106","59453091","59453319","chr9","86755766","86756000","40","27302675"
"JH378106","59835990","59836260","chr4","37731664","37731929","39","22104326"
"JH378106","60353952","60354106","chr8","124933735","124933890","27","64579783"
"JH378106","60370018","60370291","chr15","4986082","4986355","47","55383936"
"JH378106","60439751","60439885","chrX","77324374","77324510","14","16884623"
"JH378106","60776631","60776782","chr29","23529798","23529947","29","37246833"
"JH378106","61678234","61678520","chr4","71555519","71555804","43","9877285"
"JH378106","61822851","61823144","chr1","50364882","50365169","53","11457969"
"JH378106","62513681","62513975","chr12","65356809","65357103","37","2843128"
"JH378106","62550348","62550630","chr20","19842108","19842392","48","42708240"
"JH378106","62596352","62596663","chr7","119466216","119466521","44","56869864"
"JH378106","62677170","62677461","chr11","27415567","27415860","37","35261603"
"JH378106","62999116","62999409","chr18","63833457","63833758","48","834341"
"JH378106","63046636","63046910","chrX","126577906","126578182","53","63531270"
"JH378106","64304709","64304993","chr2","6803049","6803335","35","57501660"
"JH378106","64717897","64718071","chr20","87928737","87928908","25","23210840"
"JH378106","64996824","64997115","chr20_KE148049v1_random","1057268","1057561","37","63939556"
"JH378106","65924251","65924534","chr11","42708500","42708788","35","23215751"
"JH378106","66958091","66958386","chr14","26741966","26742270","47","40216125"
"JH378106","67412825","67413122","chr8","95859478","95859783","56","28446653"
"JH378106","67448846","67449155","chr16","35104042","35104353","39","32344804"
"JH378106","67766653","67766827","chr26","40178880","40179052","38","27587773"
"JH378106","68031962","68032010","chr1","94293794","94293836","12","26261832"
"JH378106","68045474","68045525","chr13","55236222","55236271","9","12809252"
"JH378106","68167458","68167738","chr17","33280317","33280602","50","34887141"
"JH378106","68374185","68374466","chr20","19842108","19842392","52","48532077"
"JH378106","68483588","68483693","chr1","19184037","19184145","21","49299551"
"JH378106","68735756","68736030","chr7","24372563","24372858","54","44363193"
"JH378106","70239533","70239839","chr20","7876234","7876541","45","62363299"
"JH378106","70508567","70508701","chr14","33067112","33067242","26","37441455"
"JH378106","70513055","70513357","chrX","50449700","50450001","47","20063355"
"JH378106","70530448","70530756","chr3","14236526","14236826","46","56293922"
"JH378106","70557547","70557838","chr1","9360845","9361141","43","61196702"
"JH378106","70723184","70723453","chr19","15464805","15465074","44","55258379"
"JH378106","70962905","70963187","chr16","71130019","71130298","44","167114"
"JH378106","70972153","70972465","chr23","57612824","57613126","50","13359329"
"JH378107","285991","286271","chr15","91094478","91094763","49","90808487"
"JH378107","380567","380879","chr10","18120093","18120403","43","17739526"
"JH378107","1226663","1226941","chr7","29422863","29423146","38","28196200"
"JH378107","2539138","2539401","chr10","94020388","94020642","46","91481250"
"JH378107","3214807","3215110","chrX","58994083","58994385","43","55779276"
"JH378107","4300399","4300706","chr1","10964645","10964948","61","6664246"
"JH378107","5020313","5020611","chr4","74750244","74750542","37","69729931"
"JH378107","5448274","5448575","chr5","34361928","34362228","45","28913654"
"JH378107","5480224","5480529","chr1","43486737","43487042","46","38006513"
"JH378107","5588645","5588797","chrX","37746028","37746173","26","32157383"
"JH378107","5622791","5623026","chr1","14043292","14043520","44","8420501"
"JH378107","5790824","5791112","chr20","2854395","2854680","37","2936429"
"JH378107","5933406","5933691","chr4","11736984","11737266","45","5803578"
"JH378107","5947860","5948155","chrX","6571847","6572139","45","623987"
"JH378107","6234110","6234414","chr26","26868700","26868994","44","20634590"
"JH378107","6319675","6319796","chrUn_AQIB01158800v1","1","125","18","6319674"
"JH378107","6578487","6578710","chr25","19270221","19270449","63","12691734"
"JH378107","6721480","6721681","chrX","347902","348103","40","6373578"
"JH378107","6765480","6765789","chr12","25030968","25031277","43","18265488"
"JH378107","6789534","6789647","chr2","4976621","4976741","23","1812913"
"JH378107","6823291","6823584","chr12","65356809","65357103","34","58533518"
"JH378107","7118694","7118992","chr1","98960303","98960603","42","91841609"
"JH378107","7177154","7177450","chr16","44211282","44211580","38","37034128"
"JH378107","9278865","9279141","chr14","51174162","51174453","46","41895297"
"JH378107","9481858","9482164","chr1","31207787","31208094","66","21725929"
"JH378107","9998149","9998402","chr10","94020388","94020642","40","84022239"
"JH378107","12831806","12832111","chr8","112469219","112469524","53","99637413"
"JH378107","13345468","13345772","chr13","21872508","21872816","45","8527040"
"JH378107","13881485","13881759","chr27","2530148","2530418","57","11351337"
"JH378107","14573599","14573885","chr20","14658462","14658743","49","84863"
"JH378107","14645949","14646255","chr21","55549223","55549531","37","40903274"
"JH378107","15240943","15241223","chr2","61082854","61083126","63","45841911"
"JH378107","16929195","16929332","chr25","6369752","6369893","19","10559443"
"JH378107","18749666","18749899","chr18","68668421","68668651","35","49918755"
"JH378107","19960091","19960419","chr13","33537588","33537921","67","13577497"
"JH378107","20015434","20015727","chr1","51035370","51035662","42","31019936"
"JH378107","22946719","22947005","chr11","42708500","42708788","39","19761781"
"JH378107","23136862","23137112","chr1","50678867","50679117","42","27542005"
"JH378107","23308987","23309284","chr14","35916188","35916490","40","12607201"
"JH378107","24499373","24499661","chr1","9142653","9142941","32","15356720"
"JH378107","26793890","26794189","chr14","61349438","61349746","55","34555548"
"JH378107","26914978","26915271","chr1","9360845","9361141","53","17554133"
"JH378107","27661933","27662205","chr23","63036814","63037090","41","35374881"
"JH378107","27927174","27927473","chr23","37622829","37623120","64","9695655"
"JH378107","28027286","28027587","chrX","58994083","58994385","49","30966797"
"JH378107","28147709","28147980","chr14","86997958","86998245","52","58850249"
"JH378107","28258850","28258984","chr5","70321221","70321359","22","42062371"
"JH378107","28418522","28418808","chr10","104330612","104330907","43","75912090"
"JH378107","29556119","29556407","chr8","17131358","17131640","47","12424761"
"JH378107","29762286","29762474","chr20","87241411","87241591","38","57479125"
"JH378107","29911746","29912035","chr16","24824595","24824890","43","5087151"
"JH378107","30072514","30072720","chr22","59313204","59313418","52","29240690"
"JH378107","30091802","30092097","chr11","90535443","90535733","51","60443641"
"JH378107","30537528","30537801","chr9","17604750","17605020","52","12932778"
"JH378107","31083047","31083363","chr2","33362197","33362503","49","2279150"
"JH378107","32034605","32034883","chr18","8947915","8948183","59","23086690"
"JH378107","32077371","32077651","chr11","42708500","42708788","42","10631129"
"JH378107","32078809","32079110","chrX","33027186","33027484","40","948377"
"JH378107","32783512","32783694","chr21","18967230","18967419","49","13816282"
"JH378107","33008532","33008842","chr21","8921616","8921919","51","24086916"
"JH378107","33899005","33899315","chr10","59935987","59936305","50","26036982"
"JH378107","34250160","34250462","chr9","47580831","47581120","43","13330671"
"JH378107","36223958","36224260","chr17","42200797","42201101","47","5976839"
"JH378107","36341427","36341735","chr1","40186193","40186501","47","3844766"
"JH378107","36939093","36939391","chr12","10047022","10047316","47","26892071"
"JH378107","37707478","37707761","chr1","68970266","68970543","43","31262788"
"JH378107","39618087","39618368","chr26","45493442","45493721","40","5875355"
"JH378107","40140341","40140640","chr24","68758364","68758667","40","28618023"
"JH378107","41820004","41820241","chr20","107997025","107997264","43","66177021"
"JH378107","42545487","42545780","chr16","70729210","70729502","43","28183723"
"JH378107","42983062","42983358","chr23","57612824","57613126","45","14629762"
"JH378107","45025485","45025593","chr20","80015270","80015379","17","34989785"
"JH378107","46933245","46933543","chr19","22145953","22146248","41","24787292"
"JH378107","47595199","47595358","chr9","114689314","114689468","27","67094115"
"JH378107","49168960","49169248","chr6","31992433","31992727","47","17176527"
"JH378107","49445389","49445518","chr21","99460334","99460473","31","50014945"
"JH378107","49597759","49597856","chr8","97137579","97137683","26","47539820"
"JH378107","49709835","49710076","chr7","57513437","57513664","48","7803602"
"JH378107","50224251","50224547","chr2","61035797","61036096","54","10811546"
"JH378107","50292768","50292924","chr27","9643377","9643537","34","40649391"
"JH378107","50722943","50723230","chr1","32028693","32028980","50","18694250"
"JH378107","50804181","50804468","chr11","42708500","42708788","39","8095681"
"JH378107","53908694","53908972","chr16","17103242","17103520","43","36805452"
"JH378107","54859317","54859612","chr12","15293737","15294044","57","39565580"
"JH378107","55029718","55029991","chr28","13713786","13714063","51","41315932"
"JH378107","55447329","55447542","chr22","94574583","94574800","42","39127254"
"JH378107","55927517","55927787","chr20","19842108","19842392","57","36085409"
"JH378107","55941932","55942054","chr7","105880955","105881077","37","49939023"
"JH378107","55942619","55942802","chr14","102685720","102685915","48","46743101"
"JH378107","55965140","55965304","chr1","101573986","101574156","32","45608846"
"JH378107","57212745","57212817","chrX","71000271","71000334","16","13787526"
"JH378107","57491745","57492039","chr20","97928139","97928435","55","40436394"
"JH378107","57547719","57548027","chr10","81709556","81709863","44","24161837"
"JH378107","57599109","57599404","chr16","14422338","14422632","36","43176771"
"JH378107","57847940","57848235","chr20","16704211","16704502","59","41143729"
"JH378107","57879706","57879778","chr5","2445602","2445676","21","55434104"
"JH378107","57880081","57880308","chr18","9905435","9905663","43","47974646"
"JH378107","57903432","57903731","chr2","61035797","61036096","43","3132365"
"JH378107","58117960","58118269","chrX","60403420","60403723","44","2285460"
"JH378107","58244803","58245057","chr14","61597585","61597855","42","3352782"
"JH378108","42205152","42205324","chr27","10317709","10317877","29","31887443"
"JH378108","937396","937704","chr29","3711047","3711343","49","2773651"
"JH378108","960534","960822","chr23","38922269","38922564","44","37961735"
"JH378108","1215083","1215371","chr9","11828451","11828739","42","10613368"
"JH378108","1325159","1325464","chr20","113381135","113381444","35","112055976"
"JH378108","1885268","1885575","chr20","19843709","19844017","40","17958441"
"JH378108","1959902","1960184","chr12","45962018","45962309","44","44002116"
"JH378108","1999743","2000000","chr29","17560737","17560997","46","15560994"
"JH378108","3223370","3223658","chr6","21119238","21119524","57","17895868"
"JH378108","3585309","3585552","chr1","50678867","50679117","52","47093558"
"JH378108","4159382","4159673","chr3","10998901","10999200","47","6839519"
"JH378108","4728986","4729295","chr10","81709556","81709863","42","76980570"
"JH378108","4877947","4878254","chr10","77202412","77202718","42","72324465"
"JH378108","4916263","4916557","chr28","15327544","15327835","37","10411281"
"JH378108","5542961","5543113","chr27","38068036","38068200","48","32525075"
"JH378108","6370198","6370456","chr23","49183004","49183254","56","42812806"
"JH378108","8224420","8224705","chr11","24876645","24876927","38","16652225"
"JH378108","8476055","8476349","chr16","24824595","24824890","40","16348540"
"JH378108","8982563","8982789","chr12","108518404","108518625","47","99535841"
"JH378108","9104953","9105265","chr16","53329772","53330076","47","44224819"
"JH378108","9765068","9765370","chrX","10891227","10891532","43","1126159"
"JH378108","10399137","10399438","chrX","45160626","45160926","51","34761489"
"JH378108","13205601","13205901","chrX","47726776","47727071","53","34521175"
"JH378108","13366219","13366517","chrX","6571847","6572139","44","6794372"
"JH378108","15113030","15113299","chr1","66543995","66544268","47","51430965"
"JH378108","15328078","15328385","chr5","432745","433046","61","14895333"
"JH378108","15490689","15490971","chr8","1064617","1064892","42","14426072"
"JH378108","16510659","16510946","chr9","31281354","31281649","50","14770695"
"JH378108","17113159","17113300","chr4","90460665","90460796","30","73347506"
"JH378108","18113067","18113347","chr10","115555729","115556012","50","97442662"
"JH378108","18140716","18141008","chr11","42708500","42708788","38","24567784"
"JH378108","18426361","18426651","chr14","89802144","89802429","45","71375783"
"JH378108","18728077","18728383","chr16","52166373","52166679","38","33438296"
"JH378108","18805637","18805916","chr9","58155888","58156167","42","39350251"
"JH378108","19069827","19070112","chr17","67473342","67473631","47","48403515"
"JH378108","19280481","19280762","chr2","12062172","12062451","48","7218309"
"JH378108","20878781","20879074","chr11","12286875","12287171","46","8591906"
"JH378108","20909405","20909710","chr18","63833457","63833758","44","42924052"
"JH378108","21267018","21267322","chr3","31757392","31757689","47","10490374"
"JH378108","22310222","22310381","chr24","65904734","65904875","51","43594512"
"JH378108","23016301","23016596","chr22","12759710","12760008","54","10256591"
"JH378108","23111881","23111979","chr6","29480212","29480322","28","6368331"
"JH378108","23268799","23269045","chr6","11215683","11215935","59","12053116"
"JH378108","23283045","23283346","chr24","80299811","80300120","50","57016766"
"JH378108","23382240","23382552","chr10","65391026","65391336","53","42008786"
"JH378108","23401054","23401236","chr24","80060255","80060437","50","56659201"
"JH378108","24024569","24024703","chr6","33578769","33578895","23","9554200"
"JH378108","24515455","24515749","chr28","15327544","15327835","42","9187911"
"JH378108","24629801","24630089","chr14","82243520","82243806","43","57613719"
"JH378108","26570912","26571105","chr21","18967230","18967419","31","7603682"
"JH378108","26915970","26916260","chr28","15327544","15327835","38","11588426"
"JH378108","27602386","27602665","chr12","37660390","37660680","52","10058004"
"JH378108","29091340","29091626","chr9","32604399","32604698","56","3513059"
"JH378108","30264643","30264952","chr27","32681295","32681602","32","2416652"
"JH378108","30695937","30696115","chr11","67439351","67439527","38","36743414"
"JH378108","30892654","30892759","chr3","1161792","1161901","33","29730862"
"JH378108","31487310","31487597","chr17","59172426","59172715","49","27685116"
"JH378108","31511402","31511704","chr20","78903029","78903335","44","47391627"
"JH378108","31573981","31574276","chr26","18794536","18794836","41","12779445"
"JH378108","31630614","31630742","chr5","25933140","25933266","18","5697474"
"JH378108","31749506","31749776","chr25","85169491","85169762","36","53419985"
"JH378108","31924013","31924230","chr22","9520134","9520352","31","22403879"
"JH378108","32768245","32768537","chr20","104293209","104293496","37","71524964"
"JH378108","32965684","32965961","chr11","42708500","42708788","44","9742816"
"JH378108","33161243","33161398","chr9","95380691","95380840","25","62219448"
"JH378108","33249182","33249447","chr14","60740033","60740297","37","27490851"
"JH378108","33894901","33895169","chr11","42101160","42101440","56","8206259"
"JH378108","33914106","33914215","chr8","57977187","57977292","33","24063081"
"JH378108","34036050","34036359","chr23","37388023","37388329","35","3351973"
"JH378108","34249640","34249912","chr1","70897757","70898029","45","36648117"
"JH378108","34277198","34277494","chr14","68359125","68359423","40","34081927"
"JH378108","34518525","34518672","chr20","107981176","107981334","37","73462651"
"JH378108","34518685","34518725","chr26","37713050","37713081","16","3194365"
"JH378108","34550877","34551020","chrX","555973","556115","24","33994904"
"JH378108","34750775","34751070","chr3","6022508","6022797","44","28728267"
"JH378108","34751071","34751275","chr10","100143125","100143331","43","65392054"
"JH378108","35099828","35100110","chr5","5298594","5298888","57","29801234"
"JH378108","35383685","35383984","chr6","10613040","10613338","37","24770645"
"JH378108","35538532","35538813","chr20","34728052","34728331","33","810480"
"JH378108","37214075","37214367","chr28","15327544","15327835","30","21886531"
"JH378108","38006331","38006486","chr6","33811352","33811518","33","4194979"
"JH378108","38101746","38102041","chr4","74750244","74750542","33","36648498"
"JH378108","38115324","38115603","chr19","18231589","18231878","54","19883735"
"JH378108","38126129","38126394","chr27","2530148","2530418","56","35595981"
"JH378108","38264969","38265233","chr6","17894365","17894631","48","20370604"
"JH378108","38883713","38883903","chr10","88224804","88224966","55","49341091"
"JH378108","39018559","39018723","chr6","43429100","43429261","32","4410541"
"JH378108","39277551","39277842","chr10","75740191","75740486","48","36462640"
"JH378108","39476447","39476749","chr7","91843770","91844065","53","52367323"
"JH378108","39530436","39530721","chr20","106542786","106543068","51","67012350"
"JH378108","40709721","40709999","chr9","57921121","57921405","53","17211400"
"JH378108","40943318","40943617","chr16","18257374","18257671","43","22685944"
"JH378108","41472030","41472231","chr1","21512792","21512987","45","19959238"
"JH378108","41732162","41732464","chr2","42406046","42406352","38","673884"
"JH378108","41946439","41946731","chr6","16935358","16935648","44","25011081"
"JH378108","42205550","42205865","chr9","89864364","89864670","55","47658814"
"JH378108","42264721","42265014","chr4","61692314","61692609","42","19427593"
"JH378108","42408869","42409153","chr28","8917006","8917294","47","33491863"
"JH378108","43211225","43211509","chr25","54334996","54335282","50","11123771"
"JH378108","43435228","43435520","chr16","4436610","4436903","34","38998618"
"JH378108","43583906","43584141","chrX","90939813","90940045","44","47355907"
"JH378108","44326624","44326902","chr5","42930459","42930742","50","1396165"
"JH378108","44413800","44414098","chrX","33027186","33027484","42","11386614"
"JH378108","44680529","44680736","chr16","9005892","9006101","44","35674637"
"JH378108","44737280","44737576","chr22","30234167","30234462","39","14503113"
"JH378108","44837795","44838076","chr2","36039113","36039395","57","8798682"
"JH378108","45064246","45064534","chr18","31464231","31464522","44","13600015"
"JH378108","45104526","45104807","chr9","120719378","120719663","46","75614852"
"JH378108","45157513","45157653","chr19","8893838","8893978","27","36263675"
"JH378108","45241562","45241864","chr22","99768771","99769071","48","54527209"
"JH378108","45331365","45331676","chr9","57444017","57444321","47","12112652"
"JH378108","46291321","46291619","chr21","81623551","81623841","51","35332230"
"JH378108","46295954","46296093","chr4","90460665","90460796","28","44164711"
"JH378108","46485866","46486149","chr6","3646070","3646335","60","42839796"
"JH378108","47520866","47521158","chr24","28147960","28148255","54","19372906"
"JH378108","49238970","49239262","chr28","8917006","8917294","52","40321964"
"JH378108","49307461","49307710","chr12","15320158","15320403","41","33987303"
"JH378108","49314034","49314325","chr12","65356809","65357103","34","16042775"
"JH378108","49356983","49357054","chr2","7577624","7577697","20","41779359"
"JH378108","49466936","49467222","chr2","7721210","7721494","39","41745726"
"JH378108","50126772","50127028","chr10","94020388","94020642","44","43893616"
"JH378108","50577121","50577413","chr1","68581324","68581621","46","18004203"
"JH378108","50737490","50737634","chr25","55203429","55203580","28","4465939"
"JH378108","51189938","51190201","chr12","108171343","108171621","43","56981405"
"JH378108","51304897","51305190","chr2","61035797","61036096","41","9730900"
"JH378108","51571157","51571373","chr11","100225388","100225600","35","48654231"
"JH378108","51993219","51993397","chr8","112629520","112629695","34","60636301"
"JH378108","52190489","52190695","chr2","25630213","25630417","36","26560276"
"JH378108","52554793","52555066","chr23","7334731","7335011","53","45220062"
"JH378108","52889957","52890249","chr10","104330612","104330907","51","51440655"
"JH378108","54507897","54508191","chr24","50545181","50545478","48","3962716"
"JH378109","2998981","2999327","chr27","40239547","40239855","80","37240566"
"JH378109","3291158","3291435","chr2","40676301","40676592","62","37385143"
"JH378109","4354725","4354860","chr9","65878775","65878915","27","61524050"
"JH378109","5358048","5358237","chr4","50510683","50510871","36","45152635"
"JH378109","6559776","6559974","chr23","48995816","48996012","48","42436040"
"JH378109","6836300","6836589","chr16","33551674","33551968","43","26715374"
"JH378109","7304918","7305220","chr20","7876234","7876541","45","571316"
"JH378109","8113032","8113326","chr11","22874498","22874787","50","14761466"
"JH378109","8749029","8749327","chr11","19714655","19714953","42","10965626"
"JH378109","9630391","9630675","chr20","101676702","101676992","40","92046311"
"JH378109","9674435","9674731","chr4","74707922","74708225","40","65033487"
"JH378109","9927817","9927902","chr7","27620515","27620606","32","17692698"
"JH378109","11163735","11164041","chr15","2000778","2001083","42","9162957"
"JH378109","11416456","11416767","chr11","53164231","53164531","57","41747775"
"JH378109","12018090","12018393","chr16","33471388","33471690","40","21453298"
"JH378109","12114773","12115073","chr26","18794536","18794836","50","6679763"
"JH378109","12366199","12366502","chr12","18148903","18149203","45","5782704"
"JH378109","12452361","12452593","chr20","104477833","104478070","42","92025472"
"JH378109","13996699","13997008","chrX","40429653","40429961","39","26432954"
"JH378109","14073564","14073872","chr25","27994473","27994768","53","13920909"
"JH378109","14588297","14588475","chr9","34571025","34571210","48","19982728"
"JH378109","14941360","14941641","chr14","75250425","75250685","54","60309065"
"JH378109","15478080","15478365","chr3","6022508","6022797","48","9455572"
"JH378109","16069603","16069908","chr6","32749709","32750008","43","16680106"
"JH378109","16446005","16446282","chr3","18929139","18929429","48","2483134"
"JH378109","17222842","17223140","chrX","29670774","29671076","43","12447932"
"JH378109","17441255","17441567","chr2","61035797","61036096","51","43594542"
"JH378109","17567713","17567997","chr17","29306106","29306387","55","11738393"
"JH378109","19345246","19345524","chr16","17103242","17103520","43","2242004"
"JH378109","19947041","19947143","chr21","103512848","103512947","15","83565807"
"JH378109","20732477","20732751","chr11","4332732","4332996","41","16399745"
"JH378109","20992139","20992341","chr10","50250809","50251017","33","29258670"
"JH378109","22104007","22104153","chr8","124933735","124933890","33","102829728"
"JH378109","22117167","22117457","chr9","85636273","85636563","40","63519106"
"JH378109","22642306","22642581","chr6","4289783","4290054","51","18352523"
"JH378109","23022859","23023153","chr6","32749709","32750008","42","9726850"
"JH378109","23301674","23301975","chr12","25030968","25031277","45","1729294"
"JH378109","23448623","23448894","chr19","4180398","4180669","63","19268225"
"JH378109","24242488","24242796","chr16","52166373","52166679","39","27923885"
"JH378109","25145562","25145847","chr1","114482348","114482630","44","89336786"
"JH378109","26104590","26104882","chr12","103186024","103186315","57","77081434"
"JH378109","26178476","26178730","chr12","32039026","32039282","38","5860550"
"JH378109","26363778","26364067","chr9","86584742","86585030","43","60220964"
"JH378109","26369944","26370236","chr24","51521386","51521673","51","25151442"
"JH378109","26388129","26388280","chr22","27074075","27074227","27","685946"
"JH378109","27771378","27771687","chr10","44221705","44222014","42","16450327"
"JH378109","28085874","28086183","chr8","20072572","20072880","38","8013302"
"JH378109","28179027","28179330","chr16","30260040","30260349","57","2081013"
"JH378109","28960187","28960479","chr19","27584635","27584934","40","1375552"
"JH378109","29089420","29089681","chr9","18313882","18314160","51","10775538"
"JH378109","29504291","29504591","chr23","49548546","49548845","56","20044255"
"JH378109","29802507","29802617","chr20","80015270","80015379","14","50212763"
"JH378109","29841253","29841541","chr18","48953277","48953567","49","19112024"
"JH378109","30221227","30221539","chr22","14725489","14725798","42","15495738"
"JH378109","30452677","30452905","chr9","57732450","57732667","48","27279773"
"JH378109","30619687","30619992","chr23","57612824","57613126","48","26993137"
"JH378109","30723275","30723566","chr28","8917006","8917294","56","21806269"
"JH378109","30894689","30894963","chr2","71646286","71646551","55","40751597"
"JH378109","31056687","31057000","chr1","32220138","32220445","55","1163451"
"JH378109","31215422","31215537","chr1","39576787","39576899","17","8361365"
"JH378109","31376195","31376438","chr10","39409876","39410151","60","8033681"
"JH378109","31460775","31461065","chr15","4518124","4518415","35","26942651"
"JH378109","33042154","33042457","chr14","63605219","63605526","36","30563065"
"JH378109","33177469","33177751","chrX","29558025","29558318","47","3619444"
"JH378109","33289593","33289874","chr11","42101160","42101440","37","8811567"
"JH378109","33352326","33352452","chr4","74247685","74247799","30","40895359"
"JH378109","33743373","33743672","chr2","61035797","61036096","35","27292424"
"JH378109","33828991","33829241","chr27","34512765","34513037","63","683774"
"JH378109","33983285","33983389","chr1","19184037","19184145","24","14799248"
"JH378109","34676871","34677084","chr19","12992619","12992824","42","21684252"
"JH378109","34726794","34727052","chr20","111949525","111949783","49","77222731"
"JH378109","35457315","35457461","chr22","27074075","27074227","38","8383240"
"JH378109","35604105","35604380","chr11","9923400","9923670","50","25680705"
"JH378109","35746279","35746580","chr1","36079803","36080100","39","333524"
"JH378109","36587379","36587663","chr26","48811822","48812111","37","12224443"
"JH378109","37131296","37131599","chr8","22789986","22790291","44","14341310"
"JH378109","39813317","39813618","chr7","49482276","49482577","49","9668959"
"JH378109","40139079","40139369","chr12","41367876","41368167","42","1228797"
"JH378109","40480017","40480288","chr5","25044505","25044772","45","15435512"
"JH378109","41198217","41198518","chr20","7876234","7876541","39","33321983"
"JH378109","41897403","41897678","chr8","88728726","88729002","46","46831323"
"JH378109","44026325","44026644","chr12","41019638","41019945","50","3006687"
"JH378109","44263701","44263999","chr24","27110583","27110876","66","17153118"
"JH378109","46203547","46203843","chr26","26868700","26868994","44","19334847"
"JH378109","47602024","47602308","chr8","40644845","40645130","55","6957179"
"JH378109","48847030","48847159","chr8","120450677","120450792","31","71603647"
"JH378109","48847307","48847370","chr5","48794817","48794876","10","52490"
"JH378109","48962064","48962213","chr14","63352153","63352302","20","14390089"
"JH378109","49061980","49062261","chr12","78722890","78723173","43","29660910"
"JH378109","49100726","49101004","chr3","76758914","76759196","46","27658188"
"JH378109","49145065","49145346","chrX","6571847","6572139","56","42573218"
"JH378109","49682267","49682460","chr21","18967230","18967419","46","30715037"
"JH378109","50317859","50318168","chr5","14198316","14198616","47","36119543"
"JH378109","50354677","50354952","chr20","9842411","9842688","33","40512266"
"JH378109","50649192","50649484","chrX","29558025","29558318","45","21091167"
"JH378110","19660636","19660915","chr2","36039113","36039395","53","16378477"
"JH378110","200435","200725","chr4","61125414","61125714","71","60924979"
"JH378110","501421","501701","chr23","74492423","74492703","47","73991002"
"JH378110","1353084","1353342","chr6","18761743","18761979","59","17408659"
"JH378110","2474967","2475249","chr1","120558770","120559064","48","118083803"
"JH378110","3166437","3166608","chr4","66826794","66826969","31","63660357"
"JH378110","4045580","4045857","chr28","10446409","10446678","48","6400829"
"JH378110","4242743","4243043","chr12","97392320","97392622","48","93149577"
"JH378110","4516077","4516288","chr5","4207569","4207789","39","308508"
"JH378110","4931175","4931459","chr5","3873106","3873396","41","1058069"
"JH378110","5117817","5118106","chr11","42708500","42708788","33","37590683"
"JH378110","6195640","6195924","chr12","10348016","10348298","41","4152376"
"JH378110","6518327","6518614","chr13","86323276","86323561","36","79804949"
"JH378110","6936704","6936872","chrX","100082116","100082286","49","93145412"
"JH378110","7262790","7263091","chr14","13154936","13155232","49","5892146"
"JH378110","7592124","7592406","chr28","15327544","15327835","42","7735420"
"JH378110","7618220","7618532","chr8","21110357","21110668","54","13492137"
"JH378110","8156973","8157265","chrX","29558025","29558318","44","21401052"
"JH378110","8191938","8192062","chr2","4976621","4976741","21","3215317"
"JH378110","8271121","8271350","chr17","20179990","20180235","53","11908869"
"JH378110","8290842","8291133","chr11","46870539","46870831","48","38579697"
"JH378110","8767867","8768160","chr12","45962018","45962309","38","37194151"
"JH378110","8874070","8874379","chr10","88288814","88289117","47","79414744"
"JH378110","9340061","9340335","chr9","18313882","18314160","50","8973821"
"JH378110","10437037","10437322","chr16","42347539","42347818","45","31910502"
"JH378110","11996761","11997068","chr6","18852331","18852633","36","6855570"
"JH378110","12071967","12072271","chr2","61035797","61036096","44","48963830"
"JH378110","12542897","12543190","chr2","57324560","57324855","43","44781663"
"JH378110","12547151","12547245","chr10","82963214","82963322","31","70416063"
"JH378110","12558178","12558405","chr7","57513437","57513664","42","44955259"
"JH378110","13001886","13002134","chr1","8731653","8731900","48","4270233"
"JH378110","13317133","13317438","chr1","36079803","36080100","55","22762670"
"JH378110","13727098","13727163","chr1","110773079","110773145","13","97045981"
"JH378110","13764596","13764766","chr11","12136411","12136592","36","1628185"
"JH378110","14097911","14098172","chr6","10963028","10963286","41","3134883"
"JH378110","15398621","15398914","chr4","65360239","65360531","41","49961618"
"JH378110","15715220","15715500","chr15","91094478","91094763","44","75379258"
"JH378110","16325433","16325699","chr7","118981728","118981994","42","102656295"
"JH378110","16358445","16358631","chr21","18967230","18967419","32","2608785"
"JH378110","16783518","16783793","chr14","953562","953838","52","15829956"
"JH378110","17066406","17066593","chr6","8728657","8728838","30","8337749"
"JH378110","17946707","17947015","chrX","61756996","61757299","46","43810289"
"JH378110","17964356","17964661","chrX","78779381","78779687","47","60815025"
"JH378110","18536794","18536950","chr7","118654776","118654934","33","100117982"
"JH378110","18584284","18584584","chr3","46170082","46170384","46","27585798"
"JH378110","18964323","18964625","chr1","80729590","80729904","64","61765267"
"JH378110","20398100","20398379","chr25","23334126","23334409","49","2936026"
"JH378110","20979825","20980136","chr1","7743906","7744215","59","13235919"
"JH378110","21461438","21461718","chr9","99714018","99714298","41","78252580"
"JH378110","22138329","22138649","chr15","30822586","30822904","57","8684257"
"JH378110","22154108","22154389","chr4","19815227","19815505","39","2338881"
"JH378110","22304888","22305199","chrX","51256568","51256876","51","28951680"
"JH378110","25915907","25916215","chr2","17881225","17881532","45","8034682"
"JH378110","26750028","26750301","chr11","29396564","29396830","56","2646536"
"JH378110","26905034","26905310","chr12","83448937","83449207","51","56543903"
"JH378110","27502043","27502330","chr9","39487572","39487853","41","11985529"
"JH378110","28410957","28411252","chr24","78152668","78152967","47","49741711"
"JH378110","28526386","28526686","chr4","31811484","31811787","48","3285098"
"JH378110","28576968","28577264","chr4","16716893","16717190","38","11860075"
"JH378110","28770970","28771263","chr13","57139627","57139918","37","28368657"
"JH378110","29451923","29452205","chr15","1318494","1318783","56","28133429"
"JH378110","29467614","29467909","chr16","33551674","33551968","42","4084060"
"JH378110","29627987","29628217","chr18","9905435","9905663","38","19722552"
"JH378110","29628393","29628686","chr1","9360845","9361141","43","20267548"
"JH378110","29633122","29633418","chr1","9360845","9361141","42","20272277"
"JH378110","29759457","29759746","chr22","13908203","13908488","55","15851254"
"JH378110","29792004","29792226","chr20","104185965","104186185","36","74393961"
"JH378110","30010762","30011052","chr1","67566937","67567228","37","37556175"
"JH378110","30088463","30088762","chr7","69846926","69847219","54","39758463"
"JH378110","30175350","30175441","chr19","23677129","23677223","24","6498221"
"JH378110","30207425","30207705","chr25","27172863","27173143","59","3034562"
"JH378110","30279939","30280219","chr8","51467183","51467461","41","21187244"
"JH378110","30467487","30467687","chr26","42306145","42306344","36","11838658"
"JH378110","30605544","30605832","chr6","3974552","3974843","45","26630992"
"JH378110","31242912","31243198","chr4","74750244","74750542","46","43507332"
"JH378110","31886186","31886464","chr6","26593661","26593944","39","5292525"
"JH378110","32366187","32366488","chr24","10677968","10678270","36","21688219"
"JH378110","32846083","32846396","chr23","78084416","78084726","43","45238333"
"JH378110","32850411","32850701","chr12","30449003","30449293","33","2401408"
"JH378110","32960714","32961016","chr1","29621888","29622188","43","3338826"
"JH378110","33439893","33440191","chr1","29712863","29713163","42","3727030"
"JH378110","33570344","33570616","chr15","4986082","4986355","43","28584262"
"JH378110","33937639","33937840","chr7","26338472","26338675","28","7599167"
"JH378110","33978073","33978296","chr7","57513437","57513664","39","23535364"
"JH378110","34807646","34807940","chr18","34852642","34852922","49","44996"
"JH378110","34865273","34865573","chr4","74750244","74750542","45","39884971"
"JH378110","34898883","34899092","chr24","47558800","47559017","38","12659917"
"JH378110","34932248","34932508","chr9","119241694","119241960","47","84309446"
"JH378110","34959580","34959756","chr20","73921736","73921930","56","38962156"
"JH378110","35170982","35171097","chr26","11126640","11126755","16","24044342"
"JH378110","35177249","35177575","chr1","117467462","117467775","69","82290213"
"JH378110","35207170","35207299","chr24","65904734","65904875","32","30697564"
"JH378110","35306191","35306454","chr9","99714018","99714298","49","64407827"
"JH378110","35563295","35563602","chr28","16439912","16440215","52","19123383"
"JH378110","35671182","35671479","chr8","127413553","127413847","45","91742371"
"JH378110","36124990","36125291","chr9","61932207","61932503","34","25807217"
"JH378110","36313368","36313611","chr4","65263107","65263348","38","28949739"
"JH378110","36382930","36383224","chr11","95498272","95498559","52","59115342"
"JH378110","36843129","36843348","chr25","14371016","14371245","53","22472113"
"JH378110","37040829","37041100","chr11","62921553","62921824","37","25880724"
"JH378110","37537604","37537907","chr26","17176341","17176638","50","20361263"
"JH378110","37710973","37711233","chr18","33547985","33548248","54","4162988"
"JH378110","37747484","37747763","chr28","12107555","12107843","55","25639929"
"JH378110","37815894","37816202","chr8","20072572","20072880","43","17743322"
"JH378110","37896139","37896433","chr28","15327544","15327835","40","22568595"
"JH378110","38954017","38954331","chrX","38292909","38293216","50","661108"
"JH378110","39269972","39270280","chr10","88288814","88289117","47","49018842"
"JH378110","39414144","39414272","chrX_KE148108v1_random","1007292","1007414","26","38406852"
"JH378110","39442803","39443111","chr21","47096414","47096720","48","7653611"
"JH378110","39453652","39453951","chr3","26133895","26134193","32","13319757"
"JH378110","39769473","39769703","chr20","43886824","43887060","33","4117351"
"JH378110","39978392","39978694","chr3","76855982","76856288","44","36877590"
"JH378110","40130041","40130320","chr2","72579806","72580084","46","32449765"
"JH378110","40438032","40438330","chr13","63945970","63946266","39","23507938"
"JH378110","43095866","43096113","chr1","112610540","112610791","44","69514674"
"JH378110","43301452","43301672","chr12","108518404","108518625","33","65216952"
"JH378110","44240052","44240361","chr20","7876234","7876541","54","36363818"
"JH378110","44620212","44620491","chr12","83139546","83139821","41","38519334"
"JH378110","44914749","44915027","chr20","120203418","120203695","60","75288669"
"JH378110","45069431","45069717","chr12","43161561","43161851","45","1907870"
"JH378110","47308806","47308990","chr6","45412468","45412650","44","1896338"
"JH378110","47974076","47974415","chr20","99741211","99741546","55","51767135"
"JH378110","48912636","48912945","chr16","65798303","65798603","48","16885667"
"JH378111","648029","648320","chr19","27584635","27584934","50","26936606"
"JH378111","1307848","1308149","chr27","32681295","32681602","50","31373447"
"JH378111","1318753","1319052","chr3","88057816","88058114","39","86739063"
"JH378111","2803557","2803834","chr7","29422863","29423146","45","26619306"
"JH378111","2810233","2810418","chr16","74527352","74527538","39","71717119"
"JH378111","3101901","3102200","chr17","38569856","38570151","56","35467955"
"JH378111","4229264","4229492","chr11","7774263","7774487","41","3544999"
"JH378111","5406601","5406783","chr12","43957933","43958104","38","38551332"
"JH378111","5460926","5461119","chr9","53409532","53409725","26","47948606"
"JH378111","5513969","5514265","chr21","77273281","77273577","40","71759312"
"JH378111","7044366","7044673","chr24","10677968","10678270","44","3633602"
"JH378111","7056194","7056480","chr3","7226127","7226416","46","169933"
"JH378111","7537466","7537724","chr18","44693649","44693911","41","37156183"
"JH378111","7537727","7537772","chr6","45751608","45751639","18","38213881"
"JH378111","7597488","7597778","chr10","85456712","85457001","47","77859224"
"JH378111","7617460","7617759","chr1","8696866","8697165","46","1079406"
"JH378111","7782425","7782698","chr11","42708500","42708788","47","34926075"
"JH378111","7882415","7882529","chr2","12031294","12031409","23","4148879"
"JH378111","8032605","8032910","chr22","65760377","65760684","41","57727772"
"JH378111","8273314","8273538","chr20","73604908","73605140","39","65331594"
"JH378111","9036807","9037115","chr26","9484061","9484366","41","447254"
"JH378111","9129596","9129888","chr18","48953277","48953567","37","39823681"
"JH378111","9984145","9984422","chr26","4458411","4458686","58","5525734"
"JH378111","10002284","10002369","chr25","39143607","39143687","21","29141323"
"JH378111","10055731","10055895","chr19","20956765","20956929","37","10901034"
"JH378111","10276798","10277100","chrX","10891227","10891532","41","614429"
"JH378111","10402325","10402624","chr23","3797499","3797794","43","6604826"
"JH378111","10659069","10659346","chr29","22945616","22945895","50","12286547"
"JH378111","11111446","11111548","chr11","3146472","3146575","30","7964974"
"JH378111","11192712","11193004","chr16","24824595","24824890","42","13631883"
"JH378111","11440513","11440787","chr11","42101160","42101440","42","30660647"
"JH378111","11552038","11552316","chr3","4648816","4649103","50","6903222"
"JH378111","11569938","11570049","chr6","33618456","33618572","19","22048518"
"JH378111","12190471","12190738","chrX_KE148109v1_random","382438","382717","52","11808033"
"JH378111","13078485","13078601","chr26","11126640","11126755","16","1951845"
"JH378111","13712741","13713041","chr16","61356844","61357143","45","47644103"
"JH378111","15659386","15659666","chr12","10348016","10348298","37","5311370"
"JH378111","16010747","16010840","chr25","39143607","39143687","25","23132860"
"JH378111","16054590","16054774","chr5","13172968","13173157","39","2881622"
"JH378111","16080229","16080310","chr15","51574719","51574807","25","35494490"
"JH378111","16081087","16081221","chr5","2033212","2033345","20","14047875"
"JH378111","16433410","16433597","chr9","56425008","56425194","31","39991598"
"JH378111","16433698","16433780","chr20","25260925","25260981","34","8827227"
"JH378111","16441564","16441854","chr28","9769851","9770153","71","6671713"
"JH378111","16572446","16572722","chr18","44016665","44016956","46","27444219"
"JH378111","16637901","16638194","chr21","108956483","108956786","53","92318582"
"JH378111","16722241","16722455","chr14","51479355","51479569","39","34757114"
"JH378111","17771199","17771502","chr11","9736123","9736423","39","8035076"
"JH378111","17890385","17890677","chr3","7226127","7226416","50","10664258"
"JH378111","18016886","18017188","chr1","29712863","29713163","46","11695977"
"JH378111","18252467","18252774","chr17","42200797","42201101","41","23948330"
"JH378111","18254848","18255147","chr1","29294849","29295125","78","11040001"
"JH378111","18487194","18487317","chr10","110800532","110800647","21","92313338"
"JH378111","19091630","19091926","chr2","14848640","14848936","54","4242990"
"JH378111","19141876","19142118","chrX","90939813","90940045","42","71797937"
"JH378111","19298647","19298898","chr8","122465744","122465992","59","103167097"
"JH378111","19625806","19626111","chrX","111147394","111147703","59","91521588"
"JH378111","19741469","19741742","chr8","40231397","40231673","55","20489928"
"JH378111","19814733","19814863","chr10","113050222","113050344","22","93235489"
"JH378111","19985478","19985782","chr19","22626676","22626983","50","2641198"
"JH378111","20123786","20124049","chr13","86323276","86323561","48","66199490"
"JH378111","20566118","20566413","chr11","83560875","83561170","35","62994757"
"JH378111","20788102","20788318","chr10_KE148023v1_random","388267","388479","39","20399835"
"JH378111","20874334","20874647","chr11","116558393","116558699","55","95684059"
"JH378111","21580200","21580328","chr13","93936933","93937062","23","72356733"
"JH378111","21807640","21807738","chr10","56449279","56449356","37","34641639"
"JH378111","21807924","21807986","chr5","2445602","2445676","17","19362322"
"JH378111","23064864","23065118","chr6","25120427","25120677","56","2055563"
"JH378111","25403857","25404152","chr12","30449003","30449293","44","5045146"
"JH378111","25482244","25482535","chr5","61098134","61098429","40","35615890"
"JH378111","25499816","25500000","chr6","40853681","40853861","36","15353865"
"JH378111","25503645","25503905","chr13","20142235","20142496","36","5361410"
"JH378111","26089436","26089596","chr11","111794464","111794630","44","85705028"
"JH378111","26466236","26466535","chr17","38569856","38570151","46","12103620"
"JH378111","26969095","26969388","chr9","38837074","38837370","52","11867979"
"JH378111","27161677","27161729","chr6","7321959","7322011","9","19839718"
"JH378111","27966647","27966926","chr21","108593430","108593710","40","80626783"
"JH378111","28070014","28070288","chr1","8790492","8790780","47","19279522"
"JH378111","29118167","29118462","chr15","57645136","57645424","49","28526969"
"JH378111","30919477","30919774","chr10","104330612","104330907","42","73411135"
"JH378111","31419932","31420229","chr10","75740191","75740486","48","44320259"
"JH378111","32061627","32061941","chr10","39012436","39012740","56","6950809"
"JH378111","32604407","32604499","chr10","88746594","88746679","24","56142187"
"JH378111","32605296","32605576","chr2","7721210","7721494","41","24884086"
"JH378111","32934133","32934456","chr15","90715776","90716082","54","57781643"
"JH378111","33162417","33162718","chr18","3239806","3240108","40","29922611"
"JH378111","33368177","33368479","chr9","44890494","44890803","53","11522317"
"JH378111","33537848","33538135","chr10","106138132","106138427","50","72600284"
"JH378111","34046401","34046689","chr8","54639056","54639335","48","20592655"
"JH378111","34098314","34098600","chr6","15375419","15375710","50","18722895"
"JH378111","34570968","34571265","chr4","73839786","73840081","46","39268818"
"JH378111","34863325","34863643","chr6","47032560","47032866","67","12169235"
"JH378111","35104027","35104328","chr8","41018649","41018955","39","5914622"
"JH378111","35106238","35106514","chr16","17103242","17103520","55","18002996"
"JH378111","35297419","35297715","chr3","19437037","19437326","42","15860382"
"JH378111","36118424","36118704","chrX","121197060","121197345","39","85078636"
"JH378111","36950014","36950300","chr2","6803049","6803335","51","30146965"
"JH378111","37696379","37696488","chr9","67639808","67639920","30","29943429"
"JH378111","37700909","37701202","chrX","44238718","44239009","50","6537809"
"JH378111","39777996","39778298","chr20","105708807","105709105","53","65930811"
"JH378111","40657081","40657381","chrX","23470949","23471243","38","17186132"
"JH378111","41104332","41104611","chr16","24824595","24824890","47","16279737"
"JH378111","41930926","41931113","chr5","19938843","19939015","34","21992083"
"JH378111","41954756","41955056","chr16","57335675","57335985","50","15380919"
"JH378111","42322515","42322751","chr20","107997025","107997264","41","65674510"
"JH378111","42351779","42351918","chr7","21071333","21071472","15","21280446"
"JH378111","42404792","42404877","chr1","32855214","32855299","17","9549578"
"JH378111","42405016","42405233","chrX","124509631","124509844","32","82104615"
"JH378111","42598911","42599219","chrX","60057029","60057325","44","17458118"
"JH378111","43718822","43719116","chr10","104330612","104330907","35","60611790"
"JH378111","45128406","45128694","chr10","94012577","94012864","39","48884171"
"JH378111","45169008","45169295","chr7","91843770","91844065","39","46674762"
"JH378111","45220433","45220611","chr14","52418990","52419165","37","7198557"
"JH378111","45371629","45371928","chr17","40106599","40106905","59","5265030"
"JH378111","45813667","45813956","chr14","75159045","75159335","55","29345378"
"JH378111","45864612","45864901","chr16","17103242","17103520","75","28761370"
"JH378111","45921557","45921866","chr2","14953819","14954119","54","30967738"
"JH378112","1757603","1757899","chr9","22687772","22688068","36","20930169"
"JH378112","3278661","3278979","chr2","71625140","71625445","53","68346479"
"JH378112","3396484","3396789","chr18","63833457","63833758","47","60436973"
"JH378112","5419150","5419453","chr2","61035797","61036096","42","55616647"
"JH378112","5523868","5524156","chr8","115294220","115294508","40","109770352"
"JH378112","5743613","5743836","chr9","86755766","86756000","45","81012153"
"JH378112","7288000","7288281","chr2","12062172","12062451","64","4774172"
"JH378112","9308372","9308659","chr1","57899913","57900199","42","48591541"
"JH378112","9420621","9420915","chr16","24824595","24824890","40","15403974"
"JH378112","11287292","11287350","chr5","48794817","48794876","7","37507525"
"JH378112","11313675","11313964","chr12","18705494","18705782","44","7391819"
"JH378112","11368430","11368645","chr23","42922019","42922224","40","31553589"
"JH378112","11746880","11747099","chr2","52457627","52457845","36","40710747"
"JH378112","12004071","12004376","chr11","47411625","47411934","47","35407554"
"JH378112","13098794","13099097","chr15","2000778","2001083","49","11098016"
"JH378112","14235267","14235576","chr9","119761241","119761543","55","105525974"
"JH378112","14323665","14323977","chr1","125024996","125025302","59","110701331"
"JH378112","15559449","15559754","chr4","74750244","74750542","50","59190795"
"JH378112","16156265","16156378","chr6","29480212","29480322","20","13323947"
"JH378112","16282831","16283082","chr2","87954053","87954315","54","71671222"
"JH378112","16483958","16484265","chrX","61756996","61757299","42","45273038"
"JH378112","17736588","17736888","chr1","57993153","57993457","33","40256565"
"JH378112","18896664","18896927","chr14","74080496","74080760","32","55183832"
"JH378112","19238404","19238684","chr7","75281084","75281363","55","56042680"
"JH378112","19638985","19639199","chr8","120238157","120238376","28","100599172"
"JH378112","19777947","19778242","chr3","18929139","18929429","54","848808"
"JH378112","19901820","19902109","chr11","42708500","42708788","38","22806680"
"JH378112","20051091","20051374","chrX","25445320","25445602","45","5394229"
"JH378112","20320464","20320766","chr5","75158813","75159122","45","54838349"
"JH378112","20580742","20581047","chr12","41019638","41019945","48","20438896"
"JH378112","20662275","20662521","chr1","2272506","2272749","54","18389769"
"JH378112","20972673","20972977","chr1","125024996","125025302","47","104052323"
"JH378112","21215200","21215475","chr1","56961737","56962012","43","35746537"
"JH378112","21500919","21501223","chr4","74750244","74750542","47","53249325"
"JH378112","21647187","21647494","chr13","34539616","34539925","46","12892429"
"JH378112","22134387","22134698","chr12","72899340","72899646","45","50764953"
"JH378112","22519194","22519317","chr5","8452769","8452882","31","14066425"
"JH378112","22899319","22899628","chr11","116558393","116558699","41","93659074"
"JH378112","23952460","23952760","chr17","39027745","39028045","56","15075285"
"JH378112","24660233","24660513","chr13","64951567","64951860","49","40291334"
"JH378112","25038540","25038847","chr2","54312462","54312771","47","29273922"
"JH378112","25267031","25267333","chr1","36079803","36080100","49","10812772"
"JH378112","26045059","26045162","chr10","2090892","2091004","28","23954167"
"JH378112","26133925","26134141","chr10","70414517","70414733","42","44280592"
"JH378112","27062310","27062619","chr20","113381135","113381444","46","86318825"
"JH378112","27991081","27991355","chrX","78367633","78367906","60","50376552"
"JH378112","30538132","30538425","chr3","20463117","20463410","44","10075015"
"JH378112","30791512","30791812","chr6","36288281","36288590","60","5496769"
"JH378112","31213010","31213255","chrX","28441716","28441974","59","2771294"
"JH378112","31220633","31220898","chr14","61597585","61597855","42","30376952"
"JH378112","31238918","31239200","chr13","86323276","86323561","49","55084358"
"JH378112","32331682","32331979","chr4","65360239","65360531","35","33028557"
"JH378112","32511232","32511534","chrX","47726776","47727071","48","15215544"
"JH378112","32518557","32518859","chrX","47726776","47727071","48","15208219"
"JH378112","32532221","32532531","chr10","122812616","122812920","48","90280395"
"JH378112","32735339","32735464","chr6","33578769","33578895","25","843430"
"JH378112","33119493","33119784","chr1","36079803","36080100","41","2960310"
"JH378112","33372908","33373088","chr17","36613783","36613962","27","3240875"
"JH378112","33505043","33505328","chr1","108300659","108300949","61","74795616"
"JH378112","33564266","33564426","chr16","70459044","70459205","23","36894778"
"JH378112","34076628","34076825","chr21","3476256","3476448","39","30600372"
"JH378112","34249992","34250284","chr23","38922269","38922564","38","4672277"
"JH378112","34681985","34682212","chr4","39404751","39404989","49","4722766"
"JH378112","34959634","34959767","chrX","114563807","114563945","22","79604173"
"JH378112","35086206","35086487","chr18","48953277","48953567","60","13867071"
"JH378112","35184294","35184592","chr4","74750244","74750542","35","39565950"
"JH378112","36056885","36057186","chr13","13879559","13879858","59","22177326"
"JH378112","36617601","36617932","chr5","8592767","8593093","68","28024834"
"JH378112","36853381","36853651","chr14","45592971","45593246","45","8739590"
"JH378112","37104218","37104496","chr20","13058406","13058680","58","24045812"
"JH378112","37404677","37404964","chr8","76684830","76685120","42","39280153"
"JH378112","38014222","38014296","chr5","34199615","34199685","24","3814607"
"JH378112","39126236","39126541","chr17","31068189","31068485","48","8058047"
"JH378112","40352678","40352938","chr14","1152102","1152358","72","39200576"
"JH378112","40507130","40507415","chr13","34406931","34407219","58","6100199"
"JH378112","41550455","41550746","chr4","65360239","65360531","38","23809784"
"JH378112","41719967","41720267","chr6","10613040","10613338","53","31106927"
"JH378112","41724818","41725107","chr10","104330612","104330907","49","62605794"
"JH378112","42274567","42274861","chr14","68489088","68489386","49","26214521"
"JH378112","42321018","42321317","chr9","86699927","86700224","39","44378909"
"JH378112","44911572","44911847","chr26","11209053","11209344","46","33702519"
"JH378112","45272809","45273098","chr10","113971484","113971784","65","68698675"
"JH378112","45309846","45309909","chr6","7321959","7322011","29","37987887"
"JH378112","45309912","45309936","chr5","2445257","2445270","13","42864655"
"JH378112","45309984","45310019","chr7","19053592","19053622","9","26256392"
"JH378112","45312775","45313067","chr11","93726594","93726883","45","48413819"
"JH378113","479385","479666","chr1","114482348","114482630","49","114002963"
"JH378113","1847030","1847352","chr12","41019638","41019945","38","39172608"
"JH378113","2230181","2230468","chr6","6607557","6607844","49","4377376"
"JH378113","2322886","2323154","chr11","31189578","31189838","57","28866692"
"JH378113","2336401","2336694","chr20","2854395","2854680","49","517994"
"JH378113","2441472","2441730","chr7","116216737","116217000","70","113775265"
"JH378113","2465261","2465533","chr1","83241401","83241681","46","80776140"
"JH378113","3066094","3066372","chr15","63096897","63097174","60","60030803"
"JH378113","3884198","3884408","chr14","74021868","74022082","41","70137670"
"JH378113","3980535","3980825","chr5","53126639","53126932","40","49146104"
"JH378113","4266832","4267140","chr26","37658547","37658856","38","33391715"
"JH378113","4289521","4289831","chr3","10998901","10999200","46","6709380"
"JH378113","4495815","4495948","chr2","70699454","70699583","26","66203639"
"JH378113","4845049","4845413","chr1","17768407","17768750","98","12923358"
"JH378113","5715632","5715911","chr22","13908203","13908488","53","8192571"
"JH378113","5757605","5757908","chr7","24551837","24552140","37","18794232"
"JH378113","6134477","6134765","chr6","45915188","45915480","49","39780711"
"JH378113","6395706","6395977","chr13","57700238","57700522","43","51304532"
"JH378113","9378434","9378741","chr20","7876234","7876541","44","1502200"
"JH378113","10696168","10696484","chr12","25030968","25031277","52","14334800"
"JH378113","11469222","11469520","chrX","43777377","43777676","43","32308155"
"JH378113","11598061","11598361","chrX","60403420","60403723","48","48805359"
"JH378113","13782423","13782727","chr24","10677968","10678270","42","3104455"
"JH378113","14853050","14853358","chr1","29712863","29713163","62","14859813"
"JH378113","14888410","14888586","chr6","44727396","44727576","35","29838986"
"JH378113","15412323","15412632","chr20","105708807","105709105","53","90296484"
"JH378113","15991276","15991465","chr7","131233865","131234062","38","115242589"
"JH378113","16303379","16303688","chr14","12038537","12038844","42","4264842"
"JH378113","16673752","16674040","chr9","11828451","11828739","41","4845301"
"JH378113","16703132","16703435","chr16","18257374","18257671","48","1554242"
"JH378113","16794391","16794614","chr16","15121498","15121716","45","1672893"
"JH378113","16842938","16843227","chr2","12062172","12062451","55","4780766"
"JH378113","16901980","16902282","chr12","72899340","72899646","39","55997360"
"JH378113","16941592","16941893","chrX","43777377","43777676","43","26835785"
"JH378113","17031032","17031157","chrUn_AQIB01158800v1","1","125","27","17031031"
"JH378113","17031253","17031455","chr10","39386554","39386748","41","22355301"
"JH378113","17068548","17068657","chr20","74424969","74425077","17","57356421"
"JH378113","17974428","17974607","chr8","112629520","112629695","33","94655092"
"JH378113","19004894","19005134","chr16","40626399","40626635","63","21621505"
"JH378113","19035592","19035880","chr7","27620996","27621280","50","8585404"
"JH378113","19245718","19245883","chrX","29833617","29833775","37","10587899"
"JH378113","19673802","19674106","chr10","82223974","82224279","38","62550172"
"JH378113","19928991","19929298","chr9","56706151","56706456","44","36777160"
"JH378113","20841239","20841523","chr14","89802144","89802429","59","68960905"
"JH378113","21083822","21084093","chr11","104824667","104824944","60","83740845"
"JH378113","21555028","21555241","chr10","79624934","79625163","60","58069906"
"JH378113","21749232","21749355","chr5","25933140","25933266","23","4183908"
"JH378113","21761296","21761595","chr29","3711047","3711343","47","18050249"
"JH378113","22005780","22005970","chr19","16893479","16893663","36","5112301"
"JH378113","22033435","22033738","chr16","33551674","33551968","42","11518239"
"JH378113","22317793","22318034","chr26","37830957","37831211","53","15513164"
"JH378113","22761984","22762276","chr6","27769176","27769470","51","5007192"
"JH378113","23073540","23073838","chr1","31259486","31259780","35","8185946"
"JH378113","23217576","23217871","chr20","105708807","105709105","53","82491231"
"JH378113","23349349","23349509","chr11","117718811","117718965","33","94369462"
"JH378113","23442319","23442397","chr16","33133637","33133720","19","9691318"
"JH378113","23442448","23442678","chr11","52400982","52401220","38","28958534"
"JH378113","23625208","23625416","chr11","100225388","100225600","33","76600180"
"JH378113","23836289","23836591","chr24","16508354","16508661","44","7327935"
"JH378113","25116998","25117283","chr2","10339052","10339336","50","14777946"
"JH378113","26643432","26643535","chr10","4397964","4398071","27","22245468"
"JH378113","28296625","28296923","chr6","29394044","29394346","37","1097419"
"JH378113","28595797","28596088","chr2","57300310","57300610","44","28704513"
"JH378113","28732230","28732517","chr17","16685119","16685410","41","12047111"
"JH378113","29865571","29865848","chrX","85829317","85829602","55","55963746"
"JH378113","29987686","29987737","chr22","74065325","74065376","8","44077639"
"JH378113","30099401","30099521","chr7","122220159","122220276","28","92120758"
"JH378113","30679378","30679675","chr20","97872595","97872898","50","67193217"
"JH378113","31089078","31089365","chrX","61756996","61757299","61","30667918"
"JH378113","31950888","31951083","chr7","26338472","26338675","37","5612416"
"JH378113","31968967","31969264","chr7","130499463","130499763","46","98530496"
"JH378113","32289459","32289753","chr12","65356809","65357103","42","33067350"
"JH378113","32455099","32455375","chr12","108171343","108171621","46","75716244"
"JH378113","32589584","32589849","chr10","63585093","63585357","54","30995509"
"JH378113","33026584","33026869","chr11","42708500","42708788","36","9681916"
"JH378113","35774697","35774984","chr15","63096897","63097174","47","27322200"
"JH378113","36016586","36016875","chr16","24824595","24824890","43","11191991"
"JH378113","36550254","36550548","chrX","29670774","29671076","54","6879480"
"JH378113","36961557","36961838","chr14","97755318","97755609","42","60793761"
"JH378113","37555689","37556002","chr3","81970581","81970881","47","44414892"
"JH378113","37751829","37752054","chr9","86755766","86756000","43","49003937"
"JH378113","37756338","37756514","chr8","112629520","112629695","31","74873182"
"JH378113","38734960","38735104","chr13","93936933","93937062","37","55201973"
"JH378113","39464662","39464967","chr26","33717836","33718134","52","5746826"
"JH378113","39588023","39588330","chrX","43777377","43777676","53","4189354"
"JH378113","39917989","39918180","chr20_KE148050v1_random","1166449","1166639","39","38751540"
"JH378113","40710635","40710763","chr4","77908589","77908714","24","37197954"
"JH378113","41491952","41492264","chr16","36007753","36008062","51","5484199"
"JH378113","41879883","41880170","chr21","103650269","103650560","53","61770386"
"JH378113","42153471","42153696","chr16","15121498","15121716","50","27031973"
"JH378113","43113979","43114256","chr2","5238241","5238519","45","37875738"
"JH378113","43541568","43541871","chr28","13645418","13645720","61","29896150"
"JH378114","180450","180744","chr15","81539546","81539843","39","81359096"
"JH378114","1247829","1248143","chr12","104165778","104166085","53","102917949"
"JH378114","1495373","1495648","chr2","44451176","44451458","44","42955803"
"JH378114","1567800","1568096","chr12","62505268","62505568","44","60937468"
"JH378114","3934167","3934466","chr2","42406046","42406352","44","38471879"
"JH378114","4289632","4289919","chr21","76648555","76648837","48","72358923"
"JH378114","5810481","5810778","chr3","29617498","29617804","45","23807017"
"JH378114","6377830","6377918","chr20","27499106","27499181","21","21121276"
"JH378114","6434182","6434485","chr6","20486258","20486561","56","14052076"
"JH378114","6580146","6580435","chr8","76684830","76685120","44","70104684"
"JH378114","6636350","6636641","chr3","24122582","24122878","56","17486232"
"JH378114","6788235","6788514","chr17","1803514","1803790","42","4984721"
"JH378114","7078896","7079204","chr2","22860155","22860456","48","15781259"
"JH378114","7093586","7093713","chr6","12469520","12469644","26","5375934"
"JH378114","8591679","8591964","chr11","75071530","75071805","66","66479851"
"JH378114","8657031","8657327","chr2","80562522","80562815","61","71905491"
"JH378114","9035177","9035477","chr1","20836893","20837193","37","11801716"
"JH378114","10013662","10013953","chr28","15327544","15327835","41","5313882"
"JH378114","10531905","10532202","chr7","11870928","11871220","67","1339023"
"JH378114","10859544","10859852","chr2","16628919","16629201","67","5769375"
"JH378114","10948399","10948665","chrX","126577906","126578182","58","115629507"
"JH378114","11921872","11922154","chrX","42007554","42007848","55","30085682"
"JH378114","12807296","12807339","chr13","82612030","82612077","11","69804734"
"JH378114","14557678","14557982","chr6","32749709","32750008","49","18192031"
"JH378114","14999823","14999999","chr12","43957933","43958104","34","28958110"
"JH378114","16191471","16191766","chr16","58839580","58839876","48","42648109"
"JH378114","16691609","16691909","chr11","31385000","31385296","36","14693391"
"JH378114","16769302","16769606","chr11","112865767","112866066","52","96096465"
"JH378114","19486664","19486969","chr19","15214670","15214974","40","4271994"
"JH378114","19539807","19540107","chr4","74750244","74750542","32","55210437"
"JH378114","19759890","19760021","chrX","38700708","38700847","25","18940818"
"JH378114","19982373","19982677","chr7","115157979","115158272","49","95175606"
"JH378114","20065806","20066075","chr14","61597585","61597855","37","41531779"
"JH378114","20181002","20181259","chr11","65223996","65224264","52","45042994"
"JH378114","20558235","20558419","chrX","37861407","37861589","25","17303172"
"JH378114","20898403","20898695","chr4","74750244","74750542","44","53851841"
"JH378114","20997844","20998154","chrX","10891227","10891532","44","10106617"
"JH378114","21136585","21136877","chr26","11209053","11209344","39","9927532"
"JH378114","22050154","22050436","chrUn_KE147587v1","49075","49361","40","22001079"
"JH378114","22531342","22531630","chr10","75740191","75740486","37","53208849"
"JH378114","22803117","22803401","chr11","24876645","24876927","41","2073528"
"JH378114","23024560","23024857","chr18","35039565","35039862","43","12015005"
"JH378114","23629990","23630086","chr7","38047909","38048019","25","14417919"
"JH378114","24370004","24370243","chr25","70813721","70813962","65","46443717"
"JH378114","24506223","24506527","chr4","31811484","31811787","45","7305261"
"JH378114","24528225","24528337","chr6","35661566","35661675","18","11133341"
"JH378114","24868769","24868941","chr22","74857230","74857409","45","49988461"
"JH378114","25667041","25667314","chr9","96272747","96273028","44","70605706"
"JH378114","25907599","25907900","chr18","57336811","57337111","41","31429212"
"JH378114","26694835","26695145","chr21","47096414","47096720","44","20401579"
"JH378114","26860697","26860960","chr21","108474892","108475142","55","81614195"
"JH378114","27650119","27650287","chr4","66826794","66826969","35","39176675"
"JH378114","27729444","27729745","chr4","31811484","31811787","37","4082040"
"JH378114","28326879","28327092","chr19","12992619","12992824","36","15334260"
"JH378114","29131777","29132070","chr26","50672148","50672443","40","21540371"
"JH378114","29647943","29648205","chrX","118182064","118182317","59","88534121"
"JH378114","29679015","29679306","chr1","113701331","113701623","47","84022316"
"JH378114","30433109","30433400","chr1","9142653","9142941","48","21290456"
"JH378114","31687624","31687908","chr8","17131358","17131640","42","14556266"
"JH378114","32214271","32214602","chr7","24372563","24372858","68","7841708"
"JH378114","33770740","33771004","chr11","4332732","4332996","43","29438008"
"JH378114","36163095","36163380","chr9","58155888","58156167","43","21992793"
"JH378114","36873815","36874124","chr12","23102848","23103154","41","13770967"
"JH378114","37127459","37127739","chr11","83560875","83561170","43","46433416"
"JH378114","37138945","37139234","chr11","102915301","102915590","39","65776356"
"JH378114","37624452","37624761","chr4","10168457","10168762","44","27455995"
"JH378114","38835282","38835568","chr24","42824289","42824580","44","3989007"
"JH378114","38882682","38882961","chr14","83288480","83288767","52","44405798"
"JH378114","39765786","39765947","chr9","32125196","32125331","51","7640590"
"JH378114","40519510","40519806","chr3","4648816","4649103","52","35870694"
"JH378114","41462341","41462374","chr13","82612030","82612077","16","41149689"
"JH378114","41498528","41498820","chr17","22605049","22605342","33","18893479"
"JH378114","41559105","41559262","chrX","29833617","29833775","37","11725488"
"JH378114","41702284","41702594","chr15","2000778","2001083","45","39701506"
"JH378114","42008552","42008815","chr20","120203418","120203695","47","78194866"
"JH378114","42599792","42599908","chr2","87262500","87262610","23","44662708"
"JH378114","42851817","42852122","chr2","61035797","61036096","56","18183980"
"JH378115","3328455","3328755","chr1","79707021","79707313","42","76378566"
"JH378115","3599487","3599781","chr23","38922269","38922564","40","35322782"
"JH378115","3617210","3617506","chr26","18794536","18794836","45","15177326"
"JH378115","3817450","3817721","chr1","29294849","29295125","40","25477399"
"JH378115","3857944","3857994","chr13","7060006","7060057","7","3202062"
"JH378115","4110648","4110943","chr12","45962018","45962309","47","41851370"
"JH378115","4243782","4244085","chr7","91843770","91844065","53","87599988"
"JH378115","4653390","4653662","chr1","29294849","29295125","46","24641459"
"JH378115","7316491","7316784","chrX","6571847","6572139","51","744644"
"JH378115","7670474","7670772","chr18","33422516","33422822","43","25752042"
"JH378115","7845752","7845972","chr16","10795330","10795551","46","2949578"
"JH378115","7862572","7862865","chrX","33027186","33027484","37","25164614"
"JH378115","9151034","9151334","chr9","38837074","38837370","50","29686040"
"JH378115","9607583","9607869","chr12","37660390","37660680","48","28052807"
"JH378115","11371323","11371628","chr2","33362197","33362503","62","21990874"
"JH378115","11403391","11403664","chr18","8947915","8948183","44","2455476"
"JH378115","11732358","11732634","chr3","77559405","77559679","52","65827047"
"JH378115","12546470","12546774","chr21","8921616","8921919","47","3624854"
"JH378115","13047204","13047309","chr2","42519286","42519394","21","29472082"
"JH378115","13047771","13047953","chr5","192637","192820","33","12855134"
"JH378115","13571100","13571355","chr25","78907072","78907333","70","65335972"
"JH378115","14727858","14728024","chr18","62022139","62022304","32","47294281"
"JH378115","15290111","15290239","chr26","11354204","11354323","26","3935907"
"JH378115","15370629","15370953","chr10","85056318","85056623","51","69685689"
"JH378115","17054810","17055105","chr12","64183477","64183775","37","47128667"
"JH378115","17450315","17450601","chr4","74750244","74750542","42","57299929"
"JH378115","17492557","17492805","chr20","107997025","107997264","45","90504468"
"JH378115","18761547","18761831","chr19","1538482","1538767","43","17223065"
"JH378115","19690118","19690297","chr9","107561541","107561712","30","87871423"
"JH378115","19754746","19755059","chr9","41529323","41529631","49","21774577"
"JH378115","19780129","19780323","chr20","73921736","73921930","38","54141607"
"JH378115","19830325","19830611","chr7","55740326","55740609","33","35910001"
"JH378115","19869301","19869569","chr14","44852060","44852332","48","24982759"
"JH378115","20926028","20926152","chr7","106999873","106999998","21","86073845"
"JH378115","21147802","21148101","chr24","26855604","26855893","82","5707802"
"JH378115","21306552","21306857","chr6","48541295","48541599","33","27234743"
"JH378115","21375994","21376248","chr19","13608773","13609025","44","7767221"
"JH378115","21491041","21491261","chr24","47558800","47559017","36","26067759"
"JH378115","21568431","21568729","chr3","30187575","30187872","31","8619144"
"JH378115","21573991","21574253","chr14","75250425","75250685","50","53676434"
"JH378115","21630879","21631183","chr6","32749709","32750008","42","11118830"
"JH378115","21649886","21650069","chrX","25278669","25278849","38","3628783"
"JH378115","21730068","21730106","chrY","1041155","1041191","12","20688913"
"JH378115","21730555","21730636","chr19","20678473","20678556","14","1052082"
"JH378115","21737978","21738230","chr1","50678867","50679117","45","28940889"
"JH378115","22131367","22131479","chr10","2090892","2091004","26","20040475"
"JH378115","22590792","22590891","chr22","94574472","94574572","27","71983680"
"JH378115","22692650","22692950","chr23","39001740","39002032","51","16309090"
"JH378115","22851489","22851794","chr8","102187954","102188258","50","79336465"
"JH378115","23054868","23055075","chr16","34169864","34170075","36","11114996"
"JH378115","23317086","23317338","chr4","65263107","65263348","46","41946021"
"JH378115","23699976","23700256","chr11","24876645","24876927","41","1176669"
"JH378115","23760155","23760384","chr12","108518404","108518625","37","84758249"
"JH378115","24990463","24990759","chr9","61932207","61932503","45","36941744"
"JH378115","25156197","25156500","chrX","18575272","18575575","59","6580925"
"JH378115","25162211","25162502","chr12","65356809","65357103","39","40194598"
"JH378115","25168667","25168957","chr2","33362197","33362503","45","8193530"
"JH378115","25579637","25579928","chr24","51521386","51521673","46","25941749"
"JH378115","25585665","25585875","chr14","74021868","74022082","40","48436203"
"JH378115","25827342","25827636","chr19","14623177","14623470","36","11204165"
"JH378115","26679625","26679914","chrX","10891227","10891532","52","15788398"
"JH378115","26746878","26747158","chr9","105575072","105575353","47","78828194"
"JH378115","27041333","27041520","chr6","40853681","40853861","43","13812348"
"JH378115","27224210","27224503","chr9","29459013","29459303","38","2234803"
"JH378115","28748479","28748706","chr8","120238157","120238376","40","91489678"
"JH378115","29394878","29394932","chr5","23010177","23010233","7","6384701"
"JH378115","29686213","29686540","chr23","78084416","78084726","58","48398203"
"JH378115","30278734","30279025","chr2","23207246","23207530","61","7071488"
"JH378115","30683796","30683965","chr5","69599282","69599452","28","38915486"
"JH378115","30895316","30895588","chr12","72756184","72756452","51","41860868"
"JH378115","31310093","31310404","chr2","11078883","11079185","51","20231210"
"JH378115","31330998","31331300","chr10","104330612","104330907","37","72999614"
"JH378115","31357410","31357701","chrX","29558025","29558318","45","1799385"
"JH378115","31431250","31431546","chrX","42131988","42132277","53","10700738"
"JH378115","31573171","31573468","chr9","32604399","32604698","33","1031228"
"JH378115","31641413","31641711","chr3","26133895","26134193","43","5507518"
"JH378115","31652935","31653243","chr15","2000778","2001083","43","29652157"
"JH378115","31728052","31728281","chr12","83070817","83071048","43","51342765"
"JH378115","31757514","31757805","chr11","42708500","42708788","38","10950986"
"JH378115","31765456","31765746","chr11","60552837","60553124","41","28787381"
"JH378115","31993225","31993377","chr16","53193224","53193368","32","21199999"
"JH378115","32010886","32011192","chr23","78084416","78084726","48","46073530"
"JH378115","32229636","32229924","chr1","8790492","8790780","40","23439144"
"JH378115","32437168","32437477","chr14","61597253","61597561","34","29160085"
"JH378115","32615555","32615844","chr15","58145892","58146179","46","25530337"
"JH378115","32838663","32838956","chr12","41367876","41368167","40","8529213"
"JH378115","33013532","33013833","chr11","112865767","112866066","38","79852235"
"JH378115","33088712","33089011","chr6","35097365","35097661","50","2008653"
"JH378115","33441082","33441371","chr20","42774949","42775237","42","9333867"
"JH378115","34390490","34390775","chr11","42708500","42708788","28","8318010"
"JH378115","34945920","34946160","chr6","28190603","28190847","53","6755317"
"JH378115","35001379","35001685","chr20","105708807","105709105","37","70707428"
"JH378115","35010800","35011115","chr1","117467462","117467775","56","82456662"
"JH378115","35163549","35163842","chr5","38130069","38130369","42","2966520"
"JH378115","35292224","35292516","chr5","55179159","55179451","45","19886935"
"JH378115","35301084","35301374","chr12","10047022","10047316","38","25254062"
"JH378115","35312645","35312928","chr26","52629602","52629887","33","17316957"
"JH378115","35324085","35324380","chr3","6414985","6415283","55","28909100"
"JH378115","35673765","35673815","chr5","23010177","23010233","11","12663588"
"JH378115","35782825","35782933","chr2","87262500","87262610","15","51479675"
"JH378115","35869899","35870189","chr17","4564564","4564857","42","31305335"
"JH378115","35991148","35991431","chr11","42101160","42101440","42","6110012"
"JH378115","36119897","36120101","chr20","87241411","87241591","47","51121514"
"JH378115","36244891","36245150","chr15","57792292","57792548","39","21547401"
"JH378115","37445907","37446203","chr27","9022840","9023138","45","28423067"
"JH378115","41915970","41916257","chr18","44016665","44016956","43","2100695"
"JH378115","42287217","42287499","chr15","63096897","63097174","57","20809680"
"JH378115","42702367","42702592","chr5","5335108","5335336","45","37367259"
"JH378115","42829563","42829848","chr13","86323276","86323561","39","43493713"
"JH378115","43249475","43249770","chr2","22860155","22860456","54","20389320"
"JH378115","43310287","43310558","chr8","62310553","62310826","61","19000266"
"JH378116","114495","114756","chr6","11215683","11215935","55","11101188"
"JH378116","251012","251308","chr16","14482255","14482552","44","14231243"
"JH378116","818959","819066","chr1","19184037","19184145","26","18365078"
"JH378116","2131263","2131548","chr16","9687728","9688011","49","7556465"
"JH378116","2180051","2180342","chr13","23538206","23538505","52","21358155"
"JH378116","2829064","2829319","chr10","127587035","127587285","54","124757971"
"JH378116","2829320","2829365","chr29","10717384","10717425","16","7888064"
"JH378116","2872595","2872885","chr19","4455651","4455943","46","1583056"
"JH378116","3999666","3999956","chr3","19321332","19321620","48","15321666"
"JH378116","5020883","5021089","chr11","100225388","100225600","30","95204505"
"JH378116","6133711","6134009","chr12","88099693","88099989","53","81965982"
"JH378116","6366000","6366300","chr8","114453792","114454090","52","108087792"
"JH378116","7447672","7447953","chr3","76758914","76759196","43","69311242"
"JH378116","7561477","7561784","chr11","47411625","47411934","36","39850148"
"JH378116","7634293","7634596","chr15","2000778","2001083","42","5633515"
"JH378116","8334564","8334832","chr4","90750684","90750957","51","82416120"
"JH378116","8591889","8592188","chr5","10824452","10824759","48","2232563"
"JH378116","9396697","9397003","chrX","61756996","61757299","35","52360299"
"JH378116","10469355","10469556","chr20","89047795","89047990","44","78578440"
"JH378116","11146891","11147182","chr16","70729210","70729502","32","59582319"
"JH378116","11819253","11819549","chr12","41367876","41368167","48","29548623"
"JH378116","12061756","12061952","chr9","53409532","53409725","39","41347776"
"JH378116","13526447","13526640","chr7","132382832","132383026","38","118856385"
"JH378116","13571746","13572031","chr7","97587429","97587716","59","84015683"
"JH378116","13609952","13610237","chr6","26593661","26593944","43","12983709"
"JH378116","15348535","15348833","chrX","45701597","45701901","66","30353062"
"JH378116","16814874","16815148","chr26","27705032","27705304","55","10890158"
"JH378116","17059037","17059332","chr4","16716893","16717190","45","342144"
"JH378116","18270417","18270707","chr18","52888108","52888407","59","34617691"
"JH378116","19651373","19651510","chr11","14145561","14145705","35","5505812"
"JH378116","19675080","19675376","chr3","6781605","6781888","72","12893475"
"JH378116","20039444","20039745","chr10","75740191","75740486","44","55700747"
"JH378116","21559517","21559843","chr10","102332242","102332544","62","80772725"
"JH378116","21581070","21581354","chr11","24876645","24876927","33","3295575"
"JH378116","21630706","21631014","chr27","40239547","40239855","40","18608841"
"JH378116","21683062","21683359","chr3","20463117","20463410","48","1219945"
"JH378116","21763411","21763719","chr26","4574785","4575094","45","17188626"
"JH378116","21891932","21892227","chr24","79892238","79892525","44","58000306"
"JH378116","21980934","21981218","chr24","55921514","55921800","37","33940580"
"JH378116","22099539","22099749","chr20","73921736","73921930","37","51822197"
"JH378116","22247291","22247607","chr12","52562723","52563030","45","30315432"
"JH378116","22645492","22645770","chr9","106946005","106946287","35","84300513"
"JH378116","22716222","22716499","chr17","53582686","53582976","44","30866464"
"JH378116","23039814","23040099","chr19","4180398","4180669","50","18859416"
"JH378116","23049177","23049468","chr11","76273547","76273835","49","53224370"
"JH378116","23391450","23391741","chr13","67198097","67198382","37","43806647"
"JH378116","23718423","23718609","chr5","70426117","70426301","49","46707694"
"JH378116","23950484","23950788","chr23","45383243","45383541","49","21432759"
"JH378116","24134953","24135241","chr16","18257374","18257671","53","5877579"
"JH378116","25197467","25197770","chr6","18852331","18852633","62","6345136"
"JH378116","25769123","25769414","chr11","42708500","42708788","48","16939377"
"JH378116","28047085","28047386","chr4","74750244","74750542","33","46703159"
"JH378116","28674921","28675224","chr16","24824595","24824890","41","3850326"
"JH378116","29208758","29209073","chr24","27814571","27814877","61","1394187"
"JH378116","31571506","31571808","chr26","24027927","24028229","44","7543579"
"JH378116","32367690","32367978","chr14","83288480","83288767","43","50920790"
"JH378116","32487203","32487489","chr20","44512838","44513119","46","12025635"
"JH378116","32620132","32620423","chr12","65356809","65357103","39","32736677"
"JH378116","32643672","32643958","chr8","17131358","17131640","49","15512314"
"JH378116","32897480","32897781","chr1","20836893","20837193","46","12060587"
"JH378116","33533571","33533854","chr5","24852161","24852433","48","8681410"
"JH378116","34456202","34456379","chr2","19488342","19488513","55","14967860"
"JH378116","34686192","34686473","chr18","41891395","41891674","47","7205203"
"JH378116","37000598","37000827","chr7","57513437","57513664","33","20512839"
"JH378116","37059431","37059729","chr10","104330612","104330907","44","67271181"
"JH378116","37121395","37121554","chr10","61946373","61946539","30","24824978"
"JH378116","37543133","37543415","chr20","68385003","68385285","54","30841870"
"JH378116","37613152","37613475","chr9","95286564","95286873","61","57673412"
"JH378116","37774414","37774679","chr17","47805481","47805753","53","10031067"
"JH378116","39019170","39019452","chr3","6022508","6022797","43","32996662"
"JH378116","39618540","39618659","chr20","39310180","39310301","23","308360"
"JH378116","39618774","39618936","chr10","61946373","61946539","33","22327599"
"JH378117","48301","48502","chr7","131233865","131234062","42","131185564"
"JH378117","53049","53351","chr22","9714838","9715138","37","9661789"
"JH378117","3447447","3447710","chr13","36191782","36192048","72","32744335"
"JH378117","3449557","3449847","chrX","29558025","29558318","41","26108468"
"JH378117","3492058","3492320","chr28","15448114","15448384","44","11956056"
"JH378117","3514839","3515129","chrX","44238718","44239009","37","40723879"
"JH378117","3520232","3520536","chr5","10824452","10824759","38","7304220"
"JH378117","5827286","5827578","chrX_KE148109v1_random","59166","59473","66","5768120"
"JH378117","6898319","6898628","chrX","22829405","22829716","46","15931086"
"JH378117","7150740","7151034","chr10","75740191","75740486","40","68589451"
"JH378117","7653811","7654118","chr6","36288281","36288590","44","28634470"
"JH378117","7757483","7757766","chr1","114482348","114482630","41","106724865"
"JH378117","8253915","8254212","chr7","41384280","41384575","40","33130365"
"JH378117","8283280","8283563","chr20","2854395","2854680","40","5428885"
"JH378117","8472321","8472610","chr11","42708500","42708788","37","34236179"
"JH378117","8547287","8547589","chr23","37622829","37623120","44","29075542"
"JH378117","8567396","8567666","chr7","39417307","39417586","58","30849911"
"JH378117","8840622","8840912","chr9","97265638","97265929","41","88425016"
"JH378117","8887828","8887947","chr6","17749395","17749522","30","8861567"
"JH378117","9012521","9012809","chr3","19437037","19437326","48","10424516"
"JH378117","9181773","9182001","chr18","9905435","9905663","42","723662"
"JH378117","10351710","10351988","chr16","17103242","17103520","38","6751532"
"JH378117","10506019","10506311","chr6","49004703","49004998","40","38498684"
"JH378117","10625506","10625813","chr9","18227013","18227322","43","7601507"
"JH378117","10677958","10678227","chr3","61105522","61105802","42","50427564"
"JH378117","11666637","11666941","chr8","20072572","20072880","49","8405935"
"JH378117","11700901","11701212","chr12","25030968","25031277","70","13330067"
"JH378117","12835610","12835910","chr9","32604399","32604698","58","19768789"
"JH378117","13031104","13031407","chr8","81491576","81491880","45","68460472"
"JH378117","16210612","16210887","chr16","17102812","17103083","52","892200"
"JH378117","16262365","16262645","chr13","93964542","93964823","61","77702177"
"JH378117","16348262","16348365","chr6","11844044","11844146","11","4504218"
"JH378117","17019909","17020174","chr26","53514723","53514995","41","36494814"
"JH378117","17281436","17281744","chr10","44221705","44222014","42","26940269"
"JH378117","18984849","18985120","chrX","85829317","85829602","55","66844468"
"JH378117","19184613","19184936","chr23","59622743","59623065","46","40438130"
"JH378117","20282802","20283070","chr2_AQIB01158150v1_random","7269","7532","41","20275533"
"JH378117","21761558","21761854","chr5","5298594","5298888","50","16462964"
"JH378117","22320586","22320884","chr4","74750244","74750542","39","52429658"
"JH378117","22395361","22395655","chr22","52379511","52379797","57","29984150"
"JH378117","22415472","22415762","chr12","45962018","45962309","37","23546546"
"JH378117","22474488","22474785","chr23","45383243","45383541","49","22908755"
"JH378117","22479496","22479622","chr13","93936933","93937062","19","71457437"
"JH378117","22533684","22533985","chr6","18891953","18892253","45","3641731"
"JH378117","22703698","22703811","chr10","66128392","66128503","24","43424694"
"JH378117","23011916","23012210","chr1","9360845","9361141","37","13651071"
"JH378117","23112676","23112859","chr28","19978049","19978251","71","3134627"
"JH378117","23577329","23577607","chr14","61597585","61597855","58","38020256"
"JH378117","24582111","24582416","chr6","29394044","29394346","45","4811933"
"JH378117","24666680","24666978","chr16","41764138","41764434","41","17097458"
"JH378117","24679510","24679810","chr11","19714655","19714953","50","4964855"
"JH378117","27103151","27103449","chr12","80263417","80263718","41","53160266"
"JH378117","27309893","27310182","chr26","16423084","16423376","42","10886809"
"JH378117","27474122","27474430","chr14","61349438","61349746","38","33875316"
"JH378117","27659729","27660005","chr8","40712258","40712534","46","13052529"
"JH378117","28684950","28685234","chr19","7984494","7984775","48","20700456"
"JH378117","30013332","30013633","chr26","18794536","18794836","36","11218796"
"JH378117","30640445","30640593","chr1","18525048","18525193","37","12115397"
"JH378117","30845562","30845865","chr23","65059093","65059390","48","34213531"
"JH378117","33011160","33011459","chr4","74750244","74750542","41","41739084"
"JH378117","33125985","33126264","chr16","3279077","3279364","42","29846908"
"JH378117","33561668","33561956","chr23","55163642","55163933","45","21601974"
"JH378117","34572341","34572585","chr1","112610540","112610791","58","78038199"
"JH378117","35210026","35210193","chr3","77318398","77318568","42","42108372"
"JH378117","35439056","35439359","chr6","30079079","30079380","44","5359977"
"JH378117","36467534","36467803","chr28","13713786","13714063","45","22753748"
"JH378117","37822788","37823100","chr16","29392625","29392932","45","8430163"
"JH378117","38341942","38342221","chr9","87793699","87793980","43","49451757"
"JH378118","212400","212515","chr12","17356175","17356289","14","17143775"
"JH378118","915486","915558","chr14","99207960","99208028","11","98292474"
"JH378118","953945","954244","chr4","74750244","74750542","38","73796299"
"JH378118","1517465","1517612","chr25","55203429","55203580","29","53685964"
"JH378118","1637912","1638211","chr14","18956776","18957072","34","17318864"
"JH378118","1905894","1906194","chr12","97392320","97392622","32","95486426"
"JH378118","1956844","1957133","chr15","21505985","21506275","40","19549141"
"JH378118","2270865","2271157","chr11","52774613","52774907","36","50503748"
"JH378118","3132239","3132470","chr12","20158995","20159217","33","17026756"
"JH378118","3172023","3172168","chr16","59350503","59350658","42","56178480"
"JH378118","3857887","3858112","chr11","7774263","7774487","36","3916376"
"JH378118","4447234","4447524","chr1","115101604","115101892","52","110654370"
"JH378118","5512774","5512971","chr23","42922019","42922224","41","37409245"
"JH378118","5842324","5842485","chr11","6506714","6506863","37","664390"
"JH378118","6931697","6931894","chr16","62117476","62117671","46","55185779"
"JH378118","7849299","7849586","chr1","51035370","51035662","49","43186071"
"JH378118","7986369","7986644","chr11","24876645","24876927","59","16890276"
"JH378118","8854915","8855211","chr4","16716893","16717190","50","7861978"
"JH378118","8903830","8904129","chr10","104330612","104330907","38","95426782"
"JH378118","9044786","9045089","chr5","10824452","10824759","55","1779666"
"JH378118","9075180","9075381","chr20","73921736","73921930","39","64846556"
"JH378118","9193623","9193760","chr21","99460334","99460473","23","90266711"
"JH378118","9613951","9614269","chr3","29617498","29617804","47","20003547"
"JH378118","10116896","10117009","chr12","17356175","17356289","18","7239279"
"JH378118","10198517","10198687","chr27","10317709","10317877","38","119192"
"JH378118","10492347","10492648","chr2","33362197","33362503","47","22869850"
"JH378118","11197231","11197431","chr17","44797436","44797665","69","33600205"
"JH378118","11443908","11444222","chr3","27047348","27047655","47","15603440"
"JH378118","13070111","13070394","chr3","19142444","19142731","45","6072333"
"JH378118","13364357","13364526","chr6","33811352","33811518","39","20446995"
"JH378118","14259454","14259746","chrX","29558025","29558318","40","15298571"
"JH378118","14645571","14645868","chr29","3711047","3711343","39","10934524"
"JH378118","14665899","14666006","chr6","33839130","33839249","29","19173231"
"JH378118","14673245","14673539","chr28","15327544","15327835","41","654299"
"JH378118","14769389","14769692","chr19","32620355","32620659","38","17850966"
"JH378118","16352834","16353126","chrX","6571847","6572139","35","9780987"
"JH378118","17117607","17117916","chr6","30079079","30079380","47","12961472"
"JH378118","17721413","17721726","chr5","25969437","25969747","48","8248024"
"JH378118","17757719","17757964","chr9","63956761","63957022","54","46199042"
"JH378118","20192437","20192715","chr4","11736984","11737266","48","8455453"
"JH378118","20642786","20643071","chr20","72949086","72949362","50","52306300"
"JH378118","21709878","21710176","chr1","84642400","84642694","42","62932522"
"JH378118","21778365","21778659","chr11","42708500","42708788","47","20930135"
"JH378118","23066339","23066651","chr9","20557395","20557703","42","2508944"
"JH378118","23161739","23162034","chr4","61692314","61692609","34","38530575"
"JH378118","23217384","23217655","chr12","56981284","56981548","46","33763900"
"JH378118","23248021","23248345","chr2","89875723","89876040","53","66627702"
"JH378118","24473078","24473368","chr4","74750244","74750542","40","50277166"
"JH378118","24779954","24780253","chr19","27584635","27584934","48","2804681"
"JH378118","24804016","24804304","chr10","85456712","85457001","51","60652696"
"JH378118","24998511","24998808","chr4","52226463","52226762","57","27227952"
"JH378118","25129294","25129540","chr20","93979343","93979574","58","68850049"
"JH378118","25233054","25233346","chr17","38569856","38570151","45","13336802"
"JH378118","25295883","25296182","chr1","20836893","20837193","37","4458990"
"JH378118","25584401","25584609","chr11","100225388","100225600","41","74640987"
"JH378118","25637100","25637391","chr12","45962018","45962309","38","20324918"
"JH378118","25710533","25710844","chr20","7876234","7876541","44","17834299"
"JH378118","26959397","26959613","chr11","100225388","100225600","34","73265991"
"JH378118","26963838","26964020","chr2","25630213","25630417","40","1333625"
"JH378118","27125825","27126038","chr14","80915347","80915557","39","53789522"
"JH378118","27267565","27267835","chr11","113615804","113616083","46","86348239"
"JH378118","27563660","27563969","chr2","33362197","33362503","43","5798537"
"JH378118","27694453","27694756","chr1","20836893","20837193","39","6857560"
"JH378118","27702254","27702548","chr20","92950108","92950404","31","65247854"
"JH378118","28186046","28186331","chr5","58048044","58048323","39","29861998"
"JH378118","28296384","28296636","chr1","66763889","66764138","40","38467505"
"JH378118","28574928","28575226","chrX","6571847","6572139","39","22003081"
"JH378118","28606869","28607156","chr17","36678048","36678335","33","8071179"
"JH378118","28713909","28714196","chr14","75996449","75996748","66","47282540"
"JH378118","29112126","29112412","chr12","39114189","39114476","51","10002063"
"JH378118","29146505","29146781","chr9","96272747","96273028","44","67126242"
"JH378118","29383185","29383453","chr21","119050608","119050872","39","89667423"
"JH378118","29430550","29430832","chr9","59423774","59424053","39","29993224"
"JH378118","29449206","29449543","chr22","73890472","73890806","52","44441266"
"JH378118","29600696","29600999","chr2","33362197","33362503","46","3761501"
"JH378118","29626628","29626918","chr12","65356809","65357103","45","35730181"
"JH378118","29770264","29770554","chr10","94012577","94012864","42","64242313"
"JH378118","31697242","31697533","chr9","21135134","21135430","47","10562108"
"JH378118","32646916","32647069","chr14","63352153","63352302","29","30705237"
"JH378118","32791602","32791903","chr10","89318076","89318373","46","56526474"
"JH378118","33000433","33000710","chr15","53844522","53844788","55","20844089"
"JH378118","33033297","33033596","chr16","24824595","24824890","35","8208702"
"JH378118","33269442","33269753","chr2","66559968","66560273","49","33290526"
"JH378118","33572764","33572960","chr16","62117476","62117671","29","28544712"
"JH378118","33611134","33611397","chr25","74544052","74544325","57","40932918"
"JH378118","33667241","33667515","chr2","12062172","12062451","56","21605069"
"JH378118","33969934","33970063","chr22","3180119","3180245","17","30789815"
"JH378118","34913327","34913626","chr17","38749593","38749886","44","3836266"
"JH378118","35501373","35501681","chr13","385523","385830","40","35115850"
"JH378118","35768141","35768431","chrX","47726776","47727071","46","11958635"
"JH378118","37137799","37138085","chrX","6571847","6572139","40","30565952"
"JH378118","37186310","37186450","chr25","6369752","6369893","31","30816558"
"JH378119","39050","39348","chr19","14623177","14623470","38","14584127"
"JH378119","294826","295122","chr14","81078166","81078460","60","80783340"
"JH378119","518252","518375","chr6","33578769","33578895","29","33060517"
"JH378119","2302623","2302926","chr4","74707922","74708225","44","72405299"
"JH378119","2333027","2333165","chr10","16224051","16224189","31","13891024"
"JH378119","2656171","2656346","chr14","9346341","9346512","26","6690170"
"JH378119","2732403","2732713","chr1","125024996","125025302","42","122292593"
"JH378119","3356905","3357209","chr1","29621888","29622188","52","26264983"
"JH378119","3436364","3436568","chr19","12992619","12992824","51","9556255"
"JH378119","3565184","3565418","chr18","51117684","51117913","48","47552500"
"JH378119","4556788","4557087","chrX","101271704","101272011","115","96714916"
"JH378119","4761820","4762135","chr9","106648222","106648531","48","101886402"
"JH378119","5240316","5240600","chr24","42610394","42610688","45","37370078"
"JH378119","5257353","5257614","chr26","42500760","42501016","41","37243407"
"JH378119","5272333","5272606","chr12","31899150","31899427","40","26626817"
"JH378119","5303643","5303763","chr5","16452354","16452474","20","11148711"
"JH378119","6054645","6054926","chr26","4458411","4458686","55","1596234"
"JH378119","7201809","7202110","chr15","2000778","2001083","36","5201031"
"JH378119","7274484","7274783","chr26","26868700","26868994","52","19594216"
"JH378119","7950531","7950828","chr3","73292441","73292730","44","65341910"
"JH378119","8287703","8287973","chr14","61597585","61597855","55","53309882"
"JH378119","8589582","8589877","chr1","74176948","74177248","52","65587366"
"JH378119","8816026","8816327","chr12","3898076","3898379","46","4917950"
"JH378119","9126139","9126432","chr29","9188440","9188729","47","62301"
"JH378119","9289847","9290129","chr8","75310214","75310504","46","66020367"
"JH378119","10220131","10220435","chr16","30260040","30260349","48","20039909"
"JH378119","10525410","10525698","chr17","4564564","4564857","40","5960846"
"JH378119","10548587","10548895","chr11","1373833","1374133","66","9174754"
"JH378119","10623654","10623973","chr11","116558393","116558699","75","105934739"
"JH378119","10726776","10727023","chr5","72051782","72052054","62","61325006"
"JH378119","10729053","10729351","chr10","102332242","102332544","34","91603189"
"JH378119","10984890","10985188","chr24","12126609","12126914","42","1141719"
"JH378119","11243219","11243513","chr26","19485506","19485798","43","8242287"
"JH378119","11424300","11424576","chrX","46213593","46213878","74","34789293"
"JH378119","11528381","11528542","chr6","43429100","43429261","36","31900719"
"JH378119","11544618","11544913","chr10","104330612","104330907","39","92785994"
"JH378119","11548466","11548688","chrX","5651910","5652138","43","5896556"
"JH378119","11557893","11558201","chr18","33422516","33422822","43","21864623"
"JH378119","11925526","11925825","chr26","18794536","18794836","38","6869010"
"JH378119","12835763","12836045","chr25","26617701","26617991","62","13781938"
"JH378119","12963846","12964138","chr10","64531801","64532097","39","51567955"
"JH378119","13136683","13136795","chr1","19184037","19184145","28","6047354"
"JH378119","13311302","13311610","chr12","3898076","3898379","43","9413226"
"JH378119","13521219","13521515","chr1","29621888","29622188","35","16100669"
"JH378119","14150811","14151114","chr9","111337288","111337584","40","97186477"
"JH378119","14364434","14364556","chr12","9394703","9394838","24","4969731"
"JH378119","15254236","15254494","chr13","35085161","35085424","50","19830925"
"JH378119","15812908","15813195","chr12","43926668","43926967","50","28113760"
"JH378119","17013621","17013911","chr1","20836893","20837193","55","3823272"
"JH378119","17215360","17215558","chr13","96152783","96152983","33","78937423"
"JH378119","19512084","19512263","chr20","113342426","113342612","44","93830342"
"JH378119","20997768","20998057","chr10","55141969","55142258","41","34144201"
"JH378119","21077731","21077971","chr24","6466580","6466820","44","14611151"
"JH378119","21613499","21613728","chrX","92178511","92178733","32","70565012"
"JH378119","21792123","21792423","chr2","22860155","22860456","47","1068032"
"JH378119","22014895","22015189","chr11","95498272","95498559","48","73483377"
"JH378119","23130212","23130386","chr5","13172968","13173157","46","9957244"
"JH378119","24233901","24234206","chr2","64489411","64489719","46","40255510"
"JH378119","26143832","26144112","chr3","30521039","30521319","43","4377207"
"JH378119","26241612","26241903","chr17","43994556","43994844","59","17752944"
"JH378119","26536929","26537223","chr12","65356809","65357103","38","38819880"
"JH378119","26853126","26853401","chr11","42101160","42101440","47","15248034"
"JH378119","26880389","26880675","chr20","2854395","2854680","41","24025994"
"JH378119","26913992","26914100","chr2","63172174","63172281","18","36258182"
"JH378119","26952309","26952605","chr23","6539800","6540082","52","20412509"
"JH378119","26961660","26961852","chr7","92803834","92804013","44","65842174"
"JH378119","27026044","27026341","chr10","53802403","53802702","49","26776359"
"JH378119","27039792","27040087","chrX","38077262","38077554","43","11037470"
"JH378119","27051073","27051377","chrX","58994083","58994385","43","31943010"
"JH378119","27168622","27168724","chr6","11844044","11844146","15","15324578"
"JH378119","27322554","27322861","chr8","20072572","20072880","40","7249982"
"JH378119","27377029","27377148","chr5","25933140","25933266","30","1443889"
"JH378119","27464231","27464358","chr13","93936933","93937062","17","66472702"
"JH378119","27568992","27569235","chr4","65263107","65263348","32","37694115"
"JH378119","27603688","27603980","chr4","57711841","57712143","42","30108153"
"JH378119","28186275","28186575","chr11","14114130","14114435","37","14072145"
"JH378119","29192047","29192342","chr23","81285499","81285798","47","52093452"
"JH378119","29333190","29333506","chr14","75472416","75472708","86","46139226"
"JH378119","29752002","29752255","chr20","120203418","120203695","53","90451416"
"JH378119","29851869","29852174","chr10","82223974","82224279","39","52372105"
"JH378119","30158483","30158792","chr8","20072572","20072880","47","10085911"
"JH378119","30692432","30692706","chrX","85829317","85829602","57","55136885"
"JH378119","30741392","30741514","chrX","55638054","55638168","32","24896662"
"JH378119","31108833","31109111","chr2","51487811","51488079","51","20378978"
"JH378119","31364898","31365091","chr10","88746680","88746875","48","57381782"
"JH378119","31694436","31694657","chr8","120238157","120238376","45","88543721"
"JH378119","32117055","32117352","chr23","12799637","12799937","40","19317418"
"JH378119","32128196","32128481","chr13","23142221","23142512","45","8985975"
"JH378119","32610206","32610495","chr16","70729210","70729502","47","38119004"
"JH378119","32684875","32685138","chr7","95455735","95455993","39","62770860"
"JH378119","32812733","32813082","chr15","2240033","2240341","86","30572700"
"JH378119","32820363","32820638","chr12","73233764","73234041","39","40413401"
"JH378119","33386404","33386710","chr4","74750244","74750542","38","41363840"
"JH378119","33407068","33407358","chr10","75740191","75740486","56","42333123"
"JH378119","34132756","34133064","chr11","116558393","116558699","39","82425637"
"JH378119","34376766","34377058","chr26","11209053","11209344","39","23167713"
"JH378120","354595","354895","chr5","38130069","38130369","36","37775474"
"JH378120","414986","415278","chr21","32263328","32263616","39","31848342"
"JH378120","433396","433697","chr22","9714838","9715138","49","9281442"
"JH378120","946135","946446","chr3","11063125","11063453","53","10116990"
"JH378120","1440187","1440472","chr16","33438205","33438489","43","31998018"
"JH378120","1628458","1628758","chr19","27584635","27584934","42","25956177"
"JH378120","1742599","1742900","chr12","18358405","18358704","57","16615806"
"JH378120","1991159","1991465","chr4","31811484","31811787","39","29820325"
"JH378120","2920472","2920765","chr9","61444147","61444444","46","58523675"
"JH378120","3034129","3034280","chrX","34581089","34581238","37","31546960"
"JH378120","3034865","3034988","chr6","33839130","33839249","18","30804265"
"JH378120","3074164","3074446","chr1","68970266","68970543","52","65896102"
"JH378120","3272125","3272410","chr12","103186024","103186315","60","99913899"
"JH378120","3380198","3380355","chr10","56563339","56563485","36","53183141"
"JH378120","6258305","6258607","chr9","57444017","57444321","35","51185712"
"JH378120","6969065","6969271","chr7","26338472","26338675","35","19369407"
"JH378120","7063631","7063919","chr19","20545323","20545613","40","13481692"
"JH378120","7545519","7545826","chr9","45167813","45168121","32","37622294"
"JH378120","7616381","7616669","chr6","50164890","50165177","50","42548509"
"JH378120","7969891","7969942","chrX_KE148108v1_random","5212730","5212778","10","2757161"
"JH378120","9424922","9424964","chr13","82612030","82612077","15","73187108"
"JH378120","9545191","9545491","chr11","116558393","116558699","53","107013202"
"JH378120","9939437","9939696","chr18","6024340","6024599","44","3915097"
"JH378120","10027100","10027401","chr7","109750336","109750636","39","99723236"
"JH378120","10132260","10132549","chr20","2854395","2854680","35","7277865"
"JH378120","10134069","10134172","chr4","58622830","58622931","13","48488761"
"JH378120","10220004","10220302","chr23","40996685","40996984","39","30776681"
"JH378120","10261268","10261448","chr14","9346341","9346512","29","914927"
"JH378120","10328439","10328734","chr8","119134907","119135216","51","108806468"
"JH378120","10346199","10346634","chr10","119989338","119989702","152","109643139"
"JH378120","10740794","10741069","chr1","114482348","114482630","47","103741554"
"JH378120","10928910","10929222","chr23","51149623","51149911","65","40220713"
"JH378120","11198025","11198332","chr5","5827035","5827340","44","5370990"
"JH378120","11277317","11277596","chr26","48681956","48682245","54","37404639"
"JH378120","11283718","11284009","chr4","74750244","74750542","44","63466526"
"JH378120","11757774","11758053","chr1","114482348","114482630","37","102724574"
"JH378120","11869075","11869379","chr1","125024996","125025302","47","113155921"
"JH378120","12203124","12203430","chr21","61356008","61356310","45","49152884"
"JH378120","12447727","12448022","chr7","24372563","24372858","43","11924836"
"JH378120","13443418","13443730","chrX","29670774","29671076","57","16227356"
"JH378120","13469301","13469531","chr1","50678867","50679117","49","37209566"
"JH378120","15210418","15210543","chr18","68076040","68076170","27","52865622"
"JH378120","15332500","15332774","chr26","45493442","45493721","44","30160942"
"JH378120","15572469","15572765","chr6","9932043","9932339","37","5640426"
"JH378120","15833776","15834074","chr23","57612824","57613126","31","41779048"
"JH378120","16403613","16403878","chr6","11340998","11341271","46","5062615"
"JH378120","17516816","17517106","chr9","6382689","6382978","48","11134127"
"JH378120","17709798","17709979","chr7","92803834","92804013","33","75094036"
"JH378120","19349443","19349745","chr1","113325394","113325698","48","93975951"
"JH378120","19735027","19735312","chr10","18802261","18802546","43","932766"
"JH378120","21194640","21194942","chr24","26360086","26360391","47","5165446"
"JH378120","21744134","21744444","chr26","41461037","41461347","71","19716903"
"JH378120","22079864","22080152","chr18","21169838","21170126","55","910026"
"JH378120","22094555","22094842","chr26","48811822","48812111","50","26717267"
"JH378120","24688251","24688539","chr3","6022508","6022797","42","18665743"
"JH378120","25575288","25575581","chr22","95239299","95239587","43","69664011"
"JH378120","25771607","25771870","chr14","33993071","33993339","53","8221464"
"JH378120","26394614","26394912","chr5","34361928","34362228","42","7967314"
"JH378120","26427338","26427635","chr11","83560875","83561170","42","57133537"
"JH378120","26640347","26640655","chr21","1683088","1683396","44","24957259"
"JH378120","26783352","26783648","chr28","8917006","8917294","59","17866346"
"JH378120","26785123","26785374","chr20","9448039","9448298","57","17337084"
"JH378120","26799841","26800133","chr2","61035797","61036096","47","34235956"
"JH378120","27914246","27914546","chr1","9360845","9361141","47","18553401"
"JH378120","29259566","29259873","chr1","64816119","64816429","43","35556553"
"JH378120","29344362","29344642","chr12","10348016","10348298","49","18996346"
"JH378120","30162575","30162870","chr12","101706953","101707248","52","71544378"
"JH378120","30225375","30225680","chr23","57612824","57613126","56","27387449"
"JH378120","30247844","30248135","chr10","2202474","2202766","36","28045370"
"JH378120","30282041","30282244","chr1","21512792","21512987","41","8769249"
"JH378120","30660156","30660447","chrX","38649521","38649815","42","7989365"
"JH378120","30721729","30721997","chr11","42708500","42708788","56","11986771"
"JH378120","30756582","30756696","chr1","19184037","19184145","21","11572545"
"JH378120","30944053","30944253","chr7","26338472","26338675","38","4605581"
"JH378120","31275397","31275677","chr11","24876645","24876927","35","6398752"
"JH378120","31547273","31547564","chr19","18980878","18981173","40","12566395"
"JH378120","31547763","31548052","chr26","8970369","8970646","46","22577394"
"JH378120","31614306","31614587","chr11","42101160","42101440","44","10486854"
"JH378120","31741264","31741548","chr24","52062002","52062293","49","20320738"
"JH378120","32182350","32182639","chrX","6571847","6572139","39","25610503"
"JH378120","32328645","32328945","chr26","18794536","18794836","35","13534109"
"JH378121","28835700","28835986","chr25","49550004","49550295","55","20714304"
"JH378121","285850","286154","chr14","20590623","20590929","43","20304773"
"JH378121","335886","336187","chr12","62505268","62505568","42","62169382"
"JH378121","813765","813906","chr14","33067112","33067242","31","32253347"
"JH378121","3108940","3109229","chr15","8473619","8473907","41","5364679"
"JH378121","3139730","3140032","chr16","18257374","18257671","44","15117644"
"JH378121","3248253","3248555","chr2","51179671","51179972","39","47931418"
"JH378121","3250898","3251204","chr3","76855982","76856288","41","73605084"
"JH378121","3253703","3253994","chr12","41367876","41368167","47","38114173"
"JH378121","5017543","5017762","chr12","108518404","108518625","39","103500861"
"JH378121","5046316","5046604","chr13","86323276","86323561","48","81276960"
"JH378121","5358306","5358611","chr12","72996428","72996729","46","67638122"
"JH378121","8369466","8369719","chr1","50678867","50679117","50","42309401"
"JH378121","8842874","8843138","chr10","63585093","63585357","51","54742219"
"JH378121","9306999","9307305","chr9","18580784","18581088","48","9273785"
"JH378121","9321628","9321927","chr12","12357674","12357969","42","3036046"
"JH378121","9718237","9718489","chr11","52400982","52401220","49","42682745"
"JH378121","9904595","9904720","chr1","9431377","9431502","21","473218"
"JH378121","10133144","10133404","chr20","111949525","111949783","39","101816381"
"JH378121","10260211","10260524","chrX","125597726","125598033","41","115337515"
"JH378121","10722123","10722418","chr26","31593489","31593788","56","20871366"
"JH378121","11002430","11002743","chr16","53329772","53330076","71","42327342"
"JH378121","11047675","11047809","chr26","27840309","27840431","43","16792634"
"JH378121","11650269","11650638","chr17","48124549","48124857","111","36474280"
"JH378121","14056451","14056685","chr3","54097857","54098084","39","40041406"
"JH378121","14132601","14132904","chr16","18299936","18300237","52","4167335"
"JH378121","14210934","14211219","chr9","61932207","61932503","65","47721273"
"JH378121","14298768","14299066","chr10","102332242","102332544","67","88033474"
"JH378121","15128047","15128342","chr16","34953642","34953933","56","19825595"
"JH378121","15367956","15368235","chr9","87793699","87793980","40","72425743"
"JH378121","15641267","15641549","chr5","42930459","42930742","51","27289192"
"JH378121","15929786","15930072","chr20","118001146","118001448","55","102071360"
"JH378121","16132550","16132835","chr25","3359926","3360212","36","12772624"
"JH378121","16383033","16383303","chr20","4278487","4278750","58","12104546"
"JH378121","19400918","19401207","chr1","67566937","67567228","43","48166019"
"JH378121","19528095","19528357","chr7","116216737","116217000","55","96688642"
"JH378121","19641066","19641350","chr9","103138976","103139260","38","83497910"
"JH378121","19697242","19697514","chr14","45592971","45593246","56","25895729"
"JH378121","19966224","19966509","chr2","62954520","62954811","47","42988296"
"JH378121","20030601","20030900","chr24","41015674","41015968","50","20985073"
"JH378121","20262271","20262574","chr16","8468476","8468785","40","11793795"
"JH378121","20638819","20639112","chrX","33027186","33027484","35","12388367"
"JH378121","20899296","20899583","chr18","35039565","35039862","42","14140269"
"JH378121","21041612","21041763","chr21","28276441","28276585","33","7234829"
"JH378121","21092279","21092524","chr10","94020388","94020642","41","72928109"
"JH378121","21709758","21710063","chr14","61597253","61597561","52","39887495"
"JH378121","21928464","21928783","chr2","89875723","89876040","51","67947259"
"JH378121","23612711","23613022","chr26","24027927","24028229","52","415216"
"JH378121","23790623","23790917","chr19","14623177","14623470","37","9167446"
"JH378121","23900628","23900826","chr20","113342426","113342612","41","89441798"
"JH378121","24236926","24237237","chr6","18852331","18852633","55","5384595"
"JH378121","24432366","24432654","chr6","9932043","9932339","38","14500323"
"JH378121","24844580","24844804","chr20","93979343","93979574","45","69134763"
"JH378121","25407381","25407486","chr20","80015270","80015379","13","54607889"
"JH378121","26639837","26640133","chr26","26868700","26868994","41","228863"
"JH378121","26813234","26813530","chr9","32604399","32604698","35","5791165"
"JH378121","27620408","27620701","chrX","47726776","47727071","41","20106368"
"JH378121","28649506","28649808","chr26","28505257","28505558","32","144249"
"JH378121","28825843","28826065","chr10","88746680","88746875","53","59920837"
"JH378121","29070575","29070902","chr5","60542028","60542347","56","31471453"
"JH378121","29752770","29753062","chr11","60552837","60553124","33","30800067"
"JH378121","30310928","30311196","chr5","66352492","66352757","48","36041564"
"JH378121","30868316","30868609","chr14","68359125","68359423","32","37490809"
"JH378121","31071621","31071896","chr15","4986082","4986355","43","26085539"
"JH378122","137311","137614","chr4","10168457","10168762","45","10031146"
"JH378122","436660","436967","chr1","10964645","10964948","39","10527985"
"JH378122","1168189","1168473","chr20","78791369","78791657","42","77623180"
"JH378122","1385989","1386189","chr10","38837051","38837254","45","37451062"
"JH378122","1481109","1481409","chr4","74750244","74750542","42","73269135"
"JH378122","1971282","1971404","chrUn_AQIB01158800v1","1","125","26","1971281"
"JH378122","2045444","2045603","chr16","8056026","8056187","23","6010582"
"JH378122","2378604","2378895","chr14","48826130","48826421","41","46447526"
"JH378122","3808402","3808684","chr11","42708500","42708788","54","38900098"
"JH378122","3871383","3871678","chr16","14422338","14422632","37","10550955"
"JH378122","4645100","4645328","chrX","13770781","13771028","65","9125681"
"JH378122","5233233","5233485","chr1","50678867","50679117","38","45445634"
"JH378122","5273225","5273511","chr12","103143939","103144227","52","97870714"
"JH378122","5523205","5523523","chrX","58994083","58994385","58","53470878"
"JH378122","5602240","5602533","chr14","99085390","99085687","41","93483150"
"JH378122","6087278","6087586","chr16","18257374","18257671","60","12170096"
"JH378122","6443537","6443813","chr11","62921553","62921824","44","56478016"
"JH378122","7164781","7164873","chr10","85283682","85283779","41","78118901"
"JH378122","7215779","7216062","chr21","48106444","48106729","55","40890665"
"JH378122","7566695","7566992","chr15","33541193","33541502","67","25974498"
"JH378122","7623573","7623870","chr19","1463318","1463615","49","6160255"
"JH378122","8083932","8084215","chr6","6359779","6360068","45","1724153"
"JH378122","8365406","8365678","chr14","78282196","78282477","37","69916790"
"JH378122","8989705","8989948","chr21","85642900","85643169","56","76653195"
"JH378122","9122810","9123034","chr7","57513437","57513664","38","48390627"
"JH378122","9628980","9629157","chr12","43957933","43958104","28","34328953"
"JH378122","9629275","9629402","chr16","64256171","64256304","22","54626896"
"JH378122","9889612","9889912","chr16","36007753","36008062","42","26118141"
"JH378122","10055565","10055710","chr5","70321221","70321359","40","60265656"
"JH378122","10069777","10069977","chr23","42922019","42922224","38","32852242"
"JH378122","10316150","10316369","chr6","45204746","45204963","43","34888596"
"JH378122","10684112","10684388","chr17","29306106","29306387","69","18621994"
"JH378122","10886792","10886860","chr14","101528986","101529061","18","90642194"
"JH378122","10894628","10894807","chr27","24409985","24410154","31","13515357"
"JH378122","10942426","10942697","chr11","105269557","105269836","56","94327131"
"JH378122","11200689","11200997","chr1","125024996","125025302","42","113824307"
"JH378122","11623231","11623497","chr1","24159641","24159900","61","12536410"
"JH378122","13059208","13059502","chr11","41803129","41803428","31","28743921"
"JH378122","13098890","13099199","chr7","119466216","119466521","42","106367326"
"JH378122","13203794","13203895","chr21","64493767","64493871","23","51289973"
"JH378122","13373373","13373666","chr18","59850632","59850929","46","46477259"
"JH378122","14687815","14688097","chr3","6022508","6022797","53","8665307"
"JH378122","15493201","15493505","chr7","24372563","24372858","58","8879362"
"JH378122","15920267","15920478","chr14","74021868","74022082","41","58101601"
"JH378122","16034291","16034596","chrX","111958920","111959222","41","95924629"
"JH378122","16107343","16107646","chr2","61035797","61036096","44","44928454"
"JH378122","16349718","16350000","chr12","13143084","13143366","36","3206634"
"JH378122","16763176","16763444","chr20","120203418","120203695","62","103440242"
"JH378122","17194290","17194589","chr1","29621888","29622188","35","12427598"
"JH378122","18611769","18612073","chr3","52274420","52274723","47","33662651"
"JH378122","20194239","20194405","chr6_KE147962v1_random","287534","287697","32","19906705"
"JH378122","20194525","20194635","chr7","54942222","54942331","31","34747697"
"JH378122","22350628","22350770","chrX","555973","556115","22","21794655"
"JH378122","23320517","23320802","chr3","4648816","4649103","45","18671701"
"JH378122","24496688","24496987","chr5","52401150","52401448","51","27904462"
"JH378122","24784488","24784768","chr16","63994911","63995193","48","39210423"
"JH378122","25130629","25130929","chr14","75472416","75472708","61","50341787"
"JH378122","25596059","25596357","chr9","61444147","61444444","48","35848088"
"JH378122","25645350","25645645","chr16","19278140","19278448","48","6367210"
"JH378122","25746131","25746432","chr2","14953819","14954119","41","10792312"
"JH378122","25791341","25791513","chr3","91778271","91778445","33","65986930"
"JH378122","26318127","26318417","chr9","29459013","29459303","55","3140886"
"JH378122","26370340","26370636","chr7","96395974","96396266","52","70025634"
"JH378122","27381640","27381946","chr5","26586506","26586810","54","795134"
"JH378122","27882488","27882776","chrX","85829317","85829602","57","57946829"
"JH378122","27979031","27979337","chrX","127444889","127445196","49","99465858"
"JH378122","28180073","28180394","chr24","29267094","29267410","73","1087021"
"JH378122","28532004","28532309","chr21","3002493","3002804","45","25529511"
"JH378122","28838510","28838812","chr1","74176948","74177248","36","45338438"
"JH378122","28861025","28861324","chr23","57612824","57613126","41","28751799"
"JH378122","29032258","29032514","chr25","28732748","28733009","46","299510"
"JH378123","83030","83315","chr1","9360845","9361141","44","9277815"
"JH378123","272480","272774","chr20","105708807","105709105","41","105436327"
"JH378123","287369","287657","chr23","74687797","74688087","48","74400428"
"JH378123","495211","495507","chr13","37127275","37127575","53","36632064"
"JH378123","571981","572290","chr8","20072572","20072880","40","19500591"
"JH378123","626882","627165","chr10","23978015","23978297","47","23351133"
"JH378123","1020323","1020629","chr19","29618607","29618903","57","28598284"
"JH378123","2198071","2198353","chr3","76758914","76759196","67","74560843"
"JH378123","2529625","2529931","chr27","46561466","46561771","48","44031841"
"JH378123","2920957","2921217","chr15","15999747","16000000","50","13078790"
"JH378123","3275500","3275807","chr19","22626676","22626983","43","19351176"
"JH378123","3296315","3296601","chrX","85693757","85694048","49","82397442"
"JH378123","4178281","4178560","chr25","27453211","27453490","52","23274930"
"JH378123","5990957","5991125","chr5","23857201","23857369","41","17866244"
"JH378123","6035492","6035688","chr1","21512792","21512987","55","15477300"
"JH378123","6170808","6171112","chr14","61349438","61349746","44","55178630"
"JH378123","7148956","7149060","chr6","29480212","29480322","17","22331256"
"JH378123","7478714","7479000","chr16","58839580","58839876","49","51360866"
"JH378123","7678201","7678477","chr12","73233764","73234041","40","65555563"
"JH378123","8378121","8378422","chr26","18794536","18794836","50","10416415"
"JH378123","8611023","8611310","chr5","53503219","53503505","52","44892196"
"JH378123","9088889","9089158","chr7","57344542","57344818","50","48255653"
"JH378123","9461724","9461997","chr23","82158504","82158780","51","72696780"
"JH378123","9654204","9654331","chr11","3463080","3463210","24","6191124"
"JH378123","10135422","10135731","chr5","66452880","66453187","43","56317458"
"JH378123","10208477","10208731","chr10","55600559","55600818","54","45392082"
"JH378123","11206770","11207072","chr4","74750244","74750542","36","63543474"
"JH378123","11498344","11498641","chr28","12166824","12167128","49","668480"
"JH378123","11692536","11692813","chr10","94012577","94012864","40","82320041"
"JH378123","11731967","11732252","chr22","51803732","51804029","43","40071765"
"JH378123","12069104","12069343","chr18","9905435","9905663","38","2163669"
"JH378123","12265148","12265461","chr14","75453210","75453507","46","63188062"
"JH378123","14443842","14444143","chr16","66139074","66139369","37","51695232"
"JH378123","15236428","15236555","chr4","77908589","77908714","19","62672161"
"JH378123","15538318","15538441","chr11","24710077","24710199","8","9171759"
"JH378123","17380783","17380921","chr5","2033212","2033345","19","15347571"
"JH378123","18185359","18185667","chr12","62505268","62505568","50","44319909"
"JH378123","18218233","18218510","chr19","21107721","21107998","50","2889488"
"JH378123","19452973","19453265","chrX","43777377","43777676","43","24324404"
"JH378123","19617256","19617531","chr4","36106904","36107172","52","16489648"
"JH378123","19623698","19623974","chr1","32028693","32028980","55","12404995"
"JH378123","20050577","20050871","chr10","104330612","104330907","42","84280035"
"JH378123","21263021","21263305","chr12","98075663","98075941","37","76812642"
"JH378123","21316547","21316747","chr24","47558800","47559017","42","26242253"
"JH378123","21327561","21327865","chr20","117005664","117005963","46","95678103"
"JH378123","21357423","21357546","chr16","44225988","44226106","22","22868565"
"JH378123","21552029","21552313","chr4","36472091","36472381","50","14920062"
"JH378123","21810625","21810796","chr20","87928737","87928908","26","66118112"
"JH378123","21850830","21851058","chrX_KE148108v1_random","1302503","1302741","41","20548327"
"JH378123","22111731","22112034","chr3","84994259","84994563","40","62882528"
"JH378123","22150517","22150826","chr14","18787069","18787376","39","3363448"
"JH378123","22236482","22236802","chr15","90468926","90469226","64","68232444"
"JH378123","22301708","22301996","chr9","6382689","6382978","35","15919019"
"JH378123","22651067","22651358","chr9","114693205","114693503","44","92042138"
"JH378123","24006772","24007084","chr20","2957027","2957333","51","21049745"
"JH378123","24207294","24207598","chr7","49482276","49482577","42","25274982"
"JH378123","24563681","24563981","chr1","102867195","102867490","39","78303514"
"JH378123","25669236","25669529","chr10","85456712","85457001","47","59787476"
"JH378123","26380016","26380303","chr2","26528623","26528910","57","148607"
"JH378123","27131348","27131607","chrX","28441716","28441974","41","1310368"
"JH378123","27152189","27152424","chr9","98025352","98025582","68","70873163"
"JH378123","27152525","27152585","chr5","74278756","74278811","25","47126231"
"JH378123","27444702","27444987","chr9","11828451","11828739","45","15616251"
"JH378123","29106632","29106924","chr11","42708500","42708788","47","13601868"
"JH378123","29142319","29142564","chr11","32138671","32138911","35","2996352"
"JH378123","29156875","29157185","chr5","26026229","26026536","39","3130646"
"JH378123","29695398","29695695","chr7","24372563","24372858","39","5322835"
"JH378123","29817415","29817708","chr12","101706953","101707248","42","71889538"
"JH378124","439292","439599","chr14","79684474","79684770","65","79245182"
"JH378124","1488402","1488589","chrX","89417992","89418174","35","87929590"
"JH378124","2011365","2011617","chr21","125813352","125813599","37","123801987"
"JH378124","2058039","2058347","chr26","19790629","19790935","42","17732590"
"JH378124","2684943","2685220","chr1","110377684","110377975","56","107692741"
"JH378124","4879104","4879394","chr13","57139627","57139918","37","52260523"
"JH378124","4997169","4997489","chr20","7876234","7876541","61","2879065"
"JH378124","5006629","5006854","chr2","65988272","65988503","44","60981643"
"JH378124","5007929","5008155","chr7","57513437","57513664","44","52505508"
"JH378124","5159781","5160082","chr5","10824452","10824759","41","5664671"
"JH378124","5207216","5207527","chr23","60371285","60371593","45","55164069"
"JH378124","5208601","5208760","chr10","55103495","55103662","29","49894894"
"JH378124","5507126","5507241","chr1","63674757","63674878","28","58167631"
"JH378124","5803455","5803764","chr5","26026229","26026536","50","20222774"
"JH378124","6364376","6364567","chr21","18967230","18967419","39","12602854"
"JH378124","6562335","6562602","chr10","55562512","55562784","55","49000177"
"JH378124","6857938","6858108","chr11","93699684","93699857","26","86841746"
"JH378124","7098386","7098682","chr26","26868700","26868994","47","19770314"
"JH378124","7435722","7436028","chr9","9186120","9186416","55","1750398"
"JH378124","7746733","7747028","chr10","104330612","104330907","55","96583879"
"JH378124","7846990","7847123","chr21","99460334","99460473","23","91613344"
"JH378124","8667336","8667496","chr11","117718811","117718965","23","109051475"
"JH378124","8755794","8755926","chr22","3180119","3180245","25","5575675"
"JH378124","9706722","9707027","chr2","33362197","33362503","53","23655475"
"JH378124","9716741","9717029","chr19","1538482","1538767","45","8178259"
"JH378124","10035837","10036131","chr3","19437037","19437326","44","9401200"
"JH378124","10301402","10301689","chr15","47377794","47378078","55","37076392"
"JH378124","11907765","11908041","chr25","27172863","27173143","44","15265098"
"JH378124","11966141","11966414","chrX","32243062","32243337","42","20276921"
"JH378124","11976278","11976577","chrX","60057029","60057325","39","48080751"
"JH378124","12120278","12120574","chr1","32220138","32220445","45","20099860"
"JH378124","12132302","12132574","chr22","9226203","9226481","45","2906099"
"JH378124","12229363","12229663","chr11","106973007","106973312","50","94743644"
"JH378124","12473122","12473420","chr17","26921535","26921831","50","14448413"
"JH378124","13195045","13195201","chr2","37782743","37782903","35","24587698"
"JH378124","14261043","14261351","chr14","61349438","61349746","45","47088395"
"JH378124","14371242","14371547","chr16","51524710","51525012","58","37153468"
"JH378124","14646624","14646886","chr25","82986391","82986624","67","68339767"
"JH378124","14768804","14768935","chr14","3273365","3273488","27","11495439"
"JH378124","15641140","15641430","chr14","51174162","51174453","33","35533022"
"JH378124","15915511","15915814","chr20","105708807","105709105","55","89793296"
"JH378124","15948365","15948638","chr1","16838288","16838572","47","889923"
"JH378124","16006367","16006676","chr2","14953819","14954119","59","1052548"
"JH378124","16258504","16258814","chr2","33362197","33362503","48","17103693"
"JH378124","17605915","17606199","chr8","17131358","17131640","37","474557"
"JH378124","17659596","17659891","chr1","36079803","36080100","49","18420207"
"JH378124","18521633","18521941","chr5","66452880","66453187","47","47931247"
"JH378124","18946982","18947179","chr16","56784147","56784341","51","37837165"
"JH378124","19508409","19508693","chr9","86584742","86585030","56","67076333"
"JH378124","20286087","20286387","chr20","115487637","115487936","42","95201550"
"JH378124","21489052","21489341","chr11","42708500","42708788","40","21219448"
"JH378124","22297771","22298067","chr11","42708500","42708788","43","20410729"
"JH378124","23373088","23373372","chr9","96272747","96273028","50","72899659"
"JH378124","23838609","23838896","chr3","67889935","67890219","47","44051326"
"JH378124","24759467","24759772","chr14","61499082","61499381","39","36739615"
"JH378124","26185466","26185763","chr2","33362197","33362503","44","7176731"
"JH378124","26756141","26756428","chr12","30449003","30449293","38","3692862"
"JH378124","27091937","27092251","chr10","75740191","75740486","64","48648254"
"JH378124","27438666","27438969","chr8","23531210","23531497","59","3907456"
"JH378124","27453571","27453850","chr9","58155888","58156167","37","30702317"
"JH378124","28458362","28458655","chr3","6414985","6415283","40","22043377"
"JH378124","28546183","28546472","chr23","51149623","51149911","37","22603440"
"JH378125","327012","327302","chr15","57645136","57645424","37","57318124"
"JH378125","1473076","1473284","chr22","59313204","59313418","39","57840128"
"JH378125","1473386","1473458","chr5","2445602","2445676","20","972216"
"JH378125","2423240","2423545","chr10","44221705","44222014","43","41798465"
"JH378125","2671346","2671568","chr8","120238157","120238376","30","117566811"
"JH378125","2897578","2897863","chr3","19142444","19142731","40","16244866"
"JH378125","3873173","3873401","chr2","13316902","13317112","57","9443729"
"JH378125","3968822","3969113","chr28","15327544","15327835","32","11358722"
"JH378125","5008549","5008828","chr20","19842108","19842392","46","14833559"
"JH378125","5392879","5393179","chrX","41905010","41905298","40","36512131"
"JH378125","5675665","5675736","chr10","93857219","93857287","22","88181554"
"JH378125","6178783","6178985","chr11","33441548","33441753","44","27262765"
"JH378125","6504475","6504763","chr10","18939692","18939979","41","12435217"
"JH378125","6652036","6652337","chr8","121502988","121503294","45","114850952"
"JH378125","6838099","6838402","chr2","22860155","22860456","42","16022056"
"JH378125","6948351","6948483","chr5","25933140","25933266","33","18984789"
"JH378125","7040115","7040415","chr6","32749709","32750008","52","25709594"
"JH378125","7124992","7125286","chr12","103186024","103186315","46","96061032"
"JH378125","7289364","7289664","chr17","16693959","16694262","39","9404595"
"JH378125","7380457","7380755","chr6","20604921","20605215","40","13224464"
"JH378125","8095442","8095659","chrX","28983794","28984018","57","20888352"
"JH378125","8486762","8487059","chrX","29670774","29671076","48","21184012"
"JH378125","8532329","8532587","chr14","60740033","60740297","54","52207704"
"JH378125","9260201","9260394","chr23","43611135","43611328","40","34350934"
"JH378125","9644307","9644610","chr1","36079803","36080100","38","26435496"
"JH378125","9881467","9881667","chr21","18967230","18967419","37","9085763"
"JH378125","10057794","10058108","chr2","29171160","29171476","56","19113366"
"JH378125","10637759","10638051","chr12","44290728","44291019","41","33652969"
"JH378125","11313588","11313700","chr10","66128392","66128503","16","54814804"
"JH378125","11896342","11896630","chr13","86323276","86323561","70","74426934"
"JH378125","12443520","12443822","chr2","22860155","22860456","47","10416635"
"JH378125","12980375","12980611","chr11","7774263","7774487","55","5206112"
"JH378125","13059604","13059890","chr9","58155888","58156167","42","45096284"
"JH378125","13226621","13226669","chr1","186061","186108","21","13040560"
"JH378125","13226670","13226745","chr14","44990628","44990709","17","31763958"
"JH378125","13931254","13931546","chr12","65356809","65357103","41","51425555"
"JH378125","13985039","13985343","chr9","61932207","61932503","40","47947168"
"JH378125","14099056","14099319","chr25","27453211","27453490","48","13354155"
"JH378125","14101102","14101400","chr4","31811484","31811787","48","17710382"
"JH378125","14121107","14121412","chr20","7876234","7876541","45","6244873"
"JH378125","14159380","14159672","chr11","44998691","44998982","34","30839311"
"JH378125","14376338","14376640","chr2","33362197","33362503","42","18985859"
"JH378125","15075727","15076021","chr23","79133871","79134164","37","64058144"
"JH378125","15129592","15129896","chr4","31811484","31811787","38","16681892"
"JH378125","15170698","15170979","chr16","71130019","71130298","45","55959321"
"JH378125","15212239","15212548","chr2","54312462","54312771","42","39100223"
"JH378125","15294289","15294598","chr19","4670484","4670791","44","10623805"
"JH378125","15742344","15742635","chr21","74307427","74307720","38","58565083"
"JH378125","15995356","15995641","chr9","6382689","6382978","52","9612667"
"JH378125","16115559","16115829","chr26","8970369","8970646","57","7145190"
"JH378125","16283633","16283923","chr24","27110583","27110876","37","10826950"
"JH378125","16752088","16752376","chr17","38569856","38570151","50","21817768"
"JH378125","17178756","17179033","chr14","53650197","53650475","42","36471441"
"JH378125","17444057","17444357","chr8","138976562","138976862","37","121532505"
"JH378125","17444367","17444671","chr18","22102012","22102319","36","4657645"
"JH378125","17618496","17618699","chr1","8274775","8274983","38","9343721"
"JH378125","17661035","17661328","chr26","11209053","11209344","33","6451982"
"JH378125","17967551","17967839","chr16","14422338","14422632","47","3545213"
"JH378125","18186041","18186334","chr18","59850632","59850929","32","41664591"
"JH378125","18763382","18763611","chr10","60038144","60038373","38","41274762"
"JH378125","18764068","18764360","chr11","53236031","53236327","48","34471963"
"JH378125","19125823","19126119","chr6","29394044","29394346","39","10268221"
"JH378125","19234538","19234832","chr12","62505268","62505568","32","43270730"
"JH378125","19241127","19241415","chr9","11828451","11828739","40","7412676"
"JH378125","19415476","19415747","chr10","116055181","116055460","67","96639705"
"JH378125","20032761","20033048","chr22","52015872","52016167","45","31983111"
"JH378125","20432736","20432956","chr13","37121390","37121603","41","16688654"
"JH378125","20433054","20433137","chr15","51574719","51574807","23","31141665"
"JH378125","22699814","22699989","chr3","28939304","28939471","33","6239490"
"JH378125","23406370","23406500","chr8","92651231","92651365","30","69244861"
"JH378125","23555137","23555430","chrX","47726776","47727071","45","24171639"
"JH378125","23818576","23818885","chr16","36007753","36008062","43","12189177"
"JH378125","23940136","23940427","chr11","6630303","6630595","60","17309833"
"JH378125","26780224","26780322","chrX_KE148108v1_random","2493517","2493615","17","24286707"
"JH378125","27226716","27227016","chr21","13146718","13147023","47","14079998"
"JH378125","27324491","27324780","chr8","134729160","134729454","58","107404669"
"JH378125","27521883","27522162","chr20","9842411","9842688","51","17679472"
"JH378126","288606","288780","chr16","59570852","59571033","39","59282246"
"JH378126","339619","339807","chr3","27911177","27911379","43","27571558"
"JH378126","927862","928174","chr1","677235","677538","53","250627"
"JH378126","1000721","1001018","chr11","112865767","112866066","49","111865046"
"JH378126","1177138","1177409","chr9","119241694","119241960","47","118064556"
"JH378126","1467058","1467341","chr12","103186024","103186315","43","101718966"
"JH378126","1684961","1685266","chr20","85656834","85657133","53","83971873"
"JH378126","4032679","4032968","chr9","96272747","96273028","48","92240068"
"JH378126","4692056","4692340","chr7","55740326","55740609","45","51048270"
"JH378126","5049615","5049896","chr9","11828451","11828739","45","6778836"
"JH378126","5525728","5526017","chr19","19336208","19336496","65","13810480"
"JH378126","6275526","6275797","chr14","75250425","75250685","45","68974899"
"JH378126","7038364","7038636","chr12","83448937","83449207","55","76410573"
"JH378126","8680562","8680855","chr11","42708500","42708788","46","34027938"
"JH378126","8900604","8900904","chr26","24027927","24028229","44","15127323"
"JH378126","9209649","9209920","chr21","29485302","29485578","53","20275653"
"JH378126","9302425","9302724","chr12","52562723","52563030","53","43260298"
"JH378126","9808422","9808717","chr9","14090186","14090481","42","4281764"
"JH378126","13912665","13912930","chr2","66937766","66938027","40","53025101"
"JH378126","14601096","14601403","chr11","47411625","47411934","53","32810529"
"JH378126","15297456","15297765","chr18","65492271","65492578","39","50194815"
"JH378126","15848856","15849114","chr25","54386032","54386295","52","38537176"
"JH378126","17394162","17394368","chr1","20346354","20346557","38","2952192"
"JH378126","19521311","19521614","chr20","90303203","90303504","51","70781892"
"JH378126","21940040","21940310","chr17","65551708","65551980","43","43611668"
"JH378126","22031408","22031715","chr16","36007753","36008062","52","13976345"
"JH378126","22044027","22044316","chr12","18705494","18705782","45","3338533"
"JH378126","22504014","22504310","chr1","9360845","9361141","39","13143169"
"JH378126","22931137","22931435","chr11","73973874","73974175","36","51042737"
"JH378126","22990485","22990773","chr1","68990574","68990859","43","46000089"
"JH378126","24140493","24140782","chr3","24930798","24931089","45","790305"
"JH378126","24486271","24486569","chr18","35039565","35039862","42","10553294"
"JH378126","24732699","24733006","chrX","18575272","18575575","38","6157427"
"JH378126","24871019","24871309","chr13","37127275","37127575","53","12256256"
"JH378126","26377558","26377863","chr7","119466216","119466521","42","93088658"
"JH378126","26405439","26405568","chrX","77324374","77324510","22","50918935"
"JH378126","26763553","26763740","chr6","9550495","9550686","29","17213058"
"JH378127","466798","467083","chrX","66837968","66838254","44","66371170"
"JH378127","516404","516693","chr23","81402491","81402780","76","80886087"
"JH378127","532195","532492","chr11","91887378","91887674","59","91355183"
"JH378127","724474","724509","chr5","7080160","7080178","19","6355686"
"JH378127","1052081","1052378","chrX","33027186","33027484","37","31975105"
"JH378127","1690314","1690598","chr2","10339052","10339336","47","8648738"
"JH378127","1797273","1797554","chr6","9604562","9604849","52","7807289"
"JH378127","2253598","2253902","chrX","43777377","43777676","51","41523779"
"JH378127","2381670","2381964","chr9","85636273","85636563","46","83254603"
"JH378127","4573231","4573434","chr7","26338472","26338675","29","21765241"
"JH378127","4857690","4857975","chr2","7721210","7721494","41","2863520"
"JH378127","5109685","5109991","chr22","45546705","45547014","32","40437020"
"JH378127","5110002","5110243","chr20","107997025","107997264","48","102887023"
"JH378127","5309683","5309987","chr23","62385682","62385982","50","57075999"
"JH378127","6026896","6027160","chrX","126577906","126578182","69","120551010"
"JH378127","6036671","6036967","chr5","26884776","26885075","42","20848105"
"JH378127","6298058","6298316","chr5","75072071","75072324","46","68774013"
"JH378127","6768906","6769200","chrX","60403420","60403723","58","53634514"
"JH378127","6940344","6940630","chr2","7721210","7721494","45","780866"
"JH378127","8076540","8076836","chr26","57070585","57070883","37","48994045"
"JH378127","8247802","8248108","chr13","23437891","23438191","42","15190089"
"JH378127","8794357","8794424","chr14","99207960","99208028","13","90413603"
"JH378127","8825834","8826152","chr6","36288281","36288590","45","27462447"
"JH378127","8873605","8873818","chr10","89006976","89007181","38","80133371"
"JH378127","9143376","9143614","chr20","104477833","104478070","44","95334457"
"JH378127","9984351","9984654","chr6","29394044","29394346","42","19409693"
"JH378127","10079174","10079414","chr3","54097857","54098084","45","44018683"
"JH378127","10105800","10105927","chr4","77908589","77908714","17","67802789"
"JH378127","10275214","10275513","chr4","74750244","74750542","42","64475030"
"JH378127","10846613","10846907","chr2","57178242","57178539","43","46331629"
"JH378127","11475400","11475697","chr2","10557335","10557628","50","918065"
"JH378127","11585983","11586286","chr1","20836893","20837193","41","9250910"
"JH378127","11650970","11651270","chr1","29712863","29713163","36","18061893"
"JH378127","11894161","11894265","chrX","11264436","11264549","26","629725"
"JH378127","11894910","11895199","chr28","8917006","8917294","57","2977904"
"JH378127","12427547","12427845","chrX","11078548","11078855","41","1348999"
"JH378127","12747175","12747348","chr9","62372766","62372941","33","49625591"
"JH378127","12945918","12946139","chr11","88797811","88798032","28","75851893"
"JH378127","13055449","13055580","chrX","31589687","31589809","22","18534238"
"JH378127","13214989","13215291","chr6","32749709","32750008","46","19534720"
"JH378127","13269318","13269585","chr14","61597585","61597855","47","48328267"
"JH378127","13386170","13386304","chr9","4882925","4883070","35","8503245"
"JH378127","13386918","13387188","chr1","63915738","63916013","48","50528820"
"JH378127","13821562","13821828","chr14","74080496","74080760","40","60258934"
"JH378127","14507518","14507702","chr19","16893479","16893663","29","2385961"
"JH378127","14941585","14941725","chr25","6369752","6369893","28","8571833"
"JH378127","15001211","15001324","chr22","94574472","94574572","25","79573261"
"JH378127","15010483","15010781","chr23","57612824","57613126","36","42602341"
"JH378127","15126616","15126912","chr25","54930545","54930841","46","39803929"
"JH378127","15467014","15467305","chr1","64953626","64953920","39","49486612"
"JH378127","15468929","15469222","chr24","70960884","70961175","42","55491955"
"JH378127","15653840","15654140","chr6","18852331","18852633","40","3198491"
"JH378127","15973885","15974078","chr5","10938981","10939201","62","5034904"
"JH378127","15998287","15998497","chr10","100143125","100143331","34","84144838"
"JH378127","16725022","16725301","chr2","5238241","5238519","45","11486781"
"JH378127","17513456","17513755","chr19","22145953","22146248","41","4632497"
"JH378127","17849394","17849506","chr26","27840309","27840431","37","9990915"
"JH378127","18069285","18069563","chrX","89385183","89385466","46","71315898"
"JH378127","18595990","18596282","chr2","61035797","61036096","44","42439807"
"JH378127","18624724","18624982","chr1","21908885","21909148","61","3284161"
"JH378127","18831078","18831196","chr2","87262500","87262610","22","68431422"
"JH378127","19023484","19023613","chr5","25933140","25933266","23","6909656"
"JH378127","19316365","19316668","chr26","26868700","26868994","60","7552335"
"JH378127","19983057","19983331","chr2","5238241","5238519","37","14744816"
"JH378127","20831546","20831703","chr11","6506714","6506863","38","14324832"
"JH378127","21178111","21178401","chr11","96237698","96237981","60","75059587"
"JH378127","21231758","21231915","chr8","114449333","114449485","35","93217575"
"JH378127","22079477","22079757","chr12","40164000","40164280","48","18084523"
"JH378127","22105160","22105391","chr8","138179124","138179376","68","116073964"
"JH378127","22159074","22159191","chr21","2508889","2509006","13","19650185"
"JH378127","22286963","22287267","chr4","31811484","31811787","38","9524521"
"JH378127","23230572","23230690","chr9","44129740","44129861","21","20899168"
"JH378127","23850623","23850717","chr19","23677129","23677223","28","173494"
"JH378127","24299842","24300145","chr5","32820601","32820910","44","8520759"
"JH378127","25916003","25916307","chr23","71906236","71906536","40","45990233"
"JH378127","25963211","25963436","chr12","108518404","108518625","33","82555193"
"JH378128","5635969","5636271","chr19","22145953","22146248","61","16509984"
"JH378128","1867497","1867791","chr19","4455651","4455943","49","2588154"
"JH378128","1884222","1884534","chr5","10824452","10824759","57","8940230"
"JH378128","1991241","1991540","chr6","2235183","2235482","47","243942"
"JH378128","2071604","2071685","chr20","27499106","27499181","17","25427502"
"JH378128","2172517","2172750","chr2","65988272","65988503","29","63815755"
"JH378128","2657485","2657786","chr20","103885017","103885310","45","101227532"
"JH378128","2759558","2759703","chr6","13795451","13795605","32","11035893"
"JH378128","3125729","3126035","chr10","82223974","82224279","37","79098245"
"JH378128","3942533","3942810","chr28","8917006","8917294","50","4974473"
"JH378128","3970470","3970723","chr1","50678867","50679117","51","46708397"
"JH378128","4420073","4420358","chr11","24876645","24876927","43","20456572"
"JH378128","4801339","4801649","chr17","40106599","40106905","46","35305260"
"JH378128","5241749","5242066","chr22","14725489","14725798","47","9483740"
"JH378128","6123425","6123689","chr11","4332732","4332996","48","1790693"
"JH378128","6319053","6319350","chr6","49004703","49004998","46","42685650"
"JH378128","7022156","7022471","chr26","33024367","33024673","56","26002211"
"JH378128","7055620","7055907","chr26","26868700","26868994","44","19813080"
"JH378128","7999352","7999652","chr2","33362197","33362503","43","25362845"
"JH378128","8574847","8575142","chr22","52341420","52341721","45","43766573"
"JH378128","8652079","8652216","chr14","33067112","33067242","30","24415033"
"JH378128","8818649","8818957","chrX","37342702","37343011","43","28524053"
"JH378128","9326978","9327273","chr12","18148605","18148902","41","8821627"
"JH378128","10508161","10508472","chr8","121880813","121881121","49","111372652"
"JH378128","10771798","10772091","chr1","64865119","64865416","41","54093321"
"JH378128","10832949","10833114","chr9","122729670","122729833","34","111896721"
"JH378128","11161195","11161451","chr24","67319898","67320148","44","56158703"
"JH378128","11568614","11568901","chr6","3646070","3646335","67","7922544"
"JH378128","11710462","11710680","chr24","47558800","47559017","34","35848338"
"JH378128","12396286","12396555","chr20","13058406","13058680","49","662120"
"JH378128","13042153","13042453","chr16","61943605","61943901","41","48901452"
"JH378128","13100863","13101158","chr22","30234167","30234462","42","17133304"
"JH378128","13211378","13211684","chr16","18299936","18300237","49","5088558"
"JH378128","13649831","13650006","chr3","91778271","91778445","34","78128440"
"JH378128","14686333","14686639","chr11","5659614","5659906","67","9026719"
"JH378128","15069551","15069806","chr6","11215683","11215935","51","3853868"
"JH378128","15095878","15096154","chr15","66867086","66867350","67","51771208"
"JH378128","15607900","15608188","chr13","62781204","62781489","55","47173304"
"JH378128","15968925","15969198","chr19","21107721","21107998","70","5138796"
"JH378128","16523127","16523250","chr10","103943544","103943665","28","87420417"
"JH378128","16913797","16914016","chr5","54895761","54895974","61","37981964"
"JH378128","17834504","17834813","chr5","26026229","26026536","45","8191725"
"JH378128","21109020","21109139","chr1","7047997","7048113","22","14061023"
"JH378128","22181483","22181771","chr24","7989911","7990199","44","14191572"
"JH378128","23014065","23014370","chr14","61499082","61499381","39","38485017"
"JH378128","23112131","23112449","chr10","39012436","39012740","59","15900305"
"JH378128","23726185","23726336","chr21","99460334","99460473","30","75734149"
"JH378128","24080884","24081191","chr10","77202412","77202718","38","53121528"
"JH378128","24311035","24311325","chr11","42708500","42708788","42","18397465"
"JH378128","24459426","24459671","chr14","45516246","45516500","43","21056820"
"JH378128","24982183","24982466","chr27","46614616","46614910","53","21632433"
"JH378129","2883326","2883624","chr16","70729210","70729502","40","67845884"
"JH378129","901756","902019","chr14","60740033","60740297","42","59838277"
"JH378129","1029375","1029659","chr20","2854395","2854680","36","1825020"
"JH378129","1328476","1328768","chr10","104330612","104330907","42","103002136"
"JH378129","1344401","1344707","chr6","1136364","1136672","41","208037"
"JH378129","1374820","1375109","chr15","62977156","62977449","38","61602336"
"JH378129","1964368","1964672","chr11","113615804","113616083","73","111651436"
"JH378129","2003280","2003562","chr14","45592971","45593246","62","43589691"
"JH378129","2019403","2019714","chr17","16693959","16694262","51","14674556"
"JH378129","2239574","2239703","chr2","70699454","70699583","18","68459880"
"JH378129","2450530","2450736","chr8","51214368","51214580","46","48763838"
"JH378129","2983522","2983613","chr19","20678473","20678556","29","17694951"
"JH378129","3115399","3115689","chr9","24595991","24596279","42","21480592"
"JH378129","3318719","3319002","chr11","83560875","83561170","48","80242156"
"JH378129","3393064","3393353","chr11","42708500","42708788","41","39315436"
"JH378129","4901086","4901380","chrX","33027186","33027484","33","28126100"
"JH378129","5122555","5122649","chr22","94574472","94574572","22","89451917"
"JH378129","5531743","5532044","chr5","34361928","34362228","47","28830185"
"JH378129","6026900","6027059","chr13","61564391","61564541","29","55537491"
"JH378129","6407679","6407980","chr20","104985298","104985598","40","98577619"
"JH378129","7909758","7910021","chr23","29726953","29727218","50","21817195"
"JH378129","10142898","10143191","chr20","2854395","2854680","47","7288503"
"JH378129","10151821","10151928","chr2","63172174","63172281","18","53020353"
"JH378129","10254707","10254976","chr1","23837818","23838095","45","13583111"
"JH378129","10363732","10363848","chr2","14267810","14267928","24","3904078"
"JH378129","10475849","10476145","chr15","76465178","76465474","39","65989329"
"JH378129","10612167","10612466","chr3","4720558","4720866","54","5891609"
"JH378129","10647135","10647418","chr16","58327777","58328064","40","47680642"
"JH378129","10701445","10701713","chr2_AQIB01158150v1_random","7269","7532","51","10694176"
"JH378129","11035296","11035524","chr7","57513437","57513664","34","46478141"
"JH378129","11354955","11355241","chr16","33551674","33551968","55","22196719"
"JH378129","11521479","11521779","chr1","31259486","31259780","40","19738007"
"JH378129","11531963","11532237","chrX","32243062","32243337","41","20711099"
"JH378129","11815831","11816136","chr1","125024996","125025302","37","113209165"
"JH378129","12027947","12028250","chr2","54312462","54312771","50","42284515"
"JH378129","12143016","12143332","chr14","61349438","61349746","63","49206422"
"JH378129","12238577","12238707","chr1","77159136","77159266","35","64920559"
"JH378129","12242150","12242376","chrX","92178511","92178733","41","79936361"
"JH378129","12297335","12297541","chr8","51214368","51214580","36","38917033"
"JH378129","12306199","12306350","chr17","16580478","16580635","33","4274279"
"JH378129","12329892","12330200","chr18","65492271","65492578","44","53162379"
"JH378129","12395687","12395972","chr14","89802144","89802429","36","77406457"
"JH378129","12442312","12442609","chr12","3898076","3898379","50","8544236"
"JH378129","12591995","12592291","chr10","21171624","21171917","43","8579629"
"JH378129","13318752","13319060","chr8","100037545","100037817","73","86718793"
"JH378129","13491343","13491558","chr1","55208231","55208438","38","41716888"
"JH378129","13504821","13505129","chr25","25558841","25559144","48","12054020"
"JH378129","13623597","13623885","chr11","42708500","42708788","36","29084903"
"JH378129","14057964","14058261","chr19","27584635","27584934","41","13526671"
"JH378129","14095865","14096143","chr23","51149623","51149911","45","37053758"
"JH378129","14467876","14468138","chrX","126577906","126578182","56","112110030"
"JH378129","15078468","15078768","chr23","57612824","57613126","48","42534356"
"JH378129","15888929","15889242","chr12","15293737","15294044","55","595192"
"JH378129","16809830","16810123","chr18","71127519","71127809","37","54317689"
"JH378129","17219029","17219301","chr26","4458411","4458686","50","12760618"
"JH378129","18127627","18127907","chr13","86323276","86323561","38","68195649"
"JH378129","18999782","18999899","chr7","106999873","106999998","31","88000091"
"JH378129","20070674","20070794","chr2","4976621","4976741","20","15094053"
"JH378129","20173493","20173749","chr11","118892467","118892729","41","98718974"
"JH378129","20187442","20187680","chr11","105858746","105858992","43","85671304"
"JH378129","20687772","20688065","chrX","23470949","23471243","43","2783177"
"JH378129","21402391","21402574","chr19","16893479","16893663","20","4508912"
"JH378129","21731581","21731875","chr20","97098637","97098929","51","75367056"
"JH378129","21767047","21767179","chr23","57002695","57002826","16","35235648"
"JH378129","21921362","21921583","chr12","108518404","108518625","43","86597042"
"JH378129","22330427","22330731","chr12","62505268","62505568","48","40174841"
"JH378129","22346142","22346287","chr10","56563339","56563485","29","34217197"
"JH378129","22762700","22762969","chr14","75250425","75250685","46","52487725"
"JH378129","24862526","24862787","chr2","66937766","66938027","60","42075240"
"JH378130","116","344","chr12","108518404","108518625","41","108518288"
"JH378130","8113","8375","chr12","72756184","72756452","54","72748071"
"JH378130","94156","94453","chr20","90303203","90303504","51","90209047"
"JH378130","144696","144984","chr18","48372580","48372868","41","48227884"
"JH378130","1237212","1237506","chr16","24549619","24549911","44","23312407"
"JH378130","1336021","1336307","chr7","91843770","91844065","56","90507749"
"JH378130","1708775","1708903","chr20","106252780","106252912","13","104544005"
"JH378130","1759811","1760105","chr11","47267698","47267990","54","45507887"
"JH378130","1792982","1793106","chr4","77908589","77908714","16","76115607"
"JH378130","2176664","2176959","chr11","83560875","83561170","56","81384211"
"JH378130","2515876","2515983","chr2","4976621","4976741","33","2460745"
"JH378130","2819273","2819571","chr18","59834146","59834452","50","57014873"
"JH378130","3369041","3369337","chr12","62505268","62505568","42","59136227"
"JH378130","3588201","3588483","chr7","116251443","116251737","54","112663242"
"JH378130","4277593","4277877","chr16","71130019","71130298","42","66852426"
"JH378130","4771162","4771465","chr3","27047348","27047655","47","22276186"
"JH378130","5479146","5479457","chrX","10891227","10891532","53","5412081"
"JH378130","5755757","5756079","chrX_KE148108v1_random","4599625","4599934","62","1156132"
"JH378130","6385435","6385690","chr1","50678867","50679117","43","44293432"
"JH378130","6775798","6776120","chr1","125024996","125025302","60","118249198"
"JH378130","7011468","7011775","chrX","109019895","109020211","82","102008427"
"JH378130","7693761","7694044","chr3","88516944","88517224","51","80823183"
"JH378130","7701268","7701566","chr2","54312462","54312771","44","46611194"
"JH378130","7804163","7804421","chr4","90750684","90750957","57","82946521"
"JH378130","7954922","7955215","chr8","122071808","122072100","52","114116886"
"JH378130","8096154","8096432","chr10","55562512","55562784","57","47466358"
"JH378130","8104725","8104988","chr18","44693649","44693911","45","36588924"
"JH378130","8297630","8297901","chr7","108418621","108418894","47","100120991"
"JH378130","8545990","8546284","chr22","74065039","74065314","58","65519049"
"JH378130","8632321","8632622","chr1","98960303","98960603","50","90327982"
"JH378130","8688577","8688681","chr8","78735337","78735439","18","70046760"
"JH378130","9452801","9453084","chr20_KE148049v1_random","1366044","1366320","49","8086757"
"JH378130","9623751","9624061","chr11","53164231","53164531","56","43540480"
"JH378130","9825335","9825662","chr8","95859478","95859783","62","86034143"
"JH378130","10186408","10186648","chr9","57398632","57398875","58","47212224"
"JH378130","11117560","11117870","chr11","116558393","116558699","41","105440833"
"JH378130","11133446","11133727","chr11","112865767","112866066","60","101732321"
"JH378130","11707270","11707450","chr5","192637","192820","26","11514633"
"JH378130","12166990","12167266","chr12","41367876","41368167","50","29200886"
"JH378130","12712682","12712998","chr18","70941881","70942195","47","58229199"
"JH378130","13232401","13232647","chr1","41979357","41979596","48","28746956"
"JH378130","13232648","13232770","chr20","90491182","90491314","29","77258534"
"JH378130","14306717","14306902","chr11","78449878","78450062","45","64143161"
"JH378130","18714533","18714611","chr10","93857116","93857194","18","75142583"
"JH378130","19147618","19147951","chr19","22626676","22626983","82","3479058"
"JH378130","20457681","20457974","chr16","6528379","6528669","43","13929302"
"JH378130","21671462","21671562","chr21","103512848","103512947","19","81841386"
"JH378130","21981784","21981884","chr21","19920396","19920505","21","2061388"
"JH378130","23845313","23845586","chr11","88314499","88314794","55","64469186"
"JH378130","23891771","23892069","chr11","47267698","47267990","52","23375927"
"JH378130","23918385","23918498","chr3","54517299","54517407","34","30598914"
"JH378130","24370954","24371226","chr14","67795061","67795345","56","43424107"
"JH378131","31848","31982","chr25","29458811","29458944","18","29426963"
"JH378131","96235","96355","chr2","4976621","4976741","24","4880386"
"JH378131","128394","128659","chr12","72756184","72756452","49","72627790"
"JH378131","214121","214426","chr23","49548546","49548845","49","49334425"
"JH378131","252403","252686","chr1","29621888","29622188","47","29369485"
"JH378131","366434","366562","chr6","4471309","4471442","23","4104875"
"JH378131","476567","476867","chr12","82648127","82648418","47","82171560"
"JH378131","905442","905579","chrUn_AQIB01158800v1","1","125","32","905441"
"JH378131","1095104","1095183","chr1","21908799","21908872","28","20813695"
"JH378131","1119590","1119883","chr11","90535443","90535733","49","89415853"
"JH378131","1122855","1123149","chr20","80617936","80618232","37","79495081"
"JH378131","1209539","1209834","chr27","24896939","24897237","46","23687400"
"JH378131","1346902","1347208","chr5","54600933","54601231","39","53254031"
"JH378131","1540049","1540344","chrX","47726776","47727071","38","46186727"
"JH378131","1918211","1918520","chr16","36007753","36008062","36","34089542"
"JH378131","2022354","2022634","chr9","105575072","105575353","41","103552718"
"JH378131","2836687","2836818","chr28","12031940","12032076","32","9195253"
"JH378131","3266730","3267033","chr12","52562723","52563030","47","49295993"
"JH378131","3962808","3963078","chr27","5447935","5448211","66","1485127"
"JH378131","4494379","4494669","chr5","53285593","53285884","47","48791214"
"JH378131","5110320","5110623","chr1","31259486","31259780","45","26149166"
"JH378131","5134545","5134681","chrX","77324374","77324510","20","72189829"
"JH378131","5224005","5224298","chr12","79663159","79663453","34","74439154"
"JH378131","5249445","5249739","chr9","38837074","38837370","37","33587629"
"JH378131","5293005","5293291","chr11","42708500","42708788","41","37415495"
"JH378131","6683702","6683835","chr29","17121091","17121216","36","10437389"
"JH378131","6696021","6696271","chr24","80508974","80509233","62","73812953"
"JH378131","7481001","7481301","chr11","40043815","40044105","49","32562814"
"JH378131","7782211","7782512","chr3","10998901","10999200","51","3216690"
"JH378131","8034898","8035182","chr11","9923400","9923670","55","1888502"
"JH378131","8698484","8698770","chr9","6382689","6382978","46","2315795"
"JH378131","8866132","8866437","chr22","47240034","47240339","53","38373902"
"JH378131","9305089","9305407","chr12","19277707","19278020","51","9972618"
"JH378131","9399774","9400030","chr5","43989885","43990146","46","34590111"
"JH378131","10420552","10420872","chr17","27039242","27039550","63","16618690"
"JH378131","10987324","10987620","chr28","15327544","15327835","53","4340220"
"JH378131","11167486","11167786","chr29","3010474","3010774","41","8157012"
"JH378131","11209696","11209950","chr4","14253886","14254130","48","3044190"
"JH378131","11421020","11421306","chr16","53033143","53033426","40","41612123"
"JH378131","11632452","11632693","chr3","25922879","25923130","40","14290427"
"JH378131","11687748","11688045","chr2","61035797","61036096","43","49348049"
"JH378131","11790774","11790959","chr8","112629520","112629695","33","100838746"
"JH378131","12628154","12628447","chrX","47726776","47727071","35","35098622"
"JH378131","12807675","12807904","chr9","57732450","57732667","41","44924775"
"JH378131","13036392","13036612","chr20","111770346","111770564","33","98733954"
"JH378131","13238977","13239283","chr12","45962018","45962309","54","32723041"
"JH378131","13362730","13363059","chr5","60824315","60824624","71","47461585"
"JH378131","13552176","13552473","chr6","32749709","32750008","35","19197533"
"JH378131","13797693","13797998","chr7","119466216","119466521","42","105668523"
"JH378131","15804724","15805039","chr1","124161627","124161932","44","108356903"
"JH378131","16012299","16012611","chr1","20836893","20837193","57","4824594"
"JH378131","16134065","16134358","chr12","65356809","65357103","48","49222744"
"JH378131","16181299","16181591","chr8","7331653","7331946","39","8849646"
"JH378131","16198945","16199059","chr16","58247487","58247609","30","42048542"
"JH378131","16206308","16206596","chr12","73372231","73372515","49","57165923"
"JH378131","16362965","16363273","chr13","34539616","34539925","47","18176651"
"JH378131","18070581","18070712","chr8","120450677","120450792","37","102380096"
"JH378131","18647789","18648081","chr6","16935358","16935648","45","1712431"
"JH378131","20067027","20067329","chr11","74723467","74723764","53","54656440"
"JH378131","21951018","21951298","chr8","51467183","51467461","51","29516165"
"JH378131","22423910","22424197","chr11","42708500","42708788","48","20284590"
"JH378131","22570328","22570626","chr7","42923647","42923938","52","20353319"
"JH378131","22687551","22687860","chr5","10824452","10824759","49","11863099"
"JH378131","22733785","22734060","chr1","68970266","68970543","42","46236481"
"JH378131","22778393","22778688","chr26","16065185","16065476","39","6713208"
"JH378131","23097557","23097847","chr11","127415663","127415952","50","104318106"
"JH378131","23098448","23098572","chr2","4976621","4976741","23","18121827"
"JH378131","23501395","23501651","chr1","18300604","18300863","40","5200791"
"JH378131","23639267","23639535","chr9","1816543","1816811","39","21822724"
"JH378131","23645767","23646067","chr16","57032948","57033254","50","33387181"
"JH378131","23708414","23708713","chr8","20072572","20072880","49","3635842"
"JH378131","24095152","24095445","chr12","103186024","103186315","62","79090872"
"JH378132","761501","761771","chr23","40664623","40664894","55","39903122"
"JH378132","762620","762957","chr6","10540061","10540366","71","9777441"
"JH378132","1932939","1933238","chr12","25210001","25210293","47","23277062"
"JH378132","2057736","2058039","chr23","41454856","41455159","36","39397120"
"JH378132","2139890","2140195","chr7","91843770","91844065","60","89703880"
"JH378132","2802711","2802813","chr8","57977187","57977292","20","55174476"
"JH378132","2853775","2854076","chrX","60403420","60403723","40","57549645"
"JH378132","2877007","2877280","chr10","63585093","63585357","57","60708086"
"JH378132","3589836","3590146","chr2","54312462","54312771","38","50722626"
"JH378132","5096363","5096657","chr9","17799612","17799903","57","12703249"
"JH378132","5454747","5455033","chr3","6022508","6022797","42","567761"
"JH378132","5477386","5477688","chr1","20836893","20837193","43","15359507"
"JH378132","5968402","5968696","chr3","26133895","26134193","38","20165493"
"JH378132","6705505","6705836","chr16","33540006","33540315","68","26834501"
"JH378132","6727382","6727548","chr4","66826794","66826969","38","60099412"
"JH378132","6956868","6957171","chr1","125024996","125025302","39","118068128"
"JH378132","7410163","7410442","chr29","4259612","4259893","46","3150551"
"JH378132","7892297","7892603","chr1","68581324","68581621","57","60689027"
"JH378132","8219637","8219933","chr1","119397052","119397342","49","111177415"
"JH378132","8796859","8797164","chrX","126202780","126203078","44","117405921"
"JH378132","8866992","8867280","chr12","39125555","39125840","41","30258563"
"JH378132","9430156","9430283","chr22","3180119","3180245","23","6250037"
"JH378132","9625210","9625321","chr2","30454897","30455000","47","20829687"
"JH378132","9664728","9665023","chr23","80642893","80643191","57","70978165"
"JH378132","10344294","10344540","chr22","9520134","9520352","62","824160"
"JH378132","10476553","10476857","chr19","27584635","27584934","44","17108082"
"JH378132","10513552","10513835","chr2","47509921","47510201","65","36996369"
"JH378132","11467992","11468257","chr11","29396564","29396830","56","17928572"
"JH378132","11485173","11485378","chr13","96152783","96152983","38","84667610"
"JH378132","12203864","12204138","chr3","6259071","6259348","38","5944793"
"JH378132","12711201","12711497","chr9","78073476","78073771","44","65362275"
"JH378132","12849789","12850078","chrX","38186867","38187158","41","25337078"
"JH378132","14368733","14369028","chr7_AQIB01159043v1_random","18062","18357","40","14350671"
"JH378132","16142522","16142810","chr10","104330612","104330907","45","88188090"
"JH378132","16471783","16472090","chr1","29712863","29713163","60","13241080"
"JH378132","18439398","18439671","chr13","34406931","34407219","58","15967533"
"JH378132","19038220","19038534","chr4","73421373","73421681","46","54383153"
"JH378132","20248858","20249144","chr23","34060209","34060496","38","13811351"
"JH378132","20273724","20274035","chr16","36007753","36008062","54","15734029"
"JH378132","20778382","20778489","chr6","29480212","29480322","19","8701830"
"JH378132","20889623","20889950","chr23","37388023","37388329","64","16498400"
"JH378132","21007131","21007423","chr16","70729210","70729502","45","49722079"
"JH378132","21417423","21417687","chr14","60740033","60740297","55","39322610"
"JH378132","21779188","21779493","chr5","10824452","10824759","51","10954736"
"JH378132","22291600","22291730","chr6","37703627","37703760","20","15412027"
"JH378132","22306418","22306718","chr15","2000778","2001083","39","20305640"
"JH378132","22380238","22380381","chr21","125448935","125449073","24","103068697"
"JH378132","22468395","22468571","chr14","52418990","52419165","29","29950595"
"JH378132","22475370","22475649","chr25","27453211","27453490","48","4977841"
"JH378132","22938577","22938879","chr13","38731809","38732113","46","15793232"
"JH378133","99177","99464","chr10","55092261","55092557","42","54993084"
"JH378133","714228","714486","chr4","23997845","23998097","57","23283617"
"JH378133","1664656","1664945","chr23","38922269","38922564","44","37257613"
"JH378133","1831231","1831502","chrX","46595117","46595394","45","44763886"
"JH378133","2039724","2040038","chr16","57335675","57335985","49","55295951"
"JH378133","3167564","3167863","chr8","20072572","20072880","51","16905008"
"JH378133","3335429","3335670","chr11","105858746","105858992","36","102523317"
"JH378133","4193716","4194010","chr5","69299877","69300170","46","65106161"
"JH378133","4302617","4302924","chr23","79133871","79134164","57","74831254"
"JH378133","4592410","4592689","chr12","31899150","31899427","40","27306740"
"JH378133","5062353","5062622","chr25","85169491","85169762","43","80107138"
"JH378133","5284113","5284417","chr16","66139074","66139369","50","60854961"
"JH378133","5795425","5795720","chr27","11295804","11296100","39","5500379"
"JH378133","6928680","6928885","chr3","76063430","76063623","38","69134750"
"JH378133","7050747","7051057","chr16","42524176","42524469","49","35473429"
"JH378133","7534244","7534559","chr5","32677022","32677328","66","25142778"
"JH378133","7979284","7979578","chr10","87920761","87921058","50","79941477"
"JH378133","8147729","8148008","chr6","50164890","50165177","46","42017161"
"JH378133","8379697","8379983","chrX","6571847","6572139","44","1807850"
"JH378133","8666856","8666939","chr10","39386471","39386543","24","30719615"
"JH378133","8754106","8754390","chr20","111548650","111548931","55","102794544"
"JH378133","8964177","8964461","chr20","2854395","2854680","39","6109782"
"JH378133","9056542","9056721","chrX","238563","238744","30","8817979"
"JH378133","9141528","9141763","chrX","92178511","92178733","53","83036983"
"JH378133","9331254","9331550","chr16","66139074","66139369","32","56807820"
"JH378133","9334186","9334458","chr5","54825245","54825525","50","45491059"
"JH378133","9569342","9569523","chr5","192637","192820","26","9376705"
"JH378133","9625189","9625489","chr16","66139074","66139369","55","56513885"
"JH378133","9940479","9940778","chr7","91843770","91844065","59","81903291"
"JH378133","11024931","11025237","chr7","119466216","119466521","38","108441285"
"JH378133","11719728","11720014","chr16","17103242","17103520","43","5383514"
"JH378133","12138028","12138307","chr9","80798088","80798364","61","68660060"
"JH378133","15952354","15952622","chr14","61597585","61597855","44","45645231"
"JH378133","16173031","16173303","chr5","66352492","66352757","47","50179461"
"JH378133","16910633","16910767","chr5","44499469","44499605","33","27588836"
"JH378133","17004357","17004649","chr11","47267698","47267990","54","30263341"
"JH378133","17211667","17211950","chr11","9923400","9923670","60","7288267"
"JH378133","20404000","20404239","chr12","15320158","15320403","37","5083842"
"JH378133","21271014","21271259","chrX_KE148108v1_random","5211050","5211291","44","16059964"
"JH378133","21817018","21817290","chr1","29294849","29295125","45","7477831"
"JH378133","22090980","22091272","chr21","48106444","48106729","48","26015464"
"JH378133","22157441","22157577","chr9","32125196","32125331","25","9967755"
"JH378134","912492","912807","chr12","29549649","29549958","63","28637157"
"JH378134","918650","918945","chr20","116376251","116376549","49","115457601"
"JH378134","1051502","1051716","chr11","7774263","7774487","40","6722761"
"JH378134","1421674","1421948","chr20","118736380","118736663","57","117314706"
"JH378134","2356750","2357050","chr20","105708807","105709105","52","103352057"
"JH378134","2696963","2697242","chr20","9842411","9842688","51","7145448"
"JH378134","3047611","3047874","chr25","28732748","28733009","42","25685137"
"JH378134","3435940","3436174","chr7","57513437","57513664","48","54077497"
"JH378134","4166017","4166218","chr8","74679906","74680079","63","70513889"
"JH378134","6123100","6123372","chr1","24159641","24159900","54","18036541"
"JH378134","6425984","6426061","chrX","38462565","38462648","25","32036581"
"JH378134","7160970","7161271","chr1","109924260","109924555","50","102763290"
"JH378134","7222855","7223165","chr20","20540590","20540902","87","13317735"
"JH378134","7573855","7574151","chr7","19172829","19173113","74","11598974"
"JH378134","8670810","8671112","chr12","72996428","72996729","41","64325618"
"JH378134","8724638","8724934","chr7","134574240","134574527","74","125849602"
"JH378134","8987631","8987902","chr3","6259071","6259348","42","2728560"
"JH378134","10147315","10147500","chr11","117722922","117723099","33","107575607"
"JH378134","10293900","10294076","chrX","66835729","66835905","37","56541829"
"JH378134","11206906","11207116","chrX","129744426","129744635","45","118537520"
"JH378134","11402148","11402439","chr7","57273431","57273708","58","45871283"
"JH378134","11770496","11770755","chr17","38305843","38306098","46","26535347"
"JH378134","12570487","12570740","chr5","72051782","72052054","62","59481295"
"JH378134","13534651","13534749","chr6","11844044","11844146","21","1690607"
"JH378134","13605727","13605918","chr14","830872","831067","34","12774855"
"JH378134","13877504","13877672","chr9","56425008","56425194","46","42547504"
"JH378134","14131746","14132017","chr14","61597585","61597855","39","47465839"
"JH378134","14975601","14975910","chr1","33477981","33478289","39","18502380"
"JH378134","15061796","15062072","chr10","55562512","55562784","50","40500716"
"JH378134","15087841","15088094","chr1","62973229","62973484","54","47885388"
"JH378134","15398443","15398742","chr12","62505268","62505568","35","47106825"
"JH378134","15724470","15724753","chrX","6571847","6572139","49","9152623"
"JH378134","15793435","15793745","chr14","61597253","61597561","45","45803818"
"JH378134","15856351","15856643","chr26","16423084","16423376","41","566733"
"JH378134","15969031","15969282","chr10","127587035","127587285","43","111618004"
"JH378134","16063397","16063541","chr17","61823129","61823273","25","45759732"
"JH378134","16328591","16328700","chr8","40990809","40990921","28","24662218"
"JH378134","16648301","16648528","chr2","65988272","65988503","32","49339971"
"JH378134","16805960","16806257","chr10","55092261","55092557","37","38286301"
"JH378134","16839055","16839361","chr6","10540061","10540366","50","6298994"
"JH378134","17063037","17063323","chr24","40072459","40072748","37","23009422"
"JH378134","17159643","17159871","chr18","9905435","9905663","47","7254208"
"JH378134","17247968","17248229","chr1","84078127","84078396","78","66830159"
"JH378134","17362457","17362612","chr7","72961203","72961346","48","55598746"
"JH378134","17595330","17595632","chr12","64183477","64183775","33","46588147"
"JH378134","17789645","17789897","chr6","45579600","45579859","64","27789955"
"JH378134","18039081","18039358","chr29","4259612","4259893","48","13779469"
"JH378134","18049969","18050259","chr24","52715350","52715638","37","34665381"
"JH378134","18375604","18375904","chr20","36468992","36469298","43","18093388"
"JH378134","18465480","18465749","chr4","90750684","90750957","46","72285204"
"JH378134","18509117","18509389","chr11","4332732","4332996","32","14176385"
"JH378134","18536675","18536953","chr22","9226203","9226481","40","9310472"
"JH378134","18993340","18993472","chr6","37703627","37703760","24","18710287"
"JH378134","19197816","19197970","chr22","27074075","27074227","26","7876259"
"JH378134","19199602","19199865","chr4","36106904","36107172","49","16907302"
"JH378134","19888705","19888975","chr23","80040682","80040974","55","60151977"
"JH378134","19928189","19928482","chr12","45962018","45962309","41","26033829"
"JH378134","20158681","20158895","chr14","74021868","74022082","40","53863187"
"JH378134","20455745","20456035","chr11","112865767","112866066","49","92410022"
"JH378134","20902698","20903000","chrX","60403420","60403723","50","39500722"
"JH378134","21212775","21213079","chr23","34060209","34060496","66","12847434"
"JH378134","21457503","21457807","chr25","27839006","27839308","35","6381503"
"JH378134","21674760","21675074","chr11","40362198","40362503","57","18687438"
"JH378134","22453013","22453323","chr29","3711047","3711343","47","18741966"
"JH378135","462895","463056","chrX","29833617","29833775","36","29370722"
"JH378135","484784","485026","chr9","86755766","86756000","62","86270982"
"JH378135","633665","633927","chr14","61597585","61597855","39","60963920"
"JH378135","668641","668772","chr13","80405244","80405376","21","79736603"
"JH378135","1030336","1030602","chr7","57513437","57513664","67","56483101"
"JH378135","1031030","1031105","chr19","20678473","20678556","19","19647443"
"JH378135","1052499","1052816","chr10","59437483","59437798","61","58384984"
"JH378135","1132102","1132393","chr12","79663159","79663453","39","78531057"
"JH378135","1532242","1532541","chr1","29621888","29622188","35","28089646"
"JH378135","1546416","1546709","chr12","65356809","65357103","35","63810393"
"JH378135","1704787","1705059","chr6","31277843","31278132","58","29573056"
"JH378135","2456685","2456996","chr28","10271566","10271865","47","7814881"
"JH378135","3333260","3333360","chr6","29480212","29480322","21","26146952"
"JH378135","3442846","3443151","chr9","6382689","6382978","57","2939843"
"JH378135","3789837","3790117","chr1","10737262","10737562","66","6947425"
"JH378135","4390531","4390830","chr4","65357267","65357566","38","60966736"
"JH378135","4540195","4540490","chr12","45962018","45962309","34","41421823"
"JH378135","4619771","4620051","chr12","108171343","108171621","39","103551572"
"JH378135","4993678","4993865","chr12","43962243","43962428","42","38968565"
"JH378135","5054317","5054487","chr6","45412468","45412650","43","40358151"
"JH378135","5384186","5384494","chr7","49482276","49482577","50","44098090"
"JH378135","5408143","5408364","chr20","109309565","109309789","42","103901422"
"JH378135","5499191","5499392","chr19","12992619","12992824","42","7493428"
"JH378135","5542342","5542651","chr12","72899340","72899646","43","67356998"
"JH378135","5689421","5689688","chr24","42639656","42639923","43","36950235"
"JH378135","5781149","5781389","chr17","24468408","24468643","47","18687259"
"JH378135","6099234","6099284","chr22","74065325","74065376","9","67966091"
"JH378135","6254338","6254622","chr1","16838288","16838572","47","10583950"
"JH378135","6389601","6389909","chr16","1150044","1150347","50","5239557"
"JH378135","6440593","6440890","chrX","43777377","43777676","42","37336784"
"JH378135","7398661","7398927","chr6","19556533","19556792","55","12157872"
"JH378135","7734579","7734868","chr13","89187148","89187443","55","81452569"
"JH378135","8096221","8096359","chr9","65878775","65878915","26","57782554"
"JH378135","8099475","8099760","chr13","67198097","67198382","49","59098622"
"JH378135","8471391","8471700","chr12","86891380","86891688","41","78419989"
"JH378135","9037180","9037461","chr16","71130019","71130298","54","62092839"
"JH378135","9879560","9879696","chr22","3180119","3180245","22","6699441"
"JH378135","10000960","10001291","chr19","32408780","32409083","68","22407820"
"JH378135","10183106","10183400","chr10","57547890","57548186","40","47364784"
"JH378135","12567300","12567423","chr13","93936933","93937062","18","81369633"
"JH378135","13271850","13272088","chr10","82421989","82422214","46","69150139"
"JH378135","13301022","13301139","chr27","48328000","48328117","20","35026978"
"JH378135","13382344","13382651","chr22","9714838","9715138","39","3667506"
"JH378135","13478171","13478467","chr1","50678867","50679117","79","37200696"
"JH378135","15291658","15291878","chr3","54097857","54098084","37","38806199"
"JH378135","15307069","15307370","chr11","47411625","47411934","45","32104556"
"JH378135","15389593","15389857","chr13","20142235","20142496","43","4752642"
"JH378135","15404011","15404217","chr2","13316902","13317112","41","2087109"
"JH378135","15417945","15417999","chr5","2445602","2445676","22","12972343"
"JH378135","15418920","15419047","chr23","44842799","44842925","30","29423879"
"JH378135","15419353","15419469","chr10","57390608","57390714","32","41971255"
"JH378135","15700527","15700842","chr9","46624912","46625212","47","30924385"
"JH378135","16110056","16110348","chr23","71906236","71906536","56","55796180"
"JH378135","16284937","16285070","chr4","90460665","90460796","22","74175728"
"JH378135","17804126","17804393","chr5","72051782","72052054","51","54247656"
"JH378135","18034383","18034703","chr7","30250588","30250897","56","12216205"
"JH378135","18676771","18677044","chrX","85829317","85829602","51","67152546"
"JH378135","18703803","18704118","chr10","119350464","119350773","60","100646661"
"JH378135","18946994","18947191","chr24","11947136","11947332","32","6999858"
"JH378135","19248606","19248922","chr22","70384752","70385069","46","51136146"
"JH378135","19652777","19653072","chr20","110642932","110643228","43","90990155"
"JH378135","19694617","19694918","chr22","30234167","30234462","53","10539550"
"JH378135","19980928","19981246","chr7","119466216","119466521","55","99485288"
"JH378135","20008021","20008325","chr1","10964645","10964948","40","9043376"
"JH378135","20240582","20240898","chr8","102187954","102188258","57","81947372"
"JH378135","20285905","20286199","chr6","18856457","18856747","39","1429448"
"JH378135","20446322","20446603","chr11","12552639","12552924","38","7893683"
"JH378135","20559515","20559713","chr13","96152783","96152983","46","75593268"
"JH378135","20671135","20671444","chr14","3111155","3111464","40","17559980"
"JH378135","21167293","21167564","chr14","33993071","33993339","50","12825778"
"JH378135","21506558","21506866","chr13","23437891","23438191","54","1931333"
"JH378135","21559296","21559579","chr9","18313882","18314160","60","3245414"
"JH378135","21560471","21560760","chr17","50641426","50641718","47","29080955"
"JH378135","21642762","21643023","chr19","23425164","23425442","61","1782402"
"JH378135","21702802","21703101","chr3","30187575","30187872","46","8484773"
"JH378135","21803251","21803418","chr5","14308413","14308583","18","7494838"
"JH378136","932214","932333","chr10","82963214","82963322","36","82031000"
"JH378136","1042738","1043034","chr1","113325394","113325698","57","112282656"
"JH378136","2699990","2700288","chr10","57547890","57548186","50","54847900"
"JH378136","2736509","2736798","chr16","14422338","14422632","41","11685829"
"JH378136","2936888","2937167","chr16","17103242","17103520","34","14166354"
"JH378136","3454189","3454491","chr12","72899340","72899646","48","69445151"
"JH378136","3701410","3701714","chr6","36288281","36288590","45","32586871"
"JH378136","3956159","3956318","chr7","100001570","100001727","31","96045411"
"JH378136","4267976","4268273","chr4","74248285","74248581","45","69980309"
"JH378136","6209462","6209764","chr10","89318076","89318373","35","83108614"
"JH378136","6248637","6248939","chr1","22014129","22014427","45","15765492"
"JH378136","7033293","7033601","chr11","26291826","26292124","52","19258533"
"JH378136","7194004","7194235","chr12","83070817","83071048","35","75876813"
"JH378136","7274197","7274491","chr16","58839580","58839876","51","51565383"
"JH378136","7292283","7292588","chr14","68359125","68359423","45","61066842"
"JH378136","7327681","7327976","chr20","110642932","110643228","43","103315251"
"JH378136","7369059","7369338","chr18","48953277","48953567","43","41584218"
"JH378136","7641220","7641361","chr21","99460334","99460473","22","91819114"
"JH378136","8602007","8602308","chr13","45133548","45133846","42","36531541"
"JH378136","8622962","8623183","chr20","111770346","111770564","34","103147384"
"JH378136","9150858","9151090","chr8","122465744","122465992","65","113314886"
"JH378136","9596016","9596326","chr1","9360845","9361141","55","235171"
"JH378136","12269233","12269480","chr23","75075445","75075691","52","62806212"
"JH378136","12580911","12581209","chr18","63833457","63833758","38","51252546"
"JH378136","13271268","13271442","chr12","43231649","43231830","28","29960381"
"JH378136","13743161","13743455","chr15","5366624","5366919","51","8376537"
"JH378136","13813201","13813442","chr21","125813352","125813599","36","112000151"
"JH378136","13931112","13931289","chrX","238563","238744","35","13692549"
"JH378136","13989578","13989734","chr10","115413660","115413806","31","101424082"
"JH378136","14102465","14102690","chr20","109309565","109309789","43","95207100"
"JH378136","14381868","14382137","chr14","61597585","61597855","48","47215717"
"JH378136","14507425","14507490","chr1","110773079","110773145","8","96265654"
"JH378136","15111164","15111466","chr23","57612824","57613126","41","42501660"
"JH378136","16038775","16039071","chr2","59602741","59603032","57","43563966"
"JH378136","16495332","16495540","chr23","49845432","49845639","34","33350100"
"JH378136","16861618","16861829","chr11","15603408","15603620","36","1258210"
"JH378136","16875833","16876073","chr7","57513437","57513664","44","40637604"
"JH378136","17651367","17651500","chrUn_KE147541v1","534739","534860","23","17116628"
"JH378136","17879402","17879554","chr29","23529798","23529947","23","5650396"
"JH378136","17937227","17937534","chr12","52562723","52563030","50","34625496"
"JH378136","17984614","17984909","chr18","31464231","31464522","53","13479617"
"JH378136","18012600","18012830","chr18","9905435","9905663","50","8107165"
"JH378136","18028277","18028563","chr12","39114189","39114476","37","21085912"
"JH378136","18040017","18040317","chr3","25784267","25784567","57","7744250"
"JH378136","18463962","18464265","chr6","10613040","10613338","39","7850922"
"JH378136","18687435","18687557","chrUn_AQIB01158800v1","1","125","21","18687434"
"JH378136","19270183","19270375","chr2","25629978","25630164","42","6359795"
"JH378136","19392174","19392400","chr17","19329630","19329857","39","62544"
"JH378136","20009387","20009669","chr9","6382689","6382978","43","13626698"
"JH378136","20879941","20880235","chr17","53582686","53582976","36","32702745"
"JH378137","158052","158334","chr23","51149623","51149911","43","50991571"
"JH378137","169660","169873","chr2","25630213","25630417","42","25460553"
"JH378137","170309","170426","chr25","43477682","43477798","18","43307373"
"JH378137","260844","261143","chr1","86467570","86467849","87","86206726"
"JH378137","296908","297204","chr2_KE147940v1_random","21204","21502","37","275704"
"JH378137","415335","415548","chr14","74021868","74022082","30","73606533"
"JH378137","735368","735660","chr9","78073476","78073771","41","77338108"
"JH378137","970264","970567","chr3","19781093","19781390","50","18810829"
"JH378137","1275680","1275984","chr20","7876234","7876541","42","6600554"
"JH378137","1545129","1545260","chr2","70699454","70699583","22","69154325"
"JH378137","1666645","1666932","chr10","82223974","82224279","51","80557329"
"JH378137","1771430","1771691","chr10","94020388","94020642","40","92248958"
"JH378137","1880956","1881136","chr3","64830263","64830435","43","62949307"
"JH378137","2206009","2206301","chr16","70729210","70729502","34","68523201"
"JH378137","2435114","2435310","chr16","62117476","62117671","48","59682362"
"JH378137","2477525","2477763","chr1","41979357","41979596","57","39501832"
"JH378137","2727025","2727314","chr7","59480176","59480463","56","56753151"
"JH378137","2914169","2914466","chr16","33471388","33471690","37","30557219"
"JH378137","3206747","3207049","chr8","95859478","95859783","33","92652731"
"JH378137","3373983","3374267","chr3","67889935","67890219","48","64515952"
"JH378137","3383530","3383827","chr23","41937596","41937890","64","38554066"
"JH378137","3720506","3720792","chr20","92249941","92250224","50","88529435"
"JH378137","3815591","3815775","chr5","192637","192820","37","3622954"
"JH378137","4061868","4062182","chr19","22626676","22626983","47","18564808"
"JH378137","4099642","4099945","chr5","34361928","34362228","43","30262286"
"JH378137","4237136","4237429","chr11","24876645","24876927","38","20639509"
"JH378137","4320527","4320812","chr29","9188440","9188729","36","4867913"
"JH378137","4646401","4646583","chr10","37561184","37561370","30","32914783"
"JH378137","4700988","4701287","chr11","83560875","83561170","44","78859887"
"JH378137","4787807","4788112","chr12","72899340","72899646","39","68111533"
"JH378137","4990438","4990724","chr9","59423774","59424053","51","54433336"
"JH378137","5007515","5007805","chr15","8473619","8473907","42","3466104"
"JH378137","5089050","5089345","chr16","33551674","33551968","43","28462624"
"JH378137","5397579","5397883","chr6","32749709","32750008","37","27352130"
"JH378137","5434926","5435203","chr5","72051782","72052054","46","66616856"
"JH378137","5526714","5527020","chr16","10702414","10702717","38","5175700"
"JH378137","5540793","5541078","chr1","9142653","9142941","43","3601860"
"JH378137","6407256","6407552","chr9","81013808","81014095","50","74606552"
"JH378137","6431882","6432183","chr26","18794536","18794836","48","12362654"
"JH378137","6567977","6568115","chr8","138508118","138508261","22","131940141"
"JH378137","6870800","6871094","chr28","15327544","15327835","41","8456744"
"JH378137","7179192","7179490","chr16","33139486","33139791","42","25960294"
"JH378137","7695089","7695396","chrX","120888991","120889289","44","113193902"
"JH378137","7762955","7763263","chr27","40239547","40239855","43","32476592"
"JH378137","7785200","7785522","chr10","55314845","55315155","69","47529645"
"JH378137","8077916","8078092","chr9","62372766","62372941","29","54294850"
"JH378137","8348229","8348445","chr9","57732450","57732667","35","49384221"
"JH378137","8434702","8435004","chr14","61597253","61597561","39","53162551"
"JH378137","8803580","8803892","chr16","70242315","70242624","52","61438735"
"JH378137","8968472","8968694","chr9","57732450","57732667","39","48763978"
"JH378137","9413770","9413898","chr25","28864990","28865114","18","19451220"
"JH378137","9674576","9674873","chr1","9360845","9361141","36","313731"
"JH378137","10006816","10007117","chrX","43777377","43777676","46","33770561"
"JH378137","10572006","10572297","chr4","65360239","65360531","34","54788233"
"JH378137","11506204","11506272","chr14","99207960","99208028","10","87701756"
"JH378137","11765749","11766021","chr1","29294849","29295125","44","17529100"
"JH378137","12057693","12058000","chr13","41724361","41724668","37","29666668"
"JH378137","12101535","12101705","chr14","9346341","9346512","28","2755194"
"JH378137","12208304","12208594","chr24","11781500","11781793","32","426804"
"JH378137","12860547","12860676","chr6","33578769","33578895","17","20718222"
"JH378137","13545860","13546140","chr20","103871063","103871349","40","90325203"
"JH378137","14250901","14251183","chr6","40316487","40316767","38","26065586"
"JH378137","14468551","14468842","chr7_AQIB01159043v1_random","18062","18357","47","14450489"
"JH378137","14603432","14603656","chr28","13453464","13453689","43","1149968"
"JH378137","14646017","14646298","chr4","76488596","76488882","55","61842579"
"JH378137","14766710","14766928","chrX","92178511","92178733","46","77411801"
"JH378137","14791307","14791585","chr4","51976280","51976557","40","37184973"
"JH378137","15193594","15193725","chr7","86286493","86286622","18","71092899"
"JH378137","15217108","15217414","chr20","16464290","16464599","40","1247182"
"JH378137","15306924","15307115","chr6","9550495","9550686","27","5756429"
"JH378137","15636616","15636913","chrX","47726776","47727071","38","32090160"
"JH378137","15667384","15667597","chr11","100225388","100225600","42","84558004"
"JH378137","15867309","15867556","chr9","57398632","57398875","39","41531323"
"JH378137","15900986","15901251","chr16","33438205","33438489","51","17537219"
"JH378137","16103814","16103875","chr11","115887567","115887625","28","99783753"
"JH378137","16103981","16104090","chr28","16241085","16241207","28","137104"
"JH378137","16129219","16129525","chr16","59154431","59154733","50","43025212"
"JH378137","16545793","16545960","chr9","14957021","14957185","37","1588772"
"JH378137","16637798","16637919","chr2","4976621","4976741","23","11661177"
"JH378137","16872574","16872872","chr26","24027927","24028229","41","7155353"
"JH378137","17125932","17126219","chr28","15327544","15327835","52","1798388"
"JH378137","17248956","17249222","chr28","6474858","6475121","38","10774098"
"JH378137","17330430","17330800","chr12","64371628","64372017","95","47041198"
"JH378137","17336250","17336394","chr25","6369752","6369893","27","10966498"
"JH378137","17965516","17965721","chr4","60274875","60275075","47","42309359"
"JH378137","17966609","17966892","chr29","18842544","18842821","46","875935"
"JH378137","18247220","18247377","chr11","6506714","6506863","38","11740506"
"JH378137","18286943","18287238","chr16","70729210","70729502","42","52442267"
"JH378137","18415430","18415735","chrX","50512059","50512366","37","32096629"
"JH378137","18798331","18798493","chr10","55103495","55103662","32","36305164"
"JH378137","18909289","18909368","chr10","88746594","88746679","22","69837305"
"JH378137","18958071","18958359","chr14","49482958","49483244","58","30524887"
"JH378137","19100743","19100863","chr16","44225988","44226106","23","25125245"
"JH378137","19134168","19134469","chr6","48617359","48617659","46","29483191"
"JH378137","19934647","19934931","chr14","81078166","81078460","56","61143519"
"JH378137","20154206","20154373","chr22","18362469","18362628","36","1791737"
"JH378137","20201314","20201360","chr13","8915789","8915834","8","11285525"
"JH378137","20411763","20412016","chr13","20142235","20142496","47","269528"
"JH378137","20659404","20659700","chr16","34953642","34953933","48","14294238"
"JH378138","171294","171559","chr27","13518144","13518412","43","13346850"
"JH378138","1569519","1569642","chr19","14641039","14641163","29","13071520"
"JH378138","2069720","2070013","chr19","28144135","28144428","41","26074415"
"JH378138","2325269","2325379","chr20","74424969","74425077","20","72099700"
"JH378138","2622121","2622247","chr14","33067112","33067242","26","30444991"
"JH378138","2668964","2669176","chr14","74021868","74022082","44","71352904"
"JH378138","2798185","2798451","chr14","12717469","12717730","43","9919284"
"JH378138","2983799","2984085","chr12","65356809","65357103","59","62373010"
"JH378138","2993064","2993355","chr11","83560875","83561170","43","80567811"
"JH378138","3050584","3050810","chr17","19329630","19329857","35","16279046"
"JH378138","3616650","3616939","chr24","40072459","40072748","38","36455809"
"JH378138","4635034","4635171","chr6","37703627","37703760","24","33068593"
"JH378138","4973921","4974203","chr9","41489082","41489363","37","36515161"
"JH378138","5286949","5287239","chr24","26360086","26360391","49","21073137"
"JH378138","5560392","5560678","chr12","10047022","10047316","42","4486630"
"JH378138","5913736","5914037","chr5","14198316","14198616","50","8284580"
"JH378138","6016716","6016973","chr19","20171476","20171751","58","14154760"
"JH378138","6508980","6509259","chrX","60057029","60057325","51","53548049"
"JH378138","6927555","6927775","chrX","129744426","129744635","38","122816871"
"JH378138","8509506","8509642","chr13","93936933","93937062","22","85427427"
"JH378138","9117043","9117347","chr2","61035797","61036096","34","51918754"
"JH378138","9613245","9613453","chr11","33441548","33441753","41","23828303"
"JH378138","9740066","9740268","chr14","52996483","52996698","40","43256417"
"JH378138","10027222","10027528","chr1","29712863","29713163","43","19685641"
"JH378138","10056291","10056601","chr26","33024367","33024673","54","22968076"
"JH378138","10060378","10060673","chr4","75730761","75731061","38","65670383"
"JH378138","10073530","10073815","chr21","14733313","14733598","38","4659783"
"JH378138","10245082","10245399","chr23","81285499","81285798","52","71040417"
"JH378138","11318694","11318966","chr23","74492423","74492703","56","63173729"
"JH378138","12471902","12472185","chr7","97703417","97703707","67","85231515"
"JH378138","12886148","12886319","chr9","107561541","107561712","26","94675393"
"JH378138","13280917","13281169","chr7","49960380","49960632","33","36679463"
"JH378138","13443324","13443597","chrX","47726776","47727071","51","34283452"
"JH378138","15443583","15443870","chrX","246016","246303","44","15197567"
"JH378138","15923411","15923643","chr13","23414803","23415054","68","7491392"
"JH378138","16134854","16135136","chr13","63080365","63080655","44","46945511"
"JH378138","17362769","17363079","chr21","18451357","18451661","51","1088588"
"JH378138","19176743","19176894","chr24","16758420","16758559","25","2418323"
"JH378138","19436984","19437270","chr11","42708500","42708788","42","23271516"
"JH378138","19982566","19982822","chr6","44499748","44500000","50","24517182"
"JH378138","20216681","20216986","chr12","72899340","72899646","51","52682659"
"JH378139","42208","42493","chr20","105708807","105709105","53","105666599"
"JH378139","321355","321575","chr5","55258104","55258323","48","54936749"
"JH378139","384317","384589","chr5","72051782","72052054","45","71667465"
"JH378139","412579","412689","chr10","2090892","2091004","22","1678313"
"JH378139","949383","949688","chr1","104562716","104563010","60","103613333"
"JH378139","1037859","1037932","chr20","27499106","27499181","13","26461247"
"JH378139","1252067","1252380","chr12","21589054","21589349","106","20336987"
"JH378139","1566468","1566794","chr23","52188598","52188932","62","50622130"
"JH378139","1678579","1678848","chr6","7057","7319","65","1671522"
"JH378139","1879924","1880226","chr12","3898076","3898379","42","2018152"
"JH378139","1983061","1983110","chr22","74065325","74065376","8","72082264"
"JH378139","1989777","1990080","chr9","118212875","118213175","47","116223098"
"JH378139","2066723","2067005","chr28","8917006","8917294","51","6850283"
"JH378139","2337544","2337815","chr20","120203418","120203695","50","117865874"
"JH378139","2835452","2835750","chr16","14422338","14422632","48","11586886"
"JH378139","2853840","2854038","chr12","43962243","43962428","41","41108403"
"JH378139","2995416","2995648","chr18","9905435","9905663","41","6910019"
"JH378139","3024531","3024816","chr11","12552639","12552924","40","9528108"
"JH378139","3074621","3074939","chr1","40186193","40186501","40","37111572"
"JH378139","3164587","3164880","chr12","45962018","45962309","50","42797431"
"JH378139","3773369","3773670","chr2","7727690","7727993","34","3954321"
"JH378139","4636615","4636748","chr13","93936933","93937062","22","89300318"
"JH378139","5080141","5080444","chr10","102332242","102332544","41","97252101"
"JH378139","5115255","5115463","chr2","13316902","13317112","32","8201647"
"JH378139","5408378","5408679","chr11","13880374","13880674","48","8471996"
"JH378139","5415249","5415556","chr6","48617359","48617659","39","43202110"
"JH378139","6342574","6342866","chr9","52584616","52584911","45","46242042"
"JH378139","6561954","6562229","chr20","9842411","9842688","43","3280457"
"JH378139","7898177","7898436","chr7","116216737","116217000","60","108318560"
"JH378139","7989490","7989786","chr4","73783048","73783346","57","65793558"
"JH378139","8215132","8215275","chr11","6506714","6506863","33","1708418"
"JH378139","8235623","8235912","chrX","61756996","61757299","49","53521373"
"JH378139","8255230","8255278","chr10","57361441","57361488","11","49106211"
"JH378139","8377794","8378091","chr9","62609877","62610171","47","54232083"
"JH378139","8844838","8844951","chr14","3260195","3260311","22","5584643"
"JH378139","9723913","9724191","chr11","24876645","24876927","55","15152732"
"JH378139","10183064","10183156","chr9","70380929","70381021","31","60197865"
"JH378139","10183996","10184042","chr1","18422941","18422987","14","8238945"
"JH378139","10211526","10211807","chr1","68970266","68970543","53","58758740"
"JH378139","10542598","10542889","chr12","10047022","10047316","43","495576"
"JH378139","10774180","10774475","chr9","114669635","114669933","52","103895455"
"JH378139","11167527","11167825","chr5","61098134","61098429","49","49930607"
"JH378139","11220475","11220777","chr5","14139090","14139392","39","2918615"
"JH378139","12289611","12289909","chr23","45383243","45383541","43","33093632"
"JH378139","13709344","13709639","chr14","104088241","104088539","58","90378897"
"JH378139","14618145","14618446","chr16","61943605","61943901","49","47325460"
"JH378139","15328769","15329069","chr4","74750244","74750542","45","59421475"
"JH378139","15387184","15387480","chr10","102332242","102332544","47","86945058"
"JH378139","15523865","15523968","chr6","11844044","11844146","16","3679821"
"JH378139","16919523","16919818","chr29","22012118","22012414","46","5092595"
"JH378139","17146798","17147073","chr12","108171343","108171621","41","91024545"
"JH378139","17638189","17638467","chr1","68970266","68970543","39","51332077"
"JH378139","17653260","17653371","chr20","80015270","80015379","21","62362010"
"JH378139","17685944","17686164","chr7","97741073","97741285","55","80055129"
"JH378139","17991845","17992144","chr18","62626281","62626580","43","44634436"
"JH378139","18076614","18076867","chr16","34809540","34809792","45","16732926"
"JH378139","18147595","18147768","chr9","107561541","107561712","26","89413946"
"JH378139","18701195","18701491","chr2","89878041","89878342","53","71176846"
"JH378139","19035674","19035984","chr15","2000778","2001083","39","17034896"
"JH378139","19808275","19808456","chr6","40853681","40853861","36","21045406"
"JH378140","705637","705892","chr1","18300604","18300863","50","17594967"
"JH378140","1142309","1142433","chr2","70699454","70699583","33","69557145"
"JH378140","3810150","3810437","chr11","42708500","42708788","32","38898350"
"JH378140","3880646","3880947","chr20","69572248","69572548","49","65691602"
"JH378140","3943457","3943753","chr19","27584635","27584934","43","23641178"
"JH378140","5167933","5168199","chr8","94532373","94532636","35","89364440"
"JH378140","5229939","5230229","chr25","25882485","25882774","54","20652546"
"JH378140","5983767","5984043","chr20","119275773","119276050","57","113292006"
"JH378140","6066459","6066637","chr21","108556201","108556382","20","102489742"
"JH378140","6104502","6104804","chr4","74750244","74750542","37","68645742"
"JH378140","6288790","6289102","chrX","23182631","23182933","57","16893841"
"JH378140","7111931","7112239","chr10","83091676","83091982","50","75979745"
"JH378140","8203619","8203919","chr10","44221705","44222014","48","36018086"
"JH378140","8687299","8687521","chr13","67891703","67891927","45","59204404"
"JH378140","8938448","8938581","chr1","7765384","7765518","31","1173064"
"JH378140","9984736","9985042","chr15","33541193","33541502","43","23556457"
"JH378140","10388608","10388862","chr2","33108990","33109245","54","22720382"
"JH378140","10449715","10450016","chr26","11319916","11320217","46","870201"
"JH378140","10620801","10621052","chr19","13608773","13609025","39","2987972"
"JH378140","11069967","11070273","chr1","29712863","29713163","51","18642896"
"JH378140","11750255","11750522","chr14","74080496","74080760","42","62330241"
"JH378140","11808614","11808922","chr18","6977924","6978229","55","4830690"
"JH378140","12178334","12178625","chr17","53582686","53582976","48","41404352"
"JH378140","12252539","12252840","chrX","33027186","33027484","61","20774647"
"JH378140","13313064","13313355","chr1","9360845","9361141","40","3952219"
"JH378140","14387767","14388062","chr20","107925558","107925844","57","93537791"
"JH378140","14430793","14431078","chr11","96237698","96237981","51","81806905"
"JH378140","14434179","14434486","chr12","41019638","41019945","40","26585459"
"JH378140","14476170","14476217","chr6","45751608","45751639","21","31275438"
"JH378140","14476218","14476364","chr2","25020841","25020984","26","10544623"
"JH378140","14626694","14626996","chr2","33362197","33362503","47","18735503"
"JH378140","14988620","14988922","chr14","35916188","35916490","47","20927568"
"JH378140","15429762","15430058","chr12","62505268","62505568","38","47075506"
"JH378140","15640819","15641094","chr14","53650197","53650475","37","38009378"
"JH378140","16179489","16179561","chr5","34199615","34199685","18","18020126"
"JH378140","17108350","17108652","chr12","18358405","18358704","42","1250055"
"JH378140","17344339","17344632","chr12","2036491","2036781","42","15307848"
"JH378140","17402599","17402884","chr16","58327777","58328064","47","40925178"
"JH378140","17477575","17477680","chr2","30454897","30455000","29","12977322"
"JH378140","17478395","17478475","chr12","87864616","87864703","34","70386221"
"JH378140","18337726","18338015","chr10","94012577","94012864","40","75674851"
"JH378140","18620872","18621050","chr20","87928737","87928908","33","69307865"
"JH378140","18762795","18763108","chr22","48723618","48723929","50","29960823"
"JH378140","18971513","18971674","chr2","36086667","36086826","39","17115154"
"JH378140","19045981","19046143","chr10","55103495","55103662","41","36057514"
"JH378140","19317273","19317584","chr14","61597253","61597561","39","42279980"
"JH378141","112101","112320","chrX","92178511","92178733","49","92066410"
"JH378141","160778","160989","chr14","52996483","52996698","42","52835705"
"JH378141","217960","218168","chr28","5263156","5263365","48","5045196"
"JH378141","516871","516981","chr21","2508889","2509006","35","1992018"
"JH378141","536351","536628","chr2","84407708","84407986","38","83871357"
"JH378141","942624","942885","chrX","103690587","103690853","50","102747963"
"JH378141","1460337","1460463","chr13","93936933","93937062","19","92476596"
"JH378141","2450060","2450364","chrX","23182631","23182933","43","20732571"
"JH378141","2721873","2722152","chr16","17103242","17103520","34","14381369"
"JH378141","2794112","2794349","chr6","18081079","18081310","57","15286967"
"JH378141","3084976","3085082","chr13","61044596","61044698","24","57959620"
"JH378141","3114076","3114384","chr4","58182166","58182477","41","55068090"
"JH378141","3157252","3157425","chr26","26147166","26147342","46","22989914"
"JH378141","5269307","5269617","chr26","9219402","9219713","37","3950095"
"JH378141","5849764","5849968","chr10","75475335","75475550","50","69625571"
"JH378141","6163965","6164243","chr9","39487572","39487853","48","33323607"
"JH378141","6362370","6362578","chr28","5263156","5263365","41","1099214"
"JH378141","8106914","8107206","chr8","29582632","29582928","55","21475718"
"JH378141","8292581","8292888","chr15","2000778","2001083","41","6291803"
"JH378141","8571880","8572176","chr17","51807451","51807736","56","43235571"
"JH378141","9271229","9271332","chr21","103512848","103512947","19","94241619"
"JH378141","9821189","9821482","chr1","108598109","108598405","42","98776920"
"JH378141","9873038","9873362","chr11","105253725","105254027","56","95380687"
"JH378141","9938402","9938697","chrX","43777377","43777676","43","33838975"
"JH378141","10374176","10374468","chr19","27584635","27584934","41","17210459"
"JH378141","10401410","10401702","chr18","59850632","59850929","49","49449222"
"JH378141","10557545","10557797","chr25","72031741","72032007","54","61474196"
"JH378141","10794199","10794493","chr11","106655120","106655411","38","95860921"
"JH378141","10807399","10807453","chr13","7060006","7060057","6","3747393"
"JH378141","11254325","11254488","chr10","88224804","88224966","38","76970479"
"JH378141","11442185","11442328","chr27","46451202","46451337","29","35009017"
"JH378141","11842239","11842529","chr9","31281354","31281649","38","19439115"
"JH378141","11853039","11853325","chr10","85456712","85457001","48","73603673"
"JH378141","11853843","11854144","chrX","90715027","90715323","45","78861184"
"JH378141","11937904","11938193","chr28","9652356","9652644","44","2285548"
"JH378141","12311577","12311880","chr2","22860155","22860456","35","10548578"
"JH378141","12583125","12583301","chr11","111452777","111452942","40","98869652"
"JH378141","12730989","12731290","chr24","27110583","27110876","48","14379594"
"JH378141","13174679","13174942","chr14","74080496","74080760","46","60905817"
"JH378141","13192732","13193029","chr11","72041420","72041714","31","58848688"
"JH378141","13224948","13225104","chr1","99995650","99995808","30","86770702"
"JH378141","13235785","13235917","chr4","90460665","90460796","20","77224880"
"JH378141","13353220","13353420","chrX","347902","348103","43","13005318"
"JH378141","13544400","13544697","chr6","6217754","6218043","50","7326646"
"JH378141","13852198","13852494","chr4","10168457","10168762","42","3683741"
"JH378141","13965486","13965766","chr23","37087327","37087607","45","23121841"
"JH378141","14549259","14549537","chr14","53650197","53650475","49","39100938"
"JH378141","14607738","14608012","chr14","51174162","51174453","76","36566424"
"JH378141","15209037","15209264","chr5","21993783","21994011","36","6784746"
"JH378141","15872870","15873147","chr17","51807451","51807736","59","35934581"
"JH378141","16392866","16393136","chr21","125287731","125288011","51","108894865"
"JH378141","17080906","17081145","chr4","39404751","39404989","37","22323845"
"JH378141","17740881","17741177","chr4","74750244","74750542","44","57009363"
"JH378141","17911559","17911824","chr3","19980447","19980715","56","2068888"
"JH378141","18038299","18038630","chr15","74758225","74758550","61","56719926"
"JH378141","18187562","18187875","chr26","19957908","19958208","65","1770346"
"JH378141","18314955","18315134","chr8","36545404","36545573","42","18230449"
"JH378141","18452590","18452874","chr6","26593661","26593944","47","8141071"
"JH378141","18713332","18713599","chr6","11340998","11341271","47","7372334"
"JH378141","19219736","19220029","chr10","55092261","55092557","44","35872525"
"JH378142","275589","275852","chr2","87954053","87954315","59","87678464"
"JH378142","424027","424315","chr3","19427213","19427505","33","19003186"
"JH378142","613234","613521","chr11","96237698","96237981","44","95624464"
"JH378142","968046","968343","chr1","10964645","10964948","42","9996599"
"JH378142","1119249","1119550","chr19","22626676","22626983","50","21507427"
"JH378142","1209250","1209373","chr16","4541268","4541389","35","3332018"
"JH378142","1607384","1607689","chr13","86923785","86924086","45","85316401"
"JH378142","2563800","2564108","chr16","30260040","30260349","32","27696240"
"JH378142","2693106","2693409","chr2","22860155","22860456","39","20167049"
"JH378142","2762277","2762586","chr1","125024996","125025302","45","122262719"
"JH378142","2913778","2913998","chr5","55258104","55258323","44","52344326"
"JH378142","3120890","3121187","chrX","60403420","60403723","45","57282530"
"JH378142","3316119","3316428","chrX","61756996","61757299","49","58440877"
"JH378142","3318931","3319237","chr20","104985298","104985598","44","101666367"
"JH378142","5458684","5458976","chr14","83288480","83288767","57","77829796"
"JH378142","5993988","5994290","chr18","48422122","48422424","45","42428134"
"JH378142","6014054","6014343","chr6","35097365","35097661","68","29083311"
"JH378142","7916021","7916301","chr1","114482348","114482630","40","106566327"
"JH378142","8419610","8419841","chr1","18375911","18376144","48","9956301"
"JH378142","9148456","9148755","chr8","59341069","59341369","39","50192613"
"JH378142","9306716","9307012","chr1","31259486","31259780","46","21952770"
"JH378142","10238051","10238188","chrX","114563807","114563945","23","104325756"
"JH378142","11354946","11355203","chr25","77773108","77773371","51","66418162"
"JH378142","11823358","11823564","chr16","34169864","34170075","32","22346506"
"JH378142","11994958","11995225","chrUn_KE147569v1","89073","89358","56","11905885"
"JH378142","13064528","13064826","chr4","35239086","35239384","39","22174558"
"JH378142","13621478","13621777","chr6","29394044","29394346","36","15772566"
"JH378142","13639360","13639659","chrX","47726776","47727071","42","34087416"
"JH378142","14613772","14614060","chr5","5298594","5298888","39","9315178"
"JH378142","14785471","14785760","chr3","6022508","6022797","43","8762963"
"JH378142","15462762","15463084","chrX","29670774","29671076","58","14208012"
"JH378142","16673527","16673827","chr14","81687671","81687971","38","65014144"
"JH378142","17642740","17643040","chr18","63833457","63833758","46","46190717"
"JH378142","17675196","17675494","chr18","62796034","62796330","41","45120838"
"JH378142","19048407","19048694","chr9","58645917","58646207","38","39597510"
"JH378143","954814","954991","chr8","112629520","112629695","41","111674706"
"JH378143","1857392","1857683","chr13","67198097","67198382","45","65340705"
"JH378143","1975800","1976055","chr10","127587035","127587285","47","125611235"
"JH378143","2416632","2416931","chr25","54930545","54930841","40","52513913"
"JH378143","2424041","2424325","chr24","51521386","51521673","52","49097345"
"JH378143","2995312","2995604","chr9","104154348","104154646","56","101159036"
"JH378143","3661431","3661695","chr17","47805481","47805753","56","44144050"
"JH378143","3707858","3707889","chr3","1167554","1167585","7","2540304"
"JH378143","3950876","3951173","chr4","36056954","36057249","37","32106078"
"JH378143","4283667","4283836","chr11","38654438","38654609","34","34370771"
"JH378143","5100726","5101023","chr2","61035797","61036096","48","55935071"
"JH378143","6129263","6129527","chr2","87954053","87954315","41","81824790"
"JH378143","6150070","6150335","chr10","29167842","29168112","64","23017772"
"JH378143","6473116","6473388","chr9","99714018","99714298","52","93240902"
"JH378143","6761216","6761512","chr25","73344213","73344513","52","66582997"
"JH378143","7168235","7168544","chr12","25030968","25031277","34","17862733"
"JH378143","7986703","7987008","chr2","42862488","42862793","44","34875785"
"JH378143","8495658","8495930","chr9","105575072","105575353","45","97079414"
"JH378143","8584630","8584915","chrX","47726776","47727071","44","39142146"
"JH378143","8829597","8829804","chr24","47558800","47559017","52","38729203"
"JH378143","9027405","9027590","chr21","18967230","18967419","37","9939825"
"JH378143","9143249","9143380","chr22","3180119","3180245","25","5963130"
"JH378143","9354023","9354247","chr5","12500001","12500225","37","3145978"
"JH378143","9898945","9899255","chr11","116558393","116558699","50","106659448"
"JH378143","10729085","10729355","chr18","42916223","42916500","47","32187138"
"JH378143","11126902","11127110","chr11","100225388","100225600","49","89098486"
"JH378143","12651300","12651425","chr2","4976621","4976741","23","7674679"
"JH378143","13438705","13439011","chrX","109019895","109020211","76","95581190"
"JH378143","13574195","13574492","chr11","95498272","95498559","54","81924077"
"JH378143","14813793","14814091","chr3","27879990","27880287","46","13066197"
"JH378143","15265144","15265444","chr8","61385172","61385470","50","46120028"
"JH378143","17178885","17179162","chr9","18313882","18314160","44","1134997"
"JH378143","17552572","17552874","chr4","16716893","16717190","46","835679"
"JH378143","18462068","18462184","chr9","3918407","3918523","23","14543661"
"JH378143","18508476","18508671","chr16","34169864","34170075","43","15661388"
"JH378144","257902","258177","chr14","73627770","73628044","45","73369868"
"JH378144","790631","790931","chr20","105708807","105709105","40","104918176"
"JH378144","897888","898179","chr4","52226463","52226762","45","51328575"
"JH378144","1266075","1266352","chr27","34512765","34513037","47","33246690"
"JH378144","1316428","1316706","chr1","114482348","114482630","42","113165920"
"JH378144","1355464","1355737","chr7","55740326","55740609","55","54384862"
"JH378144","1393447","1393701","chr9","18313882","18314160","48","16920435"
"JH378144","1419483","1419769","chr17","4564564","4564857","45","3145081"
"JH378144","1758262","1758392","chr11","59867158","59867285","39","58108896"
"JH378144","2108850","2109082","chr20","43886824","43887060","53","41777974"
"JH378144","3081943","3082229","chr2","14848640","14848936","54","11766697"
"JH378144","3172609","3172780","chr9","14957021","14957185","46","11784412"
"JH378144","3297538","3297692","chr11","49418270","49418433","29","46120732"
"JH378144","3323094","3323396","chr10","55092261","55092557","41","51769167"
"JH378144","3769194","3769472","chr11","42708500","42708788","43","38939306"
"JH378144","4386590","4386730","chr6","45938257","45938403","33","41551667"
"JH378144","4809637","4809936","chrX","47726776","47727071","51","42917139"
"JH378144","4826447","4826655","chr11","100225388","100225600","34","95398941"
"JH378144","4994998","4995306","chr27","40239547","40239855","38","35244549"
"JH378144","5241921","5242216","chr28","8917006","8917294","50","3675085"
"JH378144","5576142","5576448","chr20","113381135","113381444","51","107804993"
"JH378144","6295105","6295419","chr2","34764440","34764750","51","28469335"
"JH378144","6465912","6466197","chr11","42708500","42708788","49","36242588"
"JH378144","6882044","6882181","chr20","86668125","86668264","27","79786081"
"JH378144","6900941","6901204","chr1","47529841","47530117","59","40628900"
"JH378144","7094563","7094850","chr12","43161561","43161851","44","36066998"
"JH378144","7414541","7414818","chr14","51174162","51174453","49","43759621"
"JH378144","7577552","7577852","chr4","74750244","74750542","32","67172692"
"JH378144","8356879","8357051","chrX","100082116","100082286","49","91725237"
"JH378144","8429543","8429837","chr23","71906236","71906536","52","63476693"
"JH378144","8507402","8507564","chr9","14957021","14957185","40","6449619"
"JH378144","8605030","8605304","chr23","39001740","39002032","52","30396710"
"JH378144","8632248","8632557","chr4","31811484","31811787","37","23179236"
"JH378144","8982036","8982315","chr20","92249941","92250224","47","83267905"
"JH378144","9334505","9334803","chr3","31757392","31757689","46","22422887"
"JH378144","9583525","9583664","chrX","77324374","77324510","21","67740849"
"JH378144","10409983","10410268","chr12","106006709","106006991","43","95596726"
"JH378144","10491010","10491245","chr17","41816726","41816966","51","31325716"
"JH378144","10603667","10603877","chr23","42922019","42922224","43","32318352"
"JH378144","11431852","11432143","chr6","32749709","32750008","53","21317857"
"JH378144","11613405","11613589","chr3","18442914","18443095","40","6829509"
"JH378144","12049930","12050193","chr25","7570447","7570723","61","4479483"
"JH378144","12219379","12219666","chr11","102258872","102259154","51","90039493"
"JH378144","12798005","12798291","chr10","110366848","110367136","57","97568843"
"JH378144","13194920","13195223","chr13","90749493","90749789","47","77554573"
"JH378144","13342622","13342895","chr19","23425164","23425442","56","10082542"
"JH378144","13364985","13365287","chr1","51035370","51035662","58","37670385"
"JH378144","13778907","13779189","chr1","68504497","68504793","59","54725590"
"JH378144","13908251","13908541","chr11","9923400","9923670","61","3984851"
"JH378144","14015699","14015981","chr9","58155888","58156167","43","44140189"
"JH378144","14454638","14454916","chr12","73233764","73234041","37","58779126"
"JH378144","15860905","15861197","chr4","61692314","61692609","45","45831409"
"JH378144","16215183","16215474","chr26","40585333","40585622","39","24370150"
"JH378144","16300128","16300421","chr8","40712258","40712534","67","24412130"
"JH378144","16692239","16692546","chr6","20405358","20405666","44","3713119"
"JH378144","16728942","16729226","chr12","41367876","41368167","60","24638934"
"JH378144","17384610","17384765","chr16","59350503","59350658","41","41965893"
"JH378144","17985996","17986219","chr20","93979343","93979574","63","75993347"
"JH378144","18204125","18204431","chr8","95859478","95859783","45","77655353"
"JH378144","18405520","18405815","chr14","86997958","86998245","62","68592438"
"JH378145","247267","247537","chr11","62921553","62921824","37","62674286"
"JH378145","364754","365044","chr11","60552837","60553124","28","60188083"
"JH378145","2174111","2174407","chr11","87886803","87887101","43","85712692"
"JH378145","2700243","2700504","chr14","75250425","75250685","62","72550182"
"JH378145","3089875","3090176","chr15","2000778","2001083","44","1089097"
"JH378145","3595083","3595375","chr12","103186024","103186315","36","99590941"
"JH378145","3645661","3645944","chr13","93964542","93964823","37","90318881"
"JH378145","4236057","4236350","chr19","27584635","27584934","40","23348578"
"JH378145","5041967","5042266","chr2","89878041","89878342","48","84836074"
"JH378145","5907785","5907944","chr8","112591683","112591837","33","106683898"
"JH378145","6313845","6314115","chr11","29396564","29396830","43","23082719"
"JH378145","6531927","6532220","chr11","19618707","19619010","45","13086780"
"JH378145","7192920","7193213","chr2","38953517","38953810","61","31760597"
"JH378145","7571724","7572027","chr2","61035797","61036096","44","53464073"
"JH378145","7683854","7684163","chrX","41878389","41878698","52","34194535"
"JH378145","8847010","8847319","chr10","50537691","50537999","40","41690681"
"JH378145","9822003","9822276","chrX","34454786","34455054","48","24632783"
"JH378145","10083206","10083370","chr9","122729670","122729833","25","112646464"
"JH378145","10545079","10545362","chr9","57921121","57921405","37","47376042"
"JH378145","10635939","10636078","chr15","5313540","5313671","25","5322399"
"JH378145","10694760","10694874","chr26","27840309","27840431","29","17145549"
"JH378145","10702094","10702392","chr10","117007658","117007955","52","106305564"
"JH378145","11579393","11579672","chr4","37507534","37507805","56","25928141"
"JH378145","11598319","11598611","chr21","12950925","12951223","63","1352606"
"JH378145","12327205","12327494","chr8","50843851","50844144","43","38516646"
"JH378145","12511907","12512116","chr14","8408006","8408236","65","4103901"
"JH378145","13190939","13191218","chr13","46226128","46226400","60","33035189"
"JH378145","14615107","14615298","chr4","50510683","50510871","36","35895576"
"JH378145","14717415","14717693","chr20","68385003","68385285","59","53667588"
"JH378145","15077176","15077330","chr22","27074075","27074227","31","11996899"
"JH378145","16468646","16468968","chr10","59935987","59936305","45","43467341"
"JH378145","16557166","16557440","chr8","17131358","17131640","39","574192"
"JH378145","16917201","16917495","chr10","104330612","104330907","44","87413411"
"JH378145","18213106","18213403","chr17","44623311","44623610","49","26410205"
"JH378146","776124","776408","chr20","105708807","105709105","55","104932683"
"JH378146","874407","874652","chr1","50678867","50679117","49","49804460"
"JH378146","1813374","1813673","chr2","33362197","33362503","55","31548823"
"JH378146","1863313","1863606","chr11","12286875","12287171","39","10423562"
"JH378146","2020472","2020782","chr10","113084712","113085016","39","111064240"
"JH378146","2540650","2540935","chr22","2609490","2609778","43","68840"
"JH378146","3236253","3236556","chr16","33139486","33139791","39","29903233"
"JH378146","5279516","5279830","chrX","111147394","111147703","54","105867878"
"JH378146","6066889","6067173","chr13","57700238","57700522","45","51633349"
"JH378146","6238616","6238826","chr10_KE148023v1_random","388267","388479","38","5850349"
"JH378146","8146118","8146401","chr5","54825245","54825525","44","46679127"
"JH378146","8741562","8741858","chr4","74750244","74750542","40","66008682"
"JH378146","10053211","10053382","chr4","66826794","66826969","34","56773583"
"JH378146","10166693","10166877","chr3","91778271","91778445","37","81611578"
"JH378146","10193021","10193292","chr6","3646070","3646335","50","6546951"
"JH378146","10222850","10223144","chr10","2202474","2202766","54","8020376"
"JH378146","10226608","10226902","chrX","61756996","61757299","50","51530388"
"JH378146","10228412","10228703","chrX_KE148108v1_random","992295","992587","44","9236117"
"JH378146","10349468","10349757","chr3","19446908","19447193","59","9097440"
"JH378146","10426275","10426422","chr10","16224051","16224189","27","5797776"
"JH378146","10495432","10495728","chr16","24824595","24824890","30","14329163"
"JH378146","10688855","10689166","chr2","33362197","33362503","41","22673342"
"JH378146","12207017","12207053","chr1","94293794","94293836","15","82086777"
"JH378146","12379613","12379920","chr16","30260040","30260349","38","17880427"
"JH378146","13407218","13407504","chr14","53650197","53650475","42","40242979"
"JH378146","15078450","15078637","chr9","61648531","61648713","30","46570081"
"JH378146","15140458","15140750","chr15","5007900","5008197","45","10132558"
"JH378146","15162042","15162135","chr14","68059462","68059545","28","52897420"
"JH378146","15386218","15386512","chr16","53047614","53047905","45","37661396"
"JH378146","15424217","15424424","chr23","42922019","42922224","35","27497802"
"JH378146","15436340","15436585","chr3","54097857","54098084","48","38661517"
"JH378146","15648948","15649243","chr16","33551674","33551968","40","17902726"
"JH378146","15842355","15842634","chr21","76462253","76462539","52","60619898"
"JH378146","15931125","15931303","chr8","112629520","112629695","35","96698395"
"JH378146","16138589","16138683","chr6","35238025","35238103","26","19099436"
"JH378146","16138784","16139009","chr2","65988272","65988503","34","49849488"
"JH378146","17320531","17320820","chr20","74306891","74307190","45","56986360"
"JH378146","17327574","17327839","chr14","45592971","45593246","51","28265397"
"JH378146","17382364","17382656","chr9","85636273","85636563","42","68253909"
"JH378146","17451569","17451876","chr13","93848759","93849059","59","76397190"
"JH378146","17545294","17545602","chr19","1399966","1400272","43","16145328"
"JH378147","50641","50914","chr8","100037545","100037817","55","99986904"
"JH378147","1860227","1860417","chr21","18967230","18967419","38","17107003"
"JH378147","1963608","1963893","chr19","1538482","1538767","51","425126"
"JH378147","2200688","2200997","chrX","41878389","41878698","46","39677701"
"JH378147","2534969","2535262","chr14","86997958","86998245","41","84462989"
"JH378147","3100234","3100534","chr24","8218231","8218539","65","5117997"
"JH378147","3298248","3298560","chr21","55549223","55549531","52","52250975"
"JH378147","3543292","3543587","chr13","67198097","67198382","57","63654805"
"JH378147","4634287","4634560","chr20","104293209","104293496","53","99658922"
"JH378147","5000831","5001050","chr20","111770346","111770564","42","106769515"
"JH378147","5045050","5045340","chr1","124161627","124161932","48","119116577"
"JH378147","5466323","5466614","chr20_KE148049v1_random","1057268","1057561","61","4409055"
"JH378147","5771385","5771681","chr23","57612824","57613126","37","51841439"
"JH378147","6866190","6866467","chr3","88516944","88517224","48","81650754"
"JH378147","6887833","6888126","chr4","89686474","89686771","42","82798641"
"JH378147","6998801","6999071","chr7","103855472","103855749","56","96856671"
"JH378147","7072166","7072475","chr22","45546705","45547014","49","38474539"
"JH378147","7222456","7222748","chr22","51935182","51935476","45","44712726"
"JH378147","8717531","8717810","chr1","67566937","67567228","51","58849406"
"JH378147","8744221","8744483","chr2","87954053","87954315","40","79209832"
"JH378147","8820988","8821293","chr22","67435237","67435541","53","58614249"
"JH378147","9418603","9418912","chr27","40239547","40239855","35","30820944"
"JH378147","11731424","11731718","chr1","29712863","29713163","52","17981439"
"JH378147","12313184","12313470","chr1","67566937","67567228","53","55253753"
"JH378147","13261065","13261357","chr26","11209053","11209344","42","2052012"
"JH378147","14362763","14363060","chr1","9360845","9361141","48","5001918"
"JH378147","14411436","14411744","chr1","20836893","20837193","50","6425457"
"JH378147","14712133","14712424","chr5","25044505","25044772","67","10332372"
"JH378147","16452816","16453113","chr3","6414985","6415283","49","10037831"
"JH378147","17521050","17521347","chr2","16490472","16490777","58","1030578"
"JH378148","1831208","1831508","chr1","36079803","36080100","42","34248595"
"JH378148","2013268","2013568","chr16","66139074","66139369","42","64125806"
"JH378148","2259469","2259758","chr5","26884776","26885075","36","24625307"
"JH378148","2743036","2743301","chr5","72051782","72052054","42","69308746"
"JH378148","2954835","2954945","chr10","110800532","110800647","28","107845697"
"JH378148","3005062","3005358","chr25","49444160","49444454","45","46439098"
"JH378148","3092213","3092512","chr11","49226350","49226650","39","46134137"
"JH378148","3106580","3106706","chr26","11354204","11354323","22","8247624"
"JH378148","3280920","3281228","chr16","36007753","36008062","44","32726833"
"JH378148","3317789","3318073","chr2","7721210","7721494","33","4403421"
"JH378148","3450666","3450975","chr2","22763066","22763371","41","19312400"
"JH378148","3454557","3454752","chr24","81299652","81299821","50","77845095"
"JH378148","3853923","3854222","chr16","70761900","70762196","44","66907977"
"JH378148","4104142","4104306","chr21","58133217","58133377","22","54029075"
"JH378148","4355035","4355344","chr27","40239547","40239855","47","35884512"
"JH378148","6907195","6907469","chr26","35795525","35795803","52","28888330"
"JH378148","7198649","7198806","chr9","85157244","85157394","30","77958595"
"JH378148","7226343","7226622","chr3","23455201","23455479","46","16228858"
"JH378148","7741747","7742068","chr25","82820672","82820979","47","75078925"
"JH378148","8012404","8012527","chr2","7593632","7593755","19","418772"
"JH378148","8013913","8014036","chr1","114922378","114922500","18","106908465"
"JH378148","8661175","8661521","chr14","8479713","8480037","76","181462"
"JH378148","9233395","9233689","chrX","26479311","26479602","41","17245916"
"JH378148","9874227","9874535","chr10","113084712","113085016","44","103210485"
"JH378148","10838709","10839014","chr10","15526811","15527117","31","4688102"
"JH378148","11932758","11933065","chr16","36007753","36008062","47","24074995"
"JH378148","12102413","12102714","chr24","78152668","78152967","42","66050255"
"JH378148","12128460","12128768","chr21","28597764","28598072","37","16469304"
"JH378148","14130902","14131189","chr6","21119238","21119524","41","6988336"
"JH378148","14143411","14143672","chr1","112610540","112610791","39","98467129"
"JH378148","14582946","14583227","chr1","114482348","114482630","35","99899402"
"JH378148","15522468","15522638","chr14","37840547","37840721","46","22318079"
"JH378148","15706296","15706605","chr16","36007753","36008062","50","20301457"
"JH378148","15990989","15991275","chr12","43161561","43161851","42","27170572"
"JH378148","16111080","16111375","chrX","6571847","6572139","34","9539233"
"JH378148","16682529","16682815","chr1","8790492","8790780","38","7892037"
"JH378148","16829909","16830215","chr27","11307380","11307681","35","5522529"
"JH378148","16915519","16915592","chrX","89653867","89653941","9","72738348"
"JH378148","16915694","16915860","chr20","108008275","108008436","30","91092581"
"JH378149","143368","143661","chr26","10924057","10924348","47","10780689"
"JH378149","490406","490699","chr6","29394044","29394346","47","28903638"
"JH378149","579086","579223","chr10","29894904","29895042","37","29315818"
"JH378149","1292107","1292227","chr1","8926569","8926682","19","7634462"
"JH378149","1435214","1435506","chr14","52817028","52817317","46","51381814"
"JH378149","1574039","1574312","chr9","41489082","41489363","46","39915043"
"JH378149","1657727","1657851","chr20_KE148049v1_random","1287449","1287579","19","370278"
"JH378149","1746285","1746596","chr23","80642893","80643191","49","78896608"
"JH378149","1787889","1788182","chr27","11295804","11296100","45","9507915"
"JH378149","1834430","1834723","chr1","29712863","29713163","69","27878433"
"JH378149","1973621","1973924","chr9","61932207","61932503","45","59958586"
"JH378149","2174277","2174479","chr19","12992619","12992824","37","10818342"
"JH378149","2355982","2356133","chr16","69077847","69078004","21","66721865"
"JH378149","2492317","2492533","chr12","108518404","108518625","32","106026087"
"JH378149","2525015","2525307","chr12","65356809","65357103","34","62831794"
"JH378149","2525923","2526227","chr10","39012436","39012740","36","36486513"
"JH378149","2661508","2661802","chr2","14848640","14848936","38","12187132"
"JH378149","3389642","3389932","chr28","8917006","8917294","48","5527364"
"JH378149","3964239","3964504","chr12","6203118","6203386","54","2238879"
"JH378149","4181567","4181696","chr14","67782475","67782602","14","63600908"
"JH378149","4182264","4182558","chr1","8790492","8790780","59","4608228"
"JH378149","4350004","4350277","chr10","55562512","55562784","50","51212508"
"JH378149","4370490","4370768","chr9","58155888","58156167","39","53785398"
"JH378149","4500105","4500401","chr23","76077886","76078182","38","71577781"
"JH378149","4770629","4770913","chr26","24027927","24028229","48","19257298"
"JH378149","4790282","4790421","chr9","65878775","65878915","25","61088493"
"JH378149","5450212","5450503","chr4","89686474","89686771","41","84236262"
"JH378149","5522453","5522755","chrX","22117998","22118290","45","16595545"
"JH378149","5666316","5666487","chr20","105726951","105727127","31","100060635"
"JH378149","7092388","7092670","chr9","41489082","41489363","56","34396694"
"JH378149","8648366","8648588","chr19","24215041","24215262","42","15566675"
"JH378149","9597779","9597891","chr2","13154797","13154910","21","3557018"
"JH378149","9678757","9679058","chr4","42367925","42368233","51","32689168"
"JH378149","10127583","10127888","chr16","14482255","14482552","66","4354672"
"JH378149","10317759","10318010","chr14","61597585","61597855","62","51279826"
"JH378149","10434702","10435010","chr12","3898076","3898379","38","6536626"
"JH378149","10442670","10442959","chr1","9360845","9361141","35","1081825"
"JH378149","10573575","10573860","chr14","81458250","81458541","41","70884675"
"JH378149","10727300","10727418","chr1","8926569","8926682","23","1800731"
"JH378149","10853044","10853171","chr2","4976621","4976741","21","5876423"
"JH378149","11105516","11105817","chr19","22626676","22626983","47","11521160"
"JH378149","11912034","11912212","chr25","58481653","58481834","40","46569619"
"JH378149","12346197","12346493","chr6","30660476","30660773","43","18314279"
"JH378149","12776933","12777249","chr13","63138736","63139042","44","50361803"
"JH378149","12997627","12997909","chr12","62505268","62505568","55","49507641"
"JH378149","13120165","13120448","chr23","50149627","50149920","36","37029462"
"JH378149","13374391","13374630","chr5","54895761","54895974","65","41521370"
"JH378149","13838539","13838847","chr8","121527131","121527436","39","107688592"
"JH378149","13867382","13867675","chr17","38569856","38570151","49","24702474"
"JH378149","14597884","14598149","chr14","75250425","75250685","47","60652541"
"JH378149","15030103","15030394","chr2","80562522","80562815","51","65532419"
"JH378149","15226896","15227192","chr9","53392827","53393126","53","38165931"
"JH378149","15378172","15378448","chr21","85642900","85643169","51","70264728"
"JH378149","15640007","15640274","chr14","61597585","61597855","37","45957578"
"JH378149","16010232","16010539","chr9","62219075","62219386","39","46208843"
"JH378149","16023657","16023720","chr24","26821576","26821642","16","10797919"
"JH378149","16092670","16092968","chr7","119466216","119466521","50","103373546"
"JH378149","16279469","16279773","chrX","89680401","89680694","49","73400932"
"JH378149","16598052","16598319","chr6","3646070","3646335","52","12951982"
"JH378149","16620946","16621243","chr21","120197471","120197770","54","103576525"
"JH378149","16714220","16714515","chr4","74750244","74750542","46","58036024"
"JH378149","17198181","17198381","chr15","67612582","67612782","32","50414401"
"JH378149","17266820","17266935","chr12","17356175","17356289","22","89355"
"JH378150","12524","12782","chr6","11215683","11215935","65","11203159"
"JH378150","552410","552705","chr21","46936802","46937109","46","46384392"
"JH378150","3013753","3014054","chr6","29394044","29394346","30","26380291"
"JH378150","3458769","3459078","chr15","68143767","68144071","38","64684998"
"JH378150","3641158","3641264","chr2","42519286","42519394","25","38878128"
"JH378150","4369084","4369379","chr15","6449816","6450113","66","2080732"
"JH378150","4396428","4396732","chr26","18874787","18875086","59","14478359"
"JH378150","4847915","4848067","chr8","23675201","23675353","44","18827286"
"JH378150","6117424","6117710","chr6","11731789","11732083","41","5614365"
"JH378150","6571565","6571863","chr10","104330612","104330907","38","97759047"
"JH378150","9695144","9695436","chrX","26479311","26479602","38","16784167"
"JH378150","9885632","9885937","chr5","26884776","26885075","42","16999144"
"JH378150","10182124","10182418","chr11","116795416","116795705","59","106613292"
"JH378150","10332251","10332552","chr19","18052906","18053205","39","7720655"
"JH378150","10411410","10411547","chrX","77324374","77324510","24","66912964"
"JH378150","10532268","10532534","chr10","63585093","63585357","59","53052825"
"JH378150","10554857","10555144","chr1","6699501","6699787","40","3855356"
"JH378150","10788402","10788694","chr24","11781500","11781793","41","993098"
"JH378150","11668175","11668487","chr19","22626676","22626983","44","10958501"
"JH378150","13293346","13293616","chr15","4986082","4986355","51","8307264"
"JH378150","13346021","13346329","chr20","104985298","104985598","50","91639277"
"JH378150","15180929","15181128","chr26","20999796","21000000","39","5818867"
"JH378150","15946309","15946607","chr9","86699927","86700224","45","70753618"
"JH378150","16169520","16169806","chr12","103186024","103186315","42","87016504"
"JH378150","16262768","16262929","chr3","187105","187248","49","16075663"
"JH378150","16265636","16265946","chr8","20072572","20072880","42","3806936"
"JH378150","16276293","16276431","chr1","21908644","21908788","27","5632351"
"JH378150","16276955","16277046","chr6","35238025","35238103","24","18961070"
"JH378151","441955","442110","chr9","32125196","32125331","41","31683241"
"JH378151","800338","800629","chr2","14848640","14848936","43","14048302"
"JH378151","974115","974341","chr5","15593128","15593380","76","14619013"
"JH378151","1969750","1970023","chr22","51367641","51367917","31","49397891"
"JH378151","2206188","2206470","chr20","83109188","83109482","66","80903000"
"JH378151","2504142","2504383","chr6","28190603","28190847","45","25686461"
"JH378151","2807457","2807740","chrX","29558025","29558318","46","26750568"
"JH378151","2930828","2931118","chr12","101706953","101707248","55","98776125"
"JH378151","2994891","2995170","chr20","77676897","77677178","41","74682006"
"JH378151","3114049","3114151","chr10","66128392","66128503","32","63014343"
"JH378151","4293168","4293463","chr4","74750244","74750542","44","70457076"
"JH378151","4462511","4462783","chr10","55562512","55562784","71","51100001"
"JH378151","4567355","4567645","chr13","6509678","6509967","36","1942323"
"JH378151","4585743","4585814","chr2","7577624","7577697","19","2991881"
"JH378151","4642935","4643245","chr11","33502906","33503207","47","28859971"
"JH378151","4756943","4757168","chr28","13453464","13453689","42","8696521"
"JH378151","6105418","6105626","chr13","96152783","96152983","36","90047365"
"JH378151","6297031","6297341","chr10","44221705","44222014","48","37924674"
"JH378151","6395086","6395301","chr15","9771214","9771427","43","3376128"
"JH378151","6419900","6420169","chr14","61597585","61597855","37","55177685"
"JH378151","6458679","6458957","chr3","4648816","4649103","51","1809863"
"JH378151","6544287","6544597","chr7","36241306","36241610","42","29697019"
"JH378151","6564475","6564619","chr9","117471956","117472107","40","110907481"
"JH378151","6640792","6641102","chr12","3898076","3898379","45","2742716"
"JH378151","6885869","6885998","chr4","90460665","90460796","27","83574796"
"JH378151","6968357","6968646","chr29","11069316","11069615","50","4100959"
"JH378151","7177295","7177480","chr10","94455021","94455185","62","87277726"
"JH378151","7493382","7493434","chr5","23010177","23010233","10","15516795"
"JH378151","7576192","7576491","chr5","14218217","14218516","44","6642025"
"JH378151","7684702","7684987","chr13","86323276","86323561","57","78638574"
"JH378151","7759213","7759438","chr14","8408006","8408236","46","648793"
"JH378151","7781396","7781702","chr6","29394044","29394346","39","21612648"
"JH378151","7840414","7840608","chr10","44668601","44668784","30","36828187"
"JH378151","8261324","8261621","chr1","8696866","8697165","39","435542"
"JH378151","8301330","8301392","chr10","91737432","91737490","21","83436102"
"JH378151","8301406","8301669","chr25","16525807","16526071","47","8224401"
"JH378151","8524907","8525201","chr8","50843851","50844144","42","42318944"
"JH378151","9156568","9156851","chrX","388719","388999","42","8767849"
"JH378151","9513209","9513525","chr16","36007753","36008062","44","26494544"
"JH378151","9563141","9563285","chr5","71122050","71122197","35","61558909"
"JH378151","9745005","9745302","chr28","15327544","15327835","47","5582539"
"JH378151","9819896","9820196","chr25","42166390","42166679","61","32346494"
"JH378151","9887027","9887239","chr23","42922019","42922224","41","33034992"
"JH378151","10152682","10152982","chr16","36007753","36008062","52","25855071"
"JH378151","11807642","11807951","chr6","36288281","36288590","38","24480639"
"JH378151","11812401","11812694","chr8","125663310","125663603","41","113850909"
"JH378151","12235553","12235846","chr20","103935663","103935958","44","91700110"
"JH378151","12259847","12260135","chrX","128244687","128244971","60","115984840"
"JH378151","12277644","12277912","chr14","61597585","61597855","33","49319941"
"JH378151","12844163","12844455","chr9","97265638","97265929","54","84421475"
"JH378151","12882128","12882459","chr8","69536522","69536828","80","56654394"
"JH378151","13127898","13128178","chr15","63096897","63097174","51","49968999"
"JH378151","13670851","13671154","chr10","102332242","102332544","43","88661391"
"JH378151","14047315","14047621","chrX","60403420","60403723","40","46356105"
"JH378151","14115007","14115304","chr15","5007900","5008197","38","9107107"
"JH378151","14116803","14117105","chr6","31992433","31992727","69","17875630"
"JH378151","14168486","14168804","chr21","110476819","110477125","51","96308333"
"JH378151","14368356","14368630","chr23","7334731","7335011","47","7033625"
"JH378151","14639899","14640200","chr14","92169283","92169582","40","77529384"
"JH378151","14950314","14950597","chr9","58167683","58167979","56","43217369"
"JH378151","14968212","14968373","chr13","29722270","29722425","32","14754058"
"JH378151","16330366","16330646","chr14","45592971","45593246","49","29262605"
"JH378151","16472702","16472992","chr12","79663159","79663453","48","63190457"
"JH378151","16716101","16716401","chr10","89318076","89318373","35","72601975"
"JH378151","17101807","17101965","chr25","55203429","55203580","39","38101622"
"JH378151","17106632","17106916","chr4","71555519","71555804","35","54448887"
"JH378152","1668100","1668365","chr14","12717469","12717730","47","11049369"
"JH378152","2404740","2405044","chr14","61597253","61597561","44","59192513"
"JH378152","2541437","2541657","chr16","10795330","10795551","40","8253893"
"JH378152","3359368","3359665","chr16","15391228","15391532","54","12031860"
"JH378152","4057618","4057924","chr4","31811484","31811787","40","27753866"
"JH378152","4149537","4149828","chr2","33362197","33362503","49","29212660"
"JH378152","5117720","5118021","chr14","92797882","92798190","55","87680162"
"JH378152","5264101","5264390","chr15","1318494","1318783","46","3945607"
"JH378152","6077723","6078030","chr28","12509435","12509742","35","6431712"
"JH378152","6304733","6305039","chr7","119466216","119466521","57","113161483"
"JH378152","7633411","7633726","chr12","15293737","15294044","47","7660326"
"JH378152","7810950","7811275","chr5","8592767","8593093","48","781817"
"JH378152","8145714","8145832","chr2","4976621","4976741","22","3169093"
"JH378152","8290889","8291197","chr7","58081445","58081753","46","49790556"
"JH378152","8342760","8342998","chr9","58607834","58608063","70","50265074"
"JH378152","10795581","10795862","chr1","114482348","114482630","51","103686767"
"JH378152","10833897","10834197","chr14","68359125","68359423","39","57525228"
"JH378152","11365087","11365367","chr5","42930459","42930742","44","31565372"
"JH378152","11534657","11534937","chr1","51035370","51035662","42","39500713"
"JH378152","11591400","11591568","chr20","70905611","70905774","32","59314211"
"JH378152","11651077","11651373","chr10","104330612","104330907","48","92679535"
"JH378152","11718102","11718227","chr6","33578769","33578895","18","21860667"
"JH378152","12051083","12051380","chr29","22012118","22012414","47","9961035"
"JH378152","12347620","12347900","chr11","42101160","42101440","35","29753540"
"JH378152","12451063","12451346","chr14","86997958","86998245","40","74546895"
"JH378152","12841840","12842158","chr12","25030968","25031277","49","12189128"
"JH378152","13110674","13110949","chr9","17604750","17605020","61","4494076"
"JH378152","13126313","13126615","chr20","39089189","39089491","40","25962876"
"JH378152","13460426","13460734","chrX_KE148108v1_random","4599625","4599934","52","8860801"
"JH378152","13733278","13733586","chr1","9360845","9361141","52","4372433"
"JH378152","14092214","14092501","chr19","19336208","19336496","38","5243994"
"JH378152","14134632","14134944","chr7","91843770","91844065","60","77709138"
"JH378152","14276683","14276991","chr9","62219075","62219386","36","47942392"
"JH378152","14402331","14402564","chr1","2272506","2272749","47","12129825"
"JH378152","14660258","14660566","chr19","11685568","11685863","43","2974690"
"JH378152","14893307","14893507","chr4","50510683","50510871","39","35617376"
"JH378152","14949193","14949475","chr1","114482348","114482630","37","99533155"
"JH378152","15128040","15128325","chr10","18802261","18802546","41","3674221"
"JH378152","15379298","15379584","chr13","86323276","86323561","35","70943978"
"JH378152","15950596","15950890","chr9","97265638","97265929","40","81315042"
"JH378152","16224894","16225238","chr16","12955116","12955426","75","3269778"
"JH378152","16444356","16444663","chr5","10824452","10824759","42","5619904"
"JH378152","16487001","16487209","chr2","52457627","52457845","40","35970626"
"JH378152","16487249","16487316","chr19","13280888","13280967","23","3206361"
"JH378152","16662468","16662578","chr21","98385810","98385904","34","81723342"
"JH378153","118006","118300","chr10","18339526","18339800","71","18221520"
"JH378153","444052","444387","chr25","25810029","25810359","54","25365977"
"JH378153","575974","576272","chr7","119466216","119466521","45","118890242"
"JH378153","613941","614139","chr12","43962243","43962428","40","43348302"
"JH378153","644535","644837","chr18","59850632","59850929","35","59206097"
"JH378153","757853","758154","chr2","80562522","80562815","51","79804669"
"JH378153","813139","813415","chr9","58155888","58156167","42","57342749"
"JH378153","860855","861158","chr3","27047348","27047655","41","26186493"
"JH378153","884392","884685","chr10","104330612","104330907","39","103446220"
"JH378153","1202142","1202435","chr10","117276725","117277019","44","116074583"
"JH378153","1521831","1522135","chr16","18257374","18257671","50","16735543"
"JH378153","1833449","1833633","chr18","22772283","22772466","29","20938834"
"JH378153","2027412","2027722","chr9","20557395","20557703","42","18529983"
"JH378153","2063141","2063414","chr4","51976280","51976557","43","49913139"
"JH378153","2373181","2373486","chr4","74750244","74750542","42","72377063"
"JH378153","2554640","2554943","chrX","60403420","60403723","37","57848780"
"JH378153","2574965","2575125","chr16","70459044","70459205","30","67884079"
"JH378153","2809195","2809493","chr19","22626676","22626983","40","19817481"
"JH378153","2845602","2845908","chr6","8634857","8635167","31","5789255"
"JH378153","3134930","3135041","chr6","35661566","35661675","18","32526636"
"JH378153","3204318","3204627","chr6","9713724","9714033","41","6509406"
"JH378153","3227960","3228121","chr6","43429100","43429261","29","40201140"
"JH378153","3248739","3249036","chr11","87886803","87887101","39","84638064"
"JH378153","3256917","3257047","chr13","80405244","80405376","19","77148327"
"JH378153","3331718","3331938","chr19","24215041","24215262","48","20883323"
"JH378153","3343038","3343319","chr9","18313882","18314160","40","14970844"
"JH378153","3436926","3437222","chr6","49004703","49004998","43","45567777"
"JH378153","3650740","3651020","chr7","132875812","132876090","49","129225072"
"JH378153","4021115","4021453","chr16","49593730","49594049","54","45572615"
"JH378153","4724014","4724314","chr8","69536522","69536828","50","64812508"
"JH378153","5302443","5302575","chr13","93936933","93937062","18","88634490"
"JH378153","5318578","5318868","chr14","5412498","5412797","47","93920"
"JH378153","5336606","5336906","chrX","43777377","43777676","48","38440771"
"JH378153","6149354","6149642","chr12","41086556","41086842","33","34937202"
"JH378153","6443494","6443803","chrX","111147394","111147703","48","104703900"
"JH378153","6521007","6521162","chr20","115225004","115225156","41","108703997"
"JH378153","6526887","6527205","chr9","111183120","111183448","62","104656233"
"JH378153","6824989","6825263","chr4","51976280","51976557","39","45151291"
"JH378153","7128587","7128804","chr25","19270221","19270449","59","12141634"
"JH378153","7493734","7493919","chr19","16893479","16893663","32","9399745"
"JH378153","7746142","7746445","chr12","3898076","3898379","43","3848066"
"JH378153","8013794","8013922","chr14","67782475","67782602","21","59768681"
"JH378153","9535300","9535600","chr29","3711047","3711343","45","5824253"
"JH378153","9540032","9540341","chr9","62219075","62219386","44","52679043"
"JH378153","9714722","9715021","chr21","97469770","97470066","40","87755048"
"JH378153","9921476","9921779","chr22","9714838","9715138","35","206638"
"JH378153","10168402","10168706","chr1","98960303","98960603","44","88791901"
"JH378153","10196739","10196963","chr17","45336545","45336772","44","35139806"
"JH378153","11266727","11266996","chr19","23425164","23425442","64","12158437"
"JH378153","11346685","11346810","chr7","54942222","54942331","35","43595537"
"JH378153","11653662","11653934","chr11","9923400","9923670","50","1730262"
"JH378153","11664975","11665268","chr24","11781500","11781793","43","116525"
"JH378153","11806235","11806543","chr9","85410997","85411306","39","73604762"
"JH378153","12008080","12008380","chrX","60057029","60057325","47","48048949"
"JH378153","12222449","12222752","chr1","55479193","55479488","67","43256744"
"JH378153","12239696","12239989","chr12","65356809","65357103","31","53117113"
"JH378153","12937080","12937362","chr11","32572841","32573128","45","19635761"
"JH378153","12964824","12964997","chr3","77318398","77318568","26","64353574"
"JH378153","13182974","13183218","chr20","109309565","109309789","66","96126591"
"JH378153","13327301","13327605","chr8","7331653","7331946","48","5995648"
"JH378153","13667752","13668057","chr1","113325394","113325698","57","99657642"
"JH378153","13965473","13965781","chr14","80779962","80780266","43","66814489"
"JH378153","14256294","14256429","chr5","70321221","70321359","21","56064927"
"JH378153","14388777","14389045","chr23","63036814","63037090","42","48648037"
"JH378153","16106967","16107233","chr9","119241694","119241960","46","103134727"
"JH378154","946856","947156","chr1","29621888","29622188","38","28675032"
"JH378154","1138904","1139204","chr9","62609877","62610171","53","61470973"
"JH378154","1532905","1533187","chr11","121539693","121539979","43","120006788"
"JH378154","2040014","2040309","chrX","29558025","29558318","37","27518011"
"JH378154","2165379","2165705","chr2","18228939","18229246","64","16063560"
"JH378154","4147815","4148067","chrX","108462793","108463063","61","104314978"
"JH378154","5730717","5730983","chr20","120203418","120203695","57","114472701"
"JH378154","6105130","6105414","chrX","85829317","85829602","52","79724187"
"JH378154","6504584","6504873","chr9","31281354","31281649","53","24776770"
"JH378154","7352866","7353154","chr24","28147960","28148255","59","20795094"
"JH378154","8408715","8409009","chr26","4458411","4458686","67","3950304"
"JH378154","9110889","9111184","chr16","66139074","66139369","43","57028185"
"JH378154","10605464","10605774","chr2","22860155","22860456","39","12254691"
"JH378154","10623416","10623706","chr20","105708807","105709105","53","95085391"
"JH378154","12293932","12294233","chr10","102332242","102332544","45","90038310"
"JH378154","12319657","12319960","chrX","60403420","60403723","44","48083763"
"JH378154","13024553","13024853","chr23","57612824","57613126","52","44588271"
"JH378154","13292060","13292359","chr24","11781500","11781793","41","1510560"
"JH378154","13462019","13462315","chr19","27584635","27584934","36","14122616"
"JH378154","13468830","13469134","chr7","14220558","14220867","48","751728"
"JH378154","13824826","13824977","chr13","61564391","61564541","32","47739565"
"JH378154","14083171","14083478","chr19","32620355","32620659","44","18537184"
"JH378154","14273139","14273245","chr21","103512848","103512947","23","89239709"
"JH378154","14447020","14447288","chr27","34512765","34513037","61","20065745"
"JH378154","14469748","14469931","chr20_KE148050v1_random","1166449","1166639","36","13303299"
"JH378154","15758237","15758539","chr10","104330612","104330907","52","88572375"
"JH378154","15889377","15889679","chr4","75730761","75731061","51","59841384"
"JH378154","15942433","15942728","chr16","14482255","14482552","47","1460178"
"JH378154","16021275","16021570","chr3","31757392","31757689","47","15736117"
"JH378154","16032366","16032667","chr2","14953819","14954119","32","1078547"
"JH378155","1851084","1851255","chr5","14308413","14308583","33","12457329"
"JH378155","2014298","2014599","chr4","74750244","74750542","42","72735946"
"JH378155","2130296","2130545","chr2","20173547","20173802","45","18043251"
"JH378155","3018251","3018542","chr7_AQIB01159043v1_random","18062","18357","33","3000189"
"JH378155","4299792","4300113","chr2","54312462","54312771","51","50012670"
"JH378155","5764277","5764578","chrX","58994083","58994385","39","53229806"
"JH378155","5987355","5987647","chr11","42708500","42708788","39","36721145"
"JH378155","6739990","6740251","chr1","106079163","106079424","38","99339173"
"JH378155","7432879","7433176","chr11","42708500","42708788","58","35275621"
"JH378155","7671062","7671362","chr4","74750244","74750542","42","67079182"
"JH378155","8532713","8532961","chr17","41816726","41816966","53","33284013"
"JH378155","10725691","10725988","chr7","133599241","133599536","47","122873550"
"JH378155","10847929","10848213","chr6","26593661","26593944","51","15745732"
"JH378155","11179816","11180114","chr16","27667099","27667396","57","16487283"
"JH378155","12687908","12688172","chr22","9226203","9226481","50","3461705"
"JH378155","13638330","13638628","chr10","44221705","44222014","48","30583375"
"JH378155","14387102","14387296","chr16","62117476","62117671","29","47730374"
"JH378156","142044","142350","chr5","26884776","26885075","45","26742732"
"JH378156","144234","144448","chr23","52506499","52506722","44","52362265"
"JH378156","234677","234969","chr9","61932207","61932503","47","61697530"
"JH378156","630765","631074","chr4","31811484","31811787","51","31180719"
"JH378156","1377778","1377796","chr6","40919176","40919192","3","39541398"
"JH378156","1378304","1378445","chr21","99460334","99460473","22","98082030"
"JH378156","1480982","1481291","chr2","33362197","33362503","38","31881215"
"JH378156","2241498","2241770","chr6","40316487","40316767","53","38074989"
"JH378156","2363263","2363565","chr16","14422338","14422632","51","12059075"
"JH378156","2607714","2607835","chr2","14267810","14267928","18","11660096"
"JH378156","2609840","2610135","chr4","74707922","74708225","42","72098082"
"JH378156","2611227","2611513","chr18","68029598","68029875","42","65418371"
"JH378156","3619322","3619606","chr20","2854395","2854680","34","764927"
"JH378156","4112120","4112419","chrX","41905010","41905298","50","37792890"
"JH378156","4206792","4206984","chr10","104506113","104506306","33","100299321"
"JH378156","4406840","4407155","chr18","63833457","63833758","57","59426617"
"JH378156","4616620","4616918","chr3","25784267","25784567","44","21167647"
"JH378156","5820778","5820999","chr11","127416029","127416256","32","121595251"
"JH378156","6143192","6143500","chrX","51256568","51256876","53","45113376"
"JH378156","6187137","6187423","chr4","51700470","51700755","49","45513333"
"JH378156","6312914","6313191","chr20","105708807","105709105","47","99395893"
"JH378156","6409808","6410117","chr18","31461630","31461936","42","25051822"
"JH378156","6432890","6433178","chr20","2854395","2854680","39","3578495"
"JH378156","6924569","6924829","chr1","73623928","73624197","51","66699359"
"JH378156","6945904","6946054","chr5","71122050","71122197","23","64176146"
"JH378156","6955135","6955438","chr9","57933408","57933710","39","50978273"
"JH378156","8323069","8323341","chr16","17103242","17103520","37","8780173"
"JH378156","8455551","8455806","chr26","38595395","38595663","47","30139844"
"JH378156","9407894","9408193","chr3","30187575","30187872","56","20779681"
"JH378156","10107933","10108222","chr23","80040682","80040974","41","69932749"
"JH378156","10750705","10751005","chr7","41384280","41384575","49","30633575"
"JH378156","10755871","10756018","chr14","947149","947293","24","9808722"
"JH378156","11262461","11262629","chr24","76523592","76523762","36","65261131"
"JH378156","11412178","11412458","chr11","24876645","24876927","42","13464467"
"JH378156","12918002","12918299","chr9","97265638","97265929","48","84347636"
"JH378156","14260757","14261010","chr6","3646070","3646335","70","10614687"
"JH378156","14452877","14453154","chr21","126969960","126970241","47","112517083"
"JH378156","15734827","15735109","chr7","22735422","22735720","60","7000595"
"JH378156","15919447","15919718","chr20","119275773","119276050","53","103356326"
"JH378157","148839","149121","chr2","26528623","26528910","64","26379784"
"JH378157","216588","216902","chr29","23721535","23721844","49","23504947"
"JH378157","301003","301193","chr20","113342426","113342612","23","113041423"
"JH378157","1015211","1015396","chr22","74857230","74857409","31","73842019"
"JH378157","1016342","1016397","chr5","2445602","2445676","24","1429260"
"JH378157","1555628","1555906","chr14","68359125","68359423","45","66803497"
"JH378157","1779227","1779489","chr25","77773108","77773371","49","75993881"
"JH378157","2296265","2296475","chr23","79650541","79650766","71","77354276"
"JH378157","2353523","2353816","chr26","26868700","26868994","38","24515177"
"JH378157","2448175","2448380","chr10","38837051","38837254","42","36388876"
"JH378157","2567505","2567726","chr8","120238157","120238376","35","117670652"
"JH378157","2732508","2732805","chr4","35239086","35239384","49","32506578"
"JH378157","3666293","3666605","chr11","83560875","83561170","61","79894582"
"JH378157","3932632","3932923","chr1","84971033","84971323","47","81038401"
"JH378157","4889784","4889998","chr12","108518404","108518625","38","103628620"
"JH378157","6133773","6134078","chr16","68481091","68481389","76","62347318"
"JH378157","6182236","6182506","chr17","62202297","62202577","46","56020061"
"JH378157","6766562","6766696","chrUn_AQIB01158800v1","1","125","23","6766561"
"JH378157","6853218","6853345","chr22","3180119","3180245","16","3673099"
"JH378157","7119209","7119493","chr16","61943605","61943901","58","54824396"
"JH378157","7419948","7420067","chr13","93936933","93937062","21","86516985"
"JH378157","7431803","7432082","chr15","76465178","76465474","48","69033375"
"JH378157","7504391","7504557","chr11","59867158","59867285","57","52362767"
"JH378157","7662418","7662716","chr22","7481424","7481721","38","180994"
"JH378157","7855841","7856142","chr26","18794536","18794836","38","10938695"
"JH378157","7944461","7944733","chr18","48953277","48953567","49","41008816"
"JH378157","7962263","7962497","chr19","24215041","24215262","44","16252778"
"JH378157","7970430","7970726","chr1","67566937","67567228","52","59596507"
"JH378157","8075695","8075999","chr26","18794536","18794836","37","10718841"
"JH378157","8138361","8138659","chr6","32749709","32750008","39","24611348"
"JH378157","8599560","8599685","chr26","11354204","11354323","30","2754644"
"JH378157","8608442","8608669","chrX","92178511","92178733","40","83570069"
"JH378157","8714484","8714662","chrX","238563","238744","35","8475921"
"JH378157","9062354","9062699","chr10","39012436","39012740","82","29950082"
"JH378157","9231611","9231901","chrX","17670935","17671231","44","8439324"
"JH378157","9252022","9252282","chr11","8392467","8392726","37","859555"
"JH378157","9325727","9326034","chr2","61035797","61036096","42","51710070"
"JH378157","9365949","9366225","chr12","96489987","96490266","48","87124038"
"JH378157","9440189","9440440","chr4","14253886","14254130","43","4813697"
"JH378157","9526472","9526591","chr16","44225988","44226106","18","34699516"
"JH378157","9527122","9527219","chr6","11844044","11844146","18","2316922"
"JH378157","9596256","9596540","chr12","103186024","103186315","41","93589768"
"JH378157","9622075","9622376","chr1","64953626","64953920","52","55331551"
"JH378157","9911311","9911518","chr28","5263156","5263365","26","4648155"
"JH378157","9983000","9983312","chrX","61756996","61757299","45","51773996"
"JH378157","10000156","10000463","chr20","7876234","7876541","47","2123922"
"JH378157","10281777","10282050","chr14","33993071","33993339","65","23711294"
"JH378157","10341850","10342130","chr25","18415051","18415339","41","8073201"
"JH378157","10686133","10686265","chr20","71356227","71356358","20","60670094"
"JH378157","10844624","10844915","chr23","80642893","80643191","43","69798269"
"JH378157","10853951","10854248","chrX","33027186","33027484","51","22173235"
"JH378157","10888369","10888671","chr20","115487637","115487936","34","104599268"
"JH378157","11028561","11028847","chr3","6414985","6415283","43","4613576"
"JH378157","11075766","11076065","chr16","18257374","18257671","32","7181608"
"JH378157","11087507","11087630","chr12","13186092","13186213","19","2098585"
"JH378157","11392662","11392833","chr20","7668107","7668299","53","3724555"
"JH378157","11481651","11481941","chr2","61035797","61036096","54","49554146"
"JH378157","11659352","11659646","chr1","8696866","8697165","40","2962486"
"JH378157","11682473","11682512","chr6","34888139","34888179","8","23205666"
"JH378157","12037697","12037931","chr9","86755766","86756000","27","74718069"
"JH378157","12150735","12150976","chr20","107997025","107997264","41","95846290"
"JH378157","12808939","12809231","chr24","40072459","40072748","39","27263520"
"JH378157","13511390","13511596","chr16","9005892","9006101","42","4505498"
"JH378157","13662036","13662343","chr2","61035797","61036096","34","47373761"
"JH378157","14198871","14199178","chr4","31811484","31811787","41","17612613"
"JH378157","15047554","15047855","chr8","122252804","122253107","43","107205250"
"JH378157","15216305","15216613","chr16","41764138","41764434","55","26547833"
"JH378157","15476850","15477129","chr13","86323276","86323561","47","70846426"
"JH378157","15617448","15617740","chr16","6093139","6093421","56","9524309"
"JH378157","15715271","15715383","chrX","105255765","105255881","28","89540494"
"JH378158","35858","36147","chr18","31464231","31464522","46","31428373"
"JH378158","48997","49286","chr9","6382689","6382978","40","6333692"
"JH378158","216371","216667","chr4","72474636","72474936","44","72258265"
"JH378158","695086","695380","chr13","6509678","6509967","52","5814592"
"JH378158","1322992","1323189","chr7","131233865","131234062","42","129910873"
"JH378158","2177847","2178114","chr26","42372142","42372415","52","40194295"
"JH378158","2191628","2191928","chr12","3898076","3898379","42","1706448"
"JH378158","2370584","2370847","chr14","60740033","60740297","44","58369449"
"JH378158","3184676","3184964","chr6","9253209","9253500","50","6068533"
"JH378158","3484128","3484433","chr15","2000778","2001083","55","1483350"
"JH378158","3528611","3528910","chr14","68359125","68359423","30","64830514"
"JH378158","3851756","3852033","chr12","73233764","73234041","47","69382008"
"JH378158","3908820","3909017","chr16","3325467","3325655","48","583353"
"JH378158","4119849","4119979","chr6","33578769","33578895","26","29458920"
"JH378158","4317045","4317162","chr7","106999873","106999998","24","102682828"
"JH378158","4636495","4636792","chr15","49450161","49450465","52","44813666"
"JH378158","4834786","4835066","chr23","57612824","57613126","59","52778038"
"JH378158","5077448","5077748","chrX","89742775","89743068","54","84665327"
"JH378158","5179860","5180166","chr8","47492135","47492438","45","42312275"
"JH378158","5570780","5571084","chr12","41019638","41019945","47","35448858"
"JH378158","5821353","5821669","chr7","91843770","91844065","75","86022417"
"JH378158","6926433","6926562","chr13","93936933","93937062","19","87010500"
"JH378158","7341633","7341872","chr1","2272506","2272749","52","5069127"
"JH378158","8135440","8135737","chr1","8696866","8697165","40","561426"
"JH378158","8170416","8170705","chr12","89549388","89549667","48","81378972"
"JH378158","8233265","8233555","chr9","6382689","6382978","45","1850576"
"JH378158","8305339","8305648","chr20","7876234","7876541","43","429105"
"JH378158","8426010","8426244","chr24","6466580","6466820","31","1959430"
"JH378158","8904089","8904392","chr25","27839006","27839308","40","18934917"
"JH378158","9043991","9044299","chr12","25030968","25031277","39","15986977"
"JH378158","9219027","9219342","chr20","80727402","80727700","58","71508375"
"JH378158","9665100","9665319","chr8","120238157","120238376","36","110573057"
"JH378158","9736001","9736124","chr16","58247487","58247609","15","48511486"
"JH378158","10781275","10781453","chr8","112629520","112629695","27","101848245"
"JH378158","12421374","12421605","chr8","77469644","77469870","47","65048270"
"JH378158","12479114","12479413","chr15","43966407","43966704","50","31487293"
"JH378158","12903633","12903898","chr1","62973229","62973484","77","50069596"
"JH378158","13637026","13637260","chr1","18375911","18376144","50","4738885"
"JH378158","14205455","14205589","chr14","33067112","33067242","25","18861657"
"JH378158","14565642","14565936","chr22","30234167","30234462","47","15668525"
"JH378158","16184033","16184298","chr23","37087327","37087607","47","20903294"
"JH378159","273174","273473","chr28","8917006","8917294","47","8643832"
"JH378159","943867","944164","chr1","8696866","8697165","54","7752999"
"JH378159","2440675","2440913","chr20","105731292","105731520","42","103290617"
"JH378159","3008608","3008889","chr1","114482348","114482630","37","111473740"
"JH378159","3733732","3733850","chr2","4976621","4976741","17","1242889"
"JH378159","3827552","3827659","chr3","1161792","1161901","25","2665760"
"JH378159","4111428","4111733","chr28","13645418","13645720","48","9533990"
"JH378159","4153019","4153316","chr5","26884776","26885075","36","22731757"
"JH378159","5071429","5071717","chr1","64953626","64953920","61","59882197"
"JH378159","5103688","5104018","chr20","119136193","119136516","58","114032505"
"JH378159","5207871","5207992","chr14","3273365","3273488","16","1934506"
"JH378159","5352954","5353262","chr1","125024996","125025302","42","119672042"
"JH378159","5884222","5884472","chr2","11956421","11956671","42","6072199"
"JH378159","5895416","5895660","chr14","88780485","88780747","51","82885069"
"JH378159","5950784","5950929","chr20","44573701","44573841","22","38622917"
"JH378159","7436657","7436957","chr19","27584635","27584934","47","20147978"
"JH378159","7548067","7548183","chr6","33618456","33618572","16","26070389"
"JH378159","7981483","7981679","chr10","104506113","104506306","42","96524630"
"JH378159","8069076","8069380","chr9","57933408","57933710","46","49864332"
"JH378159","8109280","8109562","chr28","8917006","8917294","63","807726"
"JH378159","8179085","8179354","chr21","119845377","119845648","50","111666292"
"JH378159","10061648","10061964","chr25","79338948","79339251","56","69277300"
"JH378159","10122475","10122773","chr16","24824595","24824890","48","14702120"
"JH378159","10971962","10972245","chr10","94104509","94104789","50","83132547"
"JH378159","11796923","11797056","chr17","30173106","30173243","33","18376183"
"JH378159","11895985","11896282","chr11","67594349","67594643","46","55698364"
"JH378159","12079239","12079527","chr20","104293209","104293496","37","92213970"
"JH378159","12107172","12107455","chr20","2854395","2854680","35","9252777"
"JH378159","12305602","12305782","chr26","42437123","42437309","36","30131521"
"JH378159","15655828","15655996","chr19","11544687","11544855","35","4111141"
"JH378159","15797648","15797775","chr4","90460665","90460796","20","74663017"
"JH378159","15869207","15869505","chr26","3368101","3368400","36","12501106"
"JH378159","15901582","15901853","chr1","29294849","29295125","32","13393267"
"JH378160","24158","24379","chr5","12500001","12500225","38","12475843"
"JH378160","420868","421166","chr14","68359125","68359423","36","67938257"
"JH378160","538899","539205","chrX","111529648","111529952","43","110990749"
"JH378160","867353","867481","chr14","67782475","67782602","26","66915122"
"JH378160","930861","931144","chr9","106946005","106946287","38","106015144"
"JH378160","2104897","2105044","chr15","51773180","51773322","42","49668283"
"JH378160","2200112","2200408","chr7","41384280","41384575","42","39184168"
"JH378160","3377439","3377671","chr7","57513437","57513664","56","54135998"
"JH378160","4232528","4232802","chr17","47805481","47805753","50","43572953"
"JH378160","4945251","4945507","chr7","116216737","116217000","55","111271486"
"JH378160","5893003","5893303","chr4","69032146","69032449","42","63139143"
"JH378160","5907398","5907672","chr24","68878046","68878321","51","62970648"
"JH378160","5958641","5958900","chr5","49568120","49568383","63","43609479"
"JH378160","5986430","5986618","chr20","113342426","113342612","38","107355996"
"JH378160","7405898","7406186","chr14","97755318","97755609","61","90349420"
"JH378160","7918504","7918770","chr12","89549388","89549667","78","81630884"
"JH378160","8607198","8607461","chrUn_KE147935v1","146975","147240","43","8460223"
"JH378160","8688163","8688472","chr1","21484113","21484426","48","12795950"
"JH378160","8856917","8857053","chr4","90460665","90460796","23","81603748"
"JH378160","8969482","8969774","chr12","41367876","41368167","41","32398394"
"JH378160","10930110","10930423","chr15","2000778","2001083","39","8929332"
"JH378160","11166023","11166308","chr1","67566937","67567228","45","56400914"
"JH378160","11788692","11788992","chr1","29621888","29622188","39","17833196"
"JH378160","11799284","11799509","chr10","37608567","37608791","42","25809283"
"JH378160","12169265","12169562","chr11","83560875","83561170","40","71391610"
"JH378160","12351377","12351662","chr25","65601441","65601724","36","53250064"
"JH378160","12360513","12360732","chr12","108518404","108518625","45","96157891"
"JH378160","12769715","12769945","chr12","83070817","83071048","42","70301102"
"JH378160","12942204","12942479","chr10","89968309","89968588","47","77026105"
"JH378160","12985564","12985774","chrX","124509631","124509844","39","111524067"
"JH378160","13136738","13136893","chr22","27074075","27074227","17","13937337"
"JH378160","13137070","13137215","chr1","110070240","110070388","21","96933170"
"JH378160","13582208","13582487","chr11","42708500","42708788","46","29126292"
"JH378160","14387362","14387670","chr23","81285499","81285798","56","66898137"
"JH378160","14701617","14701902","chr23","37622829","37623120","41","22921212"
"JH378160","15358557","15358840","chr17","38569856","38570151","60","23211299"
"JH378160","15377168","15377469","chr21","74458426","74458722","49","59081258"
"JH378160","15424058","15424309","chr20","80178770","80179019","43","64754712"
"JH378161","385748","386060","chr18","57336811","57337111","38","56951063"
"JH378161","402745","403047","chr22","34201969","34202268","44","33799224"
"JH378161","1677425","1677708","chr3","6781605","6781888","51","5104180"
"JH378161","1952467","1952763","chr13","86923785","86924086","44","84971318"
"JH378161","2031402","2031526","chr6","37703627","37703760","28","35672225"
"JH378161","2049786","2050053","chr11","29396564","29396830","46","27346778"
"JH378161","2131778","2131948","chr3","18442914","18443095","45","16311136"
"JH378161","2207729","2208029","chr9","28112269","28112568","38","25904540"
"JH378161","2244238","2244543","chr15","91719458","91719759","62","89475220"
"JH378161","3038471","3038553","chr10","103943451","103943533","20","100904980"
"JH378161","3601603","3601901","chr7","130499463","130499763","33","126897860"
"JH378161","3737570","3737849","chr4","83090752","83091031","47","79353182"
"JH378161","4128085","4128388","chr12","97392320","97392622","51","93264235"
"JH378161","4356357","4356530","chr19","11544687","11544855","35","7188330"
"JH378161","4573095","4573385","chr24","41083345","41083640","54","36510250"
"JH378161","4696754","4696974","chr19","24215041","24215262","39","19518287"
"JH378161","5187310","5187532","chr12","108518404","108518625","37","103331094"
"JH378161","5249121","5249343","chr12","108518404","108518625","32","103269283"
"JH378161","5369063","5369346","chr26","15899386","15899677","50","10530323"
"JH378161","5622645","5622810","chr11","117718811","117718965","35","112096166"
"JH378161","5669776","5670077","chr11","116558393","116558699","42","110888617"
"JH378161","5685357","5685652","chr20","97098637","97098929","43","91413280"
"JH378161","5883275","5883530","chr2","87954053","87954315","39","82070778"
"JH378161","6611378","6611672","chr15","90289278","90289569","49","83677900"
"JH378161","7073174","7073484","chrX","46516548","46516857","48","39443374"
"JH378161","7628034","7628318","chr20","2854395","2854680","35","4773639"
"JH378161","7724800","7725105","chr23","77412682","77412987","47","69687882"
"JH378161","8021740","8022025","chr16","7746162","7746454","36","275578"
"JH378161","8575339","8575636","chr3","11271071","11271367","45","2695732"
"JH378161","8885126","8885290","chr19","11544687","11544855","32","2659561"
"JH378161","8885941","8886220","chr2","80347966","80348251","51","71462025"
"JH378161","8926638","8926909","chr20","89878764","89879039","51","80952126"
"JH378161","8975253","8975423","chr26","17040288","17040464","27","8065035"
"JH378161","9005059","9005129","chr14","63687139","63687201","15","54682080"
"JH378161","9837080","9837363","chr21","108593430","108593710","44","98756350"
"JH378161","9953885","9954170","chr15","76326616","76326912","47","66372731"
"JH378161","12479037","12479316","chr10","29167842","29168112","55","16688805"
"JH378161","12566557","12566837","chr14","53650197","53650475","34","41083640"
"JH378161","12728902","12729150","chr1","41979357","41979596","46","29250455"
"JH378161","12879727","12879940","chr11","100225388","100225600","31","87345661"
"JH378161","13012851","13013131","chr10","15761247","15761525","48","2748396"
"JH378161","13157937","13158217","chr19","4455651","4455943","43","8702286"
"JH378161","14166774","14167064","chr11","46870539","46870831","45","32703765"
"JH378161","14807134","14807434","chr1","8696866","8697165","52","6110268"
"JH378162","22087","22328","chr1","50678867","50679117","53","50656780"
"JH378162","980793","981091","chr1","117467462","117467775","85","116486669"
"JH378162","2066816","2067100","chr29","9188440","9188729","62","7121624"
"JH378162","2313756","2314061","chr26","24027927","24028229","41","21714171"
"JH378162","3702084","3702370","chr1","67566937","67567228","44","63864853"
"JH378162","3837709","3837827","chr2","87262500","87262610","24","83424791"
"JH378162","5011990","5012302","chr16","18299936","18300237","55","13287946"
"JH378162","5323259","5323573","chr20","7876234","7876541","39","2552975"
"JH378162","5476290","5476567","chr9","99714018","99714298","53","94237728"
"JH378162","5774910","5775200","chrX","44659146","44659440","48","38884236"
"JH378162","5850623","5850886","chr25","77773108","77773371","36","71922485"
"JH378162","5883843","5884030","chr11","45526318","45526502","31","39642475"
"JH378162","6710637","6710908","chr14","75250425","75250685","60","68539788"
"JH378162","8877285","8877586","chr6","10540061","10540366","52","1662776"
"JH378162","9077399","9077685","chr24","73112801","73113086","54","64035402"
"JH378162","9369472","9369673","chr11","100225388","100225600","39","90855916"
"JH378162","10457943","10458233","chr1","68970266","68970543","50","58512323"
"JH378162","10977725","10978013","chr5","26884776","26885075","45","15907051"
"JH378162","11285370","11285595","chr20","73604908","73605140","55","62319538"
"JH378162","11398845","11399140","chr4","74750244","74750542","44","63351399"
"JH378162","11799516","11799689","chr19","11544687","11544855","26","254829"
"JH378162","12698635","12698930","chr19","11685568","11685863","44","1013067"
"JH378162","13003765","13004038","chr12","73233764","73234041","45","60229999"
"JH378163","352750","353067","chrX_KE148108v1_random","4599625","4599934","51","4246875"
"JH378163","382784","383092","chr11","103249802","103250109","47","102867018"
"JH378163","572696","572904","chr8","120238157","120238376","42","119665461"
"JH378163","4646468","4646707","chr16","40626399","40626635","32","35979931"
"JH378163","4895182","4895492","chr16","57032948","57033254","46","52137766"
"JH378163","4974148","4974433","chr20","2854395","2854680","42","2119753"
"JH378163","5539511","5539805","chr4","74750244","74750542","36","69210733"
"JH378163","5553827","5554112","chr16","7888226","7888516","34","2334399"
"JH378163","5911595","5911865","chr14","61597585","61597855","39","55685990"
"JH378163","6021391","6021678","chr20","19842108","19842392","50","13820717"
"JH378163","6856147","6856426","chr6","33738823","33739106","48","26882676"
"JH378163","9122769","9123087","chr12","72899340","72899646","53","63776571"
"JH378163","9466982","9467120","chr20","20635550","20635688","19","11168568"
"JH378163","9914670","9915001","chr20","95938099","95938408","64","86023429"
"JH378163","10430108","10430367","chr11","31189578","31189838","49","20759470"
"JH378163","10924914","10925212","chr20","24901179","24901477","40","13976265"
"JH378163","11110658","11110776","chr1","19184037","19184145","28","8073379"
"JH378163","11941026","11941321","chr20","90303203","90303504","53","78362177"
"JH378163","12663140","12663442","chrX_KE148121v1_random","11317","11619","54","12651823"
"JH378163","12788094","12788381","chr17","36107859","36108154","45","23319765"
"JH378163","12911015","12911309","chr11","83560875","83561170","44","70649860"
"JH378163","13044476","13044752","chr10","105580133","105580401","53","92535657"
"JH378163","13307515","13307812","chrX","47726776","47727071","51","34419261"
"JH378163","14279060","14279196","chr4","90460665","90460796","28","76181605"
"JH378163","14500001","14500102","chr1","19184037","19184145","22","4684036"
"JH378163","14669905","14670210","chr6","10540061","10540366","43","4129844"
"JH378164","412445","412633","chr16","74527352","74527538","36","74114907"
"JH378164","752205","752525","chr10","59935987","59936305","50","59183782"
"JH378164","1254265","1254547","chr23","38922269","38922564","54","37668004"
"JH378164","1260232","1260523","chr2","80347966","80348251","78","79087734"
"JH378164","1894872","1895055","chr5","192637","192820","27","1702235"
"JH378164","1957399","1957672","chr17","28034215","28034492","54","26076816"
"JH378164","2100902","2101200","chr1","31259486","31259780","40","29158584"
"JH378164","2154013","2154287","chr11","4332732","4332996","43","2178719"
"JH378164","2474563","2474863","chr13","41724361","41724668","43","39249798"
"JH378164","2528872","2529163","chr25","74344693","74344987","35","71815821"
"JH378164","2529729","2530038","chr12","88346471","88346778","36","85816742"
"JH378164","2563964","2564274","chr3","25784267","25784567","132","23220303"
"JH378164","2564854","2565119","chr1","112610540","112610791","55","110045686"
"JH378164","2941043","2941334","chr2","88624954","88625246","50","85683911"
"JH378164","2992276","2992566","chr11","42708500","42708788","45","39716224"
"JH378164","3036015","3036321","chr6","32749709","32750008","41","29713694"
"JH378164","3158119","3158423","chr18","59336926","59337219","56","56178807"
"JH378164","3308416","3308710","chr2","14848640","14848936","57","11540224"
"JH378164","4818112","4818333","chr2","52457627","52457845","29","47639515"
"JH378164","5266586","5266883","chr26","18794536","18794836","37","13527950"
"JH378164","5433320","5433543","chrX","92178511","92178733","41","86745191"
"JH378164","6174907","6175209","chr23","77412682","77412987","52","71237775"
"JH378164","6519065","6519355","chr1","8790492","8790780","46","2271427"
"JH378164","6806629","6806753","chr1","112893855","112893969","27","106087226"
"JH378164","6912643","6912730","chr10","88746594","88746679","38","81833951"
"JH378164","7708499","7708760","chr14","53650197","53650475","56","45941698"
"JH378164","7711972","7712256","chr16","58327777","58328064","47","50615805"
"JH378164","9468086","9468375","chr3","23590467","23590757","44","14122381"
"JH378164","10073812","10073944","chr17","67011454","67011582","22","56937642"
"JH378164","10542003","10542268","chr18","44693649","44693911","47","34151646"
"JH378164","12717418","12717708","chr26","16423084","16423376","40","3705666"
"JH378164","13832343","13832649","chr9","85410997","85411306","42","71578654"
"JH378164","13921072","13921373","chr6","10613040","10613338","44","3308032"
"JH378165","763821","764127","chrX","61756996","61757299","49","60993175"
"JH378165","808229","808535","chr2","54312462","54312771","39","53504233"
"JH378165","1265181","1265445","chr11","31189578","31189838","59","29924397"
"JH378165","2309874","2309928","chr14","86092101","86092148","17","83782227"
"JH378165","2513427","2513708","chr17","53582686","53582976","43","51069259"
"JH378165","2907476","2907584","chr1","19184037","19184145","22","16276561"
"JH378165","3305667","3305972","chrX","60403420","60403723","40","57097753"
"JH378165","3531427","3531745","chr1","106576923","106577226","53","103045496"
"JH378165","4148623","4148900","chr2","12016761","12017041","38","7868138"
"JH378165","4666560","4666837","chr11","42101160","42101440","40","37434600"
"JH378165","5021886","5022195","chrX","61756996","61757299","41","56735110"
"JH378165","5443229","5443531","chr4","63292257","63292566","39","57849028"
"JH378165","6847915","6848229","chr12","80263417","80263718","48","73415502"
"JH378165","7789769","7790072","chr27","13835984","13836285","44","6046215"
"JH378165","8403602","8403734","chr17","67011454","67011582","19","58607852"
"JH378165","9940731","9940841","chr2","13154797","13154910","19","3214066"
"JH378165","10207360","10207667","chrX","61756996","61757299","44","51549636"
"JH378165","10406756","10406887","chr6","9931908","9932038","14","474848"
"JH378165","10407020","10407183","chr20","108914232","108914397","31","98507212"
"JH378165","11021469","11021765","chr16","66139074","66139369","43","55117605"
"JH378165","12162244","12162494","chr25","50135597","50135848","50","37973353"
"JH378165","13569010","13569295","chr23","80397235","80397521","47","66828225"
"JH378165","13681639","13681921","chr4","71555519","71555804","54","57873880"
"JH378165","14027951","14028000","chr16","51239723","51239767","12","37211772"
"JH378166","116110","116294","chr11","61155330","61155517","31","61039220"
"JH378166","298088","298384","chr3","30187575","30187872","36","29889487"
"JH378166","346598","346854","chr4","65263107","65263348","52","64916509"
"JH378166","426568","426875","chr7","115268697","115268994","50","114842129"
"JH378166","428574","428827","chr14","88780485","88780747","55","88351911"
"JH378166","1094123","1094452","chr20","119136193","119136516","53","118042070"
"JH378166","1237967","1238272","chr6","32749709","32750008","48","31511742"
"JH378166","1736889","1737146","chr24","71658540","71658819","75","69921651"
"JH378166","2007767","2007910","chr20","105715190","105715330","25","103707423"
"JH378166","2163195","2163488","chr6","35097365","35097661","62","32934170"
"JH378166","2183315","2183599","chr6","33738823","33739106","66","31555508"
"JH378166","2334589","2334895","chr13","63138736","63139042","45","60804147"
"JH378166","2387691","2387807","chr2","4976621","4976741","24","2588930"
"JH378166","2405047","2405367","chr10","89318076","89318373","59","86913029"
"JH378166","2757049","2757358","chr1","125024996","125025302","42","122267947"
"JH378166","2861027","2861316","chr16","58327777","58328064","44","55466750"
"JH378166","3216220","3216501","chr15","65012411","65012687","42","61796191"
"JH378166","3850661","3850905","chr3","25922879","25923130","42","22072218"
"JH378166","4344963","4345096","chr5","16452354","16452474","25","12107391"
"JH378166","4513060","4513369","chr14","61597253","61597561","43","57084193"
"JH378166","4974224","4974525","chr13","65916557","65916859","44","60942333"
"JH378166","5042295","5042416","chr2","1554332","1554443","22","3487963"
"JH378166","5190803","5191121","chrX","10891227","10891532","51","5700424"
"JH378166","5232430","5232575","chr1","110070240","110070388","26","104837810"
"JH378166","5308137","5308198","chr14","63687139","63687201","13","58379002"
"JH378166","6278304","6278609","chr10","82223974","82224279","40","75945670"
"JH378166","7081421","7081695","chr5","72051782","72052054","49","64970361"
"JH378166","8264930","8265216","chr1","16838288","16838572","39","8573358"
"JH378166","8311002","8311253","chr9","17604750","17605020","62","9293748"
"JH378166","8355879","8356181","chr12","97392320","97392622","40","89036441"
"JH378166","8498217","8498440","chr14","74021868","74022082","35","65523651"
"JH378166","8511955","8512259","chr9","57444017","57444321","42","48932062"
"JH378166","8638815","8639131","chrX","50512059","50512366","51","41873244"
"JH378166","8722874","8723174","chr22","9714838","9715138","53","991964"
"JH378166","8910706","8911019","chr20","116376251","116376549","58","107465545"
"JH378166","9317610","9317912","chr6","29394044","29394346","36","20076434"
"JH378166","9375734","9376032","chr9","114669635","114669933","41","105293901"
"JH378166","10008226","10008523","chr20","117005664","117005963","44","106997438"
"JH378166","10135123","10135309","chr24","26958611","26958801","42","16823488"
"JH378166","11161621","11161929","chr20","80727402","80727700","43","69565781"
"JH378166","11189117","11189413","chr9","92146521","92146829","46","80957404"
"JH378166","12850938","12851235","chr17","37363181","37363484","49","24512243"
"JH378166","13259031","13259170","chr13","67430762","67430902","31","54171731"
"JH378166","13496177","13496432","chr6","14093262","14093526","52","597085"
"JH378166","13752996","13753313","chr6","36288281","36288590","46","22535285"
"JH378166","13870915","13871201","chr19","4455651","4455943","38","9415264"
"JH378167","10747842","10748126","chr2","26376276","26376553","46","15628434"
"JH378167","145494","145678","chr13","82147749","82147918","48","82002255"
"JH378167","146620","146713","chr1","32855214","32855299","24","32708594"
"JH378167","234865","234997","chr13","93936933","93937062","25","93702068"
"JH378167","314656","314867","chr11","100225388","100225600","38","99910732"
"JH378167","364744","365040","chr10","122812616","122812920","57","122447872"
"JH378167","365808","366102","chr19","19336208","19336496","46","18970400"
"JH378167","440225","440457","chr9","86755766","86756000","27","86315541"
"JH378167","440924","440987","chr1","449611","449665","22","8687"
"JH378167","1231118","1231410","chr22","95239299","95239587","47","94008181"
"JH378167","1504553","1504678","chrUn_KE147541v1","534739","534860","24","969814"
"JH378167","1823023","1823315","chr25","27994473","27994768","46","26171450"
"JH378167","1873395","1873572","chr20","108914232","108914397","32","107040837"
"JH378167","3228672","3228965","chr13","64444998","64445291","32","61216326"
"JH378167","3527308","3527449","chr10","35002409","35002551","27","31475101"
"JH378167","3560538","3560835","chr12","62505268","62505568","42","58944730"
"JH378167","3648423","3648724","chr2","14953819","14954119","47","11305396"
"JH378167","3891337","3891638","chr15","1318494","1318783","52","2572843"
"JH378167","4019838","4020143","chr1","97251820","97252124","49","93231982"
"JH378167","4046362","4046658","chr4","36056954","36057249","41","32010592"
"JH378167","4244187","4244473","chr23","79133871","79134164","40","74889684"
"JH378167","4654714","4655024","chr5","10824452","10824759","40","6169738"
"JH378167","4769650","4769950","chr3","25784267","25784567","38","21014617"
"JH378167","4900481","4900603","chr21","2508889","2509006","22","2391592"
"JH378167","4915932","4916139","chrX","129744426","129744635","38","124828494"
"JH378167","4948044","4948162","chrX","44843876","44844005","28","39895832"
"JH378167","5220343","5220415","chr5","2445602","2445676","21","2774741"
"JH378167","5221051","5221234","chr11","61155330","61155517","46","55934279"
"JH378167","5222301","5222601","chr10","104330612","104330907","35","99108311"
"JH378167","5276747","5277033","chrX","29558025","29558318","44","24281278"
"JH378167","5322871","5323116","chr20","107997025","107997264","43","102674154"
"JH378167","5444329","5444638","chr1","125024996","125025302","41","119580667"
"JH378167","5587322","5587594","chr22","19367458","19367724","49","13780136"
"JH378167","5594877","5595195","chr1","106576923","106577226","60","100982046"
"JH378167","5726739","5726869","chr6","9931908","9932038","12","4205169"
"JH378167","5834245","5834403","chr16","69077847","69078004","46","63243602"
"JH378167","6885589","6885887","chr10","104330612","104330907","43","97445023"
"JH378167","6982306","6982610","chr26","4574785","4575094","69","2407521"
"JH378167","7091664","7091961","chr14","99085390","99085687","43","91993726"
"JH378167","7400988","7401287","chr6","35097365","35097661","65","27696377"
"JH378167","7626463","7626670","chr23","42922019","42922224","27","35295556"
"JH378167","7814934","7815156","chr18","9905435","9905663","47","2090501"
"JH378167","7846593","7846838","chr21","65644826","65645077","60","57798233"
"JH378167","8435781","8435842","chr9","51130702","51130760","11","42694921"
"JH378167","8574881","8575180","chr18","59850632","59850929","48","51275751"
"JH378167","8711505","8711799","chr14","81078166","81078460","48","72366661"
"JH378167","9087034","9087202","chr3","28939304","28939471","36","19852270"
"JH378167","9359629","9359915","chr28","15327544","15327835","43","5967915"
"JH378167","9456505","9456796","chrX","43777377","43777676","44","34320872"
"JH378167","9569134","9569294","chr9","14957021","14957185","37","5387887"
"JH378167","9642358","9642668","chr17","51415912","51416220","48","41773554"
"JH378167","9696075","9696284","chr28","12818876","12819093","44","3122801"
"JH378167","9701380","9701669","chr24","51243330","51243619","44","41541950"
"JH378167","9880241","9880543","chr6","31992433","31992727","46","22112192"
"JH378167","9880544","9880838","chr12","39114189","39114476","54","29233645"
"JH378167","9940846","9941136","chr20","80621483","80621774","42","70680637"
"JH378167","10007291","10007395","chr2","1554332","1554443","22","8452959"
"JH378167","10131333","10131537","chr22","59313204","59313418","36","49181871"
"JH378167","10327831","10328114","chr19","1538482","1538767","40","8789349"
"JH378167","10427495","10427579","chr14","68059462","68059545","26","57631967"
"JH378167","10450528","10450755","chr23","79650541","79650766","50","69200013"
"JH378167","10576273","10576567","chr20","110642932","110643228","44","100066659"
"JH378167","10800640","10800940","chr28","10271566","10271865","48","529074"
"JH378167","10897865","10898130","chr20","2854395","2854680","57","8043470"
"JH378167","11128617","11128914","chr3","25784267","25784567","46","14655650"
"JH378167","12117141","12117435","chr15","90468926","90469226","46","78351785"
"JH378167","12118517","12118706","chr21","3476256","3476448","37","8642261"
"JH378167","12164221","12164524","chr8","111042264","111042570","43","98878043"
"JH378167","12344984","12345291","chr14","30200501","30200810","49","17855517"
"JH378167","12376951","12377182","chr1","32042837","32043070","42","19665886"
"JH378167","12494421","12494551","chr1","10049733","10049863","24","2444688"
"JH378167","12663278","12663480","chr12","42859340","42859549","32","30196062"
"JH378167","12764329","12764507","chr6","33811352","33811518","35","21047023"
"JH378167","12792892","12793199","chr24","10677968","10678270","41","2114924"
"JH378167","12818672","12818792","chr1","114922378","114922500","21","102103706"
"JH378167","12895321","12895603","chr13","86323276","86323561","34","73427955"
"JH378167","12930171","12930474","chr9","32604399","32604698","56","19674228"
"JH378168","315310","315586","chr9","96272747","96273028","46","95957437"
"JH378168","1095779","1096078","chr8","30764649","30764946","47","29668870"
"JH378168","1184025","1184326","chr26","24027927","24028229","51","22843902"
"JH378168","3201916","3202233","chr21","55549223","55549531","57","52347307"
"JH378168","3316552","3316610","chr24","66368253","66368315","15","63051701"
"JH378168","3538237","3538507","chr10","89968309","89968588","60","86430072"
"JH378168","3708079","3708394","chr10","93660216","93660534","54","89952137"
"JH378168","4679476","4679773","chr19","27584635","27584934","37","22905159"
"JH378168","5056913","5057193","chr6","26593661","26593944","54","21536748"
"JH378168","5187085","5187193","chr27","21673517","21673624","19","16486432"
"JH378168","5215784","5216084","chr24","70944367","70944665","32","65728583"
"JH378168","7578258","7578561","chrX","23182631","23182933","41","15604373"
"JH378168","7945977","7946039","chr6","16749695","16749759","12","8803718"
"JH378168","8391922","8392236","chr6","47032560","47032866","72","38640638"
"JH378168","8600482","8600744","chr5","43917989","43918246","57","35317507"
"JH378168","10009158","10009246","chr1","9185341","9185424","19","823817"
"JH378168","10383805","10384089","chrX","46213593","46213878","57","35829788"
"JH378168","10816167","10816367","chr23","42922019","42922224","44","32105852"
"JH378168","11493218","11493516","chrX","60403420","60403723","38","48910202"
"JH378168","11937317","11937639","chr12","41907219","41907542","58","29969902"
"JH378168","12859980","12860076","chr21","73735740","73735834","25","60875760"
"JH378169","955082","955265","chr4","66826794","66826969","46","65871712"
"JH378169","993709","994012","chrX","10891227","10891532","45","9897518"
"JH378169","1083146","1083437","chr24","81271080","81271377","51","80187934"
"JH378169","1116900","1117087","chr19","16893479","16893663","31","15776579"
"JH378169","1216372","1216662","chr13","67198097","67198382","60","65981725"
"JH378169","1238254","1238565","chr6","18852331","18852633","51","17614077"
"JH378169","1290896","1291199","chr1","64865119","64865416","47","63574223"
"JH378169","2122138","2122440","chr20","19843709","19844017","41","17721571"
"JH378169","3248816","3249113","chr11","46870539","46870831","49","43621723"
"JH378169","3385095","3385365","chr15","66867086","66867350","61","63481991"
"JH378169","4164863","4165164","chr11","24876645","24876927","50","20711782"
"JH378169","4578280","4578581","chr26","24027927","24028229","39","19449647"
"JH378169","4751647","4751944","chrX","47726776","47727071","45","42975129"
"JH378169","4871639","4871918","chr23","38922269","38922564","48","34050630"
"JH378169","4992968","4993258","chr9","18313882","18314160","65","13320914"
"JH378169","5068378","5068424","chr13","82612030","82612077","20","77543652"
"JH378169","5274656","5274940","chr28","15327544","15327835","46","10052888"
"JH378169","5288427","5288699","chr28","13713786","13714063","43","8425359"
"JH378169","5608397","5608580","chr20","67913721","67913907","24","62305324"
"JH378169","5665096","5665376","chr2","6803049","6803335","65","1137953"
"JH378169","5983548","5983849","chr9","86699927","86700224","45","80716379"
"JH378169","6001568","6001866","chr12","72899340","72899646","41","66897772"
"JH378169","6070101","6070404","chr3","25784267","25784567","39","19714166"
"JH378169","6492749","6492961","chr16","68030374","68030585","40","61537625"
"JH378169","6995289","6995583","chr3","20463117","20463410","58","13467828"
"JH378169","7675360","7675638","chr9","96272747","96273028","46","88597387"
"JH378169","7771194","7771443","chr19","28790804","28791063","55","21019610"
"JH378169","8813619","8813924","chr22","5814787","5815092","47","2998832"
"JH378169","10596984","10597272","chr17","38569856","38570151","41","27972872"
"JH378170","481319","481625","chr22","34201969","34202268","42","33720650"
"JH378170","775350","775500","chr14","947149","947293","29","171799"
"JH378170","874851","875001","chr3","187105","187248","27","687746"
"JH378170","931779","932084","chr4","31811484","31811787","40","30879705"
"JH378170","1002053","1002220","chr15","68073590","68073751","27","67071537"
"JH378170","1616082","1616344","chr6","10963028","10963286","35","9346946"
"JH378170","1684606","1684776","chr24","76523592","76523762","29","74838986"
"JH378170","2075720","2076014","chr28","15327544","15327835","43","13251824"
"JH378170","3072155","3072200","chr20","64476995","64477043","8","61404840"
"JH378170","3106583","3106851","chr20","119275773","119276050","56","116169190"
"JH378170","3291959","3292259","chr20","117005664","117005963","47","113713705"
"JH378170","3530702","3530907","chr10","38837051","38837254","37","35306349"
"JH378170","4461620","4461907","chr1","8790492","8790780","40","4328872"
"JH378170","4560426","4560723","chr11","90535443","90535733","47","85975017"
"JH378170","4573614","4573911","chrX","33027186","33027484","40","28453572"
"JH378170","4605294","4605583","chr11","52774613","52774907","41","48169319"
"JH378170","4719366","4719486","chr4","77908589","77908714","19","73189223"
"JH378170","4754960","4755182","chr11","12336976","12337195","42","7582016"
"JH378170","5093590","5093884","chr1","61657675","61657969","33","56564085"
"JH378170","6587043","6587250","chr2","25630213","25630417","48","19043170"
"JH378170","6630436","6630729","chr2","84553599","84553896","39","77923163"
"JH378170","7587633","7587946","chr24","55110169","55110477","44","47522536"
"JH378170","8030129","8030438","chrX","60403420","60403723","44","52373291"
"JH378170","8295264","8295507","chr10","24210364","24210604","45","15915100"
"JH378170","11222374","11222653","chr18","34852642","34852922","45","23630268"
"JH378170","11253496","11253792","chr13","90749493","90749789","49","79495997"
"JH378170","11316458","11316760","chr15","2279579","2279874","52","9036879"
"JH378170","11375749","11375873","chr6","12469520","12469644","32","1093771"
"JH378170","11510492","11510783","chr11","53710956","53711245","50","42200464"
"JH378171","110318","110605","chr18","45579140","45579432","54","45468822"
"JH378171","127051","127187","chr8","124995937","124996065","31","124868886"
"JH378171","417841","418017","chr11","106691321","106691504","35","106273480"
"JH378171","650329","650622","chr1","9360845","9361141","40","8710516"
"JH378171","1263361","1263627","chr8","40712258","40712534","58","39448897"
"JH378171","1299184","1299375","chr14","96227602","96227779","39","94928418"
"JH378171","1343557","1343758","chr2","13316902","13317112","43","11973345"
"JH378171","1733470","1733761","chr11","83560875","83561170","40","81827405"
"JH378171","2495843","2496147","chrX","38186867","38187158","53","35691024"
"JH378171","4396740","4397029","chr9","32604399","32604698","44","28207659"
"JH378171","4504516","4504803","chr1","68990574","68990859","40","64486058"
"JH378171","4584761","4585065","chr22","9714838","9715138","44","5130077"
"JH378171","6284368","6284497","chr13","93936933","93937062","17","87652565"
"JH378171","7170534","7170669","chr28","12031940","12032076","22","4861406"
"JH378171","7479598","7479891","chr14","68359125","68359423","61","60879527"
"JH378171","7795209","7795511","chrX","29670774","29671076","41","21875565"
"JH378171","7946249","7946526","chr23","79036882","79037174","51","71090633"
"JH378171","8045393","8045682","chr5","55179159","55179451","42","47133766"
"JH378171","8047044","8047183","chr9","32125196","32125331","34","24078152"
"JH378171","8177330","8177609","chr12","10348016","10348298","47","2170686"
"JH378171","8942525","8942641","chr19","14641039","14641163","29","5698514"
"JH378171","8965274","8965359","chr9","58507566","58507653","23","49542292"
"JH378171","9016504","9016804","chr1","29712863","29713163","44","20696359"
"JH378171","10910335","10910639","chrX","33027186","33027484","43","22116851"
"JH378172","91642","91727","chrX_KE148108v1_random","2493517","2493615","27","2401875"
"JH378172","98375","98634","chr5","15593128","15593380","51","15494753"
"JH378172","565262","565432","chr20_KE148050v1_random","781117","781273","43","215855"
"JH378172","2049944","2050245","chr4","75730761","75731061","42","73680817"
"JH378172","2189919","2190202","chr8","40644845","40645130","54","38454926"
"JH378172","2225800","2225929","chr25","24055489","24055622","19","21829689"
"JH378172","2265300","2265599","chrX","26479311","26479602","51","24214011"
"JH378172","2638162","2638351","chrX","238563","238744","49","2399599"
"JH378172","2640500","2640808","chr8","20072572","20072880","45","17432072"
"JH378172","2645207","2645467","chrX","13770781","13771028","63","11125574"
"JH378172","4398305","4398527","chr11","7774263","7774487","32","3375958"
"JH378172","4462357","4462666","chr14","79956017","79956326","61","75493660"
"JH378172","4855775","4856095","chr16","57189024","57189330","64","52333249"
"JH378172","5809848","5810113","chr10","94020388","94020642","43","88210540"
"JH378172","6524743","6525030","chr20","97098637","97098929","52","90573894"
"JH378172","6994619","6994925","chr20","117005664","117005963","52","110011045"
"JH378172","8065086","8065391","chr2","61035797","61036096","37","52970711"
"JH378172","8165001","8165297","chr9","30541985","30542296","53","22376984"
"JH378172","8224368","8224665","chr23","39001740","39002032","76","30777372"
"JH378172","9367678","9367971","chr29","16924096","16924391","36","7556418"
"JH378172","9403016","9403302","chr12","43161561","43161851","39","33758545"
"JH378172","9583117","9583408","chr11","6772448","6772741","43","2810669"
"JH378172","10247608","10247904","chr8","111042264","111042570","57","100794656"
"JH378172","10362476","10362738","chr20","111949525","111949783","40","101587049"
"JH378172","10548718","10549014","chr24","70944367","70944665","37","60395649"
"JH378172","10737405","10737707","chr16","44211282","44211580","43","33473877"
"JH378172","10815732","10816000","chr14","33993071","33993339","38","23177339"
"JH378172","11918213","11918514","chr1","68504497","68504793","47","56586284"
"JH378172","11948470","11948744","chr3","64952340","64952627","52","53003870"
"JH378172","11967141","11967446","chr1","32220138","32220445","45","20252997"
"JH378172","12053306","12053616","chrX","61756996","61757299","37","49703690"
"JH378172","12591079","12591174","chr7","27620515","27620606","25","15029436"
"JH378173","435660","435750","chr9","70380929","70381021","27","69945269"
"JH378173","1131943","1132035","chr10","85283682","85283779","23","84151739"
"JH378173","1282426","1282734","chr25","9296548","9296856","51","8014122"
"JH378173","1396057","1396361","chr17","40106599","40106905","44","38710542"
"JH378173","1538853","1539156","chr13","41724361","41724668","53","40185508"
"JH378173","1900913","1901204","chr16","70729210","70729502","40","68828297"
"JH378173","2188438","2188574","chr8","104279467","104279601","27","102091029"
"JH378173","2752065","2752370","chr26","1303623","1303927","44","1448442"
"JH378173","3039773","3039970","chr19","12992619","12992824","38","9952846"
"JH378173","3259720","3260012","chr20","90303203","90303504","52","87043483"
"JH378173","3687445","3687567","chr8","120450677","120450792","32","116763232"
"JH378173","3836787","3837088","chrX","43777377","43777676","44","39940590"
"JH378173","4059055","4059164","chr6","35661566","35661675","12","31602511"
"JH378173","4256977","4257251","chr22","45531342","45531633","44","41274365"
"JH378173","4336115","4336372","chr6","25120427","25120677","45","20784312"
"JH378173","4354166","4354467","chr21","25378112","25378415","52","21023946"
"JH378173","4494305","4494604","chr10","105566815","105567106","51","101072510"
"JH378173","5004028","5004306","chr11","113615804","113616083","61","108611776"
"JH378173","5042204","5042506","chr12","29549649","29549958","41","24507445"
"JH378173","5107810","5108085","chr28","13713786","13714063","43","8605976"
"JH378173","5343290","5343610","chrX","41936824","41937138","56","36593534"
"JH378173","5501433","5501684","chr1","112610540","112610791","49","107109107"
"JH378173","5809689","5809759","chr12","5872576","5872638","19","62887"
"JH378173","5984599","5984879","chr8","138385912","138386190","36","132401313"
"JH378173","6597015","6597286","chr1","86467570","86467849","53","79870555"
"JH378173","6766977","6767094","chr2","4976621","4976741","19","1790356"
"JH378173","7114139","7114401","chr6","19556533","19556792","57","12442394"
"JH378173","7240288","7240584","chr26","11209053","11209344","48","3968765"
"JH378173","7293847","7294141","chr6","27769176","27769470","39","20475329"
"JH378173","7342888","7343177","chr11","46870539","46870831","50","39527651"
"JH378173","7860274","7860568","chr23","73443707","73444001","35","65583433"
"JH378173","8603136","8603429","chr26","11209053","11209344","38","2605917"
"JH378173","8677069","8677307","chrX","90939813","90940045","40","82262744"
"JH378173","9172361","9172665","chr1","29621888","29622188","54","20449527"
"JH378173","9198146","9198368","chr24","40869921","40870127","41","31671775"
"JH378173","10212838","10213031","chr20_KE148050v1_random","1166449","1166639","31","9046389"
"JH378173","10213032","10213085","chr5","2445602","2445676","25","7767430"
"JH378173","10349588","10349885","chr22","9714838","9715138","42","634750"
"JH378173","10472229","10472506","chr1","29294849","29295125","45","18822620"
"JH378173","10512591","10512871","chrX","6571847","6572139","51","3940744"
"JH378173","11165613","11165941","chr10","59935987","59936305","47","48770374"
"JH378173","11998881","11999167","chr6","17390935","17391221","48","5392054"
"JH378173","12099497","12099790","chr7","97703417","97703707","44","85603920"
"JH378174","93275","93570","chr4","35239086","35239384","51","35145811"
"JH378174","97980","98221","chr20","107997025","107997264","35","107899045"
"JH378174","152375","152672","chr1","36079803","36080100","49","35927428"
"JH378174","739283","739508","chr5","75072071","75072324","72","74332788"
"JH378174","980623","980906","chr15","63096897","63097174","59","62116274"
"JH378174","1099675","1099946","chr10","63585093","63585357","53","62485418"
"JH378174","1772214","1772515","chr19","23855744","23856050","56","22083530"
"JH378174","2415044","2415355","chr5","26026229","26026536","45","23611185"
"JH378174","2476019","2476316","chr13","79765152","79765450","42","77289133"
"JH378174","3142523","3142830","chr21","6005263","6005553","63","2862740"
"JH378174","3194475","3194735","chr14","75250425","75250685","38","72055950"
"JH378174","3486543","3486847","chr16","57189024","57189330","42","53702481"
"JH378174","4146381","4146650","chr11","7687297","7687565","48","3540916"
"JH378174","4950806","4951033","chr15","37052691","37052912","39","32101885"
"JH378174","6530577","6530829","chr10","127587035","127587285","40","121056458"
"JH378174","6694542","6694851","chr21","47096414","47096720","41","40401872"
"JH378174","6724896","6725229","chr24","36436227","36436544","81","29711331"
"JH378174","7785419","7785704","chr1","29294849","29295125","45","21509430"
"JH378174","8463237","8463510","chr15","4986082","4986355","39","3477155"
"JH378174","8633354","8633653","chr4","74750244","74750542","45","66116890"
"JH378174","8688431","8688687","chr20","104477833","104478070","62","95789402"
"JH378174","9082948","9083253","chr1","10964645","10964948","47","1881697"
"JH378174","9293028","9293234","chr19","12992619","12992824","38","3699591"
"JH378174","9293438","9293539","chr6","11844044","11844146","16","2550606"
"JH378174","11037457","11037684","chr12","108518404","108518625","35","97480947"
"JH378174","11709724","11709996","chr26","42372142","42372415","44","30662418"
"JH378174","11815914","11816221","chr25","75497986","75498294","48","63682072"
"JH378175","721518","721817","chr23","57612824","57613126","44","56891306"
"JH378175","784376","784686","chr26","19790629","19790935","48","19006253"
"JH378175","955206","955504","chrX","38491163","38491471","46","37535957"
"JH378175","2505857","2506165","chr2","33362197","33362503","40","30856340"
"JH378175","2523366","2523650","chr25","3359926","3360212","41","836560"
"JH378175","2718554","2718844","chrX","85693757","85694048","61","82975203"
"JH378175","2729655","2729806","chr15","47627624","47627769","36","44897969"
"JH378175","2838829","2839118","chr24","51521386","51521673","50","48682557"
"JH378175","3152346","3152629","chr19","16574920","16575197","58","13422574"
"JH378175","3212136","3212450","chr15","41834967","41835273","48","38622831"
"JH378175","3878640","3878940","chr18","53369128","53369429","46","49490488"
"JH378175","4255121","4255417","chr6","27769176","27769470","49","23514055"
"JH378175","5543246","5543565","chr23","59622743","59623065","61","54079497"
"JH378175","5731555","5731701","chr17","61823129","61823273","25","56091574"
"JH378175","5742296","5742597","chrX","33027186","33027484","43","27284890"
"JH378175","5802797","5803082","chr8","51467183","51467461","48","45664386"
"JH378175","6337237","6337538","chr1","38609642","38609938","43","32272405"
"JH378175","6684074","6684362","chr11","46870539","46870831","40","40186465"
"JH378175","7023545","7023711","chr10","61946373","61946539","24","54922828"
"JH378175","7907322","7907551","chr22","59313204","59313418","42","51405882"
"JH378175","7907603","7907671","chr5","2445602","2445676","24","5462001"
"JH378175","8482588","8482707","chr8","88261673","88261783","21","79779085"
"JH378175","9250441","9250721","chr12","91269439","91269722","59","82018998"
"JH378175","9308330","9308490","chr19","11544687","11544855","26","2236357"
"JH378175","9374047","9374318","chr11","62921553","62921824","47","53547506"
"JH378175","9437947","9438251","chr11","47411625","47411934","37","37973678"
"JH378175","9618091","9618373","chr28","8917006","8917294","52","701085"
"JH378175","10968117","10968376","chr6","10963028","10963286","43","5089"
"JH378175","11102517","11102814","chr1","36079803","36080100","53","24977286"
"JH378176","1047417","1047678","chrX","47726776","47727071","55","46679359"
"JH378176","2498222","2498515","chr13","57139627","57139918","31","54641405"
"JH378176","2710796","2711102","chr22","67435237","67435541","39","64724441"
"JH378176","2760940","2761238","chr3","30187575","30187872","34","27426635"
"JH378176","4986389","4986529","chr13","80405244","80405376","33","75418855"
"JH378176","5043221","5043520","chr9","57444017","57444321","36","52400796"
"JH378176","5140249","5140519","chr14","61597585","61597855","30","56457336"
"JH378176","5239900","5240217","chr11","47411625","47411934","52","42171725"
"JH378176","5372849","5373119","chr1","18300604","18300863","37","12927755"
"JH378176","5414255","5414328","chr22","13374214","13374273","21","7959959"
"JH378176","6896200","6896514","chr4","76340083","76340392","58","69443883"
"JH378176","7048391","7048697","chr6","18852331","18852633","52","11803940"
"JH378176","7917228","7917504","chr21","76648555","76648837","48","68731327"
"JH378176","8127235","8127542","chrX","111147394","111147703","46","103020159"
"JH378176","8315519","8315845","chr8","76021813","76022153","60","67706294"
"JH378176","9185871","9186160","chr5","3297052","3297343","39","5888819"
"JH378176","9378022","9378314","chr11","102915301","102915590","36","93537279"
"JH378176","9416959","9417256","chr11","52774613","52774907","34","43357654"
"JH378176","9517876","9518161","chr4","71555519","71555804","29","62037643"
"JH378176","9578226","9578521","chr6","10179837","10180133","43","601611"
"JH378176","10258500","10258696","chr16","62117476","62117671","27","51858976"
"JH378176","10258856","10258973","chr2","7577214","7577318","31","2681642"
"JH378176","10290367","10290670","chr10","92373753","92374046","61","82083386"
"JH378176","10605815","10605947","chr20","71356227","71356358","23","60750412"
"JH378176","10883730","10883850","chr10","66128392","66128503","22","55244662"
"JH378177","1094300","1094493","chr16","74574690","74574885","29","73480390"
"JH378177","1156398","1156680","chr12","89549388","89549667","38","88392990"
"JH378177","1252483","1252774","chr26","40585333","40585622","54","39332850"
"JH378177","1400255","1400545","chr18","48953277","48953567","31","47553022"
"JH378177","1742366","1742673","chrX","61756996","61757299","48","60014630"
"JH378177","1821361","1821655","chr4","74750244","74750542","40","72928883"
"JH378177","2682361","2682549","chr5","26327986","26328184","45","23645625"
"JH378177","3010011","3010293","chr5","53503219","53503505","42","50493208"
"JH378177","3051218","3051505","chr11","42708500","42708788","34","39657282"
"JH378177","3126413","3126720","chr9","250796","251089","66","2875617"
"JH378177","3244907","3245076","chr20","122239975","122240145","29","118995068"
"JH378177","4048978","4049261","chr16","6272773","6273062","45","2223795"
"JH378177","4420477","4420773","chr12","62505268","62505568","46","58084791"
"JH378177","4590107","4590391","chr17","36678048","36678335","35","32087941"
"JH378177","5098710","5098851","chr4","90460665","90460796","25","85361955"
"JH378177","5297980","5298247","chr12","73233764","73234041","42","67935784"
"JH378177","5607790","5608067","chr1","29294849","29295125","37","23687059"
"JH378177","5640578","5640866","chr11","47267698","47267990","48","41627120"
"JH378177","5711215","5711499","chr29","9188440","9188729","52","3477225"
"JH378177","5713825","5714017","chrX","25278669","25278849","34","19564844"
"JH378177","6649057","6649351","chr14","99085390","99085687","48","92436333"
"JH378177","6832213","6832519","chr14","68359125","68359423","44","61526912"
"JH378177","6879386","6879571","chrX","100082116","100082286","57","93202730"
"JH378177","6975521","6975818","chr4","16716893","16717190","35","9741372"
"JH378177","7008570","7008777","chr9","57732450","57732667","40","50723880"
"JH378177","7284481","7284788","chr20","105585607","105585916","39","98301126"
"JH378177","7772749","7773085","chr12","54339229","54339556","52","46566480"
"JH378177","8651408","8651698","chr6","10335041","10335331","52","1683633"
"JH378177","8931257","8931557","chr4","75730761","75731061","49","66799504"
"JH378177","8944881","8945109","chr2","65988272","65988503","33","57043391"
"JH378177","10385396","10385708","chr11","116558393","116558699","46","106172997"
"JH378177","10596986","10597215","chr15","49088342","49088573","36","38491356"
"JH378177","10605639","10605927","chr9","12360770","12361060","43","1755131"
"JH378177","10622052","10622332","chr9","59423774","59424053","56","48801722"
"JH378177","10662730","10662955","chr3","54097857","54098084","42","43435127"
"JH378177","10690982","10691276","chr5","73939526","73939822","40","63248544"
"JH378177","11015698","11016032","chr11","116558393","116558699","84","105542695"
"JH378178","700396","700563","chr20","122239975","122240145","30","121539579"
"JH378178","875926","876157","chr21","124764715","124764961","76","123888789"
"JH378178","1706586","1706877","chr6","31992433","31992727","48","30285847"
"JH378178","1887690","1887996","chr2","33362197","33362503","40","31474507"
"JH378178","1950854","1951150","chr20","103885017","103885310","59","101934163"
"JH378178","1952018","1952295","chr7","20125290","20125568","36","18173272"
"JH378178","2483769","2484073","chr1","97251820","97252124","41","94768051"
"JH378178","2987979","2988014","chr10","94455223","94455247","18","91467244"
"JH378178","2988016","2988146","chr5","35961442","35961590","46","32973426"
"JH378178","3646287","3646490","chr23","42922019","42922224","46","39275732"
"JH378178","6826749","6826874","chr19","29005790","29005923","21","22179041"
"JH378178","6885760","6886020","chr1","112610540","112610791","37","105724780"
"JH378178","6952436","6952707","chr26","37713108","37713384","46","30760672"
"JH378178","7572080","7572379","chr15","81539546","81539843","43","73967466"
"JH378178","7739014","7739312","chrX","58994083","58994385","40","51255069"
"JH378178","8650191","8650501","chr9","92146521","92146829","59","83496330"
"JH378178","8734813","8735112","chr26","18794536","18794836","44","10059723"
"JH378178","9486547","9486843","chr16","24824595","24824890","41","15338048"
"JH378178","10559005","10559306","chr10","88288814","88289117","42","77729809"
"JH378179","49762","49976","chr11","100225388","100225600","44","100175626"
"JH378179","119629","119738","chr20","80015270","80015379","9","79895641"
"JH378179","345001","345309","chr2","54312462","54312771","37","53967461"
"JH378179","1200091","1200407","chrX","107405185","107405479","73","106205094"
"JH378179","1579359","1579651","chr2","89878041","89878342","49","88298682"
"JH378179","1780652","1780945","chr12","43161561","43161851","41","41380909"
"JH378179","3229695","3229794","chr14","44953493","44953595","23","41723798"
"JH378179","3522701","3523006","chr1","125024996","125025302","37","121502295"
"JH378179","3788671","3788916","chr12","15320158","15320403","33","11531487"
"JH378179","4356857","4356981","chr6","44726967","44727090","20","40370110"
"JH378179","5165520","5165828","chr2","33362197","33362503","38","28196677"
"JH378179","5303888","5304183","chr14","98403772","98404061","50","93099884"
"JH378179","5339477","5339786","chr12","21589054","21589349","122","16249577"
"JH378179","5350589","5350897","chr9","56706151","56706456","40","51355562"
"JH378179","5366073","5366377","chr15","2000778","2001083","56","3365295"
"JH378179","5692215","5692527","chr23","78084416","78084726","47","72392201"
"JH378179","6319367","6319653","chr1","4366395","4366679","50","1952972"
"JH378179","6488850","6489158","chr1","40186193","40186501","52","33697343"
"JH378179","7820505","7820764","chr5","15593128","15593380","73","7772623"
"JH378179","8626546","8626855","chr20","113381135","113381444","49","104754589"
"JH378179","8736893","8736994","chr21","73735740","73735834","27","64998847"
"JH378179","10139704","10139994","chr15","21505985","21506275","35","11366281"
"JH378179","10164155","10164295","chr20","33278984","33279121","23","23114829"
"JH378179","10388864","10388943","chr14","44990628","44990709","20","34601764"
"JH378180","72952","73263","chr2","33362197","33362503","46","33289245"
"JH378180","255542","255832","chr3","19437037","19437326","41","19181495"
"JH378180","501133","501432","chr6","8448101","8448397","47","7946968"
"JH378180","634652","634916","chr29","17560737","17560997","43","16926085"
"JH378180","993518","993827","chr18","63833457","63833758","46","62839939"
"JH378180","4530370","4530598","chr18","9905435","9905663","40","5375065"
"JH378180","4563013","4563303","chr11","96237698","96237981","44","91674685"
"JH378180","4884716","4885025","chr22","99768771","99769071","46","94884055"
"JH378180","5406890","5407187","chr11","101562712","101563001","59","96155822"
"JH378180","5467564","5467837","chr6","11340998","11341271","45","5873434"
"JH378180","5479731","5480007","chr10","75901598","75901887","65","70421867"
"JH378180","6351363","6351665","chr13","64444998","64445291","49","58093635"
"JH378180","6721196","6721487","chr9","85636273","85636563","39","78915077"
"JH378180","6789324","6789385","chr13","7060006","7060057","13","270682"
"JH378180","7338875","7339173","chr13","86923785","86924086","57","79584910"
"JH378180","7462213","7462333","chr20","80015270","80015379","29","72553057"
"JH378180","7850445","7850759","chr14","80301164","80301473","46","72450719"
"JH378180","7995779","7996045","chr1","32854681","32854917","71","24858902"
"JH378180","8413934","8414237","chr6","32749709","32750008","46","24335775"
"JH378180","9069415","9069693","chr11","42101160","42101440","69","33031745"
"JH378180","9245512","9245761","chr2","66937766","66938027","49","57692254"
"JH378180","9758370","9758644","chr20","48407400","48407687","57","38649030"
"JH378180","9853165","9853443","chr1","29294849","29295125","44","19441684"
"JH378180","10108410","10108693","chr6","10963028","10963286","63","854618"
"JH378180","10139252","10139552","chr5","26884776","26885075","47","16745524"
"JH378180","10192172","10192454","chr24","51521386","51521673","48","41329214"
"JH378180","10233834","10234122","chr19","14623177","14623470","41","4389343"
"JH378180","10661922","10662223","chr22","81370851","81371151","43","70708929"
"JH378181","1631549","1631800","chr2","11956421","11956671","55","10324872"
"JH378181","1879968","1880277","chr6","10540061","10540366","42","8660093"
"JH378181","2003323","2003609","chr23","38922269","38922564","48","36918946"
"JH378181","2494226","2494507","chr22","70978181","70978471","46","68483955"
"JH378181","3492033","3492326","chr17","36678048","36678335","47","33186015"
"JH378181","4269661","4269720","chr5","2445602","2445676","21","1824059"
"JH378181","4269928","4270071","chr8","23675201","23675353","27","19405273"
"JH378181","4651866","4652159","chr8","7331653","7331946","43","2679787"
"JH378181","5921228","5921339","chr8","57977187","57977292","17","52055959"
"JH378181","6399279","6399510","chr8","93004179","93004415","54","86604900"
"JH378181","6530168","6530460","chrX","6571847","6572139","39","41679"
"JH378181","6756044","6756336","chr1","108300659","108300949","43","101544615"
"JH378181","7826312","7826616","chr20","7876234","7876541","48","49922"
"JH378181","7933431","7933736","chr14","79956017","79956326","43","72022586"
"JH378181","7954026","7954202","chr2","68873500","68873683","52","60919474"
"JH378181","7954276","7954387","chr24","32586079","32586185","29","24631803"
"JH378181","8930796","8931078","chr2","26528623","26528910","56","17597827"
"JH378181","9408837","9409126","chr25","54334996","54335282","42","44926159"
"JH378181","9648045","9648325","chr9","58155888","58156167","39","48507843"
"JH378181","10104084","10104371","chr6","6217754","6218043","53","3886330"
"JH378181","10309814","10310109","chr10","55092261","55092557","39","44782447"
"JH378181","10325996","10326288","chr3","6022508","6022797","44","4303488"
"JH378181","10629406","10629710","chr17","40106599","40106905","34","29477193"
"JH378182","416287","416559","chr9","58111172","58111449","43","57694885"
"JH378182","494048","494239","chr3","91778271","91778445","64","91284223"
"JH378182","558511","558555","chr1","94293794","94293836","7","93735283"
"JH378182","558686","558866","chr12","43957933","43958104","30","43399247"
"JH378182","716611","716903","chr22","48314402","48314693","39","47597791"
"JH378182","726662","726939","chr14","27748542","27748824","60","27021880"
"JH378182","741709","742004","chr9","57444017","57444321","50","56702308"
"JH378182","860751","860943","chr10","104506113","104506306","39","103645362"
"JH378182","959362","959408","chr24","51584132","51584183","8","50624770"
"JH378182","965247","965533","chr16","44211282","44211580","45","43246035"
"JH378182","1038478","1038784","chr11","47411625","47411934","54","46373147"
"JH378182","1252557","1252717","chr20","87928737","87928908","34","86676180"
"JH378182","1540944","1541167","chr18","9905435","9905663","35","8364491"
"JH378182","1730233","1730389","chr26","42515621","42515785","43","40785388"
"JH378182","1806011","1806303","chr13","90749493","90749789","47","88943482"
"JH378182","2243410","2243603","chr12","43962243","43962428","30","41718833"
"JH378182","3674796","3675096","chr1","71131341","71131637","46","67456545"
"JH378182","4509672","4509964","chr2","57324560","57324855","38","52814888"
"JH378182","4808553","4808858","chr2","61035797","61036096","48","56227244"
"JH378182","5434653","5434943","chr21","81623551","81623841","46","76188898"
"JH378182","5756301","5756594","chr4","67806059","67806358","40","62049758"
"JH378182","6570253","6570364","chr10","82963214","82963322","30","76392961"
"JH378182","7295085","7295390","chrX","61756996","61757299","39","54461911"
"JH378182","7391762","7392055","chr23","41108818","41109109","43","33717056"
"JH378182","7520078","7520378","chr10","104330612","104330907","51","96810534"
"JH378182","8262885","8263025","chr21","99460334","99460473","26","91197449"
"JH378182","8420735","8420920","chr17","36613783","36613962","31","28193048"
"JH378182","8996758","8997052","chr12","18705494","18705782","37","9708736"
"JH378182","9023070","9023375","chr14","61499082","61499381","47","52476012"
"JH378182","9140117","9140426","chr23","49548546","49548845","87","40408429"
"JH378182","9154871","9155166","chr13","64444998","64445291","42","55290127"
"JH378182","9203194","9203465","chr11","42101160","42101440","47","32897966"
"JH378182","9247934","9248217","chr11","76273547","76273835","54","67025613"
"JH378182","9294928","9295235","chr19","22626676","22626983","51","13331748"
"JH378182","9415295","9415574","chr14","61597585","61597855","52","52182290"
"JH378182","9443271","9443556","chr17","38569856","38570151","49","29126585"
"JH378182","10178683","10178991","chr4","72611984","72612288","47","62433301"
"JH378183","642869","643168","chrX","43777377","43777676","39","43134508"
"JH378183","1295147","1295447","chr3","76855982","76856288","52","75560835"
"JH378183","1453665","1453854","chr13","63471952","63472154","34","62018287"
"JH378183","1683033","1683302","chr5","75072071","75072324","54","73389038"
"JH378183","2982338","2982630","chr20","105708807","105709105","41","102726469"
"JH378183","3179676","3179972","chr11","42708500","42708788","38","39528824"
"JH378183","3321858","3322001","chr17","61823129","61823273","31","58501271"
"JH378183","3491433","3491693","chr16","16583135","16583399","33","13091702"
"JH378183","3648693","3648987","chr5","53503219","53503505","60","49854526"
"JH378183","4251772","4252042","chr19","15464805","15465074","50","11213033"
"JH378183","5344744","5345042","chr3","31757392","31757689","37","26412648"
"JH378183","7200735","7201016","chr11","85747341","85747626","48","78546606"
"JH378183","7222015","7222323","chr2","22860155","22860456","48","15638140"
"JH378183","7738607","7738900","chr24","48803007","48803311","46","41064400"
"JH378183","9032509","9032793","chr6","26593661","26593944","47","17561152"
"JH378183","9621306","9621593","chr21","48106444","48106729","50","38485138"
"JH378183","10242049","10242335","chrX","6571847","6572139","57","3670202"
"JH378184","377496","377785","chr2","26528623","26528910","51","26151127"
"JH378184","2248927","2249210","chr12","108171343","108171621","49","105922416"
"JH378184","3038064","3038203","chr1","25970139","25970266","36","22932075"
"JH378184","3038746","3038850","chr23","79882920","79883023","22","76844174"
"JH378184","3279817","3280119","chr1","125024996","125025302","50","121745179"
"JH378184","4699083","4699197","chrX","105255765","105255881","29","100556682"
"JH378184","4950026","4950331","chr2","61035797","61036096","44","56085771"
"JH378184","5257677","5257841","chr9_KE148022v1_random","4936","5091","37","5252741"
"JH378184","6006772","6006943","chr20","105726951","105727127","32","99720179"
"JH378184","7098085","7098294","chr20","9904240","9904456","29","2806155"
"JH378184","7429811","7429974","chr16","70459044","70459205","31","63029233"
"JH378184","7471292","7471589","chr19","19203666","19203967","44","11732374"
"JH378184","7540754","7540876","chr13","88890694","88890812","18","81349940"
"JH378184","8450401","8450713","chrX","29670774","29671076","54","21220373"
"JH378184","8746725","8747033","chr4","63292257","63292566","42","54545532"
"JH378184","9125662","9125981","chrX","61756996","61757299","54","52631334"
"JH378184","9222512","9222621","chr8","88261673","88261783","15","79039161"
"JH378185","741666","741972","chrX","58994083","58994385","46","58252417"
"JH378185","1211539","1211669","chr20","16264148","16264271","29","15052609"
"JH378185","1322444","1322750","chrX","61756996","61757299","40","60434552"
"JH378185","1687533","1687806","chr18","42916223","42916500","40","41228690"
"JH378185","1765319","1765444","chr10","2548528","2548653","26","783209"
"JH378185","1768592","1768901","chr9","61932207","61932503","59","60163615"
"JH378185","2330458","2330625","chr10","61946373","61946539","33","59615915"
"JH378185","2358416","2358714","chr1","29621888","29622188","37","27263472"
"JH378185","2372027","2372303","chr2","5238241","5238519","39","2866214"
"JH378185","2373002","2373263","chr10","55600559","55600818","52","53227557"
"JH378185","2389699","2389995","chr23","41108818","41109109","55","38719119"
"JH378185","2732208","2732321","chr1","81771309","81771421","22","79039101"
"JH378185","2737899","2738196","chr26","26868700","26868994","33","24130801"
"JH378185","4164914","4165214","chr2","61035797","61036096","39","56870883"
"JH378185","5590722","5590991","chr11","29396564","29396830","40","23805842"
"JH378185","5635144","5635381","chr16","34809540","34809792","60","29174396"
"JH378185","5650928","5651225","chr12","10047022","10047316","34","4396094"
"JH378185","5862108","5862403","chr29","5196778","5197073","45","665330"
"JH378185","5934720","5934994","chrUn_KE147569v1","89073","89358","72","5845647"
"JH378185","6047696","6047905","chr11","100225388","100225600","39","94177692"
"JH378185","6348223","6348343","chr5","25933140","25933266","26","19584917"
"JH378185","6635356","6635657","chr19","15214670","15214974","52","8579314"
"JH378185","7153864","7153990","chr2","4976621","4976741","18","2177243"
"JH378185","7241690","7241964","chr5","72051782","72052054","48","64810092"
"JH378185","7250574","7250859","chr2","7721210","7721494","52","470636"
"JH378185","7848580","7848888","chr1","97251820","97252124","55","89403240"
"JH378185","7871111","7871398","chr9","117104920","117105209","45","109233809"
"JH378185","9580178","9580303","chr13","93936933","93937062","19","84356755"
"JH378185","9627916","9628044","chr25","24055489","24055622","17","14427573"
"JH378185","9724569","9724880","chr4","31811484","31811787","43","22086915"
"JH378185","9743504","9743795","chr5","26884776","26885075","47","17141272"
"JH378185","9807439","9807680","chr9","17384544","17384792","68","7577105"
"JH378185","9872454","9872754","chrX","61756996","61757299","49","51884542"
"JH378185","10047474","10047767","chr13","57139627","57139918","43","47092153"
"JH378186","57092","57225","chr22","3180119","3180245","21","3123027"
"JH378186","215195","215487","chr2","56439278","56439567","42","56224083"
"JH378186","225172","225479","chr23","57612824","57613126","39","57387652"
"JH378186","595777","596066","chrX","38186867","38187158","46","37591090"
"JH378186","1125378","1125600","chr12","108518404","108518625","29","107393026"
"JH378186","1311855","1312130","chr9","29130810","29131082","61","27818955"
"JH378186","1690491","1690774","chr16","16583135","16583399","62","14892644"
"JH378186","1917313","1917426","chr23","37043050","37043157","33","35125737"
"JH378186","1917496","1917508","chr6","40152497","40152507","5","38235001"
"JH378186","1917530","1917678","chr10","56543534","56543675","45","54626004"
"JH378186","2027319","2027514","chr12","43962243","43962428","38","41934924"
"JH378186","2513185","2513313","chr14","67782475","67782602","30","65269290"
"JH378186","2982081","2982331","chr20","80178770","80179019","47","77196689"
"JH378186","2982359","2982403","chr9","67628980","67629015","21","64646621"
"JH378186","3705399","3705692","chr7_AQIB01159043v1_random","18062","18357","38","3687337"
"JH378186","4088142","4088419","chr15","5487201","5487494","46","1399059"
"JH378186","4555032","4555313","chr13","62781204","62781489","42","58226172"
"JH378186","4886904","4887201","chr10","104330612","104330907","44","99443708"
"JH378186","5377538","5377812","chr21","126969960","126970241","51","121592422"
"JH378186","5382432","5382728","chrX","10891227","10891532","56","5508795"
"JH378186","5560251","5560559","chr11","111219175","111219476","40","105658924"
"JH378186","5610620","5610893","chr12","72756184","72756452","45","67145564"
"JH378186","5667701","5667997","chr29","3711047","3711343","35","1956654"
"JH378186","6033592","6033874","chr2","7721210","7721494","44","1687618"
"JH378186","6055111","6055313","chr26","42306145","42306344","39","36251034"
"JH378186","6290257","6290362","chr8","97137579","97137683","25","90847322"
"JH378186","6299680","6299966","chrX","18237548","18237842","51","11937868"
"JH378186","9439414","9439697","chr22","9119652","9119940","49","319762"
"JH378187","3538850","3539120","chr9","96272747","96273028","51","92733897"
"JH378187","2056660","2056954","chrX","47726776","47727071","45","45670116"
"JH378187","2073840","2074128","chr14","83288480","83288767","41","81214640"
"JH378187","3035501","3035805","chr9","119761241","119761543","37","116725740"
"JH378187","3056541","3056732","chr21","3476256","3476448","40","419715"
"JH378187","3150572","3150857","chr11","42101160","42101440","39","38950588"
"JH378187","3205443","3205740","chr12","11159558","11159849","52","7954115"
"JH378187","3356192","3356465","chr12","41757497","41757783","65","38401305"
"JH378187","3359745","3360037","chr2","38953517","38953810","41","35593772"
"JH378187","3505891","3506191","chr4","72474636","72474936","45","68968745"
"JH378187","3866252","3866561","chr12","99225811","99226117","52","95359559"
"JH378187","4278482","4278760","chr9","58155888","58156167","44","53877406"
"JH378187","7649535","7649826","chr9","119662466","119662760","33","112012931"
"JH378187","7686262","7686564","chr27","32681295","32681602","58","24995033"
"JH378187","7765085","7765367","chr2","47509921","47510201","40","39744836"
"JH378187","8296417","8296708","chr11","42708500","42708788","42","34412083"
"JH378187","8374013","8374264","chr25","50135597","50135848","53","41761584"
"JH378187","9021605","9021896","chr27","8247376","8247668","43","774229"
"JH378188","349711","350003","chr9","32604399","32604698","50","32254688"
"JH378188","483591","483786","chr2","25630213","25630417","42","25146622"
"JH378188","701847","702144","chr7","109750336","109750636","45","109048489"
"JH378188","1096217","1096512","chr11","46870539","46870831","46","45774322"
"JH378188","3427258","3427446","chr20","113342426","113342612","38","109915168"
"JH378188","3476147","3476428","chr2","84407708","84407986","56","80931561"
"JH378188","3803534","3803815","chr9","99714018","99714298","37","95910484"
"JH378188","4269313","4269491","chr9","44129525","44129702","31","39860212"
"JH378188","4442570","4442866","chr3","19781093","19781390","43","15338523"
"JH378188","4542135","4542416","chr21","18672750","18673031","44","14130615"
"JH378188","4989554","4989842","chr10","104330612","104330907","47","99341058"
"JH378188","5313992","5314300","chr19","24473267","24473575","58","19159275"
"JH378188","6491354","6491557","chr16","9005892","9006101","34","2514538"
"JH378188","6716804","6717014","chr2","25630213","25630417","49","18913409"
"JH378188","6957581","6957807","chr22","59313204","59313418","44","52355623"
"JH378188","7564194","7564500","chrX","12578700","12578996","62","5014506"
"JH378188","7857510","7857826","chr22","60500152","60500460","51","52642642"
"JH378188","8889993","8890280","chr11","42708500","42708788","43","33818507"
"JH378188","8901685","8901970","chr14","60501630","60501919","56","51599945"
"JH378188","8954967","8955097","chr7","106999873","106999998","24","98044906"
"JH378188","9077096","9077373","chr14","80224772","80225054","55","71147676"
"JH378188","9271725","9272021","chr16","30445850","30446151","38","21174125"
"JH378188","9503781","9503895","chr2","87262500","87262610","21","77758719"
"JH378188","9579181","9579472","chr26","11209053","11209344","42","1629872"
"JH378189","59510","59751","chr20","102003909","102004157","47","101944399"
"JH378189","508810","509098","chr3","64952340","64952627","57","64443530"
"JH378189","859102","859409","chr20","7876234","7876541","44","7017132"
"JH378189","1163224","1163525","chr5","56224591","56224886","43","55061367"
"JH378189","1483458","1483763","chr14","61597253","61597561","33","60113795"
"JH378189","1744212","1744467","chr15","57792292","57792548","44","56048080"
"JH378189","3136889","3137097","chr9","57732450","57732667","51","54595561"
"JH378189","3585532","3585802","chr21","35594447","35594717","47","32008915"
"JH378189","3681487","3681747","chr12","56981284","56981548","49","53299797"
"JH378189","3780900","3781208","chr16","36007753","36008062","44","32226853"
"JH378189","4241188","4241453","chr16","17103242","17103520","53","12862054"
"JH378189","4350898","4351101","chr16","9005892","9006101","33","4654994"
"JH378189","4456023","4456087","chr16","23004870","23004934","14","18548847"
"JH378189","4456088","4456251","chr12","65894368","65894537","32","61438280"
"JH378189","5121588","5121881","chr12","62843629","62843921","50","57722041"
"JH378189","5350890","5351111","chr7","57513437","57513664","35","52162547"
"JH378189","5382668","5382925","chr5","15593128","15593380","46","10210460"
"JH378189","5921877","5922150","chr1","89981933","89982205","50","84060056"
"JH378189","5966404","5966527","chr26","27840309","27840431","39","21873905"
"JH378189","5976581","5976886","chr2","33362197","33362503","44","27385616"
"JH378189","6094248","6094505","chr11","31189578","31189838","48","25095330"
"JH378189","6898592","6898899","chr2","22860155","22860456","56","15961563"
"JH378189","7028372","7028681","chrX","10891227","10891532","42","3862855"
"JH378189","7133191","7133469","chr8","40712258","40712534","50","33579067"
"JH378189","7470134","7470434","chr20","90303203","90303504","56","82833069"
"JH378189","8238330","8238453","chr13","23729542","23729661","29","15491212"
"JH378189","8574661","8574953","chr13","64951567","64951860","50","56376906"
"JH378189","8894802","8895088","chr22","11362456","11362743","42","2467654"
"JH378189","9481628","9481915","chr1","16838288","16838572","42","7356660"
"JH378189","9576084","9576379","chr20","105708807","105709105","47","96132723"
"JH378190","35022","35320","chr7","31225213","31225514","47","31190191"
"JH378190","365910","366193","chr3","19427213","19427505","49","19061303"
"JH378190","784334","784479","chr5","71122050","71122197","34","70337716"
"JH378190","889887","889933","chr22","18861482","18861528","5","17971595"
"JH378190","1010745","1011060","chrX","45701597","45701901","55","44690852"
"JH378190","1406442","1406616","chr21","58133217","58133377","50","56726775"
"JH378190","1790967","1791261","chr26","26868700","26868994","50","25077733"
"JH378190","1908156","1908350","chr23","43611135","43611328","39","41702979"
"JH378190","2184175","2184457","chr2","12062172","12062451","47","9877997"
"JH378190","2759796","2760085","chr15","4518124","4518415","41","1758328"
"JH378190","3021453","3021674","chr11","100225388","100225600","38","97203935"
"JH378190","3948353","3948662","chr20","16464290","16464599","44","12515937"
"JH378190","4678516","4678818","chrX","29670774","29671076","43","24992258"
"JH378190","4818058","4818289","chr5","63256","63474","45","4754802"
"JH378190","5390143","5390436","chr28","15327544","15327835","37","9937401"
"JH378190","5562082","5562247","chr8","74679906","74680079","48","69117824"
"JH378190","5580580","5580875","chr11","83560875","83561170","38","77980295"
"JH378190","5602715","5602988","chr25","17601824","17602097","53","11999109"
"JH378190","5624205","5624322","chr7","24354570","24354672","27","18730365"
"JH378190","5687782","5688077","chr1","109924260","109924555","53","104236478"
"JH378190","5831756","5832048","chr5","53126639","53126932","49","47294883"
"JH378190","6098205","6098405","chr7","132382832","132383026","31","126284627"
"JH378190","6844014","6844294","chr9","99714018","99714298","47","92870004"
"JH378190","6878676","6878964","chr29","9188440","9188729","34","2309764"
"JH378190","7389565","7389758","chr5","26327986","26328184","46","18938421"
"JH378190","7549654","7549921","chr5","43989885","43990146","50","36440231"
"JH378190","8278503","8278787","chrX","58994083","58994385","58","50715580"
"JH378190","8468220","8468336","chr6","44726967","44727090","26","36258747"
"JH378190","8519306","8519607","chrX","61756996","61757299","36","53237690"
"JH378190","8721729","8722033","chr19","23855744","23856050","39","15134015"
"JH378190","8909010","8909315","chr11","19714655","19714953","57","10805645"
"JH378190","9008686","9008970","chr25","18817843","18818127","39","9809157"
"JH378190","9086062","9086332","chr7","108418621","108418894","46","99332559"
"JH378190","9205871","9206143","chr14","61597585","61597855","48","52391714"
"JH378190","9345974","9346248","chr1","119397052","119397342","51","110051078"
"JH378190","9376875","9377166","chr22","48035770","48036066","48","38658895"
"JH378190","9454391","9454558","chr20","100399354","100399526","31","90944963"
"JH378191","458504","458795","chr14","81458250","81458541","69","80999746"
"JH378191","471181","471320","chr9","32125196","32125331","40","31654015"
"JH378191","646992","647292","chr2","61035797","61036096","52","60388805"
"JH378191","726513","726814","chr3","30187575","30187872","38","29461062"
"JH378191","882348","882628","chr3","76758914","76759196","53","75876566"
"JH378191","1857767","1858035","chr11","105269557","105269836","48","103411790"
"JH378191","2140137","2140443","chr17","40106599","40106905","39","37966462"
"JH378191","3273621","3273919","chr9","86699927","86700224","53","83426306"
"JH378191","3364299","3364595","chr22","60712414","60712713","49","57348115"
"JH378191","3558484","3558793","chr9","62219075","62219386","43","58660591"
"JH378191","3601546","3601827","chr7","97803272","97803563","50","94201726"
"JH378191","3676649","3676929","chr11","42708500","42708788","40","39031851"
"JH378191","4022522","4022703","chr11","12136411","12136592","33","8113889"
"JH378191","4077040","4077149","chr6","29480212","29480322","19","25403172"
"JH378191","6646496","6646790","chr16","14422338","14422632","35","7775842"
"JH378191","6832310","6832444","chr7","131555078","131555210","26","124722768"
"JH378191","8138805","8139084","chr13","86323276","86323561","35","78184471"
"JH378191","8850366","8850677","chr18","11547924","11548236","45","2697558"
"JH378191","8906714","8906929","chr14","74021868","74022082","29","65115154"
"JH378191","8992188","8992428","chr8","93004179","93004415","56","84011991"
"JH378191","9236706","9236921","chr7","57513437","57513664","54","48276731"
"JH378192","941885","942132","chr10","94020388","94020642","53","93078503"
"JH378192","1079938","1080237","chr29","3711047","3711343","41","2631109"
"JH378192","1217543","1217846","chr3","4720558","4720866","50","3503015"
"JH378192","2200419","2200701","chr25","27172863","27173143","54","24972444"
"JH378192","5240043","5240342","chr3","6414985","6415283","40","1174942"
"JH378192","5366418","5366715","chr2","14953819","14954119","38","9587401"
"JH378192","5618827","5618993","chr27","10317709","10317877","28","4698882"
"JH378192","6892539","6892833","chr23","63097278","63097570","40","56204739"
"JH378192","7301439","7301754","chr6","36288281","36288590","57","28986842"
"JH378192","7751084","7751392","chr20","7876234","7876541","35","125150"
"JH378192","8095639","8095925","chr16","58327777","58328064","34","50232138"
"JH378192","8193217","8193522","chr12","41019638","41019945","41","32826421"
"JH378192","8462681","8462987","chr6","8634857","8635167","44","172176"
"JH378193","564995","565256","chr2","87954053","87954315","47","87389058"
"JH378193","571079","571370","chr5","69299877","69300170","49","68728798"
"JH378193","839412","839616","chr9","105264842","105265042","33","104425430"
"JH378193","930369","930476","chr12","17356175","17356289","27","16425806"
"JH378193","1292616","1292883","chr2","5238241","5238519","47","3945625"
"JH378193","1303302","1303570","chr10","34411206","34411482","50","33107904"
"JH378193","1362927","1363115","chr17","35595762","35595954","33","34232835"
"JH378193","1378050","1378349","chr9","52584616","52584911","53","51206566"
"JH378193","1391283","1391588","chr10","104330612","104330907","51","102939329"
"JH378193","1496888","1497171","chr15","4769595","4769876","33","3272707"
"JH378193","1505580","1505864","chr2","56072846","56073138","53","54567266"
"JH378193","1527051","1527320","chr4","37731664","37731929","46","36204613"
"JH378193","1596594","1596709","chr28","16241085","16241207","22","14644491"
"JH378193","1986572","1986741","chr20","87928737","87928908","29","85942165"
"JH378193","2118512","2118649","chr18","68076040","68076170","29","65957528"
"JH378193","2139108","2139382","chr21","85642900","85643169","37","83503792"
"JH378193","2381057","2381347","chr3","4648816","4649103","48","2267759"
"JH378193","2422284","2422570","chr20","2854395","2854680","34","432111"
"JH378193","2498708","2499008","chr12","81862904","81863207","42","79364196"
"JH378193","2614848","2615137","chr16","18257374","18257671","59","15642526"
"JH378193","2787852","2788060","chrX","129744426","129744635","42","126956574"
"JH378193","2803219","2803505","chr14","89802144","89802429","34","86998925"
"JH378193","2813386","2813497","chr10","2090892","2091004","18","722494"
"JH378193","3073472","3073763","chr10","55092261","55092557","41","52018789"
"JH378193","3166158","3166442","chr3","6022508","6022797","41","2856350"
"JH378193","3302782","3303017","chr21","125373692","125373921","40","122070910"
"JH378193","3865834","3866038","chr9","105264842","105265042","38","101399008"
"JH378193","4202002","4202161","chr9","107561541","107561712","38","103359539"
"JH378193","4225372","4225565","chr16","56784147","56784341","46","52558775"
"JH378193","4227218","4227512","chr12","101706953","101707248","40","97479735"
"JH378193","5068299","5068429","chr4","77908589","77908714","18","72840290"
"JH378193","5834041","5834350","chr9","119761241","119761543","36","113927200"
"JH378193","6018409","6018708","chr9","57444017","57444321","42","51425608"
"JH378193","6235213","6235519","chr12","3898076","3898379","46","2337137"
"JH378193","6673883","6674147","chr1","21908885","21909148","49","15235002"
"JH378193","6708562","6708804","chr3","54097857","54098084","51","47389295"
"JH378193","7002869","7003133","chr14","953562","953838","50","6049307"
"JH378193","7337541","7337833","chr2","61035797","61036096","47","53698256"
"JH378193","7505485","7505784","chrX","43777377","43777676","39","36271892"
"JH378193","7727872","7728172","chr20","93694818","93695111","40","85966946"
"JH378193","7747959","7748273","chr1","103001759","103002077","53","95253800"
"JH378193","7993067","7993250","chr7","92803834","92804013","28","84810767"
"JH378193","8425601","8425910","chr2","33362197","33362503","43","24936596"
"JH378193","8610952","8611069","chr6","44726967","44727090","21","36116015"
"JH378193","8780433","8780743","chrX","58994083","58994385","42","50213650"
"JH378193","8881747","8882054","chr6","36288281","36288590","38","27406534"
"JH378193","9025683","9025977","chr5","38130069","38130369","40","29104386"
"JH378193","9309235","9309463","chr17","19329630","19329857","35","10020395"
"JH378193","9345768","9346063","chr1","120558770","120559064","61","111213002"
"JH378194","194205","194476","chr20","13058406","13058680","51","12864201"
"JH378194","333703","333922","chr9","58607834","58608063","63","58274131"
"JH378194","426120","426395","chr2_AQIB01158150v1_random","7269","7532","55","418851"
"JH378194","988323","988628","chr23","78084416","78084726","41","77096093"
"JH378194","1061438","1061727","chr24","42824289","42824580","36","41762851"
"JH378194","1399298","1399601","chr9","119761241","119761543","40","118361943"
"JH378194","2305003","2305083","chr9","58507566","58507653","25","56202563"
"JH378194","2670703","2670971","chr2","20173547","20173802","66","17502844"
"JH378194","4310703","4311003","chr6","47227981","47228287","56","42917278"
"JH378194","4777662","4777949","chr14","83288480","83288767","51","78510818"
"JH378194","5089080","5089220","chr20","20635550","20635688","24","15546470"
"JH378194","5304785","5304903","chr9","3918407","3918523","22","1386378"
"JH378194","6945613","6945914","chr2","61035797","61036096","39","54090184"
"JH378194","7505455","7505728","chr10","19583407","19583687","49","12077952"
"JH378194","8497584","8497849","chrX","34454786","34455054","39","25957202"
"JH378194","8872080","8872343","chr10","55600559","55600818","47","46728479"
"JH378195","1503568","1503868","chr19","18052906","18053205","61","16549338"
"JH378195","1717277","1717566","chr10","94012577","94012864","54","92295300"
"JH378195","2004571","2004783","chr21","106582007","106582232","46","104577436"
"JH378195","2253329","2253613","chr20","7876234","7876541","45","5622905"
"JH378195","2376296","2376604","chr20","7876234","7876541","39","5499938"
"JH378195","2433833","2434133","chr20","104985298","104985598","62","102551465"
"JH378195","2589404","2589697","chr14","22096587","22096882","39","19507183"
"JH378195","3467206","3467485","chr25","27453211","27453490","38","23986005"
"JH378195","4346648","4346956","chr1","125024996","125025302","42","120678348"
"JH378195","4426720","4426993","chr3","88516944","88517224","54","84090224"
"JH378195","4480953","4481246","chr9","62609877","62610171","47","58128924"
"JH378195","5362963","5363247","chr13","67198097","67198382","49","61835134"
"JH378195","5586707","5586999","chr26","11209053","11209344","42","5622346"
"JH378195","5737433","5737744","chr6","8634857","8635167","46","2897424"
"JH378195","5852236","5852512","chr9","18313882","18314160","69","12461646"
"JH378195","7511435","7511741","chr12","3898076","3898379","46","3613359"
"JH378195","7529443","7529727","chr4","53460153","53460432","42","45930710"
"JH378195","7600428","7600717","chr2","6803049","6803335","37","797379"
"JH378195","7768653","7768943","chr9","103138976","103139260","58","95370323"
"JH378195","7793639","7793810","chr20","87928737","87928908","32","80135098"
"JH378195","7905255","7905427","chr12","43957933","43958104","30","36052678"
"JH378195","8007614","8007918","chr2","22860155","22860456","43","14852541"
"JH378195","8053365","8053541","chr22","11241699","11241867","38","3188334"
"JH378195","8181455","8181704","chr10","55600559","55600818","60","47419104"
"JH378195","8469221","8469525","chr16","33139486","33139791","41","24670265"
"JH378195","8642069","8642369","chr10","44221705","44222014","49","35579636"
"JH378196","352632","352792","chr2","36086667","36086826","34","35734035"
"JH378196","865054","865349","chr14","61597253","61597561","47","60732199"
"JH378196","1141702","1141980","chr29","22945616","22945895","48","21803914"
"JH378196","1807355","1807464","chr23","21500132","21500258","27","19692777"
"JH378196","2478204","2478494","chr9","98453445","98453725","68","95975241"
"JH378196","2768035","2768314","chr13","86323276","86323561","58","83555241"
"JH378196","3314297","3314437","chr19","8893838","8893978","31","5579541"
"JH378196","3448151","3448443","chr1","8790492","8790780","51","5342341"
"JH378196","4031670","4031977","chr1","113325394","113325698","51","109293724"
"JH378196","4544259","4544412","chr6","45938257","45938403","40","41393998"
"JH378196","4894652","4894938","chr3","4648816","4649103","48","245836"
"JH378196","5765722","5766046","chr11","31876186","31876503","53","26110464"
"JH378196","5852654","5852952","chr19","27584635","27584934","41","21731981"
"JH378196","6116703","6116822","chr1","19184037","19184145","26","13067334"
"JH378196","6852435","6852716","chr28","8917006","8917294","44","2064571"
"JH378196","7358221","7358329","chr9","53409388","53409496","16","46051167"
"JH378196","7603552","7603840","chr14","83761665","83761957","41","76158113"
"JH378196","8306959","8307244","chr7","102129980","102130268","65","93823021"
"JH378197","122416","122620","chr2","36659699","36659910","41","36537283"
"JH378197","175965","176095","chr25","28864990","28865114","22","28689025"
"JH378197","650788","651060","chr14","33993071","33993339","32","33342283"
"JH378197","978431","978722","chr6","5826877","5827168","43","4848446"
"JH378197","978725","979042","chr7","101887455","101887761","53","100908730"
"JH378197","1260670","1260884","chr11","100225388","100225600","23","98964718"
"JH378197","1579612","1579914","chr11","47411625","47411934","46","45832013"
"JH378197","1621778","1622060","chr9","18313882","18314160","65","16692104"
"JH378197","2018091","2018375","chr20","117005664","117005963","48","114987573"
"JH378197","2298247","2298381","chr6","50646888","50647023","32","48348641"
"JH378197","2431370","2431655","chr11","42708500","42708788","45","40277130"
"JH378197","3086399","3086701","chr13","65755815","65756123","52","62669416"
"JH378197","3111609","3111775","chr17","49898426","49898587","35","46786817"
"JH378197","3142133","3142251","chr5","8452769","8452882","32","5310636"
"JH378197","3928995","3929299","chr6","10613040","10613338","46","6684045"
"JH378197","3960670","3960966","chr18","44016665","44016956","63","40055995"
"JH378197","4308477","4308643","chr19","11544687","11544855","31","7236210"
"JH378197","4335726","4336019","chr1","44461610","44461904","36","40125884"
"JH378197","4342409","4342699","chr23","45383243","45383541","47","41040834"
"JH378197","4460921","4461223","chr1","7743906","7744215","49","3282985"
"JH378197","5280792","5280951","chr23","44797757","44797907","35","39516965"
"JH378197","5327135","5327416","chr11","102065439","102065716","43","96738304"
"JH378197","5348299","5348587","chr1","108300659","108300949","47","102952360"
"JH378197","5532751","5533058","chr6","29394044","29394346","31","23861293"
"JH378197","5758554","5758737","chr12","43962243","43962428","37","38203689"
"JH378197","6015240","6015528","chr9","52584616","52584911","48","46569376"
"JH378197","6153937","6154013","chr28","12381794","12381862","23","6227857"
"JH378197","6519171","6519270","chr14","67029759","67029860","18","60510588"
"JH378197","6559260","6559560","chrX","33027186","33027484","40","26467926"
"JH378197","6588542","6588838","chr10","89318076","89318373","51","82729534"
"JH378197","6774022","6774306","chr21","14733313","14733598","37","7959291"
"JH378197","6849695","6849966","chr20","6799163","6799446","51","50532"
"JH378197","6970313","6970595","chr17","50312022","50312314","57","43341709"
"JH378197","7179733","7180023","chr19","14623177","14623470","50","7443444"
"JH378197","7363797","7364113","chr17","1608450","1608742","67","5755347"
"JH378197","7642591","7642792","chr9","36937433","36937631","36","29294842"
"JH378197","7710210","7710499","chr9","17526312","17526604","39","9816102"
"JH378197","7716474","7716730","chr9","119241694","119241960","48","111525220"
"JH378197","7852501","7852804","chr28","10271566","10271865","52","2419065"
"JH378197","8034204","8034480","chr11","75071530","75071805","47","67037326"
"JH378197","8069901","8070195","chr9","52584616","52584911","40","44514715"
"JH378197","8077569","8077870","chr18","35039565","35039862","36","26961996"
"JH378197","8149337","8149638","chr11","87886803","87887101","35","79737466"
"JH378197","8249951","8250240","chr25","50668923","50669216","45","42418972"
"JH378197","8443675","8443785","chr8","88261673","88261783","18","79817998"
"JH378197","8497976","8498272","chr20","93227674","93227983","49","84729698"
"JH378197","8589354","8589655","chrX","50449700","50450001","41","41860346"
"JH378197","8748279","8748445","chr18","62022139","62022304","30","53273860"
"JH378198","27691","27980","chr12","45962018","45962309","43","45934327"
"JH378198","1313540","1313826","chr13","67198097","67198382","45","65884557"
"JH378198","1495602","1495892","chr28","15327544","15327835","41","13831942"
"JH378198","1551501","1551793","chr2","47485248","47485546","42","45933747"
"JH378198","1591633","1591929","chr8","11215621","11215918","37","9623988"
"JH378198","1613120","1613421","chr1","43486737","43487042","38","41873617"
"JH378198","1666492","1666785","chr20","80621483","80621774","42","78954991"
"JH378198","1761438","1761604","chr16","8056026","8056187","31","6294588"
"JH378198","1796715","1796874","chrX","29833617","29833775","36","28036902"
"JH378198","1816460","1816721","chr10","55562512","55562784","58","53746052"
"JH378198","1981676","1981946","chr11","62921553","62921824","38","60939877"
"JH378198","1993599","1993901","chr2","61035797","61036096","48","59042198"
"JH378198","2005815","2006106","chr9","6382689","6382978","33","4376874"
"JH378198","2016922","2017225","chr9","104154348","104154646","47","102137426"
"JH378198","2094728","2095013","chr12","34143053","34143343","49","32048325"
"JH378198","2141518","2141817","chr26","24027927","24028229","45","21886409"
"JH378198","2237203","2237506","chr19","15214670","15214974","39","12977467"
"JH378198","2237588","2237896","chr11","116558393","116558699","45","114320805"
"JH378198","3212181","3212493","chr26","18794536","18794836","51","15582355"
"JH378198","3962043","3962309","chr5","72051782","72052054","40","68089739"
"JH378198","4927383","4927671","chr5","32762367","32762666","52","27834984"
"JH378198","4987454","4987768","chr10","29161569","29161885","49","24174115"
"JH378198","5178893","5179038","chr15","47627624","47627769","45","42448731"
"JH378198","5463110","5463369","chr13","20142235","20142496","35","14679125"
"JH378198","5607188","5607473","chr28","8917006","8917294","46","3309818"
"JH378198","5664381","5664689","chrX","29670774","29671076","46","24006393"
"JH378198","6223789","6223999","chr28","5263156","5263365","39","960633"
"JH378198","6499265","6499558","chr9","92267415","92267704","35","85768150"
"JH378198","6546761","6547069","chr2","22860155","22860456","47","16313394"
"JH378198","7137357","7137527","chr6","33811352","33811518","35","26673995"
"JH378198","8414575","8414877","chrX","44238718","44239009","43","35824143"
"JH378198","8594083","8594257","chr16","56984674","56984842","30","48390591"
"JH378198","8687421","8687728","chr12","41019638","41019945","42","32332217"
"JH378199","38727","38855","chr14","67782475","67782602","17","67743748"
"JH378199","125558","125866","chrX","23182631","23182933","43","23057073"
"JH378199","490867","491156","chr18","31464231","31464522","34","30973364"
"JH378199","670709","670997","chr9","57921121","57921405","37","57250412"
"JH378199","1356597","1356676","chr1","9185341","9185424","19","7828744"
"JH378199","1678495","1678777","chr9","6382689","6382978","39","4704194"
"JH378199","1893275","1893565","chr15","58145892","58146179","32","56252617"
"JH378199","2041961","2042123","chr10","61946373","61946539","28","59904412"
"JH378199","2079286","2079521","chr11","100832309","100832548","30","98753023"
"JH378199","2248160","2248460","chr3","25784267","25784567","56","23536107"
"JH378199","2271975","2272269","chr1","29621888","29622188","63","27349913"
"JH378199","2385469","2385762","chr14","86997958","86998245","55","84612489"
"JH378199","2493193","2493471","chr11","42708500","42708788","51","40215307"
"JH378199","2912722","2912869","chr20","20635550","20635688","24","17722828"
"JH378199","3199329","3199631","chr26","24027927","24028229","39","20828598"
"JH378199","3271293","3271600","chr6","36288281","36288590","43","33016988"
"JH378199","3579710","3579890","chr16","74527352","74527538","37","70947642"
"JH378199","3660231","3660455","chr18","9905435","9905663","39","6245204"
"JH378199","3660540","3660595","chr5","2445602","2445676","25","1214938"
"JH378199","3737016","3737264","chr2","56770497","56770741","42","53033481"
"JH378199","3810886","3811170","chr1","65102131","65102418","41","61291245"
"JH378199","3861684","3861972","chr7_AQIB01159043v1_random","18062","18357","43","3843622"
"JH378199","3892929","3893103","chr22","74857230","74857409","30","70964301"
"JH378199","3982418","3982730","chr6","30079079","30079380","46","26096661"
"JH378199","4011640","4011943","chr1","86467570","86467849","76","82455930"
"JH378199","4306754","4306992","chr10","82421989","82422214","59","78115235"
"JH378199","4437713","4437995","chr12","108171343","108171621","44","103733630"
"JH378199","4532940","4533233","chr9","85636273","85636563","38","81103333"
"JH378199","4933019","4933327","chrX","61756996","61757299","39","56823977"
"JH378199","5059208","5059265","chr25","75564241","75564295","13","70505033"
"JH378199","5124140","5124438","chr6","10613040","10613338","31","5488900"
"JH378199","5293482","5293780","chr23","12799637","12799937","32","7506155"
"JH378199","5941188","5941340","chr14","63352153","63352302","25","57410965"
"JH378199","6182360","6182504","chr17","61823129","61823273","27","55640769"
"JH378199","6182609","6182805","chr19","16893479","16893663","37","10710870"
"JH378199","6191307","6191453","chr10","35002409","35002551","22","28811102"
"JH378199","6625629","6625909","chr19","7984494","7984775","63","1358865"
"JH378199","7488861","7489148","chr10","117276725","117277019","38","109787864"
"JH378199","7624846","7625123","chr2","7721210","7721494","38","96364"
"JH378199","7686398","7686681","chr19","1538482","1538767","38","6147916"
"JH378199","8326690","8326829","chr11","59867158","59867285","34","51540468"
"JH378199","8380670","8380958","chr24","26872400","26872686","42","18491730"
"JH378199","8565772","8566065","chr12","41367876","41368167","41","32802104"
"JH378200","7208883","7209115","chr20","107997025","107997264","35","100788142"
"JH378200","680784","681056","chr3","73292441","73292730","50","72611657"
"JH378200","953238","953547","chr23","46626246","46626546","50","45673008"
"JH378200","959691","959905","chr25","83957326","83957569","71","82997635"
"JH378200","1055063","1055351","chr14","68359125","68359423","50","67304062"
"JH378200","1055878","1056089","chr13","13267143","13267363","44","12211265"
"JH378200","1330851","1331103","chr10","105580133","105580401","49","104249282"
"JH378200","2102383","2102686","chr4","10168457","10168762","46","8066074"
"JH378200","2217842","2218080","chr10","24210364","24210604","49","21992522"
"JH378200","3439975","3440186","chr9","85897385","85897596","35","82457410"
"JH378200","3512087","3512385","chr12","3898076","3898379","52","385989"
"JH378200","3931518","3931825","chr20","7876234","7876541","45","3944716"
"JH378200","4037733","4038042","chr26","4574785","4575094","36","537052"
"JH378200","4065099","4065360","chr11","62921553","62921824","55","58856454"
"JH378200","4326988","4327106","chrX","105255765","105255881","27","100928777"
"JH378200","6184345","6184561","chr22","9183381","9183596","50","2999036"
"JH378200","6429191","6429478","chr15","8473619","8473907","43","2044428"
"JH378200","6738343","6738654","chr6","8634857","8635167","52","1896514"
"JH378200","7114024","7114343","chr6","8634857","8635167","51","1520833"
"JH378200","7301587","7301873","chr4","71555519","71555804","61","64253932"
"JH378200","7565804","7566112","chrX","32649258","32649566","49","25083454"
"JH378200","8125784","8125990","chr8","80615009","80615223","40","72489225"
"JH378201","229051","229321","chr14","73627770","73628044","53","73398719"
"JH378201","243471","243644","chr14","9346341","9346512","29","9102870"
"JH378201","363542","363834","chr23","16885528","16885821","38","16521986"
"JH378201","409306","409481","chr14","57070656","57070827","31","56661350"
"JH378201","547290","547589","chr11","120396815","120397109","61","119849525"
"JH378201","574346","574641","chr9","6382689","6382978","34","5808343"
"JH378201","944091","944191","chr22","36426191","36426290","34","35482100"
"JH378201","1099765","1100074","chr10","122812616","122812920","56","121712851"
"JH378201","1112938","1113225","chr26","48811822","48812111","39","47698884"
"JH378201","2019604","2019909","chr6","48617359","48617659","55","46597755"
"JH378201","2424716","2424920","chr19","12992619","12992824","39","10567903"
"JH378201","3487266","3487584","chr12","72899340","72899646","44","69412074"
"JH378201","5894110","5894376","chr2","66937766","66938027","47","61043656"
"JH378201","6212462","6212711","chr6","11215683","11215935","50","5003221"
"JH378201","6250119","6250279","chr16","62500748","62500910","31","56250629"
"JH378201","6356672","6356973","chr1","20836893","20837193","41","14480221"
"JH378201","6552769","6553067","chr15","43966407","43966704","61","37413638"
"JH378201","6880307","6880602","chr1","84971033","84971323","40","78090726"
"JH378201","7281925","7282205","chr9","106946005","106946287","37","99664080"
"JH378201","7454494","7454792","chr3","31757392","31757689","33","24302898"
"JH378201","7475278","7475570","chr3","19321332","19321620","47","11846054"
"JH378201","7487323","7487613","chr29","9188440","9188729","32","1701117"
"JH378201","7666889","7667179","chr9","78073476","78073771","45","70406587"
"JH378201","8212868","8212989","chr9","3918407","3918523","20","4294461"
"JH378202","6606","6912","chr7","133367054","133367360","54","133360448"
"JH378202","3219942","3220244","chr20","7876234","7876541","51","4656292"
"JH378202","5008715","5009026","chr20","78995008","78995313","65","73986293"
"JH378202","5815178","5815521","chr27","33864159","33864484","63","28048981"
"JH378202","7632537","7632750","chrX","124509631","124509844","46","116877094"
"JH378203","331037","331343","chr8","20779287","20779584","52","20448250"
"JH378203","505335","505493","chr20","71250856","71251020","47","70745521"
"JH378203","552590","552886","chr16","63906186","63906482","42","63353596"
"JH378203","926212","926489","chr11","60552837","60553124","49","59626625"
"JH378203","1213763","1214047","chr5","56326093","56326386","61","55112330"
"JH378203","1469323","1469577","chr14","74080496","74080760","51","72611173"
"JH378203","1701112","1701406","chr7","91843770","91844065","41","90142658"
"JH378203","2749548","2749856","chr16","36007753","36008062","48","33258205"
"JH378203","3317260","3317553","chr12","64183477","64183775","41","60866217"
"JH378203","3981853","3981940","chr24","48773002","48773103","31","44791149"
"JH378203","4099869","4100003","chr2","65450198","65450327","27","61350329"
"JH378203","4110678","4110985","chr8","20072572","20072880","34","15961894"
"JH378203","5494528","5494818","chr16","57139176","57139471","39","51644648"
"JH378203","6013950","6014243","chr11","83560875","83561170","46","77546925"
"JH378203","6529861","6530151","chr15","21505985","21506275","43","14976124"
"JH378203","6745426","6745738","chr8","102187954","102188258","69","95442528"
"JH378203","7391865","7392167","chr16","18257374","18257671","47","10865509"
"JH378203","7948430","7948741","chr15","2000778","2001083","55","5947652"
"JH378203","8063221","8063461","chr24","33252032","33252271","51","25188811"
"JH378203","8140105","8140337","chr12","83070817","83071048","36","74930712"
"JH378204","837266","837486","chr11","7774263","7774487","51","6936997"
"JH378204","1219787","1220076","chr1","9360845","9361141","38","8141058"
"JH378204","2092660","2092961","chr19","27584635","27584934","46","25491975"
"JH378204","2456924","2457030","chr21","103512848","103512947","23","101055924"
"JH378204","2825859","2826163","chr18","61784480","61784788","44","58958621"
"JH378204","2834431","2834714","chr5","15825478","15825762","49","12991047"
"JH378204","2855808","2856108","chr10","102332242","102332544","34","99476434"
"JH378204","2889394","2889706","chr5","26715790","26716088","54","23826396"
"JH378204","2895550","2895862","chr20","7876234","7876541","43","4980684"
"JH378204","2909273","2909570","chr10","104330612","104330907","43","101421339"
"JH378204","3403737","3404068","chr23","12799637","12799937","68","9395900"
"JH378204","3810102","3810402","chr14","80469888","80470183","68","76659786"
"JH378204","3857816","3858124","chr8","121880813","121881121","40","118022997"
"JH378204","4091964","4092231","chr23","74349864","74350142","66","70257900"
"JH378204","4325633","4325936","chr6","18852331","18852633","44","14526698"
"JH378204","4445004","4445248","chr1","41979357","41979596","46","37534353"
"JH378204","4789675","4789968","chr16","70729210","70729502","32","65939535"
"JH378204","5006288","5006586","chr4","31811484","31811787","42","26805196"
"JH378204","5051498","5051821","chr11","113683313","113683616","71","108631815"
"JH378204","5288948","5289235","chr9","6382689","6382978","44","1093741"
"JH378204","5399538","5399833","chrX","45160626","45160926","47","39761088"
"JH378204","5661302","5661589","chr11","90535443","90535733","39","84874141"
"JH378204","6270908","6271209","chr12","97392320","97392622","45","91121412"
"JH378204","6291008","6291317","chr7","119466216","119466521","45","113175208"
"JH378204","6400512","6400788","chr23","63097278","63097570","48","56696766"
"JH378204","6707444","6707734","chr16","32482378","32482667","43","25774934"
"JH378204","6833685","6833963","chr25","24645788","24646060","43","17812103"
"JH378204","7112161","7112443","chr9","57921121","57921405","39","50808960"
"JH378204","7247064","7247236","chr7","92803834","92804013","32","85556770"
"JH378204","7305369","7305589","chrX","92178511","92178733","34","84873142"
"JH378204","7483564","7483862","chr2","22860155","22860456","50","15376591"
"JH378204","7694379","7694684","chr3","29617498","29617804","37","21923119"
"JH378204","7913667","7913954","chr11","102915301","102915590","46","95001634"
"JH378204","7951475","7951764","chr1","68581324","68581621","45","60629849"
"JH378205","152342","152454","chr2","14267810","14267928","27","14115468"
"JH378205","446589","446853","chr22","71874724","71874995","44","71428135"
"JH378205","1407110","1407410","chr29","22012118","22012414","53","20605008"
"JH378205","1632041","1632119","chr24","62832408","62832491","16","61200367"
"JH378205","2673962","2674215","chr19","28790804","28791063","39","26116842"
"JH378205","3372765","3372977","chr16","15121498","15121716","45","11748733"
"JH378205","3843863","3844094","chr17","19329630","19329857","65","15485767"
"JH378205","4262876","4263063","chr8","74679906","74680079","45","70417030"
"JH378205","5159319","5159590","chr1","73623928","73624197","44","68464609"
"JH378205","5540110","5540398","chr20_KE148049v1_random","957708","957997","44","4582402"
"JH378205","5633912","5633947","chr29","10717384","10717425","13","5083472"
"JH378205","5695171","5695472","chr14","99085390","99085687","43","93390219"
"JH378205","5901273","5901563","chr11","42708500","42708788","41","36807227"
"JH378205","5936520","5936638","chr14","3260195","3260311","15","2676325"
"JH378205","6209683","6209725","chrY","1041155","1041191","15","5168528"
"JH378205","6238256","6238535","chr9","58155888","58156167","36","51917632"
"JH378205","6898404","6898594","chr8","74679906","74680079","53","67781502"
"JH378205","7332068","7332366","chr21","45012523","45012821","39","37680455"
"JH378205","7625228","7625523","chr10","9201728","9202027","51","1576500"
"JH378205","7816412","7816702","chr29","9188440","9188729","35","1372028"
"JH378205","8070408","8070608","chr2","20258865","20259070","62","12188457"
"JH378206","19680","19971","chr12","45962018","45962309","45","45942338"
"JH378206","98553","98860","chr20","80727402","80727700","46","80628849"
"JH378206","255967","256267","chr8","36168194","36168492","49","35912227"
"JH378206","306813","307090","chr6","14093262","14093526","73","13786449"
"JH378206","443293","443584","chr2","32652390","32652683","53","32209097"
"JH378206","550981","551280","chr6","35097365","35097661","49","34546384"
"JH378206","562938","563234","chr11","1413948","1414243","42","851010"
"JH378206","646746","646885","chr1","25970139","25970266","40","25323393"
"JH378206","1071656","1071857","chr13","96152783","96152983","39","95081127"
"JH378206","1257393","1257607","chr14","52996483","52996698","46","51739090"
"JH378206","1266978","1267282","chr21","14578304","14578604","40","13311326"
"JH378206","1462465","1462579","chr2","1554332","1554443","33","91867"
"JH378206","2233900","2234185","chr1","9923402","9923684","54","7689502"
"JH378206","2323437","2323584","chrX","45517967","45518126","35","43194530"
"JH378206","2423429","2423694","chr26","42372142","42372415","47","39948713"
"JH378206","3598419","3598721","chr2","22860155","22860456","43","19261736"
"JH378206","4751790","4752058","chr5","66352492","66352757","44","61600702"
"JH378206","5061855","5061979","chr14","67782475","67782602","12","62720620"
"JH378206","5160906","5160958","chr10","41694742","41694780","18","36533836"
"JH378206","5994123","5994432","chr16","7746162","7746454","64","1752039"
"JH378206","6026829","6026967","chr6","45938257","45938403","34","39911428"
"JH378206","6117704","6117964","chr15","57792292","57792548","38","51674588"
"JH378206","6233883","6234182","chr12","64183477","64183775","35","57949594"
"JH378206","7277468","7277619","chr28","12108779","12108927","35","4831311"
"JH378206","7301382","7301672","chr11","42708500","42708788","49","35407118"
"JH378206","7319706","7319840","chr24","65904734","65904875","38","58585028"
"JH378206","7353010","7353065","chr5","2445602","2445676","25","4907408"
"JH378206","7353288","7353539","chr13","10244688","10244932","48","2891400"
"JH378206","7745582","7745875","chr27","10526763","10527062","39","2781181"
"JH378207","1381972","1382278","chr4","31811484","31811787","49","30429512"
"JH378207","2978567","2978815","chr6","25120427","25120677","51","22141860"
"JH378207","4582615","4582916","chr16","11015749","11016046","37","6433134"
"JH378207","4751067","4751363","chr23","57612824","57613126","42","52861757"
"JH378207","4759925","4760128","chr9","85897385","85897596","41","81137460"
"JH378207","5006405","5006520","chr2","18115940","18116064","26","13109535"
"JH378207","5838623","5838930","chr2","27449856","27450162","47","21611233"
"JH378207","6925939","6926208","chr27","13518144","13518412","41","6592205"
"JH378208","796710","796991","chr9","81013808","81014095","53","80217098"
"JH378208","906752","907044","chr17","67473342","67473631","48","66566590"
"JH378208","1167258","1167535","chr14","953562","953838","46","213696"
"JH378208","1356008","1356314","chr2","42406046","42406352","41","41050038"
"JH378208","1653097","1653207","chr3","54517299","54517407","20","52864202"
"JH378208","1828423","1828723","chr1","29712863","29713163","37","27884440"
"JH378208","2110472","2110792","chr2","61035797","61036096","64","58925325"
"JH378208","2602525","2602802","chr23","79884796","79885070","50","77282271"
"JH378208","2887501","2887630","chr14","33067112","33067242","25","30179611"
"JH378208","3473281","3473590","chr2","54312462","54312771","42","50839181"
"JH378208","3608929","3609223","chr9","78073476","78073771","31","74464547"
"JH378208","3615664","3615910","chr1","50678867","50679117","57","47063203"
"JH378208","5560610","5560904","chr9","96272747","96273028","54","90712137"
"JH378208","5785817","5786109","chr11","52774613","52774907","45","46988796"
"JH378208","6011080","6011390","chr2","22860155","22860456","50","16849075"
"JH378209","593406","593676","chr5","25044505","25044772","37","24451099"
"JH378209","957961","958067","chr7","38047909","38048019","24","37089948"
"JH378209","1002758","1003050","chr11","120396815","120397109","44","119394057"
"JH378209","1010813","1011096","chr8","54639056","54639335","44","53628243"
"JH378209","1075086","1075382","chr18","59850632","59850929","44","58775546"
"JH378209","1441315","1441603","chr26","16065185","16065476","48","14623870"
"JH378209","1556711","1556846","chr20","86668125","86668264","24","85111414"
"JH378209","2148979","2149179","chr15","67612582","67612782","31","65463603"
"JH378209","3869272","3869550","chr20","9842411","9842688","45","5973139"
"JH378209","6001944","6002068","chr6","12469520","12469644","28","6467576"
"JH378209","6130482","6130762","chr11","116618009","116618296","48","110487527"
"JH378210","1574698","1574997","chr20","26242242","26242540","48","24667544"
"JH378210","2114284","2114405","chr1","8926569","8926682","21","6812285"
"JH378210","5840269","5840332","chr13","17633109","17633178","13","11792840"
"JH378210","5840372","5840434","chr20","25260925","25260981","25","19420553"
"JH378210","7452848","7453144","chr4","71555519","71555804","51","64102671"
"JH378210","7605241","7605553","chr12","72899340","72899646","43","65294099"
"JH378211","1604856","1605106","chr20","9448039","9448298","63","7843183"
"JH378211","2769427","2769543","chr17","34746845","34746962","21","31977418"
"JH378211","2820519","2820815","chr21","112020078","112020375","35","109199559"
"JH378211","2879974","2880105","chr16","71843572","71843697","29","68963598"
"JH378211","2967101","2967280","chr12","103198428","103198609","29","100231327"
"JH378211","3322834","3323135","chr6","10613040","10613338","46","7290206"
"JH378211","3360678","3360998","chr8","121527131","121527436","66","118166453"
"JH378211","3800629","3800794","chr12","43957933","43958104","32","40157304"
"JH378211","3882596","3882708","chr11","96699055","96699163","27","92816459"
"JH378211","5610156","5610460","chr7","75870311","75870612","40","70260155"
"JH378211","6262469","6262760","chr10","55092261","55092557","39","48829792"
"JH378211","6403870","6404171","chr20","105561395","105561692","44","99157525"
"JH378211","6635902","6635997","chr2","60596700","60596797","22","53960798"
"JH378211","6636787","6637025","chr3","21737714","21737910","72","15100927"
"JH378212","78331","78596","chr19","23425164","23425442","63","23346833"
"JH378212","99172","99463","chr20","104985298","104985598","49","104886126"
"JH378212","188303","188584","chr19","1538482","1538767","41","1350179"
"JH378212","396014","396259","chr8","122465744","122465992","49","122069730"
"JH378212","430937","431066","chr16","23717759","23717888","28","23286822"
"JH378212","546065","546382","chr12","72899340","72899646","49","72353275"
"JH378212","747455","747758","chr22","67435237","67435541","44","66687782"
"JH378212","964021","964288","chr14","53650197","53650475","56","52686176"
"JH378212","1591714","1591823","chr2","30454897","30455000","27","28863183"
"JH378212","1784395","1784703","chr22","18034163","18034467","38","16249768"
"JH378212","2268489","2268788","chrX","50449700","50450001","38","48181211"
"JH378212","3083061","3083359","chr7","59813439","59813734","48","56730378"
"JH378212","4577902","4578194","chr6","15375419","15375710","40","10797517"
"JH378212","4671977","4672110","chr14","45335131","45335263","18","40663154"
"JH378212","4769177","4769441","chr14","61597585","61597855","41","56828408"
"JH378212","5540592","5540889","chr20","110642932","110643228","36","105102340"
"JH378212","5650169","5650460","chr29","9188440","9188729","41","3538271"
"JH378213","73131","73295","chr18","62022139","62022304","25","61949008"
"JH378213","200664","200957","chr19","27584635","27584934","43","27383971"
"JH378213","1256302","1256598","chr3","160895","161193","39","1095407"
"JH378213","1430748","1431044","chr5","34149578","34149877","51","32718830"
"JH378213","1529588","1529858","chr3","64952340","64952627","57","63422752"
"JH378213","1656022","1656325","chr8","121880813","121881121","50","120224791"
"JH378213","1909741","1910015","chr3","36294282","36294553","46","34384541"
"JH378213","2212197","2212464","chr9","17604750","17605020","58","15392553"
"JH378213","2225846","2225967","chr25","28864990","28865114","20","26639144"
"JH378213","2232154","2232436","chr14","61597585","61597855","57","59365431"
"JH378213","2733526","2733706","chr26","40178880","40179052","33","37445354"
"JH378213","2922497","2922787","chr20","2854395","2854680","37","68102"
"JH378213","3079770","3080031","chr26","38595395","38595663","44","35515625"
"JH378213","3098912","3099143","chr15","49088342","49088573","41","45989430"
"JH378213","3278954","3279252","chrX","33027186","33027484","41","29748232"
"JH378213","3501886","3502183","chr12","25210001","25210293","44","21708115"
"JH378213","3516401","3516512","chr6","29480212","29480322","19","25963811"
"JH378213","3715854","3716161","chr5","32677022","32677328","41","28961168"
"JH378213","3791833","3792002","chr7","57464491","57464651","49","53672658"
"JH378213","3873994","3874151","chr27","1495726","1495880","34","2378268"
"JH378213","4017678","4017951","chr28","13713786","13714063","47","9696108"
"JH378213","4654639","4654909","chr14","61597585","61597855","40","56942946"
"JH378213","5300575","5300845","chr24","20020356","20020608","80","14719781"
"JH378213","5408472","5408640","chr9","122729670","122729833","35","117321198"
"JH378213","5532960","5533186","chr28","13453464","13453689","36","7920504"
"JH378213","5588651","5588699","chr6","17749126","17749175","7","12160475"
"JH378213","5603267","5603569","chrX","60403420","60403723","44","54800153"
"JH378213","5789663","5789958","chr12","103186024","103186315","46","97396361"
"JH378213","5870130","5870347","chr5","12500001","12500225","45","6629871"
"JH378213","5913372","5913674","chr4","74750244","74750542","39","68836872"
"JH378213","6446749","6447055","chrX","60403420","60403723","41","53956671"
"JH378213","6544458","6544605","chr16","69077847","69078004","38","62533389"
"JH378213","6606248","6606546","chr5","14139090","14139392","42","7532842"
"JH378213","6733637","6733941","chr3","30187575","30187872","49","23453938"
"JH378213","7093217","7093502","chr12","39125555","39125840","41","32032338"
"JH378213","7181778","7182006","chr9","57732450","57732667","39","50550672"
"JH378214","196633","196914","chr11","106903918","106904206","48","106707285"
"JH378214","388567","388873","chr12","86891380","86891688","57","86502813"
"JH378214","615434","615723","chr7","57344542","57344818","53","56729108"
"JH378214","755498","755622","chr29","17121091","17121216","21","16365593"
"JH378214","2073699","2073980","chr13","86323276","86323561","29","84249577"
"JH378214","2674751","2675034","chr16","58327777","58328064","44","55653026"
"JH378214","3216637","3216935","chr4","74750244","74750542","41","71533607"
"JH378214","3438366","3438659","chrX","6571847","6572139","35","3133481"
"JH378214","3949734","3949983","chr10","127587035","127587285","53","123637301"
"JH378214","4141640","4141855","chrX","124509631","124509844","48","120367991"
"JH378214","5263358","5263654","chr24","27110583","27110876","43","21847225"
"JH378214","5654531","5654824","chr11","90535443","90535733","40","84880912"
"JH378214","6525354","6525648","chr1","108300659","108300949","54","101775305"
"JH378214","6553640","6553864","chr25","19270221","19270449","56","12716581"
"JH378214","6584857","6584981","chr28","16241085","16241207","22","9656228"
"JH378214","6813508","6813789","chr11","42708500","42708788","46","35894992"
"JH378214","7061871","7062178","chr20","104985298","104985598","44","97923427"
"JH378215","31186","31472","chr8","43709944","43710222","61","43678758"
"JH378215","873371","873467","chr21","73735740","73735834","26","72862369"
"JH378215","1206191","1206499","chr12","72899340","72899646","39","71693149"
"JH378215","1683117","1683336","chr23","79650541","79650766","47","77967424"
"JH378215","2336687","2336727","chr1","123915771","123915811","5","121579084"
"JH378215","2679552","2679854","chr18","45579140","45579432","61","42899588"
"JH378215","2982658","2982875","chr15","21276418","21276632","67","18293760"
"JH378215","3270461","3270800","chr20","119136193","119136516","55","115865732"
"JH378215","5358714","5359012","chr6","6166086","6166377","43","807372"
"JH378215","6067210","6067428","chr15","78928706","78928925","43","72861496"
"JH378216","114148","114412","chr10","35699443","35699712","52","35585295"
"JH378216","194381","194680","chr19","4455651","4455943","56","4261270"
"JH378216","415815","415999","chr20","70868860","70869044","25","70453045"
"JH378216","471781","472060","chr2","60044452","60044731","35","59572671"
"JH378216","553161","553455","chr19","4455651","4455943","35","3902490"
"JH378216","563132","563428","chr28","13645418","13645720","45","13082286"
"JH378216","627776","628053","chr14","53650197","53650475","51","53022421"
"JH378216","907799","907965","chr5","69599282","69599452","29","68691483"
"JH378216","968605","968678","chr24","66368253","66368315","16","65399648"
"JH378216","992808","993116","chr15","2000778","2001083","42","1007970"
"JH378216","1280341","1280597","chr14","75250425","75250685","42","73970084"
"JH378216","1500924","1501159","chr20","107997025","107997264","28","106496101"
"JH378216","1557242","1557533","chr4","74750244","74750542","47","73193002"
"JH378216","1636554","1636848","chr6","21576313","21576617","46","19939759"
"JH378216","1880815","1880941","chr2","4976621","4976741","24","3095806"
"JH378216","2012404","2012582","chr19","16893479","16893663","38","14881075"
"JH378216","2073685","2073968","chr14","51174162","51174453","44","49100477"
"JH378216","2175213","2175525","chr10","115019004","115019300","50","112843791"
"JH378216","2176066","2176316","chr14","33993071","33993339","58","31817005"
"JH378216","2372216","2372518","chr10","53802403","53802702","45","51430187"
"JH378216","2917731","2918003","chr11","47946756","47947023","25","45029025"
"JH378216","2959306","2959589","chr9","97265638","97265929","48","94306332"
"JH378216","3085846","3086104","chr16","13075121","13075385","53","9989275"
"JH378216","3219650","3219908","chr2","66937766","66938027","40","63718116"
"JH378216","3918991","3919296","chr24","27110583","27110876","54","23191592"
"JH378216","3999099","3999409","chr12","9898617","9898926","50","5899518"
"JH378216","4097441","4097739","chr20","104653040","104653338","37","100555599"
"JH378216","4160223","4160512","chr4","36472091","36472381","38","32311868"
"JH378216","4566983","4567089","chr1","8926569","8926682","21","4359586"
"JH378216","5179170","5179463","chr10","104330612","104330907","37","99151442"
"JH378216","5252279","5252584","chrX","61756996","61757299","41","56504717"
"JH378216","5344170","5344453","chr10","89968309","89968588","67","84624139"
"JH378216","5353828","5354128","chr26","26868700","26868994","53","21514872"
"JH378216","6367902","6368146","chr1","122078820","122079044","63","115710918"
"JH378216","7105164","7105469","chr27","40239547","40239855","37","33134383"
"JH378216","7153021","7153325","chr23","76307669","76307973","42","69154648"
"JH378216","7193490","7193787","chr6","50023972","50024262","49","42830482"
"JH378217","124289","124578","chr13","86323276","86323561","55","86198987"
"JH378217","2332200","2332493","chr1","9360845","9361141","37","7028645"
"JH378217","2405242","2405567","chr12","21984962","21985274","78","19579720"
"JH378217","4615237","4615394","chr2","37782743","37782903","37","33167506"
"JH378217","4857274","4857566","chr20","97098637","97098929","36","92241363"
"JH378217","4904000","4904296","chr4","63292257","63292566","59","58388257"
"JH378217","5362593","5362878","chr9","119662466","119662760","46","114299873"
"JH378217","5658058","5658341","chr12","103186024","103186315","42","97527966"
"JH378217","6727813","6728112","chr10","56765965","56766265","47","50038152"
"JH378217","7116777","7117076","chr4","74750244","74750542","43","67633467"
"JH378218","64202","64509","chr23","77806185","77806493","47","77741983"
"JH378218","180049","180350","chrX","29670774","29671076","48","29490725"
"JH378218","450548","450854","chr12","41019638","41019945","48","40569090"
"JH378218","2713317","2713596","chr23","37087327","37087607","48","34374010"
"JH378218","5941779","5942073","chr12","18358405","18358704","46","12416626"
"JH378218","7048369","7048487","chr2","87262500","87262610","21","80214131"
"JH378219","5766896","5767201","chr14","61597253","61597561","47","55830357"
"JH378219","362385","362692","chrX","60403420","60403723","50","60041035"
"JH378219","1970660","1970935","chr1","4366395","4366679","48","2395735"
"JH378219","2334316","2334620","chr7","42923647","42923938","58","40589331"
"JH378219","2446907","2447077","chr1","99228374","99228543","34","96781467"
"JH378219","2766456","2766626","chr19","11544687","11544855","30","8778231"
"JH378219","2781042","2781344","chr11","9736123","9736423","35","6955081"
"JH378219","2825344","2825640","chr2_KE147940v1_random","21204","21502","33","2804140"
"JH378219","3011221","3011516","chr16","18257374","18257671","39","15246153"
"JH378219","3011521","3011832","chr19","22626676","22626983","51","19615155"
"JH378219","3864382","3864658","chr18","56777325","56777608","44","52912943"
"JH378219","4167524","4167818","chr11","112865767","112866066","43","108698243"
"JH378219","5052251","5052406","chr22","31386790","31386954","37","26334539"
"JH378219","5974032","5974221","chr18","47444253","47444436","35","41470221"
"JH378219","6029777","6029897","chr2","4976621","4976741","20","1053156"
"JH378219","6082039","6082337","chr16","18257374","18257671","39","12175335"
"JH378219","6159628","6159922","chr20","125041520","125041815","41","118881892"
"JH378219","6175606","6175678","chr2","90007462","90007528","19","83831856"
"JH378220","39066","39362","chr16","70729210","70729502","46","70690144"
"JH378220","49296","49411","chr10","110800532","110800647","15","110751236"
"JH378220","768066","768366","chrX","33027186","33027484","36","32259120"
"JH378220","1001872","1002174","chr11","112865767","112866066","37","111863895"
"JH378220","1015176","1015470","chr12","12357674","12357969","46","11342498"
"JH378220","1230091","1230372","chrX","66837968","66838254","39","65607877"
"JH378220","1291909","1292188","chr9","29459013","29459303","52","28167104"
"JH378220","1425061","1425295","chr11","52400982","52401220","37","50975921"
"JH378220","2362753","2363065","chr12","41019638","41019945","40","38656885"
"JH378220","2681742","2682063","chr16","36007753","36008062","46","33326011"
"JH378220","2759005","2759304","chr4","74750244","74750542","44","71991239"
"JH378220","2787542","2787830","chr8","76684830","76685120","36","73897288"
"JH378220","3009635","3009917","chr12","13143084","13143366","54","10133449"
"JH378220","3331689","3331841","chr11","6506714","6506863","29","3175025"
"JH378220","3351680","3351957","chr8","138385912","138386190","46","135034232"
"JH378220","3461307","3461615","chrX","61756996","61757299","43","58295689"
"JH378220","3508909","3509104","chr28","16496490","16496672","53","12987581"
"JH378220","3509128","3509177","chr22","74065325","74065376","17","70556197"
"JH378220","3509648","3509735","chr19","20678473","20678556","25","17168825"
"JH378220","3739277","3739577","chr22","67435237","67435541","45","63695960"
"JH378220","3867735","3868025","chr10","41444706","41445000","39","37576971"
"JH378220","4112261","4112548","chr18","63833457","63833758","43","59721196"
"JH378220","4195502","4195783","chr11","42101160","42101440","44","37905658"
"JH378220","4402185","4402484","chr12","18358405","18358704","41","13956220"
"JH378220","4484952","4485238","chr3","19437037","19437326","41","14952085"
"JH378220","4552907","4553074","chr8","92570169","92570339","39","88017262"
"JH378220","4804814","4804948","chr16","71843572","71843697","25","67038758"
"JH378220","4913417","4913671","chr23","29726953","29727218","55","24813536"
"JH378220","4921253","4921557","chrX","6571847","6572139","50","1650594"
"JH378220","5592488","5592798","chr6","37574407","37574720","43","31981919"
"JH378220","6299470","6299767","chr1","29621888","29622188","39","23322418"
"JH378220","6331117","6331407","chr2_KE147940v1_random","21204","21502","49","6309913"
"JH378221","50804","51092","chr3","64952340","64952627","47","64901536"
"JH378221","138969","139182","chr8","51214368","51214580","44","51075399"
"JH378221","411006","411315","chr11","111219175","111219476","44","110808169"
"JH378221","920355","920659","chr28","12166824","12167128","41","11246469"
"JH378221","1318337","1318646","chr23","12799637","12799937","51","11481300"
"JH378221","1845060","1845385","chr15","74678009","74678326","59","72832949"
"JH378221","2407939","2408247","chr9","114704023","114704332","42","112296084"
"JH378221","3193656","3193956","chr11","91887378","91887674","43","88693722"
"JH378221","3527616","3527915","chr14","63187388","63187693","47","59659772"
"JH378221","4246103","4246390","chr9","78073476","78073771","38","73827373"
"JH378221","4423261","4423542","chr26","13844204","13844483","52","9420943"
"JH378221","6404429","6404487","chr13","7060006","7060057","12","655577"
"JH378222","442169","442459","chr24","42824289","42824580","46","42382120"
"JH378222","1012799","1013109","chr9","56706151","56706456","45","55693352"
"JH378222","1182241","1182531","chr18","71127519","71127809","39","69945278"
"JH378222","4441946","4442037","chr14","44953493","44953595","30","40511547"
"JH378222","4474775","4475076","chr2","61035797","61036096","39","56561022"
"JH378222","5177461","5177760","chr23","45383243","45383541","39","40205782"
"JH378222","5779663","5779959","chr23","76077886","76078182","33","70298223"
"JH378222","5924748","5924988","chr14","10326097","10326351","70","4401349"
"JH378222","6636355","6636575","chr1","122078820","122079044","46","115442465"
"JH378223","232515","232734","chr8","120238157","120238376","46","120005642"
"JH378223","992597","992903","chr4","31811484","31811787","45","30818887"
"JH378223","1873396","1873700","chr25","27839006","27839308","47","25965610"
"JH378223","2590926","2591064","chr20","105715190","105715330","20","103124264"
"JH378223","4588436","4588718","chr28","8917006","8917294","52","4328570"
"JH378223","4613861","4614163","chr24","26360086","26360391","49","21746225"
"JH378223","4846193","4846502","chr10","39012436","39012740","32","34166243"
"JH378223","4871519","4871789","chr5","26714462","26714737","52","21842943"
"JH378223","4965599","4965895","chrX","33027186","33027484","42","28061587"
"JH378223","4977484","4977764","chr8","36493015","36493296","56","31515531"
"JH378223","5254070","5254166","chr14","68059462","68059545","28","62805392"
"JH378223","5881371","5881659","chr24","40072459","40072748","46","34191088"
"JH378223","6141878","6142175","chrX","33027186","33027484","39","26885308"
"JH378223","6168049","6168346","chr9","44637205","44637501","41","38469156"
"JH378223","6200657","6200853","chr16","9005892","9006101","43","2805235"
"JH378223","6421170","6421479","chr3","550166","550467","58","5871004"
"JH378223","6544986","6545183","chr10","88746680","88746875","30","82201694"
"JH378223","6672977","6673276","chr3","25784267","25784567","42","19111290"
"JH378224","1310558","1310730","chr7","15251330","15251507","37","13940772"
"JH378224","601132","601312","chr21","18967230","18967419","43","18366098"
"JH378224","979188","979441","chr21","124764715","124764961","41","123785527"
"JH378224","991080","991131","chr13","8915789","8915834","16","7924709"
"JH378224","2115336","2115628","chr9","12200560","12200854","52","10085224"
"JH378224","2182852","2183149","chr11","47267698","47267990","42","45084846"
"JH378224","2249912","2250032","chr6","33839130","33839249","15","31589218"
"JH378224","2474596","2474917","chr12","86891380","86891688","61","84416784"
"JH378224","2585182","2585472","chrX","107405185","107405479","37","104820003"
"JH378224","2707228","2707526","chr10","44221705","44222014","59","41514477"
"JH378224","2754940","2755238","chr18","56511205","56511496","66","53756265"
"JH378224","3071579","3071873","chr20","105708807","105709105","42","102637228"
"JH378224","3257067","3257329","chr26","8970369","8970646","53","5713302"
"JH378224","3514806","3515107","chrX","18575272","18575575","30","15060466"
"JH378224","3584995","3585197","chr7","26338472","26338675","44","22753477"
"JH378224","3627500","3627626","chr7","86286493","86286622","18","82658993"
"JH378224","3701285","3701583","chr19","27584635","27584934","48","23883350"
"JH378224","3961235","3961531","chr11","90535443","90535733","41","86574208"
"JH378224","3998227","3998414","chrX","238563","238744","29","3759664"
"JH378224","4232680","4232991","chr1","125024996","125025302","48","120792316"
"JH378224","4575185","4575318","chr20","106252780","106252912","14","101677595"
"JH378224","4576067","4576375","chr22","67435237","67435541","56","62859170"
"JH378224","5047491","5047788","chr25","50668923","50669216","49","45621432"
"JH378224","5243086","5243382","chr20","104985298","104985598","42","99742212"
"JH378224","5615579","5615844","chr8","94532373","94532636","43","88916794"
"JH378224","5661032","5661319","chr22","11362456","11362743","42","5701424"
"JH378224","5718090","5718384","chr10","104330612","104330907","41","98612522"
"JH378224","6296765","6297068","chr19","17666137","17666438","45","11369372"
"JH378224","6557460","6557688","chr7","57513437","57513664","33","50955977"
"JH378225","76336","76623","chr23","80642893","80643191","46","80566557"
"JH378225","193361","193634","chr9","18313882","18314160","49","18120521"
"JH378225","452011","452340","chr6","47032560","47032866","89","46580549"
"JH378225","494672","494990","chr2","33362197","33362503","50","32867525"
"JH378225","907448","907733","chrX","17716344","17716633","37","16808896"
"JH378225","999518","999747","chr17","6642467","6642719","77","5642949"
"JH378225","1236652","1236709","chr24","77600312","77600370","8","76363660"
"JH378225","1250078","1250350","chr13","46226128","46226400","50","44976050"
"JH378225","1454200","1454504","chr6","10613040","10613338","41","9158840"
"JH378225","1522397","1522652","chr5","43989885","43990146","67","42467488"
"JH378225","1551004","1551297","chr12","82648127","82648418","40","81097123"
"JH378225","2616529","2616738","chr14","74021868","74022082","44","71405339"
"JH378225","3077181","3077328","chr9","32125196","32125331","61","29048015"
"JH378225","4168650","4168944","chr19","1544623","1544917","43","2624027"
"JH378225","4322540","4322829","chr11","42708500","42708788","42","38385960"
"JH378225","4519610","4519890","chr7","55740326","55740609","48","51220716"
"JH378225","5499668","5499869","chr14","44892179","44892372","36","39392511"
"JH378225","5587621","5587893","chr9","59423774","59424053","47","53836153"
"JH378225","5655720","5656015","chr4","74750244","74750542","44","69094524"
"JH378225","5716292","5716591","chr16","66139074","66139369","45","60422782"
"JH378225","5724998","5725123","chr5","2033212","2033345","20","3691786"
"JH378225","6142088","6142381","chr9","28285762","28286057","46","22143674"
"JH378225","6263885","6264174","chr27","5957641","5957923","39","306244"
"JH378225","6474038","6474331","chr2","56439278","56439567","43","49965240"
"JH378226","278633","278877","chr3","54097857","54098084","55","53819224"
"JH378226","1702680","1702973","chr1","98960303","98960603","41","97257623"
"JH378226","1740449","1740749","chr18","26717615","26717912","36","24977166"
"JH378226","1892143","1892440","chr14","68359125","68359423","40","66466982"
"JH378226","3373716","3374015","chr1","112929344","112929645","43","109555628"
"JH378226","3992246","3992535","chr2","6803049","6803335","48","2810803"
"JH378226","5431635","5431943","chr20","7876234","7876541","49","2444599"
"JH378226","6241714","6241941","chr9","57732450","57732667","39","51490736"
"JH378227","60890","61166","chr19","16574920","16575197","37","16514030"
"JH378227","119580","119874","chr4","74750244","74750542","41","74630664"
"JH378227","523857","524079","chr8","120238157","120238376","40","119714300"
"JH378227","567229","567420","chr20","113342426","113342612","43","112775197"
"JH378227","922230","922355","chrX","77324374","77324510","29","76402144"
"JH378227","966984","967262","chr3","6781605","6781888","44","5814621"
"JH378227","994905","995197","chrX","89680401","89680694","40","88685496"
"JH378227","1282787","1283089","chr9","114669635","114669933","40","113386848"
"JH378227","1911418","1911560","chr15","51773180","51773322","24","49861762"
"JH378227","2154460","2154757","chr26","26868700","26868994","36","24714240"
"JH378227","2248590","2248902","chr20","7876234","7876541","38","5627644"
"JH378227","2623748","2623954","chr2","25630213","25630417","30","23006465"
"JH378227","2706042","2706347","chr9","57444017","57444321","41","54737975"
"JH378227","2987369","2987654","chr10","94012577","94012864","42","91025208"
"JH378227","2992481","2992780","chr26","18794536","18794836","38","15802055"
"JH378227","3601975","3602256","chr20","2854395","2854680","34","747580"
"JH378227","4881050","4881340","chrX","46213593","46213878","43","41332543"
"JH378227","5747792","5747847","chr13","55236222","55236271","12","49488430"
"JH378227","5818121","5818434","chr11","116558393","116558699","44","110740272"
"JH378228","261936","262227","chr1","67566937","67567228","49","67305001"
"JH378228","440060","440372","chr7","24831990","24832293","46","24391930"
"JH378228","966140","966260","chr21","105814695","105814817","25","104848555"
"JH378228","1273917","1274213","chr13","86923785","86924086","42","85649868"
"JH378228","1911743","1911936","chr2","74004467","74004653","35","72092724"
"JH378228","3871035","3871310","chr17","47805481","47805753","54","43934446"
"JH378228","5160432","5160720","chr11","42708500","42708788","42","37548068"
"JH378228","5354908","5355035","chr5","2033212","2033345","25","3321696"
"JH378228","5423538","5423819","chr2","5238241","5238519","39","185297"
"JH378228","5445147","5445449","chr9","53392827","53393126","42","47947680"
"JH378228","5460206","5460462","chr25","50135597","50135848","47","44675391"
"JH378228","5460996","5461040","chr26","37713050","37713081","15","32252054"
"JH378228","5682625","5682910","chr20","19842108","19842392","49","14159483"
"JH378229","2717052","2717322","chr14","61597585","61597855","37","58880533"
"JH378229","4044215","4044338","chr13","93936933","93937062","20","89892718"
"JH378229","4182671","4182951","chr4","71160137","71160418","45","66977466"
"JH378229","4525728","4526030","chr26","18794536","18794836","41","14268808"
"JH378229","4590105","4590312","chr16","9005892","9006101","32","4415787"
"JH378230","433950","434180","chr18","68668421","68668651","41","68234471"
"JH378230","472001","472268","chr25","85169491","85169762","42","84697490"
"JH378230","1068010","1068294","chr14","7740969","7741247","47","6672959"
"JH378230","1431135","1431408","chr14","61597585","61597855","58","60166450"
"JH378230","1690347","1690628","chr7","107239053","107239342","69","105548706"
"JH378230","1769610","1769905","chr13","38703830","38704121","52","36934220"
"JH378230","2374691","2375012","chr27","33864159","33864484","58","31489468"
"JH378230","3677987","3678273","chr20","97928139","97928435","52","94250152"
"JH378230","4526107","4526410","chr2","22860155","22860456","51","18334048"
"JH378230","4735259","4735509","chr18","6024340","6024599","61","1289081"
"JH378230","5718451","5718759","chr10","44221705","44222014","53","38503254"
"JH378230","5947401","5947640","chr2","65988272","65988503","48","60040871"
"JH378231","1794004","1794308","chr12","3898076","3898379","38","2104072"
"JH378231","2188316","2188608","chr1","67566937","67567228","37","65378621"
"JH378231","2206341","2206531","chr1","20346354","20346557","53","18140013"
"JH378231","2240732","2241041","chr16","57032948","57033254","55","54792216"
"JH378231","2276851","2276995","chr21","54066983","54067128","25","51790132"
"JH378231","2323121","2323397","chr9","58155888","58156167","39","55832767"
"JH378231","2506615","2506899","chr23","37087327","37087607","46","34580712"
"JH378231","2757863","2758170","chr12","95743369","95743669","56","92985506"
"JH378231","3192631","3192906","chr14","89802144","89802429","47","86609513"
"JH378231","3203367","3203667","chr23","57612824","57613126","43","54409457"
"JH378231","3740629","3740857","chrUn_KE147540v1","154518","154749","36","3586111"
"JH378231","4301851","4302134","chr13","86323276","86323561","41","82021425"
"JH378231","4498327","4498603","chr9","18313882","18314160","43","13815555"
"JH378231","5136649","5136928","chr7","27620996","27621280","54","22484347"
"JH378231","6176907","6177201","chr12","41019638","41019945","53","34842731"
"JH378232","653108","653242","chr27","46451202","46451337","22","45798094"
"JH378232","740557","740839","chr11","42101160","42101440","31","41360603"
"JH378232","863184","863485","chr16","4472870","4473177","50","3609686"
"JH378232","970277","970564","chr21","76462253","76462539","54","75491976"
"JH378232","977369","977652","chr13","64951567","64951860","59","63974198"
"JH378232","1135694","1135857","chr9","85157244","85157394","37","84021550"
"JH378232","1357227","1357399","chr11","111452777","111452942","40","110095550"
"JH378232","1827212","1827433","chr21","125373692","125373921","42","123546480"
"JH378232","1831995","1832272","chr16","63994911","63995193","44","62162916"
"JH378232","1875408","1875701","chrX","47726776","47727071","33","45851368"
"JH378232","2316977","2317269","chr5","53126639","53126932","43","50809662"
"JH378232","2523114","2523245","chr13","80405244","80405376","21","77882130"
"JH378232","3194811","3195056","chr9","86755766","86756000","41","83560955"
"JH378232","3249614","3249911","chr4","74750244","74750542","39","71500630"
"JH378232","3344619","3344904","chr7","55740326","55740609","35","52395707"
"JH378232","3483469","3483770","chr25","19956609","19956908","47","16473140"
"JH378232","3854809","3854921","chr2","63172174","63172281","29","59317365"
"JH378232","3924848","3925117","chr9","17334979","17335249","58","13410131"
"JH378232","4228649","4228947","chr13","90749493","90749789","47","86520844"
"JH378232","4281672","4281964","chr6","32338202","32338477","46","28056530"
"JH378232","4381733","4382017","chr12","31899150","31899427","49","27517417"
"JH378232","4401133","4401254","chr6","33578769","33578895","29","29177636"
"JH378232","4500835","4501110","chr3","4648816","4649103","53","147981"
"JH378232","4590855","4591124","chr25","54386032","54386295","53","49795177"
"JH378232","4625224","4625546","chr8","22789986","22790291","44","18164762"
"JH378232","4823671","4823788","chr6","50805503","50805627","23","45981832"
"JH378232","5018821","5019121","chr4","74750244","74750542","40","69731423"
"JH378232","5494906","5495075","chr6","40853500","40853668","30","35358594"
"JH378232","5495474","5495577","chr6","11844044","11844146","16","6348570"
"JH378232","5785890","5786021","chr4","90460665","90460796","25","84674775"
"JH378232","5804813","5804954","chr21","99460334","99460473","23","93655521"
"JH378233","260616","260907","chr15","8473619","8473907","62","8213003"
"JH378233","317864","318155","chr25","27453211","27453490","45","27135347"
"JH378233","356332","356640","chr4","75730761","75731061","51","75374429"
"JH378233","441020","441308","chrX","89680401","89680694","40","89239381"
"JH378233","972339","972623","chr4","19815227","19815505","68","18842888"
"JH378233","1271447","1271686","chr6","11215683","11215935","58","9944236"
"JH378233","2333061","2333356","chr21","23798419","23798714","49","21465358"
"JH378233","2370481","2370783","chr14","99085390","99085687","44","96714909"
"JH378233","3137952","3138231","chr10","85456712","85457001","59","82318760"
"JH378233","5326481","5326787","chr29","3711047","3711343","39","1615434"
"JH378233","5344329","5344568","chr7","57513437","57513664","62","52169108"
"JH378233","5547854","5548150","chr6","31992433","31992727","78","26444579"
"JH378233","5989507","5989790","chr9","96272747","96273028","43","90283240"
"JH378234","827606","827924","chr1","68581324","68581621","51","67753718"
"JH378234","1272137","1272420","chr2","58132919","58133197","55","56860782"
"JH378234","1285324","1285628","chr5","8635602","8635904","37","7350278"
"JH378234","2589378","2589669","chr24","42511128","42511419","45","39921750"
"JH378234","3193951","3194215","chr10","63585093","63585357","32","60391142"
"JH378234","3810768","3811048","chr9","99714018","99714298","43","95903250"
"JH378234","5896854","5897150","chr19","27584635","27584934","43","21687781"
"JH378234","5937526","5937759","chr5","75072071","75072324","57","69134545"
"JH378234","6073468","6073762","chrX","38077262","38077554","36","32003794"
"JH378235","3538900","3539074","chr22","74857230","74857409","36","71318330"
"JH378235","77060","77358","chr11","83560875","83561170","40","83483815"
"JH378235","109050","109079","chr19","20678144","20678174","6","20569094"
"JH378235","115407","115436","chr19","20678144","20678174","6","20562737"
"JH378235","186291","186596","chr11","47411625","47411934","38","47225334"
"JH378235","355972","356273","chr2","47485248","47485546","45","47129276"
"JH378235","379448","379730","chr5","72051782","72052054","43","71672334"
"JH378235","493511","493816","chrX","105348076","105348380","36","104854565"
"JH378235","668532","668698","chr24","76523592","76523762","32","75855060"
"JH378235","978440","978597","chrX","45517967","45518126","30","44539527"
"JH378235","1147426","1147712","chr17","60953943","60954243","49","59806517"
"JH378235","1224624","1224915","chr28","15327544","15327835","41","14102920"
"JH378235","1243917","1244223","chr16","6272773","6273062","54","5028856"
"JH378235","1412257","1412551","chr14","79684474","79684770","38","78272217"
"JH378235","2208036","2208304","chr23","82158504","82158780","46","79950468"
"JH378235","2405493","2405773","chr11","62921553","62921824","45","60516060"
"JH378235","3334201","3334513","chr10","92839454","92839761","49","89505253"
"JH378235","3696232","3696541","chr7","14220558","14220867","47","10524326"
"JH378235","3748099","3748336","chr26","37830957","37831211","55","34082858"
"JH378235","3786339","3786643","chr15","2000778","2001083","39","1785561"
"JH378235","4006603","4006887","chr29","10632045","10632335","46","6625442"
"JH378235","4021834","4022114","chr25","17601824","17602097","45","13579990"
"JH378235","4290286","4290590","chr12","72899340","72899646","38","68609054"
"JH378235","4379286","4379503","chr7","97741073","97741285","36","93361787"
"JH378235","4741506","4741797","chr2","38953517","38953810","38","34212011"
"JH378235","5111096","5111268","chr2","36086667","36086826","39","30975571"
"JH378235","5776368","5776673","chr2","33362197","33362503","37","27585829"
"JH378235","6020111","6020394","chr11","42101160","42101440","39","36081049"
"JH378236","174762","174902","chr15","19716277","19716418","27","19541515"
"JH378236","316797","317072","chr3","25922879","25923130","70","25606082"
"JH378236","339909","340201","chr1","20836893","20837193","50","20496984"
"JH378236","473775","474046","chr18","55842191","55842463","47","55368416"
"JH378236","1623805","1624104","chr13","38731809","38732113","46","37108004"
"JH378236","1795411","1795518","chr22","13989142","13989247","18","12193731"
"JH378236","1829419","1829712","chrX","6571847","6572139","37","4742428"
"JH378236","2126444","2126717","chr1","29294849","29295125","35","27168405"
"JH378236","2151219","2151488","chr12","72756184","72756452","55","70604965"
"JH378236","2194372","2194677","chr1","29712863","29713163","43","27518491"
"JH378236","2230096","2230333","chr9","86755766","86756000","33","84525670"
"JH378236","2258247","2258542","chr10","104330612","104330907","47","102072365"
"JH378236","2349732","2350056","chr19","22626676","22626983","45","20276944"
"JH378236","2355682","2355980","chr16","44211282","44211580","40","41855600"
"JH378236","2779959","2780072","chr9","3918407","3918523","22","1138448"
"JH378236","4169797","4170107","chr17","40106599","40106905","53","35936802"
"JH378236","4215383","4215559","chr3","91778271","91778445","27","87562888"
"JH378237","3877","3995","chr16","60312871","60312984","23","60308994"
"JH378237","39597","39716","chrUn_AQIB01158800v1","1","125","25","39596"
"JH378237","64982","65284","chr19","32620355","32620659","38","32555373"
"JH378237","331873","332099","chr5","3148405","3148630","47","2816532"
"JH378237","526153","526462","chr18","65492271","65492578","39","64966118"
"JH378237","1668809","1669095","chr23","6539800","6540082","47","4870991"
"JH378237","2109185","2109476","chr4","36472091","36472381","54","34362906"
"JH378237","2177670","2177953","chr9","58155888","58156167","51","55978218"
"JH378237","2402723","2402798","chr13","17633109","17633178","23","15230386"
"JH378237","3130980","3131267","chr16","32482378","32482667","43","29351398"
"JH378237","3876097","3876374","chr2","47509921","47510201","42","43633824"
"JH378237","4418270","4418556","chr22","11362456","11362743","39","6944186"
"JH378237","5353969","5354106","chrUn_KE147584v1","22429","22564","26","5331540"
"JH378238","711551","711813","chr7","129912785","129913051","47","129201234"
"JH378238","1315374","1315669","chr17","22605049","22605342","41","21289675"
"JH378238","2063169","2063459","chr10","2202474","2202766","40","139305"
"JH378238","2512037","2512327","chr6","13075381","13075667","47","10563344"
"JH378238","2834597","2834864","chr11","9923400","9923670","64","7088803"
"JH378238","3403980","3404129","chr17","61823129","61823273","29","58419149"
"JH378238","4045933","4046244","chr1","40186193","40186501","35","36140260"
"JH378238","4435524","4435789","chr23","16346527","16346792","46","11911003"
"JH378238","4467492","4467777","chr20","106542786","106543068","55","102075294"
"JH378238","4488552","4488845","chrX","17670935","17671231","39","13182383"
"JH378238","4533384","4533684","chr10","41444706","41445000","36","36911322"
"JH378238","4599425","4599629","chr7","26338472","26338675","36","21739047"
"JH378238","4599897","4599980","chr7","27620515","27620606","20","23020618"
"JH378238","5190257","5190562","chr9","36981551","36981851","39","31791294"
"JH378238","5254310","5254593","chr3","76758914","76759196","38","71504604"
"JH378239","543034","543326","chr14","885388","885684","41","342354"
"JH378239","749671","749937","chr18","2725758","2726046","51","1976087"
"JH378239","909507","909797","chr20","116629660","116629953","43","115720153"
"JH378239","1121316","1121435","chr8","88261673","88261783","21","87140357"
"JH378239","1150150","1150425","chr11","42708500","42708788","41","41558350"
"JH378239","1432473","1432755","chr12","80513942","80514219","43","79081469"
"JH378239","3439510","3439826","chr9","38031843","38032141","47","34592333"
"JH378239","4138130","4138433","chr9","114693205","114693503","50","110555075"
"JH378239","4466619","4466919","chr9","45167813","45168121","46","40701194"
"JH378239","5327756","5327809","chr24","51584132","51584183","11","46256376"
"JH378240","526152","526447","chr16","34559933","34560229","59","34033781"
"JH378240","1492123","1492419","chr2","23799581","23799880","41","22307458"
"JH378240","1593913","1594221","chr2","54312462","54312771","33","52718549"
"JH378240","2986962","2987243","chr28","15327544","15327835","48","12340582"
"JH378240","5493225","5493482","chr11","31189578","31189838","78","25696353"
"JH378240","5521816","5521859","chr13","8915789","8915834","10","3393973"
"JH378241","1004339","1004629","chr18","48374388","48374692","57","47370049"
"JH378241","1036466","1036723","chr14","45516246","45516500","50","44479780"
"JH378241","1522758","1523094","chr20","99741211","99741546","52","98218453"
"JH378241","1680567","1680764","chr13","96152783","96152983","36","94472216"
"JH378241","4550121","4550441","chrX","10891227","10891532","65","6341106"
"JH378241","4878712","4878921","chr2","13316902","13317112","33","8438190"
"JH378241","4971315","4971557","chr11","52400982","52401220","52","47429667"
"JH378241","5182285","5182571","chr9","17526312","17526604","41","12344027"
"JH378241","5457159","5457438","chr29","9188440","9188729","46","3731281"
"JH378242","503235","503408","chr20","87928737","87928908","42","87425502"
"JH378242","551331","551477","chr9","32125196","32125331","49","31573865"
"JH378242","781480","781776","chr11","83560875","83561170","42","82779395"
"JH378242","882261","882553","chrX","111147394","111147703","56","110265133"
"JH378242","901546","901771","chrX","92178511","92178733","28","91276965"
"JH378242","1259019","1259321","chr16","36007753","36008062","43","34748734"
"JH378242","1414227","1414327","chr23","79882920","79883023","16","78468693"
"JH378242","1750353","1750620","chr20","119275773","119276050","45","117525420"
"JH378242","1857654","1857941","chr28","15448114","15448384","59","13590460"
"JH378242","2171150","2171428","chr11","24876645","24876927","43","22705495"
"JH378242","2748336","2748567","chr20","104477833","104478070","45","101729497"
"JH378242","3531191","3531445","chrX","28441716","28441974","46","24910525"
"JH378242","4023345","4023646","chr1","125024996","125025302","39","121001651"
"JH378243","472975","473105","chr2","4976621","4976741","23","4503646"
"JH378243","836605","836721","chr6","33618456","33618572","24","32781851"
"JH378243","1817391","1817706","chr3","11063125","11063453","55","9245734"
"JH378243","3225528","3225814","chr1","64865119","64865416","48","61639591"
"JH378243","3376021","3376287","chr17","47805481","47805753","55","44429460"
"JH378243","4097844","4098152","chr14","61597253","61597561","36","57499409"
"JH378243","4666792","4667066","chr10","119103850","119104131","38","114437058"
"JH378243","4686155","4686276","chr13","88890694","88890812","17","84204539"
"JH378244","167672","167969","chr16","31785","32089","57","135887"
"JH378244","1303810","1303906","chr14","44990628","44990709","25","43686818"
"JH378244","2162879","2163185","chr1","43486737","43487042","45","41323858"
"JH378244","2248375","2248670","chr28","17632120","17632410","49","15383745"
"JH378244","3432312","3432621","chr20","95938099","95938408","39","92505787"
"JH378244","3867068","3867357","chr20","103935663","103935958","51","100068595"
"JH378244","3967354","3967661","chr11","107469251","107469553","50","103501897"
"JH378244","4208314","4208582","chrX","118182064","118182317","51","113973750"
"JH378244","4326992","4327273","chr3","27839765","27840043","38","23512773"
"JH378244","4676865","4677079","chr14","8408006","8408236","73","3731141"
"JH378244","4677081","4677334","chr18","6024340","6024599","71","1347259"
"JH378245","416233","416542","chr13","385523","385830","38","30710"
"JH378245","450475","450771","chrX","45160626","45160926","41","44710151"
"JH378245","547158","547278","chr2","4976621","4976741","28","4429463"
"JH378245","781055","781249","chr7","131233865","131234062","33","130452810"
"JH378245","915496","915641","chr21","54066983","54067128","28","53151487"
"JH378245","919171","919455","chr1","108300659","108300949","41","107381488"
"JH378245","985000","985274","chr25","18532202","18532481","49","17547202"
"JH378245","1694487","1694648","chr16","68873108","68873261","33","67178621"
"JH378245","2393061","2393352","chr16","15362610","15362905","43","12969549"
"JH378245","2428906","2429066","chr3","91778271","91778445","56","89349365"
"JH378245","2546317","2546528","chr16","34169864","34170075","26","31623547"
"JH378245","2561286","2561581","chr19","27584635","27584934","38","25023349"
"JH378245","2619943","2620229","chr17","51807451","51807736","47","49187508"
"JH378245","2954634","2954775","chr17","61823129","61823273","26","58868495"
"JH378245","3514288","3514591","chr16","350699","351009","48","3163589"
"JH378245","3551292","3551587","chr12","65356809","65357103","41","61805517"
"JH378245","3652971","3653219","chr6","28190603","28190847","45","24537632"
"JH378245","3730305","3730593","chr6","15004939","15005239","50","11274634"
"JH378245","3842600","3842898","chr2","61035797","61036096","45","57193197"
"JH378245","3987313","3987597","chr2","34904629","34904927","43","30917316"
"JH378246","461003","461219","chr24","47558800","47559017","35","47097797"
"JH378246","997205","997508","chr23","80642893","80643191","43","79645688"
"JH378246","1217698","1217982","chr13","67198097","67198382","52","65980399"
"JH378246","1329061","1329351","chr3","84994259","84994563","50","83665198"
"JH378246","2086179","2086448","chr11","31189578","31189838","61","29103399"
"JH378246","2252823","2252998","chr12","43957933","43958104","31","41705110"
"JH378246","3583101","3583416","chr14","61597253","61597561","53","58014152"
"JH378246","4078756","4079049","chr17","48124549","48124857","53","44045793"
"JH378246","4569577","4569845","chr14","33993071","33993339","46","29423494"
"JH378247","193714","193982","chr14","61597585","61597855","39","61403871"
"JH378247","276005","276178","chr24","76523592","76523762","30","76247587"
"JH378247","419601","419855","chr10","55600559","55600818","45","55180958"
"JH378247","726421","726718","chrX","29558025","29558318","42","28831604"
"JH378247","850260","850561","chr4","74750244","74750542","44","73899984"
"JH378247","852088","852210","chr17","30173106","30173243","36","29321018"
"JH378247","1204818","1204961","chr20","86668125","86668264","31","85463307"
"JH378247","1645020","1645317","chr9","78073476","78073771","42","76428456"
"JH378247","1701492","1701669","chrX","100082116","100082286","45","98380624"
"JH378247","2393084","2393385","chrX","37510117","37510417","54","35117033"
"JH378247","2579319","2579627","chr21","13146718","13147023","42","10567399"
"JH378247","3154287","3154579","chrX","47726776","47727071","37","44572489"
"JH378247","3319557","3319856","chr18","63833457","63833758","40","60513900"
"JH378247","3410686","3410919","chrX","92178511","92178733","49","88767825"
"JH378247","3564700","3564841","chr20","86668125","86668264","21","83103425"
"JH378247","3565472","3565759","chr6","6217754","6218043","46","2652282"
"JH378247","3595676","3595937","chr14","75250425","75250685","44","71654749"
"JH378247","3949824","3950096","chr9","6382689","6382978","53","2432865"
"JH378247","3984314","3984619","chr1","113325394","113325698","41","109341080"
"JH378247","4098087","4098393","chr14","12038537","12038844","35","7940450"
"JH378247","4318264","4318494","chr11","123182652","123182885","51","118864388"
"JH378247","4386703","4386982","chr24","40072459","40072748","54","35685756"
"JH378247","4485252","4485555","chr4","31811484","31811787","47","27326232"
"JH378248","361563","361871","chr19","1399966","1400272","44","1038403"
"JH378248","480481","480786","chr13","67664836","67665130","52","67184355"
"JH378248","605302","605569","chr14","88780485","88780747","38","88175183"
"JH378248","666984","667292","chr11","83560875","83561170","45","82893891"
"JH378248","884844","885147","chr12","9982374","9982661","53","9097530"
"JH378248","912704","912991","chr14","97755318","97755609","44","96842614"
"JH378248","1127912","1127959","chr22","74065325","74065376","9","72937413"
"JH378248","1229199","1229499","chr2","61035797","61036096","42","59806598"
"JH378248","1410109","1410339","chr18","9905435","9905663","33","8495326"
"JH378248","1446023","1446243","chr16","15121498","15121716","41","13675475"
"JH378248","2405957","2406176","chr2","65988272","65988503","49","63582315"
"JH378248","2473367","2473657","chr25","50668923","50669216","41","48195556"
"JH378248","2596460","2596746","chr14","2503001","2503287","51","93459"
"JH378248","3133401","3133684","chr15","4986082","4986355","59","1852681"
"JH378248","3277696","3277823","chr2","25020841","25020984","29","21743145"
"JH378248","3472018","3472274","chr21","104210680","104210937","49","100738662"
"JH378248","3653939","3654224","chr23","34060209","34060496","35","30406270"
"JH378248","4451678","4451836","chr9","114689314","114689468","31","110237636"
"JH378249","518549","518857","chr6","18852331","18852633","44","18333782"
"JH378249","1399879","1400139","chr28","8917006","8917294","78","7517127"
"JH378249","1660615","1660745","chr2","4976621","4976741","24","3316006"
"JH378249","1886348","1886581","chr15","49088342","49088573","29","47201994"
"JH378249","2544547","2544824","chr2","23207246","23207530","58","20662699"
"JH378249","2565189","2565474","chr3","32873359","32873648","44","30308170"
"JH378249","2607599","2607841","chr17","24468408","24468643","43","21860809"
"JH378249","2709663","2709956","chr6","35301468","35301762","34","32591805"
"JH378249","3389247","3389541","chr10","75740191","75740486","48","72350944"
"JH378249","3820023","3820289","chr12","6203118","6203386","41","2383095"
"JH378250","633650","633951","chr22","45546705","45547014","43","44913055"
"JH378250","1319150","1319337","chr2","25630213","25630417","41","24311063"
"JH378250","1814195","1814356","chr16","69077847","69078004","44","67263652"
"JH378250","1957226","1957487","chr21","117751109","117751372","57","115793883"
"JH378250","2035083","2035357","chr1","125539185","125539461","48","123504102"
"JH378250","2071687","2071900","chr8","51214368","51214580","39","49142681"
"JH378250","2169686","2169968","chr7","75281084","75281363","45","73111398"
"JH378250","2359879","2360186","chr1","33477981","33478289","50","31118102"
"JH378250","3371564","3371696","chr4","77908589","77908714","21","74537025"
"JH378250","4029480","4029788","chr14","79956017","79956326","38","75926537"
"JH378251","1022789","1022916","chr2","4976621","4976741","20","3953832"
"JH378251","2018963","2019265","chr15","908203","908506","49","1110760"
"JH378251","3425646","3425935","chr13","64951567","64951860","37","61525921"
"JH378251","3573338","3573643","chr12","41019638","41019945","38","37446300"
"JH378251","3710397","3710533","chr5","71122050","71122197","31","67411653"
"JH378251","3884170","3884221","chr24","51584132","51584183","8","47699962"
"JH378251","4242773","4242918","chr17","61823129","61823273","26","57580356"
"JH378252","714192","714477","chr26","18794536","18794836","53","18080344"
"JH378252","1499100","1499395","chrX","6571847","6572139","43","5072747"
"JH378252","2502202","2502481","chr1","56961737","56962012","43","54459535"
"JH378252","2524857","2525157","chr17","22605049","22605342","40","20080192"
"JH378252","3061820","3062132","chr20","7876234","7876541","50","4814414"
"JH378252","3204585","3204896","chr17","50480721","50481028","42","47276136"
"JH378252","3373987","3374093","chrX","105255765","105255881","25","101881778"
"JH378252","3600062","3600354","chr10","2202474","2202766","33","1397588"
"JH378252","3717180","3717392","chr22","59313204","59313418","37","55596024"
"JH378252","3847060","3847365","chr2","22860155","22860456","40","19013095"
"JH378253","417020","417206","chr20","67913721","67913907","27","67496701"
"JH378253","464523","464824","chr4","74750244","74750542","44","74285721"
"JH378253","860122","860410","chr26","11209053","11209344","38","10348931"
"JH378253","1938674","1938952","chr28","8917006","8917294","42","6978332"
"JH378253","2579491","2579665","chr5","19938843","19939015","31","17359352"
"JH378253","2738471","2738582","chr7","93779028","93779150","28","91040557"
"JH378253","2738595","2738690","chr6","35238025","35238103","29","32499430"
"JH378253","4049260","4049448","chr5","13172968","13173157","47","9123708"
"JH378254","165475","165771","chr3","19781093","19781390","43","19615618"
"JH378254","268366","268665","chr11","1373833","1374133","44","1105467"
"JH378254","503115","503407","chr24","50545181","50545478","40","50042066"
"JH378254","772206","772508","chr6","18852331","18852633","41","18080125"
"JH378254","1267055","1267356","chr2_KE147940v1_random","21204","21502","38","1245851"
"JH378254","2088205","2088503","chr23","71906236","71906536","39","69818031"
"JH378254","3097310","3097590","chr14","80514087","80514367","49","77416777"
"JH378254","3300258","3300551","chr15","8473619","8473907","49","5173361"
"JH378254","3643135","3643443","chr7","30250588","30250897","48","26607453"
"JH378254","4076239","4076383","chr20","115225004","115225156","42","111148765"
"JH378255","384819","384933","chr4","74247685","74247799","46","73862866"
"JH378255","636931","637242","chr16","8254554","8254859","49","7617623"
"JH378255","732090","732351","chr16","11994566","11994827","52","11262476"
"JH378255","738978","739034","chr5","74278756","74278811","18","73539778"
"JH378255","739663","739766","chr8","88261673","88261783","23","87522010"
"JH378255","1192531","1192826","chr27","10526763","10527062","43","9334232"
"JH378255","1702308","1702609","chr20","104985298","104985598","47","103282990"
"JH378255","1926481","1926777","chr5","55179159","55179451","45","53252678"
"JH378255","2017652","2017792","chr19","8893838","8893978","28","6876186"
"JH378255","2397052","2397183","chr14","33067112","33067242","29","30670060"
"JH378255","2488052","2488243","chr16","74527352","74527538","33","72039300"
"JH378255","2543646","2543934","chr11","42708500","42708788","44","40164854"
"JH378255","3264917","3265095","chr24","76523592","76523762","45","73258675"
"JH378255","3403928","3404210","chr13","67198097","67198382","36","63794169"
"JH378255","3439652","3439893","chr1","41979357","41979596","37","38539705"
"JH378255","3642458","3642595","chr13","93936933","93937062","25","90294475"
"JH378255","3830679","3830993","chr6","47650116","47650422","46","43819437"
"JH378255","3839602","3839783","chr2","74004467","74004653","49","70164865"
"JH378255","3915081","3915349","chr25","74544052","74544325","61","70628971"
"JH378255","4034048","4034188","chr27","46451202","46451337","22","42417154"
"JH378256","666617","666901","chr8","54639056","54639335","45","53972439"
"JH378256","910363","910648","chr9","59423774","59424053","50","58513411"
"JH378256","1043334","1043565","chr17","64118191","64118422","48","63074857"
"JH378256","1737301","1737614","chr16","30260040","30260349","43","28522739"
"JH378256","1766937","1767229","chr17","52102206","52102500","51","50335269"
"JH378256","2183564","2183877","chr2","10270080","10270351","81","8086516"
"JH378256","2275781","2276079","chr23","57612824","57613126","45","55337043"
"JH378256","3576921","3577198","chr2","10339052","10339336","52","6762131"
"JH378257","20024","20309","chr6","31277843","31278132","52","31257819"
"JH378257","78154","78266","chr2","4976621","4976741","21","4898467"
"JH378257","228577","228871","chr22","73085737","73086028","48","72857160"
"JH378257","1264534","1264774","chrX","803016","803259","57","461518"
"JH378257","2358503","2358768","chr16","16583135","16583399","42","14224632"
"JH378257","2528186","2528406","chr16","15121498","15121716","44","12593312"
"JH378257","2541721","2541988","chrX","118182064","118182317","59","115640343"
"JH378257","2611734","2611906","chr14","57070656","57070827","38","54458922"
"JH378257","2701073","2701216","chr25","6369752","6369893","32","3668679"
"JH378257","2878248","2878578","chr4","74750244","74750542","76","71871996"
"JH378257","3125847","3126141","chr20","105708807","105709105","40","102582960"
"JH378257","3388803","3388956","chr10","56563339","56563485","40","53174536"
"JH378257","3389280","3389424","chr29","23529798","23529947","29","20140518"
"JH378257","3946042","3946307","chr1","29294849","29295125","52","25348807"
"JH378258","204364","204513","chr10","97260354","97260495","32","97055990"
"JH378258","481783","482072","chr11","72041420","72041714","46","71559637"
"JH378258","482074","482366","chr15","8473619","8473907","45","7991545"
"JH378258","779560","779830","chr7","31487501","31487784","54","30707941"
"JH378258","971087","971243","chr20","115225004","115225156","32","114253917"
"JH378258","1090499","1090801","chr12","72899340","72899646","48","71808841"
"JH378258","1142070","1142204","chr10","35002409","35002551","29","33860339"
"JH378258","1792186","1792470","chr5","24852161","24852433","57","23059975"
"JH378258","1994842","1995123","chr12","108171343","108171621","40","106176501"
"JH378259","883197","883503","chr16","33417645","33417952","45","32534448"
"JH378259","1523111","1523403","chr12","45962018","45962309","44","44438907"
"JH378259","1933771","1934068","chr1","29712863","29713163","45","27779092"
"JH378259","2177368","2177663","chr17","4564564","4564857","36","2387196"
"JH378259","3057572","3057860","chr12","45962018","45962309","40","42904446"
"JH378259","3097728","3097940","chr8","120238157","120238376","39","117140429"
"JH378260","2228115","2228422","chr3","27047348","27047655","55","24819233"
"JH378260","134210","134496","chr21","126969960","126970241","56","126835750"
"JH378260","172245","172533","chr23","79133871","79134164","50","78961626"
"JH378260","206818","207130","chr26","18794536","18794836","44","18587718"
"JH378260","514870","515026","chr21","58133217","58133377","30","57618347"
"JH378260","643257","643558","chr20","105708807","105709105","43","105065550"
"JH378260","1340742","1340983","chr21","104210680","104210937","43","102869938"
"JH378260","2124111","2124408","chr16","18257374","18257671","37","16133263"
"JH378260","3307083","3307374","chr9","31281354","31281649","35","27974271"
"JH378260","3601553","3601769","chr14","74021868","74022082","41","70420315"
"JH378260","3679131","3679439","chr20","7876234","7876541","48","4197103"
"JH378260","3759138","3759406","chr18","23735352","23735620","44","19976214"
"JH378260","3884172","3884457","chr1","110377684","110377975","56","106493512"
"JH378260","3889430","3889540","chr16","24559855","24559969","20","20670425"
"JH378261","180751","180850","chr21","103512848","103512947","21","103332097"
"JH378261","181147","181353","chr7","26338472","26338675","32","26157325"
"JH378261","482384","482693","chr8","22789986","22790291","40","22307602"
"JH378261","2439622","2439928","chr12","72899340","72899646","42","70459718"
"JH378261","2582459","2582758","chr3","26574983","26575280","51","23992524"
"JH378261","2936232","2936526","chr26","26868700","26868994","34","23932468"
"JH378261","2948889","2949200","chr2","33362197","33362503","54","30413308"
"JH378262","449778","450072","chrX","33027186","33027484","38","32577408"
"JH378262","462058","462344","chr4","71555519","71555804","35","71093461"
"JH378262","528255","528415","chr8","36545404","36545573","36","36017149"
"JH378262","836858","837157","chr8","7202688","7202991","49","6365830"
"JH378262","1024942","1025244","chr12","93230250","93230542","48","92205308"
"JH378262","1054331","1054627","chr20","39089189","39089491","54","38034858"
"JH378262","1282265","1282470","chr8","98533747","98533957","36","97251482"
"JH378262","1402332","1402619","chr5","15593128","15593380","77","14190796"
"JH378262","1438859","1439163","chr3","46170082","46170384","51","44731223"
"JH378262","1502908","1503133","chr5","55258104","55258323","30","53755196"
"JH378262","1558965","1559121","chr20","130028139","130028296","39","128469174"
"JH378262","1584730","1585007","chr12","108171343","108171621","40","106586613"
"JH378262","1589907","1590206","chr26","26868700","26868994","39","25278793"
"JH378262","1622589","1622882","chr10","93505199","93505495","46","91882610"
"JH378262","1701390","1701616","chr3","54097857","54098084","47","52396467"
"JH378262","1728309","1728611","chr27","8181096","8181392","59","6452787"
"JH378262","1789920","1790210","chr16","70729210","70729502","38","68939290"
"JH378262","2477446","2477743","chr11","83560875","83561170","48","81083429"
"JH378262","3169458","3169747","chr5","3873106","3873396","45","703648"
"JH378262","3550125","3550431","chr4","65357267","65357566","68","61807142"
"JH378262","3613883","3614191","chr10","120888122","120888431","41","117274239"
"JH378262","3634046","3634340","chr12","18148605","18148902","47","14514559"
"JH378263","306687","306958","chrX","108462793","108463063","48","108156106"
"JH378263","358558","358867","chr5","26884776","26885075","51","26526218"
"JH378263","724944","725065","chr11","52256103","52256219","19","51531159"
"JH378263","1128860","1129142","chr11","42708500","42708788","32","41579640"
"JH378263","1267946","1268246","chr3","81970581","81970881","36","80702635"
"JH378263","1340768","1341065","chr7","116251443","116251737","53","114910675"
"JH378263","1682641","1682926","chr9","17526312","17526604","40","15843671"
"JH378263","2573710","2574000","chr12","103810770","103811053","42","101237060"
"JH378263","2863048","2863327","chr16","17103242","17103520","42","14240194"
"JH378263","3180841","3181175","chr11","116558393","116558699","67","113377552"
"JH378263","3268872","3269167","chr4","36056954","36057249","40","32788082"
"JH378263","3475770","3476077","chr25","27839006","27839308","42","24363236"
"JH378264","624443","624662","chr11","100225388","100225600","38","99600945"
"JH378264","788150","788404","chr11","74305189","74305418","59","73517039"
"JH378264","1121030","1121293","chr15","57792292","57792548","40","56671262"
"JH378264","1209098","1209388","chr9","85636273","85636563","45","84427175"
"JH378264","1257724","1258029","chr2","61035797","61036096","48","59778073"
"JH378264","1540799","1541069","chr1","89981933","89982205","46","88441134"
"JH378264","1580395","1580522","chr7","86286493","86286622","30","84706098"
"JH378264","1689238","1689377","chr10","56563339","56563485","26","54874101"
"JH378264","2079698","2079736","chr10","41694742","41694780","14","39615044"
"JH378264","2403091","2403386","chr16","24824595","24824890","36","22421504"
"JH378264","2897148","2897439","chr4","72474636","72474936","50","69577488"
"JH378264","3173833","3174137","chr1","98960303","98960603","40","95786470"
"JH378264","3237432","3237721","chr19","4455651","4455943","39","1218219"
"JH378264","3491098","3491411","chr26","4574785","4575094","48","1083687"
"JH378264","3596465","3596635","chr8","36545404","36545573","36","32948939"
"JH378264","3780863","3781168","chr6","10540061","10540366","46","6759198"
"JH378264","3798333","3798619","chr11","60552837","60553124","44","56754504"
"JH378265","114963","115240","chr1","56961737","56962012","44","56846774"
"JH378265","3171348","3171619","chr11","96237698","96237981","39","93066350"
"JH378265","3177610","3177904","chr1","8696866","8697165","36","5519256"
"JH378265","3313635","3313936","chr9","56706151","56706456","41","53392516"
"JH378265","3378977","3379229","chr4","14253886","14254130","37","10874909"
"JH378265","3393944","3394199","chr14","21025906","21026176","49","17631962"
"JH378266","6302","6522","chrX","125770526","125770749","44","125764224"
"JH378266","93325","93628","chr20","104985298","104985598","49","104891973"
"JH378266","188699","188997","chr9","61932207","61932503","35","61743508"
"JH378266","242239","242418","chr7","92803834","92804013","33","92561595"
"JH378266","467336","467394","chr9","51130702","51130760","3","50663366"
"JH378266","1477218","1477508","chr20","2854395","2854680","37","1377177"
"JH378266","1682980","1683288","chr9","96286060","96286366","45","94603080"
"JH378266","2514620","2514917","chr2","86879795","86880085","37","84365175"
"JH378266","3106012","3106119","chr1","19184037","19184145","18","16078025"
"JH378266","3292595","3292899","chr4","56195016","56195323","52","52902421"
"JH378266","3506819","3507105","chr14","86997958","86998245","53","83491139"
"JH378266","3722308","3722536","chr3","23197224","23197451","36","19474916"
"JH378267","314963","315141","chr7","92803834","92804013","24","92488871"
"JH378267","385965","386260","chr21","48106444","48106729","44","47720479"
"JH378267","448607","448900","chr8","11215621","11215918","41","10767014"
"JH378267","555701","555971","chr23","25570629","25570915","54","25014928"
"JH378267","939525","939814","chr11","75071530","75071805","71","74132005"
"JH378267","1017721","1018002","chr26","13844204","13844483","53","12826483"
"JH378267","1046882","1047195","chr19","1399966","1400272","47","353084"
"JH378267","1110016","1110181","chr10","61946373","61946539","27","60836357"
"JH378267","1810351","1810654","chr15","76326616","76326912","43","74516265"
"JH378267","2889297","2889575","chr9","39487572","39487853","43","36598275"
"JH378267","3169341","3169644","chr3","52994122","52994427","55","49824781"
"JH378268","4945","5253","chr15","2000778","2001083","56","1995833"
"JH378268","80682","80788","chr9","53409388","53409496","21","53328706"
"JH378268","510536","510648","chr4","66655504","66655608","31","66144968"
"JH378268","687220","687530","chr26","1398589","1398900","40","711369"
"JH378268","2703167","2703458","chr16","42400873","42401164","40","39697706"
"JH378268","3082995","3083168","chr4","66826794","66826969","29","63743799"
"JH378268","3598214","3598470","chr11","63970392","63970657","46","60372178"
"JH378269","17575","17693","chr11","24710077","24710199","37","24692502"
"JH378269","284858","285167","chrX","648656","648963","48","363798"
"JH378269","306427","306724","chrX","120888991","120889289","40","120582564"
"JH378269","416347","416543","chr9","85897385","85897596","44","85481038"
"JH378269","498605","498894","chr1","9360845","9361141","38","8862240"
"JH378269","509803","509986","chr14","37840547","37840721","41","37330744"
"JH378269","724021","724131","chr2","16354446","16354549","43","15630425"
"JH378269","765056","765361","chr26","24027927","24028229","42","23262871"
"JH378269","803338","803605","chr6","11215683","11215935","51","10412345"
"JH378269","960386","960600","chr16","34169864","34170075","38","33209478"
"JH378269","1899560","1899881","chr9","23211217","23211527","67","21311657"
"JH378270","619205","619329","chr13","93936933","93937062","26","93317728"
"JH378270","1548752","1548938","chr20","67913721","67913907","27","66364969"
"JH378270","1711156","1711453","chr2_KE147940v1_random","21204","21502","42","1689952"
"JH378271","151654","151964","chr1","9360845","9361141","49","9209191"
"JH378271","176071","176325","chr12","72756184","72756452","56","72580113"
"JH378271","317756","318048","chr1","29621888","29622188","46","29304132"
"JH378271","481296","481602","chr4","74750244","74750542","35","74268948"
"JH378271","576396","576689","chr1","102867195","102867490","53","102290799"
"JH378271","579244","579546","chr12","41019638","41019945","45","40440394"
"JH378271","625947","626242","chr9","86914519","86914814","44","86288572"
"JH378271","771321","771541","chr16","54270286","54270498","54","53498965"
"JH378271","832173","832460","chr3","25784267","25784567","37","24952094"
"JH378271","979560","979669","chr10","2090892","2091004","22","1111332"
"JH378271","1018261","1018363","chr8","120883432","120883531","33","119865171"
"JH378271","1046656","1046942","chr9","103138976","103139260","43","102092320"
"JH378271","1102800","1103084","chr4","53460153","53460432","45","52357353"
"JH378271","1229493","1229803","chr21","17625480","17625789","49","16395987"
"JH378271","1302949","1303263","chr21","55549223","55549531","49","54246274"
"JH378271","2293933","2294198","chr9","58155888","58156167","58","55861955"
"JH378271","2487072","2487373","chr6","29394044","29394346","39","26906972"
"JH378271","2838596","2838891","chr20_KE148049v1_random","757858","758154","39","2080738"
"JH378271","3459936","3460221","chr19","19336208","19336496","43","15876272"
"JH378272","58915","59023","chr3","54517299","54517407","34","54458384"
"JH378272","375084","375371","chr11","83560875","83561170","49","83185791"
"JH378272","422373","422664","chr9","87793699","87793980","57","87371326"
"JH378272","430995","431262","chr16","16583135","16583399","45","16152140"
"JH378272","467711","467914","chr8","62762310","62762525","38","62294599"
"JH378272","619282","619530","chr12","15320158","15320403","30","14700876"
"JH378272","790328","790627","chr1","9360845","9361141","34","8570517"
"JH378272","1997565","1997881","chr9","106648222","106648531","60","104650657"
"JH378272","2587330","2587484","chr18","58836864","58837013","30","56249534"
"JH378272","2781372","2781614","chr4","36121643","36121897","49","33340271"
"JH378272","2996240","2996548","chrX","13750936","13751243","43","10754696"
"JH378273","467605","467869","chr25","27453211","27453490","54","26985606"
"JH378273","474913","475212","chr13","45133548","45133846","44","44658635"
"JH378273","592784","593077","chr9","32604399","32604698","44","32011615"
"JH378273","609594","609930","chr20","69549135","69549464","63","68939541"
"JH378273","711696","711907","chr16","68030374","68030585","37","67318678"
"JH378273","725801","726036","chr18","68668421","68668651","38","67942620"
"JH378273","731587","731879","chr5","53126639","53126932","42","52395052"
"JH378273","737456","737726","chr14","61597585","61597855","45","60860129"
"JH378273","739984","740283","chr15","17458573","17458862","66","16718589"
"JH378273","769852","770121","chr3","88516944","88517224","41","87747092"
"JH378273","807068","807368","chr27","11295804","11296100","40","10488736"
"JH378273","812829","812940","chr1","81771309","81771421","29","80958480"
"JH378273","947989","948283","chr9","17799612","17799903","60","16851623"
"JH378273","1164258","1164547","chr13","49730977","49731264","51","48566719"
"JH378273","2545354","2545631","chr3","44477956","44478242","52","41932602"
"JH378274","259558","259848","chr20","1575953","1576241","54","1316395"
"JH378274","881958","882142","chr6","40853681","40853861","38","39971723"
"JH378274","2043204","2043532","chr6","46217489","46217813","63","44174285"
"JH378274","2874468","2874768","chr2","61035797","61036096","41","58161329"
"JH378274","3256510","3256798","chr10","117007658","117007955","71","113751148"
"JH378275","370794","370963","chr16","56984674","56984842","32","56613880"
"JH378275","430842","431117","chr9","18313882","18314160","49","17883040"
"JH378275","460234","460533","chr16","30260040","30260349","46","29799806"
"JH378275","460846","461132","chr25","59876382","59876671","46","59415536"
"JH378275","1810367","1810630","chr15","4986082","4986355","61","3175715"
"JH378275","3210934","3211209","chr25","12712961","12713239","44","9502027"
"JH378275","3258641","3258866","chr9","86755766","86756000","41","83497125"
"JH378276","350090","350383","chr20","7353494","7353791","39","7003404"
"JH378276","512836","512981","chr28","12031940","12032076","26","11519104"
"JH378276","595597","595735","chrX","77324374","77324510","24","76728777"
"JH378276","1641057","1641303","chr11","32138671","32138911","46","30497614"
"JH378276","1781411","1781715","chr12","72899340","72899646","42","71117929"
"JH378276","1782180","1782457","chr13","60154028","60154308","36","58371848"
"JH378276","1878581","1878876","chr17","38569856","38570151","52","36691275"
"JH378276","2999405","2999684","chr12","108171343","108171621","34","105171938"
"JH378276","3013505","3013803","chr14","68489088","68489386","61","65475583"
"JH378276","3065035","3065322","chr3","19321332","19321620","53","16256297"
"JH378276","3141237","3141538","chr23","40996685","40996984","39","37855448"
"JH378277","511463","511773","chr19","22145953","22146248","48","21634490"
"JH378277","1366407","1366695","chr11","42708500","42708788","49","41342093"
"JH378277","1514726","1515042","chr5","66452880","66453187","47","64938154"
"JH378277","1855586","1855877","chr4","74750244","74750542","46","72894658"
"JH378277","2009879","2010172","chr12","65356809","65357103","33","63346930"
"JH378277","2336785","2337010","chr1","18375911","18376144","52","16039126"
"JH378277","2795702","2795865","chr6","45276349","45276508","43","42480647"
"JH378277","2875913","2876065","chr11","6506714","6506863","27","3630801"
"JH378277","2939048","2939265","chr5","55258104","55258323","39","52319056"
"JH378278","293567","293784","chr16","15121498","15121716","39","14827931"
"JH378278","747514","747755","chr17","6642467","6642719","64","5894953"
"JH378278","1440994","1441303","chr1","125024996","125025302","42","123584002"
"JH378278","1635869","1636176","chr15","41834967","41835273","50","40199098"
"JH378278","1660582","1660894","chr25","11940518","11940832","55","10279936"
"JH378278","2088428","2088704","chr7","42923647","42923938","53","40835219"
"JH378278","2362561","2362857","chr15","81171502","81171802","47","78808941"
"JH378278","2553287","2553589","chr2","10875291","10875598","45","8322004"
"JH378278","3111167","3111432","chr6","21215806","21216076","57","18104639"
"JH378278","3119210","3119490","chr14","33993071","33993339","47","30873861"
"JH378279","1212348","1212611","chr24","80508974","80509233","56","79296626"
"JH378279","1213695","1213958","chr24","80508974","80509233","56","79295279"
"JH378279","1720140","1720443","chr4","74750244","74750542","41","73030104"
"JH378279","2112992","2113300","chrX_KE148109v1_random","59166","59473","36","2053826"
"JH378279","2184297","2184593","chr12","72899340","72899646","52","70715043"
"JH378279","2604723","2604917","chr21","18967230","18967419","42","16362507"
"JH378279","2767922","2768151","chr6","18761743","18761979","45","15993821"
"JH378279","2768976","2769029","chr5","2445602","2445676","23","323374"
"JH378279","2854005","2854305","chr20","105708807","105709105","37","102854802"
"JH378280","378203","378332","chr8","124995937","124996065","20","124617734"
"JH378280","598616","598903","chr29","9188440","9188729","46","8589824"
"JH378280","1494188","1494474","chr13","57700238","57700522","42","56206050"
"JH378280","2679786","2679885","chr21","103512848","103512947","23","100833062"
"JH378280","2935178","2935473","chr20","92950108","92950404","35","90014930"
"JH378280","3120935","3121223","chr1","8790492","8790780","43","5669557"
"JH378281","231302","231467","chr10","61946373","61946539","33","61715071"
"JH378281","253713","253957","chr4","65263107","65263348","30","65009394"
"JH378281","464123","464328","chr26","42306145","42306344","31","41842022"
"JH378281","531948","532141","chr1","21512792","21512987","45","20980844"
"JH378281","809777","810072","chr16","66139074","66139369","46","65329297"
"JH378281","1068308","1068617","chr6","34524049","34524352","41","33455741"
"JH378281","1068908","1069191","chr10","94012577","94012864","35","92943669"
"JH378281","1986028","1986234","chr9","105264842","105265042","38","103278814"
"JH378281","2549060","2549349","chr3","19321332","19321620","44","16772272"
"JH378281","2837856","2838154","chr3","63855865","63856174","48","61018009"
"JH378281","2858916","2859226","chr17","40106599","40106905","65","37247683"
"JH378281","3019734","3020042","chr1","125024996","125025302","37","122005262"
"JH378282","379106","379206","chrX_KE148108v1_random","2493517","2493615","16","2114411"
"JH378282","843033","843187","chr11","117718811","117718965","29","116875778"
"JH378282","852795","853082","chr5","14198316","14198616","57","13345521"
"JH378282","2071170","2071346","chr7","92803834","92804013","30","90732664"
"JH378282","2719875","2720174","chr12","43161561","43161851","53","40441686"
"JH378283","436970","437256","chr13","38703830","38704121","50","38266860"
"JH378283","1989657","1989729","chrX","89653867","89653941","24","87664210"
"JH378283","2060415","2060698","chr2","7721210","7721494","43","5660795"
"JH378283","2381362","2381420","chr5","74278756","74278811","26","71897394"
"JH378283","2535171","2535444","chrX","85829317","85829602","41","83294146"
"JH378283","2600540","2600704","chrX","29833617","29833775","35","27233077"
"JH378283","2635483","2635617","chrX","77324374","77324510","24","74688891"
"JH378284","89754","90037","chr16","71130019","71130298","61","71040265"
"JH378284","2408783","2409084","chr9","32604399","32604698","33","30195616"
"JH378284","2549992","2550290","chr23","38922269","38922564","37","36372277"
"JH378284","2719771","2720061","chr4","72474636","72474936","51","69754865"
"JH378285","268713","268910","chr24","69778555","69778746","36","69509842"
"JH378285","1916794","1916946","chr8","112591683","112591837","27","110674889"
"JH378286","285972","286217","chr20","43886824","43887060","48","43600852"
"JH378286","668354","668641","chr19","1463318","1463615","45","794964"
"JH378286","1076938","1077223","chr11","8100251","8100533","55","7023313"
"JH378287","467070","467171","chr3","54517299","54517407","29","54050229"
"JH378288","734715","735013","chr11","91887378","91887674","40","91152663"
"JH378288","830206","830440","chr19","13608773","13609025","56","12778567"
"JH378288","920587","920883","chr1","9360845","9361141","46","8440258"
"JH378288","939281","939406","chr1","8926569","8926682","22","7987288"
"JH378288","1416688","1416987","chr16","70729210","70729502","66","69312522"
"JH378288","1499784","1500000","chr11","100225388","100225600","38","98725604"
"JH378288","1505133","1505307","chr20","122239975","122240145","46","120734842"
"JH378288","1835577","1835822","chr20","107997025","107997264","43","106161448"
"JH378288","1905379","1905676","chr26","26868700","26868994","35","24963321"
"JH378288","1915678","1916011","chr23","60066478","60066800","53","58150800"
"JH378288","2175627","2175927","chr9","102983131","102983431","45","100807504"
"JH378288","2233873","2234167","chr4","74750244","74750542","31","72516371"
"JH378288","2741937","2742173","chr1","50678867","50679117","43","47936930"
"JH378289","1638665","1638955","chr22","11362456","11362743","36","9723791"
"JH378289","2662225","2662495","chr10","29167842","29168112","50","26505617"
"JH378289","2768401","2768710","chr16","35104042","35104353","51","32335641"
"JH378290","320497","320800","chrX","61756996","61757299","45","61436499"
"JH378290","649939","650243","chr11","19618707","19619010","47","18968768"
"JH378290","806889","807174","chrX","66837968","66838254","39","66031079"
"JH378290","823801","824087","chr4","37086524","37086833","61","36262723"
"JH378290","918341","918629","chr18","48953277","48953567","39","48034936"
"JH378290","1153737","1154029","chrX","47726776","47727071","45","46573039"
"JH378290","1178956","1179251","chr10","104330612","104330907","45","103151656"
"JH378290","1389539","1389806","chr6","7057","7319","56","1382482"
"JH378290","1640837","1641070","chr1","41979357","41979596","47","40338520"
"JH378290","1722933","1723057","chr14","67782475","67782602","21","66059542"
"JH378290","1829241","1829520","chr11","42101160","42101440","37","40271919"
"JH378290","2468001","2468294","chr12","62505268","62505568","43","60037267"
"JH378290","2488878","2488998","chr2","4976621","4976741","10","2487743"
"JH378290","2526512","2526811","chr23","12799637","12799937","57","10273125"
"JH378290","2557713","2558021","chr6","4074649","4074950","58","1516936"
"JH378290","2572926","2573181","chr5","43989885","43990146","47","41416959"
"JH378291","86426","86595","chr20","122239975","122240145","23","122153549"
"JH378291","498075","498380","chrX","60403420","60403723","47","59905345"
"JH378291","657863","658157","chr17","38569856","38570151","59","37911993"
"JH378291","776609","776887","chr11","115608615","115608899","52","114832006"
"JH378291","1472248","1472539","chr9","6382689","6382978","38","4910441"
"JH378291","1577344","1577480","chr5","71122050","71122197","35","69544706"
"JH378291","1613937","1614233","chr16","18257374","18257671","44","16643437"
"JH378291","1636575","1636882","chr27","34173912","34174217","46","32537337"
"JH378291","1873346","1873653","chr10","76125498","76125800","47","74252152"
"JH378291","1944548","1944845","chr3","54134214","54134510","46","52189666"
"JH378291","2045344","2045646","chr7","130904274","130904570","47","128858930"
"JH378291","2276896","2277167","chr23","63036814","63037090","36","60759918"
"JH378291","2284268","2284566","chr2","74710313","74710618","55","72426045"
"JH378291","2501097","2501297","chr7","131233865","131234062","41","128732768"
"JH378292","2421689","2421987","chr4","74750244","74750542","49","72328555"
"JH378292","2484677","2484807","chr10","88097615","88097749","21","85612938"
"JH378292","2491125","2491421","chr12","2036491","2036781","63","454634"
"JH378293","187406","187676","chr18","55842191","55842463","35","55654785"
"JH378293","734503","734797","chr4","13952658","13952953","39","13218155"
"JH378293","1205297","1205588","chr11","47698619","47698910","41","46493322"
"JH378293","1351895","1352191","chr1","9360845","9361141","37","8008950"
"JH378293","1412742","1413052","chr6","29394044","29394346","46","27981302"
"JH378293","1765321","1765621","chr3","31757392","31757689","42","29992071"
"JH378293","1933446","1933734","chr16","7888226","7888516","40","5954780"
"JH378293","2276867","2277000","chr20","108914992","108915125","13","106638125"
"JH378293","2383782","2384071","chr14","52817028","52817317","47","50433246"
"JH378294","121346","121624","chr4","71688456","71688734","37","71567110"
"JH378294","1890062","1890202","chr20","20635550","20635688","32","18745488"
"JH378294","2287132","2287424","chr11","99440874","99441165","34","97153742"
"JH378294","2310611","2310911","chr5","27334768","27335067","46","25024157"
"JH378294","2343146","2343394","chr2","60488088","60488342","43","58144942"
"JH378294","2377705","2377986","chr8","11165799","11166080","39","8788094"
"JH378295","813955","814217","chr2","66937766","66938027","48","66123811"
"JH378295","1688854","1689142","chr22","95239299","95239587","52","93550445"
"JH378296","1187594","1187888","chr2","22860155","22860456","42","21672561"
"JH378296","1248737","1249029","chr20","2854395","2854680","49","1605658"
"JH378296","1409140","1409406","chr20","9448039","9448298","58","8038899"
"JH378296","2205011","2205301","chr10","104330612","104330907","49","102125601"
"JH378297","363965","364271","chr6","36288281","36288590","38","35924316"
"JH378297","939162","939449","chr1","29621888","29622188","56","28682726"
"JH378297","1680325","1680631","chr15","81171502","81171802","39","79491177"
"JH378297","1801657","1801880","chr13","13267143","13267363","44","11465486"
"JH378298","61191","61323","chr16","23717759","23717888","26","23656568"
"JH378298","62645","62910","chr14","61597585","61597855","49","61534940"
"JH378298","119224","119510","chr20","80621483","80621774","35","80502259"
"JH378298","662793","663088","chr2","6803049","6803335","47","6140256"
"JH378298","1176051","1176325","chr10","18339526","18339800","50","17163475"
"JH378299","653955","654264","chr26","11268579","11268887","44","10614624"
"JH378299","1381697","1381865","chr9","107561541","107561712","28","106179844"
"JH378299","1476160","1476458","chr2","80227980","80228270","46","78751820"
"JH378299","1592347","1592509","chr15","68073590","68073751","30","66481243"
"JH378299","1809038","1809314","chr4","51976280","51976557","37","50167242"
"JH378300","305924","306219","chr9","96272747","96273028","50","95966823"
"JH378300","432820","433131","chr22","45546705","45547014","39","45113885"
"JH378300","541335","541499","chr25","17368661","17368839","45","16827326"
"JH378300","623003","623298","chr16","24824595","24824890","37","24201592"
"JH378300","761711","761830","chr13","88890694","88890812","17","88128983"
"JH378300","772650","772944","chr7","24372563","24372858","38","23599913"
"JH378300","921863","922062","chr10","103972130","103972329","39","103050267"
"JH378300","922742","922853","chr26","11354204","11354323","24","10431462"
"JH378300","1015627","1015904","chr12","31899150","31899427","35","30883523"
"JH378300","1109517","1109801","chr12","45962018","45962309","65","44852501"
"JH378300","1109809","1110095","chr23","38922269","38922564","45","37812460"
"JH378300","1122719","1122848","chr14","9848029","9848146","32","8725310"
"JH378300","1269816","1270131","chr6","29664605","29664916","55","28394789"
"JH378300","1404016","1404185","chr10","61946373","61946539","30","60542357"
"JH378300","1456583","1456809","chr28","13453464","13453689","36","11996881"
"JH378300","1549175","1549465","chrX","18575272","18575575","50","17026097"
"JH378300","1904491","1904781","chr15","4518124","4518415","46","2613633"
"JH378300","1913041","1913329","chr12","91269439","91269722","43","89356398"
"JH378301","9527","9818","chr16","24824595","24824890","43","24815068"
"JH378301","313940","314233","chr6","13913107","13913406","47","13599167"
"JH378301","317256","317541","chrX","66837968","66838254","40","66520712"
"JH378301","332155","332311","chr20","115225004","115225156","37","114892849"
"JH378301","942546","942828","chr12","106006709","106006991","42","105064163"
"JH378301","1402487","1402604","chr21","2508889","2509006","19","1106402"
"JH378301","1543451","1543744","chr1","51035370","51035662","39","49491919"
"JH378301","1670081","1670375","chr1","108598109","108598405","39","106928028"
"JH378301","1739705","1740005","chr1","677235","677538","57","1062470"
"JH378302","1214425","1214716","chr26","11209053","11209344","40","9994628"
"JH378302","1251090","1251400","chr25","27839006","27839308","44","26587916"
"JH378302","1503328","1503620","chr14","48826130","48826421","60","47322802"
"JH378303","267661","267947","chr1","64953626","64953920","54","64685965"
"JH378303","361657","361866","chr16","74574690","74574885","39","74213033"
"JH378303","477064","477368","chr4","35239086","35239384","36","34762022"
"JH378303","900115","900360","chr5","24852161","24852433","73","23952046"
"JH378303","1119524","1119833","chr10","44221705","44222014","36","43102181"
"JH378304","183540","183844","chr4","37086524","37086833","49","36902984"
"JH378304","1158338","1158459","chr15","76091978","76092101","26","74933640"
"JH378305","153329","153519","chr5","192637","192820","44","39308"
"JH378305","153651","153740","chr25","39143607","39143687","26","38989956"
"JH378305","697387","697540","chr8","112591683","112591837","25","111894296"
"JH378305","1062110","1062289","chr24","77863315","77863484","36","76801205"
"JH378305","1167119","1167410","chr24","51521386","51521673","48","50354267"
"JH378305","1254675","1254970","chr2","80562522","80562815","48","79307847"
"JH378305","1276470","1276665","chr6","40853681","40853861","37","39577211"
"JH378305","1469750","1469934","chr9","61648531","61648713","40","60178781"
"JH378305","1659820","1659857","chr1","123915771","123915811","9","122255951"
"JH378306","960894","961190","chr2","47485248","47485546","42","46524354"
"JH378307","332365","332507","chr21","54066983","54067128","27","53734618"
"JH378307","1171823","1172102","chr2","56072846","56073138","52","54901023"
"JH378308","398218","398456","chr20","104477833","104478070","37","104079615"
"JH378308","692609","692909","chr9","32604399","32604698","37","31911790"
"JH378308","1369275","1369568","chr4","52198329","52198623","40","50829054"
"JH378308","1423015","1423309","chr11","9736123","9736423","42","8313108"
"JH378308","1476580","1476867","chr23","38922269","38922564","45","37445689"
"JH378309","247570","247851","chr12","49653019","49653294","41","49405449"
"JH378309","557901","558175","chr10","24786097","24786370","42","24228196"
"JH378309","1311410","1311703","chr13","93848759","93849059","51","92537349"
"JH378309","1413665","1413748","chr13","22775549","22775632","12","21361884"
"JH378310","90449","90749","chr3","18369063","18369363","62","18278614"
"JH378310","104579","104854","chr10","34411206","34411482","73","34306627"
"JH378310","1088620","1088886","chr16","16583135","16583399","38","15494515"
"JH378310","1090935","1091205","chr22","71874724","71874995","44","70783789"
"JH378311","71768","72067","chr1","108232344","108232644","46","108160576"
"JH378311","99200","99511","chr1","40186193","40186501","46","40086993"
"JH378311","1086866","1087095","chr7","57513437","57513664","45","56426571"
"JH378312","160327","160498","chr21","58133217","58133377","43","57972890"
"JH378312","186261","186417","chr13","29722270","29722425","37","29536009"
"JH378312","215174","215369","chr6","45412468","45412650","54","45197294"
"JH378312","243419","243562","chr11","101833145","101833283","37","101589726"
"JH378312","602989","603195","chr7","92803834","92804013","69","92200845"
"JH378312","928433","928737","chr23","57612824","57613126","42","56684391"
"JH378313","66158","66298","chr17","61823129","61823273","27","61756971"
"JH378313","395378","395662","chr12","39114189","39114476","43","38718811"
"JH378313","428073","428178","chr3","54517299","54517407","29","54089226"
"JH378313","488209","488505","chrX","47726776","47727071","38","47238567"
"JH378313","845836","846121","chr9","39487572","39487853","53","38641736"
"JH378313","931950","932256","chrX","60403420","60403723","45","59471470"
"JH378313","986432","986745","chr1","33477981","33478289","46","32491549"
"JH378314","625264","625319","chr5","23010177","23010233","10","22384913"
"JH378315","160241","160429","chr24","41871595","41871780","35","41711354"
"JH378315","500272","500585","chr8","95859478","95859783","58","95359206"
"JH378316","768656","768952","chr23","80642893","80643191","42","79874237"
"JH378316","857607","857787","chr12","57864011","57864204","44","57006404"
"JH378316","1031721","1032018","chr24","27110583","27110876","42","26078862"
"JH378317","189918","190089","chr8","36545404","36545573","43","36355486"
"JH378317","589103","589421","chrX","10891227","10891532","57","10302124"
"JH378317","736268","736552","chr28","8917006","8917294","49","8180738"
"JH378318","416464","416611","chr8","124933735","124933890","28","124517271"
"JH378319","129402","129711","chr8","47492135","47492438","45","47362733"
"JH378319","207212","207381","chr17","28504407","28504573","37","28297195"
"JH378319","304587","304889","chr14","80779962","80780266","49","80475375"
"JH378319","498060","498337","chr21","16639270","16639547","50","16141210"
"JH378319","612066","612274","chr16","34169864","34170075","39","33557798"
"JH378319","797413","797699","chr24","71658540","71658819","56","70861127"
"JH378319","921071","921358","chr7","58300547","58300835","61","57379476"
"JH378320","107241","107455","chr11","100225388","100225600","33","100118147"
"JH378320","343617","343737","chr9","48788101","48788226","28","48444484"
"JH378320","343767","344070","chr1","29712863","29713163","53","29369096"
"JH378320","417962","418263","chr7","42735840","42736150","77","42317878"
"JH378320","622184","622466","chr28","9652356","9652644","48","9030172"
"JH378320","692190","692492","chr10","75740191","75740486","42","75048001"
"JH378320","771787","771920","chr12","9394703","9394838","25","8622916"
"JH378320","790491","790787","chr10","55092261","55092557","49","54301770"
"JH378321","121001","121229","chr7","57513437","57513664","31","57392436"
"JH378321","213534","213829","chr2","22860155","22860456","44","22646621"
"JH378322","225872","226169","chr20","80621483","80621774","55","80395611"
"JH378322","290002","290218","chr22","59313204","59313418","35","59023202"
"JH378322","429019","429058","chr1","25970067","25970095","21","25541048"
"JH378322","429145","429261","chr16","4541268","4541389","35","4112123"
"JH378323","58565","58785","chr20","108953446","108953684","55","108894881"
"JH378323","153672","153871","chr16","74527352","74527538","34","74373680"
"JH378323","239885","239914","chr19","20678144","20678174","6","20438259"
"JH378323","648272","648570","chr6","32749709","32750008","38","32101437"
"JH378324","59137","59436","chr2","75600430","75600728","52","75541293"
"JH378324","92489","92668","chr12","43957933","43958104","32","43865444"
"JH378324","321103","321405","chr17","16693959","16694262","39","16372856"
"JH378325","31100","31387","chr15","21505985","21506275","42","21474885"
"JH378326","254597","254898","chr14","81687671","81687971","46","81433074"
"JH378326","318230","318365","chrX","77324374","77324510","24","77006144"
"JH378326","481433","481742","chr9","57444017","57444321","47","56962584"
"JH378326","664023","664290","chr19","20171476","20171751","58","19507453"
"JH378326","733121","733403","chr11","42101160","42101440","54","41368039"
"JH378327","246947","247064","chr16","58247487","58247609","29","58000540"
"JH378327","380957","381217","chr25","52946162","52946411","46","52565205"
"JH378327","528593","528883","chr15","60397717","60398018","55","59869124"
"JH378328","112855","113021","chr21","107613399","107613563","37","107500544"
"JH378328","163758","163928","chr19","11544687","11544855","30","11380929"
"JH378328","171938","172248","chr9","28112269","28112568","47","27940331"
"JH378328","260814","260956","chrX","555973","556115","32","295159"
"JH378328","294366","294675","chr9","95286564","95286873","53","94992198"
"JH378328","677705","677825","chr6","50805503","50805627","26","50127798"
"JH378328","690743","690955","chr15","72161983","72162197","60","71471240"
"JH378329","583593","583882","chr11","115608615","115608899","42","115025022"
"JH378330","91130","91383","chr5","75072071","75072324","56","74980941"
"JH378330","230744","231013","chr11","90535443","90535733","58","90304699"
"JH378332","183918","184234","chr20","49698370","49698675","70","49514452"
"JH378333","519236","519532","chr17","36678048","36678335","56","36158812"
"JH378334","111994","112294","chr27","40239547","40239855","57","40127553"
"JH378334","206143","206441","chr7","24372563","24372858","36","24166420"
"JH378334","537052","537341","chr16","14658708","14659007","66","14121656"
"JH378337","110448","110685","chr7","57513437","57513664","50","57402989"
"JH378337","271382","271676","chr23","76077886","76078182","54","75806504"
"JH378337","325423","325698","chr20","9842411","9842688","35","9516988"
"JH378337","413324","413629","chr10","75740191","75740486","59","75326867"
"JH378338","117129","117264","chr21","126135742","126135874","26","126018613"
"JH378338","279047","279265","chr26","20999796","21000000","50","20720749"
"JH378339","328044","328273","chr10","40208228","40208448","54","39880184"
"JH378339","380942","381241","chr1","125024996","125025302","41","124644054"
"JH378342","46442","46732","chr1","32185350","32185644","35","32138908"
"JH378342","131286","131575","chr16","66373684","66373974","34","66242398"
"JH378343","434874","435183","chr14","12038537","12038844","40","11603663"
"JH378344","394970","395241","chr11","42708500","42708788","47","42313530"
"JH378344","396373","396674","chr16","18299936","18300237","53","17903563"
"JH378345","42316","42389","chr1","110773079","110773145","15","110730763"
"JH378347","117089","117385","chr17","29306106","29306387","58","29189017"
"JH378347","226229","226363","chr7","106999873","106999998","30","106773644"
"JH378348","194678","194965","chr2","7721210","7721494","36","7526532"
"JH378348","243010","243139","chr6","37703627","37703760","24","37460617"
"JH378350","138108","138394","chr16","12085942","12086229","46","11947834"
"JH378350","153705","153837","chr4","90460665","90460796","29","90306960"
"JH378350","233622","233906","chr16","70729210","70729502","47","70495588"
"JH378350","332929","333098","chrX","66835729","66835905","36","66502800"
"JH378355","274720","275021","chr4","74750244","74750542","39","74475524"
"JH378359","186591","186860","chr14","73449016","73449297","62","73262425"
"JH378360","83613","83735","chr2","4976621","4976741","16","4893008"
"JH378361","155188","155322","chr1","77159136","77159266","25","77003948"
"JH378361","176658","176902","chr20","107997025","107997264","40","107820367"
"JH378362","56567","56851","chr1","16838288","16838572","55","16781721"
"JH378364","72821","73112","chr24","27110583","27110876","47","27037762"
"JH378365","163370","163539","chr16","59570852","59571033","37","59407482"
"JH378366","76467","76566","chr21","73735740","73735834","30","73659273"
"JH378366","143977","144188","chr6","45204746","45204963","50","45060769"
"JH378370","16524","16841","chrX","41878389","41878698","51","41861865"
"JH378375","117006","117291","chr7","33514999","33515284","63","33397993"
"JH378375","120116","120400","chr14","22324093","22324369","66","22203977"
"JH378378","98185","98493","chr20","7876234","7876541","39","7778049"
"JH378381","14227","14529","chr3","77902958","77903231","74","77888731"
"JH378386","45860","45988","chr4","31240462","31240592","20","31194602"
"JH378386","46039","46109","chr27","34039445","34039506","27","33993406"
"JH378386","46200","46319","chr25","28864990","28865114","18","28818790"
"JH378389","72290","72571","chr23","52521673","52521952","57","52449383"
"JH378401","31501","31620","chr20_KE148049v1_random","1287449","1287579","20","1255948"
"JH378403","12042","12317","chr8","40231397","40231673","37","40219355"
"JH378411","47887","48109","chr5","3148405","3148630","43","3100518"
"JH378414","15900","15949","chr10","57361441","57361488","8","57345541"
"JH378417","4108","4418","chrX","60403420","60403723","46","60399312"
"JH378431","13774","13892","chr18","63015245","63015360","20","63001471"
"JH378471","3869","4156","chr11","42708500","42708788","50","42704631"
"JH378508","4684","4873","chr5","192637","192820","28","187953"
"JH378577","661","964","chr6","32749709","32750008","45","32749048"
"JH378619","834","1136","chr22","47240034","47240339","56","47239200"
"JH378715","3649","3886","chr20","43886824","43887060","38","43883175"
"AGCE01148737","10140","10363","chr7","53120863","53121084","44","53110723"
"AGCE01148959","5882","6119","chr7","57513437","57513664","49","57507555"
"AGCE01149497","2979","3273","chr11","83560875","83561170","53","83557896"
"AGCE01149666","701","962","chr19","4180398","4180669","70","4179697"
"AGCE01149756","1","133","chr4","90460665","90460796","23","90460664"
"AGCE01149756","1788","1966","chr20","87928737","87928908","36","87926949"
"AGCE01149761","310","591","chr6","10963028","10963286","77","10962718"
"AGCE01149895","1432","1757","chr3","11063125","11063453","44","11061693"
"AGCE01149920","182","481","chr18","59850632","59850929","38","59850450"
"AGCE01150147","1","282","chr7","75281084","75281363","44","75281083"
"AGCE01150150","6","227","chrX_KE148109v1_random","1194908","1195135","56","1194902"
"AGCE01150276","308","468","chr5","26491060","26491223","33","26490752"
"AGCE01150298","93","323","chr12","15320158","15320403","48","15320065"
"AGCE01150305","287","586","chr20","44512838","44513119","62","44512551"
"AGCE01150406","1332","1375","chr13","7060006","7060057","10","7058674"
"AGCE01150416","1","180","chr12","57864011","57864204","40","57864010"
"AGCE01150436","1","275","chr7","103499225","103499505","52","103499224"
"AGCE01150486","174","436","chrX","28441716","28441974","45","28441542"
"AGCE01150487","1108","1264","chr3","28939304","28939471","40","28938196"
"AGCE01150749","918","1210","chr3","19281727","19282020","46","19280809"
"AGCE01150768","595","887","chr20","1575953","1576241","51","1575358"
"AGCE01150769","1","61","chr5","23010177","23010233","8","23010176"
"AGCE01150811","420","596","chr12","43957933","43958104","33","43957513"
"AGCE01150891","328","623","chr27","9710911","9711212","42","9710583"
"AGCE01150985","27","325","chr24","28147960","28148255","73","28147933"
"AGCE01151326","907","1083","chr9","56425008","56425194","31","56424101"
