"JH378105","47972290","47972566","KQ055173v1","452351","452623","55","47519939"
"JH378105","151859","152146","KQ056672v1","3082150","3082439","64","2930291"
"JH378105","415937","416216","KQ058184v1","1505565","1505858","67","1089628"
"JH378105","421638","421797","KQ057649v1","424252","424417","38","2614"
"JH378105","806487","806782","KQ052970v1","13817736","13818032","81","13011249"
"JH378105","891419","891725","KQ054826v1","11793577","11793880","76","10902158"
"JH378105","1218882","1219160","KQ055755v1","209063","209333","76","1009819"
"JH378105","1398984","1399261","KQ058583v1","1187997","1188260","73","210987"
"JH378105","1710105","1710239","KQ055893v1","1630751","1630897","43","79354"
"JH378105","1830792","1831058","KQ055872v1","2360857","2361124","60","530065"
"JH378105","1854370","1854656","KQ056790v1","446564","446855","63","1407806"
"JH378105","2015526","2015667","KQ053240v1","144390","144530","29","1871136"
"JH378105","2059474","2059747","KQ053004v1","3225867","3226135","73","1166393"
"JH378105","2150195","2150488","KQ058585v1","580456","580763","66","1569739"
"JH378105","2184808","2185091","KQ058184v1","1505565","1505858","67","679243"
"JH378105","2292498","2292642","KQ053982v1","3934263","3934401","35","1641765"
"JH378105","2512902","2513213","KQ054932v1","4081077","4081374","69","1568175"
"JH378105","2663573","2663665","KQ053498v1","6687279","6687374","36","4023706"
"JH378105","2663743","2663895","KQ058316v1","1612479","1612626","34","1051264"
"JH378105","2848276","2848597","KQ053816v1","7043043","7043343","76","4194767"
"JH378105","3400089","3400387","KQ057656v1","192900","193174","87","3207189"
"JH378105","3484462","3484740","KQ055247v1","216427","216708","51","3268035"
"JH378105","3633899","3634208","KQ058272v1","4942871","4943179","67","1308972"
"JH378105","3642284","3642540","KQ058004v1","2612564","2612826","73","1029720"
"JH378105","3668728","3669023","KQ054412v1","2490468","2490761","60","1178260"
"JH378105","4028121","4028337","KQ058445v1","325619","325833","55","3702502"
"JH378105","4067305","4067613","KQ058184v1","1505565","1505858","68","2561740"
"JH378105","4081657","4081944","KQ053894v1","1290632","1290924","79","2791025"
"JH378105","4107377","4107664","KQ055065v1","1117201","1117481","67","2990176"
"JH378105","4127649","4127769","KQ054356v1","1379018","1379142","30","2748631"
"JH378105","4128148","4128298","KQ056587v1","7257462","7257612","39","3129314"
"JH378105","4319696","4319971","KQ054191v1","687910","688159","75","3631786"
"JH378105","4331990","4332315","KQ057737v1","5499585","5499900","78","1167595"
"JH378105","4338265","4338576","KQ052969v1","11192474","11192788","65","6854209"
"JH378105","4398274","4398474","KQ053565v1","3764313","3764506","59","633961"
"JH378105","4843930","4844090","KQ055872v1","5870772","5870928","33","1026842"
"JH378105","4958947","4959145","KQ057290v1","4745481","4745684","51","213466"
"JH378105","5050422","5050701","KQ053146v1","2819587","2819868","62","2230835"
"JH378105","5087521","5087828","KQ053816v1","7464708","7465010","57","2377187"
"JH378105","5227745","5227827","KQ054533v1","1814787","1814857","27","3412958"
"JH378105","5228121","5228152","KQ055717v1","1652302","1652326","9","3575819"
"JH378105","5283866","5284128","KQ053299v1","22323868","22324139","70","17040002"
"JH378105","5328730","5329043","KQ054510v1","2681434","2681749","62","2647296"
"JH378105","5532458","5532708","KQ054068v1","2000305","2000565","59","3532153"
"JH378105","5563673","5563965","KQ057118v1","4601602","4601894","64","962071"
"JH378105","5599048","5599357","KQ054179v1","1784791","1785086","83","3814257"
"JH378105","5696350","5696642","KQ055457v1","8436987","8437281","58","2740637"
"JH378105","5703169","5703409","KQ053654v1","3892663","3892904","69","1810506"
"JH378105","5796115","5796451","KQ054510v1","7367073","7367385","95","1570958"
"JH378105","6091920","6092195","KQ054401v1","3111879","3112162","70","2980041"
"JH378105","6607428","6607704","KQ053223v1","590063","590338","64","6017365"
"JH378105","6634420","6634707","KQ055173v1","248885","249169","70","6385535"
"JH378105","6801557","6801702","KQ053643v1","448224","448371","30","6353333"
"JH378105","6802570","6802865","KQ056440v1","1157164","1157460","71","5645406"
"JH378105","6931632","6931924","KQ057560v1","1194310","1194592","70","5737322"
"JH378105","7055458","7055750","KQ058184v1","1505565","1505858","69","5549893"
"JH378105","7206281","7206580","KQ054565v1","2548872","2549165","76","4657409"
"JH378105","7233226","7233484","KQ053332v1","804189","804443","66","6429037"
"JH378105","7559428","7559604","KQ054533v1","2294255","2294433","59","5265173"
"JH378105","7867109","7867232","KQ054510v1","2941967","2942098","27","4925142"
"JH378105","7896147","7896438","KQ054868v1","2066688","2066976","66","5829459"
"JH378105","8009952","8010227","KQ057213v1","1074642","1074915","65","6935310"
"JH378105","8110147","8110458","KQ054682v1","2237365","2237671","68","5872782"
"JH378105","8281797","8282084","KQ056147v1","236639","236927","69","8045158"
"JH378105","8761249","8761551","KQ053476v1","4437256","4437557","67","4323993"
"JH378105","8803949","8804206","KQ054693v1","745323","745572","64","8058626"
"JH378105","9091696","9091929","KQ058317v1","189601","189833","79","8902095"
"JH378105","9351120","9351439","KQ056225v1","48046","48349","77","9303074"
"JH378105","9562273","9562572","KQ055852v1","1231373","1231668","74","8330900"
"JH378105","9832859","9833162","KQ054932v1","10830322","10830609","76","997463"
"JH378105","10087737","10087904","KQ053223v1","2815634","2815800","31","7272103"
"JH378105","10269979","10270318","KQ055893v1","2313607","2313921","106","7956372"
"JH378105","10500943","10501073","KQ053982v1","3934263","3934401","40","6566680"
"JH378105","10523127","10523341","KQ056404v1","77681","77883","51","10445446"
"JH378105","10523938","10524018","KQ057118v1","1020903","1020978","20","9503035"
"JH378105","10708926","10709206","KQ053115v1","1118362","1118655","74","9590564"
"JH378105","11500844","11501062","KQ055247v1","2156838","2157064","63","9344006"
"JH378105","12217677","12217996","KQ055457v1","2061137","2061448","75","10156540"
"JH378105","12775165","12775507","KQ058320v1","1468489","1468793","101","11306676"
"JH378105","12782468","12782599","KQ056404v1","1195188","1195317","22","11587280"
"JH378105","12870475","12870754","KQ053409v1","3716306","3716585","61","9154169"
"JH378105","12887408","12887725","KQ054081v1","1271367","1271690","72","11616041"
"JH378105","12981756","12981873","KQ055777v1","1218556","1218681","39","11763200"
"JH378105","12992626","12992924","KQ053070v1","3622196","3622482","80","9370430"
"JH378105","13049299","13049598","KQ058539v1","1057985","1058283","62","11991314"
"JH378105","13139816","13140105","KQ053299v1","3622388","3622669","64","9517428"
"JH378105","13247548","13247843","KQ058428v1","2055160","2055453","67","11192388"
"JH378105","13278557","13278666","KQ058383v1","8974295","8974399","24","4304262"
"JH378105","13383115","13383298","KQ054510v1","2373994","2374175","48","11009121"
"JH378105","13468293","13468580","KQ054191v1","1890710","1890994","75","11577583"
"JH378105","13561246","13561513","KQ058004v1","1480411","1480689","72","12080835"
"JH378105","13567247","13567548","KQ053816v1","7464708","7465010","66","6102539"
"JH378105","13679415","13679702","KQ054693v1","832788","833076","50","12846627"
"JH378105","13741739","13741908","KQ053827v1","4556306","4556473","37","9185433"
"JH378105","13745372","13745655","KQ055798v1","887234","887524","62","12858138"
"JH378105","13760696","13760958","KQ058427v1","4553509","4553777","68","9207187"
"JH378105","13789185","13789475","KQ058353v1","458843","459133","68","13330342"
"JH378105","13790921","13791196","KQ053409v1","5686466","5686740","56","8104455"
"JH378105","13812990","13813286","KQ053554v1","1157184","1157483","73","12655806"
"JH378105","13951750","13952068","KQ056928v1","2385460","2385767","79","11566290"
"JH378105","14128632","14128941","KQ056493v1","1483561","1483863","72","12645071"
"JH378105","14243332","14243624","KQ056762v1","532889","533183","65","13710443"
"JH378105","14300935","14301228","KQ058561v1","4040393","4040683","71","10260542"
"JH378105","14312419","14312721","KQ055479v1","1841725","1842025","72","12470694"
"JH378105","14314645","14314920","KQ057504v1","162767","163049","65","14151878"
"JH378105","14365642","14365812","KQ057909v1","1828108","1828268","43","12537534"
"JH378105","14465637","14465912","KQ053082v1","1085491","1085778","80","13380146"
"JH378105","14468988","14469278","KQ057560v1","1548733","1549024","65","12920255"
"JH378105","14842865","14843139","KQ053718v1","1496748","1497022","62","13346117"
"JH378105","14911511","14911796","KQ055097v1","1884579","1884874","75","13026932"
"JH378105","14958472","14958648","KQ055352v1","9227221","9227396","41","5731251"
"JH378105","15807758","15808040","KQ054693v1","832788","833076","76","14974970"
"JH378105","16640660","16640953","KQ053081v1","1141867","1142168","71","15498793"
"JH378105","16748684","16748974","KQ054693v1","832788","833076","60","15915896"
"JH378105","16753536","16753639","KQ054179v1","1549328","1549427","40","15204208"
"JH378105","16801339","16801648","KQ052968v1","9583834","9584132","87","7217505"
"JH378105","16924687","16924911","KQ053299v1","6846672","6846867","75","10078015"
"JH378105","16928015","16928287","KQ058275v1","35725","35991","87","16892290"
"JH378105","16931347","16931638","KQ056920v1","144919","145210","61","16786428"
"JH378105","16950860","16951192","KQ058316v1","982603","982911","81","15968257"
"JH378105","17593384","17593600","KQ058438v1","228244","228462","58","17365140"
"JH378105","17729369","17729528","KQ056996v1","1524030","1524195","33","16205339"
"JH378105","18125570","18125837","KQ053409v1","3716306","3716585","69","14409264"
"JH378105","18281010","18281298","KQ057290v1","1053741","1054027","68","17227269"
"JH378105","18339639","18339916","KQ053026v1","3680523","3680807","72","14659116"
"JH378105","18417494","18417677","KQ054933v1","3939617","3939804","40","14477877"
"JH378105","18444594","18444875","KQ056148v1","2419670","2419961","82","16024924"
"JH378105","18453540","18453773","KQ057291v1","322948","323180","60","18130592"
"JH378105","18496747","18497053","KQ058427v1","6207003","6207299","65","12289744"
"JH378105","18570186","18570476","KQ053409v1","3716306","3716585","93","14853880"
"JH378105","18578205","18578492","KQ058184v1","1505565","1505858","57","17072640"
"JH378105","18760650","18760932","KQ053520v1","456408","456696","62","18304242"
"JH378105","19124146","19124453","KQ055248v1","947170","947461","87","18176976"
"JH378105","19720915","19721035","KQ058381v1","951834","951958","29","18769081"
"JH378105","19771346","19771518","KQ056996v1","1524030","1524195","45","18247316"
"JH378105","19804074","19804376","KQ058582v1","2229564","2229861","70","17574510"
"JH378105","20230819","20231048","KQ056108v1","1837748","1837978","57","18393071"
"JH378105","20615685","20615891","KQ055457v1","1904386","1904585","56","18711299"
"JH378105","20729314","20729625","KQ053785v1","807454","807767","67","19921860"
"JH378105","20781227","20781497","KQ053654v1","346478","346752","57","20434749"
"JH378105","20817109","20817358","KQ058537v1","27912","28129","71","20789197"
"JH378105","20982256","20982376","KQ054179v1","3865170","3865294","25","17117086"
"JH378105","21040261","21040556","KQ054786v1","1481220","1481519","67","19559041"
"JH378105","21093404","21093680","KQ052968v1","5194409","5194696","68","15898995"
"JH378105","21188290","21188573","KQ052970v1","6659487","6659775","66","14528803"
"JH378105","21188748","21189022","KQ053409v1","3716306","3716585","62","17472442"
"JH378105","21190066","21190359","KQ056988v1","1068914","1069193","88","20121152"
"JH378105","21264644","21264788","KQ052970v1","11857903","11858038","33","9406741"
"JH378105","21266423","21266541","KQ052969v1","4262458","4262578","27","17003965"
"JH378105","21266627","21266803","KQ053827v1","4556306","4556473","52","16710321"
"JH378105","21309867","21310026","KQ053827v1","4556306","4556473","38","16753561"
"JH378105","21310682","21310756","KQ053465v1","4199536","4199596","26","17111146"
"JH378105","21333219","21333531","KQ055119v1","3293975","3294284","66","18039244"
"JH378105","21350724","21351004","KQ053146v1","2819587","2819868","48","18531137"
"JH378105","21607238","21607560","KQ055766v1","1784472","1784784","80","19822766"
"JH378105","21879984","21880274","KQ053554v1","1105373","1105659","70","20774611"
"JH378105","21918036","21918328","KQ058291v1","415111","415402","70","21502925"
"JH378105","21973027","21973298","KQ053037v1","3640291","3640559","78","18332736"
"JH378105","22003009","22003297","KQ054932v1","10830322","10830609","61","11172687"
"JH378105","22174411","22174708","KQ052984v1","105454","105757","70","22068957"
"JH378105","22229257","22229361","KQ053157v1","8174152","8174260","28","14055105"
"JH378105","22232005","22232336","KQ053343v1","1747702","1748011","93","20484303"
"JH378105","22239160","22239325","KQ056996v1","1524030","1524195","37","20715130"
"JH378105","22325654","22325942","KQ053631v1","7288314","7288608","79","15037340"
"JH378105","22346904","22347122","KQ054704v1","483937","484161","79","21862967"
"JH378105","22372299","22372483","KQ054652v1","6051","6229","48","22366248"
"JH378105","22459142","22459424","KQ053299v1","21375969","21376245","59","1083173"
"JH378105","22462140","22462361","KQ058383v1","8692134","8692359","59","13770006"
"JH378105","22503947","22504241","KQ058004v1","709820","710116","67","21794127"
"JH378105","22520880","22521109","KQ053190v1","4129892","4130119","75","18390988"
"JH378105","22565503","22565707","KQ057290v1","4745481","4745684","45","17820022"
"JH378105","22589766","22590053","KQ053631v1","9116387","9116675","62","13473379"
"JH378105","24066624","24066915","KQ055035v1","3034480","3034786","71","21032144"
"JH378105","24162503","24162657","KQ054576v1","2685252","2685406","40","21477251"
"JH378105","24227014","24227265","KQ055320v1","2365107","2365346","80","21861907"
"JH378105","24315278","24315587","KQ053191v1","3529605","3529913","84","20785673"
"JH378105","24618189","24618344","KQ055978v1","2949687","2949843","29","21668502"
"JH378105","24671842","24672135","KQ056673v1","1151371","1151663","59","23520471"
"JH378105","24815887","24816156","KQ053070v1","1145700","1145952","76","23670187"
"JH378105","24977947","24978225","KQ056254v1","1300375","1300653","74","23677572"
"JH378105","25256927","25257242","KQ055014v1","3227784","3228090","93","22029143"
"JH378105","25266868","25267018","KQ052968v1","10427732","10427888","36","14839136"
"JH378105","25451974","25452252","KQ054510v1","9222042","9222321","82","16229932"
"JH378105","25460053","25460204","KQ053387v1","3508985","3509121","46","21951068"
"JH378105","25460292","25460397","KQ055872v1","5141445","5141541","22","20318847"
"JH378105","25582549","25582813","KQ053609v1","2550928","2551200","63","23031621"
"JH378105","26411322","26411516","KQ055558v1","562625","562811","54","25848697"
"JH378105","26449214","26449363","KQ052968v1","10427732","10427888","33","16021482"
"JH378105","27184592","27184889","KQ056996v1","837133","837431","79","26347459"
"JH378105","27727675","27727845","KQ053223v1","2815634","2815800","39","24912041"
"JH378105","27874502","27874634","KQ053190v1","1502830","1502955","37","26371672"
"JH378105","27901620","27901905","KQ053297v1","44026","44315","72","27857594"
"JH378105","27921790","27922075","KQ058317v1","5506620","5506904","67","22415170"
"JH378105","28349260","28349555","KQ052969v1","9553757","9554052","75","18795503"
"JH378105","28515208","28515492","KQ053093v1","2323068","2323339","79","26192140"
"JH378105","28772375","28772663","KQ056587v1","9000240","9000528","72","19772135"
"JH378105","29026238","29026585","KQ058394v1","13308963","13309304","103","15717275"
"JH378105","29028967","29029276","KQ054682v1","2246019","2246316","74","26782948"
"JH378105","29864229","29864486","KQ053331v1","433337","433605","67","29430892"
"JH378105","29925923","29926217","KQ053297v1","44026","44315","74","29881897"
"JH378105","30126021","30126302","KQ053096v1","602899","603182","65","29523122"
"JH378105","30240961","30241254","KQ053927v1","199693","199992","70","30041268"
"JH378105","30573141","30573452","KQ054932v1","9683849","9684160","65","20889292"
"JH378105","30574012","30574314","KQ053631v1","7288314","7288608","84","23285698"
"JH378105","30795325","30795620","KQ058084v1","24077","24376","63","30771248"
"JH378105","31419317","31419611","KQ052968v1","5470311","5470611","81","25949006"
"JH378105","31446400","31446703","KQ058272v1","6007682","6007982","77","25438718"
"JH378105","31862459","31862755","KQ058494v1","9923631","9923914","80","21938828"
"JH378105","32595899","32596192","KQ053387v1","3571051","3571353","68","29024848"
"JH378105","32810061","32810376","KQ056928v1","1915686","1915996","77","30894375"
"JH378105","33096958","33097039","KQ052970v1","18216359","18216440","16","14880599"
"JH378105","33108077","33108342","KQ058004v1","4701579","4701856","68","28406498"
"JH378105","33116607","33116906","KQ053297v1","44026","44315","72","33072581"
"JH378105","33134379","33134672","KQ053212v1","1248645","1248940","69","31885734"
"JH378105","33252834","33253110","KQ054868v1","2229582","2229854","79","31023252"
"JH378105","33442475","33442735","KQ052968v1","10745715","10745973","61","22696760"
"JH378105","34087091","34087376","KQ052968v1","5865817","5866093","67","28221274"
"JH378105","34121101","34121239","KQ056147v1","2168964","2169108","33","31952137"
"JH378105","34407932","34408197","KQ058004v1","2612564","2612826","68","31795368"
"JH378105","34420184","34420407","KQ058572v1","913074","913293","53","33507110"
"JH378105","34912503","34912783","KQ058485v1","709809","710085","71","34202694"
"JH378105","34922832","34923142","KQ053795v1","1729459","1729773","69","33193373"
"JH378105","35222098","35222392","KQ053300v1","2874445","2874736","74","32347653"
"JH378105","35260478","35260771","KQ054804v1","964015","964313","55","34296463"
"JH378105","35547453","35547626","KQ053609v1","1884265","1884430","45","33663188"
"JH378105","35567249","35567544","KQ053816v1","5837219","5837503","70","29730030"
"JH378105","35623366","35623599","KQ053310v1","2851403","2851646","60","32771963"
"JH378105","35623657","35623938","KQ058550v1","2988133","2988411","66","32635524"
"JH378105","35650473","35650599","KQ056663v1","464182","464321","31","35186291"
"JH378105","35735799","35736108","KQ058413v1","565473","565785","72","35170326"
"JH378105","35780917","35781221","KQ056672v1","3108202","3108500","70","32672715"
"JH378105","35783398","35783694","KQ052968v1","10629964","10630247","65","25153434"
"JH378105","35889910","35890222","KQ053398v1","3445470","3445768","71","32444440"
"JH378105","35960606","35960912","KQ052970v1","8274642","8274940","72","27685964"
"JH378105","36141113","36141383","KQ053665v1","817341","817603","66","35323772"
"JH378105","36351521","36351807","KQ053063v1","238751","239047","74","36112770"
"JH378105","36457715","36457995","KQ053365v1","2996957","2997245","72","33460758"
"JH378105","36569316","36569574","KQ053476v1","1675362","1675619","57","34893954"
"JH378105","36710936","36711086","KQ054180v1","70685","70834","36","36640251"
"JH378105","36717229","36717534","KQ055717v1","2074416","2074712","80","34642813"
"JH378105","36744073","36744300","KQ053299v1","7690856","7691089","70","29053217"
"JH378105","36772080","36772239","KQ053037v1","3255963","3256108","39","33516117"
"JH378105","37100996","37101261","KQ058538v1","1444447","1444703","69","35656549"
"JH378105","37497802","37497973","KQ056996v1","1524030","1524195","40","35973772"
"JH378105","37592008","37592277","KQ057471v1","1722738","1722988","85","35869270"
"JH378105","37603017","37603273","KQ058316v1","4984552","4984820","64","32618465"
"JH378105","37769148","37769428","KQ055142v1","2368287","2368571","77","35400861"
"JH378105","38276829","38277155","KQ058583v1","3101722","3102049","80","35175107"
"JH378105","38294749","38295049","KQ053476v1","3712115","3712409","65","34582634"
"JH378105","38530168","38530468","KQ052969v1","8465928","8466216","73","30064240"
"JH378105","38706184","38706478","KQ058394v1","9107761","9108054","62","29598423"
"JH378105","38712318","38712559","KQ057345v1","1938824","1939073","60","36773494"
"JH378105","38817346","38817673","KQ054412v1","2490468","2490761","81","36326878"
"JH378105","38995388","38995522","KQ053212v1","1220125","1220262","40","37775263"
"JH378105","39017527","39017810","KQ058317v1","5506620","5506904","57","33510907"
"JH378105","39200355","39200646","KQ054401v1","2629005","2629296","68","36571350"
"JH378105","39371299","39371601","KQ053631v1","9631170","9631468","67","29740129"
"JH378105","40333797","40334092","KQ055798v1","887234","887524","69","39446563"
"JH378105","40528793","40529026","KQ053300v1","3018160","3018380","75","37510633"
"JH378105","41184289","41184580","KQ053297v1","44026","44315","87","41140263"
"JH378105","42286410","42286628","KQ052968v1","4264501","4264717","47","38021909"
"JH378105","42356790","42357060","KQ056587v1","474721","474978","73","41882069"
"JH378105","42410067","42410360","KQ053261v1","43496","43784","77","42366571"
"JH378105","42539714","42539765","KQ054135v1","1661841","1661887","12","40877873"
"JH378105","43324560","43324841","KQ058004v1","4701579","4701856","64","38622981"
"JH378105","44555395","44555548","KQ053190v1","2372433","2372579","42","42182962"
"JH378105","45018889","45019193","KQ053948v1","168940","169229","73","44849949"
"JH378105","45289899","45290081","KQ057290v1","248142","248326","48","45041757"
"JH378105","45290086","45290169","KQ057560v1","3159552","3159622","30","42130534"
"JH378105","45323675","45323948","KQ057755v1","45985","46262","82","45277690"
"JH378105","45341040","45341165","KQ054868v1","751727","751851","22","44589313"
"JH378105","45364143","45364414","KQ055735v1","667472","667747","63","44696671"
"JH378105","45369702","45370001","KQ056147v1","1747366","1747648","79","43622336"
"JH378105","45450307","45450550","KQ058094v1","5430881","5431130","67","40019426"
"JH378105","45458207","45458532","KQ055498v1","987179","987479","83","44471028"
"JH378105","45479497","45479789","KQ058291v1","406175","406478","80","45073322"
"JH378105","45628316","45628609","KQ058184v1","1505565","1505858","65","44122751"
"JH378105","45753892","45754177","KQ053631v1","9963313","9963601","66","35790579"
"JH378105","45798388","45798655","KQ053059v1","2135970","2136233","53","43662418"
"JH378105","45840045","45840347","KQ055957v1","1731327","1731617","65","44108718"
"JH378105","45866142","45866423","KQ055468v1","1908448","1908731","54","43957694"
"JH378105","46579061","46579194","KQ055352v1","4659384","4659515","30","41919677"
"JH378105","46650454","46650623","KQ052970v1","15796964","15797136","46","30853490"
"JH378105","47419464","47419766","KQ054279v1","3185335","3185640","62","44234129"
"JH378105","47750378","47750671","KQ057858v1","376905","377209","52","47373473"
"JH378105","48043107","48043319","KQ053256v1","942460","942674","51","47100647"
"JH378105","48043816","48043909","KQ055872v1","3969127","3969217","25","44074689"
"JH378105","48208192","48208265","KQ052970v1","14806680","14806754","14","33401512"
"JH378105","48348280","48348575","KQ057118v1","4601602","4601894","65","43746678"
"JH378105","48418284","48418573","KQ056521v1","155996","156302","79","48262288"
"JH378105","48463026","48463091","KQ053740v1","2775064","2775127","19","45687962"
"JH378105","48790896","48791145","KQ053631v1","8512379","8512600","69","40278517"
"JH378105","48830311","48830599","KQ052969v1","11182978","11183250","77","37647333"
"JH378105","48852517","48852643","KQ054522v1","1628214","1628331","32","47224303"
"JH378105","48891535","48891819","KQ054124v1","2442155","2442433","59","46449380"
"JH378105","49091281","49091393","KQ056493v1","5199606","5199715","29","43891675"
"JH378105","49265438","49265712","KQ056423v1","1792966","1793243","70","47472472"
"JH378105","49295287","49295555","KQ056254v1","1300375","1300653","62","47994912"
"JH378105","49340387","49340469","KQ056643v1","1142508","1142594","27","48197879"
"JH378105","49396200","49396504","KQ053654v1","5318679","5318982","62","44077521"
"JH378105","49507843","49508143","KQ056475v1","2179070","2179363","58","47328773"
"JH378105","49606098","49606403","KQ053816v1","7464708","7465010","61","42141390"
"JH378105","49698929","49699116","KQ057673v1","2220920","2221103","40","47478009"
"JH378105","49731593","49731816","KQ058445v1","325619","325833","51","49405974"
"JH378105","49743190","49743323","KQ053104v1","317902","318035","37","49425288"
"JH378105","49803486","49803674","KQ054725v1","2305706","2305894","49","47497780"
"JH378105","49900413","49900627","KQ058468v1","55206","55436","66","49845207"
"JH378105","49903867","49904165","KQ056973v1","1903580","1903877","79","48000287"
"JH378105","49930924","49931000","KQ058483v1","6093039","6093121","20","43837885"
"JH378105","49931344","49931413","KQ053598v1","1093587","1093662","19","48837757"
"JH378105","49964523","49964617","KQ053498v1","6687279","6687374","32","43277244"
"JH378105","49964638","49964649","KQ055518v1","1367373","1367383","7","48597265"
"JH378105","49965064","49965219","KQ054196v1","237","387","33","49964827"
"JH378105","50193333","50193615","KQ058291v1","474599","474881","64","49718734"
"JH378105","50223515","50223794","KQ053816v1","7464708","7465010","60","42758807"
"JH378105","50779888","50780195","KQ053631v1","7288314","7288608","78","43491574"
"JH378105","51465632","51465791","KQ052968v1","10427732","10427888","31","41037900"
"JH378105","51557451","51557752","KQ054682v1","1577967","1578262","62","49979484"
"JH378105","51624116","51624414","KQ058184v1","1505565","1505858","60","50118551"
"JH378105","51629739","51630051","KQ053299v1","2867160","2867464","72","48762579"
"JH378105","51669820","51669951","KQ056293v1","110261","110385","37","51559559"
"JH378105","51695358","51695673","KQ053037v1","2305956","2306272","72","49389402"
"JH378105","51759970","51760318","KQ058561v1","4558478","4558779","104","47201492"
"JH378105","51775769","51776060","KQ055852v1","1231373","1231668","65","50544396"
"JH378105","51799488","51799800","KQ053740v1","2898644","2898953","71","48900844"
"JH378105","51807664","51807789","KQ053432v1","3920706","3920835","24","47886958"
"JH378105","51807934","51808100","KQ057213v1","476570","476722","41","51331364"
"JH378105","51909415","51909571","KQ054725v1","2033305","2033462","33","49876110"
"JH378105","52184186","52184398","KQ054804v1","89280","89485","64","52094906"
"JH378105","52452225","52452372","KQ058183v1","4244743","4244893","33","48207482"
"JH378105","52526488","52526843","KQ053310v1","2092689","2092989","113","50433799"
"JH378105","52640905","52641094","KQ057629v1","623321","623500","52","52017584"
"JH378105","52641405","52641516","KQ058050v1","918290","918400","25","51723115"
"JH378105","52885636","52885784","KQ054576v1","2685252","2685406","36","50200384"
"JH378105","53275127","53275260","KQ053654v1","4929533","4929667","19","48345594"
"JH378105","53364577","53364855","KQ056493v1","3966936","3967208","72","49397641"
"JH378105","53917058","53917212","KQ055384v1","843998","844147","41","53073060"
"JH378105","54204249","54204529","KQ054693v1","832788","833076","59","53371461"
"JH378105","54531749","54532057","KQ053816v1","7464708","7465010","66","47067041"
"JH378105","54669007","54669280","KQ058272v1","5443874","5444159","69","49225133"
"JH378105","54735249","54735527","KQ053299v1","6282965","6283256","73","48452284"
"JH378105","54845222","54845355","KQ053115v1","1333586","1333718","40","53511636"
"JH378105","54875713","54875905","KQ054068v1","2554856","2555034","63","52320857"
"JH378105","54961061","54961191","KQ053763v1","4935139","4935266","27","50025922"
"JH378105","54961209","54961288","KQ057737v1","356405","356487","21","54604804"
"JH378105","55315547","55315678","KQ053157v1","5621627","5621750","33","49693920"
"JH378105","55397538","55397621","KQ056147v1","2303606","2303683","31","53093932"
"JH378105","55408531","55408799","KQ055173v1","248885","249169","64","55159646"
"JH378105","55630943","55631093","KQ052970v1","12418764","12418905","39","43212179"
"JH378105","56576434","56576588","KQ052968v1","10427732","10427888","34","46148702"
"JH378105","56610393","56610645","KQ054289v1","4355551","4355817","71","52254842"
"JH378105","56619453","56619653","KQ053654v1","4118798","4119013","64","52500655"
"JH378105","56621135","56621435","KQ057911v1","428931","429228","65","56192204"
"JH378105","56724367","56724499","KQ058427v1","4756553","4756686","29","51967814"
"JH378105","57299822","57299961","KQ058589v1","240412","240547","40","57059410"
"JH378105","57339079","57339206","KQ055404v1","2665938","2666066","35","54673141"
"JH378105","58120780","58120931","KQ058350v1","446681","446829","38","57674099"
"JH378105","58120934","58121014","KQ058333v1","1207343","1207422","19","56913591"
"JH378105","58130687","58130794","KQ055364v1","1736501","1736613","27","56394186"
"JH378105","58276031","58276289","KQ057822v1","393915","394169","81","57882116"
"JH378105","58338742","58338820","KQ052970v1","18216359","18216440","27","40122383"
"JH378105","58338828","58339108","KQ056587v1","15594744","15595024","80","42744084"
"JH378105","58613903","58614183","KQ054921v1","2493802","2494087","70","56120101"
"JH378105","58679124","58679250","KQ054047v1","1054810","1054936","23","57624314"
"JH378105","58805302","58805579","KQ058183v1","4736369","4736640","72","54068933"
"JH378105","58903437","58903570","KQ054786v1","479127","479249","31","58424310"
"JH378105","58974490","58974800","KQ057471v1","475360","475647","80","58499130"
"JH378105","59103235","59103553","KQ053288v1","2034811","2035125","71","57068424"
"JH378105","59221341","59221484","KQ052993v1","71964","72092","42","59149377"
"JH378105","59255993","59256067","KQ054412v1","1720542","1720608","21","57535451"
"JH378105","59307992","59308110","KQ054533v1","1811819","1811926","39","57496173"
"JH378105","59373234","59373369","KQ054213v1","615112","615244","29","58758122"
"JH378105","59432981","59433125","KQ054069v1","7038072","7038210","35","52394909"
"JH378105","59436542","59436812","KQ058594v1","300729","301008","80","59135813"
"JH378105","59453988","59454283","KQ056672v1","3082150","3082439","61","56371838"
"JH378105","59485283","59485364","KQ053520v1","1561632","1561710","26","57923651"
"JH378105","59485839","59486044","KQ058505v1","3952082","3952290","51","55533757"
"JH378105","59503631","59503760","KQ057268v1","150223","150357","34","59353408"
"JH378105","59586731","59586978","KQ053310v1","2851403","2851646","54","56735328"
"JH378105","59821011","59821272","KQ053299v1","22323868","22324139","68","37497143"
"JH378105","60438657","60438752","KQ056147v1","2303606","2303683","32","58135051"
"JH378105","60757584","60757894","KQ053398v1","2431232","2431537","77","58326352"
"JH378105","60845813","60846037","KQ057380v1","2047063","2047290","65","58798750"
"JH378105","61045851","61046135","KQ057755v1","45985","46262","70","60999866"
"JH378105","61199137","61199439","KQ057693v1","117172","117472","68","61081965"
"JH378105","61224013","61224290","KQ055044v1","505525","505797","72","60718488"
"JH378105","61344014","61344313","KQ053816v1","6856607","6856902","72","54487407"
"JH378105","61349297","61349596","KQ053816v1","6856607","6856902","72","54492690"
"JH378105","61401168","61401414","KQ058542v1","550732","550973","64","60850436"
"JH378105","61458237","61458520","KQ058561v1","4466656","4466945","67","56991581"
"JH378105","61474389","61474643","KQ056404v1","638131","638387","73","60836258"
"JH378105","61538622","61538806","KQ053774v1","1982290","1982469","55","59556332"
"JH378105","61597154","61597469","KQ056568v1","817681","817996","75","60779473"
"JH378105","61685946","61686222","KQ053146v1","2819587","2819868","71","58866359"
"JH378105","61872366","61872675","KQ052969v1","9116808","9117108","70","52755558"
"JH378105","62148919","62149231","KQ058272v1","6007682","6007982","78","56141237"
"JH378105","62192361","62192496","KQ056643v1","1491838","1491968","22","60700523"
"JH378105","62250001","62250129","KQ053409v1","6105325","6105446","25","56144676"
"JH378105","62250162","62250251","KQ053774v1","1983133","1983216","18","60267029"
"JH378105","62348426","62348678","KQ053498v1","3849819","3850073","62","58498607"
"JH378105","62355848","62356120","KQ053146v1","2819587","2819868","63","59536261"
"JH378105","62404157","62404460","KQ053816v1","7464708","7465010","72","54939449"
"JH378105","62419136","62419266","KQ053432v1","5514393","5514523","23","56904743"
"JH378105","62503699","62503875","KQ054682v1","2336064","2336208","60","60167635"
"JH378105","62695505","62695807","KQ058550v1","3068705","3069008","90","59626800"
"JH378105","62733764","62734030","KQ057788v1","953639","953903","76","61780125"
"JH378105","62956389","62956661","KQ058484v1","1229388","1229668","63","61727001"
"JH378105","63070661","63070797","KQ058281v1","1664150","1664292","31","61406511"
"JH378105","63103119","63103392","KQ056148v1","2246905","2247173","65","60856214"
"JH378105","63153307","63153451","KQ053115v1","1650505","1650644","31","61502802"
"JH378105","63877333","63877487","KQ058527v1","5886961","5887131","47","57990372"
"JH378105","64013923","64014237","KQ056928v1","97902","98210","85","63916021"
"JH378105","64032573","64032840","KQ055119v1","3538344","3538616","62","60494229"
"JH378105","64218782","64218977","KQ053849v1","1126392","1126589","53","63092390"
"JH378105","64316351","64316501","KQ056864v1","2852271","2852420","37","61464080"
"JH378105","64401008","64401233","KQ058427v1","7850908","7851135","52","56550100"
"JH378105","64701213","64701495","KQ053146v1","2819587","2819868","66","61881626"
"JH378105","64717410","64717660","KQ055735v1","1032075","1032317","69","63685335"
"JH378105","64830998","64831295","KQ053816v1","7464708","7465010","66","57366290"
"JH378105","64841817","64841945","KQ053948v1","1299259","1299390","20","63542558"
"JH378105","64974025","64974073","KQ053686v1","2686865","2686920","16","62287160"
"JH378105","65164624","65164922","KQ058328v1","6293951","6294242","65","58870673"
"JH378105","65218090","65218383","KQ053190v1","5495992","5496283","66","59722098"
"JH378105","65294966","65295047","KQ053598v1","1093587","1093662","24","64201379"
"JH378105","65349174","65349463","KQ053631v1","9963313","9963601","65","55385861"
"JH378105","65358192","65358434","KQ054069v1","928440","928688","64","64429752"
"JH378105","67090088","67090383","KQ058316v1","2150959","2151268","74","64939129"
"JH378105","68078825","68079125","KQ056493v1","3974454","3974746","68","64104371"
"JH378105","68217660","68217790","KQ053354v1","702320","702452","27","67515340"
"JH378105","68403138","68403197","KQ053465v1","4199536","4199596","19","64203602"
"JH378105","68403399","68403566","KQ055214v1","4014336","4014483","60","64389063"
"JH378105","68850507","68850639","KQ055957v1","554477","554608","25","68296030"
"JH378105","68940168","68940472","KQ058184v1","1505565","1505858","64","67434603"
"JH378105","69276741","69276840","KQ058253v1","973922","974008","26","68302819"
"JH378105","69982393","69982649","KQ058272v1","6539142","6539400","67","63443251"
"JH378105","70035955","70036242","KQ055353v1","1973943","1974227","60","68062012"
"JH378105","70334757","70335103","KQ058288v1","34632","34947","85","70300125"
"JH378105","71246726","71247009","KQ053696v1","289251","289545","59","70957475"
"JH378105","72015428","72015699","KQ058190v1","350088","350375","56","71665340"
"JH378105","72090098","72090407","KQ054213v1","780092","780393","60","71310006"
"JH378106","21382","21673","KQ058272v1","5519908","5520197","66","5498526"
"JH378106","25193","25368","KQ054179v1","1173116","1173284","51","1147923"
"JH378106","138560","138734","KQ058313v1","3485903","3486070","35","3347343"
"JH378106","221961","222104","KQ053190v1","2372433","2372579","34","2150472"
"JH378106","233775","233940","KQ054565v1","627778","627936","41","394003"
"JH378106","516355","516570","KQ057840v1","234828","235046","48","281527"
"JH378106","697365","697662","KQ058184v1","1505565","1505858","56","808200"
"JH378106","707809","707973","KQ057291v1","765415","765578","39","57606"
"JH378106","828712","829010","KQ056643v1","815328","815625","79","13384"
"JH378106","1312110","1312418","KQ058272v1","4942871","4943179","72","3630761"
"JH378106","1347563","1347873","KQ054693v1","832788","833076","82","514775"
"JH378106","1404139","1404421","KQ056320v1","1284429","1284707","74","119710"
"JH378106","1406365","1406522","KQ053157v1","4288391","4288538","41","2882026"
"JH378106","1496801","1497079","KQ057260v1","588691","588975","74","908110"
"JH378106","1535094","1535151","KQ054279v1","852960","853011","14","682134"
"JH378106","1632469","1632609","KQ058405v1","1518051","1518190","36","114418"
"JH378106","1691523","1691729","KQ053354v1","1104956","1105153","57","586567"
"JH378106","1904566","1904858","KQ053816v1","7474325","7474608","63","5569759"
"JH378106","2314766","2315061","KQ058539v1","1057985","1058283","67","1256781"
"JH378106","2411181","2411496","KQ055787v1","694393","694708","71","1716788"
"JH378106","2612597","2612877","KQ052982v1","924564","924846","81","1688033"
"JH378106","2841375","2841669","KQ056855v1","4111147","4111444","66","1269772"
"JH378106","2902260","2902427","KQ055425v1","1445594","1445758","40","1456666"
"JH378106","3232341","3232628","KQ056404v1","1771928","1772196","72","1460413"
"JH378106","4169865","4170146","KQ054954v1","2363040","2363310","84","1806825"
"JH378106","4695291","4695443","KQ053741v1","1690943","1691088","33","3004348"
"JH378106","4695522","4695622","KQ055903v1","184486","184598","28","4511036"
"JH378106","4806021","4806313","KQ052990v1","293181","293473","74","4512840"
"JH378106","5057143","5057284","KQ054510v1","8179279","8179421","30","3122136"
"JH378106","6253412","6253710","KQ057380v1","2738009","2738301","71","3515403"
"JH378106","6253874","6254171","KQ058315v1","658193","658490","57","5595681"
"JH378106","6283043","6283306","KQ055629v1","27732","27989","58","6255311"
"JH378106","6332167","6332265","KQ055872v1","5141445","5141541","17","1190722"
"JH378106","6386398","6386679","KQ057532v1","2338800","2339085","81","4047598"
"JH378106","6398009","6398277","KQ058503v1","123813","124064","64","6274196"
"JH378106","6435879","6436168","KQ053299v1","163998","164280","76","6271881"
"JH378106","6456781","6456878","KQ055572v1","5736","5831","29","6451045"
"JH378106","6457055","6457184","KQ054943v1","3395301","3395419","43","3061754"
"JH378106","6469828","6469952","KQ058405v1","1752866","1752986","26","4716962"
"JH378106","6470132","6470281","KQ056234v1","319108","319254","43","6151024"
"JH378106","6545935","6546197","KQ053115v1","1246859","1247104","70","5299076"
"JH378106","6585321","6585652","KQ054933v1","1587290","1587623","108","4998031"
"JH378106","6619222","6619384","KQ053971v1","2499842","2500000","49","4119380"
"JH378106","6739961","6740241","KQ053059v1","3865389","3865665","69","2874572"
"JH378106","6824099","6824417","KQ053135v1","3156167","3156481","66","3667932"
"JH378106","6839158","6839449","KQ058184v1","1505565","1505858","71","5333593"
"JH378106","6886794","6887074","KQ053212v1","3080111","3080401","78","3806683"
"JH378106","6921840","6921967","KQ053115v1","1333586","1333718","19","5588254"
"JH378106","6925784","6926105","KQ053785v1","807454","807767","104","6118330"
"JH378106","6975533","6975659","KQ055352v1","6062328","6062459","37","913205"
"JH378106","7043155","7043291","KQ053354v1","702320","702452","27","6340835"
"JH378106","7059344","7059490","KQ055406v1","2968","3106","34","7056376"
"JH378106","7073351","7073437","KQ052969v1","1110869","1110946","19","5962482"
"JH378106","7268191","7268456","KQ054826v1","9969237","9969502","70","2701046"
"JH378106","8631343","8631507","KQ057805v1","1648140","1648302","43","6983203"
"JH378106","8673492","8673613","KQ053609v1","1892948","1893072","28","6780544"
"JH378106","8673707","8673807","KQ058483v1","2767088","2767193","30","5906619"
"JH378106","9208410","9208684","KQ055457v1","6834638","6834917","67","2373772"
"JH378106","9365668","9365960","KQ054693v1","832788","833076","57","8532880"
"JH378106","9427567","9427732","KQ056996v1","1524030","1524195","34","7903537"
"JH378106","9444778","9445071","KQ052969v1","9553757","9554052","64","108979"
"JH378106","9471466","9471750","KQ053093v1","1361295","1361576","69","8110171"
"JH378106","9478669","9478979","KQ055490v1","442825","443132","79","9035844"
"JH378106","9516578","9516676","KQ053838v1","1840604","1840696","29","7675974"
"JH378106","9524301","9524439","KQ054533v1","748660","748796","44","8775641"
"JH378106","9535073","9535299","KQ058516v1","2391279","2391485","71","7143794"
"JH378106","9581464","9581768","KQ058539v1","1057985","1058283","70","8523479"
"JH378106","9617492","9617777","KQ054069v1","5704070","5704362","65","3913422"
"JH378106","9710315","9710616","KQ055044v1","89244","89545","78","9621071"
"JH378106","9722669","9722745","KQ053048v1","2691541","2691623","18","7031128"
"JH378106","9757867","9758168","KQ056673v1","1151371","1151663","87","8606496"
"JH378106","9866871","9867146","KQ058113v1","209342","209622","65","9657529"
"JH378106","9906058","9906150","KQ055394v1","1859853","1859939","27","8046205"
"JH378106","9984121","9984399","KQ056456v1","827977","828265","71","9156144"
"JH378106","10079297","10079559","KQ056773v1","122800","123057","62","9956497"
"JH378106","10549078","10549214","KQ053026v1","2906402","2906536","50","7642676"
"JH378106","10998456","10998747","KQ053631v1","9398334","9398603","69","1600122"
"JH378106","11472072","11472344","KQ058627v1","276273","276537","70","11195799"
"JH378106","12042655","12042924","KQ055662v1","4683524","4683789","75","7359131"
"JH378106","12069252","12069403","KQ055717v1","807828","807977","37","11261424"
"JH378106","12359263","12359496","KQ053476v1","4704452","4704683","79","7654811"
"JH378106","12851325","12851620","KQ053959v1","5527939","5528237","89","7323386"
"JH378106","13548086","13548381","KQ053960v1","70067","70362","63","13478019"
"JH378106","13570621","13570934","KQ053343v1","1747702","1748011","67","11822919"
"JH378106","13771754","13772025","KQ058004v1","2612564","2612826","70","11159190"
"JH378106","14259368","14259554","KQ053332v1","848203","848389","42","13411165"
"JH378106","14413976","14414072","KQ058427v1","6152893","6152991","28","8261083"
"JH378106","15247812","15248093","KQ055119v1","848363","848641","65","14399449"
"JH378106","15820850","15821131","KQ058483v1","1448388","1448679","74","14372462"
"JH378106","15975888","15976179","KQ058184v1","1505565","1505858","66","14470323"
"JH378106","16062875","16063177","KQ058184v1","1505565","1505858","72","14557310"
"JH378106","16115830","16116108","KQ058249v1","184192","184468","73","15931638"
"JH378106","16246836","16246908","KQ053520v1","4894874","4894935","27","11351962"
"JH378106","16335848","16335948","KQ053465v1","1602887","1602984","36","14732961"
"JH378106","16363684","16363972","KQ055468v1","203615","203906","72","16160069"
"JH378106","16414116","16414383","KQ058283v1","1694307","1694568","66","14719809"
"JH378106","16457579","16457895","KQ058305v1","2795843","2796149","78","13661736"
"JH378106","16624306","16624606","KQ053631v1","5081194","5081497","74","11543112"
"JH378106","16729973","16730179","KQ053849v1","1126392","1126589","51","15603581"
"JH378106","17015711","17015989","KQ057151v1","982137","982421","71","16033574"
"JH378106","17442960","17443259","KQ053741v1","839656","839949","83","16603304"
"JH378106","17488774","17489041","KQ057910v1","2537338","2537606","59","14951436"
"JH378106","18011141","18011416","KQ054704v1","985921","986190","68","17025220"
"JH378106","18183462","18183779","KQ055457v1","2061137","2061448","69","16122325"
"JH378106","18556463","18556586","KQ053299v1","20832561","20832685","35","2276098"
"JH378106","19211925","19212185","KQ053959v1","6189151","6189431","75","13022774"
"JH378106","19978963","19979110","KQ054682v1","606323","606472","34","19372640"
"JH378106","20176064","20176345","KQ055352v1","9449634","9449904","74","10726430"
"JH378106","21434134","21434265","KQ054081v1","697724","697856","24","20736410"
"JH378106","21443150","21443424","KQ053310v1","2851403","2851646","77","18591747"
"JH378106","21533375","21533650","KQ053520v1","2992926","2993205","67","18540449"
"JH378106","21627951","21628243","KQ053026v1","3680523","3680807","72","17947428"
"JH378106","21713200","21713331","KQ058257v1","652425","652556","28","21060775"
"JH378106","21806067","21806156","KQ055872v1","3969127","3969217","28","17836940"
"JH378106","21806526","21806674","KQ053190v1","2372433","2372579","42","19434093"
"JH378106","21827967","21828254","KQ052969v1","11082995","11083279","54","10744972"
"JH378106","21852144","21852408","KQ053849v1","2872588","2872865","65","18979556"
"JH378106","21860028","21860358","KQ055787v1","694393","694708","80","21165635"
"JH378106","21956969","21957101","KQ053146v1","2683242","2683362","38","19273727"
"JH378106","21998740","21999054","KQ053420v1","122023","122324","79","21876717"
"JH378106","22303631","22303805","KQ056475v1","3672925","3673096","44","18630706"
"JH378106","22915481","22915783","KQ053816v1","7327018","7327317","79","15588463"
"JH378106","23104381","23104677","KQ058433v1","410816","411110","69","22693565"
"JH378106","23127452","23127647","KQ054932v1","4858901","4859108","48","18268551"
"JH378106","23723051","23723294","KQ058503v1","123813","124064","64","23599238"
"JH378106","24004809","24005092","KQ053191v1","614334","614618","76","23390475"
"JH378106","24856702","24857009","KQ054786v1","1481220","1481519","86","23375482"
"JH378106","25047964","25048259","KQ054725v1","2218271","2218569","64","22829693"
"JH378106","25171452","25171722","KQ053982v1","5797999","5798259","81","19373453"
"JH378106","25206516","25206729","KQ058339v1","5944070","5944289","54","19262446"
"JH378106","25223877","25223978","KQ057909v1","11088334","11088435","25","14135543"
"JH378106","25391130","25391385","KQ052970v1","2715607","2715860","67","22675523"
"JH378106","25401334","25401619","KQ053332v1","447571","447853","59","24953763"
"JH378106","25402289","25402478","KQ054213v1","1200564","1200764","50","24201725"
"JH378106","25446306","25446446","ABDC02047922v1","197","340","39","25446109"
"JH378106","25523627","25523883","KQ058643v1","858469","858727","70","24665158"
"JH378106","25954834","25955064","KQ053082v1","6710764","6711025","76","19244070"
"JH378106","25955244","25955358","KQ055394v1","2370199","2370316","35","23585045"
"JH378106","26069720","26070042","KQ055236v1","2049624","2049930","75","24020096"
"JH378106","26246266","26246542","KQ058516v1","945634","945904","76","25300632"
"JH378106","26452934","26453198","KQ057290v1","2469746","2470009","76","23983188"
"JH378106","26784351","26784504","KQ052969v1","10341601","10341760","35","16442750"
"JH378106","26956453","26956738","KQ058389v1","660695","660988","70","26295758"
"JH378106","27032503","27032795","KQ058184v1","1505565","1505858","73","25526938"
"JH378106","27298911","27299053","KQ056147v1","2168964","2169108","33","25129947"
"JH378106","27464158","27464423","KQ057345v1","1938824","1939073","66","25525334"
"JH378106","27509539","27509834","KQ054725v1","2218271","2218569","67","25291268"
"JH378106","27631380","27631638","KQ054932v1","3933819","3934068","66","23697561"
"JH378106","27680246","27680547","KQ055767v1","2455394","2455703","70","25224852"
"JH378106","27683574","27683856","KQ053827v1","4198964","4199247","66","23484610"
"JH378106","27700795","27701050","KQ053465v1","4158086","4158345","63","23542709"
"JH378106","27832493","27832615","KQ052969v1","2661859","2661968","31","25170634"
"JH378106","28111207","28111303","KQ053498v1","6687279","6687374","20","21423928"
"JH378106","28111462","28111637","KQ055479v1","2601433","2601611","41","25510029"
"JH378106","28115744","28116066","KQ053410v1","2509930","2510247","79","25605814"
"JH378106","28124079","28124357","KQ057931v1","399684","399967","75","27724395"
"JH378106","28263301","28263591","KQ055852v1","1231373","1231668","64","27031928"
"JH378106","28270448","28270758","KQ053816v1","7464708","7465010","75","20805740"
"JH378106","28321360","28321627","KQ054693v1","837377","837666","75","27483983"
"JH378106","28346737","28346954","KQ055651v1","4351956","4352174","62","23994781"
"JH378106","28357537","28357673","KQ054069v1","4083160","4083297","33","24274377"
"JH378106","28357869","28358006","KQ052968v1","13532913","13533048","34","14824956"
"JH378106","28466444","28466754","KQ053795v1","1729459","1729773","64","26736985"
"JH378106","28554597","28554895","KQ058490v1","420741","421044","80","28133856"
"JH378106","28712524","28712819","KQ056432v1","1593337","1593624","74","27119187"
"JH378106","28834116","28834399","KQ056773v1","168010","168288","70","28666106"
"JH378106","29148630","29148813","KQ057781v1","1031280","1031456","45","28117350"
"JH378106","29379606","29379905","KQ054725v1","2218271","2218569","64","27161335"
"JH378106","29381395","29381626","KQ054069v1","159011","159235","56","29222384"
"JH378106","29508985","29509237","KQ057290v1","2469746","2470009","65","27039239"
"JH378106","29598022","29598298","KQ055852v1","2060276","2060554","69","27537746"
"JH378106","29912127","29912239","KQ058328v1","5454635","5454751","31","24457492"
"JH378106","29969855","29970133","KQ054124v1","4347479","4347753","66","25622376"
"JH378106","30090691","30090863","KQ057397v1","306237","306400","39","29784454"
"JH378106","30302237","30302523","KQ055755v1","1393655","1393946","70","28908582"
"JH378106","31354104","31354396","KQ053631v1","7288314","7288608","58","24065790"
"JH378106","31459094","31459379","KQ053520v1","456408","456696","59","31002686"
"JH378106","31487012","31487078","KQ053620v1","931136","931196","25","30555876"
"JH378106","31487476","31487639","KQ055735v1","2321269","2321424","32","29166207"
"JH378106","32165683","32165846","KQ053082v1","2181762","2181924","37","29983921"
"JH378106","32187051","32187385","KQ053554v1","2471177","2471484","99","29715874"
"JH378106","32761038","32761270","KQ056762v1","1558119","1558341","56","31202919"
"JH378106","32764452","32764522","KQ055979v1","1425","1498","15","32763027"
"JH378106","32834213","32834511","KQ058184v1","1505565","1505858","67","31328648"
"JH378106","33128552","33128857","KQ054191v1","4157356","4157666","72","28971196"
"JH378106","33164683","33164953","KQ053202v1","590990","591274","71","32573693"
"JH378106","33291172","33291460","KQ055394v1","3441211","3441489","71","29849961"
"JH378106","33345958","33346094","KQ052968v1","8523342","8523490","38","24822616"
"JH378106","33397924","33398244","KQ055236v1","313643","313956","81","33084281"
"JH378106","33640002","33640291","KQ057118v1","4601602","4601894","64","29038400"
"JH378106","34172506","34172674","KQ056996v1","1524030","1524195","42","32648476"
"JH378106","34895576","34895724","KQ053741v1","1690943","1691088","35","33204633"
"JH378106","35041413","35041663","KQ055203v1","1891285","1891537","73","33150128"
"JH378106","35116742","35117016","KQ055978v1","3560415","3560681","76","31556327"
"JH378106","35216042","35216181","KQ056147v1","2168964","2169108","30","33047078"
"JH378106","35652123","35652414","KQ053520v1","3826144","3826443","82","31825979"
"JH378106","36127255","36127540","KQ058350v1","6740286","6740580","68","29386969"
"JH378106","36209560","36209870","KQ058184v1","1505565","1505858","74","34703995"
"JH378106","36361828","36361995","KQ058459v1","469480","469653","41","35892348"
"JH378106","37676776","37676850","KQ054815v1","618062","618122","24","37058714"
"JH378106","37754866","37755021","KQ058297v1","117665","117816","35","37637201"
"JH378106","37819459","37819756","KQ052968v1","5668114","5668408","67","32151345"
"JH378106","37853593","37853875","KQ058427v1","4553509","4553777","74","33300084"
"JH378106","38066012","38066295","KQ053115v1","1118362","1118655","66","36947650"
"JH378106","38124799","38125009","KQ058242v1","892038","892246","53","37232761"
"JH378106","38415711","38415833","KQ054412v1","2196456","2196568","41","36219255"
"JH378106","38494232","38494479","KQ058616v1","1966485","1966734","68","36527747"
"JH378106","38821041","38821327","KQ053093v1","1361295","1361576","77","37459746"
"JH378106","39772807","39773119","KQ058450v1","2960681","2960988","66","36812126"
"JH378106","40424405","40424698","KQ052968v1","13260777","13261056","83","27163628"
"JH378106","40851751","40852032","KQ055036v1","1478515","1478803","79","39373236"
"JH378106","41065265","41065556","KQ057004v1","1506143","1506432","79","39559122"
"JH378106","41629852","41630112","KQ056672v1","4169432","4169691","65","37460420"
"JH378106","41660611","41660806","KQ058427v1","6736144","6736323","57","34924467"
"JH378106","41661855","41662130","KQ055035v1","4381466","4381744","63","37280389"
"JH378106","41678652","41678979","KQ053343v1","1729289","1729583","90","39949363"
"JH378106","41704548","41704839","KQ057290v1","1053741","1054027","60","40650807"
"JH378106","41792145","41792432","KQ053398v1","11302","11591","71","41780843"
"JH378106","42301021","42301277","KQ054180v1","2132402","2132657","69","40168619"
"JH378106","42320684","42320912","KQ053631v1","5569446","5569674","63","36751238"
"JH378106","42657193","42657505","KQ056475v1","14677","14970","82","42642516"
"JH378106","43050937","43051149","KQ053398v1","3158290","3158500","60","39892647"
"JH378106","43239842","43240086","KQ056044v1","570262","570509","65","42669580"
"JH378106","43281035","43281351","KQ055141v1","1054026","1054336","76","42227009"
"JH378106","43919569","43919874","KQ057290v1","2953971","2954265","88","40965598"
"JH378106","44084533","44084800","KQ054868v1","2229582","2229854","62","41854951"
"JH378106","44685893","44686181","KQ055725v1","1064759","1065040","70","43621134"
"JH378106","44713837","44714143","KQ053398v1","2431232","2431537","65","42282605"
"JH378106","45195284","45195592","KQ057449v1","1989308","1989615","72","43205976"
"JH378106","45215419","45215543","KQ053299v1","6849474","6849602","24","38365945"
"JH378106","45237610","45237899","KQ057290v1","1053741","1054027","63","44183869"
"JH378106","45294133","45294492","KQ056456v1","1767773","1768093","107","43526360"
"JH378106","45550877","45551057","KQ053948v1","3061823","3062004","53","42489054"
"JH378106","45605815","45606009","KQ057480v1","674678","674843","65","44931137"
"JH378106","45785713","45785996","KQ053081v1","6443105","6443391","70","39342608"
"JH378106","45789097","45789433","KQ054682v1","3645921","3646228","95","42143176"
"JH378106","46066487","46066704","KQ054576v1","2775916","2776136","54","43290571"
"JH378106","46066709","46066883","KQ058328v1","3794482","3794646","48","42272227"
"JH378106","46118780","46119058","KQ056973v1","2328262","2328562","79","43790518"
"JH378106","46419260","46419569","KQ053554v1","2471177","2471484","64","43948083"
"JH378106","46440903","46441219","KQ053554v1","2471177","2471484","81","43969726"
"JH378106","48580626","48580845","KQ054279v1","1133071","1133299","63","47447555"
"JH378106","48826895","48827097","KQ054921v1","3806549","3806756","52","45020346"
"JH378106","48829024","48829172","KQ054606v1","554177","554332","59","48274847"
"JH378106","48895950","48896111","KQ054576v1","2685252","2685406","41","46210698"
"JH378106","48897073","48897204","KQ055192v1","1759958","1760089","26","47137115"
"JH378106","48916165","48916467","KQ052981v1","658787","659079","72","48257378"
"JH378106","49013361","49013689","KQ053190v1","6808669","6808952","94","42204692"
"JH378106","49034077","49034238","KQ057291v1","765415","765578","35","48268662"
"JH378106","49167509","49167786","KQ056432v1","1593337","1593624","72","47574172"
"JH378106","49532991","49533225","KQ058501v1","262278","262510","68","49270713"
"JH378106","49782763","49783001","KQ054693v1","3245566","3245803","67","46537197"
"JH378106","49918244","49918547","KQ058272v1","6007682","6007982","60","43910562"
"JH378106","50608053","50608339","KQ058594v1","1719198","1719477","74","48888855"
"JH378106","51245917","51246202","KQ058427v1","7552507","7552810","82","43693410"
"JH378106","51257390","51257521","KQ054932v1","5248320","5248439","38","46009070"
"JH378106","51504255","51504531","KQ053093v1","1361295","1361576","77","50142960"
"JH378106","51516553","51516690","KQ053190v1","4771351","4771483","32","46745202"
"JH378106","51590127","51590390","KQ057821v1","37392","37663","63","51552735"
"JH378106","51685800","51686050","KQ055725v1","3090816","3091074","64","48594984"
"JH378106","51706103","51706381","KQ056147v1","236639","236927","77","51469464"
"JH378106","51786274","51786555","KQ055957v1","1731327","1731617","66","50054947"
"JH378106","51823017","51823318","KQ053299v1","2867160","2867464","75","48955857"
"JH378106","51995138","51995396","KQ054026v1","2067640","2067906","69","49927498"
"JH378106","52830809","52831134","KQ053278v1","1984227","1984541","84","50846582"
"JH378106","52854119","52854392","KQ058291v1","474599","474881","62","52379520"
"JH378106","53007873","53008044","KQ056996v1","1524030","1524195","38","51483843"
"JH378106","53075430","53075748","KQ053795v1","1729459","1729773","82","51345971"
"JH378106","53115371","53115519","KQ056147v1","2168964","2169108","24","50946407"
"JH378106","53771457","53771681","KQ054848v1","194460","194660","63","53576997"
"JH378106","53847005","53847266","KQ057161v1","335610","335854","69","53511395"
"JH378106","54256171","54256373","KQ053354v1","1104956","1105153","49","53151215"
"JH378106","54540032","54540091","KQ052968v1","8156468","8156529","18","46383564"
"JH378106","54540211","54540303","KQ053223v1","2552349","2552442","27","51987862"
"JH378106","54711494","54711774","KQ058242v1","597390","597671","77","54114104"
"JH378106","54750580","54750730","KQ053916v1","1573932","1574091","44","53176648"
"JH378106","55024601","55024849","KQ057345v1","1938824","1939073","73","53085777"
"JH378106","56228406","56228657","KQ058585v1","28595","28845","73","56199811"
"JH378106","56877372","56877542","KQ058572v1","3607755","3607912","52","53269617"
"JH378106","56905218","56905335","KQ053070v1","2111294","2111415","26","54793924"
"JH378106","56954293","56954412","KQ058328v1","3089025","3089146","28","53865268"
"JH378106","56954658","56954805","KQ056587v1","7257462","7257612","37","49697196"
"JH378106","56954835","56954845","KQ053299v1","15691903","15691914","2","41262932"
"JH378106","57664262","57664564","KQ054510v1","8555095","8555387","67","49109167"
"JH378106","57915480","57915778","KQ057693v1","621833","622123","78","57293647"
"JH378106","58010420","58010577","KQ054510v1","3803526","3803690","38","54206894"
"JH378106","58137262","58137518","KQ057404v1","796061","796320","77","57341201"
"JH378106","58265640","58265734","KQ054179v1","1339277","1339369","23","56926363"
"JH378106","58278829","58279009","KQ056147v1","3323","3476","49","58275506"
"JH378106","58287772","58288103","KQ054786v1","934497","934799","94","57353275"
"JH378106","58537770","58537899","KQ055298v1","1575436","1575566","27","56962334"
"JH378106","58577483","58577798","KQ057875v1","404539","404839","72","58172944"
"JH378106","58758614","58758758","KQ053278v1","1213411","1213560","28","57545203"
"JH378106","58827185","58827451","KQ053696v1","3248742","3249021","70","55578443"
"JH378106","59127685","59127980","KQ054356v1","1356188","1356481","64","57771497"
"JH378106","59137288","59137581","KQ058350v1","6740286","6740580","74","52397002"
"JH378106","59499750","59500000","KQ053520v1","2840509","2840769","69","56659241"
"JH378106","59600977","59601130","KQ058381v1","517901","518051","36","59083076"
"JH378106","59655253","59655354","KQ058506v1","612587","612671","29","59042666"
"JH378106","59830909","59831133","KQ053487v1","3972854","3973080","50","55858055"
"JH378106","59862644","59862771","KQ055258v1","3274072","3274190","30","56588572"
"JH378106","59873041","59873376","KQ055236v1","313643","313956","81","59559398"
"JH378106","60284437","60284721","KQ054191v1","1535022","1535313","71","58749415"
"JH378106","60336579","60336866","KQ058572v1","2655736","2656027","67","57680843"
"JH378106","60635403","60635684","KQ056157v1","875015","875294","64","59760388"
"JH378106","60804730","60804860","KQ055498v1","86970","87098","27","60717760"
"JH378106","60859392","60859585","KQ057764v1","2088730","2088934","67","58770662"
"JH378106","60945616","60945892","KQ053774v1","3529459","3529722","69","57416157"
"JH378106","61020028","61020166","KQ053354v1","702320","702452","21","60317708"
"JH378106","61111455","61111749","KQ058313v1","660634","660924","63","60450821"
"JH378106","61222232","61222554","KQ054400v1","4672799","4673099","88","56549433"
"JH378106","61297801","61298063","KQ058550v1","2724421","2724683","65","58573380"
"JH378106","61333583","61333883","KQ054191v1","3857584","3857880","64","57475999"
"JH378106","61416720","61416885","KQ053082v1","2181762","2181924","38","59234958"
"JH378106","61587953","61588107","KQ055425v1","1445594","1445758","37","60142359"
"JH378106","61593553","61593808","KQ055662v1","4683524","4683789","69","56910029"
"JH378106","61625635","61625825","KQ052968v1","13131640","13131834","44","48493995"
"JH378106","61641374","61641683","KQ053343v1","1747702","1748011","63","59893672"
"JH378106","61776930","61777135","KQ057290v1","4745481","4745684","49","57031449"
"JH378106","62284708","62285002","KQ053520v1","848167","848461","66","61436541"
"JH378106","62473129","62473428","KQ054725v1","2218271","2218569","69","60254858"
"JH378106","62962266","62962431","KQ053190v1","5047993","5048157","48","57914273"
"JH378106","63046517","63046628","KQ057883v1","26280","26392","25","63020237"
"JH378106","63257310","63257409","KQ058427v1","6152893","6152991","25","57104417"
"JH378106","63257679","63257811","KQ052970v1","4661614","4661744","23","58596065"
"JH378106","63268281","63268511","KQ055978v1","5166519","5166749","51","58101762"
"JH378106","63329141","63329250","KQ055651v1","2477255","2477367","31","60851886"
"JH378106","63590355","63590551","KQ054191v1","642274","642457","60","62948081"
"JH378106","63633471","63633747","KQ055065v1","1117201","1117481","59","62516270"
"JH378106","63641366","63641486","KQ056147v1","1962111","1962234","21","61679255"
"JH378106","63642277","63642439","KQ055872v1","9395394","9395552","35","54246883"
"JH378106","63649452","63649758","KQ053816v1","7464708","7465010","68","56184744"
"JH378106","63779378","63779623","KQ056147v1","3491603","3491838","74","60287775"
"JH378106","64022334","64022627","KQ052981v1","658787","659079","61","63363547"
"JH378106","64049876","64050025","KQ052970v1","12418764","12418905","36","51631112"
"JH378106","64296140","64296421","KQ054345v1","1874793","1875073","63","62421347"
"JH378106","64325492","64325703","KQ056996v1","148346","148555","44","64177146"
"JH378106","64380988","64381274","KQ053288v1","2756106","2756392","73","61624882"
"JH378106","64399565","64399860","KQ053465v1","3609319","3609610","67","60790246"
"JH378106","64450103","64450396","KQ053565v1","3797961","3798259","77","60652142"
"JH378106","64466884","64467141","KQ055352v1","14158369","14158624","75","50308515"
"JH378106","64491719","64491853","KQ057910v1","1548802","1548933","29","62942917"
"JH378106","64533753","64534059","KQ052969v1","9114256","9114521","99","55419497"
"JH378106","64557208","64557470","KQ054400v1","2059350","2059621","72","62497858"
"JH378106","64591980","64592114","KQ056673v1","833514","833652","29","63758466"
"JH378106","64605575","64605871","KQ052981v1","658787","659079","73","63946788"
"JH378106","64675308","64675472","KQ053115v1","4093406","4093574","33","60581902"
"JH378106","64908598","64908750","KQ054533v1","1027813","1027974","37","63880785"
"JH378106","64969680","64969988","KQ054682v1","2125705","2126015","64","62843975"
"JH378106","65008359","65008632","KQ052970v1","6659487","6659775","68","58348872"
"JH378106","65018439","65018569","KQ055957v1","554477","554608","26","64463962"
"JH378106","65049276","65049566","KQ052970v1","6659487","6659775","76","58389789"
"JH378106","65124918","65125077","KQ055819v1","854516","854671","40","64270402"
"JH378106","65997406","65997671","KQ053297v1","44026","44315","68","65953380"
"JH378106","66094599","66094888","KQ054660v1","2994204","2994490","59","63100395"
"JH378106","66110397","66110572","KQ058571v1","931737","931906","39","65178660"
"JH378106","66138651","66138934","KQ055468v1","1908448","1908731","70","64230203"
"JH378106","66171105","66171409","KQ055247v1","1248490","1248795","67","64922615"
"JH378106","66183635","66183934","KQ056790v1","446564","446855","59","65737071"
"JH378106","66219430","66219561","KQ052970v1","4661614","4661744","25","61557816"
"JH378106","66231619","66231833","KQ057737v1","1779203","1779413","53","64452416"
"JH378106","66232603","66232897","KQ053115v1","1118362","1118655","73","65114241"
"JH378106","66233871","66234168","KQ057693v1","713533","713827","67","65520338"
"JH378106","66599819","66600136","KQ053035v1","112316","112619","79","66487503"
"JH378106","66612468","66612688","KQ054069v1","159011","159235","61","66453457"
"JH378106","66761213","66761519","KQ056440v1","658042","658344","72","66103171"
"JH378106","66839643","66839806","KQ057649v1","424252","424417","40","66415391"
"JH378106","67077318","67077453","KQ054279v1","76889","77022","24","67000429"
"JH378106","67112407","67112685","KQ054565v1","836477","836767","78","66275930"
"JH378106","67150316","67150607","KQ053299v1","4095914","4096215","73","63054402"
"JH378106","67461760","67462025","KQ054124v1","2442155","2442433","70","65019605"
"JH378106","67522256","67522523","KQ058643v1","858469","858727","70","66663787"
"JH378106","67662977","67663142","KQ054652v1","6051","6229","50","67656926"
"JH378106","67704953","67705244","KQ056475v1","2179070","2179363","72","65525883"
"JH378106","67997707","67997847","KQ054179v1","3865170","3865294","32","64132537"
"JH378106","68006607","68006781","KQ054213v1","2445756","2445931","36","65560851"
"JH378106","68007026","68007338","KQ053398v1","1573433","1573739","70","66433593"
"JH378106","68042433","68042572","KQ053135v1","3925667","3925819","45","64116766"
"JH378106","68253078","68253355","KQ055394v1","3441211","3441489","64","64811867"
"JH378106","68291899","68292109","KQ058595v1","117016","117224","45","68174883"
"JH378106","68327545","68327837","KQ053297v1","44026","44315","82","68283519"
"JH378106","68486505","68486810","KQ058184v1","1505565","1505858","71","66980940"
"JH378106","68582367","68582477","KQ057883v1","26280","26392","24","68556087"
"JH378106","68672203","68672506","KQ052970v1","6659487","6659775","65","62012716"
"JH378106","68841784","68842074","KQ057504v1","162767","163049","57","68679017"
"JH378106","69277687","69277962","KQ058616v1","3808264","3808541","74","65469423"
"JH378106","69319859","69320134","KQ052969v1","11182978","11183250","57","58136881"
"JH378106","69338086","69338383","KQ056762v1","532889","533183","60","68805197"
"JH378106","69362030","69362236","KQ054827v1","2292729","2292949","79","67069301"
"JH378106","69379875","69380184","KQ057911v1","428931","429228","76","68950944"
"JH378106","69616684","69616989","KQ053212v1","1560173","1560471","61","68056511"
"JH378106","69814965","69815273","KQ053783v1","73311","73618","65","69741654"
"JH378106","69943085","69943388","KQ053398v1","2816605","2816914","83","67126480"
"JH378106","69981555","69981842","KQ055468v1","1908448","1908731","58","68073107"
"JH378106","70330968","70331251","KQ053696v1","3248742","3249021","62","67082226"
"JH378106","70386501","70386789","KQ058094v1","7832529","7832815","66","62553972"
"JH378106","70499675","70499957","KQ055065v1","1117201","1117481","65","69382474"
"JH378106","70556004","70556312","KQ058328v1","4260134","4260435","67","66295870"
"JH378106","70803745","70803959","KQ056166v1","1907479","1907686","55","68896266"
"JH378106","70859796","70860093","KQ058184v1","1505565","1505858","60","69354231"
"JH378106","70898329","70898617","KQ054693v1","832788","833076","64","70065541"
"JH378106","70965871","70966159","KQ053300v1","2877663","2877955","67","68088208"
"JH378106","71249067","71249359","KQ056147v1","1747366","1747648","74","69501701"
"JH378107","224384","224670","KQ054693v1","832788","833076","66","608404"
"JH378107","354436","354655","KQ058550v1","3053970","3054174","49","2699534"
"JH378107","557475","557722","KQ053267v1","3723852","3724102","69","3166377"
"JH378107","653213","653507","KQ053959v1","2839561","2839850","58","2186348"
"JH378107","700287","700552","KQ053299v1","14446867","14447148","69","13746580"
"JH378107","788172","788447","KQ053299v1","21375969","21376245","74","20587797"
"JH378107","874695","874798","KQ053157v1","8174152","8174260","21","7299457"
"JH378107","1063638","1063916","KQ054994v1","3190229","3190506","68","2126591"
"JH378107","1416658","1416977","KQ053894v1","1262767","1263078","71","153891"
"JH378107","1502285","1502486","KQ056064v1","661842","662034","64","840443"
"JH378107","1701140","1701347","KQ053398v1","3158290","3158500","52","1457150"
"JH378107","2372592","2372918","KQ055629v1","1214508","1214831","91","1158084"
"JH378107","2502162","2502440","KQ053093v1","1361295","1361576","78","1140867"
"JH378107","2718843","2719055","KQ053609v1","2642121","2642332","42","76722"
"JH378107","2919284","2919599","KQ058585v1","580456","580763","69","2338828"
"JH378107","3391963","3392294","KQ052968v1","4333082","4333389","97","941119"
"JH378107","4090781","4091053","KQ053718v1","1496748","1497022","73","2594033"
"JH378107","4392180","4392385","KQ053421v1","5583842","5584035","60","1191662"
"JH378107","4400209","4400452","KQ052970v1","17324014","17324257","65","12923805"
"JH378107","4400884","4401032","KQ055406v1","3895","4043","33","4396989"
"JH378107","4772774","4773066","KQ052968v1","9731339","9731640","67","4958565"
"JH378107","4773574","4773785","KQ053959v1","3147544","3147761","60","1626030"
"JH378107","4830118","4830277","KQ057023v1","552794","552951","27","4277324"
"JH378107","4837198","4837332","KQ058257v1","652425","652556","22","4184773"
"JH378107","4899388","4899667","KQ054068v1","3341291","3341579","67","1558097"
"JH378107","4915611","4915778","KQ053609v1","1884265","1884430","35","3031346"
"JH378107","5053967","5054122","KQ052968v1","8575658","8575813","35","3521691"
"JH378107","5135083","5135371","KQ053331v1","97381","97652","77","5037702"
"JH378107","5135926","5136225","KQ052968v1","13657848","13658133","76","8521922"
"JH378107","5246145","5246277","KQ052970v1","12418764","12418905","42","7172619"
"JH378107","5247248","5247538","KQ058585v1","580456","580763","80","4666792"
"JH378107","5416843","5417130","KQ058383v1","6917259","6917555","69","1500416"
"JH378107","5674818","5675139","KQ053288v1","2034811","2035125","81","3640007"
"JH378107","5701736","5701912","KQ054356v1","151868","152037","42","5549868"
"JH378107","5796401","5796532","KQ053718v1","316226","316356","23","5480175"
"JH378107","6106725","6107006","KQ055173v1","452351","452623","76","5654374"
"JH378107","6257242","6257535","KQ056044v1","996204","996495","60","5261038"
"JH378107","6263034","6263196","KQ056996v1","1524030","1524195","32","4739004"
"JH378107","6499377","6499650","KQ055893v1","2015012","2015285","60","4484365"
"JH378107","6548900","6549198","KQ053554v1","2471177","2471484","61","4077723"
"JH378107","6551033","6551333","KQ053297v1","44026","44315","77","6507007"
"JH378107","6611962","6612208","KQ053498v1","3849819","3850073","67","2762143"
"JH378107","6616526","6616804","KQ054921v1","3256553","3256829","65","3359973"
"JH378107","6712686","6712756","KQ053004v1","1367501","1367567","20","5345185"
"JH378107","6785687","6785990","KQ053288v1","2034811","2035125","73","4750876"
"JH378107","6806526","6806722","KQ058594v1","5040769","5040972","49","1765757"
"JH378107","6830277","6830568","KQ055014v1","2491689","2491976","66","4338588"
"JH378107","6841015","6841306","KQ055479v1","2609512","2609794","68","4231503"
"JH378107","6865923","6866223","KQ053157v1","7174603","7174889","72","308680"
"JH378107","7058433","7058554","KQ058383v1","7248131","7248254","26","189698"
"JH378107","7166519","7166832","KQ058094v1","7850642","7850940","78","684123"
"JH378107","7292989","7293137","KQ053115v1","1650505","1650644","31","5642484"
"JH378107","7336036","7336157","KQ054179v1","3865170","3865294","21","3470866"
"JH378107","7487845","7488016","KQ058583v1","2039372","2039538","40","5448473"
"JH378107","7567050","7567153","KQ052982v1","1023528","1023630","28","6543522"
"JH378107","7587629","7587939","KQ054910v1","1541067","1541374","64","6046562"
"JH378107","7780210","7780479","KQ055309v1","1596833","1597106","64","6183377"
"JH378107","7783823","7784126","KQ058184v1","1505565","1505858","62","6278258"
"JH378107","7835009","7835224","KQ052970v1","3216316","3216523","51","4618693"
"JH378107","8076384","8076535","KQ053740v1","1071467","1071623","36","7004917"
"JH378107","8290578","8290709","KQ056643v1","1491838","1491968","27","6798740"
"JH378107","8570830","8571119","KQ054932v1","10830322","10830609","61","2259492"
"JH378107","8860022","8860322","KQ056790v1","446564","446855","61","8413458"
"JH378107","9040934","9041223","KQ052969v1","8840489","8840774","62","200445"
"JH378107","9051999","9052208","KQ058505v1","2234909","2235124","52","6817090"
"JH378107","9351146","9351425","ABDC02003384v1","193955","194231","69","9157191"
"JH378107","9425971","9426185","KQ056996v1","148346","148555","52","9277625"
"JH378107","9996598","9996695","KQ058253v1","973922","974008","34","9022676"
"JH378107","10367054","10367342","KQ052982v1","2245447","2245718","84","8121607"
"JH378107","11688159","11688432","KQ053554v1","2462851","2463107","72","9225308"
"JH378107","11862869","11863139","KQ058550v1","3794922","3795189","79","8067947"
"JH378107","11917578","11917859","KQ057737v1","2756211","2756494","61","9161367"
"JH378107","12062467","12062777","KQ053115v1","3485337","3485650","67","8577130"
"JH378107","12136848","12137111","KQ054068v1","2000305","2000565","64","10136543"
"JH378107","12150388","12150714","KQ053816v1","7464708","7465010","92","4685680"
"JH378107","12168647","12168899","KQ053278v1","2947726","2947979","75","9220921"
"JH378107","12577991","12578283","KQ058539v1","1057985","1058283","65","11520006"
"JH378107","12912917","12913222","KQ054879v1","1971571","1971875","76","10941346"
"JH378107","13194875","13195161","KQ058183v1","487423","487710","76","12707452"
"JH378107","13456891","13457189","KQ058317v1","5506620","5506904","65","7950271"
"JH378107","13529859","13530124","KQ054400v1","3760476","3760752","68","9769383"
"JH378107","13633103","13633379","KQ055468v1","2241758","2242037","80","11391345"
"JH378107","13656985","13657246","KQ056955v1","1460875","1461137","67","12196110"
"JH378107","13848425","13848718","KQ053982v1","8167565","8167847","73","5680860"
"JH378107","14099456","14099584","KQ052993v1","71964","72092","29","14027492"
"JH378107","14099589","14099712","KQ055600v1","267326","267449","29","13832263"
"JH378107","14274498","14274807","KQ056568v1","817681","817996","70","13456817"
"JH378107","14290034","14290335","KQ056456v1","827977","828265","72","13462057"
"JH378107","14339466","14339770","KQ058572v1","1453592","1453891","78","12885874"
"JH378107","14564050","14564334","KQ052968v1","14043756","14044036","65","520294"
"JH378107","14564581","14564741","KQ053740v1","3090554","3090702","41","11474027"
"JH378107","15230364","15230534","KQ058394v1","15325605","15325776","46","95241"
"JH378107","16172121","16172280","KQ055425v1","1445594","1445758","38","14726527"
"JH378107","16535051","16535314","KQ052969v1","8825162","8825427","70","7709889"
"JH378107","16859883","16860172","KQ053297v1","44026","44315","79","16815857"
"JH378107","17265502","17265830","KQ055004v1","332895","333205","84","16932607"
"JH378107","18062721","18063034","KQ052981v1","1198440","1198752","82","16864281"
"JH378107","18094487","18094646","KQ053740v1","1071467","1071623","33","17023020"
"JH378107","18192239","18192387","KQ053476v1","4635198","4635357","44","13557041"
"JH378107","18196369","18196523","KQ057737v1","1426090","1426247","33","16770279"
"JH378107","18224812","18225128","KQ056568v1","817681","817996","74","17407131"
"JH378107","18351866","18351986","KQ053223v1","119848","119963","24","18232018"
"JH378107","18352383","18352549","KQ054279v1","1648441","1648602","40","16703942"
"JH378107","18434292","18434544","KQ055352v1","14158369","14158624","81","4275923"
"JH378107","18459431","18459712","KQ054693v1","1429670","1429955","67","17029761"
"JH378107","18655990","18656271","KQ058328v1","3748844","3749103","72","14907146"
"JH378107","18736957","18737232","KQ056673v1","983726","984000","70","17753231"
"JH378107","18791807","18792099","KQ055468v1","1908448","1908731","64","16883359"
"JH378107","18793097","18793382","KQ054401v1","2629005","2629296","76","16164092"
"JH378107","18794370","18794675","KQ054510v1","2056259","2056562","71","16738111"
"JH378107","18917225","18917522","KQ056147v1","266944","267241","61","18650281"
"JH378107","19003064","19003380","KQ054400v1","4609733","4610042","85","14393331"
"JH378107","19029153","19029337","KQ055140v1","3477076","3477259","43","15552077"
"JH378107","19781705","19781969","KQ057035v1","2378582","2378848","76","17403123"
"JH378107","20105206","20105501","KQ053297v1","44026","44315","68","20061180"
"JH378107","20548460","20548754","KQ058316v1","982603","982911","66","19565857"
"JH378107","20615183","20615494","KQ056587v1","17306365","17306676","71","3308818"
"JH378107","20677988","20678236","KQ054456v1","4787552","4787805","71","15890436"
"JH378107","20703869","20704168","KQ054804v1","964015","964313","74","19739854"
"JH378107","20890127","20890384","KQ056707v1","1900843","1901105","67","18989284"
"JH378107","20952852","20953137","KQ052968v1","13260777","13261056","55","7692075"
"JH378107","21105676","21105838","KQ053223v1","2815634","2815800","37","18290042"
"JH378107","21157740","21157900","KQ056996v1","1524030","1524195","32","19633710"
"JH378107","21383906","21384222","KQ055787v1","694393","694708","67","20689513"
"JH378107","21487180","21487383","KQ056475v1","279980","280179","50","21207200"
"JH378107","21644950","21645234","KQ055364v1","2160874","2161165","74","19484076"
"JH378107","21959631","21959910","KQ052971v1","646100","646383","73","21313531"
"JH378107","22210925","22211176","KQ056234v1","4592339","4592554","75","17618586"
"JH378107","22387645","22387925","KQ053631v1","9116387","9116675","75","13271258"
"JH378107","22534795","22534892","KQ055872v1","5141445","5141541","20","17393350"
"JH378107","22993737","22993990","KQ058627v1","266046","266300","69","22727691"
"JH378107","23262809","23263089","KQ052968v1","13260777","13261056","54","10002032"
"JH378107","23280644","23280940","KQ052970v1","9813160","9813451","64","13467484"
"JH378107","23611604","23611902","KQ052981v1","658787","659079","67","22952817"
"JH378107","23691064","23691264","KQ054826v1","9981760","9981967","58","13709304"
"JH378107","23897941","23898191","KQ058503v1","123813","124064","64","23774128"
"JH378107","24016307","24016536","KQ053310v1","3196302","3196523","77","20820005"
"JH378107","24163792","24164080","KQ053465v1","3806004","3806288","71","20357788"
"JH378107","24241045","24241303","KQ054565v1","7472196","7472426","67","16768849"
"JH378107","24279315","24279531","KQ057840v1","234828","235046","54","24044487"
"JH378107","25614368","25614641","KQ056773v1","168010","168288","65","25446358"
"JH378107","26219414","26219500","KQ053565v1","3764807","3764898","25","22454607"
"JH378107","26219654","26219812","KQ055735v1","2321269","2321424","36","23898385"
"JH378107","26271664","26271957","KQ053409v1","3716306","3716585","65","22555358"
"JH378107","26405480","26405776","KQ058313v1","660634","660924","78","25744846"
"JH378107","26523247","26523546","KQ052981v1","1456424","1456719","66","25066823"
"JH378107","26966916","26967191","KQ054652v1","4505","4775","83","26962411"
"JH378107","26967773","26967880","KQ058483v1","2767088","2767193","39","24200685"
"JH378107","27300786","27301106","KQ054525v1","45769","46078","70","27255017"
"JH378107","27594482","27594783","KQ053554v1","2471177","2471484","63","25123305"
"JH378107","27597798","27598073","KQ058483v1","6010751","6011031","68","21587047"
"JH378107","27621129","27621430","KQ053398v1","3774526","3774835","74","23846603"
"JH378107","27694370","27694673","KQ053190v1","5623449","5623748","72","22070921"
"JH378107","27749852","27750003","KQ053795v1","588026","588179","32","27161826"
"JH378107","27766529","27766824","KQ058257v1","502287","502580","67","27264242"
"JH378107","27769222","27769359","KQ057909v1","9079137","9079275","29","18690085"
"JH378107","27776422","27776719","KQ058184v1","1505565","1505858","68","26270857"
"JH378107","27827694","27827983","KQ058184v1","1505565","1505858","70","26322129"
"JH378107","27879954","27880260","KQ055787v1","1064992","1065293","72","26814962"
"JH378107","28031121","28031421","KQ057911v1","428931","429228","65","27602190"
"JH378107","28370170","28370447","KQ055331v1","476282","476544","81","27893888"
"JH378107","29481099","29481395","KQ053971v1","3610129","3610423","74","25870970"
"JH378107","29603311","29603574","KQ057380v1","2071007","2071284","76","27532304"
"JH378107","29681484","29681782","KQ053971v1","3610129","3610423","66","26071355"
"JH378107","29710813","29711112","KQ053816v1","6856607","6856902","70","22854206"
"JH378107","29734054","29734318","KQ053256v1","1257292","1257559","75","28476762"
"JH378107","29771781","29772073","KQ054401v1","2629005","2629296","61","27142776"
"JH378107","29933167","29933377","KQ053191v1","3682228","3682423","57","26250939"
"JH378107","30237504","30237822","KQ055862v1","2038392","2038709","76","28199112"
"JH378107","30244678","30244984","KQ055914v1","218683","218977","75","30025995"
"JH378107","30252513","30252643","KQ055097v1","2255144","2255272","35","27997369"
"JH378107","30254306","30254600","KQ052968v1","4276704","4277004","66","25977602"
"JH378107","30266281","30266584","KQ053554v1","1157184","1157483","67","29109097"
"JH378107","30298256","30298546","KQ054113v1","1571890","1572169","82","28726366"
"JH378107","30429050","30429307","KQ054068v1","2000305","2000565","65","28428745"
"JH378107","30547941","30548244","KQ056147v1","1064032","1064323","86","29483909"
"JH378107","30603924","30604219","KQ058272v1","4942871","4943179","67","25661053"
"JH378107","30849147","30849383","KQ054804v1","1007773","1008011","57","29841374"
"JH378107","30976027","30976266","KQ057909v1","104692","104936","73","30871335"
"JH378107","31222050","31222345","KQ054879v1","1971571","1971875","70","29250479"
"JH378107","31288125","31288200","KQ052968v1","9483686","9483763","17","21804439"
"JH378107","31675636","31675909","KQ054124v1","4347479","4347753","67","27328157"
"JH378107","31787219","31787486","KQ055662v1","4683524","4683789","63","27103695"
"JH378107","32013020","32013317","KQ055777v1","2252512","2252796","72","29760508"
"JH378107","32118009","32118313","KQ054725v1","2090703","2091002","68","30027306"
"JH378107","32135664","32135955","KQ057118v1","4601602","4601894","64","27534062"
"JH378107","32258207","32258497","KQ058184v1","1505565","1505858","58","30752642"
"JH378107","32358667","32358905","KQ055457v1","1902633","1902878","65","30456034"
"JH378107","32811892","32812173","KQ055141v1","254262","254544","64","32557630"
"JH378107","32833935","32834078","KQ053190v1","2372433","2372579","33","30461502"
"JH378107","32855638","32855921","KQ053409v1","3716306","3716585","71","29139332"
"JH378107","32910346","32910573","KQ053409v1","2693050","2693293","75","30217296"
"JH378107","32954903","32955051","KQ058316v1","1612479","1612626","36","31342424"
"JH378107","32965285","32965576","KQ053916v1","2506391","2506679","72","30458894"
"JH378107","32979492","32979609","KQ053135v1","3445097","3445217","40","29534395"
"JH378107","32979629","32979666","KQ057082v1","642960","642996","10","32336669"
"JH378107","33098305","33098579","KQ054510v1","8518307","8518589","84","24579998"
"JH378107","33113556","33113850","KQ054804v1","964015","964313","71","32149541"
"JH378107","33127367","33127667","KQ054693v1","832788","833076","71","32294579"
"JH378107","33158019","33158273","KQ052970v1","21565783","21566032","71","11592236"
"JH378107","33187889","33188154","KQ055192v1","1201363","1201615","70","31986526"
"JH378107","33280627","33280931","KQ056920v1","1346398","1346707","65","31934229"
"JH378107","33314227","33314517","KQ055364v1","2160874","2161165","60","31153353"
"JH378107","33882826","33883112","KQ056672v1","3535300","3535593","70","30347526"
"JH378107","34157278","34157575","KQ054510v1","8555095","8555387","65","25602183"
"JH378107","34292589","34292892","KQ054932v1","9022614","9022904","84","25269975"
"JH378107","34474359","34474676","KQ058266v1","1113469","1113760","77","33360890"
"JH378107","34528649","34528928","ABDC02051297v1","1939","2213","72","34526710"
"JH378107","34579009","34579295","KQ058184v1","1505565","1505858","70","33073444"
"JH378107","34990056","34990334","KQ053631v1","8893553","8893834","75","26096503"
"JH378107","35014826","35015088","KQ054868v1","2229582","2229854","66","32785244"
"JH378107","35371145","35371446","KQ056331v1","1501968","1502262","67","33869177"
"JH378107","35437787","35438090","KQ052968v1","9583834","9584132","72","25853953"
"JH378107","35633749","35634036","KQ058394v1","5421387","5421681","75","30212362"
"JH378107","35810661","35810972","KQ053299v1","4095914","4096215","71","31714747"
"JH378107","35888487","35888780","KQ053297v1","44026","44315","70","35844461"
"JH378107","36115690","36115933","KQ054932v1","4146161","4146408","65","31969529"
"JH378107","36140162","36140293","KQ053718v1","316226","316356","24","35823936"
"JH378107","36711708","36712011","KQ053960v1","70067","70362","71","36641641"
"JH378107","37401863","37402153","KQ053299v1","21869448","21869738","79","15532415"
"JH378107","37759026","37759314","KQ058350v1","6740286","6740580","71","31018740"
"JH378107","37765043","37765261","KQ053609v1","2642121","2642332","58","35122922"
"JH378107","38770897","38771177","KQ058383v1","2713168","2713439","78","36057729"
"JH378107","38917762","38918053","KQ052970v1","11462392","11462680","64","27455370"
"JH378107","39130522","39130577","KQ053696v1","870676","870725","24","38259846"
"JH378107","39503392","39503704","KQ054804v1","964015","964313","78","38539377"
"JH378107","40399852","40400158","KQ053816v1","7464708","7465010","72","32935144"
"JH378107","40480369","40480548","KQ054660v1","3679956","3680128","43","36800413"
"JH378107","40854049","40854341","KQ054693v1","837377","837666","74","40016672"
"JH378107","41175102","41175375","KQ053465v1","403029","403303","81","40772073"
"JH378107","41180159","41180467","KQ053299v1","4095914","4096215","81","37084245"
"JH378107","41273249","41273547","KQ053631v1","7288314","7288608","71","33984935"
"JH378107","41603140","41603415","KQ052968v1","13260777","13261056","68","28342363"
"JH378107","42001337","42001470","KQ053354v1","702320","702452","25","41299017"
"JH378107","42265905","42266198","KQ053115v1","1118362","1118655","65","41147543"
"JH378107","42504028","42504335","KQ052970v1","2531178","2531455","86","39972850"
"JH378107","42587358","42587655","KQ053115v1","1118362","1118655","59","41468996"
"JH378107","42604031","42604342","KQ052969v1","9116808","9117108","82","33487223"
"JH378107","42616796","42616952","ABDC02051947v1","1","158","35","42616795"
"JH378107","42674011","42674300","KQ055725v1","503531","503824","66","42170480"
"JH378107","42700567","42700842","KQ055755v1","209063","209333","79","42491504"
"JH378107","42719111","42719193","KQ054533v1","1814787","1814857","26","40904324"
"JH378107","42735092","42735227","KQ053354v1","702320","702452","32","42032772"
"JH378107","42780091","42780363","KQ053409v1","5686466","5686740","67","37093625"
"JH378107","42814622","42814796","KQ055872v1","16452101","16452279","50","26362521"
"JH378107","42900129","42900283","KQ058461v1","3297582","3297739","38","39602547"
"JH378107","43109613","43109903","KQ053420v1","122023","122324","74","42987590"
"JH378107","43271900","43272188","KQ058448v1","69670","69956","66","43202230"
"JH378107","43703732","43703980","KQ057118v1","591556","591810","78","43112176"
"JH378107","44273659","44273958","KQ058604v1","210345","210647","57","44063314"
"JH378107","44779186","44779444","KQ053026v1","2213601","2213834","73","42565585"
"JH378107","45040685","45040979","KQ057118v1","4601602","4601894","56","40439083"
"JH378107","45072005","45072296","KQ054356v1","1600089","1600380","71","43471916"
"JH378107","45094931","45095211","KQ054124v1","2442155","2442433","72","42652776"
"JH378107","45113623","45113911","KQ054660v1","3497722","3498007","64","41615901"
"JH378107","45156408","45156708","KQ054069v1","5704070","5704362","75","39452338"
"JH378107","45257117","45257409","KQ058272v1","6295757","6296050","60","38961360"
"JH378107","45272588","45272884","KQ053631v1","7288314","7288608","73","37984274"
"JH378107","45369921","45370060","KQ053432v1","7005343","7005477","31","38364578"
"JH378107","45377793","45378075","KQ054660v1","2994204","2994490","66","42383589"
"JH378107","45549342","45549474","KQ053774v1","406836","406969","17","45142506"
"JH378107","45630973","45631228","KQ053476v1","1675362","1675619","68","43955611"
"JH378107","45718956","45719238","KQ058291v1","474599","474881","69","45244357"
"JH378107","45729347","45729640","KQ058427v1","2533789","2534086","69","43195558"
"JH378107","45890419","45890701","KQ057118v1","4601602","4601894","80","41288817"
"JH378107","45948783","45949027","KQ055203v1","1891285","1891537","63","44057498"
"JH378107","46199359","46199592","KQ055558v1","1784961","1785194","61","44414398"
"JH378107","46221197","46221446","KQ055055v1","1882469","1882726","61","44338728"
"JH378107","46600989","46601259","KQ053696v1","625208","625481","63","45975781"
"JH378107","46648212","46648516","KQ053631v1","7288314","7288608","78","39359898"
"JH378107","46887825","46888121","KQ053190v1","5623449","5623748","58","41264376"
"JH378107","46916434","46916714","KQ055065v1","1117201","1117481","75","45799233"
"JH378107","46964389","46964659","KQ053409v1","3716306","3716585","71","43248083"
"JH378107","47000654","47000914","KQ052971v1","6441372","6441626","71","40559282"
"JH378107","47024508","47024793","KQ055735v1","667472","667747","82","46357036"
"JH378107","47053599","47053744","KQ053157v1","4288391","4288538","35","42765208"
"JH378107","47058643","47058951","KQ054068v1","5491779","5492087","71","41566864"
"JH378107","47079801","47080089","KQ056493v1","3974454","3974746","66","43105347"
"JH378107","47208544","47208752","KQ053398v1","3158290","3158500","41","44050254"
"JH378107","47229312","47229589","KQ052968v1","13260777","13261056","73","33968535"
"JH378107","47231928","47232222","KQ052968v1","5668114","5668408","69","41563814"
"JH378107","47275126","47275434","KQ054682v1","2125705","2126015","77","45149421"
"JH378107","47283255","47283525","KQ053223v1","2852845","2853123","65","44430410"
"JH378107","47283947","47284094","KQ054954v1","879721","879853","55","46404226"
"JH378107","47290746","47291044","KQ052970v1","20988009","20988278","80","26302737"
"JH378107","47435662","47435953","KQ054565v1","6587941","6588226","69","40847721"
"JH378107","47729844","47730139","KQ053498v1","3696034","3696323","62","44033810"
"JH378107","49432513","49432775","KQ058505v1","2346233","2346497","55","47086280"
"JH378107","49448769","49448864","KQ053763v1","508269","508363","24","48940500"
"JH378107","49482800","49483100","KQ053554v1","1105373","1105659","74","48377427"
"JH378107","49488768","49488872","KQ056108v1","2112954","2113058","36","47375814"
"JH378107","49625219","49625539","KQ053740v1","888034","888333","93","48737185"
"JH378107","49661742","49661911","KQ058050v1","695702","695863","41","48966040"
"JH378107","49688870","49689173","KQ052971v1","959704","960011","77","48729166"
"JH378107","49869738","49870013","KQ053332v1","447571","447853","69","49422167"
"JH378107","49902267","49902531","KQ057910v1","2537338","2537606","58","47364929"
"JH378107","49960689","49960835","KQ053190v1","2372433","2372579","35","47588256"
"JH378107","49986484","49986628","KQ058538v1","1533488","1533628","31","48452996"
"JH378107","50150632","50150879","KQ053795v1","121444","121694","60","50029188"
"JH378107","50203197","50203497","KQ055097v1","1884579","1884874","68","48318618"
"JH378107","50852981","50853274","KQ058328v1","6293951","6294242","68","44559030"
"JH378107","51291530","51291794","KQ053795v1","370451","370712","65","50921079"
"JH378107","51593820","51594054","KQ052968v1","10277697","10277942","75","41316123"
"JH378107","51884843","51885106","KQ055735v1","667472","667747","66","51217371"
"JH378107","51924450","51924605","KQ054510v1","8179279","8179421","35","43745171"
"JH378107","52027670","52027951","KQ055035v1","4381466","4381744","70","47646204"
"JH378107","52058616","52058902","KQ058595v1","297389","297662","79","51761227"
"JH378107","52093868","52094087","KQ058266v1","662378","662594","64","51431490"
"JH378107","52184936","52185244","KQ057045v1","590946","591241","68","51593990"
"JH378107","53032177","53032313","KQ056587v1","8786019","8786154","32","44246158"
"JH378107","53062962","53063233","KQ057213v1","1074642","1074915","74","51988320"
"JH378107","53347004","53347285","KQ055173v1","248885","249169","70","53098119"
"JH378107","53623930","53624196","KQ055735v1","1022582","1022853","80","52601348"
"JH378107","53664406","53664699","KQ053299v1","4095914","4096215","66","49568492"
"JH378107","54161915","54162060","KQ053299v1","7348738","7348881","43","46813177"
"JH378107","54393564","54393681","KQ053785v1","828746","828862","46","53564818"
"JH378107","54831255","54831566","KQ053332v1","554962","555258","81","54276293"
"JH378107","55135348","55135577","KQ053587v1","1788518","1788751","69","53346830"
"JH378107","55791157","55791437","KQ052971v1","646100","646383","83","55145057"
"JH378107","55981611","55981738","KQ054682v1","1410308","1410435","28","54571303"
"JH378107","56045140","56045360","KQ058272v1","2561906","2562124","57","53483234"
"JH378107","56447514","56447805","KQ058346v1","648606","648904","85","55798908"
"JH378107","56718604","56718889","KQ054389v1","1065530","1065798","77","55653074"
"JH378107","56782119","56782393","KQ054510v1","1641980","1642248","81","55140139"
"JH378107","56911631","56911925","KQ058184v1","1505565","1505858","61","55406066"
"JH378107","57231211","57231344","KQ053332v1","575690","575814","28","56655521"
"JH378107","57577149","57577299","KQ053157v1","4288391","4288538","39","53288758"
"JH378107","57644877","57645009","KQ057380v1","1927712","1927837","34","55717165"
"JH378107","57659153","57659427","KQ055893v1","1739065","1739339","76","55920088"
"JH378107","57661450","57661784","KQ056587v1","17306365","17306676","83","40355085"
"JH378107","57667354","57667627","KQ058325v1","97535","97813","63","57569819"
"JH378107","57694398","57694532","KQ058259v1","1242505","1242648","43","56451893"
"JH378107","57884054","57884336","KQ055036v1","1971125","1971407","65","55912929"
"JH378107","57885878","57886162","KQ058428v1","2055160","2055453","75","55830718"
"JH378107","57901474","57901604","KQ053299v1","22459675","22459802","29","35441799"
"JH378107","57940220","57940365","KQ055946v1","942442","942588","35","56997778"
"JH378107","58089361","58089642","KQ058184v1","1505565","1505858","59","56583796"
"JH378107","58129382","58129668","KQ058328v1","6293951","6294242","70","51835431"
"JH378107","58212158","58212396","KQ056493v1","4393253","4393488","66","53818905"
"JH378107","58217294","58217596","KQ053398v1","2431232","2431537","57","55786062"
"JH378108","40370106","40370390","KQ052968v1","14043756","14044036","75","26326350"
"JH378108","249502","249796","KQ054932v1","2071898","2072191","70","1822396"
"JH378108","312058","312356","KQ054213v1","780092","780393","55","468034"
"JH378108","540419","540710","KQ054135v1","2702098","2702381","77","2161679"
"JH378108","731214","731483","KQ053948v1","168940","169229","71","562274"
"JH378108","801358","801669","KQ053093v1","1522159","1522464","59","720801"
"JH378108","915347","915517","KQ057737v1","1426090","1426247","35","510743"
"JH378108","1127010","1127304","KQ053498v1","3696034","3696323","69","2569024"
"JH378108","1380397","1380665","KQ056200v1","648300","648566","79","732097"
"JH378108","1521583","1521672","KQ055375v1","460174","460273","30","1061409"
"JH378108","1557090","1557247","KQ056147v1","3323","3476","32","1553767"
"JH378108","1665007","1665292","KQ058561v1","4466656","4466945","67","2801649"
"JH378108","1988009","1988297","KQ055755v1","209063","209333","77","1778946"
"JH378108","2106663","2106973","KQ055004v1","332895","333205","73","1773768"
"JH378108","2485197","2485509","KQ055236v1","2049624","2049930","71","435573"
"JH378108","3004634","3004912","KQ057161v1","218502","218773","74","2786132"
"JH378108","3434807","3435115","KQ058184v1","1505565","1505858","79","1929242"
"JH378108","3536823","3537111","KQ055777v1","2252512","2252796","69","1284311"
"JH378108","4689439","4689746","KQ053059v1","2387120","2387415","59","2302319"
"JH378108","4709020","4709318","KQ053093v1","1738898","1739201","77","2970122"
"JH378108","4772333","4772629","KQ058084v1","24077","24376","73","4748256"
"JH378108","4824867","4825149","KQ057909v1","11703388","11703663","82","6878521"
"JH378108","4831446","4831737","KQ052968v1","9583834","9584132","63","4752388"
"JH378108","4836728","4836860","KQ054301v1","3483833","3483964","30","1352895"
"JH378108","4853182","4853328","KQ055725v1","889865","890010","35","3963317"
"JH378108","5563928","5564022","KQ053971v1","4775120","4775210","23","788808"
"JH378108","5703316","5703624","KQ053288v1","2034811","2035125","71","3668505"
"JH378108","6046241","6046460","KQ053299v1","4478737","4478951","59","1567504"
"JH378108","6250895","6251178","KQ058183v1","594864","595153","67","5656031"
"JH378108","6344857","6345126","KQ055662v1","4683524","4683789","81","1661333"
"JH378108","6433351","6433655","KQ053299v1","4095914","4096215","72","2337437"
"JH378108","6505968","6506270","KQ053398v1","2816605","2816914","75","3689363"
"JH378108","6838307","6838563","KQ054290v1","1767307","1767578","77","5071000"
"JH378108","6924590","6924929","KQ054510v1","1767978","1768276","98","5156612"
"JH378108","7457157","7457256","KQ053827v1","2612475","2612564","27","4844682"
"JH378108","8006204","8006506","KQ058184v1","1505565","1505858","62","6500639"
"JH378108","8147101","8147388","KQ058146v1","155561","155839","80","7991540"
"JH378108","8159241","8159312","KQ056855v1","3190666","3190732","23","4968575"
"JH378108","8218594","8218865","ABDC02045363v1","7098","7372","69","8211496"
"JH378108","8343233","8343381","KQ052969v1","8129388","8129539","36","213845"
"JH378108","8379457","8379728","KQ058184v1","1608105","1608378","69","6771352"
"JH378108","8384390","8384523","KQ056663v1","464182","464321","28","7920208"
"JH378108","8445822","8446113","KQ055140v1","3423560","3423842","67","5022262"
"JH378108","8460328","8460642","KQ054510v1","2681434","2681749","72","5778894"
"JH378108","8480782","8481081","KQ053816v1","7327018","7327317","61","1153764"
"JH378108","8487251","8487530","KQ053104v1","3864277","3864560","67","4622974"
"JH378108","8491268","8491424","KQ056148v1","7050287","7050441","38","1440981"
"JH378108","8494625","8494742","KQ056527v1","169","285","42","8494456"
"JH378108","8532403","8532711","KQ057449v1","1989308","1989615","71","6543095"
"JH378108","8534093","8534340","KQ057291v1","322948","323180","67","8211145"
"JH378108","8644309","8644592","KQ055808v1","339221","339505","67","8305088"
"JH378108","8679906","8680171","KQ053387v1","564882","565122","71","8115024"
"JH378108","8833462","8833718","KQ054652v1","4505","4775","60","8828957"
"JH378108","9014996","9015288","KQ056147v1","1064032","1064323","68","7950964"
"JH378108","9043474","9043755","KQ057737v1","3083543","3083824","74","5959931"
"JH378108","9091717","9091867","KQ058345v1","136254","136406","39","8955463"
"JH378108","9126588","9126830","KQ054932v1","6362120","6362372","73","2764468"
"JH378108","9202951","9203122","KQ055352v1","9227221","9227396","37","24270"
"JH378108","9203549","9203663","KQ053971v1","4103392","4103508","25","5100157"
"JH378108","9222899","9223180","KQ053115v1","1118362","1118655","72","8104537"
"JH378108","9816538","9816664","KQ055498v1","86970","87098","20","9729568"
"JH378108","10068701","10069000","KQ057702v1","1237368","1237672","71","8831333"
"JH378108","10266654","10266919","KQ053521v1","2273365","2273646","68","7993289"
"JH378108","10388327","10388601","KQ058183v1","4736369","4736640","73","5651958"
"JH378108","10466025","10466327","KQ053795v1","1812338","1812629","73","8653687"
"JH378108","10493285","10493563","KQ052968v1","13260777","13261056","64","2767492"
"JH378108","10606795","10607061","KQ053343v1","3705818","3706088","66","6900977"
"JH378108","10640711","10640964","KQ053729v1","2394549","2394806","74","8246162"
"JH378108","11050174","11050311","KQ056147v1","2168964","2169108","38","8881210"
"JH378108","11606910","11607184","KQ053146v1","2819587","2819868","65","8787323"
"JH378108","11729304","11729582","KQ052968v1","13260777","13261056","64","1531473"
"JH378108","11934238","11934384","KQ054180v1","70685","70834","41","11863553"
"JH378108","12134845","12135128","KQ056928v1","2303396","2303675","73","9831449"
"JH378108","12174645","12174922","KQ057931v1","399684","399967","76","11774961"
"JH378108","12199564","12199630","KQ057737v1","3597561","3597632","20","8602003"
"JH378108","12729655","12729936","KQ055097v1","1540055","1540340","63","11189600"
"JH378108","13126577","13126822","KQ058272v1","6315628","6315874","58","6810949"
"JH378108","13372555","13372883","KQ053025v1","49730","50045","74","13322825"
"JH378108","14490197","14490464","KQ055192v1","1201363","1201615","61","13288834"
"JH378108","14679575","14679877","KQ057788v1","561223","561518","76","14118352"
"JH378108","14885562","14885843","KQ057136v1","685943","686219","85","14199619"
"JH378108","15395766","15396063","KQ055097v1","1884579","1884874","62","13511187"
"JH378108","15592019","15592311","KQ053816v1","7464708","7465010","73","8127311"
"JH378108","15605977","15606284","KQ056568v1","1617795","1618102","77","13988182"
"JH378108","15813715","15813935","KQ058561v1","565602","565807","56","15248113"
"JH378108","16597752","16598032","KQ057603v1","1306760","1307030","73","15290992"
"JH378108","17222671","17222948","KQ054510v1","5210888","5211157","71","12011783"
"JH378108","17335031","17335166","KQ054510v1","8179279","8179421","35","9155752"
"JH378108","17474193","17474514","KQ053816v1","7045838","7046139","83","10428355"
"JH378108","17490131","17490297","KQ058383v1","3421845","3422005","43","14068286"
"JH378108","17910889","17910975","KQ054400v1","280157","280246","21","17630732"
"JH378108","17975912","17976186","KQ054069v1","955693","955974","70","17020219"
"JH378108","18107180","18107360","KQ058478v1","77180","77361","42","18030000"
"JH378108","18184200","18184413","KQ055014v1","599464","599668","52","17584736"
"JH378108","18188370","18188671","KQ055097v1","1567802","1568097","72","16620568"
"JH378108","18226887","18227063","KQ057449v1","2013176","2013351","40","16213711"
"JH378108","18307473","18307679","KQ057290v1","4745481","4745684","47","13561992"
"JH378108","18435846","18436135","KQ053299v1","21869448","21869738","57","3433602"
"JH378108","18534686","18534841","KQ058461v1","3297582","3297739","36","15237104"
"JH378108","18691712","18692021","KQ053299v1","2118230","2118517","72","16573482"
"JH378108","18714090","18714392","KQ052970v1","7313976","7314276","84","11400114"
"JH378108","18818701","18818991","KQ053631v1","6512697","6512984","70","12306004"
"JH378108","18849219","18849389","KQ053696v1","3211004","3211170","38","15638215"
"JH378108","18866646","18866800","KQ054533v1","1027813","1027974","40","17838833"
"JH378108","18879668","18879796","KQ053982v1","7381789","7381920","32","11497879"
"JH378108","18892992","18893246","KQ055320v1","2365107","2365346","68","16527885"
"JH378108","18894702","18894991","KQ055014v1","2491689","2491976","66","16403013"
"JH378108","18935565","18935848","KQ058275v1","938649","938919","60","17996916"
"JH378108","19035560","19035859","KQ058183v1","3247932","3248220","67","15787628"
"JH378108","19107301","19107437","KQ054533v1","748660","748796","33","18358641"
"JH378108","19107759","19107893","KQ053256v1","1284266","1284394","36","17823493"
"JH378108","19314018","19314183","KQ055014v1","682174","682339","33","18631844"
"JH378108","19749830","19750069","KQ058427v1","6379745","6379978","66","13370085"
"JH378108","19863612","19863776","KQ055014v1","15960","16127","34","19847652"
"JH378108","20153679","20153800","KQ054682v1","1583084","1583200","30","18570595"
"JH378108","20196293","20196411","KQ053187v1","324884","324999","28","19871409"
"JH378108","20239571","20239860","KQ054356v1","787783","788076","63","19451788"
"JH378108","20411363","20411645","KQ058316v1","6456357","6456653","69","13955006"
"JH378108","20517000","20517258","KQ057755v1","45985","46262","69","20471015"
"JH378108","20605568","20605819","KQ054933v1","935520","935770","63","19670048"
"JH378108","20617751","20617874","KQ055141v1","2421865","2421977","29","18195886"
"JH378108","20691201","20691509","KQ055518v1","326248","326564","63","20364953"
"JH378108","20782628","20782905","KQ057290v1","1053741","1054027","72","19728887"
"JH378108","20902353","20902603","KQ052971v1","6441372","6441626","62","14460981"
"JH378108","21025217","21025502","KQ058427v1","4553509","4553777","77","16471708"
"JH378108","21185580","21185865","KQ055957v1","1731327","1731617","75","19454253"
"JH378108","21216234","21216531","KQ057737v1","110075","110366","73","21106159"
"JH378108","21267611","21267768","KQ053365v1","134858","135027","45","21132753"
"JH378108","21387758","21388042","KQ056672v1","3082150","3082439","66","18305608"
"JH378108","21564985","21565279","KQ058353v1","1264780","1265071","55","20300205"
"JH378108","21704778","21705043","KQ056955v1","1460875","1461137","66","20243903"
"JH378108","21722988","21723159","KQ056855v1","3850449","3850612","38","17872539"
"JH378108","21872918","21873190","KQ056673v1","983726","984000","66","20889192"
"JH378108","22143825","22144070","KQ053982v1","1400209","1400429","69","20743616"
"JH378108","22153254","22153532","KQ058616v1","3808264","3808541","74","18344990"
"JH378108","22264603","22264901","KQ058184v1","1505565","1505858","73","20759038"
"JH378108","22623065","22623356","KQ055352v1","13451535","13451828","74","9171530"
"JH378108","22680667","22680981","KQ058266v1","495363","495656","77","22185304"
"JH378108","22836111","22836418","KQ058450v1","2960681","2960988","72","19875430"
"JH378108","22904522","22904813","KQ053421v1","2664387","2664683","66","20240135"
"JH378108","22916036","22916331","KQ052981v1","658787","659079","60","22257249"
"JH378108","23034474","23034671","KQ055404v1","3762645","3762830","46","19271829"
"JH378108","23044586","23044885","KQ053816v1","7464708","7465010","53","15579878"
"JH378108","23073240","23073383","KQ053982v1","3934263","3934401","36","19138977"
"JH378108","23131165","23131452","KQ058183v1","487423","487710","53","22643742"
"JH378108","23176560","23176790","KQ054693v1","3245566","3245803","61","19930994"
"JH378108","23189616","23189816","KQ058383v1","5244323","5244522","44","17945293"
"JH378108","23245977","23246283","KQ058184v1","1505565","1505858","78","21740412"
"JH378108","23299229","23299528","KQ053310v1","1170519","1170818","73","22128710"
"JH378108","23301511","23301730","KQ058572v1","913074","913293","54","22388437"
"JH378108","23359731","23359941","KQ057268v1","1608514","1608738","65","21751217"
"JH378108","23387000","23387323","KQ053816v1","7464708","7465010","75","15922292"
"JH378108","23495972","23496088","KQ053785v1","361683","361800","25","23134289"
"JH378108","23520625","23520793","KQ055014v1","15960","16127","39","23504665"
"JH378108","23520972","23521096","KQ056404v1","1195188","1195317","30","22325784"
"JH378108","23569379","23569679","KQ053816v1","7327018","7327317","62","16242361"
"JH378108","23587191","23587321","KQ054932v1","5190304","5190436","23","18396887"
"JH378108","23731319","23731609","KQ058004v1","1100771","1101059","79","22630548"
"JH378108","23820439","23820578","KQ056568v1","798477","798603","45","23021962"
"JH378108","23820609","23820738","KQ058495v1","301929","302060","25","23518680"
"JH378108","23911093","23911287","KQ052970v1","7199437","7199628","41","16711656"
"JH378108","23990591","23990754","KQ055872v1","5870772","5870928","37","18119819"
"JH378108","24009646","24009775","KQ052968v1","13626337","13626476","39","10383309"
"JH378108","24128232","24128344","KQ058494v1","8405615","8405726","38","15722617"
"JH378108","24321185","24321472","KQ056331v1","106636","106916","68","24214549"
"JH378108","24337728","24338033","KQ058184v1","1505565","1505858","63","22832163"
"JH378108","24346626","24346842","KQ053609v1","2642121","2642332","51","21704505"
"JH378108","24635615","24635718","KQ052969v1","2661859","2661968","27","21973756"
"JH378108","25301569","25301703","KQ053332v1","575690","575814","35","24725879"
"JH378108","25401897","25402169","KQ056587v1","1312432","1312709","68","24089465"
"JH378108","26027489","26027800","KQ053827v1","4217183","4217477","73","21810306"
"JH378108","26608618","26608913","KQ053190v1","5623449","5623748","63","20985169"
"JH378108","26884709","26885013","KQ054191v1","3583730","3584032","76","23300979"
"JH378108","26935392","26935486","KQ053223v1","2552349","2552442","26","24383043"
"JH378108","26935970","26936044","KQ055979v1","1425","1498","22","26934545"
"JH378108","26943565","26943642","KQ052968v1","9483686","9483763","25","17459879"
"JH378108","26950082","26950363","KQ053387v1","3128366","3128646","69","23821716"
"JH378108","26987172","26987239","KQ054943v1","3387644","3387704","23","23599528"
"JH378108","26988067","26988307","KQ057656v1","1375539","1375777","58","25612528"
"JH378108","27371756","27371999","KQ053387v1","564882","565122","60","26806874"
"JH378108","27848585","27848848","KQ055629v1","27732","27989","65","27820853"
"JH378108","28053007","28053309","KQ058372v1","1134128","1134432","63","26918879"
"JH378108","28566903","28567212","KQ052970v1","10883964","10884266","74","17682939"
"JH378108","28977759","28977887","KQ054499v1","472083","472205","29","28505676"
"JH378108","29069147","29069286","KQ053004v1","3051555","3051691","35","26017592"
"JH378108","29359027","29359304","KQ052970v1","8520800","8521088","77","20838227"
"JH378108","30717619","30717857","KQ056587v1","17778524","17778766","70","12939095"
"JH378108","30882334","30882473","KQ056996v1","661309","661441","39","30221025"
"JH378108","30950328","30950646","KQ056310v1","349137","349447","78","30601191"
"JH378108","30954571","30954895","KQ054682v1","2125705","2126015","77","28828866"
"JH378108","30988015","30988321","KQ058184v1","1505565","1505858","72","29482450"
"JH378108","31090124","31090213","KQ053398v1","4200835","4200909","31","26889289"
"JH378108","31090621","31090707","KQ053082v1","7408393","7408474","25","23682228"
"JH378108","31112351","31112649","KQ054804v1","964015","964313","66","30148336"
"JH378108","31126720","31126999","KQ057737v1","2756211","2756494","59","28370509"
"JH378108","31146213","31146342","KQ053718v1","316226","316356","23","30829987"
"JH378108","31231656","31231833","KQ056587v1","7602017","7602187","51","23629639"
"JH378108","31237549","31237610","KQ056928v1","835672","835737","18","30401877"
"JH378108","31259732","31259996","KQ058538v1","1444447","1444703","68","29815285"
"JH378108","31499506","31499792","KQ053752v1","35796","36072","81","31463710"
"JH378108","31514069","31514378","KQ054671v1","1130836","1131142","70","30383233"
"JH378108","31546493","31546768","KQ055978v1","3560415","3560681","79","27986078"
"JH378108","31563516","31563777","KQ053971v1","2955866","2956116","71","28607650"
"JH378108","31671655","31671915","KQ058539v1","60805","61074","75","31610850"
"JH378108","31733121","31733442","KQ056588v1","65800","66114","82","31667321"
"JH378108","31742358","31742552","ABDC02055963v1","5","192","43","31742353"
"JH378108","31757387","31757672","KQ054745v1","933559","933827","80","30823828"
"JH378108","31760696","31760830","KQ053982v1","7381789","7381920","23","24378907"
"JH378108","31827472","31827784","KQ058490v1","420741","421044","66","31406731"
"JH378108","31888584","31888797","KQ053332v1","1938314","1938530","62","29950270"
"JH378108","32103833","32104055","KQ053310v1","3196302","3196523","70","28907531"
"JH378108","32166822","32167034","KQ054081v1","1002095","1002297","47","31164727"
"JH378108","32222074","32222365","KQ054289v1","107239","107526","77","32114835"
"JH378108","32295306","32295486","KQ055273v1","46777","46952","54","32248529"
"JH378108","32368070","32368351","KQ057204v1","1712399","1712670","65","30655671"
"JH378108","32401262","32401562","KQ054412v1","2490468","2490761","59","29910794"
"JH378108","32455241","32455542","KQ058184v1","1505565","1505858","57","30949676"
"JH378108","32496136","32496404","KQ058561v1","7531454","7531724","60","24964682"
"JH378108","32531853","32532148","KQ053740v1","2323389","2323680","74","30208464"
"JH378108","32535663","32535963","KQ053816v1","7327018","7327317","68","25208645"
"JH378108","32557523","32557743","KQ055549v1","3253754","3253974","60","29303769"
"JH378108","32751542","32751870","KQ058394v1","9107761","9108054","88","23643781"
"JH378108","32751918","32752090","KQ054510v1","8888528","8888700","39","23863390"
"JH378108","32766746","32766939","KQ053554v1","293392","293586","48","32473354"
"JH378108","32770710","32770966","KQ054704v1","232562","232813","76","32538148"
"JH378108","32957556","32957831","KQ058291v1","474599","474881","62","32482957"
"JH378108","32975248","32975528","KQ058275v1","938649","938919","63","32036599"
"JH378108","32975939","32976254","KQ055872v1","2402427","2402732","70","30573512"
"JH378108","32977367","32977666","KQ058242v1","722153","722450","68","32255214"
"JH378108","33083656","33083962","KQ053093v1","1738898","1739201","68","31344758"
"JH378108","33202759","33202831","KQ055979v1","1425","1498","13","33201334"
"JH378108","33258888","33259178","KQ058538v1","1399962","1400253","59","31858926"
"JH378108","33361162","33361444","KQ054536v1","6222","6488","79","33354940"
"JH378108","33380789","33380929","KQ053741v1","1685544","1685681","36","31695245"
"JH378108","33477070","33477436","KQ053135v1","3687285","3687645","108","29789785"
"JH378108","33506172","33506324","KQ055384v1","843998","844147","30","32662174"
"JH378108","33595951","33596248","KQ056475v1","14677","14970","63","33581274"
"JH378108","33691576","33691888","KQ058184v1","1505565","1505858","71","32186011"
"JH378108","33723410","33723737","KQ053631v1","9631170","9631468","98","24092240"
"JH378108","33873822","33874104","KQ053959v1","2212270","2212546","69","31661552"
"JH378108","33931183","33931459","KQ053409v1","5686466","5686740","76","28244717"
"JH378108","33985650","33985781","KQ058561v1","3297234","3297359","29","30688416"
"JH378108","33991365","33991516","KQ055247v1","5533181","5533323","42","28458184"
"JH378108","34021318","34021617","KQ058291v1","474599","474881","70","33546719"
"JH378108","34021833","34022186","KQ058287v1","982841","983179","86","33038992"
"JH378108","34044832","34045135","KQ058438v1","548495","548786","68","33496337"
"JH378108","34070754","34071007","KQ056148v1","5020971","5021229","70","29049783"
"JH378108","34090518","34090767","KQ054933v1","935520","935770","63","33154998"
"JH378108","34130182","34130431","KQ054069v1","2389274","2389511","70","31740908"
"JH378108","34179273","34179397","KQ054510v1","8272255","8272377","31","25907018"
"JH378108","34218210","34218482","KQ055735v1","667472","667747","68","33550738"
"JH378108","34301931","34302204","KQ054124v1","2442155","2442433","73","31859776"
"JH378108","34377551","34377855","KQ053631v1","7288314","7288608","74","27089237"
"JH378108","34384569","34384621","KQ053632v1","195846","195898","8","34188723"
"JH378108","34401123","34401401","KQ053498v1","169879","170149","68","34231244"
"JH378108","34445319","34445585","ABDC02051297v1","1939","2213","67","34443380"
"JH378108","34448729","34448944","KQ053609v1","2642121","2642332","64","31806608"
"JH378108","34493560","34493678","KQ053849v1","2918468","2918588","28","31575092"
"JH378108","34518860","34519062","KQ055490v1","1751422","1751617","56","32767438"
"JH378108","34522447","34522753","KQ056440v1","1157164","1157460","51","33365283"
"JH378108","34529038","34529339","KQ053631v1","7288314","7288608","80","27240724"
"JH378108","34537633","34537726","KQ056540v1","227724","227816","21","34309909"
"JH378108","34665238","34665509","KQ054826v1","9969237","9969502","69","24696001"
"JH378108","34692550","34692854","KQ056331v1","1501968","1502262","76","33190582"
"JH378108","34707317","34707455","KQ052968v1","13707910","13708039","30","20999407"
"JH378108","34726773","34727055","KQ058317v1","5506620","5506904","68","29220153"
"JH378108","34774576","34774739","KQ058265v1","212584","212745","30","34561992"
"JH378108","34876928","34877226","KQ053740v1","2323389","2323680","63","32553539"
"JH378108","34891515","34891754","KQ057034v1","3957140","3957365","63","30934375"
"JH378108","34892168","34892231","KQ052968v1","8156468","8156529","19","26735700"
"JH378108","35133864","35134144","KQ054412v1","1824448","1824730","91","33309416"
"JH378108","35377208","35377456","KQ058405v1","697304","697560","70","34679904"
"JH378108","35704033","35704192","KQ058339v1","1288900","1289062","38","34415133"
"JH378108","35783679","35783796","KQ053157v1","7994190","7994309","23","27789489"
"JH378108","35795746","35796049","KQ055097v1","2825545","2825834","73","32970201"
"JH378108","36586508","36586787","KQ058427v1","4553509","4553777","67","32032999"
"JH378108","37069786","37069890","KQ057909v1","13527094","13527201","25","23542692"
"JH378108","37095103","37095404","KQ053115v1","3485337","3485650","72","33609766"
"JH378108","37631762","37632067","KQ052968v1","7300500","7300792","60","30331262"
"JH378108","38100682","38100953","KQ054660v1","3676105","3676388","79","34424577"
"JH378108","38133802","38134070","KQ057290v1","534242","534517","64","37599560"
"JH378108","38205713","38205872","KQ054466v1","1866785","1866925","40","36338928"
"JH378108","38210904","38211178","KQ055394v1","3441211","3441489","63","34769693"
"JH378108","38727095","38727239","KQ055141v1","2115239","2115370","33","36611856"
"JH378108","39085001","39085286","KQ058033v1","76819","77103","67","39008182"
"JH378108","39248263","39248558","KQ055097v1","1884579","1884874","71","37363684"
"JH378108","39298389","39298652","KQ053365v1","327436","327701","62","38970953"
"JH378108","39481980","39482270","KQ056234v1","2521120","2521411","71","36960860"
"JH378108","39495392","39495561","KQ056945v1","2675278","2675453","45","36820114"
"JH378108","39928771","39929063","KQ053190v1","5495992","5496283","75","34432779"
"JH378108","40178337","40178646","KQ057875v1","561558","561851","84","39616779"
"JH378108","40415322","40415648","KQ054510v1","2100811","2101122","82","38314511"
"JH378108","40536032","40536337","KQ058484v1","1273599","1273890","71","39262433"
"JH378108","40697163","40697481","KQ058184v1","1505565","1505858","90","39191598"
"JH378108","40861960","40862126","KQ054279v1","635355","635545","58","40226605"
"JH378108","41213465","41213779","KQ058594v1","6070669","6070969","78","35142796"
"JH378108","41382552","41382845","KQ058427v1","2533789","2534086","81","38848763"
"JH378108","41676673","41676965","KQ057693v1","621833","622123","62","41054840"
"JH378108","42087758","42088036","KQ053520v1","456408","456696","72","41631350"
"JH378108","42497227","42497486","KQ056773v1","122800","123057","59","42374427"
"JH378108","42548002","42548290","KQ055173v1","452351","452623","73","42095651"
"JH378108","42670941","42671115","KQ054168v1","859124","859305","46","41811817"
"JH378108","42956311","42956472","KQ055872v1","3992534","3992693","32","38963777"
"JH378108","43223224","43223356","KQ053948v1","2765570","2765701","27","40457654"
"JH378108","43449392","43449541","KQ055394v1","2370199","2370316","55","41079193"
"JH378108","43546012","43546158","KQ056055v1","2764","2905","32","43543248"
"JH378108","43687999","43688297","KQ058474v1","218695","218994","69","43469304"
"JH378108","43786950","43787268","KQ053234v1","810274","810574","82","42976676"
"JH378108","44104907","44105160","KQ058503v1","123813","124064","63","43981094"
"JH378108","44293721","44293990","KQ055014v1","517341","517616","77","43776380"
"JH378108","44380529","44380802","KQ052969v1","8465928","8466216","69","35914601"
"JH378108","44414782","44415091","KQ058582v1","1599482","1599782","62","42815300"
"JH378108","44479580","44479875","KQ053109v1","131996","132292","74","44347584"
"JH378108","44484755","44485047","KQ053212v1","1248645","1248940","67","43236110"
"JH378108","44863692","44863851","KQ057336v1","635116","635282","39","44228576"
"JH378108","44956344","44956653","KQ053093v1","1738898","1739201","64","43217446"
"JH378108","45246557","45246685","KQ058280v1","21417","21542","20","45225140"
"JH378108","45277384","45277659","KQ054932v1","10830322","10830609","68","34447062"
"JH378108","45388990","45389145","KQ054356v1","2063578","2063712","51","43325412"
"JH378108","45420722","45420837","KQ053849v1","2581886","2582009","33","42838836"
"JH378108","45614249","45614387","KQ053654v1","4929533","4929667","26","40684716"
"JH378108","45721235","45721538","KQ053816v1","7464708","7465010","61","38256527"
"JH378108","45819274","45819565","KQ058350v1","6740286","6740580","62","39078988"
"JH378108","45850201","45850508","KQ052970v1","9695320","9695625","85","36154881"
"JH378108","45907571","45907864","KQ053520v1","3826144","3826443","76","42081427"
"JH378108","45916564","45916826","KQ056920v1","346245","346510","58","45570319"
"JH378108","45964736","45965019","KQ054765v1","1675072","1675339","84","44289664"
"JH378108","46030504","46030799","KQ056790v1","446564","446855","72","45583940"
"JH378108","46044945","46045181","KQ054660v1","2829812","2830044","58","43215133"
"JH378108","46054857","46055009","KQ056663v1","464182","464321","40","45590675"
"JH378108","46106086","46106360","KQ055978v1","3560415","3560681","67","42545671"
"JH378108","46110436","46110772","KQ054202v1","380178","380469","87","45730258"
"JH378108","46171102","46171394","KQ054565v1","836477","836767","64","45334625"
"JH378108","46198822","46199131","KQ055787v1","694393","694708","75","45504429"
"JH378108","46302869","46303073","KQ055457v1","1673513","1673719","47","44629356"
"JH378108","46714090","46714310","KQ055978v1","1055761","1055981","44","45658329"
"JH378108","46775580","46775713","KQ052970v1","2955883","2956009","41","43819697"
"JH378108","46954254","46954517","KQ058503v1","123813","124064","64","46830441"
"JH378108","46974042","46974357","KQ053299v1","4095914","4096215","73","42878128"
"JH378108","47716500","47716709","KQ053398v1","3158290","3158500","60","44558210"
"JH378108","48049302","48049620","KQ054068v1","5491779","5492087","82","42557523"
"JH378108","48062885","48063049","KQ053190v1","5905807","5905973","43","42157078"
"JH378108","48221608","48221769","KQ052969v1","8430836","8430996","36","39790772"
"JH378108","48236063","48236324","KQ052970v1","11867674","11867953","63","36368389"
"JH378108","48346303","48346593","KQ056331v1","1501968","1502262","66","46844335"
"JH378108","48596353","48596634","KQ058094v1","6015552","6015834","75","42580801"
"JH378108","48625180","48625428","KQ058328v1","2569266","2569497","64","46055914"
"JH378108","49053387","49053692","KQ053420v1","122023","122324","67","48931364"
"JH378108","49110596","49110826","KQ054401v1","3245220","3245428","77","45865376"
"JH378108","49423016","49423314","KQ056973v1","783590","783885","71","48639426"
"JH378108","49689829","49690065","KQ057291v1","322948","323180","60","49366881"
"JH378108","49697006","49697312","KQ055914v1","218683","218977","63","49478323"
"JH378108","49756053","49756153","KQ053157v1","203721","203827","25","49552332"
"JH378108","49760455","49760538","KQ057737v1","356405","356487","19","49404050"
"JH378108","49867781","49867925","KQ053190v1","2372433","2372579","32","47495348"
"JH378108","49919479","49919605","KQ056147v1","1828259","1828388","25","48091220"
"JH378108","50009032","50009244","KQ054826v1","7733380","7733605","63","42275652"
"JH378108","50696722","50697012","KQ054069v1","3733362","3733643","60","46963360"
"JH378108","50818812","50819099","KQ053752v1","135567","135860","73","50683245"
"JH378108","50857601","50857893","KQ055183v1","3160885","3161168","63","47696716"
"JH378108","50920076","50920363","KQ054510v1","8555095","8555387","64","42364981"
"JH378108","50939819","50940097","KQ057822v1","52257","52533","56","50887562"
"JH378108","50983572","50983862","KQ054412v1","2490468","2490761","65","48493104"
"JH378108","51056972","51057132","KQ056147v1","3323","3476","38","51053649"
"JH378108","51513804","51514020","KQ058505v1","2234909","2235124","60","49278895"
"JH378108","51708616","51708879","KQ056182v1","539878","540134","80","51168738"
"JH378108","51791021","51791333","KQ054964v1","665129","665440","77","51125892"
"JH378108","51874091","51874361","KQ053993v1","1017100","1017367","78","50856991"
"JH378108","51994882","51995156","KQ056254v1","1300375","1300653","69","50694507"
"JH378108","52239743","52239872","KQ055298v1","1575436","1575566","24","50664307"
"JH378108","52801583","52801710","KQ055479v1","2280436","2280558","40","50521147"
"JH378108","52810744","52811002","ABDC02001028v1","1438","1684","83","52809306"
"JH378108","52911408","52911708","KQ054213v1","780092","780393","71","52131316"
"JH378108","52931042","52931336","KQ053398v1","3445470","3445768","70","49485572"
"JH378108","53289342","53289657","KQ053223v1","652834","653148","68","52636508"
"JH378108","53588140","53588259","KQ053019v1","394011","394133","31","53194129"
"JH378108","53799475","53799647","KQ058571v1","931737","931906","35","52867738"
"JH378108","53942016","53942118","KQ058355v1","511262","511357","21","53430754"
"JH378108","53984214","53984361","KQ053631v1","6372458","6372604","39","47611756"
"JH378108","54197323","54197608","KQ057118v1","2470263","2470561","63","51727060"
"JH378108","54684373","54684461","KQ056148v1","5019141","5019230","16","49665232"
"JH378109","85919","86204","KQ058184v1","1505565","1505858","75","1419646"
"JH378109","243017","243150","KQ055298v1","1575436","1575566","21","1332419"
"JH378109","1083167","1083470","KQ054786v1","934497","934799","73","148670"
"JH378109","1182315","1182587","KQ058316v1","4984552","4984820","84","3802237"
"JH378109","1534858","1534970","KQ056064v1","5108638","5108754","26","3573780"
"JH378109","1553373","1553665","KQ054565v1","6587941","6588226","81","5034568"
"JH378109","1567970","1568101","KQ055236v1","1859314","1859441","30","291344"
"JH378109","1568116","1568189","KQ054068v1","1383975","1384041","21","184141"
"JH378109","2041413","2041685","KQ058004v1","4701579","4701856","70","2660166"
"JH378109","2063960","2064258","KQ053631v1","9116387","9116675","71","7052427"
"JH378109","2404303","2404550","KQ054456v1","4787552","4787805","69","2383249"
"JH378109","2652102","2652368","KQ057504v1","162767","163049","65","2489335"
"JH378109","2764792","2765077","KQ058184v1","1505565","1505858","79","1259227"
"JH378109","3129779","3129920","KQ052969v1","8332082","8332226","37","5202303"
"JH378109","3131767","3131908","KQ053565v1","3424702","3424834","37","292935"
"JH378109","3173108","3173377","KQ055893v1","1771908","1772186","81","1401200"
"JH378109","3181001","3181302","KQ056672v1","3086385","3086688","79","94616"
"JH378109","3228792","3229086","KQ055141v1","378501","378798","72","2850291"
"JH378109","4366225","4366528","KQ055787v1","1064992","1065293","70","3301233"
"JH378109","4822252","4822559","KQ053420v1","122023","122324","76","4700229"
"JH378109","5816235","5816402","KQ053850v1","197751","197910","44","5618484"
"JH378109","5829670","5829913","KQ055352v1","6335992","6336248","76","506322"
"JH378109","5883038","5883322","KQ055036v1","1508392","1508683","62","4374646"
"JH378109","5905729","5906051","KQ055141v1","1054026","1054336","83","4851703"
"JH378109","6254789","6255088","KQ053299v1","21835674","21835971","67","15580885"
"JH378109","6590085","6590376","KQ052969v1","9553757","9554052","67","2963672"
"JH378109","6726546","6726838","KQ053115v1","1118362","1118655","59","5608184"
"JH378109","6778547","6778830","KQ057290v1","534242","534517","65","6244305"
"JH378109","7587014","7587103","KQ053082v1","6601560","6601653","17","985454"
"JH378109","7587368","7587555","KQ053948v1","2270313","2270496","47","5317055"
"JH378109","7679023","7679186","KQ056996v1","1524030","1524195","36","6154993"
"JH378109","7687102","7687325","KQ054704v1","483937","484161","62","7203165"
"JH378109","7843705","7843785","KQ053398v1","4200835","4200909","26","3642870"
"JH378109","7941757","7942022","KQ054289v1","4355551","4355817","71","3586206"
"JH378109","8326796","8327089","KQ054124v1","2442155","2442433","63","5884641"
"JH378109","8372049","8372170","KQ054649v1","1173471","1173595","33","7198578"
"JH378109","8502504","8502790","KQ053299v1","20600753","20601033","75","12098249"
"JH378109","8511464","8511753","KQ055852v1","1231373","1231668","59","7280091"
"JH378109","8543290","8543587","KQ054565v1","6587941","6588226","74","1955349"
"JH378109","8589049","8589325","KQ058594v1","1719198","1719477","65","6869851"
"JH378109","8603131","8603382","KQ056568v1","971857","972102","53","7631274"
"JH378109","8650005","8650303","KQ053135v1","2766167","2766465","67","5883838"
"JH378109","8716856","8717141","KQ055468v1","1611526","1611815","67","7105330"
"JH378109","8869233","8869518","KQ052968v1","6282633","6282918","69","2586600"
"JH378109","8904433","8904692","KQ058353v1","1449127","1449389","72","7455306"
"JH378109","9081542","9081838","KQ057522v1","1495406","1495703","78","7586136"
"JH378109","9160111","9160390","KQ058484v1","1229388","1229668","68","7930723"
"JH378109","9209228","9209566","KQ058372v1","1076965","1077278","98","8132263"
"JH378109","9638770","9638866","KQ053675v1","1338166","1338271","28","8300604"
"JH378109","9639258","9639342","KQ055755v1","1329385","1329455","29","8309873"
"JH378109","10376158","10376471","KQ053816v1","7464708","7465010","79","2911450"
"JH378109","10439561","10439845","KQ053278v1","2495073","2495369","68","7944488"
"JH378109","10720047","10720193","KQ053115v1","1650505","1650644","33","9069542"
"JH378109","10759510","10759815","KQ053816v1","7045838","7046139","89","3713672"
"JH378109","10804263","10804450","KQ054180v1","511425","511611","57","10292838"
"JH378109","11000042","11000344","KQ058483v1","6010751","6011031","85","4989291"
"JH378109","11132504","11132649","KQ056147v1","2168964","2169108","26","8963540"
"JH378109","11144678","11144803","KQ053409v1","6105325","6105446","28","5039353"
"JH378109","11264633","11264808","KQ056996v1","1524030","1524195","51","9740603"
"JH378109","11294001","11294297","KQ058184v1","1505565","1505858","74","9788436"
"JH378109","11450969","11451233","KQ058242v1","122902","123175","68","11328067"
"JH378109","11477407","11477553","KQ053299v1","2636184","2636329","29","8841223"
"JH378109","11804758","11804906","KQ054693v1","1748877","1749022","37","10055881"
"JH378109","11891362","11891483","KQ056035v1","296324","296444","23","11595038"
"JH378109","11947064","11947148","KQ056375v1","1151640","1151722","28","10795424"
"JH378109","11947701","11947894","KQ054933v1","3939617","3939804","43","8008084"
"JH378109","12100197","12100476","KQ058283v1","3525175","3525450","53","8575022"
"JH378109","12432716","12433002","KQ055777v1","788390","788678","78","11644326"
"JH378109","12508573","12508890","KQ054932v1","9683849","9684160","73","2824724"
"JH378109","12833433","12833736","KQ058272v1","6007682","6007982","62","6825751"
"JH378109","12992803","12993088","KQ056558v1","670740","671032","76","12322063"
"JH378109","13094615","13094816","KQ055014v1","2321535","2321726","51","10773080"
"JH378109","13174356","13174492","KQ054868v1","1966723","1966859","22","11207633"
"JH378109","13298614","13298906","KQ053299v1","21835674","21835971","69","8537060"
"JH378109","13322691","13322964","KQ053795v1","370451","370712","61","12952240"
"JH378109","13334356","13334626","KQ053696v1","3248742","3249021","68","10085614"
"JH378109","13444619","13444797","KQ053126v1","200434","200608","52","13244185"
"JH378109","13475958","13476255","KQ055457v1","8436987","8437281","60","5038971"
"JH378109","13660949","13661253","KQ055457v1","2061137","2061448","64","11599812"
"JH378109","13680703","13680988","KQ054693v1","832788","833076","57","12847915"
"JH378109","13682992","13683269","KQ056331v1","106636","106916","66","13576356"
"JH378109","13806583","13806892","KQ054682v1","2125705","2126015","67","11680878"
"JH378109","13864789","13865049","KQ053498v1","2883835","2884087","68","10980954"
"JH378109","13902477","13902783","KQ057858v1","376905","377209","65","13525572"
"JH378109","14010167","14010399","KQ058272v1","2561906","2562124","59","11448261"
"JH378109","14014130","14014462","KQ057909v1","14156146","14156474","79","142016"
"JH378109","14039893","14040171","KQ055725v1","2638016","2638288","71","11401877"
"JH378109","14100520","14100778","KQ058084v1","45517","45787","71","14055003"
"JH378109","14126958","14127091","KQ054179v1","3927334","3927468","20","10199624"
"JH378109","14137236","14137491","KQ052970v1","3216316","3216523","89","10920920"
"JH378109","14171049","14171246","KQ054081v1","1002095","1002297","54","13168954"
"JH378109","14573824","14574119","KQ053212v1","1560173","1560471","67","13013651"
"JH378109","14583123","14583396","KQ053740v1","716482","716767","67","13866641"
"JH378109","14607663","14607970","KQ056996v1","837133","837431","74","13770530"
"JH378109","14627775","14628058","KQ058275v1","938649","938919","61","13689126"
"JH378109","14854362","14854641","KQ055119v1","2748969","2749251","71","12105393"
"JH378109","14863891","14864184","KQ057693v1","117172","117472","72","14746719"
"JH378109","14954510","14954808","KQ053081v1","2094351","2094648","86","12860159"
"JH378109","14956007","14956124","KQ058350v1","1062787","1062904","26","13893220"
"JH378109","14956273","14956470","KQ053332v1","848203","848389","57","14108070"
"JH378109","14963341","14963426","KQ057821v1","1407299","1407387","26","13556042"
"JH378109","14981576","14981897","KQ052969v1","9116808","9117108","67","5864768"
"JH378109","15006078","15006340","KQ055192v1","1201363","1201615","60","13804715"
"JH378109","15073918","15074202","KQ052971v1","6686838","6687124","72","8387080"
"JH378109","15122844","15123128","KQ058389v1","2329886","2330179","68","12792958"
"JH378109","15150726","15151036","KQ056148v1","3012765","3013044","102","12137961"
"JH378109","15183740","15184028","KQ057737v1","2756211","2756494","66","12427529"
"JH378109","15194152","15194456","KQ052981v1","1198440","1198752","74","13995712"
"JH378109","15224975","15225108","KQ052968v1","13421979","13422119","38","1802996"
"JH378109","15294602","15294893","KQ053465v1","3806004","3806288","64","11488598"
"JH378109","15454756","15455034","KQ055590v1","962353","962634","65","14492403"
"JH378109","15560894","15561192","KQ053343v1","1747702","1748011","72","13813192"
"JH378109","15600052","15600171","KQ058328v1","4075684","4075799","35","11524368"
"JH378109","15756698","15756993","KQ057702v1","1420535","1420827","76","14336163"
"JH378109","15762238","15762322","KQ057737v1","356405","356487","22","15405833"
"JH378109","15857693","15857916","KQ055457v1","9003971","9004197","59","6853722"
"JH378109","16060114","16060338","KQ055872v1","3361212","3361420","64","12698902"
"JH378109","16148416","16148690","KQ053332v1","447571","447853","60","15700845"
"JH378109","16164066","16164202","KQ057648v1","2314551","2314685","23","13849515"
"JH378109","16245495","16245809","KQ056855v1","2837412","2837717","80","13408083"
"JH378109","16300149","16300291","KQ057788v1","949735","949853","50","15350414"
"JH378109","16358701","16358968","KQ054301v1","3391378","3391638","66","12967323"
"JH378109","16392353","16392669","KQ053432v1","4280053","4280348","66","12112300"
"JH378109","16473326","16473524","KQ054401v1","3245220","3245428","54","13228106"
"JH378109","16521149","16521431","KQ058257v1","502287","502580","72","16018862"
"JH378109","16839862","16839986","KQ056404v1","1195188","1195317","27","15644674"
"JH378109","17161908","17162116","KQ053256v1","942460","942674","53","16219448"
"JH378109","17177397","17177557","KQ054412v1","2185013","2185160","36","14992384"
"JH378109","17463830","17464126","KQ054180v1","1484199","1484494","82","15979631"
"JH378109","17578840","17579111","KQ053948v1","168940","169229","77","17409900"
"JH378109","17799993","17800313","KQ056568v1","1617795","1618102","79","16182198"
"JH378109","18257055","18257199","KQ058509v1","50870","51012","28","18206185"
"JH378109","18489574","18489733","KQ053565v1","1922532","1922687","39","16567042"
"JH378109","18785124","18785399","KQ054124v1","2442155","2442433","65","16342969"
"JH378109","18830132","18830408","KQ053297v1","44026","44315","72","18786106"
"JH378109","18969948","18970187","KQ053026v1","2213601","2213834","68","16756347"
"JH378109","19107497","19107810","KQ058184v1","1505565","1505858","69","17601932"
"JH378109","19109312","19109612","KQ056672v1","6393431","6393732","88","12715881"
"JH378109","19659635","19659913","KQ052970v1","6659487","6659775","69","13000148"
"JH378109","20218725","20219022","KQ054102v1","1325684","1325978","71","18893041"
"JH378109","20367029","20367309","KQ055787v1","925083","925374","81","19441946"
"JH378109","20377659","20377951","KQ054565v1","6079929","6080214","66","14297730"
"JH378109","20747411","20747668","KQ056044v1","570262","570509","66","20177149"
"JH378109","20796715","20797013","KQ058184v1","1505565","1505858","59","19291150"
"JH378109","20860237","20860439","KQ053294v1","648","849","56","20859589"
"JH378109","20974902","20975210","KQ053432v1","6072921","6073219","89","14901981"
"JH378109","20980815","20981063","KQ058503v1","123813","124064","59","20857002"
"JH378109","21002648","21002774","KQ056293v1","110261","110385","28","20892387"
"JH378109","21131745","21132004","KQ058329v1","246650","246919","68","20885095"
"JH378109","21156419","21156572","KQ056147v1","2168964","2169108","33","18987455"
"JH378109","21208276","21208562","KQ056973v1","783590","783885","73","20424686"
"JH378109","21571223","21571416","KQ055892v1","1173","1363","48","21570050"
"JH378109","22186757","22187054","KQ053465v1","167701","167983","78","22019056"
"JH378109","22245056","22245353","KQ053297v1","44026","44315","86","22201030"
"JH378109","22568408","22568712","KQ057693v1","117172","117472","68","22451236"
"JH378109","22693340","22693598","KQ058516v1","1888551","1888807","66","20804789"
"JH378109","23248047","23248353","KQ057036v1","1392073","1392368","87","21855974"
"JH378109","24077434","24077734","KQ057035v1","3194687","3194980","69","20882747"
"JH378109","24127975","24128246","KQ057213v1","1074642","1074915","70","23053333"
"JH378109","24560893","24561184","KQ054510v1","7031374","7031652","70","17529519"
"JH378109","24734892","24735040","KQ053631v1","6372458","6372604","37","18362434"
"JH378109","24745922","24746214","KQ054135v1","2702098","2702381","72","22043824"
"JH378109","24907091","24907371","KQ055173v1","248885","249169","79","24658206"
"JH378109","25003288","25003578","KQ054565v1","6587941","6588226","67","18415347"
"JH378109","25148467","25148624","KQ058427v1","12281154","12281310","37","12867313"
"JH378109","25162688","25162957","KQ058316v1","2555894","2556176","71","22606794"
"JH378109","25371484","25371754","KQ058413v1","348155","348432","62","25023329"
"JH378109","25409404","25409706","KQ057911v1","428931","429228","70","24980473"
"JH378109","25659061","25659291","KQ054510v1","8112428","8112664","80","17546633"
"JH378109","25779378","25779644","KQ058394v1","2881287","2881567","70","22898091"
"JH378109","25800117","25800218","KQ052982v1","1023528","1023630","18","24776589"
"JH378109","25810398","25810672","KQ054400v1","2059350","2059621","66","23751048"
"JH378109","25925242","25925526","KQ055819v1","820090","820395","83","25105152"
"JH378109","25951757","25952032","KQ056423v1","1792966","1793243","70","24158791"
"JH378109","25953331","25953631","KQ056404v1","176748","177054","73","25776583"
"JH378109","25961903","25962160","KQ058561v1","1351959","1352198","76","24609944"
"JH378109","26036572","26036878","KQ053093v1","1738898","1739201","68","24297674"
"JH378109","26052985","26053267","KQ053093v1","1361295","1361576","72","24691690"
"JH378109","26151391","26151678","KQ053093v1","3162517","3162806","69","22988874"
"JH378109","26269228","26269513","KQ053332v1","447571","447853","62","25821657"
"JH378109","26272694","26272988","KQ053115v1","1118362","1118655","69","25154332"
"JH378109","26394083","26394361","KQ053993v1","1017100","1017367","68","25376983"
"JH378109","26417570","26417867","KQ057702v1","1420535","1420827","64","24997035"
"JH378109","26568271","26568578","KQ058315v1","658193","658490","68","25910078"
"JH378109","26570187","26570322","KQ057268v1","150223","150357","25","26419964"
"JH378109","26612518","26612835","KQ054400v1","4609733","4610042","70","22002785"
"JH378109","26641396","26641681","KQ058550v1","2728733","2729016","61","23912663"
"JH378109","26642220","26642493","KQ055662v1","1906494","1906757","70","24735726"
"JH378109","26645031","26645316","KQ053827v1","2948623","2948910","65","23696408"
"JH378109","26714811","26715133","KQ053288v1","2034811","2035125","73","24680000"
"JH378109","26717032","26717170","KQ053157v1","4288391","4288538","40","22428641"
"JH378109","26846421","26846720","KQ056530v1","922943","923229","70","25923478"
"JH378109","27314143","27314441","KQ058350v1","6740286","6740580","67","20573857"
"JH378109","27318467","27318753","KQ055065v1","1117201","1117481","62","26201266"
"JH378109","27632072","27632347","KQ053409v1","5686466","5686740","66","21945606"
"JH378109","27708614","27708754","KQ058561v1","557545","557678","28","27151069"
"JH378109","28195951","28196159","KQ053609v1","2642121","2642332","58","25553830"
"JH378109","28665119","28665266","KQ056234v1","319108","319254","40","28346011"
"JH378109","28862667","28862953","KQ052968v1","11214344","11214622","60","17648323"
"JH378109","29083248","29083536","KQ055087v1","1063066","1063349","65","28020182"
"JH378109","29113285","29113580","KQ055097v1","1884579","1884874","62","27228706"
"JH378109","29355767","29356072","KQ056345v1","621994","622295","75","28733773"
"JH378109","30125205","30125497","KQ054745v1","919926","920212","72","29205279"
"JH378109","31060388","31060547","KQ054693v1","1748877","1749022","44","29311511"
"JH378109","31514810","31515027","KQ053004v1","2616751","2616958","60","28898059"
"JH378109","32420839","32421157","KQ054671v1","1130836","1131142","77","31290003"
"JH378109","32466385","32466661","KQ052971v1","646100","646383","68","31820285"
"JH378109","32480951","32481242","KQ052970v1","11462392","11462680","72","21018559"
"JH378109","32829062","32829148","KQ058561v1","5551877","5551953","30","27277185"
"JH378109","32829441","32829525","KQ052968v1","6651946","6652022","28","26177495"
"JH378109","32874076","32874208","KQ058561v1","5525984","5526115","29","27348092"
"JH378109","32879002","32879132","KQ054510v1","2941967","2942098","27","29937035"
"JH378109","33127726","33128045","KQ053554v1","2471177","2471484","68","30656549"
"JH378109","33145154","33145437","KQ056855v1","2789429","2789717","59","30355725"
"JH378109","33555354","33555641","KQ055490v1","2797344","2797631","60","30758010"
"JH378109","33654897","33655184","KQ053398v1","1756246","1756533","55","31898651"
"JH378109","33835141","33835429","KQ056035v1","288185","288466","72","33546956"
"JH378109","33851577","33851882","KQ053398v1","2431232","2431537","70","31420345"
"JH378109","33972517","33972787","KQ055173v1","452351","452623","66","33520166"
"JH378109","34120611","34120892","KQ053093v1","1361295","1361576","67","32759316"
"JH378109","34133601","34133886","KQ056147v1","1064032","1064323","59","33069569"
"JH378109","34321208","34321401","KQ054533v1","2294255","2294433","56","32026953"
"JH378109","35148223","35148507","KQ056147v1","1064032","1064323","81","34084191"
"JH378109","35578245","35578523","KQ055600v1","1871424","1871698","73","33706821"
"JH378109","36046575","36046887","KQ053718v1","3638528","3638821","78","32408047"
"JH378109","36206669","36206959","KQ057268v1","638006","638293","77","35568663"
"JH378109","36350360","36350641","KQ058183v1","487423","487710","67","35862937"
"JH378109","36461162","36461424","KQ057755v1","45985","46262","67","36415177"
"JH378109","36561712","36562014","KQ054786v1","934497","934799","66","35627215"
"JH378109","36578769","36578897","KQ057702v1","1862724","1862857","25","34716045"
"JH378109","36671107","36671203","KQ058427v1","6152893","6152991","22","30518214"
"JH378109","36812597","36812906","KQ053894v1","1262767","1263078","72","35549830"
"JH378109","36865450","36865735","KQ056790v1","446564","446855","78","36418886"
"JH378109","37006372","37006667","KQ058184v1","1505565","1505858","64","35500807"
"JH378109","37408202","37408486","KQ054693v1","832788","833076","69","36575414"
"JH378109","37505346","37505604","KQ055872v1","12987862","12988141","71","24517484"
"JH378109","38093446","38093727","ABDC02001013v1","5347","5624","60","38088099"
"JH378109","38126778","38127012","KQ054124v1","147406","147625","62","37979372"
"JH378109","38412406","38412525","KQ056643v1","1279625","1279744","34","37132781"
"JH378109","38891057","38891377","KQ058272v1","6007682","6007982","76","32883375"
"JH378109","38917522","38917768","KQ053498v1","3849819","3850073","73","35067703"
"JH378109","39135124","39135399","KQ053332v1","2579491","2579756","68","36555633"
"JH378109","39751108","39751376","KQ055735v1","667472","667747","85","39083636"
"JH378109","39933451","39933771","KQ052968v1","4333082","4333389","86","35600369"
"JH378109","40368395","40368672","KQ053093v1","1375309","1375598","68","38993086"
"JH378109","40803771","40804073","KQ054401v1","2629005","2629296","68","38174766"
"JH378109","40823801","40824076","KQ058249v1","184192","184468","71","40639609"
"JH378109","41256225","41256532","KQ053299v1","2867160","2867464","73","38389065"
"JH378109","41729395","41729573","KQ055352v1","9227221","9227396","46","32502174"
"JH378109","41843331","41843636","KQ058184v1","1505565","1505858","69","40337766"
"JH378109","41952310","41952442","KQ053256v1","1284266","1284394","30","40668044"
"JH378109","41962714","41963009","KQ058004v1","3883150","3883446","70","38079564"
"JH378109","42117513","42117752","KQ054776v1","1311356","1311593","72","40806157"
"JH378109","42218552","42218847","KQ054412v1","1824448","1824730","75","40394104"
"JH378109","42663498","42663815","KQ056148v1","430759","431072","94","42232739"
"JH378109","43020398","43020524","KQ053982v1","3934263","3934401","38","39086135"
"JH378109","43300334","43300605","KQ054400v1","3760476","3760752","70","39539858"
"JH378109","43344384","43344515","KQ057649v1","141749","141881","20","43202635"
"JH378109","43379982","43380129","KQ058381v1","517901","518051","39","42862081"
"JH378109","43504007","43504303","KQ052969v1","9553757","9554052","69","33950250"
"JH378109","43531505","43531753","KQ053115v1","1246859","1247104","67","42284646"
"JH378109","43604231","43604556","KQ055787v1","694393","694708","80","42909838"
"JH378109","44075717","44076030","KQ058272v1","4942871","4943179","77","39132846"
"JH378109","44974783","44975058","KQ053959v1","6189151","6189431","78","38785632"
"JH378109","45834792","45834956","KQ058483v1","5279934","5280083","42","40554858"
"JH378109","46010634","46010950","KQ058383v1","6350835","6351150","74","39659799"
"JH378109","46067767","46067898","KQ058094v1","3687022","3687155","26","42380745"
"JH378109","46093082","46093381","KQ054682v1","2125705","2126015","65","43967377"
"JH378109","46941884","46942043","KQ052970v1","12418764","12418905","48","34523120"
"JH378109","47274509","47274779","KQ055872v1","4131960","4132231","77","43142549"
"JH378109","47608387","47608651","KQ052970v1","2715607","2715860","73","44892780"
"JH378109","48298588","48298891","KQ053883v1","5150895","5151200","71","43147693"
"JH378109","48522185","48522486","KQ055004v1","332895","333205","71","48189290"
"JH378109","48552716","48552887","KQ058265v1","212584","212745","40","48340132"
"JH378109","48634592","48634814","KQ053654v1","3892663","3892904","58","44741929"
"JH378109","48701008","48701155","KQ053190v1","2372433","2372579","32","46328575"
"JH378109","48703501","48703803","KQ058458v1","579716","580014","79","48123785"
"JH378109","48839381","48839671","KQ053993v1","1017100","1017367","83","47822281"
"JH378109","48941737","48942005","KQ053609v1","2550928","2551200","76","46390809"
"JH378109","48955912","48956203","KQ058283v1","37203","37490","78","48918709"
"JH378109","48968114","48968287","KQ056996v1","1524030","1524195","36","47444084"
"JH378109","49033165","49033445","KQ055540v1","4545763","4546052","73","44487402"
"JH378109","49097789","49097938","KQ053299v1","2812031","2812178","43","46285758"
"JH378109","49213024","49213194","KQ056773v1","1047442","1047609","46","48165582"
"JH378109","49230905","49231213","KQ058184v1","1505565","1505858","63","47725340"
"JH378109","49239753","49239988","KQ057471v1","1354703","1354943","75","47885050"
"JH378109","49355031","49355285","KQ052969v1","9114256","9114521","66","40240775"
"JH378109","49408325","49408607","KQ055352v1","4380175","4380453","72","45028150"
"JH378109","49433916","49434138","KQ053520v1","4901250","4901462","54","44532666"
"JH378109","49857145","49857300","KQ058583v1","2039372","2039538","43","47817773"
"JH378109","50150186","50150310","KQ058473v1","392626","392756","34","49757560"
"JH378109","50150827","50150951","KQ054932v1","7772773","7772892","27","42378054"
"JH378109","50320060","50320353","KQ055036v1","1508392","1508683","77","48811668"
"JH378109","50721656","50721973","KQ056118v1","4276621","4276924","66","46445035"
"JH378109","50742421","50742753","KQ053332v1","25135","25444","98","50717286"
"JH378110","120413","120739","KQ055978v1","3056372","3056695","81","2935959"
"JH378110","232940","233057","KQ058328v1","2150165","2150287","37","1917225"
"JH378110","716383","716643","KQ058405v1","697304","697560","58","19079"
"JH378110","875322","875402","KQ053299v1","7062999","7063074","28","6187677"
"JH378110","905201","905478","KQ054565v1","6587941","6588226","73","5682740"
"JH378110","910510","910824","KQ058427v1","5159761","5160062","80","4249251"
"JH378110","1396101","1396233","KQ057910v1","1548802","1548933","23","152701"
"JH378110","1503741","1503976","KQ058328v1","2569266","2569497","62","1065525"
"JH378110","1961089","1961387","KQ056404v1","1889967","1890264","73","71122"
"JH378110","2274052","2274338","KQ058452v1","757762","758043","76","1516290"
"JH378110","3241130","3241357","KQ054576v1","2775916","2776136","63","465214"
"JH378110","3805163","3805309","KQ054412v1","2185013","2185160","31","1620150"
"JH378110","3896907","3897175","KQ057755v1","45985","46262","74","3850922"
"JH378110","4058114","4058414","KQ054693v1","832788","833076","67","3225326"
"JH378110","5221197","5221470","KQ052968v1","10578958","10579232","79","5357761"
"JH378110","5318045","5318331","KQ056568v1","950109","950397","64","4367936"
"JH378110","6329686","6329792","KQ057308v1","1804731","1804836","30","4524955"
"JH378110","6345781","6346069","KQ058184v1","1505565","1505858","67","4840216"
"JH378110","7312757","7313048","KQ057118v1","2304225","2304522","63","5008532"
"JH378110","7376983","7377128","KQ053752v1","1412395","1412540","34","5964588"
"JH378110","7922075","7922346","KQ058094v1","3646770","3647052","59","4275305"
"JH378110","8146750","8146951","KQ053740v1","3206530","3206729","49","4940220"
"JH378110","8296522","8296608","KQ053763v1","508269","508363","21","7788253"
"JH378110","8318030","8318292","KQ054146v1","3258465","3258719","75","5059565"
"JH378110","8384232","8384529","ABDC02052257v1","792","1085","64","8383440"
"JH378110","8508368","8508675","KQ055766v1","3990187","3990501","72","4518181"
"JH378110","8588046","8588351","KQ053115v1","3485337","3485650","61","5102709"
"JH378110","8628959","8629176","KQ058272v1","2561906","2562124","59","6067053"
"JH378110","8702624","8702791","KQ057875v1","498761","498926","35","8203863"
"JH378110","8719927","8720081","KQ055872v1","5870772","5870928","31","2849155"
"JH378110","9114113","9114416","KQ057471v1","479322","479624","65","8634791"
"JH378110","9170304","9170641","KQ058394v1","13308963","13309304","91","4138659"
"JH378110","9413135","9413178","KQ054135v1","1661841","1661887","9","7751294"
"JH378110","9413741","9413904","KQ053190v1","5047993","5048157","38","4365748"
"JH378110","9579938","9580239","KQ058272v1","4942871","4943179","59","4637067"
"JH378110","10046318","10046621","KQ057036v1","458164","458465","59","9588154"
"JH378110","10079535","10079679","KQ054196v1","237","387","42","10079298"
"JH378110","10765179","10765307","KQ053409v1","6105325","6105446","26","4659854"
"JH378110","10769539","10769694","KQ054196v1","237","387","30","10769302"
"JH378110","10811510","10811730","KQ053299v1","7690856","7691089","68","3120654"
"JH378110","10904714","10905016","KQ058184v1","1505565","1505858","71","9399149"
"JH378110","11002832","11003009","KQ056928v1","375938","376108","46","10626894"
"JH378110","11023657","11023992","KQ053398v1","4097175","4097499","102","6926482"
"JH378110","11039489","11039769","KQ058594v1","5996843","5997124","72","5042646"
"JH378110","11047135","11047271","KQ054795v1","459225","459351","31","10587910"
"JH378110","11356305","11356624","KQ058184v1","1505565","1505858","87","9850740"
"JH378110","11711171","11711476","KQ054069v1","7687863","7688158","69","4023308"
"JH378110","12943382","12943512","KQ056911v1","748463","748593","19","12194919"
"JH378110","12946223","12946531","KQ056035v1","1507771","1508068","83","11438452"
"JH378110","12965994","12966300","KQ056672v1","5687819","5688123","75","7278175"
"JH378110","12967103","12967378","KQ054510v1","2872930","2873219","67","10094173"
"JH378110","13244374","13244642","KQ058316v1","3289111","3289379","67","9955263"
"JH378110","13424309","13424441","KQ057883v1","1224468","1224597","20","12199841"
"JH378110","13613487","13613779","KQ053104v1","925246","925544","60","12688241"
"JH378110","13674031","13674269","KQ053696v1","3631267","3631475","74","10042764"
"JH378110","13722037","13722297","KQ058405v1","697304","697560","63","13024733"
"JH378110","13752035","13752176","KQ053631v1","8603317","8603457","26","5148718"
"JH378110","14321555","14321845","KQ055414v1","149964","150226","81","14171591"
"JH378110","14787055","14787363","KQ053654v1","5318679","5318982","63","9468376"
"JH378110","14935227","14935418","KQ053554v1","293392","293586","51","14641835"
"JH378110","15537516","15537604","KQ057648v1","2245752","2245839","19","13291764"
"JH378110","15538339","15538443","KQ053905v1","3739304","3739409","29","11799035"
"JH378110","15716249","15716497","KQ054933v1","935520","935770","62","14780729"
"JH378110","15755320","15755490","KQ053631v1","7980794","7980971","46","7774526"
"JH378110","15776247","15776548","KQ056147v1","1064032","1064323","70","14712215"
"JH378110","15782115","15782416","KQ056147v1","1064032","1064323","70","14718083"
"JH378110","15831138","15831429","KQ055725v1","1527395","1527689","81","14303743"
"JH378110","16322369","16322506","KQ053354v1","702320","702452","32","15620049"
"JH378110","16421707","16421856","KQ057560v1","1680015","1680156","35","14741692"
"JH378110","16462550","16462839","KQ057737v1","3083543","3083824","77","13379007"
"JH378110","17127921","17128167","KQ053982v1","5080962","5081189","79","12046959"
"JH378110","17420796","17421092","KQ054660v1","2743639","2743930","79","14677157"
"JH378110","18099503","18099811","KQ055479v1","1841725","1842025","73","16257778"
"JH378110","18185819","18186107","KQ056773v1","168010","168288","60","18017809"
"JH378110","18225695","18225973","KQ053146v1","2819587","2819868","58","15406108"
"JH378110","18398262","18398576","KQ053741v1","2418696","2419001","67","15979566"
"JH378110","18596267","18596413","KQ057648v1","352128","352277","34","18244139"
"JH378110","18614894","18615193","KQ055468v1","2950644","2950940","76","15664250"
"JH378110","18627907","18628174","KQ055893v1","1739065","1739339","69","16888842"
"JH378110","18773824","18773984","KQ054533v1","1027813","1027974","43","17746011"
"JH378110","18836763","18836974","KQ054725v1","1394675","1394915","73","17442088"
"JH378110","18984019","18984182","KQ056996v1","1524030","1524195","35","17459989"
"JH378110","19183814","19184105","KQ055767v1","2455394","2455703","66","16728420"
"JH378110","19195237","19195537","KQ052969v1","11182978","11183250","79","8012259"
"JH378110","19765994","19766045","KQ054135v1","1661841","1661887","9","18104153"
"JH378110","19822734","19823048","KQ053971v1","3610129","3610423","72","16212605"
"JH378110","19856689","19856973","KQ056673v1","654012","654302","67","19202677"
"JH378110","19946644","19946778","KQ053654v1","4929533","4929667","26","15017111"
"JH378110","19990138","19990411","KQ058427v1","4553509","4553777","75","15436629"
"JH378110","20037650","20037973","KQ055787v1","694393","694708","76","19343257"
"JH378110","20131637","20131959","KQ052984v1","105454","105757","77","20026183"
"JH378110","20145729","20146037","KQ055119v1","3015978","3016290","70","17129751"
"JH378110","20264958","20265266","KQ058631v1","330883","331189","70","19934075"
"JH378110","20338758","20339078","KQ055777v1","559218","559528","78","19779540"
"JH378110","20625785","20626064","KQ057345v1","1938824","1939073","71","18686961"
"JH378110","20648999","20649256","KQ058339v1","4743560","4743804","67","15905439"
"JH378110","21236300","21236431","KQ054069v1","5155029","5155163","28","16081271"
"JH378110","21799516","21799815","KQ053927v1","199693","199992","64","21599823"
"JH378110","21917493","21917788","KQ056672v1","3082150","3082439","62","18835343"
"JH378110","22004759","22005046","KQ055610v1","1837519","1837800","56","20167240"
"JH378110","22057422","22057728","KQ053752v1","135567","135860","77","21921855"
"JH378110","22089913","22090001","KQ053971v1","4775120","4775210","24","17314793"
"JH378110","22322153","22322317","KQ057737v1","1426090","1426247","38","20896063"
"JH378110","22373246","22373517","KQ057035v1","2309844","2310112","67","20063402"
"JH378110","22460468","22460586","KQ052970v1","4795906","4796029","32","17664562"
"JH378110","23104880","23105182","KQ053398v1","2545768","2546067","66","20559112"
"JH378110","23377876","23378099","KQ053520v1","4901250","4901462","65","18476626"
"JH378110","23412508","23412599","KQ055872v1","5141445","5141541","27","18271063"
"JH378110","24052705","24053014","KQ055247v1","895463","895756","84","23157242"
"JH378110","24167309","24167573","KQ058427v1","4553509","4553777","64","19613800"
"JH378110","24355805","24356116","KQ054857v1","891890","892194","92","23463915"
"JH378110","25325249","25325539","KQ058183v1","3247932","3248220","74","22077317"
"JH378110","25443459","25443544","KQ053179v1","1820197","1820288","30","23623262"
"JH378110","25443727","25443769","KQ056558v1","910670","910721","18","24533057"
"JH378110","25444085","25444251","KQ054196v1","237","387","41","25443848"
"JH378110","25502593","25502870","KQ058561v1","4466656","4466945","66","21035937"
"JH378110","25966483","25966766","KQ055364v1","2160874","2161165","70","23805609"
"JH378110","26184519","26184764","KQ056320v1","2083058","2083308","65","24101461"
"JH378110","26815209","26815509","KQ052970v1","10427454","10427754","74","16387755"
"JH378110","27012703","27012820","KQ052969v1","2661859","2661968","33","24350844"
"JH378110","27140537","27140679","KQ053948v1","2765570","2765701","38","24374967"
"JH378110","27538215","27538512","KQ054932v1","7948199","7948483","85","19590016"
"JH378110","27557877","27558196","KQ057702v1","1237368","1237672","91","26320509"
"JH378110","27787483","27787692","KQ053741v1","1190544","1190756","49","26596939"
"JH378110","27857287","27857548","KQ056404v1","1771928","1772196","64","26085359"
"JH378110","28477382","28477681","KQ053948v1","168940","169229","73","28308442"
"JH378110","28568165","28568462","KQ058184v1","1505565","1505858","76","27062600"
"JH378110","28968485","28968646","KQ057737v1","1426090","1426247","37","27542395"
"JH378110","28984133","28984407","ABDC02003384v1","193955","194231","67","28790178"
"JH378110","29197994","29198302","KQ058513v1","15345","15653","79","29182649"
"JH378110","29287422","29287706","KQ056301v1","1134815","1135079","87","28152607"
"JH378110","29333646","29333955","KQ058585v1","580456","580763","67","28753190"
"JH378110","29337662","29337970","KQ055004v1","332895","333205","66","29004767"
"JH378110","29381791","29382097","KQ056996v1","837133","837431","64","28544658"
"JH378110","29392543","29392824","KQ054400v1","3760476","3760752","69","25632067"
"JH378110","29609204","29609305","KQ053432v1","3939855","3939953","17","25669349"
"JH378110","29754370","29754664","KQ057702v1","1420535","1420827","67","28333835"
"JH378110","29761370","29761640","KQ055610v1","1837519","1837800","74","27923851"
"JH378110","29784734","29784931","KQ053267v1","3263961","3264178","67","26520773"
"JH378110","29805581","29805739","KQ053157v1","5478543","5478695","35","24327038"
"JH378110","29957863","29958168","KQ053299v1","4095914","4096215","56","25861949"
"JH378110","30160775","30160909","KQ058427v1","4756553","4756686","28","25404222"
"JH378110","30161158","30161231","KQ055946v1","371653","371727","22","29789505"
"JH378110","30162223","30162347","KQ057909v1","5263919","5264037","29","24898304"
"JH378110","30218175","30218477","KQ053959v1","5527939","5528237","68","24690236"
"JH378110","30298328","30298436","KQ053675v1","1335502","1335608","23","28962826"
"JH378110","30602252","30602565","KQ054068v1","5074639","5074944","72","25527613"
"JH378110","31050084","31050363","KQ052968v1","14043756","14044036","62","17006328"
"JH378110","31062126","31062215","KQ053598v1","1093587","1093662","30","29968539"
"JH378110","31107117","31107257","KQ054510v1","8179279","8179421","30","22927838"
"JH378110","31149554","31149849","KQ053096v1","602899","603182","52","30546655"
"JH378110","31197971","31198259","KQ058512v1","329344","329634","73","30868627"
"JH378110","31216293","31216613","KQ054704v1","223675","223980","81","30992618"
"JH378110","31234985","31235161","KQ054652v1","6051","6229","38","31228934"
"JH378110","31433290","31433385","KQ054456v1","5057079","5057175","27","26376211"
"JH378110","31492163","31492447","KQ056587v1","1312432","1312709","67","30179731"
"JH378110","31548966","31549286","KQ055119v1","1213631","1213952","76","30335335"
"JH378110","31621747","31621879","KQ054218v1","2975","3106","22","31618772"
"JH378110","31642106","31642397","KQ054693v1","832788","833076","63","30809318"
"JH378110","31715981","31716277","KQ058190v1","350088","350375","65","31365893"
"JH378110","31758714","31758973","KQ058226v1","440771","441020","85","31317943"
"JH378110","31913853","31914142","KQ057290v1","1053741","1054027","72","30860112"
"JH378110","32010068","32010364","KQ053398v1","2431232","2431537","66","29578836"
"JH378110","32089167","32089456","KQ053816v1","7464708","7465010","66","24624459"
"JH378110","32195959","32196274","KQ054932v1","3714594","3714900","66","28481365"
"JH378110","32201691","32202008","KQ057099v1","648781","649090","64","31552910"
"JH378110","32241759","32241923","KQ055725v1","994366","994530","37","31247393"
"JH378110","32323486","32323789","KQ055468v1","2950644","2950940","65","29372842"
"JH378110","32360075","32360394","KQ055872v1","14673747","14674061","80","17686328"
"JH378110","32382636","32382884","KQ053082v1","7643617","7643861","60","24739019"
"JH378110","32484419","32484728","KQ055097v1","1884579","1884874","73","30599840"
"JH378110","32514686","32514819","KQ056056v1","323824","323942","32","32190862"
"JH378110","32519087","32519401","KQ053026v1","1073868","1074158","85","31445219"
"JH378110","32974195","32974473","KQ055065v1","1117201","1117481","60","31856994"
"JH378110","33048290","33048401","KQ054921v1","165725","165837","22","32882565"
"JH378110","33163575","33163874","KQ058350v1","3209491","3209789","49","29954084"
"JH378110","33441640","33441948","KQ053816v1","7464708","7465010","72","25976932"
"JH378110","33661898","33662183","KQ053026v1","3680523","3680807","72","29981375"
"JH378110","33819438","33819717","KQ053332v1","447571","447853","66","33371867"
"JH378110","33825330","33825629","ABDC02052257v1","792","1085","71","33824538"
"JH378110","33863059","33863396","KQ055872v1","4196195","4196516","95","29666864"
"JH378110","33864030","33864298","KQ055872v1","10113033","10113299","66","23750997"
"JH378110","34004319","34004632","KQ057290v1","2180782","2181079","76","31823537"
"JH378110","34275900","34276223","KQ056521v1","155996","156302","72","34119904"
"JH378110","34304741","34305042","KQ056928v1","1915686","1915996","75","32389055"
"JH378110","34357513","34357795","KQ054412v1","1824448","1824730","72","32533065"
"JH378110","34685427","34685721","KQ056456v1","827977","828265","70","33857450"
"JH378110","34714613","34714918","KQ054412v1","2490468","2490761","64","32224145"
"JH378110","34880572","34880861","KQ055097v1","1884579","1884874","67","32995993"
"JH378110","34897547","34897672","KQ053409v1","6105325","6105446","29","28792222"
"JH378110","35004567","35004804","KQ053894v1","1236287","1236536","72","33768280"
"JH378110","35099515","35099803","KQ058539v1","1095385","1095679","59","34004130"
"JH378110","35110750","35111029","KQ053288v1","2218996","2219287","69","32891754"
"JH378110","35247037","35247214","KQ054180v1","511425","511611","57","34735612"
"JH378110","35341327","35341496","KQ052968v1","9610036","9610212","48","25731291"
"JH378110","35422640","35422919","KQ053741v1","1482396","1482684","62","33940244"
"JH378110","35428544","35428827","KQ054693v1","832788","833076","58","34595756"
"JH378110","35434397","35434686","KQ058394v1","9107761","9108054","64","26326636"
"JH378110","35436065","35436308","KQ054725v1","1394675","1394915","66","34041390"
"JH378110","35464532","35464817","KQ053487v1","1481124","1481401","79","33983408"
"JH378110","35615835","35616122","KQ056148v1","3012765","3013044","65","32603070"
"JH378110","35617181","35617466","KQ056790v1","446564","446855","74","35170617"
"JH378110","35636181","35636254","KQ056855v1","3190666","3190732","26","32445515"
"JH378110","35636474","35636671","KQ053387v1","4402041","4402214","71","31234433"
"JH378110","35661661","35661969","KQ053115v1","2308479","2308791","74","33353182"
"JH378110","35773233","35773504","KQ053157v1","3558863","3559137","79","32214370"
"JH378110","35958611","35958858","KQ053795v1","370451","370712","59","35588160"
"JH378110","36341339","36341626","KQ058316v1","2150959","2151268","79","34190380"
"JH378110","36417857","36418085","KQ053093v1","1363144","1363361","72","35054713"
"JH378110","36497246","36497508","KQ052968v1","10745715","10745973","71","25751531"
"JH378110","36616802","36617093","KQ057648v1","78808","79100","61","36537994"
"JH378110","36703988","36704113","KQ053948v1","2765570","2765701","24","33938418"
"JH378110","36738275","36738487","KQ053398v1","3158290","3158500","36","33579985"
"JH378110","36925941","36926113","KQ058459v1","469480","469653","33","36456461"
"JH378110","36926785","36926911","KQ057883v1","1224468","1224597","23","35702317"
"JH378110","36939447","36939742","KQ053816v1","7464708","7465010","62","29474739"
"JH378110","36956174","36956436","KQ055490v1","4433291","4433558","68","32522883"
"JH378110","37255560","37255860","KQ054868v1","1584588","1584882","63","35670972"
"JH378110","37472952","37473235","KQ058538v1","1780355","1780644","60","35692597"
"JH378110","37781666","37781932","KQ055978v1","3560415","3560681","65","34221251"
"JH378110","37798853","37798941","KQ053827v1","2612475","2612564","21","35186378"
"JH378110","37816810","37816946","KQ054412v1","2185013","2185160","38","35631797"
"JH378110","37839505","37839781","KQ058272v1","5443874","5444159","62","32395631"
"JH378110","37897031","37897313","KQ055247v1","1248490","1248795","66","36648541"
"JH378110","38058200","38058483","KQ052968v1","10629964","10630247","67","27428236"
"JH378110","38076993","38077298","KQ058272v1","4942871","4943179","79","33134122"
"JH378110","38137919","38138122","KQ054401v1","3245220","3245428","56","34892699"
"JH378110","38299021","38299319","KQ058184v1","1505565","1505858","74","36793456"
"JH378110","38381892","38382132","KQ053487v1","3972854","3973080","58","34409038"
"JH378110","38438939","38439228","KQ055468v1","2950644","2950940","64","35488295"
"JH378110","38538282","38538544","KQ053795v1","370451","370712","64","38167831"
"JH378110","38850516","38850602","KQ053082v1","2466226","2466310","24","36384290"
"JH378110","38850910","38851048","KQ058328v1","5358834","5358954","36","33492076"
"JH378110","39185189","39185383","KQ053598v1","2876763","2876951","48","36308426"
"JH378110","39393239","39393500","KQ053816v1","5213784","5214044","64","34179455"
"JH378110","39423283","39423563","KQ058428v1","1815721","1816007","64","37607562"
"JH378110","39487849","39488127","KQ053654v1","346478","346752","65","39141371"
"JH378110","39565141","39565437","KQ054401v1","2629005","2629296","68","36936136"
"JH378110","39565438","39565572","KQ053004v1","2961452","2961584","25","36603986"
"JH378110","39675545","39675858","KQ053894v1","1262767","1263078","74","38412778"
"JH378110","39880875","39881004","KQ053774v1","406836","406969","27","39474039"
"JH378110","39996836","39997032","KQ053685v1","16639","16818","57","39980197"
"JH378110","40060395","40060720","KQ054693v1","832788","833076","81","39227607"
"JH378110","40225364","40225672","KQ055662v1","5484080","5484349","78","34741284"
"JH378110","40345893","40346182","KQ053146v1","2819587","2819868","67","37526306"
"JH378110","40354688","40354967","KQ056643v1","159950","160228","68","40194738"
"JH378110","40689543","40689826","KQ056456v1","918897","919186","74","39770646"
"JH378110","41370988","41371282","KQ053096v1","602899","603182","69","40768089"
"JH378110","42045548","42045634","KQ052968v1","9483686","9483763","24","32561862"
"JH378110","42045816","42045930","KQ053774v1","3363452","3363567","23","38682364"
"JH378110","42539928","42540197","KQ052969v1","8465928","8466216","75","34074000"
"JH378110","42743277","42743581","KQ058184v1","1505565","1505858","79","41237712"
"JH378110","42949139","42949278","ABDC02047922v1","197","340","41","42948942"
"JH378110","42958871","42959077","KQ056996v1","148346","148555","45","42810525"
"JH378110","43064246","43064504","KQ054713v1","840037","840292","72","42224209"
"JH378110","43106780","43107077","KQ055247v1","895463","895756","64","42211317"
"JH378110","43179581","43179883","KQ054213v1","780092","780393","69","42399489"
"JH378110","43477271","43477430","KQ053774v1","3363264","3363425","45","40114007"
"JH378110","43780360","43780624","KQ053310v1","2851403","2851646","67","40928957"
"JH378110","43806914","43807212","KQ055468v1","2950644","2950940","67","40856270"
"JH378110","44054756","44055050","KQ057909v1","3829378","3829677","58","40225378"
"JH378110","44117091","44117355","KQ055662v1","4683524","4683789","65","39433567"
"JH378110","44503961","44504116","KQ052969v1","8332082","8332226","42","36171879"
"JH378110","44551982","44552276","KQ053432v1","4280053","4280348","62","40271929"
"JH378110","44565211","44565512","KQ057290v1","1556271","1556560","80","43008940"
"JH378110","44906128","44906397","KQ053565v1","2341738","2341996","78","42564390"
"JH378110","44907362","44907658","KQ053631v1","7288314","7288608","67","37619048"
"JH378110","45021840","45021959","KQ055141v1","2421865","2421977","27","42599975"
"JH378110","45029403","45029666","KQ055055v1","1882469","1882726","60","43146934"
"JH378110","45074548","45074866","KQ058485v1","518830","519142","78","44555718"
"JH378110","45273460","45273555","KQ052969v1","2661859","2661968","29","42611601"
"JH378110","45672641","45672930","KQ055140v1","2748912","2749194","71","42923729"
"JH378110","45761950","45762224","KQ053465v1","403029","403303","74","45358921"
"JH378110","45990770","45991089","KQ055141v1","1054026","1054336","80","44936744"
"JH378110","46113922","46114224","KQ058257v1","559477","559763","87","45554445"
"JH378110","46201244","46201514","KQ057909v1","519161","519431","71","45682083"
"JH378110","46301981","46302132","KQ054401v1","3742804","3742954","32","42559177"
"JH378110","46329398","46329700","KQ053554v1","1157184","1157483","63","45172214"
"JH378110","46346415","46346712","KQ054412v1","2490468","2490761","65","43855947"
"JH378110","46525326","46525563","KQ054932v1","10346474","10346710","74","36178852"
"JH378110","46923120","46923456","KQ054786v1","934497","934799","92","45988623"
"JH378110","47071522","47071812","KQ058184v1","1505565","1505858","64","45565957"
"JH378110","47270707","47271007","KQ058538v1","934688","934988","67","46336019"
"JH378110","47564999","47565143","KQ056864v1","2410292","2410433","37","45154707"
"JH378110","47565167","47565214","KQ055247v1","4402957","4403009","13","43162210"
"JH378110","47614925","47615213","KQ058190v1","350088","350375","75","47264837"
"JH378110","48038870","48039175","KQ053696v1","435954","436253","83","47602916"
"JH378110","48179484","48179759","KQ055663v1","1737755","1738038","75","46441729"
"JH378111","28616","28910","KQ058184v1","1505565","1505858","67","1476949"
"JH378111","629005","629290","KQ058313v1","660634","660924","75","31629"
"JH378111","961629","961752","KQ055957v1","2095070","2095194","32","1133441"
"JH378111","1487205","1487334","KQ058427v1","4756553","4756686","26","3269348"
"JH378111","1495904","1496196","KQ058184v1","1505565","1505858","66","9661"
"JH378111","1530855","1531124","KQ058594v1","1719198","1719477","72","188343"
"JH378111","1737863","1737987","KQ053187v1","324884","324999","35","1412979"
"JH378111","1738437","1738554","KQ053409v1","5845480","5845594","36","4107043"
"JH378111","2002860","2002991","KQ053849v1","2918468","2918588","39","915608"
"JH378111","2132810","2132965","KQ054533v1","1027813","1027974","36","1104997"
"JH378111","2164691","2164979","KQ056147v1","1064032","1064323","54","1100659"
"JH378111","2312854","2313192","KQ058428v1","556167","556488","102","1756687"
"JH378111","2814257","2814551","KQ057118v1","4082560","4082854","102","1268303"
"JH378111","2888423","2888619","KQ056673v1","1365335","1365539","57","1523088"
"JH378111","3131748","3132016","KQ053398v1","4974410","4974675","79","1842662"
"JH378111","3167998","3168211","KQ053872v1","262334","262548","65","2905664"
"JH378111","3684748","3685035","KQ055097v1","2825545","2825834","63","859203"
"JH378111","3925517","3925816","KQ058184v1","1505565","1505858","60","2419952"
"JH378111","4542100","4542320","KQ057268v1","1608514","1608738","71","2933586"
"JH378111","5400362","5400659","KQ055518v1","326248","326564","77","5074114"
"JH378111","6451976","6452133","KQ055725v1","720931","721083","37","5731045"
"JH378111","6561686","6561980","KQ058427v1","705606","705898","58","5856080"
"JH378111","6653339","6653572","KQ057345v1","1938824","1939073","57","4714515"
"JH378111","6669110","6669361","KQ055320v1","2365107","2365346","71","4304003"
"JH378111","6687474","6687794","KQ053620v1","859013","859318","87","5828461"
"JH378111","6783933","6784191","KQ057471v1","1722738","1722988","71","5061195"
"JH378111","6804625","6804911","KQ053774v1","416886","417189","76","6387739"
"JH378111","6913991","6914120","KQ053686v1","1108593","1108721","22","5805398"
"JH378111","7055216","7055509","KQ057045v1","590946","591241","65","6464270"
"JH378111","7065661","7065907","KQ052970v1","7191829","7192066","71","126168"
"JH378111","7326814","7327110","KQ058305v1","3899980","3900272","65","3426834"
"JH378111","7400126","7400258","KQ053004v1","2961452","2961584","23","4438674"
"JH378111","7507960","7508091","KQ058427v1","4756553","4756686","20","2751407"
"JH378111","7533553","7533844","KQ058317v1","3244448","3244747","68","4289105"
"JH378111","7624321","7624611","KQ058328v1","7544499","7544779","77","79822"
"JH378111","7692606","7692897","KQ057693v1","621833","622123","68","7070773"
"JH378111","7727992","7728280","KQ055852v1","1231373","1231668","80","6496619"
"JH378111","7937459","7937771","KQ053299v1","4095914","4096215","66","3841545"
"JH378111","8037765","8038008","KQ058605v1","2146177","2146420","58","5891588"
"JH378111","8310789","8311053","KQ057560v1","3114391","3114640","74","5196398"
"JH378111","8430437","8430737","KQ058450v1","2960681","2960988","69","5469756"
"JH378111","8508270","8508538","KQ053398v1","4702476","4702738","64","3805794"
"JH378111","8520725","8521007","KQ053332v1","484061","484362","65","8036664"
"JH378111","8629687","8629973","KQ055384v1","364193","364479","67","8265494"
"JH378111","8722102","8722252","KQ053763v1","367228","367378","41","8354874"
"JH378111","8766424","8766693","KQ055662v1","4683524","4683789","72","4082900"
"JH378111","8862734","8862964","KQ053432v1","3680432","3680677","65","5182302"
"JH378111","9105315","9105569","KQ054068v1","3810441","3810685","79","5294874"
"JH378111","9165225","9165557","KQ052969v1","11192474","11192788","80","2027249"
"JH378111","9637528","9637800","KQ058427v1","8032070","8032333","75","1605458"
"JH378111","9680829","9681121","KQ052971v1","841846","842131","67","8838983"
"JH378111","10226419","10226586","KQ056587v1","14868083","14868254","48","4641664"
"JH378111","10293024","10293313","KQ055352v1","7784426","7784721","60","2508598"
"JH378111","10294439","10294576","KQ053948v1","2198512","2198648","20","8095927"
"JH378111","10296657","10296886","KQ053587v1","1788518","1788751","59","8508139"
"JH378111","10352085","10352397","KQ055457v1","2061137","2061448","91","8290948"
"JH378111","10383148","10383399","KQ058288v1","54043","54290","71","10329105"
"JH378111","10385764","10385923","KQ057023v1","552794","552951","34","9832970"
"JH378111","10401960","10402264","KQ058450v1","2960681","2960988","74","7441279"
"JH378111","11010825","11011124","KQ053146v1","1320586","1320881","66","9690239"
"JH378111","11150269","11150394","KQ054279v1","76889","77022","31","11073380"
"JH378111","11191290","11191471","KQ053609v1","1884265","1884430","44","9307025"
"JH378111","11207920","11208216","KQ053816v1","7327018","7327317","68","3880902"
"JH378111","11226658","11226940","KQ053565v1","3315103","3315388","71","7911555"
"JH378111","11295837","11296029","KQ056200v1","206014","206202","57","11089823"
"JH378111","11306292","11306426","KQ053245v1","473950","474077","27","10832342"
"JH378111","11311555","11311840","KQ058473v1","230477","230773","71","11081078"
"JH378111","11325598","11325895","KQ056148v1","4321952","4322238","72","7003646"
"JH378111","11333110","11333168","KQ058394v1","7459384","7459440","10","3873726"
"JH378111","11401551","11401791","KQ055192v1","1201363","1201615","62","10200188"
"JH378111","11777725","11777858","KQ055755v1","801738","801870","25","10975987"
"JH378111","11790396","11790711","KQ055872v1","2402427","2402732","88","9387969"
"JH378111","11872231","11872428","KQ057673v1","2220920","2221103","49","9651311"
"JH378111","11874308","11874575","KQ057910v1","2540095","2540357","81","9334213"
"JH378111","11991179","11991480","KQ054932v1","4500910","4501208","66","7490269"
"JH378111","12041884","12042191","KQ053299v1","2867160","2867464","80","9174724"
"JH378111","12722661","12722950","KQ054510v1","8555095","8555387","61","4167566"
"JH378111","13420919","13421204","KQ053598v1","2814990","2815277","66","10605929"
"JH378111","13467195","13467366","KQ054660v1","3679956","3680128","40","9787239"
"JH378111","13576984","13577277","KQ055883v1","284887","285187","70","13292097"
"JH378111","13707774","13708086","KQ058184v1","1505565","1505858","78","12202209"
"JH378111","13787998","13788316","KQ057737v1","5499585","5499900","79","8288413"
"JH378111","13811494","13811766","KQ055735v1","667472","667747","79","13144022"
"JH378111","14765027","14765242","KQ058595v1","117016","117224","54","14648011"
"JH378111","14765435","14765530","KQ053565v1","3764807","3764898","22","11000628"
"JH378111","15007448","15007752","KQ054510v1","2447370","2447670","68","12560078"
"JH378111","15014992","15015265","KQ054191v1","3855095","3855383","81","11159897"
"JH378111","15696797","15697073","KQ058291v1","474599","474881","56","15222198"
"JH378111","15748573","15748836","KQ057440v1","818898","819163","66","14929675"
"JH378111","16077340","16077458","KQ058428v1","1141942","1142059","31","14935398"
"JH378111","16107770","16107913","KQ058183v1","3299072","3299206","32","12808698"
"JH378111","16179041","16179316","KQ055978v1","3560415","3560681","77","12618626"
"JH378111","16195976","16196201","KQ056465v1","72608","72828","54","16123368"
"JH378111","16286984","16287150","KQ054026v1","2068803","2068970","37","14218181"
"JH378111","16448049","16448378","KQ057821v1","4954489","4954823","82","11493560"
"JH378111","16561346","16561678","KQ053343v1","1747702","1748011","96","14813644"
"JH378111","17047932","17048080","KQ054756v1","16179","16324","34","17031753"
"JH378111","17218593","17218785","KQ058301v1","333804","333994","48","16884789"
"JH378111","17247889","17248184","KQ058353v1","1264780","1265071","63","15983109"
"JH378111","17279055","17279206","KQ057737v1","3826261","3826415","38","13452794"
"JH378111","17314242","17314542","KQ053816v1","7327018","7327317","71","9987224"
"JH378111","17319162","17319431","KQ053191v1","2134125","2134399","75","15185037"
"JH378111","17362596","17362837","KQ054826v1","303348","303596","67","17059248"
"JH378111","17396777","17397088","KQ054786v1","934497","934799","74","16462280"
"JH378111","17540634","17540936","KQ058585v1","580456","580763","76","16960178"
"JH378111","17600953","17601240","KQ053686v1","963025","963293","81","16637928"
"JH378111","17680755","17681049","KQ054068v1","5304638","5304934","73","12376117"
"JH378111","17794999","17795271","KQ052969v1","11182978","11183250","53","6612021"
"JH378111","17856905","17857057","KQ054196v1","237","387","35","17856668"
"JH378111","17911781","17911933","KQ055662v1","1094666","1094812","44","16817115"
"JH378111","17997669","17997937","KQ058427v1","3947837","3948110","75","14049832"
"JH378111","17999062","17999350","KQ055490v1","2797344","2797631","66","15201718"
"JH378111","18036192","18036405","KQ053398v1","3158290","3158500","47","14877902"
"JH378111","18083671","18083884","KQ058561v1","565602","565807","56","17518069"
"JH378111","18167818","18168105","KQ053827v1","4198964","4199247","67","13968854"
"JH378111","18248112","18248401","KQ054826v1","11958391","11958689","62","6289721"
"JH378111","18511102","18511381","KQ058283v1","37203","37490","59","18473899"
"JH378111","18512990","18513147","KQ053795v1","588026","588179","34","17924964"
"JH378111","18513337","18513474","KQ055375v1","716065","716198","33","17797272"
"JH378111","18620491","18620639","KQ055490v1","2065440","2065590","35","16555051"
"JH378111","18845016","18845317","KQ054091v1","1704509","1704815","65","17140507"
"JH378111","18933651","18933966","KQ052981v1","1198440","1198752","73","17735211"
"JH378111","19157838","19158125","KQ058316v1","1439391","1439671","66","17718447"
"JH378111","19165741","19165931","KQ054933v1","3939617","3939804","43","15226124"
"JH378111","19193794","19194104","KQ053554v1","928272","928577","69","18265522"
"JH378111","19353214","19353524","KQ053093v1","1738898","1739201","69","17614316"
"JH378111","19413774","19413958","KQ055404v1","3762645","3762830","39","15651129"
"JH378111","19429889","19430169","KQ056672v1","3535300","3535593","67","15894589"
"JH378111","19548741","19548914","KQ055490v1","1751422","1751617","59","17797319"
"JH378111","19601786","19601910","KQ058516v1","4102482","4102606","22","15499304"
"JH378111","19602039","19602223","KQ058394v1","10110818","10110995","46","9491221"
"JH378111","19692498","19692786","KQ052968v1","6282633","6282918","64","13409865"
"JH378111","19736206","19736328","KQ054179v1","3865170","3865294","33","15871036"
"JH378111","19736668","19736730","KQ053299v1","2592408","2592461","23","17144260"
"JH378111","19737346","19737428","KQ058427v1","6765309","6765385","29","12972037"
"JH378111","19737492","19737780","KQ053816v1","7438202","7438483","70","12299290"
"JH378111","19746589","19746884","KQ056672v1","3535300","3535593","81","16211289"
"JH378111","19760147","19760450","KQ052981v1","1198440","1198752","83","18561707"
"JH378111","19929761","19930053","KQ053126v1","1419293","1419571","74","18510468"
"JH378111","19934004","19934286","KQ057737v1","542025","542315","85","19391979"
"JH378111","19966823","19967025","KQ058383v1","9982530","9982731","46","9984293"
"JH378111","20207397","20207663","KQ053332v1","447571","447853","67","19759826"
"JH378111","20223783","20224070","KQ058483v1","5574658","5574940","64","14649125"
"JH378111","20275088","20275384","KQ053816v1","7327018","7327317","68","12948070"
"JH378111","20406850","20407045","KQ054804v1","89280","89485","50","20317570"
"JH378111","20464541","20464824","KQ054868v1","2229582","2229854","63","18234959"
"JH378111","20499776","20499970","KQ056405v1","6821","7014","51","20492955"
"JH378111","20506846","20507150","KQ053299v1","4095914","4096215","81","16410932"
"JH378111","20507361","20507689","KQ053299v1","4095914","4096215","75","16411447"
"JH378111","20530853","20531149","KQ053763v1","3936916","3937207","78","16593937"
"JH378111","20571827","20571988","KQ057737v1","1426090","1426247","38","19145737"
"JH378111","20701676","20701819","KQ053741v1","1967586","1967710","49","18734090"
"JH378111","21929498","21929783","KQ055247v1","216427","216708","75","21713071"
"JH378111","22379709","22380010","KQ054510v1","8555095","8555387","66","13824614"
"JH378111","23242815","23243085","KQ056044v1","570262","570509","83","22672553"
"JH378111","23869739","23870003","KQ057480v1","520324","520577","89","23349415"
"JH378111","23979595","23979899","KQ058004v1","1242544","1242848","71","22737051"
"JH378111","24406678","24406989","KQ054510v1","2056259","2056562","74","22350419"
"JH378111","24424177","24424319","KQ053741v1","1690943","1691088","41","22733234"
"JH378111","25032065","25032335","KQ055893v1","1771908","1772186","66","23260157"
"JH378111","25165438","25165623","KQ058305v1","5597618","5597803","45","19567820"
"JH378111","25330208","25330498","KQ053059v1","2954068","2954363","69","22376140"
"JH378111","25371281","25371414","KQ055457v1","5874928","5875062","25","19496353"
"JH378111","25457940","25458228","KQ057118v1","4601602","4601894","63","20856338"
"JH378111","25622701","25622990","KQ055247v1","4445738","4446031","62","21176963"
"JH378111","25747647","25747911","KQ058615v1","157196","157468","71","25590451"
"JH378111","25855715","25855990","KQ053126v1","1419293","1419571","73","24436422"
"JH378111","25861874","25862151","KQ055610v1","1837519","1837800","64","24024355"
"JH378111","25895421","25895688","KQ054932v1","7245576","7245838","73","18649845"
"JH378111","25909224","25909524","KQ057911v1","428931","429228","62","25480293"
"JH378111","26037011","26037253","KQ056773v1","122800","123057","67","25914211"
"JH378111","26070537","26070818","KQ053409v1","3716306","3716585","62","22354231"
"JH378111","26084537","26084822","KQ057649v1","81106","81383","74","26003431"
"JH378111","26558305","26558567","KQ057345v1","1938824","1939073","65","24619481"
"JH378111","26666023","26666086","KQ054068v1","1383975","1384041","19","25282048"
"JH378111","26666102","26666228","KQ053835v1","409491","409618","23","26256611"
"JH378111","26766596","26766889","KQ058350v1","6740286","6740580","71","20026310"
"JH378111","26852951","26853248","KQ052970v1","8274642","8274940","77","18578309"
"JH378111","27089671","27089973","KQ055852v1","1231373","1231668","64","25858298"
"JH378111","27278866","27279128","KQ056707v1","1656923","1657169","71","25621943"
"JH378111","27290449","27290723","KQ052969v1","8465928","8466216","75","18824521"
"JH378111","27353753","27353884","KQ053115v1","1333586","1333718","22","26020167"
"JH378111","27368401","27368482","KQ056148v1","5019141","5019230","18","22349260"
"JH378111","27455688","27455971","KQ056762v1","807057","807347","79","26648631"
"JH378111","27472210","27472485","KQ054224v1","1162755","1163034","69","26309455"
"JH378111","27788334","27788618","KQ054068v1","7299352","7299643","64","20488982"
"JH378111","28462684","28462827","KQ053081v1","7678221","7678366","36","20784463"
"JH378111","28742610","28742734","KQ054356v1","1379018","1379142","28","27363592"
"JH378111","28742840","28742897","KQ052968v1","8156468","8156529","14","20586372"
"JH378111","28928348","28928517","KQ053299v1","22920975","22921141","38","6007373"
"JH378111","29034513","29034805","KQ058538v1","934688","934988","84","28099825"
"JH378111","30156517","30156808","KQ058155v1","1405246","1405544","80","28751271"
"JH378111","30285027","30285363","KQ056672v1","3535300","3535593","109","26749727"
"JH378111","30808225","30808371","KQ056672v1","6452016","6452164","37","24356209"
"JH378111","31095309","31095623","KQ054921v1","2545115","2545426","67","28550194"
"JH378111","31262125","31262399","KQ058283v1","3525175","3525450","73","27736950"
"JH378111","31382054","31382336","KQ058249v1","184192","184468","66","31197862"
"JH378111","32010512","32010825","KQ052970v1","18719762","18720075","79","13290750"
"JH378111","32225118","32225429","KQ053816v1","7464708","7465010","61","24760410"
"JH378111","32599113","32599245","KQ055957v1","554477","554608","24","32044636"
"JH378111","32768778","32769083","KQ053498v1","3696034","3696323","74","29072744"
"JH378111","32794817","32795109","KQ055141v1","3789164","3789452","67","29005653"
"JH378111","32798512","32798776","KQ052971v1","6441372","6441626","70","26357140"
"JH378111","32839862","32840167","KQ055119v1","3293975","3294284","67","29545887"
"JH378111","33013204","33013343","KQ052970v1","12418764","12418905","29","20594440"
"JH378111","33141503","33141662","KQ058050v1","749360","749517","37","32392143"
"JH378111","33186326","33186461","KQ058004v1","4709381","4709516","25","28476945"
"JH378111","33264852","33265149","KQ058183v1","487423","487710","73","32777429"
"JH378111","33296559","33296773","KQ058505v1","3952082","3952290","58","29344477"
"JH378111","33391161","33391442","KQ052968v1","7064883","7065171","66","26326278"
"JH378111","33405629","33405749","KQ057118v1","3875160","3875276","29","29530469"
"JH378111","33463146","33463391","KQ055035v1","3353120","3353360","68","30110026"
"JH378111","33475174","33475391","KQ053741v1","1190544","1190756","51","32284630"
"JH378111","33479352","33479585","KQ055320v1","2365107","2365346","63","31114245"
"JH378111","33497844","33498163","KQ052968v1","4333082","4333389","85","29164762"
"JH378111","33498471","33498772","KQ055036v1","4936193","4936498","75","28562278"
"JH378111","33590107","33590284","KQ058459v1","469480","469653","38","33120627"
"JH378111","33618686","33618820","KQ058561v1","557545","557678","14","33061141"
"JH378111","33706301","33706404","KQ054660v1","4884240","4884341","25","28822061"
"JH378111","34119327","34119615","KQ056494v1","2222182","2222467","65","31897145"
"JH378111","34475974","34476257","KQ052968v1","4204511","4204788","71","30271463"
"JH378111","34612177","34612453","KQ053894v1","688559","688830","74","33923618"
"JH378111","34911863","34912152","KQ053520v1","848167","848461","73","34063696"
"JH378111","35097236","35097550","KQ054401v1","2629005","2629296","70","32468231"
"JH378111","35124425","35124743","KQ056044v1","2538771","2539068","84","32585654"
"JH378111","35598959","35599181","KQ054124v1","4660657","4660862","71","30938302"
"JH378111","35947113","35947245","KQ053310v1","2640191","2640334","47","33306922"
"JH378111","36724932","36725247","KQ053795v1","1729459","1729773","73","34995473"
"JH378111","37281440","37281754","KQ053795v1","1729459","1729773","64","35551981"
"JH378111","37595325","37595586","KQ053993v1","1017100","1017367","81","36578225"
"JH378111","37667354","37667609","KQ054576v1","657552","657814","73","37009802"
"JH378111","37724849","37725135","KQ055893v1","2015012","2015285","79","35709837"
"JH378111","37730900","37731199","KQ053816v1","7464708","7465010","67","30266192"
"JH378111","38580891","38580955","KQ053072v1","197621","197681","21","38383270"
"JH378111","38582654","38582947","KQ054510v1","2204929","2205225","76","36377725"
"JH378111","39501589","39501720","KQ055957v1","554477","554608","29","38947112"
"JH378111","40141440","40141728","KQ058473v1","369163","369455","73","39772277"
"JH378111","40156098","40156379","KQ058317v1","5506620","5506904","69","34649478"
"JH378111","40399267","40399528","KQ056423v1","1942313","1942589","68","38456954"
"JH378111","40533534","40533799","KQ057404v1","796061","796320","83","39737473"
"JH378111","41159360","41159655","KQ054124v1","77238","77535","71","41082122"
"JH378111","41204201","41204492","KQ052968v1","13657848","13658133","74","27546353"
"JH378111","41225919","41226054","KQ053948v1","2765570","2765701","26","38460349"
"JH378111","41467533","41467738","KQ057560v1","1700424","1700630","67","39767109"
"JH378111","41524826","41524958","KQ058619v1","128477","128611","22","41396349"
"JH378111","41626743","41626991","KQ053256v1","1257292","1257559","75","40369451"
"JH378111","42225815","42226115","KQ058315v1","658193","658490","73","41567622"
"JH378111","42683956","42684077","KQ053409v1","6105325","6105446","31","36578631"
"JH378111","42693835","42694108","KQ053905v1","3600529","3600809","67","39093306"
"JH378111","43100195","43100492","KQ053332v1","554962","555258","72","42545233"
"JH378111","43332069","43332350","KQ055404v1","2891185","2891468","65","40440884"
"JH378111","43393092","43393401","KQ056568v1","1617795","1618102","64","41775297"
"JH378111","43919649","43919966","KQ058585v1","580456","580763","82","43339193"
"JH378111","44369586","44369874","KQ055352v1","7784426","7784721","68","36585160"
"JH378111","44664210","44664425","KQ053872v1","262334","262548","79","44401876"
"JH378111","44742759","44743066","KQ052981v1","1198440","1198752","72","43544319"
"JH378111","44898057","44898180","KQ053146v1","2799678","2799801","24","42098379"
"JH378111","44911289","44911376","KQ054400v1","280157","280246","16","44631132"
"JH378111","45064891","45065204","KQ057291v1","667476","667747","100","44397415"
"JH378111","45266308","45266584","KQ057290v1","1053741","1054027","76","44212567"
"JH378111","45787662","45787816","KQ053850v1","197751","197910","47","45589911"
"JH378111","45817908","45818141","KQ054704v1","483937","484161","81","45333971"
"JH378111","45882476","45882760","KQ054102v1","1325684","1325978","69","44556792"
"JH378111","45928128","45928376","KQ057656v1","1375539","1375777","68","44552589"
"JH378111","45969859","45970136","KQ057380v1","1672785","1673058","70","44297074"
"JH378112","24117220","24117520","KQ053035v1","112316","112619","74","24004904"
"JH378112","139802","139974","KQ057560v1","2172970","2173133","47","2033168"
"JH378112","553354","553584","KQ056493v1","4393253","4393488","67","3839899"
"JH378112","822154","822453","KQ052968v1","12144948","12145253","71","11322794"
"JH378112","948454","948676","KQ056762v1","1558119","1558341","72","609665"
"JH378112","989288","989528","KQ055518v1","1576074","1576315","72","586786"
"JH378112","1946679","1946959","KQ056643v1","159950","160228","72","1786729"
"JH378112","2144505","2144794","KQ054565v1","6587941","6588226","74","4443436"
"JH378112","2213881","2214156","KQ058316v1","3211882","3212156","76","998001"
"JH378112","2484891","2485179","KQ058317v1","5506620","5506904","68","3021729"
"JH378112","2583201","2583525","KQ053115v1","3485337","3485650","82","902136"
"JH378112","3124970","3125244","KQ053631v1","6524455","6524734","60","3399485"
"JH378112","3154435","3154607","KQ055352v1","9227221","9227396","41","6072786"
"JH378112","3180571","3180858","KQ053763v1","3320654","3320946","69","140083"
"JH378112","3198554","3198821","KQ053409v1","2092356","2092619","62","1106198"
"JH378112","3251356","3251659","KQ054412v1","2490468","2490761","75","760888"
"JH378112","3256517","3256766","KQ053070v1","1145700","1145952","67","2110817"
"JH378112","3372414","3372557","KQ058338v1","185444","185583","31","3186970"
"JH378112","3448000","3448276","KQ052968v1","13260777","13261056","67","9812777"
"JH378112","4436540","4436835","KQ052968v1","5668114","5668408","67","1231574"
"JH378112","4455296","4455595","KQ058272v1","5519908","5520197","73","1064612"
"JH378112","4847214","4847455","KQ053409v1","1084436","1084680","58","3762778"
"JH378112","5312729","5313009","KQ058183v1","3247932","3248220","63","2064797"
"JH378112","5481026","5481237","KQ053081v1","2153068","2153282","65","3327958"
"JH378112","5532688","5532969","KQ056790v1","446564","446855","73","5086124"
"JH378112","5618587","5618892","KQ054682v1","2246019","2246316","64","3372568"
"JH378112","5632849","5633058","KQ053959v1","3147544","3147761","59","2485305"
"JH378112","6006652","6006940","KQ057004v1","1506143","1506432","70","4500509"
"JH378112","6492785","6492987","KQ054682v1","822940","823121","56","5669845"
"JH378112","6625522","6625823","KQ056855v1","2789429","2789717","77","3836093"
"JH378112","6721140","6721407","KQ052969v1","11182978","11183250","76","4461838"
"JH378112","7509318","7509608","KQ052970v1","11867674","11867953","80","4358356"
"JH378112","8734422","8734720","KQ055808v1","1816763","1817047","72","6917659"
"JH378112","9009167","9009465","KQ058184v1","1505565","1505858","72","7503602"
"JH378112","9021299","9021589","KQ058291v1","474599","474881","77","8546700"
"JH378112","9149218","9149505","KQ058484v1","1273599","1273890","72","7875619"
"JH378112","9512712","9513013","KQ058272v1","4942871","4943179","71","4569841"
"JH378112","9757653","9757942","KQ053654v1","820983","821268","76","8936670"
"JH378112","10876473","10876751","KQ054868v1","473451","473739","82","10403022"
"JH378112","10891654","10891959","KQ057737v1","5377555","5377852","63","5514099"
"JH378112","10960355","10960659","KQ052970v1","8514092","8514396","68","2446263"
"JH378112","11053075","11053375","KQ058094v1","7832529","7832815","72","3220546"
"JH378112","11120227","11120515","KQ053059v1","3421896","3422194","63","7698331"
"JH378112","11684158","11684456","KQ053343v1","1747702","1748011","74","9936456"
"JH378112","11797090","11797297","KQ058537v1","27912","28129","57","11769178"
"JH378112","11879200","11879401","KQ054826v1","10000696","10000885","62","1878504"
"JH378112","12016268","12016566","KQ054682v1","1577967","1578262","61","10438301"
"JH378112","12062859","12063142","KQ053763v1","141096","141389","67","11921763"
"JH378112","12303457","12303707","KQ055518v1","1576074","1576315","61","10727383"
"JH378112","12429018","12429144","KQ053409v1","6573923","6574054","35","5855095"
"JH378112","12442109","12442400","KQ058473v1","369163","369455","66","12072946"
"JH378112","12449754","12450063","KQ056404v1","176748","177054","72","12273006"
"JH378112","12477198","12477293","KQ054932v1","4252125","4252214","26","8225073"
"JH378112","12488590","12488683","KQ053299v1","14559361","14559465","35","2070771"
"JH378112","12510869","12511060","KQ054826v1","9981760","9981967","61","2529109"
"JH378112","12642320","12642588","KQ055004v1","410084","410350","82","12232236"
"JH378112","12747352","12747609","KQ053894v1","1236287","1236536","67","11511065"
"JH378112","12824179","12824469","KQ056672v1","3108202","3108500","69","9715977"
"JH378112","12837359","12837497","KQ052968v1","8523342","8523490","38","4314017"
"JH378112","12837503","12837783","KQ058625v1","340677","340961","73","12496826"
"JH378112","12929670","12929962","KQ055097v1","1884579","1884874","73","11045091"
"JH378112","12954086","12954345","KQ055394v1","3441211","3441489","73","9512875"
"JH378112","12955912","12956114","KQ057737v1","1779203","1779413","53","11176709"
"JH378112","13159450","13159645","KQ055978v1","4255249","4255437","64","8904201"
"JH378112","13160542","13160675","KQ058427v1","4756553","4756686","26","8403989"
"JH378112","13170591","13170890","KQ056147v1","1747366","1747648","73","11423225"
"JH378112","13272334","13272532","KQ052970v1","2956326","2956524","62","10316008"
"JH378112","13281512","13281673","KQ057737v1","1426090","1426247","32","11855422"
"JH378112","13326895","13327030","KQ053520v1","716323","716460","32","12610572"
"JH378112","13454209","13454509","KQ056973v1","783590","783885","66","12670619"
"JH378112","13579517","13579807","KQ054412v1","2490468","2490761","65","11089049"
"JH378112","13819984","13820097","KQ054124v1","1271410","1271528","28","12548574"
"JH378112","13825653","13825832","KQ055457v1","11733685","11733859","49","2091968"
"JH378112","13902181","13902456","KQ053157v1","811137","811422","81","13091044"
"JH378112","13979403","13979527","KQ056234v1","886803","886922","24","13092600"
"JH378112","14279260","14279494","KQ053827v1","5369199","5369432","58","8910061"
"JH378112","14406171","14406488","KQ056928v1","1915686","1915996","78","12490485"
"JH378112","14492237","14492522","KQ058561v1","4466656","4466945","70","10025581"
"JH378112","14505166","14505292","KQ055600v1","267326","267449","28","14237840"
"JH378112","14566864","14567177","KQ054879v1","1971571","1971875","75","12595293"
"JH378112","14654868","14655160","KQ054069v1","5704070","5704362","70","8950798"
"JH378112","14656654","14656779","KQ055236v1","1859314","1859441","26","12797340"
"JH378112","14768228","14768534","KQ058184v1","1505565","1505858","65","13262663"
"JH378112","14990652","14990922","KQ053146v1","2819587","2819868","69","12171065"
"JH378112","15019064","15019357","KQ054510v1","2204929","2205225","60","12814135"
"JH378112","15138514","15138825","KQ053816v1","7464708","7465010","70","7673806"
"JH378112","16053784","16053890","KQ058183v1","3236759","3236851","25","12817025"
"JH378112","16312250","16312502","KQ055364v1","1919520","1919774","54","14392730"
"JH378112","16447519","16447824","KQ054213v1","780092","780393","75","15667427"
"JH378112","16479850","16480133","KQ055352v1","272395","272688","72","16207455"
"JH378112","16480294","16480573","KQ058317v1","5506620","5506904","67","10973674"
"JH378112","16531853","16532165","KQ057108v1","1270384","1270673","94","15261469"
"JH378112","16652435","16652712","KQ052969v1","8840489","8840774","67","7811946"
"JH378112","16794990","16795284","KQ053948v1","168940","169229","67","16626050"
"JH378112","17589382","17589649","KQ058316v1","3289111","3289379","75","14300271"
"JH378112","17844502","17844716","KQ054826v1","9981760","9981967","53","7862742"
"JH378112","17894461","17894719","KQ058538v1","1444447","1444703","71","16450014"
"JH378112","18145024","18145319","KQ058452v1","114230","114518","70","18030794"
"JH378112","18232672","18232962","KQ053948v1","2078671","2078957","61","16154001"
"JH378112","18250041","18250315","KQ053299v1","22323868","22324139","62","4073827"
"JH378112","18286475","18286737","KQ054301v1","3512152","3512421","80","14774323"
"JH378112","18436598","18436900","KQ054879v1","1971571","1971875","67","16465027"
"JH378112","18522641","18522832","KQ054776v1","1314982","1315182","53","17207659"
"JH378112","18586929","18587236","KQ053299v1","4095914","4096215","75","14491015"
"JH378112","18592829","18592992","KQ056475v1","5275769","5275928","40","13317060"
"JH378112","18625937","18626233","KQ053059v1","3421896","3422194","66","15204041"
"JH378112","18658433","18658592","KQ056386v1","2670252","2670409","42","15988181"
"JH378112","18902119","18902301","KQ056988v1","1481408","1481609","58","17420711"
"JH378112","18962013","18962295","KQ055479v1","641165","641444","70","18320848"
"JH378112","19020432","19020680","KQ056014v1","272527","272799","68","18747905"
"JH378112","19187242","19187370","KQ058427v1","4756553","4756686","24","14430689"
"JH378112","19465420","19465722","KQ057693v1","117172","117472","82","19348248"
"JH378112","19925794","19926102","KQ058585v1","580456","580763","66","19345338"
"JH378112","20489973","20490052","KQ052968v1","6651946","6652022","23","13838027"
"JH378112","20490802","20490964","KQ053774v1","3363264","3363425","37","17127538"
"JH378112","20571204","20571390","KQ053554v1","1326535","1326707","59","19244669"
"JH378112","20596158","20596420","KQ057560v1","1236972","1237228","58","19359186"
"JH378112","20819974","20820234","KQ057875v1","469535","469791","72","20350439"
"JH378112","20998057","20998325","KQ058283v1","1694307","1694568","61","19303750"
"JH378112","21318634","21318908","KQ054069v1","955693","955974","61","20362941"
"JH378112","21323738","21324023","KQ058538v1","2401604","2401892","63","18922134"
"JH378112","21333216","21333524","KQ058184v1","1505565","1505858","57","19827651"
"JH378112","21339099","21339389","ABDC02052257v1","792","1085","67","21338307"
"JH378112","21376202","21376519","KQ054525v1","45769","46078","74","21330433"
"JH378112","21506602","21506706","KQ055142v1","1223635","1223740","34","20282967"
"JH378112","21581678","21581925","KQ053632v1","575941","576173","73","21005737"
"JH378112","21805148","21805299","KQ055518v1","1979184","1979328","42","19825964"
"JH378112","21816664","21816963","KQ054725v1","2218271","2218569","65","19598393"
"JH378112","21836305","21836588","KQ053081v1","2760355","2760643","67","19075950"
"JH378112","21908283","21908587","KQ055236v1","2049624","2049930","55","19858659"
"JH378112","22068422","22068722","KQ054213v1","780092","780393","69","21288330"
"JH378112","22112447","22112745","KQ058266v1","1113469","1113760","69","20998978"
"JH378112","22307068","22307361","KQ054356v1","1600089","1600380","73","20706979"
"JH378112","22308248","22308546","KQ053299v1","18070968","18071267","71","4237280"
"JH378112","22383587","22383747","KQ057541v1","90696","90859","41","22292891"
"JH378112","22443911","22444064","KQ057118v1","1492016","1492164","39","20951895"
"JH378112","22483924","22484229","KQ055097v1","1884579","1884874","74","20599345"
"JH378112","22711981","22712263","KQ058317v1","5506620","5506904","69","17205361"
"JH378112","22747017","22747316","KQ053763v1","141096","141389","70","22605921"
"JH378112","22841346","22841649","KQ053816v1","7464708","7465010","73","15376638"
"JH378112","22977301","22977587","KQ055140v1","3474676","3474973","87","19502625"
"JH378112","23131864","23132163","KQ053631v1","9116387","9116675","64","14015477"
"JH378112","23578495","23578782","KQ055087v1","1063066","1063349","69","22515429"
"JH378112","23673379","23673689","KQ054932v1","4699407","4699723","85","18973972"
"JH378112","23740998","23741295","KQ058190v1","869921","870213","75","22871077"
"JH378112","23963170","23963432","KQ053059v1","2135970","2136233","78","21827200"
"JH378112","23973032","23973261","KQ054693v1","3245566","3245803","68","20727466"
"JH378112","24108199","24108287","KQ053096v1","344734","344824","22","23763465"
"JH378112","24109568","24109697","KQ055258v1","3274072","3274190","37","20835496"
"JH378112","24290818","24291074","KQ053146v1","2819587","2819868","77","21471231"
"JH378112","25396873","25397028","KQ054576v1","2237345","2237502","36","23159528"
"JH378112","25818075","25818379","KQ055830v1","814565","814880","65","25003510"
"JH378112","25837493","25837797","KQ056920v1","1346398","1346707","73","24491095"
"JH378112","26149474","26149709","KQ054289v1","4494059","4494296","74","21655415"
"JH378112","26151154","26151292","KQ053774v1","406836","406969","26","25744318"
"JH378112","26156923","26157215","KQ053959v1","2303063","2303358","80","23853860"
"JH378112","26233101","26233375","KQ053288v1","2756106","2756392","64","23476995"
"JH378112","26316705","26316843","KQ056147v1","2168964","2169108","33","24147741"
"JH378112","27903786","27903952","KQ056996v1","1524030","1524195","33","26379756"
"JH378112","28131078","28131371","KQ058394v1","9107761","9108054","69","19023317"
"JH378112","28427334","28427620","KQ052970v1","4083831","4084116","78","24343503"
"JH378112","28593535","28593802","KQ055745v1","631144","631414","60","27962391"
"JH378112","28753820","28754090","KQ057380v1","1672785","1673058","71","27081035"
"JH378112","28838443","28838541","KQ054932v1","4252125","4252214","27","24586318"
"JH378112","30320601","30320890","KQ053631v1","9116387","9116675","54","21204214"
"JH378112","30481811","30482036","KQ054069v1","159011","159235","61","30322800"
"JH378112","30600358","30600644","KQ054786v1","934497","934799","72","29665861"
"JH378112","30739309","30739594","KQ057380v1","3282069","3282354","76","27457240"
"JH378112","30867671","30867957","KQ053982v1","8167565","8167847","65","22700106"
"JH378112","30999043","30999302","KQ053157v1","3558863","3559137","66","27440180"
"JH378112","31005117","31005293","KQ054565v1","5663153","5663337","50","25341964"
"JH378112","31218724","31218812","KQ057737v1","356405","356487","21","30862319"
"JH378112","31218958","31219189","KQ058350v1","384041","384263","61","30834917"
"JH378112","31342491","31342782","KQ058184v1","1505565","1505858","68","29836926"
"JH378112","31382788","31383071","KQ058272v1","5443874","5444159","64","25938914"
"JH378112","31459854","31459935","KQ058527v1","757316","757404","22","30702538"
"JH378112","31833534","31833679","KQ057035v1","1134876","1135013","34","30698658"
"JH378112","31834253","31834385","KQ053654v1","4929533","4929667","23","26904720"
"JH378112","31953797","31954042","KQ055352v1","14158369","14158624","70","17795428"
"JH378112","32110458","32110700","KQ055375v1","3453902","3454144","74","28656556"
"JH378112","32146866","32146969","KQ053157v1","203721","203827","26","31943145"
"JH378112","32153130","32153426","KQ058405v1","1120230","1120530","62","31032900"
"JH378112","32170086","32170375","KQ053409v1","3716306","3716585","64","28453780"
"JH378112","32173279","32173547","KQ053948v1","80758","81020","66","32092521"
"JH378112","32228438","32228587","KQ053740v1","1071467","1071623","37","31156971"
"JH378112","32312957","32313262","KQ054725v1","2218271","2218569","59","30094686"
"JH378112","32465223","32465528","KQ053299v1","3622388","3622669","75","28842835"
"JH378112","32544920","32545108","KQ054933v1","3939617","3939804","45","28605303"
"JH378112","32559013","32559215","KQ058594v1","5040769","5040972","53","27518244"
"JH378112","32644279","32644402","KQ058483v1","4711310","4711430","32","27932969"
"JH378112","32644889","32645038","KQ057023v1","552794","552951","37","32092095"
"JH378112","32649811","32650114","KQ058585v1","580456","580763","60","32069355"
"JH378112","32670948","32671078","KQ058427v1","4756553","4756686","22","27914395"
"JH378112","32703950","32704240","KQ053565v1","754705","754987","64","31949245"
"JH378112","32758393","32758579","KQ058305v1","5597618","5597803","47","27160775"
"JH378112","32792944","32793046","KQ056447v1","3220649","3220743","24","29572295"
"JH378112","32811168","32811477","KQ053539v1","74662","74966","73","32736506"
"JH378112","32845885","32846156","KQ055735v1","1022582","1022853","65","31823303"
"JH378112","32876602","32876903","KQ057045v1","590946","591241","65","32285656"
"JH378112","32934867","32935172","KQ057296v1","1704","2006","72","32933163"
"JH378112","32949244","32949552","KQ053093v1","2968915","2969207","75","29980329"
"JH378112","32974112","32974289","KQ055457v1","11733685","11733859","36","21240427"
"JH378112","33140115","33140244","KQ054179v1","3865170","3865294","27","29274945"
"JH378112","33200662","33200944","KQ053465v1","2490819","2491086","85","30709843"
"JH378112","33288070","33288226","KQ058409v1","175175","175335","30","33112895"
"JH378112","33352409","33352519","KQ055662v1","2158228","2158334","36","31194181"
"JH378112","33379340","33379535","KQ053696v1","492750","492962","55","32886590"
"JH378112","33389570","33389689","KQ054682v1","1410308","1410435","24","31979262"
"JH378112","33409553","33409685","KQ053115v1","1333586","1333718","24","32075967"
"JH378112","33592548","33592710","KQ058283v1","1754070","1754231","51","31838478"
"JH378112","33595616","33595821","KQ054069v1","159011","159235","56","33436605"
"JH378112","33769108","33769427","KQ054068v1","6098024","6098330","84","27671084"
"JH378112","33883847","33883986","KQ054466v1","1866785","1866925","32","32017062"
"JH378112","33969736","33969986","KQ053267v1","2016796","2017035","67","31952940"
"JH378112","34001208","34001509","KQ058184v1","1505565","1505858","70","32495643"
"JH378112","34086703","34086967","KQ054826v1","9895778","9896046","79","24190925"
"JH378112","34116067","34116350","KQ053409v1","1794810","1795097","65","32321257"
"JH378112","34186995","34187285","KQ053365v1","2996957","2997245","62","31190038"
"JH378112","34515966","34516272","KQ058190v1","350088","350375","80","34165878"
"JH378112","34782894","34783202","KQ052969v1","9116808","9117108","61","25666086"
"JH378112","34969532","34969666","KQ058550v1","2860233","2860368","28","32109299"
"JH378112","35045737","35045797","KQ053696v1","870676","870725","22","34175061"
"JH378112","35133522","35133684","KQ058280v1","671567","671726","49","34461955"
"JH378112","35150988","35151252","KQ058379v1","21379","21640","65","35129609"
"JH378112","35151821","35151951","KQ053354v1","702320","702452","26","34449501"
"JH378112","35152217","35152381","KQ054533v1","1027813","1027974","36","34124404"
"JH378112","35163744","35164048","KQ058184v1","1505565","1505858","64","33658179"
"JH378112","35281138","35281424","KQ054510v1","2872930","2873219","62","32408208"
"JH378112","35326651","35326908","KQ057560v1","1236972","1237228","59","34089679"
"JH378112","35383443","35383575","KQ057649v1","141749","141881","26","35241694"
"JH378112","35672770","35673015","KQ053872v1","539000","539247","69","35133770"
"JH378112","35865754","35865770","KQ056540v1","177854","177870","4","35687900"
"JH378112","35865810","35865976","KQ058405v1","1518051","1518190","52","34347759"
"JH378112","35865978","35866083","KQ053654v1","3900921","3901030","26","31965057"
"JH378112","35928993","35929146","KQ053004v1","4759784","4759947","43","31169209"
"JH378112","36158633","36158910","KQ058184v1","1834586","1834869","69","34324047"
"JH378112","36287336","36287558","KQ057737v1","1779203","1779413","48","34508133"
"JH378112","36304809","36305094","KQ056672v1","3535300","3535593","54","32769509"
"JH378112","36465214","36465515","KQ058320v1","923031","923330","76","35542183"
"JH378112","36503384","36503659","KQ058004v1","1537773","1538048","71","34965611"
"JH378112","36603888","36604182","KQ053365v1","2996957","2997245","80","33606931"
"JH378112","36645119","36645258","KQ053565v1","3424702","3424834","37","33220417"
"JH378112","36647201","36647489","KQ053299v1","21723186","21723462","69","14924015"
"JH378112","36686145","36686436","KQ053093v1","3162517","3162806","60","33523628"
"JH378112","36970286","36970441","KQ054682v1","606323","606472","41","36363963"
"JH378112","37297057","37297223","KQ053179v1","1735404","1735576","44","35561653"
"JH378112","37300403","37300672","KQ058316v1","4984552","4984820","62","32315851"
"JH378112","37376641","37376885","KQ057522v1","1670299","1670546","55","35706342"
"JH378112","37690396","37690618","KQ053288v1","3238190","3238419","66","34452206"
"JH378112","37990943","37991244","KQ054466v1","2183618","2183917","60","35807325"
"JH378112","38189322","38189604","KQ058383v1","5944247","5944518","78","32245075"
"JH378112","38979694","38979840","KQ054191v1","266771","266904","37","38712923"
"JH378112","39420671","39420970","KQ055872v1","7304225","7304518","66","32116446"
"JH378112","39910308","39910608","KQ054068v1","5074639","5074944","88","34835669"
"JH378112","40528172","40528317","KQ053135v1","3925667","3925819","46","36602505"
"JH378112","41129615","41129911","KQ053959v1","5479288","5479573","81","35650327"
"JH378112","41205528","41205823","KQ055375v1","2960963","2961246","68","38244565"
"JH378112","41243245","41243448","KQ053170v1","267257","267471","59","40975988"
"JH378112","41306574","41306674","KQ055024v1","329599","329697","24","40976975"
"JH378112","41397995","41398223","KQ055457v1","9003971","9004197","58","32394024"
"JH378112","41766981","41767284","KQ058184v1","1505565","1505858","72","40261416"
"JH378112","41884308","41884613","KQ054069v1","7687863","7688158","71","34196445"
"JH378112","42320717","42321004","KQ056827v1","989698","989981","66","41331019"
"JH378112","42346256","42346538","KQ056254v1","1300375","1300653","62","41045881"
"JH378112","42443130","42443301","KQ053631v1","5537811","5537978","51","36905319"
"JH378112","42814792","42815063","KQ055173v1","452351","452623","79","42362441"
"JH378112","43460809","43460957","KQ053190v1","2372433","2372579","38","41088376"
"JH378112","43702882","43703184","KQ055097v1","1884579","1884874","66","41818303"
"JH378112","44082352","44082657","KQ056790v1","446564","446855","76","43635788"
"JH378112","45088050","45088329","KQ055872v1","12987862","12988141","65","32100188"
"JH378112","45110971","45111239","KQ058283v1","5849694","5849954","78","39261277"
"JH378112","45123292","45123377","KQ053060v1","4849","4931","16","45118443"
"JH378112","45164367","45164684","KQ056440v1","448517","448809","84","44715850"
"JH378112","45173149","45173404","KQ054984v1","996853","997105","64","44176296"
"JH378112","45194209","45194391","KQ056945v1","2675278","2675453","51","42518931"
"JH378112","45220000","45220143","KQ053115v1","1650505","1650644","34","43569495"
"JH378112","45222459","45222748","KQ053409v1","6051156","6051445","74","39171303"
"JH378112","45227875","45228028","KQ054196v1","237","387","46","45227638"
"JH378112","45242836","45243069","KQ055247v1","2156838","2157064","54","43085998"
"JH378113","19136472","19136768","KQ053816v1","7464708","7465010","59","11671764"
"JH378113","146069","146366","KQ056790v1","446564","446855","63","300495"
"JH378113","1323015","1323360","KQ058316v1","3835362","3835700","90","2512347"
"JH378113","1790482","1790667","KQ053598v1","2876763","2876951","46","1086281"
"JH378113","1892275","1892350","KQ058317v1","4520617","4520689","24","2628342"
"JH378113","1905362","1905493","KQ053948v1","2765570","2765701","31","860208"
"JH378113","2035925","2036197","KQ052982v1","2557979","2558263","65","522054"
"JH378113","2152823","2153144","KQ053398v1","2431232","2431537","70","278409"
"JH378113","2172991","2173266","KQ056064v1","587492","587768","88","1585499"
"JH378113","2299203","2299436","KQ058643v1","592514","592742","59","1706689"
"JH378113","2314617","2314904","KQ054069v1","5704070","5704362","82","3389453"
"JH378113","2325839","2326138","KQ056345v1","621994","622295","69","1703845"
"JH378113","2359169","2359286","KQ053157v1","7994190","7994309","26","5635021"
"JH378113","2482661","2482865","KQ055893v1","679395","679599","56","1803266"
"JH378113","2540647","2540844","KQ058561v1","574552","574746","52","1966095"
"JH378113","2541207","2541317","KQ057909v1","4153593","4153709","21","1612386"
"JH378113","2564135","2564429","KQ054533v1","1794603","1794882","78","769532"
"JH378113","2567771","2568070","KQ054401v1","2629005","2629296","66","61234"
"JH378113","2570230","2570533","KQ054565v1","7466367","7466669","62","4896137"
"JH378113","2672807","2673101","KQ053696v1","325593","325885","71","2347214"
"JH378113","2682014","2682308","KQ058550v1","3068705","3069008","70","386691"
"JH378113","2787431","2787678","KQ058595v1","270580","270831","62","2516851"
"JH378113","2941367","2941607","KQ058405v1","697304","697560","73","2244063"
"JH378113","2974317","2974512","KQ058301v1","333804","333994","50","2640513"
"JH378113","3322219","3322371","KQ053157v1","5478543","5478695","37","2156324"
"JH378113","3326570","3326711","KQ052970v1","10419372","10419512","31","7092802"
"JH378113","3362004","3362308","KQ058505v1","2806472","2806766","58","555532"
"JH378113","3377405","3377726","KQ055004v1","332895","333205","74","3044510"
"JH378113","3388903","3389197","KQ056148v1","2419670","2419961","65","969233"
"JH378113","3390115","3390365","KQ054826v1","303348","303596","73","3086767"
"JH378113","3405085","3405397","KQ056493v1","1483561","1483863","63","1921524"
"JH378113","3451180","3451308","KQ053409v1","6573923","6574054","27","3122743"
"JH378113","3474114","3474404","KQ053565v1","1022720","1023014","74","2451394"
"JH378113","3580321","3580609","KQ056672v1","3082150","3082439","62","498171"
"JH378113","3588572","3588852","KQ055375v1","3672008","3672286","70","83436"
"JH378113","3627036","3627296","KQ053816v1","5213784","5214044","62","1586748"
"JH378113","3647440","3647722","KQ053740v1","2323389","2323680","76","1324051"
"JH378113","3763956","3764269","KQ054682v1","2125705","2126015","72","1638251"
"JH378113","3765125","3765263","KQ054312v1","1696011","1696119","54","2069114"
"JH378113","3765487","3765777","KQ058594v1","5996843","5997124","61","2231356"
"JH378113","3785400","3785649","KQ054660v1","2829812","2830044","61","955588"
"JH378113","3813093","3813347","KQ057380v1","1672785","1673058","67","2140308"
"JH378113","3898659","3898949","KQ054510v1","8555095","8555387","70","4656436"
"JH378113","4018173","4018388","KQ058410v1","1161849","1162066","58","2856324"
"JH378113","4048642","4048723","KQ055946v1","371653","371727","26","3676989"
"JH378113","4049112","4049294","KQ055457v1","3916871","3917034","54","132241"
"JH378113","4057383","4057684","KQ053135v1","2766167","2766465","64","1291216"
"JH378113","4243833","4244128","KQ055248v1","947170","947461","67","3296663"
"JH378113","4286103","4286260","KQ053498v1","3548759","3548906","46","737344"
"JH378113","4290098","4290385","KQ052971v1","841846","842131","66","3448252"
"JH378113","4298554","4298851","KQ058184v1","1505565","1505858","63","2792989"
"JH378113","4316554","4316748","KQ053294v1","648","849","55","4315906"
"JH378113","4380447","4380738","KQ056672v1","3535300","3535593","65","845147"
"JH378113","4411591","4411768","KQ053288v1","1003387","1003559","34","3408204"
"JH378113","4549873","4550153","KQ053816v1","5837219","5837503","71","1287346"
"JH378113","4633978","4634241","KQ058381v1","733538","733808","74","3900440"
"JH378113","4636838","4637159","KQ054704v1","223675","223980","94","4413163"
"JH378113","4655109","4655393","KQ058291v1","474599","474881","64","4180510"
"JH378113","4703223","4703507","KQ058561v1","4466656","4466945","61","236567"
"JH378113","4728209","4728568","KQ053037v1","2305956","2306272","102","2422253"
"JH378113","4731254","4731569","KQ056928v1","1915686","1915996","65","2815568"
"JH378113","4812910","4813121","KQ053212v1","1714221","1714450","74","3098689"
"JH378113","4825962","4826127","KQ058305v1","1174954","1175117","30","3651008"
"JH378113","4858526","4858624","KQ058427v1","6152893","6152991","25","1294367"
"JH378113","4979641","4979884","KQ058503v1","123813","124064","70","4855828"
"JH378113","5029063","5029215","KQ057649v1","141749","141881","43","4887314"
"JH378113","5057011","5057317","KQ058184v1","1505565","1505858","69","3551446"
"JH378113","5218393","5218520","KQ056855v1","804290","804423","28","4414103"
"JH378113","5280111","5280401","KQ053135v1","3426022","3426314","61","1854089"
"JH378113","5716043","5716333","KQ056790v1","446564","446855","64","5269479"
"JH378113","5895484","5895648","KQ057737v1","3327678","3327839","47","2567806"
"JH378113","6227130","6227413","KQ057737v1","2756211","2756494","57","3470919"
"JH378113","6278700","6278888","KQ053387v1","4402041","4402214","55","1876659"
"JH378113","6324423","6324586","KQ054533v1","1027813","1027974","32","5296610"
"JH378113","6458145","6458449","KQ056673v1","654012","654302","68","5804133"
"JH378113","6559401","6559695","KQ053398v1","11302","11591","72","6548099"
"JH378113","6730440","6730578","KQ053157v1","4288391","4288538","38","2442049"
"JH378113","6788628","6788786","KQ058372v1","1963602","1963771","43","4825026"
"JH378113","6789877","6790085","KQ053256v1","942460","942674","44","5847417"
"JH378113","6854827","6855093","KQ057648v1","1045378","1045620","75","5809449"
"JH378113","6948623","6948936","KQ053686v1","1253783","1254086","79","5694840"
"JH378113","6988520","6988645","KQ054795v1","2377934","2378063","31","4610586"
"JH378113","7531641","7531861","KQ058266v1","662378","662594","65","6869263"
"JH378113","8197016","8197267","KQ057380v1","3498341","3498594","78","4698675"
"JH378113","8347613","8347911","KQ058184v1","1505565","1505858","84","6842048"
"JH378113","8489648","8489924","KQ057522v1","1108367","1108662","75","7381281"
"JH378113","8716392","8716517","KQ057488v1","512192","512325","29","8204200"
"JH378113","8921469","8921672","KQ054826v1","9981760","9981967","51","1060291"
"JH378113","9299373","9299663","KQ052970v1","6659487","6659775","71","2639886"
"JH378113","9966467","9966660","KQ054179v1","1149324","1149515","52","8817143"
"JH378113","10149367","10149659","KQ053554v1","1105373","1105659","61","9043994"
"JH378113","10302993","10303285","KQ058394v1","9107761","9108054","62","1195232"
"JH378113","10400469","10400598","KQ056361v1","317113","317243","24","10083356"
"JH378113","10460759","10460917","KQ054565v1","627778","627936","31","9832981"
"JH378113","10490605","10490863","KQ056643v1","159950","160228","63","10330655"
"JH378113","10532331","10532626","KQ052969v1","7351818","7352090","80","3180513"
"JH378113","10538700","10538941","KQ052969v1","1086346","1086592","80","9452354"
"JH378113","10566920","10567212","KQ053115v1","1118362","1118655","67","9448558"
"JH378113","10761263","10761544","KQ058184v1","1608105","1608378","75","9153158"
"JH378113","10762239","10762537","KQ057911v1","428931","429228","52","10333308"
"JH378113","10804485","10804788","KQ058272v1","6295757","6296050","66","4508728"
"JH378113","10835981","10836274","KQ058350v1","6740286","6740580","70","4095695"
"JH378113","10984833","10984977","KQ058640v1","122151","122286","35","10862682"
"JH378113","11021816","11022104","KQ057648v1","78808","79100","59","10943008"
"JH378113","11064818","11065121","KQ053299v1","3823059","3823361","66","7241759"
"JH378113","11433417","11433707","KQ057875v1","561558","561851","69","10871859"
"JH378113","11440158","11440463","KQ053299v1","6038380","6038679","64","5401778"
"JH378113","11459785","11459988","KQ058594v1","5040769","5040972","51","6419016"
"JH378113","11581676","11581984","KQ054191v1","3583730","3584032","78","7997946"
"JH378113","11629292","11629561","KQ058328v1","6007709","6007975","71","5621583"
"JH378113","11646676","11646963","KQ052982v1","2557979","2558263","70","9088697"
"JH378113","11801819","11802118","KQ058394v1","12155871","12156172","77","354052"
"JH378113","12467166","12467475","KQ058272v1","5344193","5344507","69","7122973"
"JH378113","12944327","12944437","KQ054091v1","1562507","1562616","28","11381820"
"JH378113","13195781","13196090","KQ054786v1","934497","934799","68","12261284"
"JH378113","13450635","13450865","KQ058272v1","2561906","2562124","62","10888729"
"JH378113","13597969","13598099","KQ055600v1","267326","267449","29","13330643"
"JH378113","13631029","13631222","KQ053126v1","200434","200608","56","13430595"
"JH378113","14100635","14100912","KQ058004v1","1908068","1908353","68","12192567"
"JH378113","14127546","14127762","KQ055651v1","4351956","4352174","56","9775590"
"JH378113","14253355","14253635","KQ053115v1","1118362","1118655","66","13134993"
"JH378113","14387973","14388270","KQ054510v1","8555095","8555387","60","5832878"
"JH378113","14504711","14504987","KQ058184v1","1505565","1505858","69","12999146"
"JH378113","14550112","14550305","KQ057290v1","4745481","4745684","49","9804631"
"JH378113","14558056","14558346","KQ053718v1","3638528","3638821","58","10919528"
"JH378113","14630598","14630896","KQ058550v1","3068705","3069008","70","11561893"
"JH378113","14703028","14703311","KQ053332v1","447571","447853","59","14255457"
"JH378113","14720319","14720606","KQ055384v1","757163","757453","59","13963156"
"JH378113","15044507","15044776","KQ054713v1","3140905","3141166","75","11903602"
"JH378113","15139587","15139813","KQ058272v1","2561906","2562124","61","12577681"
"JH378113","15178385","15178551","KQ053476v1","4635198","4635357","41","10543187"
"JH378113","15182457","15182609","KQ053476v1","2915425","2915579","49","12267032"
"JH378113","15234906","15235163","KQ057702v1","1579642","1579892","65","13655264"
"JH378113","15282240","15282365","KQ055957v1","554477","554608","27","14727763"
"JH378113","15541517","15541823","KQ054510v1","2681434","2681749","69","12860083"
"JH378113","15892502","15892803","KQ054510v1","8555095","8555387","71","7337407"
"JH378113","15920447","15920731","KQ054068v1","3341291","3341579","62","12579156"
"JH378113","15959434","15959722","KQ057755v1","45985","46262","59","15913449"
"JH378113","15980268","15980526","KQ058280v1","515894","516148","80","15464374"
"JH378113","15981118","15981444","KQ053278v1","1984227","1984541","82","13996891"
"JH378113","16222277","16222583","KQ053343v1","1747702","1748011","72","14474575"
"JH378113","16227687","16227944","KQ054713v1","840037","840292","74","15387650"
"JH378113","16365343","16365476","KQ056147v1","1993009","1993136","30","14372334"
"JH378113","16398811","16398910","KQ056613v1","1941571","1941673","25","14457240"
"JH378113","16398986","16399054","KQ054466v1","1769053","1769119","25","14629933"
"JH378113","16399068","16399141","KQ058483v1","4491053","4491121","20","11908015"
"JH378113","16724353","16724602","KQ058503v1","123813","124064","63","16600540"
"JH378113","16994548","16994689","KQ058272v1","5819713","5819848","39","11174835"
"JH378113","17171507","17171803","KQ054356v1","1600089","1600380","56","15571418"
"JH378113","17193115","17193259","KQ058640v1","122151","122286","40","17070964"
"JH378113","17202882","17203011","KQ053115v1","1333586","1333718","25","15869296"
"JH378113","17290981","17291272","KQ054412v1","2490468","2490761","69","14800513"
"JH378113","17652891","17653173","KQ055065v1","1117201","1117481","63","16535690"
"JH378113","17694148","17694460","KQ054510v1","2056259","2056562","66","15637889"
"JH378113","17762582","17762725","KQ056234v1","319108","319254","37","17443474"
"JH378113","18079159","18079457","KQ052970v1","2531178","2531455","78","15547981"
"JH378113","18128786","18129098","KQ058184v1","1505565","1505858","68","16623221"
"JH378113","19055525","19055609","KQ058253v1","973922","974008","23","18081603"
"JH378113","19105731","19106026","KQ053300v1","2874445","2874736","70","16231286"
"JH378113","20084985","20085253","KQ054068v1","2778435","2778706","75","17306550"
"JH378113","20126600","20126848","KQ054933v1","935520","935770","55","19191080"
"JH378113","20262787","20263070","KQ057213v1","1074642","1074915","64","19188145"
"JH378113","21065224","21065492","KQ053609v1","2550928","2551200","60","18514296"
"JH378113","21175312","21175565","KQ055364v1","1919520","1919774","67","19255792"
"JH378113","21371619","21371916","KQ055097v1","2825545","2825834","59","18546074"
"JH378113","21374522","21374815","KQ053115v1","1118362","1118655","83","20256160"
"JH378113","21633171","21633301","KQ054857v1","362885","363016","24","21270286"
"JH378113","21842940","21843256","KQ053299v1","4095914","4096215","75","17747026"
"JH378113","21954214","21954496","KQ058459v1","41509","41799","71","21912705"
"JH378113","22047498","22047766","KQ055873v1","328672","328938","66","21718826"
"JH378113","22079266","22079507","KQ056147v1","3491603","3491838","55","18587663"
"JH378113","22102718","22102854","KQ053115v1","1650505","1650644","34","20452213"
"JH378113","22636542","22636846","KQ054510v1","6887667","6887971","64","15748875"
"JH378113","22682691","22682968","KQ053299v1","22411132","22411409","69","271559"
"JH378113","22934263","22934545","KQ058004v1","1480411","1480689","71","21453852"
"JH378113","22986182","22986469","KQ053631v1","9963313","9963601","67","13022869"
"JH378113","23194748","23194963","KQ058505v1","3952082","3952290","54","19242666"
"JH378113","23198384","23198636","KQ055247v1","2156838","2157064","73","21041546"
"JH378113","23282209","23282499","KQ058428v1","1609842","1610139","72","21672367"
"JH378113","23300747","23301057","KQ055787v1","1064992","1065293","80","22235755"
"JH378113","23342271","23342416","KQ056147v1","2168964","2169108","32","21173307"
"JH378113","23398098","23398386","KQ054932v1","10830322","10830609","74","12567776"
"JH378113","23442909","23443230","KQ052981v1","1198440","1198752","78","22244469"
"JH378113","23453344","23453643","KQ058184v1","1505565","1505858","58","21947779"
"JH378113","23474052","23474343","KQ057205v1","1970885","1971154","75","21503167"
"JH378113","23490428","23490732","KQ056673v1","1151371","1151663","77","22339057"
"JH378113","23530732","23530961","KQ057764v1","2088730","2088934","60","21442002"
"JH378113","23583322","23583613","KQ054693v1","832788","833076","62","22750534"
"JH378113","23591491","23591767","KQ053247v1","287917","288197","72","23303574"
"JH378113","23665091","23665360","KQ055662v1","4683524","4683789","69","18981567"
"JH378113","23731150","23731284","KQ057901v1","1218014","1218146","23","22513136"
"JH378113","23815970","23816194","KQ057034v1","3957140","3957365","46","19858830"
"JH378113","24262521","24262793","KQ057910v1","2537338","2537606","70","21725183"
"JH378113","24311581","24311880","KQ053654v1","5318679","5318982","77","18992902"
"JH378113","24850456","24850599","KQ053498v1","3548759","3548906","35","21301697"
"JH378113","25002039","25002323","KQ053332v1","447571","447853","60","24554468"
"JH378113","25513831","25514124","KQ054412v1","2490468","2490761","58","23023363"
"JH378113","25523335","25523629","KQ057290v1","1053741","1054027","72","24469594"
"JH378113","25638134","25638417","KQ058394v1","9107761","9108054","69","16530373"
"JH378113","26060784","26061049","KQ054933v1","4715601","4715851","68","21345183"
"JH378113","26113049","26113180","KQ057649v1","141749","141881","28","25971300"
"JH378113","26114712","26114995","KQ056234v1","4184542","4184823","70","21930170"
"JH378113","26115464","26115614","KQ053631v1","1260941","1261095","37","24854523"
"JH378113","26385070","26385360","KQ054693v1","832788","833076","69","25552282"
"JH378113","26488246","26488525","KQ053332v1","447571","447853","56","26040675"
"JH378113","26661590","26661889","KQ058184v1","1505565","1505858","65","25156025"
"JH378113","26822784","26822969","KQ054826v1","9847228","9847399","48","16975556"
"JH378113","26836595","26836729","KQ057910v1","1548802","1548933","25","25287793"
"JH378113","27058557","27058864","KQ053115v1","3485337","3485650","67","23573220"
"JH378113","28131379","28131638","KQ053465v1","403029","403303","62","27728350"
"JH378113","28291031","28291345","KQ056475v1","2179070","2179363","74","26111961"
"JH378113","28294639","28294721","KQ054400v1","280157","280246","20","28014482"
"JH378113","28511884","28512154","KQ053409v1","5686466","5686740","68","22825418"
"JH378113","28548903","28549143","KQ058394v1","15440202","15440431","72","13108701"
"JH378113","28568251","28568557","KQ053849v1","1318915","1319229","68","27249336"
"JH378113","28617724","28617868","KQ053299v1","7348738","7348881","33","21268986"
"JH378113","28624927","28625213","KQ053300v1","2877663","2877955","65","25747264"
"JH378113","28629542","28629703","KQ056475v1","5275769","5275928","32","23353773"
"JH378113","28630002","28630115","KQ058494v1","8405615","8405726","27","20224387"
"JH378113","28690312","28690587","KQ053785v1","2248190","2248465","84","26442122"
"JH378113","28797771","28797935","KQ053004v1","4759784","4759947","33","24037987"
"JH378113","28804862","28805146","KQ053093v1","1375309","1375598","65","27429553"
"JH378113","28891137","28891425","KQ058329v1","663480","663767","75","28227657"
"JH378113","29635453","29635718","KQ058266v1","992042","992314","70","28643411"
"JH378113","29980910","29981218","KQ057737v1","4424765","4425071","71","25556145"
"JH378113","30055370","30055671","KQ055236v1","2049624","2049930","74","28005746"
"JH378113","31420852","31421163","KQ053081v1","1141867","1142168","68","30278985"
"JH378113","31443588","31443658","KQ055140v1","2199171","2199252","23","29244417"
"JH378113","31512986","31513252","KQ055192v1","1201363","1201615","65","30311623"
"JH378113","31646942","31647244","KQ053035v1","112316","112619","75","31534626"
"JH378113","31660877","31661175","KQ053498v1","3647598","3647890","72","28013279"
"JH378113","31719741","31720022","KQ053299v1","21869448","21869738","71","9850293"
"JH378113","31731873","31732152","KQ053093v1","1361295","1361576","51","30370578"
"JH378113","31743743","31744059","KQ056148v1","430759","431072","76","31312984"
"JH378113","31753674","31753936","KQ053256v1","1257292","1257559","68","30496382"
"JH378113","31766425","31766680","KQ053521v1","1520832","1521089","69","30245593"
"JH378113","31774247","31774392","KQ053081v1","7678221","7678366","36","24096026"
"JH378113","31808110","31808277","KQ054725v1","735942","736116","36","31072168"
"JH378113","31808497","31808572","KQ058272v1","6366456","6366524","21","25442041"
"JH378113","31834083","31834270","KQ054804v1","1503479","1503667","38","30330604"
"JH378113","31854816","31855095","KQ053520v1","2992926","2993205","58","28861890"
"JH378113","31886243","31886601","KQ053025v1","49730","50045","106","31836513"
"JH378113","31906398","31906679","KQ054660v1","3418146","3418430","60","28488252"
"JH378113","31953780","31954068","KQ053476v1","1593386","1593681","68","30360394"
"JH378113","32061788","32061917","KQ056147v1","3988341","3988465","36","28073447"
"JH378113","32151527","32151828","KQ053115v1","1118362","1118655","71","31033165"
"JH378113","32154974","32155246","KQ053190v1","3029554","3029812","80","29125420"
"JH378113","32219121","32219200","KQ053883v1","3315834","3315907","24","28903287"
"JH378113","32221209","32221377","KQ053223v1","2815634","2815800","39","29405575"
"JH378113","32299700","32299972","KQ052969v1","10404297","10404571","68","21895403"
"JH378113","32312959","32313232","KQ056404v1","1771928","1772196","73","30541031"
"JH378113","32345711","32345997","KQ055087v1","1063066","1063349","75","31282645"
"JH378113","32367842","32367944","KQ052969v1","10606705","10606802","23","21761137"
"JH378113","32368014","32368173","KQ057232v1","342166","342330","42","32025848"
"JH378113","32373702","32373826","KQ058257v1","652425","652556","29","31721277"
"JH378113","32381609","32381695","KQ053081v1","745029","745121","25","31636580"
"JH378113","32412714","32412798","KQ052968v1","9790867","9790941","27","22621847"
"JH378113","32454602","32454907","KQ058184v1","1505565","1505858","61","30949037"
"JH378113","32461615","32461735","KQ058042v1","92910","93024","27","32368705"
"JH378113","32804333","32804464","KQ056663v1","464182","464321","31","32340151"
"JH378113","33078029","33078235","KQ053081v1","1259521","1259727","57","31818508"
"JH378113","33981199","33981357","KQ057023v1","552794","552951","44","33428405"
"JH378113","34245275","34245568","KQ053409v1","3716306","3716585","68","30528969"
"JH378113","34260074","34260344","KQ053498v1","3849819","3850073","67","30410255"
"JH378113","34349732","34350021","KQ057205v1","1097243","1097539","66","33252489"
"JH378113","34701592","34701769","KQ053179v1","1735404","1735576","42","32966188"
"JH378113","34992567","34992824","KQ055364v1","1919520","1919774","67","33073047"
"JH378113","35014590","35014750","KQ053916v1","1573932","1574091","35","33440658"
"JH378113","35176753","35177026","KQ058199v1","376819","377090","80","34799934"
"JH378113","35197039","35197232","KQ054401v1","3245220","3245428","58","31951819"
"JH378113","35364635","35364862","KQ055457v1","9003971","9004197","60","26360664"
"JH378113","35452536","35452842","KQ058328v1","1680275","1680587","70","33772261"
"JH378113","35734092","35734363","KQ053191v1","1874915","1875171","81","33859177"
"JH378113","35946271","35946435","KQ052968v1","10427732","10427888","33","25518539"
"JH378113","36000594","36000874","KQ053718v1","2407956","2408236","74","33592638"
"JH378113","36096052","36096344","KQ053409v1","3716306","3716585","74","32379746"
"JH378113","36443931","36444126","KQ052969v1","8528994","8529192","55","27914937"
"JH378113","36820259","36820546","KQ058497v1","407841","408124","69","36412418"
"JH378113","36952973","36953122","KQ055498v1","556944","557105","47","36396029"
"JH378113","37036861","37037140","KQ053465v1","167701","167983","73","36869160"
"JH378113","37172639","37172712","KQ058539v1","1080134","1080203","27","36092505"
"JH378113","37247066","37247352","KQ053686v1","963025","963293","73","36284041"
"JH378113","37514874","37515168","KQ053740v1","2565840","2566138","72","34949034"
"JH378113","37722839","37723082","KQ055203v1","1891285","1891537","59","35831554"
"JH378113","37725704","37725997","KQ053520v1","2913074","2913361","68","34812630"
"JH378113","37730645","37730776","KQ054533v1","2564884","2565016","33","35165761"
"JH378113","37803796","37804005","KQ058550v1","3053970","3054174","44","34749826"
"JH378113","37816181","37816313","KQ056064v1","5108638","5108754","38","32707543"
"JH378113","37823304","37823588","KQ058561v1","583947","584226","56","37239357"
"JH378113","38144798","38144995","KQ055662v1","1117136","1117330","53","37027662"
"JH378113","38503836","38504120","KQ054693v1","832788","833076","59","37671048"
"JH378113","38577499","38577719","KQ053354v1","55115","55328","61","38522384"
"JH378113","38609305","38609573","KQ053816v1","5213784","5214044","74","33395521"
"JH378113","39006325","39006636","KQ055468v1","2950644","2950940","73","36055681"
"JH378113","39341797","39342057","KQ058427v1","7850908","7851135","72","31490889"
"JH378113","39342242","39342285","KQ054135v1","1661841","1661887","9","37680401"
"JH378113","39368378","39368658","KQ054671v1","1712525","1712816","69","37655853"
"JH378113","40612547","40612843","KQ057909v1","11632258","11632558","67","28980289"
"JH378113","40789569","40789848","KQ058399v1","1755965","1756235","73","39033604"
"JH378113","41329939","41330229","KQ054756v1","1026786","1027083","79","40303153"
"JH378113","41656551","41656840","KQ055183v1","3167551","3167831","80","38489000"
"JH378113","41891907","41892194","KQ058184v1","1505565","1505858","62","40386342"
"JH378113","42027718","42027957","KQ053093v1","1363144","1363361","72","40664574"
"JH378113","42910733","42911024","KQ058094v1","7832529","7832815","65","35078204"
"JH378113","43201412","43201587","KQ052968v1","9610036","9610212","60","33591376"
"JH378113","43327799","43328087","KQ057603v1","1306760","1307030","89","42021039"
"JH378113","43717971","43718267","KQ053082v1","1023453","1023747","57","42694518"
"JH378113","44115246","44115510","KQ055142v1","1193213","1193460","80","42922033"
"JH378113","44195423","44195721","KQ057290v1","2180782","2181079","66","42014641"
"JH378113","44265546","44265706","KQ056475v1","5275769","5275928","34","38989777"
"JH378114","189730","190025","KQ058572v1","1453592","1453891","70","1263862"
"JH378114","216523","216819","KQ056044v1","2538771","2539068","74","2322248"
"JH378114","346728","347020","KQ053082v1","1085491","1085778","69","738763"
"JH378114","619340","619478","KQ056147v1","2168964","2169108","25","1549624"
"JH378114","778032","778310","KQ052968v1","13260777","13261056","69","12482745"
"JH378114","823071","823301","KQ055787v1","153774","154010","67","669297"
"JH378114","895587","895855","KQ054068v1","3341291","3341579","62","2445704"
"JH378114","1184541","1184791","KQ055893v1","1739065","1739339","76","554524"
"JH378114","1452571","1452801","KQ057380v1","2047063","2047290","58","594492"
"JH378114","1562909","1563036","KQ057875v1","315120","315258","38","1247789"
"JH378114","1563658","1563781","KQ054932v1","7772773","7772892","24","6209115"
"JH378114","1581163","1581434","KQ057035v1","2378582","2378848","75","797419"
"JH378114","1594181","1594309","KQ054179v1","3865170","3865294","24","2270989"
"JH378114","1657983","1658280","KQ055119v1","2003090","2003396","71","345107"
"JH378114","1794313","1794602","KQ056855v1","2789429","2789717","61","995116"
"JH378114","2257006","2257302","KQ054533v1","865330","865612","67","1391676"
"JH378114","2276087","2276409","KQ056762v1","177315","177633","77","2098772"
"JH378114","2293812","2294112","KQ055236v1","2049624","2049930","67","244188"
"JH378114","2399295","2399544","KQ053816v1","5213784","5214044","80","2814489"
"JH378114","2496098","2496367","KQ055978v1","3560415","3560681","79","1064317"
"JH378114","2511230","2511510","KQ053190v1","4987885","4988162","59","2476655"
"JH378114","2526371","2526667","KQ058184v1","1505565","1505858","59","1020806"
"JH378114","2706148","2706413","KQ053872v1","539000","539247","78","2167148"
"JH378114","2913013","2913083","KQ053179v1","1520740","1520793","28","1392273"
"JH378114","3036465","3036750","KQ058275v1","938649","938919","70","2097816"
"JH378114","3207781","3208067","KQ053190v1","1299491","1299778","75","1908290"
"JH378114","3307520","3307803","KQ053631v1","8893553","8893834","73","5586033"
"JH378114","3965200","3965528","KQ058377v1","25815","26128","84","3939385"
"JH378114","4093259","4093561","KQ056256v1","5595","5892","76","4087664"
"JH378114","4611568","4611738","KQ058394v1","8507617","8507787","35","3896049"
"JH378114","4843385","4843644","KQ056920v1","1054358","1054613","71","3789027"
"JH378114","5167178","5167481","KQ054510v1","2056259","2056562","91","3110919"
"JH378114","5543462","5543764","KQ056044v1","1867924","1868223","60","3675538"
"JH378114","5685026","5685309","KQ054660v1","3418146","3418430","82","2266880"
"JH378114","5992526","5992759","KQ056035v1","1236900","1237146","79","4755626"
"JH378114","6144528","6144803","KQ055375v1","3672008","3672286","81","2472520"
"JH378114","6276895","6277177","KQ053343v1","1729289","1729583","69","4547606"
"JH378114","6357470","6357732","KQ056945v1","942729","942997","65","5414741"
"JH378114","6358174","6358454","KQ054069v1","955693","955974","65","5402481"
"JH378114","6400139","6400440","KQ058291v1","474599","474881","84","5925540"
"JH378114","6450623","6450922","KQ053082v1","1023453","1023747","57","5427170"
"JH378114","6468549","6468849","KQ058184v1","1505565","1505858","68","4962984"
"JH378114","6507359","6507596","KQ053763v1","3100356","3100582","59","3407003"
"JH378114","6596239","6596530","KQ057693v1","621833","622123","73","5974406"
"JH378114","6654572","6654711","KQ058257v1","652425","652556","36","6002147"
"JH378114","6678829","6679128","KQ058450v1","2960681","2960988","56","3718148"
"JH378114","6725085","6725213","KQ058283v1","128882","129005","35","6596203"
"JH378114","6750056","6750247","KQ056672v1","5452932","5453100","55","1297124"
"JH378114","6750284","6750367","KQ053168v1","1574388","1574479","24","5175896"
"JH378114","6874104","6874382","KQ053409v1","3716306","3716585","63","3157798"
"JH378114","6922684","6922961","KQ054124v1","2442155","2442433","61","4480529"
"JH378114","7003291","7003448","KQ053157v1","5478543","5478695","38","1524748"
"JH378114","7003739","7003888","KQ055384v1","843998","844147","34","6159741"
"JH378114","7007399","7007527","KQ056911v1","748463","748593","23","6258936"
"JH378114","7008838","7008941","KQ057909v1","11088334","11088435","15","4079496"
"JH378114","7144621","7144781","KQ052969v1","8430836","8430996","40","1286215"
"JH378114","7238304","7238617","KQ054102v1","737712","738028","70","6500592"
"JH378114","7752071","7752362","KQ058226v1","265143","265437","70","7486928"
"JH378114","7782849","7783000","KQ052970v1","9702416","9702545","38","1919567"
"JH378114","8391307","8391587","KQ057737v1","2756211","2756494","71","5635096"
"JH378114","8400902","8401178","KQ056423v1","1942313","1942589","68","6458589"
"JH378114","8436925","8437203","KQ055735v1","667472","667747","75","7769453"
"JH378114","8461077","8461376","KQ058512v1","329344","329634","75","8131733"
"JH378114","8466802","8466903","KQ055872v1","3969127","3969217","31","4497675"
"JH378114","8466994","8467089","KQ056494v1","3420476","3420570","32","5046518"
"JH378114","8467673","8467898","KQ054510v1","6090992","6091229","59","2376681"
"JH378114","8547955","8548194","KQ053310v1","2851403","2851646","65","5696552"
"JH378114","8581017","8581299","KQ055852v1","2060276","2060554","68","6520741"
"JH378114","8650373","8650657","KQ057764v1","906126","906404","65","7744247"
"JH378114","8653968","8654254","KQ052969v1","9553757","9554052","69","899789"
"JH378114","8830467","8830731","KQ056773v1","122800","123057","65","8707667"
"JH378114","9323659","9323867","KQ052968v1","10569063","10569270","55","1245404"
"JH378114","9350443","9350746","KQ057560v1","2450216","2450512","63","6900227"
"JH378114","9595289","9595600","KQ053554v1","2471177","2471484","68","7124112"
"JH378114","9667645","9667975","KQ058184v1","1505565","1505858","93","8162080"
"JH378114","9844573","9844656","KQ053387v1","3288543","3288619","27","6556030"
"JH378114","10271043","10271331","KQ055097v1","1884579","1884874","67","8386464"
"JH378114","10395377","10395588","KQ058505v1","3952082","3952290","48","6443295"
"JH378114","10430658","10430957","KQ058427v1","7552507","7552810","75","2878151"
"JH378114","10466045","10466343","KQ052970v1","21793990","21794288","75","11327945"
"JH378114","10632602","10632872","KQ058379v1","21379","21640","71","10611223"
"JH378114","10721551","10721606","KQ053260v1","77779","77831","13","10643772"
"JH378114","10722012","10722092","KQ052968v1","9483686","9483763","26","1238326"
"JH378114","10748698","10748935","KQ052971v1","6441372","6441626","53","4307326"
"JH378114","10827307","10827511","KQ055549v1","432046","432256","61","10395261"
"JH378114","11061583","11061890","KQ055457v1","8422337","8422638","73","2639246"
"JH378114","11527191","11527358","KQ055014v1","15960","16127","40","11511231"
"JH378114","11631622","11631916","KQ053948v1","168940","169229","70","11462682"
"JH378114","11717496","11717662","KQ052969v1","7161511","7161667","53","4555985"
"JH378114","11988939","11989035","KQ053763v1","508269","508363","17","11480670"
"JH378114","11989499","11989596","KQ055384v1","267995","268089","22","11721504"
"JH378114","12043863","12044151","KQ056148v1","4321952","4322238","72","7721911"
"JH378114","12045507","12045633","KQ055755v1","801738","801870","28","11243769"
"JH378114","12624207","12624517","KQ053299v1","4095914","4096215","68","8528293"
"JH378114","13512891","13513169","KQ057931v1","399684","399967","69","13113207"
"JH378114","13656938","13657228","KQ053093v1","3162517","3162806","68","10494421"
"JH378114","13715970","13716242","KQ056493v1","445937","446218","78","13270033"
"JH378114","13777680","13777959","KQ057213v1","1074642","1074915","74","12703038"
"JH378114","14074559","14074865","KQ058184v1","1505565","1505858","65","12568994"
"JH378114","14292981","14293232","KQ055457v1","1902633","1902878","62","12390348"
"JH378114","14611785","14612056","KQ054124v1","2742235","2742487","81","11869550"
"JH378114","15910070","15910193","KQ056527v1","169","285","28","15909901"
"JH378114","16123060","16123365","KQ053212v1","2900872","2901182","83","13222188"
"JH378114","16194117","16194370","KQ055364v1","1832819","1833067","70","14361298"
"JH378114","16527831","16528137","KQ053631v1","7288314","7288608","87","9239517"
"JH378114","16581997","16582237","KQ053190v1","3348295","3348533","66","13233702"
"JH378114","16773027","16773314","KQ053816v1","6856607","6856902","64","9916420"
"JH378114","17120634","17120765","KQ056147v1","1828259","1828388","24","15292375"
"JH378114","17348838","17349062","KQ056465v1","72608","72828","56","17276230"
"JH378114","17403178","17403486","KQ053299v1","4095914","4096215","71","13307264"
"JH378114","17500817","17501121","KQ053816v1","7464708","7465010","63","10036109"
"JH378114","18000592","18000827","KQ055872v1","14992593","14992828","77","3007999"
"JH378114","18321409","18321691","KQ053146v1","2819587","2819868","57","15501822"
"JH378114","18711648","18711732","KQ055036v1","4936704","4936788","22","13774944"
"JH378114","19485794","19486086","KQ053421v1","2664387","2664683","62","16821407"
"JH378114","19516670","19516912","KQ053894v1","688559","688830","73","18828111"
"JH378114","19577219","19577372","KQ054576v1","2685252","2685406","35","16891967"
"JH378114","19989102","19989240","KQ053654v1","4929533","4929667","22","15059569"
"JH378114","20032940","20033108","KQ056996v1","1524030","1524195","36","18508910"
"JH378114","20034909","20035216","KQ054213v1","780092","780393","66","19254817"
"JH378114","20052716","20052871","KQ058297v1","117665","117816","35","19935051"
"JH378114","20065222","20065334","KQ054868v1","26468","26576","30","20038754"
"JH378114","20065640","20065802","KQ056996v1","1524030","1524195","46","18541610"
"JH378114","20295196","20295501","KQ058561v1","4991819","4992113","82","15303377"
"JH378114","20305889","20306217","KQ053816v1","7464708","7465010","88","12841181"
"JH378114","20339055","20339343","KQ058427v1","4553509","4553777","72","15785546"
"JH378114","20598298","20598593","KQ055640v1","554057","554353","70","20044241"
"JH378114","20653471","20653647","KQ052970v1","15796964","15797136","43","4856507"
"JH378114","20663887","20664186","KQ056494v1","510992","511284","75","20152895"
"JH378114","20696498","20696699","KQ053081v1","1259521","1259727","45","19436977"
"JH378114","20697204","20697293","KQ057664v1","404566","404648","21","20292638"
"JH378114","20841288","20841584","KQ056643v1","431969","432259","62","20409319"
"JH378114","21053233","21053410","KQ056587v1","1313670","1313846","50","19739563"
"JH378114","21054303","21054599","KQ056672v1","3535300","3535593","64","17519003"
"JH378114","21265124","21265414","KQ058350v1","6740286","6740580","60","14524838"
"JH378114","22240370","22240654","KQ053631v1","9398334","9398603","71","12842036"
"JH378114","22600900","22601198","KQ058257v1","502287","502580","64","22098613"
"JH378114","22627203","22627489","KQ058184v1","1505565","1505858","84","21121638"
"JH378114","23178057","23178212","KQ057805v1","1792742","1792892","35","21385315"
"JH378114","23577302","23577418","KQ058405v1","1752866","1752986","25","21824436"
"JH378114","23577804","23577952","KQ054102v1","1263396","1263536","46","22314408"
"JH378114","24115981","24116294","KQ055119v1","3015978","3016290","69","21100003"
"JH378114","24628958","24629258","KQ056475v1","2179070","2179363","72","22449888"
"JH378114","26171749","26172109","KQ056254v1","843475","843787","117","25328274"
"JH378114","26386414","26386576","KQ052968v1","10427732","10427888","45","15958682"
"JH378114","26546299","26546559","KQ053838v1","3041304","3041566","86","23504995"
"JH378114","27824873","27825178","KQ053300v1","2877663","2877955","66","24947210"
"JH378114","27932671","27933026","KQ056673v1","1004724","1005090","97","26927947"
"JH378114","27957567","27957852","KQ053916v1","1741116","1741399","72","26216451"
"JH378114","28213880","28214013","KQ052968v1","9518967","9519104","34","18694913"
"JH378114","28933033","28933310","KQ058184v1","1608105","1608378","68","27324928"
"JH378114","29746435","29746727","KQ053398v1","2545768","2546067","54","27200667"
"JH378114","30096764","30097056","KQ054693v1","832788","833076","66","29263976"
"JH378114","30135115","30135325","KQ053609v1","2642121","2642332","48","27492994"
"JH378114","30170377","30170558","KQ053685v1","16639","16818","40","30153738"
"JH378114","30456728","30457022","KQ055479v1","1841725","1842025","77","28615003"
"JH378114","30923430","30923711","KQ056148v1","2419670","2419961","67","28503760"
"JH378114","31119155","31119521","KQ053082v1","4919260","4919576","113","26199895"
"JH378114","31751933","31752226","KQ057648v1","78808","79100","65","31673125"
"JH378114","32637133","32637389","KQ056672v1","4169432","4169691","66","28467701"
"JH378114","32650565","32650859","KQ053299v1","21869448","21869738","59","10781117"
"JH378114","33105810","33106088","KQ053004v1","2744572","2744859","74","30361238"
"JH378114","33117961","33118215","KQ058372v1","1188857","1189118","77","31929104"
"JH378114","33300745","33301019","KQ058316v1","4697990","4698273","61","28602755"
"JH378114","33447154","33447453","KQ057909v1","3829378","3829677","71","29617776"
"JH378114","33612821","33613104","KQ058324v1","623645","623935","61","32989176"
"JH378114","33617830","33618162","KQ058583v1","3101722","3102049","81","30516108"
"JH378114","33651790","33651949","KQ053299v1","11343198","11343362","44","22308592"
"JH378114","33661426","33661703","KQ058538v1","1444447","1444703","69","32216979"
"JH378114","33691874","33692023","KQ054179v1","2203336","2203492","33","31488538"
"JH378114","34045923","34046079","KQ053740v1","1071467","1071623","38","32974456"
"JH378114","34211113","34211263","KQ053288v1","28257","28404","33","34182856"
"JH378114","34786353","34786457","KQ055065v1","2126335","2126429","35","32660018"
"JH378114","34822618","34822909","KQ057648v1","78808","79100","72","34743810"
"JH378114","34942682","34942867","KQ057737v1","1188439","1188621","45","33754243"
"JH378114","35431280","35431406","KQ054682v1","1410308","1410435","29","34020972"
"JH378114","35628728","35628860","KQ056643v1","1491838","1491968","21","34136890"
"JH378114","35632555","35632865","KQ058094v1","7832529","7832815","74","27800026"
"JH378114","35788639","35788915","KQ054279v1","3033507","3033776","76","32755132"
"JH378114","36076983","36077248","KQ058184v1","1608105","1608378","80","34468878"
"JH378114","36199044","36199353","KQ053115v1","1118362","1118655","70","35080682"
"JH378114","36234610","36234949","KQ053520v1","3856867","3857169","97","32377743"
"JH378114","36289668","36289846","KQ055457v1","11733685","11733859","49","24555983"
"JH378114","36581955","36582165","KQ053332v1","362442","362653","59","36219513"
"JH378114","36594893","36595200","KQ053816v1","7464708","7465010","67","29130185"
"JH378114","36856790","36856839","KQ054279v1","852960","853011","9","36003830"
"JH378114","36890164","36890433","KQ055192v1","1201363","1201615","59","35688801"
"JH378114","36927032","36927316","KQ058317v1","5506620","5506904","61","31420412"
"JH378114","36965227","36965433","KQ052968v1","7572312","7572523","50","29392915"
"JH378114","36987006","36987285","KQ058248v1","1222370","1222655","56","35764636"
"JH378114","37078363","37078671","KQ058184v1","1505565","1505858","73","35572798"
"JH378114","37189888","37190184","KQ053894v1","1290632","1290924","64","35899256"
"JH378114","37438871","37439152","KQ053741v1","1492320","1492601","71","35946551"
"JH378114","37490908","37491221","KQ056587v1","17306365","17306676","63","20184543"
"JH378114","37494211","37494524","KQ056587v1","17306365","17306676","63","20187846"
"JH378114","37591298","37591446","KQ057118v1","1492016","1492164","26","36099282"
"JH378114","38445250","38445547","KQ054826v1","11793577","11793880","66","26651673"
"JH378114","39085913","39086229","KQ054932v1","9683849","9684160","72","29402064"
"JH378114","39108520","39108762","KQ057291v1","322948","323180","55","38785572"
"JH378114","39444707","39445010","KQ057911v1","428931","429228","61","39015776"
"JH378114","39607382","39607666","KQ053299v1","2118230","2118517","60","37489152"
"JH378114","39769001","39769253","KQ054069v1","928440","928688","56","38840561"
"JH378114","40025921","40026228","KQ058184v1","1505565","1505858","65","38520356"
"JH378114","40243427","40243519","KQ054932v1","4252125","4252214","18","35991302"
"JH378114","40468933","40469125","KQ058527v1","3280527","3280719","48","37188406"
"JH378114","40576899","40577200","KQ053398v1","2431232","2431537","72","38145667"
"JH378114","40591728","40592034","KQ054510v1","9729880","9730175","68","30861848"
"JH378114","40650782","40651080","KQ053398v1","2545768","2546067","59","38105014"
"JH378114","40666758","40667090","KQ055872v1","14673747","14674061","80","25993011"
"JH378114","40669735","40670067","KQ055872v1","14673747","14674061","80","25995988"
"JH378114","40687081","40687296","KQ054179v1","2728283","2728498","51","37958798"
"JH378114","40698609","40698889","KQ055808v1","339221","339505","54","40359388"
"JH378114","40740182","40740477","KQ057693v1","621833","622123","57","40118349"
"JH378114","40818624","40818894","KQ054510v1","1641980","1642248","60","39176644"
"JH378114","40831502","40831603","KQ054901v1","2051416","2051518","28","38780086"
"JH378114","40839781","40839917","KQ056279v1","71970","72109","29","40767811"
"JH378114","40905364","40905656","KQ054412v1","2490468","2490761","68","38414896"
"JH378114","40909805","40910085","KQ058295v1","94204","94487","65","40815601"
"JH378114","40916833","40917155","KQ054879v1","1971571","1971875","93","38945262"
"JH378114","40932761","40933065","KQ055457v1","2061137","2061448","68","38871624"
"JH378114","40951706","40952029","KQ053816v1","7464708","7465010","70","33486998"
"JH378114","41054347","41054643","KQ057004v1","1506143","1506432","69","39548204"
"JH378114","41388241","41388545","KQ054069v1","7687863","7688158","72","33700378"
"JH378114","41401735","41402036","KQ053147v1","791299","791577","69","40610436"
"JH378114","41566407","41566598","KQ053299v1","6349877","6350047","71","35216530"
"JH378114","41609683","41609890","KQ054058v1","1737833","1738018","57","39871850"
"JH378114","42012001","42012306","KQ053741v1","857230","857531","59","41154771"
"JH378114","42357050","42357334","KQ057290v1","1053741","1054027","58","41303309"
"JH378114","42457886","42458018","KQ055755v1","801738","801870","22","41656148"
"JH378114","42514268","42514398","KQ055755v1","1807261","1807395","26","40707007"
"JH378114","42561772","42561886","KQ058050v1","918290","918400","25","41643482"
"JH378114","42608603","42608861","KQ058538v1","1444447","1444703","60","41164156"
"JH378114","42941969","42942052","KQ052968v1","9483686","9483763","28","33458283"
"JH378114","43152408","43152705","KQ053631v1","9116387","9116675","70","34036021"
"JH378114","43592355","43592487","KQ056652v1","675563","675695","20","42916792"
"JH378114","43848789","43848888","KQ058294v1","8337497","8337593","26","35511292"
"JH378114","44041836","44042133","KQ058291v1","836930","837225","59","43204906"
"JH378114","44055549","44055835","KQ053465v1","167701","167983","60","43887848"
"JH378114","44089616","44089722","KQ056320v1","135977","136085","32","43953639"
"JH378114","44171533","44171708","KQ058394v1","13334171","13334328","54","30837362"
"JH378115","415955","416240","KQ054868v1","17131","17416","69","398824"
"JH378115","1139657","1139948","KQ053465v1","403029","403303","71","736628"
"JH378115","1196901","1197176","KQ057875v1","469535","469791","70","727366"
"JH378115","1267203","1267363","KQ056147v1","70626","70780","40","1196577"
"JH378115","1419664","1419957","KQ053631v1","9116387","9116675","66","7696723"
"JH378115","1499599","1499894","KQ058184v1","1505565","1505858","73","5966"
"JH378115","1534878","1535188","KQ058607v1","429760","430048","83","1105118"
"JH378115","1556839","1557126","KQ054356v1","1600089","1600380","72","43250"
"JH378115","1643893","1644206","KQ055872v1","6063044","6063339","76","4419151"
"JH378115","1688626","1688909","KQ056331v1","106636","106916","71","1581990"
"JH378115","1838014","1838332","KQ053115v1","2408608","2408907","72","570594"
"JH378115","2194301","2194652","KQ053409v1","5569056","5569389","109","3374755"
"JH378115","2350383","2350650","KQ058394v1","3915274","3915538","61","1564891"
"JH378115","2546993","2547248","KQ052971v1","6441372","6441626","79","3894379"
"JH378115","3112079","3112226","KQ054412v1","2185013","2185160","33","927066"
"JH378115","3115911","3116023","KQ054068v1","6466552","6466668","31","3350641"
"JH378115","3142654","3142933","KQ052968v1","13260777","13261056","67","10118123"
"JH378115","3155654","3155786","KQ053300v1","3146249","3146389","30","9405"
"JH378115","3156848","3157152","KQ053816v1","7464708","7465010","66","4307860"
"JH378115","3376220","3376304","KQ053774v1","1983133","1983216","12","1393087"
"JH378115","3388692","3389016","KQ054179v1","3693372","3693688","85","304680"
"JH378115","3464641","3464775","KQ058094v1","3687022","3687155","21","222381"
"JH378115","3631111","3631474","KQ058394v1","13308963","13309304","127","9677852"
"JH378115","3645593","3645885","KQ055787v1","1064992","1065293","69","2580601"
"JH378115","3720314","3720560","KQ056147v1","3491603","3491838","67","228711"
"JH378115","3731938","3732240","KQ058474v1","218695","218994","67","3513243"
"JH378115","3788303","3788592","KQ057693v1","249719","250017","72","3538584"
"JH378115","3813458","3813523","KQ058394v1","4958081","4958139","19","1144623"
"JH378115","3814400","3814552","KQ054180v1","70685","70834","34","3743715"
"JH378115","3817861","3818143","KQ053278v1","2499478","2499766","77","1318383"
"JH378115","3901207","3901495","KQ053916v1","1741116","1741399","80","2160091"
"JH378115","4010935","4011078","KQ053082v1","6937319","6937463","40","2926384"
"JH378115","4062114","4062265","KQ054378v1","157932","158074","35","3904182"
"JH378115","4161914","4162079","KQ053476v1","4635198","4635357","45","473284"
"JH378115","4163912","4164193","KQ053631v1","7288314","7288608","66","3124402"
"JH378115","4221406","4221544","KQ053631v1","8603317","8603457","26","4381911"
"JH378115","4282108","4282364","KQ058328v1","2975933","2976189","63","1306175"
"JH378115","4320627","4320903","KQ053838v1","3013088","3013374","65","1307539"
"JH378115","4332734","4332869","KQ053354v1","702320","702452","28","3630414"
"JH378115","4405742","4405919","KQ053609v1","1884265","1884430","42","2521477"
"JH378115","4406247","4406367","KQ056724v1","241913","242037","29","4164334"
"JH378115","4439250","4439364","KQ058383v1","8974295","8974399","28","4535045"
"JH378115","4515486","4515587","KQ055024v1","329599","329697","26","4185887"
"JH378115","4557457","4557721","KQ058275v1","938649","938919","57","3618808"
"JH378115","4617230","4617473","KQ057702v1","1579642","1579892","68","3037588"
"JH378115","4835490","4835758","KQ056368v1","571844","572113","73","4263646"
"JH378115","5011578","5011878","KQ058328v1","6293951","6294242","71","1282373"
"JH378115","5129072","5129342","KQ053894v1","688559","688830","61","4440513"
"JH378115","5431294","5431614","KQ052968v1","7084626","7084953","80","1653332"
"JH378115","5727616","5727915","KQ058377v1","541031","541325","72","5186585"
"JH378115","5936931","5937090","KQ055425v1","1445594","1445758","39","4491337"
"JH378115","5990729","5991023","KQ058184v1","1505565","1505858","60","4485164"
"JH378115","6076360","6076505","KQ054510v1","8179279","8179421","37","2102919"
"JH378115","6268350","6268611","KQ058173v1","992259","992524","67","5276091"
"JH378115","6378082","6378384","KQ052970v1","6659487","6659775","76","281405"
"JH378115","6480370","6480528","KQ054533v1","1027813","1027974","42","5452557"
"JH378115","6552703","6552996","KQ055036v1","4176745","4177042","76","2375958"
"JH378115","6773193","6773340","KQ053288v1","28257","28404","37","6744936"
"JH378115","6782247","6782433","KQ056475v1","396846","397033","61","6385401"
"JH378115","6854393","6854654","KQ058321v1","21060","21321","66","6833333"
"JH378115","6858588","6858871","KQ056147v1","1747366","1747648","58","5111222"
"JH378115","6968205","6968491","KQ056331v1","106636","106916","70","6861569"
"JH378115","7235499","7235789","KQ057693v1","117172","117472","67","7118327"
"JH378115","7312808","7313113","KQ058184v1","1505565","1505858","69","5807243"
"JH378115","7498895","7499270","KQ058183v1","2217470","2217853","117","5281425"
"JH378115","7531551","7531848","KQ058474v1","218695","218994","65","7312856"
"JH378115","7547028","7547148","KQ054671v1","1335497","1335616","24","6211531"
"JH378115","7547659","7547801","KQ058389v1","1559421","1559572","40","5988238"
"JH378115","7596222","7596357","KQ053190v1","4627206","4627347","32","2969016"
"JH378115","7669010","7669285","KQ053409v1","3716306","3716585","71","3952704"
"JH378115","7750543","7750817","KQ058484v1","1229388","1229668","60","6521155"
"JH378115","7800678","7800985","KQ052968v1","5470311","5470611","69","2330367"
"JH378115","7843818","7844111","KQ055957v1","364218","364491","76","7479600"
"JH378115","7848085","7848382","KQ053331v1","97381","97652","87","7750704"
"JH378115","7853453","7853628","KQ057151v1","1284903","1285079","53","6568550"
"JH378115","7954856","7955074","KQ058328v1","4557655","4557870","52","3397201"
"JH378115","7978663","7978955","KQ052971v1","1111058","1111352","65","6867605"
"JH378115","8204155","8204438","KQ052971v1","1065774","1066042","81","7138381"
"JH378115","8349414","8349735","KQ058272v1","5344193","5344507","78","3005221"
"JH378115","8469117","8469366","KQ056404v1","638131","638387","68","7830986"
"JH378115","8888493","8888656","KQ058583v1","2039372","2039538","46","6849121"
"JH378115","9078005","9078244","KQ058539v1","875694","875928","55","8202311"
"JH378115","9228162","9228472","KQ054213v1","780092","780393","61","8448070"
"JH378115","10006945","10007259","KQ054713v1","3248327","3248628","85","6758618"
"JH378115","10887626","10887928","KQ055044v1","89244","89545","72","10798382"
"JH378115","11288619","11288877","KQ057821v1","37392","37663","72","11251227"
"JH378115","11688072","11688165","KQ053299v1","14559361","14559465","29","2871289"
"JH378115","11892622","11892881","KQ058470v1","464724","464997","68","11427898"
"JH378115","12022898","12023162","KQ053191v1","1874915","1875171","68","10147983"
"JH378115","12093168","12093442","KQ053432v1","3710952","3711220","74","8382216"
"JH378115","12302218","12302477","KQ058427v1","4553509","4553777","74","7748709"
"JH378115","13836806","13837117","KQ054804v1","964015","964313","75","12872791"
"JH378115","14047430","14047666","KQ058542v1","550732","550973","57","13496698"
"JH378115","14103503","14103797","KQ058184v1","1505565","1505858","73","12597938"
"JH378115","14124102","14124401","KQ055247v1","216427","216708","80","13907675"
"JH378115","14154703","14154950","KQ053432v1","2483909","2484156","64","11670794"
"JH378115","14357906","14358168","KQ053795v1","380044","380305","58","13977862"
"JH378115","14423460","14423744","KQ053157v1","3558863","3559137","77","10864597"
"JH378115","14561930","14562250","KQ056148v1","430759","431072","80","14131171"
"JH378115","14639226","14639503","KQ055745v1","631144","631414","62","14008082"
"JH378115","14676781","14677065","KQ055140v1","2748912","2749194","64","11927869"
"JH378115","14802186","14802487","KQ058372v1","1134128","1134432","72","13668058"
"JH378115","14814920","14815234","KQ058184v1","1505565","1505858","65","13309355"
"JH378115","14972738","14973015","KQ053223v1","590063","590338","64","14382675"
"JH378115","15003749","15003952","KQ058462v1","452919","453117","52","14550830"
"JH378115","15062300","15062602","KQ058266v1","898592","898893","60","14163708"
"JH378115","15109513","15109552","KQ057909v1","13231474","13231525","18","1878039"
"JH378115","15163805","15164012","KQ054533v1","1766391","1766592","64","13397414"
"JH378115","15238250","15238325","KQ053299v1","3013663","3013729","21","12224587"
"JH378115","15418538","15418635","KQ053299v1","10212827","10212927","30","5205711"
"JH378115","15422787","15423079","KQ058184v1","1505565","1505858","73","13917222"
"JH378115","15501582","15501866","KQ054704v1","985921","986190","72","14515661"
"JH378115","15613202","15613507","KQ053082v1","1476670","1476954","81","14136532"
"JH378115","15758682","15758983","KQ055364v1","2160874","2161165","72","13597808"
"JH378115","15948248","15948353","KQ053256v1","5132292","5132396","22","10815956"
"JH378115","15963883","15964026","KQ053631v1","8603317","8603457","28","7360566"
"JH378115","16443650","16443914","KQ055192v1","1201363","1201615","58","15242287"
"JH378115","16519402","16519526","KQ053432v1","3920706","3920835","27","12598696"
"JH378115","16519834","16519991","KQ058483v1","5279934","5280083","44","11239900"
"JH378115","16923723","16924021","KQ053059v1","2387120","2387415","65","14536603"
"JH378115","16971146","16971430","KQ053409v1","3716306","3716585","65","13254840"
"JH378115","17123024","17123184","KQ053135v1","3925667","3925819","37","13197357"
"JH378115","17548772","17549077","KQ053816v1","7464708","7465010","76","10084064"
"JH378115","17596592","17596770","KQ053498v1","3849226","3849393","49","13747366"
"JH378115","17625016","17625312","KQ058299v1","1080259","1080541","75","16544757"
"JH378115","17696966","17697115","KQ055893v1","1958950","1959098","34","15738016"
"JH378115","17803078","17803370","KQ053959v1","2268166","2268455","70","15534912"
"JH378115","18166776","18167051","KQ053631v1","9398334","9398603","67","8768442"
"JH378115","18245312","18245600","KQ054401v1","2629005","2629296","71","15616307"
"JH378115","18307857","18308149","KQ054932v1","10830322","10830609","73","7477535"
"JH378115","18321114","18321427","KQ054932v1","2708037","2708346","64","15613077"
"JH378115","18488099","18488387","KQ058317v1","5506620","5506904","59","12981479"
"JH378115","18526134","18526423","KQ053093v1","3162517","3162806","81","15363617"
"JH378115","18621045","18621290","KQ056493v1","2734287","2734533","81","15886758"
"JH378115","18628386","18628679","KQ053115v1","1118362","1118655","67","17510024"
"JH378115","18693418","18693720","KQ053476v1","1823610","1823912","74","16869808"
"JH378115","18741832","18741908","KQ058325v1","894348","894422","14","17847484"
"JH378115","18768548","18768784","KQ054224v1","1168104","1168343","65","17600444"
"JH378115","18831547","18831835","KQ057560v1","2450216","2450512","67","16381331"
"JH378115","18846789","18847072","KQ054069v1","3294165","3294452","64","15552624"
"JH378115","18857666","18857967","KQ053332v1","771022","771332","84","18086644"
"JH378115","18888276","18888604","KQ053299v1","6038380","6038679","92","12849896"
"JH378115","19326822","19326987","KQ056996v1","1524030","1524195","36","17802792"
"JH378115","19343550","19343841","KQ053190v1","5495992","5496283","66","13847558"
"JH378115","19361108","19361404","KQ056147v1","1064032","1064323","66","18297076"
"JH378115","19370753","19371035","KQ056643v1","159950","160228","68","19210803"
"JH378115","19477904","19478033","KQ056147v1","1828259","1828388","26","17649645"
"JH378115","20002148","20002453","KQ053631v1","6119015","6119311","75","13883133"
"JH378115","21200585","21200736","KQ057034v1","3721608","3721761","36","17478977"
"JH378115","21210374","21210552","KQ053179v1","1735404","1735576","33","19474970"
"JH378115","21242079","21242329","KQ055745v1","1992718","1992978","60","19249361"
"JH378115","21487880","21488033","KQ057737v1","3826261","3826415","33","17661619"
"JH378115","21523638","21523835","KQ055892v1","1173","1363","60","21522465"
"JH378115","21545640","21545715","KQ055479v1","2280775","2280852","24","19264865"
"JH378115","21554767","21555068","KQ054693v1","832788","833076","82","20721979"
"JH378115","21590408","21590702","KQ058389v1","2329886","2330179","79","19260522"
"JH378115","21602760","21603023","KQ055375v1","3213142","3213415","65","18389618"
"JH378115","21652042","21652195","KQ058345v1","136254","136406","37","21515788"
"JH378115","21712499","21712711","KQ057737v1","1779203","1779413","58","19933296"
"JH378115","21796392","21796702","KQ055852v1","1231373","1231668","68","20565019"
"JH378115","21807513","21807791","KQ058561v1","4225175","4225466","69","17582338"
"JH378115","21889264","21889548","KQ057380v1","1672785","1673058","73","20216479"
"JH378115","21958258","21958573","KQ053816v1","7464708","7465010","70","14493550"
"JH378115","21974954","21975233","KQ058625v1","340677","340961","63","21634277"
"JH378115","22040361","22040618","KQ057345v1","1938824","1939073","67","20101537"
"JH378115","22110579","22110881","KQ054400v1","354368","354668","80","21756211"
"JH378115","22136482","22136796","KQ055119v1","2003090","2003396","79","20133392"
"JH378115","22202752","22203085","KQ058359v1","574163","574471","80","21628589"
"JH378115","22376351","22376624","KQ053785v1","2248190","2248465","76","20128161"
"JH378115","22535038","22535296","KQ053409v1","1917567","1917823","63","20617471"
"JH378115","22628072","22628372","KQ057290v1","3090594","3090898","66","19537478"
"JH378115","22663642","22663759","KQ056035v1","296324","296444","25","22367318"
"JH378115","22748465","22748770","KQ055119v1","3025572","3025880","65","19722893"
"JH378115","22826035","22826322","KQ054510v1","8555095","8555387","62","14270940"
"JH378115","22929624","22929766","KQ058509v1","50870","51012","23","22878754"
"JH378115","23044511","23044644","KQ058483v1","5373223","5373356","31","17671288"
"JH378115","23195030","23195332","KQ058606v1","232956","233258","66","22962074"
"JH378115","23328194","23328494","KQ056475v1","2179070","2179363","63","21149124"
"JH378115","23345232","23345381","KQ057875v1","315120","315258","34","23030112"
"JH378115","23345913","23346212","KQ055852v1","1231373","1231668","65","22114540"
"JH378115","23370867","23371141","KQ054704v1","985921","986190","70","22384946"
"JH378115","23472839","23472992","KQ056148v1","7050287","7050441","35","16422552"
"JH378115","23512298","23512560","KQ055662v1","4683524","4683789","60","18828774"
"JH378115","23621439","23621694","KQ053146v1","1086333","1086558","78","22535106"
"JH378115","24199775","24200011","KQ053795v1","121444","121694","70","24078331"
"JH378115","24724139","24724226","KQ053971v1","4775120","4775210","23","19949019"
"JH378115","24724220","24724356","KQ055214v1","1020885","1021021","37","23703335"
"JH378115","24856400","24856688","KQ058394v1","5421387","5421681","84","19435013"
"JH378115","24880999","24881277","KQ057397v1","335976","336255","63","24545023"
"JH378115","25213835","25214086","ABDC02037708v1","6177","6423","77","25207658"
"JH378115","25239358","25239636","KQ057909v1","3737795","3738073","67","21501563"
"JH378115","25245957","25246261","KQ052968v1","5712560","5712870","66","19533397"
"JH378115","25516775","25517086","KQ053816v1","7464708","7465010","65","18052067"
"JH378115","25524508","25524801","KQ053082v1","1085491","1085778","83","24439017"
"JH378115","25627515","25627671","KQ054124v1","4733901","4734054","34","20893614"
"JH378115","25695532","25695647","KQ053026v1","2376723","2376841","24","23318809"
"JH378115","25706331","25706627","KQ055457v1","8436987","8437281","71","17269344"
"JH378115","25738803","25739028","KQ054510v1","6090992","6091229","60","19647811"
"JH378115","25763467","25763651","KQ054776v1","1314982","1315182","52","24448485"
"JH378115","25880073","25880393","KQ056475v1","5519037","5519344","70","20361036"
"JH378115","26089345","26089656","KQ058184v1","1505565","1505858","72","24583780"
"JH378115","26361167","26361476","KQ053476v1","4429901","4430211","72","21931266"
"JH378115","26491047","26491145","KQ054724v1","2800695","2800789","27","23690352"
"JH378115","26622728","26622922","KQ052969v1","8528994","8529192","52","18093734"
"JH378115","26666121","26666418","KQ057693v1","117172","117472","62","26548949"
"JH378115","26997407","26997540","KQ056147v1","1828259","1828388","32","25169148"
"JH378115","27065967","27066254","KQ054660v1","2994204","2994490","65","24071763"
"JH378115","27112665","27112882","KQ053696v1","492750","492962","63","26619915"
"JH378115","27147716","27148013","KQ058184v1","1505565","1505858","71","25642151"
"JH378115","27186886","27187192","KQ053398v1","2431232","2431537","62","24755654"
"JH378115","27229729","27230032","KQ058550v1","3068705","3069008","60","24161024"
"JH378115","27249078","27249237","KQ055406v1","3895","4043","34","27245183"
"JH378115","27253428","27253730","KQ058184v1","1505565","1505858","67","25747863"
"JH378115","27291096","27291390","KQ053816v1","7464708","7465010","64","19826388"
"JH378115","27314371","27314645","KQ056673v1","983726","984000","67","26330645"
"JH378115","27324769","27325066","KQ055629v1","4831189","4831479","68","22493580"
"JH378115","27326921","27327223","KQ056493v1","1483561","1483863","67","25843360"
"JH378115","27387735","27388002","KQ058094v1","4200652","4200934","77","23187083"
"JH378115","27395412","27395718","KQ054191v1","3583730","3584032","66","23811682"
"JH378115","27454931","27455231","KQ053115v1","3485337","3485650","69","23969594"
"JH378115","27491344","27491505","KQ057805v1","1792742","1792892","41","25698602"
"JH378115","27505982","27506230","KQ058383v1","8692134","8692359","61","18813848"
"JH378115","27540026","27540171","KQ053026v1","3592158","3592294","38","23947868"
"JH378115","27563538","27563850","KQ053816v1","7464708","7465010","74","20098830"
"JH378115","27653673","27653958","KQ057290v1","1053741","1054027","63","26599932"
"JH378115","28240541","28240807","KQ053059v1","2135970","2136233","73","26104571"
"JH378115","28416568","28416859","KQ056234v1","2521120","2521411","73","25895448"
"JH378115","28437127","28437392","KQ053059v1","2135970","2136233","71","26301157"
"JH378115","28669917","28670168","KQ056432v1","1067354","1067600","68","27602563"
"JH378115","28720434","28720686","KQ057909v1","4085960","4086201","77","24634474"
"JH378115","28827189","28827309","KQ057788v1","949735","949853","35","27877454"
"JH378115","29041665","29041916","KQ057290v1","2469746","2470009","69","26571919"
"JH378115","29072587","29072879","KQ053827v1","4198964","4199247","71","24873623"
"JH378115","29111242","29111375","KQ055298v1","1575436","1575566","22","27535806"
"JH378115","29133920","29134098","KQ053740v1","1980068","1980251","55","27153852"
"JH378115","29162281","29162587","KQ058184v1","1505565","1505858","74","27656716"
"JH378115","29372412","29372708","KQ056672v1","3535300","3535593","70","25837112"
"JH378115","29378870","29379163","KQ058226v1","265143","265437","68","29113727"
"JH378115","30668638","30668722","KQ053234v1","1555252","1555344","32","29113386"
"JH378115","30668860","30669081","KQ054069v1","159011","159235","46","30509849"
"JH378115","30681029","30681333","KQ052981v1","1198440","1198752","72","29482589"
"JH378115","30762570","30762881","KQ055987v1","77625","77928","70","30684945"
"JH378115","30796470","30796714","KQ053191v1","1874915","1875171","71","28921555"
"JH378115","30815899","30816161","KQ053795v1","370451","370712","57","30445448"
"JH378115","30840538","30840679","KQ054069v1","2479321","2479456","31","28361217"
"JH378115","30870562","30870868","KQ053554v1","2471177","2471484","63","28399385"
"JH378115","30983442","30983645","KQ058548v1","210080","210266","70","30773362"
"JH378115","30993194","30993310","KQ053070v1","1407707","1407821","31","29585487"
"JH378115","31087460","31087680","KQ058550v1","4156400","4156623","64","26931060"
"JH378115","31159661","31159953","KQ057737v1","3274981","3275269","73","27884680"
"JH378115","31206178","31206477","KQ054191v1","3583730","3584032","78","27622448"
"JH378115","31208629","31208764","KQ053310v1","890644","890800","39","30317985"
"JH378115","31238872","31239164","KQ053948v1","168940","169229","61","31069932"
"JH378115","31274846","31275105","KQ053191v1","1874915","1875171","68","29399931"
"JH378115","31388071","31388353","KQ058249v1","184192","184468","63","31203879"
"JH378115","31510428","31510684","KQ055745v1","631144","631414","67","30879284"
"JH378115","31532790","31533080","KQ056147v1","1064032","1064323","60","30468758"
"JH378115","31548994","31549229","KQ056773v1","122800","123057","64","31426194"
"JH378115","31550507","31550819","KQ054804v1","1152481","1152777","77","30398026"
"JH378115","31577955","31578213","KQ053752v1","35796","36072","74","31542159"
"JH378115","31578979","31579243","KQ053409v1","2092356","2092619","68","29486623"
"JH378115","31762266","31762550","KQ052968v1","14043756","14044036","68","17718510"
"JH378115","31820645","31820922","KQ052968v1","14043756","14044036","69","17776889"
"JH378115","31822677","31822961","KQ056331v1","106636","106916","65","31716041"
"JH378115","31962168","31962458","KQ055852v1","1231373","1231668","65","30730795"
"JH378115","32143397","32143542","KQ056493v1","3853002","3853159","34","28290395"
"JH378115","32346064","32346351","KQ056643v1","159950","160228","57","32186114"
"JH378115","32453855","32454152","KQ053816v1","7464708","7465010","56","24989147"
"JH378115","32492214","32492515","KQ054704v1","215433","215738","69","32276781"
"JH378115","32757500","32757787","KQ056707v1","1365575","1365867","61","31391925"
"JH378115","32898122","32898411","KQ058184v1","1505565","1505858","68","31392557"
"JH378115","33077645","33077851","KQ057290v1","4745481","4745684","41","28332164"
"JH378115","33149836","33149983","KQ058305v1","4820083","4820218","38","28329753"
"JH378115","33271698","33271833","KQ058094v1","3687022","3687155","21","29584676"
"JH378115","33308195","33308361","KQ056996v1","1524030","1524195","36","31784165"
"JH378115","33420223","33420500","KQ055173v1","248885","249169","68","33171338"
"JH378115","33485726","33485942","KQ053696v1","4325554","4325770","56","29160172"
"JH378115","33534623","33534906","KQ053554v1","1157184","1157483","70","32377439"
"JH378115","33600275","33600586","KQ058004v1","2495177","2495491","65","31105098"
"JH378115","33713895","33714056","KQ053740v1","1071467","1071623","34","32642428"
"JH378115","33944405","33944709","KQ054401v1","2629005","2629296","71","31315400"
"JH378115","33951865","33952078","KQ056996v1","148346","148555","51","33803519"
"JH378115","33954458","33954799","KQ058413v1","565473","565785","90","33388985"
"JH378115","34132579","34132828","KQ058505v1","2479512","2479769","66","31653067"
"JH378115","34285070","34285354","KQ058625v1","340677","340961","70","33944393"
"JH378115","34457569","34457860","KQ055610v1","180843","181127","73","34276726"
"JH378115","34554687","34554965","KQ055097v1","1704793","1705067","57","32849894"
"JH378115","34663300","34663598","KQ054954v1","3921224","3921526","62","30742076"
"JH378115","34890440","34890717","KQ052969v1","10404297","10404571","64","24486143"
"JH378115","35458864","35459086","KQ053004v1","2616751","2616958","55","32842113"
"JH378115","35461337","35461459","KQ054932v1","7772773","7772892","26","27688564"
"JH378115","35509052","35509188","KQ053115v1","1650505","1650644","20","33858547"
"JH378115","35558262","35558351","KQ058484v1","214024","214108","23","35344238"
"JH378115","35643954","35644092","KQ057397v1","624142","624276","27","35019812"
"JH378115","35650248","35650431","KQ058462v1","452919","453117","46","35197329"
"JH378115","35838527","35838829","KQ054510v1","2056259","2056562","74","33782268"
"JH378115","35855609","35855742","KQ054279v1","76889","77022","28","35778720"
"JH378115","36986455","36986734","KQ057737v1","3083543","3083824","81","33902912"
"JH378115","37059438","37059723","KQ054510v1","5210888","5211157","67","31848550"
"JH378115","37229939","37230225","KQ052982v1","1103561","1103855","66","36126378"
"JH378115","38303350","38303507","KQ058350v1","4411482","4411631","43","33891868"
"JH378115","38428546","38428833","KQ054412v1","2490468","2490761","70","35938078"
"JH378115","38544879","38545152","KQ055247v1","216427","216708","71","38328452"
"JH378115","38582097","38582398","KQ052984v1","105454","105757","65","38476643"
"JH378115","39409131","39409432","KQ058328v1","6293951","6294242","68","33115180"
"JH378115","40182780","40182925","KQ053146v1","2315136","2315281","31","37867644"
"JH378115","41385740","41386015","KQ058266v1","1113469","1113760","74","40272271"
"JH378115","41809591","41809860","KQ056855v1","3557407","3557680","62","38252184"
"JH378115","42102941","42103220","KQ053299v1","5560469","5560751","84","36542472"
"JH378115","42326243","42326377","KQ055140v1","2336730","2336863","23","39989513"
"JH378115","42716489","42716804","KQ058383v1","6350835","6351150","82","36365654"
"JH378115","42757086","42757405","KQ053190v1","6566399","6566709","72","36190687"
"JH378115","42876925","42877187","KQ058427v1","4553509","4553777","82","38323416"
"JH378115","43143407","43143579","KQ055014v1","15960","16127","46","43127447"
"JH378115","43192899","43193220","KQ057423v1","52243","52545","81","43140656"
"JH378115","43441574","43441870","KQ058483v1","6902132","6902428","70","36539442"
"JH378116","524140","524427","KQ058094v1","7832529","7832815","60","7308389"
"JH378116","47612","47744","KQ057290v1","2220265","2220402","34","2172653"
"JH378116","266873","267039","KQ054533v1","1027813","1027974","40","760940"
"JH378116","512191","512494","KQ053044v1","405596","405892","86","106595"
"JH378116","539316","539588","KQ052969v1","11182978","11183250","64","10643662"
"JH378116","704017","704114","KQ058483v1","2767088","2767193","28","2063071"
"JH378116","711734","711822","KQ054456v1","5057079","5057175","19","4345345"
"JH378116","840225","840408","KQ054725v1","735942","736116","43","104283"
"JH378116","889627","889755","KQ058366v1","490828","490957","30","398799"
"JH378116","1280956","1281076","KQ056035v1","296324","296444","29","984632"
"JH378116","1314265","1314557","KQ053959v1","2839561","2839850","63","1525296"
"JH378116","1551514","1551803","KQ053520v1","3856867","3857169","68","2305353"
"JH378116","1776621","1776888","KQ054857v1","1057701","1057989","70","718920"
"JH378116","2196909","2197127","KQ052969v1","8533892","8534095","52","6336983"
"JH378116","2464781","2465089","KQ053774v1","3575898","3576198","72","1111117"
"JH378116","3043293","3043587","KQ058257v1","502287","502580","86","2541006"
"JH378116","3312324","3312623","KQ053115v1","1118362","1118655","76","2193962"
"JH378116","3936438","3936716","KQ053146v1","2819587","2819868","66","1116851"
"JH378116","4503452","4503605","KQ053299v1","5209668","5209811","47","706216"
"JH378116","4503613","4503885","KQ055065v1","1117201","1117481","74","3386412"
"JH378116","4708049","4708334","KQ054693v1","832788","833076","60","3875261"
"JH378116","4826650","4826944","KQ053948v1","168940","169229","70","4657710"
"JH378116","4875656","4875969","KQ053752v1","4034148","4034439","85","841508"
"JH378116","4970301","4970436","KQ053948v1","2198512","2198648","28","2771789"
"JH378116","5215925","5216217","KQ054693v1","832788","833076","59","4383137"
"JH378116","5420659","5420960","KQ055457v1","2061137","2061448","73","3359522"
"JH378116","5422383","5422633","KQ053948v1","1892815","1893053","77","3529568"
"JH378116","5500763","5501060","KQ053948v1","168940","169229","65","5331823"
"JH378116","5754622","5754906","KQ053554v1","1105373","1105659","63","4649249"
"JH378116","6131862","6132118","KQ056568v1","971857","972102","64","5160005"
"JH378116","6510251","6510458","KQ056855v1","3783104","3783319","66","2727147"
"JH378116","6599778","6600096","KQ056587v1","17306365","17306676","81","10706587"
"JH378116","7254884","7255143","KQ058594v1","2202249","2202489","83","5052635"
"JH378116","7314478","7314781","KQ053960v1","70067","70362","81","7244411"
"JH378116","7320782","7320928","KQ052970v1","12418764","12418905","44","5097982"
"JH378116","7530713","7530858","KQ054235v1","823003","823145","40","6707710"
"JH378116","7660931","7661235","KQ056672v1","3535300","3535593","87","4125631"
"JH378116","7875640","7875914","KQ053191v1","1874915","1875171","75","6000725"
"JH378116","8140638","8140921","KQ053654v1","4803183","4803475","76","3337455"
"JH378116","8153398","8153722","KQ058585v1","580456","580763","86","7572942"
"JH378116","8460089","8460243","KQ053332v1","2039644","2039799","35","6420445"
"JH378116","8974893","8975204","KQ053025v1","49730","50045","77","8925163"
"JH378116","9014653","9014792","KQ053026v1","2906402","2906536","39","6108251"
"JH378116","9561802","9562048","KQ055735v1","1032075","1032317","57","8529727"
"JH378116","9601783","9602054","KQ055309v1","1596833","1597106","74","8004950"
"JH378116","9707854","9708122","KQ058184v1","1608105","1608378","77","8099749"
"JH378116","9856236","9856516","KQ058184v1","1505565","1505858","66","8350671"
"JH378116","10164251","10164393","KQ053157v1","4288391","4288538","31","5875860"
"JH378116","10221720","10222005","KQ054124v1","2442155","2442433","71","7779565"
"JH378116","10343565","10343751","KQ054510v1","1448917","1449101","44","8894648"
"JH378116","10394239","10394333","KQ056613v1","1941571","1941673","29","8452668"
"JH378116","10401641","10401781","KQ058281v1","1664150","1664292","30","8737491"
"JH378116","10490545","10490833","KQ056773v1","168010","168288","63","10322535"
"JH378116","10533899","10534082","KQ053966v1","301124","301319","53","10232775"
"JH378116","10547927","10548209","KQ053299v1","3284099","3284383","77","7263828"
"JH378116","10615247","10615406","KQ053223v1","2815634","2815800","37","7799613"
"JH378116","10617548","10617712","KQ058328v1","2236694","2236854","48","8380854"
"JH378116","10630639","10630929","KQ058353v1","1264780","1265071","72","9365859"
"JH378116","10642474","10642669","KQ053849v1","1126392","1126589","53","9516082"
"JH378116","10667964","10668262","KQ054826v1","11793577","11793880","74","1125613"
"JH378116","10670089","10670264","KQ052969v1","7479624","7479813","59","3190465"
"JH378116","10683402","10683697","KQ054510v1","8166225","8166512","69","2517177"
"JH378116","10798116","10798390","KQ052969v1","11182978","11183250","66","384862"
"JH378116","11150760","11150856","KQ052970v1","3193692","3193782","26","7957068"
"JH378116","11166455","11166687","KQ055352v1","10219546","10219792","82","946909"
"JH378116","11415390","11415681","KQ053288v1","2218996","2219287","64","9196394"
"JH378116","11459891","11460189","KQ053631v1","6588404","6588705","64","4871487"
"JH378116","11803511","11803821","KQ054400v1","4609733","4610042","70","7193778"
"JH378116","12110481","12110622","KQ056663v1","464182","464321","32","11646299"
"JH378116","12195846","12196081","KQ057909v1","12196801","12197037","53","955"
"JH378116","12415065","12415361","KQ055872v1","1927794","1928087","76","10487271"
"JH378116","12446666","12446863","KQ058183v1","3187602","3187791","52","9259064"
"JH378116","12608760","12609051","KQ053948v1","168940","169229","69","12439820"
"JH378116","12820169","12820303","KQ055192v1","1759958","1760089","25","11060211"
"JH378116","13149054","13149335","KQ058283v1","3525175","3525450","76","9623879"
"JH378116","13842903","13843042","KQ054466v1","1866785","1866925","32","11976118"
"JH378116","13898752","13899039","KQ053982v1","8167565","8167847","65","5731187"
"JH378116","14154561","14154861","KQ055872v1","1934073","1934378","67","12220488"
"JH378116","14338251","14338542","KQ053146v1","2819587","2819868","78","11518664"
"JH378116","14383562","14383813","KQ058503v1","123813","124064","62","14259749"
"JH378116","14499718","14499853","KQ054533v1","1111592","1111720","26","13388126"
"JH378116","15330447","15330735","KQ058305v1","3899980","3900272","65","11430467"
"JH378116","15763162","15763420","KQ053115v1","2180745","2181002","69","13582417"
"JH378116","16324671","16324859","KQ052968v1","13131640","13131834","52","3193031"
"JH378116","16447215","16447292","KQ053191v1","3736417","3736492","19","12710798"
"JH378116","16595233","16595537","KQ058348v1","1633794","1634092","69","14961439"
"JH378116","16648140","16648432","KQ057380v1","2548496","2548785","76","14099644"
"JH378116","17280178","17280481","KQ053565v1","3317692","3317989","70","13962486"
"JH378116","17790411","17790541","KQ055141v1","3481451","3481584","26","14308960"
"JH378116","17856281","17856545","KQ054932v1","4146161","4146408","76","13710120"
"JH378116","18165665","18165823","KQ054068v1","1471821","1471979","42","16693844"
"JH378116","18175836","18176133","KQ057875v1","561558","561851","61","17614278"
"JH378116","18496652","18496921","KQ058594v1","908912","909187","77","17587740"
"JH378116","18577767","18578069","KQ058184v1","1505565","1505858","69","17072202"
"JH378116","18595392","18595646","KQ055414v1","410942","411211","61","18184450"
"JH378116","18755031","18755296","KQ052971v1","6441372","6441626","71","12313659"
"JH378116","18888670","18888809","KQ054510v1","2941967","2942098","31","15946703"
"JH378116","18903335","18903633","KQ053096v1","602899","603182","68","18300436"
"JH378116","18999221","18999382","KQ055425v1","1445594","1445758","36","17553627"
"JH378116","19098194","19098495","KQ057693v1","621833","622123","75","18476361"
"JH378116","19131248","19131537","KQ053838v1","3013088","3013374","65","16118160"
"JH378116","19366051","19366341","KQ058353v1","1264780","1265071","65","18101271"
"JH378116","19371226","19371521","KQ058004v1","3883150","3883446","67","15488076"
"JH378116","19375157","19375460","KQ053398v1","2431232","2431537","65","16943925"
"JH378116","19394552","19394855","KQ054068v1","4356269","4356568","75","15038283"
"JH378116","19464322","19464627","KQ056928v1","1915686","1915996","71","17548636"
"JH378116","19479598","19479737","KQ053115v1","1333586","1333718","21","18146012"
"JH378116","19635693","19636004","KQ055236v1","2049624","2049930","76","17586069"
"JH378116","19826719","19826820","KQ053299v1","16386218","16386314","31","3440501"
"JH378116","19826909","19827141","KQ052968v1","14292615","14292844","53","5534294"
"JH378116","19963160","19963448","KQ054510v1","8555095","8555387","58","11408065"
"JH378116","20054255","20054426","KQ054725v1","735942","736116","44","19318313"
"JH378116","20088879","20089166","KQ053763v1","3936916","3937207","67","16151963"
"JH378116","20134544","20134830","KQ055097v1","2825545","2825834","71","17308999"
"JH378116","20341517","20341810","KQ058328v1","4012912","4013206","62","16328605"
"JH378116","20525462","20525727","KQ053609v1","2550928","2551200","72","17974534"
"JH378116","20729493","20729782","KQ054069v1","7687863","7688158","64","13041630"
"JH378116","21151880","21152185","KQ053299v1","2867160","2867464","80","18284720"
"JH378116","21491940","21492138","KQ058527v1","3280527","3280719","48","18211413"
"JH378116","21564533","21564743","KQ052968v1","7572312","7572523","52","13992221"
"JH378116","21774135","21774430","KQ053093v1","1375309","1375598","68","20398826"
"JH378116","21816135","21816343","KQ053741v1","1190544","1190756","62","20625591"
"JH378116","21834154","21834426","KQ058173v1","992259","992524","57","20841895"
"JH378116","21969968","21970264","KQ053299v1","21835674","21835971","74","134294"
"JH378116","22016898","22017118","KQ053741v1","1190544","1190756","55","20826354"
"JH378116","22054213","22054522","KQ058490v1","420741","421044","64","21633472"
"JH378116","22240943","22241263","KQ052969v1","9116808","9117108","71","13124135"
"JH378116","22251282","22251530","KQ053696v1","1946341","1946596","71","20304941"
"JH378116","22280753","22281037","KQ058184v1","1505565","1505858","59","20775188"
"JH378116","22400608","22400841","KQ053718v1","2663788","2664010","68","19736820"
"JH378116","22401525","22401783","KQ055192v1","1201363","1201615","72","21200162"
"JH378116","22406181","22406313","KQ053409v1","6573923","6574054","24","15832258"
"JH378116","22409529","22409800","KQ058328v1","2975933","2976189","70","19433596"
"JH378116","22499650","22499931","KQ053245v1","383288","383584","70","22116362"
"JH378116","22508679","22508968","KQ058353v1","1264780","1265071","69","21243899"
"JH378116","22557559","22557749","KQ056475v1","396846","397033","54","22160713"
"JH378116","22595382","22595676","KQ058428v1","2055160","2055453","63","20540222"
"JH378116","22642866","22642992","KQ054179v1","3865170","3865294","24","18777696"
"JH378116","22843884","22844161","KQ057702v1","1251524","1251800","74","21592360"
"JH378116","22928269","22928550","KQ052969v1","11182978","11183250","63","11745291"
"JH378116","22996694","22996981","KQ055540v1","4545763","4546052","75","18450931"
"JH378116","23035602","23035739","KQ053982v1","3934263","3934401","38","19101339"
"JH378116","23123048","23123315","KQ053816v1","5213784","5214044","65","17909264"
"JH378116","23128630","23128904","KQ052968v1","10745715","10745973","70","12382915"
"JH378116","23224982","23225260","KQ052968v1","13260777","13261056","46","9964205"
"JH378116","23519707","23519912","KQ055457v1","1904386","1904585","50","21615321"
"JH378116","23523762","23524075","KQ057004v1","1231997","1232305","72","22291765"
"JH378116","23805362","23805446","KQ053082v1","2466226","2466310","16","21339136"
"JH378116","23894413","23894569","KQ055872v1","3992534","3992693","30","19901879"
"JH378116","23992237","23992525","KQ053631v1","9963313","9963601","67","14028924"
"JH378116","24052465","24052582","KQ057909v1","4153593","4153709","22","19898872"
"JH378116","24053320","24053481","KQ054533v1","1027813","1027974","31","23025507"
"JH378116","24076188","24076453","KQ054289v1","4355551","4355817","71","19720637"
"JH378116","24101360","24101431","KQ053696v1","870676","870725","30","23230684"
"JH378116","24103369","24103645","KQ053948v1","1850099","1850373","89","22253270"
"JH378116","24180303","24180630","KQ054510v1","2100811","2101122","80","22079492"
"JH378116","24215090","24215227","KQ052970v1","4795906","4796029","40","19419184"
"JH378116","24238900","24239204","KQ052968v1","10629964","10630247","82","13608936"
"JH378116","24342448","24342750","KQ053816v1","7045838","7046139","72","17296610"
"JH378116","24386695","24386991","KQ053554v1","1157184","1157483","59","23229511"
"JH378116","24492903","24493166","KQ055141v1","526887","527156","71","23966016"
"JH378116","24503533","24503807","KQ058328v1","808528","808806","66","23695005"
"JH378116","24531612","24531878","KQ052969v1","1108868","1109131","84","23422744"
"JH378116","24570453","24570750","KQ055097v1","1884579","1884874","64","22685874"
"JH378116","24737729","24737891","KQ057036v1","1270725","1270889","41","23467004"
"JH378116","24775166","24775461","KQ055735v1","667472","667747","76","24107694"
"JH378116","24920375","24920580","KQ052968v1","7524927","7525138","47","17395448"
"JH378116","24944777","24945088","KQ056148v1","430759","431072","67","24514018"
"JH378116","25026218","25026524","KQ054704v1","215433","215738","61","24810785"
"JH378116","25064401","25064702","KQ053816v1","7464708","7465010","64","17599693"
"JH378116","25161172","25161364","KQ053294v1","648","849","50","25160524"
"JH378116","25183306","25183603","KQ053643v1","1564697","1564988","69","23618609"
"JH378116","25427659","25427781","KQ053861v1","8359","8490","25","25419300"
"JH378116","25437276","25437436","KQ056483v1","805524","805686","42","24631752"
"JH378116","25497033","25497331","KQ058184v1","1505565","1505858","58","23991468"
"JH378116","25614671","25614873","KQ054886v1","79","289","55","25614592"
"JH378116","25615678","25615787","KQ055903v1","184486","184598","26","25431192"
"JH378116","25689561","25689694","KQ057649v1","141749","141881","26","25547812"
"JH378116","25722134","25722238","KQ057821v1","1407299","1407387","39","24314835"
"JH378116","25734872","25735032","KQ057737v1","1426090","1426247","34","24308782"
"JH378116","25849132","25849434","KQ056928v1","97902","98210","71","25751230"
"JH378116","25867330","25867543","KQ058350v1","384041","384263","61","25483289"
"JH378116","25883418","25883558","KQ053082v1","2246114","2246256","27","23637304"
"JH378116","25977925","25978230","KQ054069v1","3864487","3864783","86","22113438"
"JH378116","27020043","27020175","KQ055352v1","1985696","1985827","20","25034347"
"JH378116","27127006","27127167","KQ052969v1","10507290","10507446","41","16619716"
"JH378116","27316435","27316733","KQ058473v1","369163","369455","61","26947272"
"JH378116","27663967","27664235","KQ055978v1","3560415","3560681","72","24103552"
"JH378116","27874495","27874795","KQ055987v1","77625","77928","67","27796870"
"JH378116","27894003","27894119","KQ054671v1","629082","629194","33","27264921"
"JH378116","27894510","27894613","KQ054510v1","2127300","2127398","25","25767210"
"JH378116","28063076","28063319","KQ055518v1","1576074","1576315","62","26487002"
"JH378116","28116064","28116332","KQ055140v1","2748912","2749194","76","25367152"
"JH378116","28139574","28139709","KQ055755v1","1807261","1807395","24","26332313"
"JH378116","28161404","28161679","KQ058328v1","6293951","6294242","65","21867453"
"JH378116","28288401","28288688","KQ053297v1","44026","44315","63","28244375"
"JH378116","28302640","28302936","KQ054660v1","27868","28164","61","28274772"
"JH378116","28358909","28359040","KQ053202v1","780148","780280","21","27578761"
"JH378116","28541924","28542211","KQ056873v1","1178409","1178686","75","27363515"
"JH378116","28697239","28697504","KQ053465v1","403029","403303","66","28294210"
"JH378116","28873905","28874206","KQ054466v1","2183618","2183917","66","26690287"
"JH378116","28932419","28932702","KQ053631v1","6939636","6939913","67","21992783"
"JH378116","29047243","29047525","KQ053190v1","4987885","4988162","64","24059358"
"JH378116","29115127","29115392","KQ055978v1","3560415","3560681","72","25554712"
"JH378116","29197792","29197926","KQ054932v1","7091907","7092041","27","22105885"
"JH378116","29455936","29456102","KQ058265v1","212584","212745","37","29243352"
"JH378116","29991952","29992247","KQ054795v1","2774148","2774449","68","27217804"
"JH378116","30299238","30299546","KQ054921v1","2545115","2545426","78","27754123"
"JH378116","30488825","30489094","KQ053191v1","1874915","1875171","74","28613910"
"JH378116","30522281","30522485","KQ054693v1","2405955","2406178","76","28116326"
"JH378116","30868384","30868687","KQ055457v1","2061137","2061448","62","28807247"
"JH378116","31552610","31552914","KQ053115v1","3485337","3485650","70","28067273"
"JH378116","31565084","31565414","KQ053025v1","180690","180990","89","31384394"
"JH378116","31646422","31646718","KQ054510v1","2056259","2056562","72","29590163"
"JH378116","31664743","31664899","KQ057059v1","1256796","1256956","38","30407947"
"JH378116","31970236","31970494","KQ053993v1","1017100","1017367","70","30953136"
"JH378116","32016301","32016462","KQ053774v1","3363264","3363425","33","28653037"
"JH378116","32362004","32362268","KQ053299v1","3021609","3021869","68","29340395"
"JH378116","32365430","32365688","KQ055035v1","2595126","2595373","73","29770304"
"JH378116","32418112","32418312","KQ055766v1","4486132","4486328","55","27931980"
"JH378116","32504754","32505049","KQ056147v1","1064032","1064323","68","31440722"
"JH378116","32728364","32728671","KQ053146v1","2218316","2218626","65","30510048"
"JH378116","32781621","32781758","KQ054510v1","8179279","8179421","31","24602342"
"JH378116","32836670","32836968","KQ052981v1","658787","659079","73","32177883"
"JH378116","32857758","32858009","KQ057345v1","1938824","1939073","64","30918934"
"JH378116","32943703","32943981","KQ053520v1","2840509","2840769","76","30103194"
"JH378116","33012466","33012751","KQ054069v1","955693","955974","71","32056773"
"JH378116","33108264","33108506","KQ058503v1","123813","124064","68","32984451"
"JH378116","33513067","33513375","KQ052969v1","9116808","9117108","69","24396259"
"JH378116","33617950","33618159","KQ054069v1","6282670","6282876","56","27335280"
"JH378116","33628760","33629029","KQ057290v1","862441","862706","53","32766319"
"JH378116","33751440","33751674","KQ058427v1","7850908","7851135","69","25900532"
"JH378116","33779225","33779529","KQ057875v1","561558","561851","66","33217667"
"JH378116","33861004","33861313","KQ052981v1","1198440","1198752","62","32662564"
"JH378116","33885530","33885811","KQ056493v1","2543428","2543718","69","31342102"
"JH378116","33888947","33889232","KQ053267v1","3500174","3500463","74","30388773"
"JH378116","34061799","34062112","KQ052970v1","6659487","6659775","81","27402312"
"JH378116","34119957","34120271","KQ054389v1","955589","955891","78","33164368"
"JH378116","34347890","34348143","KQ055014v1","188109","188353","72","34159781"
"JH378116","34354133","34354417","KQ053278v1","106295","106592","77","34247838"
"JH378116","34382068","34382333","KQ058501v1","355820","356085","73","34026248"
"JH378116","34418199","34418480","KQ053631v1","6524455","6524734","70","27893744"
"JH378116","34446037","34446299","KQ058605v1","570168","570442","65","33875869"
"JH378116","34476509","34476801","KQ054932v1","10830322","10830609","67","23646187"
"JH378116","34479018","34479334","KQ055479v1","3509341","3509657","84","30969677"
"JH378116","34542136","34542410","KQ054795v1","605547","605810","80","33936589"
"JH378116","34544681","34544938","KQ056331v1","106636","106916","80","34438045"
"JH378116","34625477","34625768","KQ053267v1","3278124","3278417","64","31347353"
"JH378116","34631180","34631474","KQ057875v1","561558","561851","68","34069622"
"JH378116","34641545","34641688","KQ053631v1","8603317","8603457","33","26038228"
"JH378116","34647500","34647630","KQ055141v1","2421865","2421977","40","32225635"
"JH378116","34668179","34668447","KQ058348v1","1423555","1423818","68","33244624"
"JH378116","34715604","34715875","KQ054510v1","8555095","8555387","70","26160509"
"JH378116","34827497","34827804","KQ053299v1","2867160","2867464","86","31960337"
"JH378116","34882002","34882275","KQ053331v1","268052","268335","60","34613950"
"JH378116","34974623","34974896","KQ055173v1","248885","249169","69","34725738"
"JH378116","34998683","34998985","KQ058184v1","1505565","1505858","62","33493118"
"JH378116","35012692","35013008","KQ055320v1","703550","703864","74","34309142"
"JH378116","35019206","35019502","ABDC02051297v1","1939","2213","80","35017267"
"JH378116","35653631","35653766","KQ053948v1","2765570","2765701","32","32888061"
"JH378116","35812393","35812688","KQ053059v1","3421896","3422194","74","32390497"
"JH378116","35934705","35935022","KQ058383v1","5021173","5021475","87","30913532"
"JH378116","36596914","36597072","KQ054004v1","434795","434955","38","36162119"
"JH378116","36875328","36875638","KQ058288v1","34632","34947","70","36840696"
"JH378116","37032002","37032082","KQ053332v1","1937831","1937907","19","35094171"
"JH378116","37085554","37085798","KQ054826v1","9969237","9969502","63","27116317"
"JH378116","37085920","37086252","KQ058583v1","3101722","3102049","86","33984198"
"JH378116","37108904","37109136","KQ057431v1","2411902","2412116","66","34697002"
"JH378116","37132201","37132307","KQ056432v1","2290247","2290350","25","34841954"
"JH378116","37132688","37132755","KQ053520v1","3803739","3803813","17","33328949"
"JH378116","37181856","37182146","KQ053096v1","602899","603182","70","36578957"
"JH378116","37213331","37213632","KQ058266v1","1113469","1113760","64","36099862"
"JH378116","37304195","37304477","KQ053565v1","754705","754987","66","36549490"
"JH378116","37324238","37324479","KQ058328v1","2569266","2569497","58","34754972"
"JH378116","37441410","37441701","KQ056928v1","2303396","2303675","63","35138014"
"JH378116","37450552","37450847","KQ055364v1","2160874","2161165","72","35289678"
"JH378116","37525836","37526139","KQ052969v1","9116808","9117108","69","28409028"
"JH378116","37531951","37532099","KQ053948v1","296331","296478","45","37235620"
"JH378116","37541391","37541691","KQ053520v1","456408","456696","69","37084983"
"JH378116","37683764","37684000","KQ056044v1","1215881","1216119","71","36467883"
"JH378116","37817722","37818018","KQ052968v1","7064883","7065171","65","30752839"
"JH378116","37822327","37822548","KQ053300v1","3018160","3018380","52","34804167"
"JH378116","37850638","37850869","KQ054693v1","3245566","3245803","64","34605072"
"JH378116","37920474","37920682","KQ057737v1","1779203","1779413","52","36141271"
"JH378116","37989594","37989757","KQ053004v1","4759784","4759947","37","33229810"
"JH378116","38351255","38351550","KQ058184v1","1505565","1505858","68","36845690"
"JH378116","38408858","38409043","KQ053190v1","4183682","4183869","48","34225176"
"JH378116","38497352","38497636","KQ053849v1","2872588","2872865","60","35624764"
"JH378116","38651596","38651907","KQ053343v1","1747702","1748011","68","36903894"
"JH378116","38743688","38743987","KQ054069v1","7687863","7688158","57","31055825"
"JH378116","38767786","38768060","KQ057059v1","4388541","4388812","68","34379245"
"JH378116","38885590","38885703","KQ052969v1","2661859","2661968","28","36223731"
"JH378116","38946146","38946435","KQ058184v1","1505565","1505858","66","37440581"
"JH378116","38960285","38960438","KQ053115v1","3116373","3116525","34","35843912"
"JH378117","49470","49634","KQ053740v1","1071467","1071623","37","1021997"
"JH378117","71523","71832","KQ057737v1","5252287","5252595","75","5180764"
"JH378117","77704","77837","KQ054218v1","2975","3106","39","74729"
"JH378117","139587","139663","KQ053332v1","1937831","1937907","19","1798244"
"JH378117","139740","139966","KQ058613v1","403026","403252","54","263286"
"JH378117","185128","185423","KQ055914v1","218683","218977","63","33555"
"JH378117","192255","192555","KQ054412v1","2490468","2490761","62","2298213"
"JH378117","216304","216580","KQ055248v1","2793952","2794228","61","2577648"
"JH378117","224589","224782","KQ053849v1","1126392","1126589","45","901803"
"JH378117","357516","357659","KQ053190v1","2372433","2372579","35","2014917"
"JH378117","360395","360552","KQ056837v1","1376328","1376481","39","1015933"
"JH378117","398341","398504","KQ057023v1","876183","876346","33","477842"
"JH378117","428490","428784","KQ055141v1","378501","378798","62","49989"
"JH378117","526962","527257","KQ054401v1","409648","409945","74","117314"
"JH378117","535496","535684","KQ054933v1","3939617","3939804","41","3404121"
"JH378117","535728","535835","KQ052969v1","2661859","2661968","34","2126131"
"JH378117","1349778","1350063","KQ056790v1","446564","446855","61","903214"
"JH378117","2102524","2102830","KQ056673v1","654012","654302","79","1448512"
"JH378117","2193382","2193673","KQ058538v1","934688","934988","79","1258694"
"JH378117","3714941","3715240","KQ058577v1","563667","563958","72","3151274"
"JH378117","4066205","4066475","KQ053816v1","5213784","5214044","68","1147579"
"JH378117","4210418","4210688","KQ058283v1","3525175","3525450","70","685243"
"JH378117","5083462","5083717","KQ058372v1","1188857","1189118","81","3894605"
"JH378117","5368329","5368607","KQ053409v1","3716306","3716585","63","1652023"
"JH378117","5410007","5410329","KQ054510v1","1767978","1768276","83","3642029"
"JH378117","5476333","5476648","KQ057875v1","561558","561851","74","4914775"
"JH378117","5791994","5792261","KQ058561v1","1351959","1352198","79","4440035"
"JH378117","5904347","5904569","KQ058550v1","3053970","3054174","61","2850377"
"JH378117","6070800","6071074","KQ056493v1","4637126","4637410","73","1433674"
"JH378117","6420138","6420423","KQ052968v1","10629964","10630247","71","4209826"
"JH378117","6558939","6559104","KQ057560v1","2172970","2173133","41","4385969"
"JH378117","6849624","6849905","KQ058275v1","938649","938919","60","5910975"
"JH378117","6977224","6977527","KQ055787v1","694393","694708","73","6282831"
"JH378117","7202141","7202472","KQ053838v1","3147156","3147480","83","4054985"
"JH378117","7338162","7338439","KQ053332v1","447571","447853","64","6890591"
"JH378117","7347384","7347659","KQ057875v1","469535","469791","74","6877849"
"JH378117","7351937","7352217","KQ053763v1","141096","141389","71","7210841"
"JH378117","7453383","7453678","KQ058428v1","1609842","1610139","73","5843541"
"JH378117","7499404","7499679","KQ053398v1","4702476","4702738","73","2796928"
"JH378117","7640890","7641024","KQ053190v1","4627206","4627347","30","3013684"
"JH378117","7663625","7663833","KQ056147v1","3894275","3894476","59","3769350"
"JH378117","7702660","7702925","KQ055173v1","452351","452623","69","7250309"
"JH378117","7709297","7709586","KQ057290v1","2953971","2954265","70","4755326"
"JH378117","7780668","7780952","KQ053741v1","1482396","1482684","77","6298272"
"JH378117","7953554","7953854","KQ057059v1","3076587","3076891","81","4876967"
"JH378117","8005015","8005291","KQ053146v1","2819587","2819868","62","5185428"
"JH378117","8366525","8366789","KQ058616v1","3808264","3808541","71","4558261"
"JH378117","8442643","8442724","KQ055140v1","2877125","2877206","17","5565518"
"JH378117","8699018","8699285","KQ058379v1","21379","21640","68","8677639"
"JH378117","8738305","8738377","KQ053849v1","1707655","1707721","24","7030650"
"JH378117","8739207","8739235","KQ058317v1","5369536","5369554","13","3369671"
"JH378117","8739546","8739689","KQ053026v1","1335920","1336065","29","7403626"
"JH378117","9182299","9182563","KQ057380v1","1672785","1673058","67","7509514"
"JH378117","9235357","9235623","KQ058272v1","5539241","5539492","80","3696116"
"JH378117","9520804","9520980","KQ054510v1","3803526","3803690","42","5717278"
"JH378117","10484441","10484678","KQ058503v1","123813","124064","66","10360628"
"JH378117","10760010","10760287","KQ055394v1","2461651","2461910","82","8298359"
"JH378117","10783330","10783631","KQ056790v1","446564","446855","75","10336766"
"JH378117","10857738","10858042","KQ058305v1","3465508","3465807","71","7392230"
"JH378117","10895637","10895915","KQ053082v1","1085491","1085778","66","9810146"
"JH378117","11225137","11225376","KQ053631v1","9034236","9034449","70","2190901"
"JH378117","11848998","11849104","KQ058050v1","918290","918400","23","10930708"
"JH378117","12270480","12270642","KQ056996v1","1524030","1524195","35","10746450"
"JH378117","12451582","12451829","KQ057290v1","2469746","2470009","75","9981836"
"JH378117","12512819","12513076","KQ053191v1","1874915","1875171","68","10637904"
"JH378117","12975507","12975669","KQ056996v1","1524030","1524195","39","11451477"
"JH378117","13426551","13426735","KQ053520v1","3921290","3921471","46","9505261"
"JH378117","14746374","14746666","KQ058184v1","1505565","1505858","72","13240809"
"JH378117","15011071","15011282","KQ055309v1","1468159","1468383","76","13542912"
"JH378117","15014760","15014964","KQ053299v1","2901484","2901684","59","12113276"
"JH378117","15035955","15036262","KQ053332v1","761333","761652","84","14274622"
"JH378117","15058029","15058314","KQ058257v1","502287","502580","69","14555742"
"JH378117","15066808","15067091","KQ055862v1","1844412","1844705","69","13222396"
"JH378117","15086472","15086774","KQ054401v1","2629005","2629296","70","12457467"
"JH378117","15191996","15192305","KQ054068v1","5074639","5074944","78","10117357"
"JH378117","15315732","15315934","KQ054826v1","9981760","9981967","61","5333972"
"JH378117","15602270","15602566","KQ055808v1","339221","339505","73","15263049"
"JH378117","15813097","15813237","KQ053115v1","1650505","1650644","35","14162592"
"JH378117","15841253","15841384","KQ058305v1","4820083","4820218","27","11021170"
"JH378117","15917179","15917448","KQ054224v1","428324","428601","73","15488855"
"JH378117","16024828","16025114","KQ056331v1","1501968","1502262","67","14522860"
"JH378117","16051866","16052030","KQ055014v1","15960","16127","44","16035906"
"JH378117","16093930","16094240","KQ053398v1","2816605","2816914","77","13277325"
"JH378117","16378127","16378392","ABDC02051297v1","1939","2213","73","16376188"
"JH378117","17501734","17502015","KQ055957v1","446738","447027","74","17054996"
"JH378117","17862408","17862536","KQ053432v1","5514393","5514523","30","12348015"
"JH378117","17919206","17919480","KQ053409v1","3716306","3716585","67","14202900"
"JH378117","18265506","18265779","KQ053299v1","2858924","2859187","65","15406582"
"JH378117","18826849","18827128","KQ056035v1","1769934","1770210","75","17056915"
"JH378117","18887720","18887898","KQ054510v1","1448917","1449101","51","17438803"
"JH378117","19129594","19129687","KQ055872v1","3969127","3969217","21","15160467"
"JH378117","19130257","19130365","KQ055872v1","15136888","15137001","25","3993369"
"JH378117","19173424","19173726","KQ054224v1","1081743","1082035","84","18091681"
"JH378117","19355491","19355796","KQ053300v1","2874445","2874736","69","16481046"
"JH378117","19381363","19381656","KQ058561v1","7979148","7979437","71","11402215"
"JH378117","20107872","20108147","KQ054069v1","3733362","3733643","68","16374510"
"JH378117","20115936","20116218","KQ055490v1","2797344","2797631","72","17318592"
"JH378117","20166255","20166527","KQ058316v1","4984552","4984820","68","15181703"
"JH378117","20371853","20372063","KQ058561v1","565602","565807","51","19806251"
"JH378117","20763263","20763554","KQ052990v1","208509","208785","75","20554754"
"JH378117","20857028","20857144","KQ058383v1","8339612","8339728","18","12517416"
"JH378117","20901274","20901574","KQ052969v1","9553757","9554052","69","11347517"
"JH378117","22394144","22394419","KQ053190v1","4987885","4988162","74","17406259"
"JH378117","22403837","22404024","KQ056134v1","2704736","2704912","42","19699101"
"JH378117","22452004","22452304","KQ054068v1","5074639","5074944","67","17377365"
"JH378117","22530236","22530532","KQ057151v1","1087366","1087668","62","21442870"
"JH378117","23022704","23022876","KQ058542v1","353143","353313","39","22669561"
"JH378117","23202521","23202596","KQ052968v1","9483686","9483763","19","13718835"
"JH378117","23213967","23214243","KQ054224v1","428324","428601","67","22785643"
"JH378117","23226147","23226467","KQ057858v1","376905","377209","91","22849242"
"JH378117","23522078","23522408","KQ055590v1","630185","630485","95","22891893"
"JH378117","23538568","23538882","KQ054068v1","6469624","6469931","86","17068944"
"JH378117","24000453","24000543","KQ053838v1","1840604","1840696","32","22159849"
"JH378117","24217046","24217352","KQ056345v1","621994","622295","67","23595052"
"JH378117","24479396","24479686","KQ054745v1","919926","920212","60","23559470"
"JH378117","24544266","24544576","KQ058184v1","1505565","1505858","59","23038701"
"JH378117","24749949","24750149","KQ058383v1","9982530","9982731","46","14767419"
"JH378117","24773488","24773603","KQ058383v1","569515","569642","38","24203973"
"JH378117","24808626","24808924","KQ054124v1","473618","473911","69","24335008"
"JH378117","25369957","25370251","KQ052968v1","13459203","13459489","66","11910754"
"JH378117","25449410","25449709","KQ056510v1","1147","1447","69","25448263"
"JH378117","25504982","25505272","KQ053299v1","21835674","21835971","74","3669308"
"JH378117","25621095","25621388","KQ058350v1","6740286","6740580","57","18880809"
"JH378117","25634796","25635092","KQ055468v1","203615","203906","60","25431181"
"JH378117","25714338","25714654","KQ054725v1","1024418","1024732","66","24689920"
"JH378117","25842319","25842446","KQ053654v1","4929533","4929667","20","20912786"
"JH378117","25978146","25978275","KQ054890v1","666308","666433","46","25311838"
"JH378117","26134419","26134549","KQ053299v1","10228320","10228443","40","15906099"
"JH378117","26244245","26244431","KQ058249v1","1128789","1128974","51","25115456"
"JH378117","26332644","26332841","KQ053398v1","3158290","3158500","50","23174354"
"JH378117","26938474","26938765","KQ053816v1","7464708","7465010","71","19473766"
"JH378117","26977110","26977217","KQ053115v1","4371036","4371145","18","22606074"
"JH378117","27089376","27089640","KQ058383v1","2713168","2713439","67","24376208"
"JH378117","27212895","27213171","KQ058561v1","583947","584226","73","26628948"
"JH378117","27740278","27740501","KQ052968v1","7524927","7525138","60","20215351"
"JH378117","27763014","27763220","KQ058242v1","892038","892246","58","26870976"
"JH378117","27800482","27800764","KQ055352v1","272395","272688","76","27528087"
"JH378117","28341341","28341576","KQ054135v1","1541023","1541259","79","26800318"
"JH378117","28341873","28341911","KQ056762v1","404433","404470","14","27937440"
"JH378117","28509452","28509755","KQ058293v1","670508","670799","65","27838944"
"JH378117","28602764","28603054","KQ053498v1","3696034","3696323","65","24906730"
"JH378117","28617792","28618030","KQ053409v1","5579475","5579686","64","23038317"
"JH378117","28647078","28647366","KQ058184v1","1505565","1505858","67","27141513"
"JH378117","28685810","28686070","KQ058272v1","6315628","6315874","66","22370182"
"JH378117","28763789","28763943","KQ052968v1","13532288","13532426","51","15231501"
"JH378117","28793574","28793881","KQ057858v1","376905","377209","73","28416669"
"JH378117","28940253","28940540","KQ056331v1","106636","106916","69","28833617"
"JH378117","29000200","29000355","KQ056147v1","3323","3476","37","28996877"
"JH378117","29018196","29018465","KQ058305v1","3371252","3371528","76","25646944"
"JH378117","29175394","29175677","KQ052971v1","646100","646383","75","28529294"
"JH378117","29393665","29393934","KQ058275v1","938649","938919","71","28455016"
"JH378117","29402140","29402414","KQ053631v1","9398334","9398603","64","20003806"
"JH378117","29512460","29512673","KQ058505v1","2234909","2235124","60","27277551"
"JH378117","29626119","29626362","KQ055735v1","1032075","1032317","56","28594044"
"JH378117","29776530","29776769","KQ054713v1","840037","840292","69","28936493"
"JH378117","29819268","29819584","KQ053420v1","122023","122324","74","29697245"
"JH378117","29864436","29864728","KQ057013v1","1226708","1226991","71","28637728"
"JH378117","30559867","30560179","KQ056928v1","1915686","1915996","76","28644181"
"JH378117","30829207","30829494","KQ053202v1","590990","591274","67","30238217"
"JH378117","30919988","30920227","KQ052982v1","3633817","3634050","56","27286171"
"JH378117","30920908","30920969","KQ054943v1","3387644","3387704","19","27533264"
"JH378117","31008259","31008549","KQ056147v1","1064032","1064323","57","29944227"
"JH378117","31330825","31330965","KQ053631v1","8603317","8603457","32","22727508"
"JH378117","31357963","31358262","KQ057858v1","376905","377209","66","30981058"
"JH378117","31808910","31809201","KQ055662v1","1145336","1145647","73","30663574"
"JH378117","31864418","31864710","KQ058353v1","1264780","1265071","63","30599638"
"JH378117","32330860","32331163","KQ054804v1","964015","964313","71","31366845"
"JH378117","32616094","32616400","KQ058184v1","1505565","1505858","69","31110529"
"JH378117","32727826","32728086","KQ053409v1","2693050","2693293","70","30034776"
"JH378117","32858490","32858785","KQ056475v1","2179070","2179363","79","30679420"
"JH378117","32968733","32969026","KQ058389v1","2329886","2330179","63","30638847"
"JH378117","33018185","33018484","KQ055097v1","2825545","2825834","77","30192640"
"JH378117","33224505","33224817","KQ053409v1","51347","51643","81","33173158"
"JH378117","33483824","33483986","KQ057737v1","1426090","1426247","35","32057734"
"JH378117","33545426","33545572","KQ055872v1","5870772","5870928","35","27674654"
"JH378117","33601800","33601924","KQ055600v1","267326","267449","29","33334474"
"JH378117","33753055","33753378","KQ053223v1","2969906","2970218","68","30783149"
"JH378117","33992299","33992484","KQ058462v1","452919","453117","55","33539380"
"JH378117","34004703","34005016","KQ053299v1","4095914","4096215","77","29908789"
"JH378117","34081517","34081830","KQ058105v1","434060","434348","97","33647457"
"JH378117","34299084","34299389","KQ058317v1","5506620","5506904","94","28792464"
"JH378117","34343431","34343724","KQ057931v1","453083","453376","74","33890348"
"JH378117","34538693","34538889","KQ057290v1","4745481","4745684","60","29793212"
"JH378117","34724670","34724957","KQ054069v1","7026364","7026639","73","27698306"
"JH378117","34981811","34982074","KQ056423v1","1942313","1942589","68","33039498"
"JH378117","35426874","35426998","KQ053686v1","1108593","1108721","33","34318281"
"JH378117","35482809","35483099","KQ058350v1","6740286","6740580","62","28742523"
"JH378117","35600923","35601208","KQ058266v1","1113469","1113760","67","34487454"
"JH378117","35633156","35633439","KQ055717v1","439513","439802","73","35193643"
"JH378117","36116789","36117078","KQ053696v1","5093430","5093716","66","31023359"
"JH378117","37068669","37068967","KQ053115v1","1118362","1118655","60","35950307"
"JH378117","37349746","37350045","KQ055787v1","1064992","1065293","65","36284754"
"JH378117","37477064","37477354","KQ053498v1","3696034","3696323","75","33781030"
"JH378117","37735219","37735510","KQ055247v1","1761880","1762166","64","35973339"
"JH378117","37825831","37825959","KQ054533v1","1111592","1111720","24","36714239"
"JH378117","38449848","38449995","KQ057440v1","384538","384683","30","38065310"
"JH378117","38576325","38576563","KQ057910v1","1519898","1520150","68","37056427"
"JH378117","38991742","38992022","KQ055035v1","4381466","4381744","79","34610276"
"JH378118","163824","164102","KQ056331v1","106636","106916","72","57188"
"JH378118","208828","209113","KQ057290v1","1053741","1054027","63","844913"
"JH378118","278368","278686","KQ055044v1","207214","207505","83","71154"
"JH378118","598094","598377","KQ053631v1","9823225","9823499","71","9225131"
"JH378118","764563","764857","KQ054412v1","2490468","2490761","63","1725905"
"JH378118","773322","773557","KQ058526v1","91779","91996","59","681543"
"JH378118","779825","780132","KQ055247v1","2301997","2302301","68","1522172"
"JH378118","951566","951876","KQ053398v1","2431232","2431537","62","1479666"
"JH378118","1085098","1085270","KQ056996v1","1524030","1524195","41","438932"
"JH378118","1132105","1132237","KQ053191v1","655494","655627","21","476611"
"JH378118","1244075","1244382","KQ058494v1","4784845","4785156","63","3540770"
"JH378118","1336696","1336848","KQ056864v1","2852271","2852420","41","1515575"
"JH378118","1632106","1632244","KQ057702v1","1862724","1862857","31","230618"
"JH378118","1785867","1786121","KQ054400v1","3760476","3760752","60","1974609"
"JH378118","1835269","1835579","KQ052981v1","1198440","1198752","65","636829"
"JH378118","2382736","2382909","KQ053741v1","1690943","1691088","54","691793"
"JH378118","2491046","2491242","KQ054826v1","1680834","1681044","51","810212"
"JH378118","3153551","3153799","KQ053521v1","1805661","1805912","76","1347890"
"JH378118","3174257","3174549","KQ053696v1","5093430","5093716","65","1919173"
"JH378118","3801973","3802180","KQ052968v1","7782911","7783091","60","3980938"
"JH378118","3843399","3843519","KQ054671v1","629082","629194","44","3214317"
"JH378118","4194459","4194643","KQ057082v1","645637","645822","46","3548822"
"JH378118","4194770","4195045","KQ058004v1","3112196","3112474","78","1082574"
"JH378118","4404095","4404397","KQ053554v1","2471177","2471484","70","1932918"
"JH378118","4722743","4723003","KQ054693v1","3278351","3278621","72","1444392"
"JH378118","4980867","4981041","KQ053179v1","1735404","1735576","43","3245463"
"JH378118","5513391","5513699","KQ052981v1","1198440","1198752","65","4314951"
"JH378118","5731227","5731500","KQ052969v1","11182978","11183250","74","5451751"
"JH378118","5742742","5743045","KQ053299v1","6038380","6038679","68","295638"
"JH378118","6905238","6905517","KQ054135v1","2702098","2702381","74","4203140"
"JH378118","6918454","6918693","KQ053827v1","5369199","5369432","65","1549255"
"JH378118","7051938","7052118","KQ054510v1","2373994","2374175","46","4677944"
"JH378118","7472638","7472915","KQ058275v1","938649","938919","75","6533989"
"JH378118","7482595","7482725","KQ055140v1","2778452","2778584","24","4704143"
"JH378118","7761279","7761569","KQ053421v1","2664387","2664683","58","5096892"
"JH378118","8099716","8099943","KQ053696v1","1876148","1876374","68","6223568"
"JH378118","8100003","8100304","KQ058582v1","1599482","1599782","71","6500521"
"JH378118","8191447","8191738","KQ053299v1","6282965","6283256","59","1908482"
"JH378118","8343905","8344204","KQ058329v1","663480","663767","70","7680425"
"JH378118","8370998","8371292","KQ056475v1","2179070","2179363","60","6191928"
"JH378118","8605859","8606144","KQ056093v1","2289180","2289470","63","6316679"
"JH378118","8855295","8855404","KQ053190v1","4952878","4952995","30","3902417"
"JH378118","8951949","8952215","KQ056093v1","1429973","1430243","67","7521976"
"JH378118","9024700","9024814","KQ054179v1","3865170","3865294","22","5159530"
"JH378118","9131250","9131506","KQ052970v1","21565783","21566032","74","12434533"
"JH378118","9186863","9187183","KQ058483v1","4098293","4098613","80","5088570"
"JH378118","9266077","9266227","KQ054943v1","3338657","3338793","41","5927420"
"JH378118","9282260","9282558","KQ052969v1","9116808","9117108","74","165452"
"JH378118","9489676","9489864","KQ053387v1","3273859","3274045","49","6215817"
"JH378118","9538600","9538732","KQ053135v1","4005291","4005427","29","5533309"
"JH378118","9587654","9587888","KQ053785v1","2317325","2317548","67","7270329"
"JH378118","9602819","9603048","KQ053520v1","4901250","4901462","55","4701569"
"JH378118","9608165","9608451","KQ058272v1","5443874","5444159","72","4164291"
"JH378118","9620286","9620591","KQ058427v1","5134091","5134389","59","4486195"
"JH378118","9684575","9684812","KQ055457v1","1902633","1902878","54","7781942"
"JH378118","9702136","9702435","KQ058190v1","350088","350375","77","9352048"
"JH378118","9738111","9738415","KQ058561v1","4466656","4466945","69","5271455"
"JH378118","9741586","9741885","KQ058184v1","1505565","1505858","57","8236021"
"JH378118","9778561","9778878","KQ053299v1","4095914","4096215","68","5682647"
"JH378118","9789539","9789815","KQ055662v1","5484080","5484349","71","4305459"
"JH378118","9820763","9820920","KQ054533v1","1027813","1027974","33","8792950"
"JH378118","9926916","9927164","KQ053696v1","1946341","1946596","70","7980575"
"JH378118","10046720","10047011","KQ058184v1","1505565","1505858","67","8541155"
"JH378118","10055437","10055639","KQ054848v1","194460","194660","51","9860977"
"JH378118","10070349","10070671","KQ056147v1","190516","190832","84","9879833"
"JH378118","10138565","10138687","KQ054179v1","3865170","3865294","37","6273395"
"JH378118","10230219","10230507","KQ054693v1","832788","833076","56","9397431"
"JH378118","10844533","10844837","KQ053816v1","7464708","7465010","72","3379825"
"JH378118","11081257","11081553","KQ052993v1","743501","743813","60","10337756"
"JH378118","11219407","11219707","KQ054356v1","1356188","1356481","72","9863219"
"JH378118","11612468","11612748","KQ054868v1","2229582","2229854","64","9382886"
"JH378118","12032453","12032735","KQ058283v1","3525175","3525450","80","8507278"
"JH378118","12123473","12123786","KQ056475v1","2179070","2179363","84","9944403"
"JH378118","12183322","12183603","KQ053026v1","3680523","3680807","66","8502799"
"JH378118","12258520","12258799","KQ053146v1","2819587","2819868","72","9438933"
"JH378118","12473936","12474065","KQ054499v1","472083","472205","32","12001853"
"JH378118","12546046","12546286","KQ055777v1","744780","745022","69","11801266"
"JH378118","12707875","12708033","KQ057603v1","1535538","1535702","33","11172337"
"JH378118","12792398","12792549","KQ057737v1","1426090","1426247","35","11366308"
"JH378118","12922655","12922932","KQ058004v1","1100771","1101059","76","11821884"
"JH378118","12974692","12974965","KQ057290v1","1053741","1054027","72","11920951"
"JH378118","12975277","12975583","KQ058594v1","180149","180449","75","12795128"
"JH378118","13037772","13037933","KQ057603v1","1535538","1535702","39","11502234"
"JH378118","13041092","13041219","KQ052970v1","4661614","4661744","31","8379478"
"JH378118","13158493","13158610","KQ056643v1","1279625","1279744","27","11878868"
"JH378118","13178723","13178887","KQ053223v1","2815634","2815800","38","10363089"
"JH378118","13353710","13353860","KQ054412v1","2185013","2185160","28","11168697"
"JH378118","13426438","13426735","KQ055852v1","2616321","2616621","64","10810117"
"JH378118","14535563","14535768","KQ056147v1","3894275","3894476","52","10641288"
"JH378118","14550861","14551160","KQ054069v1","5704070","5704362","72","8846791"
"JH378118","14699295","14699554","KQ053454v1","817557","817829","78","13881738"
"JH378118","14735262","14735445","KQ053686v1","2686351","2686537","50","12048911"
"JH378118","14789968","14790255","KQ053104v1","3864277","3864560","68","10925691"
"JH378118","14991767","14992076","KQ053960v1","70067","70362","74","14921700"
"JH378118","15131281","15131393","KQ057290v1","2125675","2125777","34","13005606"
"JH378118","15159062","15159341","KQ055457v1","11296503","11296794","69","3862559"
"JH378118","15184596","15184849","KQ058427v1","7850908","7851135","70","7333688"
"JH378118","16417760","16417916","KQ057737v1","1426090","1426247","31","14991670"
"JH378118","16574205","16574490","KQ053146v1","2819587","2819868","64","13754618"
"JH378118","16621596","16621892","KQ054412v1","2490468","2490761","67","14131128"
"JH378118","16685505","16685762","KQ052971v1","6441372","6441626","58","10244133"
"JH378118","16688352","16688647","KQ057471v1","475360","475647","68","16212992"
"JH378118","16738390","16738686","KQ058353v1","1264780","1265071","63","15473610"
"JH378118","16816127","16816420","KQ053816v1","6856607","6856902","77","9959520"
"JH378118","17119727","17119911","KQ053234v1","534494","534654","51","16585233"
"JH378118","17710026","17710306","KQ053465v1","3806004","3806288","71","13904022"
"JH378118","18578963","18579095","KQ056361v1","317113","317243","24","18261850"
"JH378118","18664992","18665283","KQ058184v1","1505565","1505858","77","17159427"
"JH378118","18834963","18835142","KQ053179v1","1735404","1735576","46","17099559"
"JH378118","18915084","18915364","KQ053191v1","1874915","1875171","75","17040169"
"JH378118","19379858","19379984","KQ053916v1","2379880","2380005","28","16999978"
"JH378118","19645102","19645344","KQ056063v1","5211","5464","81","19639891"
"JH378118","21245368","21245534","KQ055119v1","1040353","1040537","54","20205015"
"JH378118","21245891","21246114","KQ058427v1","3767741","3767953","64","17478150"
"JH378118","21246456","21246553","KQ053631v1","8860661","8860759","25","12385795"
"JH378118","21673721","21673978","KQ053332v1","2579491","2579756","78","19094230"
"JH378118","22649321","22649599","KQ057118v1","4850374","4850664","84","17798947"
"JH378118","23144241","23144533","KQ054804v1","964015","964313","67","22180226"
"JH378118","23220961","23221081","KQ057649v1","141749","141881","28","23079212"
"JH378118","23261854","23262082","KQ056147v1","3491603","3491838","56","19770251"
"JH378118","23353707","23353989","KQ057118v1","1749884","1750157","82","21603823"
"JH378118","23415626","23415939","KQ053343v1","1747702","1748011","65","21667924"
"JH378118","23453091","23453213","KQ053409v1","6105325","6105446","19","17347766"
"JH378118","23729701","23729932","KQ053654v1","3892663","3892904","60","19837038"
"JH378118","23857692","23857944","KQ053093v1","1400479","1400733","72","22457213"
"JH378118","23867636","23867846","KQ053741v1","1190544","1190756","50","22677092"
"JH378118","23902194","23902399","KQ053256v1","942460","942674","51","22959734"
"JH378118","24115801","24116058","KQ058291v1","570212","570475","62","23545589"
"JH378118","24122438","24122732","KQ058184v1","1505565","1505858","63","22616873"
"JH378118","24252771","24253089","KQ058485v1","826092","826398","78","23426679"
"JH378118","24320962","24321201","KQ053763v1","974463","974700","64","23346499"
"JH378118","24410757","24411042","KQ055755v1","209063","209333","65","24201694"
"JH378118","24475055","24475353","KQ053299v1","21835674","21835971","66","2639381"
"JH378118","24539124","24539404","KQ052968v1","10629964","10630247","63","13909160"
"JH378118","24639373","24639593","KQ053654v1","4118798","4119013","55","20520575"
"JH378118","25069062","25069353","KQ057737v1","3274981","3275269","78","21794081"
"JH378118","25075084","25075363","KQ054921v1","3166511","3166802","81","21908573"
"JH378118","25091670","25091956","KQ055394v1","3441211","3441489","72","21650459"
"JH378118","25276608","25276815","KQ054510v1","1862026","1862244","58","23414582"
"JH378118","25277276","25277351","KQ057796v1","119005","119079","17","25158271"
"JH378118","25584098","25584400","KQ053554v1","2471177","2471484","81","23112921"
"JH378118","25655974","25656134","KQ055479v1","601792","601954","36","25054182"
"JH378118","25711807","25712106","KQ058184v1","1505565","1505858","65","24206242"
"JH378118","25783558","25783661","KQ053005v1","324436","324539","26","25459122"
"JH378118","25876022","25876156","KQ057488v1","512192","512325","23","25363830"
"JH378118","26752124","26752227","KQ052969v1","2661859","2661968","37","24090265"
"JH378118","26768575","26768769","KQ056148v1","3512538","3512717","54","23256037"
"JH378118","27172534","27172682","KQ055225v1","876816","876968","37","26295718"
"JH378118","27192676","27192812","KQ052969v1","2661859","2661968","43","24530817"
"JH378118","27202657","27202873","KQ055457v1","1673513","1673719","52","25529144"
"JH378118","27256919","27257234","KQ057290v1","2953971","2954265","73","24302948"
"JH378118","27381738","27382046","KQ053135v1","3156167","3156481","68","24225571"
"JH378118","27660688","27661000","KQ053190v1","4341347","4341648","72","23319341"
"JH378118","27683313","27683594","KQ052969v1","7351818","7352090","66","20331495"
"JH378118","27980952","27981232","KQ058595v1","297389","297662","68","27683563"
"JH378118","28067241","28067412","KQ058583v1","2039372","2039538","39","26027869"
"JH378118","28076655","28076964","KQ053520v1","848167","848461","76","27228488"
"JH378118","28470571","28470845","KQ054693v1","832788","833076","59","27637783"
"JH378118","28608619","28608900","KQ058394v1","3915274","3915538","73","24693345"
"JH378118","28721066","28721324","KQ053631v1","9398334","9398603","58","19322732"
"JH378118","28770491","28770650","KQ057560v1","2172970","2173133","35","26597521"
"JH378118","29513012","29513199","KQ058301v1","333804","333994","46","29179208"
"JH378118","29518409","29518726","KQ058184v1","1505565","1505858","74","28012844"
"JH378118","29668546","29668689","KQ053191v1","655494","655627","44","29013052"
"JH378118","29772691","29772861","KQ056996v1","1524030","1524195","43","28248661"
"JH378118","29883121","29883252","KQ053774v1","406836","406969","37","29476285"
"JH378118","29966044","29966313","KQ055662v1","4683524","4683789","61","25282520"
"JH378118","30801186","30801341","KQ056147v1","2168964","2169108","33","28632222"
"JH378118","30861997","30862275","KQ058561v1","583947","584226","65","30278050"
"JH378118","31095402","31095593","KQ058272v1","4821532","4821718","43","26273870"
"JH378118","31501324","31501628","KQ058505v1","2273110","2273413","82","29228214"
"JH378118","31541801","31542070","KQ053299v1","22323868","22324139","68","9217933"
"JH378118","31624890","31625033","KQ055872v1","9395394","9395552","38","22229496"
"JH378118","31686662","31686944","KQ054412v1","2490468","2490761","73","29196194"
"JH378118","31703340","31703504","KQ057737v1","1426090","1426247","43","30277250"
"JH378118","31858502","31858783","KQ055978v1","3560415","3560681","74","28298087"
"JH378118","31890443","31890585","KQ057118v1","1492016","1492164","31","30398427"
"JH378118","32491779","32492075","KQ054400v1","354368","354668","65","32137411"
"JH378118","32751045","32751362","KQ054191v1","4157356","4157666","67","28593689"
"JH378118","32853950","32854226","KQ058316v1","1439391","1439671","65","31414559"
"JH378118","32894413","32894571","KQ052969v1","8430836","8430996","38","24463577"
"JH378118","33029629","33029910","KQ053190v1","4987885","4988162","63","28041744"
"JH378118","33232084","33232391","KQ054068v1","3341291","3341579","78","29890793"
"JH378118","33278004","33278292","KQ053409v1","3716306","3716585","82","29561698"
"JH378118","33495209","33495508","KQ056475v1","2179070","2179363","78","31316139"
"JH378118","33503939","33504124","KQ054576v1","2685252","2685406","55","30818687"
"JH378118","33587746","33588024","KQ055872v1","12608496","12608784","76","20979250"
"JH378118","33652604","33652920","KQ053409v1","6036210","6036520","67","27616394"
"JH378118","33759993","33760286","KQ054786v1","1481220","1481519","70","32278773"
"JH378118","34143730","34144036","KQ055141v1","1054026","1054336","72","33089704"
"JH378118","34445034","34445313","KQ053409v1","3716306","3716585","78","30728728"
"JH378118","34837059","34837350","KQ056827v1","803277","803578","73","34033782"
"JH378118","35413525","35413822","KQ053816v1","7045838","7046139","72","28367687"
"JH378118","35553038","35553308","KQ058184v1","1505565","1505858","79","34047473"
"JH378118","35651626","35651796","KQ058350v1","579975","580134","52","35071651"
"JH378118","35711764","35712047","KQ057875v1","469535","469791","73","35242229"
"JH378118","35870209","35870370","KQ054660v1","3603105","3603267","38","32267104"
"JH378118","36395672","36395974","KQ053299v1","11542441","11542747","73","24853231"
"JH378118","36798323","36798604","KQ058594v1","2023684","2023963","76","34774639"
"JH378118","36862730","36863040","KQ058290v1","511568","511873","80","36351162"
"JH378118","36943823","36943995","KQ052982v1","1147716","1147889","51","35796107"
"JH378118","36945163","36945258","KQ056147v1","1435797","1435892","25","35509366"
"JH378118","36955061","36955229","KQ054660v1","3679956","3680128","52","33275105"
"JH378118","37156947","37157024","KQ058076v1","120666","120729","22","37036281"
"JH378118","37157639","37157913","KQ055872v1","12987862","12988141","70","24169777"
"JH378119","83181","83326","KQ056234v1","2226010","2226149","30","2142829"
"JH378119","126896","127195","KQ058146v1","160981","161283","74","34085"
"JH378119","341302","341510","KQ054776v1","1314982","1315182","67","973680"
"JH378119","383187","383492","KQ054638v1","441089","441368","95","57902"
"JH378119","416885","417199","KQ054932v1","2493764","2494041","98","2076879"
"JH378119","518393","518550","KQ052968v1","8575658","8575813","33","8057265"
"JH378119","657907","658200","KQ053476v1","1197230","1197485","108","539323"
"JH378119","760037","760189","KQ052970v1","10856401","10856550","31","10096364"
"JH378119","1167903","1168077","KQ053179v1","1735404","1735576","43","567501"
"JH378119","1361303","1361436","KQ054279v1","76889","77022","24","1284414"
"JH378119","2158236","2158541","KQ053816v1","7464708","7465010","62","5306472"
"JH378119","2203807","2204087","KQ053146v1","2819587","2819868","59","615780"
"JH378119","2352223","2352497","KQ055872v1","4131960","4132231","77","1779737"
"JH378119","2353383","2353500","KQ056864v1","346785","346900","34","2006598"
"JH378119","2362693","2363002","KQ055706v1","457678","457979","73","1905015"
"JH378119","2438735","2438859","KQ055498v1","20783","20899","27","2417952"
"JH378119","2456839","2457099","KQ055872v1","12987862","12988141","73","10531023"
"JH378119","2557116","2557302","KQ056423v1","1148199","1148381","45","1408917"
"JH378119","3019593","3019750","KQ055872v1","5870772","5870928","39","2851179"
"JH378119","4739812","4740061","KQ054693v1","3245566","3245803","68","1494246"
"JH378119","5124897","5125220","KQ056928v1","1915686","1915996","75","3209211"
"JH378119","5238378","5238678","KQ058290v1","511568","511873","71","4726810"
"JH378119","5297056","5297191","KQ058483v1","5373223","5373356","20","76167"
"JH378119","5625059","5625292","KQ053654v1","3892663","3892904","77","1732396"
"JH378119","5698264","5698555","KQ058004v1","753396","753688","63","4944868"
"JH378119","5962485","5962715","KQ054827v1","2292729","2292949","61","3669756"
"JH378119","6034761","6035038","KQ055065v1","999059","999338","66","5035702"
"JH378119","6036339","6036639","KQ055087v1","1205525","1205826","57","4830814"
"JH378119","6191755","6192053","KQ055097v1","1884579","1884874","61","4307176"
"JH378119","6302147","6302401","KQ052971v1","6441372","6441626","67","139225"
"JH378119","6331326","6331585","KQ055035v1","3353120","3353360","79","2978206"
"JH378119","6411484","6411594","KQ054091v1","1562507","1562616","33","4848977"
"JH378119","6943651","6943930","KQ057488v1","888509","888773","83","6055142"
"JH378119","7123366","7123690","KQ056093v1","1723775","1724065","101","5399591"
"JH378119","7135341","7135476","KQ053971v1","2520321","2520463","38","4615020"
"JH378119","7137708","7137849","KQ052970v1","12609564","12609700","30","5471856"
"JH378119","7161377","7161649","KQ055662v1","4683524","4683789","66","2477853"
"JH378119","7254722","7255020","KQ054069v1","7687863","7688158","67","433141"
"JH378119","7487162","7487457","KQ053190v1","5495992","5496283","57","1991170"
"JH378119","7648625","7648918","KQ057290v1","2180782","2181079","72","5467843"
"JH378119","7730478","7730633","KQ055735v1","2321269","2321424","39","5409209"
"JH378119","8177644","8177943","KQ054356v1","787783","788076","72","7389861"
"JH378119","8327497","8327787","KQ058438v1","548495","548786","80","7779002"
"JH378119","9034931","9035070","KQ055404v1","2665938","2666066","36","6368993"
"JH378119","9355107","9355391","KQ054826v1","7957748","7958033","72","1397359"
"JH378119","9706684","9706939","KQ053631v1","8205336","8205582","66","1501348"
"JH378119","10053195","10053510","KQ056928v1","1915686","1915996","75","8137509"
"JH378119","10131804","10131940","KQ054069v1","2479321","2479456","30","7652483"
"JH378119","10297069","10297202","KQ053202v1","780148","780280","31","9516921"
"JH378119","10414668","10414911","KQ054725v1","1394675","1394915","70","9019993"
"JH378119","10503827","10504121","KQ053948v1","2955232","2955526","66","7548595"
"JH378119","10528064","10528350","KQ058291v1","836930","837225","67","9691134"
"JH378119","10677411","10677588","KQ053685v1","16639","16818","38","10660772"
"JH378119","10957848","10958146","KQ058184v1","1505565","1505858","66","9452283"
"JH378119","10972483","10972793","KQ052981v1","1198440","1198752","79","9774043"
"JH378119","11152946","11153249","KQ053816v1","7327018","7327317","71","3825928"
"JH378119","11258674","11258865","KQ054191v1","1574522","1574711","50","9684152"
"JH378119","11396766","11397075","KQ055004v1","332895","333205","71","11063871"
"JH378119","12398905","12399198","KQ054660v1","4800585","4800872","62","7598320"
"JH378119","12494632","12494918","KQ054510v1","940143","940436","69","11554489"
"JH378119","12654042","12654160","KQ055141v1","2421865","2421977","26","10232177"
"JH378119","12828620","12828903","KQ053190v1","1299491","1299778","59","11529129"
"JH378119","13213809","13214104","KQ058094v1","7832529","7832815","76","5381280"
"JH378119","13216744","13217028","KQ058353v1","1264780","1265071","68","11951964"
"JH378119","13258145","13258322","KQ053774v1","1982290","1982469","46","11275855"
"JH378119","13272835","13273175","KQ053168v1","173562","173900","105","13099273"
"JH378119","13517268","13517560","KQ055787v1","1064992","1065293","57","12452276"
"JH378119","13619274","13619581","KQ058184v1","1505565","1505858","65","12113709"
"JH378119","13940043","13940212","KQ052970v1","4434435","4434604","45","9505608"
"JH378119","13941801","13942081","KQ055808v1","115144","115414","76","13826657"
"JH378119","13975828","13976119","KQ052968v1","11214344","11214622","65","2761484"
"JH378119","14018390","14018545","KQ057737v1","1426090","1426247","32","12592300"
"JH378119","14175359","14175650","KQ053465v1","3818784","3819069","63","10356575"
"JH378119","14465232","14465447","KQ058305v1","3932993","3933212","71","10532239"
"JH378119","14488061","14488225","KQ056996v1","1524030","1524195","30","12964031"
"JH378119","14981099","14981325","KQ055352v1","4410547","4410789","78","10570552"
"JH378119","15190086","15190383","KQ054932v1","4838112","4838407","74","10351974"
"JH378119","15620037","15620307","KQ058594v1","5996843","5997124","71","9623194"
"JH378119","15632684","15632878","KQ053223v1","773388","773584","58","14859296"
"JH378119","15720347","15720567","KQ054069v1","159011","159235","51","15561336"
"JH378119","15817795","15818092","KQ057648v1","78808","79100","81","15738987"
"JH378119","15924211","15924513","KQ054069v1","955693","955974","85","14968518"
"JH378119","16537849","16538157","KQ058184v1","1505565","1505858","76","15032284"
"JH378119","16749653","16749907","KQ055735v1","1032075","1032317","64","15717578"
"JH378119","16898219","16898497","KQ058427v1","4553509","4553777","60","12344710"
"JH378119","17090835","17091088","KQ055629v1","27732","27989","70","17063103"
"JH378119","17173038","17173338","KQ056456v1","918897","919186","79","16254141"
"JH378119","17755193","17755473","KQ052968v1","13260777","13261056","79","4494416"
"JH378119","17795236","17795522","KQ056147v1","1064032","1064323","77","16731204"
"JH378119","17998893","17999195","KQ053816v1","7464708","7465010","73","10534185"
"JH378119","18182258","18182374","KQ056527v1","169","285","34","18182089"
"JH378119","18407709","18407983","KQ054510v1","5210888","5211157","67","13196821"
"JH378119","19186489","19186781","KQ055490v1","2107132","2107421","68","17079357"
"JH378119","19265224","19265383","KQ056996v1","1524030","1524195","40","17741194"
"JH378119","19274792","19275068","KQ053631v1","9963313","9963601","80","9311479"
"JH378119","19403965","19404267","KQ054213v1","780092","780393","72","18623873"
"JH378119","19458326","19458622","KQ052968v1","5470311","5470611","75","13988015"
"JH378119","19751766","19752078","KQ058184v1","1505565","1505858","64","18246201"
"JH378119","19792614","19792919","KQ054290v1","1454980","1455264","77","18337634"
"JH378119","20071251","20071542","KQ054565v1","6091969","6092246","71","13979282"
"JH378119","20088487","20088758","KQ058004v1","3112196","3112474","74","16976291"
"JH378119","20993502","20993779","KQ056440v1","448517","448809","65","20544985"
"JH378119","21190603","21190883","KQ053146v1","2819587","2819868","63","18371016"
"JH378119","21331343","21331663","KQ058317v1","2976228","2976549","87","18355115"
"JH378119","21350133","21350418","KQ055735v1","667472","667747","81","20682661"
"JH378119","21419491","21419563","KQ054533v1","1814787","1814857","19","19604704"
"JH378119","21588650","21588951","KQ056672v1","3082150","3082439","66","18506500"
"JH378119","21736158","21736462","KQ053554v1","2471177","2471484","72","19264981"
"JH378119","21903964","21904282","KQ054932v1","4699407","4699723","76","17204557"
"JH378119","22040479","22040791","KQ054713v1","2696056","2696350","84","19344423"
"JH378119","22684037","22684317","KQ053565v1","754705","754987","75","21929332"
"JH378119","22685651","22685806","KQ057118v1","1492016","1492164","36","21193635"
"JH378119","23081157","23081269","KQ057449v1","2012727","2012843","31","21068430"
"JH378119","23086219","23086480","KQ057373v1","517182","517448","76","22569037"
"JH378119","23090373","23090680","KQ058288v1","34632","34947","78","23055741"
"JH378119","23099490","23099643","KQ054826v1","9847228","9847399","56","13252262"
"JH378119","23133518","23133780","KQ052969v1","11182978","11183250","65","11950540"
"JH378119","23160220","23160485","KQ056493v1","3873865","3874113","66","19286355"
"JH378119","23219107","23219194","KQ055978v1","4006864","4006954","19","19212243"
"JH378119","23244233","23244306","KQ053398v1","2188132","2188206","27","21056101"
"JH378119","23244574","23244714","KQ054279v1","76889","77022","28","23167685"
"JH378119","23266916","23267224","KQ053398v1","2431232","2431537","69","20835684"
"JH378119","23279383","23279698","KQ056928v1","2385460","2385767","74","20893923"
"JH378119","23373443","23373606","KQ052969v1","8430836","8430996","38","14942607"
"JH378119","23893126","23893281","KQ058461v1","2122434","2122581","41","21770692"
"JH378119","24021304","24021430","KQ056101v1","1575504","1575620","32","22445800"
"JH378119","24320704","24321014","KQ053620v1","156684","156991","73","24164020"
"JH378119","24666838","24666946","KQ054921v1","165725","165837","26","24501113"
"JH378119","24806195","24806494","KQ054191v1","3583730","3584032","75","21222465"
"JH378119","25211596","25211867","KQ058394v1","15350086","15350346","70","9861510"
"JH378119","25288588","25288721","KQ053299v1","6849474","6849602","22","18439114"
"JH378119","25294531","25294638","KQ057023v1","274419","274523","32","25020112"
"JH378119","25416791","25417098","KQ053299v1","4095914","4096215","63","21320877"
"JH378119","25692423","25692721","KQ055767v1","2455394","2455703","79","23237029"
"JH378119","25868895","25869188","KQ057560v1","2450216","2450512","67","23418679"
"JH378119","26010553","26010684","KQ055352v1","6062328","6062459","43","19948225"
"JH378119","26012499","26012766","KQ057938v1","232934","233198","72","25779565"
"JH378119","26049225","26049392","KQ055014v1","15960","16127","38","26033265"
"JH378119","26095722","26095965","KQ058372v1","2892778","2893032","71","23202944"
"JH378119","26284881","26285167","KQ057345v1","1425121","1425407","86","24859760"
"JH378119","26308725","26308984","KQ055394v1","2461651","2461910","54","23847074"
"JH378119","26310120","26310417","KQ053409v1","6051156","6051445","65","20258964"
"JH378119","26350373","26350669","KQ055479v1","1841725","1842025","66","24508648"
"JH378119","26474230","26474516","KQ054356v1","180957","181232","70","26293273"
"JH378119","26513728","26514030","KQ056928v1","332602","332898","76","26181126"
"JH378119","26533237","26533465","KQ054279v1","1133071","1133299","51","25400166"
"JH378119","26558085","26558327","KQ055518v1","1576074","1576315","62","24982011"
"JH378119","26581998","26582119","KQ056973v1","1508744","1508869","31","25073254"
"JH378119","26635751","26636039","KQ055364v1","1103430","1103723","70","25532321"
"JH378119","26671784","26672095","KQ058377v1","25815","26128","71","26645969"
"JH378119","26676000","26676168","KQ056996v1","1524030","1524195","31","25151970"
"JH378119","26684093","26684306","KQ057664v1","525813","526016","46","26158280"
"JH378119","26688809","26689100","KQ052969v1","8045253","8045541","61","18643556"
"JH378119","26709202","26709337","KQ056855v1","2808237","2808368","32","23900965"
"JH378119","26712261","26712403","KQ055872v1","5870772","5870928","44","20841489"
"JH378119","26718245","26718537","KQ056331v1","1501968","1502262","65","25216277"
"JH378119","26849045","26849194","KQ053300v1","3146249","3146389","35","23702796"
"JH378119","26877430","26877568","KQ053115v1","1650505","1650644","25","25226925"
"JH378119","26955082","26955373","KQ053288v1","2218996","2219287","71","24736086"
"JH378119","26976565","26976864","KQ053554v1","1157184","1157483","64","25819381"
"JH378119","26996013","26996214","KQ057560v1","1700424","1700630","58","25295589"
"JH378119","27047452","27047712","KQ054068v1","2000305","2000565","60","25047147"
"JH378119","27101503","27101802","KQ053190v1","5623449","5623748","66","21478054"
"JH378119","27126816","27127094","KQ054826v1","7957748","7958033","70","19169068"
"JH378119","27199284","27199581","KQ053288v1","2218996","2219287","75","24980288"
"JH378119","27361538","27361850","KQ053398v1","2816605","2816914","68","24544933"
"JH378119","27464482","27464607","KQ056293v1","110261","110385","26","27354221"
"JH378119","27467367","27467668","KQ058184v1","1505565","1505858","65","25961802"
"JH378119","27566335","27566530","KQ053565v1","3764313","3764506","51","23802022"
"JH378119","27691594","27691909","KQ055247v1","4718622","4718934","74","22972972"
"JH378119","28425953","28426085","KQ058427v1","4756553","4756686","23","23669400"
"JH378119","28511806","28512098","KQ054693v1","1429670","1429955","68","27082136"
"JH378119","28533018","28533241","KQ054378v1","2101845","2102077","65","26431173"
"JH378119","28549377","28549511","KQ053115v1","1333586","1333718","24","27215791"
"JH378119","28573477","28573616","KQ053004v1","3051555","3051691","24","25521922"
"JH378119","28615564","28615845","KQ058625v1","340677","340961","77","28274887"
"JH378119","28641726","28642010","KQ053520v1","456408","456696","67","28185318"
"JH378119","28654353","28654652","KQ058184v1","1505565","1505858","55","27148788"
"JH378119","28753679","28753805","KQ057036v1","663657","663784","27","28090022"
"JH378119","28774896","28775159","KQ058583v1","1187997","1188260","71","27586899"
"JH378119","28962235","28962367","KQ057883v1","1224468","1224597","24","27737767"
"JH378119","29219442","29219593","KQ053190v1","2372433","2372579","42","26847009"
"JH378119","29544328","29544616","KQ057045v1","590946","591241","72","28953382"
"JH378119","29596987","29597290","KQ054213v1","780092","780393","59","28816895"
"JH378119","29760106","29760399","KQ058316v1","1400358","1400649","77","28359748"
"JH378119","29906635","29906767","KQ056404v1","1195188","1195317","17","28711447"
"JH378119","30158104","30158250","KQ053190v1","2372433","2372579","36","27785671"
"JH378119","30172547","30172697","KQ057204v1","3219950","3220097","34","26952597"
"JH378119","30211036","30211326","KQ058272v1","5519908","5520197","65","24691128"
"JH378119","30230980","30231252","KQ058004v1","1480411","1480689","64","28750569"
"JH378119","30234572","30234626","KQ053620v1","1104065","1104117","11","29130507"
"JH378119","30466301","30466468","KQ057737v1","1426090","1426247","41","29040211"
"JH378119","30585180","30585492","KQ054943v1","2938380","2938687","77","27646800"
"JH378119","31299914","31300203","KQ055248v1","947170","947461","54","30352744"
"JH378119","31674867","31675150","KQ054932v1","10830322","10830609","63","20844545"
"JH378119","31930859","31931125","KQ055014v1","250838","251107","66","31680021"
"JH378119","31943269","31943561","KQ056643v1","431969","432259","64","31511300"
"JH378119","31999412","31999542","KQ054565v1","5438306","5438438","31","26561106"
"JH378119","32019230","32019536","KQ058184v1","1505565","1505858","68","30513665"
"JH378119","32026896","32027185","KQ054693v1","832788","833076","68","31194108"
"JH378119","32044445","32044571","KQ055957v1","66304","66434","30","31978141"
"JH378119","32132708","32132873","KQ054510v1","2373994","2374175","48","29758714"
"JH378119","32191766","32191891","KQ053409v1","6105325","6105446","23","26086441"
"JH378119","32193651","32193937","KQ058438v1","548495","548786","64","31645156"
"JH378119","32198714","32198892","KQ056587v1","7602017","7602187","42","24596697"
"JH378119","32198995","32199102","KQ053310v1","1622751","1622859","19","30576244"
"JH378119","32217000","32217294","KQ052968v1","8311259","8311538","79","23905741"
"JH378119","32222253","32222473","KQ053632v1","278979","279203","65","31943274"
"JH378119","32235876","32235982","KQ058050v1","918290","918400","20","31317586"
"JH378119","32516006","32516172","KQ055014v1","682174","682339","39","31833832"
"JH378119","32574838","32575120","KQ052968v1","13260777","13261056","52","19314061"
"JH378119","32595620","32595869","KQ053310v1","2851403","2851646","65","29744217"
"JH378119","32689778","32690029","KQ053299v1","3021609","3021869","72","29668169"
"JH378119","32928269","32928576","KQ058184v1","1505565","1505858","65","31422704"
"JH378119","33043123","33043418","KQ058242v1","722153","722450","77","32320970"
"JH378119","33046120","33046393","KQ058275v1","938649","938919","63","32107471"
"JH378119","33144145","33144415","KQ056663v1","500658","500926","75","32643487"
"JH378119","33261587","33261904","KQ056331v1","1886723","1887024","68","31374864"
"JH378119","33357293","33357552","KQ057345v1","1938824","1939073","58","31418469"
"JH378119","33384315","33384617","KQ053554v1","2471177","2471484","65","30913138"
"JH378119","33437464","33437769","KQ058288v1","34632","34947","67","33402832"
"JH378119","33455449","33455756","KQ058315v1","658193","658490","64","32797256"
"JH378119","33702840","33703082","KQ053082v1","7643617","7643861","58","26059223"
"JH378119","33980663","33980948","KQ055468v1","1908448","1908731","61","32072215"
"JH378119","33983635","33983740","KQ053850v1","279389","279490","17","33704246"
"JH378119","34024270","34024431","KQ053115v1","1650505","1650644","41","32373765"
"JH378119","34024766","34024936","KQ055457v1","11733685","11733859","49","22291081"
"JH378119","34043476","34043708","KQ054565v1","5770490","5770715","52","28272986"
"JH378119","35477526","35477658","KQ055457v1","9630773","9630904","33","25846753"
"JH378119","35486365","35486627","KQ058321v1","21060","21321","66","35465305"
"JH378119","36079676","36079888","KQ054827v1","2292729","2292949","78","33786947"
"JH378120","601557","601772","KQ053256v1","5123343","5123559","61","4521786"
"JH378120","696882","697191","KQ058539v1","1057985","1058283","61","361103"
"JH378120","803107","803391","KQ053299v1","16242688","16242978","62","15439581"
"JH378120","966736","967053","KQ053838v1","3013088","3013374","81","2046352"
"JH378120","968664","968950","KQ054660v1","2994204","2994490","71","2025540"
"JH378120","1183415","1183700","KQ053554v1","1121586","1121875","72","61829"
"JH378120","1243899","1244203","KQ058004v1","3883150","3883446","76","2639251"
"JH378120","1448094","1448304","KQ055014v1","599464","599668","50","848630"
"JH378120","1720712","1720909","KQ052969v1","8528994","8529192","45","6808282"
"JH378120","2004531","2004851","KQ058582v1","1599482","1599782","85","405049"
"JH378120","2048385","2048600","KQ058572v1","913074","913293","53","1135311"
"JH378120","2057926","2058242","KQ058320v1","1468489","1468793","72","589437"
"JH378120","2151010","2151146","KQ054682v1","2336064","2336208","36","185054"
"JH378120","2167002","2167274","KQ053631v1","9398334","9398603","78","7231332"
"JH378120","2458028","2458297","KQ053916v1","1741116","1741399","84","716912"
"JH378120","2501126","2501361","KQ057910v1","2769076","2769295","69","267950"
"JH378120","2557804","2558055","KQ054301v1","3391378","3391638","74","833574"
"JH378120","2626072","2626330","KQ053609v1","2550928","2551200","73","75144"
"JH378120","2709196","2709344","KQ053696v1","3211004","3211170","37","501808"
"JH378120","2839489","2839570","KQ054091v1","552694","552778","20","2286795"
"JH378120","2842219","2842480","KQ054932v1","1186473","1186736","67","1655746"
"JH378120","2952690","2952923","KQ057397v1","736284","736521","57","2216406"
"JH378120","2960680","2960995","KQ053093v1","1522159","1522464","76","1438521"
"JH378120","3011577","3011858","KQ053631v1","7288314","7288608","87","4276737"
"JH378120","3051287","3051568","KQ053883v1","3868605","3868876","74","817318"
"JH378120","3114588","3114842","KQ054069v1","928440","928688","61","2186148"
"JH378120","3159511","3159820","KQ058272v1","4942871","4943179","63","1783360"
"JH378120","3257466","3257671","KQ054921v1","3806549","3806756","50","549083"
"JH378120","3414832","3415096","KQ054367v1","3036352","3036606","61","378480"
"JH378120","3548895","3549198","KQ058184v1","1505565","1505858","63","2043330"
"JH378120","3573805","3574108","KQ058184v1","1505565","1505858","65","2068240"
"JH378120","3960541","3960834","KQ057118v1","4601602","4601894","68","641061"
"JH378120","4539100","4539468","KQ054704v1","223675","223980","109","4315425"
"JH378120","5066841","5067138","KQ052968v1","7064883","7065171","68","1998042"
"JH378120","5135722","5136009","KQ058427v1","5134091","5134389","74","1631"
"JH378120","5582954","5583261","KQ053409v1","6051156","6051445","72","468202"
"JH378120","5955336","5955586","KQ053135v1","4845077","4845313","67","1110259"
"JH378120","6111058","6111184","KQ056568v1","1536713","1536841","28","4574345"
"JH378120","6177435","6177720","KQ058275v1","201680","201968","71","5975755"
"JH378120","6264929","6265226","KQ055498v1","33918","34207","80","6231011"
"JH378120","6420892","6421163","KQ055662v1","4683524","4683789","59","1737368"
"JH378120","6475242","6475539","KQ053741v1","1482396","1482684","71","4992846"
"JH378120","6560885","6561159","KQ055394v1","3441211","3441489","71","3119674"
"JH378120","6574179","6574437","KQ055352v1","3968278","3968546","74","2605901"
"JH378120","6590843","6591099","KQ053135v1","6974800","6975038","68","383957"
"JH378120","6666272","6666453","KQ055404v1","2918950","2919115","48","3747322"
"JH378120","6666791","6666926","KQ053135v1","3210852","3210985","27","3455939"
"JH378120","6708575","6708849","KQ054510v1","9842754","9843031","67","3134179"
"JH378120","6790879","6790962","KQ055036v1","4936704","4936788","23","1854175"
"JH378120","6942770","6943060","KQ053070v1","4276457","4276735","74","2666313"
"JH378120","6968919","6969060","KQ057118v1","3875160","3875276","56","3093759"
"JH378120","6974137","6974433","KQ056093v1","2289180","2289470","79","4684957"
"JH378120","7477974","7478266","KQ058473v1","369163","369455","60","7108811"
"JH378120","7628921","7629198","KQ054745v1","919926","920212","62","6708995"
"JH378120","7712589","7712837","KQ055364v1","1832819","1833067","78","5879770"
"JH378120","7731174","7731430","KQ055662v1","4683524","4683789","73","3047650"
"JH378120","8278628","8278886","KQ053740v1","548757","549009","81","7729871"
"JH378120","8290479","8290793","KQ053409v1","5849852","5850162","76","2440627"
"JH378120","9097723","9098008","KQ053044v1","405596","405892","85","8692127"
"JH378120","9629016","9629146","KQ053256v1","1284266","1284394","27","8344750"
"JH378120","9722606","9722738","KQ053115v1","1333586","1333718","32","8389020"
"JH378120","9890136","9890458","KQ053816v1","7464708","7465010","61","2425428"
"JH378120","9913516","9913856","KQ053310v1","2634517","2634827","112","7278999"
"JH378120","10023667","10023744","KQ053432v1","5774004","5774087","22","4249663"
"JH378120","10103425","10103624","KQ053554v1","293392","293586","46","9810033"
"JH378120","10118167","10118467","KQ058328v1","6293951","6294242","66","3824216"
"JH378120","10191294","10191572","KQ058533v1","977692","977970","65","9213602"
"JH378120","10229773","10230030","KQ054826v1","303348","303596","73","9926425"
"JH378120","10321678","10321989","KQ056225v1","48046","48349","81","10273632"
"JH378120","10977108","10977260","KQ058405v1","1538334","1538484","33","9438774"
"JH378120","11505366","11505567","KQ052968v1","5592291","5592483","67","5913075"
"JH378120","11652519","11652819","KQ056148v1","4371920","4372216","78","7280599"
"JH378120","11670233","11670349","KQ056293v1","110261","110385","33","11559972"
"JH378120","11705681","11705977","KQ055468v1","2950644","2950940","75","8755037"
"JH378120","11707431","11707727","KQ058316v1","3211882","3212156","87","8495549"
"JH378120","11721239","11721529","KQ053299v1","21835674","21835971","66","10114435"
"JH378120","11818802","11819096","KQ055490v1","2107132","2107421","68","9711670"
"JH378120","11928815","11928996","KQ052969v1","8528994","8529192","66","3399821"
"JH378120","11929081","11929163","KQ053520v1","1561632","1561710","23","10367449"
"JH378120","11999657","11999928","KQ053520v1","2992926","2993205","70","9006731"
"JH378120","12025114","12025383","KQ054356v1","180957","181232","67","11844157"
"JH378120","12040127","12040388","KQ057909v1","12298038","12298291","74","257911"
"JH378120","12746444","12746607","KQ056965v1","118773","118937","35","12627671"
"JH378120","12922610","12922648","KQ058313v1","489758","489791","14","12432852"
"JH378120","13022917","13023187","KQ053520v1","2992926","2993205","64","10029991"
"JH378120","13036616","13036841","KQ054069v1","159011","159235","57","12877605"
"JH378120","13209772","13210025","KQ057848v1","1169962","1170222","64","12039810"
"JH378120","13257419","13257698","KQ057764v1","688152","688437","70","12569267"
"JH378120","13356649","13356783","KQ054113v1","1506620","1506744","37","11850029"
"JH378120","13591297","13591589","KQ053299v1","21835674","21835971","63","8244377"
"JH378120","13850798","13851091","KQ054693v1","832788","833076","66","13018010"
"JH378120","14047639","14047798","KQ056996v1","1524030","1524195","37","12523609"
"JH378120","15167602","15167881","KQ055119v1","2510369","2510631","79","12657233"
"JH378120","15189825","15190058","KQ055119v1","976180","976409","79","14213645"
"JH378120","15246694","15246823","KQ057488v1","512192","512325","29","14734502"
"JH378120","15307970","15308215","KQ054826v1","10613987","10614255","80","4693983"
"JH378120","15458745","15459040","KQ056147v1","266944","267241","66","15191801"
"JH378120","15460391","15460688","KQ055872v1","1927794","1928087","67","13532597"
"JH378120","15529282","15529584","KQ057045v1","590946","591241","64","14938336"
"JH378120","15575549","15575822","KQ058546v1","168071","168339","75","15407478"
"JH378120","15642702","15642993","KQ054693v1","1429670","1429955","66","14213032"
"JH378120","15867926","15868223","KQ053816v1","7464708","7465010","66","8403218"
"JH378120","16325294","16325594","KQ055852v1","1231373","1231668","65","15093921"
"JH378120","16478471","16478747","KQ058266v1","992042","992314","61","15486429"
"JH378120","16540830","16540957","KQ053300v1","2910811","2910928","39","13630019"
"JH378120","16542920","16543046","KQ053354v1","702320","702452","25","15840600"
"JH378120","16547998","16548094","KQ058253v1","973922","974008","34","15574076"
"JH378120","16554782","16554902","KQ056064v1","5108638","5108754","29","11446144"
"JH378120","16588749","16589039","KQ053157v1","7882293","7882588","65","8706456"
"JH378120","16608014","16608296","KQ056093v1","1723775","1724065","71","14884239"
"JH378120","16634911","16635054","KQ054179v1","3865170","3865294","33","12769741"
"JH378120","16801471","16801776","KQ058328v1","6293951","6294242","81","10507520"
"JH378120","16855230","16855515","KQ058190v1","350088","350375","65","16505142"
"JH378120","16858352","16858516","KQ053157v1","5478543","5478695","36","11379809"
"JH378120","16881111","16881383","KQ058550v1","2481462","2481746","75","14399649"
"JH378120","16885208","16885508","KQ053816v1","7464708","7465010","65","9420500"
"JH378120","16978942","16979114","KQ056996v1","1524030","1524195","38","15454912"
"JH378120","16997849","16998130","KQ058184v1","1505565","1505858","63","15492284"
"JH378120","17015084","17015242","KQ057308v1","82917","83077","29","16932167"
"JH378120","17174262","17174550","KQ053146v1","2819587","2819868","73","14354675"
"JH378120","17361742","17362011","KQ053696v1","1946341","1946596","80","15415401"
"JH378120","17640822","17640942","KQ058530v1","227142","227264","31","17413680"
"JH378120","17908008","17908264","KQ055141v1","1531345","1531592","53","16376663"
"JH378120","18000389","18000676","KQ053816v1","7438202","7438483","73","10562187"
"JH378120","18192550","18192800","KQ053223v1","1280256","1280511","67","16912294"
"JH378120","19427159","19427364","KQ053774v1","1982290","1982469","59","17444869"
"JH378120","19641713","19642023","KQ055872v1","3755827","3756146","80","15885886"
"JH378120","19658451","19658603","KQ053260v1","251013","251153","31","19407438"
"JH378120","19984058","19984263","KQ058242v1","892038","892246","55","19092020"
"JH378120","20456738","20457010","KQ054191v1","2440489","2440756","88","18016249"
"JH378120","20677685","20677998","KQ053554v1","2471177","2471484","79","18206508"
"JH378120","20841080","20841396","KQ058184v1","1505565","1505858","89","19335515"
"JH378120","21072818","21073115","KQ053299v1","4095914","4096215","61","16976904"
"JH378120","21342044","21342189","KQ056147v1","2168964","2169108","34","19173080"
"JH378120","21348843","21348951","KQ055808v1","1908479","1908585","29","19440364"
"JH378120","21491918","21492219","KQ053783v1","73311","73618","71","21418607"
"JH378120","21571966","21572288","KQ053115v1","3485337","3485650","94","18086629"
"JH378120","21669094","21669395","KQ058631v1","330883","331189","70","21338211"
"JH378120","21801989","21802265","KQ054058v1","1511559","1511832","76","20290430"
"JH378120","21818127","21818417","KQ053686v1","2863017","2863313","80","18955110"
"JH378120","22168259","22168538","KQ053093v1","1375309","1375598","76","20792950"
"JH378120","22296383","22296683","KQ053465v1","167701","167983","74","22128682"
"JH378120","22618108","22618373","KQ055662v1","5484080","5484349","76","17134028"
"JH378120","23292523","23292802","KQ052968v1","10629964","10630247","75","12662559"
"JH378120","23483094","23483322","KQ057345v1","1938824","1939073","75","21544270"
"JH378120","23971120","23971239","KQ054179v1","3865170","3865294","22","20105950"
"JH378120","24191725","24191886","KQ056663v1","1268814","1268972","37","22922911"
"JH378120","24227816","24228125","KQ058372v1","1134128","1134432","63","23093688"
"JH378120","24430286","24430580","KQ058594v1","1719198","1719477","75","22711088"
"JH378120","24466324","24466607","KQ058184v1","1505565","1505858","64","22960759"
"JH378120","24539850","24540019","KQ055589v1","815","963","52","24539035"
"JH378120","24704573","24704850","KQ055808v1","339221","339505","68","24365352"
"JH378120","24745132","24745273","KQ053654v1","4929533","4929667","26","19815599"
"JH378120","24802387","24802509","KQ053916v1","2379880","2380005","34","22422507"
"JH378120","24963540","24963663","KQ053543v1","1868215","1868343","25","23095325"
"JH378120","25134168","25134441","KQ055331v1","476282","476544","67","24657886"
"JH378120","25910120","25910383","KQ055055v1","1882469","1882726","68","24027651"
"JH378120","25971712","25971990","KQ058394v1","9107761","9108054","68","16863951"
"JH378120","26039717","26039821","KQ053005v1","324436","324539","24","25715281"
"JH378120","26280423","26280582","KQ055425v1","1445594","1445758","33","24834829"
"JH378120","26789605","26789928","KQ053816v1","7327018","7327317","91","19462587"
"JH378120","26880732","26880946","KQ054826v1","9981760","9981967","57","16898972"
"JH378120","26881081","26881141","KQ058483v1","4491053","4491121","23","22390028"
"JH378120","27377818","27378117","KQ053554v1","2471177","2471484","67","24906641"
"JH378120","28483801","28484072","KQ053409v1","3716306","3716585","67","24767495"
"JH378120","28560511","28560788","KQ053520v1","482516","482787","76","28077995"
"JH378120","29142585","29142643","KQ053620v1","1104065","1104117","12","28038520"
"JH378120","29323077","29323361","KQ053654v1","820983","821268","66","28502094"
"JH378120","29840472","29840757","KQ054124v1","2442155","2442433","66","27398317"
"JH378120","29963790","29964099","KQ055706v1","457678","457979","82","29506112"
"JH378120","30150998","30151217","KQ058004v1","2720169","2720394","59","27430829"
"JH378120","30180769","30180988","KQ053115v1","723349","723574","62","29457420"
"JH378120","30187295","30187508","KQ053398v1","3158290","3158500","52","27029005"
"JH378120","30190026","30190320","KQ055883v1","292153","292441","74","29897873"
"JH378120","30235087","30235235","KQ054606v1","554177","554332","47","29680910"
"JH378120","30375962","30376253","KQ054290v1","1454980","1455264","57","28920982"
"JH378120","30509537","30509811","KQ057397v1","335976","336255","68","30173561"
"JH378120","30584979","30585273","KQ053894v1","1005022","1005317","69","29579957"
"JH378120","30753517","30753748","KQ052982v1","3633817","3634050","58","27119700"
"JH378120","30763346","30763614","KQ058283v1","3525175","3525450","71","27238171"
"JH378120","30951045","30951266","KQ053631v1","8821839","8822058","54","22129206"
"JH378120","31086236","31086488","KQ054401v1","734156","734406","58","30352080"
"JH378120","31423291","31423583","KQ057045v1","590946","591241","79","30832345"
"JH378120","31431150","31431445","KQ056475v1","14677","14970","78","31416473"
"JH378120","31961471","31961575","KQ052969v1","2661859","2661968","21","29299612"
"JH378120","32168159","32168331","KQ058550v1","4456971","4457134","49","27711188"
"JH378120","32653550","32653829","KQ053278v1","563031","563302","73","32090519"
"JH378120","32681786","32682048","KQ053740v1","548757","549009","81","32133029"
"JH378120","32801654","32801925","KQ052971v1","202363","202645","73","32599291"
"JH378120","32827750","32827882","KQ053861v1","8359","8490","24","32819391"
"JH378120","32889564","32889855","KQ058394v1","9107761","9108054","63","23781803"
"JH378121","27787143","27787427","KQ053465v1","403029","403303","58","27384114"
"JH378121","252999","253301","KQ055457v1","7311489","7311771","78","7058490"
"JH378121","342388","342684","KQ055674v1","707314","707618","76","364926"
"JH378121","466392","466715","KQ053135v1","3156167","3156481","76","2689775"
"JH378121","502617","502874","KQ055055v1","1882469","1882726","66","1379852"
"JH378121","1071457","1071790","KQ058184v1","1505565","1505858","80","434108"
"JH378121","1276712","1277003","KQ054693v1","832788","833076","76","443924"
"JH378121","2274117","2274327","KQ055375v1","2261003","2261228","69","13114"
"JH378121","2994633","2994781","KQ053026v1","1335920","1336065","34","1658713"
"JH378121","3040139","3040396","KQ057345v1","1938824","1939073","55","1101315"
"JH378121","3069575","3069860","KQ055872v1","1813173","1813459","70","1256402"
"JH378121","3312588","3312896","KQ053476v1","4437256","4437557","71","1124668"
"JH378121","3726208","3726338","KQ053191v1","655494","655627","25","3070714"
"JH378121","3877360","3877543","KQ055629v1","4964425","4964609","45","1087065"
"JH378121","4792355","4792654","KQ055883v1","292153","292441","72","4500202"
"JH378121","5057326","5057428","KQ055872v1","5141445","5141541","25","84119"
"JH378121","5075866","5076163","KQ058328v1","6293951","6294242","69","1218085"
"JH378121","5110369","5110583","KQ058537v1","27912","28129","78","5082457"
"JH378121","6197178","6197426","KQ055173v1","452351","452623","67","5744827"
"JH378121","6744541","6744837","KQ055872v1","3185791","3186084","70","3558750"
"JH378121","7842646","7842794","KQ054412v1","2185013","2185160","34","5657633"
"JH378121","8336822","8337104","KQ055872v1","12987862","12988141","75","4651040"
"JH378121","8427160","8427374","KQ053741v1","1190544","1190756","51","7236616"
"JH378121","9166729","9166874","KQ057204v1","3219950","3220097","35","5946779"
"JH378121","9422019","9422237","KQ058505v1","2234909","2235124","46","7187110"
"JH378121","9466983","9467286","KQ058539v1","727698","728007","76","8739285"
"JH378121","9578943","9579242","KQ054693v1","837377","837666","74","8741566"
"JH378121","10167923","10168214","KQ052970v1","11462392","11462680","74","1294469"
"JH378121","10482134","10482256","KQ053718v1","316226","316356","25","10165908"
"JH378121","10482286","10482390","KQ053256v1","5132292","5132396","27","5349994"
"JH378121","10498338","10498625","KQ054932v1","10830322","10830609","70","331984"
"JH378121","10689914","10690069","KQ056148v1","7050287","7050441","40","3639627"
"JH378121","10845183","10845431","KQ056762v1","813232","813494","80","10031951"
"JH378121","11072019","11072173","KQ057737v1","1426090","1426247","33","9645929"
"JH378121","11342767","11343031","KQ058350v1","7145635","7145904","69","4197132"
"JH378121","12074357","12074617","KQ057781v1","739257","739515","79","11335100"
"JH378121","12513272","12513547","KQ055978v1","3560415","3560681","73","8952857"
"JH378121","12692802","12692854","KQ055648v1","977","1030","19","12691825"
"JH378121","12944132","12944263","KQ053763v1","4935139","4935266","31","8008993"
"JH378121","13206856","13207152","KQ057737v1","4424765","4425071","79","8782091"
"JH378121","13233906","13234207","KQ057045v1","590946","591241","79","12642960"
"JH378121","14736384","14736517","KQ052970v1","12418764","12418905","32","2317620"
"JH378121","15299114","15299280","KQ053082v1","2181762","2181924","41","13117352"
"JH378121","15439921","15440214","KQ055468v1","2950644","2950940","68","12489277"
"JH378121","16080292","16080587","KQ053631v1","8322466","8322756","60","7757826"
"JH378121","16183861","16184080","KQ053631v1","8821839","8822058","53","7362022"
"JH378121","16234279","16234582","KQ058184v1","1505565","1505858","70","14728714"
"JH378121","16319199","16319485","KQ054400v1","2791993","2792290","72","13527206"
"JH378121","16500511","16500787","KQ053476v1","1675362","1675619","71","14825149"
"JH378121","16504274","16504521","KQ058389v1","2110988","2111239","66","14393286"
"JH378121","16524412","16524462","KQ057909v1","13231474","13231525","10","3292938"
"JH378121","16697844","16698106","KQ053631v1","9398334","9398603","63","7299510"
"JH378121","17183186","17183449","KQ055629v1","27732","27989","69","17155454"
"JH378121","17196984","17197240","KQ058405v1","1047675","1047942","76","16149309"
"JH378121","17289298","17289467","KQ054652v1","6051","6229","41","17283247"
"JH378121","17289726","17289855","KQ058004v1","2748482","2748614","25","14541244"
"JH378121","17457346","17457613","KQ056800v1","725015","725272","61","16732331"
"JH378121","17470906","17471176","KQ058379v1","21379","21640","68","17449527"
"JH378121","18240593","18240865","KQ058383v1","2699813","2700083","74","15540780"
"JH378121","18270017","18270145","KQ052968v1","9760638","9760766","30","8509379"
"JH378121","18717324","18717598","KQ053609v1","2550928","2551200","72","16166396"
"JH378121","18847411","18847587","KQ053288v1","1003387","1003559","31","17844024"
"JH378121","18865103","18865449","KQ054224v1","719168","719494","90","18145935"
"JH378121","18910530","18910840","KQ053861v1","1997327","1997639","72","16913203"
"JH378121","18918065","18918289","KQ054704v1","483937","484161","62","18434128"
"JH378121","18958211","18958508","KQ058184v1","1505565","1505858","70","17452646"
"JH378121","19564958","19565111","KQ058345v1","136254","136406","40","19428704"
"JH378121","19614128","19614413","KQ055798v1","887234","887524","69","18726894"
"JH378121","19649223","19649410","KQ052969v1","10193825","10193991","47","9455398"
"JH378121","19732853","19732964","KQ058317v1","3398622","3398723","25","16334231"
"JH378121","19784417","19784717","KQ058184v1","1505565","1505858","57","18278852"
"JH378121","19999634","19999956","KQ053343v1","1747702","1748011","86","18251932"
"JH378121","20278658","20278942","KQ053838v1","3013088","3013374","64","17265570"
"JH378121","20346238","20346551","KQ058184v1","1505565","1505858","65","18840673"
"JH378121","20462933","20463058","KQ053686v1","1108593","1108721","36","19354340"
"JH378121","20470914","20471062","KQ054510v1","8179279","8179421","41","12291635"
"JH378121","20486960","20487121","KQ057603v1","1535538","1535702","36","18951422"
"JH378121","20548215","20548495","KQ057931v1","399684","399967","71","20148531"
"JH378121","20732652","20732949","KQ055097v1","1884579","1884874","62","18848073"
"JH378121","20756198","20756366","KQ058571v1","931737","931906","35","19824461"
"JH378121","20862092","20862323","KQ053354v1","1943191","1943424","46","18918901"
"JH378121","21048710","21048903","KQ054180v1","1190446","1190628","50","19858264"
"JH378121","21079559","21079649","KQ053565v1","3764807","3764898","24","17314752"
"JH378121","21079852","21080041","KQ058313v1","3551894","3552068","50","17527958"
"JH378121","21137277","21137569","KQ056234v1","2521120","2521411","77","18616157"
"JH378121","21504110","21504409","KQ053115v1","1118362","1118655","72","20385748"
"JH378121","22143534","22143702","KQ055119v1","165476","165630","45","21978058"
"JH378121","22143846","22143923","KQ055946v1","371653","371727","20","21772193"
"JH378121","22740083","22740271","KQ054533v1","2294255","2294433","63","20445828"
"JH378121","23095468","23095747","KQ058094v1","6015552","6015834","72","17079916"
"JH378121","23414899","23415200","KQ053343v1","1729289","1729583","62","21685610"
"JH378121","23459821","23460102","KQ055036v1","1971125","1971407","58","21488696"
"JH378121","23486871","23487170","KQ055236v1","2049624","2049930","56","21437247"
"JH378121","23838438","23838742","KQ058184v1","1505565","1505858","58","22332873"
"JH378121","24311409","24311732","KQ052970v1","10427454","10427754","81","13883955"
"JH378121","24405343","24405646","KQ058184v1","1505565","1505858","55","22899778"
"JH378121","24475892","24476153","KQ052970v1","21565783","21566032","69","2910109"
"JH378121","24564159","24564411","KQ058288v1","54043","54290","80","24510116"
"JH378121","25050387","25050599","KQ056074v1","244831","245053","53","24805556"
"JH378121","25404089","25404416","KQ053157v1","3524179","3524481","97","21879910"
"JH378121","25550453","25550730","KQ055662v1","2337496","2337760","80","23212957"
"JH378121","25728689","25728953","KQ053409v1","5686466","5686740","74","20042223"
"JH378121","26009678","26009816","KQ055097v1","2621016","2621150","34","23388662"
"JH378121","26373371","26373662","KQ056234v1","2476692","2476974","85","23896679"
"JH378121","26595640","26595888","KQ053740v1","548757","549009","69","26046883"
"JH378121","27054216","27054508","KQ058594v1","2023684","2023963","73","25030532"
"JH378121","27156832","27157010","KQ054202v1","2644235","2644413","52","24512597"
"JH378121","27171756","27172027","KQ052968v1","13260777","13261056","63","13910979"
"JH378121","27202851","27202989","KQ054135v1","1889077","1889201","45","25313774"
"JH378121","27308295","27308604","KQ058585v1","580456","580763","70","26727839"
"JH378121","27376090","27376292","KQ053631v1","9034236","9034449","50","18341854"
"JH378121","27463349","27463642","KQ053409v1","1836700","1836987","65","25626649"
"JH378121","27857919","27858219","KQ057570v1","948451","948753","63","26909468"
"JH378121","27888483","27888792","KQ055457v1","2061137","2061448","63","25827346"
"JH378121","28099286","28099569","KQ053752v1","35796","36072","66","28063490"
"JH378121","28254297","28254490","KQ054724v1","240787","240986","52","28013510"
"JH378121","28435693","28435996","KQ058184v1","1505565","1505858","64","26930128"
"JH378121","28618116","28618417","KQ056558v1","670740","671032","75","27947376"
"JH378121","28656341","28656633","KQ054213v1","780092","780393","68","27876249"
"JH378121","28705925","28706232","KQ053520v1","2913074","2913361","102","25792851"
"JH378121","28777562","28777842","KQ052968v1","10629964","10630247","60","18147598"
"JH378121","28833377","28833638","KQ053654v1","3892663","3892904","75","24940714"
"JH378121","28876743","28877053","KQ053554v1","2471177","2471484","75","26405566"
"JH378121","28905773","28906082","KQ058405v1","1120230","1120530","73","27785543"
"JH378121","28970772","28971034","KQ058004v1","3112196","3112474","66","25858576"
"JH378121","29104566","29104864","KQ054533v1","288767","289055","82","28815799"
"JH378121","29106762","29106891","KQ058004v1","2254984","2255111","28","26851778"
"JH378121","29526752","29527042","KQ056147v1","266944","267241","61","29259808"
"JH378121","29764464","29764780","KQ054068v1","5074639","5074944","80","24689825"
"JH378121","29841557","29841678","KQ055140v1","3148311","3148416","29","26693246"
"JH378121","30116642","30116953","KQ058094v1","6655571","6655890","73","23461071"
"JH378121","31026019","31026131","KQ054037v1","1060028","1060143","28","29965991"
"JH378121","31026883","31027049","KQ054510v1","1448917","1449101","50","29577966"
"JH378121","31084910","31085123","KQ053959v1","3147544","3147761","51","27937366"
"JH378121","31222331","31222644","KQ055862v1","2038392","2038709","65","29183939"
"JH378121","31300811","31301061","KQ053740v1","548757","549009","77","30752054"
"JH378122","241231","241532","KQ055247v1","895463","895756","60","654232"
"JH378122","281196","281505","KQ058372v1","1134128","1134432","66","852932"
"JH378122","438292","438592","KQ057737v1","4424765","4425071","76","3986473"
"JH378122","465622","465916","KQ058539v1","1057985","1058283","81","592363"
"JH378122","632904","633201","KQ053409v1","4013908","4014196","72","3381004"
"JH378122","665690","665956","KQ058374v1","497022","497284","71","168668"
"JH378122","834802","834960","KQ053082v1","5736615","5736775","38","4901813"
"JH378122","842357","842668","KQ054124v1","2442155","2442433","90","1599798"
"JH378122","1011166","1011456","KQ058184v1","1505565","1505858","56","494399"
"JH378122","1109640","1109770","KQ057910v1","1548802","1548933","21","439162"
"JH378122","1141201","1141486","KQ056148v1","2419670","2419961","77","1278469"
"JH378122","1298973","1299036","KQ053620v1","1104065","1104117","21","194908"
"JH378122","1308090","1308268","KQ053191v1","2005380","2005547","51","697290"
"JH378122","1338959","1339145","KQ053774v1","1982290","1982469","58","643331"
"JH378122","1485516","1485805","KQ054954v1","4226407","4226696","77","2740891"
"JH378122","1491131","1491356","KQ058266v1","662378","662594","53","828753"
"JH378122","1492209","1492268","KQ054932v1","3876923","3876983","15","2384714"
"JH378122","1499253","1499377","KQ053157v1","8174152","8174260","34","6674899"
"JH378122","1562056","1562221","KQ056996v1","1524030","1524195","36","38026"
"JH378122","1579251","1579517","KQ053927v1","300161","300454","79","1279090"
"JH378122","1616889","1617034","KQ057118v1","2873589","2873730","32","1256700"
"JH378122","1716706","1716920","KQ053959v1","3147544","3147761","51","1430838"
"JH378122","1967341","1967477","KQ053245v1","473950","474077","29","1493391"
"JH378122","1990989","1991262","KQ052969v1","7351818","7352090","60","5360829"
"JH378122","2118564","2118707","KQ058394v1","81695","81845","40","2036869"
"JH378122","2152212","2152351","KQ058281v1","1664150","1664292","30","488062"
"JH378122","2162349","2162637","KQ053916v1","1741116","1741399","69","421233"
"JH378122","2434451","2434719","KQ055364v1","1919520","1919774","66","514931"
"JH378122","2485026","2485324","KQ058316v1","3118971","3119267","79","633945"
"JH378122","2529350","2529644","KQ054756v1","1026786","1027083","61","1502564"
"JH378122","2710602","2710915","KQ052981v1","1198440","1198752","62","1512162"
"JH378122","2794266","2794559","KQ058561v1","7961595","7961877","75","5167329"
"JH378122","3036589","3036713","KQ058257v1","652425","652556","28","2384164"
"JH378122","3221327","3221623","KQ053299v1","4095914","4096215","58","874587"
"JH378122","3298920","3299050","KQ054932v1","5190304","5190436","28","1891384"
"JH378122","3903179","3903345","KQ056475v1","396846","397033","59","3506333"
"JH378122","3962795","3963080","KQ055468v1","1908448","1908731","60","2054347"
"JH378122","4238402","4238688","KQ054401v1","2629005","2629296","60","1609397"
"JH378122","4446325","4446523","KQ058350v1","871497","871688","51","3574828"
"JH378122","4451935","4452225","KQ052968v1","6282633","6282918","64","1830698"
"JH378122","4556334","4556615","ABDC02054223v1","3152","3442","60","4553182"
"JH378122","4620636","4620731","KQ053465v1","1602887","1602984","29","3017749"
"JH378122","4887671","4887812","KQ053982v1","8151372","8151511","33","3263701"
"JH378122","4888363","4888490","KQ054932v1","7772773","7772892","33","2884410"
"JH378122","5051213","5051492","KQ054068v1","1268545","1268823","69","3782668"
"JH378122","5081486","5081743","KQ058419v1","367494","367746","76","4713992"
"JH378122","5137127","5137418","KQ055035v1","4381466","4381744","69","755661"
"JH378122","5246349","5246479","KQ057910v1","1548802","1548933","24","3697547"
"JH378122","5573040","5573348","KQ058183v1","487423","487710","89","5085617"
"JH378122","5630776","5630878","KQ053850v1","279389","279490","24","5351387"
"JH378122","5671017","5671327","KQ053288v1","2034811","2035125","75","3636206"
"JH378122","5805259","5805546","KQ053465v1","3806004","3806288","61","1999255"
"JH378122","5924500","5924778","KQ053082v1","1085491","1085778","72","4839009"
"JH378122","6161516","6161818","KQ053343v1","1729289","1729583","67","4432227"
"JH378122","6218224","6218388","KQ058533v1","544439","544600","42","5673785"
"JH378122","6303413","6303690","KQ053146v1","2819587","2819868","60","3483826"
"JH378122","6361419","6361733","KQ053332v1","2499122","2499413","90","3862297"
"JH378122","6465450","6465719","KQ058283v1","3525175","3525450","69","2940275"
"JH378122","7171627","7171758","KQ056643v1","1491838","1491968","25","5679789"
"JH378122","7171815","7171905","KQ057648v1","2245752","2245839","22","4926063"
"JH378122","7242993","7243128","KQ053565v1","1793162","1793293","29","5449831"
"JH378122","7245461","7245748","KQ053838v1","2829855","2830133","72","4415606"
"JH378122","7348059","7348352","KQ058328v1","4260134","4260435","69","3087925"
"JH378122","7364605","7364772","KQ056587v1","1313670","1313846","49","6050935"
"JH378122","7516770","7517070","KQ058305v1","2795843","2796149","90","4720927"
"JH378122","7545938","7546242","KQ054879v1","1971571","1971875","64","5574367"
"JH378122","7701426","7701703","KQ055248v1","2598609","2598880","71","5102817"
"JH378122","8051370","8051634","KQ055735v1","667472","667747","72","7383898"
"JH378122","8085250","8085412","KQ057023v1","552794","552951","37","7532456"
"JH378122","8107130","8107291","KQ056035v1","1594013","1594170","38","6513117"
"JH378122","8200920","8201206","KQ056147v1","1064032","1064323","64","7136888"
"JH378122","8218648","8218921","KQ055755v1","209063","209333","60","8009585"
"JH378122","8335099","8335403","KQ058585v1","580456","580763","64","7754643"
"JH378122","8424990","8425285","KQ058316v1","1439391","1439671","69","6985599"
"JH378122","8516757","8516956","KQ054933v1","3939617","3939804","61","4577140"
"JH378122","8521632","8521767","KQ057648v1","2314551","2314685","18","6207081"
"JH378122","8662492","8662623","KQ057910v1","1548802","1548933","25","7113690"
"JH378122","9151785","9152081","KQ054606v1","1604394","1604691","55","7547391"
"JH378122","9412616","9412927","KQ053212v1","2900872","2901182","68","6511744"
"JH378122","9500001","9500070","KQ055979v1","1425","1498","13","9498576"
"JH378122","9582948","9583206","KQ058283v1","5849694","5849954","74","3733254"
"JH378122","9713841","9714154","KQ058184v1","1505565","1505858","79","8208276"
"JH378122","9745591","9745878","KQ058353v1","1449127","1449389","91","8296464"
"JH378122","9779625","9779899","KQ052969v1","8828499","8828765","78","951126"
"JH378122","9797625","9797890","KQ054826v1","9895778","9896046","78","98153"
"JH378122","9854327","9854594","KQ055662v1","2338823","2339077","69","7515504"
"JH378122","9886568","9886872","KQ058184v1","1505565","1505858","72","8381003"
"JH378122","10128347","10128488","KQ055152v1","3233706","3233848","29","6894641"
"JH378122","10167294","10167424","KQ057910v1","1548802","1548933","20","8618492"
"JH378122","10223973","10224051","KQ058076v1","120666","120729","29","10103307"
"JH378122","10229377","10229663","KQ058394v1","9107761","9108054","61","1121616"
"JH378122","10247004","10247136","KQ053026v1","2906402","2906536","37","7340602"
"JH378122","10283709","10284009","KQ058266v1","898592","898893","75","9385117"
"JH378122","10344673","10344805","KQ056652v1","675563","675695","30","9669110"
"JH378122","10411258","10411559","KQ056672v1","3082150","3082439","61","7329108"
"JH378122","10501458","10501676","KQ056673v1","1365335","1365539","67","9136123"
"JH378122","10551051","10551215","KQ055035v1","1856271","1856430","51","8694780"
"JH378122","10608502","10608800","KQ053299v1","4095914","4096215","74","6512588"
"JH378122","10681622","10681731","KQ058286v1","473841","473942","35","10207781"
"JH378122","10681731","10681804","KQ055883v1","741152","741209","23","9940579"
"JH378122","10682569","10682881","KQ058272v1","4942871","4943179","71","5739698"
"JH378122","10687612","10687904","KQ053838v1","3013088","3013374","74","7674524"
"JH378122","10942112","10942259","KQ055183v1","2514156","2514302","32","8427956"
"JH378122","11010727","11011052","KQ053816v1","7464708","7465010","98","3546019"
"JH378122","11020096","11020359","KQ053795v1","370451","370712","69","10649645"
"JH378122","11087677","11087984","KQ054932v1","8677551","8677850","78","2410126"
"JH378122","11209934","11210067","KQ057883v1","1224468","1224597","20","9985466"
"JH378122","11291106","11291300","KQ055766v1","4486132","4486328","40","6804974"
"JH378122","11293418","11293704","KQ057013v1","1174886","1175155","76","10118532"
"JH378122","11300656","11300842","KQ053354v1","1582807","1582998","46","9717849"
"JH378122","11488696","11488953","KQ057345v1","1938824","1939073","65","9549872"
"JH378122","11667565","11667856","KQ057693v1","716624","716921","84","10950941"
"JH378122","12253847","12253987","KQ054932v1","2191839","2191983","33","10062008"
"JH378122","12661070","12661376","KQ053190v1","1299491","1299778","80","11361579"
"JH378122","13153978","13154289","KQ056928v1","1915686","1915996","64","11238292"
"JH378122","13168262","13168387","KQ053191v1","655494","655627","25","12512768"
"JH378122","13185102","13185335","KQ053332v1","1938314","1938530","59","11246788"
"JH378122","13256503","13256666","KQ054510v1","3803526","3803690","42","9452977"
"JH378122","13289021","13289184","KQ057737v1","1426090","1426247","33","11862931"
"JH378122","13340923","13341215","KQ057755v1","45985","46262","77","13294938"
"JH378122","13423452","13423651","KQ058505v1","3952082","3952290","56","9471370"
"JH378122","13482457","13482575","KQ053146v1","2683242","2683362","29","10799215"
"JH378122","13749095","13749390","KQ054289v1","149049","149343","84","13600046"
"JH378122","13758711","13759007","KQ054879v1","1971571","1971875","70","11787140"
"JH378122","13937431","13937690","KQ052971v1","6441372","6441626","70","7496059"
"JH378122","14043914","14044205","KQ058552v1","771580","771883","84","13272334"
"JH378122","14085066","14085306","KQ058503v1","123813","124064","61","13961253"
"JH378122","14095280","14095575","KQ056064v1","5232182","5232473","82","8863098"
"JH378122","14329160","14329503","KQ054682v1","2125705","2126015","89","12203455"
"JH378122","14464142","14464333","KQ058350v1","871497","871688","51","13592645"
"JH378122","14582496","14582783","KQ052970v1","9813160","9813451","67","4769336"
"JH378122","15815770","15816004","KQ055267v1","38052","38281","67","15777718"
"JH378122","15891498","15891743","KQ057345v1","1938824","1939073","61","13952674"
"JH378122","15962743","15963028","KQ058272v1","5443874","5444159","64","10518869"
"JH378122","17657910","17658178","KQ056035v1","1236900","1237146","79","16421010"
"JH378122","17892890","17893096","KQ054081v1","1002095","1002297","52","16890795"
"JH378122","17997210","17997490","KQ055352v1","4072477","4072766","74","13924733"
"JH378122","18353706","18353976","KQ057822v1","52257","52533","77","18301449"
"JH378122","18369331","18369616","KQ054135v1","2702098","2702381","68","15667233"
"JH378122","18534591","18534711","KQ053146v1","2799678","2799801","30","15734913"
"JH378122","18961316","18961598","KQ052968v1","14043756","14044036","77","4917560"
"JH378122","19085365","19085641","KQ053539v1","110493","110767","81","18974872"
"JH378122","19778784","19779072","KQ053157v1","7174603","7174889","72","12604181"
"JH378122","20203698","20203997","KQ055987v1","77625","77928","78","20126073"
"JH378122","20207343","20207571","KQ054693v1","2405955","2406178","62","17801388"
"JH378122","20343938","20344234","KQ054069v1","7687863","7688158","70","12656075"
"JH378122","20819949","20820238","KQ058538v1","1780355","1780644","60","19039594"
"JH378122","21213563","21213836","KQ055183v1","3167551","3167831","77","18046012"
"JH378122","21673742","21674040","KQ054510v1","9729880","9730175","66","11943862"
"JH378122","21849151","21849388","KQ056965v1","1824644","1824878","71","20024507"
"JH378122","22364416","22364735","KQ055872v1","6063044","6063339","72","16301372"
"JH378122","22505750","22506053","KQ053299v1","2867160","2867464","76","19638590"
"JH378122","22599585","22599774","KQ052969v1","8528994","8529192","55","14070591"
"JH378122","22622851","22623013","KQ055479v1","601792","601954","34","22021059"
"JH378122","22634497","22634653","KQ057737v1","1426090","1426247","30","21208407"
"JH378122","22970380","22970691","KQ053654v1","5318679","5318982","69","17651701"
"JH378122","23183257","23183532","KQ058383v1","2713168","2713439","71","20470089"
"JH378122","23994058","23994320","KQ058533v1","977692","977970","83","23016366"
"JH378122","25121786","25121963","KQ057737v1","1426090","1426247","46","23695696"
"JH378122","25315679","25315950","KQ057909v1","763467","763734","65","24552212"
"JH378122","25317932","25318049","KQ053310v1","1622751","1622859","33","23695181"
"JH378122","25318324","25318458","KQ053409v1","6573923","6574054","25","18744401"
"JH378122","25318572","25318661","KQ058473v1","345375","345456","24","24973197"
"JH378122","25539920","25540050","KQ055247v1","859431","859560","25","24680489"
"JH378122","25627349","25627678","KQ055247v1","1248490","1248795","91","24378859"
"JH378122","25702014","25702286","KQ053959v1","6189151","6189431","57","19512863"
"JH378122","26475364","26475629","KQ058328v1","6007709","6007975","84","20467655"
"JH378122","26898268","26898575","KQ053816v1","7464708","7465010","64","19433560"
"JH378122","27317647","27317900","KQ053520v1","2840509","2840769","73","24477138"
"JH378122","27472945","27473188","KQ058503v1","123813","124064","70","27349132"
"JH378122","28096717","28097013","KQ058317v1","5506620","5506904","71","22590097"
"JH378122","28105570","28105890","KQ055457v1","8926731","8927039","71","19178839"
"JH378122","28751702","28751932","KQ055830v1","278558","278787","68","28473144"
"JH378122","28836723","28836880","KQ057023v1","552794","552951","41","28283929"
"JH378122","29381481","29381791","KQ053115v1","3485337","3485650","58","25896144"
"JH378122","29402002","29402220","KQ053256v1","942460","942674","54","28459542"
"JH378122","29451182","29451484","KQ053420v1","122023","122324","76","29329159"
"JH378122","29914508","29914724","KQ053256v1","942460","942674","52","28972048"
"JH378122","29915088","29915338","KQ052971v1","6441372","6441626","56","23473716"
"JH378123","50726","50868","KQ054191v1","266771","266904","47","216045"
"JH378123","528898","529207","KQ058427v1","7552507","7552810","70","7023609"
"JH378123","553457","553737","KQ054069v1","955693","955974","63","402236"
"JH378123","631315","631511","KQ053740v1","1109410","1109606","52","478095"
"JH378123","679054","679351","KQ058004v1","2495177","2495491","76","1816123"
"JH378123","735120","735368","KQ054933v1","935520","935770","62","200400"
"JH378123","735896","735942","KQ058253v1","973211","973250","17","237315"
"JH378123","932490","932765","KQ058272v1","5443874","5444159","56","4511384"
"JH378123","987905","988041","KQ058313v1","471478","471611","28","516427"
"JH378123","1121630","1121900","KQ054510v1","8087837","8088117","74","6966207"
"JH378123","1162374","1162462","KQ054124v1","762930","763025","30","399444"
"JH378123","1453030","1453322","KQ058184v1","1505565","1505858","64","52535"
"JH378123","1584540","1584716","KQ054191v1","642274","642457","64","942266"
"JH378123","1821191","1821453","KQ054868v1","2229582","2229854","72","408391"
"JH378123","2532710","2532919","KQ058505v1","2234909","2235124","59","297801"
"JH378123","3505170","3505441","KQ053096v1","602899","603182","79","2902271"
"JH378123","3642506","3642625","KQ056235v1","1725320","1725441","32","1917186"
"JH378123","4210600","4210883","KQ053421v1","4801102","4801383","68","590502"
"JH378123","4618851","4618972","KQ058004v1","1368020","1368133","35","3250831"
"JH378123","4682900","4683189","KQ058427v1","11865581","11865863","76","7182681"
"JH378123","5282172","5282331","KQ055872v1","5870772","5870928","35","588600"
"JH378123","5297715","5297985","KQ055872v1","13136193","13136453","71","7838478"
"JH378123","5324275","5324569","KQ057290v1","1053741","1054027","64","4270534"
"JH378123","5406487","5406782","KQ058266v1","1113469","1113760","69","4293018"
"JH378123","5416883","5417144","KQ053806v1","112703","112966","74","5304180"
"JH378123","5553139","5553262","KQ058004v1","2254984","2255111","22","3298155"
"JH378123","5689368","5689679","KQ056148v1","430759","431072","66","5258609"
"JH378123","5703706","5703982","KQ057755v1","45985","46262","80","5657721"
"JH378123","5780773","5780918","KQ053037v1","3255963","3256108","31","2524810"
"JH378123","5956107","5956235","KQ057488v1","512192","512325","23","5443915"
"JH378123","6213645","6213776","KQ053115v1","1333586","1333718","23","4880059"
"JH378123","6315480","6315776","KQ058184v1","1505565","1505858","63","4809915"
"JH378123","6554226","6554313","KQ054400v1","280157","280246","24","6274069"
"JH378123","6711373","6711655","KQ054933v1","4410189","4410469","69","2301184"
"JH378123","6742390","6742467","KQ056790v1","756434","756514","22","5985956"
"JH378123","6777550","6777620","KQ057380v1","2993795","2993866","17","3783755"
"JH378123","7151309","7151591","KQ053297v1","44026","44315","61","7107283"
"JH378123","7161369","7161569","KQ058427v1","6736144","6736323","55","425225"
"JH378123","7324979","7325096","KQ058122v1","552137","552253","28","6772842"
"JH378123","7500966","7501263","KQ053332v1","771022","771332","81","6729944"
"JH378123","7607144","7607453","KQ055852v1","2616321","2616621","63","4990823"
"JH378123","7711670","7711960","KQ053093v1","3162517","3162806","68","4549153"
"JH378123","7729409","7729703","KQ057118v1","4601602","4601894","62","3127807"
"JH378123","7772855","7773064","KQ057290v1","4745481","4745684","40","3027374"
"JH378123","7796161","7796325","KQ057737v1","1426090","1426247","31","6370071"
"JH378123","7993231","7993411","KQ055273v1","46777","46952","56","7946454"
"JH378123","8117626","8117840","KQ058595v1","117016","117224","48","8000610"
"JH378123","8176738","8176993","KQ054921v1","4041226","4041499","77","4135512"
"JH378123","8283264","8283496","KQ057291v1","322948","323180","60","7960316"
"JH378123","8901951","8902252","KQ058184v1","1505565","1505858","68","7396386"
"JH378123","8959977","8960121","KQ053157v1","4288391","4288538","33","4671586"
"JH378123","9050553","9050817","KQ058328v1","4345009","4345273","62","4705544"
"JH378123","9162767","9162896","KQ057431v1","750387","750523","42","8412380"
"JH378123","9222959","9223090","KQ053354v1","702320","702452","29","8520639"
"JH378123","9429106","9429279","KQ057737v1","835784","835962","45","8593322"
"JH378123","9429471","9429585","KQ055903v1","184486","184598","26","9244985"
"JH378123","9489087","9489257","KQ052968v1","9610036","9610212","49","120949"
"JH378123","9489739","9490045","KQ053299v1","3823059","3823361","64","5666680"
"JH378123","9596933","9597175","KQ055978v1","5166519","5166749","67","4430414"
"JH378123","9647368","9647674","KQ054213v1","780092","780393","56","8867276"
"JH378123","9764633","9764910","KQ057796v1","1059003","1059279","72","8705630"
"JH378123","9822601","9822876","KQ058353v1","1257017","1257298","61","8565584"
"JH378123","9984062","9984211","KQ057204v1","1848184","1848342","37","8135878"
"JH378123","10301830","10301913","KQ054091v1","552694","552778","21","9749136"
"JH378123","10332038","10332325","KQ053212v1","3080111","3080401","73","7251927"
"JH378123","10498221","10498535","KQ058359v1","574163","574471","81","9924058"
"JH378123","10662390","10662692","KQ053654v1","820983","821268","83","9841407"
"JH378123","10686078","10686240","KQ057023v1","552794","552951","42","10133284"
"JH378123","11017167","11017442","KQ054693v1","832788","833076","71","10184379"
"JH378123","11237847","11238161","KQ053093v1","1539467","1539776","71","9698380"
"JH378123","11425294","11425449","KQ056475v1","5275769","5275928","33","6149525"
"JH378123","11448202","11448474","KQ053993v1","1017100","1017367","67","10431102"
"JH378123","11454806","11455094","KQ053013v1","547618","547904","67","10907188"
"JH378123","11582964","11583100","KQ056044v1","1879665","1879803","23","9703299"
"JH378123","11596613","11596923","KQ058372v1","1134128","1134432","71","10462485"
"JH378123","11645949","11646267","KQ058316v1","2150959","2151268","71","9494990"
"JH378123","11723301","11723570","KQ055375v1","3672008","3672286","72","8051293"
"JH378123","11761782","11761991","KQ055490v1","27634","27846","47","11734148"
"JH378123","11771608","11771744","ABDC02047922v1","197","340","39","11771411"
"JH378123","12449630","12449910","KQ058494v1","4837812","4838086","82","7611818"
"JH378123","12604156","12604458","KQ053299v1","22532300","22532596","74","9928144"
"JH378123","12732739","12733053","KQ058377v1","25815","26128","77","12706924"
"JH378123","12779342","12779635","KQ057036v1","1155186","1155473","72","11624156"
"JH378123","13254701","13254905","KQ054401v1","3245220","3245428","44","10009481"
"JH378123","13256471","13256644","KQ053948v1","3061823","3062004","50","10194648"
"JH378123","13491248","13491335","KQ055695v1","1060551","1060630","19","12430697"
"JH378123","13694102","13694263","KQ053299v1","3040139","3040314","43","10653963"
"JH378123","13961611","13961918","KQ058316v1","4697990","4698273","79","9263621"
"JH378123","14371686","14371897","KQ053609v1","2642121","2642332","55","11729565"
"JH378123","14606830","14607097","KQ053332v1","813051","813309","82","13793779"
"JH378123","14769247","14769555","KQ056672v1","5770252","5770551","74","8998995"
"JH378123","14934060","14934319","KQ055662v1","4683524","4683789","61","10250536"
"JH378123","15053066","15053272","KQ058445v1","325619","325833","49","14727447"
"JH378123","15284252","15284509","KQ058338v1","2081003","2081254","64","13203249"
"JH378123","15437306","15437496","KQ056375v1","1153881","1154077","45","14283425"
"JH378123","15479734","15480024","KQ058183v1","487423","487710","60","14992311"
"JH378123","15548002","15548209","KQ058004v1","2720169","2720394","56","12827833"
"JH378123","15550374","15550546","KQ054191v1","3864999","3865160","45","11685375"
"JH378123","15550740","15550857","KQ058383v1","7248131","7248254","28","8302609"
"JH378123","15630222","15630363","KQ057118v1","2873589","2873730","28","12756633"
"JH378123","16126200","16126476","KQ053476v1","2688466","2688754","73","13437734"
"JH378123","16504928","16505205","KQ057373v1","517182","517448","80","15987746"
"JH378123","16518821","16518885","KQ053632v1","195846","195898","20","16322975"
"JH378123","16518899","16519065","KQ052982v1","1147716","1147889","46","15371183"
"JH378123","16835944","16836224","KQ053146v1","2819587","2819868","61","14016357"
"JH378123","17387745","17387895","KQ054180v1","2677141","2677319","59","14710604"
"JH378123","17462980","17463273","KQ053343v1","2900708","2901000","88","14562272"
"JH378123","17491273","17491559","KQ053465v1","3806004","3806288","65","13685269"
"JH378123","17516956","17517086","KQ053565v1","1793162","1793293","26","15723794"
"JH378123","17736321","17736451","KQ052993v1","71964","72092","29","17664357"
"JH378123","17799815","17800080","KQ055142v1","1193213","1193460","79","16606602"
"JH378123","17901915","17902047","KQ056652v1","675563","675695","23","17226352"
"JH378123","18194770","18195080","KQ055787v1","694393","694708","73","17500377"
"JH378123","18340462","18340749","KQ055490v1","2797344","2797631","68","15543118"
"JH378123","18544690","18544752","KQ058394v1","2776716","2776783","22","15767974"
"JH378123","18545108","18545239","KQ054795v1","2377934","2378063","37","16167174"
"JH378123","18565156","18565427","KQ053827v1","6235617","6235875","82","12329539"
"JH378123","18599013","18599313","KQ053299v1","21869448","21869738","71","3270435"
"JH378123","18694567","18694721","KQ056587v1","7257462","7257612","38","11437105"
"JH378123","19458245","19458396","KQ052970v1","12418764","12418905","34","7039481"
"JH378123","19520737","19521031","KQ054069v1","7687863","7688158","64","11832874"
"JH378123","19566833","19567134","KQ058310v1","269634","269939","77","19297199"
"JH378123","20375413","20375566","KQ057737v1","1426090","1426247","36","18949323"
"JH378123","20666772","20667075","KQ053093v1","1738898","1739201","57","18927874"
"JH378123","20752750","20753054","KQ053299v1","6038380","6038679","69","14714370"
"JH378123","20956096","20956388","KQ058184v1","1505565","1505858","65","19450531"
"JH378123","21061055","21061252","KQ053849v1","1126392","1126589","48","19934663"
"JH378123","21126159","21126446","KQ058004v1","1100771","1101059","77","20025388"
"JH378123","21222274","21222425","KQ053741v1","1690943","1691088","36","19531331"
"JH378123","21298005","21298140","KQ058305v1","4820083","4820218","31","16477922"
"JH378123","21303934","21304230","KQ058184v1","1505565","1505858","54","19798369"
"JH378123","21358901","21359064","KQ053299v1","22069326","22069490","40","710425"
"JH378123","21443558","21443822","KQ055662v1","4683524","4683789","80","16760034"
"JH378123","21497147","21497256","KQ054135v1","1868466","1868583","37","19628681"
"JH378123","21564533","21564660","KQ053409v1","6573923","6574054","27","14990610"
"JH378123","21609797","21609936","KQ057036v1","1067545","1067684","26","20542252"
"JH378123","21625044","21625319","KQ052982v1","2557979","2558263","68","19067065"
"JH378123","21640772","21641065","KQ052970v1","6659487","6659775","65","14981285"
"JH378123","21653561","21653860","KQ053631v1","9631170","9631468","60","12022391"
"JH378123","21772474","21772769","KQ056996v1","837133","837431","67","20935341"
"JH378123","21879693","21879968","KQ055035v1","8495544","8495813","74","13384149"
"JH378123","22000106","22000428","KQ055119v1","2003090","2003396","75","19997016"
"JH378123","22002924","22003200","KQ055590v1","2725615","2725902","73","19277309"
"JH378123","22208189","22208428","KQ054401v1","3245220","3245428","66","18962969"
"JH378123","22299714","22299852","KQ053982v1","3934263","3934401","34","18365451"
"JH378123","22377873","22378042","KQ053135v1","3925667","3925819","46","18452206"
"JH378123","22420717","22421019","KQ058184v1","1505565","1505858","68","20915152"
"JH378123","22709265","22709585","KQ052970v1","8274642","8274940","74","14434623"
"JH378123","22715845","22715982","KQ054533v1","1111592","1111720","26","21604253"
"JH378123","23872767","23873046","KQ054091v1","189699","189989","68","23683068"
"JH378123","23936403","23936689","KQ052970v1","8520800","8521088","62","15415603"
"JH378123","24283432","24283682","KQ055457v1","1902633","1902878","70","22380799"
"JH378123","24602906","24603214","KQ055787v1","1064992","1065293","69","23537914"
"JH378123","24615146","24615446","KQ058427v1","7552507","7552810","65","17062639"
"JH378123","25118047","25118343","KQ055087v1","1063066","1063349","73","24054981"
"JH378123","25164144","25164427","KQ058533v1","977692","977970","76","24186452"
"JH378123","25261847","25262157","KQ053554v1","2471177","2471484","77","22790670"
"JH378123","25276776","25277080","KQ054510v1","8555095","8555387","67","16721681"
"JH378123","25469848","25470124","KQ058183v1","4736369","4736640","66","20733479"
"JH378123","25808556","25808839","KQ053432v1","5326013","5326296","74","20482543"
"JH378123","25863726","25864003","KQ056147v1","1747366","1747648","68","24116360"
"JH378123","25907133","25907338","KQ053093v1","1363144","1363361","64","24543989"
"JH378123","26573382","26573667","KQ056432v1","1593337","1593624","66","24980045"
"JH378123","26597697","26598001","KQ058594v1","1507517","1507820","74","25090180"
"JH378123","26733106","26733412","KQ056973v1","1765942","1766236","78","24967164"
"JH378123","26751659","26751929","KQ058288v1","54043","54290","75","26697616"
"JH378123","27073587","27073858","KQ057345v1","642911","643183","77","26430676"
"JH378123","27192630","27192799","KQ054510v1","8888528","8888700","35","18304102"
"JH378123","27238976","27239279","KQ055097v1","1884579","1884874","67","25354397"
"JH378123","27309083","27309354","KQ057213v1","1074642","1074915","65","26234441"
"JH378123","27526549","27526753","KQ058383v1","5244323","5244522","49","22282226"
"JH378123","27527144","27527254","KQ053971v1","4103392","4103508","32","23423752"
"JH378123","27641433","27641737","KQ058184v1","1505565","1505858","64","26135868"
"JH378123","27722003","27722237","KQ058328v1","2569266","2569497","49","25152737"
"JH378123","28832485","28832746","KQ056920v1","346245","346510","73","28486240"
"JH378123","28895637","28895799","KQ053004v1","4759784","4759947","38","24135853"
"JH378123","29002243","29002528","KQ053959v1","6189151","6189431","72","22813092"
"JH378123","29069710","29069840","KQ057910v1","1548802","1548933","23","27520908"
"JH378123","29112064","29112323","KQ053883v1","3868605","3868876","64","25243459"
"JH378123","29322888","29323174","KQ055808v1","339221","339505","64","28983667"
"JH378123","29428003","29428263","KQ058183v1","87868","88123","73","29340135"
"JH378123","29750752","29751045","KQ058539v1","1057985","1058283","73","28692767"
"JH378124","46655","46932","KQ053361v1","85477","85759","60","38822"
"JH378124","66177","66478","KQ054693v1","832788","833076","66","766611"
"JH378124","75021","75325","KQ054400v1","354368","354668","71","279347"
"JH378124","148659","148947","KQ057118v1","4601602","4601894","66","4452943"
"JH378124","339850","340151","KQ055629v1","2992972","2993267","84","2653122"
"JH378124","590121","590409","KQ054682v1","1577967","1578262","71","987846"
"JH378124","623318","623469","KQ054180v1","70685","70834","36","552633"
"JH378124","831919","832220","KQ055787v1","1064992","1065293","74","233073"
"JH378124","890754","891045","KQ057380v1","4658761","4659050","70","3768007"
"JH378124","1226002","1226289","KQ056035v1","1507771","1508068","74","281769"
"JH378124","1248346","1248628","KQ055173v1","248885","249169","70","999461"
"JH378124","1258360","1258629","KQ052970v1","8520800","8521088","67","7262440"
"JH378124","1798095","1798370","KQ054660v1","3676105","3676388","73","1878010"
"JH378124","1962737","1963041","KQ056225v1","48046","48349","72","1914691"
"JH378124","1984852","1984965","KQ058004v1","1368020","1368133","26","616832"
"JH378124","2021900","2022194","KQ057118v1","4601602","4601894","72","2579702"
"JH378124","2674097","2674384","ABDC02052257v1","792","1085","65","2673305"
"JH378124","2891302","2891572","KQ054069v1","4151356","4151622","85","1260054"
"JH378124","3389188","3389489","KQ052984v1","105454","105757","70","3283734"
"JH378124","3426223","3426509","KQ058413v1","348155","348432","77","3078068"
"JH378124","3474708","3475009","KQ053044v1","405596","405892","71","3069112"
"JH378124","3699930","3700166","KQ058487v1","1040716","1040932","67","2659214"
"JH378124","3865872","3866173","KQ055717v1","675803","676103","63","3190069"
"JH378124","4112705","4113021","KQ056855v1","4111147","4111444","89","1558"
"JH378124","4409678","4409960","KQ052982v1","2557979","2558263","55","1851699"
"JH378124","4577211","4577495","KQ053631v1","8893553","8893834","70","4316342"
"JH378124","4582549","4582690","KQ058004v1","4709381","4709516","27","126832"
"JH378124","4614979","4615210","KQ058483v1","5089676","5089885","72","474697"
"JH378124","4641269","4641562","KQ057290v1","2047430","2047717","57","2593839"
"JH378124","4717212","4717333","KQ056643v1","1279625","1279744","35","3437587"
"JH378124","4762994","4763281","KQ053905v1","3600529","3600809","69","1162465"
"JH378124","4925448","4925713","KQ058275v1","938649","938919","65","3986799"
"JH378124","5000842","5001132","KQ058561v1","4225175","4225466","66","775667"
"JH378124","5088070","5088197","KQ056855v1","804290","804423","24","4283780"
"JH378124","5135660","5135937","KQ058413v1","348155","348432","65","4787505"
"JH378124","5368254","5368540","KQ055468v1","1908448","1908731","67","3459806"
"JH378124","5444179","5444481","KQ057290v1","3090594","3090898","68","2353585"
"JH378124","5448432","5448711","KQ054693v1","832788","833076","66","4615644"
"JH378124","5468194","5468472","KQ053126v1","1419293","1419571","69","4048901"
"JH378124","5490668","5491001","KQ054576v1","616813","617125","89","4873855"
"JH378124","5521436","5521578","KQ054301v1","3483833","3483964","34","2037603"
"JH378124","5576536","5576837","KQ053816v1","7327018","7327317","59","1750482"
"JH378124","5652640","5653015","KQ053230v1","230648","230980","128","5421992"
"JH378124","5726393","5726627","KQ052971v1","6441372","6441626","62","714979"
"JH378124","5761755","5761945","KQ054179v1","1149324","1149515","52","4612431"
"JH378124","5775256","5775570","KQ054932v1","4838112","4838407","75","937144"
"JH378124","5866573","5866800","KQ056465v1","72608","72828","52","5793965"
"JH378124","5992000","5992269","KQ057560v1","3114391","3114640","76","2877609"
"JH378124","6058328","6058579","KQ057702v1","1579642","1579892","60","4478686"
"JH378124","6218379","6218574","KQ053774v1","1982290","1982469","44","4236089"
"JH378124","6491732","6491830","KQ056540v1","227724","227816","21","6264008"
"JH378124","6492709","6492738","KQ053609v1","2120703","2120733","1","4372006"
"JH378124","6505653","6505798","KQ052970v1","12418764","12418905","39","5913111"
"JH378124","6606748","6606863","KQ054921v1","165725","165837","29","6441023"
"JH378124","6643090","6643288","KQ058505v1","3952082","3952290","41","2691008"
"JH378124","6643373","6643673","KQ058394v1","10439289","10439587","62","3795916"
"JH378124","6816436","6816568","KQ053982v1","3934263","3934401","40","2882173"
"JH378124","6816713","6816845","KQ053849v1","2576503","2576633","30","4240210"
"JH378124","6886637","6886930","KQ056928v1","2385460","2385767","64","4501177"
"JH378124","7300437","7300731","KQ054412v1","2490468","2490761","73","4809969"
"JH378124","7920060","7920324","KQ054984v1","996853","997105","69","6923207"
"JH378124","8123109","8123304","KQ057065v1","226","423","50","8122883"
"JH378124","8148158","8148289","KQ056475v1","2305251","2305383","24","5842907"
"JH378124","8217486","8217800","KQ053816v1","7464708","7465010","77","752778"
"JH378124","8617220","8617513","KQ058257v1","559477","559763","78","8057743"
"JH378124","8900729","8900900","KQ058483v1","5621339","5621499","42","3279390"
"JH378124","8937665","8937975","KQ058272v1","5344193","5344507","86","3593472"
"JH378124","9441389","9441669","KQ053905v1","3600529","3600809","68","5840860"
"JH378124","9866904","9867123","KQ053398v1","3158290","3158500","50","6708614"
"JH378124","9892443","9892719","KQ054510v1","1641980","1642248","67","8250463"
"JH378124","9943258","9943509","KQ054804v1","1007773","1008011","71","8935485"
"JH378124","9977536","9977817","KQ053146v1","2819587","2819868","65","7157949"
"JH378124","9995287","9995572","KQ058248v1","1222370","1222655","68","8772917"
"JH378124","10049861","10049989","KQ057909v1","14636622","14636750","21","4586761"
"JH378124","10060717","10060845","KQ053409v1","6573923","6574054","32","3486794"
"JH378124","10089308","10089606","KQ054510v1","2872930","2873219","75","7216378"
"JH378124","10151213","10151523","KQ058184v1","1505565","1505858","76","8645648"
"JH378124","10271979","10272237","KQ058427v1","11419159","11419415","68","1147180"
"JH378124","10581035","10581310","KQ058383v1","5944247","5944518","70","4636788"
"JH378124","10661716","10662054","KQ054510v1","7367073","7367385","101","3294643"
"JH378124","10941467","10941677","KQ058561v1","565602","565807","49","10375865"
"JH378124","11513395","11513536","KQ058259v1","1242505","1242648","43","10270890"
"JH378124","11647765","11648049","KQ055777v1","2840700","2840988","71","8807065"
"JH378124","11854294","11854602","KQ053093v1","1522159","1522464","74","10332135"
"JH378124","11909291","11909544","KQ053037v1","3640291","3640559","60","8269000"
"JH378124","12012820","12012943","KQ053409v1","6105325","6105446","27","5907495"
"JH378124","12069227","12069452","KQ055935v1","436277","436509","64","11632950"
"JH378124","12087621","12087891","KQ052969v1","11182978","11183250","64","904643"
"JH378124","12099197","12099452","KQ053872v1","539000","539247","75","11560197"
"JH378124","12127455","12127658","KQ052968v1","13624694","13624898","60","1497239"
"JH378124","12128862","12129166","KQ054069v1","7687863","7688158","73","4440999"
"JH378124","12157348","12157480","KQ056568v1","798477","798603","40","11358871"
"JH378124","12208638","12208719","KQ054356v1","2633959","2634042","27","9574679"
"JH378124","12213115","12213351","KQ053827v1","5369199","5369432","62","6843916"
"JH378124","12277717","12278012","KQ053785v1","767236","767521","65","11510481"
"JH378124","12295693","12295946","KQ056773v1","122800","123057","54","12172893"
"JH378124","12313515","12313681","KQ056996v1","1524030","1524195","43","10789485"
"JH378124","12314059","12314197","KQ053135v1","3210852","3210985","41","9103207"
"JH378124","12490345","12490591","KQ058272v1","5539241","5539492","69","6951104"
"JH378124","12590175","12590320","KQ054401v1","2342043","2342190","33","10248132"
"JH378124","12659504","12659798","KQ054466v1","2183618","2183917","67","10475886"
"JH378124","12894427","12894729","KQ058305v1","2335011","2335313","74","10559416"
"JH378124","14331269","14331408","KQ053004v1","3051555","3051691","39","11279714"
"JH378124","14665782","14666059","KQ052971v1","1065774","1066042","91","13600008"
"JH378124","15123970","15124121","KQ056587v1","7257462","7257612","30","7866508"
"JH378124","15281386","15281523","KQ052970v1","12418764","12418905","42","2862622"
"JH378124","15494872","15495032","KQ055518v1","2431373","2431535","37","13063499"
"JH378124","15502131","15502207","KQ055173v1","599075","599150","21","14903056"
"JH378124","15502209","15502269","KQ053849v1","1707655","1707721","18","13794554"
"JH378124","15505945","15506241","KQ055662v1","2138973","2139274","73","13366972"
"JH378124","15638801","15639069","KQ055192v1","1201363","1201615","60","14437438"
"JH378124","15665948","15666223","KQ053816v1","7438202","7438483","80","8227746"
"JH378124","15830934","15831231","KQ058184v1","1505565","1505858","49","14325369"
"JH378124","15864915","15865188","KQ054954v1","2363040","2363310","75","13501875"
"JH378124","15908556","15908724","KQ055014v1","15960","16127","40","15892596"
"JH378124","15934181","15934504","KQ054682v1","2125705","2126015","76","13808476"
"JH378124","16024250","16024517","KQ057345v1","642911","643183","73","15381339"
"JH378124","16164397","16164649","KQ058503v1","123813","124064","53","16040584"
"JH378124","16427617","16427886","KQ054069v1","7026364","7026639","64","9401253"
"JH378124","16496174","16496474","KQ055141v1","5520929","5521213","80","10975245"
"JH378124","16539474","16539658","KQ052968v1","5592291","5592483","59","10947183"
"JH378124","16710471","16710751","KQ058294v1","6026641","6026920","66","10683830"
"JH378124","16780760","16780907","KQ056147v1","2168964","2169108","33","14611796"
"JH378124","17578209","17578370","KQ058129v1","667073","667226","38","16911136"
"JH378124","17586144","17586444","KQ055352v1","4183105","4183394","69","13403039"
"JH378124","17618829","17618884","KQ053260v1","77779","77831","11","17541050"
"JH378124","17619612","17619757","KQ058405v1","1518051","1518190","35","16101561"
"JH378124","17620345","17620377","KQ053310v1","1622893","1622916","13","15997452"
"JH378124","18184728","18184876","KQ056147v1","2168964","2169108","32","16015764"
"JH378124","18190027","18190295","KQ058283v1","3663865","3664141","62","14526162"
"JH378124","18268619","18268786","KQ055425v1","1445594","1445758","39","16823025"
"JH378124","18465628","18465914","KQ054693v1","832788","833076","59","17632840"
"JH378124","18666983","18667265","KQ053498v1","3696034","3696323","67","14970949"
"JH378124","18668224","18668491","KQ058546v1","168071","168339","62","18500153"
"JH378124","18717846","18718094","KQ053190v1","4129892","4130119","68","14587954"
"JH378124","19013618","19013875","KQ053740v1","548757","549009","66","18464861"
"JH378124","19898059","19898186","KQ053905v1","1686209","1686337","27","18211850"
"JH378124","20019365","20019654","KQ052969v1","9553757","9554052","76","10465608"
"JH378124","20100627","20100688","KQ054943v1","3387644","3387704","21","16712983"
"JH378124","20101310","20101537","KQ052970v1","11661690","11661906","63","8439620"
"JH378124","20194169","20194390","KQ057065v1","226","423","62","20193943"
"JH378124","21159471","21159756","KQ054289v1","107239","107526","69","21052232"
"JH378124","21262977","21263268","KQ058004v1","1100771","1101059","68","20162206"
"JH378124","21803771","21804067","KQ053299v1","21835674","21835971","70","31903"
"JH378124","21813135","21813257","KQ056672v1","6062631","6062745","30","15750504"
"JH378124","21886818","21886948","KQ055141v1","3499859","3499986","25","18386959"
"JH378124","22018606","22018743","KQ054466v1","1866785","1866925","35","20151821"
"JH378124","22489690","22489993","KQ053631v1","7288314","7288608","65","15201376"
"JH378124","22528259","22528503","KQ056973v1","1660312","1660545","62","20867947"
"JH378124","22576817","22577066","KQ055364v1","1919520","1919774","63","20657297"
"JH378124","22833467","22833779","KQ057875v1","960027","960319","73","21873440"
"JH378124","22840425","22840756","KQ053288v1","2034811","2035125","85","20805614"
"JH378124","23097355","23097657","KQ054725v1","2218271","2218569","58","20879084"
"JH378124","23384740","23384902","KQ054037v1","1059835","1059995","47","22324905"
"JH378124","23385488","23385613","KQ054069v1","8057401","8057529","29","15328087"
"JH378124","23558429","23558728","KQ053059v1","2387120","2387415","68","21171309"
"JH378124","23589695","23589985","KQ053332v1","447571","447853","59","23142124"
"JH378124","23611124","23611240","KQ058389v1","1435032","1435149","25","22176092"
"JH378124","23611386","23611564","KQ054660v1","3679956","3680128","46","19931430"
"JH378124","23903691","23903994","KQ054401v1","2629005","2629296","61","21274686"
"JH378124","24526964","24527105","KQ058305v1","4820083","4820218","38","19706881"
"JH378124","24787541","24787833","KQ055590v1","2725615","2725902","67","22061926"
"JH378124","25000364","25000649","KQ054356v1","1600089","1600380","84","23400275"
"JH378124","25210606","25210798","KQ054180v1","1190446","1190628","60","24020160"
"JH378124","25211306","25211367","KQ055979v1","1425","1498","21","25209881"
"JH378124","25462393","25462697","KQ057290v1","2953971","2954265","107","22508422"
"JH378124","25474803","25475081","KQ054069v1","3733362","3733643","72","21741441"
"JH378124","26281847","26282122","KQ053146v1","2819587","2819868","65","23462260"
"JH378124","26564276","26564473","KQ055140v1","3477076","3477259","53","23087200"
"JH378124","26569674","26569951","KQ058283v1","3525175","3525450","59","23044499"
"JH378124","26638637","26638725","KQ054400v1","280157","280246","16","26358480"
"JH378124","26680954","26681251","KQ058561v1","4225175","4225466","61","22455779"
"JH378124","26784228","26784519","KQ053146v1","1320586","1320881","75","25463642"
"JH378124","26894244","26894513","KQ054932v1","8904655","8904928","79","17989589"
"JH378124","27002754","27002904","KQ054964v1","705465","705626","37","26297289"
"JH378124","27119389","27119538","KQ053115v1","1650505","1650644","28","25468884"
"JH378124","27228289","27228599","KQ052981v1","1198440","1198752","74","26029849"
"JH378124","27268684","27268811","KQ053409v1","6573923","6574054","31","20694761"
"JH378124","27395456","27395780","KQ053332v1","771022","771332","77","26624434"
"JH378124","27403138","27403448","KQ054389v1","2169070","2169367","71","25234068"
"JH378124","27456001","27456295","KQ056147v1","1064032","1064323","62","26391969"
"JH378124","27481690","27481978","KQ058353v1","1264780","1265071","63","26216910"
"JH378124","27594876","27595176","KQ053959v1","2839561","2839850","79","24755315"
"JH378124","27768396","27768713","KQ057118v1","1400403","1400720","69","26367993"
"JH378124","28171044","28171353","KQ057693v1","621833","622123","70","27549211"
"JH378124","28306336","28306601","KQ052969v1","1108868","1109131","77","27197468"
"JH378124","28685918","28686192","KQ058405v1","697304","697560","85","27988614"
"JH378124","28767946","28768108","KQ053740v1","1071467","1071623","36","27696479"
"JH378125","19398423","19398701","KQ055097v1","1884579","1884874","69","17513844"
"JH378125","24907","25067","KQ058407v1","217537","217702","39","192630"
"JH378125","200478","200702","KQ054704v1","884226","884461","58","683748"
"JH378125","362074","362373","KQ058184v1","1505565","1505858","63","1143491"
"JH378125","600172","600355","KQ058494v1","668098","668289","57","67926"
"JH378125","879888","880012","KQ058550v1","2678881","2679004","35","1798993"
"JH378125","1210666","1210938","KQ058317v1","5506620","5506904","63","4295954"
"JH378125","1393164","1393445","KQ056928v1","2303396","2303675","61","910232"
"JH378125","1422133","1422450","KQ056014v1","335464","335774","74","1086669"
"JH378125","1514431","1514703","KQ053093v1","1361295","1361576","72","153136"
"JH378125","1744188","1744407","KQ054933v1","523965","524188","60","1220223"
"JH378125","2313307","2313600","KQ052968v1","14043756","14044036","70","11730449"
"JH378125","2854021","2854323","KQ058184v1","1505565","1505858","53","1348456"
"JH378125","3024253","3024520","KQ058503v1","123813","124064","66","2900440"
"JH378125","3269548","3269857","KQ054400v1","354368","354668","64","2915180"
"JH378125","4111450","4111718","KQ053059v1","2135970","2136233","61","1975480"
"JH378125","4194442","4194724","KQ053498v1","3647598","3647890","67","546844"
"JH378125","4194823","4195131","KQ055236v1","2049624","2049930","77","2145199"
"JH378125","4262522","4262806","KQ056673v1","1151371","1151663","56","3111151"
"JH378125","4342179","4342445","KQ058405v1","982085","982349","65","3360094"
"JH378125","4345236","4345547","KQ053849v1","842088","842395","63","3503148"
"JH378125","4353211","4353497","KQ058248v1","1222370","1222655","65","3130841"
"JH378125","4411644","4411939","KQ058184v1","1505565","1505858","60","2906079"
"JH378125","4442609","4442870","KQ056568v1","1535795","1536045","73","2906814"
"JH378125","4470620","4470873","KQ058427v1","4553509","4553777","65","82889"
"JH378125","4706846","4707124","KQ053631v1","6939636","6939913","71","2232790"
"JH378125","4772525","4772642","KQ053019v1","394011","394133","30","4378514"
"JH378125","4938008","4938297","KQ052971v1","841846","842131","61","4096162"
"JH378125","4954435","4954725","KQ054510v1","8518307","8518589","74","3563872"
"JH378125","5049970","5050255","KQ055490v1","2107132","2107421","72","2942838"
"JH378125","5059785","5059908","KQ053146v1","2799678","2799801","31","2260107"
"JH378125","5089758","5090062","KQ054510v1","7205518","7205814","86","2115760"
"JH378125","5091761","5092014","KQ055055v1","1882469","1882726","57","3209292"
"JH378125","5119869","5120147","KQ055893v1","2015012","2015285","62","3104857"
"JH378125","5126754","5126909","KQ052968v1","10427732","10427888","33","5300978"
"JH378125","5129236","5129377","KQ053354v1","702320","702452","30","4426916"
"JH378125","5156492","5156787","KQ058184v1","1505565","1505858","67","3650927"
"JH378125","5165804","5165935","KQ053565v1","1793162","1793293","19","3372642"
"JH378125","5202375","5202536","KQ057291v1","765415","765578","37","4436960"
"JH378125","5207268","5207404","KQ053003v1","17444","17574","30","5189824"
"JH378125","5353916","5354206","KQ053959v1","2839561","2839850","71","2514355"
"JH378125","5575867","5576162","KQ052969v1","9116808","9117108","74","3540941"
"JH378125","5937174","5937444","KQ052970v1","2531178","2531455","73","3405996"
"JH378125","6047075","6047374","KQ054804v1","964015","964313","58","5083060"
"JH378125","6112877","6113022","KQ056147v1","2168964","2169108","33","3943913"
"JH378125","6252953","6253229","KQ056440v1","1069847","1070137","66","5183106"
"JH378125","6693808","6694094","KQ055192v1","1304874","1305155","85","5388934"
"JH378125","6866666","6866979","KQ058405v1","1120230","1120530","75","5746436"
"JH378125","6866984","6867245","KQ054068v1","3810441","3810685","86","3056543"
"JH378125","6994765","6995063","KQ054191v1","3857584","3857880","71","3137181"
"JH378125","7026961","7027217","KQ054510v1","5210888","5211157","80","1816073"
"JH378125","7115272","7115480","KQ058505v1","2234909","2235124","62","4880363"
"JH378125","7891449","7891740","KQ057755v1","45985","46262","61","7845464"
"JH378125","8122797","8123118","KQ058290v1","511568","511873","82","7611229"
"JH378125","8642162","8642489","KQ056928v1","97902","98210","91","8544260"
"JH378125","9371789","9372085","KQ054069v1","7687863","7688158","69","1683926"
"JH378125","9520161","9520419","KQ055119v1","2510369","2510631","76","7009792"
"JH378125","9524742","9524887","KQ053179v1","1176666","1176810","34","8348076"
"JH378125","9600189","9600475","KQ057151v1","58440","58720","80","9541749"
"JH378125","9600601","9600895","KQ057648v1","78808","79100","71","9521793"
"JH378125","9668699","9668957","KQ058503v1","123813","124064","69","9544886"
"JH378125","10241562","10241619","KQ053260v1","77779","77831","18","10163783"
"JH378125","10241747","10241985","KQ054704v1","884226","884461","69","9357521"
"JH378125","10921846","10922127","KQ058561v1","4466656","4466945","67","6455190"
"JH378125","11535402","11535694","KQ057560v1","2746169","2746460","78","8789233"
"JH378125","11660115","11660266","KQ054565v1","1484422","1484575","38","10175693"
"JH378125","11966837","11967141","KQ054068v1","3341291","3341579","77","8625546"
"JH378125","12017102","12017196","KQ057821v1","1407299","1407387","29","10609803"
"JH378125","12119557","12119851","KQ053894v1","1290632","1290924","62","10828925"
"JH378125","12502586","12502660","KQ057796v1","119005","119079","20","12383581"
"JH378125","12502759","12502937","KQ054606v1","554177","554332","59","11948582"
"JH378125","12641369","12641665","KQ058184v1","1505565","1505858","73","11135804"
"JH378125","12795178","12795458","KQ057380v1","2548496","2548785","78","10246682"
"JH378125","13312899","13313202","KQ052969v1","9116808","9117108","65","4196091"
"JH378125","13589302","13589454","KQ053135v1","3925667","3925819","39","9663635"
"JH378125","13815853","13816078","KQ053587v1","1788518","1788751","71","12027335"
"JH378125","13849504","13849736","KQ053190v1","3029554","3029812","75","10819950"
"JH378125","13918577","13918744","KQ058265v1","212584","212745","36","13705993"
"JH378125","14986882","14987162","KQ058266v1","992042","992314","70","13994840"
"JH378125","15090349","15090634","KQ055755v1","209063","209333","70","14881286"
"JH378125","15531477","15531777","KQ056672v1","3082150","3082439","74","12449327"
"JH378125","16044767","16044932","KQ055498v1","556944","557105","49","15487823"
"JH378125","16107172","16107490","KQ055141v1","1054026","1054336","72","15053146"
"JH378125","16116883","16117014","KQ054213v1","615112","615244","29","15501771"
"JH378125","16168019","16168308","KQ058561v1","4466656","4466945","67","11701363"
"JH378125","16188903","16189212","KQ056345v1","621994","622295","70","15566909"
"JH378125","16252156","16252320","KQ055425v1","1445594","1445758","30","14806562"
"JH378125","16348916","16349113","KQ054776v1","1314982","1315182","64","15033934"
"JH378125","16398695","16398969","KQ055852v1","2060276","2060554","56","14338419"
"JH378125","16498807","16499099","KQ058328v1","4012912","4013206","65","12485895"
"JH378125","16636643","16636910","KQ056148v1","2246905","2247173","61","14389738"
"JH378125","16803635","16803898","KQ057345v1","1938824","1939073","72","14864811"
"JH378125","16947355","16947483","KQ053718v1","316226","316356","28","16631129"
"JH378125","16997197","16997382","KQ057737v1","1188439","1188621","43","15808758"
"JH378125","16997942","16998020","KQ055755v1","1328874","1328956","23","15669068"
"JH378125","17096707","17096985","KQ053299v1","21375969","21376245","76","4279262"
"JH378125","17160569","17160855","KQ054693v1","832788","833076","56","16327781"
"JH378125","17246467","17246560","KQ053827v1","2612475","2612564","19","14633992"
"JH378125","17412353","17412635","KQ058324v1","623645","623935","66","16788708"
"JH378125","17487868","17488141","KQ053096v1","602899","603182","66","16884969"
"JH378125","17617415","17617707","KQ053331v1","97381","97652","103","17520034"
"JH378125","17640375","17640526","KQ054682v1","606323","606472","33","17034052"
"JH378125","17669319","17669444","KQ053299v1","20832561","20832685","30","3163242"
"JH378125","17737149","17737447","KQ055787v1","970960","971266","67","16766189"
"JH378125","18238707","18238936","KQ053785v1","2317325","2317548","59","15921382"
"JH378125","18524204","18524512","KQ055479v1","1841725","1842025","62","16682479"
"JH378125","18638123","18638424","KQ058184v1","1505565","1505858","62","17132558"
"JH378125","18712366","18712517","KQ055214v1","4014336","4014483","47","14698030"
"JH378125","18714981","18715274","KQ053387v1","4074527","4074832","68","14640454"
"JH378125","18789511","18789646","KQ053948v1","2765570","2765701","24","16023941"
"JH378125","18852776","18853080","KQ058184v1","1505565","1505858","72","17347211"
"JH378125","18859630","18859912","KQ054069v1","955693","955974","60","17903937"
"JH378125","19199954","19200249","KQ058094v1","7832529","7832815","59","11367425"
"JH378125","19220501","19220636","KQ053982v1","3934263","3934401","30","15286238"
"JH378125","19355107","19355405","KQ056790v1","446564","446855","69","18908543"
"JH378125","19379720","19380047","KQ055978v1","3588191","3588491","95","15791529"
"JH378125","19389241","19389530","KQ054510v1","9729880","9730175","67","9659361"
"JH378125","19434612","19434865","KQ053191v1","1874915","1875171","67","17559697"
"JH378125","19452481","19452791","KQ058585v1","580456","580763","61","18872025"
"JH378125","19534397","19534681","KQ053654v1","3690816","3691107","66","15843581"
"JH378125","19645433","19645736","KQ054068v1","1099741","1100039","67","18545692"
"JH378125","19897333","19897510","KQ056475v1","396846","397033","63","19500487"
"JH378125","20158582","20158788","KQ053223v1","773388","773584","59","19385194"
"JH378125","20324593","20324808","KQ058487v1","1040716","1040932","55","19283877"
"JH378125","20990604","20990761","KQ053740v1","1071467","1071623","37","19919137"
"JH378125","21281696","21281929","KQ055610v1","1015132","1015354","74","20266564"
"JH378125","21665873","21666004","KQ055352v1","4179658","4179774","41","17486215"
"JH378125","21969771","21969967","KQ056234v1","1020319","1020518","57","20949452"
"JH378125","22348627","22348936","KQ056928v1","1915686","1915996","74","20432941"
"JH378125","23218777","23219099","KQ052968v1","7084626","7084953","88","16134151"
"JH378125","23230652","23230857","KQ055872v1","1786723","1786929","54","21443929"
"JH378125","23373625","23373753","KQ054522v1","21180","21301","34","23352445"
"JH378125","23403993","23404292","KQ053082v1","1023453","1023747","72","22380540"
"JH378125","23448359","23448670","KQ054693v1","832788","833076","74","22615571"
"JH378125","23513129","23513434","KQ053816v1","7464708","7465010","61","16048421"
"JH378125","23613129","23613440","KQ054124v1","473618","473911","73","23139511"
"JH378125","23810726","23811041","KQ056568v1","817681","817996","73","22993045"
"JH378125","24041165","24041271","KQ058328v1","5358834","5358954","31","18682331"
"JH378125","24058676","24058973","KQ053948v1","168940","169229","67","23889736"
"JH378125","24081753","24081881","KQ057910v1","1548802","1548933","27","22532951"
"JH378125","24165318","24165477","KQ057023v1","876183","876346","42","23289135"
"JH378125","24335460","24335631","KQ053498v1","3849226","3849393","41","20486234"
"JH378125","24411458","24411693","KQ054289v1","4494059","4494296","81","19917399"
"JH378125","24519509","24519793","KQ053146v1","2819587","2819868","68","21699922"
"JH378125","24796656","24796918","KQ056597v1","1198358","1198607","69","23598298"
"JH378125","25168607","25168746","KQ058394v1","2902727","2902859","30","22265880"
"JH378125","25466968","25467247","KQ053410v1","515520","515804","70","24951448"
"JH378125","25648596","25648877","KQ052968v1","13260777","13261056","68","12387819"
"JH378125","25743232","25743381","KQ054682v1","606323","606472","32","25136909"
"JH378125","26279142","26279293","KQ056587v1","7257462","7257612","36","19021680"
"JH378125","26279395","26279450","KQ056540v1","178443","178502","20","26100952"
"JH378125","26373087","26373390","KQ054191v1","3857584","3857880","73","22515503"
"JH378125","26551933","26552097","KQ055214v1","601175","601332","38","25950758"
"JH378125","26599362","26599470","KQ052969v1","2661859","2661968","30","23937503"
"JH378125","26667945","26668028","KQ054400v1","280157","280246","26","26387788"
"JH378125","27083510","27083691","KQ053631v1","9533513","9533694","48","17549997"
"JH378125","27210349","27210574","KQ055830v1","278558","278787","75","26931791"
"JH378125","27358309","27358548","KQ057910v1","2769076","2769295","75","24589233"
"JH378125","27485001","27485245","KQ053872v1","1102425","1102662","73","26382576"
"JH378126","445912","446215","KQ058512v1","329344","329634","75","116568"
"JH378126","762967","763252","KQ053763v1","3936916","3937207","71","3173949"
"JH378126","847856","848072","KQ057290v1","3936336","3936540","60","3088480"
"JH378126","990034","990324","KQ052970v1","9411816","9412108","73","8421782"
"JH378126","1128918","1129206","KQ053948v1","168940","169229","64","959978"
"JH378126","1234747","1234827","KQ054124v1","2329074","2329151","20","1094327"
"JH378126","1395986","1396135","KQ054682v1","606323","606472","33","789663"
"JH378126","1530392","1530653","KQ056404v1","1771928","1772196","60","241536"
"JH378126","1591060","1591349","KQ053740v1","716482","716767","70","874578"
"JH378126","1704768","1705045","KQ054693v1","832788","833076","72","871980"
"JH378126","1781678","1781945","KQ053487v1","3306049","3306316","69","1524371"
"JH378126","1782357","1782558","KQ053849v1","1126392","1126589","44","655965"
"JH378126","1782600","1782692","KQ053179v1","1820197","1820288","24","37597"
"JH378126","1799844","1800143","KQ053631v1","7288314","7288608","79","5488470"
"JH378126","1847784","1848062","KQ054510v1","1641980","1642248","71","205804"
"JH378126","1896275","1896564","KQ058316v1","753926","754202","73","1142349"
"JH378126","2028300","2028583","KQ056790v1","446564","446855","68","1581736"
"JH378126","2180305","2180432","KQ056855v1","2808237","2808368","31","627932"
"JH378126","2603170","2603456","KQ053343v1","2900708","2901000","78","297538"
"JH378126","2948354","2948671","KQ052970v1","843026","843331","84","2105328"
"JH378126","2963008","2963281","KQ054400v1","4832904","4833184","79","1869896"
"JH378126","3173690","3173782","KQ056414v1","256142","256232","25","2917548"
"JH378126","3295301","3295589","KQ053288v1","3772705","3772989","70","477404"
"JH378126","3429314","3429438","KQ056035v1","296324","296444","36","3132990"
"JH378126","3540410","3540552","KQ054378v1","157932","158074","32","3382478"
"JH378126","3767860","3767981","KQ054068v1","6466552","6466668","34","2698692"
"JH378126","3950403","3950690","KQ053115v1","1118362","1118655","71","2832041"
"JH378126","4585195","4585297","KQ054356v1","2742215","2742318","24","1842980"
"JH378126","4868131","4868359","KQ054886v1","79","289","76","4868052"
"JH378126","5584070","5584358","KQ052969v1","8840489","8840774","70","3256419"
"JH378126","5726770","5727077","KQ056855v1","4111147","4111444","78","1615623"
"JH378126","5940298","5940557","KQ054279v1","3033507","3033776","75","2906791"
"JH378126","6138893","6139202","KQ053816v1","7327018","7327317","77","1188125"
"JH378126","6212006","6212291","KQ052970v1","2531178","2531455","73","3680828"
"JH378126","6801955","6802247","KQ053190v1","5623449","5623748","75","1178506"
"JH378126","7166466","7166759","KQ054068v1","3341291","3341579","64","3825175"
"JH378126","7167286","7167407","KQ053299v1","20832561","20832685","34","13665275"
"JH378126","7216898","7217147","KQ055364v1","1919520","1919774","71","5297378"
"JH378126","7340574","7340719","KQ054682v1","606323","606472","33","6734251"
"JH378126","7917336","7917392","KQ053260v1","77779","77831","15","7839557"
"JH378126","7917989","7918058","KQ052968v1","6651533","6651609","18","1266456"
"JH378126","7918082","7918210","KQ052970v1","12418764","12418905","41","4500682"
"JH378126","7998081","7998390","KQ052968v1","5470311","5470611","70","2527770"
"JH378126","8000041","8000243","KQ057290v1","4745481","4745684","51","3254560"
"JH378126","8130571","8130885","KQ053554v1","2471177","2471484","81","5659394"
"JH378126","8158134","8158439","KQ058184v1","1505565","1505858","74","6652569"
"JH378126","8191855","8192114","KQ055629v1","27732","27989","62","8164123"
"JH378126","8327373","8327683","KQ055457v1","2061137","2061448","72","6266236"
"JH378126","8423477","8423774","KQ054412v1","2490468","2490761","69","5933009"
"JH378126","8522461","8522774","KQ053288v1","2034811","2035125","74","6487650"
"JH378126","8555660","8555801","KQ053190v1","2372433","2372579","30","6183227"
"JH378126","8593619","8593929","KQ055798v1","887234","887524","81","7706385"
"JH378126","8623350","8623637","KQ054068v1","3341291","3341579","66","5282059"
"JH378126","8828559","8828704","KQ053157v1","5478543","5478695","35","3350016"
"JH378126","8829408","8829598","KQ058094v1","6990178","6990359","55","1839230"
"JH378126","8853728","8853994","KQ054135v1","2702098","2702381","76","6151630"
"JH378126","8879902","8880186","KQ052970v1","10427454","10427754","75","1547552"
"JH378126","8987556","8987849","KQ053631v1","9963313","9963601","62","975757"
"JH378126","9031630","9031889","KQ054826v1","9895778","9896046","72","864148"
"JH378126","9573516","9573759","KQ053587v1","1184258","1184508","77","8389258"
"JH378126","10168895","10169024","KQ052968v1","9760638","9760766","29","408257"
"JH378126","10501473","10501584","KQ053115v1","4371036","4371145","20","6130437"
"JH378126","10741631","10741913","KQ058316v1","4697990","4698273","72","6043641"
"JH378126","11429855","11430149","KQ055375v1","2577826","2578106","77","8852029"
"JH378126","11644424","11644711","KQ053520v1","2913074","2913361","67","8731350"
"JH378126","12377529","12377631","KQ055662v1","2319305","2319402","30","10058224"
"JH378126","12618284","12618580","KQ054412v1","2490468","2490761","77","10127816"
"JH378126","12745299","12745599","KQ058184v1","1505565","1505858","77","11239734"
"JH378126","12855757","12856029","KQ053297v1","44026","44315","77","12811731"
"JH378126","12951654","12951933","KQ053146v1","2819587","2819868","66","10132067"
"JH378126","13894999","13895281","KQ053278v1","106295","106592","92","13788704"
"JH378126","14118467","14118747","KQ058413v1","348155","348432","64","13770312"
"JH378126","14174074","14174386","KQ058290v1","511568","511873","75","13662506"
"JH378126","14343278","14343579","KQ055004v1","332895","333205","78","14010383"
"JH378126","14447944","14448244","KQ054191v1","4151413","4151706","80","10296531"
"JH378126","14661507","14661811","KQ058389v1","2329886","2330179","80","12331621"
"JH378126","14672228","14672532","KQ058552v1","771580","771883","85","13900648"
"JH378126","14943683","14943995","KQ053740v1","2898644","2898953","91","12045039"
"JH378126","14958409","14958694","KQ055352v1","4183105","4183394","69","10775304"
"JH378126","15880045","15880183","KQ054724v1","4354278","4354419","37","11525767"
"JH378126","16280270","16280548","KQ058184v1","1608105","1608378","71","14672165"
"JH378126","16308139","16308402","KQ054026v1","1635275","1635542","75","14672864"
"JH378126","17259102","17259231","KQ053299v1","22459675","22459802","31","5200573"
"JH378126","17352603","17352881","KQ053520v1","2992926","2993205","55","14359677"
"JH378126","17471888","17471993","KQ058094v1","5889178","5889279","29","11582710"
"JH378126","17472136","17472279","KQ054378v1","157932","158074","37","17314204"
"JH378126","17562822","17563090","KQ056368v1","571844","572113","70","16990978"
"JH378126","17900574","17900874","KQ054868v1","1651243","1651531","68","16249331"
"JH378126","18347533","18347827","KQ057909v1","3829378","3829677","75","14518155"
"JH378126","19097043","19097335","KQ056148v1","2419670","2419961","76","16677373"
"JH378126","20987186","20987497","KQ055787v1","694393","694708","67","20292793"
"JH378126","21147285","21147536","KQ053498v1","3849819","3850073","55","17297466"
"JH378126","21505493","21505668","KQ055457v1","11733685","11733859","31","9771808"
"JH378126","21745922","21746171","KQ058503v1","123813","124064","72","21622109"
"JH378126","22013673","22013951","KQ056494v1","2222182","2222467","74","19791491"
"JH378126","22074973","22075093","KQ054412v1","2196456","2196568","40","19878517"
"JH378126","22103422","22103693","KQ057205v1","1486379","1486647","62","20617043"
"JH378126","22772202","22772355","KQ058004v1","4755337","4755486","30","18016865"
"JH378126","22893340","22893626","KQ058183v1","4026019","4026305","71","18867321"
"JH378126","22898225","22898511","KQ055457v1","8436987","8437281","73","14461238"
"JH378126","23211460","23211742","KQ052981v1","658787","659079","66","22552673"
"JH378126","23369511","23369813","KQ054068v1","5491779","5492087","75","17877732"
"JH378126","23435651","23435822","KQ058459v1","469480","469653","36","22966171"
"JH378126","23508527","23508831","KQ057737v1","4424765","4425071","66","19083762"
"JH378126","23538215","23538501","KQ053741v1","2899023","2899305","58","20639192"
"JH378126","23867210","23867457","KQ055872v1","4839210","4839481","82","19028000"
"JH378126","23948004","23948296","KQ054868v1","2066688","2066976","74","21881316"
"JH378126","23975447","23975729","KQ052968v1","13260777","13261056","65","10714670"
"JH378126","24269925","24270209","KQ054693v1","832788","833076","62","23437137"
"JH378126","24286475","24286751","KQ055065v1","1117201","1117481","59","23169274"
"JH378126","24392853","24393171","KQ058272v1","4942871","4943179","76","19449982"
"JH378126","24499586","24499901","KQ053299v1","2867160","2867464","71","21632426"
"JH378126","24507560","24507807","KQ053686v1","2718006","2718245","60","21789554"
"JH378126","24660172","24660448","KQ052969v1","7351818","7352090","55","17308354"
"JH378126","25078070","25078360","KQ055375v1","2577826","2578106","79","22500244"
"JH378126","25671262","25671535","KQ054618v1","2142076","2142353","72","23529186"
"JH378127","1572686","1572961","KQ053476v1","3998036","3998311","73","2425350"
"JH378127","618476","618633","KQ057118v1","1492016","1492164","41","873540"
"JH378127","650618","650760","KQ054179v1","3818836","3818992","43","3168218"
"JH378127","673482","673724","KQ054345v1","1135795","1136030","67","462313"
"JH378127","772306","772627","KQ058483v1","4098293","4098613","78","3325987"
"JH378127","795971","796274","KQ052969v1","9116808","9117108","79","8320837"
"JH378127","910882","911065","KQ053948v1","2270313","2270496","56","1359431"
"JH378127","1092328","1092456","KQ053543v1","1868215","1868343","32","775887"
"JH378127","1119661","1119824","KQ052969v1","8430836","8430996","37","7311175"
"JH378127","1145042","1145232","KQ058550v1","3053970","3054174","58","1908928"
"JH378127","1231561","1231851","KQ054069v1","7687863","7688158","58","6456302"
"JH378127","1566603","1566885","KQ055014v1","159249","159539","72","1407354"
"JH378127","1646076","1646130","KQ053299v1","2592408","2592461","17","946332"
"JH378127","1646148","1646184","KQ053299v1","20748277","20748312","12","19102129"
"JH378127","1646268","1646278","KQ052970v1","6659383","6659394","3","5013115"
"JH378127","1740477","1740630","KQ053082v1","2181762","2181924","43","441285"
"JH378127","1826846","1827132","KQ055852v1","2060276","2060554","73","233430"
"JH378127","1843435","1843764","KQ055808v1","1435153","1435453","84","408282"
"JH378127","1848168","1848325","KQ055872v1","9395394","9395552","37","7547226"
"JH378127","1858597","1858880","KQ054868v1","2229582","2229854","68","370985"
"JH378127","1878557","1878753","KQ053294v1","648","849","54","1877909"
"JH378127","2223737","2224038","KQ053115v1","1118362","1118655","70","1105375"
"JH378127","3207642","3207940","KQ054068v1","5074639","5074944","77","1866997"
"JH378127","3223970","3224288","KQ058583v1","3101722","3102049","85","122248"
"JH378127","3927337","3927500","KQ057336v1","635116","635282","42","3292221"
"JH378127","3972500","3972817","KQ053157v1","395610","395902","86","3576890"
"JH378127","4230051","4230368","KQ057290v1","2481256","2481560","80","1748795"
"JH378127","4618647","4618923","KQ058184v1","1505565","1505858","76","3113082"
"JH378127","4745825","4745953","KQ053115v1","1333586","1333718","29","3412239"
"JH378127","4789965","4790259","KQ055852v1","2060276","2060554","85","2729689"
"JH378127","4792001","4792292","KQ054191v1","3583730","3584032","76","1208271"
"JH378127","4877796","4878085","KQ057118v1","465368","465655","80","4412428"
"JH378127","5088339","5088436","KQ052982v1","1023528","1023630","29","4064811"
"JH378127","5608309","5608594","KQ057004v1","1506143","1506432","73","4102166"
"JH378127","5666570","5666743","KQ055014v1","2321535","2321726","50","3345035"
"JH378127","5669737","5670025","KQ053146v1","2819587","2819868","71","2850150"
"JH378127","5702927","5703154","KQ057291v1","322948","323180","59","5379979"
"JH378127","5726674","5727004","KQ055766v1","1784472","1784784","84","3942202"
"JH378127","5763024","5763301","KQ052968v1","13260777","13261056","71","7497753"
"JH378127","5860415","5860698","KQ058484v1","1229388","1229668","65","4631027"
"JH378127","5949357","5949608","KQ058305v1","2924909","2925173","77","3024448"
"JH378127","6065050","6065317","KQ058561v1","7531454","7531724","63","1466404"
"JH378127","6112127","6112400","KQ053409v1","4241768","4242029","78","1870359"
"JH378127","6117172","6117485","KQ054704v1","215433","215738","82","5901739"
"JH378127","6314836","6314994","KQ055978v1","2949687","2949843","39","3365149"
"JH378127","6315676","6315783","KQ053850v1","279389","279490","29","6036287"
"JH378127","6362604","6362917","KQ058389v1","2329886","2330179","81","4032718"
"JH378127","6475970","6476250","KQ056331v1","348695","348980","74","6127275"
"JH378127","6480054","6480334","KQ056331v1","348695","348980","74","6131359"
"JH378127","6857873","6858145","KQ055872v1","3222285","3222560","79","3635588"
"JH378127","6902561","6902853","KQ053190v1","5495992","5496283","63","1406569"
"JH378127","7045391","7045659","KQ055662v1","4683524","4683789","56","2361867"
"JH378127","7945294","7945509","KQ054704v1","483937","484161","69","7461357"
"JH378127","8087453","8087765","KQ057373v1","1224950","1225260","73","6862503"
"JH378127","8141348","8141580","KQ054279v1","1133071","1133299","57","7008277"
"JH378127","8295797","8296004","KQ052970v1","11415688","11415897","53","3119891"
"JH378127","8298523","8298820","KQ056587v1","7322169","7322473","69","976354"
"JH378127","8365420","8365504","KQ053454v1","1364861","1364941","20","7000559"
"JH378127","8391423","8391723","KQ055600v1","649277","649577","63","7742146"
"JH378127","8477739","8477901","KQ053631v1","5537811","5537978","38","2939928"
"JH378127","8529020","8529160","KQ053037v1","3255963","3256108","33","5273057"
"JH378127","8575837","8576133","KQ054693v1","837377","837666","75","7738460"
"JH378127","8603300","8603423","KQ054725v1","1816931","1817058","26","6786369"
"JH378127","8610831","8611132","KQ053565v1","3797961","3798259","73","4812870"
"JH378127","8653460","8653609","KQ053190v1","2372433","2372579","32","6281027"
"JH378127","8731875","8732153","KQ058316v1","6284943","6285210","85","2446932"
"JH378127","8738887","8739185","KQ053927v1","199693","199992","76","8539194"
"JH378127","8750231","8750348","KQ056672v1","6062631","6062745","25","2687600"
"JH378127","8753690","8753822","KQ053432v1","3920706","3920835","23","4832984"
"JH378127","8881994","8882280","KQ058483v1","6010751","6011031","60","2871243"
"JH378127","9210825","9211086","KQ053795v1","380044","380305","64","8830781"
"JH378127","9364959","9365254","KQ052981v1","658787","659079","56","8706172"
"JH378127","9469407","9469670","KQ053631v1","9398334","9398603","61","71073"
"JH378127","9470536","9470809","KQ057291v1","667476","667747","64","8803060"
"JH378127","9586009","9586107","KQ053838v1","1840604","1840696","35","7745405"
"JH378127","9694054","9694178","KQ053157v1","5621627","5621750","26","4072427"
"JH378127","9694396","9694504","KQ057345v1","1181543","1181650","37","8512853"
"JH378127","9718014","9718204","KQ054058v1","1737833","1738018","48","7980181"
"JH378127","9725684","9725979","KQ053299v1","21835674","21835971","64","12109990"
"JH378127","9794129","9794411","KQ053190v1","4987885","4988162","68","4806244"
"JH378127","9947398","9947680","KQ058317v1","5506620","5506904","58","4440778"
"JH378127","9947727","9947872","KQ054510v1","8179279","8179421","23","1768448"
"JH378127","9952871","9953048","KQ053157v1","7874292","7874430","71","2078579"
"JH378127","9999823","9999954","KQ058328v1","5358834","5358954","29","4640989"
"JH378127","10258649","10258775","KQ058516v1","4102482","4102606","26","6156167"
"JH378127","10293586","10293744","KQ058550v1","4456971","4457134","47","5836615"
"JH378127","10293747","10293949","KQ058506v1","612733","612922","54","9681014"
"JH378127","10302153","10302429","KQ054510v1","5210888","5211157","75","5091265"
"JH378127","10302669","10302792","KQ054786v1","479127","479249","26","9823542"
"JH378127","10302870","10303075","KQ057290v1","1671404","1671603","47","8631466"
"JH378127","10749185","10749492","KQ056331v1","1886723","1887024","69","8862462"
"JH378127","10816221","10816524","KQ058427v1","7552507","7552810","69","3263714"
"JH378127","10935645","10935938","KQ056148v1","4371920","4372216","66","6563725"
"JH378127","11188956","11189133","KQ054660v1","3679956","3680128","59","7509000"
"JH378127","11243032","11243368","KQ055352v1","5244823","5245128","104","5998209"
"JH378127","11278158","11278345","KQ054879v1","1455515","1455684","60","9822643"
"JH378127","11461052","11461327","KQ053093v1","1361295","1361576","67","10099757"
"JH378127","11476391","11476692","KQ052968v1","9583834","9584132","61","1892557"
"JH378127","11511167","11511463","KQ053331v1","268052","268335","73","11243115"
"JH378127","11520680","11520958","KQ056663v1","500658","500926","89","11020022"
"JH378127","11835619","11835911","KQ053288v1","2218996","2219287","61","9616623"
"JH378127","12139713","12139996","KQ054068v1","8076811","8077098","66","4062902"
"JH378127","12849763","12849931","KQ054510v1","8888528","8888700","38","3961235"
"JH378127","12917696","12917990","KQ054510v1","8555095","8555387","53","4362601"
"JH378127","13060380","13060526","KQ053212v1","578976","579120","30","12481404"
"JH378127","13160633","13160829","KQ053398v1","3158290","3158500","46","10002343"
"JH378127","13204452","13204730","KQ058004v1","1480411","1480689","63","11724041"
"JH378127","13272785","13273079","KQ058272v1","5443874","5444159","68","7828911"
"JH378127","13648736","13649028","KQ054693v1","832788","833076","70","12815948"
"JH378127","13851853","13852134","KQ053104v1","3864277","3864560","64","9987576"
"JH378127","13957772","13958079","KQ053554v1","2471177","2471484","79","11486595"
"JH378127","14026750","14026920","KQ057036v1","1270725","1270889","38","12756025"
"JH378127","14460890","14461198","KQ058004v1","5010124","5010435","74","9450766"
"JH378127","14801586","14801876","KQ055014v1","2491689","2491976","66","12309897"
"JH378127","14920633","14920834","KQ057764v1","2088730","2088934","62","12831903"
"JH378127","15121039","15121267","KQ053696v1","1876148","1876374","65","13244891"
"JH378127","15343044","15343253","KQ054069v1","159011","159235","51","15184033"
"JH378127","15365624","15365687","KQ058076v1","120666","120729","15","15244958"
"JH378127","15467748","15468034","KQ053146v1","2819587","2819868","57","12648161"
"JH378127","15468433","15468733","KQ057693v1","117172","117472","62","15351261"
"JH378127","15610740","15611042","KQ054932v1","4838112","4838407","72","10772628"
"JH378127","15811279","15811572","KQ055247v1","4445738","4446031","72","11365541"
"JH378127","15875465","15875589","KQ056404v1","1195188","1195317","30","14680277"
"JH378127","15904555","15904829","KQ056587v1","1312432","1312709","63","14592123"
"JH378127","16013625","16013755","KQ056643v1","1491838","1491968","26","14521787"
"JH378127","17892992","17893288","ABDC02052257v1","792","1085","70","17892200"
"JH378127","18121980","18122071","KQ054400v1","280157","280246","20","17841823"
"JH378127","18163414","18163577","KQ056996v1","1524030","1524195","36","16639384"
"JH378127","18284688","18284945","KQ054826v1","9969237","9969502","65","8315451"
"JH378127","18288682","18288803","KQ053026v1","2376723","2376841","28","15911959"
"JH378127","18596858","18597159","KQ053146v1","1320586","1320881","78","17276272"
"JH378127","18639124","18639426","KQ058266v1","898592","898893","65","17740532"
"JH378127","18716670","18716927","KQ057380v1","5005431","5005698","83","13711239"
"JH378127","18754626","18754664","KQ056672v1","5125852","5125891","13","13628774"
"JH378127","18754687","18754867","KQ053631v1","7980794","7980971","49","10773893"
"JH378127","18757023","18757307","KQ057755v1","2041504","2041782","80","16715519"
"JH378127","18813341","18813533","KQ052969v1","8528994","8529192","45","10284347"
"JH378127","18813954","18814061","KQ054323v1","1973428","1973538","22","16840526"
"JH378127","18826177","18826435","KQ055978v1","5278975","5279254","73","13547202"
"JH378127","19071779","19072082","KQ054466v1","2183618","2183917","66","16888161"
"JH378127","19128236","19128517","KQ054400v1","2059350","2059621","66","17068886"
"JH378127","19445672","19445951","KQ058317v1","5506620","5506904","61","13939052"
"JH378127","19701368","19701570","KQ053398v1","3158290","3158500","50","16543078"
"JH378127","20468707","20468979","KQ053686v1","963025","963293","61","19505682"
"JH378127","20675188","20675506","KQ058283v1","622348","622657","79","20052840"
"JH378127","20846118","20846408","KQ056234v1","2521120","2521411","88","18324998"
"JH378127","20892725","20893036","KQ055629v1","4218571","4218881","72","16674154"
"JH378127","21075378","21075522","KQ058427v1","4756553","4756686","35","16318825"
"JH378127","21500468","21500599","KQ053432v1","7005343","7005477","34","14495125"
"JH378127","22140035","22140213","KQ055140v1","1129098","1129272","44","21010937"
"JH378127","22442415","22442710","KQ056790v1","446564","446855","76","21995851"
"JH378127","22545290","22545600","KQ058389v1","2329886","2330179","80","20215404"
"JH378127","22598129","22598250","KQ053409v1","6105325","6105446","24","16492804"
"JH378127","22754041","22754326","KQ058356v1","225845","226125","66","22528196"
"JH378127","23318175","23318461","KQ058184v1","1505565","1505858","68","21812610"
"JH378127","23876749","23877035","KQ057649v1","382951","383234","69","23493798"
"JH378127","23902351","23902648","KQ053421v1","2664387","2664683","66","21237964"
"JH378127","23923280","23923579","KQ056293v1","417508","417818","79","23505772"
"JH378127","24198002","24198136","KQ054213v1","615112","615244","26","23582890"
"JH378127","24324464","24324768","KQ052968v1","9540930","9541228","84","14783534"
"JH378127","24338530","24338839","KQ056432v1","1643068","1643346","80","22695462"
"JH378127","25143478","25143672","KQ053948v1","2776497","2776701","54","22366981"
"JH378127","25680526","25680625","KQ055214v1","452701","452790","28","25227825"
"JH378127","26073542","26073849","KQ058585v1","580456","580763","72","25493086"
"JH378127","26099505","26099588","KQ053432v1","5774004","5774087","21","20325501"
"JH378128","247397","247687","KQ056456v1","918897","919186","62","671500"
"JH378128","340128","340264","KQ053059v1","5084837","5084963","52","4744709"
"JH378128","340642","340779","KQ055141v1","2115239","2115370","37","1774597"
"JH378128","603385","603669","KQ057308v1","1312598","1312876","69","709213"
"JH378128","837735","837891","KQ055404v1","3099039","3099197","52","2261304"
"JH378128","1476589","1476863","KQ058173v1","992259","992524","69","484330"
"JH378128","2124144","2124422","KQ055873v1","328672","328938","70","1795472"
"JH378128","2327323","2327377","KQ053299v1","2592408","2592461","13","265085"
"JH378128","2401805","2401976","KQ057737v1","835784","835962","47","1566021"
"JH378128","2401999","2402080","KQ058427v1","6765309","6765385","34","4363310"
"JH378128","2520116","2520325","KQ056643v1","601903","602112","55","1918213"
"JH378128","2804161","2804440","KQ053959v1","2839561","2839850","71","35400"
"JH378128","3204629","3204909","KQ057045v1","590946","591241","60","2613683"
"JH378128","3302360","3302658","KQ058184v1","1505565","1505858","62","1796795"
"JH378128","3411727","3412029","KQ053894v1","1290632","1290924","77","2121095"
"JH378128","3667529","3667810","KQ057291v1","667476","667747","75","3000053"
"JH378128","3698812","3699109","KQ053774v1","2397082","2397375","73","1301730"
"JH378128","3797752","3798044","KQ057380v1","6646151","6646454","69","2848399"
"JH378128","3842396","3842658","KQ053037v1","3640291","3640559","69","202105"
"JH378128","4202992","4203119","KQ054179v1","3865170","3865294","27","337822"
"JH378128","4296614","4296885","KQ053332v1","447571","447853","68","3849043"
"JH378128","4620634","4620838","KQ057268v1","1608514","1608738","66","3012120"
"JH378128","5024416","5024689","KQ053763v1","141096","141389","73","4883320"
"JH378128","5043902","5044191","KQ053894v1","1290632","1290924","81","3753270"
"JH378128","5722444","5722636","KQ052970v1","7199437","7199628","44","1476993"
"JH378128","5728149","5728433","KQ054124v1","2442155","2442433","74","3285994"
"JH378128","6357924","6358174","KQ058505v1","2479512","2479769","75","3878412"
"JH378128","6467344","6467657","KQ054932v1","10830322","10830609","90","4362978"
"JH378128","6498044","6498332","KQ056147v1","1064032","1064323","61","5434012"
"JH378128","6901661","6901775","KQ055498v1","20783","20899","29","6880878"
"JH378128","7158889","7159153","KQ053521v1","322834","323094","64","6836055"
"JH378128","7660399","7660707","KQ053115v1","3485337","3485650","75","4175062"
"JH378128","8013938","8014227","KQ057702v1","1420535","1420827","67","6593403"
"JH378128","8045901","8046040","KQ053299v1","7348738","7348881","30","697163"
"JH378128","8270671","8270807","KQ057875v1","315120","315258","38","7955551"
"JH378128","8561486","8561773","KQ054401v1","2629005","2629296","70","5932481"
"JH378128","8656592","8656737","KQ052969v1","8332082","8332226","31","324510"
"JH378128","9046853","9047138","KQ056432v1","1747986","1748267","77","7298867"
"JH378128","9053815","9054031","KQ053093v1","1363144","1363361","63","7690671"
"JH378128","9950328","9950607","KQ055087v1","1063066","1063349","77","8887262"
"JH378128","10122808","10123094","KQ054932v1","9022614","9022904","81","1100194"
"JH378128","10653173","10653334","KQ058183v1","3213511","3213674","50","7439662"
"JH378128","11201091","11201386","KQ058389v1","2329886","2330179","67","8871205"
"JH378128","11298677","11298969","KQ058184v1","1505565","1505858","64","9793112"
"JH378128","11339928","11340244","KQ053037v1","2305956","2306272","74","9033972"
"JH378128","11395945","11396084","KQ055141v1","2115239","2115370","34","9280706"
"JH378128","11426542","11426697","KQ056404v1","1391066","1391218","38","10035476"
"JH378128","11446981","11447118","KQ056663v1","464182","464321","31","10982799"
"JH378128","11517224","11517485","KQ058394v1","3915274","3915538","63","7601950"
"JH378128","11604492","11604786","KQ058594v1","5863745","5864030","77","5740747"
"JH378128","11716105","11716269","KQ053916v1","1023573","1023722","44","10692532"
"JH378128","12044864","12045025","KQ053409v1","3021754","3021920","39","9023110"
"JH378128","12245340","12245637","KQ053631v1","9963313","9963601","69","2282027"
"JH378128","12360422","12360727","KQ053299v1","4095914","4096215","71","8264508"
"JH378128","12482201","12482481","KQ058094v1","7832529","7832815","75","4649672"
"JH378128","12539174","12539389","KQ058561v1","565602","565807","52","11973572"
"JH378128","12679625","12679907","KQ056494v1","2222182","2222467","67","10457443"
"JH378128","12703067","12703365","KQ057911v1","428931","429228","68","12274136"
"JH378128","12748990","12749273","KQ058452v1","757762","758043","78","11991228"
"JH378128","12834850","12835150","KQ052969v1","9116808","9117108","75","3718042"
"JH378128","12876629","12876745","KQ056035v1","721922","722032","23","12154707"
"JH378128","13012783","13013123","KQ055767v1","2455394","2455703","95","10557389"
"JH378128","14694492","14694790","KQ055331v1","476282","476544","77","14218210"
"JH378128","16690263","16690576","KQ055141v1","1054026","1054336","84","15636237"
"JH378128","16713532","16713807","KQ057931v1","399684","399967","81","16313848"
"JH378128","17058382","17058607","KQ054693v1","2405955","2406178","64","14652427"
"JH378128","17244307","17244438","KQ056855v1","2808237","2808368","38","14436070"
"JH378128","17244581","17244702","KQ053310v1","1622751","1622859","36","15621830"
"JH378128","17313495","17313768","KQ054400v1","446491","446757","78","16867004"
"JH378128","17544577","17544738","KQ056475v1","5275769","5275928","31","12268808"
"JH378128","17644326","17644601","KQ053191v1","614334","614618","77","17029992"
"JH378128","17960964","17961232","KQ052970v1","2715607","2715860","79","15245357"
"JH378128","17976724","17977023","KQ058184v1","1505565","1505858","77","16471159"
"JH378128","17999111","17999326","KQ053959v1","3147544","3147761","78","14851567"
"JH378128","18343369","18343664","KQ055309v1","1596833","1597106","76","16746536"
"JH378128","18623820","18624054","KQ057909v1","12196801","12197037","65","6427019"
"JH378128","18875245","18875482","KQ053849v1","2000206","2000452","73","16875039"
"JH378128","19050684","19050964","KQ053927v1","300161","300454","83","18750523"
"JH378128","19404255","19404433","KQ055479v1","2601433","2601611","50","16802822"
"JH378128","19456882","19456982","KQ055903v1","115400","115506","27","19341482"
"JH378128","21176870","21177171","KQ052981v1","1198440","1198752","80","19978430"
"JH378128","21302048","21302323","KQ053465v1","403029","403303","81","20899019"
"JH378128","21428847","21429131","KQ053082v1","1476670","1476954","87","19952177"
"JH378128","21634868","21635151","KQ053410v1","515520","515804","77","21119348"
"JH378128","22151324","22151455","KQ053982v1","7381789","7381920","22","14769535"
"JH378128","23406978","23407128","KQ054180v1","70685","70834","39","23336293"
"JH378128","23470693","23471009","KQ058561v1","4991819","4992113","76","18478874"
"JH378128","23541003","23541129","KQ053354v1","702320","702452","26","22838683"
"JH378128","23788333","23788544","KQ058561v1","565602","565807","50","23222731"
"JH378128","23891306","23891443","KQ053982v1","3934263","3934401","30","19957043"
"JH378128","23896642","23896946","KQ053752v1","8072410","8072709","67","15824232"
"JH378128","24021248","24021566","KQ054932v1","2708037","2708346","79","21313211"
"JH378128","24137895","24138154","KQ052970v1","13142491","13142755","67","10995404"
"JH378128","24204997","24205089","KQ058253v1","973922","974008","28","23231075"
"JH378128","24331796","24332072","KQ058350v1","6740286","6740580","76","17591510"
"JH378128","24625575","24625831","KQ058094v1","5430881","5431130","60","19194694"
"JH378128","24629167","24629265","KQ058427v1","6152893","6152991","24","18476274"
"JH378128","24697437","24697722","KQ056855v1","3871130","3871414","72","20826307"
"JH378128","24718467","24718758","KQ056827v1","989698","989981","59","23728769"
"JH378128","24969705","24969956","KQ053365v1","327436","327701","80","24642269"
"JH378128","25041887","25041946","KQ054367v1","3035217","3035279","20","22006670"
"JH378128","25307884","25308156","KQ053004v1","2107939","2108219","79","23199945"
"JH378128","25322526","25322782","KQ058542v1","550732","550973","75","24771794"
"JH378128","25497580","25497878","KQ054401v1","2629005","2629296","66","22868575"
"JH378129","909980","910236","KQ055364v1","1919520","1919774","66","1009540"
"JH378129","1003479","1003613","KQ057910v1","1548802","1548933","26","545323"
"JH378129","1121624","1121703","KQ057737v1","356405","356487","21","765219"
"JH378129","1260460","1260727","KQ053004v1","3225867","3226135","79","1965407"
"JH378129","1415564","1415857","KQ053763v1","3936916","3937207","54","2521352"
"JH378129","1427433","1427739","KQ053816v1","7464708","7465010","65","6037275"
"JH378129","1497869","1498033","KQ058561v1","1782649","1782817","45","284780"
"JH378129","1547289","1547408","KQ058530v1","227142","227264","30","1320147"
"JH378129","1657051","1657100","KQ056404v1","1258356","1258411","19","398695"
"JH378129","1825843","1826148","KQ056320v1","2416951","2417254","62","591108"
"JH378129","1916121","1916249","KQ056404v1","1195188","1195317","28","720933"
"JH378129","2025032","2025141","KQ053785v1","828746","828862","29","1196286"
"JH378129","2092016","2092141","KQ054047v1","1054810","1054936","25","1037206"
"JH378129","2765506","2765680","KQ055014v1","15960","16127","42","2749546"
"JH378129","2846659","2846778","KQ056035v1","296324","296444","21","2550335"
"JH378129","2864674","2864954","KQ053409v1","5686466","5686740","73","2821792"
"JH378129","3693360","3693653","KQ052969v1","11082995","11083279","77","7389635"
"JH378129","3922205","3922320","KQ053299v1","3287766","3287881","32","634439"
"JH378129","4103174","4103484","KQ052968v1","5470311","5470611","79","1367137"
"JH378129","4143119","4143403","KQ058317v1","5506620","5506904","66","1363501"
"JH378129","4396149","4396472","KQ053554v1","2471177","2471484","79","1924972"
"JH378129","4765196","4765490","KQ053409v1","3716306","3716585","82","1048890"
"JH378129","5025626","5025752","KQ053187v1","324884","324999","42","4700742"
"JH378129","5029651","5029809","KQ054964v1","705465","705626","40","4324186"
"JH378129","5118807","5118972","KQ055662v1","1232362","1232527","39","3886445"
"JH378129","5122976","5123211","KQ057702v1","1579642","1579892","75","3543334"
"JH378129","5260681","5260829","KQ058381v1","517901","518051","33","4742780"
"JH378129","5308417","5308695","KQ058527v1","5623096","5623362","80","314679"
"JH378129","5350133","5350309","KQ058094v1","6990178","6990359","40","1640045"
"JH378129","5587444","5587660","KQ053718v1","2663788","2664010","61","2923656"
"JH378129","5745505","5745792","KQ054826v1","9969237","9969502","74","4223732"
"JH378129","5807705","5807952","KQ057909v1","104692","104936","74","5703013"
"JH378129","6053597","6053921","KQ055893v1","2313607","2313921","90","3739990"
"JH378129","6304916","6305120","KQ054826v1","10000696","10000885","63","3695780"
"JH378129","6519568","6519743","KQ058561v1","5347821","5347986","48","1171747"
"JH378129","6639016","6639306","KQ058184v1","1505565","1505858","66","5133451"
"JH378129","6833769","6834058","KQ053146v1","2819587","2819868","61","4014182"
"JH378129","7046634","7046873","KQ053521v1","322834","323094","72","6723800"
"JH378129","7056863","7057130","KQ056475v1","3485423","3485684","70","3571440"
"JH378129","7205204","7205499","KQ056475v1","2179070","2179363","71","5026134"
"JH378129","7297662","7297930","KQ053398v1","4702476","4702738","63","2595186"
"JH378129","7570190","7570499","KQ052981v1","1198440","1198752","65","6371750"
"JH378129","7583439","7583714","KQ053190v1","4987885","4988162","70","2595554"
"JH378129","7805149","7805301","KQ054510v1","3408703","3408848","43","4396446"
"JH378129","7911185","7911348","KQ058571v1","931737","931906","38","6979448"
"JH378129","7989152","7989415","KQ058383v1","5944247","5944518","61","2044905"
"JH378129","8203098","8203211","KQ053191v1","1086674","1086785","39","7116424"
"JH378129","8204087","8204371","KQ055353v1","1973943","1974227","57","6230144"
"JH378129","8254104","8254425","KQ055014v1","3227784","3228090","84","5026320"
"JH378129","8722239","8722531","KQ058184v1","1505565","1505858","63","7216674"
"JH378129","9124503","9124769","KQ058328v1","4345009","4345273","70","4779494"
"JH378129","9237507","9237811","KQ052968v1","5470311","5470611","65","3767196"
"JH378129","9727958","9728097","KQ053741v1","1685544","1685681","33","8042414"
"JH378129","9728621","9728912","KQ054412v1","2490468","2490761","60","7238153"
"JH378129","9765804","9766120","KQ055236v1","2049624","2049930","72","7716180"
"JH378129","9773471","9773758","KQ056331v1","348695","348980","60","9424776"
"JH378129","9939368","9939535","KQ055214v1","273759","273938","52","9665609"
"JH378129","10226628","10226925","KQ058184v1","1505565","1505858","62","8721063"
"JH378129","10353533","10353843","KQ058280v1","497136","497438","76","9856397"
"JH378129","10354400","10354674","KQ058383v1","5944247","5944518","72","4410153"
"JH378129","10397796","10398087","KQ054693v1","832788","833076","67","9565008"
"JH378129","10436544","10436823","KQ053299v1","22323868","22324139","71","11887324"
"JH378129","10490800","10491089","KQ056044v1","2538771","2539068","62","7952029"
"JH378129","10500653","10500869","KQ056404v1","77681","77883","55","10422972"
"JH378129","10629847","10630000","KQ058183v1","4244743","4244893","34","6385104"
"JH378129","10880039","10880336","KQ058184v1","1505565","1505858","60","9374474"
"JH378129","11133414","11133705","KQ053299v1","3622388","3622669","72","7511026"
"JH378129","11161960","11162263","KQ058094v1","1702550","1702850","73","9459410"
"JH378129","11260637","11260917","KQ053093v1","1375309","1375598","80","9885328"
"JH378129","11357494","11357800","KQ053267v1","3278124","3278417","70","8079370"
"JH378129","11512481","11512787","KQ054400v1","208508","208808","87","11303973"
"JH378129","11651658","11651937","KQ053631v1","7288314","7288608","68","4363344"
"JH378129","11699186","11699444","KQ053059v1","2135970","2136233","67","9563216"
"JH378129","11701942","11702069","KQ053135v1","3210852","3210985","24","8491090"
"JH378129","11703746","11703997","KQ058050v1","910717","910957","79","10793029"
"JH378129","12336587","12336894","KQ053299v1","4095914","4096215","71","8240673"
"JH378129","12376577","12376843","KQ055745v1","631144","631414","64","11745433"
"JH378129","12499793","12499931","KQ058281v1","1664150","1664292","31","10835643"
"JH378129","12542252","12542423","KQ058571v1","931737","931906","45","11610515"
"JH378129","12582014","12582255","KQ052971v1","6441372","6441626","75","6140642"
"JH378129","12626678","12626979","KQ052981v1","658787","659079","73","11967891"
"JH378129","12685628","12685934","KQ053948v1","168940","169229","75","12516688"
"JH378129","12777048","12777343","KQ057909v1","3829378","3829677","73","8947670"
"JH378129","12913212","12913426","KQ054069v1","159011","159235","53","12754201"
"JH378129","13006063","13006213","KQ054682v1","606323","606472","36","12399740"
"JH378129","13072804","13073054","KQ054826v1","303348","303596","66","12769456"
"JH378129","13370481","13370768","KQ053827v1","6235617","6235875","91","7134864"
"JH378129","13400794","13401090","KQ053365v1","104844","105138","69","13295950"
"JH378129","13580336","13580611","KQ058533v1","977692","977970","67","12602644"
"JH378129","14199223","14199485","KQ053037v1","3640291","3640559","56","10558932"
"JH378129","14248627","14248872","KQ052971v1","6441372","6441626","65","7807255"
"JH378129","14485261","14485398","KQ058427v1","4756553","4756686","24","9728708"
"JH378129","14570709","14570993","KQ054412v1","2490468","2490761","61","12080241"
"JH378129","14587418","14587524","KQ054921v1","165725","165837","27","14421693"
"JH378129","14736687","14736776","KQ055140v1","2877125","2877206","26","11859562"
"JH378129","14777963","14778097","KQ057883v1","1224468","1224597","23","13553495"
"JH378129","14811486","14811784","KQ053894v1","1005022","1005317","67","13806464"
"JH378129","15645285","15645375","KQ053223v1","2552349","2552442","29","13092936"
"JH378129","15645548","15645695","KQ058538v1","1533488","1533628","34","14112060"
"JH378129","16827761","16828051","KQ054933v1","1739437","1739724","66","15088324"
"JH378129","17189362","17189685","KQ054124v1","496204","496509","96","16693158"
"JH378129","17832059","17832345","KQ053026v1","3680523","3680807","71","14151536"
"JH378129","17864439","17864733","KQ056587v1","9000240","9000528","71","8864199"
"JH378129","18732634","18732936","KQ058616v1","3808264","3808541","89","14924370"
"JH378129","18774759","18775040","KQ058389v1","2329886","2330179","78","16444873"
"JH378129","18788886","18789207","KQ057931v1","399684","399967","95","18389202"
"JH378129","18964041","18964330","KQ057118v1","1405248","1405530","80","17558793"
"JH378129","19043715","19044003","KQ053654v1","820983","821268","67","18222732"
"JH378129","19444251","19444538","KQ053297v1","44026","44315","76","19400225"
"JH378129","19608349","19608500","KQ054180v1","70685","70834","35","19537664"
"JH378129","20111240","20111537","KQ054401v1","2629005","2629296","72","17482235"
"JH378129","21294578","21294733","KQ054533v1","1027813","1027974","35","20266765"
"JH378129","21562029","21562333","KQ053299v1","4095914","4096215","71","17466115"
"JH378129","21623836","21623973","KQ053300v1","2231135","2231263","29","19392701"
"JH378129","21698555","21698701","KQ053190v1","2372433","2372579","34","19326122"
"JH378129","22241761","22241924","KQ053191v1","3634315","3634484","39","18607446"
"JH378129","22347174","22347290","KQ057883v1","26280","26392","28","22320894"
"JH378129","22394844","22395060","KQ055978v1","4693349","4693586","69","17701495"
"JH378129","22425598","22425703","KQ053916v1","191904","192015","26","22233694"
"JH378129","22425843","22426024","KQ056672v1","5452932","5453100","44","16972911"
"JH378129","22492467","22492616","KQ054660v1","3603105","3603267","40","18889362"
"JH378129","22533633","22533940","KQ053816v1","7327018","7327317","67","15206615"
"JH378129","22554343","22554640","KQ056946v1","2554812","2555106","56","19999531"
"JH378129","22730258","22730493","KQ058542v1","550732","550973","63","22179526"
"JH378129","22858176","22858462","KQ055119v1","848363","848641","72","22009813"
"JH378129","22905530","22905758","KQ054510v1","6090992","6091229","74","16814538"
"JH378129","23351858","23352054","KQ053106v1","608807","609006","51","22743051"
"JH378129","23490014","23490250","KQ057656v1","1375539","1375777","69","22114475"
"JH378129","23501407","23501696","KQ053509v1","3252752","3253034","69","20248655"
"JH378129","23765999","23766308","KQ055662v1","1145336","1145647","81","22620663"
"JH378129","24875299","24875580","KQ055247v1","216427","216708","68","24658872"
"JH378130","126945","127087","KQ053157v1","4288391","4288538","35","4161446"
"JH378130","184391","184691","KQ058394v1","9107761","9108054","58","8923370"
"JH378130","223253","223553","KQ054671v1","1795882","1796167","88","1572629"
"JH378130","405172","405398","KQ053827v1","5369199","5369432","55","4964027"
"JH378130","433060","433364","KQ052981v1","1198440","1198752","65","765380"
"JH378130","469150","469288","KQ053850v1","709379","709515","28","240229"
"JH378130","509476","509616","ABDC02047922v1","197","340","39","509279"
"JH378130","598106","598374","KQ055375v1","3672008","3672286","74","3073902"
"JH378130","614537","614835","KQ058272v1","76837","77137","62","537700"
"JH378130","633807","634101","KQ053752v1","135567","135860","61","498240"
"JH378130","644809","645081","KQ053409v1","5686466","5686740","60","5041657"
"JH378130","796712","797022","KQ054682v1","2125705","2126015","69","1328993"
"JH378130","800513","800789","KQ053093v1","1361295","1361576","60","560782"
"JH378130","819062","819357","KQ057118v1","4601602","4601894","61","3782540"
"JH378130","860012","860144","KQ053115v1","1333586","1333718","21","473574"
"JH378130","974436","974570","KQ053354v1","702320","702452","26","272116"
"JH378130","1002924","1003208","KQ058272v1","3244025","3244312","92","2241101"
"JH378130","1188620","1188919","KQ055247v1","895463","895756","70","293157"
"JH378130","1326384","1326682","KQ053299v1","4095914","4096215","73","2769530"
"JH378130","1391906","1392178","KQ056672v1","4169432","4169691","71","2777526"
"JH378130","1480253","1480581","KQ054400v1","4609733","4610042","85","3129480"
"JH378130","1534131","1534262","KQ056361v1","317113","317243","25","1217018"
"JH378130","1566873","1567175","KQ053398v1","2431232","2431537","72","864359"
"JH378130","2067539","2067831","KQ055036v1","1508392","1508683","65","559147"
"JH378130","2119691","2119955","KQ055873v1","328672","328938","63","1791019"
"JH378130","2190211","2190506","KQ055872v1","7320445","7320745","76","5130234"
"JH378130","2248633","2248768","KQ057648v1","2314551","2314685","28","65918"
"JH378130","2400659","2400968","KQ058405v1","1120230","1120530","66","1280429"
"JH378130","2468729","2469019","KQ054412v1","1824448","1824730","69","644281"
"JH378130","2777167","2777461","KQ054510v1","8555095","8555387","67","5777928"
"JH378130","3322584","3322714","KQ056855v1","2808237","2808368","41","514347"
"JH378130","3672793","3672942","KQ054682v1","606323","606472","31","3066470"
"JH378130","4234523","4234811","KQ055725v1","1527395","1527689","64","2707128"
"JH378130","5757703","5757991","KQ053409v1","7074418","7074709","74","1316715"
"JH378130","7099223","7099511","KQ058242v1","722153","722450","65","6377070"
"JH378130","7454838","7455109","KQ055065v1","1117201","1117481","57","6337637"
"JH378130","7611208","7611336","KQ055298v1","1575436","1575566","25","6035772"
"JH378130","7614765","7614983","KQ053026v1","2213601","2213834","73","5401164"
"JH378130","7636472","7636624","KQ058405v1","1538334","1538484","43","6098138"
"JH378130","7831947","7832140","KQ058453v1","204250","204451","70","7627697"
"JH378130","7844324","7844593","KQ056147v1","2698308","2698592","77","5146016"
"JH378130","7928235","7928521","KQ055248v1","947170","947461","64","6981065"
"JH378130","7951876","7952175","KQ054510v1","8555095","8555387","68","603219"
"JH378130","8014494","8014730","KQ053212v1","1714221","1714450","81","6300273"
"JH378130","8017065","8017392","KQ056134v1","3639725","3640034","99","4377340"
"JH378130","8044154","8044446","KQ056672v1","3535300","3535593","60","4508854"
"JH378130","8137737","8138009","KQ057909v1","3830086","3830352","68","4307651"
"JH378130","8151750","8152021","KQ057656v1","192900","193174","78","7958850"
"JH378130","8557036","8557292","KQ054510v1","1641980","1642248","64","6915056"
"JH378130","8654498","8654787","KQ057397v1","393128","393422","74","8261370"
"JH378130","8884238","8884518","KQ055957v1","364218","364491","67","8520020"
"JH378130","8992755","8993069","KQ054565v1","1948059","1948359","86","7044696"
"JH378130","9577765","9578051","KQ053696v1","289251","289545","63","9288514"
"JH378130","9594447","9594744","KQ054693v1","837377","837666","76","8757070"
"JH378130","9654523","9654675","KQ055735v1","2321269","2321424","37","7333254"
"JH378130","9853809","9854096","KQ053539v1","110493","110767","91","9743316"
"JH378130","9932337","9932629","KQ058473v1","369163","369455","78","9563174"
"JH378130","11238119","11238424","KQ052969v1","8915694","8915990","78","2322425"
"JH378130","11285572","11285842","KQ054400v1","3760476","3760752","65","7525096"
"JH378130","11475074","11475378","KQ055352v1","4204310","4204606","73","7270764"
"JH378130","11945173","11945438","KQ053059v1","2135970","2136233","65","9809203"
"JH378130","12358794","12359073","ABDC02000680v1","5435","5718","66","12353359"
"JH378130","12370536","12370827","KQ057290v1","1053741","1054027","70","11316795"
"JH378130","12660587","12660796","KQ058255v1","301545","301759","65","12359042"
"JH378130","12667375","12667654","KQ054389v1","2169070","2169367","78","10498305"
"JH378130","12703765","12703879","KQ053838v1","1840604","1840696","35","10863161"
"JH378130","12725580","12725856","KQ056493v1","2027415","2027683","68","10698165"
"JH378130","13074073","13074239","KQ058571v1","931737","931906","43","12142336"
"JH378130","13501953","13502221","KQ054499v1","2146605","2146883","74","11355348"
"JH378130","13695548","13695614","KQ053332v1","1937831","1937907","21","11757717"
"JH378130","13696173","13696402","KQ053696v1","492750","492962","60","13203423"
"JH378130","14004529","14004668","KQ053409v1","5845480","5845594","41","8159049"
"JH378130","14229728","14230011","KQ054954v1","4226407","4226696","71","10003321"
"JH378130","15342245","15342553","KQ058146v1","160981","161283","79","15181264"
"JH378130","15947890","15948038","KQ054499v1","2153744","2153898","49","13794146"
"JH378130","16004417","16004726","KQ058372v1","1387691","1388000","67","14616726"
"JH378130","16158122","16158425","KQ057693v1","117172","117472","80","16040950"
"JH378130","16195455","16195612","KQ057023v1","552794","552951","39","15642661"
"JH378130","16280360","16280639","KQ052969v1","8828499","8828765","59","7451861"
"JH378130","16824125","16824406","KQ055808v1","1792236","1792518","73","15031889"
"JH378130","17208766","17209089","KQ058450v1","2960681","2960988","99","14248085"
"JH378130","17984597","17984893","KQ053157v1","7174603","7174889","82","10809994"
"JH378130","18515644","18515933","ABDC02054223v1","3152","3442","69","18512492"
"JH378130","18557751","18558072","KQ055479v1","3509341","3509657","69","15048410"
"JH378130","18674377","18674651","KQ058094v1","7832529","7832815","65","10841848"
"JH378130","18757189","18757467","KQ058383v1","2713168","2713439","77","16044021"
"JH378130","19101790","19102059","KQ056147v1","1064032","1064323","76","18037758"
"JH378130","19170058","19170370","KQ053190v1","5623449","5623748","80","13546609"
"JH378130","19201719","19201991","KQ053631v1","9398334","9398603","72","9803385"
"JH378130","19221174","19221462","KQ053082v1","1023453","1023747","67","18197721"
"JH378130","19326223","19326526","KQ058485v1","518830","519142","78","18807393"
"JH378130","19647705","19647902","KQ053354v1","3239417","3239609","52","16408288"
"JH378130","19880570","19880877","KQ054510v1","6887667","6887971","69","12992903"
"JH378130","20088545","20088808","KQ052969v1","8828499","8828765","68","11260046"
"JH378130","20121435","20121729","KQ053631v1","7288314","7288608","57","12833121"
"JH378130","20324943","20325053","KQ054671v1","1335497","1335616","29","18989446"
"JH378130","20325187","20325284","KQ056494v1","3420476","3420570","26","16904711"
"JH378130","20390320","20390604","KQ055173v1","452351","452623","61","19937969"
"JH378130","20433265","20433570","KQ055457v1","2061137","2061448","67","18372128"
"JH378130","20449959","20450274","KQ058315v1","658193","658490","77","19791766"
"JH378130","20792880","20793188","KQ057858v1","376905","377209","69","20415975"
"JH378130","20964135","20964377","KQ053354v1","2057850","2058093","61","18906285"
"JH378130","20988631","20988943","KQ054932v1","3714594","3714900","68","17274037"
"JH378130","21283581","21283715","KQ056568v1","1112336","1112472","27","20171245"
"JH378130","22382068","22382350","KQ053288v1","1350431","1350707","67","21031637"
"JH378130","22667432","22667753","KQ057909v1","14156146","14156474","81","8511286"
"JH378130","23003643","23003959","KQ054401v1","2629005","2629296","87","20374638"
"JH378130","23034887","23034964","KQ055893v1","2912845","2912909","25","20122042"
"JH378130","23143659","23143939","KQ058427v1","4553509","4553777","73","18590150"
"JH378130","23157092","23157387","KQ056234v1","2521120","2521411","72","20635972"
"JH378130","23163781","23163912","KQ057702v1","1862724","1862857","24","21301057"
"JH378130","23457707","23458044","KQ058287v1","982841","983179","87","22474866"
"JH378130","23597981","23598268","KQ058184v1","1505565","1505858","70","22092416"
"JH378130","23803819","23803951","KQ055457v1","5874928","5875062","27","17928891"
"JH378130","23806200","23806337","KQ058094v1","3687022","3687155","31","20119178"
"JH378130","23857729","23857936","KQ058550v1","3053970","3054174","46","20803759"
"JH378130","23861770","23861941","KQ056996v1","1524030","1524195","40","22337740"
"JH378130","23869407","23869536","KQ055957v1","554477","554608","24","23314930"
"JH378130","23944964","23945128","KQ054434v1","711357","711522","38","23233607"
"JH378130","24011342","24011626","KQ053816v1","5837219","5837503","70","18174123"
"JH378130","24349809","24350014","KQ056996v1","148346","148555","52","24201463"
"JH378130","24396258","24396386","KQ053838v1","798752","798885","28","23597506"
"JH378131","68290","68404","KQ053850v1","279389","279490","26","211099"
"JH378131","171731","171844","KQ054068v1","6466552","6466668","26","6294821"
"JH378131","228006","228312","KQ055717v1","675803","676103","74","447797"
"JH378131","442691","442991","KQ054786v1","1481220","1481519","63","1038529"
"JH378131","454556","454834","KQ057737v1","3083543","3083824","67","2628987"
"JH378131","468034","468324","KQ055662v1","456935","457225","68","11099"
"JH378131","685040","685263","KQ054068v1","1263304","1263537","71","578264"
"JH378131","728031","728343","KQ054932v1","9683849","9684160","64","8955818"
"JH378131","774779","774920","KQ054510v1","8179279","8179421","32","7404500"
"JH378131","814901","815180","KQ053465v1","167701","167983","58","647200"
"JH378131","908588","908890","KQ052969v1","8915694","8915990","67","8007106"
"JH378131","955036","955322","KQ056148v1","3012765","3013044","72","2057729"
"JH378131","1314474","1314776","KQ057036v1","502032","502329","64","812442"
"JH378131","1359815","1360102","KQ058004v1","1100771","1101059","53","259044"
"JH378131","1406579","1406899","KQ054069v1","7687863","7688158","86","6281284"
"JH378131","1433648","1433829","KQ054826v1","8498753","8498935","57","7065105"
"JH378131","1435075","1435211","KQ052970v1","9107596","9107736","33","7672521"
"JH378131","1728623","1728740","KQ054179v1","3865170","3865294","22","2136547"
"JH378131","1806533","1806700","KQ053179v1","1735404","1735576","36","71129"
"JH378131","1890882","1891199","KQ058272v1","4942871","4943179","74","3051989"
"JH378131","1903126","1903430","KQ055298v1","1624557","1624840","81","278569"
"JH378131","1922513","1922674","KQ053565v1","1922532","1922687","44","19"
"JH378131","1947764","1948063","KQ052970v1","4748851","4749144","81","2801087"
"JH378131","2017865","2018011","KQ055490v1","2065440","2065590","31","47575"
"JH378131","2067842","2068082","KQ053487v1","3717771","3717999","64","1649929"
"JH378131","2068285","2068371","KQ053565v1","3764807","3764898","23","1696522"
"JH378131","2120851","2121140","KQ052970v1","9813160","9813451","63","7692309"
"JH378131","2377556","2377834","KQ058249v1","184192","184468","65","2193364"
"JH378131","2463005","2463311","KQ053465v1","3609319","3609610","84","1146314"
"JH378131","3619416","3619624","KQ054776v1","463252","463444","59","3156164"
"JH378131","4008150","4008433","KQ054026v1","2067640","2067906","81","1940510"
"JH378131","4372431","4372713","KQ053609v1","2550928","2551200","79","1821503"
"JH378131","4558247","4558506","KQ055629v1","27732","27989","67","4530515"
"JH378131","4582960","4583165","KQ056404v1","77681","77883","50","4505279"
"JH378131","4637929","4638197","KQ057764v1","646545","646819","71","3991384"
"JH378131","4638198","4638280","KQ053520v1","1561632","1561710","19","3076566"
"JH378131","4967557","4967858","KQ053631v1","8031857","8032161","78","3064300"
"JH378131","5062667","5062966","KQ058266v1","898592","898893","64","4164075"
"JH378131","5221799","5221964","KQ053631v1","5537811","5537978","47","316012"
"JH378131","5305318","5305614","KQ052981v1","658787","659079","63","4646531"
"JH378131","5323750","5324070","KQ055141v1","1054026","1054336","76","4269724"
"JH378131","5549882","5550169","KQ054693v1","832788","833076","69","4717094"
"JH378131","5679026","5679276","KQ058291v1","570212","570475","63","5108814"
"JH378131","6214980","6215067","KQ055065v1","2126335","2126429","28","4088645"
"JH378131","6696359","6696692","KQ053115v1","3485337","3485650","84","3211022"
"JH378131","6724866","6725157","KQ053026v1","3886778","3887069","79","2838088"
"JH378131","7478434","7478620","KQ054804v1","1503479","1503667","43","5974955"
"JH378131","7492699","7493005","KQ053332v1","771022","771332","70","6721677"
"JH378131","8256187","8256476","KQ054693v1","832788","833076","61","7423399"
"JH378131","8383827","8384101","KQ058199v1","635962","636242","68","7747865"
"JH378131","9008736","9009005","KQ052971v1","6441372","6441626","65","2567364"
"JH378131","9041448","9041720","KQ056587v1","1312432","1312709","72","7729016"
"JH378131","9145205","9145509","KQ055957v1","671574","671880","78","8473631"
"JH378131","9279771","9279961","KQ055490v1","1751422","1751617","50","7528349"
"JH378131","10088296","10088611","KQ058146v1","160981","161283","79","9927315"
"JH378131","10153549","10153816","KQ056440v1","691104","691369","70","9462445"
"JH378131","10342916","10343227","KQ055119v1","3293975","3294284","66","7048941"
"JH378131","10405397","10405682","KQ058184v1","1505565","1505858","62","8899832"
"JH378131","10515718","10516021","KQ053498v1","2276386","2276679","74","8239332"
"JH378131","10518072","10518376","KQ058184v1","1505565","1505858","63","9012507"
"JH378131","10570541","10570709","KQ055425v1","1445594","1445758","34","9124947"
"JH378131","10865425","10865716","KQ058184v1","1505565","1505858","59","9359860"
"JH378131","10983159","10983462","KQ057909v1","11632258","11632558","67","649099"
"JH378131","11202016","11202295","KQ053631v1","9398334","9398603","61","1803682"
"JH378131","11425611","11425960","KQ058583v1","3101722","3102049","90","8323889"
"JH378131","11565183","11565339","KQ054682v1","606323","606472","34","10958860"
"JH378131","11585844","11586170","KQ058389v1","1089415","1089721","85","10496429"
"JH378131","11644734","11644935","KQ053554v1","293392","293586","50","11351342"
"JH378131","12024449","12024611","KQ053740v1","1071467","1071623","40","10952982"
"JH378131","12149950","12150235","KQ053297v1","44026","44315","71","12105924"
"JH378131","12240147","12240425","KQ054401v1","2629005","2629296","72","9611142"
"JH378131","12558108","12558362","KQ053432v1","3834403","3834656","64","8723705"
"JH378131","12601398","12601609","KQ054776v1","1314982","1315182","68","11286416"
"JH378131","12694033","12694317","KQ053146v1","2819587","2819868","69","9874446"
"JH378131","12836022","12836295","KQ057909v1","5234200","5234480","58","7601822"
"JH378131","12872194","12872284","KQ053223v1","2552349","2552442","19","10319845"
"JH378131","12873190","12873288","KQ055755v1","1629124","1629227","33","11244066"
"JH378131","12880802","12880939","KQ053300v1","3146249","3146389","36","9734553"
"JH378131","12929723","12930019","KQ053299v1","21835674","21835971","63","8905951"
"JH378131","12965492","12965691","KQ053398v1","3158290","3158500","56","9807202"
"JH378131","13126827","13126988","KQ054037v1","1059835","1059995","38","12066992"
"JH378131","13155114","13155338","KQ052971v1","6601670","6601897","66","6553444"
"JH378131","13156627","13156920","KQ054857v1","921177","921473","69","12235450"
"JH378131","13171818","13172084","KQ052968v1","10745715","10745973","65","2426103"
"JH378131","13222040","13222364","KQ054932v1","10830322","10830609","96","2391718"
"JH378131","13339602","13339870","KQ053409v1","2092356","2092619","68","11247246"
"JH378131","13373983","13374274","KQ054069v1","937520","937812","62","12436463"
"JH378131","13412052","13412336","KQ054510v1","8555095","8555387","65","4856957"
"JH378131","13547231","13547465","KQ055735v1","1032075","1032317","69","12515156"
"JH378131","13874742","13875037","KQ053365v1","104844","105138","61","13769898"
"JH378131","13992826","13993125","KQ056493v1","3974454","3974746","69","10018372"
"JH378131","14475977","14476281","KQ056440v1","1002303","1002600","69","13473674"
"JH378131","14839132","14839421","KQ057875v1","404539","404839","79","14434593"
"JH378131","15133884","15134172","KQ053190v1","2950123","2950400","70","12183761"
"JH378131","15144912","15145056","KQ053081v1","7678221","7678366","33","7466691"
"JH378131","15235659","15235968","KQ053146v1","329936","330234","78","14905723"
"JH378131","15881912","15882206","KQ053212v1","1730667","1730952","72","14151245"
"JH378131","16208002","16208115","KQ055142v1","1223635","1223740","34","14984367"
"JH378131","16264300","16264380","KQ058333v1","1207343","1207422","21","15056957"
"JH378131","16326496","16326771","KQ052969v1","7351818","7352090","65","8974678"
"JH378131","16466330","16466473","KQ058281v1","1664150","1664292","34","14802180"
"JH378131","16478401","16478692","KQ052971v1","1111058","1111352","63","15367343"
"JH378131","17468900","17469031","KQ056855v1","810484","810618","20","16658416"
"JH378131","17831881","17832181","KQ058606v1","232956","233258","69","17598925"
"JH378131","17862113","17862412","KQ054191v1","3857584","3857880","80","14004529"
"JH378131","17986282","17986589","KQ053849v1","2680206","2680494","71","15306076"
"JH378131","18073249","18073544","KQ058383v1","6917259","6917555","64","11155990"
"JH378131","18185893","18186201","KQ054069v1","7687863","7688158","63","10498030"
"JH378131","18334918","18335221","KQ054682v1","1577967","1578262","78","16756951"
"JH378131","18454749","18455039","KQ052970v1","6659487","6659775","64","11795262"
"JH378131","18521256","18521531","KQ058379v1","21379","21640","54","18499877"
"JH378131","18711970","18712079","KQ053850v1","279389","279490","28","18432581"
"JH378131","19046422","19046689","KQ058328v1","2975933","2976189","79","16070489"
"JH378131","19084173","19084456","KQ054356v1","1356188","1356481","64","17727985"
"JH378131","19418632","19418940","KQ053299v1","4095914","4096215","75","15322718"
"JH378131","19500702","19500986","KQ053631v1","9963313","9963601","68","9537389"
"JH378131","19620462","19620739","KQ058625v1","340677","340961","56","19279785"
"JH378131","19656999","19657172","KQ058316v1","3666295","3666468","44","15990704"
"JH378131","19891836","19892121","KQ054356v1","1931225","1931518","72","17960611"
"JH378131","19947303","19947449","KQ053300v1","3146249","3146389","34","16801054"
"JH378131","20036340","20036509","KQ056996v1","1524030","1524195","39","18512310"
"JH378131","20087514","20087801","KQ057390v1","1266388","1266686","67","18821126"
"JH378131","20128830","20129107","KQ052970v1","18096565","18096847","71","2032265"
"JH378131","20360313","20360581","KQ056404v1","1771928","1772196","73","18588385"
"JH378131","20378044","20378353","KQ054932v1","4081077","4081374","73","16296967"
"JH378131","20480469","20480775","KQ055717v1","1235392","1235704","74","19245077"
"JH378131","21638239","21638351","KQ054921v1","165725","165837","31","21472514"
"JH378131","21773462","21773545","KQ054179v1","1673076","1673160","29","20100386"
"JH378131","21879318","21879624","KQ055014v1","3089851","3090151","81","18789467"
"JH378131","22066981","22067245","KQ058317v1","5506620","5506904","66","16560361"
"JH378131","22329497","22329798","KQ054533v1","1836056","1836358","71","20493441"
"JH378131","22444449","22444769","KQ052990v1","293181","293473","88","22151268"
"JH378131","22541654","22541796","KQ054191v1","2450802","2450939","31","20090852"
"JH378131","22657561","22657833","KQ058561v1","583947","584226","69","22073614"
"JH378131","22710060","22710367","KQ053297v1","44026","44315","61","22666034"
"JH378131","22834818","22835104","KQ058403v1","502472","502765","57","22332346"
"JH378131","23059371","23059674","KQ058184v1","1505565","1505858","71","21553806"
"JH378131","23104333","23104661","KQ054289v1","1432888","1433224","78","21671445"
"JH378131","23183715","23184020","KQ053115v1","3485337","3485650","82","19698378"
"JH378131","23237552","23237829","KQ058275v1","938649","938919","59","22298903"
"JH378131","23292845","23293062","KQ055119v1","976180","976409","68","22316665"
"JH378131","23812283","23812497","KQ054401v1","3245220","3245428","58","20567063"
"JH378131","23840992","23841293","KQ056613v1","654151","654445","86","23186841"
"JH378131","23865159","23865457","KQ055248v1","947170","947461","69","22917989"
"JH378131","23896876","23897202","KQ056432v1","3338517","3338841","71","20558359"
"JH378131","23977566","23977834","KQ058291v1","284522","284798","78","23693044"
"JH378131","24040482","24040769","KQ053410v1","515520","515804","66","23524962"
"JH378131","24055509","24055767","KQ053398v1","4702476","4702738","68","19353033"
"JH378132","23068536","23068838","KQ058293v1","1010866","1011153","72","22057670"
"JH378132","21062","21347","KQ053763v1","3936916","3937207","61","3915854"
"JH378132","333186","333466","KQ056587v1","1312432","1312709","59","979246"
"JH378132","649900","650033","KQ057204v1","3219950","3220097","36","2570050"
"JH378132","706783","707088","KQ053894v1","688559","688830","87","18224"
"JH378132","766278","766500","KQ056762v1","1558119","1558341","54","791841"
"JH378132","770106","770262","KQ058316v1","1612479","1612626","37","842373"
"JH378132","770387","770485","KQ058094v1","5889178","5889279","23","5118791"
"JH378132","1395336","1395467","KQ058561v1","557545","557678","27","837791"
"JH378132","1506618","1506907","KQ058372v1","1134128","1134432","70","372490"
"JH378132","1706812","1707099","KQ058184v1","1505565","1505858","64","201247"
"JH378132","1830832","1830934","KQ053070v1","1407707","1407821","35","423125"
"JH378132","2157190","2157350","KQ053827v1","4961567","4961731","47","2804377"
"JH378132","2262739","2263027","KQ057693v1","117172","117472","66","2145567"
"JH378132","2398821","2399028","KQ054401v1","3245220","3245428","52","846399"
"JH378132","2410125","2410306","KQ055119v1","2614682","2614878","56","204557"
"JH378132","2586379","2586562","KQ058459v1","469480","469653","43","2116899"
"JH378132","2637354","2637487","KQ056855v1","3576546","3576678","30","939192"
"JH378132","3171187","3171479","KQ058372v1","1866883","1867182","65","1304304"
"JH378132","3359842","3360084","KQ056707v1","1656923","1657169","69","1702919"
"JH378132","3480638","3480950","KQ056440v1","1022590","1022891","73","2458048"
"JH378132","3795658","3795951","KQ053465v1","3818784","3819069","76","23126"
"JH378132","4363563","4363614","KQ054135v1","1661841","1661887","16","2701722"
"JH378132","4363635","4363703","KQ057909v1","3940935","3941001","18","422700"
"JH378132","4364104","4364194","KQ053223v1","2552349","2552442","30","1811755"
"JH378132","4494001","4494277","KQ053190v1","4987885","4988162","62","493884"
"JH378132","4909281","4909436","KQ053740v1","1071467","1071623","41","3837814"
"JH378132","5012289","5012533","KQ054826v1","11923518","11923772","79","6911229"
"JH378132","5227205","5227490","KQ055755v1","1493732","1494013","73","3733473"
"JH378132","5227756","5228055","KQ057290v1","1053741","1054027","84","4174015"
"JH378132","5490380","5490671","KQ053476v1","1910351","1910649","77","3580029"
"JH378132","6027221","6027521","KQ058267v1","526536","526834","67","5500685"
"JH378132","6829236","6829357","KQ054179v1","3865170","3865294","30","2964066"
"JH378132","6939313","6939597","KQ058328v1","6293951","6294242","76","645362"
"JH378132","7410462","7410688","KQ053170v1","267257","267471","67","7143205"
"JH378132","7840443","7840723","KQ058249v1","184192","184468","67","7656251"
"JH378132","8413070","8413359","KQ058616v1","3808264","3808541","72","4604806"
"JH378132","8728367","8728648","KQ052968v1","10629964","10630247","72","1901597"
"JH378132","8944501","8944819","KQ053299v1","4095914","4096215","77","4848587"
"JH378132","9020518","9020793","KQ053476v1","1203162","1203439","70","7817356"
"JH378132","9040097","9040372","KQ058328v1","6293951","6294242","79","2746146"
"JH378132","9133510","9133796","KQ053948v1","168940","169229","76","8964570"
"JH378132","9205664","9205736","KQ054795v1","2450088","2450154","18","6755576"
"JH378132","9254735","9254914","KQ054826v1","8498753","8498935","66","755982"
"JH378132","9254917","9255136","KQ058487v1","1040716","1040932","47","8214201"
"JH378132","9792069","9792332","KQ058272v1","2221154","2221416","68","7570915"
"JH378132","9833304","9833619","KQ058184v1","1505565","1505858","80","8327739"
"JH378132","9909397","9909699","KQ053631v1","7288314","7288608","62","2621083"
"JH378132","10279447","10279539","KQ053168v1","1574388","1574479","21","8705059"
"JH378132","10294785","10295066","KQ055978v1","3560415","3560681","64","6734370"
"JH378132","10402161","10402429","KQ053288v1","2129299","2129561","64","8272862"
"JH378132","10440331","10440449","KQ054932v1","7772773","7772892","26","2667558"
"JH378132","10440878","10441040","KQ058461v1","2955991","2956154","33","7484887"
"JH378132","10450947","10451152","KQ054400v1","319216","319421","60","10131731"
"JH378132","10574357","10574644","KQ054533v1","1794603","1794882","79","8779754"
"JH378132","11084751","11084855","KQ058561v1","2182315","2182419","26","8902436"
"JH378132","11391986","11392264","KQ053179v1","1222343","1222623","55","10169643"
"JH378132","11747163","11747473","KQ053409v1","4968617","4968916","79","6778546"
"JH378132","11775961","11776269","KQ058184v1","1505565","1505858","67","10270396"
"JH378132","11939289","11939582","KQ058272v1","5750882","5751176","74","6188407"
"JH378132","12148082","12148372","KQ054401v1","409648","409945","67","11738434"
"JH378132","12166524","12166735","KQ058462v1","452919","453117","61","11713605"
"JH378132","12232227","12232539","KQ054868v1","1584588","1584882","86","10647639"
"JH378132","12436326","12436600","KQ053696v1","289251","289545","71","12147075"
"JH378132","12447649","12447892","KQ053082v1","7191209","7191457","61","5256440"
"JH378132","12449443","12449610","KQ057737v1","1426090","1426247","38","11023353"
"JH378132","12810541","12810747","KQ053190v1","4129892","4130119","65","8680649"
"JH378132","12845855","12845940","KQ053838v1","1840604","1840696","19","11005251"
"JH378132","12846918","12846991","KQ053849v1","1707655","1707721","23","11139263"
"JH378132","12851473","12851734","KQ054868v1","1834842","1835084","75","11016631"
"JH378132","12856656","12856935","KQ058328v1","3799836","3800112","68","9056820"
"JH378132","13039095","13039399","KQ055662v1","2228766","2229056","75","10810329"
"JH378132","13069522","13069662","KQ054378v1","157932","158074","31","12911590"
"JH378132","13342850","13343145","KQ053044v1","405596","405892","69","12937254"
"JH378132","13404543","13404745","KQ052970v1","11415688","11415897","54","1988855"
"JH378132","13610647","13610967","KQ054510v1","7367073","7367385","88","6243574"
"JH378132","13727064","13727340","KQ058594v1","2023684","2023963","68","11703380"
"JH378132","13783064","13783346","KQ052968v1","14043756","14044036","79","260692"
"JH378132","13784669","13784945","KQ054124v1","4347479","4347753","66","9437190"
"JH378132","13859192","13859273","KQ054400v1","280157","280246","24","13579035"
"JH378132","14326652","14326863","KQ053191v1","3682228","3682423","58","10644424"
"JH378132","14416726","14416915","KQ054933v1","3939617","3939804","49","10477109"
"JH378132","14531646","14531950","KQ054510v1","6887667","6887971","57","7643979"
"JH378132","14568322","14568630","KQ057151v1","625459","625760","76","13942863"
"JH378132","15001015","15001308","KQ056475v1","2179070","2179363","67","12821945"
"JH378132","15162185","15162444","KQ057560v1","1236972","1237228","62","13925213"
"JH378132","15354451","15354640","KQ055892v1","1173","1363","50","15353278"
"JH378132","15371060","15371371","KQ057108v1","2064599","2064896","66","13306461"
"JH378132","15386302","15386600","KQ058272v1","76837","77137","78","15309465"
"JH378132","15513285","15513582","KQ053554v1","1157184","1157483","75","14356101"
"JH378132","15571421","15571710","KQ053520v1","2913074","2913361","66","12658347"
"JH378132","16325622","16325919","KQ053476v1","3712115","3712409","67","12613507"
"JH378132","16388850","16389162","KQ053740v1","2898644","2898953","74","13490206"
"JH378132","16445124","16445256","KQ055957v1","554477","554608","23","15890647"
"JH378132","16581883","16582153","KQ056873v1","1328825","1329068","85","15253058"
"JH378132","16593867","16594094","KQ056465v1","72608","72828","63","16521259"
"JH378132","16691082","16691160","KQ053520v1","1561632","1561710","17","15129450"
"JH378132","18329793","18330074","KQ055352v1","13451535","13451828","85","4878258"
"JH378132","18453099","18453209","KQ058403v1","2083243","2083351","24","16369856"
"JH378132","18574495","18574796","KQ053783v1","73311","73618","72","18501184"
"JH378132","18730824","18731017","KQ057118v1","644670","644854","55","18086154"
"JH378132","19041713","19041970","KQ055247v1","5804007","5804261","72","13237706"
"JH378132","19263776","19264051","KQ058004v1","4701579","4701856","78","14562197"
"JH378132","19326727","19327019","KQ053465v1","93558","93850","74","19233169"
"JH378132","19874808","19875076","KQ056493v1","3873865","3874113","77","16000943"
"JH378132","20139135","20139411","KQ053409v1","3716306","3716585","71","16422829"
"JH378132","20502335","20502643","KQ053409v1","5849852","5850162","102","14652483"
"JH378132","20648867","20649150","KQ052968v1","14043756","14044036","88","6605111"
"JH378132","21171439","21171744","KQ052970v1","13817736","13818032","82","7353703"
"JH378132","21915023","21915336","KQ057449v1","1455036","1455335","89","20459987"
"JH378132","21996514","21996815","KQ055236v1","2049624","2049930","58","19946890"
"JH378132","22190095","22190377","KQ053631v1","8322466","8322756","74","13867629"
"JH378132","22280947","22281221","KQ053332v1","447571","447853","61","21833376"
"JH378132","22472247","22472395","KQ054180v1","70685","70834","41","22401562"
"JH378132","22472777","22472898","KQ058417v1","488117","488237","28","21984660"
"JH378132","22496445","22496593","KQ054196v1","237","387","46","22496208"
"JH378132","22605425","22605695","KQ054069v1","928440","928688","81","21676985"
"JH378132","22700633","22700747","KQ058383v1","7921452","7921570","27","14779181"
"JH378132","22784499","22784792","KQ058184v1","1505565","1505858","54","21278934"
"JH378132","23046186","23046398","KQ054401v1","3245220","3245428","50","19800966"
"JH378132","23090368","23090663","KQ054693v1","832788","833076","66","22257580"
"JH378132","23099594","23099871","KQ058275v1","938649","938919","61","22160945"
"JH378132","23103123","23103334","KQ053267v1","1129016","1129207","72","21974107"
"JH378132","23288537","23288829","KQ053081v1","2760355","2760643","79","20528182"
"JH378132","23320516","23320821","KQ058272v1","6295757","6296050","69","17024759"
"JH378132","23325565","23325861","KQ058184v1","1505565","1505858","69","21820000"
"JH378133","5504990","5505233","KQ054704v1","483937","484161","73","5021053"
"JH378133","411301","411571","KQ058494v1","3105105","3105369","65","2693804"
"JH378133","619800","620019","KQ058561v1","565602","565807","54","54198"
"JH378133","1135093","1135372","KQ053520v1","2992926","2993205","66","1857833"
"JH378133","1470916","1471233","KQ056672v1","3082150","3082439","86","1611234"
"JH378133","2018488","2018785","KQ057909v1","14641987","14642269","78","12623499"
"JH378133","2782371","2782593","KQ056405v1","6821","7014","77","2775550"
"JH378133","2782612","2782708","KQ054069v1","6576888","6576971","26","3794276"
"JH378133","2851137","2851429","KQ053190v1","1299491","1299778","77","1551646"
"JH378133","3328673","3328963","KQ058538v1","934688","934988","75","2393985"
"JH378133","4195814","4195962","KQ054510v1","8179279","8179421","34","3983465"
"JH378133","4285483","4285769","KQ056762v1","532889","533183","66","3752594"
"JH378133","4344118","4344421","KQ053267v1","3278124","3278417","64","1065994"
"JH378133","4638650","4638941","KQ058572v1","3070725","3071013","65","1567925"
"JH378133","4964371","4964462","KQ053971v1","4775120","4775210","19","189251"
"JH378133","4992798","4992937","KQ055065v1","3115232","3115371","42","1877566"
"JH378133","5009188","5009333","KQ055352v1","6062328","6062459","40","1053140"
"JH378133","5344674","5344975","KQ055457v1","2061137","2061448","69","3283537"
"JH378133","5361880","5362156","KQ053740v1","2323389","2323680","79","3038491"
"JH378133","5398387","5398592","KQ053223v1","773388","773584","54","4624999"
"JH378133","5403189","5403311","KQ055629v1","3423907","3424031","38","1979282"
"JH378133","5593644","5593932","KQ054290v1","1454980","1455264","59","4138664"
"JH378133","6048298","6048578","KQ053948v1","2078671","2078957","76","3969627"
"JH378133","6338041","6338148","KQ053894v1","1409409","1409506","27","4928632"
"JH378133","6657204","6657517","KQ054047v1","432706","433011","67","6224498"
"JH378133","7110042","7110208","KQ057931v1","360872","361037","30","6749170"
"JH378133","7416232","7416530","KQ056587v1","1312432","1312709","71","6103800"
"JH378133","7424554","7424834","KQ055065v1","999059","999338","65","6425495"
"JH378133","7518448","7518732","KQ052968v1","14043756","14044036","73","6525308"
"JH378133","7544098","7544246","KQ053299v1","5209668","5209811","40","2334430"
"JH378133","7603336","7603481","KQ054412v1","2185013","2185160","32","5418323"
"JH378133","7731494","7731580","KQ054323v1","1956964","1957052","23","5774530"
"JH378133","7755925","7756209","KQ054124v1","3300649","3300941","74","4455276"
"JH378133","7829408","7829661","KQ057223v1","124007","124258","68","7705401"
"JH378133","8020082","8020374","KQ053816v1","7327018","7327317","69","693064"
"JH378133","8113733","8114020","KQ056147v1","1064032","1064323","70","7049701"
"JH378133","8155974","8156126","KQ055735v1","2321269","2321424","36","5834705"
"JH378133","8196995","8197260","KQ053278v1","2947726","2947979","61","5249269"
"JH378133","8241770","8242069","KQ055044v1","207214","207505","72","8034556"
"JH378133","8497988","8498283","KQ058184v1","1505565","1505858","63","6992423"
"JH378133","8539941","8540261","KQ056946v1","2554812","2555106","82","5985129"
"JH378133","8635857","8636146","KQ054356v1","1356188","1356481","69","7279669"
"JH378133","8674489","8674533","KQ055883v1","741152","741209","21","7933337"
"JH378133","8674570","8674685","KQ052969v1","2661859","2661968","31","6012711"
"JH378133","9010697","9010981","KQ054510v1","1641980","1642248","71","7368717"
"JH378133","9015604","9015906","KQ053299v1","4095914","4096215","73","4919690"
"JH378133","9069928","9070060","KQ055957v1","554477","554608","19","8515451"
"JH378133","9130401","9130700","KQ053300v1","2874445","2874736","58","6255956"
"JH378133","9309951","9310238","KQ053096v1","602899","603182","63","8707052"
"JH378133","9447834","9448039","KQ053299v1","6846672","6846867","48","2601162"
"JH378133","9794461","9794778","KQ053785v1","807454","807767","69","8987007"
"JH378133","9851272","9851531","KQ057291v1","667476","667747","71","9183796"
"JH378133","9979324","9979656","KQ053115v1","3485337","3485650","78","6493987"
"JH378133","10279315","10279418","KQ055935v1","449406","449504","29","9829909"
"JH378133","10377023","10377325","KQ052970v1","843026","843331","77","9533997"
"JH378133","10777484","10777700","KQ053872v1","262334","262548","48","10515150"
"JH378133","11350361","11350647","KQ056234v1","2521120","2521411","64","8829241"
"JH378133","11839090","11839316","KQ054576v1","2775916","2776136","58","9063174"
"JH378133","12316926","12317229","KQ058184v1","1505565","1505858","62","10811361"
"JH378133","13629561","13629845","KQ056494v1","2222182","2222467","73","11407379"
"JH378133","14050744","14051028","KQ053157v1","4118505","4118788","71","9932239"
"JH378133","14652113","14652404","KQ056790v1","446564","446855","70","14205549"
"JH378133","15998629","15998927","KQ054412v1","2490468","2490761","66","13508161"
"JH378133","16037326","16037628","KQ053297v1","44026","44315","76","15993300"
"JH378133","16413220","16413528","KQ055414v1","222827","223136","72","16190393"
"JH378133","16534454","16534751","KQ056225v1","48046","48349","78","16486408"
"JH378133","19188145","19188275","KQ055957v1","554477","554608","19","18633668"
"JH378133","19642834","19643156","KQ058450v1","2960681","2960988","73","16682153"
"JH378133","19652724","19652987","KQ055394v1","2461651","2461910","65","17191073"
"JH378133","19679618","19679897","KQ055119v1","848363","848641","65","18831255"
"JH378133","19709514","19709721","KQ057290v1","4745481","4745684","59","14964033"
"JH378133","19832974","19833271","KQ054356v1","1600089","1600380","61","18232885"
"JH378133","19974523","19974651","KQ057883v1","1224468","1224597","25","18750055"
"JH378133","20062879","20063177","KQ053816v1","7464708","7465010","76","12598171"
"JH378133","20120893","20121202","KQ053816v1","7327018","7327317","68","12793875"
"JH378133","20996150","20996222","KQ056540v1","178443","178502","25","20817707"
"JH378133","22092767","22093027","KQ057290v1","862441","862706","64","21230326"
"JH378133","22144079","22144275","KQ052968v1","1711014","1711208","45","20433065"
"JH378133","22418997","22419249","KQ058333v1","1173899","1174141","70","21245098"
"JH378133","22786329","22786483","KQ054533v1","748660","748796","49","22037669"
"JH378133","22954643","22954942","KQ052984v1","105454","105757","60","22849189"
"JH378133","22958777","22959047","KQ058328v1","1854656","1854928","62","21104121"
"JH378133","22964277","22964560","KQ056494v1","1571325","1571622","68","21392952"
"JH378133","23060764","23061039","KQ053093v1","1361295","1361576","67","21699469"
"JH378134","118041","118339","KQ054068v1","1099741","1100039","59","981700"
"JH378134","389796","389979","KQ054510v1","1448917","1449101","56","1059121"
"JH378134","484408","484707","KQ054400v1","354368","354668","73","130040"
"JH378134","925852","926152","KQ056440v1","1022590","1022891","77","96738"
"JH378134","1198330","1198470","KQ056147v1","2168964","2169108","32","970634"
"JH378134","1737222","1737514","KQ056762v1","532889","533183","80","1204333"
"JH378134","2427695","2427941","KQ058501v1","262278","262510","80","2165417"
"JH378134","2629589","2629849","KQ053157v1","6574489","6574759","74","3944900"
"JH378134","2703451","2703757","KQ058348v1","1633794","1634092","75","1069657"
"JH378134","2937400","2937491","KQ053838v1","1840604","1840696","27","1096796"
"JH378134","3178425","3178558","KQ053543v1","1868215","1868343","29","1310210"
"JH378134","3419422","3419764","KQ056432v1","3338517","3338841","102","80905"
"JH378134","3647576","3647872","KQ053959v1","2400017","2400302","82","1247559"
"JH378134","4047932","4048205","KQ056911v1","509549","509809","77","3538383"
"JH378134","4067186","4067465","KQ053838v1","3013088","3013374","78","1054098"
"JH378134","4237355","4237643","KQ053093v1","3162517","3162806","74","1074838"
"JH378134","4958046","4958191","KQ058561v1","5864457","5864607","48","906411"
"JH378134","5344789","5344867","KQ053398v1","4200835","4200909","24","1143954"
"JH378134","5666999","5667311","KQ054826v1","5356474","5356782","92","310525"
"JH378134","6269718","6269886","KQ057213v1","476570","476722","45","5793148"
"JH378134","6440913","6441111","KQ058616v1","3055609","3055812","53","3385304"
"JH378134","6965273","6965584","KQ053299v1","4095914","4096215","65","2869359"
"JH378134","7389817","7390082","KQ055872v1","2360857","2361124","68","5028960"
"JH378134","7402131","7402340","KQ053609v1","2642121","2642332","56","4760010"
"JH378134","7713303","7713436","KQ052970v1","4661614","4661744","27","3051689"
"JH378134","7816376","7816642","KQ058583v1","1187997","1188260","76","6628379"
"JH378134","7866890","7867141","KQ054693v1","745323","745572","66","7121567"
"JH378134","8778151","8778454","KQ053927v1","199693","199992","81","8578458"
"JH378134","8820259","8820408","KQ054168v1","1100368","1100517","37","7719891"
"JH378134","9119832","9119909","KQ052968v1","9483686","9483763","26","363854"
"JH378134","9176009","9176301","KQ058183v1","487423","487710","63","8688586"
"JH378134","9385931","9386234","KQ053960v1","70067","70362","76","9315864"
"JH378134","9387911","9388218","KQ057213v1","521153","521454","73","8866758"
"JH378134","9414444","9414756","KQ058184v1","1505565","1505858","74","7908879"
"JH378134","9462671","9462819","KQ057561v1","285997","286147","35","9176674"
"JH378134","9609184","9609497","KQ055457v1","2061137","2061448","66","7548047"
"JH378134","10268666","10268953","KQ054804v1","964015","964313","67","9304651"
"JH378134","10384942","10385175","KQ054724v1","2773806","2774015","78","7611136"
"JH378134","10395008","10395278","KQ052969v1","7351818","7352090","73","3043190"
"JH378134","10730480","10730701","KQ055872v1","6738410","6738636","69","3992070"
"JH378134","10961610","10961854","ABDC02049463v1","260","485","73","10961350"
"JH378134","11174317","11174597","KQ055119v1","848363","848641","73","10325954"
"JH378134","11255691","11256001","KQ057909v1","14156146","14156474","91","2900455"
"JH378134","11566749","11567031","KQ053752v1","35796","36072","90","11530953"
"JH378134","11658962","11659235","KQ056643v1","28985","29245","76","11629977"
"JH378134","11976999","11977289","KQ056345v1","621994","622295","71","11355005"
"JH378134","12020124","12020431","KQ054510v1","2056259","2056562","79","9963865"
"JH378134","12853341","12853602","KQ058291v1","284522","284798","74","12568819"
"JH378134","13502134","13502327","KQ053332v1","848203","848389","59","12653931"
"JH378134","13591905","13592027","KQ058383v1","7248131","7248254","33","6343774"
"JH378134","13592821","13593010","KQ053565v1","3407633","3407810","52","10185188"
"JH378134","13610311","13610604","KQ055036v1","1508392","1508683","70","12101919"
"JH378134","13691329","13691466","KQ053191v1","655494","655627","25","13035835"
"JH378134","13721637","13721768","KQ053861v1","8359","8490","30","13713278"
"JH378134","13828282","13828414","KQ054179v1","3927334","3927468","24","9900948"
"JH378134","13906687","13906820","KQ053202v1","780148","780280","25","13126539"
"JH378134","14267786","14268017","KQ057345v1","642320","642545","64","13625466"
"JH378134","14332926","14333057","KQ053354v1","702320","702452","27","13630606"
"JH378134","14624861","14625016","KQ055214v1","2928936","2929084","35","11695925"
"JH378134","14667815","14667925","KQ058350v1","1062787","1062904","25","13605028"
"JH378134","14668145","14668245","KQ054533v1","1811819","1811926","34","12856326"
"JH378134","14669388","14669502","KQ058050v1","918290","918400","27","13751098"
"JH378134","14754857","14755130","KQ058004v1","3112196","3112474","87","11642661"
"JH378134","15210538","15210677","KQ057036v1","1067545","1067684","25","14142993"
"JH378134","15347771","15348076","KQ055247v1","715191","715485","75","14632580"
"JH378134","15446649","15446859","KQ054069v1","7412441","7412647","53","8034208"
"JH378134","15484677","15484906","KQ058542v1","550732","550973","69","14933945"
"JH378134","15498499","15498775","KQ058184v1","1505565","1505858","76","13992934"
"JH378134","15608197","15608354","KQ055425v1","1445594","1445758","38","14162603"
"JH378134","15679369","15679491","KQ058542v1","469843","469958","30","15209526"
"JH378134","15681291","15681375","KQ054400v1","280157","280246","23","15401134"
"JH378134","15771258","15771389","KQ053354v1","702320","702452","23","15068938"
"JH378134","15785867","15786009","KQ053115v1","1650505","1650644","30","14135362"
"JH378134","16068234","16068498","KQ054289v1","4355551","4355817","76","11712683"
"JH378134","16232314","16232577","KQ053454v1","649600","649875","74","15582714"
"JH378134","16275586","16275867","KQ058184v1","1505565","1505858","58","14770021"
"JH378134","16663110","16663244","KQ053565v1","1793162","1793293","30","14869948"
"JH378134","16819880","16820190","KQ058293v1","315725","316030","65","16504155"
"JH378134","16822472","16822687","KQ053872v1","262334","262548","55","16560138"
"JH378134","16829511","16829813","KQ054628v1","802926","803228","63","16026585"
"JH378134","16988804","16989034","KQ053654v1","3892663","3892904","60","13096141"
"JH378134","17018104","17018190","KQ057875v1","396722","396804","25","16621382"
"JH378134","17018828","17019101","KQ058004v1","3112196","3112474","80","13906632"
"JH378134","17021511","17021660","KQ054412v1","2196456","2196568","61","14825055"
"JH378134","17039435","17039724","KQ058483v1","1747852","1748144","63","15291583"
"JH378134","17063325","17063602","KQ053565v1","1909206","1909471","74","15154119"
"JH378134","17159493","17159640","KQ054412v1","2185013","2185160","39","14974480"
"JH378134","17491969","17492105","KQ058004v1","2254984","2255111","29","15236985"
"JH378134","17850363","17850545","KQ053643v1","232376","232561","44","17617987"
"JH378134","17892338","17892586","KQ058627v1","3341899","3342143","58","14550439"
"JH378134","17925580","17925870","KQ052968v1","10629964","10630247","64","7295616"
"JH378134","18007068","18007228","KQ053223v1","2815634","2815800","35","15191434"
"JH378134","18016409","18016701","KQ053631v1","9631170","9631468","57","8385239"
"JH378134","18074449","18074715","KQ058594v1","6111844","6112110","68","11962605"
"JH378134","18302943","18303239","KQ052969v1","9553757","9554052","67","8749186"
"JH378134","18408275","18408403","KQ052970v1","4926745","4926872","27","13481530"
"JH378134","18764649","18764924","KQ053409v1","5686466","5686740","60","13078183"
"JH378134","18786499","18786805","KQ053409v1","4278416","4278719","79","14508083"
"JH378134","19226211","19226515","KQ053115v1","1118362","1118655","83","18107849"
"JH378134","19431045","19431341","KQ058472v1","1327185","1327479","73","18103860"
"JH378134","19718976","19719208","KQ053498v1","3178905","3179128","65","16540071"
"JH378134","20475584","20475871","KQ053146v1","2819587","2819868","66","17655997"
"JH378134","20745298","20745610","KQ053190v1","4987885","4988162","98","15757413"
"JH378134","20915549","20915856","KQ058184v1","1505565","1505858","78","19409984"
"JH378134","21269262","21269552","KQ055097v1","1884579","1884874","80","19384683"
"JH378134","21271865","21272149","KQ054069v1","3733362","3733643","75","17538503"
"JH378134","21305293","21305578","KQ058561v1","4466656","4466945","75","16838637"
"JH378134","22242505","22242637","KQ056643v1","1491838","1491968","22","20750667"
"JH378134","22330499","22330810","KQ058585v1","580456","580763","68","21750043"
"JH378135","8949","9104","KQ053026v1","1584528","1584674","53","1575579"
"JH378135","109980","110263","KQ054510v1","6844504","6844778","82","6734524"
"JH378135","206546","206803","KQ053872v1","1313216","1313477","89","1106670"
"JH378135","278193","278311","KQ053632v1","7771","7867","38","270422"
"JH378135","525293","525430","KQ053004v1","3305017","3305151","32","2779724"
"JH378135","565826","565962","KQ057821v1","5630751","5630884","36","5064925"
"JH378135","856087","856276","KQ053190v1","4183682","4183869","54","3327595"
"JH378135","918847","919117","KQ053421v1","3062266","3062539","69","2143419"
"JH378135","949085","949339","KQ055629v1","27732","27989","59","921353"
"JH378135","1005415","1005669","KQ055414v1","149964","150226","66","855451"
"JH378135","1028100","1028401","KQ058585v1","580456","580763","80","447644"
"JH378135","1090780","1091053","KQ055152v1","2989651","2989915","65","1898871"
"JH378135","1126398","1126644","KQ053082v1","7191209","7191457","89","6064811"
"JH378135","1139387","1139672","KQ053026v1","3680523","3680807","69","2541136"
"JH378135","1181699","1181927","KQ058004v1","2720169","2720394","63","1538470"
"JH378135","1205353","1205502","KQ058450v1","492647","492790","39","712706"
"JH378135","1221705","1221940","KQ054724v1","2773806","2774015","70","1552101"
"JH378135","1241964","1242117","KQ052970v1","10856401","10856550","36","9614437"
"JH378135","1244367","1244632","KQ057910v1","1519898","1520150","70","275531"
"JH378135","1322593","1322882","KQ053498v1","3696034","3696323","72","2373441"
"JH378135","1367950","1368178","KQ054804v1","1007773","1008011","75","360177"
"JH378135","1406967","1407246","KQ053752v1","577130","577407","59","829837"
"JH378135","1445324","1445620","KQ054401v1","2629005","2629296","71","1183681"
"JH378135","1463269","1463414","KQ055097v1","2621016","2621150","34","1157747"
"JH378135","1614192","1614327","KQ055298v1","1575436","1575566","31","38756"
"JH378135","1636723","1636861","KQ058372v1","1534337","1534480","40","102386"
"JH378135","1645572","1645704","KQ053654v1","4929533","4929667","29","3283961"
"JH378135","1667007","1667327","KQ054400v1","4609733","4610042","91","2942726"
"JH378135","1724415","1724521","KQ054510v1","2127300","2127398","24","402885"
"JH378135","1742380","1742655","KQ058173v1","992259","992524","79","750121"
"JH378135","1751570","1751724","KQ056147v1","2168964","2169108","33","417394"
"JH378135","1774396","1774679","KQ055490v1","2797344","2797631","69","1022948"
"JH378135","1791272","1791406","KQ057397v1","624142","624276","30","1167130"
"JH378135","1858063","1858269","KQ053554v1","1019005","1019210","63","839058"
"JH378135","1861538","1861845","KQ052970v1","10427454","10427754","71","8565916"
"JH378135","2105276","2105585","KQ054401v1","409648","409945","75","1695628"
"JH378135","2282388","2282663","KQ055035v1","8495544","8495813","79","6213156"
"JH378135","2379613","2379735","KQ057034v1","1997084","1997205","40","382529"
"JH378135","2506071","2506382","KQ052993v1","743501","743813","64","1762570"
"JH378135","2531754","2531878","KQ055498v1","86970","87098","21","2444784"
"JH378135","2766755","2767071","KQ054191v1","3583730","3584032","73","816975"
"JH378135","2953217","2953421","KQ052968v1","13131640","13131834","62","10178423"
"JH378135","2971287","2971593","KQ052984v1","105454","105757","63","2865833"
"JH378135","3120767","3120898","KQ054522v1","1628214","1628331","37","1492553"
"JH378135","3305483","3305790","KQ057911v1","428931","429228","69","2876552"
"JH378135","3414891","3415158","KQ054069v1","7184312","7184581","69","3769421"
"JH378135","3571153","3571285","KQ053409v1","6573923","6574054","31","3002770"
"JH378135","3584170","3584305","KQ054826v1","38244","38379","46","3545926"
"JH378135","3606031","3606264","KQ055518v1","1576074","1576315","59","2029957"
"JH378135","3626482","3626757","KQ054510v1","5210888","5211157","64","1584406"
"JH378135","3655319","3655503","KQ054994v1","1493970","1494127","55","2161349"
"JH378135","3716253","3716476","KQ057840v1","234828","235046","54","3481425"
"JH378135","4506926","4507055","KQ055957v1","554477","554608","22","3952449"
"JH378135","4596393","4596686","KQ054400v1","2791993","2792290","56","1804400"
"JH378135","4601410","4601690","KQ052968v1","13260777","13261056","64","8659367"
"JH378135","4611968","4612265","KQ052968v1","7300500","7300792","67","2688532"
"JH378135","4623763","4624030","KQ052969v1","11182978","11183250","71","6559215"
"JH378135","4821818","4822064","KQ057380v1","5296448","5296684","78","474630"
"JH378135","4840322","4840487","KQ058259v1","1242505","1242648","53","3597817"
"JH378135","4896049","4896356","KQ057858v1","376905","377209","68","4519144"
"JH378135","4999344","4999396","KQ055247v1","4402957","4403009","11","596387"
"JH378135","5176902","5177064","KQ055518v1","2431373","2431535","44","2745529"
"JH378135","5182350","5182658","KQ053816v1","7327018","7327317","77","2144668"
"JH378135","5199700","5199845","KQ053115v1","1650505","1650644","30","3549195"
"JH378135","5353376","5353556","KQ053454v1","785491","785674","45","4567885"
"JH378135","5509144","5509275","KQ053202v1","780148","780280","19","4728996"
"JH378135","5514116","5514386","KQ058184v1","1608105","1608378","59","3906011"
"JH378135","5535210","5535490","KQ054124v1","2442155","2442433","57","3093055"
"JH378135","5557584","5557867","KQ054693v1","832788","833076","65","4724796"
"JH378135","5563988","5564294","KQ053070v1","1687512","1687824","72","3876476"
"JH378135","5651958","5652092","KQ056996v1","661309","661441","41","4990649"
"JH378135","5790579","5790799","KQ053190v1","1461591","1461816","60","4328988"
"JH378135","5997060","5997342","KQ054804v1","964015","964313","61","5033045"
"JH378135","6437802","6438070","KQ053146v1","2819587","2819868","74","3618215"
"JH378135","6438981","6439112","KQ053883v1","3686969","3687100","33","2752012"
"JH378135","7203383","7203516","KQ054069v1","2479321","2479456","28","4724062"
"JH378135","7328807","7329085","KQ054745v1","163102","163377","65","7165705"
"JH378135","7359332","7359571","KQ057291v1","322948","323180","62","7036384"
"JH378135","8300080","8300245","KQ055425v1","1445594","1445758","36","6854486"
"JH378135","8365388","8365688","KQ052981v1","658787","659079","81","7706601"
"JH378135","8610923","8611107","KQ055457v1","11733685","11733859","46","3122762"
"JH378135","8752831","8753107","KQ058316v1","4697990","4698273","76","4054841"
"JH378135","8956456","8956585","KQ054069v1","4083160","4083297","32","4873296"
"JH378135","8978722","8978983","KQ054069v1","928440","928688","61","8050282"
"JH378135","9088800","9088986","KQ055140v1","3477076","3477259","50","5611724"
"JH378135","9287761","9288056","KQ058275v1","201680","201968","70","9086081"
"JH378135","9352807","9352957","KQ054466v1","1866785","1866925","40","7486022"
"JH378135","9453746","9454067","KQ053267v1","3278124","3278417","78","6175622"
"JH378135","9715289","9715441","KQ053234v1","993607","993754","37","8721682"
"JH378135","9871374","9871581","KQ056331v1","921190","921418","59","8950184"
"JH378135","9991906","9992199","KQ053696v1","289251","289545","61","9702655"
"JH378135","10046894","10047024","KQ053059v1","5085021","5085153","37","4961873"
"JH378135","10095392","10095664","KQ053905v1","975454","975736","71","9119938"
"JH378135","10097332","10097583","KQ052968v1","8641435","8641673","73","1455897"
"JH378135","10171637","10171770","KQ053520v1","716323","716460","27","9455314"
"JH378135","10312327","10312493","KQ054533v1","1027813","1027974","44","9284514"
"JH378135","10346603","10346748","KQ053157v1","4288391","4288538","36","6058212"
"JH378135","10371312","10371623","KQ053816v1","7464708","7465010","77","2906604"
"JH378135","10425234","10425442","KQ057290v1","4745481","4745684","49","5679753"
"JH378135","10450931","10451066","KQ058561v1","557545","557678","25","9893386"
"JH378135","10531666","10531962","KQ053729v1","548974","549267","69","9982692"
"JH378135","10574679","10574980","KQ058516v1","1662296","1662590","73","8912383"
"JH378135","11224548","11224874","KQ055777v1","2071501","2071828","78","9153047"
"JH378135","11337661","11337928","KQ053026v1","3680523","3680807","85","7657138"
"JH378135","11669578","11669766","KQ054933v1","3939617","3939804","52","7729961"
"JH378135","11955287","11955567","KQ053409v1","3716306","3716585","60","8238981"
"JH378135","12039229","12039507","KQ054401v1","3812976","3813275","83","8226253"
"JH378135","12042938","12043234","KQ052970v1","10427454","10427754","71","1615484"
"JH378135","12360602","12360895","KQ054400v1","4672799","4673099","64","7687803"
"JH378135","12379406","12379535","KQ058483v1","5373223","5373356","25","7006183"
"JH378135","12406100","12406273","KQ056134v1","2704736","2704912","51","9701364"
"JH378135","12527923","12528232","KQ053816v1","7223046","7223355","76","5304877"
"JH378135","12899157","12899363","KQ053223v1","773388","773584","56","12125769"
"JH378135","13042676","13042823","KQ058105v1","498394","498537","35","12544282"
"JH378135","13092259","13092444","KQ056375v1","1153881","1154077","55","11938378"
"JH378135","13125978","13126265","KQ056234v1","2521120","2521411","74","10604858"
"JH378135","13413617","13413903","KQ054356v1","1356188","1356481","73","12057429"
"JH378135","13995942","13996220","KQ053190v1","4987885","4988162","54","9008057"
"JH378135","14189736","14190040","KQ058184v1","1505565","1505858","73","12684171"
"JH378135","14486377","14486509","KQ055141v1","3481451","3481584","35","11004926"
"JH378135","14821517","14821804","KQ053971v1","3610129","3610423","66","11211388"
"JH378135","14935448","14935718","KQ055035v1","4381466","4381744","56","10553982"
"JH378135","15183215","15183499","KQ053104v1","3864277","3864560","66","11318938"
"JH378135","15222834","15223123","KQ053948v1","168940","169229","72","15053894"
"JH378135","15225638","15225763","KQ054113v1","1506620","1506744","29","13719018"
"JH378135","15307661","15307919","KQ058280v1","515894","516148","64","14791767"
"JH378135","15311585","15311900","KQ053894v1","1262767","1263078","65","14048818"
"JH378135","15338395","15338560","KQ053135v1","3925667","3925819","47","11412728"
"JH378135","15361186","15361460","KQ052970v1","4138682","4138959","84","11222504"
"JH378135","15439987","15440141","KQ053740v1","1071467","1071623","33","14368520"
"JH378135","15440990","15441117","KQ053115v1","1650505","1650644","29","13790485"
"JH378135","15594355","15594490","KQ053654v1","4929533","4929667","24","10664822"
"JH378135","15619786","15620070","KQ053146v1","1320586","1320881","71","14299200"
"JH378135","15668974","15669129","KQ054179v1","2203336","2203492","37","13465638"
"JH378135","15697564","15697777","KQ058505v1","2234909","2235124","48","13462655"
"JH378135","15787692","15787872","KQ053631v1","9533513","9533694","42","6254179"
"JH378135","15890863","15891147","KQ053465v1","167701","167983","63","15723162"
"JH378135","15939763","15940073","KQ058585v1","580456","580763","71","15359307"
"JH378135","15998209","15998338","KQ053354v1","702320","702452","29","15295889"
"JH378135","16035999","16036288","KQ053827v1","4198964","4199247","68","11837035"
"JH378135","16057470","16057628","KQ054179v1","3818836","3818992","46","12238634"
"JH378135","16077622","16077916","KQ058184v1","1505565","1505858","63","14572057"
"JH378135","16177080","16177376","KQ055490v1","2107132","2107421","76","14069948"
"JH378135","16402437","16402707","KQ057213v1","1074642","1074915","65","15327795"
"JH378135","16452553","16452778","KQ058255v1","233892","234115","58","16218661"
"JH378135","16554637","16554943","KQ058490v1","211864","212170","74","16342773"
"JH378135","16587431","16587695","KQ053332v1","447571","447853","80","16139860"
"JH378135","16648194","16648500","KQ058561v1","4991819","4992113","71","11656375"
"JH378135","16855055","16855338","KQ055777v1","2252512","2252796","65","14602543"
"JH378135","17318512","17318647","KQ053354v1","702320","702452","23","16616192"
"JH378135","17326440","17326743","KQ053816v1","6856607","6856902","67","10469833"
"JH378135","17429713","17429844","KQ053718v1","316226","316356","24","17113487"
"JH378135","17471824","17472114","KQ054102v1","1325684","1325978","65","16146140"
"JH378135","17505078","17505366","KQ058184v1","1505565","1505858","57","15999513"
"JH378135","17531760","17532065","KQ053654v1","5318679","5318982","58","12213081"
"JH378135","17565530","17565822","KQ058094v1","7832529","7832815","74","9733001"
"JH378135","17606993","17607269","KQ052968v1","6282633","6282918","75","11324360"
"JH378135","17726098","17726221","KQ053146v1","2799678","2799801","29","14926420"
"JH378135","17960259","17960399","KQ057380v1","3048534","3048665","27","14911725"
"JH378135","18044938","18045198","KQ057380v1","3498341","3498594","72","14546597"
"JH378135","18111273","18111486","KQ056996v1","148346","148555","51","17962927"
"JH378135","18121571","18121701","KQ053299v1","20847245","20847364","42","2725674"
"JH378135","18219034","18219308","KQ053146v1","2819587","2819868","70","15399447"
"JH378135","18259247","18259498","KQ052969v1","810013","810295","75","17449234"
"JH378135","18262966","18263222","KQ058379v1","21379","21640","70","18241587"
"JH378135","18438934","18439227","KQ058184v1","1505565","1505858","58","16933369"
"JH378135","18487939","18488094","KQ055549v1","3675407","3675567","44","14812532"
"JH378135","18500906","18501202","KQ055097v1","1884579","1884874","65","16616327"
"JH378135","18604887","18605019","KQ056643v1","1491838","1491968","21","17113049"
"JH378135","18660653","18660909","KQ058427v1","4553509","4553777","69","14107144"
"JH378135","18723345","18723644","KQ054606v1","1970307","1970600","69","16753038"
"JH378135","18763579","18763880","KQ055590v1","630185","630485","68","18133394"
"JH378135","18768918","18769059","KQ054069v1","2479321","2479456","26","16289597"
"JH378135","18982973","18983286","KQ053432v1","4280053","4280348","69","14702920"
"JH378135","19396318","19396614","KQ058184v1","1505565","1505858","77","17890753"
"JH378135","19499119","19499425","KQ052968v1","5470311","5470611","69","14028808"
"JH378135","19663824","19664136","KQ054525v1","45769","46078","67","19618055"
"JH378135","19886052","19886331","KQ055787v1","925083","925374","69","18960969"
"JH378135","20350329","20350585","KQ053894v1","688559","688830","59","19661770"
"JH378135","20575652","20575930","KQ057118v1","4601602","4601894","65","15974050"
"JH378135","20843113","20843241","KQ058427v1","4756553","4756686","23","16086560"
"JH378135","20912160","20912359","KQ055978v1","4931093","4931294","55","15981067"
"JH378135","20943294","20943346","KQ053443v1","334639","334693","11","20608655"
"JH378135","20969996","20970284","KQ053026v1","3680523","3680807","57","17289473"
"JH378135","21099523","21099836","KQ058480v1","758959","759271","70","20340564"
"JH378135","21289602","21289899","KQ054412v1","2490468","2490761","59","18799134"
"JH378135","21452807","21453087","KQ052969v1","7351818","7352090","71","14100989"
"JH378135","21591669","21591807","KQ057911v1","1028079","1028217","26","20563590"
"JH378135","21668566","21668862","KQ052969v1","9553757","9554052","64","12114809"
"JH378136","15073191","15073486","KQ054725v1","2218271","2218569","60","12854920"
"JH378136","85226","85502","KQ056320v1","1284429","1284707","78","1199203"
"JH378136","138389","138681","KQ054804v1","964015","964313","59","825626"
"JH378136","186654","186933","KQ053883v1","4079248","4079525","76","3892594"
"JH378136","329744","329998","KQ054289v1","4494059","4494296","66","4164315"
"JH378136","439752","439993","KQ053795v1","121444","121694","69","318308"
"JH378136","482728","483035","KQ053299v1","4095914","4096215","71","3613186"
"JH378136","743095","743395","KQ054400v1","4684535","4684832","70","3941440"
"JH378136","1450624","1450895","KQ058394v1","3915274","3915538","69","2464650"
"JH378136","1615538","1615745","KQ052969v1","8528994","8529192","59","6913456"
"JH378136","1704622","1704933","KQ056568v1","817681","817996","60","886941"
"JH378136","1835625","1835852","KQ057380v1","2047063","2047290","53","211438"
"JH378136","2424941","2425120","KQ058513v1","234116","234313","62","2190825"
"JH378136","2697880","2698049","KQ056996v1","1524030","1524195","37","1173850"
"JH378136","2768394","2768595","KQ055893v1","679395","679599","59","2088999"
"JH378136","2774731","2775015","KQ052968v1","14043756","14044036","70","11269025"
"JH378136","2783721","2783906","KQ058094v1","6990178","6990359","54","4206457"
"JH378136","2784238","2784362","KQ053609v1","1892948","1893072","22","891290"
"JH378136","5557733","5558044","KQ052981v1","1198440","1198752","62","4359293"
"JH378136","5738088","5738173","KQ058484v1","214024","214108","24","5524064"
"JH378136","5738261","5738413","KQ054466v1","1866785","1866925","42","3871476"
"JH378136","5937916","5938209","KQ052982v1","1103561","1103855","68","4834355"
"JH378136","5994818","5994952","KQ058427v1","4756553","4756686","31","1238265"
"JH378136","6044493","6044795","KQ058427v1","5781896","5782172","81","262597"
"JH378136","6080703","6080895","KQ057504v1","820042","820223","52","5260661"
"JH378136","6155035","6155345","KQ058184v1","1505565","1505858","76","4649470"
"JH378136","6219369","6219532","KQ057737v1","1426090","1426247","31","4793279"
"JH378136","6226876","6227077","KQ054510v1","1448917","1449101","56","4777959"
"JH378136","6348644","6348931","KQ053409v1","6051156","6051445","68","297488"
"JH378136","6401196","6401468","KQ052969v1","11182978","11183250","60","4781782"
"JH378136","6411072","6411387","KQ054191v1","4157356","4157666","60","2253716"
"JH378136","6449738","6449948","KQ053520v1","4901250","4901462","54","1548488"
"JH378136","6529851","6530137","KQ054412v1","2490468","2490761","66","4039383"
"JH378136","6665717","6665851","KQ053354v1","702320","702452","21","5963397"
"JH378136","6761142","6761283","KQ055065v1","3115232","3115371","36","3645910"
"JH378136","7087620","7087793","KQ057649v1","424252","424417","32","6663368"
"JH378136","7154237","7154367","KQ053070v1","2490401","2490534","24","4663836"
"JH378136","7390615","7390929","KQ054401v1","4006898","4007199","81","3383717"
"JH378136","7554621","7554941","KQ056855v1","2079303","2079613","96","5475318"
"JH378136","7645752","7646076","KQ053554v1","2471177","2471484","82","5174575"
"JH378136","7661408","7661689","KQ055872v1","12987862","12988141","57","5326454"
"JH378136","7753113","7753396","KQ056762v1","532889","533183","64","7220224"
"JH378136","7987804","7988092","KQ055353v1","1973943","1974227","57","6013861"
"JH378136","8695636","8695914","KQ055872v1","12987862","12988141","75","4292226"
"JH378136","8749607","8749880","KQ053267v1","3621249","3621519","81","5128358"
"JH378136","8762035","8762177","KQ053081v1","7678221","7678366","36","1083814"
"JH378136","8883492","8883779","KQ056147v1","1064032","1064323","66","7819460"
"JH378136","8892176","8892449","KQ053288v1","2767251","2767531","71","6124925"
"JH378136","9115973","9116261","KQ053654v1","820983","821268","65","8294990"
"JH378136","9377960","9378204","KQ058503v1","123813","124064","63","9254147"
"JH378136","10053732","10054030","KQ058190v1","350088","350375","70","9703644"
"JH378136","10072497","10072780","KQ054069v1","955693","955974","69","9116804"
"JH378136","10161449","10161597","KQ058594v1","1377512","1377662","36","8783937"
"JH378136","10167281","10167624","KQ053785v1","1434687","1435016","86","8732594"
"JH378136","10174221","10174511","KQ056672v1","5197135","5197428","60","4977086"
"JH378136","10553043","10553343","KQ053421v1","5481506","5481799","76","5071537"
"JH378136","10933635","10933924","KQ057909v1","14641987","14642269","77","3708352"
"JH378136","11955898","11956176","KQ053785v1","767236","767521","64","11188662"
"JH378136","12199590","12199870","KQ058561v1","4466656","4466945","64","7732934"
"JH378136","12265562","12265683","KQ058076v1","395436","395552","27","11870126"
"JH378136","12373480","12373794","KQ056293v1","93732","94015","105","12279748"
"JH378136","12506513","12506805","KQ057693v1","621833","622123","71","11884680"
"JH378136","12552698","12552830","KQ053354v1","702320","702452","20","11850378"
"JH378136","12610875","12611086","KQ053398v1","3158290","3158500","54","9452585"
"JH378136","12702431","12702715","KQ058427v1","4553509","4553777","79","8148922"
"JH378136","12762257","12762456","KQ056386v1","681355","681556","52","12080902"
"JH378136","12763222","12763312","KQ052968v1","6651946","6652022","28","6111276"
"JH378136","12777054","12777372","KQ054725v1","1024418","1024732","70","11752636"
"JH378136","12865590","12865723","KQ054213v1","615112","615244","20","12250478"
"JH378136","12961704","12962028","KQ052970v1","6519506","6519794","99","6442198"
"JH378136","13200004","13200230","KQ058328v1","2569266","2569497","59","10630738"
"JH378136","13204892","13205193","KQ054510v1","8555095","8555387","59","4649797"
"JH378136","13273933","13274053","KQ053135v1","3445097","3445217","32","9828836"
"JH378136","13286564","13286842","KQ054401v1","2629005","2629296","70","10657559"
"JH378136","13289534","13289838","KQ054879v1","1971571","1971875","58","11317963"
"JH378136","13372070","13372364","KQ058184v1","1505565","1505858","65","11866505"
"JH378136","13449159","13449334","KQ052969v1","8430836","8430996","47","5018323"
"JH378136","13500001","13500129","KQ052993v1","71964","72092","27","13428037"
"JH378136","13558006","13558178","KQ053004v1","2575851","2575999","54","10982155"
"JH378136","13711300","13711481","KQ058381v1","759884","760066","52","12951416"
"JH378136","13736530","13736603","KQ053332v1","1937831","1937907","13","11798699"
"JH378136","13807733","13807865","KQ053861v1","8359","8490","22","13799374"
"JH378136","13872271","13872591","KQ053146v1","2819587","2819868","86","11052684"
"JH378136","13974476","13974698","KQ058272v1","2561906","2562124","59","11412570"
"JH378136","14023649","14023940","KQ054510v1","8555095","8555387","67","5468554"
"JH378136","14108954","14109256","KQ058184v1","1505565","1505858","71","12603389"
"JH378136","14144672","14144963","KQ053109v1","131996","132292","72","14012676"
"JH378136","14182925","14183079","KQ057561v1","1395117","1395274","38","12787808"
"JH378136","14348901","14349187","KQ058405v1","697304","697560","84","13651597"
"JH378136","14378355","14378604","KQ058379v1","21379","21640","64","14356976"
"JH378136","14423309","14423472","KQ055518v1","2431373","2431535","40","11991936"
"JH378136","14428177","14428341","KQ058394v1","13334171","13334328","48","1094006"
"JH378136","14444737","14444957","KQ053959v1","3147544","3147761","50","11297193"
"JH378136","14496639","14496926","KQ053410v1","515520","515804","65","13981119"
"JH378136","14551176","14551424","KQ058272v1","4031819","4032082","75","10519357"
"JH378136","14619087","14619391","KQ058272v1","6007682","6007982","64","8611405"
"JH378136","14646454","14646586","KQ055498v1","134697","134829","30","14511757"
"JH378136","14663154","14663444","KQ053763v1","3936916","3937207","63","10726238"
"JH378136","14739267","14739353","KQ052968v1","6651946","6652022","26","8087321"
"JH378136","14740191","14740311","KQ056182v1","147436","147554","36","14592755"
"JH378136","14747999","14748151","KQ053212v1","578976","579120","36","14169023"
"JH378136","14811412","14811498","KQ053520v1","1561632","1561710","17","13249780"
"JH378136","14814074","14814378","KQ054510v1","2056259","2056562","77","12757815"
"JH378136","14833084","14833389","KQ053741v1","2418696","2419001","59","12414388"
"JH378136","14928770","14929070","KQ053432v1","7885304","7885597","105","7043466"
"JH378136","14962786","14963073","KQ057004v1","1506143","1506432","66","13456643"
"JH378136","14977388","14977678","KQ055248v1","947170","947461","71","14030218"
"JH378136","15026191","15026314","KQ054125v1","70048","70178","40","14956143"
"JH378136","15061456","15061675","KQ056762v1","1558119","1558341","53","13503337"
"JH378136","15108632","15108833","KQ054401v1","3245220","3245428","49","11863412"
"JH378136","15165431","15165565","KQ053948v1","2765570","2765701","23","12399861"
"JH378136","15326295","15326348","KQ055579v1","267652","267696","17","15058643"
"JH378136","15608183","15608473","KQ052971v1","841846","842131","64","14766337"
"JH378136","15693981","15694138","KQ055725v1","1180022","1180171","42","14513959"
"JH378136","15910888","15911172","KQ055352v1","13451535","13451828","79","2459353"
"JH378136","16031469","16031761","KQ053297v1","44026","44315","77","15987443"
"JH378136","16037427","16037728","KQ058428v1","2055160","2055453","70","13982267"
"JH378136","16069989","16070259","KQ057693v1","621833","622123","75","15448156"
"JH378136","16074374","16074656","KQ053093v1","1361295","1361576","69","14713079"
"JH378136","16184909","16185263","KQ058321v1","727704","728006","130","15457205"
"JH378136","16209288","16209532","KQ054804v1","1007773","1008011","79","15201515"
"JH378136","16210242","16210388","KQ054196v1","237","387","36","16210005"
"JH378136","16228217","16228513","KQ058350v1","729240","729534","78","15498977"
"JH378136","16232696","16232978","KQ052969v1","11082995","11083279","72","5149701"
"JH378136","16301159","16301440","KQ053146v1","2819587","2819868","62","13481572"
"JH378136","16313966","16314102","KQ055893v1","1630751","1630897","48","14683215"
"JH378136","16404571","16404694","KQ053409v1","6105325","6105446","26","10299246"
"JH378136","16442657","16442962","KQ058184v1","1505565","1505858","74","14937092"
"JH378136","16466555","16466717","KQ058572v1","3607755","3607912","34","12858800"
"JH378136","16492762","16493001","KQ054921v1","1712964","1713196","50","14779798"
"JH378136","16938577","16938873","KQ053520v1","3826144","3826443","73","13112433"
"JH378136","17114392","17114674","KQ055352v1","4380175","4380453","80","12734217"
"JH378136","17129111","17129416","KQ053398v1","2545768","2546067","64","14583343"
"JH378136","17494170","17494305","KQ054943v1","3338657","3338793","33","14155513"
"JH378136","17622301","17622428","KQ058483v1","5373223","5373356","24","12249078"
"JH378136","17811047","17811371","KQ055872v1","4196195","4196516","88","13614852"
"JH378136","17894676","17895043","KQ053409v1","5569056","5569389","115","12325620"
"JH378136","17951298","17951588","KQ058561v1","4466656","4466945","67","13484642"
"JH378136","18025249","18025498","KQ054068v1","1263304","1263537","75","16761945"
"JH378136","18254161","18254296","KQ058355v1","1446443","1446570","30","16807718"
"JH378136","18254433","18254563","KQ054857v1","362885","363016","26","17891548"
"JH378136","18324570","18324790","KQ053398v1","3158290","3158500","64","15166280"
"JH378136","18331196","18331466","KQ055331v1","559095","559355","75","17772101"
"JH378136","18423161","18423285","KQ054649v1","1173471","1173595","37","17249690"
"JH378136","18618603","18618917","KQ056404v1","1889967","1890264","90","16728636"
"JH378136","18795705","18795879","KQ053299v1","6349877","6350047","52","12445828"
"JH378136","18830667","18830948","KQ055978v1","3560415","3560681","72","15270252"
"JH378136","18832246","18832311","KQ058076v1","120666","120729","20","18711580"
"JH378136","18917434","18917619","KQ054628v1","818377","818563","46","18099057"
"JH378136","19500207","19500469","KQ054401v1","734156","734406","76","18766051"
"JH378136","19578730","19579004","KQ055097v1","1704793","1705067","69","17873937"
"JH378136","19602164","19602349","KQ053032v1","508140","508329","77","19094024"
"JH378136","19635898","19636235","KQ058317v1","2741476","2741796","105","16894422"
"JH378136","19767074","19767296","KQ056234v1","4592339","4592554","62","15174735"
"JH378136","20226860","20227150","KQ052969v1","9116808","9117108","73","11110052"
"JH378136","21025315","21025435","KQ053409v1","6105325","6105446","26","14919990"
"JH378136","21068793","21069087","KQ055173v1","452351","452623","64","20616442"
"JH378136","21338903","21339185","KQ057875v1","469535","469791","68","20869368"
"JH378137","52377","52531","KQ054124v1","4733901","4734054","33","4681524"
"JH378137","158394","158633","KQ054693v1","745323","745572","69","586929"
"JH378137","167137","167442","KQ056148v1","4371920","4372216","66","4204783"
"JH378137","240679","240987","KQ053299v1","2867160","2867464","77","2626481"
"JH378137","325857","326131","KQ056773v1","168010","168288","66","157847"
"JH378137","353235","353412","KQ057737v1","3327678","3327839","62","2974443"
"JH378137","355141","355449","KQ056148v1","430759","431072","72","75618"
"JH378137","377961","378250","KQ055852v1","1231373","1231668","71","853412"
"JH378137","422611","422866","KQ055872v1","4871111","4871358","61","4448500"
"JH378137","428268","428626","KQ056568v1","1297900","1298206","105","869632"
"JH378137","463176","463434","KQ053191v1","1874915","1875171","60","1411739"
"JH378137","616656","616924","KQ052968v1","4142140","4142422","64","3525484"
"JH378137","646780","647087","KQ053044v1","405596","405892","75","241184"
"JH378137","883554","883686","KQ055298v1","1575436","1575566","20","691882"
"JH378137","990438","990690","KQ054725v1","1394675","1394915","77","404237"
"JH378137","1109237","1109339","KQ054921v1","165725","165837","25","943512"
"JH378137","1110317","1110469","KQ058427v1","3400358","3400512","44","2290041"
"JH378137","1129057","1129268","KQ058595v1","117016","117224","56","1012041"
"JH378137","1242389","1242676","KQ056672v1","3535300","3535593","65","2292911"
"JH378137","1258957","1259187","KQ055076v1","1771126","1771361","76","512169"
"JH378137","1296947","1297041","KQ056494v1","3420476","3420570","25","2123529"
"JH378137","1323991","1324277","KQ052970v1","6659487","6659775","67","5335496"
"JH378137","1472827","1473108","KQ054068v1","1268545","1268823","68","204282"
"JH378137","1559317","1559606","KQ056475v1","14677","14970","71","1544640"
"JH378137","1763994","1764313","KQ053115v1","3485337","3485650","67","1721343"
"JH378137","1782942","1783069","KQ055236v1","1859314","1859441","28","76372"
"JH378137","1793061","1793218","KQ057737v1","1426090","1426247","34","366971"
"JH378137","1997591","1997745","KQ052968v1","10427732","10427888","35","8430141"
"JH378137","2094654","2094818","KQ056996v1","1524030","1524195","34","570624"
"JH378137","2216376","2216588","KQ057119v1","1328304","1328524","52","888072"
"JH378137","2220166","2220441","KQ058275v1","938649","938919","63","1281517"
"JH378137","2261809","2262129","KQ058199v1","498772","499079","73","1763037"
"JH378137","2266321","2266627","KQ058328v1","4902909","4903206","65","2636588"
"JH378137","2273466","2273764","KQ054069v1","5704070","5704362","71","3430604"
"JH378137","2310746","2311029","KQ052968v1","10629964","10630247","63","8319218"
"JH378137","2448383","2448670","KQ055717v1","439513","439802","66","2008870"
"JH378137","2519705","2519926","KQ053959v1","3147544","3147761","45","627839"
"JH378137","2542683","2542850","KQ053223v1","2815634","2815800","33","272951"
"JH378137","2564563","2564701","KQ054932v1","7091907","7092041","29","4527344"
"JH378137","2574920","2575200","KQ054412v1","2490468","2490761","62","84452"
"JH378137","2592697","2592769","KQ057796v1","119005","119079","18","2473692"
"JH378137","2598290","2598372","KQ053060v1","4849","4931","14","2593441"
"JH378137","2622302","2622625","KQ055787v1","694393","694708","75","1927909"
"JH378137","2663071","2663236","KQ054026v1","2068803","2068970","41","594268"
"JH378137","2723244","2723403","KQ057737v1","1426090","1426247","20","1297154"
"JH378137","2768259","2768488","KQ053354v1","1943191","1943424","57","825068"
"JH378137","2768565","2768644","KQ053332v1","1937831","1937907","18","830734"
"JH378137","2892561","2892671","KQ053686v1","2459317","2459421","34","433244"
"JH378137","2927591","2927864","KQ057223v1","124007","124258","83","2803584"
"JH378137","2972522","2972811","KQ057504v1","162767","163049","67","2809755"
"JH378137","2979769","2980030","KQ053059v1","2135970","2136233","67","843799"
"JH378137","3001921","3002218","KQ054857v1","921177","921473","59","2080744"
"JH378137","3070597","3070864","KQ058546v1","168071","168339","71","2902526"
"JH378137","3126368","3126624","KQ056493v1","2027415","2027683","63","1098953"
"JH378137","3144400","3144563","KQ053202v1","830653","830812","40","2313747"
"JH378137","3224634","3224924","KQ052982v1","2466107","2466398","61","758527"
"JH378137","3667198","3667474","KQ057268v1","638006","638293","76","3029192"
"JH378137","3691096","3691394","KQ054401v1","2629005","2629296","70","1062091"
"JH378137","3702935","3703256","KQ058585v1","580456","580763","78","3122479"
"JH378137","3718435","3718567","KQ055498v1","814067","814199","28","2904368"
"JH378137","3718881","3719048","KQ052969v1","8430836","8430996","37","4711955"
"JH378137","3733774","3734047","KQ056148v1","2246905","2247173","64","1486869"
"JH378137","3767130","3767434","KQ056568v1","1617795","1618102","65","2149335"
"JH378137","3778031","3778184","KQ055662v1","1094666","1094812","39","2683365"
"JH378137","3817266","3817395","KQ053609v1","1892948","1893072","25","1924318"
"JH378137","3817678","3817836","KQ053157v1","5478543","5478695","29","1660865"
"JH378137","3859416","3859698","KQ053409v1","3716306","3716585","61","143110"
"JH378137","3940373","3940656","KQ054693v1","832788","833076","64","3107585"
"JH378137","3953873","3954149","KQ057737v1","3083543","3083824","74","870330"
"JH378137","4019329","4019483","KQ054179v1","3818836","3818992","29","200493"
"JH378137","4023439","4023722","KQ055352v1","13451535","13451828","63","9428096"
"JH378137","4028039","4028176","KQ052970v1","11857903","11858038","39","7829864"
"JH378137","4188009","4188209","KQ058383v1","9982530","9982731","41","5794521"
"JH378137","4207259","4207551","KQ053763v1","141096","141389","69","4066163"
"JH378137","4254606","4254846","KQ053026v1","2213601","2213834","72","2041005"
"JH378137","4257655","4257953","KQ054213v1","780092","780393","64","3477563"
"JH378137","4262269","4262511","KQ056945v1","3412069","3412291","74","850200"
"JH378137","4303232","4303507","KQ053409v1","5686466","5686740","67","1383234"
"JH378137","4398055","4398332","KQ054069v1","955693","955974","60","3442362"
"JH378137","4402143","4402444","KQ058350v1","6740286","6740580","64","2338143"
"JH378137","4461442","4461615","KQ056056v1","323324","323503","43","4138118"
"JH378137","4466968","4467233","KQ055735v1","667472","667747","75","3799496"
"JH378137","4497186","4497290","KQ058394v1","16261373","16261476","19","11764187"
"JH378137","4625753","4626048","KQ056147v1","1064032","1064323","64","3561721"
"JH378137","4974067","4974346","KQ055065v1","999059","999338","65","3975008"
"JH378137","5023094","5023398","KQ055236v1","2049624","2049930","69","2973470"
"JH378137","5097110","5097263","KQ053212v1","578976","579120","37","4518134"
"JH378137","5155281","5155432","KQ054401v1","2342043","2342190","34","2813238"
"JH378137","5168674","5168978","KQ056331v1","1886723","1887024","67","3281951"
"JH378137","5220821","5221091","KQ057755v1","45985","46262","70","5174836"
"JH378137","5284990","5285116","KQ053115v1","2895891","2896019","34","2389099"
"JH378137","5325359","5325648","KQ053948v1","168940","169229","61","5156419"
"JH378137","5345315","5345595","KQ055755v1","1099241","1099517","78","4246074"
"JH378137","5469889","5470126","KQ054510v1","6090992","6091229","63","621103"
"JH378137","5492668","5492808","KQ053354v1","702320","702452","35","4790348"
"JH378137","5583615","5583897","KQ054932v1","11240590","11240876","69","5656975"
"JH378137","5595471","5595604","KQ053982v1","3934263","3934401","33","1661208"
"JH378137","5630019","5630298","KQ056440v1","1069847","1070137","71","4560172"
"JH378137","5649146","5649239","KQ053082v1","6601560","6601653","13","952414"
"JH378137","5666455","5666585","KQ057909v1","14636622","14636750","33","8970167"
"JH378137","5666727","5666817","KQ053005v1","324436","324539","24","5342291"
"JH378137","5671182","5671448","KQ053256v1","1257292","1257559","72","4413890"
"JH378137","5890358","5890525","KQ057480v1","674678","674843","30","5215680"
"JH378137","5904362","5904675","KQ054994v1","2360792","2361105","67","3543570"
"JH378137","5992774","5993031","KQ052970v1","2715607","2715860","70","3277167"
"JH378137","6151351","6151469","KQ054660v1","5437047","5437165","29","714304"
"JH378137","6183709","6183977","KQ053894v1","3244655","3244928","74","2939054"
"JH378137","6419790","6420091","KQ054037v1","400177","400475","73","6019613"
"JH378137","6741810","6742097","ABDC02003384v1","193955","194231","62","6547855"
"JH378137","6764029","6764159","KQ053354v1","702320","702452","23","6061709"
"JH378137","6973060","6973219","KQ055457v1","9445515","9445670","51","2472455"
"JH378137","6992182","6992449","KQ055663v1","1737755","1738038","80","5254427"
"JH378137","7091975","7092181","KQ053872v1","262334","262548","63","6829641"
"JH378137","7146846","7147142","KQ053300v1","2874445","2874736","62","4272401"
"JH378137","7181026","7181315","KQ058339v1","2911632","2911914","78","4269394"
"JH378137","7321056","7321283","KQ056447v1","2522955","2523197","65","4798101"
"JH378137","7332923","7333236","KQ054047v1","432706","433011","63","6900217"
"JH378137","7454027","7454311","KQ054124v1","2442155","2442433","67","5011872"
"JH378137","7455711","7456018","KQ052970v1","6659487","6659775","72","796224"
"JH378137","7491286","7491592","KQ054795v1","2774148","2774449","68","4717138"
"JH378137","7669061","7669190","KQ056475v1","2305251","2305383","25","5363810"
"JH378137","7860494","7860792","KQ054704v1","215433","215738","67","7645061"
"JH378137","7946056","7946361","KQ053115v1","3485337","3485650","70","4460719"
"JH378137","8061160","8061452","KQ056672v1","3535300","3535593","59","4525860"
"JH378137","8232757","8232962","KQ053299v1","2901484","2901684","61","5331273"
"JH378137","8596597","8596885","KQ053565v1","754705","754987","62","7841892"
"JH378137","8630199","8630512","KQ054289v1","107239","107526","87","8522960"
"JH378137","8790812","8790968","KQ053126v1","3105652","3105798","38","5685160"
"JH378137","8912391","8912662","KQ053631v1","9398334","9398603","66","485943"
"JH378137","9044805","9045086","KQ055065v1","1117201","1117481","62","7927604"
"JH378137","9395738","9396028","KQ053059v1","3421896","3422194","65","5973842"
"JH378137","9517547","9517775","KQ058613v1","403026","403252","50","9114521"
"JH378137","9518550","9518650","KQ053432v1","3939855","3939953","27","5578695"
"JH378137","9568567","9568846","KQ055173v1","248885","249169","60","9319682"
"JH378137","9576835","9577135","KQ057290v1","1053741","1054027","66","8523094"
"JH378137","9709443","9709752","KQ058184v1","1505565","1505858","66","8203878"
"JH378137","10128071","10128385","KQ058552v1","506861","507172","64","9621210"
"JH378137","10332822","10333130","KQ058427v1","11577834","11578154","81","1245012"
"JH378137","10437192","10437448","KQ054510v1","8112428","8112664","73","2324764"
"JH378137","10544523","10544810","KQ053093v1","1361295","1361576","64","9183228"
"JH378137","11291752","11291977","KQ054886v1","79","289","53","11291673"
"JH378137","11904225","11904508","KQ056587v1","15594744","15595024","68","3690519"
"JH378137","12144222","12144508","KQ055173v1","248885","249169","69","11895337"
"JH378137","12338029","12338243","KQ055076v1","1876180","1876398","55","10461849"
"JH378137","12525176","12525399","KQ056166v1","1907479","1907686","59","10617697"
"JH378137","13553802","13554098","KQ053070v1","1482644","1482942","68","12071158"
"JH378137","14025566","14025862","KQ057004v1","1506143","1506432","80","12519423"
"JH378137","14552708","14552924","KQ055830v1","278558","278787","72","14274150"
"JH378137","14649432","14649684","KQ053093v1","1363144","1363361","90","13286288"
"JH378137","14896764","14896806","KQ053696v1","2515039","2515082","9","12381725"
"JH378137","14926779","14927081","KQ055036v1","1508392","1508683","75","13418387"
"JH378137","14934201","14934330","KQ053948v1","2765570","2765701","25","12168631"
"JH378137","14989128","14989395","KQ056182v1","13998","14251","72","14975130"
"JH378137","15330718","15330868","KQ052970v1","12418764","12418905","32","2911954"
"JH378137","15331979","15332202","KQ056699v1","1232347","1232563","62","14099632"
"JH378137","15374873","15374958","KQ057909v1","12817249","12817336","29","2557624"
"JH378137","15387134","15387417","KQ056234v1","2521120","2521411","75","12866014"
"JH378137","16527491","16527792","KQ056035v1","996862","997158","77","15530629"
"JH378137","16544641","16544767","KQ058004v1","2254984","2255111","26","14289657"
"JH378137","16704011","16704327","KQ055629v1","4218571","4218881","64","12485440"
"JH378137","16888873","16889161","KQ053520v1","456408","456696","69","16432465"
"JH378137","17335467","17335761","KQ055725v1","1527395","1527689","64","15808072"
"JH378137","17550919","17551194","KQ054704v1","985921","986190","71","16564998"
"JH378137","17607903","17608020","KQ055352v1","4179658","4179774","39","13428245"
"JH378137","17720778","17721067","KQ054356v1","1931225","1931518","62","15789553"
"JH378137","17768751","17769067","KQ053476v1","3959355","3959665","73","13809396"
"JH378137","17809494","17809758","KQ053202v1","902785","903041","65","16906709"
"JH378137","17880873","17881187","KQ056928v1","1915686","1915996","71","15965187"
"JH378137","17932020","17932301","KQ052970v1","3228321","3228582","79","14703699"
"JH378137","18128161","18128420","KQ055872v1","13136193","13136453","60","4991968"
"JH378137","18265971","18266263","KQ058607v1","429760","430048","50","17836211"
"JH378137","18275568","18275670","KQ055903v1","115400","115506","32","18160168"
"JH378137","18277236","18277383","KQ056864v1","2852271","2852420","40","15424965"
"JH378137","18310850","18310906","KQ053299v1","2592408","2592461","14","15718442"
"JH378137","18319400","18319613","KQ053070v1","378761","378970","46","17940639"
"JH378137","18426407","18426655","KQ053115v1","1246859","1247104","67","17179548"
"JH378137","18610849","18611167","KQ055236v1","2049624","2049930","77","16561225"
"JH378137","18806805","18807079","KQ054804v1","315967","316240","71","18490838"
"JH378137","19202709","19202936","KQ058293v1","316326","316556","75","18886383"
"JH378137","19326953","19327084","KQ058383v1","7057041","7057173","22","12269912"
"JH378137","19358632","19358922","KQ057290v1","1053741","1054027","61","18304891"
"JH378137","19417678","19417947","KQ053004v1","3225867","3226135","68","16191811"
"JH378137","19419014","19419068","KQ057909v1","13231474","13231525","23","6187540"
"JH378137","19497227","19497522","KQ056790v1","446564","446855","63","19050663"
"JH378137","19525268","19525527","KQ053398v1","4974410","4974675","76","14550858"
"JH378137","19547934","19548146","KQ055394v1","2468946","2469164","60","17078988"
"JH378137","19630300","19630578","ABDC02051297v1","1939","2213","78","19628361"
"JH378137","19634966","19635244","KQ055766v1","4175053","4175345","63","15459913"
"JH378137","19647264","19647543","KQ053520v1","2913074","2913361","87","16734190"
"JH378137","19678852","19679148","KQ058516v1","1789801","1790088","63","17889051"
"JH378137","19751969","19752082","KQ055258v1","3274072","3274190","32","16477897"
"JH378137","19773660","19773767","KQ055903v1","115400","115506","31","19658260"
"JH378137","19810909","19811174","KQ054932v1","4469926","4470179","74","15340983"
"JH378137","19816973","19817263","KQ058173v1","992259","992524","84","18824714"
"JH378137","20022621","20022800","KQ056056v1","323324","323503","45","19699297"
"JH378137","20045525","20045807","KQ054412v1","1824448","1824730","65","18221077"
"JH378137","20101803","20101935","KQ055872v1","4808828","4808960","20","15292975"
"JH378137","20503130","20503289","KQ055425v1","1445594","1445758","33","19057536"
"JH378137","20547270","20547436","KQ053179v1","1735404","1735576","47","18811866"
"JH378137","20665979","20666106","KQ053354v1","702320","702452","24","19963659"
"JH378137","20717692","20717990","KQ055787v1","1064992","1065293","68","19652700"
"JH378137","20906538","20906838","KQ056643v1","431969","432259","60","20474569"
"JH378137","20954435","20954554","KQ058346v1","532513","532625","27","20421922"
"JH378137","21084975","21085168","KQ056147v1","3894275","3894476","59","17190700"
"JH378138","527696","527972","KQ058561v1","4466656","4466945","68","3938960"
"JH378138","2221205","2221500","KQ055375v1","2531528","2531834","72","310323"
"JH378138","2778824","2779111","KQ058383v1","2713168","2713439","74","65656"
"JH378138","2781885","2782027","KQ054180v1","70685","70834","40","2711200"
"JH378138","2782213","2782510","KQ057909v1","3829378","3829677","83","1047165"
"JH378138","2815406","2815571","KQ056996v1","1524030","1524195","38","1291376"
"JH378138","2867278","2867514","KQ052971v1","6441372","6441626","76","3574094"
"JH378138","3022817","3023089","KQ058004v1","1480411","1480689","67","1542406"
"JH378138","3085102","3085176","KQ058427v1","13228636","13228714","23","10143534"
"JH378138","3085177","3085300","KQ053146v1","2799678","2799801","22","285499"
"JH378138","3301518","3301864","KQ052968v1","7084626","7084953","105","3783108"
"JH378138","4305018","4305096","KQ057796v1","119005","119079","19","4186013"
"JH378138","4524495","4524870","KQ052970v1","22139707","22140040","129","17615212"
"JH378138","4989489","4989724","KQ055766v1","493092","493310","66","4496397"
"JH378138","5300149","5300348","KQ053294v1","648","849","54","5299501"
"JH378138","5300970","5301061","KQ055872v1","3969127","3969217","24","1331843"
"JH378138","5309325","5309607","KQ055590v1","962353","962634","68","4346972"
"JH378138","5478924","5479263","KQ053554v1","2471177","2471484","96","3007747"
"JH378138","5588354","5588668","KQ053816v1","7464708","7465010","64","1876354"
"JH378138","5699157","5699353","KQ054932v1","683409","683584","51","5015748"
"JH378138","5867804","5868108","KQ056996v1","837133","837431","68","5030671"
"JH378138","6077711","6078027","KQ056928v1","1915686","1915996","62","4162025"
"JH378138","6105422","6105691","KQ057290v1","2469746","2470009","61","3635676"
"JH378138","6344404","6344705","KQ054401v1","4718214","4718515","86","1626190"
"JH378138","6422133","6422421","KQ058184v1","1007732","1008022","70","5414401"
"JH378138","6478076","6478353","KQ052969v1","3675361","3675652","61","2802715"
"JH378138","6701814","6702111","KQ058184v1","1505565","1505858","61","5196249"
"JH378138","6798881","6799185","KQ054102v1","1325684","1325978","56","5473197"
"JH378138","7053867","7054197","KQ053332v1","761333","761652","83","6292534"
"JH378138","7172438","7172651","KQ053191v1","3682228","3682423","55","3490210"
"JH378138","7199811","7200109","KQ055872v1","3185791","3186084","67","4014020"
"JH378138","7354275","7354414","KQ053686v1","1108593","1108721","31","6245682"
"JH378138","7535911","7536212","KQ054510v1","6887667","6887971","64","648244"
"JH378138","7658162","7658437","KQ054826v1","9895778","9896046","65","2237616"
"JH378138","7773851","7774192","KQ058468v1","36378","36710","115","7737473"
"JH378138","8552711","8552994","KQ053004v1","1504007","1504282","76","7048704"
"JH378138","8592793","8593089","KQ054704v1","223675","223980","80","8369118"
"JH378138","10238620","10238930","KQ053115v1","3485337","3485650","74","6753283"
"JH378138","10790498","10790700","KQ056064v1","661842","662034","60","10128656"
"JH378138","11116535","11116755","KQ058505v1","3952082","3952290","66","7164453"
"JH378138","12233035","12233342","KQ053816v1","7464708","7465010","67","4768327"
"JH378138","12283392","12283469","KQ055893v1","2912845","2912909","25","9370547"
"JH378138","12457246","12457524","KQ058317v1","5506620","5506904","70","6950626"
"JH378138","13635685","13635993","KQ058184v1","1505565","1505858","81","12130120"
"JH378138","13804144","13804452","KQ054725v1","2090703","2091002","81","11713441"
"JH378138","14073767","14074055","KQ053299v1","21463978","21464264","73","7390211"
"JH378138","14898602","14898737","KQ058550v1","2860233","2860368","31","12038369"
"JH378138","14950486","14950779","KQ058317v1","4081966","4082258","69","10868520"
"JH378138","14970606","14970871","KQ055055v1","1882469","1882726","74","13088137"
"JH378138","15053388","15053668","KQ053081v1","3070068","3070349","69","11983320"
"JH378138","16058900","16059050","KQ056268v1","862150","862302","40","15196750"
"JH378138","16068984","16069286","KQ055629v1","135233","135538","64","15933751"
"JH378138","16076587","16076899","KQ052970v1","6659487","6659775","92","9417100"
"JH378138","16132455","16132727","KQ058341v1","1282553","1282819","74","14849902"
"JH378138","16222885","16223163","KQ052982v1","2557979","2558263","60","13664906"
"JH378138","16239566","16239836","KQ057909v1","519161","519431","70","15720405"
"JH378138","16295371","16295650","KQ058484v1","1229388","1229668","61","15065983"
"JH378138","16349339","16349621","KQ058427v1","4952461","4952735","72","11396878"
"JH378138","16435726","16435890","KQ054533v1","1027813","1027974","29","15407913"
"JH378138","16497863","16498132","KQ053959v1","6189151","6189431","65","10308712"
"JH378138","16499646","16499812","KQ055014v1","15960","16127","33","16483686"
"JH378138","16544705","16544952","KQ053740v1","548757","549009","63","15995948"
"JH378138","16623718","16623873","KQ055214v1","601175","601332","35","16022543"
"JH378138","16674161","16674485","KQ053299v1","2867160","2867464","93","13807001"
"JH378138","16869087","16869381","KQ054693v1","837377","837666","69","16031710"
"JH378138","16912645","16912726","KQ058107v1","1643","1725","25","16911002"
"JH378138","17632933","17633239","KQ053409v1","5839938","5840242","73","11792995"
"JH378138","17733957","17734247","KQ052970v1","8520800","8521088","66","9213157"
"JH378138","18072313","18072620","KQ053299v1","6038380","6038679","70","12033933"
"JH378138","18226075","18226215","KQ056147v1","2168964","2169108","34","16057111"
"JH378138","18366932","18367244","KQ057380v1","4658761","4659050","99","13708171"
"JH378138","18455848","18456126","KQ057204v1","3243370","3243655","77","15212478"
"JH378138","18592455","18592697","KQ055978v1","3670193","3670433","73","14922262"
"JH378138","18857769","18858069","KQ054725v1","2218271","2218569","71","16639498"
"JH378138","18968851","18969132","KQ057649v1","81106","81383","65","18887745"
"JH378138","19201934","19202289","KQ054289v1","1432888","1433224","98","17769046"
"JH378138","19238905","19239110","KQ058339v1","5944070","5944289","57","13294835"
"JH378138","19544175","19544447","KQ053299v1","22323868","22324139","64","2779693"
"JH378138","19735069","19735335","KQ053993v1","1017100","1017367","75","18717969"
"JH378138","19825026","19825319","KQ054069v1","7687863","7688158","68","12137163"
"JH378138","19912071","19912366","KQ053631v1","7943206","7943503","69","11968865"
"JH378138","19918545","19918721","KQ055684v1","1008210","1008383","41","18910335"
"JH378138","19929758","19929906","KQ056147v1","2168964","2169108","34","17760794"
"JH378138","19947749","19948035","KQ053146v1","2819587","2819868","64","17128162"
"JH378138","20391392","20391684","KQ052969v1","9116808","9117108","71","11274584"
"JH378138","20402029","20402191","KQ056996v1","1524030","1524195","36","18877999"
"JH378138","20492949","20493218","KQ055662v1","4683524","4683789","67","15809425"
"JH378138","20657165","20657456","KQ053476v1","3712115","3712409","59","16945050"
"JH378139","41245","41515","KQ056035v1","1769934","1770210","75","1728689"
"JH378139","124590","124874","KQ057629v1","401877","402160","68","277287"
"JH378139","178012","178295","KQ053916v1","20061","20349","63","157951"
"JH378139","393753","394032","KQ053654v1","4803183","4803475","77","4409430"
"JH378139","669325","669561","KQ058572v1","5214095","5214349","60","4544770"
"JH378139","757428","757568","KQ053190v1","4771351","4771483","34","4013923"
"JH378139","874070","874357","KQ053409v1","3716306","3716585","63","2842236"
"JH378139","874390","874670","KQ057755v1","45985","46262","71","828405"
"JH378139","905193","905310","KQ057909v1","4153593","4153709","29","3248400"
"JH378139","905371","905454","KQ052968v1","9483686","9483763","27","8578315"
"JH378139","905584","905649","KQ053190v1","5979740","5979806","22","5074156"
"JH378139","1086527","1086820","KQ052984v1","105454","105757","65","981073"
"JH378139","1243334","1243502","KQ058328v1","3794482","3794646","39","2551148"
"JH378139","1415493","1415783","KQ055852v1","1231373","1231668","65","184120"
"JH378139","1444244","1444551","KQ053299v1","6038380","6038679","74","4594136"
"JH378139","1504828","1505060","KQ057223v1","124007","124258","65","1380821"
"JH378139","1588499","1588787","KQ053816v1","7464708","7465010","79","5876209"
"JH378139","1652059","1652294","KQ058539v1","875694","875928","68","776365"
"JH378139","1820001","1820293","KQ054135v1","2702098","2702381","68","882097"
"JH378139","1821914","1822116","KQ055162v1","650995","651207","47","1170919"
"JH378139","1852213","1852349","KQ053948v1","2765570","2765701","26","913357"
"JH378139","1873645","1873901","KQ056773v1","122800","123057","53","1750845"
"JH378139","1935282","1935633","KQ053398v1","4097175","4097499","116","2161893"
"JH378139","1945691","1945977","KQ053409v1","3716306","3716585","64","1770615"
"JH378139","1976712","1976900","KQ053332v1","848203","848389","48","1128509"
"JH378139","1992083","1992214","KQ057910v1","1548802","1548933","29","443281"
"JH378139","2023418","2023731","KQ058450v1","2960681","2960988","72","937263"
"JH378139","2183634","2183944","KQ053816v1","7464708","7465010","84","5281074"
"JH378139","2382853","2383134","KQ054565v1","6587941","6588226","76","4205088"
"JH378139","2603543","2603830","KQ053190v1","1299491","1299778","66","1304052"
"JH378139","2644880","2645183","KQ053398v1","2431232","2431537","69","213648"
"JH378139","2646737","2647020","KQ053146v1","2819587","2819868","68","172850"
"JH378139","2662272","2662581","KQ055787v1","1064992","1065293","67","1597280"
"JH378139","2730915","2731199","KQ054693v1","832788","833076","62","1898127"
"JH378139","2823095","2823228","KQ053354v1","702320","702452","26","2120775"
"JH378139","2893809","2894108","KQ058353v1","1264780","1265071","78","1629029"
"JH378139","2920348","2920655","KQ053554v1","2471177","2471484","69","449171"
"JH378139","2999501","2999804","KQ053299v1","4095914","4096215","66","1096413"
"JH378139","3294917","3295204","KQ054671v1","1712525","1712816","66","1582392"
"JH378139","3599290","3599474","KQ058394v1","10110818","10110995","49","6511528"
"JH378139","3661818","3662102","KQ054510v1","8251247","8251532","68","4589429"
"JH378139","3900384","3900692","KQ056404v1","176748","177054","72","3723636"
"JH378139","4152877","4153078","KQ054848v1","194460","194660","64","3958417"
"JH378139","4193007","4193149","KQ058394v1","9297282","9297394","48","5104275"
"JH378139","4289727","4289854","KQ055498v1","86970","87098","26","4202757"
"JH378139","4339987","4340292","KQ053299v1","21835674","21835971","72","17495687"
"JH378139","4354534","4354825","KQ053631v1","9631170","9631468","64","5276636"
"JH378139","4655097","4655391","KQ053631v1","9116387","9116675","74","4461290"
"JH378139","4763993","4764125","KQ057702v1","1862724","1862857","22","2901269"
"JH378139","4848077","4848271","KQ052968v1","1711014","1711208","42","3137063"
"JH378139","4857181","4857474","KQ053299v1","21835674","21835971","64","16978493"
"JH378139","4920288","4920450","KQ053916v1","1573932","1574091","44","3346356"
"JH378139","5093011","5093300","KQ058184v1","1505565","1505858","76","3587446"
"JH378139","5109029","5109192","KQ056996v1","1524030","1524195","38","3584999"
"JH378139","5207550","5207822","KQ053297v1","44026","44315","66","5163524"
"JH378139","5521819","5522105","KQ053785v1","2248190","2248465","79","3273629"
"JH378139","5879306","5879515","KQ054081v1","1002095","1002297","57","4877211"
"JH378139","6448334","6448621","KQ057649v1","81106","81383","77","6367228"
"JH378139","6498488","6498716","KQ054069v1","159011","159235","52","6339477"
"JH378139","6535046","6535323","KQ053740v1","2323389","2323680","79","4211657"
"JH378139","6553922","6554150","KQ055978v1","1055761","1055981","57","5498161"
"JH378139","6557498","6557771","KQ053146v1","2819587","2819868","61","3737911"
"JH378139","6558591","6558630","KQ056762v1","404433","404470","12","6154158"
"JH378139","6593652","6593906","KQ057223v1","124007","124258","60","6469645"
"JH378139","6626157","6626405","KQ058594v1","5720704","5720954","60","905453"
"JH378139","6640099","6640263","KQ056996v1","1524030","1524195","31","5116069"
"JH378139","6640747","6640876","KQ056663v1","464182","464321","33","6176565"
"JH378139","6869721","6870014","KQ052969v1","9116808","9117108","72","2247087"
"JH378139","7097046","7097181","KQ058257v1","652425","652556","23","6444621"
"JH378139","7236672","7236796","KQ054047v1","1054810","1054936","26","6181862"
"JH378139","7236815","7236903","KQ055872v1","5141445","5141541","21","2095370"
"JH378139","7423305","7423588","KQ053631v1","9963313","9963601","62","2540008"
"JH378139","7791507","7791756","KQ058503v1","123813","124064","63","7667694"
"JH378139","7872274","7872572","KQ058184v1","1505565","1505858","61","6366709"
"JH378139","8078490","8078624","KQ058281v1","1664150","1664292","31","6414340"
"JH378139","8279687","8279934","KQ055055v1","1882469","1882726","70","6397218"
"JH378139","9680480","9680765","KQ058183v1","487423","487710","60","9193057"
"JH378139","9755654","9755913","KQ053070v1","4206208","4206463","77","5549446"
"JH378139","10085055","10085269","KQ058572v1","913074","913293","56","9171981"
"JH378139","10133211","10133481","KQ058272v1","5963811","5964091","67","4169400"
"JH378139","10173638","10173928","KQ058582v1","1599482","1599782","75","8574156"
"JH378139","10209196","10209497","KQ053631v1","9116387","9116675","65","1092809"
"JH378139","10236737","10237013","KQ055529v1","748449","748724","74","9488288"
"JH378139","10271182","10271352","KQ056279v1","658086","658263","52","9613096"
"JH378139","10446402","10446660","KQ057702v1","1579642","1579892","60","8866760"
"JH378139","10476574","10476857","KQ053365v1","2996957","2997245","67","7479617"
"JH378139","10624147","10624240","KQ056414v1","256142","256232","26","10368005"
"JH378139","10624523","10624654","KQ054795v1","2377934","2378063","21","8246589"
"JH378139","10868497","10868792","ABDC02021259v1","71107","71404","56","10797390"
"JH378139","10894830","10895134","KQ056494v1","1990294","1990594","74","8904536"
"JH378139","10966815","10967092","KQ058561v1","4466656","4466945","65","6500159"
"JH378139","11000546","11000769","KQ058516v1","2391279","2391485","57","8609267"
"JH378139","11007666","11007975","KQ054213v1","780092","780393","68","10227574"
"JH378139","11040532","11040790","KQ057909v1","12421223","12421497","70","1380691"
"JH378139","11147851","11147993","KQ054682v1","606323","606472","36","10541528"
"JH378139","11293413","11293694","KQ056568v1","744517","744792","68","10548896"
"JH378139","12054103","12054374","KQ058004v1","1118282","1118550","90","10935821"
"JH378139","12206931","12207260","KQ054682v1","2237365","2237671","76","9969566"
"JH378139","12292007","12292319","KQ057848v1","1223262","1223564","69","11068745"
"JH378139","12477166","12477466","KQ058494v1","4784845","4785156","75","7692321"
"JH378139","12531178","12531476","KQ053816v1","7038123","7038425","65","5493055"
"JH378139","12587954","12588257","KQ055798v1","887234","887524","65","11700720"
"JH378139","12842128","12842374","KQ054576v1","657552","657814","80","12184576"
"JH378139","12902897","12903186","KQ058594v1","6070669","6070969","67","6832228"
"JH378139","12913623","12913918","KQ058427v1","4553509","4553777","74","8360114"
"JH378139","12921134","12921404","KQ054401v1","1444218","1444498","69","11476916"
"JH378139","12922595","12922782","KQ053294v1","648","849","54","12921947"
"JH378139","12924530","12924615","KQ054179v1","1673076","1673160","29","11251454"
"JH378139","12940550","12940855","KQ054191v1","3583730","3584032","78","9356820"
"JH378139","13060081","13060394","KQ053476v1","3959355","3959665","65","9100726"
"JH378139","13061988","13062264","KQ053816v1","5837219","5837503","70","7224769"
"JH378139","13078105","13078394","KQ054933v1","4854778","4855065","66","8223327"
"JH378139","13155451","13155733","KQ055247v1","216427","216708","75","12939024"
"JH378139","13218718","13218866","KQ054401v1","2342043","2342190","37","10876675"
"JH378139","13262716","13262805","KQ057737v1","356405","356487","16","12906311"
"JH378139","13263296","13263574","KQ055014v1","2491689","2491976","75","10771607"
"JH378139","13343659","13343972","KQ056928v1","1915686","1915996","75","11427973"
"JH378139","13491645","13491936","KQ053398v1","2545768","2546067","58","10945877"
"JH378139","13556210","13556503","KQ056672v1","3082150","3082439","63","10474060"
"JH378139","13689373","13689637","KQ055872v1","4839210","4839481","59","8850163"
"JH378139","13701097","13701231","KQ056147v1","1828259","1828388","28","11872838"
"JH378139","13758213","13758507","KQ058606v1","232956","233258","73","13525257"
"JH378139","13778650","13778820","KQ058305v1","820286","820452","43","12958364"
"JH378139","14012284","14012557","KQ055978v1","5278975","5279254","83","8733309"
"JH378139","14128976","14129248","KQ054179v1","4270912","4271203","77","9858064"
"JH378139","14259490","14259790","KQ057118v1","1749884","1750157","85","12509606"
"JH378139","14262921","14263223","KQ052970v1","10427454","10427754","78","3835467"
"JH378139","14478541","14478688","KQ054682v1","606323","606472","38","13872218"
"JH378139","14636389","14636551","KQ055425v1","1445594","1445758","28","13190795"
"JH378139","14689463","14689759","KQ052970v1","9813160","9813451","78","4876303"
"JH378139","14891403","14891697","KQ056456v1","918897","919186","68","13972506"
"JH378139","15206542","15206752","KQ055978v1","4257847","4258036","68","10948695"
"JH378139","15210106","15210250","KQ058640v1","122151","122286","36","15087955"
"JH378139","15448748","15449032","KQ056432v1","3123097","3123378","59","12325651"
"JH378139","16165762","16166052","KQ058328v1","6293951","6294242","62","9871811"
"JH378139","16169199","16169329","KQ056147v1","1828259","1828388","20","14340940"
"JH378139","16496412","16496754","KQ054191v1","3583730","3584032","90","12912682"
"JH378139","16574996","16575254","KQ053115v1","1101942","1102218","70","15473054"
"JH378139","16694362","16694672","KQ053299v1","4095914","4096215","62","12598448"
"JH378139","17104758","17104926","KQ056996v1","1524030","1524195","32","15580728"
"JH378139","17608922","17609222","KQ054466v1","2183618","2183917","64","15425304"
"JH378139","17972778","17972944","KQ053827v1","4961567","4961731","38","13011211"
"JH378139","17983845","17984142","KQ053115v1","1118362","1118655","76","16865483"
"JH378139","17990202","17990499","KQ055549v1","3431468","3431763","70","14558734"
"JH378139","18091180","18091258","KQ052968v1","6651946","6652022","28","11439234"
"JH378139","18092046","18092104","KQ054401v1","4683450","4683508","16","13408596"
"JH378139","18092109","18092423","KQ053299v1","4095914","4096215","75","13996195"
"JH378139","18105216","18105510","KQ056493v1","3974454","3974746","63","14130762"
"JH378139","18152784","18152954","KQ055457v1","11733685","11733859","29","6419099"
"JH378139","18220648","18220776","KQ054533v1","1111592","1111720","29","17109056"
"JH378139","18221724","18221787","KQ054943v1","3387644","3387704","21","14834080"
"JH378139","18484307","18484434","KQ053543v1","1868215","1868343","25","16616092"
"JH378139","18524338","18524561","KQ056148v1","3131043","3131264","61","15393295"
"JH378139","18595937","18596209","KQ058275v1","938649","938919","61","17657288"
"JH378139","18987456","18987757","KQ053025v1","180690","180990","68","18806766"
"JH378139","19457761","19458045","KQ056773v1","168010","168288","67","19289751"
"JH378139","19838960","19839255","KQ058184v1","1505565","1505858","73","18333395"
"JH378140","513016","513159","KQ058354v1","315739","315881","38","197277"
"JH378140","572001","572246","KQ058503v1","123813","124064","67","448188"
"JH378140","934844","934970","KQ053332v1","575690","575814","29","359154"
"JH378140","1202710","1202999","KQ057909v1","14641987","14642269","64","13439277"
"JH378140","1203842","1204155","KQ055468v1","2950644","2950940","68","1746802"
"JH378140","1243491","1243676","KQ055490v1","1751422","1751617","41","507931"
"JH378140","1982699","1982988","KQ053026v1","3680523","3680807","71","1697824"
"JH378140","2033364","2033547","KQ056855v1","3357892","3358081","51","1324528"
"JH378140","2958089","2958205","KQ058538v1","5682851","5682963","30","2724762"
"JH378140","3297679","3297954","KQ056200v1","188634","188917","77","3109045"
"JH378140","3941571","3941708","KQ054213v1","615112","615244","28","3326459"
"JH378140","4340166","4340316","KQ053916v1","1023573","1023722","32","3316593"
"JH378140","4352313","4352479","ABDC02051947v1","1","158","41","4352312"
"JH378140","4355106","4355194","KQ053598v1","1093587","1093662","25","3261519"
"JH378140","4410323","4410611","KQ055014v1","2491689","2491976","68","1918634"
"JH378140","4425281","4425572","KQ058184v1","1505565","1505858","66","2919716"
"JH378140","4471271","4471555","KQ052969v1","8840489","8840774","63","4369218"
"JH378140","4595430","4595721","KQ054510v1","8555095","8555387","57","3959665"
"JH378140","4684629","4684688","KQ054401v1","4683450","4683508","16","1179"
"JH378140","4711881","4712068","KQ055404v1","449593","449772","46","4262288"
"JH378140","4900478","4900778","KQ058184v1","1505565","1505858","70","3394913"
"JH378140","4927984","4928117","KQ057488v1","512192","512325","27","4415792"
"JH378140","5021309","5021608","KQ054412v1","2490468","2490761","58","2530841"
"JH378140","5137250","5137532","KQ054401v1","1704355","1704633","74","3432895"
"JH378140","5147531","5147814","KQ054765v1","2007143","2007428","71","3140388"
"JH378140","5329702","5329862","KQ057805v1","1792742","1792892","43","3536960"
"JH378140","5380658","5380953","KQ058328v1","4012912","4013206","70","1367746"
"JH378140","5397828","5398128","KQ053420v1","122023","122324","70","5275805"
"JH378140","5468857","5469150","KQ054456v1","4960954","4961242","60","507903"
"JH378140","5494880","5495048","KQ053883v1","6952953","6953124","39","1458073"
"JH378140","5535902","5536047","KQ052993v1","71964","72092","49","5463938"
"JH378140","5561745","5561988","KQ057291v1","322948","323180","63","5238797"
"JH378140","5665548","5665678","KQ053004v1","2961452","2961584","26","2704096"
"JH378140","5678378","5678663","KQ058266v1","1113469","1113760","67","4564909"
"JH378140","5850289","5850589","KQ055140v1","2495467","2495773","70","3354822"
"JH378140","5960942","5961263","KQ053554v1","2528691","2528989","77","3432251"
"JH378140","6121927","6122212","KQ058313v1","787059","787344","65","5334868"
"JH378140","6374774","6375077","KQ058184v1","1505565","1505858","65","4869209"
"JH378140","6578573","6578719","KQ054606v1","1683916","1684063","27","4894657"
"JH378140","6639046","6639309","KQ058328v1","2975933","2976189","63","3663113"
"JH378140","6662349","6662516","KQ055425v1","1445594","1445758","36","5216755"
"JH378140","6817045","6817345","KQ053297v1","44026","44315","64","6773019"
"JH378140","7092536","7092661","KQ056147v1","1828259","1828388","22","5264277"
"JH378140","7135176","7135441","KQ053354v1","2203019","2203291","70","4932157"
"JH378140","7218204","7218335","KQ053299v1","22459675","22459802","30","15241471"
"JH378140","8373478","8373635","KQ058328v1","3794482","3794646","36","4578996"
"JH378140","9205396","9205464","KQ054466v1","1769053","1769119","24","7436343"
"JH378140","9288385","9288608","KQ052969v1","1115877","1116104","70","8172508"
"JH378140","9314717","9314943","KQ055987v1","321281","321487","63","8993436"
"JH378140","9537604","9537899","KQ052968v1","13459203","13459489","71","3921599"
"JH378140","9712908","9713184","KQ055662v1","2337496","2337760","70","7375412"
"JH378140","9806848","9807165","KQ054921v1","1683019","1683324","75","8123829"
"JH378140","9955570","9955853","KQ053520v1","2992926","2993205","74","6962644"
"JH378140","9955906","9956220","KQ057737v1","5293792","5294097","79","4662114"
"JH378140","10010171","10010351","KQ057177v1","237647","237827","42","9772524"
"JH378140","10239685","10239905","KQ053609v1","2642121","2642332","67","7597564"
"JH378140","10330484","10330789","KQ053115v1","3485337","3485650","77","6845147"
"JH378140","10403323","10403606","KQ053752v1","285596","285880","70","10117727"
"JH378140","10734199","10734485","KQ054795v1","814924","815211","67","9919275"
"JH378140","10819997","10820235","KQ058094v1","6815572","6815819","83","4004425"
"JH378140","11169500","11169672","KQ055425v1","1445594","1445758","44","9723906"
"JH378140","11589675","11589974","KQ055173v1","248885","249169","93","11340790"
"JH378140","12570693","12570843","KQ053631v1","1260941","1261095","30","11309752"
"JH378140","12581606","12581758","KQ052968v1","10427732","10427888","34","2153874"
"JH378140","13020573","13020839","KQ055352v1","9449634","9449904","67","3570939"
"JH378140","13642179","13642371","KQ052968v1","1711014","1711208","48","11931165"
"JH378140","13748118","13748426","KQ053299v1","3823059","3823361","65","9925059"
"JH378140","14288232","14288530","KQ053223v1","2852845","2853123","67","11435387"
"JH378140","14409950","14410222","KQ058383v1","4690209","4690488","78","9719741"
"JH378140","14493322","14493409","KQ053827v1","2612475","2612564","21","11880847"
"JH378140","14548252","14548367","KQ053631v1","8539724","8539846","31","6008528"
"JH378140","14548425","14548512","KQ055375v1","747749","747826","31","13800676"
"JH378140","14646149","14646238","KQ058506v1","612587","612671","20","14033562"
"JH378140","14659994","14660319","KQ058316v1","3835362","3835700","78","10824632"
"JH378140","14871424","14871715","KQ055557v1","4628423","4628710","76","10243001"
"JH378140","14882962","14883256","KQ058184v1","1505565","1505858","81","13377397"
"JH378140","15384793","15385106","KQ056404v1","176748","177054","72","15208045"
"JH378140","15843406","15843491","KQ055755v1","1328874","1328956","26","14514532"
"JH378140","15843620","15843673","KQ053299v1","2592408","2592461","13","13251212"
"JH378140","15843960","15844102","KQ057118v1","2873589","2873730","32","12970371"
"JH378140","15865312","15865585","KQ054179v1","4865616","4865880","77","10999696"
"JH378140","15894810","15895036","KQ058250v1","905623","905852","67","14989187"
"JH378140","15917432","15917675","KQ054932v1","6362120","6362372","64","9555312"
"JH378140","15993623","15993778","KQ053643v1","1466202","1466359","36","14527421"
"JH378140","16062498","16062623","KQ053299v1","22459675","22459802","30","6397177"
"JH378140","16146792","16146930","KQ058640v1","122151","122286","34","16024641"
"JH378140","16183209","16183503","KQ058329v1","663480","663767","71","15519729"
"JH378140","16214111","16214299","KQ053763v1","5043851","5044035","57","11170260"
"JH378140","16274732","16275017","KQ054693v1","832788","833076","62","15441944"
"JH378140","16314783","16315055","KQ053993v1","1017100","1017367","72","15297683"
"JH378140","16443101","16443383","KQ058594v1","2023684","2023963","74","14419417"
"JH378140","16531512","16531820","KQ053135v1","3156167","3156481","76","13375345"
"JH378140","16798017","16798284","KQ055872v1","10113033","10113299","67","6684984"
"JH378140","16800438","16800714","KQ053146v1","2819587","2819868","57","13980851"
"JH378140","16966421","16966552","KQ058427v1","4756553","4756686","28","12209868"
"JH378140","17121394","17121665","KQ056331v1","106636","106916","67","17014758"
"JH378140","17128349","17128655","KQ053631v1","7288314","7288608","73","9840035"
"JH378140","17133434","17133707","KQ055735v1","667472","667747","68","16465962"
"JH378140","17273488","17273626","KQ057901v1","1218014","1218146","32","16055474"
"JH378140","17507750","17507910","KQ057291v1","765415","765578","39","16742335"
"JH378140","17515574","17515788","KQ052970v1","11415688","11415897","58","6099886"
"JH378140","17601584","17601844","KQ053894v1","688559","688830","72","16913025"
"JH378140","17653339","17653618","KQ054576v1","913010","913303","72","16740329"
"JH378140","18417905","18418213","KQ055629v1","4831189","4831479","72","13586716"
"JH378140","18499120","18499416","KQ052981v1","658787","659079","70","17840333"
"JH378140","18729893","18730032","KQ053850v1","820499","820643","38","17909394"
"JH378140","18730923","18731207","KQ057693v1","621833","622123","62","18109090"
"JH378141","401747","402020","KQ056597v1","1198358","1198607","73","796611"
"JH378141","719190","719482","KQ054682v1","2585084","2585382","75","1865894"
"JH378141","1006081","1006222","KQ055247v1","5533181","5533323","45","4527100"
"JH378141","1595434","1595548","KQ054091v1","1562507","1562616","36","32927"
"JH378141","2355088","2355376","KQ057004v1","1506143","1506432","67","848945"
"JH378141","2384389","2384518","KQ057649v1","141749","141881","21","2242640"
"JH378141","2420386","2420688","KQ053696v1","289251","289545","64","2131135"
"JH378141","2655307","2655468","KQ052968v1","10427732","10427888","38","7772425"
"JH378141","2702839","2703127","KQ055610v1","1837519","1837800","62","865320"
"JH378141","2788309","2788443","KQ052970v1","11857903","11858038","25","9069594"
"JH378141","2815481","2815642","KQ053202v1","830653","830812","53","1984828"
"JH378141","3090065","3090155","KQ052970v1","8775146","8775235","19","5685081"
"JH378141","3256814","3257075","KQ054289v1","4355551","4355817","83","1098737"
"JH378141","4273952","4274020","KQ056147v1","112501","112561","22","4161451"
"JH378141","4576507","4576706","KQ052970v1","7199437","7199628","51","2622930"
"JH378141","4643408","4643671","KQ053332v1","2579491","2579756","67","2063917"
"JH378141","4721005","4721324","KQ058250v1","878786","879087","74","3842219"
"JH378141","5050099","5050396","KQ054102v1","1325684","1325978","66","3724415"
"JH378141","5266899","5267093","KQ058462v1","452919","453117","51","4813980"
"JH378141","5361385","5361688","KQ054933v1","667391","667678","79","4693994"
"JH378141","5394634","5394766","KQ053432v1","3920706","3920835","25","1473928"
"JH378141","5686931","5687055","KQ053300v1","2607358","2607485","30","3079573"
"JH378141","5702883","5703159","KQ058383v1","5401358","5401623","68","301525"
"JH378141","5740669","5740971","KQ055247v1","895463","895756","73","4845206"
"JH378141","5831112","5831241","KQ056643v1","1491838","1491968","22","4339274"
"JH378141","6019297","6019585","KQ057737v1","5327168","5327456","71","692129"
"JH378141","6108764","6109070","KQ053070v1","257960","258260","63","5850804"
"JH378141","6144578","6144841","KQ055830v1","460576","460834","69","5684002"
"JH378141","6181409","6181632","KQ053093v1","1363144","1363361","60","4818265"
"JH378141","6321060","6321325","KQ055662v1","4683524","4683789","78","1637536"
"JH378141","6899080","6899145","KQ055458v1","1227920","1227985","15","5671160"
"JH378141","7064518","7064721","KQ053849v1","1126392","1126589","58","5938126"
"JH378141","7621814","7621957","KQ053190v1","2372433","2372579","27","5249381"
"JH378141","7623969","7624232","KQ057290v1","862441","862706","61","6761528"
"JH378141","7636317","7636626","KQ053409v1","7319546","7319849","69","316771"
"JH378141","7708446","7708732","KQ054412v1","2490468","2490761","65","5217978"
"JH378141","7826770","7826993","KQ053256v1","942460","942674","64","6884310"
"JH378141","7911600","7911866","KQ053310v1","2851403","2851646","75","5060197"
"JH378141","7923276","7923538","KQ057910v1","2540095","2540357","55","5383181"
"JH378141","8043956","8044240","KQ055247v1","1761880","1762166","73","6282076"
"JH378141","8390124","8390270","KQ053299v1","5209668","5209811","42","3180456"
"JH378141","8639239","8639542","KQ054533v1","288767","289055","73","8350472"
"JH378141","8959063","8959329","KQ056773v1","168010","168288","84","8791053"
"JH378141","9042075","9042196","KQ056035v1","296324","296444","28","8745751"
"JH378141","9105046","9105177","KQ053432v1","3920706","3920835","26","5184340"
"JH378141","9125064","9125206","KQ053212v1","578976","579120","27","8546088"
"JH378141","9140280","9140580","KQ056331v1","1886723","1887024","75","7253557"
"JH378141","9243822","9243977","KQ055498v1","556944","557105","47","8686878"
"JH378141","9358363","9358622","KQ058004v1","1118282","1118550","74","8240081"
"JH378141","9373133","9373249","KQ058350v1","1062787","1062904","25","8310346"
"JH378141","9374035","9374190","KQ055735v1","2321269","2321424","32","7052766"
"JH378141","9398335","9398629","KQ055777v1","2252512","2252796","76","7145823"
"JH378141","9411858","9412006","KQ053299v1","5209668","5209811","37","4202190"
"JH378141","9432066","9432360","KQ056035v1","309470","309760","75","9122596"
"JH378141","9460549","9460816","KQ058283v1","3525175","3525450","71","5935374"
"JH378141","9659307","9659461","KQ056148v1","7050287","7050441","31","2609020"
"JH378141","9698450","9698714","KQ054289v1","4355551","4355817","61","5342899"
"JH378141","9876920","9877064","KQ056540v1","511524","511659","47","9365396"
"JH378141","10008810","10009082","KQ054191v1","3785722","3786005","70","6223088"
"JH378141","10043245","10043316","KQ055893v1","2912845","2912909","18","7130400"
"JH378141","10097111","10097185","KQ053598v1","1093587","1093662","22","9003524"
"JH378141","10103645","10103798","KQ053300v1","3146249","3146389","33","6957396"
"JH378141","10240211","10240356","KQ054466v1","1866785","1866925","33","8373426"
"JH378141","10253901","10254126","KQ056465v1","72608","72828","57","10181293"
"JH378141","10517573","10517737","KQ058257v1","652425","652556","52","9865148"
"JH378141","10522748","10523041","KQ058572v1","3070725","3071013","75","7452023"
"JH378141","10574082","10574372","KQ053971v1","3610129","3610423","61","6963953"
"JH378141","10645796","10646120","KQ055457v1","2061137","2061448","80","8584659"
"JH378141","10648452","10648657","KQ058294v1","6170109","6170304","57","4478343"
"JH378141","10674173","10674470","KQ054660v1","1344918","1345204","71","9329255"
"JH378141","10688254","10688557","KQ058372v1","1134128","1134432","62","9554126"
"JH378141","10689433","10689608","KQ053288v1","1003387","1003559","34","9686046"
"JH378141","10744704","10744988","KQ058184v1","1505565","1505858","62","9239139"
"JH378141","10797998","10798148","KQ053072v1","221812","221965","34","10576186"
"JH378141","10819236","10819521","KQ058561v1","4466656","4466945","57","6352580"
"JH378141","10902831","10903099","KQ055893v1","2015012","2015285","66","8887819"
"JH378141","10912939","10913235","KQ054868v1","1584588","1584882","57","9328351"
"JH378141","10997275","10997578","KQ053741v1","1613413","1613703","73","9383862"
"JH378141","11128166","11128451","KQ052982v1","2466107","2466398","60","8662059"
"JH378141","11227977","11228270","KQ058328v1","7544499","7544779","63","3683478"
"JH378141","11246580","11246883","KQ054068v1","1099741","1100039","66","10146839"
"JH378141","11308245","11308554","KQ058184v1","1505565","1505858","59","9802680"
"JH378141","11311114","11311358","KQ055457v1","1008530","1008768","71","10302584"
"JH378141","11365387","11365675","KQ052970v1","12030199","12030491","70","664812"
"JH378141","11469697","11470004","KQ056447v1","2325318","2325624","65","9144379"
"JH378141","11480330","11480445","KQ058483v1","4711310","4711430","29","6769020"
"JH378141","11719586","11719892","KQ058317v1","5791740","5792039","75","5927846"
"JH378141","11887601","11887708","KQ053059v1","2351984","2352070","35","9535617"
"JH378141","12345490","12345796","KQ053300v1","2877663","2877955","74","9467827"
"JH378141","12349217","12349426","KQ053354v1","1104956","1105153","47","11244261"
"JH378141","12357385","12357682","KQ055468v1","2564339","2564635","69","9793046"
"JH378141","12380006","12380138","KQ053718v1","316226","316356","28","12063780"
"JH378141","12552447","12552504","KQ053696v1","870676","870725","18","11681771"
"JH378141","12552738","12552907","KQ055872v1","13212412","13212576","50","659674"
"JH378141","12561372","12561669","ABDC02054223v1","3152","3442","59","12558220"
"JH378141","12610684","12610976","KQ057693v1","621833","622123","57","11988851"
"JH378141","12615536","12615843","KQ053299v1","4095914","4096215","68","8519622"
"JH378141","12695787","12695879","KQ055872v1","5141445","5141541","23","7554342"
"JH378141","12774831","12775125","KQ052969v1","9553757","9554052","67","3221074"
"JH378141","12998420","12998730","KQ054525v1","45769","46078","80","12952651"
"JH378141","13010453","13010646","KQ053554v1","293392","293586","55","12717061"
"JH378141","13097807","13097864","KQ055108v1","2427889","2427943","14","10669918"
"JH378141","13124117","13124414","KQ054068v1","5134007","5134302","64","7990110"
"JH378141","13212249","13212540","KQ053093v1","3162517","3162806","72","10049732"
"JH378141","13352003","13352170","KQ056996v1","1524030","1524195","36","11827973"
"JH378141","13677854","13677982","KQ053081v1","1901531","1901659","39","11776323"
"JH378141","13765911","13766189","KQ056279v1","960352","960626","63","12805559"
"JH378141","13972741","13973040","KQ055097v1","1884579","1884874","75","12088162"
"JH378141","14037043","14037336","KQ058594v1","6070669","6070969","63","7966374"
"JH378141","14113387","14113658","KQ055725v1","1064759","1065040","72","13048628"
"JH378141","14121309","14121582","KQ058413v1","348155","348432","59","13773154"
"JH378141","14147115","14147404","KQ054660v1","1344918","1345204","62","12802197"
"JH378141","14205224","14205397","KQ058494v1","10142546","10142705","59","4062678"
"JH378141","14218963","14219135","KQ056672v1","5452932","5453100","45","8766031"
"JH378141","14270595","14270885","KQ057693v1","621833","622123","68","13648762"
"JH378141","14339166","14339298","KQ052970v1","12609564","12609700","25","1729602"
"JH378141","14345188","14345495","KQ056928v1","1915686","1915996","60","12429502"
"JH378141","14381339","14381642","KQ058427v1","7552507","7552810","70","6828832"
"JH378141","14424914","14425161","KQ055364v1","1832819","1833067","57","12592095"
"JH378141","14581831","14582071","KQ052970v1","6911341","6911564","76","7670490"
"JH378141","14646855","14647117","KQ055364v1","1515825","1516085","66","13131030"
"JH378141","14683766","14683896","KQ053861v1","8359","8490","24","14675407"
"JH378141","14835192","14835444","KQ054693v1","3245566","3245803","61","11589626"
"JH378141","14881257","14881539","KQ058413v1","348155","348432","61","14533102"
"JH378141","15094081","15094377","KQ058248v1","1222370","1222655","63","13871711"
"JH378141","15141867","15141958","KQ053763v1","508269","508363","21","14633598"
"JH378141","15142218","15142374","KQ054606v1","554177","554332","51","14588041"
"JH378141","15147050","15147367","KQ053631v1","5081194","5081497","72","10065856"
"JH378141","15216357","15216655","KQ055745v1","1895479","1895762","76","13320878"
"JH378141","15247093","15247390","KQ056147v1","152442","152732","69","15094651"
"JH378141","15381210","15381312","KQ053632v1","7771","7867","23","15373439"
"JH378141","15445325","15445440","KQ053223v1","119848","119963","30","15325477"
"JH378141","15446396","15446575","KQ056945v1","2675278","2675453","40","12771118"
"JH378141","15453161","15453446","KQ058607v1","429760","430048","65","15023401"
"JH378141","15625951","15626083","KQ053948v1","2765570","2765701","26","12860381"
"JH378141","15795954","15796159","KQ053115v1","1122961","1123171","54","14672993"
"JH378141","15871031","15871122","KQ054091v1","1379638","1379732","25","14491393"
"JH378141","16027148","16027358","KQ053398v1","3158290","3158500","47","12868858"
"JH378141","16048769","16049033","KQ054510v1","5210888","5211157","65","10837881"
"JH378141","16050399","16050515","KQ058050v1","918290","918400","32","15132109"
"JH378141","16063220","16063493","KQ058427v1","4553509","4553777","72","11509711"
"JH378141","16074486","16074656","KQ052969v1","10193825","10193991","34","5880661"
"JH378141","16404195","16404323","KQ053774v1","406836","406969","23","15997359"
"JH378141","16429088","16429335","KQ054933v1","935520","935770","59","15493568"
"JH378141","16538840","16539123","KQ058299v1","1080259","1080541","65","15458581"
"JH378141","16675465","16675734","KQ058594v1","2023684","2023963","72","14651781"
"JH378141","16770100","16770408","KQ055236v1","2049624","2049930","72","14720476"
"JH378141","16802062","16802376","KQ054786v1","934497","934799","69","15867565"
"JH378141","17200105","17200405","KQ053398v1","3445470","3445768","66","13754635"
"JH378141","17326840","17327141","KQ053297v1","44026","44315","73","17282814"
"JH378141","17385370","17385546","KQ053774v1","1982290","1982469","64","15403080"
"JH378141","17431541","17431667","KQ054932v1","7654347","7654470","38","9777194"
"JH378141","17483365","17483670","KQ055755v1","446339","446640","61","17037026"
"JH378141","17759553","17759855","KQ058184v1","1505565","1505858","56","16253988"
"JH378141","17894854","17894949","KQ056148v1","5019141","5019230","21","12875713"
"JH378141","17898637","17898931","KQ057858v1","376905","377209","63","17521732"
"JH378141","17906222","17906355","KQ053543v1","1868215","1868343","25","16038007"
"JH378141","17906435","17906594","KQ056672v1","5452932","5453100","50","12453503"
"JH378141","17975332","17975462","KQ053115v1","1650505","1650644","34","16324827"
"JH378141","18070315","18070445","KQ053948v1","2765570","2765701","24","15304745"
"JH378141","18201699","18201957","KQ055808v1","865533","865804","69","17336166"
"JH378141","18347089","18347264","KQ055872v1","11131397","11131559","39","7215692"
"JH378141","18403768","18404065","KQ054401v1","2629005","2629296","72","15774763"
"JH378141","18438406","18438644","KQ057291v1","322948","323180","47","18115458"
"JH378141","18444039","18444307","KQ055978v1","3656660","3656939","68","14787379"
"JH378141","18575557","18575843","KQ053398v1","11302","11591","71","18564255"
"JH378141","18658938","18659221","KQ058184v1","1505565","1505858","58","17153373"
"JH378141","18674528","18674674","KQ057118v1","1492016","1492164","30","17182512"
"JH378141","18721853","18722134","KQ056331v1","106636","106916","61","18615217"
"JH378141","18869124","18869257","KQ057883v1","1224468","1224597","22","17644656"
"JH378141","18903611","18903807","KQ052968v1","13131640","13131834","40","5771971"
"JH378141","18903988","18904109","KQ058383v1","8339612","8339728","29","10564376"
"JH378141","18930311","18930586","KQ053740v1","2323389","2323680","81","16606922"
"JH378141","18930607","18930878","KQ056855v1","2789429","2789717","78","16141178"
"JH378141","18968465","18968594","KQ058199v1","1560557","1560686","32","17407908"
"JH378141","19015173","19015454","KQ053905v1","3600529","3600809","72","15414644"
"JH378141","19055875","19056136","KQ053948v1","1892815","1893053","75","17163060"
"JH378141","19094394","19094688","KQ056093v1","1723775","1724065","64","17370619"
"JH378141","19098225","19098511","KQ052968v1","6282633","6282918","66","12815592"
"JH378141","19200349","19200537","KQ058427v1","6736144","6736323","49","12464205"
"JH378141","19237596","19237887","KQ058316v1","1400358","1400649","75","17837238"
"JH378142","84331","84623","KQ054389v1","1065530","1065798","71","981199"
"JH378142","89762","89924","KQ053223v1","2815634","2815800","38","2725872"
"JH378142","94699","94817","KQ058328v1","2150165","2150287","24","2055466"
"JH378142","105085","105250","KQ057737v1","1426090","1426247","32","1321005"
"JH378142","125790","126091","KQ057290v1","2953971","2954265","65","2828181"
"JH378142","201473","201622","KQ058350v1","10883513","10883668","38","10682040"
"JH378142","216456","216726","KQ058184v1","1608105","1608378","72","1391649"
"JH378142","317470","317783","KQ053070v1","4380102","4380392","102","4062632"
"JH378142","611584","611791","KQ056375v1","1153881","1154077","65","542297"
"JH378142","630958","631261","KQ053816v1","7464708","7465010","47","6833750"
"JH378142","646311","646584","KQ054756v1","440195","440459","66","206116"
"JH378142","676535","676826","KQ058542v1","552861","553154","73","123674"
"JH378142","930868","930961","KQ053048v1","2691541","2691623","19","1760673"
"JH378142","971107","971205","KQ053816v1","6703101","6703179","36","5731994"
"JH378142","984503","984763","KQ058538v1","1444447","1444703","66","459944"
"JH378142","1270094","1270234","KQ057875v1","315120","315258","33","954974"
"JH378142","1299926","1300235","KQ055352v1","4400544","4400843","76","3100618"
"JH378142","1390318","1390456","KQ057488v1","512192","512325","21","878126"
"JH378142","1694638","1694803","KQ054660v1","3592730","3592895","49","1898092"
"JH378142","1695187","1695309","KQ058383v1","7248131","7248254","26","5552944"
"JH378142","1738875","1739093","KQ053741v1","1190544","1190756","49","548331"
"JH378142","1767789","1768072","KQ053190v1","5322744","5323031","64","3554955"
"JH378142","1770928","1771222","KQ058372v1","1134128","1134432","62","636800"
"JH378142","1771772","1772069","KQ058550v1","2374575","2374877","63","602803"
"JH378142","1792950","1793247","KQ058184v1","1505565","1505858","73","287385"
"JH378142","1865660","1865820","KQ054565v1","627778","627936","33","1237882"
"JH378142","1988627","1988902","KQ053476v1","3998036","3998311","68","2009409"
"JH378142","2564714","2565028","KQ055457v1","9231252","9231546","81","6666538"
"JH378142","2587157","2587439","KQ055140v1","2748912","2749194","60","161755"
"JH378142","2639733","2640011","KQ054401v1","3177756","3178031","67","538023"
"JH378142","2659366","2659514","KQ053157v1","7874292","7874430","42","5214926"
"JH378142","2664230","2664541","KQ058266v1","898592","898893","73","1765638"
"JH378142","2669561","2669869","KQ054068v1","5074639","5074944","61","2405078"
"JH378142","2678940","2679247","KQ058585v1","580456","580763","71","2098484"
"JH378142","2685023","2685316","KQ058184v1","1505565","1505858","64","1179458"
"JH378142","2685341","2685599","KQ054857v1","757347","757593","72","1927994"
"JH378142","2711777","2712074","KQ053093v1","3162517","3162806","75","450740"
"JH378142","2727107","2727418","KQ053299v1","4095914","4096215","75","1368807"
"JH378142","2727724","2727900","KQ056672v1","5452932","5453100","41","2725208"
"JH378142","2773772","2774078","KQ054068v1","5491779","5492087","85","2718007"
"JH378142","2808877","2809004","KQ053409v1","6105325","6105446","23","3296448"
"JH378142","2839985","2840210","KQ058004v1","2720169","2720394","49","119816"
"JH378142","2841723","2841808","KQ052969v1","10606705","10606802","30","7764982"
"JH378142","2842360","2842535","KQ056587v1","7602017","7602187","49","4759657"
"JH378142","2857031","2857184","KQ057737v1","1426090","1426247","33","1430941"
"JH378142","2873724","2873935","KQ057431v1","2411902","2412116","56","461822"
"JH378142","2902943","2903218","KQ053059v1","2387120","2387415","74","515823"
"JH378142","3008152","3008454","KQ052969v1","9116808","9117108","71","6108656"
"JH378142","3009543","3009654","KQ053191v1","1086674","1086785","28","1922869"
"JH378142","3133901","3134040","KQ055406v1","2968","3106","26","3130933"
"JH378142","3164227","3164500","KQ056643v1","431969","432259","60","2732258"
"JH378142","3185943","3186254","KQ057495v1","815665","815977","68","2370278"
"JH378142","3622789","3623024","KQ053487v1","3972854","3973080","63","350065"
"JH378142","3821436","3821741","KQ054932v1","4699407","4699723","66","877971"
"JH378142","3965935","3966037","KQ053157v1","203721","203827","27","3762214"
"JH378142","4453377","4453685","KQ053398v1","3762214","3762511","89","691163"
"JH378142","4839105","4839383","KQ053409v1","7074418","7074709","73","2235313"
"JH378142","5259689","5259988","KQ054857v1","921177","921473","60","4338512"
"JH378142","5711049","5711298","KQ058503v1","123813","124064","69","5587236"
"JH378142","6043325","6043680","KQ055777v1","2071501","2071828","96","3971824"
"JH378142","6097483","6097659","KQ058272v1","3944046","3944208","43","2153437"
"JH378142","6160648","6160960","KQ053398v1","4280241","4280537","70","1880407"
"JH378142","6393227","6393313","KQ055872v1","5141445","5141541","27","1251782"
"JH378142","6410779","6411074","KQ057404v1","478884","479180","70","5931895"
"JH378142","6448796","6449093","KQ054868v1","473451","473739","74","5975345"
"JH378142","6463513","6463793","KQ058317v1","5506620","5506904","69","956893"
"JH378142","6490906","6491071","KQ055425v1","1445594","1445758","31","5045312"
"JH378142","6514815","6515098","KQ055414v1","149964","150226","81","6364851"
"JH378142","6546474","6546744","KQ054091v1","962150","962426","71","5584324"
"JH378142","6589136","6589437","KQ053044v1","405596","405892","66","6183540"
"JH378142","6630292","6630580","KQ055957v1","1731327","1731617","61","4898965"
"JH378142","6635013","6635315","KQ058184v1","1505565","1505858","67","5129448"
"JH378142","6706927","6707226","KQ055036v1","1508392","1508683","82","5198535"
"JH378142","7278568","7278856","KQ055352v1","4204310","4204606","82","3074258"
"JH378142","7812668","7812978","KQ054533v1","288767","289055","81","7523901"
"JH378142","7874171","7874475","KQ058490v1","420741","421044","68","7453430"
"JH378142","7910593","7910876","KQ053104v1","3864277","3864560","66","4046316"
"JH378142","7974879","7975033","KQ058316v1","1612479","1612626","38","6362400"
"JH378142","8054545","8054785","KQ053894v1","688559","688830","71","7365986"
"JH378142","8365840","8366064","KQ058255v1","233892","234115","55","8131948"
"JH378142","8589029","8589322","KQ054693v1","1429670","1429955","65","7159359"
"JH378142","8711677","8711902","KQ054704v1","483937","484161","54","8227740"
"JH378142","8848257","8848551","KQ058184v1","1505565","1505858","67","7342692"
"JH378142","8901984","8902261","KQ058275v1","938649","938919","62","7963335"
"JH378142","9062028","9062313","KQ058353v1","1264780","1265071","61","7797248"
"JH378142","9256519","9256777","KQ057223v1","124007","124258","63","9132512"
"JH378142","9393050","9393336","KQ058248v1","1222370","1222655","61","8170680"
"JH378142","9426143","9426451","KQ058372v1","1134128","1134432","60","8292015"
"JH378142","9486877","9487174","KQ058299v1","988637","988944","71","8498240"
"JH378142","9621735","9622044","KQ057702v1","1237368","1237672","83","8384367"
"JH378142","9884642","9884803","KQ055425v1","1445594","1445758","37","8439048"
"JH378142","10216619","10216723","KQ058320v1","1383713","1383812","27","8832906"
"JH378142","10429081","10429238","KQ053299v1","22920975","22921141","43","12491894"
"JH378142","10571809","10571915","KQ056320v1","135977","136085","35","10435832"
"JH378142","10601986","10602294","KQ058299v1","988637","988944","80","9613349"
"JH378142","10607285","10607583","KQ058313v1","660634","660924","73","9946651"
"JH378142","10872517","10872769","KQ057649v1","54936","55173","74","10817581"
"JH378142","10963933","10964158","KQ052969v1","10670889","10671116","62","293044"
"JH378142","11176374","11176645","KQ058350v1","10250287","10250561","69","926087"
"JH378142","11460067","11460350","KQ055141v1","254262","254544","57","11205805"
"JH378142","11504354","11504668","KQ053299v1","4095914","4096215","74","7408440"
"JH378142","11855759","11856089","KQ058184v1","1505565","1505858","85","10350194"
"JH378142","12453644","12453929","KQ052970v1","8520800","8521088","69","3932844"
"JH378142","12477794","12477965","KQ056643v1","1174972","1175125","48","11302822"
"JH378142","12538554","12538807","KQ053872v1","539000","539247","66","11999554"
"JH378142","12655015","12655316","KQ053816v1","7464708","7465010","60","5190307"
"JH378142","12705858","12706150","KQ055872v1","4131960","4132231","76","8573898"
"JH378142","12770835","12771099","KQ058291v1","474599","474881","66","12296236"
"JH378142","12872730","12872998","KQ056643v1","159950","160228","61","12712780"
"JH378142","12952096","12952134","KQ057909v1","13231474","13231525","15","279378"
"JH378142","13089949","13090120","KQ054168v1","1100368","1100517","42","11989581"
"JH378142","13110695","13110991","KQ058184v1","1505565","1505858","53","11605130"
"JH378142","13256259","13256464","KQ057065v1","226","423","60","13256033"
"JH378142","13257244","13257345","KQ053223v1","2552349","2552442","30","10704895"
"JH378142","13373829","13374128","KQ058184v1","1505565","1505858","59","11868264"
"JH378142","13540054","13540196","KQ057118v1","2873589","2873730","25","10666465"
"JH378142","13831920","13832128","KQ053740v1","1109410","1109606","59","12722510"
"JH378142","13845052","13845355","KQ058272v1","6007682","6007982","67","7837370"
"JH378142","13988080","13988385","KQ055236v1","2049624","2049930","60","11938456"
"JH378142","13991408","13991682","KQ057755v1","45985","46262","65","13945423"
"JH378142","14008413","14008707","KQ056331v1","1501968","1502262","70","12506445"
"JH378142","14259752","14259880","KQ053409v1","6105325","6105446","25","8154427"
"JH378142","14383683","14383843","KQ055872v1","14332561","14332707","43","51122"
"JH378142","14442656","14442872","KQ054921v1","3806549","3806756","57","10636107"
"JH378142","14483593","14483753","KQ058316v1","1612479","1612626","40","12871114"
"JH378142","14484445","14484530","KQ053223v1","2552349","2552442","26","11932096"
"JH378142","15001683","15001978","KQ053365v1","2996957","2997245","74","12004726"
"JH378142","15188959","15189250","KQ054412v1","2490468","2490761","62","12698491"
"JH378142","15224432","15224689","KQ053498v1","3849819","3850073","65","11374613"
"JH378142","15278221","15278485","KQ056773v1","122800","123057","62","15155421"
"JH378142","15386357","15386679","KQ058427v1","11577834","11578154","73","3808523"
"JH378142","15389692","15389939","KQ053310v1","2851403","2851646","77","12538289"
"JH378142","15594325","15594517","KQ055119v1","1040353","1040537","50","14553972"
"JH378142","15866817","15867094","KQ057290v1","534242","534517","78","15332575"
"JH378142","16221289","16221591","KQ058283v1","622348","622657","71","15598941"
"JH378142","16287904","16288223","KQ054693v1","2010555","2010863","76","14277349"
"JH378142","16457915","16458166","KQ053332v1","813051","813309","79","15644864"
"JH378142","16596348","16596509","KQ053696v1","3211004","3211170","36","13385344"
"JH378142","16822788","16823070","KQ056432v1","1593337","1593624","69","15229451"
"JH378142","16858913","16859047","KQ053654v1","4929533","4929667","27","11929380"
"JH378142","16924152","16924422","KQ054713v1","3140905","3141166","70","13783247"
"JH378142","17196162","17196443","KQ053146v1","2819587","2819868","61","14376575"
"JH378142","17457403","17457690","KQ053093v1","1361295","1361576","75","16096108"
"JH378142","17528143","17528427","KQ058389v1","550849","551129","77","16977294"
"JH378142","17634524","17634689","KQ057737v1","1426090","1426247","37","16208434"
"JH378142","18020198","18020481","KQ056673v1","174628","174922","68","17845570"
"JH378142","18027492","18027792","KQ053146v1","2819587","2819868","82","15207905"
"JH378142","18414255","18414463","KQ053223v1","773388","773584","57","17640867"
"JH378142","18655124","18655381","KQ058450v1","2367943","2368207","64","16287181"
"JH378142","18719558","18719846","KQ058184v1","1505565","1505858","68","17213993"
"JH378142","18732068","18732353","KQ054868v1","1584588","1584882","64","17147480"
"JH378142","18827970","18828239","KQ054301v1","3391378","3391638","67","15436592"
"JH378142","18836428","18836712","KQ054932v1","10830322","10830609","66","8006106"
"JH378142","19077436","19077718","KQ058184v1","1505565","1505858","53","17571871"
"JH378142","19123810","19124080","KQ056234v1","975878","976150","60","18147932"
"JH378143","179922","180107","KQ053554v1","293392","293586","52","113470"
"JH378143","519925","520101","KQ053179v1","1735404","1735576","46","1215479"
"JH378143","555694","556002","KQ058305v1","3899980","3900272","83","3344286"
"JH378143","667970","668205","KQ054725v1","1394675","1394915","77","726705"
"JH378143","707346","707423","KQ053082v1","7408393","7408474","18","6701047"
"JH378143","805115","805345","KQ058537v1","27912","28129","73","777203"
"JH378143","888208","888353","KQ053081v1","7678221","7678366","28","6790013"
"JH378143","889015","889105","KQ053223v1","2552349","2552442","20","1663334"
"JH378143","971902","971978","KQ052968v1","9483686","9483763","27","8511784"
"JH378143","1179906","1180193","KQ053763v1","141096","141389","66","1038810"
"JH378143","1789487","1789631","KQ053146v1","2315136","2315281","34","525649"
"JH378143","1904545","1904834","KQ057693v1","117172","117472","73","1787373"
"JH378143","2006132","2006387","KQ056147v1","2120177","2120443","80","114045"
"JH378143","2073069","2073369","KQ058594v1","6070669","6070969","70","3997600"
"JH378143","2088536","2088845","KQ058255v1","511287","511596","73","1577249"
"JH378143","2110584","2110850","KQ055183v1","3184785","3185031","79","1074201"
"JH378143","2308758","2309046","KQ053267v1","3500174","3500463","65","1191416"
"JH378143","3685620","3685929","KQ055457v1","6534446","6534755","72","2848826"
"JH378143","3742223","3742308","KQ053565v1","3764807","3764898","28","22584"
"JH378143","3742451","3742678","KQ053299v1","4478737","4478951","63","736286"
"JH378143","3803835","3803949","KQ054932v1","9608222","9608338","24","5804387"
"JH378143","3829072","3829234","KQ057649v1","424252","424417","41","3404820"
"JH378143","3900604","3900904","KQ053643v1","1564697","1564988","76","2335907"
"JH378143","3917794","3917928","KQ053190v1","2372433","2372579","40","1545361"
"JH378143","3947627","3947913","KQ053115v1","1118362","1118655","63","2829265"
"JH378143","4009862","4010117","KQ053740v1","548757","549009","65","3461105"
"JH378143","4053871","4054019","KQ053234v1","993607","993754","39","3060264"
"JH378143","4054652","4054948","KQ058394v1","215643","215934","76","3839009"
"JH378143","4140816","4141104","KQ055490v1","2107132","2107421","69","2033684"
"JH378143","4244616","4244931","KQ057560v1","1548733","1549024","79","2695883"
"JH378143","4493460","4493742","KQ058004v1","4701579","4701856","72","208119"
"JH378143","4692603","4692673","KQ057664v1","404566","404648","24","4288037"
"JH378143","4692712","4692950","KQ057909v1","12196801","12197037","65","7504089"
"JH378143","4717034","4717166","KQ053718v1","316226","316356","23","4400808"
"JH378143","4930589","4930856","KQ056920v1","346245","346510","66","4584344"
"JH378143","5191885","5192156","KQ057693v1","584920","585198","74","4606965"
"JH378143","5255268","5255541","KQ054826v1","9969237","9969502","84","4713969"
"JH378143","5586839","5587006","KQ057603v1","1535538","1535702","35","4051301"
"JH378143","5663578","5663872","KQ052968v1","7300500","7300792","61","1636922"
"JH378143","5707728","5708031","KQ056672v1","6393431","6393732","73","685703"
"JH378143","5939258","5939565","KQ054401v1","2629005","2629296","79","3310253"
"JH378143","6151584","6151729","KQ055735v1","2321269","2321424","35","3830315"
"JH378143","6302629","6302912","KQ055872v1","12987862","12988141","59","6685233"
"JH378143","6326644","6326783","KQ058394v1","2902727","2902859","44","3423917"
"JH378143","6382546","6382844","KQ055978v1","3588191","3588491","73","2794355"
"JH378143","6413467","6413760","KQ058184v1","1505565","1505858","62","4907902"
"JH378143","6521941","6522231","KQ058184v1","1505565","1505858","70","5016376"
"JH378143","6569311","6569589","KQ053631v1","6524455","6524734","64","44856"
"JH378143","6799065","6799189","KQ053696v1","3287264","3287380","41","3511801"
"JH378143","6940262","6940478","KQ055375v1","2261003","2261228","55","4679259"
"JH378143","7023984","7024167","KQ053234v1","293386","293576","58","6730598"
"JH378143","7032824","7033109","KQ058272v1","5443874","5444159","53","1588950"
"JH378143","7077647","7077884","KQ053487v1","3972854","3973080","58","3104793"
"JH378143","7079188","7079498","KQ053476v1","3959355","3959665","68","3119833"
"JH378143","7274648","7274945","KQ053299v1","21835674","21835971","66","14561026"
"JH378143","7399019","7399312","KQ053190v1","5623449","5623748","63","1775570"
"JH378143","7464752","7464840","KQ055152v1","1163688","1163781","24","6301064"
"JH378143","7700540","7700792","KQ052971v1","6441372","6441626","58","1259168"
"JH378143","7769149","7769420","ABDC02049955v1","1118","1378","68","7768031"
"JH378143","7837994","7838300","KQ054069v1","7687863","7688158","66","150131"
"JH378143","7866705","7866960","KQ054932v1","7706438","7706707","78","160267"
"JH378143","8025276","8025521","KQ053310v1","2851403","2851646","57","5173873"
"JH378143","8095726","8095991","KQ053894v1","688559","688830","69","7407167"
"JH378143","8201161","8201418","KQ058389v1","2110988","2111239","70","6090173"
"JH378143","8365008","8365309","KQ054412v1","2490468","2490761","66","5874540"
"JH378143","8412513","8412805","KQ053212v1","1560173","1560471","68","6852340"
"JH378143","8572227","8572451","KQ053982v1","2652830","2653054","59","5919397"
"JH378143","8601618","8601767","KQ053146v1","2315136","2315281","36","6286482"
"JH378143","8634325","8634454","KQ057397v1","624142","624276","27","8010183"
"JH378143","8640112","8640237","KQ058510v1","411991","412116","24","8228121"
"JH378143","8651344","8651642","KQ054693v1","832788","833076","70","7818556"
"JH378143","8744534","8744685","ABDC02029150v1","2120","2268","31","8742414"
"JH378143","8802112","8802359","KQ053795v1","121444","121694","66","8680668"
"JH378143","8821008","8821216","KQ053398v1","3158290","3158500","58","5662718"
"JH378143","8854136","8854441","KQ058184v1","1505565","1505858","77","7348571"
"JH378143","8860872","8861160","KQ053476v1","2781917","2782207","67","6078955"
"JH378143","8884056","8884358","KQ058428v1","2055160","2055453","71","6828896"
"JH378143","9107837","9107949","KQ053026v1","2376723","2376841","31","6731114"
"JH378143","9207683","9207843","KQ058571v1","931737","931906","34","8275946"
"JH378143","9375237","9375509","KQ052968v1","14043756","14044036","65","4668519"
"JH378143","9456411","9456690","KQ058316v1","4697990","4698273","55","4758421"
"JH378143","9512254","9512513","KQ056920v1","346245","346510","69","9166009"
"JH378143","9692321","9692597","KQ053795v1","370451","370712","75","9321870"
"JH378143","10737692","10738010","KQ053816v1","7464708","7465010","72","3272984"
"JH378143","11025179","11025385","KQ054682v1","822940","823121","61","10202239"
"JH378143","11025885","11026154","KQ052970v1","7374072","7374342","64","3651813"
"JH378143","11373367","11373651","KQ055468v1","1908448","1908731","67","9464919"
"JH378143","11416365","11416658","KQ058184v1","1505565","1505858","70","9910800"
"JH378143","11605992","11606289","KQ057702v1","1237368","1237672","77","10368624"
"JH378143","11705443","11705708","KQ058348v1","989193","989444","62","10716250"
"JH378143","13183618","13183864","KQ058328v1","2569266","2569497","56","10614352"
"JH378143","13204113","13204405","KQ058428v1","2055160","2055453","59","11148953"
"JH378143","13388009","13388262","KQ058383v1","6512538","6512791","74","6875471"
"JH378143","13532180","13532470","KQ054412v1","2490468","2490761","71","11041712"
"JH378143","13727737","13727935","KQ054682v1","2378995","2379170","62","11348742"
"JH378143","13738688","13738991","KQ053816v1","7327018","7327317","66","6411670"
"JH378143","13764693","13764944","KQ058627v1","3341899","3342143","59","10422794"
"JH378143","13779827","13780097","KQ056225v1","171484","171758","65","13608343"
"JH378143","13792756","13792917","KQ058050v1","578571","578732","32","13214185"
"JH378143","13936414","13936629","KQ054704v1","483937","484161","52","13452477"
"JH378143","14646158","14646341","KQ058394v1","10197833","10198006","50","4448325"
"JH378143","15028268","15028599","KQ056475v1","2179070","2179363","94","12849198"
"JH378143","15551489","15551785","KQ057290v1","1053741","1054027","83","14497748"
"JH378143","15640040","15640348","KQ053082v1","7379147","7379444","82","8260893"
"JH378143","15656886","15657115","KQ057291v1","322948","323180","68","15333938"
"JH378143","15739323","15739443","KQ054179v1","3865170","3865294","21","11874153"
"JH378143","16074176","16074461","KQ056587v1","5696001","5696305","95","10378175"
"JH378143","16537848","16538144","KQ058004v1","3883150","3883446","78","12654698"
"JH378143","16733249","16733445","KQ057380v1","3384921","3385115","56","13348328"
"JH378143","17777733","17777890","KQ057308v1","82917","83077","44","17694816"
"JH378143","17886640","17886771","KQ052970v1","11857903","11858038","31","6028737"
"JH378143","18016370","18016458","KQ055152v1","1163688","1163781","29","16852682"
"JH378143","18023800","18024067","KQ054510v1","5210888","5211157","79","12812912"
"JH378144","305840","306127","KQ056672v1","3082150","3082439","73","2776310"
"JH378144","332407","332698","KQ058190v1","350088","350375","71","17681"
"JH378144","619979","620110","KQ053191v1","655494","655627","26","35515"
"JH378144","743597","743655","KQ058316v1","5629786","5629842","15","4886189"
"JH378144","1259173","1259302","KQ053916v1","2379880","2380005","32","1120707"
"JH378144","1337969","1338091","KQ058550v1","4939754","4939880","45","3601785"
"JH378144","1378757","1378887","KQ056673v1","833514","833652","29","545243"
"JH378144","1662809","1662962","KQ055589v1","815","963","45","1661994"
"JH378144","2418007","2418291","KQ054660v1","1344918","1345204","74","1073089"
"JH378144","3329236","3329367","KQ053849v1","2576503","2576633","24","752733"
"JH378144","3622320","3622632","KQ053432v1","4280053","4280348","78","657733"
"JH378144","3769538","3769817","KQ053432v1","4280053","4280348","81","510515"
"JH378144","3962919","3963044","KQ054412v1","2196456","2196568","39","1766463"
"JH378144","4173607","4173911","KQ054466v1","2183618","2183917","69","1989989"
"JH378144","4315945","4316233","KQ054932v1","3846859","3847131","75","469086"
"JH378144","4330863","4331026","KQ055978v1","2949687","2949843","38","1381176"
"JH378144","4378710","4378793","KQ058483v1","6093039","6093121","24","1714329"
"JH378144","4379238","4379353","KQ053310v1","1622751","1622859","40","2756487"
"JH378144","4492000","4492306","KQ053432v1","7885304","7885597","83","3393304"
"JH378144","4538648","4538948","KQ055893v1","1276515","1276814","67","3262133"
"JH378144","4643199","4643492","KQ054510v1","8555095","8555387","62","3911896"
"JH378144","4670659","4670772","KQ053631v1","8860661","8860759","33","4190002"
"JH378144","4835597","4835878","KQ056147v1","1747366","1747648","59","3088231"
"JH378144","4962044","4962330","KQ058248v1","1222370","1222655","65","3739674"
"JH378144","5084068","5084375","KQ058184v1","1505565","1505858","65","3578503"
"JH378144","5178253","5178350","KQ055384v1","267995","268089","22","4910258"
"JH378144","5208202","5208514","KQ056587v1","6691978","6692271","67","1483776"
"JH378144","5514865","5515149","KQ054660v1","4800585","4800872","68","714280"
"JH378144","5550143","5550309","KQ058183v1","3213511","3213674","42","2336632"
"JH378144","5597320","5597634","KQ053420v1","122023","122324","65","5475297"
"JH378144","5740685","5740976","KQ053959v1","3147888","3148185","72","2592797"
"JH378144","5949476","5949749","KQ056790v1","446564","446855","78","5502912"
"JH378144","6021086","6021369","KQ058004v1","1480411","1480689","65","4540675"
"JH378144","6101533","6101622","KQ053223v1","2552349","2552442","20","3549184"
"JH378144","6102107","6102328","KQ053070v1","378761","378970","56","5723346"
"JH378144","6203063","6203372","KQ054693v1","2010555","2010863","63","4192508"
"JH378144","6470500","6470552","KQ053072v1","197621","197681","17","6272879"
"JH378144","6471026","6471244","KQ058410v1","1161849","1162066","59","5309177"
"JH378144","6495163","6495448","KQ053343v1","1729289","1729583","70","4765874"
"JH378144","6847118","6847364","KQ053299v1","7690856","7691089","76","843738"
"JH378144","6934598","6934875","KQ057118v1","4601602","4601894","73","2332996"
"JH378144","6970176","6970455","KQ053115v1","394728","395016","69","6575448"
"JH378144","7239548","7239742","KQ057659v1","440","634","53","7239108"
"JH378144","7253142","7253434","KQ054400v1","820241","820532","73","6432901"
"JH378144","7437225","7437511","KQ052968v1","14043756","14044036","67","6606531"
"JH378144","7494567","7494857","KQ058184v1","1505565","1505858","74","5989002"
"JH378144","7515167","7515451","KQ053190v1","4987885","4988162","60","2527282"
"JH378144","7549988","7550102","KQ058350v1","1062787","1062904","29","6487201"
"JH378144","7550470","7550642","KQ054510v1","8888528","8888700","43","1338058"
"JH378144","7588143","7588449","KQ054704v1","215433","215738","70","7372710"
"JH378144","7630294","7630598","KQ053332v1","554962","555258","78","7075332"
"JH378144","7635601","7635861","KQ055662v1","4683524","4683789","58","2952077"
"JH378144","7684406","7684581","KQ056672v1","5452932","5453100","42","2231474"
"JH378144","7700783","7701064","KQ054704v1","985921","986190","53","6714862"
"JH378144","7782168","7782322","KQ053631v1","1260941","1261095","42","6521227"
"JH378144","7938366","7938603","KQ057488v1","132259","132504","73","7806107"
"JH378144","8153342","8153466","KQ056527v1","169","285","26","8153173"
"JH378144","8168262","8168561","KQ057747v1","1657451","1657754","74","6510811"
"JH378144","8451843","8451964","KQ053299v1","11744958","11745084","30","3293115"
"JH378144","8475803","8476094","KQ052968v1","4142140","4142422","65","4333663"
"JH378144","8549172","8549463","KQ058594v1","5996843","5997124","76","2552329"
"JH378144","8653851","8653986","KQ053409v1","6573923","6574054","27","2079928"
"JH378144","8755729","8755786","KQ055140v1","2522004","2522048","20","6233725"
"JH378144","8756070","8756203","KQ058394v1","13692702","13692834","25","4936632"
"JH378144","8796306","8796411","KQ053883v1","4947576","4947690","27","3848730"
"JH378144","8826649","8826940","KQ052981v1","1456424","1456719","70","7370225"
"JH378144","9026206","9026493","KQ057560v1","2450216","2450512","66","6575990"
"JH378144","9474430","9474565","KQ053115v1","1650505","1650644","32","7823925"
"JH378144","9488006","9488143","KQ054179v1","3927334","3927468","25","5560672"
"JH378144","9785907","9786190","KQ053299v1","21835674","21835971","67","12049767"
"JH378144","10106353","10106652","KQ053740v1","2323389","2323680","68","7782964"
"JH378144","10110060","10110349","KQ053288v1","2756106","2756392","67","7353954"
"JH378144","10206839","10207071","KQ053007v1","595933","596153","59","9610906"
"JH378144","10353343","10353635","KQ055140v1","2748912","2749194","74","7604431"
"JH378144","10437288","10437586","KQ058184v1","1505565","1505858","63","8931723"
"JH378144","10440630","10440934","KQ053816v1","7038123","7038425","66","3402507"
"JH378144","10495225","10495511","KQ054693v1","832788","833076","60","9662437"
"JH378144","10536073","10536372","KQ053465v1","3806004","3806288","68","6730069"
"JH378144","10654717","10655007","KQ053631v1","7288314","7288608","64","3366403"
"JH378144","10677111","10677442","KQ056447v1","4582175","4582468","106","6094936"
"JH378144","10682670","10682958","KQ055468v1","1908448","1908731","64","8774222"
"JH378144","10927117","10927304","KQ058394v1","10110818","10110995","42","816299"
"JH378144","10988409","10988709","KQ058316v1","6456357","6456653","68","4532052"
"JH378144","11171042","11171313","KQ057129v1","1786","2062","70","11169256"
"JH378144","11636056","11636189","KQ055872v1","4808828","4808960","23","6827228"
"JH378144","11939795","11940091","KQ056672v1","3535300","3535593","66","8404495"
"JH378144","12297331","12297533","KQ054776v1","1314982","1315182","59","10982349"
"JH378144","12349385","12349624","KQ054932v1","6362120","6362372","73","5987265"
"JH378144","12380177","12380341","KQ055140v1","1129098","1129272","44","11251079"
"JH378144","12488867","12489123","KQ054510v1","8112428","8112664","75","4376439"
"JH378144","12841787","12842097","KQ053696v1","4752560","4752868","67","8089227"
"JH378144","12845610","12845730","KQ054660v1","5437047","5437165","25","7408563"
"JH378144","12973686","12973814","KQ054179v1","3865170","3865294","22","9108516"
"JH378144","13059929","13060270","KQ053035v1","112316","112619","97","12947613"
"JH378144","13067618","13067906","KQ053093v1","1361295","1361576","77","11706323"
"JH378144","13089380","13089564","KQ053398v1","1237447","1237622","51","11851933"
"JH378144","13149609","13149904","KQ053763v1","3936916","3937207","77","9212693"
"JH378144","13244266","13244562","KQ053398v1","3445470","3445768","80","9798796"
"JH378144","13301184","13301491","KQ055852v1","1231373","1231668","81","12069811"
"JH378144","13306907","13307185","KQ055140v1","2748912","2749194","68","10557995"
"JH378144","13789023","13789333","KQ054682v1","2125705","2126015","68","11663318"
"JH378144","13828016","13828306","KQ053763v1","3936916","3937207","71","9891100"
"JH378144","13855733","13855998","KQ055872v1","4131960","4132231","74","9723773"
"JH378144","13981356","13981660","KQ053288v1","2218996","2219287","67","11762360"
"JH378144","14187832","14187984","KQ054196v1","237","387","36","14187595"
"JH378144","14198773","14199080","KQ055352v1","13451535","13451828","69","747238"
"JH378144","14472801","14473090","KQ053093v1","3162517","3162806","67","11310284"
"JH378144","14520403","14520556","KQ057205v1","1386607","1386765","42","13133796"
"JH378144","14583362","14583651","KQ053948v1","168940","169229","71","14414422"
"JH378144","14621041","14621339","KQ058004v1","2495177","2495491","69","12125864"
"JH378144","14778687","14778831","KQ057488v1","512192","512325","31","14266495"
"JH378144","14864190","14864352","KQ058539v1","1340326","1340487","38","13523864"
"JH378144","14940880","14941240","KQ056673v1","1004724","1005090","108","13936156"
"JH378144","14979755","14979904","KQ054378v1","157932","158074","39","14821823"
"JH378144","14992268","14992478","KQ052968v1","4264501","4264717","47","10727767"
"JH378144","15134168","15134266","KQ054932v1","4252125","4252214","24","10882043"
"JH378144","15422402","15422631","KQ056762v1","1558119","1558341","52","13864283"
"JH378144","15520113","15520270","KQ055589v1","815","963","47","15519298"
"JH378144","15648734","15648975","KQ058250v1","905623","905852","65","14743111"
"JH378144","15651852","15652102","KQ052970v1","2715607","2715860","63","12936245"
"JH378144","15716459","15716752","KQ057909v1","3829378","3829677","60","11887081"
"JH378144","15804269","15804480","KQ058505v1","3952082","3952290","47","11852187"
"JH378144","15829565","15829692","KQ053354v1","702320","702452","31","15127245"
"JH378144","15857426","15857718","KQ055557v1","4063555","4063849","72","11793871"
"JH378144","15892767","15892972","KQ058445v1","325619","325833","57","15567148"
"JH378144","15910642","15910768","KQ055518v1","2390890","2391006","41","13519752"
"JH378144","16101657","16102000","KQ058328v1","581761","582080","96","15519896"
"JH378144","16111756","16112042","KQ058272v1","5443874","5444159","65","10667882"
"JH378144","16122883","16123009","KQ058280v1","21417","21542","20","16101466"
"JH378144","16362015","16362318","KQ058184v1","1505565","1505858","65","14856450"
"JH378144","16370829","16371117","KQ057737v1","5327168","5327456","75","11043661"
"JH378144","16376450","16376612","KQ055518v1","2431373","2431535","41","13945077"
"JH378144","16382318","16382627","KQ058316v1","2150959","2151268","74","14231359"
"JH378144","16602160","16602432","KQ055364v1","1515825","1516085","60","15086335"
"JH378144","16866890","16867216","KQ054932v1","9683849","9684160","87","7183041"
"JH378144","17006498","17006743","KQ057345v1","1938824","1939073","70","15067674"
"JH378144","17203694","17204007","KQ055352v1","5244823","5245128","72","11958871"
"JH378144","17268337","17268628","KQ053332v1","447571","447853","62","16820766"
"JH378144","17353489","17353654","KQ055014v1","682174","682339","44","16671315"
"JH378144","17392945","17393045","KQ053059v1","2351984","2352070","23","15040961"
"JH378144","17400493","17400620","KQ054693v1","2971330","2971463","30","14429163"
"JH378144","17538743","17538902","KQ053795v1","588026","588179","42","16950717"
"JH378144","17587319","17587596","KQ054068v1","2000305","2000565","74","15587014"
"JH378144","17704378","17704681","KQ058313v1","1804900","1805199","70","15899478"
"JH378144","17787681","17787900","KQ053609v1","2642121","2642332","49","15145560"
"JH378144","17863483","17863676","KQ055457v1","1904386","1904585","47","15959097"
"JH378144","17914546","17914685","KQ055406v1","2968","3106","23","17911578"
"JH378144","17972615","17972929","KQ058550v1","3068705","3069008","66","14903910"
"JH378144","17976073","17976387","KQ058550v1","3068705","3069008","66","14907368"
"JH378144","18010943","18011085","KQ058394v1","13692702","13692834","30","4318241"
"JH378144","18084181","18084458","KQ058283v1","3525175","3525450","77","14559006"
"JH378144","18103040","18103345","KQ054068v1","1885845","1886123","91","16217195"
"JH378144","18292889","18293125","KQ053718v1","2663788","2664010","71","15629101"
"JH378145","225780","226043","KQ053082v1","6710764","6711025","73","6484984"
"JH378145","269004","269241","KQ058050v1","910717","910957","77","641713"
"JH378145","289851","290020","KQ057649v1","424252","424417","33","134401"
"JH378145","320491","320768","KQ053959v1","6189151","6189431","67","5868660"
"JH378145","379808","380002","KQ052968v1","1711014","1711208","42","1331206"
"JH378145","403727","403888","KQ056996v1","1524030","1524195","31","1120303"
"JH378145","489475","489750","KQ052968v1","14043756","14044036","65","13554281"
"JH378145","591276","591571","KQ058215v1","1617451","1617752","75","1026175"
"JH378145","997724","997999","KQ053959v1","6189151","6189431","69","5191427"
"JH378145","1216762","1217052","KQ053948v1","168940","169229","65","1047822"
"JH378145","1244456","1244609","KQ055425v1","1445594","1445758","44","201138"
"JH378145","2023137","2023423","KQ052971v1","841846","842131","62","1181291"
"JH378145","2194209","2194361","KQ054606v1","1683916","1684063","31","510293"
"JH378145","2548295","2548593","KQ058594v1","6070669","6070969","63","3522374"
"JH378145","2553420","2553727","KQ053332v1","771022","771332","77","1782398"
"JH378145","3085078","3085296","KQ053398v1","3158290","3158500","51","73212"
"JH378145","3116490","3116763","KQ052969v1","10404297","10404571","66","7287807"
"JH378145","3465806","3466084","KQ058405v1","697304","697560","76","2768502"
"JH378145","3925224","3925502","KQ055808v1","115144","115414","81","3810080"
"JH378145","4226455","4226750","KQ054804v1","964015","964313","63","3262440"
"JH378145","4352356","4352658","KQ053816v1","7464708","7465010","75","3112352"
"JH378145","4768268","4768434","KQ057336v1","635116","635282","38","4133152"
"JH378145","4809349","4809631","KQ055004v1","410084","410350","74","4399265"
"JH378145","5046013","5046295","KQ056432v1","1785478","1785754","62","3260535"
"JH378145","5308765","5309069","KQ054400v1","2708310","2708610","80","2600455"
"JH378145","5897921","5898220","KQ054682v1","1577967","1578262","71","4319954"
"JH378145","6200227","6200516","KQ053816v1","7327018","7327317","71","1126791"
"JH378145","6211092","6211347","KQ058405v1","697304","697560","68","5513788"
"JH378145","6264274","6264406","KQ052968v1","7374720","7374851","31","1110446"
"JH378145","6271397","6271540","KQ054179v1","903137","903278","44","5368260"
"JH378145","6316526","6316663","KQ055406v1","2968","3106","24","6313558"
"JH378145","6365830","6366132","KQ054786v1","934497","934799","76","5431333"
"JH378145","6461660","6461814","KQ053916v1","1573932","1574091","38","4887728"
"JH378145","6491944","6492241","KQ054191v1","3857584","3857880","62","2634360"
"JH378145","6691354","6691649","KQ053059v1","2112049","2112344","79","4579305"
"JH378145","6728106","6728432","KQ054555v1","1591338","1591641","90","5136768"
"JH378145","6752827","6752937","KQ054323v1","1973428","1973538","30","4779399"
"JH378145","6752951","6753079","KQ054047v1","1054810","1054936","26","5698141"
"JH378145","7124698","7124987","KQ053059v1","4903374","4903666","82","2221324"
"JH378145","7540327","7540603","KQ053465v1","403029","403303","71","7137298"
"JH378145","8674284","8674574","KQ053894v1","688559","688830","75","7985725"
"JH378145","9090212","9090441","KQ054704v1","483937","484161","69","8606275"
"JH378145","9124708","9124839","KQ053849v1","2576503","2576633","21","6548205"
"JH378145","9378268","9378574","KQ058474v1","218695","218994","69","9159573"
"JH378145","9422204","9422468","KQ056035v1","1236900","1237146","65","8185304"
"JH378145","9833972","9834134","KQ055425v1","1445594","1445758","33","8388378"
"JH378145","10014784","10014924","KQ055375v1","281063","281205","31","9733721"
"JH378145","10068264","10068551","KQ056973v1","783590","783885","68","9284674"
"JH378145","10153599","10153911","KQ053631v1","7288314","7288608","81","2865285"
"JH378145","10208410","10208498","KQ054994v1","3559925","3560015","26","6648485"
"JH378145","10227754","10228052","KQ055662v1","456935","457225","68","9770819"
"JH378145","10329974","10330262","KQ056973v1","783590","783885","76","9546384"
"JH378145","10408703","10409003","KQ053398v1","4862357","4862665","73","5546346"
"JH378145","10462641","10462813","KQ053202v1","830653","830812","46","9631988"
"JH378145","10537450","10537582","KQ056147v1","2896905","2897037","25","7640545"
"JH378145","10719812","10719944","KQ053234v1","993607","993754","38","9726205"
"JH378145","10752609","10752904","KQ054725v1","2218271","2218569","75","8534338"
"JH378145","10863652","10863947","KQ055457v1","9231252","9231546","77","1632400"
"JH378145","10894320","10894607","KQ053288v1","2218996","2219287","54","8675324"
"JH378145","10957626","10957761","KQ058542v1","584943","585090","34","10372683"
"JH378145","10971191","10971463","KQ058317v1","5506620","5506904","62","5464571"
"JH378145","11221280","11221590","KQ055457v1","2061137","2061448","72","9160143"
"JH378145","11867126","11867427","KQ053476v1","1823610","1823912","86","10043516"
"JH378145","12801389","12801640","KQ053387v1","564882","565122","63","12236507"
"JH378145","13821670","13821954","KQ058427v1","4553509","4553777","74","9268161"
"JH378145","15080739","15081059","KQ053212v1","2732847","2733131","98","12347892"
"JH378145","15664348","15664482","KQ055914v1","886489","886615","28","14777859"
"JH378145","16055082","16055231","KQ054954v1","3590829","3590969","50","12464253"
"JH378145","16358120","16358399","KQ053146v1","2819587","2819868","64","13538533"
"JH378145","16477620","16477906","KQ053554v1","1157184","1157483","70","15320436"
"JH378145","17380255","17380536","KQ058249v1","184192","184468","63","17196063"
"JH378146","17344","17529","KQ055404v1","449593","449772","48","432249"
"JH378146","32547","32832","KQ053565v1","754705","754987","62","722158"
"JH378146","101460","101754","KQ055872v1","2360857","2361124","91","2259397"
"JH378146","144916","145046","KQ058305v1","4820083","4820218","33","4675167"
"JH378146","145302","145578","KQ055140v1","2493739","2494024","61","2348437"
"JH378146","152520","152787","KQ053146v1","2819587","2819868","69","2667067"
"JH378146","567820","567975","KQ055014v1","682174","682339","44","114354"
"JH378146","749309","749441","KQ053432v1","5514393","5514523","36","4765084"
"JH378146","778893","779182","KQ058428v1","1609842","1610139","60","830949"
"JH378146","872626","872748","KQ056235v1","1268887","1269018","29","396261"
"JH378146","872776","872873","KQ053598v1","1093587","1093662","40","220811"
"JH378146","887199","887332","KQ053376v1","388499","388628","30","498700"
"JH378146","970812","970862","KQ054279v1","852960","853011","11","117852"
"JH378146","1157848","1158144","KQ058184v1","1505565","1505858","66","347717"
"JH378146","1199364","1199657","KQ057045v1","590946","591241","63","608418"
"JH378146","1700285","1700491","KQ058594v1","5040769","5040972","60","3340484"
"JH378146","1726534","1726810","KQ054932v1","2493764","2494041","58","767230"
"JH378146","1861565","1861918","ABDC02046171v1","544","925","127","1861021"
"JH378146","2008541","2008635","KQ053299v1","14559361","14559465","31","12550820"
"JH378146","2233299","2233441","KQ053037v1","3255963","3256108","31","1022664"
"JH378146","2407830","2408006","KQ056996v1","1524030","1524195","36","883800"
"JH378146","2427633","2427851","KQ055872v1","13252975","13253189","68","10825342"
"JH378146","2443572","2443861","KQ058183v1","487423","487710","72","1956149"
"JH378146","2482611","2482761","KQ052970v1","12418764","12418905","43","9936153"
"JH378146","2496227","2496507","KQ054069v1","937520","937812","66","1558707"
"JH378146","2545530","2545763","KQ057205v1","1814477","1814692","69","731053"
"JH378146","3384137","3384409","KQ053190v1","2950123","2950400","62","434014"
"JH378146","3409423","3409703","KQ058291v1","474599","474881","61","2934824"
"JH378146","3809778","3810066","KQ056587v1","9000240","9000528","65","5190462"
"JH378146","3856002","3856295","KQ058313v1","660634","660924","71","3195368"
"JH378146","4412250","4412372","KQ054068v1","3785962","3786083","28","626288"
"JH378146","4457787","4457911","KQ056361v1","2241193","2241324","29","2216594"
"JH378146","5014444","5014742","KQ054412v1","1824448","1824730","69","3189996"
"JH378146","5032535","5032842","KQ054389v1","2169070","2169367","73","2863465"
"JH378146","5042836","5042964","KQ056147v1","1828259","1828388","22","3214577"
"JH378146","5043107","5043257","KQ053498v1","3548759","3548906","36","1494348"
"JH378146","5310275","5310506","KQ058328v1","2569266","2569497","47","2741009"
"JH378146","5314221","5314523","KQ052969v1","9116808","9117108","67","3802587"
"JH378146","5597246","5597534","KQ055490v1","2107132","2107421","69","3490114"
"JH378146","5639675","5639972","KQ054412v1","2490468","2490761","67","3149207"
"JH378146","5726135","5726274","KQ058527v1","842675","842817","41","4883460"
"JH378146","5819645","5819883","KQ057291v1","322948","323180","54","5496697"
"JH378146","5915500","5915661","KQ053004v1","4759784","4759947","38","1155716"
"JH378146","6122608","6122913","KQ057875v1","404539","404839","70","5718069"
"JH378146","6169369","6169651","KQ055353v1","1973943","1974227","64","4195426"
"JH378146","6249252","6249541","KQ055036v1","1508392","1508683","68","4740860"
"JH378146","6270903","6271034","KQ058094v1","3687022","3687155","23","2583881"
"JH378146","6407424","6407710","KQ058516v1","2978478","2978774","78","3428946"
"JH378146","6490306","6490616","KQ053620v1","156684","156991","82","6333622"
"JH378146","6725891","6726027","KQ056147v1","1828259","1828388","42","4897632"
"JH378146","8498174","8498466","KQ054412v1","2490468","2490761","63","6007706"
"JH378146","8511212","8511352","KQ058405v1","1518051","1518190","37","6993161"
"JH378146","8696559","8696850","KQ058184v1","1505565","1505858","71","7190994"
"JH378146","9030744","9031038","KQ053288v1","2218996","2219287","74","6811748"
"JH378146","9383672","9383967","KQ057693v1","621833","622123","62","8761839"
"JH378146","9438539","9438824","KQ054533v1","288767","289055","75","9149772"
"JH378146","9451053","9451314","KQ054124v1","2442155","2442433","69","7008898"
"JH378146","9555308","9555634","KQ055457v1","2061137","2061448","86","7494171"
"JH378146","9581901","9582043","KQ052993v1","71964","72092","40","9509937"
"JH378146","9597693","9598001","KQ058184v1","1505565","1505858","74","8092128"
"JH378146","9647717","9647849","KQ057118v1","2873589","2873730","37","6774128"
"JH378146","9660607","9660911","KQ058585v1","580456","580763","74","9080151"
"JH378146","9787123","9787357","KQ053104v1","390620","390851","71","9396503"
"JH378146","9829958","9830257","KQ053554v1","1157184","1157483","67","8672774"
"JH378146","10051692","10051968","KQ057603v1","1306760","1307030","63","8744932"
"JH378146","10112370","10112634","KQ058394v1","3915274","3915538","65","6197096"
"JH378146","10135163","10135451","KQ054069v1","955693","955974","66","9179470"
"JH378146","10142308","10142586","KQ053135v1","6132160","6132437","65","4010148"
"JH378146","10207401","10207482","KQ058280v1","649966","650041","31","9557435"
"JH378146","10216906","10217174","KQ053520v1","4344405","4344670","77","5872501"
"JH378146","10338584","10338726","KQ057764v1","1022073","1022218","35","9316511"
"JH378146","10375812","10376072","KQ054068v1","2000305","2000565","58","8375507"
"JH378146","10436045","10436235","KQ055404v1","3762645","3762830","45","6673400"
"JH378146","10462718","10462875","KQ053741v1","1690943","1691088","33","8771775"
"JH378146","11480790","11481098","KQ053135v1","3156167","3156481","69","8324623"
"JH378146","11885678","11885962","KQ056928v1","2303396","2303675","69","9582282"
"JH378146","12235228","12235512","KQ055735v1","667472","667747","86","11567756"
"JH378146","12600049","12600354","KQ053816v1","7327018","7327317","82","5273031"
"JH378146","13367227","13367515","KQ053631v1","7288314","7288608","70","6078913"
"JH378146","13428338","13428631","KQ058328v1","6293951","6294242","65","7134387"
"JH378146","13685233","13685505","KQ056375v1","1886765","1887053","79","11798468"
"JH378146","14211209","14211499","KQ053465v1","167701","167983","75","14043508"
"JH378146","14420377","14420687","KQ058184v1","1505565","1505858","65","12914812"
"JH378146","14657708","14657932","KQ053267v1","2807850","2808092","64","11849858"
"JH378146","14995542","14995774","KQ055457v1","1008530","1008768","51","13987012"
"JH378146","15257670","15257717","KQ053299v1","2602841","2602888","14","12654829"
"JH378146","15387136","15387222","KQ058253v1","973922","974008","26","14413214"
"JH378146","15392185","15392469","KQ053631v1","9116387","9116675","66","6275798"
"JH378146","15711169","15711443","KQ056643v1","730062","730338","73","14981107"
"JH378146","15714218","15714403","KQ053948v1","2270313","2270496","51","13443905"
"JH378146","15887373","15887642","KQ054826v1","9969237","9969502","64","5918136"
"JH378146","16188413","16188736","KQ056432v1","3338517","3338841","73","12849896"
"JH378146","16207864","16208170","KQ052984v1","105454","105757","75","16102410"
"JH378146","16258422","16258587","KQ053190v1","5197561","5197720","38","11060861"
"JH378146","16961343","16961619","KQ053454v1","817557","817829","70","16143786"
"JH378146","17043784","17043874","KQ054994v1","3559925","3560015","28","13483859"
"JH378146","17056160","17056467","KQ053299v1","3137460","3137763","77","13918700"
"JH378146","17222261","17222546","KQ057909v1","5234200","5234480","73","11988061"
"JH378146","17580695","17580920","KQ055162v1","650995","651207","63","16929700"
"JH378146","17625764","17625917","KQ052970v1","12418764","12418905","37","5207000"
"JH378146","17662605","17662911","KQ058184v1","1505565","1505858","70","16157040"
"JH378147","198040","198389","KQ053498v1","4701656","4701994","114","4503616"
"JH378147","328084","328370","KQ053190v1","4987885","4988162","72","4659801"
"JH378147","414231","414531","KQ058315v1","658193","658490","70","243962"
"JH378147","456395","456620","KQ053741v1","1190544","1190756","70","734149"
"JH378147","518642","518939","KQ053082v1","857394","857690","84","338752"
"JH378147","527454","527747","KQ056035v1","288185","288466","86","239269"
"JH378147","550896","551163","KQ053643v1","2469250","2469508","84","1918354"
"JH378147","656503","656717","KQ058445v1","325619","325833","57","330884"
"JH378147","706650","706805","KQ057737v1","1426090","1426247","35","719440"
"JH378147","1128976","1129176","KQ052969v1","8528994","8529192","65","7400018"
"JH378147","1682092","1682222","KQ054412v1","2185013","2185160","34","502921"
"JH378147","2092583","2092861","KQ053278v1","106295","106592","80","1986288"
"JH378147","2179746","2180016","KQ055978v1","3560415","3560681","74","1380669"
"JH378147","2911261","2911540","KQ053894v1","688559","688830","71","2222702"
"JH378147","3186392","3186560","KQ054412v1","2471643","2471804","45","714749"
"JH378147","3505949","3506085","KQ054301v1","3483833","3483964","28","22116"
"JH378147","3564579","3564852","ABDC02003384v1","193955","194231","73","3370624"
"JH378147","3882440","3882738","KQ056386v1","2566293","2566591","80","1316147"
"JH378147","3969151","3969421","KQ054868v1","2229582","2229854","70","1739569"
"JH378147","3992021","3992324","KQ053816v1","7327018","7327317","71","3334997"
"JH378147","4443356","4443559","KQ053135v1","2336123","2336324","56","2107233"
"JH378147","4855323","4855608","KQ056354v1","419020","419303","72","4436303"
"JH378147","5303390","5303531","KQ058583v1","3719424","3719557","43","1583966"
"JH378147","5303759","5303878","KQ056147v1","1962111","1962234","33","3341648"
"JH378147","5340968","5341124","KQ053234v1","993607","993754","43","4347361"
"JH378147","5735904","5736051","KQ056279v1","763953","764097","48","4971951"
"JH378147","6079339","6079635","KQ053093v1","3162517","3162806","79","2916822"
"JH378147","6207584","6207738","KQ054412v1","2185013","2185160","38","4022571"
"JH378147","6290454","6290705","KQ057560v1","1236972","1237228","76","5053482"
"JH378147","6984866","6985156","KQ056643v1","431969","432259","67","6552897"
"JH378147","7088784","7088916","KQ053654v1","4929533","4929667","33","2159251"
"JH378147","8019153","8019438","KQ053696v1","325593","325885","66","7693560"
"JH378147","8100698","8100992","KQ053816v1","5837219","5837503","96","2263479"
"JH378147","8354550","8354741","KQ053948v1","3061823","3062004","62","5292727"
"JH378147","8626667","8626951","KQ058094v1","3646770","3647052","73","4979897"
"JH378147","8940637","8940799","KQ057737v1","1426090","1426247","39","7514547"
"JH378147","8957954","8958191","KQ058274v1","391536","391765","58","8566418"
"JH378147","9384065","9384368","KQ058305v1","2335011","2335313","68","7049054"
"JH378147","9575826","9576103","KQ056587v1","1312432","1312709","66","8263394"
"JH378147","9619415","9619517","KQ054510v1","2127300","2127398","39","7492115"
"JH378147","9619716","9619883","KQ055014v1","15960","16127","47","9603756"
"JH378147","9700040","9700153","KQ053170v1","242066","242183","28","9457974"
"JH378147","9700728","9700884","KQ057737v1","1426090","1426247","39","8274638"
"JH378147","10055747","10056021","KQ058184v1","1505565","1505858","82","8550182"
"JH378147","10427493","10427773","KQ058317v1","5506620","5506904","76","4920873"
"JH378147","10825329","10825599","KQ053454v1","649600","649875","74","10175729"
"JH378147","11207792","11208099","KQ058452v1","757762","758043","80","10450030"
"JH378147","11345526","11345821","KQ054068v1","3341291","3341579","65","8004235"
"JH378147","11572684","11572946","KQ054826v1","9969237","9969502","77","1603447"
"JH378147","11831466","11831778","KQ058450v1","2960681","2960988","69","8870785"
"JH378147","11898190","11898494","KQ055173v1","452351","452623","82","11445839"
"JH378147","11909738","11910039","KQ058184v1","1505565","1505858","68","10404173"
"JH378147","11937942","11938078","KQ054301v1","3207509","3207646","44","8730433"
"JH378147","11944315","11944628","KQ053343v1","1747702","1748011","74","10196613"
"JH378147","11966091","11966403","KQ053190v1","6566399","6566709","67","5399692"
"JH378147","11974402","11974563","KQ053082v1","5736615","5736775","33","6237787"
"JH378147","12241462","12241743","KQ053631v1","6524455","6524734","71","5717007"
"JH378147","12585378","12585559","KQ053115v1","4093406","4093574","46","8491972"
"JH378147","12876082","12876208","KQ054279v1","76889","77022","32","12799193"
"JH378147","13260067","13260336","KQ054124v1","2442155","2442433","64","10817912"
"JH378147","13330183","13330478","KQ054069v1","955693","955974","76","12374490"
"JH378147","13346769","13347017","KQ053310v1","2851403","2851646","63","10495366"
"JH378147","13375709","13375853","KQ053948v1","2765570","2765701","39","10610139"
"JH378147","13935237","13935525","KQ055852v1","1231373","1231668","68","12703864"
"JH378147","14232020","14232181","KQ055490v1","2065440","2065590","39","12166580"
"JH378147","14423288","14423568","KQ054745v1","163102","163377","72","14260186"
"JH378147","14532474","14532766","KQ054401v1","2629005","2629296","71","11903469"
"JH378147","14668890","14669100","KQ058595v1","117016","117224","81","14551874"
"JH378147","14731402","14731658","KQ054682v1","1212844","1213102","72","13518558"
"JH378147","15006848","15007144","KQ053554v1","1157184","1157483","64","13849664"
"JH378147","15089781","15090079","KQ055872v1","2402427","2402732","67","12687354"
"JH378147","15245853","15246003","KQ052970v1","12418764","12418905","32","2827089"
"JH378147","15439421","15439566","KQ053190v1","2372433","2372579","33","13066988"
"JH378147","15511866","15512127","KQ053070v1","4206208","4206463","70","11305658"
"JH378147","15569331","15569652","KQ058572v1","1453592","1453891","73","14115739"
"JH378147","15580573","15580702","KQ055258v1","3274072","3274190","43","12306501"
"JH378147","15592955","15593257","KQ055490v1","2107132","2107421","75","13485823"
"JH378147","15658151","15658250","KQ054323v1","1898058","1898154","18","13760093"
"JH378147","15732100","15732212","KQ053609v1","1892948","1893072","23","13839152"
"JH378147","15732636","15732781","KQ056568v1","798477","798603","36","14934159"
"JH378147","15734689","15734972","KQ053631v1","7288314","7288608","71","8446375"
"JH378147","15746651","15746854","KQ058242v1","892038","892246","47","14854613"
"JH378147","15759882","15760180","KQ055352v1","4072477","4072766","66","11687405"
"JH378147","15792803","15793070","KQ054180v1","2985258","2985514","65","12807545"
"JH378147","15870311","15870613","KQ057737v1","5252287","5252595","73","10618024"
"JH378147","15967710","15968012","KQ052981v1","1198440","1198752","68","14769270"
"JH378147","15970418","15970692","KQ052969v1","9114256","9114521","73","6856162"
"JH378147","16084967","16085224","KQ058542v1","550732","550973","64","15534235"
"JH378147","16284367","16284618","KQ053498v1","3849819","3850073","63","12434548"
"JH378147","16414184","16414469","KQ057205v1","1956346","1956638","77","14457838"
"JH378147","16834227","16834397","KQ053190v1","5197561","5197720","56","11636666"
"JH378147","16879563","16879850","KQ056147v1","1064032","1064323","63","15815531"
"JH378147","17007656","17007936","KQ058339v1","3085488","3085768","74","13922168"
"JH378147","17517404","17517707","KQ053959v1","1626696","1626985","86","15890708"
"JH378148","1347971","1348282","KQ057380v1","2548496","2548785","76","1200525"
"JH378148","1707415","1707703","KQ055978v1","3560415","3560681","93","1853000"
"JH378148","1773001","1773153","KQ053631v1","1260941","1261095","33","512060"
"JH378148","1971132","1971412","KQ058184v1","1608105","1608378","65","363027"
"JH378148","1990819","1991106","KQ053190v1","5623449","5623748","61","3632630"
"JH378148","1993081","1993291","KQ053398v1","3158290","3158500","49","1165209"
"JH378148","2054299","2054591","KQ054826v1","7957748","7958033","84","5903449"
"JH378148","2055322","2055594","KQ054068v1","1268545","1268823","62","786777"
"JH378148","2113637","2113939","KQ056945v1","3782849","3783143","59","1669212"
"JH378148","2300231","2300366","KQ054213v1","615112","615244","27","1685119"
"JH378148","2329316","2329639","KQ052970v1","10427454","10427754","85","8098138"
"JH378148","2710718","2711011","KQ057290v1","1053741","1054027","62","1656977"
"JH378148","2948785","2948991","KQ058627v1","2039042","2039248","47","909743"
"JH378148","3108123","3108415","KQ053631v1","7288314","7288608","62","4180191"
"JH378148","3233479","3233778","KQ058184v1","1505565","1505858","68","1727914"
"JH378148","3408821","3408974","KQ052969v1","11047655","11047802","50","7638834"
"JH378148","3409556","3409648","KQ057909v1","14813149","14813240","20","11403593"
"JH378148","3531050","3531147","KQ058183v1","3236759","3236851","29","294291"
"JH378148","3531610","3531777","KQ058429v1","52814","52983","43","3478796"
"JH378148","3592354","3592632","KQ054069v1","955693","955974","55","2636661"
"JH378148","3709847","3710136","KQ053741v1","1718834","1719118","71","1991013"
"JH378148","3807873","3808156","KQ055557v1","3645114","3645397","69","162759"
"JH378148","3946173","3946461","KQ053398v1","2545768","2546067","71","1400405"
"JH378148","3959415","3959682","KQ056404v1","1771928","1772196","76","2187487"
"JH378148","3978134","3978291","KQ055872v1","5870772","5870928","35","1892638"
"JH378148","3990710","3990805","KQ055872v1","3969127","3969217","26","21583"
"JH378148","3991231","3991416","KQ054565v1","5663153","5663337","40","1671922"
"JH378148","4036933","4037221","KQ053190v1","5495992","5496283","56","1459059"
"JH378148","4049221","4049339","KQ053916v1","2379880","2380005","30","1669341"
"JH378148","4118843","4119134","KQ056928v1","13418","13711","67","4105425"
"JH378148","4132093","4132376","KQ053093v1","3162517","3162806","63","969576"
"JH378148","5851350","5851539","KQ053643v1","232376","232561","50","5618974"
"JH378148","5870037","5870278","KQ058339v1","6896749","6897014","75","1026712"
"JH378148","6201110","6201384","KQ058381v1","889964","890251","77","5311146"
"JH378148","6592356","6592504","KQ056672v1","6452016","6452164","28","140340"
"JH378148","7010436","7010534","KQ055872v1","5141445","5141541","19","1868991"
"JH378148","7010888","7011169","KQ054868v1","2229582","2229854","64","4781306"
"JH378148","7083287","7083390","KQ056613v1","1941571","1941673","25","5141716"
"JH378148","7084361","7084481","KQ053409v1","6105325","6105446","28","979036"
"JH378148","7159594","7159709","KQ052969v1","2661859","2661968","25","4497735"
"JH378148","7306370","7306643","KQ057755v1","45985","46262","68","7260385"
"JH378148","7312698","7313001","KQ058184v1","1505565","1505858","70","5807133"
"JH378148","7744085","7744395","KQ053816v1","7464708","7465010","62","279377"
"JH378148","7789700","7789825","KQ054047v1","1054810","1054936","27","6734890"
"JH378148","8040696","8040976","KQ058356v1","225845","226125","76","7814851"
"JH378148","8186477","8186702","KQ053093v1","1363144","1363361","57","6823333"
"JH378148","9495620","9495915","KQ053631v1","7288314","7288608","69","2207306"
"JH378148","9838777","9839078","KQ053816v1","7327018","7327317","77","2511759"
"JH378148","10360528","10360806","KQ053146v1","2819587","2819868","69","7540941"
"JH378148","10559781","10560012","KQ053696v1","492750","492962","71","10067031"
"JH378148","11598791","11599077","KQ054660v1","3418146","3418430","55","8180645"
"JH378148","12109442","12109700","KQ055662v1","4683524","4683789","62","7425918"
"JH378148","12222443","12222730","KQ053115v1","1118362","1118655","56","11104081"
"JH378148","12355339","12355626","KQ054868v1","473451","473739","63","11881888"
"JH378148","12478129","12478280","KQ058427v1","6712716","6712867","29","5765413"
"JH378148","12478281","12478310","KQ052968v1","8257998","8258026","14","4220283"
"JH378148","12546842","12546948","KQ053005v1","324436","324539","26","12222406"
"JH378148","12906154","12906446","KQ052971v1","1111058","1111352","72","11795096"
"JH378148","13319675","13319786","KQ053115v1","4371036","4371145","27","8948639"
"JH378148","13921284","13921603","KQ053631v1","7288314","7288608","72","6632970"
"JH378148","13960610","13960823","KQ058242v1","892038","892246","61","13068572"
"JH378148","14864780","14864933","KQ054725v1","950864","951002","36","13913916"
"JH378148","15000641","15000778","KQ058094v1","3687022","3687155","23","11313619"
"JH378148","15324239","15324523","KQ053631v1","7288314","7288608","64","8035925"
"JH378148","15461805","15461935","KQ053256v1","1284266","1284394","25","14177539"
"JH378148","15469746","15469977","KQ057034v1","3957140","3957365","59","11512606"
"JH378148","15546659","15546969","KQ056440v1","1022590","1022891","84","14524069"
"JH378148","15558006","15558285","KQ058248v1","1222370","1222655","57","14335636"
"JH378148","15596126","15596269","KQ056147v1","2168964","2169108","31","13427162"
"JH378148","15660763","15661048","KQ053299v1","2118230","2118517","66","13542533"
"JH378148","16592221","16592446","KQ057840v1","234828","235046","56","16357393"
"JH378148","16633270","16633399","KQ054932v1","7772773","7772892","25","8860497"
"JH378148","16633737","16633781","KQ057737v1","421645","421684","17","16212092"
"JH378148","16691410","16691675","KQ054289v1","4355551","4355817","64","12335859"
"JH378148","16723506","16723793","KQ053816v1","5837219","5837503","66","10886287"
"JH378148","16874497","16874769","KQ058184v1","1505565","1505858","68","15368932"
"JH378148","17092527","17092662","KQ055141v1","1805334","1805474","36","15287193"
"JH378148","17092975","17093037","KQ053288v1","6197479","6197533","20","10895496"
"JH378148","17093678","17093749","KQ053849v1","1707655","1707721","24","15386023"
"JH378148","17159708","17159999","KQ053420v1","122023","122324","73","17037685"
"JH378148","17305510","17305807","KQ054921v1","2493802","2494087","63","14811708"
"JH378148","17534879","17535124","KQ054191v1","687910","688159","74","16846969"
"JH378149","72150","72450","KQ053070v1","533496","533791","67","461346"
"JH378149","77751","77884","KQ053191v1","655494","655627","19","577743"
"JH378149","113445","113667","KQ057345v1","642320","642545","56","528875"
"JH378149","126061","126355","KQ053948v1","168940","169229","72","42879"
"JH378149","241012","241303","KQ055183v1","429489","429783","71","188477"
"JH378149","365701","365830","KQ053354v1","702320","702452","20","336619"
"JH378149","426224","426343","KQ056234v1","886803","886922","31","460579"
"JH378149","552918","553000","KQ057664v1","404566","404648","18","148352"
"JH378149","705288","705402","KQ053816v1","7354481","7354583","33","6649193"
"JH378149","767529","767836","KQ053420v1","122023","122324","68","645506"
"JH378149","1110563","1110696","KQ056404v1","1195188","1195317","28","84625"
"JH378149","1199357","1199496","KQ058350v1","6598688","6598822","28","5399331"
"JH378149","1556851","1557142","KQ053631v1","8322466","8322756","61","6765615"
"JH378149","1587932","1588031","KQ053048v1","5003924","5004020","20","3415992"
"JH378149","1648768","1649003","KQ055247v1","2156838","2157064","51","508070"
"JH378149","1649640","1649729","KQ058516v1","1389709","1389802","19","259931"
"JH378149","1774363","1774552","KQ054964v1","2260574","2260761","45","486211"
"JH378149","1785706","1785941","KQ057380v1","2047063","2047290","64","261357"
"JH378149","1963067","1963264","KQ052968v1","1711014","1711208","55","252053"
"JH378149","2063305","2063592","KQ055872v1","12987862","12988141","66","10924557"
"JH378149","2127446","2127564","KQ058383v1","8339612","8339728","21","6212166"
"JH378149","2131388","2131664","KQ053520v1","2840509","2840769","74","709121"
"JH378149","2349096","2349245","KQ053157v1","4288391","4288538","42","1939295"
"JH378149","2456514","2456799","KQ058184v1","1505565","1505858","65","950949"
"JH378149","2563003","2563130","KQ053432v1","3920706","3920835","29","1357703"
"JH378149","2693161","2693292","KQ053256v1","1284266","1284394","30","1408895"
"JH378149","2714008","2714246","KQ058501v1","262278","262510","61","2451730"
"JH378149","2765035","2765275","KQ057345v1","1938824","1939073","61","826211"
"JH378149","2912662","2912914","KQ055629v1","27732","27989","63","2884930"
"JH378149","2990489","2990627","KQ053059v1","5085021","5085153","34","2094532"
"JH378149","2992693","2992857","KQ054510v1","3803526","3803690","39","810833"
"JH378149","2995488","2995773","KQ054356v1","1600089","1600380","66","1395399"
"JH378149","3002350","3002639","KQ053816v1","7464708","7465010","77","4462358"
"JH378149","3059615","3059906","KQ053465v1","3818784","3819069","70","759169"
"JH378149","3260448","3260719","KQ057910v1","2540095","2540357","65","720353"
"JH378149","3442128","3442407","KQ058184v1","1505565","1505858","60","1936563"
"JH378149","3796624","3796852","KQ054565v1","5770490","5770715","56","1973866"
"JH378149","3836086","3836271","KQ053190v1","4183682","4183869","58","347596"
"JH378149","3924842","3925135","KQ055247v1","895463","895756","65","3029379"
"JH378149","3964891","3965195","KQ058305v1","3465508","3465807","69","499383"
"JH378149","4073530","4073624","KQ057821v1","1407299","1407387","29","2666231"
"JH378149","4090069","4090311","KQ058537v1","27912","28129","81","4062157"
"JH378149","4131630","4131704","KQ058076v1","120666","120729","23","4010964"
"JH378149","4336010","4336302","KQ057290v1","1053741","1054027","68","3282269"
"JH378149","4336310","4336402","KQ058253v1","973922","974008","25","3362388"
"JH378149","4394862","4395043","KQ054804v1","1503479","1503667","51","2891383"
"JH378149","4516216","4516344","KQ057910v1","1548802","1548933","22","2967414"
"JH378149","4520178","4520274","KQ058483v1","4491456","4491541","41","28722"
"JH378149","4550738","4550969","KQ058572v1","913074","913293","62","3637664"
"JH378149","4742769","4743031","KQ053795v1","370451","370712","65","4372318"
"JH378149","5082271","5082548","KQ057931v1","399684","399967","65","4682587"
"JH378149","5088319","5088611","KQ054179v1","4270912","4271203","77","817407"
"JH378149","5130800","5131103","KQ058004v1","1100771","1101059","76","4030029"
"JH378149","5184783","5185071","KQ055087v1","1205525","1205826","64","3979258"
"JH378149","5341263","5341433","KQ058050v1","749360","749517","39","4591903"
"JH378149","5891487","5891778","KQ056672v1","6393431","6393732","86","501944"
"JH378149","5903804","5904113","KQ053310v1","2092689","2092989","69","3811115"
"JH378149","6833781","6833971","KQ053861v1","3645821","3646005","64","3187960"
"JH378149","6938051","6938343","KQ054412v1","2490468","2490761","73","4447583"
"JH378149","7384839","7385120","KQ052968v1","13657848","13658133","82","6273009"
"JH378149","7772076","7772345","KQ053332v1","2579491","2579756","67","5192585"
"JH378149","7947724","7948012","KQ055036v1","1478515","1478803","63","6469209"
"JH378149","8194706","8194866","KQ055024v1","2169588","2169740","40","6025118"
"JH378149","8510123","8510430","KQ055479v1","1841725","1842025","68","6668398"
"JH378149","8566989","8567263","KQ056148v1","2246905","2247173","60","6320084"
"JH378149","8651027","8651327","KQ055457v1","4506133","4506425","75","4144894"
"JH378149","8753235","8753513","KQ058383v1","5944247","5944518","70","2808988"
"JH378149","8923311","8923600","KQ054401v1","2629005","2629296","82","6294306"
"JH378149","9045633","9045918","KQ057560v1","1714004","1714291","61","7331629"
"JH378149","9155293","9155584","KQ056432v1","1447969","1448266","69","7707324"
"JH378149","9206551","9206704","KQ056147v1","2168964","2169108","33","7037587"
"JH378149","9364336","9364608","KQ053409v1","5686466","5686740","62","3677870"
"JH378149","9980418","9980572","KQ054168v1","1100368","1100517","38","8880050"
"JH378149","10019603","10019892","KQ055540v1","364924","365227","68","9654679"
"JH378149","10058081","10058296","KQ054848v1","194460","194660","61","9863621"
"JH378149","10069250","10069558","KQ058585v1","580456","580763","60","9488794"
"JH378149","10069571","10069871","KQ057693v1","621833","622123","65","9447738"
"JH378149","10226376","10226643","KQ055065v1","1117201","1117481","62","9109175"
"JH378149","10277704","10277841","KQ055457v1","5830277","5830416","26","4447427"
"JH378149","10343039","10343330","KQ058184v1","1505565","1505858","65","8837474"
"JH378149","10402925","10403220","KQ057858v1","376905","377209","65","10026020"
"JH378149","10549386","10549641","KQ053041v1","580788","581047","67","9968598"
"JH378149","10634975","10635101","KQ053432v1","3920706","3920835","21","6714269"
"JH378149","10768656","10768958","KQ058184v1","1505565","1505858","52","9263091"
"JH378149","10872685","10872985","KQ054191v1","3583730","3584032","59","7288955"
"JH378149","10948704","10948985","KQ058183v1","487423","487710","62","10461281"
"JH378149","10951513","10951639","KQ054932v1","5285465","5285595","26","5666048"
"JH378149","11004510","11004660","KQ058527v1","842675","842817","34","10161835"
"JH378149","11197187","11197465","KQ057504v1","162767","163049","67","11034420"
"JH378149","11251636","11251924","KQ054693v1","832788","833076","48","10418848"
"JH378149","12111333","12111619","KQ058190v1","350088","350375","66","11761245"
"JH378149","12340109","12340403","KQ053520v1","456408","456696","64","11883701"
"JH378149","12373400","12373612","KQ058505v1","2234909","2235124","50","10138491"
"JH378149","12480775","12481060","KQ056475v1","2179070","2179363","70","10301705"
"JH378149","12538734","12539032","KQ054682v1","2125705","2126015","74","10413029"
"JH378149","12590467","12590587","KQ058483v1","4711310","4711430","36","7879157"
"JH378149","12687397","12687524","KQ054412v1","2196456","2196568","41","10490941"
"JH378149","12718248","12718550","KQ057911v1","428931","429228","66","12289317"
"JH378149","12860967","12861246","KQ055872v1","12987862","12988141","57","126895"
"JH378149","12899221","12899351","KQ053354v1","702320","702452","21","12196901"
"JH378149","13058914","13059060","KQ053299v1","6512522","6512671","35","6546392"
"JH378149","13101772","13101913","KQ058612v1","126615","126755","28","12975157"
"JH378149","13329164","13329438","KQ053256v1","1257292","1257559","74","12071872"
"JH378149","13443186","13443427","KQ056597v1","1198358","1198607","57","12244828"
"JH378149","13672571","13672867","KQ053420v1","122023","122324","65","13550548"
"JH378149","13834860","13835151","KQ055097v1","2825545","2825834","58","11009315"
"JH378149","13892945","13893227","KQ055872v1","2472548","2472832","67","11420397"
"JH378149","13938638","13938936","KQ054069v1","7687863","7688158","60","6250775"
"JH378149","14072339","14072446","KQ057053v1","1428277","1428372","29","12644062"
"JH378149","14086720","14087010","KQ053082v1","1476670","1476954","66","12610050"
"JH378149","14164335","14164549","KQ054886v1","79","289","54","14164256"
"JH378149","14173928","14174025","KQ058183v1","3236759","3236851","22","10937169"
"JH378149","14296641","14296823","KQ055872v1","3361212","3361420","59","10935429"
"JH378149","14324673","14324876","KQ058242v1","892038","892246","56","13432635"
"JH378149","14639100","14639232","KQ058550v1","2035409","2035537","42","12603691"
"JH378149","14642288","14642423","KQ054921v1","3001829","3001962","29","11640459"
"JH378149","14735289","14735436","KQ058004v1","4755337","4755486","32","9979952"
"JH378149","14902142","14902414","KQ052968v1","10745715","10745973","70","4156427"
"JH378149","14907155","14907285","KQ053202v1","780148","780280","27","14127007"
"JH378149","14969827","14970115","KQ053297v1","44026","44315","66","14925801"
"JH378149","15112242","15112519","KQ058550v1","4253544","4253836","77","10858698"
"JH378149","15116974","15117259","KQ052981v1","658787","659079","59","14458187"
"JH378149","15339753","15340074","KQ053093v1","1522159","1522464","72","13817594"
"JH378149","15440909","15441157","KQ055055v1","1882469","1882726","68","13558440"
"JH378149","15469934","15470178","KQ057291v1","322948","323180","57","15146986"
"JH378149","15686526","15686822","KQ053212v1","1248645","1248940","71","14437881"
"JH378149","15755742","15755866","KQ056234v1","886803","886922","30","14868939"
"JH378149","15770958","15771269","KQ054704v1","223675","223980","68","15547283"
"JH378149","15772653","15772965","KQ055629v1","135233","135538","81","15637420"
"JH378149","15823916","15824206","KQ054124v1","2208704","2209004","75","13615212"
"JH378149","16013689","16013838","KQ058483v1","5279934","5280083","29","10733755"
"JH378149","16310461","16310713","KQ055735v1","1032075","1032317","61","15278386"
"JH378149","16488423","16488719","KQ054868v1","1651243","1651531","69","14837180"
"JH378149","16491261","16491543","KQ053398v1","1756246","1756533","70","14735015"
"JH378149","16684425","16684587","KQ053223v1","2815634","2815800","41","13868791"
"JH378149","16685542","16685824","KQ057118v1","393210","393488","74","16292332"
"JH378149","16782456","16782635","KQ058301v1","333804","333994","44","16448652"
"JH378149","16917198","16917351","KQ053288v1","28257","28404","34","16888941"
"JH378149","16933518","16933808","KQ053288v1","2218996","2219287","69","14714522"
"JH378149","16943290","16943426","KQ055375v1","716065","716198","34","16227225"
"JH378149","17315452","17315742","KQ058190v1","350088","350375","66","16965364"
"JH378150","806401","806451","KQ054839v1","3569","3615","17","802832"
"JH378150","806887","807123","KQ053026v1","2213601","2213834","65","1406714"
"JH378150","823497","823816","KQ054069v1","7687863","7688158","74","6864366"
"JH378150","1105065","1105235","KQ052969v1","10845523","10845690","43","9740458"
"JH378150","1105528","1105663","KQ058516v1","2773394","2773527","35","1667866"
"JH378150","1555776","1556068","KQ053752v1","1559954","1560242","65","4178"
"JH378150","1807191","1807485","KQ054693v1","837377","837666","69","969814"
"JH378150","2198691","2198958","KQ055375v1","3298020","3298279","74","1099329"
"JH378150","2538906","2539198","KQ057045v1","590946","591241","73","1947960"
"JH378150","2660343","2660559","KQ052968v1","13624694","13624898","72","10964351"
"JH378150","2664153","2664442","KQ054400v1","4672799","4673099","62","2008646"
"JH378150","2722115","2722419","KQ053816v1","7464708","7465010","67","4742593"
"JH378150","2837702","2837970","KQ058316v1","6274690","6274954","78","3436988"
"JH378150","2884155","2884422","KQ058383v1","5944247","5944518","63","3060092"
"JH378150","2970719","2971013","ABDC02049972v1","438","730","68","2970281"
"JH378150","2978649","2978803","KQ054180v1","70685","70834","35","2907964"
"JH378150","3580377","3580671","KQ054868v1","1584588","1584882","66","1995789"
"JH378150","3962514","3962785","KQ058184v1","1505565","1505858","72","2456949"
"JH378150","3983554","3983855","KQ053059v1","2112049","2112344","67","1871505"
"JH378150","4128700","4128831","KQ053299v1","22459675","22459802","34","18330975"
"JH378150","4224512","4224787","KQ056331v1","106636","106916","62","4117876"
"JH378150","4251932","4252100","KQ056475v1","5275769","5275928","48","1023837"
"JH378150","4308338","4308629","KQ054693v1","837377","837666","74","3470961"
"JH378150","4668387","4668523","KQ058350v1","13060265","13060398","32","8391878"
"JH378150","4926035","4926303","KQ052970v1","20988009","20988278","61","16061974"
"JH378150","5051300","5051611","KQ055119v1","3015978","3016290","96","2035322"
"JH378150","5905610","5905884","KQ057910v1","2540095","2540357","79","3365515"
"JH378150","6617746","6618061","KQ056928v1","1915686","1915996","58","4702060"
"JH378150","6696159","6696431","KQ054069v1","955693","955974","76","5740466"
"JH378150","6966999","6967265","KQ056587v1","15594744","15595024","68","8627745"
"JH378150","7144301","7144628","KQ053654v1","2191002","2191319","79","4953299"
"JH378150","7267726","7268014","KQ056432v1","2055804","2056087","80","5211922"
"JH378150","7275549","7275824","KQ057440v1","750226","750500","86","6525323"
"JH378150","7351491","7351792","KQ054804v1","964015","964313","60","6387476"
"JH378150","7968418","7968552","KQ054179v1","3927334","3927468","34","4041084"
"JH378150","7971648","7971971","KQ055787v1","694393","694708","83","7277255"
"JH378150","8027085","8027368","KQ053905v1","3605331","3605611","74","4421754"
"JH378150","8053790","8054096","KQ054932v1","9683849","9684160","77","1630059"
"JH378150","8167846","8167997","KQ053157v1","4288391","4288538","33","3879455"
"JH378150","8331259","8331553","KQ053115v1","1118362","1118655","76","7212897"
"JH378150","8354783","8355064","KQ055035v1","4381466","4381744","63","3973317"
"JH378150","8406041","8406185","ABDC02029150v1","2120","2268","32","8403921"
"JH378150","8442851","8443143","KQ058183v1","487423","487710","64","7955428"
"JH378150","8458914","8459201","KQ058316v1","4697990","4698273","69","3760924"
"JH378150","8993058","8993281","KQ053959v1","3147544","3147761","55","5845514"
"JH378150","9218434","9218721","KQ056147v1","1064032","1064323","55","8154402"
"JH378150","9497155","9497379","KQ054827v1","2292729","2292949","75","7204426"
"JH378150","9683875","9684066","KQ052982v1","1613820","1613991","57","8070055"
"JH378150","9816716","9816939","KQ054191v1","642274","642457","76","9174442"
"JH378150","10129020","10129194","KQ053267v1","2398569","2398723","54","7730451"
"JH378150","10183854","10183986","KQ056652v1","675563","675695","27","9508291"
"JH378150","10248670","10248808","KQ053498v1","3548279","3548419","41","6700391"
"JH378150","10299191","10299508","KQ054400v1","4609733","4610042","87","5689458"
"JH378150","10335277","10335579","KQ056440v1","1157164","1157460","64","9178113"
"JH378150","11562923","11563110","KQ053230v1","1511650","1511838","49","10051273"
"JH378150","11915681","11915990","KQ058585v1","580456","580763","76","11335225"
"JH378150","12584945","12585225","KQ055192v1","1106994","1107270","72","11477951"
"JH378150","12623063","12623353","KQ057004v1","1506143","1506432","74","11116920"
"JH378150","13259228","13259493","KQ053993v1","1017100","1017367","79","12242128"
"JH378150","13368557","13368865","KQ058283v1","622348","622657","74","12746209"
"JH378150","14035592","14035856","KQ053795v1","121444","121694","78","13914148"
"JH378150","14211298","14211607","KQ058146v1","160981","161283","81","14050317"
"JH378150","14280267","14280535","KQ058184v1","1608105","1608378","64","12672162"
"JH378150","15225909","15226202","KQ058184v1","1505565","1505858","61","13720344"
"JH378150","15373224","15373523","KQ058585v1","580456","580763","71","14792768"
"JH378150","15394539","15394836","KQ052968v1","4276704","4277004","62","11117835"
"JH378150","15537610","15537913","KQ055872v1","7552789","7553093","75","7984821"
"JH378150","15564880","15565067","KQ056475v1","279980","280179","51","15284900"
"JH378150","15693072","15693346","KQ054932v1","6142005","6142272","73","9551067"
"JH378150","15709305","15709642","KQ055414v1","375826","376139","103","15333479"
"JH378150","15793261","15793574","KQ058272v1","4942871","4943179","65","10850390"
"JH378150","15942873","15943007","KQ054213v1","615112","615244","27","15327761"
"JH378150","15943905","15944008","KQ058411v1","42674","42772","22","15901231"
"JH378150","15947188","15947437","KQ053795v1","380044","380305","65","15567144"
"JH378150","16208243","16208400","KQ055872v1","5870772","5870928","41","10337471"
"JH378150","16216685","16216967","KQ053631v1","9963313","9963601","74","6253372"
"JH378150","16364787","16365072","KQ058184v1","1505565","1505858","73","14859222"
"JH378150","16432704","16432921","KQ053093v1","1363144","1363361","61","15069560"
"JH378150","17199443","17199689","KQ058545v1","178299","178534","67","17021144"
"JH378151","53121","53400","KQ052970v1","9759602","9759863","77","9706481"
"JH378151","167393","167543","KQ053212v1","578976","579120","30","411583"
"JH378151","465575","465741","KQ053223v1","2815634","2815800","35","2350059"
"JH378151","664590","664886","KQ053288v1","2218996","2219287","64","1554406"
"JH378151","774559","774755","KQ058394v1","10110818","10110995","62","9336259"
"JH378151","1048429","1048570","KQ053982v1","3934263","3934401","32","2885834"
"JH378151","1246448","1246720","KQ053465v1","403029","403303","69","843419"
"JH378151","1261833","1261964","KQ054795v1","2377934","2378063","24","1116101"
"JH378151","1276614","1276937","KQ053816v1","7464708","7465010","85","6188094"
"JH378151","1352357","1352425","KQ057380v1","2993795","2993866","16","1641438"
"JH378151","1379918","1380047","KQ057910v1","1548802","1548933","26","168884"
"JH378151","1598558","1598835","KQ056790v1","446564","446855","73","1151994"
"JH378151","1650001","1650311","KQ058513v1","15345","15653","70","1634656"
"JH378151","1859395","1859603","KQ058550v1","3053970","3054174","45","1194575"
"JH378151","2253110","2253257","KQ054499v1","2153744","2153898","45","99366"
"JH378151","2329703","2330007","KQ058184v1","1505565","1505858","82","824138"
"JH378151","2461557","2461719","KQ053004v1","4759784","4759947","40","2298227"
"JH378151","2508293","2508555","KQ055065v1","1117201","1117481","66","1391092"
"JH378151","2718879","2719019","KQ055288v1","226204","226359","38","2492675"
"JH378151","2737537","2737844","KQ055065v1","1117201","1117481","83","1620336"
"JH378151","2826901","2826997","KQ054994v1","3559925","3560015","33","733024"
"JH378151","2918299","2918415","KQ054179v1","3865170","3865294","31","946871"
"JH378151","3020139","3020444","KQ054401v1","2629005","2629296","67","391134"
"JH378151","3446290","3446494","KQ054124v1","147406","147625","50","3298884"
"JH378151","4191895","4192177","KQ054510v1","1641980","1642248","75","2549915"
"JH378151","4221556","4221595","KQ056465v1","1649422","1649455","19","2572134"
"JH378151","4224026","4224294","KQ053849v1","952727","952990","74","3271299"
"JH378151","4229081","4229211","KQ052968v1","9760638","9760766","19","5531557"
"JH378151","4298552","4298683","KQ057702v1","1862724","1862857","29","2435828"
"JH378151","4357871","4358182","KQ053398v1","3774526","3774835","73","583345"
"JH378151","4480827","4480986","KQ055589v1","815","963","52","4480012"
"JH378151","4661627","4661930","KQ054213v1","780092","780393","69","3881535"
"JH378151","4711815","4712073","KQ053409v1","2092356","2092619","58","2619459"
"JH378151","5072538","5072663","KQ053300v1","2910811","2910928","43","2161727"
"JH378151","5078274","5078492","KQ055518v1","2384780","2384994","53","2693494"
"JH378151","5118437","5118747","KQ057737v1","5499585","5499900","66","381148"
"JH378151","5710111","5710293","KQ053190v1","4080726","4080898","47","1629385"
"JH378151","5797227","5797287","KQ053556v1","5700","5760","15","5791527"
"JH378151","5813151","5813284","KQ053696v1","1609033","1609169","35","4204118"
"JH378151","5918428","5918732","KQ058184v1","1505565","1505858","62","4412863"
"JH378151","6247766","6247964","KQ054933v1","3939617","3939804","44","2308149"
"JH378151","6477536","6477714","KQ053014v1","58936","59114","53","6418600"
"JH378151","6480196","6480326","KQ054932v1","5190304","5190436","27","1289892"
"JH378151","6486720","6486943","KQ054135v1","1541023","1541259","62","4945697"
"JH378151","6553888","6554129","KQ053639v1","33677","33923","67","6520211"
"JH378151","6556671","6556749","KQ053454v1","1364861","1364941","14","5191810"
"JH378151","6580929","6581277","KQ058287v1","982841","983179","96","5598088"
"JH378151","6592810","6592869","KQ058065v1","399231","399281","20","6193579"
"JH378151","6593154","6593254","KQ053343v1","2133194","2133295","25","4459960"
"JH378151","6619653","6619796","KQ057204v1","3219950","3220097","34","3399703"
"JH378151","6656001","6656309","KQ057268v1","244944","245247","88","6411057"
"JH378151","6679397","6679685","KQ056855v1","2789429","2789717","62","3889968"
"JH378151","6710274","6710408","KQ052970v1","12609564","12609700","25","5899290"
"JH378151","6931304","6931433","KQ053432v1","3920706","3920835","24","3010598"
"JH378151","6978489","6978769","KQ058294v1","6026641","6026920","67","951848"
"JH378151","7069304","7069437","KQ058355v1","1446443","1446570","40","5622861"
"JH378151","7220811","7221082","KQ058184v1","1608105","1608378","64","5612706"
"JH378151","7343102","7343234","KQ055298v1","1575436","1575566","22","5767666"
"JH378151","7452823","7452963","KQ053432v1","3920706","3920835","31","3532117"
"JH378151","7456790","7456954","KQ055014v1","682174","682339","32","6774616"
"JH378151","7509291","7509409","KQ057909v1","14636622","14636750","31","7127331"
"JH378151","7545536","7545756","KQ057291v1","322948","323180","63","7222588"
"JH378151","7562761","7563029","KQ053816v1","5213784","5214044","65","2348977"
"JH378151","7641346","7641563","KQ052970v1","6911341","6911564","64","730005"
"JH378151","7711677","7711842","KQ054533v1","1027813","1027974","37","6683864"
"JH378151","7916037","7916165","KQ055755v1","1807261","1807395","32","6108776"
"JH378151","7931767","7931921","KQ056268v1","862150","862302","39","7069617"
"JH378151","7943443","7943731","KQ056928v1","2303396","2303675","65","5640047"
"JH378151","7979769","7979939","KQ052968v1","10427732","10427888","45","2447963"
"JH378151","7980631","7980953","KQ054682v1","2246019","2246316","80","5734612"
"JH378151","8214997","8215223","KQ055192v1","996310","996558","78","7218687"
"JH378151","8363330","8363457","KQ057702v1","1862724","1862857","24","6500606"
"JH378151","8372381","8372681","KQ052969v1","9116808","9117108","61","744427"
"JH378151","9370773","9370921","KQ052970v1","10856401","10856550","27","1485628"
"JH378151","9559317","9559483","KQ058572v1","3607755","3607912","42","5951562"
"JH378151","9574225","9574293","KQ057380v1","2993795","2993866","14","6580430"
"JH378151","9592656","9592931","KQ055055v1","1727574","1727850","77","7865082"
"JH378151","10104472","10104604","KQ054179v1","3927334","3927468","22","6177138"
"JH378151","10249874","10250066","KQ053179v1","1735404","1735576","47","8514470"
"JH378151","10455737","10455998","KQ054826v1","9969237","9969502","65","486500"
"JH378151","10696198","10696513","KQ058184v1","1505565","1505858","72","9190633"
"JH378151","10938099","10938355","KQ054724v1","188121","188363","69","10749978"
"JH378151","11674128","11674416","KQ053476v1","3712115","3712409","75","7962013"
"JH378151","11808204","11808418","KQ053398v1","3158290","3158500","51","8649914"
"JH378151","11844925","11845212","KQ052981v1","658787","659079","69","11186138"
"JH378151","12533827","12534136","KQ057875v1","561558","561851","80","11972269"
"JH378151","13247210","13247505","KQ053631v1","7288314","7288608","67","5958896"
"JH378151","13932423","13932704","KQ055119v1","3538344","3538616","71","10394079"
"JH378151","13989120","13989434","KQ058450v1","2960681","2960988","85","11028439"
"JH378151","14099271","14099533","KQ057603v1","1562174","1562426","67","12537097"
"JH378151","14329821","14330101","KQ052970v1","6659487","6659775","67","7670334"
"JH378151","14347693","14347822","KQ054786v1","479127","479249","22","13868566"
"JH378151","14398884","14399124","KQ052982v1","4105869","4106109","55","10293015"
"JH378151","14402380","14402664","KQ053146v1","2819587","2819868","65","11582793"
"JH378151","14437047","14437344","KQ057693v1","621833","622123","73","13815214"
"JH378151","14450456","14450734","KQ052968v1","10629964","10630247","65","3820492"
"JH378151","14486166","14486444","KQ052968v1","10629964","10630247","65","3856202"
"JH378151","14515158","14515421","KQ055394v1","3441211","3441489","64","11073947"
"JH378151","15120575","15120875","KQ053299v1","2867160","2867464","74","12253415"
"JH378151","15283944","15284237","KQ054401v1","2629005","2629296","74","12654939"
"JH378151","15368224","15368515","KQ053190v1","5623449","5623748","68","9744775"
"JH378151","15416292","15416513","KQ053631v1","8821839","8822058","55","6594453"
"JH378151","15563801","15564094","KQ056234v1","1421732","1422025","64","14142069"
"JH378151","15602003","15602163","KQ055183v1","1201657","1201816","36","14400346"
"JH378151","15614924","15615035","KQ053354v1","1582358","1582469","25","14032566"
"JH378151","15615276","15615434","KQ056475v1","5275769","5275928","43","10339507"
"JH378151","15652349","15652624","KQ053795v1","370451","370712","72","15281898"
"JH378151","15704178","15704488","KQ055755v1","446339","446640","64","15257839"
"JH378151","15911610","15911773","KQ056996v1","1524030","1524195","33","14387580"
"JH378151","15982492","15982793","KQ057911v1","428931","429228","65","15553561"
"JH378151","16025347","16025640","KQ053631v1","9631170","9631468","70","6394177"
"JH378151","16161602","16161891","KQ058328v1","2590769","2591069","71","13570833"
"JH378151","16463256","16463502","KQ054693v1","745323","745572","70","15717933"
"JH378151","16627119","16627378","KQ055352v1","14158369","14158624","70","2468750"
"JH378151","16634460","16634670","KQ053948v1","2776497","2776701","52","13857963"
"JH378151","16714126","16714423","KQ054565v1","6587941","6588226","77","10126185"
"JH378151","16736099","16736374","KQ053752v1","7728136","7728398","58","9007963"
"JH378151","16744010","16744292","KQ058291v1","474599","474881","63","16269411"
"JH378151","16866704","16866964","KQ057875v1","469535","469791","72","16397169"
"JH378151","16938250","16938561","KQ054345v1","1580511","1580819","74","15357739"
"JH378151","17020790","17021082","KQ058389v1","2329886","2330179","74","14690904"
"JH378151","17055039","17055305","KQ052969v1","1030266","1030512","72","16024773"
"JH378151","17065045","17065182","KQ058257v1","652425","652556","27","16412620"
"JH378152","130574","130785","KQ054091v1","1183626","1183803","72","1053052"
"JH378152","130828","130924","KQ053115v1","618454","618553","30","487626"
"JH378152","752114","752373","KQ056404v1","638131","638387","64","113983"
"JH378152","1507021","1507215","KQ056996v1","148346","148555","56","1358675"
"JH378152","2502161","2502441","KQ053146v1","2819587","2819868","83","317426"
"JH378152","2532730","2532865","KQ055662v1","1063677","1063805","28","1469053"
"JH378152","2779208","2779337","KQ054725v1","1816931","1817058","35","962277"
"JH378152","2800306","2800585","KQ054124v1","2442155","2442433","79","358151"
"JH378152","3186271","3186413","KQ055375v1","281063","281205","30","2905208"
"JH378152","3897884","3898171","KQ053631v1","9116387","9116675","61","5218503"
"JH378152","3925829","3926050","KQ058328v1","2569266","2569497","57","1356563"
"JH378152","4089765","4090015","KQ052968v1","10745715","10745973","64","6655950"
"JH378152","4156293","4156561","KQ053059v1","2135970","2136233","60","2020323"
"JH378152","4258118","4258258","KQ056147v1","2168964","2169108","36","2089154"
"JH378152","4457283","4457525","KQ054704v1","884226","884461","56","3573057"
"JH378152","4665956","4666060","KQ055872v1","5141445","5141541","25","475489"
"JH378152","5115542","5115806","KQ055662v1","907053","907314","69","4208489"
"JH378152","5608202","5608483","KQ052968v1","6282633","6282918","61","674431"
"JH378152","5759168","5759301","KQ057649v1","141749","141881","22","5617419"
"JH378152","5792073","5792295","KQ053343v1","1057961","1058175","53","4734112"
"JH378152","5949137","5949368","KQ054638v1","641429","641659","66","5307708"
"JH378152","6164278","6164448","KQ053223v1","1451954","1452125","50","4712324"
"JH378152","6872648","6872954","KQ053343v1","1747702","1748011","62","5124946"
"JH378152","7898023","7898313","KQ054069v1","3294165","3294452","74","4603858"
"JH378152","8367324","8367620","KQ055872v1","2402427","2402732","67","5964897"
"JH378152","8459240","8459495","KQ057345v1","1938824","1939073","61","6520416"
"JH378152","8582739","8583025","KQ052970v1","6659487","6659775","68","1923252"
"JH378152","8585738","8586024","KQ052970v1","6659487","6659775","68","1926251"
"JH378152","8743736","8743975","KQ053082v1","7643617","7643861","57","1100119"
"JH378152","10227162","10227315","KQ054179v1","2203336","2203492","41","8023826"
"JH378152","10632014","10632158","KQ055725v1","889865","890010","28","9742149"
"JH378152","10717904","10718166","KQ056225v1","171484","171758","74","10546420"
"JH378152","10732999","10733210","KQ053170v1","267257","267471","60","10465742"
"JH378152","10841188","10841361","KQ055457v1","11733685","11733859","39","892497"
"JH378152","10851415","10851670","KQ054826v1","9969237","9969502","63","882178"
"JH378152","10962650","10962949","KQ056790v1","446564","446855","73","10516086"
"JH378152","10987666","10987926","KQ053157v1","3558863","3559137","72","7428803"
"JH378152","11037735","11037859","KQ056035v1","296324","296444","36","10741411"
"JH378152","11042551","11042820","KQ056673v1","983726","984000","72","10058825"
"JH378152","11170800","11171017","KQ056166v1","1907479","1907686","42","9263321"
"JH378152","11279218","11279529","KQ058328v1","2967558","2967855","72","8311660"
"JH378152","11331907","11332193","KQ055065v1","1117201","1117481","59","10214706"
"JH378152","11378117","11378272","KQ058533v1","544439","544600","44","10833678"
"JH378152","11378853","11378977","KQ054378v1","1235262","1235382","31","10143591"
"JH378152","11385566","11385841","KQ055044v1","505525","505797","62","10880041"
"JH378152","11419111","11419257","KQ056147v1","2168964","2169108","23","9250147"
"JH378152","11495344","11495516","KQ053948v1","3061823","3062004","55","8433521"
"JH378152","11540939","11541230","KQ053115v1","4471494","4471788","55","7069445"
"JH378152","11600800","11600930","KQ054725v1","1816931","1817058","25","9783869"
"JH378152","11746835","11747137","KQ052968v1","12144948","12145253","64","398113"
"JH378152","11761929","11762201","ABDC02001013v1","5347","5624","60","11756582"
"JH378152","11811168","11811309","KQ053631v1","8603317","8603457","26","3207851"
"JH378152","11892858","11893083","KQ058255v1","233892","234115","56","11658966"
"JH378152","11899062","11899368","KQ053795v1","1812338","1812629","89","10086724"
"JH378152","11920497","11920556","KQ058316v1","5629786","5629842","12","6290711"
"JH378152","12059832","12060104","KQ054868v1","2229582","2229854","63","9830250"
"JH378152","12112432","12112641","KQ053959v1","3147544","3147761","48","8964888"
"JH378152","12324596","12324885","KQ057737v1","3083543","3083824","78","9241053"
"JH378152","12459025","12459300","KQ057755v1","45985","46262","73","12413040"
"JH378152","12474554","12474718","KQ054213v1","2445756","2445931","39","10028798"
"JH378152","12483891","12484188","KQ054693v1","837377","837666","68","11646514"
"JH378152","12609872","12610031","KQ054704v1","752376","752518","46","11857496"
"JH378152","12622657","12622891","KQ052970v1","17731728","17731958","72","5109071"
"JH378152","12793643","12793929","KQ053146v1","2819587","2819868","51","9974056"
"JH378152","12855206","12855360","KQ056147v1","3323","3476","31","12851883"
"JH378152","12921493","12921630","KQ057702v1","1862724","1862857","19","11058769"
"JH378152","13027375","13027542","KQ057603v1","1535538","1535702","45","11491837"
"JH378152","13127615","13127941","KQ053631v1","7288314","7288608","91","5839301"
"JH378152","13155091","13155385","KQ054401v1","2629005","2629296","62","10526086"
"JH378152","13213879","13213976","KQ056672v1","4497643","4497736","18","8716236"
"JH378152","13263582","13263884","KQ053299v1","6282965","6283256","63","6980617"
"JH378152","13289756","13290029","KQ053398v1","4399062","4399325","80","8890694"
"JH378152","13291400","13291501","KQ054456v1","5057079","5057175","16","8234321"
"JH378152","13291981","13292104","KQ057788v1","949735","949853","33","12342246"
"JH378152","13440239","13440389","KQ054499v1","2153744","2153898","44","11286495"
"JH378152","13650022","13650120","KQ053905v1","3739304","3739409","26","9910718"
"JH378152","13650487","13650655","KQ058571v1","931737","931906","32","12718750"
"JH378152","13715536","13715671","KQ055610v1","1324189","1324330","30","12391347"
"JH378152","13786975","13787065","KQ053827v1","2612475","2612564","21","11174500"
"JH378152","13810425","13810704","KQ054401v1","1444218","1444498","72","12366207"
"JH378152","14063533","14063826","KQ055309v1","1479297","1479588","61","12584236"
"JH378152","14111314","14111398","KQ056988v1","824037","824111","31","13287277"
"JH378152","14125561","14125615","KQ053632v1","195846","195898","8","13929715"
"JH378152","14126836","14127047","KQ053191v1","3682228","3682423","57","10444608"
"JH378152","14194150","14194252","KQ054312v1","1696011","1696119","41","12498139"
"JH378152","14194820","14195108","KQ058184v1","1505565","1505858","59","12689255"
"JH378152","14273912","14273961","KQ054135v1","1661841","1661887","9","12612071"
"JH378152","14298113","14298399","KQ055065v1","999059","999338","64","13299054"
"JH378152","14324688","14324956","KQ058004v1","1908068","1908353","71","12416620"
"JH378152","14332086","14332226","KQ055406v1","2968","3106","24","14329118"
"JH378152","14500026","14500287","KQ055957v1","285461","285716","72","14214565"
"JH378152","14556898","14557183","KQ058313v1","787059","787344","71","13769839"
"JH378152","14621848","14622009","KQ053498v1","3849226","3849393","33","10772622"
"JH378152","14631807","14632120","KQ053299v1","4095914","4096215","64","10535893"
"JH378152","14768040","14768155","KQ056035v1","296324","296444","31","14471716"
"JH378152","14773271","14773559","KQ053093v1","1375309","1375598","72","13397962"
"JH378152","14789811","14790034","KQ057737v1","5198067","5198297","63","9591744"
"JH378152","15117419","15117701","KQ058249v1","184192","184468","59","14933227"
"JH378152","15358792","15358941","KQ055384v1","843998","844147","28","14514794"
"JH378152","15968234","15968528","KQ058427v1","3024751","3025042","62","12943483"
"JH378152","15980061","15980365","KQ053299v1","4095914","4096215","65","11884147"
"JH378152","16144556","16144848","KQ055662v1","456935","457225","68","15687621"
"JH378152","16229795","16230111","KQ055141v1","1054026","1054336","82","15175769"
"JH378152","16289183","16289483","KQ055352v1","13451535","13451828","58","2837648"
"JH378152","16303370","16303623","KQ057290v1","862441","862706","65","15440929"
"JH378152","16326699","16326919","KQ058242v1","892038","892246","55","15434661"
"JH378152","16479972","16480238","KQ053004v1","3225867","3226135","67","13254105"
"JH378152","16548353","16548560","KQ054400v1","319216","319421","57","16229137"
"JH378153","84112","84435","KQ056447v1","2325318","2325624","85","2241206"
"JH378153","132095","132322","KQ058438v1","228244","228462","60","96149"
"JH378153","288367","288667","KQ054786v1","934497","934799","64","646130"
"JH378153","307592","307881","KQ054693v1","832788","833076","56","525196"
"JH378153","379033","379331","KQ055004v1","332895","333205","72","46138"
"JH378153","668916","669218","KQ058184v1","1505565","1505858","59","836649"
"JH378153","701806","701885","KQ053520v1","1561632","1561710","27","859826"
"JH378153","701903","702029","KQ057059v1","276965","277090","32","424938"
"JH378153","744816","745082","KQ057345v1","1938824","1939073","64","1194008"
"JH378153","791495","791782","KQ054081v1","1240364","1240650","72","448869"
"JH378153","802720","802996","KQ058184v1","1608105","1608378","67","805385"
"JH378153","812361","812650","KQ056920v1","1132476","1132763","79","320115"
"JH378153","869625","869701","KQ056643v1","1142508","1142594","28","272883"
"JH378153","869814","869927","KQ057832v1","358963","359077","27","510851"
"JH378153","949526","949791","KQ053795v1","370451","370712","78","579075"
"JH378153","978713","978958","KQ057291v1","322948","323180","68","655765"
"JH378153","1008122","1008387","KQ054933v1","1016159","1016426","75","8037"
"JH378153","1026540","1026786","KQ057603v1","1562174","1562426","71","535634"
"JH378153","1040866","1041009","KQ057805v1","1647703","1647843","33","606837"
"JH378153","1191121","1191357","KQ056147v1","3491603","3491838","69","2300482"
"JH378153","1191852","1191917","KQ058483v1","4491053","4491121","18","3299201"
"JH378153","1222796","1223087","KQ053631v1","7288314","7288608","73","6065518"
"JH378153","1311065","1311333","KQ055755v1","209063","209333","69","1102002"
"JH378153","1551880","1551945","KQ053556v1","5700","5760","17","1546180"
"JH378153","1554820","1555105","KQ053093v1","1361295","1361576","59","193525"
"JH378153","1565051","1565225","KQ054652v1","6051","6229","43","1559000"
"JH378153","1565342","1565458","KQ057909v1","4153593","4153709","22","2588251"
"JH378153","2052461","2052810","KQ053063v1","238751","239047","115","1813710"
"JH378153","2137695","2137771","KQ055629v1","5058378","5058456","22","2920683"
"JH378153","2137894","2138027","KQ055468v1","1808172","1808307","31","329722"
"JH378153","2145598","2145839","KQ054984v1","996853","997105","64","1148745"
"JH378153","2318405","2318700","KQ055557v1","4063555","4063849","64","1745150"
"JH378153","2565058","2565204","KQ053190v1","2372433","2372579","37","192625"
"JH378153","2627432","2627575","KQ055014v1","2851953","2852097","37","224521"
"JH378153","2731531","2731734","KQ055662v1","1117136","1117330","56","1614395"
"JH378153","2737353","2737458","KQ058538v1","5682851","5682963","25","2945498"
"JH378153","2766399","2766680","KQ054868v1","2229582","2229854","76","536817"
"JH378153","2853644","2853937","KQ058094v1","6762572","6762874","75","3908928"
"JH378153","2878054","2878362","KQ055629v1","4218571","4218881","67","1340517"
"JH378153","3083069","3083291","KQ053816v1","5259129","5259356","65","2176060"
"JH378153","3149090","3149223","KQ057649v1","141749","141881","29","3007341"
"JH378153","3204955","3205226","KQ052970v1","6659487","6659775","66","3454532"
"JH378153","3206097","3206414","KQ053631v1","9631170","9631468","80","6425073"
"JH378153","3258931","3259079","KQ052968v1","8523342","8523490","54","5264411"
"JH378153","3305966","3306272","KQ056855v1","4111147","4111444","70","805181"
"JH378153","3342254","3342305","KQ054279v1","852960","853011","10","2489294"
"JH378153","3412581","3412736","KQ055725v1","720931","721083","38","2691650"
"JH378153","3454563","3454837","KQ058316v1","2622478","2622754","76","832085"
"JH378153","3456991","3457260","KQ054826v1","9969237","9969502","67","6512246"
"JH378153","3555813","3556046","KQ054289v1","4494059","4494296","63","938246"
"JH378153","3595718","3595970","KQ053632v1","575941","576173","71","3019777"
"JH378153","3720916","3721209","KQ056973v1","783590","783885","65","2937326"
"JH378153","3920182","3920456","KQ058383v1","7436623","7436889","73","3516441"
"JH378153","4010946","4011216","KQ057910v1","2537338","2537606","61","1473608"
"JH378153","4013688","4013992","KQ056911v1","756889","757207","66","3256799"
"JH378153","4072045","4072355","KQ055767v1","2455394","2455703","65","1616651"
"JH378153","4170681","4170989","KQ054576v1","750272","750582","59","3420409"
"JH378153","4769279","4769480","KQ053354v1","1104956","1105153","44","3664323"
"JH378153","5239642","5239915","KQ054301v1","3391378","3391638","70","1848264"
"JH378153","5320454","5320618","KQ057036v1","1270725","1270889","43","4049729"
"JH378153","5359475","5359690","KQ054565v1","5663153","5663337","62","303678"
"JH378153","5387351","5387471","KQ056293v1","110261","110385","21","5277090"
"JH378153","5393339","5393499","KQ056475v1","5275769","5275928","40","117570"
"JH378153","5407423","5407697","KQ058291v1","474599","474881","67","4932824"
"JH378153","5590353","5590615","KQ058523v1","79401","79664","75","5510952"
"JH378153","5623972","5624129","KQ058427v1","3400358","3400512","36","2223614"
"JH378153","5637287","5637573","KQ054565v1","6587941","6588226","72","950654"
"JH378153","5675404","5675534","KQ055457v1","5874928","5875062","20","199524"
"JH378153","5723265","5723481","KQ058550v1","3097967","3098175","63","2625298"
"JH378153","5729588","5729871","KQ056432v1","1593337","1593624","61","4136251"
"JH378153","5914503","5914567","KQ054367v1","3035217","3035279","20","2879286"
"JH378153","6324488","6324793","KQ058290v1","511568","511873","64","5812920"
"JH378153","6359543","6359852","KQ053927v1","199693","199992","68","6159850"
"JH378153","6454797","6455081","KQ058546v1","168071","168339","61","6286726"
"JH378153","6520682","6520977","KQ057290v1","2180782","2181079","75","4339900"
"JH378153","6586202","6586417","KQ054180v1","536720","536932","55","6049482"
"JH378153","6599795","6599977","KQ055978v1","2949687","2949843","47","3650108"
"JH378153","6709382","6709664","KQ052981v1","658787","659079","67","6050595"
"JH378153","6857710","6857917","KQ058505v1","2234909","2235124","53","4622801"
"JH378153","6900336","6900598","KQ054191v1","687910","688159","73","6212426"
"JH378153","6922652","6922943","KQ054693v1","832788","833076","66","6089864"
"JH378153","7093040","7093186","KQ057440v1","384538","384683","34","6708502"
"JH378153","7185493","7185621","KQ056855v1","804290","804423","28","6381203"
"JH378153","7195152","7195455","KQ053115v1","1118362","1118655","70","6076790"
"JH378153","7317097","7317345","KQ056182v1","281266","281497","69","7035831"
"JH378153","7456915","7457049","KQ058483v1","5373223","5373356","23","2083692"
"JH378153","7477870","7478166","KQ055787v1","1064992","1065293","72","6412878"
"JH378153","7555934","7556197","KQ054068v1","3810441","3810685","79","3745493"
"JH378153","7788731","7789028","KQ058184v1","1505565","1505858","76","6283166"
"JH378153","8156832","8157124","KQ057788v1","561223","561518","59","7595609"
"JH378153","9101090","9101234","KQ054069v1","7038072","7038210","31","2063018"
"JH378153","9167731","9168013","KQ052970v1","9103070","9103367","69","64661"
"JH378153","9259471","9259571","KQ052969v1","10606705","10606802","29","1347234"
"JH378153","9259602","9259644","KQ057909v1","13231474","13231525","15","3971872"
"JH378153","9364271","9364576","KQ058538v1","934688","934988","69","8429583"
"JH378153","9656228","9656500","KQ052970v1","3685906","3686177","77","5970322"
"JH378153","9949103","9949373","KQ053332v1","447571","447853","67","9501532"
"JH378153","9996897","9997054","KQ053982v1","4960413","4960565","38","5036484"
"JH378153","10070563","10070843","KQ053146v1","2819587","2819868","66","7250976"
"JH378153","10194341","10194592","KQ056965v1","1346676","1346924","64","8847665"
"JH378153","10202810","10203099","KQ057118v1","4601602","4601894","59","5601208"
"JH378153","10504429","10504725","KQ053827v1","4217183","4217477","69","6287246"
"JH378153","10563340","10563590","KQ058561v1","1351959","1352198","76","9211381"
"JH378153","10608268","10608410","KQ053354v1","702320","702452","31","9905948"
"JH378153","10732784","10733067","KQ055140v1","2748912","2749194","61","7983872"
"JH378153","10734374","10734645","KQ053409v1","5686466","5686740","56","5047908"
"JH378153","10743020","10743175","KQ054533v1","1027813","1027974","40","9715207"
"JH378153","10945267","10945543","KQ057380v1","1484947","1485224","67","9460320"
"JH378153","10987168","10987467","KQ053554v1","1157184","1157483","61","9829984"
"JH378153","11064639","11064824","KQ056056v1","323324","323503","44","10741315"
"JH378153","11174242","11174558","KQ053740v1","2898644","2898953","68","8275598"
"JH378153","11176502","11176802","KQ058585v1","580456","580763","62","10596046"
"JH378153","11218051","11218231","KQ054933v1","3939617","3939804","52","7278434"
"JH378153","11273955","11274265","KQ058484v1","1273599","1273890","78","10000356"
"JH378153","11274905","11275192","KQ054510v1","9222042","9222321","79","2052863"
"JH378153","11303364","11303651","KQ057290v1","1053741","1054027","55","10249623"
"JH378153","11321069","11321348","KQ052968v1","13260777","13261056","69","1939708"
"JH378153","11322728","11322871","KQ053432v1","3920706","3920835","38","7402022"
"JH378153","11388567","11388717","KQ053299v1","5209668","5209811","36","6178899"
"JH378153","11419823","11420112","KQ058329v1","663480","663767","64","10756343"
"JH378153","11523660","11523874","KQ053082v1","1408848","1409073","74","10114812"
"JH378153","11857136","11857336","KQ058462v1","452919","453117","54","11404217"
"JH378153","11877612","11877920","KQ053289v1","187323","187624","60","11690289"
"JH378153","11908763","11909053","KQ053365v1","104844","105138","61","11803919"
"JH378153","11915629","11915831","KQ053288v1","4396519","4396708","60","7519110"
"JH378153","12156080","12156268","KQ053643v1","232376","232561","40","11923704"
"JH378153","12157953","12158095","KQ054921v1","3001829","3001962","32","9156124"
"JH378153","12180882","12181110","KQ056493v1","105247","105464","73","12075635"
"JH378153","12223102","12223351","KQ054058v1","2764755","2765007","75","9458347"
"JH378153","12249904","12250046","KQ057764v1","1022073","1022218","39","11227831"
"JH378153","12336377","12336655","KQ053093v1","1361295","1361576","64","10975082"
"JH378153","12438445","12438663","KQ058328v1","4557655","4557870","56","7880790"
"JH378153","12468078","12468228","KQ054180v1","70685","70834","34","12397393"
"JH378153","12468232","12468492","KQ052971v1","6441372","6441626","59","6026860"
"JH378153","12474238","12474560","KQ054804v1","52712","53011","86","12421526"
"JH378153","12520000","12520132","KQ053774v1","406836","406969","22","12113164"
"JH378153","12552649","12552916","KQ058595v1","270580","270831","66","12282069"
"JH378153","12736036","12736316","KQ054693v1","1429670","1429955","65","11306366"
"JH378153","12854385","12854505","KQ057788v1","949735","949853","36","11904650"
"JH378153","12907090","12907220","KQ053179v1","1207231","1207365","41","11699859"
"JH378153","12907286","12907352","KQ057380v1","2993795","2993866","17","9913491"
"JH378153","12922000","12922341","KQ055352v1","5905726","5906015","99","7016274"
"JH378153","12979252","12979375","KQ054113v1","1506620","1506744","32","11472632"
"JH378153","13124761","13124898","KQ052968v1","6389959","6390079","36","6734802"
"JH378153","13191095","13191218","KQ052982v1","972434","972567","34","12218661"
"JH378153","13212505","13212647","KQ053115v1","1650505","1650644","22","11562000"
"JH378153","13240861","13241152","KQ058280v1","497136","497438","74","12743725"
"JH378153","13322679","13322947","KQ058383v1","5944247","5944518","69","7378432"
"JH378153","13430729","13430943","KQ056234v1","4592339","4592554","53","8838390"
"JH378153","13434278","13434543","KQ055364v1","1515825","1516085","64","11918453"
"JH378153","13590637","13590911","KQ053454v1","649600","649875","61","12941037"
"JH378153","13669067","13669348","KQ058004v1","4701579","4701856","61","8967488"
"JH378153","13857945","13858166","KQ053115v1","723349","723574","52","13134596"
"JH378153","13880748","13880936","KQ058076v1","206234","206417","46","13674514"
"JH378153","13969021","13969156","KQ055755v1","1807261","1807395","20","12161760"
"JH378153","14111550","14111805","KQ058389v1","2110988","2111239","56","12000562"
"JH378153","14132912","14133041","KQ058550v1","2678881","2679004","28","11454031"
"JH378153","14147537","14147824","KQ058394v1","9107761","9108054","60","5039776"
"JH378153","14255070","14255205","KQ057702v1","1862724","1862857","24","12392346"
"JH378153","14260762","14261033","KQ053849v1","952727","952990","64","13308035"
"JH378153","14400936","14401053","KQ056035v1","296324","296444","18","14104612"
"JH378153","14419437","14419527","KQ054179v1","1335329","1335420","21","13084108"
"JH378153","14603717","14603831","KQ057883v1","26280","26392","22","14577437"
"JH378153","14705527","14705841","KQ057909v1","3829378","3829677","66","10876149"
"JH378153","14730749","14731055","KQ054704v1","215433","215738","62","14515316"
"JH378153","14876500","14876799","KQ058266v1","1113469","1113760","79","13763031"
"JH378153","14885661","14885956","KQ056973v1","783590","783885","74","14102071"
"JH378153","14899585","14899852","KQ055717v1","1647447","1647711","62","13252138"
"JH378153","15093102","15093239","KQ053948v1","1299259","1299390","27","13793843"
"JH378153","15124769","15125048","KQ055852v1","1231373","1231668","68","13893396"
"JH378153","15210208","15210450","KQ053212v1","1714221","1714450","69","13495987"
"JH378153","15256551","15256683","KQ054533v1","1111592","1111720","29","14144959"
"JH378153","15388270","15388560","KQ054693v1","837377","837666","62","14550893"
"JH378153","15432485","15432761","KQ053190v1","4987885","4988162","59","10444600"
"JH378153","15473192","15473497","KQ053554v1","1157184","1157483","78","14316008"
"JH378153","15523761","15524098","KQ053082v1","4919260","4919576","96","10604501"
"JH378153","16069187","16069472","KQ053409v1","3716306","3716585","68","12352881"
"JH378153","16148826","16148998","KQ053126v1","200434","200608","41","15948392"
"JH378153","16338566","16338860","KQ057875v1","561558","561851","62","15777008"
"JH378153","16387300","16387568","KQ058427v1","4553509","4553777","66","11833791"
"JH378153","16512260","16512521","KQ053498v1","3849819","3850073","76","12662441"
"JH378153","16514098","16514320","KQ056855v1","3783104","3783319","59","12730994"
"JH378154","681780","682073","KQ057118v1","4601602","4601894","64","3919822"
"JH378154","1064439","1064664","KQ054113v1","1710714","1710953","78","646275"
"JH378154","1098486","1098776","KQ054213v1","780092","780393","76","318394"
"JH378154","1230787","1231072","KQ055468v1","1908448","1908731","56","677661"
"JH378154","1273492","1273620","KQ053654v1","4929533","4929667","29","3656041"
"JH378154","1484027","1484313","KQ058184v1","1505565","1505858","81","21538"
"JH378154","1546018","1546340","KQ056014v1","335464","335774","85","1210554"
"JH378154","1566835","1566952","KQ053883v1","3387147","3387269","33","1820312"
"JH378154","1916341","1916612","KQ058275v1","597983","598269","74","1318358"
"JH378154","1991715","1992022","KQ058184v1","1505565","1505858","61","486150"
"JH378154","2284638","2284927","KQ053409v1","3716306","3716585","69","1431668"
"JH378154","3026344","3026603","KQ054652v1","4505","4775","63","3021839"
"JH378154","3314249","3314550","KQ054383v1","7970","8268","71","3306279"
"JH378154","3493346","3493620","KQ055065v1","1117201","1117481","72","2376145"
"JH378154","3978224","3978540","KQ052968v1","4333082","4333389","98","354858"
"JH378154","4579173","4579415","KQ054933v1","935520","935770","62","3643653"
"JH378154","4878501","4878636","KQ057488v1","512192","512325","28","4366309"
"JH378154","5581847","5581951","KQ056613v1","1941571","1941673","25","3640276"
"JH378154","5606513","5606800","KQ058328v1","7544499","7544779","70","1937986"
"JH378154","6769633","6769745","KQ053299v1","14559361","14559465","27","7789728"
"JH378154","6944628","6944870","KQ054069v1","159011","159235","68","6785617"
"JH378154","7005345","7005628","KQ056044v1","1867924","1868223","80","5137421"
"JH378154","7153060","7153352","KQ058184v1","1505565","1505858","61","5647495"
"JH378154","7847455","7847769","KQ054682v1","2237365","2237671","80","5610090"
"JH378154","8095771","8095953","KQ058561v1","1649916","1650101","60","6445855"
"JH378154","8138015","8138297","KQ058184v1","1608105","1608378","74","6529910"
"JH378154","8512104","8512386","KQ058316v1","3289111","3289379","80","5222993"
"JH378154","8837990","8838266","KQ057004v1","1506143","1506432","78","7331847"
"JH378154","8913476","8913802","KQ053299v1","2867160","2867464","92","6046316"
"JH378154","9134161","9134460","KQ055097v1","1884579","1884874","71","7249582"
"JH378154","9170964","9171285","KQ058485v1","518830","519142","78","8652134"
"JH378154","9242169","9242327","KQ056147v1","2168964","2169108","37","7073205"
"JH378154","9258832","9259125","KQ058527v1","4947423","4947709","72","4311409"
"JH378154","9548291","9548556","KQ057702v1","1579642","1579892","65","7968649"
"JH378154","10303568","10303837","KQ053421v1","3062266","3062539","80","7241302"
"JH378154","10311651","10311936","KQ057909v1","14641987","14642269","77","4330336"
"JH378154","10577490","10577640","KQ053498v1","3548759","3548906","33","7028731"
"JH378154","10578359","10578478","KQ058516v1","4102482","4102606","31","6475877"
"JH378154","10620299","10620577","KQ055035v1","114810","115094","70","10505489"
"JH378154","10642238","10642384","KQ056147v1","2168964","2169108","39","8473274"
"JH378154","10709638","10709947","KQ053398v1","2545768","2546067","70","8163870"
"JH378154","10807556","10807842","KQ055468v1","1908448","1908731","61","8899108"
"JH378154","10903365","10903655","KQ053565v1","754705","754987","62","10148660"
"JH378154","11041549","11041708","KQ053004v1","4759784","4759947","34","6281765"
"JH378154","11073946","11074265","KQ058004v1","2495177","2495491","70","8578769"
"JH378154","11153667","11153769","KQ053631v1","8860661","8860759","36","2293006"
"JH378154","11282041","11282224","KQ056134v1","2704736","2704912","46","8577305"
"JH378154","11285294","11285545","KQ052971v1","6441372","6441626","54","4843922"
"JH378154","11316430","11316722","KQ058324v1","623645","623935","70","10692785"
"JH378154","11387515","11387787","KQ053096v1","602899","603182","64","10784616"
"JH378154","11621991","11622125","KQ053774v1","406836","406969","29","11215155"
"JH378154","12031521","12031588","KQ056716v1","1673454","1673521","18","10358067"
"JH378154","12893804","12893959","KQ056147v1","2168964","2169108","35","10724840"
"JH378154","12903551","12903824","KQ054745v1","163102","163377","60","12740449"
"JH378154","12960389","12960670","KQ056587v1","1312432","1312709","67","11647957"
"JH378154","12987287","12987552","KQ056035v1","1769934","1770210","77","11217353"
"JH378154","13091325","13091603","KQ057909v1","14641987","14642269","80","1550662"
"JH378154","13235920","13236156","KQ053795v1","1831765","1832005","60","11404155"
"JH378154","13373396","13373682","KQ053146v1","2819587","2819868","71","10553809"
"JH378154","13449281","13449347","KQ056855v1","3190666","3190732","17","10258615"
"JH378154","13449899","13450119","KQ058328v1","2569266","2569497","68","10880633"
"JH378154","13671221","13671350","KQ053631v1","9145577","9145705","37","4525644"
"JH378154","13690728","13690821","KQ052970v1","8775146","8775235","22","4915582"
"JH378154","13735945","13736079","KQ053654v1","4929533","4929667","25","8806412"
"JH378154","13736490","13736769","KQ054826v1","9969237","9969502","73","3767253"
"JH378154","13753055","13753344","KQ055173v1","248885","249169","70","13504170"
"JH378154","13887259","13887558","KQ053816v1","7464708","7465010","75","6422551"
"JH378154","14036745","14036997","KQ055055v1","1882469","1882726","74","12154276"
"JH378154","14440547","14440855","KQ056928v1","1915686","1915996","64","12524861"
"JH378154","14586428","14586732","KQ057480v1","1031601","1031909","75","13554827"
"JH378154","14782713","14782988","KQ058004v1","2612564","2612826","69","12170149"
"JH378154","15535274","15535544","KQ053654v1","346478","346752","77","15188796"
"JH378154","15583734","15583863","KQ053409v1","6105325","6105446","26","9478409"
"JH378154","15719708","15719951","KQ054135v1","1541023","1541259","60","14178685"
"JH378154","15732824","15733125","KQ053354v1","35371","35663","83","15697453"
"JH378154","15735608","15735780","KQ055978v1","4255249","4255437","60","11480359"
"JH378154","15793261","15793569","KQ053035v1","112316","112619","66","15680945"
"JH378154","15795230","15795544","KQ057522v1","1108367","1108662","66","14686863"
"JH378154","15884816","15885100","KQ058428v1","2055160","2055453","67","13829656"
"JH378154","16131361","16131644","KQ054868v1","17131","17416","61","16114230"
"JH378154","16211174","16211455","KQ056465v1","119542","119834","80","16091632"
"JH378154","16271752","16272044","KQ058183v1","854","1141","74","16270898"
"JH378155","69419","69574","KQ057480v1","655209","655365","40","585790"
"JH378155","348177","348466","KQ058316v1","2555894","2556176","72","2207717"
"JH378155","374573","374863","KQ053740v1","2323389","2323680","69","1948816"
"JH378155","1333230","1333489","KQ058328v1","2975933","2976189","70","1642703"
"JH378155","1352565","1352880","KQ053849v1","842088","842395","68","510477"
"JH378155","1486198","1486469","KQ055331v1","476282","476544","66","1009916"
"JH378155","1539096","1539405","KQ054466v1","2183618","2183917","70","644522"
"JH378155","1546869","1547155","KQ055065v1","1117201","1117481","64","429668"
"JH378155","1563800","1563908","KQ053157v1","8174152","8174260","24","6610352"
"JH378155","1621950","1621992","KQ056672v1","5125852","5125891","9","3503902"
"JH378155","1622010","1622165","KQ058427v1","3400358","3400512","35","1778348"
"JH378155","1651863","1652157","KQ053476v1","3712115","3712409","70","2060252"
"JH378155","1705207","1705473","KQ053299v1","22323868","22324139","63","20618661"
"JH378155","1734120","1734339","KQ056166v1","1907479","1907686","52","173359"
"JH378155","2102569","2102863","KQ056331v1","348695","348980","78","1753874"
"JH378155","2193061","2193349","KQ058183v1","487423","487710","80","1705638"
"JH378155","2241881","2242161","KQ055852v1","2060276","2060554","66","181605"
"JH378155","2613676","2613951","KQ054868v1","2229582","2229854","68","384094"
"JH378155","3410036","3410361","KQ054704v1","745751","746051","100","2664285"
"JH378155","3914762","3915078","KQ055787v1","694393","694708","76","3220369"
"JH378155","4252416","4252728","KQ052969v1","9116808","9117108","76","4864392"
"JH378155","4445205","4445444","KQ058539v1","875694","875928","66","3569511"
"JH378155","4459616","4459910","KQ053096v1","602899","603182","68","3856717"
"JH378155","4647769","4648059","KQ058607v1","429760","430048","76","4218009"
"JH378155","5041470","5041757","KQ053157v1","7174603","7174889","75","2133133"
"JH378155","5199924","5200204","KQ053070v1","129472","129753","84","5070452"
"JH378155","5270221","5270514","KQ058484v1","1273599","1273890","56","3996622"
"JH378155","5699763","5700031","KQ055872v1","4131960","4132231","76","1567803"
"JH378155","6370818","6371105","KQ055787v1","1064992","1065293","74","5305826"
"JH378155","6397648","6397940","KQ056673v1","1151371","1151663","68","5246277"
"JH378155","6633225","6633522","KQ055248v1","947170","947461","65","5686055"
"JH378155","6950572","6950868","KQ058561v1","4040393","4040683","74","2910179"
"JH378155","6972421","6972533","KQ053785v1","828746","828862","26","6143675"
"JH378155","7013934","7014235","KQ053398v1","2431232","2431537","62","4582702"
"JH378155","7387378","7387664","KQ055036v1","1508392","1508683","69","5878986"
"JH378155","8636188","8636476","KQ053332v1","447571","447853","71","8188617"
"JH378155","9730748","9730970","KQ054704v1","483937","484161","61","9246811"
"JH378155","10156576","10156884","KQ058184v1","1505565","1505858","69","8651011"
"JH378155","10279952","10280018","KQ053072v1","197621","197681","15","10082331"
"JH378155","11233276","11233501","KQ057291v1","322948","323180","61","10910328"
"JH378155","11399867","11400103","KQ053686v1","2718006","2718245","64","8681861"
"JH378155","11760570","11760687","KQ053119v1","25232","25356","28","11735338"
"JH378155","11811174","11811465","KQ058427v1","7552507","7552810","73","4258667"
"JH378155","14587032","14587316","KQ055872v1","12987862","12988141","63","1599170"
"JH378155","15266200","15266514","KQ053654v1","5318679","5318982","71","9947521"
"JH378155","15324517","15324831","KQ058272v1","4942871","4943179","74","10381646"
"JH378155","15435303","15435435","KQ057883v1","1224468","1224597","27","14210835"
"JH378155","16103361","16103479","KQ058050v1","918290","918400","38","15185071"
"JH378155","16182859","16183166","KQ054628v1","3617503","3617813","76","12565356"
"JH378155","16234759","16234884","KQ058383v1","7248131","7248254","21","8986628"
"JH378155","16319018","16319152","KQ054191v1","2450802","2450939","37","13868216"
"JH378156","91865","92023","KQ056643v1","1174972","1175125","36","1083107"
"JH378156","287338","287497","KQ055404v1","3099039","3099197","39","2811701"
"JH378156","287586","287680","KQ055872v1","3969127","3969217","24","3681541"
"JH378156","626368","626617","KQ058643v1","858469","858727","70","232101"
"JH378156","687224","687522","KQ052969v1","8915694","8915990","62","8228470"
"JH378156","707797","707951","ABDC02047922v1","197","340","53","707600"
"JH378156","1176742","1176956","KQ053294v1","648","849","54","1176094"
"JH378156","1305247","1305451","KQ053872v1","262334","262548","55","1042913"
"JH378156","1324621","1324926","KQ055787v1","1064992","1065293","67","259629"
"JH378156","1590519","1590809","KQ053959v1","2303063","2303358","74","712544"
"JH378156","1835332","1835584","KQ055192v1","1201363","1201615","70","633969"
"JH378156","1871482","1871791","KQ053631v1","7288314","7288608","75","5416832"
"JH378156","2131970","2132149","KQ054510v1","2373994","2374175","47","242024"
"JH378156","2198867","2198967","KQ057290v1","2125675","2125777","33","73192"
"JH378156","2364873","2365155","KQ053146v1","2819587","2819868","66","454714"
"JH378156","2381964","2382230","KQ058538v1","1444447","1444703","61","937517"
"JH378156","2446821","2446997","KQ053631v1","9533513","9533694","41","7086692"
"JH378156","2479986","2480262","KQ053299v1","13684531","13684810","71","11204545"
"JH378156","2552286","2552573","KQ055247v1","895463","895756","51","1656823"
"JH378156","2589985","2590076","KQ056494v1","3420476","3420570","26","830491"
"JH378156","2615562","2615696","KQ057883v1","1224468","1224597","25","1391094"
"JH378156","3090616","3090903","KQ056147v1","1064032","1064323","72","2026584"
"JH378156","3116995","3117294","KQ054068v1","1099741","1100039","75","2017254"
"JH378156","3256586","3256668","KQ056147v1","2303606","2303683","30","952980"
"JH378156","3290330","3290372","KQ053686v1","2686865","2686920","20","603465"
"JH378156","3291202","3291296","KQ053223v1","2552349","2552442","21","738853"
"JH378156","3411062","3411189","KQ054671v1","1335497","1335616","25","2075565"
"JH378156","3608996","3609304","KQ053476v1","4769064","4769369","69","1160068"
"JH378156","3640185","3640486","KQ052968v1","5194409","5194696","75","1554224"
"JH378156","4034587","4034874","KQ053740v1","2323389","2323680","69","1711198"
"JH378156","4207096","4207307","KQ055987v1","321281","321487","62","3885815"
"JH378156","4275205","4275349","KQ055384v1","843998","844147","35","3431207"
"JH378156","4296360","4296635","KQ055353v1","1973943","1974227","71","2322417"
"JH378156","4367838","4368143","KQ054879v1","1971571","1971875","61","2396267"
"JH378156","4505262","4505438","KQ054725v1","2305706","2305894","51","2199556"
"JH378156","4602852","4603141","KQ053763v1","141096","141389","56","4461756"
"JH378156","4665870","4666130","KQ057345v1","1938824","1939073","61","2727046"
"JH378156","5476320","5476626","KQ052968v1","6282633","6282918","73","806313"
"JH378156","5602354","5602678","KQ053816v1","7464708","7465010","74","1862354"
"JH378156","5895611","5895742","KQ056147v1","1828259","1828388","27","4067352"
"JH378156","5906200","5906289","KQ058427v1","9575453","9575522","30","3669253"
"JH378156","6123215","6123426","KQ052969v1","8528994","8529192","54","2405779"
"JH378156","6851824","6852097","KQ055247v1","216427","216708","68","6635397"
"JH378156","8319166","8319465","KQ058184v1","1505565","1505858","67","6813601"
"JH378156","8416022","8416341","KQ053025v1","49730","50045","75","8366292"
"JH378156","8465369","8465677","KQ055549v1","787933","788233","76","7677436"
"JH378156","8646308","8646443","KQ056147v1","2896905","2897037","31","5749403"
"JH378156","8847274","8847566","KQ057397v1","393128","393422","74","8454146"
"JH378156","8886852","8887163","KQ053398v1","2431232","2431537","77","6455620"
"JH378156","9080438","9080592","KQ055872v1","9395394","9395552","40","314956"
"JH378156","9701945","9702009","KQ053072v1","197621","197681","19","9504324"
"JH378156","10118450","10118606","KQ055384v1","843998","844147","35","9274452"
"JH378156","10444550","10444858","KQ053299v1","4095914","4096215","70","6348636"
"JH378156","10667966","10668197","KQ058487v1","1040716","1040932","68","9627250"
"JH378156","10721186","10721299","KQ053609v1","1892948","1893072","40","8828238"
"JH378156","10731621","10731907","KQ056672v1","3082150","3082439","55","7649471"
"JH378156","11104043","11104174","KQ053565v1","1793162","1793293","21","9310881"
"JH378156","11123933","11124204","KQ058004v1","1480411","1480689","64","9643522"
"JH378156","11277359","11277526","KQ057336v1","635116","635282","37","10642243"
"JH378156","11301318","11301602","KQ055787v1","155952","156239","79","11145366"
"JH378156","11321436","11321703","KQ053686v1","963025","963293","65","10358411"
"JH378156","11401124","11401448","KQ053654v1","5318679","5318982","80","6082445"
"JH378156","12048426","12048693","KQ058383v1","2699813","2700083","72","9348613"
"JH378156","12170896","12171184","KQ053299v1","21835674","21835971","72","9664778"
"JH378156","13253850","13254139","KQ058383v1","5074137","5074420","80","8179713"
"JH378156","13745021","13745307","KQ053361v1","85477","85759","65","13659544"
"JH378156","13829202","13829501","KQ057911v1","428931","429228","63","13400271"
"JH378156","14440264","14440575","KQ053299v1","4095914","4096215","72","10344350"
"JH378156","15632498","15632654","KQ053037v1","3255963","3256108","41","12376535"
"JH378156","15740105","15740234","KQ055141v1","3481451","3481584","27","12258654"
"JH378156","15782902","15783135","KQ057522v1","1670299","1670546","76","14112603"
"JH378156","15790825","15791109","KQ058113v1","209342","209622","67","15581483"
"JH378156","16112233","16112523","KQ058272v1","5443874","5444159","64","10668359"
"JH378156","16294927","16295219","KQ053190v1","5495992","5496283","69","10798935"
"JH378157","178356","178472","KQ053785v1","828746","828862","27","650390"
"JH378157","868104","868340","KQ054279v1","1133071","1133299","53","264967"
"JH378157","1026124","1026255","KQ057268v1","150223","150357","25","875901"
"JH378157","1718850","1718979","KQ054312v1","1452387","1452515","19","266463"
"JH378157","2023998","2024299","KQ056672v1","3082150","3082439","65","1058152"
"JH378157","2048746","2049050","KQ053816v1","7464708","7465010","60","5415962"
"JH378157","2336571","2336889","KQ054910v1","1541067","1541374","79","795504"
"JH378157","2598404","2598708","KQ052984v1","105454","105757","52","2492950"
"JH378157","2678435","2678547","KQ058050v1","918290","918400","22","1760145"
"JH378157","3149252","3149472","KQ058274v1","391536","391765","63","2757716"
"JH378157","3184162","3184334","KQ058407v1","217537","217702","44","2966625"
"JH378157","3197452","3197585","KQ054510v1","2941967","2942098","27","255485"
"JH378157","3361883","3362196","KQ056673v1","1151371","1151663","80","2210512"
"JH378157","3588204","3588357","KQ057118v1","1492016","1492164","36","2096188"
"JH378157","4209446","4209733","KQ056432v1","1593337","1593624","64","2616109"
"JH378157","5145275","5145565","KQ055247v1","1761880","1762166","72","3383395"
"JH378157","6088881","6089115","KQ053093v1","1363144","1363361","67","4725737"
"JH378157","6176043","6176172","KQ057910v1","1548802","1548933","24","4627241"
"JH378157","6669014","6669278","KQ053026v1","3680523","3680807","75","2988491"
"JH378157","6702975","6703225","KQ058389v1","2110988","2111239","50","4591987"
"JH378157","6816348","6816476","KQ057910v1","1548802","1548933","31","5267546"
"JH378157","6846367","6846528","KQ053740v1","1071467","1071623","30","5774900"
"JH378157","6859935","6860109","KQ055044v1","270762","270957","55","6589173"
"JH378157","6901839","6902132","KQ052984v1","105454","105757","74","6796385"
"JH378157","7023463","7023761","KQ053059v1","3421896","3422194","60","3601567"
"JH378157","7076459","7076731","KQ058427v1","3703679","3703944","71","3372780"
"JH378157","7404515","7404794","KQ058004v1","3112196","3112474","75","4292319"
"JH378157","7422869","7422975","KQ053398v1","5101348","5101453","31","2321521"
"JH378157","7579938","7580216","KQ055540v1","4545763","4546052","67","3034175"
"JH378157","7836157","7836439","KQ056432v1","1593337","1593624","70","6242820"
"JH378157","7863301","7863422","KQ053487v1","3798719","3798837","23","4064582"
"JH378157","7864065","7864246","KQ056404v1","1194679","1194865","43","6669386"
"JH378157","7942191","7942326","KQ054312v1","1452387","1452515","37","6489804"
"JH378157","7958254","7958393","KQ055375v1","281063","281205","38","7677191"
"JH378157","8218434","8218700","KQ054289v1","4355551","4355817","65","3862883"
"JH378157","8511238","8511496","KQ053763v1","17735","18009","74","8493503"
"JH378157","8546769","8547022","KQ055352v1","3968278","3968546","68","4578491"
"JH378157","8630391","8630487","KQ055384v1","267995","268089","20","8362396"
"JH378157","8738400","8738693","KQ053827v1","4198964","4199247","60","4539436"
"JH378157","8745626","8745930","KQ053081v1","2388028","2388336","78","6357598"
"JH378157","8756100","8756308","KQ055717v1","640981","641187","56","8115119"
"JH378157","8843409","8843586","KQ057673v1","2220920","2221103","43","6622489"
"JH378157","8853900","8854199","KQ058272v1","6007682","6007982","71","2846218"
"JH378157","9015308","9015574","KQ058427v1","5781896","5782172","79","3233412"
"JH378157","9016577","9016722","KQ053465v1","864117","864263","35","8152460"
"JH378157","9039796","9039873","KQ055695v1","1060551","1060630","20","7979245"
"JH378157","9040083","9040382","KQ053476v1","1823610","1823912","79","7216473"
"JH378157","9050308","9050449","KQ054378v1","157932","158074","36","8892376"
"JH378157","9060014","9060154","KQ053115v1","1650505","1650644","27","7409509"
"JH378157","9081797","9082096","KQ054565v1","2548872","2549165","99","6532925"
"JH378157","9094926","9095215","KQ054682v1","1577967","1578262","68","7516959"
"JH378157","9153514","9153806","KQ053146v1","2819587","2819868","71","6333927"
"JH378157","9276212","9276502","KQ058184v1","1505565","1505858","62","7770647"
"JH378157","9283430","9283557","KQ054533v1","1111592","1111720","30","8171838"
"JH378157","9296622","9296757","KQ053115v1","1650505","1650644","33","7646117"
"JH378157","9300292","9300536","KQ058094v1","6815572","6815819","71","2484720"
"JH378157","9407206","9407474","KQ058184v1","1505565","1505858","75","7901641"
"JH378157","9430854","9431143","KQ058184v1","1505565","1505858","59","7925289"
"JH378157","9437892","9438057","KQ054943v1","3338657","3338793","46","6099235"
"JH378157","9455723","9455893","KQ056587v1","7602017","7602187","47","1853706"
"JH378157","9500736","9500894","KQ055183v1","2514156","2514302","38","6986580"
"JH378157","9544678","9544967","KQ058554v1","614936","615231","78","8929742"
"JH378157","9565895","9566186","KQ056147v1","1064032","1064323","64","8501863"
"JH378157","9580322","9580593","KQ052968v1","8601947","8602202","72","978375"
"JH378157","9807422","9807712","KQ053299v1","21835674","21835971","64","12028252"
"JH378157","9861861","9862160","KQ053343v1","2900708","2901000","76","6961153"
"JH378157","9863565","9863867","KQ058582v1","1599482","1599782","66","8264083"
"JH378157","10113369","10113681","KQ055457v1","2061137","2061448","74","8052232"
"JH378157","10429914","10430224","KQ058606v1","232956","233258","68","10196958"
"JH378157","10760217","10760502","KQ053740v1","716482","716767","64","10043735"
"JH378157","10784533","10784833","KQ053631v1","7288314","7288608","65","3496219"
"JH378157","10810736","10810883","KQ054401v1","3742804","3742954","33","7067932"
"JH378157","10811675","10811771","KQ056494v1","3420476","3420570","28","7391199"
"JH378157","10909703","10909992","KQ054932v1","10830322","10830609","63","79381"
"JH378157","11072066","11072208","KQ053631v1","8603317","8603457","26","2468749"
"JH378157","11093564","11093774","KQ052968v1","13131640","13131834","65","2038076"
"JH378157","11129212","11129477","KQ058353v1","1449127","1449389","67","9680085"
"JH378157","11253078","11253301","KQ057431v1","2411902","2412116","51","8841176"
"JH378157","11257009","11257306","KQ054069v1","7687863","7688158","65","3569146"
"JH378157","11587230","11587352","KQ053157v1","8174152","8174260","35","3413078"
"JH378157","11599069","11599222","KQ056147v1","2168964","2169108","35","9430105"
"JH378157","11600127","11600248","KQ057013v1","833647","833765","31","10766480"
"JH378157","11602355","11602651","KQ052982v1","252378","252680","62","11349977"
"JH378157","11605436","11605589","KQ056147v1","2168964","2169108","35","9436472"
"JH378157","11606494","11606615","KQ057013v1","833647","833765","31","10772847"
"JH378157","11610942","11611237","KQ058184v1","1505565","1505858","72","10105377"
"JH378157","11711485","11711789","KQ054973v1","358404","358708","75","11353081"
"JH378157","11713972","11714164","KQ055141v1","963624","963817","55","10750348"
"JH378157","11827490","11827716","KQ055935v1","436277","436509","63","11391213"
"JH378157","12163948","12164085","KQ058427v1","4756553","4756686","25","7407395"
"JH378157","12729069","12729232","KQ054533v1","1027813","1027974","33","11701256"
"JH378157","12897712","12898019","KQ058427v1","7552507","7552810","69","5345205"
"JH378157","12909143","12909442","KQ058428v1","2055160","2055453","65","10853983"
"JH378157","12924719","12924990","KQ053520v1","2992926","2993205","61","9931793"
"JH378157","13132024","13132298","KQ053409v1","3716306","3716585","60","9415718"
"JH378157","13206648","13206961","KQ054682v1","2125705","2126015","64","11080943"
"JH378157","13208822","13209109","KQ055394v1","3441211","3441489","77","9767611"
"JH378157","13267118","13267436","KQ053115v1","3485337","3485650","72","9781781"
"JH378157","13391975","13392266","KQ053146v1","2819587","2819868","72","10572388"
"JH378157","13623138","13623254","KQ052969v1","2661859","2661968","26","10961279"
"JH378157","13708378","13708686","KQ058183v1","487423","487710","83","13220955"
"JH378157","13749213","13749346","KQ057649v1","141749","141881","25","13607464"
"JH378157","13808228","13808505","KQ053190v1","4987885","4988162","66","8820343"
"JH378157","14355833","14356048","KQ054660v1","4522544","4522737","74","9833289"
"JH378157","14511904","14512197","KQ054412v1","2490468","2490761","72","12021436"
"JH378157","14681357","14681650","KQ054693v1","832788","833076","63","13848569"
"JH378157","14978317","14978613","KQ054069v1","7687863","7688158","55","7290454"
"JH378157","15463150","15463265","KQ058346v1","532513","532625","29","14930637"
"JH378157","15480731","15481005","KQ058328v1","6293951","6294242","69","9186780"
"JH378157","15539329","15539484","KQ053157v1","5478543","5478695","40","10060786"
"JH378157","15734099","15734372","KQ053631v1","8893553","8893834","67","6840546"
"JH378157","15803554","15803851","KQ058004v1","3883150","3883446","66","11920404"
"JH378158","49867","50166","KQ053288v1","2218996","2219287","73","2169129"
"JH378158","64400","64688","KQ056093v1","1723775","1724065","77","1659375"
"JH378158","81355","81651","KQ053299v1","2867160","2867464","75","2785805"
"JH378158","132129","132414","KQ054068v1","3341291","3341579","63","3209162"
"JH378158","153623","153925","KQ056996v1","837133","837431","70","683510"
"JH378158","171285","171561","KQ058383v1","5944247","5944518","75","5772962"
"JH378158","436905","437191","KQ052981v1","658787","659079","66","221882"
"JH378158","532285","532560","KQ054069v1","7026364","7026639","76","6494079"
"JH378158","558104","558379","KQ054289v1","4355551","4355817","66","3797447"
"JH378158","565187","565466","KQ057737v1","3317482","3317762","84","2752295"
"JH378158","592588","592883","KQ054213v1","780092","780393","55","187504"
"JH378158","708656","708776","KQ058473v1","392626","392756","29","316030"
"JH378158","759014","759279","KQ055725v1","3090816","3091074","57","2331802"
"JH378158","772136","772396","KQ052971v1","6441372","6441626","63","5669236"
"JH378158","839537","839709","KQ054725v1","735942","736116","36","103595"
"JH378158","909983","910202","KQ054826v1","9981760","9981967","59","9071777"
"JH378158","994400","994519","KQ058346v1","532513","532625","25","461887"
"JH378158","998698","998795","KQ055024v1","329599","329697","17","669099"
"JH378158","1045902","1046196","KQ058353v1","1264780","1265071","65","218878"
"JH378158","1543371","1543661","KQ053554v1","2471177","2471484","77","927806"
"JH378158","1627454","1627742","KQ058428v1","1609842","1610139","67","17612"
"JH378158","2169877","2170168","KQ052970v1","4083831","4084116","68","1913954"
"JH378158","2559212","2559344","KQ057910v1","1548802","1548933","25","1010410"
"JH378158","2809059","2809196","KQ053115v1","1333586","1333718","23","1475473"
"JH378158","2918434","2918569","KQ053982v1","3934263","3934401","32","1015829"
"JH378158","3051056","3051336","KQ058561v1","583947","584226","64","2467109"
"JH378158","3228754","3229028","KQ053795v1","370451","370712","58","2858303"
"JH378158","3306820","3307027","KQ055798v1","993074","993294","64","2313746"
"JH378158","3326609","3326851","KQ057522v1","1670299","1670546","73","1656310"
"JH378158","3455019","3455325","KQ058283v1","622348","622657","72","2832671"
"JH378158","3519275","3519586","KQ058004v1","2495177","2495491","66","1024098"
"JH378158","3521243","3521522","KQ054124v1","2442155","2442433","67","1079088"
"JH378158","3631966","3632256","KQ053288v1","2218996","2219287","70","1412970"
"JH378158","3644862","3645064","KQ054533v1","1766391","1766592","62","1878471"
"JH378158","3645212","3645321","KQ057909v1","4153593","4153709","33","508381"
"JH378158","3691224","3691487","KQ054400v1","446491","446757","60","3244733"
"JH378158","3732406","3732695","KQ058383v1","2699813","2700083","85","1032593"
"JH378158","3738338","3738628","KQ053288v1","2218996","2219287","56","1519342"
"JH378158","3917508","3917802","KQ054693v1","832788","833076","65","3084720"
"JH378158","4114097","4114396","KQ053795v1","1714401","1714699","65","2399696"
"JH378158","4346120","4346379","KQ055457v1","1902633","1902878","63","2443487"
"JH378158","4461256","4461437","KQ056440v1","1044527","1044709","42","3416729"
"JH378158","4671337","4671634","KQ054191v1","3857584","3857880","66","813753"
"JH378158","4812509","4812800","KQ057099v1","274308","274596","73","4538201"
"JH378158","4819261","4819535","KQ053409v1","5686466","5686740","68","867205"
"JH378158","4959020","4959157","KQ055097v1","2621016","2621150","30","2338004"
"JH378158","5058499","5058805","KQ054401v1","2629005","2629296","71","2429494"
"JH378158","5234852","5235090","KQ055651v1","1261019","1261268","72","3973833"
"JH378158","5378348","5378644","KQ053752v1","464138","464437","76","4914210"
"JH378158","5536368","5536527","KQ052968v1","10427732","10427888","33","4891364"
"JH378158","5614236","5614524","KQ053696v1","325593","325885","65","5288643"
"JH378158","5640607","5640904","KQ058184v1","1505565","1505858","55","4135042"
"JH378158","5869271","5869578","KQ056928v1","1915686","1915996","65","3953585"
"JH378158","6200347","6200639","KQ058585v1","580456","580763","76","5619891"
"JH378158","6213299","6213594","KQ054191v1","3583730","3584032","79","2629569"
"JH378158","7200480","7200567","KQ055662v1","3028941","3029027","20","4171539"
"JH378158","7291163","7291462","KQ054525v1","45769","46078","70","7245394"
"JH378158","7508513","7508675","KQ055425v1","1445594","1445758","37","6062919"
"JH378158","7799098","7799357","KQ055192v1","1201363","1201615","70","6597735"
"JH378158","7812837","7813131","KQ054412v1","2490468","2490761","61","5322369"
"JH378158","8077787","8078101","KQ058315v1","658193","658490","74","7419594"
"JH378158","8733935","8734193","KQ055192v1","996310","996558","74","7737625"
"JH378158","8814371","8814503","KQ056652v1","675563","675695","24","8138808"
"JH378158","8884622","8884910","KQ057290v1","1053741","1054027","61","7830881"
"JH378158","10341173","10341468","KQ054356v1","1600089","1600380","70","8741084"
"JH378158","10624354","10624715","KQ055629v1","1214508","1214831","117","9409846"
"JH378158","10920163","10920309","KQ057118v1","1492016","1492164","40","9428147"
"JH378158","10920361","10920580","KQ053872v1","262334","262548","54","10658027"
"JH378158","11092546","11092766","KQ053093v1","2180735","2180954","52","8911811"
"JH378158","11099216","11099380","KQ057737v1","1426090","1426247","33","9673126"
"JH378158","11264667","11264879","KQ057034v1","3957140","3957365","65","7307527"
"JH378158","11935081","11935394","KQ055767v1","2455394","2455703","74","9479687"
"JH378158","11974006","11974279","KQ058577v1","148492","148755","78","11825514"
"JH378158","13338031","13338175","KQ058389v1","1559421","1559572","40","11778610"
"JH378158","13521813","13521945","KQ058304v1","1601806","1601935","28","11920007"
"JH378158","13752037","13752323","KQ053520v1","2913074","2913361","66","10838963"
"JH378158","14005625","14005869","KQ057909v1","3387416","3387657","66","10618209"
"JH378158","14123066","14123209","KQ053212v1","578976","579120","33","13544090"
"JH378158","14250891","14251037","KQ054693v1","1748877","1749022","45","12502014"
"JH378158","14344663","14344951","KQ055872v1","8751058","8751357","82","5593605"
"JH378158","14780951","14781208","KQ056965v1","1346676","1346924","69","13434275"
"JH378158","15229860","15230144","KQ053960v1","70067","70362","89","15159793"
"JH378158","15331923","15332086","KQ058461v1","3297582","3297739","46","12034341"
"JH378158","15691927","15692144","KQ053398v1","3158290","3158500","49","12533637"
"JH378158","15778207","15778391","KQ056475v1","396846","397033","60","15381361"
"JH378159","855339","855634","KQ058184v1","1505565","1505858","61","650226"
"JH378159","876658","876931","KQ053331v1","97381","97652","79","779277"
"JH378159","879901","880029","KQ053343v1","2309705","2309836","28","1429804"
"JH378159","880410","880564","KQ054196v1","237","387","40","880173"
"JH378159","1014391","1014672","KQ054401v1","3124044","3124323","70","2109653"
"JH378159","1016004","1016133","KQ053565v1","1793162","1793293","25","777158"
"JH378159","1327646","1327926","KQ053696v1","3248742","3249021","63","1921096"
"JH378159","1412283","1412573","KQ057737v1","110075","110366","62","1302208"
"JH378159","1427879","1428189","KQ053299v1","6038380","6038679","71","4610501"
"JH378159","1444583","1444865","KQ053598v1","2814990","2815277","65","1370407"
"JH378159","1527141","1527427","KQ058294v1","6026641","6026920","66","4499500"
"JH378159","1606389","1606542","KQ055872v1","5870772","5870928","42","4264383"
"JH378159","1640530","1640834","KQ053082v1","1023453","1023747","75","617077"
"JH378159","1841956","1842265","KQ058328v1","2590769","2591069","76","748813"
"JH378159","2668726","2669041","KQ053795v1","1729459","1729773","64","939267"
"JH378159","3124209","3124433","KQ058572v1","2891446","2891664","60","232763"
"JH378159","3600090","3600269","KQ058571v1","931737","931906","40","2668353"
"JH378159","3605273","3605560","KQ057664v1","556486","556781","80","3048787"
"JH378159","3690976","3691124","KQ055406v1","3895","4043","39","3687081"
"JH378159","3712530","3712837","KQ055957v1","671574","671880","67","3040956"
"JH378159","3772085","3772343","KQ054576v1","657552","657814","61","3114533"
"JH378159","3905094","3905204","KQ057151v1","758089","758204","39","3147005"
"JH378159","4161491","4161786","KQ055097v1","1884579","1884874","60","2276912"
"JH378159","4192006","4192162","KQ055957v1","1679850","1680008","31","2512156"
"JH378159","4218972","4219097","KQ058399v1","1636419","1636543","28","2582553"
"JH378159","4227368","4227649","KQ055777v1","2252512","2252796","61","1974856"
"JH378159","4268578","4268710","KQ053354v1","702320","702452","21","3566258"
"JH378159","4356245","4356553","KQ056432v1","119334","119643","67","4236911"
"JH378159","4480053","4480363","KQ053299v1","4095914","4096215","64","384139"
"JH378159","4522001","4522122","KQ056035v1","296324","296444","22","4225677"
"JH378159","4597571","4597827","KQ055457v1","1902633","1902878","68","2694938"
"JH378159","4772487","4772656","KQ058494v1","10142546","10142705","49","5370059"
"JH378159","5126661","5126941","KQ057129v1","1786","2062","74","5124875"
"JH378159","5451722","5451929","KQ056493v1","886447","886648","51","4565275"
"JH378159","5931708","5932004","KQ053398v1","11302","11591","82","5920406"
"JH378159","6090962","6091249","KQ053631v1","5528922","5529218","70","562040"
"JH378159","7068352","7068641","KQ058317v1","5506620","5506904","65","1561732"
"JH378159","7360794","7361075","KQ056147v1","1747366","1747648","75","5613428"
"JH378159","7453748","7453903","KQ053202v1","830653","830812","40","6623095"
"JH378159","7454104","7454204","KQ058468v1","653772","653877","30","6800332"
"JH378159","7557377","7557666","KQ054168v1","1784797","1785101","72","5772580"
"JH378159","7893027","7893311","KQ056827v1","989698","989981","57","6903329"
"JH378159","8102563","8102791","KQ054069v1","159011","159235","52","7943552"
"JH378159","8127169","8127467","KQ056345v1","621994","622295","70","7505175"
"JH378159","8189626","8189905","KQ052970v1","7682876","7683140","75","506750"
"JH378159","8270654","8270965","KQ053816v1","7043043","7043343","83","1227611"
"JH378159","8458246","8458445","KQ054400v1","319216","319421","50","8139030"
"JH378159","8470984","8471250","KQ058427v1","3703679","3703944","69","4767305"
"JH378159","8515754","8516058","KQ054202v1","943374","943681","72","7572380"
"JH378159","8782153","8782394","KQ055978v1","4184612","4184858","80","4597541"
"JH378159","8939023","8939310","KQ055035v1","4381466","4381744","74","4557557"
"JH378159","9531516","9531844","KQ053135v1","5174837","5175166","94","4356679"
"JH378159","10722191","10722447","KQ058616v1","1966485","1966734","59","8755706"
"JH378159","11039393","11039681","KQ057136v1","685943","686219","72","10353450"
"JH378159","11051096","11051230","KQ053108v1","477534","477668","24","10573562"
"JH378159","11322463","11322752","KQ057737v1","3083543","3083824","77","8238920"
"JH378159","11390673","11390839","KQ056965v1","118773","118937","38","11271900"
"JH378159","11480465","11480748","KQ053299v1","2118230","2118517","62","9362235"
"JH378159","12136932","12137221","KQ053104v1","1894209","1894491","80","10242723"
"JH378159","12150631","12150937","KQ055119v1","3293975","3294284","70","8856656"
"JH378159","12379557","12379897","KQ058583v1","2292745","2293066","98","10086812"
"JH378159","12601929","12602008","KQ053060v1","4849","4931","16","12597080"
"JH378159","12627990","12628275","KQ058317v1","5506620","5506904","66","7121370"
"JH378159","12699224","12699493","KQ055248v1","2793952","2794228","73","9905272"
"JH378159","12706160","12706438","KQ053476v1","3998036","3998311","76","8708124"
"JH378159","12792303","12792609","KQ053816v1","7464708","7465010","80","5327595"
"JH378159","13155068","13155207","KQ056147v1","2168964","2169108","32","10986104"
"JH378159","13155354","13155461","KQ055903v1","184486","184598","29","12970868"
"JH378159","13248965","13249256","KQ052969v1","11182978","11183250","62","2065987"
"JH378159","13464268","13464468","KQ053223v1","773388","773584","65","12690880"
"JH378159","13487851","13488147","KQ053299v1","21869448","21869738","73","8381597"
"JH378159","13676379","13676570","KQ056423v1","1148199","1148381","60","12528180"
"JH378159","14127525","14127811","KQ058257v1","559477","559763","71","13568048"
"JH378159","14614790","14615030","KQ058360v1","26261","26480","79","14588529"
"JH378159","15098633","15098899","KQ055141v1","254262","254544","62","14844371"
"JH378159","15237324","15237607","KQ053409v1","3716306","3716585","64","11521018"
"JH378159","15373393","15373649","KQ055414v1","149964","150226","75","15223429"
"JH378159","15409394","15409653","KQ058389v1","2110988","2111239","58","13298406"
"JH378159","15437265","15437377","KQ053883v1","4947576","4947690","25","10489689"
"JH378159","15444846","15445139","KQ053774v1","2397082","2397375","72","13047764"
"JH378159","15451167","15451459","KQ053774v1","2397082","2397375","72","13054085"
"JH378159","15455181","15455452","KQ055735v1","1022582","1022853","62","14432599"
"JH378159","15456527","15456831","KQ053432v1","3634372","3634675","75","11822155"
"JH378159","15609226","15609528","KQ054786v1","1481220","1481519","67","14128006"
"JH378159","15680656","15680775","KQ057151v1","758089","758204","39","14922567"
"JH378159","15680907","15681017","KQ058050v1","918290","918400","26","14762617"
"JH378159","15790927","15791213","KQ055629v1","4831189","4831479","79","10959738"
"JH378159","15813261","15813417","KQ057737v1","3826261","3826415","42","11987000"
"JH378159","15862156","15862437","KQ055140v1","3362733","3363019","67","12499423"
"JH378159","16033473","16033584","KQ055404v1","3929342","3929457","35","12104131"
"JH378159","16120808","16120958","KQ058427v1","3400358","3400512","37","12720450"
"JH378159","16130971","16131246","KQ054124v1","2442155","2442433","71","13688816"
"JH378159","16147242","16147323","KQ055946v1","371653","371727","24","15775589"
"JH378159","16157279","16157503","KQ054704v1","483937","484161","64","15673342"
"JH378160","297327","297622","KQ053631v1","9631170","9631468","64","9333843"
"JH378160","576940","577289","KQ056673v1","1004724","1005090","132","427784"
"JH378160","591007","591281","KQ056494v1","2222182","2222467","68","1631175"
"JH378160","1660881","1661103","KQ053082v1","1408848","1409073","62","252033"
"JH378160","1898984","1899283","KQ058427v1","6988722","6989008","73","5089738"
"JH378160","2347498","2347776","KQ053332v1","447571","447853","69","1899927"
"JH378160","2460995","2461192","KQ054848v1","194460","194660","56","2266535"
"JH378160","3772805","3773090","KQ053421v1","3062266","3062539","72","710539"
"JH378160","4515858","4516038","KQ055871v1","2","180","41","4515856"
"JH378160","4570268","4570558","KQ056643v1","431969","432259","57","4138299"
"JH378160","4617866","4618179","KQ058577v1","505780","506079","141","4112086"
"JH378160","4625744","4626033","KQ056928v1","2303396","2303675","65","2322348"
"JH378160","4741317","4741610","KQ056035v1","1507771","1508068","68","3233546"
"JH378160","4830231","4830529","KQ055014v1","3089851","3090151","71","1740380"
"JH378160","5552363","5552451","KQ053432v1","5774004","5774087","22","221641"
"JH378160","5555664","5555954","KQ054693v1","832788","833076","68","4722876"
"JH378160","5668060","5668361","KQ053190v1","5623449","5623748","68","44611"
"JH378160","5722974","5723287","KQ054693v1","3864984","3865298","72","1857990"
"JH378160","5812742","5813010","KQ053487v1","3306049","3306316","63","2506693"
"JH378160","5844397","5844664","KQ056855v1","5905673","5905935","68","61276"
"JH378160","5863944","5864225","KQ056368v1","571844","572113","86","5292100"
"JH378160","5904986","5905290","KQ053741v1","2418696","2419001","67","3486290"
"JH378160","5921886","5922170","KQ058383v1","5944247","5944518","72","22361"
"JH378160","5968687","5968821","KQ053850v1","709379","709515","27","5259308"
"JH378160","6027413","6027678","KQ057840v1","682650","682933","81","5344763"
"JH378160","6194340","6194617","KQ053096v1","602899","603182","69","5591441"
"JH378160","6796062","6796370","KQ053072v1","422061","422353","89","6374001"
"JH378160","7053384","7053685","KQ052970v1","10427454","10427754","73","3374070"
"JH378160","7135955","7136209","KQ054804v1","1007773","1008011","74","6128182"
"JH378160","8401510","8401794","KQ053297v1","44026","44315","65","8357484"
"JH378160","8771185","8771480","KQ053631v1","7943206","7943503","63","827979"
"JH378160","8958968","8959239","KQ058494v1","4837812","4838086","66","4121156"
"JH378160","9085945","9086232","KQ054069v1","7026364","7026639","69","2059581"
"JH378160","10520808","10520987","KQ052981v1","215622","215797","42","10305186"
"JH378160","10526834","10527112","KQ058004v1","1480411","1480689","64","9046423"
"JH378160","10606354","10606667","KQ054525v1","45769","46078","63","10560585"
"JH378160","10636969","10637048","KQ058505v1","6586082","6586163","11","4050887"
"JH378160","10743545","10743824","KQ056432v1","1593337","1593624","73","9150208"
"JH378160","11071751","11071972","KQ057345v1","223285","223507","61","10848466"
"JH378160","11111760","11111942","KQ056587v1","7602017","7602187","48","3509743"
"JH378160","11247469","11247579","KQ054323v1","1973428","1973538","18","9274041"
"JH378160","11296706","11296992","KQ052969v1","11082995","11083279","74","213711"
"JH378160","11370445","11370695","KQ055375v1","3672008","3672286","73","7698437"
"JH378160","11627703","11627831","KQ058004v1","2254984","2255111","24","9372719"
"JH378160","11663242","11663516","KQ058305v1","3899980","3900272","71","7763262"
"JH378160","11689782","11690077","KQ055540v1","208375","208677","65","11481407"
"JH378160","11707932","11708066","KQ055192v1","1759958","1760089","23","9947974"
"JH378160","11717238","11717538","KQ058184v1","1505565","1505858","72","10211673"
"JH378160","11895646","11895920","KQ054069v1","7026364","7026639","70","4869282"
"JH378160","11968254","11968385","KQ058576v1","401936","402067","25","11566318"
"JH378160","11968710","11968833","KQ056368v1","2150446","2150570","28","9818264"
"JH378160","11972966","11973143","KQ054660v1","3679956","3680128","45","8293010"
"JH378160","11973841","11973949","KQ053310v1","1622751","1622859","27","10351090"
"JH378160","12051362","12051572","KQ053959v1","3147544","3147761","50","8903818"
"JH378160","12310050","12310337","KQ058577v1","505780","506079","68","11804270"
"JH378160","12375441","12375585","KQ053115v1","1650505","1650644","33","10724936"
"JH378160","12375888","12375981","KQ057821v1","1407299","1407387","31","10968589"
"JH378160","12376123","12376174","KQ054839v1","3569","3615","19","12372554"
"JH378160","12460364","12460532","KQ056996v1","1524030","1524195","35","10936334"
"JH378160","12469951","12470078","KQ054522v1","1628214","1628331","34","10841737"
"JH378160","12472768","12473031","KQ053609v1","2550928","2551200","66","9921840"
"JH378160","12481479","12481784","KQ058372v1","1866883","1867182","85","10614596"
"JH378160","12579953","12580243","KQ054202v1","1197930","1198217","62","11382023"
"JH378160","12580952","12581255","KQ058146v1","160981","161283","70","12419971"
"JH378160","12610593","12610644","KQ053260v1","77779","77831","12","12532814"
"JH378160","12611569","12611671","KQ053763v1","508269","508363","35","12103300"
"JH378160","12680995","12681280","KQ053631v1","9963313","9963601","65","2717682"
"JH378160","12688022","12688282","KQ054510v1","2417726","2417985","63","10270296"
"JH378160","12719980","12720236","KQ058427v1","4553509","4553777","68","8166471"
"JH378160","12742113","12742390","KQ055014v1","2491689","2491976","77","10250424"
"JH378160","12779851","12780137","KQ054660v1","2994204","2994490","73","9785647"
"JH378160","12789401","12789643","KQ055457v1","1902633","1902878","75","10886768"
"JH378160","12819593","12819755","KQ057023v1","876183","876346","41","11943410"
"JH378160","12894456","12894600","KQ054068v1","3810713","3810858","31","9083743"
"JH378160","12899181","12899342","KQ056855v1","3850449","3850612","36","9048732"
"JH378160","12932483","12932770","KQ056643v1","431969","432259","68","12500514"
"JH378160","13025887","13026204","KQ057380v1","6646151","6646454","78","6379736"
"JH378160","13119094","13119382","KQ055872v1","2776548","2776830","77","10342546"
"JH378160","13204995","13205145","KQ056147v1","2168964","2169108","34","11036031"
"JH378160","13248071","13248145","KQ052968v1","9483686","9483763","28","3764385"
"JH378160","13256135","13256425","KQ053288v1","2218996","2219287","69","11037139"
"JH378160","13419375","13419700","KQ058184v1","1505565","1505858","90","11913810"
"JH378160","13564618","13564682","KQ054412v1","1720542","1720608","22","11844076"
"JH378160","13685255","13685545","KQ054818v1","7909","8189","80","13677346"
"JH378160","13796631","13796880","KQ058503v1","123813","124064","53","13672818"
"JH378160","13952488","13952739","KQ056404v1","1771928","1772196","77","12180560"
"JH378160","13962099","13962244","KQ053288v1","28257","28404","34","13933842"
"JH378160","14037610","14037832","KQ054179v1","2728283","2728498","58","11309327"
"JH378160","14247398","14247549","KQ055384v1","843998","844147","32","13403400"
"JH378160","14378378","14378679","KQ053816v1","7464708","7465010","60","6913670"
"JH378160","14662582","14662802","KQ057291v1","322948","323180","64","14339634"
"JH378160","15218533","15218647","KQ053060v1","24143","24257","25","15194390"
"JH378160","15396215","15396443","KQ056762v1","1558119","1558341","57","13838096"
"JH378160","15411468","15411747","KQ055065v1","1117201","1117481","59","14294267"
"JH378160","15431605","15431802","KQ052968v1","13131640","13131834","53","2299965"
"JH378160","15572362","15572650","KQ057911v1","428931","429228","66","15143431"
"JH378161","274063","274283","KQ053696v1","3631267","3631475","63","3357204"
"JH378161","293780","293917","KQ054069v1","2479321","2479456","26","2185541"
"JH378161","332677","332977","KQ053959v1","2303063","2303358","82","1970386"
"JH378161","424175","424431","KQ055872v1","4131960","4132231","74","3707785"
"JH378161","426302","426590","KQ053115v1","1445261","1445551","66","1018959"
"JH378161","597723","597766","KQ057737v1","421645","421684","17","176078"
"JH378161","597841","597964","KQ055394v1","2370199","2370316","34","1772358"
"JH378161","598254","598383","KQ056147v1","1828259","1828388","27","1230005"
"JH378161","614044","614311","KQ053982v1","5661896","5662161","66","5047852"
"JH378161","617812","617981","KQ053190v1","5047993","5048157","44","4430181"
"JH378161","644434","644748","KQ055457v1","2061137","2061448","64","1416703"
"JH378161","1624574","1624785","KQ055404v1","102225","102438","50","1522349"
"JH378161","1692438","1692756","KQ058146v1","160981","161283","70","1531457"
"JH378161","1698390","1698528","KQ053686v1","1108593","1108721","31","589797"
"JH378161","1725744","1725984","KQ057480v1","520324","520577","69","1205420"
"JH378161","1856196","1856414","KQ053299v1","7690856","7691089","70","5834660"
"JH378161","1862051","1862349","KQ053960v1","70067","70362","63","1791984"
"JH378161","2028459","2028628","KQ054026v1","2068803","2068970","40","40344"
"JH378161","2052614","2052705","KQ053267v1","1130078","1130179","31","922536"
"JH378161","2090301","2090597","KQ054804v1","964015","964313","73","1126286"
"JH378161","2138445","2138551","KQ056568v1","1103954","1104055","30","1034491"
"JH378161","2166334","2166480","KQ053398v1","2023679","2023818","28","142655"
"JH378161","2293689","2293968","KQ056673v1","1151371","1151663","77","1142318"
"JH378161","2303648","2303811","KQ054660v1","3592730","3592895","34","1289082"
"JH378161","2347584","2347875","KQ052969v1","3675361","3675652","58","1327777"
"JH378161","2461138","2461287","KQ056268v1","862150","862302","41","1598988"
"JH378161","2715547","2715865","KQ053398v1","2545768","2546067","74","169779"
"JH378161","2792156","2792237","KQ053454v1","1364861","1364941","16","1427295"
"JH378161","2801272","2801548","KQ054745v1","163102","163377","68","2638170"
"JH378161","2877423","2877708","KQ055248v1","947170","947461","77","1930253"
"JH378161","3036510","3036602","KQ053256v1","5132292","5132396","25","2095782"
"JH378161","3057465","3057545","KQ053191v1","3736417","3736492","27","678952"
"JH378161","3143925","3144212","KQ058473v1","369163","369455","69","2774762"
"JH378161","3146790","3147091","KQ054191v1","3857584","3857880","70","710794"
"JH378161","3217506","3217632","KQ053299v1","22459675","22459802","26","19242169"
"JH378161","3409007","3409169","KQ055404v1","3099039","3099197","48","309968"
"JH378161","4244013","4244279","KQ054745v1","988289","988551","62","3255724"
"JH378161","4570920","4571185","KQ055662v1","907053","907314","67","3663867"
"JH378161","4595700","4595987","KQ054356v1","1600089","1600380","65","2995611"
"JH378161","4842311","4842625","KQ054576v1","616813","617125","67","4225498"
"JH378161","4853507","4853625","KQ053256v1","1284266","1284394","27","3569241"
"JH378161","4906768","4906889","KQ058483v1","4711310","4711430","25","195458"
"JH378161","4923246","4923531","KQ058389v1","2329886","2330179","63","2593360"
"JH378161","5049945","5050256","KQ058550v1","3068705","3069008","72","1981240"
"JH378161","5059631","5059933","KQ054510v1","9759814","9760122","75","4700183"
"JH378161","5131203","5131495","KQ058377v1","541031","541325","63","4590172"
"JH378161","5193216","5193457","KQ054932v1","4146161","4146408","69","1047055"
"JH378161","5307793","5307921","KQ053044v1","607812","607942","36","4699981"
"JH378161","5333068","5333212","KQ053115v1","1650505","1650644","36","3682563"
"JH378161","5383191","5383405","KQ054932v1","10432562","10432772","53","5049371"
"JH378161","5429372","5429678","KQ054921v1","2378911","2379222","64","3050461"
"JH378161","5470581","5470738","KQ054565v1","627778","627936","36","4842803"
"JH378161","5541571","5541702","KQ052970v1","4661614","4661744","26","879957"
"JH378161","5642759","5643048","KQ058533v1","977692","977970","62","4665067"
"JH378161","5646485","5646795","KQ052968v1","12144948","12145253","65","6498463"
"JH378161","5844057","5844067","KQ052970v1","6659383","6659394","3","815326"
"JH378161","5844101","5844324","KQ058505v1","3952082","3952290","58","1892019"
"JH378161","6249020","6249321","KQ056147v1","266944","267241","65","5982076"
"JH378161","6849570","6849838","KQ054933v1","935520","935770","61","5914050"
"JH378161","7286554","7286803","KQ056973v1","2256680","2256947","84","5029874"
"JH378161","7718000","7718302","KQ054510v1","6887667","6887971","76","830333"
"JH378161","8220253","8220547","KQ056234v1","4712656","4712947","74","3507597"
"JH378161","8234605","8234824","KQ053849v1","2000206","2000452","66","6234399"
"JH378161","8495819","8496002","KQ053299v1","776665","776838","60","7719154"
"JH378161","8590831","8591147","KQ053410v1","622761","623073","69","7968070"
"JH378161","8646222","8646482","KQ055629v1","27732","27989","77","8618490"
"JH378161","8882018","8882308","KQ055468v1","2950644","2950940","67","5931374"
"JH378161","8931771","8931877","KQ055375v1","460174","460273","26","8471597"
"JH378161","9214889","9215047","KQ057737v1","1426090","1426247","30","7788799"
"JH378161","9460828","9461182","KQ053135v1","3687285","3687645","106","5773543"
"JH378161","9529651","9529850","KQ054776v1","1314982","1315182","67","8214669"
"JH378161","9559084","9559275","KQ053554v1","293392","293586","58","9265692"
"JH378161","9575827","9575990","KQ054533v1","1027813","1027974","39","8548014"
"JH378161","9795483","9795786","KQ053135v1","2291396","2291675","81","7504087"
"JH378161","9816578","9816861","KQ053093v1","3162517","3162806","63","6654061"
"JH378161","9887305","9887587","KQ058004v1","733850","734131","73","9153455"
"JH378161","9926247","9926569","KQ053093v1","1287338","1287634","89","8638909"
"JH378161","10268984","10269092","KQ057522v1","1402538","1402652","26","8866446"
"JH378161","10385901","10386202","KQ056440v1","1022590","1022891","62","9363311"
"JH378161","10426373","10426681","KQ055883v1","288983","289282","65","10137390"
"JH378161","10452245","10452511","KQ052970v1","20988009","20988278","58","10535764"
"JH378161","10485649","10485742","KQ053827v1","2612475","2612564","18","7873174"
"JH378161","10513023","10513155","KQ056643v1","1491838","1491968","28","9021185"
"JH378161","10576156","10576302","KQ053631v1","8603317","8603457","29","1972839"
"JH378161","10632847","10633161","KQ053894v1","1262767","1263078","71","9370080"
"JH378161","10684182","10684481","KQ053409v1","4812949","4813233","75","5871233"
"JH378161","10828320","10828447","KQ053686v1","1108593","1108721","31","9719727"
"JH378161","10846798","10846868","KQ056855v1","3190666","3190732","24","7656132"
"JH378161","11482841","11483115","KQ053332v1","2579491","2579756","69","8903350"
"JH378161","11796121","11796261","KQ053850v1","820499","820643","42","10975622"
"JH378161","12042557","12042858","KQ058184v1","1505565","1505858","66","10536992"
"JH378161","12333937","12334199","KQ054279v1","3033507","3033776","63","9300430"
"JH378161","12541969","12542089","KQ056235v1","1725320","1725441","23","10816649"
"JH378161","12542815","12542946","KQ053115v1","1650505","1650644","27","10892310"
"JH378161","12687691","12687898","KQ058627v1","2039042","2039248","46","10648649"
"JH378161","12757810","12758096","KQ054356v1","787783","788076","77","11970027"
"JH378161","12783495","12783805","KQ053365v1","2996957","2997245","78","9786538"
"JH378161","12874695","12874959","KQ057541v1","534229","534482","68","12340466"
"JH378161","12964705","12964998","KQ052984v1","105454","105757","64","12859251"
"JH378161","13049301","13049429","KQ058280v1","649565","649696","26","12399736"
"JH378161","13209540","13209670","KQ055352v1","6062328","6062459","35","7147212"
"JH378161","13546181","13546489","KQ053432v1","4280053","4280348","75","9266128"
"JH378161","13714422","13714710","KQ055468v1","1908448","1908731","64","11805974"
"JH378161","14329800","14330106","KQ058254v1","626655","626964","75","13703145"
"JH378161","14475488","14475791","KQ055352v1","4183105","4183394","81","10292383"
"JH378161","15080454","15080750","KQ058184v1","1505565","1505858","59","13574889"
"JH378162","236605","236893","KQ053741v1","1482396","1482684","77","1245791"
"JH378162","1106942","1107226","KQ058561v1","9231306","9231597","70","8124364"
"JH378162","1171571","1171727","KQ054533v1","1027813","1027974","46","143758"
"JH378162","1301723","1301971","KQ053082v1","7643617","7643861","65","6341894"
"JH378162","1321264","1321415","KQ053179v1","1176666","1176810","44","144598"
"JH378162","1321667","1321791","KQ052969v1","4262458","4262578","32","2940791"
"JH378162","1514389","1514663","KQ057737v1","2756211","2756494","66","1241822"
"JH378162","1635666","1635927","KQ053202v1","1134199","1134469","70","501467"
"JH378162","2320092","2320331","KQ052984v1","1039352","1039584","64","1280740"
"JH378162","2397720","2398014","KQ056483v1","716725","717025","82","1680995"
"JH378162","2450559","2450842","KQ055978v1","3560415","3560681","74","1109856"
"JH378162","2504750","2505045","KQ056093v1","1723775","1724065","63","780975"
"JH378162","3888826","3889109","KQ053741v1","2899023","2899305","74","989803"
"JH378162","3899996","3900301","KQ056928v1","97902","98210","74","3802094"
"JH378162","5200932","5201226","KQ058328v1","6293951","6294242","71","1093019"
"JH378162","5447788","5448083","KQ052970v1","6659487","6659775","58","1211699"
"JH378162","5669827","5670081","KQ053565v1","4309559","4309823","64","1360268"
"JH378162","5701508","5701644","KQ057901v1","1218014","1218146","29","4483494"
"JH378162","5704678","5704948","KQ056331v1","106636","106916","63","5598042"
"JH378162","5914717","5914826","KQ053916v1","191904","192015","29","5722813"
"JH378162","5915799","5915874","KQ053883v1","3315834","3315907","18","2599965"
"JH378162","6060745","6061047","KQ058538v1","934688","934988","58","5126057"
"JH378162","6088073","6088316","KQ053763v1","974463","974700","61","5113610"
"JH378162","6088484","6088613","KQ056475v1","2305251","2305383","25","3783233"
"JH378162","6161365","6161667","KQ054786v1","934497","934799","67","5226868"
"JH378162","6452400","6452554","KQ057737v1","1426090","1426247","33","5026310"
"JH378162","6504810","6505090","KQ052970v1","8520800","8521088","77","2015990"
"JH378162","6539778","6539937","KQ054933v1","776608","776773","40","5763170"
"JH378162","6688975","6689264","KQ054510v1","5210888","5211157","72","1478087"
"JH378162","6707304","6707588","KQ055065v1","999059","999338","68","5708245"
"JH378162","6787592","6787872","KQ055173v1","248885","249169","77","6538707"
"JH378162","6887238","6887554","KQ053299v1","4095914","4096215","67","2791324"
"JH378162","6993659","6993931","KQ054510v1","8555095","8555387","73","1561436"
"JH378162","7048052","7048330","KQ055065v1","1117201","1117481","58","5930851"
"JH378162","7149961","7150206","KQ054135v1","1541023","1541259","69","5608938"
"JH378162","7153534","7153851","KQ058272v1","4942871","4943179","66","2210663"
"JH378162","7443043","7443323","KQ058383v1","2713168","2713439","76","4729875"
"JH378162","8034211","8034501","KQ052968v1","13260777","13261056","65","5226566"
"JH378162","8210664","8210775","KQ054693v1","3852073","3852175","30","4358591"
"JH378162","8259479","8259726","KQ058503v1","123813","124064","61","8135666"
"JH378162","8280175","8280462","KQ053476v1","3712115","3712409","66","4568060"
"JH378162","8320114","8320273","KQ056147v1","2168964","2169108","37","6151150"
"JH378162","8354276","8354561","KQ053409v1","3716306","3716585","65","4637970"
"JH378162","8456437","8456680","KQ056147v1","3491603","3491838","60","4964834"
"JH378162","8688859","8689125","KQ058321v1","21060","21321","72","8667799"
"JH378162","9324744","9325046","KQ057290v1","2953971","2954265","68","6370773"
"JH378162","9592405","9592686","KQ053093v1","1361295","1361576","51","8231110"
"JH378162","9755977","9756262","KQ058625v1","340677","340961","67","9415300"
"JH378162","9767249","9767535","KQ058428v1","1583535","1583812","64","8183714"
"JH378162","9776621","9776785","KQ058321v1","657714","657877","42","9118907"
"JH378162","9785414","9785577","KQ055425v1","1445594","1445758","30","8339820"
"JH378162","9848406","9848657","KQ058503v1","123813","124064","69","9724593"
"JH378162","9907204","9907502","KQ055457v1","2061137","2061448","57","7846067"
"JH378162","10172680","10172807","KQ056855v1","2808237","2808368","33","7364443"
"JH378162","10276631","10276932","KQ054533v1","1836056","1836358","73","8440575"
"JH378162","10487601","10487747","KQ053498v1","3548759","3548906","36","6938842"
"JH378162","10515325","10515613","KQ054068v1","3341291","3341579","65","7174034"
"JH378162","10565408","10565631","KQ052970v1","11661690","11661906","56","1096282"
"JH378162","10717305","10717578","KQ055735v1","1022582","1022853","69","9694723"
"JH378162","10781635","10781779","KQ053398v1","2023679","2023818","33","8757956"
"JH378162","10806663","10806940","KQ055352v1","3968278","3968546","62","6838385"
"JH378162","10849693","10849957","KQ055662v1","4683524","4683789","65","6166169"
"JH378162","10899938","10900042","KQ055572v1","5736","5831","22","10894202"
"JH378162","10971240","10971518","KQ055065v1","1117201","1117481","70","9854039"
"JH378162","11040576","11040852","KQ054868v1","2229582","2229854","74","8810994"
"JH378162","11083695","11083899","KQ055119v1","2614682","2614878","42","8469013"
"JH378162","11137763","11138055","KQ058184v1","1505565","1505858","68","9632198"
"JH378162","11180706","11181005","KQ054725v1","2218271","2218569","64","8962435"
"JH378162","11277394","11277544","KQ053081v1","7678221","7678366","44","3599173"
"JH378162","11325552","11325748","KQ053554v1","293392","293586","50","11032160"
"JH378162","11396839","11397109","KQ055331v1","476282","476544","66","10920557"
"JH378162","11399786","11399906","KQ055872v1","15136888","15137001","23","3737102"
"JH378162","11561446","11561583","KQ054069v1","4083160","4083297","32","7478286"
"JH378162","11661370","11661679","KQ058184v1","1505565","1505858","64","10155805"
"JH378162","11683959","11684193","KQ055479v1","1059427","1059676","73","10624532"
"JH378162","12441782","12442071","KQ054401v1","2629005","2629296","67","9812777"
"JH378162","12869381","12869603","KQ054565v1","7472196","7472426","59","5397185"
"JH378162","13364677","13364959","KQ053409v1","3716306","3716585","78","9648371"
"JH378162","13787012","13787297","KQ058594v1","908912","909187","75","12878100"
"JH378162","14673169","14673448","KQ052969v1","11182978","11183250","71","3490191"
"JH378162","14720706","14720994","KQ057737v1","171405","171682","73","14549301"
"JH378163","333447","333622","KQ055425v1","1445594","1445758","43","1112147"
"JH378163","660175","660335","KQ053157v1","5478543","5478695","34","4818368"
"JH378163","2857331","2857633","KQ055468v1","2564339","2564635","83","292992"
"JH378163","3191061","3191398","KQ054921v1","2359888","2360197","99","831173"
"JH378163","3856720","3856845","KQ054179v1","3865170","3865294","20","8450"
"JH378163","4086081","4086408","KQ057317v1","983417","983718","99","3102664"
"JH378163","4172503","4172792","KQ057290v1","2953971","2954265","60","1218532"
"JH378163","4271833","4271955","KQ056368v1","2150446","2150570","30","2121387"
"JH378163","4282020","4282339","KQ053115v1","3485337","3485650","67","796683"
"JH378163","4751339","4751475","KQ052970v1","11857903","11858038","28","7106564"
"JH378163","4778184","4778451","KQ053299v1","7562036","7562301","71","2783852"
"JH378163","5032928","5033190","KQ053632v1","575941","576173","82","4456987"
"JH378163","5296091","5296337","KQ055364v1","1919520","1919774","51","3376571"
"JH378163","5363595","5363839","KQ056147v1","3491603","3491838","72","1871992"
"JH378163","6305139","6305429","KQ057702v1","1237368","1237672","86","5067771"
"JH378163","6607705","6608009","KQ056404v1","176748","177054","72","6430957"
"JH378163","7180642","7180954","KQ055490v1","3912093","3912400","80","3268549"
"JH378163","7413577","7413821","KQ053686v1","2718006","2718245","66","4695571"
"JH378163","7608152","7608315","KQ055425v1","1445594","1445758","38","6162558"
"JH378163","7651656","7651806","KQ053982v1","8151372","8151511","35","499716"
"JH378163","7962780","7962932","KQ056643v1","1174972","1175125","38","6787808"
"JH378163","8157048","8157336","KQ056035v1","311208","311497","70","7845840"
"JH378163","8187655","8187792","KQ052970v1","9107596","9107736","34","919941"
"JH378163","8188501","8188652","KQ056587v1","7257462","7257612","38","931039"
"JH378163","8264169","8264444","KQ053409v1","5686466","5686740","57","2577703"
"JH378163","8299147","8299337","KQ054510v1","2941469","2941642","54","5357678"
"JH378163","8385320","8385614","KQ054124v1","2442155","2442433","90","5943165"
"JH378163","8453717","8453757","KQ056672v1","5125852","5125891","11","3327865"
"JH378163","8454214","8454352","KQ053982v1","3934263","3934401","40","4519951"
"JH378163","8454646","8454668","KQ055717v1","1652302","1652326","8","6802344"
"JH378163","8471275","8471560","KQ058317v1","5506620","5506904","61","2964655"
"JH378163","8546556","8546865","KQ056447v1","2393292","2393590","74","6153264"
"JH378163","9162229","9162511","KQ056331v1","822967","823254","71","8339262"
"JH378163","9642330","9642612","KQ053409v1","6128059","6128332","77","3514271"
"JH378163","9869413","9869727","KQ054191v1","3857584","3857880","79","6011829"
"JH378163","9996683","9996976","KQ058313v1","1804900","1805199","71","8191783"
"JH378163","10244932","10245224","KQ055872v1","4324109","4324401","66","5920823"
"JH378163","10573893","10574163","KQ058383v1","5944247","5944518","76","4629646"
"JH378163","10711676","10711967","KQ053752v1","4443232","4443526","70","6268444"
"JH378163","10949147","10949439","KQ058483v1","6010751","6011031","82","4938396"
"JH378163","11289659","11289784","KQ052993v1","71964","72092","31","11217695"
"JH378163","11434447","11434611","KQ055978v1","2949687","2949843","39","8484760"
"JH378163","11535999","11536281","KQ055141v1","254262","254544","73","11281737"
"JH378163","11570460","11570586","KQ053004v1","2961452","2961584","37","8609008"
"JH378163","12186857","12187139","KQ053146v1","2819587","2819868","53","9367270"
"JH378163","12430943","12431094","KQ053343v1","2529084","2529233","33","9901859"
"JH378163","12484156","12484344","KQ053234v1","293386","293576","57","12190770"
"JH378163","12667082","12667277","KQ053654v1","4118798","4119013","67","8548284"
"JH378163","12770064","12770208","KQ058572v1","3894290","3894431","37","8875774"
"JH378163","12833594","12833810","KQ055518v1","1223220","1223455","63","11610374"
"JH378163","12857739","12858010","KQ053520v1","2840509","2840769","83","10017230"
"JH378163","12960954","12961058","KQ054456v1","5057079","5057175","29","7903875"
"JH378163","13007468","13007728","KQ058275v1","938649","938919","67","12068819"
"JH378163","13073724","13074028","KQ055457v1","9231252","9231546","72","3842472"
"JH378163","13148190","13148499","KQ055468v1","2950644","2950940","61","10197546"
"JH378163","13167740","13167873","KQ054510v1","6505807","6505941","26","6661933"
"JH378163","13507084","13507392","KQ056331v1","348695","348980","83","13158389"
"JH378163","13520305","13520433","KQ055957v1","554477","554608","27","12965828"
"JH378163","13538446","13538694","KQ053632v1","579940","580190","66","12958506"
"JH378163","13582840","13583109","KQ053256v1","1257292","1257559","63","12325548"
"JH378163","13593644","13593804","KQ057336v1","635116","635282","36","12958528"
"JH378163","13593950","13594077","KQ052970v1","4661614","4661744","22","8932336"
"JH378163","13608314","13608607","KQ058184v1","1505565","1505858","69","12102749"
"JH378163","14274586","14274841","KQ056773v1","122800","123057","58","14151786"
"JH378163","14277452","14277738","KQ054693v1","832788","833076","64","13444664"
"JH378163","14416435","14416584","KQ054795v1","2377934","2378063","36","12038501"
"JH378163","14512088","14512210","KQ055192v1","1759958","1760089","25","12752130"
"JH378163","14595122","14595426","KQ053398v1","2545768","2546067","65","12049354"
"JH378163","14649350","14649656","KQ052971v1","959704","960011","77","13689646"
"JH378164","209922","210094","KQ054660v1","3603105","3603267","43","3393183"
"JH378164","250001","250289","KQ052969v1","9116808","9117108","71","8866807"
"JH378164","302115","302399","KQ053838v1","983133","983429","81","681018"
"JH378164","649956","650241","KQ053146v1","2819587","2819868","71","2169631"
"JH378164","1068740","1069030","KQ053300v1","2874445","2874736","63","1805705"
"JH378164","2144165","2144447","KQ057151v1","982137","982421","68","1162028"
"JH378164","2153300","2153436","KQ053654v1","4929533","4929667","25","2776233"
"JH378164","2213594","2213884","KQ058184v1","1505565","1505858","56","708029"
"JH378164","2232488","2232614","KQ056035v1","296324","296444","24","1936164"
"JH378164","2308270","2308573","KQ054400v1","4609733","4610042","94","2301463"
"JH378164","2327587","2327880","KQ055872v1","7304225","7304518","64","4976638"
"JH378164","2490462","2490707","KQ053082v1","7643617","7643861","56","5153155"
"JH378164","2507590","2507722","KQ055872v1","4808828","4808960","27","2301238"
"JH378164","2568880","2569162","KQ053752v1","35796","36072","72","2533084"
"JH378164","2686853","2687135","KQ053398v1","3625586","3625864","73","938733"
"JH378164","2949643","2949796","ABDC02029150v1","2120","2268","26","2947523"
"JH378164","3029055","3029337","KQ053741v1","1718834","1719118","62","1310221"
"JH378164","3109551","3109684","KQ053157v1","5621627","5621750","36","2512076"
"JH378164","3171221","3171357","KQ054660v1","2772250","2772392","32","398971"
"JH378164","3370124","3370365","KQ053654v1","3892663","3892904","70","522539"
"JH378164","3503197","3503498","KQ053343v1","1747702","1748011","68","1755495"
"JH378164","4428088","4428355","KQ058389v1","2110988","2111239","70","2317100"
"JH378164","4564486","4564595","KQ054932v1","8091927","8092018","38","3527441"
"JH378164","4668126","4668415","KQ054069v1","937520","937812","71","3730606"
"JH378164","4689238","4689546","KQ055004v1","332895","333205","71","4356343"
"JH378164","4732966","4733258","KQ054401v1","3144940","3145233","69","1588026"
"JH378164","4790619","4790923","KQ055852v1","1231373","1231668","70","3559246"
"JH378164","4944524","4944695","KQ058571v1","931737","931906","37","4012787"
"JH378164","4944898","4944999","KQ053916v1","191904","192015","29","4752994"
"JH378164","5022173","5022354","KQ053191v1","3634315","3634484","42","1387858"
"JH378164","5137298","5137409","KQ054671v1","629082","629194","26","4508216"
"JH378164","5799688","5799904","KQ052970v1","21250711","21250920","56","15451023"
"JH378164","5805480","5805740","KQ057345v1","1938824","1939073","72","3866656"
"JH378164","5900917","5901211","KQ058184v1","1505565","1505858","58","4395352"
"JH378164","5906589","5906960","KQ055777v1","2071501","2071828","114","3835088"
"JH378164","6044178","6044490","KQ053212v1","2900872","2901182","63","3143306"
"JH378164","6263329","6263645","KQ058254v1","626655","626964","72","5636674"
"JH378164","6356699","6356839","KQ053631v1","8603317","8603457","33","2246618"
"JH378164","6401976","6402259","KQ056432v1","1593337","1593624","60","4808639"
"JH378164","6427561","6427845","KQ054069v1","955693","955974","72","5471868"
"JH378164","6494156","6494457","KQ058427v1","10136514","10136815","82","3642358"
"JH378164","6674232","6674499","KQ058427v1","4553509","4553777","68","2120723"
"JH378164","6801380","6801512","KQ053409v1","6105325","6105446","24","696055"
"JH378164","7439168","7439455","KQ055490v1","2797344","2797631","60","4641824"
"JH378164","7463008","7463298","KQ054412v1","2490468","2490761","58","4972540"
"JH378164","7560534","7560812","KQ053267v1","3500174","3500463","73","4060360"
"JH378164","7613880","7614157","KQ053752v1","35796","36072","74","7578084"
"JH378164","7657284","7657481","KQ053299v1","6846672","6846867","61","810612"
"JH378164","7759268","7759570","KQ058283v1","622348","622657","63","7136920"
"JH378164","8248174","8248379","KQ058453v1","204250","204451","66","8043924"
"JH378164","8483210","8483528","KQ058283v1","622348","622657","66","7860862"
"JH378164","8539582","8539863","KQ055755v1","209063","209333","79","8330519"
"JH378164","8688596","8688891","KQ054026v1","1656381","1656673","54","7032215"
"JH378164","9049118","9049343","KQ054124v1","147406","147625","59","8901712"
"JH378164","9230694","9230941","KQ055364v1","1832819","1833067","69","7397875"
"JH378164","9375153","9375362","KQ054660v1","4522544","4522737","77","4852609"
"JH378164","9550129","9550416","KQ053190v1","4987885","4988162","72","4562244"
"JH378164","9976591","9976880","KQ053620v1","1059372","1059660","64","8917219"
"JH378164","10939595","10939863","KQ053894v1","1459401","1459655","75","9480194"
"JH378164","11639585","11639822","KQ052970v1","2715607","2715860","75","8923978"
"JH378164","11998791","11999089","KQ057290v1","2180782","2181079","86","9818009"
"JH378164","12143359","12143667","KQ056440v1","1022590","1022891","71","11120769"
"JH378164","12932325","12932626","KQ053299v1","6038380","6038679","66","6893945"
"JH378164","13130540","13130732","KQ058350v1","871497","871688","44","12259043"
"JH378164","13253900","13254205","KQ054401v1","2629005","2629296","64","10624895"
"JH378164","13286546","13286733","KQ053774v1","1982290","1982469","48","11304256"
"JH378164","13502688","13502988","KQ058427v1","2533789","2534086","57","10968899"
"JH378164","13532597","13532810","KQ053565v1","3764313","3764506","57","9768284"
"JH378164","13847148","13847428","KQ053827v1","4198964","4199247","67","9648184"
"JH378164","13887346","13887653","KQ058328v1","6293951","6294242","71","7593395"
"JH378164","14185999","14186174","KQ052970v1","14221378","14221551","41","35379"
"JH378164","14407801","14408095","KQ053631v1","7288314","7288608","70","7119487"
"JH378164","14597725","14597888","KQ054533v1","1027813","1027974","36","13569912"
"JH378165","76553","76845","KQ053299v1","6282965","6283256","73","6206412"
"JH378165","80255","80430","KQ056587v1","1313670","1313846","48","1233415"
"JH378165","113869","114150","KQ057693v1","621833","622123","71","507964"
"JH378165","115919","116215","KQ053631v1","9631170","9631468","80","9515251"
"JH378165","914280","914563","KQ053332v1","447571","447853","72","466709"
"JH378165","1049229","1049489","KQ058328v1","2975933","2976189","65","1926704"
"JH378165","1110149","1110449","KQ058582v1","1599482","1599782","75","489333"
"JH378165","1231585","1231718","KQ057910v1","1548802","1548933","28","317217"
"JH378165","1458909","1459085","KQ056996v1","1524030","1524195","43","65121"
"JH378165","2138677","2138812","KQ055457v1","5874928","5875062","23","3736251"
"JH378165","2190553","2190831","KQ053146v1","2819587","2819868","76","629034"
"JH378165","2196409","2196697","KQ053070v1","1662300","1662600","75","534109"
"JH378165","2351878","2351959","KQ058505v1","6586082","6586163","23","4234204"
"JH378165","2352021","2352058","KQ056672v1","5125852","5125891","9","2773831"
"JH378165","2408827","2409120","KQ053554v1","1157184","1157483","74","1251643"
"JH378165","2524280","2524561","KQ056773v1","168010","168288","61","2356270"
"JH378165","2788201","2788335","KQ053654v1","4929533","4929667","27","2141332"
"JH378165","2803944","2804108","KQ055425v1","1445594","1445758","38","1358350"
"JH378165","2823747","2824038","KQ054213v1","780092","780393","76","2043655"
"JH378165","3040076","3040214","KQ058304v1","1601806","1601935","28","1438270"
"JH378165","3248554","3248831","KQ054756v1","1395135","1395418","76","1853419"
"JH378165","3628439","3628722","KQ055872v1","1927794","1928087","68","1700645"
"JH378165","3880839","3881150","KQ055872v1","13002843","13003159","66","9122004"
"JH378165","4134558","4134853","KQ053631v1","3294956","3295241","74","839602"
"JH378165","4247583","4247890","KQ054068v1","5074639","5074944","83","827056"
"JH378165","4286074","4286146","KQ058317v1","4520617","4520689","9","234543"
"JH378165","4457984","4458219","KQ054069v1","2389274","2389511","78","2068710"
"JH378165","4593768","4593906","KQ055872v1","11131397","11131559","39","6537629"
"JH378165","5032363","5032441","KQ053267v1","4202512","4202585","29","829851"
"JH378165","5075251","5075377","KQ058305v1","4820083","4820218","33","255168"
"JH378165","5265066","5265376","KQ055236v1","2049624","2049930","60","3215442"
"JH378165","5332333","5332634","KQ058484v1","1273599","1273890","65","4058734"
"JH378165","5438066","5438192","KQ054047v1","1054810","1054936","26","4383256"
"JH378165","5756052","5756298","KQ053587v1","1788518","1788751","79","3967534"
"JH378165","5880423","5880660","KQ053718v1","2663788","2664010","63","3216635"
"JH378165","5965802","5966110","KQ055755v1","446339","446640","75","5519463"
"JH378165","6203052","6203145","KQ055872v1","5141445","5141541","17","1061607"
"JH378165","6246991","6247150","KQ057023v1","876183","876346","38","5370808"
"JH378165","6424124","6424403","KQ054618v1","2142076","2142353","68","4282048"
"JH378165","6552471","6552549","KQ057118v1","1020903","1020978","21","5531568"
"JH378165","6552685","6552876","KQ058427v1","4705427","4705629","53","1847258"
"JH378165","6580998","6581148","KQ053300v1","3146249","3146389","31","3434749"
"JH378165","6616584","6616836","KQ055364v1","1919520","1919774","67","4697064"
"JH378165","6840741","6840872","KQ053256v1","1284266","1284394","30","5556475"
"JH378165","6971567","6971862","KQ056293v1","93732","94015","72","6877835"
"JH378165","7040898","7041187","KQ054693v1","832788","833076","60","6208110"
"JH378165","7101364","7101425","KQ055648v1","977","1030","19","7100387"
"JH378165","7220448","7220755","KQ053082v1","7379147","7379444","73","158699"
"JH378165","7304978","7305272","KQ055798v1","887234","887524","78","6417744"
"JH378165","7770981","7771269","KQ053959v1","1626696","1626985","78","6144285"
"JH378165","7773315","7773613","KQ053631v1","7288314","7288608","70","485001"
"JH378165","7910549","7910714","KQ058483v1","5621339","5621499","40","2289210"
"JH378165","8108456","8108696","KQ054135v1","1541023","1541259","65","6567433"
"JH378165","8471722","8471999","KQ055755v1","209063","209333","78","8262659"
"JH378165","8748277","8748556","KQ053409v1","5686466","5686740","80","3061811"
"JH378165","9384036","9384311","KQ056157v1","875015","875294","73","8509021"
"JH378165","9473435","9473681","KQ058293v1","1110212","1110452","67","8363223"
"JH378165","9912364","9912651","KQ052969v1","9553757","9554052","62","358607"
"JH378165","10042348","10042469","KQ052969v1","2661859","2661968","35","7380489"
"JH378165","10213430","10213516","KQ058183v1","3236759","3236851","24","6976671"
"JH378165","10662184","10662441","KQ053332v1","804189","804443","67","9857995"
"JH378165","10938497","10938787","KQ052970v1","6659487","6659775","70","4279010"
"JH378165","11049059","11049355","KQ054868v1","1584588","1584882","69","9464471"
"JH378165","11476868","11477104","KQ056404v1","638131","638387","61","10838737"
"JH378165","11870482","11870760","KQ052968v1","13260777","13261056","67","1390295"
"JH378165","12199064","12199234","KQ053037v1","631347","631512","42","11567717"
"JH378165","12665592","12665891","KQ053093v1","1522159","1522464","75","11143433"
"JH378165","12744693","12744849","KQ055893v1","1958950","1959098","43","10785743"
"JH378165","13024461","13024633","KQ052970v1","14221378","14221551","37","1196917"
"JH378165","13379349","13379655","KQ055468v1","2950644","2950940","71","10428705"
"JH378165","13401418","13401705","KQ055872v1","12987862","12988141","72","413556"
"JH378165","13521601","13521662","KQ055883v1","741152","741209","20","12780449"
"JH378165","13533795","13534079","KQ053465v1","403029","403303","72","13130766"
"JH378165","13923196","13923481","KQ055352v1","13451535","13451828","66","471661"
"JH378165","14118794","14119066","KQ058184v1","1608105","1608378","71","12510689"
"JH378166","187117","187299","KQ053081v1","4935689","4935872","43","4748572"
"JH378166","232160","232271","KQ057909v1","4153593","4153709","23","3921433"
"JH378166","232488","232602","KQ052969v1","2661859","2661968","27","2429371"
"JH378166","274643","274949","KQ053299v1","21835674","21835971","64","21561031"
"JH378166","285497","285799","KQ053300v1","2874445","2874736","64","2588948"
"JH378166","301365","301655","KQ058428v1","2055160","2055453","62","1753795"
"JH378166","321115","321395","KQ058394v1","3915274","3915538","73","3594159"
"JH378166","374740","375037","KQ058339v1","5589567","5589858","76","5214827"
"JH378166","421707","422010","KQ056134v1","3642023","3642333","63","3220316"
"JH378166","504249","504551","KQ053093v1","1522159","1522464","69","1017910"
"JH378166","508180","508314","KQ053916v1","2379880","2380005","28","1871700"
"JH378166","520967","521261","KQ053297v1","44026","44315","67","476941"
"JH378166","548311","548576","KQ052969v1","11182978","11183250","64","10634667"
"JH378166","728831","729120","KQ056827v1","803277","803578","76","74446"
"JH378166","932691","932975","KQ056643v1","431969","432259","62","500722"
"JH378166","1609479","1609611","KQ057649v1","141749","141881","17","1467730"
"JH378166","1657455","1657744","KQ057737v1","3083543","3083824","59","1426088"
"JH378166","1679154","1679465","KQ053816v1","7464708","7465010","65","5785554"
"JH378166","1845026","1845319","KQ056790v1","446564","446855","79","1398462"
"JH378166","1999809","2000000","KQ058427v1","6736144","6736323","39","4736335"
"JH378166","2028346","2028632","KQ055957v1","364218","364491","62","1664128"
"JH378166","2110341","2110623","KQ058305v1","5546895","5547169","86","3436554"
"JH378166","2168729","2169021","KQ058266v1","1113469","1113760","70","1055260"
"JH378166","2218739","2218981","KQ057909v1","12196801","12197037","59","9978062"
"JH378166","2318061","2318344","KQ056587v1","9000240","9000528","56","6682179"
"JH378166","2323113","2323369","KQ053299v1","3622388","3622669","75","1299275"
"JH378166","2412383","2412672","KQ058350v1","6740286","6740580","82","4327903"
"JH378166","2525758","2525916","KQ057737v1","1426090","1426247","31","1099668"
"JH378166","2531068","2531289","KQ053816v1","5259129","5259356","70","2728061"
"JH378166","2594368","2594483","KQ053060v1","24143","24257","26","2570225"
"JH378166","2655252","2655477","KQ056465v1","72608","72828","57","2582644"
"JH378166","2763407","2763706","KQ052969v1","9116808","9117108","64","6353401"
"JH378166","2804217","2804498","KQ058427v1","4553509","4553777","70","1749292"
"JH378166","2840946","2841182","KQ057821v1","5073835","5074072","60","2232889"
"JH378166","2899520","2899743","KQ053741v1","1190544","1190756","53","1708976"
"JH378166","2928969","2929263","KQ058184v1","1505565","1505858","51","1423404"
"JH378166","3380465","3380768","KQ057449v1","2137704","2138005","76","1242761"
"JH378166","3426231","3426492","KQ058450v1","2367943","2368207","54","1058288"
"JH378166","3510828","3511118","KQ058184v1","1505565","1505858","65","2005263"
"JH378166","3669188","3669278","KQ055384v1","267995","268089","17","3401193"
"JH378166","3772366","3772489","KQ053752v1","7596252","7596371","25","3823886"
"JH378166","4067013","4067161","KQ055978v1","2949687","2949843","34","1117326"
"JH378166","4787941","4788233","KQ058184v1","1505565","1505858","59","3282376"
"JH378166","4869577","4869722","KQ053190v1","7157110","7157260","34","2287533"
"JH378166","4898127","4898324","KQ055892v1","1173","1363","48","4896954"
"JH378166","4914643","4914928","KQ058184v1","1505565","1505858","61","3409078"
"JH378166","4992880","4993172","KQ053631v1","8311486","8311774","71","3318606"
"JH378166","5181822","5182125","KQ056672v1","6393431","6393732","63","1211609"
"JH378166","5241954","5242135","KQ054724v1","240787","240986","58","5001167"
"JH378166","5257618","5257911","KQ053299v1","2212932","2213199","88","3044686"
"JH378166","5262506","5262811","KQ054412v1","2490468","2490761","77","2772038"
"JH378166","5791242","5791323","KQ058427v1","6765309","6765385","27","974067"
"JH378166","5791730","5791873","KQ053299v1","2812031","2812178","38","2979699"
"JH378166","6055580","6055866","KQ054756v1","1026786","1027083","77","5028794"
"JH378166","6300334","6300615","KQ053146v1","2819587","2819868","78","3480747"
"JH378166","6348353","6348659","KQ054724v1","2812268","2812574","71","3536085"
"JH378166","8176164","8176464","KQ056493v1","1483561","1483863","71","6692603"
"JH378166","8236194","8236513","KQ054879v1","1971571","1971875","75","6264623"
"JH378166","8272049","8272213","KQ057480v1","674678","674843","36","7597371"
"JH378166","8447727","8447962","KQ058346v1","173209","173433","67","8274518"
"JH378166","8716601","8716735","KQ054682v1","3248658","3248790","27","5467943"
"JH378166","8812401","8812696","KQ053554v1","1157184","1157483","54","7655217"
"JH378166","8828825","8829114","KQ054290v1","1454980","1455264","65","7373845"
"JH378166","8968092","8968395","KQ052970v1","10427454","10427754","78","1459362"
"JH378166","9219659","9219856","KQ057290v1","248142","248326","53","8971517"
"JH378166","9230705","9230808","KQ053763v1","508269","508363","28","8722436"
"JH378166","9295755","9296051","KQ057380v1","2085297","2085597","64","7210458"
"JH378166","9580978","9581045","KQ053686v1","2686865","2686920","24","6894113"
"JH378166","9581107","9581217","KQ058328v1","4075684","4075799","25","5505423"
"JH378166","9718023","9718239","KQ058242v1","892038","892246","57","8825985"
"JH378166","9929589","9929904","KQ058561v1","583947","584226","84","9345642"
"JH378166","9976841","9977116","KQ058328v1","6293951","6294242","79","3682890"
"JH378166","10260841","10261040","KQ053294v1","648","849","62","10260193"
"JH378166","10593275","10593416","KQ054401v1","2342043","2342190","29","8251232"
"JH378166","10764643","10764931","KQ052968v1","4142140","4142422","63","6622503"
"JH378166","12667174","12667478","KQ053816v1","7464708","7465010","65","5202466"
"JH378166","12778873","12779006","KQ058405v1","1518051","1518190","35","11260822"
"JH378166","13249450","13249732","KQ053959v1","5479288","5479573","76","7770162"
"JH378166","13395953","13396254","KQ054191v1","3583730","3584032","73","9812223"
"JH378166","13538954","13539064","KQ058328v1","2150165","2150287","29","11388789"
"JH378166","13628138","13628280","KQ054466v1","1866785","1866925","36","11761353"
"JH378166","13688130","13688419","KQ053146v1","2848155","2848435","67","10839975"
"JH378166","13697953","13698209","KQ058503v1","123813","124064","70","13574140"
"JH378166","13735563","13735839","KQ052968v1","13260777","13261056","64","474786"
"JH378166","13803318","13803521","KQ055892v1","1173","1363","47","13802145"
"JH378166","13810808","13810921","KQ054068v1","6466552","6466668","26","7344256"
"JH378167","27018","27296","KQ054745v1","919926","920212","78","892908"
"JH378167","469131","469401","KQ053795v1","370451","370712","78","98680"
"JH378167","638430","638637","KQ055717v1","640981","641187","61","2551"
"JH378167","672426","672713","KQ052981v1","658787","659079","65","13639"
"JH378167","687611","687817","KQ058272v1","2561906","2562124","55","1874295"
"JH378167","754555","754637","KQ058527v1","757316","757404","31","2761"
"JH378167","774258","774552","KQ058184v1","1505565","1505858","68","731307"
"JH378167","798201","798488","KQ053498v1","3696034","3696323","62","2897833"
"JH378167","883995","884299","KQ056345v1","621994","622295","56","262001"
"JH378167","903242","903374","KQ053565v1","1793162","1793293","34","889920"
"JH378167","954231","954460","KQ054756v1","66754","66988","72","887477"
"JH378167","1011023","1011157","KQ058257v1","652425","652556","24","358598"
"JH378167","1038848","1038985","KQ053260v1","251013","251153","42","787835"
"JH378167","1098082","1098214","KQ056475v1","2305251","2305383","24","1207169"
"JH378167","1205962","1206232","KQ053520v1","456408","456696","81","749554"
"JH378167","1248573","1248764","KQ052968v1","1711014","1711208","52","462441"
"JH378167","1378268","1378422","KQ058427v1","3400358","3400512","37","2022090"
"JH378167","1379535","1379830","KQ053465v1","3609319","3609610","55","2229784"
"JH378167","1439256","1439345","KQ054323v1","1913767","1913855","22","474511"
"JH378167","1471715","1471990","KQ056945v1","942729","942997","62","528986"
"JH378167","1531830","1532101","KQ057345v1","642911","643183","69","888919"
"JH378167","1549179","1549425","KQ054693v1","3245566","3245803","62","1696387"
"JH378167","1595170","1595471","KQ053135v1","7547440","7547727","78","5952270"
"JH378167","1658178","1658462","KQ055777v1","2252512","2252796","69","594334"
"JH378167","1662257","1662401","KQ053026v1","1335920","1336065","33","326337"
"JH378167","1667661","1667804","KQ056568v1","798477","798603","40","869184"
"JH378167","1752915","1753222","KQ055352v1","13451535","13451828","84","11698620"
"JH378167","1808931","1809245","KQ058585v1","580456","580763","68","1228475"
"JH378167","1963732","1964039","KQ054400v1","354368","354668","79","1609364"
"JH378167","1997834","1998114","KQ055787v1","925083","925374","77","1072751"
"JH378167","2010849","2011137","KQ052969v1","8161032","8161329","64","6150183"
"JH378167","2011288","2011414","KQ058349v1","1169536","1169663","26","841752"
"JH378167","2113318","2113606","KQ055364v1","2160874","2161165","75","47556"
"JH378167","2251351","2251651","KQ053115v1","1118362","1118655","59","1132989"
"JH378167","2366669","2366814","KQ053288v1","28257","28404","34","2338412"
"JH378167","2377242","2377520","KQ057755v1","45985","46262","65","2331257"
"JH378167","2724315","2724446","KQ057901v1","1218014","1218146","23","1506301"
"JH378167","2828212","2828486","KQ053883v1","3868605","3868876","81","1040393"
"JH378167","2903832","2904123","ABDC02054223v1","3152","3442","68","2900680"
"JH378167","2932586","2932722","KQ054068v1","3810713","3810858","33","878127"
"JH378167","2971595","2971876","KQ058503v1","123813","124064","81","2847782"
"JH378167","3001012","3001252","KQ054135v1","1541023","1541259","70","1459989"
"JH378167","3035353","3035487","KQ052970v1","15723145","15723276","27","12687792"
"JH378167","3160538","3160835","KQ056234v1","1421732","1422025","70","1738806"
"JH378167","3188313","3188458","KQ054933v1","651306","651450","42","2537007"
"JH378167","3293672","3293971","KQ057205v1","1097243","1097539","74","2196429"
"JH378167","3436510","3436841","KQ055787v1","694393","694708","75","2742117"
"JH378167","3471990","3472286","KQ057693v1","621833","622123","71","2850157"
"JH378167","3477396","3477535","KQ053654v1","4929533","4929667","27","1452137"
"JH378167","3479424","3479735","KQ055414v1","222827","223136","64","3256597"
"JH378167","3535543","3535675","KQ057702v1","1862724","1862857","22","1672819"
"JH378167","3698359","3698662","KQ058585v1","580456","580763","75","3117903"
"JH378167","3805073","3805350","KQ058328v1","808528","808806","71","2996545"
"JH378167","3809422","3809724","KQ053223v1","590063","590338","84","3219359"
"JH378167","3809743","3809835","KQ058274v1","110344","110432","21","3699399"
"JH378167","3840864","3840996","KQ053004v1","2961452","2961584","23","879412"
"JH378167","4035277","4035345","KQ053072v1","197621","197681","21","3837656"
"JH378167","4044565","4044839","KQ054765v1","1675072","1675339","79","2369493"
"JH378167","4057417","4057709","KQ053115v1","4471494","4471788","69","414077"
"JH378167","4173441","4173566","KQ053146v1","2799678","2799801","28","1373763"
"JH378167","4383008","4383230","KQ055518v1","2384780","2384994","51","1998228"
"JH378167","4512149","4512433","KQ053288v1","2218996","2219287","63","2293153"
"JH378167","4669184","4669492","KQ056855v1","6552134","6552438","73","1882950"
"JH378167","4699879","4700092","KQ052968v1","13131640","13131834","68","8431761"
"JH378167","4757962","4758123","KQ057036v1","1270725","1270889","37","3487237"
"JH378167","4898609","4898854","KQ056447v1","2522955","2523197","75","2375654"
"JH378167","5002650","5002897","KQ058272v1","5539241","5539492","64","536591"
"JH378167","5009905","5010202","KQ053539v1","110493","110767","80","4899412"
"JH378167","5140609","5140747","KQ057702v1","1862724","1862857","29","3277885"
"JH378167","5144846","5145081","KQ055735v1","1032075","1032317","56","4112771"
"JH378167","5256340","5256495","KQ055978v1","2949687","2949843","36","2306653"
"JH378167","5315711","5315831","KQ057035v1","2316254","2316371","28","2999457"
"JH378167","5405974","5406241","KQ053686v1","963025","963293","70","4442949"
"JH378167","5627588","5627869","KQ056432v1","1447969","1448266","74","4179619"
"JH378167","5631405","5631539","KQ053752v1","1144688","1144821","26","4486717"
"JH378167","5645401","5645532","KQ054301v1","3483833","3483964","26","2161568"
"JH378167","5657856","5657981","KQ054921v1","165725","165837","37","5492131"
"JH378167","5672720","5673020","KQ056147v1","266944","267241","60","5405776"
"JH378167","5756330","5756600","KQ057693v1","621833","622123","66","5134497"
"JH378167","5811737","5812004","KQ055192v1","1201363","1201615","58","4610374"
"JH378167","5855966","5856091","KQ058427v1","4756553","4756686","27","1099413"
"JH378167","5930525","5930794","KQ054868v1","2229582","2229854","62","3700943"
"JH378167","5951608","5951893","KQ055097v1","1884579","1884874","67","4067029"
"JH378167","6077533","6077718","KQ054725v1","735942","736116","45","5341591"
"JH378167","6219981","6220115","KQ053354v1","702320","702452","21","5517661"
"JH378167","6356233","6356519","KQ052971v1","3152804","3153086","76","3203429"
"JH378167","6406253","6406553","KQ053554v1","2471177","2471484","66","3935076"
"JH378167","6415109","6415221","KQ053752v1","1332751","1332858","29","5082358"
"JH378167","6576092","6576326","KQ057649v1","54936","55173","54","6521156"
"JH378167","6595880","6596190","KQ053093v1","1738898","1739201","68","4856982"
"JH378167","6709906","6710052","KQ053487v1","3756038","3756189","46","2953868"
"JH378167","6830542","6830681","KQ053115v1","1650505","1650644","38","5180037"
"JH378167","6898113","6898226","KQ058004v1","1368020","1368133","31","5530093"
"JH378167","6942644","6942830","KQ055457v1","12366559","12366757","65","5423915"
"JH378167","6972589","6972864","KQ052968v1","13260777","13261056","51","6288188"
"JH378167","7052198","7052386","KQ053631v1","7980794","7980971","53","928596"
"JH378167","7063739","7063874","KQ055957v1","554477","554608","28","6509262"
"JH378167","7109584","7109877","KQ053816v1","7464708","7465010","73","355124"
"JH378167","7146020","7146158","KQ053179v1","1781179","1781324","32","5364841"
"JH378167","7147607","7147896","KQ055248v1","947170","947461","76","6200437"
"JH378167","7172838","7173118","KQ055610v1","2807920","2808197","74","4364918"
"JH378167","7225154","7225281","KQ054047v1","1054810","1054936","22","6170344"
"JH378167","7360909","7361045","KQ057901v1","1218014","1218146","24","6142895"
"JH378167","7391695","7391804","KQ055024v1","329599","329697","27","7062096"
"JH378167","7400850","7400985","KQ053115v1","1333586","1333718","32","6067264"
"JH378167","7408248","7408447","KQ058595v1","117016","117224","52","7291232"
"JH378167","7489144","7489353","KQ057570v1","324724","324932","67","7164420"
"JH378167","7527484","7527761","KQ053696v1","1946341","1946596","74","5581143"
"JH378167","7558325","7558461","KQ053993v1","884675","884815","33","6673650"
"JH378167","7558541","7558811","KQ053037v1","3640291","3640559","63","3918250"
"JH378167","7567510","7567712","KQ055457v1","12366559","12366757","64","4799049"
"JH378167","7665046","7665323","KQ055735v1","667472","667747","69","6997574"
"JH378167","7729903","7730033","KQ053654v1","4929533","4929667","28","2800370"
"JH378167","7767181","7767477","KQ054400v1","354368","354668","58","7412813"
"JH378167","7771278","7771384","KQ057883v1","26280","26392","23","7744998"
"JH378167","7792452","7792778","KQ053004v1","2744572","2744859","98","5047880"
"JH378167","7837661","7837959","KQ055852v1","1231373","1231668","60","6606288"
"JH378167","7850025","7850311","KQ053365v1","104844","105138","67","7745181"
"JH378167","7884703","7884959","KQ055352v1","14158369","14158624","71","6273666"
"JH378167","7933374","7933499","KQ056663v1","464182","464321","38","7469192"
"JH378167","7989760","7990032","KQ055852v1","2060276","2060554","86","5929484"
"JH378167","7993242","7993373","KQ057268v1","150223","150357","27","7843019"
"JH378167","7998951","7999242","KQ057108v1","2064599","2064896","65","5934352"
"JH378167","8076315","8076445","KQ053187v1","324884","324999","39","7751431"
"JH378167","8332638","8332679","KQ055140v1","2522004","2522048","21","5810634"
"JH378167","8332689","8332753","KQ055883v1","741152","741209","17","7591537"
"JH378167","8358715","8358996","KQ054693v1","837377","837666","68","7521338"
"JH378167","8459468","8459599","KQ053115v1","1333586","1333718","28","7125882"
"JH378167","8627175","8627440","KQ053948v1","80758","81020","66","8546417"
"JH378167","8728760","8728893","KQ053861v1","8359","8490","26","8720401"
"JH378167","8740637","8740950","KQ055457v1","8422337","8422638","76","318300"
"JH378167","8759608","8759758","KQ053982v1","4960413","4960565","34","3799195"
"JH378167","8786018","8786313","KQ057788v1","1897225","1897533","78","6888793"
"JH378167","8979452","8979593","KQ053696v1","1609033","1609169","35","7370419"
"JH378167","8979888","8979944","KQ057909v1","9285552","9285592","20","305664"
"JH378167","8980070","8980184","KQ058394v1","10198337","10198452","27","1218267"
"JH378167","9060325","9060613","KQ054933v1","667391","667678","56","8392934"
"JH378167","9081612","9081916","KQ058605v1","2210776","2211044","85","6870836"
"JH378167","9085937","9086069","KQ053654v1","4929533","4929667","24","4156404"
"JH378167","9159754","9160076","KQ055735v1","977762","978063","79","8181992"
"JH378167","9172627","9172909","KQ053093v1","1375309","1375598","75","7797318"
"JH378167","9224972","9225078","KQ053850v1","279389","279490","26","8945583"
"JH378167","9267874","9267935","KQ053004v1","1367501","1367567","24","7900373"
"JH378167","9268346","9268426","KQ053332v1","1937831","1937907","20","7330515"
"JH378167","9280310","9280610","KQ054725v1","2218271","2218569","64","7062039"
"JH378167","9309987","9310193","KQ058505v1","2234909","2235124","62","7075078"
"JH378167","9317169","9317284","KQ057883v1","26280","26392","26","9290889"
"JH378167","9355675","9355963","KQ058305v1","3899980","3900272","69","5455695"
"JH378167","9361472","9361617","KQ058345v1","136254","136406","32","9225218"
"JH378167","9401830","9401999","KQ055872v1","13212412","13212576","46","3810582"
"JH378167","9454400","9454655","KQ058427v1","4553509","4553777","75","4900891"
"JH378167","9458618","9458738","KQ057909v1","14636622","14636750","30","5178004"
"JH378167","9460376","9460641","KQ054932v1","5122260","5122524","63","4338116"
"JH378167","9601629","9601932","KQ053093v1","3162517","3162806","80","6439112"
"JH378167","9637756","9638046","KQ054725v1","2218271","2218569","64","7419485"
"JH378167","9745285","9745548","KQ053631v1","9398334","9398603","75","346951"
"JH378167","9805998","9806060","KQ058394v1","7459384","7459440","19","2346614"
"JH378167","9854915","9855020","KQ058280v1","649966","650041","46","9204949"
"JH378167","9855128","9855254","KQ054890v1","666308","666433","40","9188820"
"JH378167","10457388","10457528","KQ053543v1","1868215","1868343","38","8589173"
"JH378167","10528341","10528473","KQ053354v1","702320","702452","25","9826021"
"JH378167","10625373","10625655","KQ052969v1","9114256","9114521","69","1511117"
"JH378167","10635300","10635416","KQ055498v1","86970","87098","30","10548330"
"JH378167","10652878","10653178","KQ053332v1","447571","447853","70","10205307"
"JH378167","10691317","10691444","KQ054649v1","1173471","1173595","40","9517846"
"JH378167","10737962","10738088","KQ054868v1","751727","751851","29","9986235"
"JH378167","10744861","10745012","KQ055490v1","2065440","2065590","30","8679421"
"JH378167","10792035","10792168","KQ056404v1","1195188","1195317","25","9596847"
"JH378167","11030525","11030735","KQ058505v1","3952082","3952290","52","7078443"
"JH378167","11099649","11099931","KQ057648v1","78808","79100","66","11020841"
"JH378167","11195663","11195808","KQ052970v1","9107596","9107736","28","2088067"
"JH378167","11228821","11228953","KQ058427v1","4756553","4756686","25","6472268"
"JH378167","11309243","11309544","KQ053115v1","1118362","1118655","62","10190881"
"JH378167","11374041","11374252","KQ058462v1","452919","453117","55","10921122"
"JH378167","11446065","11446272","KQ054964v1","2260574","2260761","51","9185491"
"JH378167","11448030","11448162","KQ057702v1","1862724","1862857","26","9585306"
"JH378167","11577955","11578094","KQ053387v1","3508985","3509121","47","8068970"
"JH378167","11623415","11623690","KQ053409v1","5686466","5686740","61","5936949"
"JH378167","11674234","11674521","KQ052968v1","9583834","9584132","69","2090400"
"JH378167","11711366","11711566","KQ053849v1","1126392","1126589","58","10584974"
"JH378167","11744997","11745130","KQ056044v1","1879665","1879803","27","9865332"
"JH378167","11785249","11785547","KQ058183v1","487423","487710","69","11297826"
"JH378167","11844235","11844509","KQ052970v1","8520800","8521088","74","3323435"
"JH378167","11917154","11917418","KQ055320v1","1606262","1606530","57","10310892"
"JH378167","11940346","11940642","KQ054383v1","7970","8268","71","11932376"
"JH378167","12053990","12054182","KQ054069v1","7451915","7452104","60","4602075"
"JH378167","12110014","12110238","KQ053827v1","5369199","5369432","61","6740815"
"JH378167","12206357","12206637","KQ054124v1","6084027","6084304","73","6122330"
"JH378167","12239112","12239187","KQ052968v1","9483686","9483763","28","2755426"
"JH378167","12343044","12343317","KQ054868v1","2229582","2229854","77","10113462"
"JH378167","12360502","12360602","KQ053421v1","4660652","4660752","31","7699850"
"JH378167","12410571","12410861","KQ055872v1","14798891","14799181","65","2388320"
"JH378167","12442633","12442924","KQ053343v1","1729289","1729583","64","10713344"
"JH378167","12447781","12448059","KQ055173v1","248885","249169","62","12198896"
"JH378167","12572219","12572349","KQ055298v1","1575436","1575566","32","10996783"
"JH378167","12813049","12813203","KQ058381v1","517901","518051","44","12295148"
"JH378167","12813276","12813394","KQ054191v1","1574768","1574888","31","11238508"
"JH378167","12931371","12931543","KQ054412v1","1809179","1809349","51","11122192"
"JH378167","12932138","12932435","KQ058184v1","1505565","1505858","64","11426573"
"JH378167","12988132","12988426","KQ058184v1","1505565","1505858","62","11482567"
"JH378168","347720","347864","KQ057118v1","1492016","1492164","40","1144296"
"JH378168","735099","735374","KQ053059v1","2135970","2136233","80","1400871"
"JH378168","1622816","1623117","KQ058184v1","1505565","1505858","66","117251"
"JH378168","1829493","1829778","KQ054964v1","31084","31374","73","1798409"
"JH378168","1836257","1836406","KQ055097v1","2392887","2393023","45","556630"
"JH378168","1836453","1836583","KQ056643v1","1491838","1491968","30","344615"
"JH378168","2414197","2414476","KQ056673v1","983726","984000","77","1430471"
"JH378168","2570200","2570386","KQ055141v1","5366238","5366422","44","2796038"
"JH378168","2594994","2595253","KQ056773v1","122800","123057","70","2472194"
"JH378168","2873187","2873466","KQ054932v1","2522024","2522313","83","351163"
"JH378168","3065929","3066223","KQ054510v1","8555095","8555387","65","5489166"
"JH378168","3218441","3218705","KQ052969v1","962459","962736","74","2255982"
"JH378168","3262356","3262653","KQ055852v1","1231373","1231668","71","2030983"
"JH378168","3452946","3453266","KQ058004v1","2469012","2469310","88","983934"
"JH378168","3556149","3556444","KQ053631v1","6588404","6588705","67","3032255"
"JH378168","3592721","3593036","KQ054179v1","1784791","1785086","86","1807930"
"JH378168","3686658","3686861","KQ055490v1","27634","27846","55","3659024"
"JH378168","4936435","4936587","KQ056148v1","7050287","7050441","33","2113852"
"JH378168","5222986","5223118","KQ055498v1","86970","87098","26","5136016"
"JH378168","5264825","5265105","KQ056404v1","976488","976758","71","4288337"
"JH378168","5536580","5536855","KQ058184v1","1608105","1608378","63","3928475"
"JH378168","5681875","5682005","KQ052970v1","15723145","15723276","26","10041270"
"JH378168","6284201","6284297","KQ053299v1","14559361","14559465","24","8275160"
"JH378168","6341258","6341488","KQ057471v1","1744674","1744909","75","4596584"
"JH378168","7014465","7014715","KQ058539v1","481549","481810","74","6532916"
"JH378168","7021939","7022250","KQ058577v1","505780","506079","78","6516159"
"JH378168","7688687","7688808","KQ054191v1","2895761","2895881","35","4792926"
"JH378168","8438348","8438645","KQ058585v1","580456","580763","75","7857892"
"JH378168","8900129","8900410","KQ057737v1","2756211","2756494","78","6143918"
"JH378168","9978455","9978520","KQ056540v1","178443","178502","28","9800012"
"JH378168","9978552","9978704","KQ058272v1","5669368","5669513","37","4309184"
"JH378168","10181398","10181702","KQ054682v1","1577967","1578262","75","8603431"
"JH378168","10711257","10711536","KQ056035v1","311208","311497","72","10400049"
"JH378168","10863275","10863564","KQ054069v1","955693","955974","61","9907582"
"JH378168","10968665","10968967","KQ058184v1","1505565","1505858","74","9463100"
"JH378168","10995514","10995659","KQ053004v1","3051555","3051691","41","7943959"
"JH378168","11080618","11080939","KQ058317v1","3244448","3244747","90","7836170"
"JH378168","11081282","11081583","KQ053631v1","9631170","9631468","70","1450112"
"JH378168","11254198","11254349","KQ055076v1","481316","481464","44","10772882"
"JH378168","11325038","11325343","KQ058184v1","1505565","1505858","59","9819473"
"JH378168","11698843","11699120","KQ057260v1","588691","588975","81","11110152"
"JH378168","11950870","11950989","KQ055404v1","3929342","3929457","33","8021528"
"JH378168","11966000","11966315","KQ053686v1","1253783","1254086","76","10712217"
"JH378168","12241403","12241719","KQ056587v1","8832818","8833130","74","3408585"
"JH378168","12251928","12252053","KQ054179v1","3865170","3865294","27","8386758"
"JH378169","4849603","4849897","KQ054412v1","2490468","2490761","62","2359135"
"JH378169","280369","280502","KQ055498v1","814067","814199","27","533698"
"JH378169","461578","461876","KQ055490v1","2107132","2107421","62","1645554"
"JH378169","467147","467407","KQ053498v1","3849819","3850073","62","3382672"
"JH378169","617335","617618","KQ053190v1","4987885","4988162","66","4370550"
"JH378169","793738","794052","KQ056568v1","817681","817996","71","23943"
"JH378169","973922","973985","KQ054069v1","6374104","6374169","17","5400182"
"JH378169","1011485","1011731","KQ053267v1","3723852","3724102","68","2712367"
"JH378169","1112472","1112791","KQ053960v1","70067","70362","88","1042405"
"JH378169","1249764","1250082","KQ054879v1","1971571","1971875","62","721807"
"JH378169","1261759","1262043","KQ054868v1","2229582","2229854","61","967823"
"JH378169","1338556","1338867","KQ053343v1","1747702","1748011","76","409146"
"JH378169","1403286","1403418","KQ053409v1","6105325","6105446","28","4702039"
"JH378169","1423503","1423799","KQ058184v1","1505565","1505858","74","82062"
"JH378169","1510404","1510514","ABDC02048745v1","10","118","22","1510394"
"JH378169","1609265","1609550","KQ053838v1","2962241","2962531","59","1352976"
"JH378169","1618136","1618420","KQ056404v1","1889967","1890264","64","271831"
"JH378169","1656307","1656610","KQ053476v1","1823610","1823912","65","167303"
"JH378169","2085919","2086242","KQ054964v1","665129","665440","88","1420790"
"JH378169","2430416","2430725","KQ053004v1","2261286","2261586","78","169130"
"JH378169","2436893","2437176","KQ053146v1","2819587","2819868","66","382694"
"JH378169","3060764","3060927","KQ053827v1","4961567","4961731","36","1900803"
"JH378169","3203917","3204117","KQ053849v1","1126392","1126589","52","2077525"
"JH378169","3216563","3216852","KQ053365v1","2996957","2997245","59","219606"
"JH378169","3497809","3498026","KQ055872v1","1786723","1786929","53","1711086"
"JH378169","3802716","3802996","KQ055735v1","667472","667747","74","3135244"
"JH378169","4779915","4780203","KQ057045v1","590946","591241","72","4188969"
"JH378169","4797941","4798074","KQ053212v1","404054","404177","36","4393887"
"JH378169","4798197","4798329","KQ055957v1","554477","554608","28","4243720"
"JH378169","4836030","4836249","KQ053741v1","1190544","1190756","50","3645486"
"JH378169","4891050","4891167","KQ053631v1","8539724","8539846","27","3648674"
"JH378169","4891840","4891973","KQ058305v1","4820083","4820218","33","71757"
"JH378169","4893419","4893536","KQ053631v1","8539724","8539846","27","3646305"
"JH378169","4899949","4900239","KQ053816v1","7464708","7465010","66","2564759"
"JH378169","4904962","4905258","KQ058184v1","1505565","1505858","59","3399397"
"JH378169","5073402","5073635","KQ053223v1","959933","960151","55","4113469"
"JH378169","5076907","5077249","KQ053332v1","771022","771332","102","4305885"
"JH378169","5333027","5333294","KQ053299v1","3706491","3706755","61","1626536"
"JH378169","5339380","5339545","KQ055425v1","1445594","1445758","32","3893786"
"JH378169","5349255","5349526","KQ054638v1","279592","279854","69","5069663"
"JH378169","5457420","5457557","KQ053115v1","1333586","1333718","27","4123834"
"JH378169","5482790","5482925","KQ053354v1","702320","702452","25","4780470"
"JH378169","5947974","5948132","KQ055893v1","1958950","1959098","39","3989024"
"JH378169","6051458","6051721","KQ055192v1","1201363","1201615","77","4850095"
"JH378169","6308754","6309041","KQ058004v1","1100771","1101059","70","5207983"
"JH378169","6384725","6384997","KQ053686v1","963025","963293","66","5421700"
"JH378169","6848794","6848998","KQ052968v1","1711014","1711208","52","5137780"
"JH378169","6998666","6998929","KQ058503v1","123813","124064","66","6874853"
"JH378169","7209836","7210132","KQ053300v1","2877663","2877955","73","4332173"
"JH378169","7444499","7444705","KQ057290v1","3936336","3936540","58","3508163"
"JH378169","7699020","7699300","KQ057570v1","100802","101086","78","7598218"
"JH378169","7970889","7971203","KQ058184v1","1505565","1505858","79","6465324"
"JH378169","8234090","8234214","KQ053332v1","575690","575814","28","7658400"
"JH378169","8237727","8238019","KQ052968v1","7064883","7065171","73","1172844"
"JH378169","8453736","8453984","KQ057290v1","2383871","2384129","69","6069865"
"JH378169","8522999","8523292","KQ056361v1","352158","352460","65","8170841"
"JH378169","8803810","8803920","KQ053157v1","203721","203827","27","8600089"
"JH378169","8878257","8878552","KQ054671v1","1712525","1712816","71","7165732"
"JH378169","9107277","9107565","KQ056044v1","1867924","1868223","69","7239353"
"JH378169","9607843","9607960","KQ054660v1","5437047","5437165","21","4170796"
"JH378169","9675811","9676112","KQ058394v1","2709989","2710289","65","6965822"
"JH378169","9741034","9741348","KQ054069v1","7687863","7688158","94","2053171"
"JH378169","10056351","10056482","KQ055755v1","1807261","1807395","26","8249090"
"JH378169","10532581","10532861","KQ053894v1","1290632","1290924","70","9241949"
"JH378169","10713578","10713876","KQ057004v1","1231997","1232305","65","9481581"
"JH378169","10908600","10908871","KQ058316v1","6274690","6274954","70","4633910"
"JH378169","11827287","11827569","KQ058539v1","1700786","1701070","61","10126501"
"JH378169","12164546","12164825","KQ053146v1","2819587","2819868","67","9344959"
"JH378169","12169818","12169917","KQ055572v1","5736","5831","26","12164082"
"JH378169","12233240","12233520","KQ056254v1","1122996","1123269","74","11110244"
"JH378169","12469098","12469284","KQ053332v1","862992","863181","56","11606106"
"JH378169","12498067","12498279","KQ054389v1","1509576","1509788","61","10988491"
"JH378169","12503595","12503835","KQ053310v1","2851403","2851646","60","9652192"
"JH378169","12752799","12753077","KQ057737v1","171405","171682","66","12581394"
"JH378170","3800908","3801201","KQ058494v1","12140224","12140499","86","8339316"
"JH378170","71110","71395","KQ054932v1","5027932","5028215","67","4956822"
"JH378170","330346","330581","KQ053741v1","1190544","1190756","60","860198"
"JH378170","365568","365838","KQ057764v1","646545","646819","75","280977"
"JH378170","418074","418378","KQ054213v1","780092","780393","77","362018"
"JH378170","440935","441022","KQ053432v1","5774004","5774087","23","5333069"
"JH378170","447002","447118","KQ057883v1","26280","26392","21","420722"
"JH378170","448456","448771","KQ057702v1","1237368","1237672","84","788912"
"JH378170","509547","509829","KQ053696v1","625208","625481","68","115661"
"JH378170","546779","547085","KQ054704v1","223675","223980","65","323104"
"JH378170","692197","692312","KQ053916v1","2379880","2380005","36","1687683"
"JH378170","712892","713164","KQ053763v1","3936916","3937207","67","3224024"
"JH378170","797885","798164","KQ054069v1","7677009","7677286","71","6879124"
"JH378170","877680","877999","KQ058184v1","1505565","1505858","86","627885"
"JH378170","894385","894666","KQ055978v1","5085382","5085675","70","4190997"
"JH378170","896912","897208","KQ053190v1","5623449","5623748","66","4726537"
"JH378170","936424","936496","KQ055979v1","1425","1498","15","934999"
"JH378170","970531","970749","ABDC02030067v1","1339","1560","57","969192"
"JH378170","983905","984199","KQ054510v1","8555095","8555387","64","7571190"
"JH378170","998757","999048","KQ054682v1","2237365","2237671","70","1238608"
"JH378170","1047731","1047995","KQ053498v1","3849819","3850073","54","2802088"
"JH378170","1051145","1051442","KQ053432v1","4280053","4280348","73","3228908"
"JH378170","1114791","1115093","KQ053421v1","2664387","2664683","64","1549596"
"JH378170","1184342","1184640","KQ055119v1","2313355","2313645","89","1129013"
"JH378170","1399658","1399914","KQ058280v1","515894","516148","65","883764"
"JH378170","1474353","1474643","KQ056790v1","446564","446855","78","1027789"
"JH378170","1686280","1686544","KQ058316v1","744353","744622","72","941927"
"JH378170","1749871","1750182","KQ055787v1","1064992","1065293","80","684879"
"JH378170","1999018","1999301","KQ055777v1","2840700","2840988","70","841682"
"JH378170","2617393","2617611","KQ058317v1","3410517","3410729","66","793124"
"JH378170","2651954","2652240","KQ058004v1","1480411","1480689","66","1171543"
"JH378170","2795617","2795718","KQ058050v1","918290","918400","19","1877327"
"JH378170","3208759","3209025","ABDC02049955v1","1118","1378","62","3207641"
"JH378170","3657132","3657422","KQ053696v1","5523721","5524018","78","1866589"
"JH378170","3870944","3871254","KQ053115v1","3485337","3485650","71","385607"
"JH378170","3898457","3898732","KQ053631v1","6939636","6939913","63","3041179"
"JH378170","3916295","3916572","KQ053477v1","72886","73168","80","3843409"
"JH378170","3949278","3949409","KQ054857v1","362885","363016","22","3586393"
"JH378170","3962766","3963060","KQ052969v1","9553757","9554052","65","5590991"
"JH378170","3992153","3992444","KQ053190v1","4987885","4988162","68","995732"
"JH378170","4124317","4124626","KQ055247v1","1761880","1762166","91","2362437"
"JH378170","4801329","4801595","KQ055893v1","2015012","2015285","64","2786317"
"JH378170","4901368","4901617","KQ054704v1","483937","484161","71","4417431"
"JH378170","4928016","4928306","KQ057911v1","428931","429228","65","4499085"
"JH378170","5044259","5044556","KQ052968v1","10629964","10630247","68","5585705"
"JH378170","5070315","5070618","KQ053631v1","368629","368924","78","4701686"
"JH378170","5088301","5088596","KQ053026v1","3680523","3680807","73","1407778"
"JH378170","5108474","5108638","KQ056996v1","1524030","1524195","33","3584444"
"JH378170","5109107","5109343","KQ055457v1","1008530","1008768","65","4100577"
"JH378170","5111858","5112153","KQ057875v1","404539","404839","59","4707319"
"JH378170","5169521","5169808","KQ053654v1","821411","821694","62","4348110"
"JH378170","5206775","5206934","KQ057036v1","1270725","1270889","39","3936050"
"JH378170","5351912","5352074","KQ056965v1","118773","118937","35","5233139"
"JH378170","5790328","5790525","KQ054179v1","4085367","4085566","44","1704961"
"JH378170","6609659","6609963","KQ053816v1","7464708","7465010","70","855049"
"JH378170","6723182","6723475","KQ058329v1","663480","663767","68","6059702"
"JH378170","6775042","6775332","KQ056673v1","983726","984000","73","5791316"
"JH378170","6821745","6821805","KQ053465v1","4199536","4199596","15","2622209"
"JH378170","6860733","6860902","KQ054879v1","1455515","1455684","57","5405218"
"JH378170","6956121","6956390","KQ053631v1","9398334","9398603","59","2442213"
"JH378170","7032106","7032427","KQ054555v1","358094","358405","73","6674012"
"JH378170","7195604","7195699","KQ054994v1","3559925","3560015","25","3635679"
"JH378170","7302060","7302340","KQ053398v1","2021251","2021517","72","5280809"
"JH378170","7905931","7906214","KQ053146v1","2819587","2819868","68","5086344"
"JH378170","8143237","8143485","KQ056568v1","742353","742617","79","7400884"
"JH378170","8266447","8266656","KQ057299v1","243728","243931","44","8022719"
"JH378170","8577519","8577807","KQ052969v1","8465928","8466216","70","111591"
"JH378170","8609117","8609349","KQ054693v1","3245566","3245803","80","5363551"
"JH378170","9006163","9006418","KQ055097v1","1305118","1305367","84","7701045"
"JH378170","10406316","10406594","KQ053146v1","2819587","2819868","63","7586729"
"JH378170","10636711","10636995","KQ053126v1","1419293","1419571","63","9217418"
"JH378170","10801037","10801172","KQ057648v1","2314551","2314685","22","8486486"
"JH378170","10850708","10850859","KQ057648v1","352128","352277","38","10498580"
"JH378170","10919094","10919349","KQ057587v1","428786","429038","69","10490308"
"JH378170","10957393","10957686","KQ058350v1","6740286","6740580","69","4217107"
"JH378170","10966966","10967106","KQ053774v1","406836","406969","27","10560130"
"JH378170","11186837","11187152","KQ055035v1","3034480","3034786","73","8152357"
"JH378170","11210987","11211286","KQ055097v1","1884579","1884874","63","9326408"
"JH378170","11272430","11272721","KQ058316v1","1400358","1400649","81","9872072"
"JH378170","11318439","11318625","KQ058275v1","502812","503007","58","10815627"
"JH378170","11320302","11320599","KQ058184v1","1505565","1505858","87","9814737"
"JH378170","11337626","11337757","KQ053686v1","1108593","1108721","35","10229033"
"JH378170","11546224","11546511","KQ058470v1","464724","464997","77","11081500"
"JH378170","11643506","11643821","KQ055414v1","222827","223136","73","11420679"
"JH378170","11658976","11659269","KQ054725v1","1255370","1255663","69","10403606"
"JH378170","12035989","12036254","KQ053299v1","22323868","22324139","65","10287879"
"JH378170","12106951","12107262","KQ053299v1","4095914","4096215","78","8011037"
"JH378170","12319785","12319950","KQ057480v1","674678","674843","38","11645107"
"JH378170","12677664","12677742","KQ052968v1","9483686","9483763","27","3193978"
"JH378170","12681316","12681459","KQ053190v1","2372433","2372579","50","10308883"
"JH378170","12904299","12904565","KQ058627v1","3345805","3346054","70","9558494"
"JH378171","7864293","7864428","KQ054069v1","4083160","4083297","29","3781133"
"JH378171","214594","214885","KQ053267v1","3621249","3621519","79","3406655"
"JH378171","771405","771699","KQ053631v1","7166814","7167113","66","6395409"
"JH378171","798422","798570","KQ054378v1","157932","158074","30","640490"
"JH378171","1109595","1109893","KQ058585v1","580456","580763","70","529139"
"JH378171","1496548","1496835","KQ057118v1","4601602","4601894","70","3105054"
"JH378171","1516924","1517206","KQ057909v1","519161","519431","73","997763"
"JH378171","1544961","1545086","KQ056235v1","1725320","1725441","28","180359"
"JH378171","1628987","1629153","KQ055014v1","15960","16127","39","1613027"
"JH378171","1662053","1662144","KQ055375v1","460174","460273","29","1201879"
"JH378171","1775029","1775252","KQ058505v1","2234909","2235124","61","459880"
"JH378171","1804768","1805086","KQ053025v1","49730","50045","73","1755038"
"JH378171","1897938","1898068","KQ056855v1","2808237","2808368","39","910299"
"JH378171","1933691","1933859","KQ058429v1","52814","52983","45","1880877"
"JH378171","1982478","1982649","KQ052969v1","6715408","6715578","52","4732930"
"JH378171","2047400","2047690","KQ056855v1","2789429","2789717","57","742029"
"JH378171","2138392","2138656","KQ053409v1","6532615","6532884","72","4394223"
"JH378171","2144664","2144801","KQ053432v1","7005343","7005477","35","4860679"
"JH378171","2361694","2361841","KQ058094v1","3687022","3687155","29","1325328"
"JH378171","2779227","2779524","KQ055787v1","1064992","1065293","64","1714235"
"JH378171","2789620","2789917","KQ053948v1","168940","169229","75","2620680"
"JH378171","2915727","2916021","KQ054401v1","2629005","2629296","67","286722"
"JH378171","3942101","3942359","KQ056268v1","840558","840818","64","3101543"
"JH378171","4287421","4287543","KQ057345v1","1273173","1273291","27","3014248"
"JH378171","4364328","4364617","KQ057737v1","2756211","2756494","58","1608117"
"JH378171","4478540","4478911","KQ053783v1","73311","73618","119","4405229"
"JH378171","4509271","4509564","KQ055097v1","1884579","1884874","61","2624692"
"JH378171","4560936","4561100","KQ055425v1","1445594","1445758","29","3115342"
"JH378171","4586196","4586479","KQ053115v1","1118362","1118655","65","3467834"
"JH378171","4593615","4593902","KQ053816v1","7438202","7438483","59","2844587"
"JH378171","4657152","4657278","KQ053785v1","828746","828862","31","3828406"
"JH378171","5381945","5382238","KQ058604v1","210345","210647","68","5171600"
"JH378171","5437661","5437948","KQ053718v1","3638528","3638821","79","1799133"
"JH378171","5520427","5520576","KQ058004v1","4755337","4755486","37","765090"
"JH378171","5520902","5520973","KQ057664v1","404566","404648","19","5116336"
"JH378171","5645127","5645397","KQ053190v1","5495992","5496283","70","149135"
"JH378171","5660068","5660192","KQ053026v1","2376723","2376841","27","3283345"
"JH378171","5778070","5778379","KQ052981v1","1198440","1198752","70","4579630"
"JH378171","5808954","5809250","KQ053948v1","168940","169229","60","5640014"
"JH378171","5830321","5830618","KQ057380v1","2738009","2738301","78","3092312"
"JH378171","5853121","5853425","KQ054383v1","7970","8268","68","5845151"
"JH378171","5880902","5881217","KQ056440v1","1157164","1157460","64","4723738"
"JH378171","6200803","6201066","KQ058283v1","1694307","1694568","70","4506496"
"JH378171","6598768","6599074","KQ055457v1","2061137","2061448","62","4537631"
"JH378171","6826528","6826813","KQ058275v1","938649","938919","57","5887879"
"JH378171","7726648","7726925","KQ055872v1","12987862","12988141","71","5261214"
"JH378171","7861717","7862032","KQ058450v1","2960681","2960988","71","4901036"
"JH378171","7996455","7996665","KQ054081v1","1002095","1002297","53","6994360"
"JH378171","8041690","8041991","KQ058454v1","922011","922304","75","7119679"
"JH378171","8367516","8367621","KQ053763v1","508269","508363","29","7859247"
"JH378171","9341148","9341429","KQ055872v1","12987862","12988141","69","3646714"
"JH378171","9357546","9357827","KQ052969v1","11182978","11183250","76","1825432"
"JH378171","9555985","9556283","KQ053190v1","5495992","5496283","82","4059993"
"JH378171","9623320","9623600","KQ056673v1","983726","984000","61","8639594"
"JH378171","9743267","9743514","KQ054069v1","159011","159235","75","9584256"
"JH378171","9745651","9745939","KQ056147v1","1064032","1064323","69","8681619"
"JH378171","9790562","9790816","KQ058199v1","885969","886232","61","8904593"
"JH378171","10656048","10656313","KQ058546v1","168071","168339","75","10487977"
"JH378171","11115469","11115746","KQ053631v1","9963313","9963601","71","1152156"
"JH378171","11296599","11296865","KQ057223v1","124007","124258","83","11172592"
"JH378171","12025732","12025903","KQ054879v1","1455515","1455684","47","10570217"
"JH378171","12031817","12032110","KQ054868v1","1584588","1584882","59","10447229"
"JH378171","12361799","12362059","KQ054068v1","1899112","1899362","77","10462687"
"JH378171","12528583","12528789","KQ054848v1","194460","194660","67","12334123"
"JH378172","44160","44293","KQ053948v1","2804373","2804495","40","2760213"
"JH378172","311441","311647","KQ053398v1","3158290","3158500","48","2846849"
"JH378172","564956","565232","KQ053631v1","7288314","7288608","70","6723358"
"JH378172","1254929","1255243","KQ054068v1","3341291","3341579","85","2086362"
"JH378172","1621359","1621631","KQ052968v1","14043756","14044036","77","12422397"
"JH378172","1826377","1826641","KQ058538v1","1444447","1444703","66","381930"
"JH378172","2091039","2091198","KQ053037v1","3255963","3256108","46","1164924"
"JH378172","2423881","2424146","KQ054826v1","303348","303596","71","2120533"
"JH378172","2519694","2519991","KQ053059v1","2387120","2387415","76","132574"
"JH378172","2739940","2740080","KQ058594v1","1377512","1377662","33","1362428"
"JH378172","3848023","3848322","KQ056855v1","2789429","2789717","77","1058594"
"JH378172","4363392","4363528","KQ055298v1","1575436","1575566","25","2787956"
"JH378172","4534419","4534691","ABDC02003384v1","193955","194231","76","4340464"
"JH378172","4563926","4564237","KQ055787v1","694393","694708","66","3869533"
"JH378172","4572999","4573300","KQ053816v1","7464708","7465010","60","2891709"
"JH378172","4825352","4825641","KQ058316v1","2555894","2556176","69","2269458"
"JH378172","4834756","4835098","KQ053609v1","3067120","3067424","109","1767636"
"JH378172","5347623","5347836","KQ055651v1","4351956","4352174","53","995667"
"JH378172","5506593","5506747","KQ053299v1","7348738","7348881","46","1842145"
"JH378172","5911975","5912266","KQ052970v1","17684700","17684986","88","11772725"
"JH378172","5977068","5977354","KQ058274v1","819297","819564","87","5157771"
"JH378172","6313837","6314064","KQ058266v1","662378","662594","62","5651459"
"JH378172","6343424","6343611","KQ053631v1","7168494","7168680","50","825070"
"JH378172","6568104","6568359","KQ055140v1","1369331","1369589","73","5198773"
"JH378172","6569725","6570010","KQ057380v1","1672785","1673058","64","4896940"
"JH378172","7054270","7054565","KQ054693v1","832788","833076","72","6221482"
"JH378172","7147799","7147933","KQ054734v1","365901","366035","27","6781898"
"JH378172","7256903","7257158","KQ054400v1","2059350","2059621","69","5197553"
"JH378172","7436182","7436408","KQ054069v1","159011","159235","56","7277171"
"JH378172","7462830","7462954","KQ053223v1","119848","119963","28","7342982"
"JH378172","7467735","7467945","KQ057290v1","4745481","4745684","50","2722254"
"JH378172","7964512","7964792","KQ055787v1","805344","805622","57","7159168"
"JH378172","8028117","8028413","KQ054069v1","7687863","7688158","51","340254"
"JH378172","8050929","8051145","KQ058328v1","2569266","2569497","52","5481663"
"JH378172","8539199","8539464","KQ053410v1","363999","364271","70","8175200"
"JH378172","8810311","8810608","KQ055247v1","4445738","4446031","70","4364573"
"JH378172","9215349","9215630","KQ053191v1","614334","614618","64","8601015"
"JH378172","9281807","9281956","KQ056147v1","2168964","2169108","32","7112843"
"JH378172","9311564","9311745","KQ052968v1","13535456","13535639","55","4223892"
"JH378172","9404383","9404688","KQ056790v1","446564","446855","69","8957819"
"JH378172","9488963","9489064","KQ052969v1","8430708","8430815","34","1058255"
"JH378172","10141182","10141464","KQ058317v1","5506620","5506904","64","4634562"
"JH378172","10208530","10208825","KQ057702v1","1420535","1420827","58","8787995"
"JH378172","10232465","10232725","KQ054510v1","1641980","1642248","63","8590485"
"JH378172","10479347","10479510","KQ054964v1","705465","705626","38","9773882"
"JH378172","10581274","10581574","KQ057290v1","3090594","3090898","66","7490680"
"JH378172","10586101","10586137","KQ056465v1","1649422","1649455","17","8936679"
"JH378172","10586728","10586840","KQ053916v1","191904","192015","24","10394824"
"JH378172","10591939","10592073","KQ056044v1","1879665","1879803","31","8712274"
"JH378172","10609615","10609944","KQ058428v1","2055160","2055453","84","8554455"
"JH378172","10841660","10841865","KQ054401v1","3245220","3245428","43","7596440"
"JH378172","10886029","10886193","KQ053115v1","4093406","4093574","39","6792623"
"JH378172","10966299","10966584","KQ054290v1","1454980","1455264","67","9511319"
"JH378172","11093372","11093685","KQ052984v1","105454","105757","70","10987918"
"JH378172","11300303","11300545","KQ057737v1","5186159","5186392","79","6114144"
"JH378172","11518644","11518894","KQ054693v1","745323","745572","64","10773321"
"JH378172","11538409","11538620","KQ054868v1","815376","815554","75","10723033"
"JH378172","11640987","11641287","KQ055457v1","2061137","2061448","69","9579850"
"JH378172","11829632","11829806","KQ057737v1","3327678","3327839","56","8501954"
"JH378172","11904677","11904967","KQ055957v1","446738","447027","79","11457939"
"JH378172","11956159","11956365","KQ054081v1","1002095","1002297","45","10954064"
"JH378172","11975905","11976040","KQ053654v1","4929533","4929667","23","7046372"
"JH378172","11984894","11984978","KQ052968v1","6651946","6652022","25","5332948"
"JH378172","11985618","11985662","KQ056672v1","5125852","5125891","14","6859766"
"JH378172","12008633","12008786","KQ058427v1","6712716","6712867","40","5295917"
"JH378172","12194281","12194568","KQ058094v1","7832529","7832815","63","4361752"
"JH378172","12198057","12198226","KQ056672v1","5452932","5453100","41","6745125"
"JH378172","12322053","12322309","KQ055404v1","2778560","2778817","69","9543493"
"JH378172","12382315","12382429","KQ053785v1","828746","828862","28","11553569"
"JH378172","12400987","12401270","KQ053409v1","3716306","3716585","66","8684681"
"JH378172","12468452","12468661","KQ055662v1","1117136","1117330","54","11351316"
"JH378172","12532393","12532537","KQ058483v1","5373223","5373356","38","7159170"
"JH378172","12570316","12570601","KQ054921v1","3166511","3166802","70","9403805"
"JH378172","12578593","12578861","KQ054510v1","6844504","6844778","78","5734089"
"JH378172","12673746","12674006","KQ053883v1","6941025","6941276","61","5732721"
"JH378172","12684461","12684719","KQ056147v1","3491603","3491838","66","9192858"
"JH378173","64164","64427","KQ054279v1","2894825","2895100","79","2830661"
"JH378173","95851","96070","KQ054168v1","859896","860125","57","764045"
"JH378173","100145","100372","KQ058266v1","662378","662594","71","562233"
"JH378173","122629","122914","KQ055140v1","3498233","3498522","65","3375604"
"JH378173","297543","297901","KQ055777v1","2071501","2071828","107","1773958"
"JH378173","341760","341896","KQ053212v1","1220125","1220262","40","878365"
"JH378173","437997","438220","KQ053741v1","1190544","1190756","55","752547"
"JH378173","452028","452192","KQ053696v1","3211004","3211170","30","2758976"
"JH378173","527191","527483","KQ058184v1","1505565","1505858","65","978374"
"JH378173","621990","622263","KQ053916v1","1741116","1741399","69","1119126"
"JH378173","654572","654863","KQ054533v1","288767","289055","58","365805"
"JH378173","764754","765066","KQ055119v1","2003090","2003396","70","1238336"
"JH378173","813934","814067","KQ053354v1","702320","702452","26","111614"
"JH378173","880939","881209","KQ053454v1","817557","817829","62","63382"
"JH378173","944609","944909","KQ057118v1","2263919","2264225","77","1319310"
"JH378173","1067368","1067663","KQ054682v1","1577967","1578262","70","510599"
"JH378173","1207608","1207882","KQ054933v1","4410189","4410469","68","3202581"
"JH378173","1262302","1262586","KQ055468v1","1908448","1908731","65","646146"
"JH378173","1377525","1377693","KQ054533v1","1027813","1027974","34","349712"
"JH378173","1468917","1469220","KQ053299v1","4095914","4096215","75","2626997"
"JH378173","1742198","1742509","KQ054693v1","2010555","2010863","68","268357"
"JH378173","1813427","1813692","KQ056245v1","3396909","3397165","62","1583482"
"JH378173","1818345","1818557","KQ054826v1","9981760","9981967","54","8163415"
"JH378173","1923718","1924017","KQ057875v1","561558","561851","69","1362160"
"JH378173","1940781","1941078","KQ053631v1","7288314","7288608","73","5347533"
"JH378173","1987662","1987967","KQ057290v1","534242","534517","80","1453420"
"JH378173","2212644","2212975","KQ055352v1","4183105","4183394","96","1970461"
"JH378173","2229927","2230222","KQ053774v1","935995","936267","81","1293932"
"JH378173","2231741","2231821","KQ055140v1","2877125","2877206","18","645384"
"JH378173","2279193","2279454","KQ054745v1","988289","988551","63","1290904"
"JH378173","2301679","2301976","KQ054510v1","8555095","8555387","64","6253416"
"JH378173","2310218","2310491","KQ053004v1","3225867","3226135","79","915649"
"JH378173","2615144","2615417","KQ053037v1","3640291","3640559","60","1025147"
"JH378173","2685038","2685335","KQ053520v1","2517282","2517587","78","167756"
"JH378173","2819005","2819286","KQ053093v1","1361295","1361576","62","1457710"
"JH378173","2840038","2840299","KQ056773v1","122800","123057","74","2717238"
"JH378173","3037287","3037511","KQ057737v1","1779203","1779413","54","1258084"
"JH378173","3037525","3037668","KQ054890v1","666308","666433","48","2371217"
"JH378173","3067879","3068166","KQ054879v1","1954531","1954814","71","1113348"
"JH378173","3245812","3246114","KQ053816v1","7464708","7465010","68","4218896"
"JH378173","3433058","3433369","KQ053554v1","2471177","2471484","72","961881"
"JH378173","3473913","3474205","KQ054213v1","780092","780393","55","2693821"
"JH378173","3572161","3572286","KQ052969v1","2661859","2661968","33","910302"
"JH378173","3637853","3638134","KQ054069v1","955693","955974","64","2682160"
"JH378173","3653496","3653790","KQ053115v1","1118362","1118655","74","2535134"
"JH378173","3668755","3669052","KQ053115v1","1118362","1118655","70","2550393"
"JH378173","3728877","3729113","KQ057656v1","1375539","1375777","56","2353338"
"JH378173","4681829","4682099","KQ053409v1","5686466","5686740","70","1004637"
"JH378173","4888937","4889211","KQ058183v1","4736369","4736640","71","152568"
"JH378173","4953350","4953622","KQ053521v1","2273365","2273646","73","2679985"
"JH378173","5084939","5085221","KQ054124v1","2442155","2442433","60","2642784"
"JH378173","5109006","5109284","KQ053498v1","169879","170149","66","4939127"
"JH378173","5282447","5282611","KQ054345v1","3389802","3389968","37","1892645"
"JH378173","5283523","5283648","KQ053785v1","828746","828862","25","4454777"
"JH378173","5346812","5346938","KQ056035v1","296324","296444","28","5050488"
"JH378173","5411769","5411902","KQ054921v1","3001829","3001962","24","2409940"
"JH378173","5448128","5448280","KQ053157v1","5478543","5478695","37","30415"
"JH378173","5513791","5514098","KQ055852v1","1231373","1231668","78","4282418"
"JH378173","5532065","5532359","KQ052970v1","4083831","4084116","73","1448234"
"JH378173","5534075","5534393","KQ053212v1","1560173","1560471","74","3973902"
"JH378173","5672437","5672693","KQ052971v1","6441372","6441626","66","768935"
"JH378173","5674316","5674361","KQ053299v1","20748277","20748312","19","15073961"
"JH378173","5674727","5674974","KQ054146v1","3258465","3258719","64","2416262"
"JH378173","5792018","5792176","KQ057480v1","655209","655365","38","5136809"
"JH378173","5974497","5974628","KQ053212v1","1220125","1220262","32","4754372"
"JH378173","5975356","5975376","KQ058317v1","5369536","5369554","10","605820"
"JH378173","5975381","5975502","KQ058350v1","1062787","1062904","23","4912594"
"JH378173","6002815","6003094","KQ055352v1","4380175","4380453","65","1622640"
"JH378173","6027151","6027289","KQ058350v1","6598688","6598822","32","571537"
"JH378173","6083179","6083312","KQ057901v1","1218014","1218146","20","4865165"
"JH378173","6146711","6146846","KQ053037v1","3255963","3256108","42","2890748"
"JH378173","6303141","6303417","KQ053883v1","6115153","6115431","67","187988"
"JH378173","6494811","6495058","KQ053498v1","3849819","3850073","62","2644992"
"JH378173","6509678","6509787","ABDC02047787v1","285","390","30","6509393"
"JH378173","6696207","6696512","KQ055457v1","2061137","2061448","64","4635070"
"JH378173","6773609","6773920","KQ053774v1","2397082","2397375","90","4376527"
"JH378173","6869997","6870127","KQ054213v1","615112","615244","27","6254885"
"JH378173","6894385","6894676","KQ057737v1","110075","110366","72","6784310"
"JH378173","6967755","6967917","KQ055014v1","682174","682339","37","6285581"
"JH378173","6970457","6970758","KQ054565v1","7466367","7466669","58","495910"
"JH378173","7198814","7199116","KQ058583v1","474794","475079","89","6724020"
"JH378173","7357846","7358139","KQ055946v1","855067","855357","78","6502779"
"JH378173","7378531","7378710","KQ054069v1","7451915","7452104","51","73384"
"JH378173","7419117","7419372","KQ055404v1","3857721","3857969","71","3561396"
"JH378173","7552355","7552592","KQ057291v1","322948","323180","49","7229407"
"JH378173","7571152","7571457","KQ052969v1","9116808","9117108","63","1545656"
"JH378173","7614252","7614565","KQ054510v1","2681434","2681749","70","4932818"
"JH378173","7760487","7760781","KQ053288v1","2218996","2219287","54","5541491"
"JH378173","7856661","7856953","KQ053300v1","2874445","2874736","62","4982216"
"JH378173","7876150","7876462","KQ055141v1","2573822","2574123","66","5302328"
"JH378173","8571050","8571348","KQ055735v1","667472","667747","76","7903578"
"JH378173","8638951","8639248","KQ058353v1","1264780","1265071","61","7374171"
"JH378173","9030440","9030733","KQ054068v1","3739014","3739300","81","5291426"
"JH378173","9164776","9164894","KQ054179v1","3865170","3865294","26","5299606"
"JH378173","9263035","9263197","KQ053004v1","4759784","4759947","35","4503251"
"JH378173","9475184","9475475","KQ055872v1","7304225","7304518","60","2170959"
"JH378173","9698737","9698869","KQ056475v1","2305251","2305383","23","7393486"
"JH378173","9837531","9837798","KQ058427v1","4553509","4553777","68","5284022"
"JH378173","9863034","9863227","KQ054921v1","4087847","4088033","54","5775187"
"JH378173","9867613","9867931","KQ058539v1","2019983","2020284","72","7847630"
"JH378173","10041537","10041634","KQ053082v1","7299591","7299682","41","2741946"
"JH378173","10165218","10165419","KQ053421v1","5583842","5584035","56","4581376"
"JH378173","10212420","10212568","KQ053190v1","2372433","2372579","32","7839987"
"JH378173","10304036","10304327","KQ058305v1","3899980","3900272","71","6404056"
"JH378173","10436838","10437151","KQ053179v1","2012868","2013172","65","8423970"
"JH378173","10491162","10491433","KQ054713v1","2139616","2139910","74","8351546"
"JH378173","10818459","10818572","KQ053785v1","828746","828862","28","9989713"
"JH378173","11260633","11260913","KQ053297v1","44026","44315","67","11216607"
"JH378173","11298220","11298464","KQ057290v1","2383871","2384129","65","8914349"
"JH378173","11335282","11335564","KQ053696v1","3248742","3249021","70","8086540"
"JH378173","12527435","12527649","KQ053741v1","1190544","1190756","53","11336891"
"JH378173","12595805","12596119","KQ053785v1","807454","807767","74","11788351"
"JH378174","4715","4791","KQ054020v1","67530","67615","21","62815"
"JH378174","19815","20096","KQ058539v1","481549","481810","77","461734"
"JH378174","38331","38479","ABDC02047922v1","197","340","39","38134"
"JH378174","214909","215223","KQ058538v1","2064419","2064712","92","1849510"
"JH378174","252704","252859","KQ058381v1","517901","518051","40","265197"
"JH378174","277055","277319","KQ057290v1","534242","534517","67","257187"
"JH378174","292168","292453","KQ056790v1","446564","446855","59","154396"
"JH378174","339000","339133","KQ053686v1","1108593","1108721","29","769593"
"JH378174","346595","346814","KQ053631v1","8821839","8822058","62","8475244"
"JH378174","381977","382182","KQ057611v1","297312","297526","79","84665"
"JH378174","387805","387932","KQ054191v1","2895761","2895881","38","2507956"
"JH378174","388322","388399","KQ053398v1","2188132","2188206","23","1799810"
"JH378174","605586","605735","KQ054412v1","2034642","2034787","35","1429056"
"JH378174","642108","642394","KQ058094v1","7832529","7832815","68","7190421"
"JH378174","754752","755034","KQ057290v1","1053741","1054027","70","298989"
"JH378174","780140","780441","KQ053299v1","7158156","7158440","76","6378016"
"JH378174","781680","781976","KQ058155v1","1405246","1405544","70","623566"
"JH378174","809946","810238","KQ052981v1","658787","659079","57","151159"
"JH378174","985166","985461","KQ054756v1","1395135","1395418","76","409969"
"JH378174","1002601","1002879","KQ057151v1","58440","58720","79","944161"
"JH378174","1089282","1089577","KQ054400v1","354368","354668","69","734914"
"JH378174","1221827","1222037","KQ054081v1","1002095","1002297","46","219732"
"JH378174","1871417","1871723","KQ055236v1","2049624","2049930","68","178207"
"JH378174","1906688","1906968","KQ054290v1","1454980","1455264","64","451708"
"JH378174","2227923","2228203","KQ057664v1","298993","299270","60","1928930"
"JH378174","2388469","2388670","KQ053554v1","293392","293586","51","2095077"
"JH378174","2632072","2632397","KQ055457v1","2061137","2061448","78","570935"
"JH378174","2926055","2926298","KQ053135v1","6974800","6975038","75","4048745"
"JH378174","3376530","3376821","KQ053631v1","8480063","8480351","82","5103533"
"JH378174","3546116","3546334","KQ058595v1","117016","117224","52","3429100"
"JH378174","3994790","3994983","KQ058516v1","676890","677070","56","3317900"
"JH378174","4202979","4203267","KQ052968v1","6282633","6282918","75","2079654"
"JH378174","4455129","4455424","KQ052982v1","2557979","2558263","84","1897150"
"JH378174","4509068","4509365","KQ058291v1","474599","474881","82","4034469"
"JH378174","4757444","4757734","ABDC02017848v1","262620","262914","67","4494824"
"JH378174","5210751","5210848","KQ055024v1","329599","329697","21","4881152"
"JH378174","5218754","5218949","KQ056320v1","2002842","2003039","52","3215912"
"JH378174","5255865","5255933","KQ057796v1","119005","119079","20","5136860"
"JH378174","5369435","5369738","KQ054069v1","7687863","7688158","66","2318428"
"JH378174","5432417","5432703","KQ053044v1","405596","405892","82","5026821"
"JH378174","5433875","5434002","KQ056855v1","2808237","2808368","31","2625638"
"JH378174","5441459","5441748","KQ058190v1","350088","350375","73","5091371"
"JH378174","5480305","5480614","KQ053059v1","3421896","3422194","75","2058409"
"JH378174","5511741","5511883","KQ056147v1","2168964","2169108","34","3342777"
"JH378174","5557722","5557887","KQ056996v1","1524030","1524195","39","4033692"
"JH378174","5660098","5660375","KQ058004v1","4701579","4701856","63","958519"
"JH378174","5661768","5662073","KQ058394v1","8774432","8774719","94","3112664"
"JH378174","5806365","5806616","KQ055192v1","1201363","1201615","69","4605002"
"JH378174","5837087","5837351","KQ055662v1","1906494","1906757","84","3930593"
"JH378174","6244570","6244868","KQ052970v1","7631891","7632195","77","1387321"
"JH378174","7707412","7707541","KQ053432v1","3920706","3920835","25","3786706"
"JH378174","7937495","7937637","KQ053115v1","1650505","1650644","29","6286990"
"JH378174","8147707","8147883","KQ058459v1","469480","469653","40","7678227"
"JH378174","8148128","8148246","KQ054932v1","7772773","7772892","28","375355"
"JH378174","8232513","8232805","KQ056973v1","1765942","1766236","58","6466571"
"JH378174","8263902","8264087","KQ053223v1","526976","527156","45","7736926"
"JH378174","8283188","8283359","KQ053332v1","2039644","2039799","50","6243544"
"JH378174","8374027","8374157","KQ057909v1","4153593","4153709","32","4220434"
"JH378174","8374566","8374691","KQ055777v1","1218556","1218681","21","7156010"
"JH378174","8383656","8383829","KQ054868v1","443230","443404","36","7940426"
"JH378174","8396570","8396811","KQ058199v1","346526","346773","72","8050044"
"JH378174","8412767","8413047","KQ052970v1","8520800","8521088","66","108033"
"JH378174","8434150","8434435","KQ055173v1","248885","249169","68","8185265"
"JH378174","8474311","8474619","KQ056345v1","621994","622295","80","7852317"
"JH378174","8526302","8526600","KQ058577v1","505780","506079","68","8020522"
"JH378174","8605174","8605450","KQ052970v1","3685906","3686177","65","4919268"
"JH378174","8616090","8616405","ABDC02005909v1","22473","22778","85","8593617"
"JH378174","8657184","8657469","KQ053816v1","7464708","7465010","58","1192476"
"JH378174","8702402","8702699","KQ053093v1","3162517","3162806","63","5539885"
"JH378174","9283892","9284243","KQ058350v1","6740286","6740580","110","2543606"
"JH378174","9320910","9320983","KQ054954v1","999926","999999","19","8320984"
"JH378174","9379256","9379410","KQ057204v1","1848184","1848342","41","7531072"
"JH378174","10372349","10372480","KQ054081v1","697724","697856","35","9674625"
"JH378174","10773344","10773594","KQ054124v1","2742235","2742487","69","8031109"
"JH378174","11184980","11185262","KQ056652v1","699001","699281","66","10485979"
"JH378174","11423551","11423736","KQ058301v1","333804","333994","50","11089747"
"JH378174","11458353","11458617","KQ058427v1","3892841","3893118","77","7565512"
"JH378174","11743267","11743539","KQ056475v1","5043413","5043676","71","6699854"
"JH378174","11827079","11827383","KQ054725v1","2218271","2218569","68","9608808"
"JH378175","384598","384851","KQ053686v1","963025","963293","71","578427"
"JH378175","610618","610780","KQ052968v1","10427732","10427888","38","9817114"
"JH378175","657084","657396","KQ058184v1","1505565","1505858","75","848481"
"JH378175","759962","760118","KQ056475v1","5275769","5275928","35","4515807"
"JH378175","946250","946391","KQ052970v1","9107596","9107736","25","8161346"
"JH378175","1014613","1014789","KQ056440v1","24372","24553","62","990241"
"JH378175","1157413","1157718","KQ054069v1","5704070","5704362","71","4546657"
"JH378175","1245381","1245531","KQ054196v1","237","387","33","1245144"
"JH378175","1279666","1279969","KQ054857v1","891890","892194","66","387776"
"JH378175","1385259","1385550","KQ054412v1","2490468","2490761","69","1105209"
"JH378175","1445765","1446061","KQ052969v1","11182978","11183250","84","9737213"
"JH378175","1492456","1492723","KQ058383v1","5944247","5944518","76","4451791"
"JH378175","1638224","1638378","KQ053115v1","1409764","1409915","45","228460"
"JH378175","2102266","2102503","KQ056147v1","3491603","3491838","58","1389337"
"JH378175","2223622","2223939","KQ058184v1","1505565","1505858","72","718057"
"JH378175","2346499","2346649","KQ057118v1","4162216","4162364","36","1815717"
"JH378175","2433123","2433385","KQ056920v1","346245","346510","63","2086878"
"JH378175","2450081","2450376","KQ054069v1","7687863","7688158","64","5237782"
"JH378175","2683484","2683720","KQ058274v1","391536","391765","63","2291948"
"JH378175","2747561","2747750","KQ053565v1","3407633","3407810","40","660072"
"JH378175","2789192","2789463","KQ053816v1","5213784","5214044","70","2424592"
"JH378175","2902721","2903003","KQ055394v1","3441211","3441489","54","538490"
"JH378175","3047867","3047998","KQ057268v1","150223","150357","22","2897644"
"JH378175","3083654","3083886","KQ053654v1","3892663","3892904","56","809009"
"JH378175","3212630","3212865","KQ053632v1","278979","279203","65","2933651"
"JH378175","3219207","3219361","KQ053081v1","7678221","7678366","39","4459014"
"JH378175","3302227","3302534","KQ054932v1","4838112","4838407","69","1535885"
"JH378175","3356693","3356982","KQ058184v1","1505565","1505858","83","1851128"
"JH378175","3452296","3452431","KQ058550v1","2035409","2035537","31","1416887"
"JH378175","3570972","3571082","KQ054323v1","1973428","1973538","22","1597544"
"JH378175","3571191","3571376","KQ054682v1","1934600","1934782","47","1636591"
"JH378175","3752886","3753172","KQ055766v1","4175053","4175345","61","422167"
"JH378175","4009136","4009433","KQ057108v1","2064599","2064896","65","1944537"
"JH378175","4117865","4118184","KQ055457v1","2061137","2061448","75","2056728"
"JH378175","4166149","4166422","KQ055978v1","3560415","3560681","70","605734"
"JH378175","4228674","4228945","KQ054921v1","4041226","4041499","67","187448"
"JH378175","4370130","4370437","KQ057693v1","117172","117472","72","4252958"
"JH378175","4697010","4697306","KQ053343v1","1729289","1729583","75","2967721"
"JH378175","5215369","5215661","KQ056762v1","532889","533183","73","4682480"
"JH378175","5545313","5545581","KQ054932v1","1186473","1186736","63","4358840"
"JH378175","5568897","5569113","KQ053267v1","3263961","3264178","58","2304936"
"JH378175","5758188","5758313","KQ054113v1","778087","778215","25","4980101"
"JH378175","5802308","5802612","KQ058383v1","5021173","5021475","64","781135"
"JH378175","5886717","5887018","KQ058184v1","1505565","1505858","51","4381152"
"JH378175","6087195","6087473","KQ053948v1","168940","169229","75","5918255"
"JH378175","6153321","6153447","KQ053686v1","1108593","1108721","27","5044728"
"JH378175","6261158","6261436","KQ053752v1","35796","36072","73","6225362"
"JH378175","6290706","6290830","KQ054932v1","7772773","7772892","29","1482067"
"JH378175","6291254","6291413","KQ058316v1","1681267","1681425","40","4609987"
"JH378175","6331699","6331979","KQ056988v1","1068914","1069193","69","5262785"
"JH378175","6363889","6364161","KQ058183v1","4736369","4736640","59","1627520"
"JH378175","6401442","6401737","KQ058272v1","4942871","4943179","66","1458571"
"JH378175","6417820","6418039","ABDC02048579v1","1276","1502","51","6416544"
"JH378175","6423149","6423434","KQ056234v1","4712656","4712947","80","1710493"
"JH378175","6443213","6443506","KQ055248v1","947170","947461","65","5496043"
"JH378175","6458376","6458641","KQ053332v1","2579491","2579756","62","3878885"
"JH378175","6492407","6492685","KQ052968v1","13260777","13261056","56","6768370"
"JH378175","6687741","6688022","KQ053299v1","21375969","21376245","72","14688228"
"JH378175","6766247","6766543","KQ057737v1","5377555","5377852","66","1388692"
"JH378175","6994262","6994462","KQ055717v1","640981","641187","71","6353281"
"JH378175","7026222","7026520","KQ054725v1","2218271","2218569","58","4807951"
"JH378175","7091389","7091686","KQ053816v1","7464708","7465010","82","373319"
"JH378175","7125456","7125770","KQ053190v1","1690950","1691254","80","5434506"
"JH378175","7614041","7614288","KQ053041v1","580788","581047","74","7033253"
"JH378175","7672757","7672913","KQ053631v1","10321219","10321372","32","2648462"
"JH378175","7952686","7952966","KQ056911v1","629332","629617","75","7323354"
"JH378175","8133017","8133305","KQ056234v1","2521120","2521411","84","5611897"
"JH378175","8314894","8315033","KQ053190v1","1502830","1502955","38","6812064"
"JH378175","8402198","8402434","KQ053299v1","22140679","22140906","61","13738481"
"JH378175","8481334","8481480","KQ054069v1","4083160","4083297","38","4398174"
"JH378175","8791032","8791182","KQ053299v1","20682065","20682208","47","11891033"
"JH378175","8922252","8922439","KQ058301v1","333804","333994","50","8588448"
"JH378175","9215794","9215995","KQ053343v1","1057961","1058175","51","8157833"
"JH378175","9354994","9355295","KQ058585v1","580456","580763","60","8774538"
"JH378175","9370856","9371145","KQ058428v1","2055160","2055453","70","7315696"
"JH378175","9411316","9411631","KQ054069v1","7687863","7688158","76","1723453"
"JH378175","9449268","9449556","KQ055766v1","4175053","4175345","64","5274215"
"JH378175","9535117","9535402","KQ053631v1","460848","461138","74","9074269"
"JH378175","9757249","9757548","KQ057788v1","561223","561518","64","9196026"
"JH378175","9928516","9928801","KQ053565v1","754705","754987","60","9173811"
"JH378175","9984807","9985072","KQ053827v1","6235617","6235875","68","3749190"
"JH378175","10008563","10008892","KQ055540v1","1236996","1237300","95","8771567"
"JH378175","10544149","10544445","KQ053288v1","2218996","2219287","64","8325153"
"JH378175","11012047","11012331","KQ058184v1","1505565","1505858","60","9506482"
"JH378175","11384298","11384591","KQ053190v1","5623449","5623748","77","5760849"
"JH378175","11505042","11505299","KQ058316v1","4984552","4984820","68","6520490"
"JH378175","11505327","11505460","KQ053026v1","2906402","2906536","31","8598925"
"JH378175","11550394","11550661","KQ058399v1","1219400","1219664","70","10330994"
"JH378175","11622145","11622406","KQ055662v1","4683524","4683789","65","6938621"
"JH378175","11659486","11659603","KQ056056v1","323824","323942","27","11335662"
"JH378176","121915","122044","KQ058427v1","4756553","4756686","18","4634638"
"JH378176","147414","147703","KQ056200v1","188634","188917","75","41220"
"JH378176","357101","357217","KQ053060v1","24143","24257","26","332958"
"JH378176","383173","383466","KQ055404v1","474978","475252","84","91805"
"JH378176","384730","385024","KQ054069v1","955693","955974","73","570963"
"JH378176","419983","420275","KQ052968v1","4142140","4142422","67","3722157"
"JH378176","459823","459920","KQ053631v1","8860661","8860759","33","8400838"
"JH378176","467835","468140","KQ053476v1","1823610","1823912","69","1355775"
"JH378176","556883","557030","KQ053300v1","3146249","3146389","32","2589366"
"JH378176","570212","570489","KQ053157v1","3558863","3559137","77","2988651"
"JH378176","663884","664196","KQ058272v1","4942871","4943179","67","4278987"
"JH378176","904664","904916","KQ055183v1","3184785","3185031","67","2280121"
"JH378176","1086328","1086587","KQ053476v1","3998036","3998311","67","2911708"
"JH378176","1212705","1212857","KQ057560v1","4489331","4489477","32","3276626"
"JH378176","1922002","1922277","KQ056663v1","500658","500926","75","1421344"
"JH378176","2500676","2500967","KQ052969v1","11182978","11183250","83","8682302"
"JH378176","2631268","2631573","KQ053059v1","2387120","2387415","69","244148"
"JH378176","2642698","2642953","KQ054868v1","2229582","2229854","74","413116"
"JH378176","2981492","2981634","KQ053300v1","3146249","3146389","38","164757"
"JH378176","3083130","3083430","KQ056044v1","2538771","2539068","69","544359"
"JH378176","3380946","3381235","KQ054069v1","955693","955974","75","2425253"
"JH378176","3996134","3996373","KQ053310v1","2851403","2851646","60","1144731"
"JH378176","4738417","4738715","KQ053410v1","507437","507742","66","4230980"
"JH378176","4786543","4786836","KQ057036v1","502032","502329","66","4284511"
"JH378176","4982003","4982141","KQ057910v1","1548802","1548933","25","3433201"
"JH378176","4982813","4983058","KQ057875v1","469535","469791","70","4513278"
"JH378176","5111370","5111642","KQ053299v1","22323868","22324139","63","17212498"
"JH378176","5323578","5323718","KQ052970v1","7437118","7437269","50","2113540"
"JH378176","5336027","5336152","KQ053409v1","6105325","6105446","21","769298"
"JH378176","5349573","5349745","KQ056301v1","226861","227032","70","5122712"
"JH378176","5638219","5638506","KQ058184v1","1505565","1505858","68","4132654"
"JH378176","5659760","5659997","KQ058094v1","6815572","6815819","66","1155812"
"JH378176","5719751","5720043","KQ056762v1","532889","533183","68","5186862"
"JH378176","6143369","6143556","KQ053849v1","1126392","1126589","49","5016977"
"JH378176","6458405","6458675","KQ054693v1","3278351","3278621","69","3180054"
"JH378176","6493636","6493930","KQ052970v1","9103070","9103367","71","2609434"
"JH378176","6820547","6820823","KQ053465v1","167701","167983","78","6652846"
"JH378176","7091551","7091690","KQ053741v1","1685544","1685681","37","5406007"
"JH378176","8631666","8631967","KQ057693v1","117172","117472","55","8514494"
"JH378176","8695078","8695295","KQ053093v1","1363144","1363361","54","7331934"
"JH378176","8832365","8832610","KQ058503v1","123813","124064","58","8708552"
"JH378176","8833661","8833793","KQ052982v1","972434","972567","22","7861227"
"JH378176","8893235","8893368","KQ058619v1","128477","128611","27","8764758"
"JH378176","8916852","8917153","KQ056928v1","1915686","1915996","70","7001166"
"JH378176","9012653","9012765","KQ053916v1","191904","192015","27","8820749"
"JH378176","9013334","9013467","KQ053026v1","802453","802594","30","8210881"
"JH378176","9041444","9041610","KQ053299v1","22920975","22921141","31","13879531"
"JH378176","9072947","9073226","KQ058275v1","597983","598269","54","8474964"
"JH378176","9098584","9098675","KQ053082v1","6601560","6601653","19","2497024"
"JH378176","9140409","9140561","KQ053763v1","367228","367378","41","8773181"
"JH378176","9311844","9312121","KQ052971v1","646100","646383","63","8665744"
"JH378176","9320817","9321130","KQ058485v1","518830","519142","77","8801987"
"JH378176","9391540","9391788","KQ054069v1","928440","928688","71","8463100"
"JH378176","9959449","9959728","KQ058483v1","2943412","2943683","66","7016037"
"JH378176","10422429","10422522","KQ058253v1","973922","974008","33","9448507"
"JH378176","10514723","10514986","KQ058305v1","5011759","5012038","70","5502964"
"JH378176","10630652","10630941","KQ053409v1","7074418","7074709","90","3556234"
"JH378176","10728656","10728960","KQ058184v1","1505565","1505858","59","9223091"
"JH378176","10779404","10779594","KQ054124v1","4446780","4446948","60","6332624"
"JH378176","11025032","11025201","KQ054058v1","123498","123661","55","10901534"
"JH378176","11051359","11051650","KQ052968v1","7300500","7300792","68","3750859"
"JH378176","11140512","11140807","KQ056673v1","1151371","1151663","67","9989141"
"JH378176","11184898","11185186","KQ058190v1","350088","350375","63","10834810"
"JH378176","11194093","11194370","KQ053465v1","3818784","3819069","72","7375309"
"JH378176","11213576","11213791","KQ053398v1","3158290","3158500","46","8055286"
"JH378176","11224451","11224754","KQ058348v1","1983357","1983661","72","9241094"
"JH378176","11239851","11240126","KQ053202v1","1134199","1134469","61","10105652"
"JH378177","179669","179838","KQ053223v1","2815634","2815800","34","2635965"
"JH378177","225756","226007","KQ054180v1","2985258","2985514","64","2759502"
"JH378177","690693","690924","KQ053409v1","3724488","3724719","64","3033795"
"JH378177","778431","778678","KQ054289v1","4494059","4494296","64","3715628"
"JH378177","1214756","1215052","KQ053741v1","1613413","1613703","75","398657"
"JH378177","1233110","1233367","KQ053004v1","3225867","3226135","75","1992757"
"JH378177","1242515","1242624","KQ055903v1","184486","184598","23","1058029"
"JH378177","1242920","1243087","KQ054091v1","1599976","1600116","55","357056"
"JH378177","1281969","1282277","KQ054191v1","3857584","3857880","62","2575615"
"JH378177","1365620","1365790","KQ056587v1","7602017","7602187","43","6236397"
"JH378177","1419692","1419951","KQ058561v1","7531454","7531724","68","6111762"
"JH378177","1439234","1439503","KQ057603v1","1306760","1307030","75","132474"
"JH378177","1471118","1471271","KQ057737v1","1426090","1426247","26","45028"
"JH378177","1552914","1553196","KQ053905v1","3605331","3605611","67","2052417"
"JH378177","1704034","1704244","KQ058445v1","325619","325833","62","1378415"
"JH378177","1713579","1713652","KQ053332v1","1937831","1937907","13","224252"
"JH378177","1826204","1826495","KQ054191v1","3857584","3857880","76","2031380"
"JH378177","1912580","1912883","KQ055629v1","135233","135538","67","1777347"
"JH378177","1913476","1913789","KQ053135v1","3156167","3156481","75","1242691"
"JH378177","2108515","2108818","KQ054401v1","2629005","2629296","72","520490"
"JH378177","2172305","2172609","KQ055097v1","1884579","1884874","73","287726"
"JH378177","2274949","2275232","KQ052982v1","2557979","2558263","69","283030"
"JH378177","2337769","2338042","KQ054652v1","4505","4775","66","2333264"
"JH378177","2475399","2475683","KQ052969v1","9553757","9554052","68","7078358"
"JH378177","2576557","2576704","KQ053476v1","2915425","2915579","42","338868"
"JH378177","2576905","2577020","KQ055903v1","184486","184598","29","2392419"
"JH378177","2606019","2606309","KQ056148v1","2419670","2419961","61","186349"
"JH378177","2815139","2815337","KQ053398v1","3158290","3158500","60","343151"
"JH378177","2838979","2839053","KQ056310v1","105254","105332","25","2733725"
"JH378177","2847274","2847431","KQ057737v1","1426090","1426247","32","1421184"
"JH378177","3026703","3026975","KQ058594v1","1719198","1719477","65","1307505"
"JH378177","3041706","3041932","ABDC02049463v1","260","485","68","3041446"
"JH378177","3203811","3204000","KQ054191v1","1574522","1574711","47","1629289"
"JH378177","3336895","3337168","KQ053654v1","3819217","3819495","74","482322"
"JH378177","3412230","3412524","KQ055766v1","4175053","4175345","66","762823"
"JH378177","3454664","3454831","KQ058383v1","9907100","9907256","44","6452436"
"JH378177","3534520","3534808","KQ053631v1","9116387","9116675","66","5581867"
"JH378177","3551175","3551434","KQ058505v1","7982709","7982947","84","4431534"
"JH378177","3638225","3638534","KQ055236v1","2049624","2049930","69","1588601"
"JH378177","3670656","3670947","KQ055457v1","11296503","11296794","67","7625847"
"JH378177","3686023","3686328","KQ052970v1","5509997","5510301","74","1823974"
"JH378177","3823351","3823507","KQ058316v1","1612479","1612626","32","2210872"
"JH378177","3873106","3873226","KQ056855v1","2808237","2808368","41","1064869"
"JH378177","3997075","3997354","KQ053146v1","2819587","2819868","63","1177488"
"JH378177","4079312","4079588","KQ053288v1","2218996","2219287","69","1860316"
"JH378177","4327048","4327334","KQ053398v1","2935840","2936118","64","1391208"
"JH378177","4440819","4440942","KQ057260v1","977724","977847","26","3463095"
"JH378177","4441329","4441466","KQ054693v1","1748877","1749022","40","2692452"
"JH378177","4484546","4484873","KQ054606v1","452258","452567","87","4032288"
"JH378177","4536830","4537108","KQ053763v1","17735","18009","82","4519095"
"JH378177","4566407","4566684","KQ057290v1","1053741","1054027","64","3512666"
"JH378177","4828790","4829086","KQ055457v1","1355598","1355888","64","3473192"
"JH378177","5146468","5146610","KQ058494v1","8405772","8405923","42","3259304"
"JH378177","5365190","5365481","KQ053631v1","9631170","9631468","52","4265980"
"JH378177","5566257","5566571","KQ055872v1","14673747","14674061","76","9107490"
"JH378177","6025420","6025700","KQ056773v1","168010","168288","65","5857410"
"JH378177","6191107","6191276","KQ057909v1","4153743","4153903","44","2037364"
"JH378177","6261746","6261912","KQ053082v1","2181762","2181924","36","4079984"
"JH378177","6520768","6520914","KQ055406v1","2968","3106","34","6517800"
"JH378177","6729214","6729499","KQ058316v1","4697990","4698273","63","2031224"
"JH378177","6811890","6812164","KQ053190v1","4987885","4988162","60","1824005"
"JH378177","7356148","7356463","KQ058389v1","2329886","2330179","77","5026262"
"JH378177","8406525","8406764","KQ052969v1","1108868","1109131","84","7297657"
"JH378177","8421044","8421347","KQ058490v1","420741","421044","61","8000303"
"JH378177","8583251","8583546","KQ056147v1","1064032","1064323","76","7519219"
"JH378177","8778941","8779039","KQ053082v1","6601560","6601653","26","2177381"
"JH378177","8821545","8821851","KQ055872v1","12987862","12988141","80","4166317"
"JH378177","8868258","8868559","KQ055457v1","2061137","2061448","71","6807121"
"JH378177","9444381","9444655","KQ053278v1","215181","215451","71","9229200"
"JH378177","9565598","9565680","KQ053398v1","4200835","4200909","26","5364763"
"JH378177","9598983","9599130","KQ058350v1","446681","446829","43","9152302"
"JH378177","9644061","9644194","KQ058550v1","4488728","4488857","27","5155333"
"JH378177","9746198","9746459","KQ056672v1","4169432","4169691","69","5576766"
"JH378177","9816186","9816480","KQ055097v1","2825545","2825834","69","6990641"
"JH378177","9818602","9818897","KQ053343v1","1729289","1729583","61","8089313"
"JH378177","9870961","9871254","KQ058184v1","1505565","1505858","60","8365396"
"JH378177","9989736","9990055","KQ054466v1","2183618","2183917","75","7806118"
"JH378177","10118424","10118579","KQ052968v1","10427732","10427888","33","309308"
"JH378177","10135341","10135623","KQ054068v1","3341291","3341579","71","6794050"
"JH378177","10189432","10189683","KQ052970v1","2715607","2715860","70","7473825"
"JH378177","10194730","10195023","KQ056331v1","1501968","1502262","58","8692762"
"JH378177","10362507","10362632","KQ053299v1","22459675","22459802","32","12097168"
"JH378177","10500470","10500624","KQ058345v1","136254","136406","41","10364216"
"JH378177","10662567","10662706","KQ053037v1","3255963","3256108","35","7406604"
"JH378177","11015358","11015645","KQ052968v1","7300500","7300792","57","3714858"
"JH378177","11029209","11029476","KQ053115v1","2180745","2181002","68","8848464"
"JH378177","11049366","11049569","KQ053740v1","3206530","3206729","50","7842836"
"JH378178","366216","366479","KQ057143v1","1759528","1759785","73","1393312"
"JH378178","597119","597426","KQ053554v1","1157184","1157483","67","560065"
"JH378178","699390","699475","KQ053223v1","2552349","2552442","30","1852959"
"JH378178","699594","699725","KQ054533v1","1111592","1111720","27","411998"
"JH378178","1062415","1062569","KQ054180v1","70685","70834","37","991730"
"JH378178","1099946","1100193","KQ054069v1","159011","159235","69","940935"
"JH378178","1106157","1106332","KQ056996v1","1524030","1524195","39","417873"
"JH378178","1185560","1185857","KQ053631v1","7288314","7288608","72","6102754"
"JH378178","1194147","1194251","KQ053157v1","8174152","8174260","28","6980005"
"JH378178","1331955","1332033","KQ055457v1","846484","846563","22","485471"
"JH378178","1444058","1444339","KQ055097v1","2825545","2825834","70","1381487"
"JH378178","1452622","1452939","KQ056404v1","176748","177054","76","1275874"
"JH378178","1554222","1554496","KQ052968v1","13260777","13261056","63","11706555"
"JH378178","1802612","1802767","KQ055404v1","4095582","4095739","39","2292970"
"JH378178","2203042","2203298","KQ052970v1","566850","567108","73","1636192"
"JH378178","2728194","2728427","KQ057345v1","223285","223507","69","2504909"
"JH378178","3076433","3076723","KQ053093v1","1361295","1361576","83","1715138"
"JH378178","3515454","3515758","KQ055140v1","3474676","3474973","81","40778"
"JH378178","3923011","3923293","KQ053190v1","4987885","4988162","62","1064874"
"JH378178","3951955","3952225","KQ053093v1","1361295","1361576","73","2590660"
"JH378178","3953841","3953992","KQ054196v1","237","387","42","3953604"
"JH378178","3957390","3957689","KQ053816v1","7464708","7465010","59","3507318"
"JH378178","4050664","4050952","KQ052971v1","841846","842131","68","3208818"
"JH378178","4746727","4746959","KQ052968v1","8641435","8641673","60","3894708"
"JH378178","4885369","4885610","KQ058394v1","15440202","15440431","64","10554833"
"JH378178","5314082","5314256","KQ057649v1","424252","424417","45","4889830"
"JH378178","5315186","5315314","KQ055957v1","554477","554608","28","4760709"
"JH378178","5344825","5345103","KQ054069v1","6924447","6924716","74","1579622"
"JH378178","5513435","5513702","KQ054857v1","883935","884179","78","4629500"
"JH378178","5650747","5650974","KQ053082v1","1408848","1409073","69","4241899"
"JH378178","6055937","6056100","KQ054533v1","1027813","1027974","31","5028124"
"JH378178","6436794","6437110","KQ052968v1","7013898","7014196","73","577104"
"JH378178","6670289","6670485","KQ056475v1","396846","397033","53","6273443"
"JH378178","6904258","6904417","KQ057737v1","1426090","1426247","27","5478168"
"JH378178","6913423","6913730","KQ058184v1","1505565","1505858","80","5407858"
"JH378178","6987249","6987547","KQ058428v1","2055160","2055453","66","4932089"
"JH378178","7051111","7051395","KQ052968v1","13260777","13261056","67","6209666"
"JH378178","7311044","7311393","KQ053609v1","2180889","2181223","108","5130155"
"JH378178","7323608","7323734","KQ058550v1","2678881","2679004","26","4644727"
"JH378178","7604749","7604920","KQ057649v1","424252","424417","33","7180497"
"JH378178","7713146","7713440","KQ056345v1","621994","622295","62","7091152"
"JH378178","8375655","8375954","KQ053398v1","2545768","2546067","78","5829887"
"JH378178","8808952","8809199","KQ056147v1","3491603","3491838","75","5317349"
"JH378178","8848622","8848740","KQ055651v1","2477255","2477367","37","6371367"
"JH378178","8912571","8912864","KQ054932v1","9022614","9022904","60","110043"
"JH378178","9290567","9290851","KQ057909v1","585646","585918","66","8704921"
"JH378178","10019675","10019971","KQ058183v1","594864","595153","76","9424811"
"JH378179","359769","359914","KQ053081v1","7678221","7678366","38","7318452"
"JH378179","787450","787726","KQ053718v1","1496748","1497022","73","709298"
"JH378179","935047","935176","KQ055097v1","2255144","2255272","22","1320097"
"JH378179","1122271","1122414","KQ054466v1","1866785","1866925","30","744514"
"JH378179","1237098","1237392","KQ053299v1","6282965","6283256","79","5045867"
"JH378179","1505487","1505771","KQ054412v1","2490468","2490761","65","984981"
"JH378179","1560105","1560325","KQ058004v1","2720169","2720394","59","1160064"
"JH378179","1569801","1570054","KQ055192v1","1201363","1201615","73","368438"
"JH378179","1600966","1601085","KQ058494v1","5227445","5227567","24","3626479"
"JH378179","1601902","1602070","KQ056996v1","1524030","1524195","41","77872"
"JH378179","1790113","1790369","KQ054932v1","3846859","3847131","72","2056746"
"JH378179","1943248","1943450","KQ055893v1","679395","679599","56","1263853"
"JH378179","2033148","2033414","KQ055364v1","1515825","1516085","54","517323"
"JH378179","2524110","2524401","KQ056672v1","3010023","3010308","61","485913"
"JH378179","2785440","2785717","KQ054713v1","3140905","3141166","79","355465"
"JH378179","3862055","3862347","KQ057118v1","4601602","4601894","59","739547"
"JH378179","4323695","4323963","KQ055662v1","907053","907314","72","3416642"
"JH378179","4332297","4332598","KQ058428v1","1609842","1610139","64","2722455"
"JH378179","5352964","5353242","KQ053905v1","3753788","3754052","78","1599176"
"JH378179","5382151","5382432","KQ053763v1","3936916","3937207","62","1445235"
"JH378179","5493869","5494013","KQ055406v1","2968","3106","34","5490901"
"JH378179","5614096","5614404","KQ053146v1","920355","920648","87","4693741"
"JH378179","6512493","6512601","KQ057380v1","2533902","2534012","29","3978591"
"JH378179","6792949","6793067","KQ057345v1","1181543","1181650","34","5611406"
"JH378179","7088263","7088552","KQ057035v1","3194687","3194980","67","3893576"
"JH378179","7102104","7102249","KQ053643v1","1401609","1401754","40","5700495"
"JH378179","7553150","7553453","KQ053894v1","1262767","1263078","71","6290383"
"JH378179","7835314","7835557","KQ057213v1","475202","475423","71","7360112"
"JH378179","8805299","8805550","KQ058538v1","1444447","1444703","57","7360852"
"JH378179","9302128","9302420","KQ056587v1","9000240","9000528","59","301888"
"JH378179","9305643","9305785","KQ056663v1","464182","464321","35","8841461"
"JH378179","9401680","9401974","KQ054510v1","8555095","8555387","74","846585"
"JH378179","9605704","9605834","KQ057901v1","1218014","1218146","30","8387690"
"JH378179","9669898","9670101","KQ053294v1","648","849","51","9669250"
"JH378179","9971993","9972125","KQ058605v1","2691696","2691830","25","7280297"
"JH378179","10001100","10001309","KQ052970v1","11415688","11415897","51","1414588"
"JH378179","10002968","10003260","KQ058561v1","4225175","4225466","71","5777793"
"JH378179","10090804","10090921","KQ055097v1","2325791","2325906","36","7765013"
"JH378179","10133808","10134103","KQ058094v1","7832529","7832815","63","2301279"
"JH378179","10136112","10136375","KQ055457v1","7311489","7311771","66","2824623"
"JH378179","10160995","10161271","KQ053299v1","22323868","22324139","79","12162873"
"JH378179","10369979","10370268","KQ053916v1","20061","20349","64","10349918"
"JH378179","10468190","10468471","KQ058383v1","5122379","5122654","70","5345811"
"JH378179","10481036","10481338","KQ058572v1","1453592","1453891","68","9027444"
"JH378179","10740228","10740511","KQ053741v1","1482396","1482684","70","9257832"
"JH378179","10843484","10843683","KQ054058v1","1737833","1738018","54","9105651"
"JH378180","221749","222025","KQ053190v1","4987885","4988162","60","4766136"
"JH378180","497392","497655","KQ055247v1","216427","216708","68","280965"
"JH378180","612227","612525","KQ053365v1","104844","105138","65","507383"
"JH378180","772903","773188","KQ058542v1","552861","553154","66","220042"
"JH378180","775736","775867","KQ053752v1","1144688","1144821","21","368952"
"JH378180","793497","793746","KQ056911v1","1003682","1003922","77","210185"
"JH378180","834735","834929","KQ057034v1","3470754","3470928","61","2636019"
"JH378180","864962","865256","KQ053300v1","2874445","2874736","66","2009483"
"JH378180","930158","930363","KQ053631v1","11530054","11530254","65","10599896"
"JH378180","946701","947007","KQ058472v1","1327185","1327479","71","380484"
"JH378180","965130","965341","KQ058505v1","3952082","3952290","49","2986952"
"JH378180","995402","995725","KQ055893v1","2313607","2313921","80","1318205"
"JH378180","1122766","1123065","KQ058350v1","6740286","6740580","66","5617520"
"JH378180","1208599","1208721","KQ056643v1","1279625","1279744","39","71026"
"JH378180","1235122","1235435","KQ058275v1","201680","201968","119","1033442"
"JH378180","1780798","1780932","KQ058640v1","122151","122286","29","1658647"
"JH378180","2228946","2229199","KQ056014v1","278314","278570","78","1950632"
"JH378180","2270861","2271140","KQ053146v1","2819587","2819868","65","548726"
"JH378180","2895338","2895634","KQ057875v1","561558","561851","72","2333780"
"JH378180","3154891","3155197","KQ054704v1","215433","215738","65","2939458"
"JH378180","3245118","3245362","KQ058272v1","3223553","3223798","72","21565"
"JH378180","3252019","3252225","KQ054724v1","2773806","2774015","53","478213"
"JH378180","3282219","3282503","KQ058317v1","5506620","5506904","83","2224401"
"JH378180","3429009","3429297","KQ057290v1","2953971","2954265","73","475038"
"JH378180","3449926","3450131","KQ053070v1","1971067","1971271","53","1478859"
"JH378180","3631748","3631885","KQ058405v1","1518051","1518190","36","2113697"
"JH378180","3758640","3758934","KQ054693v1","832788","833076","72","2925852"
"JH378180","3825247","3825338","KQ055214v1","452701","452790","19","3372546"
"JH378180","3849860","3850152","KQ055141v1","4683951","4684249","78","834091"
"JH378180","3939980","3940276","KQ054804v1","52712","53011","75","3887268"
"JH378180","4072969","4073265","KQ056147v1","1064032","1064323","61","3008937"
"JH378180","4144837","4145107","KQ057821v1","37392","37663","65","4107445"
"JH378180","4402384","4402501","KQ055808v1","1908479","1908585","30","2493905"
"JH378180","4681539","4681650","KQ054660v1","5437047","5437165","31","755508"
"JH378180","4774800","4774973","KQ054510v1","8888528","8888700","37","4113728"
"JH378180","4860427","4860566","KQ056147v1","2168964","2169108","29","2691463"
"JH378180","4908107","4908358","KQ058427v1","11800558","11800805","72","6892451"
"JH378180","5020596","5020636","KQ057082v1","642960","642996","11","4377636"
"JH378180","5020696","5020863","KQ053004v1","4759784","4759947","44","260912"
"JH378180","5292528","5292809","KQ054868v1","2229582","2229854","67","3062946"
"JH378180","5295526","5295802","KQ053409v1","3716306","3716585","58","1579220"
"JH378180","5323435","5323727","KQ054510v1","9729880","9730175","68","4406445"
"JH378180","5528839","5529142","KQ054179v1","5850900","5851209","81","322061"
"JH378180","5734941","5735173","KQ054069v1","159011","159235","55","5575930"
"JH378180","5872978","5873267","KQ055957v1","1731327","1731617","76","4141651"
"JH378180","6353336","6353644","KQ058585v1","580456","580763","72","5772880"
"JH378180","6376745","6377073","KQ053409v1","6036210","6036520","85","340535"
"JH378180","6657304","6657606","KQ055872v1","14090556","14090859","72","7433252"
"JH378180","6752708","6752866","KQ057737v1","1426090","1426247","34","5326618"
"JH378180","6993668","6993933","KQ057522v1","1670299","1670546","65","5323369"
"JH378180","6999637","6999845","KQ057737v1","1779203","1779413","52","5220434"
"JH378180","7061608","7061759","KQ058105v1","498394","498537","34","6563214"
"JH378180","7087870","7088153","KQ053409v1","6051156","6051445","67","1036714"
"JH378180","7207486","7207760","KQ053409v1","3716306","3716585","70","3491180"
"JH378180","7256792","7257112","KQ053398v1","2816605","2816914","75","4440187"
"JH378180","7458475","7458716","KQ058616v1","1966485","1966734","70","5491990"
"JH378180","7468231","7468547","KQ056014v1","335464","335774","76","7132767"
"JH378180","7692540","7692850","KQ058004v1","5010124","5010435","67","2682416"
"JH378180","7808917","7809058","KQ056147v1","2168964","2169108","36","5639953"
"JH378180","7900393","7900758","KQ058287v1","982841","983179","115","6917552"
"JH378180","7916251","7916547","KQ058561v1","4466656","4466945","68","3449595"
"JH378180","8057481","8057790","KQ056920v1","1346398","1346707","82","6711083"
"JH378180","8099814","8100109","KQ054510v1","6887667","6887971","78","1212147"
"JH378180","8135054","8135204","KQ058427v1","3400358","3400512","34","4734696"
"JH378180","8202143","8202439","KQ056475v1","2179070","2179363","63","6023073"
"JH378180","8271752","8271806","KQ055384v1","420057","420110","13","7851695"
"JH378180","8757753","8758018","KQ055662v1","4683524","4683789","82","4074229"
"JH378180","8800471","8800666","KQ058427v1","4705427","4705629","57","4095044"
"JH378180","9540565","9540856","KQ052981v1","658787","659079","64","8881778"
"JH378180","9580908","9581038","KQ058004v1","2254984","2255111","30","7325924"
"JH378180","9694977","9695272","KQ053190v1","530742","531036","77","9164235"
"JH378180","9720661","9720948","KQ058383v1","5944247","5944518","64","3776414"
"JH378180","9731434","9731712","KQ052968v1","13260777","13261056","66","3529343"
"JH378180","9740969","9741219","KQ052971v1","6441372","6441626","59","3299597"
"JH378180","9851677","9851981","KQ058288v1","34632","34947","71","9817045"
"JH378180","9874641","9874782","KQ052968v1","10427732","10427888","44","553091"
"JH378180","9885869","9886163","KQ054401v1","2629005","2629296","69","7256864"
"JH378180","9957754","9957936","KQ053230v1","1511650","1511838","47","8446104"
"JH378180","10003028","10003288","KQ056404v1","1771928","1772196","71","8231100"
"JH378180","10090419","10090586","KQ054533v1","1027813","1027974","37","9062606"
"JH378180","10205219","10205514","KQ055529v1","1174084","1174371","64","9031135"
"JH378180","10363684","10363901","KQ055978v1","1055761","1055981","58","9307923"
"JH378180","10630535","10630807","KQ053432v1","3710952","3711220","69","6919583"
"JH378181","1284666","1284947","KQ054868v1","2229582","2229854","71","944916"
"JH378181","1813237","1813385","KQ056147v1","2168964","2169108","34","355727"
"JH378181","2129160","2129444","KQ054804v1","964015","964313","68","1165145"
"JH378181","2207753","2207878","KQ057082v1","848615","848730","32","1359138"
"JH378181","2414074","2414374","KQ056996v1","837133","837431","76","1576941"
"JH378181","2519288","2519547","KQ053774v1","3529459","3529722","70","1010171"
"JH378181","2578453","2578679","KQ054921v1","1712964","1713196","61","865489"
"JH378181","2624703","2624972","KQ057291v1","667476","667747","68","1957227"
"JH378181","2680840","2681004","KQ055872v1","13212412","13212576","50","10531572"
"JH378181","3616673","3616763","KQ055183v1","924207","924302","26","2692466"
"JH378181","3864647","3864814","KQ056996v1","1524030","1524195","35","2340617"
"JH378181","4115239","4115516","KQ053740v1","2323389","2323680","76","1791850"
"JH378181","4154877","4155159","KQ057205v1","1669338","1669614","73","2485539"
"JH378181","4345735","4346040","KQ058377v1","25815","26128","80","4319920"
"JH378181","4459913","4460220","KQ054191v1","2184540","2184841","67","2275373"
"JH378181","4580667","4580949","KQ055404v1","3692832","3693118","65","887835"
"JH378181","4674288","4674571","KQ054660v1","2994204","2994490","60","1680084"
"JH378181","4678000","4678268","KQ057204v1","1712399","1712670","66","2965601"
"JH378181","4998195","4998324","KQ054179v1","3927334","3927468","21","1070861"
"JH378181","5004917","5005192","KQ055087v1","1145575","1145867","79","3859342"
"JH378181","5570830","5571123","KQ053959v1","2839561","2839850","66","2731269"
"JH378181","5718329","5718626","KQ058183v1","3707459","3707754","69","2010870"
"JH378181","6011045","6011322","KQ057118v1","2418455","2418734","63","3592590"
"JH378181","6052234","6052297","KQ053004v1","1367501","1367567","18","4684733"
"JH378181","6123117","6123353","KQ056762v1","1558119","1558341","62","4564998"
"JH378181","6281234","6281436","KQ052970v1","3216316","3216523","45","3064918"
"JH378181","6300089","6300378","KQ058328v1","4012912","4013206","60","2287177"
"JH378181","6372020","6372282","KQ057290v1","862441","862706","72","5509579"
"JH378181","6375657","6375969","KQ054786v1","934497","934799","77","5441160"
"JH378181","6621746","6621889","KQ053354v1","702320","702452","31","5919426"
"JH378181","6862538","6862627","KQ053763v1","508269","508363","20","6354269"
"JH378181","6865631","6865775","KQ053300v1","3146249","3146389","35","3719382"
"JH378181","6917601","6917876","KQ058329v1","663480","663767","68","6254121"
"JH378181","6991876","6992179","KQ053299v1","1682676","1682983","73","5309200"
"JH378181","8205128","8205394","KQ058383v1","2699813","2700083","66","5505315"
"JH378181","8295439","8295733","KQ055893v1","2727403","2727703","63","5568036"
"JH378181","8604172","8604470","KQ054628v1","802926","803228","75","7801246"
"JH378181","8925902","8926138","KQ057909v1","104692","104936","71","8821210"
"JH378181","9176566","9176845","KQ058004v1","1480411","1480689","78","7696155"
"JH378181","9261956","9262064","KQ054456v1","5057079","5057175","35","4204877"
"JH378181","9407796","9408078","KQ053763v1","4154338","4154624","68","5253458"
"JH378181","9586125","9586414","KQ053082v1","1085491","1085778","72","8500634"
"JH378181","9698117","9698442","KQ054401v1","2629005","2629296","88","7069112"
"JH378181","9990268","9990526","KQ052968v1","10745715","10745973","63","755447"
"JH378181","10005388","10005449","KQ053696v1","870676","870725","22","9134712"
"JH378181","10220951","10221224","KQ052970v1","19670046","19670323","66","9449095"
"JH378181","10260616","10260771","KQ058433v1","381762","381914","39","9878854"
"JH378181","10424932","10425224","KQ054725v1","2218271","2218569","50","8206661"
"JH378181","10469164","10469449","KQ054224v1","428324","428601","56","10040840"
"JH378181","10478130","10478335","KQ054932v1","5992696","5992910","50","4485434"
"JH378181","10504576","10504823","KQ054826v1","9969237","9969502","78","535339"
"JH378181","10509916","10510146","KQ055162v1","650995","651207","60","9858921"
"JH378181","10517786","10518077","KQ053176v1","127570","127860","66","10390216"
"JH378181","10520749","10521037","KQ054068v1","3341291","3341579","64","7179458"
"JH378181","10574480","10574783","KQ053554v1","1157184","1157483","69","9417296"
"JH378181","10654014","10654309","KQ055247v1","3219331","3219626","81","7434683"
"JH378182","295498","295784","KQ058257v1","559477","559763","64","263979"
"JH378182","298177","298352","KQ053299v1","2901484","2901684","55","2603307"
"JH378182","324359","324665","KQ057788v1","561223","561518","63","236864"
"JH378182","628285","628574","KQ053096v1","602899","603182","69","25386"
"JH378182","670933","671195","KQ055468v1","1908448","1908731","75","1237515"
"JH378182","689627","689930","KQ058428v1","1609842","1610139","79","920215"
"JH378182","736381","736493","KQ053785v1","828746","828862","34","92365"
"JH378182","787871","788009","KQ053115v1","1650505","1650644","31","862634"
"JH378182","857883","858177","KQ053026v1","3680523","3680807","70","2822640"
"JH378182","877791","877990","KQ055717v1","1890031","1890236","58","1012240"
"JH378182","975743","975908","KQ053004v1","4759784","4759947","38","3784041"
"JH378182","1326008","1326135","KQ053299v1","6849474","6849602","24","5523466"
"JH378182","1364444","1364557","KQ055872v1","15136888","15137001","32","13772444"
"JH378182","1439482","1439786","KQ058427v1","5781896","5782172","86","4342414"
"JH378182","1465528","1465662","KQ057449v1","1943131","1943261","30","477603"
"JH378182","1495667","1495809","KQ053115v1","1650505","1650644","36","154838"
"JH378182","1550299","1550527","KQ052970v1","10693922","10694149","55","9143623"
"JH378182","1623374","1623542","KQ055425v1","1445594","1445758","46","177780"
"JH378182","1638861","1639140","KQ055629v1","4007668","4007948","67","2368807"
"JH378182","1647244","1647401","KQ055549v1","3675407","3675567","37","2028163"
"JH378182","1701520","1701791","KQ053299v1","11017319","11017592","65","9315799"
"JH378182","1833444","1833679","KQ052970v1","21565783","21566032","74","19732339"
"JH378182","1856880","1857183","KQ053420v1","122023","122324","75","1734857"
"JH378182","2013030","2013201","KQ055808v1","1957736","1957912","58","55294"
"JH378182","2015650","2015954","KQ054401v1","2629005","2629296","68","613355"
"JH378182","2045703","2045908","KQ056493v1","886447","886648","51","1159256"
"JH378182","2055362","2055524","KQ056996v1","1524030","1524195","33","531332"
"JH378182","2069706","2069998","KQ052970v1","8274642","8274940","68","6204936"
"JH378182","2231898","2232017","KQ056234v1","886803","886922","27","1345095"
"JH378182","2360182","2360434","KQ053343v1","1950988","1951230","77","409194"
"JH378182","2381485","2381560","KQ055946v1","371653","371727","25","2009832"
"JH378182","2382301","2382457","KQ053157v1","5478543","5478695","35","3096242"
"JH378182","2501669","2501989","KQ057532v1","1410219","1410539","85","1091450"
"JH378182","2503288","2503581","KQ056790v1","446564","446855","61","2056724"
"JH378182","2781481","2781623","KQ056147v1","2168964","2169108","31","612517"
"JH378182","3509450","3509726","KQ053409v1","3716306","3716585","77","206856"
"JH378182","3632489","3632788","KQ053299v1","11542441","11542747","73","7909952"
"JH378182","3885718","3885980","KQ057290v1","2383871","2384129","82","1501847"
"JH378182","4407521","4407812","KQ055097v1","2825545","2825834","77","1581976"
"JH378182","5217202","5217485","KQ058328v1","808528","808806","76","4408674"
"JH378182","5247328","5247638","KQ055457v1","2061137","2061448","72","3186191"
"JH378182","5359694","5360005","KQ055787v1","1064992","1065293","70","4294702"
"JH378182","5362238","5362555","KQ058004v1","2495177","2495491","66","2867061"
"JH378182","5556896","5557103","KQ057711v1","824759","824972","58","4732137"
"JH378182","6129750","6130022","KQ055119v1","3538344","3538616","87","2591406"
"JH378182","7099136","7099407","KQ055893v1","2015012","2015285","72","5084124"
"JH378182","7324353","7324645","KQ053365v1","104844","105138","65","7219509"
"JH378182","7384336","7384631","ABDC02054223v1","3152","3442","63","7381184"
"JH378182","7694435","7694661","KQ058539v1","875694","875928","64","6818741"
"JH378182","7699666","7699959","KQ058272v1","6007682","6007982","71","1691984"
"JH378182","7912162","7912439","KQ054510v1","9222042","9222321","69","1309880"
"JH378182","8049760","8050042","KQ054745v1","919926","920212","77","7129834"
"JH378182","8050220","8050507","KQ054412v1","2490468","2490761","78","5559752"
"JH378182","8345239","8345490","KQ058627v1","3341899","3342143","61","5003340"
"JH378182","8351571","8351840","KQ055479v1","855073","855336","77","7496498"
"JH378182","8458632","8458749","KQ053343v1","2133194","2133295","32","6325438"
"JH378182","8489236","8489508","KQ055173v1","452351","452623","76","8036885"
"JH378182","8897225","8897415","KQ058301v1","333804","333994","55","8563421"
"JH378182","9020593","9020750","KQ055872v1","3992534","3992693","37","5028059"
"JH378182","9086929","9087083","KQ054693v1","1748877","1749022","47","7338052"
"JH378182","9135650","9135886","KQ052970v1","17324014","17324257","64","8188364"
"JH378182","9316609","9316845","KQ058503v1","123813","124064","60","9192796"
"JH378182","9364757","9365000","KQ054068v1","1263304","1263537","75","8101453"
"JH378182","9379717","9379989","KQ054826v1","9969237","9969502","69","589520"
"JH378182","9398145","9398411","KQ053081v1","1237660","1237932","81","8160485"
"JH378182","9466758","9466886","KQ056147v1","1828259","1828388","23","7638499"
"JH378182","10179612","10179719","KQ054901v1","2051416","2051518","23","8128196"
"JH378182","10281297","10281629","KQ058248v1","862888","863197","93","9418409"
"JH378182","10298768","10298912","KQ053763v1","367228","367378","38","9931540"
"JH378182","10329751","10330060","KQ058427v1","7552507","7552810","74","2777244"
"JH378183","41276","41425","KQ053299v1","5209668","5209811","45","5168392"
"JH378183","122776","123020","KQ057909v1","12196801","12197037","60","12074025"
"JH378183","148114","148248","KQ053948v1","2765570","2765701","24","2617456"
"JH378183","195785","196091","KQ054628v1","802926","803228","69","607141"
"JH378183","335704","336008","KQ058427v1","7552507","7552810","68","7216803"
"JH378183","455215","455535","KQ056475v1","2179070","2179363","74","1723855"
"JH378183","549248","549540","KQ052969v1","11182978","11183250","77","10633730"
"JH378183","695302","695383","KQ052968v1","9483686","9483763","25","8788384"
"JH378183","877988","878283","KQ058317v1","5506620","5506904","75","4628632"
"JH378183","929746","930031","KQ057560v1","1194310","1194592","71","264564"
"JH378183","994063","994189","KQ056148v1","2604630","2604758","34","1610567"
"JH378183","1417698","1417984","KQ058272v1","3244025","3244312","88","1826327"
"JH378183","1512469","1512771","KQ053816v1","7474325","7474608","84","5961856"
"JH378183","1533801","1534108","KQ055035v1","3034480","3034786","75","1500679"
"JH378183","1534504","1534551","KQ052968v1","10904673","10904714","20","9370169"
"JH378183","1534870","1534948","KQ055979v1","1425","1498","23","1533445"
"JH378183","1576998","1577307","KQ053554v1","2471177","2471484","69","894179"
"JH378183","1862527","1862845","KQ053620v1","156684","156991","77","1705843"
"JH378183","2086213","2086511","KQ055852v1","1231373","1231668","66","854840"
"JH378183","2269823","2269919","KQ053763v1","508269","508363","23","1761554"
"JH378183","2364073","2364354","KQ054069v1","955693","955974","69","1408380"
"JH378183","2649418","2649673","KQ058280v1","515894","516148","73","2133524"
"JH378183","3802087","3802239","KQ054179v1","2203336","2203492","34","1598751"
"JH378183","4104000","4104281","KQ058257v1","559477","559763","65","3544523"
"JH378183","4442345","4442627","KQ056773v1","168010","168288","67","4274335"
"JH378183","4565260","4565556","KQ058184v1","1505565","1505858","65","3059695"
"JH378183","4655997","4656283","KQ054412v1","2490468","2490761","59","2165529"
"JH378183","4826959","4827173","KQ055375v1","809382","809596","62","4017577"
"JH378183","5070835","5071120","KQ058417v1","265847","266135","75","4804988"
"JH378183","5167772","5168035","KQ058272v1","2867774","2868036","68","2299998"
"JH378183","5226353","5226592","KQ058328v1","2569266","2569497","61","2657087"
"JH378183","6315886","6316198","KQ056108v1","1110776","1111092","91","5205110"
"JH378183","6573655","6573942","KQ052970v1","8520800","8521088","60","1947145"
"JH378183","6777830","6778125","KQ052971v1","841846","842131","63","5935984"
"JH378183","6955816","6956096","KQ058383v1","5944247","5944518","69","1011569"
"JH378183","7236511","7236696","KQ057737v1","1188439","1188621","50","6048072"
"JH378183","7244122","7244300","KQ052969v1","7479624","7479813","64","235502"
"JH378183","7586268","7586558","KQ053476v1","3712115","3712409","71","3874153"
"JH378183","7732887","7733188","KQ054412v1","2490468","2490761","56","5242419"
"JH378183","7774511","7774632","KQ058483v1","4711310","4711430","23","3063201"
"JH378183","7940532","7940825","KQ057560v1","2450216","2450512","56","5490316"
"JH378183","8695889","8696175","KQ054510v1","8555095","8555387","63","140794"
"JH378183","8825588","8825850","KQ055108v1","2927238","2927477","67","5898350"
"JH378183","9527399","9527543","KQ053081v1","7678221","7678366","32","1849178"
"JH378183","9551275","9551561","KQ055872v1","4131960","4132231","81","5419315"
"JH378183","9905971","9906265","KQ057317v1","983417","983718","64","8922554"
"JH378183","9986214","9986488","KQ057840v1","682650","682933","70","9303564"
"JH378183","10064111","10064379","KQ054124v1","2442155","2442433","75","7621956"
"JH378183","10080607","10080760","KQ057205v1","1386607","1386765","51","8694000"
"JH378183","10122282","10122587","KQ053741v1","1270673","1270967","84","8851609"
"JH378183","10184202","10184408","KQ057290v1","4745481","4745684","44","5438721"
"JH378183","10276197","10276382","KQ053332v1","848203","848389","55","9427994"
"JH378183","10312870","10313090","KQ053398v1","3158290","3158500","60","7154580"
"JH378183","10352587","10352886","KQ053093v1","1738898","1739201","69","8613689"
"JH378184","95522","95575","KQ053632v1","195846","195898","9","100324"
"JH378184","142410","142562","KQ053202v1","830179","830322","36","687769"
"JH378184","933351","933618","KQ055787v1","914297","914538","81","19054"
"JH378184","951512","951811","KQ056672v1","3082150","3082439","68","2130638"
"JH378184","1000223","1000490","KQ057204v1","1079165","1079456","82","78942"
"JH378184","1165305","1165572","KQ056440v1","691104","691369","80","474201"
"JH378184","1392312","1392572","KQ057702v1","1579642","1579892","61","187330"
"JH378184","1516363","1516685","KQ057737v1","110075","110366","86","1406288"
"JH378184","2352340","2352597","KQ052971v1","6441372","6441626","63","4089032"
"JH378184","2365239","2365487","KQ056673v1","1511657","1511915","79","853582"
"JH378184","2499123","2499360","KQ055957v1","640033","640248","71","1859090"
"JH378184","2705105","2705384","KQ055725v1","1064759","1065040","67","1640346"
"JH378184","2774460","2774749","KQ056855v1","2789429","2789717","61","14969"
"JH378184","2917807","2918044","KQ053683v1","8051","8283","65","2909756"
"JH378184","2918788","2918938","KQ053398v1","2883602","2883749","41","35186"
"JH378184","2927123","2927432","KQ058004v1","3883150","3883446","73","956027"
"JH378184","2968642","2968785","KQ058280v1","170740","170874","31","2797902"
"JH378184","2973571","2973887","KQ058184v1","1505565","1505858","81","1468006"
"JH378184","3084909","3085183","KQ057363v1","333757","334010","73","2751152"
"JH378184","3100979","3101274","KQ053146v1","2819587","2819868","74","281392"
"JH378184","3261152","3261429","KQ054499v1","2146605","2146883","64","1114547"
"JH378184","3415739","3415904","KQ054606v1","554177","554332","43","2861562"
"JH378184","3429872","3430031","KQ055457v1","9458412","9458563","44","6028540"
"JH378184","3430118","3430249","KQ053718v1","316226","316356","30","3113892"
"JH378184","3658638","3658937","KQ053554v1","2471177","2471484","62","1187461"
"JH378184","3679570","3679860","KQ056147v1","1064032","1064323","62","2615538"
"JH378184","4131400","4131702","KQ058184v1","1505565","1505858","67","2625835"
"JH378184","4271419","4271621","KQ058505v1","3952082","3952290","45","319337"
"JH378184","4367015","4367301","KQ058248v1","1222370","1222655","65","3144645"
"JH378184","4413738","4413994","KQ054510v1","1372478","1372735","78","3041260"
"JH378184","4424621","4424922","KQ053146v1","329936","330234","60","4094685"
"JH378184","4463380","4463661","KQ055735v1","667472","667747","75","3795908"
"JH378184","4557204","4557502","KQ058184v1","1505565","1505858","63","3051639"
"JH378184","4706836","4706901","KQ055979v1","1425","1498","15","4705411"
"JH378184","4803302","4803600","KQ058184v1","1505565","1505858","57","3297737"
"JH378184","5102914","5103179","KQ055735v1","667472","667747","67","4435442"
"JH378184","5193232","5193519","KQ058275v1","201680","201968","70","4991552"
"JH378184","5232702","5232846","KQ053631v1","8603317","8603457","35","3370615"
"JH378184","5310780","5311057","KQ054069v1","955693","955974","64","4355087"
"JH378184","5342790","5343092","KQ054921v1","2378911","2379222","74","2963879"
"JH378184","5427420","5427638","KQ054081v1","1002095","1002297","58","4425325"
"JH378184","5480992","5481303","KQ054510v1","2681434","2681749","68","2799558"
"JH378184","5520754","5520814","KQ055755v1","1329385","1329455","29","4191369"
"JH378184","5619043","5619347","KQ054191v1","3583730","3584032","67","2035313"
"JH378184","5652519","5652733","KQ058242v1","892038","892246","47","4760481"
"JH378184","5683790","5684007","KQ058438v1","228244","228462","51","5455546"
"JH378184","5913543","5913771","KQ055872v1","6738410","6738636","54","824867"
"JH378184","5913845","5913907","KQ054068v1","1383975","1384041","20","4529870"
"JH378184","5967080","5967319","KQ054124v1","351437","351635","89","5615643"
"JH378184","6053984","6054138","KQ054401v1","3742804","3742954","31","2311180"
"JH378184","6193209","6193366","KQ053157v1","5478543","5478695","38","714666"
"JH378184","6193983","6194114","KQ055192v1","1759958","1760089","22","4434025"
"JH378184","6208931","6209108","KQ054932v1","4131919","4132090","67","2077012"
"JH378184","6274463","6274717","KQ054124v1","2751753","2752002","66","3522710"
"JH378184","6292838","6292969","KQ056404v1","1195188","1195317","21","5097650"
"JH378184","6330849","6331144","KQ054412v1","2490468","2490761","67","3840381"
"JH378184","6369396","6369544","KQ054400v1","3608755","3608918","42","2760641"
"JH378184","6416681","6416965","KQ056147v1","1747366","1747648","71","4669315"
"JH378184","6432106","6432260","KQ058190v1","494840","494990","37","5937266"
"JH378184","6432552","6432863","KQ054179v1","5850900","5851209","70","581652"
"JH378184","6500972","6501250","KQ053288v1","2218996","2219287","58","4281976"
"JH378184","6559908","6560225","KQ055457v1","2061137","2061448","80","4498771"
"JH378184","6841669","6841973","KQ058324v1","623645","623935","72","6218024"
"JH378184","6949843","6950141","KQ056331v1","1501968","1502262","69","5447875"
"JH378184","7040018","7040228","KQ053741v1","1190544","1190756","46","5849474"
"JH378184","7120541","7120837","KQ055247v1","3219331","3219626","67","3901210"
"JH378184","7140297","7140594","KQ055468v1","2950644","2950940","70","4189653"
"JH378184","7153728","7153901","KQ052982v1","1613820","1613991","49","5539908"
"JH378184","7355150","7355384","KQ053763v1","974463","974700","58","6380687"
"JH378184","7394935","7395027","KQ053096v1","344734","344824","20","7050201"
"JH378184","7617887","7618163","KQ052968v1","13260777","13261056","59","5642890"
"JH378184","7932778","7933079","KQ054693v1","1429670","1429955","67","6503108"
"JH378184","7987342","7987645","KQ052970v1","9813689","9813997","62","1826347"
"JH378184","8242770","8243023","KQ054533v1","1630479","1630731","73","6612291"
"JH378184","8290913","8291236","KQ056108v1","1110776","1111092","77","7180137"
"JH378184","8354930","8355251","KQ054466v1","2183618","2183917","76","6171312"
"JH378184","8619246","8619527","KQ053816v1","5837219","5837503","72","2782027"
"JH378184","8717499","8717718","KQ054565v1","5770490","5770715","56","2947009"
"JH378184","8739446","8739600","KQ054168v1","1100368","1100517","31","7639078"
"JH378184","8791028","8791332","KQ053838v1","3013088","3013374","64","5777940"
"JH378184","8854459","8854805","KQ058583v1","3101722","3102049","69","5752737"
"JH378184","8919417","8919521","KQ053256v1","5132292","5132396","26","3787125"
"JH378184","9009648","9009942","KQ058427v1","705606","705898","70","8304042"
"JH378184","9051694","9051978","KQ056440v1","233464","233746","75","8818230"
"JH378184","9054466","9054545","KQ058360v1","449292","449368","28","8605174"
"JH378184","9054948","9055130","KQ052969v1","4175976","4176146","50","4878972"
"JH378184","9103351","9103626","KQ053410v1","363999","364271","60","8739352"
"JH378184","9165661","9165958","KQ054786v1","1481220","1481519","59","7684441"
"JH378184","9245578","9245891","KQ054671v1","1130836","1131142","73","8114742"
"JH378184","9304173","9304309","KQ056475v1","2305251","2305383","27","6998922"
"JH378184","9432230","9432342","KQ055903v1","115400","115506","27","9316830"
"JH378184","9526876","9527041","KQ053299v1","22069326","22069490","41","12542450"
"JH378184","9698003","9698074","KQ055375v1","747749","747826","24","8950254"
"JH378185","5114","5399","KQ054652v1","4505","4775","88","609"
"JH378185","25289","25557","KQ054289v1","4355551","4355817","81","4330262"
"JH378185","26630","26921","KQ053191v1","2134125","2134399","90","2107495"
"JH378185","320506","320610","KQ053115v1","618454","618553","28","297948"
"JH378185","416306","416604","KQ054213v1","780092","780393","72","363786"
"JH378185","463109","463408","KQ054786v1","934497","934799","72","471388"
"JH378185","516134","516284","KQ053288v1","28257","28404","31","487877"
"JH378185","579279","579569","KQ055140v1","3362733","3363019","61","2783454"
"JH378185","606211","606406","KQ053354v1","1104956","1105153","53","498745"
"JH378185","616584","616880","KQ056672v1","3535300","3535593","73","2918716"
"JH378185","847744","848042","KQ058328v1","6293951","6294242","61","5446207"
"JH378185","855230","855292","KQ058505v1","1518039","1518097","22","662809"
"JH378185","855353","855589","KQ057380v1","2047063","2047290","59","1191710"
"JH378185","1049510","1049643","KQ053299v1","7611093","7611226","27","6561583"
"JH378185","1168448","1168744","KQ056827v1","989698","989981","65","178750"
"JH378185","1249899","1250023","KQ056643v1","1279625","1279744","25","29726"
"JH378185","1305549","1305674","KQ053409v1","6573923","6574054","23","5268374"
"JH378185","1484296","1484586","KQ058184v1","1505565","1505858","59","21269"
"JH378185","1669577","1669841","KQ054124v1","2442155","2442433","65","772578"
"JH378185","1752719","1752849","KQ053409v1","6573923","6574054","27","4821204"
"JH378185","1753840","1753979","KQ052970v1","12418764","12418905","37","10664924"
"JH378185","1841606","1841865","KQ055735v1","667472","667747","67","1174134"
"JH378185","1865866","1866020","KQ058329v1","497711","497869","41","1368155"
"JH378185","2026673","2026795","KQ055352v1","7176654","7176763","35","5149981"
"JH378185","2047879","2048179","KQ053927v1","199693","199992","62","1848186"
"JH378185","2216166","2216296","KQ057901v1","1218014","1218146","27","998152"
"JH378185","2310306","2310532","KQ053135v1","2336123","2336324","75","25817"
"JH378185","2349601","2349883","KQ052969v1","9047118","9047410","69","6697517"
"JH378185","2354442","2354724","KQ058561v1","4466656","4466945","69","2112214"
"JH378185","2392137","2392419","KQ053093v1","1361295","1361576","58","1030842"
"JH378185","2419983","2420297","KQ053741v1","1270673","1270967","82","1149310"
"JH378185","2585515","2585815","KQ054786v1","1481220","1481519","81","1104295"
"JH378185","2639667","2639975","KQ053398v1","2816605","2816914","69","176938"
"JH378185","3358790","3359082","KQ053948v1","168940","169229","65","3189850"
"JH378185","3391054","3391328","KQ053146v1","2819587","2819868","66","571467"
"JH378185","3635898","3636053","KQ053740v1","1071467","1071623","47","2564431"
"JH378185","4366594","4366862","KQ052970v1","7374072","7374342","79","3007478"
"JH378185","5618545","5618858","KQ055375v1","3021064","3021372","77","2597481"
"JH378185","5628465","5628755","KQ053212v1","1560173","1560471","69","4068292"
"JH378185","5722229","5722455","KQ056234v1","4592339","4592554","63","1129890"
"JH378185","5780607","5780824","KQ053982v1","2652830","2653054","61","3127777"
"JH378185","5856939","5857234","KQ053409v1","4082357","4082648","75","1774582"
"JH378185","5973525","5973787","KQ057345v1","1938824","1939073","63","4034701"
"JH378185","5987080","5987224","KQ055589v1","815","963","41","5986265"
"JH378185","6015823","6016105","KQ058516v1","1789801","1790088","69","4226022"
"JH378185","6050333","6050599","KQ056200v1","648300","648566","70","5402033"
"JH378185","6363508","6363665","KQ053157v1","5478543","5478695","36","884965"
"JH378185","6381248","6381411","KQ057023v1","876183","876346","43","5505065"
"JH378185","6569397","6569479","KQ057821v1","1407299","1407387","30","5162098"
"JH378185","7579788","7579950","KQ054179v1","1173116","1173284","41","6406672"
"JH378185","7663371","7663679","KQ058328v1","4260134","4260435","70","3403237"
"JH378185","7671162","7671359","KQ054826v1","9981760","9981967","52","2310598"
"JH378185","7684118","7684354","KQ058572v1","5214095","5214349","71","2470023"
"JH378185","7685271","7685558","KQ056440v1","1069847","1070137","78","6615424"
"JH378185","7825051","7825186","KQ055498v1","86970","87098","32","7738081"
"JH378185","8019901","8020110","KQ054826v1","9981760","9981967","65","1961859"
"JH378185","8085563","8085859","KQ057693v1","117172","117472","72","7968391"
"JH378185","9071769","9072080","KQ054786v1","1481220","1481519","82","7590549"
"JH378185","9334248","9334564","KQ053115v1","3485337","3485650","70","5848911"
"JH378185","9343004","9343136","KQ054213v1","615112","615244","22","8727892"
"JH378185","9372761","9372901","KQ053288v1","2708276","2708422","38","6664485"
"JH378185","9372902","9372956","KQ054943v1","3387644","3387704","22","5985258"
"JH378185","9615215","9615502","KQ053741v1","1613413","1613703","69","8001802"
"JH378185","9842134","9842423","KQ055352v1","7784426","7784721","72","2057708"
"JH378185","9875233","9875540","KQ056928v1","1915686","1915996","68","7959547"
"JH378186","134897","135177","KQ055065v1","1117201","1117481","67","982304"
"JH378186","671066","671362","KQ055352v1","4317660","4317958","68","3646594"
"JH378186","795722","796007","KQ054510v1","8555095","8555387","67","7759373"
"JH378186","942083","942348","KQ052969v1","7351818","7352090","72","6409735"
"JH378186","1110990","1111106","KQ058328v1","2150165","2150287","34","1039175"
"JH378186","1148476","1148580","KQ052982v1","1023528","1023630","33","124948"
"JH378186","1175010","1175074","KQ053556v1","5700","5760","19","1169310"
"JH378186","1425839","1426128","KQ053299v1","2118230","2118517","71","692391"
"JH378186","1469820","1469983","KQ054004v1","434795","434955","41","1035025"
"JH378186","1592355","1592632","KQ053299v1","3284099","3284383","62","1691744"
"JH378186","1673652","1673790","KQ054179v1","3865170","3865294","29","2191518"
"JH378186","1674115","1674427","KQ058359v1","574163","574471","59","1099952"
"JH378186","1760613","1760900","KQ053816v1","7474325","7474608","85","5713712"
"JH378186","1889636","1889802","KQ053827v1","4961567","4961731","43","3071931"
"JH378186","1926232","1926369","KQ054765v1","1100397","1100531","31","825835"
"JH378186","2066096","2066373","KQ054933v1","1016159","1016426","61","1049937"
"JH378186","2480471","2480754","KQ056331v1","1501968","1502262","72","978503"
"JH378186","2940190","2940455","KQ056148v1","3012765","3013044","77","72575"
"JH378186","3727423","3727714","KQ056672v1","3535300","3535593","68","192123"
"JH378186","4303305","4303552","KQ056965v1","1346676","1346924","62","2956629"
"JH378186","4455481","4455772","KQ054693v1","832788","833076","53","3622693"
"JH378186","4528768","4529031","KQ053894v1","688559","688830","69","3840209"
"JH378186","4537748","4537996","KQ054713v1","840037","840292","72","3697711"
"JH378186","4569168","4569296","KQ058280v1","21417","21542","28","4547751"
"JH378186","4801987","4802273","KQ055610v1","1837519","1837800","73","2964468"
"JH378186","4805137","4805431","KQ058183v1","594864","595153","85","4210273"
"JH378186","4807874","4808162","KQ053476v1","3998036","3998311","77","809838"
"JH378186","5295031","5295324","KQ056762v1","532889","533183","72","4762142"
"JH378186","5337392","5337621","KQ052968v1","7572312","7572523","69","2234920"
"JH378186","5427332","5427640","KQ056568v1","1617795","1618102","71","3809537"
"JH378186","5458385","5458533","KQ055183v1","2514156","2514302","37","2944229"
"JH378186","5476514","5476656","KQ055662v1","1094666","1094812","41","4381848"
"JH378186","5676774","5677090","KQ055767v1","2455394","2455703","84","3221380"
"JH378186","5742732","5743019","KQ058317v1","5506620","5506904","84","236112"
"JH378186","5756972","5757270","KQ053299v1","4095914","4096215","82","1661058"
"JH378186","6183023","6183300","KQ054124v1","2442155","2442433","67","3740868"
"JH378186","6275668","6275952","KQ053026v1","3680523","3680807","84","2595145"
"JH378186","6278673","6278762","KQ058427v1","6152893","6152991","36","125780"
"JH378186","6278934","6279077","KQ053310v1","2640191","2640334","45","3638743"
"JH378186","6286787","6286917","KQ057649v1","141749","141881","33","6145038"
"JH378186","6584081","6584388","KQ054682v1","2237365","2237671","66","4346716"
"JH378186","7017787","7018067","KQ055717v1","2074416","2074712","76","4943371"
"JH378186","7149354","7149665","KQ054704v1","223675","223980","79","6925679"
"JH378186","7588347","7588505","KQ054994v1","1493970","1494127","42","6094377"
"JH378186","7624216","7624486","KQ053146v1","2848155","2848435","64","4776061"
"JH378186","7663170","7663444","KQ054868v1","2229582","2229854","59","5433588"
"JH378186","8454423","8454718","KQ053190v1","1690950","1691254","65","6763473"
"JH378186","8638616","8638748","KQ053202v1","780148","780280","25","7858468"
"JH378186","8713516","8713803","KQ055140v1","3423560","3423842","76","5289956"
"JH378186","8772842","8773111","KQ055192v1","1201363","1201615","66","7571479"
"JH378186","8786476","8786759","KQ053299v1","21869448","21869738","68","13082972"
"JH378186","8860325","8860622","KQ053432v1","3634372","3634675","68","5225953"
"JH378186","8867645","8867802","KQ056996v1","1524030","1524195","37","7343615"
"JH378186","8880842","8880969","KQ056855v1","2808237","2808368","34","6072605"
"JH378186","8922026","8922348","KQ054932v1","3714594","3714900","75","5207432"
"JH378186","8932089","8932194","KQ058050v1","918290","918400","23","8013799"
"JH378186","8981813","8982065","KQ053037v1","3640291","3640559","63","5341522"
"JH378186","9206755","9207042","KQ053409v1","3716306","3716585","66","5490449"
"JH378186","9418371","9418683","KQ053554v1","2471177","2471484","72","6947194"
"JH378187","253041","253160","KQ057345v1","1273173","1273291","30","1020132"
"JH378187","890077","890418","KQ055893v1","2313607","2313921","108","1423530"
"JH378187","1246014","1246322","KQ053070v1","660433","660737","80","585581"
"JH378187","2048332","2048627","KQ053146v1","2819587","2819868","82","771255"
"JH378187","2821134","2821438","KQ056234v1","2521120","2521411","73","300014"
"JH378187","2942144","2942315","KQ057336v1","635116","635282","42","2307028"
"JH378187","2996244","2996507","KQ053686v1","963025","963293","58","2033219"
"JH378187","3106840","3107130","KQ053299v1","4095914","4096215","66","989074"
"JH378187","3265890","3266022","KQ058427v1","4756553","4756686","23","1490663"
"JH378187","3309115","3309395","KQ058290v1","867857","868151","79","2441258"
"JH378187","3315063","3315353","KQ057693v1","621833","622123","66","2693230"
"JH378187","3426364","3426697","KQ055777v1","2071501","2071828","86","1354863"
"JH378187","3428222","3428463","KQ057764v1","1446444","1446674","74","1981778"
"JH378187","3522519","3522822","KQ054725v1","2218271","2218569","80","1304248"
"JH378187","3561987","3562111","KQ053004v1","2961452","2961584","27","600535"
"JH378187","3654397","3654687","KQ058561v1","583947","584226","70","3070450"
"JH378187","4027685","4027853","KQ057036v1","1270725","1270889","41","2756960"
"JH378187","4151412","4151691","KQ054693v1","832788","833076","59","3318624"
"JH378187","4316689","4316760","KQ053883v1","3315834","3315907","16","1000855"
"JH378187","4583298","4583491","KQ053294v1","648","849","50","4582650"
"JH378187","4902193","4902439","KQ058503v1","123813","124064","74","4778380"
"JH378187","4925344","4925641","KQ053554v1","1157184","1157483","71","3768160"
"JH378187","5168654","5168952","KQ057449v1","2137704","2138005","74","3030950"
"JH378187","5812785","5813080","KQ053387v1","4074527","4074832","64","1738258"
"JH378187","5926087","5926225","KQ054068v1","2661732","2661876","39","3264355"
"JH378187","6706582","6706891","KQ054704v1","223675","223980","69","6482907"
"JH378187","7034204","7034295","KQ057821v1","1407299","1407387","27","5626905"
"JH378187","7060096","7060340","KQ055108v1","1614024","1614276","68","5446072"
"JH378187","7076465","7076749","KQ058316v1","3289111","3289379","72","3787354"
"JH378187","7089730","7090020","KQ053631v1","8322466","8322756","74","1232736"
"JH378187","7111440","7111740","KQ053476v1","1823610","1823912","74","5287830"
"JH378187","7299788","7300054","KQ055248v1","2598609","2598880","73","4701179"
"JH378187","7369917","7370212","KQ056331v1","1886723","1887024","73","5483194"
"JH378187","7712087","7712372","ABDC02001013v1","5347","5624","66","7706740"
"JH378187","7873812","7874082","KQ053278v1","215181","215451","83","7658631"
"JH378187","7918702","7918991","KQ055248v1","947170","947461","63","6971532"
"JH378187","7986437","7986714","KQ055745v1","1992718","1992978","73","5993719"
"JH378187","8171179","8171459","KQ053465v1","1719599","1719873","68","6451580"
"JH378187","8516934","8517077","KQ053115v1","1650505","1650644","28","6866429"
"JH378187","8866283","8866548","KQ058275v1","938649","938919","68","7927634"
"JH378187","8978601","8978887","KQ053070v1","1482644","1482942","71","7495957"
"JH378187","8985093","8985342","KQ058316v1","6274690","6274954","76","2710403"
"JH378187","9264099","9264396","KQ058389v1","2329886","2330179","71","6934213"
"JH378188","39778","39905","KQ055141v1","3481451","3481584","28","3441673"
"JH378188","85123","85310","KQ052968v1","1711014","1711208","51","1625891"
"JH378188","143279","143526","KQ054135v1","1541023","1541259","74","1397744"
"JH378188","202576","202819","KQ058328v1","5551458","5551700","65","5348882"
"JH378188","476120","476362","KQ055518v1","1576074","1576315","61","1099954"
"JH378188","863368","863642","KQ054069v1","3733362","3733643","70","2869994"
"JH378188","891224","891509","KQ053332v1","127947","128230","66","763277"
"JH378188","1837732","1837981","KQ052970v1","7191829","7192066","69","5354097"
"JH378188","1865444","1865609","KQ056996v1","1524030","1524195","35","341414"
"JH378188","1866991","1867214","KQ054168v1","859896","860125","67","1007095"
"JH378188","2367629","2367910","KQ058184v1","1108809","1109092","72","1258820"
"JH378188","2467090","2467380","KQ056672v1","6393431","6393732","74","3926341"
"JH378188","2994302","2994620","KQ053696v1","5523721","5524018","84","2529419"
"JH378188","3420982","3421268","KQ055352v1","6786092","6786384","74","3365110"
"JH378188","3649313","3649614","KQ057440v1","799774","800040","92","2849539"
"JH378188","3762957","3763224","KQ053332v1","2579491","2579756","83","1183466"
"JH378188","4033500","4033822","KQ054289v1","1432888","1433224","94","2600612"
"JH378188","4453940","4454029","KQ054323v1","1913767","1913855","21","2540173"
"JH378188","4834986","4835288","KQ055987v1","858506","858800","73","3976480"
"JH378188","4967318","4967594","KQ053718v1","1496748","1497022","63","3470570"
"JH378188","5123949","5124245","KQ053421v1","2664387","2664683","84","2459562"
"JH378188","5184348","5184621","KQ055173v1","452351","452623","74","4731997"
"JH378188","5226653","5226930","KQ055610v1","1837519","1837800","64","3389134"
"JH378188","5341556","5341854","KQ058585v1","580456","580763","76","4761100"
"JH378188","5559190","5559343","KQ055119v1","3199848","3199995","40","2359342"
"JH378188","5962546","5962702","KQ055735v1","2321269","2321424","35","3641277"
"JH378188","6619948","6620066","KQ056064v1","5108638","5108754","20","1511310"
"JH378188","6635209","6635359","KQ056864v1","2852271","2852420","35","3782938"
"JH378188","6950070","6950204","KQ053774v1","406836","406969","29","6543234"
"JH378188","6950786","6950952","KQ055119v1","3199848","3199995","46","3750938"
"JH378188","7023210","7023460","KQ053354v1","588576","588825","65","6434634"
"JH378188","7113200","7113431","KQ054124v1","4660657","4660862","83","2452543"
"JH378188","7153009","7153190","KQ053740v1","1980068","1980251","56","5172941"
"JH378188","7327389","7327683","KQ058561v1","4466656","4466945","63","2860733"
"JH378188","7438137","7438415","KQ053631v1","9398334","9398603","65","1960197"
"JH378188","7545838","7546074","KQ058627v1","3266538","3266783","75","4279300"
"JH378188","7597414","7597620","KQ055717v1","640981","641187","60","6956433"
"JH378188","7729761","7729955","KQ055978v1","4931093","4931294","52","2798668"
"JH378188","7764108","7764350","KQ058328v1","3279510","3279770","64","4484598"
"JH378188","7775214","7775424","KQ058505v1","2234909","2235124","45","5540305"
"JH378188","7829165","7829294","KQ056234v1","886803","886922","28","6942362"
"JH378188","7829662","7829843","KQ057232v1","476727","476913","58","7352935"
"JH378188","7855933","7856226","KQ056044v1","2538771","2539068","66","5317162"
"JH378188","7867778","7868088","KQ058317v1","5506620","5506904","90","2361158"
"JH378188","7904170","7904453","KQ056147v1","1064032","1064323","70","6840138"
"JH378188","8063664","8063826","KQ058613v1","368815","368973","44","7694849"
"JH378188","8164645","8164930","KQ054068v1","1099741","1100039","66","7064904"
"JH378188","8195965","8196260","KQ053299v1","22532300","22532596","66","14336335"
"JH378188","8276581","8276678","KQ053157v1","8174152","8174260","28","102429"
"JH378188","8294909","8295029","KQ053026v1","2376723","2376841","34","5918186"
"JH378188","8298337","8298584","KQ056268v1","840558","840818","79","7457779"
"JH378188","8309195","8309327","KQ057649v1","141749","141881","22","8167446"
"JH378188","8355576","8355847","KQ054868v1","2229582","2229854","67","6125994"
"JH378188","8363597","8363798","KQ058595v1","117016","117224","48","8246581"
"JH378188","8381387","8381544","KQ055404v1","4095582","4095739","36","4285805"
"JH378188","8385574","8385834","KQ056404v1","1771928","1772196","76","6613646"
"JH378188","8499031","8499335","KQ057737v1","5499585","5499900","75","2999446"
"JH378188","8595326","8595622","KQ053816v1","7464708","7465010","59","1130618"
"JH378188","8620896","8621036","KQ053631v1","8603317","8603457","24","17579"
"JH378188","8752578","8752847","KQ057909v1","2835931","2836214","66","5916647"
"JH378188","8771648","8771782","KQ057380v1","1927712","1927837","41","6843936"
"JH378188","8856764","8856936","KQ057023v1","552794","552951","38","8303970"
"JH378188","8872983","8873141","KQ056268v1","862150","862302","49","8010833"
"JH378188","8917353","8917656","KQ054068v1","1099741","1100039","66","7817612"
"JH378188","8997817","8998037","KQ058004v1","2720169","2720394","61","6277648"
"JH378188","9027162","9027308","KQ054068v1","3810713","3810858","29","5216449"
"JH378188","9052495","9052764","KQ053070v1","1145700","1145952","76","7906795"
"JH378188","9085540","9085589","KQ058065v1","399231","399281","11","8686309"
"JH378188","9093335","9093474","KQ054868v1","44095","44235","35","9049240"
"JH378188","9093489","9093569","KQ053082v1","2466226","2466310","18","6627263"
"JH378188","9153169","9153305","KQ054510v1","2941967","2942098","29","6211202"
"JH378188","9483388","9483677","KQ056147v1","2698308","2698592","68","6785080"
"JH378188","9503674","9503754","KQ054994v1","3559925","3560015","30","5943749"
"JH378188","9503890","9503973","KQ055946v1","371653","371727","24","9132237"
"JH378188","9628039","9628171","KQ054943v1","3338657","3338793","34","6289382"
"JH378188","9688190","9688290","KQ053763v1","508269","508363","26","9179921"
"JH378189","8519655","8519966","KQ054804v1","52712","53011","82","8466943"
"JH378189","8996","9280","KQ058450v1","2681494","2681788","70","2672498"
"JH378189","102971","103259","KQ053093v1","3162517","3162806","59","3059546"
"JH378189","246199","246449","KQ053894v1","1236287","1236536","74","990088"
"JH378189","436064","436180","KQ053409v1","6105325","6105446","29","5669261"
"JH378189","467802","468077","KQ058316v1","753926","754202","60","286124"
"JH378189","757563","757861","KQ055141v1","2573822","2574123","60","1816259"
"JH378189","786804","787027","KQ055320v1","2365107","2365346","64","1578303"
"JH378189","795420","795630","KQ056996v1","148346","148555","47","647074"
"JH378189","817835","817999","KQ056996v1","1524030","1524195","33","706195"
"JH378189","863938","864240","KQ053816v1","7464708","7465010","63","6600770"
"JH378189","864795","864873","KQ053520v1","3803739","3803813","24","2938944"
"JH378189","1073922","1074225","KQ054345v1","1580511","1580819","70","506589"
"JH378189","1165378","1165450","KQ056855v1","3190666","3190732","21","2025288"
"JH378189","1262915","1263208","KQ054879v1","1971571","1971875","58","708656"
"JH378189","1339051","1339366","KQ055872v1","14673747","14674061","73","13334696"
"JH378189","1357331","1357613","KQ053093v1","1361295","1361576","59","3964"
"JH378189","1362772","1363088","KQ052968v1","12144948","12145253","71","10782176"
"JH378189","1549915","1550202","KQ057755v1","45985","46262","63","1503930"
"JH378189","1603847","1604103","KQ052968v1","10745715","10745973","58","9141868"
"JH378189","1788242","1788327","ABDC02049544v1","576","661","18","1787666"
"JH378189","2380505","2380786","KQ057931v1","399684","399967","66","1980821"
"JH378189","2488107","2488413","KQ058585v1","580456","580763","64","1907651"
"JH378189","3351711","3352000","KQ054868v1","1584588","1584882","73","1767123"
"JH378189","3645655","3645931","KQ053026v1","3680523","3680807","83","34868"
"JH378189","3782601","3782888","KQ058350v1","6740286","6740580","63","2957685"
"JH378189","3974220","3974547","KQ055862v1","2038392","2038709","80","1935828"
"JH378189","3978285","3978401","KQ058004v1","2254984","2255111","24","1723301"
"JH378189","4003912","4004156","KQ055364v1","1919520","1919774","58","2084392"
"JH378189","4102718","4103019","KQ058184v1","1505565","1505858","64","2597153"
"JH378189","4180606","4180809","KQ052968v1","1711014","1711208","53","2469592"
"JH378189","4223787","4224091","KQ054879v1","1971571","1971875","65","2252216"
"JH378189","4301186","4301464","KQ053432v1","5326013","5326296","61","1024827"
"JH378189","4382327","4382383","KQ056558v1","910670","910721","14","3471657"
"JH378189","4382384","4382462","KQ055479v1","2280775","2280852","25","2101609"
"JH378189","4969071","4969364","KQ053004v1","2107939","2108219","82","2861132"
"JH378189","5466433","5466682","KQ055236v1","1830193","1830449","65","3636240"
"JH378189","5475620","5475926","KQ057858v1","376905","377209","67","5098715"
"JH378189","5480659","5480942","KQ055140v1","2748912","2749194","66","2731747"
"JH378189","5544071","5544288","KQ053948v1","2776497","2776701","61","2767574"
"JH378189","5882828","5882950","KQ056234v1","886803","886922","25","4996025"
"JH378189","5974069","5974378","KQ056672v1","4616100","4616414","80","1357969"
"JH378189","6662452","6662730","KQ055247v1","216427","216708","69","6446025"
"JH378189","6920207","6920515","KQ057471v1","479322","479624","73","6440885"
"JH378189","6963254","6963436","KQ056672v1","5452932","5453100","35","1510322"
"JH378189","6967068","6967199","KQ054279v1","76889","77022","20","6890179"
"JH378189","7279467","7279759","KQ058316v1","1439391","1439671","68","5840076"
"JH378189","7463198","7463478","KQ055035v1","4381466","4381744","68","3081732"
"JH378189","7483016","7483301","KQ052968v1","5194409","5194696","75","2288607"
"JH378189","7483302","7483436","KQ057832v1","358798","358927","29","7124504"
"JH378189","7493986","7494254","KQ055173v1","452351","452623","69","7041635"
"JH378189","7595621","7595915","KQ053816v1","7464708","7465010","55","130913"
"JH378189","7747410","7747508","KQ054510v1","2127300","2127398","31","5620110"
"JH378189","7747595","7747747","KQ054196v1","237","387","33","7747358"
"JH378189","7877465","7877762","KQ053960v1","70067","70362","73","7807398"
"JH378189","7923622","7923886","KQ058516v1","945634","945904","71","6977988"
"JH378189","8025080","8025244","KQ056996v1","1524030","1524195","35","6501050"
"JH378189","8025580","8025732","KQ052968v1","3013386","3013535","30","5012194"
"JH378189","8033240","8033404","KQ056996v1","1524030","1524195","35","6509210"
"JH378189","8033740","8033892","KQ052968v1","3013386","3013535","30","5020354"
"JH378189","8177108","8177382","KQ053398v1","1830305","1830577","65","6346803"
"JH378189","8184994","8185121","KQ054682v1","1410308","1410435","27","6774686"
"JH378189","8199326","8199625","KQ058184v1","1505565","1505858","61","6693761"
"JH378189","8303136","8303250","KQ058350v1","1062787","1062904","25","7240349"
"JH378189","8303821","8303984","KQ057213v1","476570","476722","60","7827251"
"JH378189","8319654","8319822","KQ058328v1","3794482","3794646","42","4525172"
"JH378189","8345632","8345780","KQ053179v1","1207231","1207365","37","7138401"
"JH378189","8456812","8457184","KQ054510v1","7367073","7367385","119","1089739"
"JH378189","8729881","8730192","KQ054510v1","6887667","6887971","70","1842214"
"JH378189","8818522","8818819","KQ055236v1","2049624","2049930","72","6768898"
"JH378189","8908781","8909074","KQ053297v1","44026","44315","72","8864755"
"JH378189","8965659","8965934","KQ056996v1","837133","837431","63","8128526"
"JH378189","9025158","9025341","KQ053554v1","293392","293586","54","8731766"
"JH378189","9129535","9129797","KQ053223v1","590063","590338","69","8539472"
"JH378189","9171495","9171787","KQ057693v1","621833","622123","59","8549662"
"JH378189","9398505","9398763","KQ054069v1","928440","928688","61","8470065"
"JH378189","9426979","9427260","KQ057205v1","1174433","1174713","70","8252546"
"JH378189","9554979","9555271","KQ058316v1","3861630","3861913","70","5693349"
"JH378190","6902","7010","KQ055141v1","2421865","2421977","27","2414963"
"JH378190","102980","103272","KQ057911v1","428931","429228","66","325951"
"JH378190","113590","113875","KQ054124v1","2442155","2442433","78","2328565"
"JH378190","192740","192907","KQ055735v1","2321269","2321424","43","2128529"
"JH378190","208947","209220","KQ053752v1","577130","577407","65","368183"
"JH378190","506635","506856","KQ053398v1","3158290","3158500","58","2651655"
"JH378190","580374","580576","KQ053520v1","4901250","4901462","55","4320876"
"JH378190","589394","589610","KQ056643v1","601903","602112","62","12509"
"JH378190","653659","653797","KQ054400v1","3437607","3437752","28","2783948"
"JH378190","657388","657671","KQ056773v1","168010","168288","67","489378"
"JH378190","760485","760762","KQ056790v1","446564","446855","71","313921"
"JH378190","851368","851678","KQ058427v1","2533789","2534086","74","1682421"
"JH378190","868475","868718","KQ055457v1","1008530","1008768","80","140055"
"JH378190","893699","894007","KQ055787v1","913986","914287","72","20287"
"JH378190","939482","939646","KQ057649v1","424252","424417","29","515230"
"JH378190","1123527","1123779","KQ055353v1","1875425","1875690","80","751898"
"JH378190","1173676","1173970","KQ055787v1","913986","914287","69","259690"
"JH378190","1202136","1202271","KQ054279v1","76889","77022","28","1125247"
"JH378190","1326168","1326464","KQ056587v1","9000240","9000528","60","7674072"
"JH378190","1358774","1359077","KQ058290v1","511568","511873","63","847206"
"JH378190","1403147","1403436","KQ058305v1","2302392","2302684","63","899245"
"JH378190","1670142","1670460","KQ053654v1","5318679","5318982","65","3648537"
"JH378190","1718222","1718506","KQ053816v1","7438202","7438483","66","5719980"
"JH378190","1783791","1784084","KQ058183v1","3676455","3676744","71","1892664"
"JH378190","1854264","1854441","KQ055978v1","4257847","4258036","58","2403583"
"JH378190","1923565","1923831","KQ053059v1","2135970","2136233","64","212405"
"JH378190","1961313","1961626","KQ058184v1","1505565","1505858","65","455748"
"JH378190","2016383","2016685","KQ054191v1","3857584","3857880","75","1841201"
"JH378190","2175316","2175625","KQ053752v1","841061","841364","71","1334255"
"JH378190","2195804","2196083","KQ053849v1","2666385","2666665","61","470581"
"JH378190","2226945","2227254","KQ052969v1","9116808","9117108","66","6889863"
"JH378190","2503391","2503697","KQ055610v1","2418373","2418677","72","85018"
"JH378190","3023718","3023868","KQ052970v1","12418764","12418905","40","9395046"
"JH378190","3152706","3153001","KQ055247v1","4445738","4446031","72","1293032"
"JH378190","4059981","4060133","KQ054168v1","1100368","1100517","31","2959613"
"JH378190","4306652","4306939","KQ054224v1","428324","428601","74","3878328"
"JH378190","4495740","4496015","KQ058539v1","481549","481810","72","4014191"
"JH378190","4647973","4648278","KQ054533v1","1836056","1836358","78","2811917"
"JH378190","4814340","4814630","KQ056475v1","2179070","2179363","76","2635270"
"JH378190","4843836","4844000","KQ053398v1","4129725","4129885","42","714111"
"JH378190","4903459","4903570","KQ058050v1","918290","918400","24","3985169"
"JH378190","4985581","4985867","KQ053331v1","97381","97652","91","4888200"
"JH378190","5006487","5006728","KQ053267v1","3723852","3724102","71","1282635"
"JH378190","5179827","5180125","KQ058184v1","1505565","1505858","63","3674262"
"JH378190","5200345","5200457","KQ054921v1","165725","165837","30","5034620"
"JH378190","5233486","5233737","KQ056423v1","449946","450194","75","4783540"
"JH378190","5291686","5291893","KQ057711v1","824759","824972","57","4466927"
"JH378190","5574414","5574546","KQ055394v1","2518506","2518638","32","3055908"
"JH378190","5587030","5587143","KQ056064v1","5128113","5128227","29","458917"
"JH378190","5665969","5666159","KQ056493v1","4620664","4620862","55","1045305"
"JH378190","5682807","5683084","KQ057213v1","1074642","1074915","56","4608165"
"JH378190","5687359","5687628","KQ056620v1","480136","480413","75","5207223"
"JH378190","5714097","5714342","KQ053093v1","1944813","1945054","64","3769284"
"JH378190","5714979","5715282","KQ058004v1","2469012","2469310","63","3245967"
"JH378190","5741594","5741732","KQ058257v1","652425","652556","28","5089169"
"JH378190","6225819","6226117","KQ055872v1","7552789","7553093","66","1326970"
"JH378190","6329184","6329344","KQ053157v1","5478543","5478695","35","850641"
"JH378190","6572597","6572883","KQ052970v1","4083831","4084116","66","2488766"
"JH378190","6715319","6715432","KQ053354v1","1582358","1582469","27","5132961"
"JH378190","6716109","6716227","KQ054839v1","3130","3250","31","6712979"
"JH378190","6735871","6736063","KQ057431v1","1231216","1231387","55","5504655"
"JH378190","6842495","6842626","KQ056147v1","2896905","2897037","27","3945590"
"JH378190","6846705","6847014","KQ056475v1","5519037","5519344","67","1327668"
"JH378190","6860454","6860488","KQ057082v1","642960","642996","9","6217494"
"JH378190","6860490","6860550","KQ053872v1","295693","295746","19","6564797"
"JH378190","6864137","6864399","KQ053190v1","3029554","3029812","73","3834583"
"JH378190","6945830","6946151","KQ057099v1","648781","649090","80","6297049"
"JH378190","6984676","6984984","KQ055755v1","446339","446640","69","6538337"
"JH378190","7124822","7125110","KQ057118v1","4601602","4601894","69","2523220"
"JH378190","7292708","7293008","KQ053115v1","1118362","1118655","89","6174346"
"JH378190","7322637","7322852","KQ054081v1","1002095","1002297","68","6320542"
"JH378190","7355650","7355933","KQ058094v1","7832529","7832815","66","476879"
"JH378190","7425636","7425729","KQ054576v1","802587","802678","11","6623049"
"JH378190","7497884","7498172","KQ058283v1","3525175","3525450","64","3972709"
"JH378190","7499447","7499648","KQ053948v1","2776497","2776701","49","4722950"
"JH378190","7511232","7511357","KQ054533v1","748660","748796","34","6762572"
"JH378190","7550126","7550416","KQ053498v1","3696034","3696323","68","3854092"
"JH378190","7568089","7568377","KQ056790v1","446564","446855","55","7121525"
"JH378190","7593535","7593663","KQ053256v1","1284266","1284394","29","6309269"
"JH378190","7838243","7838350","KQ053916v1","191904","192015","28","7646339"
"JH378190","7838706","7838866","KQ052968v1","10427732","10427888","32","2589026"
"JH378190","8142317","8142592","KQ052971v1","646100","646383","70","7496217"
"JH378190","8223654","8223968","KQ058494v1","4784845","4785156","73","3438809"
"JH378190","8422757","8423011","KQ053631v1","9823225","9823499","70","1400468"
"JH378190","8572350","8572638","KQ053300v1","2874445","2874736","73","5697905"
"JH378190","8645151","8645313","KQ056996v1","1524030","1524195","36","7121121"
"JH378190","8671882","8672012","KQ057910v1","1548802","1548933","19","7123080"
"JH378190","8757670","8757756","KQ057764v1","1234295","1234375","22","7523375"
"JH378190","8764451","8764586","KQ053398v1","2023679","2023818","24","6740772"
"JH378190","8770537","8770842","KQ053554v1","2471177","2471484","69","6299360"
"JH378190","8946184","8946354","KQ052970v1","4434435","4434604","42","4511749"
"JH378190","8981419","8981494","KQ057796v1","119005","119079","21","8862414"
"JH378190","8988655","8988810","KQ054466v1","1866785","1866925","38","7121870"
"JH378190","9016967","9017278","KQ053115v1","3485337","3485650","68","5531630"
"JH378190","9300479","9300581","KQ053850v1","279389","279490","19","9021090"
"JH378190","9401721","9401936","KQ054180v1","536720","536932","62","8865001"
"JH378190","9434779","9435120","KQ058561v1","4466656","4466945","105","4968123"
"JH378191","28809","29104","KQ058394v1","9107761","9108054","67","9078952"
"JH378191","64015","64310","KQ053631v1","9631170","9631468","64","9567155"
"JH378191","75615","75896","KQ053059v1","2387120","2387415","66","2311505"
"JH378191","145337","145618","KQ055342v1","1257141","1257428","72","1111804"
"JH378191","288043","288335","KQ055097v1","1884579","1884874","60","1596536"
"JH378191","522695","522977","KQ053631v1","9398334","9398603","69","8875639"
"JH378191","769657","769808","KQ058297v1","117665","117816","38","651992"
"JH378191","800099","800343","KQ054984v1","2879035","2879272","69","2078936"
"JH378191","827779","827996","KQ058516v1","2391279","2391485","62","1563500"
"JH378191","840143","840293","KQ053081v1","1901531","1901659","53","1061388"
"JH378191","902214","902367","KQ053026v1","1584528","1584674","38","682314"
"JH378191","2457974","2458248","KQ058383v1","5944247","5944518","71","3486273"
"JH378191","3216377","3216532","KQ053565v1","1922532","1922687","31","1293845"
"JH378191","3275438","3275715","KQ057755v1","45985","46262","66","3229453"
"JH378191","3286519","3286604","KQ058394v1","2776716","2776783","29","509803"
"JH378191","3363299","3363470","KQ055766v1","758184","758347","47","2605115"
"JH378191","3430212","3430453","KQ057268v1","1608514","1608738","58","1821698"
"JH378191","3465650","3465892","KQ058394v1","15350086","15350346","59","11884436"
"JH378191","3478723","3479011","KQ058316v1","2555894","2556176","70","922829"
"JH378191","3775031","3775112","KQ052968v1","9483686","9483763","22","5708655"
"JH378191","4066923","4067205","KQ058272v1","5519908","5520197","74","1452985"
"JH378191","4200635","4200910","KQ056200v1","648300","648566","73","3552335"
"JH378191","5536556","5536815","KQ055872v1","4131960","4132231","78","1404596"
"JH378191","5584044","5584198","KQ053135v1","3210852","3210985","40","2373192"
"JH378191","5695460","5695600","KQ055097v1","2621016","2621150","33","3074444"
"JH378191","5720403","5720618","KQ058505v1","2234909","2235124","50","3485494"
"JH378191","5735310","5735629","KQ058184v1","1505565","1505858","85","4229745"
"JH378191","5891701","5891831","KQ053354v1","702320","702452","24","5189381"
"JH378191","5893428","5893748","KQ053927v1","199693","199992","108","5693735"
"JH378191","6015817","6016113","KQ055479v1","493491","493789","61","5522326"
"JH378191","6134794","6134921","KQ054102v1","1708348","1708484","29","4426446"
"JH378191","6175492","6175806","KQ058539v1","1057985","1058283","83","5117507"
"JH378191","6381305","6381538","KQ055108v1","2927238","2927477","65","3454067"
"JH378191","6568569","6568729","KQ058350v1","579975","580134","35","5988594"
"JH378191","7143625","7143938","KQ057373v1","1224950","1225260","78","5918675"
"JH378191","7638445","7638654","KQ053398v1","3158290","3158500","48","4480155"
"JH378191","7822203","7822502","KQ055777v1","782451","782743","70","7039752"
"JH378191","8241610","8241801","KQ053498v1","5509223","5509395","62","2732387"
"JH378191","8861385","8861657","KQ053299v1","21375969","21376245","72","12514584"
"JH378191","8936323","8936608","KQ056945v1","942729","942997","88","7993594"
"JH378191","8948780","8948897","KQ054693v1","3852073","3852175","40","5096707"
"JH378191","9066198","9066479","KQ058183v1","487423","487710","67","8578775"
"JH378191","9073928","9074005","KQ053398v1","4200835","4200909","26","4873093"
"JH378191","9092484","9092632","KQ056147v1","2168964","2169108","29","6923520"
"JH378191","9240595","9240754","KQ053741v1","1690943","1691088","45","7549652"
"JH378192","171729","171984","KQ056044v1","570262","570509","73","398533"
"JH378192","449615","449784","KQ058050v1","695702","695863","39","246087"
"JH378192","469035","469284","KQ057299v1","2834261","2834512","71","2365226"
"JH378192","711959","712259","KQ053631v1","7288314","7288608","78","6576355"
"JH378192","1205669","1205954","KQ052969v1","9553757","9554052","65","8348088"
"JH378192","3648087","3648366","KQ052971v1","6441372","6441626","81","2793285"
"JH378192","5263496","5263739","KQ054510v1","8112428","8112664","61","2848932"
"JH378192","5331114","5331344","KQ055872v1","6738410","6738636","54","1407296"
"JH378192","5403074","5403378","KQ054879v1","1971571","1971875","63","3431503"
"JH378192","5407079","5407314","KQ054576v1","2775916","2776136","62","2631163"
"JH378192","5424004","5424139","KQ055457v1","5874928","5875062","21","450924"
"JH378192","5450471","5450670","KQ055065v1","1825987","1826193","56","3624484"
"JH378192","5519163","5519448","KQ054290v1","526840","527128","72","4992323"
"JH378192","5526990","5527128","KQ054466v1","1866785","1866925","26","3660205"
"JH378192","5627446","5627724","KQ055468v1","1908448","1908731","67","3718998"
"JH378192","5664143","5664449","KQ052970v1","8274642","8274940","68","2610499"
"JH378192","5692620","5692893","KQ053409v1","4812949","4813233","68","879671"
"JH378192","5741959","5742280","KQ053554v1","2471177","2471484","79","3270782"
"JH378192","5752373","5752506","KQ053543v1","1868215","1868343","21","3884158"
"JH378192","5785700","5785988","KQ053332v1","447571","447853","66","5338129"
"JH378192","5984794","5984936","KQ056147v1","2168964","2169108","25","3815830"
"JH378192","6704155","6704441","KQ052968v1","13481922","13482197","69","6777767"
"JH378192","7301109","7301407","KQ053631v1","7288314","7288608","68","12795"
"JH378192","7324318","7324641","KQ057702v1","1237368","1237672","86","6086950"
"JH378192","7780353","7780483","KQ055662v1","1063677","1063805","24","6716676"
"JH378192","7902594","7902897","KQ053059v1","2112049","2112344","75","5790545"
"JH378192","8009996","8010149","KQ058265v1","212584","212745","30","7797412"
"JH378192","8011256","8011339","KQ053060v1","4849","4931","15","8006407"
"JH378192","8256636","8256918","KQ053631v1","9823225","9823499","74","1566589"
"JH378192","8485599","8485845","KQ053070v1","1873279","1873542","74","6612320"
"JH378192","8665377","8665633","KQ057345v1","1938824","1939073","64","6726553"
"JH378193","5636001","5636276","ABDC02054223v1","3152","3442","69","5632849"
"JH378193","35693","35770","KQ053398v1","4200835","4200909","25","4165142"
"JH378193","53678","53989","KQ055457v1","2061137","2061448","75","2007459"
"JH378193","602547","602594","KQ054135v1","1661841","1661887","12","1059294"
"JH378193","602824","603054","KQ056762v1","1558119","1558341","64","955295"
"JH378193","653437","653657","KQ058272v1","2013158","2013380","66","1359721"
"JH378193","687897","688155","KQ058094v1","5430881","5431130","57","4742984"
"JH378193","838184","838466","KQ057909v1","519161","519431","62","319023"
"JH378193","848776","848818","KQ058394v1","7265515","7265555","12","6416739"
"JH378193","1054359","1054665","KQ058577v1","563667","563958","82","490692"
"JH378193","1098753","1098869","KQ053916v1","191904","192015","29","906849"
"JH378193","1098883","1098949","KQ058394v1","3244065","3244120","26","2145182"
"JH378193","1115768","1115897","KQ054890v1","666308","666433","48","449460"
"JH378193","1122328","1122519","KQ056320v1","2002842","2003039","41","880514"
"JH378193","1161691","1161819","KQ053774v1","406836","406969","22","754855"
"JH378193","1194776","1194874","KQ054456v1","5057079","5057175","25","3862303"
"JH378193","1208369","1208516","KQ058389v1","1559421","1559572","34","351052"
"JH378193","1245284","1245487","KQ053398v1","3158290","3158500","49","1913006"
"JH378193","1261443","1261762","KQ053795v1","1729459","1729773","81","468016"
"JH378193","1446829","1447126","KQ057449v1","2137704","2138005","63","690875"
"JH378193","1486044","1486349","KQ056148v1","430759","431072","66","1055285"
"JH378193","1495602","1495864","KQ058538v1","1444447","1444703","61","51155"
"JH378193","1520425","1520507","KQ053267v1","4202512","4202585","24","2682087"
"JH378193","1534212","1534498","KQ053521v1","2273365","2273646","69","739153"
"JH378193","1538583","1538906","KQ053883v1","4011013","4011321","81","2472430"
"JH378193","1545281","1545476","KQ054068v1","2511189","2511380","62","965908"
"JH378193","1564855","1565161","KQ054510v1","9759814","9760122","75","8194959"
"JH378193","1655774","1655951","KQ053202v1","830653","830812","52","825121"
"JH378193","1690208","1690510","KQ055674v1","310411","310707","67","1379797"
"JH378193","1690579","1690778","KQ053554v1","293392","293586","53","1397187"
"JH378193","1743965","1744246","KQ053409v1","3716306","3716585","52","1972341"
"JH378193","1781347","1781478","KQ056235v1","1268887","1269018","27","512460"
"JH378193","1814362","1814659","KQ053654v1","5318679","5318982","74","3504317"
"JH378193","1825283","1825553","KQ053520v1","2840509","2840769","67","1015226"
"JH378193","1915386","1915550","KQ056965v1","118773","118937","35","1796613"
"JH378193","1955242","1955518","KQ052968v1","13260777","13261056","61","11305535"
"JH378193","2164489","2164778","KQ052968v1","6282633","6282918","55","4118144"
"JH378193","2317710","2318011","KQ053816v1","7464708","7465010","57","5146998"
"JH378193","2360765","2361054","KQ053554v1","1105373","1105659","57","1255392"
"JH378193","2693690","2693972","KQ058257v1","559477","559763","64","2134213"
"JH378193","2707411","2707704","KQ055247v1","3219331","3219626","66","511920"
"JH378193","2802233","2802542","KQ056014v1","335464","335774","68","2466769"
"JH378193","2815831","2816152","KQ055236v1","2049624","2049930","73","766207"
"JH378193","2823042","2823147","KQ057122v1","1","104","24","2823041"
"JH378193","2831406","2831691","KQ057764v1","906126","906404","64","1925280"
"JH378193","2873187","2873484","KQ054356v1","1356188","1356481","77","1516999"
"JH378193","2880917","2881042","KQ055498v1","86970","87098","29","2793947"
"JH378193","2983855","2984146","KQ058561v1","4466656","4466945","60","1482801"
"JH378193","3035288","3035571","KQ058283v1","3525175","3525450","71","489887"
"JH378193","3095877","3096213","KQ056331v1","708530","708846","89","2387347"
"JH378193","3154617","3154907","KQ054932v1","5222584","5222864","63","2067967"
"JH378193","3166622","3166932","KQ054704v1","223675","223980","70","2942947"
"JH378193","3167125","3167393","KQ058383v1","5944247","5944518","66","2777122"
"JH378193","3177895","3178208","KQ058310v1","352181","352480","83","2825714"
"JH378193","3190546","3190721","KQ055479v1","2601433","2601611","45","589113"
"JH378193","3220478","3220761","KQ053409v1","3716306","3716585","63","495828"
"JH378193","3262590","3262861","KQ053190v1","4987885","4988162","68","1725295"
"JH378193","3506583","3506880","KQ052981v1","658787","659079","59","2847796"
"JH378193","3532974","3533161","KQ058386v1","145600","145783","47","3387374"
"JH378193","3534036","3534131","KQ053565v1","4323978","4324087","31","789942"
"JH378193","3733477","3733721","KQ054868v1","1834842","1835084","66","1898635"
"JH378193","3986198","3986298","KQ053135v1","7640479","7640580","25","3654281"
"JH378193","4065251","4065500","KQ053476v1","3998036","3998311","68","67215"
"JH378193","4090414","4090648","KQ053982v1","8827793","8828034","64","4737379"
"JH378193","4109502","4109660","KQ052968v1","10427732","10427888","29","6318230"
"JH378193","4234077","4234274","KQ055766v1","4486132","4486328","45","252055"
"JH378193","4234540","4234657","KQ057909v1","4153593","4153709","21","80947"
"JH378193","4353116","4353383","KQ058505v1","2346233","2346497","82","2006883"
"JH378193","4460430","4460719","KQ058427v1","8937580","8937869","69","4477150"
"JH378193","4577387","4577540","KQ053300v1","3146249","3146389","35","1431138"
"JH378193","4594746","4594988","KQ055375v1","3298020","3298279","73","1296726"
"JH378193","4622917","4623202","KQ052982v1","1103561","1103855","71","3519356"
"JH378193","4717742","4717989","KQ053795v1","380044","380305","66","4337698"
"JH378193","5085941","5086027","KQ053774v1","1983133","1983216","15","3102808"
"JH378193","5581122","5581418","KQ053299v1","4095914","4096215","57","1485208"
"JH378193","5644249","5644404","KQ053982v1","8151372","8151511","50","2507123"
"JH378193","5678134","5678414","KQ057118v1","2418455","2418734","58","3259679"
"JH378193","5726641","5726897","KQ057737v1","3083543","3083824","74","2643098"
"JH378193","5775681","5775809","KQ053146v1","2683242","2683362","33","3092439"
"JH378193","5790387","5790682","KQ058184v1","1505565","1505858","64","4284822"
"JH378193","5882470","5882655","KQ053993v1","924511","924676","51","4957959"
"JH378193","5912027","5912303","KQ053096v1","602899","603182","62","5309128"
"JH378193","6132137","6132279","KQ057764v1","1022073","1022218","34","5110064"
"JH378193","6149795","6150109","KQ056790v1","446564","446855","92","5703231"
"JH378193","6190742","6190964","KQ055375v1","2261003","2261228","52","3929739"
"JH378193","6272957","6273224","KQ055065v1","1117201","1117481","58","5155756"
"JH378193","6327947","6328236","KQ054124v1","2442155","2442433","68","3885792"
"JH378193","6350510","6350788","KQ052968v1","13260777","13261056","66","6910267"
"JH378193","6354217","6354489","KQ052968v1","4342479","4342745","66","2011738"
"JH378193","6368022","6368195","KQ057649v1","424252","424417","38","5943770"
"JH378193","6374582","6374879","KQ053398v1","2545768","2546067","61","3828814"
"JH378193","6388380","6388684","KQ058183v1","3008572","3008874","69","3379808"
"JH378193","6426014","6426282","KQ058483v1","2943412","2943683","67","3482602"
"JH378193","6464980","6465276","KQ053289v1","187323","187624","67","6277657"
"JH378193","6590055","6590189","KQ054279v1","76889","77022","23","6513166"
"JH378193","6615250","6615499","KQ058328v1","2569266","2569497","77","4045984"
"JH378193","6655379","6655682","KQ054047v1","432706","433011","78","6222673"
"JH378193","6704103","6704233","KQ052970v1","4795906","4796029","39","1908197"
"JH378193","6704242","6704365","KQ057151v1","259894","260018","23","6444348"
"JH378193","6714253","6714528","KQ053959v1","6189151","6189431","73","525102"
"JH378193","6766468","6766781","KQ058184v1","1505565","1505858","62","5260903"
"JH378193","6770955","6771174","KQ053256v1","942460","942674","48","5828495"
"JH378193","6794076","6794227","KQ054510v1","8179279","8179421","38","1385203"
"JH378193","6862953","6863216","KQ056587v1","1312432","1312709","75","5550521"
"JH378193","6901689","6901939","KQ054933v1","451778","452036","76","6449911"
"JH378193","7063645","7063886","KQ053115v1","1246859","1247104","74","5816786"
"JH378193","7076091","7076378","KQ052968v1","7064883","7065171","59","11208"
"JH378193","7231147","7231453","KQ058146v1","160981","161283","75","7070166"
"JH378193","7259855","7259985","KQ057560v1","1120980","1121109","24","6138875"
"JH378193","7298569","7298730","KQ055425v1","1445594","1445758","43","5852975"
"JH378193","7322072","7322324","KQ052971v1","6441372","6441626","56","880700"
"JH378193","7353966","7354084","KQ053256v1","1284266","1284394","26","6069700"
"JH378193","7391320","7391505","KQ053179v1","1735404","1735576","47","5655916"
"JH378193","7421160","7421457","KQ053212v1","1560173","1560471","67","5860987"
"JH378193","7465337","7465624","KQ052968v1","10629964","10630247","62","3164627"
"JH378193","7515010","7515255","KQ058405v1","697304","697560","67","6817706"
"JH378193","7651402","7651711","KQ058184v1","1505565","1505858","64","6145837"
"JH378193","7715267","7715473","KQ058383v1","9982530","9982731","45","2267263"
"JH378193","7731999","7732288","KQ053299v1","21869448","21869738","73","14137449"
"JH378193","7760834","7761079","KQ057345v1","1938824","1939073","67","5822010"
"JH378193","7853140","7853241","KQ053115v1","4371036","4371145","28","3482104"
"JH378193","7889946","7890259","KQ055044v1","89244","89545","76","7800702"
"JH378193","7994748","7995030","KQ052968v1","14043756","14044036","65","6049008"
"JH378193","8006581","8006704","KQ058042v1","92910","93024","29","7913671"
"JH378193","8199581","8199886","KQ053299v1","4095914","4096215","64","4103667"
"JH378193","8418394","8418556","KQ053299v1","15789056","15789214","42","7370662"
"JH378193","8622654","8622897","KQ054933v1","935520","935770","56","7687134"
"JH378193","8833448","8833722","KQ055192v1","1201363","1201615","66","7632085"
"JH378193","9020289","9020446","KQ053631v1","6372458","6372604","38","2647831"
"JH378193","9020940","9021073","KQ056855v1","2808237","2808368","41","6212703"
"JH378193","9029143","9029423","KQ053816v1","7327018","7327317","65","1702125"
"JH378193","9032626","9032916","KQ053157v1","7882293","7882588","73","1150333"
"JH378193","9095277","9095547","KQ053070v1","1068531","1068799","69","8026746"
"JH378193","9107702","9107956","KQ053521v1","1520832","1521089","73","7586870"
"JH378193","9135996","9136306","KQ053816v1","7464708","7465010","67","1671288"
"JH378193","9190211","9190484","KQ052970v1","6238337","6238613","69","2951874"
"JH378193","9198226","9198502","KQ054068v1","1268545","1268823","60","7929681"
"JH378193","9303625","9303784","KQ053774v1","3363264","3363425","34","5940361"
"JH378193","9305125","9305286","KQ057737v1","1426090","1426247","30","7879035"
"JH378194","73018","73304","KQ055610v1","1837519","1837800","71","1764501"
"JH378194","142080","142377","KQ058184v1","1505565","1505858","65","1363485"
"JH378194","146888","147167","KQ053498v1","3696034","3696323","68","3549146"
"JH378194","161362","161639","KQ053477v1","72886","73168","72","88476"
"JH378194","1124262","1124519","KQ053299v1","7562036","7562301","74","6437774"
"JH378194","1283279","1283414","KQ058257v1","652425","652556","28","630854"
"JH378194","2052878","2053099","KQ052969v1","3434555","3434769","59","1381677"
"JH378194","2647090","2647410","KQ058585v1","580456","580763","77","2066634"
"JH378194","4050987","4051118","KQ053354v1","702320","702452","23","3348667"
"JH378194","4133931","4134242","KQ055766v1","3990187","3990501","74","143744"
"JH378194","4478893","4479085","KQ053685v1","16639","16818","51","4462254"
"JH378194","5227961","5228155","KQ053849v1","1126392","1126589","48","4101569"
"JH378194","7648301","7648455","KQ057649v1","424252","424417","37","7224049"
"JH378194","7757428","7757726","KQ052968v1","7064883","7065171","69","692545"
"JH378194","7968653","7968919","KQ058383v1","2699813","2700083","61","5268840"
"JH378194","7972896","7973192","KQ053631v1","7166814","7167113","62","806082"
"JH378194","8048830","8049062","KQ056762v1","1558119","1558341","49","6490711"
"JH378194","8058296","8058587","KQ055872v1","3534333","3534634","76","4523963"
"JH378194","8329813","8330067","KQ054301v1","3391378","3391638","69","4938435"
"JH378194","8347607","8347755","KQ054412v1","2034642","2034787","44","6312965"
"JH378194","8619945","8620200","KQ053191v1","2134125","2134399","69","6485820"
"JH378194","8839277","8839538","KQ058503v1","123813","124064","64","8715464"
"JH378194","8874120","8874228","KQ053850v1","279389","279490","28","8594731"
"JH378194","8934871","8935174","KQ055852v1","1231373","1231668","76","7703498"
"JH378194","8947202","8947502","KQ053300v1","2877663","2877955","69","6069539"
"JH378194","9029173","9029461","KQ053288v1","2218996","2219287","59","6810177"
"JH378194","9091006","9091142","KQ057931v1","224937","225072","24","8866069"
"JH378194","9099853","9100115","KQ056773v1","122800","123057","59","8977053"
"JH378195","655318","655606","KQ055352v1","4183105","4183394","59","3527787"
"JH378195","563463","563713","KQ058627v1","3341899","3342143","62","2778436"
"JH378195","574148","574419","KQ056855v1","4172503","4172781","62","3598355"
"JH378195","919895","920173","KQ053146v1","2819587","2819868","63","1899692"
"JH378195","947195","947473","KQ058004v1","1480411","1480689","56","533216"
"JH378195","1204708","1205011","KQ058184v1","1505565","1505858","60","300857"
"JH378195","1360718","1361008","KQ055087v1","1063066","1063349","61","297652"
"JH378195","1392167","1392455","KQ055097v1","2825545","2825834","64","1433378"
"JH378195","1544660","1544943","KQ052969v1","7351818","7352090","65","5807158"
"JH378195","1556752","1557037","KQ058184v1","1505565","1505858","64","51187"
"JH378195","1636062","1636345","KQ058272v1","5443874","5444159","68","3807812"
"JH378195","1636942","1637077","KQ056643v1","1491838","1491968","28","145104"
"JH378195","1651575","1651871","KQ055173v1","248885","249169","79","1402690"
"JH378195","1675982","1676268","KQ055065v1","1117201","1117481","72","558781"
"JH378195","1676342","1676623","KQ057693v1","621833","622123","72","1054509"
"JH378195","1753506","1753634","KQ053752v1","4139428","4139559","23","2385922"
"JH378195","1776216","1776517","KQ058184v1","1505565","1505858","63","270651"
"JH378195","1789700","1789999","KQ054091v1","1388741","1389046","69","400959"
"JH378195","1858994","1859276","KQ058413v1","348155","348432","67","1510839"
"JH378195","1874450","1874797","KQ053993v1","1494489","1494813","91","379961"
"JH378195","1877048","1877335","KQ053421v1","2664387","2664683","63","787339"
"JH378195","1881431","1881708","KQ058528v1","57301","57576","68","1824130"
"JH378195","1893072","1893375","KQ058316v1","982603","982911","60","910469"
"JH378195","2039146","2039314","KQ053179v1","1735404","1735576","40","303742"
"JH378195","2414690","2414986","KQ056234v1","1233075","1233370","69","1181615"
"JH378195","4013015","4013310","KQ058316v1","1400358","1400649","77","2612657"
"JH378195","4098864","4099165","KQ055119v1","3293975","3294284","74","804889"
"JH378195","4343196","4343390","KQ058416v1","1197336","1197512","60","3145860"
"JH378195","4377839","4377953","KQ058050v1","918290","918400","18","3459549"
"JH378195","4435885","4436195","KQ053299v1","4095914","4096215","66","339971"
"JH378195","4487585","4487866","KQ056331v1","106636","106916","59","4380949"
"JH378195","4614066","4614205","KQ057702v1","1862724","1862857","28","2751342"
"JH378195","4684586","4684810","KQ057119v1","1328304","1328524","56","3356282"
"JH378195","4727900","4728208","KQ058184v1","1505565","1505858","69","3222335"
"JH378195","4850462","4850753","KQ053816v1","6856607","6856902","71","2006145"
"JH378195","4905578","4905875","KQ054510v1","2056259","2056562","66","2849319"
"JH378195","4934975","4935312","KQ058583v1","3101722","3102049","79","1833253"
"JH378195","4946487","4946819","KQ054795v1","2774148","2774449","84","2172339"
"JH378195","5384398","5384678","KQ054069v1","7677009","7677286","71","2292611"
"JH378195","5493219","5493365","KQ054466v1","1866785","1866925","33","3626434"
"JH378195","5493757","5493886","KQ053763v1","4935139","4935266","25","558618"
"JH378195","5590530","5590802","KQ057380v1","1672785","1673058","69","3917745"
"JH378195","5591713","5592000","KQ056790v1","446564","446855","69","5145149"
"JH378195","5705402","5705547","KQ053310v1","2640191","2640334","40","3065211"
"JH378195","5768373","5768467","KQ055872v1","3969127","3969217","18","1799246"
"JH378195","5768661","5768873","KQ052968v1","7524927","7525138","54","1756266"
"JH378195","5778576","5778845","KQ057909v1","763467","763734","61","5015109"
"JH378195","5847659","5847829","KQ054026v1","2068803","2068970","37","3778856"
"JH378195","5864280","5864588","KQ054400v1","4672799","4673099","89","1191481"
"JH378195","5864731","5865009","KQ058283v1","1694307","1694568","68","4170424"
"JH378195","5981109","5981379","KQ053398v1","4702476","4702738","70","1278633"
"JH378195","6323532","6323811","KQ053816v1","7464708","7465010","86","1141176"
"JH378195","6730024","6730310","KQ053332v1","447571","447853","58","6282453"
"JH378195","6793713","6794041","KQ053135v1","3156167","3156481","74","3637546"
"JH378195","6849785","6850099","KQ055787v1","694393","694708","68","6155392"
"JH378195","7369529","7369827","KQ053631v1","7288314","7288608","62","81215"
"JH378195","7413409","7413708","KQ058184v1","1505565","1505858","67","5907844"
"JH378195","7583975","7584269","KQ058483v1","1747852","1748144","87","5836123"
"JH378195","7649917","7650223","KQ058291v1","406175","406478","69","7243742"
"JH378195","7663834","7663940","KQ053299v1","10212827","10212927","34","2548993"
"JH378195","7663955","7664077","KQ056837v1","2728847","2728978","26","4935108"
"JH378195","7680269","7680562","KQ058383v1","6917259","6917555","66","763010"
"JH378195","7705361","7705628","KQ057345v1","1938824","1939073","71","5766537"
"JH378195","7709956","7710233","KQ053278v1","563031","563302","74","7146925"
"JH378195","7711854","7712050","KQ058561v1","565602","565807","42","7146252"
"JH378195","7780798","7781081","KQ058607v1","429760","430048","56","7351038"
"JH378195","7785125","7785401","KQ057380v1","1672785","1673058","64","6112340"
"JH378195","7846377","7846584","KQ058561v1","565602","565807","57","7280775"
"JH378195","7910830","7911152","KQ055767v1","2455394","2455703","79","5455436"
"JH378195","7915634","7915899","KQ054994v1","3190229","3190506","76","4725405"
"JH378195","7990382","7990515","KQ052970v1","11857903","11858038","38","3867521"
"JH378195","8036847","8037074","KQ056762v1","1558119","1558341","61","6478728"
"JH378195","8134817","8134949","KQ053432v1","5514393","5514523","32","2620424"
"JH378195","8195334","8195620","KQ052981v1","658787","659079","66","7536547"
"JH378195","8320282","8320573","KQ052970v1","8520800","8521088","77","200518"
"JH378195","8401929","8402218","KQ053299v1","21835674","21835971","64","13433745"
"JH378195","8494471","8494785","KQ055457v1","2061137","2061448","74","6433334"
"JH378195","9115778","9116072","KQ058184v1","1505565","1505858","54","7610213"
"JH378196","3276570","3276895","KQ055404v1","3812653","3812963","81","536083"
"JH378196","34164","34321","KQ053157v1","5478543","5478695","33","5444379"
"JH378196","132263","132533","KQ056234v1","797462","797744","79","665199"
"JH378196","176717","177016","KQ053631v1","9595448","9595749","67","9418731"
"JH378196","330759","331067","KQ055004v1","332895","333205","69","2136"
"JH378196","337065","337339","KQ057909v1","12421223","12421497","60","12084158"
"JH378196","340923","341196","KQ056475v1","2065342","2065608","64","1724419"
"JH378196","344816","345118","KQ058585v1","580456","580763","66","235640"
"JH378196","351546","351681","KQ054510v1","2941967","2942098","26","2590421"
"JH378196","379807","379962","KQ053850v1","197751","197910","46","182056"
"JH378196","465870","466173","KQ057693v1","117172","117472","83","348698"
"JH378196","545687","545809","KQ053300v1","2607358","2607485","33","2061671"
"JH378196","1085260","1085567","KQ058184v1","1505565","1505858","68","420305"
"JH378196","1192887","1193197","KQ053398v1","3445470","3445768","83","2252583"
"JH378196","1323506","1323815","KQ054932v1","2708037","2708346","62","1384531"
"JH378196","1603960","1604250","KQ058004v1","1100771","1101059","71","503189"
"JH378196","1699817","1700101","KQ054786v1","1481220","1481519","81","218597"
"JH378196","1840411","1840732","KQ052970v1","7631891","7632195","68","5791480"
"JH378196","1841865","1842003","KQ053752v1","1383162","1383295","26","458703"
"JH378196","2490707","2490983","KQ057118v1","2418455","2418734","69","72252"
"JH378196","2604150","2604454","KQ058184v1","1505565","1505858","57","1098585"
"JH378196","2907417","2907701","KQ054068v1","4908299","4908556","82","2000882"
"JH378196","3054352","3054403","KQ053443v1","334639","334693","9","2719713"
"JH378196","3100996","3101283","KQ053256v1","2921030","2921328","78","179966"
"JH378196","3106255","3106544","KQ057099v1","274308","274596","77","2831947"
"JH378196","3173261","3173544","KQ055087v1","1063066","1063349","58","2110195"
"JH378196","3214197","3214467","KQ057161v1","218502","218773","79","2995695"
"JH378196","3265355","3265659","KQ054932v1","4838112","4838407","66","1572757"
"JH378196","3274460","3274537","KQ056182v1","2075045","2075117","28","1199415"
"JH378196","3275555","3275815","KQ058539v1","60805","61074","72","3214750"
"JH378196","3299396","3299681","KQ054412v1","1824448","1824730","67","1474948"
"JH378196","3307432","3307559","KQ058320v1","631698","631822","24","2675734"
"JH378196","3312388","3312666","KQ053191v1","614334","614618","78","2698054"
"JH378196","3330493","3330704","KQ058537v1","27912","28129","55","3302581"
"JH378196","3357870","3358151","KQ054069v1","7677009","7677286","63","4319139"
"JH378196","3361923","3362054","KQ053409v1","6573923","6574054","25","3212000"
"JH378196","3406720","3406850","KQ056996v1","661309","661441","33","2745411"
"JH378196","3428470","3428606","KQ053115v1","1650505","1650644","25","1777965"
"JH378196","3452762","3453006","KQ055035v1","3353120","3353360","62","99642"
"JH378196","3463534","3463631","KQ055024v1","329599","329697","19","3133935"
"JH378196","3493378","3493601","KQ057119v1","1328304","1328524","51","2165074"
"JH378196","3547454","3547744","KQ058004v1","3144607","3144910","91","402847"
"JH378196","3552037","3552169","KQ055192v1","1759958","1760089","21","1792079"
"JH378196","3554314","3554612","KQ052969v1","9116808","9117108","65","5562494"
"JH378196","3747314","3747594","KQ055735v1","667472","667747","74","3079842"
"JH378196","3878049","3878338","KQ052968v1","10629964","10630247","71","6751915"
"JH378196","4034699","4035003","KQ057909v1","11632258","11632558","70","7597559"
"JH378196","4355237","4355430","KQ053948v1","2776497","2776701","55","1578740"
"JH378196","4379364","4379670","KQ053299v1","4095914","4096215","67","283450"
"JH378196","4993225","4993517","KQ054412v1","2490468","2490761","70","2502757"
"JH378196","5029368","5029663","KQ058550v1","780687","780984","78","4248681"
"JH378196","5080195","5080488","KQ058184v1","1505565","1505858","57","3574630"
"JH378196","5692857","5693023","KQ052968v1","10427732","10427888","40","4734875"
"JH378196","6251227","6251513","KQ057693v1","117172","117472","67","6134055"
"JH378196","6335590","6335879","KQ053816v1","5837219","5837503","85","498371"
"JH378196","6449950","6450262","KQ054826v1","7957748","7958033","91","1507798"
"JH378196","6468587","6468860","KQ052969v1","8828499","8828765","60","2359912"
"JH378196","6542958","6543245","KQ056494v1","2222182","2222467","66","4320776"
"JH378196","6581025","6581320","KQ058184v1","1505565","1505858","53","5075460"
"JH378196","6583076","6583287","KQ053609v1","2642121","2642332","65","3940955"
"JH378196","6588376","6588514","KQ053354v1","702320","702452","25","5886056"
"JH378196","6626635","6626782","KQ054466v1","1866785","1866925","36","4759850"
"JH378196","6628334","6628598","KQ058094v1","5430881","5431130","56","1197453"
"JH378196","6641428","6641744","KQ054786v1","934497","934799","81","5706931"
"JH378196","6723537","6723742","KQ056148v1","3131043","3131264","58","3592494"
"JH378196","6738972","6739256","KQ058184v1","1505565","1505858","79","5233407"
"JH378196","6790721","6791011","KQ055787v1","925083","925374","76","5865638"
"JH378196","6796103","6796256","KQ054401v1","3742804","3742954","34","3053299"
"JH378196","6907039","6907174","KQ053190v1","1502830","1502955","33","5404209"
"JH378196","7033273","7033557","KQ053332v1","554962","555258","76","6478311"
"JH378196","7113948","7114127","KQ056945v1","2675278","2675453","49","4438670"
"JH378196","7131790","7132079","KQ056673v1","1151371","1151663","56","5980419"
"JH378196","7142048","7142333","KQ054124v1","2442155","2442433","60","4699893"
"JH378196","7289738","7289855","KQ053409v1","1348905","1349026","41","5940833"
"JH378196","7290123","7290429","KQ053795v1","1714401","1714699","70","5575722"
"JH378196","7304320","7304619","KQ058315v1","141150","141450","70","7163170"
"JH378196","7502879","7503185","KQ052969v1","9116808","9117108","63","1613929"
"JH378196","7552149","7552228","KQ055755v1","1328874","1328956","18","6223275"
"JH378196","7552440","7552567","KQ054047v1","1054810","1054936","22","6497630"
"JH378196","7654953","7655125","KQ055425v1","1445594","1445758","36","6209359"
"JH378196","7719731","7720016","KQ058339v1","5036375","5036644","75","2683356"
"JH378196","7948803","7949090","KQ057118v1","2418455","2418734","71","5530348"
"JH378196","7950532","7950815","KQ053300v1","2874445","2874736","65","5076087"
"JH378196","7968950","7969203","KQ053795v1","370451","370712","63","7598499"
"JH378196","7999076","7999369","KQ058353v1","1264780","1265071","62","6734296"
"JH378196","8005803","8006079","KQ057560v1","3114391","3114640","77","4891412"
"JH378196","8147251","8147508","KQ055978v1","3560415","3560681","66","4586836"
"JH378196","8343361","8343658","KQ053476v1","1823610","1823912","69","6519751"
"JH378196","8497879","8498012","KQ053850v1","709379","709515","26","7788500"
"JH378196","8578485","8578648","KQ055425v1","1445594","1445758","39","7132891"
"JH378196","8599455","8599604","KQ054124v1","4733901","4734054","38","3865554"
"JH378196","8630776","8631058","KQ057737v1","3274981","3275269","74","5355795"
"JH378196","8945457","8945521","KQ054466v1","1769053","1769119","23","7176404"
"JH378196","8945544","8945658","KQ054124v1","2458387","2458494","33","6487157"
"JH378196","9049594","9049786","KQ055425v1","1445594","1445758","55","7604000"
"JH378197","21400","21670","KQ054124v1","4347479","4347753","83","4326079"
"JH378197","46510","46811","KQ056672v1","3108202","3108500","74","3061692"
"JH378197","401487","401588","KQ058532v1","371084","371193","33","30403"
"JH378197","401707","401821","KQ052969v1","10780536","10780655","29","10378829"
"JH378197","717159","717378","KQ058317v1","3410517","3410729","57","2693358"
"JH378197","741569","741865","KQ055236v1","199628","199925","65","541941"
"JH378197","1050694","1050834","KQ056147v1","2168964","2169108","32","1118270"
"JH378197","1221383","1221601","KQ053520v1","4901250","4901462","52","3679867"
"JH378197","1458528","1458730","KQ058350v1","871497","871688","49","587031"
"JH378197","1559047","1559305","KQ056456v1","2396773","2397042","66","837726"
"JH378197","2048889","2049134","KQ058339v1","4743560","4743804","73","2694671"
"JH378197","2336210","2336494","KQ058184v1","1505565","1505858","61","830645"
"JH378197","2765430","2765617","KQ055203v1","430860","431048","51","2334570"
"JH378197","3140966","3141270","KQ053631v1","7288314","7288608","74","4147348"
"JH378197","3263430","3263714","KQ052968v1","7064883","7065171","74","3801453"
"JH378197","3280952","3281249","KQ053299v1","3823059","3823361","65","542107"
"JH378197","3296192","3296471","KQ053082v1","1085491","1085778","63","2210701"
"JH378197","3567703","3568006","KQ056475v1","2179070","2179363","65","1388633"
"JH378197","3591709","3591870","KQ053026v1","3592158","3592294","52","449"
"JH378197","3854573","3854856","KQ053146v1","2819587","2819868","59","1034986"
"JH378197","3918070","3918232","KQ055872v1","11131397","11131559","38","7213327"
"JH378197","3942421","3942663","KQ057345v1","1938824","1939073","58","2003597"
"JH378197","4019390","4019682","KQ053631v1","7288314","7288608","65","3268924"
"JH378197","4082411","4082553","KQ055384v1","491912","492046","32","3590499"
"JH378197","4370853","4370987","KQ056652v1","675563","675695","25","3695290"
"JH378197","4424754","4425009","KQ058539v1","481549","481810","61","3943205"
"JH378197","4433624","4433902","KQ054693v1","832788","833076","69","3600836"
"JH378197","4478569","4478714","KQ055183v1","2514156","2514302","30","1964413"
"JH378197","4522682","4522998","KQ058313v1","2020900","2021211","69","2501782"
"JH378197","4613331","4613513","KQ056440v1","24372","24553","56","4588959"
"JH378197","4617386","4617520","KQ057910v1","1548802","1548933","25","3068584"
"JH378197","4627630","4627767","KQ055258v1","3274072","3274190","35","1353558"
"JH378197","4737620","4737907","KQ052971v1","841846","842131","70","3895774"
"JH378197","4754099","4754397","KQ058184v1","1505565","1505858","65","3248534"
"JH378197","4839675","4839949","KQ055247v1","4473872","4474145","66","365803"
"JH378197","4996404","4996630","KQ053354v1","1943191","1943424","54","3053213"
"JH378197","5074480","5074555","KQ055979v1","1425","1498","13","5073055"
"JH378197","5224640","5224922","KQ053959v1","439986","440271","57","4784654"
"JH378197","5258078","5258361","KQ055183v1","429489","429783","61","4828589"
"JH378197","5267738","5268027","KQ058542v1","552861","553154","68","4714877"
"JH378197","5310205","5310290","KQ056148v1","5019141","5019230","20","291064"
"JH378197","5325778","5326074","KQ057004v1","1506143","1506432","69","3819635"
"JH378197","5393250","5393431","KQ055457v1","11733685","11733859","39","6340435"
"JH378197","5451109","5451278","KQ055425v1","1445594","1445758","35","4005515"
"JH378197","5487224","5487356","KQ053948v1","2765570","2765701","24","2721654"
"JH378197","5530430","5530777","KQ053398v1","4097175","4097499","96","1433255"
"JH378197","5567612","5567861","KQ054932v1","10346474","10346710","64","4778862"
"JH378197","5608730","5609028","KQ056790v1","446564","446855","66","5162166"
"JH378197","5688275","5688445","KQ057397v1","306237","306400","36","5382038"
"JH378197","5714345","5714529","KQ057648v1","342241","342427","44","5372104"
"JH378197","5764964","5765245","KQ053827v1","4198964","4199247","73","1566000"
"JH378197","5866458","5866757","KQ056973v1","1765942","1766236","62","4100516"
"JH378197","5960728","5960996","KQ053432v1","3710952","3711220","70","2249776"
"JH378197","6077649","6077935","KQ055662v1","456935","457225","84","5620714"
"JH378197","6213670","6213806","KQ055557v1","3342421","3342554","28","2871249"
"JH378197","6403090","6403367","KQ053146v1","2819587","2819868","58","3583503"
"JH378197","6412900","6413067","KQ055425v1","1445594","1445758","36","4967306"
"JH378197","6458179","6458312","KQ054179v1","3927334","3927468","26","2530845"
"JH378197","6469741","6469897","KQ054466v1","1866785","1866925","39","4602956"
"JH378197","6469899","6469959","KQ053260v1","77779","77831","23","6392120"
"JH378197","6529907","6530212","KQ052969v1","9116808","9117108","60","2586901"
"JH378197","6540326","6540612","KQ058316v1","2555894","2556176","65","3984432"
"JH378197","6637065","6637240","KQ057648v1","1909422","1909597","54","4727643"
"JH378197","6710531","6710692","KQ058305v1","820286","820452","38","5890245"
"JH378197","6789414","6789705","KQ053816v1","7464708","7465010","62","675294"
"JH378197","6793745","6793914","KQ057471v1","905063","905222","53","5888682"
"JH378197","7170322","7170619","KQ058184v1","1505565","1505858","62","5664757"
"JH378197","7212704","7212992","KQ058184v1","1505565","1505858","64","5707139"
"JH378197","7472843","7473147","KQ053343v1","1747702","1748011","68","5725141"
"JH378197","7488378","7488544","KQ053223v1","2815634","2815800","39","4672744"
"JH378197","7538853","7539171","KQ054984v1","1182758","1183073","76","6356095"
"JH378197","7747630","7747925","KQ053093v1","2967081","2967372","71","4780549"
"JH378197","7852365","7852500","KQ057488v1","512192","512325","28","7340173"
"JH378197","7867745","7867920","KQ058459v1","469480","469653","44","7398265"
"JH378197","8068056","8068235","KQ053299v1","776665","776838","59","7291391"
"JH378197","8142870","8143174","KQ058427v1","6207003","6207299","70","1935867"
"JH378197","8188579","8188715","KQ053070v1","2490401","2490534","23","5698178"
"JH378197","8304297","8304569","KQ058183v1","83296","83573","68","8221001"
"JH378197","8483285","8483415","KQ054682v1","2336064","2336208","41","6147221"
"JH378197","8523963","8524275","KQ058184v1","1505565","1505858","70","7018398"
"JH378197","8577014","8577328","KQ052982v1","924564","924846","93","7652450"
"JH378197","8642157","8642447","KQ058538v1","1399962","1400253","67","7242195"
"JH378197","8709988","8710089","KQ053157v1","8174152","8174260","29","535836"
"JH378197","8731405","8731540","KQ053115v1","1650505","1650644","26","7080900"
"JH378197","8886520","8886804","KQ056920v1","144919","145210","69","8741601"
"JH378198","50390","50612","KQ053741v1","1190544","1190756","54","1140154"
"JH378198","96265","96587","KQ055787v1","694393","694708","78","598128"
"JH378198","117278","117565","KQ053170v1","106778","107070","62","10500"
"JH378198","169864","170057","KQ056404v1","77681","77883","43","92183"
"JH378198","1087077","1087231","KQ052968v1","10427732","10427888","33","9340655"
"JH378198","1151935","1152253","KQ054289v1","3313891","3314207","66","2161956"
"JH378198","1189804","1189926","KQ056035v1","296324","296444","23","893480"
"JH378198","1205785","1206090","KQ058582v1","1599482","1599782","75","393697"
"JH378198","1223966","1224180","KQ058360v1","26261","26480","69","1197705"
"JH378198","1269621","1269927","KQ056440v1","1157164","1157460","77","112457"
"JH378198","1278630","1278783","KQ057034v1","3721608","3721761","34","2442978"
"JH378198","1465578","1465885","KQ053816v1","7464708","7465010","74","5999130"
"JH378198","1538422","1538546","KQ052970v1","11857903","11858038","31","10319481"
"JH378198","1554040","1554204","KQ058394v1","145224","145389","39","1408816"
"JH378198","1763025","1763306","KQ058183v1","487423","487710","62","1275602"
"JH378198","1866477","1866734","KQ054932v1","4146161","4146408","69","2279684"
"JH378198","1945031","1945161","KQ058394v1","2902727","2902859","30","957696"
"JH378198","1986697","1986963","KQ053520v1","482516","482787","64","1504181"
"JH378198","2106657","2106923","KQ057910v1","2540095","2540357","72","433438"
"JH378198","2161273","2161560","KQ053959v1","6189151","6189431","65","4027878"
"JH378198","2195544","2195844","KQ052969v1","9047118","9047410","81","6851574"
"JH378198","2252597","2252914","KQ053816v1","3348768","3349084","70","1096171"
"JH378198","2264211","2264507","KQ054704v1","215433","215738","62","2048778"
"JH378198","2306110","2306400","KQ054510v1","2204929","2205225","72","101181"
"JH378198","2316479","2316780","KQ056672v1","3082150","3082439","77","765671"
"JH378198","2403067","2403353","KQ053093v1","1361295","1361576","61","1041772"
"JH378198","2573986","2574279","KQ054069v1","7687863","7688158","76","5113877"
"JH378198","2855412","2855726","KQ055236v1","2049624","2049930","60","805788"
"JH378198","3383539","3383850","KQ054704v1","223675","223980","71","3159864"
"JH378198","3419149","3419438","KQ058316v1","4697990","4698273","72","1278841"
"JH378198","3975756","3975934","KQ054879v1","1455515","1455684","48","2520241"
"JH378198","4090811","4091057","KQ053135v1","6974800","6975038","77","2883989"
"JH378198","4126970","4127264","KQ053916v1","1741116","1741399","67","2385854"
"JH378198","4214601","4214867","KQ055662v1","4683524","4683789","67","468923"
"JH378198","4279626","4279907","KQ058533v1","977692","977970","60","3301934"
"JH378198","4289698","4289950","KQ055203v1","1891285","1891537","77","2398413"
"JH378198","4369040","4369345","KQ053554v1","2471177","2471484","67","1897863"
"JH378198","4476950","4477108","KQ053157v1","5478543","5478695","30","1001593"
"JH378198","4500688","4500848","KQ056475v1","5275769","5275928","35","775081"
"JH378198","4598132","4598434","KQ053960v1","70067","70362","62","4528065"
"JH378198","4605694","4605898","KQ058616v1","3055609","3055812","50","1550085"
"JH378198","4621400","4621648","KQ058505v1","2234909","2235124","80","2386491"
"JH378198","4648174","4648469","KQ055852v1","1231373","1231668","63","3416801"
"JH378198","4817038","4817235","KQ054921v1","4087847","4088033","59","729191"
"JH378198","4817280","4817368","KQ054576v1","802587","802678","22","4014693"
"JH378198","4884453","4884573","KQ055808v1","1908479","1908585","39","2975974"
"JH378198","4993888","4994000","KQ052969v1","2661859","2661968","31","2332029"
"JH378198","5083539","5083819","KQ058272v1","5443874","5444159","76","360335"
"JH378198","5130992","5131152","KQ058461v1","2955991","2956154","42","2175001"
"JH378198","5290004","5290071","KQ053072v1","197621","197681","13","5092383"
"JH378198","5381219","5381511","KQ053070v1","533496","533791","72","4847723"
"JH378198","5438365","5438484","KQ055498v1","20783","20899","28","5417582"
"JH378198","5475275","5475568","KQ058561v1","4225175","4225466","59","1250100"
"JH378198","5496939","5497223","KQ053115v1","1118362","1118655","73","4378577"
"JH378198","5506065","5506341","KQ058550v1","3353016","3353303","76","2153049"
"JH378198","5517846","5518093","KQ057345v1","1938824","1939073","58","3579022"
"JH378198","5572016","5572136","KQ057118v1","1458691","1458813","45","4113325"
"JH378198","5575096","5575301","KQ056147v1","3894275","3894476","71","1680821"
"JH378198","5581183","5581311","KQ053498v1","2897317","2897441","32","2683866"
"JH378198","5585213","5585506","KQ054693v1","832788","833076","62","4752425"
"JH378198","5663878","5664022","KQ052970v1","12418764","12418905","33","6754886"
"JH378198","5664699","5664806","KQ053310v1","1622751","1622859","28","4041948"
"JH378198","5704817","5704984","KQ058050v1","578571","578732","31","5126246"
"JH378198","5709962","5710221","KQ055808v1","865533","865804","68","4844429"
"JH378198","5723387","5723455","KQ055458v1","1227920","1227985","23","4495467"
"JH378198","5944974","5945293","KQ052981v1","1198440","1198752","76","4746534"
"JH378198","6215235","6215520","KQ058094v1","7832529","7832815","59","1617294"
"JH378198","6254944","6255076","KQ054565v1","5438306","5438438","27","816638"
"JH378198","6282693","6282880","KQ056945v1","2675278","2675453","57","3607415"
"JH378198","6283278","6283385","KQ054180v1","2833924","2834036","31","3449354"
"JH378198","6283608","6283701","KQ054323v1","1913767","1913855","29","4369841"
"JH378198","6375249","6375546","KQ056587v1","9000240","9000528","68","2624991"
"JH378198","6443670","6443814","KQ056055v1","2764","2905","32","6440906"
"JH378198","6444248","6444381","KQ055141v1","3481451","3481584","38","2962797"
"JH378198","6587589","6587909","KQ057875v1","404539","404839","83","6183050"
"JH378198","6630703","6630817","KQ053157v1","8174152","8174260","30","1543449"
"JH378198","6791046","6791272","KQ054724v1","2773806","2774015","70","4017240"
"JH378198","8065860","8066170","KQ053631v1","8031857","8032161","66","34003"
"JH378198","8187481","8187772","KQ055248v1","947170","947461","63","7240311"
"JH378198","8306407","8306719","KQ058377v1","25815","26128","73","8280592"
"JH378198","8360638","8360914","KQ053332v1","447571","447853","68","7913067"
"JH378198","8431315","8431607","KQ058538v1","934688","934988","71","7496627"
"JH378198","8585220","8585498","KQ053299v1","2118230","2118517","68","6466990"
"JH378198","8700694","8700842","KQ054412v1","2185013","2185160","33","6515681"
"JH378198","8760731","8760994","KQ056404v1","638131","638387","69","8122600"
"JH378198","8816394","8816617","KQ058004v1","2720169","2720394","57","6096225"
"JH378199","72133","72394","KQ056440v1","384535","384789","84","312402"
"JH378199","107454","107761","KQ058315v1","658193","658490","70","550739"
"JH378199","140062","140328","KQ055192v1","1201363","1201615","73","1061301"
"JH378199","252176","252296","KQ053157v1","8174152","8174260","31","7921976"
"JH378199","427615","427755","KQ053115v1","1650505","1650644","28","1222890"
"JH378199","467475","467577","KQ055142v1","1223635","1223740","29","756160"
"JH378199","646368","646664","KQ053816v1","7464708","7465010","70","6818340"
"JH378199","661281","661451","KQ058605v1","2263683","2263842","42","1602402"
"JH378199","808155","808313","KQ052968v1","8575658","8575813","43","7767503"
"JH378199","986125","986305","KQ054400v1","998921","999101","36","12796"
"JH378199","1143139","1143271","KQ055498v1","86970","87098","24","1056169"
"JH378199","1201061","1201365","KQ053093v1","1738898","1739201","69","537837"
"JH378199","1254356","1254648","KQ056673v1","1151371","1151663","55","102985"
"JH378199","1485579","1485739","KQ056965v1","118773","118937","39","1366806"
"JH378199","1595896","1596053","KQ057737v1","1426090","1426247","40","169806"
"JH378199","1724814","1725116","KQ054124v1","2442155","2442433","93","717341"
"JH378199","1809210","1809294","KQ058325v1","894348","894422","19","914862"
"JH378199","2060030","2060232","KQ054081v1","1002095","1002297","51","1057935"
"JH378199","2108517","2108812","KQ053026v1","3680523","3680807","66","1572006"
"JH378199","2158944","2159253","KQ054378v1","1992071","1992380","79","166873"
"JH378199","2194534","2194694","KQ058461v1","3297582","3297739","32","1103048"
"JH378199","2315496","2315805","KQ053554v1","2471177","2471484","68","155681"
"JH378199","2337634","2337878","KQ058550v1","5126897","5127128","79","2789263"
"JH378199","2349634","2349928","KQ055674v1","310411","310707","74","2039223"
"JH378199","2392657","2392956","KQ053299v1","3823059","3823361","78","1430402"
"JH378199","2429492","2429623","KQ058539v1","1674569","1674697","25","754923"
"JH378199","2449307","2449575","KQ053082v1","6554439","6554712","76","4105132"
"JH378199","2606521","2606636","KQ058328v1","5454635","5454751","29","2848114"
"JH378199","2606961","2607043","KQ053060v1","4849","4931","17","2602112"
"JH378199","2711913","2712204","KQ053146v1","1320586","1320881","63","1391327"
"JH378199","2718762","2719059","KQ053176v1","127570","127860","63","2591192"
"JH378199","2763557","2763783","KQ058394v1","15440202","15440431","67","12676645"
"JH378199","2823405","2823537","KQ058339v1","4320449","4320570","32","1497044"
"JH378199","2949889","2950031","KQ053115v1","1650505","1650644","22","1299384"
"JH378199","2956550","2956844","KQ053135v1","2595482","2595783","72","361068"
"JH378199","3060480","3060756","KQ054868v1","2229582","2229854","60","830898"
"JH378199","3182906","3183201","KQ053115v1","1118362","1118655","69","2064544"
"JH378199","3481217","3481509","KQ055490v1","2107132","2107421","66","1374085"
"JH378199","3650088","3650209","KQ058550v1","2678881","2679004","29","971207"
"JH378199","3650289","3650398","KQ053850v1","279389","279490","31","3370900"
"JH378199","3675240","3675455","KQ056440v1","828108","828325","50","2847132"
"JH378199","3770411","3770471","KQ055384v1","420057","420110","20","3350354"
"JH378199","3800276","3800453","KQ054932v1","4131919","4132090","52","331643"
"JH378199","3800831","3800942","KQ053785v1","828746","828862","28","2972085"
"JH378199","3839779","3839928","KQ057023v1","552794","552951","33","3286985"
"JH378199","3987202","3987369","KQ058394v1","8507617","8507787","44","4520415"
"JH378199","4024626","4024837","KQ053827v1","5369199","5369432","74","1344573"
"JH378199","4037061","4037267","KQ053115v1","1122961","1123171","65","2914100"
"JH378199","4162752","4162887","KQ053520v1","716323","716460","37","3446429"
"JH378199","4250171","4250330","KQ052969v1","8430836","8430996","41","4180665"
"JH378199","4252256","4252510","KQ058094v1","5430881","5431130","58","1178625"
"JH378199","4310615","4310689","KQ054932v1","3876923","3876983","21","433692"
"JH378199","4315627","4315774","KQ054724v1","4354278","4354419","37","38651"
"JH378199","4319585","4319844","KQ057471v1","1395073","1395329","68","2924512"
"JH378199","4377733","4378027","KQ052970v1","8274642","8274940","78","3896909"
"JH378199","4386558","4386866","KQ053654v1","5318679","5318982","70","932121"
"JH378199","4476287","4476448","KQ055589v1","815","963","60","4475472"
"JH378199","4618400","4618548","KQ054196v1","237","387","39","4618163"
"JH378199","4717812","4718102","KQ055192v1","1106994","1107270","69","3610818"
"JH378199","4768285","4768417","KQ054356v1","2063578","2063712","41","2704707"
"JH378199","5198078","5198389","KQ056331v1","106636","106916","66","5091442"
"JH378199","5697350","5697555","KQ053609v1","2642121","2642332","59","3055229"
"JH378199","6886196","6886328","KQ053115v1","1333586","1333718","23","5552610"
"JH378199","7222285","7222446","KQ055610v1","2914168","2914340","55","4308117"
"JH378199","7416896","7417184","KQ056663v1","500658","500926","84","6916238"
"JH378199","8111305","8111588","KQ053838v1","3013088","3013374","67","5098217"
"JH378199","8316954","8317246","KQ053398v1","2545768","2546067","60","5771186"
"JH378199","8523081","8523215","KQ053763v1","4935139","4935266","22","3587942"
"JH378200","15750","16066","KQ054943v1","2938380","2938687","80","2922630"
"JH378200","280897","281156","KQ056643v1","159950","160228","79","120947"
"JH378200","476755","476886","KQ055755v1","801738","801870","28","324983"
"JH378200","752724","753016","KQ056147v1","876300","876576","82","123576"
"JH378200","981367","981645","KQ055893v1","1739065","1739339","59","757698"
"JH378200","1016527","1016879","KQ058287v1","982841","983179","95","33686"
"JH378200","1316250","1316530","KQ054533v1","288767","289055","75","1027483"
"JH378200","2364075","2364346","KQ058304v1","1018835","1019100","73","1345240"
"JH378200","2971200","2971502","KQ057290v1","2953971","2954265","72","17229"
"JH378200","3670209","3670412","KQ053343v1","1057961","1058175","62","2612248"
"JH378200","3824187","3824455","KQ056920v1","346245","346510","63","3477942"
"JH378200","3849718","3849792","KQ053267v1","4202512","4202585","14","352794"
"JH378200","4051732","4051796","KQ056928v1","835672","835737","17","3216060"
"JH378200","4100130","4100263","KQ058094v1","3687022","3687155","27","413108"
"JH378200","4105908","4105997","KQ058253v1","973922","974008","26","3131986"
"JH378200","4351965","4352279","KQ056331v1","249789","250088","81","4102176"
"JH378200","4387283","4387576","KQ058452v1","757762","758043","74","3629521"
"JH378200","5084521","5084814","KQ054224v1","428324","428601","72","4656197"
"JH378200","5280051","5280322","KQ056643v1","159950","160228","66","5120101"
"JH378200","5822977","5823114","KQ053686v1","1108593","1108721","38","4714384"
"JH378200","6017791","6018070","KQ052982v1","2557979","2558263","65","3459812"
"JH378200","6325303","6325597","KQ058184v1","1505565","1505858","71","4819738"
"JH378200","6421314","6421528","KQ056673v1","1365335","1365539","51","5055979"
"JH378200","6443381","6443670","KQ053816v1","5837219","5837503","69","606162"
"JH378200","6447780","6448035","KQ055364v1","1919520","1919774","59","4528260"
"JH378200","6771668","6771823","KQ054235v1","823003","823145","42","5948665"
"JH378200","6988708","6989017","KQ054510v1","2056259","2056562","72","4932449"
"JH378200","7013634","7013839","KQ055873v1","348217","348419","57","6665417"
"JH378200","7136681","7136789","KQ052969v1","2661859","2661968","28","4474822"
"JH378200","7182464","7182677","KQ056762v1","1558119","1558341","61","5624345"
"JH378200","7191894","7192043","KQ056147v1","2168964","2169108","30","5022930"
"JH378200","7297395","7297702","KQ056873v1","1417748","1418037","84","5879647"
"JH378200","7303226","7303530","KQ054191v1","3857584","3857880","75","3445642"
"JH378200","7548346","7548460","KQ058328v1","5454635","5454751","30","2093711"
"JH378200","7732904","7733038","KQ058399v1","1077489","1077625","33","6655415"
"JH378200","8007950","8008249","KQ058184v1","1505565","1505858","67","6502385"
"JH378200","8074283","8074567","KQ058094v1","7832529","7832815","74","241754"
"JH378200","8312563","8312717","KQ056147v1","2168964","2169108","36","6143599"
"JH378200","8429936","8430086","KQ057118v1","2873589","2873730","33","5556347"
"JH378201","8519503","8519723","KQ054886v1","79","289","48","8519424"
"JH378201","78181","78459","KQ053093v1","1361295","1361576","56","1283114"
"JH378201","171781","172064","KQ055014v1","2457670","2457960","69","2285889"
"JH378201","235190","235488","KQ058427v1","7552507","7552810","67","7317317"
"JH378201","238495","238766","KQ053421v1","3062266","3062539","73","2823771"
"JH378201","527284","527564","KQ054334v1","1724125","1724399","66","1196841"
"JH378201","604286","604595","KQ052969v1","9116808","9117108","63","8512522"
"JH378201","665696","665962","KQ055055v1","1882469","1882726","65","1216773"
"JH378201","791294","791398","KQ053157v1","203721","203827","26","587573"
"JH378201","849362","849653","KQ058550v1","2005568","2005863","52","1156206"
"JH378201","863291","863574","KQ054565v1","836477","836767","64","26814"
"JH378201","882949","883130","KQ055425v1","1445594","1445758","44","562645"
"JH378201","953509","953811","KQ054786v1","934497","934799","67","19012"
"JH378201","1026596","1026897","KQ056613v1","654151","654445","79","372445"
"JH378201","1143554","1143700","KQ058281v1","1664150","1664292","22","520596"
"JH378201","1145532","1145835","KQ055872v1","1927794","1928087","75","782262"
"JH378201","1292125","1292441","KQ053554v1","2471177","2471484","76","1179052"
"JH378201","1333904","1334186","KQ057570v1","917234","917514","66","416670"
"JH378201","1427471","1427767","KQ055852v1","1231373","1231668","69","196098"
"JH378201","1497256","1497570","KQ055119v1","2003090","2003396","70","505834"
"JH378201","1663910","1664070","KQ053157v1","5478543","5478695","38","3814633"
"JH378201","1837445","1837608","KQ053520v1","4624897","4625059","43","2787452"
"JH378201","2042966","2043253","KQ053332v1","127947","128230","80","1915019"
"JH378201","2102990","2103264","KQ056331v1","106636","106916","72","1996354"
"JH378201","2128135","2128448","KQ057471v1","479322","479624","66","1648813"
"JH378201","2176664","2176936","KQ058004v1","4701579","4701856","65","2524915"
"JH378201","2318958","2319231","KQ052968v1","13260777","13261056","62","10941819"
"JH378201","2349974","2350258","KQ057821v1","3853838","3854117","68","1503864"
"JH378201","2566812","2567100","KQ058199v1","498772","499079","79","2068040"
"JH378201","2715086","2715189","KQ053256v1","5132292","5132396","20","2417206"
"JH378201","2805949","2806076","KQ058328v1","2150165","2150287","32","655784"
"JH378201","3252970","3253268","KQ054725v1","2218271","2218569","65","1034699"
"JH378201","3277912","3278213","KQ053476v1","3959355","3959665","72","681443"
"JH378201","3402402","3402656","KQ053310v1","2851403","2851646","76","550999"
"JH378201","3427960","3428246","KQ058275v1","201680","201968","83","3226280"
"JH378201","3497205","3497354","KQ053476v1","4635198","4635357","45","1137993"
"JH378201","3498057","3498188","KQ055192v1","1759958","1760089","27","1738099"
"JH378201","3531250","3531540","KQ056855v1","6324027","6324312","74","2792777"
"JH378201","3595211","3595529","KQ053795v1","1729459","1729773","64","1865752"
"JH378201","4516141","4516367","KQ055978v1","4693349","4693586","68","177208"
"JH378201","4566190","4566279","KQ052969v1","3623516","3623606","31","942674"
"JH378201","4677720","4678021","KQ056928v1","1915686","1915996","84","2762034"
"JH378201","4853772","4854053","KQ057471v1","475360","475647","66","4378412"
"JH378201","4978837","4979079","KQ052982v1","3633817","3634050","66","1345020"
"JH378201","5124802","5125076","ABDC02003384v1","193955","194231","69","4930847"
"JH378201","5202734","5203055","KQ056568v1","817681","817996","81","4385053"
"JH378201","5242222","5242508","KQ058190v1","350088","350375","72","4892134"
"JH378201","5262057","5262346","KQ053146v1","1320586","1320881","72","3941471"
"JH378201","5501672","5501964","KQ053157v1","4118505","4118788","71","1383167"
"JH378201","5623889","5624192","KQ054401v1","3412791","3413099","74","2211098"
"JH378201","5723065","5723445","KQ058438v1","724583","724886","157","4998482"
"JH378201","5755711","5755991","KQ056643v1","159950","160228","59","5595761"
"JH378201","5837377","5837686","KQ053343v1","1747702","1748011","73","4089675"
"JH378201","5946640","5946958","KQ058272v1","4942871","4943179","73","1003769"
"JH378201","6061147","6061298","KQ052970v1","10856401","10856550","36","4795254"
"JH378201","6061785","6061897","KQ053299v1","16386218","16386314","36","10324433"
"JH378201","6175027","6175295","KQ058328v1","6007709","6007975","78","167318"
"JH378201","6323467","6323771","KQ053620v1","156684","156991","73","6166783"
"JH378201","6827434","6827742","KQ053476v1","1823610","1823912","77","5003824"
"JH378201","6932353","6932568","KQ053190v1","1461591","1461816","57","5470762"
"JH378201","6956303","6956593","KQ053432v1","5326013","5326296","73","1630290"
"JH378201","7183653","7183948","KQ057108v1","2064599","2064896","65","5119054"
"JH378201","7250134","7250347","KQ056024v1","1408204","1408411","51","5841930"
"JH378201","7401590","7401744","KQ054412v1","2185013","2185160","34","5216577"
"JH378201","7403745","7403864","KQ054921v1","165725","165837","26","7238020"
"JH378201","7419884","7420005","KQ053354v1","2718447","2718566","34","4701437"
"JH378201","7428808","7429100","KQ054933v1","4854778","4855065","65","2574030"
"JH378201","7465867","7466190","KQ053299v1","6038380","6038679","81","1427487"
"JH378201","7468097","7468400","KQ053816v1","7227022","7227323","60","241075"
"JH378201","7484621","7484930","KQ058606v1","232956","233258","59","7251665"
"JH378201","7567313","7567596","KQ053816v1","7464708","7465010","65","102605"
"JH378201","7595398","7595699","KQ054745v1","919926","920212","85","6675472"
"JH378201","7617420","7617619","KQ058561v1","565602","565807","48","7051818"
"JH378201","7626826","7626966","KQ057118v1","2873589","2873730","26","4753237"
"JH378201","7918216","7918522","KQ055097v1","1884579","1884874","63","6033637"
"JH378201","8106117","8106413","KQ053785v1","2698287","2698587","70","5407830"
"JH378201","8191979","8192253","KQ058494v1","2407274","2407542","69","5784705"
"JH378201","8249282","8249587","KQ054068v1","3341291","3341579","73","4907991"
"JH378201","8288512","8288812","KQ054826v1","11793577","11793880","59","3505065"
"JH378201","8305942","8306074","KQ053191v1","655494","655627","26","7650448"
"JH378201","8306415","8306702","KQ058184v1","1505565","1505858","67","6800850"
"JH378201","8391991","8392258","KQ058427v1","4553509","4553777","57","3838482"
"JH378201","8471658","8471957","KQ058184v1","1505565","1505858","55","6966093"
"JH378201","8497987","8498273","KQ058539v1","1700786","1701070","69","6797201"
"JH378201","8532969","8533262","KQ055087v1","1063066","1063349","68","7469903"
"JH378202","25614","25910","KQ053696v1","3248742","3249021","83","3223128"
"JH378202","1077152","1077459","KQ054213v1","780092","780393","74","297060"
"JH378202","1656095","1656368","KQ057380v1","3282069","3282354","88","1625974"
"JH378202","1672357","1672618","KQ058643v1","858469","858727","65","813888"
"JH378202","2548956","2549146","KQ052970v1","12204121","12204320","67","9655165"
"JH378202","3029210","3029490","KQ053299v1","21869448","21869738","59","18840238"
"JH378202","3299316","3299593","KQ053093v1","1361295","1361576","69","1938021"
"JH378202","3435835","3436107","KQ056773v1","122800","123057","88","3313035"
"JH378202","3510880","3511168","KQ054124v1","2442155","2442433","77","1068725"
"JH378202","3729343","3729627","KQ057118v1","2418455","2418734","74","1310888"
"JH378202","3920192","3920436","KQ055247v1","2156838","2157064","73","1763354"
"JH378202","4144209","4144500","KQ052971v1","646100","646383","83","3498109"
"JH378202","4389250","4389512","KQ054826v1","9969237","9969502","72","5579987"
"JH378202","4573544","4573711","KQ053190v1","5047993","5048157","42","474449"
"JH378202","4905958","4906219","KQ052968v1","10578958","10579232","84","5673000"
"JH378202","5241273","5241541","KQ057504v1","162767","163049","72","5078506"
"JH378202","5430074","5430315","KQ058385v1","899965","900195","69","4530109"
"JH378202","5781623","5781956","KQ054533v1","288767","289055","99","5492856"
"JH378202","5943138","5943211","KQ053883v1","3315834","3315907","26","2627304"
"JH378202","6075838","6076125","KQ052968v1","14043756","14044036","80","7967918"
"JH378203","292095","292383","KQ055787v1","925083","925374","75","632988"
"JH378203","459182","459437","KQ058394v1","3915274","3915538","75","3456092"
"JH378203","471094","471277","KQ053631v1","5619292","5619462","59","5148198"
"JH378203","580990","581282","KQ058184v1","1505565","1505858","64","924575"
"JH378203","709681","709941","KQ054510v1","5210888","5211157","66","4501207"
"JH378203","818477","818793","KQ054725v1","2090703","2091002","80","1272226"
"JH378203","819800","820116","KQ054725v1","2090703","2091002","80","1270903"
"JH378203","935374","935655","KQ053631v1","9496285","9496571","65","8560911"
"JH378203","1110878","1111093","KQ058242v1","892038","892246","44","218840"
"JH378203","1132677","1132835","KQ058183v1","4244743","4244893","39","3112066"
"JH378203","1670499","1670799","KQ053476v1","1155618","1155925","72","514881"
"JH378203","1747349","1747479","KQ053115v1","1333586","1333718","21","413763"
"JH378203","1817255","1817552","KQ055725v1","503531","503824","73","1313724"
"JH378203","1942235","1942499","KQ054069v1","7677009","7677286","76","5734774"
"JH378203","1979606","1979755","KQ053267v1","2398569","2398723","50","418963"
"JH378203","2030247","2030536","KQ053948v1","168940","169229","69","1861307"
"JH378203","2044378","2044658","KQ057380v1","2548496","2548785","63","504118"
"JH378203","2098632","2098907","KQ055035v1","4381466","4381744","76","2282834"
"JH378203","2429834","2430139","KQ057858v1","376905","377209","72","2052929"
"JH378203","2486615","2486908","KQ053299v1","4095914","4096215","69","1609299"
"JH378203","2661857","2661938","KQ057118v1","1020903","1020978","26","1640954"
"JH378203","2772596","2772827","KQ053587v1","1788518","1788751","72","984078"
"JH378203","2858833","2859113","KQ057737v1","2756211","2756494","54","102622"
"JH378203","3397896","3398043","KQ053104v1","317902","318035","51","3079994"
"JH378203","3429283","3429601","KQ058485v1","826092","826398","76","2603191"
"JH378203","3883628","3883759","KQ054218v1","2975","3106","28","3880653"
"JH378203","4056742","4057003","KQ053115v1","2180745","2181002","74","1875997"
"JH378203","4635135","4635405","KQ055662v1","4683524","4683789","78","48389"
"JH378203","4831392","4831609","KQ054026v1","1987872","1988097","76","2843520"
"JH378203","5986856","5987138","KQ054224v1","428324","428601","64","5558532"
"JH378203","6536692","6536966","KQ057603v1","1306760","1307030","63","5229932"
"JH378203","6564702","6564869","KQ053631v1","5537811","5537978","36","1026891"
"JH378203","6581606","6581897","KQ056331v1","1501968","1502262","69","5079638"
"JH378203","6691376","6691631","KQ054932v1","6362120","6362372","62","329256"
"JH378203","7108625","7108884","KQ058272v1","5539241","5539492","57","1569384"
"JH378203","7135157","7135453","KQ053816v1","7464708","7465010","62","329551"
"JH378203","7265060","7265359","KQ054713v1","702794","703080","70","6562266"
"JH378203","7273514","7273652","KQ054921v1","3001829","3001962","37","4271685"
"JH378203","7476452","7476668","KQ053959v1","3147544","3147761","53","4328908"
"JH378203","7538486","7538763","KQ055725v1","518672","518947","69","7019814"
"JH378203","7657252","7657557","KQ055987v1","77625","77928","73","7579627"
"JH378203","7700321","7700620","KQ053948v1","168940","169229","82","7531381"
"JH378203","7725666","7725970","KQ053398v1","2816605","2816914","71","4909061"
"JH378203","7760966","7761279","KQ055236v1","2049624","2049930","68","5711342"
"JH378203","7851888","7852199","KQ052969v1","7401399","7401679","82","450489"
"JH378203","7886815","7886934","KQ053498v1","2897317","2897441","29","4989498"
"JH378203","8089453","8089757","KQ058353v1","458843","459133","70","7630610"
"JH378203","8118586","8118858","KQ057909v1","585646","585918","63","7532940"
"JH378203","8122543","8122645","KQ055872v1","5141445","5141541","23","2981098"
"JH378203","8143507","8143775","KQ055173v1","452351","452623","57","7691156"
"JH378204","115825","116099","KQ053948v1","168940","169229","70","53115"
"JH378204","153369","153661","KQ055766v1","4175053","4175345","79","4021684"
"JH378204","525163","525469","KQ056345v1","621994","622295","75","96831"
"JH378204","1018643","1018810","KQ058533v1","544439","544600","43","474204"
"JH378204","1178711","1178863","KQ053190v1","2372433","2372579","39","1193722"
"JH378204","1491212","1491492","KQ054290v1","1454980","1455264","65","36232"
"JH378204","1852430","1852735","KQ057737v1","5664356","5664660","66","3811926"
"JH378204","2178444","2178719","KQ054400v1","3760476","3760752","65","1582032"
"JH378204","2293369","2293541","KQ055065v1","1265194","1265372","53","1028175"
"JH378204","2515886","2516180","KQ053476v1","3712115","3712409","64","1196229"
"JH378204","2841310","2841581","KQ053299v1","13684531","13684810","73","10843221"
"JH378204","3044208","3044316","KQ056110v1","768","870","38","3043440"
"JH378204","3044346","3044456","KQ056447v1","2874774","2874884","27","169572"
"JH378204","3137570","3137709","KQ052993v1","71964","72092","47","3065606"
"JH378204","3138731","3138995","KQ056432v1","2792307","2792574","79","346424"
"JH378204","3555342","3555598","KQ053081v1","204366","204603","80","3350976"
"JH378204","3634732","3634909","KQ056996v1","1524030","1524195","41","2110702"
"JH378204","3764080","3764357","KQ053409v1","387896","388178","88","3376184"
"JH378204","3802083","3802310","KQ055978v1","4184123","4184351","59","382040"
"JH378204","3860696","3860997","KQ054713v1","2696056","2696350","70","1164640"
"JH378204","3917811","3917945","KQ053850v1","709379","709515","21","3208432"
"JH378204","3938466","3938744","KQ054412v1","2490468","2490761","62","1447998"
"JH378204","3938759","3939035","KQ056368v1","571844","572113","58","3366915"
"JH378204","4125398","4125639","KQ053310v1","2851403","2851646","65","1273995"
"JH378204","4410553","4410816","KQ053081v1","1237660","1237932","70","3172893"
"JH378204","4463393","4463496","KQ053850v1","279389","279490","20","4184004"
"JH378204","4613793","4614095","KQ058585v1","580456","580763","65","4033337"
"JH378204","4662473","4662667","KQ053849v1","1126392","1126589","45","3536081"
"JH378204","4839445","4839718","KQ054069v1","7534905","7535183","67","2695460"
"JH378204","4848127","4848361","KQ054124v1","3269453","3269685","78","1578674"
"JH378204","4964928","4965212","KQ054510v1","8518307","8518589","65","3553379"
"JH378204","5112526","5112818","KQ058272v1","4101964","4102263","75","1010562"
"JH378204","5256203","5256501","KQ053093v1","1738898","1739201","57","3517305"
"JH378204","5486324","5486579","KQ058594v1","5720704","5720954","72","234380"
"JH378204","5717771","5717905","KQ057702v1","1862724","1862857","25","3855047"
"JH378204","5727984","5728192","KQ053741v1","1190544","1190756","59","4537440"
"JH378204","5753774","5753883","KQ054671v1","629082","629194","38","5124692"
"JH378204","5911392","5911514","KQ053948v1","2765570","2765701","29","3145822"
"JH378204","5942929","5943246","KQ053299v1","4095914","4096215","73","1847015"
"JH378204","5975743","5975900","KQ056056v1","323324","323503","47","5652419"
"JH378204","6052835","6053126","KQ055787v1","925083","925374","79","5127752"
"JH378204","6055963","6056250","KQ058190v1","350088","350375","70","5705875"
"JH378204","6109294","6109414","KQ053135v1","3445097","3445217","35","2664197"
"JH378204","6114072","6114356","KQ055610v1","1837519","1837800","67","4276553"
"JH378204","6158627","6158924","KQ058328v1","5430592","5430898","73","728035"
"JH378204","6335808","6336099","KQ058184v1","1505565","1505858","69","4830243"
"JH378204","6360100","6360409","KQ058004v1","2495177","2495491","68","3864923"
"JH378204","6598218","6598433","KQ053398v1","1712465","1712682","49","4885753"
"JH378204","6603544","6603885","KQ057909v1","6306247","6306550","111","297297"
"JH378204","6644988","6645313","KQ053432v1","4280053","4280348","105","2364935"
"JH378204","6645986","6646234","KQ053191v1","1874915","1875171","64","4771071"
"JH378204","6770987","6771295","KQ057108v1","2064599","2064896","65","4706388"
"JH378204","6974369","6974651","KQ054660v1","2994204","2994490","60","3980165"
"JH378204","7515612","7515798","KQ058293v1","993236","993409","55","6522376"
"JH378204","7551337","7551610","KQ058291v1","284522","284798","58","7266815"
"JH378204","7582897","7583056","KQ054724v1","1365958","1366108","49","6216939"
"JH378204","7583506","7583619","KQ056064v1","5128113","5128227","30","2455393"
"JH378204","7695231","7695541","KQ056331v1","1886723","1887024","70","5808508"
"JH378204","7980471","7980737","KQ054124v1","2442155","2442433","68","5538316"
"JH378204","8011324","8011618","KQ053398v1","2431232","2431537","72","5580092"
"JH378204","8013513","8013848","KQ054047v1","432706","433011","84","7580807"
"JH378204","8141839","8142036","KQ054081v1","1002095","1002297","55","7139744"
"JH378204","8167999","8168292","KQ054725v1","2218271","2218569","66","5949728"
"JH378205","244368","244500","KQ056847v1","1574956","1575077","37","1330588"
"JH378205","266881","267165","KQ053498v1","3696034","3696323","71","3429153"
"JH378205","699070","699371","KQ058184v1","1505565","1505858","55","806495"
"JH378205","856397","856628","KQ053686v1","2718006","2718245","54","1861609"
"JH378205","1094123","1094369","KQ055745v1","1992718","1992978","72","898595"
"JH378205","1248713","1248928","KQ056148v1","3131043","3131264","63","1882330"
"JH378205","1376809","1377085","KQ055203v1","1891285","1891537","81","514476"
"JH378205","1458948","1459234","KQ055479v1","2609512","2609794","72","1150564"
"JH378205","1522299","1522563","KQ056320v1","2083058","2083308","72","560759"
"JH378205","1560240","1560533","KQ053093v1","1361295","1361576","66","198945"
"JH378205","1643307","1643575","KQ058268v1","513639","513894","69","1129668"
"JH378205","1677045","1677161","KQ053905v1","1081893","1082008","30","595152"
"JH378205","1677835","1678020","KQ054510v1","2373994","2374175","49","696159"
"JH378205","1736838","1737016","KQ057649v1","424252","424417","43","1312586"
"JH378205","1811415","1811554","KQ053354v1","702320","702452","29","1109095"
"JH378205","1848390","1848531","KQ056147v1","2168964","2169108","29","320574"
"JH378205","1910813","1911117","KQ058350v1","6740286","6740580","81","4829473"
"JH378205","1945668","1945971","KQ058184v1","1505565","1505858","67","440103"
"JH378205","2043241","2043498","KQ058538v1","1444447","1444703","66","598794"
"JH378205","2061788","2062080","KQ054069v1","955693","955974","74","1106095"
"JH378205","2097587","2097861","KQ052969v1","7351818","7352090","70","5254231"
"JH378205","2178957","2179048","KQ053168v1","1574388","1574479","26","604569"
"JH378205","2221741","2221867","KQ054724v1","1366445","1366569","31","855296"
"JH378205","2256132","2256266","KQ057488v1","512192","512325","29","1743940"
"JH378205","2283017","2283314","KQ053816v1","7464708","7465010","73","5181691"
"JH378205","2451552","2451830","KQ058535v1","1032013","1032302","68","1419539"
"JH378205","2550641","2550864","KQ054135v1","1541023","1541259","56","1009618"
"JH378205","2632686","2632990","KQ054400v1","354368","354668","66","2278318"
"JH378205","2725269","2725580","KQ055852v1","1231373","1231668","70","1493896"
"JH378205","2826835","2827134","KQ054102v1","1325684","1325978","59","1501151"
"JH378205","3145355","3145670","KQ054191v1","3583730","3584032","72","438375"
"JH378205","3206717","3207011","KQ054932v1","10830322","10830609","66","7623605"
"JH378205","3268661","3268950","KQ054933v1","4854778","4855065","63","1586117"
"JH378205","3284711","3284973","KQ054868v1","2229582","2229854","68","1055129"
"JH378205","3295789","3295873","KQ056148v1","5019141","5019230","20","1723352"
"JH378205","3791546","3791749","KQ056493v1","886447","886648","54","2905099"
"JH378205","3856346","3856647","KQ053004v1","2744572","2744859","98","1111774"
"JH378205","3872050","3872354","KQ055883v1","284887","285187","67","3587163"
"JH378205","3899618","3899904","KQ055872v1","12987862","12988141","66","9088244"
"JH378205","4178677","4178962","KQ055035v1","4381466","4381744","61","202789"
"JH378205","4344685","4344816","KQ058483v1","5373223","5373356","19","1028538"
"JH378205","4367335","4367647","KQ054868v1","473451","473739","88","3893884"
"JH378205","4483961","4484098","KQ055353v1","332440","332586","27","4151521"
"JH378205","4515414","4515682","KQ054510v1","9222042","9222321","70","4706628"
"JH378205","4622517","4622815","KQ058394v1","10439289","10439587","75","5816772"
"JH378205","4737153","4737290","KQ054510v1","2354993","2355135","44","2382160"
"JH378205","4977638","4977929","KQ055735v1","667472","667747","65","4310166"
"JH378205","5054361","5054660","KQ058427v1","7552507","7552810","73","2498146"
"JH378205","5067437","5067744","KQ053774v1","416886","417189","76","4650551"
"JH378205","5068256","5068563","KQ053816v1","7464708","7465010","62","2396452"
"JH378205","5077197","5077486","KQ058427v1","11341294","11341584","63","6264097"
"JH378205","5116125","5116396","KQ053365v1","327436","327701","73","4788689"
"JH378205","5353922","5354241","KQ055457v1","2061137","2061448","73","3292785"
"JH378205","5437674","5437804","KQ054412v1","2196456","2196568","51","3241218"
"JH378205","5489307","5489524","KQ053520v1","4901250","4901462","56","588057"
"JH378205","5508164","5508473","KQ054412v1","2153220","2153505","91","3354944"
"JH378205","5669977","5670096","KQ058328v1","5358834","5358954","30","311143"
"JH378205","5716777","5716907","KQ056147v1","1828259","1828388","29","3888518"
"JH378205","5979960","5980271","KQ055787v1","1064992","1065293","66","4914968"
"JH378205","6025734","6025898","KQ057603v1","1535538","1535702","45","4490196"
"JH378205","6049481","6049773","KQ053816v1","7464708","7465010","64","1415227"
"JH378205","6159302","6159565","KQ053665v1","817341","817603","75","5341961"
"JH378205","6205216","6205339","KQ053409v1","6105325","6105446","21","99891"
"JH378205","6230201","6230447","KQ054026v1","2138432","2138679","70","4091769"
"JH378205","6233845","6234106","KQ057345v1","1938824","1939073","70","4295021"
"JH378205","6450656","6450961","KQ056855v1","2831735","2832032","94","3618921"
"JH378205","6461793","6462123","KQ056672v1","8155221","8155536","96","1693428"
"JH378205","6480194","6480473","KQ057693v1","621833","622123","64","5858361"
"JH378205","6488645","6488925","KQ055035v1","4381466","4381744","66","2107179"
"JH378205","6574214","6574521","KQ053202v1","761728","762026","80","5812486"
"JH378205","6584645","6584709","KQ053072v1","197621","197681","18","6387024"
"JH378205","6599024","6599320","KQ053115v1","1118362","1118655","64","5480662"
"JH378205","6604777","6605080","KQ052993v1","743501","743813","74","5861276"
"JH378205","6657018","6657315","KQ052968v1","9583834","9584132","64","2926816"
"JH378205","6774210","6774335","KQ056147v1","1962111","1962234","23","4812099"
"JH378205","6825480","6825793","KQ054179v1","5991896","5992209","78","833584"
"JH378205","6906774","6907083","KQ052981v1","1198440","1198752","62","5708334"
"JH378205","6917633","6917772","KQ054921v1","3001829","3001962","35","3915804"
"JH378205","6934718","6935024","KQ055787v1","1064992","1065293","67","5869726"
"JH378205","6951920","6952165","KQ057290v1","2383871","2384129","70","4568049"
"JH378205","7143309","7143522","KQ053609v1","2642121","2642332","48","4501188"
"JH378205","7164648","7164857","KQ052968v1","13131640","13131834","50","5966992"
"JH378205","7231394","7231677","KQ053146v1","2819587","2819868","63","4411807"
"JH378205","7250102","7250401","KQ058550v1","2621985","2622282","76","4628117"
"JH378205","7328467","7328743","KQ054069v1","955693","955974","69","6372774"
"JH378205","7378553","7378851","KQ054921v1","1683019","1683324","71","5695534"
"JH378205","7449967","7450248","KQ052968v1","14043756","14044036","67","6593789"
"JH378205","7480040","7480179","KQ053026v1","3592158","3592294","38","3887882"
"JH378205","7547881","7548162","KQ052968v1","10629964","10630247","73","3082083"
"JH378205","7562368","7562558","KQ058416v1","1427758","1427952","67","6134610"
"JH378205","7655689","7655969","KQ053465v1","3806004","3806288","70","3849685"
"JH378205","7876727","7877038","KQ055457v1","8422337","8422638","80","545610"
"JH378205","8031274","8031550","KQ056254v1","1300375","1300653","67","6730899"
"JH378206","11816","12068","KQ058503v1","123813","124064","59","111997"
"JH378206","13673","13960","KQ054660v1","3382052","3382330","66","3368379"
"JH378206","279931","280223","KQ054533v1","288767","289055","56","8836"
"JH378206","325545","325871","KQ053299v1","2867160","2867464","83","2541615"
"JH378206","334611","334907","KQ057648v1","78808","79100","62","255803"
"JH378206","335806","335965","KQ057649v1","424252","424417","40","88446"
"JH378206","371524","371802","KQ055872v1","3606686","3606949","80","3235162"
"JH378206","415640","415914","KQ055119v1","2973132","2973394","64","2557492"
"JH378206","573248","573543","KQ055978v1","5914999","5915296","73","5341751"
"JH378206","584880","585180","KQ056928v1","1915686","1915996","63","1330806"
"JH378206","811027","811297","KQ058173v1","1122175","1122457","72","311148"
"JH378206","961318","961597","KQ055192v1","1304874","1305155","79","343556"
"JH378206","1050699","1050830","KQ054510v1","2941967","2942098","25","1891268"
"JH378206","1181772","1181833","KQ055745v1","156965","157036","23","1024807"
"JH378206","1182462","1182569","KQ057034v1","1997084","1997205","31","814622"
"JH378206","1195547","1195811","KQ057702v1","1579642","1579892","59","384095"
"JH378206","1300742","1301025","KQ058328v1","808528","808806","57","492214"
"JH378206","1511540","1511845","KQ052968v1","7300500","7300792","66","5788960"
"JH378206","1563701","1563995","KQ058350v1","6740286","6740580","66","5176585"
"JH378206","1722166","1722465","KQ058594v1","6070669","6070969","67","4348503"
"JH378206","1794045","1794169","KQ053409v1","6105325","6105446","25","4311280"
"JH378206","1831671","1831974","KQ058305v1","2335011","2335313","71","503340"
"JH378206","1835991","1836180","KQ054179v1","1149324","1149515","52","686667"
"JH378206","1887710","1887974","KQ052970v1","9459292","9459566","69","7571582"
"JH378206","1898270","1898556","KQ058389v1","2329886","2330179","65","431616"
"JH378206","2108075","2108375","KQ058184v1","1505565","1505858","66","602510"
"JH378206","2136658","2136945","KQ054356v1","1356188","1356481","64","780470"
"JH378206","2140769","2140903","KQ054533v1","1111592","1111720","27","1029177"
"JH378206","2202933","2203284","KQ053850v1","1709487","1709792","110","493446"
"JH378206","2322689","2322772","KQ053082v1","6601560","6601653","26","4278871"
"JH378206","2373903","2374216","KQ057004v1","1231997","1232305","78","1141906"
"JH378206","2390904","2391016","KQ057118v1","3875160","3875276","26","1484256"
"JH378206","2409503","2409795","KQ054091v1","1614084","1614359","66","795419"
"JH378206","2414397","2414689","KQ053816v1","6856607","6856902","62","4442210"
"JH378206","2579434","2579717","KQ058316v1","4697990","4698273","66","2118556"
"JH378206","2693619","2693898","KQ054510v1","9842754","9843031","67","7149135"
"JH378206","2710473","2710642","KQ054533v1","1027813","1027974","41","1682660"
"JH378206","2710973","2711094","KQ056147v1","1962111","1962234","23","748862"
"JH378206","2729262","2729570","KQ058184v1","1505565","1505858","72","1223697"
"JH378206","2748894","2749188","KQ055468v1","1908448","1908731","73","840446"
"JH378206","2842210","2842342","KQ053354v1","702320","702452","29","2139890"
"JH378206","3029602","3029892","KQ052969v1","11082995","11083279","76","8053393"
"JH378206","3032394","3032660","KQ053816v1","5213784","5214044","69","2181390"
"JH378206","3038396","3038561","KQ053299v1","2787791","2787954","40","250605"
"JH378206","3084333","3084612","KQ058316v1","4984552","4984820","71","1900219"
"JH378206","3219219","3219505","KQ053146v1","2819587","2819868","66","399632"
"JH378206","3256363","3256673","KQ053521v1","2273365","2273646","86","982998"
"JH378206","3709336","3709620","KQ053654v1","346478","346752","74","3362858"
"JH378206","3805716","3805990","KQ054400v1","2059350","2059621","67","1746366"
"JH378206","3994369","3994677","KQ054725v1","2218271","2218569","81","1776098"
"JH378206","4068124","4068360","KQ055457v1","1902633","1902878","62","2165491"
"JH378206","4072902","4073215","KQ053190v1","6566399","6566709","72","2493497"
"JH378206","4180745","4181001","KQ057522v1","1670299","1670546","67","2510446"
"JH378206","4220806","4221101","KQ053959v1","3147888","3148185","84","1072918"
"JH378206","4780384","4780648","KQ058320v1","856678","856938","67","3923706"
"JH378206","4805259","4805528","KQ058183v1","4736369","4736640","78","68890"
"JH378206","5121540","5121823","KQ058272v1","3500305","3500579","68","1621235"
"JH378206","5430413","5430709","KQ058461v1","1233656","1233955","67","4196757"
"JH378206","5476724","5477025","KQ054868v1","1584588","1584882","65","3892136"
"JH378206","5478234","5478504","KQ053331v1","97381","97652","79","5380853"
"JH378206","5499792","5499909","KQ054522v1","1628214","1628331","32","3871578"
"JH378206","5705660","5705950","KQ053816v1","6856607","6856902","74","1150947"
"JH378206","5970042","5970314","KQ058275v1","938649","938919","73","5031393"
"JH378206","6271151","6271477","KQ052970v1","2531178","2531455","93","3739973"
"JH378206","6592183","6592462","KQ058383v1","5944247","5944518","68","647936"
"JH378206","6603981","6604109","KQ053409v1","6573923","6574054","24","30058"
"JH378206","6779930","6780225","KQ055777v1","2840700","2840988","69","3939230"
"JH378206","6797760","6798050","KQ053146v1","329936","330234","73","6467824"
"JH378206","6856950","6857213","KQ058374v1","497022","497284","64","6359928"
"JH378206","6955457","6955733","KQ054826v1","9895778","9896046","64","2940321"
"JH378206","7041886","7042157","KQ058004v1","2612564","2612826","67","4429322"
"JH378206","7237684","7237788","KQ057883v1","26280","26392","31","7211404"
"JH378206","7241674","7241802","KQ055404v1","2665938","2666066","30","4575736"
"JH378206","7311834","7311965","KQ054932v1","5190304","5190436","27","2121530"
"JH378206","7322033","7322311","KQ058594v1","1719198","1719477","73","5602835"
"JH378206","7454992","7455227","KQ057821v1","5073835","5074072","61","2381157"
"JH378206","7489030","7489345","KQ053554v1","2471177","2471484","70","5017853"
"JH378206","7492128","7492428","KQ056790v1","446564","446855","61","7045564"
"JH378206","7553939","7554235","KQ053816v1","7327018","7327317","60","226921"
"JH378206","7560219","7560487","KQ058577v1","227999","228256","76","7332220"
"JH378206","7686852","7687148","KQ057205v1","1097243","1097539","67","6589609"
"JH378206","7957825","7957954","KQ053948v1","1299259","1299390","25","6658566"
"JH378206","7958413","7958483","KQ053299v1","3013663","3013729","16","4944750"
"JH378207","1172193","1172438","KQ055978v1","4693349","4693586","78","3521156"
"JH378207","2262140","2262446","KQ053387v1","1739791","1740089","81","522349"
"JH378207","2960093","2960254","KQ055872v1","5870772","5870928","37","2910679"
"JH378207","3068793","3069078","KQ056147v1","152442","152732","73","2916351"
"JH378207","3101784","3102081","KQ058473v1","369163","369455","66","2732621"
"JH378207","3220124","3220374","KQ053387v1","564882","565122","66","2655242"
"JH378207","3446967","3447276","KQ058585v1","580456","580763","58","2866511"
"JH378207","4025348","4025581","KQ054069v1","159011","159235","59","3866337"
"JH378207","4069854","4070130","KQ058291v1","474599","474881","70","3595255"
"JH378207","4229012","4229281","KQ053299v1","22323868","22324139","67","18094856"
"JH378207","4529263","4529394","KQ052970v1","11857903","11858038","29","7328640"
"JH378207","5490331","5490470","KQ054510v1","8179279","8179421","35","2688948"
"JH378207","5938267","5938555","KQ052968v1","6282633","6282918","70","344366"
"JH378207","6189511","6189806","KQ053093v1","1361295","1361576","76","4828216"
"JH378207","6202134","6202442","KQ056345v1","621994","622295","74","5580140"
"JH378207","6323450","6323719","KQ052970v1","4138682","4138959","66","2184768"
"JH378207","6487994","6488164","KQ056475v1","5275769","5275928","48","1212225"
"JH378207","6716446","6716735","KQ057045v1","590946","591241","66","6125500"
"JH378207","6813815","6813943","KQ055957v1","554477","554608","28","6259338"
"JH378207","7153820","7154122","KQ053299v1","2867160","2867464","73","4286660"
"JH378207","7179641","7179943","KQ057737v1","5059854","5060155","72","2119787"
"JH378207","7200533","7200850","KQ055717v1","1448724","1449037","65","5751809"
"JH378207","7203129","7203403","KQ058483v1","2943412","2943683","84","4259717"
"JH378207","7342611","7342876","KQ057603v1","1306760","1307030","63","6035851"
"JH378207","7394116","7394392","KQ058505v1","6856388","6856672","66","537728"
"JH378207","7497245","7497519","KQ058427v1","4553509","4553777","71","2943736"
"JH378207","7516202","7516470","KQ056147v1","1747366","1747648","70","5768836"
"JH378207","7759968","7760116","KQ053146v1","2315136","2315281","32","5444832"
"JH378207","7797004","7797081","KQ058325v1","894348","894422","20","6902656"
"JH378207","7823867","7824167","KQ055404v1","2891185","2891468","64","4932682"
"JH378207","7948295","7948594","KQ054868v1","556852","557160","63","7391443"
"JH378208","1017379","1017660","KQ053059v1","2112049","2112344","72","1094670"
"JH378208","1188776","1189046","KQ057909v1","13232153","13232424","66","12043377"
"JH378208","1198368","1198633","KQ058350v1","1674136","1674403","76","475768"
"JH378208","1263219","1263482","KQ057290v1","2383871","2384129","73","1120652"
"JH378208","1428958","1429231","KQ058383v1","5122379","5122654","75","3693421"
"JH378208","1464177","1464341","KQ054533v1","1027813","1027974","45","436364"
"JH378208","1507931","1508240","KQ055830v1","814565","814880","64","693366"
"JH378208","1547901","1548202","KQ055352v1","272395","272688","72","1275506"
"JH378208","1566429","1566590","KQ053004v1","4759784","4759947","37","3193355"
"JH378208","1689777","1690006","KQ053398v1","3158290","3158500","64","1468513"
"JH378208","1999023","1999291","KQ055173v1","248885","249169","77","1750138"
"JH378208","2099960","2100213","KQ055331v1","559095","559355","63","1540865"
"JH378208","2169207","2169503","KQ058328v1","4012912","4013206","66","1843705"
"JH378208","2330665","2330933","KQ055662v1","4683524","4683789","74","2352859"
"JH378208","2360723","2361024","KQ054693v1","832788","833076","67","1527935"
"JH378208","2403771","2403983","KQ054827v1","2292729","2292949","60","111042"
"JH378208","2488164","2488449","KQ053190v1","4987885","4988162","69","2499721"
"JH378208","2795485","2795758","KQ052970v1","6659487","6659775","66","3864002"
"JH378208","2799254","2799540","KQ056440v1","666502","666774","79","2132752"
"JH378208","2936242","2936382","KQ053643v1","1401609","1401754","36","1534633"
"JH378208","3134611","3134733","KQ053409v1","6105325","6105446","28","2970714"
"JH378208","3516278","3516560","KQ055777v1","2252512","2252796","80","1263766"
"JH378208","4172050","4172349","KQ053554v1","1157184","1157483","60","3014866"
"JH378208","4896963","4897233","KQ054068v1","2155045","2155315","67","2741918"
"JH378208","5224917","5225212","KQ056440v1","1002303","1002600","80","4222614"
"JH378208","5912204","5912508","KQ057118v1","4601602","4601894","73","1310602"
"JH378208","6001427","6001760","KQ055490v1","3912093","3912400","89","2089334"
"JH378208","6076972","6077103","KQ053565v1","1793162","1793293","28","4283810"
"JH378208","6148036","6148335","KQ055247v1","4445738","4446031","61","1702298"
"JH378208","6288824","6289093","KQ055404v1","2451649","2451919","68","3837175"
"JH378208","6360277","6360575","KQ057151v1","1087366","1087668","64","5272911"
"JH378208","6363311","6363547","KQ053966v1","301124","301319","84","6062187"
"JH378208","6388177","6388327","KQ054533v1","1027813","1027974","38","5360364"
"JH378208","6388435","6388559","KQ053609v1","1892948","1893072","24","4495487"
"JH378208","6538082","6538389","KQ056044v1","2538771","2539068","72","3999311"
"JH378208","6655066","6655346","KQ053146v1","2848155","2848435","73","3806911"
"JH378208","6873434","6873706","KQ055065v1","1117201","1117481","71","5756233"
"JH378208","7344710","7345012","KQ053082v1","1687672","1687961","81","5657038"
"JH378209","531925","532110","KQ057673v1","2220920","2221103","51","1688995"
"JH378209","544046","544181","KQ055755v1","801738","801870","29","257692"
"JH378209","893315","893611","KQ052969v1","8915694","8915990","78","8022379"
"JH378209","1028548","1028889","KQ058304v1","1283332","1283644","94","254784"
"JH378209","1081229","1081386","KQ053135v1","3353675","3353825","37","2272446"
"JH378209","1163275","1163596","KQ058583v1","3101722","3102049","71","1938447"
"JH378209","2527236","2527520","KQ057423v1","1145168","1145450","75","1382068"
"JH378209","2962036","2962335","KQ058405v1","1120230","1120530","68","1841806"
"JH378209","3256330","3256467","KQ055097v1","2255144","2255272","31","1001186"
"JH378209","3746516","3746797","KQ053146v1","2819587","2819868","72","926929"
"JH378209","4071203","4071335","KQ054069v1","4083160","4083297","31","11957"
"JH378209","4275091","4275360","KQ055065v1","1117201","1117481","67","3157890"
"JH378209","4548489","4548641","KQ058427v1","3400358","3400512","37","1148131"
"JH378209","4898134","4898405","KQ053093v1","1564186","1564460","68","3333948"
"JH378209","5258200","5258437","KQ053026v1","2213601","2213834","71","3044599"
"JH378209","5915981","5916274","KQ057788v1","561223","561518","58","5354758"
"JH378209","5979618","5979908","KQ053398v1","2545768","2546067","61","3433850"
"JH378209","6098600","6098760","KQ057737v1","1426090","1426247","47","4672510"
"JH378209","6119446","6119748","KQ052969v1","9116808","9117108","64","2997362"
"JH378209","6134761","6135065","KQ055097v1","1567802","1568097","63","4566959"
"JH378209","6249678","6249990","KQ053332v1","771022","771332","87","5478656"
"JH378209","6348689","6348986","KQ053520v1","2517282","2517587","80","3831407"
"JH378209","6804102","6804215","KQ053971v1","4103392","4103508","27","2700710"
"JH378209","6804241","6804321","KQ055036v1","4936704","4936788","24","1867537"
"JH378209","6836426","6836563","KQ058589v1","240412","240547","41","6596014"
"JH378209","7090738","7091021","KQ052970v1","8520800","8521088","76","1430062"
"JH378209","7155481","7155768","KQ058594v1","5863745","5864030","75","1291736"
"JH378209","7297120","7297398","KQ055735v1","667472","667747","74","6629648"
"JH378210","59253","59490","KQ054124v1","147406","147625","83","88153"
"JH378210","366144","366426","KQ053959v1","2268166","2268455","71","1902022"
"JH378210","417703","417812","KQ055663v1","2359440","2359549","26","1941737"
"JH378210","590456","590753","KQ055352v1","13451535","13451828","83","12861079"
"JH378210","593736","594000","KQ053982v1","5797999","5798259","66","5204263"
"JH378210","1179075","1179388","KQ057693v1","117172","117472","91","1061903"
"JH378210","1460784","1461085","KQ057560v1","2450216","2450512","80","989432"
"JH378210","1778462","1778616","KQ053565v1","1922532","1922687","42","144070"
"JH378210","1806929","1807048","KQ054932v1","7772773","7772892","30","5965844"
"JH378210","1807588","1807755","KQ053004v1","4759784","4759947","38","2952196"
"JH378210","2038340","2038628","KQ053297v1","44026","44315","70","1994314"
"JH378210","2518569","2518792","KQ057910v1","2769076","2769295","72","250507"
"JH378210","2916662","2916883","KQ055651v1","4351956","4352174","60","1435294"
"JH378210","4026908","4027220","KQ054525v1","45769","46078","76","3981139"
"JH378210","4094019","4094302","KQ053631v1","9116387","9116675","72","5022368"
"JH378210","4147516","4147795","KQ058625v1","340677","340961","69","3806839"
"JH378210","4416686","4416857","KQ057909v1","2188179","2188344","43","2228507"
"JH378210","5343376","5343648","KQ054713v1","3140905","3141166","79","2202471"
"JH378210","5572494","5572763","KQ055872v1","2360857","2361124","69","3211637"
"JH378210","5892111","5892386","KQ055140v1","3423560","3423842","77","2468551"
"JH378210","6131432","6131624","KQ055014v1","2321535","2321726","58","3809897"
"JH378210","6347000","6347277","KQ056568v1","744517","744792","78","5602483"
"JH378210","6397409","6397708","KQ056790v1","446564","446855","68","5950845"
"JH378210","6421564","6421841","KQ056166v1","957045","957330","58","5464519"
"JH378210","6711609","6711915","KQ055468v1","2950644","2950940","69","3760965"
"JH378210","6851201","6851422","KQ058334v1","131921","132137","63","6719280"
"JH378210","7029835","7029977","KQ058199v1","1560557","1560686","29","5469278"
"JH378210","7042986","7043297","KQ053343v1","1747702","1748011","65","5295284"
"JH378210","7212949","7213119","KQ053827v1","4556306","4556473","40","2656643"
"JH378211","145880","146163","KQ058184v1","1505565","1505858","75","1359685"
"JH378211","368012","368263","KQ055331v1","476282","476544","73","108270"
"JH378211","741933","742195","KQ052969v1","11182978","11183250","67","10441045"
"JH378211","1146126","1146434","KQ055457v1","9231252","9231546","83","8085126"
"JH378211","1493714","1494007","KQ055087v1","1145575","1145867","66","348139"
"JH378211","1858342","1858653","KQ053816v1","7464708","7465010","77","5606366"
"JH378211","1977687","1978023","KQ055787v1","694393","694708","78","1283294"
"JH378211","2252960","2253274","KQ057693v1","621833","622123","74","1631127"
"JH378211","2347014","2347347","KQ054510v1","1767978","1768276","101","579036"
"JH378211","2487396","2487597","KQ055384v1","1506430","1506619","64","980966"
"JH378211","2689342","2689632","KQ053520v1","456408","456696","75","2232934"
"JH378211","2732083","2732378","KQ055852v1","1231373","1231668","77","1500710"
"JH378211","3185743","3186030","KQ052982v1","1103561","1103855","63","2082182"
"JH378211","3324767","3325027","KQ053093v1","1564186","1564460","71","1760581"
"JH378211","3527664","3527855","KQ053190v1","4183682","4183869","64","656018"
"JH378211","4247990","4248204","KQ058383v1","8692134","8692359","62","4444144"
"JH378211","4292849","4293138","KQ053081v1","2760355","2760643","68","1532494"
"JH378211","4546805","4546941","KQ053070v1","1907974","1908104","42","2638831"
"JH378211","4558677","4558861","KQ058427v1","6736144","6736323","58","2177467"
"JH378211","4653371","4653494","KQ053835v1","409491","409618","32","4243880"
"JH378211","4653695","4653767","KQ053520v1","3803739","3803813","24","849956"
"JH378211","5029579","5029696","KQ058483v1","4711310","4711430","30","318269"
"JH378211","5323116","5323359","KQ053202v1","902785","903041","80","4420331"
"JH378211","5519543","5519836","KQ053299v1","21869448","21869738","74","16349905"
"JH378211","5619059","5619397","KQ058316v1","3835362","3835700","98","1783697"
"JH378211","5677388","5677637","KQ055518v1","2146788","2147072","74","3530600"
"JH378211","5752018","5752202","KQ058550v1","1375153","1375330","56","4376865"
"JH378211","6080797","6080908","KQ058272v1","1922226","1922341","27","4158571"
"JH378211","6632943","6633202","KQ055203v1","1891285","1891537","70","4741658"
"JH378211","6745169","6745467","KQ053785v1","767236","767521","69","5977933"
"JH378211","6793007","6793278","KQ054565v1","6587941","6588226","78","205066"
"JH378211","6894278","6894436","KQ058433v1","381762","381914","41","6512516"
"JH378211","7407665","7407952","KQ055140v1","2748912","2749194","55","4658753"
"JH378211","7439967","7440241","KQ052969v1","7351818","7352090","58","88149"
"JH378211","7444479","7444761","KQ058287v1","778590","778873","71","6665889"
"JH378212","45280","45422","KQ053982v1","3934263","3934401","31","3888983"
"JH378212","429693","429781","KQ053432v1","5774004","5774087","23","5344311"
"JH378212","436809","436950","KQ053387v1","1356680","1356822","39","919871"
"JH378212","598554","598688","KQ053565v1","1793162","1793293","32","1194608"
"JH378212","662724","663024","KQ053554v1","1157184","1157483","67","494460"
"JH378212","1085824","1086031","KQ055490v1","27634","27846","46","1058190"
"JH378212","1444828","1445121","KQ058184v1","1505565","1505858","80","60737"
"JH378212","1454822","1455141","KQ056108v1","1110776","1111092","82","344046"
"JH378212","1486034","1486165","KQ053948v1","2765570","2765701","22","1279536"
"JH378212","1534638","1534920","KQ052968v1","13260777","13261056","61","11726139"
"JH378212","1752549","1752823","KQ053331v1","433337","433605","72","1319212"
"JH378212","1755929","1756237","KQ057449v1","2137704","2138005","72","381775"
"JH378212","1779493","1779685","KQ054510v1","1448917","1449101","43","330576"
"JH378212","1940323","1940629","KQ057693v1","117172","117472","66","1823151"
"JH378212","2016635","2016784","KQ053037v1","3255963","3256108","35","1239328"
"JH378212","2176985","2177117","KQ057488v1","512192","512325","24","1664793"
"JH378212","2255470","2255742","KQ054868v1","2229582","2229854","68","25888"
"JH378212","2400388","2400671","KQ052981v1","658787","659079","75","1741601"
"JH378212","2416018","2416148","KQ053432v1","3920706","3920835","27","1504688"
"JH378212","2949755","2949906","KQ054196v1","237","387","33","2949518"
"JH378212","2958705","2958881","KQ054725v1","735942","736116","38","2222763"
"JH378212","3106328","3106640","KQ058290v1","511568","511873","79","2594760"
"JH378212","3819626","3819853","KQ057909v1","12196801","12197037","59","8377175"
"JH378212","4041330","4041617","KQ055468v1","1908448","1908731","72","2132882"
"JH378212","4186826","4187098","KQ054868v1","2229582","2229854","71","1957244"
"JH378212","4331725","4332014","KQ055663v1","1737755","1738038","70","2593970"
"JH378212","4436099","4436370","KQ052969v1","8828499","8828765","62","4392400"
"JH378212","4640934","4641088","KQ055872v1","9395394","9395552","42","4754460"
"JH378212","4642667","4642935","KQ055173v1","248885","249169","86","4393782"
"JH378212","4800739","4800893","KQ055872v1","14332561","14332707","45","9531822"
"JH378212","4863695","4863990","KQ058184v1","1505565","1505858","61","3358130"
"JH378212","4916340","4916645","KQ057108v1","2064599","2064896","77","2851741"
"JH378212","4955754","4955932","KQ055662v1","122750","122928","43","4833004"
"JH378212","5092242","5092518","KQ057909v1","3737795","3738073","74","1354447"
"JH378212","5443274","5443546","KQ058389v1","1354781","1355045","72","4088493"
"JH378212","5446763","5446964","KQ053398v1","3158290","3158500","43","2288473"
"JH378212","5606717","5607007","KQ054069v1","7026364","7026639","75","1419647"
"JH378212","5660191","5660388","KQ057290v1","4745481","4745684","52","914710"
"JH378212","5683659","5683982","KQ058427v1","2121255","2121558","85","3562404"
"JH378212","5697906","5698198","KQ053631v1","7288314","7288608","77","1590408"
"JH378212","5804660","5804968","KQ058184v1","1505565","1505858","57","4299095"
"JH378212","6344501","6344773","KQ053959v1","6189151","6189431","64","155350"
"JH378212","7194846","7195064","KQ054069v1","159011","159235","49","7035835"
"JH378212","7251109","7251265","KQ058339v1","1288900","1289062","32","5962209"
"JH378213","49062","49241","KQ054725v1","735942","736116","48","686880"
"JH378213","49287","49411","KQ057118v1","3875160","3875276","35","3825873"
"JH378213","55807","55881","KQ057317v1","272227","272303","19","216420"
"JH378213","256615","256906","KQ056147v1","236639","236927","73","19976"
"JH378213","409443","409568","KQ053409v1","6105325","6105446","33","5695882"
"JH378213","484985","485103","KQ053409v1","6105325","6105446","28","5620340"
"JH378213","832057","832324","KQ054301v1","3391378","3391638","74","2559321"
"JH378213","1128480","1128614","KQ057036v1","663657","663784","38","464823"
"JH378213","1169347","1169580","KQ058250v1","905623","905852","78","263724"
"JH378213","1229699","1229839","KQ055384v1","843998","844147","39","385701"
"JH378213","1274886","1275232","KQ057404v1","1158393","1158741","110","116493"
"JH378213","1298821","1299114","KQ054857v1","921177","921473","64","377644"
"JH378213","1335117","1335394","KQ053299v1","21375969","21376245","71","20040852"
"JH378213","1368451","1368716","KQ054289v1","4355551","4355817","66","2987100"
"JH378213","1512132","1512459","KQ053631v1","7288314","7288608","92","5776182"
"JH378213","1516506","1516634","KQ053135v1","3445097","3445217","30","1928591"
"JH378213","1603626","1603903","KQ052970v1","11867674","11867953","59","10264048"
"JH378213","1643941","1644139","KQ054964v1","2260574","2260761","45","616633"
"JH378213","1645827","1646001","KQ057036v1","1270725","1270889","43","375102"
"JH378213","1646695","1646964","KQ058427v1","4553509","4553777","70","2906814"
"JH378213","1708570","1708701","KQ053409v1","6105325","6105446","25","4396755"
"JH378213","2050919","2051029","KQ053675v1","1335502","1335608","31","715417"
"JH378213","2104247","2104387","KQ053115v1","1650505","1650644","28","453742"
"JH378213","2122213","2122322","KQ053850v1","279389","279490","30","1842824"
"JH378213","2587318","2587646","KQ053631v1","10562647","10562982","90","7975329"
"JH378213","2615327","2615465","KQ053850v1","709379","709515","24","1905948"
"JH378213","2675375","2675511","KQ055518v1","2390890","2391006","48","284485"
"JH378213","2805635","2805954","KQ058184v1","1505565","1505858","72","1300070"
"JH378213","3008952","3009226","KQ053631v1","6939636","6939913","71","3930684"
"JH378213","3262898","3263171","KQ053454v1","649600","649875","64","2613298"
"JH378213","3447062","3447364","KQ052969v1","9116808","9117108","65","5669746"
"JH378213","3561639","3561795","KQ054587v1","989182","989330","45","2572457"
"JH378213","3853285","3853580","KQ052981v1","658787","659079","62","3194498"
"JH378213","3856852","3857126","KQ057693v1","621833","622123","69","3235019"
"JH378213","3868639","3868815","KQ053685v1","16639","16818","36","3852000"
"JH378213","4133974","4134209","KQ054069v1","928440","928688","69","3205534"
"JH378213","4407231","4407503","KQ053752v1","35796","36072","81","4371435"
"JH378213","4434680","4434966","KQ053763v1","3936916","3937207","70","497764"
"JH378213","4518398","4518537","KQ058427v1","10837136","10837285","46","6318738"
"JH378213","4625475","4625773","KQ053554v1","1157184","1157483","68","3468291"
"JH378213","4693678","4693837","KQ056672v1","6452016","6452164","42","1758338"
"JH378213","4821299","4821415","KQ058350v1","1062787","1062904","17","3758512"
"JH378213","4821647","4821791","KQ053498v1","3548759","3548906","35","1272888"
"JH378213","4836297","4836553","KQ053795v1","121444","121694","56","4714853"
"JH378213","4948278","4948585","KQ056790v1","446564","446855","71","4501714"
"JH378213","5015938","5016048","KQ055014v1","823836","823944","22","4192102"
"JH378213","5017775","5018091","KQ055662v1","1145336","1145647","72","3872439"
"JH378213","5038226","5038363","KQ053300v1","3146249","3146389","28","1891977"
"JH378213","5177310","5177555","KQ052969v1","1030266","1030512","71","4147044"
"JH378213","5279539","5279843","KQ053190v1","1690950","1691254","61","3588589"
"JH378213","5455806","5456030","KQ054069v1","159011","159235","63","5296795"
"JH378213","5607803","5608140","KQ057345v1","1486494","1486811","84","4121309"
"JH378213","5631424","5631717","KQ058316v1","4697990","4698273","67","933434"
"JH378213","5637826","5637980","KQ058433v1","381762","381914","50","5256064"
"JH378213","5638807","5638882","KQ052968v1","6651946","6652022","22","1013139"
"JH378213","5764251","5764544","KQ053332v1","447571","447853","71","5316680"
"JH378213","6205803","6205969","KQ056996v1","1524030","1524195","46","4681773"
"JH378213","6210921","6211214","KQ055097v1","1884579","1884874","64","4326342"
"JH378213","6380547","6380857","KQ058184v1","1505565","1505858","77","4874982"
"JH378213","6518303","6518447","KQ052970v1","10419372","10419512","32","3901069"
"JH378213","6531839","6532133","KQ058184v1","1505565","1505858","61","5026274"
"JH378213","6546494","6546773","KQ054334v1","1724125","1724399","64","4822369"
"JH378213","6588808","6589093","KQ058503v1","123813","124064","96","6464995"
"JH378213","6611059","6611221","KQ055725v1","994366","994530","52","5616693"
"JH378213","6622346","6622413","KQ053072v1","197621","197681","18","6424725"
"JH378213","6795762","6795951","KQ058383v1","5151347","5151550","54","1644415"
"JH378213","6804201","6804329","KQ053004v1","3051555","3051691","32","3752646"
"JH378213","6915984","6916116","KQ054179v1","3927334","3927468","19","2988650"
"JH378213","6919786","6920023","KQ057213v1","475202","475423","42","6444584"
"JH378213","7070678","7070847","KQ054345v1","3389802","3389968","47","3680876"
"JH378213","7104023","7104295","KQ054334v1","1724125","1724399","64","5379898"
"JH378213","7200445","7200639","KQ057118v1","1514671","1514851","41","5685774"
"JH378213","7248652","7248791","KQ053631v1","8603317","8603457","31","1354665"
"JH378213","7249805","7250018","KQ058242v1","892038","892246","44","6357767"
"JH378213","7339885","7340027","KQ057118v1","2873589","2873730","37","4466296"
"JH378214","214289","214578","KQ056475v1","2179070","2179363","65","1964781"
"JH378214","235050","235337","KQ052968v1","13260777","13261056","70","13025727"
"JH378214","283179","283443","KQ055893v1","2015012","2015285","76","1731833"
"JH378214","301815","301902","KQ053740v1","2301575","2301661","20","1999760"
"JH378214","506463","506762","KQ058184v1","1505565","1505858","72","999102"
"JH378214","969711","970029","KQ058313v1","2020900","2021211","68","1051189"
"JH378214","1114860","1115182","KQ052969v1","9116808","9117108","76","8001948"
"JH378214","1474646","1474773","KQ053565v1","1793162","1793293","29","318516"
"JH378214","1714710","1714976","KQ056331v1","106636","106916","80","1608074"
"JH378214","2203851","2204153","KQ054921v1","3166511","3166802","58","962660"
"JH378214","2248054","2248345","KQ058561v1","4466656","4466945","62","2218602"
"JH378214","2248895","2249197","KQ052969v1","9116808","9117108","68","6867913"
"JH378214","2279688","2279998","KQ057664v1","556486","556781","72","1723202"
"JH378214","2290975","2291091","KQ058542v1","469843","469958","24","1821132"
"JH378214","2667884","2668126","KQ052971v1","6441372","6441626","63","3773488"
"JH378214","3739802","3739954","KQ057440v1","384538","384683","43","3355264"
"JH378214","3838282","3838425","KQ058094v1","3687022","3687155","25","151260"
"JH378214","3947242","3947536","KQ054146v1","2481896","2482193","87","1465346"
"JH378214","4056654","4056934","KQ055036v1","1971125","1971407","84","2085529"
"JH378214","4794330","4794458","KQ053948v1","2765570","2765701","25","2028760"
"JH378214","5049202","5049530","KQ058328v1","5430592","5430898","78","381390"
"JH378214","5820740","5820966","KQ054815v1","2805831","2806062","65","3014909"
"JH378214","6808410","6808684","KQ057603v1","1306760","1307030","73","5501650"
"JH378214","6827306","6827614","KQ055852v1","1231373","1231668","61","5595933"
"JH378214","7183197","7183491","KQ056493v1","5258905","5259181","88","1924292"
"JH378214","7203389","7203676","KQ054510v1","8555095","8555387","61","1351706"
"JH378214","7320464","7320704","KQ053894v1","1236287","1236536","82","6084177"
"JH378215","6013","6179","KQ055479v1","2601433","2601611","47","2595420"
"JH378215","887734","887872","KQ056320v1","2323247","2323381","41","1435513"
"JH378215","2211035","2211188","KQ053135v1","3353675","3353825","54","1142640"
"JH378215","2296884","2296986","KQ054214v1","95","191","31","2296789"
"JH378215","2849929","2850225","KQ057205v1","1174433","1174713","68","1675496"
"JH378215","3767478","3767841","KQ056597v1","1349148","1349504","129","2418330"
"JH378215","5017464","5017765","KQ055140v1","3362733","3363019","72","1654731"
"JH378215","6236452","6236751","KQ053763v1","4831173","4831481","80","1405279"
"JH378216","31278","31573","KQ053299v1","21835674","21835971","61","21804396"
"JH378216","43141","43276","KQ056148v1","3513045","3513172","30","3469904"
"JH378216","65159","65298","KQ054533v1","2564884","2565016","27","2499725"
"JH378216","153334","153591","KQ053520v1","2840509","2840769","72","2687175"
"JH378216","293045","293326","KQ053498v1","169879","170149","76","123166"
"JH378216","309271","309560","KQ058272v1","76837","77137","73","232434"
"JH378216","312127","312436","KQ054525v1","45769","46078","62","266358"
"JH378216","329520","329780","KQ053849v1","2000206","2000452","67","1670686"
"JH378216","331510","331820","KQ058272v1","4942871","4943179","64","4611361"
"JH378216","403035","403289","KQ057488v1","132259","132504","62","270776"
"JH378216","507196","507332","KQ053070v1","2490401","2490534","28","1983205"
"JH378216","553585","553887","KQ058184v1","1505565","1505858","68","951980"
"JH378216","583675","583966","KQ053718v1","2672992","2673290","63","2089317"
"JH378216","613352","613649","KQ055777v1","2840700","2840988","77","2227348"
"JH378216","682682","682867","KQ057673v1","2220920","2221103","46","1538238"
"JH378216","683017","683120","KQ058050v1","918290","918400","23","235273"
"JH378216","819579","819857","KQ055662v1","4683524","4683789","55","3863945"
"JH378216","851103","851375","KQ052968v1","14043756","14044036","72","13192653"
"JH378216","855913","856187","KQ053654v1","3819217","3819495","68","2963304"
"JH378216","935763","936062","KQ056293v1","1792862","1793157","60","857099"
"JH378216","966769","967039","KQ054868v1","2229582","2229854","75","1262813"
"JH378216","1004361","1004622","KQ056475v1","5043413","5043676","69","4039052"
"JH378216","1066008","1066149","KQ052970v1","9107596","9107736","27","8041588"
"JH378216","1279860","1279999","KQ053190v1","2372433","2372579","36","1092573"
"JH378216","1285626","1285880","KQ057702v1","1579642","1579892","61","294016"
"JH378216","1426537","1426827","KQ054745v1","919926","920212","71","506611"
"JH378216","1458173","1458298","KQ054682v1","1410308","1410435","25","47865"
"JH378216","1479907","1480040","KQ054113v1","1506620","1506744","38","26713"
"JH378216","1509199","1509356","KQ056148v1","7050287","7050441","38","5541088"
"JH378216","1781220","1781350","KQ052993v1","71964","72092","35","1709256"
"JH378216","1781804","1781912","KQ053310v1","1622751","1622859","29","159053"
"JH378216","1900097","1900380","KQ057911v1","428931","429228","61","1471166"
"JH378216","2183508","2183598","KQ054638v1","240495","240586","29","1943013"
"JH378216","2300570","2300698","KQ056286v1","1109899","1110029","26","1190671"
"JH378216","2416310","2416444","KQ058094v1","3687022","3687155","22","1270712"
"JH378216","2449455","2449762","KQ058317v1","5791740","5792039","60","3342285"
"JH378216","2463322","2463438","KQ053835v1","409491","409618","29","2053831"
"JH378216","2489416","2489669","KQ053795v1","121444","121694","61","2367972"
"JH378216","2489859","2489925","KQ053465v1","4186482","4186543","20","1696623"
"JH378216","2609778","2610077","KQ053299v1","6038380","6038679","75","3428602"
"JH378216","2628453","2628748","KQ056494v1","510992","511284","71","2117461"
"JH378216","2741028","2741151","KQ053565v1","3424702","3424834","40","683674"
"JH378216","2741188","2741323","KQ054037v1","616202","616327","33","2124986"
"JH378216","2865850","2866156","KQ055600v1","649277","649577","63","2216573"
"JH378216","2957620","2957745","KQ057883v1","1224468","1224597","29","1733152"
"JH378216","3067018","3067305","KQ053959v1","6189151","6189431","70","3122133"
"JH378216","3159515","3159636","KQ058647v1","393534","393654","26","2765981"
"JH378216","3340391","3340683","KQ058538v1","934688","934988","79","2405703"
"JH378216","3555630","3555793","KQ053299v1","22920975","22921141","38","19365345"
"JH378216","3996014","3996328","KQ053729v1","1991451","1991758","71","2004563"
"JH378216","4076910","4077137","KQ054565v1","7472196","7472426","66","3395286"
"JH378216","4089377","4089578","KQ053354v1","1104956","1105153","50","2984421"
"JH378216","4200870","4201171","KQ053332v1","554962","555258","65","3645908"
"JH378216","4520134","4520229","KQ055662v1","3028941","3029027","27","1491193"
"JH378216","4534656","4534934","KQ058627v1","1643485","1643771","81","2891171"
"JH378216","4628074","4628205","KQ058272v1","6537742","6537872","30","1909668"
"JH378216","4628223","4628524","KQ053093v1","1522159","1522464","68","3106064"
"JH378216","4630664","4630944","KQ053948v1","168940","169229","77","4461724"
"JH378216","4703310","4703453","KQ058372v1","1975141","1975267","39","2728169"
"JH378216","4716723","4716818","KQ058249v1","520675","520767","20","4196048"
"JH378216","4924343","4924627","KQ053146v1","2819587","2819868","61","2104756"
"JH378216","4939696","4939832","KQ053256v1","1284266","1284394","28","3655430"
"JH378216","5569288","5569581","KQ058094v1","7832529","7832815","79","2263241"
"JH378216","5578995","5579140","KQ053190v1","2372433","2372579","30","3206562"
"JH378216","5597414","5597734","KQ055787v1","694393","694708","73","4903021"
"JH378216","5611777","5612055","ABDC02003384v1","193955","194231","60","5417822"
"JH378216","5867999","5868150","KQ053916v1","1573932","1574091","39","4294067"
"JH378216","6297172","6297471","KQ058572v1","1453592","1453891","66","4843580"
"JH378216","6394528","6394727","KQ058183v1","1419795","1419993","59","4974733"
"JH378216","6430922","6431188","KQ053409v1","7176794","7177078","68","745872"
"JH378216","6488859","6489161","KQ055141v1","378501","378798","71","6110358"
"JH378216","6599570","6599837","KQ058272v1","1995513","1995783","70","4604057"
"JH378216","6827071","6827219","KQ054196v1","237","387","37","6826834"
"JH378216","6941000","6941308","KQ053861v1","2668717","2669018","81","4272283"
"JH378216","7081813","7081900","KQ053520v1","1561632","1561710","23","5520181"
"JH378216","7082791","7082924","KQ053948v1","2804373","2804495","29","4278418"
"JH378216","7114415","7114681","KQ058184v1","1608105","1608378","60","5506310"
"JH378216","7154021","7154333","KQ054682v1","2237365","2237671","78","4916656"
"JH378216","7167257","7167445","KQ054713v1","774243","774430","55","6393014"
"JH378216","7207289","7207601","KQ054068v1","5074639","5074944","67","2132650"
"JH378216","7220137","7220304","KQ056494v1","731383","731554","48","6488754"
"JH378217","84790","85079","KQ052970v1","8274642","8274940","83","8189852"
"JH378217","124912","125214","KQ055119v1","848363","848641","78","723451"
"JH378217","148266","148578","KQ057822v1","223912","224221","70","75646"
"JH378217","209656","209747","KQ055119v1","3153967","3154055","30","2944311"
"JH378217","210119","210421","KQ055787v1","1064992","1065293","62","854873"
"JH378217","297710","298017","KQ053982v1","6591023","6591326","76","6293313"
"JH378217","821364","821500","KQ055872v1","4769945","4770082","27","3948581"
"JH378217","1313363","1313665","KQ058462v1","283306","283598","80","1030057"
"JH378217","2328118","2328385","KQ053632v1","579940","580190","88","1748178"
"JH378217","2478634","2478909","KQ052969v1","7351818","7352090","73","4873184"
"JH378217","2599544","2599695","KQ057875v1","315120","315258","42","2284424"
"JH378217","2811078","2811384","KQ056672v1","4955322","4955625","73","2144244"
"JH378217","2819929","2820231","KQ056320v1","2416951","2417254","79","402978"
"JH378217","2849072","2849387","KQ058004v1","2495177","2495491","71","353895"
"JH378217","3102163","3102463","KQ058317v1","3244448","3244747","75","142285"
"JH378217","3117222","3117481","KQ058405v1","697304","697560","78","2419918"
"JH378217","3717099","3717392","KQ053816v1","6856607","6856902","68","3139508"
"JH378217","4056797","4056908","KQ053774v1","3363452","3363567","30","693345"
"JH378217","4057312","4057383","KQ055384v1","420057","420110","24","3637255"
"JH378217","4057384","4057433","KQ058065v1","399231","399281","13","3658153"
"JH378217","4211647","4211796","KQ058265v1","212584","212745","42","3999063"
"JH378217","4345479","4345746","KQ058379v1","21379","21640","74","4324100"
"JH378217","4481868","4482160","KQ058184v1","1505565","1505858","96","2976303"
"JH378217","5475549","5475829","KQ057909v1","12575553","12575837","70","7100004"
"JH378217","5852960","5853102","KQ054510v1","8179279","8179421","32","2326319"
"JH378217","6003568","6003862","KQ054745v1","933559","933827","91","5070009"
"JH378217","6257107","6257369","KQ056148v1","2246905","2247173","70","4010202"
"JH378217","6732422","6732560","ABDC02047922v1","197","340","41","6732225"
"JH378217","6817700","6817858","KQ052969v1","8430836","8430996","42","1613136"
"JH378217","6880654","6880969","KQ058585v1","580456","580763","71","6300198"
"JH378218","324179","324481","KQ056973v1","783590","783885","74","459411"
"JH378218","359060","359261","KQ052970v1","7199437","7199628","56","6840377"
"JH378218","359348","359389","KQ053696v1","870676","870725","17","511328"
"JH378218","457428","457615","KQ058505v1","3952082","3952290","61","3494654"
"JH378218","523963","524201","KQ058328v1","2569266","2569497","43","2045303"
"JH378218","898643","898924","KQ055225v1","2800985","2801258","75","1902342"
"JH378218","913891","914126","KQ057213v1","475202","475423","60","438689"
"JH378218","916776","916974","KQ054533v1","2294255","2294433","58","1377479"
"JH378218","1468137","1468419","KQ053026v1","3886778","3887069","81","2418641"
"JH378218","2725151","2725443","KQ054412v1","2490468","2490761","79","234683"
"JH378218","2875465","2875762","KQ053115v1","1433384","1433674","79","1442081"
"JH378218","3853384","3853607","KQ057471v1","1354703","1354943","67","2498681"
"JH378218","3854518","3854605","KQ053059v1","2351984","2352070","20","1502534"
"JH378218","4050370","4050674","KQ056234v1","1421732","1422025","72","2628638"
"JH378218","4481174","4481463","KQ057504v1","162767","163049","67","4318407"
"JH378218","4593088","4593313","KQ053827v1","5369199","5369432","72","776111"
"JH378218","5000070","5000336","KQ055725v1","3090816","3091074","63","1909254"
"JH378218","6863527","6863799","KQ058321v1","21060","21321","62","6842467"
"JH378219","16770","17058","KQ055236v1","2049624","2049930","85","2032854"
"JH378219","376582","376792","KQ054069v1","7451915","7452104","63","7075333"
"JH378219","579889","580140","KQ052968v1","2521887","2522128","67","1941998"
"JH378219","868992","869153","KQ054202v1","2647138","2647297","43","1778146"
"JH378219","1345527","1345817","KQ058516v1","4175446","4175722","71","2829919"
"JH378219","1817071","1817381","KQ053398v1","2431232","2431537","72","614161"
"JH378219","1848930","1849238","KQ055767v1","2455394","2455703","64","606464"
"JH378219","2458887","2459052","KQ053223v1","2815634","2815800","32","356747"
"JH378219","2480041","2480317","KQ053993v1","1017100","1017367","74","1462941"
"JH378219","2521972","2522112","KQ055141v1","3481451","3481584","32","959479"
"JH378219","2545222","2545379","KQ056147v1","2168964","2169108","33","376258"
"JH378219","2687080","2687385","KQ058184v1","1505565","1505858","80","1181515"
"JH378219","2935105","2935417","KQ053816v1","7464708","7465010","72","4529603"
"JH378219","2989162","2989451","KQ056148v1","2419670","2419961","67","569492"
"JH378219","3198974","3199290","KQ058606v1","232956","233258","77","2966018"
"JH378219","3281376","3281656","KQ058226v1","265143","265437","68","3016233"
"JH378219","3486446","3486599","KQ057561v1","1395117","1395274","38","2091329"
"JH378219","3663644","3663791","KQ053310v1","2640191","2640334","43","1023453"
"JH378219","3970662","3970936","KQ056368v1","571844","572113","76","3398818"
"JH378219","4091635","4091786","KQ057702v1","1862724","1862857","37","2228911"
"JH378219","4426131","4426418","KQ053332v1","127947","128230","73","4298184"
"JH378219","4578872","4579118","KQ057504v1","1503716","1503966","70","3075156"
"JH378219","4594339","4594442","KQ053498v1","6687279","6687374","32","2092940"
"JH378219","4594654","4594783","KQ053300v1","2607358","2607485","39","1987296"
"JH378219","5291111","5291288","KQ054068v1","2554856","2555034","44","2736255"
"JH378219","5291449","5291555","KQ055352v1","899958","900063","25","4391491"
"JH378219","5605347","5605646","KQ054933v1","667391","667678","65","4937956"
"JH378219","5651879","5652182","KQ055872v1","14090556","14090859","73","8438677"
"JH378219","5727588","5727721","KQ054179v1","3927334","3927468","26","1800254"
"JH378219","6000217","6000519","KQ054069v1","7687863","7688158","66","1687646"
"JH378219","6002834","6003117","KQ053816v1","7425503","7425796","76","1422669"
"JH378219","6124758","6124925","KQ056475v1","5275769","5275928","43","848989"
"JH378219","6125891","6126176","KQ053332v1","447571","447853","66","5678320"
"JH378219","6141783","6141910","KQ056044v1","1806435","1806551","34","4335348"
"JH378219","6172405","6172685","KQ055557v1","4039701","4039984","65","2132704"
"JH378219","6466101","6466354","KQ053982v1","5797999","5798259","63","668102"
"JH378219","6801871","6802221","KQ054628v1","1274797","1275111","98","5527074"
"JH378220","303486","303657","KQ054058v1","123498","123661","44","179988"
"JH378220","506141","506436","KQ058184v1","1505565","1505858","63","999424"
"JH378220","597510","597808","KQ057875v1","404539","404839","77","192971"
"JH378220","684627","684946","KQ054713v1","1049755","1050073","67","365128"
"JH378220","727252","727399","KQ055490v1","2065440","2065590","28","1338188"
"JH378220","732797","733104","KQ054682v1","2125705","2126015","75","1392908"
"JH378220","766148","766451","KQ053827v1","4217183","4217477","67","3451035"
"JH378220","807026","807321","KQ053631v1","9631170","9631468","61","8824144"
"JH378220","828207","828383","KQ054401v1","2619021","2619192","52","1790814"
"JH378220","828426","828548","KQ054786v1","479127","479249","21","349299"
"JH378220","940349","940629","KQ053948v1","168940","169229","63","771409"
"JH378220","1187956","1188255","KQ055787v1","1064992","1065293","70","122964"
"JH378220","1262662","1262972","KQ058184v1","1505565","1505858","67","242903"
"JH378220","1309044","1309336","KQ055777v1","2252512","2252796","67","943468"
"JH378220","1344023","1344269","KQ058550v1","4156400","4156623","79","2812377"
"JH378220","1390012","1390302","KQ057004v1","1506143","1506432","70","116131"
"JH378220","1433775","1433983","KQ052968v1","10569063","10569270","43","9135288"
"JH378220","1929802","1930093","KQ058184v1","1505565","1505858","69","424237"
"JH378220","2005008","2005274","KQ055978v1","3560415","3560681","69","1555407"
"JH378220","2112207","2112460","KQ054510v1","1641980","1642248","73","470227"
"JH378220","2161015","2161321","KQ053190v1","1690950","1691254","63","470065"
"JH378220","2350740","2350950","KQ058242v1","892038","892246","41","1458702"
"JH378220","2388831","2389142","KQ053554v1","2471177","2471484","73","82346"
"JH378220","2574000","2574139","KQ058094v1","3687022","3687155","28","1113022"
"JH378220","2748546","2748838","KQ053740v1","2323389","2323680","76","425157"
"JH378220","2797792","2798092","KQ056672v1","3082150","3082439","68","284358"
"JH378220","2954337","2954637","KQ056855v1","4111147","4111444","69","1156810"
"JH378220","3082929","3083056","KQ053718v1","316226","316356","25","2766703"
"JH378220","3083921","3084147","KQ053332v1","1938314","1938530","52","1145607"
"JH378220","3116303","3116563","KQ054693v1","3278351","3278621","69","162048"
"JH378220","3182708","3182868","KQ053631v1","5537811","5537978","36","2355103"
"JH378220","3226976","3227241","KQ055192v1","1201363","1201615","62","2025613"
"JH378220","3255883","3256100","KQ053741v1","1190544","1190756","58","2065339"
"JH378220","3466971","3467094","KQ055600v1","267326","267449","25","3199645"
"JH378220","3523294","3523417","KQ055600v1","267326","267449","22","3255968"
"JH378220","3621385","3621633","KQ053654v1","3892663","3892904","61","271278"
"JH378220","3739960","3740273","KQ053288v1","2034811","2035125","71","1705149"
"JH378220","3976419","3976725","KQ054069v1","7687863","7688158","56","3711444"
"JH378220","4175969","4176246","KQ053631v1","9398334","9398603","65","5222365"
"JH378220","4240330","4240634","KQ053816v1","7464708","7465010","65","3224378"
"JH378220","4269696","4269971","KQ058539v1","1700786","1701070","62","2568910"
"JH378220","4426658","4426887","KQ053872v1","262334","262548","53","4164324"
"JH378220","4473528","4473743","KQ058328v1","2569266","2569497","55","1904262"
"JH378220","4625524","4625818","KQ058094v1","7832529","7832815","62","3207005"
"JH378220","4847086","4847251","KQ053072v1","221812","221965","40","4625274"
"JH378220","4920559","4920862","KQ058328v1","4260134","4260435","73","660425"
"JH378220","4928807","4929094","KQ053398v1","3625586","3625864","68","1303221"
"JH378220","4936023","4936194","KQ056587v1","7602017","7602187","30","2665994"
"JH378220","5016625","5016895","KQ058539v1","60805","61074","77","4955820"
"JH378220","5189597","5189899","KQ057858v1","376905","377209","74","4812692"
"JH378220","5197821","5198063","KQ058503v1","123813","124064","56","5074008"
"JH378220","5459642","5459956","KQ053299v1","4095914","4096215","71","1363728"
"JH378220","5718390","5718502","KQ058542v1","469843","469958","25","5248547"
"JH378220","5721490","5721797","KQ055236v1","2049624","2049930","68","3671866"
"JH378220","5749779","5749912","KQ055298v1","1575436","1575566","19","4174343"
"JH378220","6031198","6031489","KQ053093v1","1361295","1361576","65","4669903"
"JH378220","6321994","6322306","KQ053115v1","3485337","3485650","65","2836657"
"JH378220","6781839","6782156","KQ053343v1","1747702","1748011","69","5034137"
"JH378221","104348","104640","KQ054724v1","2732481","2732785","70","2628133"
"JH378221","109211","109485","KQ054964v1","328693","328953","80","219482"
"JH378221","117779","118057","KQ053665v1","817341","817603","83","699562"
"JH378221","276774","277064","KQ058183v1","487423","487710","69","210649"
"JH378221","323403","323690","KQ058293v1","1010866","1011153","78","687463"
"JH378221","1141945","1142204","KQ053354v1","2057850","2058093","63","915905"
"JH378221","1177261","1177566","KQ055777v1","745469","745769","73","431792"
"JH378221","1188472","1188759","KQ057118v1","1405248","1405530","79","216776"
"JH378221","1264980","1265104","KQ053565v1","3592345","3592467","24","2327365"
"JH378221","1265455","1265613","KQ053916v1","1573932","1574091","37","308477"
"JH378221","1270288","1270559","KQ053520v1","456408","456696","66","813880"
"JH378221","1404515","1404805","KQ057560v1","2450216","2450512","66","1045701"
"JH378221","1420553","1420826","KQ057213v1","1074642","1074915","68","345911"
"JH378221","1471868","1472123","KQ054933v1","935520","935770","66","536348"
"JH378221","1532158","1532316","KQ053191v1","2005380","2005547","51","473222"
"JH378221","1563040","1563255","KQ058004v1","2720169","2720394","56","1157129"
"JH378221","2314973","2315266","KQ052969v1","9116808","9117108","78","6801835"
"JH378221","3902667","3902814","KQ055384v1","843998","844147","25","3058669"
"JH378221","4203802","4204087","KQ054932v1","2522024","2522313","68","1681778"
"JH378221","4231742","4231941","KQ052968v1","13131640","13131834","53","8899898"
"JH378221","4708021","4708298","KQ055014v1","2491689","2491976","72","2216332"
"JH378221","5570916","5571141","KQ054994v1","39752","39994","78","5531164"
"JH378221","5881066","5881338","KQ058129v1","593564","593835","79","5287502"
"JH378221","5996453","5996703","KQ057702v1","1579642","1579892","65","4416811"
"JH378221","6010735","6010999","KQ053741v1","1633258","1633521","75","4377477"
"JH378221","6111612","6111753","KQ055725v1","720931","721083","36","5390681"
"JH378221","6246457","6246623","KQ057561v1","1395117","1395274","49","4851340"
"JH378221","6528472","6528779","KQ054068v1","5074639","5074944","73","1453833"
"JH378222","210243","210420","KQ054180v1","1190446","1190628","46","980203"
"JH378222","457693","457967","KQ058287v1","778590","778873","65","320897"
"JH378222","546265","546498","KQ053212v1","1714221","1714450","66","1167956"
"JH378222","563319","563589","KQ053332v1","447571","447853","64","115748"
"JH378222","722544","722859","KQ055119v1","3025572","3025880","74","2303028"
"JH378222","765141","765419","KQ058353v1","1449127","1449389","68","683986"
"JH378222","805934","806209","KQ057290v1","1053741","1054027","66","247807"
"JH378222","899387","899636","KQ052969v1","8172360","8172607","65","7272973"
"JH378222","1170332","1170501","KQ053774v1","1982290","1982469","46","811958"
"JH378222","1252454","1252733","KQ058516v1","4175446","4175722","79","2922992"
"JH378222","1269775","1270074","KQ054954v1","3921224","3921526","78","2651449"
"JH378222","1494218","1494361","KQ054213v1","615112","615244","40","879106"
"JH378222","1774422","1774730","KQ058184v1","1505565","1505858","62","268857"
"JH378222","2392817","2393117","KQ052982v1","252378","252680","64","2140439"
"JH378222","2649529","2649744","KQ055457v1","12366559","12366757","70","9717030"
"JH378222","2650537","2650647","KQ054091v1","1275705","1275817","34","1374832"
"JH378222","2757624","2757664","KQ058253v1","973211","973250","18","1784413"
"JH378222","2757665","2757892","KQ056447v1","2522955","2523197","72","234710"
"JH378222","3461516","3461823","KQ055457v1","2061137","2061448","77","1400379"
"JH378222","3471198","3471486","KQ055978v1","5201357","5201652","77","1730159"
"JH378222","3931261","3931505","KQ054510v1","4674182","4674430","65","742921"
"JH378222","4270307","4270580","KQ053398v1","2021251","2021517","87","2249056"
"JH378222","4367850","4368075","KQ058572v1","913074","913293","54","3454776"
"JH378222","4513317","4513592","KQ053465v1","403029","403303","75","4110288"
"JH378222","4918376","4918506","KQ056855v1","2808237","2808368","37","2110139"
"JH378222","5654743","5655026","KQ056494v1","2222182","2222467","74","3432561"
"JH378222","5698089","5698395","KQ055767v1","2455394","2455703","76","3242695"
"JH378222","6080036","6080345","KQ054932v1","2708037","2708346","67","3371999"
"JH378222","6119039","6119301","KQ058173v1","992259","992524","67","5126780"
"JH378222","6227655","6227938","KQ052970v1","2531178","2531455","80","3696477"
"JH378222","6288537","6288583","KQ053696v1","870676","870725","17","5417861"
"JH378222","6288584","6288686","KQ053299v1","14559361","14559465","37","8270777"
"JH378222","6304918","6305234","KQ054068v1","1399948","1400246","70","4904970"
"JH378222","6316430","6316734","KQ054879v1","1971571","1971875","82","4344859"
"JH378222","6335143","6335277","KQ057931v1","224937","225072","27","6110206"
"JH378222","6494407","6494513","KQ053894v1","1409409","1409506","22","5084998"
"JH378222","6754180","6754344","KQ053126v1","200434","200608","45","6553746"
"JH378223","413869","414174","KQ058561v1","4991819","4992113","75","4577950"
"JH378223","539186","539328","KQ053686v1","1108593","1108721","33","569407"
"JH378223","539775","539907","KQ058094v1","3687022","3687155","24","3147247"
"JH378223","543027","543330","KQ054069v1","5704070","5704362","69","5161043"
"JH378223","1051254","1051542","KQ058291v1","284522","284798","66","766732"
"JH378223","1805278","1805352","KQ054301v1","3456273","3456342","25","1650995"
"JH378223","1857693","1857982","KQ058389v1","2329886","2330179","71","472193"
"JH378223","1916119","1916423","KQ058290v1","511568","511873","71","1404551"
"JH378223","1946963","1947261","KQ055468v1","2950644","2950940","64","1003681"
"JH378223","2004877","2005122","KQ053565v1","3300439","3300690","74","1295562"
"JH378223","2020044","2020353","KQ053654v1","5318679","5318982","65","3298635"
"JH378223","2074257","2074553","KQ055978v1","5914999","5915296","68","3840742"
"JH378223","2586818","2586980","KQ057336v1","635116","635282","38","1951702"
"JH378223","2749615","2749927","KQ058290v1","511568","511873","75","2238047"
"JH378223","2764103","2764226","KQ053631v1","8539724","8539846","27","5775621"
"JH378223","3139397","3139696","KQ058184v1","1505565","1505858","66","1633832"
"JH378223","3312491","3312781","KQ055957v1","1731327","1731617","71","1581164"
"JH378223","3595263","3595557","KQ054510v1","9222042","9222321","73","5626779"
"JH378223","3651896","3652158","KQ052970v1","6238337","6238613","78","2586441"
"JH378223","3708714","3708994","KQ055610v1","2807920","2808197","66","900794"
"JH378223","3773545","3773700","KQ058483v1","5279934","5280083","40","1506389"
"JH378223","4137939","4138219","KQ057290v1","1053741","1054027","67","3084198"
"JH378223","4244544","4244867","KQ053115v1","1118362","1118655","87","3126182"
"JH378223","4373725","4373873","KQ053631v1","1260941","1261095","32","3112784"
"JH378223","4443540","4443854","KQ055141v1","1054026","1054336","69","3389514"
"JH378223","4462938","4463263","KQ057603v1","1570905","1571210","86","2892033"
"JH378223","4611619","4611933","KQ053081v1","2388028","2388336","74","2223591"
"JH378223","4614603","4614888","KQ052982v1","2557979","2558263","72","2056624"
"JH378223","4818321","4818483","KQ056965v1","118773","118937","45","4699548"
"JH378223","4823424","4823592","KQ058583v1","2039372","2039538","43","2784052"
"JH378223","4849270","4849557","KQ054434v1","1251638","1251923","76","3597632"
"JH378223","4877434","4877658","ABDC02049463v1","260","485","49","4877174"
"JH378223","4881428","4881713","KQ058533v1","977692","977970","63","3903736"
"JH378223","4893641","4893771","KQ053565v1","1793162","1793293","26","3100479"
"JH378223","4968166","4968273","KQ053026v1","2376723","2376841","27","2591443"
"JH378223","4970861","4970995","KQ054191v1","266771","266904","31","4704090"
"JH378223","5017771","5018039","KQ053288v1","2544116","2544381","71","2473655"
"JH378223","5042871","5043185","KQ053115v1","3485337","3485650","72","1557534"
"JH378223","5059335","5059588","KQ053631v1","7086492","7086738","74","2027157"
"JH378223","5129075","5129360","KQ053343v1","1729289","1729583","75","3399786"
"JH378223","5145249","5145525","KQ053299v1","3622388","3622669","73","1522861"
"JH378223","5152120","5152384","KQ058483v1","6010751","6011031","67","858631"
"JH378223","5173083","5173385","KQ056855v1","4111147","4111444","70","1061936"
"JH378223","5260860","5261132","KQ056761v1","2453965","2454244","78","2806895"
"JH378223","5316802","5317093","KQ053631v1","9963313","9963601","62","4646511"
"JH378223","5329352","5329646","KQ058274v1","458499","458797","75","4870853"
"JH378223","5388142","5388460","KQ058483v1","4098293","4098613","76","1289849"
"JH378223","5415522","5415798","KQ052969v1","11182978","11183250","63","5767456"
"JH378223","5436354","5436438","KQ054179v1","1673076","1673160","31","3763278"
"JH378223","5467170","5467469","KQ057290v1","1053741","1054027","78","4413429"
"JH378223","5511984","5512252","KQ053409v1","3716306","3716585","68","1795678"
"JH378223","5527250","5527478","KQ054693v1","2405955","2406178","54","3121295"
"JH378223","5530151","5530273","KQ057910v1","1548802","1548933","25","3981349"
"JH378223","5625070","5625197","KQ053432v1","3920706","3920835","25","1704364"
"JH378223","5647822","5648015","KQ055892v1","1173","1363","59","5646649"
"JH378223","5651844","5652160","KQ053115v1","3485337","3485650","71","2166507"
"JH378223","5670986","5671265","KQ053763v1","3936916","3937207","65","1734070"
"JH378223","5718619","5718889","KQ054202v1","373737","374019","70","5344882"
"JH378223","5777830","5778150","KQ052970v1","3660551","3660853","77","2117279"
"JH378223","5821599","5821843","KQ057291v1","322948","323180","71","5498651"
"JH378223","5827312","5827471","KQ054606v1","554177","554332","45","5273135"
"JH378223","5893211","5893506","KQ055852v1","1231373","1231668","64","4661838"
"JH378223","5921509","5921804","KQ053299v1","3823059","3823361","75","2098450"
"JH378223","5993091","5993212","KQ058280v1","21417","21542","29","5971674"
"JH378223","6039127","6039408","KQ052970v1","6659487","6659775","63","620360"
"JH378223","6118742","6119057","KQ053398v1","2431232","2431537","78","3687510"
"JH378223","6370128","6370413","KQ057504v1","162767","163049","67","6207361"
"JH378223","6418073","6418354","KQ056773v1","168010","168288","62","6250063"
"JH378223","6649140","6649324","KQ056855v1","3333191","3333380","50","3315949"
"JH378223","6680128","6680321","KQ056375v1","1153881","1154077","40","5526247"
"JH378223","6689784","6690083","KQ053409v1","6207403","6207697","73","482381"
"JH378224","2813","3068","KQ053191v1","1874915","1875171","67","1872102"
"JH378224","638691","638914","KQ053093v1","1363144","1363361","57","724453"
"JH378224","722796","723064","KQ058329v1","246650","246919","76","476146"
"JH378224","771424","771696","KQ058379v1","21379","21640","70","750045"
"JH378224","773833","774127","KQ053740v1","716482","716767","76","57351"
"JH378224","917587","917919","KQ058292v1","649365","649654","113","268222"
"JH378224","1027239","1027362","KQ053135v1","3445097","3445217","27","2417858"
"JH378224","1217787","1218091","KQ053398v1","3445470","3445768","70","2227683"
"JH378224","1265591","1265892","KQ053299v1","6038380","6038679","63","4772789"
"JH378224","1406571","1406748","KQ055014v1","15960","16127","45","1390611"
"JH378224","1472787","1472922","KQ053752v1","1383162","1383295","24","89625"
"JH378224","1502994","1503242","KQ052970v1","566850","567108","74","936144"
"JH378224","1778992","1779132","KQ054412v1","2034642","2034787","42","255650"
"JH378224","1943801","1943983","KQ056483v1","805524","805686","53","1138277"
"JH378224","1949624","1949949","KQ058483v1","4098293","4098613","75","2148669"
"JH378224","2464239","2464552","KQ056928v1","97902","98210","78","2366337"
"JH378224","2524186","2524464","KQ058184v1","1505565","1505858","68","1018621"
"JH378224","2540073","2540382","KQ058539v1","1057985","1058283","72","1482088"
"JH378224","2587706","2588002","KQ054412v1","1824448","1824730","80","763258"
"JH378224","2664722","2665033","KQ058184v1","1505565","1505858","64","1159157"
"JH378224","2722732","2722957","KQ056465v1","72608","72828","51","2650124"
"JH378224","2760343","2760653","KQ058328v1","6293951","6294242","66","3533608"
"JH378224","2784741","2784872","KQ057488v1","512192","512325","25","2272549"
"JH378224","2851337","2851499","KQ057480v1","674678","674843","30","2176659"
"JH378224","2932424","2932719","KQ058389v1","2329886","2330179","63","602538"
"JH378224","2973399","2973696","KQ053520v1","848167","848461","68","2125232"
"JH378224","2985372","2985429","KQ053299v1","2592408","2592461","17","392964"
"JH378224","2985784","2985876","KQ053827v1","2612475","2612564","20","373309"
"JH378224","3099000","3099248","KQ056855v1","4137320","4137571","77","1038320"
"JH378224","3121758","3122052","KQ058242v1","722153","722450","60","2399605"
"JH378224","3153276","3153558","KQ054693v1","832788","833076","71","2320488"
"JH378224","3280435","3280745","KQ055457v1","2061137","2061448","73","1219298"
"JH378224","3281144","3281291","KQ053212v1","578976","579120","32","2702168"
"JH378224","3283309","3283463","KQ054124v1","4733901","4734054","33","1450592"
"JH378224","3294810","3295090","KQ055457v1","6834638","6834917","59","3539828"
"JH378224","3480827","3481104","KQ053565v1","1231326","1231605","61","2249501"
"JH378224","3530850","3531149","KQ052971v1","646100","646383","75","2884750"
"JH378224","3677378","3677551","KQ054068v1","2554856","2555034","39","1122522"
"JH378224","3948307","3948363","KQ058594v1","5938807","5938870","17","1990500"
"JH378224","4217600","4217881","KQ053421v1","3062266","3062539","59","1155334"
"JH378224","4359373","4359689","KQ053387v1","1398364","1398674","69","2961009"
"JH378224","4394482","4394770","KQ056643v1","159950","160228","68","4234532"
"JH378224","4497869","4497984","KQ055946v1","298049","298158","29","4199820"
"JH378224","4696366","4696613","KQ054069v1","928440","928688","67","3767926"
"JH378224","4754016","4754319","KQ058538v1","934688","934988","69","3819328"
"JH378224","4827611","4827835","KQ054704v1","483937","484161","64","4343674"
"JH378224","4876218","4876355","KQ053115v1","1650505","1650644","20","3225713"
"JH378224","5001926","5002129","KQ056345v1","609427","609631","51","4392499"
"JH378224","5015702","5015962","KQ052971v1","6441372","6441626","67","1425670"
"JH378224","5125036","5125343","KQ054660v1","4406825","4407120","78","718211"
"JH378224","5196185","5196495","KQ054179v1","1802843","1803147","73","3393342"
"JH378224","5261644","5261930","KQ055777v1","2840700","2840988","80","2420944"
"JH378224","5267667","5267951","KQ058394v1","9107761","9108054","60","3840094"
"JH378224","5271896","5272187","KQ053631v1","368629","368924","64","4903267"
"JH378224","5281128","5281307","KQ058242v1","763206","763378","47","4517922"
"JH378224","5560202","5560492","KQ052969v1","9116808","9117108","64","3556606"
"JH378224","5704776","5705014","KQ056465v1","72608","72828","64","5632168"
"JH378224","5741644","5741920","KQ055957v1","364218","364491","59","5377426"
"JH378224","5754509","5754616","KQ058294v1","8337497","8337593","33","2582988"
"JH378224","5800827","5801126","KQ054510v1","2447370","2447670","66","3353457"
"JH378224","5804179","5804454","KQ053816v1","5837219","5837503","65","33040"
"JH378224","5809678","5809972","KQ054345v1","1874793","1875073","73","3934885"
"JH378224","5856157","5856454","KQ054124v1","2442155","2442433","86","3414002"
"JH378224","5968695","5968974","KQ053191v1","614334","614618","66","5354361"
"JH378224","6091798","6092088","KQ053288v1","2218996","2219287","51","3872802"
"JH378224","6154559","6154860","KQ058539v1","2019983","2020284","66","4134576"
"JH378224","6264689","6264977","KQ054124v1","4347479","4347753","78","1917210"
"JH378224","6396941","6397255","KQ053654v1","2982209","2982517","74","3414732"
"JH378224","6529873","6530008","KQ057910v1","1548802","1548933","29","4981071"
"JH378225","212296","212418","KQ053190v1","4952878","4952995","31","4740582"
"JH378225","219368","219639","KQ055735v1","667472","667747","66","448104"
"JH378225","236266","236428","KQ057649v1","424252","424417","37","187986"
"JH378225","237055","237179","KQ058383v1","7248131","7248254","28","7011076"
"JH378225","253261","253533","KQ053752v1","577130","577407","75","323869"
"JH378225","392951","393065","KQ053157v1","5621627","5621750","26","5228676"
"JH378225","567697","567980","KQ053146v1","2819587","2819868","66","2251890"
"JH378225","589806","590090","KQ053026v1","3680523","3680807","70","3090717"
"JH378225","672385","672669","KQ057260v1","588691","588975","77","83694"
"JH378225","719892","720148","KQ054826v1","9969237","9969502","62","9249345"
"JH378225","775523","775659","KQ058483v1","5373223","5373356","30","4597700"
"JH378225","795776","796060","KQ054565v1","6587941","6588226","56","5792165"
"JH378225","804853","805152","KQ053343v1","1747702","1748011","69","942849"
"JH378225","1039313","1039616","KQ054682v1","2125705","2126015","73","1086392"
"JH378225","1184031","1184327","KQ054400v1","354368","354668","69","829663"
"JH378225","1186267","1186543","KQ053070v1","3808565","3808842","70","2622298"
"JH378225","1242800","1243096","KQ056673v1","1151371","1151663","60","91429"
"JH378225","1245341","1245483","KQ053191v1","655494","655627","30","589847"
"JH378225","1293091","1293326","KQ053026v1","2213601","2213834","53","920510"
"JH378225","1398420","1398501","KQ052968v1","8156468","8156529","35","6758048"
"JH378225","1450701","1450935","KQ054124v1","147406","147625","69","1303295"
"JH378225","1615619","1615898","KQ053190v1","3029554","3029812","74","1413935"
"JH378225","1665256","1665335","KQ055735v1","739305","739373","29","925951"
"JH378225","1665758","1665835","KQ054815v1","618062","618122","25","1047696"
"JH378225","1704465","1704593","KQ056643v1","1491838","1491968","23","212627"
"JH378225","1908783","1908917","KQ057702v1","1862724","1862857","25","46059"
"JH378225","2074984","2075276","KQ058483v1","6010751","6011031","80","3935767"
"JH378225","2135380","2135639","KQ056773v1","122800","123057","71","2012580"
"JH378225","2546678","2546939","KQ053795v1","370451","370712","71","2176227"
"JH378225","2577095","2577280","KQ057737v1","1188439","1188621","49","1388656"
"JH378225","2657058","2657315","KQ058328v1","2975933","2976189","63","318875"
"JH378225","2670454","2670573","KQ053157v1","8174152","8174260","32","5503698"
"JH378225","2732530","2732611","KQ053398v1","4200835","4200909","22","1468305"
"JH378225","2850581","2850826","KQ055662v1","2338823","2339077","77","511758"
"JH378225","2998353","2998513","KQ057649v1","424252","424417","30","2574101"
"JH378225","3143394","3143641","KQ055014v1","250838","251107","75","2892556"
"JH378225","3330009","3330325","KQ055247v1","1248490","1248795","67","2081519"
"JH378225","3410399","3410505","KQ053070v1","2111294","2111415","30","1299105"
"JH378225","3410655","3410711","KQ053696v1","870676","870725","17","2539979"
"JH378225","3480794","3480937","KQ054510v1","8179279","8179421","31","4698485"
"JH378225","3683840","3684176","KQ058468v1","36378","36710","104","3647462"
"JH378225","3697457","3697608","KQ053476v1","4635198","4635357","37","937741"
"JH378225","4197170","4197385","KQ058383v1","5244323","5244522","58","1047153"
"JH378225","4204614","4204740","KQ056147v1","1828259","1828388","23","2376355"
"JH378225","4238400","4238699","KQ054804v1","964015","964313","65","3274385"
"JH378225","4245956","4246089","KQ053774v1","406836","406969","32","3839120"
"JH378225","4297733","4298022","KQ058356v1","225845","226125","58","4071888"
"JH378225","4337315","4337617","KQ053654v1","5318679","5318982","72","981364"
"JH378225","4456588","4456798","KQ054932v1","5992696","5992910","52","1536108"
"JH378225","4469229","4469540","KQ053958v1","83131","83439","84","4386098"
"JH378225","4474654","4474923","KQ055662v1","4683524","4683789","62","208870"
"JH378225","4515948","4516227","KQ054954v1","2363040","2363310","61","2152908"
"JH378225","4712152","4712452","KQ052970v1","6659487","6659775","77","1947335"
"JH378225","4712527","4712817","KQ053299v1","3622388","3622669","73","1090139"
"JH378225","4975314","4975612","KQ053816v1","7464708","7465010","51","2489394"
"JH378225","5012192","5012445","KQ057910v1","2540095","2540357","65","2472097"
"JH378225","5252060","5252361","KQ056432v1","1593337","1593624","64","3658723"
"JH378225","5275333","5275621","KQ053476v1","3712115","3712409","59","1563218"
"JH378225","5403341","5403650","KQ053816v1","7327018","7327317","73","1923677"
"JH378225","5424631","5424913","KQ058316v1","2126674","2126964","68","3297957"
"JH378225","5484148","5484431","KQ054565v1","6587941","6588226","77","1103793"
"JH378225","5513270","5513473","KQ053398v1","3158290","3158500","46","2354980"
"JH378225","5515199","5515471","KQ054289v1","4355551","4355817","74","1159648"
"JH378225","5565074","5565209","KQ058438v1","574406","574539","30","4990668"
"JH378225","5602979","5603092","KQ058328v1","5454635","5454751","27","148344"
"JH378225","5625480","5625569","KQ058561v1","5551877","5551953","29","73603"
"JH378225","5625746","5625841","KQ055872v1","5141445","5141541","20","484301"
"JH378225","5807228","5807544","KQ053718v1","2884509","2884816","81","2922719"
"JH378225","5876765","5877051","KQ054617v1","177849","178129","74","5698916"
"JH378225","5883628","5883928","KQ055140v1","3781964","3782260","78","2101664"
"JH378225","5918587","5918870","KQ055755v1","209063","209333","67","5709524"
"JH378225","5930313","5930613","KQ053398v1","2545768","2546067","55","3384545"
"JH378225","6040974","6041260","KQ056790v1","446564","446855","74","5594410"
"JH378225","6090635","6090797","KQ055425v1","1445594","1445758","34","4645041"
"JH378225","6099429","6099706","KQ057560v1","1194310","1194592","60","4905119"
"JH378225","6241943","6242229","KQ058438v1","548495","548786","68","5693448"
"JH378225","6277382","6277665","KQ056855v1","2789429","2789717","60","3487953"
"JH378225","6288856","6289146","KQ054933v1","4854778","4855065","59","1434078"
"JH378225","6316923","6317054","KQ054058v1","442463","442593","29","5874460"
"JH378225","6575988","6576293","KQ058604v1","210345","210647","61","6365643"
"JH378225","6589541","6589840","KQ054804v1","964015","964313","62","5625526"
"JH378226","128282","128577","KQ054606v1","1970307","1970600","64","1842025"
"JH378226","442082","442379","KQ053631v1","7288314","7288608","66","6846232"
"JH378226","800015","800314","KQ055767v1","2455394","2455703","68","1655379"
"JH378226","932272","932580","KQ053082v1","857394","857690","77","74878"
"JH378226","1414594","1414684","KQ053432v1","5774004","5774087","21","4359410"
"JH378226","1537215","1537494","KQ058184v1","1505565","1505858","68","31650"
"JH378226","1570773","1571054","KQ052968v1","13657848","13658133","72","12087075"
"JH378226","1779331","1779720","KQ053894v1","566617","566947","134","1212714"
"JH378226","1895651","1895921","KQ054510v1","1733420","1733680","78","162231"
"JH378226","1952058","1952325","KQ058383v1","2699813","2700083","65","747755"
"JH378226","2065576","2065872","KQ058184v1","1505565","1505858","64","560011"
"JH378226","2083383","2083575","KQ056166v1","1004668","1004858","64","1078715"
"JH378226","2380135","2380435","KQ052969v1","9116808","9117108","70","6736673"
"JH378226","2614722","2615010","KQ058249v1","184192","184468","74","2430530"
"JH378226","2685964","2686276","KQ058184v1","1505565","1505858","72","1180399"
"JH378226","2697622","2697920","KQ053465v1","167701","167983","76","2529921"
"JH378226","3293982","3294045","KQ055893v1","2912845","2912909","16","381137"
"JH378226","3294323","3294489","KQ054047v1","324266","324438","40","2970057"
"JH378226","3425193","3425484","KQ055629v1","4831189","4831479","77","1405996"
"JH378226","3626332","3626463","KQ053543v1","1868215","1868343","24","1758117"
"JH378226","4075261","4075518","KQ052968v1","10578958","10579232","75","6503697"
"JH378226","4219504","4219801","KQ053631v1","7288314","7288608","65","3068810"
"JH378226","4301650","4301954","KQ054191v1","3583730","3584032","80","717920"
"JH378226","4355089","4355381","KQ056587v1","9000240","9000528","56","4645151"
"JH378226","4366622","4366925","KQ056148v1","3455662","3455957","71","910960"
"JH378226","4782980","4783272","KQ058472v1","1327185","1327479","72","3455795"
"JH378226","5186378","5186421","KQ058253v1","973211","973250","19","4213167"
"JH378226","5186422","5186488","KQ056147v1","882792","882852","14","4303630"
"JH378226","5345114","5345358","KQ054069v1","928440","928688","55","4416674"
"JH378226","5408038","5408353","KQ057673v1","1971708","1972015","70","3436330"
"JH378226","5408402","5408529","KQ053609v1","1892948","1893072","26","3515454"
"JH378226","5657875","5658002","KQ057431v1","750387","750523","31","4907488"
"JH378226","5727168","5727286","KQ055024v1","329599","329697","35","5397569"
"JH378226","5831831","5832153","KQ054693v1","2010555","2010863","63","3821276"
"JH378226","5832332","5832481","KQ052969v1","11713785","11713934","30","5881453"
"JH378226","6248506","6248790","KQ056361v1","74136","74395","91","6174370"
"JH378226","6249102","6249383","KQ058490v1","79904","80160","82","6169198"
"JH378226","6411864","6412158","KQ053398v1","1997614","1997898","67","4414250"
"JH378227","42263","42405","KQ053115v1","1650505","1650644","26","1608242"
"JH378227","277040","277158","KQ054179v1","4089970","4090089","29","3812930"
"JH378227","277503","277614","KQ054671v1","629082","629194","37","351579"
"JH378227","375009","375270","KQ053059v1","2135970","2136233","64","1760961"
"JH378227","502151","502446","KQ052981v1","658787","659079","71","156636"
"JH378227","512019","512218","KQ053696v1","3631267","3631475","64","3119248"
"JH378227","518167","518292","KQ053256v1","1284266","1284394","33","766099"
"JH378227","534719","534846","KQ053044v1","607812","607942","39","73093"
"JH378227","542409","542704","KQ058184v1","1505565","1505858","51","963156"
"JH378227","587256","587413","KQ053795v1","588026","588179","38","770"
"JH378227","630787","631078","KQ053816v1","7464708","7465010","66","6833921"
"JH378227","745136","745454","KQ055141v1","1054026","1054336","77","308890"
"JH378227","820392","820668","KQ052969v1","11182978","11183250","55","10362586"
"JH378227","839330","839628","KQ054868v1","2229582","2229854","70","1390252"
"JH378227","946681","946941","KQ058427v1","6988722","6989008","73","6042041"
"JH378227","990145","990416","KQ053191v1","2134125","2134399","70","1143980"
"JH378227","1014705","1014856","KQ052969v1","8332082","8332226","32","7317377"
"JH378227","1079819","1079981","KQ053190v1","5905807","5905973","37","4825988"
"JH378227","1080336","1080400","KQ053556v1","5700","5760","19","1074636"
"JH378227","1264079","1264328","KQ052968v1","6916520","6916761","61","5652441"
"JH378227","1264440","1264499","KQ053260v1","77779","77831","21","1186661"
"JH378227","1274693","1274952","KQ056035v1","1236900","1237146","78","37793"
"JH378227","1276994","1277276","ABDC02003384v1","193955","194231","68","1083039"
"JH378227","1279267","1279530","KQ054954v1","2363040","2363310","68","1083773"
"JH378227","1310121","1310418","KQ057118v1","4601602","4601894","53","3291481"
"JH378227","1311355","1311640","KQ053288v1","2218996","2219287","63","907641"
"JH378227","1316309","1316443","KQ053115v1","1333586","1333718","22","17277"
"JH378227","1354442","1354706","KQ052968v1","6916520","6916761","68","5562078"
"JH378227","1392861","1393025","KQ054933v1","651306","651450","50","741555"
"JH378227","1393469","1393573","KQ053498v1","6687279","6687374","27","5293810"
"JH378227","1395006","1395289","KQ052968v1","13260777","13261056","65","11865771"
"JH378227","1424029","1424337","KQ052968v1","9583834","9584132","70","8159805"
"JH378227","1571499","1571794","KQ054510v1","8555095","8555387","60","6983596"
"JH378227","1575872","1576179","KQ053299v1","21869448","21869738","73","20293576"
"JH378227","1865600","1865895","KQ053827v1","4198964","4199247","66","2333364"
"JH378227","1869051","1869317","KQ052971v1","6441372","6441626","59","4572321"
"JH378227","1891381","1891688","KQ054932v1","4838112","4838407","76","2946731"
"JH378227","1933460","1933604","KQ058004v1","2254984","2255111","34","321524"
"JH378227","2210221","2210366","KQ053212v1","578976","579120","25","1631245"
"JH378227","2321682","2321982","KQ058242v1","122902","123175","149","2198780"
"JH378227","2350180","2350475","KQ057290v1","2953971","2954265","62","603791"
"JH378227","2534465","2534607","KQ058004v1","2711466","2711602","29","177001"
"JH378227","2722475","2722606","KQ053565v1","1793162","1793293","21","929313"
"JH378227","2725852","2726142","KQ054113v1","1585808","1586104","65","1140044"
"JH378227","2761507","2761792","KQ057290v1","2180782","2181079","80","580725"
"JH378227","2801583","2801746","KQ053190v1","5905807","5905973","40","3104224"
"JH378227","2860992","2861272","KQ054356v1","1600089","1600380","63","1260903"
"JH378227","2888042","2888195","KQ057118v1","1492016","1492164","40","1396026"
"JH378227","3147689","3148002","KQ054932v1","9683849","9684160","61","6536160"
"JH378227","3199485","3199769","KQ053838v1","3013088","3013374","62","186397"
"JH378227","3274065","3274355","KQ054725v1","2218271","2218569","69","1055794"
"JH378227","3291562","3291852","KQ056331v1","1886723","1887024","76","1404839"
"JH378227","3401254","3401498","KQ057336v1","26477","26732","73","3374777"
"JH378227","3861630","3861918","KQ055745v1","1895479","1895762","71","1966151"
"JH378227","4484839","4485126","KQ052968v1","4142140","4142422","69","342699"
"JH378227","4616345","4616655","KQ052981v1","1198440","1198752","65","3417905"
"JH378227","4674171","4674420","KQ056423v1","449946","450194","79","4224225"
"JH378227","4804350","4804660","KQ055629v1","3439406","3439722","81","1364944"
"JH378227","4904452","4904763","KQ053785v1","807454","807767","71","4096998"
"JH378227","4977191","4977492","KQ053763v1","3936916","3937207","65","1040275"
"JH378227","4980780","4981086","KQ058183v1","487423","487710","83","4493357"
"JH378227","5423546","5423860","KQ054466v1","67740","68048","79","5355806"
"JH378227","5815516","5815795","KQ054434v1","1251638","1251923","76","4563878"
"JH378227","6037738","6038005","KQ058305v1","3371252","3371528","66","2666486"
"JH378227","6205203","6205452","KQ053654v1","3892663","3892904","72","2312540"
"JH378227","6257065","6257192","KQ053916v1","2379880","2380005","20","3877185"
"JH378228","407662","407942","KQ053299v1","3084158","3084422","79","2676496"
"JH378228","439248","439359","KQ055141v1","2421865","2421977","24","1982617"
"JH378228","507346","507469","KQ055384v1","230130","230259","33","277216"
"JH378228","619094","619186","KQ058183v1","3236759","3236851","17","2617665"
"JH378228","1271910","1272216","KQ052981v1","1198440","1198752","72","73470"
"JH378228","1776404","1776602","KQ058305v1","3932993","3933212","66","2156589"
"JH378228","1979705","1979989","KQ054693v1","832788","833076","60","1146917"
"JH378228","2214779","2215073","KQ058184v1","1505565","1505858","73","709214"
"JH378228","2330222","2330519","KQ053816v1","7464708","7465010","74","5134486"
"JH378228","4191710","4191940","KQ053299v1","7690856","7691089","60","3499146"
"JH378228","5417715","5418019","KQ053398v1","3445470","3445768","60","1972245"
"JH378228","5431833","5432143","KQ057480v1","1557653","1557963","75","3874180"
"JH378228","5477621","5477920","KQ053146v1","329936","330234","63","5147685"
"JH378228","5846599","5846910","KQ053190v1","5623449","5623748","82","223150"
"JH378228","5875898","5876007","KQ056527v1","169","285","39","5875729"
"JH378228","6048547","6048831","KQ053960v1","70067","70362","67","5978480"
"JH378229","47560","47839","KQ053126v1","1419293","1419571","62","1371733"
"JH378229","264624","264919","KQ053026v1","3680523","3680807","74","3415899"
"JH378229","376103","376405","KQ055629v1","135233","135538","71","240870"
"JH378229","561849","562148","KQ058315v1","830377","830680","79","268528"
"JH378229","590292","590591","KQ054412v1","2490468","2490761","74","1900176"
"JH378229","812511","812792","KQ055192v1","1180464","1180749","73","367953"
"JH378229","1206526","1206812","KQ056147v1","1064032","1064323","84","142494"
"JH378229","2066837","2066972","KQ053278v1","2831986","2832103","42","765149"
"JH378229","2854546","2854783","KQ056432v1","1067354","1067600","72","1787192"
"JH378229","2863064","2863355","KQ058328v1","6293951","6294242","64","3430887"
"JH378229","3423399","3423707","KQ052968v1","7300500","7300792","78","3877101"
"JH378229","3815594","3815894","KQ057471v1","400564","400844","79","3415030"
"JH378229","3959307","3959605","KQ054693v1","837377","837666","62","3121930"
"JH378229","4100301","4100445","KQ057875v1","315120","315258","35","3785181"
"JH378229","4259255","4259429","KQ056996v1","1524030","1524195","39","2735225"
"JH378229","4259555","4259694","KQ058640v1","122151","122286","40","4137404"
"JH378229","4375657","4375727","KQ058076v1","120666","120729","27","4254991"
"JH378229","4486179","4486439","KQ058394v1","3915274","3915538","73","570905"
"JH378229","4545514","4545832","KQ054412v1","2490468","2490761","75","2055046"
"JH378229","4600489","4600588","KQ053223v1","2552349","2552442","25","2048140"
"JH378229","4601188","4601398","KQ054401v1","3245220","3245428","59","1355968"
"JH378229","4625957","4626161","KQ053106v1","608807","609006","69","4017150"
"JH378229","4629512","4629788","KQ057931v1","399684","399967","65","4229828"
"JH378229","4759452","4759754","KQ053816v1","7327018","7327317","60","2567566"
"JH378229","4864811","4864957","KQ056147v1","2168964","2169108","35","2695847"
"JH378229","4990454","4990734","KQ056643v1","159950","160228","63","4830504"
"JH378229","5687939","5688205","KQ058427v1","4553509","4553777","74","1134430"
"JH378229","5739153","5739439","KQ058317v1","5506620","5506904","69","232533"
"JH378229","5959896","5960022","KQ056568v1","798477","798603","30","5161419"
"JH378229","5960026","5960261","KQ057268v1","1608514","1608738","70","4351512"
"JH378230","1128600","1128890","KQ053059v1","4765435","4765723","76","3636835"
"JH378230","1255966","1256216","KQ053850v1","553652","553884","71","702314"
"JH378230","1327985","1328279","KQ055640v1","442033","442328","85","885952"
"JH378230","1546351","1546617","ABDC02003384v1","193955","194231","76","1352396"
"JH378230","2212291","2212530","KQ058199v1","885969","886232","75","1326322"
"JH378230","2627391","2627685","KQ058428v1","1815721","1816007","76","811670"
"JH378230","2644909","2645196","KQ055247v1","4445738","4446031","60","1800829"
"JH378230","2649223","2649527","KQ052969v1","9116808","9117108","74","6467585"
"JH378230","3661670","3661945","KQ056773v1","122800","123057","80","3538870"
"JH378230","4397551","4397772","KQ053398v1","3158290","3158500","58","1239261"
"JH378230","4997718","4998007","KQ055883v1","292153","292441","73","4705565"
"JH378230","5321442","5321641","KQ054576v1","2775916","2776136","64","2545526"
"JH378230","5371585","5371826","KQ056044v1","570262","570509","65","4801323"
"JH378230","5374500","5374662","KQ056475v1","5275769","5275928","37","98731"
"JH378230","5821155","5821360","KQ058516v1","2391279","2391485","73","3429876"
"JH378230","5902574","5902874","KQ052970v1","9813160","9813451","82","3910586"
"JH378231","197628","197903","KQ053631v1","6939636","6939913","70","6742008"
"JH378231","735953","736227","KQ058533v1","977692","977970","60","241739"
"JH378231","960485","960613","KQ054660v1","5437047","5437165","36","4476562"
"JH378231","1321820","1322129","KQ053093v1","3162517","3162806","82","1840697"
"JH378231","1495939","1496050","KQ052969v1","2661859","2661968","22","1165920"
"JH378231","1702635","1702934","KQ058394v1","2709989","2710289","74","1007354"
"JH378231","1767018","1767147","KQ052968v1","13532288","13532426","38","11765270"
"JH378231","1988950","1989089","KQ058305v1","4820083","4820218","35","2831133"
"JH378231","2187163","2187470","KQ052969v1","9116808","9117108","60","6929645"
"JH378231","2205414","2205711","KQ054069v1","7687863","7688158","62","5482449"
"JH378231","2232894","2233196","KQ052969v1","9116808","9117108","67","6883914"
"JH378231","2274980","2275262","KQ058183v1","4026019","4026305","63","1751039"
"JH378231","2342508","2342673","KQ052969v1","8430836","8430996","34","6088328"
"JH378231","2373160","2373244","KQ054179v1","1673076","1673160","30","700084"
"JH378231","2440483","2440648","KQ052968v1","10427732","10427888","44","7987249"
"JH378231","2456347","2456641","KQ054682v1","1577967","1578262","63","878380"
"JH378231","2596037","2596168","KQ056973v1","1531147","1531277","25","1064890"
"JH378231","2596483","2596644","KQ053202v1","830653","830812","32","1765830"
"JH378231","2836650","2836955","KQ054401v1","2629005","2629296","78","207645"
"JH378231","2908760","2908977","KQ058242v1","892038","892246","58","2016722"
"JH378231","3015919","3016048","KQ056761v1","12919","13049","25","3003000"
"JH378231","3205200","3205507","KQ055457v1","2061137","2061448","69","1144063"
"JH378231","3217129","3217404","KQ053520v1","2992926","2993205","66","224203"
"JH378231","3373051","3373348","KQ053763v1","141096","141389","72","3231955"
"JH378231","3479910","3480197","KQ054510v1","8555095","8555387","64","5075185"
"JH378231","3556268","3556571","KQ058272v1","6007682","6007982","78","2451414"
"JH378231","3573445","3573559","KQ057118v1","3875160","3875276","30","301715"
"JH378231","3581402","3581708","KQ055457v1","6534446","6534755","75","2953044"
"JH378231","3724383","3724693","KQ054725v1","1024418","1024732","73","2699965"
"JH378231","3802428","3802709","KQ055872v1","12987862","12988141","66","9185434"
"JH378231","3859384","3859652","KQ052968v1","11227872","11228133","71","7368488"
"JH378231","3930843","3931141","KQ058184v1","1505565","1505858","60","2425278"
"JH378231","3941257","3941552","KQ058272v1","3478327","3478617","75","462930"
"JH378231","3987790","3987975","KQ055119v1","1040353","1040537","46","2947437"
"JH378231","3988434","3988460","KQ053299v1","20748277","20748312","14","16759843"
"JH378231","4128702","4129004","KQ057118v1","4601602","4601894","77","472900"
"JH378231","4152580","4152862","KQ053894v1","688559","688830","65","3464021"
"JH378231","4547013","4547261","KQ053026v1","1821708","1821962","60","2725305"
"JH378231","4632996","4633280","KQ057471v1","475360","475647","74","4157636"
"JH378231","4684323","4684581","ABDC02001028v1","1438","1684","81","4682885"
"JH378231","4690690","4690984","KQ058550v1","3122590","3122877","71","1568100"
"JH378231","5359428","5359692","KQ056404v1","1771928","1772196","60","3587500"
"JH378231","5481753","5482060","KQ054804v1","1152481","1152777","78","4329272"
"JH378231","5489389","5489636","KQ054693v1","3245566","3245803","66","2243823"
"JH378231","5676922","5677204","KQ052970v1","4138682","4138959","81","1538240"
"JH378231","5923434","5923717","KQ054456v1","2217999","2218282","62","3705435"
"JH378231","5947482","5947793","KQ056643v1","431969","432259","74","5515513"
"JH378231","5999776","5999960","KQ055978v1","4257847","4258036","54","1741929"
"JH378231","6092493","6092807","KQ053299v1","20647137","20647450","78","14554644"
"JH378231","6157226","6157464","KQ054933v1","935520","935770","63","5221706"
"JH378232","249731","249901","KQ052969v1","4175976","4176146","57","3926245"
"JH378232","276677","276947","KQ053147v1","593881","594139","70","317204"
"JH378232","286426","286736","KQ053093v1","1738898","1739201","70","1452472"
"JH378232","315900","316138","KQ058272v1","2013158","2013380","70","1697258"
"JH378232","326985","327076","KQ056148v1","5019141","5019230","29","4692156"
"JH378232","344695","344886","KQ057082v1","645637","645822","50","300942"
"JH378232","345219","345347","KQ054724v1","2045246","2045378","32","1700027"
"JH378232","467897","468036","KQ053300v1","3146249","3146389","26","2678352"
"JH378232","475855","476162","KQ052981v1","1198440","1198752","69","722585"
"JH378232","502014","502145","KQ053409v1","6573923","6574054","30","6071909"
"JH378232","645792","645872","KQ054091v1","552694","552778","19","93098"
"JH378232","658501","658641","KQ053948v1","2765570","2765701","26","2107069"
"JH378232","906793","907064","KQ054826v1","9895778","9896046","61","8988985"
"JH378232","936681","936813","KQ057910v1","1548802","1548933","25","612121"
"JH378232","937275","937547","KQ058427v1","5781896","5782172","68","4844621"
"JH378232","1190419","1190606","KQ053299v1","776665","776838","53","413754"
"JH378232","1279357","1279571","KQ058242v1","892038","892246","55","387319"
"JH378232","1592006","1592143","KQ053686v1","1108593","1108721","32","483413"
"JH378232","1624601","1624883","KQ054713v1","647552","647834","67","977049"
"JH378232","1710104","1710406","KQ056790v1","446564","446855","69","1263540"
"JH378232","2090686","2090815","KQ053354v1","702320","702452","22","1388366"
"JH378232","2141337","2141513","KQ054660v1","3679956","3680128","39","1538619"
"JH378232","2145361","2145606","KQ057541v1","534229","534482","67","1611132"
"JH378232","2150466","2150713","KQ053115v1","1246859","1247104","67","903607"
"JH378232","2190850","2190982","KQ053202v1","780148","780280","31","1410702"
"JH378232","2220947","2221267","KQ056855v1","2831735","2832032","84","610788"
"JH378232","2430597","2430882","KQ052968v1","13260777","13261056","77","10830180"
"JH378232","2500001","2500154","KQ058345v1","136254","136406","34","2363747"
"JH378232","2533703","2533842","KQ053838v1","798752","798885","31","1734951"
"JH378232","2552048","2552190","KQ057118v1","2873589","2873730","36","321541"
"JH378232","2566378","2566544","KQ053685v1","16639","16818","45","2549739"
"JH378232","2715117","2715324","KQ054069v1","7412441","7412647","58","4697324"
"JH378232","2822561","2822796","KQ053609v1","2642121","2642332","71","180440"
"JH378232","2907429","2907724","KQ052968v1","6035508","6035790","69","3128079"
"JH378232","3220264","3220379","KQ055600v1","267326","267449","22","2952938"
"JH378232","3267264","3267571","KQ058184v1","1505565","1505858","73","1761699"
"JH378232","3308696","3308827","KQ056147v1","2896905","2897037","24","411791"
"JH378232","3309098","3309161","KQ053072v1","197621","197681","18","3111477"
"JH378232","3547423","3547555","KQ055298v1","1575436","1575566","27","1971987"
"JH378232","3753088","3753220","KQ053354v1","702320","702452","23","3050768"
"JH378232","3763469","3763662","KQ058301v1","333804","333994","48","3429665"
"JH378232","3820559","3820691","KQ056475v1","2305251","2305383","28","1515308"
"JH378232","3935104","3935401","KQ053299v1","21869448","21869738","76","17934344"
"JH378232","3952493","3952649","KQ053037v1","3255963","3256108","38","696530"
"JH378232","3953658","3953961","KQ057290v1","2180782","2181079","75","1772876"
"JH378232","4000027","4000299","KQ058413v1","348155","348432","64","3651872"
"JH378232","4024321","4024637","KQ054932v1","5122260","5122524","107","1097939"
"JH378232","4250302","4250439","KQ054932v1","5285465","5285595","32","1035163"
"JH378232","4635307","4635438","KQ053520v1","4869540","4869668","35","234233"
"JH378232","4752693","4752816","KQ053135v1","3445097","3445217","31","1307596"
"JH378232","4794190","4794319","KQ058129v1","667559","667683","33","4126631"
"JH378232","4877715","4878044","KQ053476v1","3546789","3547105","78","1330926"
"JH378232","4919930","4920212","KQ053816v1","7464708","7465010","68","2544778"
"JH378232","5382138","5382426","KQ058605v1","2526722","2527013","66","2855416"
"JH378232","5549701","5549815","KQ058542v1","469843","469958","28","5079858"
"JH378232","6030756","6030924","KQ057603v1","1535538","1535702","34","4495218"
"JH378233","55443","55728","KQ052982v1","2557979","2558263","65","2502536"
"JH378233","205048","205192","KQ053498v1","3548279","3548419","28","3343231"
"JH378233","376017","376126","KQ058403v1","2083243","2083351","29","1707226"
"JH378233","585199","585401","KQ054660v1","4974920","4975121","50","4389721"
"JH378233","725848","726174","KQ052969v1","9116808","9117108","86","8390960"
"JH378233","863765","864063","KQ053093v1","1738898","1739201","67","875133"
"JH378233","945564","945839","KQ055777v1","2252512","2252796","76","1306948"
"JH378233","950174","950380","KQ056345v1","609427","609631","46","340747"
"JH378233","1012311","1012604","KQ053816v1","7464708","7465010","66","6452397"
"JH378233","1201591","1201888","KQ055852v1","1231373","1231668","74","29782"
"JH378233","1222495","1222624","KQ053654v1","4929533","4929667","27","3707038"
"JH378233","1227187","1227478","KQ056973v1","783590","783885","70","443597"
"JH378233","1231739","1232025","KQ058184v1","1505565","1505858","71","273826"
"JH378233","1291642","1291928","KQ057118v1","4601602","4601894","63","3309960"
"JH378233","1636289","1636425","KQ055141v1","3481451","3481584","25","1845162"
"JH378233","1674191","1674303","KQ052969v1","2661859","2661968","31","987668"
"JH378233","3550083","3550363","KQ057909v1","14641987","14642269","73","11091904"
"JH378233","3980241","3980536","KQ055787v1","1064992","1065293","64","2915249"
"JH378233","4037034","4037313","KQ058004v1","3112196","3112474","74","924838"
"JH378233","4270539","4270823","KQ058317v1","5506620","5506904","64","1236081"
"JH378233","4299055","4299354","KQ058394v1","8774432","8774719","94","4475377"
"JH378233","4594364","4594674","KQ056928v1","1915686","1915996","60","2678678"
"JH378233","4609771","4610077","KQ053554v1","2471177","2471484","75","2138594"
"JH378233","5155280","5155530","KQ052970v1","2715607","2715860","61","2439673"
"JH378233","5340617","5340830","KQ053170v1","267257","267471","65","5073360"
"JH378233","5619616","5619917","KQ053288v1","3772705","3772989","75","1846911"
"JH378233","5647510","5647749","KQ054933v1","935520","935770","58","4711990"
"JH378234","74151","74444","KQ054412v1","2490468","2490761","67","2416317"
"JH378234","288037","288248","KQ054921v1","3806549","3806756","56","3518512"
"JH378234","344516","344820","KQ053816v1","7464708","7465010","67","7120192"
"JH378234","668298","668513","KQ058550v1","3053970","3054174","57","2385672"
"JH378234","895036","895197","KQ057649v1","424252","424417","40","470784"
"JH378234","982340","982640","KQ058184v1","1505565","1505858","62","523225"
"JH378234","1185826","1186133","KQ054213v1","780092","780393","65","405734"
"JH378234","1249119","1249346","KQ053741v1","1190544","1190756","52","58575"
"JH378234","1823638","1823918","KQ057726v1","1243606","1243873","72","580032"
"JH378234","1963940","1964062","KQ058042v1","92910","93024","23","1871030"
"JH378234","1989072","1989347","KQ058283v1","3525175","3525450","65","1536103"
"JH378234","2137142","2137420","KQ054412v1","1824448","1824730","59","312694"
"JH378234","2658816","2659095","KQ055490v1","2797344","2797631","70","138528"
"JH378234","3295197","3295455","ABDC02049955v1","1118","1378","64","3294079"
"JH378234","3480505","3480774","KQ058305v1","3371252","3371528","69","109253"
"JH378234","3976733","3976775","KQ057909v1","13231474","13231525","15","9254741"
"JH378234","3977117","3977196","KQ058427v1","6765309","6765385","19","2788192"
"JH378234","4038162","4038457","KQ055247v1","216427","216708","78","3821735"
"JH378234","4049730","4050016","KQ053026v1","3680523","3680807","58","369207"
"JH378234","4152492","4152785","KQ058317v1","5506620","5506904","70","1354128"
"JH378234","4247802","4248090","KQ056494v1","2222182","2222467","70","2025620"
"JH378234","4253125","4253416","KQ056234v1","4712656","4712947","78","459531"
"JH378234","4318297","4318457","KQ054565v1","627778","627936","36","3690519"
"JH378234","4715361","4715495","KQ053686v1","1108593","1108721","34","3606768"
"JH378234","4762003","4762304","KQ056790v1","446564","446855","66","4315439"
"JH378234","4885379","4885670","KQ057693v1","621833","622123","61","4263546"
"JH378234","4933224","4933542","KQ053795v1","1714401","1714699","77","3218823"
"JH378234","4988817","4989077","KQ055978v1","3560415","3560681","68","1428402"
"JH378234","5065515","5065646","KQ058328v1","2150165","2150287","31","2915350"
"JH378234","5333565","5333859","KQ055787v1","1064992","1065293","72","4268573"
"JH378234","5974225","5974500","KQ058294v1","6026641","6026920","71","52416"
"JH378235","56227","56362","KQ054091v1","1184143","1184277","34","1127916"
"JH378235","83759","84020","KQ058383v1","10165252","10165509","61","10081493"
"JH378235","200484","200753","KQ055590v1","2725615","2725902","66","2525131"
"JH378235","352017","352106","KQ055755v1","1329385","1329455","30","977368"
"JH378235","361053","361189","KQ053300v1","2231135","2231263","34","1870082"
"JH378235","363525","363679","KQ058427v1","3400358","3400512","31","3036833"
"JH378235","436002","436301","KQ054693v1","832788","833076","67","396786"
"JH378235","455359","455584","KQ058317v1","3410517","3410729","59","2955158"
"JH378235","697594","697889","KQ058184v1","1505565","1505858","51","807971"
"JH378235","848378","848659","KQ058328v1","6293951","6294242","61","5445573"
"JH378235","1068256","1068388","KQ052968v1","13707910","13708039","32","12639654"
"JH378235","1493829","1494121","KQ056440v1","1157164","1157460","63","336665"
"JH378235","1669640","1669875","KQ057649v1","54936","55173","66","1614704"
"JH378235","1753264","1753455","KQ055065v1","1891639","1891811","56","138375"
"JH378235","1763087","1763360","KQ055309v1","1596833","1597106","65","166254"
"JH378235","2035438","2035722","KQ058324v1","623645","623935","70","1411793"
"JH378235","2149105","2149374","KQ055065v1","1117201","1117481","62","1031904"
"JH378235","2224211","2224513","KQ058184v1","1505565","1505858","63","718646"
"JH378235","2258504","2258634","KQ052970v1","12609564","12609700","27","10351060"
"JH378235","2447809","2448099","KQ055852v1","1231373","1231668","69","1216436"
"JH378235","2475099","2475391","KQ054725v1","2218271","2218569","65","256828"
"JH378235","2629014","2629314","KQ053631v1","9631170","9631468","72","7002156"
"JH378235","2743252","2743536","KQ052969v1","8465928","8466216","66","5722676"
"JH378235","2764126","2764415","KQ053752v1","35796","36072","68","2728330"
"JH378235","2775513","2775806","KQ053465v1","3609319","3609610","66","833806"
"JH378235","2842132","2842361","KQ058328v1","2569266","2569497","54","272866"
"JH378235","2929200","2929482","KQ058190v1","350088","350375","63","2579112"
"JH378235","2988547","2988842","KQ058184v1","1505565","1505858","67","1482982"
"JH378235","3028462","3028598","KQ056320v1","2323247","2323381","36","705215"
"JH378235","3052393","3052704","KQ055014v1","159249","159539","81","2893144"
"JH378235","3245267","3245550","KQ053409v1","3716306","3716585","58","471039"
"JH378235","3329154","3329290","KQ053190v1","4627206","4627347","25","1298052"
"JH378235","3436352","3436640","KQ057290v1","2953971","2954265","61","482381"
"JH378235","3486604","3486742","KQ055457v1","9533075","9533212","37","6046471"
"JH378235","3550827","3551126","KQ055872v1","14090556","14090859","73","10539729"
"JH378235","3625207","3625469","KQ055872v1","2360857","2361124","62","1264350"
"JH378235","3639146","3639438","KQ053146v1","1320586","1320881","74","2318560"
"JH378235","3679890","3680180","KQ057118v1","4601602","4601894","67","921712"
"JH378235","3754741","3755034","KQ054400v1","354368","354668","66","3400373"
"JH378235","3773216","3773388","KQ055140v1","3477076","3477259","37","296140"
"JH378235","3799603","3799906","KQ054786v1","1481220","1481519","64","2318383"
"JH378235","3957324","3957637","KQ052984v1","105454","105757","75","3851870"
"JH378235","4088786","4089043","KQ054725v1","1322157","1322413","61","2766629"
"JH378235","4095567","4095857","KQ058561v1","4466656","4466945","63","371089"
"JH378235","4098682","4098908","KQ053696v1","4325554","4325770","65","226872"
"JH378235","4284178","4284267","KQ053838v1","1840604","1840696","32","2443574"
"JH378235","4317682","4317969","KQ052968v1","13260777","13261056","77","8943095"
"JH378235","4467937","4468197","KQ053059v1","2135970","2136233","60","2331967"
"JH378235","4567323","4567641","KQ054725v1","2218271","2218569","78","2349052"
"JH378235","4765574","4765835","KQ054826v1","303348","303596","82","4462226"
"JH378235","4828288","4828591","KQ052969v1","8840489","8840774","73","4012201"
"JH378235","4839670","4839943","KQ058427v1","4553509","4553777","79","286161"
"JH378235","4931684","4931944","KQ055192v1","1201363","1201615","71","3730321"
"JH378235","5064781","5065075","KQ055097v1","1884579","1884874","61","3180202"
"JH378235","5293760","5293927","KQ057023v1","552794","552951","38","4740966"
"JH378235","5398479","5398643","KQ056996v1","1524030","1524195","33","3874449"
"JH378235","5531836","5532113","KQ056331v1","348695","348980","66","5183141"
"JH378235","5534462","5534773","KQ053894v1","1262767","1263078","70","4271695"
"JH378235","5619754","5620068","KQ054191v1","4157356","4157666","68","1462398"
"JH378235","5775025","5775335","KQ052971v1","6441372","6441626","101","666347"
"JH378235","6003343","6003631","KQ054693v1","832788","833076","58","5170555"
"JH378235","6012983","6013284","KQ054804v1","52712","53011","67","5960271"
"JH378236","118515","118793","KQ053202v1","1134199","1134469","77","1015684"
"JH378236","203155","203463","KQ058184v1","1505565","1505858","61","1302410"
"JH378236","368589","368855","KQ053686v1","963025","963293","72","594436"
"JH378236","462123","462422","KQ053816v1","7464708","7465010","62","7002585"
"JH378236","518353","518640","KQ058105v1","2118391","2118676","77","1600038"
"JH378236","541606","541714","KQ057909v1","13527094","13527201","25","12985488"
"JH378236","666407","666682","KQ054510v1","8518307","8518589","59","7851900"
"JH378236","689976","690311","KQ053343v1","1747702","1748011","90","1057726"
"JH378236","701916","702212","KQ056673v1","1151371","1151663","73","449455"
"JH378236","829664","829774","KQ058004v1","1368020","1368133","32","538356"
"JH378236","843153","843405","KQ054510v1","7193272","7193502","71","6350119"
"JH378236","911881","912178","KQ058582v1","1599482","1599782","73","687601"
"JH378236","965055","965277","KQ053487v1","3972854","3973080","60","3007799"
"JH378236","1335966","1336284","KQ054191v1","3583730","3584032","81","2247764"
"JH378236","1349742","1350047","KQ054068v1","5491779","5492087","65","4142037"
"JH378236","1448678","1448960","KQ053297v1","44026","44315","62","1404652"
"JH378236","1612406","1612684","KQ057004v1","604815","605101","62","1007591"
"JH378236","1935851","1936058","KQ058462v1","452919","453117","46","1482932"
"JH378236","2078767","2079047","KQ057603v1","1306760","1307030","76","772007"
"JH378236","2189921","2190146","KQ054827v1","2292729","2292949","77","102808"
"JH378236","2212984","2213132","KQ054533v1","748660","748796","39","1464324"
"JH378236","2337989","2338289","KQ055978v1","3560415","3560681","90","1222426"
"JH378236","2370734","2370861","KQ053948v1","1299259","1299390","28","1071475"
"JH378236","2494219","2494517","KQ058184v1","1505565","1505858","64","988654"
"JH378236","2505410","2505638","KQ053872v1","262334","262548","55","2243076"
"JH378236","2546090","2546330","KQ052968v1","6916520","6916761","52","4370430"
"JH378236","2557870","2557998","KQ054756v1","16179","16324","39","2541691"
"JH378236","2599479","2599645","KQ056475v1","5275769","5275928","44","2676290"
"JH378236","2606074","2606228","KQ056148v1","7050287","7050441","36","4444213"
"JH378236","2705096","2705312","KQ056404v1","77681","77883","53","2627415"
"JH378236","2722311","2722594","KQ055893v1","2351492","2351779","61","370819"
"JH378236","2810303","2810601","KQ053959v1","5527939","5528237","78","2717636"
"JH378236","3265535","3265817","KQ055777v1","2252512","2252796","75","1013023"
"JH378236","3462508","3462791","KQ053465v1","167701","167983","83","3294807"
"JH378236","3503213","3503360","KQ058004v1","4755337","4755486","31","1252124"
"JH378236","3532161","3532400","KQ058501v1","262278","262510","72","3269883"
"JH378236","3645935","3646200","KQ055978v1","3560415","3560681","81","85520"
"JH378236","3662383","3662665","KQ055097v1","1540055","1540340","76","2122328"
"JH378236","4113247","4113464","KQ056855v1","3783104","3783319","54","330143"
"JH378236","4174604","4174875","KQ054510v1","5210888","5211157","65","1036284"
"JH378236","5862945","5863260","KQ053905v1","3605331","3605611","92","2257614"
"JH378237","713367","713655","KQ058183v1","487423","487710","79","225944"
"JH378237","1125166","1125464","KQ053816v1","7464708","7465010","83","6339542"
"JH378237","1184378","1184480","KQ053850v1","279389","279490","22","904989"
"JH378237","1958753","1958941","KQ053696v1","734685","734878","56","1224068"
"JH378237","2692822","2693112","KQ053398v1","2545768","2546067","79","147054"
"JH378237","3840004","3840244","KQ054069v1","928440","928688","73","2911564"
"JH378237","3859409","3859544","KQ053654v1","4929533","4929667","32","1070124"
"JH378237","3862374","3862667","KQ053115v1","1118362","1118655","58","2744012"
"JH378237","4107751","4108029","KQ055957v1","364218","364491","71","3743533"
"JH378237","4176788","4176917","KQ052970v1","4661614","4661744","27","484826"
"JH378237","4290132","4290425","KQ058184v1","1505565","1505858","62","2784567"
"JH378237","4374273","4374552","KQ058004v1","1480411","1480689","68","2893862"
"JH378237","4427122","4427309","KQ053294v1","648","849","51","4426474"
"JH378237","5550223","5550373","KQ054180v1","70685","70834","37","5479538"
"JH378237","5740429","5740728","KQ054124v1","473618","473911","67","5266811"
"JH378238","327367","327670","KQ057504v1","162767","163049","77","164600"
"JH378238","996341","996511","KQ054879v1","1455515","1455684","45","459174"
"JH378238","1053794","1053919","KQ053299v1","22459675","22459802","26","21405881"
"JH378238","1246315","1246619","KQ057045v1","590946","591241","71","655369"
"JH378238","1698426","1698591","KQ054068v1","2554856","2555034","46","856430"
"JH378238","2085256","2085536","KQ054400v1","2059350","2059621","71","25906"
"JH378238","2277958","2278269","KQ056147v1","190516","190832","91","2087442"
"JH378238","2515901","2516217","KQ053631v1","8893553","8893834","91","6377652"
"JH378238","2698736","2699038","KQ052968v1","5940895","5941196","80","3242159"
"JH378238","2990066","2990218","KQ053157v1","5478543","5478695","43","2488477"
"JH378238","3095067","3095139","KQ053520v1","1561632","1561710","23","1533435"
"JH378238","3374029","3374316","KQ053476v1","3343386","3343662","70","30643"
"JH378238","4077798","4077966","KQ057336v1","635116","635282","42","3442682"
"JH378238","4322987","4323274","KQ054068v1","2986206","2986480","68","1336781"
"JH378238","4435795","4435848","KQ054279v1","852960","853011","9","3582835"
"JH378238","4507726","4508008","KQ052969v1","11182978","11183250","73","6675252"
"JH378238","4868669","4868945","KQ052969v1","11182978","11183250","62","6314309"
"JH378238","4941206","4941515","KQ055872v1","2402427","2402732","63","2538779"
"JH378238","4995904","4996091","KQ058301v1","333804","333994","45","4662100"
"JH378238","5000970","5001125","KQ058316v1","1681267","1681425","36","3319703"
"JH378238","5013734","5013866","KQ056643v1","1491838","1491968","20","3521896"
"JH378238","5032358","5032560","KQ053948v1","2776497","2776701","48","2255861"
"JH378238","5034751","5035052","KQ057004v1","1506143","1506432","58","3528608"
"JH378238","5291079","5291248","KQ058350v1","579975","580134","34","4711104"
"JH378238","5345271","5345554","KQ058561v1","4466656","4466945","61","878615"
"JH378238","5624957","5625267","KQ055457v1","2061137","2061448","58","3563820"
"JH378238","5797410","5797664","KQ058427v1","9096255","9096517","64","3298845"
"JH378239","359181","359346","KQ056996v1","1524030","1524195","33","1164849"
"JH378239","390856","391076","KQ057380v1","2047063","2047290","55","1656207"
"JH378239","405696","405936","KQ058503v1","123813","124064","57","281883"
"JH378239","416702","417029","KQ056108v1","1110776","1111092","82","694074"
"JH378239","434519","434682","KQ055872v1","5870772","5870928","37","5436253"
"JH378239","461509","461698","KQ054933v1","3939617","3939804","44","3478108"
"JH378239","484895","485165","KQ057603v1","1306760","1307030","71","821865"
"JH378239","496375","496513","KQ054279v1","76889","77022","23","419486"
"JH378239","567616","567669","KQ057118v1","3429344","3429385","22","2861728"
"JH378239","603681","603989","KQ055014v1","2457670","2457960","85","1853989"
"JH378239","645661","645911","KQ054510v1","8112428","8112664","75","7466767"
"JH378239","823078","823321","KQ052971v1","6441372","6441626","65","5618294"
"JH378239","853008","853304","KQ053070v1","533496","533791","73","319512"
"JH378239","858196","858339","KQ054466v1","1866785","1866925","27","1008589"
"JH378239","1006555","1006843","KQ056331v1","106636","106916","77","899919"
"JH378239","1162164","1162455","KQ053288v1","1322394","1322691","73","160230"
"JH378239","1288212","1288525","KQ053752v1","6338004","6338314","81","5049792"
"JH378239","1300417","1300698","KQ054868v1","2229582","2229854","72","929165"
"JH378239","1487270","1487589","KQ057702v1","1420535","1420827","86","66735"
"JH378239","1922374","1922676","KQ054412v1","2490468","2490761","63","568094"
"JH378239","2117055","2117329","KQ058379v1","21379","21640","69","2095676"
"JH378239","2136790","2137138","KQ054660v1","1378777","1379079","107","758013"
"JH378239","2138584","2138699","KQ056973v1","1531147","1531277","26","607437"
"JH378239","2174460","2174756","KQ057118v1","4601602","4601894","63","2427142"
"JH378239","2187901","2188005","KQ053310v1","1622751","1622859","21","565150"
"JH378239","2188149","2188354","KQ056404v1","77681","77883","63","2110468"
"JH378239","2192923","2193200","KQ058383v1","5944247","5944518","62","3751324"
"JH378239","2230678","2230975","KQ058585v1","580456","580763","62","1650222"
"JH378239","2272263","2272529","KQ058383v1","5122379","5122654","60","2850116"
"JH378239","2385737","2386042","KQ054423v1","1159875","1160173","67","1225862"
"JH378239","2517146","2517443","KQ058383v1","6917259","6917555","68","4400113"
"JH378239","2596309","2596592","KQ053202v1","1134199","1134469","70","1462110"
"JH378239","2599483","2599774","KQ054124v1","2442155","2442433","75","157328"
"JH378239","2631051","2631358","KQ054400v1","4609733","4610042","79","1978682"
"JH378239","2969690","2969888","KQ058250v1","230291","230481","55","2739399"
"JH378239","2970176","2970266","KQ057909v1","14813149","14813240","21","11842973"
"JH378239","3057044","3057356","KQ053816v1","7327018","7327317","65","4269974"
"JH378239","3236766","3237059","KQ053288v1","2218996","2219287","72","1017770"
"JH378239","3321476","3321778","KQ052969v1","9116808","9117108","67","5795332"
"JH378239","3384065","3384302","KQ054510v1","8112428","8112664","74","4728363"
"JH378239","3508648","3508951","KQ054191v1","3857584","3857880","66","348936"
"JH378239","3567981","3568257","KQ058494v1","4837812","4838086","70","1269831"
"JH378239","3683435","3683732","KQ052970v1","4138682","4138959","87","455247"
"JH378239","3762760","3763077","KQ053894v1","1290632","1290924","75","2472128"
"JH378239","4058151","4058362","KQ054693v1","3245566","3245803","67","812585"
"JH378239","4127595","4127887","KQ056672v1","3082150","3082439","74","1045445"
"JH378239","4271355","4271624","KQ055065v1","1117201","1117481","58","3154154"
"JH378239","4273782","4273839","KQ053894v1","495450","495515","20","3778332"
"JH378239","4274444","4274571","KQ054890v1","666308","666433","37","3608136"
"JH378239","4373715","4373993","KQ053048v1","4253920","4254187","73","119795"
"JH378239","4564377","4564544","KQ052968v1","10427732","10427888","39","5863355"
"JH378239","4672836","4673119","KQ058550v1","2728733","2729016","57","1944103"
"JH378239","4716056","4716337","KQ054745v1","919926","920212","69","3796130"
"JH378239","4938018","4938185","KQ054713v1","2940409","2940578","34","1997609"
"JH378239","5091989","5092117","KQ058594v1","5704561","5704688","35","612572"
"JH378239","5097941","5098230","KQ056147v1","1064032","1064323","71","4033909"
"JH378239","5252285","5252538","KQ054068v1","2000305","2000565","59","3251980"
"JH378239","5252630","5252689","KQ053620v1","931136","931196","16","4321494"
"JH378239","5339984","5340118","KQ054921v1","3001829","3001962","28","2338155"
"JH378239","5363270","5363557","KQ056475v1","2179070","2179363","66","3184200"
"JH378239","5424272","5424528","KQ056920v1","346245","346510","78","5078027"
"JH378239","5431252","5431396","KQ055183v1","2514156","2514302","31","2917096"
"JH378239","5459560","5459727","KQ053288v1","1672177","1672324","50","3787383"
"JH378240","380766","381075","KQ056790v1","1807975","1808279","77","1427209"
"JH378240","391326","391627","KQ058184v1","1505565","1505858","66","1114239"
"JH378240","1299067","1299374","KQ058184v1","1505565","1505858","67","206498"
"JH378240","1581189","1581482","KQ055140v1","3423560","3423842","74","1842371"
"JH378240","1595182","1595442","KQ058183v1","87868","88123","76","1507314"
"JH378240","1643671","1643979","KQ058184v1","1505565","1505858","73","138106"
"JH378240","1717005","1717280","KQ054290v1","1454980","1455264","55","262025"
"JH378240","2210204","2210496","KQ055097v1","2825545","2825834","73","615341"
"JH378240","2250524","2250679","KQ056147v1","70626","70780","42","2179898"
"JH378240","2650484","2650784","KQ057702v1","1237368","1237672","81","1413116"
"JH378240","2703349","2703481","KQ057702v1","1862724","1862857","29","840625"
"JH378240","2728353","2728636","KQ058533v1","977692","977970","62","1750661"
"JH378240","2780042","2780216","KQ054068v1","2554856","2555034","49","225186"
"JH378240","2854933","2855053","KQ056147v1","1962111","1962234","23","892822"
"JH378240","2855161","2855306","KQ053146v1","2315136","2315281","31","540025"
"JH378240","2883813","2884082","KQ052982v1","2385971","2386246","76","497842"
"JH378240","2889639","2889868","KQ055457v1","1902633","1902878","65","987006"
"JH378240","2897220","2897514","KQ058257v1","559477","559763","62","2337743"
"JH378240","3022745","3023029","KQ053332v1","447571","447853","68","2575174"
"JH378240","3090283","3090540","KQ053299v1","22323868","22324139","66","19233585"
"JH378240","4098470","4098743","KQ055725v1","3090816","3091074","67","1007654"
"JH378240","4352665","4352969","KQ053816v1","7464708","7465010","66","3112043"
"JH378240","4510700","4511003","KQ053146v1","920355","920648","71","3590345"
"JH378240","5334232","5334289","KQ053556v1","5700","5760","17","5328532"
"JH378241","32660","32867","KQ054401v1","3245220","3245428","54","3212560"
"JH378241","251296","251577","KQ053297v1","44026","44315","78","207270"
"JH378241","300237","300551","KQ057693v1","117172","117472","63","183065"
"JH378241","431741","431876","KQ054135v1","1889077","1889201","42","1457336"
"JH378241","1024508","1024800","KQ053081v1","2760355","2760643","68","1735847"
"JH378241","1051176","1051315","KQ054466v1","1866785","1866925","35","815609"
"JH378241","1075039","1075352","KQ054191v1","4157356","4157666","67","3082317"
"JH378241","1124623","1124889","KQ055352v1","5784468","5784732","77","4659845"
"JH378241","1201810","1202088","KQ054693v1","837377","837666","67","364433"
"JH378241","1714938","1715231","KQ056331v1","106636","106916","63","1608302"
"JH378241","1829597","1829907","KQ056928v1","1915686","1915996","66","86089"
"JH378241","1860672","1860975","KQ055777v1","2840700","2840988","82","980028"
"JH378241","3083638","3083913","KQ053332v1","447571","447853","76","2636067"
"JH378241","3408080","3408229","KQ056147v1","70626","70780","45","3337454"
"JH378241","3424559","3424851","KQ056147v1","3586811","3587109","78","162252"
"JH378241","3482905","3483081","KQ055808v1","1858979","1859156","47","1623926"
"JH378241","4169184","4169470","KQ058352v1","470540","470817","66","3698644"
"JH378241","4242832","4243130","KQ054213v1","780092","780393","61","3462740"
"JH378241","4495052","4495340","KQ053409v1","3716306","3716585","70","778746"
"JH378241","4495341","4495470","KQ053354v1","702320","702452","25","3793021"
"JH378241","4716449","4716731","KQ058299v1","1080259","1080541","63","3636190"
"JH378241","4846720","4846859","KQ052969v1","7619400","7619543","29","2772680"
"JH378241","4866515","4866789","KQ058527v1","4814329","4814604","73","52186"
"JH378241","5143711","5143888","KQ053179v1","1735404","1735576","39","3408307"
"JH378241","5195096","5195365","KQ056423v1","1792966","1793243","73","3402130"
"JH378241","5202769","5203058","KQ054693v1","832788","833076","59","4369981"
"JH378241","5260931","5261002","KQ057317v1","272227","272303","19","4988704"
"JH378241","5356932","5357182","KQ058291v1","570212","570475","63","4786720"
"JH378241","5381336","5381626","KQ054815v1","1502173","1502462","72","3879163"
"JH378241","5428452","5428674","KQ058190v1","1075454","1075684","64","4352998"
"JH378242","137295","137573","KQ058275v1","938649","938919","68","801354"
"JH378242","249068","249385","KQ058539v1","1057985","1058283","76","808917"
"JH378242","365384","365676","KQ058184v1","1505565","1505858","59","1140181"
"JH378242","425241","425362","KQ056148v1","3961494","3961621","25","3536253"
"JH378242","526061","526358","KQ054510v1","8555095","8555387","61","8029034"
"JH378242","605141","605262","KQ058550v1","2678881","2679004","21","2073740"
"JH378242","627108","627387","KQ053299v1","3496585","3496844","85","2869477"
"JH378242","627427","627721","KQ058184v1","1505565","1505858","67","878138"
"JH378242","645386","645690","KQ053299v1","4095914","4096215","72","3450528"
"JH378242","702701","702933","KQ053686v1","2718006","2718245","56","2015305"
"JH378242","709258","709422","KQ055425v1","1445594","1445758","40","736336"
"JH378242","753887","754218","KQ053894v1","566617","566947","95","187270"
"JH378242","865638","865923","KQ055978v1","3560415","3560681","77","2694777"
"JH378242","877951","878243","KQ057373v1","1224950","1225260","74","346999"
"JH378242","912970","913091","KQ056035v1","296324","296444","31","616646"
"JH378242","1319839","1319936","KQ057373v1","250437","250530","35","1069402"
"JH378242","1345596","1345811","KQ054932v1","10432562","10432772","66","9086966"
"JH378242","1421688","1421952","KQ054713v1","3140905","3141166","75","1719217"
"JH378242","1508749","1508892","ABDC02047922v1","197","340","39","1508552"
"JH378242","1524034","1524240","KQ056996v1","148346","148555","43","1375688"
"JH378242","1555413","1555707","KQ058561v1","4466656","4466945","68","2911243"
"JH378242","1595275","1595418","KQ053971v1","2520321","2520463","34","925046"
"JH378242","1653369","1653682","KQ054191v1","3857584","3857880","73","2204215"
"JH378242","1691180","1691472","KQ058512v1","329344","329634","70","1361836"
"JH378242","1745824","1746124","KQ057036v1","502032","502329","66","1243792"
"JH378242","1823653","1823768","KQ053299v1","22459675","22459802","30","20636022"
"JH378242","1930818","1930934","KQ053849v1","2918468","2918588","37","987650"
"JH378242","1951383","1951696","KQ057449v1","1989308","1989615","85","37925"
"JH378242","1977009","1977132","KQ054356v1","1379018","1379142","33","597991"
"JH378242","1977865","1978086","KQ053354v1","3886847","3887045","71","1908982"
"JH378242","2007705","2007958","KQ053565v1","2341738","2341996","73","334033"
"JH378242","2008028","2008357","KQ055119v1","3293975","3294284","81","1285947"
"JH378242","2048476","2048619","KQ053299v1","11502285","11502431","36","9453809"
"JH378242","2208239","2208519","KQ055651v1","3516059","3516345","71","1307820"
"JH378242","2297110","2297249","KQ053190v1","4771351","4771483","38","2474241"
"JH378242","2304403","2304601","KQ056166v1","1004668","1004858","54","1299735"
"JH378242","2355988","2356266","KQ053409v1","5686466","5686740","58","3330478"
"JH378242","2410702","2410992","KQ054400v1","354368","354668","66","2056334"
"JH378242","2413853","2414136","KQ053520v1","456408","456696","76","1957445"
"JH378242","2554220","2554464","KQ055518v1","1576074","1576315","66","978146"
"JH378242","2565225","2565519","KQ058184v1","1505565","1505858","65","1059660"
"JH378242","2601861","2602125","KQ055192v1","1201363","1201615","71","1400498"
"JH378242","2665154","2665274","KQ057118v1","3875160","3875276","33","1210006"
"JH378242","3032555","3032621","KQ055893v1","2912845","2912909","21","119710"
"JH378242","3032804","3033003","KQ055862v1","1603660","1603857","60","1429144"
"JH378242","3145778","3146064","KQ058004v1","3112196","3112474","82","33582"
"JH378242","3216350","3216632","KQ057390v1","1381328","1381610","65","1835022"
"JH378242","3245236","3245403","KQ055498v1","556944","557105","46","2688292"
"JH378242","3457079","3457373","KQ055247v1","895463","895756","73","2561616"
"JH378242","4138923","4139177","KQ054826v1","9969237","9969502","58","5830314"
"JH378242","4263350","4263630","KQ053190v1","4987885","4988162","69","724535"
"JH378242","4716566","4716854","KQ058184v1","1505565","1505858","73","3211001"
"JH378242","5187594","5187906","KQ058184v1","1505565","1505858","75","3682029"
"JH378242","5274634","5274964","KQ053299v1","4095914","4096215","88","1178720"
"JH378243","21021","21320","KQ054401v1","2629005","2629296","72","2607984"
"JH378243","81183","81372","KQ053966v1","301124","301319","49","219941"
"JH378243","85207","85486","KQ058317v1","5506620","5506904","55","5421413"
"JH378243","104981","105286","KQ055192v1","948049","948357","67","843068"
"JH378243","146472","146766","KQ053631v1","9963313","9963601","58","9816841"
"JH378243","150588","150903","KQ058427v1","7552507","7552810","72","7401919"
"JH378243","220941","221071","KQ057883v1","1224468","1224597","28","1003527"
"JH378243","1634089","1634344","KQ054713v1","840037","840292","76","794052"
"JH378243","1709227","1709511","KQ053609v1","2483327","2483619","69","774100"
"JH378243","2433663","2433964","KQ058184v1","1505565","1505858","54","928098"
"JH378243","2436937","2437235","KQ058184v1","1505565","1505858","73","931372"
"JH378243","2476034","2476331","KQ058328v1","6293951","6294242","70","3817917"
"JH378243","2565917","2566014","KQ053838v1","1840604","1840696","36","725313"
"JH378243","3459250","3459536","KQ053332v1","447571","447853","63","3011679"
"JH378243","3521287","3521481","KQ058494v1","668098","668289","46","2853189"
"JH378243","3759046","3759295","KQ054984v1","152087","152331","78","3606959"
"JH378243","4642936","4643234","KQ054565v1","836477","836767","62","3806459"
"JH378243","4682829","4683021","KQ054652v1","6051","6229","50","4676778"
"JH378243","4683483","4683591","KQ053916v1","191904","192015","26","4491579"
"JH378243","4685822","4686134","KQ053135v1","3156167","3156481","73","1529655"
"JH378243","4711343","4711487","KQ053310v1","2640191","2640334","41","2071152"
"JH378244","986388","986669","KQ053409v1","5686466","5686740","69","4700078"
"JH378244","1222596","1222875","KQ058533v1","977692","977970","64","244904"
"JH378244","1446920","1447171","KQ054124v1","2751753","2752002","70","1304833"
"JH378244","1545087","1545256","KQ054660v1","3679956","3680128","41","2134869"
"JH378244","1883576","1883663","KQ056494v1","3420476","3420570","21","1536900"
"JH378244","2069971","2070105","KQ053146v1","2799678","2799801","25","729707"
"JH378244","2203611","2203896","KQ057648v1","78808","79100","65","2124803"
"JH378244","2375747","2375880","KQ053948v1","2765570","2765701","24","389823"
"JH378244","2479638","2479943","KQ053212v1","1560173","1560471","70","919465"
"JH378244","2558268","2558363","KQ053816v1","6703101","6703179","29","4144833"
"JH378244","2559045","2559197","KQ057136v1","1436079","1436229","35","1122966"
"JH378244","2839598","2839856","KQ053827v1","5299575","5299848","66","2459977"
"JH378244","3162024","3162256","KQ053587v1","1788518","1788751","60","1373506"
"JH378244","3166769","3167045","KQ057118v1","4601602","4601894","77","1434833"
"JH378244","3197209","3197500","KQ052969v1","8840489","8840774","73","5643280"
"JH378244","3307890","3308189","KQ053054v1","129769","130073","72","3178121"
"JH378244","3350857","3351012","KQ056837v1","1376328","1376481","34","1974529"
"JH378244","3487948","3488081","KQ055872v1","4808828","4808960","24","1320880"
"JH378244","3587771","3587851","KQ055173v1","599075","599150","20","2988696"
"JH378244","3696401","3696702","KQ053212v1","1560173","1560471","71","2136228"
"JH378244","4095125","4095248","KQ056035v1","296324","296444","23","3798801"
"JH378244","4321939","4322195","KQ058550v1","5126897","5127128","76","804958"
"JH378244","4346307","4346608","KQ055872v1","3534333","3534634","62","811974"
"JH378244","4537921","4538089","KQ055457v1","11733685","11733859","44","7195764"
"JH378244","4538688","4538807","KQ058350v1","1062787","1062904","31","3475901"
"JH378244","4577350","4577634","KQ054069v1","955693","955974","69","3621657"
"JH378244","4636964","4637262","KQ053115v1","1118362","1118655","74","3518602"
"JH378244","4696196","4696352","KQ055014v1","682174","682339","44","4014022"
"JH378244","4712083","4712358","KQ053487v1","1481124","1481401","77","3230959"
"JH378244","4727467","4727771","KQ054191v1","3583730","3584032","62","1143737"
"JH378244","4731115","4731168","KQ055384v1","420057","420110","15","4311058"
"JH378245","3408","3611","KQ054921v1","3806549","3806756","55","3803141"
"JH378245","30856","31060","KQ054124v1","4660657","4660862","59","4629801"
"JH378245","106439","106556","KQ055498v1","20783","20899","24","85656"
"JH378245","374510","374818","KQ056790v1","446564","446855","91","72054"
"JH378245","485602","485915","KQ054725v1","2090703","2091002","75","1605101"
"JH378245","505744","505924","KQ054068v1","2568398","2568574","61","2062654"
"JH378245","545628","545891","KQ058539v1","60805","61074","68","484823"
"JH378245","585268","585422","KQ053421v1","820099","820261","44","234831"
"JH378245","591921","592195","KQ054693v1","832788","833076","68","240867"
"JH378245","593647","593810","KQ056996v1","1524030","1524195","29","930383"
"JH378245","628762","629068","KQ053212v1","1560173","1560471","71","931411"
"JH378245","630741","631035","KQ053631v1","460848","461138","81","169893"
"JH378245","765162","765467","KQ053631v1","9631170","9631468","72","8866008"
"JH378245","931786","932054","KQ056375v1","113511","113776","84","818275"
"JH378245","1137054","1137339","KQ057909v1","14641987","14642269","69","13504933"
"JH378245","1413622","1413950","KQ056234v1","2521120","2521411","97","1107498"
"JH378245","1529870","1529986","KQ056527v1","169","285","26","1529701"
"JH378245","1539950","1540224","ABDC02003384v1","193955","194231","73","1345995"
"JH378245","1601152","1601416","KQ055662v1","4683524","4683789","77","3082372"
"JH378245","1794462","1794727","KQ056268v1","840558","840818","70","953904"
"JH378245","1859840","1860153","KQ056148v1","430759","431072","67","1429081"
"JH378245","2165199","2165490","KQ054356v1","1600089","1600380","58","565110"
"JH378245","2166761","2166892","KQ057648v1","2314551","2314685","19","147790"
"JH378245","2184355","2184663","KQ055352v1","2812321","2812635","78","627966"
"JH378245","2416978","2417207","KQ057345v1","223285","223507","52","2193693"
"JH378245","2468482","2468828","KQ054932v1","7379258","7379569","103","4910776"
"JH378245","2602711","2603003","KQ052970v1","6659487","6659775","64","4056776"
"JH378245","2624230","2624329","KQ053763v1","508269","508363","24","2115961"
"JH378245","2686440","2686688","KQ058353v1","1449127","1449389","71","1237313"
"JH378245","2710234","2710581","KQ053190v1","6566399","6566709","111","3856165"
"JH378245","2718663","2718938","KQ055518v1","2146788","2147072","69","571875"
"JH378245","2812004","2812321","KQ058582v1","1599482","1599782","70","1212522"
"JH378245","2840999","2841299","KQ053082v1","1023453","1023747","72","1817546"
"JH378245","2842365","2842577","KQ054081v1","1002095","1002297","58","1840270"
"JH378245","3043024","3043249","KQ054069v1","159011","159235","57","2884013"
"JH378245","3048716","3049044","KQ053157v1","794390","794702","88","2254326"
"JH378245","3128148","3128298","KQ053288v1","28257","28404","33","3099891"
"JH378245","3175838","3176137","KQ053654v1","3349196","3349482","60","173358"
"JH378245","3362097","3362365","KQ057290v1","2469746","2470009","54","892351"
"JH378245","3558907","3559090","KQ058094v1","5908019","5908204","54","2349112"
"JH378245","3585105","3585368","KQ053752v1","35796","36072","73","3549309"
"JH378245","3611757","3612034","KQ054289v1","4355551","4355817","83","743794"
"JH378245","3632089","3632245","KQ057737v1","5627336","5627495","45","1995247"
"JH378245","3632496","3632628","KQ053861v1","8359","8490","27","3624137"
"JH378245","3633691","3633991","KQ058184v1","1505565","1505858","67","2128126"
"JH378245","3704434","3704602","KQ055766v1","4560542","4560706","37","856108"
"JH378245","3798739","3799007","KQ053631v1","6939636","6939913","66","3140897"
"JH378245","3895782","3895875","KQ056014v1","311566","311664","21","3584216"
"JH378245","4058034","4058257","KQ054704v1","483937","484161","54","3574097"
"JH378245","4230577","4230847","KQ057755v1","45985","46262","61","4184592"
"JH378245","4290567","4290865","KQ057118v1","4601602","4601894","77","311035"
"JH378245","4316415","4316517","KQ053785v1","828746","828862","30","3487669"
"JH378245","4317429","4317606","KQ054510v1","8888528","8888700","35","4571099"
"JH378245","4495534","4495607","KQ054301v1","3456273","3456342","14","1039261"
"JH378245","4577996","4578298","KQ055540v1","208375","208677","78","4369621"
"JH378245","4672829","4673126","KQ055097v1","2825545","2825834","78","1847284"
"JH378245","4676990","4677280","KQ053157v1","7882293","7882588","67","3205303"
"JH378246","136194","136479","KQ056928v1","274365","274652","70","138171"
"JH378246","200360","200671","KQ056404v1","176748","177054","65","23612"
"JH378246","206438","206726","KQ055065v1","999059","999338","66","792621"
"JH378246","480916","481198","KQ058316v1","4697990","4698273","60","4217074"
"JH378246","594133","594425","KQ055852v1","1231373","1231668","68","637240"
"JH378246","594911","595191","KQ058427v1","5781896","5782172","74","5186985"
"JH378246","668859","669132","KQ058561v1","4466656","4466945","68","3797797"
"JH378246","706769","707073","KQ053554v1","2528691","2528989","70","1821922"
"JH378246","736057","736289","KQ057764v1","2088730","2088934","65","1352673"
"JH378246","1047858","1048138","KQ053297v1","44026","44315","66","1003832"
"JH378246","1225227","1225510","KQ054069v1","955693","955974","62","269534"
"JH378246","1245731","1246015","KQ052969v1","11182978","11183250","67","9937247"
"JH378246","1820144","1820417","KQ053299v1","3284099","3284383","70","1463955"
"JH378246","1849351","1849653","KQ053816v1","7327018","7327317","70","5477667"
"JH378246","1898115","1898412","KQ057108v1","2064599","2064896","75","166484"
"JH378246","1900303","1900408","KQ053299v1","10212827","10212927","29","8312524"
"JH378246","1938895","1939106","KQ056996v1","148346","148555","48","1790549"
"JH378246","1953762","1954025","KQ058595v1","270580","270831","69","1683182"
"JH378246","2037343","2037606","KQ053498v1","3849819","3850073","73","1812476"
"JH378246","2341636","2341725","KQ056672v1","4497643","4497736","18","2156007"
"JH378246","2354157","2354324","KQ054682v1","1659123","1659287","37","695034"
"JH378246","2399239","2399543","KQ055298v1","2837169","2837476","73","437930"
"JH378246","2696461","2696584","KQ053026v1","2376723","2376841","23","319738"
"JH378246","3142584","3142858","KQ058325v1","1208232","1208503","67","1934352"
"JH378246","3150717","3150958","KQ053026v1","2213601","2213834","62","937116"
"JH378246","3171271","3171389","KQ058594v1","4333954","4334068","34","1162683"
"JH378246","3282812","3283126","KQ054400v1","4609733","4610042","82","1326921"
"JH378246","3321779","3322062","KQ053827v1","4198964","4199247","70","877185"
"JH378246","3403364","3403647","KQ056673v1","1151371","1151663","73","2251993"
"JH378246","3437601","3437883","KQ055978v1","4723834","4724112","79","1286233"
"JH378246","4572865","4573176","KQ058317v1","5506620","5506904","78","933755"
"JH378246","4602907","4603211","KQ055893v1","1276515","1276814","69","3326392"
"JH378246","4613925","4614213","KQ054510v1","9222042","9222321","60","4608117"
"JH378247","108495","108644","KQ055375v1","281063","281205","34","172568"
"JH378247","751182","751480","KQ058184v1","1505565","1505858","54","754383"
"JH378247","808083","808344","KQ053299v1","3706491","3706755","79","2898408"
"JH378247","977262","977408","KQ056055v1","2764","2905","32","974498"
"JH378247","1039118","1039282","KQ057291v1","765415","765578","37","273703"
"JH378247","1141742","1142003","KQ055364v1","1919520","1919774","67","777778"
"JH378247","1246121","1246439","KQ053299v1","4095914","4096215","73","2849793"
"JH378247","1722943","1723064","KQ054910v1","259538","259645","50","1463405"
"JH378247","1872907","1873044","KQ057648v1","2314551","2314685","28","441644"
"JH378247","2518355","2518572","KQ058004v1","2720169","2720394","47","201814"
"JH378247","2592074","2592257","KQ056587v1","7602017","7602187","36","5009943"
"JH378247","2605119","2605427","KQ053774v1","416886","417189","59","2188233"
"JH378247","2718410","2718719","KQ055490v1","442825","443132","76","2275585"
"JH378247","2818320","2818624","KQ056672v1","3535300","3535593","83","716980"
"JH378247","2849826","2850085","KQ058427v1","7850908","7851135","79","5001082"
"JH378247","2873245","2873451","KQ058301v1","333804","333994","51","2539441"
"JH378247","2977092","2977371","KQ053609v1","2550928","2551200","67","426164"
"JH378247","3064513","3064654","KQ053300v1","3146249","3146389","24","81736"
"JH378247","3098886","3098997","KQ055808v1","1908479","1908585","32","1190407"
"JH378247","3148066","3148369","KQ054113v1","1515164","1515476","72","1632902"
"JH378247","3184081","3184249","KQ053037v1","631347","631512","38","2552734"
"JH378247","3378037","3378140","KQ053675v1","1335502","1335608","25","2042535"
"JH378247","3726907","3727084","KQ054412v1","2471643","2471804","50","1255264"
"JH378247","3780853","3781183","KQ058316v1","2150959","2151268","95","1629894"
"JH378247","3888516","3888812","KQ053212v1","1560173","1560471","58","2328343"
"JH378247","4134347","4134525","KQ053643v1","2807353","2807529","51","1326994"
"JH378247","4353027","4353179","KQ055540v1","1152413","1152570","39","3200614"
"JH378247","4358783","4358998","KQ055375v1","2261003","2261228","54","2097780"
"JH378247","4435571","4435696","KQ053432v1","5514393","5514523","36","1078822"
"JH378247","4518965","4519234","KQ053126v1","1419293","1419571","67","3099672"
"JH378247","4536712","4536855","KQ054401v1","3742804","3742954","39","793908"
"JH378247","4536961","4537186","KQ058004v1","2720169","2720394","43","1816792"
"JH378247","4544024","4544174","KQ054533v1","1027813","1027974","34","3516211"
"JH378247","4545748","4545924","KQ052968v1","13535456","13535639","50","8989708"
"JH378248","197496","197660","KQ053421v1","820099","820261","49","622603"
"JH378248","220689","220965","KQ053146v1","2819587","2819868","55","2598898"
"JH378248","224313","224467","KQ054660v1","3603105","3603267","38","3378792"
"JH378248","254872","254988","KQ053586v1","14796","14909","37","240076"
"JH378248","415530","415816","KQ058539v1","1700786","1701070","68","1285256"
"JH378248","600203","600465","KQ054713v1","840037","840292","68","239834"
"JH378248","665684","665954","KQ054652v1","4505","4775","64","661179"
"JH378248","780640","780793","KQ056147v1","2168964","2169108","35","1388324"
"JH378248","801502","801811","KQ055036v1","4936193","4936498","75","4134691"
"JH378248","984311","984572","KQ058383v1","2699813","2700083","74","1715502"
"JH378248","988200","988275","KQ053310v1","2141084","2141158","19","1152884"
"JH378248","1045941","1046066","KQ057909v1","14636622","14636750","27","13590681"
"JH378248","1114854","1114983","KQ057909v1","9285027","9285152","41","8170173"
"JH378248","1155143","1155272","KQ055044v1","499212","499335","31","655931"
"JH378248","1192062","1192198","KQ053409v1","6105325","6105446","26","4913263"
"JH378248","1248154","1248231","KQ055651v1","2196723","2196803","28","948569"
"JH378248","1262601","1262833","KQ056345v1","609427","609631","74","653174"
"JH378248","1394278","1394537","KQ058328v1","2569266","2569497","68","1174988"
"JH378248","2011234","2011498","KQ058379v1","21379","21640","65","1989855"
"JH378248","2258911","2259048","KQ058257v1","652425","652556","32","1606486"
"JH378248","2266671","2266974","KQ058291v1","406175","406478","58","1860496"
"JH378248","2268486","2268707","KQ056234v1","4592339","4592554","57","2323853"
"JH378248","2474476","2474777","KQ055140v1","3617842","3618146","70","1143366"
"JH378248","2665614","2665870","KQ054826v1","9969237","9969502","55","7303623"
"JH378248","3002303","3002599","KQ057118v1","2470263","2470561","73","532040"
"JH378248","3103216","3103475","KQ053993v1","1017100","1017367","67","2086116"
"JH378248","3123963","3124251","KQ053135v1","2766167","2766465","69","357796"
"JH378248","3343020","3343182","KQ058483v1","5621339","5621499","35","2278319"
"JH378248","3395081","3395357","KQ053191v1","614334","614618","69","2780747"
"JH378248","3522665","3522964","KQ054786v1","735518","735827","72","2787147"
"JH378248","3592292","3592589","KQ058272v1","5443874","5444159","68","1851582"
"JH378248","3775110","3775435","KQ056375v1","523131","523440","74","3251979"
"JH378248","3919186","3919467","KQ057291v1","667476","667747","71","3251710"
"JH378248","4095485","4095773","KQ058328v1","6293951","6294242","70","2198466"
"JH378249","149302","149603","KQ054693v1","832788","833076","76","683486"
"JH378249","372942","373244","KQ058272v1","6007682","6007982","66","5634740"
"JH378249","643019","643268","KQ058283v1","3525175","3525450","79","2882156"
"JH378249","657177","657455","KQ058272v1","5443874","5444159","71","4786697"
"JH378249","696750","697081","KQ054510v1","2681434","2681749","78","1984684"
"JH378249","983542","983800","KQ057223v1","124007","124258","71","859535"
"JH378249","1045437","1045581","KQ054378v1","157932","158074","33","887505"
"JH378249","1226052","1226215","KQ053190v1","5047993","5048157","41","3821941"
"JH378249","1972768","1973071","KQ053554v1","2471177","2471484","71","498409"
"JH378249","2155491","2155763","KQ053299v1","11017319","11017592","69","8861828"
"JH378249","2160120","2160403","KQ056035v1","311208","311497","77","1848912"
"JH378249","2200209","2200501","KQ053774v1","935995","936267","84","1264214"
"JH378249","3726619","3726935","KQ053212v1","2900872","2901182","75","825747"
"JH378249","3839538","3839736","KQ052969v1","8528994","8529192","65","4689456"
"JH378249","4033694","4033826","KQ053115v1","1333586","1333718","26","2700108"
"JH378249","4244972","4245244","KQ058291v1","474599","474881","70","3770373"
"JH378250","162404","162653","KQ053004v1","3311097","3311344","54","3148693"
"JH378250","185873","186163","KQ058184v1","1505565","1505858","56","1319692"
"JH378250","414421","414739","KQ054682v1","2237365","2237671","75","1822944"
"JH378250","769125","769225","KQ053157v1","203721","203827","23","565404"
"JH378250","781476","781765","KQ053654v1","820983","821268","68","39507"
"JH378250","804859","805113","KQ053409v1","2693050","2693293","61","1888191"
"JH378250","935718","936053","KQ058316v1","3835362","3835700","89","2899644"
"JH378250","1128602","1128924","KQ054400v1","4609733","4610042","74","3481131"
"JH378250","1636128","1636423","KQ054510v1","8555095","8555387","65","6918967"
"JH378250","1833058","1833351","KQ058094v1","7832529","7832815","66","5999471"
"JH378250","1927408","1927656","KQ055457v1","1902633","1902878","60","24775"
"JH378250","2048627","2048945","KQ054068v1","1399948","1400246","87","648679"
"JH378250","2109318","2109598","KQ057737v1","2756211","2756494","74","646893"
"JH378250","2171085","2171307","KQ058427v1","7850908","7851135","54","5679823"
"JH378250","2181539","2181854","KQ055787v1","694393","694708","72","1487146"
"JH378250","2187807","2188118","KQ054565v1","676983","677291","72","1510824"
"JH378250","2550581","2550847","KQ057035v1","2309844","2310112","62","240737"
"JH378250","2673785","2674101","KQ053299v1","4095914","4096215","78","1422129"
"JH378250","2685139","2685346","KQ053294v1","648","849","52","2684491"
"JH378250","2690395","2690660","KQ053004v1","2107939","2108219","69","582456"
"JH378250","2729920","2730101","KQ054682v1","2336064","2336208","75","393856"
"JH378250","2863935","2864068","KQ058427v1","4756553","4756686","25","1892618"
"JH378250","3520632","3520782","KQ053157v1","4288391","4288538","37","767759"
"JH378250","3918083","3918383","KQ056440v1","347885","348180","67","3570198"
"JH378250","3988857","3989067","KQ054124v1","4660657","4660862","66","671800"
"JH378250","4023718","4024009","KQ058184v1","1505565","1505858","66","2518153"
"JH378250","4084654","4084946","KQ058190v1","350088","350375","61","3734566"
"JH378250","4279327","4279592","KQ053454v1","4443711","4443985","77","164384"
"JH378251","52649","52758","KQ056613v1","1941571","1941673","25","1888922"
"JH378251","94383","94596","KQ058595v1","117016","117224","46","22633"
"JH378251","535788","535920","KQ058004v1","2254984","2255111","30","1719196"
"JH378251","588741","588891","KQ053288v1","28257","28404","38","560484"
"JH378251","2113087","2113371","KQ052968v1","13260777","13261056","62","11147690"
"JH378251","2760611","2760747","KQ058583v1","3719424","3719557","41","958813"
"JH378251","2923290","2923410","KQ054932v1","7772773","7772892","26","4849483"
"JH378251","2923542","2923703","KQ054533v1","1027813","1027974","40","1895729"
"JH378251","2982643","2982914","KQ054510v1","3864856","3865128","68","882213"
"JH378251","3400324","3400623","KQ055852v1","1231373","1231668","64","2168951"
"JH378251","3467984","3468118","KQ057901v1","1218014","1218146","23","2249970"
"JH378251","3522745","3523007","KQ053299v1","7541492","7541756","71","4018747"
"JH378251","3543681","3543831","KQ054826v1","38244","38379","46","3505437"
"JH378251","3561673","3561975","KQ054804v1","52712","53011","72","3508961"
"JH378251","3605275","3605567","KQ054356v1","787783","788076","75","2817492"
"JH378251","3629335","3629627","KQ053476v1","3712115","3712409","68","82780"
"JH378251","3704565","3704835","KQ053894v1","688559","688830","66","3016006"
"JH378251","3849345","3849398","KQ058316v1","5629786","5629842","10","1780441"
"JH378251","3918200","3918425","KQ054704v1","483937","484161","57","3434263"
"JH378252","6549","6842","KQ053146v1","329936","330234","75","323387"
"JH378252","106350","106475","KQ055957v1","2095070","2095194","28","1988720"
"JH378252","216469","216768","KQ058184v1","1505565","1505858","59","1289096"
"JH378252","226091","226209","KQ053916v1","1734787","1734913","27","1508696"
"JH378252","325149","325284","KQ053654v1","4929533","4929667","23","4604384"
"JH378252","389074","389378","KQ058184v1","1505565","1505858","84","1116491"
"JH378252","414938","415239","KQ058350v1","6740286","6740580","60","6325348"
"JH378252","450642","450913","KQ055394v1","3441211","3441489","63","2990569"
"JH378252","518531","518841","KQ053774v1","416886","417189","80","101645"
"JH378252","792448","792747","KQ058290v1","511568","511873","72","280880"
"JH378252","1346217","1346359","KQ053916v1","1023573","1023722","31","322644"
"JH378252","1586625","1586759","KQ057204v1","1988095","1988228","28","401470"
"JH378252","1594942","1595235","KQ056673v1","983726","984000","66","611216"
"JH378252","1676200","1676330","KQ053115v1","2895891","2896019","35","1219691"
"JH378252","1811278","1811571","KQ054725v1","1255370","1255663","65","555908"
"JH378252","1822070","1822235","KQ055065v1","1891639","1891811","50","69569"
"JH378252","1825919","1826108","KQ055662v1","1117136","1117330","56","708783"
"JH378252","1949543","1949760","KQ054533v1","1766391","1766592","58","183152"
"JH378252","2085690","2086000","KQ058184v1","1505565","1505858","68","580125"
"JH378252","2227026","2227330","KQ057449v1","2137704","2138005","64","89322"
"JH378252","2328658","2328981","KQ053849v1","1318915","1319229","78","1009743"
"JH378252","2371158","2371434","KQ052969v1","11082995","11083279","67","8711837"
"JH378252","2405587","2405868","KQ053409v1","3716306","3716585","54","1310719"
"JH378252","2484706","2484864","KQ055425v1","1445594","1445758","28","1039112"
"JH378252","2702480","2702752","KQ058546v1","168071","168339","58","2534409"
"JH378252","2844989","2845155","KQ056996v1","1524030","1524195","37","1320959"
"JH378252","2911766","2911956","KQ058350v1","871497","871688","48","2040269"
"JH378252","2913368","2913668","KQ054868v1","1584588","1584882","78","1328780"
"JH378252","2949622","2949910","KQ055247v1","3219331","3219626","71","269709"
"JH378252","2958426","2958539","KQ053785v1","828746","828862","30","2129680"
"JH378252","2988178","2988476","KQ054868v1","1584588","1584882","71","1403590"
"JH378252","3035626","3035928","KQ056672v1","6393431","6393732","67","3357805"
"JH378252","3138194","3138362","KQ055468v1","2985167","2985321","63","153027"
"JH378252","3200301","3200585","KQ058561v1","4466656","4466945","57","1266355"
"JH378252","3443142","3443447","KQ055457v1","2061137","2061448","64","1382005"
"JH378252","3564230","3564282","KQ055648v1","977","1030","19","3563253"
"JH378252","3663791","3664068","KQ058184v1","1505565","1505858","59","2158226"
"JH378252","4167319","4167652","KQ056672v1","3082150","3082439","110","1085169"
"JH378252","4208516","4208813","KQ055629v1","135233","135538","73","4073283"
"JH378252","4349052","4349165","KQ053785v1","828746","828862","30","3520306"
"JH378252","4385172","4385325","KQ058350v1","446681","446829","35","3938491"
"JH378253","23444","23753","KQ058272v1","3047974","3048266","71","3024530"
"JH378253","31585","31839","KQ053498v1","3849819","3850073","61","3818234"
"JH378253","67700","67864","KQ054533v1","1027813","1027974","42","960113"
"JH378253","549591","549901","KQ053365v1","1641173","1641479","74","1091582"
"JH378253","1538456","1538735","KQ055247v1","216427","216708","75","1322029"
"JH378253","1752027","1752305","KQ054933v1","4410189","4410469","73","2658162"
"JH378253","1945836","1946102","KQ054576v1","657552","657814","81","1288284"
"JH378253","2005631","2005774","KQ058281v1","1664150","1664292","36","341481"
"JH378253","2219650","2219948","KQ058353v1","1264780","1265071","75","954870"
"JH378253","2317228","2317524","KQ055852v1","1231373","1231668","62","1085855"
"JH378253","2325590","2325901","KQ053093v1","1522159","1522464","69","803431"
"JH378253","2340693","2340968","KQ052969v1","962459","962736","69","1378234"
"JH378253","2463929","2464090","KQ053082v1","7188403","7188567","43","4724474"
"JH378253","2706495","2706786","KQ053816v1","6856607","6856902","68","4150112"
"JH378253","2729721","2729853","KQ057702v1","1862724","1862857","24","866997"
"JH378253","2894484","2894620","KQ056147v1","2168964","2169108","39","725520"
"JH378253","2917702","2917783","KQ053816v1","6703101","6703179","34","3785399"
"JH378253","2960401","2960544","KQ053260v1","251013","251153","31","2709388"
"JH378253","2991435","2991579","KQ055425v1","2013948","2014107","48","977487"
"JH378253","3048847","3048986","KQ054135v1","1889077","1889201","43","1159770"
"JH378253","3111483","3111780","KQ053299v1","4095914","4096215","69","984431"
"JH378253","3168404","3168706","KQ056673v1","1151371","1151663","86","2017033"
"JH378253","3216166","3216302","KQ053104v1","317902","318035","32","2898264"
"JH378253","3557031","3557235","KQ058506v1","612733","612922","58","2944298"
"JH378254","23973","24229","KQ053740v1","548757","549009","70","524784"
"JH378254","98865","99123","KQ053740v1","548757","549009","72","449892"
"JH378254","219596","219902","KQ058184v1","1505565","1505858","66","1285969"
"JH378254","563334","563634","KQ052969v1","7033432","7033732","74","6470098"
"JH378254","564455","564745","KQ054179v1","4270912","4271203","61","3706457"
"JH378254","573768","574057","KQ058539v1","1057985","1058283","79","484217"
"JH378254","717293","717597","KQ058184v1","1505565","1505858","71","788272"
"JH378254","847670","847952","KQ055745v1","631144","631414","70","216526"
"JH378254","882894","883145","KQ056404v1","638131","638387","62","244763"
"JH378254","887778","887936","KQ058394v1","13334171","13334328","58","12446393"
"JH378254","895615","895812","KQ053849v1","1126392","1126589","54","230777"
"JH378254","1119797","1120102","KQ058184v1","1505565","1505858","51","385768"
"JH378254","1190013","1190324","KQ058316v1","1584048","1584351","65","394035"
"JH378254","1191859","1192126","KQ058316v1","6274690","6274954","73","5082831"
"JH378254","1204049","1204308","KQ055745v1","631144","631414","70","572905"
"JH378254","1263901","1264095","KQ058350v1","871497","871688","46","392404"
"JH378254","1306846","1307151","KQ055957v1","671574","671880","64","635272"
"JH378254","1333269","1333545","KQ055173v1","248885","249169","64","1084384"
"JH378254","1403509","1403825","KQ058377v1","25815","26128","76","1377694"
"JH378254","1467365","1467665","KQ053365v1","1641173","1641479","76","173808"
"JH378254","1523996","1524293","KQ053409v1","6051156","6051445","58","4527160"
"JH378254","1552721","1553036","KQ054628v1","2076001","2076309","69","523280"
"JH378254","1646836","1647113","KQ053115v1","1118362","1118655","65","528474"
"JH378254","1685179","1685326","KQ054191v1","266771","266904","42","1418408"
"JH378254","1761692","1761843","KQ054401v1","2342043","2342190","43","580351"
"JH378254","1811378","1811665","KQ057290v1","1053741","1054027","68","757637"
"JH378254","1816154","1816339","KQ052968v1","13535456","13535639","43","11719302"
"JH378254","1923212","1923519","KQ053631v1","8031857","8032161","79","6108645"
"JH378254","2041929","2042144","KQ056493v1","5256811","5257011","56","3214882"
"JH378254","2151588","2151669","KQ053398v1","4200835","4200909","23","2049247"
"JH378254","2823433","2823737","KQ054068v1","5134007","5134302","66","2310574"
"JH378254","2984629","2984675","KQ053115v1","3147245","3147295","12","162616"
"JH378254","2998655","2998917","KQ054081v1","1240364","1240650","74","1758291"
"JH378254","3168589","3168719","KQ053354v1","702320","702452","21","2466269"
"JH378254","3342094","3342305","KQ054565v1","7472196","7472426","74","4130102"
"JH378254","3363396","3363704","KQ053115v1","3485337","3485650","62","121941"
"JH378254","3410207","3410530","KQ058272v1","4942871","4943179","62","1532664"
"JH378254","3614620","3614869","KQ056404v1","1771928","1772196","74","1842692"
"JH378254","3924986","3925290","KQ055787v1","1064992","1065293","60","2859994"
"JH378254","4060559","4060691","KQ053191v1","655494","655627","24","3405065"
"JH378254","4092603","4092918","KQ055035v1","105161","105450","108","3987442"
"JH378254","4093303","4093348","KQ053465v1","4036077","4036125","9","57226"
"JH378254","4100104","4100389","KQ058184v1","1505565","1505858","74","2594539"
"JH378255","35035","35328","KQ057702v1","1420535","1420827","61","1385500"
"JH378255","65743","66033","KQ056331v1","348695","348980","76","282952"
"JH378255","95052","95300","KQ053026v1","2213601","2213834","73","2118549"
"JH378255","201575","201833","KQ053894v1","688559","688830","64","486984"
"JH378255","202919","203182","KQ054826v1","9969237","9969502","61","9766318"
"JH378255","277580","277781","KQ053299v1","22896430","22896597","63","22618850"
"JH378255","547352","547492","KQ055755v1","1807261","1807395","37","1259909"
"JH378255","606254","606506","KQ054069v1","928440","928688","79","322186"
"JH378255","608977","609262","KQ058004v1","1480411","1480689","62","871434"
"JH378255","660793","661095","KQ053059v1","2387120","2387415","68","1726327"
"JH378255","720820","720939","KQ053409v1","4665948","4666070","29","3945128"
"JH378255","788757","788902","KQ053037v1","3255963","3256108","34","2467206"
"JH378255","857032","857339","KQ053115v1","3485337","3485650","59","2628305"
"JH378255","910369","910504","KQ055141v1","3481451","3481584","25","2571082"
"JH378255","997329","997644","KQ054704v1","223675","223980","70","773654"
"JH378255","1180947","1181221","KQ058572v1","2386857","2387136","62","1205910"
"JH378255","1234596","1234884","KQ058275v1","938649","938919","71","295947"
"JH378255","1285484","1285605","KQ053223v1","119848","119963","23","1165636"
"JH378255","1285683","1285832","KQ056147v1","2168964","2169108","36","883281"
"JH378255","1320754","1321061","KQ054289v1","107239","107526","74","1213515"
"JH378255","1374162","1374453","KQ053146v1","2819587","2819868","73","1445425"
"JH378255","1400910","1401192","KQ058316v1","753926","754202","68","646984"
"JH378255","1404706","1404899","KQ058183v1","3187602","3187791","44","1782896"
"JH378255","1456815","1456945","KQ053299v1","22459675","22459802","26","21002860"
"JH378255","1468568","1468716","KQ057204v1","1033140","1033287","42","435428"
"JH378255","1468785","1469072","KQ054069v1","7687863","7688158","66","6219078"
"JH378255","1472276","1472573","KQ058350v1","6740286","6740580","67","5268010"
"JH378255","1500407","1500719","KQ057290v1","2405044","2405354","70","904637"
"JH378255","1507008","1507321","KQ054565v1","6587941","6588226","88","5080933"
"JH378255","1542404","1542700","KQ052981v1","658787","659079","73","883617"
"JH378255","1622808","1622913","KQ055152v1","1163688","1163781","34","459120"
"JH378255","1698960","1699170","KQ056405v1","6821","7014","59","1692139"
"JH378255","1722658","1722919","KQ058283v1","3525175","3525450","63","1802517"
"JH378255","1859132","1859289","KQ055725v1","720931","721083","43","1138201"
"JH378255","1864422","1864584","KQ053387v1","3518506","3518663","46","1654084"
"JH378255","1896076","1896359","KQ053838v1","2688977","2689267","71","792901"
"JH378255","2052166","2052300","KQ054890v1","666308","666433","52","1385858"
"JH378255","2211943","2212097","KQ057023v1","552794","552951","39","1659149"
"JH378255","2225115","2225419","KQ056672v1","3082150","3082439","81","857035"
"JH378255","2241205","2241415","KQ055651v1","5048558","5048780","59","2807353"
"JH378255","2345544","2345823","KQ054745v1","919926","920212","58","1425618"
"JH378255","2359933","2360144","KQ053959v1","3147544","3147761","52","787611"
"JH378255","2407892","2408036","KQ055384v1","843998","844147","34","1563894"
"JH378255","2502427","2502556","KQ058316v1","3822440","3822571","35","1320013"
"JH378255","2597947","2598264","KQ053543v1","1766119","1766434","72","831828"
"JH378255","2968825","2969050","KQ058505v1","2234909","2235124","59","733916"
"JH378255","3020863","3021047","KQ054933v1","3939617","3939804","53","918754"
"JH378255","3071806","3072089","KQ054124v1","2442155","2442433","80","629651"
"JH378255","3119949","3120226","KQ057291v1","667476","667747","67","2452473"
"JH378255","3234925","3235070","KQ058281v1","1238804","1238950","45","1996121"
"JH378255","3322508","3322809","KQ058427v1","7552507","7552810","75","4229999"
"JH378255","3385671","3385896","KQ053982v1","2652830","2653054","68","732841"
"JH378255","3391051","3391361","KQ056148v1","2246905","2247173","95","1144146"
"JH378255","3403692","3403795","KQ053654v1","3900921","3901030","37","497229"
"JH378255","3485577","3485838","KQ052968v1","10745715","10745973","67","7260138"
"JH378255","3579714","3579812","KQ055024v1","329599","329697","28","3250115"
"JH378255","3657254","3657459","KQ053774v1","1982290","1982469","60","1674964"
"JH378255","3705884","3706185","KQ057693v1","117172","117472","74","3588712"
"JH378255","3725367","3725466","KQ053675v1","1335502","1335608","29","2389865"
"JH378255","3770023","3770159","KQ054191v1","2450802","2450939","33","1319221"
"JH378255","3862552","3862760","KQ058505v1","3952082","3952290","54","89530"
"JH378255","3906283","3906408","KQ055236v1","812426","812550","27","3093857"
"JH378255","3909351","3909458","KQ055651v1","2477255","2477367","30","1432096"
"JH378255","3968887","3969103","KQ055935v1","436277","436509","84","3532610"
"JH378255","4058660","4058939","KQ054660v1","3418146","3418430","70","640514"
"JH378256","563229","563546","KQ053299v1","3823059","3823361","91","3259830"
"JH378256","742346","742623","KQ055152v1","3201144","3201427","64","2458798"
"JH378256","790752","791020","KQ058413v1","348155","348432","76","442597"
"JH378256","1691622","1691719","KQ055883v1","755116","755212","31","936506"
"JH378256","1963764","1964051","ABDC02003384v1","193955","194231","65","1769809"
"JH378256","2121893","2122202","KQ055957v1","671574","671880","85","1450319"
"JH378256","2223892","2224124","KQ058050v1","910717","910957","72","1313175"
"JH378256","2249493","2249670","KQ054533v1","2294255","2294433","54","44762"
"JH378256","3420173","3420403","KQ058427v1","7850908","7851135","49","4430735"
"JH378257","261935","262228","KQ056790v1","446564","446855","73","184629"
"JH378257","76443","76616","KQ056996v1","1524030","1524195","35","1447587"
"JH378257","103492","103798","KQ056044v1","2538771","2539068","72","2435279"
"JH378257","128925","129236","KQ057522v1","1108367","1108662","76","979442"
"JH378257","291046","291146","KQ055024v1","329599","329697","20","38553"
"JH378257","342620","342938","KQ053795v1","1729459","1729773","63","1386839"
"JH378257","406437","406722","KQ052969v1","9553757","9554052","70","9147320"
"JH378257","488549","488832","KQ053454v1","817557","817829","75","329008"
"JH378257","491338","491610","KQ053299v1","22323868","22324139","65","21832530"
"JH378257","498658","498822","KQ056475v1","5275769","5275928","35","4777111"
"JH378257","521628","521934","KQ053958v1","83131","83439","75","438497"
"JH378257","539977","540275","KQ055247v1","895463","895756","62","355486"
"JH378257","707012","707287","KQ053631v1","460848","461138","65","246164"
"JH378257","731638","731927","KQ058184v1","1505565","1505858","68","773927"
"JH378257","798541","798836","KQ057390v1","1266388","1266686","84","467847"
"JH378257","2106320","2106611","KQ055097v1","1884579","1884874","69","221741"
"JH378257","2113523","2113834","KQ055787v1","694393","694708","61","1419130"
"JH378257","2139838","2140101","KQ053520v1","2840509","2840769","69","700671"
"JH378257","2172404","2172585","KQ058459v1","469480","469653","53","1702924"
"JH378257","2399119","2399373","KQ054868v1","1834842","1835084","77","564277"
"JH378257","2426023","2426318","KQ052969v1","9116808","9117108","66","6690785"
"JH378257","2483681","2483985","KQ053631v1","9631170","9631468","58","7147489"
"JH378257","2546702","2546829","KQ054932v1","5285465","5285595","25","2738763"
"JH378257","2578687","2578991","KQ053365v1","2996957","2997245","82","418270"
"JH378257","2729810","2730050","KQ052970v1","17324014","17324257","60","14594204"
"JH378257","2740917","2741206","KQ056044v1","2538771","2539068","69","202146"
"JH378257","2767188","2767480","ABDC02052257v1","792","1085","60","2766396"
"JH378257","2821994","2822300","KQ058184v1","1505565","1505858","60","1316429"
"JH378257","2866648","2866952","KQ054400v1","4609733","4610042","70","1743085"
"JH378257","2904017","2904292","KQ054510v1","8087837","8088117","68","5183820"
"JH378257","2946870","2947169","KQ054290v1","1454980","1455264","79","1491890"
"JH378257","2978573","2978855","KQ055173v1","452351","452623","63","2526222"
"JH378257","3085957","3086254","KQ052968v1","6329604","6329900","65","3243647"
"JH378257","3318773","3319073","KQ058427v1","4553509","4553777","71","1234736"
"JH378257","3333163","3333435","KQ057755v1","45985","46262","69","3287178"
"JH378257","3362123","3362215","KQ054091v1","552694","552778","24","2809429"
"JH378257","3630268","3630571","KQ058389v1","2329886","2330179","75","1300382"
"JH378257","3639862","3640162","KQ055777v1","2252512","2252796","74","1387350"
"JH378257","3641562","3641856","KQ054068v1","5074639","5074944","64","1433077"
"JH378257","3644541","3644817","KQ053916v1","1741116","1741399","64","1903425"
"JH378257","3645414","3645582","KQ056483v1","805524","805686","37","2839890"
"JH378258","101507","101817","KQ054786v1","934497","934799","61","832990"
"JH378258","108129","108290","ABDC02046354v1","1","162","49","108128"
"JH378258","119010","119301","KQ054191v1","3857584","3857880","70","3738574"
"JH378258","209958","210100","KQ053115v1","1650505","1650644","26","1440547"
"JH378258","272128","272275","KQ052970v1","12418764","12418905","34","12146636"
"JH378258","412824","412951","KQ054533v1","1111592","1111720","21","698768"
"JH378258","1254399","1254665","KQ053752v1","35796","36072","67","1218603"
"JH378258","1334741","1334873","KQ057268v1","150223","150357","25","1184518"
"JH378258","1532782","1532909","KQ053354v1","702320","702452","22","830462"
"JH378258","2365212","2365491","KQ053354v1","2295556","2295845","75","69656"
"JH378258","2709681","2709968","KQ055404v1","2891185","2891468","87","181504"
"JH378258","3060226","3060505","KQ058184v1","1505565","1505858","64","1554661"
"JH378258","3222373","3222681","KQ054932v1","8677551","8677850","66","5455178"
"JH378258","3360252","3360387","KQ054724v1","2045246","2045378","23","1315006"
"JH378258","3609865","3610097","KQ055203v1","1684178","1684395","60","1925687"
"JH378258","3714525","3714639","KQ058403v1","2083243","2083351","31","1631282"
"JH378258","3726971","3727267","KQ053476v1","1155618","1155925","66","2571353"
"JH378258","3734809","3735108","KQ058184v1","1505565","1505858","69","2229244"
"JH378258","3749079","3749284","KQ052968v1","13086221","13086431","66","9337142"
"JH378258","3750954","3751164","KQ053883v1","3874582","3874795","64","123628"
"JH378258","3780427","3780514","KQ056672v1","4497643","4497736","25","717216"
"JH378258","3813915","3814155","KQ054804v1","1007773","1008011","66","2806142"
"JH378258","3823422","3823725","KQ058372v1","1866883","1867182","69","1956539"
"JH378259","935911","936115","KQ054069v1","7451915","7452104","63","6516004"
"JH378259","1130935","1131232","KQ053816v1","7464708","7465010","75","6333773"
"JH378259","1199714","1200027","KQ053520v1","3826144","3826443","80","2626430"
"JH378259","1488511","1488785","KQ053059v1","3865389","3865665","60","2376878"
"JH378259","1606616","1606885","KQ055735v1","667472","667747","77","939144"
"JH378259","2087167","2087451","KQ052969v1","8840489","8840774","70","6753322"
"JH378259","2645774","2646055","KQ055192v1","1304874","1305155","76","1340900"
"JH378259","3139779","3139943","KQ054565v1","627778","627936","35","2512001"
"JH378259","3179310","3179568","KQ058316v1","4984552","4984820","65","1805242"
"JH378259","3412906","3413158","KQ054815v1","2598000","2598258","67","814906"
"JH378259","3432849","3432974","KQ056147v1","1828259","1828388","27","1604590"
"JH378259","3433057","3433240","KQ052969v1","8430836","8430996","47","4997779"
"JH378259","3585969","3586262","KQ057290v1","1053741","1054027","61","2532228"
"JH378259","3716524","3716573","KQ054279v1","852960","853011","9","2863564"
"JH378259","3813807","3813858","KQ055384v1","420057","420110","13","3393750"
"JH378260","75506","75804","KQ053927v1","199693","199992","65","124187"
"JH378260","168662","168714","KQ054279v1","852960","853011","13","684298"
"JH378260","212633","212928","KQ053816v1","7464708","7465010","79","7252075"
"JH378260","217736","217819","KQ055108v1","472985","473065","23","255249"
"JH378260","217951","218104","KQ054725v1","2033305","2033462","35","1815354"
"JH378260","239129","239261","KQ055872v1","4808828","4808960","23","4569699"
"JH378260","409520","409796","KQ055457v1","9231252","9231546","77","8821732"
"JH378260","469595","469757","KQ055755v1","647816","647973","45","178221"
"JH378260","561192","561325","KQ055755v1","1807261","1807395","21","1246069"
"JH378260","1359001","1359296","KQ056254v1","1122996","1123269","77","236005"
"JH378260","1399903","1399999","KQ057821v1","1407299","1407387","32","7396"
"JH378260","1453024","1453322","KQ055808v1","339221","339505","82","1113803"
"JH378260","1763213","1763500","KQ055787v1","1031631","1031912","77","731582"
"JH378260","2483650","2483971","KQ053093v1","1522159","1522464","73","961491"
"JH378260","2586278","2586418","KQ056643v1","1491838","1491968","30","1094440"
"JH378260","2833705","2834015","KQ053465v1","167701","167983","90","2666004"
"JH378260","2834910","2835206","KQ052981v1","1198440","1198752","74","1636470"
"JH378260","3040769","3041050","KQ054068v1","3341291","3341579","65","300522"
"JH378260","3068220","3068497","KQ055457v1","8436987","8437281","75","5368767"
"JH378260","3209042","3209192","KQ053190v1","2372433","2372579","33","836609"
"JH378260","3214773","3215077","KQ053115v1","1118362","1118655","63","2096411"
"JH378260","3223979","3224270","KQ053157v1","7174603","7174889","71","3950624"
"JH378260","3491825","3492107","KQ056465v1","119542","119834","68","3372283"
"JH378260","3530758","3530883","KQ053409v1","6105325","6105446","25","2574567"
"JH378260","3531535","3531688","KQ058613v1","368815","368973","50","3162720"
"JH378260","3560679","3560993","KQ054068v1","5491779","5492087","78","1931100"
"JH378260","3772353","3772662","KQ053115v1","3485337","3485650","71","287016"
"JH378260","3875324","3875461","KQ057649v1","141749","141881","33","3733575"
"JH378261","323686","323889","KQ053387v1","3273859","3274045","59","2950173"
"JH378261","915352","915618","KQ053894v1","688559","688830","66","226793"
"JH378261","1050818","1051099","KQ053696v1","3248742","3249021","72","2197924"
"JH378261","1309620","1309912","KQ057875v1","404539","404839","66","905081"
"JH378261","1745424","1745696","KQ058275v1","938649","938919","71","806775"
"JH378261","1814525","1814833","KQ058377v1","25815","26128","66","1788710"
"JH378261","1861799","1861914","KQ058383v1","8339612","8339728","24","6477813"
"JH378261","2098966","2099228","KQ057223v1","124007","124258","67","1974959"
"JH378261","2146100","2146393","KQ053894v1","1262767","1263078","68","883333"
"JH378261","2313702","2313990","KQ056147v1","1064032","1064323","59","1249670"
"JH378261","2408400","2408675","KQ055173v1","248885","249169","69","2159515"
"JH378261","2409101","2409203","KQ054587v1","1268052","1268146","32","1141049"
"JH378261","2564475","2564771","KQ058184v1","1505565","1505858","63","1058910"
"JH378261","2571651","2571823","KQ058183v1","3213511","3213674","52","641860"
"JH378261","2821326","2821600","KQ056911v1","629332","629617","69","2191994"
"JH378261","2949293","2949589","KQ056147v1","1064032","1064323","68","1885261"
"JH378261","2981302","2981431","KQ053718v1","316226","316356","21","2665076"
"JH378261","3007020","3007157","KQ056652v1","675563","675695","30","2331457"
"JH378261","3097354","3097642","KQ054124v1","2442155","2442433","74","655199"
"JH378261","3319361","3319618","KQ052970v1","3228321","3228582","77","91040"
"JH378261","3549761","3550056","KQ056643v1","431969","432259","54","3117792"
"JH378262","3276799","3276990","KQ056147v1","3894275","3894476","59","617476"
"JH378262","3538846","3539000","KQ052969v1","8332082","8332226","42","4793236"
"JH378262","59579","59858","KQ052970v1","8520800","8521088","77","8461221"
"JH378262","137183","137481","KQ054725v1","2218271","2218569","60","2081088"
"JH378262","678885","679079","KQ058250v1","230291","230481","51","448594"
"JH378262","714963","715045","KQ058293v1","1008728","1008810","25","293765"
"JH378262","863539","863668","KQ056234v1","886803","886922","27","23264"
"JH378262","867872","868163","KQ054826v1","7957748","7958033","73","7089876"
"JH378262","952804","953100","KQ055852v1","1231373","1231668","62","278569"
"JH378262","978105","978374","KQ055065v1","1117201","1117481","62","139096"
"JH378262","1114803","1115097","KQ058184v1","1505565","1505858","61","390762"
"JH378262","1169677","1169807","KQ055957v1","554477","554608","27","615200"
"JH378262","1227877","1228141","KQ053037v1","3640291","3640559","67","2412414"
"JH378262","1276095","1276223","KQ055600v1","267326","267449","32","1008769"
"JH378262","1330749","1331036","KQ056672v1","3535300","3535593","68","2204551"
"JH378262","1343049","1343274","KQ053816v1","5259129","5259356","78","3916080"
"JH378262","1350517","1350820","KQ058372v1","1134128","1134432","75","216389"
"JH378262","1439166","1439307","KQ055406v1","2968","3106","26","1436198"
"JH378262","1673328","1673470","KQ055893v1","1958950","1959098","58","285622"
"JH378262","1719039","1719323","KQ052968v1","13260777","13261056","66","11541738"
"JH378262","1897029","1897160","KQ053718v1","316226","316356","27","1580803"
"JH378262","2651505","2651620","KQ058403v1","2083243","2083351","31","568262"
"JH378262","2673127","2673258","KQ053004v1","2961452","2961584","21","288325"
"JH378262","2815560","2815727","KQ058539v1","1340326","1340487","36","1475234"
"JH378262","2849699","2850000","KQ058184v1","1505565","1505858","56","1344134"
"JH378262","2882135","2882198","KQ056716v1","1673454","1673521","14","1208681"
"JH378262","2885016","2885112","KQ053631v1","8860661","8860759","31","5975645"
"JH378262","3663475","3663603","KQ054725v1","1816931","1817058","22","1846544"
"JH378262","3695836","3696135","KQ053816v1","7327018","7327317","56","3631182"
"JH378262","3719672","3719797","KQ056200v1","30786","30917","27","3688886"
"JH378263","295798","295960","KQ055872v1","5870772","5870928","39","5574974"
"JH378263","357151","357448","KQ053190v1","2453353","2453652","71","2096202"
"JH378263","535627","535925","KQ053816v1","6856607","6856902","82","6320980"
"JH378263","556668","556825","KQ052968v1","8575658","8575813","36","8018990"
"JH378263","702837","703072","KQ054660v1","2829812","2830044","57","2126975"
"JH378263","809166","809310","KQ055183v1","2514156","2514302","28","1704990"
"JH378263","1055242","1055529","KQ054693v1","832788","833076","57","222454"
"JH378263","1195098","1195387","KQ057471v1","475360","475647","72","719738"
"JH378263","1350399","1350507","KQ053850v1","279389","279490","26","1071010"
"JH378263","1371068","1371195","KQ053752v1","1383162","1383295","25","12094"
"JH378263","1376125","1376235","KQ058403v1","2083243","2083351","29","707118"
"JH378263","1376437","1376617","KQ053179v1","1735404","1735576","39","358967"
"JH378263","1478346","1478642","KQ052971v1","1111058","1111352","61","367288"
"JH378263","1495232","1495537","KQ058275v1","201680","201968","81","1293552"
"JH378263","1601020","1601322","KQ053299v1","4095914","4096215","63","2494894"
"JH378263","1607632","1607916","KQ053299v1","3622388","3622669","71","2014756"
"JH378263","1709689","1709925","KQ054776v1","1303678","1303900","73","406011"
"JH378263","1786060","1786351","KQ056147v1","1064032","1064323","63","722028"
"JH378263","1803032","1803288","KQ058321v1","21060","21321","69","1781972"
"JH378263","1812417","1812729","KQ058527v1","5208632","5208933","77","3396215"
"JH378263","1815588","1815784","KQ055203v1","430860","431048","61","1384728"
"JH378263","1822919","1823139","KQ053081v1","2153068","2153282","59","330149"
"JH378263","1869720","1870003","KQ056773v1","168010","168288","65","1701710"
"JH378263","2061844","2062119","KQ058561v1","583947","584226","63","1477897"
"JH378263","2319285","2319604","KQ058583v1","3101722","3102049","72","782437"
"JH378263","2364460","2364684","KQ056234v1","4592339","4592554","49","2227879"
"JH378263","2538610","2538905","KQ054725v1","2218271","2218569","66","320339"
"JH378263","2608575","2608837","KQ058383v1","10165252","10165509","77","7556677"
"JH378263","2738671","2738873","KQ052970v1","3216316","3216523","47","477645"
"JH378263","2963251","2963379","KQ057648v1","2314551","2314685","25","648700"
"JH378264","172350","172641","KQ052968v1","6282633","6282918","65","6110283"
"JH378264","199423","199711","KQ055946v1","855067","855357","72","655644"
"JH378264","202651","202915","KQ056663v1","500658","500926","70","298007"
"JH378264","207475","207777","KQ053816v1","7464708","7465010","55","7257233"
"JH378264","297045","297336","KQ054745v1","919926","920212","75","622881"
"JH378264","307074","307330","KQ053894v1","688559","688830","58","381485"
"JH378264","310682","310962","KQ058405v1","697304","697560","82","386622"
"JH378264","343772","344035","KQ056044v1","570262","570509","73","226490"
"JH378264","352501","352786","KQ055352v1","4380175","4380453","83","4027674"
"JH378264","471549","471851","KQ057875v1","561558","561851","60","90009"
"JH378264","493288","493408","KQ056035v1","296324","296444","19","196964"
"JH378264","523024","523317","KQ058561v1","4466656","4466945","57","3943632"
"JH378264","611580","611859","KQ057541v1","1286268","1286551","66","674688"
"JH378264","631960","632186","KQ054693v1","3245566","3245803","55","2613606"
"JH378264","642805","642987","KQ054725v1","735942","736116","42","93137"
"JH378264","683212","683363","KQ058427v1","3400358","3400512","30","2717146"
"JH378264","730759","731067","KQ052981v1","1198440","1198752","67","467681"
"JH378264","749207","749511","KQ056440v1","1022590","1022891","67","273383"
"JH378264","1022261","1022571","KQ058480v1","549233","549550","77","473028"
"JH378264","1109226","1109522","KQ053409v1","4278416","4278719","63","3169190"
"JH378264","1145950","1146236","KQ054565v1","2548872","2549165","74","1402922"
"JH378264","1277432","1277713","KQ058316v1","6284943","6285210","76","5007511"
"JH378264","1285756","1286032","KQ053409v1","6051156","6051445","70","4765400"
"JH378264","1388581","1388865","KQ053498v1","169879","170149","65","1218702"
"JH378264","1589475","1589728","KQ054301v1","3391378","3391638","60","1801903"
"JH378264","1714032","1714183","KQ052968v1","10427732","10427888","29","8713700"
"JH378264","1772383","1772680","KQ057909v1","3829378","3829677","67","2056995"
"JH378264","1782511","1782667","KQ054068v1","1471821","1471979","40","310690"
"JH378264","1932540","1932672","KQ054213v1","615112","615244","26","1317428"
"JH378264","2307266","2307356","KQ054837v1","331491","331578","25","1975775"
"JH378264","2320950","2321257","KQ055097v1","1884579","1884874","66","436371"
"JH378264","2462323","2462625","KQ056790v1","446564","446855","62","2015759"
"JH378264","2514549","2514852","KQ055097v1","1884579","1884874","67","629970"
"JH378264","2521725","2522008","KQ055490v1","2107132","2107421","73","414593"
"JH378264","2524049","2524216","KQ054068v1","6548035","6548195","44","4023986"
"JH378264","2532240","2532509","KQ053202v1","1134199","1134469","77","1398041"
"JH378264","2592262","2592385","KQ053409v1","6105325","6105446","26","3513063"
"JH378264","3019511","3019796","KQ058004v1","1480411","1480689","64","1539100"
"JH378264","3030702","3030981","KQ053146v1","2819587","2819868","70","211115"
"JH378264","3031069","3031379","KQ055457v1","6534446","6534755","69","3503377"
"JH378264","3063723","3064029","KQ056568v1","817681","817996","67","2246042"
"JH378264","3120510","3120597","KQ053838v1","1840604","1840696","27","1279906"
"JH378264","3159372","3159483","KQ053675v1","1335502","1335608","31","1823870"
"JH378264","3276065","3276369","KQ058372v1","1134128","1134432","65","2141937"
"JH378264","3342483","3342733","KQ053752v1","4514543","4514771","72","1172060"
"JH378264","3389509","3389791","KQ056773v1","168010","168288","63","3221499"
"JH378264","3479000","3479299","KQ053387v1","1398364","1398674","82","2080636"
"JH378264","3518297","3518586","KQ056587v1","9000240","9000528","63","5481943"
"JH378264","3598602","3598768","KQ057603v1","1535538","1535702","38","2063064"
"JH378264","3728849","3728984","KQ053115v1","1650505","1650644","21","2078344"
"JH378264","3763403","3763561","KQ053643v1","1466202","1466359","34","2297201"
"JH378264","3795617","3795894","KQ055097v1","1704793","1705067","68","2090824"
"JH378265","68818","69006","KQ058550v1","3053970","3054174","52","2985152"
"JH378265","145407","145709","KQ053554v1","2471177","2471484","70","2325770"
"JH378265","230403","230534","KQ055662v1","1070457","1070585","26","840054"
"JH378265","242202","242369","KQ055893v1","1958950","1959098","51","1716748"
"JH378265","352062","352138","KQ057317v1","272227","272303","21","79835"
"JH378265","781704","782009","KQ057858v1","376905","377209","65","404799"
"JH378265","838851","839061","KQ053106v1","608807","609006","60","230044"
"JH378265","1054432","1054636","KQ054826v1","9981760","9981967","49","8927328"
"JH378265","1853990","1854052","KQ052968v1","8156468","8156529","18","6302478"
"JH378265","1971266","1971544","KQ053631v1","9116387","9116675","62","7145121"
"JH378265","2022197","2022485","KQ053332v1","2483799","2484093","64","461602"
"JH378265","2043232","2043518","KQ055735v1","667472","667747","76","1375760"
"JH378265","2094038","2094314","KQ054868v1","2229582","2229854","58","135544"
"JH378265","2308622","2308985","KQ056147v1","190516","190832","115","2118106"
"JH378265","2582562","2582681","KQ056147v1","3725193","3725318","35","1142631"
"JH378265","2774032","2774319","KQ055353v1","572634","572921","68","2201398"
"JH378265","2861005","2861162","KQ057737v1","1426090","1426247","33","1434915"
"JH378265","2905787","2906006","KQ053093v1","2180735","2180954","60","725052"
"JH378265","3039981","3040264","KQ056234v1","2521120","2521411","62","518861"
"JH378265","3052213","3052510","KQ057290v1","2953971","2954265","64","98242"
"JH378265","3054568","3054884","KQ056148v1","430759","431072","74","2623809"
"JH378265","3113133","3113368","KQ058427v1","7850908","7851135","50","4737775"
"JH378265","3162388","3162667","KQ055978v1","3560415","3560681","70","398027"
"JH378265","3652924","3653215","KQ054804v1","964015","964313","68","2688909"
"JH378265","3787203","3787514","KQ054401v1","2629005","2629296","69","1158198"
"JH378266","622405","622477","KQ057909v1","3940935","3941001","20","3318530"
"JH378266","1432871","1433156","KQ052969v1","8840489","8840774","72","7407618"
"JH378266","1522959","1523277","KQ054713v1","1049755","1050073","74","473204"
"JH378266","1600755","1601033","KQ058272v1","2867774","2868036","88","1267019"
"JH378266","1674314","1674567","KQ058516v1","4186311","4186545","71","2511997"
"JH378266","1721534","1721703","KQ055065v1","1891639","1891811","57","170105"
"JH378266","1857929","1858245","KQ053894v1","1262767","1263078","72","595162"
"JH378266","2297662","2297972","KQ058004v1","2241357","2241663","77","56305"
"JH378266","2490998","2491279","KQ053465v1","3806004","3806288","68","1315006"
"JH378266","2938550","2938765","KQ052970v1","11415688","11415897","68","8477138"
"JH378266","3054841","3055118","KQ057931v1","399684","399967","75","2655157"
"JH378266","3429470","3429598","KQ056293v1","110261","110385","32","3319209"
"JH378266","3494338","3494606","KQ053146v1","2819587","2819868","76","674751"
"JH378266","3618602","3618740","KQ052970v1","12418764","12418905","39","8800162"
"JH378267","108688","108967","ABDC02001013v1","5347","5624","82","103341"
"JH378267","179446","179726","KQ056254v1","1300375","1300653","68","1120929"
"JH378267","291940","292218","KQ054356v1","1600089","1600380","70","1308149"
"JH378267","347891","348172","KQ056558v1","670740","671032","62","322849"
"JH378267","359060","359349","KQ053948v1","168940","169229","72","190120"
"JH378267","466161","466463","KQ055097v1","1884579","1884874","67","1418418"
"JH378267","471476","471755","KQ053654v1","346478","346752","59","124998"
"JH378267","476001","476282","KQ053093v1","1361295","1361576","69","885294"
"JH378267","566474","566620","KQ053190v1","2372433","2372579","37","1805959"
"JH378267","591667","591953","KQ055651v1","1814596","1814880","78","1222929"
"JH378267","791440","791748","KQ053299v1","2621981","2622273","82","1830541"
"JH378267","846352","846534","KQ055404v1","3099039","3099197","56","2252687"
"JH378267","1001409","1001630","KQ054724v1","2773806","2774015","60","1772397"
"JH378267","1169216","1169509","KQ058494v1","5339063","5339354","75","4169847"
"JH378267","1174048","1174274","KQ056493v1","5393607","5393825","62","4219559"
"JH378267","1224980","1225083","KQ053256v1","5132292","5132396","20","3907312"
"JH378267","1257977","1258256","KQ052968v1","14208975","14209258","60","12950998"
"JH378267","1486438","1486758","KQ056568v1","817681","817996","68","668757"
"JH378267","1697061","1697342","KQ055610v1","1837519","1837800","60","140458"
"JH378267","1741217","1741347","KQ053982v1","7381789","7381920","26","5640572"
"JH378267","1741597","1741762","KQ053631v1","1550584","1550749","31","191013"
"JH378267","1838983","1839288","KQ058184v1","1505565","1505858","61","333418"
"JH378267","1912469","1912600","KQ052982v1","972434","972567","23","940035"
"JH378267","2368722","2368981","KQ058583v1","1187997","1188260","73","1180725"
"JH378267","2567969","2568245","KQ054745v1","988289","988551","74","1579680"
"JH378267","2977785","2977933","KQ054179v1","3865170","3865294","39","887385"
"JH378267","2978367","2978505","KQ053398v1","2023679","2023818","30","954688"
"JH378267","3070033","3070326","KQ053696v1","325593","325885","67","2744440"
"JH378267","3651162","3651442","KQ055978v1","5085382","5085675","70","1434220"
"JH378268","109025","109095","KQ053004v1","1367501","1367567","21","1258476"
"JH378268","121406","121704","KQ058184v1","1505565","1505858","63","1384159"
"JH378268","279969","280264","KQ054868v1","1651243","1651531","73","1371274"
"JH378268","307497","307797","KQ057290v1","2180782","2181079","69","1873285"
"JH378268","324521","324834","KQ052969v1","9116808","9117108","74","8792287"
"JH378268","341553","341842","KQ056855v1","3871130","3871414","74","3529577"
"JH378268","453452","453578","KQ058438v1","574406","574539","29","120954"
"JH378268","489063","489334","KQ055808v1","2066682","2066960","64","1577619"
"JH378268","561797","562039","KQ054180v1","2132402","2132657","68","1570605"
"JH378268","601407","601712","KQ053740v1","2334461","2334763","75","1733054"
"JH378268","643227","643371","KQ053982v1","3934263","3934401","46","3291036"
"JH378268","645295","645448","KQ053476v1","4635198","4635357","34","3989903"
"JH378268","656006","656224","KQ058410v1","1161849","1162066","62","505843"
"JH378268","997712","997907","KQ056320v1","2002842","2003039","50","1005130"
"JH378268","1336410","1336666","KQ058505v1","2346233","2346497","67","1009823"
"JH378268","1570751","1571047","KQ058290v1","511568","511873","73","1059183"
"JH378268","1575153","1575429","KQ055725v1","503531","503824","73","1071622"
"JH378268","1761536","1761814","KQ058315v1","658193","658490","77","1103343"
"JH378268","1853425","1853540","KQ052969v1","4262458","4262578","26","2409033"
"JH378268","1853778","1853947","KQ056996v1","1524030","1524195","36","329748"
"JH378268","2144837","2145120","KQ058427v1","5781896","5782172","74","3637059"
"JH378268","2758320","2758460","KQ052970v1","10856401","10856550","39","8098081"
"JH378268","3002881","3003164","KQ053332v1","554962","555258","69","2447919"
"JH378268","3097461","3097555","KQ054576v1","802587","802678","20","2294874"
"JH378268","3512110","3512194","KQ056148v1","5019141","5019230","17","1507031"
"JH378269","143069","143234","KQ057737v1","3327678","3327839","51","3184609"
"JH378269","175632","175862","KQ053741v1","855665","855885","68","680033"
"JH378269","185135","185428","KQ053299v1","21869448","21869738","68","21684313"
"JH378269","188669","188809","KQ054401v1","3742804","3742954","32","3554135"
"JH378269","443844","444111","KQ058516v1","1888551","1888807","94","1444707"
"JH378269","481627","481785","KQ056475v1","5275769","5275928","37","4794142"
"JH378269","513197","513477","KQ053104v1","3864277","3864560","57","3351080"
"JH378269","539732","539877","KQ053115v1","1650505","1650644","30","1110773"
"JH378269","649437","649567","KQ052970v1","9702416","9702545","29","9052979"
"JH378269","649713","649848","KQ053948v1","2765570","2765701","33","2115857"
"JH378269","668662","668951","KQ057380v1","2085297","2085597","68","1416635"
"JH378269","715855","716027","KQ054660v1","3679956","3680128","27","2964101"
"JH378269","824369","824503","KQ055406v1","2968","3106","24","821401"
"JH378269","862245","862529","KQ055065v1","1117201","1117481","87","254956"
"JH378269","943619","943755","KQ054795v1","2377934","2378063","27","1434315"
"JH378269","993254","993542","KQ053288v1","2218996","2219287","71","1225742"
"JH378269","1075312","1075591","KQ054124v1","2442155","2442433","65","1366843"
"JH378269","1102522","1102684","KQ055425v1","1445594","1445758","30","343072"
"JH378269","1110819","1111094","KQ055087v1","1063066","1063349","70","47753"
"JH378269","1261408","1261722","KQ056928v1","1915686","1915996","74","654278"
"JH378269","1301769","1302054","KQ055457v1","9231252","9231546","79","7929483"
"JH378269","1455287","1455456","KQ056672v1","5452932","5453100","48","3997645"
"JH378269","1726885","1727011","KQ057532v1","195960","196086","33","1530925"
"JH378269","1728164","1728333","KQ052969v1","10507290","10507446","43","8779126"
"JH378269","1797590","1797890","KQ058389v1","2329886","2330179","67","532296"
"JH378269","1933323","1933593","KQ053741v1","2705790","2706059","77","772467"
"JH378269","1941454","1941610","KQ058394v1","81695","81845","52","1859759"
"JH378269","1994160","1994451","KQ052969v1","3675361","3675652","57","1681201"
"JH378269","2014516","2014813","KQ053299v1","4095914","4096215","69","2081398"
"JH378269","2266854","2266971","KQ053409v1","6105325","6105446","28","3838471"
"JH378269","2269690","2269825","KQ054510v1","8889038","8889174","28","6619348"
"JH378269","2931506","2931642","KQ053115v1","1333586","1333718","19","1597920"
"JH378269","3243129","3243255","KQ053409v1","6105325","6105446","31","2862196"
"JH378269","3338441","3338570","KQ053718v1","316226","316356","28","3022215"
"JH378269","3422105","3422242","KQ053299v1","7348738","7348881","39","3926633"
"JH378269","3423071","3423189","KQ053752v1","7596252","7596371","29","4173181"
"JH378270","19375","19668","KQ053816v1","5837219","5837503","89","5817844"
"JH378270","109967","110255","KQ058452v1","757762","758043","78","647795"
"JH378270","1174166","1174450","KQ058184v1","1505565","1505858","64","331399"
"JH378270","1325365","1325666","KQ055777v1","745469","745769","69","579896"
"JH378270","1779391","1779649","KQ053191v1","1874915","1875171","80","95524"
"JH378270","1883908","1884014","KQ053256v1","5132292","5132396","30","3248384"
"JH378270","1938256","1938514","KQ058405v1","697304","697560","67","1240952"
"JH378270","2809819","2809954","KQ054943v1","3338657","3338793","43","528838"
"JH378270","2959726","2959985","KQ053230v1","477709","477953","80","2482017"
"JH378270","3287637","3287953","KQ054068v1","5074639","5074944","72","1787002"
"JH378270","3428188","3428482","KQ056587v1","17306365","17306676","77","13878177"
"JH378271","93856","93949","KQ055152v1","1163688","1163781","29","1069832"
"JH378271","194484","194677","KQ054179v1","4085367","4085566","48","3890883"
"JH378271","241825","242116","KQ054202v1","1197930","1198217","59","956105"
"JH378271","359088","359383","KQ052990v1","293181","293473","70","65907"
"JH378271","451487","451790","KQ057911v1","428931","429228","56","22556"
"JH378271","539278","539408","KQ057901v1","1218014","1218146","25","678736"
"JH378271","552953","553251","KQ058184v1","1505565","1505858","67","952612"
"JH378271","621208","621417","KQ057431v1","2411902","2412116","43","1790694"
"JH378271","805680","805984","KQ052970v1","10427454","10427754","83","9621774"
"JH378271","837390","837546","KQ055490v1","2065440","2065590","32","1228050"
"JH378271","841164","841531","KQ057059v1","2555565","2555896","118","1714401"
"JH378271","928246","928473","KQ054693v1","3245566","3245803","55","2317320"
"JH378271","935387","935655","KQ053190v1","4987885","4988162","66","4052498"
"JH378271","966483","966613","KQ053354v1","702320","702452","22","264163"
"JH378271","985395","985685","KQ055014v1","2491689","2491976","71","1506294"
"JH378271","1367178","1367315","KQ058094v1","3687022","3687155","22","2319844"
"JH378271","1775401","1775558","KQ057291v1","765415","765578","36","1009986"
"JH378271","2159369","2159678","KQ053410v1","507437","507742","70","1651932"
"JH378271","2168498","2168776","KQ053288v1","1350431","1350707","70","818067"
"JH378271","2279933","2280113","KQ053032v1","508140","508329","49","1771793"
"JH378271","2317561","2317834","KQ053632v1","579940","580190","80","1737621"
"JH378271","2544370","2544669","KQ058184v1","1505565","1505858","51","1038805"
"JH378271","2740298","2740460","KQ052969v1","8430836","8430996","34","5690538"
"JH378271","2920005","2920208","KQ056375v1","1153881","1154077","61","1766124"
"JH378271","3119780","3120094","KQ054932v1","4838112","4838407","72","1718332"
"JH378271","3172582","3172643","KQ054068v1","1383975","1384041","20","1788607"
"JH378271","3172691","3172917","KQ056108v1","1837748","1837978","58","1334943"
"JH378271","3175948","3176157","KQ054069v1","159011","159235","53","3016937"
"JH378271","3268284","3268389","KQ058050v1","918290","918400","12","2349994"
"JH378271","3268436","3268726","KQ052971v1","646100","646383","67","2622336"
"JH378271","3324366","3324635","KQ055872v1","10113033","10113299","61","6788667"
"JH378271","3469024","3469321","KQ057308v1","1408537","1408826","70","2060487"
"JH378271","3493116","3493392","KQ053146v1","2848155","2848435","66","644961"
"JH378272","51025","51307","KQ057909v1","585646","585918","58","534621"
"JH378272","209430","209669","KQ054224v1","1168104","1168343","69","958674"
"JH378272","257498","257796","KQ058313v1","660634","660924","75","403136"
"JH378272","294246","294349","KQ058458v1","124811","124915","23","169435"
"JH378272","301469","301616","KQ053299v1","7348738","7348881","30","7047269"
"JH378272","335324","335482","KQ053299v1","2812031","2812178","35","2476707"
"JH378272","380974","381247","KQ053718v1","1496748","1497022","62","1115774"
"JH378272","387053","387378","KQ055590v1","1614986","1615298","100","1227933"
"JH378272","556442","556733","KQ058389v1","2329886","2330179","64","1773444"
"JH378272","597767","597910","KQ053146v1","2315136","2315281","33","1717369"
"JH378272","652199","652361","KQ054533v1","1027813","1027974","39","375614"
"JH378272","659015","659299","KQ057290v1","1053741","1054027","83","394726"
"JH378272","708100","708368","KQ055717v1","1651708","1651976","72","943608"
"JH378272","780782","781090","KQ057151v1","1087366","1087668","69","306584"
"JH378272","816583","816820","KQ055192v1","1201363","1201615","76","384780"
"JH378272","904120","904410","KQ056234v1","2521120","2521411","72","1617000"
"JH378272","1012404","1012696","KQ058183v1","594864","595153","70","417540"
"JH378272","1032197","1032502","KQ052970v1","10427454","10427754","75","9395257"
"JH378272","1038675","1038954","KQ058249v1","184192","184468","55","854483"
"JH378272","1283808","1284095","KQ053454v1","649600","649875","66","634208"
"JH378272","1376732","1377017","KQ055957v1","1731327","1731617","61","354595"
"JH378272","1738762","1739045","KQ053093v1","1361295","1361576","68","377467"
"JH378272","1758546","1758843","KQ053631v1","8322466","8322756","67","6563920"
"JH378272","1930680","1930968","KQ055872v1","6063044","6063339","73","4132364"
"JH378272","2002981","2003158","KQ056134v1","2704736","2704912","43","701755"
"JH378272","2160041","2160327","KQ054124v1","2442155","2442433","62","282114"
"JH378272","2589490","2589784","KQ057118v1","465368","465655","76","2124122"
"JH378272","2825001","2825133","KQ058550v1","2035409","2035537","36","789592"
"JH378272","2937080","2937356","KQ053498v1","3402648","3402924","76","465568"
"JH378272","2969437","2969521","KQ055065v1","2126335","2126429","27","843102"
"JH378272","3342789","3343067","KQ053093v1","1361295","1361576","60","1981494"
"JH378273","393078","393372","KQ053816v1","7464708","7465010","65","7071630"
"JH378273","307758","307924","KQ053631v1","1550584","1550749","36","1242826"
"JH378273","536399","536562","KQ054725v1","735942","736116","38","199543"
"JH378273","539954","540165","KQ058283v1","1504866","1505073","53","964912"
"JH378273","603215","603521","KQ058360v1","344917","345206","90","258298"
"JH378273","630886","631151","KQ058316v1","4697990","4698273","77","4067104"
"JH378273","764435","764721","KQ057755v1","45985","46262","65","718450"
"JH378273","827918","828049","KQ057648v1","2314551","2314685","22","1486633"
"JH378273","829295","829429","KQ054932v1","5190304","5190436","30","4361009"
"JH378273","837093","837367","KQ057290v1","3760817","3761084","68","2923724"
"JH378273","886869","887179","KQ053465v1","3806004","3806288","73","2919135"
"JH378273","1138960","1139245","KQ056928v1","274365","274652","63","864595"
"JH378273","1146987","1147274","KQ057004v1","1506143","1506432","75","359156"
"JH378273","1524102","1524391","KQ058004v1","1480411","1480689","66","43691"
"JH378273","1951612","1951903","KQ058413v1","348155","348432","74","1603457"
"JH378273","2011006","2011313","KQ054412v1","2490468","2490761","77","479462"
"JH378273","2140971","2141258","KQ058275v1","938649","938919","80","1202322"
"JH378273","2156900","2157147","KQ055457v1","1902633","1902878","74","254267"
"JH378273","2375206","2375516","KQ055629v1","135233","135538","70","2239973"
"JH378273","2502128","2502324","KQ054401v1","3245220","3245428","55","743092"
"JH378273","2741721","2741937","KQ055540v1","3334089","3334331","71","592368"
"JH378273","2844387","2844695","KQ058389v1","660695","660988","82","2183692"
"JH378274","140323","140577","KQ056147v1","3491603","3491838","60","3351280"
"JH378274","416058","416364","KQ053300v1","2874445","2874736","67","2458387"
"JH378274","471204","471353","KQ054466v1","1866785","1866925","47","1395581"
"JH378274","547464","547697","KQ054693v1","2405955","2406178","58","1858491"
"JH378274","570575","570869","KQ053816v1","7327018","7327317","68","6756443"
"JH378274","660912","661085","KQ055384v1","112089","112268","55","548823"
"JH378274","700522","700651","KQ056404v1","1195188","1195317","28","494666"
"JH378274","872119","872376","KQ058405v1","697304","697560","71","174815"
"JH378274","898141","898434","KQ057875v1","561558","561851","73","336583"
"JH378274","1261768","1261923","KQ057737v1","3327678","3327839","48","2065910"
"JH378274","1426128","1426397","KQ053096v1","602899","603182","67","823229"
"JH378274","1501728","1502042","KQ055852v1","1231373","1231668","82","270355"
"JH378274","1669209","1669347","KQ054954v1","879300","879438","42","789909"
"JH378274","2373137","2373277","KQ052968v1","8523342","8523490","35","6150205"
"JH378274","2521847","2521994","KQ055183v1","2514156","2514302","38","7691"
"JH378274","2530944","2531227","KQ055777v1","2252512","2252796","73","278432"
"JH378274","2641919","2642082","KQ055425v1","1445594","1445758","48","1196325"
"JH378274","3273385","3273690","KQ054400v1","1644314","1644619","72","1629071"
"JH378275","164131","164430","KQ057290v1","1100809","1101109","109","936678"
"JH378275","196667","196887","KQ058383v1","8692134","8692359","63","8495467"
"JH378275","1189946","1190235","KQ058316v1","1439391","1439671","71","249445"
"JH378275","1650359","1650636","KQ056404v1","1771928","1772196","66","121569"
"JH378275","1835789","1835959","KQ055140v1","1129098","1129272","44","706691"
"JH378275","1907196","1907494","KQ054713v1","2139616","2139910","65","232420"
"JH378275","1989305","1989568","KQ052969v1","7351818","7352090","66","5362513"
"JH378275","2078668","2078832","KQ053191v1","3634315","3634484","33","1555647"
"JH378275","2093602","2093834","KQ056855v1","244832","245055","72","1848770"
"JH378275","2399300","2399593","KQ056672v1","3535300","3535593","76","1136000"
"JH378275","2401552","2401834","KQ055629v1","1979911","1980189","63","421641"
"JH378275","2421459","2421737","KQ056404v1","1771928","1772196","68","649531"
"JH378275","2551124","2551394","KQ057909v1","763467","763734","64","1787657"
"JH378275","2584501","2584805","KQ058350v1","6740286","6740580","73","4155785"
"JH378275","2660998","2661279","KQ058352v1","859926","860214","65","1801072"
"JH378275","2748499","2748804","KQ054213v1","780092","780393","63","1968407"
"JH378275","2775573","2775881","KQ054786v1","934497","934799","68","1841076"
"JH378275","2786408","2786718","KQ057099v1","648781","649090","76","2137627"
"JH378275","2938094","2938388","KQ053093v1","3162517","3162806","64","224423"
"JH378275","3064045","3064342","KQ058226v1","265143","265437","67","2798902"
"JH378275","3069747","3069821","KQ053520v1","1561632","1561710","20","1508115"
"JH378275","3291906","3292114","KQ056996v1","148346","148555","45","3143560"
"JH378276","275127","275430","KQ055004v1","332895","333205","68","57768"
"JH378276","279655","279952","KQ054412v1","2490468","2490761","57","2210813"
"JH378276","301272","301548","KQ055978v1","3560415","3560681","62","3259143"
"JH378276","428717","428831","KQ054921v1","165725","165837","27","262992"
"JH378276","627517","627718","KQ054068v1","1767221","1767410","53","1139704"
"JH378276","630329","630611","KQ053093v1","3162517","3162806","70","2532188"
"JH378276","1267387","1267652","KQ054725v1","2213545","2213811","70","946158"
"JH378276","1343223","1343448","KQ055457v1","9003971","9004197","53","7660748"
"JH378276","1362055","1362362","KQ055987v1","77625","77928","65","1284430"
"JH378276","1363444","1363565","KQ056235v1","1725320","1725441","30","361876"
"JH378276","1459333","1459509","KQ053387v1","3518506","3518663","59","2059173"
"JH378276","1463385","1463629","KQ056440v1","7067","7315","75","1456318"
"JH378276","1638525","1638798","KQ053190v1","4987885","4988162","56","3349360"
"JH378276","1747760","1748059","KQ053093v1","1375309","1375598","79","372451"
"JH378276","1882691","1882950","KQ058272v1","5539241","5539492","66","3656550"
"JH378276","2217438","2217721","KQ058266v1","1113469","1113760","71","1103969"
"JH378276","2258036","2258193","KQ056996v1","1524030","1524195","32","734006"
"JH378276","2271619","2271903","KQ056423v1","1792966","1793243","68","478653"
"JH378276","2360459","2360741","KQ058427v1","4488063","4488350","65","2127604"
"JH378276","2389617","2389914","KQ054704v1","223675","223980","73","2165942"
"JH378276","2656523","2656812","KQ058350v1","6740286","6740580","69","4083763"
"JH378276","2846297","2846533","KQ054932v1","4146161","4146408","68","1299864"
"JH378276","2934760","2934892","KQ056652v1","675563","675695","22","2259197"
"JH378276","2935842","2936179","KQ053299v1","21835674","21835971","95","18899832"
"JH378276","3037615","3037778","KQ053827v1","4961567","4961731","33","1923952"
"JH378276","3050166","3050297","KQ055755v1","801738","801870","26","2248428"
"JH378276","3150113","3150409","KQ054401v1","2629005","2629296","64","521108"
"JH378277","43206","43493","KQ053409v1","6051156","6051445","52","6007950"
"JH378277","237880","238167","KQ058539v1","1700786","1701070","67","1462906"
"JH378277","422232","422520","KQ058004v1","4701579","4701856","71","4279347"
"JH378277","446949","447075","KQ053763v1","4935139","4935266","34","4488190"
"JH378277","663514","663801","KQ054068v1","2986206","2986480","56","2322692"
"JH378277","874284","874578","KQ057693v1","249719","250017","64","624565"
"JH378277","923319","923470","KQ054196v1","237","387","32","923082"
"JH378277","925876","925980","KQ055141v1","2421865","2421977","25","1495989"
"JH378277","961212","961481","KQ055192v1","1201363","1201615","64","240151"
"JH378277","1082950","1083250","KQ054704v1","223675","223980","70","859275"
"JH378277","1099197","1099461","KQ054932v1","4469926","4470179","67","3370729"
"JH378277","1227128","1227374","KQ058503v1","123813","124064","67","1103315"
"JH378277","1324479","1324773","KQ053299v1","21835674","21835971","71","20511195"
"JH378277","1544263","1544557","KQ053816v1","7464708","7465010","74","5920445"
"JH378277","1748959","1749221","KQ058094v1","5430881","5431130","63","3681922"
"JH378277","1807572","1807797","KQ054932v1","5992696","5992910","62","4185124"
"JH378277","1838075","1838371","KQ058512v1","329344","329634","76","1508731"
"JH378277","1961692","1961957","KQ055755v1","209063","209333","72","1752629"
"JH378277","1962072","1962224","KQ055725v1","720931","721083","32","1241141"
"JH378277","1983172","1983331","KQ058407v1","217537","217702","46","1765635"
"JH378277","1987278","1987570","KQ058516v1","1789801","1790088","62","197477"
"JH378277","1995145","1995405","KQ055364v1","1919520","1919774","65","75625"
"JH378277","2025154","2025461","KQ054786v1","934497","934799","65","1090657"
"JH378277","2067478","2067789","KQ053795v1","1729459","1729773","71","338019"
"JH378277","2128872","2128974","KQ054826v1","2918265","2918358","30","789393"
"JH378277","2170585","2170869","KQ056331v1","348695","348980","68","1821890"
"JH378277","2223972","2224220","KQ053948v1","1892815","1893053","74","331157"
"JH378277","2471359","2471654","KQ053849v1","2199927","2200219","68","271432"
"JH378277","2600132","2600340","KQ053741v1","1190544","1190756","48","1409588"
"JH378277","2601997","2602156","KQ056643v1","1174972","1175125","36","1427025"
"JH378277","2715280","2715488","KQ057290v1","4560361","4560561","56","1845081"
"JH378277","2715963","2716185","KQ055872v1","3361212","3361420","64","645249"
"JH378277","2756188","2756490","KQ053740v1","2323389","2323680","93","432799"
"JH378277","2766042","2766330","KQ053465v1","3818784","3819069","62","1052742"
"JH378277","3130207","3130393","KQ055119v1","2614682","2614878","43","515525"
"JH378277","3133192","3133314","KQ053409v1","6105325","6105446","28","2972133"
"JH378278","263549","263819","KQ055777v1","2252512","2252796","78","1988963"
"JH378278","355533","355822","KQ058353v1","1264780","1265071","69","909247"
"JH378278","641160","641387","KQ052968v1","8564552","8564784","72","7923392"
"JH378278","968343","968636","KQ053109v1","131996","132292","74","836347"
"JH378278","1057672","1057843","KQ052969v1","8430836","8430996","44","7373164"
"JH378278","1149576","1149788","KQ056493v1","5256811","5257011","58","4107235"
"JH378278","1452201","1452487","KQ057755v1","45985","46262","71","1406216"
"JH378278","2242890","2243175","KQ058389v1","2329886","2330179","70","86996"
"JH378278","2854907","2855205","KQ056345v1","621994","622295","67","2232913"
"JH378278","2941807","2941953","KQ058394v1","81695","81845","40","2860112"
"JH378278","2973816","2974113","KQ056440v1","1069847","1070137","65","1903969"
"JH378278","2980822","2980953","KQ056936v1","1658601","1658746","37","1322221"
"JH378278","3018466","3018777","KQ053785v1","807454","807767","70","2211012"
"JH378278","3075613","3075874","KQ052971v1","6441372","6441626","74","3365759"
"JH378279","15186","15490","KQ053299v1","3823059","3823361","70","3807873"
"JH378279","157469","157756","KQ053223v1","2852845","2853123","75","2695376"
"JH378279","290111","290418","KQ058184v1","1505565","1505858","76","1215454"
"JH378279","543995","544274","KQ058316v1","753926","754202","63","209931"
"JH378279","625385","625631","KQ053654v1","3892663","3892904","61","3267278"
"JH378279","661596","661901","KQ058585v1","580456","580763","64","81140"
"JH378279","775784","776113","KQ055247v1","2654083","2654401","92","1878299"
"JH378279","822135","822380","KQ053212v1","670457","670693","68","151678"
"JH378279","1058920","1059221","KQ053631v1","7288314","7288608","74","6229394"
"JH378279","1074573","1074882","KQ053332v1","771022","771332","88","303551"
"JH378279","1270310","1270575","KQ058394v1","3915274","3915538","74","2644964"
"JH378279","1299558","1299869","KQ058550v1","3068705","3069008","64","1769147"
"JH378279","1349245","1349512","KQ055065v1","999059","999338","64","350186"
"JH378279","1455846","1456152","KQ053565v1","2344303","2344603","76","888457"
"JH378279","1545592","1545762","KQ056996v1","1524030","1524195","32","21562"
"JH378279","1621978","1622027","KQ054135v1","1661841","1661887","14","39863"
"JH378279","1655499","1655801","KQ053654v1","5318679","5318982","66","3663180"
"JH378279","1683982","1684077","KQ054412v1","2917475","2917568","23","1233493"
"JH378279","1928582","1928718","KQ058494v1","1124502","1124638","26","804080"
"JH378279","1988380","1988672","KQ058316v1","6456357","6456653","59","4467977"
"JH378279","2112199","2112503","KQ054704v1","223675","223980","70","1888524"
"JH378279","2213992","2214278","KQ053146v1","2819587","2819868","75","605595"
"JH378279","2248501","2248788","KQ054932v1","10830322","10830609","63","8581821"
"JH378279","2395402","2395553","KQ054412v1","2185013","2185160","28","210389"
"JH378279","2493509","2493819","KQ055755v1","446339","446640","83","2047170"
"JH378279","2503821","2504053","KQ053026v1","2213601","2213834","70","290220"
"JH378279","2664963","2665101","KQ057931v1","224937","225072","25","2440026"
"JH378279","2777055","2777184","KQ056044v1","1806435","1806551","39","970620"
"JH378279","2908872","2909171","KQ058184v1","1505565","1505858","66","1403307"
"JH378279","2917160","2917405","KQ055725v1","3090816","3091074","60","173656"
"JH378279","2972884","2973181","KQ053565v1","3983143","3983404","86","1010259"
"JH378279","3126269","3126557","KQ055247v1","216427","216708","66","2909842"
"JH378280","72862","73117","KQ053740v1","548757","549009","64","475895"
"JH378280","187169","187301","KQ053861v1","8359","8490","21","178810"
"JH378280","224627","224760","KQ052970v1","9702416","9702545","22","9477789"
"JH378280","247040","247350","KQ054068v1","5491779","5492087","70","5244739"
"JH378280","334901","335033","KQ057488v1","512192","512325","23","177291"
"JH378280","387847","387988","KQ056320v1","2323247","2323381","42","1935400"
"JH378280","726523","726764","KQ054932v1","4146161","4146408","62","3419638"
"JH378280","819464","819753","KQ054068v1","1099741","1100039","71","280277"
"JH378280","827985","828094","KQ054921v1","165725","165837","27","662260"
"JH378280","1147585","1147856","KQ053409v1","5686466","5686740","71","4538881"
"JH378280","1221533","1221832","KQ053299v1","4095914","4096215","72","2874381"
"JH378280","1359203","1359496","KQ054693v1","832788","833076","57","526415"
"JH378280","1566576","1566852","KQ052968v1","10629964","10630247","65","9063388"
"JH378280","2004598","2004765","KQ053082v1","2181762","2181924","41","177164"
"JH378280","2585288","2585584","KQ058184v1","1505565","1505858","62","1079723"
"JH378280","2887541","2887674","KQ057449v1","1943131","1943261","25","944410"
"JH378280","3093962","3094072","KQ053157v1","8174152","8174260","25","5080190"
"JH378281","37092","37379","KQ056475v1","2179070","2179363","64","2141978"
"JH378281","48944","49109","KQ053037v1","631347","631512","36","582403"
"JH378281","168232","168354","KQ056235v1","1725320","1725441","20","1557088"
"JH378281","374411","374626","KQ053398v1","3158290","3158500","46","2783879"
"JH378281","529627","529890","KQ058516v1","1888551","1888807","63","1358924"
"JH378281","817621","817790","KQ053300v1","380498","380669","55","437123"
"JH378281","858606","858890","KQ053299v1","2118230","2118517","77","1259624"
"JH378281","896532","896830","KQ058428v1","2055160","2055453","74","1158628"
"JH378281","918903","919212","KQ053146v1","920355","920648","92","1452"
"JH378281","963227","963498","KQ054069v1","4151356","4151622","84","3188129"
"JH378281","990042","990308","KQ058542v1","46421","46681","72","943621"
"JH378281","1039987","1040268","KQ053332v1","447571","447853","62","592416"
"JH378281","1083791","1083836","KQ053696v1","2515039","2515082","10","1431248"
"JH378281","1144857","1144986","KQ058094v1","3687022","3687155","25","2542165"
"JH378281","1155928","1156228","KQ053432v1","7885304","7885597","78","6729376"
"JH378281","1176034","1176324","KQ058317v1","5506620","5506904","62","4330586"
"JH378281","1244341","1244485","KQ054401v1","3742804","3742954","34","2498463"
"JH378281","1446995","1447208","KQ055717v1","640981","641187","56","806014"
"JH378281","1574467","1574615","KQ053718v1","316226","316356","49","1258241"
"JH378281","1719204","1719493","ABDC02054223v1","3152","3442","70","1716052"
"JH378281","1955571","1955874","KQ055183v1","1088963","1089262","66","866608"
"JH378281","2012596","2012900","KQ053948v1","168940","169229","79","1843656"
"JH378281","2029540","2029729","KQ053978v1","48420","48611","48","1981120"
"JH378281","2053443","2053735","KQ054412v1","1824448","1824730","73","228995"
"JH378281","2055026","2055298","KQ058538v1","1444447","1444703","81","610579"
"JH378281","2059597","2059910","KQ053554v1","2471177","2471484","67","411580"
"JH378281","2144769","2144936","KQ058272v1","6462496","6462668","48","4317727"
"JH378281","2372023","2372331","KQ056568v1","1617795","1618102","68","754228"
"JH378281","2548268","2548398","KQ054179v1","3927334","3927468","21","1379066"
"JH378281","2952218","2952350","KQ054510v1","2941967","2942098","26","10251"
"JH378281","3004563","3004849","KQ057755v1","45985","46262","59","2958578"
"JH378282","16360","16525","KQ054510v1","8776051","8776210","48","8759691"
"JH378282","179567","179695","KQ053982v1","3934263","3934401","35","3754696"
"JH378282","348911","349171","KQ053465v1","2490819","2491086","74","2141908"
"JH378282","740511","740663","KQ054576v1","2685252","2685406","31","1944741"
"JH378282","742412","742543","KQ053409v1","6573923","6574054","25","5831511"
"JH378282","759633","759810","KQ052982v1","1147716","1147889","52","388083"
"JH378282","850718","850991","KQ053409v1","3716306","3716585","72","2865588"
"JH378282","880874","881157","KQ055036v1","1478515","1478803","61","597641"
"JH378282","920401","920691","KQ055097v1","1884579","1884874","60","964178"
"JH378282","2061454","2061752","KQ053631v1","9116387","9116675","76","7054933"
"JH378282","2121197","2121324","KQ054682v1","1410308","1410435","20","710889"
"JH378282","2143226","2143525","KQ054400v1","2791993","2792290","73","648767"
"JH378282","2178724","2179003","KQ056423v1","218256","218517","86","1960468"
"JH378282","2299022","2299208","KQ057737v1","835784","835962","56","1463238"
"JH378282","2310656","2310908","KQ058643v1","858469","858727","57","1452187"
"JH378282","2451932","2452210","KQ053332v1","127947","128230","63","2323985"
"JH378283","40280","40406","KQ053146v1","2799678","2799801","31","2759398"
"JH378283","639959","640106","KQ053190v1","2372433","2372579","34","1732474"
"JH378283","963260","963551","KQ054068v1","1268545","1268823","73","305285"
"JH378283","1324782","1324936","KQ054576v1","2685252","2685406","33","1360470"
"JH378283","1624365","1624654","KQ057693v1","117172","117472","66","1507193"
"JH378283","1746413","1746627","KQ053643v1","2492538","2492752","53","746125"
"JH378283","2129941","2130086","ABDC02029150v1","2120","2268","41","2127821"
"JH378283","2232851","2233157","KQ058184v1","1505565","1505858","72","727286"
"JH378283","2320147","2320415","KQ055065v1","1117201","1117481","71","1202946"
"JH378283","2379422","2379652","KQ053971v1","1587972","1588205","83","791450"
"JH378283","2549988","2550275","KQ053960v1","70067","70362","65","2479921"
"JH378283","2989232","2989517","KQ055957v1","1731327","1731617","65","1257905"
"JH378283","3035981","3036055","KQ055173v1","599075","599150","25","2436906"
"JH378284","184817","185134","KQ056014v1","335464","335774","70","150647"
"JH378284","209394","209577","KQ055777v1","2184681","2184834","56","1975287"
"JH378284","421955","422204","KQ053115v1","1574256","1574486","62","1152301"
"JH378284","493953","494237","KQ054069v1","955693","955974","69","461740"
"JH378284","605389","605654","KQ053565v1","1909206","1909471","75","1303817"
"JH378284","656688","656968","KQ057205v1","1174433","1174713","74","517745"
"JH378284","1385018","1385256","KQ053654v1","3892663","3892904","68","2507645"
"JH378284","1599844","1600114","KQ052969v1","11182978","11183250","63","9583134"
"JH378284","1679090","1679370","KQ057755v1","45985","46262","66","1633105"
"JH378284","1836577","1836802","KQ053135v1","5399862","5400092","73","3563285"
"JH378284","2567587","2567863","KQ052969v1","11182978","11183250","67","8615391"
"JH378284","2571513","2571767","KQ053387v1","564882","565122","60","2006631"
"JH378284","2584117","2584254","KQ057648v1","2314551","2314685","30","269566"
"JH378284","2599043","2599292","KQ055629v1","27732","27989","60","2571311"
"JH378284","2740008","2740232","KQ053354v1","1943191","1943424","54","796817"
"JH378284","2794366","2794582","KQ055375v1","809382","809596","69","1984984"
"JH378285","1441602","1441835","KQ055590v1","1404557","1404784","60","37045"
"JH378285","41888","42094","KQ053081v1","1259521","1259727","52","1217633"
"JH378285","560138","560423","KQ052969v1","9553757","9554052","76","8993619"
"JH378285","621653","621999","KQ058290v1","511568","511873","98","110085"
"JH378285","731721","732015","KQ054565v1","6874735","6875031","60","6143014"
"JH378285","778552","778832","KQ056587v1","9000240","9000528","74","8221688"
"JH378285","1797354","1797653","KQ058184v1","1505565","1505858","58","291789"
"JH378285","1967468","1967602","KQ058427v1","4756553","4756686","22","2789085"
"JH378285","1998978","1999298","KQ054682v1","2125705","2126015","78","126727"
"JH378285","2047020","2047174","KQ054196v1","237","387","38","2046783"
"JH378285","2136819","2137115","KQ054213v1","780092","780393","56","1356727"
"JH378285","2722621","2722931","KQ054068v1","5491779","5492087","67","2769158"
"JH378285","2781757","2782048","KQ058594v1","2836175","2836471","72","54418"
"JH378286","86823","86987","KQ057480v1","674678","674843","37","587855"
"JH378286","739933","740220","KQ053093v1","3162517","3162806","73","2422584"
"JH378286","877590","877878","KQ058184v1","1505565","1505858","74","627975"
"JH378286","1991574","1991829","KQ054693v1","3245566","3245803","73","1253992"
"JH378286","2058129","2058288","KQ054180v1","70685","70834","42","1987444"
"JH378286","2274512","2274799","KQ058278v1","381941","382234","76","1892571"
"JH378287","440479","440688","KQ053609v1","2642121","2642332","54","2201642"
"JH378287","782938","783233","KQ054826v1","11793577","11793880","72","11010639"
"JH378287","980526","980810","KQ053300v1","2874445","2874736","73","1893919"
"JH378287","1843480","1843615","KQ053686v1","1108593","1108721","31","734887"
"JH378287","2136223","2136348","KQ053409v1","6105325","6105446","31","3969102"
"JH378287","2408004","2408187","KQ053774v1","1982290","1982469","62","425714"
"JH378287","2547813","2547942","KQ053108v1","477534","477668","29","2070279"
"JH378287","2558093","2558352","KQ055192v1","1201363","1201615","60","1356730"
"JH378288","52246","52536","KQ057290v1","534242","534517","71","481996"
"JH378288","234922","235208","KQ056147v1","1064032","1064323","58","829110"
"JH378288","313007","313285","KQ053299v1","4869507","4869790","70","4556500"
"JH378288","589174","589329","KQ057480v1","655209","655365","36","66035"
"JH378288","589574","589726","KQ053354v1","702320","702452","41","112746"
"JH378288","611678","611957","KQ054660v1","3497722","3498007","74","2886044"
"JH378288","671102","671397","KQ057290v1","2180782","2181079","64","1509680"
"JH378288","682769","682929","KQ057737v1","1426090","1426247","35","743321"
"JH378288","685183","685347","KQ053037v1","631347","631512","35","53836"
"JH378288","756933","757242","KQ058184v1","1505565","1505858","71","748632"
"JH378288","759349","759604","KQ056773v1","122800","123057","57","636549"
"JH378288","824748","824863","KQ056235v1","1725320","1725441","24","900572"
"JH378288","955791","956092","KQ054401v1","2629005","2629296","70","1673214"
"JH378288","1156816","1157130","KQ058561v1","583947","584226","98","572869"
"JH378288","1164220","1164470","KQ055192v1","1201363","1201615","59","37143"
"JH378288","1229236","1229412","KQ058459v1","469480","469653","35","759756"
"JH378288","1230053","1230181","KQ054068v1","3785962","3786083","42","2555909"
"JH378288","1250545","1250672","KQ053354v1","702320","702452","20","548225"
"JH378288","1335667","1335959","KQ058184v1","1505565","1505858","57","169898"
"JH378288","1409234","1409521","KQ054180v1","1484199","1484494","70","74965"
"JH378288","1817522","1817695","KQ057560v1","2172970","2173133","41","355448"
"JH378288","1949423","1949562","KQ054954v1","879300","879438","36","1070123"
"JH378288","1963109","1963269","KQ057560v1","2172970","2173133","40","209861"
"JH378288","1973591","1973868","KQ054202v1","1197930","1198217","72","775661"
"JH378288","2313031","2313332","KQ058184v1","1505565","1505858","72","807466"
"JH378288","2360835","2361064","KQ054921v1","1712964","1713196","53","647871"
"JH378288","2361922","2362245","KQ055248v1","947170","947461","91","1414752"
"JH378288","2481479","2481610","KQ057910v1","1548802","1548933","18","932677"
"JH378288","2491120","2491401","KQ058594v1","2023684","2023963","75","467436"
"JH378288","2690444","2690739","KQ055557v1","4628423","4628710","80","1937979"
"JH378288","2730279","2730422","KQ054179v1","3865170","3865294","37","1134891"
"JH378288","2732350","2732460","KQ053157v1","8174152","8174260","24","5441802"
"JH378289","4690","4946","KQ055141v1","2639315","2639579","69","2634625"
"JH378289","1539846","1540112","KQ053202v1","1134199","1134469","70","405647"
"JH378289","1906441","1906724","KQ057118v1","393210","393488","74","1513231"
"JH378289","2003998","2004141","KQ053190v1","2372433","2372579","31","368435"
"JH378289","2005704","2005831","KQ054179v1","3865170","3865294","29","1859466"
"JH378289","2160322","2160610","KQ053093v1","1361295","1361576","82","799027"
"JH378289","2490230","2490338","KQ052969v1","2661859","2661968","30","171629"
"JH378289","2508947","2509244","KQ058462v1","283306","283598","68","2225641"
"JH378289","2549131","2549416","KQ053816v1","7464708","7465010","63","4915577"
"JH378289","2642351","2642566","KQ054724v1","2773806","2774015","65","131455"
"JH378289","2702500","2702787","KQ055352v1","4380175","4380453","73","1677675"
"JH378289","2778709","2779011","KQ053398v1","1756246","1756533","77","1022463"
"JH378289","2779781","2780064","KQ053082v1","1085491","1085778","86","1694290"
"JH378289","2817442","2817576","KQ054179v1","3927334","3927468","23","1109892"
"JH378289","2817660","2817829","KQ056996v1","1524030","1524195","43","1293630"
"JH378290","302810","303074","KQ053267v1","3621249","3621519","73","3318439"
"JH378290","312454","312725","KQ053190v1","4987885","4988162","64","4675431"
"JH378290","678680","678802","KQ053070v1","2111294","2111415","34","1432614"
"JH378290","714956","715251","KQ055755v1","446339","446640","72","268617"
"JH378290","739433","739559","KQ053191v1","1086674","1086785","40","347241"
"JH378290","743327","743490","KQ056672v1","5452932","5453100","33","4709605"
"JH378290","858035","858326","KQ054693v1","832788","833076","68","25247"
"JH378290","943000","943074","KQ058076v1","120666","120729","28","822334"
"JH378290","973984","974285","KQ058184v1","1505565","1505858","58","531581"
"JH378290","1148425","1148538","KQ053785v1","828746","828862","24","319679"
"JH378290","1390785","1390939","KQ053037v1","3255963","3256108","37","1865178"
"JH378290","1517869","1518143","KQ053631v1","9398334","9398603","62","7880465"
"JH378290","1563485","1563791","KQ054786v1","934497","934799","63","628988"
"JH378290","1603457","1603739","KQ054400v1","3760476","3760752","64","2157019"
"JH378290","1747621","1747932","KQ058317v1","5506620","5506904","77","3758999"
"JH378290","1837686","1837994","KQ055119v1","3293975","3294284","69","1456289"
"JH378290","1838050","1838326","KQ057291v1","322948","323180","82","1515102"
"JH378290","1981327","1981624","KQ054412v1","2490468","2490761","59","509141"
"JH378290","2109193","2109455","KQ058546v1","168071","168339","72","1941122"
"JH378290","2123599","2123672","KQ055893v1","2912845","2912909","23","789246"
"JH378290","2177895","2178189","KQ055557v1","4063555","4063849","77","1885660"
"JH378290","2299871","2300154","KQ053565v1","754705","754987","58","1545166"
"JH378290","2304420","2304737","KQ053288v1","5748854","5749169","84","3444434"
"JH378290","2405664","2405972","KQ058305v1","2335011","2335313","67","70653"
"JH378290","2411574","2411741","KQ055872v1","5870772","5870928","38","3459198"
"JH378290","2411886","2411969","KQ053816v1","6703101","6703179","33","4291215"
"JH378290","2455419","2455706","KQ053299v1","3622388","3622669","77","1166969"
"JH378290","2568469","2568766","KQ055468v1","2950644","2950940","59","382175"
"JH378290","2689460","2689560","KQ052969v1","2661859","2661968","27","27601"
"JH378290","2762765","2763037","KQ053631v1","8893553","8893834","80","6130788"
"JH378291","53004","53303","KQ054412v1","2490468","2490761","61","2437464"
"JH378291","112571","112788","KQ055375v1","809382","809596","52","696811"
"JH378291","163820","163974","KQ056456v1","904731","904889","39","740911"
"JH378291","474402","474693","KQ055725v1","518672","518947","86","44270"
"JH378291","489418","489712","KQ053299v1","2118230","2118517","67","1628812"
"JH378291","520819","520960","KQ054179v1","3927334","3927468","32","3406515"
"JH378291","546138","546290","KQ053157v1","7874292","7874430","51","7328154"
"JH378291","656772","657070","KQ053398v1","2431232","2431537","66","1774460"
"JH378291","674337","674635","KQ057858v1","376905","377209","64","297432"
"JH378291","694733","694875","KQ054466v1","1866785","1866925","34","1172052"
"JH378291","695017","695166","KQ054412v1","2185013","2185160","27","1489996"
"JH378291","699524","699659","KQ057931v1","224937","225072","16","474587"
"JH378291","700280","700452","KQ057082v1","645637","645822","54","54643"
"JH378291","720876","721006","KQ054047v1","1054810","1054936","27","333934"
"JH378291","767731","767865","KQ058427v1","4756553","4756686","24","3988822"
"JH378291","851691","851979","KQ058583v1","1850638","1850927","55","998947"
"JH378291","870268","870426","KQ057737v1","1426090","1426247","36","555822"
"JH378291","920544","920678","KQ053752v1","1383162","1383295","31","462618"
"JH378291","1001613","1001905","KQ053948v1","2955232","2955526","56","1953619"
"JH378291","1007323","1007451","KQ058550v1","4488728","4488857","27","3481405"
"JH378291","1022681","1022971","KQ053476v1","1823610","1823912","70","800929"
"JH378291","1034328","1034445","KQ054910v1","1548749","1548865","27","514421"
"JH378291","1052999","1053308","KQ057909v1","12108614","12108924","67","11055615"
"JH378291","1125834","1125981","KQ053115v1","1650505","1650644","29","524671"
"JH378291","1174188","1174447","KQ054146v1","3258465","3258719","68","2084277"
"JH378291","1183895","1184181","KQ052968v1","9641706","9641986","67","8457811"
"JH378291","1327662","1327972","KQ058527v1","5208632","5208933","75","3880970"
"JH378291","1370177","1370370","KQ055014v1","2321535","2321726","53","951358"
"JH378291","1375134","1375325","KQ053631v1","7168494","7168680","48","5793360"
"JH378291","1386902","1387193","KQ053948v1","168940","169229","74","1217962"
"JH378291","1392896","1393185","KQ058316v1","4697990","4698273","62","3305094"
"JH378291","1412888","1413164","KQ057693v1","271965","272244","72","1140923"
"JH378291","1421398","1421692","KQ055352v1","6690633","6690913","87","5269235"
"JH378291","1474945","1475200","KQ058320v1","856678","856938","68","618267"
"JH378291","1480461","1480574","KQ053916v1","191904","192015","33","1288557"
"JH378291","1480773","1480895","KQ054522v1","1628214","1628331","32","147441"
"JH378291","1543002","1543294","KQ053409v1","3716306","3716585","64","2173304"
"JH378291","1591582","1591796","KQ054069v1","159011","159235","58","1432571"
"JH378291","1674709","1675002","KQ056345v1","621994","622295","58","1052715"
"JH378291","1677121","1677406","KQ055035v1","4381466","4381744","70","2704345"
"JH378291","1684921","1685099","KQ053354v1","52179","52349","44","1632742"
"JH378291","1686010","1686312","KQ058427v1","6207003","6207299","78","4520993"
"JH378291","1729306","1729589","KQ058316v1","6284943","6285210","96","4555637"
"JH378291","1739632","1739757","KQ056200v1","30786","30917","26","1708846"
"JH378291","1799018","1799272","KQ057291v1","667476","667747","73","1131542"
"JH378291","1998391","1998548","KQ053135v1","3353675","3353825","35","1355284"
"JH378291","2017891","2018180","KQ053096v1","602899","603182","68","1414992"
"JH378291","2147964","2148154","KQ055404v1","3762645","3762830","42","1614681"
"JH378291","2273883","2274077","KQ056234v1","1020319","1020518","52","1253564"
"JH378291","2568457","2568742","KQ058094v1","3646770","3647052","69","1078313"
"JH378291","2625548","2625856","KQ054921v1","2378911","2379222","67","246637"
"JH378292","119020","119304","KQ053476v1","3998036","3998311","80","3879016"
"JH378292","146475","146758","KQ055978v1","3560415","3560681","69","3413940"
"JH378292","226146","226417","KQ058004v1","3112196","3112474","69","2886050"
"JH378292","333018","333282","KQ055247v1","216427","216708","76","116591"
"JH378292","355066","355366","KQ057711v1","3794033","3794324","79","3438967"
"JH378292","408690","408970","KQ058561v1","583947","584226","60","175257"
"JH378292","477475","477553","KQ056672v1","1816118","1816198","25","1338643"
"JH378292","596253","596532","KQ058316v1","753926","754202","69","157673"
"JH378292","611407","611509","KQ055872v1","5141445","5141541","23","4530038"
"JH378292","964325","964607","KQ053146v1","2819587","2819868","72","1855262"
"JH378292","1011700","1012017","KQ053332v1","771022","771332","85","240678"
"JH378292","1056339","1056545","KQ053256v1","942460","942674","51","113879"
"JH378292","1188429","1188735","KQ053179v1","2012868","2013172","71","824439"
"JH378292","1194689","1194988","KQ052970v1","3660551","3660853","74","2465862"
"JH378292","1510175","1510273","KQ053223v1","2552349","2552442","31","1042174"
"JH378292","1510507","1510602","KQ054179v1","1673076","1673160","40","162569"
"JH378292","1520881","1521171","KQ052970v1","6519506","6519794","83","4998625"
"JH378292","1585506","1585770","KQ054932v1","6885445","6885700","74","5299939"
"JH378292","1853356","1853663","KQ053299v1","13931847","13932149","74","12078491"
"JH378292","1886930","1887108","KQ056996v1","1524030","1524195","49","362900"
"JH378292","2091429","2091545","KQ053696v1","870907","871022","36","1220522"
"JH378292","2388927","2389223","KQ055852v1","1231373","1231668","65","1157554"
"JH378293","245436","245715","KQ052968v1","6282633","6282918","59","6037197"
"JH378293","778862","779160","KQ054069v1","7687863","7688158","65","6909001"
"JH378293","820561","820830","KQ058287v1","849489","849747","73","28928"
"JH378293","930865","931152","KQ053816v1","7464708","7465010","60","6533843"
"JH378293","981208","981381","KQ055014v1","682174","682339","42","299034"
"JH378293","1022395","1022522","KQ057649v1","141749","141881","28","880646"
"JH378293","1083720","1083909","KQ055766v1","4486132","4486328","57","3402412"
"JH378293","1084397","1084460","KQ054660v1","3068329","3068387","20","1983932"
"JH378293","1166826","1166988","KQ056996v1","1524030","1524195","28","357204"
"JH378293","1195621","1195929","KQ053234v1","810274","810574","80","385347"
"JH378293","1219763","1220070","KQ054628v1","802926","803228","76","416837"
"JH378293","1262858","1263149","KQ058183v1","487423","487710","75","775435"
"JH378293","1286446","1286656","KQ058561v1","565602","565807","46","720844"
"JH378293","1287359","1287448","KQ053223v1","2552349","2552442","20","1264990"
"JH378293","1406883","1407114","KQ056354v1","958719","958943","58","448164"
"JH378293","1436167","1436472","KQ053816v1","6856607","6856902","78","5420440"
"JH378293","1478756","1478997","KQ053299v1","7690856","7691089","66","6212100"
"JH378293","1786620","1786901","KQ058004v1","1480411","1480689","62","306209"
"JH378293","1924639","1924764","KQ057648v1","2314551","2314685","25","389912"
"JH378293","1934920","1935087","KQ053082v1","2181762","2181924","42","246842"
"JH378293","2239058","2239215","KQ053643v1","2642624","2642783","39","403566"
"JH378293","2239332","2239437","KQ055903v1","184486","184598","28","2054846"
"JH378293","2328622","2328905","KQ054412v1","2490468","2490761","65","161846"
"JH378293","2393928","2394080","KQ057737v1","3327678","3327839","43","933750"
"JH378293","2414797","2414919","KQ058550v1","2678881","2679004","38","264084"
"JH378294","180387","180668","KQ056558v1","670740","671032","76","490353"
"JH378294","501452","501746","KQ057788v1","561223","561518","81","59771"
"JH378294","773595","773806","KQ055873v1","348217","348419","58","425378"
"JH378294","1163082","1163391","KQ055987v1","858506","858800","83","304576"
"JH378294","1603614","1603901","KQ054068v1","1050270","1050547","74","553344"
"JH378294","1783607","1783736","KQ053245v1","473950","474077","29","1309657"
"JH378294","2043484","2043753","KQ056475v1","5043413","5043676","72","2999929"
"JH378294","2081260","2081378","KQ057345v1","1273173","1273291","24","808087"
"JH378294","2285914","2286046","KQ057910v1","1548802","1548933","19","737112"
"JH378294","2295519","2295680","KQ052969v1","8430836","8430996","35","6135317"
"JH378294","2317724","2317880","KQ058305v1","820286","820452","46","1497438"
"JH378294","2330735","2330894","KQ055903v1","180948","181107","37","2149787"
"JH378294","2497397","2497700","KQ058582v1","1599482","1599782","58","897915"
"JH378294","2624004","2624166","KQ053774v1","3363264","3363425","29","739260"
"JH378294","2640130","2640286","KQ055288v1","226204","226359","38","2413926"
"JH378295","70210","70517","KQ058549v1","799852","800135","88","729642"
"JH378295","100799","100971","KQ054068v1","2554856","2555034","44","2454057"
"JH378295","747762","748061","KQ056354v1","419020","419303","74","328742"
"JH378295","968216","968507","KQ053288v1","2218996","2219287","68","1250780"
"JH378295","1052109","1052373","KQ057290v1","749291","749525","92","302818"
"JH378295","2003414","2003702","KQ055097v1","1884579","1884874","73","118835"
"JH378295","2026103","2026309","KQ053135v1","2336123","2336324","61","310020"
"JH378296","699786","699872","KQ058280v1","649966","650041","29","49820"
"JH378296","726346","726468","KQ053948v1","1299259","1299390","26","572913"
"JH378296","737119","737254","KQ058327v1","79607","79739","25","657512"
"JH378296","886462","886765","KQ055468v1","2950644","2950940","73","2064182"
"JH378296","921805","921974","KQ053179v1","1735404","1735576","40","813599"
"JH378296","963411","963548","KQ057702v1","1862724","1862857","27","899313"
"JH378296","1200097","1200234","KQ058383v1","8123991","8124130","41","6923894"
"JH378296","1577370","1577539","KQ058527v1","5886961","5887131","34","4309591"
"JH378296","1623134","1623457","KQ058272v1","4942871","4943179","76","3319737"
"JH378296","1668960","1669263","KQ054412v1","2490468","2490761","72","821508"
"JH378296","1737564","1737868","KQ056790v1","446564","446855","79","1291000"
"JH378296","1840916","1841201","KQ053093v1","3162517","3162806","61","1321601"
"JH378296","1887324","1887600","KQ057603v1","1306760","1307030","75","580564"
"JH378296","1937670","1937830","KQ057036v1","1270725","1270889","36","666945"
"JH378296","2093507","2093812","KQ053631v1","7288314","7288608","82","5194807"
"JH378296","2109844","2110030","KQ054510v1","1448917","1449101","59","660927"
"JH378296","2158419","2158562","KQ053190v1","2372433","2372579","32","214014"
"JH378296","2192325","2192518","KQ057034v1","3470754","3470928","52","1278429"
"JH378296","2315050","2315340","KQ053631v1","7288314","7288608","72","4973264"
"JH378297","49757","49995","KQ055457v1","1902633","1902878","73","1852876"
"JH378297","121173","121471","KQ058184v1","1505565","1505858","68","1384392"
"JH378297","161223","161501","KQ055663v1","1737755","1738038","77","1576532"
"JH378297","165749","165954","KQ058561v1","565602","565807","52","399853"
"JH378297","225340","225637","KQ054693v1","832788","833076","62","607448"
"JH378297","247214","247477","KQ058379v1","21379","21640","83","225835"
"JH378297","247719","248008","KQ053297v1","44026","44315","59","203693"
"JH378297","300154","300314","KQ057737v1","1426090","1426247","37","1125936"
"JH378297","617190","617473","KQ058313v1","787059","787344","67","169869"
"JH378297","939453","939755","KQ055852v1","1231373","1231668","65","291920"
"JH378297","962570","962829","KQ052971v1","6441372","6441626","66","5478802"
"JH378297","963248","963533","KQ058184v1","1505565","1505858","60","542317"
"JH378297","1114203","1114492","KQ053146v1","2819587","2819868","66","1705384"
"JH378297","1206415","1206542","KQ058280v1","21417","21542","28","1184998"
"JH378297","1442104","1442400","KQ058184v1","1505565","1505858","62","63461"
"JH378297","1488061","1488223","KQ058328v1","3794482","3794646","40","2306421"
"JH378297","1737666","1737830","KQ056996v1","1524030","1524195","35","213636"
"JH378297","1814928","1815076","KQ053299v1","2636184","2636329","26","821256"
"JH378297","1962702","1962998","KQ054786v1","1481220","1481519","64","481482"
"JH378297","1988606","1988910","KQ052969v1","9116808","9117108","60","7128202"
"JH378297","2020454","2020681","KQ056331v1","921190","921418","57","1099264"
"JH378297","2094315","2094632","KQ052970v1","21793990","21794288","82","19699675"
"JH378297","2117932","2118236","KQ057449v1","2137704","2138005","61","19772"
"JH378298","643656","643963","KQ055787v1","694393","694708","79","50737"
"JH378298","647603","647903","KQ053059v1","2387120","2387415","74","1739517"
"JH378298","738026","738271","KQ057649v1","314156","314398","72","423870"
"JH378298","819058","819354","KQ055097v1","1884579","1884874","73","1065521"
"JH378298","878484","878766","KQ053004v1","855909","856190","72","22575"
"JH378298","1420650","1420852","KQ058266v1","662378","662594","67","758272"
"JH378299","526559","526689","KQ053861v1","8359","8490","25","518200"
"JH378299","531590","531753","KQ056996v1","1524030","1524195","35","992440"
"JH378299","598225","598390","KQ055872v1","3992534","3992693","39","3394309"
"JH378299","621164","621458","KQ055247v1","715191","715485","61","94027"
"JH378299","943657","943965","KQ053948v1","168940","169229","81","774717"
"JH378299","971331","971622","KQ054932v1","10830322","10830609","62","9858991"
"JH378299","1483519","1483634","KQ054179v1","1344609","1344704","33","138910"
"JH378299","1791300","1791593","KQ058094v1","7832529","7832815","66","6041229"
"JH378300","90945","91215","KQ053299v1","3084158","3084422","68","2993213"
"JH378300","190168","190326","KQ055425v1","1445594","1445758","32","1255426"
"JH378300","471751","471959","KQ053398v1","3158290","3158500","52","2686539"
"JH378300","593196","593356","KQ053157v1","5478543","5478695","36","4885347"
"JH378300","595967","596170","KQ056293v1","42983","43184","47","552984"
"JH378300","612978","613294","KQ058184v1","1505565","1505858","89","892587"
"JH378300","689302","689621","KQ058450v1","2960681","2960988","86","2271379"
"JH378300","1103182","1103438","KQ053894v1","688559","688830","69","414623"
"JH378300","1355387","1355670","KQ055549v1","2348693","2348975","79","993306"
"JH378300","1407320","1407560","KQ053332v1","1938314","1938530","74","530994"
"JH378300","1692934","1693076","KQ053398v1","2023679","2023818","38","330745"
"JH378301","1703662","1703940","KQ058450v1","2367943","2368207","80","664281"
"JH378301","101454","101720","KQ053191v1","2134125","2134399","68","2032671"
"JH378301","221217","221485","KQ055717v1","1647447","1647711","65","1426230"
"JH378301","290184","290286","KQ058050v1","918290","918400","32","628106"
"JH378301","360921","361208","KQ055247v1","1761880","1762166","73","1400959"
"JH378301","362940","363180","KQ057345v1","1938824","1939073","62","1575884"
"JH378301","407544","407681","KQ054943v1","3338657","3338793","39","2931113"
"JH378301","417168","417459","KQ054423v1","892182","892468","71","475014"
"JH378301","428754","429028","KQ056920v1","1054358","1054613","71","625604"
"JH378301","495503","495823","KQ053297v1","44026","44315","95","451477"
"JH378301","1625432","1625645","KQ058550v1","4156400","4156623","69","2530968"
"JH378301","1695914","1696081","KQ058550v1","4456971","4457134","47","2761057"
"JH378301","1716647","1716718","KQ055893v1","2912845","2912909","24","1196198"
"JH378301","1716712","1716852","KQ056652v1","675563","675695","31","1041149"
"JH378302","16663","16946","KQ053288v1","2218996","2219287","64","2202333"
"JH378302","785549","785678","KQ054499v1","472083","472205","34","313466"
"JH378302","1557598","1557862","KQ058249v1","184192","184468","65","1373406"
"JH378303","63150","63214","KQ053556v1","5700","5760","18","57450"
"JH378303","95406","95687","KQ057560v1","1194310","1194592","61","1098904"
"JH378303","361042","361322","KQ057380v1","1672785","1673058","62","1311743"
"JH378303","362249","362427","KQ056056v1","323324","323503","48","38925"
"JH378303","363408","363506","KQ052969v1","10606705","10606802","21","10243297"
"JH378303","379884","380169","KQ053654v1","3690816","3691107","64","3310932"
"JH378303","406808","407085","KQ057345v1","211396","211676","64","195412"
"JH378303","506358","506494","KQ053409v1","6573923","6574054","29","6067565"
"JH378303","807112","807207","KQ054576v1","802587","802678","21","4525"
"JH378303","807277","807458","KQ058427v1","6736144","6736323","47","5928867"
"JH378303","1023504","1023675","KQ054606v1","554177","554332","64","469327"
"JH378303","1027024","1027333","KQ053267v1","2668578","2668893","79","1641554"
"JH378303","1199879","1199997","KQ054921v1","165725","165837","30","1034154"
"JH378303","1725836","1726148","KQ054191v1","4157356","4157666","74","2431520"
"JH378304","466752","467035","KQ058291v1","474599","474881","62","7847"
"JH378304","544982","545076","KQ057373v1","250437","250530","31","294545"
"JH378304","557507","557805","KQ054069v1","7687863","7688158","61","7130356"
"JH378304","1043691","1043843","KQ054124v1","4733901","4734054","32","3690210"
"JH378304","1238317","1238617","KQ056225v1","48046","48349","78","1190271"
"JH378304","1433631","1433929","KQ052968v1","7300500","7300792","66","5866869"
"JH378304","1445596","1445906","KQ052969v1","9116808","9117108","66","7671212"
"JH378304","1539343","1539640","KQ053288v1","3772705","3772989","69","2233362"
"JH378304","1572029","1572306","KQ053126v1","1419293","1419571","66","152736"
"JH378304","1600338","1600501","KQ055014v1","682174","682339","42","918164"
"JH378304","1604684","1604814","KQ053354v1","702320","702452","27","902364"
"JH378305","690202","690319","KQ054660v1","5437047","5437165","34","4746845"
"JH378305","787712","787871","KQ052969v1","8430836","8430996","36","7643124"
"JH378305","934907","934996","KQ058293v1","1008728","1008810","32","73821"
"JH378305","964076","964183","KQ053059v1","2351984","2352070","40","1387908"
"JH378305","1014755","1014852","KQ053059v1","2351984","2352070","34","1337229"
"JH378305","1021541","1021634","KQ058293v1","1008728","1008810","33","12813"
"JH378305","1104164","1104438","KQ055173v1","248885","249169","73","855279"
"JH378305","1173350","1173489","KQ054400v1","4984056","4984198","41","3810706"
"JH378305","1458327","1458454","KQ053520v1","4869540","4869668","27","3411213"
"JH378306","807","950","KQ057213v1","476570","476722","46","475763"
"JH378306","124185","124389","KQ058242v1","892038","892246","50","767853"
"JH378306","324637","324762","KQ054279v1","76889","77022","27","247748"
"JH378306","328140","328300","KQ055872v1","9395394","9395552","34","9067254"
"JH378306","362048","362191","KQ054510v1","8179279","8179421","37","7817231"
"JH378306","575072","575374","KQ058173v1","1122175","1122457","80","547103"
"JH378306","822022","822321","KQ053299v1","4095914","4096215","69","3273892"
"JH378306","965868","966158","KQ056234v1","2521120","2521411","72","1555252"
"JH378306","967347","967496","KQ058316v1","1612479","1612626","32","645132"
"JH378306","1003808","1004091","KQ057290v1","1053741","1054027","66","49933"
"JH378306","1072103","1072216","KQ055663v1","2359440","2359549","27","1287337"
"JH378306","1148659","1148737","KQ055140v1","2199171","2199252","18","1050512"
"JH378306","1443451","1443643","KQ057909v1","9349625","9349810","64","7906174"
"JH378307","260619","260837","KQ058383v1","8692134","8692359","59","8431515"
"JH378307","374491","374801","KQ058004v1","5010124","5010435","71","4635633"
"JH378307","464673","464969","KQ053465v1","3818784","3819069","67","3354111"
"JH378307","1250449","1250717","KQ058595v1","297389","297662","84","953060"
"JH378308","71083","71380","KQ055852v1","1231373","1231668","57","1160290"
"JH378308","130548","130837","KQ054401v1","2629005","2629296","63","2498457"
"JH378308","304159","304438","KQ055457v1","7574372","7574646","82","7270213"
"JH378308","551425","551710","KQ053365v1","2996957","2997245","68","2445532"
"JH378308","894673","894828","KQ057649v1","424252","424417","52","470421"
"JH378308","952562","952846","KQ054510v1","5210888","5211157","75","4258326"
"JH378308","981299","981588","KQ058183v1","487423","487710","61","493876"
"JH378308","1519170","1519325","KQ055725v1","720931","721083","38","798239"
"JH378309","601676","601985","KQ053093v1","1738898","1739201","74","1137222"
"JH378309","706749","707057","KQ054921v1","1683019","1683324","70","976270"
"JH378309","836895","837054","KQ052968v1","10427732","10427888","34","9590837"
"JH378309","854944","855203","KQ052969v1","11659994","11660258","76","10805050"
"JH378309","856860","857057","KQ057290v1","4745481","4745684","50","3888621"
"JH378309","928433","928644","KQ058383v1","9982530","9982731","54","9054097"
"JH378309","1185397","1185694","KQ058535v1","1032013","1032302","60","153384"
"JH378309","1314975","1315265","KQ058184v1","1608105","1608378","71","293130"
"JH378309","1329879","1329938","KQ054301v1","3456273","3456342","22","2126394"
"JH378309","1329995","1330163","KQ056945v1","2675278","2675453","46","1345283"
"JH378309","1408366","1408628","KQ058353v1","1449127","1449389","63","40761"
"JH378309","1429656","1429782","KQ053135v1","3445097","3445217","30","2015441"
"JH378310","437104","437475","KQ056286v1","1016458","1016821","132","579354"
"JH378310","730302","730577","KQ053299v1","20541985","20542265","72","19811683"
"JH378310","957850","958144","KQ053299v1","22532300","22532596","73","21574450"
"JH378310","1325047","1325178","KQ054466v1","759695","759829","31","565352"
"JH378310","1331250","1331544","KQ054466v1","2183618","2183917","81","852368"
"JH378310","1370633","1370796","KQ053609v1","1884265","1884430","28","513632"
"JH378311","340108","340404","KQ053631v1","9116387","9116675","75","8776279"
"JH378311","360376","360683","KQ054345v1","1580511","1580819","78","1220135"
"JH378311","416294","416509","KQ057764v1","2088730","2088934","58","1672436"
"JH378311","429328","429630","KQ053861v1","1997327","1997639","80","1567999"
"JH378311","478863","478972","KQ055872v1","15136888","15137001","25","14658025"
"JH378311","481650","481938","KQ056148v1","2419670","2419961","67","1938020"
"JH378311","491694","491796","KQ056110v1","768","870","22","490926"
"JH378311","694431","694565","KQ056652v1","675563","675695","25","18868"
"JH378311","733368","733522","KQ057737v1","1426090","1426247","38","692722"
"JH378311","746807","747101","KQ056587v1","9000240","9000528","65","8253433"
"JH378311","1083430","1083707","KQ053288v1","2767251","2767531","74","1683821"
"JH378312","533409","533680","KQ058470v1","464724","464997","78","68685"
"JH378312","612950","613234","KQ053288v1","2218996","2219287","70","1606046"
"JH378312","836092","836378","KQ058603v1","554216","554502","63","281876"
"JH378312","1112043","1112158","KQ057883v1","26280","26392","27","1085763"
"JH378313","81149","81189","KQ058313v1","489758","489791","12","408609"
"JH378313","143089","143291","KQ052968v1","6140652","6140862","48","5997563"
"JH378313","431212","431431","KQ058505v1","2234909","2235124","50","1803697"
"JH378313","915752","916025","KQ053297v1","44026","44315","70","871726"
"JH378313","969258","969544","KQ053465v1","403029","403303","67","566229"
"JH378313","1039720","1039787","KQ055384v1","420057","420110","23","619663"
"JH378314","120112","120410","KQ058317v1","4141722","4142023","61","4021610"
"JH378314","139538","139758","KQ053631v1","9034236","9034449","52","8894698"
"JH378314","182805","183092","KQ053631v1","9398334","9398603","61","9215529"
"JH378314","540179","540449","KQ058275v1","938649","938919","64","398470"
"JH378315","581046","581311","KQ053299v1","3496585","3496844","68","2915539"
"JH378315","696381","696455","KQ057118v1","1020903","1020978","18","324522"
"JH378315","696572","696616","KQ054068v1","5116022","5116065","9","4419450"
"JH378315","889471","889602","KQ055298v1","1575436","1575566","22","685965"
"JH378315","961304","961612","KQ056928v1","97902","98210","79","863402"
"JH378315","977707","978007","KQ052968v1","5668114","5668408","72","4690407"
"JH378315","1020102","1020257","KQ058274v1","430286","430436","36","589816"
"JH378315","1021588","1021893","KQ056475v1","2179070","2179363","71","1157482"
"JH378316","102191","102300","KQ058004v1","1368020","1368133","29","1265829"
"JH378316","288231","288456","KQ053299v1","22140679","22140906","58","21852448"
"JH378316","556003","556299","KQ053332v1","554962","555258","60","1041"
"JH378316","598455","598588","KQ056147v1","2168964","2169108","32","1570509"
"JH378316","902418","902701","KQ055468v1","1908448","1908731","55","1006030"
"JH378316","913763","913938","KQ057737v1","1426090","1426247","53","512327"
"JH378317","121065","121318","KQ053795v1","121444","121694","57","379"
"JH378317","380349","380485","KQ057910v1","1548802","1548933","30","1168453"
"JH378317","603034","603170","KQ058305v1","4820083","4820218","29","4217049"
"JH378317","611917","612078","KQ055225v1","876816","876968","45","264899"
"JH378317","632614","632871","KQ053093v1","1564186","1564460","68","931572"
"JH378317","703162","703254","KQ053498v1","6687279","6687374","25","5984117"
"JH378317","703481","703628","KQ053037v1","3255963","3256108","34","2552482"
"JH378317","816275","816560","KQ057290v1","1053741","1054027","67","237466"
"JH378318","36446","36718","ABDC02001013v1","5347","5624","63","31099"
"JH378318","211508","211689","KQ054179v1","1149324","1149515","51","937816"
"JH378318","387931","388239","KQ056493v1","1483561","1483863","66","1095630"
"JH378318","412079","412166","KQ054756v1","198873","198962","18","213206"
"JH378318","455809","456095","KQ053297v1","44026","44315","67","411783"
"JH378318","490039","490188","KQ054698v1","3036","3182","37","487003"
"JH378318","536336","536639","KQ053654v1","820983","821268","70","284647"
"JH378318","544116","544166","KQ053631v1","8001750","8001796","14","7457634"
"JH378318","544308","544433","KQ054786v1","479127","479249","23","65181"
"JH378318","552774","552939","KQ054565v1","627778","627936","37","75004"
"JH378318","568830","569133","KQ053093v1","1738898","1739201","62","1170068"
"JH378318","596351","596677","KQ054081v1","1271367","1271690","67","675016"
"JH378318","670395","670686","KQ058184v1","1505565","1505858","60","835170"
"JH378318","739723","739876","KQ054682v1","606323","606472","33","133400"
"JH378318","820979","821203","KQ057290v1","749291","749525","63","71688"
"JH378318","823524","823805","KQ054124v1","2442155","2442433","63","1618631"
"JH378318","896479","896582","KQ058427v1","6152893","6152991","31","5256414"
"JH378319","58592","58793","KQ053070v1","1971067","1971271","71","1912475"
"JH378320","183036","183180","KQ054412v1","2034642","2034787","46","1851606"
"JH378320","410753","410874","KQ053409v1","6105325","6105446","29","5694572"
"JH378320","749112","749258","KQ054401v1","3742804","3742954","37","2993692"
"JH378320","801846","802040","KQ056404v1","77681","77883","54","724165"
"JH378321","95294","95431","KQ054179v1","3927334","3927468","21","3832040"
"JH378321","116034","116342","KQ055872v1","14090556","14090859","66","13974522"
"JH378321","189674","189729","KQ055108v1","2427889","2427943","12","2238215"
"JH378321","382267","382573","KQ053179v1","2012868","2013172","65","1630601"
"JH378321","432051","432339","KQ058094v1","7832529","7832815","75","7400478"
"JH378321","492869","492968","KQ053157v1","8174152","8174260","32","7681283"
"JH378321","493105","493226","KQ058530v1","227142","227264","24","265963"
"JH378321","515315","515418","KQ053763v1","508269","508363","25","7046"
"JH378321","832010","832277","KQ056475v1","5043413","5043676","77","4211403"
"JH378322","372768","372902","KQ056475v1","2305251","2305383","25","1932483"
"JH378322","519855","519991","KQ053354v1","702320","702452","27","182465"
"JH378322","526624","526740","KQ057909v1","4153593","4153709","25","3626969"
"JH378322","527059","527168","KQ052969v1","2661859","2661968","29","2134800"
"JH378322","553783","553828","KQ054068v1","5116022","5116065","9","4562239"
"JH378322","621318","621459","KQ054191v1","266771","266904","47","354547"
"JH378322","622376","622510","KQ054533v1","1111592","1111720","31","489216"
"JH378322","688551","688772","KQ054576v1","2775916","2776136","57","2087365"
"JH378322","809156","809357","KQ054081v1","1002095","1002297","52","192939"
"JH378323","85433","85570","KQ054179v1","3927334","3927468","26","3841901"
"JH378323","111189","111336","KQ055375v1","281063","281205","33","169874"
"JH378323","120961","121136","KQ054725v1","735942","736116","36","614981"
"JH378323","248995","249257","KQ053631v1","9398334","9398603","57","9149339"
"JH378323","263495","263724","KQ054704v1","884226","884461","66","620731"
"JH378323","263790","263876","KQ055014v1","1278676","1278740","35","1014886"
"JH378323","316229","316534","KQ058257v1","559477","559763","66","243248"
"JH378323","361146","361295","KQ056147v1","2168964","2169108","40","1807818"
"JH378323","424160","424269","KQ058316v1","6327782","6327891","32","5903622"
"JH378323","440533","440812","KQ058561v1","1838977","1839227","79","1398444"
"JH378323","498736","498877","KQ057911v1","1028079","1028217","33","529343"
"JH378323","592104","592256","KQ054196v1","237","387","37","591867"
"JH378323","742071","742359","KQ053361v1","85477","85759","67","656594"
"JH378324","754699","755002","KQ058394v1","9107761","9108054","85","8353062"
"JH378325","806297","806427","KQ058517v1","119422","119555","30","686875"
"JH378326","179654","179938","KQ053297v1","44026","44315","61","135628"
"JH378326","317685","317881","KQ054179v1","1149324","1149515","46","831639"
"JH378326","395563","395868","KQ054412v1","2490468","2490761","58","2094905"
"JH378326","403698","403830","KQ053520v1","3215640","3215778","30","2811942"
"JH378326","432839","433120","KQ056234v1","1590639","1590919","66","1157800"
"JH378326","440332","440595","KQ057345v1","1938824","1939073","61","1498492"
"JH378326","485197","485392","KQ053741v1","1190544","1190756","60","705347"
"JH378326","487342","487636","KQ055035v1","114810","115094","79","372532"
"JH378326","500001","500247","KQ057345v1","1938824","1939073","68","1438823"
"JH378326","507416","507605","KQ054069v1","7451915","7452104","62","6944499"
"JH378326","552306","552588","KQ053146v1","2819587","2819868","64","2267281"
"JH378326","598910","599031","KQ055404v1","3929342","3929457","28","3330432"
"JH378326","678832","679124","KQ055872v1","6063044","6063339","63","5384212"
"JH378326","710368","710641","KQ057380v1","5943139","5943404","82","5232771"
"JH378326","740527","740691","KQ055425v1","1445594","1445758","37","705067"
"JH378327","108528","108716","KQ058094v1","6990178","6990359","49","6881650"
"JH378327","309287","309418","KQ052970v1","12609564","12609700","22","12300277"
"JH378327","319477","319627","KQ058183v1","4244743","4244893","42","3925266"
"JH378327","477448","477647","KQ054400v1","319216","319421","54","158232"
"JH378327","628353","628634","KQ058272v1","6295757","6296050","71","5667404"
"JH378327","638198","638483","KQ056157v1","875015","875294","66","236817"
"JH378328","327417","327545","KQ057901v1","1218014","1218146","24","890597"
"JH378328","417221","417386","KQ058329v1","497711","497869","34","80490"
"JH378328","464192","464274","KQ058505v1","2268415","2268494","23","1804223"
"JH378328","512706","513003","KQ055852v1","1231373","1231668","61","718667"
"JH378328","727673","727948","KQ053454v1","4443711","4443985","69","3716038"
"JH378329","204342","204495","KQ053212v1","578976","579120","41","374634"
"JH378329","227486","227741","KQ053982v1","8276171","8276436","75","8048685"
"JH378330","190538","190671","KQ053948v1","2804373","2804495","29","2613835"
"JH378330","192302","192438","KQ053310v1","2651039","2651171","28","2458737"
"JH378330","440017","440180","ABDC02046354v1","1","162","47","440016"
"JH378331","369853","370135","KQ058184v1","1505565","1505858","84","1135712"
"JH378332","217411","217544","KQ053948v1","2804373","2804495","28","2586962"
"JH378332","424136","424470","KQ055987v1","858506","858800","93","434370"
"JH378332","449040","449343","KQ057380v1","2738009","2738301","84","2288969"
"JH378333","138974","139042","KQ056404v1","2815121","2815186","17","2676147"
"JH378334","121376","121698","KQ053343v1","1747702","1748011","80","1626326"
"JH378334","204710","204957","KQ053631v1","6732984","6733238","68","6528274"
"JH378334","358410","358690","KQ054069v1","955693","955974","60","597283"
"JH378334","428618","428786","KQ057036v1","1270725","1270889","41","842107"
"JH378334","498642","498900","KQ055364v1","1919520","1919774","63","1420878"
"JH378334","502772","503069","KQ052969v1","11082995","11083279","71","10580223"
"JH378336","133183","133481","KQ054456v1","401374","401660","81","268191"
"JH378336","239944","240095","KQ054510v1","8179279","8179421","38","7939335"
"JH378336","240506","240586","KQ055651v1","2196723","2196803","25","1956217"
"JH378336","374080","374229","KQ054466v1","1866785","1866925","33","1492705"
"JH378336","390424","390588","KQ056475v1","5275769","5275928","40","4885345"
"JH378336","423105","423394","KQ055777v1","2252512","2252796","78","1829407"
"JH378336","543001","543153","KQ058345v1","136254","136406","34","406747"
"JH378336","543505","543647","KQ053059v1","5084837","5084963","48","4541332"
"JH378337","17464","17749","KQ058004v1","4701579","4701856","83","4684115"
"JH378337","90767","90855","KQ056148v1","5019141","5019230","20","4928374"
"JH378337","341834","342137","KQ056613v1","1447527","1447824","61","1105693"
"JH378337","398106","398345","KQ053093v1","1944813","1945054","63","1546707"
"JH378337","472179","472295","KQ054068v1","6466552","6466668","26","5994373"
"JH378337","516622","516825","KQ058301v1","333804","333994","56","182818"
"JH378338","112162","112346","KQ058394v1","10110818","10110995","46","9998656"
"JH378338","141490","141614","KQ057151v1","259894","260018","29","118404"
"JH378338","141640","141741","KQ053115v1","4371036","4371145","27","4229396"
"JH378339","20236","20537","KQ055097v1","1884579","1884874","59","1864343"
"JH378339","23855","24122","KQ053059v1","2135970","2136233","57","2112115"
"JH378339","317101","317261","KQ057737v1","1426090","1426247","22","1108989"
"JH378339","448405","448505","KQ055935v1","449406","449504","23","1001"
"JH378339","476843","477132","KQ056587v1","9000240","9000528","60","8523397"
"JH378340","175694","175850","KQ058394v1","81695","81845","43","93999"
"JH378341","12084","12365","KQ056613v1","654151","654445","84","642067"
"JH378341","20015","20148","KQ054868v1","751727","751851","42","731712"
"JH378341","86861","86995","KQ054868v1","751727","751851","40","664866"
"JH378341","121659","121952","KQ057541v1","508573","508865","73","386914"
"JH378341","129676","129831","KQ058297v1","117665","117816","39","12011"
"JH378341","430099","430388","KQ053048v1","3048536","3048827","86","2618437"
"JH378341","446311","446588","KQ058272v1","5443874","5444159","64","4997563"
"JH378342","117860","117996","KQ058338v1","185444","185583","27","67584"
"JH378342","314624","314900","KQ055978v1","3560415","3560681","67","3245791"
"JH378343","19648","19902","KQ052970v1","2715607","2715860","59","2695959"
"JH378343","36011","36269","KQ058427v1","6892153","6892390","76","6856142"
"JH378343","236731","236916","KQ053883v1","6952953","6953124","49","6716222"
"JH378343","424882","424966","KQ057737v1","356405","356487","19","68477"
"JH378343","464340","464631","KQ053741v1","1482396","1482684","61","1018056"
"JH378344","254639","254718","KQ053432v1","5774004","5774087","20","5519365"
"JH378346","223359","223494","KQ053354v1","702320","702452","35","478961"
"JH378347","222158","222365","KQ056996v1","148346","148555","45","73812"
"JH378348","44235","44399","KQ054533v1","1027813","1027974","34","983578"
"JH378348","135251","135533","KQ053146v1","2819587","2819868","62","2684336"
"JH378349","131572","131872","KQ055183v1","1088963","1089262","74","957391"
"JH378349","323093","323404","KQ054412v1","2490468","2490761","89","2167375"
"JH378350","18474","18776","KQ058291v1","406175","406478","66","387701"
"JH378350","64804","64934","KQ058427v1","4756553","4756686","23","4691749"
"JH378350","66085","66149","KQ053556v1","5700","5760","16","60385"
"JH378350","81418","81712","KQ053654v1","3690816","3691107","65","3609398"
"JH378350","150664","150940","KQ052970v1","6659487","6659775","71","6508823"
"JH378350","156159","156442","KQ058329v1","663480","663767","70","507321"
"JH378350","176576","176846","KQ055394v1","3441211","3441489","61","3264635"
"JH378351","167218","167329","KQ053816v1","7354481","7354583","33","7187263"
"JH378352","335167","335437","KQ053299v1","3084158","3084422","86","2748991"
"JH378354","282320","282595","KQ053179v1","1222343","1222623","76","940023"
"JH378355","194183","194416","KQ055214v1","2498827","2499054","55","2304644"
"JH378356","46269","46468","KQ056475v1","396846","397033","56","350577"
"JH378356","73989","74292","KQ055600v1","649277","649577","72","575288"
"JH378356","79679","79842","KQ057036v1","1270725","1270889","34","1191046"
"JH378359","106299","106607","KQ058290v1","511568","511873","74","405269"
"JH378359","168689","168742","KQ053443v1","334639","334693","13","165950"
"JH378360","99728","99968","KQ053278v1","2947726","2947979","73","2847998"
"JH378362","101769","102010","KQ053082v1","7191209","7191457","82","7089440"
"JH378364","21490","21790","KQ056613v1","654151","654445","75","632661"
"JH378364","30810","30958","KQ053631v1","10321219","10321372","38","10290409"
"JH378364","129649","129945","KQ058272v1","5750882","5751176","79","5621233"
"JH378364","138237","138392","KQ053157v1","5478543","5478695","42","5340306"
"JH378365","27562","27716","KQ055872v1","11131397","11131559","52","11103835"
"JH378374","1054","1333","KQ054068v1","3341291","3341579","80","3340237"
"JH378375","7062","7316","KQ056447v1","2522955","2523197","70","2515893"
"JH378377","72525","72682","KQ053631v1","8856331","8856488","38","8783806"
"JH378379","56966","57131","KQ053223v1","2815634","2815800","32","2758668"
"JH378381","32303","32468","KQ053082v1","2181762","2181924","37","2149459"
"JH378381","40230","40521","KQ054102v1","1325684","1325978","63","1285454"
"JH378381","49297","49551","KQ053332v1","804189","804443","59","754892"
"JH378381","121038","121288","KQ054984v1","996853","997105","66","875815"
"JH378386","50773","50897","KQ053409v1","6105325","6105446","30","6054552"
"JH378388","1179","1334","KQ058297v1","117665","117816","39","116486"
"JH378388","10443","10743","KQ056613v1","654151","654445","83","643708"
"JH378393","23361","23664","KQ055640v1","442033","442328","71","418672"
"JH378399","40240","40470","KQ056945v1","3412069","3412291","53","3371829"
"JH378402","31806","32077","KQ054224v1","428324","428601","69","396518"
"JH378403","14305","14398","KQ056663v1","785607","785697","31","771302"
"JH378418","1719","1988","KQ053498v1","3696034","3696323","81","3694315"
"JH378418","18895","19029","KQ058094v1","3687022","3687155","25","3668127"
"JH378429","20685","20949","KQ056663v1","500658","500926","70","479973"
"JH378429","23889","24177","KQ055946v1","855067","855357","72","831178"
"JH378435","12516","12831","KQ053299v1","22532300","22532596","80","22519784"
"JH378448","372","484","KQ053191v1","1086674","1086785","37","1086302"
"JH378448","1348","1387","KQ057909v1","7751289","7751335","12","7749941"
"JH378449","12153","12434","KQ053476v1","3189142","3189421","83","3176989"
"JH378449","20014","20149","KQ054868v1","751727","751851","43","731713"
"JH378452","15244","15347","KQ053135v1","7640479","7640580","29","7625235"
"JH378456","17731","17934","KQ053398v1","3158290","3158500","51","3140559"
"JH378567","3580","3855","KQ053432v1","3710952","3711220","72","3707372"
"JH378587","4598","4731","KQ053948v1","2804373","2804495","40","2799775"
"JH378676","2973","3243","KQ054954v1","2363040","2363310","79","2360067"
"JH378711","349","605","KQ055717v1","1647447","1647711","73","1647098"
"JH378744","252","518","KQ052969v1","7351818","7352090","71","7351566"
"JH378813","2409","2718","KQ056568v1","1617795","1618102","68","1615386"
"JH378813","2719","2855","KQ057560v1","3159951","3160086","23","3157232"
"AGCE01148620","2886","3050","KQ056475v1","5275769","5275928","40","5272883"
"AGCE01148718","10856","10996","KQ058613v1","368815","368973","49","357959"
"AGCE01148947","3997","4267","KQ058539v1","60805","61074","77","56808"
"AGCE01149076","852","984","KQ053191v1","655494","655627","26","654642"
"AGCE01149716","155","286","KQ054510v1","2941967","2942098","26","2941812"
"AGCE01149746","1270","1524","KQ058004v1","2720169","2720394","68","2718899"
"AGCE01149790","1771","1827","KQ054279v1","852960","853011","14","851189"
"AGCE01149810","1157","1427","KQ053059v1","3865389","3865665","63","3864232"
"AGCE01149895","985","1263","KQ053409v1","3716306","3716585","60","3715321"
"AGCE01149934","1068","1383","KQ058359v1","574163","574471","69","573095"
"AGCE01149961","304","580","KQ053905v1","975454","975736","63","975150"
"AGCE01149989","1506","1646","KQ054466v1","1866785","1866925","31","1865279"
"AGCE01150005","435","607","KQ058381v1","759884","760066","63","759449"
"AGCE01150041","9","177","KQ055425v1","1445594","1445758","34","1445585"
"AGCE01150092","1203","1369","KQ056996v1","1524030","1524195","37","1522827"
"AGCE01150163","1173","1321","KQ052970v1","12418764","12418905","42","12417591"
"AGCE01150303","75","394","KQ054682v1","2237365","2237671","77","2237290"
"AGCE01150310","160","427","KQ058272v1","5539241","5539492","79","5539081"
"AGCE01150311","1216","1393","KQ054682v1","822940","823121","52","821724"
"AGCE01150317","10","324","KQ058538v1","934688","934988","68","934678"
"AGCE01150373","254","538","KQ058316v1","1439391","1439671","53","1439137"
"AGCE01150391","1044","1281","KQ057380v1","2047063","2047290","58","2046019"
"AGCE01150427","149","466","KQ052984v1","105454","105757","75","105305"
"AGCE01150433","462","759","KQ052969v1","9553757","9554052","69","9553295"
"AGCE01150490","830","1059","KQ057290v1","749291","749525","64","748461"
"AGCE01150555","123","405","KQ055353v1","1973943","1974227","72","1973820"
"AGCE01150558","881","1174","KQ058261v1","274865","275149","73","273984"
"AGCE01150616","713","943","KQ058250v1","905623","905852","66","904910"
"AGCE01150642","1","111","KQ057909v1","11088334","11088435","24","11088333"
"AGCE01150642","1024","1298","KQ054401v1","1704355","1704633","57","1703331"
"AGCE01150765","609","857","KQ054933v1","935520","935770","75","934911"
"AGCE01150785","74","348","KQ052970v1","8520800","8521088","67","8520726"
"AGCE01150887","521","627","KQ055935v1","449406","449504","32","448885"
"AGCE01150935","431","732","KQ058184v1","1505565","1505858","65","1505134"
"AGCE01150995","166","323","KQ054533v1","1027813","1027974","35","1027647"
"AGCE01151042","85","358","KQ057205v1","1174433","1174713","76","1174348"
"AGCE01151103","338","641","KQ053554v1","2471177","2471484","65","2470839"
"AGCE01151114","764","904","KQ055141v1","3481451","3481584","37","3480687"
"AGCE01151167","392","688","KQ058272v1","3047974","3048266","69","3047582"
"AGCE01151222","746","880","KQ053654v1","4929533","4929667","26","4928787"
"AGCE01151292","138","428","KQ053146v1","920355","920648","65","920217"
