"GL873520","2729980","2730055","chr10","28805224","28805297","15","26075244","GTGCCTTATGCCTATACTCCCAGCACTTTGGAGGTTGAGGCAGGCAGATCACCTGAGCTCACAGGTTCGAGACCAG","GTGGCTCATGCCTGTAATCTCAGCACTTTGGGAGGCTGAGGCAGGCAGATAACCTGAGGTCAGGAGTTCGAGAC"
"GL873520","5968827","5968901","chr1","122543190","122543268","25","116574363","GCTTGGGAGACGGAGGATGCAGTGAGCTATGACTGTCCCACTGTCCACCCTGGCTTGGGAGACCGAGGACGCTGT","CCTGGGAGAGGGAGGTTGCAGTGAGCCAAGATTGCACCACTGTACTCTAGCCTGGGTGACAGAGCAAGACTCCATCTCA"
"GL873520","7106784","7106925","chr10","82728840","82728983","38","75622056","CAGGCCTGTGCCCTGTGCCTGTAATCCCAGCACTCTGGGAGGCTGAAGTGGTGCAATCGCTTGAACCCAGGAGGCTGAGATTGCAGTAAGCCAAAATGATGCCCCTGCATTCCATCCTAGGCAACACAGTGACACTGCCTCA","GCCAGGTGTGGTGATACGTGCCTGTGGTCCCAGCTACTTGGGAGGCTGAAGCAGGAGAATTGCTTGAACCAGAGAGGTGGAGGTTGCAGTGAGCCAAGATTGTGGCACTGCACTCCAGCCTGGGCAACAGAGTGAGACTCTGTC"
"GL873520","7153894","7153979","chr9","93194085","93194171","18","86040191","GACTAGGCATGGTGGCTTGTGCCTGTAATTCCAGCACTTGGGGAGGCTGAGACCTGTGGATTGCCTGAGCTCACGGGTTCAAGACC","GGCCGAGCATGGTGGCTCACACCTGTAATCCCAGCACTTTGGGAGGCTGAGGCAGGTGGATTACCTGAGGTCAAGAGTTCAAGACCA"
"GL873520","16086841","16086886","chr20","59371428","59371465","14","43284587","GGCTGGGTGTGGTGGCTCATGCCTGTACTACTGGTGGGAGAATCTC","GCTGGGTGTGGTGGTGCACGCCTGTAATTCCAGTACTC"
"GL873520","16087342","16087542","chr7","95222121","95222323","72","79134779","GATCCCTTGAGCTTAGAGTTCAAGACCTGTGTAAGTAACATAGTCTCTACTAAAATAGAAAAAATTAGCCAGGTGTTGTGGTGAGCGCCTATACTCCCAGCCACTCAGGAGGCTGAGGCAGAAGTTTGAGGTTGCTATACATACCTAGGCTAAGGCCCTGGCACTTTAGCATGGGCAATGGAGTGAGACTCTGACTCAAAA","CGAGACCAGCCTGACCAACATGGTGAAACCCCGTCTCTACTACAAATACAAAAATTAGCCAGGCGTGGTGGCGGGCACCTGTAATCCCAGCTACTCAGGAGGCTGAGGCAGGAGAATCACTTGAACCCGGGAGGCAGAGGTTACAGTGAGCCGAGATTGCGCCACTGCACTCCAGCCTGGGCCACAGAGTGAGACTCTGTCTC"
"GL873520","16780664","16780902","chr3","82455760","82455975","79","65675096","GGCTGAGCATGGTGGCTTATGCCTGTTGTCCCAGCACTGTGTGAGGCCAAGGTGGGTGGATCGCCTGAGCTCAGCCGAGATGGAGACAGGCGGAAGACCAGCATGAGGCAGAGTAAGCCAGAAGGAGACCCCATCTCTACAAAACAAAAACAAAAACAAAAACAAAAACAGCCGTTGTGGCCAGCGTCTGTAATCCCTGCTACATGGAGGGCAAGAGAATCACTACAGGAGGAAGAAGT","GCTGGACATGGTGGCTCATGCCTGTAATCCCAGCACTTTGGGAGGCCGAGGTGGGTGGATCACGAGGTCAGGAATTTGAGACAAGCCTGGCCAAGATGGTGAAACCCCGTCTCTACTTAAAATAATAATAAAAAAAATAGCCAGGTGTGGTGGTGCATGCCTGTAATCCCAGCTACTTGGGAGGCTGAGGCAGGAGAATCACTTGAACCTGAAAGG"
"GL873520","16835471","16835553","chr17","13636074","13636156","25","3199397","CCTGTACACCTAGCACTGAGAGAGGCCAAGCCAGGAGGATCACTTGAGGTTAGAGCAAGACACCAACTTTACAAAAAATGAAA","CTGTAATCCCAGCACTTTGAGAGGCCAAGGCGGGTGGATCATTTGAGGTCAGGAGTTCAAGACCAGCCTCGCCAACATGATGA"
"GL873520","18244868","18244970","chr3","6960323","6960408","32","11284545","CTATTGGGGAGGCTGAGGCAGGACAATCGTTTGAGGTTGCTGTGAGCTAGGTTGACACCACTGCACTCTAGCCTGGGGCAACAGAGTGAGACTTTGTTTCAAA","GCTTGAGCCTGGGAGGCAAAGGTTGCGGTGGGCTGAGATTGCGCCACTGCACTCCAGTCTGGGCAACAGAATGAGACCCTGTCTCA"
"GL873520","24570388","24570471","chr2","25183327","25183408","17","612939","GGCCGGCATAGTGGATCACACCTGTAATCCAGCACTCTGGGAAGCCAAGGCAGGTGGATCACCTGAGGATCCTCAGGAGCTTGA","GGACGGGTATAGTAGCTCACGCCTGTAATCCCAGCACTTGGGAAGCCGAGGCGGGTGGATCACGTGAGGTCAGGAGCTCGAG"
"GL873520","26001724","26001799","chr17","53008083","53008158","19","27006359","GGCCAGGCCCAGTGGCTCATGCGTAATCCCAGCAATTGGGAGACCAAGGAGGGTGCATCGCCTAAAGTTCAAGACC","GGCCAGGCATGGTTGCTCATGCCTGTAATCCCAGCATTTTGGGAGCCAAGACAGGGGGATCACCTAAGGTCAGGAG"
"GL873520","27613025","27613160","chr1","29437872","29437991","31","1824847","GGCCGGGCGTGGTGGCGCACGCCAGTAGTCCCAGCGCTATGGGAGGCCGAGGCGGGTGGATCACCTGAGCTCAGAGGTTCGAGACCAGCCAAGACCCCCCTGAGCCAAACGAGCCAGACTGAGACCCCGTCTCTAC","GGCCGGGCGTGGTGGCTCACGCCTGTAATCCCAACATTTTGGGAGGCCAAGGCGGGTGGATCACCTGAGGTCAGAAGTTCGAGACCAACCTGGCCAACATGGTGAAACCCCTGTCTCTAC"
"GL873520","30075665","30075747","chr9","93194085","93194171","20","63118420","GCGGAGCGTGGTGGCCTGTAATCCTACCACTCTGGGAGACTGAGGCAGGTGGATTGCCTGAGCTCACAGGTTCAAGACCAGCC","GGCCGAGCATGGTGGCTCACACCTGTAATCCCAGCACTTTGGGAGGCTGAGGCAGGTGGATTACCTGAGGTCAAGAGTTCAAGACCA"
"GL873520","30148065","30148234","chrX","44675116","44675262","57","14527051","AAAAAAATAGTCGGGTATTGTGGCCAACTCCTCCACTTCAATTCCCAGCTCCAATTCCCAGCTACTCAAGAGCCTGAGGCAAGAGAACTGCTTGAACCCAAGAGTCTGAGGTTGCTGTGACACTCTACCCAGGGGTGACAAAGTGAGACACTGTCTCAAAATAAAAAAAA","TTAGTTGAGTATGCTGGTGCTGGCACACATCTGTAATCCCAGCTGCTTGGGAGGCTAAGGCACGAGAATTGTTTGAACCTGGGAGGTGGAGGTTGCAGTGAGCACTCCAGCCTGGGTGACAAAGTGAGACTATGTCTCAAAAAAAAA"
"GL873520","30148472","30148605","chr11","49380987","49381121","30","19232515","GGCCGGGCACGGTGGCTCATGCCTCTAATCCCAACACTCTGGGAGGCTGAGGCAGGCAGATCACCTAAGCTCATAAGTTCAAGACCAGCCTGAGGTAGAGCAAGACCTCTGTCTCTTAAAAAAATAGCTGGGGA","GGCCAGGCACGGTGGCTCATGCCTGTAATCCCAGTACTTCGGGAGGCTGAGGCAGGCAGATCACCTGAGGTCAGGAGTTCAAGACCAGCCTGGCCAACACAATGAAACCCTGTCTCTACTAAAAATACAAAAGTT"
"GL873520","30307592","30307720","chr7","82846043","82846151","40","52538451","TCAAGAGTTCAAGACTAGTCTGAGCAAGAGCAAGAGCAAGAGCAAGACCCCACCTCTGCTAAAATTAGAAAAATTTGCCAGGTGTGGTGGTTTGTGCCTGTAATCCCAGCTACTCAGAAAGCTGAGGCA","GAGGCCAGCCTGACCAACATGGTGAAACCCCGTCTCTACTAAAAATACAAAAATTAGCTGGGTGTGGTGGCGCACACCTGTAATCCCAGCTACTCAGAAGGCTGAGGCA"
"GL873520","30307997","30308122","chr13","39071147","39071274","34","8763150","AGAAAGCTGAAGCAGGACTGGTTGCATCTAGGAGTCTGAGGTTGCTGTGATCTAAGCTGATGCCATGGCACTCTAGCCTGGACAACAGAGTAAGACTCTGTCTCAAAAAAAAAAAAAAGCAAAGAA","CAGGAGGCTGAGGCAGGAGAATTGCTTGAACCTGGGAGACAGAGGTTGCAGTGAGCCGAGATCAGGCCACTGCACTCCAGCCTGGGTGACAGAGCGAGACTCTGTCTCAAAGAAACAAAAACAAAAAA"
"GL873520","30644293","30644346","chr3","178724466","178724519","15","148080173","TTATCTGGGTGTCATGGCAGGCACCTGTAGTACCATCTACTTGGGAGCCTGAGG","GTTAGCCGGGTGTGGTGGTACACCTGTAGTCCCAACTACTCAAGAGGCTGAGGC"
"GL873520","30644626","30644756","chr10","86840248","86840381","28","56195622","GGCCAGGCATGGTGGCTGATAACTGTAATCCTAGTACTCGGGGAGGCCAAGGTGGGTATATAACTTGAGATCAGGACTTTGAGAGCAGCCTATGCAAGAGTGAGACCATCTCTACTAAAAATAGAAAAATT","GCCGGACATGGTGGCTCATGCCTGTAATCCCAGCACTTTGGGAGGCCAAGGTGGGTGGATCACCTGAGGTCAGGAGTTTGAGACCAGCCTGGCTAACATGGTGAAACCCCATCTCTATTAAAAATACAAAAATT"
"GL873520","34668521","34668671","chr2","101636903","101637047","55","66968382","GTGCATTGACCCACACTCATAATTCCAGGACTCTGTGAAGCTGGGCTGCGTGGGTCACTCAAGGTCAGGAGTTCCAGCCTGAGAAAGACCAAAACTCCCATCTCTGCCTAATAAAAAAAAAAAAGTTAGCAATATGTCATAGTAGGGACCT","GTGGTGACTCATGCCCGTAATCCCAGCACTTTGGGAGGCCAAGGCGGGCGGATCACCTGAGGTCAGGAGTTTGAGACCAGCCTGGTCAACATGGCAAAATTCCATCTCTACTAAAAATACAAAAAATAGCTGGGCACGGTGGCAC"
"GL873520","38507269","38507342","chr5","184653087","184653156","24","146145818","GGCTCACACCTGTAATGCCAACACTTGGGAGGCTGAGAAGGGTGGACTGCCTGAACAAGAGTTGAGATCTGTCT","TAGCTCACACTTGTAATCCCAGCACTTTGGGAGGCTGAAGCGGGCAGATCAGGAACAAGAAAAAGACACC"
"GL873520","38852134","38852145","chr4","43961950","43961960","2","5109816","TAGTAGAAATAA","TAATAAAATAA"
"GL873520","41660608","41660744","chr12","91249483","91249604","44","49588875","GGCCAGGCGTGGTGCTCATGCCTATTGTCCCAGTGCTGTGGGAGGCCCAAGCAGAGGGATCGCCTGAACTCAGTAGAGTTGGAGACCAGAGGAAGACCAGCATGAGGCAGAGTGAGCCAGAGTGAGACCCCATCTCT","GGCCAGGCGTGGTAGTTCATGCCTGTAATCCCAGTACTTTGGGAGGCCGAGGCGGGCAGATCACCTGAGGTCAGGAGTTTGAGACCAGCCTGGCCAACACATAGTGAAACCCCGTCTCTACC"
"GL873520","41660769","41660840","chr9","25871885","25871947","23","15788884","TCAAAAGCCGGACGTTGTGGCAAGCGCCTGTAATCCCAGCTACATGGGGGGCAAGAGGGCAAGAGAATCTCT","GCCAGGTGAGCTGGCGCATGCTTGTAATCCCAGCTACTTGGGAGGCTGAGGCAAGAGAATTGC"
"GL873520","42050182","42050509","chr4","11228671","11228989","67","30821511","GGCCCAGTGCAGTGGCTCACGCCTATAATCCTAGCACTCTGGGAGGCTGAGGCGGGTGGATTGCCTGAGCTCAGGAATTTGAGACCAGCCTGAGCAAAAGTGAGACCCTGTCTCTACTAAAAATAGAAAAACTAGCCAGGTGTTGTGGCCGGCACTTGTATTCCCAGCTACTAGGGAGGCTGAGACAAGAGAATCACACTTAAGCCCAAGAGTCTGAGGTTGCTGTGAGCTGTGACACCATGGCACTCTACTCTACCCAGGGTGTCAGAGTGAGACTCTGTCTCAATAAATAAATAAATAAATAAATAAAAATAAGGAAAGAAAAAAA","GCTGGGCGTGGTGGCTCATGCCTGTAATCCCAGCACTTTGGGAGGCCGAGGCGGGTGGATCACCTGAGGTCTGGATTTGAGACCAGCCTGGCCAACATGGTAAAACCCCATCTCTACTAAAAATACAAAAATTAGCCAGGCGTGGTGGCATACACCTGTAGTCCCAGCTACTAGGGAGGCTGAGGCAGGAGAATCACTCGAACTCAGGAGGCAGAGGTTGCAGTGAGCTGAGATTGCACCACTGTACTCCAGCCTGGGTGACAGAGTGAGACGCTGTCTAAATAAATAAATAAATAAATAAATAAATAAATAACAAAAA"
"GL873520","45601445","45601581","chr1","1092766","1092900","32","44508679","CTGGGCATGGTGGCTCACATCTGTAATCATAACACTCTGGAAGGCTGAGAGAGGGTGGATTGCTCATTGAGGTCAGGAGTTACAGACCAGCCTGAGCAACAGTGAGATGCCGACTATACTAAAAATAAAAAAAAATA","GTCGGGCACGGTGGCTCACGCCTGTAATCCCAACACTTTGGGAGGCTGAGGCGGGTGGATCACCTGAGGGCAAGAGTTAGAGACCGGCCTGACCAACACGGCGAGACCCCATCTCTACTAAAAATACAAAAATTA"
"GL873520","45601862","45602016","chrX","117720504","117720665","38","72118642","GCTGGACATGGTGGTGGGCACCTATAGTCCCAGCTACTTGCAAGGCTAAGGCAAGAGGATGGCTTGAACCTAGGAGTTTGAGGTTGCTGTGAGCTAGGCTCAAGCCATGGCACTGTACCCTGGGCAACAGAGTGAGACGGTTTCAACAAACAAAA","TAGCTGGGCATGGTGGCACACATCTGTAGTCCCAGCTACTCGGGAGGCTAAGGCAGGAGAATCGCTTGAACCTGGGAGGTGGAGGTTGCAGTGAGCCGAGGTCACGCCATTGCACTCCAGCCTGGGCAATAGAGTGAGACTCCATCTCAAAAAAAAAAAAAA"
"GL873520","46131934","46132083","chr9","21128084","21128223","42","25003850","TTAGCCAGGTATCATGGCGGTGCCTGTAATCCTAGATACTTGGGAGGCTGAGGCAAGAGGATCACTTAAGGTTATTATGAGCTATGACACCACGGCACTCTAGCCAGGGTGACAGAGTAAGACTCTGCCTCCAATAATAATAATAATAAA","TTAGCCAGGTGTGGTGGCACATGCCTGTATTTCCAGCTACTCGGGAGGCTGAGGCAGGAGAATTGCGTGAGCTGAGATCATGCCACTTCATTCCAGTCTGGGTGACAGAGTGAGACTCTGCCTCAAAAAACAAAACAAAA"
"GL873520","46132356","46132368","chr2","174386521","174386532","3","128254165","AATGGAAAAACTA","AATGCAAAAAAA"
"GL873520","46132640","46132770","chr3","15114401","15114535","29","31018239","GGCCGGGTATAGTGGCTCATAACTATAATCCTAGCGTTCTGGAAGGCCAAGGTGGGTAGATTGCTTGAGGTCATGAGTTCAAAACCAGCCTGAGCAAGAGAGAGATTGTCTCTATTAAAAATGGAAAAACT","GGCCGGGTGTGGTGGCTCATGCCTGTAATCCCAGCATTTTGGGAGGCCAAGGTGGGTAGATTACCTGAGGTCACGAGTTCAAGACCAGCCTGGCCAACATGGTGAAACCCTGTCTCTACTAAAAACACAAAACTT"
"GL873520","46902414","46902720","chr2","69273471","69273769","71","22371057","GGCCAGGCATGGTGGCTGATACCTGTAATCCTAGCACTCTGGGAGGCTGATGCAGGTGGATCACCTGAGCTCAGAAGTTCAAGACCAGCCTAAGCATGAGTGATACCAGCCTGAGCAAGCAGTGTCTCTACTAAAAATCGAAAAACTAGTTGGATGTGGTAGTGCATGCCTGTAATCCCAGCTACTCGGGAGGCTGAGGCAAGAGGATCGTTCAAGCTGAAAGGTTTGAGTTTGCTGTGAGAGATGACACCATGGCACTCTACCCAGGGCAAAAGAGTGAGACTGTCTCAAAAACAAAAAGAAAGAA","GGCCAGGCACAGTGGCTCATGCCTGTAATCCAAACACTCTGGGAGGCCGAGGCAGGTGGATCACCTGAGGTCAGGAGTTCGAGAACAGCCTGACCAACATGGTGAAACCATGTCTCTACTAAAAATACAAAAATTAGCCAGGTGTGGTGGTGCACTCCTGTAATCCCAGCTACTCGGGAGGCTGAGGCAGGAGAATCGCTTGAACCTGGGAGGCGGAGGTTGCAGTGAGCTGACATCGCACCATTGCACTCCAGCCTGGGTGACAGAGTGAGACTCTATCTCAAAAAAGAAAAAAAAAA"
"GL873520","47083028","47083197","chr7","165092908","165093077","40","118009880","TAGTAAGGTGGTGTGGTGGGTGCCTGTAATCCCAGCTACTTGGGAGACTGAGGCAAGTGAATCACTTGAACTCAAGAGTTTAAGGTTGCTGTGAGCTATGACACTACAACACTCTACTAAGGGTGACAAAGTGAGACTCTGTCTCAAAAAGAAAAAAAATAAAAGAAAAA","TAGCCAGGTGTGGTGGCATGCGCCTGTAATCCCAGCTACTCAGGAGGCTGAGGCAGGAGAATCGCTTGAACCCAGGAGGTGGAGGTTGCAGTGAGCCAAGATCATGCCACTGCACTACAGCCTGGGCAACAGCATGAGACTCTGTCTCAAAAAAAAAAAAAAAAAAAAAA"
"GL873520","47083462","47083591","chr7","127541861","127541986","28","80458399","GCCAGGCACAGTGGCTGATGCCCGTAATCCTAGCACTCTAGAAGGCTGAGGCAGGTAGATTACCTGAGCTCACGGGTTTGACACCAGCCTGACCAAGAGTGAGACCCCCATCTCTAAAAATAGCAAGGCT","GCCGGGCACAGTGGCTCATGCCTGTAATCCTAGCACTTTGGGAGGTTGAGGCAGGCAGATTGCCTGAGCTCAGGAGTTTGAGACCAGCCTGGGCAACATGGTGAAACCCCATCTCTATTAAAATAC"
"GL873520","59071253","59071388","chr1","29437872","29437991","35","29633381","GGCCGGACGTGGTGGCTCATGCCTATAGTCCCAGCGCTGTGGGAGGCCGAGGCAGGTGGATCACCTGTGCTCAGAGGTTCGAGACCAGCCAAGACCCCCCTGAGCCAAATGAGCCAGAGTGAGACCCCATCTCTAC","GGCCGGGCGTGGTGGCTCACGCCTGTAATCCCAACATTTTGGGAGGCCAAGGCGGGTGGATCACCTGAGGTCAGAAGTTCGAGACCAACCTGGCCAACATGGTGAAACCCCTGTCTCTAC"
"GL873520","59570747","59570861","chr6","116838256","116838377","37","57267509","GCTGGAAGTGGTAGCTTATGCCTATAATCCTAGCACTCTGGGAGGCCAAGGCAGATCACTTGAGGTCTAGCCCAGGTAACAGAAAGAGATCCTGTCAAAAAAAAAAAAAAAAAAA","GGCTGGAGGCGGTGGCTTACGCCTGTAATCCCAGCACTTTGGGAGGCCCAGGTGGGCGGATCACCTGAGGTCCAGAGACCAACATGGCAAAACCCTGTCTTACTAAAAAATACAAAAATTAG"
"GL873520","60111723","60111855","chr16","48859797","48859933","32","11251926","GGCCGGTTGCAGGGGCTCACACCTATAATCCCTGCACTTGGGAGGCCAAGGTGGGTGGATTGCCTGAGCTAACAGGTTCCAGACCAACCTGAGCAAGAGGGAGACCCCCATCTCTTAAAAATAGCCAAGTGCT","GGCCAGGTGCGGTGGCTCACACCTATAATCCCAGCACTTTGGGAGGCCAAGGTAGGTGGATCACCTGAGATCAGGAGTTCAAGACCAGACTGACAAATGTGGTGAAACCCCATCTCTATTAAAAATACAAAAGTTTG"
"GL873520","60112135","60112295","chr20","69739094","69739252","47","9626959","AAAAAAAATAGCCAAGTGCTGTGGTGGGTGTCTATAGTCTCAACTACCTGGGAAGCTGAGGCAAGAGAATCACTTGTATCCAAGAGTTAGAGGTTGCTGTAAGATGCCACAGCACTCTACCCAGGGTGACCAAATGAGACTTTGTCTCAAAAACAAACAAA","AACAACAAAACTTAGCCAGGTGTGGTTGGTGCTTGTAATCCCAGCTACTCGGGAGGCTAAGGCATGAGAATCACTTGAACCCGGGAGGTGGAGGTTGCAGTGAGCCAAGATTCCACCAGCCTAGGCGACAGAGCAAGACTCTTGTCTCAAAAAAAAAAA"
"GL873520","60873051","60873186","chr1","29437872","29437991","35","31435179","GGCCGGGTGTGGTGGCGCACACCTGTAGTCCCAGCACTATGGGAGGCCGAGGCGGGTGGATTACCTGTGCTCAGAGGTTGGAGACCAGCCAAGACCCCCCTGAGCCAAATGAGCCAGAGTGAGACCCCATCTCTAC","GGCCGGGCGTGGTGGCTCACGCCTGTAATCCCAACATTTTGGGAGGCCAAGGCGGGTGGATCACCTGAGGTCAGAAGTTCGAGACCAACCTGGCCAACATGGTGAAACCCCTGTCTCTAC"
"GL873520","60937777","60937881","chr19","37998405","37998501","36","22939372","CTTAACTGGGTGTTATAGTCCCAGCTACTTGGAAGGCTGAGGCAAGAGAATTACTTAAGCCCAAGAATTTGAGTTGGCTGGGAGCTAGGCTGACACCAAGGCACT","CCTGTGATCCCAGCTACTTGGGAGGCTGAGGCACAAGAATCGCTTGAACCCAAGAGGCGGAGGTTGCGGTGAACTGAGTTTGCACCACTGCACTCCA"
"GL873520","60938156","60938286","chr7","41104440","41104574","31","19833716","GGCCGAGTGTATTGGCTCATGCCTATAGTCCTAGCCCTTTGAGAGGTCAAAGCAGGTGGATCGCCTGATCTCAGGAGTTCAAGACGAGTCTGAACAAGAGAGAGACACCATCTCTACTAAAAACTTAACTG","GGCGGGGTGTGGTGGCTCACGCCTATAATCCTAGCACTTTGGGAAGCCAAGGCAGGAGGATCACCTGAGATCAGGAGTTTGAGACGAGCCTGACCAACATGGCGAAACCCCATCTCTACTAAAAACACAAAAATA"
"GL873520","61773762","61773989","chr11","33080879","33081101","70","28692883","GCCGGATGGGTGGGTTTATACCTTTAATCCCAGCACTTGAAGAGGCTGAGGTGGGCGAAGCACAGATTAGCCGGGTATCGTAGCATATGTGTATAATCCCAGCAACTCCAGAGACTGACACCAGAGGATCCCTTGAGCCCAGGAGCGCAAGGTTACAGTGAGCTTTGATCAGCCCACCGTACGTACTCCAGTCTGGGTGACAGAGCAAAAACTCTTAACAAAAAAAAA","GGCTGGGCAAGGTGGCTCATGCCTGTAATCCCAGCACTTTGGGAGGCTGAGGCAGGCAGATCGCATGGGGTCGGGAGTTCGGACACGCCTGTAATCCCAGCTATTCAGGAGGCTGAGACAGGAGAATCACTTGAACCTGGGAGGCAGAGGTTCCAGTGAGCTAAGATCGCACCACCGCACTCCATCCTGGGCGACAGAGCGAAACTCCGTCTCAAAAAAAAAA"
"GL873520","72645184","72645308","chr7","50551582","50551705","32","22093602","GGCTGGGCAGTGGTTCACACCTGTAATATCAGCACTTAGGAGGCCCAGGCAGGTGGAATGCCTGAGCTCACAGGTTTGAGACTAGCCTGAGCCAATGCAAGACCTTGTCTCTAAAACTAGCAGAT","GGCCGGGCATGGTGGCTCACCCCTGTAATTTCAGCACTTTGGGAGGCTGAGGCAAGTGGATCGCTTGAGGTCAAGAGTTCGAGACCAGCCTGGCCAACATAGCAAAACCCTGTCTCTACTAAAA"
"GL873520","72645574","72645744","chr1","9166384","9166552","40","63479190","TAGCCAGGTGCTGTAGCAGGCCATGTAGTCCCAGCTACTTGGGAGGCTAAGGCAAGAGAATTGCTTAAGTCCACGAGTTGGAGGTTGCTGTGAGCTATGATGCCATAGTACTCTACCAAGGGTGACAAAGTAAGACTCTGTCTTGAAAAAAAAAAAAAAAGAAAAAAGAAA","TTAGCCAGGTGTGGTGGCTGGCGCCTGTTATCCCAGCTACTTGGGAGGCTGAGGCATGAGAATTGCTTGAATCCAGGAGGTGGAGGTTGCAGTGAGCTGAGATCACGCCTCAGCACTCCAGCCTGTGTGACAGATTGAGACTCTGTCTCAAAAAAAAAAAAAAAAAAAA"
"GL873520","72695562","72695678","chr8","4916900","4917001","42","67778662","CTAGCCTCAGCAAGAGTAAGACCCTGCCTCTACTAAAAATAGAAAAAAAATGAGTCAAGCCTGGGGGCGCATGCCTATAGTCCTGTAGTCCCAGACACTGAAGCAAGAGGATGCCTT","CTAGCCTGGCCAACATGATGAAACCCCCTCTCTACTAAAAATACAAAAATTAGCCAGGTGCGTGGTGGTATGTGCCTGCAGTCCCAGCTATTCTAGAGTCTG"
"GL873520","72695921","72696036","chr1","39198637","39198744","38","33497284","AAAGAGAGGATCCCTTGAACCCATAAGTCTGAGGTTGCTATCAGCCACAATGATGGGCTTGGAACTATACCCAGGGAGACACAATGAGATTAGGTCAAAAAAAAAAAAAGAAAAAA","AGAATCGCTTGAACCTGGGAGGCGGAGGTTGCAGTGAGACCAGATCATGGCACTGCACTCCAGCCTGGGCGACAGAGTAAGACTCGGTCTCAAAAAAAAAAAAAAAAA"
"GL873521","191316","191395","chr19","9500695","9500778","21","9309379","GGTCAGGTGCCAAGGCTCATGCCTGTAACCCTAGCATTCTGGAGGCCCGGTGTAGGGATCCCCTGAGCAAGAGTGAGACC","GGCAGGGTGCCGTGGCTCATGCCTGTAATCCCAGCACTTTCGGAGGCTGAGGCAGGTGGATCACCTTGAGGGAAGAGCGAGACC"
"GL873521","7177375","7177437","chr1","9215018","9215080","24","2037643","AGACCCCATCTCTTCTAAAGTAGAAAAATTTGATTGGGTGCACTGGCTCACGCCTGTAATCTC","CCCATCTCTACTGAAAATACAAAAATTAGCTGGGCATAGTGGTGCATGCCTATAGTCTCATCT"
"GL873521","9203628","9203782","chr1","38303341","38303491","47","29099713","AGATTGAGGAAGCAGAATAGATTTGAAAAGGCCTGTAATCCTAGTACTGAGGTTGCTGTGAGCTAGGCTAATGCCACAGCCCTCCAGCCCAGGTGACAGAGTAATACTCTGTCTCAAAATAAATAAATAAATAAATAAAAATAATAATAGATAAA","CGAGAGGCTGAGGCAGGCAGGAGAATTGCTTGAACCTGGGAGGCAGAGGTTGCAGTGAGCCAAGATCATGCCACTGCACTCTAGCCTGGGCGACAGAGTGAGACTCTGTCTCAAAAAAAATCAAATCAAATGAAAGATAAAAATAAAAAAA"
"GL873521","11822781","11822898","chr1","131078233","131078350","22","119255452","GGCTAGGCATGGTGGCTCACACTTATAATCCCAGCATTTTGGGAGTCCAAAGTAGGAGGATTGCCTGAGTTCAGGAATTCAAGTCCAACCTGATCAAGAGTGAGACCCCATCTCTAAA","GGCCAGGCATGGTGGCTCACACCTGTAATCCCAGCATTTTGGGAGGCCAAGGCAGGTGGATTACCTGAGGTCAGAGTTCAAGACCAGCCTGGCTAACATGGTGAAACCCCATCTCTAC"
"GL873521","11822924","11823077","chr6","58863249","58863409","40","47040325","GCTGGGCTCGTGGCAGGTGCCTGTATTCCCAGCTACCAGGGAGGGTGAGGCACAAGAATCACTAAGCCCAAGAGTTGGAGGTTGCTATGAGCTATAATGCCATGGCACTCTACCAAGGGTGACAAAGTGAGACTCTGTCTCAGAAAAAGGAAAA","TTAGCCAGGCATGGTGGCACATGCCAGTAATCCCAGCTACTCAGGAGGATGAGGCAGGAGAATCGCTTGAACCCAGGAGGCAGAGGTTGCAGTGAGCTGAGATTGCGCCACAGCACTCTACCCTGGGTGACAGAAGGAGACTCTGTCTCAAAAAAAAAAAA"
"GL873521","13369663","13369934","chr4","44140247","44140529","73","30770584","GGCCAGATGTGGTGGCTAATGCCTGTAATCCCAGCACTCTGGGAAGCCAAGGAGGGTGGATCACCTAAGCTCATGAGTTCGAGACCACCCTGAACTTGAGTGAGACCCTCTAAAAATAGCCGGGTATTGTGGCAGCACCTGTAATCCCAGCTACTTGGGAGGCTGAGGCAAGAGAATCTCTTGCGCCCAAGAGTTGGAGGTTGCTGGGAGCTAGGAGTCTACCCAGGTGGGGGGCAGAGAGACAAAGTGAGACTCTATTTCAAAAAAAAGAA","GGCCGGGTGCGGTGGCTCACGCCTATAATCCCAACATTTTGGGAGGCCAAGGCAGGTGGATCACCCAAGGTCAGGAGTTCGAGACCAGCCTGGCCAACATGGTGAAACCTCATCTCTACTAAAAATTAGCTGGGCATGGTGGCGCATGCCTGTAATCCCAGCTACTTGGGAGGCTGAGGCAGGAGAATCGCTTGAACCAGGGAGACAGAGGTTGCAGTGAGCTGAGATCACGCCACTGCACTCCAGCCTGGGTGACAGAGCAAGATCCATCTCAAAAAAAAAA"
"GL873521","20362154","20362268","chr11","51614343","51614439","40","31252189","CCTGTTGTCCCAGTGCTGTGGGAGGCCGAGGAGGGTGGATCGCCTGAGCTCAGCTGAGTTGGAGACCAGCTGAAGACCAGCCTGAGGCAGAGTGAGCCAGAGTGAGACCCGTCTC","GCCTGTAATCCCAGCACTTTGGGAAGCCGAGGTGGGCGGATCACCTGAGGCCAGGAGTTTGAGACTAACCTAACCAACTTGGAGAAAGCCCGTGTCT"
"GL873521","24809417","24809578","chr3","61255547","61255702","33","36446130","CTGGGCACTGTGGCTCACACCTGTAATCCCAGAACTTTGGGAGGCTGAGGCAGGAAGATCACTTGAGCCTGGGAGGTGGAGATTGCAGTGAGCTAAGACTGTACGACTGCACTCCAGCCTGGGCAACAGAGTGGGACCAGATCCTATGTCTAAAAAATAAAA","AGTTGGGCACGGTGGATCACACCTGTAATCCCAGCTACTCGGGAGGTTGAGGCAGGATAATTACTTGAACCTGGGAGGTGGAGGTTGCAGTGAGCTGAAATTGCACCACTGCACTCCAGCCTGGGCAACAGAGCAAGACTCTGTCTCAGAAAAGAA"
"GL873521","26087028","26087176","chr1","27794417","27794561","46","1707389","GCCAGGGCGGTGGGACACTCCTGTAATCCTAGCACTAGCACTCTGGGAGGCTGAGGCAGGAGAATTGCTTGAACCCAGGAGTCTGAGGTTGGTGTGATCTAGGCTGATGCCACAGCCTACCTCTGTCCTGTGCAATAGAGACTCCATTT","CCCAGGTGCAGTGGTGTACACCTGTAATCCCAGCTACTTGGGAGGCTGAGGCAGGAGAATCACTTGAACCCAGGAGGTGGAAGTTGCAGTGAGCCGAGACCGCACCACTGCACTGCAGCCTGGGCGATAAAGTGAGGTTCCATCT"
"GL873521","26993909","26994076","chr6","148611209","148611366","47","121617300","CTCTAGCTGGGTATTGTGCCAGACACCTGTTTCCCAGCTACTCCCAACCCTGAAGAAAGAGAAACCTTTAAACCTAGGAGTTTGAGGTTGCTCTGAGCCTTGACACCATGGCACTCTACTGAGGGCAACATAGTAAGACTCTGTCTCAATAAATAAATAAATAAATAA","TTAGCTGGGCATGGTGGCAGGTGCCTGTAATCCCAGCTACTCTGGAGGCTGAAGCAAGAGAATCGCTTGAACCCAGGAGGTGTAGGTTGCAGTGAGTCGTGCCACAGCACTCCATCCTGGGTGACAGAGCAAGACTCTGTCTCAAAAAAAAAAAAAAA"
"GL873521","26994349","26994493","chr7","52091432","52091576","33","25097083","GGCCAGGCATGGTGGTTCATGCCTATAATCCTAGCACTCTGGGAGGCCCAGGCTGGTGGATCACCTGAGCTCAGGAGTTGAAGACCAGCCTGAGGAAGAACATGGATACTTGGTATCTGCTAAAACTAGAAAACCTAGCTGTGTA","GGCCAGGCACAGTGGCTCATGCCTGTAATCCCAGCACTTTGGGAGGCCAAGGCAGGTGGATCACCTGAGGTCAGGAGTTTGAGACTAGCCTGGCCAACATAATGAAACCTCGTCTCTACTGAAAATACAAAAAGTAGCCGGGCAT"
"GL873521","30956694","30956803","chr19","52946786","52946890","23","21990092","GGCCAGGCATGGTGGCTCGTGCCTATAATCCTAGTATTCTGGGAGGCTGAGGTGGGTGGATCATCTGAGCTTAAGAGTTTGAGACCATGGGGCGGAGCCAAGATGGCGAA","GGCCAGGCATGGTGACTCGCGCCTATAATCCCAGCACTTTGGCAGGCCGAGGTGGGCGGATCACCTGAGGTCTGGAGTTTGAGACCAGCCTGACCAACATGGAGA"
"GL873521","32095514","32095619","chr3","10321001","10321105","27","21774513","CCCAGAAGTATAAGGTTGCTGTGAGCTAGGCTGATGCCATGGCGCTCTAACCTGGGCAACAAAGTAAGATTGTGTCTCAAAAATAATAATAATAATAAAATAAAAA","CCCAGGAGGCAGAGGTTGCAGTGAGCCAAGATCACCCCAATGCACTCCAGCCTGGGCAACAGAGTGAGACTCTGTCTCAAAAAAAAAAAAAAAAAAAAAAAAAAA"
"GL873521","32095879","32096085","chr18","14793986","14794201","49","17301893","GGCTGAGCATGGTGACTCACACCTGTAATCCTAGCACTTTAGGAGACCAGGACCCGGGGTCCTTGAGCTCAGGAGTTTGAGACTAGCCTGACCAAGAGTGACACCCTGTCTGTAATAAAAATAGAAAAATCAGCCAGGCATTGTGGGGGACGTAGTCTCAGCTACTCAGGAGGCTGAGGCAAGAGGACCACTTAAACCCAGAAGTAT","GGCCAGACACAGTGTCTCATGCCTGTAATCCTAGCACTTTCGGAGGCCAAGGTGGGCGGATCACCTGAGGTCAGGAGTTCGAGACTAGCCTGGCCAACATGGTGAAACCTTGTCTCTACTAAAAATACAGAAAATTAGCCCGGTGTGGTGGGGTGCCCCTGTAGTCTCAGCTACTCAGGAGGCTGAGGCACGAGAATCACTTGAACCCAGGAGGCG"
"GL873521","32862348","32862502","chr15","9786599","9786734","44","23075749","GGCTGGGCATGGTGATTCACGCTTGTTGTCCCAGTGCTGTGGGAGGCCAAGGCGGGTGTATCATCTGAGCTCTAGAGGTTTGAGACCAGCATAAGACCAGCATGAGCTGGAGTGAGCCAGATTGAGATCCCATCTCTACAATAAATAAATAATTA","GGCTGGGCATGGTGGCTCATACCTGTAATCCCAGCACTTTGGGAGGCCAAGGTGGGTGGATCATCTGAGGTCAGGAGTTTGAGACCAGCCTGGCCAACATGGTGAAACCCCATCTCCACTAAAAATACAAAAATTA"
"GL873521","33221660","33221761","chr3","123390838","123390916","37","90169178","GCCAAAATGTGATAGAAATATAGGGAGCTAGTATGGTTGGCTGCACCTATAATCCCAGCTACTTAGGAGCCTGTGGCAGGAAGATTATGTAAATCCAAGAGG","ATTAGCTGGGTGTGGTGGCACACCTGTAATCCCAGCTACTTGGGAGGCTGAGGCAGAAGAATCACTTGAACCCAGGAGG"
"GL873521","35279514","35279565","chr15","26088692","26088743","14","9190822","GGGAGGCCAAGGTGGGTAGATCACCTAAGCTCAGGAGGTGGAGACTAGCCTG","GGAAAAACGAGGCAGGCGGATCACTTGAGGTCAGGAGTTGGAGACAAGCCTG"
"GL873521","39317755","39317840","chr19","9500695","9500778","21","29817060","GGCTGGGTGCAGTGGCTCAAGCCCATAATCCTCGCTGGCACTTTGGGAGGCTGACATTAGTGGATCTCCTGAGCAAGAGCAAGACC","GGCAGGGTGCCGTGGCTCATGCCTGTAATCCCAGCACTTTCGGAGGCTGAGGCAGGTGGATCACCTTGAGGGAAGAGCGAGACC"
"GL873521","40487814","40487991","chr13","66273235","66273415","55","25785421","GGGAGACTGAGGCAGATAGATCACCTGAGCTCAGAAGTTTAAGACCAGCCTGACAATGTAGTGAGAATTTGCCTCTACAAAAAGTAAAAAATCAGCTAGGTATGTAGGACTGTGCCTATAGTCTCTGCTCTTCAGCAGATTAAGGCAGGAAAATCACTTGAGCCCAGGGTGGGGAGGT","GGGAGGCCAAGGCAGATGGATAACCTAAGGTCAGGAGTTCGAGACCAGCCTGGCCATCATGGTGAAACCCCCATCTCTACCAAAAATGCAAAATTAGCCAGGCGTGGTGGCGCACGTCCATAATCCTAGCTACCTGGGAGGCTGAGGCAGGAGAATCGCTTGAACCAGGGAGGTGGAGGTT"
"GL873521","40568769","40568851","chr19","10984398","10984480","21","29584371","GGCTAGGTTTGGTGGCTCTCAGCTATAATCCCAGCACTTTGGGAGGATCACTTGAGGACAGGAGTTCAAGTCCATCATTGCTA","GGCTGGGTGTGGTGGTTCACGTTTATAATCCCACCACTTTGCGAACATTGCTTGAGGCCAGGAGTTCAAGATCAGCGTAGTCA"
"GL873521","40943306","40943379","chr2","92370724","92370803","23","51427418","ACTGCTTGAGCCCAGGAGTCTAAGGTTGCTGCCGAGCTGTGACACCATAGCACTCTAGGCAACAAAATGAGACT","TTGCTTGAACCCAGGAGCTAGAGGTTGCAGTGAGCTGAGATTGCACTATTGCACTCCAGCCTGGGCAACAGGGTGAGACT"
"GL873521","40943637","40943827","chr6","132230797","132231000","46","91287160","GGCCAGGTGCAGTGGCTCACGCCTGTAATCCAAGCACTCTAGGAGGCTGGGGCAGGCAGGTTGCCTGAACTCACCAGTTCGAGACCAGCCTGAGCTACAGTCACACCCCTCCACCTCTAAAAATAGCTGGGCATTGGGGCGGGCACCTGTAATCCCAGCTACTTGGGGGCTGAGGCAAGAGAATTGCTTGA","GGCCAGGCGCAGTGGCTTGCACCCGTAATCCTAGCACTTCGGGAGGCCGAGGCAGGTGGATTGCCTGAGCTCAGGAGTTCGAGACCAGGCTAGGCAACACAGTGAAACCCCGTCTCTACTCAAATACAAAAAATTAGCTGGGCATGGCGGCGTGTGCATGTAATCCCAGCTACTCGGGAGGCTGAGGCAGGAGAATCGCTTGAA"
"GL873521","40966652","40966987","chr1","7216647","7216973","91","33750005","GGCCAGGCGTGGTGGCTCACGCCTGTAGTCCCAGCGCTGTGGGAGGCCGAGGCAGGTGGATCACCTGTGCTCAGAGGTTTGAGACCAGCATGAGCCAGAAGGAGAGCCAGAGTGAGACCCCGTCTCAACCAAAAATTGCTGGGCGTTCTGGCAGGCACCTGTAATCCCAGCTACTTGGGAGGCTGAAGCCGGAGAATCACTTAAACCCAGGGACCCAGGGGTTGGCAGAGGTTGCTGTGAGCTATGTACCCTACTGAAGGACACAAAGTGAGACTCTGTCTCCTCCATTAAAATAAATAAATAAATAAATAAAAGCAAAAAAAAAAAAAAGAAAAA","GGCCGGGCGCGGTGGCTCACGCCTGTAATCCCAGCACTCTGGGAGGCTGAGGCAGGTGGATCACCTGAGGTCAGGAGTTTGAGACCAGCCTGGCCAACATGGCGAAATCCCATCTCTACTAAAAATACAAAATTAGCTGGGCATGGTGGCACACACCTGTAGTCCCAGCTACTTGGGAGGCTGAGGCAGGAGAATCACTTGAACCCAGGAGGCAGAGGTTGCAGTGAGCCAAGATCATGCCACTGCACTCCAGCCTAGGGGATAGAGCAAGACTCTGGCTCAAAAAAAAAAAAAAAAAAAAACAAAAAACAAACAAACAAAAAAAAA"
"GL873521","40995184","40995245","chr3","87543658","87543719","20","46548474","CTTGCCATCCCAGAACTTGGAAGGCTGAAGCAGGTGGATTGTCTGAGATCAGGATCGAGACC","GCCAGTAATCCCAGCACTTTGGCAGGCCGAGGCAGGTGGATCACCTGAGGTCAGGAGTTCAA"
"GL873521","42278447","42278594","chr10","5542225","5542375","40","36736222","CATGGTGGTTCATGCCTGTAATCCTAGCACTCTGGGAGACTGAGGCGGGAGAATCACTTGAACTCAGGAGCCTGAGATTGCTATAAACTAGGCTAATGCTACAGTAGTCTAACCTGGGCAACAAAGTGAGACTAAAAAAAAAAAAAAA","GGTGGCTCATGCCTGTAATCCCAGCTACTAGGGAGGCTGAGGCAGGAGAGTTGCTTGAACTCAGGAGGCAGAGATTGCAGTCATCGGAGATCATGCCATTGCACTTCTGCCTGGGCAACAAGAGTGAAACTCCATCTCAAAAAAAAAAAAA"
"GL873521","42528529","42528702","chr8","92315933","92316117","53","49787404","GGCCAGGCACGGTGGCTCATGCCTGTAATGCTAGCACTTTGGGAGGCCTTCGCAGGTGAATCACCCAAGCTCAGGAGTTTGAGACTCTGCTAAAAATAGAAAAACTAACCAGGTGTTGTAGAATGCACCTGTAGTCCCAGCTACTCAGGAGGCTGAGATAAGAATATTGCTTAA","GGCCAGGCACAGTGGCTCATGCCTGTAATCTCAGCACTTTGGGAGGCTGAGGAGGGCAGATCACCTGAGGTGGGGAGTTCGAGACCAGACTGACCAACATGGAGAAACCCCGTCTTCAGCCGGGCATGGTGGCACGTCTGTAATCCCAGCTACTCGGGAGGCTGAGGCAGGAGAATCGCTTGAAC"
"GL873521","48647935","48648019","chr10","47852509","47852598","19","795426","GGCCAGGTAAGGTGGCTCACACCTGTCATCCTAGCACTCTGGGAGGCTGAGGCTGGCTTAGCACCTGAGCAAGAGTGAGACCTGC","GGCCAGGTGCAGTGGCTCACACCTGTAATCCCAGCAACTTTGGGAGGCTGAGGCAGGCAGATCACTTGAGGTCAGGAGTTCGAGATCAGC"
"GL873521","48808639","48808706","chr10","17022253","17022322","9","31786386","GGCCAGTGTGGTGGCTCACACCTGTAATCCCAGCACTCTGGGAGGCCGAGGTGGACAAATCGCCTGGG","GGCCAGGTGCGGTGACTCACACCTGTAATCCCAGCACTTTGGGAGCCCGAGGTGGGCAGATCACCTGAGG"
"GL873521","49619898","49620034","chr3","44595520","44595642","50","5024378","GGCCAGGTGTGGGTGGCTTACAGCTGAAATCCTAGCAGGTTGGTAGACCAAGGAGGGAAAGAAGATTGCCTGAGGCCACTCATAGTGTGGGCTAAAGAATACCACCTCTCTCAAAGAAAGAAGTAAAAAAGGCAAAA","GGCCAGGTGCAGTGGCTTGTGCCTGTAATCTCAGCACTGTGGGAGGTCAAGGTGGGCAGATCACCTGAGGTCAGGACATGGGAAAACCCCCATCTCTACAAAAACAACAAACAAACAAACAAA"
"GL873521","53893742","53893910","chr14","19572004","19572165","51","34321738","TGAAACCCTGTCTCTAGTAAACATAGAAAAACTACCTGGGTGTCATGGTGAGTGCCTATAGTCCCAGTTACTTAGAGGCTGAGGTAGGAAAATCGCTTCAGCCCAGGAGTATGAGGTTGCTGTAAGTTGGGCTTTGGCCATGGCACTGTAGCCTAGGCTATGGGCAGAG","AAACCCTGTCTCTATTAAAAATACAAAAAATTAGCTGAGCATGATGAAGAGTGCCTATACTCCCAGCTACTCAGGAGGCTGAGGTGGGAGGATCACTTGAATCCAGGAGGCGGAGGTTGCAGTGAGCCAAGATCGCTCCATTGCACTCCATGGGCAATAGAG"
"GL873522","4768533","4768615","chr1","199505332","199505412","15","194736799","CCAGGCTTGGTGACTCACACCTGTAATCCCAGCACTTTGGGAGACTGAGGCTGATGGATTTCCTGAGCTCAGGAGTTTGAGAC","CCAGGCGCAGTGGCTCACACCTGTAATCCCAGCACTTTGGGAGGCTGAGGCAGGCAGATCACCTGAGGTCAGGAGTTGGAG"
"GL873522","8149679","8149740","chr9","99178070","99178121","21","91028391","CTTTCTTGAGAATCAAAAATGTAGCTGGGGCCGGGGTGGAGGCACACGCCTGTAATCCCAGC","TACTAAAAATACAAAAATTAGGGGGCATAGTGGTGCATGCCCGTAATCCCAG"
"GL873522","8494222","8494296","chr7","11092831","11092900","15","2598609","GGCTGGGTGTGGTGGCTCATGCCTGTAATCCTAGCACTCTGGAAGGCCAAAGCAGGCGGACTGTCTAAGCTCAGG","GGCCGGGCGTGGTGGCTCAAGCCTGTAATCCCAGCACTTTGGGAGGCCAAGGCAGGTGGATCACCTGAGG"
"GL873522","9272209","9272424","chr10","27959033","27959239","73","18686824","AGAAAGAAAGAAAGAAAAGAAAGAAAACAAAGAAAAGAAAGAAAGAAAGAAAAGAATAGCTGGACATAGTGGCTCTTGCCTGTAGTCCAAGCTACTCCGGAGGCTGAGGCAAGAGGATCACTTGAATGCAGGAGTTTGAGGTTGCTGTGAGCTATGATGAATGTACTTTACCCAGAGAAGTAGAGTGAGATTTGGTCTCAAAAAAAAAAAAGACAA","AAAAAAGGAAAGAAAAGAAAAGAAAAGAAAAAAAGAAAGATAAAATGAACCAGGCATGGTGGCATGCATGTGTAGTCCCAGCTACTTGGGAGGCTGAAATGGGAGGATCATCTGAGCCTGGGAGGTTGGGGCAGCAGTGATCGTGCCAGTGCACTTCTGCCTAGGCAACAGAACAAGACTCTGCCTTGGAAAAATAAATTTAAAAAA"
"GL873522","9272655","9272798","chr1","45959857","45960000","36","36687202","GGTCAGGCGCCGTGGCTCATATGGCTCGTGTAATCCTAGCACTCTGGGACGCCGAGGGGGGTGGATTGCTTGAGCTTAGGATTCTGAGACCAACCTGTGCAAGAGGAAGACGCTCTCTACTAAAAATAGAAAAAAATAGCTAGT","GACTGGGCGCGGTGGCTCACGCCTCTAATCCTAGCACTTTGGGAGGCTGAGGCGGGCGGATTGCCTGAGCTCAGGAGTTTGAGACCAGCCTGGGCAACATGGTGAAACCCTGTCTCTACTAAAATACAAAAAAATTAGCTGGGT"
"GL873522","16505754","16505850","chr8","68271230","68271313","39","51765476","AGGCGCGGTGGCTCACACCTGTAATCTGGTTCGAGACTAGCATGACCAAGAGTGAAATCTCGCCTCTAAAAATAGCTGGGTGTTGTGGCACGCACCT","GGGTGCGGTGGCTCACACCTGTAATCCCAGCACTTTGGGAGGCCGAGCCAGGTGGATCACCTGAAGCCAGGTGTTTGAGACCAG"
"GL873522","20051315","20051399","chr4","102397930","102398011","28","82346615","AAAAATAATGGCTGGGTATGATAGCTCATATCTGTAATCTGAGCACTCTGGGAGGCAGGTGGATCACCTGAACAAGAGCGAGACC","ATAAAAAGGCCGGGCATGTTTGCTTATGCCTGTAATCCCAGCACTTTGGGAGGCCACGACAGGCGGAAGAGAGCAGTGGATC"
"GL873522","25501946","25502038","chr10","29045352","29045442","19","3543406","GGCTTGGCACAGAGGCTCACGCCTATAATCTCAGGACTTTGGGAGGTCGAGGCAGGAGGATCTCCTGAGGTCAGGCATCTGAGATCAGTCTGG","GGCGGGGCACAGTGGCTCATGCCTGTAATCCTAGTACTTTGGGAGGTCGAGGCGGATGGATCATCTGAGGTCAGGAGTTTAAGACCAGTCT"
"GL873522","29582573","29582741","chr4","127864075","127864248","48","98281502","TCCTGTGTCTAAAAATAGCTGGGCATTGTAGCGGACACCTGTAGTCCCAGCTTCTTGGAAGGCTGAAGCAAGAGAATCCCTTGAAGCCAAGAGTTGGAGGTTGCTGTGAGTTGTGATGCCACAGCACTCTACCAAGGGCGACAAAGTGAAGCTCTGTCTCCAAAAAAAA","AAAGTACAAAAATTAGCTGGGCATTGTGGCAGGCACCTGTAATCCCAGCTACTCAGGAGGCTGAGGAGGAGAATCACTTGAACCCAGGAGACAGAGGTTTGCAGTGAGCCGAGATCACGCCACTGCACTCCAGCCTGGGTGACAAGAGCGAGATTCTGTCTCAAAAATAAAGAA"
"GL873522","29582997","29583112","chrX","2209428","2209547","27","27373569","GCTGGGTGCAGTGGCTTATGCCTGTATCCTAGCACTCTGGAAGGCTGAGGCAGGTGGATTGCCCTGAGTTCACAGGTTCGAGATCAGCCTGAGCAAGAGCAAGATCCTGTCTCTAG","GACTGGTCATGGTGGCTCACGCCTGTAATCCCAACACTTTGGGAGGCTGAGGCAGGGTGGATTGCCTGAGTTCAGGAGTTCGAGACCAGCCTGGGCAACATGGCGAAACTCTGTCTCTAC"
"GL873522","30103184","30103363","chr17","27139801","27139981","43","2963383","AACTAGCTGGGCATTGTGGCACATGTCTATAATCTCAGCTACTTTGGGAGCTGAGGCAAAGGATTGCTTGAACTCAGGAGTTTAAAGTTGCTGTGAAGTAGGATGACTCCACAGAACTCTAGCCTGGAACAACAGAGTGAAATTCTATCTCAAAAAAAAAAAAAAAATGATAAAAAGAAA","AATTAGCCAGGCATGATGGCACATGCCTGTAATCCCAGCTACTCGGGAGGCTGAGGCAGGAGAATTGCTTGAACCCGGGAGGTGGAGGGTGCGGTGAGCTGAGATCACACCATTGCACTCCAGCCTGGGCAAAAAGAGTGAAACTCCGTCTCAAAAAAAAAAAAAAAAAAAAAAAAAAAAA"
"GL873522","30103671","30103698","chr10","12568351","12568378","9","17535320","CCCACCTTTACCAGAAATAGAAAAACTG","CCCTGACTCTACTAAAAATACAAAACTT"
"GL873522","33580185","33580447","chr1","14534701","14534944","84","19045484","GGCCAGGCTTCGTGGCTAATGCCTGTAATCCTAGCACTCTGGGAGGCTAGGGTGGATGGATCACCTATGCTTAAGAGTTCAAGACCAGACTGAACAAGAGCAAACCAACCCACACCCCACCACCGTCGTCTCTATTAAAAATAGAGCTGAGTGGCTAACCGAGGTGGCTCATGCCTGCAATCTCAGCACTTGGGAGGCTAAAGCAAGTGCATTGCCTGAGCTCACAGGTTCAAGACCAGCCTGAGCCAGAGCAAGACCCCATC","GGCCAGGCACGGTGGCTCATGCCTGTAATCCCAGCACTTTGGGAGGCTGAGGAGGGTGGATCACCTGAGGTCAGGAGTTCCAGACCAGCCTGGCCAACACGGTGAAACCCCGTCTCTACTAAAAATACAAAAATTAGCCAGGCGTGGTGGCACATGCCTGTAACTCCCAGCCACTTGGGAGGCTGAGGCAGAAGAATTGCTTGAACCTGGGAGGCAGAGGTTGCAGTGAGCCAAGATGGCACCA"
"GL873522","36171113","36171213","chr2","51286276","51286376","21","15115163","GCTGGGCACAGTGGCTCATGCCTATAATCATAACACTTTGGGATGCTGAGGCACCCAGTTCACATGAGGCCAGCAGTTCAAACCCAGCCTGGGAAACAGCA","GGCTGGGTGCAGTGGCTCACGCCTATAATCCCAGCACTTCGGGAGGCTGAGGCAGGCAGGTCACCTGAGGCCAGGAGTTCAAGACCAGCCTGGCCAACATG"
"GL873522","36171238","36171260","chr7","154977358","154977375","7","118806120","TCCCTACAAAAAATTAAAAAATT","CCAACAAAAAACAAAAAA"
"GL873522","36582699","36582803","chr2","51286276","51286376","30","14703577","GGCCAGGTGCAGTGGTTCATGCCTGTAATCCCTGGAAGGCCACCAAGGCAGGTGCAAGGCAGGTGCACCTGAGCTCATAGGTTCAAGCCAGCCTGGTAAAAATAG","GGCTGGGTGCAGTGGCTCACGCCTATAATCCCAGCACTTCGGGAGGCTGAGGCAGGCAGGTCACCTGAGGCCAGGAGTTCAAGACCAGCCTGGCCAACATG"
"GL873522","37187319","37187491","chr14","111120428","111120581","57","73933109","CTCAGGAGGCTAAGGCAGGAGGATCACTTGAACCCAGGAGACTGAGGTTATTTTGAGGTAGGCTGATTCCATGGCACTCTAGCCTTGGCAACAAAATGAGACTCTGTCCAAATAAATAAATAAATAAATCCTGTGTAAAGATTCTTGAAAAGACAAAAAAAAAAAAAAAGAAA","CTCAGGAGGCTGAGGCAGGATAATTGCTTGAACCTGGGAGGTGGAGGTTGCAGTGAGCCAAGATTGTGCCACTGCACTCCAGTCTGGACTACAGAATGAGATTCTGTCTCAAAAAAAAAAAAAAAAAAAAAAAAAATAAATAAATAATAAAAAA"
"GL873522","37803968","37804051","chr10","28805224","28805297","29","8998744","GGTGGCTTACACCTATAATCTTAGTACTTTGGGAGGCTGAGGCCAGGTATTTGAGGTCAGCTTCGTCAATATAACGGGACCTCT","GTGGCTCATGCCTGTAATCTCAGCACTTTGGGAGGCTGAGGCAGGCAGATAACCTGAGGTCAGGAGTTCGAGAC"
"GL873522","37804145","37804333","chr16","65290394","65290566","64","27486249","ATTATAATAATAATGGGACCTCATCTGTATTAAAAGATTAAAAAATAAAAGGTAGCTGAGTGTGGTAGTGTACACCTGTCTCCCAGCTACTTGGGAGGCTGTGACAGGAGGATCACTTGAACCCAGGGCTTTATGGTTTTAGTGAGCTATGATCTCACCACTCTACTCCAGCCTGCATGACAGGGCCAG","TCTACTAAAAATAATAATAATAAAAAAAACTAGCCAGGCGTGGTGGTACACACCTGTAGTCCCAGGTACTCAGGAGGCTGAGGCAGGAGAATCGCTTGAACCCAGGGGGCGAAGGTTGCAGTGAGTCGAGATCACACCACTTCACTCCAGCCAGCTTGAGTGACAGAGTGAGA"
"GL873522","37849246","37849377","chr19","4954017","4954151","34","32895229","GGCCAGGTGTGGTGACTCAAACCTATAATTCCAGCACTCAGGGAGGCGGAGGTAGGCAGATCGCCTAAGCTCACAAGTTCAAGACCAGCCTGAGCTAGAGAAAGACCCTCGCCTATGAAAATAGCCAGGTGT","GGCCAGGTGTGGTGGCTCACGCCTATAATCCCAGCACTCTGGGAGGCTAAGGTGGGTGGATCACCTAAGGTCAGGAGTTCAAGACCAGCCTGGCCAACATGGTGAAACCCCATCTCTATTAAAAATACAAAACTG"
"GL873522","37849629","37849779","chr6","58863249","58863409","37","21013620","TAGCCAGGTATTGTGGCCAGTGCCTATAATCCCAGCTACTCAGAAGGCTGAGGCAAGAGAATCAGTTGAGCCCAGGAGTCTGAAATTGCTGTCTGCTGTGATGCCACGGCACTCTACTAGGGGTGACGAAGACTCTTGTCCCAAAAAAAAA","TTAGCCAGGCATGGTGGCACATGCCAGTAATCCCAGCTACTCAGGAGGATGAGGCAGGAGAATCGCTTGAACCCAGGAGGCAGAGGTTGCAGTGAGCTGAGATTGCGCCACAGCACTCTACCCTGGGTGACAGAAGGAGACTCTGTCTCAAAAAAAAAAAA"
"GL873522","38000004","38000142","chr1","29437872","29437991","40","8562132","GGCCGGCATGGTGGCTCACACCTGTTGTCCCAATGCTGTGGGAGGCCAAGGTGGGTGGAGCACCTAAGCTCAGCCAAGTTCGAGACTAGTGGAAGACCAGCATGAGGCAGAGTGAGCCAGAGTGAGACCCTGTCTCTAC","GGCCGGGCGTGGTGGCTCACGCCTGTAATCCCAACATTTTGGGAGGCCAAGGCGGGTGGATCACCTGAGGTCAGAAGTTCGAGACCAACCTGGCCAACATGGTGAAACCCCTGTCTCTAC"
"GL873522","41126747","41126758","chr10","25616253","25616263","1","15510494","AAAGGAAAGAAA","AAAGAAAGAAA"
"GL873522","41126853","41127134","chr10","36212219","36212493","79","4914634","GTGGCTGTCGCCTATAATCCTAGCACTCCCGGGGCAGAGGCGGATAGATCACCTGAGCTCAAAAGATCAAGACCAGGGTGAGCAAGAATGAGACTCTATCACTACTAAAAATAGAAAAAAACTAGCTGAGCATGGTGGCAGGTGCCAGTAATCCCAGCTATTTGGAAAGCTGAGGTAAGGGGATCAATTCATCCCAAGAGTTGGAGGTTGCTGTTAGCTGTGATGCCCTGGCACTCTATCCAGGGAAACTGAGTGAAACTGTCTTAAAAAAAGGAAAGAAAG","GTGGCTCACGCCTGTAATCGCAGCACTTTGGGAGGCCGAGGCAAGTGGATCACCTGAGGTCAGGAGTTCGAGACCAGCCTGGCCAACATGGTGAAACCTCTTCTCTACTGAAAATACAAAAATTAGCTGGGCGTGGTGGCACATGCCTGTAATCCCAGCTACTTGGGAGGCTGAGGCAGGAGAATCACTCGAACTCGAGAGATGGAGGTTGCAGTGAGCTGAGATCGTGCCTCCAGCCTGGGCAACAGAGCGAGACTCTGTCTAAAAAAATAAAA"
"GL873522","42701141","42701202","chr1","36724160","36724214","21","5976981","TCAGCCCTGCACGGTGGCTTGCACCTGTAATTCCAGTTACTCAGGGAGCTTAGAAGGCTCGC","TTAGCCTGGCACAGTGGTGGGTGCCTGTAATCCCAGCTACTTGGGAGGCTGAGGC"
"GL873522","43241133","43241220","chr7","151280825","151280914","20","108039692","GGCCAAGTGTGGTGGCTTCTGCCTGTAATCCTAGCCCTTTGGAAGCCTAAGGTGGGTGGATCGCCTGAGCAAGAGCAAGACTCAGTCT","GGCCAGGCATGGTGGCTCATGCCTGTAATCCCAACACTTTGGGAGGCTGAGGTGGGTGGATCACTTGAGGCCAAGAGTTCAAGACCAGCC"
"GL873522","47072367","47072485","chr7","17832200","17832315","31","29240167","GCCGGATGTGGTGGCTCATGCCTCTACTCCTAGCACTCAGGGAGGCCAGGACAAGAGGATCACCTGAGCTCAGGAATTTGAGATCCTATCTCTACTAAAAATAAAAACATTAGCTGGGC","GCCAGGAGAGGTGGCTCATGCCTCTAATCCCAGCACTCTGGAAATCCAAGGTGGGTGGATCACCTGAGGTCAGGAATTCCAGACCAGTCTGGCCAATATAAAAAATTAGCCAGGCT"
"GL873522","48077685","48077781","chr7","162283431","162283525","18","114205746","GGCAGGGTGTGGTGGCTCATGCCTGTTGTCCCAGCGCTGTGGGAGGCCGAGGCATGTGGATCACCTGAACTCAGAGGTTCGAGACCAGCATGAGCCA","GGCAGGGCATGGTGGCTCACACCTGTAATCCCAGCACTTTGGGAGGCCGAAGCAGGTGGATCACCTGAGGTCAGGAGTTCAAGACCAGCCTGGCC"
"GL873522","48191755","48191802","chr14","7470272","7470321","12","40721483","AGAGTGAGAGTCTTGTCTCAAAAAAAAAAAAGAAAAGAAAAAGGAAAA","ACAGAGTGAGACTCCATCTCAAAAAAAAAAAGAAAAAAAAAGAAAAAAAA"
"GL873522","48192074","48192326","chr3","10747052","10747303","70","37445022","GCCTGTTATCTAGCAGTCTGGGAGGCTGAGGCAAGTGAATCTCCTGAGATCAGGAGTTTGAGATCAGCCTGAGCAAGAGCAATACTCTCATCTCTACTAAAAATAGAAAAACTAGCTGGGTTTTGTGGCAGTTGCCTGTAGTCCCAGGTATTCAGGAGATTAAGGCCAGAGGATTGCTTGAACCCAAGGATTAGGGGTTGCTGTGAGCTATGACATGAAGCCATGGCACTTTACCCCAGGAAACAGACTGAGA","TGTAATCCCAGCACTTTGGGAGGCCGAGGTGGGTGGATCACCTGAGATCAGGAGTTTGAGACCAGCCTGCCCAATATGGTGAAACCCCGTCTCTACTAAAAATACAAAAAATTAGCTGGGTGTGGTGGCGTGTACCTGTAATCCCAGCTACTCTGGAGGCTGAGGCAGGAGAATCGCTTGAACCCAGAAGGCAGAGGTTTGCGGTGAGCCAAGATCATGCCACTGCACACCAGCCTGGGCAACACAGTGAGA"
"GL873523","3332385","3332501","chr13","53714334","53714446","35","50381949","ATCTGAGAGATTTCTTGAATTCAAGAGTTTGACATTGCTGTGAGACACCATGGTACTCTACCTAGGGCACACGGAGTAAGACTCTGTCTCAAAAAAAAAAAAAAAAAAAAAGGAAAA","TCATTTGAACCTGGGAGGCAGAGGGTGCAGTGAGCCGAGATCATGCCACTGCACTCCAGCCTGGGCAACAGAGCAAGACTCTGTCTCAAAAAAAAAAAAAAAAAAAAAAAAAA"
"GL873523","3332735","3332919","chr6","124254397","124254590","56","120921662","TGGCTCATGGTTGTCATCCTAGCACTCTGGGAGTCTGAGGAAGGTGGATTATCTGAGTTCAGGAGTTTGAGGCCAACCTGAGCAAAGCTAGAGAGACCCCATCTCTACTAAAAATAGAAAAAAATTGTGGTGGGTGACTCTAGTCCCATCTAGTCAGTAGGCTGAGATGAGAGGCTTTCTTTCCC","TGGCTCATGCCTATAATCCCCGAACTGTGAGAGGCCGAGGCAGGCAGATCACCTGAGGTCAGGAGTTTGAGACCAGCCTGACCAACATGGTAAAACCCCGTCTCTACTAAAAATACAAAAATTAGCCAGACATGGTGGCACGTGCCTGTAATCCCAGCTACTCAGGAGGCTGGAGCATGAGAATCGCTTGAACC"
"GL873523","4356096","4356383","chr3","71609921","71610217","84","67253825","GCATGGTGGCTCATGCCTATAATAATAGCACTCTGGGAGGCCAAGGTGGGTGGATTGGCTGAGCTTAGGAGTTCAAGACCAGCTTGAACAAGAACAAGACTCTGTCTCTACTAAAATAAAAAAACCAACTGGGCATTGTGGTGGGCACCTATAATCCTAGCTATTCTGGAGGTTGAGGTAAAAGGATCACTTGAGCCTAGGAGTTTGAAGTCACTATGGATATGACACCATGGCACTCTACCCAGGATAACAGAGAGAGACTCTGTTTTAAAAAGGGGGAGAGGGGTT","GGCACAGTGGCTCACGCCTGTAATCCCAGCACTTTGGGAGCCCGAGGTGGGTGGATCACCTGAGGTCAGGAGTTCAAGACCAGCCTGACCAACATGGCAAAACTCTGTCTCTACTAAAATACAAAAATTAGCCAGGCGTGATGGCATGCACCTATAGTCCCAGCTACTCGGGAGGCTGAGGCAAGAGAATCACTTGAACTGGGAGGCAGAGGTTGCTGTGAGCCAAGATCATGCATGGCACTGCACTCCAGCCAGGGTGACAGAGCGAGACTCTGTCTCGGAAAAAAAAAAGAAAAA"
"GL873523","4356472","4356489","chr4","71593145","71593162","2","67236673","TAAAAAAAAAAAAAAAAA","TAAAAATAAAAAATAAAA"
"GL873523","4429580","4429699","chr1","111354387","111354508","24","106924807","GGCCCAGTGAGGTGGCTCACATCTGTAATCCCAGCACTCTGGGAGGCCGAGGCCAGTAGATCACCTGAGATCAGAAGTTTGAGACCATTCTGAGCAAGAGTGAGACCTTGTCTCTAAAAA","GGCCGGGCGTAGTGGCTCACACCTGTAATCCCAGCACTTTGGGAGGCCGAGGCGGATGGATCACCTGAGTTCAGGAGTTTGAGACCAGCCTGACCAAAGTGGTGAAACCCCGTCTCTACTAA"
"GL873523","6833811","6834029","chr7","163565510","163565735","58","156731699","ATCCCTTGAGCTCAGGAGTTCGAGATCAGCCTAAGCAAGAGCAAGACCCTGTCTCCACTAAAATTGGAAAACTAGCTGGGATAGTTAGTGACGCGTGCCTGTAGTCCCAGCTACTCAGGAGGCTGAGGCAAGAGAATCACATGAACCCAAGAGTTTGAGGTTGCTGTGAGCTATGATGCCACAGCACTCTATGTGGATGACAAAACAAGACTCTGTCTC","ATCACCTGAGGTCAGGAGTTCGAGACCAGCCTGGCCAACATGGTGAAACCCCCATCTCTACTAAAAATGCAAAAGATTAGCTGGGCGTGGTGGCTCAGACCTGTAATCCCAGCTACTCGGGAGGCTGAGGCAGGAGAATCGCTTGAACCTGGGAGGTGGAGGTTGCAGTGAGCTGAGATCATGCCACTGCACTCCAGCCTGGGCGACAAGAGCAAAACTTTGTCTC"
"GL873523","16315626","16315707","chr13","94842991","94843063","27","78527365","AAAAATTACCCAATCGTAGCTGGGCGCACGCTGGTAATCCCAGCACTTGGGAGGCCAAGGCAGGTGGATTCGAAGAGTTCAC","GGCCAGGTGCAGTGGCTCTCACCTGTAATCCCAGCACTTTGGGAGGCCAAGGCAGGTGGATCACCTGAGGTCA"
"GL873523","21241172","21241220","chr1","123145244","123145289","12","101904072","GGAGGCTGAAGCAGGGGAATTGCCTGAGGTCATGGGTTCGAGACCAGCC","AGGCTGAGGGAGGCGAATCACCTGAGGTCAGGAGTTTGAAACCAGC"
"GL873523","23105539","23105822","chr17","82280273","82280555","69","59174734","GGGCAGATGCTGTGGTTTAGGCCTGTAATCCCAGCACTCTGGGAGGCCAAAGCCAGCAAATAACCTGAGTTTATGAGTTCCAGACCAGCCTGAGCTAGAGTGAGACCCCACCTCTAAAAATAGCTGGGCATTCTGGCCTGAGCCTGTAATCCCAGCTACTCCAGAGGCTGAGGCAAGAGAATTGCTTAAACCCAGGAGTCTGGGGTTGCTCTGAGTATGACGGCATGGCACTCTACCAGGGATGACAAAGTAAGACTCTGCCTCAAAAAAAAAAAAAAGAAAAA","GGCCAGTGCAGTAGCTCATGCCTGTAATCCCAGCACTTTGTGAGGCCAAAGTGGGTAGATCACCTGAGGTCAGAAGTTCCAGACCAGCCTGACCAATATGGTAAAAATACAAAAATTAGCTGGGCCTGGTGGCATGCACCTGTAGTTCCAGTTACTCAAGAGGTTGAGACAGGAGAATTGCTTGAACCCAGGAGGCGGAGGTTGCGGTGAGCCGAGATCGTGCCATTGCACTCCAGCCTGGGTGACAGAGGAAGACTCTGTCTCAAAAAAAAAAAAAAAAAAA"
"GL873523","23426950","23427021","chrX","1169850","1169920","19","22257100","AGCCAGGTGTGGTACTTACACCTGTAATCCCAGCTACTTGGAGGCTGAGGTGTGAATGATAGACTTAAACTC","GGCCAGGTGTGGTGGCTCACACCTGTAATCCCAGCACTTTGGGAGGCTGAGGCAGGCTGATCACCTGAGGT"
"GL873523","23442184","23442405","chr3","10510226","10510429","62","12931958","GGCCAAGGTGGTGGCTCACATCCTGTTGTCCCAGAGCTGTGGGAGGCCGAGGCGAGTGGATTGCCTGAGCTCAGAGGTTCAAGACCAGCATGAGACCAGCATGACCCAGAGTGAGCCAGAGTGAGACCCCATCTCTACAAAAAAAAAAAAAAAAAAAAGCCGGGCATTGTGGTGGGCACCTGTAATCCCAGCTACTTGGGGGCAGAGGGCAAGAGAATCACT","GGCCAGGCGCGTGGCTCATGCCTGTAATCCCAGTACTTTGGGAGGCCAAAGCGGGTGGATCACCTGAGGTCAGGAGGTTCGAAACCAGCCTGGCCAACATGATGAAACCCCCATCTCTACTAAAATTACAAAAAAATTAGTCGGGTGTGGTGCGCACACCTGTAATCCCAGCTACTTGGGAGGCTGAGGCCGGAGAATCACTTG"
"GL873523","23442682","23442693","chr3","39104358","39104371","3","15661676","AAACCCTAAAGG","AAAACTCTAAAGGT"
"GL873523","25683169","25683273","chr7","127452068","127452175","41","101768899","TGGCGGCACACACACCTGTAATCTCAGCTACTCGGGAGACTGAGGTCAGAAGACTGAGCACCAGCAACTGGGCACAGAGGAAGAACAGGGCTCAAAAACAAACAA","AGCTGGTCCTGATGGCACAAGTGTGTAATCCCAGCTACTCAGGATGCTGAGGCAGGAGATCACGCTGGGCAACATAGCAAGACCCTGTCTCAAAACAACAACAACAAA"
"GL873523","31106298","31106393","chr16","1249761","1249864","26","29856537","GGGTGGATCACCTGAACTCAGGAGCTCAAGACCAGCCTGAGCTGGAGTGATACCTCCATCTCTACTAAAAATAGAAAAACTAGCTGGGCAGGGTGG","AGGTGGGCAGATCACCTGAGGTCAGGAGTTTAAGACCAGCCTCACCAACATGCTGAAACCCCGTCTCTACTAAAAATAGAAAAGTTAGCCGGGCATGGTGGCGC"
"GL873523","33422418","33422694","chr2","48933480","48933757","83","15511062","GGCCGGCTGCTGTGGCTCGCTCCTGTAATCCTAGCACTCTGGAGGACCAGGGAGGAAGGGTCACTTGAGTTCAGGAGGTGGACATGAGCCTGAGCAAGAGTGAGACTCCATCTCTTCTGAAAATAGAAAAATTAACTGTGCATTGTGGCAGGAGGCTGACACAGGAGGCTCACTTGAACCCAGGAGTTTGAGGTTTCTGTGGGCTAGGTTGACACTCTAACAGACTGAGACTCTATCTCAAAACAAACAAACAAACAAACACAAAGAAAAAAAGAAA","GGCTGGGCCTGGTGGCTCAGGCCTGTAATCCCAACACTTTGGGAGGCCAAGGCCAGTGGATCACCTGAGGTCAGGAGTTTGAGACCAGCCTGACCAATATAGTGAAACCTCATCTCTACTAAAAATACAAAAATTAGCCAGACTTGGGAGGCTGAGACATGAGAATTGCTTGAACCCGGGAGGCAGAGGTTGCAGTGAGCCAAGATGTCTGCCTGGGCGACAGAGCAAGACTCTATCTCAAAACCAAACCAAATCAAACAAAACAAAACAAGAAAAAA"
"GL873523","33763875","33763989","chr1","128948288","128948404","32","95184413","GCCTGGGACAATGGCTTAGTCCTATAATTCTAGCACTCTGGGAGGTTAAGGTGAGTGGATCATTTGAGGCTAGGAGATTGAGAATAGCCTGAGCCAGAGTAAAGCCCATTTTCAA","GGCTGGGCACAGTGGCTCACACTTGTAATCCCAGCACTTTGGGAGGCCAAGGAAGATGGATCACTAGAGGCCAGGAGTTTGAGACCAGCCTGGCCAGCATGGTGAAACCCCATCTTT"
"GL873523","33764059","33764211","chr11","122218381","122218538","48","88454322","TTAGCCAAGCATGGTGTTTTCCCCACTACTTAGGAGGGTGAGGAAGGAGAGTAGCTTGAACCCAGGAATTTGAGGTAGAGCTATGATGCTCACCACTATGCTCTAGAGGAGTGAGAAAGTGAGGCCCAGTCTCTAAAAAAGAAAAATAAAAAA","TTAGCCGGGTTTGTTGGCACTCCTCAGCTACTTGGGAGGCTGAGGCAGGAGAATCGCTTGAACCCAGGAGGCAGAGGTTGCAGTGTGCTGAGATCACGCCACTGCACCCCAGCCTGGGTGACAGAGTGAAGCTCTGTGTCAAAAAAAAAAAAAAAAAA"
"GL873523","39364711","39364764","chrX","127489526","127489582","12","88124815","GCCAAGCTAAGTGGCACACACCTGTAATCTCAGTTACTTGGGAGGCTGAAGCAG","TAGCCGAGCATACTGGCACATGCCTGTAATCCCAGCTACTTGGGAGGCTGAGGCAGG"
"GL873523","39442533","39442600","chr17","19340396","19340451","21","20102137","CGGCACTTTTGGAGGCTGAGGCAGGAGGCTCACCTGATGTCAGGAGTTCAAGGTTGCGGAGGGCTATG","AGCACTTTGGGAGGCTGAGGCGGGCAGATCACCTGAGGTCAGAAGTTCAAGATCAG"
"GL873523","43190599","43190734","chr1","29437872","29437991","34","13752727","GGCCAGGCGTGGTGGCGCACGCCTGTAGTCCCAGTGCTATGGGAGGCCGAGGCGGGTGGATGACCTGTGCTCAGAGGTGCGAGACCAGCCAAGACCCCCCTGAGCCAAACGAGCCAGAGTGAGACCCCGTCTCTAC","GGCCGGGCGTGGTGGCTCACGCCTGTAATCCCAACATTTTGGGAGGCCAAGGCGGGTGGATCACCTGAGGTCAGAAGTTCGAGACCAACCTGGCCAACATGGTGAAACCCCTGTCTCTAC"
"GL873523","44268333","44268467","chr1","29437872","29437991","35","14830461","GGCCAGGTGTGGTGGCGCACGCCTGTAGTCCCAGCGCTATGCGAGGCCGAGACAGGTGGATCACCTGTGCTCAGAGGTTCGAGACCAGCCAAGACCCCCCTGAGCCAACGAGCCAGAGTGAGACCCCATCTCTAC","GGCCGGGCGTGGTGGCTCACGCCTGTAATCCCAACATTTTGGGAGGCCAAGGCGGGTGGATCACCTGAGGTCAGAAGTTCGAGACCAACCTGGCCAACATGGTGAAACCCCTGTCTCTAC"
"GL873523","45183435","45183549","chr11","50137629","50137739","41","4954194","GCTCACACCTGCAACTCTAGGACTTTGGGGGGTCAAGCTGGGTGGGTCCCTCAAAGTCAGACACTCCTTAACAGCCTGGTCAAAACCAAGACATCCACCTCTGACAAATACAGAA","GGCTCACTCCTGTAATCCCAGCACTTTGGGAGGCCGAGGTAGGTGGATCGCCAGGTCAGGAGTTCGAGACCAGCATGGCTAACATGGTGAAACCCTACTAAAAATACAAAA"
"GL873524","1197676","1197886","chr16","24199776","24199985","41","23002100","GGACATGATGGCTCACGCTTGTAATCCTAGCACTCTGGGAGGCCAACGTGGATGGATTGCCTGAGGTCAGGAGTTTGAGACCAGCCTGAGCGAAAGCGAGACCCCATCTCTACTAAAAATAGAAAAACTAGCTGGGTGTAGTGGTGCATGTCTGTAGTCTCAGCTACTCAGGAGGCTGAGGCAAGAGGATCACTTGAACTCAAGAGTTTGA","GTGGTGGCTCACGCCTGTAATCCCAGCACTTTGGGAGGCCAAGGCGGGTGGATCGCCTGAGGTCAGGAGTTTGAGACCATCCTGGCCAACATGACGAAACCCCCTCTCTACTAAAAATACAAAGATTAGCTGGGTGTGGTGGTGCACATCTGTAGTCCCAGCTACTTGGGAGGCTGAGGCAGGAGAATTGCTTGAACCTGGGAGGCAGAG"
"GL873524","1198172","1198271","chr2","157713386","157713486","33","156515214","GCCAACAACAACAAAAGAGTTTGAGGTTGCTGTGAGCTACAAAGACACAAAGACACTACCCTAGGCAACAGGGTGACACTGTCTCAAAAAAAAAAAAAAA","TCTCTTGAACTCAGGAGGCAGAGGTTGCAGTGAGCCGAGATCACGCCAATGCACTGCAGCCTGGGCAACAGAGTGAAACTCTGTCAGAAAAAAAAAAAAAA"
"GL873524","3058899","3058993","chr1","25829614","25829692","36","22770715","ATTAAAAACAAAATAAGCCAGCACAGTTTCATGCACCTGTAATCCCAGCTATTCAGGAGGTTGAGGCAGGAAGAGGTTGAGACCTGGGCAATATA","ATACAAAAATTAGCTGGGCGGGGTAGTGCACAGCTATAATCCCAGCTACTCAGGAGGCTGAGGCAGGAGAATCGCTTGA"
"GL873524","3866907","3866975","chr10","28805224","28805297","15","24938317","TAGCTCATGCCTGTAATCCAGCACTTTGGGAGGCCGAGGCGGGTGGATAGCCTGAGCAAAAGTGAGACC","GTGGCTCATGCCTGTAATCTCAGCACTTTGGGAGGCTGAGGCAGGCAGATAACCTGAGGTCAGGAGTTCGAGAC"
"GL873524","5893886","5893982","chr2","175823240","175823333","31","169929354","GGTGGCTCATGCCTATAATCCTAGTACTTGGGGAGGCCTAGATGGGCAGATTGTCTAAGCTTGGTTTTGCTCAGGAGTTTGGTACCAACCTGATCAA","GGTGCAGTGGCTCATGCCTGTAATCCCAGCACTTTGGGAGGCTGAGGTGGGCAGATTACCTGAGGTGGGGAGTTTGAGACCAACCTGACCACCA"
"GL873524","8037528","8037603","chr20","4086909","4086983","18","3950619","TGTCATCTCAGCACTTTGGGAGACTGAGCTAGGAGGATCACCTGAGGTCAGGTGTTTAAAACTAGCCTGGACATCA","GTAATCTCAGCACTTTGGGAGGCTGAGGTGGGTGCATCACACGAGGTCAGAGAGTTCGAGACCAGCCTGGCCAAC"
"GL873524","11279444","11279613","chr15","10208849","10209017","51","1070595","AAGTAGAAAAACAAGCCAGATCTTATGGCGTGCACCTGTAGTTCCAGCAACTGTGTAGACTGAGGCAAGATCTCTCGAACCCAAGATTCTGAGGTGCTGAGTTATCACAGCACCACGCTCTACCCATGGCTACAGAGTGAGACTCTGCTCAAAGAACAAACAAACAAAAA","TACAAACATTAGCCAGGCATGGTGTCGGGCACCTGTAATTCCAGCTACTCGGGAGGCTGAGGCAGGAGAATTGCTAGAACCCAGGAGGCGAAGGTTGCCGAGATCACACCACTGTACTCCAGCCTGGGTGACAGAGTGAGACTCTGTCTCAAAAAAAAAAAAAAGAAAA"
"GL873524","11279653","11279773","chr6","167983186","167983307","29","156703533","GGTTGTGTGCAGTGGGTCATGTCTGTAATCCTAGCACTCTGGGAGGCCAAGCTAGGTGAATCACCCAAGCTCAGGAGTTTGAAACTAGCCTGAGCAGGAGCAAGACCTCGTCTCTACTTAA","GGCTAGGTACAGTGGCTCATGCCTGTAATCCCAGCACTTTGGGAGGCCAAGGTGGGTGGATCACCTGAGGTCATGAGCTTGAGACGAGCCTGGCCAACATGGTGAAGCTCTGTCTCTACTAA"
"GL873524","11628587","11628862","chr5","101626651","101626922","72","89998064","GCCAGGCATGCTGGCTCACACCTGTAATCCCAGCACTCTGGGAGGCCAAGGTGGGTAGATTGCCTGAGTTCAGGAGTTCAAGACCAGCCTGAGCCAGAGTATCTACTAAAAATAGAAAAAGTAGGTGGGTGTTGTAGGGTATACCTGTATTGTCCCCAGCTACTCTGGAGCCTGAGGCAAGAGATAGCTTGAACATGACAGTTTGAGGTTGCTATGAACTAGGACACCAGGGCACTCTACACAGGGCCAGAGAGGGAGACTCGGTCTCAAAAAAAA","GGCCAGGCGTGGTGGCTCACCCCTGTAATCCCAACACCTTGGGAGGCCAAGGCGGGCAAATCACCTAAGGTCAGGAGTTCGAGAGCAGCCTGGCCAACATCTACTAAAAATAAAAAAATTAGCCAGGTGTGGTGGCACATGCCTGTAGTCCCAGCTACTAGGGAGGCTGAGGCAGGAGACTTGCTTGAACCTGGGAGGCAGAGGTTGCAGTGAGCCAAGAGCATGCCATTGCACTCCAGCCTGGACGACACGCTGAGACTCTGTCTCCAAAA"
"GL873524","16511392","16511466","chr1","5090046","5090110","25","11421346","CTGGTCATCTGGTCAGATGACCCCTTCTCTACTAAAAATAGAAAAACTAGCCAGATGTTGTAGTAGACTCTTTTA","TGGCCAGGTGCAAAACCCCATCTCTACTAAAAGTACAAAAATCAGCCGGGTGTGGTAGCAGCTGC"
"GL873524","16511549","16511623","chr1","5090046","5090110","25","11421503","CTGGTCATCTGGTCAGATGACCCCTTCTCTACTAAAAATAGAAAAACTAGCCAGATGTTGTAGTAGACTCTTTTA","TGGCCAGGTGCAAAACCCCATCTCTACTAAAAGTACAAAAATCAGCCGGGTGTGGTAGCAGCTGC"
"GL873524","19863637","19863772","chr1","29437872","29437991","30","9574235","GGCCGGGCGTGGTGGCGCATGCCTGTAGTCCCAGTGCTATGGGAGGCCAAGGCGGGTGGATCACCTGAGCTCAGAGGTTCGAGACCAGCCAAGACCCCCCTGAGCCAAACGAGCCAGAGTGAGACCCCGTCTCTAC","GGCCGGGCGTGGTGGCTCACGCCTGTAATCCCAACATTTTGGGAGGCCAAGGCGGGTGGATCACCTGAGGTCAGAAGTTCGAGACCAACCTGGCCAACATGGTGAAACCCCTGTCTCTAC"
"GL873524","21542225","21542241","chr3","175722160","175722172","6","154179935","GCATGCTGGACATGCTC","GCTGGGCATGGTG"
"GL873524","22965091","22965163","chr10","92401809","92401875","21","69436718","CAAGGCAGGTGGATTACCTGAGTTCAGGAGTTGGAGACCATCCTGAACAAAAGCAAGTGCAAACCCTGTCTCT","GCAGGCGGATCACCTGAGGTCAGGAGTTCAAGACCAGCCTGGCCAACACAGTGAAATCCCGTCCTTA"
"GL873524","28836605","28836679","chr13","38732122","38732200","21","9895517","GTGCAGTGACTCATGCCTAAAATACCAGTACTTGGGAGGGTAAGGTAGGAATCACTTGAGGTCAAAAATTCAATA","GGGCATGGTGGCTCGCACCTATAATCCCAGCACTTTGGGAGGCCAAGGTAGTCAGATCACCTGAGGTCAAGAGTTCGAT"
"GL873524","29806789","29806882","chr14","6548819","6548901","27","23257970","TAGAAAAAGCAGCTGGGAGTAGTGGCTCTTACTGGTAATCCTGGCATTTGGGGAGGCTGAGGCAAGAGGATCACTTGAAGTCAGGAGTTTGAGA","GCCGGGCGTGGTGGCTCATGCCTGTAATCCCAGCACTTCGGGAGGCTGAGGCGAGCGGATCACCTGAGGTCAGGAGTTCAAGA"
"GL873524","40351122","40351310","chr13","10181886","10182054","59","30169236","GCTGGATGCAGTGACTCACTCCTATAATCCTAGCACTTTGGGAGTCTGAGGTGGGCAGATCACCTGAGGCTATTAGTTCCTGACCAGCCAGGGCATCATACTGAAACTCCCCACACACAATACACACCCATCTCTACAAAACTAGAAAAATTAGCCTGCCCAGCGCCCCACACTTGTAGTTCCACCTAC","CTGAGCGCAGTGACTCATGCCTGTAATCCCAGCACTTTGTGAGGCTGAGGTGGGTGGATCACCTGAGGTCAGAAGTTTGAGACCAGCCTGGTCAACATAGTGAAACCCCGTCTCCAGTAAAAATACAAAAATTAGCCAGGCGTGGTGGCGCACACCTGTAATCCCAGCT"
"GL873524","43462775","43462937","chr1","26946456","26946617","44","16516319","CTTGCTAGGTGTTTTGTTGGGCACCTGTAGCCCCAGCTCCTTGAGAAGCTGAGGCAAGACTATTGCTTGAGCCCAAGAGGTTGAGGTTGCTATGAGCTATCACATCATAGCACTTAACCCAGGGCAACAGGGTGACACTCTGTCTCAAAAAAAAAAGTAAAAA","TAGCTGGGCGTGGTGGCACATGCCTGTAGTCCCAGCTACTTGGGAGACTGAGGCAGGAGAATTGCATGAACCCAAGAGGTGGAGGTTGCAATAAGCCAAGATCACGCCACTGCACTCCAGCCTGGGCAACAGAGTGAAACTGTGCCTCAAAAAAAAAAAAAA"
"GL873524","43463213","43463338","chr6","137317853","137317983","35","93854640","GTCAGGCTCAGCGGCTTTTACCTGTGATCCTAGTACTCTGGGAGGTGGAGGTGGGTGGATCTCTTTAAGTTTGAGACCAGCCTGACCAAGAACAAGACCCCATTTCTACTAACAATAGAAAAACTA","GGCTGGGCGCAGTGGTTCATGCCTGTAATCCCAGCACTTTGGGAGGCTGAGGCAGGCGGATCACCTGAGGAGTTCGAGACCAGCCTGGCCAACATGGCAAAACCCCATCTCTACTAAAAATACAAAAAAAA"
"GL873524","45132804","45133101","chr2","91320157","91320457","77","46187353","GGCCAGGCGTGGTGGCTCATGCCTGTACCTAACACTCTAGGAGGCTGAGGTGGGTGGATTGCCTGAGCTCACAGGTTCAAGATCAGCTTGAGCAAATGGAAGACCGCTGTCTCTAAAATTAGCCAGGCATTGTGGTGGACGCCTGTAATCCCAGCTACTTGGGAGGCTGAGGCAAGAGAATTGTTTGAGCCCAAGAGTTGGAGGTTGCTGTGAGCTGTGACACCATAGTATTCTACTGAGAGTGACAAAATGATATTCTGTCTCAAAAAAAGAAAGAAAGAAAGAAAAGAAAAATAAA","GGCCAGGCGCAGTGGTCATGCCTGTAATTCCATCACTTTGGGAGGCTGAGGTGGGTGGATCACCTGAGGTCAGGAGTTTGAGACCAGCCTGGCCAAGATGGTGAAACCCTGTCTCTAAATACAAAAATTAGCCAGGCGTGGTGGTGCACACCTGTAATCCCAGCTACATGGGAGGTTGAGGCATGAAAATTGCTTGAACCCAGGAAGTGGAGGTTGCAGTGAGTTAAGATTGCACCATTGTACTCCAGCCTGGGTGACAGTGAGACTGTCTCAAAAACAACAACAAAAACAGAGAAATAAA"
"GL873525","5326525","5326637","chr3","40154619","40154733","35","34828094","CTAGGCATAGTGTCTCATGCCTATAATCCAGGCATTTTGGAAGACTGAACCAAAAGAATAACTTGAGGCTAGAAGTTTGAGACTAGCCTACCCACACAATCCCATCTCTACCA","GGCGCAGTGTCTCATGCCTGTAATCCCAGCACTTTGGAAGGCAGAGGCAGGCGGATCACTTGAGGTCAGGAGCTTGAGACCAGCTTGACCAACATGGTGAAACCCCATCTCTACT"
"GL873525","5326686","5326859","chr6","132206031","132206198","55","126879345","TAGCTAGGTGTGATGATATGGGCCTGTAATCCTATTTATTTGAGAAGTTAGGGCAAGAGGGTCATTTGAGCATAAGAGTTCAAGGTTACATAGAGCTATGATTGAACCCCTACACGTCACACTTCAGCCTAAGCAACAGAATGAGGCCCTGTATTTAAAAAAAAAAGAAAGAAA","TTAGCCAGGTGTGGTGGTGCATGCCTGTAATCCCAGCTACTCGGGAGGCTGGGGCAGGAGAATCACTTTGAACCTGGGAGGCGGAGGTTGCAGTAGCTGAGATTGCGCCACTGCACTCCAGCCTGGGCAACAGAGTGAGACTCTGTCTCTAAAAAAAAAAAAAAAGAA"
"GL873525","7531820","7531915","chr8","4916900","4917001","32","2614920","CAGCCTGAGCAAAGTGACACTGCATCTCTGCTAAAAATAGAAAAATTAGCTGGATGTTGTGGCGGGTGCCTGTAGTCTTGGCTAAGGCAAGAGAAT","CTAGCCTGGCCAACATGATGAAACCCCCTCTCTACTAAAAATACAAAAATTAGCCAGGTGCGTGGTGGTATGTGCCTGCAGTCCCAGCTATTCTAGAGTCTG"
"GL873525","7532192","7532284","chr7","49412503","49412597","22","41880311","GGTTGGGCACAGTGGCTCATGCCTATAATCCTAGCACTCTGAGAGGCCCAGGCCAGTGGACTGCCTCAGCTCAGGAGTTCAAGAGCGGCCTGA","GGCCAGGTGCAGTGGCTCATGCCTGTAATCCGAGCACTTTGAGAGGCCGAGGCAGGCAGATCACCTGAGGTCAGGAGTTCAAGACCAGCCTAGTA"
"GL873525","8108080","8108148","chr13","39203832","39203891","23","31095752","ATAAAGAAGTTTAGCCCAGCACCATGGTGCGTGCCTGTAATCCCAGCTACTGCGGATGTCGAGGCGGGA","TTAGCTGGGCGTAGTGGTGTGTGCCTGTAATCCCAGCTACTTGGGAGGCTGAGGCGGGAG"
"GL873525","8672403","8672538","chr1","29437872","29437991","34","20765469","GGCCGGACGTGGTGGCTCACGCCTGTAGTCCCAGCGCTATGGGAGGCCGAGGTGGGTGGATCACCTGTGCTCAGAGGTTCGAGACCAGCCAAGACCCCCCTAAGCCAAATGAGCCAGAGTGAGACCCCATCTCTAC","GGCCGGGCGTGGTGGCTCACGCCTGTAATCCCAACATTTTGGGAGGCCAAGGCGGGTGGATCACCTGAGGTCAGAAGTTCGAGACCAACCTGGCCAACATGGTGAAACCCCTGTCTCTAC"
"GL873525","11166273","11166616","chr8","87825297","87825617","99","76659024","CTGGGAGTGGTGGCTCACGCCTGTTGTCTCAGCGTTGTGGGAGGCTGAGGCGGGTGGATTGCCCTGAGCTCAGAGGTTCGAGACCAGCATGAGCCAGAGTGAGACCCCCGTCTCTACCAAATAATTGCTGGGCGTTCTGGCAGGTGCCTGTAATCCTGTAATCCCAGCTACTTGGGAGGCTGAGGCTAGAGAATCACTTAAACCCAAGGACCCAAGGGTTGGTGGAGGTTGCTGTGAGCTATGATTTCACAGTACTCTACTGAGGGTCACAAAGTGAGACTCTGTCTCCATAAAGAAAGAAAGAAAGAAAGAAAGAAAATGAAAGCAAAATTTAAAAAAAAAAA","GACTGGTTGTGGTGGCTCACGCCTGTAATCCCAGCAGTTTGGGAGGCTGAGGCGGGTGGATCCTCTAAGGTCAGGAGTTTGAGACTAGCCTAGCCAACATGGTGAAACTCTGTCTCTACTAAAAATGCAAAAATTATCTGGGCATGGTGATGCATGCCTGTAATCCCAGCTACTCAGGAGGCTGAGGCAGGAGAATTGCTGGAACCCAGGAAGTGGAGGTTGCAGTGAGCTGAGATTTCTCCAGTGTACTCCAGCCTTGAGTGCAGAGAGAGACTCCGTCTCAAAAAAAAAAAAAAAAAAAAAAAAAAAAAAAAAAAAAAA"
"GL873525","12899476","12899747","chr15","34238788","34239066","76","21339312","CAGTGGCTCACGCCTGTAATCCCAGCACTTGGGAGGCCCAGGTGGGTGTATTGCCTGAGGTCACAGGTTGGAGATCAGCCTGAGCCAGAGTGAAACCTCATCTCTAACAAATAGCCAGGTGTTGTGGTTGCCTGAAGTCCCAGCTGCTCCAGAGGCTGAGGCAAGAGGATTACTTGAACCCAAGAGTTTGAGGATTACTTTGCTATGAGCTAAGACACCATGGCACTCTACCCAGGGCGGCCAAGTAAGACTCCGTCTCAAAAAAACAAAAA","GCAGTGGCTCACGCCTGTAATCCCGGCACTTTGGGCGGCCGAGATGGGAGGATCACCTGAGGTCAGGAGTTTGAGATCAGCCTGGCCAACATAGTGAAACCCCATCTAAAAATTCAAAATTAGCTGGGTGTGGTGGTACATGCCTGTAATCCCAGCTACCTGGGAGGCTGAGTCAGGAGAATCACTTGAACCTGGGAGGTGGAGGTTGCAGTAAGCCGAGATTACACCATGCACTCCAGCCTGGGCAACAGGAGCGAAACTCCGTCTCAAAAAAAAAAA"
"GL873525","17336158","17336417","chr1","182660703","182660975","86","165324545","GACCAGGCACAGTGACTCGTAGCTATAATTCTAACTGCAGGAGGATGAGGCAGGTGGATTGCTTGAGCTCAGGAGTTCAGCCTGTCCAAGAGTGAAACACTATCTCTACTAAAAGTAGAAAAACTAGCCTGGCATCATGGCAGGTGCCTGTAGTTCCAGCTACTTCAGTTGAGCCCAAGAGTTTGAGGTTGCTATGACAAAGAACTCTACCGGGGTAAGAATCTATCTCAAAAAGCTAAAAACTAAAAAATGAATAAAAA","GGCCAGGCACAGTGGCTCATGCTTGTAATCCTAGCACTTTGAGAGGCCGAGGCAGGCAGATTACGTGAGGTAAGGGAGCTCTAGACCAGCCTGGCCAACAGGGTGAAACCCCATCTCTACAAAAATATAAAAAATTAGCCAGGCATGGTGACATGTGCCTGTAATCCCAGGTACTCAGGAGGCTAAGGCAGGAGGATCGATCATGACCTGCACTCCAGCCTGGGCAACAGAGCAAGACTCTGTCTAAAAAAAAATAAAAATAAAATAAAAAAA"
"GL873525","20222951","20223051","chr11","120670891","120670976","32","100447940","GACTGGGTACAGTAGCTCACAGCTATAATCCCAGCACTTTGGGAGTCCAAGACCAACCTGGGCAAGAGCAAGACCTTCTTTCAAATAAAAATAGAAAAACT","GACTGGGTGCAGTGGCTCACACCTATAATCCCAGCACTTTGGGATGTCAAGACTGGCAGATTACCTGAGGTTAAGAGTTCAAGACC"
"GL873525","20223298","20223327","chr1","27794863","27794888","7","7571565","TAATAATAATTAATAAAAATAGAAAACTGA","TAGATAAAATTAAAAAAAAAAAAATA"
"GL873525","20252925","20253072","chr13","92037687","92037820","38","71784762","GCTGGGAGCGGTGGCTCACGCCTATAATCCCAGCACCCAGCCCCTGGGAGGGTGAGGCAGGTGGATTGCCTGAGCTCACCAGTTTGAGACTAGCCTAAGCAAGAGCCAGACACGCCTCAGCTCCAGTCTCTTAAAAAAACAAAAAATA","GCCGGGCGCAGTGGCTCACGCCTATAATCCCAGCTCTTTGGGAGGCCGAGGCAGGCGGATCACCTGAGGTCAGGAGTTTGAGACCAGCCTGGCCAACACGGCGAAACTCTAGCTCTCTAAAAATACAAAAATTA"
"GL873525","20253346","20253510","chrX","113513243","113513403","45","93259897","AGAAAAATCGGGCGTTGTGATTGAGGCCTGTAGTTCCAGGTACTTGGGAGACTGAGGCAAGAGATTCTTTTGAGCCCTGGAGTTTGAAGTTGCTGTGAGCTAAGACACCAAGGCACTCTACCAAGGATGACCAAGTGAGACTGTCTCAAAAAACAAACAAAAAAA","GCCAGGTGTGGTGACACACACCTGTAGTCCCAGCTACTTGGGAGGCTGAGGCAGGAGAATCGCATGAGCCTGGGAGGTGGAAGTTGCAGTGAGCTGAGATCACACCACTGCACTCTAACCTGGGCGAAAGAGTGAGACTGTCTTAAAAAAAAAAAAAAAAA"
"GL873525","20289361","20289486","chr15","97741321","97741440","30","77451960","GGCCAGGCATGGTGGCTCATGCCTATAGTCCCAGTGCTGTGGGAAGCTGAGGCAGGTGAATCGCTGAGCTCAGAGGTTTGAGACCAGCATGAACCAGAGTGAGCCAGAGTGAGACCCTATCTCTAC","GGCCAGGTATGGTGGCTCACACCTGTAATCCCAGCTCTGTGGGAGGTTGAAGCAGGTTGATCACCTGAGGTCAGAAGTTTGAGACCAGCCTGGCCAAAATGGAGAAACCCTATATCTACT"
"GL873525","20289514","20289586","chr3","48261745","48261808","23","27972231","AAAAAAAAGCAGGGCCTTGTGGCAGGCGCCTGTGATTCCAGCTACTTGGGAGGCAAAGGGCAAGAGAATTGCT","GCTGGGCATGGTGGTGCATGCCTGTGATCCCAGCTACTCAGGAGGCTGAGGCAGGAGAATTGCT"
"GL873525","22042539","22042646","chr1","43445161","43445263","40","21402622","CCCTCAAAATGATCTCTTTAGTCCAAAAGTTTGAGGTTGCTGTGAGCTATCTGACACCCTGGTGCTCAACCCAGAGTGACAGAATGAGTCTATCAAAAAAAAAAAAAA","GCAGAAGAACTGCTTGAACCCAGGAGGCAGAGGCTGCAGTGAGCTGTGCCACTGCACTCCAGCCTGGGTGACAGAGCAAGACTCCATCTCAGAAAAAAAATAA"
"GL873525","22042928","22043107","chr1","25825674","25825851","51","3782746","TGTAATCCTAGCACTTTGGGAGGCTCAGACAGGTGGATTCCCTGAGCTCAAGAGTTTCAAACCAGTGAGTAAGAGTGAGACCCTGTCTCTACTAAAAATAGAAAATCTAGCAGGGCATTGTAGCAGGTTCCTGTAGTCCCAGCTATTTGCAAGGCTGAGGCAAAATTATCTCTCTCTCTC","TGTAATCCCAGCACTTTGGGAGGTCAAGGCGGGTGGATCACCTGAGGTCGGAGTTCGAGACCAGCCTGACCAACATGGTGAAACCCCGTCTCTACTAAGAACACAAAAATTAGCCAGGCGTGGTGGCGGGCACCTGTAATCCCAGCTACTTGGGAGGCTGAGGCAGGAGAATCGGTTG"
"GL873525","22091206","22091358","chr2","74327001","74327153","58","52235795","CTCAATTAAGAATGCAGGCACTAGCCAGGCATAGTGACACACGACACAATCCCAGCTACTTGGGAGGCTGGGGTGGGAGGACTGCTCAAGCCCACTGACTCTGTGGGCTCTCATTCTGCAACAGAATGTGACTCTGTCTTTTGGGGTAAAAAA","GTCTCTACTAAAAATACAAAATTAGCCGGGCATGGTGGCACATGCCTGTAATCCCAGCTACTTGGGAGGCTGAGGCAGGAGAATCGCTGGAACCCAGGAGGCGGAGGGCGCGGTGAGCCAAGATCATGACATTGCACTCCAGCCTGGGCAACA"
"GL873525","24584081","24584377","chr2","94286272","94286584","71","69702191","GGCCAGGTGTGGTGGCTCACACCTGTAATCCTGGCACTCTGGGAGGCTGAGGTGGGTGGATTGCCTGAGCTCATGAGTTGGAGACCAGCCTGAGCCACAGCAAGACCTCCTCTCTAAAAATAGTTGGTGTTGTGGTGGGCACCTATAGTCCCAGCTACTCAGGAGGCTCAGGCAAGAGAATCGCTTGAGCCCAAGAGTTTGAGATTGCTGTGAGCTAAGATGCCATGGTACTCTACCCAGGGTAACAAAATGAGATTCAGTCTCAAAAATAAATAAATAAATAAATAAATACAAAAA","GGCTGGGTGCGGTGGCTCATGGCTATAATCCCAGCACTTTAGGAGGCTGAGGTGGGTGGATCACCTGAGTTCAGGAGTTCAAGACCCAGCCTGATCAACATGGGCGAAACCCCATGTCTACTAAAAATACAAGTAACCAGGTGTGGTGGCGTGAGGCTGTAATCCCAGCTACTCAGGAGGCTGAGGCAAGAGAATCACTTGAACCCAGGAGGCGGAGGTTGCAGTGAGCTAAGATCATGCCACTGCACTCCAACCTGGGCAACAAAACGAGACTCCGTCTCAAAAATAAATAATAAATAAATAAATAAATAAA"
"GL873525","25680003","25680112","chr10","22894092","22894181","38","2785911","AAAGCTAGCTGGGTTGTGGTGGTTCATGCCTGTAATTTGGGTGACTTGAGAGGCTGAGGCAGTGACCTGAGTCGCTGAGGCGACTTGAGAGGCTGAGGCAGGAGGCTGAG","AAAATTAGCCAGGTGTGGTGGCACATGCCTGTAGTCCTTGAGAGGCTGAGGCAGGAGAACCACTTGAACCTGGGAGGTGGAGGTTGTAAT"
"GL873525","29785863","29786066","chr19","4814413","4814616","66","24971450","AAAAAAAGACCAACTTGAGCAACAGCAAGATCCTATCACTACTAAAAACCCAGAAAAATTAGGTGGACATTGTGGCAGGTGCCTGTAGTCCCAGCTACTCAGAAGACGGAGGCAGGAGGACTGCTTGAGCCCAGGAGTTTGAGGTTGCTGTGAGCTAGGCTGAGGCTAGCTCTCACTCTGTCACAAAAAAGAAAAGAAAACAAA","CAAGCAATTCGAGACAAGTTAGGCCAACATGATAAAACCCTCTCTCTACTAAAAATACAAAAAAATTAGCCGGGCGTGGTGCCATGCGCCTATAATCCTACCTACTCAGGAGGCTGAGGCAGGAGAATCGCTTGAACCCAGGAGGTGGAGGTTGCAGTGAGCCGAGATCCCAAGACTTTGTCTTGAAAACAAAAAGAAAAAGAG"
"GL873525","29786306","29786401","chr5","24882384","24882475","21","4903922","GGCTGGGTGTGGGTGGCTTATATCTATTATCCTACCATTCTGGGAGGCCGAAGCAGTTGGATCGCTTTAAGTCAGGAGTTCAAGACCAGCCTGAGT","GGCCGGGCGCAGTGGCTCACATCTATAATCCTAGCATTTTGGGAGGCTGAGGCAGGCGGATCACCTGAAGTCAGGAGTTTAAGACCAGCCTG"
"GL873525","29877465","29877625","chr7","82063315","82063476","51","52185850","GAAAGAAAGAAATAGAAAAATTAGCCCAGCCATGTGGCACACACACATATTCCCAGCTACTGGGGAGGGCGAGGCAAGAGGATCACTTGAACCAGGAATCTAAGGTTGCTATGAGCTAGTCTGACACCATAGCATTCTGACCTGGGAAAAAGAGTGAGACT","TCTCTACTAAAAATACAAAACATTAGCCAGGCATGGTGGTGGGCACCTGTAATCCCAGCTACTCTGGAGGCTGAGGCAGGAGAATCGCTTGAATCCAGGAGGCAGAGGTTTCAGTGAGCTAAGATTGCACCATTGCACTCCAGCCTGGGTTACAAGAGTGAG"
"GL873525","29877907","29878025","chr6","43968663","43968782","30","14090756","TTACGCCTATAATCTTAGGACTTTGAGAGGCTGAGGTGGGAGGATCTATTGACCTCAGGAGTTTGAAACCAGCCTGACTAAAAACAAGACAGCGTCTCTACTAAAAATAGAAAAATTTA","TCATGCCTTTAAGCCCAGCACTTTGGGAGGCTGAGACAGGTGGATCACCTGAGGTCAGGAGTTTGAGACCAGCCTGACCAATATGGCGAAACCCCTTCTCTACTAAAAATACAAAAATTA"
"GL873525","31295530","31295723","chr1","135804705","135804887","63","104509175","GGCCAGGCATGGTAGCTCACGCCTGTTGTCCCAGCACTGTGGGAGGCTGAGGCGGGTGGATCACCTGTGCTCAGAGGTTCAAGACCAGCTGAAGTCTCGCCTGAGCCAGAGTGAGCCAGAGTGAGATCTCGTCTCTACAATAACAACAAGACAGCCGGACCTTGTGATCCCAGCTACATGGGGGCACAAGAGAA","GGCCAGGCATGGTGGCTCACGCCTATAATCCCAGCACTTTGGGAGGCTGAGGCGGGCGGATTACCTGAGGTCAGGAGTTCAAGACCAGTGTGGTCAACATGGTGAAACCCCGACTCTACTAGAAATACAAAAAACTAGCTGGGCATGCTGACGCACACCTGTAATCCCAGCTACTCAGGAGGC"
"GL873525","33338359","33338414","chr1","137809650","137809704","22","104471291","GGGCAAGGTAGCTCACACCTGGAATCCTGGCACTCTACAAGCCAATGCTTCTAGAC","GGCCAGGGGCAGTAGCTCACGCCTGTAATCTCAGCACTTTAGAAGGCCAAGGAGG"
"GL873525","33338687","33338944","chr3","63678013","63678270","70","30339326","AATGCTTCTAGACTTAAAGTCAGGAGTTTGAAACCAGCCTGAGCAACAGTGAGATCCATCACTACTAAAAAGAGAAAAATTTGCCAGTGGTTGTGGCAGAGGCTTCTAGTCCCAGTATGTCAGGAGGCTGAGGCAGGAAGATCACTTGAAGCTACGAGTTTGAAGTTGCTGTGAATTAGGCTAACGCCATGGCCCTCTAGCCTGGGCAACAGAGTAGGACTCTGTTTCAAAACAAAACAAAAAAAAAAAGAAAGAAAA","CAGGCAGATCACCTGAGGTCAGGAATTTGAGATCAGCCTAGTCAACATGGTGAAACCCTGTGCCTACTAAAAATACAAAAATTAACCAAGTGTGGTGGCACACGCCTGTAGTCCCAGCTACTCAGGAGGCTGAGGTGGGAAGATCACTTGAACCTGGAAGATGGAGGCTGTAGTGAGCTGAGACTGTGCCACTGCACTCCAGCCTGGGTGACAGAGTGAGACTCCGTCTCAAACAAAACAAAACAAAAATAAAGAAAA"
"GL873525","33345321","33345627","chr11","56032052","56032370","86","22686731","GGCCAGGTGTGGTGGCTCACACCTATAATCTTAGCACTTGGGAGGCCAAGGCAGGTGGATTGCCTGAACTCATGAGTTTGAGACCAGTCTGACCAAGAGCAAGACTCCGTCTCTAAAAAATAGCCAGGTATTGTGGCAGGCGTCTATAGTCCTGGCTATTTGGGAGGCTGAGGCAAGAGAATTGCTTGAGCCCAAGAGTTTGAGGTTGCTGTGAGCTAAGACGCCATGGAACTGTACCGAAGGTAACCAAGTAAGACTCTGAGTCAATAAATAAATAAATAAATAAACTTTCCCTTAAAAAAAAAAA","GGCCGGGTGAGGTGGCTCACGCCTGTAATCCCAGCACTTTGGGAGGCCAAGGCGGGTGGATTACCTGAGGTCAGGAGTTTGAGACCAGCCTGGCCAACATGGTGAAACCCCGTCTCTACTAAAAATACAAAAATTAGCCAGGTGTGGTAGCACACGCCTGTAATCCCAGCTACTTGGGAGGCTGAGGCAGGAGAATTGCTTGAGCCCAGGAGGCGGAGGTTGCAGTGAGCCGAGATTGTGCCACTGCACTCCAGCCTAGCCGACAGAGTGAGATTCTGTCTCAAAAAAAAAAAAAAAAAGAAAAGAAAAAAAAAAAAAA"
"GL873525","34685957","34685999","chr5","63739362","63739402","13","29053405","GAGGCCAAGGTCGGTGGACTACCTGAGCTCAGGAGTTTGAGAC","AGGCCAAGGCTGTCAGATCACTTAAGGTCAGGAGTTCAAGA"
"GL873525","34863164","34863232","chr4","116689217","116689285","10","81826053","GGCCAGGCATGGTGGCTCGTGCCTGTAATCCCAGCACTCTGGGAGGCTGAGGTGAGCTGATTGCCTGAG","GGCTGGACGTGGTGGCTCATGCCTGTAATCCCAGCACTTTGGGAGGCCGAGGTGGGCGGATTACCTGAG"
"GL873525","40285069","40285164","chr6","28153994","28154075","31","12131075","CACAAAAAAAGATAGAATACTGCTGCTGCAGGGGCATGTGCCTATGGTCCCAGCTACTTGGGAGACTGAGGCAGGAGAATCCTATGAAGCCACGAG","AAAATTAGCCGGGTGTGGTGATGCATGCCTCTAATCCCAGCTACTTGGAAGGCTGAGGCAGGAGAATCACTTGAAGGCAGGA"
"GL873525","40547002","40547136","chr14","57165080","57165209","38","16618078","GGCCGGGTATGATAGCTCACACCTATAATTCTAGCACTCTAGGAAGCCCAGGTGGGAGAATCACCTTGAAGTCAGGAGTTACTGGCCAGCTTGACCCCATCTCTACTAAAAAAATAAAAAATAATTTAGCTGGAC","GGCCAGGTGCAGTGGCTCATGCTTGTAATCCCAGCACTTTGGGAGGCCAAGGTGGGCAGATCACCTGAAGTTGGGAGTTCGAGACCAGCTTGGCCACGTCTCTACTAAAAATGCAAAAAATTGGCCAGGC"
"GL873525","43783277","43783370","chr13","1958369","1958453","32","41824908","CAGGTGCAAGTGGCTCATGCCAATAATCCTACCACTTGGGGAGTATCACTTGAGGTCAGAAGTTAGGGACCGGTCTGAACAAGGCCAAGATCCC","GGCCGAGCTGCAGTGGCTCATGCCTGTAATCCCAGCACTTTGGGAGTGGATCACCGGAGATCAGAAGTTTGAGGCCGCAGGCCAA"
"GL873526","145641","145727","chr7","119887863","119887946","20","119742222","GCCAGGAGTGGTGGTTTATGCCTGTAATCCTTGCACTCTGGAAGGCCAAGGTGGGCAGATCACCTGAGCAAAAGCAAAACCCAGTCT","GGCCAGGTGTGGTGGCTCATGCCTGTAATCCCAGCACTTTGGAAGGACGAGGTGGGCAGATCACCTGAGGTCAAGAATTCAAGA"
"GL873526","401382","401451","chr1","22619342","22619410","10","22217960","GGCTGGGCGCAGTGGCTCACACCTGTAATCTCAGCACTCTGGGAGGCTGAGGTGGGCAGATCGCCTAAAT","GGCCGGGCGCGGTGGCTCACACCTGTAATCCCAGCACTTTGGGAGGCCGAGGTGGGCGGATCACCTGAG"
"GL873526","401684","401906","chr6","137468851","137469080","68","137067167","GCCTAAGCTCACAGGTTCGAGACCAGCCTAAGCAAGAGCAAGACTCTGTCTCTAAAAAATAGCCCAGTGTTGTGGCAGGTGCCTGTAGTCCCAGCTACTAGGGAGGCTGAGGCAAGAAAATCACTTGAGCCCAAGAGTCTGAGGTTGCTATGAGCTGTGACGTCATGGCACTCTACCATGGTTGACAAAATAAGACTCCATTTCTAAATAAAATAAAATAAAA","GATCATCTGAGGTCAGGAGTTCAAGACCAGCCTGGCCAACATGGTGAAACCCATCTCTACAAAAATTAGCCAGGCATGGTAGCACGTGCCTGTAATCCCAGCTACTCAGGAGGCTGAGACAGGAGAATCGCTTGAACCTGGGAGGCAGAGGTTGCAGTGAGCTAAGATCGCATCATTGCACTCTAGCCTGGGTAACAGAGTGAGACTCAGTCTCAACAAAAAACAAGAAA"
"GL873526","921834","921923","chr2","16373245","16373329","35","15451411","CATTTTTATTAAAGAGTAAAAATTGCTGAGTGTTATAGTGGCTCACACCTGAAATCCTCATGTTTTGGGAGGCCAAGGCAGGAGGATTGC","CTAGAAGTAAACAAAATAGTCTGGGGTTTGGTGGCTCATGCCTGTAATCCCAGCACTTTCGAAGTCTGAGGCGGATGGATCACTT"
"GL873526","3954210","3954342","chr7","18750820","18750952","34","14796610","GGCCAGGTACAGCGGCTCACTCCTATAATCCCAGCACTCTGGGAGACCAAGGTAGGCGGATAGTCTAAGTTCACAAGTTCGAGACCAGCCTGAGCTAAAGCAAGACCCTGTCTAAAAAATAGCCAGGTGTTAG","GGCCAGGCGTGGTGGCTCACACCTGTAATCCCAGCACTTTGGGAGGCCAAGGTAGGAGGATTACCTGAGGTCAGGAGTTCGAGACCAGCCTGACCAACATGGTGAAACCCTGTCTCTAAAAATACAAAAATTG"
"GL873526","3954636","3954787","chr7","137476596","137476751","42","133521960","CCGGGTATTATGGTGGGCACCTATAGTTGCAGCTGTTTGGGAGGCTGAGGCAAGAGAATTGCTTGACCCCAAGAGTCTGAGGTTGCTGTGAGTGCCATGGCACTCTACTGGCTACCAGGGTGACTGAGTGAGACTCTGTCTCAAAAAAAAAA","TCTGGGTATGGTGGCACGCACCTGTAATCCCAGCTACCTGGGAGGCTGAGCCAGGAGAATCACTTGAGCCCAGGAGGCGAAGGTTGCAGTGAGCTGAGATCGCACCACTGCAGTCCAGCCTGGGGGACAGAGTGAGACTCCATCTTAAAAAATAAA"
"GL873526","5852525","5852832","chr9","59926908","59927212","75","54074383","GGCTGGGCATGGTGGTTCACGCCTGTAATCCTAGCACTTGGAAGGCCCAGGCAGGTGGATTGCCTGAGCTCATGAGTTCAAGACCAACCTGAGCAAGAGCAGGACTCCATCTCTAAAAATAGCCAGGCACTGTGGTGGGTACCTGTAGTCCTAGCTACCTGGGAGGCTGAGGCAAGGGGATCACTTGAACCCAAGAGTTTGAAGTTGCTGTGAGCTAAGATGCCACAGCACTCTACCAAGGGTGACCAAGTGAGACTCCATTGCAAAAATAGATAGATAAATAAATAAATAAAATAAAATTAGAAAAA","GCTGGGCACGGTAGTTCAAGCCTGTAATCCCAGCACTTTGGGAGGCCAAGGCAGGCAGATCACCTGAGGTCAGGAGTTCAAGACCAACCTGGCCAACATGGTGAAATCCCGTCTCTACAAAAATTAGCTGGATGTGGTGGTGCACGCCTGTAATCCCAGCTACTCGGGAGGCTGAGGCAGGAGAATCGCTTGAACCCGAGAGGTGGAGGTTGCAGTGAGCCAAGATAGCACCATTGCACTCCAGCCTGGGTGAAAGAGTGAGATTCCATCTCAAAATAAATAAATAAATAAATAAATAAAATAAA"
"GL873526","5893647","5893789","chr4","31781264","31781420","44","25887617","TTAGCCAGCCTATAGTCCTAGCGACTCAGGAGGCTGAGGCAGGAAGATTATTGAACCCAGGAGTTGGAGGTTGCTGTGAGCTGGGCTGATGCCACAGGACTCTAGAGTAACACTCTTGTCTACAAAAATAAAAATAAAAAAAA","TTAGCCAGGGGCATAGTCCCAGCTACTCAGGAGGCTAAGGCAGGAGAATCCTTTGAACCCGGCAGGTAGAGGTTGCAGTCAGCCAAGATCATGCCACTGCACTCCAGCCTGGGGGACAGAGTGACACTCTGTCAATCAAAAAATAAAATAAAATAAA"
"GL873526","5894059","5894211","chr20","62305721","62305853","61","56411662","GGCTGGGGACGGTGGCTCACACCCATAATCCTAGCAGCTGAAGAGTTCAAGACCAGCCTGCACAACAAACAGCAAGACCCATCTCTACTAAAAACAGAAAAATTGGGAGGTATGGTGGTTAAAAAGAGGAAAGAAAAATTAGCCAGCTTGGGG","GCGGGCAGATCACCTGAGGTCAGGAGTTCAAGACCAGCCTGGACAACATGGCAAACCCCATCTCTATTAAAAATACAAAAATTAGCCAGGTGTGGTGGCACATGCCTGTAATTCCAGCTACTCAGTAAAGGCT"
"GL873526","6308709","6308832","chrX","117855294","117855417","26","111546585","GGCCAGGTACAGTTCTTCACACTTGTAATCCCAGCACTTTGTGAGGCATAGGCAGGAGGATCACATGGGGTCAGAAGTTTGAGACTAGCTTGGGCCTTATGGTGAGACTCTATCTCCACTAAAA","GGCCAGGCACAGTGGCTCACACCTGTAATCCCAGTACTTTGGGAGGCCGAGGCGGGCAGATCACCTGAGGTCAGGAGTTCAAGACCAGCCTGGCCAACATGGTGAAACTCTGTCTCTACTAAAA"
"GL873526","6545891","6545982","chr10","69524806","69524901","15","62978915","GGCCAGGCACGGTGACTCATGCCTGTAATTCCAGCACTCTGGGAGGTTGAGGAGGGTGGATCACCTGAACTCAGGAGTTTGAGACCAGCCTG","GCCAGGTGCGGTGACTCATGCCTATAATCCCAGCACTTTGGGAGGCTGAGGGGGGTGGATCACCTGACGTCAGGAGTTTGAGACCAGCCTGATAAA"
"GL873526","6650452","6650546","chr20","27926909","27926994","25","21276457","TGACCCCAAGAGTTGGAGGTTGCTGTGAGCAATGATGGCACAGCACTCTACTGAGGGTGACAAAGTGAGACTTTGTCTCCAAAAAAAAAAAAGAA","GGGAGTTGGAGGTTGCGGTGAGCCAAGATGGGCCACTGAACTCCAGCCTGTGACAGAGTGAGACTCTGTCTCCAAAAAAAAAAAAA"
"GL873526","6650821","6651012","chr8","30276832","30277039","56","23626011","GGCCAGGCGAGATGTCTCACGCCTGTAATCCTAGCACTCTAGGAAGCCAAGGCAGGTGGATATCCTGAGCTCACAGGTTCAAGACCAGCCTGAGCCAGACCTTGTCCCTCAAAATAGCCAAATGTTGTGGTGGGCACCTGTAATCCCAGCTACTTGGGAGGCTAAGGCAAGGGAATTGCTTGACGCCAAGAG","GCCAGGCGCGGTGGCTCACACCTGTAGTCCTAGCACTTTGGGAGGCCCAGGCAGGTGGATCACCTGAGATCCAGAGTTCAAGACCAGCCTGACCAACATGGTAAAACCTCGTCTCTACTAAAAATACAAAAATTAGCCGTGCGTGGTGGTGGGCGTCTGTAATCCCAGCTACTCCGGAGGCTAAGGCAGTAGAATCCCTTGAACTCAG"
"GL873526","6885453","6885760","chr6","8139368","8139683","82","1253915","GGCTGGGCTCAGGGGCTCACGCCTGTAATCCTGGCACTCTGGGAGGCCGAGGTGGGTGGAATGCCTGAACTCAGGAGTTCAAGACCAGCCTGAGCAAGAGCAGGGACCCTGTCTAAAAAACAGCCAGGCATTGTGGCGGGCATCTGTAATCCCAGGTACTTGGGAGGGGGAGGCAAGAGGATCACTTGAACCCAAGAGTTTGAGATTGCTGTGAGCTAAAATGCTACAACACTCTACCGATGATGACAAAGTGAGACTTTGTCTCAAAAAATAAATAAATAAATAAATAAAGAGAAAGAAAGAAAAGA","GGCCGGGTGCAGTGGCTCACACCTGTAATCCCAGCACTTTGGGAGGCTGAGGTGGGTGAATTACCTGAGGTCAGGAGTTCAAGTCCAGCCTGGCCAACGTGGTGAAATCCCATCTCTACTAAAAATACAAAAATTAGCCAAGCACGGTGGCATACACCTGTAGTCCCAGCTACTTGGGAGGCTGAGGCAAGAGAATCACTTGAACCCGAAGGACGGAGGTTGCAGTGAGCCGAAATCATGCCACTGCACTCCAGCCTGAGTGACAGAGCAAGACTCTGTCTCAAAAAAAAAAAAAAAAAAAAAAAAAAAAAAAAAA"
"GL873526","7268645","7268798","chr13","43952281","43952438","42","36683636","TAGCCAGTCATTGTGGCAGGCATCTATAATAGCCCCAGCTACTTGGGAGGCGGAGGCAAAAGAATTGCTTAACCCCAAGAGTTTGAAGTTGCTATGAGCTATGATGCCATAGCACTCTACCTAGGGTGGTGAGACTCTGTCTCAGAAAAAAAAA","TAGCCAGGCATTAGTGGCACACACCTATAATCCCAGCTACTTGGGAGGCTGAGGCAGGAGAATTGCTTGAACCAGGGAGGCAGAGGTTGCAGTGAGCCAAGATCGTGCCATTGCAGTCCAGCCTGGGCGACAGAGCAAAACTCTGTCTCAAAAAAAAA"
"GL873526","7269073","7269213","chr7","52682488","52682622","36","45413415","GGCCAGGCACAGTGGTTCATGCCTGTAATCCCAGCACCCCAGCACTCTGGGAGGCCGAGACGGGTGGATTGCCTGAGCTCAGAAATTCAAGACCAGCCTGAGCCGGAGTGAGACTTCTCTTGTCTAAAAATAGCCAGTCAT","GGCCGGGCACGGTGGCTCATGCCTGTAATCCCAGCACTTTGGGAGGCCGAGGCAGGTGGATTGCCTGAGTTCAGGAGTTCAAGACCAGCCTGGCCAACATGGTGAAACCCCGTCTCTACTAAAAATACAAAAATT"
"GL873526","7277244","7277257","chr1","184124271","184124281","3","176847027","TAAACACAAAAGAA","AAACCAAAAAA"
"GL873526","7277350","7277534","chr7","82655090","82655276","57","75377740","CGACCCCCTCATTTTTATTAAAAAAAAATTGGCCAGATGTCATGGTGGGCACCTGTTAGTCCCAGCTACTCAGGAGACTAAGGCAGGAAGATGGCTTCATCCCAGGAATTTTAGGTTATGGGCTAGGCTGTGGCACTCCAGCCTGAGGAACAAAGTGAAACTTTGTCTCAAAAAACACAAAAGAA","CCTATCTCTACTAAAGAGATAAAAATTAGCCAGGTGTGGTGGTGGGCACCTGTAATCCCAGCTACTCAGGAGGGTGAGGCAGGATAATTGCTTGAACCCAGCAGGCAAAGGCTGCAGTGAGCCGAGATCATGTCGCTGCACTCCATCCTGGGCGACAAAGTGAGACTGTGTCTCAAAAAAGGAAAAA"
"GL873526","7277803","7277897","chr11","51614343","51614439","32","44336540","GCCAGTAATCCTGGCACTCACAGAGGCTGATGGGGGGAAGATCACCTGAGATCAGGAGTTTGAAAGCAACCTGATACATAATGAGACCCCCTCTA","GCCTGTAATCCCAGCACTTTGGGAAGCCGAGGTGGGCGGATCACCTGAGGCCAGGAGTTTGAGACTAACCTAACCAACTTGGAGAAAGCCCGTGTCT"
"GL873526","7326035","7326210","chr3","87852891","87853064","55","80526856","GGCTGGGCGCAGTGGCTCAGGCCTATAATCCCAGCACTTTGGGAGACCAACATGAGTGGATCACCTAAACTCACAAGTTTACGACCAGCCAAGCTAGAGCTAGACCCCATCTCTAAAAATAGCTGGGCACTGCGGCAGGCACCTGTAGTCCCAGCTACTTCAGTCCCAGTTAGTCC","GGCTGGGTGCAGTGGCTCATGCCTGTAATCTCAGCACTTTGGGAGGCCAAGGTGGGTGGATTACCTGAGGTCAGGAGTTTGAGACCAGCCTGATCAATATGGTGAAACCCTGTCTCTACTAAAAATACAAAAATTAGCCAGGCATGGTGGTGCATGCCTGTAGTCCCAGCTACT"
"GL873526","7326232","7326357","chr3","127362778","127362910","38","120036546","TCCAGAGGGTGAAGCAAGAGACTCACTTGAGCCCAAGAGTTAGAGGTTGCTGTGGGCTTACGCCAAGGCACTAGTATAGCAGGGCAACAAAGTGAGACTCTGTTTCTAAATAAATAAATAAATAAA","CTCGAGAGTTTGAGGCAGGAGAATCGCTTGAACCCGGGAGACAGGGGTTGCAGTGAGCTGAGATCGCGCCACTGCACTCCAGCCTGGGCTACAGAGTGAGACTCCGTCTCAAAATAAATAAAAATAAAATAAA"
"GL873526","7387793","7387891","chr1","212121416","212121513","23","204733623","GCTTGAACCTGGGAGTCTGAGGTTGTTGTCAGCTAGGCTGATGCCATGGCACTCTGGCCTAGGCAACAGAATGTGACTGTCTCAAAAAAAAAAAAAAAA","CTTGAACCTGGGAGGTGGAGGTTGCAGTGAGCCAAGATCATGCCACTGCACTCCAGCCTGGGCAACAGAGCGAGATTCTGTCTCAAAAAAAAAAAAAA"
"GL873526","8727451","8727766","chr13","36506734","36507041","93","27779283","GAGTGGGGTGGCTCACACCTGCAATCCTAGCACTTGAGAGTCCAAGGCTGGTGGACTGCTTGAGGTCAGGAGTTCAAGACCAGCCTGAGCAAGAGCAAGATCCCATTTCTACTAAAAGTAGATAGGAAAAAGAAAAAACTAGCCAGGAGTTGTGGCAGTGCCTATAACCCCAGCTACTCAGGAGGCTGAAGTGAGAAGATCTCTTCAAGAATTTCAGGTTGCTGTGAGCTATGACACCCGAGCACTCTAACAGGATGACAGAGTGAGACTCTCTCAAAACAAACAAACAAACAAAAAAACTCCAAAAAGGAAGAGA","GGCGTGGTGGCTCACGCCTGTAATCCCAGCACTTTGGGAGGCCAAGGCGGGCAGATCACCTGAGGTCAGGAGTTCAAGACCAGCCTGGCCAAAATGGCAAAACCCCATCTCTACTTTAAAAAAAAAAAAATTAGCCAGCATGGTGGCACATGTTTGTAATCCCAGCTACTCAGGAGGCTGAGGCAGGAGAATCGCTTGAACTTGGTAGGTAGAGGTTGCAATGACCTGAGATCTCACCATTGCACTCCAGCCTGGGCGACAGAGTGAGACTCCATCTCAAAAAAAAAAAAAAAAAAAAAAAAAACAAA"
"GL873526","8840355","8840484","chr14","103189930","103190058","38","94349575","GGCACGGTGGCTCACATCTACAATCCCAGCACTCTGGGAGGCCAAAGCGGGCCATCCAGATCACCTGAGCACACAGGTTGGCGACCAGCCTGAGCTAGAGTAAAACCTCTGCCTCTAAAAATAGCCGGTC","CTGGGCACGATGGTTCACACCTGTAATCCCAGCACTCTGGGAGGGCCAAGGCGGGCAGATCACCTGAGGTCAAGAGTTTGAGACCAGCCTGGCCAAAATGGTAAAACTCTGTCTCTATTGAAAATAGAA"
"GL873526","8840762","8840942","chr7","17638564","17638743","44","8797802","TAAAAATAGGAATAGCTGATTGTCATGGAGGGTGCCTGTAATCCCAGCTACTCGGGAGACTGAGGCAAGAGAATTGCTTAAGCCCAGGAGTCTGAGGTTGCTGGGAGTTATGACGCCAGGGCACTCTACTGGGGGCAACAAAGTGAGACTCTATCTCAAAAAACAAAACAAAACAAAACAA","ACAAAAAGTAGCTGTCCATGGTGGTGGGTGCCTGTGATCCCAGCTACTCGGGAGGCTGAGGCAGTAGAATTGCTTGAACCCAGGAGGCGGAGGTTGCTGTGAGCCGAGATTGCGCCACTGCACTCTAGCCTGGGCGACAAGAGCGAAACTCCATCTCAAAAAAAAAAAAAAAAAAAAAAA"
"GL873526","13539653","13539804","chr9","45697841","45697986","38","32158188","GGGTGGGGTTGCTCACACTTGTAATCCCAGCAGTTTGGGAGGTCAAAGCAGGAGGATCACCTGAGAACAAGAGTTTGAGATAACCCCCAGCCAACACAGGGAGACTCTGTCCTACCAAAACAATTCAAAAAATTAGCTGGTCATGGTGGTGC","GGTGTGGTGGCTAACGCCTGTAATCTCAGCACTTTGGGAGGTGGAGGTGGGTGGATCACCTGAGGTCAGGAGTTTGAGACCATCCTGGCCAACACGGTGAAACCCTGTCTCTAATAAAAATACAAAAAATTAGCTGGGTGTGGTGG"
"GL873526","17092797","17093005","chr1","110097662","110097873","48","93004865","GCTGGGCCCAGTGGCTCACACCTGTAATCCTAGCACTCTGGAAGGCTGAAGTGGGTGGATTGCCTGAGTTCAGGAGTTCGAGACCAGACTGAGTGAGAGTGAGACCCCATCGCTACTAAAAATAGAAAAAGCAGCCAGGGGTTGTGGAGCGCACCTATAATCTCAGCTATTTGGGAGGCTGAGGCAAGGGGATTGCCTGAGCCTGAGAG","GGCCGGTCGTGGTGGCTCACACCTGTAACCCCAGCACTTTGGGAGGCTGCAGTGGGTGGATCATCTGAGGTCAGGAGTTCGAGACCAGCCTGGGCAACATGGTGAAACCCCATTTCTACTAAAAATACAAAATTAGCTGGGCGTGGTGGCGCGTGCCTGTAGTCCCAGCTATTTGGGAGGCTGAGGCAGGAGAATTGCTTGAAACCGGGAGG"
"GL873526","17445334","17445439","chr5","18707685","18707794","36","1262351","TAGCCCACTTTGTAATCCAAGCACTTTGGGAACATCACTTAAGGTTAGGAGTTTGAGACCAGTCTGGGCAACATGAATCGTACAAAAATTTTAAAAAATACAAAAA","TCACACCTGTAATCCTAGCTGAGGCTGAGGGGGGCTGATCACTTGAGGTCAGGAGTTTGAGACCACCCTGGCCAACATGGTGAAACCCTGTCTCTACTAAAAATACAAAA"
"GL873526","20495803","20495883","chr9","93194085","93194171","16","72698282","GGCTGGGCGGCTCACTCTGTAATCCTAGCACTCTAGGAGGCCGAGGCAGGTAGATCACCTGAGTTCAAGAGTTCAAGACCA","GGCCGAGCATGGTGGCTCACACCTGTAATCCCAGCACTTTGGGAGGCTGAGGCAGGTGGATTACCTGAGGTCAAGAGTTCAAGACCA"
"GL873526","26237170","26237281","chr10","28376735","28376843","26","2139565","AGGAGAGTCATTTGAATCCAGTAGTTGGAGGTTGCAGCGCCCTAGCTTGTGCCACTGCATTCCAGCCAGAGCAGCAGAGCAAGACTGTCTCAAAACAACAACAAAAAAAAAA","AGAATCACTTGAACCCAAGAAGTGGAGGTTGCAGTGAGCCCAAATTGTGCCACTGTACTCCAGCCTGGGCTACAGAGCAAGACTCCGTCTCAAAAGAAAAAAAAAAAAA"
"GL873526","26495215","26495337","chr19","11392404","11392528","25","15102811","GATGGTTCATGTCTGTAATCCTAGCACTCTGGGAGGCCAAGGCTGGTGGATCCCTTGACCTCAGGAGTTTGAGACCAGCCTGAGCAAGAGCGAGACCGTTTCTCTATTAAAAATAGAAAAATT","GTGGTTCATGCTTGTAATCCCAGCACTTTGGGAGGCTGAGGCAGGTGGATCACCTGAGATCAGGAGTTTGAGACCAGCCTGGCCAACATGACAAAACCCTGTCTCTACTAAAAATACAACAATTA"
"GL873526","26495614","26495801","chr7","125488868","125489055","43","98993254","GAAAGAAAAGAAGAAAAATTAGCTGGGCACTGTGGTGGGCACCTGTAGTCCCAGCTAATTGGGAGGCTGAGGCAAGAGGATAGCCTGAACCCAGGAGTTGGAGGTTGCTGTGAGGTAGGCTGATATCAGGGCACTCTAGTCTTGGTGACAGGGCCAGACTCTGTCTCAAAAAACAGAACAAAACAAAA","TCTACTAAAAATACAAAAATTAGCTGGCATGGTGGCAGGCACCTGTAGTCCCAGCTACTTGGGAGGCTGAGGCAGGAGAATTGCTTGAAGCCGGGAGGTGGAGGTTGCAGTGAGCTGAGATCACACCACTGCACGCCAGCCTGGGTGACAGAGCGAGACTCTGTCTCAATAAACAAATAAATAATAAA"
"GL873526","28522166","28522337","chr3","175721959","175722096","68","147199793","GGCTGGGCATGGTGGCTCAACTTGAGGCCAAGTTCAGTGGATCACCTGAGCTCTAGAGGTTTGAGACCAGCATAAAGCCGGCATGAACCAGAGTGAGCCAGAGTGAGACCCCCATCTCTACCAAGCACCTGTAATTCCAGCTACATGAAAGGCAAAGGGCAAGAGAATTGCT","GGCCAGGCGTGGTGGCTCCTAGCACTTTGGAAGGCCAAGGCAGGTGGATCACCTGAGGTCAGGAGTTTGAGACCAGCCTAGCCAACATGGCGAAACCCCGTCTCTACTAAAAATACAAATATTAGCTGGGCGTGGCAT"
"GL873526","40937384","40937544","chr2","188225310","188225477","39","147287926","AGCTGGGCGCAGTGGCTCATGCCTGTAATCCTAGCCCTCTGAGAGGCTGAGGCAGGAGTTGGAATACAGGAACCTGAGGTTGCTGTGAGCCGTGATGACACAACAGTACTCTAGCCTGGGGCAACAGAGTGAGAGTCTGTCTCAAAAAAAAAAAAAACAAA","TTTAGCCAGGCGTTGTGGTGGTGCATGCCTGTAATCCCAGCTACTCAGGAGGCTGAGGCAGGAGAATCGATTGAACCAGGAGGCAGAGGTTGCAGTGAGCCGAGATCAGCCACTGCACTCTAGCCTGGGCAACAGAGTGAGACTCCATCTCAAAAAAAAAAAAAAAAA"
"GL873527","7744688","7744813","chr8","84681685","84681808","26","76936997","GGCCAGGCATGGTGGCTCATGCCTGTAACCCAGCACTCTGGGAGGCTGAGGTGGGTGGATTGCCTGAGCTCACGGATTTGAAACCAGCCTGAGCCAGAGCAAGACCCCGTATCTAAAAATAACCAG","GGCCAGGCATGGTGGCTCATGCCTGTAATCCCAGCACTTTGGGAGGCTAAGGAGGGTGGATCACCTGAGGTCAGGAGCTGAAGACCAGCCTGGCCAATATGGAGAAACCCCGTCTCTACTAAAA"
"GL873527","7745077","7745151","chr17","59852982","59853058","18","52107905","TAAAAATAGCTGGGTGTTGTGGCGGGTGCCTGTAATCCCAGCTTCTTGGGAAGCTGAGACAAGAGAATCACTTGA","CCAAACATTAGCTGGGTGTGGTGGCACGAGCCTGTAATCCTAGCTACCTGTGGACAGAGGCAGGAGAATCACTTGAA"
"GL873527","10550549","10550782","chr19","43353991","43354220","73","32803442","TAAAAAAGAGACCAGCCTGAACAGCAGCAAGACCCCAGCTCTACTAAAAAATAGAAAAACTAGCTGATGTGGTGGTAGCCTAGCGGTGGTGGATAATCCCAGCTATTTGAGAGGCTGAAGCAGGAGGATCTCTTGAGCCCAAAAGTTTAAGGTTGCCATGAACTATGGCACTAGGGCACTCTACTGAGGGTGACAAAGTGAGACTCTGTCTCAAAAAAATAAATAATAAAACAA","TTCGAGACCAGCCTGGCCAACATGGCAAAACCTCATGTCTACTAAAAATACAAAAATTAGTCAGGTGTGGTGGGAGGCACCTGTAATCCCAGTTACTCTAGAGGCTGAGGTAGGAGAATCGCTTGAACCCAGGAGATGGATGTTGCAGTGAGCTGAGACCAGACCACTGCACTCCAGCCTGGGTGACAGAGTGAGACTTCATCTCAAAAATAAAAAATAAAATAAAAAAA"
"GL873527","10551014","10551093","chr8","20660648","20660717","26","10109634","TCACAACTGTAATCCTGGTATTCTGGGAGGCGAGGCAGGTGGATAGCCTGAGTTCAGGAGTTTGATCAAGACCAGCCTGA","CTGTAGTCCCAGCACTTTGGGAGGCTGAGGCAGGTGGATCCTTTGAGGGCAGAACTTTAAGACCAGCCTG"
"GL873527","10823138","10823154","chr5","107531112","107531127","2","96707974","AAAAAAAAAAAAAGAAA","AAAAAAAAAAGAAAAA"
"GL873527","10823249","10823529","chr2","152176676","152176948","83","141353427","GGTGACTTATGCCTATAATCCTAGCACTACGGGAGGCCAACACCGGAGGAGGCCAACATGGGAGGATTGAATGAGGTCAGAAGTTTGAGACCAGCCTTAGTAAATTGAGATCCTGTCTCTACTAAAAATATAAAAATTAGCCTAGTGTTGTGGCGGGCACCTGTCCCAGCTATTTGGGAGGCTGAGGCAAGAGACTTGCATGAACCCAGGAGCGTGAGGTTACTGTGAGCTAGATTGAGACTGTGGAACTCTAGCCAGGTGACAAAGAAAGACTCTGTCTT","GGTGACTCACTCCTGCAATCCCAGTACTTTGGGAGGCCGAGGCAGGTGCATCACCTGAGGTCAGGAGTTTGAGACCAGCCCGACCTATATGGTGAAACCCTGTCTCTACTAAAAATACAAAAATTAGCTGAGTGTGGTGGCATGCACCTGTAACCCTAGGAACTTGGGAGGCAGAGACAGGAGAATTGCTTGAACCTGGGAGGTGGAGGTTGCAGTGAGCCATGATCACATCACTTCACTCCAGCCTGGGTGACAGAGTGAGACTCTGTCTCA"
"GL873527","11294760","11294879","chr14","48582927","48583045","23","37288167","GGCTGGGTGTGGTGGCTCATGCCTATAATCCTAGCACTCTGGGATGCCAAGGCCAGTGGATCTCCTGAGCTCAGGAGTTTAAAACCAGCCTGAGCAGGAGTGAGACCTGGTCTCTACTTA","GGCTGGGTGTGGTGGCTCACACCTGTAATCCTAGCACTTTGGGATGCAAGGCAGGCGGATCACCTGAGGTCAGGAGTTCCAGACCAGCCTGGTAAACATGGTGAAACCTCGTCTCTACT"
"GL873527","11294910","11295082","chrX","91803533","91803709","45","80508623","TAGCCAGGCATAGTGTCAGGTGCCTGTACTCTTCGCTACTCAGGAGGCTGAGGCAGGAGGACCACTTGAACCAGGAGACTGAGGTTGCTATGACCTTTAACGCAATGGCACTCTACCCACAGCTCACAGTGAGACTCTGTCTCAAAAAAAAGAAAGAAAGAAAGAAAGAAAGA","TTAGCTGGGCGTGGTGGTACATGCCTGTAATCCCAGCTACTCGGGAGGCTGAGGCAGGAAAATCACTCGAACCCAGGAGACAGAGGTTGCAGTGAGCCAGGATCGCACCACTGCACTCCAGCCTGGGCGACAGTGAGGCTCTGTCTCAAAAAAAAAAAAAAAAAAAGAAAAAAGAAA"
"GL873527","11937493","11937718","chr1","23379912","23380121","76","11442419","CTTTCCTAGCACTTTGGGAGGCAGAGCTGGGTGGATTGCTTGAGCTTAGGAATTCCAGACTATCCTGTCCAAGTGTGAGATCCCCATCTCTAGTAAAAATAGAAAAAGTAGCCAGTATTGTGGTGGCCAAGCCAGGTGGCTCAAACCTGTAATCCTAGCACTCAGGGAGGCCCGGGTCGGCCCATTGCTTGAGCTCAGGAGTTCAAGAGCAGCCTGAGCACGGGAT","ATTCCAGCACTTTGGGAGGCCAAGGTGGGAGGATCACCTGAGGTCAGGAGTTCGAGACCAGCCTGGCCAACATGGCAAAACCCCGTCTCTACTAAAAACATAAAAATTTAGCTGGGCGTGGTGGCGTGCACCTGTGATCCCAGCTACTCGGGAGGCTGAGGCAGGAGAATCACTTGAACCAGGAGGCAGAGGATGCAGGAAGCGGAGATC"
"GL873527","11937994","11938030","chr9","20539941","20539980","12","8601947","GGGTACAGTGGCTCACCCCTGTAATACTAGCACTTCG","GGCCAGGCGCTTTGGCTCACGCCTGTAATCACAGCACTTG"
"GL873527","12924251","12924348","chr1","7996796","7996891","21","4927455","GGCTGGGCAAAGGGGCTCATGCCTGCCATCCTAGCACTCTGAGAAGCTGATGGAGGGGGATTACATGATGTTAGGAGGTTGAGACCAGCCTGAAGCCA","GGCCTGGGCCCAGTGGCTCATGCCTGTAATCCCAGCACTTTGGAAGCCAAGGTGGGCAGATCACCTGATGTCAGGAGTTTGAGACCAGCCTGGCCA"
"GL873527","16494805","16494933","chr3","500432","500562","25","15994373","GCAGGGGCTTACACCTGTAAACCTAGCACTCTGGGAGGCTGAGACAGGAGGATCCCTTGAGCTCAGGAGTTCTAGATCAGCATGACCAAGAGCAAAACCCTGTTTCTACTAAAAATAGAAAAAATTATG","GCACGGAGGCTCATACCTGTAATCCCAGCACTTTGGGAGGCTGAGGCAGGTGGATCACCTGAGGTCAGGAGTTCCAGACCAGCCTGGCCAACATGGCGAAACCCTGTCTCTACTAAAAATACAAAAAATCT"
"GL873527","16495237","16495399","chr19","666223","666388","41","15829014","GTTAGTGGGGTATTGTAGCAGGCAACTGTAGTCCCAGCTACTCAGGAGGCTGAGGCAGAAGGACTGCTCAAACCCAGAAGTCGGAGGTTGCTGGGGGGCTAGGATGATGCCATGGCACTCTAACCTAGACAACAGAGTGAGACTTTGGCTCAAAAAAAAAAAA","TTAGCCGGGCGTGGTGGTGTGCACCTGTGATCCCAGCCACTCAGGAGGCTGAGGCAGGAGAACTGCTTGAACCCAGAGGTGGAGGTTGCAGTGGGCAAAGATCACGCCACTGCACTCCAGCCTGGGCAACAGAGTGAGACTCTGTCTCAAAAAAAAACCAAAAAAA"
"GL873527","17550151","17550221","chr4","19836869","19836946","24","2286718","GAGTTTGAGGTTGCTGTGAGCTATGACGTCAAGGCACTCTACCCAGGACACAGAGTGAGACTTAGACTCAA","GGGAGGTAGAGGTTGCAGTGAGCCAAGATCACGCCATTGCACTCTAGCCTGGGCTCAGAGCGAGACTCCATGTCAAAA"
"GL873527","17550493","17550599","chr14","110073522","110073623","36","92523029","AAAAAATACTAGCCAGGCACAGTGGCAGGCTTCTGTAGTCCCAGCTACTTGGGAAGTTGAGGGAAGAGAATTGTTCAAGCCCTCAAGAATGTGAGGTTAGGCGGTTA","CGAAAAGTAGCCAGGGGTGGTGGTACTGCCTGTAATCCCAGCTACTTGGGAGGTTGAGGCAGAAGAATTGCTTGAACCCGGGAGGCTGAGGTGGCAGCGAGC"
"GL873527","17550817","17550955","chr1","24106685","24106821","32","6555868","GGCCAGATATGGTGGCTCACACCTGTAATCCTAACACTGTGGGATGCCCAGGGAGGTGGATCACCTGAGCTCAGAAGTTCGAGATCAGCCTGAGCAAGAGTGAGTCCTTGATGCTACTAAAAATAAAATTTTTAAAAAA","GGCCGGGCATGGTGGCTCACGCCTGTAATCCCAACACTTTGGGAGGCTGAGGCGGATAGATCACCTGAGGTCAGGAGTTTGAGACCAGCCTGGCCCACATGGTGAAGTCCCTTCTGTACTAAAAATAATTTTAAAAA"
"GL873527","21739366","21739465","chr2","51286276","51286376","39","29546910","GGGCTGGTACAGCGACTCACATGTATAATCCTGGGAGGCTGAGCCAGGAGGGTCCCCCTCGCACAGGAGTTCAAGACCAACAAGAGTGAGACCCCCCCCA","GGCTGGGTGCAGTGGCTCACGCCTATAATCCCAGCACTTCGGGAGGCTGAGGCAGGCAGGTCACCTGAGGCCAGGAGTTCAAGACCAGCCTGGCCAACATG"
"GL873527","21739746","21739881","chr16","50778244","50778355","49","29038498","AGAGAATGAGACCCCATCTCTACTAAAAATAAATTAGCTGGGCTAATTATGGTAGACACCTGTAGTGTACACTACTCGGGAGGCTGAGTTAGGAGGATCACTTGAACTCAGGAATTGGAGGTTCCTGAGAACCTAG","AAAATAAACCACAAAAATTAGCTGGGCATGGTGGCATGCACCTGTAGCCCCAGCTACTCCGGAGCCTAAGTCAGGAGAAGCTCTTGAACCCAGGAGGTAGAGATTGCAGTGA"
"GL873527","21860590","21860725","chr1","29437872","29437991","30","7577282","GGCCGGGCGTGGTGGCTCACGCCTGTAGTCCCAGCGCTATGGGAGGCCAAGGCGGGTGGATCACCTGTGCTCAGAGGTTCGAGACCAGCCAAGACCCCCCTGAGCCAAATGAGCCAGAGTGAGACCCCATCTCTAC","GGCCGGGCGTGGTGGCTCACGCCTGTAATCCCAACATTTTGGGAGGCCAAGGCGGGTGGATCACCTGAGGTCAGAAGTTCGAGACCAACCTGGCCAACATGGTGAAACCCCTGTCTCTAC"
"GL873527","29086687","29086889","chrX","69103933","69104121","69","40017246","GTCTCCAATAAAGAAATAAGGCTCAGGTCACGCACGGTGGCTCATCCTTGTAATCCTACCACTCTAGAGACTGACGTGGAAGGATCACTTGAGGTTAGGAGTTTAAAATTGCTGTGTGGTAGGACGAGGCTGTGGAACTTGAGCCTGTGCAACAGAGTAAGACTCTGTCACAAAAATTTAAAAAAAAGAAAGATAGAAAAAAA","ATACACAAAATTAGACGGTCATGGTGGCACATGCCTGTAATCCCAGCTACTCAGGAGACTGAGGAAGGAGAATCACTTGAACCCAGGAGGCAGAGGTTGCGGCGAGCCGAGATGACGCCATTGTACTCCAGCCTGGGCAACAGAGCGAGACTCTGTCTCAAAAAAAAAGAAAAGAAAAGAAAAAGAAAA"
"GL873527","32955361","32955615","chr4","31351771","31352043","67","1603590","CTGTAATCCCAGCACTTGGGAGGCCAAGGCAGGTAGATTGCCTGAGCTTAAGGGTTCGAGACCAGCCTGAGCAAGTGTGAGACCCTATCTCCAAAAAATAGCCAGGTGTTGTGGCGGGCACCTGTAGTCCTACCTACACAGGAGGCTGAGGCAAGAGAATCACTTGAACCCAAGAGTTTGAGGTTGCTGTGAGCTAAGACACCATGGCACTCTACCGAGGGTGATCAAGTAAGACTCTCTCAAAAAATAAAAATA","CTGTAATCTCAGCACTTTGGGAGGCTAAGGCAGGCAGATCACCTGAGGTCAGGAGTTCGAGACCAGCCAGCCAACATGGTGAAACCCCGTATCTACTAAAAATACAAAAATTAGCCAGGTGTGGTGGTGCGCCTGTAATCCCAGCTACCCAGGAGCCTGAGGCCGGAGAATCACTGGAACCCGGGAGGTAGAGGCTGCAGTGAGCTGAGATCACGCCACTGCACTCCATCCTGGGTGACAGAGTGAGACTCCATCTCAAAAGACAAAAAAAGA"
"GL873527","32955905","32955923","chr1","123983819","123983835","4","91027914","CAAAGAAAGAATAAAAGAA","CACAGAACAATAAAAAA"
"GL873527","39618640","39618919","chr9","29302144","29302442","88","10316496","GACCAGGCGGGTGGCTCACACCTGTAATTCATCCACTCTGGGATGTGAAAGGATTACCTAAGGTCAGGATTTGAAGTTAGAGAACTCACCAAAAGCAAGACCCCATCTCTACTGAAAGTAGAAAAATTAGCTCACTATGGCATGCCACCTGTAGTCCCAGCTACTCCAGAGGCTGAGGCAGGATGATTGACCCCAGGAGTTTGGGAGTTGCTGAGAGTTGAGCTGAGGCCAGAGTGACAGAGGGAGACTCAATTTCTCTCTCTCTCAAAAAAAAAAAAAA","GACCAGGCGTGGTGGCTCACACCTGTAATTCCAGCACTTTGGGAGGCTAAGGTGGGTGGATCACCTGAGGTCAGGAGTTCAAGATCAGCCTGGCCAACATGGAGAAACCCCATCTGTACTAAAAATACAAACATTAGCTAAGCATGGTGGGACACGCCTGTAATCCCAGCTACTCGGGAGGCTGAGGCAGGAGAATCACTTGAACCAGGAGGTGGAGGTTGCAGTGAGCAGAGATCACACCACTGCACTCCAGCCTGGGTGACAGAGCAAGACTCTGTCTCAAAAACAAAACAAAAAAA"
"GL873528","340621","340775","chr1","93004888","93005049","36","92664267","ACTAATTGGGTGTTGTGGCGGGTACCTGTAGTCCCAGCTACTTAGGAGGCTGAGGCAAGAAGATCACTTGAACCCAGGAGTTGGAGATTGCTGTGAGCTATGATGACATGGCCCTTTACTGAGGGTGATAAACTGAGACTCTATCTCAAAAAAAA","TTGGATGGGTGTGGTGGCGTGCACCTGTAGTCCCAGCTACTCAGGAGGCAGAGGCCTGAAAATCACTTGAACCCAGGAGGCGGAGGTTGCAGTGAGCCAAGATAGCACCATTGCACTCCACCGTGGGTGACAGAGTGAGACTCTATCTCAAAAAAAAAAAAA"
"GL873528","340815","340928","chr10","67341428","67341546","27","67000613","GCTGGGCACAGTGGGTCATGGCTGTAATTCTAGCACTCTGACAGGCCAAGATGGGTGGATTGCCTAAGGTCAGGAATTGGAGACCACCCTGAGCAAGAACAAGACCCCATCTCT","GGCTGGGTGTAGTGGCTCATGCCTGTAATCCCAGCACTTTAGGAGGCCAAGGTGGATGGATTGCCTGAGCTCAGGAGTTCGAGACCACCCTGGGCAACAAGCCAAAACCCTGTCTCTAC"
"GL873528","968570","968713","chrX","147148421","147148562","29","146179851","GGCTGGGCACAATGGCTCACATTTGTAATCCTAGCACTCTGGGAGACTGAGGCAGGCGATTCACTTGAGGTTAGGAGTTCAAGACCAGCTTGAACTACAAACAGTAAGACCCTGTCTGTACTAAAAATGAAAAAAGTTAGCTAG","GGCTGGGCACGGTGGCTCACACCTGTAATCCTCGCACTTTGGGAGGCCGAGGCGGGCAGGTCACTTGAGGTCAGGAGTTCAAGAGCAGCCTAGCCAACATGGTGAAACCCCTGTCTCTACTAAAAATACAAAAGTTAGCCAG"
"GL873528","968979","969119","chr6","21723751","21723889","39","20754772","TTAGCTAGGCATCATGGCAGGAGGATAGGAGGATCACTTGTACCCAGGAGTTTGAGGTTGTTGGGAGCTAGGTTGACACTATAGCACTTTAGCCTAGGCAACAGAGTAAGACTCTGTCTCCAAAAAAAAAAAAAGTAAAAA","TTCCAGCTACGCAGGAGGCTGAGGCAGGAGAATCGCTGGAGCCAGGGAGGCAGAGGTTGCAGTGAGCCCAGATCACGCCACTGCACTCCAGCCTGGGCAACAGAGTGAGACTCTGTCTCCAAAAAAAAGAAGAAAAAAA"
"GL873528","2059845","2060163","chr2","56893700","56894034","83","54833855","GGCTGGGTATGCTGGCTCACGCCTACAGTCCTAGCACTCTGGGAGGCCAAGGCAGGAGGACTGCTTGAGGTCAGGAGGTTGAGACCAGCCTAAGTAAAGTGAGATTCCATCTGTACTAAAAATAGAAACATTAGCTGAGCATGGTGGTGGGCACCTACAATTCCAGCTGGAGGCCAAGGCAGGAATATAGCTTGAGTCCAGGAGTTTGAGGTCGCTATGAGCTAGGCTGAAGCCATGGCACAATAGCCTGGGTGGCAGAGCAAGACTCACTCTCAATAAATAAATAAAGAAATAAATAAACAAAATAAAAATAAAACAA","GACCGGGCGCGATGGCTCATGCCTGTAATCCCAGCACTCTGGGAGGCCAAGGCAGGTAGATCACCTGAGGTCAGGAGTTCGAGACCAGCCTGGTCAACATGGTGAAACCCCATCTCTACCAAAAATACAAAAATTAGCTGGATGTGGTGGCGCATGCCTGTAATCCCAGCTACTCAGGAGGCTGAGGCAGGAGAATTGCTTGAATCCAGGAGGCGGAGGTTGCAGTGAGCCAAGATTGCACCACTGCACTCCAGCCTGGGTGACAGAGCAAGACTCCCTCTCAAAAATAAATAAATAAATAAATAAATAAATAAATAAATAAATAAATAAATAAA"
"GL873528","3402696","3402969","chr9","140728","140998","72","3261968","GGCCAGGCCCAGTGGCTCACACCTGTAATCCCAGCACTTTGGGAGGCCGAGGTGGGCAGATTGACTGAACTCACAGGTTCAAGACTAGCCTGACCTAGAGCCAGACCCCATCTCTAAAACTAGCTGGGCATTGTGGTGAGCGCCTATAGTCCCAGCTACTTGGGAGGCTGAGCCAAGAGAATTGCTTGATCCCAAAAGTTAGAGGTTGCTGTGGGCTATGACACCAGGGCACTCTAGTGGGGGCAATAAAGTGAGACTCTTCCCCCCCAAAAAA","GGCTGGGCGCAGTGGCTCACGCCTGTAATCCCAGCACTTTGGGAGGCCGAGGTGGGCAGATCAGCTGAGGTCAGGAGTTCAAGACTAGCCTGACCAACATGGTGAAACCCCATCTCTACTAAAAATACAAAAATTGGCCAGCACCTGTAGTCCCAGTTTGGGAGGCTGAGGCAGGAGAATCACTTGAACCCAGGAGGCAGAGGTTGCAGTGAGCTAAGATCATGCCACTGTGCTCCAGCCTGGACAACAGAGTGAGATTACATCTCAAAAA"
"GL873528","5067749","5067835","chr15","17758338","17758422","15","12690589","GGCTGGGCGCAGTGGCTCACACCTGCAATCCCAGCACTTTGAGTGGCCAAGGTGGGAGGATCAGCTGAAGGCAGGAGTTTAAGAACA","GGCCGGGCGCAGTGGCCCACGCCTGTAATCCCAGCACTTTTTGAGGCCAAGGTGGGCAGATCACCTGAGGCTAGGAGTTTGAGAC"
"GL873528","7296122","7296295","chr4","87013233","87013406","44","79717111","GGGTGTGAGGTGGCTTACACTTGTGATCCTAGCACTCTGGGAGGCTGAGGTGGGAGGATCGCTTGAACCGGGGAATCGGAGGTTGCCATGAGCTAAGCTGATGCCGTGAGACTCTACCCTGGGGCAACAGAGTGAGACTCTGTTTGGAAAAAAAAAAAGAAAAGAAAAGGAGAA","ATTAGCGGGGTGTGGTGGTGTACGCCTGTAATCCCAGCTACTCAGGGGACTGAGGTGGGAGAATCGCTTGAACCTGGGAGGCAGAGGTTGCAATGAGCCAAGATCACTCCACTGCACTCCAGCCTGGGCAACAGAGTGGGACTCCATCTCAAAAAAAAAAAAAAAAAAAGGAAA"
"GL873528","9815890","9816026","chr1","31641123","31641242","37","21825233","GGCCGGGCGTGATGGCTCACGCCTGTAGTTCCAGCGCTATGGGAGGCCGAGATGGGTGGATCACCTGTGCTATGAGGTTTGAGACCAGCCAAGACCCCACCTGAGCCAAATGAGCCAGAGTGAGACCCCGTCTCTAC","GGCCAGGCACGGCGGCTCACGCCTGTAATCCCAGCACTTTGGGAGGCCGAGACGGGTGGATCACCTGAGGTCAGGAGTTTGAGACCAGCCTGGCCAATGTGGCAAAACCCCGTGTCTACT"
"GL873528","12850029","12850126","chrX","89474516","89474603","40","76624487","TACAAATTTTTTTTTTTTTAAATGAGCTAACCATGGTGGTACCTTGCAGTACTAGATACTCCAGAGGCTAAAGCAAGAGAACCGTATGAACCCCAGAG","GAAAAATTAGCTGAGCATGGTGGCATGTGCCTGAAGTCCCAGCTACTCAGGAGGCTGAGGCATGAGTATCGCTTGAACCCCAGAGGCG"
"GL873528","12850221","12850342","chr7","136457677","136457792","34","123607456","GGCTGGGCCCAGGAACTCACATCTATAGTTCCAGCACCTTCGGAGGCTGAGTCAGGAGAACAGCTTCAGGTCAGGAGTTTGAGATGAACTTGAGCAACACAGTAAGACCCTATATCTACTTT","GGCTGGGCGTGACTCACGCCTGTAATCCCAGCACTTTGGGAGGCTGAGGCGGGCAGATCACCTGAGGTCAGGAGTTTGAGACCAGACTGACCAACATAACAAAACCATGTCTCTAC"
"GL873528","13635143","13635464","chr8","96661655","96661960","83","83026512","GGGTGGGTACAGAGGCTCATCCCTGTAATCCTGTCACTTTGGGAGGCCAAGGTGGGTGAATCCCCTGAGATCAGGAGTTCAAAACCAGCCTGAGCAAGAGACAGATCTTTTCTCTACTAAAAATAGAAAAAAAATCTAGCCAGGCATTGTGAGAGGTGCCTGTCACAAGCTACTTGGGAGGCTGAGGCGGGAGAATAGCTTGAACCTAGGAATTAGCTGTGAGCTATGACATTAGGGCACAGGTCACTATCCCGAGGCAGCTGAGGCAGCCCAGGCAGCCGAGTGAGACTCCGTCTCAAACAAACAAACAAACAAACAAACA","GACCGGGCACAGTGGCTCATGCCTGTAATCCCAGAACTTTGGGAGGCCAAGGCGGGTGAATCACCTGAGGTCAGGAGTTCAAGACCAGCCTAGCCAACATGGCAAAATCTCGTCTCTACTAAAAATACAAAAAAACTAGCCAGGTGTGGTAGCGTGTGCCTGTAATCCCAGCTACTTGGGAGGGGCTGGCGCAGGGAGAATCACTTGAACCCAGGAAGTAGAGGTTGCAGTGAGGCAAGATCACACCATTGTACTCCAGCCTGGGCAACAGAGCAAGACTCCATCTCAAAAAAAAAAAAAAAAAAA"
"GL873528","14471318","14471400","chr12","102036604","102036690","18","87565286","CATGGTGGCTCACGCCTGTAGTCCCAGCGCTATGGGAGGCCAAGGCGGGTGGATCACCTGTGCTCAGAGGTTCGAGACCAGCC","GGGGGCGATGACTCCACACCTGTAATCCCAGCACTTTGGGAAGCCAAGGCGAGTGGATCACCTGAGGTCAGAAGTTCGAGACCAGCA"
"GL873528","28087008","28087107","chr2","51286276","51286376","26","23199268","TTGGCTGGGGTAGTGGCTCATACCTTTAATATCAGCACTCCAGGAGGCTGAGCTAGGAGGCTCCCTGAGGTCAGGAGTTCATGACTAGCCTAAGTCATGA","GGCTGGGTGCAGTGGCTCACGCCTATAATCCCAGCACTTCGGGAGGCTGAGGCAGGCAGGTCACCTGAGGCCAGGAGTTCAAGACCAGCCTGGCCAACATG"
"GL873528","29377757","29378072","chr8","143466459","143466768","76","114088702","GGCCAGGGATGATGGCTCAGGCCTGTAATCCTAACACTCTGATTGGCCGAGGCTGGAGGATCACTTGCAGTGAGGAGTTTGAGGCCAGCCTGAGCAAAAGGGAGACAGACCCAAACCTCTACTAAAAATAGAAAAATTAGCCAGGCATGGTGGTACCTGTAGTTCCAGCTACTTGGGAGGTTGAAGCAAGAGGACTGCTTAAACCCAGAAGTCTGAGTTTCCTGTGAGCAAGGCTGATGCCATGGTACCCTAGCCTGGGCAATGGAATGAGACTCTCAAAAAAACAAAAACAAACAAACAAACAAACAACAAAAAA","GGCCGGGCACGGTGGCTCACGCCTGTAATCCTAGCACTTTGGGAGCCCGAGGCGGGAGGATCACCTGAGGTCAGGAGTTTGAGACCAGCCTCTCCAACATGGTGAAACCCTGTCTCTACTAAAAATATAAAAATTAGCCTGGCGTGGTGGTGCATGCCTGTAGTCCCAGCTACTTGGGAGGCTGAGGCACGAGAATTGCTTGAACCCAGGAGGTGGAGGTTGCAGTGAGCTGAGATCACACTATTGCACTCCAGCCTGGGCAATAGGAAGAGACTCCATCTCAAAAAAAAAAAAAAAAAAAAACTAAAAA"
"GL873528","33927808","33927969","chrX","71659786","71659940","62","37731978","GTCAGGCATAGTGGTGTGCACATACTCATGTGTGCAGGGATACTGAAGCAGGAGAACTACCTGAGCACAGGAGGTTAAGGCTACTTTGTACAGTGATTTCACCTGTAAATGCCATTACAGTCTAATGTGGGCAACATAACAAGACTCCCTCTATTACCAAAA","GTCAGGCGTGGTGGTACACGTCTGTAATCCCAGGTACTCGGGAGGCTGAGGCAGGAGGATTGCTTGAATCCAGGAGGTGGAGGTTGCAGTGAACCAAGATGGTGCCACTGCACTCCAGTTGGGGCAACAGAGCGAGACTCCACTCAAAAAAAAAA"
"GL873528","36569128","36569409","chr14","9682746","9683032","63","26886382","GGCCAGGAGCAGTGGCTCACACCTATGATCCCAGCTCTCTGGGAGGCCGAGGCAGGTGAACCACCTGTGCTCAGGACTTCAAGACCAGCCTGAGGAGAAGTGAGACCTCCATCTCTACTAAAATAGAAAAACTAGCTGGATCTGTAGTCCCAGCTACTCGGGAGGCTGAGGAGAGAAGATCACTTAAACCCAGGAGTCTGAGGTTTCTGTGAGATACCAAAACACCATGGCATTCTACCTAGGGTGACAGAGTGAGACTTGGTCTTGAAAAGAAATAATAAA","GGCCAGGCGCGGTGGCTCACACCTGTAATCCCAGCACTTTGGGAGGCCGAGGCAGGCAGATCACCTGAGGTCAGGAGTTCAAGACCAGCCTGCCCAATGTGGTGAAACCCCATCTCTACGCAAAATACAAAAATTAGCCGGGCATGCCTGTAATCCCAGTTACTCGGGCAGCTGAGGCAGGAGAATCACTTGAACCCAGGAGGCGGAGGTTTCAGTGAGCCAAGATCAGGCCACTGCACTCCAGCCTAGGTGACAGAGTGAGACTCCGTCTCAAAAAAAAAAAAAAA"
"GL873528","37113044","37113319","chr17","29335507","29335791","64","7777537","GGGTGTGGTGGCTCACTGTAATCCTAGCACTGTGGGAGGCTGAGGTGGGCAGATTGCTTGAGCTCAGAAGTTCCAGACCAGCCTGAACATGAGCAAGATCCTGTCTCTACTAAAAATAGAAAAAATTAGCCAGGCATGGTAGCAGAAGCTGTAGTCCCAGCTACTCAGAAGGCTGAGGCAGAAAGATCCCCTGAGCCCAGGAGTTTGAAGTTGCTGGGAGCTAGGCTGAGGCCAGGGCACTCTATCCTGGGCAATAGAGTGAGAATACATCTTAAA","GGCCAGATGAGGTGGCTCACACCTGTAATCCCAGCACTTTGGGAGGCCGAGGTGGGCAGATCACCTGGGGTCAGGAGTTTGAGACCAGCCTGGCCAATATGGTGAAACCCCGTCTCTACTAAAAATACAAAAATTAGCCAGGCATGGTGGCACATGCCTGTAGTCCCAGCTACTCAGGAGGCTGAGGCAGGAGAATCACTCGAACCCGGGAGGCAGAGGTTGCAGTGAGCCGAGATTGTGCCACTGCACTCCAGCCTGGGCAACAGAGTGAGACTCCATCTCAAA"
"GL873528","38243712","38243790","chr13","24449820","24449901","20","13793892","GGCTGGGTGCGGTGGCTCCTGCATAACCTTAGCACTCTGGGAGGCCGAGGTGGGCAGATCCTCTTAGCAAGAGTGAGAC","GGCCGGGTGTGGTGGCTCACACCTGTAATCCGAGCACTTTGGGAGGCCGAGGTGGGCAGATCACTTGAGGTCAGGAGTTCGA"
"GL873529","2502703","2502823","chr18","11928298","11928417","33","9425595","CTAGCTGGGACATTGTTGTGAGCACCTGTAGTCCCAGCTACTTGGGAGGCTCAGACAGAAGGATCACTTAAACACAAAAGTTTGAGGTTGCTGTGAGCTATTATGCCACAGCACTCTACCC","GAGCTGGGCATGGTGGTGTGCACCTGCAATCCCAGCTACTTGAGAGGCTAAGGCAGGAGAATCACTTGAACCTGGGAGGTGGAGGTTGCAGTGAGCCAAGATCACACCACTGCACTCCAG"
"GL873529","2503177","2503247","chr7","98763730","98763789","24","96260553","GACCAACTTGAGCAAGAGTGAGACACCCCTCCGACTCCTGTTCTCTATCTAAAATAGAAAAACTAGCCAGG","GACCAGCCTGGGCAACATGGCAAAACCCTGTCTCTACCAAAAATATAAAAAATTAGGCAG"
"GL873529","2503518","2503612","chr16","47928469","47928561","17","45424951","GGCCAGGTGCAGTGGCTCACACCTATAATCCTAGCACTTTGGGAGGCCAACGCAGGTAGACTGCCTGAGATTAAGAGTTTAAGACCAACCTGAGC","GACCAGGTGCAGTGGTCACACCTGTAATCCCCGCACTTTGGGAGGCCAAGGCTGGTAGATCACCTGAGGTCAAGAGTTCAAGACCAGCCTGTT"
"GL873529","2578914","2579045","chr4","130422793","130422908","43","127843879","TTGACTGAGTGTGGTGGCTCACACCTGCCATCTCATCCTTTTGGAAGGCTGAGGTAGGAGGATCTCTTGAGCCTGGGAGTTGGATCATGCCACTGTACTCCAGCCTGGGCAACGGAGTAAGGCTCAGTCTCA","GGCCAGGCATGGTGGCTCACACCTGTAATCTCAGCATTTTGGGAGGCTGAGGCAGGAGGATTCCTGAGGTCAGAAATTCAAGACCAGCCTGGCCAACATGGTGAAACCCTGTCTCT"
"GL873529","3971763","3972065","chr5","66680571","66680888","90","62708808","GTAATCCTAGTACTCTGGGAGGCTGAGGTGGGCAGATCACCTGAGCTCTTGAGTTCGAGACCGGCCTGAGCTAGAGTGACACCCCGTCCCATCTCTAGAAACAGCTGGGCATTGTGGCTGGTGCCTGTAGCCCTAGCTAGTCAGGAAACTGAAGCAAGAGAATGGCTTGAGCCTAGGAGTCTGAGGTTGCTGTGAACTGTGACACTACAGCACTACCAGCGGTGACAAAGTGAGACTCGGTCTCAAAAAACAAACAAACAAACAAACAAACAACAACAACAACGACAACAAAAAACAGAAAAA","ATCCTAGCACTTTGGAGGCCGAGGCGGGCAGAAAACCTGAGGTCAGGAGTTTTAGACCAGCCTGGCTAGCATGGCGAAACCCTGTCTCTACTGAAAATACAAAAATTAGCTGAGCATGGTGGCGTGTGCCTGTAATCCCAACTACTGGGGAGGCTGAGGCAGGAGAATCGCTTGAACCTAGGATACAGAGGTGGTTTTGCAGTGAGCCCAGATCACACCACTGCAATCCAGCCTGGGCGACAGAGTGAGACTGTGTCTCAAAAAAACAAACAAACAAACAAACAAACAAAAAAAACCCCAAAAAGAAATAAGAGAAAA"
"GL873529","6804738","6804899","chr1","16061663","16061830","45","9256925","TTGAAAAATTAGCTGAGCATTGTGGCAGGTGTCTGGAGTTCCAGATACTTGGGAGGCTGAGGGAGGATTGCTTGAATCCAATCTGAGGTTACTGTGAGCTAGGCTGATGCCACAGCACTCTAGCCTGGGATACAGAGTGAGTCTTTGTCTTAAAAAAAAAAA","ACACAAAAATTAGCTGGGCGTGGTGGGGCATGCCTGTAGTCTCCACTACTCAGGAGGCTGAGGAGTATTGCTTGAACCCAGAGGCGGAGGTTGCAGTGAGCTGAGATCGCGCCACTGCACTCCAGCCTGGGCAACAGAGTGAGACTCTGTCTTAAGGTGGAGAAAAAA"
"GL873529","6805172","6805303","chr3","43234051","43234185","29","36428879","CCAGGCACAGTGGTCATGCCTGTAACCCTAGCACTCTAGGAGGCCAATGCAGGTGGACCACTTAAGATCAAGAGTTCAAGACTAGCCCGAGCAAGAATGAGGCCCTATCTCTACTAAAAAATAGAAAAATTA","GCCGGGAACAGTGGCTCATGCCTGCAATCCCAGCACTTTGGGAGGTCAAGGCGGGTGGATCACCTGAGGTCAAGAGTTCAAGATCAGCCTGGGCAACATGATGAAACCCTGACTCTACTAAAAATACAAAAATTA"
"GL873529","9131615","9131722","chr1","148828584","148828670","38","139696969","TCTCAATTCAAGAATAGAATAATTTGCCAGGAGTGGTGGCTCACGCCTGTAATCCTAGCACTTGGGAGGCCAAGGCTGGTTGGAGACCAACTTGAGCCAGAGTGAGAC","AAACACAAATAATTGGCCAGGAATAGAGACTCAGGCCTGTAATCCCAGCACGTTGGGAGGCCAAGGCAGATGGATGGCTTGAGGTCA"
"GL873529","12892712","12893019","chr5","51581846","51582152","82","38689134","GGTGGCCCAGGCCTGTAATCCCAGCACCCTGGGAAGCGGAGGTGGGAGGATCCCTTGAGCTCAGGATTTTGATCCTTGACCCAGAGCGAGACCCTGTCTCTCCTAAAAGGAGAAAAAACTAGCCAGATGCTGTGGCGTGCACCTGTAGTTCCAGTTACTTGGGAGGCTGAGGTGGGAGGATCACTTAAACCCAGGAGGCTAAGGTTGCTGTCAGCTAGGCTGGGGCCATGGCATTCTTAGCCTGGGCAACAGAGTGAGACTTTGTCTCAAAAATAAATAAATAAATAAATTTAAATAAAAGAAAAAAA","GGTGCGGTGGCTCATGCCTGTAATTCCAGCACTTTGGGAGGCCGAGGCAGGCGGATTGCCTGAGCTCAGGAGTTCGACATCAGCCTGGGCAACAGGGTGAAACCCCGTCTCTACTAAAATACAAAAAATTAACCAGGCACTGTGGCATGCACCTGTAGTCCCAGCTACTCGGGAGGCCAAGGCAGGAGAATCACTTGAACCCAGGAGGCAGAGGTTGCAGTGAGCTAGGATCACGCCACTGTACTCCAGCCTGGGCAACAGAGTGAGACTCCATCTCAAAAAAAAAAAAAAGAAAGAAAGAAAGAAA"
"GL873529","16285637","16285748","chr1","128607504","128607619","26","112321867","GCCTGTAATACCAGCACTCTGGGAGGCTGAGGCAGGTGGATGGACTGAGCTCAGGAGTTTGAGACCAACCTGAGCAAGACCCAGACCTGTCTCTACTAAAAATACAAAAACT","GCCTGTAATCCAAGCACTTTGGGAGGCTGAGGCGGGTGGATCACCTGAGGTCAGGTGTTCGAGACCAGCCTGGCCAACGTGGTGAAACCCCAACTCTACTAAAAATACAAAAATTA"
"GL873529","16286035","16286285","chr12","114041553","114041796","86","97755518","CCAAGAGAGAGAGAGAGAGAGAAAGACAGACAGACAGATAGACAGACAGACTATCTGGGTGTTGTGCCAGGTGCCTATAGTCCCAGCTACTCAGAAGGCTGAGGCCAGAGGATCTCTGGAGCCCAAGAGTTTGAGGTTGCTGTGAGCTAGGATGATGTCACAGCACTCTATGCAGGGCTACAGAGCAAGACAGTGTCTAAGAAAGAAAGAAAGAAAAAAAGAAAGAAAGAAAGAAAGTTTTATCAAAAAAA","CAGCCTGGCCAACATGGCAAAACCCCATCACTACTAAAAATACAAAAACTATCTGGGCATGGTGGCACATGCCTAGAATCCAAGCTACTCAGGAGGCTGAGGCAGGAGAATCACTTGAACCTGAGAGGCAGAGGTTGCAGTGAACTGAGATCGCACCACTGCACTCCAGCCTGTACCACAGAGCGAGACTCTGTCTCAAAAACAAAAAACAAAAAACAAACAAACAAAAAAACAACACGAAAAA"
"GL873529","16286597","16286848","chr16","44581957","44582210","77","28295360","GGCCCGGCATGGTGACTCACACTTGTAATCCTAGCACTCTGGGAGTCTGAGGTGGGTGGATTGCCATGAGCTCAATTAGGTTCGAGACCCCCACCTCTAAAATTAGCTGGGGGTAGTGGTAGGCGCCTGTAGCTACTTGGGAGGGTGAGGCAAGAGAATCGCTGGAGCCCAAGAATTGGAGGTTGCTGTGAGCTACAAAGCTACAGCACTCTACTGAGGGTGACAAAGTAAGACTCTGTCTCAAAAAAAAGC","GGCCGGTGCGGTGACTCACTCCTGTAATCCCAGCACTCTGGGAGGCTGAGGCGGGTGGATCACCTGAGTTAAAGAGTTTGAGACCAGCCTGGCCAATTAGCTGGCATGGTGGCACATGTCTGTAATCCTAGCTACTCAGGAGGCTGAGGCAGGAGAATTGTTTGAACCCAGGAGGCGGAGGTTGCAGTGAGCCAAGGTGGCAACACTGCACTCCAGCCTGGGCAACAGAGTGAGACCATGTCTCAAAAAACAAA"
"GL873529","16287162","16287174","chrX","44411094","44411106","1","28123932","TTAAAAAAAAAAA","GTAAAAAAAAAAA"
"GL873529","20787228","20787308","chr20","61270314","61270390","19","40483086","GGCCTGGCACACTAGCACACACCTGTAATCGTAGCACTCAGGGAGGCCAAGGCAGTGGATCACCTGAACTCAGGAGTTTGA","GGCTGGGCACGGTGCACACCTGTAATCCCAGCACTGTGGGAGGCCGAGGCAGGTGGATCACTTGAAGTCAGGAGATC"
"GL873529","21433940","21434099","chr3","180736197","180736359","53","159302257","CCTGGAACAGTGGTGCGCATATGTAGTCCCAGCTACTCTGGAGGCTGAAGCCGGACTGACTGAGGCCCCAAGTTTGAGATCTGTCCGGACAATATAGGGAGACTCCATCTCCAAAAAGATAAAAATTAGCCAACGTGATGGTGCACATCAGCAGTTCAAG","GGCTGGGCATGGTGGCTCATCCTGTAATCCCAGCACTTTGGGAGGCTGAGGCAGGCAGATCACCTGAGGTCAGGAGTTTGAGACCAGCCTGGTCGACATGGTGAAACACCATCTCTGCTAAAAGTACAAAAATTAGCCAGGTGTCATGGTGCATGCCTATAAT"
"GL873529","30361582","30361758","chr16","66190732","66190916","60","35829150","GGCGGCTCACCCCTGTAATTCCAGCACTCTGGGAGGCCGAGGCGAGCAGACCTCCTGAGGTCGCGAGCGAGTTCAAGAGCGGCCTGAGCCAAGCCCCGTCTCAAAAAATAGCAGGGCGTTGTGGCATGCGCCTCTAGTCCCAGCAACTCTGGAAGTTGAGGCAAGAGACTCGTTTGA","GGCCAGGTGATGTGGCTCACACCTGTAATCCCAGCACTTTGGGAGGCCGAGGTTGGCAGGTCACCTGAGGTCGGGAGTCCAAGACCAGACTGGTCAACATGGTGAAACCCCAAAAAATTACCTGGGCATGGTGTTGTGTGCCTGTAATCCCAGCTACTCATGAAGCTGAGGCAGGAAAATCGCTT"
"GL873529","37435712","37435995","chr1","165353981","165354272","70","127918269","GGCTGGGCGTGGTGGCTCACGCCTGTAATCCCCGCAGTCTGGGAGGCCAAGGGGGTGGATCACCTGAGTTCAGGAGTTGAAGACCAGCTTGAGCAATAGCGACACCCCGTCTCTACTAAAAACAGAAAAACTAGGCTGTGTGGCCAGCACTTGTGGTCCCAGCTATTCAGGAGGCTGAGGCAGGAGGGTCGGTTCAGCCCAAGGATGTGAGGTTGCTGTGAGCCAGGCTAATGCCACCTACCTAGAGCGACAGAGTGAGATAATGTCCCTCCCCCCCAAAAAAA","GGCTGGGCATGGTGGCTCATCCCTGTAATCCCAGCACTTTGGGAGGCCAAGACGGGTGGATCACCTGAGGTCAGGAGTTCAAGACCAGCCTGACCAATATGGTGAAACCCCGTCTCTACTAAAACTACAAAAATTAGCCAGGCATGGTGGCACACACCTGTAGTCCCAGCTACTCAGGAGGCTGAGACAGGAGAATGGCTTGAACATGGGAAGTGGAGGTTGCAGTGAGCCGAGATTACGCCATTGCACTCCAGCCTGGGCAACAGAGTGAGACTCTGTCTCAAAAAAAAAA"
"GL873530","2103983","2104104","chr9","28309649","28309769","25","26205666","GGCTAGGCACAGTGGCTCACCCCTATAATCCCAGCACTCTGAGAGGCCAAGGTGGGAGGATCCCCTGAGCTCAGGAGTTTGAGATCCCATCTCTACTTAAAATAGAAAAATTAGCCAGGTGT","GGCCAGGCGCAGTGGCTCACGCCTGTAATCCCATCACTTTGGGAGGCCAAAGCAGGTGGATCACCTGAGGTCAGGATGGCGAAACCCCATCTCTACTAAAATACAAAAATTAGCTGGGCAT"
"GL873530","3511429","3511505","chr13","41566300","41566362","25","38054871","CTTAGCACGCTAGAAGGCTGAGATGGGAGGATCACTTGAGGCCAGAAGTTTGAGACGCCAATAAGACGGAGACCCTG","TTGGGAGGCTGAGGTGGGTGGATCACTTGAGGTCAGAAGTTCGAGACCAAATGGCAAGGTGGT"
"GL873530","3511765","3511807","chr19","1742682","1742721","12","1769083","AGGGGAGACCCTGTTTCTACTAAAATTAAGAAAAAATTAGCCA","TGGTGAAACCCCTTCTCTACTAAAAATACAAAAACTAGCC"
"GL873530","5422299","5422457","chr5","104393948","104394110","50","98971649","CTAAAAATGAGAATATAGAGCTGGGCTTGGTGGCTCATGCCTGTAAACCTATAATTCTGGAAGAGTGAAGTGGGAGAACTGGTGAGGTTGCAGTAACCTGTATTGATGCCACTGCACACCAGCCTGGGTGAGAGAGGAACAATCTGTCTCAAAAATAAA","AAAAATACATATATATAGCTGGGTGTGGTGGCGCATGCCTGTAATCCCAGCTACTCAGGAGGCTGAGGCACAATAATCACTTAGGTTGCAGTGAGCCAAGATCATGCCACTGCACTCCAGCCTGGGTGACAGAGCAAGCCTGTGTCTCAGAAAAATAAATAAA"
"GL873530","8359806","8359891","chr5","184653087","184653156","32","176293281","TAACTCATGCCTATAATCCCAGCACTTTGTTGGGGGAGGGGGGCCCAAGACTGGTGGATTCCCTGAGCAAGAGTAAGACCCAGTCT","TAGCTCACACTTGTAATCCCAGCACTTTGGGAGGCTGAAGCGGGCAGATCAGGAACAAGAAAAAGACACC"
"GL873530","8832431","8832750","chr7","155415223","155415552","96","146582792","GGCTGGGCATGGTGGCTCACATCTGTAATTCTGGCACTTGGGAGGCCAGATTTGCCTGGGTGGGTGGATTGTCTGGGATCACAGGTTCGAGGCCAACCTGAGCAGAGGTGGGACCCTGTCTCTAAAGACAGCTGGGGCTGTGCCGGCAACTATAGTCCCGGCTGCGTGGGAGGCTGAGGCAGGAGAATCACTTGAGCCCGGGAATTAGAGGTTTCTGTCAGCTAAGATGCCACAGCATTCTGCCAAGGGTGACTAAGTGAGACTCTGTGTTAAAAAAAAAAAAAAAGAAAAGAAAAGAAAAAGGAAAGAAAGAAAGAAAG","GGCTGGGCACAGTGGCTCACACCTGTAATCCCAGCACTTTGGGAGGCCAAGGCGGGTGGATCACCTGAGGTCAGGAGTTCGAGACCAGCCTGGCTAACATGGTGAAACACCATCTCTACTAAAAATACAAAAATTAGCCAGGTGTGGTGGCATGCACCTGTAATCCCAGCTGCTTGGGAGGCTGAGGCTGGAGAATCACTTGAACCCAGGAGGCAGAGGTTTCAGTGAGCCAAGACCACATCATTATTCTCCAGCCTGGGCAACACAGTAAGACTCTGTCTCAAAAAAAAAAAAAAAAAAAAAAAAAAGAAAGAAAAGAAAAGAAAAAAA"
"GL873530","11340324","11340425","chr13","105416123","105416211","35","94075799","ATCCCAGCACTCTGGGAGGCCAAGACTGGGGGTGGGGATGTGGGAAATCACCTGAAGTCAGGAGTTGGAGACCAGTCTGAGAAGAGTGAGACCCCATCTCTA","CCAGCACTTTGGGAGGCCAAGGCAGGTGGATCACCTGAGCTCAGGAGTTCAAGACCAGCCTGGGCAACATGGTGAAACCCCGTGTTTAC"
"GL873530","11428714","11428848","chr6","116856044","116856179","49","105427330","ATTAAAAATTTAATACTAAGGCAGGCCTGATGGCACCTGCCTTGTAATCTCAGGTAATTGGGAGGCTGTGGCAGAAGCATCACTTGAGCCCCAGATATTTGAGACCAGCCCAAGCAACAGAGAGGGGCACAATCT","AAAAAAAAAAAATTAGCCAGGCATGGTGGCACATGCCTGTAATCCCAGGTACTCAGGAGGCTGAGGCACAAGAATCACCTGAACCTGGGAAGCAGAGGTTGCAGTGAGCCAAGATCAGGCCACTGCATTCCAGCCT"
"GL873530","11709328","11709469","chr11","49147155","49147275","50","37437827","GGTCATGGTGGCTCAAGTCTGTAATCCTGTCACACACCAGGAGGTTGAGACTGAGGCTGAGGTGGGAGGATCACTGGAGGTCAGGAGTTGGAGGCTGCAGTGACCACATTCTAGCCTAGAGCAAGACTGCCTTTTTAAAAAA","GGGCACAGTGGCTTACGCCTATAAACCCAGCACTTTGGGAGGCCGAGGTGGGTGGATCACTTGAGGCCAGGAGTTCGAGACTAGCCTGGCCAACATGGAGAAATTGCACCTCTACTAAAAA"
"GL873530","15343402","15343470","chr15","10208312","10208380","12","5135090","GACTGGGTGAGGTGGCTCATGCCTGTTATCCTAGCACTCTGGGAGCCCAAGGCAGGCAGATTACCTAAG","GGCCGGGTGTGGTGGCTCATGCCTGTAATCCCAGCACTTTGGGAGGCCCAGGCGGGCTGATCACCTGAG"
"GL873530","15348456","15348758","chr19","45247373","45247668","75","29898917","GGTGGCTCGCGCCTGTAATTCTAGCACTCTGCAAGGCTGAGGCAGGAGGATCCACTGAGGTCAGGAGATGGAGACCAGCCTGAGTAAAAGCAAGACACCCCCTCCCCCCAATCTCTACTAAAAATAAAAAAAACAAAAATAGCTGGACACTGTGGCAGTCTCCTGTGATCCTAGCTACTCAGAAGGCTGAGGCAGGAAAACGCTTGAACCCAGGACTTTGAGGTTGCTGTGCGCTAGGCTGATTCGATGGCACTATAGCCTGAGTAACAGAGTAAGACTCTGTTTCAAAAAAAAAAAAAAAGA","CAGTGGCTCACCCCCGTAATCCCAGCACTTTGGGAAGCTGAGGCAGGCAGATCACGTGAGGTCAGGAGTTTGAGACCAGCCTGGTCAACATAGCGAAACCCCGTCTCTACTTAAAAAAAAAAAAAAAAAAAAATTAGCTGGGCGTAGTGGCATGTGCCTGTAATCCCAGCTACTCAGGAGGCTGAGGCAGAATCGCTTGAACCCGGGAGGTGCAGGTTGCAGTGAGCCAAGACTCTGCCACTGTACTCCAGCCTGGGAGACAGAGCAAGACTCTGTTTCAAAGAAAAAAAAAAAAA"
"GL873530","16708867","16709014","chr2","21053086","21053219","48","4344219","CAACAAAGAAAAAAGCTGGATGCTATAGCTTATGCCAGCCACTTACTCAGGAGGCTGAGGGCTAAGGTAGGAGAACTACCTGAGATCAGGAGATTGAGATCAGCCTTGGTAATATAGCAAGATCCCCATCTCAAAAAAAAAACAAAAA","GACTAGACACAGTGGCTCACACCTATAATCCCAGCACTTTGGGAGGCTGAAGTGAGTGGATCACCTGAGGTCAGGAGTTTGAGACCAGCCTGGTCAACATGGTGAAACCCCGTCTCTACTAAAAAAAAAAAAAT"
"GL873530","16876480","16876636","chr2","94000404","94000565","39","77123924","AAACAGCCGGACACTGGGGTGGGCACCTGTAGTTCCAGCTACTTGAGAGGCTGAGGCAAGAGAATCGCTTAAACCCAAGAGCTTGAGGTTGCTGTGAGCTGTCATACCACAGCACTTTACTGAGGGCAGCCAGTGAGACTCTGTCTCAAAAAATAAA","AAACTAGCCTGGCGTGGTGGTGTGTGCCTGTAATCCCAGCTACTTGGGAGGCTGAGACAGGAGAATCACTTGAACCTGGGAAGTGGAGGTTGCAGTGAGCTGAGATCATGCCACTGCACTCCAACTTGGGCAACAGAGCGAGACTCTGTTTCAAAAAAAAAA"
"GL873530","16876891","16877021","chr17","92027699","92027828","31","75150808","GGCTGGGCTCAGTGGCTCATGACTGTAATCCTAACAGGCATGGGAGGCTAAGGCGGTGGATTGCCTGAGGTCAGGAGTTTGAGACCAGCCTGAGCAAGAGCAAGACCCTCATCTCTAAAAACAGCCGGACA","GGCTGGGCGTGGTGGCTCATGCCTGTAATCCCAGCACTTTGGGAGGCTAAGGCGGGTGGATCACCTGAGGTTGGGAGTTCGAGACCAGCCTGGCCAACATGGTAAAACCCGTCTCTACTAAAAATACACA"
"GL873530","16934149","16934372","chr6","154348130","154348349","84","137413981","GCTGGGTACAGCAATTTATGCTTATAATCCCAGCAACTCTGAAAGCTAAGGAAGGTGGATCACTTGAGGACAGGAGTTCTAGTGAGGCCCCTTCTCCACAAAAAAAAATGAAAAAAACTGACAGGACATGGTGACATGTACCTATATAGTTGCAGCCATTGAAAAGGCTAAGGCAGGAAGATCATTTGAACCCAGGAGTTCAAAACTGCAATGAAAGATCTTGC","GGCTGGGCGTAGTGGCTCACACCTGTAATATCAGCACTTTCTGAGGCTGAGGAGGGTGGATCACCTGAGATCAGGAGTCTGAGACCAGCCTGGCCAACCCTGTCTCTACTAAAAATACAAAAATTAGCTAGGCATGGTGGCCCACACCTGTAATCCCAGCTAGTTGGGAGGCTGAGGCAGGAGAATCACTTGAATCCAGGAGGCAAAGGTTGCAGTGAGC"
"GL873530","18920450","18920506","chr15","4105882","4105944","16","14814568","GCGGTGGCTCACGCCTGTAATCCCTGTAGTCTGGGAGACCTAAGTGGGCGGATCGCC","CCAGGCGCGGTGGCTCACACCTGTAATCCCAGCACTTTGGGAGGCTGAGGTGGGCGGATCACC"
"GL873530","21146990","21147148","chr10","68343040","68343195","59","47196050","GACAGGGTGCTTTTACCCACACCCACAACTCCAGGACTTTGGGGGATGAGGCTGGGTGGATCCTTCAAAGTCAGAATCTCCTTACCAATGTGGACAAAAACAAGACTCCACCTCTGCCAAATATAGAGAAAAATCAGGAGTATGTCACAGTGGGGGCCT","GGCCGGGTGCATTGGCTCACACCTGTAATCCCAGCACTTTGGGAGGCCGAGGCGGGCAGATCACCTGAGGTCAGGAGTTCGAGACCAACCTGGCTAACATGGTGAAACCCCAACTCTACTAAAAATACAAAAAAAAATTAGCCAAGGTGGGGACGC"
"GL873530","24319936","24320007","chr19","9863913","9863976","18","14456023","GGCCAGGCACAGTAGCTCACACCTGTAATCGCAGCACTGAGGCAGGTGGATTGCCTGAGCAAGAGTGAGACC","GGCTGGGCACAGTGGCTCACGCCTGTAATGGCAGCACTGAGGCGGGCGGATCACCTGAGGTCAG"
"GL873530","24708441","24708557","chr5","41111792","41111907","37","16403351","GCTAGGCATGGTGTCTTGAACCAGTGAAATAGCTACTCAGGAGGCTGAAGCAGAACAGCTGAGCTCAGTAACTTGAAATCAACCTGGCTAACATGGTGAGACCCCATTTCAAAAAAA","GACTAGGCATGATGGCTTGCGCCTGTAATCCCAGCACTCTGGGAGGCGGAGGCGGAAGGATCACCTGAGGTCAGGAGTTTGAGATCAGCCTGGCCAACATGGTGAAACCCCATTTC"
"GL873530","24709565","24709652","chr1","217601615","217601698","31","192892050","AGCTACTCAGGAGGGCTGAAGCAGAACAGCTGAGCTCAGTAACTTGAAATCAACCTGGCTAACATGGTGAGACCCCATTTCAAAAAAA","TTTGGGAGGCTGAGGCAGGTGGATCACCTGATGTCAGGAGTTTGAGACCAGCCTGGCCAACATGGTGAAACCCCATCTCTACTA"
"GL873530","24804711","24804786","chr11","33086709","33086779","17","8281998","GGCCTGGGCGAGGTGGCTCACACTTACAATCCTAGCACTCCGGGAGACCAAGGCAGGCAAATCACCTGAGCTTAAG","GGCCAGGTGCAGTGGCTCACACCTGTAATCCCAGCACTTTGGGAGGCCAAGGCAGGCAGATCACCTGAGGT"
"GL873530","24911474","24911674","chr15","94696186","94696379","47","69784712","CTGTAGGAACTCCATCTCTACTAAAAATAGAAAAACTAGCCGGGCATTTTGGCAGGTGCCTGTAGTCCCAGCTACTTGGCAGGCTGAGGCAGGAGAAGCCCTTGAACCCAGGAGTCTGAGGTTGCTGTAAGCTGTGATAAAGCCAATTGTACTCTAGCCAGGGCCACAGAATGAAACTCTGTCTCAAAAAAATAAGTAAAA","CATAGTGAAACCCCATCCCTACTAAAAATACAAAGATTAGCTGGGCATGGTGGCAGGTGCCTGTAATCCCAGCTACTAGGGAGGCTGAGGCAGGAGAATCACTTGAACCAGGGAGGCAAAGGTTGCAGTGAGCCAAGACTGCACCATTGCACTCCAGCCTGGGTAACAAGAGTGAAACTGTCTCAAAAAAAAAA"
"GL873530","24911901","24912011","chr19","32133075","32133181","24","7221174","GGCTGAGTGTGGTGGATCACACCTGTGATCCTAGCACTCTGAGAGGCTGAGGGGGAAGGGTCACTTGAGGTCAGGAGTTCAAGTCCAACCTGAGCAAAAGAGGCTATAGAG","GCTGGGTGTGGTGGCTCATACCTGTAATCCCAGCACTTTGGGAGGCTGAGGTGGGTTGATCACTTGAGGCCAGGAGTTCAAGACCAGCCTGCCAACTGGGCATGGTG"
"GL873530","26886298","26886384","chr20","27900350","27900437","17","1014052","GCAGGGCGTGGTGGCTCACGCCTGTTGTCACAGTGCTGTGGGAGGCCGAGGCGGGTGGATCACCTGTGCTCAGAGGTTTGAGACCAG","GGCCGGGCGTGGTGGCTCATGTCTGTAATCCCAGCACTTTGGGAGGCCGAGGTGGGTGGATCACCTGAGGTCAGGAGTTCAAGACCAG"
"GL873530","26957903","26958036","chr11","32811547","32811680","29","5853644","GGCCAGGTGTGATGGCTCACACCTATAATGCCAGCACTGTGGGAGGCTAAGTTGGGAGGATCATTTGAGGTCAGGAGTTCAAGACCAGCCTAAGCAAGAACGAGATCCTATTTCTACTAAAAAATAGCTGTGTG","GGCCAGGTGCGGTGGCTCACTCCTATAATCCTGGCACTTTGGGAGGCCAAGATGGGTGGATCACTTGAGGTCAGGAGCTCAATATCAGCCTGGCCAACATGGTGAAATCTTGTTTCTACTAAAAAAATAGTGGG"
"GL873530","26958288","26958450","chr2","49750797","49750964","48","22792509","TAGCTGTGTATTGTGTTGGGCATCTATGGTCCCAGCTATTTAGGAGAATCACTTGAACCCAGGAGTCTGAGGTTGCTGTGAGCTAAGCTTGGGCATAGCACTCTCCCTTGGCCCAGGCAACAGAGTGAGACTGTCTCAAAAAAAAAAAAAAAAAAAGGAACAA","TTAGCCGGGCATGGTGGCATGGGCCAGTTACTCCAGAGGCTGAGACAGGAGAATCGCTTGAACCCAGGAGGCAGAGGTTGCAGTGAGCCAAGATAGGGCCATTGCACTCCAGCTTGGGCAACAAGAGTGAAACTCCGTCTCAAAACAAAAAAGAAAGAAAGAAAAGAA"
"GL873530","27245179","27245328","chr7","151280672","151280824","44","124035493","TAGCCATTTACCTGTAGTCCCAGCTACTTAAGAGGCTGAGGGAGATCACTTGAGCTCAGGAGTCGGAGATGGCAGTGAGCTGCAATGATGCATGGTAGCCAGGACAATAGAGTGAGACTCTGTCTCAAAAAAAGTCTAAAACAACAACAA","TGGTATGCACCTGTAATCCCAGCTACTTAGGAGGCTGAGGCATGAGAATCACTTGAACCCAGGAGGTGGAACTTTTAGTGAGCTGAGATTGCACCACTGCATTCCAGCCTGGGCAACAGAATAAGACTCTATCTCAAAAAAAAAAAAAAAAAA"
"GL873530","27245605","27245727","chr20","3047800","3047916","44","24197805","ATAAAAACCCTACAATTCTGGGAGGCTAAGGCAGGACTGCTTGAGCTCAGGAGTTTGAGACAAGAGTGATCAAGACCAAGATGCCTGTCTCTACTAAAAGATTTTTTTTTAAATTAGCCATTT","TAATCCCAGCACTTTGGGATGCCAAGGCAGATGGATCACTTGAGCCCAGGAGTTCAAGACCAGCTTGGCCAAGATGGCGAAAACTGTCTCTACTAAAAATATAAAAATTAGCTGGGC"
"GL873530","27246002","27246042","chr9","20539941","20539980","12","6706061","GCCAGGCACAGTGGCTCACACCTATAATCCTAGAATTCTGC","GGCCAGGCGCTTTGGCTCACGCCTGTAATCACAGCACTTG"
"GL873530","28286487","28286547","chr20","68909283","68909346","16","40622796","AAGAGTTCAAGACCAGCTTAAGCAGAGTGAGACCCTGTCTCTATTAAAAATGGAAAAGTTA","GGAGTTCAAGACCAGCCTGACCAACATGGAGAAACCCTGTCTCTACTAAAAAATACAAAAATTA"
"GL873530","28286795","28286961","chr1","88107674","88107836","50","59820879","TGCAAAAGTTAACTGGGCGTGGTAGCACTCAGGTTGCTGAAGCAAGAGGATCTCTTGAACCCAGGAGTTTGAGATTGCTATGAACTAGGTTGAGCCCATGGCACTCTAGCCTGGGCAAAAGAGCAAGACTTTGTCTCCAAAAGAAAAAACAAAACAAGAAAAAAAAA","TGGTGGTGGGTGTCTAAAGCCTTGCTCAGGAGGCTGAGGCAGGAGAATTGATTGAACCCAGGAGGCAGAGGTTGCAGTGAACCAAGATTGCACCACTGCACTCCAGCCTGGGTGACAGAGCAAGACTTTGTCTCAAAAAGTGAAAAAAAAAAGAAAAAAAAAA"
"GL873530","33755547","33755713","chr14","1555231","1555379","58","32200316","GGCAGGGTGCTATGGCCACACTCAAAACTCTAAGACTTTGGGGGGGTCAACCTGGGTGGATCCCTCAAAGTCAGGAGCTCTATACCAGGCTCTGAAAAAGCAAAACCCCACCTCTACCAAATATGGACAGAGGAAAAAATTCAGCAGCATGTTGCAGTGGGTACTTG","GGCCGGGTTCAGTGGCTCACGCCTGTAATCTCAACACTTTGGGAGGCAAAGGTGGGTGGATCACCTGATATCAGGAGTTCAAGACCAGCCTCACCAACAAAGTGAAACCCTATCTCTATTAAAAATACAAAATCAGCCAGGAGTGGTGG"
"GL873530","35154543","35154625","chr5","25768079","25768163","25","9386464","ATTAAAAGTAAAAAGAGGCTGAGCATAGTGGATCACACCTGCAATCCTAGCTCTTTGGGAGGGTGAGGCAGCCTGAGTAAGAG","AAAAAACTCAAACAAGGCTGGGCGTGGTGGCTCACACCTGTAATCCCAGCACTTTGGGAGGCTGAGGTGGGTGGATCACCTGAGG"
"GL873531","92196","92346","chr2","107447129","107447267","54","107354933","GGGTGCGGTCAGTGGCTCATAGCTGTAACCCTAGCACTTTGGGAAGCCAAAACTTGAGGTCGGGAATTTGAGGTTGCAATAAGATATGATATACTACTGTACTCGAGTCTGGGTGATAGAGACATTCTCATTAAAAAAAAAAGGAAGGAAA","GGCTGGGTGCGGTGGCTCACGCCTGTAACCCTAGCACTTTGGGAGGCTGAGGCGGGTGGGTCACCTGAGGTTAGAAGCTCAATACTAGCTTGACCAACATGGTGAAACCCAGTCTCTACTAAAAATACAAACATTAGCA"
"GL873531","292691","292811","chr14","5728683","5728802","34","5435992","GCAGTGGCTCATGACAGTAACCCTACCACTCTAGGAGGCCATGATGGGTGGATCACTTGAGGTCAGGAGTTCGAGAACAGACCAGTCTCAGAAAGAGACCCTATATCTTCTAAAATTAGAA","GGTTCATGACTGTAATCCCAGCACTTTGGGAGGCCAAGGTGGGTGGATCACCTGAGGTCAGGAGTTAGAGACCAGCCTGGCCAACATGGTGCAACCCTATCTCTACTAAAAAAATACAAA"
"GL873531","292841","293015","chr7","21888163","21888326","52","21595322","GCCAGCATCATATGCCTGTAGTGTCATAGTGTCATATGCCTGTAGTCCCAGCTATTTGGGAAGTTGAGGCAAGAGGATCACTTGAACCCAGCAATTTGAGATCTCAGTAAACTATGATGACACTACTGCTATCTTACCTAGATGACAGAGCCAGACTCTCTGTCTAAAAGAAAAA","CTTAGCTGGGCATGGTGGCATATGCCTGAAATCCCAGATATTCGGGAGGCTGAGGCAGAGAATCGCTTGAACCCAGGAGGTGGAGGTTGCAGTAAGCCGAGATGGCACCACTGCACTCCTGCCTGGGTGACAGAGCAAGACTCTGTCTCAAAAAAAGAAAAAAA"
"GL873531","1269421","1269632","chr2","204638025","204638229","51","203368604","CTGGCCATACATGGTTGCTCACTGAGACCCCATCTTTACTAAAAACAGAAAAATTAGCTAAGTACTGTGGCAGGTGCCTATATTCCCAGCTGCTCAAAAGGCTGAGGCAGGAGGATCACTTGTTCCAGGAGTTTGAGGTTGCTGTGAAGTAGGCTGATGCCATGGCACTCTAGCCTGGGCGACAGAGTGAGACTGTCAAAAAAAAAAAAAAA","CTGACCAACATGGTAAAACCCCGTCTCTACTAAAAATACAAAAATTAGCCAGGCATGGTGGCGGGCGCCTGTAATTCCAGCTACTCGGGAGGCTGAGGCAGGAGAATCACTTGAACCCAGGAGGCAGAGGTTGCAGTGAGCCGAGCTCGTGCCACTGCACTCCAGCCTGGGCGACAAGAGGGAAACTGTCTCAAAAAAAAAAAAA"
"GL873531","10298048","10298131","chr9","32244599","32244680","26","21946551","GGCTGGGCATGGTAGATTGCCTATAATCCCAGCAGTCTGTGAGACCAAGGCAGGTAGATTCCCAGAGCAAGACCCTGTCTCTAA","GGCCGGGCATGGTGGCTCATGCCTATAATCCCAGCACTTTGGGAGGCCGAGGTGGGTGGATCATCTGAGGTCAAGTGTTTGA"
"GL873531","14014391","14014473","chr4","24638016","24638099","21","10623625","CTAGGCTTAGCAGCTCTTGTCTGTAATCCTAGGACTCTGGGAGGCCAAGATGGGAAGATCACCTGGGACAAGAGTTCAAGATC","GCCAGGCATGGTGGCTCATGCCTGTAATCTTAGCACTTTGGGAGGCCAAGGTGGGCGGATCATCTGAGGTCAGGAGTTTGAGAC"
"GL873531","20971065","20971395","chr3","14757830","14758151","89","6213235","GGCTGGGCGTGGTGTCTCACGCCTGTTGTCCCAGCACTGTGGGAGACTGAGGCAGGTGGATCACCTGTGCTCAGAGGTTTGAGACCAGCATGAGTCAGAGTGAGACCCTGTCTCTACCAAAAATTGTCGAGTGTTCTTGCAGGCGCCTGTAATCCCAGCTACTTGGGAGGCTGAGGCTAGAGAATCACTTAAACCCAGGCACCCAGGAGTTGGCAAAGGTTGCTGTGAGCTACGTACTCTACTGAAGGACACAAAGTGAGACTCTGTCTCCATAAAAAAATAATAAATAAATAAATAAATAAATAAAATAAAAGAAAAAAAATTAAAAAAA","GGATGTGGTGGCTCACGCCTGTAATCCCAGCACTTTGGGAGGCCAAGGTGGGCGGATCACCTGAGGTCAGGAGTTTGAGACCAGCCGGGTCAACACGGTGAAACCCTGTCTCTACTAAAAATAGTAGCCGGCGTGGTGGTGCGCGCCTGTAATCCCAGCTACTCAGGAGGCTGAGACTGGAGAATTGCTTGAACCTGGGAGGCAGAGGTTGCAGTGAGCTGAGATTTGCACCACTGCACTACAGCCTGGGCAACAGAGTGAGACTGTGTCTCAAAAAAAAAAAAAAAAAAAAAAAAAGAAAAAAAAGAAAAAAGAAAAAAAA"
"GL873531","21648650","21648779","chr7","67248169","67248300","45","45599519","CACATATGTAGTCCCAGCTACTCAGGAGGCTGAAGCAGGAGGATCCCTTGATCACAGGAGACGGATTGAGGCAAACATACTGCCTTCTAGGTCAGGCAACAGAGCAAAACCTACTCCCTCCCCTCAAAAA","TGTAATCCCAGCTACTCAGGAGGCTGAAGCAGGAGAATTGCTTGAACCCAGGAGGCGGAGGTTGCAGTGAGCTGAGATCATGCCATTGCATTCCAGCCTGGGTGACAGAGCAAAACTCCATCTTAAAAAAAA"
"GL873531","24910290","24910380","chr1","130874680","130874773","15","105964390","GCCGGGCATAGTGGCTCATGCCTGTAATCCCAGCACTTTGGGAGAACGAGGTAGGCAGATCACCTGAGCTCACAAGTTCAAGACCAGTCTG","GACCGGGCACAGTGGCTCATGCCTGTAATCCCAGCACTTTGGGAGGTTGAGGCAGGCAGATCACTTGAGGTCAAGAGTTTGAGACCAGCCTGGC"
"GL873531","28140004","28140278","chr15","77650660","77650942","65","49510656","GCCCAGTGGCTCATGCCTGTAATTCTAGCACTCTGGGAGGCTGAGATAGGAGGATTGCTTGAGGTCAGAAGTTGGAGACCAGCCTCAGCAAGAGGGAGACCCCCATCTCTACTAAAAATAGAAAATTTAGCTGGACATGGTGGTATGTGTCTATAGTCCCTCCTACTTGGGAGGGTAAGGCAGAAGAATTGCTTGAGCCCAAGAGTTGGAGGTTGCTGTAAGCTAGGCTGAGGCTATGACACTCTAACCTCAGCAACAGAGTAAGACTCTGTCTC","GGCCCAGTGCAGTGGCTCATGCCTGTAATACCAGCACTTTGGGAGGCTGAGCCAGGAGGATCACCTAAGGTCAGGAGTTTGAGACCAGTCTGGCCCACGTGGTGAAACCCCGCCTCTACTAAAAATACAAAATTTAGCTGGGCGTGGTGGCACATGCCTATAATCCCACTTACTTGGGAGACTGAGGCAGGAGAATCTCTTGAACCCAGGAGGCGGAGGTTGCCGTGAGCTGGGATCATGCCACTGCACTCCAGCCTGAGTAACAGAGCAAGACTCTGTGTCA"
"GL873531","28173323","28173458","chr1","29437872","29437991","31","1264549","GGCCGGGCATGGTGGCTCATGCCTGTAGTCCCAGCACTGTGGGAGGCCAAGGCAGGTGGATCACCTGTGCTCAGAGGTTCGAGACCAGCCAAGACCCCCCTGAGCCAAATGAGCCAGAGTGAGACCCCGTCTCTAC","GGCCGGGCGTGGTGGCTCACGCCTGTAATCCCAACATTTTGGGAGGCCAAGGCGGGTGGATCACCTGAGGTCAGAAGTTCGAGACCAACCTGGCCAACATGGTGAAACCCCTGTCTCTAC"
"GL873531","29287798","29287932","chr20","68167827","68167966","41","38880029","TTAGCCGGGGATGGTGGGATGTGCCTATAATCTCAGCTACTTGGTAGACTGAAGCAGAAGGATTGCTTAGCTGTAGTAAACTAAGATCACATGTCACTGTACTCTAGCCTGGACAAGACAGCAAGACTCCAACTC","AAAATTTAGCTGGACGTGGTGGTGTGTGCCTGTAATCTCAGCTACTCTGGAGGCTGCATGAACCAGGAAGGTAGAGGTTGCAGTGAGCTGAGATCACACCACTGCACTCCAGCCTGGACAACAGAGCAAGACTCTGTCTC"
"GL873532","411999","412286","chr14","50303267","50303553","71","49891268","GGCCAGGTGCAGTGGCTCACACCTATAATCCTAGCACTCTGGGAGGCTGAGGTGGGTGGACTGCCTGAGCTCATGAGTTCAAGACCAGCCTGAGCAAGAGCAAGACCCCCATCTCTAAAAACAGCCGGGCATTGTGACAGGCACCTATAATCCCAGCTACTCAGGAGGCTGAGGCAAGAGAATCACTTAAGCCCAGGAGTTTGAGGTTGCTGTCAGCTGTGACACCATGGCACTCTACCAAGGGAGACAAAGTAAGACTTCTTCCCCCCCACTAAAAAAAGAATAAGA","GGCCAGGCGCAGTGGCTCATGCCTGTAATCCTAGCACTTTGGGAGGCTGAGGTGGATAGACTTGCTGAGCTCGGGAGTTTAAAACCACCCTGGGTAACATGGTCTCCACTAAAATACAAAAGATTAGCTGGACATGGTGGCATGCACCTGTAATCTCAGCTACTCAGGATGCTGAGGCACGAGAATCACTTGAGCCCAGGAGATGGAGGTTGCAGTGAGCTGAGATCACACCACTGCACTCCAACCTGGGCAACAGAGTAAGACTCTCTCCAATAAATAAAATAAAA"
"GL873532","1556505","1556611","chr9","15245726","15245837","26","13689221","TGGCTCACACCTATAATCCGAGCACTCTCAGAGGCCTAGGTGGGCAGATCACTCAAGCTCAGGAGCTGAAGACCAACCTGAGCCAAGAACAAGAACCTGTCTCTACC","GTGGTGTCTCACGCCTATAATCCCAGCACTCTGGGAGGCCAAGGTGGGCAGATCACCTGAGGTCAGGAGTTAAGAGACCAGCCTGGCCAACATGGTGAAACCCTGTCTCTAC"
"GL873532","1556635","1556806","chr4","4726770","4726935","39","3170135","AATTATCCAGGTGTTGTAGTGGGTACCTGTAATCCCAACTACTTGGGAAGCTGAGTCAGGAGGATCATTTGAACCCAGGAATTTGAAGTTATCATAAACTAGGCTGACACCATGGCACTCTAGCATGGAGCAACAGAGTAAGACTCTGCCTCAAAAAAAAAAAAAAAAAGAA","TAGCCAGGTGTGGTGTGCATGCCTGTAATCCCAGCTACTCAGGAGGCTGAGACAGGAGAATCACTTGAACCCAGGAGGTGGAGGTTGCAATGAGCCAAGATCACACCACTGCACTCCAGCCTGGGCGACAGAGCAGACTCTGTCTCAAAAAAAAAAAAAAAAAAAA"
"GL873532","1828042","1828127","chr8","68271230","68271313","14","66443188","GGGCTTGGTGGCTCACACCTATAATCCTAAGCACTCTGGAAGGCCAAGGCAGGTGGATCACCTGAGCTCAGGAGTTTGAGACCAGC","GGGTGCGGTGGCTCACACCTGTAATCCCAGCACTTTGGGAGGCCGAGCCAGGTGGATCACCTGAAGCCAGGTGTTTGAGACCAG"
"GL873532","2251856","2252069","chr17","19340513","19340722","59","17088657","CCAGCCTAAGCAAAAGTAAGACCCTGTCTCTACTAAAAATAGAAAAAACTAGCTAGGCATTGTAGTGAGCACCCGTAGCCCCAGCTACTTGGAAACTAAGGCAAGAGATTGCTTGAGCCCAAGAGTTTGAGGTTGCTGTGAGCTATGAAGCCATGGCACTCTACCCAGGGTAGGAGAGTGAGACTCTGTCTCCTTACAAAAAAACAAAAAAAGA","TGGCCAACATGGTAAAACCCCGTCTCTACTAAAAATACAAAAATTAGCCGGGCATGGTGGTGAGCACCTGTAGTCCCAGCTACTTGGGAGGCTGAAGAAGGAGAATGGCTTGAACCCGGGAGGTGGAGGCTGCAGTGAGCCGAGATCACACCACTGCACACCAGCCTGGGTGACAGAGCAAGACTCTGTCTCAAAAAAAAAAAAAAAAAA"
"GL873532","2252342","2252433","chr11","108711352","108711444","18","106459010","GGCGGGGTGTGATGGCTCATGCCTATAATCCTAACACTCTGGGAGGCTAAGGCAGGTGAATTGCCTGAGCTCAGGAGTTTGAAACCAGCCTA","GTCAGGGGTGGTGGCTCACGCCTGTAATCCCAGCACTTTGGGAGGCCAAGGCAGGTGGATCGCCTGAGCTCAGGAGTTCAAGACCAGCCTTGC"
"GL873532","2511609","2511858","chrX","261484","261742","69","2250125","TCCTAGCACTCTGGGAGTTTGAGGTGGGTAGATTGCCTGAGCTTATGGGTTCGAGACTAGCCTGATCCAAAGCCACACCCTGTCTCTAAAAAAAATAGCCAGGCATTGTGGCAGACATCTATAGTCCCAACTACTTGGGAGGCTGAGGCAAGAGAATTGCTTGAGCCCAAGAGTCGAGAGGTTGCTGTGAGCTATGATGCCACAGCACTCTACCAAGGACAACAAAGTGACACTCGGTCTCAAAAAAAAA","ATCCCAGCACTTTAGGAGGCTGAGGTGGGTGGATCACCTGAGGTCAGGAGTTCAAGACCAGCCTGGCCAACATGGTGAAACCTCGTCTTTACTAAATATACAAAATTAGCCAGGCATGGTGGCGCATGCCTGTAATCCCAACTACTTGGGAGGCTGAGGCAGGAGAATTGCCTGAACCCAGAGGCAGAAGTTGCAGTGAGCCAAGATTACCCCAGCATACTCCAGCCTGGGCTATAGCGTGAGACTCTGTCTAAAAAAA"
"GL873532","2512112","2512153","chr9","20539941","20539980","10","18027829","GGCCTGGCGCAGTGGCTCACACCTGTAAACCTAGCACACTGG","GGCCAGGCGCTTTGGCTCACGCCTGTAATCACAGCACTTG"
"GL873532","13718552","13718740","chr7","17608776","17608965","46","3890224","AAGGCAGGCCCTAAAAATAGAAAAATTTAACTGGCCATGGTGGCAATCACCTGAAGTCCCAGCTACTTGGGAGACTGAGCCAAGAGGATTGCTTGAGCCCAGGAGTTTGAGGTTTCTGTGAGCTAGACTGATGCCCAAGGATTCCAGCCTGGGTAACAGAACAAGACTGTCTCAAAATAAACAAACAAA","GTCCCTACTAAAAATACAAAAAATTAGCTGGGCCTGGTGGCAGGCACCTGTAATCCCAGCTACTTGGGAAGCTGAGGCAAGAGAATTGCTTGAACCCAGGAGGCAGAGGTTGCAGTGAGCTGACATCAAGCCACTGTACTCCAGCCTAGGCAACAAGAGCAAGACTCTGTCTCAAAAAAAAAAAAAAAAA"
"GL873532","13718969","13719117","chr2","93663318","93663457","51","79944349","GGGCACTGTGGCTCCCGCTTGTAACCCTAGTGTTCTGGGAGGTCAAGGTGGAAGGATTGCTTGAGCTCAGGAGTTTGAGATCAGCCTGAGCAAGAGCAAGACTTTAGCTCTACCAAACATAGATTAAAAAAAAATTTTTTTTTTTTTTT","GGGCGCGGTGGCTCACGCCTGTAATCCCAGCATTTTGGGAGGCTGAGGTGGGTGGATCACTTGAGGTCAGGAGTTCGAAACCAGCCTGGCCAACGTGGTGAAACCCCAGCTCTACTAAAAATACAAAAAAAAAAAAAAAA"
"GL873532","19805107","19805406","chr4","80683524","80683821","74","60878417","GCCGGTGCAGTGGCTCATGCCTGTAATCCTAGCACTCTGGGAGGCCGAGGCGGGTGGACCGCCCTGAGCTCAGAGGTTCGAGACCAGTCTGATCCAGAGTGAGACTCCTCCATCCCACCCTGTCTCTACCAAAAAAATGCTGGGTGTTGTAGCAGGCGCCTGTAGTCCCAGCTACTTGGGAGACTGAGGCAAGAGAATTGCTTAAGCCCAAGAGCTGGAGGTTGCTGTGAATTATGATGCCACACATTCTACTGAGGGCAATATAGTGAGACTCTGTCTCAATAAATAAATAAATAAATA","CCTGGCACAGTGGTTCATGCCTGTAATCCTAGCACTTTGGGAGGCCAAGGCGGGTGGATTGCCTGAGCTCATGAGTTCGAGACCAGCCTGAGCAACATGGTGAAACCCTGTCTCTACTAAAATACAAGTTAGCTGGGTGTGGCAGCATGTGCCTGTAGCCCCAGCTACTTGGGAGGCTGAAGCAGGAGAATTGCTTGAGCCCATGAGGCAGAGGTTGCAGTGAGGTGAGGTGGTGTCACTGCACTCCAGACTGCATGACAGAGTGAATCGCTGTCTCAAAATAAATAAATAAATAAAA"
"GL873532","21365464","21365796","chr9","59777949","59778248","94","38412485","GGCACAGTGGCTCACACCTGTATTCCTAGCACTCTGGGAGGCCGAGGCAGGAGGATCACTTGAGCTAAGGAGTTCAAGACAAGCCTGACCAAGAGTGCAACCCCATCTCTACTAAAAATAGAAAAATTTGCCAGGCATAGTGGCAAATTTTCGGCTACTCAGTAGCTGACTACTTCTTGACTCAGCCTCCCCAGTAGCCTAGGCTACTGGGGAGGGTGAGTCAGGAAGATCACTTGAACCCAGGAGTTTGAGGTCAGTGTAAGCTTGGTTAATGCCACAGCTTCCTAGCCTGTGCAACAGAGTGAGACTGTGTGTCAAAAACAAAAGAGAGAA","GGCCAGGCACTGTGGCTCACACCTGTAATTCCAGCACTTTGGGAGGCCAAGGCGGGTGGATCACCTGAGGTCAGGAGTTCAAGACTACCCTGACCAACACGGTGAAACCCCATCTCTACTAAAAATACAAAAATTTAGCCGGGCATGGTGGTGCCCGCCTATAATCCCAGCTAGCTACTCAGGAGGCTGAGGCAGGAGAATCGCTTGAACTCAGGAGATGGAGGTTGCAGGGAGCAAAGATTGTGCCACTGTACTCTAGCCTGGGCAACAGAGCGAGACTCTGTCTCAAAAAAAAAAGAA"
"GL873532","21625131","21625204","chr13","14688151","14688212","23","6936980","CTAAAAATATCTAAAATCCAGGCATGGTGGCTCACACCTATAATTCCAGCTACTCAGAAGGCTGAGGCCAGGAG","ATAAAAAAATTAGCTGGCCATGGTGGCACATACCAATAATCCCAGCTACTCAGGAGGCTGAG"
"GL873532","23569107","23569222","chr6","67740809","67740926","30","44171702","GGCTGAGCATGGTGCCTCCTATCTATAACCCCAACACTTTGGGAGGCTACGGTGGGAGGATTGCCTGAGGTCAAGAGTTTGAGACTAGAAGGTGAAACTGTCTCTATAAAAATATA","GGCTGGGCACGGTGGCTCGTGCCTGTAATCCCAGCACTTTGGGAGGCTGAGGCAGGTGGATCACCTGAGGTCAGGAGTTCAAACAATGTGGTGAAACCCCGTCTCTATTAAAAGTACA"
"GL873532","24653153","24653238","chr1","12339306","12339394","20","12313847","GGGTGTTGTGGCTCACGCCTGTAATCCTAGCACTTGGGAGACCGAGGCAGGTAGATTGCCTGAGTTCACATGTTCGAGACCAACCT","GCTGGGTGCGGTGGTTCACGTCTGTAATCCCAGCACTTTGGGAGGCCGAGGCGGGCAGATCACCTGAGGTCAGGAGTTCGAGACCAGCC"
"GL873532","24653517","24653715","chr19","10638315","10638503","62","14015202","AGACCAACCTGAGGAAGAGCAAGACCTCATCTTAAAAATAGCCAAGCATTGTGTTGGGCACCTGTAGTCTCAGCTACTTGCGAGACTGAGGCAAGAGAATCATTTGAGCCCAAGAGTTTGAAGTTCCTGTGAGCTATGATGCCACAGCACTCTACAGAGAGTGACAAAGTGAGACTCTGTCTCAAAGAATAAAAATAAA","ACCCTGTTTCTACTAAAAATAAAAAAATTAGCCGGGCATGGTGGCGTGCACCTCTAGTCCCAGCTACTTGGGAGGCTGAGGCAGGAGAATCACTTGAACCCAGGAGGTGGAAGTTGCAGTGAGCCGAGATTGCGCCACTCCACTCTAGCCTGGGCGACAGAGCGAAACCCTGTCTCAAAAAATAAATAA"
"GL873532","24797385","24797436","chr9","99030580","99030628","15","74233195","AAAAATTAGCCAAGAAAGGTGGGGTGTGCCTGTAATCCCACCTACTCAGAAG","AATAATTAGCTGGGCATGGTGGCGCACGCCTGTAATCCCAGCTACTTGG"
"GL873532","26107613","26107734","chr1","25541923","25542047","26","565690","GTGGCTCACACCTATAAACCTAGCACTCCAGGAGGCTAAGGCAGGTGGATGGCTTGAGGTCAGGAGTTTGAGACCAGCCTAAGCAAAAGTGAGACCCATTTCTACTAAAGACAGAAAAATTA","GTGGCTCACACCTGTAATCCCAGCACTTCAGGAGGCCAAGGCCAGCGGATCACCTGAGGTCAGGAGTTCGAGACCAGCCTGGCCAACATGGTAAAACCCCATCGCTACTAAAAATACAAAAATTA"
"GL873532","26108044","26108237","chr7","133114354","133114541","49","107006310","TAAGTAAAATAGAAAAATTAGCTGAGCATTGTGGCAGGTACCTGTAATCCCATCTAATTGTGAGACTGAGGCAAGAGGATGGCTTGAGCCCAGGAATTTAAGGTTACTCTGAGGTAGGCTGATGCCTGCGCACTCTAGCCTGGGCAACAGAGTGAGATTCTGTCTCAAAATAAATAAATAAAATAAAAGTAAAA","TAAAAATACAAAAATTAGCCAGGCGTGGTGGCTGGCGCCTGTACTCCCAGCTACTCGGGAGACTGAGGCAGGAGAATCGCTTGAACCCAGGAAGTGGAGGTTGCAGTGAGCCAAGATCGTGCCACTGCACTCCAGCCTGGGCGACAGAGCAAGACTCCGTCTCACAAAAAAAAAAAAAAAAAAAAAAA"
"GL873532","28431979","28432157","chr4","157032804","157032983","42","128600825","GAGAAGAAAACATTAACTGGGCATTCTGATAGGAACCTGTAGTCCTAGCTATTCAAGAGGCTGAGGCAGGAGAATACCTTGAACCCAGGAGTCTGACGTTGCTGTGAGCTAGGCTAGTAACACAGCACTCCAGCCCGGGCAACAGAGTGAGACTTGTCTTTAAAAAAAAAAAAAAAAAA","AAAATAAAAATTAGCCTGACATGGTGGCAGGCACCTGTAATCCCAGCTACTCGGGAGGCTGAGGCAGGAGAATTGCTTGAATCCGGGTGACAGAGGTTGCAGTGAGCCAAGATCGCGCCACTGCACTCCAGCCAAGGCAACAGAGTGAGACTCTGTCTCAAAAAAAAGAAAAAAAAAAAA"
"GL873532","28432422","28432535","chr3","55292012","55292132","36","26859590","GGCCAGGTACAGTGGCTTATGCCTATAATCCTAGCAGAGCTAGGATTGAACTCAGGAGTTTGAGACTGGCCTGATTAAGAGCAAGACCTGTCTCTATTAAAAATAGAAAAAATT","GGCCAGGTGCAGTGGCTCACACCTGGAATCCTAGCACTCAGGGCAATCACCTGAGGTCAGGAGCTCAAGACCAGCCTGGCCAACATGGTGAAACCCTGTCTCTACTAAAAATACAAAAATT"
"GL873532","28773892","28774096","chr4","116777080","116777297","73","88003188","GGATGACCTGAGCTCAGGAGTTAAGCAAGAGTAAGGCCCTATCTCTATTAAAAATAGAAAAATTAGCTGGGTTTTATGGTAGGCACCTATAGTCCTGCCTACATGGTAGGCTGAGGCAGGAGGACTGCCTGAATTTGAGGTTGCCATGAGCTAAGCTGGCACTCTAGCCTGGGCAACAGAAATGGTCTCAAAAAATAAAAAGAGA","CGAGACCAGCCTGGTCAATATGGTGAAACCCCGTCCCTACTAAAAATACAAAAATTAGCCAGGCATGGTGGCAGGCACCTGTAGTCCCAGCTACTCGGAAGGCTGAGGCAGGAGAATCGCTTGAACCACAGAGGCAGAGGTTGCAGTGAGCCGAGACTGCACCACTGCACTCCAGCCTGGGCGACAGAGTGAGACTCAGTCTCAAAAAAAAAAAAAAA"
"GL873532","28774408","28774423","chr1","165727072","165727088","2","136952664","AAACAAACAAAAAAAA","CAAACAAACAAAGAAAA"
"GL873532","30154004","30154129","chr13","86722914","86723028","30","56568910","GGCCGGGTGTGGTGGCTCACGCCTGTTGTCCCAGCACTGTGGGAGGCGGAGGAGGGTGGATCACCTGAGCTCAGCTGAGTTGGAGACTAGCAGAAGATCAGCATGAGCCAGAGTGAGACCCCCTCT","GGCTGGGTGCAGTGGCTGACACCTGTAATCCCAGCACTTTGGGAGGCCGAGGCGGGTGGATCACCTGAGGTCAGGAGTTCAAGACCAGCCTGACCAACATGGAGAAACCCCATCT"
"GL873533","857917","858126","chr11","123356369","123356581","60","122498452","GACCAGGTGCTGTGGCTCATGCCTGTAAATCCCAGCACTCTGGGAGGCCAAGATGGTAGATTGCCTGAGCTCACAGGTTTGAGACCAGCCTAAGCCAGAGTGGGACCTTGTTCCTAAAAATAGCCAGATGTTGTTGCTGCCGCCTGTAGTCCTAGCTACTTGGAAGGCTGAGGCAAGAGAACCATTTGAACTTAAGAATTTGAGGTTGTT","GGACAGGTGCGGTGGCTCATGCCTGTAATCCCAGAACTTTGGGAGGCCAAGGTGGGCTGATCACTTGAGGTCAGGAGTTCAAGACCAACATGGCCAACGTGGTGAAACCCCATCTCTACTAAAAATAGCCAGGCTTGGTGGCTCATGCCTGTAATCCCAGCTATTCGCGAGGCTGAAGCAGGAGAATCACTTTAACTCAAGAGGCAGAGGTTG"
"GL873533","858391","858476","chr19","6911881","6911968","25","6053490","GACTTTGAGATTCCTGTGAGCTAAGATACCACAGCACTCTAATGAGGGTGACAAAGTAAGGCTCTGTCTCAAAAAAGAAAATAAAA","GAGGTGGAGGTGGCAGTGAGCTGAGATCACACTATTGCACTCTAACCTGGGTGACAGGGCAAGACTGTGTCTCAAACAACAACAAAAA"
"GL873533","4473104","4473389","chr15","18525289","18525576","68","14052185","GGCTGGGTGTGGTAGCTCATGCCTGTAATCCCAGCACTCTGGGAGGCTGAGGCAGGTGGACTGCCCTGAGCTCAGAAGTTCAAAACTAGCCTAAGCCAGAGTGAGACCCCCGTCTCTACAAAAAAAAAAAAAAAGCCAGGTGTTGTGGTGGGCACCTGTAGTCCCAGCTACTTGGGAGGCTCAGACAAGAGAATCGCTTAAGCCCAAGAGTTGGAGGTTGCCGTGAGCTCCAAGAGTTGGAGGATGCCATGCCACAAAGTAAGCCTCCGTCTCAGTAAAAAATAAA","GCTGGGTGTAGTGGCTCATGCTTGTAATCCCAGCACTTTGGGAGGCTGAGGCAGGTGGATCACCTGAGGTCAGGAGTTCAAGACCAGCCTGGCCAACATGGTGAAACCCCATCTCTACTAAAAATACAAAAATTAGCCGGGCGTGGTGGCGTGCACCTGTAGTCCCAGCTACTTGGGAGGCTGAGGCAGGAGAATCGCTTTAACCCAGGAGGCGGAGGTTGCAGTGAGCTGAGATTAGGCCACTGCACTCCATCCTGGGCAACTTCGTCTCAAAAAACAAACAAAAAA"
"GL873533","10775026","10775109","chr4","34467293","34467381","20","23692267","GACTGGGCATAGCAGCTCACGCCTATAATCCCAGCACTTTGGGAGGCCAAGACAGGAGACCAACCTGGGGACCAGAGTGAGACC","GACTGGGCCAGGTTCAGGCTCATGCCTATAATCCCAGCACTTTGGGAGGCCAAGGGTGGTGGATCACCTGAGGTCAGGAGTTCGAGACC"
"GL873533","19395984","19396283","chr1","166079981","166080274","73","146683997","GGCCAGGGGTGGGTGGCTCACACCTGTAATCCTAGCACTCTGGAAGGCTACAGCTGGGAGATTGCTTGAGCTCTGGAGTTCGAGACCAGCCTAAGCCAGAGCAAGACCCCATCTCTACTATAAATAGAAAAATTAGCCAGGTGTTACAGCAGGCATCTGTACCCCAACTGCTCAAGAGGCTAAGGCAGGAGGATTCCTTGAACCCAGGAGGAAGAGATTGCAGTGAAGTAGGCTGACATTATAGCACTCTACCCTAGGCAACAGAGCGAGGTACTTCCCCTAAATAAATCAATAAATAAA","GGCCAGGAGTGGTGGCTCACACCTGTAATCCCAGCACTTTGGGAGGTGGAGGTGGATGGATCACCTGAGATCAGGAGTTTGAGACCAGCCTGGCCAACATGTCGAAACCCCATCTCTACTAAAAATACAAAAATTAGCCAGGCATGGTGGTGCGCACCTGTAGTCCCAGCTACTCAGGAGGCTGAGGCAGGAGAATTGCTTGAACCCAGGAGGTGGAGGTTGCAGTGAGCCGAGATCACACCAGTGCACTCCAGCCTGGGCGACAGAGCGAGACTCCATCTCAAAATAAATAAA"
"GL873533","24564316","24564401","chr1","162068592","162068675","16","137504276","GGCCAGGCGCAGTGGCTCACACCTGTAATTCTAGCACTGTGGGAGGCTGAAGTGTAAGGATCTGCTGAGGTCAGGAATTCAAGACC","GGCCAGGTGCAGTGGCTCACACCTGTATTCCTAACACTTTGGGAGGCTAAGATGGGCAGATCACCTGAGGTCAGGAATTCGAGA"
"GL873533","24782266","24782368","chr10","12462206","12462324","32","12320060","GCCGGCACAGTGGCTCACACCTGTAATCCCAGCACTTGGGAGGCTGAGGTAGGTGGATGGCCAGGGCACCCTCAAACTGCATCCCTTACTTTAAGAAAAAAAA","GGCCAGGCACGGTGGCTCACTCCTATAATCCCAGCACTTTGGGAGGCCGAGGCAGGTGGATCACCTGACCAGCCTGGCCAACATACTGAAACCTCTTCTCTGCTAAAAATACAAAAATT"
"GL873533","26282139","26282219","chr10","21051082","21051165","16","5231057","GGCTGGGCGCAGTGACTCATGCCTGTATTCATAGTACTTTGGGAGGCCAAGGTGGGTGGATTACCTGAGCAAGAGTGAGAC","GGCTGGGCGCAGTGGCTCACGCCTGTAATCCCAGCACTTGGGGAGGCTGAGGTGGGTGGATTATCTGAGGTCAGGAGTTCGAGA"
"GL873533","26361218","26361398","chr7","17608776","17608965","52","8752442","GTCTCTACTAAAAATGGAAAAATTAGCCAGGCGTGGTGACAGGCACCTGTTGTCTCAGCTACTGGGGAGACCAAGACAGGAGGACGCTTGAGCCCAGGAGTCTGAAGTTGCTGTGAGCTAGGGTGAGGCCAGGGTACTGTACCCTGGGCAAGACTCTGTGTCAAGAAAAAAAGGTACAAAA","GTCCCTACTAAAAATACAAAAAATTAGCTGGGCCTGGTGGCAGGCACCTGTAATCCCAGCTACTTGGGAAGCTGAGGCAAGAGAATTGCTTGAACCCAGGAGGCAGAGGTTGCAGTGAGCTGACATCAAGCCACTGTACTCCAGCCTAGGCAACAAGAGCAAGACTCTGTCTCAAAAAAAAAAAAAAAAA"
"GL873533","26361677","26361785","chr4","18143723","18143826","30","8217954","GACCAGGCACAGTGGCTCACACCTATAATCCTAACACTCTGGGAGAGGTTGAGCTGGAAAGAGCTCTGAGGTTAGGAGTTGGAGATCAGCCTGACCGAGAGTCTCTACT","GGCCAGGCGCAGTGGCTCACTCCTGTAATCCCAGCACTTTGAGGCTGAGGCAGGCGGATCACCTGAGGTCAGGAGTTTGAGACCAGCCTGGCCGAAACCCCATC"
"GL873533","27779785","27779989","chr9","91529445","91529634","78","63749660","GGCTGGGCATGGTGTCCCAGCGCTGTGGGAGGCTGAGGCGGATGGATCACCTGAGCTCAGCCAAGTTCGAGACCAGCTGAAGACCAGCATGAGGCAGAGTGAGTCAGAGTAAGACCCCGTCTCTACAATAACAACAACAAAAAGCAGCCGGACCTTGTGATTCCAGCTACATGGAGGGCAAGAGAACACTACAGGAGGAAGAAGT","GGCTGGGCATAGTGGCTGCCTGTAATCCCAGCACATTGGGAGGCCGAGGTGGGTGGATCACCTGAGGTCAGGAGTTCGAGACCAGCCTGGCGAACATGGTGAAACCCCGTCTCTACTAATACAAAAACTAGCTGGACATAGTGGCATGCGCCTGTGATCCCAGCTACTCAAGGCAGGAGAATCACTCGAA"
"GL873533","28724287","28724421","chr9","70134986","70135105","34","41410699","GGCCGGGCATGGTGGTGCACGCCTGTAGTCCCAGCGCTATGGGAGGCCGAGGCGGGTGGATCACCTGTACTCAGAGGTTCGAGACCAGCCAAGACCCCCCTGAGCCAAACGAGCCAGAGTGAGATCCCATCTCTA","GGCTGGGCATGGTGGGTCACGCCTGTAATCTCAGCACTTTGGGAGGCCGAGGCAGGTGGATCACCTGCAGTCAGAGGTTTGAGACCAGCCTGACCAACATGGTGAAACCCTGTCTCTACT"
"GL873533","30238189","30238248","chr13","39071279","39071338","18","8833090","GTGGTGGCTCGTGCCTATAATCCTAGCACTTTGAGAGGTCGAAGAGAATGAATTGCTAGG","GGTGGTTCATGCCTGTAATCCCAGCACTTTGGGAGGCTGAGGCCGGCGGATTGCCTGAGG"
"GL873533","30238508","30238754","chr13","10083318","10083562","67","20155190","AAAGAATGAATTGCTGGGGTTAGGAGTTCAAGACCAGCCCAGCCTGAGCAAGAGAGACCCCCACCTCTACTAAAAATAGATAAATTAACAGGCATTGTGGCAGGTACCTGTAGTCCCAGCTACCTGAAAGGCTGAGGCAGGAGGATCACTTGAGAACAAAAGTTTGAGGTTGCTTTGAGCTATGATGATACCTCAGCACTCTACCTAGGGTGACAGGGTAAGGTTCTGTCTCAGGAAAAAGAAAAAA","AGGCGGTGGATGGCCTGGGTCAGGAGTTCAAGACCAGCCTGGCCAACATGGCGAAACCCGACCTCTACTAAAAATAGGAAAATTAACCAGGCTTGGTGGCACACACCTGTAATCCCAGCTACTCTGGAGGCTGAGGCAGGAAAATCGCTTGAAACCGGAGGCAGAAGTTGCAGTGAGCTGAGATCACGCCACTGCACTCCAGCCTGGATGACAGAGCAAGACTCCATCTCAAAACAAGTAAAAAA"
"GL873534","342098","342408","chr2","114043866","114044176","65","113701768","GTCGGGCGCGGTGGCTCTCGACTGTAATCCTAGTGCTCTGGGAGGCTGAGGTGGGTGGATCACCTGAGCTCAGGCGTTGGAGACCAGCCTGAGCAAAAGTGAGACCCGTCTGTACTAAAAATAGAAAAGCTAGTGGAGCGTTGTGGTGGGGCCTGTAGTCCCAGCCACTTGGGAGGCTGAGGCAAGAAAATTGCCTGAGCCCGAGAGTTTGAGGTTGCTGTGAGCTAAGATGATGCCATGGGGCTCTACCCAGGGCAACAAAGTGAGACTCTGTCTCAAAAATAAATAAACAAATAATGAATAAATAAATA","GCCGGGCGCAGTGGCTCAAGCCTATAATCCTAGTACTTAGGGAGGCTGAGGCGGGTGGGTCACCTGAGGTCAGGAATTCAAGACCAGGCTGACCAACATGGTGAAACTCCGTCTCTACTAAAAATACAAAAATTAGCCGTGCGTGGTGGTGTGTGCCTGTAGTTCCAGCTACTTGGGAGGCTGAGGCAGGAGAATCGCTTGAACCCAGGAGGTAGAGGTTGCAGTGAGCTGAGATCATGCCATTGTACTCCAGCCTGGGCGACAGAGTGAGACTCCGTCTCAAAACAAAAACAAAAATGAAAACAAAAAAA"
"GL873534","1058418","1058714","chr1","164598907","164599219","75","163540489","GGCTGGGCATAGTGGCTCATATCTGTAATCCAGGCACTCTGTGGAGCTAAGACGGGCAGATCCCTTGAGCTCAAGAGTTTGAGACCAGCCTGACCAGCAAGACCCCATCTCTACTAAAAATAGAAAAATTAGCCAGGCATGGTGGTGGGTGCCTATCCCAGCTTCTTGGGAAAGTGAGGTAGGAAGATCCCTTGAGACCAGTAGTGTGAGGTTCCTGATGACACCATGACATTCAACTCAGGACAATAGAGTGAGACTTTGTCTCAACAAACAAACAAACAAACAAACAACAAAAAA","GGCTGGACATGGTGGCTCATACCTGTAATCCCAGCACTTTGGGATGCTGAGGCGGGCAGATCACCTGAGGTCAGGAGTTTGAGACCAGCCTAGCCAACATGACAAAACCCCATCTCTACTAAAAATACAAAAATTAGCCAGGCGTGGTGGTGTATGCCTGTAATCCCAGCTACTTGGGAGACTGAGACAGGAGAATTGCTTGAGCCTGGGAGGTGGAGGTTGCAGTGAGCCGAGTTTGCACCACTGTACTCCCAGCCTGGGCGATAGAGTGAGACTCTGTCTCAAAAAGAAAAAAAAAAAAGAAAAGGAGAAA"
"GL873534","6947792","6948033","chr4","114256758","114257014","82","107308966","TGGGAGGCTGAGCTATGTGGAGGAGTTCTAGACCAGCCTGAGAAAGCATGAGACTCTGTCTTTACTAAAAATAGAAAAACTAATTGGGCATTGTGTCTGGTGCCTGTAGTCTCAGCTACTCGGGAGACTGAGGCCAGAGTTTGAGGTTGCTGTCAGTTACAGTGATGCCATGGAGCTCTACGCAAGGCAGCAGAGTGAGACTTGGTGTCAAAAAAGAAAAAAACAAAACCACAACAAAAAAA","GCAGATCACCTGAGGTCAGGAGTTCGAGATCAGCCTGACCAACATGGTGAAACCCTGTCTCTACTAAAAATACAAACATTATCTGGGTGTGGTGACACGTGCCTGTAGTCCCCACTACTCGGGAGGCTGAGGCAGGAGGATCACTTGAACCCGGGAGGTGGACGTTGCAGTGAGTCGAGACCATGCCACTGCACTCCAGCATGGGCGACAGAGCGAGATTCTGTCTCAAAAAAAAAAAAAAAAAAAAAAAAAAAAAA"
"GL873534","10439013","10439067","chr3","49294803","49294865","17","38855790","GTAATCCCAGCACTTGCGAGCCCAAGGCAGGTGGATAGCCTGAACCAGAGTGAGA","GTAATCCCAGCACTTGGGGAGGCCGAGACAGGTGGATCTCCCGAGTTCAAGAGTTTGAGACCT"
"GL873534","12994996","12995250","chr11","47482721","47482989","77","34487725","CTCACACCTATAATCCTAGCACTCTGGGAGGCTGAGGTGGATGGATTGCATGAAGTCACAAGTTCAAGACCAGCCCGAACAAGAGTGAGACCCCCATCTCTAAAAGTAGCCAGGTGTTGTGGCAGGCACCTGTACTCCCAGCTACTCAGGAGGCTGAGGCAGGAAGATAACTTGAGTCCAAGATTCTGAGGTTGCCGTAAGCTAGGACACCATGGCACTCCACTGAGGGCAATAAAGTGAAACACTGTCTCAAAA","CTCACGCCTGTAATCCTAACACTTTGGGAGGCCAAGGTGGGTGGATTGCCTGAGTTCAGCAGCTCGAGACCAGCCTGGACAACACGGCGAAACCCCATTTCTACTAAAATACAAAAAATTAGCCAGGCATGGCAGTATGTGCCTGTAATCCCAGCTACTCGGGAAGCTGAGGCAGGAGAATCACTTGAACCCAGGAGGCAGAGGTTGCAATGAGCCAAGATAGCACCATTGCACTCCAGCCTGGGCAACAGCAAGACTCTGTCTCTAAA"
"GL873534","12995274","12995290","chr3","75534440","75534456","3","62539166","AGTAAAAAATAAACAAA","ATTTAAAAACAAACAAA"
"GL873534","13890380","13890470","chr20","27900350","27900437","17","14009970","GGCTGGACGTGGTGGCTCATGCCTGTGGTCCCAGTGCTGTGGGAGGCCGAGGCGGGTGGATCACCTGAGCTCAGCCAAGTTTGAGACTAGC","GGCCGGGCGTGGTGGCTCATGTCTGTAATCCCAGCACTTTGGGAGGCCGAGGTGGGTGGATCACCTGAGGTCAGGAGTTCAAGACCAG"
"GL873534","16820841","16820854","chr11","40372963","40372976","1","23552122","AAATAAAAAAAAAA","AAATAAAATAAAAA"
"GL873534","16820889","16821167","chr7","28604877","28605165","70","11783988","GGCAGGGTGTGGCAGCTCACACCTGTAATCCTAACACTCTGGGAAGCCTAGATGGGTGGATTGCTTGATCTCAGGAGTTCAAGACCAGCCTGGGTCAGAGTGAGAACCTGTCTATACTAAAAATAGTAAAACTAACTGGGTGTTGTGGTGGGTGCTGTCCCAGCTACTCAAGAGGCTGAGGCAAGAGAATTGCTTGAGCCCAAGAGTCTGAGGTTGCTGTGAGCTAAGATGCCACAGCACTACCCAGATCAACAAAGTGAGACTCTATAACTCCCCCAA","GGCCGGGCGCGGTGGTTCACACCTGTAATCCCAACACTTTGGGAGGCCAAGGTGGGTGGATCACCTGAGGTCAGGAGTTCGAAACCAGCCTGGCCAACATGGTGAAACCCTCTCTCTACTAAAAATACAAAAAGTAGCCGGGTGTGGTGGTGCATGCCTGTAACCTCAGCTACTCAGGAGGCTGAGGCACGAGAATCACTTGAACCCTGGAGTCAGAGGTTGCAGTGAGCCGAGATTATGCCACTGCACTCCAGCCTGGGCAACAGAGTGAGACTCAAAAAAACAAAAA"
"GL873534","17808925","17809201","chr1","125359284","125359563","64","107550359","GGCTGGGCACAGTGGCTCACTGCTGTAATCTTAGCACTTGGGAGGCTGAGGCAGGTGGCCTGCCTGAGCTTAGGAGTTTGAGACCAACTTCAGCCAAGAACAAGACCCCGTCTCTACTAAAAATAGAAAAACTAGCCAGGTGTTGTGTTGGGCGCCTATAGTCCCAGCTACTTGGGAGGCTGAGGCAAGAGGATTGCTTGATCCCAAGAGTTTGAGGTAGCTGTGAGCTGGGATGCCACAGCACCTTACCTAGGGTAACTGAGTGAGACTCTATCTC","GGCCGGGCACAGTGGTTCATGCTTGTAATCCCAGCACTTTGGGAGGCCAAGGCAGGTGGATCACCTGAGATCAGGAGTTTGAGACCAGCCTGGCCAACATGGTGAAATCCCGTCTCTACTAAAAATAAAAAATTAGTGGGTGTGGTGGCGCACGCCTGTAGTCCCAGCTACTCAGGAGGCTGAGGCAGGAGGATTGCTTGAACCCAGGAGGAGGAGGTTGTAGTGAGCCGAGATCACGCCACTGCACCCCAGCCTGGGAAACAGAGTGAGACTCCGTCCC"
"GL873534","17809226","17809236","chr2","30474637","30474647","2","12665411","AATAGAAAAAA","AAAATAAAAAA"
"GL873534","24218903","24218953","chr5","85373418","85373463","10","61154515","AAACTAGCCAGGCATAGTGGTGCATGCCTGTAATCCTAGCTACTCGGGAGG","TAGCCAGGCATGGTGGTGCACACCTGTAATCCCAGCTACTTGGGAG"
"GL873534","24222244","24222306","chr3","32668110","32668173","19","8445866","TGGCAGGCCACCTGTAATCTTAGCACTTTGGGAGGCTGCAAGTGGATCACCTGAGGCCAGGAG","GGTGGCTCATGCCTGTAATTCTAGCACTTTGGGAGGCTGAGATGGGCAGATCACTTGAGGTCAG"
"GL873534","27408544","27408669","chr14","110073522","110073623","44","82664978","AAAAAGTACACAGGCTGTGTGTAGTGGTTTATGCCTGTAATCCCAGCACTTTGGGAGGCTGAGCTGAGCAGATCATTTGAACAATGACTGTGTTAACTGCACTTGAGCCCGGGTGACACAGTGAGA","CGAAAAGTAGCCAGGGGTGGTGGTACTGCCTGTAATCCCAGCTACTTGGGAGGTTGAGGCAGAAGAATTGCTTGAACCCGGGAGGCTGAGGTGGCAGCGAGC"
"GL873534","29375385","29375470","chr6","111928830","111928919","28","82553445","CGTTGGTTCATGCCTATAATCTCAGCACCCTGGGAGGCCTAGGTGGGTGAATCACCTGAGCTAGAGCTAGAGTGAGACCCTATCTC","GGCCAGGCTCAGTGGCTCATGCCTGTAATCCCAGCACTTTGGGAGGCCGAGGTGGGTGAATCACCTGAGGTCAGGAGTTCAAGACCTGCC"
"GL873535","2833264","2833368","chr16","71049107","71049211","38","68215843","GTTAAATCCCGTGAGTTCTTAAAAACAGAAAGCTGGATTTGGTGGTGTGTGCTAGTTATCCCAGGTACGAAGAAGACTGAAGCATGGTTCACTATAACCTAGGAG","TGAAACCCCATCTCTACTAAAAATACAAAATTAGCCAGGTGTGGTGGTGCATGCCTATAATCCCAGTTACTTGGGAGACTGAGGCAGGAGAATCACTTGAACCTG"
"GL873535","8145421","8145688","chr5","184196521","184196803","82","176051100","CTGGGCACAGTGGCTGAAACCTGCAATCCTAGCCTTTGGGAGGCTGAGGTGGGAGGATTGTTTGAGACCAGCCTGAGCAAGAGTGAGACCCCATCTTTACTAAAAATAGAAAAATTATCTGGGTGTTGATGTGGGTGCCTGTAGTCCCTCCCTTGGGAGGCTCAAGCAAGAGGATTGTGTGAACCCAGGAGTTTTGAGGTTGTTGTGAGCTAAGCTGATGCCGCAGTATCCCAGCCTTTAGACAGAGTATTTCATCTAAATAAATAAA","GGCAGGGTGCAGGGGCTCACTCCTGTAATCCCAGCACTTTGGGAGGCTGAGGCGGGCAGATAACCTGAGTTTGAGACCAGCTTGGCCAACATGGTGAAACCCTGTCTCTACTAAAAAAAAAAAAATTAGCCGAGTGTAGTGGCACATGCCTGTAATCCCATCTACTTGGGAGGCCTACAGAAGAATTGTTTGAACCTAGGAGATGGAGGATGCAGTGAGCCAAGACTGGGCCACTGTACTCCAGCCTGGGAGACAGAATGAGACTCCATTTCAAAAAAAGAAA"
"GL873535","8836398","8836543","chr4","88809224","88809366","49","79972826","ACAAAAAAAAAAACAGGAGACCAGCCTGAGCAAAAGTGAGACCCTGTCTCGACTAAAAACAGAAAAACTAGCCAGGTGTAGCGGTGGGCGCTTGTCATCAAAGCTACTTGGGAGGCTGTGACAAGAGAATCACTTGAGCCTAGGAG","ACCTGAGGTCAGGAGTTCGAGACCAGTCTGACCAACATGGTGAAGCCCTGTCTCTACTAAAAATACAAAAATTAGCCGGGCATAGTGGCACATGCCTGTAATCCCAGCTACTTGGGAGGCTGAGGCAGGAGAATTGCCTGAAC"
"GL873535","8836798","8836845","chr1","123145244","123145289","16","114308446","TGGGAGGCCAGGGTGGGTGGATCGCCTGAGCTCAGGAGTCTGAGACCA","AGGCTGAGGGAGGCGAATCACCTGAGGTCAGGAGTTTGAAACCAGC"
"GL873535","10326917","10327051","chr1","29437872","29437991","32","19110955","GCCGGGCGTGGTGGCGCACGCCTGTAGTCCCAGCGCTATGGGAGGCCGAGGCGGGTGGATCACCTGTGCTCAGAGGTTCGAGACCAGCCAAGACCCCCCTGAGCCAAACGAGCCAGAGTGAGATCCCGTCTCTAC","GGCCGGGCGTGGTGGCTCACGCCTGTAATCCCAACATTTTGGGAGGCCAAGGCGGGTGGATCACCTGAGGTCAGAAGTTCGAGACCAACCTGGCCAACATGGTGAAACCCCTGTCTCTAC"
"GL873535","10669698","10669829","chr1","11197428","11197566","36","527730","GGCTGGGCATCGTGGCTCACACTTATAAACCTAGCACTCTGGGAGACTGAGGCAGGTAGGTTGCCTGAGATCATGAGTTCAAGACCAGCCTGAGCCAGAGTGAGATCTTATCTTTAAAAACAGCTGGGCATT","GGCTGGGCGCGGTGGCTCACACCTGTAATCCCAGCACTTTGGGAGGCTGAGGCAGGTGGATCACCTGAGGTCAGGAGTTCAAGACCAACCTGGCCAATGTGGCGAAACCTTGTCTTACTAAAAATACAGAACTTAGCCG"
"GL873535","10670108","10670267","chr6","148611209","148611366","36","137941101","ATAGCTAGGCATTGTGGTGGGTGCCTATAGTCCCAGCTACATGAGAGGCTGAGCAAGAGAATTGCTTAAGACCAAGAGTTTGAGGTTGCAGTGAGCTGTAACACCATGACACTCTACCAAGGGTGACAAAGTGAACTCCGTCTCAAAAAAAAAAAAAGAA","TTAGCTGGGCATGGTGGCAGGTGCCTGTAATCCCAGCTACTCTGGAGGCTGAAGCAAGAGAATCGCTTGAACCCAGGAGGTGTAGGTTGCAGTGAGTCGTGCCACAGCACTCCATCCTGGGTGACAGAGCAAGACTCTGTCTCAAAAAAAAAAAAAAA"
"GL873535","11458250","11458328","chr3","43279501","43279579","27","31821251","GCCTGTAATCCCAGCTAGTCGGGAGGCTGAGGCAGAAACATCTCTTGAATCCAGTTTGAGACCCACCATTAAAAAAAAG","CTGTAATTCCAGCTACTCAGGAGGCTGAGGCAGGAGGATCACTTGGACCCAGGAGTCAGAGGTTGCAGTGAGCTAATAT"
"GL873535","11508852","11509035","chr14","18401116","18401291","47","6892264","GTGGAAAAACTACCAGGCATTGTGGCGGTTGCCTGTCATCCCAGCAACTGGGAGGCTGAGGCAGGAGAAGCACTTGAGCCCAAGAGTTTGAAGTTGCTGTGAGCTATGGATGATGCCTCCACGACGCTCTACCAGGATGACAGAAGACTCTGTCTCAAAAAAAAAAAAGAAAGAAAGAAAGAAA","TTAGCCAGGCGTGGTGGCGCATGCCTGTAATCCCAGCTCCTAGGGAGGCTGAGGCAGGAGAATCGCTTGAACCCAGGAGACGGAGGTTGCAGTGAGTTGGGATCGCGCCACTGCACTCCAGCCTGGGTGACACAGCGAGACTCTGTCTCCAAAAAAAAAAAGAAAGAAAAAAGAAA"
"GL873535","11509304","11509426","chr13","20197511","20197636","29","8688207","GGTGGCTCCTGCCCATAATTTTAGCACTCTGGGAGGCTGAAGCAGGTAGACTGCCTGAGCTCAGAAGTTAGAGACCAGCCTGAGCAAGAGTGAGACCCTATCTCTATTAAAAATAGAAAAACT","GGTGGCTCATGCCTATAATCCCAGCACTTTGGGAGGCTGAGGTCGGTGGATCACCTGAGGTCAGGAGTTCAAGACCAGCCTGACCCAAATGGTGAGACCCTGCCTCTACTGAAAATATAAAAATTT"
"GL873535","13108644","13108836","chr1","51585403","51585587","61","38476759","GGCTGGGAGCAGTCTATACTCACGTCTGTAATCCAAGCACCCTGGGAGGCCTATGCAGATGGACTGCCTGAGATCATGAGAGCTGGGTTTGAGACCAGTGTGAACAAGAGCGAGAGCCCAGTCTCTAAAAAATAGCCGGGCATTGTGGCAGGCACCTGTAGTCCCAGCTACTCAGGAGGTTGACCCAAAAGAA","GGCTGGGTGTGGTGGCTATGGCTGTAATCCTAGCATTTTGGGAGGCTGAGGTGGGTGGATCACCTGAGCTCAGGAGTTCAAGATCAGCCTGGCCAACATGGTGAAACCCCATCTCTATTAAAAATATCTCGGCGTGGTCTTATGCACCTGTACTCCCAGCTACTCAGGAGGCTGAGGCACAAGAA"
"GL873535","13573950","13574001","chr8","38376929","38376986","14","24802979","GGCTTATGCCTGTAATCCTAGCACTCTAGGAGGCTGAGATAGGCAGCACCTG","GTGGTTCAAGCCTGTAATCCCAGCACTTTGGGAGGCTGAAGCTGGCAGATCACCTGAG"
"GL873535","14291309","14291406","chr6","156104904","156104999","28","141813595","CTAAGAGTTTTGAGGTTGCAGTGAACTTAGATGATGCCACTGCACTCTAACCATGCAACAAAGCAAGACTCAGTTTCAAAAAAGAACTAGGAAAAAAA","GGGAGGAGGAGGTTGCAGTGAGCCAAGATCGAGCCACTGCACTCCAGCCTGGTGACAGAGCAAGACTCCGTCTCAAAAAAAAAAAAAAAAAAAAGA"
"GL873535","14749328","14749391","chr1","100916857","100916922","18","86167529","ACATCTGTAATCCTAGCACTCTGGGAGGCTGAGGTGTGTGGATCTCCTGAGCAAGAGTGAGACC","CATGCCTGTAATCCCAGCACCTTGGGAGGCCAAGGTGGGTGGATCACCTGAGGTCAGTAGTTTGAG"
"GL873535","21037525","21037591","chr3","48261745","48261808","19","27224220","AGCTGGATGATGTGGTGAGCGCCTGTAATCCCAGCTACTTTGGGGACAAGAGGGCAAGAGAATCACT","GCTGGGCATGGTGGTGCATGCCTGTGATCCCAGCTACTCAGGAGGCTGAGGCAGGAGAATTGCT"
"GL873535","21037861","21037877","chr5","39968060","39968074","5","18930199","ACTAATAATAACACATT","TAAAAATATGACATT"
"GL873535","23005311","23005510","chr6","55060425","55060623","53","32055114","CCTGATGCAGTGGATCATGCCTATAATCCTAACACTCTGGGAGGCCCAGGCAGGAGGATTGCTTGAAGTCAGGAATTTGAGACCATCTGGAACAAAGCAAGACCCCATTTCTGCTAAAAATAGAAAAATTAGCTGAGTATCGTGATTTGTACCTGTAGTCCCAGCTACTTGTACTTGGGAGGCTGAGGCATGGAAAGTTG","GGCCGGGCGCAGTGCCTCATGCCTGTAATCTCAACACTTTGGGAGGCCAAGGCGGGCAGATCACCTGAGGTCAGGAGTTCGAGACTAGCCTGGCCAACATGGTGAAACCCCGTCTCTACTAAAAATACAAAAATTAGCTGGGTATGGTGGTACGTGCCTGTAATCCCAGCTACTCAGGAGGCTGAGGCAGGAGAATTGC"
"GL873535","30036874","30037098","chr13","33368171","33368368","81","3331297","GGCTGGGCGTGGTGGCTCACGCCTGTTGTCCCAGCTCTGTGGGAGGCCAAGGCAAGTGGATTACCTGAGCTCAGCCGCCTTCGAGACCAGTGGAAGACCAGCATGAGGCAGACCAGACATGACCAGAGTGAGCCAGAGTGAGACCCCATCTCTACAACAACAACAACAACAAAGAAAACAGCCTGACATTGTGATCCCAGCTACATGGGAGGCAAGAGAATCACT","GGCTAGGCATGGTGGCTCATGCCAGTAATCCCACCACTTTGGGAGGCCGAGGCAGGTGGATCACCTGAGGTCAGGAGTTCAAGACCAGGCTGGCCAACATGTTATGATGAGACCCTCATCTCTACTACAAATACAAAAATCAGCTGGGCATGGTGGCAAGTGCCTGTAATCCCAGCTACTTGGGAGGCTGAGGCAGAA"
"GL873535","30074274","30074369","chr7","154286970","154287054","36","124212696","AGACTCCATCTCTACTAAAAATACAAAAATTACCTGTAGGCCCAGATGTTTGGGAGGCTGAGGCAAGAGGATTGCTTGAACCCAGAGCTAGGCAGA","TTATCCAGTCGTGGTGGCACGCACCTGTAATCCCAGCTACTCGGGAGGCTGAGGCAGAAGAATCGCTTGAACCCAGGAGGCGGAG"
"GL873536","2048760","2048820","chr14","475120","475174","25","1573640","CGTAAGTTATGACGGTGCAGCACTCAATCCCAGGTGACTGAGACTCTGGGTCCAAAAAAAA","CTGAGATCAGGTCAGTGCACTCCAGCCTGGGTGACAGAGTGAGATTCCATCTCAA"
"GL873536","2049012","2049108","chr19","43361840","43361933","25","41312828","AAGCCAGGTATTGTGGTGGGCACCTGTAGTCCAAGCTATTCAGGAGGCTAAGGCAAGAGAATTGCTTGAGCCCAAGAGTTGGAGGTTGTTGTAAGTT","CCAGGCGTGGTGGTGCACCCCTGTAATCCCAGCTACTCGGGAGGCTGAGGTGGGAGAATTGCTTGAACCCAAGAGGTGGAGGCTGCAGTGAGCC"
"GL873536","2049132","2049253","chr12","98057966","98058082","26","96008834","GGCCAGGCACAGGTGGCTCACATCTGTAATCCTAACACTCTGGGAGGTGGAGGTAGGTGGATTGCCTGAGATCAGGAGTTCGAGACCAGCCTGAGCAAGAGTGAGACCCCCCTCCCATCTCA","GGCCAGGTACAGTGGTTCACACCTGTAATCCCAGCACTTTGGGAGGCCGAGGTGGGTGGATCGCCTGAGCTCAGGAGTTCGAGACCAGCCCGGGCAACATGGTGAAACTCCGTCTCT"
"GL873536","2100960","2101105","chr7","82843703","82843849","29","80742743","GCCTGGTAGGAGGGTTCATACCTATAATCCTAGCACTCTGGGAGGCTGCTGCAGGTGGATTGCCGGAGGTCAAGAGTTTGAGACCAGCCTGGGCAAAGTGAGACCCCTTCTCTACTAAAAATAGAAAAATTAGCCAGGTGTGGTAG","GCTGGGCGCAGTGGTTCACACCTGTAATCCTAGCACTCTGGGAGGCCAAGGCAGGTGGATCACCTGAGGTCAGGGGTTCGAGACTAGCCTGGCTAACATGGTGAAACCCCGTCTCTACTAAAAATACAAAAATTAGCTAGGTGTGGT"
"GL873536","2503308","2503413","chr3","166690011","166690120","36","164186703","AAATTCTAAAATAAAGAGGGTCCAGTGTGGTGGCTAATGCCTATGTAATCCTAGCACTCGAGGAGGCTGAGGTAGGAGATCACTTGAAGTCAAGATTGCTTGAGGC","TACACATACAAAAAATCAGCTGGGTGTGGTGGTACATGCCTGTAATCCCAGCTACTCAGGAGGCTGAGGCCGGAAAATCACTTGAACCCAGGAGGCAGAGGTTGCAGTGA"
"GL873536","3184754","3185080","chr16","67947207","67947519","85","64762453","GGCTGGGTGTGGTGGCTCACGCCTGTTGTCCCAGCGCTGTGGAAGGCTGAGGCGGGTGGATCACCTGTGCTCAGAGGTTCAAGACCAACATGAGCAAGAGTGAGACCCCATCTCTACCAAAAATTGCCAGGCATTCTGGCAGGCACCTATAATCCCAGCTACTTGGGAGGCTGAGGCTAGAGAATCACTTAAACCCAGGGAACCAGGGGTTGGTGGGGGTTGCTCTGAGCTATGATTCCACAGTACTCCACTGAGTGTCACAAAGTGAGACTCTGTCTCCATTAAAAAAATAAATAAATAAATAAAAGCAAAATTAAAAAAAAAAAA","GGCTGGGCGTGCTGGCTCACGCCTGTAATCCCAGCACCTTGGGAGGCCAAGGTGAGCAGATCACCTGAGGTCAGGAGTTCCAGACCAGCCTGACCAACATGGAGAAACCCCATCTCTATTAAAAATTAGCCAGGCATGGTGGTGCATGCCTATGATCCCAGCTACTTGGGAGACTGAGGCAGGAGAATCACTTGAACCTGGGAAGCGGAGGCTGCAGTGAGCTGAGATCACACCACTGCACTCCAGCCTGGGTGACAGAGCGAGACTCCATCTCAAATAAATAAATAAATAAATAAATAAATAAATAAATAAA"
"GL873536","5657243","5657386","chr7","17802125","17802277","39","12144882","GGCCAAGTGGGGTAGTTCACACCTGTAAGCCTAGCACTCTGGGACGTCGAGGCCTGATTACTTGAGGCCAGGAGTTCAACACCAGCCTGAGCAAGAGCAAGACTTCATCTCTACTAAAACAGAAAAATTAGCCTGGATTTGAAC","GGCCTGGTGTGGTAGTTCACACCTGTAATCCCAGCACTTTGGGAGGCCAAGGCAGGTGAATCACTTGAGGTCAGTAGTTCAAGACCAGCCTGGGCAACATGATAAAACCCCATTACTACTAAAAGAACAAAAATTAGCCAAGCATGGCTGGGT"
"GL873536","5657462","5657634","chr12","78943168","78943341","61","73285706","TGAGAAGTGACTTTTTAGAGAAAAGAGAAATTCCTGGACTAGTCTCCCTAGTCCCAGTTACCAGGGAGACCGAGGCAGAGTTGTAGTGAGCTAGGCTGGTGCCAGGCCACTCTATTGAGGGCAACAGAGTGAGACTCTGTATCAAAAAAAAAAAAAAAAAAAAAAAAGATAAA","TTAGCTGGGCATGGTGGCAGGCACCTGTAATCCCAGCTACTTGGGAGGCTGAGGCAGAATTCCTGGAACCTGGGAGGCAGACATTGCAGTGAGCGGAGGTCGTGCCACTGCACTCCAGCCTGGGCAACAAGAGTGAAACTCTGTCTCAAAAAAAGAAAAAAGAAAAAAAAAAAA"
"GL873536","5916771","5916808","chr9","98246984","98247020","8","92330213","GTAAGACCCTATCTCTACTAGAAATAGAAAAATTAGAT","TAAAACCCCATCTCTACTAAAAATACAAATATTAGCC"
"GL873536","5917090","5917252","chr10","46557810","46557965","51","40640720","TTAGCTAGGCATTCATTGTGACCTGTATTCCTAGTTACTTGGGTTGGTCAGGCTGAGGCAGAAGAGTTCCTTGAATGCAGGAGTTTGAGGTTGCTGTGAGCTAGGCTAATGCTTTGACATCCTAGGTTAGAAAACAGAGTGAAATTCTTGTCTCAAAAATAAA","TTATCTGAGCATGATGGCTGACACCTGTAATCCCAGCTACTTGGGGAGGCTGAGGCAGGAGAATTGCTTGAACCTGGGAGGCTGAGGTTGCAGTGAGCCAAACATGCCACTGCACTCCACCCCGGGAGACAGAGCAAGACTCTGTCTCAAAAAAAA"
"GL873536","13061452","13061544","chr19","33137833","33137927","27","20076381","GCCAAGCATGGTGGCATGTGGCTATAATCTCACCTACTCTGGAGGCTGAGGCAGGAGAATCAGTTGAGCTCAAAGGTGGAGGTTGTATTGAAC","TTAGCTAGGCGTCTGGCGGGTGCCTGTAATCCCAGCTAGTTGGGAGGCTGAGGCAGGAGAATCGCTTGAACCCAGGAGGTGGAGGTTGCAGTGAG"
"GL873536","13310346","13310511","chr1","153219820","153220007","52","139909474","GCGGTGGCTCACACCTGTAATCCCAGCGCTTGGAGTGGGTGGATTGCCTGAGCTCACGAGTTCGAGACCAACCTGAACAAGAGCAAGACCCCCAGCTCTAAAAAATAGCCAGGCGCTGTGGTGGGTACCTGTAGTCCCAGCTTCCTGGGAGGCTGAGGCAAAAGAA","GGCCTGGCACAATGGCTCACGCCTGTAATCCTAGCACTTTGGGAGGCCGGGGTGGGTGGATCACCTGAGATCAGGAGTTTGAGACCAGCCTGGCCAACATGGTGAAACTCCTTCTCTACAAAAATTAGCCAGGTGTGGTGGTGGGTACCTGCAATCCCAGCTATTTGGGAGGCTGAGGCAGGAGAATC"
"GL873536","13310785","13310901","chr7","66856054","66856167","37","53545269","AAGAGAATTTCTTGAACTCAAGAATTTGAGGTTGATGCAAGCTAAGATGCCAGAGCATTCTACAAAGGGTGACCAAATGAGACTTTCTCTAAACAAACAAATAACAAAAAAAAAAAA","AGGAGAACTTCTTGAACCCAGGAGGCGGAGGTTGAGTGAGCTGAGATTGTTGCACTGCACTCCAGGCTGGGTGACAGAGTGACACTCCGTCTCAAAAAAAAAAAAAAAAAAAAA"
"GL873536","13325959","13326045","chr3","123612391","123612479","27","110286432","GTCAAGGGTTGTGGTGGGTACCTATAGTTCCAGCTACCAGGGAGGCTAAGGCAAGAGAATCGCTTTGACCCAAAGAGTTTGAAGTTG","TTAGTTGGGCGTGGTGGCGCATGCCTGTAATCCCAGCTTCTCGGGAGGCTGAGGCAGGAGAATGGCTTGATCCCAGGAGATAGAGGTTG"
"GL873536","13326308","13326440","chr4","18437404","18437537","33","5111096","GGCCAGGCACTGTGGCTCATATCTGTAATCCTAGCACTCTGGGAGGCTGAGGCAGGTGGACTGCCTGCACTCAGGAATTGGAAACCAGCTGACCAAGAGCAGGATTTCCATCTCTAAAGAAATAGCTGAGGAT","GCCCGGCACGGTGGCTCATGCCTGTAATCCTAGCACTTTGGGAGGCTGAGGCAGGTAGATTGCCTGAGCTCAGGAGTTCGAGACTAGCCTGGGCAACATGGAGAAACTCCATTTCTATTAAAATACAAAAAATT"
"GL873536","13520482","13520560","chr9","93194085","93194171","18","79673603","GGCTGGGAGCAGTGGCTCACATCTGTAACAGCACTTTGGGAGGGCAAGGCAGGTGGATTGCCTGAGCAAGAGCAAGACC","GGCCGAGCATGGTGGCTCACACCTGTAATCCCAGCACTTTGGGAGGCTGAGGCAGGTGGATTACCTGAGGTCAAGAGTTCAAGACCA"
"GL873536","15807997","15808076","chr11","8171927","8172005","24","7636070","AAATATTAAAATGTAGATAGGGGGTGGTGCCATCTGTAATCTGCTACTCCAGAGGCTGAGGTAGGAGGATCAGTTGAATC","AAACATTAGCTGGGGTTGGTGGTGTGCACCTGTAATGCCAGCTACTCAGGAGGCTGAGGCGGGAGAATCGCTTAAACTC"
"GL873536","19609267","19609399","chr14","113347968","113348085","46","93738701","ATCTATAGGCCTTGATACTCTGGAGGATGAGTAGGAATCCAAGCGTTGGAGGTTGCTGTGAGCTAGAATGCCACAGCGCCCTACTCAGGGTGACAGAGTGAAACTCTGTTTCAAAAGAGAGAGAGAAAGAGAA","GCTGAGGCAGGATAATCGCTTGAACCCAGGTGGTGGCGGTTGCAGTGAGCTGAGATTGCACCAGTGCACTCCAGCCTGGGTGACAGAGCGAGACTCTGTCTCAAAAAAAAAAAAAAAA"
"GL873536","19609680","19609795","chr7","107772563","107772680","33","88162883","AGGTCAAGGTGGATGGATTACCTGAGCTCAGAAGTTTGAGAACAGCCTGAGCAAGAGAGATAACCAGTCTCTACTACAAAATAGAAAAATCAACTGGGCATTGTGGTAGGCATCTA","GCTGAGGTGGGCAGATTATCTGAGGTCAGGAGTTCAAGATCAGCCTGGCCAACATGGTGAAACCCAGTCTCTACTAAAAATACAAAAAATTAGCTGGGCGTGGTGGTTCATGCCTGTA"
"GL873536","23848517","23848653","chr19","41298958","41299092","28","17450441","GCTGGGCACGGTGGCTCACACCTGTTAATCTCAGCACTCTGGGAGGCCCAGGCGGGTGGATCACCTGAGCTTAGGCGTTCGAGACCAGCCTGAACAGAGTGAGCTTCGTGAGCATTATCTCTACTAAAAATAGAAAA","GGCTGGGCGCGGTGGCTCACACCTGTAATCCCAGCACTTTGGGAGGCCCAGGCGGGTGGATCACCTGAGATCAGGAGTTTGAGACCAGCCATGGCCAACATGGCGAAAACCCTGTCTCTACTGAAAATACAAAAA"
"GL873536","26712748","26712850","chr5","25768079","25768163","34","944669","TAAAAAGCCAAAATTAAGCCTGAGTGTGGTGGCTCACGCTTGTAATCCTAGCTCTCTAGATTGGTGACCCAATCAGCCAAGGCAGGTGGATCACCTGACCCCG","AAAAAACTCAAACAAGGCTGGGCGTGGTGGCTCACACCTGTAATCCCAGCACTTTGGGAGGCTGAGGTGGGTGGATCACCTGAGG"
"GL873537","121531","121627","chr1","25829614","25829692","35","25708083","AAAAATAAAATTATGGGCCAGGCGTGGTGGTTCACGCCTGTAATCCTAGCAGCAGAAAGGCTGAGAAGCAGGCTGGGGCCAGGGGAAGTAGGGTGCA","ATACAAAAATTAGCTGGGCGGGGTAGTGCACAGCTATAATCCCAGCTACTCAGGAGGCTGAGGCAGGAGAATCGCTTGA"
"GL873537","419757","419890","chr1","161382752","161382881","27","160962995","GGTCTGGTGCAGTGGCTCACACCTATAATCCTAGCACTCTGGGAGGCCGAGGTGGGTGGATTACCTGAGCTCACAGGTTCTAGACCAGCCTGAGCAAGCGTGAGATGCCGTCTCTATTAAAAAATAGAAAAACT","GGCTGGACGCAGTGGCTCATACCTGTAATCCCAGCACTTTGGGAGGCCGAGGTGGGTGGATCACCTGAGGTCAGGAGTTCAAGACCAGTCTGGCCATGGTGAAACCCCATCTCTACTAAAAATACAAAAA"
"GL873537","420167","420288","chr14","120998992","120999113","33","120578825","GAAAGCCAGGTGTGGAGGCTCGGGCCTATAATCCTAGCATTTTGGGAGGCAGAGGCAGGTGAATGGCCTGAGCTCACAGGTTGGAGACCAGCCTGAGCCAGAGAGAGACTCCGCCTCTAAAA","GGCCGGGTGTGGTGGCTCACGCTTGTAATCCCAGCACTTTGGGAGGCCGAGATGGGTGGATTGCCTGAGGTCAGGAGTTTGAGACCAGCCTGGCCAACATGGTGAAACCCCGTCTCTACTAA"
"GL873537","984172","984344","chr4","82259338","82259494","54","81275166","GGCCGGGCGTGGTGGCTCGAGCCTGTTGTCCCAGCGCTGTGGGAGGCCGAGGCGGGTGGATTACCTGTGCTCAGAGGTTTGAGACCAGCTGAAGACCTGCCTGAGGCAGAGCCAGAGTGAGACCCCGTCTCTACAAGACAGATGGACTTTGTGATCCTAGCTACATGGGAGGC","GGCCAGGCGCAGTGGCTCATGCCTGTAATCCTAGCACTTTGGGAGGTTGAGGCGGGTGAATTGCCTGAGCTCAGGAGTTTGAGACCAGCCTGGGCAACACAGTGAAACCCCGTCTCTACTAAAACACAAAAAATTAGCCAGGCATGGTGGTGCGGGC"
"GL873537","4338752","4338865","chr1","40266497","40266608","30","35927745","GGCTGAGCACAGCGGCTCACACCTGTAATCCTAGCACTCTGGGAGGCCAAGGTGGGCAAATAACCTGAGCTCAAAGTTCCAAGCCCCAAGAGTCTGGCGGCCACAGTGTAACCC","GGCTGGACACAGGGGCTCACACCTGTAATACCAGCACTTTGGGAGGCCAAGGCGGGCAAATCATCTGAGGTCAGGAGTTTGAGACCAGCCTGGCCAACGTGGTGAAACCCCA"
"GL873537","10793376","10793711","chr7","9758411","9758732","94","1034965","GGCCAGGCGTGGTGGCTCACGCTTGTAATCCTAGCGCCCTGGGAGGCTGCGTCAGGTGGATTGCCCTGAGCTCAGACGGTCGAGACCAGTATGAGCCAGAGTGAGGACCCATCTCTACCAAAAATAGCCAGGCGTTCTGGCAGGCGCCTGTAATCCCAGCTACTTGGGAGGCTGAGGCTAGAGAATCACTTCAACTCAAGGGCCCAAGGGTTGGTGGAGGTTGCTGTGAGCTATGATTCCACAGTACTCTACTGAGGGCCACAAAGTGAGACTCTGTCTCCATAAAAAAAGAAAGAAAGAAAGAAAGAAACTGAAAGCAAAAGTTAAAAAAAAAAA","GGCCGGGCGCGGTGGCTCACACCTGTAAACCCAGCACTTTGGGAGGCTGAGGCAGGTGGATCACCTGAGATCAGGAGTTCGAGACCAGCCTGACCAACATGGTGAAACTAAAAATACAAAAATTAGTTGTGCATGGTGGCATGTACCTGTAACCCCAGCTGCTTGGGAGGCTGAGACAGGAGAACTGCTTGAACTGGGACCTGGGAGGTGGAGGTTGCAGTGAGCCGAGATCCCACCACTGCACTCCAGCCTGGGCTATAGAGTGAGACTCTGTCTCAAAAAAAAAAAAAAAAAAAAAAAAAAAAGAAAGAAAGAAAAAAAA"
"GL873537","14895208","14895352","chr19","41273913","41274057","49","26378705","AAACAAGCTTGGCATGCTGTGGGTGCCTATATTCCCAGCTACTCTGAAGGCTGAGGCAAGAGGATCTCAGTTCTCATTGCTGTGAGCTTATGACACCAGGGCACTCTACCCAGAGTAACAGTGAGACTTTGTCTCAAAAAAAAAA","TATTAGCTGGGCGTGGCGGCAGGTGCCTGTAATTCCAGCTACTCGGAGGCTGAGGCAGGAGAATTGCTTGAACCAGTTGCAGTGAGCTGAGATCGCACCACTGCCCTCCAGCCTGGGAGACAGAGCAAGATTCTGTCTCAAAAAA"
"GL873537","14895642","14895798","chr10","75549241","75549395","44","60653599","GGCCAAATGCAGTGGCTCATGCCTGTAGTCCTAACACTAAGGGAGGCCAAAACAGACGGATCGCCTGAGCTCAGTTCGTGACCTGTCTGAACAAGAGCAAGACCCTGTCTCTACTAAAAATAAATTTAAAAAAAAAAAAAAAAAAAACTAGCTGAAA","GCAGGGTGCAGTGGCTCACACCTGTAATCCCAGCACTTTGGGAGGCTGAGGGAGGTGGATCACATGAGGTCTGGAGTTCAAGACCAGCCTGACCAACGTGGCAAAACCCTGTCTCTACTAAAAATAACAAAAAAAAAAAAAAAAAAAAAAAAAAA"
"GL873537","15263883","15263981","chr20","25251062","25251144","34","9987179","AAGAACAAGACCCCATCTCTACTAAAAATAGAAAAACTAGCTAGGCACAGTGGCTCACACCTATACTCCCCTCTGTAGTCTTGACTAGCTGAATCGCTT","ACCCCATCTCTACTAAAAATACAAAAATTAGCTGGGTGTAGTGGTGCACACCTGTTATCCCAGCTATTTGGGAAGCTGAGGCA"
"GL873537","15516912","15517072","chr7","57521645","57521803","39","42004733","CTAGCTAGGTGTCATGGTGGGCACCTGTAGTCCTAGCTACTTGGGAGGCTGAGGCAGGAGGATCATTTGAACACAAGGATTTGAGGTTGCTGTGTTCTAGGCTGAAGCCATGGCATTCTAGCCTGGGCAACAAAGTGAGACTTCTGTCTCCAAAAAAAAAA","TTAGCTGGGCATGGTGGCGCATGCCTGTAGTCCCAGCTACTTGGGAAGCTGAGGCAGGAGAATCACTTGAACCTGGGAGGTGGAGGTTGCAGTGAGCTGAGATCGCACCGCTACACGCCAGCCTGAGCAACAGAGAGAGACTCTGTCTCAAAAGAAAAA"
"GL873537","15517373","15517507","chr1","26326278","26326413","29","10808905","GGCCAGGCAAAATGGCTCATGCCTGTAACCCTAGGACCTTTGAAGGCTGAAGTGGAAGGATCCTCTGAGGTCAGAAGTTTGAGACAAGCCTGAGCAAGAGCAAAAACCCTGTCTCTACTGAAAATAGAAAAACTA","GGCCTAGCGCAGAGGCTCATGCCTGTAATCCCAGCACTTTGGGAGGCTGAGGCGGGCGGATCACCTGAAGTCAGGAGTTTGAGACCAGCCTGGCCAACATGGTAAAACCCTGTCTCTACTAAAAATACAAAAATTA"
"GL873537","15640092","15640277","chr1","51585403","51585587","47","35945311","GGCCAGGCGTGGTGGCTCATACCTGTAATCCTAGCACTCTAGGAGGCCTAGGTGAGTGGCTTGCCTGAGCTCAGGAGTTTAAGACCAGCCTGAGCAAGAGTGAGACCCTGTCACTAAAAAACAGCTGAGTGTTGTGGCCTGCGCCTGTACTCCCAGCTACTCAGGAGGCTGAGGTAAGTGAATTGC","GGCTGGGTGTGGTGGCTATGGCTGTAATCCTAGCATTTTGGGAGGCTGAGGTGGGTGGATCACCTGAGCTCAGGAGTTCAAGATCAGCCTGGCCAACATGGTGAAACCCCATCTCTATTAAAAATATCTCGGCGTGGTCTTATGCACCTGTACTCCCAGCTACTCAGGAGGCTGAGGCACAAGAA"
"GL873537","17279331","17279432","chr16","71049107","71049211","31","53769776","TATATATAAATAAATAAATAAAAATAGCCAGGTATTGTGGTGGGTACCTATAATCCCAGCTACTTGGGAGGCTAAGGCAAGAGAATCGCTTAAGCCCAAGAG","TGAAACCCCATCTCTACTAAAAATACAAAATTAGCCAGGTGTGGTGGTGCATGCCTATAATCCCAGTTACTTGGGAGACTGAGGCAGGAGAATCACTTGAACCTG"
"GL873537","17279678","17279805","chr1","161382752","161382881","36","144103074","GGCAGGGTACAGTGGTTCATATCTGAAATCCTAGCACTTGGGAGGCCAAGGTAGATAGATTGCCTCAGTTCACTGGTCCAAGACCAGCCCGAGCCAGATCAAGACCCCATCTCTAAAAATAGCCAGGT","GGCTGGACGCAGTGGCTCATACCTGTAATCCCAGCACTTTGGGAGGCCGAGGTGGGTGGATCACCTGAGGTCAGGAGTTCAAGACCAGTCTGGCCATGGTGAAACCCCATCTCTACTAAAAATACAAAAA"
"GL873537","22347566","22347649","chr5","2749400","2749490","18","19598166","GGGCACAGTGGCTCACACCTGCAATCCAGCACTTTGGGAGGACAGGGCAGAACACATGAGGTCAGGAGTTTAAGGCCAGCCTGG","GGCCGGGCATGGTGGCTCACACCTGTAATCCAGCACTTAGGGAGGCCAAGGTAGGCGGATCACCTGAGGTCAGGAGTTTAAGACCAGCCTG"
"GL873537","23710391","23710549","chr6","58863249","58863409","45","35152858","CTAGCCAGGCATTGTGGCTGGCACCGGTAGTTCTAGCTACGTGGAAGATTGAGGCAAGAGGATTGCTCAAGGCCAAGAGTTTAAGGTTCCTGTGAGCTATGATGCCACAGCACTGTACCCAGGGTGACAGAATGAAACTCTGGGAAAAAAACAAACAAA","TTAGCCAGGCATGGTGGCACATGCCAGTAATCCCAGCTACTCAGGAGGATGAGGCAGGAGAATCGCTTGAACCCAGGAGGCAGAGGTTGCAGTGAGCTGAGATTGCGCCACAGCACTCTACCCTGGGTGACAGAAGGAGACTCTGTCTCAAAAAAAAAAAA"
"GL873537","23710841","23710953","chr16","18423850","18423961","29","5286991","GGCTGGGTGCAGTGGCTCCTGCCTATACTTCTAGCACTCTGGGAGGCTGAGGGGGGTCGATTGCCTGAGCTCATGAATTTGAGACCACATCTCTACTAAAAATAGAAAAACTA","GGCTGGGCACAGTGGCTCATGCCTGTAATCTTAGCAGTTTGGGAGGCCAAGGTGGGTGGATCACCTAAGGTCAGGAGTTCAAGACCAGCACTACTAAAAAAATACAAAAATT"
"GL873537","24519844","24520020","chr1","211658524","211658701","43","187138680","TAAATAAATAAAACTATTTTGGCATTGTGGTAGGTGCCTATAATCCCAGCTACTTGGGAGGCTGAGGCAGGATGGCTTGAACCCAGGAGTTTGAGGTTGTTGTGAGCTAGGCTGAGGCCACGGCACTATAGCCTGGACAAGAGAGTGAGACTCTCTCAATAAAAGGAAAAAAAGAAA","TAAAAATATGAAAATTAGCCGGGCATGGTGGTGGGTGCCTATAATCCCAGCTACTTGGGAGACTGAGGCACAAGAATCGCTTGAACCCAGGAGGCGGAGGTTGCAGTGAGCTGAGATCGTGCAACTGCACTCCAGACTGGGCCACAGAGTGAGACTCCGTCTCAGAGAAAAAAAAAAA"
"GL873537","24520281","24520424","chr3","178677039","178677180","38","154156758","GGCCAACTGTGGTGGCTGACTCTTGGAATCCTAGCACTCTAGGAGGCTGAAGTAGTACATCCCTTGAGCTCAGGAGTTCAAGACCAGCTTGAGCAACAGTGAGACCACATCTTTACTAAAAATAGAAAAACTACCTTGGTTGGG","GGCCCGGCGTGGTGGCTTACCCCTGTAATCCTAGCACTTTGGGAGGCCAAGGTGGGTAGATTGCCTGAGCTCAGGAGTTCAAGACCAGCCTGGGAACACGATGAAACCCCATCTCTACTAAAATACAAAAAATTAGCCCGGT"
"GL873537","24528294","24528507","chr18","1878493","1878704","63","22649801","CCAAGCTTGGCGGCTCACGCCTGTAATCCAGCACTTGGGAGGCCTAGGTGGGTGGATTGCCTGACTTCTCAGGTTCAAGACCAGCCTGACCCAGAGAAAGACCCCTTCTCTAAAAAATACCTGGGCGTTGTGGCGAGCGCTTGTAGTCCCAGCTAGTTGGGAGGCTGAGGCAAGAGGAACACTTGAACCTCAAACTTAAGGTTTGCTATTAGAT","GGCCAGGCATGGTGGCTCACGCCTGTAATCCCAGCACTTTGGGAGGCCGAGGCGGGTGGATCACAAGGTCAGGAGTTCAAGACCAGCCTGGCCAACATGGTGGAAGCCCATCTCTACAAAAAATTAACTGGGCGTGGTGGCAGGCACCTGTAATCCCAGCTACTTGGGAGGCTGAGGCAGGGGAATTGCTTGAACCTGGGAGGCGGAGGTTG"
"GL873537","24528606","24528672","chr7","17830794","17830867","26","6697812","AAAAAAAAAGGTTTGCTATTAGGCACTCCAAGGGTGACCAAGTGAGACTCTGTCTCAAAAAAATAAA","TAAAAGAGAGCTGAGTTCACACCACTGCACTCCAGCCTGGATGACAAAGCCAGACTGTGTCTAAAAAAACAAAA"
"GL873537","26202112","26202195","chr9","93194085","93194171","15","66991973","GCCACGCATGGTGGCTCACACTGTAATCCTAGCACTCTGGGAGGTTGAGACAAGTGTATTGCTTGAGCTCAAGAGTTCAACACC","GGCCGAGCATGGTGGCTCACACCTGTAATCCCAGCACTTTGGGAGGCTGAGGCAGGTGGATTACCTGAGGTCAAGAGTTCAAGACCA"
"GL873537","26202223","26202380","chr1","12142710","12142876","54","14059513","AAGAGTTCAAAACCAGCCTGAGCAAGAATGACCCCCACTCTCTAATAAAAATTAGAAAAACTAGCTGGGTATTGTGGCAGGTGCCAGTAGTCCCAGCTCCTGGGGAGGCTGAGGCAAGAGGATCACTTGAGTCCAAAAACGTGAGACCAAAAACGTGA","CTGAGGTCAGGAGTTCGAGACCAGCCTCACCAACACGGTGAAACCCCATTTCTACTAAAAATACAAAAATTAGCCCAGCATGGTGGCATGTGCCTGTAATCCCAGCTCCTCCGGAGGCTGAGGCAGGAGGATCGCTTGAACTGAGGAGGCAGAAGTTGAAGTGAGCC"
"GL873537","26202630","26202713","chr16","39914025","39914109","27","13711395","GCGTAAGATTGCTGTGAACTTTGTTGCCATGGTATTCTGCCCAGGGTAAGAATGAGACTCTATCTAAAAAAAAAAAAAATCAAA","GAGATTGCAGTGAGCTGAGATCATGCCACTGCACTCCAGCCTGGGTGACAGAGTGATACTCTGTCTCAAAAAAAAAAAAAAGAAA"
"GL873538","526633","526749","chr16","71049107","71049211","35","70522474","GAGTGAGTCTTCATCTCTACTAAAAATATTACGAGAAAAATTAAGTGGATACAGTAGCACATGCCTGTAATCCCACTACTTGGGAGACTGAGGCAGGAGGATCACTTGAAGTAGGGA","TGAAACCCCATCTCTACTAAAAATACAAAATTAGCCAGGTGTGGTGGTGCATGCCTATAATCCCAGTTACTTGGGAGACTGAGGCAGGAGAATCACTTGAACCTG"
"GL873538","527039","527148","chr7","40424281","40424390","25","39897242","GACTGGGCACGGTGTCTTACGCCTGTCATCCTAGCACTCTGAGAAGCAGAGGCAGGAGGATCTTCTGAGCTCAGCAGTTCGAGACCAGCCTGATCAAGAGTAAAAGCCCA","GGCCTGGCACAGTGGCTCACGCCTGTAATCCCAGCACTTTGGGAGGCCGAGGCAGGAGGGTCACGAGGTCAGGAGTTCGAGACCAGCCTGACCAACATGGTGAAACCCCG"
"GL873538","1504321","1504584","chr2","123429064","123429333","78","121924743","GCCAGCTGCAGTGGCTGTAATCCTAGCACTCTGGGAGGCTGAGCAGGAGGATCACTTGAGCAAGACTGAGACCCCATCTCTACTAAAAAACATAGAAAAACTAGCTGAGTGTGGTGATGCCCATACTCCCAGCTACTTGGGAGGCTGAGGCAGGAGAATCACTTAACCCCAAGAGTCTGAGGTTGCTGTGAGCTATGATAATGCCCCAGCACTCTACCAAGGCCGACAGAGAGAGACTGTCCCCCCACCCCCAAAAAGAACAAA","GCCGGGCATGGTGGCTCATGCCTGTAATCCTAGCATTTTGGGAGGCAGAGGCAGGCGCATTGCCTGAGCAACATGGTGAAACCCCCTCTCTACTAAAATACAAAAGAAATTAGCTGGGTGTGGTGGTGTGTGCCTGTATTCTTGCTACTTGGGAGACTGAGGCAGGAGAACTGCTTGAACCCAGGAGGCAGAGGTTGCAGTGAGCTGAGATCACGCCACTGCACTCCAGCCTGGGCGACAGAGCAACACTTGTCTCTACAAAAAAAAAAA"
"GL873538","5005203","5005336","chr2","113479953","113480087","28","108474750","GGCCAGGCATGGTGGCTCACACCTATAATCCTAGCACTCTAGGGGAGGCTGAGGAGGGCGGATCCCTTGAGCTGGGGAGTTCAAGATCAGCCTGACAAAGAGCAAGACCCTGTCTACTAATAATAGAAAAAACT","GGCCAGACATGGTGGCTCATGCCTGTAATCCCAGCACTTTGGGGAGGCTGAGGAGGACAGATCACCTGAGGTCAGGAGTTCAAGACCAGCCTGGCCAAATAGTAAAACCCCGTCTCCACTAAAAAAACAAAAATT"
"GL873538","5005621","5005786","chr20","68909877","68910038","44","63904256","GAAAAAATTAGCTGCTGTTGTGGCAGATGCTTCCAGTCCCAGCTACTTGGAAGGCTGAGGGCAGAGAGATGACTTGAACTCAGGAGTTTCACAGTGCTGTGAGCGAGGTGGATGCCAGAGCACTCTAGCCTGGGGTGACAAAGTAAAACTGTCTTGAAAAAAAAAA","AAAAATTAGCCTGGCGTGGTGGCAGGTGCCTGTAATCCCAGCTACTCAGGAGGCTGAGGCAGGAGAATCACTTGAACCTGGAAGGCAGAGGTTGCAGTGAGCCGAGATCGTGCCACTGCACTCCAGCCTGGGTGACAAAGTGACATCCTGTCTTTAAAAAAA"
"GL873538","9911326","9911458","chr14","110073075","110073211","23","100161749","GGCCGGATGCAGCGGCTCATGCCTGTAATTCTAGCACTCTGGGAAGCCAAGGCAGGTGGATTGCCTGAGTTCAGGAGTTTGAGACCAGCCTGAATAAGAGCGAGACCCTGTCTCTGCTAAAAATAGAAAAACT","GGCCGGGTGCAGTGGCTCACGCCTGTAATTCTAGCACTTTTGGAGGCCGAGGCGGGTGGATCACCTGAGGTCAGGAGTTTGAGACCAGCCTGACTAACATGGTGAAACCCTGTCTTTACTAAAAATACAAAAATTTA"
"GL873538","9911732","9911906","chr4","127864075","127864248","36","117952343","AATAAAGTAGAAAAGTTAGCTAGGCATGGTGGCGGGCACCTGTAGTCCCAGCAACTTGGGAGGCTGAGGCAGGAGAATCACTTCAGCCCAGGAGTCTGAGGTTGCTGTGAGCTAGGCTGATGCCACGGTACTCTAGCCTGGGCAACAGAGTGAGATTCTATCTCCAAAAATAAAA","AAAGTACAAAAATTAGCTGGGCATTGTGGCAGGCACCTGTAATCCCAGCTACTCAGGAGGCTGAGGAGGAGAATCACTTGAACCCAGGAGACAGAGGTTTGCAGTGAGCCGAGATCACGCCACTGCACTCCAGCCTGGGTGACAAGAGCGAGATTCTGTCTCAAAAATAAAGAA"
"GL873538","10358766","10358842","chr4","24638016","24638099","14","14279250","GACATGGTGGCTCAGGCCTGTAATCCCAGCACTTTGGGAGGCCAAGGTGGGCGGATCATCTGAGCTAAAGTGAGACC","GCCAGGCATGGTGGCTCATGCCTGTAATCTTAGCACTTTGGGAGGCCAAGGTGGGCGGATCATCTGAGGTCAGGAGTTTGAGAC"
"GL873538","10413484","10413570","chr1","20744253","20744338","13","10330769","GGCTGGGCACGGTGGCTCAGGTCTGTAATCCCAGCACTCTGGGAGGCCAAGATGGGTGGATTGCCTGAGCTCAAGAGCTCAAGACCA","GGCCAGGCACGGTGGCCACGCCTGTAATCCCAGCACTTTGGGAGGCCGAAGTGGGTGGATTACCTGAGGTCAAGAGTTTGAGACCA"
"GL873538","10413841","10414040","chr4","116777080","116777297","65","106363239","CTTAAGACCAGCCTGAGACAGAGCAAGACCCGGTCTCTAAAGACAGCCAGGTATTGTGGCAGGTGCCTGTAGTCCCAGCTACTTGGGAGGCTGAGGTAAAAGAATAGCTTGAGCCCACGAGTCTAAGGTTGCTGTGACACCACACACTGTCACCAAGGGTGACAAAGTGAGACTCTGTCTCAAACAAAACAAAACAAAAA","CGAGACCAGCCTGGTCAATATGGTGAAACCCCGTCCCTACTAAAAATACAAAAATTAGCCAGGCATGGTGGCAGGCACCTGTAGTCCCAGCTACTCGGAAGGCTGAGGCAGGAGAATCGCTTGAACCACAGAGGCAGAGGTTGCAGTGAGCCGAGACTGCACCACTGCACTCCAGCCTGGGCGACAGAGTGAGACTCAGTCTCAAAAAAAAAAAAAAA"
"GL873538","12394284","12394421","chr12","98057966","98058082","39","85663682","GGCCGGTCGTGATGGCTCACGCCTGTTGTCCCAGTGCTGTGGGAGGCTGAGGTGGGTGGATCTCCTGAGCTCAGCCGAGTTCGAGACCAGCGGAAGACCATCATGAGGCACAGTGAGCCAGAGTGAGACCCCGTCTCT","GGCCAGGTACAGTGGTTCACACCTGTAATCCCAGCACTTTGGGAGGCCGAGGTGGGTGGATCGCCTGAGCTCAGGAGTTCGAGACCAGCCCGGGCAACATGGTGAAACTCCGTCTCT"
"GL873538","12394447","12394514","chr17","55602839","55602902","27","43208392","AAAACAGCCAGACCTTGTGATCCCAGCTACATGGGGGGGGCAAGAGAACACTACAGGAGGCAGAAGTT","GGCCAGCACCTGTAATCCCAGCAGGGGAGGCCAAGGCAGGCAGATATCCTGAGGTCAGGAGTTC"
"GL873538","24424617","24424704","chr4","31882236","31882324","18","7457619","GGCCAGGCAAGGCGGCTCACACCTGTTATCCTAGCACTATGGGAGGCCAAGGTGGGCAGATCACCAAAGCTCAACGGTTTGAGAACAG","GGCCAGGCGAGGGGCTCACACCTGTAATCCCAGCACTCTGGGAGGCCAAGGTGGGGGGATCACCTGAGGTCTGAAATTTGAGATCAGCA"
"GL873538","24469217","24469376","chr10","38476851","38477031","62","14007634","CAAGAACGAGACCCCATCTATACTAAAAGTAAAAATACTAGTTGGGCATTGTGATTGGCACCTGTAAGTCCAGGTAGTCAAGAGGCTGAGGCAGGAGGTTGAGGTTGCTGTCAGCTATGATGCCATAGCACTCTAGCTGGGCCAACAAAATGAGACTTTG","ATGGTGAAACTCCATCTCTACTAAAAATACAAAAACTAGCCGGGCATGGTGGTGAGTGCCTGTAATCCCAGCTACTCAAGACACTGAGACAGGAGAATCGCTTGAACCTGGGAGGTTGAAGTTGCAGTGAGCAAGATCGCGCCATTGCACTATAGCCTGGGTGACAGAGTGAGACTCTGTC"
"GL873538","24469653","24469741","chr15","42593880","42593967","21","18124227","GGCTGGGTGCAGTGGCTCATGCTGGTAATCCAGCACTCTGGGAGGCTGAAGCTGGAGGATCACTTGAGCCTGAATAAGAACAAGAACGA","GGCCAGGTGCAGTGGCTCACGCCTGTAATACCAGCACTTTGGGAGGCTGAGGCAGGAGGATCACTTGAGGTCAGGAGTTAAGATCGGC"
"GL873538","24981236","24981329","chr1","148828584","148828670","32","123847348","TAAAAATAAGATCTTTGGCCAGGTGTGGTGGCCCACACCTCTAATCCCAGAAAGCTGGGAGGCCAGGGCTGGAGAATTCCTATGAAAATTCGAG","AAACACAAATAATTGGCCAGGAATAGAGACTCAGGCCTGTAATCCCAGCACGTTGGGAGGCCAAGGCAGATGGATGGCTTGAGGTCA"
"GL873538","25128683","25128858","chr9","27142270","27142451","49","2013587","GCCAAGCGTGGTGGCACATCCTGTGATCCCAGCACTGGGGAGGCCAAGGAGGGTGGATCACCTAAGCTCAGGAGCTGGAGACCAGCCTGAACCAGAGTGAGACCCCATCTATAAAAAAGGCAGGTGTTAGGCTAGGTGACACCTGTAATCCTAGCACTCTGGGAGGCTGAGGTGGG","GGCCGGGCGTGGTGGCTCACACCTGTGATCCCAGCACTTTGGGAGGCCGAGGTGGGTGGGTCACCTGAGGTCAGGAGTTTGAGACCAGCCTCGACATGGCGAAACCCCGTCTCTACTAAAAATACAAAATTAGTTGGGCGTGGTAGTGCATGCCTGTAATCCCAGCTACTCGGGAGGCTGAG"
"GL873539","253828","253930","chr9","98232997","98233093","29","97979169","TGAGCTCAGGAGTTTGAGGTTGCTGTGAAGCCATGGCACTCAACTCAATGGTGACTGAGTGAGACTTTGTCTCAAAAAAAAAAAAAAAAAAAAAGAGAAAGAA","GAGACTGCAGTGAGTTGAGGTCGTGTCACTGCACTCCAGGCTGGGCAACAAAGGAAGACTCTATCTCAAAAAAAAAAAAAAAAAAAGAAAGAAAGAA"
"GL873539","254199","254399","chr1","124900272","124900483","48","124646073","GCAGTGGCTCACATCTGTAATCCTAATACTATGGGAAGCCAAGGCAGGTGGATCCTGTGAGGACAGGAATTCAAGACCAGCCTAAGCAAGAGTGAGACCCTGCCTCTACTAAAAATAGAAAAAACTAGCCAGGCATTGTGGTGGGTGCCTGTAGTCCCAGCTACTCAGGAGGCTGAGACAAGATTGGTTGAGCTCAGGAGG","GCCAGACGCAGTGGCTCACACCAGTAATCCCAGCACTTTGGGAGGCCAAGGCAGGAGGATCACCTGAGGTCAGGAGTTCGAGACCAGCCTGGCCAACATGGTGAAACCCTATCTCTACTAAAAATACAAAAATTAGCCAGGCATGGTGGTGCATGCCTGTAGTCCTAGCCTCTCAGGAGGCTGAGGCAGGAGAATGGCATGAACTTGGGAGG"
"GL873539","257987","258009","chr20","40742927","40742941","10","40484940","CGACATAGTGAGACTCTTGTCTC","CAGGAGAATCGTTTC"
"GL873539","258030","258191","chr1","18496557","18496718","46","18238527","ATTTTTTAAAAAGAGAAAAACTAGCGGGCTAGGGGCACATGCCTGTAGTCCCAGCTACTCGGGAGGCTGAAGCAAGAGGATCGCTTGAACCCGAGAGTATGAGGTTGCTGTGAGCGTAGGCTGTGGCAATGGCACTCTAGCTTGGGCAACAGAATGAGACTC","AAAAGGAAAAAAAATAGCTGGGCATGGTGGCAAGCACCTGTAATCCCAGCTACTCAGGAGGCTGAGGCAGGAGAATTGCTTGAACCTGGGAGGCAGAGGTTGCAGTGAGCAGAGATTGTGCCACTGCACTCCAGCCTGGGCAACAGTATGAGACTCCATCTC"
"GL873539","4181205","4181447","chr10","27024480","27024722","80","22843275","CTGGGCATAGTGTCTCATGCTTGTAATCCTAGCACAGGAGGAACCCTTGAGCTTAGGAATTCTAGACCAGTATGAGCAAGAGCAAGACCCTGTCTCTACTGAATATAGAAAAATTGGCCGGGTGTGCCAAGGGCAGTGGATCACACCTGTAATCTCAGCATTTGGGAGGCCAAGGCAGGTGGACTGCCTGAGTTCACAGGTTTGAGACCAGACTAAGCCAGAGCAAGACCCCATCTCCAAAAA","GGCTGGGCATGGTGACTCAAGCTTGTAATCCCAACTGAGGCAGGTGGATCACCTGAGGTCAGGAGTTCAAGACCAGCCTGGCCAACATGGCGAAACCCTGTCTCTACTGAAAATAGAAAAATTAGCCAGGCATGGTGGCACACGCCTGTAGTCCCAGCTACTTGGGAGGCTGAGGCAGGAGAATTGCTTGAACCCAGGAGGTGGAGGTCACAGTAGGCTGAGATTGCACCACTGCAGTCCAGC"
"GL873539","4234217","4234295","chr1","153294566","153294642","20","149060349","GGATTCCTTAAGGTCAGGAGTTCGAGACCAGGCTGAGCAAAAGCAAGACCCCATCTCTACTAAAAACAAAAAAACTGGG","GGATCACCTGAAGTCAGGAGTTTGAGACCAGCCTGGCCAACATGGCGAAACCCCATCTCTACTAAAATACAAAAATA"
"GL873539","4234567","4234727","chr19","7937810","7937984","44","3703243","CAGAAAAACAGAAAAACAAGCCAGGTGTTATGTCAGTCTTCTGTAATCCCAGCTACTCAGGAGGGTGAGGCAGGAGGATCGCTTGAAGCCAGGAGTTTGAGGTTGCTAAGGTCATGGCACTCTAGCCTGGGGACAGAATGAGACTTTGTCTCAAAAAAAAA","CCCAAAAGTACAAAAATTAGCCAGGCCTGGTGGTACACGCTTGTAATCCCAGCTACTCAGGAGGCTGAGGCAGGAGAATCGCTTGAACCCGGGAGGCGGAGGTTGCAGTGACACGAGATTGCACCACTGCACTCCAGCCTGGGAGACAGAGCGAGACTCTGTCTCAAAAGAAAAA"
"GL873539","9058580","9058687","chr2","192014888","192015004","42","182956308","GTACAATGGCAACACCCACAACTCCAGGACTTTGGGGGCCTGGGTTGGCAGATCCCTCAAAGTCAGGAGTTCTTTATCTTGCTAGGCAAAAGCAAGTCCCCACTTCTA","GGCCAGGCACAGTGGTTCACGCCTATAATCTCAGCACATTGGGAGGCTGAGGTGGGCAGATCACCTGAACTCAAGAGTTTGAAACCAGTCTGGGCAACATGGCAAAACCCCATCTCT"
"GL873539","14872787","14872938","chr12","106042818","106042977","47","91170031","GGTATAGCAACTCACACCTGTAATACCAGCACTCAGAGTCTGAGGGAGAGGATTACTTGAGTCCAAGAGTTTGAGGCTACAATGAGCCATATGACACACACTCTAGCCTGAGCAACAAGACAAATCCTATTTCTAAAAATAAAAACTAAAAA","GGATGTGGTGGCACATGCCTGTAGTCCCAGTTACTCGGAGGCTGAGGCAGGAGAATTGCTTGAATCTGGGAGGTAGAGGTTACAATGAGCTAAGATCACACTACTGCACTCCAGCCTAGGCAACAAGAGCGAAACTCTGTCTCGAAAAAAAAAAAAAAAA"
"GL873539","16379453","16379735","chrX","52442340","52442630","75","36062887","CAGGTGCAGTGGCTAACGTCTGTAATCCTAGCACTCTGGGAGGCCAAGGCAAGTGGACTACCTGAGCTCATGGGTTTGACCAGCCTGAGCAAGTGCAAGACCCATTTCTAAAAAATAGCCAGGTGCTGTGGCGGGCGCCTCTAAGTCCCAGCTACACTGGAGGCTGAGACAAGAGAATTGCTTGAACCCAAGAGTTTGAGGTTGCTGTGAGCTACGGCACCACAGCAATCTACTCAGGGCAATAAATTGAGACTCTGTCTCAAAAACAAACAAAAAAACACCG","CCGGGTGCAGTGGCTCATGCCTGTAATCCCAGCGCTTTGGGAGGCCAAGGCGGGTGGATCACCTAAGGTCAGGAGTTTGAGACCAGCCTGATCTATATGGTGAAACCCCATCTCTATTAAAAATATAACTGGGCGTGGTGGTGCATGCCTGTAGTCCCAGCTACTCGGGAGGCTGAGACAGGAGAATTGCTTGAACCCAGGAGGTGGAGGTTGCAGTGAACCGAGATCACACCACTGCACTCCAGCCTGGGCAACAGAGCAAGACTCCGTCTCAAACAAAAAAAAAAAAAA"
"GL873539","16379934","16379946","chr14","49439829","49439842","1","33059895","AAAAAAAAAAAAA","AAAAAAAAAAAAAA"
"GL873539","17015409","17015547","chr6","56602654","56602794","36","39587245","CCAGCTACTCTACTTTGGAGATTGAGGCAAGAAGATTGCTTGCACCCATGAACTTGAGGTTGCTCTGAACTAGGTTGATGGCATGGCACTCTAGCTTGGGCAACAGAGTGAGACTCTATCTCAAAACAAAACAACAAAA","GTAGTCCCAGCTACTCTGGAGGCTGAGGCCAGAAAATTGCTTGAACCCAGGAGGTGGAGGTTGCAGTGAGCCGAGATCGTGCCACTGCACTCCAGCCTGGGCGACAGAGTGAGACTCTGTCTCAAAAAAAAAAAAAAAAAA"
"GL873539","17015821","17015971","chrX","95100361","95100524","34","78084540","CAGGCACAGTGGCTCACACCTGTAATCCTAGCACTCTGGGAGGCTGAGGTGGGTGGATCAGTTGAGGTCAGGAGTTCTAGACCAGCTGAACAAGAGCAAGATGATGTCTCTATTAAAAATAGAAAAATTGGCCAGGTGTTGTGAACTCTAC","GCCGGGCACATGGTGGCTCACACCTGTAATCCCAGCACTTTGGGAGGCTGAGGTGGGTGGATCACCTGAGGTCAGGAGTTCAAGACCAGCCTGACCAACATGGTAAAACCCGGTCTCTACTAAAAATACAAAAATTAGCCAGGCGTGGTGGTGCATGCCTGTAA"
"GL873539","19069874","19069946","chr15","50500527","50500602","15","31430653","TAGCCATGCATTGTGGTGGCACCTGTAATCCCAGCTACTTGGGAGGCTGAAGCAAGAGAATTGCTTGAGCCTG","TGGCCGGGCATGGTGGTACATGCCTGTAATCCCAGCTACTTGGGAAGCTGAAGCAGGAGAATTGCTCGAACCCAGG"
"GL873539","19070237","19070315","chr17","43908335","43908414","25","24838098","AGGCAGGTGGATTGCCTGAGCTCACGGGTTCGGGACCAGCCTGAGCTAGAGCAAGACCTGGTCTCTAAAGAATAGCCAT","GAGGCAGGTAGATCACCTGAGGTCAGGAGTTTGCGAGCAGCCTGGCCAACGTGGCAAAACCTCGGCTCTACTAAAAATAC"
"GL873540","4843806","4843869","chr17","78867242","78867306","21","74023436","GCACTTTGGGAGGCCCAAGCAGGAGGACCACTGTGGCCAGGAGTTGCAGCTCAACATTTCTGGG","AGCACTTTGGGAGGACAAGGCAGGTGGATCACTTGAGGCCAGAAGTTTAAGACCAGCCTGGCCAA"
"GL873540","8741552","8741619","chr15","77742050","77742130","22","69000498","AGCTGGGCATGGTGGCTCAAGCCTATAATCATAGCTGGGTAGGAGGATCACTTGAAGTCAAGAGTTTA","GGCTGGGCATGGTGGCTCATGCCTGTAATCCCAGTATTTTGGGAGGCTGAGGTTGGGGGATCACCTGAGGTCAGGAGTTTG"
"GL873540","16765150","16765306","chr6","58863249","58863409","39","42098099","CTAGCTAGGCACTGTGGCAGACTCCTGTAGTCCCAACTACCTGTGAGGCTAAGACAAGAGAATTACTTGAACCCAAGAATTTGAGGTTGTTGTGAGCTAAGATGCCATGGCACTCTACCAAGGGTGACCAAGTGAGACTCTGTCTCAAGAAAAAAAA","TTAGCCAGGCATGGTGGCACATGCCAGTAATCCCAGCTACTCAGGAGGATGAGGCAGGAGAATCGCTTGAACCCAGGAGGCAGAGGTTGCAGTGAGCTGAGATTGCGCCACAGCACTCTACCCTGGGTGACAGAAGGAGACTCTGTCTCAAAAAAAAAAAA"
"GL873540","16765591","16765720","chr7","31909624","31909758","24","15144033","GCTGGGTGCGGTGGCTCATGCCTGTAATCCCAGCACTTGGGAGGCTGAGGTGGATGGATTGCCTGAACTCAGGAGTTTGAGACCAACCTGAGCAAGAGTGAGACCCTGTCTCTAAAAAATAGGCAGGCAT","GCTGGGTGTGGTGGCTCATGCCTGTAATCCCAGCACTTTGGGAGGCTGAAGTGAGTGGATTACCTAAAGTCAGGAGTTTGAGACCAGCCTAGCCAGCATGGTGAAACCCTGTCTCTACTAAAAATACAAAAATTA"
"GL873540","17238528","17238614","chr16","4764895","4764982","16","12473633","GGCCGGGTGTGGTGACTCACGCCTGTTGTCCCAGCGCTGTGGGAGGCAGAGGCAGGGATCACCTGTGCTCAGAGGTTGGAGACCAGC","GGTCGGGTGTGGTGGGTCACGACTGTAATCCCAGCACTTTGGGAGGCCGAGGCAGATGGATCACCTGAGGTCAGAAGTTCGAGACCAG"
"GL873540","19109133","19109170","chr15","47991746","47991773","11","28882613","TGAAATGAGATTCTGTCTCAAAAAAAATAAGAAGAAAA","GAATATGTCTCAAAAAAAAAAAAAAAAA"
"GL873540","19109450","19109715","chr8","90559104","90559376","79","71449654","GGCTGGACATGGTGGCTCACACCTGTAATCTTAGCACTCTGGAAAGCCTGGGTGGGTAGATGGTTGAGACCAGCCTGACCAAGAGCAAGACCCCATCTCTACCAAAAATAGAAAATCTATCTGAGTAGCTGAGCATTGTGGCAGGTGCCTGTAATCCCAAGTTAACTCAGGAGGCTGAAGCAAGAATCACTTGAACCTAAGAGTTTGAGATTGCTGTGAACTAGGATGCCACAGCACTCTACTGAGGGTGACAAAGTGAAATGAGA","GGCTGGGCATAGTGGCTCACACCTGTAATCCCAGCACTTTGGGAGGCTGGGTGACCTGACGTCAGAAGTTTGAGACCAGCCTGGCCAACACGGTGAAACCCCATCTCTACTAAAAATACAAAAATTAGCTGGGCTTGGTGGCATGTGCCTGTAATCCCAGCTACTCGGGAGGCTGAGGCACGAGAATCGCTTGACCTGGGAGGCAGAGGTTGCAGTGAGCTGAGATCATGCCACTACACTCCAGCCTGGGCAGCAGAGCACGACTCTGTCTCA"
"GL873540","19331245","19331378","chr20","11318695","11318829","28","8012550","GGCCAGGCATGGTGACTCCCACTTATAATCCCAGCACTCTGGGAGGCCAAGATGGGTAGACTACTTGAGTTAAGGGGTTTGAGACCAGCCTGAGCAAGAATGAGACCCCAGTTTCTACTAAAAACAGAGAAACA","GGCCGGGCATGGTGGCTCACACCTGTAATCCCAGCACTTTGGGAGGCCAAGGCGGGTGAATCACTTGAGGTCAGGAGTTTGAGACCAGCCTGACCAACATGGTGAAACCTCATCTCCACTAAAAAAATACAAAAA"
"GL873540","19331612","19331778","chr2","150256571","150256736","46","130924959","GAAGAAAAACAAGTCAGGCATAGTGGTGCACACCTGTAATACCAGCTATTCAGGAGGCTGAGGCAAGAGGATCACTTGAGCCCCAGACGTTGCTATGAGCTAGGATGACACCATGGCACTCTACCCAGGGTGAGAGAGTGAGACTGTCTCAGGAAAAAATAAATAAA","AAGTAGCTGGATGTGGAGCACATGCCTGTAGTCCCAGCTACTCAGGAGGCTGAGGCATGAGAATCACTTGAGCCTGGGGGGCAGAGGTTGCAGTGAGCTGAGATCACGCCACTGCACTCCAGCCTGGGTGACAGAGTGAGACTCTGTCTCGAAAAAAAAAAAAAAA"
"GL873540","19356546","19356681","chr1","29437872","29437991","30","10081326","GGCCGGGTGTGGTGGCGCACGCCTGTAGTCCCAGCGCTATGGGAGGCCGAGGCGGGTGGATCACCTGAGCTCAGAGGTTCGAGACCAGCCAAGACCCCCCTGAGCCAAACGAGCCAGAGTGAGACCCCGTCTCTAC","GGCCGGGCGTGGTGGCTCACGCCTGTAATCCCAACATTTTGGGAGGCCAAGGCGGGTGGATCACCTGAGGTCAGAAGTTCGAGACCAACCTGGCCAACATGGTGAAACCCCTGTCTCTAC"
"GL873540","19786720","19786797","chr6","178365810","178365885","23","158579090","ATGAAACACTAGCCAGGCATTGTGGCAGGCACCTGTAATCCCATGTAGTTGGGAGGCTGAGGCAAGAGGATCACTGGA","CATACATAGCCAGGCACGGTGGCACATGCCTGTAATCCCAGCCCTCTGGGAGGCCGAGGCTGGTAGATCACTTGAA"
"GL873540","19787058","19787182","chr3","48450078","48450206","27","28663020","GTGGTGGCTCACACCTGTAATCCTAGCACTCTGGGAGGCCAAGGTGGGTGGATTGCAGGAGCTCAGGGGTTAGAGACAAGCCTGAGCAAGAGTGAGACCCCATCTCCACTAAAAATGAAACACTA","GTGCGGTGGCTCACACCTGTAATCCCAGCACTTTGGGAGGCCGAGGCGGGTGGATCACCTGAGGTCAGGAGTTTGAGACCAACCTGGCCAACATGGTGAAACCCCATCTCTACTAAAAACACAACAATT"
"GL873540","24067403","24067492","chr16","4764895","4764982","14","19302508","GGCCGGGTGTGGTGGCTCACACCTGTTGTCCCAGCACTTGGGAGGCCGAGGCAGGTGGATCACCTGAACTCAGCCGAGTTCGAGACCAGC","GGTCGGGTGTGGTGGGTCACGACTGTAATCCCAGCACTTTGGGAGGCCGAGGCAGATGGATCACCTGAGGTCAGAAGTTCGAGACCAG"
"GL873541","2443359","2443541","chr3","182692191","182692383","58","180248832","GGTGGCTCATGCCTGTAATCCTAGCACTCTGGGAGGCCGAGACAGGTGAATTGCCTGAGCTCAGAGGTTCAAGACCATCCTGAGCTGGAGTGAGCCAGAGTGAGACCCTGTCTCTACCCAAAAAAGCTGGGTGTTATGGCTGGCACCTGTAGTCCCAGCTACTTGGAAGGCAAGATAATCACT","GCATGGTGGCTTACACCTGTAATTCCAGCACTTTGGGAGGCTCAGGCAGGTGGATCACCTGAGGTCAGGAGCTCAAGACCAGCCTGGCCAACATGGCGAAACCCTGTCTCTACTAAAAATCCAAAAATTAGCTGGGCGCAGTGGCGTGCACCTGTAATCCCAGCTACTCAGGAGACTAGGCAGGAGAATCACT"
"GL873541","13471362","13471453","chr4","31882236","31882324","23","18410874","GGCCAAGAGCTGTGGCTCACTCCTGTAATCCCAGAACACTAGGAGGTCAAGGAAGGCATATCACCTGTGCTCACACATTTGAGATCAGCCTG","GGCCAGGCGAGGGGCTCACACCTGTAATCCCAGCACTCTGGGAGGCCAAGGTGGGGGGATCACCTGAGGTCTGAAATTTGAGATCAGCA"
"GL873541","17101572","17101746","chr1","188955699","188955870","47","171854127","ACCATCTCTACTCTAAATATAAAAAATTAGCTGGGCATGTGGTAGGCACCTGTAGTCCCAGCTACTTGGGAGGCTGAGCCAGGAAGACCACTTGAACCCAGGAATCTGAGGTTGCTGTAAGCTAGGCTGACACCACCATGGCACTCTAGGCTGGACAAGAATGAGAATCTGTCTC","CATCTCTACTAAAAATACAAAAATTAGCCGGATGTGGTGGTGAGCACCTGAAATCCCAGCTACTCGGGAGGCTGAGGCAGGAAAATTACTTGAACCCAGGAGGCAGAGGCTGCAGTGAGCCAAAAGTGCACCACTGTACTCCAGCCCGGGTGACAGAATGAAACTCCATCTC"
"GL873541","17102013","17102121","chr12","88112976","88113081","25","71010963","GGCCAGGTGCGGGGCTCATGCCTGTAATCCTAGCACTCTGGGAGGCTGAGGCAGGGGAATGATTGCTTGAAATTAGGAGTTCGAGACCAGGCTGAAAATGCATCTCTAA","GGCCAGATGCAGTGGCTCATGCCTGTAATCCCAGCACTTTGGGAGGCTGAGGCAGGCGGATCACCTGAGATCAGGAGTTTGAGACCAGCCTGGCCAACATGGTAAA"
"GL873541","18269299","18269403","chr2","74327279","74327379","24","56057980","GGCTGGCTTCAGTGGCTCACATCTATAATGCTAGCCCTTTGGGAAGCCAAGACAAGTGGATCACCTGAGCTCAGGAGTTCAAGACCACCCTATCTCTACTAAAAA","GGCCGGATGCGGTGGCTCACGCCTGTAATCCTAGAACTTTGGGAGGCCAAGGCAGGTGGATCACCTGAGGTCAGGAGTTTAAGACCAGCCTACCAACATGG"
"GL873542","110885","111081","chr19","6045933","6046125","62","5935048","CCAGCCTGACCAAGAGCAGGACCCCATCTCTATTAAAAATAGAAAAACTAGCTGGGCACTGTGGCAGACACCTATAGTCCCAGCTACTCAGGATGCTGAGACAAGAGAATCACTTGAGTTTGAAGTTGCTATGAGCTAGGCTGACACCATGGCACTCTATGCAGGGTGATGGAGGGAGACTCTGTCTTCAAAAAAAA","CAACATGGAGAAACCCCGTCTCTACTAAAAATACAAAATTAGGCAGCGTGGTGGTGGGTGCCTATAATCCCAGCTACTCAGGAGGCTGAGGCAGGAGAATCGCTTGACCGGGAGTGGAGGTTGCGGTGAGCTGAGATTGCACCATTGCACTCCAGCCTGGGCAACAAGAGTGAAACTCCGTCTCAAAAAGAAA"
"GL873542","111367","111457","chrX","25814002","25814092","20","25702635","GGCAGGGCCTTGTGGCTCACCCCTTTAATCCCAGCCTGGGAGACTGAGGTGGGTAGATTGCTTGAGCTCAGGAGTTTAAGACCAGCCTGAT","GGCTGGGAATGGTGGCTCACACCTGTAATCCCAGCACTTTGGGAGGCTGAGGTGGGCAGATCACCTGAGGTCAGGAGTTTGAGATCAGCCT"
"GL873542","359154","359248","chr15","94696541","94696637","28","94337387","GGCCAGGTGCAGTGGCTCACACCGATAAGCCCAGAACTTTGTGAGGCCAAAGGAGGCAGCTTAACAAAGCCAAAGTCTGGAGGCTGCCCTCTGAG","GGCTAGGTGCAGTGGCTCACATCTGTAATCCCAGCACTTTGGGAGGCCAAGGCAGGCAGATCACCTGAAGTCAGGAGTTTGAGACCAGCCTGGCCAA"
"GL873542","878688","878885","chr3","42454790","42454988","60","41576102","GCCTGTAATTCTAGCACTCTGGGAGGCCAAGGCACACAGACTGCTTGAGCTCAGGAATTCCAGACCAGCCTGATCCAGAGCGAGACCGATCTCTACTAAAAATAGGAAAAATCACCGGGCAGTGGTGGGTACCTGTAGTCCCACTACTCTGGAGGCTGAGGCAAGAGAATCTCTTGAGCCCAAGAGTTTGCAGTTTTG","CTGTAATCCCAGTTCTTTGGGAGGCCGAGGCAGGCGAATCACCTGAGGTCAGGAGTTCGAGACCCGCCTGGCCAACATGGTGGAACCCCGTCTCTACTAAAAATACAAAAATTAGCCGGGTGTGGTTGCACACGCCTGTAATCCCAGCCACTCAGGAGACTGAGGGAGGAGAATCCCTTGAACCCGGGAGGTGGAGATT"
"GL873542","878976","879081","chr9","15168921","15169032","34","14289945","CAGAGCCCAAGAGTTTGAGGTTGCTGGGAGCTATAACGCCACGGCACTCGGTGTGTCAGAGTGAGATTCTGTCTCAAAAGATTTTAAAAAAGAGTGAAAAAGAGAA","TTGAACCCATGAGTTGTAGGTTGAAAGGAGCTGAGATCACACCACTGCACTCCAGCCTGGGTGACAGAGTGAGACTCTGTCTCATAAAAAAAAAAAAAAAAAAAAAAAAGAA"
"GL873542","1385720","1385987","chr11","88915821","88916096","75","87530101","GGCTGGGGTGGCTTATGCCTATAATTCTAGCACTCTGGGAGGCCAAGGTGGGTGGACCACCCTGAGCAAGAGTAAGACCCCCCCTCTCTACTAAAAATAGTAAGACTATCTGGGTGTTTTGGCGGGCACCTGTGGTCCCAGCTATGTGGGGAGACTGAGGCAAGAGAATCGCTAGAGCCCAAGAGTTTGAGGTTGCTGTCAGCTGTTATGCCATAACACTCTACTCAGGGCAACAGAGTAAGACTCTCTCTGAAAAACAAACAAAACA","GGCTGGGCATGGTGGCTCACGCCTATAGTCCCAGCACTTTGGGAGGCCAAGGCAGGTGGATCACCTGAGGTCAGGAGAAACCCCGTCTCTACTGAAAATACAAAAATTAGCCAGGTGTGGTGGCGTGCACCTGTAATCCCAGCTACTCAGGAGGCTGAGACAAGAGAATTGCTTGAACCCAGGAGGCGGAGGTTGCAGTGAGCCAAGATGGCACCACTGTACTCCAGCCTGGACAACAAAGTGAGACTCCATCTCAGAAAAAAAAAAAAAAAAAAA"
"GL873542","1879603","1879861","chr5","80767955","80768224","64","78888352","GACCAGAGGCGGCTGCTCATGCCTATAATCTTAGCACTTTGGGAGGCCAAGGCAGGCAGATTTCATGAGTTCAGGAGTTTGAGACCAGCCTGAGCAAGAATGAGACCCTGTATTTACTAAAAATAGAAAAACTAGCTGGGATTGTGGTGCATGCCTGTAGTTCCAGCTACTTGGGAGGCTGAGGCAAGAGAATTGCTCAATGCTATAGCACTCTTCCCAGGGTAATAGAATGAGACTGTCTCCAAAAAAAAAAAAAAAA","GCCAGGCGCAGTGACTCACGCCTATAATCCCAACACTTTGGGAGGCTGAGGTGGGCAGATCACCTGAGGTCAGGAGTTTGAGACCAGCCTGACCAACATGGTGAAACTCTGTCTCTACTAAAAATACAAAAATTAGCTGGGCGTGGTGGTGCACGCCTATAATTCCAGCTACTTGGGAGACTGAGGCAGGAGAATTGCGTGCCATTGCACTCCAGTCTGGGTGACAGAGTGAGCATCCGTCTCCAAAAAAAAAAAAAAAAGAAAGAAAAA"
"GL873542","9268581","9268712","chr6","76961115","76961239","33","67692534","GGCCAGGCACAGTGGCACATGCTTATAATCTCAGCATTTTGGCAGACTGCCATAGGTGGATCACCTGAGGCCAGGAATTAGAGGCCAGCCTAAGCAACATGGTGACACCCTAATTATAACAATTAGCTGTGC","GGCCAGGCACAGTGGCTCATGCCTGTAATCCCAGCACTTTGGAAGGCTGAGGCAGGCGGATCACCTGAGGTCAGGAGTTCGAGACCAGCCTGGTCAACATGGTGAAACCCTGTTTCTACTGAAAA"
"GL873542","9278719","9278840","chr1","223216208","223216332","26","213937489","GGCTGGGCACAGTGTCTCATGCCTGTAATCCCAGCACCCTGGGAGGCCAAGGCAGACAGATCACCTTTGCTCAGGAGTTTGAGACCAGGCTGAACCAGAGTGATACTTCATCTCTAAAAATA","GGCTGGGCACGGTGGCTCATGCCTATAATCCCAGCACTTTGGGAGGCCAAGGTGGGTGGATCACGTGAGATCAGGAGTTCGAGACCAGCCTGGCCAACGCAGTGAAACCTCATCTCTTTAAAAAT"
"GL873542","9346825","9346956","chr2","188339337","188339471","32","178992512","GGCTGGGAATGGTGGCTCACGCCTATAATCCCAGCACTTGGGAGGCCGAGGTGGGTGGATTGCCAGAGTTCACAGGTTCAAGACCAGCCTGAACCAGAATGAGATGCTTTTTCTAAAAAATAGCCGGGAATT","GGCCGGGCGCGGTGGCTCACGCCTGTAATCCCAGCACTTTGGGAGGCCGAGGTGGGCAGATCACCTGAGGTCGGGGGTTCAAGACCAGCCTGACCAACATGGAGAAACCCCTTCTCTACTAAAAATACAAAAATT"
"GL873542","9347209","9347298","chr10","83091251","83091329","24","73744042","CCCTGACTAGGCCAGGCACAGTGAGTGGCTCATGTCTATAATCTTAGCCCTCTGGGAGGCCGAGGCAGGAGGATTGCTTGAGCTCAGCAG","GGCCAGGTGTGGTGGCTCATGTCTGTAATCGTAGCACTTTGGGAGGCCAAGGCAGGTGGATTGCCTGAGCTCAGGAGTT"
"GL873542","10417238","10417304","chr17","78867242","78867306","22","68450004","AATCGTAGGATTTGGGAGGTCCCGGCAGGCGAGGTACTTAAGGCCAGGAGTTTGAGACCAGTCTGAG","AGCACTTTGGGAGGACAAGGCAGGTGGATCACTTGAGGCCAGAAGTTTAAGACCAGCCTGGCCAA"
"GL873542","13112650","13112756","chr1","162965651","162965765","42","149853001","GGCCTGGTGGGGTGGCTCCTAGCTTTCTGGGAGGTTAAAGAAGGAGGCTCCCATGAGCTCAGGAGTTCAAGAACAATACCTTGTCTCTACTGTCTCTACTAAAAATA","TGGCTCACGCCTGTAATCCTAGCACTTTGGGAGGTTGAGCGGGGCAGATCACTTGAGGTCAGGAGTTCAAGGCCAGCCTGACCAACATGGTGAAACCCTGTCTCTACTAAAAATA"
"GL873542","17254453","17254539","chr9","52134422","52134508","15","34879969","GGCTGGGCACAATAGCTCACGTCTGTAATCCCAGCACTCTGGGAGGCTGAGCAGCTGGATCATCTGAGCTCAGGAGTTTGAGACCAG","GGCTGGGAGCAGTGACTCACGCCTATAATCCCAGCACTTTGGGAGGCTGAGGCAGATGGATCACCTGAAGTCAGGAGTTCGAGACCA"
"GL873542","21513582","21513666","chr9","93194085","93194171","14","71680503","GGCCAGGCATGGTGGCTCAGCCTGTAATCCCAGCACTCGGAAAGGCTGAGGCAGGCAGATTGCCTGAGCTCAGGAGTTCAAGACC","GGCCGAGCATGGTGGCTCACACCTGTAATCCCAGCACTTTGGGAGGCTGAGGCAGGTGGATTACCTGAGGTCAAGAGTTCAAGACCA"
"GL873542","22582799","22582894","chr1","14713934","14714033","32","7868865","CAAACAAAAAATTGCCATGAGCTATGATACAACAGTACTCTACAGAAGGTGACAAAGTAAGACTGCTTCAAAAAAAAAAAAAAAGAAAGAAAGAAA","GGGAGGCAGATGTTGCAGTGAGCTAAGATCATACCACTGCACTCCAGCCTGGGGGACAGAGTGAGACTCCATCTCAAAAAAAAAAAAAAAAAAAAAAAAA"
"GL873542","22582991","22583197","chr15","3406231","3406455","63","19176760","GTGGCTCATGCCTACAATCCCAGCACTTGGGAGGCCAAGATGGGCAGACTGCCTGAGCTCACAGGTTCAAGACCAGCCTAAGCAAGAGTGAGACCCCATCACTAAAAAATAGCCAGGCATTGTGGGGGGCGCCTGTCATTCCAGCTACTTGGAAGGCTAAGGCAAGAGAATCTCTTGAGCCCAAGTATTTAAGATTGCTATGAGCTA","GGCCAGGTGAGGTGGCTCACGCCTGTAATCCCAGCACTTTGGGAGGCCGAGGCGAGCAGATCGCCTGAGGTCAGGAGTTCAAGACCAGTCTGACCAATATGATGAAACCCAACTCTACTAAAAATTAGCCAGGCATGGTGGCGTGCACCTGTAATCCCAGCTACTCCGGAGGCTGAGACAGGAGAATCACTTGAATCTGGGAAGTAGAGATTGCAGTGAGCCAAG"
"GL873542","22909324","22909519","chr6","63999829","64000000","59","41090505","GGCCGGGCGTGGTGGCTCACGCCTGTTGTCCCAGCGCTGTGGGAGGCCGAGGAGAGTGGATCACCTGTGTTCAGAAGTTCGAGACCAGCTGAAGACTCGCCTGAGGCAGAGTGAGCCAGAGTGAGACCCCATCTCTACTACAACAACAAGAAGACAGCCGGACCTTGTGATCCCAGCTACATGGTGGGCAAGAGAA","GGCCGGGCGGGGTGGCTCACGCCTGTAATCCCAGCACTTTGGGAGGCCAAGGTGGGTGGATCACCTGAGGTCAGGAGTTCAAGACCAGCTTGGCCAACATGGCAAAACCCCATCTCTACTAAAAAATACAAAAATTAGCCAGGTGTTGTGGTGCATGTCTGTAGTCCCAGCT"
"GL873543","981057","981192","chr7","52682488","52682622","22","51701431","GGCCGAGTACGGTGGCTCACGCCTGTAATCCTAACACTCTGGGAAGCCGAGGCAGGTGGATTGCCTGAGCTCAGGAGTTCAAAACCAGACTGAGCAAAAGTGAGACCCCATCTCTACTAAGAATAGATAAAGTATT","GGCCGGGCACGGTGGCTCATGCCTGTAATCCCAGCACTTTGGGAGGCCGAGGCAGGTGGATTGCCTGAGTTCAGGAGTTCAAGACCAGCCTGGCCAACATGGTGAAACCCCGTCTCTACTAAAAATACAAAAATT"
"GL873543","981313","981450","chr19","44140824","44140969","40","43159511","TAGCTGGGTGTGTGGTGGGCACCTGTAGTCCTAGCTACTCAGGAGCTGAGGCAAGAGAATCGCTTAAGCCCAGGAGTTGGAGGTCACTACGTCCCCATGGCACTCTATTAAGGGCAACAAAGTGAGACTCTGTCTTAA","TAGCCGGGCGTGGTGGTGGACACCTGTAATCCCAGCTACTCAGGAGGCTGAGGCAGGACAGTCTCTTGAACCTGGGAGGTGGAGGTTGTAGTGAGCCAAGATTGCACCACACTCCAACCTGGGCAACAAAGTGAGACTCTGCTCTC"
"GL873543","1119389","1119604","chrX","18257027","18257253","76","17137638","CTCACACCTATAATCTAGCATTCTGGAAGGCCAAGGACTGAGGATTGCTTGAGTTCAGGAGTTGAAGACAAGGCTAAACAAACTCAAGATGCATTCTCTACTAAAAATAGAAAAATTAGCCATATGTCATCACAGCTACCTGGGATGCTGAGGCAGAAGGATAGCTTGATTCCAGGAGTCTGAGGTTGCTGTGACCTAGGCTGAGACTATGGCACT","GTTCATGCCTATAATCCCAGCACTTTGGAAGGCCAAGGCGGGTGGATCACCTGAGGTCAGGAGTTCGAGACCAGTCTGGCCAACATGGTGAAACCCTGTCTCTACTAAAAATACAAAAATTAGCTGGGCATGGTAGCACATGCCTATAATCCCAGCTACCCGGGAGGCTGAGACAGAAGAATTGTTTGAACCCAGGAGGTGGAGGTTGCAGTGAGCCGAGATCACAC"
"GL873543","1697672","1697778","chr16","2042051","2042159","24","344379","CTGGGGGCGGCACCTGTAATCCTAGCACTCTGGGAGGCTGAAATGGGTGGATTGCTGGAGGTCAGGAGTTTGAGACCAGCCTGACCAAGAGTGAGATCCTGTCTCTA","GATGGCTCACATCTGTAATCCCAGCACTTTGGGAGGCCGAGGTGGGTGGATCAATTGAGGTCAGGAGTTTGAGACCAGCCTGGCCAACATGGTGAGACCATGTCTCTAC"
"GL873543","1697806","1697971","chr6","148611209","148611366","40","146913403","ACTAGCCAGGCCTTGTGGCAAGCACCTGTAGTCCCAGCTACTTGGGAGGCTAAGACTAGAGGATCACTTGAGCACAGGATTTGGAGGTTGCTGTGAGTTATGACACCATGGCACTCTACCAAGGGTGACAAAGTGAGACTCTGTCTCAGAAAAAAAAAAAGAGAGA","TTAGCTGGGCATGGTGGCAGGTGCCTGTAATCCCAGCTACTCTGGAGGCTGAAGCAAGAGAATCGCTTGAACCCAGGAGGTGTAGGTTGCAGTGAGTCGTGCCACAGCACTCCATCCTGGGTGACAGAGCAAGACTCTGTCTCAAAAAAAAAAAAAAA"
"GL873543","2456356","2456393","chr16","43605817","43605844","17","41149461","TATGTCACTCTATCAAGGGTGACAAAGTGAGACTCTGT","CAGTCTGGGTGACAGAGCAAGATTCCAT"
"GL873543","2456647","2456880","chr4","15285954","15286199","68","12829307","GGTCAGGTGCCGTGGCTCATGCCTATAATCCCAGCACTCTGGGAGGATGAGACAGGTGGATTGCCTGAGCTCACAAGTTCAAGACTAGCTTGAGCCAGAGTGAGACCCCCGTCTCTATAAATAGCCAGGCATTGTGTCAGGTGCCTGTAGCCTCAGCTACTTGGACGGCTGAATAAAGAGAATCACTTAAACCCAAGAGTTTGAGGTTGCTGTGAGCTAAGATATGTCACTCCT","GGCTGGGTGCGGTGGCTCACGCCTGTAACCCCAGCACTTTGGGAGGCTGAGGCGGGCAGATTGCCTGAGGTCAGGAGTTCAAGACCAGCCTGGCCAACATGGTGAAACCCCTCTCTACTAAAAATACAAAAATTAGCCGGGCGTGGTGGCACATGCCTGTAATCTCAGATACTTGGGAGGCTGAGGCAGGAGAATGAGTTGAACCCGGGAGGCAGAGGTTGCGGTGAGCTGAGATCGTACCATGCA"
"GL873543","2892374","2892435","chr1","100916857","100916922","15","98024483","GCCTGTAATCTCAGCACTCTGGGAGGCCATGGTGGGTGGATCACCTGAGCTAGAGCAAGACC","CATGCCTGTAATCCCAGCACCTTGGGAGGCCAAGGTGGGTGGATCACCTGAGGTCAGTAGTTTGAG"
"GL873543","3758065","3758194","chr3","166690011","166690120","49","162931946","CTACTAACAAGAAAAAAACCAAGCCAAGTGTGGTACTACATGCCTAGAGGCCCAGCTACTTGGGGGGCTGAGACAAGTAAACTGCTTGAATCCAGCAGTTTGAGTCCAGCGTAGGCTTTAAAAAAAAAAA","TACACATACAAAAAATCAGCTGGGTGTGGTGGTACATGCCTGTAATCCCAGCTACTCAGGAGGCTGAGGCCGGAAAATCACTTGAACCCAGGAGGCAGAGGTTGCAGTGA"
"GL873543","5715758","5715848","chr15","38421204","38421287","32","32705446","AAAACACAGCAATTCAAGAGCCAAGCATGGTGGCATGTACTCATAGTTCTGGCTACTTTGGAGAGTGAGGTAGATGGCTTGATCCCAGGAG","AAAACAGCAAATTTTGGCCAGGCTCAGTAGCTTGTGACTGTAATCCTGGCACTTTGGGAGGCGAGGGAGATAGATCACTTGAGG"
"GL873543","6536140","6536337","chr1","6754007","6754209","61","217867","TATAATCCTAGCACCCTGGGAGGCTGCGATGGGTGGATCTCCAGAGGGCAGGAGGTGGAGACCATCCTGAGCAAGAGCAAGACCCCGTCTTTACTAAAAATAGAAAAAATATCTGGGCATTGTGGCGCTTGCCTATAGATTTAGCTACTCAGGAGGCTGAGGCAGGAGGACCATTAGAGCCCCAAAGACTGATATTGC","CTGTAATCCCAGCACCTTGGGAGGCTGAAGAGGGCGGATCACCTGAGGTCAGGAATTTGAGACCAGCCTGGCCAACATGGTGAAATCCCATCTCTACTGAAAATACAAAATTAGCTGGGTGTGGTGGTGCATGCCTGTAGTTCCAGCTACTTGGGGAGCTGAGGCAGAAGAATGCCTTGAACCCGGGAGGCAGAGGTTGCAGT"
"GL873543","18782383","18782483","chrY","9469734","9469829","35","9312649","AAGAATGAAAATATTCTGCCAGGCTCAATAGTTCAGGCATGTAATCCTAGCCGCTTGTGAGAATAAGACAGGCAGATCACTTGAAGTAATGAGTTCAAAAC","AAAGTACAAAGAGTCTGGGTACAGTGGCCCAAGCCTGTAATCCCAGCAGTTTGGGAGGACAAGATGGGTAGATCACCTGACATCATGAATTAGAGA"
"GL873543","18852113","18852259","chr19","4954017","4954151","41","13898096","GGCCAGGCCTGGTGGCTCACACCTATAATCCCAGAACTCTAAGGGGCTAAGGTGGGTGGATCACCTCGGTCACGAGGTCACGAGTTCAAGACAAGCCTGAGCCAAAGAGAGACCTACTTCTTAAAAATAGCCAGGTGTTGTGGCAGG","GGCCAGGTGTGGTGGCTCACGCCTATAATCCCAGCACTCTGGGAGGCTAAGGTGGGTGGATCACCTAAGGTCAGGAGTTCAAGACCAGCCTGGCCAACATGGTGAAACCCCATCTCTATTAAAAATACAAAACTG"
"GL873543","18852572","18852721","chr6","132554297","132554452","43","113701725","GTGGCAGGTTTTTATAATCAATTCCAGCTATTCAGAAGGCTGAGGTAAGAGAATTGCTTAAGCCCAGAAGTCTGAAGTTGCTGTGAGCTATGACACCAAGGCATTCTACCAGGGGCAACAAAGTAAGACTGTCTTCAAACAAACAAAAAA","TGCCGCGTGGTGGTGTGCACCTGTAATTCCAGCTACTCAGGAGGCTGAGGCATGAGAATTGCTTGAACCCAGGAGGCAGAGGTTGCAGTGAGCCAAGATCATGCCAGTGCACTCCTACCTGGACAAAAGAGCAAGACTGTCTTAAAAAAAAAAAAA"
"GL873543","19344808","19344955","chr5","62675271","62675430","45","43330463","TAATAAAAATAGCCAGGTGTTGTTCCTGTAGTCCCAGTTACTTAGGAGGCTGAGGCAAGAGAATCACTTGAGCCCAGGAGTCAGAGGTTGTTGTGAGCTATGATGCCACATAGCTCACTCTACCTGGGGGGATAAAGTGAGACTCTGT","AAAAATACAAAATTAGCTAAGTGTGGTGGTGCATGCCTGTAGTCCCAGCTACTTAGGAGGCTGAGGCAGGAGAATCATTTGAACCTGGGAGGCAAAGTTTGCAGTGAGCCAAGATGCACCATTGCACTCAAGCCTGGGTAACAAGAGCAAAACTCCATCT"
"GL873543","19345227","19345354","chr20","23111771","23111907","29","3766544","GGCCGGGAGCAGTGGCTCATGCCTATAATCCTAGCACTCTGGGAGGCTGAGGTGGGCAAATCATCTGAGCTCATGAGTGAGACCAGCCTGAGCTAAAGTGAGACCTTTTCTCTAAAAATAGCCAGGCA","GGCCAGGCGCAATGGCTCATGCTTGTGATCCTAGCACTTTGGGAGGCCGAGGTGGGAAGATCATCTGAGGTCAGGAGTTTGAGACCAGCCTGGCCAACATGGTGAAACTCCGTCTCTACTAAAAATAGCCATGCCTG"
"GL873543","19416929","19417112","chr14","11857478","11857657","44","7559451","ATATAAAAATTATCTAGGCATTGTGGTAGTGCTTGTAATCCCAGCTACTGGGGAGGTTGAGGCAGGAGGATCACTTGAATCCAGATGTTTGAGGTTGCTATGAGCAAAGCTGATTCCAGAGCACTCTAGCTTGGGTAACAGAAAGACTCCAAATCAAAGAAAGAAAAGAAAGAAAAAAGAAAGA","TACAAAAATTAGCTGGGCACGGTGCCACAAGCCTGTAATCCCAGCTACTCGGGAGGCTGGGCAGGGGAATAGCTTGAACCCAGAGGTGGAGGTTGCAGTGAGCCAAGATCAAGCCACAGCACTCCAGCCTGGGTGACAGAGCAAGACTCCATCTCAAAAAAAAAAAAAAAAAAAAAAAAA"
"GL873543","19951576","19951712","chr5","145376033","145376170","34","125424457","CCAGGCGCAGTGGCTCATACCTGTAACCCTAGCACTCTGGTAGGCCAAGGTGGGTGGAATGCTTGAGTTCATGAGTTCAAGACCTGCCTGAGCAAGAACAGGACCTTGTCTCTTCTCTGCTAAAAATAGAAAAACTG","GGTCAGGCGCAGTAGCTCACGCCTGTAATCCTAGCACTCTGGGAGGCCGAGGTGGGTGGATCACTTGAGGTCAGGAGTTCAAGACCAGCCTGGGCAACATAGCGAAACCCCCATCTCTACTAAAAAATACAAAAGTTA"
"GL873543","19951992","19952117","chr10","66170590","66170715","40","46218598","ACTGGTCAAGGGTACCTGTAATCCCTGCTACTTGGGAGGCTGAGGAAAGAGTATCTCTTGAGCCCAAGAGACTGAGTTTACTCTGAGGTACGATGATGCCATGGTACTCTACCAAGGGTGACAGAG","GTGGCTCATGCCTGTAATCCCAGCTACTTAGGAGGCTGAGGCAGGAGAGCTACTTAAACCCGGGAGGTGGAGGTTACTGTGAGCTGAGATCACGCCACTGCACTCCAGCCTGGGTGACAGAGTGAG"
"GL873543","20544075","20544189","chr19","19949995","19950109","23","594080","GGCCGGGCCCAGTGGCTCATGCCTGTAATCCTAGCACTTGGGAGGTCAAGGCAGGTGGATTGCCTGAGCTCATGGGTTCAAGACCAGCCTGAACCAAAGCAAGACCTCATCTCTA","GGCCAGGTGCAGTGGCTCACGCCTGTAATCCCAGCACTTTGGGAGGCCAAGGCAGGTGGATTGCCTGAGGTCAGGAGTTCAAGACCAGCCTGGCCAACATGGTGAAACCCCGTCT"
"GL873543","20544464","20544617","chr12","63241189","63241340","39","42696725","GACCTCTCTAAAAATAGCCAGGCTTTGTGGCAGGAACCTATAATCCCAGCTACTTGGGAGGCTGAGACAAGAGAATCACCTGAGCCTAGGAGTTTGAGGTTGATGTGAGCTAAGATGCCACAGCACTCTTACTGAAGGCGACAAAGTGAGACTC","AAAAACAAAAATTAGCCAGGTGTGTTGGCATGCACCTGTAGTCCCAGCTACTAGGGAGGCTGAGACAGAAGAATCACTTGAACCCAGGAGGTGGAGGTTGAGTGAGCCAAGATCGCGCCACTGCACTCCAGCCTGGGTGACAGAGCGAGACT"
"GL873544","1114100","1114306","chr18","11195821","11196054","67","10081721","GGCTGGGCATGGTGGCTCAAGTCTGTAATCCCAGCACTTGGGAGGCTGAGGTGGGTGGACTGCCTGAGCCAGAGCGAGACCTCATCTCTAAAAATAGCCAGGCATTGTGACAGACTCCTGTAGTCCCAGCTACTTGGGAGGCTGAGGCAAGAGAATCTCTTAAGCCTAAGAGTTGAGGTTGCTGTGAGTACAGAAGCATCACTATAC","GGCCAGGCACAGTGGCACACGCCTGTAATCCCAGCACTTTGGGAGGCCGAGGTGGGTGGATCACCTGAGGTCAGGAGTTTGAGACCCTGTCTCTACTTATAATACAAAATTTAGCCGGGCGTGGTGGCACATGCCTGTAATCCCAGCTACTTGGCAGGCTGAAGCAGGAGAATCGCTTGAACCTGGGAGGCGGAGGTTGCAGTGAGCCGAGATGGTGCCACTGCACTCCAGCCT"
"GL873544","3729723","3729832","chrX","38269524","38269615","38","34539801","ATCAGCCAGCCATGGTAGTACACACTTATAGTGTGAGTTACTCAGAAGACTGAAGCAGAGTGACCACTTGAACACTTGAACCTGGGAATTTGAGACCAGCCTAGGTAACA","AATTAGCCAGGCATGGTGGCACATGCCTATAATCCCAGCTACTCAGAAGGTTGAGGCAGGAGAATCACTTGAACCTGGGAGGCAGAGGTTGC"
"GL873544","10270453","10270591","chr5","39394789","39394934","31","29124336","GGCCTGGCATGATGGCTCATGCCTATAATCTAGCACTTTGGGAGGCCAAGGCAGGCAGATCATCTGAGCTCAGGAGTTTGAGACTAGCCTGAGCAAGACCCAGTCTCTATTAAAAACAGAAAAATGAGCCGGGTGTTGT","GCCAGGCATGGTGGCTCACCATGTAAGCCCAGCACTTTGGGAGGCCGAGGCAGGCAGATCATCTGAGGTCAGGAGTTTGAGACCAGCCTGGCCAATATAGTGAAACCCTGCCTCTATTAAAACTACAAAAATTAGCAGGGTGTAGT"
"GL873544","11270396","11270556","chr1","16061663","16061830","44","4791267","ATAGAAACATTAGCTGGGCGTGGTGGCACATGCCTGTAGTCCCAGCTTCTCAGGAGGCTAAGCAGCTTGAGCCCAGGAGTTGGAGGTTGCTGTGAGCTAGGTTGAGGACATGGCACTCTAATCCTGAATGATAGAGGAGACTGTGTCTCAAAAATAAAAAA","ACACAAAAATTAGCTGGGCGTGGTGGGGCATGCCTGTAGTCTCCACTACTCAGGAGGCTGAGGAGTATTGCTTGAACCCAGAGGCGGAGGTTGCAGTGAGCTGAGATCGCGCCACTGCACTCCAGCCTGGGCAACAGAGTGAGACTCTGTCTTAAGGTGGAGAAAAAA"
"GL873544","11270834","11270847","chr1","140208652","140208664","3","128937818","AGAAAGAAACATTA","AGAAAGAAAAGAA"
"GL873544","11271121","11271237","chr12","114502393","114502520","35","103231272","GGTGGCTCATGCCTGTAGTACTAGCACTCTGAGAGGGTAAGGCAGGAGGATAGTGTGATGTCAGGATCAGCCTGAGCAAAGGGAGACCTTGTGTCTACTAAAAATATAAACATTAGG","GGCTGGGTGTGGTGGCTCATGACTGTAATCTCAGCACTTTGGGAGGCTAAGGCAGGAGGATCACTTGAGGTCAGGTCAGCCTAGCCAACACGGTGAAACCCCATCTCTACTAAAAATACAAAAATTGG"
"GL873544","11819443","11819500","chr8","38376929","38376986","13","26557486","GTGACTCTGTGCCTGTAATCGCAGCTCTCTGGGAGGCCGAAGCGGCCGATTGCCTGAG","GTGGTTCAAGCCTGTAATCCCAGCACTTTGGGAGGCTGAAGCTGGCAGATCACCTGAG"
"GL873544","12307366","12307487","chr9","28309649","28309769","34","16002283","CAGGTGTAGTGGCTCATGCCTGTAATCCCAGCACTCTGAGGCTGAAGCAGGTGCTTGAACTTGGAGCGTGAGCAACAGTAAGACCCTGTCTCTACTAAAAATATAAAAATTAGCTGGGAGTT","GGCCAGGCGCAGTGGCTCACGCCTGTAATCCCATCACTTTGGGAGGCCAAAGCAGGTGGATCACCTGAGGTCAGGATGGCGAAACCCCATCTCTACTAAAATACAAAAATTAGCTGGGCAT"
"GL873544","12307753","12307901","chr1","160403053","160403201","36","148095300","TTAGCTGGGAGTTGTGGCAGATGCCTTTAATCCCAGTACTTGGGAGGGAGGCTGAGGCAGGAGATCACTTGCACCCAGGAGTTTGAGGTTGCTATGAGCTAGGCTGAGGCTGTGGCACTCTAGCCTGGGCAACAGGGTAAGACTCTGTC","TTAGCTGGGCATTGTGGTGCATGCCCGTAATCCCAGCTACTTGGGAGGCTGAGGCAGGAGAATCACTTGAACCTGGGAGGTGGAGGTTGCAGTAAGCTGAGACTGTGCCACTGCACTCCAGCCTGGGCAACAAGAGCAAAAACTCCTTC"
"GL873544","12749647","12749911","chr20","55894703","55894972","76","43145056","ACTCTGGGTGGCTGAGGCAGATTGATTGTCTAAGCTCAGAAATTAGACCAGCTTGACCAAGAGCAAGAACCTGTCTCTACTAAAAATAAAAATGCTAGCTGAGTATGGCAATAGGTGCCTGTAGTCTTAGCTACTAGGGAGGCTGAGGCCAGAGGATTGCTCAAGCCCAAGTGTTTGAGGTTGCTGTGAGCTATCATGTCTCGGCACTGTATTCAGGGCAACAGAGTGAGACTCTGTCTCAAAAACAACAACAAAAAAAGATTTT","CTTTGGGAGGCTGAGGCAGGCGGATCACCTGAGGTCAGGAGTTCGAGACCAGCCTGGCCAACATGGAGAAACCCTGTCTCTATTAAAAATATAAAAATTAGCTGGGTGTGGTGGTGTGTTCCTGTGGTCGCAGCTACTCAGGAGGCTGAGTCAGGAGAATCGCTTGAACCCAGGAGGTGGAGGTTGCAGTGAGCTGAGATGGCGCCACTGTACTCCAGCCTGGGCAACAGAGCAAGACTCTGTCTCAAAAAAAAAAAAAAAAAAGACAAA"
"GL873544","12750006","12750016","chr13","96293978","96293988","0","83543972","AAAAAAAAAAA","AAAAAAAAAAA"
"GL873544","14345574","14345707","chr2","93098086","93098217","26","78752512","GCTGGGCACTGTGGCTCATGCCTATAATCCTAGCACTCTGGGAGGCTGAGGCAGGAGGATCTCTCGAGGTTATGAGGAGTTCAAGACCAGACTAAACAAAGCAAGACCCTGTCTCTATTAAAAATACAAAAATT","GCCGGGCACAGTGGCTCATGCCTGTAATCCCAGCACTTTGGGAGGCCGAGGCGGGCAAATCACGAGGTCAGGAGTTCAAGACCAGCCTGACCAATATGATGAAACCCCGTCTCTATTAAAAATACAAAAATT"
"GL873544","14345970","14346159","chr1","9149177","9149355","49","5196793","AGAAAAGAAAAATTAGCTGGATGTCATGGTGGGCACTTGTAGTTATAGCTACTTCGGAGGCTGAGGCAAGAAGATTGCTTGAACTCAGGAGTTTGAAGTTGCTGTGAGCTAGGCTAAGGCCACGGCACACTACCTAGGGGGACAGACTGAGAGTCTATCTCAAAAAAATAAAGAAAGAAAGAAAAAGAAA","ACAAAAGTTAGCTGGGCGTCTTGGTGTGTACCTGTAATCCCAGCTACTCGGGAGGCTGAGACAGGAGAATCGCTTGAACCCAGGAGGTGGAGGTTGCAGTGAGCAAAGACTGCGCCACTGCACTCCAGCCTGGGTGACAGAGTAAGAGTCCATCTCAAAAAAAAAAAAAAAAAAAAAAA"
"GL873544","15336606","15336720","chr20","3047800","3047916","27","12288806","TAATCCTAGCACCCTGGAAGGCCAAGGCAGGTGGATGACCTGAGCTCAGGAGTTCTAGACCACCCTGAGCAAGAGTGAGACCTTGCCTTTACTAAAAATAGAAAGACTAACTGGG","TAATCCCAGCACTTTGGGATGCCAAGGCAGATGGATCACTTGAGCCCAGGAGTTCAAGACCAGCTTGGCCAAGATGGCGAAAACTGTCTCTACTAAAAATATAAAAATTAGCTGGGC"
"GL873544","15336982","15337120","chr12","111971011","111971153","45","96634029","GAAAAAGAAAAACTAGCTGGGCATCATGGACAACACCTTTAATCCCAGCTACTGGGAAGGCTGAGAAAGGAGGACTGCTTGAACCCAAAAGTTTGAGTTTGCTGTGAACTAGGCTGATGCCATAGCACTCTAATCAGGG","AAAAATACAAAATTAGCCGGGCATGGTGACGCATGCCTGTAATCCCAGCTACTCGGGAGGCTGAGGCAGGAGAATCGTTTGAACCCAGGAGGCAGAGGTTGTGCTGAGATGAGATTGCGCCATTGCACTCCAGCCTGGGCGAC"
"GL873544","15451246","15451396","chr3","123556434","123556577","39","108105188","GCCGGGAATGGTGGCTCACGCCTGTTGTCTCAGCGCTGTGGGAGGCCGAGGCAGGTGGATCACCTGAGCTCAGTTGAGTTCGAGACCAGCAGAAGACCAGCATGAGCCAGAGTGAGCCAGAGTGAGACCCCATCTCTACAAAAAAAAAAAT","GACTGGGCATGGTGGCGCACACCTGTAATCTCAGCGCTTTGGGAGGCTGAGGCCAGCGGATCACCTGAGGTCAGGAGTTCGAGACCAGCCTGGCCAACGTGGTCTGCATGACACAGTGAGACTGTCTCAAAAAAAAACAACAAC"
"GL873544","15525174","15525371","chr1","212816571","212816763","53","197291397","GCCGGGTGTGGTGGCTCACGCCTGTAGTTCCAGCGCTGTGGGAGGCTGAGGCAAGTGGATCACCTGAGCTCAGAGGTTTGAGACCAGCATGAACTGGAGTGAGCCAGAGTGAGACCCTGTCTCTACCAAAAAAAAAGCAGGGCAGTGTGGTGCGTACCTATAATTCCAACTACTAGGGAGGCAAAGGGCAAGAAAATC","CGGGTGCCGTGGCTCACACCTGTAGTCCCAGCACTTTGGGAGGCTGAGGCGGGCGGATCACCTGAGGTCAGGAGTTTGAGAACAGCCTGACCAACATGAAGAAACCCCGTCTCTACTAAAAATACAAAAACGTGCTGGGCATAGTGGCACATGCCTATAATCCCAGCTACTAGTGAGGCTGAGGCAGGAGAAT"
"GL873544","15718966","15719052","chr7","158031905","158031997","26","142312939","AAAAGAGTTTGAGATTGCTATAAGCTATGACACCATGCATTCTACCAAGGGTGACAAAGTGATATTCTATTTCAAAAAAAAAAAAAA","CCAGGAGGTGGAGGTTGCAATGAGCCAAGATCACACCACTGCACTCCAGCCTGGGTGACAGGGTGAGATTCTGTCTCAAAAAAAAAAAAAAAA"
"GL873544","15719332","15719551","chr13","75125824","75126049","53","59406492","GGCAGGACATGGTGGCTCATGCCTGTAATTCTATTACTCTGGAAGGCCAAGTTGGGTAGATTGCCCGAGCTCAGGAGTTCCAGACCAGCCTAAGCAAAAGTAAGACCCCATTCTACTAAAAATAGAAAAACTAGCTAGCATTGTGGTGGGTACCTATAATCCTAGCTACTTGGGAAGCTGAGGCAAGAAGATCACTTGAGCTCAAGAGTTTGAGATTGCT","GGCCAGGAGCAGTGGCTCATGCCTGTAATTCCAGAACTTTGGGAGGCCGAGGCAGGTGGATCACCTGAGGTCAGGAGTTCAAGGCCAGCCTGGCCAAAATGGCAAAACCCCATCTCTACTAAAAATACAAAAATTAGCCAGGCATGGTGGCACATACCTGTAATCCCAGCTACTTGGGAGCCTGAGGCAGTAGGATCTCTTGAACCCAGGAGGTGGAGGTTGCAAT"
"GL873544","15768839","15768991","chr2","56885995","56886146","45","41117156","TAAAAAACTAACCAGGTATGGTGGCACATGCCTGTAGTCCCAGCTACTTGGGAGGCTGAGGAAAGAGGATTGCTCAAATCCAAGAGTTTAAGGTTGCTGTGAGTCACGAACTCTAACCAGGGAAACAGATTCTGTCTCAAAATAAAAATAAAA","TTAACCAATGTGGTGGCGCATGCCTGTAATCCCAGCTACTTGGGAGGCTGAGATACAAGAATCACTTGAACCCAAGAGGTGGAGGTTGCAGTGAGCCATTGCACTCCTGCCTAGGTGACAGAGTGAGACTCTGTTTCAAAGAAAAAAAAAAA"
"GL873544","15769233","15769363","chr10","66401425","66401556","25","50632192","GCCAGGCACAGTGGCTCACATCTGTAATCCTAGCACTTTGGGAGGCTGAGGCAGGTGGATTGCTTGAGCTAGGAGTTTGAGAACATCCTAACCAAGACCAAGACTCTGTCTCTACTAAAAATAAAAAACTA","GCCAGGCACAGTGGCTCACACCTGTAATCCCAGCACTTTGGGAGGCCGAGGCAGGCAGATCACCTGAGGTCAGGAGTTTGAGACCAGCCTGGCCAACATGATGAAACGCTGTCTCTAATAAAAATACAAAAA"
"GL873544","16316300","16316391","chr2","76273588","76273666","35","59957288","TACTTCAAGAATATAGAGAGCCAGGCATGGTGGCTCACACCCATAATCCCAACACATTGGTAACTGAGGTGGATCACTTAAGGCAGCAGTTC","GGACAGGTGCAGTGCTCCACACCTATAATCCCAGCACTTTGGGAGGCTGAGGTGGCGGATCACTTGAGGTCAGGACTTC"
"GL873544","16578109","16578241","chr5","77777881","77778016","29","61199772","GGCCAGGCAAGGTGGCTCACGCCTGTAATCCCAGCACTCTTGGGAAACCAATGTGTATGGATTGCTTGAGTTCAGGATTTGAGATCAGCCTGAGCAAGAGCAAGACCCTGTCTCTTTTAAAAATAGAAAACAT","GGCCAGGCATGGTGGCTCAGGCCTGTAATCCCAGCACTTTGGGAAGCCTAGGTGGGTGGATCACTTGAAGTCAGGAATTTTGAGACCAGCCTGGCCAACATGGTGAAACCCCGTCTCTATTAAAACTACAAAAATT"
"GL873544","16578519","16578658","chr15","17851679","17851814","43","1273160","TAAAAATAAAAATAGAAAAAATTAGCAGGGTGTTGGGGTGCCTATAGTCCCATCTACTTGAGAGGCTGAGGCCAGAATACCACTTAAACCCAAGAGACTAAAGTTGCTGTGAGCTAGGTGAAGCCACAGCACTCTAGCTT","CATAAAAATACAAAAATTAGCCAAGTGTGGTGGCACGCACCTGTAGTCCCAGCTACTTGAGAGGGTGAGGCAGAAGAATCACTTGAACCCAAGAAATGGAGGTTGCAGTGAGTCGAAATCGCACCACTGCACTCCA"
"GL873544","16591349","16591482","chr12","23921382","23921509","35","7330033","GGCCAGGCGTGGTGGCTCACAACTGTAATCCTAGTAGCACTCTGGTAGGCCAAGGTCGGTAGATTCCCCTTGGCTTACAGGTTCAAGACCAGCCTAAGCCAAAGTAAGACCCTGTCTCTAAAAATAGCTGGGCA","GGCCAGGCGTAGTGGCTCACACCTGTAATCCTATCACTTTGGGAGGCCGAGGTAGGTGGATCACCTGAGGTCAGGAGTTCAAGACCAGCCTGGCCAACATGGTGAAGCCCTGTCTCTATTAAAAATAC"
"GL873544","16591758","16591910","chr20","53473013","53473159","46","36881255","AATAAGAATAGCCGGGCATTGTGCTGGGCACCTATAGTCCCAGCTACTCAGGAGAACTGTTGAACCCAAGAGTTGGAGGTTGCTGTGAGCTATGACGCCACGGCATTCTACCAAAGGTGACAAAGTGAAACTCTGTCTCAAAAAATAAATAAA","TAGTTAGGCATGGTTATGTGCACCTGTAGTCCAAGCTACTCAGGAGAATCACATGAACCTAGGAGGCAGAGGTTGCAGTGAGCTGAGATTGCACCACTGCACTCCAGCCTGGGCGACAGAGCAAGACTCCGTCTCAAAAAAAAAAAA"
"GL873544","19101396","19101613","chr11","111313301","111313520","72","92211905","AAAAAAAAGCGTTCAAGGCCAGCCTAAGTAAGAGCTAAATCACCTCTCTACTAAAAATAGAAAAATTAACCAGCGATGGTGGTGCTTCCTTATAGTCCCAGATACTTGGGAGGCTGAGGCAGGAATTTGAGGTTACAGTGTGCTAGCCTGAGGCCATGGAACTCCAGCCTGGGTGACAGAGCAAGACTCTAAGACTCTGTCTCGGGGGAAAAAAAAAA","TCACCTGAGGTCAGGAGTTCAAGACCAGCCTGGCCAACATGGCAAAACCCCGTCTCTACTAAAAATACAAAAATTAGCCAGGTGTGGTGGTGCTCACCTGTAGTCCAAGCTACTCGGGAGGCTGAGGCAGAAGAATCGCTTGAACCCGGGAGGCGGAGATTGTGCCACTGCACTCCAGCCTGGGTGACAGAGTGAGACTCTGTCTCAAAGAAAAAAAAAA"
"GL873544","19101712","19101795","chr9","93194085","93194171","18","74092373","GGCCAGGCATGGTGGCTCACTGGGAGCCTAGTACTCTGGGATGCTGTGGCAAGAAGATCACTTGAGGTCAAGAGTTCAAGACCA","GGCCGAGCATGGTGGCTCACACCTGTAATCCCAGCACTTTGGGAGGCTGAGGCAGGTGGATTACCTGAGGTCAAGAGTTCAAGACCA"
"GL873545","4389151","4389312","chr8","144173751","144173908","38","139784600","CTAGCTGGTTGTGATGGTGCACGCTCATATTCCCAGCTACTCAAGAGGCTAAGGCAAGAGAATCTCTTGAGCCCAAGAGTCTGAGTTTGCTATGAGTTATGATGATGCCACAGCACTCTACCCAGGGGAACAGAGTGAGACTCTGTATCAAAATAAATAAAA","TTAGCTGGGTGTGGTGGTGTGTGCCTGTAATCCCAGCTACTCAGGAGGCTAAGGCAGGAGAATCACCTGAACCCAGGAGGCGGAGGTTGCAGTGAGCTGAGATCGTGCCACTGCACTCCAGCCCGGGCAACAGAGTGAGACCCTGTCTCAAAACAAAA"
"GL873545","4389578","4389703","chr19","11392404","11392528","34","7002826","GCAGTGGGTCATGCTTAATCCAAGCACTCTGGGAGCCTGAGGCAAATGGATTGCTTGAGCTCAGGAGTTCAGGACCAGCGTGAACAAAGCAAGACTCTGTGTCTACTAAGAATAGAAAAACTAGGG","GTGGTTCATGCTTGTAATCCCAGCACTTTGGGAGGCTGAGGCAGGTGGATCACCTGAGATCAGGAGTTTGAGACCAGCCTGGCCAACATGACAAAACCCTGTCTCTACTAAAAATACAACAATTA"
"GL873545","4544342","4544449","chrX","38269524","38269615","42","33725182","ACTAAAAACAGCAAGAGTAGCAGAGTTGGGTAGCTTGCACCTATAATCCCAGCTACCCCAAAAGGCTAAGGCAGGAGGGTCCCTTGAATTTGTCAGTTCCAGTCTATA","AATTAGCCAGGCATGGTGGCACATGCCTATAATCCCAGCTACTCAGAAGGTTGAGGCAGGAGAATCACTTGAACCTGGGAGGCAGAGGTTGC"
"GL873545","7273965","7274148","chr19","17128073","17128283","68","9854108","AAGACCAGCCTGAGCCAGAGTGAGACCCCATCTCTAAAATTTAGCCGGACATTGTGGCAGGCACCTGTAGTCCTAGGTGCTTGGGAGGCTGAGGCAAGAGAACCACTTAAGCCCACGAGTTGATGCTGCAGCACTCTACTGAGAGTGACATAGTGAGACTGTGTCTAAAAATAAATAAATAAAA","AGACCAGCCTAGCCAACATGACAAAACCCTGCATCTACCAAAAATTAGCCAGGCATGGTGGCAGGCGCCTGTAGTCCCATGTACTGGGGAGGTGGAGGCAGGATAATCACTTGAACATGGGAGGCAGAAGTTGCAGGGAGCCGAGACGCCACTGCACTCCAGCCTGGGCGACAGAGTGAGGCTCTGCCTAAAAATAAAAAAAGAAAAAAGA"
"GL873545","7274426","7274519","chr11","118095677","118095770","17","110821251","GGCTGGGTGTGGTGGTTCACACTTGTAATCCTAGCACTCTGGGAGGCTGAGGCAGATGGATTGCCTAAGGTCACAAGTTCAAGACCAGCCTGAA","GCTGGGTGCGGTGGCTCACGCTTGTAATCCCAGCACTTTGGGAGGCTGAGGCAGGTGGATCACCTGAGGTCAGGAGTTTAAGACCACCTGATCT"
"GL873545","11746235","11746303","chr15","10208312","10208380","7","1537923","GGCCTGGTGAGGTGGCTCACGCCTGTAATCCCAGCACTCTGGAAGGCCAAGGCGGGCTGAACACCTGAG","GGCCGGGTGTGGTGGCTCATGCCTGTAATCCCAGCACTTTGGGAGGCCCAGGCGGGCTGATCACCTGAG"
"GL873545","11843428","11843568","chr5","176401004","176401146","41","164557576","CAGGTGTGGTGGCTCACTCCTTAATTATAAGTTATCTGGGAGGCCAAGGTTGGAGGGTCCCTTGAGCCCAGGAGCTGTAGGTTGCAGTGAGCTAAGATGATGCCACTGCATTCCAGGCTGGGCAACACAGGAAGTCTCCAT","CCAGGTTTGATGGTGCACACCTGTAGTCCCAGCTACTTGGGAGGCTGAGGCAGGAGAGTCTCTTGAGCCCCAGAGGCAAAAGTTGCAGTGAGCTGAGATTGTGCCACTGCACTCCAGCTTGGGCCGCAGAGTGAGACTCCATC"
"GL873545","14066539","14066659","chr4","156384534","156384656","29","142317995","GTGCCTCATGCCTGTAATCCTAGCACTCTGGGAGGCCGAGTTGGAGGATTCCTTTAGCTCAGGAGTTTGAGACCAGCCTAGCAAGAACCAGATGCCATCTCTACTAAAAATAGAAAAAAAA","GTGGCTCATGCCTGTTATCCTAGCACTTTGGGAGGCCAAGGCGGGCAAATTGCCTGAGCTCAGGAGTTCGAGACGAGCCTAGGCAACATGGAGAAACCCCATCTCTACTAAAATACAAAATAT"
"GL873545","14066921","14067132","chr7","133114354","133114541","62","119047433","ATAGAAAAAAATTAGCCAGGTGTTGAGGCAGGTGCCTATAGTCCCAGTTACTGGGGAGGCTGAGGCAGGAGGATCACTTGAACACAAGAGTTTGAGGTTGCCAAAAAAAAAAAGAGTTGAGGTTGCCATAAGCTAGGCTGACACCCGTGGCACTCTAGCCTAGGCAACAGAGTAAGACTCTGTCTCAAAAAAACCAAACAACAAAAAGAAAA","TAAAAATACAAAAATTAGCCAGGCGTGGTGGCTGGCGCCTGTACTCCCAGCTACTCGGGAGACTGAGGCAGGAGAATCGCTTGAACCCAGGAAGTGGAGGTTGCAGTGAGCCAAGATCGTGCCACTGCACTCCAGCCTGGGCGACAGAGCAAGACTCCGTCTCACAAAAAAAAAAAAAAAAAAAAAAA"
"GL873545","14745262","14745413","chr9","32244461","32244597","33","17499199","GCTACTCGGGAGGCTGAGGCAGGAGAATCACTTGATCCCAGGAGGCTGAGGTTGCGGTGAGCTAGGCTGCTGCCACTGCACTCCAGCCTGGGCAACAGAGCAAAACCTACCTCTCCAAAATAAGCTCACCTTAAAAGAAAAATAGAAGGAAA","CTACTCAGGAGGCTGAGGCAGGAGAATCACTTGAACCCGGGAGGTGGAGGTTGCAGTGAGCTGAGGTCATGCCACTGCACTCCAGCCTGGCAACAGAGCAAGATTTTGCCTCAAAAAAAAAAAAAAAGAAAGAAAAA"
"GL873545","16268378","16268466","chr20","27900350","27900437","14","11631972","GGCCGGGCGTGGTGGCTCAAGCCTGTTGTCTCAGCACTGTGGGAGGCTGAGGCAGGTGGATCACCTGTGCTCAGAGGTTCAAGACCAGC","GGCCGGGCGTGGTGGCTCATGTCTGTAATCCCAGCACTTTGGGAGGCCGAGGTGGGTGGATCACCTGAGGTCAGGAGTTCAAGACCAG"
"GL873545","17428284","17428410","chr1","164625930","164626054","43","147197646","CGTGGTGGTTCACACATGTAATCCTAGCACTTGGGGAGGCTGAGGAGGGAGAATCACCTGAGGTCAAGACTTCAGGAGCAGATTGAATTATTTTCTACTAAACTAGAAAAACCAGCTGGACATGGTG","GGTGACTCACTCCTGTAATCCCAGCACTTTGGGAGTCCGAGGTGGGCAGATCACCTGAGGTCAGGAGTTCAGCCTGACCGATATGTTGAAACCCATCTCTACTAAAAATTCAAAACTTAGCTGGG"
"GL873545","20212636","20212748","chr2","69013368","69013473","32","48800732","CACTTGAACCTAGGAGTTTGGGAGTTTGGGGTTGCAGTAAGCTGTGATGATATCACTGTACTCTGACCTGAGAAAGAGGGAGACACTGTCTACAAAAAAAAAAAAAAAGGAAA","GCTTGACCTGGGAGGTGGAGGTTGCAGTAAGCTGAGATCGTGCCACTGCACTCCAGCCTGGGCGACAGAGTGAGACTCTGTCTCAAAAAAAAAAAAAAAAAAAAAA"
"GL873545","20215180","20215469","chr20","2836244","2836529","73","17378936","GGTGGCTCATACCTATAATCCTAGCACTCTGGGAGTACAAGGAGAGAGAATACCCTACCATCAGGAGTTTGACATCAGCCTGTCCCAGAGTGAAAACCCAGTATCTACTATAATTAGAAAAAATTGGCTGGGCATGGTGGCACTCCCCTGTAATCCCTACTACTGGGGAGGCTGAGGCAGGAGAATCTCTTGAGCTCAGGAGTTTGAGGTTGCAATGAGCTATGATGATGCCATGGTACTCTACCAAAGAGGACAAAACAAGATTCCATTCTCAAAAAGAAAAACGAAAA","TGGCTCACGCCTATAATCCCAGCACTTTGGCAGGTTGAGGCGGGTGGATCACCTGAGGTCAGGAGTTCGAGACCAGCCTGGCCTACATGGTGAAACCCCATCTCTACTAAAAATACAAAAATTAGCTGGGCATGGTGGCACTTGCCTGTAATCCCAGCTACTCAGGAGGCTGAGGCAGGAGAACCACTTGAACCCCGGAGGCAGAGGTTGCAGTGAGCTGAGATCATGCCATGACACTCCAGCCTGAGCGACACAGCAAGACTCTGTCTCAAAAAAAAAAAAAGAA"
"GL873545","20215763","20215778","chr2","203073788","203073802","2","182858025","GAGAGAGAAAAGAAAA","GGAAAGAAAAGAAAA"
"GL873545","20635384","20635449","chr2","93673843","93673900","20","73038459","GTTTCTTAAAAAACAAATCTGATTAGGCCAGGTGTAGTGGCTCACACCTGTAATCCTAGCTCAGTG","TAAAAATGTAAAAGATTGGCCGGGTGTGGTGGCTCACTCCTGTAATCCCAGCACTTTG"
"GL873546","11108858","11108978","chr9","103847474","103847576","49","92738616","CTGGGCCAGAAAGATCCTGTCTATAGTAAAAATAGAAAAATTAGCTAATGCCTATAGGCCCAGCTGCTTGGGAGAATAAAGCAGGAGTCTCTTGAATCTAGGAGTGTGAGGTTACTGTGAG","TTACAAAATTTTGTGGTGTGGTGGTGTGAGCTGTAGTCCCAGCTACTCGGGAGGCTGAAGCAGGAGAATTGCTTGAATCTGGGAGGCAGAGGTTGCAGTGAGC"
"GL873546","15110900","15111165","chr12","113281674","113281947","67","98170774","GGCTGGGTGTGGTGGCTCACACCTGTAATCCTAGCACTCTGGGAAACCCAAGCTAGTAGATCAACCTGAGATCAACCTGAGCAAGAGCGAGATCCCATCTCCACCAAAAATAGAAAAACTAGCTGAGCACTGTGGCAGGCACCTGTAGTCCCAGCTACTTGGGAGGCTGAGGCAGTAGAATTAGTTGAACCCAGAAGTTTGAGGTTGCTGAGCTAGGCTGATGCCCTGGCACTCCAGCCTGGGGAATTGATTGAGACTCTGTCTCA","GGCTGGGCAAAGTGGCTCACACCTGTAATCCCAGTACTTTGGGAGGCTGAGGCAGGTGGATCACCCGAGGTCAGGAGTTTGAGCCAACATGGCGAAACCCCATCTCTACTAAAAATACAAAAACTAGCGGGGCATGGTGGCACACACCTGTAATCCCAGCTACTCGGGAGGCTGAGGCATGAGAATCGCTTGAACCCAGGAGGTGGAGGTTGTGTTGAGCTGAGATCATGCCACTGCACTCTAGCTTGGGTGACAGAGTGATACTGTGTCTCAA"
"GL873546","16270928","16271085","chr8","100272382","100272549","43","84001454","AAAAGAAGCTGGGTGTCATGGCTCATGCCTGCAATCCTAGCAACTCGGGAGGCTGAGGTAGGAGATTGGCTTGAGCCTTGGAGGCTGTGGTGAGCTGTGATTATGCCATTGTACTCCAGTCTGGGTGACAGAGACTCCGTTTTCAAACAAAAAAAAAA","AAATGTAGCCAGGCATGGTGGCACATGCCTGTAATCCCAGCAACTCGGGAGGCTGAGGCAGGAGAATCGCTTGAACCAGGGAGGCAGGGTTGCAGTGAGCCAAGATCTCGCCACTGCACTCCAGCCTGGGTGACACAGTGAGACTTCATCTCAAAAACAAACAAAAAA"
"GL873547","3944645","3944659","chrX","1083699","1083714","1","2860946","AATAAATAAAATAAA","AAATAAATAAAATAAA"
"GL873547","3944933","3945122","chr9","32684033","32684219","73","28739100","CACCAAAGAAATAACTTACCTCCTGTTGCTGGGTGAGGTGGCTCACACTTGTAATCCTAGCAGTCTGGGAGGCTATAGTCTCAGCGACTCAGGAGGCTGAGACAGGATCACTTGAATCCCACTGTGAGTAGGCGGATGTCAAGGAACTCTAGCCTAGGCAACAGAGAGTCTGTCTCAAAAAACAAAATAA","CAGACACAAAAGTTATAAAAGTTAGCTGGGTGTGGTGGTGCATGCCTGTAATCCCAGCTACTCGGGAGGCTGAGAGACGAGAATCACTTGAACCCAGGAGGCAGAGGTTGCAGTGAGCTGAGATCATGCCACTGCACTCCAGCCTGGGCAACAGAGCAAGACTCTGTCTCAAAAAAAAAAAAAAAAA"
"GL873547","3945364","3945487","chr6","162922187","162922311","39","158976823","GTGTCTCACACCTGTAGTCCTAGTATTCTAGGAGGCTGAGGTGGGTGGGTGGAGCGCCTGAGCTCAGAAATTCCAGACCAGCCTGAGCAAGAGTAAAACCAGGTCTCTTAAAATAGCCCCGTGT","TGGCTCACTCTTATAATCCTAGCACTGTGGGAGGCCGAGTTGGGTGGATCACCTGAGGTCAAGAGTTCCAGACCAGCATGACCAATATAGTGAAACCCTGTCTCTACTAAAAATACAAAAATTGT"
"GL873547","5196540","5196670","chr1","16061315","16061447","28","10864775","GGCTGAGCATGGTGGTTCATGCCCCAAATCCCAGCACTTTGGGAGCCTGAGGCAGAGGATTACTTGAGGCCAGGAGTTAAGATTATCCTGGACAATATAGTGAGGCTCCATCTCTACAAAATTATAAAATA","GGCTGGGCATGGTGGCTCATGCCTGTAATCCTAGCACTTTGGGAGGTTGAGGCAGGCAGATCACTTGAGGTCAGGAATCTGAGACTAGCCTGGCCAACATGGTGAAACTCCATCTCTACTAAAAAAAAAAAAA"
"GL873547","5196972","5197216","chr11","49346494","49346722","73","44149522","TATATATATATACACACACACGCACACATATATATACACACACTACATATATACATATATATATATATGAAATAGCTGGTATGGTGACACACACCTACAGTCCTAGCTACTCAGAAGGCTGAAGCAAAAGGATTGTTCAACCTCTGGAGTTCAAGGTTGCAGTGATCTATGATCATGCTACTGCACCAAAGCTCTAAGTGATAGAAAGAGTGAAACTTTATCTGTAAAAAAAAAAGAAAAGAAAA","TATATATATATATATATATACACACACACACACATACACACACACATATATATATATAAATTTGTCAGGTGTGGTGGCCCACACCTGTAATCCCAGCTACTCAGGAGGCTGAGGCAGGAGAATCGCTTGAACCTGGGAGGCAGAGATTGCAGTGAGCCAAGATCGCAACCACTGCCCTCCAGTGTGGGTGACAGAGCTAGACTCCATCTCAAAAAATAAGATAAACAAA"
"GL873547","5733442","5733576","chr1","11468259","11468391","48","5734817","GGAGCCTGGAGGCGGGAGGGGCCGCCGAGAACACCAAGGGCGGACTAGGGAGCTATCCAAGCCACTGCACTCTAGCTTGGGTGACAGAGTAAGACCTTGTCTAAATAAATAAATAAATAAATATTTTTTAAAAAA","GGGTGAGGTGGGAAAATTGCTTGAACCCAGGAGGTGGAGGTTGCAGTGAGCAGAGACTGTGCCACTGCACTCCAGTCTGGGCGACAGAGTAAGACTCTGTCTCAATAAAATAAATAAATATAAAGAAGAAGAA"
"GL873547","7357557","7357692","chr1","29437872","29437991","30","22080315","GGCCGGGCGTGGTGGCTCACGCCTGTAGTCCCAGCGCTGTGGGAGGCCGAGGCAGGTGGATCACCTGTGCTCAGAGGTTCGAGACCAGCCAAGACCCCCCTGAGCCAAACGAGCCAGAGTGAGACCCCGTCTCTAC","GGCCGGGCGTGGTGGCTCACGCCTGTAATCCCAACATTTTGGGAGGCCAAGGCGGGTGGATCACCTGAGGTCAGAAGTTCGAGACCAACCTGGCCAACATGGTGAAACCCCTGTCTCTAC"
"GL873547","9704989","9705118","chr4","71764038","71764170","28","62059049","GGCTGGGTACAGTGGCTCAGGCCTGTAATCCTAGCACTCTGGAAAGCTGAGGCAAGTGGATCACCTAAGCTCAGCAATTCAAGATGAGCCTGAGAAAAGTGAGACTTCGTCTCTACTAAAAACAGAAAAA","GGCTAGGTACAGTGGCTCATGCCTGTAATCCCAGTACTTTGGAAGGCCGAGGCGAGTGAATCACCTGAGGTCAGGAGTTTGAGCCCAGCCTGACCAACATGGTGAAACCCCGTCTCTACTAAAAATACAAAAA"
"GL873547","10038324","10038352","chr10","12568351","12568378","7","2530027","CCCAGCTCTTACTAAAAATGGAAAATCCT","CCCTGACTCTACTAAAAATACAAAACTT"
"GL873547","11282675","11282746","chr8","51862362","51862427","16","40579687","GGGCTGGTATGGCAGCTCACACCTGTAATCCCAGCACTCTGGGAAGCCCAGGCCAGAGGATAGCTCAAGCCT","GGCCGGGCACGGTGGCTCACACCTGTAATCCCAGCACTATGGGAGGCCGAGGCAGGTAGATCACCT"
"GL873547","11282796","11282974","chr3","124642405","124642577","41","113359609","TATATATATATTAGTTGGGTATGGTGGCAGGCACTTTTACTCCTAGCTACTTGGGAGGCTGAGGCTAGAGAATCACTTAAACTCAGGAGTTTGAAGTTGCTGTGAACTAGGCTGATGCCACTGCACTCTAGCCTGGGCAAAAGAGTAAAACTCAGTCTCCAAAAAACAAAAAAAATAAA","ATATATAAATAGCTGGGTGTGGTGGCAGGTGCCTGTAATCCTAGCTACTTGGGAGGCTGAGGCAGAAGAATTGCTTGAACCAAGAGGCGGAGGTTTCAGTGAACTGAGATTGCACCACTGTACTCCAGCCTGGGCTACAAGAATGAAACTCCATCTCAAAAAAAAAAAAAAAA"
"GL873547","11643470","11643583","chr7","86651664","86651763","39","75008194","AAGAAAAGCCTGGCATAGTGGCCCACACCTGTAATGATAGCACTCTAGGAGGCTGAGACAGGAGTTTAAGATCAGCCTCATCAAGAGTAGAGTGAGATCTTATCTTTACTAAAA","GGCCGGGCATGGTGGCTCACACCCATAATCCTAACACTTTGGGATGTCAGGAGTTTGAGACCAGGCTAGCCAACATGGTGAAAACTCGTTTCTACTGAAA"
"GL873547","12880689","12880739","chr1","95918958","95919004","16","83038269","TATAAATATTAGAATTAGGCTGAGTGTGGTGGCTCACGTCTGTAATTCCAG","ATATATAAATTAGCCAGGCATGGTGGCACACGCCTGTGATCCCAGCT"
"GL873547","18563125","18563320","chr19","48962719","48962899","72","30399594","GGGCACAGTGGCTCACGCCTGTAATTTCAGCACTCTGGGAGGCCTGTAGAGAATAGAGAAGGGCACAGTGGCTCACGCCTGTAATTTCAGCACTGCCTGAGATTAGGAGTTTGAGACCAGCTTGAGCAAGAGCAAGACCCTGAGAATAGAGAAGGGCACAGTGGCTCACGCCTGTAATTTCAGCACTCTGGGAGGC","GGCCGGGCGCAGTGGCTCACGCCTGTAATCCCAGCACTTTGGGAATTCGAGGCGGGCAGATCACAAGGTCGGGAGTTCGAGACCAGCCTGGCCAACATGGAGAAACTCTGTGTCTACTAAAAATACAGAAAAAAGGCTGGGCGCAGTGGCTCACGCCTGTAATCCTAGCACTTTGTGAGGC"
"GL873548","3918754","3919009","chr20","51239003","51239265","68","47320249","GCCAGGCCTGGTGGCTCACACCTGTAATTCTAGCATTTTGAGAGGTTGAAGTAGATAGATTCCCTGAGGCCAGGAGTTCAAAACCAGCCTGAACAAGATAAAGATCCTGTCTCTACCAAAACTAGAAAAATTAGCCAGGTATGGTGGCACATGCCTGTAGTCTCAGCTACTTGGGAGGTTGAGGCAGGGGAATCTCTTGAGGTCAGAAGTTCAAGACCAGCCTGAGCAACACGAATGAGGCACCATCTCTACAAAA","GGCCAGGCATGGAGGCTCATGCCTATAATCCCAGCACTTTGGGAGGTCGAGGTGGGTGGATCACCTGAGGTCAGGAGTTCGAAACCAGCCTGGTCAACATGGAGAAATCCTGTCTCTATTAAAAATACAAAAATTAGTCAGGTGTTGTGGCATGTGCCTGTAATTCCAGCTACTTCGGAAGGTGAGGCATGAGGATCCCTTTAAGCTGGGAGGTGGAGTTTGCAGTGAGCCTGGGCAACAGAGTGAGACTCCATCTCAAAAAA"
"GL873548","5505880","5506074","chr11","2904691","2904882","47","2601189","TGGAATCATGTATCTCATTAAAAATATAAAACCATTGCTGAGCATAGTGGCTCATGCCTGTAATCCTAGCACTTTGGGAGGCTGAGGCAGGAGGATCACAAGAGCCCAGGAGTTTGGGGGTTGCAGTGAGCCAAGATTATGCCACTGTATTCTAGCTTGGAAAACAGAGCAAGACCCTAGGTCAAAAAACAAAAA","GTGAAACCCTGTCTCTACTAAAAATACAAAAATTAGCCAGGTGTGGTGGTGCATGCCTGTAATCCCAGCTACTCAGGAGGCTGAGGCAGGAGAATCACTTGAACCCAGGAGGTGGAGGTTGCAATGAGCCAAGATCGTGCCACTGCACTCCAGCCTGGGTGACAGAGCGAGACTCCATCTCAAAAAAAAAAA"
"GL873548","7395200","7395420","chr4","31451686","31451893","58","24056486","GGCCAGGTGTGGTGGCTCACGCCTGTTGTCCCAGCACTGTGGGAGGCCAAGGGGGGTGGATCACCTGAGCTCAGCTGAGTTCGAGACTAGCGGAAGACCAGCATGAGGCAGAGGGAGCCAGAGTGAGACCCCATCTCTACAAAAAAAAAAAAAAGCCAGGCGTTGTGGCGTGCGCCTGTATTCCCAGCTACTTGGGGGAGCAAGAGGGCAAGAGAATCGCT","GGCTGGGTGTGGTGGCTCACGCCCGTAATCCCAGAACTTTGGGAGGCCGAGGGGGGTGGATCACCTGAGGTCAGGAGTTTTCAAGACCAGCCTGGCCAACATGGTGAAACCCCATCTCTACCAAAAATACAAAAATTAGCCAGGCGTGGTGGTGTGCACCTGTAATCCCAGCTACTCGGGAGGCTGAAGCAGGAGAATTGCCTGAATC"
"GL873548","12120266","12120355","chr2","202417552","202417644","28","190297286","GAACCCAAGAGTTTGAGATTGCTGTGAGCTCTGAGGTCAGGGCACTCTACCCAAGGCAACAGAGTGAGACTGGTCTCAACAACAACAAAA","AACCCAGGAGGTGGAGGTTGCAGTGAGCCAAGATTGTGCCATTGCACTCCAGTCTGGGCAACAAGAATGAAACTCCATCTCAAAAAAACAAAA"
"GL873548","12120628","12120831","chr19","53556913","53557119","49","41436285","GGTGTGGTGGCTCACGCCTATAATCCTAGCACTCTGGGAGGCAAGGTAAGTAGATCTCCTGAGTTCAGAAGGTCGAGACCAGCTTCAGCAAGAGCAAGACCCTGTCTCTACTAAAATAGAAAGAACTAGGCAGGTGTTGTGGCAGGTGCCTGTAGTCCCAGTTACTCAGGAGGCTGAAGTAAGAGAATGGCTTGAGCCCAAGAG","GGCTGGGCGCGGTGGCTCACGCCTGTAGTCCCAGCACTTTGGGAGGCTGAGGTGGGCAGATCACCTGAGGTCAGGAGTTCGAGACCAGCCTGGCCAACATGGTGAGACCCTGTCTCTACTAAAAATACAAAAATTAGCCGGGCGTGGTGGCACATGCCTGTAGTCCCAGCTACTCACGAGGCTGAGGCAGGAGAATCGCTTGAGCCC"
"GL873548","13532659","13532903","chr2","70778098","70778365","71","57245439","GGCTAAGTGTGGTGGCTCACGCCTGTAACCCCAGTACTCTGGGAGGTCAAGGCTAGCAGATCCCTTGAGCTCAGGAGTTGGAGACCAGCCTGAGCAAGAGTGGTCCCTAAAATAAAAAAATTAGAGCCAGGCATGGGTGGTTCATGCCTGTAATCCCAGCTCTCTGGGAGGTTGAGGCAGGTGTATTGCTTGAGCTCAGGAGTTGGAGACCAGCCAGAGCAAGAGCAAGACTTTGTCTCTAAAAA","GCCGGGTGCGGTGGCTCATGCCTGTAATCCCAGCACTTTGGGAGGCCAAGGCAGGCAGATCACCTGAGGTCAGGAGTTCGAGACCAGCCTGGCCAACATGGTGAAACCATTCTCTACTAAAAATACAAAGAAATTAGCCAGGCGTGGTGGCACATGCCTGTAATACCAGCTAATTGGGAGGCTGAGGCAGGAGAATTGCTTGAACCCGGGAGGCAGAGGTTGCAGTGAGCAGAGAGCATGCAACAGAACGAGGCTCTGTCTCAAAAAA"
"GL873548","15019866","15019959","chr13","39707051","39707144","24","24687185","TTTGAGGTTGTTGTGAGCTAAGACGTCACAGCACTCTAGCAAGGGTGACCAAATTAGACTCTCTCAAAAAAAAAAAAAAAAAAGAAAAGAAAAA","GAGGTTGCACTGAGCTGAGACTGACCCACTGCACTCCAGCCAGGGTGACAGAGCAAGACGCTGTCTCAAAAAAAAAAAAAAAAAAAAAAAAAAA"
"GL873548","15020229","15020437","chr13","27893942","27894155","56","12873713","GGCCAGGCACCGTGGCTCCTGCCTGTAATCCCAACACTTGGGAGGCCAAGGTGGGTGAATTGCCTAAGCTTACAGGTTCAAGACCAGTCTGAGCCAGAGCAACACCCTGTCTCTAAAAATAGCTGGGCATTATGGCAAATGCCTGTAGTTCCAGCTGCTTGGGAGGCTGAGGCAAAAGGATCACTTGAACCCAGGAGTTTGAGGTTGTT","GGCCATGCACAGTGGCTCACGCCTGTAATCCTAGCGCTTCAGGAGGCCGAGGCAGGCAGATTGCCTGAGCTCAGGAGTTTGAGACCAGTCTGGGCAACATGGTAAAACCCATCTCTGCAAAAATTAGCTGGGCGTGGTTGTACATGCCCGTAATCCCAGCTACTTGGGAGGCTGAGGCACGAGAATCGCTTGAACCTGGGAGGCGGAGGATGCA"
"GL873548","15066147","15066239","chr1","114060640","114060726","21","98994493","GACTGGGCATGGTGGCATAACGCCTGTAACCCTAGCACTCTGGGAGTCTTATGTGGGAGAATTGCTTGATGTCAGGAGTTTAAGACTAGCTTA","GACCGGGCGTGGTGGCTCACGCCTGTAATCCCAGCACTTTGGGAGGCTGAGGTGGGCAGATCATGAGGTCAGGAGTTCAAGACCAGC"
"GL873548","15066530","15066743","chr1","25987435","25987643","50","10920905","AGACTAGCTTAATCAAGGTGAGATCCTATCTCTACTACAAATAAAAAAATAACCCAGGTGTGGTGGTACATGCCTGTAGTCTCAGCTACTGGGGAGGCTGAGGCAGGAGGATTGCTTGAACCCAGGAGTTTGAGGTTGCTGTGAGGTAGGCTGACACCACAACACTCTAGCCTAGGTAGCAGAATGAGACTCTTTCTCAAAAAACAGAACAGAA","AACTTGGCCAACATGATGAAACCACACCTCTACTAAAAAATACAAAAATTAGCCGGGTGTGATGGTGCATGCCTGTAATCCCAGCTGCTGGGGAGGCTGGGGCATGAGAATCGCTTGAACCCGGGAGATGGAGGTTGCAGTGAGCTGAGATCACACCACTGCACTCCAGCCTGGGCAACAGAGTGAGACTCCATCTCAAAAAAAGAAAA"
"GL873548","15249374","15249463","chr5","46485072","46485159","19","31235698","GGCCAGGCATGGTGGCTCATACCTATTGTCCTAGCACTGTGGGAAGCCAAGGCAAGTGGATCACCTGAGCTCTAGAGGTTCGAGACCAGC","GGACAGACACAGTGGCTCATGCCTGTAATCCCAGCAGTTTGGGAGGCCAAGGCAGGTGGATCACCTGAGGTACAGAGTTCAAGACCAG"
"GL873548","15817199","15817306","chr7","158031905","158031997","37","142214706","AAAAAAAAAGAGTTGGAGGTTGCTATGAGCAACATCAGCATGGCACTCAATTCCAGGGTGACTGACTGAGACTGTTGTAGCTATACTCCAAAAAAAAAAACACACAAA","CCAGGAGGTGGAGGTTGCAATGAGCCAAGATCACACCACTGCACTCCAGCCTGGGTGACAGGGTGAGATTCTGTCTCAAAAAAAAAAAAAAAA"
"GL873548","15817589","15817786","chr3","3025868","3026088","60","12791721","GGCCAGGCATGGTGGCTTCTGTAATGCCAGCATTCTGGAAGGCTGAGGTAGGCAGTAGCTTGAGCTCAGTAGGAGAACAGCCTGACCAAAAGTGAGACCCTGTCTCTAAAAATAGTCGTTTGTGGTGGTTACCTGTTGTCCCAGCTACTAGGGAGGCTGAGGCAAGAGAATCACTTGAGCGTAAGAGTTGGAGGTTGC","GGCCAGGCACGGTGGCTCATGCCTGTAATCCCAGAACTTTGGGAGGCTGAGGTGGGCAGATCACCTGAGGTCAGGAGTTGGAGACCAGCCTGACCAACATGGTGAAACCCTGTCTCTACTAAAAATACAAAATTAGCCAGGTGTAGTGGCACGTGCCTGTAATCACAGCTACTTAGGAGGCTGAAGTAGGAGAATCACTTGAACCTGGGAGGTGGAGGTTG"
"GL873548","15856498","15856605","chr18","35090078","35090171","38","19233580","CCCCCCCCAAAAAGAAAAGGGTTGCTTGAATCTAGGAGTTTGGGGTTGCTGTGGGCTAAGCTGATACCACAGCACTTTAGCCTGAGCAAACAGAGTGACACTCTGTCT","AAGCAGGAAATCGCTTGAACCCAGGAAGCAGAGTTGCAGTGAGCCAAGATCGCACCACTGCACTGCAGCCTGAGCAACAGAGAAAGACTCTGTC"
"GL873548","15856683","15856877","chr3","3200882","3201085","53","12655801","GCCAGGCACAGTGGCTCATGCCTATAATCCTAGCACTCTGGGAGGCCAAGGCAGGATTGTCTAAGCTTGGGAGTTTGACAGCAGCCTGAGAAAGATTGAGACCCCTGTCTCTACTAAAAAATAGAAAAATTAGCTGAGTGTTGCAGCAGGTGCCTGTATTTCCAGCCAAGGGGGAGGTTGAAAAGGGTCGCTTCA","GGCCAGGCGCAGTGGCTCATGCCTGTAATCCCAGCACTTTGGGAGGCCGAGGCGGGTGGATCATAAGGTCAGGAGTTTGAGACCAGCCTGGTCAACATGGTGAAACCCCATCTCTACTAAAAATACAAAAATTAGCTGGGTGTTGTGGCACATACCTGTAATCCCACCTACTCAGGAGGCTGAGGCAGGAGAATCACTTGAACC"
"GL873549","1940307","1940608","chr12","9481260","9481565","74","7540953","GGCTGGGCGCAGGGGCTCATGCCTGTGACCCTAGCACCCTGGGAAGCCAAGGCGGGCAGATCGCCTAAGCTCACGAGTTTGAAACCAGCCTTAGCTAGAGTGAGACCCCCAATACTAAAAAAATAGCCAGGCTTTGTGATGGGCGCCTGTAGTCCCAGCTACCTGGGAGGCTGAGGCAAGAGAATGGCTCAAGCCCAAGAGTCTGAGGTCACAGTGAGCTACTGACGCCACCGCACTCTATTGGAACAACAAAGTGAGACTGTGTCTCAAACAAACAAACAAACAAACAAACAAAAAAGAAA","GCTGGGCGCGGTGGCTCATGCCTGTAATCCCAGCACTTTGGGAGGCCAAGGCAGGTGGATCACCTGAGGTCAGGAGTTCGAGACCAGCCTAGTCCACATGGTGAAACCCCATCTCTACTAAAAACTAGCCAGGCGTGGTGGTGCGCACCTGTAATCCCAGCTACTCGAGAGGCTGAGGCAGGAGAATCACTTGAGCCTAGGAAGCAGAGGTTGTGGTGAGCTGAGATCACACCACTGCACTCCAGTCTGGGCGACACAGTGAGACTCTTGTCTCAAAAACAAAAAACAAACAAACAAACAAACAAA"
"GL873549","2657819","2658019","chr11","18547798","18548000","50","15889979","GGCCTGGCACTGTGGCTCACACCTGTCAGGTTAACACTCTGGGAGGCTGATATGGGTGGGTCTCCTGAGTTTAGGAGTTTAAGACCAGCCTAATCAAGAGTAAGACCTGCCTTTACTAAAAATAGAAACACTCACCAGGACTACTGTGCACCTACAGTCCCAGCTACCTGGGAGGCTGAGGCAAGAGGATTGCTCAAGCCC","GGCCAGGCACTGTGGCTCACACCTGCAATCCCACCACTCTGGGAGGCAGAGGCAGGTGGATCACCTGAGGTCAGGAGTTTGAGACCAACCTGGCCAACAGAGCAAAACACTGCCTCTACTAAAAATACAAAAACTAGCCAGGTGTGGTGCATGCCTATAGTCCCACCTACTTGGGAGGCTGAAGCAGGAGAATCTCCTGAGCC"
"GL873549","8853848","8853952","chr12","88112976","88113081","32","79259128","AGCCAGCTGTGTGGCTCATTCCAGTAATTCCAGTTACTGGGGAGGCTGAGACAGGAGGATCACTTGAATGCAAGAGGTGGCGAGAACTCAGCTTTAAAAATAAAA","GGCCAGATGCAGTGGCTCATGCCTGTAATCCCAGCACTTTGGGAGGCTGAGGCAGGCGGATCACCTGAGATCAGGAGTTTGAGACCAGCCTGGCCAACATGGTAAA"
"GL873549","10378794","10378882","chr20","18199749","18199840","17","7820955","GGCCAGGCACGGTGGTTCACCTGTGATCCCAGCACTCTGGGAGATAAGGCAGGCTGATCACCTGAGTTCACAGGTTGGAGACCAGCCTG","GGCCGGGCATGGTGGCTCACACCTGTAATCCCAGCACTTTGGGAGGCTGAGGCAGGCGGATCACCTGAGGTCAGGAGTTCGAGACCGGCCTG"
"GL873549","15488169","15488282","chr10","38476693","38476794","41","22988524","CTGAGCACACGGGTTCACACCTGTAATCCCAGCACGCTGAGAAGCCCAGGCAAGAGGCTGACCTCCAGCCTGGGTGACGGAGCGAGATTCCCCCCCACCCCCGACCAAAAAAAA","CTGAGCGCTGGTAGCTTACACCTGTAATCCCAGCACTTTGGGAGGCCTAGACAGGCGGATCACTTGGGGTCAGGAGTTTGAGACCAGCCTGGCCAATATGAT"
"GL873549","17403348","17403519","chr10","38461164","38461337","46","21057816","GCCAGGCACAGTGGCCCACACCTGTAATCCCAGTACTGTGGGAGGCTGAGGCAGGCTGAGGCAGGCATGGATCACTGAGGTTGCTGTGAGCTAAGATGCCATGGCCCTCCACCCAAAGTGACAGAGTGAGACTCTGTCTCAGAATTAAAAAAAACAAAGAAAGAAAAATAAA","GCCAGGCATGGTGACTCACGCCTATAATCCCAGCACTTTGGGAGGCTGAGGCATGAGAATCACTTGAACCCAGAAGGCAGAGGTTGCAGTGAGCTAAGATTGTGCCACTGTACTCCTGCCTGGGTGATGGAGTGAGACTCTGTCTCGATTTAAAAAAAAAAAAAAAAAAAAAAA"
"GL873550","801968","802043","chr15","50500527","50500602","20","49698559","GTAGCCAGGTATGGTAGTGCAGGCCTGTACTCCCAGCTACTTGGAAAGCTAAGGCAATAGAATCATTTAAGCCCAG","TGGCCGGGCATGGTGGTACATGCCTGTAATCCCAGCTACTTGGGAAGCTGAAGCAGGAGAATTGCTCGAACCCAGG"
"GL873550","802343","802376","chr3","33494224","33494257","9","32691881","TAAGACTTTGTCTCTACTAAAAATAGAAAAAGTG","GTGAAACCCGTCTCTACTAAAAATACAAAAATTA"
"GL873550","2805841","2805900","chr2","93673843","93673900","18","90868002","CTATTCAAAATAGCTAAAATGGGCAGGGCAAGGTGGCTCACACCTGTAATCCCAGTACTC","TAAAAATGTAAAAGATTGGCCGGGTGTGGTGGCTCACTCCTGTAATCCCAGCACTTTG"
"GL873550","4153085","4153214","chr16","18855701","18855834","37","14702616","GGCAGGGCTTGGTGGTAAAAGCCTGTAATCCTACCACTCTGGGAGGCAGAGGTGGTTAGATTGCATGAGGTCACTGGTTGGAGACCAGCCTGAGCTAGAGCAAGACCTCATCTCCAAAAATAGCAGGGCT","GGCTGGGCGCGGTGGCTCACACCTGTAATCTCAGCACTTTGGGAGGCCGAGGTGGGTGGATCACCTGAGGTCAGGAGTTCGAGACCAGCCTGGCCAACATGGCAAAACCCCATCTCTACAAAAATACAAAATTA"
"GL873550","4153472","4153634","chr7","17472856","17473028","43","13319384","AATAAAAATAGCAGGGCTTTGTGGCGGGCACCTGTAGTCCCAGCTACTTGGGAGGCTGAGGCAAGACAATTGCTTGAGCACAAAGTTGGAGGTTGTTGTGAGCTGTGACATCATAGCACTCTACCAAGGGAGATAGAGTGAGACTATCTCGAAGAAAAAAAAA","ATACAAAAATTAGCCAGGTGTAGTGGCGTGCACCTGTAATCCCAGCTACTCGGGAGGCTGACGCATGAGAACTGCTTGAACTCAGGAAGTGGAGGTTGCAGTGAGCTGAGATAGTGCCACTGCACTCCAGCCTGGGTGACAGAGCAAGACTCCATCTCAAAAAAAAAAAAGAA"
"GL873550","6050671","6050965","chr7","84009904","84010193","74","77959233","GGTGGCTCACGCCTGTTATCCTAGCACTCCAGGAGACTAAGGTAGGAGGATGCCTTGCTTGAACTCAAGAGTTCAAGACCAGTCTGAGTGAGAGGGAGACCCTGCGTCTACTCAAAAATAGAAAAATTTACCAGCCATTGTGGCCAACACCTGTAGACCCAGCTATTCAGGAGTCTGAGGCCAGAGAATCACTTGAACCCAGGAGACTGAGATTGCTGTGAGCTAGGCTAAAACCATGGCACTCTAGCCCAGGTGGCAGAGTGAGACTGGGTCTGCAAAAAATAAATAAAAACAA","TGGCTCATGCCTGTAATCCTAGCACTTTGGGAGGCCAAGGCAGGTGGATTGCCTGAGCTCAGGAGTTCAAGACCAGCCTGGCAACACGATGAAACCCCGTCTCTATTAAAAAATACAAAAAATTGGCCAGGCATGGTGGTGTGCACCTGTAATCCCAGCCACTCAGGAGGCTGAGGCAGGAGAATCGCTTGAACCCGGGAGACAGAGGTTGCAGTGAGCCAAGATCGAACCATTGCACCCCAGCCTGGGTGAGAGTGAGACTCTGTCTAAAAAAAAAAGAAGAAAAAGAA"
"GL873550","6212004","6212068","chr19","50425309","50425373","23","44213305","AGAACCTAAGAGTTTTGAGGTTGCTATGAGCTGGACTGATACCATAGCATTCTAGTCTGGGTGAC","TGAACCCAGGAGGTGGAGGTGGCGTGATGCCCAAGATGTGCCACTGCACTCCAGCCTGGGTGATA"
"GL873550","6212319","6212418","chr17","89042086","89042197","34","82829767","CTGTCTTTTCTAAAAATAGAAAAACTAGCTGGGTTGTGGTGGGCACTTGTAGTCCTAGGTACTCTGAGGCTGAAACAGGATTGCTTGAACCTAAGAGTTT","GTCTCTACTAAAAATACAAAAATTAGCCGGGCATGCTGGTGGGCACCTGTGATCTCAAGCTACTTGGGAGGCTGAGGCAGGAGAATCACTTGAACCTGGGAGGCAGAGGTTG"
"GL873550","6504310","6504401","chr19","2969698","2969794","27","3534612","GTGCTGGTGTATGCACCTGTCATACCAGCTACTCCTGAGGTTGAGGCAGGATAGCTTGAACCCGGGAGTCTGAGACTGCAGTGAGCTGGGAT","TTAGGCGTGGTGCATGTCTGTAATCCCAGCTACCCGAGAGGCTGAGGCAGGAGAATCACTTGAACCTGGGAGGCGGAGGTTGCAGTGAGCCGAGATC"
"GL873550","7178331","7178523","chr19","40691105","40691269","60","33512774","GGCCAGACGCGGTGGCTCACGCCTGTTGTCCCGGCACTGTGGGAGGCCGAGGCTGGTGGATCCCCTGAGCTCAGCCAAGTTCAAGACCAGCGGAAGACCAGCATGAGGCAGAGTGAGCCAGAGTGAGACCCCGTCTCTACAACAACAACAACAAAAAATAGCCGGACCTTGTGATCCCAGCTACATGGGAGGC","GGCCGGGCATGGTGGCTCACGCCTGTAATCCCAGCACTTTGAGAGGTCGAGGCAGGTGGATCACCTGAGGTCAGGAGTTCGAGACCAGCCCGGCCAATATGGTGAAACCCCTTCTCTACTAAAAATACAAAAAATTAGCCGGAAGTGGTGGCATGCACCTGTGAT"
"GL873550","7981631","7981790","chr6","148611209","148611366","40","140629578","ATAGCCCCGCCTTGTGGTAGGCTCCTGTAGTCCCAGCTACTTGGGAGGCTGGGGCAAGAGAATCACTTAGGCCCAAGAGTTGGAAGTTGCTGTGAGCTGTGATGCTACAGCATTCTACTGAGAGTGACAAAATGAGACTCTGTTTAAAAAAAAAAAAAAA","TTAGCTGGGCATGGTGGCAGGTGCCTGTAATCCCAGCTACTCTGGAGGCTGAAGCAAGAGAATCGCTTGAACCCAGGAGGTGTAGGTTGCAGTGAGTCGTGCCACAGCACTCCATCCTGGGTGACAGAGCAAGACTCTGTCTCAAAAAAAAAAAAAAA"
"GL873550","7982053","7982180","chr2","182489403","182489528","28","174507350","GGCTGGGCGAGGTTGTTCAGACCTGTAATCCTAGCACTCTGGGAGACCAAGATGGGTGGATTGCCTGAGTTCATGAGTTTGAGACCAGCCTGAGCCAGAGTGAAACCTTGTTCTCTAAAAATAGCTCG","GGCCGGGTGTGGTGGCTCATGCCTGTAATCCTAGCGCTTTGGGAGGCCGAGGTGGGTGGATTGCCTGAGCTCAGGAGTTCGAGACCAGCCTGGGCAACACGGTGAAACCTGTCTCTACTAAAATAC"
"GL873550","8404122","8404320","chr4","121405930","121406135","43","113001808","GGCCAGGCACAGTGACTCACACCTGAAATCTTAGTACTCTGGGAGGCCAAGGTGGGAGGATTTCCTGAGGTCAGGAGTTCAAGACCAGCCAGAGCAAGAAGATCCTGTCTCTACTAAAAGTATAAAAAGTGAACCAAGTGTGGTAGTGAGCACCTATAATCTCAGCTACTTGGGAGGCCGAAGCAAGAGGATCACTTGA","GGCCAGGCACAGTGGCTCACACCTGTAATCTCAACACTTTGGGAGGCCAAGGTGGGTGGATCACCTGAGGTCAGGAGTTTGAGACAAGCCTAGCCAGCATGGTATAACTCCATCTCTACTAAAAGTATAAAAATCAACCAGGTGTGGTGGCACATGCCTGTGGTCCCAGCTACTTGGGAGGCTGAGGCAGGAGAATCACTTGAATC"
"GL873550","8404408","8404483","chr15","701469","701538","22","7702939","AGGATCTCTTGAGCTCGGGAGTTTGAGGTTGCAGTGAGCCAGGCTGATGTCATGGCACGCTACCCAAGACAACAAA","AATCACTTGAACCCAGGAGGCAGAGGTTGCAGTGAGCCAAGACTGTGCCATGGCACTCTAGCCTGGGCAA"
"GL873550","11648593","11648682","chr3","124881947","124882027","31","113233354","GTGGCTCACACTAGTAATCTTAGTACTTTGGGAAGCTGGGGCAAGAGGATCACTTGAGGTCAGGGTTAGGAAACTCTATCACTACAAAAA","GCGGTGGCTCACGCCTGTAATCCTAGCACTTTGGGAAGCCAGGCAGGCAAATCACGAGGTCAGGAGTTCGAAACCAGCCTG"
"GL873550","12468624","12468663","chr9","62916303","62916339","11","50447679","GCCCGGCTTGGTACCTCATGCCTGTAATCTTAGCACTCCG","GGCCGGGCATGGTGGCTCATGCCTGTAATCCCAGCAC"
"GL873550","12468943","12469188","chr12","70524409","70524645","91","58055466","AATCTTAGCACTCCGGGAGGCCGAGGCGGGTAGACCAACCTAATCAAGAGCAAGATCTACCTCTACTAAAAATAGAAAAGAATTGGCCAGGCGTATTGACTCCGCCTCTAGTGCCAGCTACTCCAAAGCTGAGGCAAGAGGATTGTTCAAATCCAAGAGTTTGAAATTGCTGTATGTTACACCAGGGCACTCTAGCCGTGGAGACATTTTCTCTATATATATTAAAAAAAACAAAAAACAGAAAAA","CTGAGCTCGGGAGTTCGAGACCAGCCTGACCAATATGGAGAAACCCTGTCTCTACTAAAAATGTAAAATTAGCCAGGCATGGTGGCACATGCCTGTAGTCCCAGCTACTCAGGAGGCTGAGGCAGGAGAATCGCTTGAGGTCAGGAGGCGGAGGTTGCAGTGAGCCAAGATCATGCCACTGCACTCCAGCCTGGGTGACAGAGTGAGACTTTGTCTCAAAAAAAAAAAAAAAAAAAA"
"GL873550","14719674","14719880","chr16","30390993","30391163","76","15671319","GGGCGTGGTTGCTCACGCCTGTTGTCCCAGCGCTGTGGGAGACCGAGGCAGATGTATCGCCTGAGCTCAGCCGAGTTCGAGTTCGAGACCAGCGGAGAGACCACCATGAGGCAGAGTGAGCCAGAGTGAGACCCCGTCTCTACAACAACAACAAAGAAAACAGCCGGATCTTGTGATCCCAGCTACATGGGGGCCAAGAGAATCACT","GGGCACGGTGGCTCACACCTGTAATCCCAGCACTTTGGGAAGCCAAGGCAGGAGGATCACCTGAGGTCAGGAGTTCAAGACCAGCCTGGCCAACATGGTGAAACCCCGTCTCTACTAAAAACACAAAAATTAGCCAGGTGTGGTGGTGCACGCTTGTAATCCCAGCTACTC"
"GL873550","15737883","15738154","chr2","20481557","20481833","73","4743674","TTAGCATTCTGGGAGGCCAAGTCAGGTGGATTGCCTGAACTCACAAATTTGAGACTAGCCTGAGATAGAGAAAGATCTTGTCTCTAAAAAAAAAAAAAAATAGCTGGACTTTGTAGTGGGCACCTGTAGTCCCTGCTACTCAGAAGGCTGTGGTAAGAGAATCACTGGAACCCAAGAGTTAGAGGTTGCCGTGAGCTGTGATGCCATGGCACTCTACCAGAGACAACAGAGTGAGACTCTCTCCAAAAAAAAGAAAAAGAAAAAGAAAAAAA","GCACTTTGGGAGGCCAAGGCAGGTGAATCACCTGAGATCAGGAGTTCAAGACCAGCCTGGGCAACATGATGAAACCCTGTCTCTATGAAAAATACAAGAATTAGCTGGGCATAGTGGTGTGCATCTGTAATCCCAGCTACTCAGGAGGCTGAGGTATGAGAATTGCTTGAACCCTGGAGGCAGAGGTTGCAGTGAGCCGAGATGACACCGTTGCACTTCAGCCTGGACAATAGAGAGAGACTCTGTCTCAAAAAAATGAAGAAAAGAAAGAAAGAAA"
"GL873550","15738844","15738873","chr10","65896918","65896951","9","50158074","GGGTGTGGTGGCTGATGCGTGTAATCCTAG","GGCTGGGCGTGGTGGCTCATGCCTGTAATCCCAA"
"GL873550","16345151","16345329","chr1","6754007","6754209","69","9591144","CACCTGTAATCCCAGCACTTGGGAGGTTGAGGAGAGTGGATTGCCTGAGCTCACAGGTTTGAGCCAGAAGGAGACCTCGTCTGTAAAAATAGCTGGGTGTTGAGACCAGCGCCTTTAGTCCCAGCTACTTGGGAGGCTGAGGCAAGAGAATCACTTAAACAATTCTAGAAGCAGAGTTT","CTGTAATCCCAGCACCTTGGGAGGCTGAAGAGGGCGGATCACCTGAGGTCAGGAATTTGAGACCAGCCTGGCCAACATGGTGAAATCCCATCTCTACTGAAAATACAAAATTAGCTGGGTGTGGTGGTGCATGCCTGTAGTTCCAGCTACTTGGGGAGCTGAGGCAGAAGAATGCCTTGAACCCGGGAGGCAGAGGTTGCAGT"
"GL873550","17727115","17727274","chr1","127857902","127858038","52","110130787","GCTGGGTGCAGTGACCCCTGCCTATAATCCCAGCAGTTAGGAGACAAAGGCAGGAGGAATTACCTGAGAGCAGGAGTTCCAGACAAGCCTCAGACCAGCGTGAGCTATGACATTGTCTGTAGCCCCCACCCCACCCCCCCAAAAAACAAAAAGAAACAAA","GGCTGAGTTCAGTGGCGCACGCCTGTAATCCCAGCAGTTGGGAGGCTGAGGCAGGTGGATTGCCTGAGGTCAGGAGTTCAAGACCAGTCTGGCCAACATGGTGAAACTCTGTCTCTACTAAAAAAAAAAAAAAAAAT"
"GL873551","6567068","6567102","chr14","109767086","109767123","14","103200018","GGATCACATGAGGTCAGGAGTTCAAGATCAGCCTG","GGAGGCAGAGGTTGCAGTGAGCCAAGACTGCGCCATTG"
"GL873551","9393264","9393376","chr1","39198637","39198744","32","29805373","CAAGAGTATCTCTGCAACCCAGTGGCCTGAGGTTGCTATGAGCTAGGATGCCACAGCACTCTACCCAAGGGGACAGAGTAAGACTCTGTCTCCAAAAAAAAAAAAGAGCAAAA","AGAATCGCTTGAACCTGGGAGGCGGAGGTTGCAGTGAGACCAGATCATGGCACTGCACTCCAGCCTGGGCGACAGAGTAAGACTCGGTCTCAAAAAAAAAAAAAAAAA"
"GL873551","9393708","9393894","chr12","115674238","115674427","40","106280530","GCTGGGCTCAGTGCCTCTCGCCTGTAATCCCAGCACGCTGGGAGCCTGAGGTGGGTGGGTTGCTTGAGCTTAGGAGTTCAAGACCAGCCTGAACCAGAGCAAGACACTATCTCTACTAAAAATAGAAAAACTATCTGGGCATGGTGGTGCGCACCTGTAGTCCCAGCTACTAGGGAAGCTGAGGCAA","CCAGGCCTGGTGGCTCACGCCTGTAATCCCAGCACTTTGGGAGGCCGAGGTGGGTAGATCACCTGAGGTCAGGAGTTCAAGACCAGCCTGGCCAACATGGCGAAACCCCATCTCTACTAAAAATACAAAAATTAGCTGGGCATGGTGGTGTATGCCTGTAATCCCAGCTACTCGGGAGGCTGAGGCAGGA"
"GL873551","10104594","10104683","chr16","53032852","53032939","31","42928258","GGTAGGTGGGTCTCTCGAGGTTAGGAGCTCTTTACCAGCCTGAGCTGACATAAGACCCAATCTCCACCAAAATAGAGAGAGAAAAAAAGA","GAGGCAGACAAATCTCTTGAGGTCAGGAGTTGAAGACCAGCCTGGGCAACATAGACCTCGTCTCTATTAAAAAAAGAAAAAAGAAAAA"
"GL873551","12307468","12307551","chr8","94102375","94102458","19","81794907","GGCCAGGCATAGCAGCTCATGCCTGTAGTCCTATTATTCTAGGAGGTCCAGGGAGGAGGATCACCTGAGATCAGAAGTTCAAGA","GGCCAGGCATGGTGCCTCATGCCTGTAATCCCAGTACTTTGGGAAGCCAAAGTGGATGGATCACCTGAGGTCAGGAGTTCGAGA"
"GL873551","13335872","13336095","chr4","85819795","85820026","56","72483923","GCCAGGTACAGTAGCTCAGGCCTGTAATCCTAGCACACTGGGAGGCTGAGGTGGTGGATCCTTGAACTCATGAATTCAAGACCAGCCTGAGGAAGAGCAAGACCCCATCTCTCCTAAAAATAGAAAAATTAGCTGGTGTCATGGCAAGTGTCTGTAATCCCAGCCACACAGGAGGCTGAGGCAAGAGGATCTCTTGAACCCAAGACACTAAAGTTACTGGGAGC","GCCGGGCATAGTGGCTCATGCCTGTAATCCCAGCACTTTGGGAGGCTGAGATGGGTGGATCATCTGAAGTTAGGGGTTCGAGACCAGCCTGGCCAAATGGCAAAAACCCATCTCTGCTAAAAATACAAAAATTAGCCAGACATTGTGGCATGTGCCTGTAATCCCAGCTACTCAGGAAGCTGAGACAGGAGAATCGCTTGAACCCAGGAGGCAAAGGTTGCAGTGAGCCAAG"
"GL873552","1195303","1195426","chr3","54039332","54039457","34","52844029","CTACTCTGGATGCCAAGGCAGCGGGATCACTTGAACCCCAGAGTCTGAGGTTGCTGTGATCTCAGCTGACTCCATGGCACACTAGCCTGAGGCAACAGACTGAGACTATATCTCAAAACAAAAA","AGCTACTCAGGAGGCTGAGACAGGGAGAGTCACTTGAACCCAGGAGGCAGAGTTGCAGTGAGCCGAGATCACGCCAACTGCACTCCATGCCTGGGCAACAGAGTGAGACTCCGTCTCAAAAAAAAA"
"GL873552","15010293","15010428","chr1","29437872","29437991","29","14427579","GGCCGGGCGTGGTGGCTCACGCCTGTATTCCCAGCGCTATGGGAGGCCGAGGCGGGTGGATCACCTGTGCTCAGAGGTTCGAGACCAGCCAAGACCCCCCTGAGCCAAACGAGCCAGAGTGAGACCCCGTCTCTAC","GGCCGGGCGTGGTGGCTCACGCCTGTAATCCCAACATTTTGGGAGGCCAAGGCGGGTGGATCACCTGAGGTCAGAAGTTCGAGACCAACCTGGCCAACATGGTGAAACCCCTGTCTCTAC"
"GL873553","860627","860695","chr1","16024119","16024187","13","15163492","GCCAGGCTCAGTGGCTCACGCCTATAATCTTAGCGCCTTTTGGAGGCCAAGGTGGGGGGATTACCTGAG","GGCCAGGCACGGTGGCTCACGCTTGTAATCCCAGCACTTTGGGAGGCCGAGGAGGGTGGATTACCTGAG"
"GL873553","7206820","7206939","chr3","156098583","156098705","38","148891763","AGCTAGGTATGGCAGCTGACATCTGTAACCCTAGCCCTCTGGCAGGCCAGGAATTCAAGACCAGCCTAGACAACATAGTAAGACCCCATCTCTACCAAAAATAATTTAAAATTGGCCAGG","GGCTGGCTGTGGTGGCTCACACCTGTAATCCCAGTACTTTGGATCATGTGAGGTCAGGAGTTCAAGACCAGACTGACCAACATGGTGAAACCCTGCCTCTACTAAAAATACAAAATTAGCCAG"
"GL873553","10985147","10985407","chr12","94325498","94325767","64","83340351","GGCCTGTGGCAGTGGCTCATGCCTGAAATCCTAGCACTCTGGGAGGCTGAGGTGGGTCGATTACCTGAACTCACCAAGACGGAGACCTCATCTCTACTAAAAATAGAAAAACTAGCTGGGCGTGGTGGCAGGTGCCTGTAGTCCCAGTTACTGGGGAGGCTGAGGCAAGAGAATTACTTGAACCCAAGAATTTGAGGTTGCTGTGAGCTATGATGCCACAACACTCTACTCAGGGTGACGGAATAAGACCCTGTCTCAAAA","GGCCGGGTGTGGTGGCTTATGCCTGTAGTCCCAGCACTTTGGGAGGCCGATGGGGATGGATCACCTGAGGTCACTGGCCAACACAGAGAAACCCCATCTCTACTAAAAATACAAAAATTAGCCAGGCGTGGTGGCATGTGCCTATAATCCCAGCTACTTGGGAGGCTGAGGCAGGAGAATCACTTGAACCCGGTAGGCAGAGGTTGCAGTGAGCCGAGATTGTGCCACTGCACTCCAGCCTGAGTGACAGAGCAAGCCTCTGTCTCAAAA"
"GL873553","10985438","10985466","chr16","73760336","73760365","6","62774898","CATAAAAAGAAAGAAAACTGAAAAGAAAA","GAAAGAAAGAAAGGAAAAGAGAAAAGAAAA"
"GL873553","12443178","12443505","chr1","3864926","3865253","98","8578252","GCAGGGTGGGGAGGCTCGCACCTACATCCCCAGCACCCTGGAAGGCTTAGGCAGGTGGACTGGGTTCAGGAGTTGGAGAGCAGCCTGAGCAATAGTGAGATTCTGTCTGCAGTAAAACTAGAAAAATTATTTAGGGGTTGTGCTGGGTGCCTATTATCCTAGCTACTGTTGAGGCAAGGGGACAGCTTGAACCCAGGATTTTCAGGTTTCTGTGAGCTAGGATGATGCCATGATGACCCTCTGACACTTTGCCTGGGCAGTAGAGTGAAACTCTGTCTCAGAAAAAACAAAACAAAACAAAACAAAACAAACAAACAAACGAAAAAAA","GGCCAGGCGTGGTGGCTCACACCTGTAATCCCAGCACTTTGGGAGGCTGAGGCAGGTGGATCACCTGAGGTCAAGAGTTCAAGACCAGCCTGGCCAACATGGTGAAACTCTGTCTCTACTAAAAATACAAAAATTAGCCGGGCATGGTGGTGCATGCCTGTAATCCCAGCTATTCGGGAGGCTGAGGTAGGAGAATAGCTTGAACCCGGGAGGTGGAGGCTGCAGTGAGCTGAGATCATGCCATTGCACTGTAGCCTGAGCAACAGAGAAAGACTCTGTCTCAAAAAACAAAACAAAACAAACAAAAGAACAAAAACAAACAAACAAA"
"GL873553","15121135","15121247","chr1","111354387","111354508","21","96233252","GGGCGTGGTGGCTCACACCTGTAATCCCATCACTTGGGAGGCTGAGGCAGGTGGATCACCTGACCTCAGGAGTTCGAGACCAGCCTGAAGAAGAGTGAGACCCCGTCTCTAAA","GGCCGGGCGTAGTGGCTCACACCTGTAATCCCAGCACTTTGGGAGGCCGAGGCGGATGGATCACCTGAGTTCAGGAGTTTGAGACCAGCCTGACCAAAGTGGTGAAACCCCGTCTCTACTAA"
"GL873553","15121274","15121455","chr7","68420775","68420939","69","53299501","AGATTTCAACAGGCCTAATGGCTTTAGTATATAAAGAGAACTTATAAAGCCAGACTCAGTGGCTTACATCTATAATCCAGGTACTTGGTAGGTTGAAGTGAGAAGATTCTTTGAGCCAGGATTTCCAGCCCAGCCTAGGCAACACAGAGAGACCCCCATCTCTAAAAGAGAAAGGTAAAAAA","GGCTAAAGGGGTGCTCATCTTAAGAATACCAGGCCAGGCGCAGTGGCTCATGCCTGTAATCCTAGCATTTTGGGAGGCTGAGGCGGGTGGATCACCTGAAGTCAGGTGTTTGAGACCAGCCTGAACAACATAGTGAGACCTCATCTCTAATTAAAAAAAGAAAAA"
"GL873553","15614197","15614298","chr4","71691062","71691163","34","56076865","GGTGGCTCACACCTGTTATCCCCATACTCTGGGGGCCTGAGGTGAGAGGATCCCCAGAAGTCAGGAGCTGGAGAGAAGCCTGTGTAAGAGTAAGAGCCAGTC","GTGGCTCATGTCTGTAATCCCAGCACTTTGGGAGGCCGAGGTCGGTGTATCATTTGAAGTCAGGAGTTTGAGACCAGCCTGGCCAACGTGGTGAAACCCTGT"
"GL873553","16849767","16850040","chr1","96770987","96771267","68","79921220","GGCCAGGAGTGGTGGCTCATGCCTGCAATCCCAGCACTTGGGAGGCCAAGGTGGGTGGATTGCCTGAGCTCACAGGTTCAAGACCAGCATGAGCCAGAGAGAGACCTTGTCTCTAAAAATAGGCACAGGTTGTGGTGGGCACCCGTAGTCCCAGCTACTTGGGAGGCTGAGGCAAGAGAATCACTTAAGCCCAGGAGTTTGAGGTTGCTGTGAGCTAAGACACCACAGCACTCTACCAAGGGTGACAAAGTAAAACTCAGATTTTTTTAAAAAA","GGCCAGGTGTGGTGGCTCACAGCCTGTAATCCCAGTAGTTTGGGAGGCCGAGGTGAGCAGATCACCTGAGGTCAGCAGTTCGAGACCAGCCTGGCCAACATGGCAAAACCCTATCTCTACTAAAAGTACAAGGTGTGGTGGCACACACCTGTAGTCCCAGCTACTTGGGAGGCTGAGGCAGGAGAATCACTTGAACTCCAGAGGTGGAGGTTGCAGTGAGCCAAGATTATGCCACCGCATTCCAGCCTGGGTGACAGAGTGAGACTCCGTCTCCAAAAAAA"
"GL873554","511555","511741","chr6","166828248","166828429","56","166316693","GTGGGACCCGCATCTATACTAAAAATGAAAAACTAGTCAGACTTGGTGACTCATGCCTATAATTTCAGTTTCTTGGGAGGTGAAGGCAGAAGAATTGCTTGATCCCAGGAATCTGAGATTGCTGTGAGCTAGGCTAACACTATGGCACTCCAGCCCAGCTGACAGAGTAAGACTTTGTCTTTAAAAA","ACCCCATCTCTACTGAAAATAGAAACATTAGCCGGGCTTGGTGGCATGCGCCTGTAGTCCCAGCTATTTGGGAGGCTGAGGCAGGAGAATTGCTGGAACCCAGGAGGCAGAGATTGCAGTGAGCGGAGATCATGCCATTGCACTCCAGCCTGGGCGACAGAATGAGGCTCCATCTCAAAAAA"
"GL873554","2046660","2046725","chr8","51862362","51862427","7","49815702","GGCTGGCCGCGGTGGCTCACGCCTGTAATCCTAGCACTCTGGGAGGCCGAGGCAGGCAGATCACCT","GGCCGGGCACGGTGGCTCACACCTGTAATCCCAGCACTATGGGAGGCCGAGGCAGGTAGATCACCT"
"GL873554","2580766","2581036","chr13","93262937","93263229","81","90682171","GGCCTGGGCAAGGTGGCTCACTCTCTGGAAGGCTGAGGCAGATGGATTGCCTGAGCTCAGGAGCTAGAGACTAGCATGATCTCACCTCTACTAAAAATAGAGAAACTAGCCAGGCATTACAGCACACGCTTGCAGCCCCAGCTACTCTGGGGGCTGAGGCAAAAGGATCACTTGGACTCAAGAAACTGAGGTTCCTGTGAGCCATGATGCCAGGACACTCTACCCAGGGAAACAGAGTGAGACTTCATCTCAAAAAAAAAAAGAAAGAAAA","GGCTGGGTGCAGTGGCTCACGCCTGCACTTTGGGAGGCCAAGGCAGGTGGATCACCTGAGGTCAAGAGTTTGAGACCAGCCTGGTCAACATGGTGAAACCCCATCTCTACTAAAAATACAAAAATTAGCCAGGCATGGTGGCACGTGCCTGTAATCTCAGCTACTCTGGAGGGTGAAGCAAAAGAATCACTTGAACCCAGGAGGCAGAGGTTGCAGTGAGCCAAAATCATGCCACTGCACTCTGGCCTGGGCAACAGAGTGAGACTCCATGTCAAAAAAAAAAAAAAAAAAAA"
"GL873554","5465741","5465829","chr11","47014803","47014890","15","41549062","GGCCAGGCATGGTGGCTCACGCCTGTAGTCCCAGCGCTGTGAGAGGCCGAGGCGGGTGGATCACCTGTGCTTAGAGGTTCGAGACCAGC","GGCCGGGCACCGTGGCTCACGCCTGTAATCCCAGCACTTTGGGAGGCCAAGGCGGGTGGATTACCTGAGGTTAGGAGTTCGAGACTAG"
"GL873555","8807785","8807956","chr1","12240468","12240612","48","3432683","GGCCGGGCGTGGTGGCGCACGCCTGTAGTCCCAGCGCTATGGGAGGCCGAGGCGGGTGGATCACCTGAGCTCAGAGGTTCGAGACCAGCCAAGACCCCCCTGAGCCAAACGAGCCAGAGTGAGACCCCGTCTCTACAACAACAACAGGACAACAAAACAGCCGGACCTTGTG","GGCCGGGCGCGGTGGCTCATGCCTGTAATCCCAGCACTTTGGGAGGCTGAGGCGGGTGGATCACCTGCGGTCAGGAGTTCGAGACCAGCCTGGCCAACGTGGTGAAACCTCATCTCTACTAAAAATATAAAAATTAGCTGGTGTG"
"GL873555","8828420","8828440","chr3","5439989","5440005","4","3388431","ATAATAATAATAATAAATTAG","ATAATAATAAAATAAAA"
"GL873555","12399534","12399604","chr15","102111398","102111458","22","89711864","GGCCAGGCATGGTGGCTCACACCTATAATCCTGGGAGGCTGAGGATTATCTGAGCTCAGGGATGTGAGACC","GGCCAGGCACGGTGGCTAAGGCCTGTAATCTGGGAGGCTGAGATGGGTGGATCACCTGAGG"
"GL873555","12440877","12440963","chr19","21209507","21209590","24","8768630","GTGGGGAGTGCACCTGAACTTTGGAGTTCAAGACCAGCCTGGGCAACATTGTGTGAGCCCTGTCTCAATTGGAAAACAAAACAAAAA","AGGTGGGCAGATCACCTAAGGTCAGGAGTTCAAGACCAGACTGGCAAAAATGGTGAAACCCTGTCTCTACTAAAAATAAAAAAA"
"GL873555","13094462","13094529","chr1","100916857","100916922","22","87822395","GCTTGTACCTATAATCCTGGTACTTTGGGAGCCTCAGGAGAGTGGATCACCTGAGTAAGAGCAAGACC","CATGCCTGTAATCCCAGCACCTTGGGAGGCCAAGGTGGGTGGATCACCTGAGGTCAGTAGTTTGAG"
"GL873555","13254579","13254784","chr7","32729330","32729532","64","19474751","GACCAATCTAAGCCAGAGCTGTCTATGCTAAAAATAGAATAATAAGCCTGGTTTATGGTAGGAGCCTGTAGTCTCAGTTACCTGGGTGTCTGGGGCAAGAGATTGACTTAAAACCAGGAGTTTGAGGTTGCTGTAAGCTAGGCTGACACCACAATACTCTAATCTGGGCAGAGTGAGATTCTGTCTCAAAAAAAAAAAGAAAGAAA","GAAACCCCATCTCTACTAAAAATACAAAATTAGCCAGGCATGGTGGTGCACACCTGTAGCTCCAACTACTTGGGAGGCTGAGGCAGGAGAATCACTTAAACCCAGGCAGTAGAGGTTGCAGTAAGCCAAGATCGCACCACTGCACTCCAGTCTGGGCAACAGAGTGAGACTCTGTCTCAAAAAAAAAAAAAAAAAAAAAAAAA"
"GL873555","13255065","13255153","chr10","29045352","29045442","23","15790287","CTGGGCACAGTGGCTGAGGGTGTAATCCTACCACCCTAGGAGGTTGAGGCAGAAGGATCACTTGAGCTCAGGAATTCAATACAAGTCTA","GGCGGGGCACAGTGGCTCATGCCTGTAATCCTAGTACTTTGGGAGGTCGAGGCGGATGGATCATCTGAGGTCAGGAGTTTAAGACCAGTCT"
"GL873555","13262783","13262918","chr1","29437872","29437991","30","16175089","GGCCGGGCGTGGTGGCGCACGCCTGTAGTCCCAGCACTATGGGAGGCTGAGGCGGGTGGATCACCTGTGCTCAGAGGTTCGAGACCAGCCAAGACCCCCCTGAGCCAAACGAGCCAGAGTGAGACCCCGTCTCTAC","GGCCGGGCGTGGTGGCTCACGCCTGTAATCCCAACATTTTGGGAGGCCAAGGCGGGTGGATCACCTGAGGTCAGAAGTTCGAGACCAACCTGGCCAACATGGTGAAACCCCTGTCTCTAC"
"GL873556","639117","639366","chr1","62410822","62411038","72","61771705","GGCCGGGTGTGGTGGCTCATGCCTGTTGTCCCAGCACTGTGGGAGGCCAAGGCAGGTGGATCGCCTGAGCTCAGCCAAGTTCGAGACCAGCGGAAGACCAGCATGAGGCACAGTGAGCCAGAGTGAGACCCTACCTCTACAAAACAACAACAACAACAAAAAACCCAGCCAGATGTTGTGGCAAGTGTCTGTAATCCCAGCTACATGAGGGGCAAGAGGGCAAGAGAATCACTAAAGGAGGAAGAAGTAA","GGCCGGGCGTGGTGGCTCACACCTGTAATCCCAGCACTTTGGGAGGCCAAGGTGGGTGGATCTCCTGAGGTCAGGAGTTCGAGAGCAGCCTGGCCAACATGGTGAAACCCTGTCTCTACTAAAATACAAAAATTAGCCAGGTGTGGTGGCACGTGCCTGTAATCCCACCTACTCAGGAAGCTGAGGCAGGAGAATCACTTAAAGCTGGGAGAGAGAG"
"GL873556","639390","639468","chr20","16893610","16893664","30","16254220","ACTTCAAACTAAGATAAAGTGAAAGTCAGCAGAAATTGAAAGCAAAAACAAAAACAAAAAAAAAAAAAAAAAAAAAAGA","AACAAAACAAAACAAAACAAAACAAAACAGACAAAAAAAAAAAAACAAAGAAAAA"
"GL873556","2031445","2031493","chr13","87950184","87950229","13","85918739","AGACCCTATCTCTACTAAAAATAGAAAAACTAGCCCAGTATAGTGATGC","AAACCCCATCTCTAGTAAAAATACAAAATTAGCTGGGTGTGGTGGC"
"GL873556","6655305","6655664","chr2","190010230","190010561","107","183354925","GGCCAGGCATGGTGGCTCACACCTGTAATCCTAGCACTCTGGAAGGCCAAGGGAGGTGAATTTCTTGAAGTTCGAGATCAGCCTAAGAGGAATGATACCCCACCTTTACTAGGAATAAAAAAAAAAAAAAAAAAAAACCCAAAACTAGCCTGGCATTGTGGCAGTTCTCTGTAATCCAAGCTACTTGGGAGGCTGAGGTAGAAGGATTGCTTGAACCAAAGAGTTTGACTAGAGGTTGCTGTGAGCTAGGCTAATGTCACCACACTCTATCCAGGGCAAGTGAGTGAAACTCCGTCTCAAAATAAATAAATAAATAAATAAATAAGTAAGAAAAACTTTTGCCCATAAAAAAAAAAAGAA","GGCCGGGCGCGGTGGCTCACACCTGTAATTCTAGCACTTTGGAAGGCTGAGGTGGGTGAATTGTCTGAGCTCAGAAGTTCGAGACCAGCCTGGGCAACACAGTGAAACCCCATCTCTACTAAAATACAAAAAAAAAAAAAAATTAGCTGGGCATGGTGGTGTGCACCTGTAGTCCCAGCTACTCAGGAGGCTGAGGCAGGAGAATTGCTTGAACCCAGGAGGCAGAGGTTGCAGTGAGCTGAGATCACGCCACTACACTCCAGCCTGGGCAACAGAGTGAGACTCCACCTCTTTAAAAAAAAAAAAAAGAAAGAAAGAAAGAAAGAAAGAAA"
"GL873556","10802692","10802792","chr20","28544296","28544376","36","17741604","TACAAAGAAATATCATTATTGGCCAGGTGCAGTGGTTCACATCTGTAATTCTAGTACACTAGTACTCAGGAGGATCACTTGAGGTCAGGAGCTTGTGACCA","TAGAAATGCACAATTCACCTGGGCACGGTGGCTCACTCCTGTAATTCCAGTACTTTGGGAGGCATGAGGTCAGGAGTTCAA"
"GL873557","1682363","1682659","chr6","13352322","13352625","72","11669959","GGCCAGGTGTCGTGGCTCAGGCCTGTAATCCCAGCATTCTGGGAGGCTGAGGTGGGTGGATTGCCCTGAGGTCACAGGTTCCAGACCAGCCTGAGCAAGAGCGAGACTCCATTTCTAATAAAATAGCCGGGTGTTGTGGTAGGTGCCTGTAGTCCCAGTTACTCGGGAGGCTGAGACAAGAGAATCATTTGAACCCAGGAATTTGAGGTTGCTGTGAGCTGTGATGCCACAGGACTCTACTGAGGGCAATAAAGTGAGACTGTCTCAAATAAACAAACAAACAAACAAAAACAAAAA","GGCCAGGTGTGGTGGCTCAGGCCTGTAATCCCAGCACTTTGGGAGACTGAGGTGGGCGGATCACCTGAAGTAAGGAGTTCAAGACCAGCCTGGCCTACATAGTGAAACCCCATCTCTACTAAAAATACAAAATTAGCTGGGTGTGGTGGCACGTGCCTGTAGTCCCAGCTATTCGGGAGGCTGAGTCAGGAGAATCACTTGAACCCAGGATGGGGAGGTTGCAGTGAGCCGAGATCACACCACTGCACTCCAGCCTTGGCAACAGATTGAGACTCTTTCTCAAAAAAAAAAAAAAAAAAAAAAA"
"GL873557","2465751","2465841","chr16","4764895","4764982","15","2299144","GGCCGGGCTTGGTGGTTCACGTCTGTTGTCCCAGCACTGTGGGAGGCCGAGGCAGGTGGATCACCTAAGCTCAGCCAAGTTCGAGACTAGC","GGTCGGGTGTGGTGGGTCACGACTGTAATCCCAGCACTTTGGGAGGCCGAGGCAGATGGATCACCTGAGGTCAGAAGTTCGAGACCAG"
"GL873557","4047834","4047915","chr12","77852792","77852880","22","73804958","ACAAGAGGTTGCTTTGAACTGTGATGCCACAGAGCACTATCCTGGGCAACAGAGACTCTGTCTCAAAAAAAAAAAAAAAAAA","CAGAGGTTGCAGTGAGCTGAGACTGTGCCACTGCACTCCAGCCTGCGCGACAAGAGTGAGACTCTGTCTCAAAAAAAAAAAAAAAAAAA"
"GL873557","4048202","4048390","chrX","23681445","23681631","42","19633243","GGCTGGGTGTGGTGGCTCACACCTGTGATTCTAGCACTCTGGGAGGCCAACGTGGGCAGATCACCTGAGCTTAGGAGTTCAAGACCAGTGTGAGCAAAATGAGACCCCGCCTCTACTAAAAATAGAAAAACTAGCCAGGCACTGTGGTGGGTGCCTATCATCCCAGCTACTCAGGAGGCAGGCAAGAGG","GGCCAGGCGTGGTGGCTCACGCCTGTAATCCCAGCACTTTGGGAGGCCGAGGTGGGTGGATCACCTGAGGTCAGGAGTTCAAGACCAGCCTGGCCAACATGGTGAAACCCCGTCTCTACTAAAAATATAAAAATTAGCCAGGGTGTGGTAGTGCCTGCCTGTAATCCCAGCTACTCGGGAGGCTGAG"
"GL873557","6292327","6292620","chr19","32265157","32265444","82","25972830","GTCAGGCACGGTGGCTCATGCTTGTTGGATTATCCCAACACTCTGGGAGGCCAAGGTGGATCGATTGTCTGAGCTCTGGAGTTCAAGACCAGCCTGAGCAGAAGCAAGACTCCATCTCTAAAAAAAAATAGCTGGGCATTGTGGTGGGCACTTGTATTCCTAGCTACTTGGAAAGCCTGAGGCAAGAGGATTGCTTGAACCCAAGAGTTTGAGGTTGCTGTGAGCTTAAGATGTCACAGCACTCTATAGAGGCTGAGCAAGTGAGACTCCAAAAAGTGAGTTTCCAGAAAAAAA","GACTAGGCACTGTGGCTCATGCCTGTAATCCCAGCACTTTGGGAGGCCGAGGCGGGTAGATCACCTGAGCTCAGGAGTTTCAGACCAGCCTGAGCAACATGGCAAAACCCCATCTCTACTAAACATTAGCCAGGCATGGTGGTGTGCACCTGTAATCCCAGCTACTTGGAAGGTTGAGGCAGGAGGATCACTTGAACCTCAGGAGGCAGAGGTTGCAGTGAGCCAAGATGACATGACTGCACTCCAATCTGGGTGGCAGAGCAAGACTCTGTCTCAAAAAAAAAAAAA"
"GL873557","6324546","6324617","chr1","39656281","39656348","22","33331735","CGCCTGTTGTCCCAGCACTGTGGGAGTGTGAGTAGGGTGGATCACCTTAGCTCAGCTGAGTTTGAGACCAGC","CATGCCTGTAATCCCAGCACTTTGGGAGGTCAAGGCTGGCAAATCACCTAAGGTCAAGAGTTTGAGAC"
"GL873557","6406262","6406343","chr1","199505332","199505412","11","193099070","CAGGCGCAGTGGCTCAATCCTATAATCCCAGCACTTTGGGAGGCTGAGGCAGGTGGATTACCTGAGCTCAGGAGTTTGAGAC","CCAGGCGCAGTGGCTCACACCTGTAATCCCAGCACTTTGGGAGGCTGAGGCAGGCAGATCACCTGAGGTCAGGAGTTGGAG"
"GL873557","6417612","6417692","chr13","102319052","102319128","16","95901440","GAGGTTGCTGTGAGCTAGACTGAGGCCACAGCACTCTAGCCTGGGCAACAGAGTGAGACTGTCTCAAAAGAAAAAAAGAAA","GAGGTTGCAGTGAGCTGAGATCACACCACTGCACTCCAGCCTAGGCAACAAAGTGAGACTCCAACTGAAAAAAAAAA"
"GL873557","6903406","6903510","chr16","18967946","18968045","32","12064540","AGTGCTCTGGGAGACTGAGATGGGCAAATATCTTGAGTTTAGGAGTTCCAGACCAGCCTAAGGAAGAACAAGACCCTATCTCTACTAAAAATAGAAAAAAATTCA","CTTTGGGAGTCTGAGGCAGGTGGATCTCCTGAGGTCAGGAGTTCAGGACCAGCCTGGCCAACATGGCAAAACCCCATCTCTACTAAAAATATAAAAATTA"
"GL873557","6903779","6903930","chr3","40638454","40638604","35","33734675","TTTGCCAGGTATTGTGGTGGACACCTGTAGTCCCAGCTGCTTGGTAGGCTGAGGCAGGAGGATCACTTGACCCTAGGAATCTGATGTTGCTGTGAGCTAGGCTGATGCTACAGCACTCTAGCCTGGACAACAGAGTAAGCTTCTGTCTCAAA","TAGCTGGGTGTCATGGCACACGCCTGTAGTCCCAGCTACTTGGGAGGCTGAGGCAGGAGAATCTCTTGAACCTGGGAGGCAGAGGTTGCAGTGAGCTGAGATCACGCCACTGCACTCCAGCCTGGGCAACAGAGTGAGACTCCGTCTCAAA"
"GL873557","8133022","8133316","chr19","42881134","42881434","76","34748112","GAGTGCAGTGGCTCACACCTGTAATCTTAGCACTCGAGAGGCTGAGGCAGGTGGATTGCCTGAACTCACAGCTTCGAGACCAGCCTGAGCCAGAGCAAGACCTCATCTCTAAAAATAGCCAGGAGTTGTGGCAGGCGCCTGTAGTCCCAGCTACTTGGGAGGCTGAGCAAGAGAATCGCTTGATCTCAGGAGTTTGAGGTTTCTGTGAGCTAAGACACCGCAGCACTCTACCAAGGGTGACAAAGTAAGACTCTGTCTCAAAAAATAAATAAATAAATAAATTATAAGAAAAAGA","CCGGGCAAGGTGGTTCACACCTATAATCCTAGCACTTTGGGAGGTCGAAGTGGATCGCCTGAGGTCAGGAGTTAGAGACCAGCCTGGGCAACATAGCAAAACCCCATCTCTACTAAAAATAGAAAAACTAGCCAGGTGTGGTGGCGCCTGTAATCCCAGCTACTCGGGAGGCTGAGGCAGAAGAATCGCTTGAACCCAGGAGGCAGAGGTTGCAGTGAGCTGAGATCGCACCACTGCACTCCAGGGTGACAGAGCAAGACTCTGTCTCAAAAAAAAAAAAAAAAAAAAAAAAAAAAAAAAA"
"GL873557","8171663","8171835","chr7","151280672","151280824","61","143109009","TTAGCCAGGCACTGTGCTCCCAGCTACTAGGGAGGCTGAGGCAAGAAGAGGATCACTTGGCTCGGCGCCTGTGACTCAAGTGGCTAAGGTGCCAGCCACATACACCTAAGGTGGAGGGTTCTCTACCCAGAGGGACAGCTTGAGGCTCCATCTCAAACAAAAAAAAAAGAAGA","TGGTATGCACCTGTAATCCCAGCTACTTAGGAGGCTGAGGCATGAGAATCACTTGAACCCAGGAGGTGGAACTTTTAGTGAGCTGAGATTGCACCACTGCATTCCAGCCTGGGCAACAGAATAAGACTCTATCTCAAAAAAAAAAAAAAAAAA"
"GL873557","8172121","8172252","chr11","123260550","123260686","30","115088429","CTGGGCATGGTGGCTCATACCTATAATCCTAGGACTTTGGTAGGCCGAGGCAGGTGGGTTGCTTGAGCTTAGAAGTTGAAGACCAGCCTGAACAACAGCAAGACCTTTCCCTACTCAAAACAGAAAAACTAT","GGCTGGGCAGGGTGGCTCATGCCTATAATCCCAGCACTTTGGGAGGCCAAGGCGGGTGGGTCACCTGAGGTCAGGAGTTCGAGACCAGCCTGACCAACATGGTAAGATCCCCTCTCTACTAAAAATACAAAAATTAA"
"GL873557","8260873","8260977","chr1","62231025","62231129","22","53970152","GGCTGGGCATGGTGGCTCACGCCTGTTGTCCCAGCCCTGTGGGAGGGTGAGGCAGGTGGATCGCCTGAGCTCAGCCGAGTTCGAGACCACTGGAAGACCAGCATG","GGCTGGGCATGGTGGCTCACGCCTATAATCCCAGCACTTTGGGAGGCCGAGGCAGGTGGATCACCTGAGATCAGGAGTTTGAGACCAGACTGGCCAACATGGTGA"
"GL873557","10032878","10033040","chr9","27037847","27038008","36","17004969","GGGGGTGGTGGCTCACACTTGTAATACCAGCTACTCTGGAGGCCGAGGCAGGAGAATCATATGAGCCCGGAAGTCTGAGGTTGTTGTGAGCTGGGTTAATGCCCCTGCACTCTAGCCTGGGCAACAGAGTGAGACCATGTCTCAAGGAAATAAAAAAAAAAAA","TTAGCTGGGCATGCTGGCACACACCTGTAATGCCAGCTACTCAGGAGGCTGAGGCAGGAGAATCACTTGAGCCCGGGAGGTGGAGGTTGCAGTGAGCTGAGACAGTGCCACTGTATTCTACCCTGGGCAACAGAGTGAGACTGTCTCAAAAAAAAAAAAAAA"
"GL873557","10366578","10366655","chr17","24597444","24597521","20","14230866","GCCAGGCGTGGTGGCTCATGACGGTAATCCCACCTACTCAGGAAGCAGAGGCAGGAGAATCACTTGCGCCTAGGAGAC","GGCCAGGCATGGTGGCTCATGCCTGTAATTCCAGCACTTTGGGAGGCCGAGGCAGGTGGATCACTACGTCAGGAGTTC"
"GL873557","12031816","12031985","chr11","55022806","55022982","46","42990990","TAGAAAAACTAGCCAGGCATTGTAGCGGGTGCCTATAGTTTCAGCTACTCTGGAGACTGAGACAAGATTGCTTGAGCCCGGGAATTTGAGGTTGCTGTGAGCTATTATGCCACAGCACTCAATACAGGACAATTGAGTGAAACTCCAGTCTCAAAAAAAAAAAAAAAAAA","CAAAAATTAGCCAGGCAGGGTGGTGGGCGCCTGTAGTCTCAGCTACTGGGAAGGCTGAGACAGGATAATCACTTGAACCCGGGAGGCGGATGTTGCAGTGAGCCGAGATCATGCCACTGCACTTCAGCCCGGGCAACGAGAGTGAAACTCCGTCTCAAAAAACAAAATAAAATAAAA"
"GL873557","12032023","12032144","chr1","111354387","111354508","23","99322364","GGTCAGGTGCAGTGGCTCACATCTGGAATCCTAGCACTCTGGGAGGCCGAGGAGAATGGATCCCCTGAGCTCAGGAATTCAATATCAGCCTGAACAAGTGTGAAACCTCCATCTCTACTTAA","GGCCGGGCGTAGTGGCTCACACCTGTAATCCCAGCACTTTGGGAGGCCGAGGCGGATGGATCACCTGAGTTCAGGAGTTTGAGACCAGCCTGACCAAAGTGGTGAAACCCCGTCTCTACTAA"
"GL873557","14208944","14209036","chr7","158031905","158031997","26","143822961","GGATGTGGTAGTTACTGTTTGCTATGATGACAACACTGCACTCTAACTCTGGGTGACACAGTAAGATTCTATCTCAAAACCAAAATAAAACAA","CCAGGAGGTGGAGGTTGCAATGAGCCAAGATCACACCACTGCACTCCAGCCTGGGTGACAGGGTGAGATTCTGTCTCAAAAAAAAAAAAAAAA"
"GL873558","2159034","2159070","chrX","41233833","41233871","7","39074799","ATTAGCCAGGTGTGGTGGCTTTTGCCTGTAATCCCAG","AAATCAGCCGGGTGTGGTGGCTCACGCCTGTAATCCCAG"
"GL873558","3486850","3487074","chr5","91338665","91338874","72","87851815","GGCCAGGCATGGTGGCTCATGCCTGTTGTCCCAGTGCTGTGGGAGGCCGAGGCAGGTGGATCGCCTGAGTTCAGCCAAGTTTGAGACCAGTGGAAGACCAGCATGAGGCAGAGTGAGCCAGAGTAAGACCCCATCTCTACAACAACAAAAAAAAAAAACAAAAAAAACAGCCGGACGTTGTGATCCCAGCTACATGGTGAGGGGGAGGGGAACAGGAGAATCACT","GGCCGGGCATGATGGCTCATGCCTGTAATCCCAGCACTTTGTGAGGCCGAGGCAGACTGATCACTTGAGGCCAGGAGTTCGAGACCAGCATAGCCAACAAGATGAAACACCATCTTTACTGAAAATACAAAAAAAAAAAAAAATAGCCGGATGTGGTGATACCTGCTTGTAATCCCAGCTGCTTGGGAGGCTGAGGCAGGAGAATCTCTT"
"GL873558","3884156","3884240","chr4","24638016","24638099","18","20753860","CCAGACACAGTGGCTTAAGCCTGTAATCCTAGCACTTTGGGAGGCTAAGGTGGATGGATCTCCTGAGCTCAGTAGTTTGAAGCTA","GCCAGGCATGGTGGCTCATGCCTGTAATCTTAGCACTTTGGGAGGCCAAGGTGGGCGGATCATCTGAGGTCAGGAGTTTGAGAC"
"GL873558","5037604","5037746","chr3","2138380","2138521","38","2899224","GCTGGGCCTGGTGGCTCACATCTGTAACCCTAACACTCTGGGAGGCCAAGGCAGGAGGATCTCTTGAAGCTAGGTTGTTAGCCAGGGCGACCCCACAGCACTCTAGCCTGGGGCAACAGAGTGAGACTTTGTCTCCAAACAAA","AGCTGGATGTGGTGGCCCACACCTGTAATCACAGCTACTCGATAGGCTAAGGCAGGAGAATCGCTTGAACCTGGGAGGCGGGGACTGCACCATCACAGCACTCCAGCCTGGGTGACAGAGTGAGACTATGTATCAAAAAAAA"
"GL873558","6488648","6488700","chr3","39516725","39516768","23","33028077","ATAGCACTCTACCATGGGTGACAGAGTGAGACTATCTCCCCCCCTCAAAAAAA","GAGACCAGCCTGACCAACACAGTGAAACCTCATCTCTACTAAAA"
"GL873558","6489359","6489583","chr10","19070944","19071172","64","12581585","GGCTGGACATGGTGGGTCCTGTAATCCTAGCACTGTGGGAGGCCGAGGCAGGTGAATTGCTTGAGCTTATGGGTTCAAGACCAACCTGAGCCAGAAGGAGACCTTGTCTCTAAAAATGGCTGGGTGTTGTGGCAGGCACCTATAATCCCAGCTACTTGGGAGGCTGAGGCAAGAGAATCGCTTGAACCCAAGAGTTTGATGTTGCTGTCAGCTAAGATGCCATAG","GGCTGGGCTCAGTGGCTTATGCCTGTAATCCCAGCGCTTTGGGAGGCCAAGGCGGGTGGATCACCTGAGGTCAGGAGTTCGGGACCAGCCTGAACAACATGGTGAAATCCCGCCTCTACTAAAAAAAAGCCGGGTGTGGTGGCATGCACCTGTAATCCCAGCTACTTGGGAGGCTGAGGCAGGAGAATCACATGAACCTGGGAGGCAGAGGTTGCAGTGAGCTGAGATC"
"GL873558","14631848","14632045","chr18","1878493","1878704","62","12753355","GGTGCAGTGGCTCACGCCTTTAATCCCAGCACTTGGGATGGTGAGGCAGGTAGATTGCCTAAGTTCACAGGTTCAAGACCAGCCTGAGCCAGAGAGACCCTACCTCTAAAAAATAGCCAAGCATTGTGGCAGGCACCTGTAATCCTACTTAGGAGGCTGAGTCAAGAGGATCATTTGAGCTTAAGAGTTAGAGCTTGT","GGCCAGGCATGGTGGCTCACGCCTGTAATCCCAGCACTTTGGGAGGCCGAGGCGGGTGGATCACAAGGTCAGGAGTTCAAGACCAGCCTGGCCAACATGGTGGAAGCCCATCTCTACAAAAAATTAACTGGGCGTGGTGGCAGGCACCTGTAATCCCAGCTACTTGGGAGGCTGAGGCAGGGGAATTGCTTGAACCTGGGAGGCGGAGGTTG"
"GL873558","14632352","14632392","chr7","10117723","10117763","10","4514629","GAGTTAGAGCTTGCTGTGAGCTAAGATGCCACGGCACTCTA","GAGTTAGTTGCAGTGAGCTGAGATCGTGCCACTGCACTCCA"
"GL873559","8193331","8193614","chr20","11734223","11734512","71","3540892","CAGGTACGGTGACTTATCCCTGGAATCTTAGAACTGTCTGAGTCCAAGGTGGGAGGATCATTGGAGGTCAGGAATTTGAGACCAGCCTGAGCAAGAGTGAGACCTCTTCTCTACTAAATATAGAAAAATTAGCCAGGGTTTGTGGCAGGTGCTTATAGTCTAAGCTTCTTAGGAGGCTGAGGCAGGAGAATCTCTTGAACCCATGAGTCTGAGGTTGCCCTGAGTTAAGATGACATCACTGCAGTCTCCCCAAAGCAACGGAGTAAGACTCTGTCTCAAAAACA","GGCCAGGCACGGTGGCTCATGCCTCTAATCCCAGCATGTTGGGAGGCCGAGGTGGGCGGATCACATGAGGTCAGGAGTTTGAGACCAGCCTGGCCAACATAGTGAAACCCTGTCTCTACTAAAAATACAAAAATTAGCCAGGTGTGGCAGCACGTGCCTGTAGTCCCAGCTAGTCAGGAGGCTGAGGCAGGAGAATCACTTGAATCCACCAGGCGGAGGCTGCAGTGAGCCAAGATCACACCACTGCATTCCAGCCTGGGCGACAGAGCAAGACTCTGTCTCAGAAAAAA"
"GL873559","8193642","8193657","chrX","1083699","1083714","0","7109943","AAATAAATAAAATAAA","AAATAAATAAAATAAA"
"GL873560","393252","393440","chr11","121440472","121440639","55","121047220","CTGGGCAGGGTGGCACACACCTGTCATCCCAGCATGTTGGGAAGCTGAGGCAGGAGAATTACTTGAGCTCAGATTCCAAGAGGTGAGGATCACTTGAGCCTAGAAGTTGAGGCTGCACTGATGCCCCAACACTCCAGCCTGGGCAACAGAGCAAGGTCCTGTCCCAAAAAGAAAAAAAGAAAAGGAAAA","GCTGGGCGCAGTGTCTCACGCCTGTAATCCCAGCTATTTGGGAGGCTGAGGCAGGAGAATTACTTGAACCTGGGAGGTGGAAGTTGCAGTGAGCCGAGATCCTACCATCGCACTCCAGTCTGGGCAACAAGAGCAAAACTCTGTCTCAAAAAAAAAAAAAAAAAAAAA"
"GL873560","4038833","4039014","chr12","78258009","78258208","56","74219176","GGCTGGGTGCGGTGACTCACACCTGTAATCCCAGCACCTGGAGGCCCAAGGCAGGGTGGATTGTCTGAGCTCACAGGTTCAAGACCAGCCTGAGCCAGAGCGAGACCTAAAAATAGCTAGGCGCTGTGGGAGGCACACGTAGTCCCAGCTACTCAGGAGGCTGAGGCAAGAGAATCACTTGA","GGCTGGGCACGGTGACTCACGCCTGTAATCCCAGCACTTTGGGAGGCCCAGGTGGGTGGATCACCTGAGGTCAGGAGTTCAAGACCAGCCTGGCCAAGATGGTGAAACCCCGTCTCTACTAAAAATACAAAACTTAGCTGGGCATGGTGGCGGGCACCTGTAATCTCAGCTAGTCGGGAGGCTGAGGCAGGAGAATCTCT"
"GL873560","4492531","4492643","chr7","56485655","56485756","37","51993124","AACAGAAAAACTAGCCAGGCATAGTGGTGCATGCCTGTTGTTCCAGCTGCTCTAGAGGCTAAGGCAAGAGGATTGCTCCAGCTCAATAGTTTGAGGTTGCTGTGAGCTTGAGA","TTAGCTGGGCATGGTGGAGCACACCTGTAATTCCAGCTACTCAGGAGGCTGAGGCAAAAGAGTTGCTTGAACCCAGGAGGCAGAGGTTGCAGTGAGCCGAGA"
"GL873560","4492670","4492771","chr8","41603464","41603564","28","37110794","AGCACTCTGGGTGACTGAGGCAGGATTACTTGAGCTCAGGAGTTTATGACCAGCCTGAGCTGGTCCTTGATCAAGACTCCATCTCTACTAAAAAAACAAACA","CACTTTGGGAGGCCGAGGCAGCAGATCACTCGAGGTCAGGAGTTTGAGACCAGCCTGGCTAACATGGCAAAACCCCATCTCTACTAAAAATATAAAAATTA"
"GL873560","8106775","8106882","chr11","111878590","111878685","39","103771815","ACATAAGAATCAGGCCAAGCCTTGTGGCTCCTGTATGTGATTCCAGCACTGGGAGGGCAAGGCAGGAGGATCCCTGACGTCAGGAACTCAAGGCTGCCCAAGTATCAT","GGGCACAGTGGCTCATGCCTGTAATCCCAGCACTTTGGGAGGCCAAGGCGGGTGGATCACCTGAGGTCAGGAGTTCAAGACCAGCCTGACCAACAT"
"GL873560","10872201","10872272","chr7","9971011","9971083","11","901190","GGCTGGGCACAATGGGTCACACTTGTAATCCCAACACTTTGGGAGGCTGAGGTGGGCAGATCACCTGAGCTC","GGCTGGGTGGGGTGGCTCACACATGTAATCTCAGCACTTTGGGAGGCTGAGGTGGGCAGATCACCTGAGGTCA"
"GL873560","11043320","11043410","chr6","111928830","111928919","19","100885510","CAGGCGAAGTGGCTCATGCCTATAATCCTAGCATTCTGGGAGGCTGAGGTGGGAGAATCCCCTGAGGTCAAAAGTTCAAGACCGGCTTGGC","GGCCAGGCTCAGTGGCTCATGCCTGTAATCCCAGCACTTTGGGAGGCCGAGGTGGGTGAATCACCTGAGGTCAGGAGTTCAAGACCTGCC"
"GL873561","5890611","5890936","chr8","76222061","76222392","77","70331450","GGCTGGGCCTGGTGGCTCATGCCTATAATCCTAGCACTCTGGGAGGCAAAGGTTGGTGGATTGCTTAAGCTCAGGAGTTCAAGACCAGCCTGATTAAGAGTGAGATCCCATCTCCACTAAAAATAGAAGGGAAAAAAAAAAAAAAAAAACCTAGTTGGGCTTGGTGGCAGCACTTGTAGTCCCAGCTATTTAGGAGGCTGAGGAAAGAGAATCACTTGAACCCAAGAGTTTGAAGTTGCTCTGAGCTATGATGCCATAGAACTCTACCCAGGGTGACAGAGTAAAACTGGATCTCAAATAAATAAATAAATAAATACATAAATAAA","GGCTGGGCATGGTAGCTCATGGCTGTAATCCTAGCACTTTGGGAGGCCAAGGAAGGTGGATTGCCTGAGCTCAGGAGTTCAAGACCAGCCTGGGCAACACAGTGAAATCCTGTCTCTACTAAAATACAAAAAAGAAAAAAAAAAAAAAAAAAAACAGCTGGGCATGGCAGTGTGCACTTGTAATCCCAGCTACTCAGGAGGCTGAGACAGGAGAATCACTTGAACCCGGGAGGCAGAGGTTGCACTGAGCCGAGATTGTATCACTGCACTCCAGCCTGGGTGACAGAGCGAGACTCTGTCTCAGAAAAAAAAAAAAAAACAAAAAAACAAAA"
"GL873561","10859256","10859475","chr6","100119122","100119352","73","89259866","GGATCACTTGAGCTCAGGAGTCAAGACCAACTTGAGTAAGAGTGAGACCCTGTCTCTACTAAAAATAAAATATATAGCCAGGCATTGTGCTGGGCACCTATATATAAGCTAAAATGGAGTCTTAGCTACCTCCTTGAACTTGAACCCAGGAGTCTGAAGTTGCTTTGAGCTAGGCTGATGCCACTGCACTTTACCCAGGCAACAGAGTGAGAGTATCTAA","GGATCACCTGAGGTCAGGAGTTCAAGACCAGCCTGGCCAACATGGTGAAACCCCGTCTCTACTAAAAATACAAAAACTAGCCAGGCATGGTGGCGCACACCTGTAGTCCCAGCTACTTGGGAGGCTGAGGCAGAAGAATCTCTTGAATCCGGGGGTTGGAGGTTGCAATGAGCTGAGATCATGCCACTGCACTCCAAGCCTGGGTGACAAGAGCGAAACTCCATCTCAAAA"
"GL873561","10859563","10859576","chr4","114457728","114457741","1","103598165","AAAAAAAAATAAAA","CAAAAAAAATAAAA"
"GL873562","12189469","12189706","chr1","31551552","31551790","75","19362083","CAGTGGCTCACGCCGGTAATCCCAGCACCTTGGGAGCTGAGGCAGGCAGATCTCCTGAGGTCACGTGTTTTGAGACCAGCCTGAGCTAGAGTGAGACCCCACCTCTAAAAATAGCCAGTCGCCTGTAATCCCAGCTACTCGGGAGAAACCCAGGAGTCTAAGGTCGCTGTGAGCTGACACCTCAGCACTCTGCTGGGGTAACAAAGTGACACTTTGTCTCAAAAAAATAAATAAATAT","GCAGTGGCTCACGCCTGTAATCCCAGCACTTTGGGAGGCCAAGGCGGGTGGATCACCTGAGGTCAGGAGTTCAAGACCAGCCTGGCCAACATGGTGAAACCTCATCTCTACTAAAAATACAAAACAGGAGAATCGCTTGAACCCGGGAGGTAGAGGTTGCAGTGAGCTGAGATAGTGCCACTGCACTCCAACCTGGGCAACAGAGTGAGACTCCGTCTCAAAAAAATAAAAAATAAAAA"
"GL873562","4526861","4526913","chr13","94764706","94764759","14","90237845","GTGAGACCTTGTCACTACTGAAAATAGAAAAATTAGCTGGGCATGGTTGTAGG","GTGATGAAACCCCATCTCTACTAAAAATACAAAAATTAGCTGGGCTTGATGGTG"
"GL873562","4789223","4789313","chr10","47852509","47852598","25","43063286","GGCCAGGAGAAGTGGCTAACACCTGTAATTCCAGCACTCTAGGAGATGGAGGCAGGGACCAGCCTGAGCTAGAGTGAGTGAGACTCCATCT","GGCCAGGTGCAGTGGCTCACACCTGTAATCCCAGCAACTTTGGGAGGCTGAGGCAGGCAGATCACTTGAGGTCAGGAGTTCGAGATCAGC"
"GL873562","4868605","4868801","chr16","54069750","54069948","44","49201145","GGCCAGGCATGGTGGCTCATGCCTGTAATCCTAGCACTCTGAGAGACCAAGGCTGATGAATCACCTGAACTCAGGAGTTGAGACCAGCAGGAGCAAAAGTGAGATCCCATCTCTACTCAAAAATAGAAAATTAGTTCAGGCAAGGTGGCACATACCTGTAATCCCAGCACCCTGGGAGGCTAAGGTGGGTGGATTGC","GCCCAGCGCAGTGGCTCATGCCTATAATCCCAGCACTTTGGGAGGCCAAGGCGGGTGGATCACCTGAGGTCAGGAGTTCGAGACCAGCCTGCCCAGCATGGTGAAACCCCATCTCTGTTAAAAATATAAAAATTAGACTAGGCGCGGTGGCTCACACCTGTAATCCCAGCACTTTGGGAGACCAAGGTGGGCGGATCAC"
"GL873562","4929184","4929360","chr10","37539693","37539877","47","32610509","GGCCAAGCTCAGTGGCTCTCCCTAGCACTTTGGGAGACCGAGGTGGGTGGATTGCCTGAACTCAGGAGTTCTAGACCAGCCTGATCAAGAGCAAGACCCTACATCTACTAAAAATAGAAAAACTAGCTGGGCATTATAGTACGCACCTGTACTCCCATCTACTCTGGAGGCTGAGGC","GGGTGCAGAGGCTTATGCCTGTAATCCCAGCACTTTGGGAGGCAGAGGTGGGTGGATCACTTGAGGCCAGGAGTTCAAGACCAGCCTGGTCAATGTGGTGAAACCTCGTCTCTACTAAAAATACAAAAATTAGCCGGGCATGGTGGCATGCATCTGTAGTCCCAGCTACTTGGGAGGCTGAGGCA"
"GL873562","5446395","5446678","chr16","63692714","63692996","79","58246319","GGCTGGATGCAGTGGCTCATACCTGTCTGTAATCCTAGCACTCTGGGAGGTCGAGGTGGGTGGATTGCCTAAGTTCACAGGTTCGAGGCCAGCCTAAGCAAGAAGAGCAAGACTCCATCTCTGAAAGTAGCCAGGCATTGTGACAGGCGCCTATAGTCCCAGCTACTTGGGAGGCTGAGGCAAGAGAATTGAGCCCAGGAGTTAGAGGTTGCTGTGAACTAGGACTCCATAGCATTCTACTGAAGGTGACAAAGTGAGATTCTGTCTCAAAAAAAAGACTGATT","GGCTGGCTGCGGTAGCTCACCCCTGTAATCCCAGCACTTTGGGAGGTCAAGGCAGGTGGATTGCCTGAGGCCAGGAGTTCGAGGCCAGCCTGACCAATATGGCAAAACCCTGTATCTACTAAAAACTAGCTGGGCATGGTGGCATACACCTGTAGTCCCAGCTACTTGGGAGGCTGAGGCAGGAGAATTGCTTGAACCTGGAGGCAGAGGTTGCAGTGAGCCAAGGCTGCCCCACTGCACGCCAGCCTGGGTGACAGAGTGACACTCCATCTCAGAAAAAAAA"
"GL873562","8499356","8499477","chrX","91860022","91860139","29","83360666","GGCTGGGTGTGCTGGCTCATGCCTGTAATCCTCGCACTCTGGGAAGCTAAGGCAGGTGGATTGCCTGAGCTTATGAGTTTAAGACTAGCCTGAGCCAGAGCAAGACCTTGTCTCTATTTTTT","GCCGGGTGTGGTGGCTCATGCCAGTAATCCTAGCACCTTGGAAGGCTGAGGCAGGTGGATTGCCTGAGCTCAGGAGCTTCAGACTAGCCTGGGCAACATAGTGAAACCCCATATCTCT"
"GL873562","8499731","8499918","chr7","167658032","167658223","45","159158301","AAGACCTTGTCTCTAAAAATAGCCAGGTGTTGTAGCAGGCACCTGTAGTCCCAGCTACTTGGGAGGCTGAGACAAGAGAATTGCTTGAGCCCAAGAGTTTGAGGTTGCTGTGAGCTGAGATGCCATGGACTCTATCGAGGGCAGTAAAGTGAGACTCCGTCTCAAAAAAAAAAAAAGAAAGAAAAGAA","TACTAAAATACATACAAAAATTAGCCAGGTATGGTGGCAGGCCCCTGTAGTCCCAGCTACTCGGGAGGCTGAGGCAGGAGAACTGCTTGAACCCAGGAGGTGGGGATTGCAGTGAGCTGAGATCGCACCACTGCACTCCAGCCTGAGCGACAGAGTGAGACTCTGTCTCAAAAATAAAAAAAGAAAAAAAAA"
"GL873562","10216295","10216385","chr1","44313085","44313176","34","34096790","TAAAAATACATTGAACCAGATTCAGTGGCTCACACCTGTGCTCCTAGCTACCCAGTGGCTGAGGCTGAAGGATGGCTTGAATCTCAAGTTC","TTACAGATCATTTGGGGCTAGATGTAATGGCTCACACCTGTAAGCCCAGTGCTTTGGGAGGTTGAGGCAGGAAGATGGCTTGAACCTAGGAG"
"GL873562","11812352","11812435","chr19","44513406","44513491","17","32701054","GGCCGGTACGATGGCTCAGGCCTATAATCTTAGAACTCTGGGAGTCCGAGGTGGGTGGACTGCCTGAGCTCACAGTTCGAGACC","GGCCGGACGCGCTGGCTCACGCCTGTAATCCTAGCACTTTGGGAGGCTGAGGGGGGCGGATAGCCTGAGCTCAGAAGTTCGAGACC"
"GL873562","12179920","12180054","chr14","8268315","8268451","18","3911605","GGCCAGGCATGGTGGCTCACACCTATAATCCTAGCACTCTGGGAGGCCAAGGCAGGTGGATCACCTGAGCTCAGGAGTTTAAGACCAGCCTGAGCAAGAGTGACAACCTATCTCTATTAAAAATACAAAAACTAG","GGCCGGGCATAGTGGCTCACACCTATAATCCCAGCACTTTGGGAGGCCAAGGCAGGTGGATCACCTGAGGTCAGGAGTTCGAGACCAGCCTGACCAAGATAGTGAAACCCCGTCCCTACTAAAAATACAAAAATTAA"
"GL873562","14017684","14017885","chr2","94000404","94000565","73","79982720","CAAGCTAGCCTAGGGATGTGGAGGTACCTGTAGTCCCAGTTACTTCATTGGCTGAGGCTTAAACCCTCTTGGATGGTCTCACTCTGTCACCCTGGTAGAGTGTTGTGGCATCATGTGTCACAGGAGGTTGAGGTTGCTGTGAGCTGTGATGCCACAACATTCTACCAGGGTGACAGAGTGAGACTCTGTTTCAAAAACAAAA","AAACTAGCCTGGCGTGGTGGTGTGTGCCTGTAATCCCAGCTACTTGGGAGGCTGAGACAGGAGAATCACTTGAACCTGGGAAGTGGAGGTTGCAGTGAGCTGAGATCATGCCACTGCACTCCAACTTGGGCAACAGAGCGAGACTCTGTTTCAAAAAAAAAA"
"GL873562","14017915","14018042","chr1","161382752","161382881","27","147364837","GGCTGGGCACGGTGGCTCACACTTGTAATTCTAGCACCCTGGGAGGCCAGCGTGGGTGGTTTGCTTGAAGTTAGGAGTTCAAGACCAGCCTGACCAAAGTGAGACCACATCTCGACTAAAAACAAACA","GGCTGGACGCAGTGGCTCATACCTGTAATCCCAGCACTTTGGGAGGCCGAGGTGGGTGGATCACCTGAGGTCAGGAGTTCAAGACCAGTCTGGCCATGGTGAAACCCCATCTCTACTAAAAATACAAAAA"
"GL873563","2645481","2645758","chr1","37954757","37955032","69","35309276","GGCTGGGTGCCATGACTCACGCCTGTCATCCCAGCTCTCTGGGAGGTCACAATGGGAGTATTCCATGAGCTCAGAAGTTTGAGACCAGTCTGAGCAAGAGCAGACTCCATTTCTACTAAATATAGAAAAATTAGCCCAGTATGGTTGTGCACACCTGTAGTCCCAGCTACTTGGGAGCTGAAGCAGGAAAACGGCTTGAGTCCAGGAGTCGGAGGTTGCTGTGAGCTGAGAGCTATAATGATGCCAGTGCACTCTACCCAGGCAACAGAGCAAGACTC","GGCCGGGTATGGTGGCTTACGCCTGTAATCCCAGCACTTTGGGAGGCCAAGGTTGGCAGATCACCTGAGGTCAGGAGTTCGAGACCAGCCTGGCCAATATGGCGAAACCCCGTCTCTACTAAAAATACAAAAATTAGCTGGGCATGGTGGCGCATACCTGTAATCCCAGCTACTCGGGAGGCTGAGGCAGGAGAACTGCTTGAACCCAGGAGGTGGAGGTTGCAGTGAGCCGAGATTGAGCCACTGCACTCCAGCCTAGGTGACAGAGTAAGACTC"
"GL873563","2646059","2646097","chr1","62915138","62915167","12","60269079","CAAACAGAACAAGACTTTGTTTCAAAAAAAAAAAAAAAA","CAAACAAACAAACATCACAAAAAAAGAAAA"
"GL873563","2651001","2651167","chr2","69424628","69424798","38","66773627","GTACAAAAATTAGCCAGATGTCTTGGTGCTTATAGTCAGCAACTCAGGAGGCTGAGGCAGGAGGATCACTTGAACCCCTGGAATTTGAGGTTGCTGTGAGCTAAGTTGATGCCACGGCATTCTAGCCTGGGTGACAGAGTAAGACTCCATCTCAATAAATAAATAAA","AAAAAAATTAGCCAGGCATGGTGGTGCATGCTTGTAATCCCAGCTACTTGGGAGGCTGAGGCAGGAAGATCACTTGAACCTGGGAGGCGGAGGTTGCAGTGAGCCAAGATTGTGCCACTGAACTCCAGCCTGGGTGACAGAGCAAGACTCCATCTCAAAAAAAAAAAAAAA"
"GL873563","2651449","2651584","chr3","121251018","121251153","32","118599569","GGTCCAGTGAGGTGGTTCAGACCTGTAATCCTAGCATTCTGGGAGGCTGAGGTGAGCAGATTGCTTGAGCTCAGTGAGTTTGAGACCAGCCTGAATAAAAGCAGCACCCCATCTCTACCAAAAGTAGGAAAATTAT","GGCCAGGTGCAATGGCTCACACCTGTAATCCCAGCACTCTGGGAGGCCGAGGTGGGCAGATCACCTGAGGTCAGGAGTTTGAGATCAGCCTGGCCAACCTGGCAAAACCCCATCTCTAATAAAAATACAAAAATTA"
"GL873563","6898038","6898117","chr6","28153994","28154075","27","21255956","AAAAAACAGAAAAATTAGTTGGGTGTGGTAGTGGGTAGCTACTTGGGAGGCTGGGGCAGGAGAATCACTTGAACCCAGGA","AAAATTAGCCGGGTGTGGTGATGCATGCCTCTAATCCCAGCTACTTGGAAGGCTGAGGCAGGAGAATCACTTGAAGGCAGGA"
"GL873563","6898395","6898520","chr5","140939246","140939381","30","134040851","GGGGGTGGTGGCTCATGCCTGTAATCCCAGCACTCTGGCTGAGACAAGTGGATTGCATGAGCTCAGGAGTTCAAGACCAGCTTGAGGAAGAACAAGACTCCATCTCTACTAAAAATAGAAAAATTT","GGCCCGGTGCTGTGGCTCATGCCTGTAATCCCAGCACTTTGGAAGGCTGAGGCAGGTGGATCCCTTGAGGTCAGGAGTTCGAGACCAGCATGGCCAACATGGCAAAATCCCATCTCTACTAAAAATACAAAAATTA"
"GL873563","7811395","7811530","chr1","29437872","29437991","31","21626477","GGCCGGGCGTGGTGGCTCATGCCTGTAGTCCCTGCACTGTGGGAGGCCGAGGCGGGTGGATCACCTGTGCTCAGAGGTTCGAGACCAGCTAAGACCCCCCTGAGCCAAATGAGCCAGAGTGAGACCCCGTCTCTAC","GGCCGGGCGTGGTGGCTCACGCCTGTAATCCCAACATTTTGGGAGGCCAAGGCGGGTGGATCACCTGAGGTCAGAAGTTCGAGACCAACCTGGCCAACATGGTGAAACCCCTGTCTCTAC"
"GL873563","7855904","7856041","chr3","37342340","37342469","34","29486436","GCCAGGGCAGTGGTTCACACCTGTAAAAACCCCAGTATTTTGAGAAGCCAAGTTGGGAGGATCACATAAGGTCAAGAGTTTGAGACCAGCCTGGACAACACAGTATAAGACTCCCATCTCTATTTTGTTAAATATACA","GCCGAGCGCGTGGCTCACGCCTGTAACCCCAGCACTTTGGGAGGCCAAGGTGGGTGGATCACTTGAGGTCAGGAGTAGGAGACCAGCCTGGCCAACATGGGTGAAACCCCACCTATAGTTTAAAAATATA"
"GL873563","8381194","8381392","chr2","167568017","167568216","65","159186823","GGCCAGTGCAGTAGCCCACACCTGTAATCCTAGCACTCTGGGAGGCCAACTCTGGTAGAGTTTGAAACTAGCCTGAGCAAGAGCGAGACCTTGTCTTCACTGAAAAAAATAGAAAAAAAAAAAAAAAACTAACTGGGCATGGTGCTGTACATCTGTAGCCCGAGCTACTCAGGAGTCTGAGGCAAGAGGATTACTCAAT","GCCAGGCGAGGTGGCTCATGCCTGTAATCCCAGCACTTTGGGAGGCCAAAGTGGACAGATTACCTGAGGCCAGGAGTTTGAGACCAGCCTGACCAATATGGTGAAACCCCATCTGTACTAAAAATACAAAAATTAGCAGGGCGTGGTGGTGTACACCTGTAATCCCAGCTACTCAGGAGGCTGAGGCAGGAGAATCTCTT"
"GL873563","8381923","8382014","chr2","92370724","92370803","33","83988801","GGATTGCTCAAGCCCAAGAGTTTGAGGTTGCTGAGAGCTATGACACTACAGCACTCTACTCTACCCAGGGCAACAGAGTGAGACAAAAAAAA","TTGCTTGAACCCAGGAGCTAGAGGTTGCAGTGAGCTGAGATTGCACTATTGCACTCCAGCCTGGGCAACAGGGTGAGACT"
"GL873563","9500422","9500552","chr19","10830410","10830544","33","1329988","GGTCAGGTGCAGTGGTCACCTGTCATCCTACCCCTCTGGGAGGCCAAGGTGGGTGGATTGCCTGAGTTCAGGAGTCTGAGACGAACCTGAGCTAGAGCAAGACCTCATCTCTTAAAAAATAGCCAGCATTC","GGCCAGGTGCAGTGGCTCATGCCTGTAATCCCAGCACTTTGGGAGGCCAAGGTGGGTGGATCACCTGAGGTCAGGAGTTCGAGACCAGCCTGATCAACGTGGTGAAACCCCATCTCTACTAAAATTGCAAAATTA"
"GL873563","9501087","9501192","chr16","71049107","71049211","33","61548020","TAAAACCTATAATGTTTGAAAATAAAAATAGCCAGGCCTTGTTGTGGGTGCCTGTAGTCCCAGCTACTTAGGAGGCTGAGGTAAGAGGATTGCTTGAGCCCAAGAG","TGAAACCCCATCTCTACTAAAAATACAAAATTAGCCAGGTGTGGTGGTGCATGCCTATAATCCCAGTTACTTGGGAGACTGAGGCAGGAGAATCACTTGAACCTG"
"GL873563","10991062","10991128","chr1","22619342","22619410","11","11628280","GGCCGGTGTAGTGGCTCACGCCTGTAATCCCAGCACTTTGGGTGCCGACATGGGCAGATCGCCTGAG","GGCCGGGCGCGGTGGCTCACACCTGTAATCCCAGCACTTTGGGAGGCCGAGGTGGGCGGATCACCTGAG"
"GL873563","12252577","12252738","chr8","144193624","144193784","41","131941047","GGCTGGGTACAGTGGCTCATATCTGTAATCCTAGCACTCCAGGAGGCTGAGGTGGGAGGATAATTGCCTGAAGTCAGAAACACAAGACCAGCCCAAACAAGAGTGAGACACCATCTCTACTAAAAATAGAAAACTGAGCTGGGTGTGGCGGTGCACACCTGT","GGCCGGGCATGGTGGCTCATGCCTATAATCCTAGCACTTTGGGAGGCCGAGGTGGGCGAATCACCTGAGGTCAGGAGTTTGAGACCAGCCTGGCCAACATGGTGAAACCCCATCTCTACTAAAAATACAAAAATTAGCTGGGTGTGGTGGCACATGCCTAT"
"GL873564","1384131","1384395","chr13","32253035","32253303","64","30868904","GGGGGGGGGGGCACACTGGCCTGTAATTCTAGCACTCTGAGAGGCCAAGGCAGGTGGATCACCTGAACTCAGGAGTTCGAGACCAGCCTGATCAAGAGTGAAACCCTGTCTCTACTAACAAGAGAAAAACCAGTAGTCCCAGCTACTCAGGAGGCTGAGGCAGAAGAATCACTTGAACCCAGGAGTTTGAGGTTTCTGTGAGCTACAGTAGTGCTATGGCACTCTACCAAGAGTGACAGAGTGAAACTCTGTCTCAAAAAAAAAA","GCTGGGCATGGTGGCTCATGCCTGTAATCCCAGCACTTTGGGAGGCTGAGGCGGGTGGATCATCTGAGGTCAGGAGTTCAAGACTAGCCTGGGCAACATGGTGAAACCCTGTCTCTACTAAAAATACAAAATTACAGGTAATCCCAGCTACTTGGGAGGCTGAGGCAGGAGAATCGGTTGAACCCAGGAGGCGGAGGTTGCAGTGAGCTGAGATCATGCCACTGCACTCCAGCCTGGGCAATAGAATGAGACTCTGTCTGAAAAAAAAA"
"GL873564","2543879","2544121","chr1","199402350","199402570","73","196858471","GGCCAGGTGTGGTGGCTTACGCCTGTTGTCCCAGCGCTGTGGGAGGCCGAGGCAGGTGGATTGCCTGAGCTTAGCTGAGTTTGAGACCAGCGGAAGACCAGCATGAGGCAGAGTGAGCCAGAGTGAGATCCTGTCTCTACAAAAAAGAAAAAAAAAAAAACAGCCGGATGTTGTGGCGCGCGTCTGTAATCCCAGCTACATGGGGGTCAAGAGGGCAAGAGAATCATACAGGAGGAAGAAGTT","GGCCAGGTGTGGTGGCTCACACCTGTAATCCCAGCACTTTGGGAGTCTGAGGCGGGTGGATTGCCTGAGGTTGAGAGTTTGAGACCAGCCTGGCCAACATGGTGAAACCCTGTCTCTACTAAAAACACAGAAATTAGCCAGGCATGGTGGCGCATGTCTGTAATCCCAGCTACCCTCCTGGAGGCTGAGGCAAGAGAATCACTTGAACCCAGGAAGCAGAG"
"GL873564","4859126","4859236","chr9","15245726","15245837","31","10386600","GTGGCTCATGCTTATAATCCAATCACTATGGGAGACCAAGGTGGGGATGGGCGGAGATCACCCTCAGGAGTTGGAGACCAGCCTGAGTTAAGAGTGATACCATGTCTCTAC","GTGGTGTCTCACGCCTATAATCCCAGCACTCTGGGAGGCCAAGGTGGGCAGATCACCTGAGGTCAGGAGTTAAGAGACCAGCCTGGCCAACATGGTGAAACCCTGTCTCTAC"
"GL873564","4859490","4859678","chr8","126054004","126054184","54","121194514","CATGTCTCTATTAAAGGTAGAAAAATTAGCCGAAGTATTGTAGTTGGGCTGTATAGTCCCAACTACTGAAGAGGCTGAGACAGGAGGATTGCTTACAACTAGGAGTTTGAGGTTGCTGTGAGCTAGGCTGATGCCAAGGTGCTCTAGCCTGGGCAACAGAATGAGACAATGTCTTAAACAACAAAAAAA","GTCTCTACTAAAAATACAAAAATTAGCTGGGTGTGGTGGTGCATGCCTGTAATCCCAGCTACTCAGGAGGCTGAGGCAGGAGAATCGCTTGAACCCAGGAGGTAGAGGTTGCAGTGAGCCAAGATCATGCCACTGCACTCCAGCCTGGGTGACAGAGGGAGACTCTGTCTCAATAAATAAA"
"GL873564","5294014","5294069","chrX","11604904","11604969","20","6310890","GGGTGTGGTGACTTGCACTTACAATCAGCACTTTGGGAGGCGAAGGTAGGAGCATC","GGCTGGGTGCAGTGACTCACGCCTGTAATCCCAGCACTTTGGGAGGCTGAGGTAGGCAGATCACCT"
"GL873564","5294155","5294257","chr15","310129","310227","21","4984026","GGCTGGGTGTGGTGGCTCACGTCTGTTGTCCCAGCGCTATGGGAGGCTGAGGAGGGTGGATCACCTGAGCTCAGAGGTTCGAGACCAGCATAAGACCAGCATG","GGCTGGGCGCAGTGGCTCACGCCTGTAATCCCAGCACTTTGGGAGGCCAAGGCGGGTGGATCACGAGGTCAGGAGTTTGAAACCAGCCTAGCCAGCATG"
"GL873564","6711055","6711262","chr18","1878493","1878704","55","4832562","CTGGGCCCAGTGGCTCACACCTATAATCCTCGCACTCTGGGAGGCTGAGGCGGGTAGATTGTCTGAGCTCACAGGTTCAAGACCAGTGTGACCCAGAGCGAGGCTTTGTCTCTAAAAATAGCAGGGCGTTGTGGCAGGCACCTGTAGTCCCAGCTACTTGGGAGGCTAAGGCAAGAGAATTGCTTAAACCTAAGAGTCTGAGGTTACA","GGCCAGGCATGGTGGCTCACGCCTGTAATCCCAGCACTTTGGGAGGCCGAGGCGGGTGGATCACAAGGTCAGGAGTTCAAGACCAGCCTGGCCAACATGGTGGAAGCCCATCTCTACAAAAAATTAACTGGGCGTGGTGGCAGGCACCTGTAATCCCAGCTACTTGGGAGGCTGAGGCAGGGGAATTGCTTGAACCTGGGAGGCGGAGGTTG"
"GL873564","6711356","6711451","chr7","158031905","158031997","31","151320549","AAAAGAGTCTGAGGTTGCCATGAGCTATCATGCCAAGGCATTCTAGAGAAGGGGTACAAAGTGAGACTCTGTCTCAAAAAAAGAAAACCAAAAAGG","CCAGGAGGTGGAGGTTGCAATGAGCCAAGATCACACCACTGCACTCCAGCCTGGGTGACAGGGTGAGATTCTGTCTCAAAAAAAAAAAAAAAA"
"GL873564","7057009","7057315","chr14","106885133","106885430","87","99828124","GCCGGGTACAATGGCTTGCGCCTATAATCCCAGCACTCTGGGAAGCAGAGGTGGGTGGATCACCTCAGCTCACGAATTCGCTACCAGCCTGTCCTAGAGTGAGACACCCCCCCCACCCCCACCCCCCACAACCTCTAAAAATAGCCTGGAGTTGTGACGGGCACCTGTTGTCCCAGCTACTCTGGAGGCTGAGACAAGAGAATTGCTTGGGCCTCAGAGTCTAAGGTTGATATGAGCTATGACATCACAGCACTCTATCAAAGGTAACAAAGTGAGACTCTAAATAAATAAATAATAAATAAATAAA","GCCGGGCCCGGTGGCTCTTGCCTGTAATCCCAGCACTTTGGGAAGCTGAGGTGGGTGGATCACCTGAGGTCAGGAGTTCGAGACCAGCCTGACCAATATGGTGAAACCCCGTCTCTACTAAAAATATAAAAATTAGCCGGGTGTGGTGGCATGCGACTATAGTCCCAGCTACTCAGGAGGCTGAGGCAGGAGAATTGCTTGAACCCAGGAGGTGGAAGTTGCAATGAGTCGAGGTCACACCACTGCACTCCAGCCTAGGCAACAGAGTGAGACTCCATCTCAAAAAAAAAGAAAAAAA"
"GL873564","7705416","7705474","chr1","51463330","51463380","19","43757914","TCATGCCTGTAGTACCAGCACTTCAGGAGGCTGAAGCAGGAGCTAAGATTAGAAATTTG","CATGCCTTTAATCCCAACTACTTGGGAGGCTGAGGCGAGAATTGAAGTCCG"
"GL873564","8307239","8307551","chr14","30585163","30585473","93","22277924","GCACAGTGGCTCAGGCCTGTAATCTGAGCACTCTGGGAGGTTGAGGCTGAGGTTAGGAGTTAGGAGAACAGCCTGAGCAAGAGTGAGACCCCATCTCTACCAAAAATAGGGGAAAAAACTCCAAAAATCTAGCCACATGTTGTGGTACTTGCCTGCAATCCCAGCTACTGGGGCATAGGGGGACTGAGGCAAGAGGGTCACTTGAGCGTGAGAGATTGAGGTTGCTGTGAGCTAAGATGATGCCATGGCACTCTACCCAAGGTGGCAGAGTGAGCCTATGTCTCACCAATAAATAAACAAATAAATAAATGAA","GGGCACAGTGGCTCACGCCTGGAATCCCAGCACTTTGGGAGGTCAAGGTGGGTGGATCACCTGAGGTCAGGAGTTTGAGACCAGCCTGGCCAAAATGGTGAAACCCCATCTCTACTAAAAAAAATACAAAAAATTAGCCAGAATGTGGTGGTGCATGCCTGTAATCCCAGCTACTGGGGAGGCTGAGGCAGGAGAATCACTTGAACCTGGGAGGCGGAGGCAGCAGTGAGCCAAGATGGCGCCACTGCACTCCAGCCTGAGTGACAGAATGAGACTCTGCCTCAGGAAAAAAAAAAAAAAAAAAGCAAAAA"
"GL873564","8738781","8739084","chr6","92598388","92598711","90","83859607","GCTGGGCACAATGGCTCACACCTGTAATGCCAGCACTTGGGAGGCTAAGACGGGCAAATTGCCTGAGCTCACAAGTTCAAGACCCAGAGCGAGACCTCATCTCTAAAAAATTGCCATGCATTGTGGAGGGTGCCTGTTGTCCCAGCTACTTGGGAGGCGGAGAAAAGACAATCGCTTTAGCCCAAGAATTGAAGGTTGCTGTGAGCTGTGACGCTGTAGCACTCACCAAGGGCAACATAGTGAGACTCTGTTTCAAAATAAATAAATAAATAAATAAAAATAAATAAATAAAATAAAAACAAAA","GGCTGGGCTCAGTGGCTCATGCCTGTAATCCCAGCACTTTGGGAGGCCAAGGCTGGCAGATTGCCTGAGGTCAGGGGTTCAAGACCAGCCTGGCTAACATGGTGAAACCTCATCTCTAATAAAAATACAAAGATTAGCTGGGTTTGGTGGCACATGCCTGTAGTCCCAGCTATTTGGGAGGCTGAGGCAGGAGAATCGCTTGAACCCAGGAGTTGGAGGTTGCAGTGAGCTGAGATGGCACCACTGCACTCCAGCCTGGGTGACACAGCAAGACTCCGTCTCAAAAAAAAAAAAAAAAAAAAAAAAAAGAAAAGAAAAAAAAAA"
"GL873564","9560044","9560238","chrX","30236033","30236239","48","20675989","GGCCAGGTGCGGTGGCTCCTGCCTGTAATCCCAGCACTCTGGGAGGCCTAGGTGGGTGGATTGCCTGAGCTCACTGGTTGGAGACCAGCCTGATACAGATTGAGACCCCCTGCCTCTAAGAATAGCAGGGTGTTGTGACAGACACCTAAAGTCCCAGCTACTCGGGAGGCTGAGGCAAGAGAATCTCTTGAGCCC","GGCTGGGTGCGGTGGCTCACTCCTGTAATCCCAGCACTTTGGGAGGCCAAGGTGGGCGGATCACCTGAGGTCAAAAGTTCGAAACCAGCCTGACCAACAGGGTGAAACCCCGTCTCTACTAAAAGTACAAAAATTAGCCGGGCATGGTGGCAGGCACCTATAATCCCAGCTACTTGGGAGGATGAGGGAGGAGAATCACTTGAACCC"
"GL873564","9560508","9560604","chr1","212121416","212121513","30","202560908","TCGCTGTGCCCAAAAGTTAGAGGTTGCTGTGAGCTATGATACCACTGCACTTTACTGAGGGTGACAAAGTGAGACTCTGTCTCAAAAAATAAATAAA","CTTGAACCTGGGAGGTGGAGGTTGCAGTGAGCCAAGATCATGCCACTGCACTCCAGCCTGGGCAACAGAGCGAGATTCTGTCTCAAAAAAAAAAAAAA"
"GL873564","9753449","9753658","chr19","10370828","10371033","59","617379","TGAGACCCTGGTCTCTTCTAAACATTAAAAAAAAAAAGAAAACTGGGTGTTGTGGCGATGCCCATAGTCCCAGCTACTGATGAGGCTGAGGCAGGGGGATCACTTGAACCCAGGAGTCTGAAGTTGCTGTAAGCTAGGCTGAAGTCACAGTTGTCTAGCCTAGGGCAATAGAGTAAGACTGTCTCACAAAAAAAAAAAAAGGAAAGAAAA","GAAACCCTGTCTCTACTAAAAATACAAAAAATTAGCTGGGTGTGGTGGTGCGTGCCTATAATCCCAGCTACTCAGGAAGCTGAGGTGGGATAATCACTTGAACCTGGGAGGCAGAGGTTGCAGTGAGCCCCAGACTGTGCCACTGCACTCCAGCCTGGGTGACAGAGTCAGACCCTGTCTCAAAAAAAAACAAAACAAAAAAAAAA"
"GL873564","9753896","9754006","chr17","50277667","50277784","33","40523771","GCTGGGCAGGGTGGCTTGTGCCTGTAATCCTCACATTCTTGGAAGCCAAGTTGGTGGATTTCTTGAGCTCAAGAGTTCAGCCTGAACAACGGTGAGACCCCTGTCTCTCTC","CCGGGCATGGTGGCTCATGCCTGTAATCCCAGCACTTTGGGAGGCCAAGGTGGGTGGATCACTTGAGGTCAGGAGTTCAAGACCAGCCTGGCCAACATAGAGAAACTCTGTCTCTACT"
"GL873564","10693118","10693253","chr1","29437872","29437991","31","18744754","GGCCAGGCGTGGTGGCTCACGCCTGTAGTCCCAGCGCTATGGGAGGCCGAGGCGGGTGGATCACCTGTGCTCAGAGGTTCGAGACCAGCCAAGACCTCCCTGAGCCAAATGAGCCAGAGTGAGACCCCGTCTCTAC","GGCCGGGCGTGGTGGCTCACGCCTGTAATCCCAACATTTTGGGAGGCCAAGGCGGGTGGATCACCTGAGGTCAGAAGTTCGAGACCAACCTGGCCAACATGGTGAAACCCCTGTCTCTAC"
"GL873564","11596705","11596819","chr15","17759279","17759407","35","6162574","AATCCGCTACTCGGGAGTCTGATGCAGGAGGATCCCTGGAACCCGGGAGTGAGCTAGGCTGTCCATTCTACCCAAGGCAGAAGAGTGAGATTCTGTCTCAAAAAAAAAAAAAAAA","AATCCCAGTTACTCAAGAGGCTGAGGCAGGAGAATTGCTTGAACCCGGGAGGTGGAGCCGAGACCGCTCCACTGCACTCCAGCCTGGGTGACAGAGTGGGACTCTGTCTAAAAAAAAAAAAAAAAAAAA"
"GL873564","13278770","13278831","chr1","10318851","10318915","18","2959919","GGCTGAGCACAGTGGCTCATGTCTATAATCCCATCACTCTGGAAAGCTAAGAATGAGGATCT","GGCTAGGCATGGTGGCTTATGCCTATAATCCCAGCACTTTGGGAGGCTGAGGCAGACGGATCACC"
"GL873564","13278924","13279152","chr20","69116969","69117193","62","55838045","AAAATAGAGAATAAGAATCCCTTGAGCTCATGAGTTCAAGATCAGTCTGAACAAGTGTCAGACCCTATCTCTACTAAAAATGGAAAAATTAGCCAGGCACTGTGGCAAGTGCCTGTAGTCCCAGATTTCAGGAGGCTGAGGCAGGAGAATCATTTGAATCCAGGAGTTTGAGGTTGCTGTGAGCTAGGCTGACACCACTGTACTGTAGCCTGGGCAACAGAGTGAGACT","GAGGTGGGTGGATCACCTAAGGTCAGGAGTTCAAGACTAGCCTGGCCAACATGGTGAAACTCCATCTCTACTAAAAATACAATAATTAGCTGGGTGTGGTGGCATGTGCCTGTAATTCCAGCTACTCAGGAGGCTGAGGCAGGAGAATCACTTGAACCCAAGAGGCGGAGGTTGCAGTGAGCCGAGACTATGCCACTGCACTCTACCCTGGGCAACAGAGCAAGA"
"GL873565","1417041","1417214","chr4","44130284","44130433","54","42713243","GGCCAGGCGTGGTGGCTCACGCCTGTTGTCCCAGCGATTTGGGAGACTGAGGTGGGTAGATCACCTGTACTCAGAGGTTCGAGACCAGCTGAAGACCAGCCTGAGGCAGAGTGAGACCCCCGTCTCTATAAGAACAAGACAGCCGGACCTTGTGATCCCAGCTACATGGGTGGC","GGCCGGGTGCGGTGGCTCACACCTGTAATCCCAGCACTTTGGGAGGCTGAGGTGGGCAGATAACCTGAGGTCAGGCGTTCGAGACCAGCCTGGCCAACATGGTAAAACCCCGTCTCTACTAAAAATACAAAAATTAGCCAGGTGTGGTGG"
"GL873565","2138367","2138455","chrX","124155143","124155229","17","122016776","GGCTGGGCGTGGTACTCACGCCTGTTGTCCCAGTGCTGTGGGAGGCTGAGGTGGGTGGATCCCCTGAGCTCAGCAGAGTTTGAGACCAG","GGCTGGGTGCGGTGGCTCACGCCTGTAATCCCAGAACTTTGGGAGGCTGAGGTGGGTGGATCACCTGGGGTGAAGAGTTCGAGACCA"
"GL873565","2459722","2459938","chr7","32729330","32729532","57","30269608","AAAAAGACCAAACACCCCAGCTCTACTAAAAGTAGAAAAATTAGCTGGGTATTGTAGTGGGCACCTGTAGTCCCAGCTGCTTGGGAGGTTGCGGCAGGAGAACCACTTAAGCCCAGGAGTTGGAGGGTGAGGTGGGCTGAGGCCACTGCATTCTAGCCTAGGCAACAGAATGAGACTCTGTCTCAAACAAACAAACAAACAAACAAACAAAAAACAA","GAAACCCCATCTCTACTAAAAATACAAAATTAGCCAGGCATGGTGGTGCACACCTGTAGCTCCAACTACTTGGGAGGCTGAGGCAGGAGAATCACTTAAACCCAGGCAGTAGAGGTTGCAGTAAGCCAAGATCGCACCACTGCACTCCAGTCTGGGCAACAGAGTGAGACTCTGTCTCAAAAAAAAAAAAAAAAAAAAAAAAA"
"GL873565","2460219","2460297","chr10","28805224","28805297","28","26345005","CTCAAGCCTGTAATTCTAGCACAGCTGGGAGGCTGAGGCAGGAAGATCTCTCAGCTTAGGATTTCAAGACTAAACACAT","GTGGCTCATGCCTGTAATCTCAGCACTTTGGGAGGCTGAGGCAGGCAGATAACCTGAGGTCAGGAGTTCGAGAC"
"GL873565","11485258","11485580","chrX","66383160","66383473","97","54897902","GGCAGGGCACAGTGGCTCAATCACAGCACTCTGGGAGGAGGCTTAGATGGGTGGATTATTTGAGTTCACAAATTTAAGAACAGCCTGAGCAAGAGTGACACCCTGTCTCTACTAAAAAACAATAGGAAAAATAAAAACTAGCTGGGCATAGTGGCATATGCCTGTGGTTCCAACTACTTGGGAGGCAGAGGCAAGTTTGCTTAGCTAGTTTTTTTTCAGGCCCAAGAGTAGAGGTTGTTGTGAGCTGTGATGCCATAGCACTCTACATAGAGTGACAGAGTGAGACTTTGTCTAAATAAATAAATAAATAAAATTTTAAAAAA","GGCCAGGCACAGTGGCTCACACCTGTAAATCCCAGCACTTTGGGAGGCCGAGATGGGTGGATCACCTGAGGTCACGAGTTTGAGACCAGCCTGGCCAACATGGTGAAACCTCGTCTCTACTAAAAATACAAAAAAAAAAAAAATTAGCTGGGCGTGGTGGTGTGCACCTGTAGTCCCAGCTACTTGGGAGGCTGAGGCAGGAGAATCGCTTGAACCCAGGAGGCAGAGGTTGCAGCGAGCCGAGATCGCGCCACTGCACTCCAGCCTAGGTGACAGAGTGAGACTCTGTCTCAAGGAAAAAAAAAAAAAAAAAA"
"GL873565","13424539","13424574","chr1","174086158","174086184","14","160661619","ACCTAGGGTGAAAGTAAGACTGTCTCAAAAAAAGAA","AAGAGAGAGAAAGAGAGAAAGAAAGAA"
"GL873565","13424654","13424896","chr16","19730961","19731217","54","6306307","GCCAAGCACAGTGGCTCACACCTGTAATCCCAGCACTCTGGGAAGCCTAGGTGGGTGGATTACTTGAGCTCAGGAGTTCAAGATCAGCCTAAGCAAGAGTGAAACTCCCATGTCTAAATAAACAGCCGGGCATTGTAGTGGGTCCCTGTAGTCCCAGCTACTCAGGAGGCTGAGGCAAGAGAATCGCTTGACCCAGGAGTTGGAGGTTGCTGTGAGCTGAGGCCACGGCACTCTATCTAGGGT","GGCCGGGCACAGTGGCTCACGCCTGTAATCCCACCACTTTGGGAGGCCGAGGCGGGTGGATTACCTGAGCTCTGGAGTTAGAGACCAGCCTAGGCAACATGGTGAAACCCCATGTCTACTAAAATACAAAAAGCCGGGCGTGGCGGCGTGTGCCAATAGTCCCAGCTACTCAGGAGGCTGAGGCAGGAGAATTGCTAGAACCCGGGAGGCGGAGGTTGCAGTGAGCTGAGATCACGCCACTGCACTCCAGCCTGGGC"
"GL873565","13679578","13679856","chr1","27657515","27657797","72","13977937","GCAGGGTACAGTGGCTCACACCTGTAATCATAGTAACTCTTAAGCGGCTGAGGCAAGTGAGAGGCCTGAGATCAGGAGTCCAAGAATAGCCTAACCAAAAGTGAGACCCCATCTCTACTAAAAATAGAAAAAAACTAGCCAGGCATGGTGGCACTTACCATAGTCCCACCTCATAAGGCTGAGGCAAGAGTATCACTTGAACCCAGAAGTTTGAAGTTGCTGTCAGCTACAATGACATCATAGCACTTTACCCAGAGCTACAGAGTAAGACTCAGTCTC","GCTGGGTGCGGTGGCTCACACCTGTAATCTCAACACTTTGGGAGGCTGAGATAGGTAGATCACCTGAGGTCAGGAGTTCGAGACCAGCCTGGCCAACATGGTGAAACCCCATCTCTACTAAAAATACAAAAAACCTAGCCAGGCATGGTGGTGTGTACCTATAATCTCAGCTATTCAGAAGACTGAGACAGGAGAATCACTTGAACTTGGGAGGTAGAGGTTGCAGTGAGCCAAGATCACACCACTGCACTCCAGCCTAGGCAACAGAGTGAGACTCCGTCTC"
"GL873566","947388","947684","chr3","178868174","178868466","60","177920786","GGCCGGGTAGGGTGGCTCATGCCTGTAATCCTAGCATTTTGAGAGGCCAAGGCAGGTAGATTACCTGAGCTCAGGAGTTCCAGACCAGGCTGAGCAAGAGCCCCATCTCTATCAAAAATAGAAAAATTAGCTGGGTATGGTGGCACATGCCTNNNNNNNNNNNNNNNNNNNNNNNNNNNNNNNNNNNNNNNNNNNNNNNNNNNNNNNNNNNNNNNNNNNNNNNNNNNNNNNNATGACACCATAGCACTCTAACCTGGAGCAACAGAGTGAGACACCGTCTTAAAAAAAAAAAAAAAA","GGCCGGGTGTGGTGGCTCATGTCTGTAATCCCAACACTTTGGGAGGCCAAGGCGGGTGGATCACCTGAGGTCAGGAGTTTGAGACCAGCCTGGCCAACATAGTGAAACCCCTCTACTAAAAATAAAAAATTAGCCAGGTGTGGTGGCANNNNNNNNNNNNNNNNNNNNNNNNNNNNNNNNNNNNNNNNNNNNNNNNNNNNNNNNNNNNNNNNNNNNNNNNNNNNNNNNNNNNNNNNNNNNNNNCTCCAGGCTGGGCAACAGAGTGAGGCTCCATCTAAAAAAAAAAAAAAAAA"
"GL873566","2530056","2530102","chr1","123145244","123145289","11","120615188","AGGCCAAGGCAGTTGGATCACCTCAGCTCAGGAGTTTGAGACCCGCC","AGGCTGAGGGAGGCGAATCACCTGAGGTCAGGAGTTTGAAACCAGC"
"GL873566","2923434","2923499","chr1","38303497","38303565","19","35380063","GGGCTCAATGGCTCAGCCTGTAATCTTAGCAGTCTGGGAGGCTGAGGCAGGCGCCTGAGCAAGAGT","GCTGGGCGCAGTGTCTCGTGCCTGTAATCCCAGCACTTTGGGAGGCTGAGGCAGGCGGATCATCTGAGG"
"GL873566","3613441","3613522","chr3","54039458","54039545","21","50426017","GGTGGCACATGCCCGTGATCCCAGCACTCTGGGAGGCCGAGGAGATCGGACTGCCTGAGCTCAGGAGTTCGAGACCAGCCTG","GCGCGGTGGCTCACGGCCTGTAATCCTTGCACTTTGGGAGGCTGAGATGGGTGGATTACCTGAGCTCAGGAGTTCGAGACCAGCCTGG"
"GL873566","6100482","6100582","chr2","51286276","51286376","32","45185794","GGCTGGGTGAGTACCTCATGCATCAAGCCCAGTGTTCTGGAGGCTGAGGCAAGGGGATCCTTGATGTGGATAGTTCAAGGCCAGCCTGGCAATTAGCTAGA","GGCTGGGTGCAGTGGCTCACGCCTATAATCCCAGCACTTCGGGAGGCTGAGGCAGGCAGGTCACCTGAGGCCAGGAGTTCAAGACCAGCCTGGCCAACATG"
"GL873566","6245586","6245714","chr3","50507869","50508002","30","44262283","GCTGGGTGTGGTGGCTCACACCTATAATACCAGCACTTGGGAGGCCAAAGCAAGTGGATTGCCTGAGTTCACAAGTTCAAGACCAGCCTGAGCAAGAGTGAGACCCTGTCTCTTAAAAATAGGTGGGCG","GCCAGGTGCGGTGACTCACACCTATAATCCCAGCACTTTGGGAGGCCGAGGCACGTGAATCACCTGAGGTCAGGAGTTCAAGACCAGCCTGACCAACATGGTGAAACCTTGTCTCTACTAAAAATACAAAAACT"
"GL873566","6245992","6246162","chr16","22888303","22888475","37","16642311","TAGCTGGGCGTTGTGGCGGGCATCTGTAATCCCAGCTACCTGGGAGGCTGAGGCAAGAAAATCACTTAAGCCCAAGAGTTTGAGGTTGCTGTGAGCTGTGATGGCACAGTACTCTATTGAGGGCAACATAGTGAGACTCTGTCTCAAAAAATAAATAAATAAATAAATAAA","ATTAGCTGGGCGTGGTGGTGGGCACCTGTAATCCCAGCTTCTTGGGAGGCTGAGGCAGGAGAATCACTTGAGCCCAGGAGGCAGAGGTTGCAGTGAGCAGAGATCGTGCCACTGCACTCCAGCCTGGATGACAGAGTCAGACTTTGTCTCAAAAAAAATAAAAAATAAAAAAA"
"GL873566","6483968","6484033","chr19","10207852","10207913","17","3723884","AAAATATGGTAAAATAAGCCAAGGATGGTGGGTCACACCTGTAATCCCAGCTACTCAAGAGACTGA","TAAAAATACAAAATTAGCTGGGTGTGGTGGCACACACCTGTAATCCCAGCTACTCAAGAGGC"
"GL873566","7043395","7043464","chr10","28805224","28805297","20","21761829","GGCTAGGCCTGGTAATCCCAGCACTCTAAAAGGCTGAGGCAGGTGGATAGCCTGAGCAAGAGTGAGACCA","GTGGCTCATGCCTGTAATCTCAGCACTTTGGGAGGCTGAGGCAGGCAGATAACCTGAGGTCAGGAGTTCGAGAC"
"GL873566","7888407","7888429","chr16","1275850","1275872","4","6612557","CTAAAAATAAAAAATTAGTCTTG","CTAAAAATACAAAAATTAGCCAG"
"GL873566","7888682","7888751","chr13","39203832","39203891","22","31315150","GTAGTCTTGGCGTAGTGATATGTACCTTTAATCCCAGCTACTCAGGAAGTGGAGGAGGAAAGAGTACAAG","TTAGCTGGGCGTAGTGGTGTGTGCCTGTAATCCCAGCTACTTGGGAGGCTGAGGCGGGAG"
"GL873566","8203857","8203949","chr20","18199749","18199840","19","9995892","GGCCCGGCATGGTGGTGCTTTGCCTATAATCCCAGCATTCTGGGAGGCCCAGGCAGGCGGATCACCTGAGCTCACAGGTTCAAGAATGGCCTG","GGCCGGGCATGGTGGCTCACACCTGTAATCCCAGCACTTTGGGAGGCTGAGGCAGGCGGATCACCTGAGGTCAGGAGTTCGAGACCGGCCTG"
"GL873566","8268872","8268975","chr15","10815564","10815667","26","2546692","GTGGCTCATGCCTGTAATCCTAGCACTCTGGGAGGCCGAGGCAGGTGGATTCCCTGAGCTCATAGGTTTGAGACCACAAGCAAGTCCAAGACCCCATCTCTTTT","GTGGTTCATGCCTGTAATCCCAGCACTTTGGGAGGCCGAAGTGGGCGGATCACCTGAGGTCAGGAGTTTGAGACCATCTGGCCAAGATGTAGAAACCCCATCTT"
"GL873566","8269263","8269458","chr15","77706857","77707054","55","69437594","AAGACCCCATCTCTTAAAAAAGAAAAAAAAAGCTGGGTGTTGTGGCCTTCACCTGTAGTCCCAGCTACTGGGGAGGCCAAGGCAAGAGACTTGCTTGAGCCAGAGTTTGAGGTTGCTGTGAGCTATAGTGCCACGGCACTCTACCAAAGGCAACAAAGTGAGACTGTCAAAAAAAAAAAAAAAAGAAGAAGAAGAA","CCCCATCTCTATTAAATATACAAAAAAATAGCTGGGTGTGGTGGTGTGCGCCTGTAATCCCAGCTACTTGGGAGGCTGATGCAGGGGAAGTGCTTGAACCAGGGAGGTGGAGGTTGCAGTGAGCCGGAATCGTGCCACTGCACCCCAGTCTGGGCAACAGATTGAGACTCTGTCTCAAGGAAAAAAAAAAAAAAAAAA"
"GL873566","8592056","8592127","chr10","28805224","28805297","15","20213168","TCTTGCCTGTAATCTCAGCACTCTGGGAGGCTGAGGCAGGCAGATCAACTGAGCTAACAAGTTCGAGACCAG","GTGGCTCATGCCTGTAATCTCAGCACTTTGGGAGGCTGAGGCAGGCAGATAACCTGAGGTCAGGAGTTCGAGAC"
"GL873566","8809109","8809200","chr11","48033118","48033204","26","39224009","ATAGCCAGGCTTGTTGCAGGCACCTGTAGTCCCAGTTACTCTGGAGGCTGAAGCAAGGGAATATCTTGAGCCCAAGAGTCTGAGGTTGCTGT","TTAGCCTGGCATGGTGGTGACACCTGTAATCCCAGCTACTCAGGAGGCTGGGAAGGAAAATCGTTTCAACCCAGGAGGCAGAGTTTG"
"GL873566","8809477","8809608","chr19","10830410","10830544","33","2020933","GGCCAGGCGCAGTGCCTCATGCCTGTAATCCTAGAACTCCGGGAGGCTAAGGAGGGTGGATTTCCTGAGTTCACAGGCTGGAGACCAGCCTGATCTAGAGTGAGATTCCCAGCTCTAAAAATAGCTGGCCTT","GGCCAGGTGCAGTGGCTCATGCCTGTAATCCCAGCACTTTGGGAGGCCAAGGTGGGTGGATCACCTGAGGTCAGGAGTTCGAGACCAGCCTGATCAACGTGGTGAAACCCCATCTCTACTAAAATTGCAAAATTA"
"GL873566","9503716","9503881","chr12","63241189","63241340","56","53737473","TATTAAAAAAAAAAGGAATTCAAGGCCAAGAGCAGTGGCTTTTGCCTGTGATACTTCCACTGTAGGAGGCCGAGGTGGAAGGATCACTTGAACTCTGGAGTTTGAGGTTGCTGTGATCTAGGCTGACACCACAGCACTCTAACTTGGTGGGCAACAGAGCAAGACT","AAAAACAAAAATTAGCCAGGTGTGTTGGCATGCACCTGTAGTCCCAGCTACTAGGGAGGCTGAGACAGAAGAATCACTTGAACCCAGGAGGTGGAGGTTGAGTGAGCCAAGATCGCGCCACTGCACTCCAGCCTGGGTGACAGAGCGAGACT"
"GL873566","9537883","9537992","chr16","43341998","43342113","30","33804115","ATGCCTGTAATCCTAGCACTTGGGAGGCCAAGGTGGGTGGATTGCCTGAGATCACAGGTTCAAGACCAGCCTGAGCCAGAGTGAGACCCTGCCTCTAAAATGAGCCAGGT","GCCTGTACTCCCAGCACTTTGGGAGGCCAAGGCGGGTGCATCACCTGAGGTCAGGGGTTCAAGACCAGCCTGGCCAACATGGTGAAACTCTGTCTCTACTGAAAATTCAAAAAATT"
"GL873566","9538266","9538462","chr7","167658032","167658223","54","158119766","TTAATTAATTAATTAAATAAAATGAGCCAGGTGTTGTGATGGGCGCCTGTAGTCCCAGCTACTTGGGAGGTGGAGGCAGGATAATCACTTGAGTCCAGGAGTTGGAAGTTGTTGTGAGCTGTGACGCCATTGTACTTGACCCAGGGCGACATCTTGAGGCGCTCTCTCTCAAAATAAATAAATAAAGAAAGAAAGAA","TACTAAAATACATACAAAAATTAGCCAGGTATGGTGGCAGGCCCCTGTAGTCCCAGCTACTCGGGAGGCTGAGGCAGGAGAACTGCTTGAACCCAGGAGGTGGGGATTGCAGTGAGCTGAGATCGCACCACTGCACTCCAGCCTGAGCGACAGAGTGAGACTCTGTCTCAAAAATAAAAAAAGAAAAAAAAA"
"GL873566","13663722","13663916","chr1","23558411","23558571","70","9894689","CTCAAGACCAGCCTGAGCCAAGAACGAGACTGAAAATAGAAAAATTAGTGGGACGTTATGTTGAGTGCTGGCTACTCTAGAGGGTGAGGTAGGAGAATTGTTTAAACTCATGAATTTAAGGTTGCTGTGAGCTAGGCTGACGCCACAGCACTGTAGCCTGGGCAACAGGCTACAGAACAGAGTGAGACTCTGTTT","AAAAATACAAAAATTATCTGGGCATGGTGGTGGGTGCCTGTATTCCCAGCTACTCTGGAGGGTGAGGCGGGAGAATTACTTGAACCCAGGAGGTGAAGGTTGCAGTGAGCCAAGATCACGCCACTGCACTCTAGCCTGGGCAACAGAATGAGACTCTGTCT"
"GL873566","13664206","13664293","chr7","151280825","151280914","17","137616619","GGCTAGATATGGTGGCTCATGCCAGTAATCTTAGCACTTTGGGAGGCTGAGGGGAGAGGATCACTTGAGCTGAAAAGTTCAAGACCAA","GGCCAGGCATGGTGGCTCATGCCTGTAATCCCAACACTTTGGGAGGCTGAGGTGGGTGGATCACTTGAGGCCAAGAGTTCAAGACCAGCC"
"GL873567","8375378","8375469","chr3","123612391","123612479","29","115237013","GGTTGGGCTTGGTGGCACGTACCTATGATCATCCTAGCTACTCAGGGAGCATAAGGCAGAAGAATTGCTTTAGCCCGGGAGTTGAGATCAAC","TTAGTTGGGCGTGGTGGCGCATGCCTGTAATCCCAGCTTCTCGGGAGGCTGAGGCAGGAGAATGGCTTGATCCCAGGAGATAGAGGTTG"
"GL873567","9062667","9063009","chr7","6620384","6620702","97","2442283","GGCCAGGCGTGGTGGCTCACGCCTGTTGTCTCAGCGCTGTGGGAGGCCGAGGCGGGTGGATCGCCTGTGCTCAGAGGTTCGAGACCAGCATGAGCCAGAGTGAGAGCCAGAGTAAGACCCCCTCTCTACCAAAAATTGCTGGGTGTTCTGGCAGGTGCCTGTAATTCCAGGTACTTGGGAGGCTGAGGCTAGAGAATCACTTAAACCCAGGGACCCAGGGGTTGGCGGAGGTTGCTGTGAGCTATGATTCTATGGTATTCTACTGAAGGACACAAAGCGAGACTCTGTCTCCATAAATAAATAAATAAATAAATAAAATAAAAGCAAAATTAAAAAAAAAAAA","GGCCAGGCACAGTGGCTCATGTCTGTAATCCCAGCACTTTGGGAGGCCGAGGCGGGTGGATTACCTGAGGTCAGGAGTTCTAGACCAGCCTGGCCAACAAGGCGAAACCCTGTCTCTACTAAAAATACAAAAAATTAGCTGGGCGTTTTGGCACATGCCTGTAATCCCAGCTACTTGGGAGGCTGAGGCAGGAGAATTGCTTGAACTGGGGAAGTGGAGGTTGCAGTGAGCTGAGATCACACCATTGCACGCCTGAGCAACAGAGCGAGACTCTGTCTCAAAAAAAAAAAAAAAAAAAAAAAAGAAAAGAAAAAGAAAA"
"GL873567","11215752","11215787","chr1","62915138","62915167","12","51699386","CAATAAAGCAAGACTCTGCCTCCAAAAGAAAAAAAA","CAAACAAACAAACATCACAAAAAAAGAAAA"
"GL873567","11215868","11216117","chr8","45194211","45194474","73","33978343","GGCTGGGTGTGATGGTTCAGGCCTGTAATCCCAGCGCTCTGGGAGACCAAGGCAGGATAGCCTGAGGTTAAGAGTTTGAGACCAGCCTGAGCAACACAAGACCCTGTCTAAACCAGGAAAATTACTGGGGTGTGGTGGCGTGTGCCTTAATCCCAACTACTCAGGAGGCTAGAGTATTGCTTGAGGGCAGAAGACTGAGGTTGCTGTGAGGAAAGGCTAAGGTCAAGCCATTCTAGCCCAGGCAATAGAG","GGCCGGGTGTGGTGGCTCATGCCTGTAATCCCAGAACTTTGGGAGGCCAAGGCAGGTAGATTACCTGAGGTCAGGAATTGGAGACCAGCCTGGCCAACATGGTGAAACCTCTTCTGTACTGAAAATTACCTGGGCATGGTGGCACACGCCTATAATCCCAGCTACTCAGGAGGCTGAGGCAGAATTGCTTGAGCCCGGGAGACAGAGGTTGCAGTGAGCCAAGATCGTGCCACTGTCCTCCAGTCTGGCCAACAGAGCAAGACT"
"GL873567","12342574","12342696","chr3","166690011","166690120","46","154347437","GTACGCGCAAACCAGAAAAATCAACTAGGTGTGGCAGGGCACACCTGTAGTCCCAGCTACTGGGGAGGGTGAAGCAAGAGATTGCTCAAGTCTGAGGTTACAGTGAGTTAAGATGATACCACT","TACACATACAAAAAATCAGCTGGGTGTGGTGGTACATGCCTGTAATCCCAGCTACTCAGGAGGCTGAGGCCGGAAAATCACTTGAACCCAGGAGGCAGAGGTTGCAGTGA"
"GL873567","12342734","12342873","chr8","96368294","96368428","43","84025560","GGCCAAACACAGTAGTTTATACCTATAATTCCAGCACTCTGGGAAGCTGAAGCAGAAGGATCAGCTGAGGTCAGGAGCCTCAAGACAAGCCTGGGCAAGACTAAGACTCCCCTCCATCCCTTCCCCCACTGTCTTCTCAC","GGCCAGACACAGTGGCTCACACCTGTAATCCCAGCTCTTTGGGAGGCTGAGGCAGGCGGATCACCTGAGGTCAGGAGTTCAAGACCAGCCTGGCCAACATGGTGAAACTGCATCTCTACTAAAAATATAAAACCA"
"GL873568","4322030","4322103","chr11","54983169","54983243","11","50661139","GGCCAGGCGCAGTGGCTCATGCCTTTAATCATAGCACTCTGGGAGGCTGAGGTAGGCGGATCTCCTGAGCCAGG","GGCCAGGTGCAGTGGCTCATGCCTGTAATCCTAGCACTTTGGGAGGCCGAGGTGGACCGATCACCTGAGGTCAGG"
"GL873568","4439574","4439747","chr7","26745376","26745549","54","22305802","GGCTGGGCATGGTGCTCACACCTGTAATCATAGCACTCAGGGAGGCCGAGGTGAGTGGATTGCCAGAGCTCACAGGTTTGAAACCAGACAGAGCCTTTTTTTTTTTAGAAGAAATTGTAGGCTGGGCATGGTGCTCATACCTGTAATCATAGCACTTGGGAGGCCAAGGCAAGA","GGCTGGGCATGGTGGCTCACGCCTGTAATACCAGTACTTTGGCAGGCCGAGGCGGGCAGATCACCTGAGGTCAGGAGTTCAAGACCAGCCTGGCCGTTTCTACTAAAAATACAAAAAATTAGCTAGGCATGGTGGTGCGCACCTGTAATCCCAGCTACTCGGGAGGCTGAGGCA"
"GL873568","4546898","4547014","chr15","31980678","31980795","24","27433780","GGCAGGGTGTGGTGTACACCCCTATAATCCCAGCACTTTGGGAGGCTAAGGCAGGAGCATCACCTGGGGCAGGAGTTCAAGGCCAGCCCGGAGAACAGAATGAAACTCCATCTCCAC","GGCAGGGCGTGGTGGCTCACGCCTCTAATCCCTGCACTTTGGGAGGCCAAGGCAGGCAGATCACCTGAGGTCAGAAGTTCAAGACCAGCCTGGCCAATGTGGTGAAACCCCATCTCCA"
"GL873568","5509331","5509406","chr12","122182458","122182528","25","116673127","TAATCCTAGCACCCTAGGAGGCCCAGGTGGGTGGATTACCTGAGCTCAGGAGTTCAAGAGCAAAAGTGAGACCCCT","CCCAGCACTTTGGGAGGCCAAGGCAGATGGATCACCTGAGGTCAGGAGTTGAAGACCAGCCTGGCCAACAT"
"GL873568","5509687","5509883","chr11","2904691","2904882","40","2604996","GTGAGACCCTTGTCTCTACTAAAAGTAGAAAAACTAGCCAGGTGTTGTGGCAGGTGCCTGTAATACCAGCTACTTAGAAGGCTGAGGCAGGAAGATCAGTTGAACCAAAGAGTTTGAGATTGCTGTGAGCTATGATGAAGCCACAGCACTCTACTATCCAGAGCGACAGAGGGAGACTCTGTCTCCAAAAAAAAAAA","GTGAAACCCTGTCTCTACTAAAAATACAAAAATTAGCCAGGTGTGGTGGTGCATGCCTGTAATCCCAGCTACTCAGGAGGCTGAGGCAGGAGAATCACTTGAACCCAGGAGGTGGAGGTTGCAATGAGCCAAGATCGTGCCACTGCACTCCAGCCTGGGTGACAGAGCGAGACTCCATCTCAAAAAAAAAAA"
"GL873568","7119774","7119822","chrX","41233833","41233871","13","34114059","AAAAGTAAAAAATGAGCCGGGTGAGGTAGCTCACGCCTGTAATCCCAGC","AAATCAGCCGGGTGTGGTGGCTCACGCCTGTAATCCCAG"
"GL873568","10881797","10881967","chr1","164648998","164649168","46","153767201","AAAATCACATATTTGCCTGGCATGTTGACTCATGCCCCTATGATCCTAGCACTCTGGGAGGCTGAGGCAGGAGCCTCACTTGAGTCTGTGAGTCTGAGGTTGCTATGAGCAAGGCTGATGCCATGATACTCTAGTGTGGTACAACAGAGTGAGACTCTGTCTCAAAAAAAA","AAAAACACATATTAGCTGGGTATGGTTGTGCGTGCCTGTAATCCCAGCTACTTGGAAGGCTGAGGCAGGAGAATCACTTGAACCCGTGAGGCGGAGTTTGCAGTGAGCTGAGATTGTGCCACTGCACTCCAGCCTGGGCAACAGAGCAAGACTCTGTCTCAAACAAACAAA"
"GL873569","1403943","1404082","chr2","53765152","53765289","48","52361209","AAGCTGAAGCAGAAAAACGGGCTAGAGGTCAAAAGTTTGAGACCTACCGTGGCTACACAGCAAAACTCTGTCTCTAAAAAAAATAAATAAGACCAGGTAAGGTGGTCATGACTATACTCCTAGCCCCTTAAGAGGCTGAG","GAGGTGGGTGGATCACCTGAGGTCAGGAGTTCCAGAACAGCCTGGTCAACATGGCGAAACACTGTCTCTACTAAAAATACAAAAATTAGCCAGGTGTGGTGGCATGCACCTGTAGTCCCCGCTACTCAGGAGGCTGGG"
"GL873569","7343422","7343556","chrX","124155286","124155406","55","116811864","TTTGAAAGTAGACTGCAAACATCATGTTGCTTCACCTCTAAATATATTAATATGGGCCAGGTGCAGTGGATCATGCCTGTAATCCTAGCACTTGCTAGGCCAAGGCTGGCGGATAGCCTGAGCAACAGCGAGACC","ATCAGCCTGACCAACATAGTGAAACCCCATCTCTACTAAAAATGCAAAATTAGCTGGGCGTGGTGGTGCATGCCTGTAATCCCAGCTACTTGGGAGGCTGAGGCGGGAGAATCACTGGAAC"
"GL873569","7404564","7404762","chr6","586928","587122","48","6817636","GAGATCCCATCTCTTAATGAAAATAAAACAATTAGCTGCTATTGTGGCAGGCACCTGTAATTCCAGCAACCCAGGAGGCTGAGGCAGGAGGATCACGTGAACCCCACCAGTTTGAGGTTGCTATGAGCCAGGCTGATGCCAGGACACTCCAGCCTGGGCAACGGAGTGAGACTCCATCTCCAAAAAAAGCAAACAAAAA","GAAACCCCATCTGTACTAAAAACACACAAATTAGTGGGATGTGGTGGCACGTCCCTGTAATCCTAGCTATTCAGGAGACTGAGGCAGGAGAATCACTTGAACCCAGGAGGTGGAGGTTGCAGTGAGCCGAGGTCACACCACTGCACTCCAGCCTGGGCAGCAGAGTAAGACTCCATCTCAAAACAAAAACAAAAA"
"GL873569","7405040","7405133","chrX","21386588","21386682","29","13981548","GGGCAGGGCGGCTCAGGCCTCTAATCCTAGCACTCTGGGAGCTTCCTTGAGCTCAGGAGTTCAAGACCATCCTAAGCAACAGAGATCCCATCTC","GCTGGGCACGGTGGCTCACGCCTGTAATCCCAGCACTTTGGGAAGCCAAGGTTTGAGGTCAGGAGTTCAAGACCAGCCTGGCCAACAGGCTGCAA"
"GL873548","15249374","15249463","chr5","46485072","46485159","19","31235698","GGCCAGGCATGGTGGCTCATACCTATTGTCCTAGCACTGTGGGAAGCCAAGGCAAGTGGATCACCTGAGCTCTAGAGGTTCGAGACCAGC","GGACAGACACAGTGGCTCATGCCTGTAATCCCAGCAGTTTGGGAGGCCAAGGCAGGTGGATCACCTGAGGTACAGAGTTCAAGACCAG"
"GL873548","15817199","15817306","chr7","158031905","158031997","37","142214706","AAAAAAAAAGAGTTGGAGGTTGCTATGAGCAACATCAGCATGGCACTCAATTCCAGGGTGACTGACTGAGACTGTTGTAGCTATACTCCAAAAAAAAAAACACACAAA","CCAGGAGGTGGAGGTTGCAATGAGCCAAGATCACACCACTGCACTCCAGCCTGGGTGACAGGGTGAGATTCTGTCTCAAAAAAAAAAAAAAAA"
"GL873548","15817589","15817786","chr3","3025868","3026088","60","12791721","GGCCAGGCATGGTGGCTTCTGTAATGCCAGCATTCTGGAAGGCTGAGGTAGGCAGTAGCTTGAGCTCAGTAGGAGAACAGCCTGACCAAAAGTGAGACCCTGTCTCTAAAAATAGTCGTTTGTGGTGGTTACCTGTTGTCCCAGCTACTAGGGAGGCTGAGGCAAGAGAATCACTTGAGCGTAAGAGTTGGAGGTTGC","GGCCAGGCACGGTGGCTCATGCCTGTAATCCCAGAACTTTGGGAGGCTGAGGTGGGCAGATCACCTGAGGTCAGGAGTTGGAGACCAGCCTGACCAACATGGTGAAACCCTGTCTCTACTAAAAATACAAAATTAGCCAGGTGTAGTGGCACGTGCCTGTAATCACAGCTACTTAGGAGGCTGAAGTAGGAGAATCACTTGAACCTGGGAGGTGGAGGTTG"
"GL873548","15856498","15856605","chr18","35090078","35090171","38","19233580","CCCCCCCCAAAAAGAAAAGGGTTGCTTGAATCTAGGAGTTTGGGGTTGCTGTGGGCTAAGCTGATACCACAGCACTTTAGCCTGAGCAAACAGAGTGACACTCTGTCT","AAGCAGGAAATCGCTTGAACCCAGGAAGCAGAGTTGCAGTGAGCCAAGATCGCACCACTGCACTGCAGCCTGAGCAACAGAGAAAGACTCTGTC"
"GL873548","15856683","15856877","chr3","3200882","3201085","53","12655801","GCCAGGCACAGTGGCTCATGCCTATAATCCTAGCACTCTGGGAGGCCAAGGCAGGATTGTCTAAGCTTGGGAGTTTGACAGCAGCCTGAGAAAGATTGAGACCCCTGTCTCTACTAAAAAATAGAAAAATTAGCTGAGTGTTGCAGCAGGTGCCTGTATTTCCAGCCAAGGGGGAGGTTGAAAAGGGTCGCTTCA","GGCCAGGCGCAGTGGCTCATGCCTGTAATCCCAGCACTTTGGGAGGCCGAGGCGGGTGGATCATAAGGTCAGGAGTTTGAGACCAGCCTGGTCAACATGGTGAAACCCCATCTCTACTAAAAATACAAAAATTAGCTGGGTGTTGTGGCACATACCTGTAATCCCACCTACTCAGGAGGCTGAGGCAGGAGAATCACTTGAACC"
"GL873549","1940307","1940608","chr12","9481260","9481565","74","7540953","GGCTGGGCGCAGGGGCTCATGCCTGTGACCCTAGCACCCTGGGAAGCCAAGGCGGGCAGATCGCCTAAGCTCACGAGTTTGAAACCAGCCTTAGCTAGAGTGAGACCCCCAATACTAAAAAAATAGCCAGGCTTTGTGATGGGCGCCTGTAGTCCCAGCTACCTGGGAGGCTGAGGCAAGAGAATGGCTCAAGCCCAAGAGTCTGAGGTCACAGTGAGCTACTGACGCCACCGCACTCTATTGGAACAACAAAGTGAGACTGTGTCTCAAACAAACAAACAAACAAACAAACAAAAAAGAAA","GCTGGGCGCGGTGGCTCATGCCTGTAATCCCAGCACTTTGGGAGGCCAAGGCAGGTGGATCACCTGAGGTCAGGAGTTCGAGACCAGCCTAGTCCACATGGTGAAACCCCATCTCTACTAAAAACTAGCCAGGCGTGGTGGTGCGCACCTGTAATCCCAGCTACTCGAGAGGCTGAGGCAGGAGAATCACTTGAGCCTAGGAAGCAGAGGTTGTGGTGAGCTGAGATCACACCACTGCACTCCAGTCTGGGCGACACAGTGAGACTCTTGTCTCAAAAACAAAAAACAAACAAACAAACAAACAAA"
"GL873549","2657819","2658019","chr11","18547798","18548000","50","15889979","GGCCTGGCACTGTGGCTCACACCTGTCAGGTTAACACTCTGGGAGGCTGATATGGGTGGGTCTCCTGAGTTTAGGAGTTTAAGACCAGCCTAATCAAGAGTAAGACCTGCCTTTACTAAAAATAGAAACACTCACCAGGACTACTGTGCACCTACAGTCCCAGCTACCTGGGAGGCTGAGGCAAGAGGATTGCTCAAGCCC","GGCCAGGCACTGTGGCTCACACCTGCAATCCCACCACTCTGGGAGGCAGAGGCAGGTGGATCACCTGAGGTCAGGAGTTTGAGACCAACCTGGCCAACAGAGCAAAACACTGCCTCTACTAAAAATACAAAAACTAGCCAGGTGTGGTGCATGCCTATAGTCCCACCTACTTGGGAGGCTGAAGCAGGAGAATCTCCTGAGCC"
"GL873549","8853848","8853952","chr12","88112976","88113081","32","79259128","AGCCAGCTGTGTGGCTCATTCCAGTAATTCCAGTTACTGGGGAGGCTGAGACAGGAGGATCACTTGAATGCAAGAGGTGGCGAGAACTCAGCTTTAAAAATAAAA","GGCCAGATGCAGTGGCTCATGCCTGTAATCCCAGCACTTTGGGAGGCTGAGGCAGGCGGATCACCTGAGATCAGGAGTTTGAGACCAGCCTGGCCAACATGGTAAA"
"GL873549","10378794","10378882","chr20","18199749","18199840","17","7820955","GGCCAGGCACGGTGGTTCACCTGTGATCCCAGCACTCTGGGAGATAAGGCAGGCTGATCACCTGAGTTCACAGGTTGGAGACCAGCCTG","GGCCGGGCATGGTGGCTCACACCTGTAATCCCAGCACTTTGGGAGGCTGAGGCAGGCGGATCACCTGAGGTCAGGAGTTCGAGACCGGCCTG"
"GL873549","15488169","15488282","chr10","38476693","38476794","41","22988524","CTGAGCACACGGGTTCACACCTGTAATCCCAGCACGCTGAGAAGCCCAGGCAAGAGGCTGACCTCCAGCCTGGGTGACGGAGCGAGATTCCCCCCCACCCCCGACCAAAAAAAA","CTGAGCGCTGGTAGCTTACACCTGTAATCCCAGCACTTTGGGAGGCCTAGACAGGCGGATCACTTGGGGTCAGGAGTTTGAGACCAGCCTGGCCAATATGAT"
"GL873549","17403348","17403519","chr10","38461164","38461337","46","21057816","GCCAGGCACAGTGGCCCACACCTGTAATCCCAGTACTGTGGGAGGCTGAGGCAGGCTGAGGCAGGCATGGATCACTGAGGTTGCTGTGAGCTAAGATGCCATGGCCCTCCACCCAAAGTGACAGAGTGAGACTCTGTCTCAGAATTAAAAAAAACAAAGAAAGAAAAATAAA","GCCAGGCATGGTGACTCACGCCTATAATCCCAGCACTTTGGGAGGCTGAGGCATGAGAATCACTTGAACCCAGAAGGCAGAGGTTGCAGTGAGCTAAGATTGTGCCACTGTACTCCTGCCTGGGTGATGGAGTGAGACTCTGTCTCGATTTAAAAAAAAAAAAAAAAAAAAAAA"
"GL873550","801968","802043","chr15","50500527","50500602","20","49698559","GTAGCCAGGTATGGTAGTGCAGGCCTGTACTCCCAGCTACTTGGAAAGCTAAGGCAATAGAATCATTTAAGCCCAG","TGGCCGGGCATGGTGGTACATGCCTGTAATCCCAGCTACTTGGGAAGCTGAAGCAGGAGAATTGCTCGAACCCAGG"
"GL873550","802343","802376","chr3","33494224","33494257","9","32691881","TAAGACTTTGTCTCTACTAAAAATAGAAAAAGTG","GTGAAACCCGTCTCTACTAAAAATACAAAAATTA"
"GL873550","2805841","2805900","chr2","93673843","93673900","18","90868002","CTATTCAAAATAGCTAAAATGGGCAGGGCAAGGTGGCTCACACCTGTAATCCCAGTACTC","TAAAAATGTAAAAGATTGGCCGGGTGTGGTGGCTCACTCCTGTAATCCCAGCACTTTG"
"GL873550","4153085","4153214","chr16","18855701","18855834","37","14702616","GGCAGGGCTTGGTGGTAAAAGCCTGTAATCCTACCACTCTGGGAGGCAGAGGTGGTTAGATTGCATGAGGTCACTGGTTGGAGACCAGCCTGAGCTAGAGCAAGACCTCATCTCCAAAAATAGCAGGGCT","GGCTGGGCGCGGTGGCTCACACCTGTAATCTCAGCACTTTGGGAGGCCGAGGTGGGTGGATCACCTGAGGTCAGGAGTTCGAGACCAGCCTGGCCAACATGGCAAAACCCCATCTCTACAAAAATACAAAATTA"
"GL873550","4153472","4153634","chr7","17472856","17473028","43","13319384","AATAAAAATAGCAGGGCTTTGTGGCGGGCACCTGTAGTCCCAGCTACTTGGGAGGCTGAGGCAAGACAATTGCTTGAGCACAAAGTTGGAGGTTGTTGTGAGCTGTGACATCATAGCACTCTACCAAGGGAGATAGAGTGAGACTATCTCGAAGAAAAAAAAA","ATACAAAAATTAGCCAGGTGTAGTGGCGTGCACCTGTAATCCCAGCTACTCGGGAGGCTGACGCATGAGAACTGCTTGAACTCAGGAAGTGGAGGTTGCAGTGAGCTGAGATAGTGCCACTGCACTCCAGCCTGGGTGACAGAGCAAGACTCCATCTCAAAAAAAAAAAAGAA"
"GL873550","6050671","6050965","chr7","84009904","84010193","74","77959233","GGTGGCTCACGCCTGTTATCCTAGCACTCCAGGAGACTAAGGTAGGAGGATGCCTTGCTTGAACTCAAGAGTTCAAGACCAGTCTGAGTGAGAGGGAGACCCTGCGTCTACTCAAAAATAGAAAAATTTACCAGCCATTGTGGCCAACACCTGTAGACCCAGCTATTCAGGAGTCTGAGGCCAGAGAATCACTTGAACCCAGGAGACTGAGATTGCTGTGAGCTAGGCTAAAACCATGGCACTCTAGCCCAGGTGGCAGAGTGAGACTGGGTCTGCAAAAAATAAATAAAAACAA","TGGCTCATGCCTGTAATCCTAGCACTTTGGGAGGCCAAGGCAGGTGGATTGCCTGAGCTCAGGAGTTCAAGACCAGCCTGGCAACACGATGAAACCCCGTCTCTATTAAAAAATACAAAAAATTGGCCAGGCATGGTGGTGTGCACCTGTAATCCCAGCCACTCAGGAGGCTGAGGCAGGAGAATCGCTTGAACCCGGGAGACAGAGGTTGCAGTGAGCCAAGATCGAACCATTGCACCCCAGCCTGGGTGAGAGTGAGACTCTGTCTAAAAAAAAAAGAAGAAAAAGAA"
"GL873550","6212004","6212068","chr19","50425309","50425373","23","44213305","AGAACCTAAGAGTTTTGAGGTTGCTATGAGCTGGACTGATACCATAGCATTCTAGTCTGGGTGAC","TGAACCCAGGAGGTGGAGGTGGCGTGATGCCCAAGATGTGCCACTGCACTCCAGCCTGGGTGATA"
"GL873550","6212319","6212418","chr17","89042086","89042197","34","82829767","CTGTCTTTTCTAAAAATAGAAAAACTAGCTGGGTTGTGGTGGGCACTTGTAGTCCTAGGTACTCTGAGGCTGAAACAGGATTGCTTGAACCTAAGAGTTT","GTCTCTACTAAAAATACAAAAATTAGCCGGGCATGCTGGTGGGCACCTGTGATCTCAAGCTACTTGGGAGGCTGAGGCAGGAGAATCACTTGAACCTGGGAGGCAGAGGTTG"
"GL873550","6504310","6504401","chr19","2969698","2969794","27","3534612","GTGCTGGTGTATGCACCTGTCATACCAGCTACTCCTGAGGTTGAGGCAGGATAGCTTGAACCCGGGAGTCTGAGACTGCAGTGAGCTGGGAT","TTAGGCGTGGTGCATGTCTGTAATCCCAGCTACCCGAGAGGCTGAGGCAGGAGAATCACTTGAACCTGGGAGGCGGAGGTTGCAGTGAGCCGAGATC"
"GL873550","7178331","7178523","chr19","40691105","40691269","60","33512774","GGCCAGACGCGGTGGCTCACGCCTGTTGTCCCGGCACTGTGGGAGGCCGAGGCTGGTGGATCCCCTGAGCTCAGCCAAGTTCAAGACCAGCGGAAGACCAGCATGAGGCAGAGTGAGCCAGAGTGAGACCCCGTCTCTACAACAACAACAACAAAAAATAGCCGGACCTTGTGATCCCAGCTACATGGGAGGC","GGCCGGGCATGGTGGCTCACGCCTGTAATCCCAGCACTTTGAGAGGTCGAGGCAGGTGGATCACCTGAGGTCAGGAGTTCGAGACCAGCCCGGCCAATATGGTGAAACCCCTTCTCTACTAAAAATACAAAAAATTAGCCGGAAGTGGTGGCATGCACCTGTGAT"
"GL873550","7981631","7981790","chr6","148611209","148611366","40","140629578","ATAGCCCCGCCTTGTGGTAGGCTCCTGTAGTCCCAGCTACTTGGGAGGCTGGGGCAAGAGAATCACTTAGGCCCAAGAGTTGGAAGTTGCTGTGAGCTGTGATGCTACAGCATTCTACTGAGAGTGACAAAATGAGACTCTGTTTAAAAAAAAAAAAAAA","TTAGCTGGGCATGGTGGCAGGTGCCTGTAATCCCAGCTACTCTGGAGGCTGAAGCAAGAGAATCGCTTGAACCCAGGAGGTGTAGGTTGCAGTGAGTCGTGCCACAGCACTCCATCCTGGGTGACAGAGCAAGACTCTGTCTCAAAAAAAAAAAAAAA"
"GL873550","7982053","7982180","chr2","182489403","182489528","28","174507350","GGCTGGGCGAGGTTGTTCAGACCTGTAATCCTAGCACTCTGGGAGACCAAGATGGGTGGATTGCCTGAGTTCATGAGTTTGAGACCAGCCTGAGCCAGAGTGAAACCTTGTTCTCTAAAAATAGCTCG","GGCCGGGTGTGGTGGCTCATGCCTGTAATCCTAGCGCTTTGGGAGGCCGAGGTGGGTGGATTGCCTGAGCTCAGGAGTTCGAGACCAGCCTGGGCAACACGGTGAAACCTGTCTCTACTAAAATAC"
"GL873550","8404122","8404320","chr4","121405930","121406135","43","113001808","GGCCAGGCACAGTGACTCACACCTGAAATCTTAGTACTCTGGGAGGCCAAGGTGGGAGGATTTCCTGAGGTCAGGAGTTCAAGACCAGCCAGAGCAAGAAGATCCTGTCTCTACTAAAAGTATAAAAAGTGAACCAAGTGTGGTAGTGAGCACCTATAATCTCAGCTACTTGGGAGGCCGAAGCAAGAGGATCACTTGA","GGCCAGGCACAGTGGCTCACACCTGTAATCTCAACACTTTGGGAGGCCAAGGTGGGTGGATCACCTGAGGTCAGGAGTTTGAGACAAGCCTAGCCAGCATGGTATAACTCCATCTCTACTAAAAGTATAAAAATCAACCAGGTGTGGTGGCACATGCCTGTGGTCCCAGCTACTTGGGAGGCTGAGGCAGGAGAATCACTTGAATC"
"GL873550","8404408","8404483","chr15","701469","701538","22","7702939","AGGATCTCTTGAGCTCGGGAGTTTGAGGTTGCAGTGAGCCAGGCTGATGTCATGGCACGCTACCCAAGACAACAAA","AATCACTTGAACCCAGGAGGCAGAGGTTGCAGTGAGCCAAGACTGTGCCATGGCACTCTAGCCTGGGCAA"
"GL873550","11648593","11648682","chr3","124881947","124882027","31","113233354","GTGGCTCACACTAGTAATCTTAGTACTTTGGGAAGCTGGGGCAAGAGGATCACTTGAGGTCAGGGTTAGGAAACTCTATCACTACAAAAA","GCGGTGGCTCACGCCTGTAATCCTAGCACTTTGGGAAGCCAGGCAGGCAAATCACGAGGTCAGGAGTTCGAAACCAGCCTG"
"GL873550","12468624","12468663","chr9","62916303","62916339","11","50447679","GCCCGGCTTGGTACCTCATGCCTGTAATCTTAGCACTCCG","GGCCGGGCATGGTGGCTCATGCCTGTAATCCCAGCAC"
"GL873550","12468943","12469188","chr12","70524409","70524645","91","58055466","AATCTTAGCACTCCGGGAGGCCGAGGCGGGTAGACCAACCTAATCAAGAGCAAGATCTACCTCTACTAAAAATAGAAAAGAATTGGCCAGGCGTATTGACTCCGCCTCTAGTGCCAGCTACTCCAAAGCTGAGGCAAGAGGATTGTTCAAATCCAAGAGTTTGAAATTGCTGTATGTTACACCAGGGCACTCTAGCCGTGGAGACATTTTCTCTATATATATTAAAAAAAACAAAAAACAGAAAAA","CTGAGCTCGGGAGTTCGAGACCAGCCTGACCAATATGGAGAAACCCTGTCTCTACTAAAAATGTAAAATTAGCCAGGCATGGTGGCACATGCCTGTAGTCCCAGCTACTCAGGAGGCTGAGGCAGGAGAATCGCTTGAGGTCAGGAGGCGGAGGTTGCAGTGAGCCAAGATCATGCCACTGCACTCCAGCCTGGGTGACAGAGTGAGACTTTGTCTCAAAAAAAAAAAAAAAAAAAA"
"GL873550","14719674","14719880","chr16","30390993","30391163","76","15671319","GGGCGTGGTTGCTCACGCCTGTTGTCCCAGCGCTGTGGGAGACCGAGGCAGATGTATCGCCTGAGCTCAGCCGAGTTCGAGTTCGAGACCAGCGGAGAGACCACCATGAGGCAGAGTGAGCCAGAGTGAGACCCCGTCTCTACAACAACAACAAAGAAAACAGCCGGATCTTGTGATCCCAGCTACATGGGGGCCAAGAGAATCACT","GGGCACGGTGGCTCACACCTGTAATCCCAGCACTTTGGGAAGCCAAGGCAGGAGGATCACCTGAGGTCAGGAGTTCAAGACCAGCCTGGCCAACATGGTGAAACCCCGTCTCTACTAAAAACACAAAAATTAGCCAGGTGTGGTGGTGCACGCTTGTAATCCCAGCTACTC"
"GL873550","15737883","15738154","chr2","20481557","20481833","73","4743674","TTAGCATTCTGGGAGGCCAAGTCAGGTGGATTGCCTGAACTCACAAATTTGAGACTAGCCTGAGATAGAGAAAGATCTTGTCTCTAAAAAAAAAAAAAAATAGCTGGACTTTGTAGTGGGCACCTGTAGTCCCTGCTACTCAGAAGGCTGTGGTAAGAGAATCACTGGAACCCAAGAGTTAGAGGTTGCCGTGAGCTGTGATGCCATGGCACTCTACCAGAGACAACAGAGTGAGACTCTCTCCAAAAAAAAGAAAAAGAAAAAGAAAAAAA","GCACTTTGGGAGGCCAAGGCAGGTGAATCACCTGAGATCAGGAGTTCAAGACCAGCCTGGGCAACATGATGAAACCCTGTCTCTATGAAAAATACAAGAATTAGCTGGGCATAGTGGTGTGCATCTGTAATCCCAGCTACTCAGGAGGCTGAGGTATGAGAATTGCTTGAACCCTGGAGGCAGAGGTTGCAGTGAGCCGAGATGACACCGTTGCACTTCAGCCTGGACAATAGAGAGAGACTCTGTCTCAAAAAAATGAAGAAAAGAAAGAAAGAAA"
"GL873550","15738844","15738873","chr10","65896918","65896951","9","50158074","GGGTGTGGTGGCTGATGCGTGTAATCCTAG","GGCTGGGCGTGGTGGCTCATGCCTGTAATCCCAA"
"GL873550","16345151","16345329","chr1","6754007","6754209","69","9591144","CACCTGTAATCCCAGCACTTGGGAGGTTGAGGAGAGTGGATTGCCTGAGCTCACAGGTTTGAGCCAGAAGGAGACCTCGTCTGTAAAAATAGCTGGGTGTTGAGACCAGCGCCTTTAGTCCCAGCTACTTGGGAGGCTGAGGCAAGAGAATCACTTAAACAATTCTAGAAGCAGAGTTT","CTGTAATCCCAGCACCTTGGGAGGCTGAAGAGGGCGGATCACCTGAGGTCAGGAATTTGAGACCAGCCTGGCCAACATGGTGAAATCCCATCTCTACTGAAAATACAAAATTAGCTGGGTGTGGTGGTGCATGCCTGTAGTTCCAGCTACTTGGGGAGCTGAGGCAGAAGAATGCCTTGAACCCGGGAGGCAGAGGTTGCAGT"
"GL873550","17727115","17727274","chr1","127857902","127858038","52","110130787","GCTGGGTGCAGTGACCCCTGCCTATAATCCCAGCAGTTAGGAGACAAAGGCAGGAGGAATTACCTGAGAGCAGGAGTTCCAGACAAGCCTCAGACCAGCGTGAGCTATGACATTGTCTGTAGCCCCCACCCCACCCCCCCAAAAAACAAAAAGAAACAAA","GGCTGAGTTCAGTGGCGCACGCCTGTAATCCCAGCAGTTGGGAGGCTGAGGCAGGTGGATTGCCTGAGGTCAGGAGTTCAAGACCAGTCTGGCCAACATGGTGAAACTCTGTCTCTACTAAAAAAAAAAAAAAAAAT"
"GL873551","6567068","6567102","chr14","109767086","109767123","14","103200018","GGATCACATGAGGTCAGGAGTTCAAGATCAGCCTG","GGAGGCAGAGGTTGCAGTGAGCCAAGACTGCGCCATTG"
"GL873551","9393264","9393376","chr1","39198637","39198744","32","29805373","CAAGAGTATCTCTGCAACCCAGTGGCCTGAGGTTGCTATGAGCTAGGATGCCACAGCACTCTACCCAAGGGGACAGAGTAAGACTCTGTCTCCAAAAAAAAAAAAGAGCAAAA","AGAATCGCTTGAACCTGGGAGGCGGAGGTTGCAGTGAGACCAGATCATGGCACTGCACTCCAGCCTGGGCGACAGAGTAAGACTCGGTCTCAAAAAAAAAAAAAAAAA"
"GL873551","9393708","9393894","chr12","115674238","115674427","40","106280530","GCTGGGCTCAGTGCCTCTCGCCTGTAATCCCAGCACGCTGGGAGCCTGAGGTGGGTGGGTTGCTTGAGCTTAGGAGTTCAAGACCAGCCTGAACCAGAGCAAGACACTATCTCTACTAAAAATAGAAAAACTATCTGGGCATGGTGGTGCGCACCTGTAGTCCCAGCTACTAGGGAAGCTGAGGCAA","CCAGGCCTGGTGGCTCACGCCTGTAATCCCAGCACTTTGGGAGGCCGAGGTGGGTAGATCACCTGAGGTCAGGAGTTCAAGACCAGCCTGGCCAACATGGCGAAACCCCATCTCTACTAAAAATACAAAAATTAGCTGGGCATGGTGGTGTATGCCTGTAATCCCAGCTACTCGGGAGGCTGAGGCAGGA"
"GL873551","10104594","10104683","chr16","53032852","53032939","31","42928258","GGTAGGTGGGTCTCTCGAGGTTAGGAGCTCTTTACCAGCCTGAGCTGACATAAGACCCAATCTCCACCAAAATAGAGAGAGAAAAAAAGA","GAGGCAGACAAATCTCTTGAGGTCAGGAGTTGAAGACCAGCCTGGGCAACATAGACCTCGTCTCTATTAAAAAAAGAAAAAAGAAAAA"
"GL873551","12307468","12307551","chr8","94102375","94102458","19","81794907","GGCCAGGCATAGCAGCTCATGCCTGTAGTCCTATTATTCTAGGAGGTCCAGGGAGGAGGATCACCTGAGATCAGAAGTTCAAGA","GGCCAGGCATGGTGCCTCATGCCTGTAATCCCAGTACTTTGGGAAGCCAAAGTGGATGGATCACCTGAGGTCAGGAGTTCGAGA"
"GL873551","13335872","13336095","chr4","85819795","85820026","56","72483923","GCCAGGTACAGTAGCTCAGGCCTGTAATCCTAGCACACTGGGAGGCTGAGGTGGTGGATCCTTGAACTCATGAATTCAAGACCAGCCTGAGGAAGAGCAAGACCCCATCTCTCCTAAAAATAGAAAAATTAGCTGGTGTCATGGCAAGTGTCTGTAATCCCAGCCACACAGGAGGCTGAGGCAAGAGGATCTCTTGAACCCAAGACACTAAAGTTACTGGGAGC","GCCGGGCATAGTGGCTCATGCCTGTAATCCCAGCACTTTGGGAGGCTGAGATGGGTGGATCATCTGAAGTTAGGGGTTCGAGACCAGCCTGGCCAAATGGCAAAAACCCATCTCTGCTAAAAATACAAAAATTAGCCAGACATTGTGGCATGTGCCTGTAATCCCAGCTACTCAGGAAGCTGAGACAGGAGAATCGCTTGAACCCAGGAGGCAAAGGTTGCAGTGAGCCAAG"
"GL873552","1195303","1195426","chr3","54039332","54039457","34","52844029","CTACTCTGGATGCCAAGGCAGCGGGATCACTTGAACCCCAGAGTCTGAGGTTGCTGTGATCTCAGCTGACTCCATGGCACACTAGCCTGAGGCAACAGACTGAGACTATATCTCAAAACAAAAA","AGCTACTCAGGAGGCTGAGACAGGGAGAGTCACTTGAACCCAGGAGGCAGAGTTGCAGTGAGCCGAGATCACGCCAACTGCACTCCATGCCTGGGCAACAGAGTGAGACTCCGTCTCAAAAAAAAA"
"GL873552","15010293","15010428","chr1","29437872","29437991","29","14427579","GGCCGGGCGTGGTGGCTCACGCCTGTATTCCCAGCGCTATGGGAGGCCGAGGCGGGTGGATCACCTGTGCTCAGAGGTTCGAGACCAGCCAAGACCCCCCTGAGCCAAACGAGCCAGAGTGAGACCCCGTCTCTAC","GGCCGGGCGTGGTGGCTCACGCCTGTAATCCCAACATTTTGGGAGGCCAAGGCGGGTGGATCACCTGAGGTCAGAAGTTCGAGACCAACCTGGCCAACATGGTGAAACCCCTGTCTCTAC"
"GL873553","860627","860695","chr1","16024119","16024187","13","15163492","GCCAGGCTCAGTGGCTCACGCCTATAATCTTAGCGCCTTTTGGAGGCCAAGGTGGGGGGATTACCTGAG","GGCCAGGCACGGTGGCTCACGCTTGTAATCCCAGCACTTTGGGAGGCCGAGGAGGGTGGATTACCTGAG"
"GL873553","7206820","7206939","chr3","156098583","156098705","38","148891763","AGCTAGGTATGGCAGCTGACATCTGTAACCCTAGCCCTCTGGCAGGCCAGGAATTCAAGACCAGCCTAGACAACATAGTAAGACCCCATCTCTACCAAAAATAATTTAAAATTGGCCAGG","GGCTGGCTGTGGTGGCTCACACCTGTAATCCCAGTACTTTGGATCATGTGAGGTCAGGAGTTCAAGACCAGACTGACCAACATGGTGAAACCCTGCCTCTACTAAAAATACAAAATTAGCCAG"
"GL873553","10985147","10985407","chr12","94325498","94325767","64","83340351","GGCCTGTGGCAGTGGCTCATGCCTGAAATCCTAGCACTCTGGGAGGCTGAGGTGGGTCGATTACCTGAACTCACCAAGACGGAGACCTCATCTCTACTAAAAATAGAAAAACTAGCTGGGCGTGGTGGCAGGTGCCTGTAGTCCCAGTTACTGGGGAGGCTGAGGCAAGAGAATTACTTGAACCCAAGAATTTGAGGTTGCTGTGAGCTATGATGCCACAACACTCTACTCAGGGTGACGGAATAAGACCCTGTCTCAAAA","GGCCGGGTGTGGTGGCTTATGCCTGTAGTCCCAGCACTTTGGGAGGCCGATGGGGATGGATCACCTGAGGTCACTGGCCAACACAGAGAAACCCCATCTCTACTAAAAATACAAAAATTAGCCAGGCGTGGTGGCATGTGCCTATAATCCCAGCTACTTGGGAGGCTGAGGCAGGAGAATCACTTGAACCCGGTAGGCAGAGGTTGCAGTGAGCCGAGATTGTGCCACTGCACTCCAGCCTGAGTGACAGAGCAAGCCTCTGTCTCAAAA"
"GL873553","10985438","10985466","chr16","73760336","73760365","6","62774898","CATAAAAAGAAAGAAAACTGAAAAGAAAA","GAAAGAAAGAAAGGAAAAGAGAAAAGAAAA"
"GL873553","12443178","12443505","chr1","3864926","3865253","98","8578252","GCAGGGTGGGGAGGCTCGCACCTACATCCCCAGCACCCTGGAAGGCTTAGGCAGGTGGACTGGGTTCAGGAGTTGGAGAGCAGCCTGAGCAATAGTGAGATTCTGTCTGCAGTAAAACTAGAAAAATTATTTAGGGGTTGTGCTGGGTGCCTATTATCCTAGCTACTGTTGAGGCAAGGGGACAGCTTGAACCCAGGATTTTCAGGTTTCTGTGAGCTAGGATGATGCCATGATGACCCTCTGACACTTTGCCTGGGCAGTAGAGTGAAACTCTGTCTCAGAAAAAACAAAACAAAACAAAACAAAACAAACAAACAAACGAAAAAAA","GGCCAGGCGTGGTGGCTCACACCTGTAATCCCAGCACTTTGGGAGGCTGAGGCAGGTGGATCACCTGAGGTCAAGAGTTCAAGACCAGCCTGGCCAACATGGTGAAACTCTGTCTCTACTAAAAATACAAAAATTAGCCGGGCATGGTGGTGCATGCCTGTAATCCCAGCTATTCGGGAGGCTGAGGTAGGAGAATAGCTTGAACCCGGGAGGTGGAGGCTGCAGTGAGCTGAGATCATGCCATTGCACTGTAGCCTGAGCAACAGAGAAAGACTCTGTCTCAAAAAACAAAACAAAACAAACAAAAGAACAAAAACAAACAAACAAA"
"GL873553","15121135","15121247","chr1","111354387","111354508","21","96233252","GGGCGTGGTGGCTCACACCTGTAATCCCATCACTTGGGAGGCTGAGGCAGGTGGATCACCTGACCTCAGGAGTTCGAGACCAGCCTGAAGAAGAGTGAGACCCCGTCTCTAAA","GGCCGGGCGTAGTGGCTCACACCTGTAATCCCAGCACTTTGGGAGGCCGAGGCGGATGGATCACCTGAGTTCAGGAGTTTGAGACCAGCCTGACCAAAGTGGTGAAACCCCGTCTCTACTAA"
"GL873553","15121274","15121455","chr7","68420775","68420939","69","53299501","AGATTTCAACAGGCCTAATGGCTTTAGTATATAAAGAGAACTTATAAAGCCAGACTCAGTGGCTTACATCTATAATCCAGGTACTTGGTAGGTTGAAGTGAGAAGATTCTTTGAGCCAGGATTTCCAGCCCAGCCTAGGCAACACAGAGAGACCCCCATCTCTAAAAGAGAAAGGTAAAAAA","GGCTAAAGGGGTGCTCATCTTAAGAATACCAGGCCAGGCGCAGTGGCTCATGCCTGTAATCCTAGCATTTTGGGAGGCTGAGGCGGGTGGATCACCTGAAGTCAGGTGTTTGAGACCAGCCTGAACAACATAGTGAGACCTCATCTCTAATTAAAAAAAGAAAAA"
"GL873553","15614197","15614298","chr4","71691062","71691163","34","56076865","GGTGGCTCACACCTGTTATCCCCATACTCTGGGGGCCTGAGGTGAGAGGATCCCCAGAAGTCAGGAGCTGGAGAGAAGCCTGTGTAAGAGTAAGAGCCAGTC","GTGGCTCATGTCTGTAATCCCAGCACTTTGGGAGGCCGAGGTCGGTGTATCATTTGAAGTCAGGAGTTTGAGACCAGCCTGGCCAACGTGGTGAAACCCTGT"
"GL873553","16849767","16850040","chr1","96770987","96771267","68","79921220","GGCCAGGAGTGGTGGCTCATGCCTGCAATCCCAGCACTTGGGAGGCCAAGGTGGGTGGATTGCCTGAGCTCACAGGTTCAAGACCAGCATGAGCCAGAGAGAGACCTTGTCTCTAAAAATAGGCACAGGTTGTGGTGGGCACCCGTAGTCCCAGCTACTTGGGAGGCTGAGGCAAGAGAATCACTTAAGCCCAGGAGTTTGAGGTTGCTGTGAGCTAAGACACCACAGCACTCTACCAAGGGTGACAAAGTAAAACTCAGATTTTTTTAAAAAA","GGCCAGGTGTGGTGGCTCACAGCCTGTAATCCCAGTAGTTTGGGAGGCCGAGGTGAGCAGATCACCTGAGGTCAGCAGTTCGAGACCAGCCTGGCCAACATGGCAAAACCCTATCTCTACTAAAAGTACAAGGTGTGGTGGCACACACCTGTAGTCCCAGCTACTTGGGAGGCTGAGGCAGGAGAATCACTTGAACTCCAGAGGTGGAGGTTGCAGTGAGCCAAGATTATGCCACCGCATTCCAGCCTGGGTGACAGAGTGAGACTCCGTCTCCAAAAAAA"
"GL873554","511555","511741","chr6","166828248","166828429","56","166316693","GTGGGACCCGCATCTATACTAAAAATGAAAAACTAGTCAGACTTGGTGACTCATGCCTATAATTTCAGTTTCTTGGGAGGTGAAGGCAGAAGAATTGCTTGATCCCAGGAATCTGAGATTGCTGTGAGCTAGGCTAACACTATGGCACTCCAGCCCAGCTGACAGAGTAAGACTTTGTCTTTAAAAA","ACCCCATCTCTACTGAAAATAGAAACATTAGCCGGGCTTGGTGGCATGCGCCTGTAGTCCCAGCTATTTGGGAGGCTGAGGCAGGAGAATTGCTGGAACCCAGGAGGCAGAGATTGCAGTGAGCGGAGATCATGCCATTGCACTCCAGCCTGGGCGACAGAATGAGGCTCCATCTCAAAAAA"
"GL873554","2046660","2046725","chr8","51862362","51862427","7","49815702","GGCTGGCCGCGGTGGCTCACGCCTGTAATCCTAGCACTCTGGGAGGCCGAGGCAGGCAGATCACCT","GGCCGGGCACGGTGGCTCACACCTGTAATCCCAGCACTATGGGAGGCCGAGGCAGGTAGATCACCT"
"GL873554","2580766","2581036","chr13","93262937","93263229","81","90682171","GGCCTGGGCAAGGTGGCTCACTCTCTGGAAGGCTGAGGCAGATGGATTGCCTGAGCTCAGGAGCTAGAGACTAGCATGATCTCACCTCTACTAAAAATAGAGAAACTAGCCAGGCATTACAGCACACGCTTGCAGCCCCAGCTACTCTGGGGGCTGAGGCAAAAGGATCACTTGGACTCAAGAAACTGAGGTTCCTGTGAGCCATGATGCCAGGACACTCTACCCAGGGAAACAGAGTGAGACTTCATCTCAAAAAAAAAAAGAAAGAAAA","GGCTGGGTGCAGTGGCTCACGCCTGCACTTTGGGAGGCCAAGGCAGGTGGATCACCTGAGGTCAAGAGTTTGAGACCAGCCTGGTCAACATGGTGAAACCCCATCTCTACTAAAAATACAAAAATTAGCCAGGCATGGTGGCACGTGCCTGTAATCTCAGCTACTCTGGAGGGTGAAGCAAAAGAATCACTTGAACCCAGGAGGCAGAGGTTGCAGTGAGCCAAAATCATGCCACTGCACTCTGGCCTGGGCAACAGAGTGAGACTCCATGTCAAAAAAAAAAAAAAAAAAAA"
"GL873554","5465741","5465829","chr11","47014803","47014890","15","41549062","GGCCAGGCATGGTGGCTCACGCCTGTAGTCCCAGCGCTGTGAGAGGCCGAGGCGGGTGGATCACCTGTGCTTAGAGGTTCGAGACCAGC","GGCCGGGCACCGTGGCTCACGCCTGTAATCCCAGCACTTTGGGAGGCCAAGGCGGGTGGATTACCTGAGGTTAGGAGTTCGAGACTAG"
"GL873555","8807785","8807956","chr1","12240468","12240612","48","3432683","GGCCGGGCGTGGTGGCGCACGCCTGTAGTCCCAGCGCTATGGGAGGCCGAGGCGGGTGGATCACCTGAGCTCAGAGGTTCGAGACCAGCCAAGACCCCCCTGAGCCAAACGAGCCAGAGTGAGACCCCGTCTCTACAACAACAACAGGACAACAAAACAGCCGGACCTTGTG","GGCCGGGCGCGGTGGCTCATGCCTGTAATCCCAGCACTTTGGGAGGCTGAGGCGGGTGGATCACCTGCGGTCAGGAGTTCGAGACCAGCCTGGCCAACGTGGTGAAACCTCATCTCTACTAAAAATATAAAAATTAGCTGGTGTG"
"GL873555","8828420","8828440","chr3","5439989","5440005","4","3388431","ATAATAATAATAATAAATTAG","ATAATAATAAAATAAAA"
"GL873555","12399534","12399604","chr15","102111398","102111458","22","89711864","GGCCAGGCATGGTGGCTCACACCTATAATCCTGGGAGGCTGAGGATTATCTGAGCTCAGGGATGTGAGACC","GGCCAGGCACGGTGGCTAAGGCCTGTAATCTGGGAGGCTGAGATGGGTGGATCACCTGAGG"
"GL873555","12440877","12440963","chr19","21209507","21209590","24","8768630","GTGGGGAGTGCACCTGAACTTTGGAGTTCAAGACCAGCCTGGGCAACATTGTGTGAGCCCTGTCTCAATTGGAAAACAAAACAAAAA","AGGTGGGCAGATCACCTAAGGTCAGGAGTTCAAGACCAGACTGGCAAAAATGGTGAAACCCTGTCTCTACTAAAAATAAAAAAA"
"GL873555","13094462","13094529","chr1","100916857","100916922","22","87822395","GCTTGTACCTATAATCCTGGTACTTTGGGAGCCTCAGGAGAGTGGATCACCTGAGTAAGAGCAAGACC","CATGCCTGTAATCCCAGCACCTTGGGAGGCCAAGGTGGGTGGATCACCTGAGGTCAGTAGTTTGAG"
"GL873555","13254579","13254784","chr7","32729330","32729532","64","19474751","GACCAATCTAAGCCAGAGCTGTCTATGCTAAAAATAGAATAATAAGCCTGGTTTATGGTAGGAGCCTGTAGTCTCAGTTACCTGGGTGTCTGGGGCAAGAGATTGACTTAAAACCAGGAGTTTGAGGTTGCTGTAAGCTAGGCTGACACCACAATACTCTAATCTGGGCAGAGTGAGATTCTGTCTCAAAAAAAAAAAGAAAGAAA","GAAACCCCATCTCTACTAAAAATACAAAATTAGCCAGGCATGGTGGTGCACACCTGTAGCTCCAACTACTTGGGAGGCTGAGGCAGGAGAATCACTTAAACCCAGGCAGTAGAGGTTGCAGTAAGCCAAGATCGCACCACTGCACTCCAGTCTGGGCAACAGAGTGAGACTCTGTCTCAAAAAAAAAAAAAAAAAAAAAAAAA"
"GL873555","13255065","13255153","chr10","29045352","29045442","23","15790287","CTGGGCACAGTGGCTGAGGGTGTAATCCTACCACCCTAGGAGGTTGAGGCAGAAGGATCACTTGAGCTCAGGAATTCAATACAAGTCTA","GGCGGGGCACAGTGGCTCATGCCTGTAATCCTAGTACTTTGGGAGGTCGAGGCGGATGGATCATCTGAGGTCAGGAGTTTAAGACCAGTCT"
"GL873555","13262783","13262918","chr1","29437872","29437991","30","16175089","GGCCGGGCGTGGTGGCGCACGCCTGTAGTCCCAGCACTATGGGAGGCTGAGGCGGGTGGATCACCTGTGCTCAGAGGTTCGAGACCAGCCAAGACCCCCCTGAGCCAAACGAGCCAGAGTGAGACCCCGTCTCTAC","GGCCGGGCGTGGTGGCTCACGCCTGTAATCCCAACATTTTGGGAGGCCAAGGCGGGTGGATCACCTGAGGTCAGAAGTTCGAGACCAACCTGGCCAACATGGTGAAACCCCTGTCTCTAC"
"GL873556","639117","639366","chr1","62410822","62411038","72","61771705","GGCCGGGTGTGGTGGCTCATGCCTGTTGTCCCAGCACTGTGGGAGGCCAAGGCAGGTGGATCGCCTGAGCTCAGCCAAGTTCGAGACCAGCGGAAGACCAGCATGAGGCACAGTGAGCCAGAGTGAGACCCTACCTCTACAAAACAACAACAACAACAAAAAACCCAGCCAGATGTTGTGGCAAGTGTCTGTAATCCCAGCTACATGAGGGGCAAGAGGGCAAGAGAATCACTAAAGGAGGAAGAAGTAA","GGCCGGGCGTGGTGGCTCACACCTGTAATCCCAGCACTTTGGGAGGCCAAGGTGGGTGGATCTCCTGAGGTCAGGAGTTCGAGAGCAGCCTGGCCAACATGGTGAAACCCTGTCTCTACTAAAATACAAAAATTAGCCAGGTGTGGTGGCACGTGCCTGTAATCCCACCTACTCAGGAAGCTGAGGCAGGAGAATCACTTAAAGCTGGGAGAGAGAG"
"GL873556","639390","639468","chr20","16893610","16893664","30","16254220","ACTTCAAACTAAGATAAAGTGAAAGTCAGCAGAAATTGAAAGCAAAAACAAAAACAAAAAAAAAAAAAAAAAAAAAAGA","AACAAAACAAAACAAAACAAAACAAAACAGACAAAAAAAAAAAAACAAAGAAAAA"
"GL873556","2031445","2031493","chr13","87950184","87950229","13","85918739","AGACCCTATCTCTACTAAAAATAGAAAAACTAGCCCAGTATAGTGATGC","AAACCCCATCTCTAGTAAAAATACAAAATTAGCTGGGTGTGGTGGC"
"GL873556","6655305","6655664","chr2","190010230","190010561","107","183354925","GGCCAGGCATGGTGGCTCACACCTGTAATCCTAGCACTCTGGAAGGCCAAGGGAGGTGAATTTCTTGAAGTTCGAGATCAGCCTAAGAGGAATGATACCCCACCTTTACTAGGAATAAAAAAAAAAAAAAAAAAAAACCCAAAACTAGCCTGGCATTGTGGCAGTTCTCTGTAATCCAAGCTACTTGGGAGGCTGAGGTAGAAGGATTGCTTGAACCAAAGAGTTTGACTAGAGGTTGCTGTGAGCTAGGCTAATGTCACCACACTCTATCCAGGGCAAGTGAGTGAAACTCCGTCTCAAAATAAATAAATAAATAAATAAATAAGTAAGAAAAACTTTTGCCCATAAAAAAAAAAAGAA","GGCCGGGCGCGGTGGCTCACACCTGTAATTCTAGCACTTTGGAAGGCTGAGGTGGGTGAATTGTCTGAGCTCAGAAGTTCGAGACCAGCCTGGGCAACACAGTGAAACCCCATCTCTACTAAAATACAAAAAAAAAAAAAAATTAGCTGGGCATGGTGGTGTGCACCTGTAGTCCCAGCTACTCAGGAGGCTGAGGCAGGAGAATTGCTTGAACCCAGGAGGCAGAGGTTGCAGTGAGCTGAGATCACGCCACTACACTCCAGCCTGGGCAACAGAGTGAGACTCCACCTCTTTAAAAAAAAAAAAAAGAAAGAAAGAAAGAAAGAAAGAAA"
"GL873556","10802692","10802792","chr20","28544296","28544376","36","17741604","TACAAAGAAATATCATTATTGGCCAGGTGCAGTGGTTCACATCTGTAATTCTAGTACACTAGTACTCAGGAGGATCACTTGAGGTCAGGAGCTTGTGACCA","TAGAAATGCACAATTCACCTGGGCACGGTGGCTCACTCCTGTAATTCCAGTACTTTGGGAGGCATGAGGTCAGGAGTTCAA"
"GL873557","1682363","1682659","chr6","13352322","13352625","72","11669959","GGCCAGGTGTCGTGGCTCAGGCCTGTAATCCCAGCATTCTGGGAGGCTGAGGTGGGTGGATTGCCCTGAGGTCACAGGTTCCAGACCAGCCTGAGCAAGAGCGAGACTCCATTTCTAATAAAATAGCCGGGTGTTGTGGTAGGTGCCTGTAGTCCCAGTTACTCGGGAGGCTGAGACAAGAGAATCATTTGAACCCAGGAATTTGAGGTTGCTGTGAGCTGTGATGCCACAGGACTCTACTGAGGGCAATAAAGTGAGACTGTCTCAAATAAACAAACAAACAAACAAAAACAAAAA","GGCCAGGTGTGGTGGCTCAGGCCTGTAATCCCAGCACTTTGGGAGACTGAGGTGGGCGGATCACCTGAAGTAAGGAGTTCAAGACCAGCCTGGCCTACATAGTGAAACCCCATCTCTACTAAAAATACAAAATTAGCTGGGTGTGGTGGCACGTGCCTGTAGTCCCAGCTATTCGGGAGGCTGAGTCAGGAGAATCACTTGAACCCAGGATGGGGAGGTTGCAGTGAGCCGAGATCACACCACTGCACTCCAGCCTTGGCAACAGATTGAGACTCTTTCTCAAAAAAAAAAAAAAAAAAAAAAA"
"GL873557","2465751","2465841","chr16","4764895","4764982","15","2299144","GGCCGGGCTTGGTGGTTCACGTCTGTTGTCCCAGCACTGTGGGAGGCCGAGGCAGGTGGATCACCTAAGCTCAGCCAAGTTCGAGACTAGC","GGTCGGGTGTGGTGGGTCACGACTGTAATCCCAGCACTTTGGGAGGCCGAGGCAGATGGATCACCTGAGGTCAGAAGTTCGAGACCAG"
"GL873557","4047834","4047915","chr12","77852792","77852880","22","73804958","ACAAGAGGTTGCTTTGAACTGTGATGCCACAGAGCACTATCCTGGGCAACAGAGACTCTGTCTCAAAAAAAAAAAAAAAAAA","CAGAGGTTGCAGTGAGCTGAGACTGTGCCACTGCACTCCAGCCTGCGCGACAAGAGTGAGACTCTGTCTCAAAAAAAAAAAAAAAAAAA"
"GL873557","4048202","4048390","chrX","23681445","23681631","42","19633243","GGCTGGGTGTGGTGGCTCACACCTGTGATTCTAGCACTCTGGGAGGCCAACGTGGGCAGATCACCTGAGCTTAGGAGTTCAAGACCAGTGTGAGCAAAATGAGACCCCGCCTCTACTAAAAATAGAAAAACTAGCCAGGCACTGTGGTGGGTGCCTATCATCCCAGCTACTCAGGAGGCAGGCAAGAGG","GGCCAGGCGTGGTGGCTCACGCCTGTAATCCCAGCACTTTGGGAGGCCGAGGTGGGTGGATCACCTGAGGTCAGGAGTTCAAGACCAGCCTGGCCAACATGGTGAAACCCCGTCTCTACTAAAAATATAAAAATTAGCCAGGGTGTGGTAGTGCCTGCCTGTAATCCCAGCTACTCGGGAGGCTGAG"
"GL873557","6292327","6292620","chr19","32265157","32265444","82","25972830","GTCAGGCACGGTGGCTCATGCTTGTTGGATTATCCCAACACTCTGGGAGGCCAAGGTGGATCGATTGTCTGAGCTCTGGAGTTCAAGACCAGCCTGAGCAGAAGCAAGACTCCATCTCTAAAAAAAAATAGCTGGGCATTGTGGTGGGCACTTGTATTCCTAGCTACTTGGAAAGCCTGAGGCAAGAGGATTGCTTGAACCCAAGAGTTTGAGGTTGCTGTGAGCTTAAGATGTCACAGCACTCTATAGAGGCTGAGCAAGTGAGACTCCAAAAAGTGAGTTTCCAGAAAAAAA","GACTAGGCACTGTGGCTCATGCCTGTAATCCCAGCACTTTGGGAGGCCGAGGCGGGTAGATCACCTGAGCTCAGGAGTTTCAGACCAGCCTGAGCAACATGGCAAAACCCCATCTCTACTAAACATTAGCCAGGCATGGTGGTGTGCACCTGTAATCCCAGCTACTTGGAAGGTTGAGGCAGGAGGATCACTTGAACCTCAGGAGGCAGAGGTTGCAGTGAGCCAAGATGACATGACTGCACTCCAATCTGGGTGGCAGAGCAAGACTCTGTCTCAAAAAAAAAAAAA"
"GL873557","6324546","6324617","chr1","39656281","39656348","22","33331735","CGCCTGTTGTCCCAGCACTGTGGGAGTGTGAGTAGGGTGGATCACCTTAGCTCAGCTGAGTTTGAGACCAGC","CATGCCTGTAATCCCAGCACTTTGGGAGGTCAAGGCTGGCAAATCACCTAAGGTCAAGAGTTTGAGAC"
"GL873557","6406262","6406343","chr1","199505332","199505412","11","193099070","CAGGCGCAGTGGCTCAATCCTATAATCCCAGCACTTTGGGAGGCTGAGGCAGGTGGATTACCTGAGCTCAGGAGTTTGAGAC","CCAGGCGCAGTGGCTCACACCTGTAATCCCAGCACTTTGGGAGGCTGAGGCAGGCAGATCACCTGAGGTCAGGAGTTGGAG"
"GL873557","6417612","6417692","chr13","102319052","102319128","16","95901440","GAGGTTGCTGTGAGCTAGACTGAGGCCACAGCACTCTAGCCTGGGCAACAGAGTGAGACTGTCTCAAAAGAAAAAAAGAAA","GAGGTTGCAGTGAGCTGAGATCACACCACTGCACTCCAGCCTAGGCAACAAAGTGAGACTCCAACTGAAAAAAAAAA"
"GL873557","6903406","6903510","chr16","18967946","18968045","32","12064540","AGTGCTCTGGGAGACTGAGATGGGCAAATATCTTGAGTTTAGGAGTTCCAGACCAGCCTAAGGAAGAACAAGACCCTATCTCTACTAAAAATAGAAAAAAATTCA","CTTTGGGAGTCTGAGGCAGGTGGATCTCCTGAGGTCAGGAGTTCAGGACCAGCCTGGCCAACATGGCAAAACCCCATCTCTACTAAAAATATAAAAATTA"
"GL873557","6903779","6903930","chr3","40638454","40638604","35","33734675","TTTGCCAGGTATTGTGGTGGACACCTGTAGTCCCAGCTGCTTGGTAGGCTGAGGCAGGAGGATCACTTGACCCTAGGAATCTGATGTTGCTGTGAGCTAGGCTGATGCTACAGCACTCTAGCCTGGACAACAGAGTAAGCTTCTGTCTCAAA","TAGCTGGGTGTCATGGCACACGCCTGTAGTCCCAGCTACTTGGGAGGCTGAGGCAGGAGAATCTCTTGAACCTGGGAGGCAGAGGTTGCAGTGAGCTGAGATCACGCCACTGCACTCCAGCCTGGGCAACAGAGTGAGACTCCGTCTCAAA"
"GL873557","8133022","8133316","chr19","42881134","42881434","76","34748112","GAGTGCAGTGGCTCACACCTGTAATCTTAGCACTCGAGAGGCTGAGGCAGGTGGATTGCCTGAACTCACAGCTTCGAGACCAGCCTGAGCCAGAGCAAGACCTCATCTCTAAAAATAGCCAGGAGTTGTGGCAGGCGCCTGTAGTCCCAGCTACTTGGGAGGCTGAGCAAGAGAATCGCTTGATCTCAGGAGTTTGAGGTTTCTGTGAGCTAAGACACCGCAGCACTCTACCAAGGGTGACAAAGTAAGACTCTGTCTCAAAAAATAAATAAATAAATAAATTATAAGAAAAAGA","CCGGGCAAGGTGGTTCACACCTATAATCCTAGCACTTTGGGAGGTCGAAGTGGATCGCCTGAGGTCAGGAGTTAGAGACCAGCCTGGGCAACATAGCAAAACCCCATCTCTACTAAAAATAGAAAAACTAGCCAGGTGTGGTGGCGCCTGTAATCCCAGCTACTCGGGAGGCTGAGGCAGAAGAATCGCTTGAACCCAGGAGGCAGAGGTTGCAGTGAGCTGAGATCGCACCACTGCACTCCAGGGTGACAGAGCAAGACTCTGTCTCAAAAAAAAAAAAAAAAAAAAAAAAAAAAAAAAA"
"GL873557","8171663","8171835","chr7","151280672","151280824","61","143109009","TTAGCCAGGCACTGTGCTCCCAGCTACTAGGGAGGCTGAGGCAAGAAGAGGATCACTTGGCTCGGCGCCTGTGACTCAAGTGGCTAAGGTGCCAGCCACATACACCTAAGGTGGAGGGTTCTCTACCCAGAGGGACAGCTTGAGGCTCCATCTCAAACAAAAAAAAAAGAAGA","TGGTATGCACCTGTAATCCCAGCTACTTAGGAGGCTGAGGCATGAGAATCACTTGAACCCAGGAGGTGGAACTTTTAGTGAGCTGAGATTGCACCACTGCATTCCAGCCTGGGCAACAGAATAAGACTCTATCTCAAAAAAAAAAAAAAAAAA"
"GL873557","8172121","8172252","chr11","123260550","123260686","30","115088429","CTGGGCATGGTGGCTCATACCTATAATCCTAGGACTTTGGTAGGCCGAGGCAGGTGGGTTGCTTGAGCTTAGAAGTTGAAGACCAGCCTGAACAACAGCAAGACCTTTCCCTACTCAAAACAGAAAAACTAT","GGCTGGGCAGGGTGGCTCATGCCTATAATCCCAGCACTTTGGGAGGCCAAGGCGGGTGGGTCACCTGAGGTCAGGAGTTCGAGACCAGCCTGACCAACATGGTAAGATCCCCTCTCTACTAAAAATACAAAAATTAA"
"GL873557","8260873","8260977","chr1","62231025","62231129","22","53970152","GGCTGGGCATGGTGGCTCACGCCTGTTGTCCCAGCCCTGTGGGAGGGTGAGGCAGGTGGATCGCCTGAGCTCAGCCGAGTTCGAGACCACTGGAAGACCAGCATG","GGCTGGGCATGGTGGCTCACGCCTATAATCCCAGCACTTTGGGAGGCCGAGGCAGGTGGATCACCTGAGATCAGGAGTTTGAGACCAGACTGGCCAACATGGTGA"
"GL873557","10032878","10033040","chr9","27037847","27038008","36","17004969","GGGGGTGGTGGCTCACACTTGTAATACCAGCTACTCTGGAGGCCGAGGCAGGAGAATCATATGAGCCCGGAAGTCTGAGGTTGTTGTGAGCTGGGTTAATGCCCCTGCACTCTAGCCTGGGCAACAGAGTGAGACCATGTCTCAAGGAAATAAAAAAAAAAAA","TTAGCTGGGCATGCTGGCACACACCTGTAATGCCAGCTACTCAGGAGGCTGAGGCAGGAGAATCACTTGAGCCCGGGAGGTGGAGGTTGCAGTGAGCTGAGACAGTGCCACTGTATTCTACCCTGGGCAACAGAGTGAGACTGTCTCAAAAAAAAAAAAAAA"
"GL873557","10366578","10366655","chr17","24597444","24597521","20","14230866","GCCAGGCGTGGTGGCTCATGACGGTAATCCCACCTACTCAGGAAGCAGAGGCAGGAGAATCACTTGCGCCTAGGAGAC","GGCCAGGCATGGTGGCTCATGCCTGTAATTCCAGCACTTTGGGAGGCCGAGGCAGGTGGATCACTACGTCAGGAGTTC"
"GL873557","12031816","12031985","chr11","55022806","55022982","46","42990990","TAGAAAAACTAGCCAGGCATTGTAGCGGGTGCCTATAGTTTCAGCTACTCTGGAGACTGAGACAAGATTGCTTGAGCCCGGGAATTTGAGGTTGCTGTGAGCTATTATGCCACAGCACTCAATACAGGACAATTGAGTGAAACTCCAGTCTCAAAAAAAAAAAAAAAAAA","CAAAAATTAGCCAGGCAGGGTGGTGGGCGCCTGTAGTCTCAGCTACTGGGAAGGCTGAGACAGGATAATCACTTGAACCCGGGAGGCGGATGTTGCAGTGAGCCGAGATCATGCCACTGCACTTCAGCCCGGGCAACGAGAGTGAAACTCCGTCTCAAAAAACAAAATAAAATAAAA"
"GL873557","12032023","12032144","chr1","111354387","111354508","23","99322364","GGTCAGGTGCAGTGGCTCACATCTGGAATCCTAGCACTCTGGGAGGCCGAGGAGAATGGATCCCCTGAGCTCAGGAATTCAATATCAGCCTGAACAAGTGTGAAACCTCCATCTCTACTTAA","GGCCGGGCGTAGTGGCTCACACCTGTAATCCCAGCACTTTGGGAGGCCGAGGCGGATGGATCACCTGAGTTCAGGAGTTTGAGACCAGCCTGACCAAAGTGGTGAAACCCCGTCTCTACTAA"
"GL873557","14208944","14209036","chr7","158031905","158031997","26","143822961","GGATGTGGTAGTTACTGTTTGCTATGATGACAACACTGCACTCTAACTCTGGGTGACACAGTAAGATTCTATCTCAAAACCAAAATAAAACAA","CCAGGAGGTGGAGGTTGCAATGAGCCAAGATCACACCACTGCACTCCAGCCTGGGTGACAGGGTGAGATTCTGTCTCAAAAAAAAAAAAAAAA"
"GL873558","2159034","2159070","chrX","41233833","41233871","7","39074799","ATTAGCCAGGTGTGGTGGCTTTTGCCTGTAATCCCAG","AAATCAGCCGGGTGTGGTGGCTCACGCCTGTAATCCCAG"
"GL873558","3486850","3487074","chr5","91338665","91338874","72","87851815","GGCCAGGCATGGTGGCTCATGCCTGTTGTCCCAGTGCTGTGGGAGGCCGAGGCAGGTGGATCGCCTGAGTTCAGCCAAGTTTGAGACCAGTGGAAGACCAGCATGAGGCAGAGTGAGCCAGAGTAAGACCCCATCTCTACAACAACAAAAAAAAAAAACAAAAAAAACAGCCGGACGTTGTGATCCCAGCTACATGGTGAGGGGGAGGGGAACAGGAGAATCACT","GGCCGGGCATGATGGCTCATGCCTGTAATCCCAGCACTTTGTGAGGCCGAGGCAGACTGATCACTTGAGGCCAGGAGTTCGAGACCAGCATAGCCAACAAGATGAAACACCATCTTTACTGAAAATACAAAAAAAAAAAAAAATAGCCGGATGTGGTGATACCTGCTTGTAATCCCAGCTGCTTGGGAGGCTGAGGCAGGAGAATCTCTT"
"GL873558","3884156","3884240","chr4","24638016","24638099","18","20753860","CCAGACACAGTGGCTTAAGCCTGTAATCCTAGCACTTTGGGAGGCTAAGGTGGATGGATCTCCTGAGCTCAGTAGTTTGAAGCTA","GCCAGGCATGGTGGCTCATGCCTGTAATCTTAGCACTTTGGGAGGCCAAGGTGGGCGGATCATCTGAGGTCAGGAGTTTGAGAC"
"GL873558","5037604","5037746","chr3","2138380","2138521","38","2899224","GCTGGGCCTGGTGGCTCACATCTGTAACCCTAACACTCTGGGAGGCCAAGGCAGGAGGATCTCTTGAAGCTAGGTTGTTAGCCAGGGCGACCCCACAGCACTCTAGCCTGGGGCAACAGAGTGAGACTTTGTCTCCAAACAAA","AGCTGGATGTGGTGGCCCACACCTGTAATCACAGCTACTCGATAGGCTAAGGCAGGAGAATCGCTTGAACCTGGGAGGCGGGGACTGCACCATCACAGCACTCCAGCCTGGGTGACAGAGTGAGACTATGTATCAAAAAAAA"
"GL873558","6488648","6488700","chr3","39516725","39516768","23","33028077","ATAGCACTCTACCATGGGTGACAGAGTGAGACTATCTCCCCCCCTCAAAAAAA","GAGACCAGCCTGACCAACACAGTGAAACCTCATCTCTACTAAAA"
"GL873558","6489359","6489583","chr10","19070944","19071172","64","12581585","GGCTGGACATGGTGGGTCCTGTAATCCTAGCACTGTGGGAGGCCGAGGCAGGTGAATTGCTTGAGCTTATGGGTTCAAGACCAACCTGAGCCAGAAGGAGACCTTGTCTCTAAAAATGGCTGGGTGTTGTGGCAGGCACCTATAATCCCAGCTACTTGGGAGGCTGAGGCAAGAGAATCGCTTGAACCCAAGAGTTTGATGTTGCTGTCAGCTAAGATGCCATAG","GGCTGGGCTCAGTGGCTTATGCCTGTAATCCCAGCGCTTTGGGAGGCCAAGGCGGGTGGATCACCTGAGGTCAGGAGTTCGGGACCAGCCTGAACAACATGGTGAAATCCCGCCTCTACTAAAAAAAAGCCGGGTGTGGTGGCATGCACCTGTAATCCCAGCTACTTGGGAGGCTGAGGCAGGAGAATCACATGAACCTGGGAGGCAGAGGTTGCAGTGAGCTGAGATC"
"GL873558","14631848","14632045","chr18","1878493","1878704","62","12753355","GGTGCAGTGGCTCACGCCTTTAATCCCAGCACTTGGGATGGTGAGGCAGGTAGATTGCCTAAGTTCACAGGTTCAAGACCAGCCTGAGCCAGAGAGACCCTACCTCTAAAAAATAGCCAAGCATTGTGGCAGGCACCTGTAATCCTACTTAGGAGGCTGAGTCAAGAGGATCATTTGAGCTTAAGAGTTAGAGCTTGT","GGCCAGGCATGGTGGCTCACGCCTGTAATCCCAGCACTTTGGGAGGCCGAGGCGGGTGGATCACAAGGTCAGGAGTTCAAGACCAGCCTGGCCAACATGGTGGAAGCCCATCTCTACAAAAAATTAACTGGGCGTGGTGGCAGGCACCTGTAATCCCAGCTACTTGGGAGGCTGAGGCAGGGGAATTGCTTGAACCTGGGAGGCGGAGGTTG"
"GL873558","14632352","14632392","chr7","10117723","10117763","10","4514629","GAGTTAGAGCTTGCTGTGAGCTAAGATGCCACGGCACTCTA","GAGTTAGTTGCAGTGAGCTGAGATCGTGCCACTGCACTCCA"
"GL873559","8193331","8193614","chr20","11734223","11734512","71","3540892","CAGGTACGGTGACTTATCCCTGGAATCTTAGAACTGTCTGAGTCCAAGGTGGGAGGATCATTGGAGGTCAGGAATTTGAGACCAGCCTGAGCAAGAGTGAGACCTCTTCTCTACTAAATATAGAAAAATTAGCCAGGGTTTGTGGCAGGTGCTTATAGTCTAAGCTTCTTAGGAGGCTGAGGCAGGAGAATCTCTTGAACCCATGAGTCTGAGGTTGCCCTGAGTTAAGATGACATCACTGCAGTCTCCCCAAAGCAACGGAGTAAGACTCTGTCTCAAAAACA","GGCCAGGCACGGTGGCTCATGCCTCTAATCCCAGCATGTTGGGAGGCCGAGGTGGGCGGATCACATGAGGTCAGGAGTTTGAGACCAGCCTGGCCAACATAGTGAAACCCTGTCTCTACTAAAAATACAAAAATTAGCCAGGTGTGGCAGCACGTGCCTGTAGTCCCAGCTAGTCAGGAGGCTGAGGCAGGAGAATCACTTGAATCCACCAGGCGGAGGCTGCAGTGAGCCAAGATCACACCACTGCATTCCAGCCTGGGCGACAGAGCAAGACTCTGTCTCAGAAAAAA"
"GL873559","8193642","8193657","chrX","1083699","1083714","0","7109943","AAATAAATAAAATAAA","AAATAAATAAAATAAA"
"GL873560","393252","393440","chr11","121440472","121440639","55","121047220","CTGGGCAGGGTGGCACACACCTGTCATCCCAGCATGTTGGGAAGCTGAGGCAGGAGAATTACTTGAGCTCAGATTCCAAGAGGTGAGGATCACTTGAGCCTAGAAGTTGAGGCTGCACTGATGCCCCAACACTCCAGCCTGGGCAACAGAGCAAGGTCCTGTCCCAAAAAGAAAAAAAGAAAAGGAAAA","GCTGGGCGCAGTGTCTCACGCCTGTAATCCCAGCTATTTGGGAGGCTGAGGCAGGAGAATTACTTGAACCTGGGAGGTGGAAGTTGCAGTGAGCCGAGATCCTACCATCGCACTCCAGTCTGGGCAACAAGAGCAAAACTCTGTCTCAAAAAAAAAAAAAAAAAAAAA"
"GL873560","4038833","4039014","chr12","78258009","78258208","56","74219176","GGCTGGGTGCGGTGACTCACACCTGTAATCCCAGCACCTGGAGGCCCAAGGCAGGGTGGATTGTCTGAGCTCACAGGTTCAAGACCAGCCTGAGCCAGAGCGAGACCTAAAAATAGCTAGGCGCTGTGGGAGGCACACGTAGTCCCAGCTACTCAGGAGGCTGAGGCAAGAGAATCACTTGA","GGCTGGGCACGGTGACTCACGCCTGTAATCCCAGCACTTTGGGAGGCCCAGGTGGGTGGATCACCTGAGGTCAGGAGTTCAAGACCAGCCTGGCCAAGATGGTGAAACCCCGTCTCTACTAAAAATACAAAACTTAGCTGGGCATGGTGGCGGGCACCTGTAATCTCAGCTAGTCGGGAGGCTGAGGCAGGAGAATCTCT"
"GL873560","4492531","4492643","chr7","56485655","56485756","37","51993124","AACAGAAAAACTAGCCAGGCATAGTGGTGCATGCCTGTTGTTCCAGCTGCTCTAGAGGCTAAGGCAAGAGGATTGCTCCAGCTCAATAGTTTGAGGTTGCTGTGAGCTTGAGA","TTAGCTGGGCATGGTGGAGCACACCTGTAATTCCAGCTACTCAGGAGGCTGAGGCAAAAGAGTTGCTTGAACCCAGGAGGCAGAGGTTGCAGTGAGCCGAGA"
"GL873560","4492670","4492771","chr8","41603464","41603564","28","37110794","AGCACTCTGGGTGACTGAGGCAGGATTACTTGAGCTCAGGAGTTTATGACCAGCCTGAGCTGGTCCTTGATCAAGACTCCATCTCTACTAAAAAAACAAACA","CACTTTGGGAGGCCGAGGCAGCAGATCACTCGAGGTCAGGAGTTTGAGACCAGCCTGGCTAACATGGCAAAACCCCATCTCTACTAAAAATATAAAAATTA"
"GL873560","8106775","8106882","chr11","111878590","111878685","39","103771815","ACATAAGAATCAGGCCAAGCCTTGTGGCTCCTGTATGTGATTCCAGCACTGGGAGGGCAAGGCAGGAGGATCCCTGACGTCAGGAACTCAAGGCTGCCCAAGTATCAT","GGGCACAGTGGCTCATGCCTGTAATCCCAGCACTTTGGGAGGCCAAGGCGGGTGGATCACCTGAGGTCAGGAGTTCAAGACCAGCCTGACCAACAT"
"GL873560","10872201","10872272","chr7","9971011","9971083","11","901190","GGCTGGGCACAATGGGTCACACTTGTAATCCCAACACTTTGGGAGGCTGAGGTGGGCAGATCACCTGAGCTC","GGCTGGGTGGGGTGGCTCACACATGTAATCTCAGCACTTTGGGAGGCTGAGGTGGGCAGATCACCTGAGGTCA"
"GL873560","11043320","11043410","chr6","111928830","111928919","19","100885510","CAGGCGAAGTGGCTCATGCCTATAATCCTAGCATTCTGGGAGGCTGAGGTGGGAGAATCCCCTGAGGTCAAAAGTTCAAGACCGGCTTGGC","GGCCAGGCTCAGTGGCTCATGCCTGTAATCCCAGCACTTTGGGAGGCCGAGGTGGGTGAATCACCTGAGGTCAGGAGTTCAAGACCTGCC"
"GL873561","5890611","5890936","chr8","76222061","76222392","77","70331450","GGCTGGGCCTGGTGGCTCATGCCTATAATCCTAGCACTCTGGGAGGCAAAGGTTGGTGGATTGCTTAAGCTCAGGAGTTCAAGACCAGCCTGATTAAGAGTGAGATCCCATCTCCACTAAAAATAGAAGGGAAAAAAAAAAAAAAAAAACCTAGTTGGGCTTGGTGGCAGCACTTGTAGTCCCAGCTATTTAGGAGGCTGAGGAAAGAGAATCACTTGAACCCAAGAGTTTGAAGTTGCTCTGAGCTATGATGCCATAGAACTCTACCCAGGGTGACAGAGTAAAACTGGATCTCAAATAAATAAATAAATAAATACATAAATAAA","GGCTGGGCATGGTAGCTCATGGCTGTAATCCTAGCACTTTGGGAGGCCAAGGAAGGTGGATTGCCTGAGCTCAGGAGTTCAAGACCAGCCTGGGCAACACAGTGAAATCCTGTCTCTACTAAAATACAAAAAAGAAAAAAAAAAAAAAAAAAAACAGCTGGGCATGGCAGTGTGCACTTGTAATCCCAGCTACTCAGGAGGCTGAGACAGGAGAATCACTTGAACCCGGGAGGCAGAGGTTGCACTGAGCCGAGATTGTATCACTGCACTCCAGCCTGGGTGACAGAGCGAGACTCTGTCTCAGAAAAAAAAAAAAAAACAAAAAAACAAAA"
"GL873561","10859256","10859475","chr6","100119122","100119352","73","89259866","GGATCACTTGAGCTCAGGAGTCAAGACCAACTTGAGTAAGAGTGAGACCCTGTCTCTACTAAAAATAAAATATATAGCCAGGCATTGTGCTGGGCACCTATATATAAGCTAAAATGGAGTCTTAGCTACCTCCTTGAACTTGAACCCAGGAGTCTGAAGTTGCTTTGAGCTAGGCTGATGCCACTGCACTTTACCCAGGCAACAGAGTGAGAGTATCTAA","GGATCACCTGAGGTCAGGAGTTCAAGACCAGCCTGGCCAACATGGTGAAACCCCGTCTCTACTAAAAATACAAAAACTAGCCAGGCATGGTGGCGCACACCTGTAGTCCCAGCTACTTGGGAGGCTGAGGCAGAAGAATCTCTTGAATCCGGGGGTTGGAGGTTGCAATGAGCTGAGATCATGCCACTGCACTCCAAGCCTGGGTGACAAGAGCGAAACTCCATCTCAAAA"
"GL873561","10859563","10859576","chr4","114457728","114457741","1","103598165","AAAAAAAAATAAAA","CAAAAAAAATAAAA"
"GL873562","12189469","12189706","chr1","31551552","31551790","75","19362083","CAGTGGCTCACGCCGGTAATCCCAGCACCTTGGGAGCTGAGGCAGGCAGATCTCCTGAGGTCACGTGTTTTGAGACCAGCCTGAGCTAGAGTGAGACCCCACCTCTAAAAATAGCCAGTCGCCTGTAATCCCAGCTACTCGGGAGAAACCCAGGAGTCTAAGGTCGCTGTGAGCTGACACCTCAGCACTCTGCTGGGGTAACAAAGTGACACTTTGTCTCAAAAAAATAAATAAATAT","GCAGTGGCTCACGCCTGTAATCCCAGCACTTTGGGAGGCCAAGGCGGGTGGATCACCTGAGGTCAGGAGTTCAAGACCAGCCTGGCCAACATGGTGAAACCTCATCTCTACTAAAAATACAAAACAGGAGAATCGCTTGAACCCGGGAGGTAGAGGTTGCAGTGAGCTGAGATAGTGCCACTGCACTCCAACCTGGGCAACAGAGTGAGACTCCGTCTCAAAAAAATAAAAAATAAAAA"
"GL873562","4526861","4526913","chr13","94764706","94764759","14","90237845","GTGAGACCTTGTCACTACTGAAAATAGAAAAATTAGCTGGGCATGGTTGTAGG","GTGATGAAACCCCATCTCTACTAAAAATACAAAAATTAGCTGGGCTTGATGGTG"
"GL873562","4789223","4789313","chr10","47852509","47852598","25","43063286","GGCCAGGAGAAGTGGCTAACACCTGTAATTCCAGCACTCTAGGAGATGGAGGCAGGGACCAGCCTGAGCTAGAGTGAGTGAGACTCCATCT","GGCCAGGTGCAGTGGCTCACACCTGTAATCCCAGCAACTTTGGGAGGCTGAGGCAGGCAGATCACTTGAGGTCAGGAGTTCGAGATCAGC"
"GL873562","4868605","4868801","chr16","54069750","54069948","44","49201145","GGCCAGGCATGGTGGCTCATGCCTGTAATCCTAGCACTCTGAGAGACCAAGGCTGATGAATCACCTGAACTCAGGAGTTGAGACCAGCAGGAGCAAAAGTGAGATCCCATCTCTACTCAAAAATAGAAAATTAGTTCAGGCAAGGTGGCACATACCTGTAATCCCAGCACCCTGGGAGGCTAAGGTGGGTGGATTGC","GCCCAGCGCAGTGGCTCATGCCTATAATCCCAGCACTTTGGGAGGCCAAGGCGGGTGGATCACCTGAGGTCAGGAGTTCGAGACCAGCCTGCCCAGCATGGTGAAACCCCATCTCTGTTAAAAATATAAAAATTAGACTAGGCGCGGTGGCTCACACCTGTAATCCCAGCACTTTGGGAGACCAAGGTGGGCGGATCAC"
"GL873562","4929184","4929360","chr10","37539693","37539877","47","32610509","GGCCAAGCTCAGTGGCTCTCCCTAGCACTTTGGGAGACCGAGGTGGGTGGATTGCCTGAACTCAGGAGTTCTAGACCAGCCTGATCAAGAGCAAGACCCTACATCTACTAAAAATAGAAAAACTAGCTGGGCATTATAGTACGCACCTGTACTCCCATCTACTCTGGAGGCTGAGGC","GGGTGCAGAGGCTTATGCCTGTAATCCCAGCACTTTGGGAGGCAGAGGTGGGTGGATCACTTGAGGCCAGGAGTTCAAGACCAGCCTGGTCAATGTGGTGAAACCTCGTCTCTACTAAAAATACAAAAATTAGCCGGGCATGGTGGCATGCATCTGTAGTCCCAGCTACTTGGGAGGCTGAGGCA"
"GL873562","5446395","5446678","chr16","63692714","63692996","79","58246319","GGCTGGATGCAGTGGCTCATACCTGTCTGTAATCCTAGCACTCTGGGAGGTCGAGGTGGGTGGATTGCCTAAGTTCACAGGTTCGAGGCCAGCCTAAGCAAGAAGAGCAAGACTCCATCTCTGAAAGTAGCCAGGCATTGTGACAGGCGCCTATAGTCCCAGCTACTTGGGAGGCTGAGGCAAGAGAATTGAGCCCAGGAGTTAGAGGTTGCTGTGAACTAGGACTCCATAGCATTCTACTGAAGGTGACAAAGTGAGATTCTGTCTCAAAAAAAAGACTGATT","GGCTGGCTGCGGTAGCTCACCCCTGTAATCCCAGCACTTTGGGAGGTCAAGGCAGGTGGATTGCCTGAGGCCAGGAGTTCGAGGCCAGCCTGACCAATATGGCAAAACCCTGTATCTACTAAAAACTAGCTGGGCATGGTGGCATACACCTGTAGTCCCAGCTACTTGGGAGGCTGAGGCAGGAGAATTGCTTGAACCTGGAGGCAGAGGTTGCAGTGAGCCAAGGCTGCCCCACTGCACGCCAGCCTGGGTGACAGAGTGACACTCCATCTCAGAAAAAAAA"
"GL873562","8499356","8499477","chrX","91860022","91860139","29","83360666","GGCTGGGTGTGCTGGCTCATGCCTGTAATCCTCGCACTCTGGGAAGCTAAGGCAGGTGGATTGCCTGAGCTTATGAGTTTAAGACTAGCCTGAGCCAGAGCAAGACCTTGTCTCTATTTTTT","GCCGGGTGTGGTGGCTCATGCCAGTAATCCTAGCACCTTGGAAGGCTGAGGCAGGTGGATTGCCTGAGCTCAGGAGCTTCAGACTAGCCTGGGCAACATAGTGAAACCCCATATCTCT"
"GL873562","8499731","8499918","chr7","167658032","167658223","45","159158301","AAGACCTTGTCTCTAAAAATAGCCAGGTGTTGTAGCAGGCACCTGTAGTCCCAGCTACTTGGGAGGCTGAGACAAGAGAATTGCTTGAGCCCAAGAGTTTGAGGTTGCTGTGAGCTGAGATGCCATGGACTCTATCGAGGGCAGTAAAGTGAGACTCCGTCTCAAAAAAAAAAAAAGAAAGAAAAGAA","TACTAAAATACATACAAAAATTAGCCAGGTATGGTGGCAGGCCCCTGTAGTCCCAGCTACTCGGGAGGCTGAGGCAGGAGAACTGCTTGAACCCAGGAGGTGGGGATTGCAGTGAGCTGAGATCGCACCACTGCACTCCAGCCTGAGCGACAGAGTGAGACTCTGTCTCAAAAATAAAAAAAGAAAAAAAAA"
"GL873562","10216295","10216385","chr1","44313085","44313176","34","34096790","TAAAAATACATTGAACCAGATTCAGTGGCTCACACCTGTGCTCCTAGCTACCCAGTGGCTGAGGCTGAAGGATGGCTTGAATCTCAAGTTC","TTACAGATCATTTGGGGCTAGATGTAATGGCTCACACCTGTAAGCCCAGTGCTTTGGGAGGTTGAGGCAGGAAGATGGCTTGAACCTAGGAG"
"GL873562","11812352","11812435","chr19","44513406","44513491","17","32701054","GGCCGGTACGATGGCTCAGGCCTATAATCTTAGAACTCTGGGAGTCCGAGGTGGGTGGACTGCCTGAGCTCACAGTTCGAGACC","GGCCGGACGCGCTGGCTCACGCCTGTAATCCTAGCACTTTGGGAGGCTGAGGGGGGCGGATAGCCTGAGCTCAGAAGTTCGAGACC"
"GL873562","12179920","12180054","chr14","8268315","8268451","18","3911605","GGCCAGGCATGGTGGCTCACACCTATAATCCTAGCACTCTGGGAGGCCAAGGCAGGTGGATCACCTGAGCTCAGGAGTTTAAGACCAGCCTGAGCAAGAGTGACAACCTATCTCTATTAAAAATACAAAAACTAG","GGCCGGGCATAGTGGCTCACACCTATAATCCCAGCACTTTGGGAGGCCAAGGCAGGTGGATCACCTGAGGTCAGGAGTTCGAGACCAGCCTGACCAAGATAGTGAAACCCCGTCCCTACTAAAAATACAAAAATTAA"
"GL873562","14017684","14017885","chr2","94000404","94000565","73","79982720","CAAGCTAGCCTAGGGATGTGGAGGTACCTGTAGTCCCAGTTACTTCATTGGCTGAGGCTTAAACCCTCTTGGATGGTCTCACTCTGTCACCCTGGTAGAGTGTTGTGGCATCATGTGTCACAGGAGGTTGAGGTTGCTGTGAGCTGTGATGCCACAACATTCTACCAGGGTGACAGAGTGAGACTCTGTTTCAAAAACAAAA","AAACTAGCCTGGCGTGGTGGTGTGTGCCTGTAATCCCAGCTACTTGGGAGGCTGAGACAGGAGAATCACTTGAACCTGGGAAGTGGAGGTTGCAGTGAGCTGAGATCATGCCACTGCACTCCAACTTGGGCAACAGAGCGAGACTCTGTTTCAAAAAAAAAA"
"GL873562","14017915","14018042","chr1","161382752","161382881","27","147364837","GGCTGGGCACGGTGGCTCACACTTGTAATTCTAGCACCCTGGGAGGCCAGCGTGGGTGGTTTGCTTGAAGTTAGGAGTTCAAGACCAGCCTGACCAAAGTGAGACCACATCTCGACTAAAAACAAACA","GGCTGGACGCAGTGGCTCATACCTGTAATCCCAGCACTTTGGGAGGCCGAGGTGGGTGGATCACCTGAGGTCAGGAGTTCAAGACCAGTCTGGCCATGGTGAAACCCCATCTCTACTAAAAATACAAAAA"
"GL873563","2645481","2645758","chr1","37954757","37955032","69","35309276","GGCTGGGTGCCATGACTCACGCCTGTCATCCCAGCTCTCTGGGAGGTCACAATGGGAGTATTCCATGAGCTCAGAAGTTTGAGACCAGTCTGAGCAAGAGCAGACTCCATTTCTACTAAATATAGAAAAATTAGCCCAGTATGGTTGTGCACACCTGTAGTCCCAGCTACTTGGGAGCTGAAGCAGGAAAACGGCTTGAGTCCAGGAGTCGGAGGTTGCTGTGAGCTGAGAGCTATAATGATGCCAGTGCACTCTACCCAGGCAACAGAGCAAGACTC","GGCCGGGTATGGTGGCTTACGCCTGTAATCCCAGCACTTTGGGAGGCCAAGGTTGGCAGATCACCTGAGGTCAGGAGTTCGAGACCAGCCTGGCCAATATGGCGAAACCCCGTCTCTACTAAAAATACAAAAATTAGCTGGGCATGGTGGCGCATACCTGTAATCCCAGCTACTCGGGAGGCTGAGGCAGGAGAACTGCTTGAACCCAGGAGGTGGAGGTTGCAGTGAGCCGAGATTGAGCCACTGCACTCCAGCCTAGGTGACAGAGTAAGACTC"
"GL873563","2646059","2646097","chr1","62915138","62915167","12","60269079","CAAACAGAACAAGACTTTGTTTCAAAAAAAAAAAAAAAA","CAAACAAACAAACATCACAAAAAAAGAAAA"
"GL873563","2651001","2651167","chr2","69424628","69424798","38","66773627","GTACAAAAATTAGCCAGATGTCTTGGTGCTTATAGTCAGCAACTCAGGAGGCTGAGGCAGGAGGATCACTTGAACCCCTGGAATTTGAGGTTGCTGTGAGCTAAGTTGATGCCACGGCATTCTAGCCTGGGTGACAGAGTAAGACTCCATCTCAATAAATAAATAAA","AAAAAAATTAGCCAGGCATGGTGGTGCATGCTTGTAATCCCAGCTACTTGGGAGGCTGAGGCAGGAAGATCACTTGAACCTGGGAGGCGGAGGTTGCAGTGAGCCAAGATTGTGCCACTGAACTCCAGCCTGGGTGACAGAGCAAGACTCCATCTCAAAAAAAAAAAAAAA"
"GL873563","2651449","2651584","chr3","121251018","121251153","32","118599569","GGTCCAGTGAGGTGGTTCAGACCTGTAATCCTAGCATTCTGGGAGGCTGAGGTGAGCAGATTGCTTGAGCTCAGTGAGTTTGAGACCAGCCTGAATAAAAGCAGCACCCCATCTCTACCAAAAGTAGGAAAATTAT","GGCCAGGTGCAATGGCTCACACCTGTAATCCCAGCACTCTGGGAGGCCGAGGTGGGCAGATCACCTGAGGTCAGGAGTTTGAGATCAGCCTGGCCAACCTGGCAAAACCCCATCTCTAATAAAAATACAAAAATTA"
"GL873563","6898038","6898117","chr6","28153994","28154075","27","21255956","AAAAAACAGAAAAATTAGTTGGGTGTGGTAGTGGGTAGCTACTTGGGAGGCTGGGGCAGGAGAATCACTTGAACCCAGGA","AAAATTAGCCGGGTGTGGTGATGCATGCCTCTAATCCCAGCTACTTGGAAGGCTGAGGCAGGAGAATCACTTGAAGGCAGGA"
"GL873563","6898395","6898520","chr5","140939246","140939381","30","134040851","GGGGGTGGTGGCTCATGCCTGTAATCCCAGCACTCTGGCTGAGACAAGTGGATTGCATGAGCTCAGGAGTTCAAGACCAGCTTGAGGAAGAACAAGACTCCATCTCTACTAAAAATAGAAAAATTT","GGCCCGGTGCTGTGGCTCATGCCTGTAATCCCAGCACTTTGGAAGGCTGAGGCAGGTGGATCCCTTGAGGTCAGGAGTTCGAGACCAGCATGGCCAACATGGCAAAATCCCATCTCTACTAAAAATACAAAAATTA"
"GL873563","7811395","7811530","chr1","29437872","29437991","31","21626477","GGCCGGGCGTGGTGGCTCATGCCTGTAGTCCCTGCACTGTGGGAGGCCGAGGCGGGTGGATCACCTGTGCTCAGAGGTTCGAGACCAGCTAAGACCCCCCTGAGCCAAATGAGCCAGAGTGAGACCCCGTCTCTAC","GGCCGGGCGTGGTGGCTCACGCCTGTAATCCCAACATTTTGGGAGGCCAAGGCGGGTGGATCACCTGAGGTCAGAAGTTCGAGACCAACCTGGCCAACATGGTGAAACCCCTGTCTCTAC"
"GL873563","7855904","7856041","chr3","37342340","37342469","34","29486436","GCCAGGGCAGTGGTTCACACCTGTAAAAACCCCAGTATTTTGAGAAGCCAAGTTGGGAGGATCACATAAGGTCAAGAGTTTGAGACCAGCCTGGACAACACAGTATAAGACTCCCATCTCTATTTTGTTAAATATACA","GCCGAGCGCGTGGCTCACGCCTGTAACCCCAGCACTTTGGGAGGCCAAGGTGGGTGGATCACTTGAGGTCAGGAGTAGGAGACCAGCCTGGCCAACATGGGTGAAACCCCACCTATAGTTTAAAAATATA"
"GL873563","8381194","8381392","chr2","167568017","167568216","65","159186823","GGCCAGTGCAGTAGCCCACACCTGTAATCCTAGCACTCTGGGAGGCCAACTCTGGTAGAGTTTGAAACTAGCCTGAGCAAGAGCGAGACCTTGTCTTCACTGAAAAAAATAGAAAAAAAAAAAAAAAACTAACTGGGCATGGTGCTGTACATCTGTAGCCCGAGCTACTCAGGAGTCTGAGGCAAGAGGATTACTCAAT","GCCAGGCGAGGTGGCTCATGCCTGTAATCCCAGCACTTTGGGAGGCCAAAGTGGACAGATTACCTGAGGCCAGGAGTTTGAGACCAGCCTGACCAATATGGTGAAACCCCATCTGTACTAAAAATACAAAAATTAGCAGGGCGTGGTGGTGTACACCTGTAATCCCAGCTACTCAGGAGGCTGAGGCAGGAGAATCTCTT"
"GL873563","8381923","8382014","chr2","92370724","92370803","33","83988801","GGATTGCTCAAGCCCAAGAGTTTGAGGTTGCTGAGAGCTATGACACTACAGCACTCTACTCTACCCAGGGCAACAGAGTGAGACAAAAAAAA","TTGCTTGAACCCAGGAGCTAGAGGTTGCAGTGAGCTGAGATTGCACTATTGCACTCCAGCCTGGGCAACAGGGTGAGACT"
"GL873563","9500422","9500552","chr19","10830410","10830544","33","1329988","GGTCAGGTGCAGTGGTCACCTGTCATCCTACCCCTCTGGGAGGCCAAGGTGGGTGGATTGCCTGAGTTCAGGAGTCTGAGACGAACCTGAGCTAGAGCAAGACCTCATCTCTTAAAAAATAGCCAGCATTC","GGCCAGGTGCAGTGGCTCATGCCTGTAATCCCAGCACTTTGGGAGGCCAAGGTGGGTGGATCACCTGAGGTCAGGAGTTCGAGACCAGCCTGATCAACGTGGTGAAACCCCATCTCTACTAAAATTGCAAAATTA"
"GL873563","9501087","9501192","chr16","71049107","71049211","33","61548020","TAAAACCTATAATGTTTGAAAATAAAAATAGCCAGGCCTTGTTGTGGGTGCCTGTAGTCCCAGCTACTTAGGAGGCTGAGGTAAGAGGATTGCTTGAGCCCAAGAG","TGAAACCCCATCTCTACTAAAAATACAAAATTAGCCAGGTGTGGTGGTGCATGCCTATAATCCCAGTTACTTGGGAGACTGAGGCAGGAGAATCACTTGAACCTG"
"GL873563","10991062","10991128","chr1","22619342","22619410","11","11628280","GGCCGGTGTAGTGGCTCACGCCTGTAATCCCAGCACTTTGGGTGCCGACATGGGCAGATCGCCTGAG","GGCCGGGCGCGGTGGCTCACACCTGTAATCCCAGCACTTTGGGAGGCCGAGGTGGGCGGATCACCTGAG"
"GL873563","12252577","12252738","chr8","144193624","144193784","41","131941047","GGCTGGGTACAGTGGCTCATATCTGTAATCCTAGCACTCCAGGAGGCTGAGGTGGGAGGATAATTGCCTGAAGTCAGAAACACAAGACCAGCCCAAACAAGAGTGAGACACCATCTCTACTAAAAATAGAAAACTGAGCTGGGTGTGGCGGTGCACACCTGT","GGCCGGGCATGGTGGCTCATGCCTATAATCCTAGCACTTTGGGAGGCCGAGGTGGGCGAATCACCTGAGGTCAGGAGTTTGAGACCAGCCTGGCCAACATGGTGAAACCCCATCTCTACTAAAAATACAAAAATTAGCTGGGTGTGGTGGCACATGCCTAT"
"GL873564","1384131","1384395","chr13","32253035","32253303","64","30868904","GGGGGGGGGGGCACACTGGCCTGTAATTCTAGCACTCTGAGAGGCCAAGGCAGGTGGATCACCTGAACTCAGGAGTTCGAGACCAGCCTGATCAAGAGTGAAACCCTGTCTCTACTAACAAGAGAAAAACCAGTAGTCCCAGCTACTCAGGAGGCTGAGGCAGAAGAATCACTTGAACCCAGGAGTTTGAGGTTTCTGTGAGCTACAGTAGTGCTATGGCACTCTACCAAGAGTGACAGAGTGAAACTCTGTCTCAAAAAAAAAA","GCTGGGCATGGTGGCTCATGCCTGTAATCCCAGCACTTTGGGAGGCTGAGGCGGGTGGATCATCTGAGGTCAGGAGTTCAAGACTAGCCTGGGCAACATGGTGAAACCCTGTCTCTACTAAAAATACAAAATTACAGGTAATCCCAGCTACTTGGGAGGCTGAGGCAGGAGAATCGGTTGAACCCAGGAGGCGGAGGTTGCAGTGAGCTGAGATCATGCCACTGCACTCCAGCCTGGGCAATAGAATGAGACTCTGTCTGAAAAAAAAA"
"GL873564","2543879","2544121","chr1","199402350","199402570","73","196858471","GGCCAGGTGTGGTGGCTTACGCCTGTTGTCCCAGCGCTGTGGGAGGCCGAGGCAGGTGGATTGCCTGAGCTTAGCTGAGTTTGAGACCAGCGGAAGACCAGCATGAGGCAGAGTGAGCCAGAGTGAGATCCTGTCTCTACAAAAAAGAAAAAAAAAAAAACAGCCGGATGTTGTGGCGCGCGTCTGTAATCCCAGCTACATGGGGGTCAAGAGGGCAAGAGAATCATACAGGAGGAAGAAGTT","GGCCAGGTGTGGTGGCTCACACCTGTAATCCCAGCACTTTGGGAGTCTGAGGCGGGTGGATTGCCTGAGGTTGAGAGTTTGAGACCAGCCTGGCCAACATGGTGAAACCCTGTCTCTACTAAAAACACAGAAATTAGCCAGGCATGGTGGCGCATGTCTGTAATCCCAGCTACCCTCCTGGAGGCTGAGGCAAGAGAATCACTTGAACCCAGGAAGCAGAG"
"GL873564","4859126","4859236","chr9","15245726","15245837","31","10386600","GTGGCTCATGCTTATAATCCAATCACTATGGGAGACCAAGGTGGGGATGGGCGGAGATCACCCTCAGGAGTTGGAGACCAGCCTGAGTTAAGAGTGATACCATGTCTCTAC","GTGGTGTCTCACGCCTATAATCCCAGCACTCTGGGAGGCCAAGGTGGGCAGATCACCTGAGGTCAGGAGTTAAGAGACCAGCCTGGCCAACATGGTGAAACCCTGTCTCTAC"
"GL873564","4859490","4859678","chr8","126054004","126054184","54","121194514","CATGTCTCTATTAAAGGTAGAAAAATTAGCCGAAGTATTGTAGTTGGGCTGTATAGTCCCAACTACTGAAGAGGCTGAGACAGGAGGATTGCTTACAACTAGGAGTTTGAGGTTGCTGTGAGCTAGGCTGATGCCAAGGTGCTCTAGCCTGGGCAACAGAATGAGACAATGTCTTAAACAACAAAAAAA","GTCTCTACTAAAAATACAAAAATTAGCTGGGTGTGGTGGTGCATGCCTGTAATCCCAGCTACTCAGGAGGCTGAGGCAGGAGAATCGCTTGAACCCAGGAGGTAGAGGTTGCAGTGAGCCAAGATCATGCCACTGCACTCCAGCCTGGGTGACAGAGGGAGACTCTGTCTCAATAAATAAA"
"GL873564","5294014","5294069","chrX","11604904","11604969","20","6310890","GGGTGTGGTGACTTGCACTTACAATCAGCACTTTGGGAGGCGAAGGTAGGAGCATC","GGCTGGGTGCAGTGACTCACGCCTGTAATCCCAGCACTTTGGGAGGCTGAGGTAGGCAGATCACCT"
"GL873564","5294155","5294257","chr15","310129","310227","21","4984026","GGCTGGGTGTGGTGGCTCACGTCTGTTGTCCCAGCGCTATGGGAGGCTGAGGAGGGTGGATCACCTGAGCTCAGAGGTTCGAGACCAGCATAAGACCAGCATG","GGCTGGGCGCAGTGGCTCACGCCTGTAATCCCAGCACTTTGGGAGGCCAAGGCGGGTGGATCACGAGGTCAGGAGTTTGAAACCAGCCTAGCCAGCATG"
"GL873564","6711055","6711262","chr18","1878493","1878704","55","4832562","CTGGGCCCAGTGGCTCACACCTATAATCCTCGCACTCTGGGAGGCTGAGGCGGGTAGATTGTCTGAGCTCACAGGTTCAAGACCAGTGTGACCCAGAGCGAGGCTTTGTCTCTAAAAATAGCAGGGCGTTGTGGCAGGCACCTGTAGTCCCAGCTACTTGGGAGGCTAAGGCAAGAGAATTGCTTAAACCTAAGAGTCTGAGGTTACA","GGCCAGGCATGGTGGCTCACGCCTGTAATCCCAGCACTTTGGGAGGCCGAGGCGGGTGGATCACAAGGTCAGGAGTTCAAGACCAGCCTGGCCAACATGGTGGAAGCCCATCTCTACAAAAAATTAACTGGGCGTGGTGGCAGGCACCTGTAATCCCAGCTACTTGGGAGGCTGAGGCAGGGGAATTGCTTGAACCTGGGAGGCGGAGGTTG"
"GL873564","6711356","6711451","chr7","158031905","158031997","31","151320549","AAAAGAGTCTGAGGTTGCCATGAGCTATCATGCCAAGGCATTCTAGAGAAGGGGTACAAAGTGAGACTCTGTCTCAAAAAAAGAAAACCAAAAAGG","CCAGGAGGTGGAGGTTGCAATGAGCCAAGATCACACCACTGCACTCCAGCCTGGGTGACAGGGTGAGATTCTGTCTCAAAAAAAAAAAAAAAA"
"GL873564","7057009","7057315","chr14","106885133","106885430","87","99828124","GCCGGGTACAATGGCTTGCGCCTATAATCCCAGCACTCTGGGAAGCAGAGGTGGGTGGATCACCTCAGCTCACGAATTCGCTACCAGCCTGTCCTAGAGTGAGACACCCCCCCCACCCCCACCCCCCACAACCTCTAAAAATAGCCTGGAGTTGTGACGGGCACCTGTTGTCCCAGCTACTCTGGAGGCTGAGACAAGAGAATTGCTTGGGCCTCAGAGTCTAAGGTTGATATGAGCTATGACATCACAGCACTCTATCAAAGGTAACAAAGTGAGACTCTAAATAAATAAATAATAAATAAATAAA","GCCGGGCCCGGTGGCTCTTGCCTGTAATCCCAGCACTTTGGGAAGCTGAGGTGGGTGGATCACCTGAGGTCAGGAGTTCGAGACCAGCCTGACCAATATGGTGAAACCCCGTCTCTACTAAAAATATAAAAATTAGCCGGGTGTGGTGGCATGCGACTATAGTCCCAGCTACTCAGGAGGCTGAGGCAGGAGAATTGCTTGAACCCAGGAGGTGGAAGTTGCAATGAGTCGAGGTCACACCACTGCACTCCAGCCTAGGCAACAGAGTGAGACTCCATCTCAAAAAAAAAGAAAAAAA"
"GL873564","7705416","7705474","chr1","51463330","51463380","19","43757914","TCATGCCTGTAGTACCAGCACTTCAGGAGGCTGAAGCAGGAGCTAAGATTAGAAATTTG","CATGCCTTTAATCCCAACTACTTGGGAGGCTGAGGCGAGAATTGAAGTCCG"
"GL873564","8307239","8307551","chr14","30585163","30585473","93","22277924","GCACAGTGGCTCAGGCCTGTAATCTGAGCACTCTGGGAGGTTGAGGCTGAGGTTAGGAGTTAGGAGAACAGCCTGAGCAAGAGTGAGACCCCATCTCTACCAAAAATAGGGGAAAAAACTCCAAAAATCTAGCCACATGTTGTGGTACTTGCCTGCAATCCCAGCTACTGGGGCATAGGGGGACTGAGGCAAGAGGGTCACTTGAGCGTGAGAGATTGAGGTTGCTGTGAGCTAAGATGATGCCATGGCACTCTACCCAAGGTGGCAGAGTGAGCCTATGTCTCACCAATAAATAAACAAATAAATAAATGAA","GGGCACAGTGGCTCACGCCTGGAATCCCAGCACTTTGGGAGGTCAAGGTGGGTGGATCACCTGAGGTCAGGAGTTTGAGACCAGCCTGGCCAAAATGGTGAAACCCCATCTCTACTAAAAAAAATACAAAAAATTAGCCAGAATGTGGTGGTGCATGCCTGTAATCCCAGCTACTGGGGAGGCTGAGGCAGGAGAATCACTTGAACCTGGGAGGCGGAGGCAGCAGTGAGCCAAGATGGCGCCACTGCACTCCAGCCTGAGTGACAGAATGAGACTCTGCCTCAGGAAAAAAAAAAAAAAAAAAGCAAAAA"
"GL873564","8738781","8739084","chr6","92598388","92598711","90","83859607","GCTGGGCACAATGGCTCACACCTGTAATGCCAGCACTTGGGAGGCTAAGACGGGCAAATTGCCTGAGCTCACAAGTTCAAGACCCAGAGCGAGACCTCATCTCTAAAAAATTGCCATGCATTGTGGAGGGTGCCTGTTGTCCCAGCTACTTGGGAGGCGGAGAAAAGACAATCGCTTTAGCCCAAGAATTGAAGGTTGCTGTGAGCTGTGACGCTGTAGCACTCACCAAGGGCAACATAGTGAGACTCTGTTTCAAAATAAATAAATAAATAAATAAAAATAAATAAATAAAATAAAAACAAAA","GGCTGGGCTCAGTGGCTCATGCCTGTAATCCCAGCACTTTGGGAGGCCAAGGCTGGCAGATTGCCTGAGGTCAGGGGTTCAAGACCAGCCTGGCTAACATGGTGAAACCTCATCTCTAATAAAAATACAAAGATTAGCTGGGTTTGGTGGCACATGCCTGTAGTCCCAGCTATTTGGGAGGCTGAGGCAGGAGAATCGCTTGAACCCAGGAGTTGGAGGTTGCAGTGAGCTGAGATGGCACCACTGCACTCCAGCCTGGGTGACACAGCAAGACTCCGTCTCAAAAAAAAAAAAAAAAAAAAAAAAAAGAAAAGAAAAAAAAAA"
"GL873564","9560044","9560238","chrX","30236033","30236239","48","20675989","GGCCAGGTGCGGTGGCTCCTGCCTGTAATCCCAGCACTCTGGGAGGCCTAGGTGGGTGGATTGCCTGAGCTCACTGGTTGGAGACCAGCCTGATACAGATTGAGACCCCCTGCCTCTAAGAATAGCAGGGTGTTGTGACAGACACCTAAAGTCCCAGCTACTCGGGAGGCTGAGGCAAGAGAATCTCTTGAGCCC","GGCTGGGTGCGGTGGCTCACTCCTGTAATCCCAGCACTTTGGGAGGCCAAGGTGGGCGGATCACCTGAGGTCAAAAGTTCGAAACCAGCCTGACCAACAGGGTGAAACCCCGTCTCTACTAAAAGTACAAAAATTAGCCGGGCATGGTGGCAGGCACCTATAATCCCAGCTACTTGGGAGGATGAGGGAGGAGAATCACTTGAACCC"
"GL873564","9560508","9560604","chr1","212121416","212121513","30","202560908","TCGCTGTGCCCAAAAGTTAGAGGTTGCTGTGAGCTATGATACCACTGCACTTTACTGAGGGTGACAAAGTGAGACTCTGTCTCAAAAAATAAATAAA","CTTGAACCTGGGAGGTGGAGGTTGCAGTGAGCCAAGATCATGCCACTGCACTCCAGCCTGGGCAACAGAGCGAGATTCTGTCTCAAAAAAAAAAAAAA"
"GL873564","9753449","9753658","chr19","10370828","10371033","59","617379","TGAGACCCTGGTCTCTTCTAAACATTAAAAAAAAAAAGAAAACTGGGTGTTGTGGCGATGCCCATAGTCCCAGCTACTGATGAGGCTGAGGCAGGGGGATCACTTGAACCCAGGAGTCTGAAGTTGCTGTAAGCTAGGCTGAAGTCACAGTTGTCTAGCCTAGGGCAATAGAGTAAGACTGTCTCACAAAAAAAAAAAAAGGAAAGAAAA","GAAACCCTGTCTCTACTAAAAATACAAAAAATTAGCTGGGTGTGGTGGTGCGTGCCTATAATCCCAGCTACTCAGGAAGCTGAGGTGGGATAATCACTTGAACCTGGGAGGCAGAGGTTGCAGTGAGCCCCAGACTGTGCCACTGCACTCCAGCCTGGGTGACAGAGTCAGACCCTGTCTCAAAAAAAAACAAAACAAAAAAAAAA"
"GL873564","9753896","9754006","chr17","50277667","50277784","33","40523771","GCTGGGCAGGGTGGCTTGTGCCTGTAATCCTCACATTCTTGGAAGCCAAGTTGGTGGATTTCTTGAGCTCAAGAGTTCAGCCTGAACAACGGTGAGACCCCTGTCTCTCTC","CCGGGCATGGTGGCTCATGCCTGTAATCCCAGCACTTTGGGAGGCCAAGGTGGGTGGATCACTTGAGGTCAGGAGTTCAAGACCAGCCTGGCCAACATAGAGAAACTCTGTCTCTACT"
"GL873564","10693118","10693253","chr1","29437872","29437991","31","18744754","GGCCAGGCGTGGTGGCTCACGCCTGTAGTCCCAGCGCTATGGGAGGCCGAGGCGGGTGGATCACCTGTGCTCAGAGGTTCGAGACCAGCCAAGACCTCCCTGAGCCAAATGAGCCAGAGTGAGACCCCGTCTCTAC","GGCCGGGCGTGGTGGCTCACGCCTGTAATCCCAACATTTTGGGAGGCCAAGGCGGGTGGATCACCTGAGGTCAGAAGTTCGAGACCAACCTGGCCAACATGGTGAAACCCCTGTCTCTAC"
"GL873564","11596705","11596819","chr15","17759279","17759407","35","6162574","AATCCGCTACTCGGGAGTCTGATGCAGGAGGATCCCTGGAACCCGGGAGTGAGCTAGGCTGTCCATTCTACCCAAGGCAGAAGAGTGAGATTCTGTCTCAAAAAAAAAAAAAAAA","AATCCCAGTTACTCAAGAGGCTGAGGCAGGAGAATTGCTTGAACCCGGGAGGTGGAGCCGAGACCGCTCCACTGCACTCCAGCCTGGGTGACAGAGTGGGACTCTGTCTAAAAAAAAAAAAAAAAAAAA"
"GL873564","13278770","13278831","chr1","10318851","10318915","18","2959919","GGCTGAGCACAGTGGCTCATGTCTATAATCCCATCACTCTGGAAAGCTAAGAATGAGGATCT","GGCTAGGCATGGTGGCTTATGCCTATAATCCCAGCACTTTGGGAGGCTGAGGCAGACGGATCACC"
"GL873564","13278924","13279152","chr20","69116969","69117193","62","55838045","AAAATAGAGAATAAGAATCCCTTGAGCTCATGAGTTCAAGATCAGTCTGAACAAGTGTCAGACCCTATCTCTACTAAAAATGGAAAAATTAGCCAGGCACTGTGGCAAGTGCCTGTAGTCCCAGATTTCAGGAGGCTGAGGCAGGAGAATCATTTGAATCCAGGAGTTTGAGGTTGCTGTGAGCTAGGCTGACACCACTGTACTGTAGCCTGGGCAACAGAGTGAGACT","GAGGTGGGTGGATCACCTAAGGTCAGGAGTTCAAGACTAGCCTGGCCAACATGGTGAAACTCCATCTCTACTAAAAATACAATAATTAGCTGGGTGTGGTGGCATGTGCCTGTAATTCCAGCTACTCAGGAGGCTGAGGCAGGAGAATCACTTGAACCCAAGAGGCGGAGGTTGCAGTGAGCCGAGACTATGCCACTGCACTCTACCCTGGGCAACAGAGCAAGA"
"GL873565","1417041","1417214","chr4","44130284","44130433","54","42713243","GGCCAGGCGTGGTGGCTCACGCCTGTTGTCCCAGCGATTTGGGAGACTGAGGTGGGTAGATCACCTGTACTCAGAGGTTCGAGACCAGCTGAAGACCAGCCTGAGGCAGAGTGAGACCCCCGTCTCTATAAGAACAAGACAGCCGGACCTTGTGATCCCAGCTACATGGGTGGC","GGCCGGGTGCGGTGGCTCACACCTGTAATCCCAGCACTTTGGGAGGCTGAGGTGGGCAGATAACCTGAGGTCAGGCGTTCGAGACCAGCCTGGCCAACATGGTAAAACCCCGTCTCTACTAAAAATACAAAAATTAGCCAGGTGTGGTGG"
"GL873565","2138367","2138455","chrX","124155143","124155229","17","122016776","GGCTGGGCGTGGTACTCACGCCTGTTGTCCCAGTGCTGTGGGAGGCTGAGGTGGGTGGATCCCCTGAGCTCAGCAGAGTTTGAGACCAG","GGCTGGGTGCGGTGGCTCACGCCTGTAATCCCAGAACTTTGGGAGGCTGAGGTGGGTGGATCACCTGGGGTGAAGAGTTCGAGACCA"
"GL873565","2459722","2459938","chr7","32729330","32729532","57","30269608","AAAAAGACCAAACACCCCAGCTCTACTAAAAGTAGAAAAATTAGCTGGGTATTGTAGTGGGCACCTGTAGTCCCAGCTGCTTGGGAGGTTGCGGCAGGAGAACCACTTAAGCCCAGGAGTTGGAGGGTGAGGTGGGCTGAGGCCACTGCATTCTAGCCTAGGCAACAGAATGAGACTCTGTCTCAAACAAACAAACAAACAAACAAACAAAAAACAA","GAAACCCCATCTCTACTAAAAATACAAAATTAGCCAGGCATGGTGGTGCACACCTGTAGCTCCAACTACTTGGGAGGCTGAGGCAGGAGAATCACTTAAACCCAGGCAGTAGAGGTTGCAGTAAGCCAAGATCGCACCACTGCACTCCAGTCTGGGCAACAGAGTGAGACTCTGTCTCAAAAAAAAAAAAAAAAAAAAAAAAA"
"GL873565","2460219","2460297","chr10","28805224","28805297","28","26345005","CTCAAGCCTGTAATTCTAGCACAGCTGGGAGGCTGAGGCAGGAAGATCTCTCAGCTTAGGATTTCAAGACTAAACACAT","GTGGCTCATGCCTGTAATCTCAGCACTTTGGGAGGCTGAGGCAGGCAGATAACCTGAGGTCAGGAGTTCGAGAC"
"GL873565","11485258","11485580","chrX","66383160","66383473","97","54897902","GGCAGGGCACAGTGGCTCAATCACAGCACTCTGGGAGGAGGCTTAGATGGGTGGATTATTTGAGTTCACAAATTTAAGAACAGCCTGAGCAAGAGTGACACCCTGTCTCTACTAAAAAACAATAGGAAAAATAAAAACTAGCTGGGCATAGTGGCATATGCCTGTGGTTCCAACTACTTGGGAGGCAGAGGCAAGTTTGCTTAGCTAGTTTTTTTTCAGGCCCAAGAGTAGAGGTTGTTGTGAGCTGTGATGCCATAGCACTCTACATAGAGTGACAGAGTGAGACTTTGTCTAAATAAATAAATAAATAAAATTTTAAAAAA","GGCCAGGCACAGTGGCTCACACCTGTAAATCCCAGCACTTTGGGAGGCCGAGATGGGTGGATCACCTGAGGTCACGAGTTTGAGACCAGCCTGGCCAACATGGTGAAACCTCGTCTCTACTAAAAATACAAAAAAAAAAAAAATTAGCTGGGCGTGGTGGTGTGCACCTGTAGTCCCAGCTACTTGGGAGGCTGAGGCAGGAGAATCGCTTGAACCCAGGAGGCAGAGGTTGCAGCGAGCCGAGATCGCGCCACTGCACTCCAGCCTAGGTGACAGAGTGAGACTCTGTCTCAAGGAAAAAAAAAAAAAAAAAA"
"GL873565","13424539","13424574","chr1","174086158","174086184","14","160661619","ACCTAGGGTGAAAGTAAGACTGTCTCAAAAAAAGAA","AAGAGAGAGAAAGAGAGAAAGAAAGAA"
"GL873565","13424654","13424896","chr16","19730961","19731217","54","6306307","GCCAAGCACAGTGGCTCACACCTGTAATCCCAGCACTCTGGGAAGCCTAGGTGGGTGGATTACTTGAGCTCAGGAGTTCAAGATCAGCCTAAGCAAGAGTGAAACTCCCATGTCTAAATAAACAGCCGGGCATTGTAGTGGGTCCCTGTAGTCCCAGCTACTCAGGAGGCTGAGGCAAGAGAATCGCTTGACCCAGGAGTTGGAGGTTGCTGTGAGCTGAGGCCACGGCACTCTATCTAGGGT","GGCCGGGCACAGTGGCTCACGCCTGTAATCCCACCACTTTGGGAGGCCGAGGCGGGTGGATTACCTGAGCTCTGGAGTTAGAGACCAGCCTAGGCAACATGGTGAAACCCCATGTCTACTAAAATACAAAAAGCCGGGCGTGGCGGCGTGTGCCAATAGTCCCAGCTACTCAGGAGGCTGAGGCAGGAGAATTGCTAGAACCCGGGAGGCGGAGGTTGCAGTGAGCTGAGATCACGCCACTGCACTCCAGCCTGGGC"
"GL873565","13679578","13679856","chr1","27657515","27657797","72","13977937","GCAGGGTACAGTGGCTCACACCTGTAATCATAGTAACTCTTAAGCGGCTGAGGCAAGTGAGAGGCCTGAGATCAGGAGTCCAAGAATAGCCTAACCAAAAGTGAGACCCCATCTCTACTAAAAATAGAAAAAAACTAGCCAGGCATGGTGGCACTTACCATAGTCCCACCTCATAAGGCTGAGGCAAGAGTATCACTTGAACCCAGAAGTTTGAAGTTGCTGTCAGCTACAATGACATCATAGCACTTTACCCAGAGCTACAGAGTAAGACTCAGTCTC","GCTGGGTGCGGTGGCTCACACCTGTAATCTCAACACTTTGGGAGGCTGAGATAGGTAGATCACCTGAGGTCAGGAGTTCGAGACCAGCCTGGCCAACATGGTGAAACCCCATCTCTACTAAAAATACAAAAAACCTAGCCAGGCATGGTGGTGTGTACCTATAATCTCAGCTATTCAGAAGACTGAGACAGGAGAATCACTTGAACTTGGGAGGTAGAGGTTGCAGTGAGCCAAGATCACACCACTGCACTCCAGCCTAGGCAACAGAGTGAGACTCCGTCTC"
"GL873566","947388","947684","chr3","178868174","178868466","60","177920786","GGCCGGGTAGGGTGGCTCATGCCTGTAATCCTAGCATTTTGAGAGGCCAAGGCAGGTAGATTACCTGAGCTCAGGAGTTCCAGACCAGGCTGAGCAAGAGCCCCATCTCTATCAAAAATAGAAAAATTAGCTGGGTATGGTGGCACATGCCTNNNNNNNNNNNNNNNNNNNNNNNNNNNNNNNNNNNNNNNNNNNNNNNNNNNNNNNNNNNNNNNNNNNNNNNNNNNNNNNNATGACACCATAGCACTCTAACCTGGAGCAACAGAGTGAGACACCGTCTTAAAAAAAAAAAAAAAA","GGCCGGGTGTGGTGGCTCATGTCTGTAATCCCAACACTTTGGGAGGCCAAGGCGGGTGGATCACCTGAGGTCAGGAGTTTGAGACCAGCCTGGCCAACATAGTGAAACCCCTCTACTAAAAATAAAAAATTAGCCAGGTGTGGTGGCANNNNNNNNNNNNNNNNNNNNNNNNNNNNNNNNNNNNNNNNNNNNNNNNNNNNNNNNNNNNNNNNNNNNNNNNNNNNNNNNNNNNNNNNNNNNNNNCTCCAGGCTGGGCAACAGAGTGAGGCTCCATCTAAAAAAAAAAAAAAAAA"
"GL873566","2530056","2530102","chr1","123145244","123145289","11","120615188","AGGCCAAGGCAGTTGGATCACCTCAGCTCAGGAGTTTGAGACCCGCC","AGGCTGAGGGAGGCGAATCACCTGAGGTCAGGAGTTTGAAACCAGC"
"GL873566","2923434","2923499","chr1","38303497","38303565","19","35380063","GGGCTCAATGGCTCAGCCTGTAATCTTAGCAGTCTGGGAGGCTGAGGCAGGCGCCTGAGCAAGAGT","GCTGGGCGCAGTGTCTCGTGCCTGTAATCCCAGCACTTTGGGAGGCTGAGGCAGGCGGATCATCTGAGG"
"GL873566","3613441","3613522","chr3","54039458","54039545","21","50426017","GGTGGCACATGCCCGTGATCCCAGCACTCTGGGAGGCCGAGGAGATCGGACTGCCTGAGCTCAGGAGTTCGAGACCAGCCTG","GCGCGGTGGCTCACGGCCTGTAATCCTTGCACTTTGGGAGGCTGAGATGGGTGGATTACCTGAGCTCAGGAGTTCGAGACCAGCCTGG"
"GL873566","6100482","6100582","chr2","51286276","51286376","32","45185794","GGCTGGGTGAGTACCTCATGCATCAAGCCCAGTGTTCTGGAGGCTGAGGCAAGGGGATCCTTGATGTGGATAGTTCAAGGCCAGCCTGGCAATTAGCTAGA","GGCTGGGTGCAGTGGCTCACGCCTATAATCCCAGCACTTCGGGAGGCTGAGGCAGGCAGGTCACCTGAGGCCAGGAGTTCAAGACCAGCCTGGCCAACATG"
"GL873566","6245586","6245714","chr3","50507869","50508002","30","44262283","GCTGGGTGTGGTGGCTCACACCTATAATACCAGCACTTGGGAGGCCAAAGCAAGTGGATTGCCTGAGTTCACAAGTTCAAGACCAGCCTGAGCAAGAGTGAGACCCTGTCTCTTAAAAATAGGTGGGCG","GCCAGGTGCGGTGACTCACACCTATAATCCCAGCACTTTGGGAGGCCGAGGCACGTGAATCACCTGAGGTCAGGAGTTCAAGACCAGCCTGACCAACATGGTGAAACCTTGTCTCTACTAAAAATACAAAAACT"
"GL873566","6245992","6246162","chr16","22888303","22888475","37","16642311","TAGCTGGGCGTTGTGGCGGGCATCTGTAATCCCAGCTACCTGGGAGGCTGAGGCAAGAAAATCACTTAAGCCCAAGAGTTTGAGGTTGCTGTGAGCTGTGATGGCACAGTACTCTATTGAGGGCAACATAGTGAGACTCTGTCTCAAAAAATAAATAAATAAATAAATAAA","ATTAGCTGGGCGTGGTGGTGGGCACCTGTAATCCCAGCTTCTTGGGAGGCTGAGGCAGGAGAATCACTTGAGCCCAGGAGGCAGAGGTTGCAGTGAGCAGAGATCGTGCCACTGCACTCCAGCCTGGATGACAGAGTCAGACTTTGTCTCAAAAAAAATAAAAAATAAAAAAA"
"GL873566","6483968","6484033","chr19","10207852","10207913","17","3723884","AAAATATGGTAAAATAAGCCAAGGATGGTGGGTCACACCTGTAATCCCAGCTACTCAAGAGACTGA","TAAAAATACAAAATTAGCTGGGTGTGGTGGCACACACCTGTAATCCCAGCTACTCAAGAGGC"
"GL873566","7043395","7043464","chr10","28805224","28805297","20","21761829","GGCTAGGCCTGGTAATCCCAGCACTCTAAAAGGCTGAGGCAGGTGGATAGCCTGAGCAAGAGTGAGACCA","GTGGCTCATGCCTGTAATCTCAGCACTTTGGGAGGCTGAGGCAGGCAGATAACCTGAGGTCAGGAGTTCGAGAC"
"GL873566","7888407","7888429","chr16","1275850","1275872","4","6612557","CTAAAAATAAAAAATTAGTCTTG","CTAAAAATACAAAAATTAGCCAG"
"GL873566","7888682","7888751","chr13","39203832","39203891","22","31315150","GTAGTCTTGGCGTAGTGATATGTACCTTTAATCCCAGCTACTCAGGAAGTGGAGGAGGAAAGAGTACAAG","TTAGCTGGGCGTAGTGGTGTGTGCCTGTAATCCCAGCTACTTGGGAGGCTGAGGCGGGAG"
"GL873566","8203857","8203949","chr20","18199749","18199840","19","9995892","GGCCCGGCATGGTGGTGCTTTGCCTATAATCCCAGCATTCTGGGAGGCCCAGGCAGGCGGATCACCTGAGCTCACAGGTTCAAGAATGGCCTG","GGCCGGGCATGGTGGCTCACACCTGTAATCCCAGCACTTTGGGAGGCTGAGGCAGGCGGATCACCTGAGGTCAGGAGTTCGAGACCGGCCTG"
"GL873566","8268872","8268975","chr15","10815564","10815667","26","2546692","GTGGCTCATGCCTGTAATCCTAGCACTCTGGGAGGCCGAGGCAGGTGGATTCCCTGAGCTCATAGGTTTGAGACCACAAGCAAGTCCAAGACCCCATCTCTTTT","GTGGTTCATGCCTGTAATCCCAGCACTTTGGGAGGCCGAAGTGGGCGGATCACCTGAGGTCAGGAGTTTGAGACCATCTGGCCAAGATGTAGAAACCCCATCTT"
"GL873566","8269263","8269458","chr15","77706857","77707054","55","69437594","AAGACCCCATCTCTTAAAAAAGAAAAAAAAAGCTGGGTGTTGTGGCCTTCACCTGTAGTCCCAGCTACTGGGGAGGCCAAGGCAAGAGACTTGCTTGAGCCAGAGTTTGAGGTTGCTGTGAGCTATAGTGCCACGGCACTCTACCAAAGGCAACAAAGTGAGACTGTCAAAAAAAAAAAAAAAAGAAGAAGAAGAA","CCCCATCTCTATTAAATATACAAAAAAATAGCTGGGTGTGGTGGTGTGCGCCTGTAATCCCAGCTACTTGGGAGGCTGATGCAGGGGAAGTGCTTGAACCAGGGAGGTGGAGGTTGCAGTGAGCCGGAATCGTGCCACTGCACCCCAGTCTGGGCAACAGATTGAGACTCTGTCTCAAGGAAAAAAAAAAAAAAAAAA"
"GL873566","8592056","8592127","chr10","28805224","28805297","15","20213168","TCTTGCCTGTAATCTCAGCACTCTGGGAGGCTGAGGCAGGCAGATCAACTGAGCTAACAAGTTCGAGACCAG","GTGGCTCATGCCTGTAATCTCAGCACTTTGGGAGGCTGAGGCAGGCAGATAACCTGAGGTCAGGAGTTCGAGAC"
"GL873566","8809109","8809200","chr11","48033118","48033204","26","39224009","ATAGCCAGGCTTGTTGCAGGCACCTGTAGTCCCAGTTACTCTGGAGGCTGAAGCAAGGGAATATCTTGAGCCCAAGAGTCTGAGGTTGCTGT","TTAGCCTGGCATGGTGGTGACACCTGTAATCCCAGCTACTCAGGAGGCTGGGAAGGAAAATCGTTTCAACCCAGGAGGCAGAGTTTG"
"GL873566","8809477","8809608","chr19","10830410","10830544","33","2020933","GGCCAGGCGCAGTGCCTCATGCCTGTAATCCTAGAACTCCGGGAGGCTAAGGAGGGTGGATTTCCTGAGTTCACAGGCTGGAGACCAGCCTGATCTAGAGTGAGATTCCCAGCTCTAAAAATAGCTGGCCTT","GGCCAGGTGCAGTGGCTCATGCCTGTAATCCCAGCACTTTGGGAGGCCAAGGTGGGTGGATCACCTGAGGTCAGGAGTTCGAGACCAGCCTGATCAACGTGGTGAAACCCCATCTCTACTAAAATTGCAAAATTA"
"GL873566","9503716","9503881","chr12","63241189","63241340","56","53737473","TATTAAAAAAAAAAGGAATTCAAGGCCAAGAGCAGTGGCTTTTGCCTGTGATACTTCCACTGTAGGAGGCCGAGGTGGAAGGATCACTTGAACTCTGGAGTTTGAGGTTGCTGTGATCTAGGCTGACACCACAGCACTCTAACTTGGTGGGCAACAGAGCAAGACT","AAAAACAAAAATTAGCCAGGTGTGTTGGCATGCACCTGTAGTCCCAGCTACTAGGGAGGCTGAGACAGAAGAATCACTTGAACCCAGGAGGTGGAGGTTGAGTGAGCCAAGATCGCGCCACTGCACTCCAGCCTGGGTGACAGAGCGAGACT"
"GL873566","9537883","9537992","chr16","43341998","43342113","30","33804115","ATGCCTGTAATCCTAGCACTTGGGAGGCCAAGGTGGGTGGATTGCCTGAGATCACAGGTTCAAGACCAGCCTGAGCCAGAGTGAGACCCTGCCTCTAAAATGAGCCAGGT","GCCTGTACTCCCAGCACTTTGGGAGGCCAAGGCGGGTGCATCACCTGAGGTCAGGGGTTCAAGACCAGCCTGGCCAACATGGTGAAACTCTGTCTCTACTGAAAATTCAAAAAATT"
"GL873566","9538266","9538462","chr7","167658032","167658223","54","158119766","TTAATTAATTAATTAAATAAAATGAGCCAGGTGTTGTGATGGGCGCCTGTAGTCCCAGCTACTTGGGAGGTGGAGGCAGGATAATCACTTGAGTCCAGGAGTTGGAAGTTGTTGTGAGCTGTGACGCCATTGTACTTGACCCAGGGCGACATCTTGAGGCGCTCTCTCTCAAAATAAATAAATAAAGAAAGAAAGAA","TACTAAAATACATACAAAAATTAGCCAGGTATGGTGGCAGGCCCCTGTAGTCCCAGCTACTCGGGAGGCTGAGGCAGGAGAACTGCTTGAACCCAGGAGGTGGGGATTGCAGTGAGCTGAGATCGCACCACTGCACTCCAGCCTGAGCGACAGAGTGAGACTCTGTCTCAAAAATAAAAAAAGAAAAAAAAA"
"GL873566","13663722","13663916","chr1","23558411","23558571","70","9894689","CTCAAGACCAGCCTGAGCCAAGAACGAGACTGAAAATAGAAAAATTAGTGGGACGTTATGTTGAGTGCTGGCTACTCTAGAGGGTGAGGTAGGAGAATTGTTTAAACTCATGAATTTAAGGTTGCTGTGAGCTAGGCTGACGCCACAGCACTGTAGCCTGGGCAACAGGCTACAGAACAGAGTGAGACTCTGTTT","AAAAATACAAAAATTATCTGGGCATGGTGGTGGGTGCCTGTATTCCCAGCTACTCTGGAGGGTGAGGCGGGAGAATTACTTGAACCCAGGAGGTGAAGGTTGCAGTGAGCCAAGATCACGCCACTGCACTCTAGCCTGGGCAACAGAATGAGACTCTGTCT"
"GL873566","13664206","13664293","chr7","151280825","151280914","17","137616619","GGCTAGATATGGTGGCTCATGCCAGTAATCTTAGCACTTTGGGAGGCTGAGGGGAGAGGATCACTTGAGCTGAAAAGTTCAAGACCAA","GGCCAGGCATGGTGGCTCATGCCTGTAATCCCAACACTTTGGGAGGCTGAGGTGGGTGGATCACTTGAGGCCAAGAGTTCAAGACCAGCC"
"GL873567","8375378","8375469","chr3","123612391","123612479","29","115237013","GGTTGGGCTTGGTGGCACGTACCTATGATCATCCTAGCTACTCAGGGAGCATAAGGCAGAAGAATTGCTTTAGCCCGGGAGTTGAGATCAAC","TTAGTTGGGCGTGGTGGCGCATGCCTGTAATCCCAGCTTCTCGGGAGGCTGAGGCAGGAGAATGGCTTGATCCCAGGAGATAGAGGTTG"
"GL873567","9062667","9063009","chr7","6620384","6620702","97","2442283","GGCCAGGCGTGGTGGCTCACGCCTGTTGTCTCAGCGCTGTGGGAGGCCGAGGCGGGTGGATCGCCTGTGCTCAGAGGTTCGAGACCAGCATGAGCCAGAGTGAGAGCCAGAGTAAGACCCCCTCTCTACCAAAAATTGCTGGGTGTTCTGGCAGGTGCCTGTAATTCCAGGTACTTGGGAGGCTGAGGCTAGAGAATCACTTAAACCCAGGGACCCAGGGGTTGGCGGAGGTTGCTGTGAGCTATGATTCTATGGTATTCTACTGAAGGACACAAAGCGAGACTCTGTCTCCATAAATAAATAAATAAATAAATAAAATAAAAGCAAAATTAAAAAAAAAAAA","GGCCAGGCACAGTGGCTCATGTCTGTAATCCCAGCACTTTGGGAGGCCGAGGCGGGTGGATTACCTGAGGTCAGGAGTTCTAGACCAGCCTGGCCAACAAGGCGAAACCCTGTCTCTACTAAAAATACAAAAAATTAGCTGGGCGTTTTGGCACATGCCTGTAATCCCAGCTACTTGGGAGGCTGAGGCAGGAGAATTGCTTGAACTGGGGAAGTGGAGGTTGCAGTGAGCTGAGATCACACCATTGCACGCCTGAGCAACAGAGCGAGACTCTGTCTCAAAAAAAAAAAAAAAAAAAAAAAAGAAAAGAAAAAGAAAA"
"GL873567","11215752","11215787","chr1","62915138","62915167","12","51699386","CAATAAAGCAAGACTCTGCCTCCAAAAGAAAAAAAA","CAAACAAACAAACATCACAAAAAAAGAAAA"
"GL873567","11215868","11216117","chr8","45194211","45194474","73","33978343","GGCTGGGTGTGATGGTTCAGGCCTGTAATCCCAGCGCTCTGGGAGACCAAGGCAGGATAGCCTGAGGTTAAGAGTTTGAGACCAGCCTGAGCAACACAAGACCCTGTCTAAACCAGGAAAATTACTGGGGTGTGGTGGCGTGTGCCTTAATCCCAACTACTCAGGAGGCTAGAGTATTGCTTGAGGGCAGAAGACTGAGGTTGCTGTGAGGAAAGGCTAAGGTCAAGCCATTCTAGCCCAGGCAATAGAG","GGCCGGGTGTGGTGGCTCATGCCTGTAATCCCAGAACTTTGGGAGGCCAAGGCAGGTAGATTACCTGAGGTCAGGAATTGGAGACCAGCCTGGCCAACATGGTGAAACCTCTTCTGTACTGAAAATTACCTGGGCATGGTGGCACACGCCTATAATCCCAGCTACTCAGGAGGCTGAGGCAGAATTGCTTGAGCCCGGGAGACAGAGGTTGCAGTGAGCCAAGATCGTGCCACTGTCCTCCAGTCTGGCCAACAGAGCAAGACT"
"GL873567","12342574","12342696","chr3","166690011","166690120","46","154347437","GTACGCGCAAACCAGAAAAATCAACTAGGTGTGGCAGGGCACACCTGTAGTCCCAGCTACTGGGGAGGGTGAAGCAAGAGATTGCTCAAGTCTGAGGTTACAGTGAGTTAAGATGATACCACT","TACACATACAAAAAATCAGCTGGGTGTGGTGGTACATGCCTGTAATCCCAGCTACTCAGGAGGCTGAGGCCGGAAAATCACTTGAACCCAGGAGGCAGAGGTTGCAGTGA"
"GL873567","12342734","12342873","chr8","96368294","96368428","43","84025560","GGCCAAACACAGTAGTTTATACCTATAATTCCAGCACTCTGGGAAGCTGAAGCAGAAGGATCAGCTGAGGTCAGGAGCCTCAAGACAAGCCTGGGCAAGACTAAGACTCCCCTCCATCCCTTCCCCCACTGTCTTCTCAC","GGCCAGACACAGTGGCTCACACCTGTAATCCCAGCTCTTTGGGAGGCTGAGGCAGGCGGATCACCTGAGGTCAGGAGTTCAAGACCAGCCTGGCCAACATGGTGAAACTGCATCTCTACTAAAAATATAAAACCA"
"GL873568","4322030","4322103","chr11","54983169","54983243","11","50661139","GGCCAGGCGCAGTGGCTCATGCCTTTAATCATAGCACTCTGGGAGGCTGAGGTAGGCGGATCTCCTGAGCCAGG","GGCCAGGTGCAGTGGCTCATGCCTGTAATCCTAGCACTTTGGGAGGCCGAGGTGGACCGATCACCTGAGGTCAGG"
"GL873568","4439574","4439747","chr7","26745376","26745549","54","22305802","GGCTGGGCATGGTGCTCACACCTGTAATCATAGCACTCAGGGAGGCCGAGGTGAGTGGATTGCCAGAGCTCACAGGTTTGAAACCAGACAGAGCCTTTTTTTTTTTAGAAGAAATTGTAGGCTGGGCATGGTGCTCATACCTGTAATCATAGCACTTGGGAGGCCAAGGCAAGA","GGCTGGGCATGGTGGCTCACGCCTGTAATACCAGTACTTTGGCAGGCCGAGGCGGGCAGATCACCTGAGGTCAGGAGTTCAAGACCAGCCTGGCCGTTTCTACTAAAAATACAAAAAATTAGCTAGGCATGGTGGTGCGCACCTGTAATCCCAGCTACTCGGGAGGCTGAGGCA"
"GL873568","4546898","4547014","chr15","31980678","31980795","24","27433780","GGCAGGGTGTGGTGTACACCCCTATAATCCCAGCACTTTGGGAGGCTAAGGCAGGAGCATCACCTGGGGCAGGAGTTCAAGGCCAGCCCGGAGAACAGAATGAAACTCCATCTCCAC","GGCAGGGCGTGGTGGCTCACGCCTCTAATCCCTGCACTTTGGGAGGCCAAGGCAGGCAGATCACCTGAGGTCAGAAGTTCAAGACCAGCCTGGCCAATGTGGTGAAACCCCATCTCCA"
"GL873568","5509331","5509406","chr12","122182458","122182528","25","116673127","TAATCCTAGCACCCTAGGAGGCCCAGGTGGGTGGATTACCTGAGCTCAGGAGTTCAAGAGCAAAAGTGAGACCCCT","CCCAGCACTTTGGGAGGCCAAGGCAGATGGATCACCTGAGGTCAGGAGTTGAAGACCAGCCTGGCCAACAT"
"GL873568","5509687","5509883","chr11","2904691","2904882","40","2604996","GTGAGACCCTTGTCTCTACTAAAAGTAGAAAAACTAGCCAGGTGTTGTGGCAGGTGCCTGTAATACCAGCTACTTAGAAGGCTGAGGCAGGAAGATCAGTTGAACCAAAGAGTTTGAGATTGCTGTGAGCTATGATGAAGCCACAGCACTCTACTATCCAGAGCGACAGAGGGAGACTCTGTCTCCAAAAAAAAAAA","GTGAAACCCTGTCTCTACTAAAAATACAAAAATTAGCCAGGTGTGGTGGTGCATGCCTGTAATCCCAGCTACTCAGGAGGCTGAGGCAGGAGAATCACTTGAACCCAGGAGGTGGAGGTTGCAATGAGCCAAGATCGTGCCACTGCACTCCAGCCTGGGTGACAGAGCGAGACTCCATCTCAAAAAAAAAAA"
"GL873568","7119774","7119822","chrX","41233833","41233871","13","34114059","AAAAGTAAAAAATGAGCCGGGTGAGGTAGCTCACGCCTGTAATCCCAGC","AAATCAGCCGGGTGTGGTGGCTCACGCCTGTAATCCCAG"
"GL873568","10881797","10881967","chr1","164648998","164649168","46","153767201","AAAATCACATATTTGCCTGGCATGTTGACTCATGCCCCTATGATCCTAGCACTCTGGGAGGCTGAGGCAGGAGCCTCACTTGAGTCTGTGAGTCTGAGGTTGCTATGAGCAAGGCTGATGCCATGATACTCTAGTGTGGTACAACAGAGTGAGACTCTGTCTCAAAAAAAA","AAAAACACATATTAGCTGGGTATGGTTGTGCGTGCCTGTAATCCCAGCTACTTGGAAGGCTGAGGCAGGAGAATCACTTGAACCCGTGAGGCGGAGTTTGCAGTGAGCTGAGATTGTGCCACTGCACTCCAGCCTGGGCAACAGAGCAAGACTCTGTCTCAAACAAACAAA"
"GL873569","1403943","1404082","chr2","53765152","53765289","48","52361209","AAGCTGAAGCAGAAAAACGGGCTAGAGGTCAAAAGTTTGAGACCTACCGTGGCTACACAGCAAAACTCTGTCTCTAAAAAAAATAAATAAGACCAGGTAAGGTGGTCATGACTATACTCCTAGCCCCTTAAGAGGCTGAG","GAGGTGGGTGGATCACCTGAGGTCAGGAGTTCCAGAACAGCCTGGTCAACATGGCGAAACACTGTCTCTACTAAAAATACAAAAATTAGCCAGGTGTGGTGGCATGCACCTGTAGTCCCCGCTACTCAGGAGGCTGGG"
"GL873569","7343422","7343556","chrX","124155286","124155406","55","116811864","TTTGAAAGTAGACTGCAAACATCATGTTGCTTCACCTCTAAATATATTAATATGGGCCAGGTGCAGTGGATCATGCCTGTAATCCTAGCACTTGCTAGGCCAAGGCTGGCGGATAGCCTGAGCAACAGCGAGACC","ATCAGCCTGACCAACATAGTGAAACCCCATCTCTACTAAAAATGCAAAATTAGCTGGGCGTGGTGGTGCATGCCTGTAATCCCAGCTACTTGGGAGGCTGAGGCGGGAGAATCACTGGAAC"
"GL873569","7404564","7404762","chr6","586928","587122","48","6817636","GAGATCCCATCTCTTAATGAAAATAAAACAATTAGCTGCTATTGTGGCAGGCACCTGTAATTCCAGCAACCCAGGAGGCTGAGGCAGGAGGATCACGTGAACCCCACCAGTTTGAGGTTGCTATGAGCCAGGCTGATGCCAGGACACTCCAGCCTGGGCAACGGAGTGAGACTCCATCTCCAAAAAAAGCAAACAAAAA","GAAACCCCATCTGTACTAAAAACACACAAATTAGTGGGATGTGGTGGCACGTCCCTGTAATCCTAGCTATTCAGGAGACTGAGGCAGGAGAATCACTTGAACCCAGGAGGTGGAGGTTGCAGTGAGCCGAGGTCACACCACTGCACTCCAGCCTGGGCAGCAGAGTAAGACTCCATCTCAAAACAAAAACAAAAA"
"GL873569","7405040","7405133","chrX","21386588","21386682","29","13981548","GGGCAGGGCGGCTCAGGCCTCTAATCCTAGCACTCTGGGAGCTTCCTTGAGCTCAGGAGTTCAAGACCATCCTAAGCAACAGAGATCCCATCTC","GCTGGGCACGGTGGCTCACGCCTGTAATCCCAGCACTTTGGGAAGCCAAGGTTTGAGGTCAGGAGTTCAAGACCAGCCTGGCCAACAGGCTGCAA"
"GL873548","15249374","15249463","chr5","46485072","46485159","19","31235698","GGCCAGGCATGGTGGCTCATACCTATTGTCCTAGCACTGTGGGAAGCCAAGGCAAGTGGATCACCTGAGCTCTAGAGGTTCGAGACCAGC","GGACAGACACAGTGGCTCATGCCTGTAATCCCAGCAGTTTGGGAGGCCAAGGCAGGTGGATCACCTGAGGTACAGAGTTCAAGACCAG"
"GL873548","15817199","15817306","chr7","158031905","158031997","37","142214706","AAAAAAAAAGAGTTGGAGGTTGCTATGAGCAACATCAGCATGGCACTCAATTCCAGGGTGACTGACTGAGACTGTTGTAGCTATACTCCAAAAAAAAAAACACACAAA","CCAGGAGGTGGAGGTTGCAATGAGCCAAGATCACACCACTGCACTCCAGCCTGGGTGACAGGGTGAGATTCTGTCTCAAAAAAAAAAAAAAAA"
"GL873548","15817589","15817786","chr3","3025868","3026088","60","12791721","GGCCAGGCATGGTGGCTTCTGTAATGCCAGCATTCTGGAAGGCTGAGGTAGGCAGTAGCTTGAGCTCAGTAGGAGAACAGCCTGACCAAAAGTGAGACCCTGTCTCTAAAAATAGTCGTTTGTGGTGGTTACCTGTTGTCCCAGCTACTAGGGAGGCTGAGGCAAGAGAATCACTTGAGCGTAAGAGTTGGAGGTTGC","GGCCAGGCACGGTGGCTCATGCCTGTAATCCCAGAACTTTGGGAGGCTGAGGTGGGCAGATCACCTGAGGTCAGGAGTTGGAGACCAGCCTGACCAACATGGTGAAACCCTGTCTCTACTAAAAATACAAAATTAGCCAGGTGTAGTGGCACGTGCCTGTAATCACAGCTACTTAGGAGGCTGAAGTAGGAGAATCACTTGAACCTGGGAGGTGGAGGTTG"
"GL873548","15856498","15856605","chr18","35090078","35090171","38","19233580","CCCCCCCCAAAAAGAAAAGGGTTGCTTGAATCTAGGAGTTTGGGGTTGCTGTGGGCTAAGCTGATACCACAGCACTTTAGCCTGAGCAAACAGAGTGACACTCTGTCT","AAGCAGGAAATCGCTTGAACCCAGGAAGCAGAGTTGCAGTGAGCCAAGATCGCACCACTGCACTGCAGCCTGAGCAACAGAGAAAGACTCTGTC"
"GL873548","15856683","15856877","chr3","3200882","3201085","53","12655801","GCCAGGCACAGTGGCTCATGCCTATAATCCTAGCACTCTGGGAGGCCAAGGCAGGATTGTCTAAGCTTGGGAGTTTGACAGCAGCCTGAGAAAGATTGAGACCCCTGTCTCTACTAAAAAATAGAAAAATTAGCTGAGTGTTGCAGCAGGTGCCTGTATTTCCAGCCAAGGGGGAGGTTGAAAAGGGTCGCTTCA","GGCCAGGCGCAGTGGCTCATGCCTGTAATCCCAGCACTTTGGGAGGCCGAGGCGGGTGGATCATAAGGTCAGGAGTTTGAGACCAGCCTGGTCAACATGGTGAAACCCCATCTCTACTAAAAATACAAAAATTAGCTGGGTGTTGTGGCACATACCTGTAATCCCACCTACTCAGGAGGCTGAGGCAGGAGAATCACTTGAACC"
"GL873549","1940307","1940608","chr12","9481260","9481565","74","7540953","GGCTGGGCGCAGGGGCTCATGCCTGTGACCCTAGCACCCTGGGAAGCCAAGGCGGGCAGATCGCCTAAGCTCACGAGTTTGAAACCAGCCTTAGCTAGAGTGAGACCCCCAATACTAAAAAAATAGCCAGGCTTTGTGATGGGCGCCTGTAGTCCCAGCTACCTGGGAGGCTGAGGCAAGAGAATGGCTCAAGCCCAAGAGTCTGAGGTCACAGTGAGCTACTGACGCCACCGCACTCTATTGGAACAACAAAGTGAGACTGTGTCTCAAACAAACAAACAAACAAACAAACAAAAAAGAAA","GCTGGGCGCGGTGGCTCATGCCTGTAATCCCAGCACTTTGGGAGGCCAAGGCAGGTGGATCACCTGAGGTCAGGAGTTCGAGACCAGCCTAGTCCACATGGTGAAACCCCATCTCTACTAAAAACTAGCCAGGCGTGGTGGTGCGCACCTGTAATCCCAGCTACTCGAGAGGCTGAGGCAGGAGAATCACTTGAGCCTAGGAAGCAGAGGTTGTGGTGAGCTGAGATCACACCACTGCACTCCAGTCTGGGCGACACAGTGAGACTCTTGTCTCAAAAACAAAAAACAAACAAACAAACAAACAAA"
"GL873549","2657819","2658019","chr11","18547798","18548000","50","15889979","GGCCTGGCACTGTGGCTCACACCTGTCAGGTTAACACTCTGGGAGGCTGATATGGGTGGGTCTCCTGAGTTTAGGAGTTTAAGACCAGCCTAATCAAGAGTAAGACCTGCCTTTACTAAAAATAGAAACACTCACCAGGACTACTGTGCACCTACAGTCCCAGCTACCTGGGAGGCTGAGGCAAGAGGATTGCTCAAGCCC","GGCCAGGCACTGTGGCTCACACCTGCAATCCCACCACTCTGGGAGGCAGAGGCAGGTGGATCACCTGAGGTCAGGAGTTTGAGACCAACCTGGCCAACAGAGCAAAACACTGCCTCTACTAAAAATACAAAAACTAGCCAGGTGTGGTGCATGCCTATAGTCCCACCTACTTGGGAGGCTGAAGCAGGAGAATCTCCTGAGCC"
"GL873549","8853848","8853952","chr12","88112976","88113081","32","79259128","AGCCAGCTGTGTGGCTCATTCCAGTAATTCCAGTTACTGGGGAGGCTGAGACAGGAGGATCACTTGAATGCAAGAGGTGGCGAGAACTCAGCTTTAAAAATAAAA","GGCCAGATGCAGTGGCTCATGCCTGTAATCCCAGCACTTTGGGAGGCTGAGGCAGGCGGATCACCTGAGATCAGGAGTTTGAGACCAGCCTGGCCAACATGGTAAA"
"GL873549","10378794","10378882","chr20","18199749","18199840","17","7820955","GGCCAGGCACGGTGGTTCACCTGTGATCCCAGCACTCTGGGAGATAAGGCAGGCTGATCACCTGAGTTCACAGGTTGGAGACCAGCCTG","GGCCGGGCATGGTGGCTCACACCTGTAATCCCAGCACTTTGGGAGGCTGAGGCAGGCGGATCACCTGAGGTCAGGAGTTCGAGACCGGCCTG"
"GL873549","15488169","15488282","chr10","38476693","38476794","41","22988524","CTGAGCACACGGGTTCACACCTGTAATCCCAGCACGCTGAGAAGCCCAGGCAAGAGGCTGACCTCCAGCCTGGGTGACGGAGCGAGATTCCCCCCCACCCCCGACCAAAAAAAA","CTGAGCGCTGGTAGCTTACACCTGTAATCCCAGCACTTTGGGAGGCCTAGACAGGCGGATCACTTGGGGTCAGGAGTTTGAGACCAGCCTGGCCAATATGAT"
"GL873549","17403348","17403519","chr10","38461164","38461337","46","21057816","GCCAGGCACAGTGGCCCACACCTGTAATCCCAGTACTGTGGGAGGCTGAGGCAGGCTGAGGCAGGCATGGATCACTGAGGTTGCTGTGAGCTAAGATGCCATGGCCCTCCACCCAAAGTGACAGAGTGAGACTCTGTCTCAGAATTAAAAAAAACAAAGAAAGAAAAATAAA","GCCAGGCATGGTGACTCACGCCTATAATCCCAGCACTTTGGGAGGCTGAGGCATGAGAATCACTTGAACCCAGAAGGCAGAGGTTGCAGTGAGCTAAGATTGTGCCACTGTACTCCTGCCTGGGTGATGGAGTGAGACTCTGTCTCGATTTAAAAAAAAAAAAAAAAAAAAAAA"
"GL873550","801968","802043","chr15","50500527","50500602","20","49698559","GTAGCCAGGTATGGTAGTGCAGGCCTGTACTCCCAGCTACTTGGAAAGCTAAGGCAATAGAATCATTTAAGCCCAG","TGGCCGGGCATGGTGGTACATGCCTGTAATCCCAGCTACTTGGGAAGCTGAAGCAGGAGAATTGCTCGAACCCAGG"
"GL873550","802343","802376","chr3","33494224","33494257","9","32691881","TAAGACTTTGTCTCTACTAAAAATAGAAAAAGTG","GTGAAACCCGTCTCTACTAAAAATACAAAAATTA"
"GL873550","2805841","2805900","chr2","93673843","93673900","18","90868002","CTATTCAAAATAGCTAAAATGGGCAGGGCAAGGTGGCTCACACCTGTAATCCCAGTACTC","TAAAAATGTAAAAGATTGGCCGGGTGTGGTGGCTCACTCCTGTAATCCCAGCACTTTG"
"GL873550","4153085","4153214","chr16","18855701","18855834","37","14702616","GGCAGGGCTTGGTGGTAAAAGCCTGTAATCCTACCACTCTGGGAGGCAGAGGTGGTTAGATTGCATGAGGTCACTGGTTGGAGACCAGCCTGAGCTAGAGCAAGACCTCATCTCCAAAAATAGCAGGGCT","GGCTGGGCGCGGTGGCTCACACCTGTAATCTCAGCACTTTGGGAGGCCGAGGTGGGTGGATCACCTGAGGTCAGGAGTTCGAGACCAGCCTGGCCAACATGGCAAAACCCCATCTCTACAAAAATACAAAATTA"
"GL873550","4153472","4153634","chr7","17472856","17473028","43","13319384","AATAAAAATAGCAGGGCTTTGTGGCGGGCACCTGTAGTCCCAGCTACTTGGGAGGCTGAGGCAAGACAATTGCTTGAGCACAAAGTTGGAGGTTGTTGTGAGCTGTGACATCATAGCACTCTACCAAGGGAGATAGAGTGAGACTATCTCGAAGAAAAAAAAA","ATACAAAAATTAGCCAGGTGTAGTGGCGTGCACCTGTAATCCCAGCTACTCGGGAGGCTGACGCATGAGAACTGCTTGAACTCAGGAAGTGGAGGTTGCAGTGAGCTGAGATAGTGCCACTGCACTCCAGCCTGGGTGACAGAGCAAGACTCCATCTCAAAAAAAAAAAAGAA"
"GL873550","6050671","6050965","chr7","84009904","84010193","74","77959233","GGTGGCTCACGCCTGTTATCCTAGCACTCCAGGAGACTAAGGTAGGAGGATGCCTTGCTTGAACTCAAGAGTTCAAGACCAGTCTGAGTGAGAGGGAGACCCTGCGTCTACTCAAAAATAGAAAAATTTACCAGCCATTGTGGCCAACACCTGTAGACCCAGCTATTCAGGAGTCTGAGGCCAGAGAATCACTTGAACCCAGGAGACTGAGATTGCTGTGAGCTAGGCTAAAACCATGGCACTCTAGCCCAGGTGGCAGAGTGAGACTGGGTCTGCAAAAAATAAATAAAAACAA","TGGCTCATGCCTGTAATCCTAGCACTTTGGGAGGCCAAGGCAGGTGGATTGCCTGAGCTCAGGAGTTCAAGACCAGCCTGGCAACACGATGAAACCCCGTCTCTATTAAAAAATACAAAAAATTGGCCAGGCATGGTGGTGTGCACCTGTAATCCCAGCCACTCAGGAGGCTGAGGCAGGAGAATCGCTTGAACCCGGGAGACAGAGGTTGCAGTGAGCCAAGATCGAACCATTGCACCCCAGCCTGGGTGAGAGTGAGACTCTGTCTAAAAAAAAAAGAAGAAAAAGAA"
"GL873550","6212004","6212068","chr19","50425309","50425373","23","44213305","AGAACCTAAGAGTTTTGAGGTTGCTATGAGCTGGACTGATACCATAGCATTCTAGTCTGGGTGAC","TGAACCCAGGAGGTGGAGGTGGCGTGATGCCCAAGATGTGCCACTGCACTCCAGCCTGGGTGATA"
"GL873550","6212319","6212418","chr17","89042086","89042197","34","82829767","CTGTCTTTTCTAAAAATAGAAAAACTAGCTGGGTTGTGGTGGGCACTTGTAGTCCTAGGTACTCTGAGGCTGAAACAGGATTGCTTGAACCTAAGAGTTT","GTCTCTACTAAAAATACAAAAATTAGCCGGGCATGCTGGTGGGCACCTGTGATCTCAAGCTACTTGGGAGGCTGAGGCAGGAGAATCACTTGAACCTGGGAGGCAGAGGTTG"
"GL873550","6504310","6504401","chr19","2969698","2969794","27","3534612","GTGCTGGTGTATGCACCTGTCATACCAGCTACTCCTGAGGTTGAGGCAGGATAGCTTGAACCCGGGAGTCTGAGACTGCAGTGAGCTGGGAT","TTAGGCGTGGTGCATGTCTGTAATCCCAGCTACCCGAGAGGCTGAGGCAGGAGAATCACTTGAACCTGGGAGGCGGAGGTTGCAGTGAGCCGAGATC"
"GL873550","7178331","7178523","chr19","40691105","40691269","60","33512774","GGCCAGACGCGGTGGCTCACGCCTGTTGTCCCGGCACTGTGGGAGGCCGAGGCTGGTGGATCCCCTGAGCTCAGCCAAGTTCAAGACCAGCGGAAGACCAGCATGAGGCAGAGTGAGCCAGAGTGAGACCCCGTCTCTACAACAACAACAACAAAAAATAGCCGGACCTTGTGATCCCAGCTACATGGGAGGC","GGCCGGGCATGGTGGCTCACGCCTGTAATCCCAGCACTTTGAGAGGTCGAGGCAGGTGGATCACCTGAGGTCAGGAGTTCGAGACCAGCCCGGCCAATATGGTGAAACCCCTTCTCTACTAAAAATACAAAAAATTAGCCGGAAGTGGTGGCATGCACCTGTGAT"
"GL873550","7981631","7981790","chr6","148611209","148611366","40","140629578","ATAGCCCCGCCTTGTGGTAGGCTCCTGTAGTCCCAGCTACTTGGGAGGCTGGGGCAAGAGAATCACTTAGGCCCAAGAGTTGGAAGTTGCTGTGAGCTGTGATGCTACAGCATTCTACTGAGAGTGACAAAATGAGACTCTGTTTAAAAAAAAAAAAAAA","TTAGCTGGGCATGGTGGCAGGTGCCTGTAATCCCAGCTACTCTGGAGGCTGAAGCAAGAGAATCGCTTGAACCCAGGAGGTGTAGGTTGCAGTGAGTCGTGCCACAGCACTCCATCCTGGGTGACAGAGCAAGACTCTGTCTCAAAAAAAAAAAAAAA"
"GL873550","7982053","7982180","chr2","182489403","182489528","28","174507350","GGCTGGGCGAGGTTGTTCAGACCTGTAATCCTAGCACTCTGGGAGACCAAGATGGGTGGATTGCCTGAGTTCATGAGTTTGAGACCAGCCTGAGCCAGAGTGAAACCTTGTTCTCTAAAAATAGCTCG","GGCCGGGTGTGGTGGCTCATGCCTGTAATCCTAGCGCTTTGGGAGGCCGAGGTGGGTGGATTGCCTGAGCTCAGGAGTTCGAGACCAGCCTGGGCAACACGGTGAAACCTGTCTCTACTAAAATAC"
"GL873550","8404122","8404320","chr4","121405930","121406135","43","113001808","GGCCAGGCACAGTGACTCACACCTGAAATCTTAGTACTCTGGGAGGCCAAGGTGGGAGGATTTCCTGAGGTCAGGAGTTCAAGACCAGCCAGAGCAAGAAGATCCTGTCTCTACTAAAAGTATAAAAAGTGAACCAAGTGTGGTAGTGAGCACCTATAATCTCAGCTACTTGGGAGGCCGAAGCAAGAGGATCACTTGA","GGCCAGGCACAGTGGCTCACACCTGTAATCTCAACACTTTGGGAGGCCAAGGTGGGTGGATCACCTGAGGTCAGGAGTTTGAGACAAGCCTAGCCAGCATGGTATAACTCCATCTCTACTAAAAGTATAAAAATCAACCAGGTGTGGTGGCACATGCCTGTGGTCCCAGCTACTTGGGAGGCTGAGGCAGGAGAATCACTTGAATC"
"GL873550","8404408","8404483","chr15","701469","701538","22","7702939","AGGATCTCTTGAGCTCGGGAGTTTGAGGTTGCAGTGAGCCAGGCTGATGTCATGGCACGCTACCCAAGACAACAAA","AATCACTTGAACCCAGGAGGCAGAGGTTGCAGTGAGCCAAGACTGTGCCATGGCACTCTAGCCTGGGCAA"
"GL873550","11648593","11648682","chr3","124881947","124882027","31","113233354","GTGGCTCACACTAGTAATCTTAGTACTTTGGGAAGCTGGGGCAAGAGGATCACTTGAGGTCAGGGTTAGGAAACTCTATCACTACAAAAA","GCGGTGGCTCACGCCTGTAATCCTAGCACTTTGGGAAGCCAGGCAGGCAAATCACGAGGTCAGGAGTTCGAAACCAGCCTG"
"GL873550","12468624","12468663","chr9","62916303","62916339","11","50447679","GCCCGGCTTGGTACCTCATGCCTGTAATCTTAGCACTCCG","GGCCGGGCATGGTGGCTCATGCCTGTAATCCCAGCAC"
"GL873550","12468943","12469188","chr12","70524409","70524645","91","58055466","AATCTTAGCACTCCGGGAGGCCGAGGCGGGTAGACCAACCTAATCAAGAGCAAGATCTACCTCTACTAAAAATAGAAAAGAATTGGCCAGGCGTATTGACTCCGCCTCTAGTGCCAGCTACTCCAAAGCTGAGGCAAGAGGATTGTTCAAATCCAAGAGTTTGAAATTGCTGTATGTTACACCAGGGCACTCTAGCCGTGGAGACATTTTCTCTATATATATTAAAAAAAACAAAAAACAGAAAAA","CTGAGCTCGGGAGTTCGAGACCAGCCTGACCAATATGGAGAAACCCTGTCTCTACTAAAAATGTAAAATTAGCCAGGCATGGTGGCACATGCCTGTAGTCCCAGCTACTCAGGAGGCTGAGGCAGGAGAATCGCTTGAGGTCAGGAGGCGGAGGTTGCAGTGAGCCAAGATCATGCCACTGCACTCCAGCCTGGGTGACAGAGTGAGACTTTGTCTCAAAAAAAAAAAAAAAAAAAA"
"GL873550","14719674","14719880","chr16","30390993","30391163","76","15671319","GGGCGTGGTTGCTCACGCCTGTTGTCCCAGCGCTGTGGGAGACCGAGGCAGATGTATCGCCTGAGCTCAGCCGAGTTCGAGTTCGAGACCAGCGGAGAGACCACCATGAGGCAGAGTGAGCCAGAGTGAGACCCCGTCTCTACAACAACAACAAAGAAAACAGCCGGATCTTGTGATCCCAGCTACATGGGGGCCAAGAGAATCACT","GGGCACGGTGGCTCACACCTGTAATCCCAGCACTTTGGGAAGCCAAGGCAGGAGGATCACCTGAGGTCAGGAGTTCAAGACCAGCCTGGCCAACATGGTGAAACCCCGTCTCTACTAAAAACACAAAAATTAGCCAGGTGTGGTGGTGCACGCTTGTAATCCCAGCTACTC"
"GL873550","15737883","15738154","chr2","20481557","20481833","73","4743674","TTAGCATTCTGGGAGGCCAAGTCAGGTGGATTGCCTGAACTCACAAATTTGAGACTAGCCTGAGATAGAGAAAGATCTTGTCTCTAAAAAAAAAAAAAAATAGCTGGACTTTGTAGTGGGCACCTGTAGTCCCTGCTACTCAGAAGGCTGTGGTAAGAGAATCACTGGAACCCAAGAGTTAGAGGTTGCCGTGAGCTGTGATGCCATGGCACTCTACCAGAGACAACAGAGTGAGACTCTCTCCAAAAAAAAGAAAAAGAAAAAGAAAAAAA","GCACTTTGGGAGGCCAAGGCAGGTGAATCACCTGAGATCAGGAGTTCAAGACCAGCCTGGGCAACATGATGAAACCCTGTCTCTATGAAAAATACAAGAATTAGCTGGGCATAGTGGTGTGCATCTGTAATCCCAGCTACTCAGGAGGCTGAGGTATGAGAATTGCTTGAACCCTGGAGGCAGAGGTTGCAGTGAGCCGAGATGACACCGTTGCACTTCAGCCTGGACAATAGAGAGAGACTCTGTCTCAAAAAAATGAAGAAAAGAAAGAAAGAAA"
"GL873550","15738844","15738873","chr10","65896918","65896951","9","50158074","GGGTGTGGTGGCTGATGCGTGTAATCCTAG","GGCTGGGCGTGGTGGCTCATGCCTGTAATCCCAA"
"GL873550","16345151","16345329","chr1","6754007","6754209","69","9591144","CACCTGTAATCCCAGCACTTGGGAGGTTGAGGAGAGTGGATTGCCTGAGCTCACAGGTTTGAGCCAGAAGGAGACCTCGTCTGTAAAAATAGCTGGGTGTTGAGACCAGCGCCTTTAGTCCCAGCTACTTGGGAGGCTGAGGCAAGAGAATCACTTAAACAATTCTAGAAGCAGAGTTT","CTGTAATCCCAGCACCTTGGGAGGCTGAAGAGGGCGGATCACCTGAGGTCAGGAATTTGAGACCAGCCTGGCCAACATGGTGAAATCCCATCTCTACTGAAAATACAAAATTAGCTGGGTGTGGTGGTGCATGCCTGTAGTTCCAGCTACTTGGGGAGCTGAGGCAGAAGAATGCCTTGAACCCGGGAGGCAGAGGTTGCAGT"
"GL873550","17727115","17727274","chr1","127857902","127858038","52","110130787","GCTGGGTGCAGTGACCCCTGCCTATAATCCCAGCAGTTAGGAGACAAAGGCAGGAGGAATTACCTGAGAGCAGGAGTTCCAGACAAGCCTCAGACCAGCGTGAGCTATGACATTGTCTGTAGCCCCCACCCCACCCCCCCAAAAAACAAAAAGAAACAAA","GGCTGAGTTCAGTGGCGCACGCCTGTAATCCCAGCAGTTGGGAGGCTGAGGCAGGTGGATTGCCTGAGGTCAGGAGTTCAAGACCAGTCTGGCCAACATGGTGAAACTCTGTCTCTACTAAAAAAAAAAAAAAAAAT"
"GL873551","6567068","6567102","chr14","109767086","109767123","14","103200018","GGATCACATGAGGTCAGGAGTTCAAGATCAGCCTG","GGAGGCAGAGGTTGCAGTGAGCCAAGACTGCGCCATTG"
"GL873551","9393264","9393376","chr1","39198637","39198744","32","29805373","CAAGAGTATCTCTGCAACCCAGTGGCCTGAGGTTGCTATGAGCTAGGATGCCACAGCACTCTACCCAAGGGGACAGAGTAAGACTCTGTCTCCAAAAAAAAAAAAGAGCAAAA","AGAATCGCTTGAACCTGGGAGGCGGAGGTTGCAGTGAGACCAGATCATGGCACTGCACTCCAGCCTGGGCGACAGAGTAAGACTCGGTCTCAAAAAAAAAAAAAAAAA"
"GL873551","9393708","9393894","chr12","115674238","115674427","40","106280530","GCTGGGCTCAGTGCCTCTCGCCTGTAATCCCAGCACGCTGGGAGCCTGAGGTGGGTGGGTTGCTTGAGCTTAGGAGTTCAAGACCAGCCTGAACCAGAGCAAGACACTATCTCTACTAAAAATAGAAAAACTATCTGGGCATGGTGGTGCGCACCTGTAGTCCCAGCTACTAGGGAAGCTGAGGCAA","CCAGGCCTGGTGGCTCACGCCTGTAATCCCAGCACTTTGGGAGGCCGAGGTGGGTAGATCACCTGAGGTCAGGAGTTCAAGACCAGCCTGGCCAACATGGCGAAACCCCATCTCTACTAAAAATACAAAAATTAGCTGGGCATGGTGGTGTATGCCTGTAATCCCAGCTACTCGGGAGGCTGAGGCAGGA"
"GL873551","10104594","10104683","chr16","53032852","53032939","31","42928258","GGTAGGTGGGTCTCTCGAGGTTAGGAGCTCTTTACCAGCCTGAGCTGACATAAGACCCAATCTCCACCAAAATAGAGAGAGAAAAAAAGA","GAGGCAGACAAATCTCTTGAGGTCAGGAGTTGAAGACCAGCCTGGGCAACATAGACCTCGTCTCTATTAAAAAAAGAAAAAAGAAAAA"
"GL873551","12307468","12307551","chr8","94102375","94102458","19","81794907","GGCCAGGCATAGCAGCTCATGCCTGTAGTCCTATTATTCTAGGAGGTCCAGGGAGGAGGATCACCTGAGATCAGAAGTTCAAGA","GGCCAGGCATGGTGCCTCATGCCTGTAATCCCAGTACTTTGGGAAGCCAAAGTGGATGGATCACCTGAGGTCAGGAGTTCGAGA"
"GL873551","13335872","13336095","chr4","85819795","85820026","56","72483923","GCCAGGTACAGTAGCTCAGGCCTGTAATCCTAGCACACTGGGAGGCTGAGGTGGTGGATCCTTGAACTCATGAATTCAAGACCAGCCTGAGGAAGAGCAAGACCCCATCTCTCCTAAAAATAGAAAAATTAGCTGGTGTCATGGCAAGTGTCTGTAATCCCAGCCACACAGGAGGCTGAGGCAAGAGGATCTCTTGAACCCAAGACACTAAAGTTACTGGGAGC","GCCGGGCATAGTGGCTCATGCCTGTAATCCCAGCACTTTGGGAGGCTGAGATGGGTGGATCATCTGAAGTTAGGGGTTCGAGACCAGCCTGGCCAAATGGCAAAAACCCATCTCTGCTAAAAATACAAAAATTAGCCAGACATTGTGGCATGTGCCTGTAATCCCAGCTACTCAGGAAGCTGAGACAGGAGAATCGCTTGAACCCAGGAGGCAAAGGTTGCAGTGAGCCAAG"
"GL873552","1195303","1195426","chr3","54039332","54039457","34","52844029","CTACTCTGGATGCCAAGGCAGCGGGATCACTTGAACCCCAGAGTCTGAGGTTGCTGTGATCTCAGCTGACTCCATGGCACACTAGCCTGAGGCAACAGACTGAGACTATATCTCAAAACAAAAA","AGCTACTCAGGAGGCTGAGACAGGGAGAGTCACTTGAACCCAGGAGGCAGAGTTGCAGTGAGCCGAGATCACGCCAACTGCACTCCATGCCTGGGCAACAGAGTGAGACTCCGTCTCAAAAAAAAA"
"GL873552","15010293","15010428","chr1","29437872","29437991","29","14427579","GGCCGGGCGTGGTGGCTCACGCCTGTATTCCCAGCGCTATGGGAGGCCGAGGCGGGTGGATCACCTGTGCTCAGAGGTTCGAGACCAGCCAAGACCCCCCTGAGCCAAACGAGCCAGAGTGAGACCCCGTCTCTAC","GGCCGGGCGTGGTGGCTCACGCCTGTAATCCCAACATTTTGGGAGGCCAAGGCGGGTGGATCACCTGAGGTCAGAAGTTCGAGACCAACCTGGCCAACATGGTGAAACCCCTGTCTCTAC"
"GL873553","860627","860695","chr1","16024119","16024187","13","15163492","GCCAGGCTCAGTGGCTCACGCCTATAATCTTAGCGCCTTTTGGAGGCCAAGGTGGGGGGATTACCTGAG","GGCCAGGCACGGTGGCTCACGCTTGTAATCCCAGCACTTTGGGAGGCCGAGGAGGGTGGATTACCTGAG"
"GL873553","7206820","7206939","chr3","156098583","156098705","38","148891763","AGCTAGGTATGGCAGCTGACATCTGTAACCCTAGCCCTCTGGCAGGCCAGGAATTCAAGACCAGCCTAGACAACATAGTAAGACCCCATCTCTACCAAAAATAATTTAAAATTGGCCAGG","GGCTGGCTGTGGTGGCTCACACCTGTAATCCCAGTACTTTGGATCATGTGAGGTCAGGAGTTCAAGACCAGACTGACCAACATGGTGAAACCCTGCCTCTACTAAAAATACAAAATTAGCCAG"
"GL873553","10985147","10985407","chr12","94325498","94325767","64","83340351","GGCCTGTGGCAGTGGCTCATGCCTGAAATCCTAGCACTCTGGGAGGCTGAGGTGGGTCGATTACCTGAACTCACCAAGACGGAGACCTCATCTCTACTAAAAATAGAAAAACTAGCTGGGCGTGGTGGCAGGTGCCTGTAGTCCCAGTTACTGGGGAGGCTGAGGCAAGAGAATTACTTGAACCCAAGAATTTGAGGTTGCTGTGAGCTATGATGCCACAACACTCTACTCAGGGTGACGGAATAAGACCCTGTCTCAAAA","GGCCGGGTGTGGTGGCTTATGCCTGTAGTCCCAGCACTTTGGGAGGCCGATGGGGATGGATCACCTGAGGTCACTGGCCAACACAGAGAAACCCCATCTCTACTAAAAATACAAAAATTAGCCAGGCGTGGTGGCATGTGCCTATAATCCCAGCTACTTGGGAGGCTGAGGCAGGAGAATCACTTGAACCCGGTAGGCAGAGGTTGCAGTGAGCCGAGATTGTGCCACTGCACTCCAGCCTGAGTGACAGAGCAAGCCTCTGTCTCAAAA"
"GL873553","10985438","10985466","chr16","73760336","73760365","6","62774898","CATAAAAAGAAAGAAAACTGAAAAGAAAA","GAAAGAAAGAAAGGAAAAGAGAAAAGAAAA"
"GL873553","12443178","12443505","chr1","3864926","3865253","98","8578252","GCAGGGTGGGGAGGCTCGCACCTACATCCCCAGCACCCTGGAAGGCTTAGGCAGGTGGACTGGGTTCAGGAGTTGGAGAGCAGCCTGAGCAATAGTGAGATTCTGTCTGCAGTAAAACTAGAAAAATTATTTAGGGGTTGTGCTGGGTGCCTATTATCCTAGCTACTGTTGAGGCAAGGGGACAGCTTGAACCCAGGATTTTCAGGTTTCTGTGAGCTAGGATGATGCCATGATGACCCTCTGACACTTTGCCTGGGCAGTAGAGTGAAACTCTGTCTCAGAAAAAACAAAACAAAACAAAACAAAACAAACAAACAAACGAAAAAAA","GGCCAGGCGTGGTGGCTCACACCTGTAATCCCAGCACTTTGGGAGGCTGAGGCAGGTGGATCACCTGAGGTCAAGAGTTCAAGACCAGCCTGGCCAACATGGTGAAACTCTGTCTCTACTAAAAATACAAAAATTAGCCGGGCATGGTGGTGCATGCCTGTAATCCCAGCTATTCGGGAGGCTGAGGTAGGAGAATAGCTTGAACCCGGGAGGTGGAGGCTGCAGTGAGCTGAGATCATGCCATTGCACTGTAGCCTGAGCAACAGAGAAAGACTCTGTCTCAAAAAACAAAACAAAACAAACAAAAGAACAAAAACAAACAAACAAA"
"GL873553","15121135","15121247","chr1","111354387","111354508","21","96233252","GGGCGTGGTGGCTCACACCTGTAATCCCATCACTTGGGAGGCTGAGGCAGGTGGATCACCTGACCTCAGGAGTTCGAGACCAGCCTGAAGAAGAGTGAGACCCCGTCTCTAAA","GGCCGGGCGTAGTGGCTCACACCTGTAATCCCAGCACTTTGGGAGGCCGAGGCGGATGGATCACCTGAGTTCAGGAGTTTGAGACCAGCCTGACCAAAGTGGTGAAACCCCGTCTCTACTAA"
"GL873553","15121274","15121455","chr7","68420775","68420939","69","53299501","AGATTTCAACAGGCCTAATGGCTTTAGTATATAAAGAGAACTTATAAAGCCAGACTCAGTGGCTTACATCTATAATCCAGGTACTTGGTAGGTTGAAGTGAGAAGATTCTTTGAGCCAGGATTTCCAGCCCAGCCTAGGCAACACAGAGAGACCCCCATCTCTAAAAGAGAAAGGTAAAAAA","GGCTAAAGGGGTGCTCATCTTAAGAATACCAGGCCAGGCGCAGTGGCTCATGCCTGTAATCCTAGCATTTTGGGAGGCTGAGGCGGGTGGATCACCTGAAGTCAGGTGTTTGAGACCAGCCTGAACAACATAGTGAGACCTCATCTCTAATTAAAAAAAGAAAAA"
"GL873553","15614197","15614298","chr4","71691062","71691163","34","56076865","GGTGGCTCACACCTGTTATCCCCATACTCTGGGGGCCTGAGGTGAGAGGATCCCCAGAAGTCAGGAGCTGGAGAGAAGCCTGTGTAAGAGTAAGAGCCAGTC","GTGGCTCATGTCTGTAATCCCAGCACTTTGGGAGGCCGAGGTCGGTGTATCATTTGAAGTCAGGAGTTTGAGACCAGCCTGGCCAACGTGGTGAAACCCTGT"
"GL873553","16849767","16850040","chr1","96770987","96771267","68","79921220","GGCCAGGAGTGGTGGCTCATGCCTGCAATCCCAGCACTTGGGAGGCCAAGGTGGGTGGATTGCCTGAGCTCACAGGTTCAAGACCAGCATGAGCCAGAGAGAGACCTTGTCTCTAAAAATAGGCACAGGTTGTGGTGGGCACCCGTAGTCCCAGCTACTTGGGAGGCTGAGGCAAGAGAATCACTTAAGCCCAGGAGTTTGAGGTTGCTGTGAGCTAAGACACCACAGCACTCTACCAAGGGTGACAAAGTAAAACTCAGATTTTTTTAAAAAA","GGCCAGGTGTGGTGGCTCACAGCCTGTAATCCCAGTAGTTTGGGAGGCCGAGGTGAGCAGATCACCTGAGGTCAGCAGTTCGAGACCAGCCTGGCCAACATGGCAAAACCCTATCTCTACTAAAAGTACAAGGTGTGGTGGCACACACCTGTAGTCCCAGCTACTTGGGAGGCTGAGGCAGGAGAATCACTTGAACTCCAGAGGTGGAGGTTGCAGTGAGCCAAGATTATGCCACCGCATTCCAGCCTGGGTGACAGAGTGAGACTCCGTCTCCAAAAAAA"
"GL873554","511555","511741","chr6","166828248","166828429","56","166316693","GTGGGACCCGCATCTATACTAAAAATGAAAAACTAGTCAGACTTGGTGACTCATGCCTATAATTTCAGTTTCTTGGGAGGTGAAGGCAGAAGAATTGCTTGATCCCAGGAATCTGAGATTGCTGTGAGCTAGGCTAACACTATGGCACTCCAGCCCAGCTGACAGAGTAAGACTTTGTCTTTAAAAA","ACCCCATCTCTACTGAAAATAGAAACATTAGCCGGGCTTGGTGGCATGCGCCTGTAGTCCCAGCTATTTGGGAGGCTGAGGCAGGAGAATTGCTGGAACCCAGGAGGCAGAGATTGCAGTGAGCGGAGATCATGCCATTGCACTCCAGCCTGGGCGACAGAATGAGGCTCCATCTCAAAAAA"
"GL873554","2046660","2046725","chr8","51862362","51862427","7","49815702","GGCTGGCCGCGGTGGCTCACGCCTGTAATCCTAGCACTCTGGGAGGCCGAGGCAGGCAGATCACCT","GGCCGGGCACGGTGGCTCACACCTGTAATCCCAGCACTATGGGAGGCCGAGGCAGGTAGATCACCT"
"GL873554","2580766","2581036","chr13","93262937","93263229","81","90682171","GGCCTGGGCAAGGTGGCTCACTCTCTGGAAGGCTGAGGCAGATGGATTGCCTGAGCTCAGGAGCTAGAGACTAGCATGATCTCACCTCTACTAAAAATAGAGAAACTAGCCAGGCATTACAGCACACGCTTGCAGCCCCAGCTACTCTGGGGGCTGAGGCAAAAGGATCACTTGGACTCAAGAAACTGAGGTTCCTGTGAGCCATGATGCCAGGACACTCTACCCAGGGAAACAGAGTGAGACTTCATCTCAAAAAAAAAAAGAAAGAAAA","GGCTGGGTGCAGTGGCTCACGCCTGCACTTTGGGAGGCCAAGGCAGGTGGATCACCTGAGGTCAAGAGTTTGAGACCAGCCTGGTCAACATGGTGAAACCCCATCTCTACTAAAAATACAAAAATTAGCCAGGCATGGTGGCACGTGCCTGTAATCTCAGCTACTCTGGAGGGTGAAGCAAAAGAATCACTTGAACCCAGGAGGCAGAGGTTGCAGTGAGCCAAAATCATGCCACTGCACTCTGGCCTGGGCAACAGAGTGAGACTCCATGTCAAAAAAAAAAAAAAAAAAAA"
"GL873554","5465741","5465829","chr11","47014803","47014890","15","41549062","GGCCAGGCATGGTGGCTCACGCCTGTAGTCCCAGCGCTGTGAGAGGCCGAGGCGGGTGGATCACCTGTGCTTAGAGGTTCGAGACCAGC","GGCCGGGCACCGTGGCTCACGCCTGTAATCCCAGCACTTTGGGAGGCCAAGGCGGGTGGATTACCTGAGGTTAGGAGTTCGAGACTAG"
"GL873555","8807785","8807956","chr1","12240468","12240612","48","3432683","GGCCGGGCGTGGTGGCGCACGCCTGTAGTCCCAGCGCTATGGGAGGCCGAGGCGGGTGGATCACCTGAGCTCAGAGGTTCGAGACCAGCCAAGACCCCCCTGAGCCAAACGAGCCAGAGTGAGACCCCGTCTCTACAACAACAACAGGACAACAAAACAGCCGGACCTTGTG","GGCCGGGCGCGGTGGCTCATGCCTGTAATCCCAGCACTTTGGGAGGCTGAGGCGGGTGGATCACCTGCGGTCAGGAGTTCGAGACCAGCCTGGCCAACGTGGTGAAACCTCATCTCTACTAAAAATATAAAAATTAGCTGGTGTG"
"GL873555","8828420","8828440","chr3","5439989","5440005","4","3388431","ATAATAATAATAATAAATTAG","ATAATAATAAAATAAAA"
"GL873555","12399534","12399604","chr15","102111398","102111458","22","89711864","GGCCAGGCATGGTGGCTCACACCTATAATCCTGGGAGGCTGAGGATTATCTGAGCTCAGGGATGTGAGACC","GGCCAGGCACGGTGGCTAAGGCCTGTAATCTGGGAGGCTGAGATGGGTGGATCACCTGAGG"
"GL873555","12440877","12440963","chr19","21209507","21209590","24","8768630","GTGGGGAGTGCACCTGAACTTTGGAGTTCAAGACCAGCCTGGGCAACATTGTGTGAGCCCTGTCTCAATTGGAAAACAAAACAAAAA","AGGTGGGCAGATCACCTAAGGTCAGGAGTTCAAGACCAGACTGGCAAAAATGGTGAAACCCTGTCTCTACTAAAAATAAAAAAA"
"GL873555","13094462","13094529","chr1","100916857","100916922","22","87822395","GCTTGTACCTATAATCCTGGTACTTTGGGAGCCTCAGGAGAGTGGATCACCTGAGTAAGAGCAAGACC","CATGCCTGTAATCCCAGCACCTTGGGAGGCCAAGGTGGGTGGATCACCTGAGGTCAGTAGTTTGAG"
"GL873555","13254579","13254784","chr7","32729330","32729532","64","19474751","GACCAATCTAAGCCAGAGCTGTCTATGCTAAAAATAGAATAATAAGCCTGGTTTATGGTAGGAGCCTGTAGTCTCAGTTACCTGGGTGTCTGGGGCAAGAGATTGACTTAAAACCAGGAGTTTGAGGTTGCTGTAAGCTAGGCTGACACCACAATACTCTAATCTGGGCAGAGTGAGATTCTGTCTCAAAAAAAAAAAGAAAGAAA","GAAACCCCATCTCTACTAAAAATACAAAATTAGCCAGGCATGGTGGTGCACACCTGTAGCTCCAACTACTTGGGAGGCTGAGGCAGGAGAATCACTTAAACCCAGGCAGTAGAGGTTGCAGTAAGCCAAGATCGCACCACTGCACTCCAGTCTGGGCAACAGAGTGAGACTCTGTCTCAAAAAAAAAAAAAAAAAAAAAAAAA"
"GL873555","13255065","13255153","chr10","29045352","29045442","23","15790287","CTGGGCACAGTGGCTGAGGGTGTAATCCTACCACCCTAGGAGGTTGAGGCAGAAGGATCACTTGAGCTCAGGAATTCAATACAAGTCTA","GGCGGGGCACAGTGGCTCATGCCTGTAATCCTAGTACTTTGGGAGGTCGAGGCGGATGGATCATCTGAGGTCAGGAGTTTAAGACCAGTCT"
"GL873555","13262783","13262918","chr1","29437872","29437991","30","16175089","GGCCGGGCGTGGTGGCGCACGCCTGTAGTCCCAGCACTATGGGAGGCTGAGGCGGGTGGATCACCTGTGCTCAGAGGTTCGAGACCAGCCAAGACCCCCCTGAGCCAAACGAGCCAGAGTGAGACCCCGTCTCTAC","GGCCGGGCGTGGTGGCTCACGCCTGTAATCCCAACATTTTGGGAGGCCAAGGCGGGTGGATCACCTGAGGTCAGAAGTTCGAGACCAACCTGGCCAACATGGTGAAACCCCTGTCTCTAC"
"GL873556","639117","639366","chr1","62410822","62411038","72","61771705","GGCCGGGTGTGGTGGCTCATGCCTGTTGTCCCAGCACTGTGGGAGGCCAAGGCAGGTGGATCGCCTGAGCTCAGCCAAGTTCGAGACCAGCGGAAGACCAGCATGAGGCACAGTGAGCCAGAGTGAGACCCTACCTCTACAAAACAACAACAACAACAAAAAACCCAGCCAGATGTTGTGGCAAGTGTCTGTAATCCCAGCTACATGAGGGGCAAGAGGGCAAGAGAATCACTAAAGGAGGAAGAAGTAA","GGCCGGGCGTGGTGGCTCACACCTGTAATCCCAGCACTTTGGGAGGCCAAGGTGGGTGGATCTCCTGAGGTCAGGAGTTCGAGAGCAGCCTGGCCAACATGGTGAAACCCTGTCTCTACTAAAATACAAAAATTAGCCAGGTGTGGTGGCACGTGCCTGTAATCCCACCTACTCAGGAAGCTGAGGCAGGAGAATCACTTAAAGCTGGGAGAGAGAG"
"GL873556","639390","639468","chr20","16893610","16893664","30","16254220","ACTTCAAACTAAGATAAAGTGAAAGTCAGCAGAAATTGAAAGCAAAAACAAAAACAAAAAAAAAAAAAAAAAAAAAAGA","AACAAAACAAAACAAAACAAAACAAAACAGACAAAAAAAAAAAAACAAAGAAAAA"
"GL873556","2031445","2031493","chr13","87950184","87950229","13","85918739","AGACCCTATCTCTACTAAAAATAGAAAAACTAGCCCAGTATAGTGATGC","AAACCCCATCTCTAGTAAAAATACAAAATTAGCTGGGTGTGGTGGC"
"GL873556","6655305","6655664","chr2","190010230","190010561","107","183354925","GGCCAGGCATGGTGGCTCACACCTGTAATCCTAGCACTCTGGAAGGCCAAGGGAGGTGAATTTCTTGAAGTTCGAGATCAGCCTAAGAGGAATGATACCCCACCTTTACTAGGAATAAAAAAAAAAAAAAAAAAAAACCCAAAACTAGCCTGGCATTGTGGCAGTTCTCTGTAATCCAAGCTACTTGGGAGGCTGAGGTAGAAGGATTGCTTGAACCAAAGAGTTTGACTAGAGGTTGCTGTGAGCTAGGCTAATGTCACCACACTCTATCCAGGGCAAGTGAGTGAAACTCCGTCTCAAAATAAATAAATAAATAAATAAATAAGTAAGAAAAACTTTTGCCCATAAAAAAAAAAAGAA","GGCCGGGCGCGGTGGCTCACACCTGTAATTCTAGCACTTTGGAAGGCTGAGGTGGGTGAATTGTCTGAGCTCAGAAGTTCGAGACCAGCCTGGGCAACACAGTGAAACCCCATCTCTACTAAAATACAAAAAAAAAAAAAAATTAGCTGGGCATGGTGGTGTGCACCTGTAGTCCCAGCTACTCAGGAGGCTGAGGCAGGAGAATTGCTTGAACCCAGGAGGCAGAGGTTGCAGTGAGCTGAGATCACGCCACTACACTCCAGCCTGGGCAACAGAGTGAGACTCCACCTCTTTAAAAAAAAAAAAAAGAAAGAAAGAAAGAAAGAAAGAAA"
"GL873556","10802692","10802792","chr20","28544296","28544376","36","17741604","TACAAAGAAATATCATTATTGGCCAGGTGCAGTGGTTCACATCTGTAATTCTAGTACACTAGTACTCAGGAGGATCACTTGAGGTCAGGAGCTTGTGACCA","TAGAAATGCACAATTCACCTGGGCACGGTGGCTCACTCCTGTAATTCCAGTACTTTGGGAGGCATGAGGTCAGGAGTTCAA"
"GL873557","1682363","1682659","chr6","13352322","13352625","72","11669959","GGCCAGGTGTCGTGGCTCAGGCCTGTAATCCCAGCATTCTGGGAGGCTGAGGTGGGTGGATTGCCCTGAGGTCACAGGTTCCAGACCAGCCTGAGCAAGAGCGAGACTCCATTTCTAATAAAATAGCCGGGTGTTGTGGTAGGTGCCTGTAGTCCCAGTTACTCGGGAGGCTGAGACAAGAGAATCATTTGAACCCAGGAATTTGAGGTTGCTGTGAGCTGTGATGCCACAGGACTCTACTGAGGGCAATAAAGTGAGACTGTCTCAAATAAACAAACAAACAAACAAAAACAAAAA","GGCCAGGTGTGGTGGCTCAGGCCTGTAATCCCAGCACTTTGGGAGACTGAGGTGGGCGGATCACCTGAAGTAAGGAGTTCAAGACCAGCCTGGCCTACATAGTGAAACCCCATCTCTACTAAAAATACAAAATTAGCTGGGTGTGGTGGCACGTGCCTGTAGTCCCAGCTATTCGGGAGGCTGAGTCAGGAGAATCACTTGAACCCAGGATGGGGAGGTTGCAGTGAGCCGAGATCACACCACTGCACTCCAGCCTTGGCAACAGATTGAGACTCTTTCTCAAAAAAAAAAAAAAAAAAAAAAA"
"GL873557","2465751","2465841","chr16","4764895","4764982","15","2299144","GGCCGGGCTTGGTGGTTCACGTCTGTTGTCCCAGCACTGTGGGAGGCCGAGGCAGGTGGATCACCTAAGCTCAGCCAAGTTCGAGACTAGC","GGTCGGGTGTGGTGGGTCACGACTGTAATCCCAGCACTTTGGGAGGCCGAGGCAGATGGATCACCTGAGGTCAGAAGTTCGAGACCAG"
"GL873557","4047834","4047915","chr12","77852792","77852880","22","73804958","ACAAGAGGTTGCTTTGAACTGTGATGCCACAGAGCACTATCCTGGGCAACAGAGACTCTGTCTCAAAAAAAAAAAAAAAAAA","CAGAGGTTGCAGTGAGCTGAGACTGTGCCACTGCACTCCAGCCTGCGCGACAAGAGTGAGACTCTGTCTCAAAAAAAAAAAAAAAAAAA"
"GL873557","4048202","4048390","chrX","23681445","23681631","42","19633243","GGCTGGGTGTGGTGGCTCACACCTGTGATTCTAGCACTCTGGGAGGCCAACGTGGGCAGATCACCTGAGCTTAGGAGTTCAAGACCAGTGTGAGCAAAATGAGACCCCGCCTCTACTAAAAATAGAAAAACTAGCCAGGCACTGTGGTGGGTGCCTATCATCCCAGCTACTCAGGAGGCAGGCAAGAGG","GGCCAGGCGTGGTGGCTCACGCCTGTAATCCCAGCACTTTGGGAGGCCGAGGTGGGTGGATCACCTGAGGTCAGGAGTTCAAGACCAGCCTGGCCAACATGGTGAAACCCCGTCTCTACTAAAAATATAAAAATTAGCCAGGGTGTGGTAGTGCCTGCCTGTAATCCCAGCTACTCGGGAGGCTGAG"
"GL873557","6292327","6292620","chr19","32265157","32265444","82","25972830","GTCAGGCACGGTGGCTCATGCTTGTTGGATTATCCCAACACTCTGGGAGGCCAAGGTGGATCGATTGTCTGAGCTCTGGAGTTCAAGACCAGCCTGAGCAGAAGCAAGACTCCATCTCTAAAAAAAAATAGCTGGGCATTGTGGTGGGCACTTGTATTCCTAGCTACTTGGAAAGCCTGAGGCAAGAGGATTGCTTGAACCCAAGAGTTTGAGGTTGCTGTGAGCTTAAGATGTCACAGCACTCTATAGAGGCTGAGCAAGTGAGACTCCAAAAAGTGAGTTTCCAGAAAAAAA","GACTAGGCACTGTGGCTCATGCCTGTAATCCCAGCACTTTGGGAGGCCGAGGCGGGTAGATCACCTGAGCTCAGGAGTTTCAGACCAGCCTGAGCAACATGGCAAAACCCCATCTCTACTAAACATTAGCCAGGCATGGTGGTGTGCACCTGTAATCCCAGCTACTTGGAAGGTTGAGGCAGGAGGATCACTTGAACCTCAGGAGGCAGAGGTTGCAGTGAGCCAAGATGACATGACTGCACTCCAATCTGGGTGGCAGAGCAAGACTCTGTCTCAAAAAAAAAAAAA"
"GL873557","6324546","6324617","chr1","39656281","39656348","22","33331735","CGCCTGTTGTCCCAGCACTGTGGGAGTGTGAGTAGGGTGGATCACCTTAGCTCAGCTGAGTTTGAGACCAGC","CATGCCTGTAATCCCAGCACTTTGGGAGGTCAAGGCTGGCAAATCACCTAAGGTCAAGAGTTTGAGAC"
"GL873557","6406262","6406343","chr1","199505332","199505412","11","193099070","CAGGCGCAGTGGCTCAATCCTATAATCCCAGCACTTTGGGAGGCTGAGGCAGGTGGATTACCTGAGCTCAGGAGTTTGAGAC","CCAGGCGCAGTGGCTCACACCTGTAATCCCAGCACTTTGGGAGGCTGAGGCAGGCAGATCACCTGAGGTCAGGAGTTGGAG"
"GL873557","6417612","6417692","chr13","102319052","102319128","16","95901440","GAGGTTGCTGTGAGCTAGACTGAGGCCACAGCACTCTAGCCTGGGCAACAGAGTGAGACTGTCTCAAAAGAAAAAAAGAAA","GAGGTTGCAGTGAGCTGAGATCACACCACTGCACTCCAGCCTAGGCAACAAAGTGAGACTCCAACTGAAAAAAAAAA"
"GL873557","6903406","6903510","chr16","18967946","18968045","32","12064540","AGTGCTCTGGGAGACTGAGATGGGCAAATATCTTGAGTTTAGGAGTTCCAGACCAGCCTAAGGAAGAACAAGACCCTATCTCTACTAAAAATAGAAAAAAATTCA","CTTTGGGAGTCTGAGGCAGGTGGATCTCCTGAGGTCAGGAGTTCAGGACCAGCCTGGCCAACATGGCAAAACCCCATCTCTACTAAAAATATAAAAATTA"
"GL873557","6903779","6903930","chr3","40638454","40638604","35","33734675","TTTGCCAGGTATTGTGGTGGACACCTGTAGTCCCAGCTGCTTGGTAGGCTGAGGCAGGAGGATCACTTGACCCTAGGAATCTGATGTTGCTGTGAGCTAGGCTGATGCTACAGCACTCTAGCCTGGACAACAGAGTAAGCTTCTGTCTCAAA","TAGCTGGGTGTCATGGCACACGCCTGTAGTCCCAGCTACTTGGGAGGCTGAGGCAGGAGAATCTCTTGAACCTGGGAGGCAGAGGTTGCAGTGAGCTGAGATCACGCCACTGCACTCCAGCCTGGGCAACAGAGTGAGACTCCGTCTCAAA"
"GL873557","8133022","8133316","chr19","42881134","42881434","76","34748112","GAGTGCAGTGGCTCACACCTGTAATCTTAGCACTCGAGAGGCTGAGGCAGGTGGATTGCCTGAACTCACAGCTTCGAGACCAGCCTGAGCCAGAGCAAGACCTCATCTCTAAAAATAGCCAGGAGTTGTGGCAGGCGCCTGTAGTCCCAGCTACTTGGGAGGCTGAGCAAGAGAATCGCTTGATCTCAGGAGTTTGAGGTTTCTGTGAGCTAAGACACCGCAGCACTCTACCAAGGGTGACAAAGTAAGACTCTGTCTCAAAAAATAAATAAATAAATAAATTATAAGAAAAAGA","CCGGGCAAGGTGGTTCACACCTATAATCCTAGCACTTTGGGAGGTCGAAGTGGATCGCCTGAGGTCAGGAGTTAGAGACCAGCCTGGGCAACATAGCAAAACCCCATCTCTACTAAAAATAGAAAAACTAGCCAGGTGTGGTGGCGCCTGTAATCCCAGCTACTCGGGAGGCTGAGGCAGAAGAATCGCTTGAACCCAGGAGGCAGAGGTTGCAGTGAGCTGAGATCGCACCACTGCACTCCAGGGTGACAGAGCAAGACTCTGTCTCAAAAAAAAAAAAAAAAAAAAAAAAAAAAAAAAA"
"GL873557","8171663","8171835","chr7","151280672","151280824","61","143109009","TTAGCCAGGCACTGTGCTCCCAGCTACTAGGGAGGCTGAGGCAAGAAGAGGATCACTTGGCTCGGCGCCTGTGACTCAAGTGGCTAAGGTGCCAGCCACATACACCTAAGGTGGAGGGTTCTCTACCCAGAGGGACAGCTTGAGGCTCCATCTCAAACAAAAAAAAAAGAAGA","TGGTATGCACCTGTAATCCCAGCTACTTAGGAGGCTGAGGCATGAGAATCACTTGAACCCAGGAGGTGGAACTTTTAGTGAGCTGAGATTGCACCACTGCATTCCAGCCTGGGCAACAGAATAAGACTCTATCTCAAAAAAAAAAAAAAAAAA"
"GL873557","8172121","8172252","chr11","123260550","123260686","30","115088429","CTGGGCATGGTGGCTCATACCTATAATCCTAGGACTTTGGTAGGCCGAGGCAGGTGGGTTGCTTGAGCTTAGAAGTTGAAGACCAGCCTGAACAACAGCAAGACCTTTCCCTACTCAAAACAGAAAAACTAT","GGCTGGGCAGGGTGGCTCATGCCTATAATCCCAGCACTTTGGGAGGCCAAGGCGGGTGGGTCACCTGAGGTCAGGAGTTCGAGACCAGCCTGACCAACATGGTAAGATCCCCTCTCTACTAAAAATACAAAAATTAA"
"GL873557","8260873","8260977","chr1","62231025","62231129","22","53970152","GGCTGGGCATGGTGGCTCACGCCTGTTGTCCCAGCCCTGTGGGAGGGTGAGGCAGGTGGATCGCCTGAGCTCAGCCGAGTTCGAGACCACTGGAAGACCAGCATG","GGCTGGGCATGGTGGCTCACGCCTATAATCCCAGCACTTTGGGAGGCCGAGGCAGGTGGATCACCTGAGATCAGGAGTTTGAGACCAGACTGGCCAACATGGTGA"
"GL873557","10032878","10033040","chr9","27037847","27038008","36","17004969","GGGGGTGGTGGCTCACACTTGTAATACCAGCTACTCTGGAGGCCGAGGCAGGAGAATCATATGAGCCCGGAAGTCTGAGGTTGTTGTGAGCTGGGTTAATGCCCCTGCACTCTAGCCTGGGCAACAGAGTGAGACCATGTCTCAAGGAAATAAAAAAAAAAAA","TTAGCTGGGCATGCTGGCACACACCTGTAATGCCAGCTACTCAGGAGGCTGAGGCAGGAGAATCACTTGAGCCCGGGAGGTGGAGGTTGCAGTGAGCTGAGACAGTGCCACTGTATTCTACCCTGGGCAACAGAGTGAGACTGTCTCAAAAAAAAAAAAAAA"
"GL873557","10366578","10366655","chr17","24597444","24597521","20","14230866","GCCAGGCGTGGTGGCTCATGACGGTAATCCCACCTACTCAGGAAGCAGAGGCAGGAGAATCACTTGCGCCTAGGAGAC","GGCCAGGCATGGTGGCTCATGCCTGTAATTCCAGCACTTTGGGAGGCCGAGGCAGGTGGATCACTACGTCAGGAGTTC"
"GL873557","12031816","12031985","chr11","55022806","55022982","46","42990990","TAGAAAAACTAGCCAGGCATTGTAGCGGGTGCCTATAGTTTCAGCTACTCTGGAGACTGAGACAAGATTGCTTGAGCCCGGGAATTTGAGGTTGCTGTGAGCTATTATGCCACAGCACTCAATACAGGACAATTGAGTGAAACTCCAGTCTCAAAAAAAAAAAAAAAAAA","CAAAAATTAGCCAGGCAGGGTGGTGGGCGCCTGTAGTCTCAGCTACTGGGAAGGCTGAGACAGGATAATCACTTGAACCCGGGAGGCGGATGTTGCAGTGAGCCGAGATCATGCCACTGCACTTCAGCCCGGGCAACGAGAGTGAAACTCCGTCTCAAAAAACAAAATAAAATAAAA"
"GL873557","12032023","12032144","chr1","111354387","111354508","23","99322364","GGTCAGGTGCAGTGGCTCACATCTGGAATCCTAGCACTCTGGGAGGCCGAGGAGAATGGATCCCCTGAGCTCAGGAATTCAATATCAGCCTGAACAAGTGTGAAACCTCCATCTCTACTTAA","GGCCGGGCGTAGTGGCTCACACCTGTAATCCCAGCACTTTGGGAGGCCGAGGCGGATGGATCACCTGAGTTCAGGAGTTTGAGACCAGCCTGACCAAAGTGGTGAAACCCCGTCTCTACTAA"
"GL873557","14208944","14209036","chr7","158031905","158031997","26","143822961","GGATGTGGTAGTTACTGTTTGCTATGATGACAACACTGCACTCTAACTCTGGGTGACACAGTAAGATTCTATCTCAAAACCAAAATAAAACAA","CCAGGAGGTGGAGGTTGCAATGAGCCAAGATCACACCACTGCACTCCAGCCTGGGTGACAGGGTGAGATTCTGTCTCAAAAAAAAAAAAAAAA"
"GL873558","2159034","2159070","chrX","41233833","41233871","7","39074799","ATTAGCCAGGTGTGGTGGCTTTTGCCTGTAATCCCAG","AAATCAGCCGGGTGTGGTGGCTCACGCCTGTAATCCCAG"
"GL873558","3486850","3487074","chr5","91338665","91338874","72","87851815","GGCCAGGCATGGTGGCTCATGCCTGTTGTCCCAGTGCTGTGGGAGGCCGAGGCAGGTGGATCGCCTGAGTTCAGCCAAGTTTGAGACCAGTGGAAGACCAGCATGAGGCAGAGTGAGCCAGAGTAAGACCCCATCTCTACAACAACAAAAAAAAAAAACAAAAAAAACAGCCGGACGTTGTGATCCCAGCTACATGGTGAGGGGGAGGGGAACAGGAGAATCACT","GGCCGGGCATGATGGCTCATGCCTGTAATCCCAGCACTTTGTGAGGCCGAGGCAGACTGATCACTTGAGGCCAGGAGTTCGAGACCAGCATAGCCAACAAGATGAAACACCATCTTTACTGAAAATACAAAAAAAAAAAAAAATAGCCGGATGTGGTGATACCTGCTTGTAATCCCAGCTGCTTGGGAGGCTGAGGCAGGAGAATCTCTT"
"GL873558","3884156","3884240","chr4","24638016","24638099","18","20753860","CCAGACACAGTGGCTTAAGCCTGTAATCCTAGCACTTTGGGAGGCTAAGGTGGATGGATCTCCTGAGCTCAGTAGTTTGAAGCTA","GCCAGGCATGGTGGCTCATGCCTGTAATCTTAGCACTTTGGGAGGCCAAGGTGGGCGGATCATCTGAGGTCAGGAGTTTGAGAC"
"GL873558","5037604","5037746","chr3","2138380","2138521","38","2899224","GCTGGGCCTGGTGGCTCACATCTGTAACCCTAACACTCTGGGAGGCCAAGGCAGGAGGATCTCTTGAAGCTAGGTTGTTAGCCAGGGCGACCCCACAGCACTCTAGCCTGGGGCAACAGAGTGAGACTTTGTCTCCAAACAAA","AGCTGGATGTGGTGGCCCACACCTGTAATCACAGCTACTCGATAGGCTAAGGCAGGAGAATCGCTTGAACCTGGGAGGCGGGGACTGCACCATCACAGCACTCCAGCCTGGGTGACAGAGTGAGACTATGTATCAAAAAAAA"
"GL873558","6488648","6488700","chr3","39516725","39516768","23","33028077","ATAGCACTCTACCATGGGTGACAGAGTGAGACTATCTCCCCCCCTCAAAAAAA","GAGACCAGCCTGACCAACACAGTGAAACCTCATCTCTACTAAAA"
"GL873558","6489359","6489583","chr10","19070944","19071172","64","12581585","GGCTGGACATGGTGGGTCCTGTAATCCTAGCACTGTGGGAGGCCGAGGCAGGTGAATTGCTTGAGCTTATGGGTTCAAGACCAACCTGAGCCAGAAGGAGACCTTGTCTCTAAAAATGGCTGGGTGTTGTGGCAGGCACCTATAATCCCAGCTACTTGGGAGGCTGAGGCAAGAGAATCGCTTGAACCCAAGAGTTTGATGTTGCTGTCAGCTAAGATGCCATAG","GGCTGGGCTCAGTGGCTTATGCCTGTAATCCCAGCGCTTTGGGAGGCCAAGGCGGGTGGATCACCTGAGGTCAGGAGTTCGGGACCAGCCTGAACAACATGGTGAAATCCCGCCTCTACTAAAAAAAAGCCGGGTGTGGTGGCATGCACCTGTAATCCCAGCTACTTGGGAGGCTGAGGCAGGAGAATCACATGAACCTGGGAGGCAGAGGTTGCAGTGAGCTGAGATC"
"GL873558","14631848","14632045","chr18","1878493","1878704","62","12753355","GGTGCAGTGGCTCACGCCTTTAATCCCAGCACTTGGGATGGTGAGGCAGGTAGATTGCCTAAGTTCACAGGTTCAAGACCAGCCTGAGCCAGAGAGACCCTACCTCTAAAAAATAGCCAAGCATTGTGGCAGGCACCTGTAATCCTACTTAGGAGGCTGAGTCAAGAGGATCATTTGAGCTTAAGAGTTAGAGCTTGT","GGCCAGGCATGGTGGCTCACGCCTGTAATCCCAGCACTTTGGGAGGCCGAGGCGGGTGGATCACAAGGTCAGGAGTTCAAGACCAGCCTGGCCAACATGGTGGAAGCCCATCTCTACAAAAAATTAACTGGGCGTGGTGGCAGGCACCTGTAATCCCAGCTACTTGGGAGGCTGAGGCAGGGGAATTGCTTGAACCTGGGAGGCGGAGGTTG"
"GL873558","14632352","14632392","chr7","10117723","10117763","10","4514629","GAGTTAGAGCTTGCTGTGAGCTAAGATGCCACGGCACTCTA","GAGTTAGTTGCAGTGAGCTGAGATCGTGCCACTGCACTCCA"
"GL873559","8193331","8193614","chr20","11734223","11734512","71","3540892","CAGGTACGGTGACTTATCCCTGGAATCTTAGAACTGTCTGAGTCCAAGGTGGGAGGATCATTGGAGGTCAGGAATTTGAGACCAGCCTGAGCAAGAGTGAGACCTCTTCTCTACTAAATATAGAAAAATTAGCCAGGGTTTGTGGCAGGTGCTTATAGTCTAAGCTTCTTAGGAGGCTGAGGCAGGAGAATCTCTTGAACCCATGAGTCTGAGGTTGCCCTGAGTTAAGATGACATCACTGCAGTCTCCCCAAAGCAACGGAGTAAGACTCTGTCTCAAAAACA","GGCCAGGCACGGTGGCTCATGCCTCTAATCCCAGCATGTTGGGAGGCCGAGGTGGGCGGATCACATGAGGTCAGGAGTTTGAGACCAGCCTGGCCAACATAGTGAAACCCTGTCTCTACTAAAAATACAAAAATTAGCCAGGTGTGGCAGCACGTGCCTGTAGTCCCAGCTAGTCAGGAGGCTGAGGCAGGAGAATCACTTGAATCCACCAGGCGGAGGCTGCAGTGAGCCAAGATCACACCACTGCATTCCAGCCTGGGCGACAGAGCAAGACTCTGTCTCAGAAAAAA"
"GL873559","8193642","8193657","chrX","1083699","1083714","0","7109943","AAATAAATAAAATAAA","AAATAAATAAAATAAA"
"GL873560","393252","393440","chr11","121440472","121440639","55","121047220","CTGGGCAGGGTGGCACACACCTGTCATCCCAGCATGTTGGGAAGCTGAGGCAGGAGAATTACTTGAGCTCAGATTCCAAGAGGTGAGGATCACTTGAGCCTAGAAGTTGAGGCTGCACTGATGCCCCAACACTCCAGCCTGGGCAACAGAGCAAGGTCCTGTCCCAAAAAGAAAAAAAGAAAAGGAAAA","GCTGGGCGCAGTGTCTCACGCCTGTAATCCCAGCTATTTGGGAGGCTGAGGCAGGAGAATTACTTGAACCTGGGAGGTGGAAGTTGCAGTGAGCCGAGATCCTACCATCGCACTCCAGTCTGGGCAACAAGAGCAAAACTCTGTCTCAAAAAAAAAAAAAAAAAAAAA"
"GL873560","4038833","4039014","chr12","78258009","78258208","56","74219176","GGCTGGGTGCGGTGACTCACACCTGTAATCCCAGCACCTGGAGGCCCAAGGCAGGGTGGATTGTCTGAGCTCACAGGTTCAAGACCAGCCTGAGCCAGAGCGAGACCTAAAAATAGCTAGGCGCTGTGGGAGGCACACGTAGTCCCAGCTACTCAGGAGGCTGAGGCAAGAGAATCACTTGA","GGCTGGGCACGGTGACTCACGCCTGTAATCCCAGCACTTTGGGAGGCCCAGGTGGGTGGATCACCTGAGGTCAGGAGTTCAAGACCAGCCTGGCCAAGATGGTGAAACCCCGTCTCTACTAAAAATACAAAACTTAGCTGGGCATGGTGGCGGGCACCTGTAATCTCAGCTAGTCGGGAGGCTGAGGCAGGAGAATCTCT"
"GL873560","4492531","4492643","chr7","56485655","56485756","37","51993124","AACAGAAAAACTAGCCAGGCATAGTGGTGCATGCCTGTTGTTCCAGCTGCTCTAGAGGCTAAGGCAAGAGGATTGCTCCAGCTCAATAGTTTGAGGTTGCTGTGAGCTTGAGA","TTAGCTGGGCATGGTGGAGCACACCTGTAATTCCAGCTACTCAGGAGGCTGAGGCAAAAGAGTTGCTTGAACCCAGGAGGCAGAGGTTGCAGTGAGCCGAGA"
"GL873560","4492670","4492771","chr8","41603464","41603564","28","37110794","AGCACTCTGGGTGACTGAGGCAGGATTACTTGAGCTCAGGAGTTTATGACCAGCCTGAGCTGGTCCTTGATCAAGACTCCATCTCTACTAAAAAAACAAACA","CACTTTGGGAGGCCGAGGCAGCAGATCACTCGAGGTCAGGAGTTTGAGACCAGCCTGGCTAACATGGCAAAACCCCATCTCTACTAAAAATATAAAAATTA"
"GL873560","8106775","8106882","chr11","111878590","111878685","39","103771815","ACATAAGAATCAGGCCAAGCCTTGTGGCTCCTGTATGTGATTCCAGCACTGGGAGGGCAAGGCAGGAGGATCCCTGACGTCAGGAACTCAAGGCTGCCCAAGTATCAT","GGGCACAGTGGCTCATGCCTGTAATCCCAGCACTTTGGGAGGCCAAGGCGGGTGGATCACCTGAGGTCAGGAGTTCAAGACCAGCCTGACCAACAT"
"GL873560","10872201","10872272","chr7","9971011","9971083","11","901190","GGCTGGGCACAATGGGTCACACTTGTAATCCCAACACTTTGGGAGGCTGAGGTGGGCAGATCACCTGAGCTC","GGCTGGGTGGGGTGGCTCACACATGTAATCTCAGCACTTTGGGAGGCTGAGGTGGGCAGATCACCTGAGGTCA"
"GL873560","11043320","11043410","chr6","111928830","111928919","19","100885510","CAGGCGAAGTGGCTCATGCCTATAATCCTAGCATTCTGGGAGGCTGAGGTGGGAGAATCCCCTGAGGTCAAAAGTTCAAGACCGGCTTGGC","GGCCAGGCTCAGTGGCTCATGCCTGTAATCCCAGCACTTTGGGAGGCCGAGGTGGGTGAATCACCTGAGGTCAGGAGTTCAAGACCTGCC"
"GL873561","5890611","5890936","chr8","76222061","76222392","77","70331450","GGCTGGGCCTGGTGGCTCATGCCTATAATCCTAGCACTCTGGGAGGCAAAGGTTGGTGGATTGCTTAAGCTCAGGAGTTCAAGACCAGCCTGATTAAGAGTGAGATCCCATCTCCACTAAAAATAGAAGGGAAAAAAAAAAAAAAAAAACCTAGTTGGGCTTGGTGGCAGCACTTGTAGTCCCAGCTATTTAGGAGGCTGAGGAAAGAGAATCACTTGAACCCAAGAGTTTGAAGTTGCTCTGAGCTATGATGCCATAGAACTCTACCCAGGGTGACAGAGTAAAACTGGATCTCAAATAAATAAATAAATAAATACATAAATAAA","GGCTGGGCATGGTAGCTCATGGCTGTAATCCTAGCACTTTGGGAGGCCAAGGAAGGTGGATTGCCTGAGCTCAGGAGTTCAAGACCAGCCTGGGCAACACAGTGAAATCCTGTCTCTACTAAAATACAAAAAAGAAAAAAAAAAAAAAAAAAAACAGCTGGGCATGGCAGTGTGCACTTGTAATCCCAGCTACTCAGGAGGCTGAGACAGGAGAATCACTTGAACCCGGGAGGCAGAGGTTGCACTGAGCCGAGATTGTATCACTGCACTCCAGCCTGGGTGACAGAGCGAGACTCTGTCTCAGAAAAAAAAAAAAAAACAAAAAAACAAAA"
"GL873561","10859256","10859475","chr6","100119122","100119352","73","89259866","GGATCACTTGAGCTCAGGAGTCAAGACCAACTTGAGTAAGAGTGAGACCCTGTCTCTACTAAAAATAAAATATATAGCCAGGCATTGTGCTGGGCACCTATATATAAGCTAAAATGGAGTCTTAGCTACCTCCTTGAACTTGAACCCAGGAGTCTGAAGTTGCTTTGAGCTAGGCTGATGCCACTGCACTTTACCCAGGCAACAGAGTGAGAGTATCTAA","GGATCACCTGAGGTCAGGAGTTCAAGACCAGCCTGGCCAACATGGTGAAACCCCGTCTCTACTAAAAATACAAAAACTAGCCAGGCATGGTGGCGCACACCTGTAGTCCCAGCTACTTGGGAGGCTGAGGCAGAAGAATCTCTTGAATCCGGGGGTTGGAGGTTGCAATGAGCTGAGATCATGCCACTGCACTCCAAGCCTGGGTGACAAGAGCGAAACTCCATCTCAAAA"
"GL873561","10859563","10859576","chr4","114457728","114457741","1","103598165","AAAAAAAAATAAAA","CAAAAAAAATAAAA"
"GL873562","12189469","12189706","chr1","31551552","31551790","75","19362083","CAGTGGCTCACGCCGGTAATCCCAGCACCTTGGGAGCTGAGGCAGGCAGATCTCCTGAGGTCACGTGTTTTGAGACCAGCCTGAGCTAGAGTGAGACCCCACCTCTAAAAATAGCCAGTCGCCTGTAATCCCAGCTACTCGGGAGAAACCCAGGAGTCTAAGGTCGCTGTGAGCTGACACCTCAGCACTCTGCTGGGGTAACAAAGTGACACTTTGTCTCAAAAAAATAAATAAATAT","GCAGTGGCTCACGCCTGTAATCCCAGCACTTTGGGAGGCCAAGGCGGGTGGATCACCTGAGGTCAGGAGTTCAAGACCAGCCTGGCCAACATGGTGAAACCTCATCTCTACTAAAAATACAAAACAGGAGAATCGCTTGAACCCGGGAGGTAGAGGTTGCAGTGAGCTGAGATAGTGCCACTGCACTCCAACCTGGGCAACAGAGTGAGACTCCGTCTCAAAAAAATAAAAAATAAAAA"
"GL873562","4526861","4526913","chr13","94764706","94764759","14","90237845","GTGAGACCTTGTCACTACTGAAAATAGAAAAATTAGCTGGGCATGGTTGTAGG","GTGATGAAACCCCATCTCTACTAAAAATACAAAAATTAGCTGGGCTTGATGGTG"
"GL873562","4789223","4789313","chr10","47852509","47852598","25","43063286","GGCCAGGAGAAGTGGCTAACACCTGTAATTCCAGCACTCTAGGAGATGGAGGCAGGGACCAGCCTGAGCTAGAGTGAGTGAGACTCCATCT","GGCCAGGTGCAGTGGCTCACACCTGTAATCCCAGCAACTTTGGGAGGCTGAGGCAGGCAGATCACTTGAGGTCAGGAGTTCGAGATCAGC"
"GL873562","4868605","4868801","chr16","54069750","54069948","44","49201145","GGCCAGGCATGGTGGCTCATGCCTGTAATCCTAGCACTCTGAGAGACCAAGGCTGATGAATCACCTGAACTCAGGAGTTGAGACCAGCAGGAGCAAAAGTGAGATCCCATCTCTACTCAAAAATAGAAAATTAGTTCAGGCAAGGTGGCACATACCTGTAATCCCAGCACCCTGGGAGGCTAAGGTGGGTGGATTGC","GCCCAGCGCAGTGGCTCATGCCTATAATCCCAGCACTTTGGGAGGCCAAGGCGGGTGGATCACCTGAGGTCAGGAGTTCGAGACCAGCCTGCCCAGCATGGTGAAACCCCATCTCTGTTAAAAATATAAAAATTAGACTAGGCGCGGTGGCTCACACCTGTAATCCCAGCACTTTGGGAGACCAAGGTGGGCGGATCAC"
"GL873562","4929184","4929360","chr10","37539693","37539877","47","32610509","GGCCAAGCTCAGTGGCTCTCCCTAGCACTTTGGGAGACCGAGGTGGGTGGATTGCCTGAACTCAGGAGTTCTAGACCAGCCTGATCAAGAGCAAGACCCTACATCTACTAAAAATAGAAAAACTAGCTGGGCATTATAGTACGCACCTGTACTCCCATCTACTCTGGAGGCTGAGGC","GGGTGCAGAGGCTTATGCCTGTAATCCCAGCACTTTGGGAGGCAGAGGTGGGTGGATCACTTGAGGCCAGGAGTTCAAGACCAGCCTGGTCAATGTGGTGAAACCTCGTCTCTACTAAAAATACAAAAATTAGCCGGGCATGGTGGCATGCATCTGTAGTCCCAGCTACTTGGGAGGCTGAGGCA"
"GL873562","5446395","5446678","chr16","63692714","63692996","79","58246319","GGCTGGATGCAGTGGCTCATACCTGTCTGTAATCCTAGCACTCTGGGAGGTCGAGGTGGGTGGATTGCCTAAGTTCACAGGTTCGAGGCCAGCCTAAGCAAGAAGAGCAAGACTCCATCTCTGAAAGTAGCCAGGCATTGTGACAGGCGCCTATAGTCCCAGCTACTTGGGAGGCTGAGGCAAGAGAATTGAGCCCAGGAGTTAGAGGTTGCTGTGAACTAGGACTCCATAGCATTCTACTGAAGGTGACAAAGTGAGATTCTGTCTCAAAAAAAAGACTGATT","GGCTGGCTGCGGTAGCTCACCCCTGTAATCCCAGCACTTTGGGAGGTCAAGGCAGGTGGATTGCCTGAGGCCAGGAGTTCGAGGCCAGCCTGACCAATATGGCAAAACCCTGTATCTACTAAAAACTAGCTGGGCATGGTGGCATACACCTGTAGTCCCAGCTACTTGGGAGGCTGAGGCAGGAGAATTGCTTGAACCTGGAGGCAGAGGTTGCAGTGAGCCAAGGCTGCCCCACTGCACGCCAGCCTGGGTGACAGAGTGACACTCCATCTCAGAAAAAAAA"
"GL873562","8499356","8499477","chrX","91860022","91860139","29","83360666","GGCTGGGTGTGCTGGCTCATGCCTGTAATCCTCGCACTCTGGGAAGCTAAGGCAGGTGGATTGCCTGAGCTTATGAGTTTAAGACTAGCCTGAGCCAGAGCAAGACCTTGTCTCTATTTTTT","GCCGGGTGTGGTGGCTCATGCCAGTAATCCTAGCACCTTGGAAGGCTGAGGCAGGTGGATTGCCTGAGCTCAGGAGCTTCAGACTAGCCTGGGCAACATAGTGAAACCCCATATCTCT"
"GL873562","8499731","8499918","chr7","167658032","167658223","45","159158301","AAGACCTTGTCTCTAAAAATAGCCAGGTGTTGTAGCAGGCACCTGTAGTCCCAGCTACTTGGGAGGCTGAGACAAGAGAATTGCTTGAGCCCAAGAGTTTGAGGTTGCTGTGAGCTGAGATGCCATGGACTCTATCGAGGGCAGTAAAGTGAGACTCCGTCTCAAAAAAAAAAAAAGAAAGAAAAGAA","TACTAAAATACATACAAAAATTAGCCAGGTATGGTGGCAGGCCCCTGTAGTCCCAGCTACTCGGGAGGCTGAGGCAGGAGAACTGCTTGAACCCAGGAGGTGGGGATTGCAGTGAGCTGAGATCGCACCACTGCACTCCAGCCTGAGCGACAGAGTGAGACTCTGTCTCAAAAATAAAAAAAGAAAAAAAAA"
"GL873562","10216295","10216385","chr1","44313085","44313176","34","34096790","TAAAAATACATTGAACCAGATTCAGTGGCTCACACCTGTGCTCCTAGCTACCCAGTGGCTGAGGCTGAAGGATGGCTTGAATCTCAAGTTC","TTACAGATCATTTGGGGCTAGATGTAATGGCTCACACCTGTAAGCCCAGTGCTTTGGGAGGTTGAGGCAGGAAGATGGCTTGAACCTAGGAG"
"GL873562","11812352","11812435","chr19","44513406","44513491","17","32701054","GGCCGGTACGATGGCTCAGGCCTATAATCTTAGAACTCTGGGAGTCCGAGGTGGGTGGACTGCCTGAGCTCACAGTTCGAGACC","GGCCGGACGCGCTGGCTCACGCCTGTAATCCTAGCACTTTGGGAGGCTGAGGGGGGCGGATAGCCTGAGCTCAGAAGTTCGAGACC"
"GL873562","12179920","12180054","chr14","8268315","8268451","18","3911605","GGCCAGGCATGGTGGCTCACACCTATAATCCTAGCACTCTGGGAGGCCAAGGCAGGTGGATCACCTGAGCTCAGGAGTTTAAGACCAGCCTGAGCAAGAGTGACAACCTATCTCTATTAAAAATACAAAAACTAG","GGCCGGGCATAGTGGCTCACACCTATAATCCCAGCACTTTGGGAGGCCAAGGCAGGTGGATCACCTGAGGTCAGGAGTTCGAGACCAGCCTGACCAAGATAGTGAAACCCCGTCCCTACTAAAAATACAAAAATTAA"
"GL873562","14017684","14017885","chr2","94000404","94000565","73","79982720","CAAGCTAGCCTAGGGATGTGGAGGTACCTGTAGTCCCAGTTACTTCATTGGCTGAGGCTTAAACCCTCTTGGATGGTCTCACTCTGTCACCCTGGTAGAGTGTTGTGGCATCATGTGTCACAGGAGGTTGAGGTTGCTGTGAGCTGTGATGCCACAACATTCTACCAGGGTGACAGAGTGAGACTCTGTTTCAAAAACAAAA","AAACTAGCCTGGCGTGGTGGTGTGTGCCTGTAATCCCAGCTACTTGGGAGGCTGAGACAGGAGAATCACTTGAACCTGGGAAGTGGAGGTTGCAGTGAGCTGAGATCATGCCACTGCACTCCAACTTGGGCAACAGAGCGAGACTCTGTTTCAAAAAAAAAA"
"GL873562","14017915","14018042","chr1","161382752","161382881","27","147364837","GGCTGGGCACGGTGGCTCACACTTGTAATTCTAGCACCCTGGGAGGCCAGCGTGGGTGGTTTGCTTGAAGTTAGGAGTTCAAGACCAGCCTGACCAAAGTGAGACCACATCTCGACTAAAAACAAACA","GGCTGGACGCAGTGGCTCATACCTGTAATCCCAGCACTTTGGGAGGCCGAGGTGGGTGGATCACCTGAGGTCAGGAGTTCAAGACCAGTCTGGCCATGGTGAAACCCCATCTCTACTAAAAATACAAAAA"
"GL873563","2645481","2645758","chr1","37954757","37955032","69","35309276","GGCTGGGTGCCATGACTCACGCCTGTCATCCCAGCTCTCTGGGAGGTCACAATGGGAGTATTCCATGAGCTCAGAAGTTTGAGACCAGTCTGAGCAAGAGCAGACTCCATTTCTACTAAATATAGAAAAATTAGCCCAGTATGGTTGTGCACACCTGTAGTCCCAGCTACTTGGGAGCTGAAGCAGGAAAACGGCTTGAGTCCAGGAGTCGGAGGTTGCTGTGAGCTGAGAGCTATAATGATGCCAGTGCACTCTACCCAGGCAACAGAGCAAGACTC","GGCCGGGTATGGTGGCTTACGCCTGTAATCCCAGCACTTTGGGAGGCCAAGGTTGGCAGATCACCTGAGGTCAGGAGTTCGAGACCAGCCTGGCCAATATGGCGAAACCCCGTCTCTACTAAAAATACAAAAATTAGCTGGGCATGGTGGCGCATACCTGTAATCCCAGCTACTCGGGAGGCTGAGGCAGGAGAACTGCTTGAACCCAGGAGGTGGAGGTTGCAGTGAGCCGAGATTGAGCCACTGCACTCCAGCCTAGGTGACAGAGTAAGACTC"
"GL873563","2646059","2646097","chr1","62915138","62915167","12","60269079","CAAACAGAACAAGACTTTGTTTCAAAAAAAAAAAAAAAA","CAAACAAACAAACATCACAAAAAAAGAAAA"
"GL873563","2651001","2651167","chr2","69424628","69424798","38","66773627","GTACAAAAATTAGCCAGATGTCTTGGTGCTTATAGTCAGCAACTCAGGAGGCTGAGGCAGGAGGATCACTTGAACCCCTGGAATTTGAGGTTGCTGTGAGCTAAGTTGATGCCACGGCATTCTAGCCTGGGTGACAGAGTAAGACTCCATCTCAATAAATAAATAAA","AAAAAAATTAGCCAGGCATGGTGGTGCATGCTTGTAATCCCAGCTACTTGGGAGGCTGAGGCAGGAAGATCACTTGAACCTGGGAGGCGGAGGTTGCAGTGAGCCAAGATTGTGCCACTGAACTCCAGCCTGGGTGACAGAGCAAGACTCCATCTCAAAAAAAAAAAAAAA"
"GL873563","2651449","2651584","chr3","121251018","121251153","32","118599569","GGTCCAGTGAGGTGGTTCAGACCTGTAATCCTAGCATTCTGGGAGGCTGAGGTGAGCAGATTGCTTGAGCTCAGTGAGTTTGAGACCAGCCTGAATAAAAGCAGCACCCCATCTCTACCAAAAGTAGGAAAATTAT","GGCCAGGTGCAATGGCTCACACCTGTAATCCCAGCACTCTGGGAGGCCGAGGTGGGCAGATCACCTGAGGTCAGGAGTTTGAGATCAGCCTGGCCAACCTGGCAAAACCCCATCTCTAATAAAAATACAAAAATTA"
"GL873563","6898038","6898117","chr6","28153994","28154075","27","21255956","AAAAAACAGAAAAATTAGTTGGGTGTGGTAGTGGGTAGCTACTTGGGAGGCTGGGGCAGGAGAATCACTTGAACCCAGGA","AAAATTAGCCGGGTGTGGTGATGCATGCCTCTAATCCCAGCTACTTGGAAGGCTGAGGCAGGAGAATCACTTGAAGGCAGGA"
"GL873563","6898395","6898520","chr5","140939246","140939381","30","134040851","GGGGGTGGTGGCTCATGCCTGTAATCCCAGCACTCTGGCTGAGACAAGTGGATTGCATGAGCTCAGGAGTTCAAGACCAGCTTGAGGAAGAACAAGACTCCATCTCTACTAAAAATAGAAAAATTT","GGCCCGGTGCTGTGGCTCATGCCTGTAATCCCAGCACTTTGGAAGGCTGAGGCAGGTGGATCCCTTGAGGTCAGGAGTTCGAGACCAGCATGGCCAACATGGCAAAATCCCATCTCTACTAAAAATACAAAAATTA"
"GL873563","7811395","7811530","chr1","29437872","29437991","31","21626477","GGCCGGGCGTGGTGGCTCATGCCTGTAGTCCCTGCACTGTGGGAGGCCGAGGCGGGTGGATCACCTGTGCTCAGAGGTTCGAGACCAGCTAAGACCCCCCTGAGCCAAATGAGCCAGAGTGAGACCCCGTCTCTAC","GGCCGGGCGTGGTGGCTCACGCCTGTAATCCCAACATTTTGGGAGGCCAAGGCGGGTGGATCACCTGAGGTCAGAAGTTCGAGACCAACCTGGCCAACATGGTGAAACCCCTGTCTCTAC"
"GL873563","7855904","7856041","chr3","37342340","37342469","34","29486436","GCCAGGGCAGTGGTTCACACCTGTAAAAACCCCAGTATTTTGAGAAGCCAAGTTGGGAGGATCACATAAGGTCAAGAGTTTGAGACCAGCCTGGACAACACAGTATAAGACTCCCATCTCTATTTTGTTAAATATACA","GCCGAGCGCGTGGCTCACGCCTGTAACCCCAGCACTTTGGGAGGCCAAGGTGGGTGGATCACTTGAGGTCAGGAGTAGGAGACCAGCCTGGCCAACATGGGTGAAACCCCACCTATAGTTTAAAAATATA"
"GL873563","8381194","8381392","chr2","167568017","167568216","65","159186823","GGCCAGTGCAGTAGCCCACACCTGTAATCCTAGCACTCTGGGAGGCCAACTCTGGTAGAGTTTGAAACTAGCCTGAGCAAGAGCGAGACCTTGTCTTCACTGAAAAAAATAGAAAAAAAAAAAAAAAACTAACTGGGCATGGTGCTGTACATCTGTAGCCCGAGCTACTCAGGAGTCTGAGGCAAGAGGATTACTCAAT","GCCAGGCGAGGTGGCTCATGCCTGTAATCCCAGCACTTTGGGAGGCCAAAGTGGACAGATTACCTGAGGCCAGGAGTTTGAGACCAGCCTGACCAATATGGTGAAACCCCATCTGTACTAAAAATACAAAAATTAGCAGGGCGTGGTGGTGTACACCTGTAATCCCAGCTACTCAGGAGGCTGAGGCAGGAGAATCTCTT"
"GL873563","8381923","8382014","chr2","92370724","92370803","33","83988801","GGATTGCTCAAGCCCAAGAGTTTGAGGTTGCTGAGAGCTATGACACTACAGCACTCTACTCTACCCAGGGCAACAGAGTGAGACAAAAAAAA","TTGCTTGAACCCAGGAGCTAGAGGTTGCAGTGAGCTGAGATTGCACTATTGCACTCCAGCCTGGGCAACAGGGTGAGACT"
"GL873563","9500422","9500552","chr19","10830410","10830544","33","1329988","GGTCAGGTGCAGTGGTCACCTGTCATCCTACCCCTCTGGGAGGCCAAGGTGGGTGGATTGCCTGAGTTCAGGAGTCTGAGACGAACCTGAGCTAGAGCAAGACCTCATCTCTTAAAAAATAGCCAGCATTC","GGCCAGGTGCAGTGGCTCATGCCTGTAATCCCAGCACTTTGGGAGGCCAAGGTGGGTGGATCACCTGAGGTCAGGAGTTCGAGACCAGCCTGATCAACGTGGTGAAACCCCATCTCTACTAAAATTGCAAAATTA"
"GL873563","9501087","9501192","chr16","71049107","71049211","33","61548020","TAAAACCTATAATGTTTGAAAATAAAAATAGCCAGGCCTTGTTGTGGGTGCCTGTAGTCCCAGCTACTTAGGAGGCTGAGGTAAGAGGATTGCTTGAGCCCAAGAG","TGAAACCCCATCTCTACTAAAAATACAAAATTAGCCAGGTGTGGTGGTGCATGCCTATAATCCCAGTTACTTGGGAGACTGAGGCAGGAGAATCACTTGAACCTG"
"GL873563","10991062","10991128","chr1","22619342","22619410","11","11628280","GGCCGGTGTAGTGGCTCACGCCTGTAATCCCAGCACTTTGGGTGCCGACATGGGCAGATCGCCTGAG","GGCCGGGCGCGGTGGCTCACACCTGTAATCCCAGCACTTTGGGAGGCCGAGGTGGGCGGATCACCTGAG"
"GL873563","12252577","12252738","chr8","144193624","144193784","41","131941047","GGCTGGGTACAGTGGCTCATATCTGTAATCCTAGCACTCCAGGAGGCTGAGGTGGGAGGATAATTGCCTGAAGTCAGAAACACAAGACCAGCCCAAACAAGAGTGAGACACCATCTCTACTAAAAATAGAAAACTGAGCTGGGTGTGGCGGTGCACACCTGT","GGCCGGGCATGGTGGCTCATGCCTATAATCCTAGCACTTTGGGAGGCCGAGGTGGGCGAATCACCTGAGGTCAGGAGTTTGAGACCAGCCTGGCCAACATGGTGAAACCCCATCTCTACTAAAAATACAAAAATTAGCTGGGTGTGGTGGCACATGCCTAT"
"GL873564","1384131","1384395","chr13","32253035","32253303","64","30868904","GGGGGGGGGGGCACACTGGCCTGTAATTCTAGCACTCTGAGAGGCCAAGGCAGGTGGATCACCTGAACTCAGGAGTTCGAGACCAGCCTGATCAAGAGTGAAACCCTGTCTCTACTAACAAGAGAAAAACCAGTAGTCCCAGCTACTCAGGAGGCTGAGGCAGAAGAATCACTTGAACCCAGGAGTTTGAGGTTTCTGTGAGCTACAGTAGTGCTATGGCACTCTACCAAGAGTGACAGAGTGAAACTCTGTCTCAAAAAAAAAA","GCTGGGCATGGTGGCTCATGCCTGTAATCCCAGCACTTTGGGAGGCTGAGGCGGGTGGATCATCTGAGGTCAGGAGTTCAAGACTAGCCTGGGCAACATGGTGAAACCCTGTCTCTACTAAAAATACAAAATTACAGGTAATCCCAGCTACTTGGGAGGCTGAGGCAGGAGAATCGGTTGAACCCAGGAGGCGGAGGTTGCAGTGAGCTGAGATCATGCCACTGCACTCCAGCCTGGGCAATAGAATGAGACTCTGTCTGAAAAAAAAA"
"GL873564","2543879","2544121","chr1","199402350","199402570","73","196858471","GGCCAGGTGTGGTGGCTTACGCCTGTTGTCCCAGCGCTGTGGGAGGCCGAGGCAGGTGGATTGCCTGAGCTTAGCTGAGTTTGAGACCAGCGGAAGACCAGCATGAGGCAGAGTGAGCCAGAGTGAGATCCTGTCTCTACAAAAAAGAAAAAAAAAAAAACAGCCGGATGTTGTGGCGCGCGTCTGTAATCCCAGCTACATGGGGGTCAAGAGGGCAAGAGAATCATACAGGAGGAAGAAGTT","GGCCAGGTGTGGTGGCTCACACCTGTAATCCCAGCACTTTGGGAGTCTGAGGCGGGTGGATTGCCTGAGGTTGAGAGTTTGAGACCAGCCTGGCCAACATGGTGAAACCCTGTCTCTACTAAAAACACAGAAATTAGCCAGGCATGGTGGCGCATGTCTGTAATCCCAGCTACCCTCCTGGAGGCTGAGGCAAGAGAATCACTTGAACCCAGGAAGCAGAG"
"GL873564","4859126","4859236","chr9","15245726","15245837","31","10386600","GTGGCTCATGCTTATAATCCAATCACTATGGGAGACCAAGGTGGGGATGGGCGGAGATCACCCTCAGGAGTTGGAGACCAGCCTGAGTTAAGAGTGATACCATGTCTCTAC","GTGGTGTCTCACGCCTATAATCCCAGCACTCTGGGAGGCCAAGGTGGGCAGATCACCTGAGGTCAGGAGTTAAGAGACCAGCCTGGCCAACATGGTGAAACCCTGTCTCTAC"
"GL873564","4859490","4859678","chr8","126054004","126054184","54","121194514","CATGTCTCTATTAAAGGTAGAAAAATTAGCCGAAGTATTGTAGTTGGGCTGTATAGTCCCAACTACTGAAGAGGCTGAGACAGGAGGATTGCTTACAACTAGGAGTTTGAGGTTGCTGTGAGCTAGGCTGATGCCAAGGTGCTCTAGCCTGGGCAACAGAATGAGACAATGTCTTAAACAACAAAAAAA","GTCTCTACTAAAAATACAAAAATTAGCTGGGTGTGGTGGTGCATGCCTGTAATCCCAGCTACTCAGGAGGCTGAGGCAGGAGAATCGCTTGAACCCAGGAGGTAGAGGTTGCAGTGAGCCAAGATCATGCCACTGCACTCCAGCCTGGGTGACAGAGGGAGACTCTGTCTCAATAAATAAA"
"GL873564","5294014","5294069","chrX","11604904","11604969","20","6310890","GGGTGTGGTGACTTGCACTTACAATCAGCACTTTGGGAGGCGAAGGTAGGAGCATC","GGCTGGGTGCAGTGACTCACGCCTGTAATCCCAGCACTTTGGGAGGCTGAGGTAGGCAGATCACCT"
"GL873564","5294155","5294257","chr15","310129","310227","21","4984026","GGCTGGGTGTGGTGGCTCACGTCTGTTGTCCCAGCGCTATGGGAGGCTGAGGAGGGTGGATCACCTGAGCTCAGAGGTTCGAGACCAGCATAAGACCAGCATG","GGCTGGGCGCAGTGGCTCACGCCTGTAATCCCAGCACTTTGGGAGGCCAAGGCGGGTGGATCACGAGGTCAGGAGTTTGAAACCAGCCTAGCCAGCATG"
"GL873564","6711055","6711262","chr18","1878493","1878704","55","4832562","CTGGGCCCAGTGGCTCACACCTATAATCCTCGCACTCTGGGAGGCTGAGGCGGGTAGATTGTCTGAGCTCACAGGTTCAAGACCAGTGTGACCCAGAGCGAGGCTTTGTCTCTAAAAATAGCAGGGCGTTGTGGCAGGCACCTGTAGTCCCAGCTACTTGGGAGGCTAAGGCAAGAGAATTGCTTAAACCTAAGAGTCTGAGGTTACA","GGCCAGGCATGGTGGCTCACGCCTGTAATCCCAGCACTTTGGGAGGCCGAGGCGGGTGGATCACAAGGTCAGGAGTTCAAGACCAGCCTGGCCAACATGGTGGAAGCCCATCTCTACAAAAAATTAACTGGGCGTGGTGGCAGGCACCTGTAATCCCAGCTACTTGGGAGGCTGAGGCAGGGGAATTGCTTGAACCTGGGAGGCGGAGGTTG"
"GL873564","6711356","6711451","chr7","158031905","158031997","31","151320549","AAAAGAGTCTGAGGTTGCCATGAGCTATCATGCCAAGGCATTCTAGAGAAGGGGTACAAAGTGAGACTCTGTCTCAAAAAAAGAAAACCAAAAAGG","CCAGGAGGTGGAGGTTGCAATGAGCCAAGATCACACCACTGCACTCCAGCCTGGGTGACAGGGTGAGATTCTGTCTCAAAAAAAAAAAAAAAA"
"GL873564","7057009","7057315","chr14","106885133","106885430","87","99828124","GCCGGGTACAATGGCTTGCGCCTATAATCCCAGCACTCTGGGAAGCAGAGGTGGGTGGATCACCTCAGCTCACGAATTCGCTACCAGCCTGTCCTAGAGTGAGACACCCCCCCCACCCCCACCCCCCACAACCTCTAAAAATAGCCTGGAGTTGTGACGGGCACCTGTTGTCCCAGCTACTCTGGAGGCTGAGACAAGAGAATTGCTTGGGCCTCAGAGTCTAAGGTTGATATGAGCTATGACATCACAGCACTCTATCAAAGGTAACAAAGTGAGACTCTAAATAAATAAATAATAAATAAATAAA","GCCGGGCCCGGTGGCTCTTGCCTGTAATCCCAGCACTTTGGGAAGCTGAGGTGGGTGGATCACCTGAGGTCAGGAGTTCGAGACCAGCCTGACCAATATGGTGAAACCCCGTCTCTACTAAAAATATAAAAATTAGCCGGGTGTGGTGGCATGCGACTATAGTCCCAGCTACTCAGGAGGCTGAGGCAGGAGAATTGCTTGAACCCAGGAGGTGGAAGTTGCAATGAGTCGAGGTCACACCACTGCACTCCAGCCTAGGCAACAGAGTGAGACTCCATCTCAAAAAAAAAGAAAAAAA"
"GL873564","7705416","7705474","chr1","51463330","51463380","19","43757914","TCATGCCTGTAGTACCAGCACTTCAGGAGGCTGAAGCAGGAGCTAAGATTAGAAATTTG","CATGCCTTTAATCCCAACTACTTGGGAGGCTGAGGCGAGAATTGAAGTCCG"
"GL873564","8307239","8307551","chr14","30585163","30585473","93","22277924","GCACAGTGGCTCAGGCCTGTAATCTGAGCACTCTGGGAGGTTGAGGCTGAGGTTAGGAGTTAGGAGAACAGCCTGAGCAAGAGTGAGACCCCATCTCTACCAAAAATAGGGGAAAAAACTCCAAAAATCTAGCCACATGTTGTGGTACTTGCCTGCAATCCCAGCTACTGGGGCATAGGGGGACTGAGGCAAGAGGGTCACTTGAGCGTGAGAGATTGAGGTTGCTGTGAGCTAAGATGATGCCATGGCACTCTACCCAAGGTGGCAGAGTGAGCCTATGTCTCACCAATAAATAAACAAATAAATAAATGAA","GGGCACAGTGGCTCACGCCTGGAATCCCAGCACTTTGGGAGGTCAAGGTGGGTGGATCACCTGAGGTCAGGAGTTTGAGACCAGCCTGGCCAAAATGGTGAAACCCCATCTCTACTAAAAAAAATACAAAAAATTAGCCAGAATGTGGTGGTGCATGCCTGTAATCCCAGCTACTGGGGAGGCTGAGGCAGGAGAATCACTTGAACCTGGGAGGCGGAGGCAGCAGTGAGCCAAGATGGCGCCACTGCACTCCAGCCTGAGTGACAGAATGAGACTCTGCCTCAGGAAAAAAAAAAAAAAAAAAGCAAAAA"
"GL873564","8738781","8739084","chr6","92598388","92598711","90","83859607","GCTGGGCACAATGGCTCACACCTGTAATGCCAGCACTTGGGAGGCTAAGACGGGCAAATTGCCTGAGCTCACAAGTTCAAGACCCAGAGCGAGACCTCATCTCTAAAAAATTGCCATGCATTGTGGAGGGTGCCTGTTGTCCCAGCTACTTGGGAGGCGGAGAAAAGACAATCGCTTTAGCCCAAGAATTGAAGGTTGCTGTGAGCTGTGACGCTGTAGCACTCACCAAGGGCAACATAGTGAGACTCTGTTTCAAAATAAATAAATAAATAAATAAAAATAAATAAATAAAATAAAAACAAAA","GGCTGGGCTCAGTGGCTCATGCCTGTAATCCCAGCACTTTGGGAGGCCAAGGCTGGCAGATTGCCTGAGGTCAGGGGTTCAAGACCAGCCTGGCTAACATGGTGAAACCTCATCTCTAATAAAAATACAAAGATTAGCTGGGTTTGGTGGCACATGCCTGTAGTCCCAGCTATTTGGGAGGCTGAGGCAGGAGAATCGCTTGAACCCAGGAGTTGGAGGTTGCAGTGAGCTGAGATGGCACCACTGCACTCCAGCCTGGGTGACACAGCAAGACTCCGTCTCAAAAAAAAAAAAAAAAAAAAAAAAAAGAAAAGAAAAAAAAAA"
"GL873564","9560044","9560238","chrX","30236033","30236239","48","20675989","GGCCAGGTGCGGTGGCTCCTGCCTGTAATCCCAGCACTCTGGGAGGCCTAGGTGGGTGGATTGCCTGAGCTCACTGGTTGGAGACCAGCCTGATACAGATTGAGACCCCCTGCCTCTAAGAATAGCAGGGTGTTGTGACAGACACCTAAAGTCCCAGCTACTCGGGAGGCTGAGGCAAGAGAATCTCTTGAGCCC","GGCTGGGTGCGGTGGCTCACTCCTGTAATCCCAGCACTTTGGGAGGCCAAGGTGGGCGGATCACCTGAGGTCAAAAGTTCGAAACCAGCCTGACCAACAGGGTGAAACCCCGTCTCTACTAAAAGTACAAAAATTAGCCGGGCATGGTGGCAGGCACCTATAATCCCAGCTACTTGGGAGGATGAGGGAGGAGAATCACTTGAACCC"
"GL873564","9560508","9560604","chr1","212121416","212121513","30","202560908","TCGCTGTGCCCAAAAGTTAGAGGTTGCTGTGAGCTATGATACCACTGCACTTTACTGAGGGTGACAAAGTGAGACTCTGTCTCAAAAAATAAATAAA","CTTGAACCTGGGAGGTGGAGGTTGCAGTGAGCCAAGATCATGCCACTGCACTCCAGCCTGGGCAACAGAGCGAGATTCTGTCTCAAAAAAAAAAAAAA"
"GL873564","9753449","9753658","chr19","10370828","10371033","59","617379","TGAGACCCTGGTCTCTTCTAAACATTAAAAAAAAAAAGAAAACTGGGTGTTGTGGCGATGCCCATAGTCCCAGCTACTGATGAGGCTGAGGCAGGGGGATCACTTGAACCCAGGAGTCTGAAGTTGCTGTAAGCTAGGCTGAAGTCACAGTTGTCTAGCCTAGGGCAATAGAGTAAGACTGTCTCACAAAAAAAAAAAAAGGAAAGAAAA","GAAACCCTGTCTCTACTAAAAATACAAAAAATTAGCTGGGTGTGGTGGTGCGTGCCTATAATCCCAGCTACTCAGGAAGCTGAGGTGGGATAATCACTTGAACCTGGGAGGCAGAGGTTGCAGTGAGCCCCAGACTGTGCCACTGCACTCCAGCCTGGGTGACAGAGTCAGACCCTGTCTCAAAAAAAAACAAAACAAAAAAAAAA"
"GL873564","9753896","9754006","chr17","50277667","50277784","33","40523771","GCTGGGCAGGGTGGCTTGTGCCTGTAATCCTCACATTCTTGGAAGCCAAGTTGGTGGATTTCTTGAGCTCAAGAGTTCAGCCTGAACAACGGTGAGACCCCTGTCTCTCTC","CCGGGCATGGTGGCTCATGCCTGTAATCCCAGCACTTTGGGAGGCCAAGGTGGGTGGATCACTTGAGGTCAGGAGTTCAAGACCAGCCTGGCCAACATAGAGAAACTCTGTCTCTACT"
"GL873564","10693118","10693253","chr1","29437872","29437991","31","18744754","GGCCAGGCGTGGTGGCTCACGCCTGTAGTCCCAGCGCTATGGGAGGCCGAGGCGGGTGGATCACCTGTGCTCAGAGGTTCGAGACCAGCCAAGACCTCCCTGAGCCAAATGAGCCAGAGTGAGACCCCGTCTCTAC","GGCCGGGCGTGGTGGCTCACGCCTGTAATCCCAACATTTTGGGAGGCCAAGGCGGGTGGATCACCTGAGGTCAGAAGTTCGAGACCAACCTGGCCAACATGGTGAAACCCCTGTCTCTAC"
"GL873564","11596705","11596819","chr15","17759279","17759407","35","6162574","AATCCGCTACTCGGGAGTCTGATGCAGGAGGATCCCTGGAACCCGGGAGTGAGCTAGGCTGTCCATTCTACCCAAGGCAGAAGAGTGAGATTCTGTCTCAAAAAAAAAAAAAAAA","AATCCCAGTTACTCAAGAGGCTGAGGCAGGAGAATTGCTTGAACCCGGGAGGTGGAGCCGAGACCGCTCCACTGCACTCCAGCCTGGGTGACAGAGTGGGACTCTGTCTAAAAAAAAAAAAAAAAAAAA"
"GL873564","13278770","13278831","chr1","10318851","10318915","18","2959919","GGCTGAGCACAGTGGCTCATGTCTATAATCCCATCACTCTGGAAAGCTAAGAATGAGGATCT","GGCTAGGCATGGTGGCTTATGCCTATAATCCCAGCACTTTGGGAGGCTGAGGCAGACGGATCACC"
"GL873564","13278924","13279152","chr20","69116969","69117193","62","55838045","AAAATAGAGAATAAGAATCCCTTGAGCTCATGAGTTCAAGATCAGTCTGAACAAGTGTCAGACCCTATCTCTACTAAAAATGGAAAAATTAGCCAGGCACTGTGGCAAGTGCCTGTAGTCCCAGATTTCAGGAGGCTGAGGCAGGAGAATCATTTGAATCCAGGAGTTTGAGGTTGCTGTGAGCTAGGCTGACACCACTGTACTGTAGCCTGGGCAACAGAGTGAGACT","GAGGTGGGTGGATCACCTAAGGTCAGGAGTTCAAGACTAGCCTGGCCAACATGGTGAAACTCCATCTCTACTAAAAATACAATAATTAGCTGGGTGTGGTGGCATGTGCCTGTAATTCCAGCTACTCAGGAGGCTGAGGCAGGAGAATCACTTGAACCCAAGAGGCGGAGGTTGCAGTGAGCCGAGACTATGCCACTGCACTCTACCCTGGGCAACAGAGCAAGA"
"GL873565","1417041","1417214","chr4","44130284","44130433","54","42713243","GGCCAGGCGTGGTGGCTCACGCCTGTTGTCCCAGCGATTTGGGAGACTGAGGTGGGTAGATCACCTGTACTCAGAGGTTCGAGACCAGCTGAAGACCAGCCTGAGGCAGAGTGAGACCCCCGTCTCTATAAGAACAAGACAGCCGGACCTTGTGATCCCAGCTACATGGGTGGC","GGCCGGGTGCGGTGGCTCACACCTGTAATCCCAGCACTTTGGGAGGCTGAGGTGGGCAGATAACCTGAGGTCAGGCGTTCGAGACCAGCCTGGCCAACATGGTAAAACCCCGTCTCTACTAAAAATACAAAAATTAGCCAGGTGTGGTGG"
"GL873565","2138367","2138455","chrX","124155143","124155229","17","122016776","GGCTGGGCGTGGTACTCACGCCTGTTGTCCCAGTGCTGTGGGAGGCTGAGGTGGGTGGATCCCCTGAGCTCAGCAGAGTTTGAGACCAG","GGCTGGGTGCGGTGGCTCACGCCTGTAATCCCAGAACTTTGGGAGGCTGAGGTGGGTGGATCACCTGGGGTGAAGAGTTCGAGACCA"
"GL873565","2459722","2459938","chr7","32729330","32729532","57","30269608","AAAAAGACCAAACACCCCAGCTCTACTAAAAGTAGAAAAATTAGCTGGGTATTGTAGTGGGCACCTGTAGTCCCAGCTGCTTGGGAGGTTGCGGCAGGAGAACCACTTAAGCCCAGGAGTTGGAGGGTGAGGTGGGCTGAGGCCACTGCATTCTAGCCTAGGCAACAGAATGAGACTCTGTCTCAAACAAACAAACAAACAAACAAACAAAAAACAA","GAAACCCCATCTCTACTAAAAATACAAAATTAGCCAGGCATGGTGGTGCACACCTGTAGCTCCAACTACTTGGGAGGCTGAGGCAGGAGAATCACTTAAACCCAGGCAGTAGAGGTTGCAGTAAGCCAAGATCGCACCACTGCACTCCAGTCTGGGCAACAGAGTGAGACTCTGTCTCAAAAAAAAAAAAAAAAAAAAAAAAA"
"GL873565","2460219","2460297","chr10","28805224","28805297","28","26345005","CTCAAGCCTGTAATTCTAGCACAGCTGGGAGGCTGAGGCAGGAAGATCTCTCAGCTTAGGATTTCAAGACTAAACACAT","GTGGCTCATGCCTGTAATCTCAGCACTTTGGGAGGCTGAGGCAGGCAGATAACCTGAGGTCAGGAGTTCGAGAC"
"GL873565","11485258","11485580","chrX","66383160","66383473","97","54897902","GGCAGGGCACAGTGGCTCAATCACAGCACTCTGGGAGGAGGCTTAGATGGGTGGATTATTTGAGTTCACAAATTTAAGAACAGCCTGAGCAAGAGTGACACCCTGTCTCTACTAAAAAACAATAGGAAAAATAAAAACTAGCTGGGCATAGTGGCATATGCCTGTGGTTCCAACTACTTGGGAGGCAGAGGCAAGTTTGCTTAGCTAGTTTTTTTTCAGGCCCAAGAGTAGAGGTTGTTGTGAGCTGTGATGCCATAGCACTCTACATAGAGTGACAGAGTGAGACTTTGTCTAAATAAATAAATAAATAAAATTTTAAAAAA","GGCCAGGCACAGTGGCTCACACCTGTAAATCCCAGCACTTTGGGAGGCCGAGATGGGTGGATCACCTGAGGTCACGAGTTTGAGACCAGCCTGGCCAACATGGTGAAACCTCGTCTCTACTAAAAATACAAAAAAAAAAAAAATTAGCTGGGCGTGGTGGTGTGCACCTGTAGTCCCAGCTACTTGGGAGGCTGAGGCAGGAGAATCGCTTGAACCCAGGAGGCAGAGGTTGCAGCGAGCCGAGATCGCGCCACTGCACTCCAGCCTAGGTGACAGAGTGAGACTCTGTCTCAAGGAAAAAAAAAAAAAAAAAA"
"GL873565","13424539","13424574","chr1","174086158","174086184","14","160661619","ACCTAGGGTGAAAGTAAGACTGTCTCAAAAAAAGAA","AAGAGAGAGAAAGAGAGAAAGAAAGAA"
"GL873565","13424654","13424896","chr16","19730961","19731217","54","6306307","GCCAAGCACAGTGGCTCACACCTGTAATCCCAGCACTCTGGGAAGCCTAGGTGGGTGGATTACTTGAGCTCAGGAGTTCAAGATCAGCCTAAGCAAGAGTGAAACTCCCATGTCTAAATAAACAGCCGGGCATTGTAGTGGGTCCCTGTAGTCCCAGCTACTCAGGAGGCTGAGGCAAGAGAATCGCTTGACCCAGGAGTTGGAGGTTGCTGTGAGCTGAGGCCACGGCACTCTATCTAGGGT","GGCCGGGCACAGTGGCTCACGCCTGTAATCCCACCACTTTGGGAGGCCGAGGCGGGTGGATTACCTGAGCTCTGGAGTTAGAGACCAGCCTAGGCAACATGGTGAAACCCCATGTCTACTAAAATACAAAAAGCCGGGCGTGGCGGCGTGTGCCAATAGTCCCAGCTACTCAGGAGGCTGAGGCAGGAGAATTGCTAGAACCCGGGAGGCGGAGGTTGCAGTGAGCTGAGATCACGCCACTGCACTCCAGCCTGGGC"
"GL873565","13679578","13679856","chr1","27657515","27657797","72","13977937","GCAGGGTACAGTGGCTCACACCTGTAATCATAGTAACTCTTAAGCGGCTGAGGCAAGTGAGAGGCCTGAGATCAGGAGTCCAAGAATAGCCTAACCAAAAGTGAGACCCCATCTCTACTAAAAATAGAAAAAAACTAGCCAGGCATGGTGGCACTTACCATAGTCCCACCTCATAAGGCTGAGGCAAGAGTATCACTTGAACCCAGAAGTTTGAAGTTGCTGTCAGCTACAATGACATCATAGCACTTTACCCAGAGCTACAGAGTAAGACTCAGTCTC","GCTGGGTGCGGTGGCTCACACCTGTAATCTCAACACTTTGGGAGGCTGAGATAGGTAGATCACCTGAGGTCAGGAGTTCGAGACCAGCCTGGCCAACATGGTGAAACCCCATCTCTACTAAAAATACAAAAAACCTAGCCAGGCATGGTGGTGTGTACCTATAATCTCAGCTATTCAGAAGACTGAGACAGGAGAATCACTTGAACTTGGGAGGTAGAGGTTGCAGTGAGCCAAGATCACACCACTGCACTCCAGCCTAGGCAACAGAGTGAGACTCCGTCTC"
"GL873566","947388","947684","chr3","178868174","178868466","60","177920786","GGCCGGGTAGGGTGGCTCATGCCTGTAATCCTAGCATTTTGAGAGGCCAAGGCAGGTAGATTACCTGAGCTCAGGAGTTCCAGACCAGGCTGAGCAAGAGCCCCATCTCTATCAAAAATAGAAAAATTAGCTGGGTATGGTGGCACATGCCTNNNNNNNNNNNNNNNNNNNNNNNNNNNNNNNNNNNNNNNNNNNNNNNNNNNNNNNNNNNNNNNNNNNNNNNNNNNNNNNNATGACACCATAGCACTCTAACCTGGAGCAACAGAGTGAGACACCGTCTTAAAAAAAAAAAAAAAA","GGCCGGGTGTGGTGGCTCATGTCTGTAATCCCAACACTTTGGGAGGCCAAGGCGGGTGGATCACCTGAGGTCAGGAGTTTGAGACCAGCCTGGCCAACATAGTGAAACCCCTCTACTAAAAATAAAAAATTAGCCAGGTGTGGTGGCANNNNNNNNNNNNNNNNNNNNNNNNNNNNNNNNNNNNNNNNNNNNNNNNNNNNNNNNNNNNNNNNNNNNNNNNNNNNNNNNNNNNNNNNNNNNNNNCTCCAGGCTGGGCAACAGAGTGAGGCTCCATCTAAAAAAAAAAAAAAAAA"
"GL873566","2530056","2530102","chr1","123145244","123145289","11","120615188","AGGCCAAGGCAGTTGGATCACCTCAGCTCAGGAGTTTGAGACCCGCC","AGGCTGAGGGAGGCGAATCACCTGAGGTCAGGAGTTTGAAACCAGC"
"GL873566","2923434","2923499","chr1","38303497","38303565","19","35380063","GGGCTCAATGGCTCAGCCTGTAATCTTAGCAGTCTGGGAGGCTGAGGCAGGCGCCTGAGCAAGAGT","GCTGGGCGCAGTGTCTCGTGCCTGTAATCCCAGCACTTTGGGAGGCTGAGGCAGGCGGATCATCTGAGG"
"GL873566","3613441","3613522","chr3","54039458","54039545","21","50426017","GGTGGCACATGCCCGTGATCCCAGCACTCTGGGAGGCCGAGGAGATCGGACTGCCTGAGCTCAGGAGTTCGAGACCAGCCTG","GCGCGGTGGCTCACGGCCTGTAATCCTTGCACTTTGGGAGGCTGAGATGGGTGGATTACCTGAGCTCAGGAGTTCGAGACCAGCCTGG"
"GL873566","6100482","6100582","chr2","51286276","51286376","32","45185794","GGCTGGGTGAGTACCTCATGCATCAAGCCCAGTGTTCTGGAGGCTGAGGCAAGGGGATCCTTGATGTGGATAGTTCAAGGCCAGCCTGGCAATTAGCTAGA","GGCTGGGTGCAGTGGCTCACGCCTATAATCCCAGCACTTCGGGAGGCTGAGGCAGGCAGGTCACCTGAGGCCAGGAGTTCAAGACCAGCCTGGCCAACATG"
"GL873566","6245586","6245714","chr3","50507869","50508002","30","44262283","GCTGGGTGTGGTGGCTCACACCTATAATACCAGCACTTGGGAGGCCAAAGCAAGTGGATTGCCTGAGTTCACAAGTTCAAGACCAGCCTGAGCAAGAGTGAGACCCTGTCTCTTAAAAATAGGTGGGCG","GCCAGGTGCGGTGACTCACACCTATAATCCCAGCACTTTGGGAGGCCGAGGCACGTGAATCACCTGAGGTCAGGAGTTCAAGACCAGCCTGACCAACATGGTGAAACCTTGTCTCTACTAAAAATACAAAAACT"
"GL873566","6245992","6246162","chr16","22888303","22888475","37","16642311","TAGCTGGGCGTTGTGGCGGGCATCTGTAATCCCAGCTACCTGGGAGGCTGAGGCAAGAAAATCACTTAAGCCCAAGAGTTTGAGGTTGCTGTGAGCTGTGATGGCACAGTACTCTATTGAGGGCAACATAGTGAGACTCTGTCTCAAAAAATAAATAAATAAATAAATAAA","ATTAGCTGGGCGTGGTGGTGGGCACCTGTAATCCCAGCTTCTTGGGAGGCTGAGGCAGGAGAATCACTTGAGCCCAGGAGGCAGAGGTTGCAGTGAGCAGAGATCGTGCCACTGCACTCCAGCCTGGATGACAGAGTCAGACTTTGTCTCAAAAAAAATAAAAAATAAAAAAA"
"GL873566","6483968","6484033","chr19","10207852","10207913","17","3723884","AAAATATGGTAAAATAAGCCAAGGATGGTGGGTCACACCTGTAATCCCAGCTACTCAAGAGACTGA","TAAAAATACAAAATTAGCTGGGTGTGGTGGCACACACCTGTAATCCCAGCTACTCAAGAGGC"
"GL873566","7043395","7043464","chr10","28805224","28805297","20","21761829","GGCTAGGCCTGGTAATCCCAGCACTCTAAAAGGCTGAGGCAGGTGGATAGCCTGAGCAAGAGTGAGACCA","GTGGCTCATGCCTGTAATCTCAGCACTTTGGGAGGCTGAGGCAGGCAGATAACCTGAGGTCAGGAGTTCGAGAC"
"GL873566","7888407","7888429","chr16","1275850","1275872","4","6612557","CTAAAAATAAAAAATTAGTCTTG","CTAAAAATACAAAAATTAGCCAG"
"GL873566","7888682","7888751","chr13","39203832","39203891","22","31315150","GTAGTCTTGGCGTAGTGATATGTACCTTTAATCCCAGCTACTCAGGAAGTGGAGGAGGAAAGAGTACAAG","TTAGCTGGGCGTAGTGGTGTGTGCCTGTAATCCCAGCTACTTGGGAGGCTGAGGCGGGAG"
"GL873566","8203857","8203949","chr20","18199749","18199840","19","9995892","GGCCCGGCATGGTGGTGCTTTGCCTATAATCCCAGCATTCTGGGAGGCCCAGGCAGGCGGATCACCTGAGCTCACAGGTTCAAGAATGGCCTG","GGCCGGGCATGGTGGCTCACACCTGTAATCCCAGCACTTTGGGAGGCTGAGGCAGGCGGATCACCTGAGGTCAGGAGTTCGAGACCGGCCTG"
"GL873566","8268872","8268975","chr15","10815564","10815667","26","2546692","GTGGCTCATGCCTGTAATCCTAGCACTCTGGGAGGCCGAGGCAGGTGGATTCCCTGAGCTCATAGGTTTGAGACCACAAGCAAGTCCAAGACCCCATCTCTTTT","GTGGTTCATGCCTGTAATCCCAGCACTTTGGGAGGCCGAAGTGGGCGGATCACCTGAGGTCAGGAGTTTGAGACCATCTGGCCAAGATGTAGAAACCCCATCTT"
"GL873566","8269263","8269458","chr15","77706857","77707054","55","69437594","AAGACCCCATCTCTTAAAAAAGAAAAAAAAAGCTGGGTGTTGTGGCCTTCACCTGTAGTCCCAGCTACTGGGGAGGCCAAGGCAAGAGACTTGCTTGAGCCAGAGTTTGAGGTTGCTGTGAGCTATAGTGCCACGGCACTCTACCAAAGGCAACAAAGTGAGACTGTCAAAAAAAAAAAAAAAAGAAGAAGAAGAA","CCCCATCTCTATTAAATATACAAAAAAATAGCTGGGTGTGGTGGTGTGCGCCTGTAATCCCAGCTACTTGGGAGGCTGATGCAGGGGAAGTGCTTGAACCAGGGAGGTGGAGGTTGCAGTGAGCCGGAATCGTGCCACTGCACCCCAGTCTGGGCAACAGATTGAGACTCTGTCTCAAGGAAAAAAAAAAAAAAAAAA"
"GL873566","8592056","8592127","chr10","28805224","28805297","15","20213168","TCTTGCCTGTAATCTCAGCACTCTGGGAGGCTGAGGCAGGCAGATCAACTGAGCTAACAAGTTCGAGACCAG","GTGGCTCATGCCTGTAATCTCAGCACTTTGGGAGGCTGAGGCAGGCAGATAACCTGAGGTCAGGAGTTCGAGAC"
"GL873566","8809109","8809200","chr11","48033118","48033204","26","39224009","ATAGCCAGGCTTGTTGCAGGCACCTGTAGTCCCAGTTACTCTGGAGGCTGAAGCAAGGGAATATCTTGAGCCCAAGAGTCTGAGGTTGCTGT","TTAGCCTGGCATGGTGGTGACACCTGTAATCCCAGCTACTCAGGAGGCTGGGAAGGAAAATCGTTTCAACCCAGGAGGCAGAGTTTG"
"GL873566","8809477","8809608","chr19","10830410","10830544","33","2020933","GGCCAGGCGCAGTGCCTCATGCCTGTAATCCTAGAACTCCGGGAGGCTAAGGAGGGTGGATTTCCTGAGTTCACAGGCTGGAGACCAGCCTGATCTAGAGTGAGATTCCCAGCTCTAAAAATAGCTGGCCTT","GGCCAGGTGCAGTGGCTCATGCCTGTAATCCCAGCACTTTGGGAGGCCAAGGTGGGTGGATCACCTGAGGTCAGGAGTTCGAGACCAGCCTGATCAACGTGGTGAAACCCCATCTCTACTAAAATTGCAAAATTA"
"GL873566","9503716","9503881","chr12","63241189","63241340","56","53737473","TATTAAAAAAAAAAGGAATTCAAGGCCAAGAGCAGTGGCTTTTGCCTGTGATACTTCCACTGTAGGAGGCCGAGGTGGAAGGATCACTTGAACTCTGGAGTTTGAGGTTGCTGTGATCTAGGCTGACACCACAGCACTCTAACTTGGTGGGCAACAGAGCAAGACT","AAAAACAAAAATTAGCCAGGTGTGTTGGCATGCACCTGTAGTCCCAGCTACTAGGGAGGCTGAGACAGAAGAATCACTTGAACCCAGGAGGTGGAGGTTGAGTGAGCCAAGATCGCGCCACTGCACTCCAGCCTGGGTGACAGAGCGAGACT"
"GL873566","9537883","9537992","chr16","43341998","43342113","30","33804115","ATGCCTGTAATCCTAGCACTTGGGAGGCCAAGGTGGGTGGATTGCCTGAGATCACAGGTTCAAGACCAGCCTGAGCCAGAGTGAGACCCTGCCTCTAAAATGAGCCAGGT","GCCTGTACTCCCAGCACTTTGGGAGGCCAAGGCGGGTGCATCACCTGAGGTCAGGGGTTCAAGACCAGCCTGGCCAACATGGTGAAACTCTGTCTCTACTGAAAATTCAAAAAATT"
"GL873566","9538266","9538462","chr7","167658032","167658223","54","158119766","TTAATTAATTAATTAAATAAAATGAGCCAGGTGTTGTGATGGGCGCCTGTAGTCCCAGCTACTTGGGAGGTGGAGGCAGGATAATCACTTGAGTCCAGGAGTTGGAAGTTGTTGTGAGCTGTGACGCCATTGTACTTGACCCAGGGCGACATCTTGAGGCGCTCTCTCTCAAAATAAATAAATAAAGAAAGAAAGAA","TACTAAAATACATACAAAAATTAGCCAGGTATGGTGGCAGGCCCCTGTAGTCCCAGCTACTCGGGAGGCTGAGGCAGGAGAACTGCTTGAACCCAGGAGGTGGGGATTGCAGTGAGCTGAGATCGCACCACTGCACTCCAGCCTGAGCGACAGAGTGAGACTCTGTCTCAAAAATAAAAAAAGAAAAAAAAA"
"GL873566","13663722","13663916","chr1","23558411","23558571","70","9894689","CTCAAGACCAGCCTGAGCCAAGAACGAGACTGAAAATAGAAAAATTAGTGGGACGTTATGTTGAGTGCTGGCTACTCTAGAGGGTGAGGTAGGAGAATTGTTTAAACTCATGAATTTAAGGTTGCTGTGAGCTAGGCTGACGCCACAGCACTGTAGCCTGGGCAACAGGCTACAGAACAGAGTGAGACTCTGTTT","AAAAATACAAAAATTATCTGGGCATGGTGGTGGGTGCCTGTATTCCCAGCTACTCTGGAGGGTGAGGCGGGAGAATTACTTGAACCCAGGAGGTGAAGGTTGCAGTGAGCCAAGATCACGCCACTGCACTCTAGCCTGGGCAACAGAATGAGACTCTGTCT"
"GL873566","13664206","13664293","chr7","151280825","151280914","17","137616619","GGCTAGATATGGTGGCTCATGCCAGTAATCTTAGCACTTTGGGAGGCTGAGGGGAGAGGATCACTTGAGCTGAAAAGTTCAAGACCAA","GGCCAGGCATGGTGGCTCATGCCTGTAATCCCAACACTTTGGGAGGCTGAGGTGGGTGGATCACTTGAGGCCAAGAGTTCAAGACCAGCC"
"GL873567","8375378","8375469","chr3","123612391","123612479","29","115237013","GGTTGGGCTTGGTGGCACGTACCTATGATCATCCTAGCTACTCAGGGAGCATAAGGCAGAAGAATTGCTTTAGCCCGGGAGTTGAGATCAAC","TTAGTTGGGCGTGGTGGCGCATGCCTGTAATCCCAGCTTCTCGGGAGGCTGAGGCAGGAGAATGGCTTGATCCCAGGAGATAGAGGTTG"
"GL873567","9062667","9063009","chr7","6620384","6620702","97","2442283","GGCCAGGCGTGGTGGCTCACGCCTGTTGTCTCAGCGCTGTGGGAGGCCGAGGCGGGTGGATCGCCTGTGCTCAGAGGTTCGAGACCAGCATGAGCCAGAGTGAGAGCCAGAGTAAGACCCCCTCTCTACCAAAAATTGCTGGGTGTTCTGGCAGGTGCCTGTAATTCCAGGTACTTGGGAGGCTGAGGCTAGAGAATCACTTAAACCCAGGGACCCAGGGGTTGGCGGAGGTTGCTGTGAGCTATGATTCTATGGTATTCTACTGAAGGACACAAAGCGAGACTCTGTCTCCATAAATAAATAAATAAATAAATAAAATAAAAGCAAAATTAAAAAAAAAAAA","GGCCAGGCACAGTGGCTCATGTCTGTAATCCCAGCACTTTGGGAGGCCGAGGCGGGTGGATTACCTGAGGTCAGGAGTTCTAGACCAGCCTGGCCAACAAGGCGAAACCCTGTCTCTACTAAAAATACAAAAAATTAGCTGGGCGTTTTGGCACATGCCTGTAATCCCAGCTACTTGGGAGGCTGAGGCAGGAGAATTGCTTGAACTGGGGAAGTGGAGGTTGCAGTGAGCTGAGATCACACCATTGCACGCCTGAGCAACAGAGCGAGACTCTGTCTCAAAAAAAAAAAAAAAAAAAAAAAAGAAAAGAAAAAGAAAA"
"GL873567","11215752","11215787","chr1","62915138","62915167","12","51699386","CAATAAAGCAAGACTCTGCCTCCAAAAGAAAAAAAA","CAAACAAACAAACATCACAAAAAAAGAAAA"
"GL873567","11215868","11216117","chr8","45194211","45194474","73","33978343","GGCTGGGTGTGATGGTTCAGGCCTGTAATCCCAGCGCTCTGGGAGACCAAGGCAGGATAGCCTGAGGTTAAGAGTTTGAGACCAGCCTGAGCAACACAAGACCCTGTCTAAACCAGGAAAATTACTGGGGTGTGGTGGCGTGTGCCTTAATCCCAACTACTCAGGAGGCTAGAGTATTGCTTGAGGGCAGAAGACTGAGGTTGCTGTGAGGAAAGGCTAAGGTCAAGCCATTCTAGCCCAGGCAATAGAG","GGCCGGGTGTGGTGGCTCATGCCTGTAATCCCAGAACTTTGGGAGGCCAAGGCAGGTAGATTACCTGAGGTCAGGAATTGGAGACCAGCCTGGCCAACATGGTGAAACCTCTTCTGTACTGAAAATTACCTGGGCATGGTGGCACACGCCTATAATCCCAGCTACTCAGGAGGCTGAGGCAGAATTGCTTGAGCCCGGGAGACAGAGGTTGCAGTGAGCCAAGATCGTGCCACTGTCCTCCAGTCTGGCCAACAGAGCAAGACT"
"GL873567","12342574","12342696","chr3","166690011","166690120","46","154347437","GTACGCGCAAACCAGAAAAATCAACTAGGTGTGGCAGGGCACACCTGTAGTCCCAGCTACTGGGGAGGGTGAAGCAAGAGATTGCTCAAGTCTGAGGTTACAGTGAGTTAAGATGATACCACT","TACACATACAAAAAATCAGCTGGGTGTGGTGGTACATGCCTGTAATCCCAGCTACTCAGGAGGCTGAGGCCGGAAAATCACTTGAACCCAGGAGGCAGAGGTTGCAGTGA"
"GL873567","12342734","12342873","chr8","96368294","96368428","43","84025560","GGCCAAACACAGTAGTTTATACCTATAATTCCAGCACTCTGGGAAGCTGAAGCAGAAGGATCAGCTGAGGTCAGGAGCCTCAAGACAAGCCTGGGCAAGACTAAGACTCCCCTCCATCCCTTCCCCCACTGTCTTCTCAC","GGCCAGACACAGTGGCTCACACCTGTAATCCCAGCTCTTTGGGAGGCTGAGGCAGGCGGATCACCTGAGGTCAGGAGTTCAAGACCAGCCTGGCCAACATGGTGAAACTGCATCTCTACTAAAAATATAAAACCA"
"GL873568","4322030","4322103","chr11","54983169","54983243","11","50661139","GGCCAGGCGCAGTGGCTCATGCCTTTAATCATAGCACTCTGGGAGGCTGAGGTAGGCGGATCTCCTGAGCCAGG","GGCCAGGTGCAGTGGCTCATGCCTGTAATCCTAGCACTTTGGGAGGCCGAGGTGGACCGATCACCTGAGGTCAGG"
"GL873568","4439574","4439747","chr7","26745376","26745549","54","22305802","GGCTGGGCATGGTGCTCACACCTGTAATCATAGCACTCAGGGAGGCCGAGGTGAGTGGATTGCCAGAGCTCACAGGTTTGAAACCAGACAGAGCCTTTTTTTTTTTAGAAGAAATTGTAGGCTGGGCATGGTGCTCATACCTGTAATCATAGCACTTGGGAGGCCAAGGCAAGA","GGCTGGGCATGGTGGCTCACGCCTGTAATACCAGTACTTTGGCAGGCCGAGGCGGGCAGATCACCTGAGGTCAGGAGTTCAAGACCAGCCTGGCCGTTTCTACTAAAAATACAAAAAATTAGCTAGGCATGGTGGTGCGCACCTGTAATCCCAGCTACTCGGGAGGCTGAGGCA"
"GL873568","4546898","4547014","chr15","31980678","31980795","24","27433780","GGCAGGGTGTGGTGTACACCCCTATAATCCCAGCACTTTGGGAGGCTAAGGCAGGAGCATCACCTGGGGCAGGAGTTCAAGGCCAGCCCGGAGAACAGAATGAAACTCCATCTCCAC","GGCAGGGCGTGGTGGCTCACGCCTCTAATCCCTGCACTTTGGGAGGCCAAGGCAGGCAGATCACCTGAGGTCAGAAGTTCAAGACCAGCCTGGCCAATGTGGTGAAACCCCATCTCCA"
"GL873568","5509331","5509406","chr12","122182458","122182528","25","116673127","TAATCCTAGCACCCTAGGAGGCCCAGGTGGGTGGATTACCTGAGCTCAGGAGTTCAAGAGCAAAAGTGAGACCCCT","CCCAGCACTTTGGGAGGCCAAGGCAGATGGATCACCTGAGGTCAGGAGTTGAAGACCAGCCTGGCCAACAT"
"GL873568","5509687","5509883","chr11","2904691","2904882","40","2604996","GTGAGACCCTTGTCTCTACTAAAAGTAGAAAAACTAGCCAGGTGTTGTGGCAGGTGCCTGTAATACCAGCTACTTAGAAGGCTGAGGCAGGAAGATCAGTTGAACCAAAGAGTTTGAGATTGCTGTGAGCTATGATGAAGCCACAGCACTCTACTATCCAGAGCGACAGAGGGAGACTCTGTCTCCAAAAAAAAAAA","GTGAAACCCTGTCTCTACTAAAAATACAAAAATTAGCCAGGTGTGGTGGTGCATGCCTGTAATCCCAGCTACTCAGGAGGCTGAGGCAGGAGAATCACTTGAACCCAGGAGGTGGAGGTTGCAATGAGCCAAGATCGTGCCACTGCACTCCAGCCTGGGTGACAGAGCGAGACTCCATCTCAAAAAAAAAAA"
"GL873568","7119774","7119822","chrX","41233833","41233871","13","34114059","AAAAGTAAAAAATGAGCCGGGTGAGGTAGCTCACGCCTGTAATCCCAGC","AAATCAGCCGGGTGTGGTGGCTCACGCCTGTAATCCCAG"
"GL873568","10881797","10881967","chr1","164648998","164649168","46","153767201","AAAATCACATATTTGCCTGGCATGTTGACTCATGCCCCTATGATCCTAGCACTCTGGGAGGCTGAGGCAGGAGCCTCACTTGAGTCTGTGAGTCTGAGGTTGCTATGAGCAAGGCTGATGCCATGATACTCTAGTGTGGTACAACAGAGTGAGACTCTGTCTCAAAAAAAA","AAAAACACATATTAGCTGGGTATGGTTGTGCGTGCCTGTAATCCCAGCTACTTGGAAGGCTGAGGCAGGAGAATCACTTGAACCCGTGAGGCGGAGTTTGCAGTGAGCTGAGATTGTGCCACTGCACTCCAGCCTGGGCAACAGAGCAAGACTCTGTCTCAAACAAACAAA"
"GL873569","1403943","1404082","chr2","53765152","53765289","48","52361209","AAGCTGAAGCAGAAAAACGGGCTAGAGGTCAAAAGTTTGAGACCTACCGTGGCTACACAGCAAAACTCTGTCTCTAAAAAAAATAAATAAGACCAGGTAAGGTGGTCATGACTATACTCCTAGCCCCTTAAGAGGCTGAG","GAGGTGGGTGGATCACCTGAGGTCAGGAGTTCCAGAACAGCCTGGTCAACATGGCGAAACACTGTCTCTACTAAAAATACAAAAATTAGCCAGGTGTGGTGGCATGCACCTGTAGTCCCCGCTACTCAGGAGGCTGGG"
"GL873569","7343422","7343556","chrX","124155286","124155406","55","116811864","TTTGAAAGTAGACTGCAAACATCATGTTGCTTCACCTCTAAATATATTAATATGGGCCAGGTGCAGTGGATCATGCCTGTAATCCTAGCACTTGCTAGGCCAAGGCTGGCGGATAGCCTGAGCAACAGCGAGACC","ATCAGCCTGACCAACATAGTGAAACCCCATCTCTACTAAAAATGCAAAATTAGCTGGGCGTGGTGGTGCATGCCTGTAATCCCAGCTACTTGGGAGGCTGAGGCGGGAGAATCACTGGAAC"
"GL873569","7404564","7404762","chr6","586928","587122","48","6817636","GAGATCCCATCTCTTAATGAAAATAAAACAATTAGCTGCTATTGTGGCAGGCACCTGTAATTCCAGCAACCCAGGAGGCTGAGGCAGGAGGATCACGTGAACCCCACCAGTTTGAGGTTGCTATGAGCCAGGCTGATGCCAGGACACTCCAGCCTGGGCAACGGAGTGAGACTCCATCTCCAAAAAAAGCAAACAAAAA","GAAACCCCATCTGTACTAAAAACACACAAATTAGTGGGATGTGGTGGCACGTCCCTGTAATCCTAGCTATTCAGGAGACTGAGGCAGGAGAATCACTTGAACCCAGGAGGTGGAGGTTGCAGTGAGCCGAGGTCACACCACTGCACTCCAGCCTGGGCAGCAGAGTAAGACTCCATCTCAAAACAAAAACAAAAA"
"GL873569","7405040","7405133","chrX","21386588","21386682","29","13981548","GGGCAGGGCGGCTCAGGCCTCTAATCCTAGCACTCTGGGAGCTTCCTTGAGCTCAGGAGTTCAAGACCATCCTAAGCAACAGAGATCCCATCTC","GCTGGGCACGGTGGCTCACGCCTGTAATCCCAGCACTTTGGGAAGCCAAGGTTTGAGGTCAGGAGTTCAAGACCAGCCTGGCCAACAGGCTGCAA"
"GL873548","15249374","15249463","chr5","46485072","46485159","19","31235698","GGCCAGGCATGGTGGCTCATACCTATTGTCCTAGCACTGTGGGAAGCCAAGGCAAGTGGATCACCTGAGCTCTAGAGGTTCGAGACCAGC","GGACAGACACAGTGGCTCATGCCTGTAATCCCAGCAGTTTGGGAGGCCAAGGCAGGTGGATCACCTGAGGTACAGAGTTCAAGACCAG"
"GL873548","15817199","15817306","chr7","158031905","158031997","37","142214706","AAAAAAAAAGAGTTGGAGGTTGCTATGAGCAACATCAGCATGGCACTCAATTCCAGGGTGACTGACTGAGACTGTTGTAGCTATACTCCAAAAAAAAAAACACACAAA","CCAGGAGGTGGAGGTTGCAATGAGCCAAGATCACACCACTGCACTCCAGCCTGGGTGACAGGGTGAGATTCTGTCTCAAAAAAAAAAAAAAAA"
"GL873548","15817589","15817786","chr3","3025868","3026088","60","12791721","GGCCAGGCATGGTGGCTTCTGTAATGCCAGCATTCTGGAAGGCTGAGGTAGGCAGTAGCTTGAGCTCAGTAGGAGAACAGCCTGACCAAAAGTGAGACCCTGTCTCTAAAAATAGTCGTTTGTGGTGGTTACCTGTTGTCCCAGCTACTAGGGAGGCTGAGGCAAGAGAATCACTTGAGCGTAAGAGTTGGAGGTTGC","GGCCAGGCACGGTGGCTCATGCCTGTAATCCCAGAACTTTGGGAGGCTGAGGTGGGCAGATCACCTGAGGTCAGGAGTTGGAGACCAGCCTGACCAACATGGTGAAACCCTGTCTCTACTAAAAATACAAAATTAGCCAGGTGTAGTGGCACGTGCCTGTAATCACAGCTACTTAGGAGGCTGAAGTAGGAGAATCACTTGAACCTGGGAGGTGGAGGTTG"
"GL873548","15856498","15856605","chr18","35090078","35090171","38","19233580","CCCCCCCCAAAAAGAAAAGGGTTGCTTGAATCTAGGAGTTTGGGGTTGCTGTGGGCTAAGCTGATACCACAGCACTTTAGCCTGAGCAAACAGAGTGACACTCTGTCT","AAGCAGGAAATCGCTTGAACCCAGGAAGCAGAGTTGCAGTGAGCCAAGATCGCACCACTGCACTGCAGCCTGAGCAACAGAGAAAGACTCTGTC"
"GL873548","15856683","15856877","chr3","3200882","3201085","53","12655801","GCCAGGCACAGTGGCTCATGCCTATAATCCTAGCACTCTGGGAGGCCAAGGCAGGATTGTCTAAGCTTGGGAGTTTGACAGCAGCCTGAGAAAGATTGAGACCCCTGTCTCTACTAAAAAATAGAAAAATTAGCTGAGTGTTGCAGCAGGTGCCTGTATTTCCAGCCAAGGGGGAGGTTGAAAAGGGTCGCTTCA","GGCCAGGCGCAGTGGCTCATGCCTGTAATCCCAGCACTTTGGGAGGCCGAGGCGGGTGGATCATAAGGTCAGGAGTTTGAGACCAGCCTGGTCAACATGGTGAAACCCCATCTCTACTAAAAATACAAAAATTAGCTGGGTGTTGTGGCACATACCTGTAATCCCACCTACTCAGGAGGCTGAGGCAGGAGAATCACTTGAACC"
"GL873549","1940307","1940608","chr12","9481260","9481565","74","7540953","GGCTGGGCGCAGGGGCTCATGCCTGTGACCCTAGCACCCTGGGAAGCCAAGGCGGGCAGATCGCCTAAGCTCACGAGTTTGAAACCAGCCTTAGCTAGAGTGAGACCCCCAATACTAAAAAAATAGCCAGGCTTTGTGATGGGCGCCTGTAGTCCCAGCTACCTGGGAGGCTGAGGCAAGAGAATGGCTCAAGCCCAAGAGTCTGAGGTCACAGTGAGCTACTGACGCCACCGCACTCTATTGGAACAACAAAGTGAGACTGTGTCTCAAACAAACAAACAAACAAACAAACAAAAAAGAAA","GCTGGGCGCGGTGGCTCATGCCTGTAATCCCAGCACTTTGGGAGGCCAAGGCAGGTGGATCACCTGAGGTCAGGAGTTCGAGACCAGCCTAGTCCACATGGTGAAACCCCATCTCTACTAAAAACTAGCCAGGCGTGGTGGTGCGCACCTGTAATCCCAGCTACTCGAGAGGCTGAGGCAGGAGAATCACTTGAGCCTAGGAAGCAGAGGTTGTGGTGAGCTGAGATCACACCACTGCACTCCAGTCTGGGCGACACAGTGAGACTCTTGTCTCAAAAACAAAAAACAAACAAACAAACAAACAAA"
"GL873549","2657819","2658019","chr11","18547798","18548000","50","15889979","GGCCTGGCACTGTGGCTCACACCTGTCAGGTTAACACTCTGGGAGGCTGATATGGGTGGGTCTCCTGAGTTTAGGAGTTTAAGACCAGCCTAATCAAGAGTAAGACCTGCCTTTACTAAAAATAGAAACACTCACCAGGACTACTGTGCACCTACAGTCCCAGCTACCTGGGAGGCTGAGGCAAGAGGATTGCTCAAGCCC","GGCCAGGCACTGTGGCTCACACCTGCAATCCCACCACTCTGGGAGGCAGAGGCAGGTGGATCACCTGAGGTCAGGAGTTTGAGACCAACCTGGCCAACAGAGCAAAACACTGCCTCTACTAAAAATACAAAAACTAGCCAGGTGTGGTGCATGCCTATAGTCCCACCTACTTGGGAGGCTGAAGCAGGAGAATCTCCTGAGCC"
"GL873549","8853848","8853952","chr12","88112976","88113081","32","79259128","AGCCAGCTGTGTGGCTCATTCCAGTAATTCCAGTTACTGGGGAGGCTGAGACAGGAGGATCACTTGAATGCAAGAGGTGGCGAGAACTCAGCTTTAAAAATAAAA","GGCCAGATGCAGTGGCTCATGCCTGTAATCCCAGCACTTTGGGAGGCTGAGGCAGGCGGATCACCTGAGATCAGGAGTTTGAGACCAGCCTGGCCAACATGGTAAA"
"GL873549","10378794","10378882","chr20","18199749","18199840","17","7820955","GGCCAGGCACGGTGGTTCACCTGTGATCCCAGCACTCTGGGAGATAAGGCAGGCTGATCACCTGAGTTCACAGGTTGGAGACCAGCCTG","GGCCGGGCATGGTGGCTCACACCTGTAATCCCAGCACTTTGGGAGGCTGAGGCAGGCGGATCACCTGAGGTCAGGAGTTCGAGACCGGCCTG"
"GL873549","15488169","15488282","chr10","38476693","38476794","41","22988524","CTGAGCACACGGGTTCACACCTGTAATCCCAGCACGCTGAGAAGCCCAGGCAAGAGGCTGACCTCCAGCCTGGGTGACGGAGCGAGATTCCCCCCCACCCCCGACCAAAAAAAA","CTGAGCGCTGGTAGCTTACACCTGTAATCCCAGCACTTTGGGAGGCCTAGACAGGCGGATCACTTGGGGTCAGGAGTTTGAGACCAGCCTGGCCAATATGAT"
"GL873549","17403348","17403519","chr10","38461164","38461337","46","21057816","GCCAGGCACAGTGGCCCACACCTGTAATCCCAGTACTGTGGGAGGCTGAGGCAGGCTGAGGCAGGCATGGATCACTGAGGTTGCTGTGAGCTAAGATGCCATGGCCCTCCACCCAAAGTGACAGAGTGAGACTCTGTCTCAGAATTAAAAAAAACAAAGAAAGAAAAATAAA","GCCAGGCATGGTGACTCACGCCTATAATCCCAGCACTTTGGGAGGCTGAGGCATGAGAATCACTTGAACCCAGAAGGCAGAGGTTGCAGTGAGCTAAGATTGTGCCACTGTACTCCTGCCTGGGTGATGGAGTGAGACTCTGTCTCGATTTAAAAAAAAAAAAAAAAAAAAAAA"
"GL873550","801968","802043","chr15","50500527","50500602","20","49698559","GTAGCCAGGTATGGTAGTGCAGGCCTGTACTCCCAGCTACTTGGAAAGCTAAGGCAATAGAATCATTTAAGCCCAG","TGGCCGGGCATGGTGGTACATGCCTGTAATCCCAGCTACTTGGGAAGCTGAAGCAGGAGAATTGCTCGAACCCAGG"
"GL873550","802343","802376","chr3","33494224","33494257","9","32691881","TAAGACTTTGTCTCTACTAAAAATAGAAAAAGTG","GTGAAACCCGTCTCTACTAAAAATACAAAAATTA"
"GL873550","2805841","2805900","chr2","93673843","93673900","18","90868002","CTATTCAAAATAGCTAAAATGGGCAGGGCAAGGTGGCTCACACCTGTAATCCCAGTACTC","TAAAAATGTAAAAGATTGGCCGGGTGTGGTGGCTCACTCCTGTAATCCCAGCACTTTG"
"GL873550","4153085","4153214","chr16","18855701","18855834","37","14702616","GGCAGGGCTTGGTGGTAAAAGCCTGTAATCCTACCACTCTGGGAGGCAGAGGTGGTTAGATTGCATGAGGTCACTGGTTGGAGACCAGCCTGAGCTAGAGCAAGACCTCATCTCCAAAAATAGCAGGGCT","GGCTGGGCGCGGTGGCTCACACCTGTAATCTCAGCACTTTGGGAGGCCGAGGTGGGTGGATCACCTGAGGTCAGGAGTTCGAGACCAGCCTGGCCAACATGGCAAAACCCCATCTCTACAAAAATACAAAATTA"
"GL873550","4153472","4153634","chr7","17472856","17473028","43","13319384","AATAAAAATAGCAGGGCTTTGTGGCGGGCACCTGTAGTCCCAGCTACTTGGGAGGCTGAGGCAAGACAATTGCTTGAGCACAAAGTTGGAGGTTGTTGTGAGCTGTGACATCATAGCACTCTACCAAGGGAGATAGAGTGAGACTATCTCGAAGAAAAAAAAA","ATACAAAAATTAGCCAGGTGTAGTGGCGTGCACCTGTAATCCCAGCTACTCGGGAGGCTGACGCATGAGAACTGCTTGAACTCAGGAAGTGGAGGTTGCAGTGAGCTGAGATAGTGCCACTGCACTCCAGCCTGGGTGACAGAGCAAGACTCCATCTCAAAAAAAAAAAAGAA"
"GL873550","6050671","6050965","chr7","84009904","84010193","74","77959233","GGTGGCTCACGCCTGTTATCCTAGCACTCCAGGAGACTAAGGTAGGAGGATGCCTTGCTTGAACTCAAGAGTTCAAGACCAGTCTGAGTGAGAGGGAGACCCTGCGTCTACTCAAAAATAGAAAAATTTACCAGCCATTGTGGCCAACACCTGTAGACCCAGCTATTCAGGAGTCTGAGGCCAGAGAATCACTTGAACCCAGGAGACTGAGATTGCTGTGAGCTAGGCTAAAACCATGGCACTCTAGCCCAGGTGGCAGAGTGAGACTGGGTCTGCAAAAAATAAATAAAAACAA","TGGCTCATGCCTGTAATCCTAGCACTTTGGGAGGCCAAGGCAGGTGGATTGCCTGAGCTCAGGAGTTCAAGACCAGCCTGGCAACACGATGAAACCCCGTCTCTATTAAAAAATACAAAAAATTGGCCAGGCATGGTGGTGTGCACCTGTAATCCCAGCCACTCAGGAGGCTGAGGCAGGAGAATCGCTTGAACCCGGGAGACAGAGGTTGCAGTGAGCCAAGATCGAACCATTGCACCCCAGCCTGGGTGAGAGTGAGACTCTGTCTAAAAAAAAAAGAAGAAAAAGAA"
"GL873550","6212004","6212068","chr19","50425309","50425373","23","44213305","AGAACCTAAGAGTTTTGAGGTTGCTATGAGCTGGACTGATACCATAGCATTCTAGTCTGGGTGAC","TGAACCCAGGAGGTGGAGGTGGCGTGATGCCCAAGATGTGCCACTGCACTCCAGCCTGGGTGATA"
"GL873550","6212319","6212418","chr17","89042086","89042197","34","82829767","CTGTCTTTTCTAAAAATAGAAAAACTAGCTGGGTTGTGGTGGGCACTTGTAGTCCTAGGTACTCTGAGGCTGAAACAGGATTGCTTGAACCTAAGAGTTT","GTCTCTACTAAAAATACAAAAATTAGCCGGGCATGCTGGTGGGCACCTGTGATCTCAAGCTACTTGGGAGGCTGAGGCAGGAGAATCACTTGAACCTGGGAGGCAGAGGTTG"
"GL873550","6504310","6504401","chr19","2969698","2969794","27","3534612","GTGCTGGTGTATGCACCTGTCATACCAGCTACTCCTGAGGTTGAGGCAGGATAGCTTGAACCCGGGAGTCTGAGACTGCAGTGAGCTGGGAT","TTAGGCGTGGTGCATGTCTGTAATCCCAGCTACCCGAGAGGCTGAGGCAGGAGAATCACTTGAACCTGGGAGGCGGAGGTTGCAGTGAGCCGAGATC"
"GL873550","7178331","7178523","chr19","40691105","40691269","60","33512774","GGCCAGACGCGGTGGCTCACGCCTGTTGTCCCGGCACTGTGGGAGGCCGAGGCTGGTGGATCCCCTGAGCTCAGCCAAGTTCAAGACCAGCGGAAGACCAGCATGAGGCAGAGTGAGCCAGAGTGAGACCCCGTCTCTACAACAACAACAACAAAAAATAGCCGGACCTTGTGATCCCAGCTACATGGGAGGC","GGCCGGGCATGGTGGCTCACGCCTGTAATCCCAGCACTTTGAGAGGTCGAGGCAGGTGGATCACCTGAGGTCAGGAGTTCGAGACCAGCCCGGCCAATATGGTGAAACCCCTTCTCTACTAAAAATACAAAAAATTAGCCGGAAGTGGTGGCATGCACCTGTGAT"
"GL873550","7981631","7981790","chr6","148611209","148611366","40","140629578","ATAGCCCCGCCTTGTGGTAGGCTCCTGTAGTCCCAGCTACTTGGGAGGCTGGGGCAAGAGAATCACTTAGGCCCAAGAGTTGGAAGTTGCTGTGAGCTGTGATGCTACAGCATTCTACTGAGAGTGACAAAATGAGACTCTGTTTAAAAAAAAAAAAAAA","TTAGCTGGGCATGGTGGCAGGTGCCTGTAATCCCAGCTACTCTGGAGGCTGAAGCAAGAGAATCGCTTGAACCCAGGAGGTGTAGGTTGCAGTGAGTCGTGCCACAGCACTCCATCCTGGGTGACAGAGCAAGACTCTGTCTCAAAAAAAAAAAAAAA"
"GL873550","7982053","7982180","chr2","182489403","182489528","28","174507350","GGCTGGGCGAGGTTGTTCAGACCTGTAATCCTAGCACTCTGGGAGACCAAGATGGGTGGATTGCCTGAGTTCATGAGTTTGAGACCAGCCTGAGCCAGAGTGAAACCTTGTTCTCTAAAAATAGCTCG","GGCCGGGTGTGGTGGCTCATGCCTGTAATCCTAGCGCTTTGGGAGGCCGAGGTGGGTGGATTGCCTGAGCTCAGGAGTTCGAGACCAGCCTGGGCAACACGGTGAAACCTGTCTCTACTAAAATAC"
"GL873550","8404122","8404320","chr4","121405930","121406135","43","113001808","GGCCAGGCACAGTGACTCACACCTGAAATCTTAGTACTCTGGGAGGCCAAGGTGGGAGGATTTCCTGAGGTCAGGAGTTCAAGACCAGCCAGAGCAAGAAGATCCTGTCTCTACTAAAAGTATAAAAAGTGAACCAAGTGTGGTAGTGAGCACCTATAATCTCAGCTACTTGGGAGGCCGAAGCAAGAGGATCACTTGA","GGCCAGGCACAGTGGCTCACACCTGTAATCTCAACACTTTGGGAGGCCAAGGTGGGTGGATCACCTGAGGTCAGGAGTTTGAGACAAGCCTAGCCAGCATGGTATAACTCCATCTCTACTAAAAGTATAAAAATCAACCAGGTGTGGTGGCACATGCCTGTGGTCCCAGCTACTTGGGAGGCTGAGGCAGGAGAATCACTTGAATC"
"GL873550","8404408","8404483","chr15","701469","701538","22","7702939","AGGATCTCTTGAGCTCGGGAGTTTGAGGTTGCAGTGAGCCAGGCTGATGTCATGGCACGCTACCCAAGACAACAAA","AATCACTTGAACCCAGGAGGCAGAGGTTGCAGTGAGCCAAGACTGTGCCATGGCACTCTAGCCTGGGCAA"
"GL873550","11648593","11648682","chr3","124881947","124882027","31","113233354","GTGGCTCACACTAGTAATCTTAGTACTTTGGGAAGCTGGGGCAAGAGGATCACTTGAGGTCAGGGTTAGGAAACTCTATCACTACAAAAA","GCGGTGGCTCACGCCTGTAATCCTAGCACTTTGGGAAGCCAGGCAGGCAAATCACGAGGTCAGGAGTTCGAAACCAGCCTG"
"GL873550","12468624","12468663","chr9","62916303","62916339","11","50447679","GCCCGGCTTGGTACCTCATGCCTGTAATCTTAGCACTCCG","GGCCGGGCATGGTGGCTCATGCCTGTAATCCCAGCAC"
"GL873550","12468943","12469188","chr12","70524409","70524645","91","58055466","AATCTTAGCACTCCGGGAGGCCGAGGCGGGTAGACCAACCTAATCAAGAGCAAGATCTACCTCTACTAAAAATAGAAAAGAATTGGCCAGGCGTATTGACTCCGCCTCTAGTGCCAGCTACTCCAAAGCTGAGGCAAGAGGATTGTTCAAATCCAAGAGTTTGAAATTGCTGTATGTTACACCAGGGCACTCTAGCCGTGGAGACATTTTCTCTATATATATTAAAAAAAACAAAAAACAGAAAAA","CTGAGCTCGGGAGTTCGAGACCAGCCTGACCAATATGGAGAAACCCTGTCTCTACTAAAAATGTAAAATTAGCCAGGCATGGTGGCACATGCCTGTAGTCCCAGCTACTCAGGAGGCTGAGGCAGGAGAATCGCTTGAGGTCAGGAGGCGGAGGTTGCAGTGAGCCAAGATCATGCCACTGCACTCCAGCCTGGGTGACAGAGTGAGACTTTGTCTCAAAAAAAAAAAAAAAAAAAA"
"GL873550","14719674","14719880","chr16","30390993","30391163","76","15671319","GGGCGTGGTTGCTCACGCCTGTTGTCCCAGCGCTGTGGGAGACCGAGGCAGATGTATCGCCTGAGCTCAGCCGAGTTCGAGTTCGAGACCAGCGGAGAGACCACCATGAGGCAGAGTGAGCCAGAGTGAGACCCCGTCTCTACAACAACAACAAAGAAAACAGCCGGATCTTGTGATCCCAGCTACATGGGGGCCAAGAGAATCACT","GGGCACGGTGGCTCACACCTGTAATCCCAGCACTTTGGGAAGCCAAGGCAGGAGGATCACCTGAGGTCAGGAGTTCAAGACCAGCCTGGCCAACATGGTGAAACCCCGTCTCTACTAAAAACACAAAAATTAGCCAGGTGTGGTGGTGCACGCTTGTAATCCCAGCTACTC"
"GL873550","15737883","15738154","chr2","20481557","20481833","73","4743674","TTAGCATTCTGGGAGGCCAAGTCAGGTGGATTGCCTGAACTCACAAATTTGAGACTAGCCTGAGATAGAGAAAGATCTTGTCTCTAAAAAAAAAAAAAAATAGCTGGACTTTGTAGTGGGCACCTGTAGTCCCTGCTACTCAGAAGGCTGTGGTAAGAGAATCACTGGAACCCAAGAGTTAGAGGTTGCCGTGAGCTGTGATGCCATGGCACTCTACCAGAGACAACAGAGTGAGACTCTCTCCAAAAAAAAGAAAAAGAAAAAGAAAAAAA","GCACTTTGGGAGGCCAAGGCAGGTGAATCACCTGAGATCAGGAGTTCAAGACCAGCCTGGGCAACATGATGAAACCCTGTCTCTATGAAAAATACAAGAATTAGCTGGGCATAGTGGTGTGCATCTGTAATCCCAGCTACTCAGGAGGCTGAGGTATGAGAATTGCTTGAACCCTGGAGGCAGAGGTTGCAGTGAGCCGAGATGACACCGTTGCACTTCAGCCTGGACAATAGAGAGAGACTCTGTCTCAAAAAAATGAAGAAAAGAAAGAAAGAAA"
"GL873550","15738844","15738873","chr10","65896918","65896951","9","50158074","GGGTGTGGTGGCTGATGCGTGTAATCCTAG","GGCTGGGCGTGGTGGCTCATGCCTGTAATCCCAA"
"GL873550","16345151","16345329","chr1","6754007","6754209","69","9591144","CACCTGTAATCCCAGCACTTGGGAGGTTGAGGAGAGTGGATTGCCTGAGCTCACAGGTTTGAGCCAGAAGGAGACCTCGTCTGTAAAAATAGCTGGGTGTTGAGACCAGCGCCTTTAGTCCCAGCTACTTGGGAGGCTGAGGCAAGAGAATCACTTAAACAATTCTAGAAGCAGAGTTT","CTGTAATCCCAGCACCTTGGGAGGCTGAAGAGGGCGGATCACCTGAGGTCAGGAATTTGAGACCAGCCTGGCCAACATGGTGAAATCCCATCTCTACTGAAAATACAAAATTAGCTGGGTGTGGTGGTGCATGCCTGTAGTTCCAGCTACTTGGGGAGCTGAGGCAGAAGAATGCCTTGAACCCGGGAGGCAGAGGTTGCAGT"
"GL873550","17727115","17727274","chr1","127857902","127858038","52","110130787","GCTGGGTGCAGTGACCCCTGCCTATAATCCCAGCAGTTAGGAGACAAAGGCAGGAGGAATTACCTGAGAGCAGGAGTTCCAGACAAGCCTCAGACCAGCGTGAGCTATGACATTGTCTGTAGCCCCCACCCCACCCCCCCAAAAAACAAAAAGAAACAAA","GGCTGAGTTCAGTGGCGCACGCCTGTAATCCCAGCAGTTGGGAGGCTGAGGCAGGTGGATTGCCTGAGGTCAGGAGTTCAAGACCAGTCTGGCCAACATGGTGAAACTCTGTCTCTACTAAAAAAAAAAAAAAAAAT"
"GL873551","6567068","6567102","chr14","109767086","109767123","14","103200018","GGATCACATGAGGTCAGGAGTTCAAGATCAGCCTG","GGAGGCAGAGGTTGCAGTGAGCCAAGACTGCGCCATTG"
"GL873551","9393264","9393376","chr1","39198637","39198744","32","29805373","CAAGAGTATCTCTGCAACCCAGTGGCCTGAGGTTGCTATGAGCTAGGATGCCACAGCACTCTACCCAAGGGGACAGAGTAAGACTCTGTCTCCAAAAAAAAAAAAGAGCAAAA","AGAATCGCTTGAACCTGGGAGGCGGAGGTTGCAGTGAGACCAGATCATGGCACTGCACTCCAGCCTGGGCGACAGAGTAAGACTCGGTCTCAAAAAAAAAAAAAAAAA"
"GL873551","9393708","9393894","chr12","115674238","115674427","40","106280530","GCTGGGCTCAGTGCCTCTCGCCTGTAATCCCAGCACGCTGGGAGCCTGAGGTGGGTGGGTTGCTTGAGCTTAGGAGTTCAAGACCAGCCTGAACCAGAGCAAGACACTATCTCTACTAAAAATAGAAAAACTATCTGGGCATGGTGGTGCGCACCTGTAGTCCCAGCTACTAGGGAAGCTGAGGCAA","CCAGGCCTGGTGGCTCACGCCTGTAATCCCAGCACTTTGGGAGGCCGAGGTGGGTAGATCACCTGAGGTCAGGAGTTCAAGACCAGCCTGGCCAACATGGCGAAACCCCATCTCTACTAAAAATACAAAAATTAGCTGGGCATGGTGGTGTATGCCTGTAATCCCAGCTACTCGGGAGGCTGAGGCAGGA"
"GL873551","10104594","10104683","chr16","53032852","53032939","31","42928258","GGTAGGTGGGTCTCTCGAGGTTAGGAGCTCTTTACCAGCCTGAGCTGACATAAGACCCAATCTCCACCAAAATAGAGAGAGAAAAAAAGA","GAGGCAGACAAATCTCTTGAGGTCAGGAGTTGAAGACCAGCCTGGGCAACATAGACCTCGTCTCTATTAAAAAAAGAAAAAAGAAAAA"
"GL873551","12307468","12307551","chr8","94102375","94102458","19","81794907","GGCCAGGCATAGCAGCTCATGCCTGTAGTCCTATTATTCTAGGAGGTCCAGGGAGGAGGATCACCTGAGATCAGAAGTTCAAGA","GGCCAGGCATGGTGCCTCATGCCTGTAATCCCAGTACTTTGGGAAGCCAAAGTGGATGGATCACCTGAGGTCAGGAGTTCGAGA"
"GL873551","13335872","13336095","chr4","85819795","85820026","56","72483923","GCCAGGTACAGTAGCTCAGGCCTGTAATCCTAGCACACTGGGAGGCTGAGGTGGTGGATCCTTGAACTCATGAATTCAAGACCAGCCTGAGGAAGAGCAAGACCCCATCTCTCCTAAAAATAGAAAAATTAGCTGGTGTCATGGCAAGTGTCTGTAATCCCAGCCACACAGGAGGCTGAGGCAAGAGGATCTCTTGAACCCAAGACACTAAAGTTACTGGGAGC","GCCGGGCATAGTGGCTCATGCCTGTAATCCCAGCACTTTGGGAGGCTGAGATGGGTGGATCATCTGAAGTTAGGGGTTCGAGACCAGCCTGGCCAAATGGCAAAAACCCATCTCTGCTAAAAATACAAAAATTAGCCAGACATTGTGGCATGTGCCTGTAATCCCAGCTACTCAGGAAGCTGAGACAGGAGAATCGCTTGAACCCAGGAGGCAAAGGTTGCAGTGAGCCAAG"
"GL873552","1195303","1195426","chr3","54039332","54039457","34","52844029","CTACTCTGGATGCCAAGGCAGCGGGATCACTTGAACCCCAGAGTCTGAGGTTGCTGTGATCTCAGCTGACTCCATGGCACACTAGCCTGAGGCAACAGACTGAGACTATATCTCAAAACAAAAA","AGCTACTCAGGAGGCTGAGACAGGGAGAGTCACTTGAACCCAGGAGGCAGAGTTGCAGTGAGCCGAGATCACGCCAACTGCACTCCATGCCTGGGCAACAGAGTGAGACTCCGTCTCAAAAAAAAA"
"GL873552","15010293","15010428","chr1","29437872","29437991","29","14427579","GGCCGGGCGTGGTGGCTCACGCCTGTATTCCCAGCGCTATGGGAGGCCGAGGCGGGTGGATCACCTGTGCTCAGAGGTTCGAGACCAGCCAAGACCCCCCTGAGCCAAACGAGCCAGAGTGAGACCCCGTCTCTAC","GGCCGGGCGTGGTGGCTCACGCCTGTAATCCCAACATTTTGGGAGGCCAAGGCGGGTGGATCACCTGAGGTCAGAAGTTCGAGACCAACCTGGCCAACATGGTGAAACCCCTGTCTCTAC"
"GL873553","860627","860695","chr1","16024119","16024187","13","15163492","GCCAGGCTCAGTGGCTCACGCCTATAATCTTAGCGCCTTTTGGAGGCCAAGGTGGGGGGATTACCTGAG","GGCCAGGCACGGTGGCTCACGCTTGTAATCCCAGCACTTTGGGAGGCCGAGGAGGGTGGATTACCTGAG"
"GL873553","7206820","7206939","chr3","156098583","156098705","38","148891763","AGCTAGGTATGGCAGCTGACATCTGTAACCCTAGCCCTCTGGCAGGCCAGGAATTCAAGACCAGCCTAGACAACATAGTAAGACCCCATCTCTACCAAAAATAATTTAAAATTGGCCAGG","GGCTGGCTGTGGTGGCTCACACCTGTAATCCCAGTACTTTGGATCATGTGAGGTCAGGAGTTCAAGACCAGACTGACCAACATGGTGAAACCCTGCCTCTACTAAAAATACAAAATTAGCCAG"
"GL873553","10985147","10985407","chr12","94325498","94325767","64","83340351","GGCCTGTGGCAGTGGCTCATGCCTGAAATCCTAGCACTCTGGGAGGCTGAGGTGGGTCGATTACCTGAACTCACCAAGACGGAGACCTCATCTCTACTAAAAATAGAAAAACTAGCTGGGCGTGGTGGCAGGTGCCTGTAGTCCCAGTTACTGGGGAGGCTGAGGCAAGAGAATTACTTGAACCCAAGAATTTGAGGTTGCTGTGAGCTATGATGCCACAACACTCTACTCAGGGTGACGGAATAAGACCCTGTCTCAAAA","GGCCGGGTGTGGTGGCTTATGCCTGTAGTCCCAGCACTTTGGGAGGCCGATGGGGATGGATCACCTGAGGTCACTGGCCAACACAGAGAAACCCCATCTCTACTAAAAATACAAAAATTAGCCAGGCGTGGTGGCATGTGCCTATAATCCCAGCTACTTGGGAGGCTGAGGCAGGAGAATCACTTGAACCCGGTAGGCAGAGGTTGCAGTGAGCCGAGATTGTGCCACTGCACTCCAGCCTGAGTGACAGAGCAAGCCTCTGTCTCAAAA"
"GL873553","10985438","10985466","chr16","73760336","73760365","6","62774898","CATAAAAAGAAAGAAAACTGAAAAGAAAA","GAAAGAAAGAAAGGAAAAGAGAAAAGAAAA"
"GL873553","12443178","12443505","chr1","3864926","3865253","98","8578252","GCAGGGTGGGGAGGCTCGCACCTACATCCCCAGCACCCTGGAAGGCTTAGGCAGGTGGACTGGGTTCAGGAGTTGGAGAGCAGCCTGAGCAATAGTGAGATTCTGTCTGCAGTAAAACTAGAAAAATTATTTAGGGGTTGTGCTGGGTGCCTATTATCCTAGCTACTGTTGAGGCAAGGGGACAGCTTGAACCCAGGATTTTCAGGTTTCTGTGAGCTAGGATGATGCCATGATGACCCTCTGACACTTTGCCTGGGCAGTAGAGTGAAACTCTGTCTCAGAAAAAACAAAACAAAACAAAACAAAACAAACAAACAAACGAAAAAAA","GGCCAGGCGTGGTGGCTCACACCTGTAATCCCAGCACTTTGGGAGGCTGAGGCAGGTGGATCACCTGAGGTCAAGAGTTCAAGACCAGCCTGGCCAACATGGTGAAACTCTGTCTCTACTAAAAATACAAAAATTAGCCGGGCATGGTGGTGCATGCCTGTAATCCCAGCTATTCGGGAGGCTGAGGTAGGAGAATAGCTTGAACCCGGGAGGTGGAGGCTGCAGTGAGCTGAGATCATGCCATTGCACTGTAGCCTGAGCAACAGAGAAAGACTCTGTCTCAAAAAACAAAACAAAACAAACAAAAGAACAAAAACAAACAAACAAA"
"GL873553","15121135","15121247","chr1","111354387","111354508","21","96233252","GGGCGTGGTGGCTCACACCTGTAATCCCATCACTTGGGAGGCTGAGGCAGGTGGATCACCTGACCTCAGGAGTTCGAGACCAGCCTGAAGAAGAGTGAGACCCCGTCTCTAAA","GGCCGGGCGTAGTGGCTCACACCTGTAATCCCAGCACTTTGGGAGGCCGAGGCGGATGGATCACCTGAGTTCAGGAGTTTGAGACCAGCCTGACCAAAGTGGTGAAACCCCGTCTCTACTAA"
"GL873553","15121274","15121455","chr7","68420775","68420939","69","53299501","AGATTTCAACAGGCCTAATGGCTTTAGTATATAAAGAGAACTTATAAAGCCAGACTCAGTGGCTTACATCTATAATCCAGGTACTTGGTAGGTTGAAGTGAGAAGATTCTTTGAGCCAGGATTTCCAGCCCAGCCTAGGCAACACAGAGAGACCCCCATCTCTAAAAGAGAAAGGTAAAAAA","GGCTAAAGGGGTGCTCATCTTAAGAATACCAGGCCAGGCGCAGTGGCTCATGCCTGTAATCCTAGCATTTTGGGAGGCTGAGGCGGGTGGATCACCTGAAGTCAGGTGTTTGAGACCAGCCTGAACAACATAGTGAGACCTCATCTCTAATTAAAAAAAGAAAAA"
"GL873553","15614197","15614298","chr4","71691062","71691163","34","56076865","GGTGGCTCACACCTGTTATCCCCATACTCTGGGGGCCTGAGGTGAGAGGATCCCCAGAAGTCAGGAGCTGGAGAGAAGCCTGTGTAAGAGTAAGAGCCAGTC","GTGGCTCATGTCTGTAATCCCAGCACTTTGGGAGGCCGAGGTCGGTGTATCATTTGAAGTCAGGAGTTTGAGACCAGCCTGGCCAACGTGGTGAAACCCTGT"
"GL873553","16849767","16850040","chr1","96770987","96771267","68","79921220","GGCCAGGAGTGGTGGCTCATGCCTGCAATCCCAGCACTTGGGAGGCCAAGGTGGGTGGATTGCCTGAGCTCACAGGTTCAAGACCAGCATGAGCCAGAGAGAGACCTTGTCTCTAAAAATAGGCACAGGTTGTGGTGGGCACCCGTAGTCCCAGCTACTTGGGAGGCTGAGGCAAGAGAATCACTTAAGCCCAGGAGTTTGAGGTTGCTGTGAGCTAAGACACCACAGCACTCTACCAAGGGTGACAAAGTAAAACTCAGATTTTTTTAAAAAA","GGCCAGGTGTGGTGGCTCACAGCCTGTAATCCCAGTAGTTTGGGAGGCCGAGGTGAGCAGATCACCTGAGGTCAGCAGTTCGAGACCAGCCTGGCCAACATGGCAAAACCCTATCTCTACTAAAAGTACAAGGTGTGGTGGCACACACCTGTAGTCCCAGCTACTTGGGAGGCTGAGGCAGGAGAATCACTTGAACTCCAGAGGTGGAGGTTGCAGTGAGCCAAGATTATGCCACCGCATTCCAGCCTGGGTGACAGAGTGAGACTCCGTCTCCAAAAAAA"
"GL873554","511555","511741","chr6","166828248","166828429","56","166316693","GTGGGACCCGCATCTATACTAAAAATGAAAAACTAGTCAGACTTGGTGACTCATGCCTATAATTTCAGTTTCTTGGGAGGTGAAGGCAGAAGAATTGCTTGATCCCAGGAATCTGAGATTGCTGTGAGCTAGGCTAACACTATGGCACTCCAGCCCAGCTGACAGAGTAAGACTTTGTCTTTAAAAA","ACCCCATCTCTACTGAAAATAGAAACATTAGCCGGGCTTGGTGGCATGCGCCTGTAGTCCCAGCTATTTGGGAGGCTGAGGCAGGAGAATTGCTGGAACCCAGGAGGCAGAGATTGCAGTGAGCGGAGATCATGCCATTGCACTCCAGCCTGGGCGACAGAATGAGGCTCCATCTCAAAAAA"
"GL873554","2046660","2046725","chr8","51862362","51862427","7","49815702","GGCTGGCCGCGGTGGCTCACGCCTGTAATCCTAGCACTCTGGGAGGCCGAGGCAGGCAGATCACCT","GGCCGGGCACGGTGGCTCACACCTGTAATCCCAGCACTATGGGAGGCCGAGGCAGGTAGATCACCT"
"GL873554","2580766","2581036","chr13","93262937","93263229","81","90682171","GGCCTGGGCAAGGTGGCTCACTCTCTGGAAGGCTGAGGCAGATGGATTGCCTGAGCTCAGGAGCTAGAGACTAGCATGATCTCACCTCTACTAAAAATAGAGAAACTAGCCAGGCATTACAGCACACGCTTGCAGCCCCAGCTACTCTGGGGGCTGAGGCAAAAGGATCACTTGGACTCAAGAAACTGAGGTTCCTGTGAGCCATGATGCCAGGACACTCTACCCAGGGAAACAGAGTGAGACTTCATCTCAAAAAAAAAAAGAAAGAAAA","GGCTGGGTGCAGTGGCTCACGCCTGCACTTTGGGAGGCCAAGGCAGGTGGATCACCTGAGGTCAAGAGTTTGAGACCAGCCTGGTCAACATGGTGAAACCCCATCTCTACTAAAAATACAAAAATTAGCCAGGCATGGTGGCACGTGCCTGTAATCTCAGCTACTCTGGAGGGTGAAGCAAAAGAATCACTTGAACCCAGGAGGCAGAGGTTGCAGTGAGCCAAAATCATGCCACTGCACTCTGGCCTGGGCAACAGAGTGAGACTCCATGTCAAAAAAAAAAAAAAAAAAAA"
"GL873554","5465741","5465829","chr11","47014803","47014890","15","41549062","GGCCAGGCATGGTGGCTCACGCCTGTAGTCCCAGCGCTGTGAGAGGCCGAGGCGGGTGGATCACCTGTGCTTAGAGGTTCGAGACCAGC","GGCCGGGCACCGTGGCTCACGCCTGTAATCCCAGCACTTTGGGAGGCCAAGGCGGGTGGATTACCTGAGGTTAGGAGTTCGAGACTAG"
"GL873555","8807785","8807956","chr1","12240468","12240612","48","3432683","GGCCGGGCGTGGTGGCGCACGCCTGTAGTCCCAGCGCTATGGGAGGCCGAGGCGGGTGGATCACCTGAGCTCAGAGGTTCGAGACCAGCCAAGACCCCCCTGAGCCAAACGAGCCAGAGTGAGACCCCGTCTCTACAACAACAACAGGACAACAAAACAGCCGGACCTTGTG","GGCCGGGCGCGGTGGCTCATGCCTGTAATCCCAGCACTTTGGGAGGCTGAGGCGGGTGGATCACCTGCGGTCAGGAGTTCGAGACCAGCCTGGCCAACGTGGTGAAACCTCATCTCTACTAAAAATATAAAAATTAGCTGGTGTG"
"GL873555","8828420","8828440","chr3","5439989","5440005","4","3388431","ATAATAATAATAATAAATTAG","ATAATAATAAAATAAAA"
"GL873555","12399534","12399604","chr15","102111398","102111458","22","89711864","GGCCAGGCATGGTGGCTCACACCTATAATCCTGGGAGGCTGAGGATTATCTGAGCTCAGGGATGTGAGACC","GGCCAGGCACGGTGGCTAAGGCCTGTAATCTGGGAGGCTGAGATGGGTGGATCACCTGAGG"
"GL873555","12440877","12440963","chr19","21209507","21209590","24","8768630","GTGGGGAGTGCACCTGAACTTTGGAGTTCAAGACCAGCCTGGGCAACATTGTGTGAGCCCTGTCTCAATTGGAAAACAAAACAAAAA","AGGTGGGCAGATCACCTAAGGTCAGGAGTTCAAGACCAGACTGGCAAAAATGGTGAAACCCTGTCTCTACTAAAAATAAAAAAA"
"GL873555","13094462","13094529","chr1","100916857","100916922","22","87822395","GCTTGTACCTATAATCCTGGTACTTTGGGAGCCTCAGGAGAGTGGATCACCTGAGTAAGAGCAAGACC","CATGCCTGTAATCCCAGCACCTTGGGAGGCCAAGGTGGGTGGATCACCTGAGGTCAGTAGTTTGAG"
"GL873555","13254579","13254784","chr7","32729330","32729532","64","19474751","GACCAATCTAAGCCAGAGCTGTCTATGCTAAAAATAGAATAATAAGCCTGGTTTATGGTAGGAGCCTGTAGTCTCAGTTACCTGGGTGTCTGGGGCAAGAGATTGACTTAAAACCAGGAGTTTGAGGTTGCTGTAAGCTAGGCTGACACCACAATACTCTAATCTGGGCAGAGTGAGATTCTGTCTCAAAAAAAAAAAGAAAGAAA","GAAACCCCATCTCTACTAAAAATACAAAATTAGCCAGGCATGGTGGTGCACACCTGTAGCTCCAACTACTTGGGAGGCTGAGGCAGGAGAATCACTTAAACCCAGGCAGTAGAGGTTGCAGTAAGCCAAGATCGCACCACTGCACTCCAGTCTGGGCAACAGAGTGAGACTCTGTCTCAAAAAAAAAAAAAAAAAAAAAAAAA"
"GL873555","13255065","13255153","chr10","29045352","29045442","23","15790287","CTGGGCACAGTGGCTGAGGGTGTAATCCTACCACCCTAGGAGGTTGAGGCAGAAGGATCACTTGAGCTCAGGAATTCAATACAAGTCTA","GGCGGGGCACAGTGGCTCATGCCTGTAATCCTAGTACTTTGGGAGGTCGAGGCGGATGGATCATCTGAGGTCAGGAGTTTAAGACCAGTCT"
"GL873555","13262783","13262918","chr1","29437872","29437991","30","16175089","GGCCGGGCGTGGTGGCGCACGCCTGTAGTCCCAGCACTATGGGAGGCTGAGGCGGGTGGATCACCTGTGCTCAGAGGTTCGAGACCAGCCAAGACCCCCCTGAGCCAAACGAGCCAGAGTGAGACCCCGTCTCTAC","GGCCGGGCGTGGTGGCTCACGCCTGTAATCCCAACATTTTGGGAGGCCAAGGCGGGTGGATCACCTGAGGTCAGAAGTTCGAGACCAACCTGGCCAACATGGTGAAACCCCTGTCTCTAC"
"GL873556","639117","639366","chr1","62410822","62411038","72","61771705","GGCCGGGTGTGGTGGCTCATGCCTGTTGTCCCAGCACTGTGGGAGGCCAAGGCAGGTGGATCGCCTGAGCTCAGCCAAGTTCGAGACCAGCGGAAGACCAGCATGAGGCACAGTGAGCCAGAGTGAGACCCTACCTCTACAAAACAACAACAACAACAAAAAACCCAGCCAGATGTTGTGGCAAGTGTCTGTAATCCCAGCTACATGAGGGGCAAGAGGGCAAGAGAATCACTAAAGGAGGAAGAAGTAA","GGCCGGGCGTGGTGGCTCACACCTGTAATCCCAGCACTTTGGGAGGCCAAGGTGGGTGGATCTCCTGAGGTCAGGAGTTCGAGAGCAGCCTGGCCAACATGGTGAAACCCTGTCTCTACTAAAATACAAAAATTAGCCAGGTGTGGTGGCACGTGCCTGTAATCCCACCTACTCAGGAAGCTGAGGCAGGAGAATCACTTAAAGCTGGGAGAGAGAG"
"GL873556","639390","639468","chr20","16893610","16893664","30","16254220","ACTTCAAACTAAGATAAAGTGAAAGTCAGCAGAAATTGAAAGCAAAAACAAAAACAAAAAAAAAAAAAAAAAAAAAAGA","AACAAAACAAAACAAAACAAAACAAAACAGACAAAAAAAAAAAAACAAAGAAAAA"
"GL873556","2031445","2031493","chr13","87950184","87950229","13","85918739","AGACCCTATCTCTACTAAAAATAGAAAAACTAGCCCAGTATAGTGATGC","AAACCCCATCTCTAGTAAAAATACAAAATTAGCTGGGTGTGGTGGC"
"GL873556","6655305","6655664","chr2","190010230","190010561","107","183354925","GGCCAGGCATGGTGGCTCACACCTGTAATCCTAGCACTCTGGAAGGCCAAGGGAGGTGAATTTCTTGAAGTTCGAGATCAGCCTAAGAGGAATGATACCCCACCTTTACTAGGAATAAAAAAAAAAAAAAAAAAAAACCCAAAACTAGCCTGGCATTGTGGCAGTTCTCTGTAATCCAAGCTACTTGGGAGGCTGAGGTAGAAGGATTGCTTGAACCAAAGAGTTTGACTAGAGGTTGCTGTGAGCTAGGCTAATGTCACCACACTCTATCCAGGGCAAGTGAGTGAAACTCCGTCTCAAAATAAATAAATAAATAAATAAATAAGTAAGAAAAACTTTTGCCCATAAAAAAAAAAAGAA","GGCCGGGCGCGGTGGCTCACACCTGTAATTCTAGCACTTTGGAAGGCTGAGGTGGGTGAATTGTCTGAGCTCAGAAGTTCGAGACCAGCCTGGGCAACACAGTGAAACCCCATCTCTACTAAAATACAAAAAAAAAAAAAAATTAGCTGGGCATGGTGGTGTGCACCTGTAGTCCCAGCTACTCAGGAGGCTGAGGCAGGAGAATTGCTTGAACCCAGGAGGCAGAGGTTGCAGTGAGCTGAGATCACGCCACTACACTCCAGCCTGGGCAACAGAGTGAGACTCCACCTCTTTAAAAAAAAAAAAAAGAAAGAAAGAAAGAAAGAAAGAAA"
"GL873556","10802692","10802792","chr20","28544296","28544376","36","17741604","TACAAAGAAATATCATTATTGGCCAGGTGCAGTGGTTCACATCTGTAATTCTAGTACACTAGTACTCAGGAGGATCACTTGAGGTCAGGAGCTTGTGACCA","TAGAAATGCACAATTCACCTGGGCACGGTGGCTCACTCCTGTAATTCCAGTACTTTGGGAGGCATGAGGTCAGGAGTTCAA"
"GL873557","1682363","1682659","chr6","13352322","13352625","72","11669959","GGCCAGGTGTCGTGGCTCAGGCCTGTAATCCCAGCATTCTGGGAGGCTGAGGTGGGTGGATTGCCCTGAGGTCACAGGTTCCAGACCAGCCTGAGCAAGAGCGAGACTCCATTTCTAATAAAATAGCCGGGTGTTGTGGTAGGTGCCTGTAGTCCCAGTTACTCGGGAGGCTGAGACAAGAGAATCATTTGAACCCAGGAATTTGAGGTTGCTGTGAGCTGTGATGCCACAGGACTCTACTGAGGGCAATAAAGTGAGACTGTCTCAAATAAACAAACAAACAAACAAAAACAAAAA","GGCCAGGTGTGGTGGCTCAGGCCTGTAATCCCAGCACTTTGGGAGACTGAGGTGGGCGGATCACCTGAAGTAAGGAGTTCAAGACCAGCCTGGCCTACATAGTGAAACCCCATCTCTACTAAAAATACAAAATTAGCTGGGTGTGGTGGCACGTGCCTGTAGTCCCAGCTATTCGGGAGGCTGAGTCAGGAGAATCACTTGAACCCAGGATGGGGAGGTTGCAGTGAGCCGAGATCACACCACTGCACTCCAGCCTTGGCAACAGATTGAGACTCTTTCTCAAAAAAAAAAAAAAAAAAAAAAA"
"GL873557","2465751","2465841","chr16","4764895","4764982","15","2299144","GGCCGGGCTTGGTGGTTCACGTCTGTTGTCCCAGCACTGTGGGAGGCCGAGGCAGGTGGATCACCTAAGCTCAGCCAAGTTCGAGACTAGC","GGTCGGGTGTGGTGGGTCACGACTGTAATCCCAGCACTTTGGGAGGCCGAGGCAGATGGATCACCTGAGGTCAGAAGTTCGAGACCAG"
"GL873557","4047834","4047915","chr12","77852792","77852880","22","73804958","ACAAGAGGTTGCTTTGAACTGTGATGCCACAGAGCACTATCCTGGGCAACAGAGACTCTGTCTCAAAAAAAAAAAAAAAAAA","CAGAGGTTGCAGTGAGCTGAGACTGTGCCACTGCACTCCAGCCTGCGCGACAAGAGTGAGACTCTGTCTCAAAAAAAAAAAAAAAAAAA"
"GL873557","4048202","4048390","chrX","23681445","23681631","42","19633243","GGCTGGGTGTGGTGGCTCACACCTGTGATTCTAGCACTCTGGGAGGCCAACGTGGGCAGATCACCTGAGCTTAGGAGTTCAAGACCAGTGTGAGCAAAATGAGACCCCGCCTCTACTAAAAATAGAAAAACTAGCCAGGCACTGTGGTGGGTGCCTATCATCCCAGCTACTCAGGAGGCAGGCAAGAGG","GGCCAGGCGTGGTGGCTCACGCCTGTAATCCCAGCACTTTGGGAGGCCGAGGTGGGTGGATCACCTGAGGTCAGGAGTTCAAGACCAGCCTGGCCAACATGGTGAAACCCCGTCTCTACTAAAAATATAAAAATTAGCCAGGGTGTGGTAGTGCCTGCCTGTAATCCCAGCTACTCGGGAGGCTGAG"
"GL873557","6292327","6292620","chr19","32265157","32265444","82","25972830","GTCAGGCACGGTGGCTCATGCTTGTTGGATTATCCCAACACTCTGGGAGGCCAAGGTGGATCGATTGTCTGAGCTCTGGAGTTCAAGACCAGCCTGAGCAGAAGCAAGACTCCATCTCTAAAAAAAAATAGCTGGGCATTGTGGTGGGCACTTGTATTCCTAGCTACTTGGAAAGCCTGAGGCAAGAGGATTGCTTGAACCCAAGAGTTTGAGGTTGCTGTGAGCTTAAGATGTCACAGCACTCTATAGAGGCTGAGCAAGTGAGACTCCAAAAAGTGAGTTTCCAGAAAAAAA","GACTAGGCACTGTGGCTCATGCCTGTAATCCCAGCACTTTGGGAGGCCGAGGCGGGTAGATCACCTGAGCTCAGGAGTTTCAGACCAGCCTGAGCAACATGGCAAAACCCCATCTCTACTAAACATTAGCCAGGCATGGTGGTGTGCACCTGTAATCCCAGCTACTTGGAAGGTTGAGGCAGGAGGATCACTTGAACCTCAGGAGGCAGAGGTTGCAGTGAGCCAAGATGACATGACTGCACTCCAATCTGGGTGGCAGAGCAAGACTCTGTCTCAAAAAAAAAAAAA"
"GL873557","6324546","6324617","chr1","39656281","39656348","22","33331735","CGCCTGTTGTCCCAGCACTGTGGGAGTGTGAGTAGGGTGGATCACCTTAGCTCAGCTGAGTTTGAGACCAGC","CATGCCTGTAATCCCAGCACTTTGGGAGGTCAAGGCTGGCAAATCACCTAAGGTCAAGAGTTTGAGAC"
"GL873557","6406262","6406343","chr1","199505332","199505412","11","193099070","CAGGCGCAGTGGCTCAATCCTATAATCCCAGCACTTTGGGAGGCTGAGGCAGGTGGATTACCTGAGCTCAGGAGTTTGAGAC","CCAGGCGCAGTGGCTCACACCTGTAATCCCAGCACTTTGGGAGGCTGAGGCAGGCAGATCACCTGAGGTCAGGAGTTGGAG"
"GL873557","6417612","6417692","chr13","102319052","102319128","16","95901440","GAGGTTGCTGTGAGCTAGACTGAGGCCACAGCACTCTAGCCTGGGCAACAGAGTGAGACTGTCTCAAAAGAAAAAAAGAAA","GAGGTTGCAGTGAGCTGAGATCACACCACTGCACTCCAGCCTAGGCAACAAAGTGAGACTCCAACTGAAAAAAAAAA"
"GL873557","6903406","6903510","chr16","18967946","18968045","32","12064540","AGTGCTCTGGGAGACTGAGATGGGCAAATATCTTGAGTTTAGGAGTTCCAGACCAGCCTAAGGAAGAACAAGACCCTATCTCTACTAAAAATAGAAAAAAATTCA","CTTTGGGAGTCTGAGGCAGGTGGATCTCCTGAGGTCAGGAGTTCAGGACCAGCCTGGCCAACATGGCAAAACCCCATCTCTACTAAAAATATAAAAATTA"
"GL873557","6903779","6903930","chr3","40638454","40638604","35","33734675","TTTGCCAGGTATTGTGGTGGACACCTGTAGTCCCAGCTGCTTGGTAGGCTGAGGCAGGAGGATCACTTGACCCTAGGAATCTGATGTTGCTGTGAGCTAGGCTGATGCTACAGCACTCTAGCCTGGACAACAGAGTAAGCTTCTGTCTCAAA","TAGCTGGGTGTCATGGCACACGCCTGTAGTCCCAGCTACTTGGGAGGCTGAGGCAGGAGAATCTCTTGAACCTGGGAGGCAGAGGTTGCAGTGAGCTGAGATCACGCCACTGCACTCCAGCCTGGGCAACAGAGTGAGACTCCGTCTCAAA"
"GL873557","8133022","8133316","chr19","42881134","42881434","76","34748112","GAGTGCAGTGGCTCACACCTGTAATCTTAGCACTCGAGAGGCTGAGGCAGGTGGATTGCCTGAACTCACAGCTTCGAGACCAGCCTGAGCCAGAGCAAGACCTCATCTCTAAAAATAGCCAGGAGTTGTGGCAGGCGCCTGTAGTCCCAGCTACTTGGGAGGCTGAGCAAGAGAATCGCTTGATCTCAGGAGTTTGAGGTTTCTGTGAGCTAAGACACCGCAGCACTCTACCAAGGGTGACAAAGTAAGACTCTGTCTCAAAAAATAAATAAATAAATAAATTATAAGAAAAAGA","CCGGGCAAGGTGGTTCACACCTATAATCCTAGCACTTTGGGAGGTCGAAGTGGATCGCCTGAGGTCAGGAGTTAGAGACCAGCCTGGGCAACATAGCAAAACCCCATCTCTACTAAAAATAGAAAAACTAGCCAGGTGTGGTGGCGCCTGTAATCCCAGCTACTCGGGAGGCTGAGGCAGAAGAATCGCTTGAACCCAGGAGGCAGAGGTTGCAGTGAGCTGAGATCGCACCACTGCACTCCAGGGTGACAGAGCAAGACTCTGTCTCAAAAAAAAAAAAAAAAAAAAAAAAAAAAAAAAA"
"GL873557","8171663","8171835","chr7","151280672","151280824","61","143109009","TTAGCCAGGCACTGTGCTCCCAGCTACTAGGGAGGCTGAGGCAAGAAGAGGATCACTTGGCTCGGCGCCTGTGACTCAAGTGGCTAAGGTGCCAGCCACATACACCTAAGGTGGAGGGTTCTCTACCCAGAGGGACAGCTTGAGGCTCCATCTCAAACAAAAAAAAAAGAAGA","TGGTATGCACCTGTAATCCCAGCTACTTAGGAGGCTGAGGCATGAGAATCACTTGAACCCAGGAGGTGGAACTTTTAGTGAGCTGAGATTGCACCACTGCATTCCAGCCTGGGCAACAGAATAAGACTCTATCTCAAAAAAAAAAAAAAAAAA"
"GL873557","8172121","8172252","chr11","123260550","123260686","30","115088429","CTGGGCATGGTGGCTCATACCTATAATCCTAGGACTTTGGTAGGCCGAGGCAGGTGGGTTGCTTGAGCTTAGAAGTTGAAGACCAGCCTGAACAACAGCAAGACCTTTCCCTACTCAAAACAGAAAAACTAT","GGCTGGGCAGGGTGGCTCATGCCTATAATCCCAGCACTTTGGGAGGCCAAGGCGGGTGGGTCACCTGAGGTCAGGAGTTCGAGACCAGCCTGACCAACATGGTAAGATCCCCTCTCTACTAAAAATACAAAAATTAA"
"GL873557","8260873","8260977","chr1","62231025","62231129","22","53970152","GGCTGGGCATGGTGGCTCACGCCTGTTGTCCCAGCCCTGTGGGAGGGTGAGGCAGGTGGATCGCCTGAGCTCAGCCGAGTTCGAGACCACTGGAAGACCAGCATG","GGCTGGGCATGGTGGCTCACGCCTATAATCCCAGCACTTTGGGAGGCCGAGGCAGGTGGATCACCTGAGATCAGGAGTTTGAGACCAGACTGGCCAACATGGTGA"
"GL873557","10032878","10033040","chr9","27037847","27038008","36","17004969","GGGGGTGGTGGCTCACACTTGTAATACCAGCTACTCTGGAGGCCGAGGCAGGAGAATCATATGAGCCCGGAAGTCTGAGGTTGTTGTGAGCTGGGTTAATGCCCCTGCACTCTAGCCTGGGCAACAGAGTGAGACCATGTCTCAAGGAAATAAAAAAAAAAAA","TTAGCTGGGCATGCTGGCACACACCTGTAATGCCAGCTACTCAGGAGGCTGAGGCAGGAGAATCACTTGAGCCCGGGAGGTGGAGGTTGCAGTGAGCTGAGACAGTGCCACTGTATTCTACCCTGGGCAACAGAGTGAGACTGTCTCAAAAAAAAAAAAAAA"
"GL873557","10366578","10366655","chr17","24597444","24597521","20","14230866","GCCAGGCGTGGTGGCTCATGACGGTAATCCCACCTACTCAGGAAGCAGAGGCAGGAGAATCACTTGCGCCTAGGAGAC","GGCCAGGCATGGTGGCTCATGCCTGTAATTCCAGCACTTTGGGAGGCCGAGGCAGGTGGATCACTACGTCAGGAGTTC"
"GL873557","12031816","12031985","chr11","55022806","55022982","46","42990990","TAGAAAAACTAGCCAGGCATTGTAGCGGGTGCCTATAGTTTCAGCTACTCTGGAGACTGAGACAAGATTGCTTGAGCCCGGGAATTTGAGGTTGCTGTGAGCTATTATGCCACAGCACTCAATACAGGACAATTGAGTGAAACTCCAGTCTCAAAAAAAAAAAAAAAAAA","CAAAAATTAGCCAGGCAGGGTGGTGGGCGCCTGTAGTCTCAGCTACTGGGAAGGCTGAGACAGGATAATCACTTGAACCCGGGAGGCGGATGTTGCAGTGAGCCGAGATCATGCCACTGCACTTCAGCCCGGGCAACGAGAGTGAAACTCCGTCTCAAAAAACAAAATAAAATAAAA"
"GL873557","12032023","12032144","chr1","111354387","111354508","23","99322364","GGTCAGGTGCAGTGGCTCACATCTGGAATCCTAGCACTCTGGGAGGCCGAGGAGAATGGATCCCCTGAGCTCAGGAATTCAATATCAGCCTGAACAAGTGTGAAACCTCCATCTCTACTTAA","GGCCGGGCGTAGTGGCTCACACCTGTAATCCCAGCACTTTGGGAGGCCGAGGCGGATGGATCACCTGAGTTCAGGAGTTTGAGACCAGCCTGACCAAAGTGGTGAAACCCCGTCTCTACTAA"
"GL873557","14208944","14209036","chr7","158031905","158031997","26","143822961","GGATGTGGTAGTTACTGTTTGCTATGATGACAACACTGCACTCTAACTCTGGGTGACACAGTAAGATTCTATCTCAAAACCAAAATAAAACAA","CCAGGAGGTGGAGGTTGCAATGAGCCAAGATCACACCACTGCACTCCAGCCTGGGTGACAGGGTGAGATTCTGTCTCAAAAAAAAAAAAAAAA"
"GL873558","2159034","2159070","chrX","41233833","41233871","7","39074799","ATTAGCCAGGTGTGGTGGCTTTTGCCTGTAATCCCAG","AAATCAGCCGGGTGTGGTGGCTCACGCCTGTAATCCCAG"
"GL873558","3486850","3487074","chr5","91338665","91338874","72","87851815","GGCCAGGCATGGTGGCTCATGCCTGTTGTCCCAGTGCTGTGGGAGGCCGAGGCAGGTGGATCGCCTGAGTTCAGCCAAGTTTGAGACCAGTGGAAGACCAGCATGAGGCAGAGTGAGCCAGAGTAAGACCCCATCTCTACAACAACAAAAAAAAAAAACAAAAAAAACAGCCGGACGTTGTGATCCCAGCTACATGGTGAGGGGGAGGGGAACAGGAGAATCACT","GGCCGGGCATGATGGCTCATGCCTGTAATCCCAGCACTTTGTGAGGCCGAGGCAGACTGATCACTTGAGGCCAGGAGTTCGAGACCAGCATAGCCAACAAGATGAAACACCATCTTTACTGAAAATACAAAAAAAAAAAAAAATAGCCGGATGTGGTGATACCTGCTTGTAATCCCAGCTGCTTGGGAGGCTGAGGCAGGAGAATCTCTT"
"GL873558","3884156","3884240","chr4","24638016","24638099","18","20753860","CCAGACACAGTGGCTTAAGCCTGTAATCCTAGCACTTTGGGAGGCTAAGGTGGATGGATCTCCTGAGCTCAGTAGTTTGAAGCTA","GCCAGGCATGGTGGCTCATGCCTGTAATCTTAGCACTTTGGGAGGCCAAGGTGGGCGGATCATCTGAGGTCAGGAGTTTGAGAC"
"GL873558","5037604","5037746","chr3","2138380","2138521","38","2899224","GCTGGGCCTGGTGGCTCACATCTGTAACCCTAACACTCTGGGAGGCCAAGGCAGGAGGATCTCTTGAAGCTAGGTTGTTAGCCAGGGCGACCCCACAGCACTCTAGCCTGGGGCAACAGAGTGAGACTTTGTCTCCAAACAAA","AGCTGGATGTGGTGGCCCACACCTGTAATCACAGCTACTCGATAGGCTAAGGCAGGAGAATCGCTTGAACCTGGGAGGCGGGGACTGCACCATCACAGCACTCCAGCCTGGGTGACAGAGTGAGACTATGTATCAAAAAAAA"
"GL873558","6488648","6488700","chr3","39516725","39516768","23","33028077","ATAGCACTCTACCATGGGTGACAGAGTGAGACTATCTCCCCCCCTCAAAAAAA","GAGACCAGCCTGACCAACACAGTGAAACCTCATCTCTACTAAAA"
"GL873558","6489359","6489583","chr10","19070944","19071172","64","12581585","GGCTGGACATGGTGGGTCCTGTAATCCTAGCACTGTGGGAGGCCGAGGCAGGTGAATTGCTTGAGCTTATGGGTTCAAGACCAACCTGAGCCAGAAGGAGACCTTGTCTCTAAAAATGGCTGGGTGTTGTGGCAGGCACCTATAATCCCAGCTACTTGGGAGGCTGAGGCAAGAGAATCGCTTGAACCCAAGAGTTTGATGTTGCTGTCAGCTAAGATGCCATAG","GGCTGGGCTCAGTGGCTTATGCCTGTAATCCCAGCGCTTTGGGAGGCCAAGGCGGGTGGATCACCTGAGGTCAGGAGTTCGGGACCAGCCTGAACAACATGGTGAAATCCCGCCTCTACTAAAAAAAAGCCGGGTGTGGTGGCATGCACCTGTAATCCCAGCTACTTGGGAGGCTGAGGCAGGAGAATCACATGAACCTGGGAGGCAGAGGTTGCAGTGAGCTGAGATC"
"GL873558","14631848","14632045","chr18","1878493","1878704","62","12753355","GGTGCAGTGGCTCACGCCTTTAATCCCAGCACTTGGGATGGTGAGGCAGGTAGATTGCCTAAGTTCACAGGTTCAAGACCAGCCTGAGCCAGAGAGACCCTACCTCTAAAAAATAGCCAAGCATTGTGGCAGGCACCTGTAATCCTACTTAGGAGGCTGAGTCAAGAGGATCATTTGAGCTTAAGAGTTAGAGCTTGT","GGCCAGGCATGGTGGCTCACGCCTGTAATCCCAGCACTTTGGGAGGCCGAGGCGGGTGGATCACAAGGTCAGGAGTTCAAGACCAGCCTGGCCAACATGGTGGAAGCCCATCTCTACAAAAAATTAACTGGGCGTGGTGGCAGGCACCTGTAATCCCAGCTACTTGGGAGGCTGAGGCAGGGGAATTGCTTGAACCTGGGAGGCGGAGGTTG"
"GL873558","14632352","14632392","chr7","10117723","10117763","10","4514629","GAGTTAGAGCTTGCTGTGAGCTAAGATGCCACGGCACTCTA","GAGTTAGTTGCAGTGAGCTGAGATCGTGCCACTGCACTCCA"
"GL873559","8193331","8193614","chr20","11734223","11734512","71","3540892","CAGGTACGGTGACTTATCCCTGGAATCTTAGAACTGTCTGAGTCCAAGGTGGGAGGATCATTGGAGGTCAGGAATTTGAGACCAGCCTGAGCAAGAGTGAGACCTCTTCTCTACTAAATATAGAAAAATTAGCCAGGGTTTGTGGCAGGTGCTTATAGTCTAAGCTTCTTAGGAGGCTGAGGCAGGAGAATCTCTTGAACCCATGAGTCTGAGGTTGCCCTGAGTTAAGATGACATCACTGCAGTCTCCCCAAAGCAACGGAGTAAGACTCTGTCTCAAAAACA","GGCCAGGCACGGTGGCTCATGCCTCTAATCCCAGCATGTTGGGAGGCCGAGGTGGGCGGATCACATGAGGTCAGGAGTTTGAGACCAGCCTGGCCAACATAGTGAAACCCTGTCTCTACTAAAAATACAAAAATTAGCCAGGTGTGGCAGCACGTGCCTGTAGTCCCAGCTAGTCAGGAGGCTGAGGCAGGAGAATCACTTGAATCCACCAGGCGGAGGCTGCAGTGAGCCAAGATCACACCACTGCATTCCAGCCTGGGCGACAGAGCAAGACTCTGTCTCAGAAAAAA"
"GL873559","8193642","8193657","chrX","1083699","1083714","0","7109943","AAATAAATAAAATAAA","AAATAAATAAAATAAA"
"GL873560","393252","393440","chr11","121440472","121440639","55","121047220","CTGGGCAGGGTGGCACACACCTGTCATCCCAGCATGTTGGGAAGCTGAGGCAGGAGAATTACTTGAGCTCAGATTCCAAGAGGTGAGGATCACTTGAGCCTAGAAGTTGAGGCTGCACTGATGCCCCAACACTCCAGCCTGGGCAACAGAGCAAGGTCCTGTCCCAAAAAGAAAAAAAGAAAAGGAAAA","GCTGGGCGCAGTGTCTCACGCCTGTAATCCCAGCTATTTGGGAGGCTGAGGCAGGAGAATTACTTGAACCTGGGAGGTGGAAGTTGCAGTGAGCCGAGATCCTACCATCGCACTCCAGTCTGGGCAACAAGAGCAAAACTCTGTCTCAAAAAAAAAAAAAAAAAAAAA"
"GL873560","4038833","4039014","chr12","78258009","78258208","56","74219176","GGCTGGGTGCGGTGACTCACACCTGTAATCCCAGCACCTGGAGGCCCAAGGCAGGGTGGATTGTCTGAGCTCACAGGTTCAAGACCAGCCTGAGCCAGAGCGAGACCTAAAAATAGCTAGGCGCTGTGGGAGGCACACGTAGTCCCAGCTACTCAGGAGGCTGAGGCAAGAGAATCACTTGA","GGCTGGGCACGGTGACTCACGCCTGTAATCCCAGCACTTTGGGAGGCCCAGGTGGGTGGATCACCTGAGGTCAGGAGTTCAAGACCAGCCTGGCCAAGATGGTGAAACCCCGTCTCTACTAAAAATACAAAACTTAGCTGGGCATGGTGGCGGGCACCTGTAATCTCAGCTAGTCGGGAGGCTGAGGCAGGAGAATCTCT"
"GL873560","4492531","4492643","chr7","56485655","56485756","37","51993124","AACAGAAAAACTAGCCAGGCATAGTGGTGCATGCCTGTTGTTCCAGCTGCTCTAGAGGCTAAGGCAAGAGGATTGCTCCAGCTCAATAGTTTGAGGTTGCTGTGAGCTTGAGA","TTAGCTGGGCATGGTGGAGCACACCTGTAATTCCAGCTACTCAGGAGGCTGAGGCAAAAGAGTTGCTTGAACCCAGGAGGCAGAGGTTGCAGTGAGCCGAGA"
"GL873560","4492670","4492771","chr8","41603464","41603564","28","37110794","AGCACTCTGGGTGACTGAGGCAGGATTACTTGAGCTCAGGAGTTTATGACCAGCCTGAGCTGGTCCTTGATCAAGACTCCATCTCTACTAAAAAAACAAACA","CACTTTGGGAGGCCGAGGCAGCAGATCACTCGAGGTCAGGAGTTTGAGACCAGCCTGGCTAACATGGCAAAACCCCATCTCTACTAAAAATATAAAAATTA"
"GL873560","8106775","8106882","chr11","111878590","111878685","39","103771815","ACATAAGAATCAGGCCAAGCCTTGTGGCTCCTGTATGTGATTCCAGCACTGGGAGGGCAAGGCAGGAGGATCCCTGACGTCAGGAACTCAAGGCTGCCCAAGTATCAT","GGGCACAGTGGCTCATGCCTGTAATCCCAGCACTTTGGGAGGCCAAGGCGGGTGGATCACCTGAGGTCAGGAGTTCAAGACCAGCCTGACCAACAT"
"GL873560","10872201","10872272","chr7","9971011","9971083","11","901190","GGCTGGGCACAATGGGTCACACTTGTAATCCCAACACTTTGGGAGGCTGAGGTGGGCAGATCACCTGAGCTC","GGCTGGGTGGGGTGGCTCACACATGTAATCTCAGCACTTTGGGAGGCTGAGGTGGGCAGATCACCTGAGGTCA"
"GL873560","11043320","11043410","chr6","111928830","111928919","19","100885510","CAGGCGAAGTGGCTCATGCCTATAATCCTAGCATTCTGGGAGGCTGAGGTGGGAGAATCCCCTGAGGTCAAAAGTTCAAGACCGGCTTGGC","GGCCAGGCTCAGTGGCTCATGCCTGTAATCCCAGCACTTTGGGAGGCCGAGGTGGGTGAATCACCTGAGGTCAGGAGTTCAAGACCTGCC"
"GL873561","5890611","5890936","chr8","76222061","76222392","77","70331450","GGCTGGGCCTGGTGGCTCATGCCTATAATCCTAGCACTCTGGGAGGCAAAGGTTGGTGGATTGCTTAAGCTCAGGAGTTCAAGACCAGCCTGATTAAGAGTGAGATCCCATCTCCACTAAAAATAGAAGGGAAAAAAAAAAAAAAAAAACCTAGTTGGGCTTGGTGGCAGCACTTGTAGTCCCAGCTATTTAGGAGGCTGAGGAAAGAGAATCACTTGAACCCAAGAGTTTGAAGTTGCTCTGAGCTATGATGCCATAGAACTCTACCCAGGGTGACAGAGTAAAACTGGATCTCAAATAAATAAATAAATAAATACATAAATAAA","GGCTGGGCATGGTAGCTCATGGCTGTAATCCTAGCACTTTGGGAGGCCAAGGAAGGTGGATTGCCTGAGCTCAGGAGTTCAAGACCAGCCTGGGCAACACAGTGAAATCCTGTCTCTACTAAAATACAAAAAAGAAAAAAAAAAAAAAAAAAAACAGCTGGGCATGGCAGTGTGCACTTGTAATCCCAGCTACTCAGGAGGCTGAGACAGGAGAATCACTTGAACCCGGGAGGCAGAGGTTGCACTGAGCCGAGATTGTATCACTGCACTCCAGCCTGGGTGACAGAGCGAGACTCTGTCTCAGAAAAAAAAAAAAAAACAAAAAAACAAAA"
"GL873561","10859256","10859475","chr6","100119122","100119352","73","89259866","GGATCACTTGAGCTCAGGAGTCAAGACCAACTTGAGTAAGAGTGAGACCCTGTCTCTACTAAAAATAAAATATATAGCCAGGCATTGTGCTGGGCACCTATATATAAGCTAAAATGGAGTCTTAGCTACCTCCTTGAACTTGAACCCAGGAGTCTGAAGTTGCTTTGAGCTAGGCTGATGCCACTGCACTTTACCCAGGCAACAGAGTGAGAGTATCTAA","GGATCACCTGAGGTCAGGAGTTCAAGACCAGCCTGGCCAACATGGTGAAACCCCGTCTCTACTAAAAATACAAAAACTAGCCAGGCATGGTGGCGCACACCTGTAGTCCCAGCTACTTGGGAGGCTGAGGCAGAAGAATCTCTTGAATCCGGGGGTTGGAGGTTGCAATGAGCTGAGATCATGCCACTGCACTCCAAGCCTGGGTGACAAGAGCGAAACTCCATCTCAAAA"
"GL873561","10859563","10859576","chr4","114457728","114457741","1","103598165","AAAAAAAAATAAAA","CAAAAAAAATAAAA"
"GL873562","12189469","12189706","chr1","31551552","31551790","75","19362083","CAGTGGCTCACGCCGGTAATCCCAGCACCTTGGGAGCTGAGGCAGGCAGATCTCCTGAGGTCACGTGTTTTGAGACCAGCCTGAGCTAGAGTGAGACCCCACCTCTAAAAATAGCCAGTCGCCTGTAATCCCAGCTACTCGGGAGAAACCCAGGAGTCTAAGGTCGCTGTGAGCTGACACCTCAGCACTCTGCTGGGGTAACAAAGTGACACTTTGTCTCAAAAAAATAAATAAATAT","GCAGTGGCTCACGCCTGTAATCCCAGCACTTTGGGAGGCCAAGGCGGGTGGATCACCTGAGGTCAGGAGTTCAAGACCAGCCTGGCCAACATGGTGAAACCTCATCTCTACTAAAAATACAAAACAGGAGAATCGCTTGAACCCGGGAGGTAGAGGTTGCAGTGAGCTGAGATAGTGCCACTGCACTCCAACCTGGGCAACAGAGTGAGACTCCGTCTCAAAAAAATAAAAAATAAAAA"
"GL873562","4526861","4526913","chr13","94764706","94764759","14","90237845","GTGAGACCTTGTCACTACTGAAAATAGAAAAATTAGCTGGGCATGGTTGTAGG","GTGATGAAACCCCATCTCTACTAAAAATACAAAAATTAGCTGGGCTTGATGGTG"
"GL873562","4789223","4789313","chr10","47852509","47852598","25","43063286","GGCCAGGAGAAGTGGCTAACACCTGTAATTCCAGCACTCTAGGAGATGGAGGCAGGGACCAGCCTGAGCTAGAGTGAGTGAGACTCCATCT","GGCCAGGTGCAGTGGCTCACACCTGTAATCCCAGCAACTTTGGGAGGCTGAGGCAGGCAGATCACTTGAGGTCAGGAGTTCGAGATCAGC"
"GL873562","4868605","4868801","chr16","54069750","54069948","44","49201145","GGCCAGGCATGGTGGCTCATGCCTGTAATCCTAGCACTCTGAGAGACCAAGGCTGATGAATCACCTGAACTCAGGAGTTGAGACCAGCAGGAGCAAAAGTGAGATCCCATCTCTACTCAAAAATAGAAAATTAGTTCAGGCAAGGTGGCACATACCTGTAATCCCAGCACCCTGGGAGGCTAAGGTGGGTGGATTGC","GCCCAGCGCAGTGGCTCATGCCTATAATCCCAGCACTTTGGGAGGCCAAGGCGGGTGGATCACCTGAGGTCAGGAGTTCGAGACCAGCCTGCCCAGCATGGTGAAACCCCATCTCTGTTAAAAATATAAAAATTAGACTAGGCGCGGTGGCTCACACCTGTAATCCCAGCACTTTGGGAGACCAAGGTGGGCGGATCAC"
"GL873562","4929184","4929360","chr10","37539693","37539877","47","32610509","GGCCAAGCTCAGTGGCTCTCCCTAGCACTTTGGGAGACCGAGGTGGGTGGATTGCCTGAACTCAGGAGTTCTAGACCAGCCTGATCAAGAGCAAGACCCTACATCTACTAAAAATAGAAAAACTAGCTGGGCATTATAGTACGCACCTGTACTCCCATCTACTCTGGAGGCTGAGGC","GGGTGCAGAGGCTTATGCCTGTAATCCCAGCACTTTGGGAGGCAGAGGTGGGTGGATCACTTGAGGCCAGGAGTTCAAGACCAGCCTGGTCAATGTGGTGAAACCTCGTCTCTACTAAAAATACAAAAATTAGCCGGGCATGGTGGCATGCATCTGTAGTCCCAGCTACTTGGGAGGCTGAGGCA"
"GL873562","5446395","5446678","chr16","63692714","63692996","79","58246319","GGCTGGATGCAGTGGCTCATACCTGTCTGTAATCCTAGCACTCTGGGAGGTCGAGGTGGGTGGATTGCCTAAGTTCACAGGTTCGAGGCCAGCCTAAGCAAGAAGAGCAAGACTCCATCTCTGAAAGTAGCCAGGCATTGTGACAGGCGCCTATAGTCCCAGCTACTTGGGAGGCTGAGGCAAGAGAATTGAGCCCAGGAGTTAGAGGTTGCTGTGAACTAGGACTCCATAGCATTCTACTGAAGGTGACAAAGTGAGATTCTGTCTCAAAAAAAAGACTGATT","GGCTGGCTGCGGTAGCTCACCCCTGTAATCCCAGCACTTTGGGAGGTCAAGGCAGGTGGATTGCCTGAGGCCAGGAGTTCGAGGCCAGCCTGACCAATATGGCAAAACCCTGTATCTACTAAAAACTAGCTGGGCATGGTGGCATACACCTGTAGTCCCAGCTACTTGGGAGGCTGAGGCAGGAGAATTGCTTGAACCTGGAGGCAGAGGTTGCAGTGAGCCAAGGCTGCCCCACTGCACGCCAGCCTGGGTGACAGAGTGACACTCCATCTCAGAAAAAAAA"
"GL873562","8499356","8499477","chrX","91860022","91860139","29","83360666","GGCTGGGTGTGCTGGCTCATGCCTGTAATCCTCGCACTCTGGGAAGCTAAGGCAGGTGGATTGCCTGAGCTTATGAGTTTAAGACTAGCCTGAGCCAGAGCAAGACCTTGTCTCTATTTTTT","GCCGGGTGTGGTGGCTCATGCCAGTAATCCTAGCACCTTGGAAGGCTGAGGCAGGTGGATTGCCTGAGCTCAGGAGCTTCAGACTAGCCTGGGCAACATAGTGAAACCCCATATCTCT"
"GL873562","8499731","8499918","chr7","167658032","167658223","45","159158301","AAGACCTTGTCTCTAAAAATAGCCAGGTGTTGTAGCAGGCACCTGTAGTCCCAGCTACTTGGGAGGCTGAGACAAGAGAATTGCTTGAGCCCAAGAGTTTGAGGTTGCTGTGAGCTGAGATGCCATGGACTCTATCGAGGGCAGTAAAGTGAGACTCCGTCTCAAAAAAAAAAAAAGAAAGAAAAGAA","TACTAAAATACATACAAAAATTAGCCAGGTATGGTGGCAGGCCCCTGTAGTCCCAGCTACTCGGGAGGCTGAGGCAGGAGAACTGCTTGAACCCAGGAGGTGGGGATTGCAGTGAGCTGAGATCGCACCACTGCACTCCAGCCTGAGCGACAGAGTGAGACTCTGTCTCAAAAATAAAAAAAGAAAAAAAAA"
"GL873562","10216295","10216385","chr1","44313085","44313176","34","34096790","TAAAAATACATTGAACCAGATTCAGTGGCTCACACCTGTGCTCCTAGCTACCCAGTGGCTGAGGCTGAAGGATGGCTTGAATCTCAAGTTC","TTACAGATCATTTGGGGCTAGATGTAATGGCTCACACCTGTAAGCCCAGTGCTTTGGGAGGTTGAGGCAGGAAGATGGCTTGAACCTAGGAG"
"GL873562","11812352","11812435","chr19","44513406","44513491","17","32701054","GGCCGGTACGATGGCTCAGGCCTATAATCTTAGAACTCTGGGAGTCCGAGGTGGGTGGACTGCCTGAGCTCACAGTTCGAGACC","GGCCGGACGCGCTGGCTCACGCCTGTAATCCTAGCACTTTGGGAGGCTGAGGGGGGCGGATAGCCTGAGCTCAGAAGTTCGAGACC"
"GL873562","12179920","12180054","chr14","8268315","8268451","18","3911605","GGCCAGGCATGGTGGCTCACACCTATAATCCTAGCACTCTGGGAGGCCAAGGCAGGTGGATCACCTGAGCTCAGGAGTTTAAGACCAGCCTGAGCAAGAGTGACAACCTATCTCTATTAAAAATACAAAAACTAG","GGCCGGGCATAGTGGCTCACACCTATAATCCCAGCACTTTGGGAGGCCAAGGCAGGTGGATCACCTGAGGTCAGGAGTTCGAGACCAGCCTGACCAAGATAGTGAAACCCCGTCCCTACTAAAAATACAAAAATTAA"
"GL873562","14017684","14017885","chr2","94000404","94000565","73","79982720","CAAGCTAGCCTAGGGATGTGGAGGTACCTGTAGTCCCAGTTACTTCATTGGCTGAGGCTTAAACCCTCTTGGATGGTCTCACTCTGTCACCCTGGTAGAGTGTTGTGGCATCATGTGTCACAGGAGGTTGAGGTTGCTGTGAGCTGTGATGCCACAACATTCTACCAGGGTGACAGAGTGAGACTCTGTTTCAAAAACAAAA","AAACTAGCCTGGCGTGGTGGTGTGTGCCTGTAATCCCAGCTACTTGGGAGGCTGAGACAGGAGAATCACTTGAACCTGGGAAGTGGAGGTTGCAGTGAGCTGAGATCATGCCACTGCACTCCAACTTGGGCAACAGAGCGAGACTCTGTTTCAAAAAAAAAA"
"GL873562","14017915","14018042","chr1","161382752","161382881","27","147364837","GGCTGGGCACGGTGGCTCACACTTGTAATTCTAGCACCCTGGGAGGCCAGCGTGGGTGGTTTGCTTGAAGTTAGGAGTTCAAGACCAGCCTGACCAAAGTGAGACCACATCTCGACTAAAAACAAACA","GGCTGGACGCAGTGGCTCATACCTGTAATCCCAGCACTTTGGGAGGCCGAGGTGGGTGGATCACCTGAGGTCAGGAGTTCAAGACCAGTCTGGCCATGGTGAAACCCCATCTCTACTAAAAATACAAAAA"
"GL873563","2645481","2645758","chr1","37954757","37955032","69","35309276","GGCTGGGTGCCATGACTCACGCCTGTCATCCCAGCTCTCTGGGAGGTCACAATGGGAGTATTCCATGAGCTCAGAAGTTTGAGACCAGTCTGAGCAAGAGCAGACTCCATTTCTACTAAATATAGAAAAATTAGCCCAGTATGGTTGTGCACACCTGTAGTCCCAGCTACTTGGGAGCTGAAGCAGGAAAACGGCTTGAGTCCAGGAGTCGGAGGTTGCTGTGAGCTGAGAGCTATAATGATGCCAGTGCACTCTACCCAGGCAACAGAGCAAGACTC","GGCCGGGTATGGTGGCTTACGCCTGTAATCCCAGCACTTTGGGAGGCCAAGGTTGGCAGATCACCTGAGGTCAGGAGTTCGAGACCAGCCTGGCCAATATGGCGAAACCCCGTCTCTACTAAAAATACAAAAATTAGCTGGGCATGGTGGCGCATACCTGTAATCCCAGCTACTCGGGAGGCTGAGGCAGGAGAACTGCTTGAACCCAGGAGGTGGAGGTTGCAGTGAGCCGAGATTGAGCCACTGCACTCCAGCCTAGGTGACAGAGTAAGACTC"
"GL873563","2646059","2646097","chr1","62915138","62915167","12","60269079","CAAACAGAACAAGACTTTGTTTCAAAAAAAAAAAAAAAA","CAAACAAACAAACATCACAAAAAAAGAAAA"
"GL873563","2651001","2651167","chr2","69424628","69424798","38","66773627","GTACAAAAATTAGCCAGATGTCTTGGTGCTTATAGTCAGCAACTCAGGAGGCTGAGGCAGGAGGATCACTTGAACCCCTGGAATTTGAGGTTGCTGTGAGCTAAGTTGATGCCACGGCATTCTAGCCTGGGTGACAGAGTAAGACTCCATCTCAATAAATAAATAAA","AAAAAAATTAGCCAGGCATGGTGGTGCATGCTTGTAATCCCAGCTACTTGGGAGGCTGAGGCAGGAAGATCACTTGAACCTGGGAGGCGGAGGTTGCAGTGAGCCAAGATTGTGCCACTGAACTCCAGCCTGGGTGACAGAGCAAGACTCCATCTCAAAAAAAAAAAAAAA"
"GL873563","2651449","2651584","chr3","121251018","121251153","32","118599569","GGTCCAGTGAGGTGGTTCAGACCTGTAATCCTAGCATTCTGGGAGGCTGAGGTGAGCAGATTGCTTGAGCTCAGTGAGTTTGAGACCAGCCTGAATAAAAGCAGCACCCCATCTCTACCAAAAGTAGGAAAATTAT","GGCCAGGTGCAATGGCTCACACCTGTAATCCCAGCACTCTGGGAGGCCGAGGTGGGCAGATCACCTGAGGTCAGGAGTTTGAGATCAGCCTGGCCAACCTGGCAAAACCCCATCTCTAATAAAAATACAAAAATTA"
"GL873563","6898038","6898117","chr6","28153994","28154075","27","21255956","AAAAAACAGAAAAATTAGTTGGGTGTGGTAGTGGGTAGCTACTTGGGAGGCTGGGGCAGGAGAATCACTTGAACCCAGGA","AAAATTAGCCGGGTGTGGTGATGCATGCCTCTAATCCCAGCTACTTGGAAGGCTGAGGCAGGAGAATCACTTGAAGGCAGGA"
"GL873563","6898395","6898520","chr5","140939246","140939381","30","134040851","GGGGGTGGTGGCTCATGCCTGTAATCCCAGCACTCTGGCTGAGACAAGTGGATTGCATGAGCTCAGGAGTTCAAGACCAGCTTGAGGAAGAACAAGACTCCATCTCTACTAAAAATAGAAAAATTT","GGCCCGGTGCTGTGGCTCATGCCTGTAATCCCAGCACTTTGGAAGGCTGAGGCAGGTGGATCCCTTGAGGTCAGGAGTTCGAGACCAGCATGGCCAACATGGCAAAATCCCATCTCTACTAAAAATACAAAAATTA"
"GL873563","7811395","7811530","chr1","29437872","29437991","31","21626477","GGCCGGGCGTGGTGGCTCATGCCTGTAGTCCCTGCACTGTGGGAGGCCGAGGCGGGTGGATCACCTGTGCTCAGAGGTTCGAGACCAGCTAAGACCCCCCTGAGCCAAATGAGCCAGAGTGAGACCCCGTCTCTAC","GGCCGGGCGTGGTGGCTCACGCCTGTAATCCCAACATTTTGGGAGGCCAAGGCGGGTGGATCACCTGAGGTCAGAAGTTCGAGACCAACCTGGCCAACATGGTGAAACCCCTGTCTCTAC"
"GL873563","7855904","7856041","chr3","37342340","37342469","34","29486436","GCCAGGGCAGTGGTTCACACCTGTAAAAACCCCAGTATTTTGAGAAGCCAAGTTGGGAGGATCACATAAGGTCAAGAGTTTGAGACCAGCCTGGACAACACAGTATAAGACTCCCATCTCTATTTTGTTAAATATACA","GCCGAGCGCGTGGCTCACGCCTGTAACCCCAGCACTTTGGGAGGCCAAGGTGGGTGGATCACTTGAGGTCAGGAGTAGGAGACCAGCCTGGCCAACATGGGTGAAACCCCACCTATAGTTTAAAAATATA"
"GL873563","8381194","8381392","chr2","167568017","167568216","65","159186823","GGCCAGTGCAGTAGCCCACACCTGTAATCCTAGCACTCTGGGAGGCCAACTCTGGTAGAGTTTGAAACTAGCCTGAGCAAGAGCGAGACCTTGTCTTCACTGAAAAAAATAGAAAAAAAAAAAAAAAACTAACTGGGCATGGTGCTGTACATCTGTAGCCCGAGCTACTCAGGAGTCTGAGGCAAGAGGATTACTCAAT","GCCAGGCGAGGTGGCTCATGCCTGTAATCCCAGCACTTTGGGAGGCCAAAGTGGACAGATTACCTGAGGCCAGGAGTTTGAGACCAGCCTGACCAATATGGTGAAACCCCATCTGTACTAAAAATACAAAAATTAGCAGGGCGTGGTGGTGTACACCTGTAATCCCAGCTACTCAGGAGGCTGAGGCAGGAGAATCTCTT"
"GL873563","8381923","8382014","chr2","92370724","92370803","33","83988801","GGATTGCTCAAGCCCAAGAGTTTGAGGTTGCTGAGAGCTATGACACTACAGCACTCTACTCTACCCAGGGCAACAGAGTGAGACAAAAAAAA","TTGCTTGAACCCAGGAGCTAGAGGTTGCAGTGAGCTGAGATTGCACTATTGCACTCCAGCCTGGGCAACAGGGTGAGACT"
"GL873563","9500422","9500552","chr19","10830410","10830544","33","1329988","GGTCAGGTGCAGTGGTCACCTGTCATCCTACCCCTCTGGGAGGCCAAGGTGGGTGGATTGCCTGAGTTCAGGAGTCTGAGACGAACCTGAGCTAGAGCAAGACCTCATCTCTTAAAAAATAGCCAGCATTC","GGCCAGGTGCAGTGGCTCATGCCTGTAATCCCAGCACTTTGGGAGGCCAAGGTGGGTGGATCACCTGAGGTCAGGAGTTCGAGACCAGCCTGATCAACGTGGTGAAACCCCATCTCTACTAAAATTGCAAAATTA"
"GL873563","9501087","9501192","chr16","71049107","71049211","33","61548020","TAAAACCTATAATGTTTGAAAATAAAAATAGCCAGGCCTTGTTGTGGGTGCCTGTAGTCCCAGCTACTTAGGAGGCTGAGGTAAGAGGATTGCTTGAGCCCAAGAG","TGAAACCCCATCTCTACTAAAAATACAAAATTAGCCAGGTGTGGTGGTGCATGCCTATAATCCCAGTTACTTGGGAGACTGAGGCAGGAGAATCACTTGAACCTG"
"GL873563","10991062","10991128","chr1","22619342","22619410","11","11628280","GGCCGGTGTAGTGGCTCACGCCTGTAATCCCAGCACTTTGGGTGCCGACATGGGCAGATCGCCTGAG","GGCCGGGCGCGGTGGCTCACACCTGTAATCCCAGCACTTTGGGAGGCCGAGGTGGGCGGATCACCTGAG"
"GL873563","12252577","12252738","chr8","144193624","144193784","41","131941047","GGCTGGGTACAGTGGCTCATATCTGTAATCCTAGCACTCCAGGAGGCTGAGGTGGGAGGATAATTGCCTGAAGTCAGAAACACAAGACCAGCCCAAACAAGAGTGAGACACCATCTCTACTAAAAATAGAAAACTGAGCTGGGTGTGGCGGTGCACACCTGT","GGCCGGGCATGGTGGCTCATGCCTATAATCCTAGCACTTTGGGAGGCCGAGGTGGGCGAATCACCTGAGGTCAGGAGTTTGAGACCAGCCTGGCCAACATGGTGAAACCCCATCTCTACTAAAAATACAAAAATTAGCTGGGTGTGGTGGCACATGCCTAT"
"GL873564","1384131","1384395","chr13","32253035","32253303","64","30868904","GGGGGGGGGGGCACACTGGCCTGTAATTCTAGCACTCTGAGAGGCCAAGGCAGGTGGATCACCTGAACTCAGGAGTTCGAGACCAGCCTGATCAAGAGTGAAACCCTGTCTCTACTAACAAGAGAAAAACCAGTAGTCCCAGCTACTCAGGAGGCTGAGGCAGAAGAATCACTTGAACCCAGGAGTTTGAGGTTTCTGTGAGCTACAGTAGTGCTATGGCACTCTACCAAGAGTGACAGAGTGAAACTCTGTCTCAAAAAAAAAA","GCTGGGCATGGTGGCTCATGCCTGTAATCCCAGCACTTTGGGAGGCTGAGGCGGGTGGATCATCTGAGGTCAGGAGTTCAAGACTAGCCTGGGCAACATGGTGAAACCCTGTCTCTACTAAAAATACAAAATTACAGGTAATCCCAGCTACTTGGGAGGCTGAGGCAGGAGAATCGGTTGAACCCAGGAGGCGGAGGTTGCAGTGAGCTGAGATCATGCCACTGCACTCCAGCCTGGGCAATAGAATGAGACTCTGTCTGAAAAAAAAA"
"GL873564","2543879","2544121","chr1","199402350","199402570","73","196858471","GGCCAGGTGTGGTGGCTTACGCCTGTTGTCCCAGCGCTGTGGGAGGCCGAGGCAGGTGGATTGCCTGAGCTTAGCTGAGTTTGAGACCAGCGGAAGACCAGCATGAGGCAGAGTGAGCCAGAGTGAGATCCTGTCTCTACAAAAAAGAAAAAAAAAAAAACAGCCGGATGTTGTGGCGCGCGTCTGTAATCCCAGCTACATGGGGGTCAAGAGGGCAAGAGAATCATACAGGAGGAAGAAGTT","GGCCAGGTGTGGTGGCTCACACCTGTAATCCCAGCACTTTGGGAGTCTGAGGCGGGTGGATTGCCTGAGGTTGAGAGTTTGAGACCAGCCTGGCCAACATGGTGAAACCCTGTCTCTACTAAAAACACAGAAATTAGCCAGGCATGGTGGCGCATGTCTGTAATCCCAGCTACCCTCCTGGAGGCTGAGGCAAGAGAATCACTTGAACCCAGGAAGCAGAG"
"GL873564","4859126","4859236","chr9","15245726","15245837","31","10386600","GTGGCTCATGCTTATAATCCAATCACTATGGGAGACCAAGGTGGGGATGGGCGGAGATCACCCTCAGGAGTTGGAGACCAGCCTGAGTTAAGAGTGATACCATGTCTCTAC","GTGGTGTCTCACGCCTATAATCCCAGCACTCTGGGAGGCCAAGGTGGGCAGATCACCTGAGGTCAGGAGTTAAGAGACCAGCCTGGCCAACATGGTGAAACCCTGTCTCTAC"
"GL873564","4859490","4859678","chr8","126054004","126054184","54","121194514","CATGTCTCTATTAAAGGTAGAAAAATTAGCCGAAGTATTGTAGTTGGGCTGTATAGTCCCAACTACTGAAGAGGCTGAGACAGGAGGATTGCTTACAACTAGGAGTTTGAGGTTGCTGTGAGCTAGGCTGATGCCAAGGTGCTCTAGCCTGGGCAACAGAATGAGACAATGTCTTAAACAACAAAAAAA","GTCTCTACTAAAAATACAAAAATTAGCTGGGTGTGGTGGTGCATGCCTGTAATCCCAGCTACTCAGGAGGCTGAGGCAGGAGAATCGCTTGAACCCAGGAGGTAGAGGTTGCAGTGAGCCAAGATCATGCCACTGCACTCCAGCCTGGGTGACAGAGGGAGACTCTGTCTCAATAAATAAA"
"GL873564","5294014","5294069","chrX","11604904","11604969","20","6310890","GGGTGTGGTGACTTGCACTTACAATCAGCACTTTGGGAGGCGAAGGTAGGAGCATC","GGCTGGGTGCAGTGACTCACGCCTGTAATCCCAGCACTTTGGGAGGCTGAGGTAGGCAGATCACCT"
"GL873564","5294155","5294257","chr15","310129","310227","21","4984026","GGCTGGGTGTGGTGGCTCACGTCTGTTGTCCCAGCGCTATGGGAGGCTGAGGAGGGTGGATCACCTGAGCTCAGAGGTTCGAGACCAGCATAAGACCAGCATG","GGCTGGGCGCAGTGGCTCACGCCTGTAATCCCAGCACTTTGGGAGGCCAAGGCGGGTGGATCACGAGGTCAGGAGTTTGAAACCAGCCTAGCCAGCATG"
"GL873564","6711055","6711262","chr18","1878493","1878704","55","4832562","CTGGGCCCAGTGGCTCACACCTATAATCCTCGCACTCTGGGAGGCTGAGGCGGGTAGATTGTCTGAGCTCACAGGTTCAAGACCAGTGTGACCCAGAGCGAGGCTTTGTCTCTAAAAATAGCAGGGCGTTGTGGCAGGCACCTGTAGTCCCAGCTACTTGGGAGGCTAAGGCAAGAGAATTGCTTAAACCTAAGAGTCTGAGGTTACA","GGCCAGGCATGGTGGCTCACGCCTGTAATCCCAGCACTTTGGGAGGCCGAGGCGGGTGGATCACAAGGTCAGGAGTTCAAGACCAGCCTGGCCAACATGGTGGAAGCCCATCTCTACAAAAAATTAACTGGGCGTGGTGGCAGGCACCTGTAATCCCAGCTACTTGGGAGGCTGAGGCAGGGGAATTGCTTGAACCTGGGAGGCGGAGGTTG"
"GL873564","6711356","6711451","chr7","158031905","158031997","31","151320549","AAAAGAGTCTGAGGTTGCCATGAGCTATCATGCCAAGGCATTCTAGAGAAGGGGTACAAAGTGAGACTCTGTCTCAAAAAAAGAAAACCAAAAAGG","CCAGGAGGTGGAGGTTGCAATGAGCCAAGATCACACCACTGCACTCCAGCCTGGGTGACAGGGTGAGATTCTGTCTCAAAAAAAAAAAAAAAA"
"GL873564","7057009","7057315","chr14","106885133","106885430","87","99828124","GCCGGGTACAATGGCTTGCGCCTATAATCCCAGCACTCTGGGAAGCAGAGGTGGGTGGATCACCTCAGCTCACGAATTCGCTACCAGCCTGTCCTAGAGTGAGACACCCCCCCCACCCCCACCCCCCACAACCTCTAAAAATAGCCTGGAGTTGTGACGGGCACCTGTTGTCCCAGCTACTCTGGAGGCTGAGACAAGAGAATTGCTTGGGCCTCAGAGTCTAAGGTTGATATGAGCTATGACATCACAGCACTCTATCAAAGGTAACAAAGTGAGACTCTAAATAAATAAATAATAAATAAATAAA","GCCGGGCCCGGTGGCTCTTGCCTGTAATCCCAGCACTTTGGGAAGCTGAGGTGGGTGGATCACCTGAGGTCAGGAGTTCGAGACCAGCCTGACCAATATGGTGAAACCCCGTCTCTACTAAAAATATAAAAATTAGCCGGGTGTGGTGGCATGCGACTATAGTCCCAGCTACTCAGGAGGCTGAGGCAGGAGAATTGCTTGAACCCAGGAGGTGGAAGTTGCAATGAGTCGAGGTCACACCACTGCACTCCAGCCTAGGCAACAGAGTGAGACTCCATCTCAAAAAAAAAGAAAAAAA"
"GL873564","7705416","7705474","chr1","51463330","51463380","19","43757914","TCATGCCTGTAGTACCAGCACTTCAGGAGGCTGAAGCAGGAGCTAAGATTAGAAATTTG","CATGCCTTTAATCCCAACTACTTGGGAGGCTGAGGCGAGAATTGAAGTCCG"
"GL873564","8307239","8307551","chr14","30585163","30585473","93","22277924","GCACAGTGGCTCAGGCCTGTAATCTGAGCACTCTGGGAGGTTGAGGCTGAGGTTAGGAGTTAGGAGAACAGCCTGAGCAAGAGTGAGACCCCATCTCTACCAAAAATAGGGGAAAAAACTCCAAAAATCTAGCCACATGTTGTGGTACTTGCCTGCAATCCCAGCTACTGGGGCATAGGGGGACTGAGGCAAGAGGGTCACTTGAGCGTGAGAGATTGAGGTTGCTGTGAGCTAAGATGATGCCATGGCACTCTACCCAAGGTGGCAGAGTGAGCCTATGTCTCACCAATAAATAAACAAATAAATAAATGAA","GGGCACAGTGGCTCACGCCTGGAATCCCAGCACTTTGGGAGGTCAAGGTGGGTGGATCACCTGAGGTCAGGAGTTTGAGACCAGCCTGGCCAAAATGGTGAAACCCCATCTCTACTAAAAAAAATACAAAAAATTAGCCAGAATGTGGTGGTGCATGCCTGTAATCCCAGCTACTGGGGAGGCTGAGGCAGGAGAATCACTTGAACCTGGGAGGCGGAGGCAGCAGTGAGCCAAGATGGCGCCACTGCACTCCAGCCTGAGTGACAGAATGAGACTCTGCCTCAGGAAAAAAAAAAAAAAAAAAGCAAAAA"
"GL873564","8738781","8739084","chr6","92598388","92598711","90","83859607","GCTGGGCACAATGGCTCACACCTGTAATGCCAGCACTTGGGAGGCTAAGACGGGCAAATTGCCTGAGCTCACAAGTTCAAGACCCAGAGCGAGACCTCATCTCTAAAAAATTGCCATGCATTGTGGAGGGTGCCTGTTGTCCCAGCTACTTGGGAGGCGGAGAAAAGACAATCGCTTTAGCCCAAGAATTGAAGGTTGCTGTGAGCTGTGACGCTGTAGCACTCACCAAGGGCAACATAGTGAGACTCTGTTTCAAAATAAATAAATAAATAAATAAAAATAAATAAATAAAATAAAAACAAAA","GGCTGGGCTCAGTGGCTCATGCCTGTAATCCCAGCACTTTGGGAGGCCAAGGCTGGCAGATTGCCTGAGGTCAGGGGTTCAAGACCAGCCTGGCTAACATGGTGAAACCTCATCTCTAATAAAAATACAAAGATTAGCTGGGTTTGGTGGCACATGCCTGTAGTCCCAGCTATTTGGGAGGCTGAGGCAGGAGAATCGCTTGAACCCAGGAGTTGGAGGTTGCAGTGAGCTGAGATGGCACCACTGCACTCCAGCCTGGGTGACACAGCAAGACTCCGTCTCAAAAAAAAAAAAAAAAAAAAAAAAAAGAAAAGAAAAAAAAAA"
"GL873564","9560044","9560238","chrX","30236033","30236239","48","20675989","GGCCAGGTGCGGTGGCTCCTGCCTGTAATCCCAGCACTCTGGGAGGCCTAGGTGGGTGGATTGCCTGAGCTCACTGGTTGGAGACCAGCCTGATACAGATTGAGACCCCCTGCCTCTAAGAATAGCAGGGTGTTGTGACAGACACCTAAAGTCCCAGCTACTCGGGAGGCTGAGGCAAGAGAATCTCTTGAGCCC","GGCTGGGTGCGGTGGCTCACTCCTGTAATCCCAGCACTTTGGGAGGCCAAGGTGGGCGGATCACCTGAGGTCAAAAGTTCGAAACCAGCCTGACCAACAGGGTGAAACCCCGTCTCTACTAAAAGTACAAAAATTAGCCGGGCATGGTGGCAGGCACCTATAATCCCAGCTACTTGGGAGGATGAGGGAGGAGAATCACTTGAACCC"
"GL873564","9560508","9560604","chr1","212121416","212121513","30","202560908","TCGCTGTGCCCAAAAGTTAGAGGTTGCTGTGAGCTATGATACCACTGCACTTTACTGAGGGTGACAAAGTGAGACTCTGTCTCAAAAAATAAATAAA","CTTGAACCTGGGAGGTGGAGGTTGCAGTGAGCCAAGATCATGCCACTGCACTCCAGCCTGGGCAACAGAGCGAGATTCTGTCTCAAAAAAAAAAAAAA"
"GL873564","9753449","9753658","chr19","10370828","10371033","59","617379","TGAGACCCTGGTCTCTTCTAAACATTAAAAAAAAAAAGAAAACTGGGTGTTGTGGCGATGCCCATAGTCCCAGCTACTGATGAGGCTGAGGCAGGGGGATCACTTGAACCCAGGAGTCTGAAGTTGCTGTAAGCTAGGCTGAAGTCACAGTTGTCTAGCCTAGGGCAATAGAGTAAGACTGTCTCACAAAAAAAAAAAAAGGAAAGAAAA","GAAACCCTGTCTCTACTAAAAATACAAAAAATTAGCTGGGTGTGGTGGTGCGTGCCTATAATCCCAGCTACTCAGGAAGCTGAGGTGGGATAATCACTTGAACCTGGGAGGCAGAGGTTGCAGTGAGCCCCAGACTGTGCCACTGCACTCCAGCCTGGGTGACAGAGTCAGACCCTGTCTCAAAAAAAAACAAAACAAAAAAAAAA"
"GL873564","9753896","9754006","chr17","50277667","50277784","33","40523771","GCTGGGCAGGGTGGCTTGTGCCTGTAATCCTCACATTCTTGGAAGCCAAGTTGGTGGATTTCTTGAGCTCAAGAGTTCAGCCTGAACAACGGTGAGACCCCTGTCTCTCTC","CCGGGCATGGTGGCTCATGCCTGTAATCCCAGCACTTTGGGAGGCCAAGGTGGGTGGATCACTTGAGGTCAGGAGTTCAAGACCAGCCTGGCCAACATAGAGAAACTCTGTCTCTACT"
"GL873564","10693118","10693253","chr1","29437872","29437991","31","18744754","GGCCAGGCGTGGTGGCTCACGCCTGTAGTCCCAGCGCTATGGGAGGCCGAGGCGGGTGGATCACCTGTGCTCAGAGGTTCGAGACCAGCCAAGACCTCCCTGAGCCAAATGAGCCAGAGTGAGACCCCGTCTCTAC","GGCCGGGCGTGGTGGCTCACGCCTGTAATCCCAACATTTTGGGAGGCCAAGGCGGGTGGATCACCTGAGGTCAGAAGTTCGAGACCAACCTGGCCAACATGGTGAAACCCCTGTCTCTAC"
"GL873564","11596705","11596819","chr15","17759279","17759407","35","6162574","AATCCGCTACTCGGGAGTCTGATGCAGGAGGATCCCTGGAACCCGGGAGTGAGCTAGGCTGTCCATTCTACCCAAGGCAGAAGAGTGAGATTCTGTCTCAAAAAAAAAAAAAAAA","AATCCCAGTTACTCAAGAGGCTGAGGCAGGAGAATTGCTTGAACCCGGGAGGTGGAGCCGAGACCGCTCCACTGCACTCCAGCCTGGGTGACAGAGTGGGACTCTGTCTAAAAAAAAAAAAAAAAAAAA"
"GL873564","13278770","13278831","chr1","10318851","10318915","18","2959919","GGCTGAGCACAGTGGCTCATGTCTATAATCCCATCACTCTGGAAAGCTAAGAATGAGGATCT","GGCTAGGCATGGTGGCTTATGCCTATAATCCCAGCACTTTGGGAGGCTGAGGCAGACGGATCACC"
"GL873564","13278924","13279152","chr20","69116969","69117193","62","55838045","AAAATAGAGAATAAGAATCCCTTGAGCTCATGAGTTCAAGATCAGTCTGAACAAGTGTCAGACCCTATCTCTACTAAAAATGGAAAAATTAGCCAGGCACTGTGGCAAGTGCCTGTAGTCCCAGATTTCAGGAGGCTGAGGCAGGAGAATCATTTGAATCCAGGAGTTTGAGGTTGCTGTGAGCTAGGCTGACACCACTGTACTGTAGCCTGGGCAACAGAGTGAGACT","GAGGTGGGTGGATCACCTAAGGTCAGGAGTTCAAGACTAGCCTGGCCAACATGGTGAAACTCCATCTCTACTAAAAATACAATAATTAGCTGGGTGTGGTGGCATGTGCCTGTAATTCCAGCTACTCAGGAGGCTGAGGCAGGAGAATCACTTGAACCCAAGAGGCGGAGGTTGCAGTGAGCCGAGACTATGCCACTGCACTCTACCCTGGGCAACAGAGCAAGA"
"GL873565","1417041","1417214","chr4","44130284","44130433","54","42713243","GGCCAGGCGTGGTGGCTCACGCCTGTTGTCCCAGCGATTTGGGAGACTGAGGTGGGTAGATCACCTGTACTCAGAGGTTCGAGACCAGCTGAAGACCAGCCTGAGGCAGAGTGAGACCCCCGTCTCTATAAGAACAAGACAGCCGGACCTTGTGATCCCAGCTACATGGGTGGC","GGCCGGGTGCGGTGGCTCACACCTGTAATCCCAGCACTTTGGGAGGCTGAGGTGGGCAGATAACCTGAGGTCAGGCGTTCGAGACCAGCCTGGCCAACATGGTAAAACCCCGTCTCTACTAAAAATACAAAAATTAGCCAGGTGTGGTGG"
"GL873565","2138367","2138455","chrX","124155143","124155229","17","122016776","GGCTGGGCGTGGTACTCACGCCTGTTGTCCCAGTGCTGTGGGAGGCTGAGGTGGGTGGATCCCCTGAGCTCAGCAGAGTTTGAGACCAG","GGCTGGGTGCGGTGGCTCACGCCTGTAATCCCAGAACTTTGGGAGGCTGAGGTGGGTGGATCACCTGGGGTGAAGAGTTCGAGACCA"
"GL873565","2459722","2459938","chr7","32729330","32729532","57","30269608","AAAAAGACCAAACACCCCAGCTCTACTAAAAGTAGAAAAATTAGCTGGGTATTGTAGTGGGCACCTGTAGTCCCAGCTGCTTGGGAGGTTGCGGCAGGAGAACCACTTAAGCCCAGGAGTTGGAGGGTGAGGTGGGCTGAGGCCACTGCATTCTAGCCTAGGCAACAGAATGAGACTCTGTCTCAAACAAACAAACAAACAAACAAACAAAAAACAA","GAAACCCCATCTCTACTAAAAATACAAAATTAGCCAGGCATGGTGGTGCACACCTGTAGCTCCAACTACTTGGGAGGCTGAGGCAGGAGAATCACTTAAACCCAGGCAGTAGAGGTTGCAGTAAGCCAAGATCGCACCACTGCACTCCAGTCTGGGCAACAGAGTGAGACTCTGTCTCAAAAAAAAAAAAAAAAAAAAAAAAA"
"GL873565","2460219","2460297","chr10","28805224","28805297","28","26345005","CTCAAGCCTGTAATTCTAGCACAGCTGGGAGGCTGAGGCAGGAAGATCTCTCAGCTTAGGATTTCAAGACTAAACACAT","GTGGCTCATGCCTGTAATCTCAGCACTTTGGGAGGCTGAGGCAGGCAGATAACCTGAGGTCAGGAGTTCGAGAC"
"GL873565","11485258","11485580","chrX","66383160","66383473","97","54897902","GGCAGGGCACAGTGGCTCAATCACAGCACTCTGGGAGGAGGCTTAGATGGGTGGATTATTTGAGTTCACAAATTTAAGAACAGCCTGAGCAAGAGTGACACCCTGTCTCTACTAAAAAACAATAGGAAAAATAAAAACTAGCTGGGCATAGTGGCATATGCCTGTGGTTCCAACTACTTGGGAGGCAGAGGCAAGTTTGCTTAGCTAGTTTTTTTTCAGGCCCAAGAGTAGAGGTTGTTGTGAGCTGTGATGCCATAGCACTCTACATAGAGTGACAGAGTGAGACTTTGTCTAAATAAATAAATAAATAAAATTTTAAAAAA","GGCCAGGCACAGTGGCTCACACCTGTAAATCCCAGCACTTTGGGAGGCCGAGATGGGTGGATCACCTGAGGTCACGAGTTTGAGACCAGCCTGGCCAACATGGTGAAACCTCGTCTCTACTAAAAATACAAAAAAAAAAAAAATTAGCTGGGCGTGGTGGTGTGCACCTGTAGTCCCAGCTACTTGGGAGGCTGAGGCAGGAGAATCGCTTGAACCCAGGAGGCAGAGGTTGCAGCGAGCCGAGATCGCGCCACTGCACTCCAGCCTAGGTGACAGAGTGAGACTCTGTCTCAAGGAAAAAAAAAAAAAAAAAA"
"GL873565","13424539","13424574","chr1","174086158","174086184","14","160661619","ACCTAGGGTGAAAGTAAGACTGTCTCAAAAAAAGAA","AAGAGAGAGAAAGAGAGAAAGAAAGAA"
"GL873565","13424654","13424896","chr16","19730961","19731217","54","6306307","GCCAAGCACAGTGGCTCACACCTGTAATCCCAGCACTCTGGGAAGCCTAGGTGGGTGGATTACTTGAGCTCAGGAGTTCAAGATCAGCCTAAGCAAGAGTGAAACTCCCATGTCTAAATAAACAGCCGGGCATTGTAGTGGGTCCCTGTAGTCCCAGCTACTCAGGAGGCTGAGGCAAGAGAATCGCTTGACCCAGGAGTTGGAGGTTGCTGTGAGCTGAGGCCACGGCACTCTATCTAGGGT","GGCCGGGCACAGTGGCTCACGCCTGTAATCCCACCACTTTGGGAGGCCGAGGCGGGTGGATTACCTGAGCTCTGGAGTTAGAGACCAGCCTAGGCAACATGGTGAAACCCCATGTCTACTAAAATACAAAAAGCCGGGCGTGGCGGCGTGTGCCAATAGTCCCAGCTACTCAGGAGGCTGAGGCAGGAGAATTGCTAGAACCCGGGAGGCGGAGGTTGCAGTGAGCTGAGATCACGCCACTGCACTCCAGCCTGGGC"
"GL873565","13679578","13679856","chr1","27657515","27657797","72","13977937","GCAGGGTACAGTGGCTCACACCTGTAATCATAGTAACTCTTAAGCGGCTGAGGCAAGTGAGAGGCCTGAGATCAGGAGTCCAAGAATAGCCTAACCAAAAGTGAGACCCCATCTCTACTAAAAATAGAAAAAAACTAGCCAGGCATGGTGGCACTTACCATAGTCCCACCTCATAAGGCTGAGGCAAGAGTATCACTTGAACCCAGAAGTTTGAAGTTGCTGTCAGCTACAATGACATCATAGCACTTTACCCAGAGCTACAGAGTAAGACTCAGTCTC","GCTGGGTGCGGTGGCTCACACCTGTAATCTCAACACTTTGGGAGGCTGAGATAGGTAGATCACCTGAGGTCAGGAGTTCGAGACCAGCCTGGCCAACATGGTGAAACCCCATCTCTACTAAAAATACAAAAAACCTAGCCAGGCATGGTGGTGTGTACCTATAATCTCAGCTATTCAGAAGACTGAGACAGGAGAATCACTTGAACTTGGGAGGTAGAGGTTGCAGTGAGCCAAGATCACACCACTGCACTCCAGCCTAGGCAACAGAGTGAGACTCCGTCTC"
"GL873566","947388","947684","chr3","178868174","178868466","60","177920786","GGCCGGGTAGGGTGGCTCATGCCTGTAATCCTAGCATTTTGAGAGGCCAAGGCAGGTAGATTACCTGAGCTCAGGAGTTCCAGACCAGGCTGAGCAAGAGCCCCATCTCTATCAAAAATAGAAAAATTAGCTGGGTATGGTGGCACATGCCTNNNNNNNNNNNNNNNNNNNNNNNNNNNNNNNNNNNNNNNNNNNNNNNNNNNNNNNNNNNNNNNNNNNNNNNNNNNNNNNNATGACACCATAGCACTCTAACCTGGAGCAACAGAGTGAGACACCGTCTTAAAAAAAAAAAAAAAA","GGCCGGGTGTGGTGGCTCATGTCTGTAATCCCAACACTTTGGGAGGCCAAGGCGGGTGGATCACCTGAGGTCAGGAGTTTGAGACCAGCCTGGCCAACATAGTGAAACCCCTCTACTAAAAATAAAAAATTAGCCAGGTGTGGTGGCANNNNNNNNNNNNNNNNNNNNNNNNNNNNNNNNNNNNNNNNNNNNNNNNNNNNNNNNNNNNNNNNNNNNNNNNNNNNNNNNNNNNNNNNNNNNNNNCTCCAGGCTGGGCAACAGAGTGAGGCTCCATCTAAAAAAAAAAAAAAAAA"
"GL873566","2530056","2530102","chr1","123145244","123145289","11","120615188","AGGCCAAGGCAGTTGGATCACCTCAGCTCAGGAGTTTGAGACCCGCC","AGGCTGAGGGAGGCGAATCACCTGAGGTCAGGAGTTTGAAACCAGC"
"GL873566","2923434","2923499","chr1","38303497","38303565","19","35380063","GGGCTCAATGGCTCAGCCTGTAATCTTAGCAGTCTGGGAGGCTGAGGCAGGCGCCTGAGCAAGAGT","GCTGGGCGCAGTGTCTCGTGCCTGTAATCCCAGCACTTTGGGAGGCTGAGGCAGGCGGATCATCTGAGG"
"GL873566","3613441","3613522","chr3","54039458","54039545","21","50426017","GGTGGCACATGCCCGTGATCCCAGCACTCTGGGAGGCCGAGGAGATCGGACTGCCTGAGCTCAGGAGTTCGAGACCAGCCTG","GCGCGGTGGCTCACGGCCTGTAATCCTTGCACTTTGGGAGGCTGAGATGGGTGGATTACCTGAGCTCAGGAGTTCGAGACCAGCCTGG"
"GL873566","6100482","6100582","chr2","51286276","51286376","32","45185794","GGCTGGGTGAGTACCTCATGCATCAAGCCCAGTGTTCTGGAGGCTGAGGCAAGGGGATCCTTGATGTGGATAGTTCAAGGCCAGCCTGGCAATTAGCTAGA","GGCTGGGTGCAGTGGCTCACGCCTATAATCCCAGCACTTCGGGAGGCTGAGGCAGGCAGGTCACCTGAGGCCAGGAGTTCAAGACCAGCCTGGCCAACATG"
"GL873566","6245586","6245714","chr3","50507869","50508002","30","44262283","GCTGGGTGTGGTGGCTCACACCTATAATACCAGCACTTGGGAGGCCAAAGCAAGTGGATTGCCTGAGTTCACAAGTTCAAGACCAGCCTGAGCAAGAGTGAGACCCTGTCTCTTAAAAATAGGTGGGCG","GCCAGGTGCGGTGACTCACACCTATAATCCCAGCACTTTGGGAGGCCGAGGCACGTGAATCACCTGAGGTCAGGAGTTCAAGACCAGCCTGACCAACATGGTGAAACCTTGTCTCTACTAAAAATACAAAAACT"
"GL873566","6245992","6246162","chr16","22888303","22888475","37","16642311","TAGCTGGGCGTTGTGGCGGGCATCTGTAATCCCAGCTACCTGGGAGGCTGAGGCAAGAAAATCACTTAAGCCCAAGAGTTTGAGGTTGCTGTGAGCTGTGATGGCACAGTACTCTATTGAGGGCAACATAGTGAGACTCTGTCTCAAAAAATAAATAAATAAATAAATAAA","ATTAGCTGGGCGTGGTGGTGGGCACCTGTAATCCCAGCTTCTTGGGAGGCTGAGGCAGGAGAATCACTTGAGCCCAGGAGGCAGAGGTTGCAGTGAGCAGAGATCGTGCCACTGCACTCCAGCCTGGATGACAGAGTCAGACTTTGTCTCAAAAAAAATAAAAAATAAAAAAA"
"GL873566","6483968","6484033","chr19","10207852","10207913","17","3723884","AAAATATGGTAAAATAAGCCAAGGATGGTGGGTCACACCTGTAATCCCAGCTACTCAAGAGACTGA","TAAAAATACAAAATTAGCTGGGTGTGGTGGCACACACCTGTAATCCCAGCTACTCAAGAGGC"
"GL873566","7043395","7043464","chr10","28805224","28805297","20","21761829","GGCTAGGCCTGGTAATCCCAGCACTCTAAAAGGCTGAGGCAGGTGGATAGCCTGAGCAAGAGTGAGACCA","GTGGCTCATGCCTGTAATCTCAGCACTTTGGGAGGCTGAGGCAGGCAGATAACCTGAGGTCAGGAGTTCGAGAC"
"GL873566","7888407","7888429","chr16","1275850","1275872","4","6612557","CTAAAAATAAAAAATTAGTCTTG","CTAAAAATACAAAAATTAGCCAG"
"GL873566","7888682","7888751","chr13","39203832","39203891","22","31315150","GTAGTCTTGGCGTAGTGATATGTACCTTTAATCCCAGCTACTCAGGAAGTGGAGGAGGAAAGAGTACAAG","TTAGCTGGGCGTAGTGGTGTGTGCCTGTAATCCCAGCTACTTGGGAGGCTGAGGCGGGAG"
"GL873566","8203857","8203949","chr20","18199749","18199840","19","9995892","GGCCCGGCATGGTGGTGCTTTGCCTATAATCCCAGCATTCTGGGAGGCCCAGGCAGGCGGATCACCTGAGCTCACAGGTTCAAGAATGGCCTG","GGCCGGGCATGGTGGCTCACACCTGTAATCCCAGCACTTTGGGAGGCTGAGGCAGGCGGATCACCTGAGGTCAGGAGTTCGAGACCGGCCTG"
"GL873566","8268872","8268975","chr15","10815564","10815667","26","2546692","GTGGCTCATGCCTGTAATCCTAGCACTCTGGGAGGCCGAGGCAGGTGGATTCCCTGAGCTCATAGGTTTGAGACCACAAGCAAGTCCAAGACCCCATCTCTTTT","GTGGTTCATGCCTGTAATCCCAGCACTTTGGGAGGCCGAAGTGGGCGGATCACCTGAGGTCAGGAGTTTGAGACCATCTGGCCAAGATGTAGAAACCCCATCTT"
"GL873566","8269263","8269458","chr15","77706857","77707054","55","69437594","AAGACCCCATCTCTTAAAAAAGAAAAAAAAAGCTGGGTGTTGTGGCCTTCACCTGTAGTCCCAGCTACTGGGGAGGCCAAGGCAAGAGACTTGCTTGAGCCAGAGTTTGAGGTTGCTGTGAGCTATAGTGCCACGGCACTCTACCAAAGGCAACAAAGTGAGACTGTCAAAAAAAAAAAAAAAAGAAGAAGAAGAA","CCCCATCTCTATTAAATATACAAAAAAATAGCTGGGTGTGGTGGTGTGCGCCTGTAATCCCAGCTACTTGGGAGGCTGATGCAGGGGAAGTGCTTGAACCAGGGAGGTGGAGGTTGCAGTGAGCCGGAATCGTGCCACTGCACCCCAGTCTGGGCAACAGATTGAGACTCTGTCTCAAGGAAAAAAAAAAAAAAAAAA"
"GL873566","8592056","8592127","chr10","28805224","28805297","15","20213168","TCTTGCCTGTAATCTCAGCACTCTGGGAGGCTGAGGCAGGCAGATCAACTGAGCTAACAAGTTCGAGACCAG","GTGGCTCATGCCTGTAATCTCAGCACTTTGGGAGGCTGAGGCAGGCAGATAACCTGAGGTCAGGAGTTCGAGAC"
"GL873566","8809109","8809200","chr11","48033118","48033204","26","39224009","ATAGCCAGGCTTGTTGCAGGCACCTGTAGTCCCAGTTACTCTGGAGGCTGAAGCAAGGGAATATCTTGAGCCCAAGAGTCTGAGGTTGCTGT","TTAGCCTGGCATGGTGGTGACACCTGTAATCCCAGCTACTCAGGAGGCTGGGAAGGAAAATCGTTTCAACCCAGGAGGCAGAGTTTG"
"GL873566","8809477","8809608","chr19","10830410","10830544","33","2020933","GGCCAGGCGCAGTGCCTCATGCCTGTAATCCTAGAACTCCGGGAGGCTAAGGAGGGTGGATTTCCTGAGTTCACAGGCTGGAGACCAGCCTGATCTAGAGTGAGATTCCCAGCTCTAAAAATAGCTGGCCTT","GGCCAGGTGCAGTGGCTCATGCCTGTAATCCCAGCACTTTGGGAGGCCAAGGTGGGTGGATCACCTGAGGTCAGGAGTTCGAGACCAGCCTGATCAACGTGGTGAAACCCCATCTCTACTAAAATTGCAAAATTA"
"GL873566","9503716","9503881","chr12","63241189","63241340","56","53737473","TATTAAAAAAAAAAGGAATTCAAGGCCAAGAGCAGTGGCTTTTGCCTGTGATACTTCCACTGTAGGAGGCCGAGGTGGAAGGATCACTTGAACTCTGGAGTTTGAGGTTGCTGTGATCTAGGCTGACACCACAGCACTCTAACTTGGTGGGCAACAGAGCAAGACT","AAAAACAAAAATTAGCCAGGTGTGTTGGCATGCACCTGTAGTCCCAGCTACTAGGGAGGCTGAGACAGAAGAATCACTTGAACCCAGGAGGTGGAGGTTGAGTGAGCCAAGATCGCGCCACTGCACTCCAGCCTGGGTGACAGAGCGAGACT"
"GL873566","9537883","9537992","chr16","43341998","43342113","30","33804115","ATGCCTGTAATCCTAGCACTTGGGAGGCCAAGGTGGGTGGATTGCCTGAGATCACAGGTTCAAGACCAGCCTGAGCCAGAGTGAGACCCTGCCTCTAAAATGAGCCAGGT","GCCTGTACTCCCAGCACTTTGGGAGGCCAAGGCGGGTGCATCACCTGAGGTCAGGGGTTCAAGACCAGCCTGGCCAACATGGTGAAACTCTGTCTCTACTGAAAATTCAAAAAATT"
"GL873566","9538266","9538462","chr7","167658032","167658223","54","158119766","TTAATTAATTAATTAAATAAAATGAGCCAGGTGTTGTGATGGGCGCCTGTAGTCCCAGCTACTTGGGAGGTGGAGGCAGGATAATCACTTGAGTCCAGGAGTTGGAAGTTGTTGTGAGCTGTGACGCCATTGTACTTGACCCAGGGCGACATCTTGAGGCGCTCTCTCTCAAAATAAATAAATAAAGAAAGAAAGAA","TACTAAAATACATACAAAAATTAGCCAGGTATGGTGGCAGGCCCCTGTAGTCCCAGCTACTCGGGAGGCTGAGGCAGGAGAACTGCTTGAACCCAGGAGGTGGGGATTGCAGTGAGCTGAGATCGCACCACTGCACTCCAGCCTGAGCGACAGAGTGAGACTCTGTCTCAAAAATAAAAAAAGAAAAAAAAA"
"GL873566","13663722","13663916","chr1","23558411","23558571","70","9894689","CTCAAGACCAGCCTGAGCCAAGAACGAGACTGAAAATAGAAAAATTAGTGGGACGTTATGTTGAGTGCTGGCTACTCTAGAGGGTGAGGTAGGAGAATTGTTTAAACTCATGAATTTAAGGTTGCTGTGAGCTAGGCTGACGCCACAGCACTGTAGCCTGGGCAACAGGCTACAGAACAGAGTGAGACTCTGTTT","AAAAATACAAAAATTATCTGGGCATGGTGGTGGGTGCCTGTATTCCCAGCTACTCTGGAGGGTGAGGCGGGAGAATTACTTGAACCCAGGAGGTGAAGGTTGCAGTGAGCCAAGATCACGCCACTGCACTCTAGCCTGGGCAACAGAATGAGACTCTGTCT"
"GL873566","13664206","13664293","chr7","151280825","151280914","17","137616619","GGCTAGATATGGTGGCTCATGCCAGTAATCTTAGCACTTTGGGAGGCTGAGGGGAGAGGATCACTTGAGCTGAAAAGTTCAAGACCAA","GGCCAGGCATGGTGGCTCATGCCTGTAATCCCAACACTTTGGGAGGCTGAGGTGGGTGGATCACTTGAGGCCAAGAGTTCAAGACCAGCC"
"GL873567","8375378","8375469","chr3","123612391","123612479","29","115237013","GGTTGGGCTTGGTGGCACGTACCTATGATCATCCTAGCTACTCAGGGAGCATAAGGCAGAAGAATTGCTTTAGCCCGGGAGTTGAGATCAAC","TTAGTTGGGCGTGGTGGCGCATGCCTGTAATCCCAGCTTCTCGGGAGGCTGAGGCAGGAGAATGGCTTGATCCCAGGAGATAGAGGTTG"
"GL873567","9062667","9063009","chr7","6620384","6620702","97","2442283","GGCCAGGCGTGGTGGCTCACGCCTGTTGTCTCAGCGCTGTGGGAGGCCGAGGCGGGTGGATCGCCTGTGCTCAGAGGTTCGAGACCAGCATGAGCCAGAGTGAGAGCCAGAGTAAGACCCCCTCTCTACCAAAAATTGCTGGGTGTTCTGGCAGGTGCCTGTAATTCCAGGTACTTGGGAGGCTGAGGCTAGAGAATCACTTAAACCCAGGGACCCAGGGGTTGGCGGAGGTTGCTGTGAGCTATGATTCTATGGTATTCTACTGAAGGACACAAAGCGAGACTCTGTCTCCATAAATAAATAAATAAATAAATAAAATAAAAGCAAAATTAAAAAAAAAAAA","GGCCAGGCACAGTGGCTCATGTCTGTAATCCCAGCACTTTGGGAGGCCGAGGCGGGTGGATTACCTGAGGTCAGGAGTTCTAGACCAGCCTGGCCAACAAGGCGAAACCCTGTCTCTACTAAAAATACAAAAAATTAGCTGGGCGTTTTGGCACATGCCTGTAATCCCAGCTACTTGGGAGGCTGAGGCAGGAGAATTGCTTGAACTGGGGAAGTGGAGGTTGCAGTGAGCTGAGATCACACCATTGCACGCCTGAGCAACAGAGCGAGACTCTGTCTCAAAAAAAAAAAAAAAAAAAAAAAAGAAAAGAAAAAGAAAA"
"GL873567","11215752","11215787","chr1","62915138","62915167","12","51699386","CAATAAAGCAAGACTCTGCCTCCAAAAGAAAAAAAA","CAAACAAACAAACATCACAAAAAAAGAAAA"
"GL873567","11215868","11216117","chr8","45194211","45194474","73","33978343","GGCTGGGTGTGATGGTTCAGGCCTGTAATCCCAGCGCTCTGGGAGACCAAGGCAGGATAGCCTGAGGTTAAGAGTTTGAGACCAGCCTGAGCAACACAAGACCCTGTCTAAACCAGGAAAATTACTGGGGTGTGGTGGCGTGTGCCTTAATCCCAACTACTCAGGAGGCTAGAGTATTGCTTGAGGGCAGAAGACTGAGGTTGCTGTGAGGAAAGGCTAAGGTCAAGCCATTCTAGCCCAGGCAATAGAG","GGCCGGGTGTGGTGGCTCATGCCTGTAATCCCAGAACTTTGGGAGGCCAAGGCAGGTAGATTACCTGAGGTCAGGAATTGGAGACCAGCCTGGCCAACATGGTGAAACCTCTTCTGTACTGAAAATTACCTGGGCATGGTGGCACACGCCTATAATCCCAGCTACTCAGGAGGCTGAGGCAGAATTGCTTGAGCCCGGGAGACAGAGGTTGCAGTGAGCCAAGATCGTGCCACTGTCCTCCAGTCTGGCCAACAGAGCAAGACT"
"GL873567","12342574","12342696","chr3","166690011","166690120","46","154347437","GTACGCGCAAACCAGAAAAATCAACTAGGTGTGGCAGGGCACACCTGTAGTCCCAGCTACTGGGGAGGGTGAAGCAAGAGATTGCTCAAGTCTGAGGTTACAGTGAGTTAAGATGATACCACT","TACACATACAAAAAATCAGCTGGGTGTGGTGGTACATGCCTGTAATCCCAGCTACTCAGGAGGCTGAGGCCGGAAAATCACTTGAACCCAGGAGGCAGAGGTTGCAGTGA"
"GL873567","12342734","12342873","chr8","96368294","96368428","43","84025560","GGCCAAACACAGTAGTTTATACCTATAATTCCAGCACTCTGGGAAGCTGAAGCAGAAGGATCAGCTGAGGTCAGGAGCCTCAAGACAAGCCTGGGCAAGACTAAGACTCCCCTCCATCCCTTCCCCCACTGTCTTCTCAC","GGCCAGACACAGTGGCTCACACCTGTAATCCCAGCTCTTTGGGAGGCTGAGGCAGGCGGATCACCTGAGGTCAGGAGTTCAAGACCAGCCTGGCCAACATGGTGAAACTGCATCTCTACTAAAAATATAAAACCA"
"GL873568","4322030","4322103","chr11","54983169","54983243","11","50661139","GGCCAGGCGCAGTGGCTCATGCCTTTAATCATAGCACTCTGGGAGGCTGAGGTAGGCGGATCTCCTGAGCCAGG","GGCCAGGTGCAGTGGCTCATGCCTGTAATCCTAGCACTTTGGGAGGCCGAGGTGGACCGATCACCTGAGGTCAGG"
"GL873568","4439574","4439747","chr7","26745376","26745549","54","22305802","GGCTGGGCATGGTGCTCACACCTGTAATCATAGCACTCAGGGAGGCCGAGGTGAGTGGATTGCCAGAGCTCACAGGTTTGAAACCAGACAGAGCCTTTTTTTTTTTAGAAGAAATTGTAGGCTGGGCATGGTGCTCATACCTGTAATCATAGCACTTGGGAGGCCAAGGCAAGA","GGCTGGGCATGGTGGCTCACGCCTGTAATACCAGTACTTTGGCAGGCCGAGGCGGGCAGATCACCTGAGGTCAGGAGTTCAAGACCAGCCTGGCCGTTTCTACTAAAAATACAAAAAATTAGCTAGGCATGGTGGTGCGCACCTGTAATCCCAGCTACTCGGGAGGCTGAGGCA"
"GL873568","4546898","4547014","chr15","31980678","31980795","24","27433780","GGCAGGGTGTGGTGTACACCCCTATAATCCCAGCACTTTGGGAGGCTAAGGCAGGAGCATCACCTGGGGCAGGAGTTCAAGGCCAGCCCGGAGAACAGAATGAAACTCCATCTCCAC","GGCAGGGCGTGGTGGCTCACGCCTCTAATCCCTGCACTTTGGGAGGCCAAGGCAGGCAGATCACCTGAGGTCAGAAGTTCAAGACCAGCCTGGCCAATGTGGTGAAACCCCATCTCCA"
"GL873568","5509331","5509406","chr12","122182458","122182528","25","116673127","TAATCCTAGCACCCTAGGAGGCCCAGGTGGGTGGATTACCTGAGCTCAGGAGTTCAAGAGCAAAAGTGAGACCCCT","CCCAGCACTTTGGGAGGCCAAGGCAGATGGATCACCTGAGGTCAGGAGTTGAAGACCAGCCTGGCCAACAT"
"GL873568","5509687","5509883","chr11","2904691","2904882","40","2604996","GTGAGACCCTTGTCTCTACTAAAAGTAGAAAAACTAGCCAGGTGTTGTGGCAGGTGCCTGTAATACCAGCTACTTAGAAGGCTGAGGCAGGAAGATCAGTTGAACCAAAGAGTTTGAGATTGCTGTGAGCTATGATGAAGCCACAGCACTCTACTATCCAGAGCGACAGAGGGAGACTCTGTCTCCAAAAAAAAAAA","GTGAAACCCTGTCTCTACTAAAAATACAAAAATTAGCCAGGTGTGGTGGTGCATGCCTGTAATCCCAGCTACTCAGGAGGCTGAGGCAGGAGAATCACTTGAACCCAGGAGGTGGAGGTTGCAATGAGCCAAGATCGTGCCACTGCACTCCAGCCTGGGTGACAGAGCGAGACTCCATCTCAAAAAAAAAAA"
"GL873568","7119774","7119822","chrX","41233833","41233871","13","34114059","AAAAGTAAAAAATGAGCCGGGTGAGGTAGCTCACGCCTGTAATCCCAGC","AAATCAGCCGGGTGTGGTGGCTCACGCCTGTAATCCCAG"
"GL873568","10881797","10881967","chr1","164648998","164649168","46","153767201","AAAATCACATATTTGCCTGGCATGTTGACTCATGCCCCTATGATCCTAGCACTCTGGGAGGCTGAGGCAGGAGCCTCACTTGAGTCTGTGAGTCTGAGGTTGCTATGAGCAAGGCTGATGCCATGATACTCTAGTGTGGTACAACAGAGTGAGACTCTGTCTCAAAAAAAA","AAAAACACATATTAGCTGGGTATGGTTGTGCGTGCCTGTAATCCCAGCTACTTGGAAGGCTGAGGCAGGAGAATCACTTGAACCCGTGAGGCGGAGTTTGCAGTGAGCTGAGATTGTGCCACTGCACTCCAGCCTGGGCAACAGAGCAAGACTCTGTCTCAAACAAACAAA"
"GL873569","1403943","1404082","chr2","53765152","53765289","48","52361209","AAGCTGAAGCAGAAAAACGGGCTAGAGGTCAAAAGTTTGAGACCTACCGTGGCTACACAGCAAAACTCTGTCTCTAAAAAAAATAAATAAGACCAGGTAAGGTGGTCATGACTATACTCCTAGCCCCTTAAGAGGCTGAG","GAGGTGGGTGGATCACCTGAGGTCAGGAGTTCCAGAACAGCCTGGTCAACATGGCGAAACACTGTCTCTACTAAAAATACAAAAATTAGCCAGGTGTGGTGGCATGCACCTGTAGTCCCCGCTACTCAGGAGGCTGGG"
"GL873569","7343422","7343556","chrX","124155286","124155406","55","116811864","TTTGAAAGTAGACTGCAAACATCATGTTGCTTCACCTCTAAATATATTAATATGGGCCAGGTGCAGTGGATCATGCCTGTAATCCTAGCACTTGCTAGGCCAAGGCTGGCGGATAGCCTGAGCAACAGCGAGACC","ATCAGCCTGACCAACATAGTGAAACCCCATCTCTACTAAAAATGCAAAATTAGCTGGGCGTGGTGGTGCATGCCTGTAATCCCAGCTACTTGGGAGGCTGAGGCGGGAGAATCACTGGAAC"
"GL873569","7404564","7404762","chr6","586928","587122","48","6817636","GAGATCCCATCTCTTAATGAAAATAAAACAATTAGCTGCTATTGTGGCAGGCACCTGTAATTCCAGCAACCCAGGAGGCTGAGGCAGGAGGATCACGTGAACCCCACCAGTTTGAGGTTGCTATGAGCCAGGCTGATGCCAGGACACTCCAGCCTGGGCAACGGAGTGAGACTCCATCTCCAAAAAAAGCAAACAAAAA","GAAACCCCATCTGTACTAAAAACACACAAATTAGTGGGATGTGGTGGCACGTCCCTGTAATCCTAGCTATTCAGGAGACTGAGGCAGGAGAATCACTTGAACCCAGGAGGTGGAGGTTGCAGTGAGCCGAGGTCACACCACTGCACTCCAGCCTGGGCAGCAGAGTAAGACTCCATCTCAAAACAAAAACAAAAA"
"GL873569","7405040","7405133","chrX","21386588","21386682","29","13981548","GGGCAGGGCGGCTCAGGCCTCTAATCCTAGCACTCTGGGAGCTTCCTTGAGCTCAGGAGTTCAAGACCATCCTAAGCAACAGAGATCCCATCTC","GCTGGGCACGGTGGCTCACGCCTGTAATCCCAGCACTTTGGGAAGCCAAGGTTTGAGGTCAGGAGTTCAAGACCAGCCTGGCCAACAGGCTGCAA"
"GL873548","15249374","15249463","chr5","46485072","46485159","19","31235698","GGCCAGGCATGGTGGCTCATACCTATTGTCCTAGCACTGTGGGAAGCCAAGGCAAGTGGATCACCTGAGCTCTAGAGGTTCGAGACCAGC","GGACAGACACAGTGGCTCATGCCTGTAATCCCAGCAGTTTGGGAGGCCAAGGCAGGTGGATCACCTGAGGTACAGAGTTCAAGACCAG"
"GL873548","15817199","15817306","chr7","158031905","158031997","37","142214706","AAAAAAAAAGAGTTGGAGGTTGCTATGAGCAACATCAGCATGGCACTCAATTCCAGGGTGACTGACTGAGACTGTTGTAGCTATACTCCAAAAAAAAAAACACACAAA","CCAGGAGGTGGAGGTTGCAATGAGCCAAGATCACACCACTGCACTCCAGCCTGGGTGACAGGGTGAGATTCTGTCTCAAAAAAAAAAAAAAAA"
"GL873548","15817589","15817786","chr3","3025868","3026088","60","12791721","GGCCAGGCATGGTGGCTTCTGTAATGCCAGCATTCTGGAAGGCTGAGGTAGGCAGTAGCTTGAGCTCAGTAGGAGAACAGCCTGACCAAAAGTGAGACCCTGTCTCTAAAAATAGTCGTTTGTGGTGGTTACCTGTTGTCCCAGCTACTAGGGAGGCTGAGGCAAGAGAATCACTTGAGCGTAAGAGTTGGAGGTTGC","GGCCAGGCACGGTGGCTCATGCCTGTAATCCCAGAACTTTGGGAGGCTGAGGTGGGCAGATCACCTGAGGTCAGGAGTTGGAGACCAGCCTGACCAACATGGTGAAACCCTGTCTCTACTAAAAATACAAAATTAGCCAGGTGTAGTGGCACGTGCCTGTAATCACAGCTACTTAGGAGGCTGAAGTAGGAGAATCACTTGAACCTGGGAGGTGGAGGTTG"
"GL873548","15856498","15856605","chr18","35090078","35090171","38","19233580","CCCCCCCCAAAAAGAAAAGGGTTGCTTGAATCTAGGAGTTTGGGGTTGCTGTGGGCTAAGCTGATACCACAGCACTTTAGCCTGAGCAAACAGAGTGACACTCTGTCT","AAGCAGGAAATCGCTTGAACCCAGGAAGCAGAGTTGCAGTGAGCCAAGATCGCACCACTGCACTGCAGCCTGAGCAACAGAGAAAGACTCTGTC"
"GL873548","15856683","15856877","chr3","3200882","3201085","53","12655801","GCCAGGCACAGTGGCTCATGCCTATAATCCTAGCACTCTGGGAGGCCAAGGCAGGATTGTCTAAGCTTGGGAGTTTGACAGCAGCCTGAGAAAGATTGAGACCCCTGTCTCTACTAAAAAATAGAAAAATTAGCTGAGTGTTGCAGCAGGTGCCTGTATTTCCAGCCAAGGGGGAGGTTGAAAAGGGTCGCTTCA","GGCCAGGCGCAGTGGCTCATGCCTGTAATCCCAGCACTTTGGGAGGCCGAGGCGGGTGGATCATAAGGTCAGGAGTTTGAGACCAGCCTGGTCAACATGGTGAAACCCCATCTCTACTAAAAATACAAAAATTAGCTGGGTGTTGTGGCACATACCTGTAATCCCACCTACTCAGGAGGCTGAGGCAGGAGAATCACTTGAACC"
"GL873549","1940307","1940608","chr12","9481260","9481565","74","7540953","GGCTGGGCGCAGGGGCTCATGCCTGTGACCCTAGCACCCTGGGAAGCCAAGGCGGGCAGATCGCCTAAGCTCACGAGTTTGAAACCAGCCTTAGCTAGAGTGAGACCCCCAATACTAAAAAAATAGCCAGGCTTTGTGATGGGCGCCTGTAGTCCCAGCTACCTGGGAGGCTGAGGCAAGAGAATGGCTCAAGCCCAAGAGTCTGAGGTCACAGTGAGCTACTGACGCCACCGCACTCTATTGGAACAACAAAGTGAGACTGTGTCTCAAACAAACAAACAAACAAACAAACAAAAAAGAAA","GCTGGGCGCGGTGGCTCATGCCTGTAATCCCAGCACTTTGGGAGGCCAAGGCAGGTGGATCACCTGAGGTCAGGAGTTCGAGACCAGCCTAGTCCACATGGTGAAACCCCATCTCTACTAAAAACTAGCCAGGCGTGGTGGTGCGCACCTGTAATCCCAGCTACTCGAGAGGCTGAGGCAGGAGAATCACTTGAGCCTAGGAAGCAGAGGTTGTGGTGAGCTGAGATCACACCACTGCACTCCAGTCTGGGCGACACAGTGAGACTCTTGTCTCAAAAACAAAAAACAAACAAACAAACAAACAAA"
"GL873549","2657819","2658019","chr11","18547798","18548000","50","15889979","GGCCTGGCACTGTGGCTCACACCTGTCAGGTTAACACTCTGGGAGGCTGATATGGGTGGGTCTCCTGAGTTTAGGAGTTTAAGACCAGCCTAATCAAGAGTAAGACCTGCCTTTACTAAAAATAGAAACACTCACCAGGACTACTGTGCACCTACAGTCCCAGCTACCTGGGAGGCTGAGGCAAGAGGATTGCTCAAGCCC","GGCCAGGCACTGTGGCTCACACCTGCAATCCCACCACTCTGGGAGGCAGAGGCAGGTGGATCACCTGAGGTCAGGAGTTTGAGACCAACCTGGCCAACAGAGCAAAACACTGCCTCTACTAAAAATACAAAAACTAGCCAGGTGTGGTGCATGCCTATAGTCCCACCTACTTGGGAGGCTGAAGCAGGAGAATCTCCTGAGCC"
"GL873549","8853848","8853952","chr12","88112976","88113081","32","79259128","AGCCAGCTGTGTGGCTCATTCCAGTAATTCCAGTTACTGGGGAGGCTGAGACAGGAGGATCACTTGAATGCAAGAGGTGGCGAGAACTCAGCTTTAAAAATAAAA","GGCCAGATGCAGTGGCTCATGCCTGTAATCCCAGCACTTTGGGAGGCTGAGGCAGGCGGATCACCTGAGATCAGGAGTTTGAGACCAGCCTGGCCAACATGGTAAA"
"GL873549","10378794","10378882","chr20","18199749","18199840","17","7820955","GGCCAGGCACGGTGGTTCACCTGTGATCCCAGCACTCTGGGAGATAAGGCAGGCTGATCACCTGAGTTCACAGGTTGGAGACCAGCCTG","GGCCGGGCATGGTGGCTCACACCTGTAATCCCAGCACTTTGGGAGGCTGAGGCAGGCGGATCACCTGAGGTCAGGAGTTCGAGACCGGCCTG"
"GL873549","15488169","15488282","chr10","38476693","38476794","41","22988524","CTGAGCACACGGGTTCACACCTGTAATCCCAGCACGCTGAGAAGCCCAGGCAAGAGGCTGACCTCCAGCCTGGGTGACGGAGCGAGATTCCCCCCCACCCCCGACCAAAAAAAA","CTGAGCGCTGGTAGCTTACACCTGTAATCCCAGCACTTTGGGAGGCCTAGACAGGCGGATCACTTGGGGTCAGGAGTTTGAGACCAGCCTGGCCAATATGAT"
"GL873549","17403348","17403519","chr10","38461164","38461337","46","21057816","GCCAGGCACAGTGGCCCACACCTGTAATCCCAGTACTGTGGGAGGCTGAGGCAGGCTGAGGCAGGCATGGATCACTGAGGTTGCTGTGAGCTAAGATGCCATGGCCCTCCACCCAAAGTGACAGAGTGAGACTCTGTCTCAGAATTAAAAAAAACAAAGAAAGAAAAATAAA","GCCAGGCATGGTGACTCACGCCTATAATCCCAGCACTTTGGGAGGCTGAGGCATGAGAATCACTTGAACCCAGAAGGCAGAGGTTGCAGTGAGCTAAGATTGTGCCACTGTACTCCTGCCTGGGTGATGGAGTGAGACTCTGTCTCGATTTAAAAAAAAAAAAAAAAAAAAAAA"
"GL873550","801968","802043","chr15","50500527","50500602","20","49698559","GTAGCCAGGTATGGTAGTGCAGGCCTGTACTCCCAGCTACTTGGAAAGCTAAGGCAATAGAATCATTTAAGCCCAG","TGGCCGGGCATGGTGGTACATGCCTGTAATCCCAGCTACTTGGGAAGCTGAAGCAGGAGAATTGCTCGAACCCAGG"
"GL873550","802343","802376","chr3","33494224","33494257","9","32691881","TAAGACTTTGTCTCTACTAAAAATAGAAAAAGTG","GTGAAACCCGTCTCTACTAAAAATACAAAAATTA"
"GL873550","2805841","2805900","chr2","93673843","93673900","18","90868002","CTATTCAAAATAGCTAAAATGGGCAGGGCAAGGTGGCTCACACCTGTAATCCCAGTACTC","TAAAAATGTAAAAGATTGGCCGGGTGTGGTGGCTCACTCCTGTAATCCCAGCACTTTG"
"GL873550","4153085","4153214","chr16","18855701","18855834","37","14702616","GGCAGGGCTTGGTGGTAAAAGCCTGTAATCCTACCACTCTGGGAGGCAGAGGTGGTTAGATTGCATGAGGTCACTGGTTGGAGACCAGCCTGAGCTAGAGCAAGACCTCATCTCCAAAAATAGCAGGGCT","GGCTGGGCGCGGTGGCTCACACCTGTAATCTCAGCACTTTGGGAGGCCGAGGTGGGTGGATCACCTGAGGTCAGGAGTTCGAGACCAGCCTGGCCAACATGGCAAAACCCCATCTCTACAAAAATACAAAATTA"
"GL873550","4153472","4153634","chr7","17472856","17473028","43","13319384","AATAAAAATAGCAGGGCTTTGTGGCGGGCACCTGTAGTCCCAGCTACTTGGGAGGCTGAGGCAAGACAATTGCTTGAGCACAAAGTTGGAGGTTGTTGTGAGCTGTGACATCATAGCACTCTACCAAGGGAGATAGAGTGAGACTATCTCGAAGAAAAAAAAA","ATACAAAAATTAGCCAGGTGTAGTGGCGTGCACCTGTAATCCCAGCTACTCGGGAGGCTGACGCATGAGAACTGCTTGAACTCAGGAAGTGGAGGTTGCAGTGAGCTGAGATAGTGCCACTGCACTCCAGCCTGGGTGACAGAGCAAGACTCCATCTCAAAAAAAAAAAAGAA"
"GL873550","6050671","6050965","chr7","84009904","84010193","74","77959233","GGTGGCTCACGCCTGTTATCCTAGCACTCCAGGAGACTAAGGTAGGAGGATGCCTTGCTTGAACTCAAGAGTTCAAGACCAGTCTGAGTGAGAGGGAGACCCTGCGTCTACTCAAAAATAGAAAAATTTACCAGCCATTGTGGCCAACACCTGTAGACCCAGCTATTCAGGAGTCTGAGGCCAGAGAATCACTTGAACCCAGGAGACTGAGATTGCTGTGAGCTAGGCTAAAACCATGGCACTCTAGCCCAGGTGGCAGAGTGAGACTGGGTCTGCAAAAAATAAATAAAAACAA","TGGCTCATGCCTGTAATCCTAGCACTTTGGGAGGCCAAGGCAGGTGGATTGCCTGAGCTCAGGAGTTCAAGACCAGCCTGGCAACACGATGAAACCCCGTCTCTATTAAAAAATACAAAAAATTGGCCAGGCATGGTGGTGTGCACCTGTAATCCCAGCCACTCAGGAGGCTGAGGCAGGAGAATCGCTTGAACCCGGGAGACAGAGGTTGCAGTGAGCCAAGATCGAACCATTGCACCCCAGCCTGGGTGAGAGTGAGACTCTGTCTAAAAAAAAAAGAAGAAAAAGAA"
"GL873550","6212004","6212068","chr19","50425309","50425373","23","44213305","AGAACCTAAGAGTTTTGAGGTTGCTATGAGCTGGACTGATACCATAGCATTCTAGTCTGGGTGAC","TGAACCCAGGAGGTGGAGGTGGCGTGATGCCCAAGATGTGCCACTGCACTCCAGCCTGGGTGATA"
"GL873550","6212319","6212418","chr17","89042086","89042197","34","82829767","CTGTCTTTTCTAAAAATAGAAAAACTAGCTGGGTTGTGGTGGGCACTTGTAGTCCTAGGTACTCTGAGGCTGAAACAGGATTGCTTGAACCTAAGAGTTT","GTCTCTACTAAAAATACAAAAATTAGCCGGGCATGCTGGTGGGCACCTGTGATCTCAAGCTACTTGGGAGGCTGAGGCAGGAGAATCACTTGAACCTGGGAGGCAGAGGTTG"
"GL873550","6504310","6504401","chr19","2969698","2969794","27","3534612","GTGCTGGTGTATGCACCTGTCATACCAGCTACTCCTGAGGTTGAGGCAGGATAGCTTGAACCCGGGAGTCTGAGACTGCAGTGAGCTGGGAT","TTAGGCGTGGTGCATGTCTGTAATCCCAGCTACCCGAGAGGCTGAGGCAGGAGAATCACTTGAACCTGGGAGGCGGAGGTTGCAGTGAGCCGAGATC"
"GL873550","7178331","7178523","chr19","40691105","40691269","60","33512774","GGCCAGACGCGGTGGCTCACGCCTGTTGTCCCGGCACTGTGGGAGGCCGAGGCTGGTGGATCCCCTGAGCTCAGCCAAGTTCAAGACCAGCGGAAGACCAGCATGAGGCAGAGTGAGCCAGAGTGAGACCCCGTCTCTACAACAACAACAACAAAAAATAGCCGGACCTTGTGATCCCAGCTACATGGGAGGC","GGCCGGGCATGGTGGCTCACGCCTGTAATCCCAGCACTTTGAGAGGTCGAGGCAGGTGGATCACCTGAGGTCAGGAGTTCGAGACCAGCCCGGCCAATATGGTGAAACCCCTTCTCTACTAAAAATACAAAAAATTAGCCGGAAGTGGTGGCATGCACCTGTGAT"
"GL873550","7981631","7981790","chr6","148611209","148611366","40","140629578","ATAGCCCCGCCTTGTGGTAGGCTCCTGTAGTCCCAGCTACTTGGGAGGCTGGGGCAAGAGAATCACTTAGGCCCAAGAGTTGGAAGTTGCTGTGAGCTGTGATGCTACAGCATTCTACTGAGAGTGACAAAATGAGACTCTGTTTAAAAAAAAAAAAAAA","TTAGCTGGGCATGGTGGCAGGTGCCTGTAATCCCAGCTACTCTGGAGGCTGAAGCAAGAGAATCGCTTGAACCCAGGAGGTGTAGGTTGCAGTGAGTCGTGCCACAGCACTCCATCCTGGGTGACAGAGCAAGACTCTGTCTCAAAAAAAAAAAAAAA"
"GL873550","7982053","7982180","chr2","182489403","182489528","28","174507350","GGCTGGGCGAGGTTGTTCAGACCTGTAATCCTAGCACTCTGGGAGACCAAGATGGGTGGATTGCCTGAGTTCATGAGTTTGAGACCAGCCTGAGCCAGAGTGAAACCTTGTTCTCTAAAAATAGCTCG","GGCCGGGTGTGGTGGCTCATGCCTGTAATCCTAGCGCTTTGGGAGGCCGAGGTGGGTGGATTGCCTGAGCTCAGGAGTTCGAGACCAGCCTGGGCAACACGGTGAAACCTGTCTCTACTAAAATAC"
"GL873550","8404122","8404320","chr4","121405930","121406135","43","113001808","GGCCAGGCACAGTGACTCACACCTGAAATCTTAGTACTCTGGGAGGCCAAGGTGGGAGGATTTCCTGAGGTCAGGAGTTCAAGACCAGCCAGAGCAAGAAGATCCTGTCTCTACTAAAAGTATAAAAAGTGAACCAAGTGTGGTAGTGAGCACCTATAATCTCAGCTACTTGGGAGGCCGAAGCAAGAGGATCACTTGA","GGCCAGGCACAGTGGCTCACACCTGTAATCTCAACACTTTGGGAGGCCAAGGTGGGTGGATCACCTGAGGTCAGGAGTTTGAGACAAGCCTAGCCAGCATGGTATAACTCCATCTCTACTAAAAGTATAAAAATCAACCAGGTGTGGTGGCACATGCCTGTGGTCCCAGCTACTTGGGAGGCTGAGGCAGGAGAATCACTTGAATC"
"GL873550","8404408","8404483","chr15","701469","701538","22","7702939","AGGATCTCTTGAGCTCGGGAGTTTGAGGTTGCAGTGAGCCAGGCTGATGTCATGGCACGCTACCCAAGACAACAAA","AATCACTTGAACCCAGGAGGCAGAGGTTGCAGTGAGCCAAGACTGTGCCATGGCACTCTAGCCTGGGCAA"
"GL873550","11648593","11648682","chr3","124881947","124882027","31","113233354","GTGGCTCACACTAGTAATCTTAGTACTTTGGGAAGCTGGGGCAAGAGGATCACTTGAGGTCAGGGTTAGGAAACTCTATCACTACAAAAA","GCGGTGGCTCACGCCTGTAATCCTAGCACTTTGGGAAGCCAGGCAGGCAAATCACGAGGTCAGGAGTTCGAAACCAGCCTG"
"GL873550","12468624","12468663","chr9","62916303","62916339","11","50447679","GCCCGGCTTGGTACCTCATGCCTGTAATCTTAGCACTCCG","GGCCGGGCATGGTGGCTCATGCCTGTAATCCCAGCAC"
"GL873550","12468943","12469188","chr12","70524409","70524645","91","58055466","AATCTTAGCACTCCGGGAGGCCGAGGCGGGTAGACCAACCTAATCAAGAGCAAGATCTACCTCTACTAAAAATAGAAAAGAATTGGCCAGGCGTATTGACTCCGCCTCTAGTGCCAGCTACTCCAAAGCTGAGGCAAGAGGATTGTTCAAATCCAAGAGTTTGAAATTGCTGTATGTTACACCAGGGCACTCTAGCCGTGGAGACATTTTCTCTATATATATTAAAAAAAACAAAAAACAGAAAAA","CTGAGCTCGGGAGTTCGAGACCAGCCTGACCAATATGGAGAAACCCTGTCTCTACTAAAAATGTAAAATTAGCCAGGCATGGTGGCACATGCCTGTAGTCCCAGCTACTCAGGAGGCTGAGGCAGGAGAATCGCTTGAGGTCAGGAGGCGGAGGTTGCAGTGAGCCAAGATCATGCCACTGCACTCCAGCCTGGGTGACAGAGTGAGACTTTGTCTCAAAAAAAAAAAAAAAAAAAA"
"GL873550","14719674","14719880","chr16","30390993","30391163","76","15671319","GGGCGTGGTTGCTCACGCCTGTTGTCCCAGCGCTGTGGGAGACCGAGGCAGATGTATCGCCTGAGCTCAGCCGAGTTCGAGTTCGAGACCAGCGGAGAGACCACCATGAGGCAGAGTGAGCCAGAGTGAGACCCCGTCTCTACAACAACAACAAAGAAAACAGCCGGATCTTGTGATCCCAGCTACATGGGGGCCAAGAGAATCACT","GGGCACGGTGGCTCACACCTGTAATCCCAGCACTTTGGGAAGCCAAGGCAGGAGGATCACCTGAGGTCAGGAGTTCAAGACCAGCCTGGCCAACATGGTGAAACCCCGTCTCTACTAAAAACACAAAAATTAGCCAGGTGTGGTGGTGCACGCTTGTAATCCCAGCTACTC"
"GL873550","15737883","15738154","chr2","20481557","20481833","73","4743674","TTAGCATTCTGGGAGGCCAAGTCAGGTGGATTGCCTGAACTCACAAATTTGAGACTAGCCTGAGATAGAGAAAGATCTTGTCTCTAAAAAAAAAAAAAAATAGCTGGACTTTGTAGTGGGCACCTGTAGTCCCTGCTACTCAGAAGGCTGTGGTAAGAGAATCACTGGAACCCAAGAGTTAGAGGTTGCCGTGAGCTGTGATGCCATGGCACTCTACCAGAGACAACAGAGTGAGACTCTCTCCAAAAAAAAGAAAAAGAAAAAGAAAAAAA","GCACTTTGGGAGGCCAAGGCAGGTGAATCACCTGAGATCAGGAGTTCAAGACCAGCCTGGGCAACATGATGAAACCCTGTCTCTATGAAAAATACAAGAATTAGCTGGGCATAGTGGTGTGCATCTGTAATCCCAGCTACTCAGGAGGCTGAGGTATGAGAATTGCTTGAACCCTGGAGGCAGAGGTTGCAGTGAGCCGAGATGACACCGTTGCACTTCAGCCTGGACAATAGAGAGAGACTCTGTCTCAAAAAAATGAAGAAAAGAAAGAAAGAAA"
"GL873550","15738844","15738873","chr10","65896918","65896951","9","50158074","GGGTGTGGTGGCTGATGCGTGTAATCCTAG","GGCTGGGCGTGGTGGCTCATGCCTGTAATCCCAA"
"GL873550","16345151","16345329","chr1","6754007","6754209","69","9591144","CACCTGTAATCCCAGCACTTGGGAGGTTGAGGAGAGTGGATTGCCTGAGCTCACAGGTTTGAGCCAGAAGGAGACCTCGTCTGTAAAAATAGCTGGGTGTTGAGACCAGCGCCTTTAGTCCCAGCTACTTGGGAGGCTGAGGCAAGAGAATCACTTAAACAATTCTAGAAGCAGAGTTT","CTGTAATCCCAGCACCTTGGGAGGCTGAAGAGGGCGGATCACCTGAGGTCAGGAATTTGAGACCAGCCTGGCCAACATGGTGAAATCCCATCTCTACTGAAAATACAAAATTAGCTGGGTGTGGTGGTGCATGCCTGTAGTTCCAGCTACTTGGGGAGCTGAGGCAGAAGAATGCCTTGAACCCGGGAGGCAGAGGTTGCAGT"
"GL873550","17727115","17727274","chr1","127857902","127858038","52","110130787","GCTGGGTGCAGTGACCCCTGCCTATAATCCCAGCAGTTAGGAGACAAAGGCAGGAGGAATTACCTGAGAGCAGGAGTTCCAGACAAGCCTCAGACCAGCGTGAGCTATGACATTGTCTGTAGCCCCCACCCCACCCCCCCAAAAAACAAAAAGAAACAAA","GGCTGAGTTCAGTGGCGCACGCCTGTAATCCCAGCAGTTGGGAGGCTGAGGCAGGTGGATTGCCTGAGGTCAGGAGTTCAAGACCAGTCTGGCCAACATGGTGAAACTCTGTCTCTACTAAAAAAAAAAAAAAAAAT"
"GL873551","6567068","6567102","chr14","109767086","109767123","14","103200018","GGATCACATGAGGTCAGGAGTTCAAGATCAGCCTG","GGAGGCAGAGGTTGCAGTGAGCCAAGACTGCGCCATTG"
"GL873551","9393264","9393376","chr1","39198637","39198744","32","29805373","CAAGAGTATCTCTGCAACCCAGTGGCCTGAGGTTGCTATGAGCTAGGATGCCACAGCACTCTACCCAAGGGGACAGAGTAAGACTCTGTCTCCAAAAAAAAAAAAGAGCAAAA","AGAATCGCTTGAACCTGGGAGGCGGAGGTTGCAGTGAGACCAGATCATGGCACTGCACTCCAGCCTGGGCGACAGAGTAAGACTCGGTCTCAAAAAAAAAAAAAAAAA"
"GL873551","9393708","9393894","chr12","115674238","115674427","40","106280530","GCTGGGCTCAGTGCCTCTCGCCTGTAATCCCAGCACGCTGGGAGCCTGAGGTGGGTGGGTTGCTTGAGCTTAGGAGTTCAAGACCAGCCTGAACCAGAGCAAGACACTATCTCTACTAAAAATAGAAAAACTATCTGGGCATGGTGGTGCGCACCTGTAGTCCCAGCTACTAGGGAAGCTGAGGCAA","CCAGGCCTGGTGGCTCACGCCTGTAATCCCAGCACTTTGGGAGGCCGAGGTGGGTAGATCACCTGAGGTCAGGAGTTCAAGACCAGCCTGGCCAACATGGCGAAACCCCATCTCTACTAAAAATACAAAAATTAGCTGGGCATGGTGGTGTATGCCTGTAATCCCAGCTACTCGGGAGGCTGAGGCAGGA"
"GL873551","10104594","10104683","chr16","53032852","53032939","31","42928258","GGTAGGTGGGTCTCTCGAGGTTAGGAGCTCTTTACCAGCCTGAGCTGACATAAGACCCAATCTCCACCAAAATAGAGAGAGAAAAAAAGA","GAGGCAGACAAATCTCTTGAGGTCAGGAGTTGAAGACCAGCCTGGGCAACATAGACCTCGTCTCTATTAAAAAAAGAAAAAAGAAAAA"
"GL873551","12307468","12307551","chr8","94102375","94102458","19","81794907","GGCCAGGCATAGCAGCTCATGCCTGTAGTCCTATTATTCTAGGAGGTCCAGGGAGGAGGATCACCTGAGATCAGAAGTTCAAGA","GGCCAGGCATGGTGCCTCATGCCTGTAATCCCAGTACTTTGGGAAGCCAAAGTGGATGGATCACCTGAGGTCAGGAGTTCGAGA"
"GL873551","13335872","13336095","chr4","85819795","85820026","56","72483923","GCCAGGTACAGTAGCTCAGGCCTGTAATCCTAGCACACTGGGAGGCTGAGGTGGTGGATCCTTGAACTCATGAATTCAAGACCAGCCTGAGGAAGAGCAAGACCCCATCTCTCCTAAAAATAGAAAAATTAGCTGGTGTCATGGCAAGTGTCTGTAATCCCAGCCACACAGGAGGCTGAGGCAAGAGGATCTCTTGAACCCAAGACACTAAAGTTACTGGGAGC","GCCGGGCATAGTGGCTCATGCCTGTAATCCCAGCACTTTGGGAGGCTGAGATGGGTGGATCATCTGAAGTTAGGGGTTCGAGACCAGCCTGGCCAAATGGCAAAAACCCATCTCTGCTAAAAATACAAAAATTAGCCAGACATTGTGGCATGTGCCTGTAATCCCAGCTACTCAGGAAGCTGAGACAGGAGAATCGCTTGAACCCAGGAGGCAAAGGTTGCAGTGAGCCAAG"
"GL873552","1195303","1195426","chr3","54039332","54039457","34","52844029","CTACTCTGGATGCCAAGGCAGCGGGATCACTTGAACCCCAGAGTCTGAGGTTGCTGTGATCTCAGCTGACTCCATGGCACACTAGCCTGAGGCAACAGACTGAGACTATATCTCAAAACAAAAA","AGCTACTCAGGAGGCTGAGACAGGGAGAGTCACTTGAACCCAGGAGGCAGAGTTGCAGTGAGCCGAGATCACGCCAACTGCACTCCATGCCTGGGCAACAGAGTGAGACTCCGTCTCAAAAAAAAA"
"GL873552","15010293","15010428","chr1","29437872","29437991","29","14427579","GGCCGGGCGTGGTGGCTCACGCCTGTATTCCCAGCGCTATGGGAGGCCGAGGCGGGTGGATCACCTGTGCTCAGAGGTTCGAGACCAGCCAAGACCCCCCTGAGCCAAACGAGCCAGAGTGAGACCCCGTCTCTAC","GGCCGGGCGTGGTGGCTCACGCCTGTAATCCCAACATTTTGGGAGGCCAAGGCGGGTGGATCACCTGAGGTCAGAAGTTCGAGACCAACCTGGCCAACATGGTGAAACCCCTGTCTCTAC"
"GL873553","860627","860695","chr1","16024119","16024187","13","15163492","GCCAGGCTCAGTGGCTCACGCCTATAATCTTAGCGCCTTTTGGAGGCCAAGGTGGGGGGATTACCTGAG","GGCCAGGCACGGTGGCTCACGCTTGTAATCCCAGCACTTTGGGAGGCCGAGGAGGGTGGATTACCTGAG"
"GL873553","7206820","7206939","chr3","156098583","156098705","38","148891763","AGCTAGGTATGGCAGCTGACATCTGTAACCCTAGCCCTCTGGCAGGCCAGGAATTCAAGACCAGCCTAGACAACATAGTAAGACCCCATCTCTACCAAAAATAATTTAAAATTGGCCAGG","GGCTGGCTGTGGTGGCTCACACCTGTAATCCCAGTACTTTGGATCATGTGAGGTCAGGAGTTCAAGACCAGACTGACCAACATGGTGAAACCCTGCCTCTACTAAAAATACAAAATTAGCCAG"
"GL873553","10985147","10985407","chr12","94325498","94325767","64","83340351","GGCCTGTGGCAGTGGCTCATGCCTGAAATCCTAGCACTCTGGGAGGCTGAGGTGGGTCGATTACCTGAACTCACCAAGACGGAGACCTCATCTCTACTAAAAATAGAAAAACTAGCTGGGCGTGGTGGCAGGTGCCTGTAGTCCCAGTTACTGGGGAGGCTGAGGCAAGAGAATTACTTGAACCCAAGAATTTGAGGTTGCTGTGAGCTATGATGCCACAACACTCTACTCAGGGTGACGGAATAAGACCCTGTCTCAAAA","GGCCGGGTGTGGTGGCTTATGCCTGTAGTCCCAGCACTTTGGGAGGCCGATGGGGATGGATCACCTGAGGTCACTGGCCAACACAGAGAAACCCCATCTCTACTAAAAATACAAAAATTAGCCAGGCGTGGTGGCATGTGCCTATAATCCCAGCTACTTGGGAGGCTGAGGCAGGAGAATCACTTGAACCCGGTAGGCAGAGGTTGCAGTGAGCCGAGATTGTGCCACTGCACTCCAGCCTGAGTGACAGAGCAAGCCTCTGTCTCAAAA"
"GL873553","10985438","10985466","chr16","73760336","73760365","6","62774898","CATAAAAAGAAAGAAAACTGAAAAGAAAA","GAAAGAAAGAAAGGAAAAGAGAAAAGAAAA"
"GL873553","12443178","12443505","chr1","3864926","3865253","98","8578252","GCAGGGTGGGGAGGCTCGCACCTACATCCCCAGCACCCTGGAAGGCTTAGGCAGGTGGACTGGGTTCAGGAGTTGGAGAGCAGCCTGAGCAATAGTGAGATTCTGTCTGCAGTAAAACTAGAAAAATTATTTAGGGGTTGTGCTGGGTGCCTATTATCCTAGCTACTGTTGAGGCAAGGGGACAGCTTGAACCCAGGATTTTCAGGTTTCTGTGAGCTAGGATGATGCCATGATGACCCTCTGACACTTTGCCTGGGCAGTAGAGTGAAACTCTGTCTCAGAAAAAACAAAACAAAACAAAACAAAACAAACAAACAAACGAAAAAAA","GGCCAGGCGTGGTGGCTCACACCTGTAATCCCAGCACTTTGGGAGGCTGAGGCAGGTGGATCACCTGAGGTCAAGAGTTCAAGACCAGCCTGGCCAACATGGTGAAACTCTGTCTCTACTAAAAATACAAAAATTAGCCGGGCATGGTGGTGCATGCCTGTAATCCCAGCTATTCGGGAGGCTGAGGTAGGAGAATAGCTTGAACCCGGGAGGTGGAGGCTGCAGTGAGCTGAGATCATGCCATTGCACTGTAGCCTGAGCAACAGAGAAAGACTCTGTCTCAAAAAACAAAACAAAACAAACAAAAGAACAAAAACAAACAAACAAA"
"GL873553","15121135","15121247","chr1","111354387","111354508","21","96233252","GGGCGTGGTGGCTCACACCTGTAATCCCATCACTTGGGAGGCTGAGGCAGGTGGATCACCTGACCTCAGGAGTTCGAGACCAGCCTGAAGAAGAGTGAGACCCCGTCTCTAAA","GGCCGGGCGTAGTGGCTCACACCTGTAATCCCAGCACTTTGGGAGGCCGAGGCGGATGGATCACCTGAGTTCAGGAGTTTGAGACCAGCCTGACCAAAGTGGTGAAACCCCGTCTCTACTAA"
"GL873553","15121274","15121455","chr7","68420775","68420939","69","53299501","AGATTTCAACAGGCCTAATGGCTTTAGTATATAAAGAGAACTTATAAAGCCAGACTCAGTGGCTTACATCTATAATCCAGGTACTTGGTAGGTTGAAGTGAGAAGATTCTTTGAGCCAGGATTTCCAGCCCAGCCTAGGCAACACAGAGAGACCCCCATCTCTAAAAGAGAAAGGTAAAAAA","GGCTAAAGGGGTGCTCATCTTAAGAATACCAGGCCAGGCGCAGTGGCTCATGCCTGTAATCCTAGCATTTTGGGAGGCTGAGGCGGGTGGATCACCTGAAGTCAGGTGTTTGAGACCAGCCTGAACAACATAGTGAGACCTCATCTCTAATTAAAAAAAGAAAAA"
"GL873553","15614197","15614298","chr4","71691062","71691163","34","56076865","GGTGGCTCACACCTGTTATCCCCATACTCTGGGGGCCTGAGGTGAGAGGATCCCCAGAAGTCAGGAGCTGGAGAGAAGCCTGTGTAAGAGTAAGAGCCAGTC","GTGGCTCATGTCTGTAATCCCAGCACTTTGGGAGGCCGAGGTCGGTGTATCATTTGAAGTCAGGAGTTTGAGACCAGCCTGGCCAACGTGGTGAAACCCTGT"
"GL873553","16849767","16850040","chr1","96770987","96771267","68","79921220","GGCCAGGAGTGGTGGCTCATGCCTGCAATCCCAGCACTTGGGAGGCCAAGGTGGGTGGATTGCCTGAGCTCACAGGTTCAAGACCAGCATGAGCCAGAGAGAGACCTTGTCTCTAAAAATAGGCACAGGTTGTGGTGGGCACCCGTAGTCCCAGCTACTTGGGAGGCTGAGGCAAGAGAATCACTTAAGCCCAGGAGTTTGAGGTTGCTGTGAGCTAAGACACCACAGCACTCTACCAAGGGTGACAAAGTAAAACTCAGATTTTTTTAAAAAA","GGCCAGGTGTGGTGGCTCACAGCCTGTAATCCCAGTAGTTTGGGAGGCCGAGGTGAGCAGATCACCTGAGGTCAGCAGTTCGAGACCAGCCTGGCCAACATGGCAAAACCCTATCTCTACTAAAAGTACAAGGTGTGGTGGCACACACCTGTAGTCCCAGCTACTTGGGAGGCTGAGGCAGGAGAATCACTTGAACTCCAGAGGTGGAGGTTGCAGTGAGCCAAGATTATGCCACCGCATTCCAGCCTGGGTGACAGAGTGAGACTCCGTCTCCAAAAAAA"
"GL873554","511555","511741","chr6","166828248","166828429","56","166316693","GTGGGACCCGCATCTATACTAAAAATGAAAAACTAGTCAGACTTGGTGACTCATGCCTATAATTTCAGTTTCTTGGGAGGTGAAGGCAGAAGAATTGCTTGATCCCAGGAATCTGAGATTGCTGTGAGCTAGGCTAACACTATGGCACTCCAGCCCAGCTGACAGAGTAAGACTTTGTCTTTAAAAA","ACCCCATCTCTACTGAAAATAGAAACATTAGCCGGGCTTGGTGGCATGCGCCTGTAGTCCCAGCTATTTGGGAGGCTGAGGCAGGAGAATTGCTGGAACCCAGGAGGCAGAGATTGCAGTGAGCGGAGATCATGCCATTGCACTCCAGCCTGGGCGACAGAATGAGGCTCCATCTCAAAAAA"
"GL873554","2046660","2046725","chr8","51862362","51862427","7","49815702","GGCTGGCCGCGGTGGCTCACGCCTGTAATCCTAGCACTCTGGGAGGCCGAGGCAGGCAGATCACCT","GGCCGGGCACGGTGGCTCACACCTGTAATCCCAGCACTATGGGAGGCCGAGGCAGGTAGATCACCT"
"GL873554","2580766","2581036","chr13","93262937","93263229","81","90682171","GGCCTGGGCAAGGTGGCTCACTCTCTGGAAGGCTGAGGCAGATGGATTGCCTGAGCTCAGGAGCTAGAGACTAGCATGATCTCACCTCTACTAAAAATAGAGAAACTAGCCAGGCATTACAGCACACGCTTGCAGCCCCAGCTACTCTGGGGGCTGAGGCAAAAGGATCACTTGGACTCAAGAAACTGAGGTTCCTGTGAGCCATGATGCCAGGACACTCTACCCAGGGAAACAGAGTGAGACTTCATCTCAAAAAAAAAAAGAAAGAAAA","GGCTGGGTGCAGTGGCTCACGCCTGCACTTTGGGAGGCCAAGGCAGGTGGATCACCTGAGGTCAAGAGTTTGAGACCAGCCTGGTCAACATGGTGAAACCCCATCTCTACTAAAAATACAAAAATTAGCCAGGCATGGTGGCACGTGCCTGTAATCTCAGCTACTCTGGAGGGTGAAGCAAAAGAATCACTTGAACCCAGGAGGCAGAGGTTGCAGTGAGCCAAAATCATGCCACTGCACTCTGGCCTGGGCAACAGAGTGAGACTCCATGTCAAAAAAAAAAAAAAAAAAAA"
"GL873554","5465741","5465829","chr11","47014803","47014890","15","41549062","GGCCAGGCATGGTGGCTCACGCCTGTAGTCCCAGCGCTGTGAGAGGCCGAGGCGGGTGGATCACCTGTGCTTAGAGGTTCGAGACCAGC","GGCCGGGCACCGTGGCTCACGCCTGTAATCCCAGCACTTTGGGAGGCCAAGGCGGGTGGATTACCTGAGGTTAGGAGTTCGAGACTAG"
"GL873555","8807785","8807956","chr1","12240468","12240612","48","3432683","GGCCGGGCGTGGTGGCGCACGCCTGTAGTCCCAGCGCTATGGGAGGCCGAGGCGGGTGGATCACCTGAGCTCAGAGGTTCGAGACCAGCCAAGACCCCCCTGAGCCAAACGAGCCAGAGTGAGACCCCGTCTCTACAACAACAACAGGACAACAAAACAGCCGGACCTTGTG","GGCCGGGCGCGGTGGCTCATGCCTGTAATCCCAGCACTTTGGGAGGCTGAGGCGGGTGGATCACCTGCGGTCAGGAGTTCGAGACCAGCCTGGCCAACGTGGTGAAACCTCATCTCTACTAAAAATATAAAAATTAGCTGGTGTG"
"GL873555","8828420","8828440","chr3","5439989","5440005","4","3388431","ATAATAATAATAATAAATTAG","ATAATAATAAAATAAAA"
"GL873555","12399534","12399604","chr15","102111398","102111458","22","89711864","GGCCAGGCATGGTGGCTCACACCTATAATCCTGGGAGGCTGAGGATTATCTGAGCTCAGGGATGTGAGACC","GGCCAGGCACGGTGGCTAAGGCCTGTAATCTGGGAGGCTGAGATGGGTGGATCACCTGAGG"
"GL873555","12440877","12440963","chr19","21209507","21209590","24","8768630","GTGGGGAGTGCACCTGAACTTTGGAGTTCAAGACCAGCCTGGGCAACATTGTGTGAGCCCTGTCTCAATTGGAAAACAAAACAAAAA","AGGTGGGCAGATCACCTAAGGTCAGGAGTTCAAGACCAGACTGGCAAAAATGGTGAAACCCTGTCTCTACTAAAAATAAAAAAA"
"GL873555","13094462","13094529","chr1","100916857","100916922","22","87822395","GCTTGTACCTATAATCCTGGTACTTTGGGAGCCTCAGGAGAGTGGATCACCTGAGTAAGAGCAAGACC","CATGCCTGTAATCCCAGCACCTTGGGAGGCCAAGGTGGGTGGATCACCTGAGGTCAGTAGTTTGAG"
"GL873555","13254579","13254784","chr7","32729330","32729532","64","19474751","GACCAATCTAAGCCAGAGCTGTCTATGCTAAAAATAGAATAATAAGCCTGGTTTATGGTAGGAGCCTGTAGTCTCAGTTACCTGGGTGTCTGGGGCAAGAGATTGACTTAAAACCAGGAGTTTGAGGTTGCTGTAAGCTAGGCTGACACCACAATACTCTAATCTGGGCAGAGTGAGATTCTGTCTCAAAAAAAAAAAGAAAGAAA","GAAACCCCATCTCTACTAAAAATACAAAATTAGCCAGGCATGGTGGTGCACACCTGTAGCTCCAACTACTTGGGAGGCTGAGGCAGGAGAATCACTTAAACCCAGGCAGTAGAGGTTGCAGTAAGCCAAGATCGCACCACTGCACTCCAGTCTGGGCAACAGAGTGAGACTCTGTCTCAAAAAAAAAAAAAAAAAAAAAAAAA"
"GL873555","13255065","13255153","chr10","29045352","29045442","23","15790287","CTGGGCACAGTGGCTGAGGGTGTAATCCTACCACCCTAGGAGGTTGAGGCAGAAGGATCACTTGAGCTCAGGAATTCAATACAAGTCTA","GGCGGGGCACAGTGGCTCATGCCTGTAATCCTAGTACTTTGGGAGGTCGAGGCGGATGGATCATCTGAGGTCAGGAGTTTAAGACCAGTCT"
"GL873555","13262783","13262918","chr1","29437872","29437991","30","16175089","GGCCGGGCGTGGTGGCGCACGCCTGTAGTCCCAGCACTATGGGAGGCTGAGGCGGGTGGATCACCTGTGCTCAGAGGTTCGAGACCAGCCAAGACCCCCCTGAGCCAAACGAGCCAGAGTGAGACCCCGTCTCTAC","GGCCGGGCGTGGTGGCTCACGCCTGTAATCCCAACATTTTGGGAGGCCAAGGCGGGTGGATCACCTGAGGTCAGAAGTTCGAGACCAACCTGGCCAACATGGTGAAACCCCTGTCTCTAC"
"GL873556","639117","639366","chr1","62410822","62411038","72","61771705","GGCCGGGTGTGGTGGCTCATGCCTGTTGTCCCAGCACTGTGGGAGGCCAAGGCAGGTGGATCGCCTGAGCTCAGCCAAGTTCGAGACCAGCGGAAGACCAGCATGAGGCACAGTGAGCCAGAGTGAGACCCTACCTCTACAAAACAACAACAACAACAAAAAACCCAGCCAGATGTTGTGGCAAGTGTCTGTAATCCCAGCTACATGAGGGGCAAGAGGGCAAGAGAATCACTAAAGGAGGAAGAAGTAA","GGCCGGGCGTGGTGGCTCACACCTGTAATCCCAGCACTTTGGGAGGCCAAGGTGGGTGGATCTCCTGAGGTCAGGAGTTCGAGAGCAGCCTGGCCAACATGGTGAAACCCTGTCTCTACTAAAATACAAAAATTAGCCAGGTGTGGTGGCACGTGCCTGTAATCCCACCTACTCAGGAAGCTGAGGCAGGAGAATCACTTAAAGCTGGGAGAGAGAG"
"GL873556","639390","639468","chr20","16893610","16893664","30","16254220","ACTTCAAACTAAGATAAAGTGAAAGTCAGCAGAAATTGAAAGCAAAAACAAAAACAAAAAAAAAAAAAAAAAAAAAAGA","AACAAAACAAAACAAAACAAAACAAAACAGACAAAAAAAAAAAAACAAAGAAAAA"
"GL873556","2031445","2031493","chr13","87950184","87950229","13","85918739","AGACCCTATCTCTACTAAAAATAGAAAAACTAGCCCAGTATAGTGATGC","AAACCCCATCTCTAGTAAAAATACAAAATTAGCTGGGTGTGGTGGC"
"GL873556","6655305","6655664","chr2","190010230","190010561","107","183354925","GGCCAGGCATGGTGGCTCACACCTGTAATCCTAGCACTCTGGAAGGCCAAGGGAGGTGAATTTCTTGAAGTTCGAGATCAGCCTAAGAGGAATGATACCCCACCTTTACTAGGAATAAAAAAAAAAAAAAAAAAAAACCCAAAACTAGCCTGGCATTGTGGCAGTTCTCTGTAATCCAAGCTACTTGGGAGGCTGAGGTAGAAGGATTGCTTGAACCAAAGAGTTTGACTAGAGGTTGCTGTGAGCTAGGCTAATGTCACCACACTCTATCCAGGGCAAGTGAGTGAAACTCCGTCTCAAAATAAATAAATAAATAAATAAATAAGTAAGAAAAACTTTTGCCCATAAAAAAAAAAAGAA","GGCCGGGCGCGGTGGCTCACACCTGTAATTCTAGCACTTTGGAAGGCTGAGGTGGGTGAATTGTCTGAGCTCAGAAGTTCGAGACCAGCCTGGGCAACACAGTGAAACCCCATCTCTACTAAAATACAAAAAAAAAAAAAAATTAGCTGGGCATGGTGGTGTGCACCTGTAGTCCCAGCTACTCAGGAGGCTGAGGCAGGAGAATTGCTTGAACCCAGGAGGCAGAGGTTGCAGTGAGCTGAGATCACGCCACTACACTCCAGCCTGGGCAACAGAGTGAGACTCCACCTCTTTAAAAAAAAAAAAAAGAAAGAAAGAAAGAAAGAAAGAAA"
"GL873556","10802692","10802792","chr20","28544296","28544376","36","17741604","TACAAAGAAATATCATTATTGGCCAGGTGCAGTGGTTCACATCTGTAATTCTAGTACACTAGTACTCAGGAGGATCACTTGAGGTCAGGAGCTTGTGACCA","TAGAAATGCACAATTCACCTGGGCACGGTGGCTCACTCCTGTAATTCCAGTACTTTGGGAGGCATGAGGTCAGGAGTTCAA"
"GL873557","1682363","1682659","chr6","13352322","13352625","72","11669959","GGCCAGGTGTCGTGGCTCAGGCCTGTAATCCCAGCATTCTGGGAGGCTGAGGTGGGTGGATTGCCCTGAGGTCACAGGTTCCAGACCAGCCTGAGCAAGAGCGAGACTCCATTTCTAATAAAATAGCCGGGTGTTGTGGTAGGTGCCTGTAGTCCCAGTTACTCGGGAGGCTGAGACAAGAGAATCATTTGAACCCAGGAATTTGAGGTTGCTGTGAGCTGTGATGCCACAGGACTCTACTGAGGGCAATAAAGTGAGACTGTCTCAAATAAACAAACAAACAAACAAAAACAAAAA","GGCCAGGTGTGGTGGCTCAGGCCTGTAATCCCAGCACTTTGGGAGACTGAGGTGGGCGGATCACCTGAAGTAAGGAGTTCAAGACCAGCCTGGCCTACATAGTGAAACCCCATCTCTACTAAAAATACAAAATTAGCTGGGTGTGGTGGCACGTGCCTGTAGTCCCAGCTATTCGGGAGGCTGAGTCAGGAGAATCACTTGAACCCAGGATGGGGAGGTTGCAGTGAGCCGAGATCACACCACTGCACTCCAGCCTTGGCAACAGATTGAGACTCTTTCTCAAAAAAAAAAAAAAAAAAAAAAA"
"GL873557","2465751","2465841","chr16","4764895","4764982","15","2299144","GGCCGGGCTTGGTGGTTCACGTCTGTTGTCCCAGCACTGTGGGAGGCCGAGGCAGGTGGATCACCTAAGCTCAGCCAAGTTCGAGACTAGC","GGTCGGGTGTGGTGGGTCACGACTGTAATCCCAGCACTTTGGGAGGCCGAGGCAGATGGATCACCTGAGGTCAGAAGTTCGAGACCAG"
"GL873557","4047834","4047915","chr12","77852792","77852880","22","73804958","ACAAGAGGTTGCTTTGAACTGTGATGCCACAGAGCACTATCCTGGGCAACAGAGACTCTGTCTCAAAAAAAAAAAAAAAAAA","CAGAGGTTGCAGTGAGCTGAGACTGTGCCACTGCACTCCAGCCTGCGCGACAAGAGTGAGACTCTGTCTCAAAAAAAAAAAAAAAAAAA"
"GL873557","4048202","4048390","chrX","23681445","23681631","42","19633243","GGCTGGGTGTGGTGGCTCACACCTGTGATTCTAGCACTCTGGGAGGCCAACGTGGGCAGATCACCTGAGCTTAGGAGTTCAAGACCAGTGTGAGCAAAATGAGACCCCGCCTCTACTAAAAATAGAAAAACTAGCCAGGCACTGTGGTGGGTGCCTATCATCCCAGCTACTCAGGAGGCAGGCAAGAGG","GGCCAGGCGTGGTGGCTCACGCCTGTAATCCCAGCACTTTGGGAGGCCGAGGTGGGTGGATCACCTGAGGTCAGGAGTTCAAGACCAGCCTGGCCAACATGGTGAAACCCCGTCTCTACTAAAAATATAAAAATTAGCCAGGGTGTGGTAGTGCCTGCCTGTAATCCCAGCTACTCGGGAGGCTGAG"
"GL873557","6292327","6292620","chr19","32265157","32265444","82","25972830","GTCAGGCACGGTGGCTCATGCTTGTTGGATTATCCCAACACTCTGGGAGGCCAAGGTGGATCGATTGTCTGAGCTCTGGAGTTCAAGACCAGCCTGAGCAGAAGCAAGACTCCATCTCTAAAAAAAAATAGCTGGGCATTGTGGTGGGCACTTGTATTCCTAGCTACTTGGAAAGCCTGAGGCAAGAGGATTGCTTGAACCCAAGAGTTTGAGGTTGCTGTGAGCTTAAGATGTCACAGCACTCTATAGAGGCTGAGCAAGTGAGACTCCAAAAAGTGAGTTTCCAGAAAAAAA","GACTAGGCACTGTGGCTCATGCCTGTAATCCCAGCACTTTGGGAGGCCGAGGCGGGTAGATCACCTGAGCTCAGGAGTTTCAGACCAGCCTGAGCAACATGGCAAAACCCCATCTCTACTAAACATTAGCCAGGCATGGTGGTGTGCACCTGTAATCCCAGCTACTTGGAAGGTTGAGGCAGGAGGATCACTTGAACCTCAGGAGGCAGAGGTTGCAGTGAGCCAAGATGACATGACTGCACTCCAATCTGGGTGGCAGAGCAAGACTCTGTCTCAAAAAAAAAAAAA"
"GL873557","6324546","6324617","chr1","39656281","39656348","22","33331735","CGCCTGTTGTCCCAGCACTGTGGGAGTGTGAGTAGGGTGGATCACCTTAGCTCAGCTGAGTTTGAGACCAGC","CATGCCTGTAATCCCAGCACTTTGGGAGGTCAAGGCTGGCAAATCACCTAAGGTCAAGAGTTTGAGAC"
"GL873557","6406262","6406343","chr1","199505332","199505412","11","193099070","CAGGCGCAGTGGCTCAATCCTATAATCCCAGCACTTTGGGAGGCTGAGGCAGGTGGATTACCTGAGCTCAGGAGTTTGAGAC","CCAGGCGCAGTGGCTCACACCTGTAATCCCAGCACTTTGGGAGGCTGAGGCAGGCAGATCACCTGAGGTCAGGAGTTGGAG"
"GL873557","6417612","6417692","chr13","102319052","102319128","16","95901440","GAGGTTGCTGTGAGCTAGACTGAGGCCACAGCACTCTAGCCTGGGCAACAGAGTGAGACTGTCTCAAAAGAAAAAAAGAAA","GAGGTTGCAGTGAGCTGAGATCACACCACTGCACTCCAGCCTAGGCAACAAAGTGAGACTCCAACTGAAAAAAAAAA"
"GL873557","6903406","6903510","chr16","18967946","18968045","32","12064540","AGTGCTCTGGGAGACTGAGATGGGCAAATATCTTGAGTTTAGGAGTTCCAGACCAGCCTAAGGAAGAACAAGACCCTATCTCTACTAAAAATAGAAAAAAATTCA","CTTTGGGAGTCTGAGGCAGGTGGATCTCCTGAGGTCAGGAGTTCAGGACCAGCCTGGCCAACATGGCAAAACCCCATCTCTACTAAAAATATAAAAATTA"
"GL873557","6903779","6903930","chr3","40638454","40638604","35","33734675","TTTGCCAGGTATTGTGGTGGACACCTGTAGTCCCAGCTGCTTGGTAGGCTGAGGCAGGAGGATCACTTGACCCTAGGAATCTGATGTTGCTGTGAGCTAGGCTGATGCTACAGCACTCTAGCCTGGACAACAGAGTAAGCTTCTGTCTCAAA","TAGCTGGGTGTCATGGCACACGCCTGTAGTCCCAGCTACTTGGGAGGCTGAGGCAGGAGAATCTCTTGAACCTGGGAGGCAGAGGTTGCAGTGAGCTGAGATCACGCCACTGCACTCCAGCCTGGGCAACAGAGTGAGACTCCGTCTCAAA"
"GL873557","8133022","8133316","chr19","42881134","42881434","76","34748112","GAGTGCAGTGGCTCACACCTGTAATCTTAGCACTCGAGAGGCTGAGGCAGGTGGATTGCCTGAACTCACAGCTTCGAGACCAGCCTGAGCCAGAGCAAGACCTCATCTCTAAAAATAGCCAGGAGTTGTGGCAGGCGCCTGTAGTCCCAGCTACTTGGGAGGCTGAGCAAGAGAATCGCTTGATCTCAGGAGTTTGAGGTTTCTGTGAGCTAAGACACCGCAGCACTCTACCAAGGGTGACAAAGTAAGACTCTGTCTCAAAAAATAAATAAATAAATAAATTATAAGAAAAAGA","CCGGGCAAGGTGGTTCACACCTATAATCCTAGCACTTTGGGAGGTCGAAGTGGATCGCCTGAGGTCAGGAGTTAGAGACCAGCCTGGGCAACATAGCAAAACCCCATCTCTACTAAAAATAGAAAAACTAGCCAGGTGTGGTGGCGCCTGTAATCCCAGCTACTCGGGAGGCTGAGGCAGAAGAATCGCTTGAACCCAGGAGGCAGAGGTTGCAGTGAGCTGAGATCGCACCACTGCACTCCAGGGTGACAGAGCAAGACTCTGTCTCAAAAAAAAAAAAAAAAAAAAAAAAAAAAAAAAA"
"GL873557","8171663","8171835","chr7","151280672","151280824","61","143109009","TTAGCCAGGCACTGTGCTCCCAGCTACTAGGGAGGCTGAGGCAAGAAGAGGATCACTTGGCTCGGCGCCTGTGACTCAAGTGGCTAAGGTGCCAGCCACATACACCTAAGGTGGAGGGTTCTCTACCCAGAGGGACAGCTTGAGGCTCCATCTCAAACAAAAAAAAAAGAAGA","TGGTATGCACCTGTAATCCCAGCTACTTAGGAGGCTGAGGCATGAGAATCACTTGAACCCAGGAGGTGGAACTTTTAGTGAGCTGAGATTGCACCACTGCATTCCAGCCTGGGCAACAGAATAAGACTCTATCTCAAAAAAAAAAAAAAAAAA"
"GL873557","8172121","8172252","chr11","123260550","123260686","30","115088429","CTGGGCATGGTGGCTCATACCTATAATCCTAGGACTTTGGTAGGCCGAGGCAGGTGGGTTGCTTGAGCTTAGAAGTTGAAGACCAGCCTGAACAACAGCAAGACCTTTCCCTACTCAAAACAGAAAAACTAT","GGCTGGGCAGGGTGGCTCATGCCTATAATCCCAGCACTTTGGGAGGCCAAGGCGGGTGGGTCACCTGAGGTCAGGAGTTCGAGACCAGCCTGACCAACATGGTAAGATCCCCTCTCTACTAAAAATACAAAAATTAA"
"GL873557","8260873","8260977","chr1","62231025","62231129","22","53970152","GGCTGGGCATGGTGGCTCACGCCTGTTGTCCCAGCCCTGTGGGAGGGTGAGGCAGGTGGATCGCCTGAGCTCAGCCGAGTTCGAGACCACTGGAAGACCAGCATG","GGCTGGGCATGGTGGCTCACGCCTATAATCCCAGCACTTTGGGAGGCCGAGGCAGGTGGATCACCTGAGATCAGGAGTTTGAGACCAGACTGGCCAACATGGTGA"
"GL873557","10032878","10033040","chr9","27037847","27038008","36","17004969","GGGGGTGGTGGCTCACACTTGTAATACCAGCTACTCTGGAGGCCGAGGCAGGAGAATCATATGAGCCCGGAAGTCTGAGGTTGTTGTGAGCTGGGTTAATGCCCCTGCACTCTAGCCTGGGCAACAGAGTGAGACCATGTCTCAAGGAAATAAAAAAAAAAAA","TTAGCTGGGCATGCTGGCACACACCTGTAATGCCAGCTACTCAGGAGGCTGAGGCAGGAGAATCACTTGAGCCCGGGAGGTGGAGGTTGCAGTGAGCTGAGACAGTGCCACTGTATTCTACCCTGGGCAACAGAGTGAGACTGTCTCAAAAAAAAAAAAAAA"
"GL873557","10366578","10366655","chr17","24597444","24597521","20","14230866","GCCAGGCGTGGTGGCTCATGACGGTAATCCCACCTACTCAGGAAGCAGAGGCAGGAGAATCACTTGCGCCTAGGAGAC","GGCCAGGCATGGTGGCTCATGCCTGTAATTCCAGCACTTTGGGAGGCCGAGGCAGGTGGATCACTACGTCAGGAGTTC"
"GL873557","12031816","12031985","chr11","55022806","55022982","46","42990990","TAGAAAAACTAGCCAGGCATTGTAGCGGGTGCCTATAGTTTCAGCTACTCTGGAGACTGAGACAAGATTGCTTGAGCCCGGGAATTTGAGGTTGCTGTGAGCTATTATGCCACAGCACTCAATACAGGACAATTGAGTGAAACTCCAGTCTCAAAAAAAAAAAAAAAAAA","CAAAAATTAGCCAGGCAGGGTGGTGGGCGCCTGTAGTCTCAGCTACTGGGAAGGCTGAGACAGGATAATCACTTGAACCCGGGAGGCGGATGTTGCAGTGAGCCGAGATCATGCCACTGCACTTCAGCCCGGGCAACGAGAGTGAAACTCCGTCTCAAAAAACAAAATAAAATAAAA"
"GL873557","12032023","12032144","chr1","111354387","111354508","23","99322364","GGTCAGGTGCAGTGGCTCACATCTGGAATCCTAGCACTCTGGGAGGCCGAGGAGAATGGATCCCCTGAGCTCAGGAATTCAATATCAGCCTGAACAAGTGTGAAACCTCCATCTCTACTTAA","GGCCGGGCGTAGTGGCTCACACCTGTAATCCCAGCACTTTGGGAGGCCGAGGCGGATGGATCACCTGAGTTCAGGAGTTTGAGACCAGCCTGACCAAAGTGGTGAAACCCCGTCTCTACTAA"
"GL873557","14208944","14209036","chr7","158031905","158031997","26","143822961","GGATGTGGTAGTTACTGTTTGCTATGATGACAACACTGCACTCTAACTCTGGGTGACACAGTAAGATTCTATCTCAAAACCAAAATAAAACAA","CCAGGAGGTGGAGGTTGCAATGAGCCAAGATCACACCACTGCACTCCAGCCTGGGTGACAGGGTGAGATTCTGTCTCAAAAAAAAAAAAAAAA"
"GL873558","2159034","2159070","chrX","41233833","41233871","7","39074799","ATTAGCCAGGTGTGGTGGCTTTTGCCTGTAATCCCAG","AAATCAGCCGGGTGTGGTGGCTCACGCCTGTAATCCCAG"
"GL873558","3486850","3487074","chr5","91338665","91338874","72","87851815","GGCCAGGCATGGTGGCTCATGCCTGTTGTCCCAGTGCTGTGGGAGGCCGAGGCAGGTGGATCGCCTGAGTTCAGCCAAGTTTGAGACCAGTGGAAGACCAGCATGAGGCAGAGTGAGCCAGAGTAAGACCCCATCTCTACAACAACAAAAAAAAAAAACAAAAAAAACAGCCGGACGTTGTGATCCCAGCTACATGGTGAGGGGGAGGGGAACAGGAGAATCACT","GGCCGGGCATGATGGCTCATGCCTGTAATCCCAGCACTTTGTGAGGCCGAGGCAGACTGATCACTTGAGGCCAGGAGTTCGAGACCAGCATAGCCAACAAGATGAAACACCATCTTTACTGAAAATACAAAAAAAAAAAAAAATAGCCGGATGTGGTGATACCTGCTTGTAATCCCAGCTGCTTGGGAGGCTGAGGCAGGAGAATCTCTT"
"GL873558","3884156","3884240","chr4","24638016","24638099","18","20753860","CCAGACACAGTGGCTTAAGCCTGTAATCCTAGCACTTTGGGAGGCTAAGGTGGATGGATCTCCTGAGCTCAGTAGTTTGAAGCTA","GCCAGGCATGGTGGCTCATGCCTGTAATCTTAGCACTTTGGGAGGCCAAGGTGGGCGGATCATCTGAGGTCAGGAGTTTGAGAC"
"GL873558","5037604","5037746","chr3","2138380","2138521","38","2899224","GCTGGGCCTGGTGGCTCACATCTGTAACCCTAACACTCTGGGAGGCCAAGGCAGGAGGATCTCTTGAAGCTAGGTTGTTAGCCAGGGCGACCCCACAGCACTCTAGCCTGGGGCAACAGAGTGAGACTTTGTCTCCAAACAAA","AGCTGGATGTGGTGGCCCACACCTGTAATCACAGCTACTCGATAGGCTAAGGCAGGAGAATCGCTTGAACCTGGGAGGCGGGGACTGCACCATCACAGCACTCCAGCCTGGGTGACAGAGTGAGACTATGTATCAAAAAAAA"
"GL873558","6488648","6488700","chr3","39516725","39516768","23","33028077","ATAGCACTCTACCATGGGTGACAGAGTGAGACTATCTCCCCCCCTCAAAAAAA","GAGACCAGCCTGACCAACACAGTGAAACCTCATCTCTACTAAAA"
"GL873558","6489359","6489583","chr10","19070944","19071172","64","12581585","GGCTGGACATGGTGGGTCCTGTAATCCTAGCACTGTGGGAGGCCGAGGCAGGTGAATTGCTTGAGCTTATGGGTTCAAGACCAACCTGAGCCAGAAGGAGACCTTGTCTCTAAAAATGGCTGGGTGTTGTGGCAGGCACCTATAATCCCAGCTACTTGGGAGGCTGAGGCAAGAGAATCGCTTGAACCCAAGAGTTTGATGTTGCTGTCAGCTAAGATGCCATAG","GGCTGGGCTCAGTGGCTTATGCCTGTAATCCCAGCGCTTTGGGAGGCCAAGGCGGGTGGATCACCTGAGGTCAGGAGTTCGGGACCAGCCTGAACAACATGGTGAAATCCCGCCTCTACTAAAAAAAAGCCGGGTGTGGTGGCATGCACCTGTAATCCCAGCTACTTGGGAGGCTGAGGCAGGAGAATCACATGAACCTGGGAGGCAGAGGTTGCAGTGAGCTGAGATC"
"GL873558","14631848","14632045","chr18","1878493","1878704","62","12753355","GGTGCAGTGGCTCACGCCTTTAATCCCAGCACTTGGGATGGTGAGGCAGGTAGATTGCCTAAGTTCACAGGTTCAAGACCAGCCTGAGCCAGAGAGACCCTACCTCTAAAAAATAGCCAAGCATTGTGGCAGGCACCTGTAATCCTACTTAGGAGGCTGAGTCAAGAGGATCATTTGAGCTTAAGAGTTAGAGCTTGT","GGCCAGGCATGGTGGCTCACGCCTGTAATCCCAGCACTTTGGGAGGCCGAGGCGGGTGGATCACAAGGTCAGGAGTTCAAGACCAGCCTGGCCAACATGGTGGAAGCCCATCTCTACAAAAAATTAACTGGGCGTGGTGGCAGGCACCTGTAATCCCAGCTACTTGGGAGGCTGAGGCAGGGGAATTGCTTGAACCTGGGAGGCGGAGGTTG"
"GL873558","14632352","14632392","chr7","10117723","10117763","10","4514629","GAGTTAGAGCTTGCTGTGAGCTAAGATGCCACGGCACTCTA","GAGTTAGTTGCAGTGAGCTGAGATCGTGCCACTGCACTCCA"
"GL873559","8193331","8193614","chr20","11734223","11734512","71","3540892","CAGGTACGGTGACTTATCCCTGGAATCTTAGAACTGTCTGAGTCCAAGGTGGGAGGATCATTGGAGGTCAGGAATTTGAGACCAGCCTGAGCAAGAGTGAGACCTCTTCTCTACTAAATATAGAAAAATTAGCCAGGGTTTGTGGCAGGTGCTTATAGTCTAAGCTTCTTAGGAGGCTGAGGCAGGAGAATCTCTTGAACCCATGAGTCTGAGGTTGCCCTGAGTTAAGATGACATCACTGCAGTCTCCCCAAAGCAACGGAGTAAGACTCTGTCTCAAAAACA","GGCCAGGCACGGTGGCTCATGCCTCTAATCCCAGCATGTTGGGAGGCCGAGGTGGGCGGATCACATGAGGTCAGGAGTTTGAGACCAGCCTGGCCAACATAGTGAAACCCTGTCTCTACTAAAAATACAAAAATTAGCCAGGTGTGGCAGCACGTGCCTGTAGTCCCAGCTAGTCAGGAGGCTGAGGCAGGAGAATCACTTGAATCCACCAGGCGGAGGCTGCAGTGAGCCAAGATCACACCACTGCATTCCAGCCTGGGCGACAGAGCAAGACTCTGTCTCAGAAAAAA"
"GL873559","8193642","8193657","chrX","1083699","1083714","0","7109943","AAATAAATAAAATAAA","AAATAAATAAAATAAA"
"GL873560","393252","393440","chr11","121440472","121440639","55","121047220","CTGGGCAGGGTGGCACACACCTGTCATCCCAGCATGTTGGGAAGCTGAGGCAGGAGAATTACTTGAGCTCAGATTCCAAGAGGTGAGGATCACTTGAGCCTAGAAGTTGAGGCTGCACTGATGCCCCAACACTCCAGCCTGGGCAACAGAGCAAGGTCCTGTCCCAAAAAGAAAAAAAGAAAAGGAAAA","GCTGGGCGCAGTGTCTCACGCCTGTAATCCCAGCTATTTGGGAGGCTGAGGCAGGAGAATTACTTGAACCTGGGAGGTGGAAGTTGCAGTGAGCCGAGATCCTACCATCGCACTCCAGTCTGGGCAACAAGAGCAAAACTCTGTCTCAAAAAAAAAAAAAAAAAAAAA"
"GL873560","4038833","4039014","chr12","78258009","78258208","56","74219176","GGCTGGGTGCGGTGACTCACACCTGTAATCCCAGCACCTGGAGGCCCAAGGCAGGGTGGATTGTCTGAGCTCACAGGTTCAAGACCAGCCTGAGCCAGAGCGAGACCTAAAAATAGCTAGGCGCTGTGGGAGGCACACGTAGTCCCAGCTACTCAGGAGGCTGAGGCAAGAGAATCACTTGA","GGCTGGGCACGGTGACTCACGCCTGTAATCCCAGCACTTTGGGAGGCCCAGGTGGGTGGATCACCTGAGGTCAGGAGTTCAAGACCAGCCTGGCCAAGATGGTGAAACCCCGTCTCTACTAAAAATACAAAACTTAGCTGGGCATGGTGGCGGGCACCTGTAATCTCAGCTAGTCGGGAGGCTGAGGCAGGAGAATCTCT"
"GL873560","4492531","4492643","chr7","56485655","56485756","37","51993124","AACAGAAAAACTAGCCAGGCATAGTGGTGCATGCCTGTTGTTCCAGCTGCTCTAGAGGCTAAGGCAAGAGGATTGCTCCAGCTCAATAGTTTGAGGTTGCTGTGAGCTTGAGA","TTAGCTGGGCATGGTGGAGCACACCTGTAATTCCAGCTACTCAGGAGGCTGAGGCAAAAGAGTTGCTTGAACCCAGGAGGCAGAGGTTGCAGTGAGCCGAGA"
"GL873560","4492670","4492771","chr8","41603464","41603564","28","37110794","AGCACTCTGGGTGACTGAGGCAGGATTACTTGAGCTCAGGAGTTTATGACCAGCCTGAGCTGGTCCTTGATCAAGACTCCATCTCTACTAAAAAAACAAACA","CACTTTGGGAGGCCGAGGCAGCAGATCACTCGAGGTCAGGAGTTTGAGACCAGCCTGGCTAACATGGCAAAACCCCATCTCTACTAAAAATATAAAAATTA"
"GL873560","8106775","8106882","chr11","111878590","111878685","39","103771815","ACATAAGAATCAGGCCAAGCCTTGTGGCTCCTGTATGTGATTCCAGCACTGGGAGGGCAAGGCAGGAGGATCCCTGACGTCAGGAACTCAAGGCTGCCCAAGTATCAT","GGGCACAGTGGCTCATGCCTGTAATCCCAGCACTTTGGGAGGCCAAGGCGGGTGGATCACCTGAGGTCAGGAGTTCAAGACCAGCCTGACCAACAT"
"GL873560","10872201","10872272","chr7","9971011","9971083","11","901190","GGCTGGGCACAATGGGTCACACTTGTAATCCCAACACTTTGGGAGGCTGAGGTGGGCAGATCACCTGAGCTC","GGCTGGGTGGGGTGGCTCACACATGTAATCTCAGCACTTTGGGAGGCTGAGGTGGGCAGATCACCTGAGGTCA"
"GL873560","11043320","11043410","chr6","111928830","111928919","19","100885510","CAGGCGAAGTGGCTCATGCCTATAATCCTAGCATTCTGGGAGGCTGAGGTGGGAGAATCCCCTGAGGTCAAAAGTTCAAGACCGGCTTGGC","GGCCAGGCTCAGTGGCTCATGCCTGTAATCCCAGCACTTTGGGAGGCCGAGGTGGGTGAATCACCTGAGGTCAGGAGTTCAAGACCTGCC"
"GL873561","5890611","5890936","chr8","76222061","76222392","77","70331450","GGCTGGGCCTGGTGGCTCATGCCTATAATCCTAGCACTCTGGGAGGCAAAGGTTGGTGGATTGCTTAAGCTCAGGAGTTCAAGACCAGCCTGATTAAGAGTGAGATCCCATCTCCACTAAAAATAGAAGGGAAAAAAAAAAAAAAAAAACCTAGTTGGGCTTGGTGGCAGCACTTGTAGTCCCAGCTATTTAGGAGGCTGAGGAAAGAGAATCACTTGAACCCAAGAGTTTGAAGTTGCTCTGAGCTATGATGCCATAGAACTCTACCCAGGGTGACAGAGTAAAACTGGATCTCAAATAAATAAATAAATAAATACATAAATAAA","GGCTGGGCATGGTAGCTCATGGCTGTAATCCTAGCACTTTGGGAGGCCAAGGAAGGTGGATTGCCTGAGCTCAGGAGTTCAAGACCAGCCTGGGCAACACAGTGAAATCCTGTCTCTACTAAAATACAAAAAAGAAAAAAAAAAAAAAAAAAAACAGCTGGGCATGGCAGTGTGCACTTGTAATCCCAGCTACTCAGGAGGCTGAGACAGGAGAATCACTTGAACCCGGGAGGCAGAGGTTGCACTGAGCCGAGATTGTATCACTGCACTCCAGCCTGGGTGACAGAGCGAGACTCTGTCTCAGAAAAAAAAAAAAAAACAAAAAAACAAAA"
"GL873561","10859256","10859475","chr6","100119122","100119352","73","89259866","GGATCACTTGAGCTCAGGAGTCAAGACCAACTTGAGTAAGAGTGAGACCCTGTCTCTACTAAAAATAAAATATATAGCCAGGCATTGTGCTGGGCACCTATATATAAGCTAAAATGGAGTCTTAGCTACCTCCTTGAACTTGAACCCAGGAGTCTGAAGTTGCTTTGAGCTAGGCTGATGCCACTGCACTTTACCCAGGCAACAGAGTGAGAGTATCTAA","GGATCACCTGAGGTCAGGAGTTCAAGACCAGCCTGGCCAACATGGTGAAACCCCGTCTCTACTAAAAATACAAAAACTAGCCAGGCATGGTGGCGCACACCTGTAGTCCCAGCTACTTGGGAGGCTGAGGCAGAAGAATCTCTTGAATCCGGGGGTTGGAGGTTGCAATGAGCTGAGATCATGCCACTGCACTCCAAGCCTGGGTGACAAGAGCGAAACTCCATCTCAAAA"
"GL873561","10859563","10859576","chr4","114457728","114457741","1","103598165","AAAAAAAAATAAAA","CAAAAAAAATAAAA"
"GL873562","12189469","12189706","chr1","31551552","31551790","75","19362083","CAGTGGCTCACGCCGGTAATCCCAGCACCTTGGGAGCTGAGGCAGGCAGATCTCCTGAGGTCACGTGTTTTGAGACCAGCCTGAGCTAGAGTGAGACCCCACCTCTAAAAATAGCCAGTCGCCTGTAATCCCAGCTACTCGGGAGAAACCCAGGAGTCTAAGGTCGCTGTGAGCTGACACCTCAGCACTCTGCTGGGGTAACAAAGTGACACTTTGTCTCAAAAAAATAAATAAATAT","GCAGTGGCTCACGCCTGTAATCCCAGCACTTTGGGAGGCCAAGGCGGGTGGATCACCTGAGGTCAGGAGTTCAAGACCAGCCTGGCCAACATGGTGAAACCTCATCTCTACTAAAAATACAAAACAGGAGAATCGCTTGAACCCGGGAGGTAGAGGTTGCAGTGAGCTGAGATAGTGCCACTGCACTCCAACCTGGGCAACAGAGTGAGACTCCGTCTCAAAAAAATAAAAAATAAAAA"
"GL873562","4526861","4526913","chr13","94764706","94764759","14","90237845","GTGAGACCTTGTCACTACTGAAAATAGAAAAATTAGCTGGGCATGGTTGTAGG","GTGATGAAACCCCATCTCTACTAAAAATACAAAAATTAGCTGGGCTTGATGGTG"
"GL873562","4789223","4789313","chr10","47852509","47852598","25","43063286","GGCCAGGAGAAGTGGCTAACACCTGTAATTCCAGCACTCTAGGAGATGGAGGCAGGGACCAGCCTGAGCTAGAGTGAGTGAGACTCCATCT","GGCCAGGTGCAGTGGCTCACACCTGTAATCCCAGCAACTTTGGGAGGCTGAGGCAGGCAGATCACTTGAGGTCAGGAGTTCGAGATCAGC"
"GL873562","4868605","4868801","chr16","54069750","54069948","44","49201145","GGCCAGGCATGGTGGCTCATGCCTGTAATCCTAGCACTCTGAGAGACCAAGGCTGATGAATCACCTGAACTCAGGAGTTGAGACCAGCAGGAGCAAAAGTGAGATCCCATCTCTACTCAAAAATAGAAAATTAGTTCAGGCAAGGTGGCACATACCTGTAATCCCAGCACCCTGGGAGGCTAAGGTGGGTGGATTGC","GCCCAGCGCAGTGGCTCATGCCTATAATCCCAGCACTTTGGGAGGCCAAGGCGGGTGGATCACCTGAGGTCAGGAGTTCGAGACCAGCCTGCCCAGCATGGTGAAACCCCATCTCTGTTAAAAATATAAAAATTAGACTAGGCGCGGTGGCTCACACCTGTAATCCCAGCACTTTGGGAGACCAAGGTGGGCGGATCAC"
"GL873562","4929184","4929360","chr10","37539693","37539877","47","32610509","GGCCAAGCTCAGTGGCTCTCCCTAGCACTTTGGGAGACCGAGGTGGGTGGATTGCCTGAACTCAGGAGTTCTAGACCAGCCTGATCAAGAGCAAGACCCTACATCTACTAAAAATAGAAAAACTAGCTGGGCATTATAGTACGCACCTGTACTCCCATCTACTCTGGAGGCTGAGGC","GGGTGCAGAGGCTTATGCCTGTAATCCCAGCACTTTGGGAGGCAGAGGTGGGTGGATCACTTGAGGCCAGGAGTTCAAGACCAGCCTGGTCAATGTGGTGAAACCTCGTCTCTACTAAAAATACAAAAATTAGCCGGGCATGGTGGCATGCATCTGTAGTCCCAGCTACTTGGGAGGCTGAGGCA"
"GL873562","5446395","5446678","chr16","63692714","63692996","79","58246319","GGCTGGATGCAGTGGCTCATACCTGTCTGTAATCCTAGCACTCTGGGAGGTCGAGGTGGGTGGATTGCCTAAGTTCACAGGTTCGAGGCCAGCCTAAGCAAGAAGAGCAAGACTCCATCTCTGAAAGTAGCCAGGCATTGTGACAGGCGCCTATAGTCCCAGCTACTTGGGAGGCTGAGGCAAGAGAATTGAGCCCAGGAGTTAGAGGTTGCTGTGAACTAGGACTCCATAGCATTCTACTGAAGGTGACAAAGTGAGATTCTGTCTCAAAAAAAAGACTGATT","GGCTGGCTGCGGTAGCTCACCCCTGTAATCCCAGCACTTTGGGAGGTCAAGGCAGGTGGATTGCCTGAGGCCAGGAGTTCGAGGCCAGCCTGACCAATATGGCAAAACCCTGTATCTACTAAAAACTAGCTGGGCATGGTGGCATACACCTGTAGTCCCAGCTACTTGGGAGGCTGAGGCAGGAGAATTGCTTGAACCTGGAGGCAGAGGTTGCAGTGAGCCAAGGCTGCCCCACTGCACGCCAGCCTGGGTGACAGAGTGACACTCCATCTCAGAAAAAAAA"
"GL873562","8499356","8499477","chrX","91860022","91860139","29","83360666","GGCTGGGTGTGCTGGCTCATGCCTGTAATCCTCGCACTCTGGGAAGCTAAGGCAGGTGGATTGCCTGAGCTTATGAGTTTAAGACTAGCCTGAGCCAGAGCAAGACCTTGTCTCTATTTTTT","GCCGGGTGTGGTGGCTCATGCCAGTAATCCTAGCACCTTGGAAGGCTGAGGCAGGTGGATTGCCTGAGCTCAGGAGCTTCAGACTAGCCTGGGCAACATAGTGAAACCCCATATCTCT"
"GL873562","8499731","8499918","chr7","167658032","167658223","45","159158301","AAGACCTTGTCTCTAAAAATAGCCAGGTGTTGTAGCAGGCACCTGTAGTCCCAGCTACTTGGGAGGCTGAGACAAGAGAATTGCTTGAGCCCAAGAGTTTGAGGTTGCTGTGAGCTGAGATGCCATGGACTCTATCGAGGGCAGTAAAGTGAGACTCCGTCTCAAAAAAAAAAAAAGAAAGAAAAGAA","TACTAAAATACATACAAAAATTAGCCAGGTATGGTGGCAGGCCCCTGTAGTCCCAGCTACTCGGGAGGCTGAGGCAGGAGAACTGCTTGAACCCAGGAGGTGGGGATTGCAGTGAGCTGAGATCGCACCACTGCACTCCAGCCTGAGCGACAGAGTGAGACTCTGTCTCAAAAATAAAAAAAGAAAAAAAAA"
"GL873562","10216295","10216385","chr1","44313085","44313176","34","34096790","TAAAAATACATTGAACCAGATTCAGTGGCTCACACCTGTGCTCCTAGCTACCCAGTGGCTGAGGCTGAAGGATGGCTTGAATCTCAAGTTC","TTACAGATCATTTGGGGCTAGATGTAATGGCTCACACCTGTAAGCCCAGTGCTTTGGGAGGTTGAGGCAGGAAGATGGCTTGAACCTAGGAG"
"GL873562","11812352","11812435","chr19","44513406","44513491","17","32701054","GGCCGGTACGATGGCTCAGGCCTATAATCTTAGAACTCTGGGAGTCCGAGGTGGGTGGACTGCCTGAGCTCACAGTTCGAGACC","GGCCGGACGCGCTGGCTCACGCCTGTAATCCTAGCACTTTGGGAGGCTGAGGGGGGCGGATAGCCTGAGCTCAGAAGTTCGAGACC"
"GL873562","12179920","12180054","chr14","8268315","8268451","18","3911605","GGCCAGGCATGGTGGCTCACACCTATAATCCTAGCACTCTGGGAGGCCAAGGCAGGTGGATCACCTGAGCTCAGGAGTTTAAGACCAGCCTGAGCAAGAGTGACAACCTATCTCTATTAAAAATACAAAAACTAG","GGCCGGGCATAGTGGCTCACACCTATAATCCCAGCACTTTGGGAGGCCAAGGCAGGTGGATCACCTGAGGTCAGGAGTTCGAGACCAGCCTGACCAAGATAGTGAAACCCCGTCCCTACTAAAAATACAAAAATTAA"
"GL873562","14017684","14017885","chr2","94000404","94000565","73","79982720","CAAGCTAGCCTAGGGATGTGGAGGTACCTGTAGTCCCAGTTACTTCATTGGCTGAGGCTTAAACCCTCTTGGATGGTCTCACTCTGTCACCCTGGTAGAGTGTTGTGGCATCATGTGTCACAGGAGGTTGAGGTTGCTGTGAGCTGTGATGCCACAACATTCTACCAGGGTGACAGAGTGAGACTCTGTTTCAAAAACAAAA","AAACTAGCCTGGCGTGGTGGTGTGTGCCTGTAATCCCAGCTACTTGGGAGGCTGAGACAGGAGAATCACTTGAACCTGGGAAGTGGAGGTTGCAGTGAGCTGAGATCATGCCACTGCACTCCAACTTGGGCAACAGAGCGAGACTCTGTTTCAAAAAAAAAA"
"GL873562","14017915","14018042","chr1","161382752","161382881","27","147364837","GGCTGGGCACGGTGGCTCACACTTGTAATTCTAGCACCCTGGGAGGCCAGCGTGGGTGGTTTGCTTGAAGTTAGGAGTTCAAGACCAGCCTGACCAAAGTGAGACCACATCTCGACTAAAAACAAACA","GGCTGGACGCAGTGGCTCATACCTGTAATCCCAGCACTTTGGGAGGCCGAGGTGGGTGGATCACCTGAGGTCAGGAGTTCAAGACCAGTCTGGCCATGGTGAAACCCCATCTCTACTAAAAATACAAAAA"
"GL873563","2645481","2645758","chr1","37954757","37955032","69","35309276","GGCTGGGTGCCATGACTCACGCCTGTCATCCCAGCTCTCTGGGAGGTCACAATGGGAGTATTCCATGAGCTCAGAAGTTTGAGACCAGTCTGAGCAAGAGCAGACTCCATTTCTACTAAATATAGAAAAATTAGCCCAGTATGGTTGTGCACACCTGTAGTCCCAGCTACTTGGGAGCTGAAGCAGGAAAACGGCTTGAGTCCAGGAGTCGGAGGTTGCTGTGAGCTGAGAGCTATAATGATGCCAGTGCACTCTACCCAGGCAACAGAGCAAGACTC","GGCCGGGTATGGTGGCTTACGCCTGTAATCCCAGCACTTTGGGAGGCCAAGGTTGGCAGATCACCTGAGGTCAGGAGTTCGAGACCAGCCTGGCCAATATGGCGAAACCCCGTCTCTACTAAAAATACAAAAATTAGCTGGGCATGGTGGCGCATACCTGTAATCCCAGCTACTCGGGAGGCTGAGGCAGGAGAACTGCTTGAACCCAGGAGGTGGAGGTTGCAGTGAGCCGAGATTGAGCCACTGCACTCCAGCCTAGGTGACAGAGTAAGACTC"
"GL873563","2646059","2646097","chr1","62915138","62915167","12","60269079","CAAACAGAACAAGACTTTGTTTCAAAAAAAAAAAAAAAA","CAAACAAACAAACATCACAAAAAAAGAAAA"
"GL873563","2651001","2651167","chr2","69424628","69424798","38","66773627","GTACAAAAATTAGCCAGATGTCTTGGTGCTTATAGTCAGCAACTCAGGAGGCTGAGGCAGGAGGATCACTTGAACCCCTGGAATTTGAGGTTGCTGTGAGCTAAGTTGATGCCACGGCATTCTAGCCTGGGTGACAGAGTAAGACTCCATCTCAATAAATAAATAAA","AAAAAAATTAGCCAGGCATGGTGGTGCATGCTTGTAATCCCAGCTACTTGGGAGGCTGAGGCAGGAAGATCACTTGAACCTGGGAGGCGGAGGTTGCAGTGAGCCAAGATTGTGCCACTGAACTCCAGCCTGGGTGACAGAGCAAGACTCCATCTCAAAAAAAAAAAAAAA"
"GL873563","2651449","2651584","chr3","121251018","121251153","32","118599569","GGTCCAGTGAGGTGGTTCAGACCTGTAATCCTAGCATTCTGGGAGGCTGAGGTGAGCAGATTGCTTGAGCTCAGTGAGTTTGAGACCAGCCTGAATAAAAGCAGCACCCCATCTCTACCAAAAGTAGGAAAATTAT","GGCCAGGTGCAATGGCTCACACCTGTAATCCCAGCACTCTGGGAGGCCGAGGTGGGCAGATCACCTGAGGTCAGGAGTTTGAGATCAGCCTGGCCAACCTGGCAAAACCCCATCTCTAATAAAAATACAAAAATTA"
"GL873563","6898038","6898117","chr6","28153994","28154075","27","21255956","AAAAAACAGAAAAATTAGTTGGGTGTGGTAGTGGGTAGCTACTTGGGAGGCTGGGGCAGGAGAATCACTTGAACCCAGGA","AAAATTAGCCGGGTGTGGTGATGCATGCCTCTAATCCCAGCTACTTGGAAGGCTGAGGCAGGAGAATCACTTGAAGGCAGGA"
"GL873563","6898395","6898520","chr5","140939246","140939381","30","134040851","GGGGGTGGTGGCTCATGCCTGTAATCCCAGCACTCTGGCTGAGACAAGTGGATTGCATGAGCTCAGGAGTTCAAGACCAGCTTGAGGAAGAACAAGACTCCATCTCTACTAAAAATAGAAAAATTT","GGCCCGGTGCTGTGGCTCATGCCTGTAATCCCAGCACTTTGGAAGGCTGAGGCAGGTGGATCCCTTGAGGTCAGGAGTTCGAGACCAGCATGGCCAACATGGCAAAATCCCATCTCTACTAAAAATACAAAAATTA"
"GL873563","7811395","7811530","chr1","29437872","29437991","31","21626477","GGCCGGGCGTGGTGGCTCATGCCTGTAGTCCCTGCACTGTGGGAGGCCGAGGCGGGTGGATCACCTGTGCTCAGAGGTTCGAGACCAGCTAAGACCCCCCTGAGCCAAATGAGCCAGAGTGAGACCCCGTCTCTAC","GGCCGGGCGTGGTGGCTCACGCCTGTAATCCCAACATTTTGGGAGGCCAAGGCGGGTGGATCACCTGAGGTCAGAAGTTCGAGACCAACCTGGCCAACATGGTGAAACCCCTGTCTCTAC"
"GL873563","7855904","7856041","chr3","37342340","37342469","34","29486436","GCCAGGGCAGTGGTTCACACCTGTAAAAACCCCAGTATTTTGAGAAGCCAAGTTGGGAGGATCACATAAGGTCAAGAGTTTGAGACCAGCCTGGACAACACAGTATAAGACTCCCATCTCTATTTTGTTAAATATACA","GCCGAGCGCGTGGCTCACGCCTGTAACCCCAGCACTTTGGGAGGCCAAGGTGGGTGGATCACTTGAGGTCAGGAGTAGGAGACCAGCCTGGCCAACATGGGTGAAACCCCACCTATAGTTTAAAAATATA"
"GL873563","8381194","8381392","chr2","167568017","167568216","65","159186823","GGCCAGTGCAGTAGCCCACACCTGTAATCCTAGCACTCTGGGAGGCCAACTCTGGTAGAGTTTGAAACTAGCCTGAGCAAGAGCGAGACCTTGTCTTCACTGAAAAAAATAGAAAAAAAAAAAAAAAACTAACTGGGCATGGTGCTGTACATCTGTAGCCCGAGCTACTCAGGAGTCTGAGGCAAGAGGATTACTCAAT","GCCAGGCGAGGTGGCTCATGCCTGTAATCCCAGCACTTTGGGAGGCCAAAGTGGACAGATTACCTGAGGCCAGGAGTTTGAGACCAGCCTGACCAATATGGTGAAACCCCATCTGTACTAAAAATACAAAAATTAGCAGGGCGTGGTGGTGTACACCTGTAATCCCAGCTACTCAGGAGGCTGAGGCAGGAGAATCTCTT"
"GL873563","8381923","8382014","chr2","92370724","92370803","33","83988801","GGATTGCTCAAGCCCAAGAGTTTGAGGTTGCTGAGAGCTATGACACTACAGCACTCTACTCTACCCAGGGCAACAGAGTGAGACAAAAAAAA","TTGCTTGAACCCAGGAGCTAGAGGTTGCAGTGAGCTGAGATTGCACTATTGCACTCCAGCCTGGGCAACAGGGTGAGACT"
"GL873563","9500422","9500552","chr19","10830410","10830544","33","1329988","GGTCAGGTGCAGTGGTCACCTGTCATCCTACCCCTCTGGGAGGCCAAGGTGGGTGGATTGCCTGAGTTCAGGAGTCTGAGACGAACCTGAGCTAGAGCAAGACCTCATCTCTTAAAAAATAGCCAGCATTC","GGCCAGGTGCAGTGGCTCATGCCTGTAATCCCAGCACTTTGGGAGGCCAAGGTGGGTGGATCACCTGAGGTCAGGAGTTCGAGACCAGCCTGATCAACGTGGTGAAACCCCATCTCTACTAAAATTGCAAAATTA"
"GL873563","9501087","9501192","chr16","71049107","71049211","33","61548020","TAAAACCTATAATGTTTGAAAATAAAAATAGCCAGGCCTTGTTGTGGGTGCCTGTAGTCCCAGCTACTTAGGAGGCTGAGGTAAGAGGATTGCTTGAGCCCAAGAG","TGAAACCCCATCTCTACTAAAAATACAAAATTAGCCAGGTGTGGTGGTGCATGCCTATAATCCCAGTTACTTGGGAGACTGAGGCAGGAGAATCACTTGAACCTG"
"GL873563","10991062","10991128","chr1","22619342","22619410","11","11628280","GGCCGGTGTAGTGGCTCACGCCTGTAATCCCAGCACTTTGGGTGCCGACATGGGCAGATCGCCTGAG","GGCCGGGCGCGGTGGCTCACACCTGTAATCCCAGCACTTTGGGAGGCCGAGGTGGGCGGATCACCTGAG"
"GL873563","12252577","12252738","chr8","144193624","144193784","41","131941047","GGCTGGGTACAGTGGCTCATATCTGTAATCCTAGCACTCCAGGAGGCTGAGGTGGGAGGATAATTGCCTGAAGTCAGAAACACAAGACCAGCCCAAACAAGAGTGAGACACCATCTCTACTAAAAATAGAAAACTGAGCTGGGTGTGGCGGTGCACACCTGT","GGCCGGGCATGGTGGCTCATGCCTATAATCCTAGCACTTTGGGAGGCCGAGGTGGGCGAATCACCTGAGGTCAGGAGTTTGAGACCAGCCTGGCCAACATGGTGAAACCCCATCTCTACTAAAAATACAAAAATTAGCTGGGTGTGGTGGCACATGCCTAT"
"GL873564","1384131","1384395","chr13","32253035","32253303","64","30868904","GGGGGGGGGGGCACACTGGCCTGTAATTCTAGCACTCTGAGAGGCCAAGGCAGGTGGATCACCTGAACTCAGGAGTTCGAGACCAGCCTGATCAAGAGTGAAACCCTGTCTCTACTAACAAGAGAAAAACCAGTAGTCCCAGCTACTCAGGAGGCTGAGGCAGAAGAATCACTTGAACCCAGGAGTTTGAGGTTTCTGTGAGCTACAGTAGTGCTATGGCACTCTACCAAGAGTGACAGAGTGAAACTCTGTCTCAAAAAAAAAA","GCTGGGCATGGTGGCTCATGCCTGTAATCCCAGCACTTTGGGAGGCTGAGGCGGGTGGATCATCTGAGGTCAGGAGTTCAAGACTAGCCTGGGCAACATGGTGAAACCCTGTCTCTACTAAAAATACAAAATTACAGGTAATCCCAGCTACTTGGGAGGCTGAGGCAGGAGAATCGGTTGAACCCAGGAGGCGGAGGTTGCAGTGAGCTGAGATCATGCCACTGCACTCCAGCCTGGGCAATAGAATGAGACTCTGTCTGAAAAAAAAA"
"GL873564","2543879","2544121","chr1","199402350","199402570","73","196858471","GGCCAGGTGTGGTGGCTTACGCCTGTTGTCCCAGCGCTGTGGGAGGCCGAGGCAGGTGGATTGCCTGAGCTTAGCTGAGTTTGAGACCAGCGGAAGACCAGCATGAGGCAGAGTGAGCCAGAGTGAGATCCTGTCTCTACAAAAAAGAAAAAAAAAAAAACAGCCGGATGTTGTGGCGCGCGTCTGTAATCCCAGCTACATGGGGGTCAAGAGGGCAAGAGAATCATACAGGAGGAAGAAGTT","GGCCAGGTGTGGTGGCTCACACCTGTAATCCCAGCACTTTGGGAGTCTGAGGCGGGTGGATTGCCTGAGGTTGAGAGTTTGAGACCAGCCTGGCCAACATGGTGAAACCCTGTCTCTACTAAAAACACAGAAATTAGCCAGGCATGGTGGCGCATGTCTGTAATCCCAGCTACCCTCCTGGAGGCTGAGGCAAGAGAATCACTTGAACCCAGGAAGCAGAG"
"GL873564","4859126","4859236","chr9","15245726","15245837","31","10386600","GTGGCTCATGCTTATAATCCAATCACTATGGGAGACCAAGGTGGGGATGGGCGGAGATCACCCTCAGGAGTTGGAGACCAGCCTGAGTTAAGAGTGATACCATGTCTCTAC","GTGGTGTCTCACGCCTATAATCCCAGCACTCTGGGAGGCCAAGGTGGGCAGATCACCTGAGGTCAGGAGTTAAGAGACCAGCCTGGCCAACATGGTGAAACCCTGTCTCTAC"
"GL873564","4859490","4859678","chr8","126054004","126054184","54","121194514","CATGTCTCTATTAAAGGTAGAAAAATTAGCCGAAGTATTGTAGTTGGGCTGTATAGTCCCAACTACTGAAGAGGCTGAGACAGGAGGATTGCTTACAACTAGGAGTTTGAGGTTGCTGTGAGCTAGGCTGATGCCAAGGTGCTCTAGCCTGGGCAACAGAATGAGACAATGTCTTAAACAACAAAAAAA","GTCTCTACTAAAAATACAAAAATTAGCTGGGTGTGGTGGTGCATGCCTGTAATCCCAGCTACTCAGGAGGCTGAGGCAGGAGAATCGCTTGAACCCAGGAGGTAGAGGTTGCAGTGAGCCAAGATCATGCCACTGCACTCCAGCCTGGGTGACAGAGGGAGACTCTGTCTCAATAAATAAA"
"GL873564","5294014","5294069","chrX","11604904","11604969","20","6310890","GGGTGTGGTGACTTGCACTTACAATCAGCACTTTGGGAGGCGAAGGTAGGAGCATC","GGCTGGGTGCAGTGACTCACGCCTGTAATCCCAGCACTTTGGGAGGCTGAGGTAGGCAGATCACCT"
"GL873564","5294155","5294257","chr15","310129","310227","21","4984026","GGCTGGGTGTGGTGGCTCACGTCTGTTGTCCCAGCGCTATGGGAGGCTGAGGAGGGTGGATCACCTGAGCTCAGAGGTTCGAGACCAGCATAAGACCAGCATG","GGCTGGGCGCAGTGGCTCACGCCTGTAATCCCAGCACTTTGGGAGGCCAAGGCGGGTGGATCACGAGGTCAGGAGTTTGAAACCAGCCTAGCCAGCATG"
"GL873564","6711055","6711262","chr18","1878493","1878704","55","4832562","CTGGGCCCAGTGGCTCACACCTATAATCCTCGCACTCTGGGAGGCTGAGGCGGGTAGATTGTCTGAGCTCACAGGTTCAAGACCAGTGTGACCCAGAGCGAGGCTTTGTCTCTAAAAATAGCAGGGCGTTGTGGCAGGCACCTGTAGTCCCAGCTACTTGGGAGGCTAAGGCAAGAGAATTGCTTAAACCTAAGAGTCTGAGGTTACA","GGCCAGGCATGGTGGCTCACGCCTGTAATCCCAGCACTTTGGGAGGCCGAGGCGGGTGGATCACAAGGTCAGGAGTTCAAGACCAGCCTGGCCAACATGGTGGAAGCCCATCTCTACAAAAAATTAACTGGGCGTGGTGGCAGGCACCTGTAATCCCAGCTACTTGGGAGGCTGAGGCAGGGGAATTGCTTGAACCTGGGAGGCGGAGGTTG"
"GL873564","6711356","6711451","chr7","158031905","158031997","31","151320549","AAAAGAGTCTGAGGTTGCCATGAGCTATCATGCCAAGGCATTCTAGAGAAGGGGTACAAAGTGAGACTCTGTCTCAAAAAAAGAAAACCAAAAAGG","CCAGGAGGTGGAGGTTGCAATGAGCCAAGATCACACCACTGCACTCCAGCCTGGGTGACAGGGTGAGATTCTGTCTCAAAAAAAAAAAAAAAA"
"GL873564","7057009","7057315","chr14","106885133","106885430","87","99828124","GCCGGGTACAATGGCTTGCGCCTATAATCCCAGCACTCTGGGAAGCAGAGGTGGGTGGATCACCTCAGCTCACGAATTCGCTACCAGCCTGTCCTAGAGTGAGACACCCCCCCCACCCCCACCCCCCACAACCTCTAAAAATAGCCTGGAGTTGTGACGGGCACCTGTTGTCCCAGCTACTCTGGAGGCTGAGACAAGAGAATTGCTTGGGCCTCAGAGTCTAAGGTTGATATGAGCTATGACATCACAGCACTCTATCAAAGGTAACAAAGTGAGACTCTAAATAAATAAATAATAAATAAATAAA","GCCGGGCCCGGTGGCTCTTGCCTGTAATCCCAGCACTTTGGGAAGCTGAGGTGGGTGGATCACCTGAGGTCAGGAGTTCGAGACCAGCCTGACCAATATGGTGAAACCCCGTCTCTACTAAAAATATAAAAATTAGCCGGGTGTGGTGGCATGCGACTATAGTCCCAGCTACTCAGGAGGCTGAGGCAGGAGAATTGCTTGAACCCAGGAGGTGGAAGTTGCAATGAGTCGAGGTCACACCACTGCACTCCAGCCTAGGCAACAGAGTGAGACTCCATCTCAAAAAAAAAGAAAAAAA"
"GL873564","7705416","7705474","chr1","51463330","51463380","19","43757914","TCATGCCTGTAGTACCAGCACTTCAGGAGGCTGAAGCAGGAGCTAAGATTAGAAATTTG","CATGCCTTTAATCCCAACTACTTGGGAGGCTGAGGCGAGAATTGAAGTCCG"
"GL873564","8307239","8307551","chr14","30585163","30585473","93","22277924","GCACAGTGGCTCAGGCCTGTAATCTGAGCACTCTGGGAGGTTGAGGCTGAGGTTAGGAGTTAGGAGAACAGCCTGAGCAAGAGTGAGACCCCATCTCTACCAAAAATAGGGGAAAAAACTCCAAAAATCTAGCCACATGTTGTGGTACTTGCCTGCAATCCCAGCTACTGGGGCATAGGGGGACTGAGGCAAGAGGGTCACTTGAGCGTGAGAGATTGAGGTTGCTGTGAGCTAAGATGATGCCATGGCACTCTACCCAAGGTGGCAGAGTGAGCCTATGTCTCACCAATAAATAAACAAATAAATAAATGAA","GGGCACAGTGGCTCACGCCTGGAATCCCAGCACTTTGGGAGGTCAAGGTGGGTGGATCACCTGAGGTCAGGAGTTTGAGACCAGCCTGGCCAAAATGGTGAAACCCCATCTCTACTAAAAAAAATACAAAAAATTAGCCAGAATGTGGTGGTGCATGCCTGTAATCCCAGCTACTGGGGAGGCTGAGGCAGGAGAATCACTTGAACCTGGGAGGCGGAGGCAGCAGTGAGCCAAGATGGCGCCACTGCACTCCAGCCTGAGTGACAGAATGAGACTCTGCCTCAGGAAAAAAAAAAAAAAAAAAGCAAAAA"
"GL873564","8738781","8739084","chr6","92598388","92598711","90","83859607","GCTGGGCACAATGGCTCACACCTGTAATGCCAGCACTTGGGAGGCTAAGACGGGCAAATTGCCTGAGCTCACAAGTTCAAGACCCAGAGCGAGACCTCATCTCTAAAAAATTGCCATGCATTGTGGAGGGTGCCTGTTGTCCCAGCTACTTGGGAGGCGGAGAAAAGACAATCGCTTTAGCCCAAGAATTGAAGGTTGCTGTGAGCTGTGACGCTGTAGCACTCACCAAGGGCAACATAGTGAGACTCTGTTTCAAAATAAATAAATAAATAAATAAAAATAAATAAATAAAATAAAAACAAAA","GGCTGGGCTCAGTGGCTCATGCCTGTAATCCCAGCACTTTGGGAGGCCAAGGCTGGCAGATTGCCTGAGGTCAGGGGTTCAAGACCAGCCTGGCTAACATGGTGAAACCTCATCTCTAATAAAAATACAAAGATTAGCTGGGTTTGGTGGCACATGCCTGTAGTCCCAGCTATTTGGGAGGCTGAGGCAGGAGAATCGCTTGAACCCAGGAGTTGGAGGTTGCAGTGAGCTGAGATGGCACCACTGCACTCCAGCCTGGGTGACACAGCAAGACTCCGTCTCAAAAAAAAAAAAAAAAAAAAAAAAAAGAAAAGAAAAAAAAAA"
"GL873564","9560044","9560238","chrX","30236033","30236239","48","20675989","GGCCAGGTGCGGTGGCTCCTGCCTGTAATCCCAGCACTCTGGGAGGCCTAGGTGGGTGGATTGCCTGAGCTCACTGGTTGGAGACCAGCCTGATACAGATTGAGACCCCCTGCCTCTAAGAATAGCAGGGTGTTGTGACAGACACCTAAAGTCCCAGCTACTCGGGAGGCTGAGGCAAGAGAATCTCTTGAGCCC","GGCTGGGTGCGGTGGCTCACTCCTGTAATCCCAGCACTTTGGGAGGCCAAGGTGGGCGGATCACCTGAGGTCAAAAGTTCGAAACCAGCCTGACCAACAGGGTGAAACCCCGTCTCTACTAAAAGTACAAAAATTAGCCGGGCATGGTGGCAGGCACCTATAATCCCAGCTACTTGGGAGGATGAGGGAGGAGAATCACTTGAACCC"
"GL873564","9560508","9560604","chr1","212121416","212121513","30","202560908","TCGCTGTGCCCAAAAGTTAGAGGTTGCTGTGAGCTATGATACCACTGCACTTTACTGAGGGTGACAAAGTGAGACTCTGTCTCAAAAAATAAATAAA","CTTGAACCTGGGAGGTGGAGGTTGCAGTGAGCCAAGATCATGCCACTGCACTCCAGCCTGGGCAACAGAGCGAGATTCTGTCTCAAAAAAAAAAAAAA"
"GL873564","9753449","9753658","chr19","10370828","10371033","59","617379","TGAGACCCTGGTCTCTTCTAAACATTAAAAAAAAAAAGAAAACTGGGTGTTGTGGCGATGCCCATAGTCCCAGCTACTGATGAGGCTGAGGCAGGGGGATCACTTGAACCCAGGAGTCTGAAGTTGCTGTAAGCTAGGCTGAAGTCACAGTTGTCTAGCCTAGGGCAATAGAGTAAGACTGTCTCACAAAAAAAAAAAAAGGAAAGAAAA","GAAACCCTGTCTCTACTAAAAATACAAAAAATTAGCTGGGTGTGGTGGTGCGTGCCTATAATCCCAGCTACTCAGGAAGCTGAGGTGGGATAATCACTTGAACCTGGGAGGCAGAGGTTGCAGTGAGCCCCAGACTGTGCCACTGCACTCCAGCCTGGGTGACAGAGTCAGACCCTGTCTCAAAAAAAAACAAAACAAAAAAAAAA"
"GL873564","9753896","9754006","chr17","50277667","50277784","33","40523771","GCTGGGCAGGGTGGCTTGTGCCTGTAATCCTCACATTCTTGGAAGCCAAGTTGGTGGATTTCTTGAGCTCAAGAGTTCAGCCTGAACAACGGTGAGACCCCTGTCTCTCTC","CCGGGCATGGTGGCTCATGCCTGTAATCCCAGCACTTTGGGAGGCCAAGGTGGGTGGATCACTTGAGGTCAGGAGTTCAAGACCAGCCTGGCCAACATAGAGAAACTCTGTCTCTACT"
"GL873564","10693118","10693253","chr1","29437872","29437991","31","18744754","GGCCAGGCGTGGTGGCTCACGCCTGTAGTCCCAGCGCTATGGGAGGCCGAGGCGGGTGGATCACCTGTGCTCAGAGGTTCGAGACCAGCCAAGACCTCCCTGAGCCAAATGAGCCAGAGTGAGACCCCGTCTCTAC","GGCCGGGCGTGGTGGCTCACGCCTGTAATCCCAACATTTTGGGAGGCCAAGGCGGGTGGATCACCTGAGGTCAGAAGTTCGAGACCAACCTGGCCAACATGGTGAAACCCCTGTCTCTAC"
"GL873564","11596705","11596819","chr15","17759279","17759407","35","6162574","AATCCGCTACTCGGGAGTCTGATGCAGGAGGATCCCTGGAACCCGGGAGTGAGCTAGGCTGTCCATTCTACCCAAGGCAGAAGAGTGAGATTCTGTCTCAAAAAAAAAAAAAAAA","AATCCCAGTTACTCAAGAGGCTGAGGCAGGAGAATTGCTTGAACCCGGGAGGTGGAGCCGAGACCGCTCCACTGCACTCCAGCCTGGGTGACAGAGTGGGACTCTGTCTAAAAAAAAAAAAAAAAAAAA"
"GL873564","13278770","13278831","chr1","10318851","10318915","18","2959919","GGCTGAGCACAGTGGCTCATGTCTATAATCCCATCACTCTGGAAAGCTAAGAATGAGGATCT","GGCTAGGCATGGTGGCTTATGCCTATAATCCCAGCACTTTGGGAGGCTGAGGCAGACGGATCACC"
"GL873564","13278924","13279152","chr20","69116969","69117193","62","55838045","AAAATAGAGAATAAGAATCCCTTGAGCTCATGAGTTCAAGATCAGTCTGAACAAGTGTCAGACCCTATCTCTACTAAAAATGGAAAAATTAGCCAGGCACTGTGGCAAGTGCCTGTAGTCCCAGATTTCAGGAGGCTGAGGCAGGAGAATCATTTGAATCCAGGAGTTTGAGGTTGCTGTGAGCTAGGCTGACACCACTGTACTGTAGCCTGGGCAACAGAGTGAGACT","GAGGTGGGTGGATCACCTAAGGTCAGGAGTTCAAGACTAGCCTGGCCAACATGGTGAAACTCCATCTCTACTAAAAATACAATAATTAGCTGGGTGTGGTGGCATGTGCCTGTAATTCCAGCTACTCAGGAGGCTGAGGCAGGAGAATCACTTGAACCCAAGAGGCGGAGGTTGCAGTGAGCCGAGACTATGCCACTGCACTCTACCCTGGGCAACAGAGCAAGA"
"GL873565","1417041","1417214","chr4","44130284","44130433","54","42713243","GGCCAGGCGTGGTGGCTCACGCCTGTTGTCCCAGCGATTTGGGAGACTGAGGTGGGTAGATCACCTGTACTCAGAGGTTCGAGACCAGCTGAAGACCAGCCTGAGGCAGAGTGAGACCCCCGTCTCTATAAGAACAAGACAGCCGGACCTTGTGATCCCAGCTACATGGGTGGC","GGCCGGGTGCGGTGGCTCACACCTGTAATCCCAGCACTTTGGGAGGCTGAGGTGGGCAGATAACCTGAGGTCAGGCGTTCGAGACCAGCCTGGCCAACATGGTAAAACCCCGTCTCTACTAAAAATACAAAAATTAGCCAGGTGTGGTGG"
"GL873565","2138367","2138455","chrX","124155143","124155229","17","122016776","GGCTGGGCGTGGTACTCACGCCTGTTGTCCCAGTGCTGTGGGAGGCTGAGGTGGGTGGATCCCCTGAGCTCAGCAGAGTTTGAGACCAG","GGCTGGGTGCGGTGGCTCACGCCTGTAATCCCAGAACTTTGGGAGGCTGAGGTGGGTGGATCACCTGGGGTGAAGAGTTCGAGACCA"
"GL873565","2459722","2459938","chr7","32729330","32729532","57","30269608","AAAAAGACCAAACACCCCAGCTCTACTAAAAGTAGAAAAATTAGCTGGGTATTGTAGTGGGCACCTGTAGTCCCAGCTGCTTGGGAGGTTGCGGCAGGAGAACCACTTAAGCCCAGGAGTTGGAGGGTGAGGTGGGCTGAGGCCACTGCATTCTAGCCTAGGCAACAGAATGAGACTCTGTCTCAAACAAACAAACAAACAAACAAACAAAAAACAA","GAAACCCCATCTCTACTAAAAATACAAAATTAGCCAGGCATGGTGGTGCACACCTGTAGCTCCAACTACTTGGGAGGCTGAGGCAGGAGAATCACTTAAACCCAGGCAGTAGAGGTTGCAGTAAGCCAAGATCGCACCACTGCACTCCAGTCTGGGCAACAGAGTGAGACTCTGTCTCAAAAAAAAAAAAAAAAAAAAAAAAA"
"GL873565","2460219","2460297","chr10","28805224","28805297","28","26345005","CTCAAGCCTGTAATTCTAGCACAGCTGGGAGGCTGAGGCAGGAAGATCTCTCAGCTTAGGATTTCAAGACTAAACACAT","GTGGCTCATGCCTGTAATCTCAGCACTTTGGGAGGCTGAGGCAGGCAGATAACCTGAGGTCAGGAGTTCGAGAC"
"GL873565","11485258","11485580","chrX","66383160","66383473","97","54897902","GGCAGGGCACAGTGGCTCAATCACAGCACTCTGGGAGGAGGCTTAGATGGGTGGATTATTTGAGTTCACAAATTTAAGAACAGCCTGAGCAAGAGTGACACCCTGTCTCTACTAAAAAACAATAGGAAAAATAAAAACTAGCTGGGCATAGTGGCATATGCCTGTGGTTCCAACTACTTGGGAGGCAGAGGCAAGTTTGCTTAGCTAGTTTTTTTTCAGGCCCAAGAGTAGAGGTTGTTGTGAGCTGTGATGCCATAGCACTCTACATAGAGTGACAGAGTGAGACTTTGTCTAAATAAATAAATAAATAAAATTTTAAAAAA","GGCCAGGCACAGTGGCTCACACCTGTAAATCCCAGCACTTTGGGAGGCCGAGATGGGTGGATCACCTGAGGTCACGAGTTTGAGACCAGCCTGGCCAACATGGTGAAACCTCGTCTCTACTAAAAATACAAAAAAAAAAAAAATTAGCTGGGCGTGGTGGTGTGCACCTGTAGTCCCAGCTACTTGGGAGGCTGAGGCAGGAGAATCGCTTGAACCCAGGAGGCAGAGGTTGCAGCGAGCCGAGATCGCGCCACTGCACTCCAGCCTAGGTGACAGAGTGAGACTCTGTCTCAAGGAAAAAAAAAAAAAAAAAA"
"GL873565","13424539","13424574","chr1","174086158","174086184","14","160661619","ACCTAGGGTGAAAGTAAGACTGTCTCAAAAAAAGAA","AAGAGAGAGAAAGAGAGAAAGAAAGAA"
"GL873565","13424654","13424896","chr16","19730961","19731217","54","6306307","GCCAAGCACAGTGGCTCACACCTGTAATCCCAGCACTCTGGGAAGCCTAGGTGGGTGGATTACTTGAGCTCAGGAGTTCAAGATCAGCCTAAGCAAGAGTGAAACTCCCATGTCTAAATAAACAGCCGGGCATTGTAGTGGGTCCCTGTAGTCCCAGCTACTCAGGAGGCTGAGGCAAGAGAATCGCTTGACCCAGGAGTTGGAGGTTGCTGTGAGCTGAGGCCACGGCACTCTATCTAGGGT","GGCCGGGCACAGTGGCTCACGCCTGTAATCCCACCACTTTGGGAGGCCGAGGCGGGTGGATTACCTGAGCTCTGGAGTTAGAGACCAGCCTAGGCAACATGGTGAAACCCCATGTCTACTAAAATACAAAAAGCCGGGCGTGGCGGCGTGTGCCAATAGTCCCAGCTACTCAGGAGGCTGAGGCAGGAGAATTGCTAGAACCCGGGAGGCGGAGGTTGCAGTGAGCTGAGATCACGCCACTGCACTCCAGCCTGGGC"
"GL873565","13679578","13679856","chr1","27657515","27657797","72","13977937","GCAGGGTACAGTGGCTCACACCTGTAATCATAGTAACTCTTAAGCGGCTGAGGCAAGTGAGAGGCCTGAGATCAGGAGTCCAAGAATAGCCTAACCAAAAGTGAGACCCCATCTCTACTAAAAATAGAAAAAAACTAGCCAGGCATGGTGGCACTTACCATAGTCCCACCTCATAAGGCTGAGGCAAGAGTATCACTTGAACCCAGAAGTTTGAAGTTGCTGTCAGCTACAATGACATCATAGCACTTTACCCAGAGCTACAGAGTAAGACTCAGTCTC","GCTGGGTGCGGTGGCTCACACCTGTAATCTCAACACTTTGGGAGGCTGAGATAGGTAGATCACCTGAGGTCAGGAGTTCGAGACCAGCCTGGCCAACATGGTGAAACCCCATCTCTACTAAAAATACAAAAAACCTAGCCAGGCATGGTGGTGTGTACCTATAATCTCAGCTATTCAGAAGACTGAGACAGGAGAATCACTTGAACTTGGGAGGTAGAGGTTGCAGTGAGCCAAGATCACACCACTGCACTCCAGCCTAGGCAACAGAGTGAGACTCCGTCTC"
"GL873566","947388","947684","chr3","178868174","178868466","60","177920786","GGCCGGGTAGGGTGGCTCATGCCTGTAATCCTAGCATTTTGAGAGGCCAAGGCAGGTAGATTACCTGAGCTCAGGAGTTCCAGACCAGGCTGAGCAAGAGCCCCATCTCTATCAAAAATAGAAAAATTAGCTGGGTATGGTGGCACATGCCTNNNNNNNNNNNNNNNNNNNNNNNNNNNNNNNNNNNNNNNNNNNNNNNNNNNNNNNNNNNNNNNNNNNNNNNNNNNNNNNNATGACACCATAGCACTCTAACCTGGAGCAACAGAGTGAGACACCGTCTTAAAAAAAAAAAAAAAA","GGCCGGGTGTGGTGGCTCATGTCTGTAATCCCAACACTTTGGGAGGCCAAGGCGGGTGGATCACCTGAGGTCAGGAGTTTGAGACCAGCCTGGCCAACATAGTGAAACCCCTCTACTAAAAATAAAAAATTAGCCAGGTGTGGTGGCANNNNNNNNNNNNNNNNNNNNNNNNNNNNNNNNNNNNNNNNNNNNNNNNNNNNNNNNNNNNNNNNNNNNNNNNNNNNNNNNNNNNNNNNNNNNNNNCTCCAGGCTGGGCAACAGAGTGAGGCTCCATCTAAAAAAAAAAAAAAAAA"
"GL873566","2530056","2530102","chr1","123145244","123145289","11","120615188","AGGCCAAGGCAGTTGGATCACCTCAGCTCAGGAGTTTGAGACCCGCC","AGGCTGAGGGAGGCGAATCACCTGAGGTCAGGAGTTTGAAACCAGC"
"GL873566","2923434","2923499","chr1","38303497","38303565","19","35380063","GGGCTCAATGGCTCAGCCTGTAATCTTAGCAGTCTGGGAGGCTGAGGCAGGCGCCTGAGCAAGAGT","GCTGGGCGCAGTGTCTCGTGCCTGTAATCCCAGCACTTTGGGAGGCTGAGGCAGGCGGATCATCTGAGG"
"GL873566","3613441","3613522","chr3","54039458","54039545","21","50426017","GGTGGCACATGCCCGTGATCCCAGCACTCTGGGAGGCCGAGGAGATCGGACTGCCTGAGCTCAGGAGTTCGAGACCAGCCTG","GCGCGGTGGCTCACGGCCTGTAATCCTTGCACTTTGGGAGGCTGAGATGGGTGGATTACCTGAGCTCAGGAGTTCGAGACCAGCCTGG"
"GL873566","6100482","6100582","chr2","51286276","51286376","32","45185794","GGCTGGGTGAGTACCTCATGCATCAAGCCCAGTGTTCTGGAGGCTGAGGCAAGGGGATCCTTGATGTGGATAGTTCAAGGCCAGCCTGGCAATTAGCTAGA","GGCTGGGTGCAGTGGCTCACGCCTATAATCCCAGCACTTCGGGAGGCTGAGGCAGGCAGGTCACCTGAGGCCAGGAGTTCAAGACCAGCCTGGCCAACATG"
"GL873566","6245586","6245714","chr3","50507869","50508002","30","44262283","GCTGGGTGTGGTGGCTCACACCTATAATACCAGCACTTGGGAGGCCAAAGCAAGTGGATTGCCTGAGTTCACAAGTTCAAGACCAGCCTGAGCAAGAGTGAGACCCTGTCTCTTAAAAATAGGTGGGCG","GCCAGGTGCGGTGACTCACACCTATAATCCCAGCACTTTGGGAGGCCGAGGCACGTGAATCACCTGAGGTCAGGAGTTCAAGACCAGCCTGACCAACATGGTGAAACCTTGTCTCTACTAAAAATACAAAAACT"
"GL873566","6245992","6246162","chr16","22888303","22888475","37","16642311","TAGCTGGGCGTTGTGGCGGGCATCTGTAATCCCAGCTACCTGGGAGGCTGAGGCAAGAAAATCACTTAAGCCCAAGAGTTTGAGGTTGCTGTGAGCTGTGATGGCACAGTACTCTATTGAGGGCAACATAGTGAGACTCTGTCTCAAAAAATAAATAAATAAATAAATAAA","ATTAGCTGGGCGTGGTGGTGGGCACCTGTAATCCCAGCTTCTTGGGAGGCTGAGGCAGGAGAATCACTTGAGCCCAGGAGGCAGAGGTTGCAGTGAGCAGAGATCGTGCCACTGCACTCCAGCCTGGATGACAGAGTCAGACTTTGTCTCAAAAAAAATAAAAAATAAAAAAA"
"GL873566","6483968","6484033","chr19","10207852","10207913","17","3723884","AAAATATGGTAAAATAAGCCAAGGATGGTGGGTCACACCTGTAATCCCAGCTACTCAAGAGACTGA","TAAAAATACAAAATTAGCTGGGTGTGGTGGCACACACCTGTAATCCCAGCTACTCAAGAGGC"
"GL873566","7043395","7043464","chr10","28805224","28805297","20","21761829","GGCTAGGCCTGGTAATCCCAGCACTCTAAAAGGCTGAGGCAGGTGGATAGCCTGAGCAAGAGTGAGACCA","GTGGCTCATGCCTGTAATCTCAGCACTTTGGGAGGCTGAGGCAGGCAGATAACCTGAGGTCAGGAGTTCGAGAC"
"GL873566","7888407","7888429","chr16","1275850","1275872","4","6612557","CTAAAAATAAAAAATTAGTCTTG","CTAAAAATACAAAAATTAGCCAG"
"GL873566","7888682","7888751","chr13","39203832","39203891","22","31315150","GTAGTCTTGGCGTAGTGATATGTACCTTTAATCCCAGCTACTCAGGAAGTGGAGGAGGAAAGAGTACAAG","TTAGCTGGGCGTAGTGGTGTGTGCCTGTAATCCCAGCTACTTGGGAGGCTGAGGCGGGAG"
"GL873566","8203857","8203949","chr20","18199749","18199840","19","9995892","GGCCCGGCATGGTGGTGCTTTGCCTATAATCCCAGCATTCTGGGAGGCCCAGGCAGGCGGATCACCTGAGCTCACAGGTTCAAGAATGGCCTG","GGCCGGGCATGGTGGCTCACACCTGTAATCCCAGCACTTTGGGAGGCTGAGGCAGGCGGATCACCTGAGGTCAGGAGTTCGAGACCGGCCTG"
"GL873566","8268872","8268975","chr15","10815564","10815667","26","2546692","GTGGCTCATGCCTGTAATCCTAGCACTCTGGGAGGCCGAGGCAGGTGGATTCCCTGAGCTCATAGGTTTGAGACCACAAGCAAGTCCAAGACCCCATCTCTTTT","GTGGTTCATGCCTGTAATCCCAGCACTTTGGGAGGCCGAAGTGGGCGGATCACCTGAGGTCAGGAGTTTGAGACCATCTGGCCAAGATGTAGAAACCCCATCTT"
"GL873566","8269263","8269458","chr15","77706857","77707054","55","69437594","AAGACCCCATCTCTTAAAAAAGAAAAAAAAAGCTGGGTGTTGTGGCCTTCACCTGTAGTCCCAGCTACTGGGGAGGCCAAGGCAAGAGACTTGCTTGAGCCAGAGTTTGAGGTTGCTGTGAGCTATAGTGCCACGGCACTCTACCAAAGGCAACAAAGTGAGACTGTCAAAAAAAAAAAAAAAAGAAGAAGAAGAA","CCCCATCTCTATTAAATATACAAAAAAATAGCTGGGTGTGGTGGTGTGCGCCTGTAATCCCAGCTACTTGGGAGGCTGATGCAGGGGAAGTGCTTGAACCAGGGAGGTGGAGGTTGCAGTGAGCCGGAATCGTGCCACTGCACCCCAGTCTGGGCAACAGATTGAGACTCTGTCTCAAGGAAAAAAAAAAAAAAAAAA"
"GL873566","8592056","8592127","chr10","28805224","28805297","15","20213168","TCTTGCCTGTAATCTCAGCACTCTGGGAGGCTGAGGCAGGCAGATCAACTGAGCTAACAAGTTCGAGACCAG","GTGGCTCATGCCTGTAATCTCAGCACTTTGGGAGGCTGAGGCAGGCAGATAACCTGAGGTCAGGAGTTCGAGAC"
"GL873566","8809109","8809200","chr11","48033118","48033204","26","39224009","ATAGCCAGGCTTGTTGCAGGCACCTGTAGTCCCAGTTACTCTGGAGGCTGAAGCAAGGGAATATCTTGAGCCCAAGAGTCTGAGGTTGCTGT","TTAGCCTGGCATGGTGGTGACACCTGTAATCCCAGCTACTCAGGAGGCTGGGAAGGAAAATCGTTTCAACCCAGGAGGCAGAGTTTG"
"GL873566","8809477","8809608","chr19","10830410","10830544","33","2020933","GGCCAGGCGCAGTGCCTCATGCCTGTAATCCTAGAACTCCGGGAGGCTAAGGAGGGTGGATTTCCTGAGTTCACAGGCTGGAGACCAGCCTGATCTAGAGTGAGATTCCCAGCTCTAAAAATAGCTGGCCTT","GGCCAGGTGCAGTGGCTCATGCCTGTAATCCCAGCACTTTGGGAGGCCAAGGTGGGTGGATCACCTGAGGTCAGGAGTTCGAGACCAGCCTGATCAACGTGGTGAAACCCCATCTCTACTAAAATTGCAAAATTA"
"GL873566","9503716","9503881","chr12","63241189","63241340","56","53737473","TATTAAAAAAAAAAGGAATTCAAGGCCAAGAGCAGTGGCTTTTGCCTGTGATACTTCCACTGTAGGAGGCCGAGGTGGAAGGATCACTTGAACTCTGGAGTTTGAGGTTGCTGTGATCTAGGCTGACACCACAGCACTCTAACTTGGTGGGCAACAGAGCAAGACT","AAAAACAAAAATTAGCCAGGTGTGTTGGCATGCACCTGTAGTCCCAGCTACTAGGGAGGCTGAGACAGAAGAATCACTTGAACCCAGGAGGTGGAGGTTGAGTGAGCCAAGATCGCGCCACTGCACTCCAGCCTGGGTGACAGAGCGAGACT"
"GL873566","9537883","9537992","chr16","43341998","43342113","30","33804115","ATGCCTGTAATCCTAGCACTTGGGAGGCCAAGGTGGGTGGATTGCCTGAGATCACAGGTTCAAGACCAGCCTGAGCCAGAGTGAGACCCTGCCTCTAAAATGAGCCAGGT","GCCTGTACTCCCAGCACTTTGGGAGGCCAAGGCGGGTGCATCACCTGAGGTCAGGGGTTCAAGACCAGCCTGGCCAACATGGTGAAACTCTGTCTCTACTGAAAATTCAAAAAATT"
"GL873566","9538266","9538462","chr7","167658032","167658223","54","158119766","TTAATTAATTAATTAAATAAAATGAGCCAGGTGTTGTGATGGGCGCCTGTAGTCCCAGCTACTTGGGAGGTGGAGGCAGGATAATCACTTGAGTCCAGGAGTTGGAAGTTGTTGTGAGCTGTGACGCCATTGTACTTGACCCAGGGCGACATCTTGAGGCGCTCTCTCTCAAAATAAATAAATAAAGAAAGAAAGAA","TACTAAAATACATACAAAAATTAGCCAGGTATGGTGGCAGGCCCCTGTAGTCCCAGCTACTCGGGAGGCTGAGGCAGGAGAACTGCTTGAACCCAGGAGGTGGGGATTGCAGTGAGCTGAGATCGCACCACTGCACTCCAGCCTGAGCGACAGAGTGAGACTCTGTCTCAAAAATAAAAAAAGAAAAAAAAA"
"GL873566","13663722","13663916","chr1","23558411","23558571","70","9894689","CTCAAGACCAGCCTGAGCCAAGAACGAGACTGAAAATAGAAAAATTAGTGGGACGTTATGTTGAGTGCTGGCTACTCTAGAGGGTGAGGTAGGAGAATTGTTTAAACTCATGAATTTAAGGTTGCTGTGAGCTAGGCTGACGCCACAGCACTGTAGCCTGGGCAACAGGCTACAGAACAGAGTGAGACTCTGTTT","AAAAATACAAAAATTATCTGGGCATGGTGGTGGGTGCCTGTATTCCCAGCTACTCTGGAGGGTGAGGCGGGAGAATTACTTGAACCCAGGAGGTGAAGGTTGCAGTGAGCCAAGATCACGCCACTGCACTCTAGCCTGGGCAACAGAATGAGACTCTGTCT"
"GL873566","13664206","13664293","chr7","151280825","151280914","17","137616619","GGCTAGATATGGTGGCTCATGCCAGTAATCTTAGCACTTTGGGAGGCTGAGGGGAGAGGATCACTTGAGCTGAAAAGTTCAAGACCAA","GGCCAGGCATGGTGGCTCATGCCTGTAATCCCAACACTTTGGGAGGCTGAGGTGGGTGGATCACTTGAGGCCAAGAGTTCAAGACCAGCC"
"GL873567","8375378","8375469","chr3","123612391","123612479","29","115237013","GGTTGGGCTTGGTGGCACGTACCTATGATCATCCTAGCTACTCAGGGAGCATAAGGCAGAAGAATTGCTTTAGCCCGGGAGTTGAGATCAAC","TTAGTTGGGCGTGGTGGCGCATGCCTGTAATCCCAGCTTCTCGGGAGGCTGAGGCAGGAGAATGGCTTGATCCCAGGAGATAGAGGTTG"
"GL873567","9062667","9063009","chr7","6620384","6620702","97","2442283","GGCCAGGCGTGGTGGCTCACGCCTGTTGTCTCAGCGCTGTGGGAGGCCGAGGCGGGTGGATCGCCTGTGCTCAGAGGTTCGAGACCAGCATGAGCCAGAGTGAGAGCCAGAGTAAGACCCCCTCTCTACCAAAAATTGCTGGGTGTTCTGGCAGGTGCCTGTAATTCCAGGTACTTGGGAGGCTGAGGCTAGAGAATCACTTAAACCCAGGGACCCAGGGGTTGGCGGAGGTTGCTGTGAGCTATGATTCTATGGTATTCTACTGAAGGACACAAAGCGAGACTCTGTCTCCATAAATAAATAAATAAATAAATAAAATAAAAGCAAAATTAAAAAAAAAAAA","GGCCAGGCACAGTGGCTCATGTCTGTAATCCCAGCACTTTGGGAGGCCGAGGCGGGTGGATTACCTGAGGTCAGGAGTTCTAGACCAGCCTGGCCAACAAGGCGAAACCCTGTCTCTACTAAAAATACAAAAAATTAGCTGGGCGTTTTGGCACATGCCTGTAATCCCAGCTACTTGGGAGGCTGAGGCAGGAGAATTGCTTGAACTGGGGAAGTGGAGGTTGCAGTGAGCTGAGATCACACCATTGCACGCCTGAGCAACAGAGCGAGACTCTGTCTCAAAAAAAAAAAAAAAAAAAAAAAAGAAAAGAAAAAGAAAA"
"GL873567","11215752","11215787","chr1","62915138","62915167","12","51699386","CAATAAAGCAAGACTCTGCCTCCAAAAGAAAAAAAA","CAAACAAACAAACATCACAAAAAAAGAAAA"
"GL873567","11215868","11216117","chr8","45194211","45194474","73","33978343","GGCTGGGTGTGATGGTTCAGGCCTGTAATCCCAGCGCTCTGGGAGACCAAGGCAGGATAGCCTGAGGTTAAGAGTTTGAGACCAGCCTGAGCAACACAAGACCCTGTCTAAACCAGGAAAATTACTGGGGTGTGGTGGCGTGTGCCTTAATCCCAACTACTCAGGAGGCTAGAGTATTGCTTGAGGGCAGAAGACTGAGGTTGCTGTGAGGAAAGGCTAAGGTCAAGCCATTCTAGCCCAGGCAATAGAG","GGCCGGGTGTGGTGGCTCATGCCTGTAATCCCAGAACTTTGGGAGGCCAAGGCAGGTAGATTACCTGAGGTCAGGAATTGGAGACCAGCCTGGCCAACATGGTGAAACCTCTTCTGTACTGAAAATTACCTGGGCATGGTGGCACACGCCTATAATCCCAGCTACTCAGGAGGCTGAGGCAGAATTGCTTGAGCCCGGGAGACAGAGGTTGCAGTGAGCCAAGATCGTGCCACTGTCCTCCAGTCTGGCCAACAGAGCAAGACT"
"GL873567","12342574","12342696","chr3","166690011","166690120","46","154347437","GTACGCGCAAACCAGAAAAATCAACTAGGTGTGGCAGGGCACACCTGTAGTCCCAGCTACTGGGGAGGGTGAAGCAAGAGATTGCTCAAGTCTGAGGTTACAGTGAGTTAAGATGATACCACT","TACACATACAAAAAATCAGCTGGGTGTGGTGGTACATGCCTGTAATCCCAGCTACTCAGGAGGCTGAGGCCGGAAAATCACTTGAACCCAGGAGGCAGAGGTTGCAGTGA"
"GL873567","12342734","12342873","chr8","96368294","96368428","43","84025560","GGCCAAACACAGTAGTTTATACCTATAATTCCAGCACTCTGGGAAGCTGAAGCAGAAGGATCAGCTGAGGTCAGGAGCCTCAAGACAAGCCTGGGCAAGACTAAGACTCCCCTCCATCCCTTCCCCCACTGTCTTCTCAC","GGCCAGACACAGTGGCTCACACCTGTAATCCCAGCTCTTTGGGAGGCTGAGGCAGGCGGATCACCTGAGGTCAGGAGTTCAAGACCAGCCTGGCCAACATGGTGAAACTGCATCTCTACTAAAAATATAAAACCA"
"GL873568","4322030","4322103","chr11","54983169","54983243","11","50661139","GGCCAGGCGCAGTGGCTCATGCCTTTAATCATAGCACTCTGGGAGGCTGAGGTAGGCGGATCTCCTGAGCCAGG","GGCCAGGTGCAGTGGCTCATGCCTGTAATCCTAGCACTTTGGGAGGCCGAGGTGGACCGATCACCTGAGGTCAGG"
"GL873568","4439574","4439747","chr7","26745376","26745549","54","22305802","GGCTGGGCATGGTGCTCACACCTGTAATCATAGCACTCAGGGAGGCCGAGGTGAGTGGATTGCCAGAGCTCACAGGTTTGAAACCAGACAGAGCCTTTTTTTTTTTAGAAGAAATTGTAGGCTGGGCATGGTGCTCATACCTGTAATCATAGCACTTGGGAGGCCAAGGCAAGA","GGCTGGGCATGGTGGCTCACGCCTGTAATACCAGTACTTTGGCAGGCCGAGGCGGGCAGATCACCTGAGGTCAGGAGTTCAAGACCAGCCTGGCCGTTTCTACTAAAAATACAAAAAATTAGCTAGGCATGGTGGTGCGCACCTGTAATCCCAGCTACTCGGGAGGCTGAGGCA"
"GL873568","4546898","4547014","chr15","31980678","31980795","24","27433780","GGCAGGGTGTGGTGTACACCCCTATAATCCCAGCACTTTGGGAGGCTAAGGCAGGAGCATCACCTGGGGCAGGAGTTCAAGGCCAGCCCGGAGAACAGAATGAAACTCCATCTCCAC","GGCAGGGCGTGGTGGCTCACGCCTCTAATCCCTGCACTTTGGGAGGCCAAGGCAGGCAGATCACCTGAGGTCAGAAGTTCAAGACCAGCCTGGCCAATGTGGTGAAACCCCATCTCCA"
"GL873568","5509331","5509406","chr12","122182458","122182528","25","116673127","TAATCCTAGCACCCTAGGAGGCCCAGGTGGGTGGATTACCTGAGCTCAGGAGTTCAAGAGCAAAAGTGAGACCCCT","CCCAGCACTTTGGGAGGCCAAGGCAGATGGATCACCTGAGGTCAGGAGTTGAAGACCAGCCTGGCCAACAT"
"GL873568","5509687","5509883","chr11","2904691","2904882","40","2604996","GTGAGACCCTTGTCTCTACTAAAAGTAGAAAAACTAGCCAGGTGTTGTGGCAGGTGCCTGTAATACCAGCTACTTAGAAGGCTGAGGCAGGAAGATCAGTTGAACCAAAGAGTTTGAGATTGCTGTGAGCTATGATGAAGCCACAGCACTCTACTATCCAGAGCGACAGAGGGAGACTCTGTCTCCAAAAAAAAAAA","GTGAAACCCTGTCTCTACTAAAAATACAAAAATTAGCCAGGTGTGGTGGTGCATGCCTGTAATCCCAGCTACTCAGGAGGCTGAGGCAGGAGAATCACTTGAACCCAGGAGGTGGAGGTTGCAATGAGCCAAGATCGTGCCACTGCACTCCAGCCTGGGTGACAGAGCGAGACTCCATCTCAAAAAAAAAAA"
"GL873568","7119774","7119822","chrX","41233833","41233871","13","34114059","AAAAGTAAAAAATGAGCCGGGTGAGGTAGCTCACGCCTGTAATCCCAGC","AAATCAGCCGGGTGTGGTGGCTCACGCCTGTAATCCCAG"
"GL873568","10881797","10881967","chr1","164648998","164649168","46","153767201","AAAATCACATATTTGCCTGGCATGTTGACTCATGCCCCTATGATCCTAGCACTCTGGGAGGCTGAGGCAGGAGCCTCACTTGAGTCTGTGAGTCTGAGGTTGCTATGAGCAAGGCTGATGCCATGATACTCTAGTGTGGTACAACAGAGTGAGACTCTGTCTCAAAAAAAA","AAAAACACATATTAGCTGGGTATGGTTGTGCGTGCCTGTAATCCCAGCTACTTGGAAGGCTGAGGCAGGAGAATCACTTGAACCCGTGAGGCGGAGTTTGCAGTGAGCTGAGATTGTGCCACTGCACTCCAGCCTGGGCAACAGAGCAAGACTCTGTCTCAAACAAACAAA"
"GL873569","1403943","1404082","chr2","53765152","53765289","48","52361209","AAGCTGAAGCAGAAAAACGGGCTAGAGGTCAAAAGTTTGAGACCTACCGTGGCTACACAGCAAAACTCTGTCTCTAAAAAAAATAAATAAGACCAGGTAAGGTGGTCATGACTATACTCCTAGCCCCTTAAGAGGCTGAG","GAGGTGGGTGGATCACCTGAGGTCAGGAGTTCCAGAACAGCCTGGTCAACATGGCGAAACACTGTCTCTACTAAAAATACAAAAATTAGCCAGGTGTGGTGGCATGCACCTGTAGTCCCCGCTACTCAGGAGGCTGGG"
"GL873569","7343422","7343556","chrX","124155286","124155406","55","116811864","TTTGAAAGTAGACTGCAAACATCATGTTGCTTCACCTCTAAATATATTAATATGGGCCAGGTGCAGTGGATCATGCCTGTAATCCTAGCACTTGCTAGGCCAAGGCTGGCGGATAGCCTGAGCAACAGCGAGACC","ATCAGCCTGACCAACATAGTGAAACCCCATCTCTACTAAAAATGCAAAATTAGCTGGGCGTGGTGGTGCATGCCTGTAATCCCAGCTACTTGGGAGGCTGAGGCGGGAGAATCACTGGAAC"
"GL873569","7404564","7404762","chr6","586928","587122","48","6817636","GAGATCCCATCTCTTAATGAAAATAAAACAATTAGCTGCTATTGTGGCAGGCACCTGTAATTCCAGCAACCCAGGAGGCTGAGGCAGGAGGATCACGTGAACCCCACCAGTTTGAGGTTGCTATGAGCCAGGCTGATGCCAGGACACTCCAGCCTGGGCAACGGAGTGAGACTCCATCTCCAAAAAAAGCAAACAAAAA","GAAACCCCATCTGTACTAAAAACACACAAATTAGTGGGATGTGGTGGCACGTCCCTGTAATCCTAGCTATTCAGGAGACTGAGGCAGGAGAATCACTTGAACCCAGGAGGTGGAGGTTGCAGTGAGCCGAGGTCACACCACTGCACTCCAGCCTGGGCAGCAGAGTAAGACTCCATCTCAAAACAAAAACAAAAA"
"GL873569","7405040","7405133","chrX","21386588","21386682","29","13981548","GGGCAGGGCGGCTCAGGCCTCTAATCCTAGCACTCTGGGAGCTTCCTTGAGCTCAGGAGTTCAAGACCATCCTAAGCAACAGAGATCCCATCTC","GCTGGGCACGGTGGCTCACGCCTGTAATCCCAGCACTTTGGGAAGCCAAGGTTTGAGGTCAGGAGTTCAAGACCAGCCTGGCCAACAGGCTGCAA"
"GL873548","15249374","15249463","chr5","46485072","46485159","19","31235698","GGCCAGGCATGGTGGCTCATACCTATTGTCCTAGCACTGTGGGAAGCCAAGGCAAGTGGATCACCTGAGCTCTAGAGGTTCGAGACCAGC","GGACAGACACAGTGGCTCATGCCTGTAATCCCAGCAGTTTGGGAGGCCAAGGCAGGTGGATCACCTGAGGTACAGAGTTCAAGACCAG"
"GL873548","15817199","15817306","chr7","158031905","158031997","37","142214706","AAAAAAAAAGAGTTGGAGGTTGCTATGAGCAACATCAGCATGGCACTCAATTCCAGGGTGACTGACTGAGACTGTTGTAGCTATACTCCAAAAAAAAAAACACACAAA","CCAGGAGGTGGAGGTTGCAATGAGCCAAGATCACACCACTGCACTCCAGCCTGGGTGACAGGGTGAGATTCTGTCTCAAAAAAAAAAAAAAAA"
"GL873548","15817589","15817786","chr3","3025868","3026088","60","12791721","GGCCAGGCATGGTGGCTTCTGTAATGCCAGCATTCTGGAAGGCTGAGGTAGGCAGTAGCTTGAGCTCAGTAGGAGAACAGCCTGACCAAAAGTGAGACCCTGTCTCTAAAAATAGTCGTTTGTGGTGGTTACCTGTTGTCCCAGCTACTAGGGAGGCTGAGGCAAGAGAATCACTTGAGCGTAAGAGTTGGAGGTTGC","GGCCAGGCACGGTGGCTCATGCCTGTAATCCCAGAACTTTGGGAGGCTGAGGTGGGCAGATCACCTGAGGTCAGGAGTTGGAGACCAGCCTGACCAACATGGTGAAACCCTGTCTCTACTAAAAATACAAAATTAGCCAGGTGTAGTGGCACGTGCCTGTAATCACAGCTACTTAGGAGGCTGAAGTAGGAGAATCACTTGAACCTGGGAGGTGGAGGTTG"
"GL873548","15856498","15856605","chr18","35090078","35090171","38","19233580","CCCCCCCCAAAAAGAAAAGGGTTGCTTGAATCTAGGAGTTTGGGGTTGCTGTGGGCTAAGCTGATACCACAGCACTTTAGCCTGAGCAAACAGAGTGACACTCTGTCT","AAGCAGGAAATCGCTTGAACCCAGGAAGCAGAGTTGCAGTGAGCCAAGATCGCACCACTGCACTGCAGCCTGAGCAACAGAGAAAGACTCTGTC"
"GL873548","15856683","15856877","chr3","3200882","3201085","53","12655801","GCCAGGCACAGTGGCTCATGCCTATAATCCTAGCACTCTGGGAGGCCAAGGCAGGATTGTCTAAGCTTGGGAGTTTGACAGCAGCCTGAGAAAGATTGAGACCCCTGTCTCTACTAAAAAATAGAAAAATTAGCTGAGTGTTGCAGCAGGTGCCTGTATTTCCAGCCAAGGGGGAGGTTGAAAAGGGTCGCTTCA","GGCCAGGCGCAGTGGCTCATGCCTGTAATCCCAGCACTTTGGGAGGCCGAGGCGGGTGGATCATAAGGTCAGGAGTTTGAGACCAGCCTGGTCAACATGGTGAAACCCCATCTCTACTAAAAATACAAAAATTAGCTGGGTGTTGTGGCACATACCTGTAATCCCACCTACTCAGGAGGCTGAGGCAGGAGAATCACTTGAACC"
"GL873549","1940307","1940608","chr12","9481260","9481565","74","7540953","GGCTGGGCGCAGGGGCTCATGCCTGTGACCCTAGCACCCTGGGAAGCCAAGGCGGGCAGATCGCCTAAGCTCACGAGTTTGAAACCAGCCTTAGCTAGAGTGAGACCCCCAATACTAAAAAAATAGCCAGGCTTTGTGATGGGCGCCTGTAGTCCCAGCTACCTGGGAGGCTGAGGCAAGAGAATGGCTCAAGCCCAAGAGTCTGAGGTCACAGTGAGCTACTGACGCCACCGCACTCTATTGGAACAACAAAGTGAGACTGTGTCTCAAACAAACAAACAAACAAACAAACAAAAAAGAAA","GCTGGGCGCGGTGGCTCATGCCTGTAATCCCAGCACTTTGGGAGGCCAAGGCAGGTGGATCACCTGAGGTCAGGAGTTCGAGACCAGCCTAGTCCACATGGTGAAACCCCATCTCTACTAAAAACTAGCCAGGCGTGGTGGTGCGCACCTGTAATCCCAGCTACTCGAGAGGCTGAGGCAGGAGAATCACTTGAGCCTAGGAAGCAGAGGTTGTGGTGAGCTGAGATCACACCACTGCACTCCAGTCTGGGCGACACAGTGAGACTCTTGTCTCAAAAACAAAAAACAAACAAACAAACAAACAAA"
"GL873549","2657819","2658019","chr11","18547798","18548000","50","15889979","GGCCTGGCACTGTGGCTCACACCTGTCAGGTTAACACTCTGGGAGGCTGATATGGGTGGGTCTCCTGAGTTTAGGAGTTTAAGACCAGCCTAATCAAGAGTAAGACCTGCCTTTACTAAAAATAGAAACACTCACCAGGACTACTGTGCACCTACAGTCCCAGCTACCTGGGAGGCTGAGGCAAGAGGATTGCTCAAGCCC","GGCCAGGCACTGTGGCTCACACCTGCAATCCCACCACTCTGGGAGGCAGAGGCAGGTGGATCACCTGAGGTCAGGAGTTTGAGACCAACCTGGCCAACAGAGCAAAACACTGCCTCTACTAAAAATACAAAAACTAGCCAGGTGTGGTGCATGCCTATAGTCCCACCTACTTGGGAGGCTGAAGCAGGAGAATCTCCTGAGCC"
"GL873549","8853848","8853952","chr12","88112976","88113081","32","79259128","AGCCAGCTGTGTGGCTCATTCCAGTAATTCCAGTTACTGGGGAGGCTGAGACAGGAGGATCACTTGAATGCAAGAGGTGGCGAGAACTCAGCTTTAAAAATAAAA","GGCCAGATGCAGTGGCTCATGCCTGTAATCCCAGCACTTTGGGAGGCTGAGGCAGGCGGATCACCTGAGATCAGGAGTTTGAGACCAGCCTGGCCAACATGGTAAA"
"GL873549","10378794","10378882","chr20","18199749","18199840","17","7820955","GGCCAGGCACGGTGGTTCACCTGTGATCCCAGCACTCTGGGAGATAAGGCAGGCTGATCACCTGAGTTCACAGGTTGGAGACCAGCCTG","GGCCGGGCATGGTGGCTCACACCTGTAATCCCAGCACTTTGGGAGGCTGAGGCAGGCGGATCACCTGAGGTCAGGAGTTCGAGACCGGCCTG"
"GL873549","15488169","15488282","chr10","38476693","38476794","41","22988524","CTGAGCACACGGGTTCACACCTGTAATCCCAGCACGCTGAGAAGCCCAGGCAAGAGGCTGACCTCCAGCCTGGGTGACGGAGCGAGATTCCCCCCCACCCCCGACCAAAAAAAA","CTGAGCGCTGGTAGCTTACACCTGTAATCCCAGCACTTTGGGAGGCCTAGACAGGCGGATCACTTGGGGTCAGGAGTTTGAGACCAGCCTGGCCAATATGAT"
"GL873549","17403348","17403519","chr10","38461164","38461337","46","21057816","GCCAGGCACAGTGGCCCACACCTGTAATCCCAGTACTGTGGGAGGCTGAGGCAGGCTGAGGCAGGCATGGATCACTGAGGTTGCTGTGAGCTAAGATGCCATGGCCCTCCACCCAAAGTGACAGAGTGAGACTCTGTCTCAGAATTAAAAAAAACAAAGAAAGAAAAATAAA","GCCAGGCATGGTGACTCACGCCTATAATCCCAGCACTTTGGGAGGCTGAGGCATGAGAATCACTTGAACCCAGAAGGCAGAGGTTGCAGTGAGCTAAGATTGTGCCACTGTACTCCTGCCTGGGTGATGGAGTGAGACTCTGTCTCGATTTAAAAAAAAAAAAAAAAAAAAAAA"
"GL873550","801968","802043","chr15","50500527","50500602","20","49698559","GTAGCCAGGTATGGTAGTGCAGGCCTGTACTCCCAGCTACTTGGAAAGCTAAGGCAATAGAATCATTTAAGCCCAG","TGGCCGGGCATGGTGGTACATGCCTGTAATCCCAGCTACTTGGGAAGCTGAAGCAGGAGAATTGCTCGAACCCAGG"
"GL873550","802343","802376","chr3","33494224","33494257","9","32691881","TAAGACTTTGTCTCTACTAAAAATAGAAAAAGTG","GTGAAACCCGTCTCTACTAAAAATACAAAAATTA"
"GL873550","2805841","2805900","chr2","93673843","93673900","18","90868002","CTATTCAAAATAGCTAAAATGGGCAGGGCAAGGTGGCTCACACCTGTAATCCCAGTACTC","TAAAAATGTAAAAGATTGGCCGGGTGTGGTGGCTCACTCCTGTAATCCCAGCACTTTG"
"GL873550","4153085","4153214","chr16","18855701","18855834","37","14702616","GGCAGGGCTTGGTGGTAAAAGCCTGTAATCCTACCACTCTGGGAGGCAGAGGTGGTTAGATTGCATGAGGTCACTGGTTGGAGACCAGCCTGAGCTAGAGCAAGACCTCATCTCCAAAAATAGCAGGGCT","GGCTGGGCGCGGTGGCTCACACCTGTAATCTCAGCACTTTGGGAGGCCGAGGTGGGTGGATCACCTGAGGTCAGGAGTTCGAGACCAGCCTGGCCAACATGGCAAAACCCCATCTCTACAAAAATACAAAATTA"
"GL873550","4153472","4153634","chr7","17472856","17473028","43","13319384","AATAAAAATAGCAGGGCTTTGTGGCGGGCACCTGTAGTCCCAGCTACTTGGGAGGCTGAGGCAAGACAATTGCTTGAGCACAAAGTTGGAGGTTGTTGTGAGCTGTGACATCATAGCACTCTACCAAGGGAGATAGAGTGAGACTATCTCGAAGAAAAAAAAA","ATACAAAAATTAGCCAGGTGTAGTGGCGTGCACCTGTAATCCCAGCTACTCGGGAGGCTGACGCATGAGAACTGCTTGAACTCAGGAAGTGGAGGTTGCAGTGAGCTGAGATAGTGCCACTGCACTCCAGCCTGGGTGACAGAGCAAGACTCCATCTCAAAAAAAAAAAAGAA"
"GL873550","6050671","6050965","chr7","84009904","84010193","74","77959233","GGTGGCTCACGCCTGTTATCCTAGCACTCCAGGAGACTAAGGTAGGAGGATGCCTTGCTTGAACTCAAGAGTTCAAGACCAGTCTGAGTGAGAGGGAGACCCTGCGTCTACTCAAAAATAGAAAAATTTACCAGCCATTGTGGCCAACACCTGTAGACCCAGCTATTCAGGAGTCTGAGGCCAGAGAATCACTTGAACCCAGGAGACTGAGATTGCTGTGAGCTAGGCTAAAACCATGGCACTCTAGCCCAGGTGGCAGAGTGAGACTGGGTCTGCAAAAAATAAATAAAAACAA","TGGCTCATGCCTGTAATCCTAGCACTTTGGGAGGCCAAGGCAGGTGGATTGCCTGAGCTCAGGAGTTCAAGACCAGCCTGGCAACACGATGAAACCCCGTCTCTATTAAAAAATACAAAAAATTGGCCAGGCATGGTGGTGTGCACCTGTAATCCCAGCCACTCAGGAGGCTGAGGCAGGAGAATCGCTTGAACCCGGGAGACAGAGGTTGCAGTGAGCCAAGATCGAACCATTGCACCCCAGCCTGGGTGAGAGTGAGACTCTGTCTAAAAAAAAAAGAAGAAAAAGAA"
"GL873550","6212004","6212068","chr19","50425309","50425373","23","44213305","AGAACCTAAGAGTTTTGAGGTTGCTATGAGCTGGACTGATACCATAGCATTCTAGTCTGGGTGAC","TGAACCCAGGAGGTGGAGGTGGCGTGATGCCCAAGATGTGCCACTGCACTCCAGCCTGGGTGATA"
"GL873550","6212319","6212418","chr17","89042086","89042197","34","82829767","CTGTCTTTTCTAAAAATAGAAAAACTAGCTGGGTTGTGGTGGGCACTTGTAGTCCTAGGTACTCTGAGGCTGAAACAGGATTGCTTGAACCTAAGAGTTT","GTCTCTACTAAAAATACAAAAATTAGCCGGGCATGCTGGTGGGCACCTGTGATCTCAAGCTACTTGGGAGGCTGAGGCAGGAGAATCACTTGAACCTGGGAGGCAGAGGTTG"
"GL873550","6504310","6504401","chr19","2969698","2969794","27","3534612","GTGCTGGTGTATGCACCTGTCATACCAGCTACTCCTGAGGTTGAGGCAGGATAGCTTGAACCCGGGAGTCTGAGACTGCAGTGAGCTGGGAT","TTAGGCGTGGTGCATGTCTGTAATCCCAGCTACCCGAGAGGCTGAGGCAGGAGAATCACTTGAACCTGGGAGGCGGAGGTTGCAGTGAGCCGAGATC"
"GL873550","7178331","7178523","chr19","40691105","40691269","60","33512774","GGCCAGACGCGGTGGCTCACGCCTGTTGTCCCGGCACTGTGGGAGGCCGAGGCTGGTGGATCCCCTGAGCTCAGCCAAGTTCAAGACCAGCGGAAGACCAGCATGAGGCAGAGTGAGCCAGAGTGAGACCCCGTCTCTACAACAACAACAACAAAAAATAGCCGGACCTTGTGATCCCAGCTACATGGGAGGC","GGCCGGGCATGGTGGCTCACGCCTGTAATCCCAGCACTTTGAGAGGTCGAGGCAGGTGGATCACCTGAGGTCAGGAGTTCGAGACCAGCCCGGCCAATATGGTGAAACCCCTTCTCTACTAAAAATACAAAAAATTAGCCGGAAGTGGTGGCATGCACCTGTGAT"
"GL873550","7981631","7981790","chr6","148611209","148611366","40","140629578","ATAGCCCCGCCTTGTGGTAGGCTCCTGTAGTCCCAGCTACTTGGGAGGCTGGGGCAAGAGAATCACTTAGGCCCAAGAGTTGGAAGTTGCTGTGAGCTGTGATGCTACAGCATTCTACTGAGAGTGACAAAATGAGACTCTGTTTAAAAAAAAAAAAAAA","TTAGCTGGGCATGGTGGCAGGTGCCTGTAATCCCAGCTACTCTGGAGGCTGAAGCAAGAGAATCGCTTGAACCCAGGAGGTGTAGGTTGCAGTGAGTCGTGCCACAGCACTCCATCCTGGGTGACAGAGCAAGACTCTGTCTCAAAAAAAAAAAAAAA"
"GL873550","7982053","7982180","chr2","182489403","182489528","28","174507350","GGCTGGGCGAGGTTGTTCAGACCTGTAATCCTAGCACTCTGGGAGACCAAGATGGGTGGATTGCCTGAGTTCATGAGTTTGAGACCAGCCTGAGCCAGAGTGAAACCTTGTTCTCTAAAAATAGCTCG","GGCCGGGTGTGGTGGCTCATGCCTGTAATCCTAGCGCTTTGGGAGGCCGAGGTGGGTGGATTGCCTGAGCTCAGGAGTTCGAGACCAGCCTGGGCAACACGGTGAAACCTGTCTCTACTAAAATAC"
"GL873550","8404122","8404320","chr4","121405930","121406135","43","113001808","GGCCAGGCACAGTGACTCACACCTGAAATCTTAGTACTCTGGGAGGCCAAGGTGGGAGGATTTCCTGAGGTCAGGAGTTCAAGACCAGCCAGAGCAAGAAGATCCTGTCTCTACTAAAAGTATAAAAAGTGAACCAAGTGTGGTAGTGAGCACCTATAATCTCAGCTACTTGGGAGGCCGAAGCAAGAGGATCACTTGA","GGCCAGGCACAGTGGCTCACACCTGTAATCTCAACACTTTGGGAGGCCAAGGTGGGTGGATCACCTGAGGTCAGGAGTTTGAGACAAGCCTAGCCAGCATGGTATAACTCCATCTCTACTAAAAGTATAAAAATCAACCAGGTGTGGTGGCACATGCCTGTGGTCCCAGCTACTTGGGAGGCTGAGGCAGGAGAATCACTTGAATC"
"GL873550","8404408","8404483","chr15","701469","701538","22","7702939","AGGATCTCTTGAGCTCGGGAGTTTGAGGTTGCAGTGAGCCAGGCTGATGTCATGGCACGCTACCCAAGACAACAAA","AATCACTTGAACCCAGGAGGCAGAGGTTGCAGTGAGCCAAGACTGTGCCATGGCACTCTAGCCTGGGCAA"
"GL873550","11648593","11648682","chr3","124881947","124882027","31","113233354","GTGGCTCACACTAGTAATCTTAGTACTTTGGGAAGCTGGGGCAAGAGGATCACTTGAGGTCAGGGTTAGGAAACTCTATCACTACAAAAA","GCGGTGGCTCACGCCTGTAATCCTAGCACTTTGGGAAGCCAGGCAGGCAAATCACGAGGTCAGGAGTTCGAAACCAGCCTG"
"GL873550","12468624","12468663","chr9","62916303","62916339","11","50447679","GCCCGGCTTGGTACCTCATGCCTGTAATCTTAGCACTCCG","GGCCGGGCATGGTGGCTCATGCCTGTAATCCCAGCAC"
"GL873550","12468943","12469188","chr12","70524409","70524645","91","58055466","AATCTTAGCACTCCGGGAGGCCGAGGCGGGTAGACCAACCTAATCAAGAGCAAGATCTACCTCTACTAAAAATAGAAAAGAATTGGCCAGGCGTATTGACTCCGCCTCTAGTGCCAGCTACTCCAAAGCTGAGGCAAGAGGATTGTTCAAATCCAAGAGTTTGAAATTGCTGTATGTTACACCAGGGCACTCTAGCCGTGGAGACATTTTCTCTATATATATTAAAAAAAACAAAAAACAGAAAAA","CTGAGCTCGGGAGTTCGAGACCAGCCTGACCAATATGGAGAAACCCTGTCTCTACTAAAAATGTAAAATTAGCCAGGCATGGTGGCACATGCCTGTAGTCCCAGCTACTCAGGAGGCTGAGGCAGGAGAATCGCTTGAGGTCAGGAGGCGGAGGTTGCAGTGAGCCAAGATCATGCCACTGCACTCCAGCCTGGGTGACAGAGTGAGACTTTGTCTCAAAAAAAAAAAAAAAAAAAA"
"GL873550","14719674","14719880","chr16","30390993","30391163","76","15671319","GGGCGTGGTTGCTCACGCCTGTTGTCCCAGCGCTGTGGGAGACCGAGGCAGATGTATCGCCTGAGCTCAGCCGAGTTCGAGTTCGAGACCAGCGGAGAGACCACCATGAGGCAGAGTGAGCCAGAGTGAGACCCCGTCTCTACAACAACAACAAAGAAAACAGCCGGATCTTGTGATCCCAGCTACATGGGGGCCAAGAGAATCACT","GGGCACGGTGGCTCACACCTGTAATCCCAGCACTTTGGGAAGCCAAGGCAGGAGGATCACCTGAGGTCAGGAGTTCAAGACCAGCCTGGCCAACATGGTGAAACCCCGTCTCTACTAAAAACACAAAAATTAGCCAGGTGTGGTGGTGCACGCTTGTAATCCCAGCTACTC"
"GL873550","15737883","15738154","chr2","20481557","20481833","73","4743674","TTAGCATTCTGGGAGGCCAAGTCAGGTGGATTGCCTGAACTCACAAATTTGAGACTAGCCTGAGATAGAGAAAGATCTTGTCTCTAAAAAAAAAAAAAAATAGCTGGACTTTGTAGTGGGCACCTGTAGTCCCTGCTACTCAGAAGGCTGTGGTAAGAGAATCACTGGAACCCAAGAGTTAGAGGTTGCCGTGAGCTGTGATGCCATGGCACTCTACCAGAGACAACAGAGTGAGACTCTCTCCAAAAAAAAGAAAAAGAAAAAGAAAAAAA","GCACTTTGGGAGGCCAAGGCAGGTGAATCACCTGAGATCAGGAGTTCAAGACCAGCCTGGGCAACATGATGAAACCCTGTCTCTATGAAAAATACAAGAATTAGCTGGGCATAGTGGTGTGCATCTGTAATCCCAGCTACTCAGGAGGCTGAGGTATGAGAATTGCTTGAACCCTGGAGGCAGAGGTTGCAGTGAGCCGAGATGACACCGTTGCACTTCAGCCTGGACAATAGAGAGAGACTCTGTCTCAAAAAAATGAAGAAAAGAAAGAAAGAAA"
"GL873550","15738844","15738873","chr10","65896918","65896951","9","50158074","GGGTGTGGTGGCTGATGCGTGTAATCCTAG","GGCTGGGCGTGGTGGCTCATGCCTGTAATCCCAA"
"GL873550","16345151","16345329","chr1","6754007","6754209","69","9591144","CACCTGTAATCCCAGCACTTGGGAGGTTGAGGAGAGTGGATTGCCTGAGCTCACAGGTTTGAGCCAGAAGGAGACCTCGTCTGTAAAAATAGCTGGGTGTTGAGACCAGCGCCTTTAGTCCCAGCTACTTGGGAGGCTGAGGCAAGAGAATCACTTAAACAATTCTAGAAGCAGAGTTT","CTGTAATCCCAGCACCTTGGGAGGCTGAAGAGGGCGGATCACCTGAGGTCAGGAATTTGAGACCAGCCTGGCCAACATGGTGAAATCCCATCTCTACTGAAAATACAAAATTAGCTGGGTGTGGTGGTGCATGCCTGTAGTTCCAGCTACTTGGGGAGCTGAGGCAGAAGAATGCCTTGAACCCGGGAGGCAGAGGTTGCAGT"
"GL873550","17727115","17727274","chr1","127857902","127858038","52","110130787","GCTGGGTGCAGTGACCCCTGCCTATAATCCCAGCAGTTAGGAGACAAAGGCAGGAGGAATTACCTGAGAGCAGGAGTTCCAGACAAGCCTCAGACCAGCGTGAGCTATGACATTGTCTGTAGCCCCCACCCCACCCCCCCAAAAAACAAAAAGAAACAAA","GGCTGAGTTCAGTGGCGCACGCCTGTAATCCCAGCAGTTGGGAGGCTGAGGCAGGTGGATTGCCTGAGGTCAGGAGTTCAAGACCAGTCTGGCCAACATGGTGAAACTCTGTCTCTACTAAAAAAAAAAAAAAAAAT"
"GL873551","6567068","6567102","chr14","109767086","109767123","14","103200018","GGATCACATGAGGTCAGGAGTTCAAGATCAGCCTG","GGAGGCAGAGGTTGCAGTGAGCCAAGACTGCGCCATTG"
"GL873551","9393264","9393376","chr1","39198637","39198744","32","29805373","CAAGAGTATCTCTGCAACCCAGTGGCCTGAGGTTGCTATGAGCTAGGATGCCACAGCACTCTACCCAAGGGGACAGAGTAAGACTCTGTCTCCAAAAAAAAAAAAGAGCAAAA","AGAATCGCTTGAACCTGGGAGGCGGAGGTTGCAGTGAGACCAGATCATGGCACTGCACTCCAGCCTGGGCGACAGAGTAAGACTCGGTCTCAAAAAAAAAAAAAAAAA"
"GL873551","9393708","9393894","chr12","115674238","115674427","40","106280530","GCTGGGCTCAGTGCCTCTCGCCTGTAATCCCAGCACGCTGGGAGCCTGAGGTGGGTGGGTTGCTTGAGCTTAGGAGTTCAAGACCAGCCTGAACCAGAGCAAGACACTATCTCTACTAAAAATAGAAAAACTATCTGGGCATGGTGGTGCGCACCTGTAGTCCCAGCTACTAGGGAAGCTGAGGCAA","CCAGGCCTGGTGGCTCACGCCTGTAATCCCAGCACTTTGGGAGGCCGAGGTGGGTAGATCACCTGAGGTCAGGAGTTCAAGACCAGCCTGGCCAACATGGCGAAACCCCATCTCTACTAAAAATACAAAAATTAGCTGGGCATGGTGGTGTATGCCTGTAATCCCAGCTACTCGGGAGGCTGAGGCAGGA"
"GL873551","10104594","10104683","chr16","53032852","53032939","31","42928258","GGTAGGTGGGTCTCTCGAGGTTAGGAGCTCTTTACCAGCCTGAGCTGACATAAGACCCAATCTCCACCAAAATAGAGAGAGAAAAAAAGA","GAGGCAGACAAATCTCTTGAGGTCAGGAGTTGAAGACCAGCCTGGGCAACATAGACCTCGTCTCTATTAAAAAAAGAAAAAAGAAAAA"
"GL873551","12307468","12307551","chr8","94102375","94102458","19","81794907","GGCCAGGCATAGCAGCTCATGCCTGTAGTCCTATTATTCTAGGAGGTCCAGGGAGGAGGATCACCTGAGATCAGAAGTTCAAGA","GGCCAGGCATGGTGCCTCATGCCTGTAATCCCAGTACTTTGGGAAGCCAAAGTGGATGGATCACCTGAGGTCAGGAGTTCGAGA"
"GL873551","13335872","13336095","chr4","85819795","85820026","56","72483923","GCCAGGTACAGTAGCTCAGGCCTGTAATCCTAGCACACTGGGAGGCTGAGGTGGTGGATCCTTGAACTCATGAATTCAAGACCAGCCTGAGGAAGAGCAAGACCCCATCTCTCCTAAAAATAGAAAAATTAGCTGGTGTCATGGCAAGTGTCTGTAATCCCAGCCACACAGGAGGCTGAGGCAAGAGGATCTCTTGAACCCAAGACACTAAAGTTACTGGGAGC","GCCGGGCATAGTGGCTCATGCCTGTAATCCCAGCACTTTGGGAGGCTGAGATGGGTGGATCATCTGAAGTTAGGGGTTCGAGACCAGCCTGGCCAAATGGCAAAAACCCATCTCTGCTAAAAATACAAAAATTAGCCAGACATTGTGGCATGTGCCTGTAATCCCAGCTACTCAGGAAGCTGAGACAGGAGAATCGCTTGAACCCAGGAGGCAAAGGTTGCAGTGAGCCAAG"
"GL873552","1195303","1195426","chr3","54039332","54039457","34","52844029","CTACTCTGGATGCCAAGGCAGCGGGATCACTTGAACCCCAGAGTCTGAGGTTGCTGTGATCTCAGCTGACTCCATGGCACACTAGCCTGAGGCAACAGACTGAGACTATATCTCAAAACAAAAA","AGCTACTCAGGAGGCTGAGACAGGGAGAGTCACTTGAACCCAGGAGGCAGAGTTGCAGTGAGCCGAGATCACGCCAACTGCACTCCATGCCTGGGCAACAGAGTGAGACTCCGTCTCAAAAAAAAA"
"GL873552","15010293","15010428","chr1","29437872","29437991","29","14427579","GGCCGGGCGTGGTGGCTCACGCCTGTATTCCCAGCGCTATGGGAGGCCGAGGCGGGTGGATCACCTGTGCTCAGAGGTTCGAGACCAGCCAAGACCCCCCTGAGCCAAACGAGCCAGAGTGAGACCCCGTCTCTAC","GGCCGGGCGTGGTGGCTCACGCCTGTAATCCCAACATTTTGGGAGGCCAAGGCGGGTGGATCACCTGAGGTCAGAAGTTCGAGACCAACCTGGCCAACATGGTGAAACCCCTGTCTCTAC"
"GL873553","860627","860695","chr1","16024119","16024187","13","15163492","GCCAGGCTCAGTGGCTCACGCCTATAATCTTAGCGCCTTTTGGAGGCCAAGGTGGGGGGATTACCTGAG","GGCCAGGCACGGTGGCTCACGCTTGTAATCCCAGCACTTTGGGAGGCCGAGGAGGGTGGATTACCTGAG"
"GL873553","7206820","7206939","chr3","156098583","156098705","38","148891763","AGCTAGGTATGGCAGCTGACATCTGTAACCCTAGCCCTCTGGCAGGCCAGGAATTCAAGACCAGCCTAGACAACATAGTAAGACCCCATCTCTACCAAAAATAATTTAAAATTGGCCAGG","GGCTGGCTGTGGTGGCTCACACCTGTAATCCCAGTACTTTGGATCATGTGAGGTCAGGAGTTCAAGACCAGACTGACCAACATGGTGAAACCCTGCCTCTACTAAAAATACAAAATTAGCCAG"
"GL873553","10985147","10985407","chr12","94325498","94325767","64","83340351","GGCCTGTGGCAGTGGCTCATGCCTGAAATCCTAGCACTCTGGGAGGCTGAGGTGGGTCGATTACCTGAACTCACCAAGACGGAGACCTCATCTCTACTAAAAATAGAAAAACTAGCTGGGCGTGGTGGCAGGTGCCTGTAGTCCCAGTTACTGGGGAGGCTGAGGCAAGAGAATTACTTGAACCCAAGAATTTGAGGTTGCTGTGAGCTATGATGCCACAACACTCTACTCAGGGTGACGGAATAAGACCCTGTCTCAAAA","GGCCGGGTGTGGTGGCTTATGCCTGTAGTCCCAGCACTTTGGGAGGCCGATGGGGATGGATCACCTGAGGTCACTGGCCAACACAGAGAAACCCCATCTCTACTAAAAATACAAAAATTAGCCAGGCGTGGTGGCATGTGCCTATAATCCCAGCTACTTGGGAGGCTGAGGCAGGAGAATCACTTGAACCCGGTAGGCAGAGGTTGCAGTGAGCCGAGATTGTGCCACTGCACTCCAGCCTGAGTGACAGAGCAAGCCTCTGTCTCAAAA"
"GL873553","10985438","10985466","chr16","73760336","73760365","6","62774898","CATAAAAAGAAAGAAAACTGAAAAGAAAA","GAAAGAAAGAAAGGAAAAGAGAAAAGAAAA"
"GL873553","12443178","12443505","chr1","3864926","3865253","98","8578252","GCAGGGTGGGGAGGCTCGCACCTACATCCCCAGCACCCTGGAAGGCTTAGGCAGGTGGACTGGGTTCAGGAGTTGGAGAGCAGCCTGAGCAATAGTGAGATTCTGTCTGCAGTAAAACTAGAAAAATTATTTAGGGGTTGTGCTGGGTGCCTATTATCCTAGCTACTGTTGAGGCAAGGGGACAGCTTGAACCCAGGATTTTCAGGTTTCTGTGAGCTAGGATGATGCCATGATGACCCTCTGACACTTTGCCTGGGCAGTAGAGTGAAACTCTGTCTCAGAAAAAACAAAACAAAACAAAACAAAACAAACAAACAAACGAAAAAAA","GGCCAGGCGTGGTGGCTCACACCTGTAATCCCAGCACTTTGGGAGGCTGAGGCAGGTGGATCACCTGAGGTCAAGAGTTCAAGACCAGCCTGGCCAACATGGTGAAACTCTGTCTCTACTAAAAATACAAAAATTAGCCGGGCATGGTGGTGCATGCCTGTAATCCCAGCTATTCGGGAGGCTGAGGTAGGAGAATAGCTTGAACCCGGGAGGTGGAGGCTGCAGTGAGCTGAGATCATGCCATTGCACTGTAGCCTGAGCAACAGAGAAAGACTCTGTCTCAAAAAACAAAACAAAACAAACAAAAGAACAAAAACAAACAAACAAA"
"GL873553","15121135","15121247","chr1","111354387","111354508","21","96233252","GGGCGTGGTGGCTCACACCTGTAATCCCATCACTTGGGAGGCTGAGGCAGGTGGATCACCTGACCTCAGGAGTTCGAGACCAGCCTGAAGAAGAGTGAGACCCCGTCTCTAAA","GGCCGGGCGTAGTGGCTCACACCTGTAATCCCAGCACTTTGGGAGGCCGAGGCGGATGGATCACCTGAGTTCAGGAGTTTGAGACCAGCCTGACCAAAGTGGTGAAACCCCGTCTCTACTAA"
"GL873553","15121274","15121455","chr7","68420775","68420939","69","53299501","AGATTTCAACAGGCCTAATGGCTTTAGTATATAAAGAGAACTTATAAAGCCAGACTCAGTGGCTTACATCTATAATCCAGGTACTTGGTAGGTTGAAGTGAGAAGATTCTTTGAGCCAGGATTTCCAGCCCAGCCTAGGCAACACAGAGAGACCCCCATCTCTAAAAGAGAAAGGTAAAAAA","GGCTAAAGGGGTGCTCATCTTAAGAATACCAGGCCAGGCGCAGTGGCTCATGCCTGTAATCCTAGCATTTTGGGAGGCTGAGGCGGGTGGATCACCTGAAGTCAGGTGTTTGAGACCAGCCTGAACAACATAGTGAGACCTCATCTCTAATTAAAAAAAGAAAAA"
"GL873553","15614197","15614298","chr4","71691062","71691163","34","56076865","GGTGGCTCACACCTGTTATCCCCATACTCTGGGGGCCTGAGGTGAGAGGATCCCCAGAAGTCAGGAGCTGGAGAGAAGCCTGTGTAAGAGTAAGAGCCAGTC","GTGGCTCATGTCTGTAATCCCAGCACTTTGGGAGGCCGAGGTCGGTGTATCATTTGAAGTCAGGAGTTTGAGACCAGCCTGGCCAACGTGGTGAAACCCTGT"
"GL873553","16849767","16850040","chr1","96770987","96771267","68","79921220","GGCCAGGAGTGGTGGCTCATGCCTGCAATCCCAGCACTTGGGAGGCCAAGGTGGGTGGATTGCCTGAGCTCACAGGTTCAAGACCAGCATGAGCCAGAGAGAGACCTTGTCTCTAAAAATAGGCACAGGTTGTGGTGGGCACCCGTAGTCCCAGCTACTTGGGAGGCTGAGGCAAGAGAATCACTTAAGCCCAGGAGTTTGAGGTTGCTGTGAGCTAAGACACCACAGCACTCTACCAAGGGTGACAAAGTAAAACTCAGATTTTTTTAAAAAA","GGCCAGGTGTGGTGGCTCACAGCCTGTAATCCCAGTAGTTTGGGAGGCCGAGGTGAGCAGATCACCTGAGGTCAGCAGTTCGAGACCAGCCTGGCCAACATGGCAAAACCCTATCTCTACTAAAAGTACAAGGTGTGGTGGCACACACCTGTAGTCCCAGCTACTTGGGAGGCTGAGGCAGGAGAATCACTTGAACTCCAGAGGTGGAGGTTGCAGTGAGCCAAGATTATGCCACCGCATTCCAGCCTGGGTGACAGAGTGAGACTCCGTCTCCAAAAAAA"
"GL873554","511555","511741","chr6","166828248","166828429","56","166316693","GTGGGACCCGCATCTATACTAAAAATGAAAAACTAGTCAGACTTGGTGACTCATGCCTATAATTTCAGTTTCTTGGGAGGTGAAGGCAGAAGAATTGCTTGATCCCAGGAATCTGAGATTGCTGTGAGCTAGGCTAACACTATGGCACTCCAGCCCAGCTGACAGAGTAAGACTTTGTCTTTAAAAA","ACCCCATCTCTACTGAAAATAGAAACATTAGCCGGGCTTGGTGGCATGCGCCTGTAGTCCCAGCTATTTGGGAGGCTGAGGCAGGAGAATTGCTGGAACCCAGGAGGCAGAGATTGCAGTGAGCGGAGATCATGCCATTGCACTCCAGCCTGGGCGACAGAATGAGGCTCCATCTCAAAAAA"
"GL873554","2046660","2046725","chr8","51862362","51862427","7","49815702","GGCTGGCCGCGGTGGCTCACGCCTGTAATCCTAGCACTCTGGGAGGCCGAGGCAGGCAGATCACCT","GGCCGGGCACGGTGGCTCACACCTGTAATCCCAGCACTATGGGAGGCCGAGGCAGGTAGATCACCT"
"GL873554","2580766","2581036","chr13","93262937","93263229","81","90682171","GGCCTGGGCAAGGTGGCTCACTCTCTGGAAGGCTGAGGCAGATGGATTGCCTGAGCTCAGGAGCTAGAGACTAGCATGATCTCACCTCTACTAAAAATAGAGAAACTAGCCAGGCATTACAGCACACGCTTGCAGCCCCAGCTACTCTGGGGGCTGAGGCAAAAGGATCACTTGGACTCAAGAAACTGAGGTTCCTGTGAGCCATGATGCCAGGACACTCTACCCAGGGAAACAGAGTGAGACTTCATCTCAAAAAAAAAAAGAAAGAAAA","GGCTGGGTGCAGTGGCTCACGCCTGCACTTTGGGAGGCCAAGGCAGGTGGATCACCTGAGGTCAAGAGTTTGAGACCAGCCTGGTCAACATGGTGAAACCCCATCTCTACTAAAAATACAAAAATTAGCCAGGCATGGTGGCACGTGCCTGTAATCTCAGCTACTCTGGAGGGTGAAGCAAAAGAATCACTTGAACCCAGGAGGCAGAGGTTGCAGTGAGCCAAAATCATGCCACTGCACTCTGGCCTGGGCAACAGAGTGAGACTCCATGTCAAAAAAAAAAAAAAAAAAAA"
"GL873554","5465741","5465829","chr11","47014803","47014890","15","41549062","GGCCAGGCATGGTGGCTCACGCCTGTAGTCCCAGCGCTGTGAGAGGCCGAGGCGGGTGGATCACCTGTGCTTAGAGGTTCGAGACCAGC","GGCCGGGCACCGTGGCTCACGCCTGTAATCCCAGCACTTTGGGAGGCCAAGGCGGGTGGATTACCTGAGGTTAGGAGTTCGAGACTAG"
"GL873555","8807785","8807956","chr1","12240468","12240612","48","3432683","GGCCGGGCGTGGTGGCGCACGCCTGTAGTCCCAGCGCTATGGGAGGCCGAGGCGGGTGGATCACCTGAGCTCAGAGGTTCGAGACCAGCCAAGACCCCCCTGAGCCAAACGAGCCAGAGTGAGACCCCGTCTCTACAACAACAACAGGACAACAAAACAGCCGGACCTTGTG","GGCCGGGCGCGGTGGCTCATGCCTGTAATCCCAGCACTTTGGGAGGCTGAGGCGGGTGGATCACCTGCGGTCAGGAGTTCGAGACCAGCCTGGCCAACGTGGTGAAACCTCATCTCTACTAAAAATATAAAAATTAGCTGGTGTG"
"GL873555","8828420","8828440","chr3","5439989","5440005","4","3388431","ATAATAATAATAATAAATTAG","ATAATAATAAAATAAAA"
"GL873555","12399534","12399604","chr15","102111398","102111458","22","89711864","GGCCAGGCATGGTGGCTCACACCTATAATCCTGGGAGGCTGAGGATTATCTGAGCTCAGGGATGTGAGACC","GGCCAGGCACGGTGGCTAAGGCCTGTAATCTGGGAGGCTGAGATGGGTGGATCACCTGAGG"
"GL873555","12440877","12440963","chr19","21209507","21209590","24","8768630","GTGGGGAGTGCACCTGAACTTTGGAGTTCAAGACCAGCCTGGGCAACATTGTGTGAGCCCTGTCTCAATTGGAAAACAAAACAAAAA","AGGTGGGCAGATCACCTAAGGTCAGGAGTTCAAGACCAGACTGGCAAAAATGGTGAAACCCTGTCTCTACTAAAAATAAAAAAA"
"GL873555","13094462","13094529","chr1","100916857","100916922","22","87822395","GCTTGTACCTATAATCCTGGTACTTTGGGAGCCTCAGGAGAGTGGATCACCTGAGTAAGAGCAAGACC","CATGCCTGTAATCCCAGCACCTTGGGAGGCCAAGGTGGGTGGATCACCTGAGGTCAGTAGTTTGAG"
"GL873555","13254579","13254784","chr7","32729330","32729532","64","19474751","GACCAATCTAAGCCAGAGCTGTCTATGCTAAAAATAGAATAATAAGCCTGGTTTATGGTAGGAGCCTGTAGTCTCAGTTACCTGGGTGTCTGGGGCAAGAGATTGACTTAAAACCAGGAGTTTGAGGTTGCTGTAAGCTAGGCTGACACCACAATACTCTAATCTGGGCAGAGTGAGATTCTGTCTCAAAAAAAAAAAGAAAGAAA","GAAACCCCATCTCTACTAAAAATACAAAATTAGCCAGGCATGGTGGTGCACACCTGTAGCTCCAACTACTTGGGAGGCTGAGGCAGGAGAATCACTTAAACCCAGGCAGTAGAGGTTGCAGTAAGCCAAGATCGCACCACTGCACTCCAGTCTGGGCAACAGAGTGAGACTCTGTCTCAAAAAAAAAAAAAAAAAAAAAAAAA"
"GL873555","13255065","13255153","chr10","29045352","29045442","23","15790287","CTGGGCACAGTGGCTGAGGGTGTAATCCTACCACCCTAGGAGGTTGAGGCAGAAGGATCACTTGAGCTCAGGAATTCAATACAAGTCTA","GGCGGGGCACAGTGGCTCATGCCTGTAATCCTAGTACTTTGGGAGGTCGAGGCGGATGGATCATCTGAGGTCAGGAGTTTAAGACCAGTCT"
"GL873555","13262783","13262918","chr1","29437872","29437991","30","16175089","GGCCGGGCGTGGTGGCGCACGCCTGTAGTCCCAGCACTATGGGAGGCTGAGGCGGGTGGATCACCTGTGCTCAGAGGTTCGAGACCAGCCAAGACCCCCCTGAGCCAAACGAGCCAGAGTGAGACCCCGTCTCTAC","GGCCGGGCGTGGTGGCTCACGCCTGTAATCCCAACATTTTGGGAGGCCAAGGCGGGTGGATCACCTGAGGTCAGAAGTTCGAGACCAACCTGGCCAACATGGTGAAACCCCTGTCTCTAC"
"GL873556","639117","639366","chr1","62410822","62411038","72","61771705","GGCCGGGTGTGGTGGCTCATGCCTGTTGTCCCAGCACTGTGGGAGGCCAAGGCAGGTGGATCGCCTGAGCTCAGCCAAGTTCGAGACCAGCGGAAGACCAGCATGAGGCACAGTGAGCCAGAGTGAGACCCTACCTCTACAAAACAACAACAACAACAAAAAACCCAGCCAGATGTTGTGGCAAGTGTCTGTAATCCCAGCTACATGAGGGGCAAGAGGGCAAGAGAATCACTAAAGGAGGAAGAAGTAA","GGCCGGGCGTGGTGGCTCACACCTGTAATCCCAGCACTTTGGGAGGCCAAGGTGGGTGGATCTCCTGAGGTCAGGAGTTCGAGAGCAGCCTGGCCAACATGGTGAAACCCTGTCTCTACTAAAATACAAAAATTAGCCAGGTGTGGTGGCACGTGCCTGTAATCCCACCTACTCAGGAAGCTGAGGCAGGAGAATCACTTAAAGCTGGGAGAGAGAG"
"GL873556","639390","639468","chr20","16893610","16893664","30","16254220","ACTTCAAACTAAGATAAAGTGAAAGTCAGCAGAAATTGAAAGCAAAAACAAAAACAAAAAAAAAAAAAAAAAAAAAAGA","AACAAAACAAAACAAAACAAAACAAAACAGACAAAAAAAAAAAAACAAAGAAAAA"
"GL873556","2031445","2031493","chr13","87950184","87950229","13","85918739","AGACCCTATCTCTACTAAAAATAGAAAAACTAGCCCAGTATAGTGATGC","AAACCCCATCTCTAGTAAAAATACAAAATTAGCTGGGTGTGGTGGC"
"GL873556","6655305","6655664","chr2","190010230","190010561","107","183354925","GGCCAGGCATGGTGGCTCACACCTGTAATCCTAGCACTCTGGAAGGCCAAGGGAGGTGAATTTCTTGAAGTTCGAGATCAGCCTAAGAGGAATGATACCCCACCTTTACTAGGAATAAAAAAAAAAAAAAAAAAAAACCCAAAACTAGCCTGGCATTGTGGCAGTTCTCTGTAATCCAAGCTACTTGGGAGGCTGAGGTAGAAGGATTGCTTGAACCAAAGAGTTTGACTAGAGGTTGCTGTGAGCTAGGCTAATGTCACCACACTCTATCCAGGGCAAGTGAGTGAAACTCCGTCTCAAAATAAATAAATAAATAAATAAATAAGTAAGAAAAACTTTTGCCCATAAAAAAAAAAAGAA","GGCCGGGCGCGGTGGCTCACACCTGTAATTCTAGCACTTTGGAAGGCTGAGGTGGGTGAATTGTCTGAGCTCAGAAGTTCGAGACCAGCCTGGGCAACACAGTGAAACCCCATCTCTACTAAAATACAAAAAAAAAAAAAAATTAGCTGGGCATGGTGGTGTGCACCTGTAGTCCCAGCTACTCAGGAGGCTGAGGCAGGAGAATTGCTTGAACCCAGGAGGCAGAGGTTGCAGTGAGCTGAGATCACGCCACTACACTCCAGCCTGGGCAACAGAGTGAGACTCCACCTCTTTAAAAAAAAAAAAAAGAAAGAAAGAAAGAAAGAAAGAAA"
"GL873556","10802692","10802792","chr20","28544296","28544376","36","17741604","TACAAAGAAATATCATTATTGGCCAGGTGCAGTGGTTCACATCTGTAATTCTAGTACACTAGTACTCAGGAGGATCACTTGAGGTCAGGAGCTTGTGACCA","TAGAAATGCACAATTCACCTGGGCACGGTGGCTCACTCCTGTAATTCCAGTACTTTGGGAGGCATGAGGTCAGGAGTTCAA"
"GL873557","1682363","1682659","chr6","13352322","13352625","72","11669959","GGCCAGGTGTCGTGGCTCAGGCCTGTAATCCCAGCATTCTGGGAGGCTGAGGTGGGTGGATTGCCCTGAGGTCACAGGTTCCAGACCAGCCTGAGCAAGAGCGAGACTCCATTTCTAATAAAATAGCCGGGTGTTGTGGTAGGTGCCTGTAGTCCCAGTTACTCGGGAGGCTGAGACAAGAGAATCATTTGAACCCAGGAATTTGAGGTTGCTGTGAGCTGTGATGCCACAGGACTCTACTGAGGGCAATAAAGTGAGACTGTCTCAAATAAACAAACAAACAAACAAAAACAAAAA","GGCCAGGTGTGGTGGCTCAGGCCTGTAATCCCAGCACTTTGGGAGACTGAGGTGGGCGGATCACCTGAAGTAAGGAGTTCAAGACCAGCCTGGCCTACATAGTGAAACCCCATCTCTACTAAAAATACAAAATTAGCTGGGTGTGGTGGCACGTGCCTGTAGTCCCAGCTATTCGGGAGGCTGAGTCAGGAGAATCACTTGAACCCAGGATGGGGAGGTTGCAGTGAGCCGAGATCACACCACTGCACTCCAGCCTTGGCAACAGATTGAGACTCTTTCTCAAAAAAAAAAAAAAAAAAAAAAA"
"GL873557","2465751","2465841","chr16","4764895","4764982","15","2299144","GGCCGGGCTTGGTGGTTCACGTCTGTTGTCCCAGCACTGTGGGAGGCCGAGGCAGGTGGATCACCTAAGCTCAGCCAAGTTCGAGACTAGC","GGTCGGGTGTGGTGGGTCACGACTGTAATCCCAGCACTTTGGGAGGCCGAGGCAGATGGATCACCTGAGGTCAGAAGTTCGAGACCAG"
"GL873557","4047834","4047915","chr12","77852792","77852880","22","73804958","ACAAGAGGTTGCTTTGAACTGTGATGCCACAGAGCACTATCCTGGGCAACAGAGACTCTGTCTCAAAAAAAAAAAAAAAAAA","CAGAGGTTGCAGTGAGCTGAGACTGTGCCACTGCACTCCAGCCTGCGCGACAAGAGTGAGACTCTGTCTCAAAAAAAAAAAAAAAAAAA"
"GL873557","4048202","4048390","chrX","23681445","23681631","42","19633243","GGCTGGGTGTGGTGGCTCACACCTGTGATTCTAGCACTCTGGGAGGCCAACGTGGGCAGATCACCTGAGCTTAGGAGTTCAAGACCAGTGTGAGCAAAATGAGACCCCGCCTCTACTAAAAATAGAAAAACTAGCCAGGCACTGTGGTGGGTGCCTATCATCCCAGCTACTCAGGAGGCAGGCAAGAGG","GGCCAGGCGTGGTGGCTCACGCCTGTAATCCCAGCACTTTGGGAGGCCGAGGTGGGTGGATCACCTGAGGTCAGGAGTTCAAGACCAGCCTGGCCAACATGGTGAAACCCCGTCTCTACTAAAAATATAAAAATTAGCCAGGGTGTGGTAGTGCCTGCCTGTAATCCCAGCTACTCGGGAGGCTGAG"
"GL873557","6292327","6292620","chr19","32265157","32265444","82","25972830","GTCAGGCACGGTGGCTCATGCTTGTTGGATTATCCCAACACTCTGGGAGGCCAAGGTGGATCGATTGTCTGAGCTCTGGAGTTCAAGACCAGCCTGAGCAGAAGCAAGACTCCATCTCTAAAAAAAAATAGCTGGGCATTGTGGTGGGCACTTGTATTCCTAGCTACTTGGAAAGCCTGAGGCAAGAGGATTGCTTGAACCCAAGAGTTTGAGGTTGCTGTGAGCTTAAGATGTCACAGCACTCTATAGAGGCTGAGCAAGTGAGACTCCAAAAAGTGAGTTTCCAGAAAAAAA","GACTAGGCACTGTGGCTCATGCCTGTAATCCCAGCACTTTGGGAGGCCGAGGCGGGTAGATCACCTGAGCTCAGGAGTTTCAGACCAGCCTGAGCAACATGGCAAAACCCCATCTCTACTAAACATTAGCCAGGCATGGTGGTGTGCACCTGTAATCCCAGCTACTTGGAAGGTTGAGGCAGGAGGATCACTTGAACCTCAGGAGGCAGAGGTTGCAGTGAGCCAAGATGACATGACTGCACTCCAATCTGGGTGGCAGAGCAAGACTCTGTCTCAAAAAAAAAAAAA"
"GL873557","6324546","6324617","chr1","39656281","39656348","22","33331735","CGCCTGTTGTCCCAGCACTGTGGGAGTGTGAGTAGGGTGGATCACCTTAGCTCAGCTGAGTTTGAGACCAGC","CATGCCTGTAATCCCAGCACTTTGGGAGGTCAAGGCTGGCAAATCACCTAAGGTCAAGAGTTTGAGAC"
"GL873557","6406262","6406343","chr1","199505332","199505412","11","193099070","CAGGCGCAGTGGCTCAATCCTATAATCCCAGCACTTTGGGAGGCTGAGGCAGGTGGATTACCTGAGCTCAGGAGTTTGAGAC","CCAGGCGCAGTGGCTCACACCTGTAATCCCAGCACTTTGGGAGGCTGAGGCAGGCAGATCACCTGAGGTCAGGAGTTGGAG"
"GL873557","6417612","6417692","chr13","102319052","102319128","16","95901440","GAGGTTGCTGTGAGCTAGACTGAGGCCACAGCACTCTAGCCTGGGCAACAGAGTGAGACTGTCTCAAAAGAAAAAAAGAAA","GAGGTTGCAGTGAGCTGAGATCACACCACTGCACTCCAGCCTAGGCAACAAAGTGAGACTCCAACTGAAAAAAAAAA"
"GL873557","6903406","6903510","chr16","18967946","18968045","32","12064540","AGTGCTCTGGGAGACTGAGATGGGCAAATATCTTGAGTTTAGGAGTTCCAGACCAGCCTAAGGAAGAACAAGACCCTATCTCTACTAAAAATAGAAAAAAATTCA","CTTTGGGAGTCTGAGGCAGGTGGATCTCCTGAGGTCAGGAGTTCAGGACCAGCCTGGCCAACATGGCAAAACCCCATCTCTACTAAAAATATAAAAATTA"
"GL873557","6903779","6903930","chr3","40638454","40638604","35","33734675","TTTGCCAGGTATTGTGGTGGACACCTGTAGTCCCAGCTGCTTGGTAGGCTGAGGCAGGAGGATCACTTGACCCTAGGAATCTGATGTTGCTGTGAGCTAGGCTGATGCTACAGCACTCTAGCCTGGACAACAGAGTAAGCTTCTGTCTCAAA","TAGCTGGGTGTCATGGCACACGCCTGTAGTCCCAGCTACTTGGGAGGCTGAGGCAGGAGAATCTCTTGAACCTGGGAGGCAGAGGTTGCAGTGAGCTGAGATCACGCCACTGCACTCCAGCCTGGGCAACAGAGTGAGACTCCGTCTCAAA"
"GL873557","8133022","8133316","chr19","42881134","42881434","76","34748112","GAGTGCAGTGGCTCACACCTGTAATCTTAGCACTCGAGAGGCTGAGGCAGGTGGATTGCCTGAACTCACAGCTTCGAGACCAGCCTGAGCCAGAGCAAGACCTCATCTCTAAAAATAGCCAGGAGTTGTGGCAGGCGCCTGTAGTCCCAGCTACTTGGGAGGCTGAGCAAGAGAATCGCTTGATCTCAGGAGTTTGAGGTTTCTGTGAGCTAAGACACCGCAGCACTCTACCAAGGGTGACAAAGTAAGACTCTGTCTCAAAAAATAAATAAATAAATAAATTATAAGAAAAAGA","CCGGGCAAGGTGGTTCACACCTATAATCCTAGCACTTTGGGAGGTCGAAGTGGATCGCCTGAGGTCAGGAGTTAGAGACCAGCCTGGGCAACATAGCAAAACCCCATCTCTACTAAAAATAGAAAAACTAGCCAGGTGTGGTGGCGCCTGTAATCCCAGCTACTCGGGAGGCTGAGGCAGAAGAATCGCTTGAACCCAGGAGGCAGAGGTTGCAGTGAGCTGAGATCGCACCACTGCACTCCAGGGTGACAGAGCAAGACTCTGTCTCAAAAAAAAAAAAAAAAAAAAAAAAAAAAAAAAA"
"GL873557","8171663","8171835","chr7","151280672","151280824","61","143109009","TTAGCCAGGCACTGTGCTCCCAGCTACTAGGGAGGCTGAGGCAAGAAGAGGATCACTTGGCTCGGCGCCTGTGACTCAAGTGGCTAAGGTGCCAGCCACATACACCTAAGGTGGAGGGTTCTCTACCCAGAGGGACAGCTTGAGGCTCCATCTCAAACAAAAAAAAAAGAAGA","TGGTATGCACCTGTAATCCCAGCTACTTAGGAGGCTGAGGCATGAGAATCACTTGAACCCAGGAGGTGGAACTTTTAGTGAGCTGAGATTGCACCACTGCATTCCAGCCTGGGCAACAGAATAAGACTCTATCTCAAAAAAAAAAAAAAAAAA"
"GL873557","8172121","8172252","chr11","123260550","123260686","30","115088429","CTGGGCATGGTGGCTCATACCTATAATCCTAGGACTTTGGTAGGCCGAGGCAGGTGGGTTGCTTGAGCTTAGAAGTTGAAGACCAGCCTGAACAACAGCAAGACCTTTCCCTACTCAAAACAGAAAAACTAT","GGCTGGGCAGGGTGGCTCATGCCTATAATCCCAGCACTTTGGGAGGCCAAGGCGGGTGGGTCACCTGAGGTCAGGAGTTCGAGACCAGCCTGACCAACATGGTAAGATCCCCTCTCTACTAAAAATACAAAAATTAA"
"GL873557","8260873","8260977","chr1","62231025","62231129","22","53970152","GGCTGGGCATGGTGGCTCACGCCTGTTGTCCCAGCCCTGTGGGAGGGTGAGGCAGGTGGATCGCCTGAGCTCAGCCGAGTTCGAGACCACTGGAAGACCAGCATG","GGCTGGGCATGGTGGCTCACGCCTATAATCCCAGCACTTTGGGAGGCCGAGGCAGGTGGATCACCTGAGATCAGGAGTTTGAGACCAGACTGGCCAACATGGTGA"
"GL873557","10032878","10033040","chr9","27037847","27038008","36","17004969","GGGGGTGGTGGCTCACACTTGTAATACCAGCTACTCTGGAGGCCGAGGCAGGAGAATCATATGAGCCCGGAAGTCTGAGGTTGTTGTGAGCTGGGTTAATGCCCCTGCACTCTAGCCTGGGCAACAGAGTGAGACCATGTCTCAAGGAAATAAAAAAAAAAAA","TTAGCTGGGCATGCTGGCACACACCTGTAATGCCAGCTACTCAGGAGGCTGAGGCAGGAGAATCACTTGAGCCCGGGAGGTGGAGGTTGCAGTGAGCTGAGACAGTGCCACTGTATTCTACCCTGGGCAACAGAGTGAGACTGTCTCAAAAAAAAAAAAAAA"
"GL873557","10366578","10366655","chr17","24597444","24597521","20","14230866","GCCAGGCGTGGTGGCTCATGACGGTAATCCCACCTACTCAGGAAGCAGAGGCAGGAGAATCACTTGCGCCTAGGAGAC","GGCCAGGCATGGTGGCTCATGCCTGTAATTCCAGCACTTTGGGAGGCCGAGGCAGGTGGATCACTACGTCAGGAGTTC"
"GL873557","12031816","12031985","chr11","55022806","55022982","46","42990990","TAGAAAAACTAGCCAGGCATTGTAGCGGGTGCCTATAGTTTCAGCTACTCTGGAGACTGAGACAAGATTGCTTGAGCCCGGGAATTTGAGGTTGCTGTGAGCTATTATGCCACAGCACTCAATACAGGACAATTGAGTGAAACTCCAGTCTCAAAAAAAAAAAAAAAAAA","CAAAAATTAGCCAGGCAGGGTGGTGGGCGCCTGTAGTCTCAGCTACTGGGAAGGCTGAGACAGGATAATCACTTGAACCCGGGAGGCGGATGTTGCAGTGAGCCGAGATCATGCCACTGCACTTCAGCCCGGGCAACGAGAGTGAAACTCCGTCTCAAAAAACAAAATAAAATAAAA"
"GL873557","12032023","12032144","chr1","111354387","111354508","23","99322364","GGTCAGGTGCAGTGGCTCACATCTGGAATCCTAGCACTCTGGGAGGCCGAGGAGAATGGATCCCCTGAGCTCAGGAATTCAATATCAGCCTGAACAAGTGTGAAACCTCCATCTCTACTTAA","GGCCGGGCGTAGTGGCTCACACCTGTAATCCCAGCACTTTGGGAGGCCGAGGCGGATGGATCACCTGAGTTCAGGAGTTTGAGACCAGCCTGACCAAAGTGGTGAAACCCCGTCTCTACTAA"
"GL873557","14208944","14209036","chr7","158031905","158031997","26","143822961","GGATGTGGTAGTTACTGTTTGCTATGATGACAACACTGCACTCTAACTCTGGGTGACACAGTAAGATTCTATCTCAAAACCAAAATAAAACAA","CCAGGAGGTGGAGGTTGCAATGAGCCAAGATCACACCACTGCACTCCAGCCTGGGTGACAGGGTGAGATTCTGTCTCAAAAAAAAAAAAAAAA"
"GL873558","2159034","2159070","chrX","41233833","41233871","7","39074799","ATTAGCCAGGTGTGGTGGCTTTTGCCTGTAATCCCAG","AAATCAGCCGGGTGTGGTGGCTCACGCCTGTAATCCCAG"
"GL873558","3486850","3487074","chr5","91338665","91338874","72","87851815","GGCCAGGCATGGTGGCTCATGCCTGTTGTCCCAGTGCTGTGGGAGGCCGAGGCAGGTGGATCGCCTGAGTTCAGCCAAGTTTGAGACCAGTGGAAGACCAGCATGAGGCAGAGTGAGCCAGAGTAAGACCCCATCTCTACAACAACAAAAAAAAAAAACAAAAAAAACAGCCGGACGTTGTGATCCCAGCTACATGGTGAGGGGGAGGGGAACAGGAGAATCACT","GGCCGGGCATGATGGCTCATGCCTGTAATCCCAGCACTTTGTGAGGCCGAGGCAGACTGATCACTTGAGGCCAGGAGTTCGAGACCAGCATAGCCAACAAGATGAAACACCATCTTTACTGAAAATACAAAAAAAAAAAAAAATAGCCGGATGTGGTGATACCTGCTTGTAATCCCAGCTGCTTGGGAGGCTGAGGCAGGAGAATCTCTT"
"GL873558","3884156","3884240","chr4","24638016","24638099","18","20753860","CCAGACACAGTGGCTTAAGCCTGTAATCCTAGCACTTTGGGAGGCTAAGGTGGATGGATCTCCTGAGCTCAGTAGTTTGAAGCTA","GCCAGGCATGGTGGCTCATGCCTGTAATCTTAGCACTTTGGGAGGCCAAGGTGGGCGGATCATCTGAGGTCAGGAGTTTGAGAC"
"GL873558","5037604","5037746","chr3","2138380","2138521","38","2899224","GCTGGGCCTGGTGGCTCACATCTGTAACCCTAACACTCTGGGAGGCCAAGGCAGGAGGATCTCTTGAAGCTAGGTTGTTAGCCAGGGCGACCCCACAGCACTCTAGCCTGGGGCAACAGAGTGAGACTTTGTCTCCAAACAAA","AGCTGGATGTGGTGGCCCACACCTGTAATCACAGCTACTCGATAGGCTAAGGCAGGAGAATCGCTTGAACCTGGGAGGCGGGGACTGCACCATCACAGCACTCCAGCCTGGGTGACAGAGTGAGACTATGTATCAAAAAAAA"
"GL873558","6488648","6488700","chr3","39516725","39516768","23","33028077","ATAGCACTCTACCATGGGTGACAGAGTGAGACTATCTCCCCCCCTCAAAAAAA","GAGACCAGCCTGACCAACACAGTGAAACCTCATCTCTACTAAAA"
"GL873558","6489359","6489583","chr10","19070944","19071172","64","12581585","GGCTGGACATGGTGGGTCCTGTAATCCTAGCACTGTGGGAGGCCGAGGCAGGTGAATTGCTTGAGCTTATGGGTTCAAGACCAACCTGAGCCAGAAGGAGACCTTGTCTCTAAAAATGGCTGGGTGTTGTGGCAGGCACCTATAATCCCAGCTACTTGGGAGGCTGAGGCAAGAGAATCGCTTGAACCCAAGAGTTTGATGTTGCTGTCAGCTAAGATGCCATAG","GGCTGGGCTCAGTGGCTTATGCCTGTAATCCCAGCGCTTTGGGAGGCCAAGGCGGGTGGATCACCTGAGGTCAGGAGTTCGGGACCAGCCTGAACAACATGGTGAAATCCCGCCTCTACTAAAAAAAAGCCGGGTGTGGTGGCATGCACCTGTAATCCCAGCTACTTGGGAGGCTGAGGCAGGAGAATCACATGAACCTGGGAGGCAGAGGTTGCAGTGAGCTGAGATC"
"GL873558","14631848","14632045","chr18","1878493","1878704","62","12753355","GGTGCAGTGGCTCACGCCTTTAATCCCAGCACTTGGGATGGTGAGGCAGGTAGATTGCCTAAGTTCACAGGTTCAAGACCAGCCTGAGCCAGAGAGACCCTACCTCTAAAAAATAGCCAAGCATTGTGGCAGGCACCTGTAATCCTACTTAGGAGGCTGAGTCAAGAGGATCATTTGAGCTTAAGAGTTAGAGCTTGT","GGCCAGGCATGGTGGCTCACGCCTGTAATCCCAGCACTTTGGGAGGCCGAGGCGGGTGGATCACAAGGTCAGGAGTTCAAGACCAGCCTGGCCAACATGGTGGAAGCCCATCTCTACAAAAAATTAACTGGGCGTGGTGGCAGGCACCTGTAATCCCAGCTACTTGGGAGGCTGAGGCAGGGGAATTGCTTGAACCTGGGAGGCGGAGGTTG"
"GL873558","14632352","14632392","chr7","10117723","10117763","10","4514629","GAGTTAGAGCTTGCTGTGAGCTAAGATGCCACGGCACTCTA","GAGTTAGTTGCAGTGAGCTGAGATCGTGCCACTGCACTCCA"
"GL873559","8193331","8193614","chr20","11734223","11734512","71","3540892","CAGGTACGGTGACTTATCCCTGGAATCTTAGAACTGTCTGAGTCCAAGGTGGGAGGATCATTGGAGGTCAGGAATTTGAGACCAGCCTGAGCAAGAGTGAGACCTCTTCTCTACTAAATATAGAAAAATTAGCCAGGGTTTGTGGCAGGTGCTTATAGTCTAAGCTTCTTAGGAGGCTGAGGCAGGAGAATCTCTTGAACCCATGAGTCTGAGGTTGCCCTGAGTTAAGATGACATCACTGCAGTCTCCCCAAAGCAACGGAGTAAGACTCTGTCTCAAAAACA","GGCCAGGCACGGTGGCTCATGCCTCTAATCCCAGCATGTTGGGAGGCCGAGGTGGGCGGATCACATGAGGTCAGGAGTTTGAGACCAGCCTGGCCAACATAGTGAAACCCTGTCTCTACTAAAAATACAAAAATTAGCCAGGTGTGGCAGCACGTGCCTGTAGTCCCAGCTAGTCAGGAGGCTGAGGCAGGAGAATCACTTGAATCCACCAGGCGGAGGCTGCAGTGAGCCAAGATCACACCACTGCATTCCAGCCTGGGCGACAGAGCAAGACTCTGTCTCAGAAAAAA"
"GL873559","8193642","8193657","chrX","1083699","1083714","0","7109943","AAATAAATAAAATAAA","AAATAAATAAAATAAA"
"GL873560","393252","393440","chr11","121440472","121440639","55","121047220","CTGGGCAGGGTGGCACACACCTGTCATCCCAGCATGTTGGGAAGCTGAGGCAGGAGAATTACTTGAGCTCAGATTCCAAGAGGTGAGGATCACTTGAGCCTAGAAGTTGAGGCTGCACTGATGCCCCAACACTCCAGCCTGGGCAACAGAGCAAGGTCCTGTCCCAAAAAGAAAAAAAGAAAAGGAAAA","GCTGGGCGCAGTGTCTCACGCCTGTAATCCCAGCTATTTGGGAGGCTGAGGCAGGAGAATTACTTGAACCTGGGAGGTGGAAGTTGCAGTGAGCCGAGATCCTACCATCGCACTCCAGTCTGGGCAACAAGAGCAAAACTCTGTCTCAAAAAAAAAAAAAAAAAAAAA"
"GL873560","4038833","4039014","chr12","78258009","78258208","56","74219176","GGCTGGGTGCGGTGACTCACACCTGTAATCCCAGCACCTGGAGGCCCAAGGCAGGGTGGATTGTCTGAGCTCACAGGTTCAAGACCAGCCTGAGCCAGAGCGAGACCTAAAAATAGCTAGGCGCTGTGGGAGGCACACGTAGTCCCAGCTACTCAGGAGGCTGAGGCAAGAGAATCACTTGA","GGCTGGGCACGGTGACTCACGCCTGTAATCCCAGCACTTTGGGAGGCCCAGGTGGGTGGATCACCTGAGGTCAGGAGTTCAAGACCAGCCTGGCCAAGATGGTGAAACCCCGTCTCTACTAAAAATACAAAACTTAGCTGGGCATGGTGGCGGGCACCTGTAATCTCAGCTAGTCGGGAGGCTGAGGCAGGAGAATCTCT"
"GL873560","4492531","4492643","chr7","56485655","56485756","37","51993124","AACAGAAAAACTAGCCAGGCATAGTGGTGCATGCCTGTTGTTCCAGCTGCTCTAGAGGCTAAGGCAAGAGGATTGCTCCAGCTCAATAGTTTGAGGTTGCTGTGAGCTTGAGA","TTAGCTGGGCATGGTGGAGCACACCTGTAATTCCAGCTACTCAGGAGGCTGAGGCAAAAGAGTTGCTTGAACCCAGGAGGCAGAGGTTGCAGTGAGCCGAGA"
"GL873560","4492670","4492771","chr8","41603464","41603564","28","37110794","AGCACTCTGGGTGACTGAGGCAGGATTACTTGAGCTCAGGAGTTTATGACCAGCCTGAGCTGGTCCTTGATCAAGACTCCATCTCTACTAAAAAAACAAACA","CACTTTGGGAGGCCGAGGCAGCAGATCACTCGAGGTCAGGAGTTTGAGACCAGCCTGGCTAACATGGCAAAACCCCATCTCTACTAAAAATATAAAAATTA"
"GL873560","8106775","8106882","chr11","111878590","111878685","39","103771815","ACATAAGAATCAGGCCAAGCCTTGTGGCTCCTGTATGTGATTCCAGCACTGGGAGGGCAAGGCAGGAGGATCCCTGACGTCAGGAACTCAAGGCTGCCCAAGTATCAT","GGGCACAGTGGCTCATGCCTGTAATCCCAGCACTTTGGGAGGCCAAGGCGGGTGGATCACCTGAGGTCAGGAGTTCAAGACCAGCCTGACCAACAT"
"GL873560","10872201","10872272","chr7","9971011","9971083","11","901190","GGCTGGGCACAATGGGTCACACTTGTAATCCCAACACTTTGGGAGGCTGAGGTGGGCAGATCACCTGAGCTC","GGCTGGGTGGGGTGGCTCACACATGTAATCTCAGCACTTTGGGAGGCTGAGGTGGGCAGATCACCTGAGGTCA"
"GL873560","11043320","11043410","chr6","111928830","111928919","19","100885510","CAGGCGAAGTGGCTCATGCCTATAATCCTAGCATTCTGGGAGGCTGAGGTGGGAGAATCCCCTGAGGTCAAAAGTTCAAGACCGGCTTGGC","GGCCAGGCTCAGTGGCTCATGCCTGTAATCCCAGCACTTTGGGAGGCCGAGGTGGGTGAATCACCTGAGGTCAGGAGTTCAAGACCTGCC"
"GL873561","5890611","5890936","chr8","76222061","76222392","77","70331450","GGCTGGGCCTGGTGGCTCATGCCTATAATCCTAGCACTCTGGGAGGCAAAGGTTGGTGGATTGCTTAAGCTCAGGAGTTCAAGACCAGCCTGATTAAGAGTGAGATCCCATCTCCACTAAAAATAGAAGGGAAAAAAAAAAAAAAAAAACCTAGTTGGGCTTGGTGGCAGCACTTGTAGTCCCAGCTATTTAGGAGGCTGAGGAAAGAGAATCACTTGAACCCAAGAGTTTGAAGTTGCTCTGAGCTATGATGCCATAGAACTCTACCCAGGGTGACAGAGTAAAACTGGATCTCAAATAAATAAATAAATAAATACATAAATAAA","GGCTGGGCATGGTAGCTCATGGCTGTAATCCTAGCACTTTGGGAGGCCAAGGAAGGTGGATTGCCTGAGCTCAGGAGTTCAAGACCAGCCTGGGCAACACAGTGAAATCCTGTCTCTACTAAAATACAAAAAAGAAAAAAAAAAAAAAAAAAAACAGCTGGGCATGGCAGTGTGCACTTGTAATCCCAGCTACTCAGGAGGCTGAGACAGGAGAATCACTTGAACCCGGGAGGCAGAGGTTGCACTGAGCCGAGATTGTATCACTGCACTCCAGCCTGGGTGACAGAGCGAGACTCTGTCTCAGAAAAAAAAAAAAAAACAAAAAAACAAAA"
"GL873561","10859256","10859475","chr6","100119122","100119352","73","89259866","GGATCACTTGAGCTCAGGAGTCAAGACCAACTTGAGTAAGAGTGAGACCCTGTCTCTACTAAAAATAAAATATATAGCCAGGCATTGTGCTGGGCACCTATATATAAGCTAAAATGGAGTCTTAGCTACCTCCTTGAACTTGAACCCAGGAGTCTGAAGTTGCTTTGAGCTAGGCTGATGCCACTGCACTTTACCCAGGCAACAGAGTGAGAGTATCTAA","GGATCACCTGAGGTCAGGAGTTCAAGACCAGCCTGGCCAACATGGTGAAACCCCGTCTCTACTAAAAATACAAAAACTAGCCAGGCATGGTGGCGCACACCTGTAGTCCCAGCTACTTGGGAGGCTGAGGCAGAAGAATCTCTTGAATCCGGGGGTTGGAGGTTGCAATGAGCTGAGATCATGCCACTGCACTCCAAGCCTGGGTGACAAGAGCGAAACTCCATCTCAAAA"
"GL873561","10859563","10859576","chr4","114457728","114457741","1","103598165","AAAAAAAAATAAAA","CAAAAAAAATAAAA"
"GL873562","12189469","12189706","chr1","31551552","31551790","75","19362083","CAGTGGCTCACGCCGGTAATCCCAGCACCTTGGGAGCTGAGGCAGGCAGATCTCCTGAGGTCACGTGTTTTGAGACCAGCCTGAGCTAGAGTGAGACCCCACCTCTAAAAATAGCCAGTCGCCTGTAATCCCAGCTACTCGGGAGAAACCCAGGAGTCTAAGGTCGCTGTGAGCTGACACCTCAGCACTCTGCTGGGGTAACAAAGTGACACTTTGTCTCAAAAAAATAAATAAATAT","GCAGTGGCTCACGCCTGTAATCCCAGCACTTTGGGAGGCCAAGGCGGGTGGATCACCTGAGGTCAGGAGTTCAAGACCAGCCTGGCCAACATGGTGAAACCTCATCTCTACTAAAAATACAAAACAGGAGAATCGCTTGAACCCGGGAGGTAGAGGTTGCAGTGAGCTGAGATAGTGCCACTGCACTCCAACCTGGGCAACAGAGTGAGACTCCGTCTCAAAAAAATAAAAAATAAAAA"
"GL873562","4526861","4526913","chr13","94764706","94764759","14","90237845","GTGAGACCTTGTCACTACTGAAAATAGAAAAATTAGCTGGGCATGGTTGTAGG","GTGATGAAACCCCATCTCTACTAAAAATACAAAAATTAGCTGGGCTTGATGGTG"
"GL873562","4789223","4789313","chr10","47852509","47852598","25","43063286","GGCCAGGAGAAGTGGCTAACACCTGTAATTCCAGCACTCTAGGAGATGGAGGCAGGGACCAGCCTGAGCTAGAGTGAGTGAGACTCCATCT","GGCCAGGTGCAGTGGCTCACACCTGTAATCCCAGCAACTTTGGGAGGCTGAGGCAGGCAGATCACTTGAGGTCAGGAGTTCGAGATCAGC"
"GL873562","4868605","4868801","chr16","54069750","54069948","44","49201145","GGCCAGGCATGGTGGCTCATGCCTGTAATCCTAGCACTCTGAGAGACCAAGGCTGATGAATCACCTGAACTCAGGAGTTGAGACCAGCAGGAGCAAAAGTGAGATCCCATCTCTACTCAAAAATAGAAAATTAGTTCAGGCAAGGTGGCACATACCTGTAATCCCAGCACCCTGGGAGGCTAAGGTGGGTGGATTGC","GCCCAGCGCAGTGGCTCATGCCTATAATCCCAGCACTTTGGGAGGCCAAGGCGGGTGGATCACCTGAGGTCAGGAGTTCGAGACCAGCCTGCCCAGCATGGTGAAACCCCATCTCTGTTAAAAATATAAAAATTAGACTAGGCGCGGTGGCTCACACCTGTAATCCCAGCACTTTGGGAGACCAAGGTGGGCGGATCAC"
"GL873562","4929184","4929360","chr10","37539693","37539877","47","32610509","GGCCAAGCTCAGTGGCTCTCCCTAGCACTTTGGGAGACCGAGGTGGGTGGATTGCCTGAACTCAGGAGTTCTAGACCAGCCTGATCAAGAGCAAGACCCTACATCTACTAAAAATAGAAAAACTAGCTGGGCATTATAGTACGCACCTGTACTCCCATCTACTCTGGAGGCTGAGGC","GGGTGCAGAGGCTTATGCCTGTAATCCCAGCACTTTGGGAGGCAGAGGTGGGTGGATCACTTGAGGCCAGGAGTTCAAGACCAGCCTGGTCAATGTGGTGAAACCTCGTCTCTACTAAAAATACAAAAATTAGCCGGGCATGGTGGCATGCATCTGTAGTCCCAGCTACTTGGGAGGCTGAGGCA"
"GL873562","5446395","5446678","chr16","63692714","63692996","79","58246319","GGCTGGATGCAGTGGCTCATACCTGTCTGTAATCCTAGCACTCTGGGAGGTCGAGGTGGGTGGATTGCCTAAGTTCACAGGTTCGAGGCCAGCCTAAGCAAGAAGAGCAAGACTCCATCTCTGAAAGTAGCCAGGCATTGTGACAGGCGCCTATAGTCCCAGCTACTTGGGAGGCTGAGGCAAGAGAATTGAGCCCAGGAGTTAGAGGTTGCTGTGAACTAGGACTCCATAGCATTCTACTGAAGGTGACAAAGTGAGATTCTGTCTCAAAAAAAAGACTGATT","GGCTGGCTGCGGTAGCTCACCCCTGTAATCCCAGCACTTTGGGAGGTCAAGGCAGGTGGATTGCCTGAGGCCAGGAGTTCGAGGCCAGCCTGACCAATATGGCAAAACCCTGTATCTACTAAAAACTAGCTGGGCATGGTGGCATACACCTGTAGTCCCAGCTACTTGGGAGGCTGAGGCAGGAGAATTGCTTGAACCTGGAGGCAGAGGTTGCAGTGAGCCAAGGCTGCCCCACTGCACGCCAGCCTGGGTGACAGAGTGACACTCCATCTCAGAAAAAAAA"
"GL873562","8499356","8499477","chrX","91860022","91860139","29","83360666","GGCTGGGTGTGCTGGCTCATGCCTGTAATCCTCGCACTCTGGGAAGCTAAGGCAGGTGGATTGCCTGAGCTTATGAGTTTAAGACTAGCCTGAGCCAGAGCAAGACCTTGTCTCTATTTTTT","GCCGGGTGTGGTGGCTCATGCCAGTAATCCTAGCACCTTGGAAGGCTGAGGCAGGTGGATTGCCTGAGCTCAGGAGCTTCAGACTAGCCTGGGCAACATAGTGAAACCCCATATCTCT"
"GL873562","8499731","8499918","chr7","167658032","167658223","45","159158301","AAGACCTTGTCTCTAAAAATAGCCAGGTGTTGTAGCAGGCACCTGTAGTCCCAGCTACTTGGGAGGCTGAGACAAGAGAATTGCTTGAGCCCAAGAGTTTGAGGTTGCTGTGAGCTGAGATGCCATGGACTCTATCGAGGGCAGTAAAGTGAGACTCCGTCTCAAAAAAAAAAAAAGAAAGAAAAGAA","TACTAAAATACATACAAAAATTAGCCAGGTATGGTGGCAGGCCCCTGTAGTCCCAGCTACTCGGGAGGCTGAGGCAGGAGAACTGCTTGAACCCAGGAGGTGGGGATTGCAGTGAGCTGAGATCGCACCACTGCACTCCAGCCTGAGCGACAGAGTGAGACTCTGTCTCAAAAATAAAAAAAGAAAAAAAAA"
"GL873562","10216295","10216385","chr1","44313085","44313176","34","34096790","TAAAAATACATTGAACCAGATTCAGTGGCTCACACCTGTGCTCCTAGCTACCCAGTGGCTGAGGCTGAAGGATGGCTTGAATCTCAAGTTC","TTACAGATCATTTGGGGCTAGATGTAATGGCTCACACCTGTAAGCCCAGTGCTTTGGGAGGTTGAGGCAGGAAGATGGCTTGAACCTAGGAG"
"GL873562","11812352","11812435","chr19","44513406","44513491","17","32701054","GGCCGGTACGATGGCTCAGGCCTATAATCTTAGAACTCTGGGAGTCCGAGGTGGGTGGACTGCCTGAGCTCACAGTTCGAGACC","GGCCGGACGCGCTGGCTCACGCCTGTAATCCTAGCACTTTGGGAGGCTGAGGGGGGCGGATAGCCTGAGCTCAGAAGTTCGAGACC"
"GL873562","12179920","12180054","chr14","8268315","8268451","18","3911605","GGCCAGGCATGGTGGCTCACACCTATAATCCTAGCACTCTGGGAGGCCAAGGCAGGTGGATCACCTGAGCTCAGGAGTTTAAGACCAGCCTGAGCAAGAGTGACAACCTATCTCTATTAAAAATACAAAAACTAG","GGCCGGGCATAGTGGCTCACACCTATAATCCCAGCACTTTGGGAGGCCAAGGCAGGTGGATCACCTGAGGTCAGGAGTTCGAGACCAGCCTGACCAAGATAGTGAAACCCCGTCCCTACTAAAAATACAAAAATTAA"
"GL873562","14017684","14017885","chr2","94000404","94000565","73","79982720","CAAGCTAGCCTAGGGATGTGGAGGTACCTGTAGTCCCAGTTACTTCATTGGCTGAGGCTTAAACCCTCTTGGATGGTCTCACTCTGTCACCCTGGTAGAGTGTTGTGGCATCATGTGTCACAGGAGGTTGAGGTTGCTGTGAGCTGTGATGCCACAACATTCTACCAGGGTGACAGAGTGAGACTCTGTTTCAAAAACAAAA","AAACTAGCCTGGCGTGGTGGTGTGTGCCTGTAATCCCAGCTACTTGGGAGGCTGAGACAGGAGAATCACTTGAACCTGGGAAGTGGAGGTTGCAGTGAGCTGAGATCATGCCACTGCACTCCAACTTGGGCAACAGAGCGAGACTCTGTTTCAAAAAAAAAA"
"GL873562","14017915","14018042","chr1","161382752","161382881","27","147364837","GGCTGGGCACGGTGGCTCACACTTGTAATTCTAGCACCCTGGGAGGCCAGCGTGGGTGGTTTGCTTGAAGTTAGGAGTTCAAGACCAGCCTGACCAAAGTGAGACCACATCTCGACTAAAAACAAACA","GGCTGGACGCAGTGGCTCATACCTGTAATCCCAGCACTTTGGGAGGCCGAGGTGGGTGGATCACCTGAGGTCAGGAGTTCAAGACCAGTCTGGCCATGGTGAAACCCCATCTCTACTAAAAATACAAAAA"
"GL873563","2645481","2645758","chr1","37954757","37955032","69","35309276","GGCTGGGTGCCATGACTCACGCCTGTCATCCCAGCTCTCTGGGAGGTCACAATGGGAGTATTCCATGAGCTCAGAAGTTTGAGACCAGTCTGAGCAAGAGCAGACTCCATTTCTACTAAATATAGAAAAATTAGCCCAGTATGGTTGTGCACACCTGTAGTCCCAGCTACTTGGGAGCTGAAGCAGGAAAACGGCTTGAGTCCAGGAGTCGGAGGTTGCTGTGAGCTGAGAGCTATAATGATGCCAGTGCACTCTACCCAGGCAACAGAGCAAGACTC","GGCCGGGTATGGTGGCTTACGCCTGTAATCCCAGCACTTTGGGAGGCCAAGGTTGGCAGATCACCTGAGGTCAGGAGTTCGAGACCAGCCTGGCCAATATGGCGAAACCCCGTCTCTACTAAAAATACAAAAATTAGCTGGGCATGGTGGCGCATACCTGTAATCCCAGCTACTCGGGAGGCTGAGGCAGGAGAACTGCTTGAACCCAGGAGGTGGAGGTTGCAGTGAGCCGAGATTGAGCCACTGCACTCCAGCCTAGGTGACAGAGTAAGACTC"
"GL873563","2646059","2646097","chr1","62915138","62915167","12","60269079","CAAACAGAACAAGACTTTGTTTCAAAAAAAAAAAAAAAA","CAAACAAACAAACATCACAAAAAAAGAAAA"
"GL873563","2651001","2651167","chr2","69424628","69424798","38","66773627","GTACAAAAATTAGCCAGATGTCTTGGTGCTTATAGTCAGCAACTCAGGAGGCTGAGGCAGGAGGATCACTTGAACCCCTGGAATTTGAGGTTGCTGTGAGCTAAGTTGATGCCACGGCATTCTAGCCTGGGTGACAGAGTAAGACTCCATCTCAATAAATAAATAAA","AAAAAAATTAGCCAGGCATGGTGGTGCATGCTTGTAATCCCAGCTACTTGGGAGGCTGAGGCAGGAAGATCACTTGAACCTGGGAGGCGGAGGTTGCAGTGAGCCAAGATTGTGCCACTGAACTCCAGCCTGGGTGACAGAGCAAGACTCCATCTCAAAAAAAAAAAAAAA"
"GL873563","2651449","2651584","chr3","121251018","121251153","32","118599569","GGTCCAGTGAGGTGGTTCAGACCTGTAATCCTAGCATTCTGGGAGGCTGAGGTGAGCAGATTGCTTGAGCTCAGTGAGTTTGAGACCAGCCTGAATAAAAGCAGCACCCCATCTCTACCAAAAGTAGGAAAATTAT","GGCCAGGTGCAATGGCTCACACCTGTAATCCCAGCACTCTGGGAGGCCGAGGTGGGCAGATCACCTGAGGTCAGGAGTTTGAGATCAGCCTGGCCAACCTGGCAAAACCCCATCTCTAATAAAAATACAAAAATTA"
"GL873563","6898038","6898117","chr6","28153994","28154075","27","21255956","AAAAAACAGAAAAATTAGTTGGGTGTGGTAGTGGGTAGCTACTTGGGAGGCTGGGGCAGGAGAATCACTTGAACCCAGGA","AAAATTAGCCGGGTGTGGTGATGCATGCCTCTAATCCCAGCTACTTGGAAGGCTGAGGCAGGAGAATCACTTGAAGGCAGGA"
"GL873563","6898395","6898520","chr5","140939246","140939381","30","134040851","GGGGGTGGTGGCTCATGCCTGTAATCCCAGCACTCTGGCTGAGACAAGTGGATTGCATGAGCTCAGGAGTTCAAGACCAGCTTGAGGAAGAACAAGACTCCATCTCTACTAAAAATAGAAAAATTT","GGCCCGGTGCTGTGGCTCATGCCTGTAATCCCAGCACTTTGGAAGGCTGAGGCAGGTGGATCCCTTGAGGTCAGGAGTTCGAGACCAGCATGGCCAACATGGCAAAATCCCATCTCTACTAAAAATACAAAAATTA"
"GL873563","7811395","7811530","chr1","29437872","29437991","31","21626477","GGCCGGGCGTGGTGGCTCATGCCTGTAGTCCCTGCACTGTGGGAGGCCGAGGCGGGTGGATCACCTGTGCTCAGAGGTTCGAGACCAGCTAAGACCCCCCTGAGCCAAATGAGCCAGAGTGAGACCCCGTCTCTAC","GGCCGGGCGTGGTGGCTCACGCCTGTAATCCCAACATTTTGGGAGGCCAAGGCGGGTGGATCACCTGAGGTCAGAAGTTCGAGACCAACCTGGCCAACATGGTGAAACCCCTGTCTCTAC"
"GL873563","7855904","7856041","chr3","37342340","37342469","34","29486436","GCCAGGGCAGTGGTTCACACCTGTAAAAACCCCAGTATTTTGAGAAGCCAAGTTGGGAGGATCACATAAGGTCAAGAGTTTGAGACCAGCCTGGACAACACAGTATAAGACTCCCATCTCTATTTTGTTAAATATACA","GCCGAGCGCGTGGCTCACGCCTGTAACCCCAGCACTTTGGGAGGCCAAGGTGGGTGGATCACTTGAGGTCAGGAGTAGGAGACCAGCCTGGCCAACATGGGTGAAACCCCACCTATAGTTTAAAAATATA"
"GL873563","8381194","8381392","chr2","167568017","167568216","65","159186823","GGCCAGTGCAGTAGCCCACACCTGTAATCCTAGCACTCTGGGAGGCCAACTCTGGTAGAGTTTGAAACTAGCCTGAGCAAGAGCGAGACCTTGTCTTCACTGAAAAAAATAGAAAAAAAAAAAAAAAACTAACTGGGCATGGTGCTGTACATCTGTAGCCCGAGCTACTCAGGAGTCTGAGGCAAGAGGATTACTCAAT","GCCAGGCGAGGTGGCTCATGCCTGTAATCCCAGCACTTTGGGAGGCCAAAGTGGACAGATTACCTGAGGCCAGGAGTTTGAGACCAGCCTGACCAATATGGTGAAACCCCATCTGTACTAAAAATACAAAAATTAGCAGGGCGTGGTGGTGTACACCTGTAATCCCAGCTACTCAGGAGGCTGAGGCAGGAGAATCTCTT"
"GL873563","8381923","8382014","chr2","92370724","92370803","33","83988801","GGATTGCTCAAGCCCAAGAGTTTGAGGTTGCTGAGAGCTATGACACTACAGCACTCTACTCTACCCAGGGCAACAGAGTGAGACAAAAAAAA","TTGCTTGAACCCAGGAGCTAGAGGTTGCAGTGAGCTGAGATTGCACTATTGCACTCCAGCCTGGGCAACAGGGTGAGACT"
"GL873563","9500422","9500552","chr19","10830410","10830544","33","1329988","GGTCAGGTGCAGTGGTCACCTGTCATCCTACCCCTCTGGGAGGCCAAGGTGGGTGGATTGCCTGAGTTCAGGAGTCTGAGACGAACCTGAGCTAGAGCAAGACCTCATCTCTTAAAAAATAGCCAGCATTC","GGCCAGGTGCAGTGGCTCATGCCTGTAATCCCAGCACTTTGGGAGGCCAAGGTGGGTGGATCACCTGAGGTCAGGAGTTCGAGACCAGCCTGATCAACGTGGTGAAACCCCATCTCTACTAAAATTGCAAAATTA"
"GL873563","9501087","9501192","chr16","71049107","71049211","33","61548020","TAAAACCTATAATGTTTGAAAATAAAAATAGCCAGGCCTTGTTGTGGGTGCCTGTAGTCCCAGCTACTTAGGAGGCTGAGGTAAGAGGATTGCTTGAGCCCAAGAG","TGAAACCCCATCTCTACTAAAAATACAAAATTAGCCAGGTGTGGTGGTGCATGCCTATAATCCCAGTTACTTGGGAGACTGAGGCAGGAGAATCACTTGAACCTG"
"GL873563","10991062","10991128","chr1","22619342","22619410","11","11628280","GGCCGGTGTAGTGGCTCACGCCTGTAATCCCAGCACTTTGGGTGCCGACATGGGCAGATCGCCTGAG","GGCCGGGCGCGGTGGCTCACACCTGTAATCCCAGCACTTTGGGAGGCCGAGGTGGGCGGATCACCTGAG"
"GL873563","12252577","12252738","chr8","144193624","144193784","41","131941047","GGCTGGGTACAGTGGCTCATATCTGTAATCCTAGCACTCCAGGAGGCTGAGGTGGGAGGATAATTGCCTGAAGTCAGAAACACAAGACCAGCCCAAACAAGAGTGAGACACCATCTCTACTAAAAATAGAAAACTGAGCTGGGTGTGGCGGTGCACACCTGT","GGCCGGGCATGGTGGCTCATGCCTATAATCCTAGCACTTTGGGAGGCCGAGGTGGGCGAATCACCTGAGGTCAGGAGTTTGAGACCAGCCTGGCCAACATGGTGAAACCCCATCTCTACTAAAAATACAAAAATTAGCTGGGTGTGGTGGCACATGCCTAT"
"GL873564","1384131","1384395","chr13","32253035","32253303","64","30868904","GGGGGGGGGGGCACACTGGCCTGTAATTCTAGCACTCTGAGAGGCCAAGGCAGGTGGATCACCTGAACTCAGGAGTTCGAGACCAGCCTGATCAAGAGTGAAACCCTGTCTCTACTAACAAGAGAAAAACCAGTAGTCCCAGCTACTCAGGAGGCTGAGGCAGAAGAATCACTTGAACCCAGGAGTTTGAGGTTTCTGTGAGCTACAGTAGTGCTATGGCACTCTACCAAGAGTGACAGAGTGAAACTCTGTCTCAAAAAAAAAA","GCTGGGCATGGTGGCTCATGCCTGTAATCCCAGCACTTTGGGAGGCTGAGGCGGGTGGATCATCTGAGGTCAGGAGTTCAAGACTAGCCTGGGCAACATGGTGAAACCCTGTCTCTACTAAAAATACAAAATTACAGGTAATCCCAGCTACTTGGGAGGCTGAGGCAGGAGAATCGGTTGAACCCAGGAGGCGGAGGTTGCAGTGAGCTGAGATCATGCCACTGCACTCCAGCCTGGGCAATAGAATGAGACTCTGTCTGAAAAAAAAA"
"GL873564","2543879","2544121","chr1","199402350","199402570","73","196858471","GGCCAGGTGTGGTGGCTTACGCCTGTTGTCCCAGCGCTGTGGGAGGCCGAGGCAGGTGGATTGCCTGAGCTTAGCTGAGTTTGAGACCAGCGGAAGACCAGCATGAGGCAGAGTGAGCCAGAGTGAGATCCTGTCTCTACAAAAAAGAAAAAAAAAAAAACAGCCGGATGTTGTGGCGCGCGTCTGTAATCCCAGCTACATGGGGGTCAAGAGGGCAAGAGAATCATACAGGAGGAAGAAGTT","GGCCAGGTGTGGTGGCTCACACCTGTAATCCCAGCACTTTGGGAGTCTGAGGCGGGTGGATTGCCTGAGGTTGAGAGTTTGAGACCAGCCTGGCCAACATGGTGAAACCCTGTCTCTACTAAAAACACAGAAATTAGCCAGGCATGGTGGCGCATGTCTGTAATCCCAGCTACCCTCCTGGAGGCTGAGGCAAGAGAATCACTTGAACCCAGGAAGCAGAG"
"GL873564","4859126","4859236","chr9","15245726","15245837","31","10386600","GTGGCTCATGCTTATAATCCAATCACTATGGGAGACCAAGGTGGGGATGGGCGGAGATCACCCTCAGGAGTTGGAGACCAGCCTGAGTTAAGAGTGATACCATGTCTCTAC","GTGGTGTCTCACGCCTATAATCCCAGCACTCTGGGAGGCCAAGGTGGGCAGATCACCTGAGGTCAGGAGTTAAGAGACCAGCCTGGCCAACATGGTGAAACCCTGTCTCTAC"
"GL873564","4859490","4859678","chr8","126054004","126054184","54","121194514","CATGTCTCTATTAAAGGTAGAAAAATTAGCCGAAGTATTGTAGTTGGGCTGTATAGTCCCAACTACTGAAGAGGCTGAGACAGGAGGATTGCTTACAACTAGGAGTTTGAGGTTGCTGTGAGCTAGGCTGATGCCAAGGTGCTCTAGCCTGGGCAACAGAATGAGACAATGTCTTAAACAACAAAAAAA","GTCTCTACTAAAAATACAAAAATTAGCTGGGTGTGGTGGTGCATGCCTGTAATCCCAGCTACTCAGGAGGCTGAGGCAGGAGAATCGCTTGAACCCAGGAGGTAGAGGTTGCAGTGAGCCAAGATCATGCCACTGCACTCCAGCCTGGGTGACAGAGGGAGACTCTGTCTCAATAAATAAA"
"GL873564","5294014","5294069","chrX","11604904","11604969","20","6310890","GGGTGTGGTGACTTGCACTTACAATCAGCACTTTGGGAGGCGAAGGTAGGAGCATC","GGCTGGGTGCAGTGACTCACGCCTGTAATCCCAGCACTTTGGGAGGCTGAGGTAGGCAGATCACCT"
"GL873564","5294155","5294257","chr15","310129","310227","21","4984026","GGCTGGGTGTGGTGGCTCACGTCTGTTGTCCCAGCGCTATGGGAGGCTGAGGAGGGTGGATCACCTGAGCTCAGAGGTTCGAGACCAGCATAAGACCAGCATG","GGCTGGGCGCAGTGGCTCACGCCTGTAATCCCAGCACTTTGGGAGGCCAAGGCGGGTGGATCACGAGGTCAGGAGTTTGAAACCAGCCTAGCCAGCATG"
"GL873564","6711055","6711262","chr18","1878493","1878704","55","4832562","CTGGGCCCAGTGGCTCACACCTATAATCCTCGCACTCTGGGAGGCTGAGGCGGGTAGATTGTCTGAGCTCACAGGTTCAAGACCAGTGTGACCCAGAGCGAGGCTTTGTCTCTAAAAATAGCAGGGCGTTGTGGCAGGCACCTGTAGTCCCAGCTACTTGGGAGGCTAAGGCAAGAGAATTGCTTAAACCTAAGAGTCTGAGGTTACA","GGCCAGGCATGGTGGCTCACGCCTGTAATCCCAGCACTTTGGGAGGCCGAGGCGGGTGGATCACAAGGTCAGGAGTTCAAGACCAGCCTGGCCAACATGGTGGAAGCCCATCTCTACAAAAAATTAACTGGGCGTGGTGGCAGGCACCTGTAATCCCAGCTACTTGGGAGGCTGAGGCAGGGGAATTGCTTGAACCTGGGAGGCGGAGGTTG"
"GL873564","6711356","6711451","chr7","158031905","158031997","31","151320549","AAAAGAGTCTGAGGTTGCCATGAGCTATCATGCCAAGGCATTCTAGAGAAGGGGTACAAAGTGAGACTCTGTCTCAAAAAAAGAAAACCAAAAAGG","CCAGGAGGTGGAGGTTGCAATGAGCCAAGATCACACCACTGCACTCCAGCCTGGGTGACAGGGTGAGATTCTGTCTCAAAAAAAAAAAAAAAA"
"GL873564","7057009","7057315","chr14","106885133","106885430","87","99828124","GCCGGGTACAATGGCTTGCGCCTATAATCCCAGCACTCTGGGAAGCAGAGGTGGGTGGATCACCTCAGCTCACGAATTCGCTACCAGCCTGTCCTAGAGTGAGACACCCCCCCCACCCCCACCCCCCACAACCTCTAAAAATAGCCTGGAGTTGTGACGGGCACCTGTTGTCCCAGCTACTCTGGAGGCTGAGACAAGAGAATTGCTTGGGCCTCAGAGTCTAAGGTTGATATGAGCTATGACATCACAGCACTCTATCAAAGGTAACAAAGTGAGACTCTAAATAAATAAATAATAAATAAATAAA","GCCGGGCCCGGTGGCTCTTGCCTGTAATCCCAGCACTTTGGGAAGCTGAGGTGGGTGGATCACCTGAGGTCAGGAGTTCGAGACCAGCCTGACCAATATGGTGAAACCCCGTCTCTACTAAAAATATAAAAATTAGCCGGGTGTGGTGGCATGCGACTATAGTCCCAGCTACTCAGGAGGCTGAGGCAGGAGAATTGCTTGAACCCAGGAGGTGGAAGTTGCAATGAGTCGAGGTCACACCACTGCACTCCAGCCTAGGCAACAGAGTGAGACTCCATCTCAAAAAAAAAGAAAAAAA"
"GL873564","7705416","7705474","chr1","51463330","51463380","19","43757914","TCATGCCTGTAGTACCAGCACTTCAGGAGGCTGAAGCAGGAGCTAAGATTAGAAATTTG","CATGCCTTTAATCCCAACTACTTGGGAGGCTGAGGCGAGAATTGAAGTCCG"
"GL873564","8307239","8307551","chr14","30585163","30585473","93","22277924","GCACAGTGGCTCAGGCCTGTAATCTGAGCACTCTGGGAGGTTGAGGCTGAGGTTAGGAGTTAGGAGAACAGCCTGAGCAAGAGTGAGACCCCATCTCTACCAAAAATAGGGGAAAAAACTCCAAAAATCTAGCCACATGTTGTGGTACTTGCCTGCAATCCCAGCTACTGGGGCATAGGGGGACTGAGGCAAGAGGGTCACTTGAGCGTGAGAGATTGAGGTTGCTGTGAGCTAAGATGATGCCATGGCACTCTACCCAAGGTGGCAGAGTGAGCCTATGTCTCACCAATAAATAAACAAATAAATAAATGAA","GGGCACAGTGGCTCACGCCTGGAATCCCAGCACTTTGGGAGGTCAAGGTGGGTGGATCACCTGAGGTCAGGAGTTTGAGACCAGCCTGGCCAAAATGGTGAAACCCCATCTCTACTAAAAAAAATACAAAAAATTAGCCAGAATGTGGTGGTGCATGCCTGTAATCCCAGCTACTGGGGAGGCTGAGGCAGGAGAATCACTTGAACCTGGGAGGCGGAGGCAGCAGTGAGCCAAGATGGCGCCACTGCACTCCAGCCTGAGTGACAGAATGAGACTCTGCCTCAGGAAAAAAAAAAAAAAAAAAGCAAAAA"
"GL873564","8738781","8739084","chr6","92598388","92598711","90","83859607","GCTGGGCACAATGGCTCACACCTGTAATGCCAGCACTTGGGAGGCTAAGACGGGCAAATTGCCTGAGCTCACAAGTTCAAGACCCAGAGCGAGACCTCATCTCTAAAAAATTGCCATGCATTGTGGAGGGTGCCTGTTGTCCCAGCTACTTGGGAGGCGGAGAAAAGACAATCGCTTTAGCCCAAGAATTGAAGGTTGCTGTGAGCTGTGACGCTGTAGCACTCACCAAGGGCAACATAGTGAGACTCTGTTTCAAAATAAATAAATAAATAAATAAAAATAAATAAATAAAATAAAAACAAAA","GGCTGGGCTCAGTGGCTCATGCCTGTAATCCCAGCACTTTGGGAGGCCAAGGCTGGCAGATTGCCTGAGGTCAGGGGTTCAAGACCAGCCTGGCTAACATGGTGAAACCTCATCTCTAATAAAAATACAAAGATTAGCTGGGTTTGGTGGCACATGCCTGTAGTCCCAGCTATTTGGGAGGCTGAGGCAGGAGAATCGCTTGAACCCAGGAGTTGGAGGTTGCAGTGAGCTGAGATGGCACCACTGCACTCCAGCCTGGGTGACACAGCAAGACTCCGTCTCAAAAAAAAAAAAAAAAAAAAAAAAAAGAAAAGAAAAAAAAAA"
"GL873564","9560044","9560238","chrX","30236033","30236239","48","20675989","GGCCAGGTGCGGTGGCTCCTGCCTGTAATCCCAGCACTCTGGGAGGCCTAGGTGGGTGGATTGCCTGAGCTCACTGGTTGGAGACCAGCCTGATACAGATTGAGACCCCCTGCCTCTAAGAATAGCAGGGTGTTGTGACAGACACCTAAAGTCCCAGCTACTCGGGAGGCTGAGGCAAGAGAATCTCTTGAGCCC","GGCTGGGTGCGGTGGCTCACTCCTGTAATCCCAGCACTTTGGGAGGCCAAGGTGGGCGGATCACCTGAGGTCAAAAGTTCGAAACCAGCCTGACCAACAGGGTGAAACCCCGTCTCTACTAAAAGTACAAAAATTAGCCGGGCATGGTGGCAGGCACCTATAATCCCAGCTACTTGGGAGGATGAGGGAGGAGAATCACTTGAACCC"
"GL873564","9560508","9560604","chr1","212121416","212121513","30","202560908","TCGCTGTGCCCAAAAGTTAGAGGTTGCTGTGAGCTATGATACCACTGCACTTTACTGAGGGTGACAAAGTGAGACTCTGTCTCAAAAAATAAATAAA","CTTGAACCTGGGAGGTGGAGGTTGCAGTGAGCCAAGATCATGCCACTGCACTCCAGCCTGGGCAACAGAGCGAGATTCTGTCTCAAAAAAAAAAAAAA"
"GL873564","9753449","9753658","chr19","10370828","10371033","59","617379","TGAGACCCTGGTCTCTTCTAAACATTAAAAAAAAAAAGAAAACTGGGTGTTGTGGCGATGCCCATAGTCCCAGCTACTGATGAGGCTGAGGCAGGGGGATCACTTGAACCCAGGAGTCTGAAGTTGCTGTAAGCTAGGCTGAAGTCACAGTTGTCTAGCCTAGGGCAATAGAGTAAGACTGTCTCACAAAAAAAAAAAAAGGAAAGAAAA","GAAACCCTGTCTCTACTAAAAATACAAAAAATTAGCTGGGTGTGGTGGTGCGTGCCTATAATCCCAGCTACTCAGGAAGCTGAGGTGGGATAATCACTTGAACCTGGGAGGCAGAGGTTGCAGTGAGCCCCAGACTGTGCCACTGCACTCCAGCCTGGGTGACAGAGTCAGACCCTGTCTCAAAAAAAAACAAAACAAAAAAAAAA"
"GL873564","9753896","9754006","chr17","50277667","50277784","33","40523771","GCTGGGCAGGGTGGCTTGTGCCTGTAATCCTCACATTCTTGGAAGCCAAGTTGGTGGATTTCTTGAGCTCAAGAGTTCAGCCTGAACAACGGTGAGACCCCTGTCTCTCTC","CCGGGCATGGTGGCTCATGCCTGTAATCCCAGCACTTTGGGAGGCCAAGGTGGGTGGATCACTTGAGGTCAGGAGTTCAAGACCAGCCTGGCCAACATAGAGAAACTCTGTCTCTACT"
"GL873564","10693118","10693253","chr1","29437872","29437991","31","18744754","GGCCAGGCGTGGTGGCTCACGCCTGTAGTCCCAGCGCTATGGGAGGCCGAGGCGGGTGGATCACCTGTGCTCAGAGGTTCGAGACCAGCCAAGACCTCCCTGAGCCAAATGAGCCAGAGTGAGACCCCGTCTCTAC","GGCCGGGCGTGGTGGCTCACGCCTGTAATCCCAACATTTTGGGAGGCCAAGGCGGGTGGATCACCTGAGGTCAGAAGTTCGAGACCAACCTGGCCAACATGGTGAAACCCCTGTCTCTAC"
"GL873564","11596705","11596819","chr15","17759279","17759407","35","6162574","AATCCGCTACTCGGGAGTCTGATGCAGGAGGATCCCTGGAACCCGGGAGTGAGCTAGGCTGTCCATTCTACCCAAGGCAGAAGAGTGAGATTCTGTCTCAAAAAAAAAAAAAAAA","AATCCCAGTTACTCAAGAGGCTGAGGCAGGAGAATTGCTTGAACCCGGGAGGTGGAGCCGAGACCGCTCCACTGCACTCCAGCCTGGGTGACAGAGTGGGACTCTGTCTAAAAAAAAAAAAAAAAAAAA"
"GL873564","13278770","13278831","chr1","10318851","10318915","18","2959919","GGCTGAGCACAGTGGCTCATGTCTATAATCCCATCACTCTGGAAAGCTAAGAATGAGGATCT","GGCTAGGCATGGTGGCTTATGCCTATAATCCCAGCACTTTGGGAGGCTGAGGCAGACGGATCACC"
"GL873564","13278924","13279152","chr20","69116969","69117193","62","55838045","AAAATAGAGAATAAGAATCCCTTGAGCTCATGAGTTCAAGATCAGTCTGAACAAGTGTCAGACCCTATCTCTACTAAAAATGGAAAAATTAGCCAGGCACTGTGGCAAGTGCCTGTAGTCCCAGATTTCAGGAGGCTGAGGCAGGAGAATCATTTGAATCCAGGAGTTTGAGGTTGCTGTGAGCTAGGCTGACACCACTGTACTGTAGCCTGGGCAACAGAGTGAGACT","GAGGTGGGTGGATCACCTAAGGTCAGGAGTTCAAGACTAGCCTGGCCAACATGGTGAAACTCCATCTCTACTAAAAATACAATAATTAGCTGGGTGTGGTGGCATGTGCCTGTAATTCCAGCTACTCAGGAGGCTGAGGCAGGAGAATCACTTGAACCCAAGAGGCGGAGGTTGCAGTGAGCCGAGACTATGCCACTGCACTCTACCCTGGGCAACAGAGCAAGA"
"GL873565","1417041","1417214","chr4","44130284","44130433","54","42713243","GGCCAGGCGTGGTGGCTCACGCCTGTTGTCCCAGCGATTTGGGAGACTGAGGTGGGTAGATCACCTGTACTCAGAGGTTCGAGACCAGCTGAAGACCAGCCTGAGGCAGAGTGAGACCCCCGTCTCTATAAGAACAAGACAGCCGGACCTTGTGATCCCAGCTACATGGGTGGC","GGCCGGGTGCGGTGGCTCACACCTGTAATCCCAGCACTTTGGGAGGCTGAGGTGGGCAGATAACCTGAGGTCAGGCGTTCGAGACCAGCCTGGCCAACATGGTAAAACCCCGTCTCTACTAAAAATACAAAAATTAGCCAGGTGTGGTGG"
"GL873565","2138367","2138455","chrX","124155143","124155229","17","122016776","GGCTGGGCGTGGTACTCACGCCTGTTGTCCCAGTGCTGTGGGAGGCTGAGGTGGGTGGATCCCCTGAGCTCAGCAGAGTTTGAGACCAG","GGCTGGGTGCGGTGGCTCACGCCTGTAATCCCAGAACTTTGGGAGGCTGAGGTGGGTGGATCACCTGGGGTGAAGAGTTCGAGACCA"
"GL873565","2459722","2459938","chr7","32729330","32729532","57","30269608","AAAAAGACCAAACACCCCAGCTCTACTAAAAGTAGAAAAATTAGCTGGGTATTGTAGTGGGCACCTGTAGTCCCAGCTGCTTGGGAGGTTGCGGCAGGAGAACCACTTAAGCCCAGGAGTTGGAGGGTGAGGTGGGCTGAGGCCACTGCATTCTAGCCTAGGCAACAGAATGAGACTCTGTCTCAAACAAACAAACAAACAAACAAACAAAAAACAA","GAAACCCCATCTCTACTAAAAATACAAAATTAGCCAGGCATGGTGGTGCACACCTGTAGCTCCAACTACTTGGGAGGCTGAGGCAGGAGAATCACTTAAACCCAGGCAGTAGAGGTTGCAGTAAGCCAAGATCGCACCACTGCACTCCAGTCTGGGCAACAGAGTGAGACTCTGTCTCAAAAAAAAAAAAAAAAAAAAAAAAA"
"GL873565","2460219","2460297","chr10","28805224","28805297","28","26345005","CTCAAGCCTGTAATTCTAGCACAGCTGGGAGGCTGAGGCAGGAAGATCTCTCAGCTTAGGATTTCAAGACTAAACACAT","GTGGCTCATGCCTGTAATCTCAGCACTTTGGGAGGCTGAGGCAGGCAGATAACCTGAGGTCAGGAGTTCGAGAC"
"GL873565","11485258","11485580","chrX","66383160","66383473","97","54897902","GGCAGGGCACAGTGGCTCAATCACAGCACTCTGGGAGGAGGCTTAGATGGGTGGATTATTTGAGTTCACAAATTTAAGAACAGCCTGAGCAAGAGTGACACCCTGTCTCTACTAAAAAACAATAGGAAAAATAAAAACTAGCTGGGCATAGTGGCATATGCCTGTGGTTCCAACTACTTGGGAGGCAGAGGCAAGTTTGCTTAGCTAGTTTTTTTTCAGGCCCAAGAGTAGAGGTTGTTGTGAGCTGTGATGCCATAGCACTCTACATAGAGTGACAGAGTGAGACTTTGTCTAAATAAATAAATAAATAAAATTTTAAAAAA","GGCCAGGCACAGTGGCTCACACCTGTAAATCCCAGCACTTTGGGAGGCCGAGATGGGTGGATCACCTGAGGTCACGAGTTTGAGACCAGCCTGGCCAACATGGTGAAACCTCGTCTCTACTAAAAATACAAAAAAAAAAAAAATTAGCTGGGCGTGGTGGTGTGCACCTGTAGTCCCAGCTACTTGGGAGGCTGAGGCAGGAGAATCGCTTGAACCCAGGAGGCAGAGGTTGCAGCGAGCCGAGATCGCGCCACTGCACTCCAGCCTAGGTGACAGAGTGAGACTCTGTCTCAAGGAAAAAAAAAAAAAAAAAA"
"GL873565","13424539","13424574","chr1","174086158","174086184","14","160661619","ACCTAGGGTGAAAGTAAGACTGTCTCAAAAAAAGAA","AAGAGAGAGAAAGAGAGAAAGAAAGAA"
"GL873565","13424654","13424896","chr16","19730961","19731217","54","6306307","GCCAAGCACAGTGGCTCACACCTGTAATCCCAGCACTCTGGGAAGCCTAGGTGGGTGGATTACTTGAGCTCAGGAGTTCAAGATCAGCCTAAGCAAGAGTGAAACTCCCATGTCTAAATAAACAGCCGGGCATTGTAGTGGGTCCCTGTAGTCCCAGCTACTCAGGAGGCTGAGGCAAGAGAATCGCTTGACCCAGGAGTTGGAGGTTGCTGTGAGCTGAGGCCACGGCACTCTATCTAGGGT","GGCCGGGCACAGTGGCTCACGCCTGTAATCCCACCACTTTGGGAGGCCGAGGCGGGTGGATTACCTGAGCTCTGGAGTTAGAGACCAGCCTAGGCAACATGGTGAAACCCCATGTCTACTAAAATACAAAAAGCCGGGCGTGGCGGCGTGTGCCAATAGTCCCAGCTACTCAGGAGGCTGAGGCAGGAGAATTGCTAGAACCCGGGAGGCGGAGGTTGCAGTGAGCTGAGATCACGCCACTGCACTCCAGCCTGGGC"
"GL873565","13679578","13679856","chr1","27657515","27657797","72","13977937","GCAGGGTACAGTGGCTCACACCTGTAATCATAGTAACTCTTAAGCGGCTGAGGCAAGTGAGAGGCCTGAGATCAGGAGTCCAAGAATAGCCTAACCAAAAGTGAGACCCCATCTCTACTAAAAATAGAAAAAAACTAGCCAGGCATGGTGGCACTTACCATAGTCCCACCTCATAAGGCTGAGGCAAGAGTATCACTTGAACCCAGAAGTTTGAAGTTGCTGTCAGCTACAATGACATCATAGCACTTTACCCAGAGCTACAGAGTAAGACTCAGTCTC","GCTGGGTGCGGTGGCTCACACCTGTAATCTCAACACTTTGGGAGGCTGAGATAGGTAGATCACCTGAGGTCAGGAGTTCGAGACCAGCCTGGCCAACATGGTGAAACCCCATCTCTACTAAAAATACAAAAAACCTAGCCAGGCATGGTGGTGTGTACCTATAATCTCAGCTATTCAGAAGACTGAGACAGGAGAATCACTTGAACTTGGGAGGTAGAGGTTGCAGTGAGCCAAGATCACACCACTGCACTCCAGCCTAGGCAACAGAGTGAGACTCCGTCTC"
"GL873566","947388","947684","chr3","178868174","178868466","60","177920786","GGCCGGGTAGGGTGGCTCATGCCTGTAATCCTAGCATTTTGAGAGGCCAAGGCAGGTAGATTACCTGAGCTCAGGAGTTCCAGACCAGGCTGAGCAAGAGCCCCATCTCTATCAAAAATAGAAAAATTAGCTGGGTATGGTGGCACATGCCTNNNNNNNNNNNNNNNNNNNNNNNNNNNNNNNNNNNNNNNNNNNNNNNNNNNNNNNNNNNNNNNNNNNNNNNNNNNNNNNNATGACACCATAGCACTCTAACCTGGAGCAACAGAGTGAGACACCGTCTTAAAAAAAAAAAAAAAA","GGCCGGGTGTGGTGGCTCATGTCTGTAATCCCAACACTTTGGGAGGCCAAGGCGGGTGGATCACCTGAGGTCAGGAGTTTGAGACCAGCCTGGCCAACATAGTGAAACCCCTCTACTAAAAATAAAAAATTAGCCAGGTGTGGTGGCANNNNNNNNNNNNNNNNNNNNNNNNNNNNNNNNNNNNNNNNNNNNNNNNNNNNNNNNNNNNNNNNNNNNNNNNNNNNNNNNNNNNNNNNNNNNNNNCTCCAGGCTGGGCAACAGAGTGAGGCTCCATCTAAAAAAAAAAAAAAAAA"
"GL873566","2530056","2530102","chr1","123145244","123145289","11","120615188","AGGCCAAGGCAGTTGGATCACCTCAGCTCAGGAGTTTGAGACCCGCC","AGGCTGAGGGAGGCGAATCACCTGAGGTCAGGAGTTTGAAACCAGC"
"GL873566","2923434","2923499","chr1","38303497","38303565","19","35380063","GGGCTCAATGGCTCAGCCTGTAATCTTAGCAGTCTGGGAGGCTGAGGCAGGCGCCTGAGCAAGAGT","GCTGGGCGCAGTGTCTCGTGCCTGTAATCCCAGCACTTTGGGAGGCTGAGGCAGGCGGATCATCTGAGG"
"GL873566","3613441","3613522","chr3","54039458","54039545","21","50426017","GGTGGCACATGCCCGTGATCCCAGCACTCTGGGAGGCCGAGGAGATCGGACTGCCTGAGCTCAGGAGTTCGAGACCAGCCTG","GCGCGGTGGCTCACGGCCTGTAATCCTTGCACTTTGGGAGGCTGAGATGGGTGGATTACCTGAGCTCAGGAGTTCGAGACCAGCCTGG"
"GL873566","6100482","6100582","chr2","51286276","51286376","32","45185794","GGCTGGGTGAGTACCTCATGCATCAAGCCCAGTGTTCTGGAGGCTGAGGCAAGGGGATCCTTGATGTGGATAGTTCAAGGCCAGCCTGGCAATTAGCTAGA","GGCTGGGTGCAGTGGCTCACGCCTATAATCCCAGCACTTCGGGAGGCTGAGGCAGGCAGGTCACCTGAGGCCAGGAGTTCAAGACCAGCCTGGCCAACATG"
"GL873566","6245586","6245714","chr3","50507869","50508002","30","44262283","GCTGGGTGTGGTGGCTCACACCTATAATACCAGCACTTGGGAGGCCAAAGCAAGTGGATTGCCTGAGTTCACAAGTTCAAGACCAGCCTGAGCAAGAGTGAGACCCTGTCTCTTAAAAATAGGTGGGCG","GCCAGGTGCGGTGACTCACACCTATAATCCCAGCACTTTGGGAGGCCGAGGCACGTGAATCACCTGAGGTCAGGAGTTCAAGACCAGCCTGACCAACATGGTGAAACCTTGTCTCTACTAAAAATACAAAAACT"
"GL873566","6245992","6246162","chr16","22888303","22888475","37","16642311","TAGCTGGGCGTTGTGGCGGGCATCTGTAATCCCAGCTACCTGGGAGGCTGAGGCAAGAAAATCACTTAAGCCCAAGAGTTTGAGGTTGCTGTGAGCTGTGATGGCACAGTACTCTATTGAGGGCAACATAGTGAGACTCTGTCTCAAAAAATAAATAAATAAATAAATAAA","ATTAGCTGGGCGTGGTGGTGGGCACCTGTAATCCCAGCTTCTTGGGAGGCTGAGGCAGGAGAATCACTTGAGCCCAGGAGGCAGAGGTTGCAGTGAGCAGAGATCGTGCCACTGCACTCCAGCCTGGATGACAGAGTCAGACTTTGTCTCAAAAAAAATAAAAAATAAAAAAA"
"GL873566","6483968","6484033","chr19","10207852","10207913","17","3723884","AAAATATGGTAAAATAAGCCAAGGATGGTGGGTCACACCTGTAATCCCAGCTACTCAAGAGACTGA","TAAAAATACAAAATTAGCTGGGTGTGGTGGCACACACCTGTAATCCCAGCTACTCAAGAGGC"
"GL873566","7043395","7043464","chr10","28805224","28805297","20","21761829","GGCTAGGCCTGGTAATCCCAGCACTCTAAAAGGCTGAGGCAGGTGGATAGCCTGAGCAAGAGTGAGACCA","GTGGCTCATGCCTGTAATCTCAGCACTTTGGGAGGCTGAGGCAGGCAGATAACCTGAGGTCAGGAGTTCGAGAC"
"GL873566","7888407","7888429","chr16","1275850","1275872","4","6612557","CTAAAAATAAAAAATTAGTCTTG","CTAAAAATACAAAAATTAGCCAG"
"GL873566","7888682","7888751","chr13","39203832","39203891","22","31315150","GTAGTCTTGGCGTAGTGATATGTACCTTTAATCCCAGCTACTCAGGAAGTGGAGGAGGAAAGAGTACAAG","TTAGCTGGGCGTAGTGGTGTGTGCCTGTAATCCCAGCTACTTGGGAGGCTGAGGCGGGAG"
"GL873566","8203857","8203949","chr20","18199749","18199840","19","9995892","GGCCCGGCATGGTGGTGCTTTGCCTATAATCCCAGCATTCTGGGAGGCCCAGGCAGGCGGATCACCTGAGCTCACAGGTTCAAGAATGGCCTG","GGCCGGGCATGGTGGCTCACACCTGTAATCCCAGCACTTTGGGAGGCTGAGGCAGGCGGATCACCTGAGGTCAGGAGTTCGAGACCGGCCTG"
"GL873566","8268872","8268975","chr15","10815564","10815667","26","2546692","GTGGCTCATGCCTGTAATCCTAGCACTCTGGGAGGCCGAGGCAGGTGGATTCCCTGAGCTCATAGGTTTGAGACCACAAGCAAGTCCAAGACCCCATCTCTTTT","GTGGTTCATGCCTGTAATCCCAGCACTTTGGGAGGCCGAAGTGGGCGGATCACCTGAGGTCAGGAGTTTGAGACCATCTGGCCAAGATGTAGAAACCCCATCTT"
"GL873566","8269263","8269458","chr15","77706857","77707054","55","69437594","AAGACCCCATCTCTTAAAAAAGAAAAAAAAAGCTGGGTGTTGTGGCCTTCACCTGTAGTCCCAGCTACTGGGGAGGCCAAGGCAAGAGACTTGCTTGAGCCAGAGTTTGAGGTTGCTGTGAGCTATAGTGCCACGGCACTCTACCAAAGGCAACAAAGTGAGACTGTCAAAAAAAAAAAAAAAAGAAGAAGAAGAA","CCCCATCTCTATTAAATATACAAAAAAATAGCTGGGTGTGGTGGTGTGCGCCTGTAATCCCAGCTACTTGGGAGGCTGATGCAGGGGAAGTGCTTGAACCAGGGAGGTGGAGGTTGCAGTGAGCCGGAATCGTGCCACTGCACCCCAGTCTGGGCAACAGATTGAGACTCTGTCTCAAGGAAAAAAAAAAAAAAAAAA"
"GL873566","8592056","8592127","chr10","28805224","28805297","15","20213168","TCTTGCCTGTAATCTCAGCACTCTGGGAGGCTGAGGCAGGCAGATCAACTGAGCTAACAAGTTCGAGACCAG","GTGGCTCATGCCTGTAATCTCAGCACTTTGGGAGGCTGAGGCAGGCAGATAACCTGAGGTCAGGAGTTCGAGAC"
"GL873566","8809109","8809200","chr11","48033118","48033204","26","39224009","ATAGCCAGGCTTGTTGCAGGCACCTGTAGTCCCAGTTACTCTGGAGGCTGAAGCAAGGGAATATCTTGAGCCCAAGAGTCTGAGGTTGCTGT","TTAGCCTGGCATGGTGGTGACACCTGTAATCCCAGCTACTCAGGAGGCTGGGAAGGAAAATCGTTTCAACCCAGGAGGCAGAGTTTG"
"GL873566","8809477","8809608","chr19","10830410","10830544","33","2020933","GGCCAGGCGCAGTGCCTCATGCCTGTAATCCTAGAACTCCGGGAGGCTAAGGAGGGTGGATTTCCTGAGTTCACAGGCTGGAGACCAGCCTGATCTAGAGTGAGATTCCCAGCTCTAAAAATAGCTGGCCTT","GGCCAGGTGCAGTGGCTCATGCCTGTAATCCCAGCACTTTGGGAGGCCAAGGTGGGTGGATCACCTGAGGTCAGGAGTTCGAGACCAGCCTGATCAACGTGGTGAAACCCCATCTCTACTAAAATTGCAAAATTA"
"GL873566","9503716","9503881","chr12","63241189","63241340","56","53737473","TATTAAAAAAAAAAGGAATTCAAGGCCAAGAGCAGTGGCTTTTGCCTGTGATACTTCCACTGTAGGAGGCCGAGGTGGAAGGATCACTTGAACTCTGGAGTTTGAGGTTGCTGTGATCTAGGCTGACACCACAGCACTCTAACTTGGTGGGCAACAGAGCAAGACT","AAAAACAAAAATTAGCCAGGTGTGTTGGCATGCACCTGTAGTCCCAGCTACTAGGGAGGCTGAGACAGAAGAATCACTTGAACCCAGGAGGTGGAGGTTGAGTGAGCCAAGATCGCGCCACTGCACTCCAGCCTGGGTGACAGAGCGAGACT"
"GL873566","9537883","9537992","chr16","43341998","43342113","30","33804115","ATGCCTGTAATCCTAGCACTTGGGAGGCCAAGGTGGGTGGATTGCCTGAGATCACAGGTTCAAGACCAGCCTGAGCCAGAGTGAGACCCTGCCTCTAAAATGAGCCAGGT","GCCTGTACTCCCAGCACTTTGGGAGGCCAAGGCGGGTGCATCACCTGAGGTCAGGGGTTCAAGACCAGCCTGGCCAACATGGTGAAACTCTGTCTCTACTGAAAATTCAAAAAATT"
"GL873566","9538266","9538462","chr7","167658032","167658223","54","158119766","TTAATTAATTAATTAAATAAAATGAGCCAGGTGTTGTGATGGGCGCCTGTAGTCCCAGCTACTTGGGAGGTGGAGGCAGGATAATCACTTGAGTCCAGGAGTTGGAAGTTGTTGTGAGCTGTGACGCCATTGTACTTGACCCAGGGCGACATCTTGAGGCGCTCTCTCTCAAAATAAATAAATAAAGAAAGAAAGAA","TACTAAAATACATACAAAAATTAGCCAGGTATGGTGGCAGGCCCCTGTAGTCCCAGCTACTCGGGAGGCTGAGGCAGGAGAACTGCTTGAACCCAGGAGGTGGGGATTGCAGTGAGCTGAGATCGCACCACTGCACTCCAGCCTGAGCGACAGAGTGAGACTCTGTCTCAAAAATAAAAAAAGAAAAAAAAA"
"GL873566","13663722","13663916","chr1","23558411","23558571","70","9894689","CTCAAGACCAGCCTGAGCCAAGAACGAGACTGAAAATAGAAAAATTAGTGGGACGTTATGTTGAGTGCTGGCTACTCTAGAGGGTGAGGTAGGAGAATTGTTTAAACTCATGAATTTAAGGTTGCTGTGAGCTAGGCTGACGCCACAGCACTGTAGCCTGGGCAACAGGCTACAGAACAGAGTGAGACTCTGTTT","AAAAATACAAAAATTATCTGGGCATGGTGGTGGGTGCCTGTATTCCCAGCTACTCTGGAGGGTGAGGCGGGAGAATTACTTGAACCCAGGAGGTGAAGGTTGCAGTGAGCCAAGATCACGCCACTGCACTCTAGCCTGGGCAACAGAATGAGACTCTGTCT"
"GL873566","13664206","13664293","chr7","151280825","151280914","17","137616619","GGCTAGATATGGTGGCTCATGCCAGTAATCTTAGCACTTTGGGAGGCTGAGGGGAGAGGATCACTTGAGCTGAAAAGTTCAAGACCAA","GGCCAGGCATGGTGGCTCATGCCTGTAATCCCAACACTTTGGGAGGCTGAGGTGGGTGGATCACTTGAGGCCAAGAGTTCAAGACCAGCC"
"GL873567","8375378","8375469","chr3","123612391","123612479","29","115237013","GGTTGGGCTTGGTGGCACGTACCTATGATCATCCTAGCTACTCAGGGAGCATAAGGCAGAAGAATTGCTTTAGCCCGGGAGTTGAGATCAAC","TTAGTTGGGCGTGGTGGCGCATGCCTGTAATCCCAGCTTCTCGGGAGGCTGAGGCAGGAGAATGGCTTGATCCCAGGAGATAGAGGTTG"
"GL873567","9062667","9063009","chr7","6620384","6620702","97","2442283","GGCCAGGCGTGGTGGCTCACGCCTGTTGTCTCAGCGCTGTGGGAGGCCGAGGCGGGTGGATCGCCTGTGCTCAGAGGTTCGAGACCAGCATGAGCCAGAGTGAGAGCCAGAGTAAGACCCCCTCTCTACCAAAAATTGCTGGGTGTTCTGGCAGGTGCCTGTAATTCCAGGTACTTGGGAGGCTGAGGCTAGAGAATCACTTAAACCCAGGGACCCAGGGGTTGGCGGAGGTTGCTGTGAGCTATGATTCTATGGTATTCTACTGAAGGACACAAAGCGAGACTCTGTCTCCATAAATAAATAAATAAATAAATAAAATAAAAGCAAAATTAAAAAAAAAAAA","GGCCAGGCACAGTGGCTCATGTCTGTAATCCCAGCACTTTGGGAGGCCGAGGCGGGTGGATTACCTGAGGTCAGGAGTTCTAGACCAGCCTGGCCAACAAGGCGAAACCCTGTCTCTACTAAAAATACAAAAAATTAGCTGGGCGTTTTGGCACATGCCTGTAATCCCAGCTACTTGGGAGGCTGAGGCAGGAGAATTGCTTGAACTGGGGAAGTGGAGGTTGCAGTGAGCTGAGATCACACCATTGCACGCCTGAGCAACAGAGCGAGACTCTGTCTCAAAAAAAAAAAAAAAAAAAAAAAAGAAAAGAAAAAGAAAA"
"GL873567","11215752","11215787","chr1","62915138","62915167","12","51699386","CAATAAAGCAAGACTCTGCCTCCAAAAGAAAAAAAA","CAAACAAACAAACATCACAAAAAAAGAAAA"
"GL873567","11215868","11216117","chr8","45194211","45194474","73","33978343","GGCTGGGTGTGATGGTTCAGGCCTGTAATCCCAGCGCTCTGGGAGACCAAGGCAGGATAGCCTGAGGTTAAGAGTTTGAGACCAGCCTGAGCAACACAAGACCCTGTCTAAACCAGGAAAATTACTGGGGTGTGGTGGCGTGTGCCTTAATCCCAACTACTCAGGAGGCTAGAGTATTGCTTGAGGGCAGAAGACTGAGGTTGCTGTGAGGAAAGGCTAAGGTCAAGCCATTCTAGCCCAGGCAATAGAG","GGCCGGGTGTGGTGGCTCATGCCTGTAATCCCAGAACTTTGGGAGGCCAAGGCAGGTAGATTACCTGAGGTCAGGAATTGGAGACCAGCCTGGCCAACATGGTGAAACCTCTTCTGTACTGAAAATTACCTGGGCATGGTGGCACACGCCTATAATCCCAGCTACTCAGGAGGCTGAGGCAGAATTGCTTGAGCCCGGGAGACAGAGGTTGCAGTGAGCCAAGATCGTGCCACTGTCCTCCAGTCTGGCCAACAGAGCAAGACT"
"GL873567","12342574","12342696","chr3","166690011","166690120","46","154347437","GTACGCGCAAACCAGAAAAATCAACTAGGTGTGGCAGGGCACACCTGTAGTCCCAGCTACTGGGGAGGGTGAAGCAAGAGATTGCTCAAGTCTGAGGTTACAGTGAGTTAAGATGATACCACT","TACACATACAAAAAATCAGCTGGGTGTGGTGGTACATGCCTGTAATCCCAGCTACTCAGGAGGCTGAGGCCGGAAAATCACTTGAACCCAGGAGGCAGAGGTTGCAGTGA"
"GL873567","12342734","12342873","chr8","96368294","96368428","43","84025560","GGCCAAACACAGTAGTTTATACCTATAATTCCAGCACTCTGGGAAGCTGAAGCAGAAGGATCAGCTGAGGTCAGGAGCCTCAAGACAAGCCTGGGCAAGACTAAGACTCCCCTCCATCCCTTCCCCCACTGTCTTCTCAC","GGCCAGACACAGTGGCTCACACCTGTAATCCCAGCTCTTTGGGAGGCTGAGGCAGGCGGATCACCTGAGGTCAGGAGTTCAAGACCAGCCTGGCCAACATGGTGAAACTGCATCTCTACTAAAAATATAAAACCA"
"GL873568","4322030","4322103","chr11","54983169","54983243","11","50661139","GGCCAGGCGCAGTGGCTCATGCCTTTAATCATAGCACTCTGGGAGGCTGAGGTAGGCGGATCTCCTGAGCCAGG","GGCCAGGTGCAGTGGCTCATGCCTGTAATCCTAGCACTTTGGGAGGCCGAGGTGGACCGATCACCTGAGGTCAGG"
"GL873568","4439574","4439747","chr7","26745376","26745549","54","22305802","GGCTGGGCATGGTGCTCACACCTGTAATCATAGCACTCAGGGAGGCCGAGGTGAGTGGATTGCCAGAGCTCACAGGTTTGAAACCAGACAGAGCCTTTTTTTTTTTAGAAGAAATTGTAGGCTGGGCATGGTGCTCATACCTGTAATCATAGCACTTGGGAGGCCAAGGCAAGA","GGCTGGGCATGGTGGCTCACGCCTGTAATACCAGTACTTTGGCAGGCCGAGGCGGGCAGATCACCTGAGGTCAGGAGTTCAAGACCAGCCTGGCCGTTTCTACTAAAAATACAAAAAATTAGCTAGGCATGGTGGTGCGCACCTGTAATCCCAGCTACTCGGGAGGCTGAGGCA"
"GL873568","4546898","4547014","chr15","31980678","31980795","24","27433780","GGCAGGGTGTGGTGTACACCCCTATAATCCCAGCACTTTGGGAGGCTAAGGCAGGAGCATCACCTGGGGCAGGAGTTCAAGGCCAGCCCGGAGAACAGAATGAAACTCCATCTCCAC","GGCAGGGCGTGGTGGCTCACGCCTCTAATCCCTGCACTTTGGGAGGCCAAGGCAGGCAGATCACCTGAGGTCAGAAGTTCAAGACCAGCCTGGCCAATGTGGTGAAACCCCATCTCCA"
"GL873568","5509331","5509406","chr12","122182458","122182528","25","116673127","TAATCCTAGCACCCTAGGAGGCCCAGGTGGGTGGATTACCTGAGCTCAGGAGTTCAAGAGCAAAAGTGAGACCCCT","CCCAGCACTTTGGGAGGCCAAGGCAGATGGATCACCTGAGGTCAGGAGTTGAAGACCAGCCTGGCCAACAT"
"GL873568","5509687","5509883","chr11","2904691","2904882","40","2604996","GTGAGACCCTTGTCTCTACTAAAAGTAGAAAAACTAGCCAGGTGTTGTGGCAGGTGCCTGTAATACCAGCTACTTAGAAGGCTGAGGCAGGAAGATCAGTTGAACCAAAGAGTTTGAGATTGCTGTGAGCTATGATGAAGCCACAGCACTCTACTATCCAGAGCGACAGAGGGAGACTCTGTCTCCAAAAAAAAAAA","GTGAAACCCTGTCTCTACTAAAAATACAAAAATTAGCCAGGTGTGGTGGTGCATGCCTGTAATCCCAGCTACTCAGGAGGCTGAGGCAGGAGAATCACTTGAACCCAGGAGGTGGAGGTTGCAATGAGCCAAGATCGTGCCACTGCACTCCAGCCTGGGTGACAGAGCGAGACTCCATCTCAAAAAAAAAAA"
"GL873568","7119774","7119822","chrX","41233833","41233871","13","34114059","AAAAGTAAAAAATGAGCCGGGTGAGGTAGCTCACGCCTGTAATCCCAGC","AAATCAGCCGGGTGTGGTGGCTCACGCCTGTAATCCCAG"
"GL873568","10881797","10881967","chr1","164648998","164649168","46","153767201","AAAATCACATATTTGCCTGGCATGTTGACTCATGCCCCTATGATCCTAGCACTCTGGGAGGCTGAGGCAGGAGCCTCACTTGAGTCTGTGAGTCTGAGGTTGCTATGAGCAAGGCTGATGCCATGATACTCTAGTGTGGTACAACAGAGTGAGACTCTGTCTCAAAAAAAA","AAAAACACATATTAGCTGGGTATGGTTGTGCGTGCCTGTAATCCCAGCTACTTGGAAGGCTGAGGCAGGAGAATCACTTGAACCCGTGAGGCGGAGTTTGCAGTGAGCTGAGATTGTGCCACTGCACTCCAGCCTGGGCAACAGAGCAAGACTCTGTCTCAAACAAACAAA"
"GL873569","1403943","1404082","chr2","53765152","53765289","48","52361209","AAGCTGAAGCAGAAAAACGGGCTAGAGGTCAAAAGTTTGAGACCTACCGTGGCTACACAGCAAAACTCTGTCTCTAAAAAAAATAAATAAGACCAGGTAAGGTGGTCATGACTATACTCCTAGCCCCTTAAGAGGCTGAG","GAGGTGGGTGGATCACCTGAGGTCAGGAGTTCCAGAACAGCCTGGTCAACATGGCGAAACACTGTCTCTACTAAAAATACAAAAATTAGCCAGGTGTGGTGGCATGCACCTGTAGTCCCCGCTACTCAGGAGGCTGGG"
"GL873569","7343422","7343556","chrX","124155286","124155406","55","116811864","TTTGAAAGTAGACTGCAAACATCATGTTGCTTCACCTCTAAATATATTAATATGGGCCAGGTGCAGTGGATCATGCCTGTAATCCTAGCACTTGCTAGGCCAAGGCTGGCGGATAGCCTGAGCAACAGCGAGACC","ATCAGCCTGACCAACATAGTGAAACCCCATCTCTACTAAAAATGCAAAATTAGCTGGGCGTGGTGGTGCATGCCTGTAATCCCAGCTACTTGGGAGGCTGAGGCGGGAGAATCACTGGAAC"
"GL873569","7404564","7404762","chr6","586928","587122","48","6817636","GAGATCCCATCTCTTAATGAAAATAAAACAATTAGCTGCTATTGTGGCAGGCACCTGTAATTCCAGCAACCCAGGAGGCTGAGGCAGGAGGATCACGTGAACCCCACCAGTTTGAGGTTGCTATGAGCCAGGCTGATGCCAGGACACTCCAGCCTGGGCAACGGAGTGAGACTCCATCTCCAAAAAAAGCAAACAAAAA","GAAACCCCATCTGTACTAAAAACACACAAATTAGTGGGATGTGGTGGCACGTCCCTGTAATCCTAGCTATTCAGGAGACTGAGGCAGGAGAATCACTTGAACCCAGGAGGTGGAGGTTGCAGTGAGCCGAGGTCACACCACTGCACTCCAGCCTGGGCAGCAGAGTAAGACTCCATCTCAAAACAAAAACAAAAA"
"GL873569","7405040","7405133","chrX","21386588","21386682","29","13981548","GGGCAGGGCGGCTCAGGCCTCTAATCCTAGCACTCTGGGAGCTTCCTTGAGCTCAGGAGTTCAAGACCATCCTAAGCAACAGAGATCCCATCTC","GCTGGGCACGGTGGCTCACGCCTGTAATCCCAGCACTTTGGGAAGCCAAGGTTTGAGGTCAGGAGTTCAAGACCAGCCTGGCCAACAGGCTGCAA"
"GL873548","15249374","15249463","chr5","46485072","46485159","19","31235698","GGCCAGGCATGGTGGCTCATACCTATTGTCCTAGCACTGTGGGAAGCCAAGGCAAGTGGATCACCTGAGCTCTAGAGGTTCGAGACCAGC","GGACAGACACAGTGGCTCATGCCTGTAATCCCAGCAGTTTGGGAGGCCAAGGCAGGTGGATCACCTGAGGTACAGAGTTCAAGACCAG"
"GL873548","15817199","15817306","chr7","158031905","158031997","37","142214706","AAAAAAAAAGAGTTGGAGGTTGCTATGAGCAACATCAGCATGGCACTCAATTCCAGGGTGACTGACTGAGACTGTTGTAGCTATACTCCAAAAAAAAAAACACACAAA","CCAGGAGGTGGAGGTTGCAATGAGCCAAGATCACACCACTGCACTCCAGCCTGGGTGACAGGGTGAGATTCTGTCTCAAAAAAAAAAAAAAAA"
"GL873548","15817589","15817786","chr3","3025868","3026088","60","12791721","GGCCAGGCATGGTGGCTTCTGTAATGCCAGCATTCTGGAAGGCTGAGGTAGGCAGTAGCTTGAGCTCAGTAGGAGAACAGCCTGACCAAAAGTGAGACCCTGTCTCTAAAAATAGTCGTTTGTGGTGGTTACCTGTTGTCCCAGCTACTAGGGAGGCTGAGGCAAGAGAATCACTTGAGCGTAAGAGTTGGAGGTTGC","GGCCAGGCACGGTGGCTCATGCCTGTAATCCCAGAACTTTGGGAGGCTGAGGTGGGCAGATCACCTGAGGTCAGGAGTTGGAGACCAGCCTGACCAACATGGTGAAACCCTGTCTCTACTAAAAATACAAAATTAGCCAGGTGTAGTGGCACGTGCCTGTAATCACAGCTACTTAGGAGGCTGAAGTAGGAGAATCACTTGAACCTGGGAGGTGGAGGTTG"
"GL873548","15856498","15856605","chr18","35090078","35090171","38","19233580","CCCCCCCCAAAAAGAAAAGGGTTGCTTGAATCTAGGAGTTTGGGGTTGCTGTGGGCTAAGCTGATACCACAGCACTTTAGCCTGAGCAAACAGAGTGACACTCTGTCT","AAGCAGGAAATCGCTTGAACCCAGGAAGCAGAGTTGCAGTGAGCCAAGATCGCACCACTGCACTGCAGCCTGAGCAACAGAGAAAGACTCTGTC"
"GL873548","15856683","15856877","chr3","3200882","3201085","53","12655801","GCCAGGCACAGTGGCTCATGCCTATAATCCTAGCACTCTGGGAGGCCAAGGCAGGATTGTCTAAGCTTGGGAGTTTGACAGCAGCCTGAGAAAGATTGAGACCCCTGTCTCTACTAAAAAATAGAAAAATTAGCTGAGTGTTGCAGCAGGTGCCTGTATTTCCAGCCAAGGGGGAGGTTGAAAAGGGTCGCTTCA","GGCCAGGCGCAGTGGCTCATGCCTGTAATCCCAGCACTTTGGGAGGCCGAGGCGGGTGGATCATAAGGTCAGGAGTTTGAGACCAGCCTGGTCAACATGGTGAAACCCCATCTCTACTAAAAATACAAAAATTAGCTGGGTGTTGTGGCACATACCTGTAATCCCACCTACTCAGGAGGCTGAGGCAGGAGAATCACTTGAACC"
"GL873549","1940307","1940608","chr12","9481260","9481565","74","7540953","GGCTGGGCGCAGGGGCTCATGCCTGTGACCCTAGCACCCTGGGAAGCCAAGGCGGGCAGATCGCCTAAGCTCACGAGTTTGAAACCAGCCTTAGCTAGAGTGAGACCCCCAATACTAAAAAAATAGCCAGGCTTTGTGATGGGCGCCTGTAGTCCCAGCTACCTGGGAGGCTGAGGCAAGAGAATGGCTCAAGCCCAAGAGTCTGAGGTCACAGTGAGCTACTGACGCCACCGCACTCTATTGGAACAACAAAGTGAGACTGTGTCTCAAACAAACAAACAAACAAACAAACAAAAAAGAAA","GCTGGGCGCGGTGGCTCATGCCTGTAATCCCAGCACTTTGGGAGGCCAAGGCAGGTGGATCACCTGAGGTCAGGAGTTCGAGACCAGCCTAGTCCACATGGTGAAACCCCATCTCTACTAAAAACTAGCCAGGCGTGGTGGTGCGCACCTGTAATCCCAGCTACTCGAGAGGCTGAGGCAGGAGAATCACTTGAGCCTAGGAAGCAGAGGTTGTGGTGAGCTGAGATCACACCACTGCACTCCAGTCTGGGCGACACAGTGAGACTCTTGTCTCAAAAACAAAAAACAAACAAACAAACAAACAAA"
"GL873549","2657819","2658019","chr11","18547798","18548000","50","15889979","GGCCTGGCACTGTGGCTCACACCTGTCAGGTTAACACTCTGGGAGGCTGATATGGGTGGGTCTCCTGAGTTTAGGAGTTTAAGACCAGCCTAATCAAGAGTAAGACCTGCCTTTACTAAAAATAGAAACACTCACCAGGACTACTGTGCACCTACAGTCCCAGCTACCTGGGAGGCTGAGGCAAGAGGATTGCTCAAGCCC","GGCCAGGCACTGTGGCTCACACCTGCAATCCCACCACTCTGGGAGGCAGAGGCAGGTGGATCACCTGAGGTCAGGAGTTTGAGACCAACCTGGCCAACAGAGCAAAACACTGCCTCTACTAAAAATACAAAAACTAGCCAGGTGTGGTGCATGCCTATAGTCCCACCTACTTGGGAGGCTGAAGCAGGAGAATCTCCTGAGCC"
"GL873549","8853848","8853952","chr12","88112976","88113081","32","79259128","AGCCAGCTGTGTGGCTCATTCCAGTAATTCCAGTTACTGGGGAGGCTGAGACAGGAGGATCACTTGAATGCAAGAGGTGGCGAGAACTCAGCTTTAAAAATAAAA","GGCCAGATGCAGTGGCTCATGCCTGTAATCCCAGCACTTTGGGAGGCTGAGGCAGGCGGATCACCTGAGATCAGGAGTTTGAGACCAGCCTGGCCAACATGGTAAA"
"GL873549","10378794","10378882","chr20","18199749","18199840","17","7820955","GGCCAGGCACGGTGGTTCACCTGTGATCCCAGCACTCTGGGAGATAAGGCAGGCTGATCACCTGAGTTCACAGGTTGGAGACCAGCCTG","GGCCGGGCATGGTGGCTCACACCTGTAATCCCAGCACTTTGGGAGGCTGAGGCAGGCGGATCACCTGAGGTCAGGAGTTCGAGACCGGCCTG"
"GL873549","15488169","15488282","chr10","38476693","38476794","41","22988524","CTGAGCACACGGGTTCACACCTGTAATCCCAGCACGCTGAGAAGCCCAGGCAAGAGGCTGACCTCCAGCCTGGGTGACGGAGCGAGATTCCCCCCCACCCCCGACCAAAAAAAA","CTGAGCGCTGGTAGCTTACACCTGTAATCCCAGCACTTTGGGAGGCCTAGACAGGCGGATCACTTGGGGTCAGGAGTTTGAGACCAGCCTGGCCAATATGAT"
"GL873549","17403348","17403519","chr10","38461164","38461337","46","21057816","GCCAGGCACAGTGGCCCACACCTGTAATCCCAGTACTGTGGGAGGCTGAGGCAGGCTGAGGCAGGCATGGATCACTGAGGTTGCTGTGAGCTAAGATGCCATGGCCCTCCACCCAAAGTGACAGAGTGAGACTCTGTCTCAGAATTAAAAAAAACAAAGAAAGAAAAATAAA","GCCAGGCATGGTGACTCACGCCTATAATCCCAGCACTTTGGGAGGCTGAGGCATGAGAATCACTTGAACCCAGAAGGCAGAGGTTGCAGTGAGCTAAGATTGTGCCACTGTACTCCTGCCTGGGTGATGGAGTGAGACTCTGTCTCGATTTAAAAAAAAAAAAAAAAAAAAAAA"
"GL873550","801968","802043","chr15","50500527","50500602","20","49698559","GTAGCCAGGTATGGTAGTGCAGGCCTGTACTCCCAGCTACTTGGAAAGCTAAGGCAATAGAATCATTTAAGCCCAG","TGGCCGGGCATGGTGGTACATGCCTGTAATCCCAGCTACTTGGGAAGCTGAAGCAGGAGAATTGCTCGAACCCAGG"
"GL873550","802343","802376","chr3","33494224","33494257","9","32691881","TAAGACTTTGTCTCTACTAAAAATAGAAAAAGTG","GTGAAACCCGTCTCTACTAAAAATACAAAAATTA"
"GL873550","2805841","2805900","chr2","93673843","93673900","18","90868002","CTATTCAAAATAGCTAAAATGGGCAGGGCAAGGTGGCTCACACCTGTAATCCCAGTACTC","TAAAAATGTAAAAGATTGGCCGGGTGTGGTGGCTCACTCCTGTAATCCCAGCACTTTG"
"GL873550","4153085","4153214","chr16","18855701","18855834","37","14702616","GGCAGGGCTTGGTGGTAAAAGCCTGTAATCCTACCACTCTGGGAGGCAGAGGTGGTTAGATTGCATGAGGTCACTGGTTGGAGACCAGCCTGAGCTAGAGCAAGACCTCATCTCCAAAAATAGCAGGGCT","GGCTGGGCGCGGTGGCTCACACCTGTAATCTCAGCACTTTGGGAGGCCGAGGTGGGTGGATCACCTGAGGTCAGGAGTTCGAGACCAGCCTGGCCAACATGGCAAAACCCCATCTCTACAAAAATACAAAATTA"
"GL873550","4153472","4153634","chr7","17472856","17473028","43","13319384","AATAAAAATAGCAGGGCTTTGTGGCGGGCACCTGTAGTCCCAGCTACTTGGGAGGCTGAGGCAAGACAATTGCTTGAGCACAAAGTTGGAGGTTGTTGTGAGCTGTGACATCATAGCACTCTACCAAGGGAGATAGAGTGAGACTATCTCGAAGAAAAAAAAA","ATACAAAAATTAGCCAGGTGTAGTGGCGTGCACCTGTAATCCCAGCTACTCGGGAGGCTGACGCATGAGAACTGCTTGAACTCAGGAAGTGGAGGTTGCAGTGAGCTGAGATAGTGCCACTGCACTCCAGCCTGGGTGACAGAGCAAGACTCCATCTCAAAAAAAAAAAAGAA"
"GL873550","6050671","6050965","chr7","84009904","84010193","74","77959233","GGTGGCTCACGCCTGTTATCCTAGCACTCCAGGAGACTAAGGTAGGAGGATGCCTTGCTTGAACTCAAGAGTTCAAGACCAGTCTGAGTGAGAGGGAGACCCTGCGTCTACTCAAAAATAGAAAAATTTACCAGCCATTGTGGCCAACACCTGTAGACCCAGCTATTCAGGAGTCTGAGGCCAGAGAATCACTTGAACCCAGGAGACTGAGATTGCTGTGAGCTAGGCTAAAACCATGGCACTCTAGCCCAGGTGGCAGAGTGAGACTGGGTCTGCAAAAAATAAATAAAAACAA","TGGCTCATGCCTGTAATCCTAGCACTTTGGGAGGCCAAGGCAGGTGGATTGCCTGAGCTCAGGAGTTCAAGACCAGCCTGGCAACACGATGAAACCCCGTCTCTATTAAAAAATACAAAAAATTGGCCAGGCATGGTGGTGTGCACCTGTAATCCCAGCCACTCAGGAGGCTGAGGCAGGAGAATCGCTTGAACCCGGGAGACAGAGGTTGCAGTGAGCCAAGATCGAACCATTGCACCCCAGCCTGGGTGAGAGTGAGACTCTGTCTAAAAAAAAAAGAAGAAAAAGAA"
"GL873550","6212004","6212068","chr19","50425309","50425373","23","44213305","AGAACCTAAGAGTTTTGAGGTTGCTATGAGCTGGACTGATACCATAGCATTCTAGTCTGGGTGAC","TGAACCCAGGAGGTGGAGGTGGCGTGATGCCCAAGATGTGCCACTGCACTCCAGCCTGGGTGATA"
"GL873550","6212319","6212418","chr17","89042086","89042197","34","82829767","CTGTCTTTTCTAAAAATAGAAAAACTAGCTGGGTTGTGGTGGGCACTTGTAGTCCTAGGTACTCTGAGGCTGAAACAGGATTGCTTGAACCTAAGAGTTT","GTCTCTACTAAAAATACAAAAATTAGCCGGGCATGCTGGTGGGCACCTGTGATCTCAAGCTACTTGGGAGGCTGAGGCAGGAGAATCACTTGAACCTGGGAGGCAGAGGTTG"
"GL873550","6504310","6504401","chr19","2969698","2969794","27","3534612","GTGCTGGTGTATGCACCTGTCATACCAGCTACTCCTGAGGTTGAGGCAGGATAGCTTGAACCCGGGAGTCTGAGACTGCAGTGAGCTGGGAT","TTAGGCGTGGTGCATGTCTGTAATCCCAGCTACCCGAGAGGCTGAGGCAGGAGAATCACTTGAACCTGGGAGGCGGAGGTTGCAGTGAGCCGAGATC"
"GL873550","7178331","7178523","chr19","40691105","40691269","60","33512774","GGCCAGACGCGGTGGCTCACGCCTGTTGTCCCGGCACTGTGGGAGGCCGAGGCTGGTGGATCCCCTGAGCTCAGCCAAGTTCAAGACCAGCGGAAGACCAGCATGAGGCAGAGTGAGCCAGAGTGAGACCCCGTCTCTACAACAACAACAACAAAAAATAGCCGGACCTTGTGATCCCAGCTACATGGGAGGC","GGCCGGGCATGGTGGCTCACGCCTGTAATCCCAGCACTTTGAGAGGTCGAGGCAGGTGGATCACCTGAGGTCAGGAGTTCGAGACCAGCCCGGCCAATATGGTGAAACCCCTTCTCTACTAAAAATACAAAAAATTAGCCGGAAGTGGTGGCATGCACCTGTGAT"
"GL873550","7981631","7981790","chr6","148611209","148611366","40","140629578","ATAGCCCCGCCTTGTGGTAGGCTCCTGTAGTCCCAGCTACTTGGGAGGCTGGGGCAAGAGAATCACTTAGGCCCAAGAGTTGGAAGTTGCTGTGAGCTGTGATGCTACAGCATTCTACTGAGAGTGACAAAATGAGACTCTGTTTAAAAAAAAAAAAAAA","TTAGCTGGGCATGGTGGCAGGTGCCTGTAATCCCAGCTACTCTGGAGGCTGAAGCAAGAGAATCGCTTGAACCCAGGAGGTGTAGGTTGCAGTGAGTCGTGCCACAGCACTCCATCCTGGGTGACAGAGCAAGACTCTGTCTCAAAAAAAAAAAAAAA"
"GL873550","7982053","7982180","chr2","182489403","182489528","28","174507350","GGCTGGGCGAGGTTGTTCAGACCTGTAATCCTAGCACTCTGGGAGACCAAGATGGGTGGATTGCCTGAGTTCATGAGTTTGAGACCAGCCTGAGCCAGAGTGAAACCTTGTTCTCTAAAAATAGCTCG","GGCCGGGTGTGGTGGCTCATGCCTGTAATCCTAGCGCTTTGGGAGGCCGAGGTGGGTGGATTGCCTGAGCTCAGGAGTTCGAGACCAGCCTGGGCAACACGGTGAAACCTGTCTCTACTAAAATAC"
"GL873550","8404122","8404320","chr4","121405930","121406135","43","113001808","GGCCAGGCACAGTGACTCACACCTGAAATCTTAGTACTCTGGGAGGCCAAGGTGGGAGGATTTCCTGAGGTCAGGAGTTCAAGACCAGCCAGAGCAAGAAGATCCTGTCTCTACTAAAAGTATAAAAAGTGAACCAAGTGTGGTAGTGAGCACCTATAATCTCAGCTACTTGGGAGGCCGAAGCAAGAGGATCACTTGA","GGCCAGGCACAGTGGCTCACACCTGTAATCTCAACACTTTGGGAGGCCAAGGTGGGTGGATCACCTGAGGTCAGGAGTTTGAGACAAGCCTAGCCAGCATGGTATAACTCCATCTCTACTAAAAGTATAAAAATCAACCAGGTGTGGTGGCACATGCCTGTGGTCCCAGCTACTTGGGAGGCTGAGGCAGGAGAATCACTTGAATC"
"GL873550","8404408","8404483","chr15","701469","701538","22","7702939","AGGATCTCTTGAGCTCGGGAGTTTGAGGTTGCAGTGAGCCAGGCTGATGTCATGGCACGCTACCCAAGACAACAAA","AATCACTTGAACCCAGGAGGCAGAGGTTGCAGTGAGCCAAGACTGTGCCATGGCACTCTAGCCTGGGCAA"
"GL873550","11648593","11648682","chr3","124881947","124882027","31","113233354","GTGGCTCACACTAGTAATCTTAGTACTTTGGGAAGCTGGGGCAAGAGGATCACTTGAGGTCAGGGTTAGGAAACTCTATCACTACAAAAA","GCGGTGGCTCACGCCTGTAATCCTAGCACTTTGGGAAGCCAGGCAGGCAAATCACGAGGTCAGGAGTTCGAAACCAGCCTG"
"GL873550","12468624","12468663","chr9","62916303","62916339","11","50447679","GCCCGGCTTGGTACCTCATGCCTGTAATCTTAGCACTCCG","GGCCGGGCATGGTGGCTCATGCCTGTAATCCCAGCAC"
"GL873550","12468943","12469188","chr12","70524409","70524645","91","58055466","AATCTTAGCACTCCGGGAGGCCGAGGCGGGTAGACCAACCTAATCAAGAGCAAGATCTACCTCTACTAAAAATAGAAAAGAATTGGCCAGGCGTATTGACTCCGCCTCTAGTGCCAGCTACTCCAAAGCTGAGGCAAGAGGATTGTTCAAATCCAAGAGTTTGAAATTGCTGTATGTTACACCAGGGCACTCTAGCCGTGGAGACATTTTCTCTATATATATTAAAAAAAACAAAAAACAGAAAAA","CTGAGCTCGGGAGTTCGAGACCAGCCTGACCAATATGGAGAAACCCTGTCTCTACTAAAAATGTAAAATTAGCCAGGCATGGTGGCACATGCCTGTAGTCCCAGCTACTCAGGAGGCTGAGGCAGGAGAATCGCTTGAGGTCAGGAGGCGGAGGTTGCAGTGAGCCAAGATCATGCCACTGCACTCCAGCCTGGGTGACAGAGTGAGACTTTGTCTCAAAAAAAAAAAAAAAAAAAA"
"GL873550","14719674","14719880","chr16","30390993","30391163","76","15671319","GGGCGTGGTTGCTCACGCCTGTTGTCCCAGCGCTGTGGGAGACCGAGGCAGATGTATCGCCTGAGCTCAGCCGAGTTCGAGTTCGAGACCAGCGGAGAGACCACCATGAGGCAGAGTGAGCCAGAGTGAGACCCCGTCTCTACAACAACAACAAAGAAAACAGCCGGATCTTGTGATCCCAGCTACATGGGGGCCAAGAGAATCACT","GGGCACGGTGGCTCACACCTGTAATCCCAGCACTTTGGGAAGCCAAGGCAGGAGGATCACCTGAGGTCAGGAGTTCAAGACCAGCCTGGCCAACATGGTGAAACCCCGTCTCTACTAAAAACACAAAAATTAGCCAGGTGTGGTGGTGCACGCTTGTAATCCCAGCTACTC"
"GL873550","15737883","15738154","chr2","20481557","20481833","73","4743674","TTAGCATTCTGGGAGGCCAAGTCAGGTGGATTGCCTGAACTCACAAATTTGAGACTAGCCTGAGATAGAGAAAGATCTTGTCTCTAAAAAAAAAAAAAAATAGCTGGACTTTGTAGTGGGCACCTGTAGTCCCTGCTACTCAGAAGGCTGTGGTAAGAGAATCACTGGAACCCAAGAGTTAGAGGTTGCCGTGAGCTGTGATGCCATGGCACTCTACCAGAGACAACAGAGTGAGACTCTCTCCAAAAAAAAGAAAAAGAAAAAGAAAAAAA","GCACTTTGGGAGGCCAAGGCAGGTGAATCACCTGAGATCAGGAGTTCAAGACCAGCCTGGGCAACATGATGAAACCCTGTCTCTATGAAAAATACAAGAATTAGCTGGGCATAGTGGTGTGCATCTGTAATCCCAGCTACTCAGGAGGCTGAGGTATGAGAATTGCTTGAACCCTGGAGGCAGAGGTTGCAGTGAGCCGAGATGACACCGTTGCACTTCAGCCTGGACAATAGAGAGAGACTCTGTCTCAAAAAAATGAAGAAAAGAAAGAAAGAAA"
"GL873550","15738844","15738873","chr10","65896918","65896951","9","50158074","GGGTGTGGTGGCTGATGCGTGTAATCCTAG","GGCTGGGCGTGGTGGCTCATGCCTGTAATCCCAA"
"GL873550","16345151","16345329","chr1","6754007","6754209","69","9591144","CACCTGTAATCCCAGCACTTGGGAGGTTGAGGAGAGTGGATTGCCTGAGCTCACAGGTTTGAGCCAGAAGGAGACCTCGTCTGTAAAAATAGCTGGGTGTTGAGACCAGCGCCTTTAGTCCCAGCTACTTGGGAGGCTGAGGCAAGAGAATCACTTAAACAATTCTAGAAGCAGAGTTT","CTGTAATCCCAGCACCTTGGGAGGCTGAAGAGGGCGGATCACCTGAGGTCAGGAATTTGAGACCAGCCTGGCCAACATGGTGAAATCCCATCTCTACTGAAAATACAAAATTAGCTGGGTGTGGTGGTGCATGCCTGTAGTTCCAGCTACTTGGGGAGCTGAGGCAGAAGAATGCCTTGAACCCGGGAGGCAGAGGTTGCAGT"
"GL873550","17727115","17727274","chr1","127857902","127858038","52","110130787","GCTGGGTGCAGTGACCCCTGCCTATAATCCCAGCAGTTAGGAGACAAAGGCAGGAGGAATTACCTGAGAGCAGGAGTTCCAGACAAGCCTCAGACCAGCGTGAGCTATGACATTGTCTGTAGCCCCCACCCCACCCCCCCAAAAAACAAAAAGAAACAAA","GGCTGAGTTCAGTGGCGCACGCCTGTAATCCCAGCAGTTGGGAGGCTGAGGCAGGTGGATTGCCTGAGGTCAGGAGTTCAAGACCAGTCTGGCCAACATGGTGAAACTCTGTCTCTACTAAAAAAAAAAAAAAAAAT"
"GL873551","6567068","6567102","chr14","109767086","109767123","14","103200018","GGATCACATGAGGTCAGGAGTTCAAGATCAGCCTG","GGAGGCAGAGGTTGCAGTGAGCCAAGACTGCGCCATTG"
"GL873551","9393264","9393376","chr1","39198637","39198744","32","29805373","CAAGAGTATCTCTGCAACCCAGTGGCCTGAGGTTGCTATGAGCTAGGATGCCACAGCACTCTACCCAAGGGGACAGAGTAAGACTCTGTCTCCAAAAAAAAAAAAGAGCAAAA","AGAATCGCTTGAACCTGGGAGGCGGAGGTTGCAGTGAGACCAGATCATGGCACTGCACTCCAGCCTGGGCGACAGAGTAAGACTCGGTCTCAAAAAAAAAAAAAAAAA"
"GL873551","9393708","9393894","chr12","115674238","115674427","40","106280530","GCTGGGCTCAGTGCCTCTCGCCTGTAATCCCAGCACGCTGGGAGCCTGAGGTGGGTGGGTTGCTTGAGCTTAGGAGTTCAAGACCAGCCTGAACCAGAGCAAGACACTATCTCTACTAAAAATAGAAAAACTATCTGGGCATGGTGGTGCGCACCTGTAGTCCCAGCTACTAGGGAAGCTGAGGCAA","CCAGGCCTGGTGGCTCACGCCTGTAATCCCAGCACTTTGGGAGGCCGAGGTGGGTAGATCACCTGAGGTCAGGAGTTCAAGACCAGCCTGGCCAACATGGCGAAACCCCATCTCTACTAAAAATACAAAAATTAGCTGGGCATGGTGGTGTATGCCTGTAATCCCAGCTACTCGGGAGGCTGAGGCAGGA"
"GL873551","10104594","10104683","chr16","53032852","53032939","31","42928258","GGTAGGTGGGTCTCTCGAGGTTAGGAGCTCTTTACCAGCCTGAGCTGACATAAGACCCAATCTCCACCAAAATAGAGAGAGAAAAAAAGA","GAGGCAGACAAATCTCTTGAGGTCAGGAGTTGAAGACCAGCCTGGGCAACATAGACCTCGTCTCTATTAAAAAAAGAAAAAAGAAAAA"
"GL873551","12307468","12307551","chr8","94102375","94102458","19","81794907","GGCCAGGCATAGCAGCTCATGCCTGTAGTCCTATTATTCTAGGAGGTCCAGGGAGGAGGATCACCTGAGATCAGAAGTTCAAGA","GGCCAGGCATGGTGCCTCATGCCTGTAATCCCAGTACTTTGGGAAGCCAAAGTGGATGGATCACCTGAGGTCAGGAGTTCGAGA"
"GL873551","13335872","13336095","chr4","85819795","85820026","56","72483923","GCCAGGTACAGTAGCTCAGGCCTGTAATCCTAGCACACTGGGAGGCTGAGGTGGTGGATCCTTGAACTCATGAATTCAAGACCAGCCTGAGGAAGAGCAAGACCCCATCTCTCCTAAAAATAGAAAAATTAGCTGGTGTCATGGCAAGTGTCTGTAATCCCAGCCACACAGGAGGCTGAGGCAAGAGGATCTCTTGAACCCAAGACACTAAAGTTACTGGGAGC","GCCGGGCATAGTGGCTCATGCCTGTAATCCCAGCACTTTGGGAGGCTGAGATGGGTGGATCATCTGAAGTTAGGGGTTCGAGACCAGCCTGGCCAAATGGCAAAAACCCATCTCTGCTAAAAATACAAAAATTAGCCAGACATTGTGGCATGTGCCTGTAATCCCAGCTACTCAGGAAGCTGAGACAGGAGAATCGCTTGAACCCAGGAGGCAAAGGTTGCAGTGAGCCAAG"
"GL873552","1195303","1195426","chr3","54039332","54039457","34","52844029","CTACTCTGGATGCCAAGGCAGCGGGATCACTTGAACCCCAGAGTCTGAGGTTGCTGTGATCTCAGCTGACTCCATGGCACACTAGCCTGAGGCAACAGACTGAGACTATATCTCAAAACAAAAA","AGCTACTCAGGAGGCTGAGACAGGGAGAGTCACTTGAACCCAGGAGGCAGAGTTGCAGTGAGCCGAGATCACGCCAACTGCACTCCATGCCTGGGCAACAGAGTGAGACTCCGTCTCAAAAAAAAA"
"GL873552","15010293","15010428","chr1","29437872","29437991","29","14427579","GGCCGGGCGTGGTGGCTCACGCCTGTATTCCCAGCGCTATGGGAGGCCGAGGCGGGTGGATCACCTGTGCTCAGAGGTTCGAGACCAGCCAAGACCCCCCTGAGCCAAACGAGCCAGAGTGAGACCCCGTCTCTAC","GGCCGGGCGTGGTGGCTCACGCCTGTAATCCCAACATTTTGGGAGGCCAAGGCGGGTGGATCACCTGAGGTCAGAAGTTCGAGACCAACCTGGCCAACATGGTGAAACCCCTGTCTCTAC"
"GL873553","860627","860695","chr1","16024119","16024187","13","15163492","GCCAGGCTCAGTGGCTCACGCCTATAATCTTAGCGCCTTTTGGAGGCCAAGGTGGGGGGATTACCTGAG","GGCCAGGCACGGTGGCTCACGCTTGTAATCCCAGCACTTTGGGAGGCCGAGGAGGGTGGATTACCTGAG"
"GL873553","7206820","7206939","chr3","156098583","156098705","38","148891763","AGCTAGGTATGGCAGCTGACATCTGTAACCCTAGCCCTCTGGCAGGCCAGGAATTCAAGACCAGCCTAGACAACATAGTAAGACCCCATCTCTACCAAAAATAATTTAAAATTGGCCAGG","GGCTGGCTGTGGTGGCTCACACCTGTAATCCCAGTACTTTGGATCATGTGAGGTCAGGAGTTCAAGACCAGACTGACCAACATGGTGAAACCCTGCCTCTACTAAAAATACAAAATTAGCCAG"
"GL873553","10985147","10985407","chr12","94325498","94325767","64","83340351","GGCCTGTGGCAGTGGCTCATGCCTGAAATCCTAGCACTCTGGGAGGCTGAGGTGGGTCGATTACCTGAACTCACCAAGACGGAGACCTCATCTCTACTAAAAATAGAAAAACTAGCTGGGCGTGGTGGCAGGTGCCTGTAGTCCCAGTTACTGGGGAGGCTGAGGCAAGAGAATTACTTGAACCCAAGAATTTGAGGTTGCTGTGAGCTATGATGCCACAACACTCTACTCAGGGTGACGGAATAAGACCCTGTCTCAAAA","GGCCGGGTGTGGTGGCTTATGCCTGTAGTCCCAGCACTTTGGGAGGCCGATGGGGATGGATCACCTGAGGTCACTGGCCAACACAGAGAAACCCCATCTCTACTAAAAATACAAAAATTAGCCAGGCGTGGTGGCATGTGCCTATAATCCCAGCTACTTGGGAGGCTGAGGCAGGAGAATCACTTGAACCCGGTAGGCAGAGGTTGCAGTGAGCCGAGATTGTGCCACTGCACTCCAGCCTGAGTGACAGAGCAAGCCTCTGTCTCAAAA"
"GL873553","10985438","10985466","chr16","73760336","73760365","6","62774898","CATAAAAAGAAAGAAAACTGAAAAGAAAA","GAAAGAAAGAAAGGAAAAGAGAAAAGAAAA"
"GL873553","12443178","12443505","chr1","3864926","3865253","98","8578252","GCAGGGTGGGGAGGCTCGCACCTACATCCCCAGCACCCTGGAAGGCTTAGGCAGGTGGACTGGGTTCAGGAGTTGGAGAGCAGCCTGAGCAATAGTGAGATTCTGTCTGCAGTAAAACTAGAAAAATTATTTAGGGGTTGTGCTGGGTGCCTATTATCCTAGCTACTGTTGAGGCAAGGGGACAGCTTGAACCCAGGATTTTCAGGTTTCTGTGAGCTAGGATGATGCCATGATGACCCTCTGACACTTTGCCTGGGCAGTAGAGTGAAACTCTGTCTCAGAAAAAACAAAACAAAACAAAACAAAACAAACAAACAAACGAAAAAAA","GGCCAGGCGTGGTGGCTCACACCTGTAATCCCAGCACTTTGGGAGGCTGAGGCAGGTGGATCACCTGAGGTCAAGAGTTCAAGACCAGCCTGGCCAACATGGTGAAACTCTGTCTCTACTAAAAATACAAAAATTAGCCGGGCATGGTGGTGCATGCCTGTAATCCCAGCTATTCGGGAGGCTGAGGTAGGAGAATAGCTTGAACCCGGGAGGTGGAGGCTGCAGTGAGCTGAGATCATGCCATTGCACTGTAGCCTGAGCAACAGAGAAAGACTCTGTCTCAAAAAACAAAACAAAACAAACAAAAGAACAAAAACAAACAAACAAA"
"GL873553","15121135","15121247","chr1","111354387","111354508","21","96233252","GGGCGTGGTGGCTCACACCTGTAATCCCATCACTTGGGAGGCTGAGGCAGGTGGATCACCTGACCTCAGGAGTTCGAGACCAGCCTGAAGAAGAGTGAGACCCCGTCTCTAAA","GGCCGGGCGTAGTGGCTCACACCTGTAATCCCAGCACTTTGGGAGGCCGAGGCGGATGGATCACCTGAGTTCAGGAGTTTGAGACCAGCCTGACCAAAGTGGTGAAACCCCGTCTCTACTAA"
"GL873553","15121274","15121455","chr7","68420775","68420939","69","53299501","AGATTTCAACAGGCCTAATGGCTTTAGTATATAAAGAGAACTTATAAAGCCAGACTCAGTGGCTTACATCTATAATCCAGGTACTTGGTAGGTTGAAGTGAGAAGATTCTTTGAGCCAGGATTTCCAGCCCAGCCTAGGCAACACAGAGAGACCCCCATCTCTAAAAGAGAAAGGTAAAAAA","GGCTAAAGGGGTGCTCATCTTAAGAATACCAGGCCAGGCGCAGTGGCTCATGCCTGTAATCCTAGCATTTTGGGAGGCTGAGGCGGGTGGATCACCTGAAGTCAGGTGTTTGAGACCAGCCTGAACAACATAGTGAGACCTCATCTCTAATTAAAAAAAGAAAAA"
"GL873553","15614197","15614298","chr4","71691062","71691163","34","56076865","GGTGGCTCACACCTGTTATCCCCATACTCTGGGGGCCTGAGGTGAGAGGATCCCCAGAAGTCAGGAGCTGGAGAGAAGCCTGTGTAAGAGTAAGAGCCAGTC","GTGGCTCATGTCTGTAATCCCAGCACTTTGGGAGGCCGAGGTCGGTGTATCATTTGAAGTCAGGAGTTTGAGACCAGCCTGGCCAACGTGGTGAAACCCTGT"
"GL873553","16849767","16850040","chr1","96770987","96771267","68","79921220","GGCCAGGAGTGGTGGCTCATGCCTGCAATCCCAGCACTTGGGAGGCCAAGGTGGGTGGATTGCCTGAGCTCACAGGTTCAAGACCAGCATGAGCCAGAGAGAGACCTTGTCTCTAAAAATAGGCACAGGTTGTGGTGGGCACCCGTAGTCCCAGCTACTTGGGAGGCTGAGGCAAGAGAATCACTTAAGCCCAGGAGTTTGAGGTTGCTGTGAGCTAAGACACCACAGCACTCTACCAAGGGTGACAAAGTAAAACTCAGATTTTTTTAAAAAA","GGCCAGGTGTGGTGGCTCACAGCCTGTAATCCCAGTAGTTTGGGAGGCCGAGGTGAGCAGATCACCTGAGGTCAGCAGTTCGAGACCAGCCTGGCCAACATGGCAAAACCCTATCTCTACTAAAAGTACAAGGTGTGGTGGCACACACCTGTAGTCCCAGCTACTTGGGAGGCTGAGGCAGGAGAATCACTTGAACTCCAGAGGTGGAGGTTGCAGTGAGCCAAGATTATGCCACCGCATTCCAGCCTGGGTGACAGAGTGAGACTCCGTCTCCAAAAAAA"
"GL873554","511555","511741","chr6","166828248","166828429","56","166316693","GTGGGACCCGCATCTATACTAAAAATGAAAAACTAGTCAGACTTGGTGACTCATGCCTATAATTTCAGTTTCTTGGGAGGTGAAGGCAGAAGAATTGCTTGATCCCAGGAATCTGAGATTGCTGTGAGCTAGGCTAACACTATGGCACTCCAGCCCAGCTGACAGAGTAAGACTTTGTCTTTAAAAA","ACCCCATCTCTACTGAAAATAGAAACATTAGCCGGGCTTGGTGGCATGCGCCTGTAGTCCCAGCTATTTGGGAGGCTGAGGCAGGAGAATTGCTGGAACCCAGGAGGCAGAGATTGCAGTGAGCGGAGATCATGCCATTGCACTCCAGCCTGGGCGACAGAATGAGGCTCCATCTCAAAAAA"
"GL873554","2046660","2046725","chr8","51862362","51862427","7","49815702","GGCTGGCCGCGGTGGCTCACGCCTGTAATCCTAGCACTCTGGGAGGCCGAGGCAGGCAGATCACCT","GGCCGGGCACGGTGGCTCACACCTGTAATCCCAGCACTATGGGAGGCCGAGGCAGGTAGATCACCT"
"GL873554","2580766","2581036","chr13","93262937","93263229","81","90682171","GGCCTGGGCAAGGTGGCTCACTCTCTGGAAGGCTGAGGCAGATGGATTGCCTGAGCTCAGGAGCTAGAGACTAGCATGATCTCACCTCTACTAAAAATAGAGAAACTAGCCAGGCATTACAGCACACGCTTGCAGCCCCAGCTACTCTGGGGGCTGAGGCAAAAGGATCACTTGGACTCAAGAAACTGAGGTTCCTGTGAGCCATGATGCCAGGACACTCTACCCAGGGAAACAGAGTGAGACTTCATCTCAAAAAAAAAAAGAAAGAAAA","GGCTGGGTGCAGTGGCTCACGCCTGCACTTTGGGAGGCCAAGGCAGGTGGATCACCTGAGGTCAAGAGTTTGAGACCAGCCTGGTCAACATGGTGAAACCCCATCTCTACTAAAAATACAAAAATTAGCCAGGCATGGTGGCACGTGCCTGTAATCTCAGCTACTCTGGAGGGTGAAGCAAAAGAATCACTTGAACCCAGGAGGCAGAGGTTGCAGTGAGCCAAAATCATGCCACTGCACTCTGGCCTGGGCAACAGAGTGAGACTCCATGTCAAAAAAAAAAAAAAAAAAAA"
"GL873554","5465741","5465829","chr11","47014803","47014890","15","41549062","GGCCAGGCATGGTGGCTCACGCCTGTAGTCCCAGCGCTGTGAGAGGCCGAGGCGGGTGGATCACCTGTGCTTAGAGGTTCGAGACCAGC","GGCCGGGCACCGTGGCTCACGCCTGTAATCCCAGCACTTTGGGAGGCCAAGGCGGGTGGATTACCTGAGGTTAGGAGTTCGAGACTAG"
"GL873555","8807785","8807956","chr1","12240468","12240612","48","3432683","GGCCGGGCGTGGTGGCGCACGCCTGTAGTCCCAGCGCTATGGGAGGCCGAGGCGGGTGGATCACCTGAGCTCAGAGGTTCGAGACCAGCCAAGACCCCCCTGAGCCAAACGAGCCAGAGTGAGACCCCGTCTCTACAACAACAACAGGACAACAAAACAGCCGGACCTTGTG","GGCCGGGCGCGGTGGCTCATGCCTGTAATCCCAGCACTTTGGGAGGCTGAGGCGGGTGGATCACCTGCGGTCAGGAGTTCGAGACCAGCCTGGCCAACGTGGTGAAACCTCATCTCTACTAAAAATATAAAAATTAGCTGGTGTG"
"GL873555","8828420","8828440","chr3","5439989","5440005","4","3388431","ATAATAATAATAATAAATTAG","ATAATAATAAAATAAAA"
"GL873555","12399534","12399604","chr15","102111398","102111458","22","89711864","GGCCAGGCATGGTGGCTCACACCTATAATCCTGGGAGGCTGAGGATTATCTGAGCTCAGGGATGTGAGACC","GGCCAGGCACGGTGGCTAAGGCCTGTAATCTGGGAGGCTGAGATGGGTGGATCACCTGAGG"
"GL873555","12440877","12440963","chr19","21209507","21209590","24","8768630","GTGGGGAGTGCACCTGAACTTTGGAGTTCAAGACCAGCCTGGGCAACATTGTGTGAGCCCTGTCTCAATTGGAAAACAAAACAAAAA","AGGTGGGCAGATCACCTAAGGTCAGGAGTTCAAGACCAGACTGGCAAAAATGGTGAAACCCTGTCTCTACTAAAAATAAAAAAA"
"GL873555","13094462","13094529","chr1","100916857","100916922","22","87822395","GCTTGTACCTATAATCCTGGTACTTTGGGAGCCTCAGGAGAGTGGATCACCTGAGTAAGAGCAAGACC","CATGCCTGTAATCCCAGCACCTTGGGAGGCCAAGGTGGGTGGATCACCTGAGGTCAGTAGTTTGAG"
"GL873555","13254579","13254784","chr7","32729330","32729532","64","19474751","GACCAATCTAAGCCAGAGCTGTCTATGCTAAAAATAGAATAATAAGCCTGGTTTATGGTAGGAGCCTGTAGTCTCAGTTACCTGGGTGTCTGGGGCAAGAGATTGACTTAAAACCAGGAGTTTGAGGTTGCTGTAAGCTAGGCTGACACCACAATACTCTAATCTGGGCAGAGTGAGATTCTGTCTCAAAAAAAAAAAGAAAGAAA","GAAACCCCATCTCTACTAAAAATACAAAATTAGCCAGGCATGGTGGTGCACACCTGTAGCTCCAACTACTTGGGAGGCTGAGGCAGGAGAATCACTTAAACCCAGGCAGTAGAGGTTGCAGTAAGCCAAGATCGCACCACTGCACTCCAGTCTGGGCAACAGAGTGAGACTCTGTCTCAAAAAAAAAAAAAAAAAAAAAAAAA"
"GL873555","13255065","13255153","chr10","29045352","29045442","23","15790287","CTGGGCACAGTGGCTGAGGGTGTAATCCTACCACCCTAGGAGGTTGAGGCAGAAGGATCACTTGAGCTCAGGAATTCAATACAAGTCTA","GGCGGGGCACAGTGGCTCATGCCTGTAATCCTAGTACTTTGGGAGGTCGAGGCGGATGGATCATCTGAGGTCAGGAGTTTAAGACCAGTCT"
"GL873555","13262783","13262918","chr1","29437872","29437991","30","16175089","GGCCGGGCGTGGTGGCGCACGCCTGTAGTCCCAGCACTATGGGAGGCTGAGGCGGGTGGATCACCTGTGCTCAGAGGTTCGAGACCAGCCAAGACCCCCCTGAGCCAAACGAGCCAGAGTGAGACCCCGTCTCTAC","GGCCGGGCGTGGTGGCTCACGCCTGTAATCCCAACATTTTGGGAGGCCAAGGCGGGTGGATCACCTGAGGTCAGAAGTTCGAGACCAACCTGGCCAACATGGTGAAACCCCTGTCTCTAC"
"GL873556","639117","639366","chr1","62410822","62411038","72","61771705","GGCCGGGTGTGGTGGCTCATGCCTGTTGTCCCAGCACTGTGGGAGGCCAAGGCAGGTGGATCGCCTGAGCTCAGCCAAGTTCGAGACCAGCGGAAGACCAGCATGAGGCACAGTGAGCCAGAGTGAGACCCTACCTCTACAAAACAACAACAACAACAAAAAACCCAGCCAGATGTTGTGGCAAGTGTCTGTAATCCCAGCTACATGAGGGGCAAGAGGGCAAGAGAATCACTAAAGGAGGAAGAAGTAA","GGCCGGGCGTGGTGGCTCACACCTGTAATCCCAGCACTTTGGGAGGCCAAGGTGGGTGGATCTCCTGAGGTCAGGAGTTCGAGAGCAGCCTGGCCAACATGGTGAAACCCTGTCTCTACTAAAATACAAAAATTAGCCAGGTGTGGTGGCACGTGCCTGTAATCCCACCTACTCAGGAAGCTGAGGCAGGAGAATCACTTAAAGCTGGGAGAGAGAG"
"GL873556","639390","639468","chr20","16893610","16893664","30","16254220","ACTTCAAACTAAGATAAAGTGAAAGTCAGCAGAAATTGAAAGCAAAAACAAAAACAAAAAAAAAAAAAAAAAAAAAAGA","AACAAAACAAAACAAAACAAAACAAAACAGACAAAAAAAAAAAAACAAAGAAAAA"
"GL873556","2031445","2031493","chr13","87950184","87950229","13","85918739","AGACCCTATCTCTACTAAAAATAGAAAAACTAGCCCAGTATAGTGATGC","AAACCCCATCTCTAGTAAAAATACAAAATTAGCTGGGTGTGGTGGC"
"GL873556","6655305","6655664","chr2","190010230","190010561","107","183354925","GGCCAGGCATGGTGGCTCACACCTGTAATCCTAGCACTCTGGAAGGCCAAGGGAGGTGAATTTCTTGAAGTTCGAGATCAGCCTAAGAGGAATGATACCCCACCTTTACTAGGAATAAAAAAAAAAAAAAAAAAAAACCCAAAACTAGCCTGGCATTGTGGCAGTTCTCTGTAATCCAAGCTACTTGGGAGGCTGAGGTAGAAGGATTGCTTGAACCAAAGAGTTTGACTAGAGGTTGCTGTGAGCTAGGCTAATGTCACCACACTCTATCCAGGGCAAGTGAGTGAAACTCCGTCTCAAAATAAATAAATAAATAAATAAATAAGTAAGAAAAACTTTTGCCCATAAAAAAAAAAAGAA","GGCCGGGCGCGGTGGCTCACACCTGTAATTCTAGCACTTTGGAAGGCTGAGGTGGGTGAATTGTCTGAGCTCAGAAGTTCGAGACCAGCCTGGGCAACACAGTGAAACCCCATCTCTACTAAAATACAAAAAAAAAAAAAAATTAGCTGGGCATGGTGGTGTGCACCTGTAGTCCCAGCTACTCAGGAGGCTGAGGCAGGAGAATTGCTTGAACCCAGGAGGCAGAGGTTGCAGTGAGCTGAGATCACGCCACTACACTCCAGCCTGGGCAACAGAGTGAGACTCCACCTCTTTAAAAAAAAAAAAAAGAAAGAAAGAAAGAAAGAAAGAAA"
"GL873556","10802692","10802792","chr20","28544296","28544376","36","17741604","TACAAAGAAATATCATTATTGGCCAGGTGCAGTGGTTCACATCTGTAATTCTAGTACACTAGTACTCAGGAGGATCACTTGAGGTCAGGAGCTTGTGACCA","TAGAAATGCACAATTCACCTGGGCACGGTGGCTCACTCCTGTAATTCCAGTACTTTGGGAGGCATGAGGTCAGGAGTTCAA"
"GL873557","1682363","1682659","chr6","13352322","13352625","72","11669959","GGCCAGGTGTCGTGGCTCAGGCCTGTAATCCCAGCATTCTGGGAGGCTGAGGTGGGTGGATTGCCCTGAGGTCACAGGTTCCAGACCAGCCTGAGCAAGAGCGAGACTCCATTTCTAATAAAATAGCCGGGTGTTGTGGTAGGTGCCTGTAGTCCCAGTTACTCGGGAGGCTGAGACAAGAGAATCATTTGAACCCAGGAATTTGAGGTTGCTGTGAGCTGTGATGCCACAGGACTCTACTGAGGGCAATAAAGTGAGACTGTCTCAAATAAACAAACAAACAAACAAAAACAAAAA","GGCCAGGTGTGGTGGCTCAGGCCTGTAATCCCAGCACTTTGGGAGACTGAGGTGGGCGGATCACCTGAAGTAAGGAGTTCAAGACCAGCCTGGCCTACATAGTGAAACCCCATCTCTACTAAAAATACAAAATTAGCTGGGTGTGGTGGCACGTGCCTGTAGTCCCAGCTATTCGGGAGGCTGAGTCAGGAGAATCACTTGAACCCAGGATGGGGAGGTTGCAGTGAGCCGAGATCACACCACTGCACTCCAGCCTTGGCAACAGATTGAGACTCTTTCTCAAAAAAAAAAAAAAAAAAAAAAA"
"GL873557","2465751","2465841","chr16","4764895","4764982","15","2299144","GGCCGGGCTTGGTGGTTCACGTCTGTTGTCCCAGCACTGTGGGAGGCCGAGGCAGGTGGATCACCTAAGCTCAGCCAAGTTCGAGACTAGC","GGTCGGGTGTGGTGGGTCACGACTGTAATCCCAGCACTTTGGGAGGCCGAGGCAGATGGATCACCTGAGGTCAGAAGTTCGAGACCAG"
"GL873557","4047834","4047915","chr12","77852792","77852880","22","73804958","ACAAGAGGTTGCTTTGAACTGTGATGCCACAGAGCACTATCCTGGGCAACAGAGACTCTGTCTCAAAAAAAAAAAAAAAAAA","CAGAGGTTGCAGTGAGCTGAGACTGTGCCACTGCACTCCAGCCTGCGCGACAAGAGTGAGACTCTGTCTCAAAAAAAAAAAAAAAAAAA"
"GL873557","4048202","4048390","chrX","23681445","23681631","42","19633243","GGCTGGGTGTGGTGGCTCACACCTGTGATTCTAGCACTCTGGGAGGCCAACGTGGGCAGATCACCTGAGCTTAGGAGTTCAAGACCAGTGTGAGCAAAATGAGACCCCGCCTCTACTAAAAATAGAAAAACTAGCCAGGCACTGTGGTGGGTGCCTATCATCCCAGCTACTCAGGAGGCAGGCAAGAGG","GGCCAGGCGTGGTGGCTCACGCCTGTAATCCCAGCACTTTGGGAGGCCGAGGTGGGTGGATCACCTGAGGTCAGGAGTTCAAGACCAGCCTGGCCAACATGGTGAAACCCCGTCTCTACTAAAAATATAAAAATTAGCCAGGGTGTGGTAGTGCCTGCCTGTAATCCCAGCTACTCGGGAGGCTGAG"
"GL873557","6292327","6292620","chr19","32265157","32265444","82","25972830","GTCAGGCACGGTGGCTCATGCTTGTTGGATTATCCCAACACTCTGGGAGGCCAAGGTGGATCGATTGTCTGAGCTCTGGAGTTCAAGACCAGCCTGAGCAGAAGCAAGACTCCATCTCTAAAAAAAAATAGCTGGGCATTGTGGTGGGCACTTGTATTCCTAGCTACTTGGAAAGCCTGAGGCAAGAGGATTGCTTGAACCCAAGAGTTTGAGGTTGCTGTGAGCTTAAGATGTCACAGCACTCTATAGAGGCTGAGCAAGTGAGACTCCAAAAAGTGAGTTTCCAGAAAAAAA","GACTAGGCACTGTGGCTCATGCCTGTAATCCCAGCACTTTGGGAGGCCGAGGCGGGTAGATCACCTGAGCTCAGGAGTTTCAGACCAGCCTGAGCAACATGGCAAAACCCCATCTCTACTAAACATTAGCCAGGCATGGTGGTGTGCACCTGTAATCCCAGCTACTTGGAAGGTTGAGGCAGGAGGATCACTTGAACCTCAGGAGGCAGAGGTTGCAGTGAGCCAAGATGACATGACTGCACTCCAATCTGGGTGGCAGAGCAAGACTCTGTCTCAAAAAAAAAAAAA"
"GL873557","6324546","6324617","chr1","39656281","39656348","22","33331735","CGCCTGTTGTCCCAGCACTGTGGGAGTGTGAGTAGGGTGGATCACCTTAGCTCAGCTGAGTTTGAGACCAGC","CATGCCTGTAATCCCAGCACTTTGGGAGGTCAAGGCTGGCAAATCACCTAAGGTCAAGAGTTTGAGAC"
"GL873557","6406262","6406343","chr1","199505332","199505412","11","193099070","CAGGCGCAGTGGCTCAATCCTATAATCCCAGCACTTTGGGAGGCTGAGGCAGGTGGATTACCTGAGCTCAGGAGTTTGAGAC","CCAGGCGCAGTGGCTCACACCTGTAATCCCAGCACTTTGGGAGGCTGAGGCAGGCAGATCACCTGAGGTCAGGAGTTGGAG"
"GL873557","6417612","6417692","chr13","102319052","102319128","16","95901440","GAGGTTGCTGTGAGCTAGACTGAGGCCACAGCACTCTAGCCTGGGCAACAGAGTGAGACTGTCTCAAAAGAAAAAAAGAAA","GAGGTTGCAGTGAGCTGAGATCACACCACTGCACTCCAGCCTAGGCAACAAAGTGAGACTCCAACTGAAAAAAAAAA"
"GL873557","6903406","6903510","chr16","18967946","18968045","32","12064540","AGTGCTCTGGGAGACTGAGATGGGCAAATATCTTGAGTTTAGGAGTTCCAGACCAGCCTAAGGAAGAACAAGACCCTATCTCTACTAAAAATAGAAAAAAATTCA","CTTTGGGAGTCTGAGGCAGGTGGATCTCCTGAGGTCAGGAGTTCAGGACCAGCCTGGCCAACATGGCAAAACCCCATCTCTACTAAAAATATAAAAATTA"
"GL873557","6903779","6903930","chr3","40638454","40638604","35","33734675","TTTGCCAGGTATTGTGGTGGACACCTGTAGTCCCAGCTGCTTGGTAGGCTGAGGCAGGAGGATCACTTGACCCTAGGAATCTGATGTTGCTGTGAGCTAGGCTGATGCTACAGCACTCTAGCCTGGACAACAGAGTAAGCTTCTGTCTCAAA","TAGCTGGGTGTCATGGCACACGCCTGTAGTCCCAGCTACTTGGGAGGCTGAGGCAGGAGAATCTCTTGAACCTGGGAGGCAGAGGTTGCAGTGAGCTGAGATCACGCCACTGCACTCCAGCCTGGGCAACAGAGTGAGACTCCGTCTCAAA"
"GL873557","8133022","8133316","chr19","42881134","42881434","76","34748112","GAGTGCAGTGGCTCACACCTGTAATCTTAGCACTCGAGAGGCTGAGGCAGGTGGATTGCCTGAACTCACAGCTTCGAGACCAGCCTGAGCCAGAGCAAGACCTCATCTCTAAAAATAGCCAGGAGTTGTGGCAGGCGCCTGTAGTCCCAGCTACTTGGGAGGCTGAGCAAGAGAATCGCTTGATCTCAGGAGTTTGAGGTTTCTGTGAGCTAAGACACCGCAGCACTCTACCAAGGGTGACAAAGTAAGACTCTGTCTCAAAAAATAAATAAATAAATAAATTATAAGAAAAAGA","CCGGGCAAGGTGGTTCACACCTATAATCCTAGCACTTTGGGAGGTCGAAGTGGATCGCCTGAGGTCAGGAGTTAGAGACCAGCCTGGGCAACATAGCAAAACCCCATCTCTACTAAAAATAGAAAAACTAGCCAGGTGTGGTGGCGCCTGTAATCCCAGCTACTCGGGAGGCTGAGGCAGAAGAATCGCTTGAACCCAGGAGGCAGAGGTTGCAGTGAGCTGAGATCGCACCACTGCACTCCAGGGTGACAGAGCAAGACTCTGTCTCAAAAAAAAAAAAAAAAAAAAAAAAAAAAAAAAA"
"GL873557","8171663","8171835","chr7","151280672","151280824","61","143109009","TTAGCCAGGCACTGTGCTCCCAGCTACTAGGGAGGCTGAGGCAAGAAGAGGATCACTTGGCTCGGCGCCTGTGACTCAAGTGGCTAAGGTGCCAGCCACATACACCTAAGGTGGAGGGTTCTCTACCCAGAGGGACAGCTTGAGGCTCCATCTCAAACAAAAAAAAAAGAAGA","TGGTATGCACCTGTAATCCCAGCTACTTAGGAGGCTGAGGCATGAGAATCACTTGAACCCAGGAGGTGGAACTTTTAGTGAGCTGAGATTGCACCACTGCATTCCAGCCTGGGCAACAGAATAAGACTCTATCTCAAAAAAAAAAAAAAAAAA"
"GL873557","8172121","8172252","chr11","123260550","123260686","30","115088429","CTGGGCATGGTGGCTCATACCTATAATCCTAGGACTTTGGTAGGCCGAGGCAGGTGGGTTGCTTGAGCTTAGAAGTTGAAGACCAGCCTGAACAACAGCAAGACCTTTCCCTACTCAAAACAGAAAAACTAT","GGCTGGGCAGGGTGGCTCATGCCTATAATCCCAGCACTTTGGGAGGCCAAGGCGGGTGGGTCACCTGAGGTCAGGAGTTCGAGACCAGCCTGACCAACATGGTAAGATCCCCTCTCTACTAAAAATACAAAAATTAA"
"GL873557","8260873","8260977","chr1","62231025","62231129","22","53970152","GGCTGGGCATGGTGGCTCACGCCTGTTGTCCCAGCCCTGTGGGAGGGTGAGGCAGGTGGATCGCCTGAGCTCAGCCGAGTTCGAGACCACTGGAAGACCAGCATG","GGCTGGGCATGGTGGCTCACGCCTATAATCCCAGCACTTTGGGAGGCCGAGGCAGGTGGATCACCTGAGATCAGGAGTTTGAGACCAGACTGGCCAACATGGTGA"
"GL873557","10032878","10033040","chr9","27037847","27038008","36","17004969","GGGGGTGGTGGCTCACACTTGTAATACCAGCTACTCTGGAGGCCGAGGCAGGAGAATCATATGAGCCCGGAAGTCTGAGGTTGTTGTGAGCTGGGTTAATGCCCCTGCACTCTAGCCTGGGCAACAGAGTGAGACCATGTCTCAAGGAAATAAAAAAAAAAAA","TTAGCTGGGCATGCTGGCACACACCTGTAATGCCAGCTACTCAGGAGGCTGAGGCAGGAGAATCACTTGAGCCCGGGAGGTGGAGGTTGCAGTGAGCTGAGACAGTGCCACTGTATTCTACCCTGGGCAACAGAGTGAGACTGTCTCAAAAAAAAAAAAAAA"
"GL873557","10366578","10366655","chr17","24597444","24597521","20","14230866","GCCAGGCGTGGTGGCTCATGACGGTAATCCCACCTACTCAGGAAGCAGAGGCAGGAGAATCACTTGCGCCTAGGAGAC","GGCCAGGCATGGTGGCTCATGCCTGTAATTCCAGCACTTTGGGAGGCCGAGGCAGGTGGATCACTACGTCAGGAGTTC"
"GL873557","12031816","12031985","chr11","55022806","55022982","46","42990990","TAGAAAAACTAGCCAGGCATTGTAGCGGGTGCCTATAGTTTCAGCTACTCTGGAGACTGAGACAAGATTGCTTGAGCCCGGGAATTTGAGGTTGCTGTGAGCTATTATGCCACAGCACTCAATACAGGACAATTGAGTGAAACTCCAGTCTCAAAAAAAAAAAAAAAAAA","CAAAAATTAGCCAGGCAGGGTGGTGGGCGCCTGTAGTCTCAGCTACTGGGAAGGCTGAGACAGGATAATCACTTGAACCCGGGAGGCGGATGTTGCAGTGAGCCGAGATCATGCCACTGCACTTCAGCCCGGGCAACGAGAGTGAAACTCCGTCTCAAAAAACAAAATAAAATAAAA"
"GL873557","12032023","12032144","chr1","111354387","111354508","23","99322364","GGTCAGGTGCAGTGGCTCACATCTGGAATCCTAGCACTCTGGGAGGCCGAGGAGAATGGATCCCCTGAGCTCAGGAATTCAATATCAGCCTGAACAAGTGTGAAACCTCCATCTCTACTTAA","GGCCGGGCGTAGTGGCTCACACCTGTAATCCCAGCACTTTGGGAGGCCGAGGCGGATGGATCACCTGAGTTCAGGAGTTTGAGACCAGCCTGACCAAAGTGGTGAAACCCCGTCTCTACTAA"
"GL873557","14208944","14209036","chr7","158031905","158031997","26","143822961","GGATGTGGTAGTTACTGTTTGCTATGATGACAACACTGCACTCTAACTCTGGGTGACACAGTAAGATTCTATCTCAAAACCAAAATAAAACAA","CCAGGAGGTGGAGGTTGCAATGAGCCAAGATCACACCACTGCACTCCAGCCTGGGTGACAGGGTGAGATTCTGTCTCAAAAAAAAAAAAAAAA"
"GL873558","2159034","2159070","chrX","41233833","41233871","7","39074799","ATTAGCCAGGTGTGGTGGCTTTTGCCTGTAATCCCAG","AAATCAGCCGGGTGTGGTGGCTCACGCCTGTAATCCCAG"
"GL873558","3486850","3487074","chr5","91338665","91338874","72","87851815","GGCCAGGCATGGTGGCTCATGCCTGTTGTCCCAGTGCTGTGGGAGGCCGAGGCAGGTGGATCGCCTGAGTTCAGCCAAGTTTGAGACCAGTGGAAGACCAGCATGAGGCAGAGTGAGCCAGAGTAAGACCCCATCTCTACAACAACAAAAAAAAAAAACAAAAAAAACAGCCGGACGTTGTGATCCCAGCTACATGGTGAGGGGGAGGGGAACAGGAGAATCACT","GGCCGGGCATGATGGCTCATGCCTGTAATCCCAGCACTTTGTGAGGCCGAGGCAGACTGATCACTTGAGGCCAGGAGTTCGAGACCAGCATAGCCAACAAGATGAAACACCATCTTTACTGAAAATACAAAAAAAAAAAAAAATAGCCGGATGTGGTGATACCTGCTTGTAATCCCAGCTGCTTGGGAGGCTGAGGCAGGAGAATCTCTT"
"GL873558","3884156","3884240","chr4","24638016","24638099","18","20753860","CCAGACACAGTGGCTTAAGCCTGTAATCCTAGCACTTTGGGAGGCTAAGGTGGATGGATCTCCTGAGCTCAGTAGTTTGAAGCTA","GCCAGGCATGGTGGCTCATGCCTGTAATCTTAGCACTTTGGGAGGCCAAGGTGGGCGGATCATCTGAGGTCAGGAGTTTGAGAC"
"GL873558","5037604","5037746","chr3","2138380","2138521","38","2899224","GCTGGGCCTGGTGGCTCACATCTGTAACCCTAACACTCTGGGAGGCCAAGGCAGGAGGATCTCTTGAAGCTAGGTTGTTAGCCAGGGCGACCCCACAGCACTCTAGCCTGGGGCAACAGAGTGAGACTTTGTCTCCAAACAAA","AGCTGGATGTGGTGGCCCACACCTGTAATCACAGCTACTCGATAGGCTAAGGCAGGAGAATCGCTTGAACCTGGGAGGCGGGGACTGCACCATCACAGCACTCCAGCCTGGGTGACAGAGTGAGACTATGTATCAAAAAAAA"
"GL873558","6488648","6488700","chr3","39516725","39516768","23","33028077","ATAGCACTCTACCATGGGTGACAGAGTGAGACTATCTCCCCCCCTCAAAAAAA","GAGACCAGCCTGACCAACACAGTGAAACCTCATCTCTACTAAAA"
"GL873558","6489359","6489583","chr10","19070944","19071172","64","12581585","GGCTGGACATGGTGGGTCCTGTAATCCTAGCACTGTGGGAGGCCGAGGCAGGTGAATTGCTTGAGCTTATGGGTTCAAGACCAACCTGAGCCAGAAGGAGACCTTGTCTCTAAAAATGGCTGGGTGTTGTGGCAGGCACCTATAATCCCAGCTACTTGGGAGGCTGAGGCAAGAGAATCGCTTGAACCCAAGAGTTTGATGTTGCTGTCAGCTAAGATGCCATAG","GGCTGGGCTCAGTGGCTTATGCCTGTAATCCCAGCGCTTTGGGAGGCCAAGGCGGGTGGATCACCTGAGGTCAGGAGTTCGGGACCAGCCTGAACAACATGGTGAAATCCCGCCTCTACTAAAAAAAAGCCGGGTGTGGTGGCATGCACCTGTAATCCCAGCTACTTGGGAGGCTGAGGCAGGAGAATCACATGAACCTGGGAGGCAGAGGTTGCAGTGAGCTGAGATC"
"GL873558","14631848","14632045","chr18","1878493","1878704","62","12753355","GGTGCAGTGGCTCACGCCTTTAATCCCAGCACTTGGGATGGTGAGGCAGGTAGATTGCCTAAGTTCACAGGTTCAAGACCAGCCTGAGCCAGAGAGACCCTACCTCTAAAAAATAGCCAAGCATTGTGGCAGGCACCTGTAATCCTACTTAGGAGGCTGAGTCAAGAGGATCATTTGAGCTTAAGAGTTAGAGCTTGT","GGCCAGGCATGGTGGCTCACGCCTGTAATCCCAGCACTTTGGGAGGCCGAGGCGGGTGGATCACAAGGTCAGGAGTTCAAGACCAGCCTGGCCAACATGGTGGAAGCCCATCTCTACAAAAAATTAACTGGGCGTGGTGGCAGGCACCTGTAATCCCAGCTACTTGGGAGGCTGAGGCAGGGGAATTGCTTGAACCTGGGAGGCGGAGGTTG"
"GL873558","14632352","14632392","chr7","10117723","10117763","10","4514629","GAGTTAGAGCTTGCTGTGAGCTAAGATGCCACGGCACTCTA","GAGTTAGTTGCAGTGAGCTGAGATCGTGCCACTGCACTCCA"
"GL873559","8193331","8193614","chr20","11734223","11734512","71","3540892","CAGGTACGGTGACTTATCCCTGGAATCTTAGAACTGTCTGAGTCCAAGGTGGGAGGATCATTGGAGGTCAGGAATTTGAGACCAGCCTGAGCAAGAGTGAGACCTCTTCTCTACTAAATATAGAAAAATTAGCCAGGGTTTGTGGCAGGTGCTTATAGTCTAAGCTTCTTAGGAGGCTGAGGCAGGAGAATCTCTTGAACCCATGAGTCTGAGGTTGCCCTGAGTTAAGATGACATCACTGCAGTCTCCCCAAAGCAACGGAGTAAGACTCTGTCTCAAAAACA","GGCCAGGCACGGTGGCTCATGCCTCTAATCCCAGCATGTTGGGAGGCCGAGGTGGGCGGATCACATGAGGTCAGGAGTTTGAGACCAGCCTGGCCAACATAGTGAAACCCTGTCTCTACTAAAAATACAAAAATTAGCCAGGTGTGGCAGCACGTGCCTGTAGTCCCAGCTAGTCAGGAGGCTGAGGCAGGAGAATCACTTGAATCCACCAGGCGGAGGCTGCAGTGAGCCAAGATCACACCACTGCATTCCAGCCTGGGCGACAGAGCAAGACTCTGTCTCAGAAAAAA"
"GL873559","8193642","8193657","chrX","1083699","1083714","0","7109943","AAATAAATAAAATAAA","AAATAAATAAAATAAA"
"GL873560","393252","393440","chr11","121440472","121440639","55","121047220","CTGGGCAGGGTGGCACACACCTGTCATCCCAGCATGTTGGGAAGCTGAGGCAGGAGAATTACTTGAGCTCAGATTCCAAGAGGTGAGGATCACTTGAGCCTAGAAGTTGAGGCTGCACTGATGCCCCAACACTCCAGCCTGGGCAACAGAGCAAGGTCCTGTCCCAAAAAGAAAAAAAGAAAAGGAAAA","GCTGGGCGCAGTGTCTCACGCCTGTAATCCCAGCTATTTGGGAGGCTGAGGCAGGAGAATTACTTGAACCTGGGAGGTGGAAGTTGCAGTGAGCCGAGATCCTACCATCGCACTCCAGTCTGGGCAACAAGAGCAAAACTCTGTCTCAAAAAAAAAAAAAAAAAAAAA"
"GL873560","4038833","4039014","chr12","78258009","78258208","56","74219176","GGCTGGGTGCGGTGACTCACACCTGTAATCCCAGCACCTGGAGGCCCAAGGCAGGGTGGATTGTCTGAGCTCACAGGTTCAAGACCAGCCTGAGCCAGAGCGAGACCTAAAAATAGCTAGGCGCTGTGGGAGGCACACGTAGTCCCAGCTACTCAGGAGGCTGAGGCAAGAGAATCACTTGA","GGCTGGGCACGGTGACTCACGCCTGTAATCCCAGCACTTTGGGAGGCCCAGGTGGGTGGATCACCTGAGGTCAGGAGTTCAAGACCAGCCTGGCCAAGATGGTGAAACCCCGTCTCTACTAAAAATACAAAACTTAGCTGGGCATGGTGGCGGGCACCTGTAATCTCAGCTAGTCGGGAGGCTGAGGCAGGAGAATCTCT"
"GL873560","4492531","4492643","chr7","56485655","56485756","37","51993124","AACAGAAAAACTAGCCAGGCATAGTGGTGCATGCCTGTTGTTCCAGCTGCTCTAGAGGCTAAGGCAAGAGGATTGCTCCAGCTCAATAGTTTGAGGTTGCTGTGAGCTTGAGA","TTAGCTGGGCATGGTGGAGCACACCTGTAATTCCAGCTACTCAGGAGGCTGAGGCAAAAGAGTTGCTTGAACCCAGGAGGCAGAGGTTGCAGTGAGCCGAGA"
"GL873560","4492670","4492771","chr8","41603464","41603564","28","37110794","AGCACTCTGGGTGACTGAGGCAGGATTACTTGAGCTCAGGAGTTTATGACCAGCCTGAGCTGGTCCTTGATCAAGACTCCATCTCTACTAAAAAAACAAACA","CACTTTGGGAGGCCGAGGCAGCAGATCACTCGAGGTCAGGAGTTTGAGACCAGCCTGGCTAACATGGCAAAACCCCATCTCTACTAAAAATATAAAAATTA"
"GL873560","8106775","8106882","chr11","111878590","111878685","39","103771815","ACATAAGAATCAGGCCAAGCCTTGTGGCTCCTGTATGTGATTCCAGCACTGGGAGGGCAAGGCAGGAGGATCCCTGACGTCAGGAACTCAAGGCTGCCCAAGTATCAT","GGGCACAGTGGCTCATGCCTGTAATCCCAGCACTTTGGGAGGCCAAGGCGGGTGGATCACCTGAGGTCAGGAGTTCAAGACCAGCCTGACCAACAT"
"GL873560","10872201","10872272","chr7","9971011","9971083","11","901190","GGCTGGGCACAATGGGTCACACTTGTAATCCCAACACTTTGGGAGGCTGAGGTGGGCAGATCACCTGAGCTC","GGCTGGGTGGGGTGGCTCACACATGTAATCTCAGCACTTTGGGAGGCTGAGGTGGGCAGATCACCTGAGGTCA"
"GL873560","11043320","11043410","chr6","111928830","111928919","19","100885510","CAGGCGAAGTGGCTCATGCCTATAATCCTAGCATTCTGGGAGGCTGAGGTGGGAGAATCCCCTGAGGTCAAAAGTTCAAGACCGGCTTGGC","GGCCAGGCTCAGTGGCTCATGCCTGTAATCCCAGCACTTTGGGAGGCCGAGGTGGGTGAATCACCTGAGGTCAGGAGTTCAAGACCTGCC"
"GL873561","5890611","5890936","chr8","76222061","76222392","77","70331450","GGCTGGGCCTGGTGGCTCATGCCTATAATCCTAGCACTCTGGGAGGCAAAGGTTGGTGGATTGCTTAAGCTCAGGAGTTCAAGACCAGCCTGATTAAGAGTGAGATCCCATCTCCACTAAAAATAGAAGGGAAAAAAAAAAAAAAAAAACCTAGTTGGGCTTGGTGGCAGCACTTGTAGTCCCAGCTATTTAGGAGGCTGAGGAAAGAGAATCACTTGAACCCAAGAGTTTGAAGTTGCTCTGAGCTATGATGCCATAGAACTCTACCCAGGGTGACAGAGTAAAACTGGATCTCAAATAAATAAATAAATAAATACATAAATAAA","GGCTGGGCATGGTAGCTCATGGCTGTAATCCTAGCACTTTGGGAGGCCAAGGAAGGTGGATTGCCTGAGCTCAGGAGTTCAAGACCAGCCTGGGCAACACAGTGAAATCCTGTCTCTACTAAAATACAAAAAAGAAAAAAAAAAAAAAAAAAAACAGCTGGGCATGGCAGTGTGCACTTGTAATCCCAGCTACTCAGGAGGCTGAGACAGGAGAATCACTTGAACCCGGGAGGCAGAGGTTGCACTGAGCCGAGATTGTATCACTGCACTCCAGCCTGGGTGACAGAGCGAGACTCTGTCTCAGAAAAAAAAAAAAAAACAAAAAAACAAAA"
"GL873561","10859256","10859475","chr6","100119122","100119352","73","89259866","GGATCACTTGAGCTCAGGAGTCAAGACCAACTTGAGTAAGAGTGAGACCCTGTCTCTACTAAAAATAAAATATATAGCCAGGCATTGTGCTGGGCACCTATATATAAGCTAAAATGGAGTCTTAGCTACCTCCTTGAACTTGAACCCAGGAGTCTGAAGTTGCTTTGAGCTAGGCTGATGCCACTGCACTTTACCCAGGCAACAGAGTGAGAGTATCTAA","GGATCACCTGAGGTCAGGAGTTCAAGACCAGCCTGGCCAACATGGTGAAACCCCGTCTCTACTAAAAATACAAAAACTAGCCAGGCATGGTGGCGCACACCTGTAGTCCCAGCTACTTGGGAGGCTGAGGCAGAAGAATCTCTTGAATCCGGGGGTTGGAGGTTGCAATGAGCTGAGATCATGCCACTGCACTCCAAGCCTGGGTGACAAGAGCGAAACTCCATCTCAAAA"
"GL873561","10859563","10859576","chr4","114457728","114457741","1","103598165","AAAAAAAAATAAAA","CAAAAAAAATAAAA"
"GL873562","12189469","12189706","chr1","31551552","31551790","75","19362083","CAGTGGCTCACGCCGGTAATCCCAGCACCTTGGGAGCTGAGGCAGGCAGATCTCCTGAGGTCACGTGTTTTGAGACCAGCCTGAGCTAGAGTGAGACCCCACCTCTAAAAATAGCCAGTCGCCTGTAATCCCAGCTACTCGGGAGAAACCCAGGAGTCTAAGGTCGCTGTGAGCTGACACCTCAGCACTCTGCTGGGGTAACAAAGTGACACTTTGTCTCAAAAAAATAAATAAATAT","GCAGTGGCTCACGCCTGTAATCCCAGCACTTTGGGAGGCCAAGGCGGGTGGATCACCTGAGGTCAGGAGTTCAAGACCAGCCTGGCCAACATGGTGAAACCTCATCTCTACTAAAAATACAAAACAGGAGAATCGCTTGAACCCGGGAGGTAGAGGTTGCAGTGAGCTGAGATAGTGCCACTGCACTCCAACCTGGGCAACAGAGTGAGACTCCGTCTCAAAAAAATAAAAAATAAAAA"
"GL873562","4526861","4526913","chr13","94764706","94764759","14","90237845","GTGAGACCTTGTCACTACTGAAAATAGAAAAATTAGCTGGGCATGGTTGTAGG","GTGATGAAACCCCATCTCTACTAAAAATACAAAAATTAGCTGGGCTTGATGGTG"
"GL873562","4789223","4789313","chr10","47852509","47852598","25","43063286","GGCCAGGAGAAGTGGCTAACACCTGTAATTCCAGCACTCTAGGAGATGGAGGCAGGGACCAGCCTGAGCTAGAGTGAGTGAGACTCCATCT","GGCCAGGTGCAGTGGCTCACACCTGTAATCCCAGCAACTTTGGGAGGCTGAGGCAGGCAGATCACTTGAGGTCAGGAGTTCGAGATCAGC"
"GL873562","4868605","4868801","chr16","54069750","54069948","44","49201145","GGCCAGGCATGGTGGCTCATGCCTGTAATCCTAGCACTCTGAGAGACCAAGGCTGATGAATCACCTGAACTCAGGAGTTGAGACCAGCAGGAGCAAAAGTGAGATCCCATCTCTACTCAAAAATAGAAAATTAGTTCAGGCAAGGTGGCACATACCTGTAATCCCAGCACCCTGGGAGGCTAAGGTGGGTGGATTGC","GCCCAGCGCAGTGGCTCATGCCTATAATCCCAGCACTTTGGGAGGCCAAGGCGGGTGGATCACCTGAGGTCAGGAGTTCGAGACCAGCCTGCCCAGCATGGTGAAACCCCATCTCTGTTAAAAATATAAAAATTAGACTAGGCGCGGTGGCTCACACCTGTAATCCCAGCACTTTGGGAGACCAAGGTGGGCGGATCAC"
"GL873562","4929184","4929360","chr10","37539693","37539877","47","32610509","GGCCAAGCTCAGTGGCTCTCCCTAGCACTTTGGGAGACCGAGGTGGGTGGATTGCCTGAACTCAGGAGTTCTAGACCAGCCTGATCAAGAGCAAGACCCTACATCTACTAAAAATAGAAAAACTAGCTGGGCATTATAGTACGCACCTGTACTCCCATCTACTCTGGAGGCTGAGGC","GGGTGCAGAGGCTTATGCCTGTAATCCCAGCACTTTGGGAGGCAGAGGTGGGTGGATCACTTGAGGCCAGGAGTTCAAGACCAGCCTGGTCAATGTGGTGAAACCTCGTCTCTACTAAAAATACAAAAATTAGCCGGGCATGGTGGCATGCATCTGTAGTCCCAGCTACTTGGGAGGCTGAGGCA"
"GL873562","5446395","5446678","chr16","63692714","63692996","79","58246319","GGCTGGATGCAGTGGCTCATACCTGTCTGTAATCCTAGCACTCTGGGAGGTCGAGGTGGGTGGATTGCCTAAGTTCACAGGTTCGAGGCCAGCCTAAGCAAGAAGAGCAAGACTCCATCTCTGAAAGTAGCCAGGCATTGTGACAGGCGCCTATAGTCCCAGCTACTTGGGAGGCTGAGGCAAGAGAATTGAGCCCAGGAGTTAGAGGTTGCTGTGAACTAGGACTCCATAGCATTCTACTGAAGGTGACAAAGTGAGATTCTGTCTCAAAAAAAAGACTGATT","GGCTGGCTGCGGTAGCTCACCCCTGTAATCCCAGCACTTTGGGAGGTCAAGGCAGGTGGATTGCCTGAGGCCAGGAGTTCGAGGCCAGCCTGACCAATATGGCAAAACCCTGTATCTACTAAAAACTAGCTGGGCATGGTGGCATACACCTGTAGTCCCAGCTACTTGGGAGGCTGAGGCAGGAGAATTGCTTGAACCTGGAGGCAGAGGTTGCAGTGAGCCAAGGCTGCCCCACTGCACGCCAGCCTGGGTGACAGAGTGACACTCCATCTCAGAAAAAAAA"
"GL873562","8499356","8499477","chrX","91860022","91860139","29","83360666","GGCTGGGTGTGCTGGCTCATGCCTGTAATCCTCGCACTCTGGGAAGCTAAGGCAGGTGGATTGCCTGAGCTTATGAGTTTAAGACTAGCCTGAGCCAGAGCAAGACCTTGTCTCTATTTTTT","GCCGGGTGTGGTGGCTCATGCCAGTAATCCTAGCACCTTGGAAGGCTGAGGCAGGTGGATTGCCTGAGCTCAGGAGCTTCAGACTAGCCTGGGCAACATAGTGAAACCCCATATCTCT"
"GL873562","8499731","8499918","chr7","167658032","167658223","45","159158301","AAGACCTTGTCTCTAAAAATAGCCAGGTGTTGTAGCAGGCACCTGTAGTCCCAGCTACTTGGGAGGCTGAGACAAGAGAATTGCTTGAGCCCAAGAGTTTGAGGTTGCTGTGAGCTGAGATGCCATGGACTCTATCGAGGGCAGTAAAGTGAGACTCCGTCTCAAAAAAAAAAAAAGAAAGAAAAGAA","TACTAAAATACATACAAAAATTAGCCAGGTATGGTGGCAGGCCCCTGTAGTCCCAGCTACTCGGGAGGCTGAGGCAGGAGAACTGCTTGAACCCAGGAGGTGGGGATTGCAGTGAGCTGAGATCGCACCACTGCACTCCAGCCTGAGCGACAGAGTGAGACTCTGTCTCAAAAATAAAAAAAGAAAAAAAAA"
"GL873562","10216295","10216385","chr1","44313085","44313176","34","34096790","TAAAAATACATTGAACCAGATTCAGTGGCTCACACCTGTGCTCCTAGCTACCCAGTGGCTGAGGCTGAAGGATGGCTTGAATCTCAAGTTC","TTACAGATCATTTGGGGCTAGATGTAATGGCTCACACCTGTAAGCCCAGTGCTTTGGGAGGTTGAGGCAGGAAGATGGCTTGAACCTAGGAG"
"GL873562","11812352","11812435","chr19","44513406","44513491","17","32701054","GGCCGGTACGATGGCTCAGGCCTATAATCTTAGAACTCTGGGAGTCCGAGGTGGGTGGACTGCCTGAGCTCACAGTTCGAGACC","GGCCGGACGCGCTGGCTCACGCCTGTAATCCTAGCACTTTGGGAGGCTGAGGGGGGCGGATAGCCTGAGCTCAGAAGTTCGAGACC"
"GL873562","12179920","12180054","chr14","8268315","8268451","18","3911605","GGCCAGGCATGGTGGCTCACACCTATAATCCTAGCACTCTGGGAGGCCAAGGCAGGTGGATCACCTGAGCTCAGGAGTTTAAGACCAGCCTGAGCAAGAGTGACAACCTATCTCTATTAAAAATACAAAAACTAG","GGCCGGGCATAGTGGCTCACACCTATAATCCCAGCACTTTGGGAGGCCAAGGCAGGTGGATCACCTGAGGTCAGGAGTTCGAGACCAGCCTGACCAAGATAGTGAAACCCCGTCCCTACTAAAAATACAAAAATTAA"
"GL873562","14017684","14017885","chr2","94000404","94000565","73","79982720","CAAGCTAGCCTAGGGATGTGGAGGTACCTGTAGTCCCAGTTACTTCATTGGCTGAGGCTTAAACCCTCTTGGATGGTCTCACTCTGTCACCCTGGTAGAGTGTTGTGGCATCATGTGTCACAGGAGGTTGAGGTTGCTGTGAGCTGTGATGCCACAACATTCTACCAGGGTGACAGAGTGAGACTCTGTTTCAAAAACAAAA","AAACTAGCCTGGCGTGGTGGTGTGTGCCTGTAATCCCAGCTACTTGGGAGGCTGAGACAGGAGAATCACTTGAACCTGGGAAGTGGAGGTTGCAGTGAGCTGAGATCATGCCACTGCACTCCAACTTGGGCAACAGAGCGAGACTCTGTTTCAAAAAAAAAA"
"GL873562","14017915","14018042","chr1","161382752","161382881","27","147364837","GGCTGGGCACGGTGGCTCACACTTGTAATTCTAGCACCCTGGGAGGCCAGCGTGGGTGGTTTGCTTGAAGTTAGGAGTTCAAGACCAGCCTGACCAAAGTGAGACCACATCTCGACTAAAAACAAACA","GGCTGGACGCAGTGGCTCATACCTGTAATCCCAGCACTTTGGGAGGCCGAGGTGGGTGGATCACCTGAGGTCAGGAGTTCAAGACCAGTCTGGCCATGGTGAAACCCCATCTCTACTAAAAATACAAAAA"
"GL873563","2645481","2645758","chr1","37954757","37955032","69","35309276","GGCTGGGTGCCATGACTCACGCCTGTCATCCCAGCTCTCTGGGAGGTCACAATGGGAGTATTCCATGAGCTCAGAAGTTTGAGACCAGTCTGAGCAAGAGCAGACTCCATTTCTACTAAATATAGAAAAATTAGCCCAGTATGGTTGTGCACACCTGTAGTCCCAGCTACTTGGGAGCTGAAGCAGGAAAACGGCTTGAGTCCAGGAGTCGGAGGTTGCTGTGAGCTGAGAGCTATAATGATGCCAGTGCACTCTACCCAGGCAACAGAGCAAGACTC","GGCCGGGTATGGTGGCTTACGCCTGTAATCCCAGCACTTTGGGAGGCCAAGGTTGGCAGATCACCTGAGGTCAGGAGTTCGAGACCAGCCTGGCCAATATGGCGAAACCCCGTCTCTACTAAAAATACAAAAATTAGCTGGGCATGGTGGCGCATACCTGTAATCCCAGCTACTCGGGAGGCTGAGGCAGGAGAACTGCTTGAACCCAGGAGGTGGAGGTTGCAGTGAGCCGAGATTGAGCCACTGCACTCCAGCCTAGGTGACAGAGTAAGACTC"
"GL873563","2646059","2646097","chr1","62915138","62915167","12","60269079","CAAACAGAACAAGACTTTGTTTCAAAAAAAAAAAAAAAA","CAAACAAACAAACATCACAAAAAAAGAAAA"
"GL873563","2651001","2651167","chr2","69424628","69424798","38","66773627","GTACAAAAATTAGCCAGATGTCTTGGTGCTTATAGTCAGCAACTCAGGAGGCTGAGGCAGGAGGATCACTTGAACCCCTGGAATTTGAGGTTGCTGTGAGCTAAGTTGATGCCACGGCATTCTAGCCTGGGTGACAGAGTAAGACTCCATCTCAATAAATAAATAAA","AAAAAAATTAGCCAGGCATGGTGGTGCATGCTTGTAATCCCAGCTACTTGGGAGGCTGAGGCAGGAAGATCACTTGAACCTGGGAGGCGGAGGTTGCAGTGAGCCAAGATTGTGCCACTGAACTCCAGCCTGGGTGACAGAGCAAGACTCCATCTCAAAAAAAAAAAAAAA"
"GL873563","2651449","2651584","chr3","121251018","121251153","32","118599569","GGTCCAGTGAGGTGGTTCAGACCTGTAATCCTAGCATTCTGGGAGGCTGAGGTGAGCAGATTGCTTGAGCTCAGTGAGTTTGAGACCAGCCTGAATAAAAGCAGCACCCCATCTCTACCAAAAGTAGGAAAATTAT","GGCCAGGTGCAATGGCTCACACCTGTAATCCCAGCACTCTGGGAGGCCGAGGTGGGCAGATCACCTGAGGTCAGGAGTTTGAGATCAGCCTGGCCAACCTGGCAAAACCCCATCTCTAATAAAAATACAAAAATTA"
"GL873563","6898038","6898117","chr6","28153994","28154075","27","21255956","AAAAAACAGAAAAATTAGTTGGGTGTGGTAGTGGGTAGCTACTTGGGAGGCTGGGGCAGGAGAATCACTTGAACCCAGGA","AAAATTAGCCGGGTGTGGTGATGCATGCCTCTAATCCCAGCTACTTGGAAGGCTGAGGCAGGAGAATCACTTGAAGGCAGGA"
"GL873563","6898395","6898520","chr5","140939246","140939381","30","134040851","GGGGGTGGTGGCTCATGCCTGTAATCCCAGCACTCTGGCTGAGACAAGTGGATTGCATGAGCTCAGGAGTTCAAGACCAGCTTGAGGAAGAACAAGACTCCATCTCTACTAAAAATAGAAAAATTT","GGCCCGGTGCTGTGGCTCATGCCTGTAATCCCAGCACTTTGGAAGGCTGAGGCAGGTGGATCCCTTGAGGTCAGGAGTTCGAGACCAGCATGGCCAACATGGCAAAATCCCATCTCTACTAAAAATACAAAAATTA"
"GL873563","7811395","7811530","chr1","29437872","29437991","31","21626477","GGCCGGGCGTGGTGGCTCATGCCTGTAGTCCCTGCACTGTGGGAGGCCGAGGCGGGTGGATCACCTGTGCTCAGAGGTTCGAGACCAGCTAAGACCCCCCTGAGCCAAATGAGCCAGAGTGAGACCCCGTCTCTAC","GGCCGGGCGTGGTGGCTCACGCCTGTAATCCCAACATTTTGGGAGGCCAAGGCGGGTGGATCACCTGAGGTCAGAAGTTCGAGACCAACCTGGCCAACATGGTGAAACCCCTGTCTCTAC"
"GL873563","7855904","7856041","chr3","37342340","37342469","34","29486436","GCCAGGGCAGTGGTTCACACCTGTAAAAACCCCAGTATTTTGAGAAGCCAAGTTGGGAGGATCACATAAGGTCAAGAGTTTGAGACCAGCCTGGACAACACAGTATAAGACTCCCATCTCTATTTTGTTAAATATACA","GCCGAGCGCGTGGCTCACGCCTGTAACCCCAGCACTTTGGGAGGCCAAGGTGGGTGGATCACTTGAGGTCAGGAGTAGGAGACCAGCCTGGCCAACATGGGTGAAACCCCACCTATAGTTTAAAAATATA"
"GL873563","8381194","8381392","chr2","167568017","167568216","65","159186823","GGCCAGTGCAGTAGCCCACACCTGTAATCCTAGCACTCTGGGAGGCCAACTCTGGTAGAGTTTGAAACTAGCCTGAGCAAGAGCGAGACCTTGTCTTCACTGAAAAAAATAGAAAAAAAAAAAAAAAACTAACTGGGCATGGTGCTGTACATCTGTAGCCCGAGCTACTCAGGAGTCTGAGGCAAGAGGATTACTCAAT","GCCAGGCGAGGTGGCTCATGCCTGTAATCCCAGCACTTTGGGAGGCCAAAGTGGACAGATTACCTGAGGCCAGGAGTTTGAGACCAGCCTGACCAATATGGTGAAACCCCATCTGTACTAAAAATACAAAAATTAGCAGGGCGTGGTGGTGTACACCTGTAATCCCAGCTACTCAGGAGGCTGAGGCAGGAGAATCTCTT"
"GL873563","8381923","8382014","chr2","92370724","92370803","33","83988801","GGATTGCTCAAGCCCAAGAGTTTGAGGTTGCTGAGAGCTATGACACTACAGCACTCTACTCTACCCAGGGCAACAGAGTGAGACAAAAAAAA","TTGCTTGAACCCAGGAGCTAGAGGTTGCAGTGAGCTGAGATTGCACTATTGCACTCCAGCCTGGGCAACAGGGTGAGACT"
"GL873563","9500422","9500552","chr19","10830410","10830544","33","1329988","GGTCAGGTGCAGTGGTCACCTGTCATCCTACCCCTCTGGGAGGCCAAGGTGGGTGGATTGCCTGAGTTCAGGAGTCTGAGACGAACCTGAGCTAGAGCAAGACCTCATCTCTTAAAAAATAGCCAGCATTC","GGCCAGGTGCAGTGGCTCATGCCTGTAATCCCAGCACTTTGGGAGGCCAAGGTGGGTGGATCACCTGAGGTCAGGAGTTCGAGACCAGCCTGATCAACGTGGTGAAACCCCATCTCTACTAAAATTGCAAAATTA"
"GL873563","9501087","9501192","chr16","71049107","71049211","33","61548020","TAAAACCTATAATGTTTGAAAATAAAAATAGCCAGGCCTTGTTGTGGGTGCCTGTAGTCCCAGCTACTTAGGAGGCTGAGGTAAGAGGATTGCTTGAGCCCAAGAG","TGAAACCCCATCTCTACTAAAAATACAAAATTAGCCAGGTGTGGTGGTGCATGCCTATAATCCCAGTTACTTGGGAGACTGAGGCAGGAGAATCACTTGAACCTG"
"GL873563","10991062","10991128","chr1","22619342","22619410","11","11628280","GGCCGGTGTAGTGGCTCACGCCTGTAATCCCAGCACTTTGGGTGCCGACATGGGCAGATCGCCTGAG","GGCCGGGCGCGGTGGCTCACACCTGTAATCCCAGCACTTTGGGAGGCCGAGGTGGGCGGATCACCTGAG"
"GL873563","12252577","12252738","chr8","144193624","144193784","41","131941047","GGCTGGGTACAGTGGCTCATATCTGTAATCCTAGCACTCCAGGAGGCTGAGGTGGGAGGATAATTGCCTGAAGTCAGAAACACAAGACCAGCCCAAACAAGAGTGAGACACCATCTCTACTAAAAATAGAAAACTGAGCTGGGTGTGGCGGTGCACACCTGT","GGCCGGGCATGGTGGCTCATGCCTATAATCCTAGCACTTTGGGAGGCCGAGGTGGGCGAATCACCTGAGGTCAGGAGTTTGAGACCAGCCTGGCCAACATGGTGAAACCCCATCTCTACTAAAAATACAAAAATTAGCTGGGTGTGGTGGCACATGCCTAT"
"GL873564","1384131","1384395","chr13","32253035","32253303","64","30868904","GGGGGGGGGGGCACACTGGCCTGTAATTCTAGCACTCTGAGAGGCCAAGGCAGGTGGATCACCTGAACTCAGGAGTTCGAGACCAGCCTGATCAAGAGTGAAACCCTGTCTCTACTAACAAGAGAAAAACCAGTAGTCCCAGCTACTCAGGAGGCTGAGGCAGAAGAATCACTTGAACCCAGGAGTTTGAGGTTTCTGTGAGCTACAGTAGTGCTATGGCACTCTACCAAGAGTGACAGAGTGAAACTCTGTCTCAAAAAAAAAA","GCTGGGCATGGTGGCTCATGCCTGTAATCCCAGCACTTTGGGAGGCTGAGGCGGGTGGATCATCTGAGGTCAGGAGTTCAAGACTAGCCTGGGCAACATGGTGAAACCCTGTCTCTACTAAAAATACAAAATTACAGGTAATCCCAGCTACTTGGGAGGCTGAGGCAGGAGAATCGGTTGAACCCAGGAGGCGGAGGTTGCAGTGAGCTGAGATCATGCCACTGCACTCCAGCCTGGGCAATAGAATGAGACTCTGTCTGAAAAAAAAA"
"GL873564","2543879","2544121","chr1","199402350","199402570","73","196858471","GGCCAGGTGTGGTGGCTTACGCCTGTTGTCCCAGCGCTGTGGGAGGCCGAGGCAGGTGGATTGCCTGAGCTTAGCTGAGTTTGAGACCAGCGGAAGACCAGCATGAGGCAGAGTGAGCCAGAGTGAGATCCTGTCTCTACAAAAAAGAAAAAAAAAAAAACAGCCGGATGTTGTGGCGCGCGTCTGTAATCCCAGCTACATGGGGGTCAAGAGGGCAAGAGAATCATACAGGAGGAAGAAGTT","GGCCAGGTGTGGTGGCTCACACCTGTAATCCCAGCACTTTGGGAGTCTGAGGCGGGTGGATTGCCTGAGGTTGAGAGTTTGAGACCAGCCTGGCCAACATGGTGAAACCCTGTCTCTACTAAAAACACAGAAATTAGCCAGGCATGGTGGCGCATGTCTGTAATCCCAGCTACCCTCCTGGAGGCTGAGGCAAGAGAATCACTTGAACCCAGGAAGCAGAG"
"GL873564","4859126","4859236","chr9","15245726","15245837","31","10386600","GTGGCTCATGCTTATAATCCAATCACTATGGGAGACCAAGGTGGGGATGGGCGGAGATCACCCTCAGGAGTTGGAGACCAGCCTGAGTTAAGAGTGATACCATGTCTCTAC","GTGGTGTCTCACGCCTATAATCCCAGCACTCTGGGAGGCCAAGGTGGGCAGATCACCTGAGGTCAGGAGTTAAGAGACCAGCCTGGCCAACATGGTGAAACCCTGTCTCTAC"
"GL873564","4859490","4859678","chr8","126054004","126054184","54","121194514","CATGTCTCTATTAAAGGTAGAAAAATTAGCCGAAGTATTGTAGTTGGGCTGTATAGTCCCAACTACTGAAGAGGCTGAGACAGGAGGATTGCTTACAACTAGGAGTTTGAGGTTGCTGTGAGCTAGGCTGATGCCAAGGTGCTCTAGCCTGGGCAACAGAATGAGACAATGTCTTAAACAACAAAAAAA","GTCTCTACTAAAAATACAAAAATTAGCTGGGTGTGGTGGTGCATGCCTGTAATCCCAGCTACTCAGGAGGCTGAGGCAGGAGAATCGCTTGAACCCAGGAGGTAGAGGTTGCAGTGAGCCAAGATCATGCCACTGCACTCCAGCCTGGGTGACAGAGGGAGACTCTGTCTCAATAAATAAA"
"GL873564","5294014","5294069","chrX","11604904","11604969","20","6310890","GGGTGTGGTGACTTGCACTTACAATCAGCACTTTGGGAGGCGAAGGTAGGAGCATC","GGCTGGGTGCAGTGACTCACGCCTGTAATCCCAGCACTTTGGGAGGCTGAGGTAGGCAGATCACCT"
"GL873564","5294155","5294257","chr15","310129","310227","21","4984026","GGCTGGGTGTGGTGGCTCACGTCTGTTGTCCCAGCGCTATGGGAGGCTGAGGAGGGTGGATCACCTGAGCTCAGAGGTTCGAGACCAGCATAAGACCAGCATG","GGCTGGGCGCAGTGGCTCACGCCTGTAATCCCAGCACTTTGGGAGGCCAAGGCGGGTGGATCACGAGGTCAGGAGTTTGAAACCAGCCTAGCCAGCATG"
"GL873564","6711055","6711262","chr18","1878493","1878704","55","4832562","CTGGGCCCAGTGGCTCACACCTATAATCCTCGCACTCTGGGAGGCTGAGGCGGGTAGATTGTCTGAGCTCACAGGTTCAAGACCAGTGTGACCCAGAGCGAGGCTTTGTCTCTAAAAATAGCAGGGCGTTGTGGCAGGCACCTGTAGTCCCAGCTACTTGGGAGGCTAAGGCAAGAGAATTGCTTAAACCTAAGAGTCTGAGGTTACA","GGCCAGGCATGGTGGCTCACGCCTGTAATCCCAGCACTTTGGGAGGCCGAGGCGGGTGGATCACAAGGTCAGGAGTTCAAGACCAGCCTGGCCAACATGGTGGAAGCCCATCTCTACAAAAAATTAACTGGGCGTGGTGGCAGGCACCTGTAATCCCAGCTACTTGGGAGGCTGAGGCAGGGGAATTGCTTGAACCTGGGAGGCGGAGGTTG"
"GL873564","6711356","6711451","chr7","158031905","158031997","31","151320549","AAAAGAGTCTGAGGTTGCCATGAGCTATCATGCCAAGGCATTCTAGAGAAGGGGTACAAAGTGAGACTCTGTCTCAAAAAAAGAAAACCAAAAAGG","CCAGGAGGTGGAGGTTGCAATGAGCCAAGATCACACCACTGCACTCCAGCCTGGGTGACAGGGTGAGATTCTGTCTCAAAAAAAAAAAAAAAA"
"GL873564","7057009","7057315","chr14","106885133","106885430","87","99828124","GCCGGGTACAATGGCTTGCGCCTATAATCCCAGCACTCTGGGAAGCAGAGGTGGGTGGATCACCTCAGCTCACGAATTCGCTACCAGCCTGTCCTAGAGTGAGACACCCCCCCCACCCCCACCCCCCACAACCTCTAAAAATAGCCTGGAGTTGTGACGGGCACCTGTTGTCCCAGCTACTCTGGAGGCTGAGACAAGAGAATTGCTTGGGCCTCAGAGTCTAAGGTTGATATGAGCTATGACATCACAGCACTCTATCAAAGGTAACAAAGTGAGACTCTAAATAAATAAATAATAAATAAATAAA","GCCGGGCCCGGTGGCTCTTGCCTGTAATCCCAGCACTTTGGGAAGCTGAGGTGGGTGGATCACCTGAGGTCAGGAGTTCGAGACCAGCCTGACCAATATGGTGAAACCCCGTCTCTACTAAAAATATAAAAATTAGCCGGGTGTGGTGGCATGCGACTATAGTCCCAGCTACTCAGGAGGCTGAGGCAGGAGAATTGCTTGAACCCAGGAGGTGGAAGTTGCAATGAGTCGAGGTCACACCACTGCACTCCAGCCTAGGCAACAGAGTGAGACTCCATCTCAAAAAAAAAGAAAAAAA"
"GL873564","7705416","7705474","chr1","51463330","51463380","19","43757914","TCATGCCTGTAGTACCAGCACTTCAGGAGGCTGAAGCAGGAGCTAAGATTAGAAATTTG","CATGCCTTTAATCCCAACTACTTGGGAGGCTGAGGCGAGAATTGAAGTCCG"
"GL873564","8307239","8307551","chr14","30585163","30585473","93","22277924","GCACAGTGGCTCAGGCCTGTAATCTGAGCACTCTGGGAGGTTGAGGCTGAGGTTAGGAGTTAGGAGAACAGCCTGAGCAAGAGTGAGACCCCATCTCTACCAAAAATAGGGGAAAAAACTCCAAAAATCTAGCCACATGTTGTGGTACTTGCCTGCAATCCCAGCTACTGGGGCATAGGGGGACTGAGGCAAGAGGGTCACTTGAGCGTGAGAGATTGAGGTTGCTGTGAGCTAAGATGATGCCATGGCACTCTACCCAAGGTGGCAGAGTGAGCCTATGTCTCACCAATAAATAAACAAATAAATAAATGAA","GGGCACAGTGGCTCACGCCTGGAATCCCAGCACTTTGGGAGGTCAAGGTGGGTGGATCACCTGAGGTCAGGAGTTTGAGACCAGCCTGGCCAAAATGGTGAAACCCCATCTCTACTAAAAAAAATACAAAAAATTAGCCAGAATGTGGTGGTGCATGCCTGTAATCCCAGCTACTGGGGAGGCTGAGGCAGGAGAATCACTTGAACCTGGGAGGCGGAGGCAGCAGTGAGCCAAGATGGCGCCACTGCACTCCAGCCTGAGTGACAGAATGAGACTCTGCCTCAGGAAAAAAAAAAAAAAAAAAGCAAAAA"
"GL873564","8738781","8739084","chr6","92598388","92598711","90","83859607","GCTGGGCACAATGGCTCACACCTGTAATGCCAGCACTTGGGAGGCTAAGACGGGCAAATTGCCTGAGCTCACAAGTTCAAGACCCAGAGCGAGACCTCATCTCTAAAAAATTGCCATGCATTGTGGAGGGTGCCTGTTGTCCCAGCTACTTGGGAGGCGGAGAAAAGACAATCGCTTTAGCCCAAGAATTGAAGGTTGCTGTGAGCTGTGACGCTGTAGCACTCACCAAGGGCAACATAGTGAGACTCTGTTTCAAAATAAATAAATAAATAAATAAAAATAAATAAATAAAATAAAAACAAAA","GGCTGGGCTCAGTGGCTCATGCCTGTAATCCCAGCACTTTGGGAGGCCAAGGCTGGCAGATTGCCTGAGGTCAGGGGTTCAAGACCAGCCTGGCTAACATGGTGAAACCTCATCTCTAATAAAAATACAAAGATTAGCTGGGTTTGGTGGCACATGCCTGTAGTCCCAGCTATTTGGGAGGCTGAGGCAGGAGAATCGCTTGAACCCAGGAGTTGGAGGTTGCAGTGAGCTGAGATGGCACCACTGCACTCCAGCCTGGGTGACACAGCAAGACTCCGTCTCAAAAAAAAAAAAAAAAAAAAAAAAAAGAAAAGAAAAAAAAAA"
"GL873564","9560044","9560238","chrX","30236033","30236239","48","20675989","GGCCAGGTGCGGTGGCTCCTGCCTGTAATCCCAGCACTCTGGGAGGCCTAGGTGGGTGGATTGCCTGAGCTCACTGGTTGGAGACCAGCCTGATACAGATTGAGACCCCCTGCCTCTAAGAATAGCAGGGTGTTGTGACAGACACCTAAAGTCCCAGCTACTCGGGAGGCTGAGGCAAGAGAATCTCTTGAGCCC","GGCTGGGTGCGGTGGCTCACTCCTGTAATCCCAGCACTTTGGGAGGCCAAGGTGGGCGGATCACCTGAGGTCAAAAGTTCGAAACCAGCCTGACCAACAGGGTGAAACCCCGTCTCTACTAAAAGTACAAAAATTAGCCGGGCATGGTGGCAGGCACCTATAATCCCAGCTACTTGGGAGGATGAGGGAGGAGAATCACTTGAACCC"
"GL873564","9560508","9560604","chr1","212121416","212121513","30","202560908","TCGCTGTGCCCAAAAGTTAGAGGTTGCTGTGAGCTATGATACCACTGCACTTTACTGAGGGTGACAAAGTGAGACTCTGTCTCAAAAAATAAATAAA","CTTGAACCTGGGAGGTGGAGGTTGCAGTGAGCCAAGATCATGCCACTGCACTCCAGCCTGGGCAACAGAGCGAGATTCTGTCTCAAAAAAAAAAAAAA"
"GL873564","9753449","9753658","chr19","10370828","10371033","59","617379","TGAGACCCTGGTCTCTTCTAAACATTAAAAAAAAAAAGAAAACTGGGTGTTGTGGCGATGCCCATAGTCCCAGCTACTGATGAGGCTGAGGCAGGGGGATCACTTGAACCCAGGAGTCTGAAGTTGCTGTAAGCTAGGCTGAAGTCACAGTTGTCTAGCCTAGGGCAATAGAGTAAGACTGTCTCACAAAAAAAAAAAAAGGAAAGAAAA","GAAACCCTGTCTCTACTAAAAATACAAAAAATTAGCTGGGTGTGGTGGTGCGTGCCTATAATCCCAGCTACTCAGGAAGCTGAGGTGGGATAATCACTTGAACCTGGGAGGCAGAGGTTGCAGTGAGCCCCAGACTGTGCCACTGCACTCCAGCCTGGGTGACAGAGTCAGACCCTGTCTCAAAAAAAAACAAAACAAAAAAAAAA"
"GL873564","9753896","9754006","chr17","50277667","50277784","33","40523771","GCTGGGCAGGGTGGCTTGTGCCTGTAATCCTCACATTCTTGGAAGCCAAGTTGGTGGATTTCTTGAGCTCAAGAGTTCAGCCTGAACAACGGTGAGACCCCTGTCTCTCTC","CCGGGCATGGTGGCTCATGCCTGTAATCCCAGCACTTTGGGAGGCCAAGGTGGGTGGATCACTTGAGGTCAGGAGTTCAAGACCAGCCTGGCCAACATAGAGAAACTCTGTCTCTACT"
"GL873564","10693118","10693253","chr1","29437872","29437991","31","18744754","GGCCAGGCGTGGTGGCTCACGCCTGTAGTCCCAGCGCTATGGGAGGCCGAGGCGGGTGGATCACCTGTGCTCAGAGGTTCGAGACCAGCCAAGACCTCCCTGAGCCAAATGAGCCAGAGTGAGACCCCGTCTCTAC","GGCCGGGCGTGGTGGCTCACGCCTGTAATCCCAACATTTTGGGAGGCCAAGGCGGGTGGATCACCTGAGGTCAGAAGTTCGAGACCAACCTGGCCAACATGGTGAAACCCCTGTCTCTAC"
"GL873564","11596705","11596819","chr15","17759279","17759407","35","6162574","AATCCGCTACTCGGGAGTCTGATGCAGGAGGATCCCTGGAACCCGGGAGTGAGCTAGGCTGTCCATTCTACCCAAGGCAGAAGAGTGAGATTCTGTCTCAAAAAAAAAAAAAAAA","AATCCCAGTTACTCAAGAGGCTGAGGCAGGAGAATTGCTTGAACCCGGGAGGTGGAGCCGAGACCGCTCCACTGCACTCCAGCCTGGGTGACAGAGTGGGACTCTGTCTAAAAAAAAAAAAAAAAAAAA"
"GL873564","13278770","13278831","chr1","10318851","10318915","18","2959919","GGCTGAGCACAGTGGCTCATGTCTATAATCCCATCACTCTGGAAAGCTAAGAATGAGGATCT","GGCTAGGCATGGTGGCTTATGCCTATAATCCCAGCACTTTGGGAGGCTGAGGCAGACGGATCACC"
"GL873564","13278924","13279152","chr20","69116969","69117193","62","55838045","AAAATAGAGAATAAGAATCCCTTGAGCTCATGAGTTCAAGATCAGTCTGAACAAGTGTCAGACCCTATCTCTACTAAAAATGGAAAAATTAGCCAGGCACTGTGGCAAGTGCCTGTAGTCCCAGATTTCAGGAGGCTGAGGCAGGAGAATCATTTGAATCCAGGAGTTTGAGGTTGCTGTGAGCTAGGCTGACACCACTGTACTGTAGCCTGGGCAACAGAGTGAGACT","GAGGTGGGTGGATCACCTAAGGTCAGGAGTTCAAGACTAGCCTGGCCAACATGGTGAAACTCCATCTCTACTAAAAATACAATAATTAGCTGGGTGTGGTGGCATGTGCCTGTAATTCCAGCTACTCAGGAGGCTGAGGCAGGAGAATCACTTGAACCCAAGAGGCGGAGGTTGCAGTGAGCCGAGACTATGCCACTGCACTCTACCCTGGGCAACAGAGCAAGA"
"GL873565","1417041","1417214","chr4","44130284","44130433","54","42713243","GGCCAGGCGTGGTGGCTCACGCCTGTTGTCCCAGCGATTTGGGAGACTGAGGTGGGTAGATCACCTGTACTCAGAGGTTCGAGACCAGCTGAAGACCAGCCTGAGGCAGAGTGAGACCCCCGTCTCTATAAGAACAAGACAGCCGGACCTTGTGATCCCAGCTACATGGGTGGC","GGCCGGGTGCGGTGGCTCACACCTGTAATCCCAGCACTTTGGGAGGCTGAGGTGGGCAGATAACCTGAGGTCAGGCGTTCGAGACCAGCCTGGCCAACATGGTAAAACCCCGTCTCTACTAAAAATACAAAAATTAGCCAGGTGTGGTGG"
"GL873565","2138367","2138455","chrX","124155143","124155229","17","122016776","GGCTGGGCGTGGTACTCACGCCTGTTGTCCCAGTGCTGTGGGAGGCTGAGGTGGGTGGATCCCCTGAGCTCAGCAGAGTTTGAGACCAG","GGCTGGGTGCGGTGGCTCACGCCTGTAATCCCAGAACTTTGGGAGGCTGAGGTGGGTGGATCACCTGGGGTGAAGAGTTCGAGACCA"
"GL873565","2459722","2459938","chr7","32729330","32729532","57","30269608","AAAAAGACCAAACACCCCAGCTCTACTAAAAGTAGAAAAATTAGCTGGGTATTGTAGTGGGCACCTGTAGTCCCAGCTGCTTGGGAGGTTGCGGCAGGAGAACCACTTAAGCCCAGGAGTTGGAGGGTGAGGTGGGCTGAGGCCACTGCATTCTAGCCTAGGCAACAGAATGAGACTCTGTCTCAAACAAACAAACAAACAAACAAACAAAAAACAA","GAAACCCCATCTCTACTAAAAATACAAAATTAGCCAGGCATGGTGGTGCACACCTGTAGCTCCAACTACTTGGGAGGCTGAGGCAGGAGAATCACTTAAACCCAGGCAGTAGAGGTTGCAGTAAGCCAAGATCGCACCACTGCACTCCAGTCTGGGCAACAGAGTGAGACTCTGTCTCAAAAAAAAAAAAAAAAAAAAAAAAA"
"GL873565","2460219","2460297","chr10","28805224","28805297","28","26345005","CTCAAGCCTGTAATTCTAGCACAGCTGGGAGGCTGAGGCAGGAAGATCTCTCAGCTTAGGATTTCAAGACTAAACACAT","GTGGCTCATGCCTGTAATCTCAGCACTTTGGGAGGCTGAGGCAGGCAGATAACCTGAGGTCAGGAGTTCGAGAC"
"GL873565","11485258","11485580","chrX","66383160","66383473","97","54897902","GGCAGGGCACAGTGGCTCAATCACAGCACTCTGGGAGGAGGCTTAGATGGGTGGATTATTTGAGTTCACAAATTTAAGAACAGCCTGAGCAAGAGTGACACCCTGTCTCTACTAAAAAACAATAGGAAAAATAAAAACTAGCTGGGCATAGTGGCATATGCCTGTGGTTCCAACTACTTGGGAGGCAGAGGCAAGTTTGCTTAGCTAGTTTTTTTTCAGGCCCAAGAGTAGAGGTTGTTGTGAGCTGTGATGCCATAGCACTCTACATAGAGTGACAGAGTGAGACTTTGTCTAAATAAATAAATAAATAAAATTTTAAAAAA","GGCCAGGCACAGTGGCTCACACCTGTAAATCCCAGCACTTTGGGAGGCCGAGATGGGTGGATCACCTGAGGTCACGAGTTTGAGACCAGCCTGGCCAACATGGTGAAACCTCGTCTCTACTAAAAATACAAAAAAAAAAAAAATTAGCTGGGCGTGGTGGTGTGCACCTGTAGTCCCAGCTACTTGGGAGGCTGAGGCAGGAGAATCGCTTGAACCCAGGAGGCAGAGGTTGCAGCGAGCCGAGATCGCGCCACTGCACTCCAGCCTAGGTGACAGAGTGAGACTCTGTCTCAAGGAAAAAAAAAAAAAAAAAA"
"GL873565","13424539","13424574","chr1","174086158","174086184","14","160661619","ACCTAGGGTGAAAGTAAGACTGTCTCAAAAAAAGAA","AAGAGAGAGAAAGAGAGAAAGAAAGAA"
"GL873565","13424654","13424896","chr16","19730961","19731217","54","6306307","GCCAAGCACAGTGGCTCACACCTGTAATCCCAGCACTCTGGGAAGCCTAGGTGGGTGGATTACTTGAGCTCAGGAGTTCAAGATCAGCCTAAGCAAGAGTGAAACTCCCATGTCTAAATAAACAGCCGGGCATTGTAGTGGGTCCCTGTAGTCCCAGCTACTCAGGAGGCTGAGGCAAGAGAATCGCTTGACCCAGGAGTTGGAGGTTGCTGTGAGCTGAGGCCACGGCACTCTATCTAGGGT","GGCCGGGCACAGTGGCTCACGCCTGTAATCCCACCACTTTGGGAGGCCGAGGCGGGTGGATTACCTGAGCTCTGGAGTTAGAGACCAGCCTAGGCAACATGGTGAAACCCCATGTCTACTAAAATACAAAAAGCCGGGCGTGGCGGCGTGTGCCAATAGTCCCAGCTACTCAGGAGGCTGAGGCAGGAGAATTGCTAGAACCCGGGAGGCGGAGGTTGCAGTGAGCTGAGATCACGCCACTGCACTCCAGCCTGGGC"
"GL873565","13679578","13679856","chr1","27657515","27657797","72","13977937","GCAGGGTACAGTGGCTCACACCTGTAATCATAGTAACTCTTAAGCGGCTGAGGCAAGTGAGAGGCCTGAGATCAGGAGTCCAAGAATAGCCTAACCAAAAGTGAGACCCCATCTCTACTAAAAATAGAAAAAAACTAGCCAGGCATGGTGGCACTTACCATAGTCCCACCTCATAAGGCTGAGGCAAGAGTATCACTTGAACCCAGAAGTTTGAAGTTGCTGTCAGCTACAATGACATCATAGCACTTTACCCAGAGCTACAGAGTAAGACTCAGTCTC","GCTGGGTGCGGTGGCTCACACCTGTAATCTCAACACTTTGGGAGGCTGAGATAGGTAGATCACCTGAGGTCAGGAGTTCGAGACCAGCCTGGCCAACATGGTGAAACCCCATCTCTACTAAAAATACAAAAAACCTAGCCAGGCATGGTGGTGTGTACCTATAATCTCAGCTATTCAGAAGACTGAGACAGGAGAATCACTTGAACTTGGGAGGTAGAGGTTGCAGTGAGCCAAGATCACACCACTGCACTCCAGCCTAGGCAACAGAGTGAGACTCCGTCTC"
"GL873566","947388","947684","chr3","178868174","178868466","60","177920786","GGCCGGGTAGGGTGGCTCATGCCTGTAATCCTAGCATTTTGAGAGGCCAAGGCAGGTAGATTACCTGAGCTCAGGAGTTCCAGACCAGGCTGAGCAAGAGCCCCATCTCTATCAAAAATAGAAAAATTAGCTGGGTATGGTGGCACATGCCTNNNNNNNNNNNNNNNNNNNNNNNNNNNNNNNNNNNNNNNNNNNNNNNNNNNNNNNNNNNNNNNNNNNNNNNNNNNNNNNNATGACACCATAGCACTCTAACCTGGAGCAACAGAGTGAGACACCGTCTTAAAAAAAAAAAAAAAA","GGCCGGGTGTGGTGGCTCATGTCTGTAATCCCAACACTTTGGGAGGCCAAGGCGGGTGGATCACCTGAGGTCAGGAGTTTGAGACCAGCCTGGCCAACATAGTGAAACCCCTCTACTAAAAATAAAAAATTAGCCAGGTGTGGTGGCANNNNNNNNNNNNNNNNNNNNNNNNNNNNNNNNNNNNNNNNNNNNNNNNNNNNNNNNNNNNNNNNNNNNNNNNNNNNNNNNNNNNNNNNNNNNNNNCTCCAGGCTGGGCAACAGAGTGAGGCTCCATCTAAAAAAAAAAAAAAAAA"
"GL873566","2530056","2530102","chr1","123145244","123145289","11","120615188","AGGCCAAGGCAGTTGGATCACCTCAGCTCAGGAGTTTGAGACCCGCC","AGGCTGAGGGAGGCGAATCACCTGAGGTCAGGAGTTTGAAACCAGC"
"GL873566","2923434","2923499","chr1","38303497","38303565","19","35380063","GGGCTCAATGGCTCAGCCTGTAATCTTAGCAGTCTGGGAGGCTGAGGCAGGCGCCTGAGCAAGAGT","GCTGGGCGCAGTGTCTCGTGCCTGTAATCCCAGCACTTTGGGAGGCTGAGGCAGGCGGATCATCTGAGG"
"GL873566","3613441","3613522","chr3","54039458","54039545","21","50426017","GGTGGCACATGCCCGTGATCCCAGCACTCTGGGAGGCCGAGGAGATCGGACTGCCTGAGCTCAGGAGTTCGAGACCAGCCTG","GCGCGGTGGCTCACGGCCTGTAATCCTTGCACTTTGGGAGGCTGAGATGGGTGGATTACCTGAGCTCAGGAGTTCGAGACCAGCCTGG"
"GL873566","6100482","6100582","chr2","51286276","51286376","32","45185794","GGCTGGGTGAGTACCTCATGCATCAAGCCCAGTGTTCTGGAGGCTGAGGCAAGGGGATCCTTGATGTGGATAGTTCAAGGCCAGCCTGGCAATTAGCTAGA","GGCTGGGTGCAGTGGCTCACGCCTATAATCCCAGCACTTCGGGAGGCTGAGGCAGGCAGGTCACCTGAGGCCAGGAGTTCAAGACCAGCCTGGCCAACATG"
"GL873566","6245586","6245714","chr3","50507869","50508002","30","44262283","GCTGGGTGTGGTGGCTCACACCTATAATACCAGCACTTGGGAGGCCAAAGCAAGTGGATTGCCTGAGTTCACAAGTTCAAGACCAGCCTGAGCAAGAGTGAGACCCTGTCTCTTAAAAATAGGTGGGCG","GCCAGGTGCGGTGACTCACACCTATAATCCCAGCACTTTGGGAGGCCGAGGCACGTGAATCACCTGAGGTCAGGAGTTCAAGACCAGCCTGACCAACATGGTGAAACCTTGTCTCTACTAAAAATACAAAAACT"
"GL873566","6245992","6246162","chr16","22888303","22888475","37","16642311","TAGCTGGGCGTTGTGGCGGGCATCTGTAATCCCAGCTACCTGGGAGGCTGAGGCAAGAAAATCACTTAAGCCCAAGAGTTTGAGGTTGCTGTGAGCTGTGATGGCACAGTACTCTATTGAGGGCAACATAGTGAGACTCTGTCTCAAAAAATAAATAAATAAATAAATAAA","ATTAGCTGGGCGTGGTGGTGGGCACCTGTAATCCCAGCTTCTTGGGAGGCTGAGGCAGGAGAATCACTTGAGCCCAGGAGGCAGAGGTTGCAGTGAGCAGAGATCGTGCCACTGCACTCCAGCCTGGATGACAGAGTCAGACTTTGTCTCAAAAAAAATAAAAAATAAAAAAA"
"GL873566","6483968","6484033","chr19","10207852","10207913","17","3723884","AAAATATGGTAAAATAAGCCAAGGATGGTGGGTCACACCTGTAATCCCAGCTACTCAAGAGACTGA","TAAAAATACAAAATTAGCTGGGTGTGGTGGCACACACCTGTAATCCCAGCTACTCAAGAGGC"
"GL873566","7043395","7043464","chr10","28805224","28805297","20","21761829","GGCTAGGCCTGGTAATCCCAGCACTCTAAAAGGCTGAGGCAGGTGGATAGCCTGAGCAAGAGTGAGACCA","GTGGCTCATGCCTGTAATCTCAGCACTTTGGGAGGCTGAGGCAGGCAGATAACCTGAGGTCAGGAGTTCGAGAC"
"GL873566","7888407","7888429","chr16","1275850","1275872","4","6612557","CTAAAAATAAAAAATTAGTCTTG","CTAAAAATACAAAAATTAGCCAG"
"GL873566","7888682","7888751","chr13","39203832","39203891","22","31315150","GTAGTCTTGGCGTAGTGATATGTACCTTTAATCCCAGCTACTCAGGAAGTGGAGGAGGAAAGAGTACAAG","TTAGCTGGGCGTAGTGGTGTGTGCCTGTAATCCCAGCTACTTGGGAGGCTGAGGCGGGAG"
"GL873566","8203857","8203949","chr20","18199749","18199840","19","9995892","GGCCCGGCATGGTGGTGCTTTGCCTATAATCCCAGCATTCTGGGAGGCCCAGGCAGGCGGATCACCTGAGCTCACAGGTTCAAGAATGGCCTG","GGCCGGGCATGGTGGCTCACACCTGTAATCCCAGCACTTTGGGAGGCTGAGGCAGGCGGATCACCTGAGGTCAGGAGTTCGAGACCGGCCTG"
"GL873566","8268872","8268975","chr15","10815564","10815667","26","2546692","GTGGCTCATGCCTGTAATCCTAGCACTCTGGGAGGCCGAGGCAGGTGGATTCCCTGAGCTCATAGGTTTGAGACCACAAGCAAGTCCAAGACCCCATCTCTTTT","GTGGTTCATGCCTGTAATCCCAGCACTTTGGGAGGCCGAAGTGGGCGGATCACCTGAGGTCAGGAGTTTGAGACCATCTGGCCAAGATGTAGAAACCCCATCTT"
"GL873566","8269263","8269458","chr15","77706857","77707054","55","69437594","AAGACCCCATCTCTTAAAAAAGAAAAAAAAAGCTGGGTGTTGTGGCCTTCACCTGTAGTCCCAGCTACTGGGGAGGCCAAGGCAAGAGACTTGCTTGAGCCAGAGTTTGAGGTTGCTGTGAGCTATAGTGCCACGGCACTCTACCAAAGGCAACAAAGTGAGACTGTCAAAAAAAAAAAAAAAAGAAGAAGAAGAA","CCCCATCTCTATTAAATATACAAAAAAATAGCTGGGTGTGGTGGTGTGCGCCTGTAATCCCAGCTACTTGGGAGGCTGATGCAGGGGAAGTGCTTGAACCAGGGAGGTGGAGGTTGCAGTGAGCCGGAATCGTGCCACTGCACCCCAGTCTGGGCAACAGATTGAGACTCTGTCTCAAGGAAAAAAAAAAAAAAAAAA"
"GL873566","8592056","8592127","chr10","28805224","28805297","15","20213168","TCTTGCCTGTAATCTCAGCACTCTGGGAGGCTGAGGCAGGCAGATCAACTGAGCTAACAAGTTCGAGACCAG","GTGGCTCATGCCTGTAATCTCAGCACTTTGGGAGGCTGAGGCAGGCAGATAACCTGAGGTCAGGAGTTCGAGAC"
"GL873566","8809109","8809200","chr11","48033118","48033204","26","39224009","ATAGCCAGGCTTGTTGCAGGCACCTGTAGTCCCAGTTACTCTGGAGGCTGAAGCAAGGGAATATCTTGAGCCCAAGAGTCTGAGGTTGCTGT","TTAGCCTGGCATGGTGGTGACACCTGTAATCCCAGCTACTCAGGAGGCTGGGAAGGAAAATCGTTTCAACCCAGGAGGCAGAGTTTG"
"GL873566","8809477","8809608","chr19","10830410","10830544","33","2020933","GGCCAGGCGCAGTGCCTCATGCCTGTAATCCTAGAACTCCGGGAGGCTAAGGAGGGTGGATTTCCTGAGTTCACAGGCTGGAGACCAGCCTGATCTAGAGTGAGATTCCCAGCTCTAAAAATAGCTGGCCTT","GGCCAGGTGCAGTGGCTCATGCCTGTAATCCCAGCACTTTGGGAGGCCAAGGTGGGTGGATCACCTGAGGTCAGGAGTTCGAGACCAGCCTGATCAACGTGGTGAAACCCCATCTCTACTAAAATTGCAAAATTA"
"GL873566","9503716","9503881","chr12","63241189","63241340","56","53737473","TATTAAAAAAAAAAGGAATTCAAGGCCAAGAGCAGTGGCTTTTGCCTGTGATACTTCCACTGTAGGAGGCCGAGGTGGAAGGATCACTTGAACTCTGGAGTTTGAGGTTGCTGTGATCTAGGCTGACACCACAGCACTCTAACTTGGTGGGCAACAGAGCAAGACT","AAAAACAAAAATTAGCCAGGTGTGTTGGCATGCACCTGTAGTCCCAGCTACTAGGGAGGCTGAGACAGAAGAATCACTTGAACCCAGGAGGTGGAGGTTGAGTGAGCCAAGATCGCGCCACTGCACTCCAGCCTGGGTGACAGAGCGAGACT"
"GL873566","9537883","9537992","chr16","43341998","43342113","30","33804115","ATGCCTGTAATCCTAGCACTTGGGAGGCCAAGGTGGGTGGATTGCCTGAGATCACAGGTTCAAGACCAGCCTGAGCCAGAGTGAGACCCTGCCTCTAAAATGAGCCAGGT","GCCTGTACTCCCAGCACTTTGGGAGGCCAAGGCGGGTGCATCACCTGAGGTCAGGGGTTCAAGACCAGCCTGGCCAACATGGTGAAACTCTGTCTCTACTGAAAATTCAAAAAATT"
"GL873566","9538266","9538462","chr7","167658032","167658223","54","158119766","TTAATTAATTAATTAAATAAAATGAGCCAGGTGTTGTGATGGGCGCCTGTAGTCCCAGCTACTTGGGAGGTGGAGGCAGGATAATCACTTGAGTCCAGGAGTTGGAAGTTGTTGTGAGCTGTGACGCCATTGTACTTGACCCAGGGCGACATCTTGAGGCGCTCTCTCTCAAAATAAATAAATAAAGAAAGAAAGAA","TACTAAAATACATACAAAAATTAGCCAGGTATGGTGGCAGGCCCCTGTAGTCCCAGCTACTCGGGAGGCTGAGGCAGGAGAACTGCTTGAACCCAGGAGGTGGGGATTGCAGTGAGCTGAGATCGCACCACTGCACTCCAGCCTGAGCGACAGAGTGAGACTCTGTCTCAAAAATAAAAAAAGAAAAAAAAA"
"GL873566","13663722","13663916","chr1","23558411","23558571","70","9894689","CTCAAGACCAGCCTGAGCCAAGAACGAGACTGAAAATAGAAAAATTAGTGGGACGTTATGTTGAGTGCTGGCTACTCTAGAGGGTGAGGTAGGAGAATTGTTTAAACTCATGAATTTAAGGTTGCTGTGAGCTAGGCTGACGCCACAGCACTGTAGCCTGGGCAACAGGCTACAGAACAGAGTGAGACTCTGTTT","AAAAATACAAAAATTATCTGGGCATGGTGGTGGGTGCCTGTATTCCCAGCTACTCTGGAGGGTGAGGCGGGAGAATTACTTGAACCCAGGAGGTGAAGGTTGCAGTGAGCCAAGATCACGCCACTGCACTCTAGCCTGGGCAACAGAATGAGACTCTGTCT"
"GL873566","13664206","13664293","chr7","151280825","151280914","17","137616619","GGCTAGATATGGTGGCTCATGCCAGTAATCTTAGCACTTTGGGAGGCTGAGGGGAGAGGATCACTTGAGCTGAAAAGTTCAAGACCAA","GGCCAGGCATGGTGGCTCATGCCTGTAATCCCAACACTTTGGGAGGCTGAGGTGGGTGGATCACTTGAGGCCAAGAGTTCAAGACCAGCC"
"GL873567","8375378","8375469","chr3","123612391","123612479","29","115237013","GGTTGGGCTTGGTGGCACGTACCTATGATCATCCTAGCTACTCAGGGAGCATAAGGCAGAAGAATTGCTTTAGCCCGGGAGTTGAGATCAAC","TTAGTTGGGCGTGGTGGCGCATGCCTGTAATCCCAGCTTCTCGGGAGGCTGAGGCAGGAGAATGGCTTGATCCCAGGAGATAGAGGTTG"
"GL873567","9062667","9063009","chr7","6620384","6620702","97","2442283","GGCCAGGCGTGGTGGCTCACGCCTGTTGTCTCAGCGCTGTGGGAGGCCGAGGCGGGTGGATCGCCTGTGCTCAGAGGTTCGAGACCAGCATGAGCCAGAGTGAGAGCCAGAGTAAGACCCCCTCTCTACCAAAAATTGCTGGGTGTTCTGGCAGGTGCCTGTAATTCCAGGTACTTGGGAGGCTGAGGCTAGAGAATCACTTAAACCCAGGGACCCAGGGGTTGGCGGAGGTTGCTGTGAGCTATGATTCTATGGTATTCTACTGAAGGACACAAAGCGAGACTCTGTCTCCATAAATAAATAAATAAATAAATAAAATAAAAGCAAAATTAAAAAAAAAAAA","GGCCAGGCACAGTGGCTCATGTCTGTAATCCCAGCACTTTGGGAGGCCGAGGCGGGTGGATTACCTGAGGTCAGGAGTTCTAGACCAGCCTGGCCAACAAGGCGAAACCCTGTCTCTACTAAAAATACAAAAAATTAGCTGGGCGTTTTGGCACATGCCTGTAATCCCAGCTACTTGGGAGGCTGAGGCAGGAGAATTGCTTGAACTGGGGAAGTGGAGGTTGCAGTGAGCTGAGATCACACCATTGCACGCCTGAGCAACAGAGCGAGACTCTGTCTCAAAAAAAAAAAAAAAAAAAAAAAAGAAAAGAAAAAGAAAA"
"GL873567","11215752","11215787","chr1","62915138","62915167","12","51699386","CAATAAAGCAAGACTCTGCCTCCAAAAGAAAAAAAA","CAAACAAACAAACATCACAAAAAAAGAAAA"
"GL873567","11215868","11216117","chr8","45194211","45194474","73","33978343","GGCTGGGTGTGATGGTTCAGGCCTGTAATCCCAGCGCTCTGGGAGACCAAGGCAGGATAGCCTGAGGTTAAGAGTTTGAGACCAGCCTGAGCAACACAAGACCCTGTCTAAACCAGGAAAATTACTGGGGTGTGGTGGCGTGTGCCTTAATCCCAACTACTCAGGAGGCTAGAGTATTGCTTGAGGGCAGAAGACTGAGGTTGCTGTGAGGAAAGGCTAAGGTCAAGCCATTCTAGCCCAGGCAATAGAG","GGCCGGGTGTGGTGGCTCATGCCTGTAATCCCAGAACTTTGGGAGGCCAAGGCAGGTAGATTACCTGAGGTCAGGAATTGGAGACCAGCCTGGCCAACATGGTGAAACCTCTTCTGTACTGAAAATTACCTGGGCATGGTGGCACACGCCTATAATCCCAGCTACTCAGGAGGCTGAGGCAGAATTGCTTGAGCCCGGGAGACAGAGGTTGCAGTGAGCCAAGATCGTGCCACTGTCCTCCAGTCTGGCCAACAGAGCAAGACT"
"GL873567","12342574","12342696","chr3","166690011","166690120","46","154347437","GTACGCGCAAACCAGAAAAATCAACTAGGTGTGGCAGGGCACACCTGTAGTCCCAGCTACTGGGGAGGGTGAAGCAAGAGATTGCTCAAGTCTGAGGTTACAGTGAGTTAAGATGATACCACT","TACACATACAAAAAATCAGCTGGGTGTGGTGGTACATGCCTGTAATCCCAGCTACTCAGGAGGCTGAGGCCGGAAAATCACTTGAACCCAGGAGGCAGAGGTTGCAGTGA"
"GL873567","12342734","12342873","chr8","96368294","96368428","43","84025560","GGCCAAACACAGTAGTTTATACCTATAATTCCAGCACTCTGGGAAGCTGAAGCAGAAGGATCAGCTGAGGTCAGGAGCCTCAAGACAAGCCTGGGCAAGACTAAGACTCCCCTCCATCCCTTCCCCCACTGTCTTCTCAC","GGCCAGACACAGTGGCTCACACCTGTAATCCCAGCTCTTTGGGAGGCTGAGGCAGGCGGATCACCTGAGGTCAGGAGTTCAAGACCAGCCTGGCCAACATGGTGAAACTGCATCTCTACTAAAAATATAAAACCA"
"GL873568","4322030","4322103","chr11","54983169","54983243","11","50661139","GGCCAGGCGCAGTGGCTCATGCCTTTAATCATAGCACTCTGGGAGGCTGAGGTAGGCGGATCTCCTGAGCCAGG","GGCCAGGTGCAGTGGCTCATGCCTGTAATCCTAGCACTTTGGGAGGCCGAGGTGGACCGATCACCTGAGGTCAGG"
"GL873568","4439574","4439747","chr7","26745376","26745549","54","22305802","GGCTGGGCATGGTGCTCACACCTGTAATCATAGCACTCAGGGAGGCCGAGGTGAGTGGATTGCCAGAGCTCACAGGTTTGAAACCAGACAGAGCCTTTTTTTTTTTAGAAGAAATTGTAGGCTGGGCATGGTGCTCATACCTGTAATCATAGCACTTGGGAGGCCAAGGCAAGA","GGCTGGGCATGGTGGCTCACGCCTGTAATACCAGTACTTTGGCAGGCCGAGGCGGGCAGATCACCTGAGGTCAGGAGTTCAAGACCAGCCTGGCCGTTTCTACTAAAAATACAAAAAATTAGCTAGGCATGGTGGTGCGCACCTGTAATCCCAGCTACTCGGGAGGCTGAGGCA"
"GL873568","4546898","4547014","chr15","31980678","31980795","24","27433780","GGCAGGGTGTGGTGTACACCCCTATAATCCCAGCACTTTGGGAGGCTAAGGCAGGAGCATCACCTGGGGCAGGAGTTCAAGGCCAGCCCGGAGAACAGAATGAAACTCCATCTCCAC","GGCAGGGCGTGGTGGCTCACGCCTCTAATCCCTGCACTTTGGGAGGCCAAGGCAGGCAGATCACCTGAGGTCAGAAGTTCAAGACCAGCCTGGCCAATGTGGTGAAACCCCATCTCCA"
"GL873568","5509331","5509406","chr12","122182458","122182528","25","116673127","TAATCCTAGCACCCTAGGAGGCCCAGGTGGGTGGATTACCTGAGCTCAGGAGTTCAAGAGCAAAAGTGAGACCCCT","CCCAGCACTTTGGGAGGCCAAGGCAGATGGATCACCTGAGGTCAGGAGTTGAAGACCAGCCTGGCCAACAT"
"GL873568","5509687","5509883","chr11","2904691","2904882","40","2604996","GTGAGACCCTTGTCTCTACTAAAAGTAGAAAAACTAGCCAGGTGTTGTGGCAGGTGCCTGTAATACCAGCTACTTAGAAGGCTGAGGCAGGAAGATCAGTTGAACCAAAGAGTTTGAGATTGCTGTGAGCTATGATGAAGCCACAGCACTCTACTATCCAGAGCGACAGAGGGAGACTCTGTCTCCAAAAAAAAAAA","GTGAAACCCTGTCTCTACTAAAAATACAAAAATTAGCCAGGTGTGGTGGTGCATGCCTGTAATCCCAGCTACTCAGGAGGCTGAGGCAGGAGAATCACTTGAACCCAGGAGGTGGAGGTTGCAATGAGCCAAGATCGTGCCACTGCACTCCAGCCTGGGTGACAGAGCGAGACTCCATCTCAAAAAAAAAAA"
"GL873568","7119774","7119822","chrX","41233833","41233871","13","34114059","AAAAGTAAAAAATGAGCCGGGTGAGGTAGCTCACGCCTGTAATCCCAGC","AAATCAGCCGGGTGTGGTGGCTCACGCCTGTAATCCCAG"
"GL873568","10881797","10881967","chr1","164648998","164649168","46","153767201","AAAATCACATATTTGCCTGGCATGTTGACTCATGCCCCTATGATCCTAGCACTCTGGGAGGCTGAGGCAGGAGCCTCACTTGAGTCTGTGAGTCTGAGGTTGCTATGAGCAAGGCTGATGCCATGATACTCTAGTGTGGTACAACAGAGTGAGACTCTGTCTCAAAAAAAA","AAAAACACATATTAGCTGGGTATGGTTGTGCGTGCCTGTAATCCCAGCTACTTGGAAGGCTGAGGCAGGAGAATCACTTGAACCCGTGAGGCGGAGTTTGCAGTGAGCTGAGATTGTGCCACTGCACTCCAGCCTGGGCAACAGAGCAAGACTCTGTCTCAAACAAACAAA"
"GL873569","1403943","1404082","chr2","53765152","53765289","48","52361209","AAGCTGAAGCAGAAAAACGGGCTAGAGGTCAAAAGTTTGAGACCTACCGTGGCTACACAGCAAAACTCTGTCTCTAAAAAAAATAAATAAGACCAGGTAAGGTGGTCATGACTATACTCCTAGCCCCTTAAGAGGCTGAG","GAGGTGGGTGGATCACCTGAGGTCAGGAGTTCCAGAACAGCCTGGTCAACATGGCGAAACACTGTCTCTACTAAAAATACAAAAATTAGCCAGGTGTGGTGGCATGCACCTGTAGTCCCCGCTACTCAGGAGGCTGGG"
"GL873569","7343422","7343556","chrX","124155286","124155406","55","116811864","TTTGAAAGTAGACTGCAAACATCATGTTGCTTCACCTCTAAATATATTAATATGGGCCAGGTGCAGTGGATCATGCCTGTAATCCTAGCACTTGCTAGGCCAAGGCTGGCGGATAGCCTGAGCAACAGCGAGACC","ATCAGCCTGACCAACATAGTGAAACCCCATCTCTACTAAAAATGCAAAATTAGCTGGGCGTGGTGGTGCATGCCTGTAATCCCAGCTACTTGGGAGGCTGAGGCGGGAGAATCACTGGAAC"
"GL873569","7404564","7404762","chr6","586928","587122","48","6817636","GAGATCCCATCTCTTAATGAAAATAAAACAATTAGCTGCTATTGTGGCAGGCACCTGTAATTCCAGCAACCCAGGAGGCTGAGGCAGGAGGATCACGTGAACCCCACCAGTTTGAGGTTGCTATGAGCCAGGCTGATGCCAGGACACTCCAGCCTGGGCAACGGAGTGAGACTCCATCTCCAAAAAAAGCAAACAAAAA","GAAACCCCATCTGTACTAAAAACACACAAATTAGTGGGATGTGGTGGCACGTCCCTGTAATCCTAGCTATTCAGGAGACTGAGGCAGGAGAATCACTTGAACCCAGGAGGTGGAGGTTGCAGTGAGCCGAGGTCACACCACTGCACTCCAGCCTGGGCAGCAGAGTAAGACTCCATCTCAAAACAAAAACAAAAA"
"GL873569","7405040","7405133","chrX","21386588","21386682","29","13981548","GGGCAGGGCGGCTCAGGCCTCTAATCCTAGCACTCTGGGAGCTTCCTTGAGCTCAGGAGTTCAAGACCATCCTAAGCAACAGAGATCCCATCTC","GCTGGGCACGGTGGCTCACGCCTGTAATCCCAGCACTTTGGGAAGCCAAGGTTTGAGGTCAGGAGTTCAAGACCAGCCTGGCCAACAGGCTGCAA"
"GL873548","15249374","15249463","chr5","46485072","46485159","19","31235698","GGCCAGGCATGGTGGCTCATACCTATTGTCCTAGCACTGTGGGAAGCCAAGGCAAGTGGATCACCTGAGCTCTAGAGGTTCGAGACCAGC","GGACAGACACAGTGGCTCATGCCTGTAATCCCAGCAGTTTGGGAGGCCAAGGCAGGTGGATCACCTGAGGTACAGAGTTCAAGACCAG"
"GL873548","15817199","15817306","chr7","158031905","158031997","37","142214706","AAAAAAAAAGAGTTGGAGGTTGCTATGAGCAACATCAGCATGGCACTCAATTCCAGGGTGACTGACTGAGACTGTTGTAGCTATACTCCAAAAAAAAAAACACACAAA","CCAGGAGGTGGAGGTTGCAATGAGCCAAGATCACACCACTGCACTCCAGCCTGGGTGACAGGGTGAGATTCTGTCTCAAAAAAAAAAAAAAAA"
"GL873548","15817589","15817786","chr3","3025868","3026088","60","12791721","GGCCAGGCATGGTGGCTTCTGTAATGCCAGCATTCTGGAAGGCTGAGGTAGGCAGTAGCTTGAGCTCAGTAGGAGAACAGCCTGACCAAAAGTGAGACCCTGTCTCTAAAAATAGTCGTTTGTGGTGGTTACCTGTTGTCCCAGCTACTAGGGAGGCTGAGGCAAGAGAATCACTTGAGCGTAAGAGTTGGAGGTTGC","GGCCAGGCACGGTGGCTCATGCCTGTAATCCCAGAACTTTGGGAGGCTGAGGTGGGCAGATCACCTGAGGTCAGGAGTTGGAGACCAGCCTGACCAACATGGTGAAACCCTGTCTCTACTAAAAATACAAAATTAGCCAGGTGTAGTGGCACGTGCCTGTAATCACAGCTACTTAGGAGGCTGAAGTAGGAGAATCACTTGAACCTGGGAGGTGGAGGTTG"
"GL873548","15856498","15856605","chr18","35090078","35090171","38","19233580","CCCCCCCCAAAAAGAAAAGGGTTGCTTGAATCTAGGAGTTTGGGGTTGCTGTGGGCTAAGCTGATACCACAGCACTTTAGCCTGAGCAAACAGAGTGACACTCTGTCT","AAGCAGGAAATCGCTTGAACCCAGGAAGCAGAGTTGCAGTGAGCCAAGATCGCACCACTGCACTGCAGCCTGAGCAACAGAGAAAGACTCTGTC"
"GL873548","15856683","15856877","chr3","3200882","3201085","53","12655801","GCCAGGCACAGTGGCTCATGCCTATAATCCTAGCACTCTGGGAGGCCAAGGCAGGATTGTCTAAGCTTGGGAGTTTGACAGCAGCCTGAGAAAGATTGAGACCCCTGTCTCTACTAAAAAATAGAAAAATTAGCTGAGTGTTGCAGCAGGTGCCTGTATTTCCAGCCAAGGGGGAGGTTGAAAAGGGTCGCTTCA","GGCCAGGCGCAGTGGCTCATGCCTGTAATCCCAGCACTTTGGGAGGCCGAGGCGGGTGGATCATAAGGTCAGGAGTTTGAGACCAGCCTGGTCAACATGGTGAAACCCCATCTCTACTAAAAATACAAAAATTAGCTGGGTGTTGTGGCACATACCTGTAATCCCACCTACTCAGGAGGCTGAGGCAGGAGAATCACTTGAACC"
"GL873549","1940307","1940608","chr12","9481260","9481565","74","7540953","GGCTGGGCGCAGGGGCTCATGCCTGTGACCCTAGCACCCTGGGAAGCCAAGGCGGGCAGATCGCCTAAGCTCACGAGTTTGAAACCAGCCTTAGCTAGAGTGAGACCCCCAATACTAAAAAAATAGCCAGGCTTTGTGATGGGCGCCTGTAGTCCCAGCTACCTGGGAGGCTGAGGCAAGAGAATGGCTCAAGCCCAAGAGTCTGAGGTCACAGTGAGCTACTGACGCCACCGCACTCTATTGGAACAACAAAGTGAGACTGTGTCTCAAACAAACAAACAAACAAACAAACAAAAAAGAAA","GCTGGGCGCGGTGGCTCATGCCTGTAATCCCAGCACTTTGGGAGGCCAAGGCAGGTGGATCACCTGAGGTCAGGAGTTCGAGACCAGCCTAGTCCACATGGTGAAACCCCATCTCTACTAAAAACTAGCCAGGCGTGGTGGTGCGCACCTGTAATCCCAGCTACTCGAGAGGCTGAGGCAGGAGAATCACTTGAGCCTAGGAAGCAGAGGTTGTGGTGAGCTGAGATCACACCACTGCACTCCAGTCTGGGCGACACAGTGAGACTCTTGTCTCAAAAACAAAAAACAAACAAACAAACAAACAAA"
"GL873549","2657819","2658019","chr11","18547798","18548000","50","15889979","GGCCTGGCACTGTGGCTCACACCTGTCAGGTTAACACTCTGGGAGGCTGATATGGGTGGGTCTCCTGAGTTTAGGAGTTTAAGACCAGCCTAATCAAGAGTAAGACCTGCCTTTACTAAAAATAGAAACACTCACCAGGACTACTGTGCACCTACAGTCCCAGCTACCTGGGAGGCTGAGGCAAGAGGATTGCTCAAGCCC","GGCCAGGCACTGTGGCTCACACCTGCAATCCCACCACTCTGGGAGGCAGAGGCAGGTGGATCACCTGAGGTCAGGAGTTTGAGACCAACCTGGCCAACAGAGCAAAACACTGCCTCTACTAAAAATACAAAAACTAGCCAGGTGTGGTGCATGCCTATAGTCCCACCTACTTGGGAGGCTGAAGCAGGAGAATCTCCTGAGCC"
"GL873549","8853848","8853952","chr12","88112976","88113081","32","79259128","AGCCAGCTGTGTGGCTCATTCCAGTAATTCCAGTTACTGGGGAGGCTGAGACAGGAGGATCACTTGAATGCAAGAGGTGGCGAGAACTCAGCTTTAAAAATAAAA","GGCCAGATGCAGTGGCTCATGCCTGTAATCCCAGCACTTTGGGAGGCTGAGGCAGGCGGATCACCTGAGATCAGGAGTTTGAGACCAGCCTGGCCAACATGGTAAA"
"GL873549","10378794","10378882","chr20","18199749","18199840","17","7820955","GGCCAGGCACGGTGGTTCACCTGTGATCCCAGCACTCTGGGAGATAAGGCAGGCTGATCACCTGAGTTCACAGGTTGGAGACCAGCCTG","GGCCGGGCATGGTGGCTCACACCTGTAATCCCAGCACTTTGGGAGGCTGAGGCAGGCGGATCACCTGAGGTCAGGAGTTCGAGACCGGCCTG"
"GL873549","15488169","15488282","chr10","38476693","38476794","41","22988524","CTGAGCACACGGGTTCACACCTGTAATCCCAGCACGCTGAGAAGCCCAGGCAAGAGGCTGACCTCCAGCCTGGGTGACGGAGCGAGATTCCCCCCCACCCCCGACCAAAAAAAA","CTGAGCGCTGGTAGCTTACACCTGTAATCCCAGCACTTTGGGAGGCCTAGACAGGCGGATCACTTGGGGTCAGGAGTTTGAGACCAGCCTGGCCAATATGAT"
"GL873549","17403348","17403519","chr10","38461164","38461337","46","21057816","GCCAGGCACAGTGGCCCACACCTGTAATCCCAGTACTGTGGGAGGCTGAGGCAGGCTGAGGCAGGCATGGATCACTGAGGTTGCTGTGAGCTAAGATGCCATGGCCCTCCACCCAAAGTGACAGAGTGAGACTCTGTCTCAGAATTAAAAAAAACAAAGAAAGAAAAATAAA","GCCAGGCATGGTGACTCACGCCTATAATCCCAGCACTTTGGGAGGCTGAGGCATGAGAATCACTTGAACCCAGAAGGCAGAGGTTGCAGTGAGCTAAGATTGTGCCACTGTACTCCTGCCTGGGTGATGGAGTGAGACTCTGTCTCGATTTAAAAAAAAAAAAAAAAAAAAAAA"
"GL873550","801968","802043","chr15","50500527","50500602","20","49698559","GTAGCCAGGTATGGTAGTGCAGGCCTGTACTCCCAGCTACTTGGAAAGCTAAGGCAATAGAATCATTTAAGCCCAG","TGGCCGGGCATGGTGGTACATGCCTGTAATCCCAGCTACTTGGGAAGCTGAAGCAGGAGAATTGCTCGAACCCAGG"
"GL873550","802343","802376","chr3","33494224","33494257","9","32691881","TAAGACTTTGTCTCTACTAAAAATAGAAAAAGTG","GTGAAACCCGTCTCTACTAAAAATACAAAAATTA"
"GL873550","2805841","2805900","chr2","93673843","93673900","18","90868002","CTATTCAAAATAGCTAAAATGGGCAGGGCAAGGTGGCTCACACCTGTAATCCCAGTACTC","TAAAAATGTAAAAGATTGGCCGGGTGTGGTGGCTCACTCCTGTAATCCCAGCACTTTG"
"GL873550","4153085","4153214","chr16","18855701","18855834","37","14702616","GGCAGGGCTTGGTGGTAAAAGCCTGTAATCCTACCACTCTGGGAGGCAGAGGTGGTTAGATTGCATGAGGTCACTGGTTGGAGACCAGCCTGAGCTAGAGCAAGACCTCATCTCCAAAAATAGCAGGGCT","GGCTGGGCGCGGTGGCTCACACCTGTAATCTCAGCACTTTGGGAGGCCGAGGTGGGTGGATCACCTGAGGTCAGGAGTTCGAGACCAGCCTGGCCAACATGGCAAAACCCCATCTCTACAAAAATACAAAATTA"
"GL873550","4153472","4153634","chr7","17472856","17473028","43","13319384","AATAAAAATAGCAGGGCTTTGTGGCGGGCACCTGTAGTCCCAGCTACTTGGGAGGCTGAGGCAAGACAATTGCTTGAGCACAAAGTTGGAGGTTGTTGTGAGCTGTGACATCATAGCACTCTACCAAGGGAGATAGAGTGAGACTATCTCGAAGAAAAAAAAA","ATACAAAAATTAGCCAGGTGTAGTGGCGTGCACCTGTAATCCCAGCTACTCGGGAGGCTGACGCATGAGAACTGCTTGAACTCAGGAAGTGGAGGTTGCAGTGAGCTGAGATAGTGCCACTGCACTCCAGCCTGGGTGACAGAGCAAGACTCCATCTCAAAAAAAAAAAAGAA"
"GL873550","6050671","6050965","chr7","84009904","84010193","74","77959233","GGTGGCTCACGCCTGTTATCCTAGCACTCCAGGAGACTAAGGTAGGAGGATGCCTTGCTTGAACTCAAGAGTTCAAGACCAGTCTGAGTGAGAGGGAGACCCTGCGTCTACTCAAAAATAGAAAAATTTACCAGCCATTGTGGCCAACACCTGTAGACCCAGCTATTCAGGAGTCTGAGGCCAGAGAATCACTTGAACCCAGGAGACTGAGATTGCTGTGAGCTAGGCTAAAACCATGGCACTCTAGCCCAGGTGGCAGAGTGAGACTGGGTCTGCAAAAAATAAATAAAAACAA","TGGCTCATGCCTGTAATCCTAGCACTTTGGGAGGCCAAGGCAGGTGGATTGCCTGAGCTCAGGAGTTCAAGACCAGCCTGGCAACACGATGAAACCCCGTCTCTATTAAAAAATACAAAAAATTGGCCAGGCATGGTGGTGTGCACCTGTAATCCCAGCCACTCAGGAGGCTGAGGCAGGAGAATCGCTTGAACCCGGGAGACAGAGGTTGCAGTGAGCCAAGATCGAACCATTGCACCCCAGCCTGGGTGAGAGTGAGACTCTGTCTAAAAAAAAAAGAAGAAAAAGAA"
"GL873550","6212004","6212068","chr19","50425309","50425373","23","44213305","AGAACCTAAGAGTTTTGAGGTTGCTATGAGCTGGACTGATACCATAGCATTCTAGTCTGGGTGAC","TGAACCCAGGAGGTGGAGGTGGCGTGATGCCCAAGATGTGCCACTGCACTCCAGCCTGGGTGATA"
"GL873550","6212319","6212418","chr17","89042086","89042197","34","82829767","CTGTCTTTTCTAAAAATAGAAAAACTAGCTGGGTTGTGGTGGGCACTTGTAGTCCTAGGTACTCTGAGGCTGAAACAGGATTGCTTGAACCTAAGAGTTT","GTCTCTACTAAAAATACAAAAATTAGCCGGGCATGCTGGTGGGCACCTGTGATCTCAAGCTACTTGGGAGGCTGAGGCAGGAGAATCACTTGAACCTGGGAGGCAGAGGTTG"
"GL873550","6504310","6504401","chr19","2969698","2969794","27","3534612","GTGCTGGTGTATGCACCTGTCATACCAGCTACTCCTGAGGTTGAGGCAGGATAGCTTGAACCCGGGAGTCTGAGACTGCAGTGAGCTGGGAT","TTAGGCGTGGTGCATGTCTGTAATCCCAGCTACCCGAGAGGCTGAGGCAGGAGAATCACTTGAACCTGGGAGGCGGAGGTTGCAGTGAGCCGAGATC"
"GL873550","7178331","7178523","chr19","40691105","40691269","60","33512774","GGCCAGACGCGGTGGCTCACGCCTGTTGTCCCGGCACTGTGGGAGGCCGAGGCTGGTGGATCCCCTGAGCTCAGCCAAGTTCAAGACCAGCGGAAGACCAGCATGAGGCAGAGTGAGCCAGAGTGAGACCCCGTCTCTACAACAACAACAACAAAAAATAGCCGGACCTTGTGATCCCAGCTACATGGGAGGC","GGCCGGGCATGGTGGCTCACGCCTGTAATCCCAGCACTTTGAGAGGTCGAGGCAGGTGGATCACCTGAGGTCAGGAGTTCGAGACCAGCCCGGCCAATATGGTGAAACCCCTTCTCTACTAAAAATACAAAAAATTAGCCGGAAGTGGTGGCATGCACCTGTGAT"
"GL873550","7981631","7981790","chr6","148611209","148611366","40","140629578","ATAGCCCCGCCTTGTGGTAGGCTCCTGTAGTCCCAGCTACTTGGGAGGCTGGGGCAAGAGAATCACTTAGGCCCAAGAGTTGGAAGTTGCTGTGAGCTGTGATGCTACAGCATTCTACTGAGAGTGACAAAATGAGACTCTGTTTAAAAAAAAAAAAAAA","TTAGCTGGGCATGGTGGCAGGTGCCTGTAATCCCAGCTACTCTGGAGGCTGAAGCAAGAGAATCGCTTGAACCCAGGAGGTGTAGGTTGCAGTGAGTCGTGCCACAGCACTCCATCCTGGGTGACAGAGCAAGACTCTGTCTCAAAAAAAAAAAAAAA"
"GL873550","7982053","7982180","chr2","182489403","182489528","28","174507350","GGCTGGGCGAGGTTGTTCAGACCTGTAATCCTAGCACTCTGGGAGACCAAGATGGGTGGATTGCCTGAGTTCATGAGTTTGAGACCAGCCTGAGCCAGAGTGAAACCTTGTTCTCTAAAAATAGCTCG","GGCCGGGTGTGGTGGCTCATGCCTGTAATCCTAGCGCTTTGGGAGGCCGAGGTGGGTGGATTGCCTGAGCTCAGGAGTTCGAGACCAGCCTGGGCAACACGGTGAAACCTGTCTCTACTAAAATAC"
"GL873550","8404122","8404320","chr4","121405930","121406135","43","113001808","GGCCAGGCACAGTGACTCACACCTGAAATCTTAGTACTCTGGGAGGCCAAGGTGGGAGGATTTCCTGAGGTCAGGAGTTCAAGACCAGCCAGAGCAAGAAGATCCTGTCTCTACTAAAAGTATAAAAAGTGAACCAAGTGTGGTAGTGAGCACCTATAATCTCAGCTACTTGGGAGGCCGAAGCAAGAGGATCACTTGA","GGCCAGGCACAGTGGCTCACACCTGTAATCTCAACACTTTGGGAGGCCAAGGTGGGTGGATCACCTGAGGTCAGGAGTTTGAGACAAGCCTAGCCAGCATGGTATAACTCCATCTCTACTAAAAGTATAAAAATCAACCAGGTGTGGTGGCACATGCCTGTGGTCCCAGCTACTTGGGAGGCTGAGGCAGGAGAATCACTTGAATC"
"GL873550","8404408","8404483","chr15","701469","701538","22","7702939","AGGATCTCTTGAGCTCGGGAGTTTGAGGTTGCAGTGAGCCAGGCTGATGTCATGGCACGCTACCCAAGACAACAAA","AATCACTTGAACCCAGGAGGCAGAGGTTGCAGTGAGCCAAGACTGTGCCATGGCACTCTAGCCTGGGCAA"
"GL873550","11648593","11648682","chr3","124881947","124882027","31","113233354","GTGGCTCACACTAGTAATCTTAGTACTTTGGGAAGCTGGGGCAAGAGGATCACTTGAGGTCAGGGTTAGGAAACTCTATCACTACAAAAA","GCGGTGGCTCACGCCTGTAATCCTAGCACTTTGGGAAGCCAGGCAGGCAAATCACGAGGTCAGGAGTTCGAAACCAGCCTG"
"GL873550","12468624","12468663","chr9","62916303","62916339","11","50447679","GCCCGGCTTGGTACCTCATGCCTGTAATCTTAGCACTCCG","GGCCGGGCATGGTGGCTCATGCCTGTAATCCCAGCAC"
"GL873550","12468943","12469188","chr12","70524409","70524645","91","58055466","AATCTTAGCACTCCGGGAGGCCGAGGCGGGTAGACCAACCTAATCAAGAGCAAGATCTACCTCTACTAAAAATAGAAAAGAATTGGCCAGGCGTATTGACTCCGCCTCTAGTGCCAGCTACTCCAAAGCTGAGGCAAGAGGATTGTTCAAATCCAAGAGTTTGAAATTGCTGTATGTTACACCAGGGCACTCTAGCCGTGGAGACATTTTCTCTATATATATTAAAAAAAACAAAAAACAGAAAAA","CTGAGCTCGGGAGTTCGAGACCAGCCTGACCAATATGGAGAAACCCTGTCTCTACTAAAAATGTAAAATTAGCCAGGCATGGTGGCACATGCCTGTAGTCCCAGCTACTCAGGAGGCTGAGGCAGGAGAATCGCTTGAGGTCAGGAGGCGGAGGTTGCAGTGAGCCAAGATCATGCCACTGCACTCCAGCCTGGGTGACAGAGTGAGACTTTGTCTCAAAAAAAAAAAAAAAAAAAA"
"GL873550","14719674","14719880","chr16","30390993","30391163","76","15671319","GGGCGTGGTTGCTCACGCCTGTTGTCCCAGCGCTGTGGGAGACCGAGGCAGATGTATCGCCTGAGCTCAGCCGAGTTCGAGTTCGAGACCAGCGGAGAGACCACCATGAGGCAGAGTGAGCCAGAGTGAGACCCCGTCTCTACAACAACAACAAAGAAAACAGCCGGATCTTGTGATCCCAGCTACATGGGGGCCAAGAGAATCACT","GGGCACGGTGGCTCACACCTGTAATCCCAGCACTTTGGGAAGCCAAGGCAGGAGGATCACCTGAGGTCAGGAGTTCAAGACCAGCCTGGCCAACATGGTGAAACCCCGTCTCTACTAAAAACACAAAAATTAGCCAGGTGTGGTGGTGCACGCTTGTAATCCCAGCTACTC"
"GL873550","15737883","15738154","chr2","20481557","20481833","73","4743674","TTAGCATTCTGGGAGGCCAAGTCAGGTGGATTGCCTGAACTCACAAATTTGAGACTAGCCTGAGATAGAGAAAGATCTTGTCTCTAAAAAAAAAAAAAAATAGCTGGACTTTGTAGTGGGCACCTGTAGTCCCTGCTACTCAGAAGGCTGTGGTAAGAGAATCACTGGAACCCAAGAGTTAGAGGTTGCCGTGAGCTGTGATGCCATGGCACTCTACCAGAGACAACAGAGTGAGACTCTCTCCAAAAAAAAGAAAAAGAAAAAGAAAAAAA","GCACTTTGGGAGGCCAAGGCAGGTGAATCACCTGAGATCAGGAGTTCAAGACCAGCCTGGGCAACATGATGAAACCCTGTCTCTATGAAAAATACAAGAATTAGCTGGGCATAGTGGTGTGCATCTGTAATCCCAGCTACTCAGGAGGCTGAGGTATGAGAATTGCTTGAACCCTGGAGGCAGAGGTTGCAGTGAGCCGAGATGACACCGTTGCACTTCAGCCTGGACAATAGAGAGAGACTCTGTCTCAAAAAAATGAAGAAAAGAAAGAAAGAAA"
"GL873550","15738844","15738873","chr10","65896918","65896951","9","50158074","GGGTGTGGTGGCTGATGCGTGTAATCCTAG","GGCTGGGCGTGGTGGCTCATGCCTGTAATCCCAA"
"GL873550","16345151","16345329","chr1","6754007","6754209","69","9591144","CACCTGTAATCCCAGCACTTGGGAGGTTGAGGAGAGTGGATTGCCTGAGCTCACAGGTTTGAGCCAGAAGGAGACCTCGTCTGTAAAAATAGCTGGGTGTTGAGACCAGCGCCTTTAGTCCCAGCTACTTGGGAGGCTGAGGCAAGAGAATCACTTAAACAATTCTAGAAGCAGAGTTT","CTGTAATCCCAGCACCTTGGGAGGCTGAAGAGGGCGGATCACCTGAGGTCAGGAATTTGAGACCAGCCTGGCCAACATGGTGAAATCCCATCTCTACTGAAAATACAAAATTAGCTGGGTGTGGTGGTGCATGCCTGTAGTTCCAGCTACTTGGGGAGCTGAGGCAGAAGAATGCCTTGAACCCGGGAGGCAGAGGTTGCAGT"
"GL873550","17727115","17727274","chr1","127857902","127858038","52","110130787","GCTGGGTGCAGTGACCCCTGCCTATAATCCCAGCAGTTAGGAGACAAAGGCAGGAGGAATTACCTGAGAGCAGGAGTTCCAGACAAGCCTCAGACCAGCGTGAGCTATGACATTGTCTGTAGCCCCCACCCCACCCCCCCAAAAAACAAAAAGAAACAAA","GGCTGAGTTCAGTGGCGCACGCCTGTAATCCCAGCAGTTGGGAGGCTGAGGCAGGTGGATTGCCTGAGGTCAGGAGTTCAAGACCAGTCTGGCCAACATGGTGAAACTCTGTCTCTACTAAAAAAAAAAAAAAAAAT"
"GL873551","6567068","6567102","chr14","109767086","109767123","14","103200018","GGATCACATGAGGTCAGGAGTTCAAGATCAGCCTG","GGAGGCAGAGGTTGCAGTGAGCCAAGACTGCGCCATTG"
"GL873551","9393264","9393376","chr1","39198637","39198744","32","29805373","CAAGAGTATCTCTGCAACCCAGTGGCCTGAGGTTGCTATGAGCTAGGATGCCACAGCACTCTACCCAAGGGGACAGAGTAAGACTCTGTCTCCAAAAAAAAAAAAGAGCAAAA","AGAATCGCTTGAACCTGGGAGGCGGAGGTTGCAGTGAGACCAGATCATGGCACTGCACTCCAGCCTGGGCGACAGAGTAAGACTCGGTCTCAAAAAAAAAAAAAAAAA"
"GL873551","9393708","9393894","chr12","115674238","115674427","40","106280530","GCTGGGCTCAGTGCCTCTCGCCTGTAATCCCAGCACGCTGGGAGCCTGAGGTGGGTGGGTTGCTTGAGCTTAGGAGTTCAAGACCAGCCTGAACCAGAGCAAGACACTATCTCTACTAAAAATAGAAAAACTATCTGGGCATGGTGGTGCGCACCTGTAGTCCCAGCTACTAGGGAAGCTGAGGCAA","CCAGGCCTGGTGGCTCACGCCTGTAATCCCAGCACTTTGGGAGGCCGAGGTGGGTAGATCACCTGAGGTCAGGAGTTCAAGACCAGCCTGGCCAACATGGCGAAACCCCATCTCTACTAAAAATACAAAAATTAGCTGGGCATGGTGGTGTATGCCTGTAATCCCAGCTACTCGGGAGGCTGAGGCAGGA"
"GL873551","10104594","10104683","chr16","53032852","53032939","31","42928258","GGTAGGTGGGTCTCTCGAGGTTAGGAGCTCTTTACCAGCCTGAGCTGACATAAGACCCAATCTCCACCAAAATAGAGAGAGAAAAAAAGA","GAGGCAGACAAATCTCTTGAGGTCAGGAGTTGAAGACCAGCCTGGGCAACATAGACCTCGTCTCTATTAAAAAAAGAAAAAAGAAAAA"
"GL873551","12307468","12307551","chr8","94102375","94102458","19","81794907","GGCCAGGCATAGCAGCTCATGCCTGTAGTCCTATTATTCTAGGAGGTCCAGGGAGGAGGATCACCTGAGATCAGAAGTTCAAGA","GGCCAGGCATGGTGCCTCATGCCTGTAATCCCAGTACTTTGGGAAGCCAAAGTGGATGGATCACCTGAGGTCAGGAGTTCGAGA"
"GL873551","13335872","13336095","chr4","85819795","85820026","56","72483923","GCCAGGTACAGTAGCTCAGGCCTGTAATCCTAGCACACTGGGAGGCTGAGGTGGTGGATCCTTGAACTCATGAATTCAAGACCAGCCTGAGGAAGAGCAAGACCCCATCTCTCCTAAAAATAGAAAAATTAGCTGGTGTCATGGCAAGTGTCTGTAATCCCAGCCACACAGGAGGCTGAGGCAAGAGGATCTCTTGAACCCAAGACACTAAAGTTACTGGGAGC","GCCGGGCATAGTGGCTCATGCCTGTAATCCCAGCACTTTGGGAGGCTGAGATGGGTGGATCATCTGAAGTTAGGGGTTCGAGACCAGCCTGGCCAAATGGCAAAAACCCATCTCTGCTAAAAATACAAAAATTAGCCAGACATTGTGGCATGTGCCTGTAATCCCAGCTACTCAGGAAGCTGAGACAGGAGAATCGCTTGAACCCAGGAGGCAAAGGTTGCAGTGAGCCAAG"
"GL873552","1195303","1195426","chr3","54039332","54039457","34","52844029","CTACTCTGGATGCCAAGGCAGCGGGATCACTTGAACCCCAGAGTCTGAGGTTGCTGTGATCTCAGCTGACTCCATGGCACACTAGCCTGAGGCAACAGACTGAGACTATATCTCAAAACAAAAA","AGCTACTCAGGAGGCTGAGACAGGGAGAGTCACTTGAACCCAGGAGGCAGAGTTGCAGTGAGCCGAGATCACGCCAACTGCACTCCATGCCTGGGCAACAGAGTGAGACTCCGTCTCAAAAAAAAA"
"GL873552","15010293","15010428","chr1","29437872","29437991","29","14427579","GGCCGGGCGTGGTGGCTCACGCCTGTATTCCCAGCGCTATGGGAGGCCGAGGCGGGTGGATCACCTGTGCTCAGAGGTTCGAGACCAGCCAAGACCCCCCTGAGCCAAACGAGCCAGAGTGAGACCCCGTCTCTAC","GGCCGGGCGTGGTGGCTCACGCCTGTAATCCCAACATTTTGGGAGGCCAAGGCGGGTGGATCACCTGAGGTCAGAAGTTCGAGACCAACCTGGCCAACATGGTGAAACCCCTGTCTCTAC"
"GL873553","860627","860695","chr1","16024119","16024187","13","15163492","GCCAGGCTCAGTGGCTCACGCCTATAATCTTAGCGCCTTTTGGAGGCCAAGGTGGGGGGATTACCTGAG","GGCCAGGCACGGTGGCTCACGCTTGTAATCCCAGCACTTTGGGAGGCCGAGGAGGGTGGATTACCTGAG"
"GL873553","7206820","7206939","chr3","156098583","156098705","38","148891763","AGCTAGGTATGGCAGCTGACATCTGTAACCCTAGCCCTCTGGCAGGCCAGGAATTCAAGACCAGCCTAGACAACATAGTAAGACCCCATCTCTACCAAAAATAATTTAAAATTGGCCAGG","GGCTGGCTGTGGTGGCTCACACCTGTAATCCCAGTACTTTGGATCATGTGAGGTCAGGAGTTCAAGACCAGACTGACCAACATGGTGAAACCCTGCCTCTACTAAAAATACAAAATTAGCCAG"
"GL873553","10985147","10985407","chr12","94325498","94325767","64","83340351","GGCCTGTGGCAGTGGCTCATGCCTGAAATCCTAGCACTCTGGGAGGCTGAGGTGGGTCGATTACCTGAACTCACCAAGACGGAGACCTCATCTCTACTAAAAATAGAAAAACTAGCTGGGCGTGGTGGCAGGTGCCTGTAGTCCCAGTTACTGGGGAGGCTGAGGCAAGAGAATTACTTGAACCCAAGAATTTGAGGTTGCTGTGAGCTATGATGCCACAACACTCTACTCAGGGTGACGGAATAAGACCCTGTCTCAAAA","GGCCGGGTGTGGTGGCTTATGCCTGTAGTCCCAGCACTTTGGGAGGCCGATGGGGATGGATCACCTGAGGTCACTGGCCAACACAGAGAAACCCCATCTCTACTAAAAATACAAAAATTAGCCAGGCGTGGTGGCATGTGCCTATAATCCCAGCTACTTGGGAGGCTGAGGCAGGAGAATCACTTGAACCCGGTAGGCAGAGGTTGCAGTGAGCCGAGATTGTGCCACTGCACTCCAGCCTGAGTGACAGAGCAAGCCTCTGTCTCAAAA"
"GL873553","10985438","10985466","chr16","73760336","73760365","6","62774898","CATAAAAAGAAAGAAAACTGAAAAGAAAA","GAAAGAAAGAAAGGAAAAGAGAAAAGAAAA"
"GL873553","12443178","12443505","chr1","3864926","3865253","98","8578252","GCAGGGTGGGGAGGCTCGCACCTACATCCCCAGCACCCTGGAAGGCTTAGGCAGGTGGACTGGGTTCAGGAGTTGGAGAGCAGCCTGAGCAATAGTGAGATTCTGTCTGCAGTAAAACTAGAAAAATTATTTAGGGGTTGTGCTGGGTGCCTATTATCCTAGCTACTGTTGAGGCAAGGGGACAGCTTGAACCCAGGATTTTCAGGTTTCTGTGAGCTAGGATGATGCCATGATGACCCTCTGACACTTTGCCTGGGCAGTAGAGTGAAACTCTGTCTCAGAAAAAACAAAACAAAACAAAACAAAACAAACAAACAAACGAAAAAAA","GGCCAGGCGTGGTGGCTCACACCTGTAATCCCAGCACTTTGGGAGGCTGAGGCAGGTGGATCACCTGAGGTCAAGAGTTCAAGACCAGCCTGGCCAACATGGTGAAACTCTGTCTCTACTAAAAATACAAAAATTAGCCGGGCATGGTGGTGCATGCCTGTAATCCCAGCTATTCGGGAGGCTGAGGTAGGAGAATAGCTTGAACCCGGGAGGTGGAGGCTGCAGTGAGCTGAGATCATGCCATTGCACTGTAGCCTGAGCAACAGAGAAAGACTCTGTCTCAAAAAACAAAACAAAACAAACAAAAGAACAAAAACAAACAAACAAA"
"GL873553","15121135","15121247","chr1","111354387","111354508","21","96233252","GGGCGTGGTGGCTCACACCTGTAATCCCATCACTTGGGAGGCTGAGGCAGGTGGATCACCTGACCTCAGGAGTTCGAGACCAGCCTGAAGAAGAGTGAGACCCCGTCTCTAAA","GGCCGGGCGTAGTGGCTCACACCTGTAATCCCAGCACTTTGGGAGGCCGAGGCGGATGGATCACCTGAGTTCAGGAGTTTGAGACCAGCCTGACCAAAGTGGTGAAACCCCGTCTCTACTAA"
"GL873553","15121274","15121455","chr7","68420775","68420939","69","53299501","AGATTTCAACAGGCCTAATGGCTTTAGTATATAAAGAGAACTTATAAAGCCAGACTCAGTGGCTTACATCTATAATCCAGGTACTTGGTAGGTTGAAGTGAGAAGATTCTTTGAGCCAGGATTTCCAGCCCAGCCTAGGCAACACAGAGAGACCCCCATCTCTAAAAGAGAAAGGTAAAAAA","GGCTAAAGGGGTGCTCATCTTAAGAATACCAGGCCAGGCGCAGTGGCTCATGCCTGTAATCCTAGCATTTTGGGAGGCTGAGGCGGGTGGATCACCTGAAGTCAGGTGTTTGAGACCAGCCTGAACAACATAGTGAGACCTCATCTCTAATTAAAAAAAGAAAAA"
"GL873553","15614197","15614298","chr4","71691062","71691163","34","56076865","GGTGGCTCACACCTGTTATCCCCATACTCTGGGGGCCTGAGGTGAGAGGATCCCCAGAAGTCAGGAGCTGGAGAGAAGCCTGTGTAAGAGTAAGAGCCAGTC","GTGGCTCATGTCTGTAATCCCAGCACTTTGGGAGGCCGAGGTCGGTGTATCATTTGAAGTCAGGAGTTTGAGACCAGCCTGGCCAACGTGGTGAAACCCTGT"
"GL873553","16849767","16850040","chr1","96770987","96771267","68","79921220","GGCCAGGAGTGGTGGCTCATGCCTGCAATCCCAGCACTTGGGAGGCCAAGGTGGGTGGATTGCCTGAGCTCACAGGTTCAAGACCAGCATGAGCCAGAGAGAGACCTTGTCTCTAAAAATAGGCACAGGTTGTGGTGGGCACCCGTAGTCCCAGCTACTTGGGAGGCTGAGGCAAGAGAATCACTTAAGCCCAGGAGTTTGAGGTTGCTGTGAGCTAAGACACCACAGCACTCTACCAAGGGTGACAAAGTAAAACTCAGATTTTTTTAAAAAA","GGCCAGGTGTGGTGGCTCACAGCCTGTAATCCCAGTAGTTTGGGAGGCCGAGGTGAGCAGATCACCTGAGGTCAGCAGTTCGAGACCAGCCTGGCCAACATGGCAAAACCCTATCTCTACTAAAAGTACAAGGTGTGGTGGCACACACCTGTAGTCCCAGCTACTTGGGAGGCTGAGGCAGGAGAATCACTTGAACTCCAGAGGTGGAGGTTGCAGTGAGCCAAGATTATGCCACCGCATTCCAGCCTGGGTGACAGAGTGAGACTCCGTCTCCAAAAAAA"
"GL873554","511555","511741","chr6","166828248","166828429","56","166316693","GTGGGACCCGCATCTATACTAAAAATGAAAAACTAGTCAGACTTGGTGACTCATGCCTATAATTTCAGTTTCTTGGGAGGTGAAGGCAGAAGAATTGCTTGATCCCAGGAATCTGAGATTGCTGTGAGCTAGGCTAACACTATGGCACTCCAGCCCAGCTGACAGAGTAAGACTTTGTCTTTAAAAA","ACCCCATCTCTACTGAAAATAGAAACATTAGCCGGGCTTGGTGGCATGCGCCTGTAGTCCCAGCTATTTGGGAGGCTGAGGCAGGAGAATTGCTGGAACCCAGGAGGCAGAGATTGCAGTGAGCGGAGATCATGCCATTGCACTCCAGCCTGGGCGACAGAATGAGGCTCCATCTCAAAAAA"
"GL873554","2046660","2046725","chr8","51862362","51862427","7","49815702","GGCTGGCCGCGGTGGCTCACGCCTGTAATCCTAGCACTCTGGGAGGCCGAGGCAGGCAGATCACCT","GGCCGGGCACGGTGGCTCACACCTGTAATCCCAGCACTATGGGAGGCCGAGGCAGGTAGATCACCT"
"GL873554","2580766","2581036","chr13","93262937","93263229","81","90682171","GGCCTGGGCAAGGTGGCTCACTCTCTGGAAGGCTGAGGCAGATGGATTGCCTGAGCTCAGGAGCTAGAGACTAGCATGATCTCACCTCTACTAAAAATAGAGAAACTAGCCAGGCATTACAGCACACGCTTGCAGCCCCAGCTACTCTGGGGGCTGAGGCAAAAGGATCACTTGGACTCAAGAAACTGAGGTTCCTGTGAGCCATGATGCCAGGACACTCTACCCAGGGAAACAGAGTGAGACTTCATCTCAAAAAAAAAAAGAAAGAAAA","GGCTGGGTGCAGTGGCTCACGCCTGCACTTTGGGAGGCCAAGGCAGGTGGATCACCTGAGGTCAAGAGTTTGAGACCAGCCTGGTCAACATGGTGAAACCCCATCTCTACTAAAAATACAAAAATTAGCCAGGCATGGTGGCACGTGCCTGTAATCTCAGCTACTCTGGAGGGTGAAGCAAAAGAATCACTTGAACCCAGGAGGCAGAGGTTGCAGTGAGCCAAAATCATGCCACTGCACTCTGGCCTGGGCAACAGAGTGAGACTCCATGTCAAAAAAAAAAAAAAAAAAAA"
"GL873554","5465741","5465829","chr11","47014803","47014890","15","41549062","GGCCAGGCATGGTGGCTCACGCCTGTAGTCCCAGCGCTGTGAGAGGCCGAGGCGGGTGGATCACCTGTGCTTAGAGGTTCGAGACCAGC","GGCCGGGCACCGTGGCTCACGCCTGTAATCCCAGCACTTTGGGAGGCCAAGGCGGGTGGATTACCTGAGGTTAGGAGTTCGAGACTAG"
"GL873555","8807785","8807956","chr1","12240468","12240612","48","3432683","GGCCGGGCGTGGTGGCGCACGCCTGTAGTCCCAGCGCTATGGGAGGCCGAGGCGGGTGGATCACCTGAGCTCAGAGGTTCGAGACCAGCCAAGACCCCCCTGAGCCAAACGAGCCAGAGTGAGACCCCGTCTCTACAACAACAACAGGACAACAAAACAGCCGGACCTTGTG","GGCCGGGCGCGGTGGCTCATGCCTGTAATCCCAGCACTTTGGGAGGCTGAGGCGGGTGGATCACCTGCGGTCAGGAGTTCGAGACCAGCCTGGCCAACGTGGTGAAACCTCATCTCTACTAAAAATATAAAAATTAGCTGGTGTG"
"GL873555","8828420","8828440","chr3","5439989","5440005","4","3388431","ATAATAATAATAATAAATTAG","ATAATAATAAAATAAAA"
"GL873555","12399534","12399604","chr15","102111398","102111458","22","89711864","GGCCAGGCATGGTGGCTCACACCTATAATCCTGGGAGGCTGAGGATTATCTGAGCTCAGGGATGTGAGACC","GGCCAGGCACGGTGGCTAAGGCCTGTAATCTGGGAGGCTGAGATGGGTGGATCACCTGAGG"
"GL873555","12440877","12440963","chr19","21209507","21209590","24","8768630","GTGGGGAGTGCACCTGAACTTTGGAGTTCAAGACCAGCCTGGGCAACATTGTGTGAGCCCTGTCTCAATTGGAAAACAAAACAAAAA","AGGTGGGCAGATCACCTAAGGTCAGGAGTTCAAGACCAGACTGGCAAAAATGGTGAAACCCTGTCTCTACTAAAAATAAAAAAA"
"GL873555","13094462","13094529","chr1","100916857","100916922","22","87822395","GCTTGTACCTATAATCCTGGTACTTTGGGAGCCTCAGGAGAGTGGATCACCTGAGTAAGAGCAAGACC","CATGCCTGTAATCCCAGCACCTTGGGAGGCCAAGGTGGGTGGATCACCTGAGGTCAGTAGTTTGAG"
"GL873555","13254579","13254784","chr7","32729330","32729532","64","19474751","GACCAATCTAAGCCAGAGCTGTCTATGCTAAAAATAGAATAATAAGCCTGGTTTATGGTAGGAGCCTGTAGTCTCAGTTACCTGGGTGTCTGGGGCAAGAGATTGACTTAAAACCAGGAGTTTGAGGTTGCTGTAAGCTAGGCTGACACCACAATACTCTAATCTGGGCAGAGTGAGATTCTGTCTCAAAAAAAAAAAGAAAGAAA","GAAACCCCATCTCTACTAAAAATACAAAATTAGCCAGGCATGGTGGTGCACACCTGTAGCTCCAACTACTTGGGAGGCTGAGGCAGGAGAATCACTTAAACCCAGGCAGTAGAGGTTGCAGTAAGCCAAGATCGCACCACTGCACTCCAGTCTGGGCAACAGAGTGAGACTCTGTCTCAAAAAAAAAAAAAAAAAAAAAAAAA"
"GL873555","13255065","13255153","chr10","29045352","29045442","23","15790287","CTGGGCACAGTGGCTGAGGGTGTAATCCTACCACCCTAGGAGGTTGAGGCAGAAGGATCACTTGAGCTCAGGAATTCAATACAAGTCTA","GGCGGGGCACAGTGGCTCATGCCTGTAATCCTAGTACTTTGGGAGGTCGAGGCGGATGGATCATCTGAGGTCAGGAGTTTAAGACCAGTCT"
"GL873555","13262783","13262918","chr1","29437872","29437991","30","16175089","GGCCGGGCGTGGTGGCGCACGCCTGTAGTCCCAGCACTATGGGAGGCTGAGGCGGGTGGATCACCTGTGCTCAGAGGTTCGAGACCAGCCAAGACCCCCCTGAGCCAAACGAGCCAGAGTGAGACCCCGTCTCTAC","GGCCGGGCGTGGTGGCTCACGCCTGTAATCCCAACATTTTGGGAGGCCAAGGCGGGTGGATCACCTGAGGTCAGAAGTTCGAGACCAACCTGGCCAACATGGTGAAACCCCTGTCTCTAC"
"GL873556","639117","639366","chr1","62410822","62411038","72","61771705","GGCCGGGTGTGGTGGCTCATGCCTGTTGTCCCAGCACTGTGGGAGGCCAAGGCAGGTGGATCGCCTGAGCTCAGCCAAGTTCGAGACCAGCGGAAGACCAGCATGAGGCACAGTGAGCCAGAGTGAGACCCTACCTCTACAAAACAACAACAACAACAAAAAACCCAGCCAGATGTTGTGGCAAGTGTCTGTAATCCCAGCTACATGAGGGGCAAGAGGGCAAGAGAATCACTAAAGGAGGAAGAAGTAA","GGCCGGGCGTGGTGGCTCACACCTGTAATCCCAGCACTTTGGGAGGCCAAGGTGGGTGGATCTCCTGAGGTCAGGAGTTCGAGAGCAGCCTGGCCAACATGGTGAAACCCTGTCTCTACTAAAATACAAAAATTAGCCAGGTGTGGTGGCACGTGCCTGTAATCCCACCTACTCAGGAAGCTGAGGCAGGAGAATCACTTAAAGCTGGGAGAGAGAG"
"GL873556","639390","639468","chr20","16893610","16893664","30","16254220","ACTTCAAACTAAGATAAAGTGAAAGTCAGCAGAAATTGAAAGCAAAAACAAAAACAAAAAAAAAAAAAAAAAAAAAAGA","AACAAAACAAAACAAAACAAAACAAAACAGACAAAAAAAAAAAAACAAAGAAAAA"
"GL873556","2031445","2031493","chr13","87950184","87950229","13","85918739","AGACCCTATCTCTACTAAAAATAGAAAAACTAGCCCAGTATAGTGATGC","AAACCCCATCTCTAGTAAAAATACAAAATTAGCTGGGTGTGGTGGC"
"GL873556","6655305","6655664","chr2","190010230","190010561","107","183354925","GGCCAGGCATGGTGGCTCACACCTGTAATCCTAGCACTCTGGAAGGCCAAGGGAGGTGAATTTCTTGAAGTTCGAGATCAGCCTAAGAGGAATGATACCCCACCTTTACTAGGAATAAAAAAAAAAAAAAAAAAAAACCCAAAACTAGCCTGGCATTGTGGCAGTTCTCTGTAATCCAAGCTACTTGGGAGGCTGAGGTAGAAGGATTGCTTGAACCAAAGAGTTTGACTAGAGGTTGCTGTGAGCTAGGCTAATGTCACCACACTCTATCCAGGGCAAGTGAGTGAAACTCCGTCTCAAAATAAATAAATAAATAAATAAATAAGTAAGAAAAACTTTTGCCCATAAAAAAAAAAAGAA","GGCCGGGCGCGGTGGCTCACACCTGTAATTCTAGCACTTTGGAAGGCTGAGGTGGGTGAATTGTCTGAGCTCAGAAGTTCGAGACCAGCCTGGGCAACACAGTGAAACCCCATCTCTACTAAAATACAAAAAAAAAAAAAAATTAGCTGGGCATGGTGGTGTGCACCTGTAGTCCCAGCTACTCAGGAGGCTGAGGCAGGAGAATTGCTTGAACCCAGGAGGCAGAGGTTGCAGTGAGCTGAGATCACGCCACTACACTCCAGCCTGGGCAACAGAGTGAGACTCCACCTCTTTAAAAAAAAAAAAAAGAAAGAAAGAAAGAAAGAAAGAAA"
"GL873556","10802692","10802792","chr20","28544296","28544376","36","17741604","TACAAAGAAATATCATTATTGGCCAGGTGCAGTGGTTCACATCTGTAATTCTAGTACACTAGTACTCAGGAGGATCACTTGAGGTCAGGAGCTTGTGACCA","TAGAAATGCACAATTCACCTGGGCACGGTGGCTCACTCCTGTAATTCCAGTACTTTGGGAGGCATGAGGTCAGGAGTTCAA"
"GL873557","1682363","1682659","chr6","13352322","13352625","72","11669959","GGCCAGGTGTCGTGGCTCAGGCCTGTAATCCCAGCATTCTGGGAGGCTGAGGTGGGTGGATTGCCCTGAGGTCACAGGTTCCAGACCAGCCTGAGCAAGAGCGAGACTCCATTTCTAATAAAATAGCCGGGTGTTGTGGTAGGTGCCTGTAGTCCCAGTTACTCGGGAGGCTGAGACAAGAGAATCATTTGAACCCAGGAATTTGAGGTTGCTGTGAGCTGTGATGCCACAGGACTCTACTGAGGGCAATAAAGTGAGACTGTCTCAAATAAACAAACAAACAAACAAAAACAAAAA","GGCCAGGTGTGGTGGCTCAGGCCTGTAATCCCAGCACTTTGGGAGACTGAGGTGGGCGGATCACCTGAAGTAAGGAGTTCAAGACCAGCCTGGCCTACATAGTGAAACCCCATCTCTACTAAAAATACAAAATTAGCTGGGTGTGGTGGCACGTGCCTGTAGTCCCAGCTATTCGGGAGGCTGAGTCAGGAGAATCACTTGAACCCAGGATGGGGAGGTTGCAGTGAGCCGAGATCACACCACTGCACTCCAGCCTTGGCAACAGATTGAGACTCTTTCTCAAAAAAAAAAAAAAAAAAAAAAA"
"GL873557","2465751","2465841","chr16","4764895","4764982","15","2299144","GGCCGGGCTTGGTGGTTCACGTCTGTTGTCCCAGCACTGTGGGAGGCCGAGGCAGGTGGATCACCTAAGCTCAGCCAAGTTCGAGACTAGC","GGTCGGGTGTGGTGGGTCACGACTGTAATCCCAGCACTTTGGGAGGCCGAGGCAGATGGATCACCTGAGGTCAGAAGTTCGAGACCAG"
"GL873557","4047834","4047915","chr12","77852792","77852880","22","73804958","ACAAGAGGTTGCTTTGAACTGTGATGCCACAGAGCACTATCCTGGGCAACAGAGACTCTGTCTCAAAAAAAAAAAAAAAAAA","CAGAGGTTGCAGTGAGCTGAGACTGTGCCACTGCACTCCAGCCTGCGCGACAAGAGTGAGACTCTGTCTCAAAAAAAAAAAAAAAAAAA"
"GL873557","4048202","4048390","chrX","23681445","23681631","42","19633243","GGCTGGGTGTGGTGGCTCACACCTGTGATTCTAGCACTCTGGGAGGCCAACGTGGGCAGATCACCTGAGCTTAGGAGTTCAAGACCAGTGTGAGCAAAATGAGACCCCGCCTCTACTAAAAATAGAAAAACTAGCCAGGCACTGTGGTGGGTGCCTATCATCCCAGCTACTCAGGAGGCAGGCAAGAGG","GGCCAGGCGTGGTGGCTCACGCCTGTAATCCCAGCACTTTGGGAGGCCGAGGTGGGTGGATCACCTGAGGTCAGGAGTTCAAGACCAGCCTGGCCAACATGGTGAAACCCCGTCTCTACTAAAAATATAAAAATTAGCCAGGGTGTGGTAGTGCCTGCCTGTAATCCCAGCTACTCGGGAGGCTGAG"
"GL873557","6292327","6292620","chr19","32265157","32265444","82","25972830","GTCAGGCACGGTGGCTCATGCTTGTTGGATTATCCCAACACTCTGGGAGGCCAAGGTGGATCGATTGTCTGAGCTCTGGAGTTCAAGACCAGCCTGAGCAGAAGCAAGACTCCATCTCTAAAAAAAAATAGCTGGGCATTGTGGTGGGCACTTGTATTCCTAGCTACTTGGAAAGCCTGAGGCAAGAGGATTGCTTGAACCCAAGAGTTTGAGGTTGCTGTGAGCTTAAGATGTCACAGCACTCTATAGAGGCTGAGCAAGTGAGACTCCAAAAAGTGAGTTTCCAGAAAAAAA","GACTAGGCACTGTGGCTCATGCCTGTAATCCCAGCACTTTGGGAGGCCGAGGCGGGTAGATCACCTGAGCTCAGGAGTTTCAGACCAGCCTGAGCAACATGGCAAAACCCCATCTCTACTAAACATTAGCCAGGCATGGTGGTGTGCACCTGTAATCCCAGCTACTTGGAAGGTTGAGGCAGGAGGATCACTTGAACCTCAGGAGGCAGAGGTTGCAGTGAGCCAAGATGACATGACTGCACTCCAATCTGGGTGGCAGAGCAAGACTCTGTCTCAAAAAAAAAAAAA"
"GL873557","6324546","6324617","chr1","39656281","39656348","22","33331735","CGCCTGTTGTCCCAGCACTGTGGGAGTGTGAGTAGGGTGGATCACCTTAGCTCAGCTGAGTTTGAGACCAGC","CATGCCTGTAATCCCAGCACTTTGGGAGGTCAAGGCTGGCAAATCACCTAAGGTCAAGAGTTTGAGAC"
"GL873557","6406262","6406343","chr1","199505332","199505412","11","193099070","CAGGCGCAGTGGCTCAATCCTATAATCCCAGCACTTTGGGAGGCTGAGGCAGGTGGATTACCTGAGCTCAGGAGTTTGAGAC","CCAGGCGCAGTGGCTCACACCTGTAATCCCAGCACTTTGGGAGGCTGAGGCAGGCAGATCACCTGAGGTCAGGAGTTGGAG"
"GL873557","6417612","6417692","chr13","102319052","102319128","16","95901440","GAGGTTGCTGTGAGCTAGACTGAGGCCACAGCACTCTAGCCTGGGCAACAGAGTGAGACTGTCTCAAAAGAAAAAAAGAAA","GAGGTTGCAGTGAGCTGAGATCACACCACTGCACTCCAGCCTAGGCAACAAAGTGAGACTCCAACTGAAAAAAAAAA"
"GL873557","6903406","6903510","chr16","18967946","18968045","32","12064540","AGTGCTCTGGGAGACTGAGATGGGCAAATATCTTGAGTTTAGGAGTTCCAGACCAGCCTAAGGAAGAACAAGACCCTATCTCTACTAAAAATAGAAAAAAATTCA","CTTTGGGAGTCTGAGGCAGGTGGATCTCCTGAGGTCAGGAGTTCAGGACCAGCCTGGCCAACATGGCAAAACCCCATCTCTACTAAAAATATAAAAATTA"
"GL873557","6903779","6903930","chr3","40638454","40638604","35","33734675","TTTGCCAGGTATTGTGGTGGACACCTGTAGTCCCAGCTGCTTGGTAGGCTGAGGCAGGAGGATCACTTGACCCTAGGAATCTGATGTTGCTGTGAGCTAGGCTGATGCTACAGCACTCTAGCCTGGACAACAGAGTAAGCTTCTGTCTCAAA","TAGCTGGGTGTCATGGCACACGCCTGTAGTCCCAGCTACTTGGGAGGCTGAGGCAGGAGAATCTCTTGAACCTGGGAGGCAGAGGTTGCAGTGAGCTGAGATCACGCCACTGCACTCCAGCCTGGGCAACAGAGTGAGACTCCGTCTCAAA"
"GL873557","8133022","8133316","chr19","42881134","42881434","76","34748112","GAGTGCAGTGGCTCACACCTGTAATCTTAGCACTCGAGAGGCTGAGGCAGGTGGATTGCCTGAACTCACAGCTTCGAGACCAGCCTGAGCCAGAGCAAGACCTCATCTCTAAAAATAGCCAGGAGTTGTGGCAGGCGCCTGTAGTCCCAGCTACTTGGGAGGCTGAGCAAGAGAATCGCTTGATCTCAGGAGTTTGAGGTTTCTGTGAGCTAAGACACCGCAGCACTCTACCAAGGGTGACAAAGTAAGACTCTGTCTCAAAAAATAAATAAATAAATAAATTATAAGAAAAAGA","CCGGGCAAGGTGGTTCACACCTATAATCCTAGCACTTTGGGAGGTCGAAGTGGATCGCCTGAGGTCAGGAGTTAGAGACCAGCCTGGGCAACATAGCAAAACCCCATCTCTACTAAAAATAGAAAAACTAGCCAGGTGTGGTGGCGCCTGTAATCCCAGCTACTCGGGAGGCTGAGGCAGAAGAATCGCTTGAACCCAGGAGGCAGAGGTTGCAGTGAGCTGAGATCGCACCACTGCACTCCAGGGTGACAGAGCAAGACTCTGTCTCAAAAAAAAAAAAAAAAAAAAAAAAAAAAAAAAA"
"GL873557","8171663","8171835","chr7","151280672","151280824","61","143109009","TTAGCCAGGCACTGTGCTCCCAGCTACTAGGGAGGCTGAGGCAAGAAGAGGATCACTTGGCTCGGCGCCTGTGACTCAAGTGGCTAAGGTGCCAGCCACATACACCTAAGGTGGAGGGTTCTCTACCCAGAGGGACAGCTTGAGGCTCCATCTCAAACAAAAAAAAAAGAAGA","TGGTATGCACCTGTAATCCCAGCTACTTAGGAGGCTGAGGCATGAGAATCACTTGAACCCAGGAGGTGGAACTTTTAGTGAGCTGAGATTGCACCACTGCATTCCAGCCTGGGCAACAGAATAAGACTCTATCTCAAAAAAAAAAAAAAAAAA"
"GL873557","8172121","8172252","chr11","123260550","123260686","30","115088429","CTGGGCATGGTGGCTCATACCTATAATCCTAGGACTTTGGTAGGCCGAGGCAGGTGGGTTGCTTGAGCTTAGAAGTTGAAGACCAGCCTGAACAACAGCAAGACCTTTCCCTACTCAAAACAGAAAAACTAT","GGCTGGGCAGGGTGGCTCATGCCTATAATCCCAGCACTTTGGGAGGCCAAGGCGGGTGGGTCACCTGAGGTCAGGAGTTCGAGACCAGCCTGACCAACATGGTAAGATCCCCTCTCTACTAAAAATACAAAAATTAA"
"GL873557","8260873","8260977","chr1","62231025","62231129","22","53970152","GGCTGGGCATGGTGGCTCACGCCTGTTGTCCCAGCCCTGTGGGAGGGTGAGGCAGGTGGATCGCCTGAGCTCAGCCGAGTTCGAGACCACTGGAAGACCAGCATG","GGCTGGGCATGGTGGCTCACGCCTATAATCCCAGCACTTTGGGAGGCCGAGGCAGGTGGATCACCTGAGATCAGGAGTTTGAGACCAGACTGGCCAACATGGTGA"
"GL873557","10032878","10033040","chr9","27037847","27038008","36","17004969","GGGGGTGGTGGCTCACACTTGTAATACCAGCTACTCTGGAGGCCGAGGCAGGAGAATCATATGAGCCCGGAAGTCTGAGGTTGTTGTGAGCTGGGTTAATGCCCCTGCACTCTAGCCTGGGCAACAGAGTGAGACCATGTCTCAAGGAAATAAAAAAAAAAAA","TTAGCTGGGCATGCTGGCACACACCTGTAATGCCAGCTACTCAGGAGGCTGAGGCAGGAGAATCACTTGAGCCCGGGAGGTGGAGGTTGCAGTGAGCTGAGACAGTGCCACTGTATTCTACCCTGGGCAACAGAGTGAGACTGTCTCAAAAAAAAAAAAAAA"
"GL873557","10366578","10366655","chr17","24597444","24597521","20","14230866","GCCAGGCGTGGTGGCTCATGACGGTAATCCCACCTACTCAGGAAGCAGAGGCAGGAGAATCACTTGCGCCTAGGAGAC","GGCCAGGCATGGTGGCTCATGCCTGTAATTCCAGCACTTTGGGAGGCCGAGGCAGGTGGATCACTACGTCAGGAGTTC"
"GL873557","12031816","12031985","chr11","55022806","55022982","46","42990990","TAGAAAAACTAGCCAGGCATTGTAGCGGGTGCCTATAGTTTCAGCTACTCTGGAGACTGAGACAAGATTGCTTGAGCCCGGGAATTTGAGGTTGCTGTGAGCTATTATGCCACAGCACTCAATACAGGACAATTGAGTGAAACTCCAGTCTCAAAAAAAAAAAAAAAAAA","CAAAAATTAGCCAGGCAGGGTGGTGGGCGCCTGTAGTCTCAGCTACTGGGAAGGCTGAGACAGGATAATCACTTGAACCCGGGAGGCGGATGTTGCAGTGAGCCGAGATCATGCCACTGCACTTCAGCCCGGGCAACGAGAGTGAAACTCCGTCTCAAAAAACAAAATAAAATAAAA"
"GL873557","12032023","12032144","chr1","111354387","111354508","23","99322364","GGTCAGGTGCAGTGGCTCACATCTGGAATCCTAGCACTCTGGGAGGCCGAGGAGAATGGATCCCCTGAGCTCAGGAATTCAATATCAGCCTGAACAAGTGTGAAACCTCCATCTCTACTTAA","GGCCGGGCGTAGTGGCTCACACCTGTAATCCCAGCACTTTGGGAGGCCGAGGCGGATGGATCACCTGAGTTCAGGAGTTTGAGACCAGCCTGACCAAAGTGGTGAAACCCCGTCTCTACTAA"
"GL873557","14208944","14209036","chr7","158031905","158031997","26","143822961","GGATGTGGTAGTTACTGTTTGCTATGATGACAACACTGCACTCTAACTCTGGGTGACACAGTAAGATTCTATCTCAAAACCAAAATAAAACAA","CCAGGAGGTGGAGGTTGCAATGAGCCAAGATCACACCACTGCACTCCAGCCTGGGTGACAGGGTGAGATTCTGTCTCAAAAAAAAAAAAAAAA"
"GL873558","2159034","2159070","chrX","41233833","41233871","7","39074799","ATTAGCCAGGTGTGGTGGCTTTTGCCTGTAATCCCAG","AAATCAGCCGGGTGTGGTGGCTCACGCCTGTAATCCCAG"
"GL873558","3486850","3487074","chr5","91338665","91338874","72","87851815","GGCCAGGCATGGTGGCTCATGCCTGTTGTCCCAGTGCTGTGGGAGGCCGAGGCAGGTGGATCGCCTGAGTTCAGCCAAGTTTGAGACCAGTGGAAGACCAGCATGAGGCAGAGTGAGCCAGAGTAAGACCCCATCTCTACAACAACAAAAAAAAAAAACAAAAAAAACAGCCGGACGTTGTGATCCCAGCTACATGGTGAGGGGGAGGGGAACAGGAGAATCACT","GGCCGGGCATGATGGCTCATGCCTGTAATCCCAGCACTTTGTGAGGCCGAGGCAGACTGATCACTTGAGGCCAGGAGTTCGAGACCAGCATAGCCAACAAGATGAAACACCATCTTTACTGAAAATACAAAAAAAAAAAAAAATAGCCGGATGTGGTGATACCTGCTTGTAATCCCAGCTGCTTGGGAGGCTGAGGCAGGAGAATCTCTT"
"GL873558","3884156","3884240","chr4","24638016","24638099","18","20753860","CCAGACACAGTGGCTTAAGCCTGTAATCCTAGCACTTTGGGAGGCTAAGGTGGATGGATCTCCTGAGCTCAGTAGTTTGAAGCTA","GCCAGGCATGGTGGCTCATGCCTGTAATCTTAGCACTTTGGGAGGCCAAGGTGGGCGGATCATCTGAGGTCAGGAGTTTGAGAC"
"GL873558","5037604","5037746","chr3","2138380","2138521","38","2899224","GCTGGGCCTGGTGGCTCACATCTGTAACCCTAACACTCTGGGAGGCCAAGGCAGGAGGATCTCTTGAAGCTAGGTTGTTAGCCAGGGCGACCCCACAGCACTCTAGCCTGGGGCAACAGAGTGAGACTTTGTCTCCAAACAAA","AGCTGGATGTGGTGGCCCACACCTGTAATCACAGCTACTCGATAGGCTAAGGCAGGAGAATCGCTTGAACCTGGGAGGCGGGGACTGCACCATCACAGCACTCCAGCCTGGGTGACAGAGTGAGACTATGTATCAAAAAAAA"
"GL873558","6488648","6488700","chr3","39516725","39516768","23","33028077","ATAGCACTCTACCATGGGTGACAGAGTGAGACTATCTCCCCCCCTCAAAAAAA","GAGACCAGCCTGACCAACACAGTGAAACCTCATCTCTACTAAAA"
"GL873558","6489359","6489583","chr10","19070944","19071172","64","12581585","GGCTGGACATGGTGGGTCCTGTAATCCTAGCACTGTGGGAGGCCGAGGCAGGTGAATTGCTTGAGCTTATGGGTTCAAGACCAACCTGAGCCAGAAGGAGACCTTGTCTCTAAAAATGGCTGGGTGTTGTGGCAGGCACCTATAATCCCAGCTACTTGGGAGGCTGAGGCAAGAGAATCGCTTGAACCCAAGAGTTTGATGTTGCTGTCAGCTAAGATGCCATAG","GGCTGGGCTCAGTGGCTTATGCCTGTAATCCCAGCGCTTTGGGAGGCCAAGGCGGGTGGATCACCTGAGGTCAGGAGTTCGGGACCAGCCTGAACAACATGGTGAAATCCCGCCTCTACTAAAAAAAAGCCGGGTGTGGTGGCATGCACCTGTAATCCCAGCTACTTGGGAGGCTGAGGCAGGAGAATCACATGAACCTGGGAGGCAGAGGTTGCAGTGAGCTGAGATC"
"GL873558","14631848","14632045","chr18","1878493","1878704","62","12753355","GGTGCAGTGGCTCACGCCTTTAATCCCAGCACTTGGGATGGTGAGGCAGGTAGATTGCCTAAGTTCACAGGTTCAAGACCAGCCTGAGCCAGAGAGACCCTACCTCTAAAAAATAGCCAAGCATTGTGGCAGGCACCTGTAATCCTACTTAGGAGGCTGAGTCAAGAGGATCATTTGAGCTTAAGAGTTAGAGCTTGT","GGCCAGGCATGGTGGCTCACGCCTGTAATCCCAGCACTTTGGGAGGCCGAGGCGGGTGGATCACAAGGTCAGGAGTTCAAGACCAGCCTGGCCAACATGGTGGAAGCCCATCTCTACAAAAAATTAACTGGGCGTGGTGGCAGGCACCTGTAATCCCAGCTACTTGGGAGGCTGAGGCAGGGGAATTGCTTGAACCTGGGAGGCGGAGGTTG"
"GL873558","14632352","14632392","chr7","10117723","10117763","10","4514629","GAGTTAGAGCTTGCTGTGAGCTAAGATGCCACGGCACTCTA","GAGTTAGTTGCAGTGAGCTGAGATCGTGCCACTGCACTCCA"
"GL873559","8193331","8193614","chr20","11734223","11734512","71","3540892","CAGGTACGGTGACTTATCCCTGGAATCTTAGAACTGTCTGAGTCCAAGGTGGGAGGATCATTGGAGGTCAGGAATTTGAGACCAGCCTGAGCAAGAGTGAGACCTCTTCTCTACTAAATATAGAAAAATTAGCCAGGGTTTGTGGCAGGTGCTTATAGTCTAAGCTTCTTAGGAGGCTGAGGCAGGAGAATCTCTTGAACCCATGAGTCTGAGGTTGCCCTGAGTTAAGATGACATCACTGCAGTCTCCCCAAAGCAACGGAGTAAGACTCTGTCTCAAAAACA","GGCCAGGCACGGTGGCTCATGCCTCTAATCCCAGCATGTTGGGAGGCCGAGGTGGGCGGATCACATGAGGTCAGGAGTTTGAGACCAGCCTGGCCAACATAGTGAAACCCTGTCTCTACTAAAAATACAAAAATTAGCCAGGTGTGGCAGCACGTGCCTGTAGTCCCAGCTAGTCAGGAGGCTGAGGCAGGAGAATCACTTGAATCCACCAGGCGGAGGCTGCAGTGAGCCAAGATCACACCACTGCATTCCAGCCTGGGCGACAGAGCAAGACTCTGTCTCAGAAAAAA"
"GL873559","8193642","8193657","chrX","1083699","1083714","0","7109943","AAATAAATAAAATAAA","AAATAAATAAAATAAA"
"GL873560","393252","393440","chr11","121440472","121440639","55","121047220","CTGGGCAGGGTGGCACACACCTGTCATCCCAGCATGTTGGGAAGCTGAGGCAGGAGAATTACTTGAGCTCAGATTCCAAGAGGTGAGGATCACTTGAGCCTAGAAGTTGAGGCTGCACTGATGCCCCAACACTCCAGCCTGGGCAACAGAGCAAGGTCCTGTCCCAAAAAGAAAAAAAGAAAAGGAAAA","GCTGGGCGCAGTGTCTCACGCCTGTAATCCCAGCTATTTGGGAGGCTGAGGCAGGAGAATTACTTGAACCTGGGAGGTGGAAGTTGCAGTGAGCCGAGATCCTACCATCGCACTCCAGTCTGGGCAACAAGAGCAAAACTCTGTCTCAAAAAAAAAAAAAAAAAAAAA"
"GL873560","4038833","4039014","chr12","78258009","78258208","56","74219176","GGCTGGGTGCGGTGACTCACACCTGTAATCCCAGCACCTGGAGGCCCAAGGCAGGGTGGATTGTCTGAGCTCACAGGTTCAAGACCAGCCTGAGCCAGAGCGAGACCTAAAAATAGCTAGGCGCTGTGGGAGGCACACGTAGTCCCAGCTACTCAGGAGGCTGAGGCAAGAGAATCACTTGA","GGCTGGGCACGGTGACTCACGCCTGTAATCCCAGCACTTTGGGAGGCCCAGGTGGGTGGATCACCTGAGGTCAGGAGTTCAAGACCAGCCTGGCCAAGATGGTGAAACCCCGTCTCTACTAAAAATACAAAACTTAGCTGGGCATGGTGGCGGGCACCTGTAATCTCAGCTAGTCGGGAGGCTGAGGCAGGAGAATCTCT"
"GL873560","4492531","4492643","chr7","56485655","56485756","37","51993124","AACAGAAAAACTAGCCAGGCATAGTGGTGCATGCCTGTTGTTCCAGCTGCTCTAGAGGCTAAGGCAAGAGGATTGCTCCAGCTCAATAGTTTGAGGTTGCTGTGAGCTTGAGA","TTAGCTGGGCATGGTGGAGCACACCTGTAATTCCAGCTACTCAGGAGGCTGAGGCAAAAGAGTTGCTTGAACCCAGGAGGCAGAGGTTGCAGTGAGCCGAGA"
"GL873560","4492670","4492771","chr8","41603464","41603564","28","37110794","AGCACTCTGGGTGACTGAGGCAGGATTACTTGAGCTCAGGAGTTTATGACCAGCCTGAGCTGGTCCTTGATCAAGACTCCATCTCTACTAAAAAAACAAACA","CACTTTGGGAGGCCGAGGCAGCAGATCACTCGAGGTCAGGAGTTTGAGACCAGCCTGGCTAACATGGCAAAACCCCATCTCTACTAAAAATATAAAAATTA"
"GL873560","8106775","8106882","chr11","111878590","111878685","39","103771815","ACATAAGAATCAGGCCAAGCCTTGTGGCTCCTGTATGTGATTCCAGCACTGGGAGGGCAAGGCAGGAGGATCCCTGACGTCAGGAACTCAAGGCTGCCCAAGTATCAT","GGGCACAGTGGCTCATGCCTGTAATCCCAGCACTTTGGGAGGCCAAGGCGGGTGGATCACCTGAGGTCAGGAGTTCAAGACCAGCCTGACCAACAT"
"GL873560","10872201","10872272","chr7","9971011","9971083","11","901190","GGCTGGGCACAATGGGTCACACTTGTAATCCCAACACTTTGGGAGGCTGAGGTGGGCAGATCACCTGAGCTC","GGCTGGGTGGGGTGGCTCACACATGTAATCTCAGCACTTTGGGAGGCTGAGGTGGGCAGATCACCTGAGGTCA"
"GL873560","11043320","11043410","chr6","111928830","111928919","19","100885510","CAGGCGAAGTGGCTCATGCCTATAATCCTAGCATTCTGGGAGGCTGAGGTGGGAGAATCCCCTGAGGTCAAAAGTTCAAGACCGGCTTGGC","GGCCAGGCTCAGTGGCTCATGCCTGTAATCCCAGCACTTTGGGAGGCCGAGGTGGGTGAATCACCTGAGGTCAGGAGTTCAAGACCTGCC"
"GL873561","5890611","5890936","chr8","76222061","76222392","77","70331450","GGCTGGGCCTGGTGGCTCATGCCTATAATCCTAGCACTCTGGGAGGCAAAGGTTGGTGGATTGCTTAAGCTCAGGAGTTCAAGACCAGCCTGATTAAGAGTGAGATCCCATCTCCACTAAAAATAGAAGGGAAAAAAAAAAAAAAAAAACCTAGTTGGGCTTGGTGGCAGCACTTGTAGTCCCAGCTATTTAGGAGGCTGAGGAAAGAGAATCACTTGAACCCAAGAGTTTGAAGTTGCTCTGAGCTATGATGCCATAGAACTCTACCCAGGGTGACAGAGTAAAACTGGATCTCAAATAAATAAATAAATAAATACATAAATAAA","GGCTGGGCATGGTAGCTCATGGCTGTAATCCTAGCACTTTGGGAGGCCAAGGAAGGTGGATTGCCTGAGCTCAGGAGTTCAAGACCAGCCTGGGCAACACAGTGAAATCCTGTCTCTACTAAAATACAAAAAAGAAAAAAAAAAAAAAAAAAAACAGCTGGGCATGGCAGTGTGCACTTGTAATCCCAGCTACTCAGGAGGCTGAGACAGGAGAATCACTTGAACCCGGGAGGCAGAGGTTGCACTGAGCCGAGATTGTATCACTGCACTCCAGCCTGGGTGACAGAGCGAGACTCTGTCTCAGAAAAAAAAAAAAAAACAAAAAAACAAAA"
"GL873561","10859256","10859475","chr6","100119122","100119352","73","89259866","GGATCACTTGAGCTCAGGAGTCAAGACCAACTTGAGTAAGAGTGAGACCCTGTCTCTACTAAAAATAAAATATATAGCCAGGCATTGTGCTGGGCACCTATATATAAGCTAAAATGGAGTCTTAGCTACCTCCTTGAACTTGAACCCAGGAGTCTGAAGTTGCTTTGAGCTAGGCTGATGCCACTGCACTTTACCCAGGCAACAGAGTGAGAGTATCTAA","GGATCACCTGAGGTCAGGAGTTCAAGACCAGCCTGGCCAACATGGTGAAACCCCGTCTCTACTAAAAATACAAAAACTAGCCAGGCATGGTGGCGCACACCTGTAGTCCCAGCTACTTGGGAGGCTGAGGCAGAAGAATCTCTTGAATCCGGGGGTTGGAGGTTGCAATGAGCTGAGATCATGCCACTGCACTCCAAGCCTGGGTGACAAGAGCGAAACTCCATCTCAAAA"
"GL873561","10859563","10859576","chr4","114457728","114457741","1","103598165","AAAAAAAAATAAAA","CAAAAAAAATAAAA"
"GL873562","12189469","12189706","chr1","31551552","31551790","75","19362083","CAGTGGCTCACGCCGGTAATCCCAGCACCTTGGGAGCTGAGGCAGGCAGATCTCCTGAGGTCACGTGTTTTGAGACCAGCCTGAGCTAGAGTGAGACCCCACCTCTAAAAATAGCCAGTCGCCTGTAATCCCAGCTACTCGGGAGAAACCCAGGAGTCTAAGGTCGCTGTGAGCTGACACCTCAGCACTCTGCTGGGGTAACAAAGTGACACTTTGTCTCAAAAAAATAAATAAATAT","GCAGTGGCTCACGCCTGTAATCCCAGCACTTTGGGAGGCCAAGGCGGGTGGATCACCTGAGGTCAGGAGTTCAAGACCAGCCTGGCCAACATGGTGAAACCTCATCTCTACTAAAAATACAAAACAGGAGAATCGCTTGAACCCGGGAGGTAGAGGTTGCAGTGAGCTGAGATAGTGCCACTGCACTCCAACCTGGGCAACAGAGTGAGACTCCGTCTCAAAAAAATAAAAAATAAAAA"
"GL873562","4526861","4526913","chr13","94764706","94764759","14","90237845","GTGAGACCTTGTCACTACTGAAAATAGAAAAATTAGCTGGGCATGGTTGTAGG","GTGATGAAACCCCATCTCTACTAAAAATACAAAAATTAGCTGGGCTTGATGGTG"
"GL873562","4789223","4789313","chr10","47852509","47852598","25","43063286","GGCCAGGAGAAGTGGCTAACACCTGTAATTCCAGCACTCTAGGAGATGGAGGCAGGGACCAGCCTGAGCTAGAGTGAGTGAGACTCCATCT","GGCCAGGTGCAGTGGCTCACACCTGTAATCCCAGCAACTTTGGGAGGCTGAGGCAGGCAGATCACTTGAGGTCAGGAGTTCGAGATCAGC"
"GL873562","4868605","4868801","chr16","54069750","54069948","44","49201145","GGCCAGGCATGGTGGCTCATGCCTGTAATCCTAGCACTCTGAGAGACCAAGGCTGATGAATCACCTGAACTCAGGAGTTGAGACCAGCAGGAGCAAAAGTGAGATCCCATCTCTACTCAAAAATAGAAAATTAGTTCAGGCAAGGTGGCACATACCTGTAATCCCAGCACCCTGGGAGGCTAAGGTGGGTGGATTGC","GCCCAGCGCAGTGGCTCATGCCTATAATCCCAGCACTTTGGGAGGCCAAGGCGGGTGGATCACCTGAGGTCAGGAGTTCGAGACCAGCCTGCCCAGCATGGTGAAACCCCATCTCTGTTAAAAATATAAAAATTAGACTAGGCGCGGTGGCTCACACCTGTAATCCCAGCACTTTGGGAGACCAAGGTGGGCGGATCAC"
"GL873562","4929184","4929360","chr10","37539693","37539877","47","32610509","GGCCAAGCTCAGTGGCTCTCCCTAGCACTTTGGGAGACCGAGGTGGGTGGATTGCCTGAACTCAGGAGTTCTAGACCAGCCTGATCAAGAGCAAGACCCTACATCTACTAAAAATAGAAAAACTAGCTGGGCATTATAGTACGCACCTGTACTCCCATCTACTCTGGAGGCTGAGGC","GGGTGCAGAGGCTTATGCCTGTAATCCCAGCACTTTGGGAGGCAGAGGTGGGTGGATCACTTGAGGCCAGGAGTTCAAGACCAGCCTGGTCAATGTGGTGAAACCTCGTCTCTACTAAAAATACAAAAATTAGCCGGGCATGGTGGCATGCATCTGTAGTCCCAGCTACTTGGGAGGCTGAGGCA"
"GL873562","5446395","5446678","chr16","63692714","63692996","79","58246319","GGCTGGATGCAGTGGCTCATACCTGTCTGTAATCCTAGCACTCTGGGAGGTCGAGGTGGGTGGATTGCCTAAGTTCACAGGTTCGAGGCCAGCCTAAGCAAGAAGAGCAAGACTCCATCTCTGAAAGTAGCCAGGCATTGTGACAGGCGCCTATAGTCCCAGCTACTTGGGAGGCTGAGGCAAGAGAATTGAGCCCAGGAGTTAGAGGTTGCTGTGAACTAGGACTCCATAGCATTCTACTGAAGGTGACAAAGTGAGATTCTGTCTCAAAAAAAAGACTGATT","GGCTGGCTGCGGTAGCTCACCCCTGTAATCCCAGCACTTTGGGAGGTCAAGGCAGGTGGATTGCCTGAGGCCAGGAGTTCGAGGCCAGCCTGACCAATATGGCAAAACCCTGTATCTACTAAAAACTAGCTGGGCATGGTGGCATACACCTGTAGTCCCAGCTACTTGGGAGGCTGAGGCAGGAGAATTGCTTGAACCTGGAGGCAGAGGTTGCAGTGAGCCAAGGCTGCCCCACTGCACGCCAGCCTGGGTGACAGAGTGACACTCCATCTCAGAAAAAAAA"
"GL873562","8499356","8499477","chrX","91860022","91860139","29","83360666","GGCTGGGTGTGCTGGCTCATGCCTGTAATCCTCGCACTCTGGGAAGCTAAGGCAGGTGGATTGCCTGAGCTTATGAGTTTAAGACTAGCCTGAGCCAGAGCAAGACCTTGTCTCTATTTTTT","GCCGGGTGTGGTGGCTCATGCCAGTAATCCTAGCACCTTGGAAGGCTGAGGCAGGTGGATTGCCTGAGCTCAGGAGCTTCAGACTAGCCTGGGCAACATAGTGAAACCCCATATCTCT"
"GL873562","8499731","8499918","chr7","167658032","167658223","45","159158301","AAGACCTTGTCTCTAAAAATAGCCAGGTGTTGTAGCAGGCACCTGTAGTCCCAGCTACTTGGGAGGCTGAGACAAGAGAATTGCTTGAGCCCAAGAGTTTGAGGTTGCTGTGAGCTGAGATGCCATGGACTCTATCGAGGGCAGTAAAGTGAGACTCCGTCTCAAAAAAAAAAAAAGAAAGAAAAGAA","TACTAAAATACATACAAAAATTAGCCAGGTATGGTGGCAGGCCCCTGTAGTCCCAGCTACTCGGGAGGCTGAGGCAGGAGAACTGCTTGAACCCAGGAGGTGGGGATTGCAGTGAGCTGAGATCGCACCACTGCACTCCAGCCTGAGCGACAGAGTGAGACTCTGTCTCAAAAATAAAAAAAGAAAAAAAAA"
"GL873562","10216295","10216385","chr1","44313085","44313176","34","34096790","TAAAAATACATTGAACCAGATTCAGTGGCTCACACCTGTGCTCCTAGCTACCCAGTGGCTGAGGCTGAAGGATGGCTTGAATCTCAAGTTC","TTACAGATCATTTGGGGCTAGATGTAATGGCTCACACCTGTAAGCCCAGTGCTTTGGGAGGTTGAGGCAGGAAGATGGCTTGAACCTAGGAG"
"GL873562","11812352","11812435","chr19","44513406","44513491","17","32701054","GGCCGGTACGATGGCTCAGGCCTATAATCTTAGAACTCTGGGAGTCCGAGGTGGGTGGACTGCCTGAGCTCACAGTTCGAGACC","GGCCGGACGCGCTGGCTCACGCCTGTAATCCTAGCACTTTGGGAGGCTGAGGGGGGCGGATAGCCTGAGCTCAGAAGTTCGAGACC"
"GL873562","12179920","12180054","chr14","8268315","8268451","18","3911605","GGCCAGGCATGGTGGCTCACACCTATAATCCTAGCACTCTGGGAGGCCAAGGCAGGTGGATCACCTGAGCTCAGGAGTTTAAGACCAGCCTGAGCAAGAGTGACAACCTATCTCTATTAAAAATACAAAAACTAG","GGCCGGGCATAGTGGCTCACACCTATAATCCCAGCACTTTGGGAGGCCAAGGCAGGTGGATCACCTGAGGTCAGGAGTTCGAGACCAGCCTGACCAAGATAGTGAAACCCCGTCCCTACTAAAAATACAAAAATTAA"
"GL873562","14017684","14017885","chr2","94000404","94000565","73","79982720","CAAGCTAGCCTAGGGATGTGGAGGTACCTGTAGTCCCAGTTACTTCATTGGCTGAGGCTTAAACCCTCTTGGATGGTCTCACTCTGTCACCCTGGTAGAGTGTTGTGGCATCATGTGTCACAGGAGGTTGAGGTTGCTGTGAGCTGTGATGCCACAACATTCTACCAGGGTGACAGAGTGAGACTCTGTTTCAAAAACAAAA","AAACTAGCCTGGCGTGGTGGTGTGTGCCTGTAATCCCAGCTACTTGGGAGGCTGAGACAGGAGAATCACTTGAACCTGGGAAGTGGAGGTTGCAGTGAGCTGAGATCATGCCACTGCACTCCAACTTGGGCAACAGAGCGAGACTCTGTTTCAAAAAAAAAA"
"GL873562","14017915","14018042","chr1","161382752","161382881","27","147364837","GGCTGGGCACGGTGGCTCACACTTGTAATTCTAGCACCCTGGGAGGCCAGCGTGGGTGGTTTGCTTGAAGTTAGGAGTTCAAGACCAGCCTGACCAAAGTGAGACCACATCTCGACTAAAAACAAACA","GGCTGGACGCAGTGGCTCATACCTGTAATCCCAGCACTTTGGGAGGCCGAGGTGGGTGGATCACCTGAGGTCAGGAGTTCAAGACCAGTCTGGCCATGGTGAAACCCCATCTCTACTAAAAATACAAAAA"
"GL873563","2645481","2645758","chr1","37954757","37955032","69","35309276","GGCTGGGTGCCATGACTCACGCCTGTCATCCCAGCTCTCTGGGAGGTCACAATGGGAGTATTCCATGAGCTCAGAAGTTTGAGACCAGTCTGAGCAAGAGCAGACTCCATTTCTACTAAATATAGAAAAATTAGCCCAGTATGGTTGTGCACACCTGTAGTCCCAGCTACTTGGGAGCTGAAGCAGGAAAACGGCTTGAGTCCAGGAGTCGGAGGTTGCTGTGAGCTGAGAGCTATAATGATGCCAGTGCACTCTACCCAGGCAACAGAGCAAGACTC","GGCCGGGTATGGTGGCTTACGCCTGTAATCCCAGCACTTTGGGAGGCCAAGGTTGGCAGATCACCTGAGGTCAGGAGTTCGAGACCAGCCTGGCCAATATGGCGAAACCCCGTCTCTACTAAAAATACAAAAATTAGCTGGGCATGGTGGCGCATACCTGTAATCCCAGCTACTCGGGAGGCTGAGGCAGGAGAACTGCTTGAACCCAGGAGGTGGAGGTTGCAGTGAGCCGAGATTGAGCCACTGCACTCCAGCCTAGGTGACAGAGTAAGACTC"
"GL873563","2646059","2646097","chr1","62915138","62915167","12","60269079","CAAACAGAACAAGACTTTGTTTCAAAAAAAAAAAAAAAA","CAAACAAACAAACATCACAAAAAAAGAAAA"
"GL873563","2651001","2651167","chr2","69424628","69424798","38","66773627","GTACAAAAATTAGCCAGATGTCTTGGTGCTTATAGTCAGCAACTCAGGAGGCTGAGGCAGGAGGATCACTTGAACCCCTGGAATTTGAGGTTGCTGTGAGCTAAGTTGATGCCACGGCATTCTAGCCTGGGTGACAGAGTAAGACTCCATCTCAATAAATAAATAAA","AAAAAAATTAGCCAGGCATGGTGGTGCATGCTTGTAATCCCAGCTACTTGGGAGGCTGAGGCAGGAAGATCACTTGAACCTGGGAGGCGGAGGTTGCAGTGAGCCAAGATTGTGCCACTGAACTCCAGCCTGGGTGACAGAGCAAGACTCCATCTCAAAAAAAAAAAAAAA"
"GL873563","2651449","2651584","chr3","121251018","121251153","32","118599569","GGTCCAGTGAGGTGGTTCAGACCTGTAATCCTAGCATTCTGGGAGGCTGAGGTGAGCAGATTGCTTGAGCTCAGTGAGTTTGAGACCAGCCTGAATAAAAGCAGCACCCCATCTCTACCAAAAGTAGGAAAATTAT","GGCCAGGTGCAATGGCTCACACCTGTAATCCCAGCACTCTGGGAGGCCGAGGTGGGCAGATCACCTGAGGTCAGGAGTTTGAGATCAGCCTGGCCAACCTGGCAAAACCCCATCTCTAATAAAAATACAAAAATTA"
"GL873563","6898038","6898117","chr6","28153994","28154075","27","21255956","AAAAAACAGAAAAATTAGTTGGGTGTGGTAGTGGGTAGCTACTTGGGAGGCTGGGGCAGGAGAATCACTTGAACCCAGGA","AAAATTAGCCGGGTGTGGTGATGCATGCCTCTAATCCCAGCTACTTGGAAGGCTGAGGCAGGAGAATCACTTGAAGGCAGGA"
"GL873563","6898395","6898520","chr5","140939246","140939381","30","134040851","GGGGGTGGTGGCTCATGCCTGTAATCCCAGCACTCTGGCTGAGACAAGTGGATTGCATGAGCTCAGGAGTTCAAGACCAGCTTGAGGAAGAACAAGACTCCATCTCTACTAAAAATAGAAAAATTT","GGCCCGGTGCTGTGGCTCATGCCTGTAATCCCAGCACTTTGGAAGGCTGAGGCAGGTGGATCCCTTGAGGTCAGGAGTTCGAGACCAGCATGGCCAACATGGCAAAATCCCATCTCTACTAAAAATACAAAAATTA"
"GL873563","7811395","7811530","chr1","29437872","29437991","31","21626477","GGCCGGGCGTGGTGGCTCATGCCTGTAGTCCCTGCACTGTGGGAGGCCGAGGCGGGTGGATCACCTGTGCTCAGAGGTTCGAGACCAGCTAAGACCCCCCTGAGCCAAATGAGCCAGAGTGAGACCCCGTCTCTAC","GGCCGGGCGTGGTGGCTCACGCCTGTAATCCCAACATTTTGGGAGGCCAAGGCGGGTGGATCACCTGAGGTCAGAAGTTCGAGACCAACCTGGCCAACATGGTGAAACCCCTGTCTCTAC"
"GL873563","7855904","7856041","chr3","37342340","37342469","34","29486436","GCCAGGGCAGTGGTTCACACCTGTAAAAACCCCAGTATTTTGAGAAGCCAAGTTGGGAGGATCACATAAGGTCAAGAGTTTGAGACCAGCCTGGACAACACAGTATAAGACTCCCATCTCTATTTTGTTAAATATACA","GCCGAGCGCGTGGCTCACGCCTGTAACCCCAGCACTTTGGGAGGCCAAGGTGGGTGGATCACTTGAGGTCAGGAGTAGGAGACCAGCCTGGCCAACATGGGTGAAACCCCACCTATAGTTTAAAAATATA"
"GL873563","8381194","8381392","chr2","167568017","167568216","65","159186823","GGCCAGTGCAGTAGCCCACACCTGTAATCCTAGCACTCTGGGAGGCCAACTCTGGTAGAGTTTGAAACTAGCCTGAGCAAGAGCGAGACCTTGTCTTCACTGAAAAAAATAGAAAAAAAAAAAAAAAACTAACTGGGCATGGTGCTGTACATCTGTAGCCCGAGCTACTCAGGAGTCTGAGGCAAGAGGATTACTCAAT","GCCAGGCGAGGTGGCTCATGCCTGTAATCCCAGCACTTTGGGAGGCCAAAGTGGACAGATTACCTGAGGCCAGGAGTTTGAGACCAGCCTGACCAATATGGTGAAACCCCATCTGTACTAAAAATACAAAAATTAGCAGGGCGTGGTGGTGTACACCTGTAATCCCAGCTACTCAGGAGGCTGAGGCAGGAGAATCTCTT"
"GL873563","8381923","8382014","chr2","92370724","92370803","33","83988801","GGATTGCTCAAGCCCAAGAGTTTGAGGTTGCTGAGAGCTATGACACTACAGCACTCTACTCTACCCAGGGCAACAGAGTGAGACAAAAAAAA","TTGCTTGAACCCAGGAGCTAGAGGTTGCAGTGAGCTGAGATTGCACTATTGCACTCCAGCCTGGGCAACAGGGTGAGACT"
"GL873563","9500422","9500552","chr19","10830410","10830544","33","1329988","GGTCAGGTGCAGTGGTCACCTGTCATCCTACCCCTCTGGGAGGCCAAGGTGGGTGGATTGCCTGAGTTCAGGAGTCTGAGACGAACCTGAGCTAGAGCAAGACCTCATCTCTTAAAAAATAGCCAGCATTC","GGCCAGGTGCAGTGGCTCATGCCTGTAATCCCAGCACTTTGGGAGGCCAAGGTGGGTGGATCACCTGAGGTCAGGAGTTCGAGACCAGCCTGATCAACGTGGTGAAACCCCATCTCTACTAAAATTGCAAAATTA"
"GL873563","9501087","9501192","chr16","71049107","71049211","33","61548020","TAAAACCTATAATGTTTGAAAATAAAAATAGCCAGGCCTTGTTGTGGGTGCCTGTAGTCCCAGCTACTTAGGAGGCTGAGGTAAGAGGATTGCTTGAGCCCAAGAG","TGAAACCCCATCTCTACTAAAAATACAAAATTAGCCAGGTGTGGTGGTGCATGCCTATAATCCCAGTTACTTGGGAGACTGAGGCAGGAGAATCACTTGAACCTG"
"GL873563","10991062","10991128","chr1","22619342","22619410","11","11628280","GGCCGGTGTAGTGGCTCACGCCTGTAATCCCAGCACTTTGGGTGCCGACATGGGCAGATCGCCTGAG","GGCCGGGCGCGGTGGCTCACACCTGTAATCCCAGCACTTTGGGAGGCCGAGGTGGGCGGATCACCTGAG"
"GL873563","12252577","12252738","chr8","144193624","144193784","41","131941047","GGCTGGGTACAGTGGCTCATATCTGTAATCCTAGCACTCCAGGAGGCTGAGGTGGGAGGATAATTGCCTGAAGTCAGAAACACAAGACCAGCCCAAACAAGAGTGAGACACCATCTCTACTAAAAATAGAAAACTGAGCTGGGTGTGGCGGTGCACACCTGT","GGCCGGGCATGGTGGCTCATGCCTATAATCCTAGCACTTTGGGAGGCCGAGGTGGGCGAATCACCTGAGGTCAGGAGTTTGAGACCAGCCTGGCCAACATGGTGAAACCCCATCTCTACTAAAAATACAAAAATTAGCTGGGTGTGGTGGCACATGCCTAT"
"GL873564","1384131","1384395","chr13","32253035","32253303","64","30868904","GGGGGGGGGGGCACACTGGCCTGTAATTCTAGCACTCTGAGAGGCCAAGGCAGGTGGATCACCTGAACTCAGGAGTTCGAGACCAGCCTGATCAAGAGTGAAACCCTGTCTCTACTAACAAGAGAAAAACCAGTAGTCCCAGCTACTCAGGAGGCTGAGGCAGAAGAATCACTTGAACCCAGGAGTTTGAGGTTTCTGTGAGCTACAGTAGTGCTATGGCACTCTACCAAGAGTGACAGAGTGAAACTCTGTCTCAAAAAAAAAA","GCTGGGCATGGTGGCTCATGCCTGTAATCCCAGCACTTTGGGAGGCTGAGGCGGGTGGATCATCTGAGGTCAGGAGTTCAAGACTAGCCTGGGCAACATGGTGAAACCCTGTCTCTACTAAAAATACAAAATTACAGGTAATCCCAGCTACTTGGGAGGCTGAGGCAGGAGAATCGGTTGAACCCAGGAGGCGGAGGTTGCAGTGAGCTGAGATCATGCCACTGCACTCCAGCCTGGGCAATAGAATGAGACTCTGTCTGAAAAAAAAA"
"GL873564","2543879","2544121","chr1","199402350","199402570","73","196858471","GGCCAGGTGTGGTGGCTTACGCCTGTTGTCCCAGCGCTGTGGGAGGCCGAGGCAGGTGGATTGCCTGAGCTTAGCTGAGTTTGAGACCAGCGGAAGACCAGCATGAGGCAGAGTGAGCCAGAGTGAGATCCTGTCTCTACAAAAAAGAAAAAAAAAAAAACAGCCGGATGTTGTGGCGCGCGTCTGTAATCCCAGCTACATGGGGGTCAAGAGGGCAAGAGAATCATACAGGAGGAAGAAGTT","GGCCAGGTGTGGTGGCTCACACCTGTAATCCCAGCACTTTGGGAGTCTGAGGCGGGTGGATTGCCTGAGGTTGAGAGTTTGAGACCAGCCTGGCCAACATGGTGAAACCCTGTCTCTACTAAAAACACAGAAATTAGCCAGGCATGGTGGCGCATGTCTGTAATCCCAGCTACCCTCCTGGAGGCTGAGGCAAGAGAATCACTTGAACCCAGGAAGCAGAG"
"GL873564","4859126","4859236","chr9","15245726","15245837","31","10386600","GTGGCTCATGCTTATAATCCAATCACTATGGGAGACCAAGGTGGGGATGGGCGGAGATCACCCTCAGGAGTTGGAGACCAGCCTGAGTTAAGAGTGATACCATGTCTCTAC","GTGGTGTCTCACGCCTATAATCCCAGCACTCTGGGAGGCCAAGGTGGGCAGATCACCTGAGGTCAGGAGTTAAGAGACCAGCCTGGCCAACATGGTGAAACCCTGTCTCTAC"
"GL873564","4859490","4859678","chr8","126054004","126054184","54","121194514","CATGTCTCTATTAAAGGTAGAAAAATTAGCCGAAGTATTGTAGTTGGGCTGTATAGTCCCAACTACTGAAGAGGCTGAGACAGGAGGATTGCTTACAACTAGGAGTTTGAGGTTGCTGTGAGCTAGGCTGATGCCAAGGTGCTCTAGCCTGGGCAACAGAATGAGACAATGTCTTAAACAACAAAAAAA","GTCTCTACTAAAAATACAAAAATTAGCTGGGTGTGGTGGTGCATGCCTGTAATCCCAGCTACTCAGGAGGCTGAGGCAGGAGAATCGCTTGAACCCAGGAGGTAGAGGTTGCAGTGAGCCAAGATCATGCCACTGCACTCCAGCCTGGGTGACAGAGGGAGACTCTGTCTCAATAAATAAA"
"GL873564","5294014","5294069","chrX","11604904","11604969","20","6310890","GGGTGTGGTGACTTGCACTTACAATCAGCACTTTGGGAGGCGAAGGTAGGAGCATC","GGCTGGGTGCAGTGACTCACGCCTGTAATCCCAGCACTTTGGGAGGCTGAGGTAGGCAGATCACCT"
"GL873564","5294155","5294257","chr15","310129","310227","21","4984026","GGCTGGGTGTGGTGGCTCACGTCTGTTGTCCCAGCGCTATGGGAGGCTGAGGAGGGTGGATCACCTGAGCTCAGAGGTTCGAGACCAGCATAAGACCAGCATG","GGCTGGGCGCAGTGGCTCACGCCTGTAATCCCAGCACTTTGGGAGGCCAAGGCGGGTGGATCACGAGGTCAGGAGTTTGAAACCAGCCTAGCCAGCATG"
"GL873564","6711055","6711262","chr18","1878493","1878704","55","4832562","CTGGGCCCAGTGGCTCACACCTATAATCCTCGCACTCTGGGAGGCTGAGGCGGGTAGATTGTCTGAGCTCACAGGTTCAAGACCAGTGTGACCCAGAGCGAGGCTTTGTCTCTAAAAATAGCAGGGCGTTGTGGCAGGCACCTGTAGTCCCAGCTACTTGGGAGGCTAAGGCAAGAGAATTGCTTAAACCTAAGAGTCTGAGGTTACA","GGCCAGGCATGGTGGCTCACGCCTGTAATCCCAGCACTTTGGGAGGCCGAGGCGGGTGGATCACAAGGTCAGGAGTTCAAGACCAGCCTGGCCAACATGGTGGAAGCCCATCTCTACAAAAAATTAACTGGGCGTGGTGGCAGGCACCTGTAATCCCAGCTACTTGGGAGGCTGAGGCAGGGGAATTGCTTGAACCTGGGAGGCGGAGGTTG"
"GL873564","6711356","6711451","chr7","158031905","158031997","31","151320549","AAAAGAGTCTGAGGTTGCCATGAGCTATCATGCCAAGGCATTCTAGAGAAGGGGTACAAAGTGAGACTCTGTCTCAAAAAAAGAAAACCAAAAAGG","CCAGGAGGTGGAGGTTGCAATGAGCCAAGATCACACCACTGCACTCCAGCCTGGGTGACAGGGTGAGATTCTGTCTCAAAAAAAAAAAAAAAA"
"GL873564","7057009","7057315","chr14","106885133","106885430","87","99828124","GCCGGGTACAATGGCTTGCGCCTATAATCCCAGCACTCTGGGAAGCAGAGGTGGGTGGATCACCTCAGCTCACGAATTCGCTACCAGCCTGTCCTAGAGTGAGACACCCCCCCCACCCCCACCCCCCACAACCTCTAAAAATAGCCTGGAGTTGTGACGGGCACCTGTTGTCCCAGCTACTCTGGAGGCTGAGACAAGAGAATTGCTTGGGCCTCAGAGTCTAAGGTTGATATGAGCTATGACATCACAGCACTCTATCAAAGGTAACAAAGTGAGACTCTAAATAAATAAATAATAAATAAATAAA","GCCGGGCCCGGTGGCTCTTGCCTGTAATCCCAGCACTTTGGGAAGCTGAGGTGGGTGGATCACCTGAGGTCAGGAGTTCGAGACCAGCCTGACCAATATGGTGAAACCCCGTCTCTACTAAAAATATAAAAATTAGCCGGGTGTGGTGGCATGCGACTATAGTCCCAGCTACTCAGGAGGCTGAGGCAGGAGAATTGCTTGAACCCAGGAGGTGGAAGTTGCAATGAGTCGAGGTCACACCACTGCACTCCAGCCTAGGCAACAGAGTGAGACTCCATCTCAAAAAAAAAGAAAAAAA"
"GL873564","7705416","7705474","chr1","51463330","51463380","19","43757914","TCATGCCTGTAGTACCAGCACTTCAGGAGGCTGAAGCAGGAGCTAAGATTAGAAATTTG","CATGCCTTTAATCCCAACTACTTGGGAGGCTGAGGCGAGAATTGAAGTCCG"
"GL873564","8307239","8307551","chr14","30585163","30585473","93","22277924","GCACAGTGGCTCAGGCCTGTAATCTGAGCACTCTGGGAGGTTGAGGCTGAGGTTAGGAGTTAGGAGAACAGCCTGAGCAAGAGTGAGACCCCATCTCTACCAAAAATAGGGGAAAAAACTCCAAAAATCTAGCCACATGTTGTGGTACTTGCCTGCAATCCCAGCTACTGGGGCATAGGGGGACTGAGGCAAGAGGGTCACTTGAGCGTGAGAGATTGAGGTTGCTGTGAGCTAAGATGATGCCATGGCACTCTACCCAAGGTGGCAGAGTGAGCCTATGTCTCACCAATAAATAAACAAATAAATAAATGAA","GGGCACAGTGGCTCACGCCTGGAATCCCAGCACTTTGGGAGGTCAAGGTGGGTGGATCACCTGAGGTCAGGAGTTTGAGACCAGCCTGGCCAAAATGGTGAAACCCCATCTCTACTAAAAAAAATACAAAAAATTAGCCAGAATGTGGTGGTGCATGCCTGTAATCCCAGCTACTGGGGAGGCTGAGGCAGGAGAATCACTTGAACCTGGGAGGCGGAGGCAGCAGTGAGCCAAGATGGCGCCACTGCACTCCAGCCTGAGTGACAGAATGAGACTCTGCCTCAGGAAAAAAAAAAAAAAAAAAGCAAAAA"
"GL873564","8738781","8739084","chr6","92598388","92598711","90","83859607","GCTGGGCACAATGGCTCACACCTGTAATGCCAGCACTTGGGAGGCTAAGACGGGCAAATTGCCTGAGCTCACAAGTTCAAGACCCAGAGCGAGACCTCATCTCTAAAAAATTGCCATGCATTGTGGAGGGTGCCTGTTGTCCCAGCTACTTGGGAGGCGGAGAAAAGACAATCGCTTTAGCCCAAGAATTGAAGGTTGCTGTGAGCTGTGACGCTGTAGCACTCACCAAGGGCAACATAGTGAGACTCTGTTTCAAAATAAATAAATAAATAAATAAAAATAAATAAATAAAATAAAAACAAAA","GGCTGGGCTCAGTGGCTCATGCCTGTAATCCCAGCACTTTGGGAGGCCAAGGCTGGCAGATTGCCTGAGGTCAGGGGTTCAAGACCAGCCTGGCTAACATGGTGAAACCTCATCTCTAATAAAAATACAAAGATTAGCTGGGTTTGGTGGCACATGCCTGTAGTCCCAGCTATTTGGGAGGCTGAGGCAGGAGAATCGCTTGAACCCAGGAGTTGGAGGTTGCAGTGAGCTGAGATGGCACCACTGCACTCCAGCCTGGGTGACACAGCAAGACTCCGTCTCAAAAAAAAAAAAAAAAAAAAAAAAAAGAAAAGAAAAAAAAAA"
"GL873564","9560044","9560238","chrX","30236033","30236239","48","20675989","GGCCAGGTGCGGTGGCTCCTGCCTGTAATCCCAGCACTCTGGGAGGCCTAGGTGGGTGGATTGCCTGAGCTCACTGGTTGGAGACCAGCCTGATACAGATTGAGACCCCCTGCCTCTAAGAATAGCAGGGTGTTGTGACAGACACCTAAAGTCCCAGCTACTCGGGAGGCTGAGGCAAGAGAATCTCTTGAGCCC","GGCTGGGTGCGGTGGCTCACTCCTGTAATCCCAGCACTTTGGGAGGCCAAGGTGGGCGGATCACCTGAGGTCAAAAGTTCGAAACCAGCCTGACCAACAGGGTGAAACCCCGTCTCTACTAAAAGTACAAAAATTAGCCGGGCATGGTGGCAGGCACCTATAATCCCAGCTACTTGGGAGGATGAGGGAGGAGAATCACTTGAACCC"
"GL873564","9560508","9560604","chr1","212121416","212121513","30","202560908","TCGCTGTGCCCAAAAGTTAGAGGTTGCTGTGAGCTATGATACCACTGCACTTTACTGAGGGTGACAAAGTGAGACTCTGTCTCAAAAAATAAATAAA","CTTGAACCTGGGAGGTGGAGGTTGCAGTGAGCCAAGATCATGCCACTGCACTCCAGCCTGGGCAACAGAGCGAGATTCTGTCTCAAAAAAAAAAAAAA"
"GL873564","9753449","9753658","chr19","10370828","10371033","59","617379","TGAGACCCTGGTCTCTTCTAAACATTAAAAAAAAAAAGAAAACTGGGTGTTGTGGCGATGCCCATAGTCCCAGCTACTGATGAGGCTGAGGCAGGGGGATCACTTGAACCCAGGAGTCTGAAGTTGCTGTAAGCTAGGCTGAAGTCACAGTTGTCTAGCCTAGGGCAATAGAGTAAGACTGTCTCACAAAAAAAAAAAAAGGAAAGAAAA","GAAACCCTGTCTCTACTAAAAATACAAAAAATTAGCTGGGTGTGGTGGTGCGTGCCTATAATCCCAGCTACTCAGGAAGCTGAGGTGGGATAATCACTTGAACCTGGGAGGCAGAGGTTGCAGTGAGCCCCAGACTGTGCCACTGCACTCCAGCCTGGGTGACAGAGTCAGACCCTGTCTCAAAAAAAAACAAAACAAAAAAAAAA"
"GL873564","9753896","9754006","chr17","50277667","50277784","33","40523771","GCTGGGCAGGGTGGCTTGTGCCTGTAATCCTCACATTCTTGGAAGCCAAGTTGGTGGATTTCTTGAGCTCAAGAGTTCAGCCTGAACAACGGTGAGACCCCTGTCTCTCTC","CCGGGCATGGTGGCTCATGCCTGTAATCCCAGCACTTTGGGAGGCCAAGGTGGGTGGATCACTTGAGGTCAGGAGTTCAAGACCAGCCTGGCCAACATAGAGAAACTCTGTCTCTACT"
"GL873564","10693118","10693253","chr1","29437872","29437991","31","18744754","GGCCAGGCGTGGTGGCTCACGCCTGTAGTCCCAGCGCTATGGGAGGCCGAGGCGGGTGGATCACCTGTGCTCAGAGGTTCGAGACCAGCCAAGACCTCCCTGAGCCAAATGAGCCAGAGTGAGACCCCGTCTCTAC","GGCCGGGCGTGGTGGCTCACGCCTGTAATCCCAACATTTTGGGAGGCCAAGGCGGGTGGATCACCTGAGGTCAGAAGTTCGAGACCAACCTGGCCAACATGGTGAAACCCCTGTCTCTAC"
"GL873564","11596705","11596819","chr15","17759279","17759407","35","6162574","AATCCGCTACTCGGGAGTCTGATGCAGGAGGATCCCTGGAACCCGGGAGTGAGCTAGGCTGTCCATTCTACCCAAGGCAGAAGAGTGAGATTCTGTCTCAAAAAAAAAAAAAAAA","AATCCCAGTTACTCAAGAGGCTGAGGCAGGAGAATTGCTTGAACCCGGGAGGTGGAGCCGAGACCGCTCCACTGCACTCCAGCCTGGGTGACAGAGTGGGACTCTGTCTAAAAAAAAAAAAAAAAAAAA"
"GL873564","13278770","13278831","chr1","10318851","10318915","18","2959919","GGCTGAGCACAGTGGCTCATGTCTATAATCCCATCACTCTGGAAAGCTAAGAATGAGGATCT","GGCTAGGCATGGTGGCTTATGCCTATAATCCCAGCACTTTGGGAGGCTGAGGCAGACGGATCACC"
"GL873564","13278924","13279152","chr20","69116969","69117193","62","55838045","AAAATAGAGAATAAGAATCCCTTGAGCTCATGAGTTCAAGATCAGTCTGAACAAGTGTCAGACCCTATCTCTACTAAAAATGGAAAAATTAGCCAGGCACTGTGGCAAGTGCCTGTAGTCCCAGATTTCAGGAGGCTGAGGCAGGAGAATCATTTGAATCCAGGAGTTTGAGGTTGCTGTGAGCTAGGCTGACACCACTGTACTGTAGCCTGGGCAACAGAGTGAGACT","GAGGTGGGTGGATCACCTAAGGTCAGGAGTTCAAGACTAGCCTGGCCAACATGGTGAAACTCCATCTCTACTAAAAATACAATAATTAGCTGGGTGTGGTGGCATGTGCCTGTAATTCCAGCTACTCAGGAGGCTGAGGCAGGAGAATCACTTGAACCCAAGAGGCGGAGGTTGCAGTGAGCCGAGACTATGCCACTGCACTCTACCCTGGGCAACAGAGCAAGA"
"GL873565","1417041","1417214","chr4","44130284","44130433","54","42713243","GGCCAGGCGTGGTGGCTCACGCCTGTTGTCCCAGCGATTTGGGAGACTGAGGTGGGTAGATCACCTGTACTCAGAGGTTCGAGACCAGCTGAAGACCAGCCTGAGGCAGAGTGAGACCCCCGTCTCTATAAGAACAAGACAGCCGGACCTTGTGATCCCAGCTACATGGGTGGC","GGCCGGGTGCGGTGGCTCACACCTGTAATCCCAGCACTTTGGGAGGCTGAGGTGGGCAGATAACCTGAGGTCAGGCGTTCGAGACCAGCCTGGCCAACATGGTAAAACCCCGTCTCTACTAAAAATACAAAAATTAGCCAGGTGTGGTGG"
"GL873565","2138367","2138455","chrX","124155143","124155229","17","122016776","GGCTGGGCGTGGTACTCACGCCTGTTGTCCCAGTGCTGTGGGAGGCTGAGGTGGGTGGATCCCCTGAGCTCAGCAGAGTTTGAGACCAG","GGCTGGGTGCGGTGGCTCACGCCTGTAATCCCAGAACTTTGGGAGGCTGAGGTGGGTGGATCACCTGGGGTGAAGAGTTCGAGACCA"
"GL873565","2459722","2459938","chr7","32729330","32729532","57","30269608","AAAAAGACCAAACACCCCAGCTCTACTAAAAGTAGAAAAATTAGCTGGGTATTGTAGTGGGCACCTGTAGTCCCAGCTGCTTGGGAGGTTGCGGCAGGAGAACCACTTAAGCCCAGGAGTTGGAGGGTGAGGTGGGCTGAGGCCACTGCATTCTAGCCTAGGCAACAGAATGAGACTCTGTCTCAAACAAACAAACAAACAAACAAACAAAAAACAA","GAAACCCCATCTCTACTAAAAATACAAAATTAGCCAGGCATGGTGGTGCACACCTGTAGCTCCAACTACTTGGGAGGCTGAGGCAGGAGAATCACTTAAACCCAGGCAGTAGAGGTTGCAGTAAGCCAAGATCGCACCACTGCACTCCAGTCTGGGCAACAGAGTGAGACTCTGTCTCAAAAAAAAAAAAAAAAAAAAAAAAA"
"GL873565","2460219","2460297","chr10","28805224","28805297","28","26345005","CTCAAGCCTGTAATTCTAGCACAGCTGGGAGGCTGAGGCAGGAAGATCTCTCAGCTTAGGATTTCAAGACTAAACACAT","GTGGCTCATGCCTGTAATCTCAGCACTTTGGGAGGCTGAGGCAGGCAGATAACCTGAGGTCAGGAGTTCGAGAC"
"GL873565","11485258","11485580","chrX","66383160","66383473","97","54897902","GGCAGGGCACAGTGGCTCAATCACAGCACTCTGGGAGGAGGCTTAGATGGGTGGATTATTTGAGTTCACAAATTTAAGAACAGCCTGAGCAAGAGTGACACCCTGTCTCTACTAAAAAACAATAGGAAAAATAAAAACTAGCTGGGCATAGTGGCATATGCCTGTGGTTCCAACTACTTGGGAGGCAGAGGCAAGTTTGCTTAGCTAGTTTTTTTTCAGGCCCAAGAGTAGAGGTTGTTGTGAGCTGTGATGCCATAGCACTCTACATAGAGTGACAGAGTGAGACTTTGTCTAAATAAATAAATAAATAAAATTTTAAAAAA","GGCCAGGCACAGTGGCTCACACCTGTAAATCCCAGCACTTTGGGAGGCCGAGATGGGTGGATCACCTGAGGTCACGAGTTTGAGACCAGCCTGGCCAACATGGTGAAACCTCGTCTCTACTAAAAATACAAAAAAAAAAAAAATTAGCTGGGCGTGGTGGTGTGCACCTGTAGTCCCAGCTACTTGGGAGGCTGAGGCAGGAGAATCGCTTGAACCCAGGAGGCAGAGGTTGCAGCGAGCCGAGATCGCGCCACTGCACTCCAGCCTAGGTGACAGAGTGAGACTCTGTCTCAAGGAAAAAAAAAAAAAAAAAA"
"GL873565","13424539","13424574","chr1","174086158","174086184","14","160661619","ACCTAGGGTGAAAGTAAGACTGTCTCAAAAAAAGAA","AAGAGAGAGAAAGAGAGAAAGAAAGAA"
"GL873565","13424654","13424896","chr16","19730961","19731217","54","6306307","GCCAAGCACAGTGGCTCACACCTGTAATCCCAGCACTCTGGGAAGCCTAGGTGGGTGGATTACTTGAGCTCAGGAGTTCAAGATCAGCCTAAGCAAGAGTGAAACTCCCATGTCTAAATAAACAGCCGGGCATTGTAGTGGGTCCCTGTAGTCCCAGCTACTCAGGAGGCTGAGGCAAGAGAATCGCTTGACCCAGGAGTTGGAGGTTGCTGTGAGCTGAGGCCACGGCACTCTATCTAGGGT","GGCCGGGCACAGTGGCTCACGCCTGTAATCCCACCACTTTGGGAGGCCGAGGCGGGTGGATTACCTGAGCTCTGGAGTTAGAGACCAGCCTAGGCAACATGGTGAAACCCCATGTCTACTAAAATACAAAAAGCCGGGCGTGGCGGCGTGTGCCAATAGTCCCAGCTACTCAGGAGGCTGAGGCAGGAGAATTGCTAGAACCCGGGAGGCGGAGGTTGCAGTGAGCTGAGATCACGCCACTGCACTCCAGCCTGGGC"
"GL873565","13679578","13679856","chr1","27657515","27657797","72","13977937","GCAGGGTACAGTGGCTCACACCTGTAATCATAGTAACTCTTAAGCGGCTGAGGCAAGTGAGAGGCCTGAGATCAGGAGTCCAAGAATAGCCTAACCAAAAGTGAGACCCCATCTCTACTAAAAATAGAAAAAAACTAGCCAGGCATGGTGGCACTTACCATAGTCCCACCTCATAAGGCTGAGGCAAGAGTATCACTTGAACCCAGAAGTTTGAAGTTGCTGTCAGCTACAATGACATCATAGCACTTTACCCAGAGCTACAGAGTAAGACTCAGTCTC","GCTGGGTGCGGTGGCTCACACCTGTAATCTCAACACTTTGGGAGGCTGAGATAGGTAGATCACCTGAGGTCAGGAGTTCGAGACCAGCCTGGCCAACATGGTGAAACCCCATCTCTACTAAAAATACAAAAAACCTAGCCAGGCATGGTGGTGTGTACCTATAATCTCAGCTATTCAGAAGACTGAGACAGGAGAATCACTTGAACTTGGGAGGTAGAGGTTGCAGTGAGCCAAGATCACACCACTGCACTCCAGCCTAGGCAACAGAGTGAGACTCCGTCTC"
"GL873566","947388","947684","chr3","178868174","178868466","60","177920786","GGCCGGGTAGGGTGGCTCATGCCTGTAATCCTAGCATTTTGAGAGGCCAAGGCAGGTAGATTACCTGAGCTCAGGAGTTCCAGACCAGGCTGAGCAAGAGCCCCATCTCTATCAAAAATAGAAAAATTAGCTGGGTATGGTGGCACATGCCTNNNNNNNNNNNNNNNNNNNNNNNNNNNNNNNNNNNNNNNNNNNNNNNNNNNNNNNNNNNNNNNNNNNNNNNNNNNNNNNNATGACACCATAGCACTCTAACCTGGAGCAACAGAGTGAGACACCGTCTTAAAAAAAAAAAAAAAA","GGCCGGGTGTGGTGGCTCATGTCTGTAATCCCAACACTTTGGGAGGCCAAGGCGGGTGGATCACCTGAGGTCAGGAGTTTGAGACCAGCCTGGCCAACATAGTGAAACCCCTCTACTAAAAATAAAAAATTAGCCAGGTGTGGTGGCANNNNNNNNNNNNNNNNNNNNNNNNNNNNNNNNNNNNNNNNNNNNNNNNNNNNNNNNNNNNNNNNNNNNNNNNNNNNNNNNNNNNNNNNNNNNNNNCTCCAGGCTGGGCAACAGAGTGAGGCTCCATCTAAAAAAAAAAAAAAAAA"
"GL873566","2530056","2530102","chr1","123145244","123145289","11","120615188","AGGCCAAGGCAGTTGGATCACCTCAGCTCAGGAGTTTGAGACCCGCC","AGGCTGAGGGAGGCGAATCACCTGAGGTCAGGAGTTTGAAACCAGC"
"GL873566","2923434","2923499","chr1","38303497","38303565","19","35380063","GGGCTCAATGGCTCAGCCTGTAATCTTAGCAGTCTGGGAGGCTGAGGCAGGCGCCTGAGCAAGAGT","GCTGGGCGCAGTGTCTCGTGCCTGTAATCCCAGCACTTTGGGAGGCTGAGGCAGGCGGATCATCTGAGG"
"GL873566","3613441","3613522","chr3","54039458","54039545","21","50426017","GGTGGCACATGCCCGTGATCCCAGCACTCTGGGAGGCCGAGGAGATCGGACTGCCTGAGCTCAGGAGTTCGAGACCAGCCTG","GCGCGGTGGCTCACGGCCTGTAATCCTTGCACTTTGGGAGGCTGAGATGGGTGGATTACCTGAGCTCAGGAGTTCGAGACCAGCCTGG"
"GL873566","6100482","6100582","chr2","51286276","51286376","32","45185794","GGCTGGGTGAGTACCTCATGCATCAAGCCCAGTGTTCTGGAGGCTGAGGCAAGGGGATCCTTGATGTGGATAGTTCAAGGCCAGCCTGGCAATTAGCTAGA","GGCTGGGTGCAGTGGCTCACGCCTATAATCCCAGCACTTCGGGAGGCTGAGGCAGGCAGGTCACCTGAGGCCAGGAGTTCAAGACCAGCCTGGCCAACATG"
"GL873566","6245586","6245714","chr3","50507869","50508002","30","44262283","GCTGGGTGTGGTGGCTCACACCTATAATACCAGCACTTGGGAGGCCAAAGCAAGTGGATTGCCTGAGTTCACAAGTTCAAGACCAGCCTGAGCAAGAGTGAGACCCTGTCTCTTAAAAATAGGTGGGCG","GCCAGGTGCGGTGACTCACACCTATAATCCCAGCACTTTGGGAGGCCGAGGCACGTGAATCACCTGAGGTCAGGAGTTCAAGACCAGCCTGACCAACATGGTGAAACCTTGTCTCTACTAAAAATACAAAAACT"
"GL873566","6245992","6246162","chr16","22888303","22888475","37","16642311","TAGCTGGGCGTTGTGGCGGGCATCTGTAATCCCAGCTACCTGGGAGGCTGAGGCAAGAAAATCACTTAAGCCCAAGAGTTTGAGGTTGCTGTGAGCTGTGATGGCACAGTACTCTATTGAGGGCAACATAGTGAGACTCTGTCTCAAAAAATAAATAAATAAATAAATAAA","ATTAGCTGGGCGTGGTGGTGGGCACCTGTAATCCCAGCTTCTTGGGAGGCTGAGGCAGGAGAATCACTTGAGCCCAGGAGGCAGAGGTTGCAGTGAGCAGAGATCGTGCCACTGCACTCCAGCCTGGATGACAGAGTCAGACTTTGTCTCAAAAAAAATAAAAAATAAAAAAA"
"GL873566","6483968","6484033","chr19","10207852","10207913","17","3723884","AAAATATGGTAAAATAAGCCAAGGATGGTGGGTCACACCTGTAATCCCAGCTACTCAAGAGACTGA","TAAAAATACAAAATTAGCTGGGTGTGGTGGCACACACCTGTAATCCCAGCTACTCAAGAGGC"
"GL873566","7043395","7043464","chr10","28805224","28805297","20","21761829","GGCTAGGCCTGGTAATCCCAGCACTCTAAAAGGCTGAGGCAGGTGGATAGCCTGAGCAAGAGTGAGACCA","GTGGCTCATGCCTGTAATCTCAGCACTTTGGGAGGCTGAGGCAGGCAGATAACCTGAGGTCAGGAGTTCGAGAC"
"GL873566","7888407","7888429","chr16","1275850","1275872","4","6612557","CTAAAAATAAAAAATTAGTCTTG","CTAAAAATACAAAAATTAGCCAG"
"GL873566","7888682","7888751","chr13","39203832","39203891","22","31315150","GTAGTCTTGGCGTAGTGATATGTACCTTTAATCCCAGCTACTCAGGAAGTGGAGGAGGAAAGAGTACAAG","TTAGCTGGGCGTAGTGGTGTGTGCCTGTAATCCCAGCTACTTGGGAGGCTGAGGCGGGAG"
"GL873566","8203857","8203949","chr20","18199749","18199840","19","9995892","GGCCCGGCATGGTGGTGCTTTGCCTATAATCCCAGCATTCTGGGAGGCCCAGGCAGGCGGATCACCTGAGCTCACAGGTTCAAGAATGGCCTG","GGCCGGGCATGGTGGCTCACACCTGTAATCCCAGCACTTTGGGAGGCTGAGGCAGGCGGATCACCTGAGGTCAGGAGTTCGAGACCGGCCTG"
"GL873566","8268872","8268975","chr15","10815564","10815667","26","2546692","GTGGCTCATGCCTGTAATCCTAGCACTCTGGGAGGCCGAGGCAGGTGGATTCCCTGAGCTCATAGGTTTGAGACCACAAGCAAGTCCAAGACCCCATCTCTTTT","GTGGTTCATGCCTGTAATCCCAGCACTTTGGGAGGCCGAAGTGGGCGGATCACCTGAGGTCAGGAGTTTGAGACCATCTGGCCAAGATGTAGAAACCCCATCTT"
"GL873566","8269263","8269458","chr15","77706857","77707054","55","69437594","AAGACCCCATCTCTTAAAAAAGAAAAAAAAAGCTGGGTGTTGTGGCCTTCACCTGTAGTCCCAGCTACTGGGGAGGCCAAGGCAAGAGACTTGCTTGAGCCAGAGTTTGAGGTTGCTGTGAGCTATAGTGCCACGGCACTCTACCAAAGGCAACAAAGTGAGACTGTCAAAAAAAAAAAAAAAAGAAGAAGAAGAA","CCCCATCTCTATTAAATATACAAAAAAATAGCTGGGTGTGGTGGTGTGCGCCTGTAATCCCAGCTACTTGGGAGGCTGATGCAGGGGAAGTGCTTGAACCAGGGAGGTGGAGGTTGCAGTGAGCCGGAATCGTGCCACTGCACCCCAGTCTGGGCAACAGATTGAGACTCTGTCTCAAGGAAAAAAAAAAAAAAAAAA"
"GL873566","8592056","8592127","chr10","28805224","28805297","15","20213168","TCTTGCCTGTAATCTCAGCACTCTGGGAGGCTGAGGCAGGCAGATCAACTGAGCTAACAAGTTCGAGACCAG","GTGGCTCATGCCTGTAATCTCAGCACTTTGGGAGGCTGAGGCAGGCAGATAACCTGAGGTCAGGAGTTCGAGAC"
"GL873566","8809109","8809200","chr11","48033118","48033204","26","39224009","ATAGCCAGGCTTGTTGCAGGCACCTGTAGTCCCAGTTACTCTGGAGGCTGAAGCAAGGGAATATCTTGAGCCCAAGAGTCTGAGGTTGCTGT","TTAGCCTGGCATGGTGGTGACACCTGTAATCCCAGCTACTCAGGAGGCTGGGAAGGAAAATCGTTTCAACCCAGGAGGCAGAGTTTG"
"GL873566","8809477","8809608","chr19","10830410","10830544","33","2020933","GGCCAGGCGCAGTGCCTCATGCCTGTAATCCTAGAACTCCGGGAGGCTAAGGAGGGTGGATTTCCTGAGTTCACAGGCTGGAGACCAGCCTGATCTAGAGTGAGATTCCCAGCTCTAAAAATAGCTGGCCTT","GGCCAGGTGCAGTGGCTCATGCCTGTAATCCCAGCACTTTGGGAGGCCAAGGTGGGTGGATCACCTGAGGTCAGGAGTTCGAGACCAGCCTGATCAACGTGGTGAAACCCCATCTCTACTAAAATTGCAAAATTA"
"GL873566","9503716","9503881","chr12","63241189","63241340","56","53737473","TATTAAAAAAAAAAGGAATTCAAGGCCAAGAGCAGTGGCTTTTGCCTGTGATACTTCCACTGTAGGAGGCCGAGGTGGAAGGATCACTTGAACTCTGGAGTTTGAGGTTGCTGTGATCTAGGCTGACACCACAGCACTCTAACTTGGTGGGCAACAGAGCAAGACT","AAAAACAAAAATTAGCCAGGTGTGTTGGCATGCACCTGTAGTCCCAGCTACTAGGGAGGCTGAGACAGAAGAATCACTTGAACCCAGGAGGTGGAGGTTGAGTGAGCCAAGATCGCGCCACTGCACTCCAGCCTGGGTGACAGAGCGAGACT"
"GL873566","9537883","9537992","chr16","43341998","43342113","30","33804115","ATGCCTGTAATCCTAGCACTTGGGAGGCCAAGGTGGGTGGATTGCCTGAGATCACAGGTTCAAGACCAGCCTGAGCCAGAGTGAGACCCTGCCTCTAAAATGAGCCAGGT","GCCTGTACTCCCAGCACTTTGGGAGGCCAAGGCGGGTGCATCACCTGAGGTCAGGGGTTCAAGACCAGCCTGGCCAACATGGTGAAACTCTGTCTCTACTGAAAATTCAAAAAATT"
"GL873566","9538266","9538462","chr7","167658032","167658223","54","158119766","TTAATTAATTAATTAAATAAAATGAGCCAGGTGTTGTGATGGGCGCCTGTAGTCCCAGCTACTTGGGAGGTGGAGGCAGGATAATCACTTGAGTCCAGGAGTTGGAAGTTGTTGTGAGCTGTGACGCCATTGTACTTGACCCAGGGCGACATCTTGAGGCGCTCTCTCTCAAAATAAATAAATAAAGAAAGAAAGAA","TACTAAAATACATACAAAAATTAGCCAGGTATGGTGGCAGGCCCCTGTAGTCCCAGCTACTCGGGAGGCTGAGGCAGGAGAACTGCTTGAACCCAGGAGGTGGGGATTGCAGTGAGCTGAGATCGCACCACTGCACTCCAGCCTGAGCGACAGAGTGAGACTCTGTCTCAAAAATAAAAAAAGAAAAAAAAA"
"GL873566","13663722","13663916","chr1","23558411","23558571","70","9894689","CTCAAGACCAGCCTGAGCCAAGAACGAGACTGAAAATAGAAAAATTAGTGGGACGTTATGTTGAGTGCTGGCTACTCTAGAGGGTGAGGTAGGAGAATTGTTTAAACTCATGAATTTAAGGTTGCTGTGAGCTAGGCTGACGCCACAGCACTGTAGCCTGGGCAACAGGCTACAGAACAGAGTGAGACTCTGTTT","AAAAATACAAAAATTATCTGGGCATGGTGGTGGGTGCCTGTATTCCCAGCTACTCTGGAGGGTGAGGCGGGAGAATTACTTGAACCCAGGAGGTGAAGGTTGCAGTGAGCCAAGATCACGCCACTGCACTCTAGCCTGGGCAACAGAATGAGACTCTGTCT"
"GL873566","13664206","13664293","chr7","151280825","151280914","17","137616619","GGCTAGATATGGTGGCTCATGCCAGTAATCTTAGCACTTTGGGAGGCTGAGGGGAGAGGATCACTTGAGCTGAAAAGTTCAAGACCAA","GGCCAGGCATGGTGGCTCATGCCTGTAATCCCAACACTTTGGGAGGCTGAGGTGGGTGGATCACTTGAGGCCAAGAGTTCAAGACCAGCC"
"GL873567","8375378","8375469","chr3","123612391","123612479","29","115237013","GGTTGGGCTTGGTGGCACGTACCTATGATCATCCTAGCTACTCAGGGAGCATAAGGCAGAAGAATTGCTTTAGCCCGGGAGTTGAGATCAAC","TTAGTTGGGCGTGGTGGCGCATGCCTGTAATCCCAGCTTCTCGGGAGGCTGAGGCAGGAGAATGGCTTGATCCCAGGAGATAGAGGTTG"
"GL873567","9062667","9063009","chr7","6620384","6620702","97","2442283","GGCCAGGCGTGGTGGCTCACGCCTGTTGTCTCAGCGCTGTGGGAGGCCGAGGCGGGTGGATCGCCTGTGCTCAGAGGTTCGAGACCAGCATGAGCCAGAGTGAGAGCCAGAGTAAGACCCCCTCTCTACCAAAAATTGCTGGGTGTTCTGGCAGGTGCCTGTAATTCCAGGTACTTGGGAGGCTGAGGCTAGAGAATCACTTAAACCCAGGGACCCAGGGGTTGGCGGAGGTTGCTGTGAGCTATGATTCTATGGTATTCTACTGAAGGACACAAAGCGAGACTCTGTCTCCATAAATAAATAAATAAATAAATAAAATAAAAGCAAAATTAAAAAAAAAAAA","GGCCAGGCACAGTGGCTCATGTCTGTAATCCCAGCACTTTGGGAGGCCGAGGCGGGTGGATTACCTGAGGTCAGGAGTTCTAGACCAGCCTGGCCAACAAGGCGAAACCCTGTCTCTACTAAAAATACAAAAAATTAGCTGGGCGTTTTGGCACATGCCTGTAATCCCAGCTACTTGGGAGGCTGAGGCAGGAGAATTGCTTGAACTGGGGAAGTGGAGGTTGCAGTGAGCTGAGATCACACCATTGCACGCCTGAGCAACAGAGCGAGACTCTGTCTCAAAAAAAAAAAAAAAAAAAAAAAAGAAAAGAAAAAGAAAA"
"GL873567","11215752","11215787","chr1","62915138","62915167","12","51699386","CAATAAAGCAAGACTCTGCCTCCAAAAGAAAAAAAA","CAAACAAACAAACATCACAAAAAAAGAAAA"
"GL873567","11215868","11216117","chr8","45194211","45194474","73","33978343","GGCTGGGTGTGATGGTTCAGGCCTGTAATCCCAGCGCTCTGGGAGACCAAGGCAGGATAGCCTGAGGTTAAGAGTTTGAGACCAGCCTGAGCAACACAAGACCCTGTCTAAACCAGGAAAATTACTGGGGTGTGGTGGCGTGTGCCTTAATCCCAACTACTCAGGAGGCTAGAGTATTGCTTGAGGGCAGAAGACTGAGGTTGCTGTGAGGAAAGGCTAAGGTCAAGCCATTCTAGCCCAGGCAATAGAG","GGCCGGGTGTGGTGGCTCATGCCTGTAATCCCAGAACTTTGGGAGGCCAAGGCAGGTAGATTACCTGAGGTCAGGAATTGGAGACCAGCCTGGCCAACATGGTGAAACCTCTTCTGTACTGAAAATTACCTGGGCATGGTGGCACACGCCTATAATCCCAGCTACTCAGGAGGCTGAGGCAGAATTGCTTGAGCCCGGGAGACAGAGGTTGCAGTGAGCCAAGATCGTGCCACTGTCCTCCAGTCTGGCCAACAGAGCAAGACT"
"GL873567","12342574","12342696","chr3","166690011","166690120","46","154347437","GTACGCGCAAACCAGAAAAATCAACTAGGTGTGGCAGGGCACACCTGTAGTCCCAGCTACTGGGGAGGGTGAAGCAAGAGATTGCTCAAGTCTGAGGTTACAGTGAGTTAAGATGATACCACT","TACACATACAAAAAATCAGCTGGGTGTGGTGGTACATGCCTGTAATCCCAGCTACTCAGGAGGCTGAGGCCGGAAAATCACTTGAACCCAGGAGGCAGAGGTTGCAGTGA"
"GL873567","12342734","12342873","chr8","96368294","96368428","43","84025560","GGCCAAACACAGTAGTTTATACCTATAATTCCAGCACTCTGGGAAGCTGAAGCAGAAGGATCAGCTGAGGTCAGGAGCCTCAAGACAAGCCTGGGCAAGACTAAGACTCCCCTCCATCCCTTCCCCCACTGTCTTCTCAC","GGCCAGACACAGTGGCTCACACCTGTAATCCCAGCTCTTTGGGAGGCTGAGGCAGGCGGATCACCTGAGGTCAGGAGTTCAAGACCAGCCTGGCCAACATGGTGAAACTGCATCTCTACTAAAAATATAAAACCA"
"GL873568","4322030","4322103","chr11","54983169","54983243","11","50661139","GGCCAGGCGCAGTGGCTCATGCCTTTAATCATAGCACTCTGGGAGGCTGAGGTAGGCGGATCTCCTGAGCCAGG","GGCCAGGTGCAGTGGCTCATGCCTGTAATCCTAGCACTTTGGGAGGCCGAGGTGGACCGATCACCTGAGGTCAGG"
"GL873568","4439574","4439747","chr7","26745376","26745549","54","22305802","GGCTGGGCATGGTGCTCACACCTGTAATCATAGCACTCAGGGAGGCCGAGGTGAGTGGATTGCCAGAGCTCACAGGTTTGAAACCAGACAGAGCCTTTTTTTTTTTAGAAGAAATTGTAGGCTGGGCATGGTGCTCATACCTGTAATCATAGCACTTGGGAGGCCAAGGCAAGA","GGCTGGGCATGGTGGCTCACGCCTGTAATACCAGTACTTTGGCAGGCCGAGGCGGGCAGATCACCTGAGGTCAGGAGTTCAAGACCAGCCTGGCCGTTTCTACTAAAAATACAAAAAATTAGCTAGGCATGGTGGTGCGCACCTGTAATCCCAGCTACTCGGGAGGCTGAGGCA"
"GL873568","4546898","4547014","chr15","31980678","31980795","24","27433780","GGCAGGGTGTGGTGTACACCCCTATAATCCCAGCACTTTGGGAGGCTAAGGCAGGAGCATCACCTGGGGCAGGAGTTCAAGGCCAGCCCGGAGAACAGAATGAAACTCCATCTCCAC","GGCAGGGCGTGGTGGCTCACGCCTCTAATCCCTGCACTTTGGGAGGCCAAGGCAGGCAGATCACCTGAGGTCAGAAGTTCAAGACCAGCCTGGCCAATGTGGTGAAACCCCATCTCCA"
"GL873568","5509331","5509406","chr12","122182458","122182528","25","116673127","TAATCCTAGCACCCTAGGAGGCCCAGGTGGGTGGATTACCTGAGCTCAGGAGTTCAAGAGCAAAAGTGAGACCCCT","CCCAGCACTTTGGGAGGCCAAGGCAGATGGATCACCTGAGGTCAGGAGTTGAAGACCAGCCTGGCCAACAT"
"GL873568","5509687","5509883","chr11","2904691","2904882","40","2604996","GTGAGACCCTTGTCTCTACTAAAAGTAGAAAAACTAGCCAGGTGTTGTGGCAGGTGCCTGTAATACCAGCTACTTAGAAGGCTGAGGCAGGAAGATCAGTTGAACCAAAGAGTTTGAGATTGCTGTGAGCTATGATGAAGCCACAGCACTCTACTATCCAGAGCGACAGAGGGAGACTCTGTCTCCAAAAAAAAAAA","GTGAAACCCTGTCTCTACTAAAAATACAAAAATTAGCCAGGTGTGGTGGTGCATGCCTGTAATCCCAGCTACTCAGGAGGCTGAGGCAGGAGAATCACTTGAACCCAGGAGGTGGAGGTTGCAATGAGCCAAGATCGTGCCACTGCACTCCAGCCTGGGTGACAGAGCGAGACTCCATCTCAAAAAAAAAAA"
"GL873568","7119774","7119822","chrX","41233833","41233871","13","34114059","AAAAGTAAAAAATGAGCCGGGTGAGGTAGCTCACGCCTGTAATCCCAGC","AAATCAGCCGGGTGTGGTGGCTCACGCCTGTAATCCCAG"
"GL873568","10881797","10881967","chr1","164648998","164649168","46","153767201","AAAATCACATATTTGCCTGGCATGTTGACTCATGCCCCTATGATCCTAGCACTCTGGGAGGCTGAGGCAGGAGCCTCACTTGAGTCTGTGAGTCTGAGGTTGCTATGAGCAAGGCTGATGCCATGATACTCTAGTGTGGTACAACAGAGTGAGACTCTGTCTCAAAAAAAA","AAAAACACATATTAGCTGGGTATGGTTGTGCGTGCCTGTAATCCCAGCTACTTGGAAGGCTGAGGCAGGAGAATCACTTGAACCCGTGAGGCGGAGTTTGCAGTGAGCTGAGATTGTGCCACTGCACTCCAGCCTGGGCAACAGAGCAAGACTCTGTCTCAAACAAACAAA"
"GL873569","1403943","1404082","chr2","53765152","53765289","48","52361209","AAGCTGAAGCAGAAAAACGGGCTAGAGGTCAAAAGTTTGAGACCTACCGTGGCTACACAGCAAAACTCTGTCTCTAAAAAAAATAAATAAGACCAGGTAAGGTGGTCATGACTATACTCCTAGCCCCTTAAGAGGCTGAG","GAGGTGGGTGGATCACCTGAGGTCAGGAGTTCCAGAACAGCCTGGTCAACATGGCGAAACACTGTCTCTACTAAAAATACAAAAATTAGCCAGGTGTGGTGGCATGCACCTGTAGTCCCCGCTACTCAGGAGGCTGGG"
"GL873569","7343422","7343556","chrX","124155286","124155406","55","116811864","TTTGAAAGTAGACTGCAAACATCATGTTGCTTCACCTCTAAATATATTAATATGGGCCAGGTGCAGTGGATCATGCCTGTAATCCTAGCACTTGCTAGGCCAAGGCTGGCGGATAGCCTGAGCAACAGCGAGACC","ATCAGCCTGACCAACATAGTGAAACCCCATCTCTACTAAAAATGCAAAATTAGCTGGGCGTGGTGGTGCATGCCTGTAATCCCAGCTACTTGGGAGGCTGAGGCGGGAGAATCACTGGAAC"
"GL873569","7404564","7404762","chr6","586928","587122","48","6817636","GAGATCCCATCTCTTAATGAAAATAAAACAATTAGCTGCTATTGTGGCAGGCACCTGTAATTCCAGCAACCCAGGAGGCTGAGGCAGGAGGATCACGTGAACCCCACCAGTTTGAGGTTGCTATGAGCCAGGCTGATGCCAGGACACTCCAGCCTGGGCAACGGAGTGAGACTCCATCTCCAAAAAAAGCAAACAAAAA","GAAACCCCATCTGTACTAAAAACACACAAATTAGTGGGATGTGGTGGCACGTCCCTGTAATCCTAGCTATTCAGGAGACTGAGGCAGGAGAATCACTTGAACCCAGGAGGTGGAGGTTGCAGTGAGCCGAGGTCACACCACTGCACTCCAGCCTGGGCAGCAGAGTAAGACTCCATCTCAAAACAAAAACAAAAA"
"GL873569","7405040","7405133","chrX","21386588","21386682","29","13981548","GGGCAGGGCGGCTCAGGCCTCTAATCCTAGCACTCTGGGAGCTTCCTTGAGCTCAGGAGTTCAAGACCATCCTAAGCAACAGAGATCCCATCTC","GCTGGGCACGGTGGCTCACGCCTGTAATCCCAGCACTTTGGGAAGCCAAGGTTTGAGGTCAGGAGTTCAAGACCAGCCTGGCCAACAGGCTGCAA"
"GL873548","15249374","15249463","chr5","46485072","46485159","19","31235698","GGCCAGGCATGGTGGCTCATACCTATTGTCCTAGCACTGTGGGAAGCCAAGGCAAGTGGATCACCTGAGCTCTAGAGGTTCGAGACCAGC","GGACAGACACAGTGGCTCATGCCTGTAATCCCAGCAGTTTGGGAGGCCAAGGCAGGTGGATCACCTGAGGTACAGAGTTCAAGACCAG"
"GL873548","15817199","15817306","chr7","158031905","158031997","37","142214706","AAAAAAAAAGAGTTGGAGGTTGCTATGAGCAACATCAGCATGGCACTCAATTCCAGGGTGACTGACTGAGACTGTTGTAGCTATACTCCAAAAAAAAAAACACACAAA","CCAGGAGGTGGAGGTTGCAATGAGCCAAGATCACACCACTGCACTCCAGCCTGGGTGACAGGGTGAGATTCTGTCTCAAAAAAAAAAAAAAAA"
"GL873548","15817589","15817786","chr3","3025868","3026088","60","12791721","GGCCAGGCATGGTGGCTTCTGTAATGCCAGCATTCTGGAAGGCTGAGGTAGGCAGTAGCTTGAGCTCAGTAGGAGAACAGCCTGACCAAAAGTGAGACCCTGTCTCTAAAAATAGTCGTTTGTGGTGGTTACCTGTTGTCCCAGCTACTAGGGAGGCTGAGGCAAGAGAATCACTTGAGCGTAAGAGTTGGAGGTTGC","GGCCAGGCACGGTGGCTCATGCCTGTAATCCCAGAACTTTGGGAGGCTGAGGTGGGCAGATCACCTGAGGTCAGGAGTTGGAGACCAGCCTGACCAACATGGTGAAACCCTGTCTCTACTAAAAATACAAAATTAGCCAGGTGTAGTGGCACGTGCCTGTAATCACAGCTACTTAGGAGGCTGAAGTAGGAGAATCACTTGAACCTGGGAGGTGGAGGTTG"
"GL873548","15856498","15856605","chr18","35090078","35090171","38","19233580","CCCCCCCCAAAAAGAAAAGGGTTGCTTGAATCTAGGAGTTTGGGGTTGCTGTGGGCTAAGCTGATACCACAGCACTTTAGCCTGAGCAAACAGAGTGACACTCTGTCT","AAGCAGGAAATCGCTTGAACCCAGGAAGCAGAGTTGCAGTGAGCCAAGATCGCACCACTGCACTGCAGCCTGAGCAACAGAGAAAGACTCTGTC"
"GL873548","15856683","15856877","chr3","3200882","3201085","53","12655801","GCCAGGCACAGTGGCTCATGCCTATAATCCTAGCACTCTGGGAGGCCAAGGCAGGATTGTCTAAGCTTGGGAGTTTGACAGCAGCCTGAGAAAGATTGAGACCCCTGTCTCTACTAAAAAATAGAAAAATTAGCTGAGTGTTGCAGCAGGTGCCTGTATTTCCAGCCAAGGGGGAGGTTGAAAAGGGTCGCTTCA","GGCCAGGCGCAGTGGCTCATGCCTGTAATCCCAGCACTTTGGGAGGCCGAGGCGGGTGGATCATAAGGTCAGGAGTTTGAGACCAGCCTGGTCAACATGGTGAAACCCCATCTCTACTAAAAATACAAAAATTAGCTGGGTGTTGTGGCACATACCTGTAATCCCACCTACTCAGGAGGCTGAGGCAGGAGAATCACTTGAACC"
"GL873549","1940307","1940608","chr12","9481260","9481565","74","7540953","GGCTGGGCGCAGGGGCTCATGCCTGTGACCCTAGCACCCTGGGAAGCCAAGGCGGGCAGATCGCCTAAGCTCACGAGTTTGAAACCAGCCTTAGCTAGAGTGAGACCCCCAATACTAAAAAAATAGCCAGGCTTTGTGATGGGCGCCTGTAGTCCCAGCTACCTGGGAGGCTGAGGCAAGAGAATGGCTCAAGCCCAAGAGTCTGAGGTCACAGTGAGCTACTGACGCCACCGCACTCTATTGGAACAACAAAGTGAGACTGTGTCTCAAACAAACAAACAAACAAACAAACAAAAAAGAAA","GCTGGGCGCGGTGGCTCATGCCTGTAATCCCAGCACTTTGGGAGGCCAAGGCAGGTGGATCACCTGAGGTCAGGAGTTCGAGACCAGCCTAGTCCACATGGTGAAACCCCATCTCTACTAAAAACTAGCCAGGCGTGGTGGTGCGCACCTGTAATCCCAGCTACTCGAGAGGCTGAGGCAGGAGAATCACTTGAGCCTAGGAAGCAGAGGTTGTGGTGAGCTGAGATCACACCACTGCACTCCAGTCTGGGCGACACAGTGAGACTCTTGTCTCAAAAACAAAAAACAAACAAACAAACAAACAAA"
"GL873549","2657819","2658019","chr11","18547798","18548000","50","15889979","GGCCTGGCACTGTGGCTCACACCTGTCAGGTTAACACTCTGGGAGGCTGATATGGGTGGGTCTCCTGAGTTTAGGAGTTTAAGACCAGCCTAATCAAGAGTAAGACCTGCCTTTACTAAAAATAGAAACACTCACCAGGACTACTGTGCACCTACAGTCCCAGCTACCTGGGAGGCTGAGGCAAGAGGATTGCTCAAGCCC","GGCCAGGCACTGTGGCTCACACCTGCAATCCCACCACTCTGGGAGGCAGAGGCAGGTGGATCACCTGAGGTCAGGAGTTTGAGACCAACCTGGCCAACAGAGCAAAACACTGCCTCTACTAAAAATACAAAAACTAGCCAGGTGTGGTGCATGCCTATAGTCCCACCTACTTGGGAGGCTGAAGCAGGAGAATCTCCTGAGCC"
"GL873549","8853848","8853952","chr12","88112976","88113081","32","79259128","AGCCAGCTGTGTGGCTCATTCCAGTAATTCCAGTTACTGGGGAGGCTGAGACAGGAGGATCACTTGAATGCAAGAGGTGGCGAGAACTCAGCTTTAAAAATAAAA","GGCCAGATGCAGTGGCTCATGCCTGTAATCCCAGCACTTTGGGAGGCTGAGGCAGGCGGATCACCTGAGATCAGGAGTTTGAGACCAGCCTGGCCAACATGGTAAA"
"GL873549","10378794","10378882","chr20","18199749","18199840","17","7820955","GGCCAGGCACGGTGGTTCACCTGTGATCCCAGCACTCTGGGAGATAAGGCAGGCTGATCACCTGAGTTCACAGGTTGGAGACCAGCCTG","GGCCGGGCATGGTGGCTCACACCTGTAATCCCAGCACTTTGGGAGGCTGAGGCAGGCGGATCACCTGAGGTCAGGAGTTCGAGACCGGCCTG"
"GL873549","15488169","15488282","chr10","38476693","38476794","41","22988524","CTGAGCACACGGGTTCACACCTGTAATCCCAGCACGCTGAGAAGCCCAGGCAAGAGGCTGACCTCCAGCCTGGGTGACGGAGCGAGATTCCCCCCCACCCCCGACCAAAAAAAA","CTGAGCGCTGGTAGCTTACACCTGTAATCCCAGCACTTTGGGAGGCCTAGACAGGCGGATCACTTGGGGTCAGGAGTTTGAGACCAGCCTGGCCAATATGAT"
"GL873549","17403348","17403519","chr10","38461164","38461337","46","21057816","GCCAGGCACAGTGGCCCACACCTGTAATCCCAGTACTGTGGGAGGCTGAGGCAGGCTGAGGCAGGCATGGATCACTGAGGTTGCTGTGAGCTAAGATGCCATGGCCCTCCACCCAAAGTGACAGAGTGAGACTCTGTCTCAGAATTAAAAAAAACAAAGAAAGAAAAATAAA","GCCAGGCATGGTGACTCACGCCTATAATCCCAGCACTTTGGGAGGCTGAGGCATGAGAATCACTTGAACCCAGAAGGCAGAGGTTGCAGTGAGCTAAGATTGTGCCACTGTACTCCTGCCTGGGTGATGGAGTGAGACTCTGTCTCGATTTAAAAAAAAAAAAAAAAAAAAAAA"
"GL873550","801968","802043","chr15","50500527","50500602","20","49698559","GTAGCCAGGTATGGTAGTGCAGGCCTGTACTCCCAGCTACTTGGAAAGCTAAGGCAATAGAATCATTTAAGCCCAG","TGGCCGGGCATGGTGGTACATGCCTGTAATCCCAGCTACTTGGGAAGCTGAAGCAGGAGAATTGCTCGAACCCAGG"
"GL873550","802343","802376","chr3","33494224","33494257","9","32691881","TAAGACTTTGTCTCTACTAAAAATAGAAAAAGTG","GTGAAACCCGTCTCTACTAAAAATACAAAAATTA"
"GL873550","2805841","2805900","chr2","93673843","93673900","18","90868002","CTATTCAAAATAGCTAAAATGGGCAGGGCAAGGTGGCTCACACCTGTAATCCCAGTACTC","TAAAAATGTAAAAGATTGGCCGGGTGTGGTGGCTCACTCCTGTAATCCCAGCACTTTG"
"GL873550","4153085","4153214","chr16","18855701","18855834","37","14702616","GGCAGGGCTTGGTGGTAAAAGCCTGTAATCCTACCACTCTGGGAGGCAGAGGTGGTTAGATTGCATGAGGTCACTGGTTGGAGACCAGCCTGAGCTAGAGCAAGACCTCATCTCCAAAAATAGCAGGGCT","GGCTGGGCGCGGTGGCTCACACCTGTAATCTCAGCACTTTGGGAGGCCGAGGTGGGTGGATCACCTGAGGTCAGGAGTTCGAGACCAGCCTGGCCAACATGGCAAAACCCCATCTCTACAAAAATACAAAATTA"
"GL873550","4153472","4153634","chr7","17472856","17473028","43","13319384","AATAAAAATAGCAGGGCTTTGTGGCGGGCACCTGTAGTCCCAGCTACTTGGGAGGCTGAGGCAAGACAATTGCTTGAGCACAAAGTTGGAGGTTGTTGTGAGCTGTGACATCATAGCACTCTACCAAGGGAGATAGAGTGAGACTATCTCGAAGAAAAAAAAA","ATACAAAAATTAGCCAGGTGTAGTGGCGTGCACCTGTAATCCCAGCTACTCGGGAGGCTGACGCATGAGAACTGCTTGAACTCAGGAAGTGGAGGTTGCAGTGAGCTGAGATAGTGCCACTGCACTCCAGCCTGGGTGACAGAGCAAGACTCCATCTCAAAAAAAAAAAAGAA"
"GL873550","6050671","6050965","chr7","84009904","84010193","74","77959233","GGTGGCTCACGCCTGTTATCCTAGCACTCCAGGAGACTAAGGTAGGAGGATGCCTTGCTTGAACTCAAGAGTTCAAGACCAGTCTGAGTGAGAGGGAGACCCTGCGTCTACTCAAAAATAGAAAAATTTACCAGCCATTGTGGCCAACACCTGTAGACCCAGCTATTCAGGAGTCTGAGGCCAGAGAATCACTTGAACCCAGGAGACTGAGATTGCTGTGAGCTAGGCTAAAACCATGGCACTCTAGCCCAGGTGGCAGAGTGAGACTGGGTCTGCAAAAAATAAATAAAAACAA","TGGCTCATGCCTGTAATCCTAGCACTTTGGGAGGCCAAGGCAGGTGGATTGCCTGAGCTCAGGAGTTCAAGACCAGCCTGGCAACACGATGAAACCCCGTCTCTATTAAAAAATACAAAAAATTGGCCAGGCATGGTGGTGTGCACCTGTAATCCCAGCCACTCAGGAGGCTGAGGCAGGAGAATCGCTTGAACCCGGGAGACAGAGGTTGCAGTGAGCCAAGATCGAACCATTGCACCCCAGCCTGGGTGAGAGTGAGACTCTGTCTAAAAAAAAAAGAAGAAAAAGAA"
"GL873550","6212004","6212068","chr19","50425309","50425373","23","44213305","AGAACCTAAGAGTTTTGAGGTTGCTATGAGCTGGACTGATACCATAGCATTCTAGTCTGGGTGAC","TGAACCCAGGAGGTGGAGGTGGCGTGATGCCCAAGATGTGCCACTGCACTCCAGCCTGGGTGATA"
"GL873550","6212319","6212418","chr17","89042086","89042197","34","82829767","CTGTCTTTTCTAAAAATAGAAAAACTAGCTGGGTTGTGGTGGGCACTTGTAGTCCTAGGTACTCTGAGGCTGAAACAGGATTGCTTGAACCTAAGAGTTT","GTCTCTACTAAAAATACAAAAATTAGCCGGGCATGCTGGTGGGCACCTGTGATCTCAAGCTACTTGGGAGGCTGAGGCAGGAGAATCACTTGAACCTGGGAGGCAGAGGTTG"
"GL873550","6504310","6504401","chr19","2969698","2969794","27","3534612","GTGCTGGTGTATGCACCTGTCATACCAGCTACTCCTGAGGTTGAGGCAGGATAGCTTGAACCCGGGAGTCTGAGACTGCAGTGAGCTGGGAT","TTAGGCGTGGTGCATGTCTGTAATCCCAGCTACCCGAGAGGCTGAGGCAGGAGAATCACTTGAACCTGGGAGGCGGAGGTTGCAGTGAGCCGAGATC"
"GL873550","7178331","7178523","chr19","40691105","40691269","60","33512774","GGCCAGACGCGGTGGCTCACGCCTGTTGTCCCGGCACTGTGGGAGGCCGAGGCTGGTGGATCCCCTGAGCTCAGCCAAGTTCAAGACCAGCGGAAGACCAGCATGAGGCAGAGTGAGCCAGAGTGAGACCCCGTCTCTACAACAACAACAACAAAAAATAGCCGGACCTTGTGATCCCAGCTACATGGGAGGC","GGCCGGGCATGGTGGCTCACGCCTGTAATCCCAGCACTTTGAGAGGTCGAGGCAGGTGGATCACCTGAGGTCAGGAGTTCGAGACCAGCCCGGCCAATATGGTGAAACCCCTTCTCTACTAAAAATACAAAAAATTAGCCGGAAGTGGTGGCATGCACCTGTGAT"
"GL873550","7981631","7981790","chr6","148611209","148611366","40","140629578","ATAGCCCCGCCTTGTGGTAGGCTCCTGTAGTCCCAGCTACTTGGGAGGCTGGGGCAAGAGAATCACTTAGGCCCAAGAGTTGGAAGTTGCTGTGAGCTGTGATGCTACAGCATTCTACTGAGAGTGACAAAATGAGACTCTGTTTAAAAAAAAAAAAAAA","TTAGCTGGGCATGGTGGCAGGTGCCTGTAATCCCAGCTACTCTGGAGGCTGAAGCAAGAGAATCGCTTGAACCCAGGAGGTGTAGGTTGCAGTGAGTCGTGCCACAGCACTCCATCCTGGGTGACAGAGCAAGACTCTGTCTCAAAAAAAAAAAAAAA"
"GL873550","7982053","7982180","chr2","182489403","182489528","28","174507350","GGCTGGGCGAGGTTGTTCAGACCTGTAATCCTAGCACTCTGGGAGACCAAGATGGGTGGATTGCCTGAGTTCATGAGTTTGAGACCAGCCTGAGCCAGAGTGAAACCTTGTTCTCTAAAAATAGCTCG","GGCCGGGTGTGGTGGCTCATGCCTGTAATCCTAGCGCTTTGGGAGGCCGAGGTGGGTGGATTGCCTGAGCTCAGGAGTTCGAGACCAGCCTGGGCAACACGGTGAAACCTGTCTCTACTAAAATAC"
"GL873550","8404122","8404320","chr4","121405930","121406135","43","113001808","GGCCAGGCACAGTGACTCACACCTGAAATCTTAGTACTCTGGGAGGCCAAGGTGGGAGGATTTCCTGAGGTCAGGAGTTCAAGACCAGCCAGAGCAAGAAGATCCTGTCTCTACTAAAAGTATAAAAAGTGAACCAAGTGTGGTAGTGAGCACCTATAATCTCAGCTACTTGGGAGGCCGAAGCAAGAGGATCACTTGA","GGCCAGGCACAGTGGCTCACACCTGTAATCTCAACACTTTGGGAGGCCAAGGTGGGTGGATCACCTGAGGTCAGGAGTTTGAGACAAGCCTAGCCAGCATGGTATAACTCCATCTCTACTAAAAGTATAAAAATCAACCAGGTGTGGTGGCACATGCCTGTGGTCCCAGCTACTTGGGAGGCTGAGGCAGGAGAATCACTTGAATC"
"GL873550","8404408","8404483","chr15","701469","701538","22","7702939","AGGATCTCTTGAGCTCGGGAGTTTGAGGTTGCAGTGAGCCAGGCTGATGTCATGGCACGCTACCCAAGACAACAAA","AATCACTTGAACCCAGGAGGCAGAGGTTGCAGTGAGCCAAGACTGTGCCATGGCACTCTAGCCTGGGCAA"
"GL873550","11648593","11648682","chr3","124881947","124882027","31","113233354","GTGGCTCACACTAGTAATCTTAGTACTTTGGGAAGCTGGGGCAAGAGGATCACTTGAGGTCAGGGTTAGGAAACTCTATCACTACAAAAA","GCGGTGGCTCACGCCTGTAATCCTAGCACTTTGGGAAGCCAGGCAGGCAAATCACGAGGTCAGGAGTTCGAAACCAGCCTG"
"GL873550","12468624","12468663","chr9","62916303","62916339","11","50447679","GCCCGGCTTGGTACCTCATGCCTGTAATCTTAGCACTCCG","GGCCGGGCATGGTGGCTCATGCCTGTAATCCCAGCAC"
"GL873550","12468943","12469188","chr12","70524409","70524645","91","58055466","AATCTTAGCACTCCGGGAGGCCGAGGCGGGTAGACCAACCTAATCAAGAGCAAGATCTACCTCTACTAAAAATAGAAAAGAATTGGCCAGGCGTATTGACTCCGCCTCTAGTGCCAGCTACTCCAAAGCTGAGGCAAGAGGATTGTTCAAATCCAAGAGTTTGAAATTGCTGTATGTTACACCAGGGCACTCTAGCCGTGGAGACATTTTCTCTATATATATTAAAAAAAACAAAAAACAGAAAAA","CTGAGCTCGGGAGTTCGAGACCAGCCTGACCAATATGGAGAAACCCTGTCTCTACTAAAAATGTAAAATTAGCCAGGCATGGTGGCACATGCCTGTAGTCCCAGCTACTCAGGAGGCTGAGGCAGGAGAATCGCTTGAGGTCAGGAGGCGGAGGTTGCAGTGAGCCAAGATCATGCCACTGCACTCCAGCCTGGGTGACAGAGTGAGACTTTGTCTCAAAAAAAAAAAAAAAAAAAA"
"GL873550","14719674","14719880","chr16","30390993","30391163","76","15671319","GGGCGTGGTTGCTCACGCCTGTTGTCCCAGCGCTGTGGGAGACCGAGGCAGATGTATCGCCTGAGCTCAGCCGAGTTCGAGTTCGAGACCAGCGGAGAGACCACCATGAGGCAGAGTGAGCCAGAGTGAGACCCCGTCTCTACAACAACAACAAAGAAAACAGCCGGATCTTGTGATCCCAGCTACATGGGGGCCAAGAGAATCACT","GGGCACGGTGGCTCACACCTGTAATCCCAGCACTTTGGGAAGCCAAGGCAGGAGGATCACCTGAGGTCAGGAGTTCAAGACCAGCCTGGCCAACATGGTGAAACCCCGTCTCTACTAAAAACACAAAAATTAGCCAGGTGTGGTGGTGCACGCTTGTAATCCCAGCTACTC"
"GL873550","15737883","15738154","chr2","20481557","20481833","73","4743674","TTAGCATTCTGGGAGGCCAAGTCAGGTGGATTGCCTGAACTCACAAATTTGAGACTAGCCTGAGATAGAGAAAGATCTTGTCTCTAAAAAAAAAAAAAAATAGCTGGACTTTGTAGTGGGCACCTGTAGTCCCTGCTACTCAGAAGGCTGTGGTAAGAGAATCACTGGAACCCAAGAGTTAGAGGTTGCCGTGAGCTGTGATGCCATGGCACTCTACCAGAGACAACAGAGTGAGACTCTCTCCAAAAAAAAGAAAAAGAAAAAGAAAAAAA","GCACTTTGGGAGGCCAAGGCAGGTGAATCACCTGAGATCAGGAGTTCAAGACCAGCCTGGGCAACATGATGAAACCCTGTCTCTATGAAAAATACAAGAATTAGCTGGGCATAGTGGTGTGCATCTGTAATCCCAGCTACTCAGGAGGCTGAGGTATGAGAATTGCTTGAACCCTGGAGGCAGAGGTTGCAGTGAGCCGAGATGACACCGTTGCACTTCAGCCTGGACAATAGAGAGAGACTCTGTCTCAAAAAAATGAAGAAAAGAAAGAAAGAAA"
"GL873550","15738844","15738873","chr10","65896918","65896951","9","50158074","GGGTGTGGTGGCTGATGCGTGTAATCCTAG","GGCTGGGCGTGGTGGCTCATGCCTGTAATCCCAA"
"GL873550","16345151","16345329","chr1","6754007","6754209","69","9591144","CACCTGTAATCCCAGCACTTGGGAGGTTGAGGAGAGTGGATTGCCTGAGCTCACAGGTTTGAGCCAGAAGGAGACCTCGTCTGTAAAAATAGCTGGGTGTTGAGACCAGCGCCTTTAGTCCCAGCTACTTGGGAGGCTGAGGCAAGAGAATCACTTAAACAATTCTAGAAGCAGAGTTT","CTGTAATCCCAGCACCTTGGGAGGCTGAAGAGGGCGGATCACCTGAGGTCAGGAATTTGAGACCAGCCTGGCCAACATGGTGAAATCCCATCTCTACTGAAAATACAAAATTAGCTGGGTGTGGTGGTGCATGCCTGTAGTTCCAGCTACTTGGGGAGCTGAGGCAGAAGAATGCCTTGAACCCGGGAGGCAGAGGTTGCAGT"
"GL873550","17727115","17727274","chr1","127857902","127858038","52","110130787","GCTGGGTGCAGTGACCCCTGCCTATAATCCCAGCAGTTAGGAGACAAAGGCAGGAGGAATTACCTGAGAGCAGGAGTTCCAGACAAGCCTCAGACCAGCGTGAGCTATGACATTGTCTGTAGCCCCCACCCCACCCCCCCAAAAAACAAAAAGAAACAAA","GGCTGAGTTCAGTGGCGCACGCCTGTAATCCCAGCAGTTGGGAGGCTGAGGCAGGTGGATTGCCTGAGGTCAGGAGTTCAAGACCAGTCTGGCCAACATGGTGAAACTCTGTCTCTACTAAAAAAAAAAAAAAAAAT"
"GL873551","6567068","6567102","chr14","109767086","109767123","14","103200018","GGATCACATGAGGTCAGGAGTTCAAGATCAGCCTG","GGAGGCAGAGGTTGCAGTGAGCCAAGACTGCGCCATTG"
"GL873551","9393264","9393376","chr1","39198637","39198744","32","29805373","CAAGAGTATCTCTGCAACCCAGTGGCCTGAGGTTGCTATGAGCTAGGATGCCACAGCACTCTACCCAAGGGGACAGAGTAAGACTCTGTCTCCAAAAAAAAAAAAGAGCAAAA","AGAATCGCTTGAACCTGGGAGGCGGAGGTTGCAGTGAGACCAGATCATGGCACTGCACTCCAGCCTGGGCGACAGAGTAAGACTCGGTCTCAAAAAAAAAAAAAAAAA"
"GL873551","9393708","9393894","chr12","115674238","115674427","40","106280530","GCTGGGCTCAGTGCCTCTCGCCTGTAATCCCAGCACGCTGGGAGCCTGAGGTGGGTGGGTTGCTTGAGCTTAGGAGTTCAAGACCAGCCTGAACCAGAGCAAGACACTATCTCTACTAAAAATAGAAAAACTATCTGGGCATGGTGGTGCGCACCTGTAGTCCCAGCTACTAGGGAAGCTGAGGCAA","CCAGGCCTGGTGGCTCACGCCTGTAATCCCAGCACTTTGGGAGGCCGAGGTGGGTAGATCACCTGAGGTCAGGAGTTCAAGACCAGCCTGGCCAACATGGCGAAACCCCATCTCTACTAAAAATACAAAAATTAGCTGGGCATGGTGGTGTATGCCTGTAATCCCAGCTACTCGGGAGGCTGAGGCAGGA"
"GL873551","10104594","10104683","chr16","53032852","53032939","31","42928258","GGTAGGTGGGTCTCTCGAGGTTAGGAGCTCTTTACCAGCCTGAGCTGACATAAGACCCAATCTCCACCAAAATAGAGAGAGAAAAAAAGA","GAGGCAGACAAATCTCTTGAGGTCAGGAGTTGAAGACCAGCCTGGGCAACATAGACCTCGTCTCTATTAAAAAAAGAAAAAAGAAAAA"
"GL873551","12307468","12307551","chr8","94102375","94102458","19","81794907","GGCCAGGCATAGCAGCTCATGCCTGTAGTCCTATTATTCTAGGAGGTCCAGGGAGGAGGATCACCTGAGATCAGAAGTTCAAGA","GGCCAGGCATGGTGCCTCATGCCTGTAATCCCAGTACTTTGGGAAGCCAAAGTGGATGGATCACCTGAGGTCAGGAGTTCGAGA"
"GL873551","13335872","13336095","chr4","85819795","85820026","56","72483923","GCCAGGTACAGTAGCTCAGGCCTGTAATCCTAGCACACTGGGAGGCTGAGGTGGTGGATCCTTGAACTCATGAATTCAAGACCAGCCTGAGGAAGAGCAAGACCCCATCTCTCCTAAAAATAGAAAAATTAGCTGGTGTCATGGCAAGTGTCTGTAATCCCAGCCACACAGGAGGCTGAGGCAAGAGGATCTCTTGAACCCAAGACACTAAAGTTACTGGGAGC","GCCGGGCATAGTGGCTCATGCCTGTAATCCCAGCACTTTGGGAGGCTGAGATGGGTGGATCATCTGAAGTTAGGGGTTCGAGACCAGCCTGGCCAAATGGCAAAAACCCATCTCTGCTAAAAATACAAAAATTAGCCAGACATTGTGGCATGTGCCTGTAATCCCAGCTACTCAGGAAGCTGAGACAGGAGAATCGCTTGAACCCAGGAGGCAAAGGTTGCAGTGAGCCAAG"
"GL873552","1195303","1195426","chr3","54039332","54039457","34","52844029","CTACTCTGGATGCCAAGGCAGCGGGATCACTTGAACCCCAGAGTCTGAGGTTGCTGTGATCTCAGCTGACTCCATGGCACACTAGCCTGAGGCAACAGACTGAGACTATATCTCAAAACAAAAA","AGCTACTCAGGAGGCTGAGACAGGGAGAGTCACTTGAACCCAGGAGGCAGAGTTGCAGTGAGCCGAGATCACGCCAACTGCACTCCATGCCTGGGCAACAGAGTGAGACTCCGTCTCAAAAAAAAA"
"GL873552","15010293","15010428","chr1","29437872","29437991","29","14427579","GGCCGGGCGTGGTGGCTCACGCCTGTATTCCCAGCGCTATGGGAGGCCGAGGCGGGTGGATCACCTGTGCTCAGAGGTTCGAGACCAGCCAAGACCCCCCTGAGCCAAACGAGCCAGAGTGAGACCCCGTCTCTAC","GGCCGGGCGTGGTGGCTCACGCCTGTAATCCCAACATTTTGGGAGGCCAAGGCGGGTGGATCACCTGAGGTCAGAAGTTCGAGACCAACCTGGCCAACATGGTGAAACCCCTGTCTCTAC"
"GL873553","860627","860695","chr1","16024119","16024187","13","15163492","GCCAGGCTCAGTGGCTCACGCCTATAATCTTAGCGCCTTTTGGAGGCCAAGGTGGGGGGATTACCTGAG","GGCCAGGCACGGTGGCTCACGCTTGTAATCCCAGCACTTTGGGAGGCCGAGGAGGGTGGATTACCTGAG"
"GL873553","7206820","7206939","chr3","156098583","156098705","38","148891763","AGCTAGGTATGGCAGCTGACATCTGTAACCCTAGCCCTCTGGCAGGCCAGGAATTCAAGACCAGCCTAGACAACATAGTAAGACCCCATCTCTACCAAAAATAATTTAAAATTGGCCAGG","GGCTGGCTGTGGTGGCTCACACCTGTAATCCCAGTACTTTGGATCATGTGAGGTCAGGAGTTCAAGACCAGACTGACCAACATGGTGAAACCCTGCCTCTACTAAAAATACAAAATTAGCCAG"
"GL873553","10985147","10985407","chr12","94325498","94325767","64","83340351","GGCCTGTGGCAGTGGCTCATGCCTGAAATCCTAGCACTCTGGGAGGCTGAGGTGGGTCGATTACCTGAACTCACCAAGACGGAGACCTCATCTCTACTAAAAATAGAAAAACTAGCTGGGCGTGGTGGCAGGTGCCTGTAGTCCCAGTTACTGGGGAGGCTGAGGCAAGAGAATTACTTGAACCCAAGAATTTGAGGTTGCTGTGAGCTATGATGCCACAACACTCTACTCAGGGTGACGGAATAAGACCCTGTCTCAAAA","GGCCGGGTGTGGTGGCTTATGCCTGTAGTCCCAGCACTTTGGGAGGCCGATGGGGATGGATCACCTGAGGTCACTGGCCAACACAGAGAAACCCCATCTCTACTAAAAATACAAAAATTAGCCAGGCGTGGTGGCATGTGCCTATAATCCCAGCTACTTGGGAGGCTGAGGCAGGAGAATCACTTGAACCCGGTAGGCAGAGGTTGCAGTGAGCCGAGATTGTGCCACTGCACTCCAGCCTGAGTGACAGAGCAAGCCTCTGTCTCAAAA"
"GL873553","10985438","10985466","chr16","73760336","73760365","6","62774898","CATAAAAAGAAAGAAAACTGAAAAGAAAA","GAAAGAAAGAAAGGAAAAGAGAAAAGAAAA"
"GL873553","12443178","12443505","chr1","3864926","3865253","98","8578252","GCAGGGTGGGGAGGCTCGCACCTACATCCCCAGCACCCTGGAAGGCTTAGGCAGGTGGACTGGGTTCAGGAGTTGGAGAGCAGCCTGAGCAATAGTGAGATTCTGTCTGCAGTAAAACTAGAAAAATTATTTAGGGGTTGTGCTGGGTGCCTATTATCCTAGCTACTGTTGAGGCAAGGGGACAGCTTGAACCCAGGATTTTCAGGTTTCTGTGAGCTAGGATGATGCCATGATGACCCTCTGACACTTTGCCTGGGCAGTAGAGTGAAACTCTGTCTCAGAAAAAACAAAACAAAACAAAACAAAACAAACAAACAAACGAAAAAAA","GGCCAGGCGTGGTGGCTCACACCTGTAATCCCAGCACTTTGGGAGGCTGAGGCAGGTGGATCACCTGAGGTCAAGAGTTCAAGACCAGCCTGGCCAACATGGTGAAACTCTGTCTCTACTAAAAATACAAAAATTAGCCGGGCATGGTGGTGCATGCCTGTAATCCCAGCTATTCGGGAGGCTGAGGTAGGAGAATAGCTTGAACCCGGGAGGTGGAGGCTGCAGTGAGCTGAGATCATGCCATTGCACTGTAGCCTGAGCAACAGAGAAAGACTCTGTCTCAAAAAACAAAACAAAACAAACAAAAGAACAAAAACAAACAAACAAA"
"GL873553","15121135","15121247","chr1","111354387","111354508","21","96233252","GGGCGTGGTGGCTCACACCTGTAATCCCATCACTTGGGAGGCTGAGGCAGGTGGATCACCTGACCTCAGGAGTTCGAGACCAGCCTGAAGAAGAGTGAGACCCCGTCTCTAAA","GGCCGGGCGTAGTGGCTCACACCTGTAATCCCAGCACTTTGGGAGGCCGAGGCGGATGGATCACCTGAGTTCAGGAGTTTGAGACCAGCCTGACCAAAGTGGTGAAACCCCGTCTCTACTAA"
"GL873553","15121274","15121455","chr7","68420775","68420939","69","53299501","AGATTTCAACAGGCCTAATGGCTTTAGTATATAAAGAGAACTTATAAAGCCAGACTCAGTGGCTTACATCTATAATCCAGGTACTTGGTAGGTTGAAGTGAGAAGATTCTTTGAGCCAGGATTTCCAGCCCAGCCTAGGCAACACAGAGAGACCCCCATCTCTAAAAGAGAAAGGTAAAAAA","GGCTAAAGGGGTGCTCATCTTAAGAATACCAGGCCAGGCGCAGTGGCTCATGCCTGTAATCCTAGCATTTTGGGAGGCTGAGGCGGGTGGATCACCTGAAGTCAGGTGTTTGAGACCAGCCTGAACAACATAGTGAGACCTCATCTCTAATTAAAAAAAGAAAAA"
"GL873553","15614197","15614298","chr4","71691062","71691163","34","56076865","GGTGGCTCACACCTGTTATCCCCATACTCTGGGGGCCTGAGGTGAGAGGATCCCCAGAAGTCAGGAGCTGGAGAGAAGCCTGTGTAAGAGTAAGAGCCAGTC","GTGGCTCATGTCTGTAATCCCAGCACTTTGGGAGGCCGAGGTCGGTGTATCATTTGAAGTCAGGAGTTTGAGACCAGCCTGGCCAACGTGGTGAAACCCTGT"
"GL873553","16849767","16850040","chr1","96770987","96771267","68","79921220","GGCCAGGAGTGGTGGCTCATGCCTGCAATCCCAGCACTTGGGAGGCCAAGGTGGGTGGATTGCCTGAGCTCACAGGTTCAAGACCAGCATGAGCCAGAGAGAGACCTTGTCTCTAAAAATAGGCACAGGTTGTGGTGGGCACCCGTAGTCCCAGCTACTTGGGAGGCTGAGGCAAGAGAATCACTTAAGCCCAGGAGTTTGAGGTTGCTGTGAGCTAAGACACCACAGCACTCTACCAAGGGTGACAAAGTAAAACTCAGATTTTTTTAAAAAA","GGCCAGGTGTGGTGGCTCACAGCCTGTAATCCCAGTAGTTTGGGAGGCCGAGGTGAGCAGATCACCTGAGGTCAGCAGTTCGAGACCAGCCTGGCCAACATGGCAAAACCCTATCTCTACTAAAAGTACAAGGTGTGGTGGCACACACCTGTAGTCCCAGCTACTTGGGAGGCTGAGGCAGGAGAATCACTTGAACTCCAGAGGTGGAGGTTGCAGTGAGCCAAGATTATGCCACCGCATTCCAGCCTGGGTGACAGAGTGAGACTCCGTCTCCAAAAAAA"
"GL873554","511555","511741","chr6","166828248","166828429","56","166316693","GTGGGACCCGCATCTATACTAAAAATGAAAAACTAGTCAGACTTGGTGACTCATGCCTATAATTTCAGTTTCTTGGGAGGTGAAGGCAGAAGAATTGCTTGATCCCAGGAATCTGAGATTGCTGTGAGCTAGGCTAACACTATGGCACTCCAGCCCAGCTGACAGAGTAAGACTTTGTCTTTAAAAA","ACCCCATCTCTACTGAAAATAGAAACATTAGCCGGGCTTGGTGGCATGCGCCTGTAGTCCCAGCTATTTGGGAGGCTGAGGCAGGAGAATTGCTGGAACCCAGGAGGCAGAGATTGCAGTGAGCGGAGATCATGCCATTGCACTCCAGCCTGGGCGACAGAATGAGGCTCCATCTCAAAAAA"
"GL873554","2046660","2046725","chr8","51862362","51862427","7","49815702","GGCTGGCCGCGGTGGCTCACGCCTGTAATCCTAGCACTCTGGGAGGCCGAGGCAGGCAGATCACCT","GGCCGGGCACGGTGGCTCACACCTGTAATCCCAGCACTATGGGAGGCCGAGGCAGGTAGATCACCT"
"GL873554","2580766","2581036","chr13","93262937","93263229","81","90682171","GGCCTGGGCAAGGTGGCTCACTCTCTGGAAGGCTGAGGCAGATGGATTGCCTGAGCTCAGGAGCTAGAGACTAGCATGATCTCACCTCTACTAAAAATAGAGAAACTAGCCAGGCATTACAGCACACGCTTGCAGCCCCAGCTACTCTGGGGGCTGAGGCAAAAGGATCACTTGGACTCAAGAAACTGAGGTTCCTGTGAGCCATGATGCCAGGACACTCTACCCAGGGAAACAGAGTGAGACTTCATCTCAAAAAAAAAAAGAAAGAAAA","GGCTGGGTGCAGTGGCTCACGCCTGCACTTTGGGAGGCCAAGGCAGGTGGATCACCTGAGGTCAAGAGTTTGAGACCAGCCTGGTCAACATGGTGAAACCCCATCTCTACTAAAAATACAAAAATTAGCCAGGCATGGTGGCACGTGCCTGTAATCTCAGCTACTCTGGAGGGTGAAGCAAAAGAATCACTTGAACCCAGGAGGCAGAGGTTGCAGTGAGCCAAAATCATGCCACTGCACTCTGGCCTGGGCAACAGAGTGAGACTCCATGTCAAAAAAAAAAAAAAAAAAAA"
"GL873554","5465741","5465829","chr11","47014803","47014890","15","41549062","GGCCAGGCATGGTGGCTCACGCCTGTAGTCCCAGCGCTGTGAGAGGCCGAGGCGGGTGGATCACCTGTGCTTAGAGGTTCGAGACCAGC","GGCCGGGCACCGTGGCTCACGCCTGTAATCCCAGCACTTTGGGAGGCCAAGGCGGGTGGATTACCTGAGGTTAGGAGTTCGAGACTAG"
"GL873555","8807785","8807956","chr1","12240468","12240612","48","3432683","GGCCGGGCGTGGTGGCGCACGCCTGTAGTCCCAGCGCTATGGGAGGCCGAGGCGGGTGGATCACCTGAGCTCAGAGGTTCGAGACCAGCCAAGACCCCCCTGAGCCAAACGAGCCAGAGTGAGACCCCGTCTCTACAACAACAACAGGACAACAAAACAGCCGGACCTTGTG","GGCCGGGCGCGGTGGCTCATGCCTGTAATCCCAGCACTTTGGGAGGCTGAGGCGGGTGGATCACCTGCGGTCAGGAGTTCGAGACCAGCCTGGCCAACGTGGTGAAACCTCATCTCTACTAAAAATATAAAAATTAGCTGGTGTG"
"GL873555","8828420","8828440","chr3","5439989","5440005","4","3388431","ATAATAATAATAATAAATTAG","ATAATAATAAAATAAAA"
"GL873555","12399534","12399604","chr15","102111398","102111458","22","89711864","GGCCAGGCATGGTGGCTCACACCTATAATCCTGGGAGGCTGAGGATTATCTGAGCTCAGGGATGTGAGACC","GGCCAGGCACGGTGGCTAAGGCCTGTAATCTGGGAGGCTGAGATGGGTGGATCACCTGAGG"
"GL873555","12440877","12440963","chr19","21209507","21209590","24","8768630","GTGGGGAGTGCACCTGAACTTTGGAGTTCAAGACCAGCCTGGGCAACATTGTGTGAGCCCTGTCTCAATTGGAAAACAAAACAAAAA","AGGTGGGCAGATCACCTAAGGTCAGGAGTTCAAGACCAGACTGGCAAAAATGGTGAAACCCTGTCTCTACTAAAAATAAAAAAA"
"GL873555","13094462","13094529","chr1","100916857","100916922","22","87822395","GCTTGTACCTATAATCCTGGTACTTTGGGAGCCTCAGGAGAGTGGATCACCTGAGTAAGAGCAAGACC","CATGCCTGTAATCCCAGCACCTTGGGAGGCCAAGGTGGGTGGATCACCTGAGGTCAGTAGTTTGAG"
"GL873555","13254579","13254784","chr7","32729330","32729532","64","19474751","GACCAATCTAAGCCAGAGCTGTCTATGCTAAAAATAGAATAATAAGCCTGGTTTATGGTAGGAGCCTGTAGTCTCAGTTACCTGGGTGTCTGGGGCAAGAGATTGACTTAAAACCAGGAGTTTGAGGTTGCTGTAAGCTAGGCTGACACCACAATACTCTAATCTGGGCAGAGTGAGATTCTGTCTCAAAAAAAAAAAGAAAGAAA","GAAACCCCATCTCTACTAAAAATACAAAATTAGCCAGGCATGGTGGTGCACACCTGTAGCTCCAACTACTTGGGAGGCTGAGGCAGGAGAATCACTTAAACCCAGGCAGTAGAGGTTGCAGTAAGCCAAGATCGCACCACTGCACTCCAGTCTGGGCAACAGAGTGAGACTCTGTCTCAAAAAAAAAAAAAAAAAAAAAAAAA"
"GL873555","13255065","13255153","chr10","29045352","29045442","23","15790287","CTGGGCACAGTGGCTGAGGGTGTAATCCTACCACCCTAGGAGGTTGAGGCAGAAGGATCACTTGAGCTCAGGAATTCAATACAAGTCTA","GGCGGGGCACAGTGGCTCATGCCTGTAATCCTAGTACTTTGGGAGGTCGAGGCGGATGGATCATCTGAGGTCAGGAGTTTAAGACCAGTCT"
"GL873555","13262783","13262918","chr1","29437872","29437991","30","16175089","GGCCGGGCGTGGTGGCGCACGCCTGTAGTCCCAGCACTATGGGAGGCTGAGGCGGGTGGATCACCTGTGCTCAGAGGTTCGAGACCAGCCAAGACCCCCCTGAGCCAAACGAGCCAGAGTGAGACCCCGTCTCTAC","GGCCGGGCGTGGTGGCTCACGCCTGTAATCCCAACATTTTGGGAGGCCAAGGCGGGTGGATCACCTGAGGTCAGAAGTTCGAGACCAACCTGGCCAACATGGTGAAACCCCTGTCTCTAC"
"GL873556","639117","639366","chr1","62410822","62411038","72","61771705","GGCCGGGTGTGGTGGCTCATGCCTGTTGTCCCAGCACTGTGGGAGGCCAAGGCAGGTGGATCGCCTGAGCTCAGCCAAGTTCGAGACCAGCGGAAGACCAGCATGAGGCACAGTGAGCCAGAGTGAGACCCTACCTCTACAAAACAACAACAACAACAAAAAACCCAGCCAGATGTTGTGGCAAGTGTCTGTAATCCCAGCTACATGAGGGGCAAGAGGGCAAGAGAATCACTAAAGGAGGAAGAAGTAA","GGCCGGGCGTGGTGGCTCACACCTGTAATCCCAGCACTTTGGGAGGCCAAGGTGGGTGGATCTCCTGAGGTCAGGAGTTCGAGAGCAGCCTGGCCAACATGGTGAAACCCTGTCTCTACTAAAATACAAAAATTAGCCAGGTGTGGTGGCACGTGCCTGTAATCCCACCTACTCAGGAAGCTGAGGCAGGAGAATCACTTAAAGCTGGGAGAGAGAG"
"GL873556","639390","639468","chr20","16893610","16893664","30","16254220","ACTTCAAACTAAGATAAAGTGAAAGTCAGCAGAAATTGAAAGCAAAAACAAAAACAAAAAAAAAAAAAAAAAAAAAAGA","AACAAAACAAAACAAAACAAAACAAAACAGACAAAAAAAAAAAAACAAAGAAAAA"
"GL873556","2031445","2031493","chr13","87950184","87950229","13","85918739","AGACCCTATCTCTACTAAAAATAGAAAAACTAGCCCAGTATAGTGATGC","AAACCCCATCTCTAGTAAAAATACAAAATTAGCTGGGTGTGGTGGC"
"GL873556","6655305","6655664","chr2","190010230","190010561","107","183354925","GGCCAGGCATGGTGGCTCACACCTGTAATCCTAGCACTCTGGAAGGCCAAGGGAGGTGAATTTCTTGAAGTTCGAGATCAGCCTAAGAGGAATGATACCCCACCTTTACTAGGAATAAAAAAAAAAAAAAAAAAAAACCCAAAACTAGCCTGGCATTGTGGCAGTTCTCTGTAATCCAAGCTACTTGGGAGGCTGAGGTAGAAGGATTGCTTGAACCAAAGAGTTTGACTAGAGGTTGCTGTGAGCTAGGCTAATGTCACCACACTCTATCCAGGGCAAGTGAGTGAAACTCCGTCTCAAAATAAATAAATAAATAAATAAATAAGTAAGAAAAACTTTTGCCCATAAAAAAAAAAAGAA","GGCCGGGCGCGGTGGCTCACACCTGTAATTCTAGCACTTTGGAAGGCTGAGGTGGGTGAATTGTCTGAGCTCAGAAGTTCGAGACCAGCCTGGGCAACACAGTGAAACCCCATCTCTACTAAAATACAAAAAAAAAAAAAAATTAGCTGGGCATGGTGGTGTGCACCTGTAGTCCCAGCTACTCAGGAGGCTGAGGCAGGAGAATTGCTTGAACCCAGGAGGCAGAGGTTGCAGTGAGCTGAGATCACGCCACTACACTCCAGCCTGGGCAACAGAGTGAGACTCCACCTCTTTAAAAAAAAAAAAAAGAAAGAAAGAAAGAAAGAAAGAAA"
"GL873556","10802692","10802792","chr20","28544296","28544376","36","17741604","TACAAAGAAATATCATTATTGGCCAGGTGCAGTGGTTCACATCTGTAATTCTAGTACACTAGTACTCAGGAGGATCACTTGAGGTCAGGAGCTTGTGACCA","TAGAAATGCACAATTCACCTGGGCACGGTGGCTCACTCCTGTAATTCCAGTACTTTGGGAGGCATGAGGTCAGGAGTTCAA"
"GL873557","1682363","1682659","chr6","13352322","13352625","72","11669959","GGCCAGGTGTCGTGGCTCAGGCCTGTAATCCCAGCATTCTGGGAGGCTGAGGTGGGTGGATTGCCCTGAGGTCACAGGTTCCAGACCAGCCTGAGCAAGAGCGAGACTCCATTTCTAATAAAATAGCCGGGTGTTGTGGTAGGTGCCTGTAGTCCCAGTTACTCGGGAGGCTGAGACAAGAGAATCATTTGAACCCAGGAATTTGAGGTTGCTGTGAGCTGTGATGCCACAGGACTCTACTGAGGGCAATAAAGTGAGACTGTCTCAAATAAACAAACAAACAAACAAAAACAAAAA","GGCCAGGTGTGGTGGCTCAGGCCTGTAATCCCAGCACTTTGGGAGACTGAGGTGGGCGGATCACCTGAAGTAAGGAGTTCAAGACCAGCCTGGCCTACATAGTGAAACCCCATCTCTACTAAAAATACAAAATTAGCTGGGTGTGGTGGCACGTGCCTGTAGTCCCAGCTATTCGGGAGGCTGAGTCAGGAGAATCACTTGAACCCAGGATGGGGAGGTTGCAGTGAGCCGAGATCACACCACTGCACTCCAGCCTTGGCAACAGATTGAGACTCTTTCTCAAAAAAAAAAAAAAAAAAAAAAA"
"GL873557","2465751","2465841","chr16","4764895","4764982","15","2299144","GGCCGGGCTTGGTGGTTCACGTCTGTTGTCCCAGCACTGTGGGAGGCCGAGGCAGGTGGATCACCTAAGCTCAGCCAAGTTCGAGACTAGC","GGTCGGGTGTGGTGGGTCACGACTGTAATCCCAGCACTTTGGGAGGCCGAGGCAGATGGATCACCTGAGGTCAGAAGTTCGAGACCAG"
"GL873557","4047834","4047915","chr12","77852792","77852880","22","73804958","ACAAGAGGTTGCTTTGAACTGTGATGCCACAGAGCACTATCCTGGGCAACAGAGACTCTGTCTCAAAAAAAAAAAAAAAAAA","CAGAGGTTGCAGTGAGCTGAGACTGTGCCACTGCACTCCAGCCTGCGCGACAAGAGTGAGACTCTGTCTCAAAAAAAAAAAAAAAAAAA"
"GL873557","4048202","4048390","chrX","23681445","23681631","42","19633243","GGCTGGGTGTGGTGGCTCACACCTGTGATTCTAGCACTCTGGGAGGCCAACGTGGGCAGATCACCTGAGCTTAGGAGTTCAAGACCAGTGTGAGCAAAATGAGACCCCGCCTCTACTAAAAATAGAAAAACTAGCCAGGCACTGTGGTGGGTGCCTATCATCCCAGCTACTCAGGAGGCAGGCAAGAGG","GGCCAGGCGTGGTGGCTCACGCCTGTAATCCCAGCACTTTGGGAGGCCGAGGTGGGTGGATCACCTGAGGTCAGGAGTTCAAGACCAGCCTGGCCAACATGGTGAAACCCCGTCTCTACTAAAAATATAAAAATTAGCCAGGGTGTGGTAGTGCCTGCCTGTAATCCCAGCTACTCGGGAGGCTGAG"
"GL873557","6292327","6292620","chr19","32265157","32265444","82","25972830","GTCAGGCACGGTGGCTCATGCTTGTTGGATTATCCCAACACTCTGGGAGGCCAAGGTGGATCGATTGTCTGAGCTCTGGAGTTCAAGACCAGCCTGAGCAGAAGCAAGACTCCATCTCTAAAAAAAAATAGCTGGGCATTGTGGTGGGCACTTGTATTCCTAGCTACTTGGAAAGCCTGAGGCAAGAGGATTGCTTGAACCCAAGAGTTTGAGGTTGCTGTGAGCTTAAGATGTCACAGCACTCTATAGAGGCTGAGCAAGTGAGACTCCAAAAAGTGAGTTTCCAGAAAAAAA","GACTAGGCACTGTGGCTCATGCCTGTAATCCCAGCACTTTGGGAGGCCGAGGCGGGTAGATCACCTGAGCTCAGGAGTTTCAGACCAGCCTGAGCAACATGGCAAAACCCCATCTCTACTAAACATTAGCCAGGCATGGTGGTGTGCACCTGTAATCCCAGCTACTTGGAAGGTTGAGGCAGGAGGATCACTTGAACCTCAGGAGGCAGAGGTTGCAGTGAGCCAAGATGACATGACTGCACTCCAATCTGGGTGGCAGAGCAAGACTCTGTCTCAAAAAAAAAAAAA"
"GL873557","6324546","6324617","chr1","39656281","39656348","22","33331735","CGCCTGTTGTCCCAGCACTGTGGGAGTGTGAGTAGGGTGGATCACCTTAGCTCAGCTGAGTTTGAGACCAGC","CATGCCTGTAATCCCAGCACTTTGGGAGGTCAAGGCTGGCAAATCACCTAAGGTCAAGAGTTTGAGAC"
"GL873557","6406262","6406343","chr1","199505332","199505412","11","193099070","CAGGCGCAGTGGCTCAATCCTATAATCCCAGCACTTTGGGAGGCTGAGGCAGGTGGATTACCTGAGCTCAGGAGTTTGAGAC","CCAGGCGCAGTGGCTCACACCTGTAATCCCAGCACTTTGGGAGGCTGAGGCAGGCAGATCACCTGAGGTCAGGAGTTGGAG"
"GL873557","6417612","6417692","chr13","102319052","102319128","16","95901440","GAGGTTGCTGTGAGCTAGACTGAGGCCACAGCACTCTAGCCTGGGCAACAGAGTGAGACTGTCTCAAAAGAAAAAAAGAAA","GAGGTTGCAGTGAGCTGAGATCACACCACTGCACTCCAGCCTAGGCAACAAAGTGAGACTCCAACTGAAAAAAAAAA"
"GL873557","6903406","6903510","chr16","18967946","18968045","32","12064540","AGTGCTCTGGGAGACTGAGATGGGCAAATATCTTGAGTTTAGGAGTTCCAGACCAGCCTAAGGAAGAACAAGACCCTATCTCTACTAAAAATAGAAAAAAATTCA","CTTTGGGAGTCTGAGGCAGGTGGATCTCCTGAGGTCAGGAGTTCAGGACCAGCCTGGCCAACATGGCAAAACCCCATCTCTACTAAAAATATAAAAATTA"
"GL873557","6903779","6903930","chr3","40638454","40638604","35","33734675","TTTGCCAGGTATTGTGGTGGACACCTGTAGTCCCAGCTGCTTGGTAGGCTGAGGCAGGAGGATCACTTGACCCTAGGAATCTGATGTTGCTGTGAGCTAGGCTGATGCTACAGCACTCTAGCCTGGACAACAGAGTAAGCTTCTGTCTCAAA","TAGCTGGGTGTCATGGCACACGCCTGTAGTCCCAGCTACTTGGGAGGCTGAGGCAGGAGAATCTCTTGAACCTGGGAGGCAGAGGTTGCAGTGAGCTGAGATCACGCCACTGCACTCCAGCCTGGGCAACAGAGTGAGACTCCGTCTCAAA"
"GL873557","8133022","8133316","chr19","42881134","42881434","76","34748112","GAGTGCAGTGGCTCACACCTGTAATCTTAGCACTCGAGAGGCTGAGGCAGGTGGATTGCCTGAACTCACAGCTTCGAGACCAGCCTGAGCCAGAGCAAGACCTCATCTCTAAAAATAGCCAGGAGTTGTGGCAGGCGCCTGTAGTCCCAGCTACTTGGGAGGCTGAGCAAGAGAATCGCTTGATCTCAGGAGTTTGAGGTTTCTGTGAGCTAAGACACCGCAGCACTCTACCAAGGGTGACAAAGTAAGACTCTGTCTCAAAAAATAAATAAATAAATAAATTATAAGAAAAAGA","CCGGGCAAGGTGGTTCACACCTATAATCCTAGCACTTTGGGAGGTCGAAGTGGATCGCCTGAGGTCAGGAGTTAGAGACCAGCCTGGGCAACATAGCAAAACCCCATCTCTACTAAAAATAGAAAAACTAGCCAGGTGTGGTGGCGCCTGTAATCCCAGCTACTCGGGAGGCTGAGGCAGAAGAATCGCTTGAACCCAGGAGGCAGAGGTTGCAGTGAGCTGAGATCGCACCACTGCACTCCAGGGTGACAGAGCAAGACTCTGTCTCAAAAAAAAAAAAAAAAAAAAAAAAAAAAAAAAA"
"GL873557","8171663","8171835","chr7","151280672","151280824","61","143109009","TTAGCCAGGCACTGTGCTCCCAGCTACTAGGGAGGCTGAGGCAAGAAGAGGATCACTTGGCTCGGCGCCTGTGACTCAAGTGGCTAAGGTGCCAGCCACATACACCTAAGGTGGAGGGTTCTCTACCCAGAGGGACAGCTTGAGGCTCCATCTCAAACAAAAAAAAAAGAAGA","TGGTATGCACCTGTAATCCCAGCTACTTAGGAGGCTGAGGCATGAGAATCACTTGAACCCAGGAGGTGGAACTTTTAGTGAGCTGAGATTGCACCACTGCATTCCAGCCTGGGCAACAGAATAAGACTCTATCTCAAAAAAAAAAAAAAAAAA"
"GL873557","8172121","8172252","chr11","123260550","123260686","30","115088429","CTGGGCATGGTGGCTCATACCTATAATCCTAGGACTTTGGTAGGCCGAGGCAGGTGGGTTGCTTGAGCTTAGAAGTTGAAGACCAGCCTGAACAACAGCAAGACCTTTCCCTACTCAAAACAGAAAAACTAT","GGCTGGGCAGGGTGGCTCATGCCTATAATCCCAGCACTTTGGGAGGCCAAGGCGGGTGGGTCACCTGAGGTCAGGAGTTCGAGACCAGCCTGACCAACATGGTAAGATCCCCTCTCTACTAAAAATACAAAAATTAA"
"GL873557","8260873","8260977","chr1","62231025","62231129","22","53970152","GGCTGGGCATGGTGGCTCACGCCTGTTGTCCCAGCCCTGTGGGAGGGTGAGGCAGGTGGATCGCCTGAGCTCAGCCGAGTTCGAGACCACTGGAAGACCAGCATG","GGCTGGGCATGGTGGCTCACGCCTATAATCCCAGCACTTTGGGAGGCCGAGGCAGGTGGATCACCTGAGATCAGGAGTTTGAGACCAGACTGGCCAACATGGTGA"
"GL873557","10032878","10033040","chr9","27037847","27038008","36","17004969","GGGGGTGGTGGCTCACACTTGTAATACCAGCTACTCTGGAGGCCGAGGCAGGAGAATCATATGAGCCCGGAAGTCTGAGGTTGTTGTGAGCTGGGTTAATGCCCCTGCACTCTAGCCTGGGCAACAGAGTGAGACCATGTCTCAAGGAAATAAAAAAAAAAAA","TTAGCTGGGCATGCTGGCACACACCTGTAATGCCAGCTACTCAGGAGGCTGAGGCAGGAGAATCACTTGAGCCCGGGAGGTGGAGGTTGCAGTGAGCTGAGACAGTGCCACTGTATTCTACCCTGGGCAACAGAGTGAGACTGTCTCAAAAAAAAAAAAAAA"
"GL873557","10366578","10366655","chr17","24597444","24597521","20","14230866","GCCAGGCGTGGTGGCTCATGACGGTAATCCCACCTACTCAGGAAGCAGAGGCAGGAGAATCACTTGCGCCTAGGAGAC","GGCCAGGCATGGTGGCTCATGCCTGTAATTCCAGCACTTTGGGAGGCCGAGGCAGGTGGATCACTACGTCAGGAGTTC"
"GL873557","12031816","12031985","chr11","55022806","55022982","46","42990990","TAGAAAAACTAGCCAGGCATTGTAGCGGGTGCCTATAGTTTCAGCTACTCTGGAGACTGAGACAAGATTGCTTGAGCCCGGGAATTTGAGGTTGCTGTGAGCTATTATGCCACAGCACTCAATACAGGACAATTGAGTGAAACTCCAGTCTCAAAAAAAAAAAAAAAAAA","CAAAAATTAGCCAGGCAGGGTGGTGGGCGCCTGTAGTCTCAGCTACTGGGAAGGCTGAGACAGGATAATCACTTGAACCCGGGAGGCGGATGTTGCAGTGAGCCGAGATCATGCCACTGCACTTCAGCCCGGGCAACGAGAGTGAAACTCCGTCTCAAAAAACAAAATAAAATAAAA"
"GL873557","12032023","12032144","chr1","111354387","111354508","23","99322364","GGTCAGGTGCAGTGGCTCACATCTGGAATCCTAGCACTCTGGGAGGCCGAGGAGAATGGATCCCCTGAGCTCAGGAATTCAATATCAGCCTGAACAAGTGTGAAACCTCCATCTCTACTTAA","GGCCGGGCGTAGTGGCTCACACCTGTAATCCCAGCACTTTGGGAGGCCGAGGCGGATGGATCACCTGAGTTCAGGAGTTTGAGACCAGCCTGACCAAAGTGGTGAAACCCCGTCTCTACTAA"
"GL873557","14208944","14209036","chr7","158031905","158031997","26","143822961","GGATGTGGTAGTTACTGTTTGCTATGATGACAACACTGCACTCTAACTCTGGGTGACACAGTAAGATTCTATCTCAAAACCAAAATAAAACAA","CCAGGAGGTGGAGGTTGCAATGAGCCAAGATCACACCACTGCACTCCAGCCTGGGTGACAGGGTGAGATTCTGTCTCAAAAAAAAAAAAAAAA"
"GL873558","2159034","2159070","chrX","41233833","41233871","7","39074799","ATTAGCCAGGTGTGGTGGCTTTTGCCTGTAATCCCAG","AAATCAGCCGGGTGTGGTGGCTCACGCCTGTAATCCCAG"
"GL873558","3486850","3487074","chr5","91338665","91338874","72","87851815","GGCCAGGCATGGTGGCTCATGCCTGTTGTCCCAGTGCTGTGGGAGGCCGAGGCAGGTGGATCGCCTGAGTTCAGCCAAGTTTGAGACCAGTGGAAGACCAGCATGAGGCAGAGTGAGCCAGAGTAAGACCCCATCTCTACAACAACAAAAAAAAAAAACAAAAAAAACAGCCGGACGTTGTGATCCCAGCTACATGGTGAGGGGGAGGGGAACAGGAGAATCACT","GGCCGGGCATGATGGCTCATGCCTGTAATCCCAGCACTTTGTGAGGCCGAGGCAGACTGATCACTTGAGGCCAGGAGTTCGAGACCAGCATAGCCAACAAGATGAAACACCATCTTTACTGAAAATACAAAAAAAAAAAAAAATAGCCGGATGTGGTGATACCTGCTTGTAATCCCAGCTGCTTGGGAGGCTGAGGCAGGAGAATCTCTT"
"GL873558","3884156","3884240","chr4","24638016","24638099","18","20753860","CCAGACACAGTGGCTTAAGCCTGTAATCCTAGCACTTTGGGAGGCTAAGGTGGATGGATCTCCTGAGCTCAGTAGTTTGAAGCTA","GCCAGGCATGGTGGCTCATGCCTGTAATCTTAGCACTTTGGGAGGCCAAGGTGGGCGGATCATCTGAGGTCAGGAGTTTGAGAC"
"GL873558","5037604","5037746","chr3","2138380","2138521","38","2899224","GCTGGGCCTGGTGGCTCACATCTGTAACCCTAACACTCTGGGAGGCCAAGGCAGGAGGATCTCTTGAAGCTAGGTTGTTAGCCAGGGCGACCCCACAGCACTCTAGCCTGGGGCAACAGAGTGAGACTTTGTCTCCAAACAAA","AGCTGGATGTGGTGGCCCACACCTGTAATCACAGCTACTCGATAGGCTAAGGCAGGAGAATCGCTTGAACCTGGGAGGCGGGGACTGCACCATCACAGCACTCCAGCCTGGGTGACAGAGTGAGACTATGTATCAAAAAAAA"
"GL873558","6488648","6488700","chr3","39516725","39516768","23","33028077","ATAGCACTCTACCATGGGTGACAGAGTGAGACTATCTCCCCCCCTCAAAAAAA","GAGACCAGCCTGACCAACACAGTGAAACCTCATCTCTACTAAAA"
"GL873558","6489359","6489583","chr10","19070944","19071172","64","12581585","GGCTGGACATGGTGGGTCCTGTAATCCTAGCACTGTGGGAGGCCGAGGCAGGTGAATTGCTTGAGCTTATGGGTTCAAGACCAACCTGAGCCAGAAGGAGACCTTGTCTCTAAAAATGGCTGGGTGTTGTGGCAGGCACCTATAATCCCAGCTACTTGGGAGGCTGAGGCAAGAGAATCGCTTGAACCCAAGAGTTTGATGTTGCTGTCAGCTAAGATGCCATAG","GGCTGGGCTCAGTGGCTTATGCCTGTAATCCCAGCGCTTTGGGAGGCCAAGGCGGGTGGATCACCTGAGGTCAGGAGTTCGGGACCAGCCTGAACAACATGGTGAAATCCCGCCTCTACTAAAAAAAAGCCGGGTGTGGTGGCATGCACCTGTAATCCCAGCTACTTGGGAGGCTGAGGCAGGAGAATCACATGAACCTGGGAGGCAGAGGTTGCAGTGAGCTGAGATC"
"GL873558","14631848","14632045","chr18","1878493","1878704","62","12753355","GGTGCAGTGGCTCACGCCTTTAATCCCAGCACTTGGGATGGTGAGGCAGGTAGATTGCCTAAGTTCACAGGTTCAAGACCAGCCTGAGCCAGAGAGACCCTACCTCTAAAAAATAGCCAAGCATTGTGGCAGGCACCTGTAATCCTACTTAGGAGGCTGAGTCAAGAGGATCATTTGAGCTTAAGAGTTAGAGCTTGT","GGCCAGGCATGGTGGCTCACGCCTGTAATCCCAGCACTTTGGGAGGCCGAGGCGGGTGGATCACAAGGTCAGGAGTTCAAGACCAGCCTGGCCAACATGGTGGAAGCCCATCTCTACAAAAAATTAACTGGGCGTGGTGGCAGGCACCTGTAATCCCAGCTACTTGGGAGGCTGAGGCAGGGGAATTGCTTGAACCTGGGAGGCGGAGGTTG"
"GL873558","14632352","14632392","chr7","10117723","10117763","10","4514629","GAGTTAGAGCTTGCTGTGAGCTAAGATGCCACGGCACTCTA","GAGTTAGTTGCAGTGAGCTGAGATCGTGCCACTGCACTCCA"
"GL873559","8193331","8193614","chr20","11734223","11734512","71","3540892","CAGGTACGGTGACTTATCCCTGGAATCTTAGAACTGTCTGAGTCCAAGGTGGGAGGATCATTGGAGGTCAGGAATTTGAGACCAGCCTGAGCAAGAGTGAGACCTCTTCTCTACTAAATATAGAAAAATTAGCCAGGGTTTGTGGCAGGTGCTTATAGTCTAAGCTTCTTAGGAGGCTGAGGCAGGAGAATCTCTTGAACCCATGAGTCTGAGGTTGCCCTGAGTTAAGATGACATCACTGCAGTCTCCCCAAAGCAACGGAGTAAGACTCTGTCTCAAAAACA","GGCCAGGCACGGTGGCTCATGCCTCTAATCCCAGCATGTTGGGAGGCCGAGGTGGGCGGATCACATGAGGTCAGGAGTTTGAGACCAGCCTGGCCAACATAGTGAAACCCTGTCTCTACTAAAAATACAAAAATTAGCCAGGTGTGGCAGCACGTGCCTGTAGTCCCAGCTAGTCAGGAGGCTGAGGCAGGAGAATCACTTGAATCCACCAGGCGGAGGCTGCAGTGAGCCAAGATCACACCACTGCATTCCAGCCTGGGCGACAGAGCAAGACTCTGTCTCAGAAAAAA"
"GL873559","8193642","8193657","chrX","1083699","1083714","0","7109943","AAATAAATAAAATAAA","AAATAAATAAAATAAA"
"GL873560","393252","393440","chr11","121440472","121440639","55","121047220","CTGGGCAGGGTGGCACACACCTGTCATCCCAGCATGTTGGGAAGCTGAGGCAGGAGAATTACTTGAGCTCAGATTCCAAGAGGTGAGGATCACTTGAGCCTAGAAGTTGAGGCTGCACTGATGCCCCAACACTCCAGCCTGGGCAACAGAGCAAGGTCCTGTCCCAAAAAGAAAAAAAGAAAAGGAAAA","GCTGGGCGCAGTGTCTCACGCCTGTAATCCCAGCTATTTGGGAGGCTGAGGCAGGAGAATTACTTGAACCTGGGAGGTGGAAGTTGCAGTGAGCCGAGATCCTACCATCGCACTCCAGTCTGGGCAACAAGAGCAAAACTCTGTCTCAAAAAAAAAAAAAAAAAAAAA"
"GL873560","4038833","4039014","chr12","78258009","78258208","56","74219176","GGCTGGGTGCGGTGACTCACACCTGTAATCCCAGCACCTGGAGGCCCAAGGCAGGGTGGATTGTCTGAGCTCACAGGTTCAAGACCAGCCTGAGCCAGAGCGAGACCTAAAAATAGCTAGGCGCTGTGGGAGGCACACGTAGTCCCAGCTACTCAGGAGGCTGAGGCAAGAGAATCACTTGA","GGCTGGGCACGGTGACTCACGCCTGTAATCCCAGCACTTTGGGAGGCCCAGGTGGGTGGATCACCTGAGGTCAGGAGTTCAAGACCAGCCTGGCCAAGATGGTGAAACCCCGTCTCTACTAAAAATACAAAACTTAGCTGGGCATGGTGGCGGGCACCTGTAATCTCAGCTAGTCGGGAGGCTGAGGCAGGAGAATCTCT"
"GL873560","4492531","4492643","chr7","56485655","56485756","37","51993124","AACAGAAAAACTAGCCAGGCATAGTGGTGCATGCCTGTTGTTCCAGCTGCTCTAGAGGCTAAGGCAAGAGGATTGCTCCAGCTCAATAGTTTGAGGTTGCTGTGAGCTTGAGA","TTAGCTGGGCATGGTGGAGCACACCTGTAATTCCAGCTACTCAGGAGGCTGAGGCAAAAGAGTTGCTTGAACCCAGGAGGCAGAGGTTGCAGTGAGCCGAGA"
"GL873560","4492670","4492771","chr8","41603464","41603564","28","37110794","AGCACTCTGGGTGACTGAGGCAGGATTACTTGAGCTCAGGAGTTTATGACCAGCCTGAGCTGGTCCTTGATCAAGACTCCATCTCTACTAAAAAAACAAACA","CACTTTGGGAGGCCGAGGCAGCAGATCACTCGAGGTCAGGAGTTTGAGACCAGCCTGGCTAACATGGCAAAACCCCATCTCTACTAAAAATATAAAAATTA"
"GL873560","8106775","8106882","chr11","111878590","111878685","39","103771815","ACATAAGAATCAGGCCAAGCCTTGTGGCTCCTGTATGTGATTCCAGCACTGGGAGGGCAAGGCAGGAGGATCCCTGACGTCAGGAACTCAAGGCTGCCCAAGTATCAT","GGGCACAGTGGCTCATGCCTGTAATCCCAGCACTTTGGGAGGCCAAGGCGGGTGGATCACCTGAGGTCAGGAGTTCAAGACCAGCCTGACCAACAT"
"GL873560","10872201","10872272","chr7","9971011","9971083","11","901190","GGCTGGGCACAATGGGTCACACTTGTAATCCCAACACTTTGGGAGGCTGAGGTGGGCAGATCACCTGAGCTC","GGCTGGGTGGGGTGGCTCACACATGTAATCTCAGCACTTTGGGAGGCTGAGGTGGGCAGATCACCTGAGGTCA"
"GL873560","11043320","11043410","chr6","111928830","111928919","19","100885510","CAGGCGAAGTGGCTCATGCCTATAATCCTAGCATTCTGGGAGGCTGAGGTGGGAGAATCCCCTGAGGTCAAAAGTTCAAGACCGGCTTGGC","GGCCAGGCTCAGTGGCTCATGCCTGTAATCCCAGCACTTTGGGAGGCCGAGGTGGGTGAATCACCTGAGGTCAGGAGTTCAAGACCTGCC"
"GL873561","5890611","5890936","chr8","76222061","76222392","77","70331450","GGCTGGGCCTGGTGGCTCATGCCTATAATCCTAGCACTCTGGGAGGCAAAGGTTGGTGGATTGCTTAAGCTCAGGAGTTCAAGACCAGCCTGATTAAGAGTGAGATCCCATCTCCACTAAAAATAGAAGGGAAAAAAAAAAAAAAAAAACCTAGTTGGGCTTGGTGGCAGCACTTGTAGTCCCAGCTATTTAGGAGGCTGAGGAAAGAGAATCACTTGAACCCAAGAGTTTGAAGTTGCTCTGAGCTATGATGCCATAGAACTCTACCCAGGGTGACAGAGTAAAACTGGATCTCAAATAAATAAATAAATAAATACATAAATAAA","GGCTGGGCATGGTAGCTCATGGCTGTAATCCTAGCACTTTGGGAGGCCAAGGAAGGTGGATTGCCTGAGCTCAGGAGTTCAAGACCAGCCTGGGCAACACAGTGAAATCCTGTCTCTACTAAAATACAAAAAAGAAAAAAAAAAAAAAAAAAAACAGCTGGGCATGGCAGTGTGCACTTGTAATCCCAGCTACTCAGGAGGCTGAGACAGGAGAATCACTTGAACCCGGGAGGCAGAGGTTGCACTGAGCCGAGATTGTATCACTGCACTCCAGCCTGGGTGACAGAGCGAGACTCTGTCTCAGAAAAAAAAAAAAAAACAAAAAAACAAAA"
"GL873561","10859256","10859475","chr6","100119122","100119352","73","89259866","GGATCACTTGAGCTCAGGAGTCAAGACCAACTTGAGTAAGAGTGAGACCCTGTCTCTACTAAAAATAAAATATATAGCCAGGCATTGTGCTGGGCACCTATATATAAGCTAAAATGGAGTCTTAGCTACCTCCTTGAACTTGAACCCAGGAGTCTGAAGTTGCTTTGAGCTAGGCTGATGCCACTGCACTTTACCCAGGCAACAGAGTGAGAGTATCTAA","GGATCACCTGAGGTCAGGAGTTCAAGACCAGCCTGGCCAACATGGTGAAACCCCGTCTCTACTAAAAATACAAAAACTAGCCAGGCATGGTGGCGCACACCTGTAGTCCCAGCTACTTGGGAGGCTGAGGCAGAAGAATCTCTTGAATCCGGGGGTTGGAGGTTGCAATGAGCTGAGATCATGCCACTGCACTCCAAGCCTGGGTGACAAGAGCGAAACTCCATCTCAAAA"
"GL873561","10859563","10859576","chr4","114457728","114457741","1","103598165","AAAAAAAAATAAAA","CAAAAAAAATAAAA"
"GL873562","12189469","12189706","chr1","31551552","31551790","75","19362083","CAGTGGCTCACGCCGGTAATCCCAGCACCTTGGGAGCTGAGGCAGGCAGATCTCCTGAGGTCACGTGTTTTGAGACCAGCCTGAGCTAGAGTGAGACCCCACCTCTAAAAATAGCCAGTCGCCTGTAATCCCAGCTACTCGGGAGAAACCCAGGAGTCTAAGGTCGCTGTGAGCTGACACCTCAGCACTCTGCTGGGGTAACAAAGTGACACTTTGTCTCAAAAAAATAAATAAATAT","GCAGTGGCTCACGCCTGTAATCCCAGCACTTTGGGAGGCCAAGGCGGGTGGATCACCTGAGGTCAGGAGTTCAAGACCAGCCTGGCCAACATGGTGAAACCTCATCTCTACTAAAAATACAAAACAGGAGAATCGCTTGAACCCGGGAGGTAGAGGTTGCAGTGAGCTGAGATAGTGCCACTGCACTCCAACCTGGGCAACAGAGTGAGACTCCGTCTCAAAAAAATAAAAAATAAAAA"
"GL873562","4526861","4526913","chr13","94764706","94764759","14","90237845","GTGAGACCTTGTCACTACTGAAAATAGAAAAATTAGCTGGGCATGGTTGTAGG","GTGATGAAACCCCATCTCTACTAAAAATACAAAAATTAGCTGGGCTTGATGGTG"
"GL873562","4789223","4789313","chr10","47852509","47852598","25","43063286","GGCCAGGAGAAGTGGCTAACACCTGTAATTCCAGCACTCTAGGAGATGGAGGCAGGGACCAGCCTGAGCTAGAGTGAGTGAGACTCCATCT","GGCCAGGTGCAGTGGCTCACACCTGTAATCCCAGCAACTTTGGGAGGCTGAGGCAGGCAGATCACTTGAGGTCAGGAGTTCGAGATCAGC"
"GL873562","4868605","4868801","chr16","54069750","54069948","44","49201145","GGCCAGGCATGGTGGCTCATGCCTGTAATCCTAGCACTCTGAGAGACCAAGGCTGATGAATCACCTGAACTCAGGAGTTGAGACCAGCAGGAGCAAAAGTGAGATCCCATCTCTACTCAAAAATAGAAAATTAGTTCAGGCAAGGTGGCACATACCTGTAATCCCAGCACCCTGGGAGGCTAAGGTGGGTGGATTGC","GCCCAGCGCAGTGGCTCATGCCTATAATCCCAGCACTTTGGGAGGCCAAGGCGGGTGGATCACCTGAGGTCAGGAGTTCGAGACCAGCCTGCCCAGCATGGTGAAACCCCATCTCTGTTAAAAATATAAAAATTAGACTAGGCGCGGTGGCTCACACCTGTAATCCCAGCACTTTGGGAGACCAAGGTGGGCGGATCAC"
"GL873562","4929184","4929360","chr10","37539693","37539877","47","32610509","GGCCAAGCTCAGTGGCTCTCCCTAGCACTTTGGGAGACCGAGGTGGGTGGATTGCCTGAACTCAGGAGTTCTAGACCAGCCTGATCAAGAGCAAGACCCTACATCTACTAAAAATAGAAAAACTAGCTGGGCATTATAGTACGCACCTGTACTCCCATCTACTCTGGAGGCTGAGGC","GGGTGCAGAGGCTTATGCCTGTAATCCCAGCACTTTGGGAGGCAGAGGTGGGTGGATCACTTGAGGCCAGGAGTTCAAGACCAGCCTGGTCAATGTGGTGAAACCTCGTCTCTACTAAAAATACAAAAATTAGCCGGGCATGGTGGCATGCATCTGTAGTCCCAGCTACTTGGGAGGCTGAGGCA"
"GL873562","5446395","5446678","chr16","63692714","63692996","79","58246319","GGCTGGATGCAGTGGCTCATACCTGTCTGTAATCCTAGCACTCTGGGAGGTCGAGGTGGGTGGATTGCCTAAGTTCACAGGTTCGAGGCCAGCCTAAGCAAGAAGAGCAAGACTCCATCTCTGAAAGTAGCCAGGCATTGTGACAGGCGCCTATAGTCCCAGCTACTTGGGAGGCTGAGGCAAGAGAATTGAGCCCAGGAGTTAGAGGTTGCTGTGAACTAGGACTCCATAGCATTCTACTGAAGGTGACAAAGTGAGATTCTGTCTCAAAAAAAAGACTGATT","GGCTGGCTGCGGTAGCTCACCCCTGTAATCCCAGCACTTTGGGAGGTCAAGGCAGGTGGATTGCCTGAGGCCAGGAGTTCGAGGCCAGCCTGACCAATATGGCAAAACCCTGTATCTACTAAAAACTAGCTGGGCATGGTGGCATACACCTGTAGTCCCAGCTACTTGGGAGGCTGAGGCAGGAGAATTGCTTGAACCTGGAGGCAGAGGTTGCAGTGAGCCAAGGCTGCCCCACTGCACGCCAGCCTGGGTGACAGAGTGACACTCCATCTCAGAAAAAAAA"
"GL873562","8499356","8499477","chrX","91860022","91860139","29","83360666","GGCTGGGTGTGCTGGCTCATGCCTGTAATCCTCGCACTCTGGGAAGCTAAGGCAGGTGGATTGCCTGAGCTTATGAGTTTAAGACTAGCCTGAGCCAGAGCAAGACCTTGTCTCTATTTTTT","GCCGGGTGTGGTGGCTCATGCCAGTAATCCTAGCACCTTGGAAGGCTGAGGCAGGTGGATTGCCTGAGCTCAGGAGCTTCAGACTAGCCTGGGCAACATAGTGAAACCCCATATCTCT"
"GL873562","8499731","8499918","chr7","167658032","167658223","45","159158301","AAGACCTTGTCTCTAAAAATAGCCAGGTGTTGTAGCAGGCACCTGTAGTCCCAGCTACTTGGGAGGCTGAGACAAGAGAATTGCTTGAGCCCAAGAGTTTGAGGTTGCTGTGAGCTGAGATGCCATGGACTCTATCGAGGGCAGTAAAGTGAGACTCCGTCTCAAAAAAAAAAAAAGAAAGAAAAGAA","TACTAAAATACATACAAAAATTAGCCAGGTATGGTGGCAGGCCCCTGTAGTCCCAGCTACTCGGGAGGCTGAGGCAGGAGAACTGCTTGAACCCAGGAGGTGGGGATTGCAGTGAGCTGAGATCGCACCACTGCACTCCAGCCTGAGCGACAGAGTGAGACTCTGTCTCAAAAATAAAAAAAGAAAAAAAAA"
"GL873562","10216295","10216385","chr1","44313085","44313176","34","34096790","TAAAAATACATTGAACCAGATTCAGTGGCTCACACCTGTGCTCCTAGCTACCCAGTGGCTGAGGCTGAAGGATGGCTTGAATCTCAAGTTC","TTACAGATCATTTGGGGCTAGATGTAATGGCTCACACCTGTAAGCCCAGTGCTTTGGGAGGTTGAGGCAGGAAGATGGCTTGAACCTAGGAG"
"GL873562","11812352","11812435","chr19","44513406","44513491","17","32701054","GGCCGGTACGATGGCTCAGGCCTATAATCTTAGAACTCTGGGAGTCCGAGGTGGGTGGACTGCCTGAGCTCACAGTTCGAGACC","GGCCGGACGCGCTGGCTCACGCCTGTAATCCTAGCACTTTGGGAGGCTGAGGGGGGCGGATAGCCTGAGCTCAGAAGTTCGAGACC"
"GL873562","12179920","12180054","chr14","8268315","8268451","18","3911605","GGCCAGGCATGGTGGCTCACACCTATAATCCTAGCACTCTGGGAGGCCAAGGCAGGTGGATCACCTGAGCTCAGGAGTTTAAGACCAGCCTGAGCAAGAGTGACAACCTATCTCTATTAAAAATACAAAAACTAG","GGCCGGGCATAGTGGCTCACACCTATAATCCCAGCACTTTGGGAGGCCAAGGCAGGTGGATCACCTGAGGTCAGGAGTTCGAGACCAGCCTGACCAAGATAGTGAAACCCCGTCCCTACTAAAAATACAAAAATTAA"
"GL873562","14017684","14017885","chr2","94000404","94000565","73","79982720","CAAGCTAGCCTAGGGATGTGGAGGTACCTGTAGTCCCAGTTACTTCATTGGCTGAGGCTTAAACCCTCTTGGATGGTCTCACTCTGTCACCCTGGTAGAGTGTTGTGGCATCATGTGTCACAGGAGGTTGAGGTTGCTGTGAGCTGTGATGCCACAACATTCTACCAGGGTGACAGAGTGAGACTCTGTTTCAAAAACAAAA","AAACTAGCCTGGCGTGGTGGTGTGTGCCTGTAATCCCAGCTACTTGGGAGGCTGAGACAGGAGAATCACTTGAACCTGGGAAGTGGAGGTTGCAGTGAGCTGAGATCATGCCACTGCACTCCAACTTGGGCAACAGAGCGAGACTCTGTTTCAAAAAAAAAA"
"GL873562","14017915","14018042","chr1","161382752","161382881","27","147364837","GGCTGGGCACGGTGGCTCACACTTGTAATTCTAGCACCCTGGGAGGCCAGCGTGGGTGGTTTGCTTGAAGTTAGGAGTTCAAGACCAGCCTGACCAAAGTGAGACCACATCTCGACTAAAAACAAACA","GGCTGGACGCAGTGGCTCATACCTGTAATCCCAGCACTTTGGGAGGCCGAGGTGGGTGGATCACCTGAGGTCAGGAGTTCAAGACCAGTCTGGCCATGGTGAAACCCCATCTCTACTAAAAATACAAAAA"
"GL873563","2645481","2645758","chr1","37954757","37955032","69","35309276","GGCTGGGTGCCATGACTCACGCCTGTCATCCCAGCTCTCTGGGAGGTCACAATGGGAGTATTCCATGAGCTCAGAAGTTTGAGACCAGTCTGAGCAAGAGCAGACTCCATTTCTACTAAATATAGAAAAATTAGCCCAGTATGGTTGTGCACACCTGTAGTCCCAGCTACTTGGGAGCTGAAGCAGGAAAACGGCTTGAGTCCAGGAGTCGGAGGTTGCTGTGAGCTGAGAGCTATAATGATGCCAGTGCACTCTACCCAGGCAACAGAGCAAGACTC","GGCCGGGTATGGTGGCTTACGCCTGTAATCCCAGCACTTTGGGAGGCCAAGGTTGGCAGATCACCTGAGGTCAGGAGTTCGAGACCAGCCTGGCCAATATGGCGAAACCCCGTCTCTACTAAAAATACAAAAATTAGCTGGGCATGGTGGCGCATACCTGTAATCCCAGCTACTCGGGAGGCTGAGGCAGGAGAACTGCTTGAACCCAGGAGGTGGAGGTTGCAGTGAGCCGAGATTGAGCCACTGCACTCCAGCCTAGGTGACAGAGTAAGACTC"
"GL873563","2646059","2646097","chr1","62915138","62915167","12","60269079","CAAACAGAACAAGACTTTGTTTCAAAAAAAAAAAAAAAA","CAAACAAACAAACATCACAAAAAAAGAAAA"
"GL873563","2651001","2651167","chr2","69424628","69424798","38","66773627","GTACAAAAATTAGCCAGATGTCTTGGTGCTTATAGTCAGCAACTCAGGAGGCTGAGGCAGGAGGATCACTTGAACCCCTGGAATTTGAGGTTGCTGTGAGCTAAGTTGATGCCACGGCATTCTAGCCTGGGTGACAGAGTAAGACTCCATCTCAATAAATAAATAAA","AAAAAAATTAGCCAGGCATGGTGGTGCATGCTTGTAATCCCAGCTACTTGGGAGGCTGAGGCAGGAAGATCACTTGAACCTGGGAGGCGGAGGTTGCAGTGAGCCAAGATTGTGCCACTGAACTCCAGCCTGGGTGACAGAGCAAGACTCCATCTCAAAAAAAAAAAAAAA"
"GL873563","2651449","2651584","chr3","121251018","121251153","32","118599569","GGTCCAGTGAGGTGGTTCAGACCTGTAATCCTAGCATTCTGGGAGGCTGAGGTGAGCAGATTGCTTGAGCTCAGTGAGTTTGAGACCAGCCTGAATAAAAGCAGCACCCCATCTCTACCAAAAGTAGGAAAATTAT","GGCCAGGTGCAATGGCTCACACCTGTAATCCCAGCACTCTGGGAGGCCGAGGTGGGCAGATCACCTGAGGTCAGGAGTTTGAGATCAGCCTGGCCAACCTGGCAAAACCCCATCTCTAATAAAAATACAAAAATTA"
"GL873563","6898038","6898117","chr6","28153994","28154075","27","21255956","AAAAAACAGAAAAATTAGTTGGGTGTGGTAGTGGGTAGCTACTTGGGAGGCTGGGGCAGGAGAATCACTTGAACCCAGGA","AAAATTAGCCGGGTGTGGTGATGCATGCCTCTAATCCCAGCTACTTGGAAGGCTGAGGCAGGAGAATCACTTGAAGGCAGGA"
"GL873563","6898395","6898520","chr5","140939246","140939381","30","134040851","GGGGGTGGTGGCTCATGCCTGTAATCCCAGCACTCTGGCTGAGACAAGTGGATTGCATGAGCTCAGGAGTTCAAGACCAGCTTGAGGAAGAACAAGACTCCATCTCTACTAAAAATAGAAAAATTT","GGCCCGGTGCTGTGGCTCATGCCTGTAATCCCAGCACTTTGGAAGGCTGAGGCAGGTGGATCCCTTGAGGTCAGGAGTTCGAGACCAGCATGGCCAACATGGCAAAATCCCATCTCTACTAAAAATACAAAAATTA"
"GL873563","7811395","7811530","chr1","29437872","29437991","31","21626477","GGCCGGGCGTGGTGGCTCATGCCTGTAGTCCCTGCACTGTGGGAGGCCGAGGCGGGTGGATCACCTGTGCTCAGAGGTTCGAGACCAGCTAAGACCCCCCTGAGCCAAATGAGCCAGAGTGAGACCCCGTCTCTAC","GGCCGGGCGTGGTGGCTCACGCCTGTAATCCCAACATTTTGGGAGGCCAAGGCGGGTGGATCACCTGAGGTCAGAAGTTCGAGACCAACCTGGCCAACATGGTGAAACCCCTGTCTCTAC"
"GL873563","7855904","7856041","chr3","37342340","37342469","34","29486436","GCCAGGGCAGTGGTTCACACCTGTAAAAACCCCAGTATTTTGAGAAGCCAAGTTGGGAGGATCACATAAGGTCAAGAGTTTGAGACCAGCCTGGACAACACAGTATAAGACTCCCATCTCTATTTTGTTAAATATACA","GCCGAGCGCGTGGCTCACGCCTGTAACCCCAGCACTTTGGGAGGCCAAGGTGGGTGGATCACTTGAGGTCAGGAGTAGGAGACCAGCCTGGCCAACATGGGTGAAACCCCACCTATAGTTTAAAAATATA"
"GL873563","8381194","8381392","chr2","167568017","167568216","65","159186823","GGCCAGTGCAGTAGCCCACACCTGTAATCCTAGCACTCTGGGAGGCCAACTCTGGTAGAGTTTGAAACTAGCCTGAGCAAGAGCGAGACCTTGTCTTCACTGAAAAAAATAGAAAAAAAAAAAAAAAACTAACTGGGCATGGTGCTGTACATCTGTAGCCCGAGCTACTCAGGAGTCTGAGGCAAGAGGATTACTCAAT","GCCAGGCGAGGTGGCTCATGCCTGTAATCCCAGCACTTTGGGAGGCCAAAGTGGACAGATTACCTGAGGCCAGGAGTTTGAGACCAGCCTGACCAATATGGTGAAACCCCATCTGTACTAAAAATACAAAAATTAGCAGGGCGTGGTGGTGTACACCTGTAATCCCAGCTACTCAGGAGGCTGAGGCAGGAGAATCTCTT"
"GL873563","8381923","8382014","chr2","92370724","92370803","33","83988801","GGATTGCTCAAGCCCAAGAGTTTGAGGTTGCTGAGAGCTATGACACTACAGCACTCTACTCTACCCAGGGCAACAGAGTGAGACAAAAAAAA","TTGCTTGAACCCAGGAGCTAGAGGTTGCAGTGAGCTGAGATTGCACTATTGCACTCCAGCCTGGGCAACAGGGTGAGACT"
"GL873563","9500422","9500552","chr19","10830410","10830544","33","1329988","GGTCAGGTGCAGTGGTCACCTGTCATCCTACCCCTCTGGGAGGCCAAGGTGGGTGGATTGCCTGAGTTCAGGAGTCTGAGACGAACCTGAGCTAGAGCAAGACCTCATCTCTTAAAAAATAGCCAGCATTC","GGCCAGGTGCAGTGGCTCATGCCTGTAATCCCAGCACTTTGGGAGGCCAAGGTGGGTGGATCACCTGAGGTCAGGAGTTCGAGACCAGCCTGATCAACGTGGTGAAACCCCATCTCTACTAAAATTGCAAAATTA"
"GL873563","9501087","9501192","chr16","71049107","71049211","33","61548020","TAAAACCTATAATGTTTGAAAATAAAAATAGCCAGGCCTTGTTGTGGGTGCCTGTAGTCCCAGCTACTTAGGAGGCTGAGGTAAGAGGATTGCTTGAGCCCAAGAG","TGAAACCCCATCTCTACTAAAAATACAAAATTAGCCAGGTGTGGTGGTGCATGCCTATAATCCCAGTTACTTGGGAGACTGAGGCAGGAGAATCACTTGAACCTG"
"GL873563","10991062","10991128","chr1","22619342","22619410","11","11628280","GGCCGGTGTAGTGGCTCACGCCTGTAATCCCAGCACTTTGGGTGCCGACATGGGCAGATCGCCTGAG","GGCCGGGCGCGGTGGCTCACACCTGTAATCCCAGCACTTTGGGAGGCCGAGGTGGGCGGATCACCTGAG"
"GL873563","12252577","12252738","chr8","144193624","144193784","41","131941047","GGCTGGGTACAGTGGCTCATATCTGTAATCCTAGCACTCCAGGAGGCTGAGGTGGGAGGATAATTGCCTGAAGTCAGAAACACAAGACCAGCCCAAACAAGAGTGAGACACCATCTCTACTAAAAATAGAAAACTGAGCTGGGTGTGGCGGTGCACACCTGT","GGCCGGGCATGGTGGCTCATGCCTATAATCCTAGCACTTTGGGAGGCCGAGGTGGGCGAATCACCTGAGGTCAGGAGTTTGAGACCAGCCTGGCCAACATGGTGAAACCCCATCTCTACTAAAAATACAAAAATTAGCTGGGTGTGGTGGCACATGCCTAT"
"GL873564","1384131","1384395","chr13","32253035","32253303","64","30868904","GGGGGGGGGGGCACACTGGCCTGTAATTCTAGCACTCTGAGAGGCCAAGGCAGGTGGATCACCTGAACTCAGGAGTTCGAGACCAGCCTGATCAAGAGTGAAACCCTGTCTCTACTAACAAGAGAAAAACCAGTAGTCCCAGCTACTCAGGAGGCTGAGGCAGAAGAATCACTTGAACCCAGGAGTTTGAGGTTTCTGTGAGCTACAGTAGTGCTATGGCACTCTACCAAGAGTGACAGAGTGAAACTCTGTCTCAAAAAAAAAA","GCTGGGCATGGTGGCTCATGCCTGTAATCCCAGCACTTTGGGAGGCTGAGGCGGGTGGATCATCTGAGGTCAGGAGTTCAAGACTAGCCTGGGCAACATGGTGAAACCCTGTCTCTACTAAAAATACAAAATTACAGGTAATCCCAGCTACTTGGGAGGCTGAGGCAGGAGAATCGGTTGAACCCAGGAGGCGGAGGTTGCAGTGAGCTGAGATCATGCCACTGCACTCCAGCCTGGGCAATAGAATGAGACTCTGTCTGAAAAAAAAA"
"GL873564","2543879","2544121","chr1","199402350","199402570","73","196858471","GGCCAGGTGTGGTGGCTTACGCCTGTTGTCCCAGCGCTGTGGGAGGCCGAGGCAGGTGGATTGCCTGAGCTTAGCTGAGTTTGAGACCAGCGGAAGACCAGCATGAGGCAGAGTGAGCCAGAGTGAGATCCTGTCTCTACAAAAAAGAAAAAAAAAAAAACAGCCGGATGTTGTGGCGCGCGTCTGTAATCCCAGCTACATGGGGGTCAAGAGGGCAAGAGAATCATACAGGAGGAAGAAGTT","GGCCAGGTGTGGTGGCTCACACCTGTAATCCCAGCACTTTGGGAGTCTGAGGCGGGTGGATTGCCTGAGGTTGAGAGTTTGAGACCAGCCTGGCCAACATGGTGAAACCCTGTCTCTACTAAAAACACAGAAATTAGCCAGGCATGGTGGCGCATGTCTGTAATCCCAGCTACCCTCCTGGAGGCTGAGGCAAGAGAATCACTTGAACCCAGGAAGCAGAG"
"GL873564","4859126","4859236","chr9","15245726","15245837","31","10386600","GTGGCTCATGCTTATAATCCAATCACTATGGGAGACCAAGGTGGGGATGGGCGGAGATCACCCTCAGGAGTTGGAGACCAGCCTGAGTTAAGAGTGATACCATGTCTCTAC","GTGGTGTCTCACGCCTATAATCCCAGCACTCTGGGAGGCCAAGGTGGGCAGATCACCTGAGGTCAGGAGTTAAGAGACCAGCCTGGCCAACATGGTGAAACCCTGTCTCTAC"
"GL873564","4859490","4859678","chr8","126054004","126054184","54","121194514","CATGTCTCTATTAAAGGTAGAAAAATTAGCCGAAGTATTGTAGTTGGGCTGTATAGTCCCAACTACTGAAGAGGCTGAGACAGGAGGATTGCTTACAACTAGGAGTTTGAGGTTGCTGTGAGCTAGGCTGATGCCAAGGTGCTCTAGCCTGGGCAACAGAATGAGACAATGTCTTAAACAACAAAAAAA","GTCTCTACTAAAAATACAAAAATTAGCTGGGTGTGGTGGTGCATGCCTGTAATCCCAGCTACTCAGGAGGCTGAGGCAGGAGAATCGCTTGAACCCAGGAGGTAGAGGTTGCAGTGAGCCAAGATCATGCCACTGCACTCCAGCCTGGGTGACAGAGGGAGACTCTGTCTCAATAAATAAA"
"GL873564","5294014","5294069","chrX","11604904","11604969","20","6310890","GGGTGTGGTGACTTGCACTTACAATCAGCACTTTGGGAGGCGAAGGTAGGAGCATC","GGCTGGGTGCAGTGACTCACGCCTGTAATCCCAGCACTTTGGGAGGCTGAGGTAGGCAGATCACCT"
"GL873564","5294155","5294257","chr15","310129","310227","21","4984026","GGCTGGGTGTGGTGGCTCACGTCTGTTGTCCCAGCGCTATGGGAGGCTGAGGAGGGTGGATCACCTGAGCTCAGAGGTTCGAGACCAGCATAAGACCAGCATG","GGCTGGGCGCAGTGGCTCACGCCTGTAATCCCAGCACTTTGGGAGGCCAAGGCGGGTGGATCACGAGGTCAGGAGTTTGAAACCAGCCTAGCCAGCATG"
"GL873564","6711055","6711262","chr18","1878493","1878704","55","4832562","CTGGGCCCAGTGGCTCACACCTATAATCCTCGCACTCTGGGAGGCTGAGGCGGGTAGATTGTCTGAGCTCACAGGTTCAAGACCAGTGTGACCCAGAGCGAGGCTTTGTCTCTAAAAATAGCAGGGCGTTGTGGCAGGCACCTGTAGTCCCAGCTACTTGGGAGGCTAAGGCAAGAGAATTGCTTAAACCTAAGAGTCTGAGGTTACA","GGCCAGGCATGGTGGCTCACGCCTGTAATCCCAGCACTTTGGGAGGCCGAGGCGGGTGGATCACAAGGTCAGGAGTTCAAGACCAGCCTGGCCAACATGGTGGAAGCCCATCTCTACAAAAAATTAACTGGGCGTGGTGGCAGGCACCTGTAATCCCAGCTACTTGGGAGGCTGAGGCAGGGGAATTGCTTGAACCTGGGAGGCGGAGGTTG"
"GL873564","6711356","6711451","chr7","158031905","158031997","31","151320549","AAAAGAGTCTGAGGTTGCCATGAGCTATCATGCCAAGGCATTCTAGAGAAGGGGTACAAAGTGAGACTCTGTCTCAAAAAAAGAAAACCAAAAAGG","CCAGGAGGTGGAGGTTGCAATGAGCCAAGATCACACCACTGCACTCCAGCCTGGGTGACAGGGTGAGATTCTGTCTCAAAAAAAAAAAAAAAA"
"GL873564","7057009","7057315","chr14","106885133","106885430","87","99828124","GCCGGGTACAATGGCTTGCGCCTATAATCCCAGCACTCTGGGAAGCAGAGGTGGGTGGATCACCTCAGCTCACGAATTCGCTACCAGCCTGTCCTAGAGTGAGACACCCCCCCCACCCCCACCCCCCACAACCTCTAAAAATAGCCTGGAGTTGTGACGGGCACCTGTTGTCCCAGCTACTCTGGAGGCTGAGACAAGAGAATTGCTTGGGCCTCAGAGTCTAAGGTTGATATGAGCTATGACATCACAGCACTCTATCAAAGGTAACAAAGTGAGACTCTAAATAAATAAATAATAAATAAATAAA","GCCGGGCCCGGTGGCTCTTGCCTGTAATCCCAGCACTTTGGGAAGCTGAGGTGGGTGGATCACCTGAGGTCAGGAGTTCGAGACCAGCCTGACCAATATGGTGAAACCCCGTCTCTACTAAAAATATAAAAATTAGCCGGGTGTGGTGGCATGCGACTATAGTCCCAGCTACTCAGGAGGCTGAGGCAGGAGAATTGCTTGAACCCAGGAGGTGGAAGTTGCAATGAGTCGAGGTCACACCACTGCACTCCAGCCTAGGCAACAGAGTGAGACTCCATCTCAAAAAAAAAGAAAAAAA"
"GL873564","7705416","7705474","chr1","51463330","51463380","19","43757914","TCATGCCTGTAGTACCAGCACTTCAGGAGGCTGAAGCAGGAGCTAAGATTAGAAATTTG","CATGCCTTTAATCCCAACTACTTGGGAGGCTGAGGCGAGAATTGAAGTCCG"
"GL873564","8307239","8307551","chr14","30585163","30585473","93","22277924","GCACAGTGGCTCAGGCCTGTAATCTGAGCACTCTGGGAGGTTGAGGCTGAGGTTAGGAGTTAGGAGAACAGCCTGAGCAAGAGTGAGACCCCATCTCTACCAAAAATAGGGGAAAAAACTCCAAAAATCTAGCCACATGTTGTGGTACTTGCCTGCAATCCCAGCTACTGGGGCATAGGGGGACTGAGGCAAGAGGGTCACTTGAGCGTGAGAGATTGAGGTTGCTGTGAGCTAAGATGATGCCATGGCACTCTACCCAAGGTGGCAGAGTGAGCCTATGTCTCACCAATAAATAAACAAATAAATAAATGAA","GGGCACAGTGGCTCACGCCTGGAATCCCAGCACTTTGGGAGGTCAAGGTGGGTGGATCACCTGAGGTCAGGAGTTTGAGACCAGCCTGGCCAAAATGGTGAAACCCCATCTCTACTAAAAAAAATACAAAAAATTAGCCAGAATGTGGTGGTGCATGCCTGTAATCCCAGCTACTGGGGAGGCTGAGGCAGGAGAATCACTTGAACCTGGGAGGCGGAGGCAGCAGTGAGCCAAGATGGCGCCACTGCACTCCAGCCTGAGTGACAGAATGAGACTCTGCCTCAGGAAAAAAAAAAAAAAAAAAGCAAAAA"
"GL873564","8738781","8739084","chr6","92598388","92598711","90","83859607","GCTGGGCACAATGGCTCACACCTGTAATGCCAGCACTTGGGAGGCTAAGACGGGCAAATTGCCTGAGCTCACAAGTTCAAGACCCAGAGCGAGACCTCATCTCTAAAAAATTGCCATGCATTGTGGAGGGTGCCTGTTGTCCCAGCTACTTGGGAGGCGGAGAAAAGACAATCGCTTTAGCCCAAGAATTGAAGGTTGCTGTGAGCTGTGACGCTGTAGCACTCACCAAGGGCAACATAGTGAGACTCTGTTTCAAAATAAATAAATAAATAAATAAAAATAAATAAATAAAATAAAAACAAAA","GGCTGGGCTCAGTGGCTCATGCCTGTAATCCCAGCACTTTGGGAGGCCAAGGCTGGCAGATTGCCTGAGGTCAGGGGTTCAAGACCAGCCTGGCTAACATGGTGAAACCTCATCTCTAATAAAAATACAAAGATTAGCTGGGTTTGGTGGCACATGCCTGTAGTCCCAGCTATTTGGGAGGCTGAGGCAGGAGAATCGCTTGAACCCAGGAGTTGGAGGTTGCAGTGAGCTGAGATGGCACCACTGCACTCCAGCCTGGGTGACACAGCAAGACTCCGTCTCAAAAAAAAAAAAAAAAAAAAAAAAAAGAAAAGAAAAAAAAAA"
"GL873564","9560044","9560238","chrX","30236033","30236239","48","20675989","GGCCAGGTGCGGTGGCTCCTGCCTGTAATCCCAGCACTCTGGGAGGCCTAGGTGGGTGGATTGCCTGAGCTCACTGGTTGGAGACCAGCCTGATACAGATTGAGACCCCCTGCCTCTAAGAATAGCAGGGTGTTGTGACAGACACCTAAAGTCCCAGCTACTCGGGAGGCTGAGGCAAGAGAATCTCTTGAGCCC","GGCTGGGTGCGGTGGCTCACTCCTGTAATCCCAGCACTTTGGGAGGCCAAGGTGGGCGGATCACCTGAGGTCAAAAGTTCGAAACCAGCCTGACCAACAGGGTGAAACCCCGTCTCTACTAAAAGTACAAAAATTAGCCGGGCATGGTGGCAGGCACCTATAATCCCAGCTACTTGGGAGGATGAGGGAGGAGAATCACTTGAACCC"
"GL873564","9560508","9560604","chr1","212121416","212121513","30","202560908","TCGCTGTGCCCAAAAGTTAGAGGTTGCTGTGAGCTATGATACCACTGCACTTTACTGAGGGTGACAAAGTGAGACTCTGTCTCAAAAAATAAATAAA","CTTGAACCTGGGAGGTGGAGGTTGCAGTGAGCCAAGATCATGCCACTGCACTCCAGCCTGGGCAACAGAGCGAGATTCTGTCTCAAAAAAAAAAAAAA"
"GL873564","9753449","9753658","chr19","10370828","10371033","59","617379","TGAGACCCTGGTCTCTTCTAAACATTAAAAAAAAAAAGAAAACTGGGTGTTGTGGCGATGCCCATAGTCCCAGCTACTGATGAGGCTGAGGCAGGGGGATCACTTGAACCCAGGAGTCTGAAGTTGCTGTAAGCTAGGCTGAAGTCACAGTTGTCTAGCCTAGGGCAATAGAGTAAGACTGTCTCACAAAAAAAAAAAAAGGAAAGAAAA","GAAACCCTGTCTCTACTAAAAATACAAAAAATTAGCTGGGTGTGGTGGTGCGTGCCTATAATCCCAGCTACTCAGGAAGCTGAGGTGGGATAATCACTTGAACCTGGGAGGCAGAGGTTGCAGTGAGCCCCAGACTGTGCCACTGCACTCCAGCCTGGGTGACAGAGTCAGACCCTGTCTCAAAAAAAAACAAAACAAAAAAAAAA"
"GL873564","9753896","9754006","chr17","50277667","50277784","33","40523771","GCTGGGCAGGGTGGCTTGTGCCTGTAATCCTCACATTCTTGGAAGCCAAGTTGGTGGATTTCTTGAGCTCAAGAGTTCAGCCTGAACAACGGTGAGACCCCTGTCTCTCTC","CCGGGCATGGTGGCTCATGCCTGTAATCCCAGCACTTTGGGAGGCCAAGGTGGGTGGATCACTTGAGGTCAGGAGTTCAAGACCAGCCTGGCCAACATAGAGAAACTCTGTCTCTACT"
"GL873564","10693118","10693253","chr1","29437872","29437991","31","18744754","GGCCAGGCGTGGTGGCTCACGCCTGTAGTCCCAGCGCTATGGGAGGCCGAGGCGGGTGGATCACCTGTGCTCAGAGGTTCGAGACCAGCCAAGACCTCCCTGAGCCAAATGAGCCAGAGTGAGACCCCGTCTCTAC","GGCCGGGCGTGGTGGCTCACGCCTGTAATCCCAACATTTTGGGAGGCCAAGGCGGGTGGATCACCTGAGGTCAGAAGTTCGAGACCAACCTGGCCAACATGGTGAAACCCCTGTCTCTAC"
"GL873564","11596705","11596819","chr15","17759279","17759407","35","6162574","AATCCGCTACTCGGGAGTCTGATGCAGGAGGATCCCTGGAACCCGGGAGTGAGCTAGGCTGTCCATTCTACCCAAGGCAGAAGAGTGAGATTCTGTCTCAAAAAAAAAAAAAAAA","AATCCCAGTTACTCAAGAGGCTGAGGCAGGAGAATTGCTTGAACCCGGGAGGTGGAGCCGAGACCGCTCCACTGCACTCCAGCCTGGGTGACAGAGTGGGACTCTGTCTAAAAAAAAAAAAAAAAAAAA"
"GL873564","13278770","13278831","chr1","10318851","10318915","18","2959919","GGCTGAGCACAGTGGCTCATGTCTATAATCCCATCACTCTGGAAAGCTAAGAATGAGGATCT","GGCTAGGCATGGTGGCTTATGCCTATAATCCCAGCACTTTGGGAGGCTGAGGCAGACGGATCACC"
"GL873564","13278924","13279152","chr20","69116969","69117193","62","55838045","AAAATAGAGAATAAGAATCCCTTGAGCTCATGAGTTCAAGATCAGTCTGAACAAGTGTCAGACCCTATCTCTACTAAAAATGGAAAAATTAGCCAGGCACTGTGGCAAGTGCCTGTAGTCCCAGATTTCAGGAGGCTGAGGCAGGAGAATCATTTGAATCCAGGAGTTTGAGGTTGCTGTGAGCTAGGCTGACACCACTGTACTGTAGCCTGGGCAACAGAGTGAGACT","GAGGTGGGTGGATCACCTAAGGTCAGGAGTTCAAGACTAGCCTGGCCAACATGGTGAAACTCCATCTCTACTAAAAATACAATAATTAGCTGGGTGTGGTGGCATGTGCCTGTAATTCCAGCTACTCAGGAGGCTGAGGCAGGAGAATCACTTGAACCCAAGAGGCGGAGGTTGCAGTGAGCCGAGACTATGCCACTGCACTCTACCCTGGGCAACAGAGCAAGA"
"GL873565","1417041","1417214","chr4","44130284","44130433","54","42713243","GGCCAGGCGTGGTGGCTCACGCCTGTTGTCCCAGCGATTTGGGAGACTGAGGTGGGTAGATCACCTGTACTCAGAGGTTCGAGACCAGCTGAAGACCAGCCTGAGGCAGAGTGAGACCCCCGTCTCTATAAGAACAAGACAGCCGGACCTTGTGATCCCAGCTACATGGGTGGC","GGCCGGGTGCGGTGGCTCACACCTGTAATCCCAGCACTTTGGGAGGCTGAGGTGGGCAGATAACCTGAGGTCAGGCGTTCGAGACCAGCCTGGCCAACATGGTAAAACCCCGTCTCTACTAAAAATACAAAAATTAGCCAGGTGTGGTGG"
"GL873565","2138367","2138455","chrX","124155143","124155229","17","122016776","GGCTGGGCGTGGTACTCACGCCTGTTGTCCCAGTGCTGTGGGAGGCTGAGGTGGGTGGATCCCCTGAGCTCAGCAGAGTTTGAGACCAG","GGCTGGGTGCGGTGGCTCACGCCTGTAATCCCAGAACTTTGGGAGGCTGAGGTGGGTGGATCACCTGGGGTGAAGAGTTCGAGACCA"
"GL873565","2459722","2459938","chr7","32729330","32729532","57","30269608","AAAAAGACCAAACACCCCAGCTCTACTAAAAGTAGAAAAATTAGCTGGGTATTGTAGTGGGCACCTGTAGTCCCAGCTGCTTGGGAGGTTGCGGCAGGAGAACCACTTAAGCCCAGGAGTTGGAGGGTGAGGTGGGCTGAGGCCACTGCATTCTAGCCTAGGCAACAGAATGAGACTCTGTCTCAAACAAACAAACAAACAAACAAACAAAAAACAA","GAAACCCCATCTCTACTAAAAATACAAAATTAGCCAGGCATGGTGGTGCACACCTGTAGCTCCAACTACTTGGGAGGCTGAGGCAGGAGAATCACTTAAACCCAGGCAGTAGAGGTTGCAGTAAGCCAAGATCGCACCACTGCACTCCAGTCTGGGCAACAGAGTGAGACTCTGTCTCAAAAAAAAAAAAAAAAAAAAAAAAA"
"GL873565","2460219","2460297","chr10","28805224","28805297","28","26345005","CTCAAGCCTGTAATTCTAGCACAGCTGGGAGGCTGAGGCAGGAAGATCTCTCAGCTTAGGATTTCAAGACTAAACACAT","GTGGCTCATGCCTGTAATCTCAGCACTTTGGGAGGCTGAGGCAGGCAGATAACCTGAGGTCAGGAGTTCGAGAC"
"GL873565","11485258","11485580","chrX","66383160","66383473","97","54897902","GGCAGGGCACAGTGGCTCAATCACAGCACTCTGGGAGGAGGCTTAGATGGGTGGATTATTTGAGTTCACAAATTTAAGAACAGCCTGAGCAAGAGTGACACCCTGTCTCTACTAAAAAACAATAGGAAAAATAAAAACTAGCTGGGCATAGTGGCATATGCCTGTGGTTCCAACTACTTGGGAGGCAGAGGCAAGTTTGCTTAGCTAGTTTTTTTTCAGGCCCAAGAGTAGAGGTTGTTGTGAGCTGTGATGCCATAGCACTCTACATAGAGTGACAGAGTGAGACTTTGTCTAAATAAATAAATAAATAAAATTTTAAAAAA","GGCCAGGCACAGTGGCTCACACCTGTAAATCCCAGCACTTTGGGAGGCCGAGATGGGTGGATCACCTGAGGTCACGAGTTTGAGACCAGCCTGGCCAACATGGTGAAACCTCGTCTCTACTAAAAATACAAAAAAAAAAAAAATTAGCTGGGCGTGGTGGTGTGCACCTGTAGTCCCAGCTACTTGGGAGGCTGAGGCAGGAGAATCGCTTGAACCCAGGAGGCAGAGGTTGCAGCGAGCCGAGATCGCGCCACTGCACTCCAGCCTAGGTGACAGAGTGAGACTCTGTCTCAAGGAAAAAAAAAAAAAAAAAA"
"GL873565","13424539","13424574","chr1","174086158","174086184","14","160661619","ACCTAGGGTGAAAGTAAGACTGTCTCAAAAAAAGAA","AAGAGAGAGAAAGAGAGAAAGAAAGAA"
"GL873565","13424654","13424896","chr16","19730961","19731217","54","6306307","GCCAAGCACAGTGGCTCACACCTGTAATCCCAGCACTCTGGGAAGCCTAGGTGGGTGGATTACTTGAGCTCAGGAGTTCAAGATCAGCCTAAGCAAGAGTGAAACTCCCATGTCTAAATAAACAGCCGGGCATTGTAGTGGGTCCCTGTAGTCCCAGCTACTCAGGAGGCTGAGGCAAGAGAATCGCTTGACCCAGGAGTTGGAGGTTGCTGTGAGCTGAGGCCACGGCACTCTATCTAGGGT","GGCCGGGCACAGTGGCTCACGCCTGTAATCCCACCACTTTGGGAGGCCGAGGCGGGTGGATTACCTGAGCTCTGGAGTTAGAGACCAGCCTAGGCAACATGGTGAAACCCCATGTCTACTAAAATACAAAAAGCCGGGCGTGGCGGCGTGTGCCAATAGTCCCAGCTACTCAGGAGGCTGAGGCAGGAGAATTGCTAGAACCCGGGAGGCGGAGGTTGCAGTGAGCTGAGATCACGCCACTGCACTCCAGCCTGGGC"
"GL873565","13679578","13679856","chr1","27657515","27657797","72","13977937","GCAGGGTACAGTGGCTCACACCTGTAATCATAGTAACTCTTAAGCGGCTGAGGCAAGTGAGAGGCCTGAGATCAGGAGTCCAAGAATAGCCTAACCAAAAGTGAGACCCCATCTCTACTAAAAATAGAAAAAAACTAGCCAGGCATGGTGGCACTTACCATAGTCCCACCTCATAAGGCTGAGGCAAGAGTATCACTTGAACCCAGAAGTTTGAAGTTGCTGTCAGCTACAATGACATCATAGCACTTTACCCAGAGCTACAGAGTAAGACTCAGTCTC","GCTGGGTGCGGTGGCTCACACCTGTAATCTCAACACTTTGGGAGGCTGAGATAGGTAGATCACCTGAGGTCAGGAGTTCGAGACCAGCCTGGCCAACATGGTGAAACCCCATCTCTACTAAAAATACAAAAAACCTAGCCAGGCATGGTGGTGTGTACCTATAATCTCAGCTATTCAGAAGACTGAGACAGGAGAATCACTTGAACTTGGGAGGTAGAGGTTGCAGTGAGCCAAGATCACACCACTGCACTCCAGCCTAGGCAACAGAGTGAGACTCCGTCTC"
"GL873566","947388","947684","chr3","178868174","178868466","60","177920786","GGCCGGGTAGGGTGGCTCATGCCTGTAATCCTAGCATTTTGAGAGGCCAAGGCAGGTAGATTACCTGAGCTCAGGAGTTCCAGACCAGGCTGAGCAAGAGCCCCATCTCTATCAAAAATAGAAAAATTAGCTGGGTATGGTGGCACATGCCTNNNNNNNNNNNNNNNNNNNNNNNNNNNNNNNNNNNNNNNNNNNNNNNNNNNNNNNNNNNNNNNNNNNNNNNNNNNNNNNNATGACACCATAGCACTCTAACCTGGAGCAACAGAGTGAGACACCGTCTTAAAAAAAAAAAAAAAA","GGCCGGGTGTGGTGGCTCATGTCTGTAATCCCAACACTTTGGGAGGCCAAGGCGGGTGGATCACCTGAGGTCAGGAGTTTGAGACCAGCCTGGCCAACATAGTGAAACCCCTCTACTAAAAATAAAAAATTAGCCAGGTGTGGTGGCANNNNNNNNNNNNNNNNNNNNNNNNNNNNNNNNNNNNNNNNNNNNNNNNNNNNNNNNNNNNNNNNNNNNNNNNNNNNNNNNNNNNNNNNNNNNNNNCTCCAGGCTGGGCAACAGAGTGAGGCTCCATCTAAAAAAAAAAAAAAAAA"
"GL873566","2530056","2530102","chr1","123145244","123145289","11","120615188","AGGCCAAGGCAGTTGGATCACCTCAGCTCAGGAGTTTGAGACCCGCC","AGGCTGAGGGAGGCGAATCACCTGAGGTCAGGAGTTTGAAACCAGC"
"GL873566","2923434","2923499","chr1","38303497","38303565","19","35380063","GGGCTCAATGGCTCAGCCTGTAATCTTAGCAGTCTGGGAGGCTGAGGCAGGCGCCTGAGCAAGAGT","GCTGGGCGCAGTGTCTCGTGCCTGTAATCCCAGCACTTTGGGAGGCTGAGGCAGGCGGATCATCTGAGG"
"GL873566","3613441","3613522","chr3","54039458","54039545","21","50426017","GGTGGCACATGCCCGTGATCCCAGCACTCTGGGAGGCCGAGGAGATCGGACTGCCTGAGCTCAGGAGTTCGAGACCAGCCTG","GCGCGGTGGCTCACGGCCTGTAATCCTTGCACTTTGGGAGGCTGAGATGGGTGGATTACCTGAGCTCAGGAGTTCGAGACCAGCCTGG"
"GL873566","6100482","6100582","chr2","51286276","51286376","32","45185794","GGCTGGGTGAGTACCTCATGCATCAAGCCCAGTGTTCTGGAGGCTGAGGCAAGGGGATCCTTGATGTGGATAGTTCAAGGCCAGCCTGGCAATTAGCTAGA","GGCTGGGTGCAGTGGCTCACGCCTATAATCCCAGCACTTCGGGAGGCTGAGGCAGGCAGGTCACCTGAGGCCAGGAGTTCAAGACCAGCCTGGCCAACATG"
"GL873566","6245586","6245714","chr3","50507869","50508002","30","44262283","GCTGGGTGTGGTGGCTCACACCTATAATACCAGCACTTGGGAGGCCAAAGCAAGTGGATTGCCTGAGTTCACAAGTTCAAGACCAGCCTGAGCAAGAGTGAGACCCTGTCTCTTAAAAATAGGTGGGCG","GCCAGGTGCGGTGACTCACACCTATAATCCCAGCACTTTGGGAGGCCGAGGCACGTGAATCACCTGAGGTCAGGAGTTCAAGACCAGCCTGACCAACATGGTGAAACCTTGTCTCTACTAAAAATACAAAAACT"
"GL873566","6245992","6246162","chr16","22888303","22888475","37","16642311","TAGCTGGGCGTTGTGGCGGGCATCTGTAATCCCAGCTACCTGGGAGGCTGAGGCAAGAAAATCACTTAAGCCCAAGAGTTTGAGGTTGCTGTGAGCTGTGATGGCACAGTACTCTATTGAGGGCAACATAGTGAGACTCTGTCTCAAAAAATAAATAAATAAATAAATAAA","ATTAGCTGGGCGTGGTGGTGGGCACCTGTAATCCCAGCTTCTTGGGAGGCTGAGGCAGGAGAATCACTTGAGCCCAGGAGGCAGAGGTTGCAGTGAGCAGAGATCGTGCCACTGCACTCCAGCCTGGATGACAGAGTCAGACTTTGTCTCAAAAAAAATAAAAAATAAAAAAA"
"GL873566","6483968","6484033","chr19","10207852","10207913","17","3723884","AAAATATGGTAAAATAAGCCAAGGATGGTGGGTCACACCTGTAATCCCAGCTACTCAAGAGACTGA","TAAAAATACAAAATTAGCTGGGTGTGGTGGCACACACCTGTAATCCCAGCTACTCAAGAGGC"
"GL873566","7043395","7043464","chr10","28805224","28805297","20","21761829","GGCTAGGCCTGGTAATCCCAGCACTCTAAAAGGCTGAGGCAGGTGGATAGCCTGAGCAAGAGTGAGACCA","GTGGCTCATGCCTGTAATCTCAGCACTTTGGGAGGCTGAGGCAGGCAGATAACCTGAGGTCAGGAGTTCGAGAC"
"GL873566","7888407","7888429","chr16","1275850","1275872","4","6612557","CTAAAAATAAAAAATTAGTCTTG","CTAAAAATACAAAAATTAGCCAG"
"GL873566","7888682","7888751","chr13","39203832","39203891","22","31315150","GTAGTCTTGGCGTAGTGATATGTACCTTTAATCCCAGCTACTCAGGAAGTGGAGGAGGAAAGAGTACAAG","TTAGCTGGGCGTAGTGGTGTGTGCCTGTAATCCCAGCTACTTGGGAGGCTGAGGCGGGAG"
"GL873566","8203857","8203949","chr20","18199749","18199840","19","9995892","GGCCCGGCATGGTGGTGCTTTGCCTATAATCCCAGCATTCTGGGAGGCCCAGGCAGGCGGATCACCTGAGCTCACAGGTTCAAGAATGGCCTG","GGCCGGGCATGGTGGCTCACACCTGTAATCCCAGCACTTTGGGAGGCTGAGGCAGGCGGATCACCTGAGGTCAGGAGTTCGAGACCGGCCTG"
"GL873566","8268872","8268975","chr15","10815564","10815667","26","2546692","GTGGCTCATGCCTGTAATCCTAGCACTCTGGGAGGCCGAGGCAGGTGGATTCCCTGAGCTCATAGGTTTGAGACCACAAGCAAGTCCAAGACCCCATCTCTTTT","GTGGTTCATGCCTGTAATCCCAGCACTTTGGGAGGCCGAAGTGGGCGGATCACCTGAGGTCAGGAGTTTGAGACCATCTGGCCAAGATGTAGAAACCCCATCTT"
"GL873566","8269263","8269458","chr15","77706857","77707054","55","69437594","AAGACCCCATCTCTTAAAAAAGAAAAAAAAAGCTGGGTGTTGTGGCCTTCACCTGTAGTCCCAGCTACTGGGGAGGCCAAGGCAAGAGACTTGCTTGAGCCAGAGTTTGAGGTTGCTGTGAGCTATAGTGCCACGGCACTCTACCAAAGGCAACAAAGTGAGACTGTCAAAAAAAAAAAAAAAAGAAGAAGAAGAA","CCCCATCTCTATTAAATATACAAAAAAATAGCTGGGTGTGGTGGTGTGCGCCTGTAATCCCAGCTACTTGGGAGGCTGATGCAGGGGAAGTGCTTGAACCAGGGAGGTGGAGGTTGCAGTGAGCCGGAATCGTGCCACTGCACCCCAGTCTGGGCAACAGATTGAGACTCTGTCTCAAGGAAAAAAAAAAAAAAAAAA"
"GL873566","8592056","8592127","chr10","28805224","28805297","15","20213168","TCTTGCCTGTAATCTCAGCACTCTGGGAGGCTGAGGCAGGCAGATCAACTGAGCTAACAAGTTCGAGACCAG","GTGGCTCATGCCTGTAATCTCAGCACTTTGGGAGGCTGAGGCAGGCAGATAACCTGAGGTCAGGAGTTCGAGAC"
"GL873566","8809109","8809200","chr11","48033118","48033204","26","39224009","ATAGCCAGGCTTGTTGCAGGCACCTGTAGTCCCAGTTACTCTGGAGGCTGAAGCAAGGGAATATCTTGAGCCCAAGAGTCTGAGGTTGCTGT","TTAGCCTGGCATGGTGGTGACACCTGTAATCCCAGCTACTCAGGAGGCTGGGAAGGAAAATCGTTTCAACCCAGGAGGCAGAGTTTG"
"GL873566","8809477","8809608","chr19","10830410","10830544","33","2020933","GGCCAGGCGCAGTGCCTCATGCCTGTAATCCTAGAACTCCGGGAGGCTAAGGAGGGTGGATTTCCTGAGTTCACAGGCTGGAGACCAGCCTGATCTAGAGTGAGATTCCCAGCTCTAAAAATAGCTGGCCTT","GGCCAGGTGCAGTGGCTCATGCCTGTAATCCCAGCACTTTGGGAGGCCAAGGTGGGTGGATCACCTGAGGTCAGGAGTTCGAGACCAGCCTGATCAACGTGGTGAAACCCCATCTCTACTAAAATTGCAAAATTA"
"GL873566","9503716","9503881","chr12","63241189","63241340","56","53737473","TATTAAAAAAAAAAGGAATTCAAGGCCAAGAGCAGTGGCTTTTGCCTGTGATACTTCCACTGTAGGAGGCCGAGGTGGAAGGATCACTTGAACTCTGGAGTTTGAGGTTGCTGTGATCTAGGCTGACACCACAGCACTCTAACTTGGTGGGCAACAGAGCAAGACT","AAAAACAAAAATTAGCCAGGTGTGTTGGCATGCACCTGTAGTCCCAGCTACTAGGGAGGCTGAGACAGAAGAATCACTTGAACCCAGGAGGTGGAGGTTGAGTGAGCCAAGATCGCGCCACTGCACTCCAGCCTGGGTGACAGAGCGAGACT"
"GL873566","9537883","9537992","chr16","43341998","43342113","30","33804115","ATGCCTGTAATCCTAGCACTTGGGAGGCCAAGGTGGGTGGATTGCCTGAGATCACAGGTTCAAGACCAGCCTGAGCCAGAGTGAGACCCTGCCTCTAAAATGAGCCAGGT","GCCTGTACTCCCAGCACTTTGGGAGGCCAAGGCGGGTGCATCACCTGAGGTCAGGGGTTCAAGACCAGCCTGGCCAACATGGTGAAACTCTGTCTCTACTGAAAATTCAAAAAATT"
"GL873566","9538266","9538462","chr7","167658032","167658223","54","158119766","TTAATTAATTAATTAAATAAAATGAGCCAGGTGTTGTGATGGGCGCCTGTAGTCCCAGCTACTTGGGAGGTGGAGGCAGGATAATCACTTGAGTCCAGGAGTTGGAAGTTGTTGTGAGCTGTGACGCCATTGTACTTGACCCAGGGCGACATCTTGAGGCGCTCTCTCTCAAAATAAATAAATAAAGAAAGAAAGAA","TACTAAAATACATACAAAAATTAGCCAGGTATGGTGGCAGGCCCCTGTAGTCCCAGCTACTCGGGAGGCTGAGGCAGGAGAACTGCTTGAACCCAGGAGGTGGGGATTGCAGTGAGCTGAGATCGCACCACTGCACTCCAGCCTGAGCGACAGAGTGAGACTCTGTCTCAAAAATAAAAAAAGAAAAAAAAA"
"GL873566","13663722","13663916","chr1","23558411","23558571","70","9894689","CTCAAGACCAGCCTGAGCCAAGAACGAGACTGAAAATAGAAAAATTAGTGGGACGTTATGTTGAGTGCTGGCTACTCTAGAGGGTGAGGTAGGAGAATTGTTTAAACTCATGAATTTAAGGTTGCTGTGAGCTAGGCTGACGCCACAGCACTGTAGCCTGGGCAACAGGCTACAGAACAGAGTGAGACTCTGTTT","AAAAATACAAAAATTATCTGGGCATGGTGGTGGGTGCCTGTATTCCCAGCTACTCTGGAGGGTGAGGCGGGAGAATTACTTGAACCCAGGAGGTGAAGGTTGCAGTGAGCCAAGATCACGCCACTGCACTCTAGCCTGGGCAACAGAATGAGACTCTGTCT"
"GL873566","13664206","13664293","chr7","151280825","151280914","17","137616619","GGCTAGATATGGTGGCTCATGCCAGTAATCTTAGCACTTTGGGAGGCTGAGGGGAGAGGATCACTTGAGCTGAAAAGTTCAAGACCAA","GGCCAGGCATGGTGGCTCATGCCTGTAATCCCAACACTTTGGGAGGCTGAGGTGGGTGGATCACTTGAGGCCAAGAGTTCAAGACCAGCC"
"GL873567","8375378","8375469","chr3","123612391","123612479","29","115237013","GGTTGGGCTTGGTGGCACGTACCTATGATCATCCTAGCTACTCAGGGAGCATAAGGCAGAAGAATTGCTTTAGCCCGGGAGTTGAGATCAAC","TTAGTTGGGCGTGGTGGCGCATGCCTGTAATCCCAGCTTCTCGGGAGGCTGAGGCAGGAGAATGGCTTGATCCCAGGAGATAGAGGTTG"
"GL873567","9062667","9063009","chr7","6620384","6620702","97","2442283","GGCCAGGCGTGGTGGCTCACGCCTGTTGTCTCAGCGCTGTGGGAGGCCGAGGCGGGTGGATCGCCTGTGCTCAGAGGTTCGAGACCAGCATGAGCCAGAGTGAGAGCCAGAGTAAGACCCCCTCTCTACCAAAAATTGCTGGGTGTTCTGGCAGGTGCCTGTAATTCCAGGTACTTGGGAGGCTGAGGCTAGAGAATCACTTAAACCCAGGGACCCAGGGGTTGGCGGAGGTTGCTGTGAGCTATGATTCTATGGTATTCTACTGAAGGACACAAAGCGAGACTCTGTCTCCATAAATAAATAAATAAATAAATAAAATAAAAGCAAAATTAAAAAAAAAAAA","GGCCAGGCACAGTGGCTCATGTCTGTAATCCCAGCACTTTGGGAGGCCGAGGCGGGTGGATTACCTGAGGTCAGGAGTTCTAGACCAGCCTGGCCAACAAGGCGAAACCCTGTCTCTACTAAAAATACAAAAAATTAGCTGGGCGTTTTGGCACATGCCTGTAATCCCAGCTACTTGGGAGGCTGAGGCAGGAGAATTGCTTGAACTGGGGAAGTGGAGGTTGCAGTGAGCTGAGATCACACCATTGCACGCCTGAGCAACAGAGCGAGACTCTGTCTCAAAAAAAAAAAAAAAAAAAAAAAAGAAAAGAAAAAGAAAA"
"GL873567","11215752","11215787","chr1","62915138","62915167","12","51699386","CAATAAAGCAAGACTCTGCCTCCAAAAGAAAAAAAA","CAAACAAACAAACATCACAAAAAAAGAAAA"
"GL873567","11215868","11216117","chr8","45194211","45194474","73","33978343","GGCTGGGTGTGATGGTTCAGGCCTGTAATCCCAGCGCTCTGGGAGACCAAGGCAGGATAGCCTGAGGTTAAGAGTTTGAGACCAGCCTGAGCAACACAAGACCCTGTCTAAACCAGGAAAATTACTGGGGTGTGGTGGCGTGTGCCTTAATCCCAACTACTCAGGAGGCTAGAGTATTGCTTGAGGGCAGAAGACTGAGGTTGCTGTGAGGAAAGGCTAAGGTCAAGCCATTCTAGCCCAGGCAATAGAG","GGCCGGGTGTGGTGGCTCATGCCTGTAATCCCAGAACTTTGGGAGGCCAAGGCAGGTAGATTACCTGAGGTCAGGAATTGGAGACCAGCCTGGCCAACATGGTGAAACCTCTTCTGTACTGAAAATTACCTGGGCATGGTGGCACACGCCTATAATCCCAGCTACTCAGGAGGCTGAGGCAGAATTGCTTGAGCCCGGGAGACAGAGGTTGCAGTGAGCCAAGATCGTGCCACTGTCCTCCAGTCTGGCCAACAGAGCAAGACT"
"GL873567","12342574","12342696","chr3","166690011","166690120","46","154347437","GTACGCGCAAACCAGAAAAATCAACTAGGTGTGGCAGGGCACACCTGTAGTCCCAGCTACTGGGGAGGGTGAAGCAAGAGATTGCTCAAGTCTGAGGTTACAGTGAGTTAAGATGATACCACT","TACACATACAAAAAATCAGCTGGGTGTGGTGGTACATGCCTGTAATCCCAGCTACTCAGGAGGCTGAGGCCGGAAAATCACTTGAACCCAGGAGGCAGAGGTTGCAGTGA"
"GL873567","12342734","12342873","chr8","96368294","96368428","43","84025560","GGCCAAACACAGTAGTTTATACCTATAATTCCAGCACTCTGGGAAGCTGAAGCAGAAGGATCAGCTGAGGTCAGGAGCCTCAAGACAAGCCTGGGCAAGACTAAGACTCCCCTCCATCCCTTCCCCCACTGTCTTCTCAC","GGCCAGACACAGTGGCTCACACCTGTAATCCCAGCTCTTTGGGAGGCTGAGGCAGGCGGATCACCTGAGGTCAGGAGTTCAAGACCAGCCTGGCCAACATGGTGAAACTGCATCTCTACTAAAAATATAAAACCA"
"GL873568","4322030","4322103","chr11","54983169","54983243","11","50661139","GGCCAGGCGCAGTGGCTCATGCCTTTAATCATAGCACTCTGGGAGGCTGAGGTAGGCGGATCTCCTGAGCCAGG","GGCCAGGTGCAGTGGCTCATGCCTGTAATCCTAGCACTTTGGGAGGCCGAGGTGGACCGATCACCTGAGGTCAGG"
"GL873568","4439574","4439747","chr7","26745376","26745549","54","22305802","GGCTGGGCATGGTGCTCACACCTGTAATCATAGCACTCAGGGAGGCCGAGGTGAGTGGATTGCCAGAGCTCACAGGTTTGAAACCAGACAGAGCCTTTTTTTTTTTAGAAGAAATTGTAGGCTGGGCATGGTGCTCATACCTGTAATCATAGCACTTGGGAGGCCAAGGCAAGA","GGCTGGGCATGGTGGCTCACGCCTGTAATACCAGTACTTTGGCAGGCCGAGGCGGGCAGATCACCTGAGGTCAGGAGTTCAAGACCAGCCTGGCCGTTTCTACTAAAAATACAAAAAATTAGCTAGGCATGGTGGTGCGCACCTGTAATCCCAGCTACTCGGGAGGCTGAGGCA"
"GL873568","4546898","4547014","chr15","31980678","31980795","24","27433780","GGCAGGGTGTGGTGTACACCCCTATAATCCCAGCACTTTGGGAGGCTAAGGCAGGAGCATCACCTGGGGCAGGAGTTCAAGGCCAGCCCGGAGAACAGAATGAAACTCCATCTCCAC","GGCAGGGCGTGGTGGCTCACGCCTCTAATCCCTGCACTTTGGGAGGCCAAGGCAGGCAGATCACCTGAGGTCAGAAGTTCAAGACCAGCCTGGCCAATGTGGTGAAACCCCATCTCCA"
"GL873568","5509331","5509406","chr12","122182458","122182528","25","116673127","TAATCCTAGCACCCTAGGAGGCCCAGGTGGGTGGATTACCTGAGCTCAGGAGTTCAAGAGCAAAAGTGAGACCCCT","CCCAGCACTTTGGGAGGCCAAGGCAGATGGATCACCTGAGGTCAGGAGTTGAAGACCAGCCTGGCCAACAT"
"GL873568","5509687","5509883","chr11","2904691","2904882","40","2604996","GTGAGACCCTTGTCTCTACTAAAAGTAGAAAAACTAGCCAGGTGTTGTGGCAGGTGCCTGTAATACCAGCTACTTAGAAGGCTGAGGCAGGAAGATCAGTTGAACCAAAGAGTTTGAGATTGCTGTGAGCTATGATGAAGCCACAGCACTCTACTATCCAGAGCGACAGAGGGAGACTCTGTCTCCAAAAAAAAAAA","GTGAAACCCTGTCTCTACTAAAAATACAAAAATTAGCCAGGTGTGGTGGTGCATGCCTGTAATCCCAGCTACTCAGGAGGCTGAGGCAGGAGAATCACTTGAACCCAGGAGGTGGAGGTTGCAATGAGCCAAGATCGTGCCACTGCACTCCAGCCTGGGTGACAGAGCGAGACTCCATCTCAAAAAAAAAAA"
"GL873568","7119774","7119822","chrX","41233833","41233871","13","34114059","AAAAGTAAAAAATGAGCCGGGTGAGGTAGCTCACGCCTGTAATCCCAGC","AAATCAGCCGGGTGTGGTGGCTCACGCCTGTAATCCCAG"
"GL873568","10881797","10881967","chr1","164648998","164649168","46","153767201","AAAATCACATATTTGCCTGGCATGTTGACTCATGCCCCTATGATCCTAGCACTCTGGGAGGCTGAGGCAGGAGCCTCACTTGAGTCTGTGAGTCTGAGGTTGCTATGAGCAAGGCTGATGCCATGATACTCTAGTGTGGTACAACAGAGTGAGACTCTGTCTCAAAAAAAA","AAAAACACATATTAGCTGGGTATGGTTGTGCGTGCCTGTAATCCCAGCTACTTGGAAGGCTGAGGCAGGAGAATCACTTGAACCCGTGAGGCGGAGTTTGCAGTGAGCTGAGATTGTGCCACTGCACTCCAGCCTGGGCAACAGAGCAAGACTCTGTCTCAAACAAACAAA"
"GL873569","1403943","1404082","chr2","53765152","53765289","48","52361209","AAGCTGAAGCAGAAAAACGGGCTAGAGGTCAAAAGTTTGAGACCTACCGTGGCTACACAGCAAAACTCTGTCTCTAAAAAAAATAAATAAGACCAGGTAAGGTGGTCATGACTATACTCCTAGCCCCTTAAGAGGCTGAG","GAGGTGGGTGGATCACCTGAGGTCAGGAGTTCCAGAACAGCCTGGTCAACATGGCGAAACACTGTCTCTACTAAAAATACAAAAATTAGCCAGGTGTGGTGGCATGCACCTGTAGTCCCCGCTACTCAGGAGGCTGGG"
"GL873569","7343422","7343556","chrX","124155286","124155406","55","116811864","TTTGAAAGTAGACTGCAAACATCATGTTGCTTCACCTCTAAATATATTAATATGGGCCAGGTGCAGTGGATCATGCCTGTAATCCTAGCACTTGCTAGGCCAAGGCTGGCGGATAGCCTGAGCAACAGCGAGACC","ATCAGCCTGACCAACATAGTGAAACCCCATCTCTACTAAAAATGCAAAATTAGCTGGGCGTGGTGGTGCATGCCTGTAATCCCAGCTACTTGGGAGGCTGAGGCGGGAGAATCACTGGAAC"
"GL873569","7404564","7404762","chr6","586928","587122","48","6817636","GAGATCCCATCTCTTAATGAAAATAAAACAATTAGCTGCTATTGTGGCAGGCACCTGTAATTCCAGCAACCCAGGAGGCTGAGGCAGGAGGATCACGTGAACCCCACCAGTTTGAGGTTGCTATGAGCCAGGCTGATGCCAGGACACTCCAGCCTGGGCAACGGAGTGAGACTCCATCTCCAAAAAAAGCAAACAAAAA","GAAACCCCATCTGTACTAAAAACACACAAATTAGTGGGATGTGGTGGCACGTCCCTGTAATCCTAGCTATTCAGGAGACTGAGGCAGGAGAATCACTTGAACCCAGGAGGTGGAGGTTGCAGTGAGCCGAGGTCACACCACTGCACTCCAGCCTGGGCAGCAGAGTAAGACTCCATCTCAAAACAAAAACAAAAA"
"GL873569","7405040","7405133","chrX","21386588","21386682","29","13981548","GGGCAGGGCGGCTCAGGCCTCTAATCCTAGCACTCTGGGAGCTTCCTTGAGCTCAGGAGTTCAAGACCATCCTAAGCAACAGAGATCCCATCTC","GCTGGGCACGGTGGCTCACGCCTGTAATCCCAGCACTTTGGGAAGCCAAGGTTTGAGGTCAGGAGTTCAAGACCAGCCTGGCCAACAGGCTGCAA"
"GL873548","15249374","15249463","chr5","46485072","46485159","19","31235698","GGCCAGGCATGGTGGCTCATACCTATTGTCCTAGCACTGTGGGAAGCCAAGGCAAGTGGATCACCTGAGCTCTAGAGGTTCGAGACCAGC","GGACAGACACAGTGGCTCATGCCTGTAATCCCAGCAGTTTGGGAGGCCAAGGCAGGTGGATCACCTGAGGTACAGAGTTCAAGACCAG"
"GL873548","15817199","15817306","chr7","158031905","158031997","37","142214706","AAAAAAAAAGAGTTGGAGGTTGCTATGAGCAACATCAGCATGGCACTCAATTCCAGGGTGACTGACTGAGACTGTTGTAGCTATACTCCAAAAAAAAAAACACACAAA","CCAGGAGGTGGAGGTTGCAATGAGCCAAGATCACACCACTGCACTCCAGCCTGGGTGACAGGGTGAGATTCTGTCTCAAAAAAAAAAAAAAAA"
"GL873548","15817589","15817786","chr3","3025868","3026088","60","12791721","GGCCAGGCATGGTGGCTTCTGTAATGCCAGCATTCTGGAAGGCTGAGGTAGGCAGTAGCTTGAGCTCAGTAGGAGAACAGCCTGACCAAAAGTGAGACCCTGTCTCTAAAAATAGTCGTTTGTGGTGGTTACCTGTTGTCCCAGCTACTAGGGAGGCTGAGGCAAGAGAATCACTTGAGCGTAAGAGTTGGAGGTTGC","GGCCAGGCACGGTGGCTCATGCCTGTAATCCCAGAACTTTGGGAGGCTGAGGTGGGCAGATCACCTGAGGTCAGGAGTTGGAGACCAGCCTGACCAACATGGTGAAACCCTGTCTCTACTAAAAATACAAAATTAGCCAGGTGTAGTGGCACGTGCCTGTAATCACAGCTACTTAGGAGGCTGAAGTAGGAGAATCACTTGAACCTGGGAGGTGGAGGTTG"
"GL873548","15856498","15856605","chr18","35090078","35090171","38","19233580","CCCCCCCCAAAAAGAAAAGGGTTGCTTGAATCTAGGAGTTTGGGGTTGCTGTGGGCTAAGCTGATACCACAGCACTTTAGCCTGAGCAAACAGAGTGACACTCTGTCT","AAGCAGGAAATCGCTTGAACCCAGGAAGCAGAGTTGCAGTGAGCCAAGATCGCACCACTGCACTGCAGCCTGAGCAACAGAGAAAGACTCTGTC"
"GL873548","15856683","15856877","chr3","3200882","3201085","53","12655801","GCCAGGCACAGTGGCTCATGCCTATAATCCTAGCACTCTGGGAGGCCAAGGCAGGATTGTCTAAGCTTGGGAGTTTGACAGCAGCCTGAGAAAGATTGAGACCCCTGTCTCTACTAAAAAATAGAAAAATTAGCTGAGTGTTGCAGCAGGTGCCTGTATTTCCAGCCAAGGGGGAGGTTGAAAAGGGTCGCTTCA","GGCCAGGCGCAGTGGCTCATGCCTGTAATCCCAGCACTTTGGGAGGCCGAGGCGGGTGGATCATAAGGTCAGGAGTTTGAGACCAGCCTGGTCAACATGGTGAAACCCCATCTCTACTAAAAATACAAAAATTAGCTGGGTGTTGTGGCACATACCTGTAATCCCACCTACTCAGGAGGCTGAGGCAGGAGAATCACTTGAACC"
"GL873549","1940307","1940608","chr12","9481260","9481565","74","7540953","GGCTGGGCGCAGGGGCTCATGCCTGTGACCCTAGCACCCTGGGAAGCCAAGGCGGGCAGATCGCCTAAGCTCACGAGTTTGAAACCAGCCTTAGCTAGAGTGAGACCCCCAATACTAAAAAAATAGCCAGGCTTTGTGATGGGCGCCTGTAGTCCCAGCTACCTGGGAGGCTGAGGCAAGAGAATGGCTCAAGCCCAAGAGTCTGAGGTCACAGTGAGCTACTGACGCCACCGCACTCTATTGGAACAACAAAGTGAGACTGTGTCTCAAACAAACAAACAAACAAACAAACAAAAAAGAAA","GCTGGGCGCGGTGGCTCATGCCTGTAATCCCAGCACTTTGGGAGGCCAAGGCAGGTGGATCACCTGAGGTCAGGAGTTCGAGACCAGCCTAGTCCACATGGTGAAACCCCATCTCTACTAAAAACTAGCCAGGCGTGGTGGTGCGCACCTGTAATCCCAGCTACTCGAGAGGCTGAGGCAGGAGAATCACTTGAGCCTAGGAAGCAGAGGTTGTGGTGAGCTGAGATCACACCACTGCACTCCAGTCTGGGCGACACAGTGAGACTCTTGTCTCAAAAACAAAAAACAAACAAACAAACAAACAAA"
"GL873549","2657819","2658019","chr11","18547798","18548000","50","15889979","GGCCTGGCACTGTGGCTCACACCTGTCAGGTTAACACTCTGGGAGGCTGATATGGGTGGGTCTCCTGAGTTTAGGAGTTTAAGACCAGCCTAATCAAGAGTAAGACCTGCCTTTACTAAAAATAGAAACACTCACCAGGACTACTGTGCACCTACAGTCCCAGCTACCTGGGAGGCTGAGGCAAGAGGATTGCTCAAGCCC","GGCCAGGCACTGTGGCTCACACCTGCAATCCCACCACTCTGGGAGGCAGAGGCAGGTGGATCACCTGAGGTCAGGAGTTTGAGACCAACCTGGCCAACAGAGCAAAACACTGCCTCTACTAAAAATACAAAAACTAGCCAGGTGTGGTGCATGCCTATAGTCCCACCTACTTGGGAGGCTGAAGCAGGAGAATCTCCTGAGCC"
"GL873549","8853848","8853952","chr12","88112976","88113081","32","79259128","AGCCAGCTGTGTGGCTCATTCCAGTAATTCCAGTTACTGGGGAGGCTGAGACAGGAGGATCACTTGAATGCAAGAGGTGGCGAGAACTCAGCTTTAAAAATAAAA","GGCCAGATGCAGTGGCTCATGCCTGTAATCCCAGCACTTTGGGAGGCTGAGGCAGGCGGATCACCTGAGATCAGGAGTTTGAGACCAGCCTGGCCAACATGGTAAA"
"GL873549","10378794","10378882","chr20","18199749","18199840","17","7820955","GGCCAGGCACGGTGGTTCACCTGTGATCCCAGCACTCTGGGAGATAAGGCAGGCTGATCACCTGAGTTCACAGGTTGGAGACCAGCCTG","GGCCGGGCATGGTGGCTCACACCTGTAATCCCAGCACTTTGGGAGGCTGAGGCAGGCGGATCACCTGAGGTCAGGAGTTCGAGACCGGCCTG"
"GL873549","15488169","15488282","chr10","38476693","38476794","41","22988524","CTGAGCACACGGGTTCACACCTGTAATCCCAGCACGCTGAGAAGCCCAGGCAAGAGGCTGACCTCCAGCCTGGGTGACGGAGCGAGATTCCCCCCCACCCCCGACCAAAAAAAA","CTGAGCGCTGGTAGCTTACACCTGTAATCCCAGCACTTTGGGAGGCCTAGACAGGCGGATCACTTGGGGTCAGGAGTTTGAGACCAGCCTGGCCAATATGAT"
"GL873549","17403348","17403519","chr10","38461164","38461337","46","21057816","GCCAGGCACAGTGGCCCACACCTGTAATCCCAGTACTGTGGGAGGCTGAGGCAGGCTGAGGCAGGCATGGATCACTGAGGTTGCTGTGAGCTAAGATGCCATGGCCCTCCACCCAAAGTGACAGAGTGAGACTCTGTCTCAGAATTAAAAAAAACAAAGAAAGAAAAATAAA","GCCAGGCATGGTGACTCACGCCTATAATCCCAGCACTTTGGGAGGCTGAGGCATGAGAATCACTTGAACCCAGAAGGCAGAGGTTGCAGTGAGCTAAGATTGTGCCACTGTACTCCTGCCTGGGTGATGGAGTGAGACTCTGTCTCGATTTAAAAAAAAAAAAAAAAAAAAAAA"
"GL873550","801968","802043","chr15","50500527","50500602","20","49698559","GTAGCCAGGTATGGTAGTGCAGGCCTGTACTCCCAGCTACTTGGAAAGCTAAGGCAATAGAATCATTTAAGCCCAG","TGGCCGGGCATGGTGGTACATGCCTGTAATCCCAGCTACTTGGGAAGCTGAAGCAGGAGAATTGCTCGAACCCAGG"
"GL873550","802343","802376","chr3","33494224","33494257","9","32691881","TAAGACTTTGTCTCTACTAAAAATAGAAAAAGTG","GTGAAACCCGTCTCTACTAAAAATACAAAAATTA"
"GL873550","2805841","2805900","chr2","93673843","93673900","18","90868002","CTATTCAAAATAGCTAAAATGGGCAGGGCAAGGTGGCTCACACCTGTAATCCCAGTACTC","TAAAAATGTAAAAGATTGGCCGGGTGTGGTGGCTCACTCCTGTAATCCCAGCACTTTG"
"GL873550","4153085","4153214","chr16","18855701","18855834","37","14702616","GGCAGGGCTTGGTGGTAAAAGCCTGTAATCCTACCACTCTGGGAGGCAGAGGTGGTTAGATTGCATGAGGTCACTGGTTGGAGACCAGCCTGAGCTAGAGCAAGACCTCATCTCCAAAAATAGCAGGGCT","GGCTGGGCGCGGTGGCTCACACCTGTAATCTCAGCACTTTGGGAGGCCGAGGTGGGTGGATCACCTGAGGTCAGGAGTTCGAGACCAGCCTGGCCAACATGGCAAAACCCCATCTCTACAAAAATACAAAATTA"
"GL873550","4153472","4153634","chr7","17472856","17473028","43","13319384","AATAAAAATAGCAGGGCTTTGTGGCGGGCACCTGTAGTCCCAGCTACTTGGGAGGCTGAGGCAAGACAATTGCTTGAGCACAAAGTTGGAGGTTGTTGTGAGCTGTGACATCATAGCACTCTACCAAGGGAGATAGAGTGAGACTATCTCGAAGAAAAAAAAA","ATACAAAAATTAGCCAGGTGTAGTGGCGTGCACCTGTAATCCCAGCTACTCGGGAGGCTGACGCATGAGAACTGCTTGAACTCAGGAAGTGGAGGTTGCAGTGAGCTGAGATAGTGCCACTGCACTCCAGCCTGGGTGACAGAGCAAGACTCCATCTCAAAAAAAAAAAAGAA"
"GL873550","6050671","6050965","chr7","84009904","84010193","74","77959233","GGTGGCTCACGCCTGTTATCCTAGCACTCCAGGAGACTAAGGTAGGAGGATGCCTTGCTTGAACTCAAGAGTTCAAGACCAGTCTGAGTGAGAGGGAGACCCTGCGTCTACTCAAAAATAGAAAAATTTACCAGCCATTGTGGCCAACACCTGTAGACCCAGCTATTCAGGAGTCTGAGGCCAGAGAATCACTTGAACCCAGGAGACTGAGATTGCTGTGAGCTAGGCTAAAACCATGGCACTCTAGCCCAGGTGGCAGAGTGAGACTGGGTCTGCAAAAAATAAATAAAAACAA","TGGCTCATGCCTGTAATCCTAGCACTTTGGGAGGCCAAGGCAGGTGGATTGCCTGAGCTCAGGAGTTCAAGACCAGCCTGGCAACACGATGAAACCCCGTCTCTATTAAAAAATACAAAAAATTGGCCAGGCATGGTGGTGTGCACCTGTAATCCCAGCCACTCAGGAGGCTGAGGCAGGAGAATCGCTTGAACCCGGGAGACAGAGGTTGCAGTGAGCCAAGATCGAACCATTGCACCCCAGCCTGGGTGAGAGTGAGACTCTGTCTAAAAAAAAAAGAAGAAAAAGAA"
"GL873550","6212004","6212068","chr19","50425309","50425373","23","44213305","AGAACCTAAGAGTTTTGAGGTTGCTATGAGCTGGACTGATACCATAGCATTCTAGTCTGGGTGAC","TGAACCCAGGAGGTGGAGGTGGCGTGATGCCCAAGATGTGCCACTGCACTCCAGCCTGGGTGATA"
"GL873550","6212319","6212418","chr17","89042086","89042197","34","82829767","CTGTCTTTTCTAAAAATAGAAAAACTAGCTGGGTTGTGGTGGGCACTTGTAGTCCTAGGTACTCTGAGGCTGAAACAGGATTGCTTGAACCTAAGAGTTT","GTCTCTACTAAAAATACAAAAATTAGCCGGGCATGCTGGTGGGCACCTGTGATCTCAAGCTACTTGGGAGGCTGAGGCAGGAGAATCACTTGAACCTGGGAGGCAGAGGTTG"
"GL873550","6504310","6504401","chr19","2969698","2969794","27","3534612","GTGCTGGTGTATGCACCTGTCATACCAGCTACTCCTGAGGTTGAGGCAGGATAGCTTGAACCCGGGAGTCTGAGACTGCAGTGAGCTGGGAT","TTAGGCGTGGTGCATGTCTGTAATCCCAGCTACCCGAGAGGCTGAGGCAGGAGAATCACTTGAACCTGGGAGGCGGAGGTTGCAGTGAGCCGAGATC"
"GL873550","7178331","7178523","chr19","40691105","40691269","60","33512774","GGCCAGACGCGGTGGCTCACGCCTGTTGTCCCGGCACTGTGGGAGGCCGAGGCTGGTGGATCCCCTGAGCTCAGCCAAGTTCAAGACCAGCGGAAGACCAGCATGAGGCAGAGTGAGCCAGAGTGAGACCCCGTCTCTACAACAACAACAACAAAAAATAGCCGGACCTTGTGATCCCAGCTACATGGGAGGC","GGCCGGGCATGGTGGCTCACGCCTGTAATCCCAGCACTTTGAGAGGTCGAGGCAGGTGGATCACCTGAGGTCAGGAGTTCGAGACCAGCCCGGCCAATATGGTGAAACCCCTTCTCTACTAAAAATACAAAAAATTAGCCGGAAGTGGTGGCATGCACCTGTGAT"
"GL873550","7981631","7981790","chr6","148611209","148611366","40","140629578","ATAGCCCCGCCTTGTGGTAGGCTCCTGTAGTCCCAGCTACTTGGGAGGCTGGGGCAAGAGAATCACTTAGGCCCAAGAGTTGGAAGTTGCTGTGAGCTGTGATGCTACAGCATTCTACTGAGAGTGACAAAATGAGACTCTGTTTAAAAAAAAAAAAAAA","TTAGCTGGGCATGGTGGCAGGTGCCTGTAATCCCAGCTACTCTGGAGGCTGAAGCAAGAGAATCGCTTGAACCCAGGAGGTGTAGGTTGCAGTGAGTCGTGCCACAGCACTCCATCCTGGGTGACAGAGCAAGACTCTGTCTCAAAAAAAAAAAAAAA"
"GL873550","7982053","7982180","chr2","182489403","182489528","28","174507350","GGCTGGGCGAGGTTGTTCAGACCTGTAATCCTAGCACTCTGGGAGACCAAGATGGGTGGATTGCCTGAGTTCATGAGTTTGAGACCAGCCTGAGCCAGAGTGAAACCTTGTTCTCTAAAAATAGCTCG","GGCCGGGTGTGGTGGCTCATGCCTGTAATCCTAGCGCTTTGGGAGGCCGAGGTGGGTGGATTGCCTGAGCTCAGGAGTTCGAGACCAGCCTGGGCAACACGGTGAAACCTGTCTCTACTAAAATAC"
"GL873550","8404122","8404320","chr4","121405930","121406135","43","113001808","GGCCAGGCACAGTGACTCACACCTGAAATCTTAGTACTCTGGGAGGCCAAGGTGGGAGGATTTCCTGAGGTCAGGAGTTCAAGACCAGCCAGAGCAAGAAGATCCTGTCTCTACTAAAAGTATAAAAAGTGAACCAAGTGTGGTAGTGAGCACCTATAATCTCAGCTACTTGGGAGGCCGAAGCAAGAGGATCACTTGA","GGCCAGGCACAGTGGCTCACACCTGTAATCTCAACACTTTGGGAGGCCAAGGTGGGTGGATCACCTGAGGTCAGGAGTTTGAGACAAGCCTAGCCAGCATGGTATAACTCCATCTCTACTAAAAGTATAAAAATCAACCAGGTGTGGTGGCACATGCCTGTGGTCCCAGCTACTTGGGAGGCTGAGGCAGGAGAATCACTTGAATC"
"GL873550","8404408","8404483","chr15","701469","701538","22","7702939","AGGATCTCTTGAGCTCGGGAGTTTGAGGTTGCAGTGAGCCAGGCTGATGTCATGGCACGCTACCCAAGACAACAAA","AATCACTTGAACCCAGGAGGCAGAGGTTGCAGTGAGCCAAGACTGTGCCATGGCACTCTAGCCTGGGCAA"
"GL873550","11648593","11648682","chr3","124881947","124882027","31","113233354","GTGGCTCACACTAGTAATCTTAGTACTTTGGGAAGCTGGGGCAAGAGGATCACTTGAGGTCAGGGTTAGGAAACTCTATCACTACAAAAA","GCGGTGGCTCACGCCTGTAATCCTAGCACTTTGGGAAGCCAGGCAGGCAAATCACGAGGTCAGGAGTTCGAAACCAGCCTG"
"GL873550","12468624","12468663","chr9","62916303","62916339","11","50447679","GCCCGGCTTGGTACCTCATGCCTGTAATCTTAGCACTCCG","GGCCGGGCATGGTGGCTCATGCCTGTAATCCCAGCAC"
"GL873550","12468943","12469188","chr12","70524409","70524645","91","58055466","AATCTTAGCACTCCGGGAGGCCGAGGCGGGTAGACCAACCTAATCAAGAGCAAGATCTACCTCTACTAAAAATAGAAAAGAATTGGCCAGGCGTATTGACTCCGCCTCTAGTGCCAGCTACTCCAAAGCTGAGGCAAGAGGATTGTTCAAATCCAAGAGTTTGAAATTGCTGTATGTTACACCAGGGCACTCTAGCCGTGGAGACATTTTCTCTATATATATTAAAAAAAACAAAAAACAGAAAAA","CTGAGCTCGGGAGTTCGAGACCAGCCTGACCAATATGGAGAAACCCTGTCTCTACTAAAAATGTAAAATTAGCCAGGCATGGTGGCACATGCCTGTAGTCCCAGCTACTCAGGAGGCTGAGGCAGGAGAATCGCTTGAGGTCAGGAGGCGGAGGTTGCAGTGAGCCAAGATCATGCCACTGCACTCCAGCCTGGGTGACAGAGTGAGACTTTGTCTCAAAAAAAAAAAAAAAAAAAA"
"GL873550","14719674","14719880","chr16","30390993","30391163","76","15671319","GGGCGTGGTTGCTCACGCCTGTTGTCCCAGCGCTGTGGGAGACCGAGGCAGATGTATCGCCTGAGCTCAGCCGAGTTCGAGTTCGAGACCAGCGGAGAGACCACCATGAGGCAGAGTGAGCCAGAGTGAGACCCCGTCTCTACAACAACAACAAAGAAAACAGCCGGATCTTGTGATCCCAGCTACATGGGGGCCAAGAGAATCACT","GGGCACGGTGGCTCACACCTGTAATCCCAGCACTTTGGGAAGCCAAGGCAGGAGGATCACCTGAGGTCAGGAGTTCAAGACCAGCCTGGCCAACATGGTGAAACCCCGTCTCTACTAAAAACACAAAAATTAGCCAGGTGTGGTGGTGCACGCTTGTAATCCCAGCTACTC"
"GL873550","15737883","15738154","chr2","20481557","20481833","73","4743674","TTAGCATTCTGGGAGGCCAAGTCAGGTGGATTGCCTGAACTCACAAATTTGAGACTAGCCTGAGATAGAGAAAGATCTTGTCTCTAAAAAAAAAAAAAAATAGCTGGACTTTGTAGTGGGCACCTGTAGTCCCTGCTACTCAGAAGGCTGTGGTAAGAGAATCACTGGAACCCAAGAGTTAGAGGTTGCCGTGAGCTGTGATGCCATGGCACTCTACCAGAGACAACAGAGTGAGACTCTCTCCAAAAAAAAGAAAAAGAAAAAGAAAAAAA","GCACTTTGGGAGGCCAAGGCAGGTGAATCACCTGAGATCAGGAGTTCAAGACCAGCCTGGGCAACATGATGAAACCCTGTCTCTATGAAAAATACAAGAATTAGCTGGGCATAGTGGTGTGCATCTGTAATCCCAGCTACTCAGGAGGCTGAGGTATGAGAATTGCTTGAACCCTGGAGGCAGAGGTTGCAGTGAGCCGAGATGACACCGTTGCACTTCAGCCTGGACAATAGAGAGAGACTCTGTCTCAAAAAAATGAAGAAAAGAAAGAAAGAAA"
"GL873550","15738844","15738873","chr10","65896918","65896951","9","50158074","GGGTGTGGTGGCTGATGCGTGTAATCCTAG","GGCTGGGCGTGGTGGCTCATGCCTGTAATCCCAA"
"GL873550","16345151","16345329","chr1","6754007","6754209","69","9591144","CACCTGTAATCCCAGCACTTGGGAGGTTGAGGAGAGTGGATTGCCTGAGCTCACAGGTTTGAGCCAGAAGGAGACCTCGTCTGTAAAAATAGCTGGGTGTTGAGACCAGCGCCTTTAGTCCCAGCTACTTGGGAGGCTGAGGCAAGAGAATCACTTAAACAATTCTAGAAGCAGAGTTT","CTGTAATCCCAGCACCTTGGGAGGCTGAAGAGGGCGGATCACCTGAGGTCAGGAATTTGAGACCAGCCTGGCCAACATGGTGAAATCCCATCTCTACTGAAAATACAAAATTAGCTGGGTGTGGTGGTGCATGCCTGTAGTTCCAGCTACTTGGGGAGCTGAGGCAGAAGAATGCCTTGAACCCGGGAGGCAGAGGTTGCAGT"
"GL873550","17727115","17727274","chr1","127857902","127858038","52","110130787","GCTGGGTGCAGTGACCCCTGCCTATAATCCCAGCAGTTAGGAGACAAAGGCAGGAGGAATTACCTGAGAGCAGGAGTTCCAGACAAGCCTCAGACCAGCGTGAGCTATGACATTGTCTGTAGCCCCCACCCCACCCCCCCAAAAAACAAAAAGAAACAAA","GGCTGAGTTCAGTGGCGCACGCCTGTAATCCCAGCAGTTGGGAGGCTGAGGCAGGTGGATTGCCTGAGGTCAGGAGTTCAAGACCAGTCTGGCCAACATGGTGAAACTCTGTCTCTACTAAAAAAAAAAAAAAAAAT"
"GL873551","6567068","6567102","chr14","109767086","109767123","14","103200018","GGATCACATGAGGTCAGGAGTTCAAGATCAGCCTG","GGAGGCAGAGGTTGCAGTGAGCCAAGACTGCGCCATTG"
"GL873551","9393264","9393376","chr1","39198637","39198744","32","29805373","CAAGAGTATCTCTGCAACCCAGTGGCCTGAGGTTGCTATGAGCTAGGATGCCACAGCACTCTACCCAAGGGGACAGAGTAAGACTCTGTCTCCAAAAAAAAAAAAGAGCAAAA","AGAATCGCTTGAACCTGGGAGGCGGAGGTTGCAGTGAGACCAGATCATGGCACTGCACTCCAGCCTGGGCGACAGAGTAAGACTCGGTCTCAAAAAAAAAAAAAAAAA"
"GL873551","9393708","9393894","chr12","115674238","115674427","40","106280530","GCTGGGCTCAGTGCCTCTCGCCTGTAATCCCAGCACGCTGGGAGCCTGAGGTGGGTGGGTTGCTTGAGCTTAGGAGTTCAAGACCAGCCTGAACCAGAGCAAGACACTATCTCTACTAAAAATAGAAAAACTATCTGGGCATGGTGGTGCGCACCTGTAGTCCCAGCTACTAGGGAAGCTGAGGCAA","CCAGGCCTGGTGGCTCACGCCTGTAATCCCAGCACTTTGGGAGGCCGAGGTGGGTAGATCACCTGAGGTCAGGAGTTCAAGACCAGCCTGGCCAACATGGCGAAACCCCATCTCTACTAAAAATACAAAAATTAGCTGGGCATGGTGGTGTATGCCTGTAATCCCAGCTACTCGGGAGGCTGAGGCAGGA"
"GL873551","10104594","10104683","chr16","53032852","53032939","31","42928258","GGTAGGTGGGTCTCTCGAGGTTAGGAGCTCTTTACCAGCCTGAGCTGACATAAGACCCAATCTCCACCAAAATAGAGAGAGAAAAAAAGA","GAGGCAGACAAATCTCTTGAGGTCAGGAGTTGAAGACCAGCCTGGGCAACATAGACCTCGTCTCTATTAAAAAAAGAAAAAAGAAAAA"
"GL873551","12307468","12307551","chr8","94102375","94102458","19","81794907","GGCCAGGCATAGCAGCTCATGCCTGTAGTCCTATTATTCTAGGAGGTCCAGGGAGGAGGATCACCTGAGATCAGAAGTTCAAGA","GGCCAGGCATGGTGCCTCATGCCTGTAATCCCAGTACTTTGGGAAGCCAAAGTGGATGGATCACCTGAGGTCAGGAGTTCGAGA"
"GL873551","13335872","13336095","chr4","85819795","85820026","56","72483923","GCCAGGTACAGTAGCTCAGGCCTGTAATCCTAGCACACTGGGAGGCTGAGGTGGTGGATCCTTGAACTCATGAATTCAAGACCAGCCTGAGGAAGAGCAAGACCCCATCTCTCCTAAAAATAGAAAAATTAGCTGGTGTCATGGCAAGTGTCTGTAATCCCAGCCACACAGGAGGCTGAGGCAAGAGGATCTCTTGAACCCAAGACACTAAAGTTACTGGGAGC","GCCGGGCATAGTGGCTCATGCCTGTAATCCCAGCACTTTGGGAGGCTGAGATGGGTGGATCATCTGAAGTTAGGGGTTCGAGACCAGCCTGGCCAAATGGCAAAAACCCATCTCTGCTAAAAATACAAAAATTAGCCAGACATTGTGGCATGTGCCTGTAATCCCAGCTACTCAGGAAGCTGAGACAGGAGAATCGCTTGAACCCAGGAGGCAAAGGTTGCAGTGAGCCAAG"
"GL873552","1195303","1195426","chr3","54039332","54039457","34","52844029","CTACTCTGGATGCCAAGGCAGCGGGATCACTTGAACCCCAGAGTCTGAGGTTGCTGTGATCTCAGCTGACTCCATGGCACACTAGCCTGAGGCAACAGACTGAGACTATATCTCAAAACAAAAA","AGCTACTCAGGAGGCTGAGACAGGGAGAGTCACTTGAACCCAGGAGGCAGAGTTGCAGTGAGCCGAGATCACGCCAACTGCACTCCATGCCTGGGCAACAGAGTGAGACTCCGTCTCAAAAAAAAA"
"GL873552","15010293","15010428","chr1","29437872","29437991","29","14427579","GGCCGGGCGTGGTGGCTCACGCCTGTATTCCCAGCGCTATGGGAGGCCGAGGCGGGTGGATCACCTGTGCTCAGAGGTTCGAGACCAGCCAAGACCCCCCTGAGCCAAACGAGCCAGAGTGAGACCCCGTCTCTAC","GGCCGGGCGTGGTGGCTCACGCCTGTAATCCCAACATTTTGGGAGGCCAAGGCGGGTGGATCACCTGAGGTCAGAAGTTCGAGACCAACCTGGCCAACATGGTGAAACCCCTGTCTCTAC"
"GL873553","860627","860695","chr1","16024119","16024187","13","15163492","GCCAGGCTCAGTGGCTCACGCCTATAATCTTAGCGCCTTTTGGAGGCCAAGGTGGGGGGATTACCTGAG","GGCCAGGCACGGTGGCTCACGCTTGTAATCCCAGCACTTTGGGAGGCCGAGGAGGGTGGATTACCTGAG"
"GL873553","7206820","7206939","chr3","156098583","156098705","38","148891763","AGCTAGGTATGGCAGCTGACATCTGTAACCCTAGCCCTCTGGCAGGCCAGGAATTCAAGACCAGCCTAGACAACATAGTAAGACCCCATCTCTACCAAAAATAATTTAAAATTGGCCAGG","GGCTGGCTGTGGTGGCTCACACCTGTAATCCCAGTACTTTGGATCATGTGAGGTCAGGAGTTCAAGACCAGACTGACCAACATGGTGAAACCCTGCCTCTACTAAAAATACAAAATTAGCCAG"
"GL873553","10985147","10985407","chr12","94325498","94325767","64","83340351","GGCCTGTGGCAGTGGCTCATGCCTGAAATCCTAGCACTCTGGGAGGCTGAGGTGGGTCGATTACCTGAACTCACCAAGACGGAGACCTCATCTCTACTAAAAATAGAAAAACTAGCTGGGCGTGGTGGCAGGTGCCTGTAGTCCCAGTTACTGGGGAGGCTGAGGCAAGAGAATTACTTGAACCCAAGAATTTGAGGTTGCTGTGAGCTATGATGCCACAACACTCTACTCAGGGTGACGGAATAAGACCCTGTCTCAAAA","GGCCGGGTGTGGTGGCTTATGCCTGTAGTCCCAGCACTTTGGGAGGCCGATGGGGATGGATCACCTGAGGTCACTGGCCAACACAGAGAAACCCCATCTCTACTAAAAATACAAAAATTAGCCAGGCGTGGTGGCATGTGCCTATAATCCCAGCTACTTGGGAGGCTGAGGCAGGAGAATCACTTGAACCCGGTAGGCAGAGGTTGCAGTGAGCCGAGATTGTGCCACTGCACTCCAGCCTGAGTGACAGAGCAAGCCTCTGTCTCAAAA"
"GL873553","10985438","10985466","chr16","73760336","73760365","6","62774898","CATAAAAAGAAAGAAAACTGAAAAGAAAA","GAAAGAAAGAAAGGAAAAGAGAAAAGAAAA"
"GL873553","12443178","12443505","chr1","3864926","3865253","98","8578252","GCAGGGTGGGGAGGCTCGCACCTACATCCCCAGCACCCTGGAAGGCTTAGGCAGGTGGACTGGGTTCAGGAGTTGGAGAGCAGCCTGAGCAATAGTGAGATTCTGTCTGCAGTAAAACTAGAAAAATTATTTAGGGGTTGTGCTGGGTGCCTATTATCCTAGCTACTGTTGAGGCAAGGGGACAGCTTGAACCCAGGATTTTCAGGTTTCTGTGAGCTAGGATGATGCCATGATGACCCTCTGACACTTTGCCTGGGCAGTAGAGTGAAACTCTGTCTCAGAAAAAACAAAACAAAACAAAACAAAACAAACAAACAAACGAAAAAAA","GGCCAGGCGTGGTGGCTCACACCTGTAATCCCAGCACTTTGGGAGGCTGAGGCAGGTGGATCACCTGAGGTCAAGAGTTCAAGACCAGCCTGGCCAACATGGTGAAACTCTGTCTCTACTAAAAATACAAAAATTAGCCGGGCATGGTGGTGCATGCCTGTAATCCCAGCTATTCGGGAGGCTGAGGTAGGAGAATAGCTTGAACCCGGGAGGTGGAGGCTGCAGTGAGCTGAGATCATGCCATTGCACTGTAGCCTGAGCAACAGAGAAAGACTCTGTCTCAAAAAACAAAACAAAACAAACAAAAGAACAAAAACAAACAAACAAA"
"GL873553","15121135","15121247","chr1","111354387","111354508","21","96233252","GGGCGTGGTGGCTCACACCTGTAATCCCATCACTTGGGAGGCTGAGGCAGGTGGATCACCTGACCTCAGGAGTTCGAGACCAGCCTGAAGAAGAGTGAGACCCCGTCTCTAAA","GGCCGGGCGTAGTGGCTCACACCTGTAATCCCAGCACTTTGGGAGGCCGAGGCGGATGGATCACCTGAGTTCAGGAGTTTGAGACCAGCCTGACCAAAGTGGTGAAACCCCGTCTCTACTAA"
"GL873553","15121274","15121455","chr7","68420775","68420939","69","53299501","AGATTTCAACAGGCCTAATGGCTTTAGTATATAAAGAGAACTTATAAAGCCAGACTCAGTGGCTTACATCTATAATCCAGGTACTTGGTAGGTTGAAGTGAGAAGATTCTTTGAGCCAGGATTTCCAGCCCAGCCTAGGCAACACAGAGAGACCCCCATCTCTAAAAGAGAAAGGTAAAAAA","GGCTAAAGGGGTGCTCATCTTAAGAATACCAGGCCAGGCGCAGTGGCTCATGCCTGTAATCCTAGCATTTTGGGAGGCTGAGGCGGGTGGATCACCTGAAGTCAGGTGTTTGAGACCAGCCTGAACAACATAGTGAGACCTCATCTCTAATTAAAAAAAGAAAAA"
"GL873553","15614197","15614298","chr4","71691062","71691163","34","56076865","GGTGGCTCACACCTGTTATCCCCATACTCTGGGGGCCTGAGGTGAGAGGATCCCCAGAAGTCAGGAGCTGGAGAGAAGCCTGTGTAAGAGTAAGAGCCAGTC","GTGGCTCATGTCTGTAATCCCAGCACTTTGGGAGGCCGAGGTCGGTGTATCATTTGAAGTCAGGAGTTTGAGACCAGCCTGGCCAACGTGGTGAAACCCTGT"
"GL873553","16849767","16850040","chr1","96770987","96771267","68","79921220","GGCCAGGAGTGGTGGCTCATGCCTGCAATCCCAGCACTTGGGAGGCCAAGGTGGGTGGATTGCCTGAGCTCACAGGTTCAAGACCAGCATGAGCCAGAGAGAGACCTTGTCTCTAAAAATAGGCACAGGTTGTGGTGGGCACCCGTAGTCCCAGCTACTTGGGAGGCTGAGGCAAGAGAATCACTTAAGCCCAGGAGTTTGAGGTTGCTGTGAGCTAAGACACCACAGCACTCTACCAAGGGTGACAAAGTAAAACTCAGATTTTTTTAAAAAA","GGCCAGGTGTGGTGGCTCACAGCCTGTAATCCCAGTAGTTTGGGAGGCCGAGGTGAGCAGATCACCTGAGGTCAGCAGTTCGAGACCAGCCTGGCCAACATGGCAAAACCCTATCTCTACTAAAAGTACAAGGTGTGGTGGCACACACCTGTAGTCCCAGCTACTTGGGAGGCTGAGGCAGGAGAATCACTTGAACTCCAGAGGTGGAGGTTGCAGTGAGCCAAGATTATGCCACCGCATTCCAGCCTGGGTGACAGAGTGAGACTCCGTCTCCAAAAAAA"
"GL873554","511555","511741","chr6","166828248","166828429","56","166316693","GTGGGACCCGCATCTATACTAAAAATGAAAAACTAGTCAGACTTGGTGACTCATGCCTATAATTTCAGTTTCTTGGGAGGTGAAGGCAGAAGAATTGCTTGATCCCAGGAATCTGAGATTGCTGTGAGCTAGGCTAACACTATGGCACTCCAGCCCAGCTGACAGAGTAAGACTTTGTCTTTAAAAA","ACCCCATCTCTACTGAAAATAGAAACATTAGCCGGGCTTGGTGGCATGCGCCTGTAGTCCCAGCTATTTGGGAGGCTGAGGCAGGAGAATTGCTGGAACCCAGGAGGCAGAGATTGCAGTGAGCGGAGATCATGCCATTGCACTCCAGCCTGGGCGACAGAATGAGGCTCCATCTCAAAAAA"
"GL873554","2046660","2046725","chr8","51862362","51862427","7","49815702","GGCTGGCCGCGGTGGCTCACGCCTGTAATCCTAGCACTCTGGGAGGCCGAGGCAGGCAGATCACCT","GGCCGGGCACGGTGGCTCACACCTGTAATCCCAGCACTATGGGAGGCCGAGGCAGGTAGATCACCT"
"GL873554","2580766","2581036","chr13","93262937","93263229","81","90682171","GGCCTGGGCAAGGTGGCTCACTCTCTGGAAGGCTGAGGCAGATGGATTGCCTGAGCTCAGGAGCTAGAGACTAGCATGATCTCACCTCTACTAAAAATAGAGAAACTAGCCAGGCATTACAGCACACGCTTGCAGCCCCAGCTACTCTGGGGGCTGAGGCAAAAGGATCACTTGGACTCAAGAAACTGAGGTTCCTGTGAGCCATGATGCCAGGACACTCTACCCAGGGAAACAGAGTGAGACTTCATCTCAAAAAAAAAAAGAAAGAAAA","GGCTGGGTGCAGTGGCTCACGCCTGCACTTTGGGAGGCCAAGGCAGGTGGATCACCTGAGGTCAAGAGTTTGAGACCAGCCTGGTCAACATGGTGAAACCCCATCTCTACTAAAAATACAAAAATTAGCCAGGCATGGTGGCACGTGCCTGTAATCTCAGCTACTCTGGAGGGTGAAGCAAAAGAATCACTTGAACCCAGGAGGCAGAGGTTGCAGTGAGCCAAAATCATGCCACTGCACTCTGGCCTGGGCAACAGAGTGAGACTCCATGTCAAAAAAAAAAAAAAAAAAAA"
"GL873554","5465741","5465829","chr11","47014803","47014890","15","41549062","GGCCAGGCATGGTGGCTCACGCCTGTAGTCCCAGCGCTGTGAGAGGCCGAGGCGGGTGGATCACCTGTGCTTAGAGGTTCGAGACCAGC","GGCCGGGCACCGTGGCTCACGCCTGTAATCCCAGCACTTTGGGAGGCCAAGGCGGGTGGATTACCTGAGGTTAGGAGTTCGAGACTAG"
"GL873555","8807785","8807956","chr1","12240468","12240612","48","3432683","GGCCGGGCGTGGTGGCGCACGCCTGTAGTCCCAGCGCTATGGGAGGCCGAGGCGGGTGGATCACCTGAGCTCAGAGGTTCGAGACCAGCCAAGACCCCCCTGAGCCAAACGAGCCAGAGTGAGACCCCGTCTCTACAACAACAACAGGACAACAAAACAGCCGGACCTTGTG","GGCCGGGCGCGGTGGCTCATGCCTGTAATCCCAGCACTTTGGGAGGCTGAGGCGGGTGGATCACCTGCGGTCAGGAGTTCGAGACCAGCCTGGCCAACGTGGTGAAACCTCATCTCTACTAAAAATATAAAAATTAGCTGGTGTG"
"GL873555","8828420","8828440","chr3","5439989","5440005","4","3388431","ATAATAATAATAATAAATTAG","ATAATAATAAAATAAAA"
"GL873555","12399534","12399604","chr15","102111398","102111458","22","89711864","GGCCAGGCATGGTGGCTCACACCTATAATCCTGGGAGGCTGAGGATTATCTGAGCTCAGGGATGTGAGACC","GGCCAGGCACGGTGGCTAAGGCCTGTAATCTGGGAGGCTGAGATGGGTGGATCACCTGAGG"
"GL873555","12440877","12440963","chr19","21209507","21209590","24","8768630","GTGGGGAGTGCACCTGAACTTTGGAGTTCAAGACCAGCCTGGGCAACATTGTGTGAGCCCTGTCTCAATTGGAAAACAAAACAAAAA","AGGTGGGCAGATCACCTAAGGTCAGGAGTTCAAGACCAGACTGGCAAAAATGGTGAAACCCTGTCTCTACTAAAAATAAAAAAA"
"GL873555","13094462","13094529","chr1","100916857","100916922","22","87822395","GCTTGTACCTATAATCCTGGTACTTTGGGAGCCTCAGGAGAGTGGATCACCTGAGTAAGAGCAAGACC","CATGCCTGTAATCCCAGCACCTTGGGAGGCCAAGGTGGGTGGATCACCTGAGGTCAGTAGTTTGAG"
"GL873555","13254579","13254784","chr7","32729330","32729532","64","19474751","GACCAATCTAAGCCAGAGCTGTCTATGCTAAAAATAGAATAATAAGCCTGGTTTATGGTAGGAGCCTGTAGTCTCAGTTACCTGGGTGTCTGGGGCAAGAGATTGACTTAAAACCAGGAGTTTGAGGTTGCTGTAAGCTAGGCTGACACCACAATACTCTAATCTGGGCAGAGTGAGATTCTGTCTCAAAAAAAAAAAGAAAGAAA","GAAACCCCATCTCTACTAAAAATACAAAATTAGCCAGGCATGGTGGTGCACACCTGTAGCTCCAACTACTTGGGAGGCTGAGGCAGGAGAATCACTTAAACCCAGGCAGTAGAGGTTGCAGTAAGCCAAGATCGCACCACTGCACTCCAGTCTGGGCAACAGAGTGAGACTCTGTCTCAAAAAAAAAAAAAAAAAAAAAAAAA"
"GL873555","13255065","13255153","chr10","29045352","29045442","23","15790287","CTGGGCACAGTGGCTGAGGGTGTAATCCTACCACCCTAGGAGGTTGAGGCAGAAGGATCACTTGAGCTCAGGAATTCAATACAAGTCTA","GGCGGGGCACAGTGGCTCATGCCTGTAATCCTAGTACTTTGGGAGGTCGAGGCGGATGGATCATCTGAGGTCAGGAGTTTAAGACCAGTCT"
"GL873555","13262783","13262918","chr1","29437872","29437991","30","16175089","GGCCGGGCGTGGTGGCGCACGCCTGTAGTCCCAGCACTATGGGAGGCTGAGGCGGGTGGATCACCTGTGCTCAGAGGTTCGAGACCAGCCAAGACCCCCCTGAGCCAAACGAGCCAGAGTGAGACCCCGTCTCTAC","GGCCGGGCGTGGTGGCTCACGCCTGTAATCCCAACATTTTGGGAGGCCAAGGCGGGTGGATCACCTGAGGTCAGAAGTTCGAGACCAACCTGGCCAACATGGTGAAACCCCTGTCTCTAC"
"GL873556","639117","639366","chr1","62410822","62411038","72","61771705","GGCCGGGTGTGGTGGCTCATGCCTGTTGTCCCAGCACTGTGGGAGGCCAAGGCAGGTGGATCGCCTGAGCTCAGCCAAGTTCGAGACCAGCGGAAGACCAGCATGAGGCACAGTGAGCCAGAGTGAGACCCTACCTCTACAAAACAACAACAACAACAAAAAACCCAGCCAGATGTTGTGGCAAGTGTCTGTAATCCCAGCTACATGAGGGGCAAGAGGGCAAGAGAATCACTAAAGGAGGAAGAAGTAA","GGCCGGGCGTGGTGGCTCACACCTGTAATCCCAGCACTTTGGGAGGCCAAGGTGGGTGGATCTCCTGAGGTCAGGAGTTCGAGAGCAGCCTGGCCAACATGGTGAAACCCTGTCTCTACTAAAATACAAAAATTAGCCAGGTGTGGTGGCACGTGCCTGTAATCCCACCTACTCAGGAAGCTGAGGCAGGAGAATCACTTAAAGCTGGGAGAGAGAG"
"GL873556","639390","639468","chr20","16893610","16893664","30","16254220","ACTTCAAACTAAGATAAAGTGAAAGTCAGCAGAAATTGAAAGCAAAAACAAAAACAAAAAAAAAAAAAAAAAAAAAAGA","AACAAAACAAAACAAAACAAAACAAAACAGACAAAAAAAAAAAAACAAAGAAAAA"
"GL873556","2031445","2031493","chr13","87950184","87950229","13","85918739","AGACCCTATCTCTACTAAAAATAGAAAAACTAGCCCAGTATAGTGATGC","AAACCCCATCTCTAGTAAAAATACAAAATTAGCTGGGTGTGGTGGC"
"GL873556","6655305","6655664","chr2","190010230","190010561","107","183354925","GGCCAGGCATGGTGGCTCACACCTGTAATCCTAGCACTCTGGAAGGCCAAGGGAGGTGAATTTCTTGAAGTTCGAGATCAGCCTAAGAGGAATGATACCCCACCTTTACTAGGAATAAAAAAAAAAAAAAAAAAAAACCCAAAACTAGCCTGGCATTGTGGCAGTTCTCTGTAATCCAAGCTACTTGGGAGGCTGAGGTAGAAGGATTGCTTGAACCAAAGAGTTTGACTAGAGGTTGCTGTGAGCTAGGCTAATGTCACCACACTCTATCCAGGGCAAGTGAGTGAAACTCCGTCTCAAAATAAATAAATAAATAAATAAATAAGTAAGAAAAACTTTTGCCCATAAAAAAAAAAAGAA","GGCCGGGCGCGGTGGCTCACACCTGTAATTCTAGCACTTTGGAAGGCTGAGGTGGGTGAATTGTCTGAGCTCAGAAGTTCGAGACCAGCCTGGGCAACACAGTGAAACCCCATCTCTACTAAAATACAAAAAAAAAAAAAAATTAGCTGGGCATGGTGGTGTGCACCTGTAGTCCCAGCTACTCAGGAGGCTGAGGCAGGAGAATTGCTTGAACCCAGGAGGCAGAGGTTGCAGTGAGCTGAGATCACGCCACTACACTCCAGCCTGGGCAACAGAGTGAGACTCCACCTCTTTAAAAAAAAAAAAAAGAAAGAAAGAAAGAAAGAAAGAAA"
"GL873556","10802692","10802792","chr20","28544296","28544376","36","17741604","TACAAAGAAATATCATTATTGGCCAGGTGCAGTGGTTCACATCTGTAATTCTAGTACACTAGTACTCAGGAGGATCACTTGAGGTCAGGAGCTTGTGACCA","TAGAAATGCACAATTCACCTGGGCACGGTGGCTCACTCCTGTAATTCCAGTACTTTGGGAGGCATGAGGTCAGGAGTTCAA"
"GL873557","1682363","1682659","chr6","13352322","13352625","72","11669959","GGCCAGGTGTCGTGGCTCAGGCCTGTAATCCCAGCATTCTGGGAGGCTGAGGTGGGTGGATTGCCCTGAGGTCACAGGTTCCAGACCAGCCTGAGCAAGAGCGAGACTCCATTTCTAATAAAATAGCCGGGTGTTGTGGTAGGTGCCTGTAGTCCCAGTTACTCGGGAGGCTGAGACAAGAGAATCATTTGAACCCAGGAATTTGAGGTTGCTGTGAGCTGTGATGCCACAGGACTCTACTGAGGGCAATAAAGTGAGACTGTCTCAAATAAACAAACAAACAAACAAAAACAAAAA","GGCCAGGTGTGGTGGCTCAGGCCTGTAATCCCAGCACTTTGGGAGACTGAGGTGGGCGGATCACCTGAAGTAAGGAGTTCAAGACCAGCCTGGCCTACATAGTGAAACCCCATCTCTACTAAAAATACAAAATTAGCTGGGTGTGGTGGCACGTGCCTGTAGTCCCAGCTATTCGGGAGGCTGAGTCAGGAGAATCACTTGAACCCAGGATGGGGAGGTTGCAGTGAGCCGAGATCACACCACTGCACTCCAGCCTTGGCAACAGATTGAGACTCTTTCTCAAAAAAAAAAAAAAAAAAAAAAA"
"GL873557","2465751","2465841","chr16","4764895","4764982","15","2299144","GGCCGGGCTTGGTGGTTCACGTCTGTTGTCCCAGCACTGTGGGAGGCCGAGGCAGGTGGATCACCTAAGCTCAGCCAAGTTCGAGACTAGC","GGTCGGGTGTGGTGGGTCACGACTGTAATCCCAGCACTTTGGGAGGCCGAGGCAGATGGATCACCTGAGGTCAGAAGTTCGAGACCAG"
"GL873557","4047834","4047915","chr12","77852792","77852880","22","73804958","ACAAGAGGTTGCTTTGAACTGTGATGCCACAGAGCACTATCCTGGGCAACAGAGACTCTGTCTCAAAAAAAAAAAAAAAAAA","CAGAGGTTGCAGTGAGCTGAGACTGTGCCACTGCACTCCAGCCTGCGCGACAAGAGTGAGACTCTGTCTCAAAAAAAAAAAAAAAAAAA"
"GL873557","4048202","4048390","chrX","23681445","23681631","42","19633243","GGCTGGGTGTGGTGGCTCACACCTGTGATTCTAGCACTCTGGGAGGCCAACGTGGGCAGATCACCTGAGCTTAGGAGTTCAAGACCAGTGTGAGCAAAATGAGACCCCGCCTCTACTAAAAATAGAAAAACTAGCCAGGCACTGTGGTGGGTGCCTATCATCCCAGCTACTCAGGAGGCAGGCAAGAGG","GGCCAGGCGTGGTGGCTCACGCCTGTAATCCCAGCACTTTGGGAGGCCGAGGTGGGTGGATCACCTGAGGTCAGGAGTTCAAGACCAGCCTGGCCAACATGGTGAAACCCCGTCTCTACTAAAAATATAAAAATTAGCCAGGGTGTGGTAGTGCCTGCCTGTAATCCCAGCTACTCGGGAGGCTGAG"
"GL873557","6292327","6292620","chr19","32265157","32265444","82","25972830","GTCAGGCACGGTGGCTCATGCTTGTTGGATTATCCCAACACTCTGGGAGGCCAAGGTGGATCGATTGTCTGAGCTCTGGAGTTCAAGACCAGCCTGAGCAGAAGCAAGACTCCATCTCTAAAAAAAAATAGCTGGGCATTGTGGTGGGCACTTGTATTCCTAGCTACTTGGAAAGCCTGAGGCAAGAGGATTGCTTGAACCCAAGAGTTTGAGGTTGCTGTGAGCTTAAGATGTCACAGCACTCTATAGAGGCTGAGCAAGTGAGACTCCAAAAAGTGAGTTTCCAGAAAAAAA","GACTAGGCACTGTGGCTCATGCCTGTAATCCCAGCACTTTGGGAGGCCGAGGCGGGTAGATCACCTGAGCTCAGGAGTTTCAGACCAGCCTGAGCAACATGGCAAAACCCCATCTCTACTAAACATTAGCCAGGCATGGTGGTGTGCACCTGTAATCCCAGCTACTTGGAAGGTTGAGGCAGGAGGATCACTTGAACCTCAGGAGGCAGAGGTTGCAGTGAGCCAAGATGACATGACTGCACTCCAATCTGGGTGGCAGAGCAAGACTCTGTCTCAAAAAAAAAAAAA"
"GL873557","6324546","6324617","chr1","39656281","39656348","22","33331735","CGCCTGTTGTCCCAGCACTGTGGGAGTGTGAGTAGGGTGGATCACCTTAGCTCAGCTGAGTTTGAGACCAGC","CATGCCTGTAATCCCAGCACTTTGGGAGGTCAAGGCTGGCAAATCACCTAAGGTCAAGAGTTTGAGAC"
"GL873557","6406262","6406343","chr1","199505332","199505412","11","193099070","CAGGCGCAGTGGCTCAATCCTATAATCCCAGCACTTTGGGAGGCTGAGGCAGGTGGATTACCTGAGCTCAGGAGTTTGAGAC","CCAGGCGCAGTGGCTCACACCTGTAATCCCAGCACTTTGGGAGGCTGAGGCAGGCAGATCACCTGAGGTCAGGAGTTGGAG"
"GL873557","6417612","6417692","chr13","102319052","102319128","16","95901440","GAGGTTGCTGTGAGCTAGACTGAGGCCACAGCACTCTAGCCTGGGCAACAGAGTGAGACTGTCTCAAAAGAAAAAAAGAAA","GAGGTTGCAGTGAGCTGAGATCACACCACTGCACTCCAGCCTAGGCAACAAAGTGAGACTCCAACTGAAAAAAAAAA"
"GL873557","6903406","6903510","chr16","18967946","18968045","32","12064540","AGTGCTCTGGGAGACTGAGATGGGCAAATATCTTGAGTTTAGGAGTTCCAGACCAGCCTAAGGAAGAACAAGACCCTATCTCTACTAAAAATAGAAAAAAATTCA","CTTTGGGAGTCTGAGGCAGGTGGATCTCCTGAGGTCAGGAGTTCAGGACCAGCCTGGCCAACATGGCAAAACCCCATCTCTACTAAAAATATAAAAATTA"
"GL873557","6903779","6903930","chr3","40638454","40638604","35","33734675","TTTGCCAGGTATTGTGGTGGACACCTGTAGTCCCAGCTGCTTGGTAGGCTGAGGCAGGAGGATCACTTGACCCTAGGAATCTGATGTTGCTGTGAGCTAGGCTGATGCTACAGCACTCTAGCCTGGACAACAGAGTAAGCTTCTGTCTCAAA","TAGCTGGGTGTCATGGCACACGCCTGTAGTCCCAGCTACTTGGGAGGCTGAGGCAGGAGAATCTCTTGAACCTGGGAGGCAGAGGTTGCAGTGAGCTGAGATCACGCCACTGCACTCCAGCCTGGGCAACAGAGTGAGACTCCGTCTCAAA"
"GL873557","8133022","8133316","chr19","42881134","42881434","76","34748112","GAGTGCAGTGGCTCACACCTGTAATCTTAGCACTCGAGAGGCTGAGGCAGGTGGATTGCCTGAACTCACAGCTTCGAGACCAGCCTGAGCCAGAGCAAGACCTCATCTCTAAAAATAGCCAGGAGTTGTGGCAGGCGCCTGTAGTCCCAGCTACTTGGGAGGCTGAGCAAGAGAATCGCTTGATCTCAGGAGTTTGAGGTTTCTGTGAGCTAAGACACCGCAGCACTCTACCAAGGGTGACAAAGTAAGACTCTGTCTCAAAAAATAAATAAATAAATAAATTATAAGAAAAAGA","CCGGGCAAGGTGGTTCACACCTATAATCCTAGCACTTTGGGAGGTCGAAGTGGATCGCCTGAGGTCAGGAGTTAGAGACCAGCCTGGGCAACATAGCAAAACCCCATCTCTACTAAAAATAGAAAAACTAGCCAGGTGTGGTGGCGCCTGTAATCCCAGCTACTCGGGAGGCTGAGGCAGAAGAATCGCTTGAACCCAGGAGGCAGAGGTTGCAGTGAGCTGAGATCGCACCACTGCACTCCAGGGTGACAGAGCAAGACTCTGTCTCAAAAAAAAAAAAAAAAAAAAAAAAAAAAAAAAA"
"GL873557","8171663","8171835","chr7","151280672","151280824","61","143109009","TTAGCCAGGCACTGTGCTCCCAGCTACTAGGGAGGCTGAGGCAAGAAGAGGATCACTTGGCTCGGCGCCTGTGACTCAAGTGGCTAAGGTGCCAGCCACATACACCTAAGGTGGAGGGTTCTCTACCCAGAGGGACAGCTTGAGGCTCCATCTCAAACAAAAAAAAAAGAAGA","TGGTATGCACCTGTAATCCCAGCTACTTAGGAGGCTGAGGCATGAGAATCACTTGAACCCAGGAGGTGGAACTTTTAGTGAGCTGAGATTGCACCACTGCATTCCAGCCTGGGCAACAGAATAAGACTCTATCTCAAAAAAAAAAAAAAAAAA"
"GL873557","8172121","8172252","chr11","123260550","123260686","30","115088429","CTGGGCATGGTGGCTCATACCTATAATCCTAGGACTTTGGTAGGCCGAGGCAGGTGGGTTGCTTGAGCTTAGAAGTTGAAGACCAGCCTGAACAACAGCAAGACCTTTCCCTACTCAAAACAGAAAAACTAT","GGCTGGGCAGGGTGGCTCATGCCTATAATCCCAGCACTTTGGGAGGCCAAGGCGGGTGGGTCACCTGAGGTCAGGAGTTCGAGACCAGCCTGACCAACATGGTAAGATCCCCTCTCTACTAAAAATACAAAAATTAA"
"GL873557","8260873","8260977","chr1","62231025","62231129","22","53970152","GGCTGGGCATGGTGGCTCACGCCTGTTGTCCCAGCCCTGTGGGAGGGTGAGGCAGGTGGATCGCCTGAGCTCAGCCGAGTTCGAGACCACTGGAAGACCAGCATG","GGCTGGGCATGGTGGCTCACGCCTATAATCCCAGCACTTTGGGAGGCCGAGGCAGGTGGATCACCTGAGATCAGGAGTTTGAGACCAGACTGGCCAACATGGTGA"
"GL873557","10032878","10033040","chr9","27037847","27038008","36","17004969","GGGGGTGGTGGCTCACACTTGTAATACCAGCTACTCTGGAGGCCGAGGCAGGAGAATCATATGAGCCCGGAAGTCTGAGGTTGTTGTGAGCTGGGTTAATGCCCCTGCACTCTAGCCTGGGCAACAGAGTGAGACCATGTCTCAAGGAAATAAAAAAAAAAAA","TTAGCTGGGCATGCTGGCACACACCTGTAATGCCAGCTACTCAGGAGGCTGAGGCAGGAGAATCACTTGAGCCCGGGAGGTGGAGGTTGCAGTGAGCTGAGACAGTGCCACTGTATTCTACCCTGGGCAACAGAGTGAGACTGTCTCAAAAAAAAAAAAAAA"
"GL873557","10366578","10366655","chr17","24597444","24597521","20","14230866","GCCAGGCGTGGTGGCTCATGACGGTAATCCCACCTACTCAGGAAGCAGAGGCAGGAGAATCACTTGCGCCTAGGAGAC","GGCCAGGCATGGTGGCTCATGCCTGTAATTCCAGCACTTTGGGAGGCCGAGGCAGGTGGATCACTACGTCAGGAGTTC"
"GL873557","12031816","12031985","chr11","55022806","55022982","46","42990990","TAGAAAAACTAGCCAGGCATTGTAGCGGGTGCCTATAGTTTCAGCTACTCTGGAGACTGAGACAAGATTGCTTGAGCCCGGGAATTTGAGGTTGCTGTGAGCTATTATGCCACAGCACTCAATACAGGACAATTGAGTGAAACTCCAGTCTCAAAAAAAAAAAAAAAAAA","CAAAAATTAGCCAGGCAGGGTGGTGGGCGCCTGTAGTCTCAGCTACTGGGAAGGCTGAGACAGGATAATCACTTGAACCCGGGAGGCGGATGTTGCAGTGAGCCGAGATCATGCCACTGCACTTCAGCCCGGGCAACGAGAGTGAAACTCCGTCTCAAAAAACAAAATAAAATAAAA"
"GL873557","12032023","12032144","chr1","111354387","111354508","23","99322364","GGTCAGGTGCAGTGGCTCACATCTGGAATCCTAGCACTCTGGGAGGCCGAGGAGAATGGATCCCCTGAGCTCAGGAATTCAATATCAGCCTGAACAAGTGTGAAACCTCCATCTCTACTTAA","GGCCGGGCGTAGTGGCTCACACCTGTAATCCCAGCACTTTGGGAGGCCGAGGCGGATGGATCACCTGAGTTCAGGAGTTTGAGACCAGCCTGACCAAAGTGGTGAAACCCCGTCTCTACTAA"
"GL873557","14208944","14209036","chr7","158031905","158031997","26","143822961","GGATGTGGTAGTTACTGTTTGCTATGATGACAACACTGCACTCTAACTCTGGGTGACACAGTAAGATTCTATCTCAAAACCAAAATAAAACAA","CCAGGAGGTGGAGGTTGCAATGAGCCAAGATCACACCACTGCACTCCAGCCTGGGTGACAGGGTGAGATTCTGTCTCAAAAAAAAAAAAAAAA"
"GL873558","2159034","2159070","chrX","41233833","41233871","7","39074799","ATTAGCCAGGTGTGGTGGCTTTTGCCTGTAATCCCAG","AAATCAGCCGGGTGTGGTGGCTCACGCCTGTAATCCCAG"
"GL873558","3486850","3487074","chr5","91338665","91338874","72","87851815","GGCCAGGCATGGTGGCTCATGCCTGTTGTCCCAGTGCTGTGGGAGGCCGAGGCAGGTGGATCGCCTGAGTTCAGCCAAGTTTGAGACCAGTGGAAGACCAGCATGAGGCAGAGTGAGCCAGAGTAAGACCCCATCTCTACAACAACAAAAAAAAAAAACAAAAAAAACAGCCGGACGTTGTGATCCCAGCTACATGGTGAGGGGGAGGGGAACAGGAGAATCACT","GGCCGGGCATGATGGCTCATGCCTGTAATCCCAGCACTTTGTGAGGCCGAGGCAGACTGATCACTTGAGGCCAGGAGTTCGAGACCAGCATAGCCAACAAGATGAAACACCATCTTTACTGAAAATACAAAAAAAAAAAAAAATAGCCGGATGTGGTGATACCTGCTTGTAATCCCAGCTGCTTGGGAGGCTGAGGCAGGAGAATCTCTT"
"GL873558","3884156","3884240","chr4","24638016","24638099","18","20753860","CCAGACACAGTGGCTTAAGCCTGTAATCCTAGCACTTTGGGAGGCTAAGGTGGATGGATCTCCTGAGCTCAGTAGTTTGAAGCTA","GCCAGGCATGGTGGCTCATGCCTGTAATCTTAGCACTTTGGGAGGCCAAGGTGGGCGGATCATCTGAGGTCAGGAGTTTGAGAC"
"GL873558","5037604","5037746","chr3","2138380","2138521","38","2899224","GCTGGGCCTGGTGGCTCACATCTGTAACCCTAACACTCTGGGAGGCCAAGGCAGGAGGATCTCTTGAAGCTAGGTTGTTAGCCAGGGCGACCCCACAGCACTCTAGCCTGGGGCAACAGAGTGAGACTTTGTCTCCAAACAAA","AGCTGGATGTGGTGGCCCACACCTGTAATCACAGCTACTCGATAGGCTAAGGCAGGAGAATCGCTTGAACCTGGGAGGCGGGGACTGCACCATCACAGCACTCCAGCCTGGGTGACAGAGTGAGACTATGTATCAAAAAAAA"
"GL873558","6488648","6488700","chr3","39516725","39516768","23","33028077","ATAGCACTCTACCATGGGTGACAGAGTGAGACTATCTCCCCCCCTCAAAAAAA","GAGACCAGCCTGACCAACACAGTGAAACCTCATCTCTACTAAAA"
"GL873558","6489359","6489583","chr10","19070944","19071172","64","12581585","GGCTGGACATGGTGGGTCCTGTAATCCTAGCACTGTGGGAGGCCGAGGCAGGTGAATTGCTTGAGCTTATGGGTTCAAGACCAACCTGAGCCAGAAGGAGACCTTGTCTCTAAAAATGGCTGGGTGTTGTGGCAGGCACCTATAATCCCAGCTACTTGGGAGGCTGAGGCAAGAGAATCGCTTGAACCCAAGAGTTTGATGTTGCTGTCAGCTAAGATGCCATAG","GGCTGGGCTCAGTGGCTTATGCCTGTAATCCCAGCGCTTTGGGAGGCCAAGGCGGGTGGATCACCTGAGGTCAGGAGTTCGGGACCAGCCTGAACAACATGGTGAAATCCCGCCTCTACTAAAAAAAAGCCGGGTGTGGTGGCATGCACCTGTAATCCCAGCTACTTGGGAGGCTGAGGCAGGAGAATCACATGAACCTGGGAGGCAGAGGTTGCAGTGAGCTGAGATC"
"GL873558","14631848","14632045","chr18","1878493","1878704","62","12753355","GGTGCAGTGGCTCACGCCTTTAATCCCAGCACTTGGGATGGTGAGGCAGGTAGATTGCCTAAGTTCACAGGTTCAAGACCAGCCTGAGCCAGAGAGACCCTACCTCTAAAAAATAGCCAAGCATTGTGGCAGGCACCTGTAATCCTACTTAGGAGGCTGAGTCAAGAGGATCATTTGAGCTTAAGAGTTAGAGCTTGT","GGCCAGGCATGGTGGCTCACGCCTGTAATCCCAGCACTTTGGGAGGCCGAGGCGGGTGGATCACAAGGTCAGGAGTTCAAGACCAGCCTGGCCAACATGGTGGAAGCCCATCTCTACAAAAAATTAACTGGGCGTGGTGGCAGGCACCTGTAATCCCAGCTACTTGGGAGGCTGAGGCAGGGGAATTGCTTGAACCTGGGAGGCGGAGGTTG"
"GL873558","14632352","14632392","chr7","10117723","10117763","10","4514629","GAGTTAGAGCTTGCTGTGAGCTAAGATGCCACGGCACTCTA","GAGTTAGTTGCAGTGAGCTGAGATCGTGCCACTGCACTCCA"
"GL873559","8193331","8193614","chr20","11734223","11734512","71","3540892","CAGGTACGGTGACTTATCCCTGGAATCTTAGAACTGTCTGAGTCCAAGGTGGGAGGATCATTGGAGGTCAGGAATTTGAGACCAGCCTGAGCAAGAGTGAGACCTCTTCTCTACTAAATATAGAAAAATTAGCCAGGGTTTGTGGCAGGTGCTTATAGTCTAAGCTTCTTAGGAGGCTGAGGCAGGAGAATCTCTTGAACCCATGAGTCTGAGGTTGCCCTGAGTTAAGATGACATCACTGCAGTCTCCCCAAAGCAACGGAGTAAGACTCTGTCTCAAAAACA","GGCCAGGCACGGTGGCTCATGCCTCTAATCCCAGCATGTTGGGAGGCCGAGGTGGGCGGATCACATGAGGTCAGGAGTTTGAGACCAGCCTGGCCAACATAGTGAAACCCTGTCTCTACTAAAAATACAAAAATTAGCCAGGTGTGGCAGCACGTGCCTGTAGTCCCAGCTAGTCAGGAGGCTGAGGCAGGAGAATCACTTGAATCCACCAGGCGGAGGCTGCAGTGAGCCAAGATCACACCACTGCATTCCAGCCTGGGCGACAGAGCAAGACTCTGTCTCAGAAAAAA"
"GL873559","8193642","8193657","chrX","1083699","1083714","0","7109943","AAATAAATAAAATAAA","AAATAAATAAAATAAA"
"GL873560","393252","393440","chr11","121440472","121440639","55","121047220","CTGGGCAGGGTGGCACACACCTGTCATCCCAGCATGTTGGGAAGCTGAGGCAGGAGAATTACTTGAGCTCAGATTCCAAGAGGTGAGGATCACTTGAGCCTAGAAGTTGAGGCTGCACTGATGCCCCAACACTCCAGCCTGGGCAACAGAGCAAGGTCCTGTCCCAAAAAGAAAAAAAGAAAAGGAAAA","GCTGGGCGCAGTGTCTCACGCCTGTAATCCCAGCTATTTGGGAGGCTGAGGCAGGAGAATTACTTGAACCTGGGAGGTGGAAGTTGCAGTGAGCCGAGATCCTACCATCGCACTCCAGTCTGGGCAACAAGAGCAAAACTCTGTCTCAAAAAAAAAAAAAAAAAAAAA"
"GL873560","4038833","4039014","chr12","78258009","78258208","56","74219176","GGCTGGGTGCGGTGACTCACACCTGTAATCCCAGCACCTGGAGGCCCAAGGCAGGGTGGATTGTCTGAGCTCACAGGTTCAAGACCAGCCTGAGCCAGAGCGAGACCTAAAAATAGCTAGGCGCTGTGGGAGGCACACGTAGTCCCAGCTACTCAGGAGGCTGAGGCAAGAGAATCACTTGA","GGCTGGGCACGGTGACTCACGCCTGTAATCCCAGCACTTTGGGAGGCCCAGGTGGGTGGATCACCTGAGGTCAGGAGTTCAAGACCAGCCTGGCCAAGATGGTGAAACCCCGTCTCTACTAAAAATACAAAACTTAGCTGGGCATGGTGGCGGGCACCTGTAATCTCAGCTAGTCGGGAGGCTGAGGCAGGAGAATCTCT"
"GL873560","4492531","4492643","chr7","56485655","56485756","37","51993124","AACAGAAAAACTAGCCAGGCATAGTGGTGCATGCCTGTTGTTCCAGCTGCTCTAGAGGCTAAGGCAAGAGGATTGCTCCAGCTCAATAGTTTGAGGTTGCTGTGAGCTTGAGA","TTAGCTGGGCATGGTGGAGCACACCTGTAATTCCAGCTACTCAGGAGGCTGAGGCAAAAGAGTTGCTTGAACCCAGGAGGCAGAGGTTGCAGTGAGCCGAGA"
"GL873560","4492670","4492771","chr8","41603464","41603564","28","37110794","AGCACTCTGGGTGACTGAGGCAGGATTACTTGAGCTCAGGAGTTTATGACCAGCCTGAGCTGGTCCTTGATCAAGACTCCATCTCTACTAAAAAAACAAACA","CACTTTGGGAGGCCGAGGCAGCAGATCACTCGAGGTCAGGAGTTTGAGACCAGCCTGGCTAACATGGCAAAACCCCATCTCTACTAAAAATATAAAAATTA"
"GL873560","8106775","8106882","chr11","111878590","111878685","39","103771815","ACATAAGAATCAGGCCAAGCCTTGTGGCTCCTGTATGTGATTCCAGCACTGGGAGGGCAAGGCAGGAGGATCCCTGACGTCAGGAACTCAAGGCTGCCCAAGTATCAT","GGGCACAGTGGCTCATGCCTGTAATCCCAGCACTTTGGGAGGCCAAGGCGGGTGGATCACCTGAGGTCAGGAGTTCAAGACCAGCCTGACCAACAT"
"GL873560","10872201","10872272","chr7","9971011","9971083","11","901190","GGCTGGGCACAATGGGTCACACTTGTAATCCCAACACTTTGGGAGGCTGAGGTGGGCAGATCACCTGAGCTC","GGCTGGGTGGGGTGGCTCACACATGTAATCTCAGCACTTTGGGAGGCTGAGGTGGGCAGATCACCTGAGGTCA"
"GL873560","11043320","11043410","chr6","111928830","111928919","19","100885510","CAGGCGAAGTGGCTCATGCCTATAATCCTAGCATTCTGGGAGGCTGAGGTGGGAGAATCCCCTGAGGTCAAAAGTTCAAGACCGGCTTGGC","GGCCAGGCTCAGTGGCTCATGCCTGTAATCCCAGCACTTTGGGAGGCCGAGGTGGGTGAATCACCTGAGGTCAGGAGTTCAAGACCTGCC"
"GL873561","5890611","5890936","chr8","76222061","76222392","77","70331450","GGCTGGGCCTGGTGGCTCATGCCTATAATCCTAGCACTCTGGGAGGCAAAGGTTGGTGGATTGCTTAAGCTCAGGAGTTCAAGACCAGCCTGATTAAGAGTGAGATCCCATCTCCACTAAAAATAGAAGGGAAAAAAAAAAAAAAAAAACCTAGTTGGGCTTGGTGGCAGCACTTGTAGTCCCAGCTATTTAGGAGGCTGAGGAAAGAGAATCACTTGAACCCAAGAGTTTGAAGTTGCTCTGAGCTATGATGCCATAGAACTCTACCCAGGGTGACAGAGTAAAACTGGATCTCAAATAAATAAATAAATAAATACATAAATAAA","GGCTGGGCATGGTAGCTCATGGCTGTAATCCTAGCACTTTGGGAGGCCAAGGAAGGTGGATTGCCTGAGCTCAGGAGTTCAAGACCAGCCTGGGCAACACAGTGAAATCCTGTCTCTACTAAAATACAAAAAAGAAAAAAAAAAAAAAAAAAAACAGCTGGGCATGGCAGTGTGCACTTGTAATCCCAGCTACTCAGGAGGCTGAGACAGGAGAATCACTTGAACCCGGGAGGCAGAGGTTGCACTGAGCCGAGATTGTATCACTGCACTCCAGCCTGGGTGACAGAGCGAGACTCTGTCTCAGAAAAAAAAAAAAAAACAAAAAAACAAAA"
"GL873561","10859256","10859475","chr6","100119122","100119352","73","89259866","GGATCACTTGAGCTCAGGAGTCAAGACCAACTTGAGTAAGAGTGAGACCCTGTCTCTACTAAAAATAAAATATATAGCCAGGCATTGTGCTGGGCACCTATATATAAGCTAAAATGGAGTCTTAGCTACCTCCTTGAACTTGAACCCAGGAGTCTGAAGTTGCTTTGAGCTAGGCTGATGCCACTGCACTTTACCCAGGCAACAGAGTGAGAGTATCTAA","GGATCACCTGAGGTCAGGAGTTCAAGACCAGCCTGGCCAACATGGTGAAACCCCGTCTCTACTAAAAATACAAAAACTAGCCAGGCATGGTGGCGCACACCTGTAGTCCCAGCTACTTGGGAGGCTGAGGCAGAAGAATCTCTTGAATCCGGGGGTTGGAGGTTGCAATGAGCTGAGATCATGCCACTGCACTCCAAGCCTGGGTGACAAGAGCGAAACTCCATCTCAAAA"
"GL873561","10859563","10859576","chr4","114457728","114457741","1","103598165","AAAAAAAAATAAAA","CAAAAAAAATAAAA"
"GL873562","12189469","12189706","chr1","31551552","31551790","75","19362083","CAGTGGCTCACGCCGGTAATCCCAGCACCTTGGGAGCTGAGGCAGGCAGATCTCCTGAGGTCACGTGTTTTGAGACCAGCCTGAGCTAGAGTGAGACCCCACCTCTAAAAATAGCCAGTCGCCTGTAATCCCAGCTACTCGGGAGAAACCCAGGAGTCTAAGGTCGCTGTGAGCTGACACCTCAGCACTCTGCTGGGGTAACAAAGTGACACTTTGTCTCAAAAAAATAAATAAATAT","GCAGTGGCTCACGCCTGTAATCCCAGCACTTTGGGAGGCCAAGGCGGGTGGATCACCTGAGGTCAGGAGTTCAAGACCAGCCTGGCCAACATGGTGAAACCTCATCTCTACTAAAAATACAAAACAGGAGAATCGCTTGAACCCGGGAGGTAGAGGTTGCAGTGAGCTGAGATAGTGCCACTGCACTCCAACCTGGGCAACAGAGTGAGACTCCGTCTCAAAAAAATAAAAAATAAAAA"
"GL873562","4526861","4526913","chr13","94764706","94764759","14","90237845","GTGAGACCTTGTCACTACTGAAAATAGAAAAATTAGCTGGGCATGGTTGTAGG","GTGATGAAACCCCATCTCTACTAAAAATACAAAAATTAGCTGGGCTTGATGGTG"
"GL873562","4789223","4789313","chr10","47852509","47852598","25","43063286","GGCCAGGAGAAGTGGCTAACACCTGTAATTCCAGCACTCTAGGAGATGGAGGCAGGGACCAGCCTGAGCTAGAGTGAGTGAGACTCCATCT","GGCCAGGTGCAGTGGCTCACACCTGTAATCCCAGCAACTTTGGGAGGCTGAGGCAGGCAGATCACTTGAGGTCAGGAGTTCGAGATCAGC"
"GL873562","4868605","4868801","chr16","54069750","54069948","44","49201145","GGCCAGGCATGGTGGCTCATGCCTGTAATCCTAGCACTCTGAGAGACCAAGGCTGATGAATCACCTGAACTCAGGAGTTGAGACCAGCAGGAGCAAAAGTGAGATCCCATCTCTACTCAAAAATAGAAAATTAGTTCAGGCAAGGTGGCACATACCTGTAATCCCAGCACCCTGGGAGGCTAAGGTGGGTGGATTGC","GCCCAGCGCAGTGGCTCATGCCTATAATCCCAGCACTTTGGGAGGCCAAGGCGGGTGGATCACCTGAGGTCAGGAGTTCGAGACCAGCCTGCCCAGCATGGTGAAACCCCATCTCTGTTAAAAATATAAAAATTAGACTAGGCGCGGTGGCTCACACCTGTAATCCCAGCACTTTGGGAGACCAAGGTGGGCGGATCAC"
"GL873562","4929184","4929360","chr10","37539693","37539877","47","32610509","GGCCAAGCTCAGTGGCTCTCCCTAGCACTTTGGGAGACCGAGGTGGGTGGATTGCCTGAACTCAGGAGTTCTAGACCAGCCTGATCAAGAGCAAGACCCTACATCTACTAAAAATAGAAAAACTAGCTGGGCATTATAGTACGCACCTGTACTCCCATCTACTCTGGAGGCTGAGGC","GGGTGCAGAGGCTTATGCCTGTAATCCCAGCACTTTGGGAGGCAGAGGTGGGTGGATCACTTGAGGCCAGGAGTTCAAGACCAGCCTGGTCAATGTGGTGAAACCTCGTCTCTACTAAAAATACAAAAATTAGCCGGGCATGGTGGCATGCATCTGTAGTCCCAGCTACTTGGGAGGCTGAGGCA"
"GL873562","5446395","5446678","chr16","63692714","63692996","79","58246319","GGCTGGATGCAGTGGCTCATACCTGTCTGTAATCCTAGCACTCTGGGAGGTCGAGGTGGGTGGATTGCCTAAGTTCACAGGTTCGAGGCCAGCCTAAGCAAGAAGAGCAAGACTCCATCTCTGAAAGTAGCCAGGCATTGTGACAGGCGCCTATAGTCCCAGCTACTTGGGAGGCTGAGGCAAGAGAATTGAGCCCAGGAGTTAGAGGTTGCTGTGAACTAGGACTCCATAGCATTCTACTGAAGGTGACAAAGTGAGATTCTGTCTCAAAAAAAAGACTGATT","GGCTGGCTGCGGTAGCTCACCCCTGTAATCCCAGCACTTTGGGAGGTCAAGGCAGGTGGATTGCCTGAGGCCAGGAGTTCGAGGCCAGCCTGACCAATATGGCAAAACCCTGTATCTACTAAAAACTAGCTGGGCATGGTGGCATACACCTGTAGTCCCAGCTACTTGGGAGGCTGAGGCAGGAGAATTGCTTGAACCTGGAGGCAGAGGTTGCAGTGAGCCAAGGCTGCCCCACTGCACGCCAGCCTGGGTGACAGAGTGACACTCCATCTCAGAAAAAAAA"
"GL873562","8499356","8499477","chrX","91860022","91860139","29","83360666","GGCTGGGTGTGCTGGCTCATGCCTGTAATCCTCGCACTCTGGGAAGCTAAGGCAGGTGGATTGCCTGAGCTTATGAGTTTAAGACTAGCCTGAGCCAGAGCAAGACCTTGTCTCTATTTTTT","GCCGGGTGTGGTGGCTCATGCCAGTAATCCTAGCACCTTGGAAGGCTGAGGCAGGTGGATTGCCTGAGCTCAGGAGCTTCAGACTAGCCTGGGCAACATAGTGAAACCCCATATCTCT"
"GL873562","8499731","8499918","chr7","167658032","167658223","45","159158301","AAGACCTTGTCTCTAAAAATAGCCAGGTGTTGTAGCAGGCACCTGTAGTCCCAGCTACTTGGGAGGCTGAGACAAGAGAATTGCTTGAGCCCAAGAGTTTGAGGTTGCTGTGAGCTGAGATGCCATGGACTCTATCGAGGGCAGTAAAGTGAGACTCCGTCTCAAAAAAAAAAAAAGAAAGAAAAGAA","TACTAAAATACATACAAAAATTAGCCAGGTATGGTGGCAGGCCCCTGTAGTCCCAGCTACTCGGGAGGCTGAGGCAGGAGAACTGCTTGAACCCAGGAGGTGGGGATTGCAGTGAGCTGAGATCGCACCACTGCACTCCAGCCTGAGCGACAGAGTGAGACTCTGTCTCAAAAATAAAAAAAGAAAAAAAAA"
"GL873562","10216295","10216385","chr1","44313085","44313176","34","34096790","TAAAAATACATTGAACCAGATTCAGTGGCTCACACCTGTGCTCCTAGCTACCCAGTGGCTGAGGCTGAAGGATGGCTTGAATCTCAAGTTC","TTACAGATCATTTGGGGCTAGATGTAATGGCTCACACCTGTAAGCCCAGTGCTTTGGGAGGTTGAGGCAGGAAGATGGCTTGAACCTAGGAG"
"GL873562","11812352","11812435","chr19","44513406","44513491","17","32701054","GGCCGGTACGATGGCTCAGGCCTATAATCTTAGAACTCTGGGAGTCCGAGGTGGGTGGACTGCCTGAGCTCACAGTTCGAGACC","GGCCGGACGCGCTGGCTCACGCCTGTAATCCTAGCACTTTGGGAGGCTGAGGGGGGCGGATAGCCTGAGCTCAGAAGTTCGAGACC"
"GL873562","12179920","12180054","chr14","8268315","8268451","18","3911605","GGCCAGGCATGGTGGCTCACACCTATAATCCTAGCACTCTGGGAGGCCAAGGCAGGTGGATCACCTGAGCTCAGGAGTTTAAGACCAGCCTGAGCAAGAGTGACAACCTATCTCTATTAAAAATACAAAAACTAG","GGCCGGGCATAGTGGCTCACACCTATAATCCCAGCACTTTGGGAGGCCAAGGCAGGTGGATCACCTGAGGTCAGGAGTTCGAGACCAGCCTGACCAAGATAGTGAAACCCCGTCCCTACTAAAAATACAAAAATTAA"
"GL873562","14017684","14017885","chr2","94000404","94000565","73","79982720","CAAGCTAGCCTAGGGATGTGGAGGTACCTGTAGTCCCAGTTACTTCATTGGCTGAGGCTTAAACCCTCTTGGATGGTCTCACTCTGTCACCCTGGTAGAGTGTTGTGGCATCATGTGTCACAGGAGGTTGAGGTTGCTGTGAGCTGTGATGCCACAACATTCTACCAGGGTGACAGAGTGAGACTCTGTTTCAAAAACAAAA","AAACTAGCCTGGCGTGGTGGTGTGTGCCTGTAATCCCAGCTACTTGGGAGGCTGAGACAGGAGAATCACTTGAACCTGGGAAGTGGAGGTTGCAGTGAGCTGAGATCATGCCACTGCACTCCAACTTGGGCAACAGAGCGAGACTCTGTTTCAAAAAAAAAA"
"GL873562","14017915","14018042","chr1","161382752","161382881","27","147364837","GGCTGGGCACGGTGGCTCACACTTGTAATTCTAGCACCCTGGGAGGCCAGCGTGGGTGGTTTGCTTGAAGTTAGGAGTTCAAGACCAGCCTGACCAAAGTGAGACCACATCTCGACTAAAAACAAACA","GGCTGGACGCAGTGGCTCATACCTGTAATCCCAGCACTTTGGGAGGCCGAGGTGGGTGGATCACCTGAGGTCAGGAGTTCAAGACCAGTCTGGCCATGGTGAAACCCCATCTCTACTAAAAATACAAAAA"
"GL873563","2645481","2645758","chr1","37954757","37955032","69","35309276","GGCTGGGTGCCATGACTCACGCCTGTCATCCCAGCTCTCTGGGAGGTCACAATGGGAGTATTCCATGAGCTCAGAAGTTTGAGACCAGTCTGAGCAAGAGCAGACTCCATTTCTACTAAATATAGAAAAATTAGCCCAGTATGGTTGTGCACACCTGTAGTCCCAGCTACTTGGGAGCTGAAGCAGGAAAACGGCTTGAGTCCAGGAGTCGGAGGTTGCTGTGAGCTGAGAGCTATAATGATGCCAGTGCACTCTACCCAGGCAACAGAGCAAGACTC","GGCCGGGTATGGTGGCTTACGCCTGTAATCCCAGCACTTTGGGAGGCCAAGGTTGGCAGATCACCTGAGGTCAGGAGTTCGAGACCAGCCTGGCCAATATGGCGAAACCCCGTCTCTACTAAAAATACAAAAATTAGCTGGGCATGGTGGCGCATACCTGTAATCCCAGCTACTCGGGAGGCTGAGGCAGGAGAACTGCTTGAACCCAGGAGGTGGAGGTTGCAGTGAGCCGAGATTGAGCCACTGCACTCCAGCCTAGGTGACAGAGTAAGACTC"
"GL873563","2646059","2646097","chr1","62915138","62915167","12","60269079","CAAACAGAACAAGACTTTGTTTCAAAAAAAAAAAAAAAA","CAAACAAACAAACATCACAAAAAAAGAAAA"
"GL873563","2651001","2651167","chr2","69424628","69424798","38","66773627","GTACAAAAATTAGCCAGATGTCTTGGTGCTTATAGTCAGCAACTCAGGAGGCTGAGGCAGGAGGATCACTTGAACCCCTGGAATTTGAGGTTGCTGTGAGCTAAGTTGATGCCACGGCATTCTAGCCTGGGTGACAGAGTAAGACTCCATCTCAATAAATAAATAAA","AAAAAAATTAGCCAGGCATGGTGGTGCATGCTTGTAATCCCAGCTACTTGGGAGGCTGAGGCAGGAAGATCACTTGAACCTGGGAGGCGGAGGTTGCAGTGAGCCAAGATTGTGCCACTGAACTCCAGCCTGGGTGACAGAGCAAGACTCCATCTCAAAAAAAAAAAAAAA"
"GL873563","2651449","2651584","chr3","121251018","121251153","32","118599569","GGTCCAGTGAGGTGGTTCAGACCTGTAATCCTAGCATTCTGGGAGGCTGAGGTGAGCAGATTGCTTGAGCTCAGTGAGTTTGAGACCAGCCTGAATAAAAGCAGCACCCCATCTCTACCAAAAGTAGGAAAATTAT","GGCCAGGTGCAATGGCTCACACCTGTAATCCCAGCACTCTGGGAGGCCGAGGTGGGCAGATCACCTGAGGTCAGGAGTTTGAGATCAGCCTGGCCAACCTGGCAAAACCCCATCTCTAATAAAAATACAAAAATTA"
"GL873563","6898038","6898117","chr6","28153994","28154075","27","21255956","AAAAAACAGAAAAATTAGTTGGGTGTGGTAGTGGGTAGCTACTTGGGAGGCTGGGGCAGGAGAATCACTTGAACCCAGGA","AAAATTAGCCGGGTGTGGTGATGCATGCCTCTAATCCCAGCTACTTGGAAGGCTGAGGCAGGAGAATCACTTGAAGGCAGGA"
"GL873563","6898395","6898520","chr5","140939246","140939381","30","134040851","GGGGGTGGTGGCTCATGCCTGTAATCCCAGCACTCTGGCTGAGACAAGTGGATTGCATGAGCTCAGGAGTTCAAGACCAGCTTGAGGAAGAACAAGACTCCATCTCTACTAAAAATAGAAAAATTT","GGCCCGGTGCTGTGGCTCATGCCTGTAATCCCAGCACTTTGGAAGGCTGAGGCAGGTGGATCCCTTGAGGTCAGGAGTTCGAGACCAGCATGGCCAACATGGCAAAATCCCATCTCTACTAAAAATACAAAAATTA"
"GL873563","7811395","7811530","chr1","29437872","29437991","31","21626477","GGCCGGGCGTGGTGGCTCATGCCTGTAGTCCCTGCACTGTGGGAGGCCGAGGCGGGTGGATCACCTGTGCTCAGAGGTTCGAGACCAGCTAAGACCCCCCTGAGCCAAATGAGCCAGAGTGAGACCCCGTCTCTAC","GGCCGGGCGTGGTGGCTCACGCCTGTAATCCCAACATTTTGGGAGGCCAAGGCGGGTGGATCACCTGAGGTCAGAAGTTCGAGACCAACCTGGCCAACATGGTGAAACCCCTGTCTCTAC"
"GL873563","7855904","7856041","chr3","37342340","37342469","34","29486436","GCCAGGGCAGTGGTTCACACCTGTAAAAACCCCAGTATTTTGAGAAGCCAAGTTGGGAGGATCACATAAGGTCAAGAGTTTGAGACCAGCCTGGACAACACAGTATAAGACTCCCATCTCTATTTTGTTAAATATACA","GCCGAGCGCGTGGCTCACGCCTGTAACCCCAGCACTTTGGGAGGCCAAGGTGGGTGGATCACTTGAGGTCAGGAGTAGGAGACCAGCCTGGCCAACATGGGTGAAACCCCACCTATAGTTTAAAAATATA"
"GL873563","8381194","8381392","chr2","167568017","167568216","65","159186823","GGCCAGTGCAGTAGCCCACACCTGTAATCCTAGCACTCTGGGAGGCCAACTCTGGTAGAGTTTGAAACTAGCCTGAGCAAGAGCGAGACCTTGTCTTCACTGAAAAAAATAGAAAAAAAAAAAAAAAACTAACTGGGCATGGTGCTGTACATCTGTAGCCCGAGCTACTCAGGAGTCTGAGGCAAGAGGATTACTCAAT","GCCAGGCGAGGTGGCTCATGCCTGTAATCCCAGCACTTTGGGAGGCCAAAGTGGACAGATTACCTGAGGCCAGGAGTTTGAGACCAGCCTGACCAATATGGTGAAACCCCATCTGTACTAAAAATACAAAAATTAGCAGGGCGTGGTGGTGTACACCTGTAATCCCAGCTACTCAGGAGGCTGAGGCAGGAGAATCTCTT"
"GL873563","8381923","8382014","chr2","92370724","92370803","33","83988801","GGATTGCTCAAGCCCAAGAGTTTGAGGTTGCTGAGAGCTATGACACTACAGCACTCTACTCTACCCAGGGCAACAGAGTGAGACAAAAAAAA","TTGCTTGAACCCAGGAGCTAGAGGTTGCAGTGAGCTGAGATTGCACTATTGCACTCCAGCCTGGGCAACAGGGTGAGACT"
"GL873563","9500422","9500552","chr19","10830410","10830544","33","1329988","GGTCAGGTGCAGTGGTCACCTGTCATCCTACCCCTCTGGGAGGCCAAGGTGGGTGGATTGCCTGAGTTCAGGAGTCTGAGACGAACCTGAGCTAGAGCAAGACCTCATCTCTTAAAAAATAGCCAGCATTC","GGCCAGGTGCAGTGGCTCATGCCTGTAATCCCAGCACTTTGGGAGGCCAAGGTGGGTGGATCACCTGAGGTCAGGAGTTCGAGACCAGCCTGATCAACGTGGTGAAACCCCATCTCTACTAAAATTGCAAAATTA"
"GL873563","9501087","9501192","chr16","71049107","71049211","33","61548020","TAAAACCTATAATGTTTGAAAATAAAAATAGCCAGGCCTTGTTGTGGGTGCCTGTAGTCCCAGCTACTTAGGAGGCTGAGGTAAGAGGATTGCTTGAGCCCAAGAG","TGAAACCCCATCTCTACTAAAAATACAAAATTAGCCAGGTGTGGTGGTGCATGCCTATAATCCCAGTTACTTGGGAGACTGAGGCAGGAGAATCACTTGAACCTG"
"GL873563","10991062","10991128","chr1","22619342","22619410","11","11628280","GGCCGGTGTAGTGGCTCACGCCTGTAATCCCAGCACTTTGGGTGCCGACATGGGCAGATCGCCTGAG","GGCCGGGCGCGGTGGCTCACACCTGTAATCCCAGCACTTTGGGAGGCCGAGGTGGGCGGATCACCTGAG"
"GL873563","12252577","12252738","chr8","144193624","144193784","41","131941047","GGCTGGGTACAGTGGCTCATATCTGTAATCCTAGCACTCCAGGAGGCTGAGGTGGGAGGATAATTGCCTGAAGTCAGAAACACAAGACCAGCCCAAACAAGAGTGAGACACCATCTCTACTAAAAATAGAAAACTGAGCTGGGTGTGGCGGTGCACACCTGT","GGCCGGGCATGGTGGCTCATGCCTATAATCCTAGCACTTTGGGAGGCCGAGGTGGGCGAATCACCTGAGGTCAGGAGTTTGAGACCAGCCTGGCCAACATGGTGAAACCCCATCTCTACTAAAAATACAAAAATTAGCTGGGTGTGGTGGCACATGCCTAT"
"GL873564","1384131","1384395","chr13","32253035","32253303","64","30868904","GGGGGGGGGGGCACACTGGCCTGTAATTCTAGCACTCTGAGAGGCCAAGGCAGGTGGATCACCTGAACTCAGGAGTTCGAGACCAGCCTGATCAAGAGTGAAACCCTGTCTCTACTAACAAGAGAAAAACCAGTAGTCCCAGCTACTCAGGAGGCTGAGGCAGAAGAATCACTTGAACCCAGGAGTTTGAGGTTTCTGTGAGCTACAGTAGTGCTATGGCACTCTACCAAGAGTGACAGAGTGAAACTCTGTCTCAAAAAAAAAA","GCTGGGCATGGTGGCTCATGCCTGTAATCCCAGCACTTTGGGAGGCTGAGGCGGGTGGATCATCTGAGGTCAGGAGTTCAAGACTAGCCTGGGCAACATGGTGAAACCCTGTCTCTACTAAAAATACAAAATTACAGGTAATCCCAGCTACTTGGGAGGCTGAGGCAGGAGAATCGGTTGAACCCAGGAGGCGGAGGTTGCAGTGAGCTGAGATCATGCCACTGCACTCCAGCCTGGGCAATAGAATGAGACTCTGTCTGAAAAAAAAA"
"GL873564","2543879","2544121","chr1","199402350","199402570","73","196858471","GGCCAGGTGTGGTGGCTTACGCCTGTTGTCCCAGCGCTGTGGGAGGCCGAGGCAGGTGGATTGCCTGAGCTTAGCTGAGTTTGAGACCAGCGGAAGACCAGCATGAGGCAGAGTGAGCCAGAGTGAGATCCTGTCTCTACAAAAAAGAAAAAAAAAAAAACAGCCGGATGTTGTGGCGCGCGTCTGTAATCCCAGCTACATGGGGGTCAAGAGGGCAAGAGAATCATACAGGAGGAAGAAGTT","GGCCAGGTGTGGTGGCTCACACCTGTAATCCCAGCACTTTGGGAGTCTGAGGCGGGTGGATTGCCTGAGGTTGAGAGTTTGAGACCAGCCTGGCCAACATGGTGAAACCCTGTCTCTACTAAAAACACAGAAATTAGCCAGGCATGGTGGCGCATGTCTGTAATCCCAGCTACCCTCCTGGAGGCTGAGGCAAGAGAATCACTTGAACCCAGGAAGCAGAG"
"GL873564","4859126","4859236","chr9","15245726","15245837","31","10386600","GTGGCTCATGCTTATAATCCAATCACTATGGGAGACCAAGGTGGGGATGGGCGGAGATCACCCTCAGGAGTTGGAGACCAGCCTGAGTTAAGAGTGATACCATGTCTCTAC","GTGGTGTCTCACGCCTATAATCCCAGCACTCTGGGAGGCCAAGGTGGGCAGATCACCTGAGGTCAGGAGTTAAGAGACCAGCCTGGCCAACATGGTGAAACCCTGTCTCTAC"
"GL873564","4859490","4859678","chr8","126054004","126054184","54","121194514","CATGTCTCTATTAAAGGTAGAAAAATTAGCCGAAGTATTGTAGTTGGGCTGTATAGTCCCAACTACTGAAGAGGCTGAGACAGGAGGATTGCTTACAACTAGGAGTTTGAGGTTGCTGTGAGCTAGGCTGATGCCAAGGTGCTCTAGCCTGGGCAACAGAATGAGACAATGTCTTAAACAACAAAAAAA","GTCTCTACTAAAAATACAAAAATTAGCTGGGTGTGGTGGTGCATGCCTGTAATCCCAGCTACTCAGGAGGCTGAGGCAGGAGAATCGCTTGAACCCAGGAGGTAGAGGTTGCAGTGAGCCAAGATCATGCCACTGCACTCCAGCCTGGGTGACAGAGGGAGACTCTGTCTCAATAAATAAA"
"GL873564","5294014","5294069","chrX","11604904","11604969","20","6310890","GGGTGTGGTGACTTGCACTTACAATCAGCACTTTGGGAGGCGAAGGTAGGAGCATC","GGCTGGGTGCAGTGACTCACGCCTGTAATCCCAGCACTTTGGGAGGCTGAGGTAGGCAGATCACCT"
"GL873564","5294155","5294257","chr15","310129","310227","21","4984026","GGCTGGGTGTGGTGGCTCACGTCTGTTGTCCCAGCGCTATGGGAGGCTGAGGAGGGTGGATCACCTGAGCTCAGAGGTTCGAGACCAGCATAAGACCAGCATG","GGCTGGGCGCAGTGGCTCACGCCTGTAATCCCAGCACTTTGGGAGGCCAAGGCGGGTGGATCACGAGGTCAGGAGTTTGAAACCAGCCTAGCCAGCATG"
"GL873564","6711055","6711262","chr18","1878493","1878704","55","4832562","CTGGGCCCAGTGGCTCACACCTATAATCCTCGCACTCTGGGAGGCTGAGGCGGGTAGATTGTCTGAGCTCACAGGTTCAAGACCAGTGTGACCCAGAGCGAGGCTTTGTCTCTAAAAATAGCAGGGCGTTGTGGCAGGCACCTGTAGTCCCAGCTACTTGGGAGGCTAAGGCAAGAGAATTGCTTAAACCTAAGAGTCTGAGGTTACA","GGCCAGGCATGGTGGCTCACGCCTGTAATCCCAGCACTTTGGGAGGCCGAGGCGGGTGGATCACAAGGTCAGGAGTTCAAGACCAGCCTGGCCAACATGGTGGAAGCCCATCTCTACAAAAAATTAACTGGGCGTGGTGGCAGGCACCTGTAATCCCAGCTACTTGGGAGGCTGAGGCAGGGGAATTGCTTGAACCTGGGAGGCGGAGGTTG"
"GL873564","6711356","6711451","chr7","158031905","158031997","31","151320549","AAAAGAGTCTGAGGTTGCCATGAGCTATCATGCCAAGGCATTCTAGAGAAGGGGTACAAAGTGAGACTCTGTCTCAAAAAAAGAAAACCAAAAAGG","CCAGGAGGTGGAGGTTGCAATGAGCCAAGATCACACCACTGCACTCCAGCCTGGGTGACAGGGTGAGATTCTGTCTCAAAAAAAAAAAAAAAA"
"GL873564","7057009","7057315","chr14","106885133","106885430","87","99828124","GCCGGGTACAATGGCTTGCGCCTATAATCCCAGCACTCTGGGAAGCAGAGGTGGGTGGATCACCTCAGCTCACGAATTCGCTACCAGCCTGTCCTAGAGTGAGACACCCCCCCCACCCCCACCCCCCACAACCTCTAAAAATAGCCTGGAGTTGTGACGGGCACCTGTTGTCCCAGCTACTCTGGAGGCTGAGACAAGAGAATTGCTTGGGCCTCAGAGTCTAAGGTTGATATGAGCTATGACATCACAGCACTCTATCAAAGGTAACAAAGTGAGACTCTAAATAAATAAATAATAAATAAATAAA","GCCGGGCCCGGTGGCTCTTGCCTGTAATCCCAGCACTTTGGGAAGCTGAGGTGGGTGGATCACCTGAGGTCAGGAGTTCGAGACCAGCCTGACCAATATGGTGAAACCCCGTCTCTACTAAAAATATAAAAATTAGCCGGGTGTGGTGGCATGCGACTATAGTCCCAGCTACTCAGGAGGCTGAGGCAGGAGAATTGCTTGAACCCAGGAGGTGGAAGTTGCAATGAGTCGAGGTCACACCACTGCACTCCAGCCTAGGCAACAGAGTGAGACTCCATCTCAAAAAAAAAGAAAAAAA"
"GL873564","7705416","7705474","chr1","51463330","51463380","19","43757914","TCATGCCTGTAGTACCAGCACTTCAGGAGGCTGAAGCAGGAGCTAAGATTAGAAATTTG","CATGCCTTTAATCCCAACTACTTGGGAGGCTGAGGCGAGAATTGAAGTCCG"
"GL873564","8307239","8307551","chr14","30585163","30585473","93","22277924","GCACAGTGGCTCAGGCCTGTAATCTGAGCACTCTGGGAGGTTGAGGCTGAGGTTAGGAGTTAGGAGAACAGCCTGAGCAAGAGTGAGACCCCATCTCTACCAAAAATAGGGGAAAAAACTCCAAAAATCTAGCCACATGTTGTGGTACTTGCCTGCAATCCCAGCTACTGGGGCATAGGGGGACTGAGGCAAGAGGGTCACTTGAGCGTGAGAGATTGAGGTTGCTGTGAGCTAAGATGATGCCATGGCACTCTACCCAAGGTGGCAGAGTGAGCCTATGTCTCACCAATAAATAAACAAATAAATAAATGAA","GGGCACAGTGGCTCACGCCTGGAATCCCAGCACTTTGGGAGGTCAAGGTGGGTGGATCACCTGAGGTCAGGAGTTTGAGACCAGCCTGGCCAAAATGGTGAAACCCCATCTCTACTAAAAAAAATACAAAAAATTAGCCAGAATGTGGTGGTGCATGCCTGTAATCCCAGCTACTGGGGAGGCTGAGGCAGGAGAATCACTTGAACCTGGGAGGCGGAGGCAGCAGTGAGCCAAGATGGCGCCACTGCACTCCAGCCTGAGTGACAGAATGAGACTCTGCCTCAGGAAAAAAAAAAAAAAAAAAGCAAAAA"
"GL873564","8738781","8739084","chr6","92598388","92598711","90","83859607","GCTGGGCACAATGGCTCACACCTGTAATGCCAGCACTTGGGAGGCTAAGACGGGCAAATTGCCTGAGCTCACAAGTTCAAGACCCAGAGCGAGACCTCATCTCTAAAAAATTGCCATGCATTGTGGAGGGTGCCTGTTGTCCCAGCTACTTGGGAGGCGGAGAAAAGACAATCGCTTTAGCCCAAGAATTGAAGGTTGCTGTGAGCTGTGACGCTGTAGCACTCACCAAGGGCAACATAGTGAGACTCTGTTTCAAAATAAATAAATAAATAAATAAAAATAAATAAATAAAATAAAAACAAAA","GGCTGGGCTCAGTGGCTCATGCCTGTAATCCCAGCACTTTGGGAGGCCAAGGCTGGCAGATTGCCTGAGGTCAGGGGTTCAAGACCAGCCTGGCTAACATGGTGAAACCTCATCTCTAATAAAAATACAAAGATTAGCTGGGTTTGGTGGCACATGCCTGTAGTCCCAGCTATTTGGGAGGCTGAGGCAGGAGAATCGCTTGAACCCAGGAGTTGGAGGTTGCAGTGAGCTGAGATGGCACCACTGCACTCCAGCCTGGGTGACACAGCAAGACTCCGTCTCAAAAAAAAAAAAAAAAAAAAAAAAAAGAAAAGAAAAAAAAAA"
"GL873564","9560044","9560238","chrX","30236033","30236239","48","20675989","GGCCAGGTGCGGTGGCTCCTGCCTGTAATCCCAGCACTCTGGGAGGCCTAGGTGGGTGGATTGCCTGAGCTCACTGGTTGGAGACCAGCCTGATACAGATTGAGACCCCCTGCCTCTAAGAATAGCAGGGTGTTGTGACAGACACCTAAAGTCCCAGCTACTCGGGAGGCTGAGGCAAGAGAATCTCTTGAGCCC","GGCTGGGTGCGGTGGCTCACTCCTGTAATCCCAGCACTTTGGGAGGCCAAGGTGGGCGGATCACCTGAGGTCAAAAGTTCGAAACCAGCCTGACCAACAGGGTGAAACCCCGTCTCTACTAAAAGTACAAAAATTAGCCGGGCATGGTGGCAGGCACCTATAATCCCAGCTACTTGGGAGGATGAGGGAGGAGAATCACTTGAACCC"
"GL873564","9560508","9560604","chr1","212121416","212121513","30","202560908","TCGCTGTGCCCAAAAGTTAGAGGTTGCTGTGAGCTATGATACCACTGCACTTTACTGAGGGTGACAAAGTGAGACTCTGTCTCAAAAAATAAATAAA","CTTGAACCTGGGAGGTGGAGGTTGCAGTGAGCCAAGATCATGCCACTGCACTCCAGCCTGGGCAACAGAGCGAGATTCTGTCTCAAAAAAAAAAAAAA"
"GL873564","9753449","9753658","chr19","10370828","10371033","59","617379","TGAGACCCTGGTCTCTTCTAAACATTAAAAAAAAAAAGAAAACTGGGTGTTGTGGCGATGCCCATAGTCCCAGCTACTGATGAGGCTGAGGCAGGGGGATCACTTGAACCCAGGAGTCTGAAGTTGCTGTAAGCTAGGCTGAAGTCACAGTTGTCTAGCCTAGGGCAATAGAGTAAGACTGTCTCACAAAAAAAAAAAAAGGAAAGAAAA","GAAACCCTGTCTCTACTAAAAATACAAAAAATTAGCTGGGTGTGGTGGTGCGTGCCTATAATCCCAGCTACTCAGGAAGCTGAGGTGGGATAATCACTTGAACCTGGGAGGCAGAGGTTGCAGTGAGCCCCAGACTGTGCCACTGCACTCCAGCCTGGGTGACAGAGTCAGACCCTGTCTCAAAAAAAAACAAAACAAAAAAAAAA"
"GL873564","9753896","9754006","chr17","50277667","50277784","33","40523771","GCTGGGCAGGGTGGCTTGTGCCTGTAATCCTCACATTCTTGGAAGCCAAGTTGGTGGATTTCTTGAGCTCAAGAGTTCAGCCTGAACAACGGTGAGACCCCTGTCTCTCTC","CCGGGCATGGTGGCTCATGCCTGTAATCCCAGCACTTTGGGAGGCCAAGGTGGGTGGATCACTTGAGGTCAGGAGTTCAAGACCAGCCTGGCCAACATAGAGAAACTCTGTCTCTACT"
"GL873564","10693118","10693253","chr1","29437872","29437991","31","18744754","GGCCAGGCGTGGTGGCTCACGCCTGTAGTCCCAGCGCTATGGGAGGCCGAGGCGGGTGGATCACCTGTGCTCAGAGGTTCGAGACCAGCCAAGACCTCCCTGAGCCAAATGAGCCAGAGTGAGACCCCGTCTCTAC","GGCCGGGCGTGGTGGCTCACGCCTGTAATCCCAACATTTTGGGAGGCCAAGGCGGGTGGATCACCTGAGGTCAGAAGTTCGAGACCAACCTGGCCAACATGGTGAAACCCCTGTCTCTAC"
"GL873564","11596705","11596819","chr15","17759279","17759407","35","6162574","AATCCGCTACTCGGGAGTCTGATGCAGGAGGATCCCTGGAACCCGGGAGTGAGCTAGGCTGTCCATTCTACCCAAGGCAGAAGAGTGAGATTCTGTCTCAAAAAAAAAAAAAAAA","AATCCCAGTTACTCAAGAGGCTGAGGCAGGAGAATTGCTTGAACCCGGGAGGTGGAGCCGAGACCGCTCCACTGCACTCCAGCCTGGGTGACAGAGTGGGACTCTGTCTAAAAAAAAAAAAAAAAAAAA"
"GL873564","13278770","13278831","chr1","10318851","10318915","18","2959919","GGCTGAGCACAGTGGCTCATGTCTATAATCCCATCACTCTGGAAAGCTAAGAATGAGGATCT","GGCTAGGCATGGTGGCTTATGCCTATAATCCCAGCACTTTGGGAGGCTGAGGCAGACGGATCACC"
"GL873564","13278924","13279152","chr20","69116969","69117193","62","55838045","AAAATAGAGAATAAGAATCCCTTGAGCTCATGAGTTCAAGATCAGTCTGAACAAGTGTCAGACCCTATCTCTACTAAAAATGGAAAAATTAGCCAGGCACTGTGGCAAGTGCCTGTAGTCCCAGATTTCAGGAGGCTGAGGCAGGAGAATCATTTGAATCCAGGAGTTTGAGGTTGCTGTGAGCTAGGCTGACACCACTGTACTGTAGCCTGGGCAACAGAGTGAGACT","GAGGTGGGTGGATCACCTAAGGTCAGGAGTTCAAGACTAGCCTGGCCAACATGGTGAAACTCCATCTCTACTAAAAATACAATAATTAGCTGGGTGTGGTGGCATGTGCCTGTAATTCCAGCTACTCAGGAGGCTGAGGCAGGAGAATCACTTGAACCCAAGAGGCGGAGGTTGCAGTGAGCCGAGACTATGCCACTGCACTCTACCCTGGGCAACAGAGCAAGA"
"GL873565","1417041","1417214","chr4","44130284","44130433","54","42713243","GGCCAGGCGTGGTGGCTCACGCCTGTTGTCCCAGCGATTTGGGAGACTGAGGTGGGTAGATCACCTGTACTCAGAGGTTCGAGACCAGCTGAAGACCAGCCTGAGGCAGAGTGAGACCCCCGTCTCTATAAGAACAAGACAGCCGGACCTTGTGATCCCAGCTACATGGGTGGC","GGCCGGGTGCGGTGGCTCACACCTGTAATCCCAGCACTTTGGGAGGCTGAGGTGGGCAGATAACCTGAGGTCAGGCGTTCGAGACCAGCCTGGCCAACATGGTAAAACCCCGTCTCTACTAAAAATACAAAAATTAGCCAGGTGTGGTGG"
"GL873565","2138367","2138455","chrX","124155143","124155229","17","122016776","GGCTGGGCGTGGTACTCACGCCTGTTGTCCCAGTGCTGTGGGAGGCTGAGGTGGGTGGATCCCCTGAGCTCAGCAGAGTTTGAGACCAG","GGCTGGGTGCGGTGGCTCACGCCTGTAATCCCAGAACTTTGGGAGGCTGAGGTGGGTGGATCACCTGGGGTGAAGAGTTCGAGACCA"
"GL873565","2459722","2459938","chr7","32729330","32729532","57","30269608","AAAAAGACCAAACACCCCAGCTCTACTAAAAGTAGAAAAATTAGCTGGGTATTGTAGTGGGCACCTGTAGTCCCAGCTGCTTGGGAGGTTGCGGCAGGAGAACCACTTAAGCCCAGGAGTTGGAGGGTGAGGTGGGCTGAGGCCACTGCATTCTAGCCTAGGCAACAGAATGAGACTCTGTCTCAAACAAACAAACAAACAAACAAACAAAAAACAA","GAAACCCCATCTCTACTAAAAATACAAAATTAGCCAGGCATGGTGGTGCACACCTGTAGCTCCAACTACTTGGGAGGCTGAGGCAGGAGAATCACTTAAACCCAGGCAGTAGAGGTTGCAGTAAGCCAAGATCGCACCACTGCACTCCAGTCTGGGCAACAGAGTGAGACTCTGTCTCAAAAAAAAAAAAAAAAAAAAAAAAA"
"GL873565","2460219","2460297","chr10","28805224","28805297","28","26345005","CTCAAGCCTGTAATTCTAGCACAGCTGGGAGGCTGAGGCAGGAAGATCTCTCAGCTTAGGATTTCAAGACTAAACACAT","GTGGCTCATGCCTGTAATCTCAGCACTTTGGGAGGCTGAGGCAGGCAGATAACCTGAGGTCAGGAGTTCGAGAC"
"GL873565","11485258","11485580","chrX","66383160","66383473","97","54897902","GGCAGGGCACAGTGGCTCAATCACAGCACTCTGGGAGGAGGCTTAGATGGGTGGATTATTTGAGTTCACAAATTTAAGAACAGCCTGAGCAAGAGTGACACCCTGTCTCTACTAAAAAACAATAGGAAAAATAAAAACTAGCTGGGCATAGTGGCATATGCCTGTGGTTCCAACTACTTGGGAGGCAGAGGCAAGTTTGCTTAGCTAGTTTTTTTTCAGGCCCAAGAGTAGAGGTTGTTGTGAGCTGTGATGCCATAGCACTCTACATAGAGTGACAGAGTGAGACTTTGTCTAAATAAATAAATAAATAAAATTTTAAAAAA","GGCCAGGCACAGTGGCTCACACCTGTAAATCCCAGCACTTTGGGAGGCCGAGATGGGTGGATCACCTGAGGTCACGAGTTTGAGACCAGCCTGGCCAACATGGTGAAACCTCGTCTCTACTAAAAATACAAAAAAAAAAAAAATTAGCTGGGCGTGGTGGTGTGCACCTGTAGTCCCAGCTACTTGGGAGGCTGAGGCAGGAGAATCGCTTGAACCCAGGAGGCAGAGGTTGCAGCGAGCCGAGATCGCGCCACTGCACTCCAGCCTAGGTGACAGAGTGAGACTCTGTCTCAAGGAAAAAAAAAAAAAAAAAA"
"GL873565","13424539","13424574","chr1","174086158","174086184","14","160661619","ACCTAGGGTGAAAGTAAGACTGTCTCAAAAAAAGAA","AAGAGAGAGAAAGAGAGAAAGAAAGAA"
"GL873565","13424654","13424896","chr16","19730961","19731217","54","6306307","GCCAAGCACAGTGGCTCACACCTGTAATCCCAGCACTCTGGGAAGCCTAGGTGGGTGGATTACTTGAGCTCAGGAGTTCAAGATCAGCCTAAGCAAGAGTGAAACTCCCATGTCTAAATAAACAGCCGGGCATTGTAGTGGGTCCCTGTAGTCCCAGCTACTCAGGAGGCTGAGGCAAGAGAATCGCTTGACCCAGGAGTTGGAGGTTGCTGTGAGCTGAGGCCACGGCACTCTATCTAGGGT","GGCCGGGCACAGTGGCTCACGCCTGTAATCCCACCACTTTGGGAGGCCGAGGCGGGTGGATTACCTGAGCTCTGGAGTTAGAGACCAGCCTAGGCAACATGGTGAAACCCCATGTCTACTAAAATACAAAAAGCCGGGCGTGGCGGCGTGTGCCAATAGTCCCAGCTACTCAGGAGGCTGAGGCAGGAGAATTGCTAGAACCCGGGAGGCGGAGGTTGCAGTGAGCTGAGATCACGCCACTGCACTCCAGCCTGGGC"
"GL873565","13679578","13679856","chr1","27657515","27657797","72","13977937","GCAGGGTACAGTGGCTCACACCTGTAATCATAGTAACTCTTAAGCGGCTGAGGCAAGTGAGAGGCCTGAGATCAGGAGTCCAAGAATAGCCTAACCAAAAGTGAGACCCCATCTCTACTAAAAATAGAAAAAAACTAGCCAGGCATGGTGGCACTTACCATAGTCCCACCTCATAAGGCTGAGGCAAGAGTATCACTTGAACCCAGAAGTTTGAAGTTGCTGTCAGCTACAATGACATCATAGCACTTTACCCAGAGCTACAGAGTAAGACTCAGTCTC","GCTGGGTGCGGTGGCTCACACCTGTAATCTCAACACTTTGGGAGGCTGAGATAGGTAGATCACCTGAGGTCAGGAGTTCGAGACCAGCCTGGCCAACATGGTGAAACCCCATCTCTACTAAAAATACAAAAAACCTAGCCAGGCATGGTGGTGTGTACCTATAATCTCAGCTATTCAGAAGACTGAGACAGGAGAATCACTTGAACTTGGGAGGTAGAGGTTGCAGTGAGCCAAGATCACACCACTGCACTCCAGCCTAGGCAACAGAGTGAGACTCCGTCTC"
"GL873566","947388","947684","chr3","178868174","178868466","60","177920786","GGCCGGGTAGGGTGGCTCATGCCTGTAATCCTAGCATTTTGAGAGGCCAAGGCAGGTAGATTACCTGAGCTCAGGAGTTCCAGACCAGGCTGAGCAAGAGCCCCATCTCTATCAAAAATAGAAAAATTAGCTGGGTATGGTGGCACATGCCTNNNNNNNNNNNNNNNNNNNNNNNNNNNNNNNNNNNNNNNNNNNNNNNNNNNNNNNNNNNNNNNNNNNNNNNNNNNNNNNNATGACACCATAGCACTCTAACCTGGAGCAACAGAGTGAGACACCGTCTTAAAAAAAAAAAAAAAA","GGCCGGGTGTGGTGGCTCATGTCTGTAATCCCAACACTTTGGGAGGCCAAGGCGGGTGGATCACCTGAGGTCAGGAGTTTGAGACCAGCCTGGCCAACATAGTGAAACCCCTCTACTAAAAATAAAAAATTAGCCAGGTGTGGTGGCANNNNNNNNNNNNNNNNNNNNNNNNNNNNNNNNNNNNNNNNNNNNNNNNNNNNNNNNNNNNNNNNNNNNNNNNNNNNNNNNNNNNNNNNNNNNNNNCTCCAGGCTGGGCAACAGAGTGAGGCTCCATCTAAAAAAAAAAAAAAAAA"
"GL873566","2530056","2530102","chr1","123145244","123145289","11","120615188","AGGCCAAGGCAGTTGGATCACCTCAGCTCAGGAGTTTGAGACCCGCC","AGGCTGAGGGAGGCGAATCACCTGAGGTCAGGAGTTTGAAACCAGC"
"GL873566","2923434","2923499","chr1","38303497","38303565","19","35380063","GGGCTCAATGGCTCAGCCTGTAATCTTAGCAGTCTGGGAGGCTGAGGCAGGCGCCTGAGCAAGAGT","GCTGGGCGCAGTGTCTCGTGCCTGTAATCCCAGCACTTTGGGAGGCTGAGGCAGGCGGATCATCTGAGG"
"GL873566","3613441","3613522","chr3","54039458","54039545","21","50426017","GGTGGCACATGCCCGTGATCCCAGCACTCTGGGAGGCCGAGGAGATCGGACTGCCTGAGCTCAGGAGTTCGAGACCAGCCTG","GCGCGGTGGCTCACGGCCTGTAATCCTTGCACTTTGGGAGGCTGAGATGGGTGGATTACCTGAGCTCAGGAGTTCGAGACCAGCCTGG"
"GL873566","6100482","6100582","chr2","51286276","51286376","32","45185794","GGCTGGGTGAGTACCTCATGCATCAAGCCCAGTGTTCTGGAGGCTGAGGCAAGGGGATCCTTGATGTGGATAGTTCAAGGCCAGCCTGGCAATTAGCTAGA","GGCTGGGTGCAGTGGCTCACGCCTATAATCCCAGCACTTCGGGAGGCTGAGGCAGGCAGGTCACCTGAGGCCAGGAGTTCAAGACCAGCCTGGCCAACATG"
"GL873566","6245586","6245714","chr3","50507869","50508002","30","44262283","GCTGGGTGTGGTGGCTCACACCTATAATACCAGCACTTGGGAGGCCAAAGCAAGTGGATTGCCTGAGTTCACAAGTTCAAGACCAGCCTGAGCAAGAGTGAGACCCTGTCTCTTAAAAATAGGTGGGCG","GCCAGGTGCGGTGACTCACACCTATAATCCCAGCACTTTGGGAGGCCGAGGCACGTGAATCACCTGAGGTCAGGAGTTCAAGACCAGCCTGACCAACATGGTGAAACCTTGTCTCTACTAAAAATACAAAAACT"
"GL873566","6245992","6246162","chr16","22888303","22888475","37","16642311","TAGCTGGGCGTTGTGGCGGGCATCTGTAATCCCAGCTACCTGGGAGGCTGAGGCAAGAAAATCACTTAAGCCCAAGAGTTTGAGGTTGCTGTGAGCTGTGATGGCACAGTACTCTATTGAGGGCAACATAGTGAGACTCTGTCTCAAAAAATAAATAAATAAATAAATAAA","ATTAGCTGGGCGTGGTGGTGGGCACCTGTAATCCCAGCTTCTTGGGAGGCTGAGGCAGGAGAATCACTTGAGCCCAGGAGGCAGAGGTTGCAGTGAGCAGAGATCGTGCCACTGCACTCCAGCCTGGATGACAGAGTCAGACTTTGTCTCAAAAAAAATAAAAAATAAAAAAA"
"GL873566","6483968","6484033","chr19","10207852","10207913","17","3723884","AAAATATGGTAAAATAAGCCAAGGATGGTGGGTCACACCTGTAATCCCAGCTACTCAAGAGACTGA","TAAAAATACAAAATTAGCTGGGTGTGGTGGCACACACCTGTAATCCCAGCTACTCAAGAGGC"
"GL873566","7043395","7043464","chr10","28805224","28805297","20","21761829","GGCTAGGCCTGGTAATCCCAGCACTCTAAAAGGCTGAGGCAGGTGGATAGCCTGAGCAAGAGTGAGACCA","GTGGCTCATGCCTGTAATCTCAGCACTTTGGGAGGCTGAGGCAGGCAGATAACCTGAGGTCAGGAGTTCGAGAC"
"GL873566","7888407","7888429","chr16","1275850","1275872","4","6612557","CTAAAAATAAAAAATTAGTCTTG","CTAAAAATACAAAAATTAGCCAG"
"GL873566","7888682","7888751","chr13","39203832","39203891","22","31315150","GTAGTCTTGGCGTAGTGATATGTACCTTTAATCCCAGCTACTCAGGAAGTGGAGGAGGAAAGAGTACAAG","TTAGCTGGGCGTAGTGGTGTGTGCCTGTAATCCCAGCTACTTGGGAGGCTGAGGCGGGAG"
"GL873566","8203857","8203949","chr20","18199749","18199840","19","9995892","GGCCCGGCATGGTGGTGCTTTGCCTATAATCCCAGCATTCTGGGAGGCCCAGGCAGGCGGATCACCTGAGCTCACAGGTTCAAGAATGGCCTG","GGCCGGGCATGGTGGCTCACACCTGTAATCCCAGCACTTTGGGAGGCTGAGGCAGGCGGATCACCTGAGGTCAGGAGTTCGAGACCGGCCTG"
"GL873566","8268872","8268975","chr15","10815564","10815667","26","2546692","GTGGCTCATGCCTGTAATCCTAGCACTCTGGGAGGCCGAGGCAGGTGGATTCCCTGAGCTCATAGGTTTGAGACCACAAGCAAGTCCAAGACCCCATCTCTTTT","GTGGTTCATGCCTGTAATCCCAGCACTTTGGGAGGCCGAAGTGGGCGGATCACCTGAGGTCAGGAGTTTGAGACCATCTGGCCAAGATGTAGAAACCCCATCTT"
"GL873566","8269263","8269458","chr15","77706857","77707054","55","69437594","AAGACCCCATCTCTTAAAAAAGAAAAAAAAAGCTGGGTGTTGTGGCCTTCACCTGTAGTCCCAGCTACTGGGGAGGCCAAGGCAAGAGACTTGCTTGAGCCAGAGTTTGAGGTTGCTGTGAGCTATAGTGCCACGGCACTCTACCAAAGGCAACAAAGTGAGACTGTCAAAAAAAAAAAAAAAAGAAGAAGAAGAA","CCCCATCTCTATTAAATATACAAAAAAATAGCTGGGTGTGGTGGTGTGCGCCTGTAATCCCAGCTACTTGGGAGGCTGATGCAGGGGAAGTGCTTGAACCAGGGAGGTGGAGGTTGCAGTGAGCCGGAATCGTGCCACTGCACCCCAGTCTGGGCAACAGATTGAGACTCTGTCTCAAGGAAAAAAAAAAAAAAAAAA"
"GL873566","8592056","8592127","chr10","28805224","28805297","15","20213168","TCTTGCCTGTAATCTCAGCACTCTGGGAGGCTGAGGCAGGCAGATCAACTGAGCTAACAAGTTCGAGACCAG","GTGGCTCATGCCTGTAATCTCAGCACTTTGGGAGGCTGAGGCAGGCAGATAACCTGAGGTCAGGAGTTCGAGAC"
"GL873566","8809109","8809200","chr11","48033118","48033204","26","39224009","ATAGCCAGGCTTGTTGCAGGCACCTGTAGTCCCAGTTACTCTGGAGGCTGAAGCAAGGGAATATCTTGAGCCCAAGAGTCTGAGGTTGCTGT","TTAGCCTGGCATGGTGGTGACACCTGTAATCCCAGCTACTCAGGAGGCTGGGAAGGAAAATCGTTTCAACCCAGGAGGCAGAGTTTG"
"GL873566","8809477","8809608","chr19","10830410","10830544","33","2020933","GGCCAGGCGCAGTGCCTCATGCCTGTAATCCTAGAACTCCGGGAGGCTAAGGAGGGTGGATTTCCTGAGTTCACAGGCTGGAGACCAGCCTGATCTAGAGTGAGATTCCCAGCTCTAAAAATAGCTGGCCTT","GGCCAGGTGCAGTGGCTCATGCCTGTAATCCCAGCACTTTGGGAGGCCAAGGTGGGTGGATCACCTGAGGTCAGGAGTTCGAGACCAGCCTGATCAACGTGGTGAAACCCCATCTCTACTAAAATTGCAAAATTA"
"GL873566","9503716","9503881","chr12","63241189","63241340","56","53737473","TATTAAAAAAAAAAGGAATTCAAGGCCAAGAGCAGTGGCTTTTGCCTGTGATACTTCCACTGTAGGAGGCCGAGGTGGAAGGATCACTTGAACTCTGGAGTTTGAGGTTGCTGTGATCTAGGCTGACACCACAGCACTCTAACTTGGTGGGCAACAGAGCAAGACT","AAAAACAAAAATTAGCCAGGTGTGTTGGCATGCACCTGTAGTCCCAGCTACTAGGGAGGCTGAGACAGAAGAATCACTTGAACCCAGGAGGTGGAGGTTGAGTGAGCCAAGATCGCGCCACTGCACTCCAGCCTGGGTGACAGAGCGAGACT"
"GL873566","9537883","9537992","chr16","43341998","43342113","30","33804115","ATGCCTGTAATCCTAGCACTTGGGAGGCCAAGGTGGGTGGATTGCCTGAGATCACAGGTTCAAGACCAGCCTGAGCCAGAGTGAGACCCTGCCTCTAAAATGAGCCAGGT","GCCTGTACTCCCAGCACTTTGGGAGGCCAAGGCGGGTGCATCACCTGAGGTCAGGGGTTCAAGACCAGCCTGGCCAACATGGTGAAACTCTGTCTCTACTGAAAATTCAAAAAATT"
"GL873566","9538266","9538462","chr7","167658032","167658223","54","158119766","TTAATTAATTAATTAAATAAAATGAGCCAGGTGTTGTGATGGGCGCCTGTAGTCCCAGCTACTTGGGAGGTGGAGGCAGGATAATCACTTGAGTCCAGGAGTTGGAAGTTGTTGTGAGCTGTGACGCCATTGTACTTGACCCAGGGCGACATCTTGAGGCGCTCTCTCTCAAAATAAATAAATAAAGAAAGAAAGAA","TACTAAAATACATACAAAAATTAGCCAGGTATGGTGGCAGGCCCCTGTAGTCCCAGCTACTCGGGAGGCTGAGGCAGGAGAACTGCTTGAACCCAGGAGGTGGGGATTGCAGTGAGCTGAGATCGCACCACTGCACTCCAGCCTGAGCGACAGAGTGAGACTCTGTCTCAAAAATAAAAAAAGAAAAAAAAA"
"GL873566","13663722","13663916","chr1","23558411","23558571","70","9894689","CTCAAGACCAGCCTGAGCCAAGAACGAGACTGAAAATAGAAAAATTAGTGGGACGTTATGTTGAGTGCTGGCTACTCTAGAGGGTGAGGTAGGAGAATTGTTTAAACTCATGAATTTAAGGTTGCTGTGAGCTAGGCTGACGCCACAGCACTGTAGCCTGGGCAACAGGCTACAGAACAGAGTGAGACTCTGTTT","AAAAATACAAAAATTATCTGGGCATGGTGGTGGGTGCCTGTATTCCCAGCTACTCTGGAGGGTGAGGCGGGAGAATTACTTGAACCCAGGAGGTGAAGGTTGCAGTGAGCCAAGATCACGCCACTGCACTCTAGCCTGGGCAACAGAATGAGACTCTGTCT"
"GL873566","13664206","13664293","chr7","151280825","151280914","17","137616619","GGCTAGATATGGTGGCTCATGCCAGTAATCTTAGCACTTTGGGAGGCTGAGGGGAGAGGATCACTTGAGCTGAAAAGTTCAAGACCAA","GGCCAGGCATGGTGGCTCATGCCTGTAATCCCAACACTTTGGGAGGCTGAGGTGGGTGGATCACTTGAGGCCAAGAGTTCAAGACCAGCC"
"GL873567","8375378","8375469","chr3","123612391","123612479","29","115237013","GGTTGGGCTTGGTGGCACGTACCTATGATCATCCTAGCTACTCAGGGAGCATAAGGCAGAAGAATTGCTTTAGCCCGGGAGTTGAGATCAAC","TTAGTTGGGCGTGGTGGCGCATGCCTGTAATCCCAGCTTCTCGGGAGGCTGAGGCAGGAGAATGGCTTGATCCCAGGAGATAGAGGTTG"
"GL873567","9062667","9063009","chr7","6620384","6620702","97","2442283","GGCCAGGCGTGGTGGCTCACGCCTGTTGTCTCAGCGCTGTGGGAGGCCGAGGCGGGTGGATCGCCTGTGCTCAGAGGTTCGAGACCAGCATGAGCCAGAGTGAGAGCCAGAGTAAGACCCCCTCTCTACCAAAAATTGCTGGGTGTTCTGGCAGGTGCCTGTAATTCCAGGTACTTGGGAGGCTGAGGCTAGAGAATCACTTAAACCCAGGGACCCAGGGGTTGGCGGAGGTTGCTGTGAGCTATGATTCTATGGTATTCTACTGAAGGACACAAAGCGAGACTCTGTCTCCATAAATAAATAAATAAATAAATAAAATAAAAGCAAAATTAAAAAAAAAAAA","GGCCAGGCACAGTGGCTCATGTCTGTAATCCCAGCACTTTGGGAGGCCGAGGCGGGTGGATTACCTGAGGTCAGGAGTTCTAGACCAGCCTGGCCAACAAGGCGAAACCCTGTCTCTACTAAAAATACAAAAAATTAGCTGGGCGTTTTGGCACATGCCTGTAATCCCAGCTACTTGGGAGGCTGAGGCAGGAGAATTGCTTGAACTGGGGAAGTGGAGGTTGCAGTGAGCTGAGATCACACCATTGCACGCCTGAGCAACAGAGCGAGACTCTGTCTCAAAAAAAAAAAAAAAAAAAAAAAAGAAAAGAAAAAGAAAA"
"GL873567","11215752","11215787","chr1","62915138","62915167","12","51699386","CAATAAAGCAAGACTCTGCCTCCAAAAGAAAAAAAA","CAAACAAACAAACATCACAAAAAAAGAAAA"
"GL873567","11215868","11216117","chr8","45194211","45194474","73","33978343","GGCTGGGTGTGATGGTTCAGGCCTGTAATCCCAGCGCTCTGGGAGACCAAGGCAGGATAGCCTGAGGTTAAGAGTTTGAGACCAGCCTGAGCAACACAAGACCCTGTCTAAACCAGGAAAATTACTGGGGTGTGGTGGCGTGTGCCTTAATCCCAACTACTCAGGAGGCTAGAGTATTGCTTGAGGGCAGAAGACTGAGGTTGCTGTGAGGAAAGGCTAAGGTCAAGCCATTCTAGCCCAGGCAATAGAG","GGCCGGGTGTGGTGGCTCATGCCTGTAATCCCAGAACTTTGGGAGGCCAAGGCAGGTAGATTACCTGAGGTCAGGAATTGGAGACCAGCCTGGCCAACATGGTGAAACCTCTTCTGTACTGAAAATTACCTGGGCATGGTGGCACACGCCTATAATCCCAGCTACTCAGGAGGCTGAGGCAGAATTGCTTGAGCCCGGGAGACAGAGGTTGCAGTGAGCCAAGATCGTGCCACTGTCCTCCAGTCTGGCCAACAGAGCAAGACT"
"GL873567","12342574","12342696","chr3","166690011","166690120","46","154347437","GTACGCGCAAACCAGAAAAATCAACTAGGTGTGGCAGGGCACACCTGTAGTCCCAGCTACTGGGGAGGGTGAAGCAAGAGATTGCTCAAGTCTGAGGTTACAGTGAGTTAAGATGATACCACT","TACACATACAAAAAATCAGCTGGGTGTGGTGGTACATGCCTGTAATCCCAGCTACTCAGGAGGCTGAGGCCGGAAAATCACTTGAACCCAGGAGGCAGAGGTTGCAGTGA"
"GL873567","12342734","12342873","chr8","96368294","96368428","43","84025560","GGCCAAACACAGTAGTTTATACCTATAATTCCAGCACTCTGGGAAGCTGAAGCAGAAGGATCAGCTGAGGTCAGGAGCCTCAAGACAAGCCTGGGCAAGACTAAGACTCCCCTCCATCCCTTCCCCCACTGTCTTCTCAC","GGCCAGACACAGTGGCTCACACCTGTAATCCCAGCTCTTTGGGAGGCTGAGGCAGGCGGATCACCTGAGGTCAGGAGTTCAAGACCAGCCTGGCCAACATGGTGAAACTGCATCTCTACTAAAAATATAAAACCA"
"GL873568","4322030","4322103","chr11","54983169","54983243","11","50661139","GGCCAGGCGCAGTGGCTCATGCCTTTAATCATAGCACTCTGGGAGGCTGAGGTAGGCGGATCTCCTGAGCCAGG","GGCCAGGTGCAGTGGCTCATGCCTGTAATCCTAGCACTTTGGGAGGCCGAGGTGGACCGATCACCTGAGGTCAGG"
"GL873568","4439574","4439747","chr7","26745376","26745549","54","22305802","GGCTGGGCATGGTGCTCACACCTGTAATCATAGCACTCAGGGAGGCCGAGGTGAGTGGATTGCCAGAGCTCACAGGTTTGAAACCAGACAGAGCCTTTTTTTTTTTAGAAGAAATTGTAGGCTGGGCATGGTGCTCATACCTGTAATCATAGCACTTGGGAGGCCAAGGCAAGA","GGCTGGGCATGGTGGCTCACGCCTGTAATACCAGTACTTTGGCAGGCCGAGGCGGGCAGATCACCTGAGGTCAGGAGTTCAAGACCAGCCTGGCCGTTTCTACTAAAAATACAAAAAATTAGCTAGGCATGGTGGTGCGCACCTGTAATCCCAGCTACTCGGGAGGCTGAGGCA"
"GL873568","4546898","4547014","chr15","31980678","31980795","24","27433780","GGCAGGGTGTGGTGTACACCCCTATAATCCCAGCACTTTGGGAGGCTAAGGCAGGAGCATCACCTGGGGCAGGAGTTCAAGGCCAGCCCGGAGAACAGAATGAAACTCCATCTCCAC","GGCAGGGCGTGGTGGCTCACGCCTCTAATCCCTGCACTTTGGGAGGCCAAGGCAGGCAGATCACCTGAGGTCAGAAGTTCAAGACCAGCCTGGCCAATGTGGTGAAACCCCATCTCCA"
"GL873568","5509331","5509406","chr12","122182458","122182528","25","116673127","TAATCCTAGCACCCTAGGAGGCCCAGGTGGGTGGATTACCTGAGCTCAGGAGTTCAAGAGCAAAAGTGAGACCCCT","CCCAGCACTTTGGGAGGCCAAGGCAGATGGATCACCTGAGGTCAGGAGTTGAAGACCAGCCTGGCCAACAT"
"GL873568","5509687","5509883","chr11","2904691","2904882","40","2604996","GTGAGACCCTTGTCTCTACTAAAAGTAGAAAAACTAGCCAGGTGTTGTGGCAGGTGCCTGTAATACCAGCTACTTAGAAGGCTGAGGCAGGAAGATCAGTTGAACCAAAGAGTTTGAGATTGCTGTGAGCTATGATGAAGCCACAGCACTCTACTATCCAGAGCGACAGAGGGAGACTCTGTCTCCAAAAAAAAAAA","GTGAAACCCTGTCTCTACTAAAAATACAAAAATTAGCCAGGTGTGGTGGTGCATGCCTGTAATCCCAGCTACTCAGGAGGCTGAGGCAGGAGAATCACTTGAACCCAGGAGGTGGAGGTTGCAATGAGCCAAGATCGTGCCACTGCACTCCAGCCTGGGTGACAGAGCGAGACTCCATCTCAAAAAAAAAAA"
"GL873568","7119774","7119822","chrX","41233833","41233871","13","34114059","AAAAGTAAAAAATGAGCCGGGTGAGGTAGCTCACGCCTGTAATCCCAGC","AAATCAGCCGGGTGTGGTGGCTCACGCCTGTAATCCCAG"
"GL873568","10881797","10881967","chr1","164648998","164649168","46","153767201","AAAATCACATATTTGCCTGGCATGTTGACTCATGCCCCTATGATCCTAGCACTCTGGGAGGCTGAGGCAGGAGCCTCACTTGAGTCTGTGAGTCTGAGGTTGCTATGAGCAAGGCTGATGCCATGATACTCTAGTGTGGTACAACAGAGTGAGACTCTGTCTCAAAAAAAA","AAAAACACATATTAGCTGGGTATGGTTGTGCGTGCCTGTAATCCCAGCTACTTGGAAGGCTGAGGCAGGAGAATCACTTGAACCCGTGAGGCGGAGTTTGCAGTGAGCTGAGATTGTGCCACTGCACTCCAGCCTGGGCAACAGAGCAAGACTCTGTCTCAAACAAACAAA"
"GL873569","1403943","1404082","chr2","53765152","53765289","48","52361209","AAGCTGAAGCAGAAAAACGGGCTAGAGGTCAAAAGTTTGAGACCTACCGTGGCTACACAGCAAAACTCTGTCTCTAAAAAAAATAAATAAGACCAGGTAAGGTGGTCATGACTATACTCCTAGCCCCTTAAGAGGCTGAG","GAGGTGGGTGGATCACCTGAGGTCAGGAGTTCCAGAACAGCCTGGTCAACATGGCGAAACACTGTCTCTACTAAAAATACAAAAATTAGCCAGGTGTGGTGGCATGCACCTGTAGTCCCCGCTACTCAGGAGGCTGGG"
"GL873569","7343422","7343556","chrX","124155286","124155406","55","116811864","TTTGAAAGTAGACTGCAAACATCATGTTGCTTCACCTCTAAATATATTAATATGGGCCAGGTGCAGTGGATCATGCCTGTAATCCTAGCACTTGCTAGGCCAAGGCTGGCGGATAGCCTGAGCAACAGCGAGACC","ATCAGCCTGACCAACATAGTGAAACCCCATCTCTACTAAAAATGCAAAATTAGCTGGGCGTGGTGGTGCATGCCTGTAATCCCAGCTACTTGGGAGGCTGAGGCGGGAGAATCACTGGAAC"
"GL873569","7404564","7404762","chr6","586928","587122","48","6817636","GAGATCCCATCTCTTAATGAAAATAAAACAATTAGCTGCTATTGTGGCAGGCACCTGTAATTCCAGCAACCCAGGAGGCTGAGGCAGGAGGATCACGTGAACCCCACCAGTTTGAGGTTGCTATGAGCCAGGCTGATGCCAGGACACTCCAGCCTGGGCAACGGAGTGAGACTCCATCTCCAAAAAAAGCAAACAAAAA","GAAACCCCATCTGTACTAAAAACACACAAATTAGTGGGATGTGGTGGCACGTCCCTGTAATCCTAGCTATTCAGGAGACTGAGGCAGGAGAATCACTTGAACCCAGGAGGTGGAGGTTGCAGTGAGCCGAGGTCACACCACTGCACTCCAGCCTGGGCAGCAGAGTAAGACTCCATCTCAAAACAAAAACAAAAA"
"GL873569","7405040","7405133","chrX","21386588","21386682","29","13981548","GGGCAGGGCGGCTCAGGCCTCTAATCCTAGCACTCTGGGAGCTTCCTTGAGCTCAGGAGTTCAAGACCATCCTAAGCAACAGAGATCCCATCTC","GCTGGGCACGGTGGCTCACGCCTGTAATCCCAGCACTTTGGGAAGCCAAGGTTTGAGGTCAGGAGTTCAAGACCAGCCTGGCCAACAGGCTGCAA"
"GL873569","7519122","7519191","chrX","79016364","79016431","16","71497242","TTGGCCAGGCATGGTCGCTCAGGCTGTAATACCAGCTACTTGGGAAGCTGAAGCAGGAGGATCACTTGAA","TTGGCCAGGCACGGTGGCTCATGCTTATAATCCCAGCTACTCGTGAGGCTGAGGCAGGGGAATCGCTT"
"GL873569","7989158","7989286","chr8","41505677","41505810","35","33516519","AGTCCCACCTATTTGGAAGGCTGAGGCAAGAGGATCACTTGAACTCAGCAGTTTGACATTGCTATGAGTTAGATTGACTCCATGGCACTCTAGCCCAGGCAACAGAGCAAGACTCCGTCTCAAAACAAA","TAATACCAGCTACGTGGGAGGCTGAGGCAGGAGAATCACTTGAACCCGGGAGGTGGAGGTTGCAGTGAGCTGAGATTGCACCGTTGCACTCTAACCTGGGCAACAAAAGCAAAACTCTGTCTCAAAAAAAAAAA"
"GL873569","7989575","7989702","chr1","62231025","62231129","47","54241450","GGCTGGGTAATGCAGTGGCTCACGCCTATAATCCTAGTGCTTTGAGAGGCCAAGAGTGAGACTCTGTGTACTAAAAATAGAAAAATTACCTAGGCATTCTGGTGGGCACCAGTAGTCCCACCTATTTG","GGCTGGGCATGGTGGCTCACGCCTATAATCCCAGCACTTTGGGAGGCCGAGGCAGGTGGATCACCTGAGATCAGGAGTTTGAGACCAGACTGGCCAACATGGTGA"
"GL873569","10034363","10034556","chr10","61268396","61268605","62","51234033","CAGCTTGAGCAAAAGTGAGCCCCTGTCTCTACTGAAAATAGAAAAAATTAGCCAGGCGTGGTGGCACACACTTATAGTCCCAGCCACTTAGGAGGCTGAGGCAGGAGTTTGAGGTTGACATAATCTAAGCTGATACCATAGCACTCTAGCCTGGGCAATAGAGTGAGACTCTGTCTCAAAGAAGAAATTTATCT","CCTGACCAATGGTGAAACCCTGTCTCTACCAAAAATACAAAATTTAGCTGGGCATGGGGGCACGCACCTGTAGTCCTAGCTACTCGGGAGGCTGAGACAGGAGAACTGCTTGAACTCGGGAGGCAGAGGTTGCAGTGAGCTGAGATCATGCCACTGCACTCTAGCCTGGGCAATAGAGTGAGACTCCGTCTCAAAAAAAAAAAAAAAAAA"
"GL873569","10034830","10034845","chr1","217667782","217667796","2","207632952","AAAAAAGAAGAAAAAA","AAGAAAAAGAAAAAA"
"GL873569","10203815","10203922","chr8","96374555","96374671","35","86170740","GCCAGGTGTAGTGGTTCACACCTATAATCCTAGCACTCTGGGAGCCTGAAGCAGGTAAATGGACTGAGCAAGAGTGAGACTTCCACCTCTATTGAAAATAGAAAAATT","GGCTAGGTATGGTGGCTGATGCCTATAATCCCAGAATTTTGGGAGGCCGAGGCAGGCAGATCATCTGAGGTCAGGAGTTTGAGACCAGTCCCGTCTCTACTAAAAATACAAAAATTA"
"GL873569","10204196","10204373","chr20","1304385","1304559","47","8899811","GAAAATAGAAAAATTAGCCAGGCATTATAGCAGGCACCAGTAATCCCAGTTACTTGGGAGGCTAAGGCAAAAGAATCTCTTGAGCCCAAGTTTGGGGTTGCTAGGAAGTAAAACACCACAGCACTATACCCAGAACAAGAGAGTGAAGACTCAGTCTCAAAAAGATAAATAAATAAAA","AAAAATACAAAAATTAGCCAGGCATGGTGGCGGGCGTCTGTAACTCCAGCTACTTGGGAGACTGAGGCAGGAGAATCGCTTGAACCCAGGAGGCAGAGGTTACAGGTGAAATCACACCACTGCACTCCAGCCTGGGCAACAGGGCAAGACTCTGTCTCAAAAAAAAAAAAAAAAA"
"GL873569","10473375","10473444","chr8","20660648","20660717","21","10187273","TGTAGTCCCAGCACTTTGGGAGGTTAAGGCAAGAGTAGCACCCAACATGAGGAGATCAAGACCAATCTGG","CTGTAGTCCCAGCACTTTGGGAGGCTGAGGCAGGTGGATCCTTTGAGGGCAGAACTTTAAGACCAGCCTG"
"GL873570","9287350","9287485","chr1","29437872","29437991","30","20150522","GGCCGGGCGTGGTGGCGCACGCCTGTAGTCCCAGCGCTATGGGAGGCCGAGGCGGGTGGATCACCTGTGCTCAGAGGTTCGAGACCAGCCAAGACCCCCCTGAGCCAAACGAGCCAGAGTGAGACCCCGTCTCTAC","GGCCGGGCGTGGTGGCTCACGCCTGTAATCCCAACATTTTGGGAGGCCAAGGCGGGTGGATCACCTGAGGTCAGAAGTTCGAGACCAACCTGGCCAACATGGTGAAACCCCTGTCTCTAC"
"GL873571","3669989","3670207","chr4","116777080","116777297","60","113107091","AGACCAGCCTGAGGAAGAGCAAGATCCCATCTCTATTAAAAATAGAAAAATTAGCCAGGCATTCTGGTGGGCACCTGTAGTTCTAACCACCTGGGAGGCTAAGGCAAGAGGAACTCTTCAACCCAAGAGTTTGAGGTTGCTGAGAGCTAGGCTAAGGCTGCAGCACTCTAGCCTGGGCAACAGAGTGAGACTGTTTCTCAAAAACAAAAAACAAAAAAA","CGAGACCAGCCTGGTCAATATGGTGAAACCCCGTCCCTACTAAAAATACAAAAATTAGCCAGGCATGGTGGCAGGCACCTGTAGTCCCAGCTACTCGGAAGGCTGAGGCAGGAGAATCGCTTGAACCACAGAGGCAGAGGTTGCAGTGAGCCGAGACTGCACCACTGCACTCCAGCCTGGGCGACAGAGTGAGACTCAGTCTCAAAAAAAAAAAAAAA"
"GL873571","106134","106236","chr4","18143723","18143826","27","18037589","GGCCAGTCTCAGTGGCTCACACCTGTAATCCAGCATTCTGGGAGGCTGAAGCACACGGTCACCTGAGCTCAAAGGTTGGAGACCAGAGTGAGACCCCACCTCT","GGCCAGGCGCAGTGGCTCACTCCTGTAATCCCAGCACTTTGAGGCTGAGGCAGGCGGATCACCTGAGGTCAGGAGTTTGAGACCAGCCTGGCCGAAACCCCATC"
"GL873571","3670496","3670589","chr7","50468399","50468491","15","46797903","GGGCAGGCATGGTGGCTCACACCTGTAATTCTAGCACTCTTGGAGGCTGAGGCAGGAAAATGGCTTGAGGTCAGGAGTTCAAGACCAGCCTGAG","GGCCAGTCATGGTTGCTCACACCTGTAATACCAGCACTTTGGGAGGCCGAGGCAGGCGAATCACCTGAAGTCAGGAGTTCAAGACCAGCCTGG"
"GL873571","4059090","4059389","chr7","52903696","52903994","88","48844606","GGCCAGGTGCAGTGGTTCACACTTATAATCCTAGCACTCTGGGAGGCCGAGGCGAGTGAAGTGCCTGAGCTCATGGGTTCAAGACCAACCTAAGCCAGAGACCCCTGACTCTTATAATAGCCTGGCATTGTGGTGGGCGCCAATATTTCCAGCTACTCTGAGGCTAAGGCAAGAGAATTGCTTGAGCCCAGGAGTTGGAGGTTTCTGTGAGCACTGACGCCGCAGCTCTCTACCAAGGGCAACAAAGACTCTGTCTCAAAAAATAAATAAATAAATAAATAACAGAATGAAAATGAAAAA","GGCCGGGTGCGGTGGTTCACGCCTGTAATCCCACCACTTTGGGAGGCTGAGGCAGGCAGGTCACCTGAGGTCAGGAGTTCCAGACCAGCCTGGCCAACATGGTGAAACCTTGTCTCGGCTATTAGCCTGGCATGGTGGTGCGTGCCCATAATCCCAGCTACTCAGGAGGCTGAGGCAGGAGAATCGCTTGAACCCAGAAGGTGGAGGTTGCAGTGAGCCAAGATAGCACCACTGCAACTCCAGTCTGGGCAACAGAATGAGACTCTGTCTCAAAAAAAAAAAACAAAAAACAAAAAGAA"
"GL873571","4209418","4209704","chr11","32517699","32517985","80","28308281","GGCTTGGCAAGGTGGCTTACACCTCAAATCCTAGCACTGTGGGAGACTGAGGCAGGTGGATTGTTTGAGCTCAGGAGGTCAAGATAGAGAGCAAGAGCAAGTCTCTGTCTCTACTAAAAATAGAAAAGAACTACTTCCCGGGGGTCATGGCAGTAGCCTGTAATCCCAGTTACTAGGTAGAATGAGGCAAGAGGATCTGTTGAAGCCAAGAGACTGAGGTTGTTATGAGCATGCCACAGCACTCTACCCAGGGTGACAGAATGAGACTCTGTTGAAAGAAAAAAAGA","GGCCGGGTGCAGTGGCTCACACCTGTAATCCCAGCACTTTGGGAGGCTGAGGCGGGTGGATCACCTGAGGTCAGGAGTTCAAGACCAGCCTGACAAACATAGTGAAACCCTGTCTCTACTGAAAATACAAAATTAGCCAGGTGTGGTGGCGCATGCCTGTAATCCCAGCTACTCGGGAGGCTGAGGCAGGAGAATTGCTTGAATCCAGGAGGTGGAGGTTGTGTGATCACACCACTGCACTCCAGCCTGGGCGACAGAGTGAGACTCTGTCTCAAAAAAAAAAGAAA"
"GL873571","4209985","4210154","chr3","175781758","175781928","60","171571773","GAAAGAAATGAAAAGAAAGAAGTTAGCTGGTTGTTGGGGTATGCTTCTATAGTCCCACCTACTCAGAAAGCTGAAATCTGGAGTTTGGGGTTGTTGTAAGGTAGGCTGATGACATAGCACTGTAGCTTGGGCAAGAGAGTGTGACTTTGTCTCAAAAAAAATTAAAACAA","ATTAAAAACACAAAGATTAGCCAGGTGTGATGGCACACAACTGTAATCCCAACTACTCAGGAGAATCGCTTGAACCTGGGAGATAGGGTTTGCAGTGAGCCAAGATTGTGCCACTGCACTCCAGCCTGGGTGACAGAGTGAGACTCTGTCTCCAAAAAAAAAAAAAAAAAA"
"GL873571","4210444","4210570","chr17","16655655","16655789","35","12445211","GCCAGGCAGATGGCTCACACTTCATCCTAGCCCTCTGGAAGGCTGAGGCAGGCTAATTTTTTGAGGTTAGGAGTTTGAGACCAGCCTGAGGAAGAGACCCATCTCTACTTTAAAAAATAAATGGAAA","GCCAGGCATGGTGGCTCACACCTGTAATCCTAGCACTTTGGGAGACTGAGGCGGGTGAATCACCTGAGGTCAGGAGTTTGAGACCAGCCTGACCAGTATGGTGAAACCCAGTCTCTACTAAAAATACAGAAATTA"
"GL873571","4391733","4391878","chr11","33723808","33723943","46","29332075","AACTTAGCTGGGAATGGTGGCTCAAGCCTGTAATCCTAGCACTCTGGGAGGCTCAGGTGGGAGGATCACTTGAGGTTGCTGTGAGCTTGGCTGATGCCAGGACACTCTAGTGTGGGCAAGAGAGTGAGACTCCGCCTCAACAACAA","GCCGGGTGCAGTGGCTCATACCTGTAATCCCAGCACTTTGGGAGGCTGAGGTAGGCGGATCACGAGGTCAGGAGCTGAGATGGCGCCACTGCACCCCAGCCTGGGTGACAGAGCAAGACTCTGTCTCAAAAAAAAA"
"GL873571","6307773","6307841","chr9","62429628","62429694","22","56121855","CTGGGTGTGGTGGCATTGCACCTGTAATCCTAGCTACTTGGAAATCTTAAGCCCAGGAGTTGAAGACTG","CCCAGCATGGTGGTGCATACCTATAATCTCAGCTACTTGGAGGCTTGAGCTCAGAAGTTTGAGACCG"
"GL873571","6496217","6496306","chr1","27257765","27257856","27","20761548","GCAGGGTGTGTTGACCCACACCCACAATTCCAGGACTCTGGGGGGCCAGGGATGGTGGGTTCCCTCAGATCAGGAGCTCCTTACCAGCCT","GACTGGGCATGATGGCTCAAATCTGTAATTCCAGCACTTTGGGAGGCCGAGGTGGGTGGATTGCCTGAGATCAGGAGTTCAAGACCAGCCTG"
"GL873571","6499738","6499903","chr1","38976375","38976555","47","32476637","AAAATAACATGAATTGACTAGGCGAGGTGGCTCACATCTCTAATCCTAGCACTCTGGGAGGCTGAGGCAGGAGAATTGCATGAGGTTGCTGTGAGCTATGATGATACCACGGCATTCTAATCAGGGTGACAGAGTGAGATTCTGTCTTAAAACAAACAAACAAAAA","AAAATAAATAAATTAGCAGGGCCTGGTGGCGCACACCTGTAATCCCAGCTACTTGGGAAGCTGAGGCAGGAGAACCCACTTGAACCTGGGAGCCGGAGGTTGCAGTGAGCTGAGATGGCACCACTGCACTCCAGACTGCGTGACAGAGTGAGACTCCGTCTCAAAAACAAACAAACAAAAA"
"GL873571","11399575","11399872","chr15","109458692","109458994","79","98059117","CAGTGGCTCACACCTGTAAATCTAACACTCTGGGAGGCCAAGGTGGGTGGATCCCTTGAGCTCAGGAATTTGATACCAGCCTGAGCAAGAGTGAGACCTTGTCTCTACTAATAATAGAAAAATAGCCCGTGTTGTGGCACTTGTCCCAACCACTGGGGAGGCTTTAGGCGGGAGGATTACTTGAATTGGGAGTTTGATATTGCTGTGAGCTGGGCTGATGCCTTGGCATTCTAGCTTGGGTAACAGCGTAAGACTCCGTCTCAAATAAATAAATAAATAAATAAAAAGAAAAAAAGAA","GTGGCTCACACCTGTAATCTCAGCACTTTGGGAGACCGAGGCAGGTGGATCACCTGAGGTCGGGAGTTTGAGACCAGCCTGACCAACGTGGAGAAACCCCGTCTCTACTAACAATACAAAATCAGCTGGGCGTGGTGGTGCATGCTTGTAATCCCAGCTACTCGGGAGGCTGAGGTAGGAGAATCGCTTGAACCTGGGAGGTGGAGGTTGCGGTGAGCCGAGATCGAGCCACTGCACTCCAGCCTGGGTGACAGAGCAAGACTCCATCTCAAAAAAAAAAAAAAAAAAAAAAAAAAAAAAAAA"
"GL873572","114760","114841","chr8","26280134","26280211","16","26165374","GGCCAGGCATGGCGGCTCTTCCCTGTAATCCTAGCACTCTGGGAGGGCGAGGCAGGCAGATCACCTAGGCTAGGGTGAGATC","GGCCAGGAATGGTGGCTCATGCCTGTAATCCCAGCACTTTGGGAGGCTGAGGCAGGCAGATCACCTGAGGTCAGGAGT"
"GL873572","9421791","9421892","chr11","8089184","8089269","35","1332607","TACTAAATATATAGCAAGGCCAGGCACAGTGGTTCATGGCTGTAATCCCAGTACTCTGGGAGGCCTAGTCAGAGTTGACCTGAGATCAGGCTAGAAGCCTGG","ATAAAAATAATTGGAGGCCAGGCACGGTGGCTCATGCTTGTAATTCTAGCAATTTGGGAGGCTGACGCGGGTGAGATCATACTGAG"
"GL873572","11052834","11053035","chr14","11857478","11857657","65","804644","TCCACAAAGAAAGCAGAAGTGTGGCCGGGTGGTAGCTCAAGGCAGGAATCCCAGCACTCTGGGAGCTGGGAGGTGGGGGAGGATCCCTTGAGATCAGGAGTTGGAGGGCACAGTGAGCCTGGGGGAGGCCACTGTCTCTGTACTCTAGCAGGGAGACAGAGCAAGACTGCCCATTCAAAGAAAAACAACAAACAAAACAAAA","TACAAAAATTAGCTGGGCACGGTGCCACAAGCCTGTAATCCCAGCTACTCGGGAGGCTGGGCAGGGGAATAGCTTGAACCCAGAGGTGGAGGTTGCAGTGAGCCAAGATCAAGCCACAGCACTCCAGCCTGGGTGACAGAGCAAGACTCCATCTCAAAAAAAAAAAAAAAAAAAAAAAAA"
"GL873573","2564195","2564244","chr1","109985445","109985491","12","107421250","TACAAAAATTAGGCTGGGCTTGGTGGTTCACGCCTATAATCCTAGCACTT","ACTAAAATTAGCTGGGCATGGTGGTGCATGCCTGTAATTCCAGCTAC"
"GL873573","7423371","7423533","chr2","202783328","202783513","56","195359957","GGTGGCTCACACCTGTAATCCCAGCACTCTGGGAGCCCTGGTGGCTCATGTCTATAATCCTAGTACTCTGGGAGACCATGGTGGCTCATGTCTATAATCCTAGTACTCTGGGAGCCATGGTGGCTCACGCCTATAATCCTAGTACTCTGGGAGACCATGGTGG","GGCTGAGGCGCGGGGGCTCACGCCTGTAATCCCAGCACTGTGGGAGGCCGAGGCGGGTGGATCACGCCTGTAATCCCAGCACTGTGGGAGGCCAAGGCGGGTGGATCACGCCTGTAATCCCAGCACTGTGGGAGGCCGAGGCGGGTGGATCACGCCTGTAATCCCAGCACTGTGGGAGGCTGAGGC"
"GL873573","9657648","9657710","chr19","10207852","10207913","10","550204","TAAAAATAAAAAATTTAGCTGGATGTGGTGGCTCACACCTGTAATCCTAGCACTCTGGGAGAC","TAAAAATACAAAATTAGCTGGGTGTGGTGGCACACACCTGTAATCCCAGCTACTCAAGAGGC"
"GL873574","1624662","1624783","chr9","814961","815079","36","809701","GACTGGGTGGGTTGGATCATGCCTGGAATCCTAGCACCCTGGGAGGCCAAGGTGAAAGGATTGCTTGAGGTTAGGAGTTCCAGAAATGTAGCAGTCATGGTGACTTCATCCTTCTCTACCAA","GGCTGGGTGCTTTGATTCATGCCTGTAATCCCAGCACTCTGGGAGGCCGAGGCAGGTGGATCACCTGAGGTTAGGAGTTCGAGACCAGCTTGGCTAACATGGTGAAACCTCGTCTCTAC"
"GL873574","4459477","4459612","chr1","29437872","29437991","29","24978395","GGCCGGGCGTGGTGGCGCACGCCTGTAGTCCCAGCGCTATGGGAGGCCGAGGCGGGTGGATCACCTGAGCTCAGAGGTTCGAGACCAGCCAAGACCCCCCTGAGCCAAACGAGCCAGAGTGAGACCCCGTCTCTAC","GGCCGGGCGTGGTGGCTCACGCCTGTAATCCCAACATTTTGGGAGGCCAAGGCGGGTGGATCACCTGAGGTCAGAAGTTCGAGACCAACCTGGCCAACATGGTGAAACCCCTGTCTCTAC"
"GL873574","4681987","4682216","chr6","153082888","153083127","73","148400901","GGGTGCGGTGGCTCAGACCTATAATCCCAGCACTCTGAGAGGCCGAAGTGGGTGGATCACCTGAGCTCAGGAATTTGAGACCAGCCGTCTCTAAAAATAGCTGAGTGTTGTGGCAGTGGCTGTAAGTCCCAGCTGTTTGGAAAGCTGAAGCAAGGGAATCACTTGAACCCAAGAGTTTGAGGTTGCTGTGATGACAAAGTGAGACTCTATCTCAAAAAAAAAAAAAAAAA","GGCCGTGCGCGGCGGCTCACGCCTGTAATCCCAGCACTTTGGGAGGCTGAGGTGGGTGGATCACCTGAGGTCAGGAGTTTGAGACCAGCCCGACCAGAAATTAGATGGGTGTGGTGGTGCGCTCCTGCAGCCCCAGCTACTTAAGAGGCTGAGGCAGGGTAATCACTTGAACCCGGGAGGCGGAGGTTGCAGTGAGCCGAGCTCACGCCACTGCACTCCAGCCTGGGTAACAGAGCGAGA"
"GL873574","4709916","4710039","chr19","13152422","13152536","46","8442506","AAAAATAGAAAAACTAGCCAAGCATGGTGGTGCACCCCCTATAGTCTGAGCTCCTCAGCGGGCTGAAGCAAAAGGACGGCTGGAGCCCTGGAGTTTGAGGTTGCTGTGAGGCAAGGTGATGCCA","ACACATAAATTAGCCAGACATGATGGTGAGTATCTGTAATTCCAGCTCCTTGGGGGGCTGAGGCGGGAGAATTGCTTGAACCTGGGAGGCAGAGATTGCAGTGAGCCAAGATCGC"
"GL873574","6353839","6353913","chr5","25768079","25768163","22","19414240","AAAAATATAGCAAGGCCAGGCATGGTGGCTCACACCTATAATCCCAGTACTTGGGAGCTGGAATTTGAACCTAGG","AAAAAACTCAAACAAGGCTGGGCGTGGTGGCTCACACCTGTAATCCCAGCACTTTGGGAGGCTGAGGTGGGTGGATCACCTGAGG"
"GL873574","6533061","6533332","chr5","85182161","85182439","81","78649100","GGCTGGGCGAGGTGGCTTACACCTATAATCCTAGTACTCTGGGAGGCCAAGGTGGGTGGATTGCCTGAGCGCACAGTTTCAAGACCAGCTGGAGCCAGAGAGAGAGAGAGAGACCCTGCCTCTAAAAATAGCCAGGCATTGTGGCAGGCACCTGTAGTCCCAGCTACTTGGCAGGCGGAGGTATGAGAATCGCTAGAGGTTGCTGTTAGCTATGATGCCATAGCACTCTACCAAGGGCGACAAAGTGAAACTCTGCCTCAAAAAAAAGAAGA","GCCAGGCGTGGTGACTCAAGCCTGTAATCCTAGCACTTTGGGAGGCCAAGGTGGGCGGATTGCCTGAGCTCAAGAGTTTGAGACCAGCCTGGGCAACACGGTGAAACCCAATCCCTACTAAATACAAAAAAAATTAGCCGGGTGTGGTGGTGTGAACCTGTAGTCCCAGCTACTCGGGAGGCTGAGGCAGGAGAAGGCAGAAGTTGCAGTGAGCCGAGATCACACCACTGCACTCCAGCCTGAGTGACAGAGCAAAACTCTTTCTCAAAAAAAAAAAAA"
"GL873574","6643746","6643907","chr2","92627944","92628105","46","85984198","AAATAGCCAGGCGTTGTGGCAGGCACCTATAGTCCCAGCTACTTGGGAGGCTGAGGCAAGAGAATCACTTAAGCCCAAGTGACAGAGGTTGCCAGGGCACTCTACGTAGGCAACAGAGTGAGACTCTATCTAAGAAAGAAGGAAGGAAGGAAGGAGAAAGAA","TTAGCCGAGCATTGTGGTGCGCGCCTGTAGTCCCAGCTACATGGGAGGCTGAGGCAGGAGAACACCTGAACCCAGGATGTGAGCTGAGTCGCGCCATTGCACTCCAGCCTGGGCAACAGAGTGAGACTCCATCTCAAAAATAAAATAAAATAAAATAAAAAA"
"GL873574","6644163","6644274","chr1","128607504","128607619","20","121963341","CTGTAATCCTAGCACTTGGGAGGCTGAGGCAGGTGGATCACCTGAGTTCAGGAGTTCAAGACCAGCCTAAACAAGAGTGAGACCCTATCTCTACTAAAAATAGAAAAAATAT","GCCTGTAATCCAAGCACTTTGGGAGGCTGAGGCGGGTGGATCACCTGAGGTCAGGTGTTCGAGACCAGCCTGGCCAACGTGGTGAAACCCCAACTCTACTAAAAATACAAAAATTA"
"GL873574","8511822","8512127","chr1","23439759","23440073","84","14927937","GGTGGCTGGTGCCTGTAATCCTAGCACTCTGGGAGACTGAGGCAGGTGGATCACTTGAAATCAGGAGTTTGAGATCAACCTGAGCAAGAGATCTTGTCTCTCCTAAAGATAGAAAAACTAGCTGGGATTTGTGGTGGACACCTGTAATTTCAGCTACTCAGGAAGCTAAGGCAAGAGCATTGCTTAAAACCAGGAGTTTGAAGTTGATGTGAGCTAGGATGTCAGGGCAGGTTACCCAGGGTGACAGAGTGAGACTCTGTGTCAAAATAAACAAACAAACAAACAAACAAAACAAAATAAAATAAA","GGCTGGACATGGTGACTCACGCTTGTAATCCCAACACTTTGGGAGGCTGAAGCAGGCAGATCACCTGAGGTCAGGAGTTTGAGACCAGCCTGACCAACATGGTGAAACCTTGTCTCTACTAAAAATACAAAAATTAGCTGGGAGCAGTGGTGCACACCTGTAATCCCAGCTACTCGGCAAGCTGAGGCAAGATAATTTTTTAAACCTGGGAGGTGGAGGTTGCAGTGAGCCAAGATCGTGCCACTGTACTCCAACCTGGGAGACAGAGCAAGACTCTGTCTCAAAAAAAAAAAAAAAAAAAAAAAAAAAAAAAAA"
"GL873575","2107336","2107519","chr4","38052972","38053149","54","35945636","TCAATTAAAAACTTTTTAAAATGAGGCTGAGCATGGTGGTTCACACCTGTAATCCCAGCACTTTGGGAGGCCGAGGCAGGAGGATCACCTGATCCCAGGAGTCCAAGCCTACAGTGAGCCGTGATAATACCACTGCACTTCAGCCCAAAGCCTCAAAAAGAAAAAAAAAAAAGGATAGACAAGA","TATATATATATATATTATTTTGGGGGGGCATGGTGGTGCACACCTGTAATCCCAGCTACTCGGGAGGCTGAGGCAGGAGAATTGCTTGAGCCCGGGAGGCAAAGGTTGCATTGAGCTGAGATCACACCACTGCACTCCAGCCTGGCGACAGAGTCTCAAAAAAAAGAAAAAATAAAAA"
"GL873575","5831824","5831959","chr1","29437872","29437991","28","23606048","GGCCGGGCGTGGTGGCGCACGCCTGTAGTCCCAGCGCTATGGGAGGCCAAGGCGGGTGGATCACCTGAGCTCAGAGGTTCGAGACCAGCCAAGACCCCCCTGAGCCAAACGAGCCAGAGTGAGACCCCGTCTCTAC","GGCCGGGCGTGGTGGCTCACGCCTGTAATCCCAACATTTTGGGAGGCCAAGGCGGGTGGATCACCTGAGGTCAGAAGTTCGAGACCAACCTGGCCAACATGGTGAAACCCCTGTCTCTAC"
"GL873575","7451097","7451208","chr3","122814630","122814743","22","115363533","GGCCAGGTGTGGTGGCTCACACCTGTTATCCTAGCACTCTGAGAGGCCACAGCAGCTGGATCACTTGAGCTCAGGAGTTCAAGACCAGTCTGAGCAAGAGCAAGACCTCACC","GGCTGGGTGTGGTGGCTCATGCCTGTAATCCCAGCACTTTGAAAGGCCAAGGCAGATGGATCACTTGAGGTCAGGAGTTCCAGACCAGCCTGGCCAACATGGCAAAACCCCATC"
"GL873575","7451277","7451445","chr6","58863249","58863409","41","51411972","AAAAATTCAGCCAGCCACAGTGGAAGTGGATGCCTGCCATCACAGCTACTCTGGGGGCTGGGGCAAGAGAATTGCTTGATCCCAGGAGTCTGAGGTTGCTGTGACCTAGGCTGACACCACAGCACTCTACCCAGGGTGACAGAGTGAGGCTGTGTTTAAAAAAAAAAAA","TTAGCCAGGCATGGTGGCACATGCCAGTAATCCCAGCTACTCAGGAGGATGAGGCAGGAGAATCGCTTGAACCCAGGAGGCAGAGGTTGCAGTGAGCTGAGATTGCGCCACAGCACTCTACCCTGGGTGACAGAAGGAGACTCTGTCTCAAAAAAAAAAAA"
"GL873576","1765109","1765185","chrX","53921180","53921256","12","52156071","GGCCAGGTGCAGTGGCTCATATCTGTAATCCTAGCACCCTGGGAGGCCAAGGTAGGCGAATCACCTGAGGCCAGGAG","GGCCAGGTGCAGTGGCTCACGCCTGTAATCCCAGCACTTTGGGAGGCCGAGGTGGGCGGATCACTTTAGGTCAGGAG"
"GL873576","2711577","2711895","chr7","6620384","6620702","85","3908807","GGTCGAGCTTGGTGGCTCATGCTTGTAATCCTAGCACTCTGGGAGGCCAAGGCAGGTAAGTTGCCCTGAGCTCATAGGTTCCAGATCAGCATGAGCCAGAGTGAGACCCTGTCTCTACCAAAAAATAGCCCGGCATTCTGGCAGGTGCCTGTAATCCCAGCTGCTTGGGAGGCTGAGGCTAGAGAATCACTTAAACCCAAGGGTTAGTGGAGGTTGCTGTGAGCTATGATTCCACCGTACTCTACTGAGGGCCACAAAGTGAGACTCTGTCTCCATAAAAAAGAAAGAAAGAAAGAAAGAAAAATAAAATAAAATAAAA","GGCCAGGCACAGTGGCTCATGTCTGTAATCCCAGCACTTTGGGAGGCCGAGGCGGGTGGATTACCTGAGGTCAGGAGTTCTAGACCAGCCTGGCCAACAAGGCGAAACCCTGTCTCTACTAAAAATACAAAAAATTAGCTGGGCGTTTTGGCACATGCCTGTAATCCCAGCTACTTGGGAGGCTGAGGCAGGAGAATTGCTTGAACTGGGGAAGTGGAGGTTGCAGTGAGCTGAGATCACACCATTGCACGCCTGAGCAACAGAGCGAGACTCTGTCTCAAAAAAAAAAAAAAAAAAAAAAAAGAAAAGAAAAAGAAAA"
"GL873576","4782520","4782652","chr9","61136941","61137074","22","56354421","CCAGGCACGGTGGCTCACCCTTGTAACCCTAGTACTTTGGGAGGCTGAGGTGGGAGGATCCCTTGAGGTCAGGAGTTCAAGACCAGCCTGAACAACAGTGAGACCCCCGTCTCTACTAAAAAATAGAAAAGTT","GCCAGGCACGGTGGCTCACGCCTGTAATCCCAGCACTTTGGGAGGCTGAAGCGGGCGGATCACCTGAGGTCAGGAGTTCAAGACCAGCCTGGGCACCATGATGAAACCCCGTCTCTATTAAAAATACAAAAATT"
"GL873576","4782930","4783078","chr7","57521645","57521803","40","52738715","AGTTAGTCTGGTGTCATGGTGGGTGCCTGTAGTCCCAGCTGCTTGGGAGGCTGAGGCAAGAGAATCACTTGAGCCCAGGAGTTGGAGGTTGCTATGAGCGAGGCTGTAGCCTAGGCAACAGAATGAGACTTTGCCTCAAAAAAATAAAA","TTAGCTGGGCATGGTGGCGCATGCCTGTAGTCCCAGCTACTTGGGAAGCTGAGGCAGGAGAATCACTTGAACCTGGGAGGTGGAGGTTGCAGTGAGCTGAGATCGCACCGCTACACGCCAGCCTGAGCAACAGAGAGAGACTCTGTCTCAAAAGAAAAA"
"GL873576","7828709","7828723","chr5","101042981","101042996","1","93214272","TAAATAAATAAAAAA","TAAATAAATAAATAAA"
"GL873576","7828960","7829230","chr13","49045537","49045844","89","41216577","GCCGGCTGCAGTGGCTATAATCCAAGTACCCTGGGAGGCTTAGGTGGATGGATCACTTGAGCTCAGAAGTTCAAGACCAGCCTCAGCAAGAGGTAGACCTTGCCTCTATTAAANNNNNNNNNNNNNNNNNNNNNNNNNNNNNNNNNNNNNNNNNNNNNNNNNNNNNNNNNNNNNNNNNNNNNNNNNNNNAGTTTGAGGTTGCTGTGAGCTATGATGAAGCCAGGGCATTCTACCCAGGGTGACAGAGTAACTCTTAAAAAAAACTAAACAA","GGCCAGGCAGAGTGGCTCATGCCTGTAATTCCAGCAATTTGGGAGGCCTAGGCAGGCAGATTACCTGAGGTCAGGAGTTTGAGACCAGCCTGGCCAACATGGTGAAACCCCGTCTCTTCTANNNNNNNNNNNNNNNNNNNNNNNNNNNNNNNNNNNNNNNNNNNNNNNNNNNNNNNNNNNNNNNNNNNNNNNNNNNNNNGGAGATAATAGCTTTTGTAGAACGAAGCGATGCAACAGCCAGATCGCCGCCACCACCCTTAGGTCCTGGCGACAGAGTGAGATCCATCTTAAAAAAAAAAAAAAAAAAA"
"GL873576","10622840","10623093","chr7","60266447","60266705","74","49643607","GCTGGGTATGGTGGTTCACACCTATAATCCTAGCACTCTGGGAGGCTGAGGTGGGAGGATTGGTGGAGCTCAGGAGCTCATGAGGTGCCAAATCACTGGTGCCACACACCTGTATTCCCAGCTACTGAGGAGGCTGAGGCAGGAGGATCAGGTAAGCCCAGGAAGTTTGAGGTTGTAGTGAGTTAGGATGATTGAACTCTGCCTTGAGAGACAGAGCAAGATCCTCCTTCCTCCTAAGCAAACAAACAAATAAA","GGCTGGGTGCAGTGGCTCACACCTGTAATCCTAGCACTTTGGGAGGCTGAGGCGGGAAAATTGCCTGAGCTCAGGAGTTCAAGGACAGCCTAGGCAACATAGCATGGTGGTGCACGCCTGTATTCCCTGCTACTTGGGAGGCTGAGGCACAAGAATTGCTTGAATCCGGGAAGTGGAGGTTGCAGTGAGCCATTGTGGCACTGCTCTCCAGTCTGGGTGACAGAGCAAGACTCCATCTCAAAAAAAAAAAAAAAAAAAA"
"GL873576","10819939","10820007","chrX","67133632","67133707","21","56313693","AGGTTGCAGTGAAATTGTACCATTCCAATGAAGCCTGGGGGACAGAGTGAGATTCTCTCAAAATAAAAA","GGAGGTTGCAGTGAACCGAGATCGTGCCACTGCACTCCAGCCTGAGCGACAGAGTGAAACTTCGTCTCAAAAAAAA"
"GL873576","10920306","10920363","chr3","48261745","48261808","16","37341439","GCTGGACCTTGTAGAGAGTGCCTGTAATCCCAGCTACATGGGGGGCAAGAGAATTGCT","GCTGGGCATGGTGGTGCATGCCTGTGATCCCAGCTACTCAGGAGGCTGAGGCAGGAGAATTGCT"
"GL873576","10920398","10920529","chr10","67341428","67341546","30","56421030","GGCCAGGCGTGGTGGCTCACGCCTGTTGTCCCAGCACTGTGGGAGGCCGAGGTGGGTGGATTGCCTGAGCTCAGAGGAGTCCGGAAGACCAGCATGAGGCAGAGTGAGCCAGAGTAAGATCCTGTCTCTACC","GGCTGGGTGTAGTGGCTCATGCCTGTAATCCCAGCACTTTAGGAGGCCAAGGTGGATGGATTGCCTGAGCTCAGGAGTTCGAGACCACCCTGGGCAACAAGCCAAAACCCTGTCTCTAC"
"GL873577","515809","515961","chr7","137660778","137660931","43","137144969","AGCTGGGCATGGTGGCTCATGCCTATAACCCTAGCGTGCTAGGAGATTGCTTGTCAGGAGACTGAGGTTGCAGGAAACTGTGATGATGGCACTGCACTCTACCCAGGGTGACAGAGCAGGACTCTGCCTCAAAAAAAAAAAAAAAAATAGAAA","TTAGCTGGGCATGGTGGCGCATGCCTATAATCCCAGCTACTTGGGAGGCTGAGGCAAGAGAATCGCTTGAACCGGGGAGGCAGAGGTTGCAGACTGCACTCCAGCCTGTGTGACAGAGTGGGACTCCGTCTCAAAAAAAAAAAAAAAAAAAAAA"
"GL873577","1633164","1633256","chrX","38269524","38269615","26","36636360","TCAGCCAGGCATGGTGGCACTTGCCTATAAACCCAGCTCCTTGGGAAGCTGAGCCGGGAGGATCCCTTGCACCCAGGAGCAACGGAAGGCAGT","AATTAGCCAGGCATGGTGGCACATGCCTATAATCCCAGCTACTCAGAAGGTTGAGGCAGGAGAATCACTTGAACCTGGGAGGCAGAGGTTGC"
"GL873577","3979502","3979560","chr20","68909283","68909346","13","64929781","GAGTTTGAGACCAGCCTGAGCAAGACCGAGACCCAGTCTCTACTAAAAATAGAAAAATT","GGAGTTCAAGACCAGCCTGACCAACATGGAGAAACCCTGTCTCTACTAAAAAATACAAAAATTA"
"GL873577","3979839","3980009","chr10","31403126","31403287","39","27423287","ATGAGCAGATTGTCTTGGTGGGCACCTGTAGTCCCAGCTATTGGAGGTGGGAGGCTGAAGCAGGAAAATCTCTTGAGCCCAGGAGTTTGAGGTTGCTGTGAGCTAGGCTGACACCACGGCACTCTAGTCAGGGCGTCAGAGTGAGACTCCGTCTCAAAAAAAAAAAAAAAA","TTAGCTGAGTGTGGTGGCGCACATCTGTACTCCCAGCTATTTGGGAGGCTGAGGCAGGAAAATCGCTTGAACCCAGGAGGTGGAGGTTGCAGTGAGCCAAGATCACACTACTGCACTCCAGCCTGGGTGACAGAGTGAGAATCCATCTCAAAAAAAAGAAAA"
"GL873577","6050882","6051080","chr1","153219820","153220007","59","147168938","GGCTGGGCGTTGTGACTCATGCCTGTAATCCCAGCACTCTAGGAGGCCGAGGTGGGTGGACTGCCTGAACTCAGAGGTTTAAGACCATCCTGAGCCGCAGTGAGCCAGAGCGAGACCCTGTCTCTACCAAAAAAAGCTGGGTGTTGTGGTGGGCGCCTATAGTCCTAGCTACTTGAGGCGCTAAGGGTAAAAAAATTGC","GGCCTGGCACAATGGCTCACGCCTGTAATCCTAGCACTTTGGGAGGCCGGGGTGGGTGGATCACCTGAGATCAGGAGTTTGAGACCAGCCTGGCCAACATGGTGAAACTCCTTCTCTACAAAAATTAGCCAGGTGTGGTGGTGGGTACCTGCAATCCCAGCTATTTGGGAGGCTGAGGCAGGAGAATC"
"GL873577","8463965","8464050","chr9","52134422","52134508","19","43670457","CTGGGTGCTATAGCTCACGCCTATAATCCTAGCACTCTGGGAGTTTGGGGCAAATGGATCACCTAGGCTCAGGAGTTTGATACCAG","GGCTGGGAGCAGTGACTCACGCCTATAATCCCAGCACTTTGGGAGGCTGAGGCAGATGGATCACCTGAAGTCAGGAGTTCGAGACCA"
"GL873577","9471486","9471613","chr16","5178790","5178910","46","4292696","TTAGCCAGGCATAGTAGCCTGTGTGTAGTCCTAGCTACTCAGGAGGCTGAGGTAGATGGGTCACTTGAGGTTGCAGAGATTATGGTAATGTCACTGTACTCTAGCCCTGGCAACAGAGCACAACCCTG","TTAGCCGAGCCTGGTGGCATAAACCTGTAATCCCAGCTACTCAGGAGGCTGAGGCAGGGGAATTGCTTGAACCTGAGAGGAGAAGGTTGCAGTGAGCCGAGATTGCACCATTGCACCCCAG"
"GL873577","9471875","9471998","chr7","17832200","17832315","36","8360325","GGCCAGGTGAAGCAGCTCATGGCTATAATCCTAGCAGTTTGGCAGGCCAAGGTGGGAGGACTGCTTGAGGTCAAGAGTTCAAGACCAACCCATCTTTGCGAAAAATTTAAAAATTACCTAGGCA","GCCAGGAGAGGTGGCTCATGCCTCTAATCCCAGCACTCTGGAAATCCAAGGTGGGTGGATCACCTGAGGTCAGGAATTCCAGACCAGTCTGGCCAATATAAAAAATTAGCCAGGCT"
"GL873577","9853150","9853170","chr3","85044647","85044667","3","75191497","AAACAAACAAACAAAAAAAGA","CAAACAAACAAACAAACAAAA"
"GL873577","9853206","9853473","chr7","130818682","130818963","67","120965476","GCTGGGCGCAGCGTCTCACTCCTGTAATCCCAGCACTTGGGAGGCCAAGGTGAGTGGATTGCCTGAGTTTACAGTTTCGAGACCAGCCTGAGCCAAAGCGAGACCCCCATCTCTAAAAAATAGCTGGGCATTGTGGTGGGCACCTGTAGTCCCAGCTACTTGGGAGGCTGAGGCAAGAGGATCGCTTGAACCTAAGAGTTTGAGGTTGCTGTGAGCTAAGGCTCCATGGCATTCTACCAAGGGTGACTAAGTGAGACTCTGTCTAAAA","GCCGGGCACAGTGGCTCACACCTGTAATCCCAGTACTTTGGGAGGCCAAGGTGGGTGGATCACCTGAGGTCAGGAGTTTGAGACCAGCCTGGCCAACATAGTGAAACTCTACTAAAAATACAAAAAAATAGCTAGGCATGGTGGTGCGCACCTGTAATCCCAGCTACTTGGGAGGCTGAGGCAGGAGAGTTGCTTGAACCCAGCGGGGTTGAGGTTGCAGTGAGTTAAGATCAAGCCACTGTGCTCCAGCCTGGATGACAGAGAGAGACTCCATCTCAAAAA"
"GL873577","10722415","10722478","chr10","12501471","12501539","23","1779056","AATAAAAAAATGCTGGGTACAGTAGTACATGCCTGTACTCTCATCTGGGGAAGCTGAGGCATGA","AAAGTAAAAAATTAGAGCTGGGCATGGTGGCACACACCTGTAATCCCAGTCACTAGGGATGCTGAGGCA"
"GL873578","463331","463568","chr10","28935382","28935620","93","28472051","CAGGTGCTTTGACCCACACCCTCAACTCTAGGACTTTGGACGCCCTGGCTGGGTGGGTCCTTTAAAGTCAGGAGCTTCTTATCAGTCTGGGCAAAAGTGAGACCCCATCTCTACCAAACAAAGAAAGAAATCAGCAGTATGTTGCAGTAGAGACTCACCAATACCTTCTTTCAAAGACCAAAGCTGGAAGGACACTAAAGACCATGATCTCATGGCCTCCCTGAGCCATGACAATGCC","CCAGGTGCAGTGGCTCATGCCTGCAAGCTCAGAACTTTGGGAGGCAGAGGTGAGCAGACTGCCTGAGTTCAGGAGTTCAAGACCAGCTGGGCAACATGGTGAGACCCTATCTCTACTAAAAATACAAATAATTAGCAGGGTGTGGTAGCACACACCTGTAGTCCAGCTACTCAGGAGGCTGAGGCAGGAGAATTGCTTGAACCCAGGAGGCAGAGTTTGCAGTGAGCCAGGACTGGGCC"
"GL873578","1143712","1143827","chr11","52824583","52824692","30","51680871","GGCTGGGTGTGGTGCCTCATGCCTGTAATCTAAGCCCTCTCCGAGGCTGAGGTGGGAGGATCCCTTGAGTTTAGGAGTTTGATTTTGAGACCAGCCTGATCAAGAGAGAGACCTCA","GGCCGGGTGTGGTGGCTCATGTCTGTAATCCCAGCACTTTGGGAGGCTGAGGTGGGTGGATACCCTGAGGTCGGGAGCTCGAGACCAGCCTGACCAACATGGAGAAACCC"
"GL873578","1144101","1144139","chr3","33494224","33494257","11","32350123","GAGAGAGACCTCATGTCTACTAAAATAAATAAATATATA","GTGAAACCCGTCTCTACTAAAAATACAAAAATTA"
"GL873578","1144175","1144343","chr12","119519961","119520131","41","118375786","ATTATCCAGGCCTTCTGGTGGATGCCTGTAGTCCTAGCTACTAGAAAAGCTGGAGCAGAATCACTTGACCCAGGAGCTGGAGGTTGCAGGGAGCTAGGCTGATGCCACAGAATTCTAGCCTGAGGCAAAAGAATTGAGCCACTGTCTCAAAAAGGAACAAAAAAGAAAA","ATTAGCCAGGTGTGGTGGCATGCACTTGTAATCCCAGCTACTAAGAAGGCTGAGGCAGGAGGATCACTTGAACCCGGGAGGTGGAGGTTGCAGTGAGCCAAGATCATGCCACTGCACTCCAGCCTGGGCAACAGAGTAAGACTCTGTCTCAAAAAAAAAAAAAAAAAAAAA"
"GL873578","4593962","4594035","chr16","68825055","68825124","22","64231093","AGCTGGGTACAGTGGCTCACATATAATCCCAGTGACTCAGGAGGCTAAGACAGGAGGATTACTAGGACCTGAGA","GGCTGGGCACAGTGGCTCAGACCTGTAATCTCAGTACTTTGGGTGGCTGAGGCAGGTGGATCACCTGAGG"
"GL873578","6158845","6158972","chr3","500432","500562","24","5658413","GACATGGTGGCTCACACCTGTAATCCTAGCCCTCTGGGAGGCTGAGGCAGGTGGATCACTTGAGTTCAGGAATTCAAGACCAGCTTGAGTGAGAGCAAGACCCTGTCTCTACTAAAAATAGAAAAATT","GCACGGAGGCTCATACCTGTAATCCCAGCACTTTGGGAGGCTGAGGCAGGTGGATCACCTGAGGTCAGGAGTTCCAGACCAGCCTGGCCAACATGGCGAAACCCTGTCTCTACTAAAAATACAAAAAATCT"
"GL873578","6159253","6159444","chr19","34496349","34496541","55","28337096","ATAAAATAAAAATAGAAAAATTAGCCAGGCATTGTGGCAGACATGCGAAGTCTCAGCTACTCCAGAGGCTGAGACAGGAAGATTACTTGAGCCCAAGAATCTTGCTGTGAGCTAAGCTGATGCCATAGCATTGTAACCTAGGCAACAGAGTAAGACTTGGCCTCAAAAATAAAATAAAATAATAAAGTAAAA","TTAGTTAATTAAATTAAACTTAGCTAGGCATAGTGGAACACACCCATAGTCCCAGCTACTCTAGAGGCTGAGGCAGGAGGATTGCTTGAGCCAAGTTGGAGGCTGCAGTGAGCTATGGTGGTGCCACTGCATTCCAGCCTCAGTGACAGAGAGAGACCCTGGCTCAAATAATAATAATAAATAAATAAATAAA"
"GL873578","6766040","6766171","chr2","93098086","93098217","30","86332046","CCAGGCACAGTGGCTCATGCCTATAATCCTAGTAGTCTAGGAGGCTGAGGTGAGTGCATTGCTTGAGCTCAGGAGTTAGATACCAGCCTAACCAAGAATGAGACCCCATCTCTATTAAAAATAGAAAAGTTA","GCCGGGCACAGTGGCTCATGCCTGTAATCCCAGCACTTTGGGAGGCCGAGGCGGGCAAATCACGAGGTCAGGAGTTCAAGACCAGCCTGACCAATATGATGAAACCCCGTCTCTATTAAAAATACAAAAATT"
"GL873578","6766434","6766577","chr9","21128084","21128223","50","14361650","GTTAGCCAGGAGTTGTGGCGGGCACCTACAGTCCTAGCGACTCAGGAGGCTGAAGTAGGCAGAGTTTGATGTGTTGCTGTGAACTACAAGGACACCAATGCACTCTAGGCCGGTAACAGAGTGAGACACTGACTAAAAAAAAAA","TTAGCCAGGTGTGGTGGCACATGCCTGTATTTCCAGCTACTCGGGAGGCTGAGGCAGGAGAATTGCGTGAGCTGAGATCATGCCACTTCATTCCAGTCTGGGTGACAGAGTGAGACTCTGCCTCAAAAAACAAAACAAAA"
"GL873578","7397948","7398119","chr5","40230148","40230319","43","32832200","TAAAAATAGCCATGCATTGTGACAGGCACCTGTAGTCCCAGCTACTCAGGAGGTTGAGGTAAGAGAATCACTTGAACCCAAGAGTTTTGAGGTTGTTATGAGCTAAGACGCCTCGGGACTCTACAAAAGGTAACAAAGTGAGACTCTGTCTCATAAAAAAAGAAAAAAAGAA","AAAATTAGCCAGGCATGGTGACGTACACCTGTAGTCCCAGCTACTCGGGAGGCTAAGGCAAGAGAATCGCTTGAACCCAGGAGGCAGAGGTTGCAGTGAGCTTAGATCACGCTACTGCGCTCCAGCCTGGGTGACGGAGTGAGACGCCATCTCAAAAAAAAAAAAAAAAAAA"
"GL873578","7398378","7398515","chr15","102382935","102383070","35","94984557","GGTCGAGCAAGGTGGCTCACGCCTGTAATCCTAGCACTCTGTGAGGCTGAGGCAGATGGATTGCCTGAGCTCGTGGGTTCGAGACCAGCCTGAGCCAGAGTGAGACCTCATCTCTAAAAATAGCTGGGAAGCTGGGCA","GGCCAGGTGTGGTGGCTCACGCCTGTAATCCTAGCACTTTGGGAGGCTGAGGCGGGTGGATTGCCTGAACTCAGGAGGTCAAGACCAGCCTGGGCAACACAGTAAAACCCCATCTCTACTAAAATACAAAAAATCA"
"GL873579","370235","370429","chr16","38067345","38067552","57","37697110","GCACAGGCCTGAAATCCTAGCACTCTGAAAGGCCAACGGAGGAGAATTTCTGGAGCTCAGGAGTTTGATACCAGCCTAAGCAAATAAAGCTAGACCTCTATCTCTACTAAAATTAGAAAAATTAGGCAGATGTGGTGGTAGGCACCTATAGTCCCAATTACTCCAGAGGCTGAGGCAGAAAGACTCTTGAACCCA","GTCAGGCATGGTGGCTCATGCCTATAATCCTAGCACTTTGGGAGGCCAAGGCCGGTGGATCACCTGAGGTCAGGAGTTTGAGACCAGCCTGGCCAATATGGCAAAACCCCGTCTCTACTAAAAATAAAAAAATTAGCTGGGCACGGTGGTGGGCACCTATAGTCCCAGCTACTCAGGAGGCTGAGGCAGGAGAATTGCTTGAACCCAG"
"GL873579","370936","371046","chr3","3847698","3847802","33","3476762","TGACTCTTGAACCCAGGCACATGAGGTTGCTAAGAGTCTAGGCTGATGTCACGGCACTCTAACCTGGGAAACAGTGTGAGGTTCTGCCTCAATAAATAAATAAATAAATAA","TGGCTTGAACCCAGGAGGCGGAGGTTGCAGTGAGCCGAGATCACGCCACTGCACTCCAGCCTGGGCAACAGAGCGAGACTGTCTCAAAAAAAAAAAAAAAAAAAA"
"GL873579","599436","599605","chr10","38982686","38982853","41","38383250","AAAAAGTCAGACATTGTGGCAGGTGTCTGTAATCCCAGCTATTTGGGAGGCTGAGGCAGGAGTATCATTTGAACCCACGAGTCTGAGGTAACTGTGAGCTAGGCTAACACAACAGCACTCTAGCCTGGGCAATAGAATGAGACTCTATCAAGAAAAGAAATGAAAAGAAA","TATTAGCCTGACACAGTGGCGCGCATCTGTAATCCCAGCTACTTGGGAGGCTGAGGCAGGAGAATCACTTGAACCCAGGAGGCGGAGGTTGCTGTGGGCTGAGATCATGCCACTGCACTCCAGCCTGGGCAACAGAGGGAGGCTCCATCTCAAAAAAAAAAAAAAAAA"
"GL873579","599942","599953","chr3","71473700","71473710","4","70873758","TTTTAAAATAGT","TTTAAAAAAAA"
"GL873579","600232","600365","chr1","16061315","16061447","30","15461083","GGCTAGGCAAGGTGACTCATGTCTGTAATCCTAGTACTCTGGGAGGTTTGAGGCAGGAAGACCACTTTAGCTCAAGAGTTCCAGATCAGCCTGTGCAAGAGTGATACATCATCTCTACTAAAAATCAAAAATTA","GGCTGGGCATGGTGGCTCATGCCTGTAATCCTAGCACTTTGGGAGGTTGAGGCAGGCAGATCACTTGAGGTCAGGAATCTGAGACTAGCCTGGCCAACATGGTGAAACTCCATCTCTACTAAAAAAAAAAAAA"
"GL873579","5650320","5650591","chr6","54938866","54939145","71","49288546","GTCAGGTGTGTTAGCTTACAGTAGTAATCCTAGCACTTTGGGAGGTTGAAGTGGGTGGATTGCTTGAGCTCAGGGGTTCAAGACCAGCCTGAACAAGAGTGGGACCTCATCTCTATTAAAAACAGAAAAACTAGCTGGGTGTTATGGTGGGTGTCTGTAGCCCCAGCTACTCAGGAGGCTGAGGCAGGAGGTTGAGGTTGCTGTGAGCTATTGAGACCACAGCACTCTATCCAGGGCAACAGAGTGAGACCCCTCCCCCCCCCAAAAAAAAA","GGCCAGGTGTGGTGGCTCACGCCTGTAATCCCAACACTTTGGGAGGCCGAGGTGGGTGGATCACCTGAGATCAGGAGTTCAAGACCACCCTGGCCAACATGGTGAAACCCCGTCTCTACTAAAAATACGAAAATTAGCTGAGTGTGGTGGTGCATGCCTGTAGTCCCAGCTACTCAAGAGGCTGAGGCAGGAGGTGGAGGTTGCAGTGAGCCGAGATTGCATCACTGCACTCCAGCCTTGGCGACAGAACGAGAGAGACTCCATCTAAAAAAAAAAAAAA"
"GL873579","7037162","7037347","chr3","37328686","37328893","67","30291524","GAGGTGGGTGGATTGCCTGAGCTCACAGGTTGGAGACCAGCCTGAGCCAGAGCAAGACCTTATCTCAAAAAATAGCCAGGTGTTGTGGCTGGCACCTGTAGTCCCAGCTGCTCAGGAGGCGGAGGCAAGAGAAATGCTTGACCTCAGGAGTTTGAGGTTGCTGTGAGTTCAACTCACACTAATACA","GAGGCAGGGGGATCACCTGAGGTCAGGAGATCGAGACCAGCCTGGCCAACATGGTGAAAACCTGTCTCTACTAAAAATCCAAAAACATTAGCCAGGTGTGGTGGCACGCACCTGTAATCCCAGCTACTTGGGAGGCTGAGGCAGGAGAATCACTTGAACCTGGGAGGCAGAGGTTGTAGCGAGCCGAGATCACACCACTGCACCCCAG"
"GL873579","11077764","11077972","chr19","1200469","1200683","63","9877295","GCCAGGTGCAGTGGCTCATGCCTATAATCCTAGCACCCTAGGAGGCTGAGGAGTTCAAGACCAGCCTAAGCAACTGTGAGACCCCATCTCTACCAAAAATAGAAAAATTAGCTGACTGTTATGGTGTGCACCTACAGTCCTAGCTACTCAGGAGGCTGAGGCAGAAAGAGTCCTTGAACCCAGGAGGCTTTTTTTTGTTGTTGTTGTTG","GGCCAGTCGCGGTAGCTCATGCCTGTAATCCCAGCACTTTGGGAGGCCGAGGCGGGCAGATCACCTGAGACCAGCCTGGCAACATGGTGAAACCCCATGTCTACCCAAACTACAAAAATTAGCTGGGTGTGGTGGTGCACGCCTGTAATCCGAGCTACTCAGCAGGCTGAGGCAGGAGAATCCCTTGAACCTGGGAGGCAGAGGCTGCAGTGAGC"
"GL873579","11078245","11078333","chr19","4926258","4926351","22","6151987","TGAACCCAGGAGTTTGAGTTCGCTGTGAGCTAAGCTGAGGCCACAGCACTCCAGCCTGGGCAACAGAGTGAAAGGAAAAAAATAAAAAA","TGAACCCGGGAGGTGGAGGTTGCAGTGAGCCAAGATCACACCAATGCACTCCAGCCTGGGCAACAAGAGTGAAACTCTGTCTAAAAAAAAAAAA"
"GL873580","320374","320488","chr13","48549305","48549409","42","48228931","GGTAGTGCGTGCCTGCATTCCCAGCTACGGGAGGGCAGGGACTTGAGGCCAGCCTGGGCAAAATAATGAGACCTACTAATGACTCTACTAATACAGAAACAATTAGCTAGGTATG","TGGGAGGCCGAAGTGCGCAGATCACCTGAGGTCAGAAGTTGGAGACCAGCCTGGCCAACATGGTGAAAACCCATCTCTACTAAAAATACAAAAATTAGCTGGGCA"
"GL873580","374969","375091","chr6","147681010","147681135","27","147306041","CGGTGGCTCACACCTATAATCCTAGCATTTTGGAAGGCTGAAGCCGAGGATCTCTGGAAGTCAGAAGTTCAAGACCAGCCTGCCCAAGAGCAAGACCCCATCTCTACTAAAAATAGAAAAACT","GGTGGCTCACACCTGTAATCCCAGCATTTTGGGAGGCTGAGGCAGGCGGATAATCTGAGGTCAAGAATTTGAGACCAGCCTGGCCAACATGGAGAAACCCTATCTCTACTAAAAATACAAAATTAC"
"GL873580","375369","375549","chr7","19977275","19977456","44","19601906","CTAACCAAGTTAGTTAGTTTTAGTTGGCAGGTGCCTGTAGTCCCAGCTCCTTGGGAGGCTGAGGCAAGAGAATGGCTTGAGCCCAGGACTTTGAAGTTGCTGTGAGCTATAATGACACCACAGCACACTACCCAGGGTGACAGAGTGAGACTGTCTCAAAAAAACAAACAAACAAAAAAAA","AACAAACGTTAGCCGAGCATGGTGGTATGTGCCTGTAGTCCCAGCTACTTGGGAGTCTAAGGCAGGAGAATTACTTGAGCCCGGGAGGCAGAGGTTGCTGTGAGCCAAGATCACGCCACTGCACTCCAGCCTGGGTGACAGAGTGAGACTCCATCTCAAAAAAAAAAAAGGAAAAAAAAAAA"
"GL873580","8760922","8761015","chr11","104681322","104681416","19","95920400","GGAGGGAGACACTGCAGTGAACTGCGATCGTGTCTCTGCTTTCCAGGCTGGGTGACAGAGTGAGACTCGGTCTCTAAAATAAAAAATAAATAAA","GGAGACGGAGGTTGCAGTGAGCTGTGATCGCGGCACTGCACTCCAGCCTGGGCAACAGAGTGAGACTCTGTCTCAAAAATAAATAAATAAATAAA"
"GL873580","9391260","9391306","chr14","49279240","49279285","12","39887980","GCCAGTCGAGGTGGCTCACACTTGTGATTCCAGCTACTTGGAAGACT","GGCTGAGATGGTGGCACACACCTGTAATCCCAGCTACTTGGGAGGC"
"GL873581","759283","759365","chr6","46535476","46535542","30","45776193","TAAGAACCTGAAAATAGAGCCAGGCATAGTGGTACATGCGTATAGTCCTGGCTACTCAGGAGGTTGAAACAACAGGATTACTT","CAAAATAGCCAGGCTTGGTGGTGCATGCCTATAATCCAAGCTACTCGGGAAGCTGAGGCAGGAGAAT"
"GL873581","1145844","1145979","chr1","29437872","29437991","29","28292028","GGCCGGGCGTGGTGGCTCACGCCTGTAGTCCCAGCACTATGGGAGGCCGAGGCGGGTGGATCACCTGTGCTCAGAGGTTCGAGACCAGCCAAGACCCCCCTGAGCCAAATGAGCCAGAGTGAGACCCCGTCTCTAC","GGCCGGGCGTGGTGGCTCACGCCTGTAATCCCAACATTTTGGGAGGCCAAGGCGGGTGGATCACCTGAGGTCAGAAGTTCGAGACCAACCTGGCCAACATGGTGAAACCCCTGTCTCTAC"
"GL873581","9628238","9628362","chr5","141044567","141044691","34","131416329","ATCCCAGGTAGTCGGGAGGCTGAGGCAGGAGGATCACTTGAACCCAGGAGGTTGAGGTTGCTGTGAGCAAGGCAGAGGCAACGGCACTCTAGCCACGGGGGCACAGAGACTCTTGTCTTTAAAAA","TAATCTCAGCTACTCGGGAGGCTGAGGCAGGAGAATCGCTTGAGCCCAGAAGGTGGAGGTTGCAGTGAGCCAAGATCGCGCCATTGCACTCCAGCCTGGGCGACAGTGCGAGACTCTGTCTCAAA"
"GL873582","1580485","1580534","chr6","32576760","32576806","12","30996275","CAGCACTTGAGAGGCCAAGGCAGGTGGATCAACTGAGCAAGAATGAGACC","CCAGCACCTTGAGAGGCCAAGGCAGGTGGATCACCTGAGGTCAGGAG"
"GL873582","1644368","1644551","chr1","211626449","211626612","63","209982081","AAAATTTGCCGGGCTCCATAGCTCATGCATGTAATCATAGCACTCTGGGAGGCCAAGATGGGAGGATCTCTCAAGCTCTCTTACTTGGGAGGCTGAGGTTGCTGTGAGTTAGGCTTACGCCACAGCACTCTACTCTAGCGTGAGCAACTCTACTCTTAGTATGAGACTGTCTCAAAAGAAAAAA","AAATTAGCCAGGCGTCGTGGCACATGCCTGTAATCCCAGCTACTCGGGAGGCTGAGGCAGGAGAATAGCTTGATCTCGGGAGGCGGAGGTTGCAGTCAGCCGAGATCACACCACTGCAATCCAGCCTGGACAACAGAATGAGACTCCATCTCAAAAAAAACAAA"
"GL873582","5794385","5794459","chr13","18872784","18872852","27","13078399","ATATTGTTAAGCACAGCCACTATTAAAAATTAAATTATAGGCCAGGCATAGTGGCTCATGCCTGTAATCCTAGCT","TGAAACCACCATCTGGACCAAGATACAAAATGTTGGCTGGGCATGGTGGCTCACACCTGTAATCCTAGC"
"GL873583","102645","102683","chr14","5808766","5808804","14","5706121","GAGCAGATCACCTGAGCTCAGGAGTTTGAGACCAGCCTG","GAGGAATCCCTGTGCTCAGGAAGCTTACATTCTAGTGAG"
"GL873583","6200447","6200560","chr4","17786849","17786963","24","11586402","GGCCAGGAGGGACGGCTCATGCCTGTTATCCTAGCACTATGGGAGACTGAGGTGGGAGGATCACTTGAAGTTAGGAGTTCCAGACCAATCTGACCAAAGTGAGACCTCATCTCT","GGCCAGGCTTGGTGGCTCATGCCTGTAATCTTAGCACTTTGGGAGGCTGAAGTGGGTGGATCACTTGAGGTCAGGAGTTAGAACCAGTCTGGCCAACATGGTGAAACCTCAGCTC"
"GL873583","6200584","6200752","chr6","169626528","169626696","42","163425944","TTAGCTGGATGTGGTAGCACATGCCTATAGTCCCATCTACTCAGGAGGCTGAGACAAGAGAGTTGCTTAAGCCCAGGAGTTTAATTTAACTGTGAACTAGACTGAGACTGTGGCACTCTAGCTGGGGCAACAGAGTGAGACTCTGTCTCAAAAGAAAGCAAGAAAGAAA","TTAGCTGGGTATGGTGTCAGATGCCTGTAGTCCCAGCTACTCAGGAGGCTGAGACAGGAGAATCGTTTGAACCCAGGAGGCCAGAACTGCAGTGAGCTGAGATTCGCACCACTGCGCTCCAGCCTGGGCCAGACAGAGTGAGACTCTATCTCAAAAGAAAAAAAAAAAA"
"GL873583","10217398","10217583","chr3","36257142","36257313","44","26039744","TACTAAAAATAAAGTGTGATAGCCAGGCATGGTGGTGGTGCCTATAGAACCAGGCTATTCAGGAGGCTGAGGCAGAAGGATCACTTGAACCCAGGAGTCTGACGTTGCTGTGAGCTAGGCTGGTGCCATGGTACTCTAGCCTGTGGTAACAGAATGAGACTCTATCTCAAAAATAAAAATAAAAAA","TACAAAATTAGCCAGGCGTGGTGGTGCGTGCCTGTAATCCCAGCTACTTGGGAGGCCGAGGCAGAAGAATGACTTGAACCCAGGAGACAGAGGTTGCAGTGAGCCAAGATCCCACCATTGTACTCCAGCCTGGGCAACACAGTGAGACTCCATCTCAAAAAAAAAAAAAAAA"
"GL873583","10394919","10394983","chr16","12841703","12841771","22","2446784","GAGGTCAGGAAATCAAGATCAGTCTGGGCAATATATTGATACCCTGCCCCTACATAAGGAAGAAA","AGGTCAGGAGTTCAAGACCAGCCTGGCCAATATGTTGAAACCTCATCTCTACTAAAAATACAAAAATTA"
"GL873584","521512","521529","chr1","167402212","167402233","10","166880700","GCATGGAACCCCCCACTC","GGTGAAACCCCATCTTTACTAA"
"GL873584","2079725","2079768","chr15","4338291","4338335","11","2258566","GGCAGGTGGATTACCTGAGTTCAGGAGTTGGAGACCAGCCTGAC","AGGCGGATGGATCACGAGGTCGGGAGTTTGAGACCAGCCTGACCA"
"GL873584","5216877","5217053","chrX","91350057","91350230","49","86133180","CTACTGAAAATGATGACAGAGGCTGGGCATGGGGGCTCCCGCCTGTTATCCTAGCACCCTCGGAGGCTGGGGAATGAGGATTGCTTACGCCCAAGAGTTTGAGGTTGCTGTGAGCTGAGGCCGCTGCACTCTAGCCTGGGCAACAGAGTGAGACTCTGTCTCAAAAAAAAAAAAAAA","TGCAAAAATGAGCTGGGCATGGTGGCACATGCCTGTAATCCCAGCTACACAGGAGGCTGAGGCAGGAGAATCGCTTGAATCTGGGAGGCGGAGGTTGCAGTGAGCTGACATCAGGCCCCTGCACTCTAGCCTGGGCCACAGAGCAAGACTCCGTCTCAAAAAAAAAAAAAAAAA"
"GL873584","7289930","7289950","chr2","51453328","51453345","10","44163398","TGAGGCTCTGTCTCGAAATAA","AATGCCATCTATTAAAAA"
"GL873584","7289975","7290131","chr11","49739997","49740154","37","42450022","CAAGAAAATTAGCTGAGAGTCCTGGTAGGTGCCTGTAATCCCAGCTATTCATGAGGCTGAGGCAGAAGGATCACTTGGGTCCAGGAGTCTGAGGTTGCTGTGAGCTAGTCTGACGCCATAACACGCAAGCCTGGGCAACAGAGTGAGGCTCGGTTTC","CTACAAAAATTAGCTGGGCGTGGTGGCACATGCCTGTAATCCCAGCTACTCGGGAGGCTGAGGCAGGAGAATCACTTGAGCCCAGGAGGCGGAGGTTGCAGTGAGCCAAGATCATGCCATTGCACTCCAACCTGGGCAACAGAGCAAGACTCCATCTC"
"GL873584","7577743","7577867","chr5","48394329","48394446","27","40816586","GGCTGGATGAGGTGGTTCATGCCTGTAATCCTAGCACTCTGGGAGGCCAAGGTGGGTGGATTGCCTGAGCTCAGGAGTTCAAGACCAGCCTGAGCAAGACCCTGTCGCTAAAAATAGCTGGGTGT","GGCTGGGTGCAGTGGCTCATGCCTGTAATCCCAGCACTTTGGGAGGTCAAGGCGGGTGGATCACCTGAGGTCAGGAGTTCAAGACCAGCCTGGCCAACATCTCTACTAAAAATACAAA"
"GL873584","7578135","7578289","chr1","130112713","130112865","31","122534578","GGAGCTGGGTTTTGTGACTGCACCTGTAATCCCAGCTGCTCAGGAGGCTGAGGCAAGAGAATTGCTTGAGCCCAGGAGTTGGAGGTTGCTGTGAGCTGTGATGCCAGGGAACTCTACCAAGGGTGACAAAGTGAAACTCTGTCTCAAAAAAAAAA","TTAGCCAGGTGTGGTGATGCATGCCTGTAATCCCAGCTACTCATGAGGCTGAGGCAGGAGAATTGCTTGAACCTTGGAGCTGGAGGTTGCAGTGAGCTGAGATCAGACCACTCCAACCTGGGTGACAGAGCGAGACTCTGTCTCAAAAAAAAA"
"GL873585","1450952","1451121","chr10","59681079","59681242","48","58230127","TAAAAACAGAAAAAACTAGTCAGGTGGTGTGGTAGGTGCTCATAAGTCCCAGCTGCTTGGGAGACTGAGGCAAGAGAATCACTTGAGCACAAGAGCTTGAGGTGGCTGTGAGCTATAACACCATAGCACTGTACTGAGGGTGACAAAGTAAGACTCTGTCTCAAAAAAAA","TACAAAAATTAGTCAAGGGTGGTGGTATGTGCTTGTAATCCCAGCTATTTGGGAGGCTGAAGCAGGGGAATCCTTGAACCCAGGAGGTGGAGGTTGCAGCGAGCCGAGATCACGTCACTGCACTCTAGCCTGGGCGATAGGGTGAGACTCTGTCTCAAAAAAAA"
"GL873585","1451382","1451515","chr6","17405813","17405948","24","15954431","GGCCCGGCTCGGTGGCTCACACCTATAATCCTAACACTCTGGGAGGCTGAGGCAGGTGGATCACCTGAGCTCAGGAGTTTGAGACCAGCTGAGCAAAAACAAGACCCTATCTCTGCTAAAAATAGAAAAAACTA","GGCCGGGCGGGGTGGCTCACGCCTGTAATCCCAGCACTCTGGGAGGCCAAGGCAGGTGGATCACCTGAGGTCAGGAGTTTGAGACCAGCCTGGCCAACACGCAGAAACCCTATTTCTACTAAAAACACAAAAATTA"
"GL873585","1626960","1627026","chr7","17782729","17782794","22","16155769","AAGATGCCACAGCACTCTACAAGAGTGACCAAGTGAGACTCTGTCTCAAAAAAAAAAAGAAAAGGAA","CAATCGCACTACTGCACTTCAGCCTGGGTGACAGAGTGAGAACCTGTCTCAAAAAAATAAATAAAA"
"GL873585","1627304","1627531","chr11","17033552","17033788","61","15406248","GGCTGGGCACAGTGGCTCACGGCTATAATCTAGGCACTTGGGAGGCTAGGGCAGGTGGATTGCCTGAACTGACAAGTTTGAGACCAACCTGAGCAAGAGCGAGACCCCTGTCTCTAAAACATAGCCAGGCTCTGTGGTGGGCGTCTGTAGTCCCAGCTACTTGGGAGGCTGAGGCAAGAGAATTGCTTGAACTCAAGAGTCTGAGGTTGCTGTGAGTTAAGATGCCAC","GCCCGGCGCAGTGGCTCACGCCTGTAATCCCGGCACTGTGGAGGCCAAGGCAGGCGGATTGCCTAAGCTCAGGGATTCGAGAACAGCCTGGGCAACATGGTGAAACCCCATCTCTACTAAAATACAAAAAACTAGCCGGGCGTGGTGGTATGCGCCTGTAATCCCAGCTACTTGGGAAGCTGAGGCAGGAGAATTGCTTGAACCCGGGAGATGGAGGTTGCAGTGAGCTCAGATCAC"
"GL873585","3626082","3626158","chr1","100916857","100916922","27","97290775","TGCCTGTAATCCCAGCACTTGGGAGGCGGAGGTGGGTAGATTGCCTGACCCAGAGTGGGACCTCATCTCTAAAAGAA","CATGCCTGTAATCCCAGCACCTTGGGAGGCCAAGGTGGGTGGATCACCTGAGGTCAGTAGTTTGAG"
"GL873585","8849829","8849913","chr18","48581945","48582025","18","39732116","GGCTGGACGAGGGGACTCATGCCTGCAATCCCAGCACTGAGAGAGGCCAAGGCAGGTGGATCCCCTGAGCTCAGAAGTTTGAGAC","GCTGGACGCAGTGGCTCACACCTGTAATCCCAGCACTTTGGGAGGCCAAAGCAGGCAGATCTGAGGTCAGGAGTTTGAGAC"
"GL873585","9319890","9319971","chr8","79499361","79499447","14","70179471","GGCCAGGTGTGGTGGCTCACACCTGTCATCCTAGCACTCTGGGAGGACGAGGTGGGTGGACCGCCTGAGTCAGAGTGAGACC","GGCCAGGTGTGGTGGCTCACACCTGTAATCCCAACACTTTGGGAGGCCCAGGTGGGTGGATCACCTGAGGTCAGGAGTTCAAGACCA"
"GL873586","895572","895692","chr17","14501559","14501680","38","13605987","GGCCAGGTGAGGTTTCTCATTCTGGGAGTGAGCCAGCAATTGGGAGGCCAAAGTAAATGGATTGCCTGAGGTTATAGGTTCCAGAACAGCCAGAACAAGATCGAAATCCTGTCTCCAAAAA","GGCCAGGCGTGGTGGCTCATGCGTGTAATCTCAGCACTTTGGAAGGCCGAGGCAGGTGGATCACCCGAGGTCAAGAGTTCAAGACCAGCCTGACCAACATGGCGAGTCTCTGTCTCCACTAA"
"GL873586","5645995","5646150","chr6","58863249","58863409","38","53217254","GGGTATGGTGGCTCATGCCTGTAATCCAAGCACTCTGGGATGGTGAGGCAGGAGAATCCCTTGAACCCAAGAGTCCGAGGTTGCTGCGAGCTAAGCTGATGGCATAACACTCTAGCCTAGGCGACAGAGTGAGACTCTGTTTCCAAAGAGAAAAAA","TTAGCCAGGCATGGTGGCACATGCCAGTAATCCCAGCTACTCAGGAGGATGAGGCAGGAGAATCGCTTGAACCCAGGAGGCAGAGGTTGCAGTGAGCTGAGATTGCGCCACAGCACTCTACCCTGGGTGACAGAAGGAGACTCTGTCTCAAAAAAAAAAAA"
"GL873586","10258686","10258969","chr12","9481260","9481565","81","777426","GGCCGGGCATGGTGGCAGAAATCTAGGAGGCCGAGGCAGGTGGATCGCCTGAGATCACAAGTTCAAGACCAGCCTCAGCTACAGCAAGACCCCATCTCTAAAAATAGCCGGCTGTTGTGGCAGGCGCCTGTAACCCCAGCTACTCGGGAGGCTAAGGCAAGAGAATCGCTTGAGCCCATGAGTCTGAGGTTGCTGCGAGCTGTGACTCCACGGCACTCTACCCGGGGCGATAAAATGAGATTCTGTGTCAAAACAAACAAACAAACAAACAACAACAAAAACAA","GCTGGGCGCGGTGGCTCATGCCTGTAATCCCAGCACTTTGGGAGGCCAAGGCAGGTGGATCACCTGAGGTCAGGAGTTCGAGACCAGCCTAGTCCACATGGTGAAACCCCATCTCTACTAAAAACTAGCCAGGCGTGGTGGTGCGCACCTGTAATCCCAGCTACTCGAGAGGCTGAGGCAGGAGAATCACTTGAGCCTAGGAAGCAGAGGTTGTGGTGAGCTGAGATCACACCACTGCACTCCAGTCTGGGCGACACAGTGAGACTCTTGTCTCAAAAACAAAAAACAAACAAACAAACAAACAAA"
"GL873587","3208032","3208047","chr8","3626746","3626762","2","418714","AAACAACCACAAAAAA","ACAACAACAACAAAAAA"
"GL873587","3208141","3208321","chr19","2057131","2057316","59","1151010","TTTCTTTTAAAAATCACCCATGGGCTGGGTATAGTGGCTCACACCTATAATCCTCGGGAGGCCAAGGTTGGAGGATTGCTTGAATCCAGGAGTTGAAGGTTACAGTGAACTGGGATTTAGCCACTAGACTCTAGCATAGCTGACAAAGCAAGAACCTATTTGTTTAAAACACAAAAAAGAA","TACTAATAATACAAAAATGAGCCGGGTATGGTGGCGGGTGCCTGTAATCCCAGCTACTGAGGAGGCTGAGGCAGGAGACTTGCTTGAACCCAGGAGGTAAAGGTTGCAGTGAGCTGAGATTGCACCACTACACTCCAGCCTGGGCGACAAGAGCAAAACTTTTTCTCCAAAAAAAAAAAAAAAAAA"
"GL873587","3278260","3278367","chr19","19044200","19044312","39","15765940","CAGTCTGAGCAAGAGGGAGAGGCTATTTCTACTAAAAACAGAAAAACTAGCTGGGTGTTGGGGTGTGTTCCTAGTCTCAGTTACTTGGGAGGCTGAAGTAAGAGGATC","ACCAGCCTGGCCAACACGGTGAAATCCCGTCTCTACTAAAAATACAAAAATTACCTAGGCGTGATGGCACGTGCCTGTAGTCCCAGCTACTCATAAGGCAGAGGTGAGAGAAT"
"GL873587","3278673","3278754","chr7","49412503","49412597","28","46133830","GGCCACGAGAGCTAGCTCATGCCTATTCTAGGAGGCCAAAGCAGGCAGACTGCCTGAGCTCAGGAGTTCAAGAGCAGCCTGG","GGCCAGGTGCAGTGGCTCATGCCTGTAATCCGAGCACTTTGAGAGGCCGAGGCAGGCAGATCACCTGAGGTCAGGAGTTCAAGACCAGCCTAGTA"
"GL873587","3782076","3782188","chr9","112128434","112128552","34","108346358","ACTGGGGTGGCTGAGGCAGGAGCGTCACTTGAACTCAGGAGTTTGAGATTGCTGTGAGCTGAGCAGATGTCATGGCACGCTAGCCTAGGTAATAGAGTGAGACTTCGTCTAAA","CAGCTACTCGGGAGGCTGAGGCAGGAGAATCACTTGAACTCGGGAGGCGGAGGTTGCAGTGAGCCGAGATCACGCCATTGCACTCCAGCCTGGGCAACAAGAGCGAAATTCCATCTCAA"
"GL873587","4564996","4565084","chr20","27900350","27900437","14","23335354","GGCGGGGTGTAGTGGCTCATGCCTATTGTCCCAGCACTGTGGGAGGCCGAGGTGGGTGGATCACCTGTGCTCAGAAGTTTGAGACCAGC","GGCCGGGCGTGGTGGCTCATGTCTGTAATCCCAGCACTTTGGGAGGCCGAGGTGGGTGGATCACCTGAGGTCAGGAGTTCAAGACCAG"
"GL873587","6307870","6308175","chr12","112427710","112428020","54","106119840","GGCCAGATATGATGGCTCATGCTTGTAATCCTAGCACTCTGGGAGGCTGAAGTGGGAGGATCACCTGAGATCAGGAGTTCAAGATCACCCTGAGCAAAAGTGAGATCCCATCTCTATTAAAAATAAAAAAATTATCCAGGCATGGTGGTGCAGTCCTTTAGTCCCAGCTACTTGGGAGGCTGAGGCAGGAGAATCTCTTGAACCCAGGAATTAGAGGTTACAGTGAGCTGTGATGATGCTACTGCACTCTAGCAGGATGACAGAGTGAGATACTCCGTGTCAAAAAAAAAAAAAAAAAAAGCAAAA","GGCTGGACATGGTGGTTCATGCTTGTAATCCGAGCACTTTGGGAGGCCAAGGCGGGTGGATCACCTGAGGTTGGGAGTTCGAGACCAGCCTGACCAACATGATGAAACCCCATCTCTACTAAAAATACAAAAAAATTAGCCAGGCATGGTGATGCACGCCTGTAATCCCAGCTACTTGGGAGGCTGAGGCAGGAGAATCACTTGAACCCAGGAGGCAGAGGTTACAGTGAGCCGAGATCATGCCATTGCACTCCAGCCTGGATGACAGAGTGAGCCTCTGTCTCAAAAAAAAAAAAAAAAAAAAAAAAAAA"
"GL873587","6484004","6484128","chr10","67341428","67341546","29","60857424","GACCAGGTTCTGTGGCTCATGCTTGTAATCCTAGCACTCTAGGAGGCCGGAAGAGGGTGGATTGATTGCCTGAGGTCAGGAGTTAGAGACCAGCCTGAGCAAGAGCTAGACCCTGTTTCTTTCTT","GGCTGGGTGTAGTGGCTCATGCCTGTAATCCCAGCACTTTAGGAGGCCAAGGTGGATGGATTGCCTGAGCTCAGGAGTTCGAGACCACCCTGGGCAACAAGCCAAAACCCTGTCTCTAC"
"GL873587","6484407","6484586","chr3","167196537","167196723","48","160712130","TAGACCCTGTTTCTAAAAAAAAAATAGCCAGGTGTTGAGGCAGGTACCTGTAGTCCCAGCTACCTGGGAGGGCTGAGGCAAGAGAATCGCTTGAACCCAAGAGTTTGAGGTTGCTGTGAGCTGAGATGCTATGGCACTCAACCGTGAGCTACAAAGTGAGACTCTGTCTCAAAAAAAAAA","AAAACCTGTCTCTGCTAAAAATACAAAAATTAGCCGGGTGTGGTGATGTGCGCCTGTAGTCCTAGCTACTTGGGAGGCTGAGGCAGGAGAATCACTTGAATCCAGGAGGTGGAGGTTGTAGTGAGTCGAGATCGTGCGACTGCACTCCAGCCTGGGTGACAGCGAGACTCTGTCTCAAAAAAAAAAA"
"GL873587","7466229","7466364","chr1","29437872","29437991","35","21971643","GGCCAGGCGTGGTGGCTCATGCCTGTAGTCCCAGCGCTATGGGAGGCCGAGGTGGGTGGATCACCTGTGCTCAGAGGTTCGAGACCAGCCAAGACCCCCCTGAGCCAAATGAGCCAGAGTGAGATCCCATCTCTAC","GGCCGGGCGTGGTGGCTCACGCCTGTAATCCCAACATTTTGGGAGGCCAAGGCGGGTGGATCACCTGAGGTCAGAAGTTCGAGACCAACCTGGCCAACATGGTGAAACCCCTGTCTCTAC"
"GL873588","1502535","1502718","chr1","34852429","34852590","60","33349894","GGTGCAGTGGCTCACACCTGTTGTCCCAGCGCTGTGGGAGGCCGAGGTGGGTGGATCACCTGTGCTCAGAGGTCGAGACCAGCTGAAGACCTGCCTGAGGCAGAGTGAGCCAGAGTGAGACCCCGTCTCTACTAGAACAACAACAAGACAGCCAGACCTTGTGATCCCAGCTACATGGGGGGCT","GCCAGGTGCAGTGGCTCACACCTGTAATCCCAGCACTTTGGGAGGCCGAGGCGGGCGGATCACCTGAGGTCAGGAGTTTGAGACCAGCTTGACCAACATGGAGAAACCCCGTCTCTACTAAAAATACAAAATTAGCCTGGTGTGGTGTCGCATGCCTGTAAT"
"GL873588","10189037","10189246","chr3","45604681","45604903","65","35415644","GCTGAGATGAGGAGACTCTGTCTCTATTAAAAATAGAAAAATTGGGTGGATGTTGTGGGTACTGTAGTTGCAGCCTCTTGGGGGGCTAAGGCAGGAGGATCAGTTGAAGCCAGGAATTTGCTTTGAGCTAGGCTAAAGCCATGGCACTCTAGCCTGGGCAACAGAGTGAGGCTAGATCTCAAAAAAAGAAAGAAAAGAAAAAGAAAAAAA","CTGGCCAACATGGCAAAACCCCATCTCTACTAAATATACAAAAATTAGCTGGACGTGGTGGCACATACCTGTAATCCCAGCTACTTGGAAGGCTGAGGCAGGAGAATAGCTTGAACCTGGGAGGCAGAGGTTGCAATGAGCTGAGATCACGCCACTGCACTCTAGCCTGGGCAATAGAATGAGACTCTGTCTCAAAAAAAAAAAAAAAAAAAAAGACAAGAAA"
"GL873589","104719","104807","chr20","27900350","27900437","13","27795631","GGCTGGGCGTGGTGGCTCATGCCTGTTGTCCCAGCGCTGTGGGAGGCTGAGGTGGGTGGATCACCTGTGCTCAGAGGTTCGAGACCAGC","GGCCGGGCGTGGTGGCTCATGTCTGTAATCCCAGCACTTTGGGAGGCCGAGGTGGGTGGATCACCTGAGGTCAGGAGTTCAAGACCAG"
"GL873589","796766","796905","chr1","166346372","166346487","49","165549606","GGCTAAGTGTGGTGGCTCACACCTGTCATCTAGTACTTTGGGAGGGTGGGCCTGGGAGTTCAAAGACTGAACTCAGGAGTTCAAGGTGGCTCCGGGGAGGAATTCAAGACCAACCTGAGCCAGAGCGAGACCTCGACTCT","GGCCAGTGGGGTGGCTCACGCCTGTAATCCCAGCACTTTGGGAGGCTGAGGTGGTCAAATGACCTGAGGTCAGGAGTTTGAGACCAACCTGGCCAACATGGTGACACCTCGTCTCT"
"GL873589","1023679","1023690","chr1","205890061","205890072","1","204866382","AAAAAAAAAAAA","ACAAAAAAAAAA"
"GL873589","1023771","1024047","chr4","103012712","103012993","70","101988941","GGCTTGGTGGCTCACACCTGTAATCCTAGCACTCTGGGAGGCCGAAGTGGCTGGAATACTTGAGGTCAGGAGTTCAAGACCAGCCTAAGTGAGAGTGAGATCCCCATCTCTAATAAAAATAGAAAAATTAGCAGGGTGTTGTGGCTGGCACTTGTAGTCCCAGCTACCCAGGAGACCGAGGCAGAAGTTTGAGATTATTGTGAGCGAGGCTGATGCCACAGCATTCTAGTGGGACAACAGAGCAAAATTCTATCTCAAAAGAAAAAAAAAAAAAGGA","CGGGCGTGATGGCTCACGCCTGTAATCCCAACACTTTGGGAAGCCGAGGCGGACGTATCACCTGAGGTCAGGAGTTCAAGACCAGCCTGGCCAACATGGTGAAACCCCGTCTCTACTAAAAATACAAAAATTAGCTGGGTGTGGTGGCATGCGCCTGTAATCCCAGCTACCCAGGAGGCTGAGGCAGGAGAATCGCTGAGGCTGCAGTGAACTGAAATTGTGCCACTGCACTCCAGCCTGGGTGACAGAGCAAGACTCTGTCTCAAAAAAAAAAAAAAAAAA"
"GL873589","4820958","4821024","chr8","33633747","33633811","15","28812789","TTAGTCAAGTGCAGTGGCTCACACCTGTCATCCCAGCTACTTGGGAGGCTGAGGCAGGAGAGTTGCT","TTAGCCAGGTGTGGTGGTGCATGCCTCTAATCCCAGCTACTCAGGAGGCTGAGGCAGGAGAATTG"
"GL873589","6763768","6763857","chrX","25814002","25814092","29","19050234","GGTGTGGTGGCTCACACTTGTATCTTAGCATTTTAGGAGGCTGAATGGGGAGAATTGCTTTAAGTCAGGAGTCTGACTTCCACCTTGCCA","GGCTGGGAATGGTGGCTCACACCTGTAATCCCAGCACTTTGGGAGGCTGAGGTGGGCAGATCACCTGAGGTCAGGAGTTTGAGATCAGCCT"
"GL873589","8444551","8444632","chr9","93194085","93194171","17","84749534","CGGGCATGGTGGCTCACAACTATAATCTTAGCACTTTGGGAGGCTGAGACAGGTGGATGCCTGAACTCAAGAGTTTGAAACC","GGCCGAGCATGGTGGCTCACACCTGTAATCCCAGCACTTTGGGAGGCTGAGGCAGGTGGATTACCTGAGGTCAAGAGTTCAAGACCA"
"GL873589","9085365","9085494","chr2","194063347","194063481","42","184977982","GGCCAGGCACAGTGGCTCACACCTATAATCCCAGCACTCTGTGAGACTGAGGCAGGTGAACTGTTGCAAGAGTGAGACCCTGTGCTTGGTGCCTGTAGCTCAGTGGTTAATAATAAGAAAAAAGAAAAAA","GGCCAGGTGCAGTGGCTCACACCTGTAATCCCAGCACTTTGGGAGTCTGAACCAGGCAGATCACCTGAGGTCAGGAGTTCGAGGCCAGCTCGGCCACCATGGTGAAACCCTGTTTCTAATAAGAATACAAAAAAA"
"GL873589","9085767","9086002","chr7","84631446","84631650","75","75545679","GAGTGAAACCCTGTCTCTACTAAAAATAGAAAAACTAGCTGTGCATCAGGGCGCATAACTGTAGTCCCAGGTACTCAGGACACTGAGGCAAGAGAATTGCTCAAGCCCAAGAGTTTGCAAGAATTTGAGGTTGCTATGAGCTATGATGCCATGGCACTCTACCTAGGGTGACAGACAGAGACTCTGTCCCAAAAAAAAAAAAAGAAGAAGAAGAAAAAAAAAAAGAAAGAAAGAAA","ATAGTGAAACCTCGTCTCTACTAAAAATACAAAAATTAGCTGGGCATCATGGTGCACGCTTGTAATTCCAGCTACTTGGGAGGCTGAGGCAGGAGAATTGCTTGAACTCAGGAGGTGGAGGTTGCAATGAGCCAAGATCGCGCCACTGCACACCAGCCTGGGTGACAAAAGACTCTGTCTCAAAAAAAAAAAAAAAAAAAAAAAA"
"GL873589","9992904","9993045","chr16","56427538","56427666","46","46434634","AACCAGCCAGGCATGGTGATTCACACCTATAATCCCAGCTACTTAGGAGTATGGCTTGAGCACACAGGATACCATACCATTCTAGTCATCCCAGGCAACAGAGGGAAACTCTGTTGGTTAAAAAAAAAGAAAAACTTAAAAA","TTAGCCAGGAGTGGTGGTGCACGCCTATAATCCCAGCTACTTGGGAGGCTGAGGCACAAGAATCACTTGAACCATTGCACTCCAGCCAGGGTGATAGAGGGAGACTCTATCCAAAAAAAAAACAAAAAA"
"GL873589","9993319","9993452","chr3","2774534","2774668","28","7218785","GGCCTGAGCCCTGTGACTCATGCCTGTAATCCCAGCACTGGAAGTTCCAAGGCAGGTGGATCGCTTGAGCTCTGGAGTTCAAGACCAGCTCAACCAAGAGTAAGACCCCATCTCTACTAAAAATAGAAAAACCA","GGCTGGGCACGGTGGCTCATGCCTGTAATCCCAGCACTTTGAGAGGCCGAGGCAGGTGGATCTCCTGAGGTCAGGAGTTCAAGACCAGCCTGGGCAACATGGTGAAACCCCATCTCTACTAAAAATACAAAAAAT"
"GL873590","9044589","9044884","chr1","83754525","83754835","84","74709936","GGCCAGGTGCAATGGCTCATGCCTATAATCCTCACACTCTGGGAGGCTGAGGCAGGAGGATCACTTTTCTCAGGGTCAGGGCCAGCCTGACAAAAGTCAGACCCTGTTTCTACTAAAAATAGAAAAACTAGCTGGGTGTTGTGGCAGATGCCTATAGTCCCAGCTACTAAGAGACTGAGACAAGTGCCCAGAGTCTGAGGTTACTGTGAGCAAAGCTGATGCCATAGCATTCTAGCTATAGATCGAGAGTCTGTCTCAAAAACAAACAAACAAACAAACAAACAAACAAAAAAGAA","GGCTGGGTGTGGTGGCTCATGCCTGTAATCCCAGCACTTTGGGAGGCCGAGGCGGGTGGATCATCTGAGGTCAGGAGTTCAAGACCAGCCTGACCAACATGGTGTAACCCTGTCTCAACTAAAAATACAAAAATTAGCTGGGCGTGGTGGTGTGCACCTATAGTCACAGCTACTTGGGAGGCTGAGACAGGAGAATTGCTTCAACCCAGGAAGTGGAGGTTGCAGTGAGCCAAGATCATGTCACTGCACTGCAGCCTGACAGAGCGAGACTCCATCTAAAACAAACAAACAAAAACAAACAAACAAACAAA"
"GL873591","1831505","1831587","chr17","61702818","61702899","25","59871313","CCCAGCACTTTGGGAGGGCAAGATGGGAGAATCATATAAAGTCAGGAGTTTGAGACCAGTTTGGCAGACATGATGAACCCATC","AATCCCAGCACTTTGGGAGGCTGAGGCAGGCGGATCATCTGAGGTCAGGAGTTCAAGACCAGCCTGGCCAACATGGTGAAAC"
"GL873591","2719175","2719275","chr4","86137755","86137847","32","83418580","GTGGGGGCTTAGGCCTGTAATCCCAGCACTCTGAGAGGCCAAGGTGAGCTGGTCACCTGGGTTTAGGAGTTTGGAGACTTGCTCGAGCTAGACTGAGGCTC","GTGGTGGCTCACGCCTGTAACCCTAACAATTTGGGAGGCCAAGGCAGGTGGATCACTTGAGGTCAGAAGTTTGAGACCAGCCTGGACAATATG"
"GL873591","4732974","4733120","chr19","7991801","7991954","55","3258827","ATACGCAGACTGGCCGAGCGTGGTGTCACATGCCTATAATCCCAGTGGCTACTCTGGGGAGGAGAATCTCTTGAAACCAAGAGTTAGAGATTGCAGTGGGGTATGATACAGGGTAACAAAGAGAGACCTTGGATCTGAAAAGAAAAA","AAAATACAGAAACTAGCTGGGCATGGTGATGCACACCTGTAATCCTAGCTACTGGGGAGGCTGAGGCAGGAGAATTGCTTGAACCCAGGAGTCAGAGGTTGCAGTGAGCAACCAGCCTGGGTGATACAGTGAGTGAGACTCTGTCTCGAAAAAA"
"GL873591","6822728","6823009","chr1","20579766","20580052","72","13757038","GGCCAGGCGTGGTGGCTCATGCCTGTAAATCTCAGCACTCTGGGAAGCTGAGGCAGGTGGATTGCTTGAGGTCAGGAGTTTGAGACCAGCCTGTACCAGAGTAAGACCCTGTCTCTAATAAAAATAGAAAAAAAAAAAAAAACTAGTTGGGCATGGTGATGGGTGCCTGTAGTCCCACCTACTTGGGAGGCTGAGGCAATGGCATCTCTTGAGCCCAAGAGTTTGAGGTTGCTGTGCCATGGCACTCTCCCCAGGGTAACAGAGTGAAAATAAAAAAAAGAA","GGCCAGGCGTGGTGACTCATGCCTGTAATCTCAGCACTTTGGGAGGCCGAGGCAGGTGAATCACCTGAGGTCAGGAGTTTGAGACCAGCCTGACCAACATGGTGAAACCTCGTCTCTACTAAAAATACAAAAAGTAGCCAGGCATGGTGGCGCATGCCTGTAATCCCAGCTACTTGGGAGGCTGAGGCAGGAGAATCGCTTGAACCCGAGAGGCAGAGGTTGCATTGAGTCAAGATGGTACCACTGCACTCCAGCCTGGGTGACAGATTGAGACTCAAAAAAAAAAA"
"GL873591","7578706","7578813","chr16","45055441","45055543","42","37476735","AAATTTAGCTACACATAGTGGCATGAGTCTGTAATGCTAGCCACCCAAAAGGCTGTAGTAAGAGGATTGCTCTATCCCAGGAGTTAAAGACCAGCCCGGACATCAGAG","AATTAGCCGGGCGTGGTGACACACACTTGTAATCCTAGATACTCAGGAGGCGAAGGTAGGAGAATTGCTTGAACCCAGGCAGCAGAGGTTGCAACGAGCAGAG"
"GL873591","9282916","9283004","chr1","20744253","20744338","16","11461337","GGCCAGGCGCGGTGGCTCACCCCTGTTGTCCCAGTTCTGTGGGAGGCCGAGGTGGGTGGATCACCTGTGCTCAGAGGTTTGAGACCAGC","GGCCAGGCACGGTGGCCACGCCTGTAATCCCAGCACTTTGGGAGGCCGAAGTGGGTGGATTACCTGAGGTCAAGAGTTTGAGACCA"
"GL873592","835155","835315","chr16","75654291","75654451","43","74819136","CTGGGTGTGGTGGCTCTTGTCTGCAATCTCAGTACACTGGGAGGCTGAGGCAGAAGGATTGCTCCAGCTCAGGAGTTTGAGGCCAGGCTGAGCTAGTGCAAAACCCCATCTCTACTAAAAAAAGAAGGAAAAAAAAAAGAAAAAGAAAAAAAATACGAGCT","CCAGGTGTGGTGACTCACGCCTGCAATCCCAGCACTCTGGGAGGCTGAGGTGGGTAGATTACCGGAGGTTAGGCGTTTGAGACCAGCCTGGCCAACATGGTGAAACCCCATCGCTACTAAAAAAAAAAAAAAAAAAAAAAAAAAAAAAAAAAAAAAAATTA"
"GL873592","835589","835765","chr1","66836166","66836336","48","66000577","ACAAAAAACCTAGCTTAGGGTTGTTATAGCACCTGTAGTCCCAGCTACTCAGGCGCTAAGGCAGGAAAATCTGCCTGAGCTCAGGAGTTTGAGGTTGCAGTAAGTTATGATGATGCTACTGCACTCTAGCTGGGGCAACAGAGTGAGACTCTGTCTGAGGAAAAACCAAAACCAAAA","TAGCCCAGCACGGTGGCTCACACCTGTAGTCTCAGCTACTCAAGAGGCTGAGGCATGAGAATCGCTTGAACCCAGGAGGTAGAGGTTGCAGTGAGCTGAGATCATGCCACTGCGCTCCAGCCTGGGCAACAGAGTGAGACTCAGTCTCAAAAAACAAAACAAAACAAAAAA"
"GL873592","2520661","2520705","chr16","66853217","66853257","11","64332556","TCTGGGAGGCTGAGGCGGGTGGATCACCTGAGCAAGAGTGAGACC","TTTGGGAGGCTGAGGCAGGTGGATCACTTGAGGTCAGGAGT"
"GL873592","4535248","4535388","chr1","12240468","12240612","38","7705220","GGCGGGATGTGGTGGTTCATGGCTGTAATCCCAGCACTCAGGGAGGCTGAGTCGGGTGGATTGCTTGAGTTCAGGAGTTTGAGACCAACCTGAGCAAGAACTAAGCCTGTCTCTACTAAAGATATTATTTCTTATTTTTCT","GGCCGGGCGCGGTGGCTCATGCCTGTAATCCCAGCACTTTGGGAGGCTGAGGCGGGTGGATCACCTGCGGTCAGGAGTTCGAGACCAGCCTGGCCAACGTGGTGAAACCTCATCTCTACTAAAAATATAAAAATTAGCTGGTGTG"
"GL873592","4535654","4535831","chr8","126054004","126054184","54","121518350","TCTACTACAAATATTAACAGAAAAATTAGCTGGGCATTGTGACAGGTGCCTATAGTCCCAGATACTCAGAAGGCTGAAGTAAGAGGATCACTTGAACCCCAGGAGCTAAGGTGGCTGTGAGCTAGGCTGAGGCTCTAGCCTGGGTAACAGAGTGAGACTGTAAAAAAAGAAAGAGAGA","GTCTCTACTAAAAATACAAAAATTAGCTGGGTGTGGTGGTGCATGCCTGTAATCCCAGCTACTCAGGAGGCTGAGGCAGGAGAATCGCTTGAACCCAGGAGGTAGAGGTTGCAGTGAGCCAAGATCATGCCACTGCACTCCAGCCTGGGTGACAGAGGGAGACTCTGTCTCAATAAATAAA"
"GL873592","6794968","6795049","chr3","154764711","154764794","20","147969743","GAAGGTTTGATGAGCTCAGATGATGCCACTGCAGTCTACCCAGAGTGAAGGAGCGAGACTCTGTCTCAAAAACAAAAAAAGA","CAGAGGTTGGCAGTGAGCTGAGACTGTGCCACTGCACTCCAGCCGGGTGACAGAGTGAGACTCTGTCTCAAATTACAAACAAAA"
"GL873592","6881384","6881478","chr5","24882384","24882475","28","18001000","GGGCAGGCATAGTGACTGGTGTCTCTAATCCTAGCAGTCTGGGATGCTGAGGCAAGTGGAATGTCAGAGTTCAGGAGTTGAAGATCACCCTGACT","GGCCGGGCGCAGTGGCTCACATCTATAATCCTAGCATTTTGGGAGGCTGAGGCAGGCGGATCACCTGAAGTCAGGAGTTTAAGACCAGCCTG"
"GL873592","6881755","6881937","chr10","61601371","61601572","66","54719616","TCACCCTGACCAAGAGCAAGACCCTGTCTCTACTAAAAATAGAATAAACTAGCTGGGAATTGTGGTGGGTGCCAGTAGTCCCCGCTACTGAGGCAGGAGGATCATTGAGTCCAAGAGTTTGAGGTTGCTGTAAGTTAGGACACCACAGCACTCTACACAGAGTAAGACTGCCTCAAAAATAAA","AGTAAAGAAAAGAAACCCTGTCTCTACTAAAAATACAAAAATTAGCTGGGTGTGGTGGTGCGCACCTGTAGTCCCAGCTACTTGGGAGGGTGAGGTATGGGAATCACTTGAACCCGGGAGGTGGAGGTTGCAGTGAGCCAAGATCACACCACTGCACTCCAGCCTGGGTGAGAGAGTGAGACTCTGTCTCAAGAAAAAAGAA"
"GL873592","7006080","7006155","chr1","8947061","8947129","24","1940981","CACACTGAGAGGCAAAGGCTGGTGGATCACCTGAGCTCAAGAGTTTGAGACCAGCCAAGCCAGAGATCTTGTCTCT","CACTTTGGAGCCAGGTAGGTGATCACCTGAGTCAGGAGTTCGAGACAGCCTGGCCAACATGTGAAACCC"
"GL873592","8446508","8446655","chr11","122502739","122502874","48","114056231","TTAGCTGGGTGTTGTGGCAGGCACCTGTAGTCCCTCCCAGCTACTTGAAAGGCTGAGGCAAGATGACAGCTTAAACCCAAGAGTTTAAGGTTACTCTATTCAGGGCAACAGAGTGAGACTCCATCTACATAAATAAATAAATAAATAA","GGCTGGGCGTGGTGGTTCACACCTGTAATCCCAACACTTTGGGAGGCTGAGGCCAGCGGATTGCCTGAGCCCAGGAGTTTGAGACCAACCTGGGCAACATGGTGAAACTCCATCTCTACTAAAATACAAAAAGTTA"
"GL873592","8446953","8447008","chr16","44513352","44513404","15","36066399","GACCAGCCTAAGCAAAAAAGAGATCCTATCTCTACTACTAAAAATAGAAAAAATTA","ACCAGCCTCACCAATATGAAGAAACCCCATCTCTACTAAAAATACAAAATATT"
"GL873592","8447239","8447325","chr1","8062863","8062957","21","384376","GGCCAGGAGCAGTGACTCATGCCTAGCACTCTGGGAGGCCAAAGCAGGTGGATCAACTGAGCTCAGGAGTTCAAGACCAGCCTAAGC","GGCCGGGTGCAGTGGCTCATGCCTGTAGTCCCAGGACTTTGGCAGGCCAAGGCCGGTGGATTACCTGAGGTCAGGAGTTCAAAACCAGCCTAGCC"
"GL873592","8723925","8724000","chr3","42066983","42067054","20","33343058","AATTAGCCGGGCATGGTAGTGTGTGCCCATAATCTCAGCTACTCAGAAAGCTAAGATAGGAAAATTGCTTGAGCTC","TTAGCTGGGTGTGGTAGTGCATGCCTATAATCCCAGCTACTCGGGAGGCTGAGGTGGGAGAACTGCTTGAAC"
"GL873593","384022","384146","chr15","102382935","102383070","28","101998913","GGCCACGAGGGCCCATGCCTGTAATCCTAGCACTCTGGGAGGCTGAGGTGAGTAGATTGCTGAGCTCAGGAGTTCAAGACCAGCCTGTGCAAGAGACCCCATCTCTGCTAAAAATAGAAAAACCA","GGCCAGGTGTGGTGGCTCACGCCTGTAATCCTAGCACTTTGGGAGGCTGAGGCGGGTGGATTGCCTGAACTCAGGAGGTCAAGACCAGCCTGGGCAACACAGTAAAACCCCATCTCTACTAAAATACAAAAAATCA"
"GL873593","384425","384607","chr20","28286874","28287058","50","27902449","GAAAGAAAAGAAAAGAAAAACTAGCAAGATGTTGTAGCTGATGCCTATAATCCTAGCTATTGGAGAGGTGGAGGCAAGAGAATTGCGTGAGCCCAAGAGTTGAAGGTTGCTGTGAGCTGCGATGCCAGAGCACTCCAGGGTGACAGAGTAAGACTCTGTCTCAAAAAAAATTACAAAATAAAA","TAATAAAAATAAAAAAATTAGCCAGGAGTCAAAGCACACGCCTATAACCCCAGCTACTTGGGAGGCTGAGGGAGGAGAATTACTTGAACCCGGGAGGTGAAAGTTGCAATGAGCTGAGATCAAGCCACTGCACTCCAGACTGGATGACAGAGTGAGACTCTGTTTCAAAAAAAAAAAAAAGACAA"
"GL873593","1408445","1408467","chr10","88070368","88070389","9","86661923","AATCTAGAGATGGGGAGAGGTTG","AAAGAGATGGAAGAGAAGAAGA"
"GL873593","4856365","4856484","chr7","56497314","56497433","31","51640949","GCAATCCCAGCTGATCGGGAGGCTGACCCAGAAGAATCCCTTGAACCCAAGAGTCTGAGGTTGCTATGGGTGGATTCTACAGCACTCTAGCCTGGGAGACAGAGTGAGACTCTGTCCCAA","ATCCCAGCTACTTGGGAGGCTGAGACAGAAGAATTGCTTGAACCCGGGAGGTGGAGGTTGCAGTGAGCCAAGATTGTACCACTGCACTCCAGCCTGGCAACAGAGTGAGACTCTGTCTCA"
"GL873593","6661298","6661485","chr10","86749316","86749514","55","80088018","GCAGAGGCTCACATATGTAATCCTAGCACTCTGGGAGGATAAGGCAGGTGGACAGCTTGAGCTCAGGGGTTTGACCAGTCTGATCAAGAGCAAGACCTGTGTCTACTAAAAATAGAAAACCTAGCCAGGTATGATGGTAGATGCCTGTATTCCTAGCTACTCTGGAAGCTAAAGCTAAAGAGTTTGAA","GGTGGCTCACACCTGTAATCTTAGCAATTTGGGAGGCCGAGGTGGGTGGATCACTTGAGGTCAGGAGTTTGAGACCAGACTGGCCAACATGGTGAAACTCTGTCTCTACTAAAAATACAAAAATTAGCCAGTCATGGTGGTGCATGCCTGTAATCCCAGCTACTCAGGAAGCTTAGGCAGGAGAATCACTTGAACCCAG"
"GL873593","6710263","6710446","chr14","4390080","4390244","66","2320183","TTGAAGTCAGGAGTTTAAGGCCAGTCTGGGCAACATAGTGAGACCCCCATCTCTACGAAAATATTTTTTAAAAATTAAAAATAGCTGGGCATAGTGAGGCTGTTGTGAGCTATAACTGCACCACTGCACTCAGCCAAGGACAGAGACCCTGTTCCCTGCCTCAAACAAACCAAAACAAAACAAA","AAGTCTAGAGTTTACAGCCTGGACAACGCAGTGAAACCCTGTCTCTACCAAAAATACAAAAATTAGACAGGTGTGAGAGGCGGAGGTTGCAATGAGCTGAGATCGCAGCACTGCAGTCCAGCCTGGATGACAGAGCGAGACCCCATCTCAAAAACAAAAACAAAA"
"GL873593","7159645","7159716","chr6","178318394","178318465","21","171158749","GATCATGTCACTGCTCTCCAACCTGGGCAATTGAGCAGGAATCTGTCTCAAAAAGAAAAAAAAAAAAGAAAA","CGAGTTCACACCACTGCACCCCAGCCTGGGCAACAGAATGAGACTCGGTTTCAAAAAAAAAAAAAAAAAAAA"
"GL873593","7159841","7160050","chr13","33368171","33368368","69","26208330","GGCCAGGCGTGGTGGCTCACACCTGTTGTCCCAGTGCTGTGGGAAGCCGAGGCAGGTGGATCACCTGAGCTCAGCCGAGTTCGAGACCAGTGGAAGACCAGCATGAGGCAGAGTGAGCCAGAGTGAGACCCCATCTCTACAACAACAACAAGAAGAAAAAAAACAGCCGGACCTTGTGATCCCAGCTACGTGGGGAGCTAGAGAATCACT","GGCTAGGCATGGTGGCTCATGCCAGTAATCCCACCACTTTGGGAGGCCGAGGCAGGTGGATCACCTGAGGTCAGGAGTTCAAGACCAGGCTGGCCAACATGTTATGATGAGACCCTCATCTCTACTACAAATACAAAAATCAGCTGGGCATGGTGGCAAGTGCCTGTAATCCCAGCTACTTGGGAGGCTGAGGCAGAA"
"GL873593","8598292","8598391","chr11","118461023","118461129","33","109862731","AGCCAGGTGAGGTGGTTCACACCTGTAACCCTAGCTGCTTGGGAGGCTGAGGCCTCTCTATCCTGGGCAGTGTGGAGAAACTTTGTTTCAAAAAAAAGAA","GCCGGGCGCGGTGGCTCACGTCTGTAATCCCAGCGCTTTGGGAAGCCGAGGCGGGACTATCCTGGCCAACATGGTGAAACCCCGTCTCTACTAAAAATACAAGAATC"
"GL873594","357249","357377","chr2","75702890","75703011","36","75345641","CCTGGTACCGTAGGTCATGCCTGTAATCCTAGCACTTTGGGATGCTGAGGTGGGCAGATTGCCTGAGCTCACGAGTTCAAGCCATTAGAACTGAGCCTGACCTAGAGTGGGACCTCCAACTCTTTTTTT","GCCAGGCACAGTGGCTCATGCCTGTAATCCCAGCAGTTTGGGAGGCTGAGGTGGGCAGATCACTTGAGGTCAGGAGTTCAAGACCAGCCTGGCTGACATGGTGAAACCCCATCTATACCAAA"
"GL873594","357656","357834","chr7","17608776","17608965","55","17251120","GGGACCTCCAACTCTTAAAATAGCTGGGCATTGTGGTGGGCACCTACAGTCACAGCTACTTGGGAGGCTAAGGCAAGAGACTTGTTTGCAGCCAAGAGTTAGAGGTTGCTGTGAGCTATGAGGCTAGGGCACTCTACAGGGGGCGACAAGTGAGACTGTAAAAAAAAAAAAAGAAAAAA","GTCCCTACTAAAAATACAAAAAATTAGCTGGGCCTGGTGGCAGGCACCTGTAATCCCAGCTACTTGGGAAGCTGAGGCAAGAGAATTGCTTGAACCCAGGAGGCAGAGGTTGCAGTGAGCTGACATCAAGCCACTGTACTCCAGCCTAGGCAACAAGAGCAAGACTCTGTCTCAAAAAAAAAAAAAAAAA"
"GL873594","1410711","1410996","chr5","151340503","151340797","76","149929792","CACAGTGGCTCATACCTATAATCCTAACACTCTGGGAGGCCAAGGTGGGTGGACTGTCTGAGTTTGGGACCAGCCTGAGCAAAAGCAAGACTCCCATCTCTACTAAAAACAAAGACAGCCAGGTATGAGGGCAGGTGCCTATCATCCCAGCTACTTGGGAGGCTGAGGAAGGAGGATCACCTAAGCCCAGGACTTTAAGGTTTCTGTGAACTAAGATGATGTTACAACACTCTAGCCAGGGTAACAAGGCAAGATTCTGTTTCAAAAGACAAAAAAAAAAAAAAAA","GGTGGTTCATGCCTGTAATCCCAGCACTTTGGGAGGCTGAGGCAGGTGGATCACCTGAGGTCAGGAGTTCGGGACCAGCCTGGCCAACATGGGGAAACCCCATCTCTACTAAAATACAAAAATTAGCCAGGTATGGTGGCACATGCCTATAATCCCAGCTACTTGGGAGGCTGAGGCAGGAGAATCACTTGAACCCAGGAGGCTAAGGTTGCAGTGAGCCGAGATTGTGCCACTGTACTCCAGCCTGGGTGACAGACTGAAACTCTGTGTCCAAAAAACAAAACAAAACAAAAAA"
"GL873594","5528090","5528162","chr2","69013639","69013718","24","63485549","GGTACAGTGGCTCACGCTTGTGATCCCAGGTTGAGGTGGGTGGATCGCCTGAGCTCAGGAGTTGGATGCCAGC","GGTGTGGTGCCTCACGCCTATAATCCCAGCACTTTGGGAGGCAGGTGGATCACTTGAGGTCAGGAGTTTGAGAACAGCCT"
"GL873594","5834047","5834168","chr2","82491537","82491662","28","76657490","GGCTGGGCCCAGTAGCTCACGACTGTAATCCCAGCACTCTGGGAAGCTGAGGTGGGCGGATCACCTGAGCTCATAGGTTCGAGACCAGCTCCAGTTAGAGTGAGAGCCTGTCTCTAAAAATA","GGCTGGGCACAGTGGCTCATGCCTGCAATCCCAGCACTTTGGGAGGCTGAGGTGGGCAGATCACCTGAAGTCAGGAGTTCAAGACCAGCCTGGCCAACACAGTGAAACCCCATCTCTACTAAAAAT"
"GL873594","5834396","5834461","chr13","14688151","14688212","20","8853755","TATATAATAATAATAACCAGGTATTGTGGCAGGTGCCTCTAGTCCCAGCTACTCGGGAGGCAAAGG","ATAAAAAAATTAGCTGGCCATGGTGGCACATACCAATAATCCCAGCTACTCAGGAGGCTGAG"
"GL873594","7786130","7786294","chr14","12217087","12217250","37","4430957","GGGTGTGCTGGCTCATACCTATAATCCTAGCACTCTGGGAGGCTGAGGTAGGTGTATTGCTTGAACCCAGGAGTCTGAGGTTGCTGTGCGCTAAGCTGATACCATAGCACTCTAGCCTGGGCAACAGAGTGAGACTCTGTCTCAAAACAAATAAATAGTAAAAAA","GCTGGGCGTGGTGGCTCACACCTGTAATCCCAGCACTTTGGGAGGCCAAGGCATGAGAATTGCTTGAAAACAGGAGGCGGAGGTTGCAGTAAGCTGAGACTGTGCCATTGCACTCCAGCCTGGGCAACAAGAGTGAAACTCTGTCTCAGAAAAAAAGAAAAAAA"
"GL873595","723579","723774","chr19","6045933","6046125","65","5322354","GCCTGAGCAGGAGAGAGACCCCATCTCTGCTGAAAGTGGAAAAGTTGGCTGAGTGTAGTGGCGGGCTGCTGCCCCAGTCACTCAGGAGGCTTAGGAAGGAGTATCGCTTGGGCCCAAGATTTGAGGTTGCTGTGAGCGCTACAAAGACATTAGGGTACTCTACACAGGGGAATAGAGTGAGACTGTCTCAAAAAAA","CAACATGGAGAAACCCCGTCTCTACTAAAAATACAAAATTAGGCAGCGTGGTGGTGGGTGCCTATAATCCCAGCTACTCAGGAGGCTGAGGCAGGAGAATCGCTTGACCGGGAGTGGAGGTTGCGGTGAGCTGAGATTGCACCATTGCACTCCAGCCTGGGCAACAAGAGTGAAACTCCGTCTCAAAAAGAAA"
"GL873595","724114","724204","chr20","18199749","18199840","22","17475635","GGCCATGCTTGGTGGTTCTCATCTGTAATCCTAGCACTCTGGAAGGTCTACAGGGGTGGATGGCTGGAGGTCAGGAGTTCAAGACTGGCCT","GGCCGGGCATGGTGGCTCACACCTGTAATCCCAGCACTTTGGGAGGCTGAGGCAGGCGGATCACCTGAGGTCAGGAGTTCGAGACCGGCCTG"
"GL873595","1065346","1065667","chr18","10529729","10530057","74","9464383","GGCCAGGTGCAGCAGCTCATGCCTGGAATCTTCCTGCTCTGTATGGCCAAGGCAGGTGGATCGCCTGACCTCAGGAGTTCCAGACCAGCCTGAACAAGAGCAAGACTCTGTCTCTACTAAAAGTAGAAAAAAAACTAGCCAGTCATAGTGGCAGGTGCCTGTAGTCCCAGCTGCTTGGGAGGCTGAGGCAAGAGGATCACTTGAACCTAAGAGTTTGAGGTTGCTGTGAGCTAAGATGCCACATCACTCTATCAAGGGTGACCAAGTGAGACTCTGTCTCAAAAATAAATAAATAAATAAATAAAAAGAAAGGCAAAAAGAA","GGCCCGGCGTGGTGGCTCATGCCTATAATCCCAGCCCTTTGGGAGGCCAAGGCAGGTGGATCACCTGAGGTCAGGCGTTCGAGACCAGCCTGACCAACGTGGTGAAACCTCATCTCTACTAAATACAAAAAAAATTTAGCCAGGCATGGAGGCACATGCCTGTAATCCCAGCTACTTGGGAGGCTGTGGCAGGAGAATCACTTGAACCTGGGAGGTGGAAGTTGCAGTGAGCTGAGATTGTACCACTGCACTCCAACCTGGGTGACAAAGCAAGACTCGGTCTCAATAAATAAATAAATAAATAAATAAATAAATAAAGTGAAAAAAAA"
"GL873595","1254878","1255146","chr4","42822326","42822607","67","41567448","GGCTGGGCATGGTGGCTCATGCCTGTAATCCTACCGCTCTGGGAGGCTGAGGCAGAGGATCACTTGAGCTCAGGAGTTTCAGACCAGCCTGCAAGAAGGACCCAGTCTCTGCCGAAAATAGAAAAGTTAGCAAGGCGTTGTCGTGAGCACATGTATCCCAGCTACCTAGAACTCTGAGGCAGGAGGATCCCTTGAACCCACAGAAGTTGCTGTTATCTAAACTGATGCCACTGGACTCTAGCCTGGGCAACAGAGTGAGACTGGTCTCA","GGCCGGGCACGGTGGCTCATGCCTGTAATCCTAGCATTTTGGGAGGCTGAGACAGGCAGATTGCCTGAGCTCAGGAGTTCAAGACCAGCCTGGGCTAGATTGTGAAACCCCATCTCTACTAAAATATAAAAATTAGCTGGGTGTGGTGGCACACGCCTGTAATCCCAGCTACCTGGGAGGCTGAGGCAGGAGAATCGCTTGAACCAGGAGACAGAGGTTGCAGTGAGCTGAGATCACGCCACTGCACTTTAGCCTGGGCAACAGAGTGATACTCTGTCTCAA"
"GL873595","3417105","3417297","chr12","115674238","115674427","44","112257133","GGCCGGGCGCTGTGCCTCACGCCTGTAATCCTAATACTCTGAGAGGCCGAGGCAGGTGGATTGCCTGAGCTCAGGTGCTCAAGACAGCCTGACTGAGCAAGCCCTGAGATCCCATCTCCACTAACAATAGTAAAACTAGCCGGGCATTGTGGTGGTGCTTGTAATCCCAGCTACTGGGAGGCTAAGACAGGAG","CCAGGCCTGGTGGCTCACGCCTGTAATCCCAGCACTTTGGGAGGCCGAGGTGGGTAGATCACCTGAGGTCAGGAGTTCAAGACCAGCCTGGCCAACATGGCGAAACCCCATCTCTACTAAAAATACAAAAATTAGCTGGGCATGGTGGTGTATGCCTGTAATCCCAGCTACTCGGGAGGCTGAGGCAGGA"
"GL873595","6098380","6098457","chr3","87492619","87492702","21","81394239","GCTGTGGCTCATGCTGATAATACCAGCACTCTGGGAGAACAAGGTAGGCAGATCACAAGAGGTCACCTGTGCAAGACC","GGGCTGGTGGTGGCTCATGCCTGTAATACCAGCACTTTGGGAGGCCAAGACAGGTGGATCACCAAAGGTCAAGAGTTCAAGACC"
"GL873596","134190","134307","chr1","203207333","203207443","31","203073143","GGCTGGGCGAGGTGGCTCACACCTGTAATCCTAGCACTCTGGAAGGCCCTAGCACTCAGGCAGTTGGATTGCCTGAGCTCACAAGTTCAAGACCAGCCTGAAAAAGAGCAAGACCTCA","GGCTGGGTGCAGTGGCTCACACCTGTAATCCCAGCACTTTGGGAGGCCGAGATGGGTGGATCACTTGAGGTCAAGAGTTGAAGACCAGCCTGGACAACATGATGAGACCCC"
"GL873596","134578","134681","chr11","50235285","50235387","37","50100707","CAAACAAAAGAGGAAGACCTCGTCTCTAAAAAAATAGCTGGGCATTGTGAGGAGTACCTGTAGTCCTAGCTACTCAGAAGGCTGAGACAAGAGAATCACTTAAA","CAACATTGTGAAACCCTGTCTCTACTAAAATAGAAAATTAGCCAGGTGTGTGGGCGTGCCTATAATCCTAGCTACTGGGGAGGGTGAGGCATGAGAATCGCCT"
"GL873596","8160215","8160350","chr1","29437872","29437991","30","21277657","GGCCGGGCGTGGTGGCGCACACCTGTAGTCCCAGCGCTATGGGAGGCCGAGGCGGGTGGATCACCTGAGCTCAGAGGTTCGAGACCAGCCAAGACCCCCCTGAGCCAAACGAGCCAGAGTGAGACCCCGTCTCTAC","GGCCGGGCGTGGTGGCTCACGCCTGTAATCCCAACATTTTGGGAGGCCAAGGCGGGTGGATCACCTGAGGTCAGAAGTTCGAGACCAACCTGGCCAACATGGTGAAACCCCTGTCTCTAC"
"GL873596","8421071","8421132","chr20","1874027","1874093","12","6547044","GTCAGGCGCAGTGGCTCACGCCTGTAATCTCAGCACTCTGAGAAGCCAAGGCAGGATCATCT","GGCCAGGCGCAGTGGCTCAGGCCTGTAATCCCAGCACTTTGGGAAGCCAAGGTGAGCAGATCACCTG"
"GL873598","4416400","4416489","chr5","39418145","39418231","15","35001745","GGCCAAGTGTGGTGGCTCATGCCTGTTGTCCCAGCACCGTGGGAGGCCGAGGCTGGTGGAACACCTGAGCTCAGCTGAGTTTGAGACCAG","GGCCAGTTGCGGTGGCTCATGCCTGTAATCCCAGCACTTTGGCAGGCTGAGGCAGGTGGATCACCTGAGGTCAGGAGTTTGAGACCA"
"GL873598","4416855","4416947","chr3","94091253","94091337","31","89674398","GTGAGACCCTGTCTCTACAAAAAAAAAAGCTGGGCACTGTGGCATGTGCCTGTAATCCCAGCTACTTGGGAGGCAAAGGGAAAGAGAATCACT","AAACCTTGCCTTTACTAGAAATACAAAAATTAGCTGGGCATGGTGGCAGGTACCTGTAATCCCAGCTACTTGGGAGGCTGAGGCA"
"GL873598","5126074","5126161","chr1","12339306","12339394","19","7213232","GCCTGGTGCACTGGTTCACACCTGGAATCCTTGCATTCTGAGAGGCCCAGGTAGGCAGATCACCTCAGCTCAGAAGTTCGAGACCAGC","GCTGGGTGCGGTGGTTCACGTCTGTAATCCCAGCACTTTGGGAGGCCGAGGCGGGCAGATCACCTGAGGTCAGGAGTTCGAGACCAGCC"
"GL873598","5467584","5467662","chr1","9313328","9313403","17","3845744","GCGAGGTGGCTCACGCCTGTAATCCCAGCACATTTGGAAGGCCAAGGAGGGTGGATCACCCGAGCTCACCAGTTGGAGA","CGCAGTGGCTCACGCCTGTAATCCCAGCACTTTGGGAGGCCGAGGCAGGCAGATCACCTGAAGTCAGGAGTTTGAG"
"GL873598","6917752","6917856","chr14","9558287","9558382","22","2640535","GGCCAGGCATGGTGGCTTGTGCCTGTTGTCCCAGCACTGTGGAAGGCCGAGGCGGGTGGATCGCCTGAGCTCAGCTGAATTCGAGACCAGCATAAGACCAGTATG","GGCCAGGCATGGTGGCTTATGCCTGTAATCCCAGCACCTTGGAAGGCCGAAGCGGGCAGATCACCTGAGCTCAGGAGTTTGAGACCAGCCTGTCCA"
"GL873598","8078910","8079062","chr7","164825511","164825660","43","156746601","AACAGCCAGGCATTGTGGTGGGCACCTGTAATCCCAGCTACTTGGGAGGCTGAGGCAAGAGAATTGCTTGAGCCCAACAGTCTCAGGTTACTGTGAGTTATGACACCATGGCACTCTATTGAGGGCAAGAAAGTGAGACTGTCTTGGAAAAAA","CTAGCCAGGCATGGTGGTGCGCACCTGTAGTCCCAGTTACTTGGGAGGTTGAGGCAAGAGAATTGCTTGAGCCTGGAAGGCAGAAGTTGCAGTGAGCTGAGATCACACCACTGCATTCCAGCCTGGGCGAAAGAGCAAGACTCTGTTGAA"
"GL873598","8079328","8079454","chr6","10381248","10381379","32","2301920","GCCCGGCGTGGTGGCTCACGCCTGTAATTCCAGCACTCTGGGGAGGCCGAGGAGGGCAGATTGCCTGAGCTCACAGGTTTGAGCTAGAGCGAGACCCTGTCTCTTAAAAAGAAAAAAAAGGAAAGAA","GCTGGGCGCGGTGGCTCACGCCTGTAATCCCAACACTTTGGGAGGCCGAGGCGGGCAGATCACCAGAGGTGATCTCCAGCCTGGGCAGGAGAGCAAGACCCTGTCTCAAAAAATTTAGAAAAAGGAAAGAAA"
"GL873599","3943256","3943456","chr9","35892110","35892312","79","31948854","GGCAGGCTGCTTTGACCCATATCTACAACTCCAGAACTTTAGAGGCTGAGCTGGGTGGGTCCCTTGAGATTAGAAACTGCTTAGTAGCCTGGCAAAAACCAGACCCCACCTCCACCATGTAGAAAAATTAGCAGTATGCCATAGTGGGAACCTACCAATACAGTCTTTCCAAAGGCCAAAGCTAGAAGGACCGTGAGCTTG","GGCTGGGTGTGGTGGCTCATGCCTATAATTCCAGCACTTTGGGAGGCCGAGGCAGGTGGATCACCTGAGGCCAGGAGTTTGAGACCAGCCTGGCCAATATGGTGAAACCCCATCTCTACTAAAAGTACAGAAAATTAGTCAGTCATGATGGCGCATGCCTATAATCCCAGTTACTCGGGAGGCTAAGGTAGGAGAATTGCTTG"
"GL873599","6693284","6693349","chr1","100916857","100916922","15","94223573","TCACGTCTATAATCCTAGCACTCTGGGAGTCCTTGGCAGGTGGATCACCTGAGCTCAGGAGTTTGA","CATGCCTGTAATCCCAGCACCTTGGGAGGCCAAGGTGGGTGGATCACCTGAGGTCAGTAGTTTGAG"
"GL873600","991618","991705","chr15","13850109","13850195","15","12858491","GGCTGGGCGTGGTGGCTCACACCTGTTGTCCCAGCGCTGTGGGAGGCTGAGGCAGGTGGATCACCTGTGCTCAGAGGTTGAGACCAGC","GCCGGGCGCTGTGGCTCACACTTGTAATCCCAGCACTTTGGGAGGCTGAGGCAGGTGGATCACCTGAGGTCAGGAGTTAGAGACCAG"
"GL873600","8825981","8826014","chr16","43605817","43605844","11","34779836","AGTCTGGGGCAACAGAGCAAGACTCTGTCTCAAA","CAGTCTGGGTGACAGAGCAAGATTCCAT"
"GL873600","8826039","8826157","chr13","87428402","87428520","35","78602363","ATTAGCCTGGTGTGGTGGTATATGCCTTCCTGCCTGCTTGGGAGGCTGAGGCAGGAAGTATGCTTTAACTGTGGAGTCTGAGGTTGCTATGAGCTAGGTTGAGGCCATGGCACTCTAAA","TTAGCCGGGTGTGGTGGTGCACGCCTGTAATCCCAGCTACTCAGGAGGCTGAAGCAGGAGAGTTGCTTGAACCCAGGAGTTGGAGGTTGCAGTGAGCTGAGATCACGCCATTGCACTCC"
"GL873601","269289","269338","chr14","49279240","49279285","14","49009951","GACTGGGTGTGGTGGCTCACACCTTTAATCCTAACACCCTGGGAGGCTTA","GGCTGAGATGGTGGCACACACCTGTAATCCCAGCTACTTGGGAGGC"
"GL873601","269431","269678","chr1","184453273","184453521","76","184183842","AGAAGATCACTCAAGATCAGGAGTTTGAGAACAGCCTGAGCAAGACCCCCATCTTTACTAAAAATGGAAAAGTTTTTACCCAGGCATGGTAGTGCGTGCCTGTATCCCATCTACTCCGGAGGCTGATAGGAGGATTGCTTCAACCAAGGAGTTTGAGGTTCCAGAGACTTAAGATGACACAACTGCATTTTACCCAGTGTGACACAGCGAGACTCTTTCAGAAGAATTTTTAAAAGGAAAAAAAAGAA","GGTCAGATCACCTGAGGTCAGGAGTTTGAGACCAGCCTGACCAACATGGTAAAACCCCATCTCTGCTAAAAATACAAAAAATTAGCCAGGCATGGTGGTGAACGCCTGTAATCCTAGCTACTCAGGAGGCAAAGACAGGAGAATCGCTTGAATCTGGAAGGTGGAGGTTGCAATGAGCCAAGATGACGCCACTGCACTCCAACCTGGGTGACAGAGGAAGACTCCATCAAAAAAAAAAAAAAAAAAAAA"
"GL873601","1397978","1398117","chr16","24839455","24839591","34","23441477","GCCTATAATCCTAGCACTCTGGAAGGCTGAGGCAGGAAGATCACTAGAGCTTGGGAGTTTGAGATTGCTGTGAGGGAGACTGACTCCATGGCACTCTAGCCTGAGGCAACAGAGTAAGACTCCATCTCAAAAAAAAAAAA","CTCTAACTCCAGCTACTCAGGAGGCTGAAGCAGGAAAATCACTTGAACCTGGGAGGTGGAGGTTACAGTGAGCCAAGATCACACCATTGCACTCCAGCCTGAGCGACAGAGCGAGACTCTGTCTCAAAATAAATAAA"
"GL873601","4065502","4065590","chr11","108711352","108711444","19","104645850","GCTGGATGTGGTGGCTCTCACCTATAATCCTAGCACTCTGGGAGGTCAAAACAGGTGGATCACCTGAGCTCAGGAGCAAGAACACCAGC","GTCAGGGGTGGTGGCTCACGCCTGTAATCCCAGCACTTTGGGAGGCCAAGGCAGGTGGATCGCCTGAGCTCAGGAGTTCAAGACCAGCCTTGC"
"GL873601","8241370","8241465","chrY","9469734","9469829","34","1228364","AAAAAAGGTGGAGATGAGCCATGCGCAGTGGTGTAGGCCTGTAATCCCAGCCCTTGGGAGGCCAAAATGGTGGATTGCCTGAAGCAGAGCAAGACC","AAAGTACAAAGAGTCTGGGTACAGTGGCCCAAGCCTGTAATCCCAGCAGTTTGGGAGGACAAGATGGGTAGATCACCTGACATCATGAATTAGAGA"
"GL873569","7519122","7519191","chrX","79016364","79016431","16","71497242","TTGGCCAGGCATGGTCGCTCAGGCTGTAATACCAGCTACTTGGGAAGCTGAAGCAGGAGGATCACTTGAA","TTGGCCAGGCACGGTGGCTCATGCTTATAATCCCAGCTACTCGTGAGGCTGAGGCAGGGGAATCGCTT"
"GL873569","7989158","7989286","chr8","41505677","41505810","35","33516519","AGTCCCACCTATTTGGAAGGCTGAGGCAAGAGGATCACTTGAACTCAGCAGTTTGACATTGCTATGAGTTAGATTGACTCCATGGCACTCTAGCCCAGGCAACAGAGCAAGACTCCGTCTCAAAACAAA","TAATACCAGCTACGTGGGAGGCTGAGGCAGGAGAATCACTTGAACCCGGGAGGTGGAGGTTGCAGTGAGCTGAGATTGCACCGTTGCACTCTAACCTGGGCAACAAAAGCAAAACTCTGTCTCAAAAAAAAAAA"
"GL873569","7989575","7989702","chr1","62231025","62231129","47","54241450","GGCTGGGTAATGCAGTGGCTCACGCCTATAATCCTAGTGCTTTGAGAGGCCAAGAGTGAGACTCTGTGTACTAAAAATAGAAAAATTACCTAGGCATTCTGGTGGGCACCAGTAGTCCCACCTATTTG","GGCTGGGCATGGTGGCTCACGCCTATAATCCCAGCACTTTGGGAGGCCGAGGCAGGTGGATCACCTGAGATCAGGAGTTTGAGACCAGACTGGCCAACATGGTGA"
"GL873569","10034363","10034556","chr10","61268396","61268605","62","51234033","CAGCTTGAGCAAAAGTGAGCCCCTGTCTCTACTGAAAATAGAAAAAATTAGCCAGGCGTGGTGGCACACACTTATAGTCCCAGCCACTTAGGAGGCTGAGGCAGGAGTTTGAGGTTGACATAATCTAAGCTGATACCATAGCACTCTAGCCTGGGCAATAGAGTGAGACTCTGTCTCAAAGAAGAAATTTATCT","CCTGACCAATGGTGAAACCCTGTCTCTACCAAAAATACAAAATTTAGCTGGGCATGGGGGCACGCACCTGTAGTCCTAGCTACTCGGGAGGCTGAGACAGGAGAACTGCTTGAACTCGGGAGGCAGAGGTTGCAGTGAGCTGAGATCATGCCACTGCACTCTAGCCTGGGCAATAGAGTGAGACTCCGTCTCAAAAAAAAAAAAAAAAAA"
"GL873569","10034830","10034845","chr1","217667782","217667796","2","207632952","AAAAAAGAAGAAAAAA","AAGAAAAAGAAAAAA"
"GL873569","10203815","10203922","chr8","96374555","96374671","35","86170740","GCCAGGTGTAGTGGTTCACACCTATAATCCTAGCACTCTGGGAGCCTGAAGCAGGTAAATGGACTGAGCAAGAGTGAGACTTCCACCTCTATTGAAAATAGAAAAATT","GGCTAGGTATGGTGGCTGATGCCTATAATCCCAGAATTTTGGGAGGCCGAGGCAGGCAGATCATCTGAGGTCAGGAGTTTGAGACCAGTCCCGTCTCTACTAAAAATACAAAAATTA"
"GL873569","10204196","10204373","chr20","1304385","1304559","47","8899811","GAAAATAGAAAAATTAGCCAGGCATTATAGCAGGCACCAGTAATCCCAGTTACTTGGGAGGCTAAGGCAAAAGAATCTCTTGAGCCCAAGTTTGGGGTTGCTAGGAAGTAAAACACCACAGCACTATACCCAGAACAAGAGAGTGAAGACTCAGTCTCAAAAAGATAAATAAATAAAA","AAAAATACAAAAATTAGCCAGGCATGGTGGCGGGCGTCTGTAACTCCAGCTACTTGGGAGACTGAGGCAGGAGAATCGCTTGAACCCAGGAGGCAGAGGTTACAGGTGAAATCACACCACTGCACTCCAGCCTGGGCAACAGGGCAAGACTCTGTCTCAAAAAAAAAAAAAAAAA"
"GL873569","10473375","10473444","chr8","20660648","20660717","21","10187273","TGTAGTCCCAGCACTTTGGGAGGTTAAGGCAAGAGTAGCACCCAACATGAGGAGATCAAGACCAATCTGG","CTGTAGTCCCAGCACTTTGGGAGGCTGAGGCAGGTGGATCCTTTGAGGGCAGAACTTTAAGACCAGCCTG"
"GL873570","9287350","9287485","chr1","29437872","29437991","30","20150522","GGCCGGGCGTGGTGGCGCACGCCTGTAGTCCCAGCGCTATGGGAGGCCGAGGCGGGTGGATCACCTGTGCTCAGAGGTTCGAGACCAGCCAAGACCCCCCTGAGCCAAACGAGCCAGAGTGAGACCCCGTCTCTAC","GGCCGGGCGTGGTGGCTCACGCCTGTAATCCCAACATTTTGGGAGGCCAAGGCGGGTGGATCACCTGAGGTCAGAAGTTCGAGACCAACCTGGCCAACATGGTGAAACCCCTGTCTCTAC"
"GL873571","3669989","3670207","chr4","116777080","116777297","60","113107091","AGACCAGCCTGAGGAAGAGCAAGATCCCATCTCTATTAAAAATAGAAAAATTAGCCAGGCATTCTGGTGGGCACCTGTAGTTCTAACCACCTGGGAGGCTAAGGCAAGAGGAACTCTTCAACCCAAGAGTTTGAGGTTGCTGAGAGCTAGGCTAAGGCTGCAGCACTCTAGCCTGGGCAACAGAGTGAGACTGTTTCTCAAAAACAAAAAACAAAAAAA","CGAGACCAGCCTGGTCAATATGGTGAAACCCCGTCCCTACTAAAAATACAAAAATTAGCCAGGCATGGTGGCAGGCACCTGTAGTCCCAGCTACTCGGAAGGCTGAGGCAGGAGAATCGCTTGAACCACAGAGGCAGAGGTTGCAGTGAGCCGAGACTGCACCACTGCACTCCAGCCTGGGCGACAGAGTGAGACTCAGTCTCAAAAAAAAAAAAAAA"
"GL873571","106134","106236","chr4","18143723","18143826","27","18037589","GGCCAGTCTCAGTGGCTCACACCTGTAATCCAGCATTCTGGGAGGCTGAAGCACACGGTCACCTGAGCTCAAAGGTTGGAGACCAGAGTGAGACCCCACCTCT","GGCCAGGCGCAGTGGCTCACTCCTGTAATCCCAGCACTTTGAGGCTGAGGCAGGCGGATCACCTGAGGTCAGGAGTTTGAGACCAGCCTGGCCGAAACCCCATC"
"GL873571","3670496","3670589","chr7","50468399","50468491","15","46797903","GGGCAGGCATGGTGGCTCACACCTGTAATTCTAGCACTCTTGGAGGCTGAGGCAGGAAAATGGCTTGAGGTCAGGAGTTCAAGACCAGCCTGAG","GGCCAGTCATGGTTGCTCACACCTGTAATACCAGCACTTTGGGAGGCCGAGGCAGGCGAATCACCTGAAGTCAGGAGTTCAAGACCAGCCTGG"
"GL873571","4059090","4059389","chr7","52903696","52903994","88","48844606","GGCCAGGTGCAGTGGTTCACACTTATAATCCTAGCACTCTGGGAGGCCGAGGCGAGTGAAGTGCCTGAGCTCATGGGTTCAAGACCAACCTAAGCCAGAGACCCCTGACTCTTATAATAGCCTGGCATTGTGGTGGGCGCCAATATTTCCAGCTACTCTGAGGCTAAGGCAAGAGAATTGCTTGAGCCCAGGAGTTGGAGGTTTCTGTGAGCACTGACGCCGCAGCTCTCTACCAAGGGCAACAAAGACTCTGTCTCAAAAAATAAATAAATAAATAAATAACAGAATGAAAATGAAAAA","GGCCGGGTGCGGTGGTTCACGCCTGTAATCCCACCACTTTGGGAGGCTGAGGCAGGCAGGTCACCTGAGGTCAGGAGTTCCAGACCAGCCTGGCCAACATGGTGAAACCTTGTCTCGGCTATTAGCCTGGCATGGTGGTGCGTGCCCATAATCCCAGCTACTCAGGAGGCTGAGGCAGGAGAATCGCTTGAACCCAGAAGGTGGAGGTTGCAGTGAGCCAAGATAGCACCACTGCAACTCCAGTCTGGGCAACAGAATGAGACTCTGTCTCAAAAAAAAAAAACAAAAAACAAAAAGAA"
"GL873571","4209418","4209704","chr11","32517699","32517985","80","28308281","GGCTTGGCAAGGTGGCTTACACCTCAAATCCTAGCACTGTGGGAGACTGAGGCAGGTGGATTGTTTGAGCTCAGGAGGTCAAGATAGAGAGCAAGAGCAAGTCTCTGTCTCTACTAAAAATAGAAAAGAACTACTTCCCGGGGGTCATGGCAGTAGCCTGTAATCCCAGTTACTAGGTAGAATGAGGCAAGAGGATCTGTTGAAGCCAAGAGACTGAGGTTGTTATGAGCATGCCACAGCACTCTACCCAGGGTGACAGAATGAGACTCTGTTGAAAGAAAAAAAGA","GGCCGGGTGCAGTGGCTCACACCTGTAATCCCAGCACTTTGGGAGGCTGAGGCGGGTGGATCACCTGAGGTCAGGAGTTCAAGACCAGCCTGACAAACATAGTGAAACCCTGTCTCTACTGAAAATACAAAATTAGCCAGGTGTGGTGGCGCATGCCTGTAATCCCAGCTACTCGGGAGGCTGAGGCAGGAGAATTGCTTGAATCCAGGAGGTGGAGGTTGTGTGATCACACCACTGCACTCCAGCCTGGGCGACAGAGTGAGACTCTGTCTCAAAAAAAAAAGAAA"
"GL873571","4209985","4210154","chr3","175781758","175781928","60","171571773","GAAAGAAATGAAAAGAAAGAAGTTAGCTGGTTGTTGGGGTATGCTTCTATAGTCCCACCTACTCAGAAAGCTGAAATCTGGAGTTTGGGGTTGTTGTAAGGTAGGCTGATGACATAGCACTGTAGCTTGGGCAAGAGAGTGTGACTTTGTCTCAAAAAAAATTAAAACAA","ATTAAAAACACAAAGATTAGCCAGGTGTGATGGCACACAACTGTAATCCCAACTACTCAGGAGAATCGCTTGAACCTGGGAGATAGGGTTTGCAGTGAGCCAAGATTGTGCCACTGCACTCCAGCCTGGGTGACAGAGTGAGACTCTGTCTCCAAAAAAAAAAAAAAAAAA"
"GL873571","4210444","4210570","chr17","16655655","16655789","35","12445211","GCCAGGCAGATGGCTCACACTTCATCCTAGCCCTCTGGAAGGCTGAGGCAGGCTAATTTTTTGAGGTTAGGAGTTTGAGACCAGCCTGAGGAAGAGACCCATCTCTACTTTAAAAAATAAATGGAAA","GCCAGGCATGGTGGCTCACACCTGTAATCCTAGCACTTTGGGAGACTGAGGCGGGTGAATCACCTGAGGTCAGGAGTTTGAGACCAGCCTGACCAGTATGGTGAAACCCAGTCTCTACTAAAAATACAGAAATTA"
"GL873571","4391733","4391878","chr11","33723808","33723943","46","29332075","AACTTAGCTGGGAATGGTGGCTCAAGCCTGTAATCCTAGCACTCTGGGAGGCTCAGGTGGGAGGATCACTTGAGGTTGCTGTGAGCTTGGCTGATGCCAGGACACTCTAGTGTGGGCAAGAGAGTGAGACTCCGCCTCAACAACAA","GCCGGGTGCAGTGGCTCATACCTGTAATCCCAGCACTTTGGGAGGCTGAGGTAGGCGGATCACGAGGTCAGGAGCTGAGATGGCGCCACTGCACCCCAGCCTGGGTGACAGAGCAAGACTCTGTCTCAAAAAAAAA"
"GL873571","6307773","6307841","chr9","62429628","62429694","22","56121855","CTGGGTGTGGTGGCATTGCACCTGTAATCCTAGCTACTTGGAAATCTTAAGCCCAGGAGTTGAAGACTG","CCCAGCATGGTGGTGCATACCTATAATCTCAGCTACTTGGAGGCTTGAGCTCAGAAGTTTGAGACCG"
"GL873571","6496217","6496306","chr1","27257765","27257856","27","20761548","GCAGGGTGTGTTGACCCACACCCACAATTCCAGGACTCTGGGGGGCCAGGGATGGTGGGTTCCCTCAGATCAGGAGCTCCTTACCAGCCT","GACTGGGCATGATGGCTCAAATCTGTAATTCCAGCACTTTGGGAGGCCGAGGTGGGTGGATTGCCTGAGATCAGGAGTTCAAGACCAGCCTG"
"GL873571","6499738","6499903","chr1","38976375","38976555","47","32476637","AAAATAACATGAATTGACTAGGCGAGGTGGCTCACATCTCTAATCCTAGCACTCTGGGAGGCTGAGGCAGGAGAATTGCATGAGGTTGCTGTGAGCTATGATGATACCACGGCATTCTAATCAGGGTGACAGAGTGAGATTCTGTCTTAAAACAAACAAACAAAAA","AAAATAAATAAATTAGCAGGGCCTGGTGGCGCACACCTGTAATCCCAGCTACTTGGGAAGCTGAGGCAGGAGAACCCACTTGAACCTGGGAGCCGGAGGTTGCAGTGAGCTGAGATGGCACCACTGCACTCCAGACTGCGTGACAGAGTGAGACTCCGTCTCAAAAACAAACAAACAAAAA"
"GL873571","11399575","11399872","chr15","109458692","109458994","79","98059117","CAGTGGCTCACACCTGTAAATCTAACACTCTGGGAGGCCAAGGTGGGTGGATCCCTTGAGCTCAGGAATTTGATACCAGCCTGAGCAAGAGTGAGACCTTGTCTCTACTAATAATAGAAAAATAGCCCGTGTTGTGGCACTTGTCCCAACCACTGGGGAGGCTTTAGGCGGGAGGATTACTTGAATTGGGAGTTTGATATTGCTGTGAGCTGGGCTGATGCCTTGGCATTCTAGCTTGGGTAACAGCGTAAGACTCCGTCTCAAATAAATAAATAAATAAATAAAAAGAAAAAAAGAA","GTGGCTCACACCTGTAATCTCAGCACTTTGGGAGACCGAGGCAGGTGGATCACCTGAGGTCGGGAGTTTGAGACCAGCCTGACCAACGTGGAGAAACCCCGTCTCTACTAACAATACAAAATCAGCTGGGCGTGGTGGTGCATGCTTGTAATCCCAGCTACTCGGGAGGCTGAGGTAGGAGAATCGCTTGAACCTGGGAGGTGGAGGTTGCGGTGAGCCGAGATCGAGCCACTGCACTCCAGCCTGGGTGACAGAGCAAGACTCCATCTCAAAAAAAAAAAAAAAAAAAAAAAAAAAAAAAAA"
"GL873572","114760","114841","chr8","26280134","26280211","16","26165374","GGCCAGGCATGGCGGCTCTTCCCTGTAATCCTAGCACTCTGGGAGGGCGAGGCAGGCAGATCACCTAGGCTAGGGTGAGATC","GGCCAGGAATGGTGGCTCATGCCTGTAATCCCAGCACTTTGGGAGGCTGAGGCAGGCAGATCACCTGAGGTCAGGAGT"
"GL873572","9421791","9421892","chr11","8089184","8089269","35","1332607","TACTAAATATATAGCAAGGCCAGGCACAGTGGTTCATGGCTGTAATCCCAGTACTCTGGGAGGCCTAGTCAGAGTTGACCTGAGATCAGGCTAGAAGCCTGG","ATAAAAATAATTGGAGGCCAGGCACGGTGGCTCATGCTTGTAATTCTAGCAATTTGGGAGGCTGACGCGGGTGAGATCATACTGAG"
"GL873572","11052834","11053035","chr14","11857478","11857657","65","804644","TCCACAAAGAAAGCAGAAGTGTGGCCGGGTGGTAGCTCAAGGCAGGAATCCCAGCACTCTGGGAGCTGGGAGGTGGGGGAGGATCCCTTGAGATCAGGAGTTGGAGGGCACAGTGAGCCTGGGGGAGGCCACTGTCTCTGTACTCTAGCAGGGAGACAGAGCAAGACTGCCCATTCAAAGAAAAACAACAAACAAAACAAAA","TACAAAAATTAGCTGGGCACGGTGCCACAAGCCTGTAATCCCAGCTACTCGGGAGGCTGGGCAGGGGAATAGCTTGAACCCAGAGGTGGAGGTTGCAGTGAGCCAAGATCAAGCCACAGCACTCCAGCCTGGGTGACAGAGCAAGACTCCATCTCAAAAAAAAAAAAAAAAAAAAAAAAA"
"GL873573","2564195","2564244","chr1","109985445","109985491","12","107421250","TACAAAAATTAGGCTGGGCTTGGTGGTTCACGCCTATAATCCTAGCACTT","ACTAAAATTAGCTGGGCATGGTGGTGCATGCCTGTAATTCCAGCTAC"
"GL873573","7423371","7423533","chr2","202783328","202783513","56","195359957","GGTGGCTCACACCTGTAATCCCAGCACTCTGGGAGCCCTGGTGGCTCATGTCTATAATCCTAGTACTCTGGGAGACCATGGTGGCTCATGTCTATAATCCTAGTACTCTGGGAGCCATGGTGGCTCACGCCTATAATCCTAGTACTCTGGGAGACCATGGTGG","GGCTGAGGCGCGGGGGCTCACGCCTGTAATCCCAGCACTGTGGGAGGCCGAGGCGGGTGGATCACGCCTGTAATCCCAGCACTGTGGGAGGCCAAGGCGGGTGGATCACGCCTGTAATCCCAGCACTGTGGGAGGCCGAGGCGGGTGGATCACGCCTGTAATCCCAGCACTGTGGGAGGCTGAGGC"
"GL873573","9657648","9657710","chr19","10207852","10207913","10","550204","TAAAAATAAAAAATTTAGCTGGATGTGGTGGCTCACACCTGTAATCCTAGCACTCTGGGAGAC","TAAAAATACAAAATTAGCTGGGTGTGGTGGCACACACCTGTAATCCCAGCTACTCAAGAGGC"
"GL873574","1624662","1624783","chr9","814961","815079","36","809701","GACTGGGTGGGTTGGATCATGCCTGGAATCCTAGCACCCTGGGAGGCCAAGGTGAAAGGATTGCTTGAGGTTAGGAGTTCCAGAAATGTAGCAGTCATGGTGACTTCATCCTTCTCTACCAA","GGCTGGGTGCTTTGATTCATGCCTGTAATCCCAGCACTCTGGGAGGCCGAGGCAGGTGGATCACCTGAGGTTAGGAGTTCGAGACCAGCTTGGCTAACATGGTGAAACCTCGTCTCTAC"
"GL873574","4459477","4459612","chr1","29437872","29437991","29","24978395","GGCCGGGCGTGGTGGCGCACGCCTGTAGTCCCAGCGCTATGGGAGGCCGAGGCGGGTGGATCACCTGAGCTCAGAGGTTCGAGACCAGCCAAGACCCCCCTGAGCCAAACGAGCCAGAGTGAGACCCCGTCTCTAC","GGCCGGGCGTGGTGGCTCACGCCTGTAATCCCAACATTTTGGGAGGCCAAGGCGGGTGGATCACCTGAGGTCAGAAGTTCGAGACCAACCTGGCCAACATGGTGAAACCCCTGTCTCTAC"
"GL873574","4681987","4682216","chr6","153082888","153083127","73","148400901","GGGTGCGGTGGCTCAGACCTATAATCCCAGCACTCTGAGAGGCCGAAGTGGGTGGATCACCTGAGCTCAGGAATTTGAGACCAGCCGTCTCTAAAAATAGCTGAGTGTTGTGGCAGTGGCTGTAAGTCCCAGCTGTTTGGAAAGCTGAAGCAAGGGAATCACTTGAACCCAAGAGTTTGAGGTTGCTGTGATGACAAAGTGAGACTCTATCTCAAAAAAAAAAAAAAAAA","GGCCGTGCGCGGCGGCTCACGCCTGTAATCCCAGCACTTTGGGAGGCTGAGGTGGGTGGATCACCTGAGGTCAGGAGTTTGAGACCAGCCCGACCAGAAATTAGATGGGTGTGGTGGTGCGCTCCTGCAGCCCCAGCTACTTAAGAGGCTGAGGCAGGGTAATCACTTGAACCCGGGAGGCGGAGGTTGCAGTGAGCCGAGCTCACGCCACTGCACTCCAGCCTGGGTAACAGAGCGAGA"
"GL873574","4709916","4710039","chr19","13152422","13152536","46","8442506","AAAAATAGAAAAACTAGCCAAGCATGGTGGTGCACCCCCTATAGTCTGAGCTCCTCAGCGGGCTGAAGCAAAAGGACGGCTGGAGCCCTGGAGTTTGAGGTTGCTGTGAGGCAAGGTGATGCCA","ACACATAAATTAGCCAGACATGATGGTGAGTATCTGTAATTCCAGCTCCTTGGGGGGCTGAGGCGGGAGAATTGCTTGAACCTGGGAGGCAGAGATTGCAGTGAGCCAAGATCGC"
"GL873574","6353839","6353913","chr5","25768079","25768163","22","19414240","AAAAATATAGCAAGGCCAGGCATGGTGGCTCACACCTATAATCCCAGTACTTGGGAGCTGGAATTTGAACCTAGG","AAAAAACTCAAACAAGGCTGGGCGTGGTGGCTCACACCTGTAATCCCAGCACTTTGGGAGGCTGAGGTGGGTGGATCACCTGAGG"
"GL873574","6533061","6533332","chr5","85182161","85182439","81","78649100","GGCTGGGCGAGGTGGCTTACACCTATAATCCTAGTACTCTGGGAGGCCAAGGTGGGTGGATTGCCTGAGCGCACAGTTTCAAGACCAGCTGGAGCCAGAGAGAGAGAGAGAGACCCTGCCTCTAAAAATAGCCAGGCATTGTGGCAGGCACCTGTAGTCCCAGCTACTTGGCAGGCGGAGGTATGAGAATCGCTAGAGGTTGCTGTTAGCTATGATGCCATAGCACTCTACCAAGGGCGACAAAGTGAAACTCTGCCTCAAAAAAAAGAAGA","GCCAGGCGTGGTGACTCAAGCCTGTAATCCTAGCACTTTGGGAGGCCAAGGTGGGCGGATTGCCTGAGCTCAAGAGTTTGAGACCAGCCTGGGCAACACGGTGAAACCCAATCCCTACTAAATACAAAAAAAATTAGCCGGGTGTGGTGGTGTGAACCTGTAGTCCCAGCTACTCGGGAGGCTGAGGCAGGAGAAGGCAGAAGTTGCAGTGAGCCGAGATCACACCACTGCACTCCAGCCTGAGTGACAGAGCAAAACTCTTTCTCAAAAAAAAAAAAA"
"GL873574","6643746","6643907","chr2","92627944","92628105","46","85984198","AAATAGCCAGGCGTTGTGGCAGGCACCTATAGTCCCAGCTACTTGGGAGGCTGAGGCAAGAGAATCACTTAAGCCCAAGTGACAGAGGTTGCCAGGGCACTCTACGTAGGCAACAGAGTGAGACTCTATCTAAGAAAGAAGGAAGGAAGGAAGGAGAAAGAA","TTAGCCGAGCATTGTGGTGCGCGCCTGTAGTCCCAGCTACATGGGAGGCTGAGGCAGGAGAACACCTGAACCCAGGATGTGAGCTGAGTCGCGCCATTGCACTCCAGCCTGGGCAACAGAGTGAGACTCCATCTCAAAAATAAAATAAAATAAAATAAAAAA"
"GL873574","6644163","6644274","chr1","128607504","128607619","20","121963341","CTGTAATCCTAGCACTTGGGAGGCTGAGGCAGGTGGATCACCTGAGTTCAGGAGTTCAAGACCAGCCTAAACAAGAGTGAGACCCTATCTCTACTAAAAATAGAAAAAATAT","GCCTGTAATCCAAGCACTTTGGGAGGCTGAGGCGGGTGGATCACCTGAGGTCAGGTGTTCGAGACCAGCCTGGCCAACGTGGTGAAACCCCAACTCTACTAAAAATACAAAAATTA"
"GL873574","8511822","8512127","chr1","23439759","23440073","84","14927937","GGTGGCTGGTGCCTGTAATCCTAGCACTCTGGGAGACTGAGGCAGGTGGATCACTTGAAATCAGGAGTTTGAGATCAACCTGAGCAAGAGATCTTGTCTCTCCTAAAGATAGAAAAACTAGCTGGGATTTGTGGTGGACACCTGTAATTTCAGCTACTCAGGAAGCTAAGGCAAGAGCATTGCTTAAAACCAGGAGTTTGAAGTTGATGTGAGCTAGGATGTCAGGGCAGGTTACCCAGGGTGACAGAGTGAGACTCTGTGTCAAAATAAACAAACAAACAAACAAACAAAACAAAATAAAATAAA","GGCTGGACATGGTGACTCACGCTTGTAATCCCAACACTTTGGGAGGCTGAAGCAGGCAGATCACCTGAGGTCAGGAGTTTGAGACCAGCCTGACCAACATGGTGAAACCTTGTCTCTACTAAAAATACAAAAATTAGCTGGGAGCAGTGGTGCACACCTGTAATCCCAGCTACTCGGCAAGCTGAGGCAAGATAATTTTTTAAACCTGGGAGGTGGAGGTTGCAGTGAGCCAAGATCGTGCCACTGTACTCCAACCTGGGAGACAGAGCAAGACTCTGTCTCAAAAAAAAAAAAAAAAAAAAAAAAAAAAAAAAA"
"GL873575","2107336","2107519","chr4","38052972","38053149","54","35945636","TCAATTAAAAACTTTTTAAAATGAGGCTGAGCATGGTGGTTCACACCTGTAATCCCAGCACTTTGGGAGGCCGAGGCAGGAGGATCACCTGATCCCAGGAGTCCAAGCCTACAGTGAGCCGTGATAATACCACTGCACTTCAGCCCAAAGCCTCAAAAAGAAAAAAAAAAAAGGATAGACAAGA","TATATATATATATATTATTTTGGGGGGGCATGGTGGTGCACACCTGTAATCCCAGCTACTCGGGAGGCTGAGGCAGGAGAATTGCTTGAGCCCGGGAGGCAAAGGTTGCATTGAGCTGAGATCACACCACTGCACTCCAGCCTGGCGACAGAGTCTCAAAAAAAAGAAAAAATAAAAA"
"GL873575","5831824","5831959","chr1","29437872","29437991","28","23606048","GGCCGGGCGTGGTGGCGCACGCCTGTAGTCCCAGCGCTATGGGAGGCCAAGGCGGGTGGATCACCTGAGCTCAGAGGTTCGAGACCAGCCAAGACCCCCCTGAGCCAAACGAGCCAGAGTGAGACCCCGTCTCTAC","GGCCGGGCGTGGTGGCTCACGCCTGTAATCCCAACATTTTGGGAGGCCAAGGCGGGTGGATCACCTGAGGTCAGAAGTTCGAGACCAACCTGGCCAACATGGTGAAACCCCTGTCTCTAC"
"GL873575","7451097","7451208","chr3","122814630","122814743","22","115363533","GGCCAGGTGTGGTGGCTCACACCTGTTATCCTAGCACTCTGAGAGGCCACAGCAGCTGGATCACTTGAGCTCAGGAGTTCAAGACCAGTCTGAGCAAGAGCAAGACCTCACC","GGCTGGGTGTGGTGGCTCATGCCTGTAATCCCAGCACTTTGAAAGGCCAAGGCAGATGGATCACTTGAGGTCAGGAGTTCCAGACCAGCCTGGCCAACATGGCAAAACCCCATC"
"GL873575","7451277","7451445","chr6","58863249","58863409","41","51411972","AAAAATTCAGCCAGCCACAGTGGAAGTGGATGCCTGCCATCACAGCTACTCTGGGGGCTGGGGCAAGAGAATTGCTTGATCCCAGGAGTCTGAGGTTGCTGTGACCTAGGCTGACACCACAGCACTCTACCCAGGGTGACAGAGTGAGGCTGTGTTTAAAAAAAAAAAA","TTAGCCAGGCATGGTGGCACATGCCAGTAATCCCAGCTACTCAGGAGGATGAGGCAGGAGAATCGCTTGAACCCAGGAGGCAGAGGTTGCAGTGAGCTGAGATTGCGCCACAGCACTCTACCCTGGGTGACAGAAGGAGACTCTGTCTCAAAAAAAAAAAA"
"GL873576","1765109","1765185","chrX","53921180","53921256","12","52156071","GGCCAGGTGCAGTGGCTCATATCTGTAATCCTAGCACCCTGGGAGGCCAAGGTAGGCGAATCACCTGAGGCCAGGAG","GGCCAGGTGCAGTGGCTCACGCCTGTAATCCCAGCACTTTGGGAGGCCGAGGTGGGCGGATCACTTTAGGTCAGGAG"
"GL873576","2711577","2711895","chr7","6620384","6620702","85","3908807","GGTCGAGCTTGGTGGCTCATGCTTGTAATCCTAGCACTCTGGGAGGCCAAGGCAGGTAAGTTGCCCTGAGCTCATAGGTTCCAGATCAGCATGAGCCAGAGTGAGACCCTGTCTCTACCAAAAAATAGCCCGGCATTCTGGCAGGTGCCTGTAATCCCAGCTGCTTGGGAGGCTGAGGCTAGAGAATCACTTAAACCCAAGGGTTAGTGGAGGTTGCTGTGAGCTATGATTCCACCGTACTCTACTGAGGGCCACAAAGTGAGACTCTGTCTCCATAAAAAAGAAAGAAAGAAAGAAAGAAAAATAAAATAAAATAAAA","GGCCAGGCACAGTGGCTCATGTCTGTAATCCCAGCACTTTGGGAGGCCGAGGCGGGTGGATTACCTGAGGTCAGGAGTTCTAGACCAGCCTGGCCAACAAGGCGAAACCCTGTCTCTACTAAAAATACAAAAAATTAGCTGGGCGTTTTGGCACATGCCTGTAATCCCAGCTACTTGGGAGGCTGAGGCAGGAGAATTGCTTGAACTGGGGAAGTGGAGGTTGCAGTGAGCTGAGATCACACCATTGCACGCCTGAGCAACAGAGCGAGACTCTGTCTCAAAAAAAAAAAAAAAAAAAAAAAAGAAAAGAAAAAGAAAA"
"GL873576","4782520","4782652","chr9","61136941","61137074","22","56354421","CCAGGCACGGTGGCTCACCCTTGTAACCCTAGTACTTTGGGAGGCTGAGGTGGGAGGATCCCTTGAGGTCAGGAGTTCAAGACCAGCCTGAACAACAGTGAGACCCCCGTCTCTACTAAAAAATAGAAAAGTT","GCCAGGCACGGTGGCTCACGCCTGTAATCCCAGCACTTTGGGAGGCTGAAGCGGGCGGATCACCTGAGGTCAGGAGTTCAAGACCAGCCTGGGCACCATGATGAAACCCCGTCTCTATTAAAAATACAAAAATT"
"GL873576","4782930","4783078","chr7","57521645","57521803","40","52738715","AGTTAGTCTGGTGTCATGGTGGGTGCCTGTAGTCCCAGCTGCTTGGGAGGCTGAGGCAAGAGAATCACTTGAGCCCAGGAGTTGGAGGTTGCTATGAGCGAGGCTGTAGCCTAGGCAACAGAATGAGACTTTGCCTCAAAAAAATAAAA","TTAGCTGGGCATGGTGGCGCATGCCTGTAGTCCCAGCTACTTGGGAAGCTGAGGCAGGAGAATCACTTGAACCTGGGAGGTGGAGGTTGCAGTGAGCTGAGATCGCACCGCTACACGCCAGCCTGAGCAACAGAGAGAGACTCTGTCTCAAAAGAAAAA"
"GL873576","7828709","7828723","chr5","101042981","101042996","1","93214272","TAAATAAATAAAAAA","TAAATAAATAAATAAA"
"GL873576","7828960","7829230","chr13","49045537","49045844","89","41216577","GCCGGCTGCAGTGGCTATAATCCAAGTACCCTGGGAGGCTTAGGTGGATGGATCACTTGAGCTCAGAAGTTCAAGACCAGCCTCAGCAAGAGGTAGACCTTGCCTCTATTAAANNNNNNNNNNNNNNNNNNNNNNNNNNNNNNNNNNNNNNNNNNNNNNNNNNNNNNNNNNNNNNNNNNNNNNNNNNNNAGTTTGAGGTTGCTGTGAGCTATGATGAAGCCAGGGCATTCTACCCAGGGTGACAGAGTAACTCTTAAAAAAAACTAAACAA","GGCCAGGCAGAGTGGCTCATGCCTGTAATTCCAGCAATTTGGGAGGCCTAGGCAGGCAGATTACCTGAGGTCAGGAGTTTGAGACCAGCCTGGCCAACATGGTGAAACCCCGTCTCTTCTANNNNNNNNNNNNNNNNNNNNNNNNNNNNNNNNNNNNNNNNNNNNNNNNNNNNNNNNNNNNNNNNNNNNNNNNNNNNNNGGAGATAATAGCTTTTGTAGAACGAAGCGATGCAACAGCCAGATCGCCGCCACCACCCTTAGGTCCTGGCGACAGAGTGAGATCCATCTTAAAAAAAAAAAAAAAAAAA"
"GL873576","10622840","10623093","chr7","60266447","60266705","74","49643607","GCTGGGTATGGTGGTTCACACCTATAATCCTAGCACTCTGGGAGGCTGAGGTGGGAGGATTGGTGGAGCTCAGGAGCTCATGAGGTGCCAAATCACTGGTGCCACACACCTGTATTCCCAGCTACTGAGGAGGCTGAGGCAGGAGGATCAGGTAAGCCCAGGAAGTTTGAGGTTGTAGTGAGTTAGGATGATTGAACTCTGCCTTGAGAGACAGAGCAAGATCCTCCTTCCTCCTAAGCAAACAAACAAATAAA","GGCTGGGTGCAGTGGCTCACACCTGTAATCCTAGCACTTTGGGAGGCTGAGGCGGGAAAATTGCCTGAGCTCAGGAGTTCAAGGACAGCCTAGGCAACATAGCATGGTGGTGCACGCCTGTATTCCCTGCTACTTGGGAGGCTGAGGCACAAGAATTGCTTGAATCCGGGAAGTGGAGGTTGCAGTGAGCCATTGTGGCACTGCTCTCCAGTCTGGGTGACAGAGCAAGACTCCATCTCAAAAAAAAAAAAAAAAAAAA"
"GL873576","10819939","10820007","chrX","67133632","67133707","21","56313693","AGGTTGCAGTGAAATTGTACCATTCCAATGAAGCCTGGGGGACAGAGTGAGATTCTCTCAAAATAAAAA","GGAGGTTGCAGTGAACCGAGATCGTGCCACTGCACTCCAGCCTGAGCGACAGAGTGAAACTTCGTCTCAAAAAAAA"
"GL873576","10920306","10920363","chr3","48261745","48261808","16","37341439","GCTGGACCTTGTAGAGAGTGCCTGTAATCCCAGCTACATGGGGGGCAAGAGAATTGCT","GCTGGGCATGGTGGTGCATGCCTGTGATCCCAGCTACTCAGGAGGCTGAGGCAGGAGAATTGCT"
"GL873576","10920398","10920529","chr10","67341428","67341546","30","56421030","GGCCAGGCGTGGTGGCTCACGCCTGTTGTCCCAGCACTGTGGGAGGCCGAGGTGGGTGGATTGCCTGAGCTCAGAGGAGTCCGGAAGACCAGCATGAGGCAGAGTGAGCCAGAGTAAGATCCTGTCTCTACC","GGCTGGGTGTAGTGGCTCATGCCTGTAATCCCAGCACTTTAGGAGGCCAAGGTGGATGGATTGCCTGAGCTCAGGAGTTCGAGACCACCCTGGGCAACAAGCCAAAACCCTGTCTCTAC"
"GL873577","515809","515961","chr7","137660778","137660931","43","137144969","AGCTGGGCATGGTGGCTCATGCCTATAACCCTAGCGTGCTAGGAGATTGCTTGTCAGGAGACTGAGGTTGCAGGAAACTGTGATGATGGCACTGCACTCTACCCAGGGTGACAGAGCAGGACTCTGCCTCAAAAAAAAAAAAAAAAATAGAAA","TTAGCTGGGCATGGTGGCGCATGCCTATAATCCCAGCTACTTGGGAGGCTGAGGCAAGAGAATCGCTTGAACCGGGGAGGCAGAGGTTGCAGACTGCACTCCAGCCTGTGTGACAGAGTGGGACTCCGTCTCAAAAAAAAAAAAAAAAAAAAAA"
"GL873577","1633164","1633256","chrX","38269524","38269615","26","36636360","TCAGCCAGGCATGGTGGCACTTGCCTATAAACCCAGCTCCTTGGGAAGCTGAGCCGGGAGGATCCCTTGCACCCAGGAGCAACGGAAGGCAGT","AATTAGCCAGGCATGGTGGCACATGCCTATAATCCCAGCTACTCAGAAGGTTGAGGCAGGAGAATCACTTGAACCTGGGAGGCAGAGGTTGC"
"GL873577","3979502","3979560","chr20","68909283","68909346","13","64929781","GAGTTTGAGACCAGCCTGAGCAAGACCGAGACCCAGTCTCTACTAAAAATAGAAAAATT","GGAGTTCAAGACCAGCCTGACCAACATGGAGAAACCCTGTCTCTACTAAAAAATACAAAAATTA"
"GL873577","3979839","3980009","chr10","31403126","31403287","39","27423287","ATGAGCAGATTGTCTTGGTGGGCACCTGTAGTCCCAGCTATTGGAGGTGGGAGGCTGAAGCAGGAAAATCTCTTGAGCCCAGGAGTTTGAGGTTGCTGTGAGCTAGGCTGACACCACGGCACTCTAGTCAGGGCGTCAGAGTGAGACTCCGTCTCAAAAAAAAAAAAAAAA","TTAGCTGAGTGTGGTGGCGCACATCTGTACTCCCAGCTATTTGGGAGGCTGAGGCAGGAAAATCGCTTGAACCCAGGAGGTGGAGGTTGCAGTGAGCCAAGATCACACTACTGCACTCCAGCCTGGGTGACAGAGTGAGAATCCATCTCAAAAAAAAGAAAA"
"GL873577","6050882","6051080","chr1","153219820","153220007","59","147168938","GGCTGGGCGTTGTGACTCATGCCTGTAATCCCAGCACTCTAGGAGGCCGAGGTGGGTGGACTGCCTGAACTCAGAGGTTTAAGACCATCCTGAGCCGCAGTGAGCCAGAGCGAGACCCTGTCTCTACCAAAAAAAGCTGGGTGTTGTGGTGGGCGCCTATAGTCCTAGCTACTTGAGGCGCTAAGGGTAAAAAAATTGC","GGCCTGGCACAATGGCTCACGCCTGTAATCCTAGCACTTTGGGAGGCCGGGGTGGGTGGATCACCTGAGATCAGGAGTTTGAGACCAGCCTGGCCAACATGGTGAAACTCCTTCTCTACAAAAATTAGCCAGGTGTGGTGGTGGGTACCTGCAATCCCAGCTATTTGGGAGGCTGAGGCAGGAGAATC"
"GL873577","8463965","8464050","chr9","52134422","52134508","19","43670457","CTGGGTGCTATAGCTCACGCCTATAATCCTAGCACTCTGGGAGTTTGGGGCAAATGGATCACCTAGGCTCAGGAGTTTGATACCAG","GGCTGGGAGCAGTGACTCACGCCTATAATCCCAGCACTTTGGGAGGCTGAGGCAGATGGATCACCTGAAGTCAGGAGTTCGAGACCA"
"GL873577","9471486","9471613","chr16","5178790","5178910","46","4292696","TTAGCCAGGCATAGTAGCCTGTGTGTAGTCCTAGCTACTCAGGAGGCTGAGGTAGATGGGTCACTTGAGGTTGCAGAGATTATGGTAATGTCACTGTACTCTAGCCCTGGCAACAGAGCACAACCCTG","TTAGCCGAGCCTGGTGGCATAAACCTGTAATCCCAGCTACTCAGGAGGCTGAGGCAGGGGAATTGCTTGAACCTGAGAGGAGAAGGTTGCAGTGAGCCGAGATTGCACCATTGCACCCCAG"
"GL873577","9471875","9471998","chr7","17832200","17832315","36","8360325","GGCCAGGTGAAGCAGCTCATGGCTATAATCCTAGCAGTTTGGCAGGCCAAGGTGGGAGGACTGCTTGAGGTCAAGAGTTCAAGACCAACCCATCTTTGCGAAAAATTTAAAAATTACCTAGGCA","GCCAGGAGAGGTGGCTCATGCCTCTAATCCCAGCACTCTGGAAATCCAAGGTGGGTGGATCACCTGAGGTCAGGAATTCCAGACCAGTCTGGCCAATATAAAAAATTAGCCAGGCT"
"GL873577","9853150","9853170","chr3","85044647","85044667","3","75191497","AAACAAACAAACAAAAAAAGA","CAAACAAACAAACAAACAAAA"
"GL873577","9853206","9853473","chr7","130818682","130818963","67","120965476","GCTGGGCGCAGCGTCTCACTCCTGTAATCCCAGCACTTGGGAGGCCAAGGTGAGTGGATTGCCTGAGTTTACAGTTTCGAGACCAGCCTGAGCCAAAGCGAGACCCCCATCTCTAAAAAATAGCTGGGCATTGTGGTGGGCACCTGTAGTCCCAGCTACTTGGGAGGCTGAGGCAAGAGGATCGCTTGAACCTAAGAGTTTGAGGTTGCTGTGAGCTAAGGCTCCATGGCATTCTACCAAGGGTGACTAAGTGAGACTCTGTCTAAAA","GCCGGGCACAGTGGCTCACACCTGTAATCCCAGTACTTTGGGAGGCCAAGGTGGGTGGATCACCTGAGGTCAGGAGTTTGAGACCAGCCTGGCCAACATAGTGAAACTCTACTAAAAATACAAAAAAATAGCTAGGCATGGTGGTGCGCACCTGTAATCCCAGCTACTTGGGAGGCTGAGGCAGGAGAGTTGCTTGAACCCAGCGGGGTTGAGGTTGCAGTGAGTTAAGATCAAGCCACTGTGCTCCAGCCTGGATGACAGAGAGAGACTCCATCTCAAAAA"
"GL873577","10722415","10722478","chr10","12501471","12501539","23","1779056","AATAAAAAAATGCTGGGTACAGTAGTACATGCCTGTACTCTCATCTGGGGAAGCTGAGGCATGA","AAAGTAAAAAATTAGAGCTGGGCATGGTGGCACACACCTGTAATCCCAGTCACTAGGGATGCTGAGGCA"
"GL873578","463331","463568","chr10","28935382","28935620","93","28472051","CAGGTGCTTTGACCCACACCCTCAACTCTAGGACTTTGGACGCCCTGGCTGGGTGGGTCCTTTAAAGTCAGGAGCTTCTTATCAGTCTGGGCAAAAGTGAGACCCCATCTCTACCAAACAAAGAAAGAAATCAGCAGTATGTTGCAGTAGAGACTCACCAATACCTTCTTTCAAAGACCAAAGCTGGAAGGACACTAAAGACCATGATCTCATGGCCTCCCTGAGCCATGACAATGCC","CCAGGTGCAGTGGCTCATGCCTGCAAGCTCAGAACTTTGGGAGGCAGAGGTGAGCAGACTGCCTGAGTTCAGGAGTTCAAGACCAGCTGGGCAACATGGTGAGACCCTATCTCTACTAAAAATACAAATAATTAGCAGGGTGTGGTAGCACACACCTGTAGTCCAGCTACTCAGGAGGCTGAGGCAGGAGAATTGCTTGAACCCAGGAGGCAGAGTTTGCAGTGAGCCAGGACTGGGCC"
"GL873578","1143712","1143827","chr11","52824583","52824692","30","51680871","GGCTGGGTGTGGTGCCTCATGCCTGTAATCTAAGCCCTCTCCGAGGCTGAGGTGGGAGGATCCCTTGAGTTTAGGAGTTTGATTTTGAGACCAGCCTGATCAAGAGAGAGACCTCA","GGCCGGGTGTGGTGGCTCATGTCTGTAATCCCAGCACTTTGGGAGGCTGAGGTGGGTGGATACCCTGAGGTCGGGAGCTCGAGACCAGCCTGACCAACATGGAGAAACCC"
"GL873578","1144101","1144139","chr3","33494224","33494257","11","32350123","GAGAGAGACCTCATGTCTACTAAAATAAATAAATATATA","GTGAAACCCGTCTCTACTAAAAATACAAAAATTA"
"GL873578","1144175","1144343","chr12","119519961","119520131","41","118375786","ATTATCCAGGCCTTCTGGTGGATGCCTGTAGTCCTAGCTACTAGAAAAGCTGGAGCAGAATCACTTGACCCAGGAGCTGGAGGTTGCAGGGAGCTAGGCTGATGCCACAGAATTCTAGCCTGAGGCAAAAGAATTGAGCCACTGTCTCAAAAAGGAACAAAAAAGAAAA","ATTAGCCAGGTGTGGTGGCATGCACTTGTAATCCCAGCTACTAAGAAGGCTGAGGCAGGAGGATCACTTGAACCCGGGAGGTGGAGGTTGCAGTGAGCCAAGATCATGCCACTGCACTCCAGCCTGGGCAACAGAGTAAGACTCTGTCTCAAAAAAAAAAAAAAAAAAAAA"
"GL873578","4593962","4594035","chr16","68825055","68825124","22","64231093","AGCTGGGTACAGTGGCTCACATATAATCCCAGTGACTCAGGAGGCTAAGACAGGAGGATTACTAGGACCTGAGA","GGCTGGGCACAGTGGCTCAGACCTGTAATCTCAGTACTTTGGGTGGCTGAGGCAGGTGGATCACCTGAGG"
"GL873578","6158845","6158972","chr3","500432","500562","24","5658413","GACATGGTGGCTCACACCTGTAATCCTAGCCCTCTGGGAGGCTGAGGCAGGTGGATCACTTGAGTTCAGGAATTCAAGACCAGCTTGAGTGAGAGCAAGACCCTGTCTCTACTAAAAATAGAAAAATT","GCACGGAGGCTCATACCTGTAATCCCAGCACTTTGGGAGGCTGAGGCAGGTGGATCACCTGAGGTCAGGAGTTCCAGACCAGCCTGGCCAACATGGCGAAACCCTGTCTCTACTAAAAATACAAAAAATCT"
"GL873578","6159253","6159444","chr19","34496349","34496541","55","28337096","ATAAAATAAAAATAGAAAAATTAGCCAGGCATTGTGGCAGACATGCGAAGTCTCAGCTACTCCAGAGGCTGAGACAGGAAGATTACTTGAGCCCAAGAATCTTGCTGTGAGCTAAGCTGATGCCATAGCATTGTAACCTAGGCAACAGAGTAAGACTTGGCCTCAAAAATAAAATAAAATAATAAAGTAAAA","TTAGTTAATTAAATTAAACTTAGCTAGGCATAGTGGAACACACCCATAGTCCCAGCTACTCTAGAGGCTGAGGCAGGAGGATTGCTTGAGCCAAGTTGGAGGCTGCAGTGAGCTATGGTGGTGCCACTGCATTCCAGCCTCAGTGACAGAGAGAGACCCTGGCTCAAATAATAATAATAAATAAATAAATAAA"
"GL873578","6766040","6766171","chr2","93098086","93098217","30","86332046","CCAGGCACAGTGGCTCATGCCTATAATCCTAGTAGTCTAGGAGGCTGAGGTGAGTGCATTGCTTGAGCTCAGGAGTTAGATACCAGCCTAACCAAGAATGAGACCCCATCTCTATTAAAAATAGAAAAGTTA","GCCGGGCACAGTGGCTCATGCCTGTAATCCCAGCACTTTGGGAGGCCGAGGCGGGCAAATCACGAGGTCAGGAGTTCAAGACCAGCCTGACCAATATGATGAAACCCCGTCTCTATTAAAAATACAAAAATT"
"GL873578","6766434","6766577","chr9","21128084","21128223","50","14361650","GTTAGCCAGGAGTTGTGGCGGGCACCTACAGTCCTAGCGACTCAGGAGGCTGAAGTAGGCAGAGTTTGATGTGTTGCTGTGAACTACAAGGACACCAATGCACTCTAGGCCGGTAACAGAGTGAGACACTGACTAAAAAAAAAA","TTAGCCAGGTGTGGTGGCACATGCCTGTATTTCCAGCTACTCGGGAGGCTGAGGCAGGAGAATTGCGTGAGCTGAGATCATGCCACTTCATTCCAGTCTGGGTGACAGAGTGAGACTCTGCCTCAAAAAACAAAACAAAA"
"GL873578","7397948","7398119","chr5","40230148","40230319","43","32832200","TAAAAATAGCCATGCATTGTGACAGGCACCTGTAGTCCCAGCTACTCAGGAGGTTGAGGTAAGAGAATCACTTGAACCCAAGAGTTTTGAGGTTGTTATGAGCTAAGACGCCTCGGGACTCTACAAAAGGTAACAAAGTGAGACTCTGTCTCATAAAAAAAGAAAAAAAGAA","AAAATTAGCCAGGCATGGTGACGTACACCTGTAGTCCCAGCTACTCGGGAGGCTAAGGCAAGAGAATCGCTTGAACCCAGGAGGCAGAGGTTGCAGTGAGCTTAGATCACGCTACTGCGCTCCAGCCTGGGTGACGGAGTGAGACGCCATCTCAAAAAAAAAAAAAAAAAAA"
"GL873578","7398378","7398515","chr15","102382935","102383070","35","94984557","GGTCGAGCAAGGTGGCTCACGCCTGTAATCCTAGCACTCTGTGAGGCTGAGGCAGATGGATTGCCTGAGCTCGTGGGTTCGAGACCAGCCTGAGCCAGAGTGAGACCTCATCTCTAAAAATAGCTGGGAAGCTGGGCA","GGCCAGGTGTGGTGGCTCACGCCTGTAATCCTAGCACTTTGGGAGGCTGAGGCGGGTGGATTGCCTGAACTCAGGAGGTCAAGACCAGCCTGGGCAACACAGTAAAACCCCATCTCTACTAAAATACAAAAAATCA"
"GL873579","370235","370429","chr16","38067345","38067552","57","37697110","GCACAGGCCTGAAATCCTAGCACTCTGAAAGGCCAACGGAGGAGAATTTCTGGAGCTCAGGAGTTTGATACCAGCCTAAGCAAATAAAGCTAGACCTCTATCTCTACTAAAATTAGAAAAATTAGGCAGATGTGGTGGTAGGCACCTATAGTCCCAATTACTCCAGAGGCTGAGGCAGAAAGACTCTTGAACCCA","GTCAGGCATGGTGGCTCATGCCTATAATCCTAGCACTTTGGGAGGCCAAGGCCGGTGGATCACCTGAGGTCAGGAGTTTGAGACCAGCCTGGCCAATATGGCAAAACCCCGTCTCTACTAAAAATAAAAAAATTAGCTGGGCACGGTGGTGGGCACCTATAGTCCCAGCTACTCAGGAGGCTGAGGCAGGAGAATTGCTTGAACCCAG"
"GL873579","370936","371046","chr3","3847698","3847802","33","3476762","TGACTCTTGAACCCAGGCACATGAGGTTGCTAAGAGTCTAGGCTGATGTCACGGCACTCTAACCTGGGAAACAGTGTGAGGTTCTGCCTCAATAAATAAATAAATAAATAA","TGGCTTGAACCCAGGAGGCGGAGGTTGCAGTGAGCCGAGATCACGCCACTGCACTCCAGCCTGGGCAACAGAGCGAGACTGTCTCAAAAAAAAAAAAAAAAAAAA"
"GL873579","599436","599605","chr10","38982686","38982853","41","38383250","AAAAAGTCAGACATTGTGGCAGGTGTCTGTAATCCCAGCTATTTGGGAGGCTGAGGCAGGAGTATCATTTGAACCCACGAGTCTGAGGTAACTGTGAGCTAGGCTAACACAACAGCACTCTAGCCTGGGCAATAGAATGAGACTCTATCAAGAAAAGAAATGAAAAGAAA","TATTAGCCTGACACAGTGGCGCGCATCTGTAATCCCAGCTACTTGGGAGGCTGAGGCAGGAGAATCACTTGAACCCAGGAGGCGGAGGTTGCTGTGGGCTGAGATCATGCCACTGCACTCCAGCCTGGGCAACAGAGGGAGGCTCCATCTCAAAAAAAAAAAAAAAAA"
"GL873579","599942","599953","chr3","71473700","71473710","4","70873758","TTTTAAAATAGT","TTTAAAAAAAA"
"GL873579","600232","600365","chr1","16061315","16061447","30","15461083","GGCTAGGCAAGGTGACTCATGTCTGTAATCCTAGTACTCTGGGAGGTTTGAGGCAGGAAGACCACTTTAGCTCAAGAGTTCCAGATCAGCCTGTGCAAGAGTGATACATCATCTCTACTAAAAATCAAAAATTA","GGCTGGGCATGGTGGCTCATGCCTGTAATCCTAGCACTTTGGGAGGTTGAGGCAGGCAGATCACTTGAGGTCAGGAATCTGAGACTAGCCTGGCCAACATGGTGAAACTCCATCTCTACTAAAAAAAAAAAAA"
"GL873579","5650320","5650591","chr6","54938866","54939145","71","49288546","GTCAGGTGTGTTAGCTTACAGTAGTAATCCTAGCACTTTGGGAGGTTGAAGTGGGTGGATTGCTTGAGCTCAGGGGTTCAAGACCAGCCTGAACAAGAGTGGGACCTCATCTCTATTAAAAACAGAAAAACTAGCTGGGTGTTATGGTGGGTGTCTGTAGCCCCAGCTACTCAGGAGGCTGAGGCAGGAGGTTGAGGTTGCTGTGAGCTATTGAGACCACAGCACTCTATCCAGGGCAACAGAGTGAGACCCCTCCCCCCCCCAAAAAAAAA","GGCCAGGTGTGGTGGCTCACGCCTGTAATCCCAACACTTTGGGAGGCCGAGGTGGGTGGATCACCTGAGATCAGGAGTTCAAGACCACCCTGGCCAACATGGTGAAACCCCGTCTCTACTAAAAATACGAAAATTAGCTGAGTGTGGTGGTGCATGCCTGTAGTCCCAGCTACTCAAGAGGCTGAGGCAGGAGGTGGAGGTTGCAGTGAGCCGAGATTGCATCACTGCACTCCAGCCTTGGCGACAGAACGAGAGAGACTCCATCTAAAAAAAAAAAAAA"
"GL873579","7037162","7037347","chr3","37328686","37328893","67","30291524","GAGGTGGGTGGATTGCCTGAGCTCACAGGTTGGAGACCAGCCTGAGCCAGAGCAAGACCTTATCTCAAAAAATAGCCAGGTGTTGTGGCTGGCACCTGTAGTCCCAGCTGCTCAGGAGGCGGAGGCAAGAGAAATGCTTGACCTCAGGAGTTTGAGGTTGCTGTGAGTTCAACTCACACTAATACA","GAGGCAGGGGGATCACCTGAGGTCAGGAGATCGAGACCAGCCTGGCCAACATGGTGAAAACCTGTCTCTACTAAAAATCCAAAAACATTAGCCAGGTGTGGTGGCACGCACCTGTAATCCCAGCTACTTGGGAGGCTGAGGCAGGAGAATCACTTGAACCTGGGAGGCAGAGGTTGTAGCGAGCCGAGATCACACCACTGCACCCCAG"
"GL873579","11077764","11077972","chr19","1200469","1200683","63","9877295","GCCAGGTGCAGTGGCTCATGCCTATAATCCTAGCACCCTAGGAGGCTGAGGAGTTCAAGACCAGCCTAAGCAACTGTGAGACCCCATCTCTACCAAAAATAGAAAAATTAGCTGACTGTTATGGTGTGCACCTACAGTCCTAGCTACTCAGGAGGCTGAGGCAGAAAGAGTCCTTGAACCCAGGAGGCTTTTTTTTGTTGTTGTTGTTG","GGCCAGTCGCGGTAGCTCATGCCTGTAATCCCAGCACTTTGGGAGGCCGAGGCGGGCAGATCACCTGAGACCAGCCTGGCAACATGGTGAAACCCCATGTCTACCCAAACTACAAAAATTAGCTGGGTGTGGTGGTGCACGCCTGTAATCCGAGCTACTCAGCAGGCTGAGGCAGGAGAATCCCTTGAACCTGGGAGGCAGAGGCTGCAGTGAGC"
"GL873579","11078245","11078333","chr19","4926258","4926351","22","6151987","TGAACCCAGGAGTTTGAGTTCGCTGTGAGCTAAGCTGAGGCCACAGCACTCCAGCCTGGGCAACAGAGTGAAAGGAAAAAAATAAAAAA","TGAACCCGGGAGGTGGAGGTTGCAGTGAGCCAAGATCACACCAATGCACTCCAGCCTGGGCAACAAGAGTGAAACTCTGTCTAAAAAAAAAAAA"
"GL873580","320374","320488","chr13","48549305","48549409","42","48228931","GGTAGTGCGTGCCTGCATTCCCAGCTACGGGAGGGCAGGGACTTGAGGCCAGCCTGGGCAAAATAATGAGACCTACTAATGACTCTACTAATACAGAAACAATTAGCTAGGTATG","TGGGAGGCCGAAGTGCGCAGATCACCTGAGGTCAGAAGTTGGAGACCAGCCTGGCCAACATGGTGAAAACCCATCTCTACTAAAAATACAAAAATTAGCTGGGCA"
"GL873580","374969","375091","chr6","147681010","147681135","27","147306041","CGGTGGCTCACACCTATAATCCTAGCATTTTGGAAGGCTGAAGCCGAGGATCTCTGGAAGTCAGAAGTTCAAGACCAGCCTGCCCAAGAGCAAGACCCCATCTCTACTAAAAATAGAAAAACT","GGTGGCTCACACCTGTAATCCCAGCATTTTGGGAGGCTGAGGCAGGCGGATAATCTGAGGTCAAGAATTTGAGACCAGCCTGGCCAACATGGAGAAACCCTATCTCTACTAAAAATACAAAATTAC"
"GL873580","375369","375549","chr7","19977275","19977456","44","19601906","CTAACCAAGTTAGTTAGTTTTAGTTGGCAGGTGCCTGTAGTCCCAGCTCCTTGGGAGGCTGAGGCAAGAGAATGGCTTGAGCCCAGGACTTTGAAGTTGCTGTGAGCTATAATGACACCACAGCACACTACCCAGGGTGACAGAGTGAGACTGTCTCAAAAAAACAAACAAACAAAAAAAA","AACAAACGTTAGCCGAGCATGGTGGTATGTGCCTGTAGTCCCAGCTACTTGGGAGTCTAAGGCAGGAGAATTACTTGAGCCCGGGAGGCAGAGGTTGCTGTGAGCCAAGATCACGCCACTGCACTCCAGCCTGGGTGACAGAGTGAGACTCCATCTCAAAAAAAAAAAAGGAAAAAAAAAAA"
"GL873580","8760922","8761015","chr11","104681322","104681416","19","95920400","GGAGGGAGACACTGCAGTGAACTGCGATCGTGTCTCTGCTTTCCAGGCTGGGTGACAGAGTGAGACTCGGTCTCTAAAATAAAAAATAAATAAA","GGAGACGGAGGTTGCAGTGAGCTGTGATCGCGGCACTGCACTCCAGCCTGGGCAACAGAGTGAGACTCTGTCTCAAAAATAAATAAATAAATAAA"
"GL873580","9391260","9391306","chr14","49279240","49279285","12","39887980","GCCAGTCGAGGTGGCTCACACTTGTGATTCCAGCTACTTGGAAGACT","GGCTGAGATGGTGGCACACACCTGTAATCCCAGCTACTTGGGAGGC"
"GL873581","759283","759365","chr6","46535476","46535542","30","45776193","TAAGAACCTGAAAATAGAGCCAGGCATAGTGGTACATGCGTATAGTCCTGGCTACTCAGGAGGTTGAAACAACAGGATTACTT","CAAAATAGCCAGGCTTGGTGGTGCATGCCTATAATCCAAGCTACTCGGGAAGCTGAGGCAGGAGAAT"
"GL873581","1145844","1145979","chr1","29437872","29437991","29","28292028","GGCCGGGCGTGGTGGCTCACGCCTGTAGTCCCAGCACTATGGGAGGCCGAGGCGGGTGGATCACCTGTGCTCAGAGGTTCGAGACCAGCCAAGACCCCCCTGAGCCAAATGAGCCAGAGTGAGACCCCGTCTCTAC","GGCCGGGCGTGGTGGCTCACGCCTGTAATCCCAACATTTTGGGAGGCCAAGGCGGGTGGATCACCTGAGGTCAGAAGTTCGAGACCAACCTGGCCAACATGGTGAAACCCCTGTCTCTAC"
"GL873581","9628238","9628362","chr5","141044567","141044691","34","131416329","ATCCCAGGTAGTCGGGAGGCTGAGGCAGGAGGATCACTTGAACCCAGGAGGTTGAGGTTGCTGTGAGCAAGGCAGAGGCAACGGCACTCTAGCCACGGGGGCACAGAGACTCTTGTCTTTAAAAA","TAATCTCAGCTACTCGGGAGGCTGAGGCAGGAGAATCGCTTGAGCCCAGAAGGTGGAGGTTGCAGTGAGCCAAGATCGCGCCATTGCACTCCAGCCTGGGCGACAGTGCGAGACTCTGTCTCAAA"
"GL873582","1580485","1580534","chr6","32576760","32576806","12","30996275","CAGCACTTGAGAGGCCAAGGCAGGTGGATCAACTGAGCAAGAATGAGACC","CCAGCACCTTGAGAGGCCAAGGCAGGTGGATCACCTGAGGTCAGGAG"
"GL873582","1644368","1644551","chr1","211626449","211626612","63","209982081","AAAATTTGCCGGGCTCCATAGCTCATGCATGTAATCATAGCACTCTGGGAGGCCAAGATGGGAGGATCTCTCAAGCTCTCTTACTTGGGAGGCTGAGGTTGCTGTGAGTTAGGCTTACGCCACAGCACTCTACTCTAGCGTGAGCAACTCTACTCTTAGTATGAGACTGTCTCAAAAGAAAAAA","AAATTAGCCAGGCGTCGTGGCACATGCCTGTAATCCCAGCTACTCGGGAGGCTGAGGCAGGAGAATAGCTTGATCTCGGGAGGCGGAGGTTGCAGTCAGCCGAGATCACACCACTGCAATCCAGCCTGGACAACAGAATGAGACTCCATCTCAAAAAAAACAAA"
"GL873582","5794385","5794459","chr13","18872784","18872852","27","13078399","ATATTGTTAAGCACAGCCACTATTAAAAATTAAATTATAGGCCAGGCATAGTGGCTCATGCCTGTAATCCTAGCT","TGAAACCACCATCTGGACCAAGATACAAAATGTTGGCTGGGCATGGTGGCTCACACCTGTAATCCTAGC"
"GL873583","102645","102683","chr14","5808766","5808804","14","5706121","GAGCAGATCACCTGAGCTCAGGAGTTTGAGACCAGCCTG","GAGGAATCCCTGTGCTCAGGAAGCTTACATTCTAGTGAG"
"GL873583","6200447","6200560","chr4","17786849","17786963","24","11586402","GGCCAGGAGGGACGGCTCATGCCTGTTATCCTAGCACTATGGGAGACTGAGGTGGGAGGATCACTTGAAGTTAGGAGTTCCAGACCAATCTGACCAAAGTGAGACCTCATCTCT","GGCCAGGCTTGGTGGCTCATGCCTGTAATCTTAGCACTTTGGGAGGCTGAAGTGGGTGGATCACTTGAGGTCAGGAGTTAGAACCAGTCTGGCCAACATGGTGAAACCTCAGCTC"
"GL873583","6200584","6200752","chr6","169626528","169626696","42","163425944","TTAGCTGGATGTGGTAGCACATGCCTATAGTCCCATCTACTCAGGAGGCTGAGACAAGAGAGTTGCTTAAGCCCAGGAGTTTAATTTAACTGTGAACTAGACTGAGACTGTGGCACTCTAGCTGGGGCAACAGAGTGAGACTCTGTCTCAAAAGAAAGCAAGAAAGAAA","TTAGCTGGGTATGGTGTCAGATGCCTGTAGTCCCAGCTACTCAGGAGGCTGAGACAGGAGAATCGTTTGAACCCAGGAGGCCAGAACTGCAGTGAGCTGAGATTCGCACCACTGCGCTCCAGCCTGGGCCAGACAGAGTGAGACTCTATCTCAAAAGAAAAAAAAAAAA"
"GL873583","10217398","10217583","chr3","36257142","36257313","44","26039744","TACTAAAAATAAAGTGTGATAGCCAGGCATGGTGGTGGTGCCTATAGAACCAGGCTATTCAGGAGGCTGAGGCAGAAGGATCACTTGAACCCAGGAGTCTGACGTTGCTGTGAGCTAGGCTGGTGCCATGGTACTCTAGCCTGTGGTAACAGAATGAGACTCTATCTCAAAAATAAAAATAAAAAA","TACAAAATTAGCCAGGCGTGGTGGTGCGTGCCTGTAATCCCAGCTACTTGGGAGGCCGAGGCAGAAGAATGACTTGAACCCAGGAGACAGAGGTTGCAGTGAGCCAAGATCCCACCATTGTACTCCAGCCTGGGCAACACAGTGAGACTCCATCTCAAAAAAAAAAAAAAAA"
"GL873583","10394919","10394983","chr16","12841703","12841771","22","2446784","GAGGTCAGGAAATCAAGATCAGTCTGGGCAATATATTGATACCCTGCCCCTACATAAGGAAGAAA","AGGTCAGGAGTTCAAGACCAGCCTGGCCAATATGTTGAAACCTCATCTCTACTAAAAATACAAAAATTA"
"GL873584","521512","521529","chr1","167402212","167402233","10","166880700","GCATGGAACCCCCCACTC","GGTGAAACCCCATCTTTACTAA"
"GL873584","2079725","2079768","chr15","4338291","4338335","11","2258566","GGCAGGTGGATTACCTGAGTTCAGGAGTTGGAGACCAGCCTGAC","AGGCGGATGGATCACGAGGTCGGGAGTTTGAGACCAGCCTGACCA"
"GL873584","5216877","5217053","chrX","91350057","91350230","49","86133180","CTACTGAAAATGATGACAGAGGCTGGGCATGGGGGCTCCCGCCTGTTATCCTAGCACCCTCGGAGGCTGGGGAATGAGGATTGCTTACGCCCAAGAGTTTGAGGTTGCTGTGAGCTGAGGCCGCTGCACTCTAGCCTGGGCAACAGAGTGAGACTCTGTCTCAAAAAAAAAAAAAAA","TGCAAAAATGAGCTGGGCATGGTGGCACATGCCTGTAATCCCAGCTACACAGGAGGCTGAGGCAGGAGAATCGCTTGAATCTGGGAGGCGGAGGTTGCAGTGAGCTGACATCAGGCCCCTGCACTCTAGCCTGGGCCACAGAGCAAGACTCCGTCTCAAAAAAAAAAAAAAAAA"
"GL873584","7289930","7289950","chr2","51453328","51453345","10","44163398","TGAGGCTCTGTCTCGAAATAA","AATGCCATCTATTAAAAA"
"GL873584","7289975","7290131","chr11","49739997","49740154","37","42450022","CAAGAAAATTAGCTGAGAGTCCTGGTAGGTGCCTGTAATCCCAGCTATTCATGAGGCTGAGGCAGAAGGATCACTTGGGTCCAGGAGTCTGAGGTTGCTGTGAGCTAGTCTGACGCCATAACACGCAAGCCTGGGCAACAGAGTGAGGCTCGGTTTC","CTACAAAAATTAGCTGGGCGTGGTGGCACATGCCTGTAATCCCAGCTACTCGGGAGGCTGAGGCAGGAGAATCACTTGAGCCCAGGAGGCGGAGGTTGCAGTGAGCCAAGATCATGCCATTGCACTCCAACCTGGGCAACAGAGCAAGACTCCATCTC"
"GL873584","7577743","7577867","chr5","48394329","48394446","27","40816586","GGCTGGATGAGGTGGTTCATGCCTGTAATCCTAGCACTCTGGGAGGCCAAGGTGGGTGGATTGCCTGAGCTCAGGAGTTCAAGACCAGCCTGAGCAAGACCCTGTCGCTAAAAATAGCTGGGTGT","GGCTGGGTGCAGTGGCTCATGCCTGTAATCCCAGCACTTTGGGAGGTCAAGGCGGGTGGATCACCTGAGGTCAGGAGTTCAAGACCAGCCTGGCCAACATCTCTACTAAAAATACAAA"
"GL873584","7578135","7578289","chr1","130112713","130112865","31","122534578","GGAGCTGGGTTTTGTGACTGCACCTGTAATCCCAGCTGCTCAGGAGGCTGAGGCAAGAGAATTGCTTGAGCCCAGGAGTTGGAGGTTGCTGTGAGCTGTGATGCCAGGGAACTCTACCAAGGGTGACAAAGTGAAACTCTGTCTCAAAAAAAAAA","TTAGCCAGGTGTGGTGATGCATGCCTGTAATCCCAGCTACTCATGAGGCTGAGGCAGGAGAATTGCTTGAACCTTGGAGCTGGAGGTTGCAGTGAGCTGAGATCAGACCACTCCAACCTGGGTGACAGAGCGAGACTCTGTCTCAAAAAAAAA"
"GL873585","1450952","1451121","chr10","59681079","59681242","48","58230127","TAAAAACAGAAAAAACTAGTCAGGTGGTGTGGTAGGTGCTCATAAGTCCCAGCTGCTTGGGAGACTGAGGCAAGAGAATCACTTGAGCACAAGAGCTTGAGGTGGCTGTGAGCTATAACACCATAGCACTGTACTGAGGGTGACAAAGTAAGACTCTGTCTCAAAAAAAA","TACAAAAATTAGTCAAGGGTGGTGGTATGTGCTTGTAATCCCAGCTATTTGGGAGGCTGAAGCAGGGGAATCCTTGAACCCAGGAGGTGGAGGTTGCAGCGAGCCGAGATCACGTCACTGCACTCTAGCCTGGGCGATAGGGTGAGACTCTGTCTCAAAAAAAA"
"GL873585","1451382","1451515","chr6","17405813","17405948","24","15954431","GGCCCGGCTCGGTGGCTCACACCTATAATCCTAACACTCTGGGAGGCTGAGGCAGGTGGATCACCTGAGCTCAGGAGTTTGAGACCAGCTGAGCAAAAACAAGACCCTATCTCTGCTAAAAATAGAAAAAACTA","GGCCGGGCGGGGTGGCTCACGCCTGTAATCCCAGCACTCTGGGAGGCCAAGGCAGGTGGATCACCTGAGGTCAGGAGTTTGAGACCAGCCTGGCCAACACGCAGAAACCCTATTTCTACTAAAAACACAAAAATTA"
"GL873585","1626960","1627026","chr7","17782729","17782794","22","16155769","AAGATGCCACAGCACTCTACAAGAGTGACCAAGTGAGACTCTGTCTCAAAAAAAAAAAGAAAAGGAA","CAATCGCACTACTGCACTTCAGCCTGGGTGACAGAGTGAGAACCTGTCTCAAAAAAATAAATAAAA"
"GL873585","1627304","1627531","chr11","17033552","17033788","61","15406248","GGCTGGGCACAGTGGCTCACGGCTATAATCTAGGCACTTGGGAGGCTAGGGCAGGTGGATTGCCTGAACTGACAAGTTTGAGACCAACCTGAGCAAGAGCGAGACCCCTGTCTCTAAAACATAGCCAGGCTCTGTGGTGGGCGTCTGTAGTCCCAGCTACTTGGGAGGCTGAGGCAAGAGAATTGCTTGAACTCAAGAGTCTGAGGTTGCTGTGAGTTAAGATGCCAC","GCCCGGCGCAGTGGCTCACGCCTGTAATCCCGGCACTGTGGAGGCCAAGGCAGGCGGATTGCCTAAGCTCAGGGATTCGAGAACAGCCTGGGCAACATGGTGAAACCCCATCTCTACTAAAATACAAAAAACTAGCCGGGCGTGGTGGTATGCGCCTGTAATCCCAGCTACTTGGGAAGCTGAGGCAGGAGAATTGCTTGAACCCGGGAGATGGAGGTTGCAGTGAGCTCAGATCAC"
"GL873585","3626082","3626158","chr1","100916857","100916922","27","97290775","TGCCTGTAATCCCAGCACTTGGGAGGCGGAGGTGGGTAGATTGCCTGACCCAGAGTGGGACCTCATCTCTAAAAGAA","CATGCCTGTAATCCCAGCACCTTGGGAGGCCAAGGTGGGTGGATCACCTGAGGTCAGTAGTTTGAG"
"GL873585","8849829","8849913","chr18","48581945","48582025","18","39732116","GGCTGGACGAGGGGACTCATGCCTGCAATCCCAGCACTGAGAGAGGCCAAGGCAGGTGGATCCCCTGAGCTCAGAAGTTTGAGAC","GCTGGACGCAGTGGCTCACACCTGTAATCCCAGCACTTTGGGAGGCCAAAGCAGGCAGATCTGAGGTCAGGAGTTTGAGAC"
"GL873585","9319890","9319971","chr8","79499361","79499447","14","70179471","GGCCAGGTGTGGTGGCTCACACCTGTCATCCTAGCACTCTGGGAGGACGAGGTGGGTGGACCGCCTGAGTCAGAGTGAGACC","GGCCAGGTGTGGTGGCTCACACCTGTAATCCCAACACTTTGGGAGGCCCAGGTGGGTGGATCACCTGAGGTCAGGAGTTCAAGACCA"
"GL873586","895572","895692","chr17","14501559","14501680","38","13605987","GGCCAGGTGAGGTTTCTCATTCTGGGAGTGAGCCAGCAATTGGGAGGCCAAAGTAAATGGATTGCCTGAGGTTATAGGTTCCAGAACAGCCAGAACAAGATCGAAATCCTGTCTCCAAAAA","GGCCAGGCGTGGTGGCTCATGCGTGTAATCTCAGCACTTTGGAAGGCCGAGGCAGGTGGATCACCCGAGGTCAAGAGTTCAAGACCAGCCTGACCAACATGGCGAGTCTCTGTCTCCACTAA"
"GL873586","5645995","5646150","chr6","58863249","58863409","38","53217254","GGGTATGGTGGCTCATGCCTGTAATCCAAGCACTCTGGGATGGTGAGGCAGGAGAATCCCTTGAACCCAAGAGTCCGAGGTTGCTGCGAGCTAAGCTGATGGCATAACACTCTAGCCTAGGCGACAGAGTGAGACTCTGTTTCCAAAGAGAAAAAA","TTAGCCAGGCATGGTGGCACATGCCAGTAATCCCAGCTACTCAGGAGGATGAGGCAGGAGAATCGCTTGAACCCAGGAGGCAGAGGTTGCAGTGAGCTGAGATTGCGCCACAGCACTCTACCCTGGGTGACAGAAGGAGACTCTGTCTCAAAAAAAAAAAA"
"GL873586","10258686","10258969","chr12","9481260","9481565","81","777426","GGCCGGGCATGGTGGCAGAAATCTAGGAGGCCGAGGCAGGTGGATCGCCTGAGATCACAAGTTCAAGACCAGCCTCAGCTACAGCAAGACCCCATCTCTAAAAATAGCCGGCTGTTGTGGCAGGCGCCTGTAACCCCAGCTACTCGGGAGGCTAAGGCAAGAGAATCGCTTGAGCCCATGAGTCTGAGGTTGCTGCGAGCTGTGACTCCACGGCACTCTACCCGGGGCGATAAAATGAGATTCTGTGTCAAAACAAACAAACAAACAAACAACAACAAAAACAA","GCTGGGCGCGGTGGCTCATGCCTGTAATCCCAGCACTTTGGGAGGCCAAGGCAGGTGGATCACCTGAGGTCAGGAGTTCGAGACCAGCCTAGTCCACATGGTGAAACCCCATCTCTACTAAAAACTAGCCAGGCGTGGTGGTGCGCACCTGTAATCCCAGCTACTCGAGAGGCTGAGGCAGGAGAATCACTTGAGCCTAGGAAGCAGAGGTTGTGGTGAGCTGAGATCACACCACTGCACTCCAGTCTGGGCGACACAGTGAGACTCTTGTCTCAAAAACAAAAAACAAACAAACAAACAAACAAA"
"GL873587","3208032","3208047","chr8","3626746","3626762","2","418714","AAACAACCACAAAAAA","ACAACAACAACAAAAAA"
"GL873587","3208141","3208321","chr19","2057131","2057316","59","1151010","TTTCTTTTAAAAATCACCCATGGGCTGGGTATAGTGGCTCACACCTATAATCCTCGGGAGGCCAAGGTTGGAGGATTGCTTGAATCCAGGAGTTGAAGGTTACAGTGAACTGGGATTTAGCCACTAGACTCTAGCATAGCTGACAAAGCAAGAACCTATTTGTTTAAAACACAAAAAAGAA","TACTAATAATACAAAAATGAGCCGGGTATGGTGGCGGGTGCCTGTAATCCCAGCTACTGAGGAGGCTGAGGCAGGAGACTTGCTTGAACCCAGGAGGTAAAGGTTGCAGTGAGCTGAGATTGCACCACTACACTCCAGCCTGGGCGACAAGAGCAAAACTTTTTCTCCAAAAAAAAAAAAAAAAAA"
"GL873587","3278260","3278367","chr19","19044200","19044312","39","15765940","CAGTCTGAGCAAGAGGGAGAGGCTATTTCTACTAAAAACAGAAAAACTAGCTGGGTGTTGGGGTGTGTTCCTAGTCTCAGTTACTTGGGAGGCTGAAGTAAGAGGATC","ACCAGCCTGGCCAACACGGTGAAATCCCGTCTCTACTAAAAATACAAAAATTACCTAGGCGTGATGGCACGTGCCTGTAGTCCCAGCTACTCATAAGGCAGAGGTGAGAGAAT"
"GL873587","3278673","3278754","chr7","49412503","49412597","28","46133830","GGCCACGAGAGCTAGCTCATGCCTATTCTAGGAGGCCAAAGCAGGCAGACTGCCTGAGCTCAGGAGTTCAAGAGCAGCCTGG","GGCCAGGTGCAGTGGCTCATGCCTGTAATCCGAGCACTTTGAGAGGCCGAGGCAGGCAGATCACCTGAGGTCAGGAGTTCAAGACCAGCCTAGTA"
"GL873587","3782076","3782188","chr9","112128434","112128552","34","108346358","ACTGGGGTGGCTGAGGCAGGAGCGTCACTTGAACTCAGGAGTTTGAGATTGCTGTGAGCTGAGCAGATGTCATGGCACGCTAGCCTAGGTAATAGAGTGAGACTTCGTCTAAA","CAGCTACTCGGGAGGCTGAGGCAGGAGAATCACTTGAACTCGGGAGGCGGAGGTTGCAGTGAGCCGAGATCACGCCATTGCACTCCAGCCTGGGCAACAAGAGCGAAATTCCATCTCAA"
"GL873587","4564996","4565084","chr20","27900350","27900437","14","23335354","GGCGGGGTGTAGTGGCTCATGCCTATTGTCCCAGCACTGTGGGAGGCCGAGGTGGGTGGATCACCTGTGCTCAGAAGTTTGAGACCAGC","GGCCGGGCGTGGTGGCTCATGTCTGTAATCCCAGCACTTTGGGAGGCCGAGGTGGGTGGATCACCTGAGGTCAGGAGTTCAAGACCAG"
"GL873587","6307870","6308175","chr12","112427710","112428020","54","106119840","GGCCAGATATGATGGCTCATGCTTGTAATCCTAGCACTCTGGGAGGCTGAAGTGGGAGGATCACCTGAGATCAGGAGTTCAAGATCACCCTGAGCAAAAGTGAGATCCCATCTCTATTAAAAATAAAAAAATTATCCAGGCATGGTGGTGCAGTCCTTTAGTCCCAGCTACTTGGGAGGCTGAGGCAGGAGAATCTCTTGAACCCAGGAATTAGAGGTTACAGTGAGCTGTGATGATGCTACTGCACTCTAGCAGGATGACAGAGTGAGATACTCCGTGTCAAAAAAAAAAAAAAAAAAAGCAAAA","GGCTGGACATGGTGGTTCATGCTTGTAATCCGAGCACTTTGGGAGGCCAAGGCGGGTGGATCACCTGAGGTTGGGAGTTCGAGACCAGCCTGACCAACATGATGAAACCCCATCTCTACTAAAAATACAAAAAAATTAGCCAGGCATGGTGATGCACGCCTGTAATCCCAGCTACTTGGGAGGCTGAGGCAGGAGAATCACTTGAACCCAGGAGGCAGAGGTTACAGTGAGCCGAGATCATGCCATTGCACTCCAGCCTGGATGACAGAGTGAGCCTCTGTCTCAAAAAAAAAAAAAAAAAAAAAAAAAAA"
"GL873587","6484004","6484128","chr10","67341428","67341546","29","60857424","GACCAGGTTCTGTGGCTCATGCTTGTAATCCTAGCACTCTAGGAGGCCGGAAGAGGGTGGATTGATTGCCTGAGGTCAGGAGTTAGAGACCAGCCTGAGCAAGAGCTAGACCCTGTTTCTTTCTT","GGCTGGGTGTAGTGGCTCATGCCTGTAATCCCAGCACTTTAGGAGGCCAAGGTGGATGGATTGCCTGAGCTCAGGAGTTCGAGACCACCCTGGGCAACAAGCCAAAACCCTGTCTCTAC"
"GL873587","6484407","6484586","chr3","167196537","167196723","48","160712130","TAGACCCTGTTTCTAAAAAAAAAATAGCCAGGTGTTGAGGCAGGTACCTGTAGTCCCAGCTACCTGGGAGGGCTGAGGCAAGAGAATCGCTTGAACCCAAGAGTTTGAGGTTGCTGTGAGCTGAGATGCTATGGCACTCAACCGTGAGCTACAAAGTGAGACTCTGTCTCAAAAAAAAAA","AAAACCTGTCTCTGCTAAAAATACAAAAATTAGCCGGGTGTGGTGATGTGCGCCTGTAGTCCTAGCTACTTGGGAGGCTGAGGCAGGAGAATCACTTGAATCCAGGAGGTGGAGGTTGTAGTGAGTCGAGATCGTGCGACTGCACTCCAGCCTGGGTGACAGCGAGACTCTGTCTCAAAAAAAAAAA"
"GL873587","7466229","7466364","chr1","29437872","29437991","35","21971643","GGCCAGGCGTGGTGGCTCATGCCTGTAGTCCCAGCGCTATGGGAGGCCGAGGTGGGTGGATCACCTGTGCTCAGAGGTTCGAGACCAGCCAAGACCCCCCTGAGCCAAATGAGCCAGAGTGAGATCCCATCTCTAC","GGCCGGGCGTGGTGGCTCACGCCTGTAATCCCAACATTTTGGGAGGCCAAGGCGGGTGGATCACCTGAGGTCAGAAGTTCGAGACCAACCTGGCCAACATGGTGAAACCCCTGTCTCTAC"
"GL873588","1502535","1502718","chr1","34852429","34852590","60","33349894","GGTGCAGTGGCTCACACCTGTTGTCCCAGCGCTGTGGGAGGCCGAGGTGGGTGGATCACCTGTGCTCAGAGGTCGAGACCAGCTGAAGACCTGCCTGAGGCAGAGTGAGCCAGAGTGAGACCCCGTCTCTACTAGAACAACAACAAGACAGCCAGACCTTGTGATCCCAGCTACATGGGGGGCT","GCCAGGTGCAGTGGCTCACACCTGTAATCCCAGCACTTTGGGAGGCCGAGGCGGGCGGATCACCTGAGGTCAGGAGTTTGAGACCAGCTTGACCAACATGGAGAAACCCCGTCTCTACTAAAAATACAAAATTAGCCTGGTGTGGTGTCGCATGCCTGTAAT"
"GL873588","10189037","10189246","chr3","45604681","45604903","65","35415644","GCTGAGATGAGGAGACTCTGTCTCTATTAAAAATAGAAAAATTGGGTGGATGTTGTGGGTACTGTAGTTGCAGCCTCTTGGGGGGCTAAGGCAGGAGGATCAGTTGAAGCCAGGAATTTGCTTTGAGCTAGGCTAAAGCCATGGCACTCTAGCCTGGGCAACAGAGTGAGGCTAGATCTCAAAAAAAGAAAGAAAAGAAAAAGAAAAAAA","CTGGCCAACATGGCAAAACCCCATCTCTACTAAATATACAAAAATTAGCTGGACGTGGTGGCACATACCTGTAATCCCAGCTACTTGGAAGGCTGAGGCAGGAGAATAGCTTGAACCTGGGAGGCAGAGGTTGCAATGAGCTGAGATCACGCCACTGCACTCTAGCCTGGGCAATAGAATGAGACTCTGTCTCAAAAAAAAAAAAAAAAAAAAAGACAAGAAA"
"GL873589","104719","104807","chr20","27900350","27900437","13","27795631","GGCTGGGCGTGGTGGCTCATGCCTGTTGTCCCAGCGCTGTGGGAGGCTGAGGTGGGTGGATCACCTGTGCTCAGAGGTTCGAGACCAGC","GGCCGGGCGTGGTGGCTCATGTCTGTAATCCCAGCACTTTGGGAGGCCGAGGTGGGTGGATCACCTGAGGTCAGGAGTTCAAGACCAG"
"GL873589","796766","796905","chr1","166346372","166346487","49","165549606","GGCTAAGTGTGGTGGCTCACACCTGTCATCTAGTACTTTGGGAGGGTGGGCCTGGGAGTTCAAAGACTGAACTCAGGAGTTCAAGGTGGCTCCGGGGAGGAATTCAAGACCAACCTGAGCCAGAGCGAGACCTCGACTCT","GGCCAGTGGGGTGGCTCACGCCTGTAATCCCAGCACTTTGGGAGGCTGAGGTGGTCAAATGACCTGAGGTCAGGAGTTTGAGACCAACCTGGCCAACATGGTGACACCTCGTCTCT"
"GL873589","1023679","1023690","chr1","205890061","205890072","1","204866382","AAAAAAAAAAAA","ACAAAAAAAAAA"
"GL873589","1023771","1024047","chr4","103012712","103012993","70","101988941","GGCTTGGTGGCTCACACCTGTAATCCTAGCACTCTGGGAGGCCGAAGTGGCTGGAATACTTGAGGTCAGGAGTTCAAGACCAGCCTAAGTGAGAGTGAGATCCCCATCTCTAATAAAAATAGAAAAATTAGCAGGGTGTTGTGGCTGGCACTTGTAGTCCCAGCTACCCAGGAGACCGAGGCAGAAGTTTGAGATTATTGTGAGCGAGGCTGATGCCACAGCATTCTAGTGGGACAACAGAGCAAAATTCTATCTCAAAAGAAAAAAAAAAAAAGGA","CGGGCGTGATGGCTCACGCCTGTAATCCCAACACTTTGGGAAGCCGAGGCGGACGTATCACCTGAGGTCAGGAGTTCAAGACCAGCCTGGCCAACATGGTGAAACCCCGTCTCTACTAAAAATACAAAAATTAGCTGGGTGTGGTGGCATGCGCCTGTAATCCCAGCTACCCAGGAGGCTGAGGCAGGAGAATCGCTGAGGCTGCAGTGAACTGAAATTGTGCCACTGCACTCCAGCCTGGGTGACAGAGCAAGACTCTGTCTCAAAAAAAAAAAAAAAAAA"
"GL873589","4820958","4821024","chr8","33633747","33633811","15","28812789","TTAGTCAAGTGCAGTGGCTCACACCTGTCATCCCAGCTACTTGGGAGGCTGAGGCAGGAGAGTTGCT","TTAGCCAGGTGTGGTGGTGCATGCCTCTAATCCCAGCTACTCAGGAGGCTGAGGCAGGAGAATTG"
"GL873589","6763768","6763857","chrX","25814002","25814092","29","19050234","GGTGTGGTGGCTCACACTTGTATCTTAGCATTTTAGGAGGCTGAATGGGGAGAATTGCTTTAAGTCAGGAGTCTGACTTCCACCTTGCCA","GGCTGGGAATGGTGGCTCACACCTGTAATCCCAGCACTTTGGGAGGCTGAGGTGGGCAGATCACCTGAGGTCAGGAGTTTGAGATCAGCCT"
"GL873589","8444551","8444632","chr9","93194085","93194171","17","84749534","CGGGCATGGTGGCTCACAACTATAATCTTAGCACTTTGGGAGGCTGAGACAGGTGGATGCCTGAACTCAAGAGTTTGAAACC","GGCCGAGCATGGTGGCTCACACCTGTAATCCCAGCACTTTGGGAGGCTGAGGCAGGTGGATTACCTGAGGTCAAGAGTTCAAGACCA"
"GL873589","9085365","9085494","chr2","194063347","194063481","42","184977982","GGCCAGGCACAGTGGCTCACACCTATAATCCCAGCACTCTGTGAGACTGAGGCAGGTGAACTGTTGCAAGAGTGAGACCCTGTGCTTGGTGCCTGTAGCTCAGTGGTTAATAATAAGAAAAAAGAAAAAA","GGCCAGGTGCAGTGGCTCACACCTGTAATCCCAGCACTTTGGGAGTCTGAACCAGGCAGATCACCTGAGGTCAGGAGTTCGAGGCCAGCTCGGCCACCATGGTGAAACCCTGTTTCTAATAAGAATACAAAAAAA"
"GL873589","9085767","9086002","chr7","84631446","84631650","75","75545679","GAGTGAAACCCTGTCTCTACTAAAAATAGAAAAACTAGCTGTGCATCAGGGCGCATAACTGTAGTCCCAGGTACTCAGGACACTGAGGCAAGAGAATTGCTCAAGCCCAAGAGTTTGCAAGAATTTGAGGTTGCTATGAGCTATGATGCCATGGCACTCTACCTAGGGTGACAGACAGAGACTCTGTCCCAAAAAAAAAAAAAGAAGAAGAAGAAAAAAAAAAAGAAAGAAAGAAA","ATAGTGAAACCTCGTCTCTACTAAAAATACAAAAATTAGCTGGGCATCATGGTGCACGCTTGTAATTCCAGCTACTTGGGAGGCTGAGGCAGGAGAATTGCTTGAACTCAGGAGGTGGAGGTTGCAATGAGCCAAGATCGCGCCACTGCACACCAGCCTGGGTGACAAAAGACTCTGTCTCAAAAAAAAAAAAAAAAAAAAAAAA"
"GL873589","9992904","9993045","chr16","56427538","56427666","46","46434634","AACCAGCCAGGCATGGTGATTCACACCTATAATCCCAGCTACTTAGGAGTATGGCTTGAGCACACAGGATACCATACCATTCTAGTCATCCCAGGCAACAGAGGGAAACTCTGTTGGTTAAAAAAAAAGAAAAACTTAAAAA","TTAGCCAGGAGTGGTGGTGCACGCCTATAATCCCAGCTACTTGGGAGGCTGAGGCACAAGAATCACTTGAACCATTGCACTCCAGCCAGGGTGATAGAGGGAGACTCTATCCAAAAAAAAAACAAAAAA"
"GL873589","9993319","9993452","chr3","2774534","2774668","28","7218785","GGCCTGAGCCCTGTGACTCATGCCTGTAATCCCAGCACTGGAAGTTCCAAGGCAGGTGGATCGCTTGAGCTCTGGAGTTCAAGACCAGCTCAACCAAGAGTAAGACCCCATCTCTACTAAAAATAGAAAAACCA","GGCTGGGCACGGTGGCTCATGCCTGTAATCCCAGCACTTTGAGAGGCCGAGGCAGGTGGATCTCCTGAGGTCAGGAGTTCAAGACCAGCCTGGGCAACATGGTGAAACCCCATCTCTACTAAAAATACAAAAAAT"
"GL873590","9044589","9044884","chr1","83754525","83754835","84","74709936","GGCCAGGTGCAATGGCTCATGCCTATAATCCTCACACTCTGGGAGGCTGAGGCAGGAGGATCACTTTTCTCAGGGTCAGGGCCAGCCTGACAAAAGTCAGACCCTGTTTCTACTAAAAATAGAAAAACTAGCTGGGTGTTGTGGCAGATGCCTATAGTCCCAGCTACTAAGAGACTGAGACAAGTGCCCAGAGTCTGAGGTTACTGTGAGCAAAGCTGATGCCATAGCATTCTAGCTATAGATCGAGAGTCTGTCTCAAAAACAAACAAACAAACAAACAAACAAACAAAAAAGAA","GGCTGGGTGTGGTGGCTCATGCCTGTAATCCCAGCACTTTGGGAGGCCGAGGCGGGTGGATCATCTGAGGTCAGGAGTTCAAGACCAGCCTGACCAACATGGTGTAACCCTGTCTCAACTAAAAATACAAAAATTAGCTGGGCGTGGTGGTGTGCACCTATAGTCACAGCTACTTGGGAGGCTGAGACAGGAGAATTGCTTCAACCCAGGAAGTGGAGGTTGCAGTGAGCCAAGATCATGTCACTGCACTGCAGCCTGACAGAGCGAGACTCCATCTAAAACAAACAAACAAAAACAAACAAACAAACAAA"
"GL873591","1831505","1831587","chr17","61702818","61702899","25","59871313","CCCAGCACTTTGGGAGGGCAAGATGGGAGAATCATATAAAGTCAGGAGTTTGAGACCAGTTTGGCAGACATGATGAACCCATC","AATCCCAGCACTTTGGGAGGCTGAGGCAGGCGGATCATCTGAGGTCAGGAGTTCAAGACCAGCCTGGCCAACATGGTGAAAC"
"GL873591","2719175","2719275","chr4","86137755","86137847","32","83418580","GTGGGGGCTTAGGCCTGTAATCCCAGCACTCTGAGAGGCCAAGGTGAGCTGGTCACCTGGGTTTAGGAGTTTGGAGACTTGCTCGAGCTAGACTGAGGCTC","GTGGTGGCTCACGCCTGTAACCCTAACAATTTGGGAGGCCAAGGCAGGTGGATCACTTGAGGTCAGAAGTTTGAGACCAGCCTGGACAATATG"
"GL873591","4732974","4733120","chr19","7991801","7991954","55","3258827","ATACGCAGACTGGCCGAGCGTGGTGTCACATGCCTATAATCCCAGTGGCTACTCTGGGGAGGAGAATCTCTTGAAACCAAGAGTTAGAGATTGCAGTGGGGTATGATACAGGGTAACAAAGAGAGACCTTGGATCTGAAAAGAAAAA","AAAATACAGAAACTAGCTGGGCATGGTGATGCACACCTGTAATCCTAGCTACTGGGGAGGCTGAGGCAGGAGAATTGCTTGAACCCAGGAGTCAGAGGTTGCAGTGAGCAACCAGCCTGGGTGATACAGTGAGTGAGACTCTGTCTCGAAAAAA"
"GL873591","6822728","6823009","chr1","20579766","20580052","72","13757038","GGCCAGGCGTGGTGGCTCATGCCTGTAAATCTCAGCACTCTGGGAAGCTGAGGCAGGTGGATTGCTTGAGGTCAGGAGTTTGAGACCAGCCTGTACCAGAGTAAGACCCTGTCTCTAATAAAAATAGAAAAAAAAAAAAAAACTAGTTGGGCATGGTGATGGGTGCCTGTAGTCCCACCTACTTGGGAGGCTGAGGCAATGGCATCTCTTGAGCCCAAGAGTTTGAGGTTGCTGTGCCATGGCACTCTCCCCAGGGTAACAGAGTGAAAATAAAAAAAAGAA","GGCCAGGCGTGGTGACTCATGCCTGTAATCTCAGCACTTTGGGAGGCCGAGGCAGGTGAATCACCTGAGGTCAGGAGTTTGAGACCAGCCTGACCAACATGGTGAAACCTCGTCTCTACTAAAAATACAAAAAGTAGCCAGGCATGGTGGCGCATGCCTGTAATCCCAGCTACTTGGGAGGCTGAGGCAGGAGAATCGCTTGAACCCGAGAGGCAGAGGTTGCATTGAGTCAAGATGGTACCACTGCACTCCAGCCTGGGTGACAGATTGAGACTCAAAAAAAAAAA"
"GL873591","7578706","7578813","chr16","45055441","45055543","42","37476735","AAATTTAGCTACACATAGTGGCATGAGTCTGTAATGCTAGCCACCCAAAAGGCTGTAGTAAGAGGATTGCTCTATCCCAGGAGTTAAAGACCAGCCCGGACATCAGAG","AATTAGCCGGGCGTGGTGACACACACTTGTAATCCTAGATACTCAGGAGGCGAAGGTAGGAGAATTGCTTGAACCCAGGCAGCAGAGGTTGCAACGAGCAGAG"
"GL873591","9282916","9283004","chr1","20744253","20744338","16","11461337","GGCCAGGCGCGGTGGCTCACCCCTGTTGTCCCAGTTCTGTGGGAGGCCGAGGTGGGTGGATCACCTGTGCTCAGAGGTTTGAGACCAGC","GGCCAGGCACGGTGGCCACGCCTGTAATCCCAGCACTTTGGGAGGCCGAAGTGGGTGGATTACCTGAGGTCAAGAGTTTGAGACCA"
"GL873592","835155","835315","chr16","75654291","75654451","43","74819136","CTGGGTGTGGTGGCTCTTGTCTGCAATCTCAGTACACTGGGAGGCTGAGGCAGAAGGATTGCTCCAGCTCAGGAGTTTGAGGCCAGGCTGAGCTAGTGCAAAACCCCATCTCTACTAAAAAAAGAAGGAAAAAAAAAAGAAAAAGAAAAAAAATACGAGCT","CCAGGTGTGGTGACTCACGCCTGCAATCCCAGCACTCTGGGAGGCTGAGGTGGGTAGATTACCGGAGGTTAGGCGTTTGAGACCAGCCTGGCCAACATGGTGAAACCCCATCGCTACTAAAAAAAAAAAAAAAAAAAAAAAAAAAAAAAAAAAAAAAATTA"
"GL873592","835589","835765","chr1","66836166","66836336","48","66000577","ACAAAAAACCTAGCTTAGGGTTGTTATAGCACCTGTAGTCCCAGCTACTCAGGCGCTAAGGCAGGAAAATCTGCCTGAGCTCAGGAGTTTGAGGTTGCAGTAAGTTATGATGATGCTACTGCACTCTAGCTGGGGCAACAGAGTGAGACTCTGTCTGAGGAAAAACCAAAACCAAAA","TAGCCCAGCACGGTGGCTCACACCTGTAGTCTCAGCTACTCAAGAGGCTGAGGCATGAGAATCGCTTGAACCCAGGAGGTAGAGGTTGCAGTGAGCTGAGATCATGCCACTGCGCTCCAGCCTGGGCAACAGAGTGAGACTCAGTCTCAAAAAACAAAACAAAACAAAAAA"
"GL873592","2520661","2520705","chr16","66853217","66853257","11","64332556","TCTGGGAGGCTGAGGCGGGTGGATCACCTGAGCAAGAGTGAGACC","TTTGGGAGGCTGAGGCAGGTGGATCACTTGAGGTCAGGAGT"
"GL873592","4535248","4535388","chr1","12240468","12240612","38","7705220","GGCGGGATGTGGTGGTTCATGGCTGTAATCCCAGCACTCAGGGAGGCTGAGTCGGGTGGATTGCTTGAGTTCAGGAGTTTGAGACCAACCTGAGCAAGAACTAAGCCTGTCTCTACTAAAGATATTATTTCTTATTTTTCT","GGCCGGGCGCGGTGGCTCATGCCTGTAATCCCAGCACTTTGGGAGGCTGAGGCGGGTGGATCACCTGCGGTCAGGAGTTCGAGACCAGCCTGGCCAACGTGGTGAAACCTCATCTCTACTAAAAATATAAAAATTAGCTGGTGTG"
"GL873592","4535654","4535831","chr8","126054004","126054184","54","121518350","TCTACTACAAATATTAACAGAAAAATTAGCTGGGCATTGTGACAGGTGCCTATAGTCCCAGATACTCAGAAGGCTGAAGTAAGAGGATCACTTGAACCCCAGGAGCTAAGGTGGCTGTGAGCTAGGCTGAGGCTCTAGCCTGGGTAACAGAGTGAGACTGTAAAAAAAGAAAGAGAGA","GTCTCTACTAAAAATACAAAAATTAGCTGGGTGTGGTGGTGCATGCCTGTAATCCCAGCTACTCAGGAGGCTGAGGCAGGAGAATCGCTTGAACCCAGGAGGTAGAGGTTGCAGTGAGCCAAGATCATGCCACTGCACTCCAGCCTGGGTGACAGAGGGAGACTCTGTCTCAATAAATAAA"
"GL873592","6794968","6795049","chr3","154764711","154764794","20","147969743","GAAGGTTTGATGAGCTCAGATGATGCCACTGCAGTCTACCCAGAGTGAAGGAGCGAGACTCTGTCTCAAAAACAAAAAAAGA","CAGAGGTTGGCAGTGAGCTGAGACTGTGCCACTGCACTCCAGCCGGGTGACAGAGTGAGACTCTGTCTCAAATTACAAACAAAA"
"GL873592","6881384","6881478","chr5","24882384","24882475","28","18001000","GGGCAGGCATAGTGACTGGTGTCTCTAATCCTAGCAGTCTGGGATGCTGAGGCAAGTGGAATGTCAGAGTTCAGGAGTTGAAGATCACCCTGACT","GGCCGGGCGCAGTGGCTCACATCTATAATCCTAGCATTTTGGGAGGCTGAGGCAGGCGGATCACCTGAAGTCAGGAGTTTAAGACCAGCCTG"
"GL873592","6881755","6881937","chr10","61601371","61601572","66","54719616","TCACCCTGACCAAGAGCAAGACCCTGTCTCTACTAAAAATAGAATAAACTAGCTGGGAATTGTGGTGGGTGCCAGTAGTCCCCGCTACTGAGGCAGGAGGATCATTGAGTCCAAGAGTTTGAGGTTGCTGTAAGTTAGGACACCACAGCACTCTACACAGAGTAAGACTGCCTCAAAAATAAA","AGTAAAGAAAAGAAACCCTGTCTCTACTAAAAATACAAAAATTAGCTGGGTGTGGTGGTGCGCACCTGTAGTCCCAGCTACTTGGGAGGGTGAGGTATGGGAATCACTTGAACCCGGGAGGTGGAGGTTGCAGTGAGCCAAGATCACACCACTGCACTCCAGCCTGGGTGAGAGAGTGAGACTCTGTCTCAAGAAAAAAGAA"
"GL873592","7006080","7006155","chr1","8947061","8947129","24","1940981","CACACTGAGAGGCAAAGGCTGGTGGATCACCTGAGCTCAAGAGTTTGAGACCAGCCAAGCCAGAGATCTTGTCTCT","CACTTTGGAGCCAGGTAGGTGATCACCTGAGTCAGGAGTTCGAGACAGCCTGGCCAACATGTGAAACCC"
"GL873592","8446508","8446655","chr11","122502739","122502874","48","114056231","TTAGCTGGGTGTTGTGGCAGGCACCTGTAGTCCCTCCCAGCTACTTGAAAGGCTGAGGCAAGATGACAGCTTAAACCCAAGAGTTTAAGGTTACTCTATTCAGGGCAACAGAGTGAGACTCCATCTACATAAATAAATAAATAAATAA","GGCTGGGCGTGGTGGTTCACACCTGTAATCCCAACACTTTGGGAGGCTGAGGCCAGCGGATTGCCTGAGCCCAGGAGTTTGAGACCAACCTGGGCAACATGGTGAAACTCCATCTCTACTAAAATACAAAAAGTTA"
"GL873592","8446953","8447008","chr16","44513352","44513404","15","36066399","GACCAGCCTAAGCAAAAAAGAGATCCTATCTCTACTACTAAAAATAGAAAAAATTA","ACCAGCCTCACCAATATGAAGAAACCCCATCTCTACTAAAAATACAAAATATT"
"GL873592","8447239","8447325","chr1","8062863","8062957","21","384376","GGCCAGGAGCAGTGACTCATGCCTAGCACTCTGGGAGGCCAAAGCAGGTGGATCAACTGAGCTCAGGAGTTCAAGACCAGCCTAAGC","GGCCGGGTGCAGTGGCTCATGCCTGTAGTCCCAGGACTTTGGCAGGCCAAGGCCGGTGGATTACCTGAGGTCAGGAGTTCAAAACCAGCCTAGCC"
"GL873592","8723925","8724000","chr3","42066983","42067054","20","33343058","AATTAGCCGGGCATGGTAGTGTGTGCCCATAATCTCAGCTACTCAGAAAGCTAAGATAGGAAAATTGCTTGAGCTC","TTAGCTGGGTGTGGTAGTGCATGCCTATAATCCCAGCTACTCGGGAGGCTGAGGTGGGAGAACTGCTTGAAC"
"GL873593","384022","384146","chr15","102382935","102383070","28","101998913","GGCCACGAGGGCCCATGCCTGTAATCCTAGCACTCTGGGAGGCTGAGGTGAGTAGATTGCTGAGCTCAGGAGTTCAAGACCAGCCTGTGCAAGAGACCCCATCTCTGCTAAAAATAGAAAAACCA","GGCCAGGTGTGGTGGCTCACGCCTGTAATCCTAGCACTTTGGGAGGCTGAGGCGGGTGGATTGCCTGAACTCAGGAGGTCAAGACCAGCCTGGGCAACACAGTAAAACCCCATCTCTACTAAAATACAAAAAATCA"
"GL873593","384425","384607","chr20","28286874","28287058","50","27902449","GAAAGAAAAGAAAAGAAAAACTAGCAAGATGTTGTAGCTGATGCCTATAATCCTAGCTATTGGAGAGGTGGAGGCAAGAGAATTGCGTGAGCCCAAGAGTTGAAGGTTGCTGTGAGCTGCGATGCCAGAGCACTCCAGGGTGACAGAGTAAGACTCTGTCTCAAAAAAAATTACAAAATAAAA","TAATAAAAATAAAAAAATTAGCCAGGAGTCAAAGCACACGCCTATAACCCCAGCTACTTGGGAGGCTGAGGGAGGAGAATTACTTGAACCCGGGAGGTGAAAGTTGCAATGAGCTGAGATCAAGCCACTGCACTCCAGACTGGATGACAGAGTGAGACTCTGTTTCAAAAAAAAAAAAAAGACAA"
"GL873593","1408445","1408467","chr10","88070368","88070389","9","86661923","AATCTAGAGATGGGGAGAGGTTG","AAAGAGATGGAAGAGAAGAAGA"
"GL873593","4856365","4856484","chr7","56497314","56497433","31","51640949","GCAATCCCAGCTGATCGGGAGGCTGACCCAGAAGAATCCCTTGAACCCAAGAGTCTGAGGTTGCTATGGGTGGATTCTACAGCACTCTAGCCTGGGAGACAGAGTGAGACTCTGTCCCAA","ATCCCAGCTACTTGGGAGGCTGAGACAGAAGAATTGCTTGAACCCGGGAGGTGGAGGTTGCAGTGAGCCAAGATTGTACCACTGCACTCCAGCCTGGCAACAGAGTGAGACTCTGTCTCA"
"GL873593","6661298","6661485","chr10","86749316","86749514","55","80088018","GCAGAGGCTCACATATGTAATCCTAGCACTCTGGGAGGATAAGGCAGGTGGACAGCTTGAGCTCAGGGGTTTGACCAGTCTGATCAAGAGCAAGACCTGTGTCTACTAAAAATAGAAAACCTAGCCAGGTATGATGGTAGATGCCTGTATTCCTAGCTACTCTGGAAGCTAAAGCTAAAGAGTTTGAA","GGTGGCTCACACCTGTAATCTTAGCAATTTGGGAGGCCGAGGTGGGTGGATCACTTGAGGTCAGGAGTTTGAGACCAGACTGGCCAACATGGTGAAACTCTGTCTCTACTAAAAATACAAAAATTAGCCAGTCATGGTGGTGCATGCCTGTAATCCCAGCTACTCAGGAAGCTTAGGCAGGAGAATCACTTGAACCCAG"
"GL873593","6710263","6710446","chr14","4390080","4390244","66","2320183","TTGAAGTCAGGAGTTTAAGGCCAGTCTGGGCAACATAGTGAGACCCCCATCTCTACGAAAATATTTTTTAAAAATTAAAAATAGCTGGGCATAGTGAGGCTGTTGTGAGCTATAACTGCACCACTGCACTCAGCCAAGGACAGAGACCCTGTTCCCTGCCTCAAACAAACCAAAACAAAACAAA","AAGTCTAGAGTTTACAGCCTGGACAACGCAGTGAAACCCTGTCTCTACCAAAAATACAAAAATTAGACAGGTGTGAGAGGCGGAGGTTGCAATGAGCTGAGATCGCAGCACTGCAGTCCAGCCTGGATGACAGAGCGAGACCCCATCTCAAAAACAAAAACAAAA"
"GL873593","7159645","7159716","chr6","178318394","178318465","21","171158749","GATCATGTCACTGCTCTCCAACCTGGGCAATTGAGCAGGAATCTGTCTCAAAAAGAAAAAAAAAAAAGAAAA","CGAGTTCACACCACTGCACCCCAGCCTGGGCAACAGAATGAGACTCGGTTTCAAAAAAAAAAAAAAAAAAAA"
"GL873593","7159841","7160050","chr13","33368171","33368368","69","26208330","GGCCAGGCGTGGTGGCTCACACCTGTTGTCCCAGTGCTGTGGGAAGCCGAGGCAGGTGGATCACCTGAGCTCAGCCGAGTTCGAGACCAGTGGAAGACCAGCATGAGGCAGAGTGAGCCAGAGTGAGACCCCATCTCTACAACAACAACAAGAAGAAAAAAAACAGCCGGACCTTGTGATCCCAGCTACGTGGGGAGCTAGAGAATCACT","GGCTAGGCATGGTGGCTCATGCCAGTAATCCCACCACTTTGGGAGGCCGAGGCAGGTGGATCACCTGAGGTCAGGAGTTCAAGACCAGGCTGGCCAACATGTTATGATGAGACCCTCATCTCTACTACAAATACAAAAATCAGCTGGGCATGGTGGCAAGTGCCTGTAATCCCAGCTACTTGGGAGGCTGAGGCAGAA"
"GL873593","8598292","8598391","chr11","118461023","118461129","33","109862731","AGCCAGGTGAGGTGGTTCACACCTGTAACCCTAGCTGCTTGGGAGGCTGAGGCCTCTCTATCCTGGGCAGTGTGGAGAAACTTTGTTTCAAAAAAAAGAA","GCCGGGCGCGGTGGCTCACGTCTGTAATCCCAGCGCTTTGGGAAGCCGAGGCGGGACTATCCTGGCCAACATGGTGAAACCCCGTCTCTACTAAAAATACAAGAATC"
"GL873594","357249","357377","chr2","75702890","75703011","36","75345641","CCTGGTACCGTAGGTCATGCCTGTAATCCTAGCACTTTGGGATGCTGAGGTGGGCAGATTGCCTGAGCTCACGAGTTCAAGCCATTAGAACTGAGCCTGACCTAGAGTGGGACCTCCAACTCTTTTTTT","GCCAGGCACAGTGGCTCATGCCTGTAATCCCAGCAGTTTGGGAGGCTGAGGTGGGCAGATCACTTGAGGTCAGGAGTTCAAGACCAGCCTGGCTGACATGGTGAAACCCCATCTATACCAAA"
"GL873594","357656","357834","chr7","17608776","17608965","55","17251120","GGGACCTCCAACTCTTAAAATAGCTGGGCATTGTGGTGGGCACCTACAGTCACAGCTACTTGGGAGGCTAAGGCAAGAGACTTGTTTGCAGCCAAGAGTTAGAGGTTGCTGTGAGCTATGAGGCTAGGGCACTCTACAGGGGGCGACAAGTGAGACTGTAAAAAAAAAAAAAGAAAAAA","GTCCCTACTAAAAATACAAAAAATTAGCTGGGCCTGGTGGCAGGCACCTGTAATCCCAGCTACTTGGGAAGCTGAGGCAAGAGAATTGCTTGAACCCAGGAGGCAGAGGTTGCAGTGAGCTGACATCAAGCCACTGTACTCCAGCCTAGGCAACAAGAGCAAGACTCTGTCTCAAAAAAAAAAAAAAAAA"
"GL873594","1410711","1410996","chr5","151340503","151340797","76","149929792","CACAGTGGCTCATACCTATAATCCTAACACTCTGGGAGGCCAAGGTGGGTGGACTGTCTGAGTTTGGGACCAGCCTGAGCAAAAGCAAGACTCCCATCTCTACTAAAAACAAAGACAGCCAGGTATGAGGGCAGGTGCCTATCATCCCAGCTACTTGGGAGGCTGAGGAAGGAGGATCACCTAAGCCCAGGACTTTAAGGTTTCTGTGAACTAAGATGATGTTACAACACTCTAGCCAGGGTAACAAGGCAAGATTCTGTTTCAAAAGACAAAAAAAAAAAAAAAA","GGTGGTTCATGCCTGTAATCCCAGCACTTTGGGAGGCTGAGGCAGGTGGATCACCTGAGGTCAGGAGTTCGGGACCAGCCTGGCCAACATGGGGAAACCCCATCTCTACTAAAATACAAAAATTAGCCAGGTATGGTGGCACATGCCTATAATCCCAGCTACTTGGGAGGCTGAGGCAGGAGAATCACTTGAACCCAGGAGGCTAAGGTTGCAGTGAGCCGAGATTGTGCCACTGTACTCCAGCCTGGGTGACAGACTGAAACTCTGTGTCCAAAAAACAAAACAAAACAAAAAA"
"GL873594","5528090","5528162","chr2","69013639","69013718","24","63485549","GGTACAGTGGCTCACGCTTGTGATCCCAGGTTGAGGTGGGTGGATCGCCTGAGCTCAGGAGTTGGATGCCAGC","GGTGTGGTGCCTCACGCCTATAATCCCAGCACTTTGGGAGGCAGGTGGATCACTTGAGGTCAGGAGTTTGAGAACAGCCT"
"GL873594","5834047","5834168","chr2","82491537","82491662","28","76657490","GGCTGGGCCCAGTAGCTCACGACTGTAATCCCAGCACTCTGGGAAGCTGAGGTGGGCGGATCACCTGAGCTCATAGGTTCGAGACCAGCTCCAGTTAGAGTGAGAGCCTGTCTCTAAAAATA","GGCTGGGCACAGTGGCTCATGCCTGCAATCCCAGCACTTTGGGAGGCTGAGGTGGGCAGATCACCTGAAGTCAGGAGTTCAAGACCAGCCTGGCCAACACAGTGAAACCCCATCTCTACTAAAAAT"
"GL873594","5834396","5834461","chr13","14688151","14688212","20","8853755","TATATAATAATAATAACCAGGTATTGTGGCAGGTGCCTCTAGTCCCAGCTACTCGGGAGGCAAAGG","ATAAAAAAATTAGCTGGCCATGGTGGCACATACCAATAATCCCAGCTACTCAGGAGGCTGAG"
"GL873594","7786130","7786294","chr14","12217087","12217250","37","4430957","GGGTGTGCTGGCTCATACCTATAATCCTAGCACTCTGGGAGGCTGAGGTAGGTGTATTGCTTGAACCCAGGAGTCTGAGGTTGCTGTGCGCTAAGCTGATACCATAGCACTCTAGCCTGGGCAACAGAGTGAGACTCTGTCTCAAAACAAATAAATAGTAAAAAA","GCTGGGCGTGGTGGCTCACACCTGTAATCCCAGCACTTTGGGAGGCCAAGGCATGAGAATTGCTTGAAAACAGGAGGCGGAGGTTGCAGTAAGCTGAGACTGTGCCATTGCACTCCAGCCTGGGCAACAAGAGTGAAACTCTGTCTCAGAAAAAAAGAAAAAAA"
"GL873595","723579","723774","chr19","6045933","6046125","65","5322354","GCCTGAGCAGGAGAGAGACCCCATCTCTGCTGAAAGTGGAAAAGTTGGCTGAGTGTAGTGGCGGGCTGCTGCCCCAGTCACTCAGGAGGCTTAGGAAGGAGTATCGCTTGGGCCCAAGATTTGAGGTTGCTGTGAGCGCTACAAAGACATTAGGGTACTCTACACAGGGGAATAGAGTGAGACTGTCTCAAAAAAA","CAACATGGAGAAACCCCGTCTCTACTAAAAATACAAAATTAGGCAGCGTGGTGGTGGGTGCCTATAATCCCAGCTACTCAGGAGGCTGAGGCAGGAGAATCGCTTGACCGGGAGTGGAGGTTGCGGTGAGCTGAGATTGCACCATTGCACTCCAGCCTGGGCAACAAGAGTGAAACTCCGTCTCAAAAAGAAA"
"GL873595","724114","724204","chr20","18199749","18199840","22","17475635","GGCCATGCTTGGTGGTTCTCATCTGTAATCCTAGCACTCTGGAAGGTCTACAGGGGTGGATGGCTGGAGGTCAGGAGTTCAAGACTGGCCT","GGCCGGGCATGGTGGCTCACACCTGTAATCCCAGCACTTTGGGAGGCTGAGGCAGGCGGATCACCTGAGGTCAGGAGTTCGAGACCGGCCTG"
"GL873595","1065346","1065667","chr18","10529729","10530057","74","9464383","GGCCAGGTGCAGCAGCTCATGCCTGGAATCTTCCTGCTCTGTATGGCCAAGGCAGGTGGATCGCCTGACCTCAGGAGTTCCAGACCAGCCTGAACAAGAGCAAGACTCTGTCTCTACTAAAAGTAGAAAAAAAACTAGCCAGTCATAGTGGCAGGTGCCTGTAGTCCCAGCTGCTTGGGAGGCTGAGGCAAGAGGATCACTTGAACCTAAGAGTTTGAGGTTGCTGTGAGCTAAGATGCCACATCACTCTATCAAGGGTGACCAAGTGAGACTCTGTCTCAAAAATAAATAAATAAATAAATAAAAAGAAAGGCAAAAAGAA","GGCCCGGCGTGGTGGCTCATGCCTATAATCCCAGCCCTTTGGGAGGCCAAGGCAGGTGGATCACCTGAGGTCAGGCGTTCGAGACCAGCCTGACCAACGTGGTGAAACCTCATCTCTACTAAATACAAAAAAAATTTAGCCAGGCATGGAGGCACATGCCTGTAATCCCAGCTACTTGGGAGGCTGTGGCAGGAGAATCACTTGAACCTGGGAGGTGGAAGTTGCAGTGAGCTGAGATTGTACCACTGCACTCCAACCTGGGTGACAAAGCAAGACTCGGTCTCAATAAATAAATAAATAAATAAATAAATAAATAAAGTGAAAAAAAA"
"GL873595","1254878","1255146","chr4","42822326","42822607","67","41567448","GGCTGGGCATGGTGGCTCATGCCTGTAATCCTACCGCTCTGGGAGGCTGAGGCAGAGGATCACTTGAGCTCAGGAGTTTCAGACCAGCCTGCAAGAAGGACCCAGTCTCTGCCGAAAATAGAAAAGTTAGCAAGGCGTTGTCGTGAGCACATGTATCCCAGCTACCTAGAACTCTGAGGCAGGAGGATCCCTTGAACCCACAGAAGTTGCTGTTATCTAAACTGATGCCACTGGACTCTAGCCTGGGCAACAGAGTGAGACTGGTCTCA","GGCCGGGCACGGTGGCTCATGCCTGTAATCCTAGCATTTTGGGAGGCTGAGACAGGCAGATTGCCTGAGCTCAGGAGTTCAAGACCAGCCTGGGCTAGATTGTGAAACCCCATCTCTACTAAAATATAAAAATTAGCTGGGTGTGGTGGCACACGCCTGTAATCCCAGCTACCTGGGAGGCTGAGGCAGGAGAATCGCTTGAACCAGGAGACAGAGGTTGCAGTGAGCTGAGATCACGCCACTGCACTTTAGCCTGGGCAACAGAGTGATACTCTGTCTCAA"
"GL873595","3417105","3417297","chr12","115674238","115674427","44","112257133","GGCCGGGCGCTGTGCCTCACGCCTGTAATCCTAATACTCTGAGAGGCCGAGGCAGGTGGATTGCCTGAGCTCAGGTGCTCAAGACAGCCTGACTGAGCAAGCCCTGAGATCCCATCTCCACTAACAATAGTAAAACTAGCCGGGCATTGTGGTGGTGCTTGTAATCCCAGCTACTGGGAGGCTAAGACAGGAG","CCAGGCCTGGTGGCTCACGCCTGTAATCCCAGCACTTTGGGAGGCCGAGGTGGGTAGATCACCTGAGGTCAGGAGTTCAAGACCAGCCTGGCCAACATGGCGAAACCCCATCTCTACTAAAAATACAAAAATTAGCTGGGCATGGTGGTGTATGCCTGTAATCCCAGCTACTCGGGAGGCTGAGGCAGGA"
"GL873595","6098380","6098457","chr3","87492619","87492702","21","81394239","GCTGTGGCTCATGCTGATAATACCAGCACTCTGGGAGAACAAGGTAGGCAGATCACAAGAGGTCACCTGTGCAAGACC","GGGCTGGTGGTGGCTCATGCCTGTAATACCAGCACTTTGGGAGGCCAAGACAGGTGGATCACCAAAGGTCAAGAGTTCAAGACC"
"GL873596","134190","134307","chr1","203207333","203207443","31","203073143","GGCTGGGCGAGGTGGCTCACACCTGTAATCCTAGCACTCTGGAAGGCCCTAGCACTCAGGCAGTTGGATTGCCTGAGCTCACAAGTTCAAGACCAGCCTGAAAAAGAGCAAGACCTCA","GGCTGGGTGCAGTGGCTCACACCTGTAATCCCAGCACTTTGGGAGGCCGAGATGGGTGGATCACTTGAGGTCAAGAGTTGAAGACCAGCCTGGACAACATGATGAGACCCC"
"GL873596","134578","134681","chr11","50235285","50235387","37","50100707","CAAACAAAAGAGGAAGACCTCGTCTCTAAAAAAATAGCTGGGCATTGTGAGGAGTACCTGTAGTCCTAGCTACTCAGAAGGCTGAGACAAGAGAATCACTTAAA","CAACATTGTGAAACCCTGTCTCTACTAAAATAGAAAATTAGCCAGGTGTGTGGGCGTGCCTATAATCCTAGCTACTGGGGAGGGTGAGGCATGAGAATCGCCT"
"GL873596","8160215","8160350","chr1","29437872","29437991","30","21277657","GGCCGGGCGTGGTGGCGCACACCTGTAGTCCCAGCGCTATGGGAGGCCGAGGCGGGTGGATCACCTGAGCTCAGAGGTTCGAGACCAGCCAAGACCCCCCTGAGCCAAACGAGCCAGAGTGAGACCCCGTCTCTAC","GGCCGGGCGTGGTGGCTCACGCCTGTAATCCCAACATTTTGGGAGGCCAAGGCGGGTGGATCACCTGAGGTCAGAAGTTCGAGACCAACCTGGCCAACATGGTGAAACCCCTGTCTCTAC"
"GL873596","8421071","8421132","chr20","1874027","1874093","12","6547044","GTCAGGCGCAGTGGCTCACGCCTGTAATCTCAGCACTCTGAGAAGCCAAGGCAGGATCATCT","GGCCAGGCGCAGTGGCTCAGGCCTGTAATCCCAGCACTTTGGGAAGCCAAGGTGAGCAGATCACCTG"
"GL873598","4416400","4416489","chr5","39418145","39418231","15","35001745","GGCCAAGTGTGGTGGCTCATGCCTGTTGTCCCAGCACCGTGGGAGGCCGAGGCTGGTGGAACACCTGAGCTCAGCTGAGTTTGAGACCAG","GGCCAGTTGCGGTGGCTCATGCCTGTAATCCCAGCACTTTGGCAGGCTGAGGCAGGTGGATCACCTGAGGTCAGGAGTTTGAGACCA"
"GL873598","4416855","4416947","chr3","94091253","94091337","31","89674398","GTGAGACCCTGTCTCTACAAAAAAAAAAGCTGGGCACTGTGGCATGTGCCTGTAATCCCAGCTACTTGGGAGGCAAAGGGAAAGAGAATCACT","AAACCTTGCCTTTACTAGAAATACAAAAATTAGCTGGGCATGGTGGCAGGTACCTGTAATCCCAGCTACTTGGGAGGCTGAGGCA"
"GL873598","5126074","5126161","chr1","12339306","12339394","19","7213232","GCCTGGTGCACTGGTTCACACCTGGAATCCTTGCATTCTGAGAGGCCCAGGTAGGCAGATCACCTCAGCTCAGAAGTTCGAGACCAGC","GCTGGGTGCGGTGGTTCACGTCTGTAATCCCAGCACTTTGGGAGGCCGAGGCGGGCAGATCACCTGAGGTCAGGAGTTCGAGACCAGCC"
"GL873598","5467584","5467662","chr1","9313328","9313403","17","3845744","GCGAGGTGGCTCACGCCTGTAATCCCAGCACATTTGGAAGGCCAAGGAGGGTGGATCACCCGAGCTCACCAGTTGGAGA","CGCAGTGGCTCACGCCTGTAATCCCAGCACTTTGGGAGGCCGAGGCAGGCAGATCACCTGAAGTCAGGAGTTTGAG"
"GL873598","6917752","6917856","chr14","9558287","9558382","22","2640535","GGCCAGGCATGGTGGCTTGTGCCTGTTGTCCCAGCACTGTGGAAGGCCGAGGCGGGTGGATCGCCTGAGCTCAGCTGAATTCGAGACCAGCATAAGACCAGTATG","GGCCAGGCATGGTGGCTTATGCCTGTAATCCCAGCACCTTGGAAGGCCGAAGCGGGCAGATCACCTGAGCTCAGGAGTTTGAGACCAGCCTGTCCA"
"GL873598","8078910","8079062","chr7","164825511","164825660","43","156746601","AACAGCCAGGCATTGTGGTGGGCACCTGTAATCCCAGCTACTTGGGAGGCTGAGGCAAGAGAATTGCTTGAGCCCAACAGTCTCAGGTTACTGTGAGTTATGACACCATGGCACTCTATTGAGGGCAAGAAAGTGAGACTGTCTTGGAAAAAA","CTAGCCAGGCATGGTGGTGCGCACCTGTAGTCCCAGTTACTTGGGAGGTTGAGGCAAGAGAATTGCTTGAGCCTGGAAGGCAGAAGTTGCAGTGAGCTGAGATCACACCACTGCATTCCAGCCTGGGCGAAAGAGCAAGACTCTGTTGAA"
"GL873598","8079328","8079454","chr6","10381248","10381379","32","2301920","GCCCGGCGTGGTGGCTCACGCCTGTAATTCCAGCACTCTGGGGAGGCCGAGGAGGGCAGATTGCCTGAGCTCACAGGTTTGAGCTAGAGCGAGACCCTGTCTCTTAAAAAGAAAAAAAAGGAAAGAA","GCTGGGCGCGGTGGCTCACGCCTGTAATCCCAACACTTTGGGAGGCCGAGGCGGGCAGATCACCAGAGGTGATCTCCAGCCTGGGCAGGAGAGCAAGACCCTGTCTCAAAAAATTTAGAAAAAGGAAAGAAA"
"GL873599","3943256","3943456","chr9","35892110","35892312","79","31948854","GGCAGGCTGCTTTGACCCATATCTACAACTCCAGAACTTTAGAGGCTGAGCTGGGTGGGTCCCTTGAGATTAGAAACTGCTTAGTAGCCTGGCAAAAACCAGACCCCACCTCCACCATGTAGAAAAATTAGCAGTATGCCATAGTGGGAACCTACCAATACAGTCTTTCCAAAGGCCAAAGCTAGAAGGACCGTGAGCTTG","GGCTGGGTGTGGTGGCTCATGCCTATAATTCCAGCACTTTGGGAGGCCGAGGCAGGTGGATCACCTGAGGCCAGGAGTTTGAGACCAGCCTGGCCAATATGGTGAAACCCCATCTCTACTAAAAGTACAGAAAATTAGTCAGTCATGATGGCGCATGCCTATAATCCCAGTTACTCGGGAGGCTAAGGTAGGAGAATTGCTTG"
"GL873599","6693284","6693349","chr1","100916857","100916922","15","94223573","TCACGTCTATAATCCTAGCACTCTGGGAGTCCTTGGCAGGTGGATCACCTGAGCTCAGGAGTTTGA","CATGCCTGTAATCCCAGCACCTTGGGAGGCCAAGGTGGGTGGATCACCTGAGGTCAGTAGTTTGAG"
"GL873600","991618","991705","chr15","13850109","13850195","15","12858491","GGCTGGGCGTGGTGGCTCACACCTGTTGTCCCAGCGCTGTGGGAGGCTGAGGCAGGTGGATCACCTGTGCTCAGAGGTTGAGACCAGC","GCCGGGCGCTGTGGCTCACACTTGTAATCCCAGCACTTTGGGAGGCTGAGGCAGGTGGATCACCTGAGGTCAGGAGTTAGAGACCAG"
"GL873600","8825981","8826014","chr16","43605817","43605844","11","34779836","AGTCTGGGGCAACAGAGCAAGACTCTGTCTCAAA","CAGTCTGGGTGACAGAGCAAGATTCCAT"
"GL873600","8826039","8826157","chr13","87428402","87428520","35","78602363","ATTAGCCTGGTGTGGTGGTATATGCCTTCCTGCCTGCTTGGGAGGCTGAGGCAGGAAGTATGCTTTAACTGTGGAGTCTGAGGTTGCTATGAGCTAGGTTGAGGCCATGGCACTCTAAA","TTAGCCGGGTGTGGTGGTGCACGCCTGTAATCCCAGCTACTCAGGAGGCTGAAGCAGGAGAGTTGCTTGAACCCAGGAGTTGGAGGTTGCAGTGAGCTGAGATCACGCCATTGCACTCC"
"GL873601","269289","269338","chr14","49279240","49279285","14","49009951","GACTGGGTGTGGTGGCTCACACCTTTAATCCTAACACCCTGGGAGGCTTA","GGCTGAGATGGTGGCACACACCTGTAATCCCAGCTACTTGGGAGGC"
"GL873601","269431","269678","chr1","184453273","184453521","76","184183842","AGAAGATCACTCAAGATCAGGAGTTTGAGAACAGCCTGAGCAAGACCCCCATCTTTACTAAAAATGGAAAAGTTTTTACCCAGGCATGGTAGTGCGTGCCTGTATCCCATCTACTCCGGAGGCTGATAGGAGGATTGCTTCAACCAAGGAGTTTGAGGTTCCAGAGACTTAAGATGACACAACTGCATTTTACCCAGTGTGACACAGCGAGACTCTTTCAGAAGAATTTTTAAAAGGAAAAAAAAGAA","GGTCAGATCACCTGAGGTCAGGAGTTTGAGACCAGCCTGACCAACATGGTAAAACCCCATCTCTGCTAAAAATACAAAAAATTAGCCAGGCATGGTGGTGAACGCCTGTAATCCTAGCTACTCAGGAGGCAAAGACAGGAGAATCGCTTGAATCTGGAAGGTGGAGGTTGCAATGAGCCAAGATGACGCCACTGCACTCCAACCTGGGTGACAGAGGAAGACTCCATCAAAAAAAAAAAAAAAAAAAAA"
"GL873601","1397978","1398117","chr16","24839455","24839591","34","23441477","GCCTATAATCCTAGCACTCTGGAAGGCTGAGGCAGGAAGATCACTAGAGCTTGGGAGTTTGAGATTGCTGTGAGGGAGACTGACTCCATGGCACTCTAGCCTGAGGCAACAGAGTAAGACTCCATCTCAAAAAAAAAAAA","CTCTAACTCCAGCTACTCAGGAGGCTGAAGCAGGAAAATCACTTGAACCTGGGAGGTGGAGGTTACAGTGAGCCAAGATCACACCATTGCACTCCAGCCTGAGCGACAGAGCGAGACTCTGTCTCAAAATAAATAAA"
"GL873601","4065502","4065590","chr11","108711352","108711444","19","104645850","GCTGGATGTGGTGGCTCTCACCTATAATCCTAGCACTCTGGGAGGTCAAAACAGGTGGATCACCTGAGCTCAGGAGCAAGAACACCAGC","GTCAGGGGTGGTGGCTCACGCCTGTAATCCCAGCACTTTGGGAGGCCAAGGCAGGTGGATCGCCTGAGCTCAGGAGTTCAAGACCAGCCTTGC"
"GL873601","8241370","8241465","chrY","9469734","9469829","34","1228364","AAAAAAGGTGGAGATGAGCCATGCGCAGTGGTGTAGGCCTGTAATCCCAGCCCTTGGGAGGCCAAAATGGTGGATTGCCTGAAGCAGAGCAAGACC","AAAGTACAAAGAGTCTGGGTACAGTGGCCCAAGCCTGTAATCCCAGCAGTTTGGGAGGACAAGATGGGTAGATCACCTGACATCATGAATTAGAGA"
"GL873569","7519122","7519191","chrX","79016364","79016431","16","71497242","TTGGCCAGGCATGGTCGCTCAGGCTGTAATACCAGCTACTTGGGAAGCTGAAGCAGGAGGATCACTTGAA","TTGGCCAGGCACGGTGGCTCATGCTTATAATCCCAGCTACTCGTGAGGCTGAGGCAGGGGAATCGCTT"
"GL873569","7989158","7989286","chr8","41505677","41505810","35","33516519","AGTCCCACCTATTTGGAAGGCTGAGGCAAGAGGATCACTTGAACTCAGCAGTTTGACATTGCTATGAGTTAGATTGACTCCATGGCACTCTAGCCCAGGCAACAGAGCAAGACTCCGTCTCAAAACAAA","TAATACCAGCTACGTGGGAGGCTGAGGCAGGAGAATCACTTGAACCCGGGAGGTGGAGGTTGCAGTGAGCTGAGATTGCACCGTTGCACTCTAACCTGGGCAACAAAAGCAAAACTCTGTCTCAAAAAAAAAAA"
"GL873569","7989575","7989702","chr1","62231025","62231129","47","54241450","GGCTGGGTAATGCAGTGGCTCACGCCTATAATCCTAGTGCTTTGAGAGGCCAAGAGTGAGACTCTGTGTACTAAAAATAGAAAAATTACCTAGGCATTCTGGTGGGCACCAGTAGTCCCACCTATTTG","GGCTGGGCATGGTGGCTCACGCCTATAATCCCAGCACTTTGGGAGGCCGAGGCAGGTGGATCACCTGAGATCAGGAGTTTGAGACCAGACTGGCCAACATGGTGA"
"GL873569","10034363","10034556","chr10","61268396","61268605","62","51234033","CAGCTTGAGCAAAAGTGAGCCCCTGTCTCTACTGAAAATAGAAAAAATTAGCCAGGCGTGGTGGCACACACTTATAGTCCCAGCCACTTAGGAGGCTGAGGCAGGAGTTTGAGGTTGACATAATCTAAGCTGATACCATAGCACTCTAGCCTGGGCAATAGAGTGAGACTCTGTCTCAAAGAAGAAATTTATCT","CCTGACCAATGGTGAAACCCTGTCTCTACCAAAAATACAAAATTTAGCTGGGCATGGGGGCACGCACCTGTAGTCCTAGCTACTCGGGAGGCTGAGACAGGAGAACTGCTTGAACTCGGGAGGCAGAGGTTGCAGTGAGCTGAGATCATGCCACTGCACTCTAGCCTGGGCAATAGAGTGAGACTCCGTCTCAAAAAAAAAAAAAAAAAA"
"GL873569","10034830","10034845","chr1","217667782","217667796","2","207632952","AAAAAAGAAGAAAAAA","AAGAAAAAGAAAAAA"
"GL873569","10203815","10203922","chr8","96374555","96374671","35","86170740","GCCAGGTGTAGTGGTTCACACCTATAATCCTAGCACTCTGGGAGCCTGAAGCAGGTAAATGGACTGAGCAAGAGTGAGACTTCCACCTCTATTGAAAATAGAAAAATT","GGCTAGGTATGGTGGCTGATGCCTATAATCCCAGAATTTTGGGAGGCCGAGGCAGGCAGATCATCTGAGGTCAGGAGTTTGAGACCAGTCCCGTCTCTACTAAAAATACAAAAATTA"
"GL873569","10204196","10204373","chr20","1304385","1304559","47","8899811","GAAAATAGAAAAATTAGCCAGGCATTATAGCAGGCACCAGTAATCCCAGTTACTTGGGAGGCTAAGGCAAAAGAATCTCTTGAGCCCAAGTTTGGGGTTGCTAGGAAGTAAAACACCACAGCACTATACCCAGAACAAGAGAGTGAAGACTCAGTCTCAAAAAGATAAATAAATAAAA","AAAAATACAAAAATTAGCCAGGCATGGTGGCGGGCGTCTGTAACTCCAGCTACTTGGGAGACTGAGGCAGGAGAATCGCTTGAACCCAGGAGGCAGAGGTTACAGGTGAAATCACACCACTGCACTCCAGCCTGGGCAACAGGGCAAGACTCTGTCTCAAAAAAAAAAAAAAAAA"
"GL873569","10473375","10473444","chr8","20660648","20660717","21","10187273","TGTAGTCCCAGCACTTTGGGAGGTTAAGGCAAGAGTAGCACCCAACATGAGGAGATCAAGACCAATCTGG","CTGTAGTCCCAGCACTTTGGGAGGCTGAGGCAGGTGGATCCTTTGAGGGCAGAACTTTAAGACCAGCCTG"
"GL873570","9287350","9287485","chr1","29437872","29437991","30","20150522","GGCCGGGCGTGGTGGCGCACGCCTGTAGTCCCAGCGCTATGGGAGGCCGAGGCGGGTGGATCACCTGTGCTCAGAGGTTCGAGACCAGCCAAGACCCCCCTGAGCCAAACGAGCCAGAGTGAGACCCCGTCTCTAC","GGCCGGGCGTGGTGGCTCACGCCTGTAATCCCAACATTTTGGGAGGCCAAGGCGGGTGGATCACCTGAGGTCAGAAGTTCGAGACCAACCTGGCCAACATGGTGAAACCCCTGTCTCTAC"
"GL873571","3669989","3670207","chr4","116777080","116777297","60","113107091","AGACCAGCCTGAGGAAGAGCAAGATCCCATCTCTATTAAAAATAGAAAAATTAGCCAGGCATTCTGGTGGGCACCTGTAGTTCTAACCACCTGGGAGGCTAAGGCAAGAGGAACTCTTCAACCCAAGAGTTTGAGGTTGCTGAGAGCTAGGCTAAGGCTGCAGCACTCTAGCCTGGGCAACAGAGTGAGACTGTTTCTCAAAAACAAAAAACAAAAAAA","CGAGACCAGCCTGGTCAATATGGTGAAACCCCGTCCCTACTAAAAATACAAAAATTAGCCAGGCATGGTGGCAGGCACCTGTAGTCCCAGCTACTCGGAAGGCTGAGGCAGGAGAATCGCTTGAACCACAGAGGCAGAGGTTGCAGTGAGCCGAGACTGCACCACTGCACTCCAGCCTGGGCGACAGAGTGAGACTCAGTCTCAAAAAAAAAAAAAAA"
"GL873571","106134","106236","chr4","18143723","18143826","27","18037589","GGCCAGTCTCAGTGGCTCACACCTGTAATCCAGCATTCTGGGAGGCTGAAGCACACGGTCACCTGAGCTCAAAGGTTGGAGACCAGAGTGAGACCCCACCTCT","GGCCAGGCGCAGTGGCTCACTCCTGTAATCCCAGCACTTTGAGGCTGAGGCAGGCGGATCACCTGAGGTCAGGAGTTTGAGACCAGCCTGGCCGAAACCCCATC"
"GL873571","3670496","3670589","chr7","50468399","50468491","15","46797903","GGGCAGGCATGGTGGCTCACACCTGTAATTCTAGCACTCTTGGAGGCTGAGGCAGGAAAATGGCTTGAGGTCAGGAGTTCAAGACCAGCCTGAG","GGCCAGTCATGGTTGCTCACACCTGTAATACCAGCACTTTGGGAGGCCGAGGCAGGCGAATCACCTGAAGTCAGGAGTTCAAGACCAGCCTGG"
"GL873571","4059090","4059389","chr7","52903696","52903994","88","48844606","GGCCAGGTGCAGTGGTTCACACTTATAATCCTAGCACTCTGGGAGGCCGAGGCGAGTGAAGTGCCTGAGCTCATGGGTTCAAGACCAACCTAAGCCAGAGACCCCTGACTCTTATAATAGCCTGGCATTGTGGTGGGCGCCAATATTTCCAGCTACTCTGAGGCTAAGGCAAGAGAATTGCTTGAGCCCAGGAGTTGGAGGTTTCTGTGAGCACTGACGCCGCAGCTCTCTACCAAGGGCAACAAAGACTCTGTCTCAAAAAATAAATAAATAAATAAATAACAGAATGAAAATGAAAAA","GGCCGGGTGCGGTGGTTCACGCCTGTAATCCCACCACTTTGGGAGGCTGAGGCAGGCAGGTCACCTGAGGTCAGGAGTTCCAGACCAGCCTGGCCAACATGGTGAAACCTTGTCTCGGCTATTAGCCTGGCATGGTGGTGCGTGCCCATAATCCCAGCTACTCAGGAGGCTGAGGCAGGAGAATCGCTTGAACCCAGAAGGTGGAGGTTGCAGTGAGCCAAGATAGCACCACTGCAACTCCAGTCTGGGCAACAGAATGAGACTCTGTCTCAAAAAAAAAAAACAAAAAACAAAAAGAA"
"GL873571","4209418","4209704","chr11","32517699","32517985","80","28308281","GGCTTGGCAAGGTGGCTTACACCTCAAATCCTAGCACTGTGGGAGACTGAGGCAGGTGGATTGTTTGAGCTCAGGAGGTCAAGATAGAGAGCAAGAGCAAGTCTCTGTCTCTACTAAAAATAGAAAAGAACTACTTCCCGGGGGTCATGGCAGTAGCCTGTAATCCCAGTTACTAGGTAGAATGAGGCAAGAGGATCTGTTGAAGCCAAGAGACTGAGGTTGTTATGAGCATGCCACAGCACTCTACCCAGGGTGACAGAATGAGACTCTGTTGAAAGAAAAAAAGA","GGCCGGGTGCAGTGGCTCACACCTGTAATCCCAGCACTTTGGGAGGCTGAGGCGGGTGGATCACCTGAGGTCAGGAGTTCAAGACCAGCCTGACAAACATAGTGAAACCCTGTCTCTACTGAAAATACAAAATTAGCCAGGTGTGGTGGCGCATGCCTGTAATCCCAGCTACTCGGGAGGCTGAGGCAGGAGAATTGCTTGAATCCAGGAGGTGGAGGTTGTGTGATCACACCACTGCACTCCAGCCTGGGCGACAGAGTGAGACTCTGTCTCAAAAAAAAAAGAAA"
"GL873571","4209985","4210154","chr3","175781758","175781928","60","171571773","GAAAGAAATGAAAAGAAAGAAGTTAGCTGGTTGTTGGGGTATGCTTCTATAGTCCCACCTACTCAGAAAGCTGAAATCTGGAGTTTGGGGTTGTTGTAAGGTAGGCTGATGACATAGCACTGTAGCTTGGGCAAGAGAGTGTGACTTTGTCTCAAAAAAAATTAAAACAA","ATTAAAAACACAAAGATTAGCCAGGTGTGATGGCACACAACTGTAATCCCAACTACTCAGGAGAATCGCTTGAACCTGGGAGATAGGGTTTGCAGTGAGCCAAGATTGTGCCACTGCACTCCAGCCTGGGTGACAGAGTGAGACTCTGTCTCCAAAAAAAAAAAAAAAAAA"
"GL873571","4210444","4210570","chr17","16655655","16655789","35","12445211","GCCAGGCAGATGGCTCACACTTCATCCTAGCCCTCTGGAAGGCTGAGGCAGGCTAATTTTTTGAGGTTAGGAGTTTGAGACCAGCCTGAGGAAGAGACCCATCTCTACTTTAAAAAATAAATGGAAA","GCCAGGCATGGTGGCTCACACCTGTAATCCTAGCACTTTGGGAGACTGAGGCGGGTGAATCACCTGAGGTCAGGAGTTTGAGACCAGCCTGACCAGTATGGTGAAACCCAGTCTCTACTAAAAATACAGAAATTA"
"GL873571","4391733","4391878","chr11","33723808","33723943","46","29332075","AACTTAGCTGGGAATGGTGGCTCAAGCCTGTAATCCTAGCACTCTGGGAGGCTCAGGTGGGAGGATCACTTGAGGTTGCTGTGAGCTTGGCTGATGCCAGGACACTCTAGTGTGGGCAAGAGAGTGAGACTCCGCCTCAACAACAA","GCCGGGTGCAGTGGCTCATACCTGTAATCCCAGCACTTTGGGAGGCTGAGGTAGGCGGATCACGAGGTCAGGAGCTGAGATGGCGCCACTGCACCCCAGCCTGGGTGACAGAGCAAGACTCTGTCTCAAAAAAAAA"
"GL873571","6307773","6307841","chr9","62429628","62429694","22","56121855","CTGGGTGTGGTGGCATTGCACCTGTAATCCTAGCTACTTGGAAATCTTAAGCCCAGGAGTTGAAGACTG","CCCAGCATGGTGGTGCATACCTATAATCTCAGCTACTTGGAGGCTTGAGCTCAGAAGTTTGAGACCG"
"GL873571","6496217","6496306","chr1","27257765","27257856","27","20761548","GCAGGGTGTGTTGACCCACACCCACAATTCCAGGACTCTGGGGGGCCAGGGATGGTGGGTTCCCTCAGATCAGGAGCTCCTTACCAGCCT","GACTGGGCATGATGGCTCAAATCTGTAATTCCAGCACTTTGGGAGGCCGAGGTGGGTGGATTGCCTGAGATCAGGAGTTCAAGACCAGCCTG"
"GL873571","6499738","6499903","chr1","38976375","38976555","47","32476637","AAAATAACATGAATTGACTAGGCGAGGTGGCTCACATCTCTAATCCTAGCACTCTGGGAGGCTGAGGCAGGAGAATTGCATGAGGTTGCTGTGAGCTATGATGATACCACGGCATTCTAATCAGGGTGACAGAGTGAGATTCTGTCTTAAAACAAACAAACAAAAA","AAAATAAATAAATTAGCAGGGCCTGGTGGCGCACACCTGTAATCCCAGCTACTTGGGAAGCTGAGGCAGGAGAACCCACTTGAACCTGGGAGCCGGAGGTTGCAGTGAGCTGAGATGGCACCACTGCACTCCAGACTGCGTGACAGAGTGAGACTCCGTCTCAAAAACAAACAAACAAAAA"
"GL873571","11399575","11399872","chr15","109458692","109458994","79","98059117","CAGTGGCTCACACCTGTAAATCTAACACTCTGGGAGGCCAAGGTGGGTGGATCCCTTGAGCTCAGGAATTTGATACCAGCCTGAGCAAGAGTGAGACCTTGTCTCTACTAATAATAGAAAAATAGCCCGTGTTGTGGCACTTGTCCCAACCACTGGGGAGGCTTTAGGCGGGAGGATTACTTGAATTGGGAGTTTGATATTGCTGTGAGCTGGGCTGATGCCTTGGCATTCTAGCTTGGGTAACAGCGTAAGACTCCGTCTCAAATAAATAAATAAATAAATAAAAAGAAAAAAAGAA","GTGGCTCACACCTGTAATCTCAGCACTTTGGGAGACCGAGGCAGGTGGATCACCTGAGGTCGGGAGTTTGAGACCAGCCTGACCAACGTGGAGAAACCCCGTCTCTACTAACAATACAAAATCAGCTGGGCGTGGTGGTGCATGCTTGTAATCCCAGCTACTCGGGAGGCTGAGGTAGGAGAATCGCTTGAACCTGGGAGGTGGAGGTTGCGGTGAGCCGAGATCGAGCCACTGCACTCCAGCCTGGGTGACAGAGCAAGACTCCATCTCAAAAAAAAAAAAAAAAAAAAAAAAAAAAAAAAA"
"GL873572","114760","114841","chr8","26280134","26280211","16","26165374","GGCCAGGCATGGCGGCTCTTCCCTGTAATCCTAGCACTCTGGGAGGGCGAGGCAGGCAGATCACCTAGGCTAGGGTGAGATC","GGCCAGGAATGGTGGCTCATGCCTGTAATCCCAGCACTTTGGGAGGCTGAGGCAGGCAGATCACCTGAGGTCAGGAGT"
"GL873572","9421791","9421892","chr11","8089184","8089269","35","1332607","TACTAAATATATAGCAAGGCCAGGCACAGTGGTTCATGGCTGTAATCCCAGTACTCTGGGAGGCCTAGTCAGAGTTGACCTGAGATCAGGCTAGAAGCCTGG","ATAAAAATAATTGGAGGCCAGGCACGGTGGCTCATGCTTGTAATTCTAGCAATTTGGGAGGCTGACGCGGGTGAGATCATACTGAG"
"GL873572","11052834","11053035","chr14","11857478","11857657","65","804644","TCCACAAAGAAAGCAGAAGTGTGGCCGGGTGGTAGCTCAAGGCAGGAATCCCAGCACTCTGGGAGCTGGGAGGTGGGGGAGGATCCCTTGAGATCAGGAGTTGGAGGGCACAGTGAGCCTGGGGGAGGCCACTGTCTCTGTACTCTAGCAGGGAGACAGAGCAAGACTGCCCATTCAAAGAAAAACAACAAACAAAACAAAA","TACAAAAATTAGCTGGGCACGGTGCCACAAGCCTGTAATCCCAGCTACTCGGGAGGCTGGGCAGGGGAATAGCTTGAACCCAGAGGTGGAGGTTGCAGTGAGCCAAGATCAAGCCACAGCACTCCAGCCTGGGTGACAGAGCAAGACTCCATCTCAAAAAAAAAAAAAAAAAAAAAAAAA"
"GL873573","2564195","2564244","chr1","109985445","109985491","12","107421250","TACAAAAATTAGGCTGGGCTTGGTGGTTCACGCCTATAATCCTAGCACTT","ACTAAAATTAGCTGGGCATGGTGGTGCATGCCTGTAATTCCAGCTAC"
"GL873573","7423371","7423533","chr2","202783328","202783513","56","195359957","GGTGGCTCACACCTGTAATCCCAGCACTCTGGGAGCCCTGGTGGCTCATGTCTATAATCCTAGTACTCTGGGAGACCATGGTGGCTCATGTCTATAATCCTAGTACTCTGGGAGCCATGGTGGCTCACGCCTATAATCCTAGTACTCTGGGAGACCATGGTGG","GGCTGAGGCGCGGGGGCTCACGCCTGTAATCCCAGCACTGTGGGAGGCCGAGGCGGGTGGATCACGCCTGTAATCCCAGCACTGTGGGAGGCCAAGGCGGGTGGATCACGCCTGTAATCCCAGCACTGTGGGAGGCCGAGGCGGGTGGATCACGCCTGTAATCCCAGCACTGTGGGAGGCTGAGGC"
"GL873573","9657648","9657710","chr19","10207852","10207913","10","550204","TAAAAATAAAAAATTTAGCTGGATGTGGTGGCTCACACCTGTAATCCTAGCACTCTGGGAGAC","TAAAAATACAAAATTAGCTGGGTGTGGTGGCACACACCTGTAATCCCAGCTACTCAAGAGGC"
"GL873574","1624662","1624783","chr9","814961","815079","36","809701","GACTGGGTGGGTTGGATCATGCCTGGAATCCTAGCACCCTGGGAGGCCAAGGTGAAAGGATTGCTTGAGGTTAGGAGTTCCAGAAATGTAGCAGTCATGGTGACTTCATCCTTCTCTACCAA","GGCTGGGTGCTTTGATTCATGCCTGTAATCCCAGCACTCTGGGAGGCCGAGGCAGGTGGATCACCTGAGGTTAGGAGTTCGAGACCAGCTTGGCTAACATGGTGAAACCTCGTCTCTAC"
"GL873574","4459477","4459612","chr1","29437872","29437991","29","24978395","GGCCGGGCGTGGTGGCGCACGCCTGTAGTCCCAGCGCTATGGGAGGCCGAGGCGGGTGGATCACCTGAGCTCAGAGGTTCGAGACCAGCCAAGACCCCCCTGAGCCAAACGAGCCAGAGTGAGACCCCGTCTCTAC","GGCCGGGCGTGGTGGCTCACGCCTGTAATCCCAACATTTTGGGAGGCCAAGGCGGGTGGATCACCTGAGGTCAGAAGTTCGAGACCAACCTGGCCAACATGGTGAAACCCCTGTCTCTAC"
"GL873574","4681987","4682216","chr6","153082888","153083127","73","148400901","GGGTGCGGTGGCTCAGACCTATAATCCCAGCACTCTGAGAGGCCGAAGTGGGTGGATCACCTGAGCTCAGGAATTTGAGACCAGCCGTCTCTAAAAATAGCTGAGTGTTGTGGCAGTGGCTGTAAGTCCCAGCTGTTTGGAAAGCTGAAGCAAGGGAATCACTTGAACCCAAGAGTTTGAGGTTGCTGTGATGACAAAGTGAGACTCTATCTCAAAAAAAAAAAAAAAAA","GGCCGTGCGCGGCGGCTCACGCCTGTAATCCCAGCACTTTGGGAGGCTGAGGTGGGTGGATCACCTGAGGTCAGGAGTTTGAGACCAGCCCGACCAGAAATTAGATGGGTGTGGTGGTGCGCTCCTGCAGCCCCAGCTACTTAAGAGGCTGAGGCAGGGTAATCACTTGAACCCGGGAGGCGGAGGTTGCAGTGAGCCGAGCTCACGCCACTGCACTCCAGCCTGGGTAACAGAGCGAGA"
"GL873574","4709916","4710039","chr19","13152422","13152536","46","8442506","AAAAATAGAAAAACTAGCCAAGCATGGTGGTGCACCCCCTATAGTCTGAGCTCCTCAGCGGGCTGAAGCAAAAGGACGGCTGGAGCCCTGGAGTTTGAGGTTGCTGTGAGGCAAGGTGATGCCA","ACACATAAATTAGCCAGACATGATGGTGAGTATCTGTAATTCCAGCTCCTTGGGGGGCTGAGGCGGGAGAATTGCTTGAACCTGGGAGGCAGAGATTGCAGTGAGCCAAGATCGC"
"GL873574","6353839","6353913","chr5","25768079","25768163","22","19414240","AAAAATATAGCAAGGCCAGGCATGGTGGCTCACACCTATAATCCCAGTACTTGGGAGCTGGAATTTGAACCTAGG","AAAAAACTCAAACAAGGCTGGGCGTGGTGGCTCACACCTGTAATCCCAGCACTTTGGGAGGCTGAGGTGGGTGGATCACCTGAGG"
"GL873574","6533061","6533332","chr5","85182161","85182439","81","78649100","GGCTGGGCGAGGTGGCTTACACCTATAATCCTAGTACTCTGGGAGGCCAAGGTGGGTGGATTGCCTGAGCGCACAGTTTCAAGACCAGCTGGAGCCAGAGAGAGAGAGAGAGACCCTGCCTCTAAAAATAGCCAGGCATTGTGGCAGGCACCTGTAGTCCCAGCTACTTGGCAGGCGGAGGTATGAGAATCGCTAGAGGTTGCTGTTAGCTATGATGCCATAGCACTCTACCAAGGGCGACAAAGTGAAACTCTGCCTCAAAAAAAAGAAGA","GCCAGGCGTGGTGACTCAAGCCTGTAATCCTAGCACTTTGGGAGGCCAAGGTGGGCGGATTGCCTGAGCTCAAGAGTTTGAGACCAGCCTGGGCAACACGGTGAAACCCAATCCCTACTAAATACAAAAAAAATTAGCCGGGTGTGGTGGTGTGAACCTGTAGTCCCAGCTACTCGGGAGGCTGAGGCAGGAGAAGGCAGAAGTTGCAGTGAGCCGAGATCACACCACTGCACTCCAGCCTGAGTGACAGAGCAAAACTCTTTCTCAAAAAAAAAAAAA"
"GL873574","6643746","6643907","chr2","92627944","92628105","46","85984198","AAATAGCCAGGCGTTGTGGCAGGCACCTATAGTCCCAGCTACTTGGGAGGCTGAGGCAAGAGAATCACTTAAGCCCAAGTGACAGAGGTTGCCAGGGCACTCTACGTAGGCAACAGAGTGAGACTCTATCTAAGAAAGAAGGAAGGAAGGAAGGAGAAAGAA","TTAGCCGAGCATTGTGGTGCGCGCCTGTAGTCCCAGCTACATGGGAGGCTGAGGCAGGAGAACACCTGAACCCAGGATGTGAGCTGAGTCGCGCCATTGCACTCCAGCCTGGGCAACAGAGTGAGACTCCATCTCAAAAATAAAATAAAATAAAATAAAAAA"
"GL873574","6644163","6644274","chr1","128607504","128607619","20","121963341","CTGTAATCCTAGCACTTGGGAGGCTGAGGCAGGTGGATCACCTGAGTTCAGGAGTTCAAGACCAGCCTAAACAAGAGTGAGACCCTATCTCTACTAAAAATAGAAAAAATAT","GCCTGTAATCCAAGCACTTTGGGAGGCTGAGGCGGGTGGATCACCTGAGGTCAGGTGTTCGAGACCAGCCTGGCCAACGTGGTGAAACCCCAACTCTACTAAAAATACAAAAATTA"
"GL873574","8511822","8512127","chr1","23439759","23440073","84","14927937","GGTGGCTGGTGCCTGTAATCCTAGCACTCTGGGAGACTGAGGCAGGTGGATCACTTGAAATCAGGAGTTTGAGATCAACCTGAGCAAGAGATCTTGTCTCTCCTAAAGATAGAAAAACTAGCTGGGATTTGTGGTGGACACCTGTAATTTCAGCTACTCAGGAAGCTAAGGCAAGAGCATTGCTTAAAACCAGGAGTTTGAAGTTGATGTGAGCTAGGATGTCAGGGCAGGTTACCCAGGGTGACAGAGTGAGACTCTGTGTCAAAATAAACAAACAAACAAACAAACAAAACAAAATAAAATAAA","GGCTGGACATGGTGACTCACGCTTGTAATCCCAACACTTTGGGAGGCTGAAGCAGGCAGATCACCTGAGGTCAGGAGTTTGAGACCAGCCTGACCAACATGGTGAAACCTTGTCTCTACTAAAAATACAAAAATTAGCTGGGAGCAGTGGTGCACACCTGTAATCCCAGCTACTCGGCAAGCTGAGGCAAGATAATTTTTTAAACCTGGGAGGTGGAGGTTGCAGTGAGCCAAGATCGTGCCACTGTACTCCAACCTGGGAGACAGAGCAAGACTCTGTCTCAAAAAAAAAAAAAAAAAAAAAAAAAAAAAAAAA"
"GL873575","2107336","2107519","chr4","38052972","38053149","54","35945636","TCAATTAAAAACTTTTTAAAATGAGGCTGAGCATGGTGGTTCACACCTGTAATCCCAGCACTTTGGGAGGCCGAGGCAGGAGGATCACCTGATCCCAGGAGTCCAAGCCTACAGTGAGCCGTGATAATACCACTGCACTTCAGCCCAAAGCCTCAAAAAGAAAAAAAAAAAAGGATAGACAAGA","TATATATATATATATTATTTTGGGGGGGCATGGTGGTGCACACCTGTAATCCCAGCTACTCGGGAGGCTGAGGCAGGAGAATTGCTTGAGCCCGGGAGGCAAAGGTTGCATTGAGCTGAGATCACACCACTGCACTCCAGCCTGGCGACAGAGTCTCAAAAAAAAGAAAAAATAAAAA"
"GL873575","5831824","5831959","chr1","29437872","29437991","28","23606048","GGCCGGGCGTGGTGGCGCACGCCTGTAGTCCCAGCGCTATGGGAGGCCAAGGCGGGTGGATCACCTGAGCTCAGAGGTTCGAGACCAGCCAAGACCCCCCTGAGCCAAACGAGCCAGAGTGAGACCCCGTCTCTAC","GGCCGGGCGTGGTGGCTCACGCCTGTAATCCCAACATTTTGGGAGGCCAAGGCGGGTGGATCACCTGAGGTCAGAAGTTCGAGACCAACCTGGCCAACATGGTGAAACCCCTGTCTCTAC"
"GL873575","7451097","7451208","chr3","122814630","122814743","22","115363533","GGCCAGGTGTGGTGGCTCACACCTGTTATCCTAGCACTCTGAGAGGCCACAGCAGCTGGATCACTTGAGCTCAGGAGTTCAAGACCAGTCTGAGCAAGAGCAAGACCTCACC","GGCTGGGTGTGGTGGCTCATGCCTGTAATCCCAGCACTTTGAAAGGCCAAGGCAGATGGATCACTTGAGGTCAGGAGTTCCAGACCAGCCTGGCCAACATGGCAAAACCCCATC"
"GL873575","7451277","7451445","chr6","58863249","58863409","41","51411972","AAAAATTCAGCCAGCCACAGTGGAAGTGGATGCCTGCCATCACAGCTACTCTGGGGGCTGGGGCAAGAGAATTGCTTGATCCCAGGAGTCTGAGGTTGCTGTGACCTAGGCTGACACCACAGCACTCTACCCAGGGTGACAGAGTGAGGCTGTGTTTAAAAAAAAAAAA","TTAGCCAGGCATGGTGGCACATGCCAGTAATCCCAGCTACTCAGGAGGATGAGGCAGGAGAATCGCTTGAACCCAGGAGGCAGAGGTTGCAGTGAGCTGAGATTGCGCCACAGCACTCTACCCTGGGTGACAGAAGGAGACTCTGTCTCAAAAAAAAAAAA"
"GL873576","1765109","1765185","chrX","53921180","53921256","12","52156071","GGCCAGGTGCAGTGGCTCATATCTGTAATCCTAGCACCCTGGGAGGCCAAGGTAGGCGAATCACCTGAGGCCAGGAG","GGCCAGGTGCAGTGGCTCACGCCTGTAATCCCAGCACTTTGGGAGGCCGAGGTGGGCGGATCACTTTAGGTCAGGAG"
"GL873576","2711577","2711895","chr7","6620384","6620702","85","3908807","GGTCGAGCTTGGTGGCTCATGCTTGTAATCCTAGCACTCTGGGAGGCCAAGGCAGGTAAGTTGCCCTGAGCTCATAGGTTCCAGATCAGCATGAGCCAGAGTGAGACCCTGTCTCTACCAAAAAATAGCCCGGCATTCTGGCAGGTGCCTGTAATCCCAGCTGCTTGGGAGGCTGAGGCTAGAGAATCACTTAAACCCAAGGGTTAGTGGAGGTTGCTGTGAGCTATGATTCCACCGTACTCTACTGAGGGCCACAAAGTGAGACTCTGTCTCCATAAAAAAGAAAGAAAGAAAGAAAGAAAAATAAAATAAAATAAAA","GGCCAGGCACAGTGGCTCATGTCTGTAATCCCAGCACTTTGGGAGGCCGAGGCGGGTGGATTACCTGAGGTCAGGAGTTCTAGACCAGCCTGGCCAACAAGGCGAAACCCTGTCTCTACTAAAAATACAAAAAATTAGCTGGGCGTTTTGGCACATGCCTGTAATCCCAGCTACTTGGGAGGCTGAGGCAGGAGAATTGCTTGAACTGGGGAAGTGGAGGTTGCAGTGAGCTGAGATCACACCATTGCACGCCTGAGCAACAGAGCGAGACTCTGTCTCAAAAAAAAAAAAAAAAAAAAAAAAGAAAAGAAAAAGAAAA"
"GL873576","4782520","4782652","chr9","61136941","61137074","22","56354421","CCAGGCACGGTGGCTCACCCTTGTAACCCTAGTACTTTGGGAGGCTGAGGTGGGAGGATCCCTTGAGGTCAGGAGTTCAAGACCAGCCTGAACAACAGTGAGACCCCCGTCTCTACTAAAAAATAGAAAAGTT","GCCAGGCACGGTGGCTCACGCCTGTAATCCCAGCACTTTGGGAGGCTGAAGCGGGCGGATCACCTGAGGTCAGGAGTTCAAGACCAGCCTGGGCACCATGATGAAACCCCGTCTCTATTAAAAATACAAAAATT"
"GL873576","4782930","4783078","chr7","57521645","57521803","40","52738715","AGTTAGTCTGGTGTCATGGTGGGTGCCTGTAGTCCCAGCTGCTTGGGAGGCTGAGGCAAGAGAATCACTTGAGCCCAGGAGTTGGAGGTTGCTATGAGCGAGGCTGTAGCCTAGGCAACAGAATGAGACTTTGCCTCAAAAAAATAAAA","TTAGCTGGGCATGGTGGCGCATGCCTGTAGTCCCAGCTACTTGGGAAGCTGAGGCAGGAGAATCACTTGAACCTGGGAGGTGGAGGTTGCAGTGAGCTGAGATCGCACCGCTACACGCCAGCCTGAGCAACAGAGAGAGACTCTGTCTCAAAAGAAAAA"
"GL873576","7828709","7828723","chr5","101042981","101042996","1","93214272","TAAATAAATAAAAAA","TAAATAAATAAATAAA"
"GL873576","7828960","7829230","chr13","49045537","49045844","89","41216577","GCCGGCTGCAGTGGCTATAATCCAAGTACCCTGGGAGGCTTAGGTGGATGGATCACTTGAGCTCAGAAGTTCAAGACCAGCCTCAGCAAGAGGTAGACCTTGCCTCTATTAAANNNNNNNNNNNNNNNNNNNNNNNNNNNNNNNNNNNNNNNNNNNNNNNNNNNNNNNNNNNNNNNNNNNNNNNNNNNNAGTTTGAGGTTGCTGTGAGCTATGATGAAGCCAGGGCATTCTACCCAGGGTGACAGAGTAACTCTTAAAAAAAACTAAACAA","GGCCAGGCAGAGTGGCTCATGCCTGTAATTCCAGCAATTTGGGAGGCCTAGGCAGGCAGATTACCTGAGGTCAGGAGTTTGAGACCAGCCTGGCCAACATGGTGAAACCCCGTCTCTTCTANNNNNNNNNNNNNNNNNNNNNNNNNNNNNNNNNNNNNNNNNNNNNNNNNNNNNNNNNNNNNNNNNNNNNNNNNNNNNNGGAGATAATAGCTTTTGTAGAACGAAGCGATGCAACAGCCAGATCGCCGCCACCACCCTTAGGTCCTGGCGACAGAGTGAGATCCATCTTAAAAAAAAAAAAAAAAAAA"
"GL873576","10622840","10623093","chr7","60266447","60266705","74","49643607","GCTGGGTATGGTGGTTCACACCTATAATCCTAGCACTCTGGGAGGCTGAGGTGGGAGGATTGGTGGAGCTCAGGAGCTCATGAGGTGCCAAATCACTGGTGCCACACACCTGTATTCCCAGCTACTGAGGAGGCTGAGGCAGGAGGATCAGGTAAGCCCAGGAAGTTTGAGGTTGTAGTGAGTTAGGATGATTGAACTCTGCCTTGAGAGACAGAGCAAGATCCTCCTTCCTCCTAAGCAAACAAACAAATAAA","GGCTGGGTGCAGTGGCTCACACCTGTAATCCTAGCACTTTGGGAGGCTGAGGCGGGAAAATTGCCTGAGCTCAGGAGTTCAAGGACAGCCTAGGCAACATAGCATGGTGGTGCACGCCTGTATTCCCTGCTACTTGGGAGGCTGAGGCACAAGAATTGCTTGAATCCGGGAAGTGGAGGTTGCAGTGAGCCATTGTGGCACTGCTCTCCAGTCTGGGTGACAGAGCAAGACTCCATCTCAAAAAAAAAAAAAAAAAAAA"
"GL873576","10819939","10820007","chrX","67133632","67133707","21","56313693","AGGTTGCAGTGAAATTGTACCATTCCAATGAAGCCTGGGGGACAGAGTGAGATTCTCTCAAAATAAAAA","GGAGGTTGCAGTGAACCGAGATCGTGCCACTGCACTCCAGCCTGAGCGACAGAGTGAAACTTCGTCTCAAAAAAAA"
"GL873576","10920306","10920363","chr3","48261745","48261808","16","37341439","GCTGGACCTTGTAGAGAGTGCCTGTAATCCCAGCTACATGGGGGGCAAGAGAATTGCT","GCTGGGCATGGTGGTGCATGCCTGTGATCCCAGCTACTCAGGAGGCTGAGGCAGGAGAATTGCT"
"GL873576","10920398","10920529","chr10","67341428","67341546","30","56421030","GGCCAGGCGTGGTGGCTCACGCCTGTTGTCCCAGCACTGTGGGAGGCCGAGGTGGGTGGATTGCCTGAGCTCAGAGGAGTCCGGAAGACCAGCATGAGGCAGAGTGAGCCAGAGTAAGATCCTGTCTCTACC","GGCTGGGTGTAGTGGCTCATGCCTGTAATCCCAGCACTTTAGGAGGCCAAGGTGGATGGATTGCCTGAGCTCAGGAGTTCGAGACCACCCTGGGCAACAAGCCAAAACCCTGTCTCTAC"
"GL873577","515809","515961","chr7","137660778","137660931","43","137144969","AGCTGGGCATGGTGGCTCATGCCTATAACCCTAGCGTGCTAGGAGATTGCTTGTCAGGAGACTGAGGTTGCAGGAAACTGTGATGATGGCACTGCACTCTACCCAGGGTGACAGAGCAGGACTCTGCCTCAAAAAAAAAAAAAAAAATAGAAA","TTAGCTGGGCATGGTGGCGCATGCCTATAATCCCAGCTACTTGGGAGGCTGAGGCAAGAGAATCGCTTGAACCGGGGAGGCAGAGGTTGCAGACTGCACTCCAGCCTGTGTGACAGAGTGGGACTCCGTCTCAAAAAAAAAAAAAAAAAAAAAA"
"GL873577","1633164","1633256","chrX","38269524","38269615","26","36636360","TCAGCCAGGCATGGTGGCACTTGCCTATAAACCCAGCTCCTTGGGAAGCTGAGCCGGGAGGATCCCTTGCACCCAGGAGCAACGGAAGGCAGT","AATTAGCCAGGCATGGTGGCACATGCCTATAATCCCAGCTACTCAGAAGGTTGAGGCAGGAGAATCACTTGAACCTGGGAGGCAGAGGTTGC"
"GL873577","3979502","3979560","chr20","68909283","68909346","13","64929781","GAGTTTGAGACCAGCCTGAGCAAGACCGAGACCCAGTCTCTACTAAAAATAGAAAAATT","GGAGTTCAAGACCAGCCTGACCAACATGGAGAAACCCTGTCTCTACTAAAAAATACAAAAATTA"
"GL873577","3979839","3980009","chr10","31403126","31403287","39","27423287","ATGAGCAGATTGTCTTGGTGGGCACCTGTAGTCCCAGCTATTGGAGGTGGGAGGCTGAAGCAGGAAAATCTCTTGAGCCCAGGAGTTTGAGGTTGCTGTGAGCTAGGCTGACACCACGGCACTCTAGTCAGGGCGTCAGAGTGAGACTCCGTCTCAAAAAAAAAAAAAAAA","TTAGCTGAGTGTGGTGGCGCACATCTGTACTCCCAGCTATTTGGGAGGCTGAGGCAGGAAAATCGCTTGAACCCAGGAGGTGGAGGTTGCAGTGAGCCAAGATCACACTACTGCACTCCAGCCTGGGTGACAGAGTGAGAATCCATCTCAAAAAAAAGAAAA"
"GL873577","6050882","6051080","chr1","153219820","153220007","59","147168938","GGCTGGGCGTTGTGACTCATGCCTGTAATCCCAGCACTCTAGGAGGCCGAGGTGGGTGGACTGCCTGAACTCAGAGGTTTAAGACCATCCTGAGCCGCAGTGAGCCAGAGCGAGACCCTGTCTCTACCAAAAAAAGCTGGGTGTTGTGGTGGGCGCCTATAGTCCTAGCTACTTGAGGCGCTAAGGGTAAAAAAATTGC","GGCCTGGCACAATGGCTCACGCCTGTAATCCTAGCACTTTGGGAGGCCGGGGTGGGTGGATCACCTGAGATCAGGAGTTTGAGACCAGCCTGGCCAACATGGTGAAACTCCTTCTCTACAAAAATTAGCCAGGTGTGGTGGTGGGTACCTGCAATCCCAGCTATTTGGGAGGCTGAGGCAGGAGAATC"
"GL873577","8463965","8464050","chr9","52134422","52134508","19","43670457","CTGGGTGCTATAGCTCACGCCTATAATCCTAGCACTCTGGGAGTTTGGGGCAAATGGATCACCTAGGCTCAGGAGTTTGATACCAG","GGCTGGGAGCAGTGACTCACGCCTATAATCCCAGCACTTTGGGAGGCTGAGGCAGATGGATCACCTGAAGTCAGGAGTTCGAGACCA"
"GL873577","9471486","9471613","chr16","5178790","5178910","46","4292696","TTAGCCAGGCATAGTAGCCTGTGTGTAGTCCTAGCTACTCAGGAGGCTGAGGTAGATGGGTCACTTGAGGTTGCAGAGATTATGGTAATGTCACTGTACTCTAGCCCTGGCAACAGAGCACAACCCTG","TTAGCCGAGCCTGGTGGCATAAACCTGTAATCCCAGCTACTCAGGAGGCTGAGGCAGGGGAATTGCTTGAACCTGAGAGGAGAAGGTTGCAGTGAGCCGAGATTGCACCATTGCACCCCAG"
"GL873577","9471875","9471998","chr7","17832200","17832315","36","8360325","GGCCAGGTGAAGCAGCTCATGGCTATAATCCTAGCAGTTTGGCAGGCCAAGGTGGGAGGACTGCTTGAGGTCAAGAGTTCAAGACCAACCCATCTTTGCGAAAAATTTAAAAATTACCTAGGCA","GCCAGGAGAGGTGGCTCATGCCTCTAATCCCAGCACTCTGGAAATCCAAGGTGGGTGGATCACCTGAGGTCAGGAATTCCAGACCAGTCTGGCCAATATAAAAAATTAGCCAGGCT"
"GL873577","9853150","9853170","chr3","85044647","85044667","3","75191497","AAACAAACAAACAAAAAAAGA","CAAACAAACAAACAAACAAAA"
"GL873577","9853206","9853473","chr7","130818682","130818963","67","120965476","GCTGGGCGCAGCGTCTCACTCCTGTAATCCCAGCACTTGGGAGGCCAAGGTGAGTGGATTGCCTGAGTTTACAGTTTCGAGACCAGCCTGAGCCAAAGCGAGACCCCCATCTCTAAAAAATAGCTGGGCATTGTGGTGGGCACCTGTAGTCCCAGCTACTTGGGAGGCTGAGGCAAGAGGATCGCTTGAACCTAAGAGTTTGAGGTTGCTGTGAGCTAAGGCTCCATGGCATTCTACCAAGGGTGACTAAGTGAGACTCTGTCTAAAA","GCCGGGCACAGTGGCTCACACCTGTAATCCCAGTACTTTGGGAGGCCAAGGTGGGTGGATCACCTGAGGTCAGGAGTTTGAGACCAGCCTGGCCAACATAGTGAAACTCTACTAAAAATACAAAAAAATAGCTAGGCATGGTGGTGCGCACCTGTAATCCCAGCTACTTGGGAGGCTGAGGCAGGAGAGTTGCTTGAACCCAGCGGGGTTGAGGTTGCAGTGAGTTAAGATCAAGCCACTGTGCTCCAGCCTGGATGACAGAGAGAGACTCCATCTCAAAAA"
"GL873577","10722415","10722478","chr10","12501471","12501539","23","1779056","AATAAAAAAATGCTGGGTACAGTAGTACATGCCTGTACTCTCATCTGGGGAAGCTGAGGCATGA","AAAGTAAAAAATTAGAGCTGGGCATGGTGGCACACACCTGTAATCCCAGTCACTAGGGATGCTGAGGCA"
"GL873578","463331","463568","chr10","28935382","28935620","93","28472051","CAGGTGCTTTGACCCACACCCTCAACTCTAGGACTTTGGACGCCCTGGCTGGGTGGGTCCTTTAAAGTCAGGAGCTTCTTATCAGTCTGGGCAAAAGTGAGACCCCATCTCTACCAAACAAAGAAAGAAATCAGCAGTATGTTGCAGTAGAGACTCACCAATACCTTCTTTCAAAGACCAAAGCTGGAAGGACACTAAAGACCATGATCTCATGGCCTCCCTGAGCCATGACAATGCC","CCAGGTGCAGTGGCTCATGCCTGCAAGCTCAGAACTTTGGGAGGCAGAGGTGAGCAGACTGCCTGAGTTCAGGAGTTCAAGACCAGCTGGGCAACATGGTGAGACCCTATCTCTACTAAAAATACAAATAATTAGCAGGGTGTGGTAGCACACACCTGTAGTCCAGCTACTCAGGAGGCTGAGGCAGGAGAATTGCTTGAACCCAGGAGGCAGAGTTTGCAGTGAGCCAGGACTGGGCC"
"GL873578","1143712","1143827","chr11","52824583","52824692","30","51680871","GGCTGGGTGTGGTGCCTCATGCCTGTAATCTAAGCCCTCTCCGAGGCTGAGGTGGGAGGATCCCTTGAGTTTAGGAGTTTGATTTTGAGACCAGCCTGATCAAGAGAGAGACCTCA","GGCCGGGTGTGGTGGCTCATGTCTGTAATCCCAGCACTTTGGGAGGCTGAGGTGGGTGGATACCCTGAGGTCGGGAGCTCGAGACCAGCCTGACCAACATGGAGAAACCC"
"GL873578","1144101","1144139","chr3","33494224","33494257","11","32350123","GAGAGAGACCTCATGTCTACTAAAATAAATAAATATATA","GTGAAACCCGTCTCTACTAAAAATACAAAAATTA"
"GL873578","1144175","1144343","chr12","119519961","119520131","41","118375786","ATTATCCAGGCCTTCTGGTGGATGCCTGTAGTCCTAGCTACTAGAAAAGCTGGAGCAGAATCACTTGACCCAGGAGCTGGAGGTTGCAGGGAGCTAGGCTGATGCCACAGAATTCTAGCCTGAGGCAAAAGAATTGAGCCACTGTCTCAAAAAGGAACAAAAAAGAAAA","ATTAGCCAGGTGTGGTGGCATGCACTTGTAATCCCAGCTACTAAGAAGGCTGAGGCAGGAGGATCACTTGAACCCGGGAGGTGGAGGTTGCAGTGAGCCAAGATCATGCCACTGCACTCCAGCCTGGGCAACAGAGTAAGACTCTGTCTCAAAAAAAAAAAAAAAAAAAAA"
"GL873578","4593962","4594035","chr16","68825055","68825124","22","64231093","AGCTGGGTACAGTGGCTCACATATAATCCCAGTGACTCAGGAGGCTAAGACAGGAGGATTACTAGGACCTGAGA","GGCTGGGCACAGTGGCTCAGACCTGTAATCTCAGTACTTTGGGTGGCTGAGGCAGGTGGATCACCTGAGG"
"GL873578","6158845","6158972","chr3","500432","500562","24","5658413","GACATGGTGGCTCACACCTGTAATCCTAGCCCTCTGGGAGGCTGAGGCAGGTGGATCACTTGAGTTCAGGAATTCAAGACCAGCTTGAGTGAGAGCAAGACCCTGTCTCTACTAAAAATAGAAAAATT","GCACGGAGGCTCATACCTGTAATCCCAGCACTTTGGGAGGCTGAGGCAGGTGGATCACCTGAGGTCAGGAGTTCCAGACCAGCCTGGCCAACATGGCGAAACCCTGTCTCTACTAAAAATACAAAAAATCT"
"GL873578","6159253","6159444","chr19","34496349","34496541","55","28337096","ATAAAATAAAAATAGAAAAATTAGCCAGGCATTGTGGCAGACATGCGAAGTCTCAGCTACTCCAGAGGCTGAGACAGGAAGATTACTTGAGCCCAAGAATCTTGCTGTGAGCTAAGCTGATGCCATAGCATTGTAACCTAGGCAACAGAGTAAGACTTGGCCTCAAAAATAAAATAAAATAATAAAGTAAAA","TTAGTTAATTAAATTAAACTTAGCTAGGCATAGTGGAACACACCCATAGTCCCAGCTACTCTAGAGGCTGAGGCAGGAGGATTGCTTGAGCCAAGTTGGAGGCTGCAGTGAGCTATGGTGGTGCCACTGCATTCCAGCCTCAGTGACAGAGAGAGACCCTGGCTCAAATAATAATAATAAATAAATAAATAAA"
"GL873578","6766040","6766171","chr2","93098086","93098217","30","86332046","CCAGGCACAGTGGCTCATGCCTATAATCCTAGTAGTCTAGGAGGCTGAGGTGAGTGCATTGCTTGAGCTCAGGAGTTAGATACCAGCCTAACCAAGAATGAGACCCCATCTCTATTAAAAATAGAAAAGTTA","GCCGGGCACAGTGGCTCATGCCTGTAATCCCAGCACTTTGGGAGGCCGAGGCGGGCAAATCACGAGGTCAGGAGTTCAAGACCAGCCTGACCAATATGATGAAACCCCGTCTCTATTAAAAATACAAAAATT"
"GL873578","6766434","6766577","chr9","21128084","21128223","50","14361650","GTTAGCCAGGAGTTGTGGCGGGCACCTACAGTCCTAGCGACTCAGGAGGCTGAAGTAGGCAGAGTTTGATGTGTTGCTGTGAACTACAAGGACACCAATGCACTCTAGGCCGGTAACAGAGTGAGACACTGACTAAAAAAAAAA","TTAGCCAGGTGTGGTGGCACATGCCTGTATTTCCAGCTACTCGGGAGGCTGAGGCAGGAGAATTGCGTGAGCTGAGATCATGCCACTTCATTCCAGTCTGGGTGACAGAGTGAGACTCTGCCTCAAAAAACAAAACAAAA"
"GL873578","7397948","7398119","chr5","40230148","40230319","43","32832200","TAAAAATAGCCATGCATTGTGACAGGCACCTGTAGTCCCAGCTACTCAGGAGGTTGAGGTAAGAGAATCACTTGAACCCAAGAGTTTTGAGGTTGTTATGAGCTAAGACGCCTCGGGACTCTACAAAAGGTAACAAAGTGAGACTCTGTCTCATAAAAAAAGAAAAAAAGAA","AAAATTAGCCAGGCATGGTGACGTACACCTGTAGTCCCAGCTACTCGGGAGGCTAAGGCAAGAGAATCGCTTGAACCCAGGAGGCAGAGGTTGCAGTGAGCTTAGATCACGCTACTGCGCTCCAGCCTGGGTGACGGAGTGAGACGCCATCTCAAAAAAAAAAAAAAAAAAA"
"GL873578","7398378","7398515","chr15","102382935","102383070","35","94984557","GGTCGAGCAAGGTGGCTCACGCCTGTAATCCTAGCACTCTGTGAGGCTGAGGCAGATGGATTGCCTGAGCTCGTGGGTTCGAGACCAGCCTGAGCCAGAGTGAGACCTCATCTCTAAAAATAGCTGGGAAGCTGGGCA","GGCCAGGTGTGGTGGCTCACGCCTGTAATCCTAGCACTTTGGGAGGCTGAGGCGGGTGGATTGCCTGAACTCAGGAGGTCAAGACCAGCCTGGGCAACACAGTAAAACCCCATCTCTACTAAAATACAAAAAATCA"
"GL873579","370235","370429","chr16","38067345","38067552","57","37697110","GCACAGGCCTGAAATCCTAGCACTCTGAAAGGCCAACGGAGGAGAATTTCTGGAGCTCAGGAGTTTGATACCAGCCTAAGCAAATAAAGCTAGACCTCTATCTCTACTAAAATTAGAAAAATTAGGCAGATGTGGTGGTAGGCACCTATAGTCCCAATTACTCCAGAGGCTGAGGCAGAAAGACTCTTGAACCCA","GTCAGGCATGGTGGCTCATGCCTATAATCCTAGCACTTTGGGAGGCCAAGGCCGGTGGATCACCTGAGGTCAGGAGTTTGAGACCAGCCTGGCCAATATGGCAAAACCCCGTCTCTACTAAAAATAAAAAAATTAGCTGGGCACGGTGGTGGGCACCTATAGTCCCAGCTACTCAGGAGGCTGAGGCAGGAGAATTGCTTGAACCCAG"
"GL873579","370936","371046","chr3","3847698","3847802","33","3476762","TGACTCTTGAACCCAGGCACATGAGGTTGCTAAGAGTCTAGGCTGATGTCACGGCACTCTAACCTGGGAAACAGTGTGAGGTTCTGCCTCAATAAATAAATAAATAAATAA","TGGCTTGAACCCAGGAGGCGGAGGTTGCAGTGAGCCGAGATCACGCCACTGCACTCCAGCCTGGGCAACAGAGCGAGACTGTCTCAAAAAAAAAAAAAAAAAAAA"
"GL873579","599436","599605","chr10","38982686","38982853","41","38383250","AAAAAGTCAGACATTGTGGCAGGTGTCTGTAATCCCAGCTATTTGGGAGGCTGAGGCAGGAGTATCATTTGAACCCACGAGTCTGAGGTAACTGTGAGCTAGGCTAACACAACAGCACTCTAGCCTGGGCAATAGAATGAGACTCTATCAAGAAAAGAAATGAAAAGAAA","TATTAGCCTGACACAGTGGCGCGCATCTGTAATCCCAGCTACTTGGGAGGCTGAGGCAGGAGAATCACTTGAACCCAGGAGGCGGAGGTTGCTGTGGGCTGAGATCATGCCACTGCACTCCAGCCTGGGCAACAGAGGGAGGCTCCATCTCAAAAAAAAAAAAAAAAA"
"GL873579","599942","599953","chr3","71473700","71473710","4","70873758","TTTTAAAATAGT","TTTAAAAAAAA"
"GL873579","600232","600365","chr1","16061315","16061447","30","15461083","GGCTAGGCAAGGTGACTCATGTCTGTAATCCTAGTACTCTGGGAGGTTTGAGGCAGGAAGACCACTTTAGCTCAAGAGTTCCAGATCAGCCTGTGCAAGAGTGATACATCATCTCTACTAAAAATCAAAAATTA","GGCTGGGCATGGTGGCTCATGCCTGTAATCCTAGCACTTTGGGAGGTTGAGGCAGGCAGATCACTTGAGGTCAGGAATCTGAGACTAGCCTGGCCAACATGGTGAAACTCCATCTCTACTAAAAAAAAAAAAA"
"GL873579","5650320","5650591","chr6","54938866","54939145","71","49288546","GTCAGGTGTGTTAGCTTACAGTAGTAATCCTAGCACTTTGGGAGGTTGAAGTGGGTGGATTGCTTGAGCTCAGGGGTTCAAGACCAGCCTGAACAAGAGTGGGACCTCATCTCTATTAAAAACAGAAAAACTAGCTGGGTGTTATGGTGGGTGTCTGTAGCCCCAGCTACTCAGGAGGCTGAGGCAGGAGGTTGAGGTTGCTGTGAGCTATTGAGACCACAGCACTCTATCCAGGGCAACAGAGTGAGACCCCTCCCCCCCCCAAAAAAAAA","GGCCAGGTGTGGTGGCTCACGCCTGTAATCCCAACACTTTGGGAGGCCGAGGTGGGTGGATCACCTGAGATCAGGAGTTCAAGACCACCCTGGCCAACATGGTGAAACCCCGTCTCTACTAAAAATACGAAAATTAGCTGAGTGTGGTGGTGCATGCCTGTAGTCCCAGCTACTCAAGAGGCTGAGGCAGGAGGTGGAGGTTGCAGTGAGCCGAGATTGCATCACTGCACTCCAGCCTTGGCGACAGAACGAGAGAGACTCCATCTAAAAAAAAAAAAAA"
"GL873579","7037162","7037347","chr3","37328686","37328893","67","30291524","GAGGTGGGTGGATTGCCTGAGCTCACAGGTTGGAGACCAGCCTGAGCCAGAGCAAGACCTTATCTCAAAAAATAGCCAGGTGTTGTGGCTGGCACCTGTAGTCCCAGCTGCTCAGGAGGCGGAGGCAAGAGAAATGCTTGACCTCAGGAGTTTGAGGTTGCTGTGAGTTCAACTCACACTAATACA","GAGGCAGGGGGATCACCTGAGGTCAGGAGATCGAGACCAGCCTGGCCAACATGGTGAAAACCTGTCTCTACTAAAAATCCAAAAACATTAGCCAGGTGTGGTGGCACGCACCTGTAATCCCAGCTACTTGGGAGGCTGAGGCAGGAGAATCACTTGAACCTGGGAGGCAGAGGTTGTAGCGAGCCGAGATCACACCACTGCACCCCAG"
"GL873579","11077764","11077972","chr19","1200469","1200683","63","9877295","GCCAGGTGCAGTGGCTCATGCCTATAATCCTAGCACCCTAGGAGGCTGAGGAGTTCAAGACCAGCCTAAGCAACTGTGAGACCCCATCTCTACCAAAAATAGAAAAATTAGCTGACTGTTATGGTGTGCACCTACAGTCCTAGCTACTCAGGAGGCTGAGGCAGAAAGAGTCCTTGAACCCAGGAGGCTTTTTTTTGTTGTTGTTGTTG","GGCCAGTCGCGGTAGCTCATGCCTGTAATCCCAGCACTTTGGGAGGCCGAGGCGGGCAGATCACCTGAGACCAGCCTGGCAACATGGTGAAACCCCATGTCTACCCAAACTACAAAAATTAGCTGGGTGTGGTGGTGCACGCCTGTAATCCGAGCTACTCAGCAGGCTGAGGCAGGAGAATCCCTTGAACCTGGGAGGCAGAGGCTGCAGTGAGC"
"GL873579","11078245","11078333","chr19","4926258","4926351","22","6151987","TGAACCCAGGAGTTTGAGTTCGCTGTGAGCTAAGCTGAGGCCACAGCACTCCAGCCTGGGCAACAGAGTGAAAGGAAAAAAATAAAAAA","TGAACCCGGGAGGTGGAGGTTGCAGTGAGCCAAGATCACACCAATGCACTCCAGCCTGGGCAACAAGAGTGAAACTCTGTCTAAAAAAAAAAAA"
"GL873580","320374","320488","chr13","48549305","48549409","42","48228931","GGTAGTGCGTGCCTGCATTCCCAGCTACGGGAGGGCAGGGACTTGAGGCCAGCCTGGGCAAAATAATGAGACCTACTAATGACTCTACTAATACAGAAACAATTAGCTAGGTATG","TGGGAGGCCGAAGTGCGCAGATCACCTGAGGTCAGAAGTTGGAGACCAGCCTGGCCAACATGGTGAAAACCCATCTCTACTAAAAATACAAAAATTAGCTGGGCA"
"GL873580","374969","375091","chr6","147681010","147681135","27","147306041","CGGTGGCTCACACCTATAATCCTAGCATTTTGGAAGGCTGAAGCCGAGGATCTCTGGAAGTCAGAAGTTCAAGACCAGCCTGCCCAAGAGCAAGACCCCATCTCTACTAAAAATAGAAAAACT","GGTGGCTCACACCTGTAATCCCAGCATTTTGGGAGGCTGAGGCAGGCGGATAATCTGAGGTCAAGAATTTGAGACCAGCCTGGCCAACATGGAGAAACCCTATCTCTACTAAAAATACAAAATTAC"
"GL873580","375369","375549","chr7","19977275","19977456","44","19601906","CTAACCAAGTTAGTTAGTTTTAGTTGGCAGGTGCCTGTAGTCCCAGCTCCTTGGGAGGCTGAGGCAAGAGAATGGCTTGAGCCCAGGACTTTGAAGTTGCTGTGAGCTATAATGACACCACAGCACACTACCCAGGGTGACAGAGTGAGACTGTCTCAAAAAAACAAACAAACAAAAAAAA","AACAAACGTTAGCCGAGCATGGTGGTATGTGCCTGTAGTCCCAGCTACTTGGGAGTCTAAGGCAGGAGAATTACTTGAGCCCGGGAGGCAGAGGTTGCTGTGAGCCAAGATCACGCCACTGCACTCCAGCCTGGGTGACAGAGTGAGACTCCATCTCAAAAAAAAAAAAGGAAAAAAAAAAA"
"GL873580","8760922","8761015","chr11","104681322","104681416","19","95920400","GGAGGGAGACACTGCAGTGAACTGCGATCGTGTCTCTGCTTTCCAGGCTGGGTGACAGAGTGAGACTCGGTCTCTAAAATAAAAAATAAATAAA","GGAGACGGAGGTTGCAGTGAGCTGTGATCGCGGCACTGCACTCCAGCCTGGGCAACAGAGTGAGACTCTGTCTCAAAAATAAATAAATAAATAAA"
"GL873580","9391260","9391306","chr14","49279240","49279285","12","39887980","GCCAGTCGAGGTGGCTCACACTTGTGATTCCAGCTACTTGGAAGACT","GGCTGAGATGGTGGCACACACCTGTAATCCCAGCTACTTGGGAGGC"
"GL873581","759283","759365","chr6","46535476","46535542","30","45776193","TAAGAACCTGAAAATAGAGCCAGGCATAGTGGTACATGCGTATAGTCCTGGCTACTCAGGAGGTTGAAACAACAGGATTACTT","CAAAATAGCCAGGCTTGGTGGTGCATGCCTATAATCCAAGCTACTCGGGAAGCTGAGGCAGGAGAAT"
"GL873581","1145844","1145979","chr1","29437872","29437991","29","28292028","GGCCGGGCGTGGTGGCTCACGCCTGTAGTCCCAGCACTATGGGAGGCCGAGGCGGGTGGATCACCTGTGCTCAGAGGTTCGAGACCAGCCAAGACCCCCCTGAGCCAAATGAGCCAGAGTGAGACCCCGTCTCTAC","GGCCGGGCGTGGTGGCTCACGCCTGTAATCCCAACATTTTGGGAGGCCAAGGCGGGTGGATCACCTGAGGTCAGAAGTTCGAGACCAACCTGGCCAACATGGTGAAACCCCTGTCTCTAC"
"GL873581","9628238","9628362","chr5","141044567","141044691","34","131416329","ATCCCAGGTAGTCGGGAGGCTGAGGCAGGAGGATCACTTGAACCCAGGAGGTTGAGGTTGCTGTGAGCAAGGCAGAGGCAACGGCACTCTAGCCACGGGGGCACAGAGACTCTTGTCTTTAAAAA","TAATCTCAGCTACTCGGGAGGCTGAGGCAGGAGAATCGCTTGAGCCCAGAAGGTGGAGGTTGCAGTGAGCCAAGATCGCGCCATTGCACTCCAGCCTGGGCGACAGTGCGAGACTCTGTCTCAAA"
"GL873582","1580485","1580534","chr6","32576760","32576806","12","30996275","CAGCACTTGAGAGGCCAAGGCAGGTGGATCAACTGAGCAAGAATGAGACC","CCAGCACCTTGAGAGGCCAAGGCAGGTGGATCACCTGAGGTCAGGAG"
"GL873582","1644368","1644551","chr1","211626449","211626612","63","209982081","AAAATTTGCCGGGCTCCATAGCTCATGCATGTAATCATAGCACTCTGGGAGGCCAAGATGGGAGGATCTCTCAAGCTCTCTTACTTGGGAGGCTGAGGTTGCTGTGAGTTAGGCTTACGCCACAGCACTCTACTCTAGCGTGAGCAACTCTACTCTTAGTATGAGACTGTCTCAAAAGAAAAAA","AAATTAGCCAGGCGTCGTGGCACATGCCTGTAATCCCAGCTACTCGGGAGGCTGAGGCAGGAGAATAGCTTGATCTCGGGAGGCGGAGGTTGCAGTCAGCCGAGATCACACCACTGCAATCCAGCCTGGACAACAGAATGAGACTCCATCTCAAAAAAAACAAA"
"GL873582","5794385","5794459","chr13","18872784","18872852","27","13078399","ATATTGTTAAGCACAGCCACTATTAAAAATTAAATTATAGGCCAGGCATAGTGGCTCATGCCTGTAATCCTAGCT","TGAAACCACCATCTGGACCAAGATACAAAATGTTGGCTGGGCATGGTGGCTCACACCTGTAATCCTAGC"
"GL873583","102645","102683","chr14","5808766","5808804","14","5706121","GAGCAGATCACCTGAGCTCAGGAGTTTGAGACCAGCCTG","GAGGAATCCCTGTGCTCAGGAAGCTTACATTCTAGTGAG"
"GL873583","6200447","6200560","chr4","17786849","17786963","24","11586402","GGCCAGGAGGGACGGCTCATGCCTGTTATCCTAGCACTATGGGAGACTGAGGTGGGAGGATCACTTGAAGTTAGGAGTTCCAGACCAATCTGACCAAAGTGAGACCTCATCTCT","GGCCAGGCTTGGTGGCTCATGCCTGTAATCTTAGCACTTTGGGAGGCTGAAGTGGGTGGATCACTTGAGGTCAGGAGTTAGAACCAGTCTGGCCAACATGGTGAAACCTCAGCTC"
"GL873583","6200584","6200752","chr6","169626528","169626696","42","163425944","TTAGCTGGATGTGGTAGCACATGCCTATAGTCCCATCTACTCAGGAGGCTGAGACAAGAGAGTTGCTTAAGCCCAGGAGTTTAATTTAACTGTGAACTAGACTGAGACTGTGGCACTCTAGCTGGGGCAACAGAGTGAGACTCTGTCTCAAAAGAAAGCAAGAAAGAAA","TTAGCTGGGTATGGTGTCAGATGCCTGTAGTCCCAGCTACTCAGGAGGCTGAGACAGGAGAATCGTTTGAACCCAGGAGGCCAGAACTGCAGTGAGCTGAGATTCGCACCACTGCGCTCCAGCCTGGGCCAGACAGAGTGAGACTCTATCTCAAAAGAAAAAAAAAAAA"
"GL873583","10217398","10217583","chr3","36257142","36257313","44","26039744","TACTAAAAATAAAGTGTGATAGCCAGGCATGGTGGTGGTGCCTATAGAACCAGGCTATTCAGGAGGCTGAGGCAGAAGGATCACTTGAACCCAGGAGTCTGACGTTGCTGTGAGCTAGGCTGGTGCCATGGTACTCTAGCCTGTGGTAACAGAATGAGACTCTATCTCAAAAATAAAAATAAAAAA","TACAAAATTAGCCAGGCGTGGTGGTGCGTGCCTGTAATCCCAGCTACTTGGGAGGCCGAGGCAGAAGAATGACTTGAACCCAGGAGACAGAGGTTGCAGTGAGCCAAGATCCCACCATTGTACTCCAGCCTGGGCAACACAGTGAGACTCCATCTCAAAAAAAAAAAAAAAA"
"GL873583","10394919","10394983","chr16","12841703","12841771","22","2446784","GAGGTCAGGAAATCAAGATCAGTCTGGGCAATATATTGATACCCTGCCCCTACATAAGGAAGAAA","AGGTCAGGAGTTCAAGACCAGCCTGGCCAATATGTTGAAACCTCATCTCTACTAAAAATACAAAAATTA"
"GL873584","521512","521529","chr1","167402212","167402233","10","166880700","GCATGGAACCCCCCACTC","GGTGAAACCCCATCTTTACTAA"
"GL873584","2079725","2079768","chr15","4338291","4338335","11","2258566","GGCAGGTGGATTACCTGAGTTCAGGAGTTGGAGACCAGCCTGAC","AGGCGGATGGATCACGAGGTCGGGAGTTTGAGACCAGCCTGACCA"
"GL873584","5216877","5217053","chrX","91350057","91350230","49","86133180","CTACTGAAAATGATGACAGAGGCTGGGCATGGGGGCTCCCGCCTGTTATCCTAGCACCCTCGGAGGCTGGGGAATGAGGATTGCTTACGCCCAAGAGTTTGAGGTTGCTGTGAGCTGAGGCCGCTGCACTCTAGCCTGGGCAACAGAGTGAGACTCTGTCTCAAAAAAAAAAAAAAA","TGCAAAAATGAGCTGGGCATGGTGGCACATGCCTGTAATCCCAGCTACACAGGAGGCTGAGGCAGGAGAATCGCTTGAATCTGGGAGGCGGAGGTTGCAGTGAGCTGACATCAGGCCCCTGCACTCTAGCCTGGGCCACAGAGCAAGACTCCGTCTCAAAAAAAAAAAAAAAAA"
"GL873584","7289930","7289950","chr2","51453328","51453345","10","44163398","TGAGGCTCTGTCTCGAAATAA","AATGCCATCTATTAAAAA"
"GL873584","7289975","7290131","chr11","49739997","49740154","37","42450022","CAAGAAAATTAGCTGAGAGTCCTGGTAGGTGCCTGTAATCCCAGCTATTCATGAGGCTGAGGCAGAAGGATCACTTGGGTCCAGGAGTCTGAGGTTGCTGTGAGCTAGTCTGACGCCATAACACGCAAGCCTGGGCAACAGAGTGAGGCTCGGTTTC","CTACAAAAATTAGCTGGGCGTGGTGGCACATGCCTGTAATCCCAGCTACTCGGGAGGCTGAGGCAGGAGAATCACTTGAGCCCAGGAGGCGGAGGTTGCAGTGAGCCAAGATCATGCCATTGCACTCCAACCTGGGCAACAGAGCAAGACTCCATCTC"
"GL873584","7577743","7577867","chr5","48394329","48394446","27","40816586","GGCTGGATGAGGTGGTTCATGCCTGTAATCCTAGCACTCTGGGAGGCCAAGGTGGGTGGATTGCCTGAGCTCAGGAGTTCAAGACCAGCCTGAGCAAGACCCTGTCGCTAAAAATAGCTGGGTGT","GGCTGGGTGCAGTGGCTCATGCCTGTAATCCCAGCACTTTGGGAGGTCAAGGCGGGTGGATCACCTGAGGTCAGGAGTTCAAGACCAGCCTGGCCAACATCTCTACTAAAAATACAAA"
"GL873584","7578135","7578289","chr1","130112713","130112865","31","122534578","GGAGCTGGGTTTTGTGACTGCACCTGTAATCCCAGCTGCTCAGGAGGCTGAGGCAAGAGAATTGCTTGAGCCCAGGAGTTGGAGGTTGCTGTGAGCTGTGATGCCAGGGAACTCTACCAAGGGTGACAAAGTGAAACTCTGTCTCAAAAAAAAAA","TTAGCCAGGTGTGGTGATGCATGCCTGTAATCCCAGCTACTCATGAGGCTGAGGCAGGAGAATTGCTTGAACCTTGGAGCTGGAGGTTGCAGTGAGCTGAGATCAGACCACTCCAACCTGGGTGACAGAGCGAGACTCTGTCTCAAAAAAAAA"
"GL873585","1450952","1451121","chr10","59681079","59681242","48","58230127","TAAAAACAGAAAAAACTAGTCAGGTGGTGTGGTAGGTGCTCATAAGTCCCAGCTGCTTGGGAGACTGAGGCAAGAGAATCACTTGAGCACAAGAGCTTGAGGTGGCTGTGAGCTATAACACCATAGCACTGTACTGAGGGTGACAAAGTAAGACTCTGTCTCAAAAAAAA","TACAAAAATTAGTCAAGGGTGGTGGTATGTGCTTGTAATCCCAGCTATTTGGGAGGCTGAAGCAGGGGAATCCTTGAACCCAGGAGGTGGAGGTTGCAGCGAGCCGAGATCACGTCACTGCACTCTAGCCTGGGCGATAGGGTGAGACTCTGTCTCAAAAAAAA"
"GL873585","1451382","1451515","chr6","17405813","17405948","24","15954431","GGCCCGGCTCGGTGGCTCACACCTATAATCCTAACACTCTGGGAGGCTGAGGCAGGTGGATCACCTGAGCTCAGGAGTTTGAGACCAGCTGAGCAAAAACAAGACCCTATCTCTGCTAAAAATAGAAAAAACTA","GGCCGGGCGGGGTGGCTCACGCCTGTAATCCCAGCACTCTGGGAGGCCAAGGCAGGTGGATCACCTGAGGTCAGGAGTTTGAGACCAGCCTGGCCAACACGCAGAAACCCTATTTCTACTAAAAACACAAAAATTA"
"GL873585","1626960","1627026","chr7","17782729","17782794","22","16155769","AAGATGCCACAGCACTCTACAAGAGTGACCAAGTGAGACTCTGTCTCAAAAAAAAAAAGAAAAGGAA","CAATCGCACTACTGCACTTCAGCCTGGGTGACAGAGTGAGAACCTGTCTCAAAAAAATAAATAAAA"
"GL873585","1627304","1627531","chr11","17033552","17033788","61","15406248","GGCTGGGCACAGTGGCTCACGGCTATAATCTAGGCACTTGGGAGGCTAGGGCAGGTGGATTGCCTGAACTGACAAGTTTGAGACCAACCTGAGCAAGAGCGAGACCCCTGTCTCTAAAACATAGCCAGGCTCTGTGGTGGGCGTCTGTAGTCCCAGCTACTTGGGAGGCTGAGGCAAGAGAATTGCTTGAACTCAAGAGTCTGAGGTTGCTGTGAGTTAAGATGCCAC","GCCCGGCGCAGTGGCTCACGCCTGTAATCCCGGCACTGTGGAGGCCAAGGCAGGCGGATTGCCTAAGCTCAGGGATTCGAGAACAGCCTGGGCAACATGGTGAAACCCCATCTCTACTAAAATACAAAAAACTAGCCGGGCGTGGTGGTATGCGCCTGTAATCCCAGCTACTTGGGAAGCTGAGGCAGGAGAATTGCTTGAACCCGGGAGATGGAGGTTGCAGTGAGCTCAGATCAC"
"GL873585","3626082","3626158","chr1","100916857","100916922","27","97290775","TGCCTGTAATCCCAGCACTTGGGAGGCGGAGGTGGGTAGATTGCCTGACCCAGAGTGGGACCTCATCTCTAAAAGAA","CATGCCTGTAATCCCAGCACCTTGGGAGGCCAAGGTGGGTGGATCACCTGAGGTCAGTAGTTTGAG"
"GL873585","8849829","8849913","chr18","48581945","48582025","18","39732116","GGCTGGACGAGGGGACTCATGCCTGCAATCCCAGCACTGAGAGAGGCCAAGGCAGGTGGATCCCCTGAGCTCAGAAGTTTGAGAC","GCTGGACGCAGTGGCTCACACCTGTAATCCCAGCACTTTGGGAGGCCAAAGCAGGCAGATCTGAGGTCAGGAGTTTGAGAC"
"GL873585","9319890","9319971","chr8","79499361","79499447","14","70179471","GGCCAGGTGTGGTGGCTCACACCTGTCATCCTAGCACTCTGGGAGGACGAGGTGGGTGGACCGCCTGAGTCAGAGTGAGACC","GGCCAGGTGTGGTGGCTCACACCTGTAATCCCAACACTTTGGGAGGCCCAGGTGGGTGGATCACCTGAGGTCAGGAGTTCAAGACCA"
"GL873586","895572","895692","chr17","14501559","14501680","38","13605987","GGCCAGGTGAGGTTTCTCATTCTGGGAGTGAGCCAGCAATTGGGAGGCCAAAGTAAATGGATTGCCTGAGGTTATAGGTTCCAGAACAGCCAGAACAAGATCGAAATCCTGTCTCCAAAAA","GGCCAGGCGTGGTGGCTCATGCGTGTAATCTCAGCACTTTGGAAGGCCGAGGCAGGTGGATCACCCGAGGTCAAGAGTTCAAGACCAGCCTGACCAACATGGCGAGTCTCTGTCTCCACTAA"
"GL873586","5645995","5646150","chr6","58863249","58863409","38","53217254","GGGTATGGTGGCTCATGCCTGTAATCCAAGCACTCTGGGATGGTGAGGCAGGAGAATCCCTTGAACCCAAGAGTCCGAGGTTGCTGCGAGCTAAGCTGATGGCATAACACTCTAGCCTAGGCGACAGAGTGAGACTCTGTTTCCAAAGAGAAAAAA","TTAGCCAGGCATGGTGGCACATGCCAGTAATCCCAGCTACTCAGGAGGATGAGGCAGGAGAATCGCTTGAACCCAGGAGGCAGAGGTTGCAGTGAGCTGAGATTGCGCCACAGCACTCTACCCTGGGTGACAGAAGGAGACTCTGTCTCAAAAAAAAAAAA"
"GL873586","10258686","10258969","chr12","9481260","9481565","81","777426","GGCCGGGCATGGTGGCAGAAATCTAGGAGGCCGAGGCAGGTGGATCGCCTGAGATCACAAGTTCAAGACCAGCCTCAGCTACAGCAAGACCCCATCTCTAAAAATAGCCGGCTGTTGTGGCAGGCGCCTGTAACCCCAGCTACTCGGGAGGCTAAGGCAAGAGAATCGCTTGAGCCCATGAGTCTGAGGTTGCTGCGAGCTGTGACTCCACGGCACTCTACCCGGGGCGATAAAATGAGATTCTGTGTCAAAACAAACAAACAAACAAACAACAACAAAAACAA","GCTGGGCGCGGTGGCTCATGCCTGTAATCCCAGCACTTTGGGAGGCCAAGGCAGGTGGATCACCTGAGGTCAGGAGTTCGAGACCAGCCTAGTCCACATGGTGAAACCCCATCTCTACTAAAAACTAGCCAGGCGTGGTGGTGCGCACCTGTAATCCCAGCTACTCGAGAGGCTGAGGCAGGAGAATCACTTGAGCCTAGGAAGCAGAGGTTGTGGTGAGCTGAGATCACACCACTGCACTCCAGTCTGGGCGACACAGTGAGACTCTTGTCTCAAAAACAAAAAACAAACAAACAAACAAACAAA"
"GL873587","3208032","3208047","chr8","3626746","3626762","2","418714","AAACAACCACAAAAAA","ACAACAACAACAAAAAA"
"GL873587","3208141","3208321","chr19","2057131","2057316","59","1151010","TTTCTTTTAAAAATCACCCATGGGCTGGGTATAGTGGCTCACACCTATAATCCTCGGGAGGCCAAGGTTGGAGGATTGCTTGAATCCAGGAGTTGAAGGTTACAGTGAACTGGGATTTAGCCACTAGACTCTAGCATAGCTGACAAAGCAAGAACCTATTTGTTTAAAACACAAAAAAGAA","TACTAATAATACAAAAATGAGCCGGGTATGGTGGCGGGTGCCTGTAATCCCAGCTACTGAGGAGGCTGAGGCAGGAGACTTGCTTGAACCCAGGAGGTAAAGGTTGCAGTGAGCTGAGATTGCACCACTACACTCCAGCCTGGGCGACAAGAGCAAAACTTTTTCTCCAAAAAAAAAAAAAAAAAA"
"GL873587","3278260","3278367","chr19","19044200","19044312","39","15765940","CAGTCTGAGCAAGAGGGAGAGGCTATTTCTACTAAAAACAGAAAAACTAGCTGGGTGTTGGGGTGTGTTCCTAGTCTCAGTTACTTGGGAGGCTGAAGTAAGAGGATC","ACCAGCCTGGCCAACACGGTGAAATCCCGTCTCTACTAAAAATACAAAAATTACCTAGGCGTGATGGCACGTGCCTGTAGTCCCAGCTACTCATAAGGCAGAGGTGAGAGAAT"
"GL873587","3278673","3278754","chr7","49412503","49412597","28","46133830","GGCCACGAGAGCTAGCTCATGCCTATTCTAGGAGGCCAAAGCAGGCAGACTGCCTGAGCTCAGGAGTTCAAGAGCAGCCTGG","GGCCAGGTGCAGTGGCTCATGCCTGTAATCCGAGCACTTTGAGAGGCCGAGGCAGGCAGATCACCTGAGGTCAGGAGTTCAAGACCAGCCTAGTA"
"GL873587","3782076","3782188","chr9","112128434","112128552","34","108346358","ACTGGGGTGGCTGAGGCAGGAGCGTCACTTGAACTCAGGAGTTTGAGATTGCTGTGAGCTGAGCAGATGTCATGGCACGCTAGCCTAGGTAATAGAGTGAGACTTCGTCTAAA","CAGCTACTCGGGAGGCTGAGGCAGGAGAATCACTTGAACTCGGGAGGCGGAGGTTGCAGTGAGCCGAGATCACGCCATTGCACTCCAGCCTGGGCAACAAGAGCGAAATTCCATCTCAA"
"GL873587","4564996","4565084","chr20","27900350","27900437","14","23335354","GGCGGGGTGTAGTGGCTCATGCCTATTGTCCCAGCACTGTGGGAGGCCGAGGTGGGTGGATCACCTGTGCTCAGAAGTTTGAGACCAGC","GGCCGGGCGTGGTGGCTCATGTCTGTAATCCCAGCACTTTGGGAGGCCGAGGTGGGTGGATCACCTGAGGTCAGGAGTTCAAGACCAG"
"GL873587","6307870","6308175","chr12","112427710","112428020","54","106119840","GGCCAGATATGATGGCTCATGCTTGTAATCCTAGCACTCTGGGAGGCTGAAGTGGGAGGATCACCTGAGATCAGGAGTTCAAGATCACCCTGAGCAAAAGTGAGATCCCATCTCTATTAAAAATAAAAAAATTATCCAGGCATGGTGGTGCAGTCCTTTAGTCCCAGCTACTTGGGAGGCTGAGGCAGGAGAATCTCTTGAACCCAGGAATTAGAGGTTACAGTGAGCTGTGATGATGCTACTGCACTCTAGCAGGATGACAGAGTGAGATACTCCGTGTCAAAAAAAAAAAAAAAAAAAGCAAAA","GGCTGGACATGGTGGTTCATGCTTGTAATCCGAGCACTTTGGGAGGCCAAGGCGGGTGGATCACCTGAGGTTGGGAGTTCGAGACCAGCCTGACCAACATGATGAAACCCCATCTCTACTAAAAATACAAAAAAATTAGCCAGGCATGGTGATGCACGCCTGTAATCCCAGCTACTTGGGAGGCTGAGGCAGGAGAATCACTTGAACCCAGGAGGCAGAGGTTACAGTGAGCCGAGATCATGCCATTGCACTCCAGCCTGGATGACAGAGTGAGCCTCTGTCTCAAAAAAAAAAAAAAAAAAAAAAAAAAA"
"GL873587","6484004","6484128","chr10","67341428","67341546","29","60857424","GACCAGGTTCTGTGGCTCATGCTTGTAATCCTAGCACTCTAGGAGGCCGGAAGAGGGTGGATTGATTGCCTGAGGTCAGGAGTTAGAGACCAGCCTGAGCAAGAGCTAGACCCTGTTTCTTTCTT","GGCTGGGTGTAGTGGCTCATGCCTGTAATCCCAGCACTTTAGGAGGCCAAGGTGGATGGATTGCCTGAGCTCAGGAGTTCGAGACCACCCTGGGCAACAAGCCAAAACCCTGTCTCTAC"
"GL873587","6484407","6484586","chr3","167196537","167196723","48","160712130","TAGACCCTGTTTCTAAAAAAAAAATAGCCAGGTGTTGAGGCAGGTACCTGTAGTCCCAGCTACCTGGGAGGGCTGAGGCAAGAGAATCGCTTGAACCCAAGAGTTTGAGGTTGCTGTGAGCTGAGATGCTATGGCACTCAACCGTGAGCTACAAAGTGAGACTCTGTCTCAAAAAAAAAA","AAAACCTGTCTCTGCTAAAAATACAAAAATTAGCCGGGTGTGGTGATGTGCGCCTGTAGTCCTAGCTACTTGGGAGGCTGAGGCAGGAGAATCACTTGAATCCAGGAGGTGGAGGTTGTAGTGAGTCGAGATCGTGCGACTGCACTCCAGCCTGGGTGACAGCGAGACTCTGTCTCAAAAAAAAAAA"
"GL873587","7466229","7466364","chr1","29437872","29437991","35","21971643","GGCCAGGCGTGGTGGCTCATGCCTGTAGTCCCAGCGCTATGGGAGGCCGAGGTGGGTGGATCACCTGTGCTCAGAGGTTCGAGACCAGCCAAGACCCCCCTGAGCCAAATGAGCCAGAGTGAGATCCCATCTCTAC","GGCCGGGCGTGGTGGCTCACGCCTGTAATCCCAACATTTTGGGAGGCCAAGGCGGGTGGATCACCTGAGGTCAGAAGTTCGAGACCAACCTGGCCAACATGGTGAAACCCCTGTCTCTAC"
"GL873588","1502535","1502718","chr1","34852429","34852590","60","33349894","GGTGCAGTGGCTCACACCTGTTGTCCCAGCGCTGTGGGAGGCCGAGGTGGGTGGATCACCTGTGCTCAGAGGTCGAGACCAGCTGAAGACCTGCCTGAGGCAGAGTGAGCCAGAGTGAGACCCCGTCTCTACTAGAACAACAACAAGACAGCCAGACCTTGTGATCCCAGCTACATGGGGGGCT","GCCAGGTGCAGTGGCTCACACCTGTAATCCCAGCACTTTGGGAGGCCGAGGCGGGCGGATCACCTGAGGTCAGGAGTTTGAGACCAGCTTGACCAACATGGAGAAACCCCGTCTCTACTAAAAATACAAAATTAGCCTGGTGTGGTGTCGCATGCCTGTAAT"
"GL873588","10189037","10189246","chr3","45604681","45604903","65","35415644","GCTGAGATGAGGAGACTCTGTCTCTATTAAAAATAGAAAAATTGGGTGGATGTTGTGGGTACTGTAGTTGCAGCCTCTTGGGGGGCTAAGGCAGGAGGATCAGTTGAAGCCAGGAATTTGCTTTGAGCTAGGCTAAAGCCATGGCACTCTAGCCTGGGCAACAGAGTGAGGCTAGATCTCAAAAAAAGAAAGAAAAGAAAAAGAAAAAAA","CTGGCCAACATGGCAAAACCCCATCTCTACTAAATATACAAAAATTAGCTGGACGTGGTGGCACATACCTGTAATCCCAGCTACTTGGAAGGCTGAGGCAGGAGAATAGCTTGAACCTGGGAGGCAGAGGTTGCAATGAGCTGAGATCACGCCACTGCACTCTAGCCTGGGCAATAGAATGAGACTCTGTCTCAAAAAAAAAAAAAAAAAAAAAGACAAGAAA"
"GL873589","104719","104807","chr20","27900350","27900437","13","27795631","GGCTGGGCGTGGTGGCTCATGCCTGTTGTCCCAGCGCTGTGGGAGGCTGAGGTGGGTGGATCACCTGTGCTCAGAGGTTCGAGACCAGC","GGCCGGGCGTGGTGGCTCATGTCTGTAATCCCAGCACTTTGGGAGGCCGAGGTGGGTGGATCACCTGAGGTCAGGAGTTCAAGACCAG"
"GL873589","796766","796905","chr1","166346372","166346487","49","165549606","GGCTAAGTGTGGTGGCTCACACCTGTCATCTAGTACTTTGGGAGGGTGGGCCTGGGAGTTCAAAGACTGAACTCAGGAGTTCAAGGTGGCTCCGGGGAGGAATTCAAGACCAACCTGAGCCAGAGCGAGACCTCGACTCT","GGCCAGTGGGGTGGCTCACGCCTGTAATCCCAGCACTTTGGGAGGCTGAGGTGGTCAAATGACCTGAGGTCAGGAGTTTGAGACCAACCTGGCCAACATGGTGACACCTCGTCTCT"
"GL873589","1023679","1023690","chr1","205890061","205890072","1","204866382","AAAAAAAAAAAA","ACAAAAAAAAAA"
"GL873589","1023771","1024047","chr4","103012712","103012993","70","101988941","GGCTTGGTGGCTCACACCTGTAATCCTAGCACTCTGGGAGGCCGAAGTGGCTGGAATACTTGAGGTCAGGAGTTCAAGACCAGCCTAAGTGAGAGTGAGATCCCCATCTCTAATAAAAATAGAAAAATTAGCAGGGTGTTGTGGCTGGCACTTGTAGTCCCAGCTACCCAGGAGACCGAGGCAGAAGTTTGAGATTATTGTGAGCGAGGCTGATGCCACAGCATTCTAGTGGGACAACAGAGCAAAATTCTATCTCAAAAGAAAAAAAAAAAAAGGA","CGGGCGTGATGGCTCACGCCTGTAATCCCAACACTTTGGGAAGCCGAGGCGGACGTATCACCTGAGGTCAGGAGTTCAAGACCAGCCTGGCCAACATGGTGAAACCCCGTCTCTACTAAAAATACAAAAATTAGCTGGGTGTGGTGGCATGCGCCTGTAATCCCAGCTACCCAGGAGGCTGAGGCAGGAGAATCGCTGAGGCTGCAGTGAACTGAAATTGTGCCACTGCACTCCAGCCTGGGTGACAGAGCAAGACTCTGTCTCAAAAAAAAAAAAAAAAAA"
"GL873589","4820958","4821024","chr8","33633747","33633811","15","28812789","TTAGTCAAGTGCAGTGGCTCACACCTGTCATCCCAGCTACTTGGGAGGCTGAGGCAGGAGAGTTGCT","TTAGCCAGGTGTGGTGGTGCATGCCTCTAATCCCAGCTACTCAGGAGGCTGAGGCAGGAGAATTG"
"GL873589","6763768","6763857","chrX","25814002","25814092","29","19050234","GGTGTGGTGGCTCACACTTGTATCTTAGCATTTTAGGAGGCTGAATGGGGAGAATTGCTTTAAGTCAGGAGTCTGACTTCCACCTTGCCA","GGCTGGGAATGGTGGCTCACACCTGTAATCCCAGCACTTTGGGAGGCTGAGGTGGGCAGATCACCTGAGGTCAGGAGTTTGAGATCAGCCT"
"GL873589","8444551","8444632","chr9","93194085","93194171","17","84749534","CGGGCATGGTGGCTCACAACTATAATCTTAGCACTTTGGGAGGCTGAGACAGGTGGATGCCTGAACTCAAGAGTTTGAAACC","GGCCGAGCATGGTGGCTCACACCTGTAATCCCAGCACTTTGGGAGGCTGAGGCAGGTGGATTACCTGAGGTCAAGAGTTCAAGACCA"
"GL873589","9085365","9085494","chr2","194063347","194063481","42","184977982","GGCCAGGCACAGTGGCTCACACCTATAATCCCAGCACTCTGTGAGACTGAGGCAGGTGAACTGTTGCAAGAGTGAGACCCTGTGCTTGGTGCCTGTAGCTCAGTGGTTAATAATAAGAAAAAAGAAAAAA","GGCCAGGTGCAGTGGCTCACACCTGTAATCCCAGCACTTTGGGAGTCTGAACCAGGCAGATCACCTGAGGTCAGGAGTTCGAGGCCAGCTCGGCCACCATGGTGAAACCCTGTTTCTAATAAGAATACAAAAAAA"
"GL873589","9085767","9086002","chr7","84631446","84631650","75","75545679","GAGTGAAACCCTGTCTCTACTAAAAATAGAAAAACTAGCTGTGCATCAGGGCGCATAACTGTAGTCCCAGGTACTCAGGACACTGAGGCAAGAGAATTGCTCAAGCCCAAGAGTTTGCAAGAATTTGAGGTTGCTATGAGCTATGATGCCATGGCACTCTACCTAGGGTGACAGACAGAGACTCTGTCCCAAAAAAAAAAAAAGAAGAAGAAGAAAAAAAAAAAGAAAGAAAGAAA","ATAGTGAAACCTCGTCTCTACTAAAAATACAAAAATTAGCTGGGCATCATGGTGCACGCTTGTAATTCCAGCTACTTGGGAGGCTGAGGCAGGAGAATTGCTTGAACTCAGGAGGTGGAGGTTGCAATGAGCCAAGATCGCGCCACTGCACACCAGCCTGGGTGACAAAAGACTCTGTCTCAAAAAAAAAAAAAAAAAAAAAAAA"
"GL873589","9992904","9993045","chr16","56427538","56427666","46","46434634","AACCAGCCAGGCATGGTGATTCACACCTATAATCCCAGCTACTTAGGAGTATGGCTTGAGCACACAGGATACCATACCATTCTAGTCATCCCAGGCAACAGAGGGAAACTCTGTTGGTTAAAAAAAAAGAAAAACTTAAAAA","TTAGCCAGGAGTGGTGGTGCACGCCTATAATCCCAGCTACTTGGGAGGCTGAGGCACAAGAATCACTTGAACCATTGCACTCCAGCCAGGGTGATAGAGGGAGACTCTATCCAAAAAAAAAACAAAAAA"
"GL873589","9993319","9993452","chr3","2774534","2774668","28","7218785","GGCCTGAGCCCTGTGACTCATGCCTGTAATCCCAGCACTGGAAGTTCCAAGGCAGGTGGATCGCTTGAGCTCTGGAGTTCAAGACCAGCTCAACCAAGAGTAAGACCCCATCTCTACTAAAAATAGAAAAACCA","GGCTGGGCACGGTGGCTCATGCCTGTAATCCCAGCACTTTGAGAGGCCGAGGCAGGTGGATCTCCTGAGGTCAGGAGTTCAAGACCAGCCTGGGCAACATGGTGAAACCCCATCTCTACTAAAAATACAAAAAAT"
"GL873590","9044589","9044884","chr1","83754525","83754835","84","74709936","GGCCAGGTGCAATGGCTCATGCCTATAATCCTCACACTCTGGGAGGCTGAGGCAGGAGGATCACTTTTCTCAGGGTCAGGGCCAGCCTGACAAAAGTCAGACCCTGTTTCTACTAAAAATAGAAAAACTAGCTGGGTGTTGTGGCAGATGCCTATAGTCCCAGCTACTAAGAGACTGAGACAAGTGCCCAGAGTCTGAGGTTACTGTGAGCAAAGCTGATGCCATAGCATTCTAGCTATAGATCGAGAGTCTGTCTCAAAAACAAACAAACAAACAAACAAACAAACAAAAAAGAA","GGCTGGGTGTGGTGGCTCATGCCTGTAATCCCAGCACTTTGGGAGGCCGAGGCGGGTGGATCATCTGAGGTCAGGAGTTCAAGACCAGCCTGACCAACATGGTGTAACCCTGTCTCAACTAAAAATACAAAAATTAGCTGGGCGTGGTGGTGTGCACCTATAGTCACAGCTACTTGGGAGGCTGAGACAGGAGAATTGCTTCAACCCAGGAAGTGGAGGTTGCAGTGAGCCAAGATCATGTCACTGCACTGCAGCCTGACAGAGCGAGACTCCATCTAAAACAAACAAACAAAAACAAACAAACAAACAAA"
"GL873591","1831505","1831587","chr17","61702818","61702899","25","59871313","CCCAGCACTTTGGGAGGGCAAGATGGGAGAATCATATAAAGTCAGGAGTTTGAGACCAGTTTGGCAGACATGATGAACCCATC","AATCCCAGCACTTTGGGAGGCTGAGGCAGGCGGATCATCTGAGGTCAGGAGTTCAAGACCAGCCTGGCCAACATGGTGAAAC"
"GL873591","2719175","2719275","chr4","86137755","86137847","32","83418580","GTGGGGGCTTAGGCCTGTAATCCCAGCACTCTGAGAGGCCAAGGTGAGCTGGTCACCTGGGTTTAGGAGTTTGGAGACTTGCTCGAGCTAGACTGAGGCTC","GTGGTGGCTCACGCCTGTAACCCTAACAATTTGGGAGGCCAAGGCAGGTGGATCACTTGAGGTCAGAAGTTTGAGACCAGCCTGGACAATATG"
"GL873591","4732974","4733120","chr19","7991801","7991954","55","3258827","ATACGCAGACTGGCCGAGCGTGGTGTCACATGCCTATAATCCCAGTGGCTACTCTGGGGAGGAGAATCTCTTGAAACCAAGAGTTAGAGATTGCAGTGGGGTATGATACAGGGTAACAAAGAGAGACCTTGGATCTGAAAAGAAAAA","AAAATACAGAAACTAGCTGGGCATGGTGATGCACACCTGTAATCCTAGCTACTGGGGAGGCTGAGGCAGGAGAATTGCTTGAACCCAGGAGTCAGAGGTTGCAGTGAGCAACCAGCCTGGGTGATACAGTGAGTGAGACTCTGTCTCGAAAAAA"
"GL873591","6822728","6823009","chr1","20579766","20580052","72","13757038","GGCCAGGCGTGGTGGCTCATGCCTGTAAATCTCAGCACTCTGGGAAGCTGAGGCAGGTGGATTGCTTGAGGTCAGGAGTTTGAGACCAGCCTGTACCAGAGTAAGACCCTGTCTCTAATAAAAATAGAAAAAAAAAAAAAAACTAGTTGGGCATGGTGATGGGTGCCTGTAGTCCCACCTACTTGGGAGGCTGAGGCAATGGCATCTCTTGAGCCCAAGAGTTTGAGGTTGCTGTGCCATGGCACTCTCCCCAGGGTAACAGAGTGAAAATAAAAAAAAGAA","GGCCAGGCGTGGTGACTCATGCCTGTAATCTCAGCACTTTGGGAGGCCGAGGCAGGTGAATCACCTGAGGTCAGGAGTTTGAGACCAGCCTGACCAACATGGTGAAACCTCGTCTCTACTAAAAATACAAAAAGTAGCCAGGCATGGTGGCGCATGCCTGTAATCCCAGCTACTTGGGAGGCTGAGGCAGGAGAATCGCTTGAACCCGAGAGGCAGAGGTTGCATTGAGTCAAGATGGTACCACTGCACTCCAGCCTGGGTGACAGATTGAGACTCAAAAAAAAAAA"
"GL873591","7578706","7578813","chr16","45055441","45055543","42","37476735","AAATTTAGCTACACATAGTGGCATGAGTCTGTAATGCTAGCCACCCAAAAGGCTGTAGTAAGAGGATTGCTCTATCCCAGGAGTTAAAGACCAGCCCGGACATCAGAG","AATTAGCCGGGCGTGGTGACACACACTTGTAATCCTAGATACTCAGGAGGCGAAGGTAGGAGAATTGCTTGAACCCAGGCAGCAGAGGTTGCAACGAGCAGAG"
"GL873591","9282916","9283004","chr1","20744253","20744338","16","11461337","GGCCAGGCGCGGTGGCTCACCCCTGTTGTCCCAGTTCTGTGGGAGGCCGAGGTGGGTGGATCACCTGTGCTCAGAGGTTTGAGACCAGC","GGCCAGGCACGGTGGCCACGCCTGTAATCCCAGCACTTTGGGAGGCCGAAGTGGGTGGATTACCTGAGGTCAAGAGTTTGAGACCA"
"GL873592","835155","835315","chr16","75654291","75654451","43","74819136","CTGGGTGTGGTGGCTCTTGTCTGCAATCTCAGTACACTGGGAGGCTGAGGCAGAAGGATTGCTCCAGCTCAGGAGTTTGAGGCCAGGCTGAGCTAGTGCAAAACCCCATCTCTACTAAAAAAAGAAGGAAAAAAAAAAGAAAAAGAAAAAAAATACGAGCT","CCAGGTGTGGTGACTCACGCCTGCAATCCCAGCACTCTGGGAGGCTGAGGTGGGTAGATTACCGGAGGTTAGGCGTTTGAGACCAGCCTGGCCAACATGGTGAAACCCCATCGCTACTAAAAAAAAAAAAAAAAAAAAAAAAAAAAAAAAAAAAAAAATTA"
"GL873592","835589","835765","chr1","66836166","66836336","48","66000577","ACAAAAAACCTAGCTTAGGGTTGTTATAGCACCTGTAGTCCCAGCTACTCAGGCGCTAAGGCAGGAAAATCTGCCTGAGCTCAGGAGTTTGAGGTTGCAGTAAGTTATGATGATGCTACTGCACTCTAGCTGGGGCAACAGAGTGAGACTCTGTCTGAGGAAAAACCAAAACCAAAA","TAGCCCAGCACGGTGGCTCACACCTGTAGTCTCAGCTACTCAAGAGGCTGAGGCATGAGAATCGCTTGAACCCAGGAGGTAGAGGTTGCAGTGAGCTGAGATCATGCCACTGCGCTCCAGCCTGGGCAACAGAGTGAGACTCAGTCTCAAAAAACAAAACAAAACAAAAAA"
"GL873592","2520661","2520705","chr16","66853217","66853257","11","64332556","TCTGGGAGGCTGAGGCGGGTGGATCACCTGAGCAAGAGTGAGACC","TTTGGGAGGCTGAGGCAGGTGGATCACTTGAGGTCAGGAGT"
"GL873592","4535248","4535388","chr1","12240468","12240612","38","7705220","GGCGGGATGTGGTGGTTCATGGCTGTAATCCCAGCACTCAGGGAGGCTGAGTCGGGTGGATTGCTTGAGTTCAGGAGTTTGAGACCAACCTGAGCAAGAACTAAGCCTGTCTCTACTAAAGATATTATTTCTTATTTTTCT","GGCCGGGCGCGGTGGCTCATGCCTGTAATCCCAGCACTTTGGGAGGCTGAGGCGGGTGGATCACCTGCGGTCAGGAGTTCGAGACCAGCCTGGCCAACGTGGTGAAACCTCATCTCTACTAAAAATATAAAAATTAGCTGGTGTG"
"GL873592","4535654","4535831","chr8","126054004","126054184","54","121518350","TCTACTACAAATATTAACAGAAAAATTAGCTGGGCATTGTGACAGGTGCCTATAGTCCCAGATACTCAGAAGGCTGAAGTAAGAGGATCACTTGAACCCCAGGAGCTAAGGTGGCTGTGAGCTAGGCTGAGGCTCTAGCCTGGGTAACAGAGTGAGACTGTAAAAAAAGAAAGAGAGA","GTCTCTACTAAAAATACAAAAATTAGCTGGGTGTGGTGGTGCATGCCTGTAATCCCAGCTACTCAGGAGGCTGAGGCAGGAGAATCGCTTGAACCCAGGAGGTAGAGGTTGCAGTGAGCCAAGATCATGCCACTGCACTCCAGCCTGGGTGACAGAGGGAGACTCTGTCTCAATAAATAAA"
"GL873592","6794968","6795049","chr3","154764711","154764794","20","147969743","GAAGGTTTGATGAGCTCAGATGATGCCACTGCAGTCTACCCAGAGTGAAGGAGCGAGACTCTGTCTCAAAAACAAAAAAAGA","CAGAGGTTGGCAGTGAGCTGAGACTGTGCCACTGCACTCCAGCCGGGTGACAGAGTGAGACTCTGTCTCAAATTACAAACAAAA"
"GL873592","6881384","6881478","chr5","24882384","24882475","28","18001000","GGGCAGGCATAGTGACTGGTGTCTCTAATCCTAGCAGTCTGGGATGCTGAGGCAAGTGGAATGTCAGAGTTCAGGAGTTGAAGATCACCCTGACT","GGCCGGGCGCAGTGGCTCACATCTATAATCCTAGCATTTTGGGAGGCTGAGGCAGGCGGATCACCTGAAGTCAGGAGTTTAAGACCAGCCTG"
"GL873592","6881755","6881937","chr10","61601371","61601572","66","54719616","TCACCCTGACCAAGAGCAAGACCCTGTCTCTACTAAAAATAGAATAAACTAGCTGGGAATTGTGGTGGGTGCCAGTAGTCCCCGCTACTGAGGCAGGAGGATCATTGAGTCCAAGAGTTTGAGGTTGCTGTAAGTTAGGACACCACAGCACTCTACACAGAGTAAGACTGCCTCAAAAATAAA","AGTAAAGAAAAGAAACCCTGTCTCTACTAAAAATACAAAAATTAGCTGGGTGTGGTGGTGCGCACCTGTAGTCCCAGCTACTTGGGAGGGTGAGGTATGGGAATCACTTGAACCCGGGAGGTGGAGGTTGCAGTGAGCCAAGATCACACCACTGCACTCCAGCCTGGGTGAGAGAGTGAGACTCTGTCTCAAGAAAAAAGAA"
"GL873592","7006080","7006155","chr1","8947061","8947129","24","1940981","CACACTGAGAGGCAAAGGCTGGTGGATCACCTGAGCTCAAGAGTTTGAGACCAGCCAAGCCAGAGATCTTGTCTCT","CACTTTGGAGCCAGGTAGGTGATCACCTGAGTCAGGAGTTCGAGACAGCCTGGCCAACATGTGAAACCC"
"GL873592","8446508","8446655","chr11","122502739","122502874","48","114056231","TTAGCTGGGTGTTGTGGCAGGCACCTGTAGTCCCTCCCAGCTACTTGAAAGGCTGAGGCAAGATGACAGCTTAAACCCAAGAGTTTAAGGTTACTCTATTCAGGGCAACAGAGTGAGACTCCATCTACATAAATAAATAAATAAATAA","GGCTGGGCGTGGTGGTTCACACCTGTAATCCCAACACTTTGGGAGGCTGAGGCCAGCGGATTGCCTGAGCCCAGGAGTTTGAGACCAACCTGGGCAACATGGTGAAACTCCATCTCTACTAAAATACAAAAAGTTA"
"GL873592","8446953","8447008","chr16","44513352","44513404","15","36066399","GACCAGCCTAAGCAAAAAAGAGATCCTATCTCTACTACTAAAAATAGAAAAAATTA","ACCAGCCTCACCAATATGAAGAAACCCCATCTCTACTAAAAATACAAAATATT"
"GL873592","8447239","8447325","chr1","8062863","8062957","21","384376","GGCCAGGAGCAGTGACTCATGCCTAGCACTCTGGGAGGCCAAAGCAGGTGGATCAACTGAGCTCAGGAGTTCAAGACCAGCCTAAGC","GGCCGGGTGCAGTGGCTCATGCCTGTAGTCCCAGGACTTTGGCAGGCCAAGGCCGGTGGATTACCTGAGGTCAGGAGTTCAAAACCAGCCTAGCC"
"GL873592","8723925","8724000","chr3","42066983","42067054","20","33343058","AATTAGCCGGGCATGGTAGTGTGTGCCCATAATCTCAGCTACTCAGAAAGCTAAGATAGGAAAATTGCTTGAGCTC","TTAGCTGGGTGTGGTAGTGCATGCCTATAATCCCAGCTACTCGGGAGGCTGAGGTGGGAGAACTGCTTGAAC"
"GL873593","384022","384146","chr15","102382935","102383070","28","101998913","GGCCACGAGGGCCCATGCCTGTAATCCTAGCACTCTGGGAGGCTGAGGTGAGTAGATTGCTGAGCTCAGGAGTTCAAGACCAGCCTGTGCAAGAGACCCCATCTCTGCTAAAAATAGAAAAACCA","GGCCAGGTGTGGTGGCTCACGCCTGTAATCCTAGCACTTTGGGAGGCTGAGGCGGGTGGATTGCCTGAACTCAGGAGGTCAAGACCAGCCTGGGCAACACAGTAAAACCCCATCTCTACTAAAATACAAAAAATCA"
"GL873593","384425","384607","chr20","28286874","28287058","50","27902449","GAAAGAAAAGAAAAGAAAAACTAGCAAGATGTTGTAGCTGATGCCTATAATCCTAGCTATTGGAGAGGTGGAGGCAAGAGAATTGCGTGAGCCCAAGAGTTGAAGGTTGCTGTGAGCTGCGATGCCAGAGCACTCCAGGGTGACAGAGTAAGACTCTGTCTCAAAAAAAATTACAAAATAAAA","TAATAAAAATAAAAAAATTAGCCAGGAGTCAAAGCACACGCCTATAACCCCAGCTACTTGGGAGGCTGAGGGAGGAGAATTACTTGAACCCGGGAGGTGAAAGTTGCAATGAGCTGAGATCAAGCCACTGCACTCCAGACTGGATGACAGAGTGAGACTCTGTTTCAAAAAAAAAAAAAAGACAA"
"GL873593","1408445","1408467","chr10","88070368","88070389","9","86661923","AATCTAGAGATGGGGAGAGGTTG","AAAGAGATGGAAGAGAAGAAGA"
"GL873593","4856365","4856484","chr7","56497314","56497433","31","51640949","GCAATCCCAGCTGATCGGGAGGCTGACCCAGAAGAATCCCTTGAACCCAAGAGTCTGAGGTTGCTATGGGTGGATTCTACAGCACTCTAGCCTGGGAGACAGAGTGAGACTCTGTCCCAA","ATCCCAGCTACTTGGGAGGCTGAGACAGAAGAATTGCTTGAACCCGGGAGGTGGAGGTTGCAGTGAGCCAAGATTGTACCACTGCACTCCAGCCTGGCAACAGAGTGAGACTCTGTCTCA"
"GL873593","6661298","6661485","chr10","86749316","86749514","55","80088018","GCAGAGGCTCACATATGTAATCCTAGCACTCTGGGAGGATAAGGCAGGTGGACAGCTTGAGCTCAGGGGTTTGACCAGTCTGATCAAGAGCAAGACCTGTGTCTACTAAAAATAGAAAACCTAGCCAGGTATGATGGTAGATGCCTGTATTCCTAGCTACTCTGGAAGCTAAAGCTAAAGAGTTTGAA","GGTGGCTCACACCTGTAATCTTAGCAATTTGGGAGGCCGAGGTGGGTGGATCACTTGAGGTCAGGAGTTTGAGACCAGACTGGCCAACATGGTGAAACTCTGTCTCTACTAAAAATACAAAAATTAGCCAGTCATGGTGGTGCATGCCTGTAATCCCAGCTACTCAGGAAGCTTAGGCAGGAGAATCACTTGAACCCAG"
"GL873593","6710263","6710446","chr14","4390080","4390244","66","2320183","TTGAAGTCAGGAGTTTAAGGCCAGTCTGGGCAACATAGTGAGACCCCCATCTCTACGAAAATATTTTTTAAAAATTAAAAATAGCTGGGCATAGTGAGGCTGTTGTGAGCTATAACTGCACCACTGCACTCAGCCAAGGACAGAGACCCTGTTCCCTGCCTCAAACAAACCAAAACAAAACAAA","AAGTCTAGAGTTTACAGCCTGGACAACGCAGTGAAACCCTGTCTCTACCAAAAATACAAAAATTAGACAGGTGTGAGAGGCGGAGGTTGCAATGAGCTGAGATCGCAGCACTGCAGTCCAGCCTGGATGACAGAGCGAGACCCCATCTCAAAAACAAAAACAAAA"
"GL873593","7159645","7159716","chr6","178318394","178318465","21","171158749","GATCATGTCACTGCTCTCCAACCTGGGCAATTGAGCAGGAATCTGTCTCAAAAAGAAAAAAAAAAAAGAAAA","CGAGTTCACACCACTGCACCCCAGCCTGGGCAACAGAATGAGACTCGGTTTCAAAAAAAAAAAAAAAAAAAA"
"GL873593","7159841","7160050","chr13","33368171","33368368","69","26208330","GGCCAGGCGTGGTGGCTCACACCTGTTGTCCCAGTGCTGTGGGAAGCCGAGGCAGGTGGATCACCTGAGCTCAGCCGAGTTCGAGACCAGTGGAAGACCAGCATGAGGCAGAGTGAGCCAGAGTGAGACCCCATCTCTACAACAACAACAAGAAGAAAAAAAACAGCCGGACCTTGTGATCCCAGCTACGTGGGGAGCTAGAGAATCACT","GGCTAGGCATGGTGGCTCATGCCAGTAATCCCACCACTTTGGGAGGCCGAGGCAGGTGGATCACCTGAGGTCAGGAGTTCAAGACCAGGCTGGCCAACATGTTATGATGAGACCCTCATCTCTACTACAAATACAAAAATCAGCTGGGCATGGTGGCAAGTGCCTGTAATCCCAGCTACTTGGGAGGCTGAGGCAGAA"
"GL873593","8598292","8598391","chr11","118461023","118461129","33","109862731","AGCCAGGTGAGGTGGTTCACACCTGTAACCCTAGCTGCTTGGGAGGCTGAGGCCTCTCTATCCTGGGCAGTGTGGAGAAACTTTGTTTCAAAAAAAAGAA","GCCGGGCGCGGTGGCTCACGTCTGTAATCCCAGCGCTTTGGGAAGCCGAGGCGGGACTATCCTGGCCAACATGGTGAAACCCCGTCTCTACTAAAAATACAAGAATC"
"GL873594","357249","357377","chr2","75702890","75703011","36","75345641","CCTGGTACCGTAGGTCATGCCTGTAATCCTAGCACTTTGGGATGCTGAGGTGGGCAGATTGCCTGAGCTCACGAGTTCAAGCCATTAGAACTGAGCCTGACCTAGAGTGGGACCTCCAACTCTTTTTTT","GCCAGGCACAGTGGCTCATGCCTGTAATCCCAGCAGTTTGGGAGGCTGAGGTGGGCAGATCACTTGAGGTCAGGAGTTCAAGACCAGCCTGGCTGACATGGTGAAACCCCATCTATACCAAA"
"GL873594","357656","357834","chr7","17608776","17608965","55","17251120","GGGACCTCCAACTCTTAAAATAGCTGGGCATTGTGGTGGGCACCTACAGTCACAGCTACTTGGGAGGCTAAGGCAAGAGACTTGTTTGCAGCCAAGAGTTAGAGGTTGCTGTGAGCTATGAGGCTAGGGCACTCTACAGGGGGCGACAAGTGAGACTGTAAAAAAAAAAAAAGAAAAAA","GTCCCTACTAAAAATACAAAAAATTAGCTGGGCCTGGTGGCAGGCACCTGTAATCCCAGCTACTTGGGAAGCTGAGGCAAGAGAATTGCTTGAACCCAGGAGGCAGAGGTTGCAGTGAGCTGACATCAAGCCACTGTACTCCAGCCTAGGCAACAAGAGCAAGACTCTGTCTCAAAAAAAAAAAAAAAAA"
"GL873594","1410711","1410996","chr5","151340503","151340797","76","149929792","CACAGTGGCTCATACCTATAATCCTAACACTCTGGGAGGCCAAGGTGGGTGGACTGTCTGAGTTTGGGACCAGCCTGAGCAAAAGCAAGACTCCCATCTCTACTAAAAACAAAGACAGCCAGGTATGAGGGCAGGTGCCTATCATCCCAGCTACTTGGGAGGCTGAGGAAGGAGGATCACCTAAGCCCAGGACTTTAAGGTTTCTGTGAACTAAGATGATGTTACAACACTCTAGCCAGGGTAACAAGGCAAGATTCTGTTTCAAAAGACAAAAAAAAAAAAAAAA","GGTGGTTCATGCCTGTAATCCCAGCACTTTGGGAGGCTGAGGCAGGTGGATCACCTGAGGTCAGGAGTTCGGGACCAGCCTGGCCAACATGGGGAAACCCCATCTCTACTAAAATACAAAAATTAGCCAGGTATGGTGGCACATGCCTATAATCCCAGCTACTTGGGAGGCTGAGGCAGGAGAATCACTTGAACCCAGGAGGCTAAGGTTGCAGTGAGCCGAGATTGTGCCACTGTACTCCAGCCTGGGTGACAGACTGAAACTCTGTGTCCAAAAAACAAAACAAAACAAAAAA"
"GL873594","5528090","5528162","chr2","69013639","69013718","24","63485549","GGTACAGTGGCTCACGCTTGTGATCCCAGGTTGAGGTGGGTGGATCGCCTGAGCTCAGGAGTTGGATGCCAGC","GGTGTGGTGCCTCACGCCTATAATCCCAGCACTTTGGGAGGCAGGTGGATCACTTGAGGTCAGGAGTTTGAGAACAGCCT"
"GL873594","5834047","5834168","chr2","82491537","82491662","28","76657490","GGCTGGGCCCAGTAGCTCACGACTGTAATCCCAGCACTCTGGGAAGCTGAGGTGGGCGGATCACCTGAGCTCATAGGTTCGAGACCAGCTCCAGTTAGAGTGAGAGCCTGTCTCTAAAAATA","GGCTGGGCACAGTGGCTCATGCCTGCAATCCCAGCACTTTGGGAGGCTGAGGTGGGCAGATCACCTGAAGTCAGGAGTTCAAGACCAGCCTGGCCAACACAGTGAAACCCCATCTCTACTAAAAAT"
"GL873594","5834396","5834461","chr13","14688151","14688212","20","8853755","TATATAATAATAATAACCAGGTATTGTGGCAGGTGCCTCTAGTCCCAGCTACTCGGGAGGCAAAGG","ATAAAAAAATTAGCTGGCCATGGTGGCACATACCAATAATCCCAGCTACTCAGGAGGCTGAG"
"GL873594","7786130","7786294","chr14","12217087","12217250","37","4430957","GGGTGTGCTGGCTCATACCTATAATCCTAGCACTCTGGGAGGCTGAGGTAGGTGTATTGCTTGAACCCAGGAGTCTGAGGTTGCTGTGCGCTAAGCTGATACCATAGCACTCTAGCCTGGGCAACAGAGTGAGACTCTGTCTCAAAACAAATAAATAGTAAAAAA","GCTGGGCGTGGTGGCTCACACCTGTAATCCCAGCACTTTGGGAGGCCAAGGCATGAGAATTGCTTGAAAACAGGAGGCGGAGGTTGCAGTAAGCTGAGACTGTGCCATTGCACTCCAGCCTGGGCAACAAGAGTGAAACTCTGTCTCAGAAAAAAAGAAAAAAA"
"GL873595","723579","723774","chr19","6045933","6046125","65","5322354","GCCTGAGCAGGAGAGAGACCCCATCTCTGCTGAAAGTGGAAAAGTTGGCTGAGTGTAGTGGCGGGCTGCTGCCCCAGTCACTCAGGAGGCTTAGGAAGGAGTATCGCTTGGGCCCAAGATTTGAGGTTGCTGTGAGCGCTACAAAGACATTAGGGTACTCTACACAGGGGAATAGAGTGAGACTGTCTCAAAAAAA","CAACATGGAGAAACCCCGTCTCTACTAAAAATACAAAATTAGGCAGCGTGGTGGTGGGTGCCTATAATCCCAGCTACTCAGGAGGCTGAGGCAGGAGAATCGCTTGACCGGGAGTGGAGGTTGCGGTGAGCTGAGATTGCACCATTGCACTCCAGCCTGGGCAACAAGAGTGAAACTCCGTCTCAAAAAGAAA"
"GL873595","724114","724204","chr20","18199749","18199840","22","17475635","GGCCATGCTTGGTGGTTCTCATCTGTAATCCTAGCACTCTGGAAGGTCTACAGGGGTGGATGGCTGGAGGTCAGGAGTTCAAGACTGGCCT","GGCCGGGCATGGTGGCTCACACCTGTAATCCCAGCACTTTGGGAGGCTGAGGCAGGCGGATCACCTGAGGTCAGGAGTTCGAGACCGGCCTG"
"GL873595","1065346","1065667","chr18","10529729","10530057","74","9464383","GGCCAGGTGCAGCAGCTCATGCCTGGAATCTTCCTGCTCTGTATGGCCAAGGCAGGTGGATCGCCTGACCTCAGGAGTTCCAGACCAGCCTGAACAAGAGCAAGACTCTGTCTCTACTAAAAGTAGAAAAAAAACTAGCCAGTCATAGTGGCAGGTGCCTGTAGTCCCAGCTGCTTGGGAGGCTGAGGCAAGAGGATCACTTGAACCTAAGAGTTTGAGGTTGCTGTGAGCTAAGATGCCACATCACTCTATCAAGGGTGACCAAGTGAGACTCTGTCTCAAAAATAAATAAATAAATAAATAAAAAGAAAGGCAAAAAGAA","GGCCCGGCGTGGTGGCTCATGCCTATAATCCCAGCCCTTTGGGAGGCCAAGGCAGGTGGATCACCTGAGGTCAGGCGTTCGAGACCAGCCTGACCAACGTGGTGAAACCTCATCTCTACTAAATACAAAAAAAATTTAGCCAGGCATGGAGGCACATGCCTGTAATCCCAGCTACTTGGGAGGCTGTGGCAGGAGAATCACTTGAACCTGGGAGGTGGAAGTTGCAGTGAGCTGAGATTGTACCACTGCACTCCAACCTGGGTGACAAAGCAAGACTCGGTCTCAATAAATAAATAAATAAATAAATAAATAAATAAAGTGAAAAAAAA"
"GL873595","1254878","1255146","chr4","42822326","42822607","67","41567448","GGCTGGGCATGGTGGCTCATGCCTGTAATCCTACCGCTCTGGGAGGCTGAGGCAGAGGATCACTTGAGCTCAGGAGTTTCAGACCAGCCTGCAAGAAGGACCCAGTCTCTGCCGAAAATAGAAAAGTTAGCAAGGCGTTGTCGTGAGCACATGTATCCCAGCTACCTAGAACTCTGAGGCAGGAGGATCCCTTGAACCCACAGAAGTTGCTGTTATCTAAACTGATGCCACTGGACTCTAGCCTGGGCAACAGAGTGAGACTGGTCTCA","GGCCGGGCACGGTGGCTCATGCCTGTAATCCTAGCATTTTGGGAGGCTGAGACAGGCAGATTGCCTGAGCTCAGGAGTTCAAGACCAGCCTGGGCTAGATTGTGAAACCCCATCTCTACTAAAATATAAAAATTAGCTGGGTGTGGTGGCACACGCCTGTAATCCCAGCTACCTGGGAGGCTGAGGCAGGAGAATCGCTTGAACCAGGAGACAGAGGTTGCAGTGAGCTGAGATCACGCCACTGCACTTTAGCCTGGGCAACAGAGTGATACTCTGTCTCAA"
"GL873595","3417105","3417297","chr12","115674238","115674427","44","112257133","GGCCGGGCGCTGTGCCTCACGCCTGTAATCCTAATACTCTGAGAGGCCGAGGCAGGTGGATTGCCTGAGCTCAGGTGCTCAAGACAGCCTGACTGAGCAAGCCCTGAGATCCCATCTCCACTAACAATAGTAAAACTAGCCGGGCATTGTGGTGGTGCTTGTAATCCCAGCTACTGGGAGGCTAAGACAGGAG","CCAGGCCTGGTGGCTCACGCCTGTAATCCCAGCACTTTGGGAGGCCGAGGTGGGTAGATCACCTGAGGTCAGGAGTTCAAGACCAGCCTGGCCAACATGGCGAAACCCCATCTCTACTAAAAATACAAAAATTAGCTGGGCATGGTGGTGTATGCCTGTAATCCCAGCTACTCGGGAGGCTGAGGCAGGA"
"GL873595","6098380","6098457","chr3","87492619","87492702","21","81394239","GCTGTGGCTCATGCTGATAATACCAGCACTCTGGGAGAACAAGGTAGGCAGATCACAAGAGGTCACCTGTGCAAGACC","GGGCTGGTGGTGGCTCATGCCTGTAATACCAGCACTTTGGGAGGCCAAGACAGGTGGATCACCAAAGGTCAAGAGTTCAAGACC"
"GL873596","134190","134307","chr1","203207333","203207443","31","203073143","GGCTGGGCGAGGTGGCTCACACCTGTAATCCTAGCACTCTGGAAGGCCCTAGCACTCAGGCAGTTGGATTGCCTGAGCTCACAAGTTCAAGACCAGCCTGAAAAAGAGCAAGACCTCA","GGCTGGGTGCAGTGGCTCACACCTGTAATCCCAGCACTTTGGGAGGCCGAGATGGGTGGATCACTTGAGGTCAAGAGTTGAAGACCAGCCTGGACAACATGATGAGACCCC"
"GL873596","134578","134681","chr11","50235285","50235387","37","50100707","CAAACAAAAGAGGAAGACCTCGTCTCTAAAAAAATAGCTGGGCATTGTGAGGAGTACCTGTAGTCCTAGCTACTCAGAAGGCTGAGACAAGAGAATCACTTAAA","CAACATTGTGAAACCCTGTCTCTACTAAAATAGAAAATTAGCCAGGTGTGTGGGCGTGCCTATAATCCTAGCTACTGGGGAGGGTGAGGCATGAGAATCGCCT"
"GL873596","8160215","8160350","chr1","29437872","29437991","30","21277657","GGCCGGGCGTGGTGGCGCACACCTGTAGTCCCAGCGCTATGGGAGGCCGAGGCGGGTGGATCACCTGAGCTCAGAGGTTCGAGACCAGCCAAGACCCCCCTGAGCCAAACGAGCCAGAGTGAGACCCCGTCTCTAC","GGCCGGGCGTGGTGGCTCACGCCTGTAATCCCAACATTTTGGGAGGCCAAGGCGGGTGGATCACCTGAGGTCAGAAGTTCGAGACCAACCTGGCCAACATGGTGAAACCCCTGTCTCTAC"
"GL873596","8421071","8421132","chr20","1874027","1874093","12","6547044","GTCAGGCGCAGTGGCTCACGCCTGTAATCTCAGCACTCTGAGAAGCCAAGGCAGGATCATCT","GGCCAGGCGCAGTGGCTCAGGCCTGTAATCCCAGCACTTTGGGAAGCCAAGGTGAGCAGATCACCTG"
"GL873598","4416400","4416489","chr5","39418145","39418231","15","35001745","GGCCAAGTGTGGTGGCTCATGCCTGTTGTCCCAGCACCGTGGGAGGCCGAGGCTGGTGGAACACCTGAGCTCAGCTGAGTTTGAGACCAG","GGCCAGTTGCGGTGGCTCATGCCTGTAATCCCAGCACTTTGGCAGGCTGAGGCAGGTGGATCACCTGAGGTCAGGAGTTTGAGACCA"
"GL873598","4416855","4416947","chr3","94091253","94091337","31","89674398","GTGAGACCCTGTCTCTACAAAAAAAAAAGCTGGGCACTGTGGCATGTGCCTGTAATCCCAGCTACTTGGGAGGCAAAGGGAAAGAGAATCACT","AAACCTTGCCTTTACTAGAAATACAAAAATTAGCTGGGCATGGTGGCAGGTACCTGTAATCCCAGCTACTTGGGAGGCTGAGGCA"
"GL873598","5126074","5126161","chr1","12339306","12339394","19","7213232","GCCTGGTGCACTGGTTCACACCTGGAATCCTTGCATTCTGAGAGGCCCAGGTAGGCAGATCACCTCAGCTCAGAAGTTCGAGACCAGC","GCTGGGTGCGGTGGTTCACGTCTGTAATCCCAGCACTTTGGGAGGCCGAGGCGGGCAGATCACCTGAGGTCAGGAGTTCGAGACCAGCC"
"GL873598","5467584","5467662","chr1","9313328","9313403","17","3845744","GCGAGGTGGCTCACGCCTGTAATCCCAGCACATTTGGAAGGCCAAGGAGGGTGGATCACCCGAGCTCACCAGTTGGAGA","CGCAGTGGCTCACGCCTGTAATCCCAGCACTTTGGGAGGCCGAGGCAGGCAGATCACCTGAAGTCAGGAGTTTGAG"
"GL873598","6917752","6917856","chr14","9558287","9558382","22","2640535","GGCCAGGCATGGTGGCTTGTGCCTGTTGTCCCAGCACTGTGGAAGGCCGAGGCGGGTGGATCGCCTGAGCTCAGCTGAATTCGAGACCAGCATAAGACCAGTATG","GGCCAGGCATGGTGGCTTATGCCTGTAATCCCAGCACCTTGGAAGGCCGAAGCGGGCAGATCACCTGAGCTCAGGAGTTTGAGACCAGCCTGTCCA"
"GL873598","8078910","8079062","chr7","164825511","164825660","43","156746601","AACAGCCAGGCATTGTGGTGGGCACCTGTAATCCCAGCTACTTGGGAGGCTGAGGCAAGAGAATTGCTTGAGCCCAACAGTCTCAGGTTACTGTGAGTTATGACACCATGGCACTCTATTGAGGGCAAGAAAGTGAGACTGTCTTGGAAAAAA","CTAGCCAGGCATGGTGGTGCGCACCTGTAGTCCCAGTTACTTGGGAGGTTGAGGCAAGAGAATTGCTTGAGCCTGGAAGGCAGAAGTTGCAGTGAGCTGAGATCACACCACTGCATTCCAGCCTGGGCGAAAGAGCAAGACTCTGTTGAA"
"GL873598","8079328","8079454","chr6","10381248","10381379","32","2301920","GCCCGGCGTGGTGGCTCACGCCTGTAATTCCAGCACTCTGGGGAGGCCGAGGAGGGCAGATTGCCTGAGCTCACAGGTTTGAGCTAGAGCGAGACCCTGTCTCTTAAAAAGAAAAAAAAGGAAAGAA","GCTGGGCGCGGTGGCTCACGCCTGTAATCCCAACACTTTGGGAGGCCGAGGCGGGCAGATCACCAGAGGTGATCTCCAGCCTGGGCAGGAGAGCAAGACCCTGTCTCAAAAAATTTAGAAAAAGGAAAGAAA"
"GL873599","3943256","3943456","chr9","35892110","35892312","79","31948854","GGCAGGCTGCTTTGACCCATATCTACAACTCCAGAACTTTAGAGGCTGAGCTGGGTGGGTCCCTTGAGATTAGAAACTGCTTAGTAGCCTGGCAAAAACCAGACCCCACCTCCACCATGTAGAAAAATTAGCAGTATGCCATAGTGGGAACCTACCAATACAGTCTTTCCAAAGGCCAAAGCTAGAAGGACCGTGAGCTTG","GGCTGGGTGTGGTGGCTCATGCCTATAATTCCAGCACTTTGGGAGGCCGAGGCAGGTGGATCACCTGAGGCCAGGAGTTTGAGACCAGCCTGGCCAATATGGTGAAACCCCATCTCTACTAAAAGTACAGAAAATTAGTCAGTCATGATGGCGCATGCCTATAATCCCAGTTACTCGGGAGGCTAAGGTAGGAGAATTGCTTG"
"GL873599","6693284","6693349","chr1","100916857","100916922","15","94223573","TCACGTCTATAATCCTAGCACTCTGGGAGTCCTTGGCAGGTGGATCACCTGAGCTCAGGAGTTTGA","CATGCCTGTAATCCCAGCACCTTGGGAGGCCAAGGTGGGTGGATCACCTGAGGTCAGTAGTTTGAG"
"GL873600","991618","991705","chr15","13850109","13850195","15","12858491","GGCTGGGCGTGGTGGCTCACACCTGTTGTCCCAGCGCTGTGGGAGGCTGAGGCAGGTGGATCACCTGTGCTCAGAGGTTGAGACCAGC","GCCGGGCGCTGTGGCTCACACTTGTAATCCCAGCACTTTGGGAGGCTGAGGCAGGTGGATCACCTGAGGTCAGGAGTTAGAGACCAG"
"GL873600","8825981","8826014","chr16","43605817","43605844","11","34779836","AGTCTGGGGCAACAGAGCAAGACTCTGTCTCAAA","CAGTCTGGGTGACAGAGCAAGATTCCAT"
"GL873600","8826039","8826157","chr13","87428402","87428520","35","78602363","ATTAGCCTGGTGTGGTGGTATATGCCTTCCTGCCTGCTTGGGAGGCTGAGGCAGGAAGTATGCTTTAACTGTGGAGTCTGAGGTTGCTATGAGCTAGGTTGAGGCCATGGCACTCTAAA","TTAGCCGGGTGTGGTGGTGCACGCCTGTAATCCCAGCTACTCAGGAGGCTGAAGCAGGAGAGTTGCTTGAACCCAGGAGTTGGAGGTTGCAGTGAGCTGAGATCACGCCATTGCACTCC"
"GL873601","269289","269338","chr14","49279240","49279285","14","49009951","GACTGGGTGTGGTGGCTCACACCTTTAATCCTAACACCCTGGGAGGCTTA","GGCTGAGATGGTGGCACACACCTGTAATCCCAGCTACTTGGGAGGC"
"GL873601","269431","269678","chr1","184453273","184453521","76","184183842","AGAAGATCACTCAAGATCAGGAGTTTGAGAACAGCCTGAGCAAGACCCCCATCTTTACTAAAAATGGAAAAGTTTTTACCCAGGCATGGTAGTGCGTGCCTGTATCCCATCTACTCCGGAGGCTGATAGGAGGATTGCTTCAACCAAGGAGTTTGAGGTTCCAGAGACTTAAGATGACACAACTGCATTTTACCCAGTGTGACACAGCGAGACTCTTTCAGAAGAATTTTTAAAAGGAAAAAAAAGAA","GGTCAGATCACCTGAGGTCAGGAGTTTGAGACCAGCCTGACCAACATGGTAAAACCCCATCTCTGCTAAAAATACAAAAAATTAGCCAGGCATGGTGGTGAACGCCTGTAATCCTAGCTACTCAGGAGGCAAAGACAGGAGAATCGCTTGAATCTGGAAGGTGGAGGTTGCAATGAGCCAAGATGACGCCACTGCACTCCAACCTGGGTGACAGAGGAAGACTCCATCAAAAAAAAAAAAAAAAAAAAA"
"GL873601","1397978","1398117","chr16","24839455","24839591","34","23441477","GCCTATAATCCTAGCACTCTGGAAGGCTGAGGCAGGAAGATCACTAGAGCTTGGGAGTTTGAGATTGCTGTGAGGGAGACTGACTCCATGGCACTCTAGCCTGAGGCAACAGAGTAAGACTCCATCTCAAAAAAAAAAAA","CTCTAACTCCAGCTACTCAGGAGGCTGAAGCAGGAAAATCACTTGAACCTGGGAGGTGGAGGTTACAGTGAGCCAAGATCACACCATTGCACTCCAGCCTGAGCGACAGAGCGAGACTCTGTCTCAAAATAAATAAA"
"GL873601","4065502","4065590","chr11","108711352","108711444","19","104645850","GCTGGATGTGGTGGCTCTCACCTATAATCCTAGCACTCTGGGAGGTCAAAACAGGTGGATCACCTGAGCTCAGGAGCAAGAACACCAGC","GTCAGGGGTGGTGGCTCACGCCTGTAATCCCAGCACTTTGGGAGGCCAAGGCAGGTGGATCGCCTGAGCTCAGGAGTTCAAGACCAGCCTTGC"
"GL873601","8241370","8241465","chrY","9469734","9469829","34","1228364","AAAAAAGGTGGAGATGAGCCATGCGCAGTGGTGTAGGCCTGTAATCCCAGCCCTTGGGAGGCCAAAATGGTGGATTGCCTGAAGCAGAGCAAGACC","AAAGTACAAAGAGTCTGGGTACAGTGGCCCAAGCCTGTAATCCCAGCAGTTTGGGAGGACAAGATGGGTAGATCACCTGACATCATGAATTAGAGA"
"GL873569","7519122","7519191","chrX","79016364","79016431","16","71497242","TTGGCCAGGCATGGTCGCTCAGGCTGTAATACCAGCTACTTGGGAAGCTGAAGCAGGAGGATCACTTGAA","TTGGCCAGGCACGGTGGCTCATGCTTATAATCCCAGCTACTCGTGAGGCTGAGGCAGGGGAATCGCTT"
"GL873569","7989158","7989286","chr8","41505677","41505810","35","33516519","AGTCCCACCTATTTGGAAGGCTGAGGCAAGAGGATCACTTGAACTCAGCAGTTTGACATTGCTATGAGTTAGATTGACTCCATGGCACTCTAGCCCAGGCAACAGAGCAAGACTCCGTCTCAAAACAAA","TAATACCAGCTACGTGGGAGGCTGAGGCAGGAGAATCACTTGAACCCGGGAGGTGGAGGTTGCAGTGAGCTGAGATTGCACCGTTGCACTCTAACCTGGGCAACAAAAGCAAAACTCTGTCTCAAAAAAAAAAA"
"GL873569","7989575","7989702","chr1","62231025","62231129","47","54241450","GGCTGGGTAATGCAGTGGCTCACGCCTATAATCCTAGTGCTTTGAGAGGCCAAGAGTGAGACTCTGTGTACTAAAAATAGAAAAATTACCTAGGCATTCTGGTGGGCACCAGTAGTCCCACCTATTTG","GGCTGGGCATGGTGGCTCACGCCTATAATCCCAGCACTTTGGGAGGCCGAGGCAGGTGGATCACCTGAGATCAGGAGTTTGAGACCAGACTGGCCAACATGGTGA"
"GL873569","10034363","10034556","chr10","61268396","61268605","62","51234033","CAGCTTGAGCAAAAGTGAGCCCCTGTCTCTACTGAAAATAGAAAAAATTAGCCAGGCGTGGTGGCACACACTTATAGTCCCAGCCACTTAGGAGGCTGAGGCAGGAGTTTGAGGTTGACATAATCTAAGCTGATACCATAGCACTCTAGCCTGGGCAATAGAGTGAGACTCTGTCTCAAAGAAGAAATTTATCT","CCTGACCAATGGTGAAACCCTGTCTCTACCAAAAATACAAAATTTAGCTGGGCATGGGGGCACGCACCTGTAGTCCTAGCTACTCGGGAGGCTGAGACAGGAGAACTGCTTGAACTCGGGAGGCAGAGGTTGCAGTGAGCTGAGATCATGCCACTGCACTCTAGCCTGGGCAATAGAGTGAGACTCCGTCTCAAAAAAAAAAAAAAAAAA"
"GL873569","10034830","10034845","chr1","217667782","217667796","2","207632952","AAAAAAGAAGAAAAAA","AAGAAAAAGAAAAAA"
"GL873569","10203815","10203922","chr8","96374555","96374671","35","86170740","GCCAGGTGTAGTGGTTCACACCTATAATCCTAGCACTCTGGGAGCCTGAAGCAGGTAAATGGACTGAGCAAGAGTGAGACTTCCACCTCTATTGAAAATAGAAAAATT","GGCTAGGTATGGTGGCTGATGCCTATAATCCCAGAATTTTGGGAGGCCGAGGCAGGCAGATCATCTGAGGTCAGGAGTTTGAGACCAGTCCCGTCTCTACTAAAAATACAAAAATTA"
"GL873569","10204196","10204373","chr20","1304385","1304559","47","8899811","GAAAATAGAAAAATTAGCCAGGCATTATAGCAGGCACCAGTAATCCCAGTTACTTGGGAGGCTAAGGCAAAAGAATCTCTTGAGCCCAAGTTTGGGGTTGCTAGGAAGTAAAACACCACAGCACTATACCCAGAACAAGAGAGTGAAGACTCAGTCTCAAAAAGATAAATAAATAAAA","AAAAATACAAAAATTAGCCAGGCATGGTGGCGGGCGTCTGTAACTCCAGCTACTTGGGAGACTGAGGCAGGAGAATCGCTTGAACCCAGGAGGCAGAGGTTACAGGTGAAATCACACCACTGCACTCCAGCCTGGGCAACAGGGCAAGACTCTGTCTCAAAAAAAAAAAAAAAAA"
"GL873569","10473375","10473444","chr8","20660648","20660717","21","10187273","TGTAGTCCCAGCACTTTGGGAGGTTAAGGCAAGAGTAGCACCCAACATGAGGAGATCAAGACCAATCTGG","CTGTAGTCCCAGCACTTTGGGAGGCTGAGGCAGGTGGATCCTTTGAGGGCAGAACTTTAAGACCAGCCTG"
"GL873570","9287350","9287485","chr1","29437872","29437991","30","20150522","GGCCGGGCGTGGTGGCGCACGCCTGTAGTCCCAGCGCTATGGGAGGCCGAGGCGGGTGGATCACCTGTGCTCAGAGGTTCGAGACCAGCCAAGACCCCCCTGAGCCAAACGAGCCAGAGTGAGACCCCGTCTCTAC","GGCCGGGCGTGGTGGCTCACGCCTGTAATCCCAACATTTTGGGAGGCCAAGGCGGGTGGATCACCTGAGGTCAGAAGTTCGAGACCAACCTGGCCAACATGGTGAAACCCCTGTCTCTAC"
"GL873571","3669989","3670207","chr4","116777080","116777297","60","113107091","AGACCAGCCTGAGGAAGAGCAAGATCCCATCTCTATTAAAAATAGAAAAATTAGCCAGGCATTCTGGTGGGCACCTGTAGTTCTAACCACCTGGGAGGCTAAGGCAAGAGGAACTCTTCAACCCAAGAGTTTGAGGTTGCTGAGAGCTAGGCTAAGGCTGCAGCACTCTAGCCTGGGCAACAGAGTGAGACTGTTTCTCAAAAACAAAAAACAAAAAAA","CGAGACCAGCCTGGTCAATATGGTGAAACCCCGTCCCTACTAAAAATACAAAAATTAGCCAGGCATGGTGGCAGGCACCTGTAGTCCCAGCTACTCGGAAGGCTGAGGCAGGAGAATCGCTTGAACCACAGAGGCAGAGGTTGCAGTGAGCCGAGACTGCACCACTGCACTCCAGCCTGGGCGACAGAGTGAGACTCAGTCTCAAAAAAAAAAAAAAA"
"GL873571","106134","106236","chr4","18143723","18143826","27","18037589","GGCCAGTCTCAGTGGCTCACACCTGTAATCCAGCATTCTGGGAGGCTGAAGCACACGGTCACCTGAGCTCAAAGGTTGGAGACCAGAGTGAGACCCCACCTCT","GGCCAGGCGCAGTGGCTCACTCCTGTAATCCCAGCACTTTGAGGCTGAGGCAGGCGGATCACCTGAGGTCAGGAGTTTGAGACCAGCCTGGCCGAAACCCCATC"
"GL873571","3670496","3670589","chr7","50468399","50468491","15","46797903","GGGCAGGCATGGTGGCTCACACCTGTAATTCTAGCACTCTTGGAGGCTGAGGCAGGAAAATGGCTTGAGGTCAGGAGTTCAAGACCAGCCTGAG","GGCCAGTCATGGTTGCTCACACCTGTAATACCAGCACTTTGGGAGGCCGAGGCAGGCGAATCACCTGAAGTCAGGAGTTCAAGACCAGCCTGG"
"GL873571","4059090","4059389","chr7","52903696","52903994","88","48844606","GGCCAGGTGCAGTGGTTCACACTTATAATCCTAGCACTCTGGGAGGCCGAGGCGAGTGAAGTGCCTGAGCTCATGGGTTCAAGACCAACCTAAGCCAGAGACCCCTGACTCTTATAATAGCCTGGCATTGTGGTGGGCGCCAATATTTCCAGCTACTCTGAGGCTAAGGCAAGAGAATTGCTTGAGCCCAGGAGTTGGAGGTTTCTGTGAGCACTGACGCCGCAGCTCTCTACCAAGGGCAACAAAGACTCTGTCTCAAAAAATAAATAAATAAATAAATAACAGAATGAAAATGAAAAA","GGCCGGGTGCGGTGGTTCACGCCTGTAATCCCACCACTTTGGGAGGCTGAGGCAGGCAGGTCACCTGAGGTCAGGAGTTCCAGACCAGCCTGGCCAACATGGTGAAACCTTGTCTCGGCTATTAGCCTGGCATGGTGGTGCGTGCCCATAATCCCAGCTACTCAGGAGGCTGAGGCAGGAGAATCGCTTGAACCCAGAAGGTGGAGGTTGCAGTGAGCCAAGATAGCACCACTGCAACTCCAGTCTGGGCAACAGAATGAGACTCTGTCTCAAAAAAAAAAAACAAAAAACAAAAAGAA"
"GL873571","4209418","4209704","chr11","32517699","32517985","80","28308281","GGCTTGGCAAGGTGGCTTACACCTCAAATCCTAGCACTGTGGGAGACTGAGGCAGGTGGATTGTTTGAGCTCAGGAGGTCAAGATAGAGAGCAAGAGCAAGTCTCTGTCTCTACTAAAAATAGAAAAGAACTACTTCCCGGGGGTCATGGCAGTAGCCTGTAATCCCAGTTACTAGGTAGAATGAGGCAAGAGGATCTGTTGAAGCCAAGAGACTGAGGTTGTTATGAGCATGCCACAGCACTCTACCCAGGGTGACAGAATGAGACTCTGTTGAAAGAAAAAAAGA","GGCCGGGTGCAGTGGCTCACACCTGTAATCCCAGCACTTTGGGAGGCTGAGGCGGGTGGATCACCTGAGGTCAGGAGTTCAAGACCAGCCTGACAAACATAGTGAAACCCTGTCTCTACTGAAAATACAAAATTAGCCAGGTGTGGTGGCGCATGCCTGTAATCCCAGCTACTCGGGAGGCTGAGGCAGGAGAATTGCTTGAATCCAGGAGGTGGAGGTTGTGTGATCACACCACTGCACTCCAGCCTGGGCGACAGAGTGAGACTCTGTCTCAAAAAAAAAAGAAA"
"GL873571","4209985","4210154","chr3","175781758","175781928","60","171571773","GAAAGAAATGAAAAGAAAGAAGTTAGCTGGTTGTTGGGGTATGCTTCTATAGTCCCACCTACTCAGAAAGCTGAAATCTGGAGTTTGGGGTTGTTGTAAGGTAGGCTGATGACATAGCACTGTAGCTTGGGCAAGAGAGTGTGACTTTGTCTCAAAAAAAATTAAAACAA","ATTAAAAACACAAAGATTAGCCAGGTGTGATGGCACACAACTGTAATCCCAACTACTCAGGAGAATCGCTTGAACCTGGGAGATAGGGTTTGCAGTGAGCCAAGATTGTGCCACTGCACTCCAGCCTGGGTGACAGAGTGAGACTCTGTCTCCAAAAAAAAAAAAAAAAAA"
"GL873571","4210444","4210570","chr17","16655655","16655789","35","12445211","GCCAGGCAGATGGCTCACACTTCATCCTAGCCCTCTGGAAGGCTGAGGCAGGCTAATTTTTTGAGGTTAGGAGTTTGAGACCAGCCTGAGGAAGAGACCCATCTCTACTTTAAAAAATAAATGGAAA","GCCAGGCATGGTGGCTCACACCTGTAATCCTAGCACTTTGGGAGACTGAGGCGGGTGAATCACCTGAGGTCAGGAGTTTGAGACCAGCCTGACCAGTATGGTGAAACCCAGTCTCTACTAAAAATACAGAAATTA"
"GL873571","4391733","4391878","chr11","33723808","33723943","46","29332075","AACTTAGCTGGGAATGGTGGCTCAAGCCTGTAATCCTAGCACTCTGGGAGGCTCAGGTGGGAGGATCACTTGAGGTTGCTGTGAGCTTGGCTGATGCCAGGACACTCTAGTGTGGGCAAGAGAGTGAGACTCCGCCTCAACAACAA","GCCGGGTGCAGTGGCTCATACCTGTAATCCCAGCACTTTGGGAGGCTGAGGTAGGCGGATCACGAGGTCAGGAGCTGAGATGGCGCCACTGCACCCCAGCCTGGGTGACAGAGCAAGACTCTGTCTCAAAAAAAAA"
"GL873571","6307773","6307841","chr9","62429628","62429694","22","56121855","CTGGGTGTGGTGGCATTGCACCTGTAATCCTAGCTACTTGGAAATCTTAAGCCCAGGAGTTGAAGACTG","CCCAGCATGGTGGTGCATACCTATAATCTCAGCTACTTGGAGGCTTGAGCTCAGAAGTTTGAGACCG"
"GL873571","6496217","6496306","chr1","27257765","27257856","27","20761548","GCAGGGTGTGTTGACCCACACCCACAATTCCAGGACTCTGGGGGGCCAGGGATGGTGGGTTCCCTCAGATCAGGAGCTCCTTACCAGCCT","GACTGGGCATGATGGCTCAAATCTGTAATTCCAGCACTTTGGGAGGCCGAGGTGGGTGGATTGCCTGAGATCAGGAGTTCAAGACCAGCCTG"
"GL873571","6499738","6499903","chr1","38976375","38976555","47","32476637","AAAATAACATGAATTGACTAGGCGAGGTGGCTCACATCTCTAATCCTAGCACTCTGGGAGGCTGAGGCAGGAGAATTGCATGAGGTTGCTGTGAGCTATGATGATACCACGGCATTCTAATCAGGGTGACAGAGTGAGATTCTGTCTTAAAACAAACAAACAAAAA","AAAATAAATAAATTAGCAGGGCCTGGTGGCGCACACCTGTAATCCCAGCTACTTGGGAAGCTGAGGCAGGAGAACCCACTTGAACCTGGGAGCCGGAGGTTGCAGTGAGCTGAGATGGCACCACTGCACTCCAGACTGCGTGACAGAGTGAGACTCCGTCTCAAAAACAAACAAACAAAAA"
"GL873571","11399575","11399872","chr15","109458692","109458994","79","98059117","CAGTGGCTCACACCTGTAAATCTAACACTCTGGGAGGCCAAGGTGGGTGGATCCCTTGAGCTCAGGAATTTGATACCAGCCTGAGCAAGAGTGAGACCTTGTCTCTACTAATAATAGAAAAATAGCCCGTGTTGTGGCACTTGTCCCAACCACTGGGGAGGCTTTAGGCGGGAGGATTACTTGAATTGGGAGTTTGATATTGCTGTGAGCTGGGCTGATGCCTTGGCATTCTAGCTTGGGTAACAGCGTAAGACTCCGTCTCAAATAAATAAATAAATAAATAAAAAGAAAAAAAGAA","GTGGCTCACACCTGTAATCTCAGCACTTTGGGAGACCGAGGCAGGTGGATCACCTGAGGTCGGGAGTTTGAGACCAGCCTGACCAACGTGGAGAAACCCCGTCTCTACTAACAATACAAAATCAGCTGGGCGTGGTGGTGCATGCTTGTAATCCCAGCTACTCGGGAGGCTGAGGTAGGAGAATCGCTTGAACCTGGGAGGTGGAGGTTGCGGTGAGCCGAGATCGAGCCACTGCACTCCAGCCTGGGTGACAGAGCAAGACTCCATCTCAAAAAAAAAAAAAAAAAAAAAAAAAAAAAAAAA"
"GL873572","114760","114841","chr8","26280134","26280211","16","26165374","GGCCAGGCATGGCGGCTCTTCCCTGTAATCCTAGCACTCTGGGAGGGCGAGGCAGGCAGATCACCTAGGCTAGGGTGAGATC","GGCCAGGAATGGTGGCTCATGCCTGTAATCCCAGCACTTTGGGAGGCTGAGGCAGGCAGATCACCTGAGGTCAGGAGT"
"GL873572","9421791","9421892","chr11","8089184","8089269","35","1332607","TACTAAATATATAGCAAGGCCAGGCACAGTGGTTCATGGCTGTAATCCCAGTACTCTGGGAGGCCTAGTCAGAGTTGACCTGAGATCAGGCTAGAAGCCTGG","ATAAAAATAATTGGAGGCCAGGCACGGTGGCTCATGCTTGTAATTCTAGCAATTTGGGAGGCTGACGCGGGTGAGATCATACTGAG"
"GL873572","11052834","11053035","chr14","11857478","11857657","65","804644","TCCACAAAGAAAGCAGAAGTGTGGCCGGGTGGTAGCTCAAGGCAGGAATCCCAGCACTCTGGGAGCTGGGAGGTGGGGGAGGATCCCTTGAGATCAGGAGTTGGAGGGCACAGTGAGCCTGGGGGAGGCCACTGTCTCTGTACTCTAGCAGGGAGACAGAGCAAGACTGCCCATTCAAAGAAAAACAACAAACAAAACAAAA","TACAAAAATTAGCTGGGCACGGTGCCACAAGCCTGTAATCCCAGCTACTCGGGAGGCTGGGCAGGGGAATAGCTTGAACCCAGAGGTGGAGGTTGCAGTGAGCCAAGATCAAGCCACAGCACTCCAGCCTGGGTGACAGAGCAAGACTCCATCTCAAAAAAAAAAAAAAAAAAAAAAAAA"
"GL873573","2564195","2564244","chr1","109985445","109985491","12","107421250","TACAAAAATTAGGCTGGGCTTGGTGGTTCACGCCTATAATCCTAGCACTT","ACTAAAATTAGCTGGGCATGGTGGTGCATGCCTGTAATTCCAGCTAC"
"GL873573","7423371","7423533","chr2","202783328","202783513","56","195359957","GGTGGCTCACACCTGTAATCCCAGCACTCTGGGAGCCCTGGTGGCTCATGTCTATAATCCTAGTACTCTGGGAGACCATGGTGGCTCATGTCTATAATCCTAGTACTCTGGGAGCCATGGTGGCTCACGCCTATAATCCTAGTACTCTGGGAGACCATGGTGG","GGCTGAGGCGCGGGGGCTCACGCCTGTAATCCCAGCACTGTGGGAGGCCGAGGCGGGTGGATCACGCCTGTAATCCCAGCACTGTGGGAGGCCAAGGCGGGTGGATCACGCCTGTAATCCCAGCACTGTGGGAGGCCGAGGCGGGTGGATCACGCCTGTAATCCCAGCACTGTGGGAGGCTGAGGC"
"GL873573","9657648","9657710","chr19","10207852","10207913","10","550204","TAAAAATAAAAAATTTAGCTGGATGTGGTGGCTCACACCTGTAATCCTAGCACTCTGGGAGAC","TAAAAATACAAAATTAGCTGGGTGTGGTGGCACACACCTGTAATCCCAGCTACTCAAGAGGC"
"GL873574","1624662","1624783","chr9","814961","815079","36","809701","GACTGGGTGGGTTGGATCATGCCTGGAATCCTAGCACCCTGGGAGGCCAAGGTGAAAGGATTGCTTGAGGTTAGGAGTTCCAGAAATGTAGCAGTCATGGTGACTTCATCCTTCTCTACCAA","GGCTGGGTGCTTTGATTCATGCCTGTAATCCCAGCACTCTGGGAGGCCGAGGCAGGTGGATCACCTGAGGTTAGGAGTTCGAGACCAGCTTGGCTAACATGGTGAAACCTCGTCTCTAC"
"GL873574","4459477","4459612","chr1","29437872","29437991","29","24978395","GGCCGGGCGTGGTGGCGCACGCCTGTAGTCCCAGCGCTATGGGAGGCCGAGGCGGGTGGATCACCTGAGCTCAGAGGTTCGAGACCAGCCAAGACCCCCCTGAGCCAAACGAGCCAGAGTGAGACCCCGTCTCTAC","GGCCGGGCGTGGTGGCTCACGCCTGTAATCCCAACATTTTGGGAGGCCAAGGCGGGTGGATCACCTGAGGTCAGAAGTTCGAGACCAACCTGGCCAACATGGTGAAACCCCTGTCTCTAC"
"GL873574","4681987","4682216","chr6","153082888","153083127","73","148400901","GGGTGCGGTGGCTCAGACCTATAATCCCAGCACTCTGAGAGGCCGAAGTGGGTGGATCACCTGAGCTCAGGAATTTGAGACCAGCCGTCTCTAAAAATAGCTGAGTGTTGTGGCAGTGGCTGTAAGTCCCAGCTGTTTGGAAAGCTGAAGCAAGGGAATCACTTGAACCCAAGAGTTTGAGGTTGCTGTGATGACAAAGTGAGACTCTATCTCAAAAAAAAAAAAAAAAA","GGCCGTGCGCGGCGGCTCACGCCTGTAATCCCAGCACTTTGGGAGGCTGAGGTGGGTGGATCACCTGAGGTCAGGAGTTTGAGACCAGCCCGACCAGAAATTAGATGGGTGTGGTGGTGCGCTCCTGCAGCCCCAGCTACTTAAGAGGCTGAGGCAGGGTAATCACTTGAACCCGGGAGGCGGAGGTTGCAGTGAGCCGAGCTCACGCCACTGCACTCCAGCCTGGGTAACAGAGCGAGA"
"GL873574","4709916","4710039","chr19","13152422","13152536","46","8442506","AAAAATAGAAAAACTAGCCAAGCATGGTGGTGCACCCCCTATAGTCTGAGCTCCTCAGCGGGCTGAAGCAAAAGGACGGCTGGAGCCCTGGAGTTTGAGGTTGCTGTGAGGCAAGGTGATGCCA","ACACATAAATTAGCCAGACATGATGGTGAGTATCTGTAATTCCAGCTCCTTGGGGGGCTGAGGCGGGAGAATTGCTTGAACCTGGGAGGCAGAGATTGCAGTGAGCCAAGATCGC"
"GL873574","6353839","6353913","chr5","25768079","25768163","22","19414240","AAAAATATAGCAAGGCCAGGCATGGTGGCTCACACCTATAATCCCAGTACTTGGGAGCTGGAATTTGAACCTAGG","AAAAAACTCAAACAAGGCTGGGCGTGGTGGCTCACACCTGTAATCCCAGCACTTTGGGAGGCTGAGGTGGGTGGATCACCTGAGG"
"GL873574","6533061","6533332","chr5","85182161","85182439","81","78649100","GGCTGGGCGAGGTGGCTTACACCTATAATCCTAGTACTCTGGGAGGCCAAGGTGGGTGGATTGCCTGAGCGCACAGTTTCAAGACCAGCTGGAGCCAGAGAGAGAGAGAGAGACCCTGCCTCTAAAAATAGCCAGGCATTGTGGCAGGCACCTGTAGTCCCAGCTACTTGGCAGGCGGAGGTATGAGAATCGCTAGAGGTTGCTGTTAGCTATGATGCCATAGCACTCTACCAAGGGCGACAAAGTGAAACTCTGCCTCAAAAAAAAGAAGA","GCCAGGCGTGGTGACTCAAGCCTGTAATCCTAGCACTTTGGGAGGCCAAGGTGGGCGGATTGCCTGAGCTCAAGAGTTTGAGACCAGCCTGGGCAACACGGTGAAACCCAATCCCTACTAAATACAAAAAAAATTAGCCGGGTGTGGTGGTGTGAACCTGTAGTCCCAGCTACTCGGGAGGCTGAGGCAGGAGAAGGCAGAAGTTGCAGTGAGCCGAGATCACACCACTGCACTCCAGCCTGAGTGACAGAGCAAAACTCTTTCTCAAAAAAAAAAAAA"
"GL873574","6643746","6643907","chr2","92627944","92628105","46","85984198","AAATAGCCAGGCGTTGTGGCAGGCACCTATAGTCCCAGCTACTTGGGAGGCTGAGGCAAGAGAATCACTTAAGCCCAAGTGACAGAGGTTGCCAGGGCACTCTACGTAGGCAACAGAGTGAGACTCTATCTAAGAAAGAAGGAAGGAAGGAAGGAGAAAGAA","TTAGCCGAGCATTGTGGTGCGCGCCTGTAGTCCCAGCTACATGGGAGGCTGAGGCAGGAGAACACCTGAACCCAGGATGTGAGCTGAGTCGCGCCATTGCACTCCAGCCTGGGCAACAGAGTGAGACTCCATCTCAAAAATAAAATAAAATAAAATAAAAAA"
"GL873574","6644163","6644274","chr1","128607504","128607619","20","121963341","CTGTAATCCTAGCACTTGGGAGGCTGAGGCAGGTGGATCACCTGAGTTCAGGAGTTCAAGACCAGCCTAAACAAGAGTGAGACCCTATCTCTACTAAAAATAGAAAAAATAT","GCCTGTAATCCAAGCACTTTGGGAGGCTGAGGCGGGTGGATCACCTGAGGTCAGGTGTTCGAGACCAGCCTGGCCAACGTGGTGAAACCCCAACTCTACTAAAAATACAAAAATTA"
"GL873574","8511822","8512127","chr1","23439759","23440073","84","14927937","GGTGGCTGGTGCCTGTAATCCTAGCACTCTGGGAGACTGAGGCAGGTGGATCACTTGAAATCAGGAGTTTGAGATCAACCTGAGCAAGAGATCTTGTCTCTCCTAAAGATAGAAAAACTAGCTGGGATTTGTGGTGGACACCTGTAATTTCAGCTACTCAGGAAGCTAAGGCAAGAGCATTGCTTAAAACCAGGAGTTTGAAGTTGATGTGAGCTAGGATGTCAGGGCAGGTTACCCAGGGTGACAGAGTGAGACTCTGTGTCAAAATAAACAAACAAACAAACAAACAAAACAAAATAAAATAAA","GGCTGGACATGGTGACTCACGCTTGTAATCCCAACACTTTGGGAGGCTGAAGCAGGCAGATCACCTGAGGTCAGGAGTTTGAGACCAGCCTGACCAACATGGTGAAACCTTGTCTCTACTAAAAATACAAAAATTAGCTGGGAGCAGTGGTGCACACCTGTAATCCCAGCTACTCGGCAAGCTGAGGCAAGATAATTTTTTAAACCTGGGAGGTGGAGGTTGCAGTGAGCCAAGATCGTGCCACTGTACTCCAACCTGGGAGACAGAGCAAGACTCTGTCTCAAAAAAAAAAAAAAAAAAAAAAAAAAAAAAAAA"
"GL873575","2107336","2107519","chr4","38052972","38053149","54","35945636","TCAATTAAAAACTTTTTAAAATGAGGCTGAGCATGGTGGTTCACACCTGTAATCCCAGCACTTTGGGAGGCCGAGGCAGGAGGATCACCTGATCCCAGGAGTCCAAGCCTACAGTGAGCCGTGATAATACCACTGCACTTCAGCCCAAAGCCTCAAAAAGAAAAAAAAAAAAGGATAGACAAGA","TATATATATATATATTATTTTGGGGGGGCATGGTGGTGCACACCTGTAATCCCAGCTACTCGGGAGGCTGAGGCAGGAGAATTGCTTGAGCCCGGGAGGCAAAGGTTGCATTGAGCTGAGATCACACCACTGCACTCCAGCCTGGCGACAGAGTCTCAAAAAAAAGAAAAAATAAAAA"
"GL873575","5831824","5831959","chr1","29437872","29437991","28","23606048","GGCCGGGCGTGGTGGCGCACGCCTGTAGTCCCAGCGCTATGGGAGGCCAAGGCGGGTGGATCACCTGAGCTCAGAGGTTCGAGACCAGCCAAGACCCCCCTGAGCCAAACGAGCCAGAGTGAGACCCCGTCTCTAC","GGCCGGGCGTGGTGGCTCACGCCTGTAATCCCAACATTTTGGGAGGCCAAGGCGGGTGGATCACCTGAGGTCAGAAGTTCGAGACCAACCTGGCCAACATGGTGAAACCCCTGTCTCTAC"
"GL873575","7451097","7451208","chr3","122814630","122814743","22","115363533","GGCCAGGTGTGGTGGCTCACACCTGTTATCCTAGCACTCTGAGAGGCCACAGCAGCTGGATCACTTGAGCTCAGGAGTTCAAGACCAGTCTGAGCAAGAGCAAGACCTCACC","GGCTGGGTGTGGTGGCTCATGCCTGTAATCCCAGCACTTTGAAAGGCCAAGGCAGATGGATCACTTGAGGTCAGGAGTTCCAGACCAGCCTGGCCAACATGGCAAAACCCCATC"
"GL873575","7451277","7451445","chr6","58863249","58863409","41","51411972","AAAAATTCAGCCAGCCACAGTGGAAGTGGATGCCTGCCATCACAGCTACTCTGGGGGCTGGGGCAAGAGAATTGCTTGATCCCAGGAGTCTGAGGTTGCTGTGACCTAGGCTGACACCACAGCACTCTACCCAGGGTGACAGAGTGAGGCTGTGTTTAAAAAAAAAAAA","TTAGCCAGGCATGGTGGCACATGCCAGTAATCCCAGCTACTCAGGAGGATGAGGCAGGAGAATCGCTTGAACCCAGGAGGCAGAGGTTGCAGTGAGCTGAGATTGCGCCACAGCACTCTACCCTGGGTGACAGAAGGAGACTCTGTCTCAAAAAAAAAAAA"
"GL873576","1765109","1765185","chrX","53921180","53921256","12","52156071","GGCCAGGTGCAGTGGCTCATATCTGTAATCCTAGCACCCTGGGAGGCCAAGGTAGGCGAATCACCTGAGGCCAGGAG","GGCCAGGTGCAGTGGCTCACGCCTGTAATCCCAGCACTTTGGGAGGCCGAGGTGGGCGGATCACTTTAGGTCAGGAG"
"GL873576","2711577","2711895","chr7","6620384","6620702","85","3908807","GGTCGAGCTTGGTGGCTCATGCTTGTAATCCTAGCACTCTGGGAGGCCAAGGCAGGTAAGTTGCCCTGAGCTCATAGGTTCCAGATCAGCATGAGCCAGAGTGAGACCCTGTCTCTACCAAAAAATAGCCCGGCATTCTGGCAGGTGCCTGTAATCCCAGCTGCTTGGGAGGCTGAGGCTAGAGAATCACTTAAACCCAAGGGTTAGTGGAGGTTGCTGTGAGCTATGATTCCACCGTACTCTACTGAGGGCCACAAAGTGAGACTCTGTCTCCATAAAAAAGAAAGAAAGAAAGAAAGAAAAATAAAATAAAATAAAA","GGCCAGGCACAGTGGCTCATGTCTGTAATCCCAGCACTTTGGGAGGCCGAGGCGGGTGGATTACCTGAGGTCAGGAGTTCTAGACCAGCCTGGCCAACAAGGCGAAACCCTGTCTCTACTAAAAATACAAAAAATTAGCTGGGCGTTTTGGCACATGCCTGTAATCCCAGCTACTTGGGAGGCTGAGGCAGGAGAATTGCTTGAACTGGGGAAGTGGAGGTTGCAGTGAGCTGAGATCACACCATTGCACGCCTGAGCAACAGAGCGAGACTCTGTCTCAAAAAAAAAAAAAAAAAAAAAAAAGAAAAGAAAAAGAAAA"
"GL873576","4782520","4782652","chr9","61136941","61137074","22","56354421","CCAGGCACGGTGGCTCACCCTTGTAACCCTAGTACTTTGGGAGGCTGAGGTGGGAGGATCCCTTGAGGTCAGGAGTTCAAGACCAGCCTGAACAACAGTGAGACCCCCGTCTCTACTAAAAAATAGAAAAGTT","GCCAGGCACGGTGGCTCACGCCTGTAATCCCAGCACTTTGGGAGGCTGAAGCGGGCGGATCACCTGAGGTCAGGAGTTCAAGACCAGCCTGGGCACCATGATGAAACCCCGTCTCTATTAAAAATACAAAAATT"
"GL873576","4782930","4783078","chr7","57521645","57521803","40","52738715","AGTTAGTCTGGTGTCATGGTGGGTGCCTGTAGTCCCAGCTGCTTGGGAGGCTGAGGCAAGAGAATCACTTGAGCCCAGGAGTTGGAGGTTGCTATGAGCGAGGCTGTAGCCTAGGCAACAGAATGAGACTTTGCCTCAAAAAAATAAAA","TTAGCTGGGCATGGTGGCGCATGCCTGTAGTCCCAGCTACTTGGGAAGCTGAGGCAGGAGAATCACTTGAACCTGGGAGGTGGAGGTTGCAGTGAGCTGAGATCGCACCGCTACACGCCAGCCTGAGCAACAGAGAGAGACTCTGTCTCAAAAGAAAAA"
"GL873576","7828709","7828723","chr5","101042981","101042996","1","93214272","TAAATAAATAAAAAA","TAAATAAATAAATAAA"
"GL873576","7828960","7829230","chr13","49045537","49045844","89","41216577","GCCGGCTGCAGTGGCTATAATCCAAGTACCCTGGGAGGCTTAGGTGGATGGATCACTTGAGCTCAGAAGTTCAAGACCAGCCTCAGCAAGAGGTAGACCTTGCCTCTATTAAANNNNNNNNNNNNNNNNNNNNNNNNNNNNNNNNNNNNNNNNNNNNNNNNNNNNNNNNNNNNNNNNNNNNNNNNNNNNAGTTTGAGGTTGCTGTGAGCTATGATGAAGCCAGGGCATTCTACCCAGGGTGACAGAGTAACTCTTAAAAAAAACTAAACAA","GGCCAGGCAGAGTGGCTCATGCCTGTAATTCCAGCAATTTGGGAGGCCTAGGCAGGCAGATTACCTGAGGTCAGGAGTTTGAGACCAGCCTGGCCAACATGGTGAAACCCCGTCTCTTCTANNNNNNNNNNNNNNNNNNNNNNNNNNNNNNNNNNNNNNNNNNNNNNNNNNNNNNNNNNNNNNNNNNNNNNNNNNNNNNGGAGATAATAGCTTTTGTAGAACGAAGCGATGCAACAGCCAGATCGCCGCCACCACCCTTAGGTCCTGGCGACAGAGTGAGATCCATCTTAAAAAAAAAAAAAAAAAAA"
"GL873576","10622840","10623093","chr7","60266447","60266705","74","49643607","GCTGGGTATGGTGGTTCACACCTATAATCCTAGCACTCTGGGAGGCTGAGGTGGGAGGATTGGTGGAGCTCAGGAGCTCATGAGGTGCCAAATCACTGGTGCCACACACCTGTATTCCCAGCTACTGAGGAGGCTGAGGCAGGAGGATCAGGTAAGCCCAGGAAGTTTGAGGTTGTAGTGAGTTAGGATGATTGAACTCTGCCTTGAGAGACAGAGCAAGATCCTCCTTCCTCCTAAGCAAACAAACAAATAAA","GGCTGGGTGCAGTGGCTCACACCTGTAATCCTAGCACTTTGGGAGGCTGAGGCGGGAAAATTGCCTGAGCTCAGGAGTTCAAGGACAGCCTAGGCAACATAGCATGGTGGTGCACGCCTGTATTCCCTGCTACTTGGGAGGCTGAGGCACAAGAATTGCTTGAATCCGGGAAGTGGAGGTTGCAGTGAGCCATTGTGGCACTGCTCTCCAGTCTGGGTGACAGAGCAAGACTCCATCTCAAAAAAAAAAAAAAAAAAAA"
"GL873576","10819939","10820007","chrX","67133632","67133707","21","56313693","AGGTTGCAGTGAAATTGTACCATTCCAATGAAGCCTGGGGGACAGAGTGAGATTCTCTCAAAATAAAAA","GGAGGTTGCAGTGAACCGAGATCGTGCCACTGCACTCCAGCCTGAGCGACAGAGTGAAACTTCGTCTCAAAAAAAA"
"GL873576","10920306","10920363","chr3","48261745","48261808","16","37341439","GCTGGACCTTGTAGAGAGTGCCTGTAATCCCAGCTACATGGGGGGCAAGAGAATTGCT","GCTGGGCATGGTGGTGCATGCCTGTGATCCCAGCTACTCAGGAGGCTGAGGCAGGAGAATTGCT"
"GL873576","10920398","10920529","chr10","67341428","67341546","30","56421030","GGCCAGGCGTGGTGGCTCACGCCTGTTGTCCCAGCACTGTGGGAGGCCGAGGTGGGTGGATTGCCTGAGCTCAGAGGAGTCCGGAAGACCAGCATGAGGCAGAGTGAGCCAGAGTAAGATCCTGTCTCTACC","GGCTGGGTGTAGTGGCTCATGCCTGTAATCCCAGCACTTTAGGAGGCCAAGGTGGATGGATTGCCTGAGCTCAGGAGTTCGAGACCACCCTGGGCAACAAGCCAAAACCCTGTCTCTAC"
"GL873577","515809","515961","chr7","137660778","137660931","43","137144969","AGCTGGGCATGGTGGCTCATGCCTATAACCCTAGCGTGCTAGGAGATTGCTTGTCAGGAGACTGAGGTTGCAGGAAACTGTGATGATGGCACTGCACTCTACCCAGGGTGACAGAGCAGGACTCTGCCTCAAAAAAAAAAAAAAAAATAGAAA","TTAGCTGGGCATGGTGGCGCATGCCTATAATCCCAGCTACTTGGGAGGCTGAGGCAAGAGAATCGCTTGAACCGGGGAGGCAGAGGTTGCAGACTGCACTCCAGCCTGTGTGACAGAGTGGGACTCCGTCTCAAAAAAAAAAAAAAAAAAAAAA"
"GL873577","1633164","1633256","chrX","38269524","38269615","26","36636360","TCAGCCAGGCATGGTGGCACTTGCCTATAAACCCAGCTCCTTGGGAAGCTGAGCCGGGAGGATCCCTTGCACCCAGGAGCAACGGAAGGCAGT","AATTAGCCAGGCATGGTGGCACATGCCTATAATCCCAGCTACTCAGAAGGTTGAGGCAGGAGAATCACTTGAACCTGGGAGGCAGAGGTTGC"
"GL873577","3979502","3979560","chr20","68909283","68909346","13","64929781","GAGTTTGAGACCAGCCTGAGCAAGACCGAGACCCAGTCTCTACTAAAAATAGAAAAATT","GGAGTTCAAGACCAGCCTGACCAACATGGAGAAACCCTGTCTCTACTAAAAAATACAAAAATTA"
"GL873577","3979839","3980009","chr10","31403126","31403287","39","27423287","ATGAGCAGATTGTCTTGGTGGGCACCTGTAGTCCCAGCTATTGGAGGTGGGAGGCTGAAGCAGGAAAATCTCTTGAGCCCAGGAGTTTGAGGTTGCTGTGAGCTAGGCTGACACCACGGCACTCTAGTCAGGGCGTCAGAGTGAGACTCCGTCTCAAAAAAAAAAAAAAAA","TTAGCTGAGTGTGGTGGCGCACATCTGTACTCCCAGCTATTTGGGAGGCTGAGGCAGGAAAATCGCTTGAACCCAGGAGGTGGAGGTTGCAGTGAGCCAAGATCACACTACTGCACTCCAGCCTGGGTGACAGAGTGAGAATCCATCTCAAAAAAAAGAAAA"
"GL873577","6050882","6051080","chr1","153219820","153220007","59","147168938","GGCTGGGCGTTGTGACTCATGCCTGTAATCCCAGCACTCTAGGAGGCCGAGGTGGGTGGACTGCCTGAACTCAGAGGTTTAAGACCATCCTGAGCCGCAGTGAGCCAGAGCGAGACCCTGTCTCTACCAAAAAAAGCTGGGTGTTGTGGTGGGCGCCTATAGTCCTAGCTACTTGAGGCGCTAAGGGTAAAAAAATTGC","GGCCTGGCACAATGGCTCACGCCTGTAATCCTAGCACTTTGGGAGGCCGGGGTGGGTGGATCACCTGAGATCAGGAGTTTGAGACCAGCCTGGCCAACATGGTGAAACTCCTTCTCTACAAAAATTAGCCAGGTGTGGTGGTGGGTACCTGCAATCCCAGCTATTTGGGAGGCTGAGGCAGGAGAATC"
"GL873577","8463965","8464050","chr9","52134422","52134508","19","43670457","CTGGGTGCTATAGCTCACGCCTATAATCCTAGCACTCTGGGAGTTTGGGGCAAATGGATCACCTAGGCTCAGGAGTTTGATACCAG","GGCTGGGAGCAGTGACTCACGCCTATAATCCCAGCACTTTGGGAGGCTGAGGCAGATGGATCACCTGAAGTCAGGAGTTCGAGACCA"
"GL873577","9471486","9471613","chr16","5178790","5178910","46","4292696","TTAGCCAGGCATAGTAGCCTGTGTGTAGTCCTAGCTACTCAGGAGGCTGAGGTAGATGGGTCACTTGAGGTTGCAGAGATTATGGTAATGTCACTGTACTCTAGCCCTGGCAACAGAGCACAACCCTG","TTAGCCGAGCCTGGTGGCATAAACCTGTAATCCCAGCTACTCAGGAGGCTGAGGCAGGGGAATTGCTTGAACCTGAGAGGAGAAGGTTGCAGTGAGCCGAGATTGCACCATTGCACCCCAG"
"GL873577","9471875","9471998","chr7","17832200","17832315","36","8360325","GGCCAGGTGAAGCAGCTCATGGCTATAATCCTAGCAGTTTGGCAGGCCAAGGTGGGAGGACTGCTTGAGGTCAAGAGTTCAAGACCAACCCATCTTTGCGAAAAATTTAAAAATTACCTAGGCA","GCCAGGAGAGGTGGCTCATGCCTCTAATCCCAGCACTCTGGAAATCCAAGGTGGGTGGATCACCTGAGGTCAGGAATTCCAGACCAGTCTGGCCAATATAAAAAATTAGCCAGGCT"
"GL873577","9853150","9853170","chr3","85044647","85044667","3","75191497","AAACAAACAAACAAAAAAAGA","CAAACAAACAAACAAACAAAA"
"GL873577","9853206","9853473","chr7","130818682","130818963","67","120965476","GCTGGGCGCAGCGTCTCACTCCTGTAATCCCAGCACTTGGGAGGCCAAGGTGAGTGGATTGCCTGAGTTTACAGTTTCGAGACCAGCCTGAGCCAAAGCGAGACCCCCATCTCTAAAAAATAGCTGGGCATTGTGGTGGGCACCTGTAGTCCCAGCTACTTGGGAGGCTGAGGCAAGAGGATCGCTTGAACCTAAGAGTTTGAGGTTGCTGTGAGCTAAGGCTCCATGGCATTCTACCAAGGGTGACTAAGTGAGACTCTGTCTAAAA","GCCGGGCACAGTGGCTCACACCTGTAATCCCAGTACTTTGGGAGGCCAAGGTGGGTGGATCACCTGAGGTCAGGAGTTTGAGACCAGCCTGGCCAACATAGTGAAACTCTACTAAAAATACAAAAAAATAGCTAGGCATGGTGGTGCGCACCTGTAATCCCAGCTACTTGGGAGGCTGAGGCAGGAGAGTTGCTTGAACCCAGCGGGGTTGAGGTTGCAGTGAGTTAAGATCAAGCCACTGTGCTCCAGCCTGGATGACAGAGAGAGACTCCATCTCAAAAA"
"GL873577","10722415","10722478","chr10","12501471","12501539","23","1779056","AATAAAAAAATGCTGGGTACAGTAGTACATGCCTGTACTCTCATCTGGGGAAGCTGAGGCATGA","AAAGTAAAAAATTAGAGCTGGGCATGGTGGCACACACCTGTAATCCCAGTCACTAGGGATGCTGAGGCA"
"GL873578","463331","463568","chr10","28935382","28935620","93","28472051","CAGGTGCTTTGACCCACACCCTCAACTCTAGGACTTTGGACGCCCTGGCTGGGTGGGTCCTTTAAAGTCAGGAGCTTCTTATCAGTCTGGGCAAAAGTGAGACCCCATCTCTACCAAACAAAGAAAGAAATCAGCAGTATGTTGCAGTAGAGACTCACCAATACCTTCTTTCAAAGACCAAAGCTGGAAGGACACTAAAGACCATGATCTCATGGCCTCCCTGAGCCATGACAATGCC","CCAGGTGCAGTGGCTCATGCCTGCAAGCTCAGAACTTTGGGAGGCAGAGGTGAGCAGACTGCCTGAGTTCAGGAGTTCAAGACCAGCTGGGCAACATGGTGAGACCCTATCTCTACTAAAAATACAAATAATTAGCAGGGTGTGGTAGCACACACCTGTAGTCCAGCTACTCAGGAGGCTGAGGCAGGAGAATTGCTTGAACCCAGGAGGCAGAGTTTGCAGTGAGCCAGGACTGGGCC"
"GL873578","1143712","1143827","chr11","52824583","52824692","30","51680871","GGCTGGGTGTGGTGCCTCATGCCTGTAATCTAAGCCCTCTCCGAGGCTGAGGTGGGAGGATCCCTTGAGTTTAGGAGTTTGATTTTGAGACCAGCCTGATCAAGAGAGAGACCTCA","GGCCGGGTGTGGTGGCTCATGTCTGTAATCCCAGCACTTTGGGAGGCTGAGGTGGGTGGATACCCTGAGGTCGGGAGCTCGAGACCAGCCTGACCAACATGGAGAAACCC"
"GL873578","1144101","1144139","chr3","33494224","33494257","11","32350123","GAGAGAGACCTCATGTCTACTAAAATAAATAAATATATA","GTGAAACCCGTCTCTACTAAAAATACAAAAATTA"
"GL873578","1144175","1144343","chr12","119519961","119520131","41","118375786","ATTATCCAGGCCTTCTGGTGGATGCCTGTAGTCCTAGCTACTAGAAAAGCTGGAGCAGAATCACTTGACCCAGGAGCTGGAGGTTGCAGGGAGCTAGGCTGATGCCACAGAATTCTAGCCTGAGGCAAAAGAATTGAGCCACTGTCTCAAAAAGGAACAAAAAAGAAAA","ATTAGCCAGGTGTGGTGGCATGCACTTGTAATCCCAGCTACTAAGAAGGCTGAGGCAGGAGGATCACTTGAACCCGGGAGGTGGAGGTTGCAGTGAGCCAAGATCATGCCACTGCACTCCAGCCTGGGCAACAGAGTAAGACTCTGTCTCAAAAAAAAAAAAAAAAAAAAA"
"GL873578","4593962","4594035","chr16","68825055","68825124","22","64231093","AGCTGGGTACAGTGGCTCACATATAATCCCAGTGACTCAGGAGGCTAAGACAGGAGGATTACTAGGACCTGAGA","GGCTGGGCACAGTGGCTCAGACCTGTAATCTCAGTACTTTGGGTGGCTGAGGCAGGTGGATCACCTGAGG"
"GL873578","6158845","6158972","chr3","500432","500562","24","5658413","GACATGGTGGCTCACACCTGTAATCCTAGCCCTCTGGGAGGCTGAGGCAGGTGGATCACTTGAGTTCAGGAATTCAAGACCAGCTTGAGTGAGAGCAAGACCCTGTCTCTACTAAAAATAGAAAAATT","GCACGGAGGCTCATACCTGTAATCCCAGCACTTTGGGAGGCTGAGGCAGGTGGATCACCTGAGGTCAGGAGTTCCAGACCAGCCTGGCCAACATGGCGAAACCCTGTCTCTACTAAAAATACAAAAAATCT"
"GL873578","6159253","6159444","chr19","34496349","34496541","55","28337096","ATAAAATAAAAATAGAAAAATTAGCCAGGCATTGTGGCAGACATGCGAAGTCTCAGCTACTCCAGAGGCTGAGACAGGAAGATTACTTGAGCCCAAGAATCTTGCTGTGAGCTAAGCTGATGCCATAGCATTGTAACCTAGGCAACAGAGTAAGACTTGGCCTCAAAAATAAAATAAAATAATAAAGTAAAA","TTAGTTAATTAAATTAAACTTAGCTAGGCATAGTGGAACACACCCATAGTCCCAGCTACTCTAGAGGCTGAGGCAGGAGGATTGCTTGAGCCAAGTTGGAGGCTGCAGTGAGCTATGGTGGTGCCACTGCATTCCAGCCTCAGTGACAGAGAGAGACCCTGGCTCAAATAATAATAATAAATAAATAAATAAA"
"GL873578","6766040","6766171","chr2","93098086","93098217","30","86332046","CCAGGCACAGTGGCTCATGCCTATAATCCTAGTAGTCTAGGAGGCTGAGGTGAGTGCATTGCTTGAGCTCAGGAGTTAGATACCAGCCTAACCAAGAATGAGACCCCATCTCTATTAAAAATAGAAAAGTTA","GCCGGGCACAGTGGCTCATGCCTGTAATCCCAGCACTTTGGGAGGCCGAGGCGGGCAAATCACGAGGTCAGGAGTTCAAGACCAGCCTGACCAATATGATGAAACCCCGTCTCTATTAAAAATACAAAAATT"
"GL873578","6766434","6766577","chr9","21128084","21128223","50","14361650","GTTAGCCAGGAGTTGTGGCGGGCACCTACAGTCCTAGCGACTCAGGAGGCTGAAGTAGGCAGAGTTTGATGTGTTGCTGTGAACTACAAGGACACCAATGCACTCTAGGCCGGTAACAGAGTGAGACACTGACTAAAAAAAAAA","TTAGCCAGGTGTGGTGGCACATGCCTGTATTTCCAGCTACTCGGGAGGCTGAGGCAGGAGAATTGCGTGAGCTGAGATCATGCCACTTCATTCCAGTCTGGGTGACAGAGTGAGACTCTGCCTCAAAAAACAAAACAAAA"
"GL873578","7397948","7398119","chr5","40230148","40230319","43","32832200","TAAAAATAGCCATGCATTGTGACAGGCACCTGTAGTCCCAGCTACTCAGGAGGTTGAGGTAAGAGAATCACTTGAACCCAAGAGTTTTGAGGTTGTTATGAGCTAAGACGCCTCGGGACTCTACAAAAGGTAACAAAGTGAGACTCTGTCTCATAAAAAAAGAAAAAAAGAA","AAAATTAGCCAGGCATGGTGACGTACACCTGTAGTCCCAGCTACTCGGGAGGCTAAGGCAAGAGAATCGCTTGAACCCAGGAGGCAGAGGTTGCAGTGAGCTTAGATCACGCTACTGCGCTCCAGCCTGGGTGACGGAGTGAGACGCCATCTCAAAAAAAAAAAAAAAAAAA"
"GL873578","7398378","7398515","chr15","102382935","102383070","35","94984557","GGTCGAGCAAGGTGGCTCACGCCTGTAATCCTAGCACTCTGTGAGGCTGAGGCAGATGGATTGCCTGAGCTCGTGGGTTCGAGACCAGCCTGAGCCAGAGTGAGACCTCATCTCTAAAAATAGCTGGGAAGCTGGGCA","GGCCAGGTGTGGTGGCTCACGCCTGTAATCCTAGCACTTTGGGAGGCTGAGGCGGGTGGATTGCCTGAACTCAGGAGGTCAAGACCAGCCTGGGCAACACAGTAAAACCCCATCTCTACTAAAATACAAAAAATCA"
"GL873579","370235","370429","chr16","38067345","38067552","57","37697110","GCACAGGCCTGAAATCCTAGCACTCTGAAAGGCCAACGGAGGAGAATTTCTGGAGCTCAGGAGTTTGATACCAGCCTAAGCAAATAAAGCTAGACCTCTATCTCTACTAAAATTAGAAAAATTAGGCAGATGTGGTGGTAGGCACCTATAGTCCCAATTACTCCAGAGGCTGAGGCAGAAAGACTCTTGAACCCA","GTCAGGCATGGTGGCTCATGCCTATAATCCTAGCACTTTGGGAGGCCAAGGCCGGTGGATCACCTGAGGTCAGGAGTTTGAGACCAGCCTGGCCAATATGGCAAAACCCCGTCTCTACTAAAAATAAAAAAATTAGCTGGGCACGGTGGTGGGCACCTATAGTCCCAGCTACTCAGGAGGCTGAGGCAGGAGAATTGCTTGAACCCAG"
"GL873579","370936","371046","chr3","3847698","3847802","33","3476762","TGACTCTTGAACCCAGGCACATGAGGTTGCTAAGAGTCTAGGCTGATGTCACGGCACTCTAACCTGGGAAACAGTGTGAGGTTCTGCCTCAATAAATAAATAAATAAATAA","TGGCTTGAACCCAGGAGGCGGAGGTTGCAGTGAGCCGAGATCACGCCACTGCACTCCAGCCTGGGCAACAGAGCGAGACTGTCTCAAAAAAAAAAAAAAAAAAAA"
"GL873579","599436","599605","chr10","38982686","38982853","41","38383250","AAAAAGTCAGACATTGTGGCAGGTGTCTGTAATCCCAGCTATTTGGGAGGCTGAGGCAGGAGTATCATTTGAACCCACGAGTCTGAGGTAACTGTGAGCTAGGCTAACACAACAGCACTCTAGCCTGGGCAATAGAATGAGACTCTATCAAGAAAAGAAATGAAAAGAAA","TATTAGCCTGACACAGTGGCGCGCATCTGTAATCCCAGCTACTTGGGAGGCTGAGGCAGGAGAATCACTTGAACCCAGGAGGCGGAGGTTGCTGTGGGCTGAGATCATGCCACTGCACTCCAGCCTGGGCAACAGAGGGAGGCTCCATCTCAAAAAAAAAAAAAAAAA"
"GL873579","599942","599953","chr3","71473700","71473710","4","70873758","TTTTAAAATAGT","TTTAAAAAAAA"
"GL873579","600232","600365","chr1","16061315","16061447","30","15461083","GGCTAGGCAAGGTGACTCATGTCTGTAATCCTAGTACTCTGGGAGGTTTGAGGCAGGAAGACCACTTTAGCTCAAGAGTTCCAGATCAGCCTGTGCAAGAGTGATACATCATCTCTACTAAAAATCAAAAATTA","GGCTGGGCATGGTGGCTCATGCCTGTAATCCTAGCACTTTGGGAGGTTGAGGCAGGCAGATCACTTGAGGTCAGGAATCTGAGACTAGCCTGGCCAACATGGTGAAACTCCATCTCTACTAAAAAAAAAAAAA"
"GL873579","5650320","5650591","chr6","54938866","54939145","71","49288546","GTCAGGTGTGTTAGCTTACAGTAGTAATCCTAGCACTTTGGGAGGTTGAAGTGGGTGGATTGCTTGAGCTCAGGGGTTCAAGACCAGCCTGAACAAGAGTGGGACCTCATCTCTATTAAAAACAGAAAAACTAGCTGGGTGTTATGGTGGGTGTCTGTAGCCCCAGCTACTCAGGAGGCTGAGGCAGGAGGTTGAGGTTGCTGTGAGCTATTGAGACCACAGCACTCTATCCAGGGCAACAGAGTGAGACCCCTCCCCCCCCCAAAAAAAAA","GGCCAGGTGTGGTGGCTCACGCCTGTAATCCCAACACTTTGGGAGGCCGAGGTGGGTGGATCACCTGAGATCAGGAGTTCAAGACCACCCTGGCCAACATGGTGAAACCCCGTCTCTACTAAAAATACGAAAATTAGCTGAGTGTGGTGGTGCATGCCTGTAGTCCCAGCTACTCAAGAGGCTGAGGCAGGAGGTGGAGGTTGCAGTGAGCCGAGATTGCATCACTGCACTCCAGCCTTGGCGACAGAACGAGAGAGACTCCATCTAAAAAAAAAAAAAA"
"GL873579","7037162","7037347","chr3","37328686","37328893","67","30291524","GAGGTGGGTGGATTGCCTGAGCTCACAGGTTGGAGACCAGCCTGAGCCAGAGCAAGACCTTATCTCAAAAAATAGCCAGGTGTTGTGGCTGGCACCTGTAGTCCCAGCTGCTCAGGAGGCGGAGGCAAGAGAAATGCTTGACCTCAGGAGTTTGAGGTTGCTGTGAGTTCAACTCACACTAATACA","GAGGCAGGGGGATCACCTGAGGTCAGGAGATCGAGACCAGCCTGGCCAACATGGTGAAAACCTGTCTCTACTAAAAATCCAAAAACATTAGCCAGGTGTGGTGGCACGCACCTGTAATCCCAGCTACTTGGGAGGCTGAGGCAGGAGAATCACTTGAACCTGGGAGGCAGAGGTTGTAGCGAGCCGAGATCACACCACTGCACCCCAG"
"GL873579","11077764","11077972","chr19","1200469","1200683","63","9877295","GCCAGGTGCAGTGGCTCATGCCTATAATCCTAGCACCCTAGGAGGCTGAGGAGTTCAAGACCAGCCTAAGCAACTGTGAGACCCCATCTCTACCAAAAATAGAAAAATTAGCTGACTGTTATGGTGTGCACCTACAGTCCTAGCTACTCAGGAGGCTGAGGCAGAAAGAGTCCTTGAACCCAGGAGGCTTTTTTTTGTTGTTGTTGTTG","GGCCAGTCGCGGTAGCTCATGCCTGTAATCCCAGCACTTTGGGAGGCCGAGGCGGGCAGATCACCTGAGACCAGCCTGGCAACATGGTGAAACCCCATGTCTACCCAAACTACAAAAATTAGCTGGGTGTGGTGGTGCACGCCTGTAATCCGAGCTACTCAGCAGGCTGAGGCAGGAGAATCCCTTGAACCTGGGAGGCAGAGGCTGCAGTGAGC"
"GL873579","11078245","11078333","chr19","4926258","4926351","22","6151987","TGAACCCAGGAGTTTGAGTTCGCTGTGAGCTAAGCTGAGGCCACAGCACTCCAGCCTGGGCAACAGAGTGAAAGGAAAAAAATAAAAAA","TGAACCCGGGAGGTGGAGGTTGCAGTGAGCCAAGATCACACCAATGCACTCCAGCCTGGGCAACAAGAGTGAAACTCTGTCTAAAAAAAAAAAA"
"GL873580","320374","320488","chr13","48549305","48549409","42","48228931","GGTAGTGCGTGCCTGCATTCCCAGCTACGGGAGGGCAGGGACTTGAGGCCAGCCTGGGCAAAATAATGAGACCTACTAATGACTCTACTAATACAGAAACAATTAGCTAGGTATG","TGGGAGGCCGAAGTGCGCAGATCACCTGAGGTCAGAAGTTGGAGACCAGCCTGGCCAACATGGTGAAAACCCATCTCTACTAAAAATACAAAAATTAGCTGGGCA"
"GL873580","374969","375091","chr6","147681010","147681135","27","147306041","CGGTGGCTCACACCTATAATCCTAGCATTTTGGAAGGCTGAAGCCGAGGATCTCTGGAAGTCAGAAGTTCAAGACCAGCCTGCCCAAGAGCAAGACCCCATCTCTACTAAAAATAGAAAAACT","GGTGGCTCACACCTGTAATCCCAGCATTTTGGGAGGCTGAGGCAGGCGGATAATCTGAGGTCAAGAATTTGAGACCAGCCTGGCCAACATGGAGAAACCCTATCTCTACTAAAAATACAAAATTAC"
"GL873580","375369","375549","chr7","19977275","19977456","44","19601906","CTAACCAAGTTAGTTAGTTTTAGTTGGCAGGTGCCTGTAGTCCCAGCTCCTTGGGAGGCTGAGGCAAGAGAATGGCTTGAGCCCAGGACTTTGAAGTTGCTGTGAGCTATAATGACACCACAGCACACTACCCAGGGTGACAGAGTGAGACTGTCTCAAAAAAACAAACAAACAAAAAAAA","AACAAACGTTAGCCGAGCATGGTGGTATGTGCCTGTAGTCCCAGCTACTTGGGAGTCTAAGGCAGGAGAATTACTTGAGCCCGGGAGGCAGAGGTTGCTGTGAGCCAAGATCACGCCACTGCACTCCAGCCTGGGTGACAGAGTGAGACTCCATCTCAAAAAAAAAAAAGGAAAAAAAAAAA"
"GL873580","8760922","8761015","chr11","104681322","104681416","19","95920400","GGAGGGAGACACTGCAGTGAACTGCGATCGTGTCTCTGCTTTCCAGGCTGGGTGACAGAGTGAGACTCGGTCTCTAAAATAAAAAATAAATAAA","GGAGACGGAGGTTGCAGTGAGCTGTGATCGCGGCACTGCACTCCAGCCTGGGCAACAGAGTGAGACTCTGTCTCAAAAATAAATAAATAAATAAA"
"GL873580","9391260","9391306","chr14","49279240","49279285","12","39887980","GCCAGTCGAGGTGGCTCACACTTGTGATTCCAGCTACTTGGAAGACT","GGCTGAGATGGTGGCACACACCTGTAATCCCAGCTACTTGGGAGGC"
"GL873581","759283","759365","chr6","46535476","46535542","30","45776193","TAAGAACCTGAAAATAGAGCCAGGCATAGTGGTACATGCGTATAGTCCTGGCTACTCAGGAGGTTGAAACAACAGGATTACTT","CAAAATAGCCAGGCTTGGTGGTGCATGCCTATAATCCAAGCTACTCGGGAAGCTGAGGCAGGAGAAT"
"GL873581","1145844","1145979","chr1","29437872","29437991","29","28292028","GGCCGGGCGTGGTGGCTCACGCCTGTAGTCCCAGCACTATGGGAGGCCGAGGCGGGTGGATCACCTGTGCTCAGAGGTTCGAGACCAGCCAAGACCCCCCTGAGCCAAATGAGCCAGAGTGAGACCCCGTCTCTAC","GGCCGGGCGTGGTGGCTCACGCCTGTAATCCCAACATTTTGGGAGGCCAAGGCGGGTGGATCACCTGAGGTCAGAAGTTCGAGACCAACCTGGCCAACATGGTGAAACCCCTGTCTCTAC"
"GL873581","9628238","9628362","chr5","141044567","141044691","34","131416329","ATCCCAGGTAGTCGGGAGGCTGAGGCAGGAGGATCACTTGAACCCAGGAGGTTGAGGTTGCTGTGAGCAAGGCAGAGGCAACGGCACTCTAGCCACGGGGGCACAGAGACTCTTGTCTTTAAAAA","TAATCTCAGCTACTCGGGAGGCTGAGGCAGGAGAATCGCTTGAGCCCAGAAGGTGGAGGTTGCAGTGAGCCAAGATCGCGCCATTGCACTCCAGCCTGGGCGACAGTGCGAGACTCTGTCTCAAA"
"GL873582","1580485","1580534","chr6","32576760","32576806","12","30996275","CAGCACTTGAGAGGCCAAGGCAGGTGGATCAACTGAGCAAGAATGAGACC","CCAGCACCTTGAGAGGCCAAGGCAGGTGGATCACCTGAGGTCAGGAG"
"GL873582","1644368","1644551","chr1","211626449","211626612","63","209982081","AAAATTTGCCGGGCTCCATAGCTCATGCATGTAATCATAGCACTCTGGGAGGCCAAGATGGGAGGATCTCTCAAGCTCTCTTACTTGGGAGGCTGAGGTTGCTGTGAGTTAGGCTTACGCCACAGCACTCTACTCTAGCGTGAGCAACTCTACTCTTAGTATGAGACTGTCTCAAAAGAAAAAA","AAATTAGCCAGGCGTCGTGGCACATGCCTGTAATCCCAGCTACTCGGGAGGCTGAGGCAGGAGAATAGCTTGATCTCGGGAGGCGGAGGTTGCAGTCAGCCGAGATCACACCACTGCAATCCAGCCTGGACAACAGAATGAGACTCCATCTCAAAAAAAACAAA"
"GL873582","5794385","5794459","chr13","18872784","18872852","27","13078399","ATATTGTTAAGCACAGCCACTATTAAAAATTAAATTATAGGCCAGGCATAGTGGCTCATGCCTGTAATCCTAGCT","TGAAACCACCATCTGGACCAAGATACAAAATGTTGGCTGGGCATGGTGGCTCACACCTGTAATCCTAGC"
"GL873583","102645","102683","chr14","5808766","5808804","14","5706121","GAGCAGATCACCTGAGCTCAGGAGTTTGAGACCAGCCTG","GAGGAATCCCTGTGCTCAGGAAGCTTACATTCTAGTGAG"
"GL873583","6200447","6200560","chr4","17786849","17786963","24","11586402","GGCCAGGAGGGACGGCTCATGCCTGTTATCCTAGCACTATGGGAGACTGAGGTGGGAGGATCACTTGAAGTTAGGAGTTCCAGACCAATCTGACCAAAGTGAGACCTCATCTCT","GGCCAGGCTTGGTGGCTCATGCCTGTAATCTTAGCACTTTGGGAGGCTGAAGTGGGTGGATCACTTGAGGTCAGGAGTTAGAACCAGTCTGGCCAACATGGTGAAACCTCAGCTC"
"GL873583","6200584","6200752","chr6","169626528","169626696","42","163425944","TTAGCTGGATGTGGTAGCACATGCCTATAGTCCCATCTACTCAGGAGGCTGAGACAAGAGAGTTGCTTAAGCCCAGGAGTTTAATTTAACTGTGAACTAGACTGAGACTGTGGCACTCTAGCTGGGGCAACAGAGTGAGACTCTGTCTCAAAAGAAAGCAAGAAAGAAA","TTAGCTGGGTATGGTGTCAGATGCCTGTAGTCCCAGCTACTCAGGAGGCTGAGACAGGAGAATCGTTTGAACCCAGGAGGCCAGAACTGCAGTGAGCTGAGATTCGCACCACTGCGCTCCAGCCTGGGCCAGACAGAGTGAGACTCTATCTCAAAAGAAAAAAAAAAAA"
"GL873583","10217398","10217583","chr3","36257142","36257313","44","26039744","TACTAAAAATAAAGTGTGATAGCCAGGCATGGTGGTGGTGCCTATAGAACCAGGCTATTCAGGAGGCTGAGGCAGAAGGATCACTTGAACCCAGGAGTCTGACGTTGCTGTGAGCTAGGCTGGTGCCATGGTACTCTAGCCTGTGGTAACAGAATGAGACTCTATCTCAAAAATAAAAATAAAAAA","TACAAAATTAGCCAGGCGTGGTGGTGCGTGCCTGTAATCCCAGCTACTTGGGAGGCCGAGGCAGAAGAATGACTTGAACCCAGGAGACAGAGGTTGCAGTGAGCCAAGATCCCACCATTGTACTCCAGCCTGGGCAACACAGTGAGACTCCATCTCAAAAAAAAAAAAAAAA"
"GL873583","10394919","10394983","chr16","12841703","12841771","22","2446784","GAGGTCAGGAAATCAAGATCAGTCTGGGCAATATATTGATACCCTGCCCCTACATAAGGAAGAAA","AGGTCAGGAGTTCAAGACCAGCCTGGCCAATATGTTGAAACCTCATCTCTACTAAAAATACAAAAATTA"
"GL873584","521512","521529","chr1","167402212","167402233","10","166880700","GCATGGAACCCCCCACTC","GGTGAAACCCCATCTTTACTAA"
"GL873584","2079725","2079768","chr15","4338291","4338335","11","2258566","GGCAGGTGGATTACCTGAGTTCAGGAGTTGGAGACCAGCCTGAC","AGGCGGATGGATCACGAGGTCGGGAGTTTGAGACCAGCCTGACCA"
"GL873584","5216877","5217053","chrX","91350057","91350230","49","86133180","CTACTGAAAATGATGACAGAGGCTGGGCATGGGGGCTCCCGCCTGTTATCCTAGCACCCTCGGAGGCTGGGGAATGAGGATTGCTTACGCCCAAGAGTTTGAGGTTGCTGTGAGCTGAGGCCGCTGCACTCTAGCCTGGGCAACAGAGTGAGACTCTGTCTCAAAAAAAAAAAAAAA","TGCAAAAATGAGCTGGGCATGGTGGCACATGCCTGTAATCCCAGCTACACAGGAGGCTGAGGCAGGAGAATCGCTTGAATCTGGGAGGCGGAGGTTGCAGTGAGCTGACATCAGGCCCCTGCACTCTAGCCTGGGCCACAGAGCAAGACTCCGTCTCAAAAAAAAAAAAAAAAA"
"GL873584","7289930","7289950","chr2","51453328","51453345","10","44163398","TGAGGCTCTGTCTCGAAATAA","AATGCCATCTATTAAAAA"
"GL873584","7289975","7290131","chr11","49739997","49740154","37","42450022","CAAGAAAATTAGCTGAGAGTCCTGGTAGGTGCCTGTAATCCCAGCTATTCATGAGGCTGAGGCAGAAGGATCACTTGGGTCCAGGAGTCTGAGGTTGCTGTGAGCTAGTCTGACGCCATAACACGCAAGCCTGGGCAACAGAGTGAGGCTCGGTTTC","CTACAAAAATTAGCTGGGCGTGGTGGCACATGCCTGTAATCCCAGCTACTCGGGAGGCTGAGGCAGGAGAATCACTTGAGCCCAGGAGGCGGAGGTTGCAGTGAGCCAAGATCATGCCATTGCACTCCAACCTGGGCAACAGAGCAAGACTCCATCTC"
"GL873584","7577743","7577867","chr5","48394329","48394446","27","40816586","GGCTGGATGAGGTGGTTCATGCCTGTAATCCTAGCACTCTGGGAGGCCAAGGTGGGTGGATTGCCTGAGCTCAGGAGTTCAAGACCAGCCTGAGCAAGACCCTGTCGCTAAAAATAGCTGGGTGT","GGCTGGGTGCAGTGGCTCATGCCTGTAATCCCAGCACTTTGGGAGGTCAAGGCGGGTGGATCACCTGAGGTCAGGAGTTCAAGACCAGCCTGGCCAACATCTCTACTAAAAATACAAA"
"GL873584","7578135","7578289","chr1","130112713","130112865","31","122534578","GGAGCTGGGTTTTGTGACTGCACCTGTAATCCCAGCTGCTCAGGAGGCTGAGGCAAGAGAATTGCTTGAGCCCAGGAGTTGGAGGTTGCTGTGAGCTGTGATGCCAGGGAACTCTACCAAGGGTGACAAAGTGAAACTCTGTCTCAAAAAAAAAA","TTAGCCAGGTGTGGTGATGCATGCCTGTAATCCCAGCTACTCATGAGGCTGAGGCAGGAGAATTGCTTGAACCTTGGAGCTGGAGGTTGCAGTGAGCTGAGATCAGACCACTCCAACCTGGGTGACAGAGCGAGACTCTGTCTCAAAAAAAAA"
"GL873585","1450952","1451121","chr10","59681079","59681242","48","58230127","TAAAAACAGAAAAAACTAGTCAGGTGGTGTGGTAGGTGCTCATAAGTCCCAGCTGCTTGGGAGACTGAGGCAAGAGAATCACTTGAGCACAAGAGCTTGAGGTGGCTGTGAGCTATAACACCATAGCACTGTACTGAGGGTGACAAAGTAAGACTCTGTCTCAAAAAAAA","TACAAAAATTAGTCAAGGGTGGTGGTATGTGCTTGTAATCCCAGCTATTTGGGAGGCTGAAGCAGGGGAATCCTTGAACCCAGGAGGTGGAGGTTGCAGCGAGCCGAGATCACGTCACTGCACTCTAGCCTGGGCGATAGGGTGAGACTCTGTCTCAAAAAAAA"
"GL873585","1451382","1451515","chr6","17405813","17405948","24","15954431","GGCCCGGCTCGGTGGCTCACACCTATAATCCTAACACTCTGGGAGGCTGAGGCAGGTGGATCACCTGAGCTCAGGAGTTTGAGACCAGCTGAGCAAAAACAAGACCCTATCTCTGCTAAAAATAGAAAAAACTA","GGCCGGGCGGGGTGGCTCACGCCTGTAATCCCAGCACTCTGGGAGGCCAAGGCAGGTGGATCACCTGAGGTCAGGAGTTTGAGACCAGCCTGGCCAACACGCAGAAACCCTATTTCTACTAAAAACACAAAAATTA"
"GL873585","1626960","1627026","chr7","17782729","17782794","22","16155769","AAGATGCCACAGCACTCTACAAGAGTGACCAAGTGAGACTCTGTCTCAAAAAAAAAAAGAAAAGGAA","CAATCGCACTACTGCACTTCAGCCTGGGTGACAGAGTGAGAACCTGTCTCAAAAAAATAAATAAAA"
"GL873585","1627304","1627531","chr11","17033552","17033788","61","15406248","GGCTGGGCACAGTGGCTCACGGCTATAATCTAGGCACTTGGGAGGCTAGGGCAGGTGGATTGCCTGAACTGACAAGTTTGAGACCAACCTGAGCAAGAGCGAGACCCCTGTCTCTAAAACATAGCCAGGCTCTGTGGTGGGCGTCTGTAGTCCCAGCTACTTGGGAGGCTGAGGCAAGAGAATTGCTTGAACTCAAGAGTCTGAGGTTGCTGTGAGTTAAGATGCCAC","GCCCGGCGCAGTGGCTCACGCCTGTAATCCCGGCACTGTGGAGGCCAAGGCAGGCGGATTGCCTAAGCTCAGGGATTCGAGAACAGCCTGGGCAACATGGTGAAACCCCATCTCTACTAAAATACAAAAAACTAGCCGGGCGTGGTGGTATGCGCCTGTAATCCCAGCTACTTGGGAAGCTGAGGCAGGAGAATTGCTTGAACCCGGGAGATGGAGGTTGCAGTGAGCTCAGATCAC"
"GL873585","3626082","3626158","chr1","100916857","100916922","27","97290775","TGCCTGTAATCCCAGCACTTGGGAGGCGGAGGTGGGTAGATTGCCTGACCCAGAGTGGGACCTCATCTCTAAAAGAA","CATGCCTGTAATCCCAGCACCTTGGGAGGCCAAGGTGGGTGGATCACCTGAGGTCAGTAGTTTGAG"
"GL873585","8849829","8849913","chr18","48581945","48582025","18","39732116","GGCTGGACGAGGGGACTCATGCCTGCAATCCCAGCACTGAGAGAGGCCAAGGCAGGTGGATCCCCTGAGCTCAGAAGTTTGAGAC","GCTGGACGCAGTGGCTCACACCTGTAATCCCAGCACTTTGGGAGGCCAAAGCAGGCAGATCTGAGGTCAGGAGTTTGAGAC"
"GL873585","9319890","9319971","chr8","79499361","79499447","14","70179471","GGCCAGGTGTGGTGGCTCACACCTGTCATCCTAGCACTCTGGGAGGACGAGGTGGGTGGACCGCCTGAGTCAGAGTGAGACC","GGCCAGGTGTGGTGGCTCACACCTGTAATCCCAACACTTTGGGAGGCCCAGGTGGGTGGATCACCTGAGGTCAGGAGTTCAAGACCA"
"GL873586","895572","895692","chr17","14501559","14501680","38","13605987","GGCCAGGTGAGGTTTCTCATTCTGGGAGTGAGCCAGCAATTGGGAGGCCAAAGTAAATGGATTGCCTGAGGTTATAGGTTCCAGAACAGCCAGAACAAGATCGAAATCCTGTCTCCAAAAA","GGCCAGGCGTGGTGGCTCATGCGTGTAATCTCAGCACTTTGGAAGGCCGAGGCAGGTGGATCACCCGAGGTCAAGAGTTCAAGACCAGCCTGACCAACATGGCGAGTCTCTGTCTCCACTAA"
"GL873586","5645995","5646150","chr6","58863249","58863409","38","53217254","GGGTATGGTGGCTCATGCCTGTAATCCAAGCACTCTGGGATGGTGAGGCAGGAGAATCCCTTGAACCCAAGAGTCCGAGGTTGCTGCGAGCTAAGCTGATGGCATAACACTCTAGCCTAGGCGACAGAGTGAGACTCTGTTTCCAAAGAGAAAAAA","TTAGCCAGGCATGGTGGCACATGCCAGTAATCCCAGCTACTCAGGAGGATGAGGCAGGAGAATCGCTTGAACCCAGGAGGCAGAGGTTGCAGTGAGCTGAGATTGCGCCACAGCACTCTACCCTGGGTGACAGAAGGAGACTCTGTCTCAAAAAAAAAAAA"
"GL873586","10258686","10258969","chr12","9481260","9481565","81","777426","GGCCGGGCATGGTGGCAGAAATCTAGGAGGCCGAGGCAGGTGGATCGCCTGAGATCACAAGTTCAAGACCAGCCTCAGCTACAGCAAGACCCCATCTCTAAAAATAGCCGGCTGTTGTGGCAGGCGCCTGTAACCCCAGCTACTCGGGAGGCTAAGGCAAGAGAATCGCTTGAGCCCATGAGTCTGAGGTTGCTGCGAGCTGTGACTCCACGGCACTCTACCCGGGGCGATAAAATGAGATTCTGTGTCAAAACAAACAAACAAACAAACAACAACAAAAACAA","GCTGGGCGCGGTGGCTCATGCCTGTAATCCCAGCACTTTGGGAGGCCAAGGCAGGTGGATCACCTGAGGTCAGGAGTTCGAGACCAGCCTAGTCCACATGGTGAAACCCCATCTCTACTAAAAACTAGCCAGGCGTGGTGGTGCGCACCTGTAATCCCAGCTACTCGAGAGGCTGAGGCAGGAGAATCACTTGAGCCTAGGAAGCAGAGGTTGTGGTGAGCTGAGATCACACCACTGCACTCCAGTCTGGGCGACACAGTGAGACTCTTGTCTCAAAAACAAAAAACAAACAAACAAACAAACAAA"
"GL873587","3208032","3208047","chr8","3626746","3626762","2","418714","AAACAACCACAAAAAA","ACAACAACAACAAAAAA"
"GL873587","3208141","3208321","chr19","2057131","2057316","59","1151010","TTTCTTTTAAAAATCACCCATGGGCTGGGTATAGTGGCTCACACCTATAATCCTCGGGAGGCCAAGGTTGGAGGATTGCTTGAATCCAGGAGTTGAAGGTTACAGTGAACTGGGATTTAGCCACTAGACTCTAGCATAGCTGACAAAGCAAGAACCTATTTGTTTAAAACACAAAAAAGAA","TACTAATAATACAAAAATGAGCCGGGTATGGTGGCGGGTGCCTGTAATCCCAGCTACTGAGGAGGCTGAGGCAGGAGACTTGCTTGAACCCAGGAGGTAAAGGTTGCAGTGAGCTGAGATTGCACCACTACACTCCAGCCTGGGCGACAAGAGCAAAACTTTTTCTCCAAAAAAAAAAAAAAAAAA"
"GL873587","3278260","3278367","chr19","19044200","19044312","39","15765940","CAGTCTGAGCAAGAGGGAGAGGCTATTTCTACTAAAAACAGAAAAACTAGCTGGGTGTTGGGGTGTGTTCCTAGTCTCAGTTACTTGGGAGGCTGAAGTAAGAGGATC","ACCAGCCTGGCCAACACGGTGAAATCCCGTCTCTACTAAAAATACAAAAATTACCTAGGCGTGATGGCACGTGCCTGTAGTCCCAGCTACTCATAAGGCAGAGGTGAGAGAAT"
"GL873587","3278673","3278754","chr7","49412503","49412597","28","46133830","GGCCACGAGAGCTAGCTCATGCCTATTCTAGGAGGCCAAAGCAGGCAGACTGCCTGAGCTCAGGAGTTCAAGAGCAGCCTGG","GGCCAGGTGCAGTGGCTCATGCCTGTAATCCGAGCACTTTGAGAGGCCGAGGCAGGCAGATCACCTGAGGTCAGGAGTTCAAGACCAGCCTAGTA"
"GL873587","3782076","3782188","chr9","112128434","112128552","34","108346358","ACTGGGGTGGCTGAGGCAGGAGCGTCACTTGAACTCAGGAGTTTGAGATTGCTGTGAGCTGAGCAGATGTCATGGCACGCTAGCCTAGGTAATAGAGTGAGACTTCGTCTAAA","CAGCTACTCGGGAGGCTGAGGCAGGAGAATCACTTGAACTCGGGAGGCGGAGGTTGCAGTGAGCCGAGATCACGCCATTGCACTCCAGCCTGGGCAACAAGAGCGAAATTCCATCTCAA"
"GL873587","4564996","4565084","chr20","27900350","27900437","14","23335354","GGCGGGGTGTAGTGGCTCATGCCTATTGTCCCAGCACTGTGGGAGGCCGAGGTGGGTGGATCACCTGTGCTCAGAAGTTTGAGACCAGC","GGCCGGGCGTGGTGGCTCATGTCTGTAATCCCAGCACTTTGGGAGGCCGAGGTGGGTGGATCACCTGAGGTCAGGAGTTCAAGACCAG"
"GL873587","6307870","6308175","chr12","112427710","112428020","54","106119840","GGCCAGATATGATGGCTCATGCTTGTAATCCTAGCACTCTGGGAGGCTGAAGTGGGAGGATCACCTGAGATCAGGAGTTCAAGATCACCCTGAGCAAAAGTGAGATCCCATCTCTATTAAAAATAAAAAAATTATCCAGGCATGGTGGTGCAGTCCTTTAGTCCCAGCTACTTGGGAGGCTGAGGCAGGAGAATCTCTTGAACCCAGGAATTAGAGGTTACAGTGAGCTGTGATGATGCTACTGCACTCTAGCAGGATGACAGAGTGAGATACTCCGTGTCAAAAAAAAAAAAAAAAAAAGCAAAA","GGCTGGACATGGTGGTTCATGCTTGTAATCCGAGCACTTTGGGAGGCCAAGGCGGGTGGATCACCTGAGGTTGGGAGTTCGAGACCAGCCTGACCAACATGATGAAACCCCATCTCTACTAAAAATACAAAAAAATTAGCCAGGCATGGTGATGCACGCCTGTAATCCCAGCTACTTGGGAGGCTGAGGCAGGAGAATCACTTGAACCCAGGAGGCAGAGGTTACAGTGAGCCGAGATCATGCCATTGCACTCCAGCCTGGATGACAGAGTGAGCCTCTGTCTCAAAAAAAAAAAAAAAAAAAAAAAAAAA"
"GL873587","6484004","6484128","chr10","67341428","67341546","29","60857424","GACCAGGTTCTGTGGCTCATGCTTGTAATCCTAGCACTCTAGGAGGCCGGAAGAGGGTGGATTGATTGCCTGAGGTCAGGAGTTAGAGACCAGCCTGAGCAAGAGCTAGACCCTGTTTCTTTCTT","GGCTGGGTGTAGTGGCTCATGCCTGTAATCCCAGCACTTTAGGAGGCCAAGGTGGATGGATTGCCTGAGCTCAGGAGTTCGAGACCACCCTGGGCAACAAGCCAAAACCCTGTCTCTAC"
"GL873587","6484407","6484586","chr3","167196537","167196723","48","160712130","TAGACCCTGTTTCTAAAAAAAAAATAGCCAGGTGTTGAGGCAGGTACCTGTAGTCCCAGCTACCTGGGAGGGCTGAGGCAAGAGAATCGCTTGAACCCAAGAGTTTGAGGTTGCTGTGAGCTGAGATGCTATGGCACTCAACCGTGAGCTACAAAGTGAGACTCTGTCTCAAAAAAAAAA","AAAACCTGTCTCTGCTAAAAATACAAAAATTAGCCGGGTGTGGTGATGTGCGCCTGTAGTCCTAGCTACTTGGGAGGCTGAGGCAGGAGAATCACTTGAATCCAGGAGGTGGAGGTTGTAGTGAGTCGAGATCGTGCGACTGCACTCCAGCCTGGGTGACAGCGAGACTCTGTCTCAAAAAAAAAAA"
"GL873587","7466229","7466364","chr1","29437872","29437991","35","21971643","GGCCAGGCGTGGTGGCTCATGCCTGTAGTCCCAGCGCTATGGGAGGCCGAGGTGGGTGGATCACCTGTGCTCAGAGGTTCGAGACCAGCCAAGACCCCCCTGAGCCAAATGAGCCAGAGTGAGATCCCATCTCTAC","GGCCGGGCGTGGTGGCTCACGCCTGTAATCCCAACATTTTGGGAGGCCAAGGCGGGTGGATCACCTGAGGTCAGAAGTTCGAGACCAACCTGGCCAACATGGTGAAACCCCTGTCTCTAC"
"GL873588","1502535","1502718","chr1","34852429","34852590","60","33349894","GGTGCAGTGGCTCACACCTGTTGTCCCAGCGCTGTGGGAGGCCGAGGTGGGTGGATCACCTGTGCTCAGAGGTCGAGACCAGCTGAAGACCTGCCTGAGGCAGAGTGAGCCAGAGTGAGACCCCGTCTCTACTAGAACAACAACAAGACAGCCAGACCTTGTGATCCCAGCTACATGGGGGGCT","GCCAGGTGCAGTGGCTCACACCTGTAATCCCAGCACTTTGGGAGGCCGAGGCGGGCGGATCACCTGAGGTCAGGAGTTTGAGACCAGCTTGACCAACATGGAGAAACCCCGTCTCTACTAAAAATACAAAATTAGCCTGGTGTGGTGTCGCATGCCTGTAAT"
"GL873588","10189037","10189246","chr3","45604681","45604903","65","35415644","GCTGAGATGAGGAGACTCTGTCTCTATTAAAAATAGAAAAATTGGGTGGATGTTGTGGGTACTGTAGTTGCAGCCTCTTGGGGGGCTAAGGCAGGAGGATCAGTTGAAGCCAGGAATTTGCTTTGAGCTAGGCTAAAGCCATGGCACTCTAGCCTGGGCAACAGAGTGAGGCTAGATCTCAAAAAAAGAAAGAAAAGAAAAAGAAAAAAA","CTGGCCAACATGGCAAAACCCCATCTCTACTAAATATACAAAAATTAGCTGGACGTGGTGGCACATACCTGTAATCCCAGCTACTTGGAAGGCTGAGGCAGGAGAATAGCTTGAACCTGGGAGGCAGAGGTTGCAATGAGCTGAGATCACGCCACTGCACTCTAGCCTGGGCAATAGAATGAGACTCTGTCTCAAAAAAAAAAAAAAAAAAAAAGACAAGAAA"
"GL873589","104719","104807","chr20","27900350","27900437","13","27795631","GGCTGGGCGTGGTGGCTCATGCCTGTTGTCCCAGCGCTGTGGGAGGCTGAGGTGGGTGGATCACCTGTGCTCAGAGGTTCGAGACCAGC","GGCCGGGCGTGGTGGCTCATGTCTGTAATCCCAGCACTTTGGGAGGCCGAGGTGGGTGGATCACCTGAGGTCAGGAGTTCAAGACCAG"
"GL873589","796766","796905","chr1","166346372","166346487","49","165549606","GGCTAAGTGTGGTGGCTCACACCTGTCATCTAGTACTTTGGGAGGGTGGGCCTGGGAGTTCAAAGACTGAACTCAGGAGTTCAAGGTGGCTCCGGGGAGGAATTCAAGACCAACCTGAGCCAGAGCGAGACCTCGACTCT","GGCCAGTGGGGTGGCTCACGCCTGTAATCCCAGCACTTTGGGAGGCTGAGGTGGTCAAATGACCTGAGGTCAGGAGTTTGAGACCAACCTGGCCAACATGGTGACACCTCGTCTCT"
"GL873589","1023679","1023690","chr1","205890061","205890072","1","204866382","AAAAAAAAAAAA","ACAAAAAAAAAA"
"GL873589","1023771","1024047","chr4","103012712","103012993","70","101988941","GGCTTGGTGGCTCACACCTGTAATCCTAGCACTCTGGGAGGCCGAAGTGGCTGGAATACTTGAGGTCAGGAGTTCAAGACCAGCCTAAGTGAGAGTGAGATCCCCATCTCTAATAAAAATAGAAAAATTAGCAGGGTGTTGTGGCTGGCACTTGTAGTCCCAGCTACCCAGGAGACCGAGGCAGAAGTTTGAGATTATTGTGAGCGAGGCTGATGCCACAGCATTCTAGTGGGACAACAGAGCAAAATTCTATCTCAAAAGAAAAAAAAAAAAAGGA","CGGGCGTGATGGCTCACGCCTGTAATCCCAACACTTTGGGAAGCCGAGGCGGACGTATCACCTGAGGTCAGGAGTTCAAGACCAGCCTGGCCAACATGGTGAAACCCCGTCTCTACTAAAAATACAAAAATTAGCTGGGTGTGGTGGCATGCGCCTGTAATCCCAGCTACCCAGGAGGCTGAGGCAGGAGAATCGCTGAGGCTGCAGTGAACTGAAATTGTGCCACTGCACTCCAGCCTGGGTGACAGAGCAAGACTCTGTCTCAAAAAAAAAAAAAAAAAA"
"GL873589","4820958","4821024","chr8","33633747","33633811","15","28812789","TTAGTCAAGTGCAGTGGCTCACACCTGTCATCCCAGCTACTTGGGAGGCTGAGGCAGGAGAGTTGCT","TTAGCCAGGTGTGGTGGTGCATGCCTCTAATCCCAGCTACTCAGGAGGCTGAGGCAGGAGAATTG"
"GL873589","6763768","6763857","chrX","25814002","25814092","29","19050234","GGTGTGGTGGCTCACACTTGTATCTTAGCATTTTAGGAGGCTGAATGGGGAGAATTGCTTTAAGTCAGGAGTCTGACTTCCACCTTGCCA","GGCTGGGAATGGTGGCTCACACCTGTAATCCCAGCACTTTGGGAGGCTGAGGTGGGCAGATCACCTGAGGTCAGGAGTTTGAGATCAGCCT"
"GL873589","8444551","8444632","chr9","93194085","93194171","17","84749534","CGGGCATGGTGGCTCACAACTATAATCTTAGCACTTTGGGAGGCTGAGACAGGTGGATGCCTGAACTCAAGAGTTTGAAACC","GGCCGAGCATGGTGGCTCACACCTGTAATCCCAGCACTTTGGGAGGCTGAGGCAGGTGGATTACCTGAGGTCAAGAGTTCAAGACCA"
"GL873589","9085365","9085494","chr2","194063347","194063481","42","184977982","GGCCAGGCACAGTGGCTCACACCTATAATCCCAGCACTCTGTGAGACTGAGGCAGGTGAACTGTTGCAAGAGTGAGACCCTGTGCTTGGTGCCTGTAGCTCAGTGGTTAATAATAAGAAAAAAGAAAAAA","GGCCAGGTGCAGTGGCTCACACCTGTAATCCCAGCACTTTGGGAGTCTGAACCAGGCAGATCACCTGAGGTCAGGAGTTCGAGGCCAGCTCGGCCACCATGGTGAAACCCTGTTTCTAATAAGAATACAAAAAAA"
"GL873589","9085767","9086002","chr7","84631446","84631650","75","75545679","GAGTGAAACCCTGTCTCTACTAAAAATAGAAAAACTAGCTGTGCATCAGGGCGCATAACTGTAGTCCCAGGTACTCAGGACACTGAGGCAAGAGAATTGCTCAAGCCCAAGAGTTTGCAAGAATTTGAGGTTGCTATGAGCTATGATGCCATGGCACTCTACCTAGGGTGACAGACAGAGACTCTGTCCCAAAAAAAAAAAAAGAAGAAGAAGAAAAAAAAAAAGAAAGAAAGAAA","ATAGTGAAACCTCGTCTCTACTAAAAATACAAAAATTAGCTGGGCATCATGGTGCACGCTTGTAATTCCAGCTACTTGGGAGGCTGAGGCAGGAGAATTGCTTGAACTCAGGAGGTGGAGGTTGCAATGAGCCAAGATCGCGCCACTGCACACCAGCCTGGGTGACAAAAGACTCTGTCTCAAAAAAAAAAAAAAAAAAAAAAAA"
"GL873589","9992904","9993045","chr16","56427538","56427666","46","46434634","AACCAGCCAGGCATGGTGATTCACACCTATAATCCCAGCTACTTAGGAGTATGGCTTGAGCACACAGGATACCATACCATTCTAGTCATCCCAGGCAACAGAGGGAAACTCTGTTGGTTAAAAAAAAAGAAAAACTTAAAAA","TTAGCCAGGAGTGGTGGTGCACGCCTATAATCCCAGCTACTTGGGAGGCTGAGGCACAAGAATCACTTGAACCATTGCACTCCAGCCAGGGTGATAGAGGGAGACTCTATCCAAAAAAAAAACAAAAAA"
"GL873589","9993319","9993452","chr3","2774534","2774668","28","7218785","GGCCTGAGCCCTGTGACTCATGCCTGTAATCCCAGCACTGGAAGTTCCAAGGCAGGTGGATCGCTTGAGCTCTGGAGTTCAAGACCAGCTCAACCAAGAGTAAGACCCCATCTCTACTAAAAATAGAAAAACCA","GGCTGGGCACGGTGGCTCATGCCTGTAATCCCAGCACTTTGAGAGGCCGAGGCAGGTGGATCTCCTGAGGTCAGGAGTTCAAGACCAGCCTGGGCAACATGGTGAAACCCCATCTCTACTAAAAATACAAAAAAT"
"GL873590","9044589","9044884","chr1","83754525","83754835","84","74709936","GGCCAGGTGCAATGGCTCATGCCTATAATCCTCACACTCTGGGAGGCTGAGGCAGGAGGATCACTTTTCTCAGGGTCAGGGCCAGCCTGACAAAAGTCAGACCCTGTTTCTACTAAAAATAGAAAAACTAGCTGGGTGTTGTGGCAGATGCCTATAGTCCCAGCTACTAAGAGACTGAGACAAGTGCCCAGAGTCTGAGGTTACTGTGAGCAAAGCTGATGCCATAGCATTCTAGCTATAGATCGAGAGTCTGTCTCAAAAACAAACAAACAAACAAACAAACAAACAAAAAAGAA","GGCTGGGTGTGGTGGCTCATGCCTGTAATCCCAGCACTTTGGGAGGCCGAGGCGGGTGGATCATCTGAGGTCAGGAGTTCAAGACCAGCCTGACCAACATGGTGTAACCCTGTCTCAACTAAAAATACAAAAATTAGCTGGGCGTGGTGGTGTGCACCTATAGTCACAGCTACTTGGGAGGCTGAGACAGGAGAATTGCTTCAACCCAGGAAGTGGAGGTTGCAGTGAGCCAAGATCATGTCACTGCACTGCAGCCTGACAGAGCGAGACTCCATCTAAAACAAACAAACAAAAACAAACAAACAAACAAA"
"GL873591","1831505","1831587","chr17","61702818","61702899","25","59871313","CCCAGCACTTTGGGAGGGCAAGATGGGAGAATCATATAAAGTCAGGAGTTTGAGACCAGTTTGGCAGACATGATGAACCCATC","AATCCCAGCACTTTGGGAGGCTGAGGCAGGCGGATCATCTGAGGTCAGGAGTTCAAGACCAGCCTGGCCAACATGGTGAAAC"
"GL873591","2719175","2719275","chr4","86137755","86137847","32","83418580","GTGGGGGCTTAGGCCTGTAATCCCAGCACTCTGAGAGGCCAAGGTGAGCTGGTCACCTGGGTTTAGGAGTTTGGAGACTTGCTCGAGCTAGACTGAGGCTC","GTGGTGGCTCACGCCTGTAACCCTAACAATTTGGGAGGCCAAGGCAGGTGGATCACTTGAGGTCAGAAGTTTGAGACCAGCCTGGACAATATG"
"GL873591","4732974","4733120","chr19","7991801","7991954","55","3258827","ATACGCAGACTGGCCGAGCGTGGTGTCACATGCCTATAATCCCAGTGGCTACTCTGGGGAGGAGAATCTCTTGAAACCAAGAGTTAGAGATTGCAGTGGGGTATGATACAGGGTAACAAAGAGAGACCTTGGATCTGAAAAGAAAAA","AAAATACAGAAACTAGCTGGGCATGGTGATGCACACCTGTAATCCTAGCTACTGGGGAGGCTGAGGCAGGAGAATTGCTTGAACCCAGGAGTCAGAGGTTGCAGTGAGCAACCAGCCTGGGTGATACAGTGAGTGAGACTCTGTCTCGAAAAAA"
"GL873591","6822728","6823009","chr1","20579766","20580052","72","13757038","GGCCAGGCGTGGTGGCTCATGCCTGTAAATCTCAGCACTCTGGGAAGCTGAGGCAGGTGGATTGCTTGAGGTCAGGAGTTTGAGACCAGCCTGTACCAGAGTAAGACCCTGTCTCTAATAAAAATAGAAAAAAAAAAAAAAACTAGTTGGGCATGGTGATGGGTGCCTGTAGTCCCACCTACTTGGGAGGCTGAGGCAATGGCATCTCTTGAGCCCAAGAGTTTGAGGTTGCTGTGCCATGGCACTCTCCCCAGGGTAACAGAGTGAAAATAAAAAAAAGAA","GGCCAGGCGTGGTGACTCATGCCTGTAATCTCAGCACTTTGGGAGGCCGAGGCAGGTGAATCACCTGAGGTCAGGAGTTTGAGACCAGCCTGACCAACATGGTGAAACCTCGTCTCTACTAAAAATACAAAAAGTAGCCAGGCATGGTGGCGCATGCCTGTAATCCCAGCTACTTGGGAGGCTGAGGCAGGAGAATCGCTTGAACCCGAGAGGCAGAGGTTGCATTGAGTCAAGATGGTACCACTGCACTCCAGCCTGGGTGACAGATTGAGACTCAAAAAAAAAAA"
"GL873591","7578706","7578813","chr16","45055441","45055543","42","37476735","AAATTTAGCTACACATAGTGGCATGAGTCTGTAATGCTAGCCACCCAAAAGGCTGTAGTAAGAGGATTGCTCTATCCCAGGAGTTAAAGACCAGCCCGGACATCAGAG","AATTAGCCGGGCGTGGTGACACACACTTGTAATCCTAGATACTCAGGAGGCGAAGGTAGGAGAATTGCTTGAACCCAGGCAGCAGAGGTTGCAACGAGCAGAG"
"GL873591","9282916","9283004","chr1","20744253","20744338","16","11461337","GGCCAGGCGCGGTGGCTCACCCCTGTTGTCCCAGTTCTGTGGGAGGCCGAGGTGGGTGGATCACCTGTGCTCAGAGGTTTGAGACCAGC","GGCCAGGCACGGTGGCCACGCCTGTAATCCCAGCACTTTGGGAGGCCGAAGTGGGTGGATTACCTGAGGTCAAGAGTTTGAGACCA"
"GL873592","835155","835315","chr16","75654291","75654451","43","74819136","CTGGGTGTGGTGGCTCTTGTCTGCAATCTCAGTACACTGGGAGGCTGAGGCAGAAGGATTGCTCCAGCTCAGGAGTTTGAGGCCAGGCTGAGCTAGTGCAAAACCCCATCTCTACTAAAAAAAGAAGGAAAAAAAAAAGAAAAAGAAAAAAAATACGAGCT","CCAGGTGTGGTGACTCACGCCTGCAATCCCAGCACTCTGGGAGGCTGAGGTGGGTAGATTACCGGAGGTTAGGCGTTTGAGACCAGCCTGGCCAACATGGTGAAACCCCATCGCTACTAAAAAAAAAAAAAAAAAAAAAAAAAAAAAAAAAAAAAAAATTA"
"GL873592","835589","835765","chr1","66836166","66836336","48","66000577","ACAAAAAACCTAGCTTAGGGTTGTTATAGCACCTGTAGTCCCAGCTACTCAGGCGCTAAGGCAGGAAAATCTGCCTGAGCTCAGGAGTTTGAGGTTGCAGTAAGTTATGATGATGCTACTGCACTCTAGCTGGGGCAACAGAGTGAGACTCTGTCTGAGGAAAAACCAAAACCAAAA","TAGCCCAGCACGGTGGCTCACACCTGTAGTCTCAGCTACTCAAGAGGCTGAGGCATGAGAATCGCTTGAACCCAGGAGGTAGAGGTTGCAGTGAGCTGAGATCATGCCACTGCGCTCCAGCCTGGGCAACAGAGTGAGACTCAGTCTCAAAAAACAAAACAAAACAAAAAA"
"GL873592","2520661","2520705","chr16","66853217","66853257","11","64332556","TCTGGGAGGCTGAGGCGGGTGGATCACCTGAGCAAGAGTGAGACC","TTTGGGAGGCTGAGGCAGGTGGATCACTTGAGGTCAGGAGT"
"GL873592","4535248","4535388","chr1","12240468","12240612","38","7705220","GGCGGGATGTGGTGGTTCATGGCTGTAATCCCAGCACTCAGGGAGGCTGAGTCGGGTGGATTGCTTGAGTTCAGGAGTTTGAGACCAACCTGAGCAAGAACTAAGCCTGTCTCTACTAAAGATATTATTTCTTATTTTTCT","GGCCGGGCGCGGTGGCTCATGCCTGTAATCCCAGCACTTTGGGAGGCTGAGGCGGGTGGATCACCTGCGGTCAGGAGTTCGAGACCAGCCTGGCCAACGTGGTGAAACCTCATCTCTACTAAAAATATAAAAATTAGCTGGTGTG"
"GL873592","4535654","4535831","chr8","126054004","126054184","54","121518350","TCTACTACAAATATTAACAGAAAAATTAGCTGGGCATTGTGACAGGTGCCTATAGTCCCAGATACTCAGAAGGCTGAAGTAAGAGGATCACTTGAACCCCAGGAGCTAAGGTGGCTGTGAGCTAGGCTGAGGCTCTAGCCTGGGTAACAGAGTGAGACTGTAAAAAAAGAAAGAGAGA","GTCTCTACTAAAAATACAAAAATTAGCTGGGTGTGGTGGTGCATGCCTGTAATCCCAGCTACTCAGGAGGCTGAGGCAGGAGAATCGCTTGAACCCAGGAGGTAGAGGTTGCAGTGAGCCAAGATCATGCCACTGCACTCCAGCCTGGGTGACAGAGGGAGACTCTGTCTCAATAAATAAA"
"GL873592","6794968","6795049","chr3","154764711","154764794","20","147969743","GAAGGTTTGATGAGCTCAGATGATGCCACTGCAGTCTACCCAGAGTGAAGGAGCGAGACTCTGTCTCAAAAACAAAAAAAGA","CAGAGGTTGGCAGTGAGCTGAGACTGTGCCACTGCACTCCAGCCGGGTGACAGAGTGAGACTCTGTCTCAAATTACAAACAAAA"
"GL873592","6881384","6881478","chr5","24882384","24882475","28","18001000","GGGCAGGCATAGTGACTGGTGTCTCTAATCCTAGCAGTCTGGGATGCTGAGGCAAGTGGAATGTCAGAGTTCAGGAGTTGAAGATCACCCTGACT","GGCCGGGCGCAGTGGCTCACATCTATAATCCTAGCATTTTGGGAGGCTGAGGCAGGCGGATCACCTGAAGTCAGGAGTTTAAGACCAGCCTG"
"GL873592","6881755","6881937","chr10","61601371","61601572","66","54719616","TCACCCTGACCAAGAGCAAGACCCTGTCTCTACTAAAAATAGAATAAACTAGCTGGGAATTGTGGTGGGTGCCAGTAGTCCCCGCTACTGAGGCAGGAGGATCATTGAGTCCAAGAGTTTGAGGTTGCTGTAAGTTAGGACACCACAGCACTCTACACAGAGTAAGACTGCCTCAAAAATAAA","AGTAAAGAAAAGAAACCCTGTCTCTACTAAAAATACAAAAATTAGCTGGGTGTGGTGGTGCGCACCTGTAGTCCCAGCTACTTGGGAGGGTGAGGTATGGGAATCACTTGAACCCGGGAGGTGGAGGTTGCAGTGAGCCAAGATCACACCACTGCACTCCAGCCTGGGTGAGAGAGTGAGACTCTGTCTCAAGAAAAAAGAA"
"GL873592","7006080","7006155","chr1","8947061","8947129","24","1940981","CACACTGAGAGGCAAAGGCTGGTGGATCACCTGAGCTCAAGAGTTTGAGACCAGCCAAGCCAGAGATCTTGTCTCT","CACTTTGGAGCCAGGTAGGTGATCACCTGAGTCAGGAGTTCGAGACAGCCTGGCCAACATGTGAAACCC"
"GL873592","8446508","8446655","chr11","122502739","122502874","48","114056231","TTAGCTGGGTGTTGTGGCAGGCACCTGTAGTCCCTCCCAGCTACTTGAAAGGCTGAGGCAAGATGACAGCTTAAACCCAAGAGTTTAAGGTTACTCTATTCAGGGCAACAGAGTGAGACTCCATCTACATAAATAAATAAATAAATAA","GGCTGGGCGTGGTGGTTCACACCTGTAATCCCAACACTTTGGGAGGCTGAGGCCAGCGGATTGCCTGAGCCCAGGAGTTTGAGACCAACCTGGGCAACATGGTGAAACTCCATCTCTACTAAAATACAAAAAGTTA"
"GL873592","8446953","8447008","chr16","44513352","44513404","15","36066399","GACCAGCCTAAGCAAAAAAGAGATCCTATCTCTACTACTAAAAATAGAAAAAATTA","ACCAGCCTCACCAATATGAAGAAACCCCATCTCTACTAAAAATACAAAATATT"
"GL873592","8447239","8447325","chr1","8062863","8062957","21","384376","GGCCAGGAGCAGTGACTCATGCCTAGCACTCTGGGAGGCCAAAGCAGGTGGATCAACTGAGCTCAGGAGTTCAAGACCAGCCTAAGC","GGCCGGGTGCAGTGGCTCATGCCTGTAGTCCCAGGACTTTGGCAGGCCAAGGCCGGTGGATTACCTGAGGTCAGGAGTTCAAAACCAGCCTAGCC"
"GL873592","8723925","8724000","chr3","42066983","42067054","20","33343058","AATTAGCCGGGCATGGTAGTGTGTGCCCATAATCTCAGCTACTCAGAAAGCTAAGATAGGAAAATTGCTTGAGCTC","TTAGCTGGGTGTGGTAGTGCATGCCTATAATCCCAGCTACTCGGGAGGCTGAGGTGGGAGAACTGCTTGAAC"
"GL873593","384022","384146","chr15","102382935","102383070","28","101998913","GGCCACGAGGGCCCATGCCTGTAATCCTAGCACTCTGGGAGGCTGAGGTGAGTAGATTGCTGAGCTCAGGAGTTCAAGACCAGCCTGTGCAAGAGACCCCATCTCTGCTAAAAATAGAAAAACCA","GGCCAGGTGTGGTGGCTCACGCCTGTAATCCTAGCACTTTGGGAGGCTGAGGCGGGTGGATTGCCTGAACTCAGGAGGTCAAGACCAGCCTGGGCAACACAGTAAAACCCCATCTCTACTAAAATACAAAAAATCA"
"GL873593","384425","384607","chr20","28286874","28287058","50","27902449","GAAAGAAAAGAAAAGAAAAACTAGCAAGATGTTGTAGCTGATGCCTATAATCCTAGCTATTGGAGAGGTGGAGGCAAGAGAATTGCGTGAGCCCAAGAGTTGAAGGTTGCTGTGAGCTGCGATGCCAGAGCACTCCAGGGTGACAGAGTAAGACTCTGTCTCAAAAAAAATTACAAAATAAAA","TAATAAAAATAAAAAAATTAGCCAGGAGTCAAAGCACACGCCTATAACCCCAGCTACTTGGGAGGCTGAGGGAGGAGAATTACTTGAACCCGGGAGGTGAAAGTTGCAATGAGCTGAGATCAAGCCACTGCACTCCAGACTGGATGACAGAGTGAGACTCTGTTTCAAAAAAAAAAAAAAGACAA"
"GL873593","1408445","1408467","chr10","88070368","88070389","9","86661923","AATCTAGAGATGGGGAGAGGTTG","AAAGAGATGGAAGAGAAGAAGA"
"GL873593","4856365","4856484","chr7","56497314","56497433","31","51640949","GCAATCCCAGCTGATCGGGAGGCTGACCCAGAAGAATCCCTTGAACCCAAGAGTCTGAGGTTGCTATGGGTGGATTCTACAGCACTCTAGCCTGGGAGACAGAGTGAGACTCTGTCCCAA","ATCCCAGCTACTTGGGAGGCTGAGACAGAAGAATTGCTTGAACCCGGGAGGTGGAGGTTGCAGTGAGCCAAGATTGTACCACTGCACTCCAGCCTGGCAACAGAGTGAGACTCTGTCTCA"
"GL873593","6661298","6661485","chr10","86749316","86749514","55","80088018","GCAGAGGCTCACATATGTAATCCTAGCACTCTGGGAGGATAAGGCAGGTGGACAGCTTGAGCTCAGGGGTTTGACCAGTCTGATCAAGAGCAAGACCTGTGTCTACTAAAAATAGAAAACCTAGCCAGGTATGATGGTAGATGCCTGTATTCCTAGCTACTCTGGAAGCTAAAGCTAAAGAGTTTGAA","GGTGGCTCACACCTGTAATCTTAGCAATTTGGGAGGCCGAGGTGGGTGGATCACTTGAGGTCAGGAGTTTGAGACCAGACTGGCCAACATGGTGAAACTCTGTCTCTACTAAAAATACAAAAATTAGCCAGTCATGGTGGTGCATGCCTGTAATCCCAGCTACTCAGGAAGCTTAGGCAGGAGAATCACTTGAACCCAG"
"GL873593","6710263","6710446","chr14","4390080","4390244","66","2320183","TTGAAGTCAGGAGTTTAAGGCCAGTCTGGGCAACATAGTGAGACCCCCATCTCTACGAAAATATTTTTTAAAAATTAAAAATAGCTGGGCATAGTGAGGCTGTTGTGAGCTATAACTGCACCACTGCACTCAGCCAAGGACAGAGACCCTGTTCCCTGCCTCAAACAAACCAAAACAAAACAAA","AAGTCTAGAGTTTACAGCCTGGACAACGCAGTGAAACCCTGTCTCTACCAAAAATACAAAAATTAGACAGGTGTGAGAGGCGGAGGTTGCAATGAGCTGAGATCGCAGCACTGCAGTCCAGCCTGGATGACAGAGCGAGACCCCATCTCAAAAACAAAAACAAAA"
"GL873593","7159645","7159716","chr6","178318394","178318465","21","171158749","GATCATGTCACTGCTCTCCAACCTGGGCAATTGAGCAGGAATCTGTCTCAAAAAGAAAAAAAAAAAAGAAAA","CGAGTTCACACCACTGCACCCCAGCCTGGGCAACAGAATGAGACTCGGTTTCAAAAAAAAAAAAAAAAAAAA"
"GL873593","7159841","7160050","chr13","33368171","33368368","69","26208330","GGCCAGGCGTGGTGGCTCACACCTGTTGTCCCAGTGCTGTGGGAAGCCGAGGCAGGTGGATCACCTGAGCTCAGCCGAGTTCGAGACCAGTGGAAGACCAGCATGAGGCAGAGTGAGCCAGAGTGAGACCCCATCTCTACAACAACAACAAGAAGAAAAAAAACAGCCGGACCTTGTGATCCCAGCTACGTGGGGAGCTAGAGAATCACT","GGCTAGGCATGGTGGCTCATGCCAGTAATCCCACCACTTTGGGAGGCCGAGGCAGGTGGATCACCTGAGGTCAGGAGTTCAAGACCAGGCTGGCCAACATGTTATGATGAGACCCTCATCTCTACTACAAATACAAAAATCAGCTGGGCATGGTGGCAAGTGCCTGTAATCCCAGCTACTTGGGAGGCTGAGGCAGAA"
"GL873593","8598292","8598391","chr11","118461023","118461129","33","109862731","AGCCAGGTGAGGTGGTTCACACCTGTAACCCTAGCTGCTTGGGAGGCTGAGGCCTCTCTATCCTGGGCAGTGTGGAGAAACTTTGTTTCAAAAAAAAGAA","GCCGGGCGCGGTGGCTCACGTCTGTAATCCCAGCGCTTTGGGAAGCCGAGGCGGGACTATCCTGGCCAACATGGTGAAACCCCGTCTCTACTAAAAATACAAGAATC"
"GL873594","357249","357377","chr2","75702890","75703011","36","75345641","CCTGGTACCGTAGGTCATGCCTGTAATCCTAGCACTTTGGGATGCTGAGGTGGGCAGATTGCCTGAGCTCACGAGTTCAAGCCATTAGAACTGAGCCTGACCTAGAGTGGGACCTCCAACTCTTTTTTT","GCCAGGCACAGTGGCTCATGCCTGTAATCCCAGCAGTTTGGGAGGCTGAGGTGGGCAGATCACTTGAGGTCAGGAGTTCAAGACCAGCCTGGCTGACATGGTGAAACCCCATCTATACCAAA"
"GL873594","357656","357834","chr7","17608776","17608965","55","17251120","GGGACCTCCAACTCTTAAAATAGCTGGGCATTGTGGTGGGCACCTACAGTCACAGCTACTTGGGAGGCTAAGGCAAGAGACTTGTTTGCAGCCAAGAGTTAGAGGTTGCTGTGAGCTATGAGGCTAGGGCACTCTACAGGGGGCGACAAGTGAGACTGTAAAAAAAAAAAAAGAAAAAA","GTCCCTACTAAAAATACAAAAAATTAGCTGGGCCTGGTGGCAGGCACCTGTAATCCCAGCTACTTGGGAAGCTGAGGCAAGAGAATTGCTTGAACCCAGGAGGCAGAGGTTGCAGTGAGCTGACATCAAGCCACTGTACTCCAGCCTAGGCAACAAGAGCAAGACTCTGTCTCAAAAAAAAAAAAAAAAA"
"GL873594","1410711","1410996","chr5","151340503","151340797","76","149929792","CACAGTGGCTCATACCTATAATCCTAACACTCTGGGAGGCCAAGGTGGGTGGACTGTCTGAGTTTGGGACCAGCCTGAGCAAAAGCAAGACTCCCATCTCTACTAAAAACAAAGACAGCCAGGTATGAGGGCAGGTGCCTATCATCCCAGCTACTTGGGAGGCTGAGGAAGGAGGATCACCTAAGCCCAGGACTTTAAGGTTTCTGTGAACTAAGATGATGTTACAACACTCTAGCCAGGGTAACAAGGCAAGATTCTGTTTCAAAAGACAAAAAAAAAAAAAAAA","GGTGGTTCATGCCTGTAATCCCAGCACTTTGGGAGGCTGAGGCAGGTGGATCACCTGAGGTCAGGAGTTCGGGACCAGCCTGGCCAACATGGGGAAACCCCATCTCTACTAAAATACAAAAATTAGCCAGGTATGGTGGCACATGCCTATAATCCCAGCTACTTGGGAGGCTGAGGCAGGAGAATCACTTGAACCCAGGAGGCTAAGGTTGCAGTGAGCCGAGATTGTGCCACTGTACTCCAGCCTGGGTGACAGACTGAAACTCTGTGTCCAAAAAACAAAACAAAACAAAAAA"
"GL873594","5528090","5528162","chr2","69013639","69013718","24","63485549","GGTACAGTGGCTCACGCTTGTGATCCCAGGTTGAGGTGGGTGGATCGCCTGAGCTCAGGAGTTGGATGCCAGC","GGTGTGGTGCCTCACGCCTATAATCCCAGCACTTTGGGAGGCAGGTGGATCACTTGAGGTCAGGAGTTTGAGAACAGCCT"
"GL873594","5834047","5834168","chr2","82491537","82491662","28","76657490","GGCTGGGCCCAGTAGCTCACGACTGTAATCCCAGCACTCTGGGAAGCTGAGGTGGGCGGATCACCTGAGCTCATAGGTTCGAGACCAGCTCCAGTTAGAGTGAGAGCCTGTCTCTAAAAATA","GGCTGGGCACAGTGGCTCATGCCTGCAATCCCAGCACTTTGGGAGGCTGAGGTGGGCAGATCACCTGAAGTCAGGAGTTCAAGACCAGCCTGGCCAACACAGTGAAACCCCATCTCTACTAAAAAT"
"GL873594","5834396","5834461","chr13","14688151","14688212","20","8853755","TATATAATAATAATAACCAGGTATTGTGGCAGGTGCCTCTAGTCCCAGCTACTCGGGAGGCAAAGG","ATAAAAAAATTAGCTGGCCATGGTGGCACATACCAATAATCCCAGCTACTCAGGAGGCTGAG"
"GL873594","7786130","7786294","chr14","12217087","12217250","37","4430957","GGGTGTGCTGGCTCATACCTATAATCCTAGCACTCTGGGAGGCTGAGGTAGGTGTATTGCTTGAACCCAGGAGTCTGAGGTTGCTGTGCGCTAAGCTGATACCATAGCACTCTAGCCTGGGCAACAGAGTGAGACTCTGTCTCAAAACAAATAAATAGTAAAAAA","GCTGGGCGTGGTGGCTCACACCTGTAATCCCAGCACTTTGGGAGGCCAAGGCATGAGAATTGCTTGAAAACAGGAGGCGGAGGTTGCAGTAAGCTGAGACTGTGCCATTGCACTCCAGCCTGGGCAACAAGAGTGAAACTCTGTCTCAGAAAAAAAGAAAAAAA"
"GL873595","723579","723774","chr19","6045933","6046125","65","5322354","GCCTGAGCAGGAGAGAGACCCCATCTCTGCTGAAAGTGGAAAAGTTGGCTGAGTGTAGTGGCGGGCTGCTGCCCCAGTCACTCAGGAGGCTTAGGAAGGAGTATCGCTTGGGCCCAAGATTTGAGGTTGCTGTGAGCGCTACAAAGACATTAGGGTACTCTACACAGGGGAATAGAGTGAGACTGTCTCAAAAAAA","CAACATGGAGAAACCCCGTCTCTACTAAAAATACAAAATTAGGCAGCGTGGTGGTGGGTGCCTATAATCCCAGCTACTCAGGAGGCTGAGGCAGGAGAATCGCTTGACCGGGAGTGGAGGTTGCGGTGAGCTGAGATTGCACCATTGCACTCCAGCCTGGGCAACAAGAGTGAAACTCCGTCTCAAAAAGAAA"
"GL873595","724114","724204","chr20","18199749","18199840","22","17475635","GGCCATGCTTGGTGGTTCTCATCTGTAATCCTAGCACTCTGGAAGGTCTACAGGGGTGGATGGCTGGAGGTCAGGAGTTCAAGACTGGCCT","GGCCGGGCATGGTGGCTCACACCTGTAATCCCAGCACTTTGGGAGGCTGAGGCAGGCGGATCACCTGAGGTCAGGAGTTCGAGACCGGCCTG"
"GL873595","1065346","1065667","chr18","10529729","10530057","74","9464383","GGCCAGGTGCAGCAGCTCATGCCTGGAATCTTCCTGCTCTGTATGGCCAAGGCAGGTGGATCGCCTGACCTCAGGAGTTCCAGACCAGCCTGAACAAGAGCAAGACTCTGTCTCTACTAAAAGTAGAAAAAAAACTAGCCAGTCATAGTGGCAGGTGCCTGTAGTCCCAGCTGCTTGGGAGGCTGAGGCAAGAGGATCACTTGAACCTAAGAGTTTGAGGTTGCTGTGAGCTAAGATGCCACATCACTCTATCAAGGGTGACCAAGTGAGACTCTGTCTCAAAAATAAATAAATAAATAAATAAAAAGAAAGGCAAAAAGAA","GGCCCGGCGTGGTGGCTCATGCCTATAATCCCAGCCCTTTGGGAGGCCAAGGCAGGTGGATCACCTGAGGTCAGGCGTTCGAGACCAGCCTGACCAACGTGGTGAAACCTCATCTCTACTAAATACAAAAAAAATTTAGCCAGGCATGGAGGCACATGCCTGTAATCCCAGCTACTTGGGAGGCTGTGGCAGGAGAATCACTTGAACCTGGGAGGTGGAAGTTGCAGTGAGCTGAGATTGTACCACTGCACTCCAACCTGGGTGACAAAGCAAGACTCGGTCTCAATAAATAAATAAATAAATAAATAAATAAATAAAGTGAAAAAAAA"
"GL873595","1254878","1255146","chr4","42822326","42822607","67","41567448","GGCTGGGCATGGTGGCTCATGCCTGTAATCCTACCGCTCTGGGAGGCTGAGGCAGAGGATCACTTGAGCTCAGGAGTTTCAGACCAGCCTGCAAGAAGGACCCAGTCTCTGCCGAAAATAGAAAAGTTAGCAAGGCGTTGTCGTGAGCACATGTATCCCAGCTACCTAGAACTCTGAGGCAGGAGGATCCCTTGAACCCACAGAAGTTGCTGTTATCTAAACTGATGCCACTGGACTCTAGCCTGGGCAACAGAGTGAGACTGGTCTCA","GGCCGGGCACGGTGGCTCATGCCTGTAATCCTAGCATTTTGGGAGGCTGAGACAGGCAGATTGCCTGAGCTCAGGAGTTCAAGACCAGCCTGGGCTAGATTGTGAAACCCCATCTCTACTAAAATATAAAAATTAGCTGGGTGTGGTGGCACACGCCTGTAATCCCAGCTACCTGGGAGGCTGAGGCAGGAGAATCGCTTGAACCAGGAGACAGAGGTTGCAGTGAGCTGAGATCACGCCACTGCACTTTAGCCTGGGCAACAGAGTGATACTCTGTCTCAA"
"GL873595","3417105","3417297","chr12","115674238","115674427","44","112257133","GGCCGGGCGCTGTGCCTCACGCCTGTAATCCTAATACTCTGAGAGGCCGAGGCAGGTGGATTGCCTGAGCTCAGGTGCTCAAGACAGCCTGACTGAGCAAGCCCTGAGATCCCATCTCCACTAACAATAGTAAAACTAGCCGGGCATTGTGGTGGTGCTTGTAATCCCAGCTACTGGGAGGCTAAGACAGGAG","CCAGGCCTGGTGGCTCACGCCTGTAATCCCAGCACTTTGGGAGGCCGAGGTGGGTAGATCACCTGAGGTCAGGAGTTCAAGACCAGCCTGGCCAACATGGCGAAACCCCATCTCTACTAAAAATACAAAAATTAGCTGGGCATGGTGGTGTATGCCTGTAATCCCAGCTACTCGGGAGGCTGAGGCAGGA"
"GL873595","6098380","6098457","chr3","87492619","87492702","21","81394239","GCTGTGGCTCATGCTGATAATACCAGCACTCTGGGAGAACAAGGTAGGCAGATCACAAGAGGTCACCTGTGCAAGACC","GGGCTGGTGGTGGCTCATGCCTGTAATACCAGCACTTTGGGAGGCCAAGACAGGTGGATCACCAAAGGTCAAGAGTTCAAGACC"
"GL873596","134190","134307","chr1","203207333","203207443","31","203073143","GGCTGGGCGAGGTGGCTCACACCTGTAATCCTAGCACTCTGGAAGGCCCTAGCACTCAGGCAGTTGGATTGCCTGAGCTCACAAGTTCAAGACCAGCCTGAAAAAGAGCAAGACCTCA","GGCTGGGTGCAGTGGCTCACACCTGTAATCCCAGCACTTTGGGAGGCCGAGATGGGTGGATCACTTGAGGTCAAGAGTTGAAGACCAGCCTGGACAACATGATGAGACCCC"
"GL873596","134578","134681","chr11","50235285","50235387","37","50100707","CAAACAAAAGAGGAAGACCTCGTCTCTAAAAAAATAGCTGGGCATTGTGAGGAGTACCTGTAGTCCTAGCTACTCAGAAGGCTGAGACAAGAGAATCACTTAAA","CAACATTGTGAAACCCTGTCTCTACTAAAATAGAAAATTAGCCAGGTGTGTGGGCGTGCCTATAATCCTAGCTACTGGGGAGGGTGAGGCATGAGAATCGCCT"
"GL873596","8160215","8160350","chr1","29437872","29437991","30","21277657","GGCCGGGCGTGGTGGCGCACACCTGTAGTCCCAGCGCTATGGGAGGCCGAGGCGGGTGGATCACCTGAGCTCAGAGGTTCGAGACCAGCCAAGACCCCCCTGAGCCAAACGAGCCAGAGTGAGACCCCGTCTCTAC","GGCCGGGCGTGGTGGCTCACGCCTGTAATCCCAACATTTTGGGAGGCCAAGGCGGGTGGATCACCTGAGGTCAGAAGTTCGAGACCAACCTGGCCAACATGGTGAAACCCCTGTCTCTAC"
"GL873596","8421071","8421132","chr20","1874027","1874093","12","6547044","GTCAGGCGCAGTGGCTCACGCCTGTAATCTCAGCACTCTGAGAAGCCAAGGCAGGATCATCT","GGCCAGGCGCAGTGGCTCAGGCCTGTAATCCCAGCACTTTGGGAAGCCAAGGTGAGCAGATCACCTG"
"GL873598","4416400","4416489","chr5","39418145","39418231","15","35001745","GGCCAAGTGTGGTGGCTCATGCCTGTTGTCCCAGCACCGTGGGAGGCCGAGGCTGGTGGAACACCTGAGCTCAGCTGAGTTTGAGACCAG","GGCCAGTTGCGGTGGCTCATGCCTGTAATCCCAGCACTTTGGCAGGCTGAGGCAGGTGGATCACCTGAGGTCAGGAGTTTGAGACCA"
"GL873598","4416855","4416947","chr3","94091253","94091337","31","89674398","GTGAGACCCTGTCTCTACAAAAAAAAAAGCTGGGCACTGTGGCATGTGCCTGTAATCCCAGCTACTTGGGAGGCAAAGGGAAAGAGAATCACT","AAACCTTGCCTTTACTAGAAATACAAAAATTAGCTGGGCATGGTGGCAGGTACCTGTAATCCCAGCTACTTGGGAGGCTGAGGCA"
"GL873598","5126074","5126161","chr1","12339306","12339394","19","7213232","GCCTGGTGCACTGGTTCACACCTGGAATCCTTGCATTCTGAGAGGCCCAGGTAGGCAGATCACCTCAGCTCAGAAGTTCGAGACCAGC","GCTGGGTGCGGTGGTTCACGTCTGTAATCCCAGCACTTTGGGAGGCCGAGGCGGGCAGATCACCTGAGGTCAGGAGTTCGAGACCAGCC"
"GL873598","5467584","5467662","chr1","9313328","9313403","17","3845744","GCGAGGTGGCTCACGCCTGTAATCCCAGCACATTTGGAAGGCCAAGGAGGGTGGATCACCCGAGCTCACCAGTTGGAGA","CGCAGTGGCTCACGCCTGTAATCCCAGCACTTTGGGAGGCCGAGGCAGGCAGATCACCTGAAGTCAGGAGTTTGAG"
"GL873598","6917752","6917856","chr14","9558287","9558382","22","2640535","GGCCAGGCATGGTGGCTTGTGCCTGTTGTCCCAGCACTGTGGAAGGCCGAGGCGGGTGGATCGCCTGAGCTCAGCTGAATTCGAGACCAGCATAAGACCAGTATG","GGCCAGGCATGGTGGCTTATGCCTGTAATCCCAGCACCTTGGAAGGCCGAAGCGGGCAGATCACCTGAGCTCAGGAGTTTGAGACCAGCCTGTCCA"
"GL873598","8078910","8079062","chr7","164825511","164825660","43","156746601","AACAGCCAGGCATTGTGGTGGGCACCTGTAATCCCAGCTACTTGGGAGGCTGAGGCAAGAGAATTGCTTGAGCCCAACAGTCTCAGGTTACTGTGAGTTATGACACCATGGCACTCTATTGAGGGCAAGAAAGTGAGACTGTCTTGGAAAAAA","CTAGCCAGGCATGGTGGTGCGCACCTGTAGTCCCAGTTACTTGGGAGGTTGAGGCAAGAGAATTGCTTGAGCCTGGAAGGCAGAAGTTGCAGTGAGCTGAGATCACACCACTGCATTCCAGCCTGGGCGAAAGAGCAAGACTCTGTTGAA"
"GL873598","8079328","8079454","chr6","10381248","10381379","32","2301920","GCCCGGCGTGGTGGCTCACGCCTGTAATTCCAGCACTCTGGGGAGGCCGAGGAGGGCAGATTGCCTGAGCTCACAGGTTTGAGCTAGAGCGAGACCCTGTCTCTTAAAAAGAAAAAAAAGGAAAGAA","GCTGGGCGCGGTGGCTCACGCCTGTAATCCCAACACTTTGGGAGGCCGAGGCGGGCAGATCACCAGAGGTGATCTCCAGCCTGGGCAGGAGAGCAAGACCCTGTCTCAAAAAATTTAGAAAAAGGAAAGAAA"
"GL873599","3943256","3943456","chr9","35892110","35892312","79","31948854","GGCAGGCTGCTTTGACCCATATCTACAACTCCAGAACTTTAGAGGCTGAGCTGGGTGGGTCCCTTGAGATTAGAAACTGCTTAGTAGCCTGGCAAAAACCAGACCCCACCTCCACCATGTAGAAAAATTAGCAGTATGCCATAGTGGGAACCTACCAATACAGTCTTTCCAAAGGCCAAAGCTAGAAGGACCGTGAGCTTG","GGCTGGGTGTGGTGGCTCATGCCTATAATTCCAGCACTTTGGGAGGCCGAGGCAGGTGGATCACCTGAGGCCAGGAGTTTGAGACCAGCCTGGCCAATATGGTGAAACCCCATCTCTACTAAAAGTACAGAAAATTAGTCAGTCATGATGGCGCATGCCTATAATCCCAGTTACTCGGGAGGCTAAGGTAGGAGAATTGCTTG"
"GL873599","6693284","6693349","chr1","100916857","100916922","15","94223573","TCACGTCTATAATCCTAGCACTCTGGGAGTCCTTGGCAGGTGGATCACCTGAGCTCAGGAGTTTGA","CATGCCTGTAATCCCAGCACCTTGGGAGGCCAAGGTGGGTGGATCACCTGAGGTCAGTAGTTTGAG"
"GL873600","991618","991705","chr15","13850109","13850195","15","12858491","GGCTGGGCGTGGTGGCTCACACCTGTTGTCCCAGCGCTGTGGGAGGCTGAGGCAGGTGGATCACCTGTGCTCAGAGGTTGAGACCAGC","GCCGGGCGCTGTGGCTCACACTTGTAATCCCAGCACTTTGGGAGGCTGAGGCAGGTGGATCACCTGAGGTCAGGAGTTAGAGACCAG"
"GL873600","8825981","8826014","chr16","43605817","43605844","11","34779836","AGTCTGGGGCAACAGAGCAAGACTCTGTCTCAAA","CAGTCTGGGTGACAGAGCAAGATTCCAT"
"GL873600","8826039","8826157","chr13","87428402","87428520","35","78602363","ATTAGCCTGGTGTGGTGGTATATGCCTTCCTGCCTGCTTGGGAGGCTGAGGCAGGAAGTATGCTTTAACTGTGGAGTCTGAGGTTGCTATGAGCTAGGTTGAGGCCATGGCACTCTAAA","TTAGCCGGGTGTGGTGGTGCACGCCTGTAATCCCAGCTACTCAGGAGGCTGAAGCAGGAGAGTTGCTTGAACCCAGGAGTTGGAGGTTGCAGTGAGCTGAGATCACGCCATTGCACTCC"
"GL873601","269289","269338","chr14","49279240","49279285","14","49009951","GACTGGGTGTGGTGGCTCACACCTTTAATCCTAACACCCTGGGAGGCTTA","GGCTGAGATGGTGGCACACACCTGTAATCCCAGCTACTTGGGAGGC"
"GL873601","269431","269678","chr1","184453273","184453521","76","184183842","AGAAGATCACTCAAGATCAGGAGTTTGAGAACAGCCTGAGCAAGACCCCCATCTTTACTAAAAATGGAAAAGTTTTTACCCAGGCATGGTAGTGCGTGCCTGTATCCCATCTACTCCGGAGGCTGATAGGAGGATTGCTTCAACCAAGGAGTTTGAGGTTCCAGAGACTTAAGATGACACAACTGCATTTTACCCAGTGTGACACAGCGAGACTCTTTCAGAAGAATTTTTAAAAGGAAAAAAAAGAA","GGTCAGATCACCTGAGGTCAGGAGTTTGAGACCAGCCTGACCAACATGGTAAAACCCCATCTCTGCTAAAAATACAAAAAATTAGCCAGGCATGGTGGTGAACGCCTGTAATCCTAGCTACTCAGGAGGCAAAGACAGGAGAATCGCTTGAATCTGGAAGGTGGAGGTTGCAATGAGCCAAGATGACGCCACTGCACTCCAACCTGGGTGACAGAGGAAGACTCCATCAAAAAAAAAAAAAAAAAAAAA"
"GL873601","1397978","1398117","chr16","24839455","24839591","34","23441477","GCCTATAATCCTAGCACTCTGGAAGGCTGAGGCAGGAAGATCACTAGAGCTTGGGAGTTTGAGATTGCTGTGAGGGAGACTGACTCCATGGCACTCTAGCCTGAGGCAACAGAGTAAGACTCCATCTCAAAAAAAAAAAA","CTCTAACTCCAGCTACTCAGGAGGCTGAAGCAGGAAAATCACTTGAACCTGGGAGGTGGAGGTTACAGTGAGCCAAGATCACACCATTGCACTCCAGCCTGAGCGACAGAGCGAGACTCTGTCTCAAAATAAATAAA"
"GL873601","4065502","4065590","chr11","108711352","108711444","19","104645850","GCTGGATGTGGTGGCTCTCACCTATAATCCTAGCACTCTGGGAGGTCAAAACAGGTGGATCACCTGAGCTCAGGAGCAAGAACACCAGC","GTCAGGGGTGGTGGCTCACGCCTGTAATCCCAGCACTTTGGGAGGCCAAGGCAGGTGGATCGCCTGAGCTCAGGAGTTCAAGACCAGCCTTGC"
"GL873601","8241370","8241465","chrY","9469734","9469829","34","1228364","AAAAAAGGTGGAGATGAGCCATGCGCAGTGGTGTAGGCCTGTAATCCCAGCCCTTGGGAGGCCAAAATGGTGGATTGCCTGAAGCAGAGCAAGACC","AAAGTACAAAGAGTCTGGGTACAGTGGCCCAAGCCTGTAATCCCAGCAGTTTGGGAGGACAAGATGGGTAGATCACCTGACATCATGAATTAGAGA"
"GL873569","7519122","7519191","chrX","79016364","79016431","16","71497242","TTGGCCAGGCATGGTCGCTCAGGCTGTAATACCAGCTACTTGGGAAGCTGAAGCAGGAGGATCACTTGAA","TTGGCCAGGCACGGTGGCTCATGCTTATAATCCCAGCTACTCGTGAGGCTGAGGCAGGGGAATCGCTT"
"GL873569","7989158","7989286","chr8","41505677","41505810","35","33516519","AGTCCCACCTATTTGGAAGGCTGAGGCAAGAGGATCACTTGAACTCAGCAGTTTGACATTGCTATGAGTTAGATTGACTCCATGGCACTCTAGCCCAGGCAACAGAGCAAGACTCCGTCTCAAAACAAA","TAATACCAGCTACGTGGGAGGCTGAGGCAGGAGAATCACTTGAACCCGGGAGGTGGAGGTTGCAGTGAGCTGAGATTGCACCGTTGCACTCTAACCTGGGCAACAAAAGCAAAACTCTGTCTCAAAAAAAAAAA"
"GL873569","7989575","7989702","chr1","62231025","62231129","47","54241450","GGCTGGGTAATGCAGTGGCTCACGCCTATAATCCTAGTGCTTTGAGAGGCCAAGAGTGAGACTCTGTGTACTAAAAATAGAAAAATTACCTAGGCATTCTGGTGGGCACCAGTAGTCCCACCTATTTG","GGCTGGGCATGGTGGCTCACGCCTATAATCCCAGCACTTTGGGAGGCCGAGGCAGGTGGATCACCTGAGATCAGGAGTTTGAGACCAGACTGGCCAACATGGTGA"
"GL873569","10034363","10034556","chr10","61268396","61268605","62","51234033","CAGCTTGAGCAAAAGTGAGCCCCTGTCTCTACTGAAAATAGAAAAAATTAGCCAGGCGTGGTGGCACACACTTATAGTCCCAGCCACTTAGGAGGCTGAGGCAGGAGTTTGAGGTTGACATAATCTAAGCTGATACCATAGCACTCTAGCCTGGGCAATAGAGTGAGACTCTGTCTCAAAGAAGAAATTTATCT","CCTGACCAATGGTGAAACCCTGTCTCTACCAAAAATACAAAATTTAGCTGGGCATGGGGGCACGCACCTGTAGTCCTAGCTACTCGGGAGGCTGAGACAGGAGAACTGCTTGAACTCGGGAGGCAGAGGTTGCAGTGAGCTGAGATCATGCCACTGCACTCTAGCCTGGGCAATAGAGTGAGACTCCGTCTCAAAAAAAAAAAAAAAAAA"
"GL873569","10034830","10034845","chr1","217667782","217667796","2","207632952","AAAAAAGAAGAAAAAA","AAGAAAAAGAAAAAA"
"GL873569","10203815","10203922","chr8","96374555","96374671","35","86170740","GCCAGGTGTAGTGGTTCACACCTATAATCCTAGCACTCTGGGAGCCTGAAGCAGGTAAATGGACTGAGCAAGAGTGAGACTTCCACCTCTATTGAAAATAGAAAAATT","GGCTAGGTATGGTGGCTGATGCCTATAATCCCAGAATTTTGGGAGGCCGAGGCAGGCAGATCATCTGAGGTCAGGAGTTTGAGACCAGTCCCGTCTCTACTAAAAATACAAAAATTA"
"GL873569","10204196","10204373","chr20","1304385","1304559","47","8899811","GAAAATAGAAAAATTAGCCAGGCATTATAGCAGGCACCAGTAATCCCAGTTACTTGGGAGGCTAAGGCAAAAGAATCTCTTGAGCCCAAGTTTGGGGTTGCTAGGAAGTAAAACACCACAGCACTATACCCAGAACAAGAGAGTGAAGACTCAGTCTCAAAAAGATAAATAAATAAAA","AAAAATACAAAAATTAGCCAGGCATGGTGGCGGGCGTCTGTAACTCCAGCTACTTGGGAGACTGAGGCAGGAGAATCGCTTGAACCCAGGAGGCAGAGGTTACAGGTGAAATCACACCACTGCACTCCAGCCTGGGCAACAGGGCAAGACTCTGTCTCAAAAAAAAAAAAAAAAA"
"GL873569","10473375","10473444","chr8","20660648","20660717","21","10187273","TGTAGTCCCAGCACTTTGGGAGGTTAAGGCAAGAGTAGCACCCAACATGAGGAGATCAAGACCAATCTGG","CTGTAGTCCCAGCACTTTGGGAGGCTGAGGCAGGTGGATCCTTTGAGGGCAGAACTTTAAGACCAGCCTG"
"GL873570","9287350","9287485","chr1","29437872","29437991","30","20150522","GGCCGGGCGTGGTGGCGCACGCCTGTAGTCCCAGCGCTATGGGAGGCCGAGGCGGGTGGATCACCTGTGCTCAGAGGTTCGAGACCAGCCAAGACCCCCCTGAGCCAAACGAGCCAGAGTGAGACCCCGTCTCTAC","GGCCGGGCGTGGTGGCTCACGCCTGTAATCCCAACATTTTGGGAGGCCAAGGCGGGTGGATCACCTGAGGTCAGAAGTTCGAGACCAACCTGGCCAACATGGTGAAACCCCTGTCTCTAC"
"GL873571","3669989","3670207","chr4","116777080","116777297","60","113107091","AGACCAGCCTGAGGAAGAGCAAGATCCCATCTCTATTAAAAATAGAAAAATTAGCCAGGCATTCTGGTGGGCACCTGTAGTTCTAACCACCTGGGAGGCTAAGGCAAGAGGAACTCTTCAACCCAAGAGTTTGAGGTTGCTGAGAGCTAGGCTAAGGCTGCAGCACTCTAGCCTGGGCAACAGAGTGAGACTGTTTCTCAAAAACAAAAAACAAAAAAA","CGAGACCAGCCTGGTCAATATGGTGAAACCCCGTCCCTACTAAAAATACAAAAATTAGCCAGGCATGGTGGCAGGCACCTGTAGTCCCAGCTACTCGGAAGGCTGAGGCAGGAGAATCGCTTGAACCACAGAGGCAGAGGTTGCAGTGAGCCGAGACTGCACCACTGCACTCCAGCCTGGGCGACAGAGTGAGACTCAGTCTCAAAAAAAAAAAAAAA"
"GL873571","106134","106236","chr4","18143723","18143826","27","18037589","GGCCAGTCTCAGTGGCTCACACCTGTAATCCAGCATTCTGGGAGGCTGAAGCACACGGTCACCTGAGCTCAAAGGTTGGAGACCAGAGTGAGACCCCACCTCT","GGCCAGGCGCAGTGGCTCACTCCTGTAATCCCAGCACTTTGAGGCTGAGGCAGGCGGATCACCTGAGGTCAGGAGTTTGAGACCAGCCTGGCCGAAACCCCATC"
"GL873571","3670496","3670589","chr7","50468399","50468491","15","46797903","GGGCAGGCATGGTGGCTCACACCTGTAATTCTAGCACTCTTGGAGGCTGAGGCAGGAAAATGGCTTGAGGTCAGGAGTTCAAGACCAGCCTGAG","GGCCAGTCATGGTTGCTCACACCTGTAATACCAGCACTTTGGGAGGCCGAGGCAGGCGAATCACCTGAAGTCAGGAGTTCAAGACCAGCCTGG"
"GL873571","4059090","4059389","chr7","52903696","52903994","88","48844606","GGCCAGGTGCAGTGGTTCACACTTATAATCCTAGCACTCTGGGAGGCCGAGGCGAGTGAAGTGCCTGAGCTCATGGGTTCAAGACCAACCTAAGCCAGAGACCCCTGACTCTTATAATAGCCTGGCATTGTGGTGGGCGCCAATATTTCCAGCTACTCTGAGGCTAAGGCAAGAGAATTGCTTGAGCCCAGGAGTTGGAGGTTTCTGTGAGCACTGACGCCGCAGCTCTCTACCAAGGGCAACAAAGACTCTGTCTCAAAAAATAAATAAATAAATAAATAACAGAATGAAAATGAAAAA","GGCCGGGTGCGGTGGTTCACGCCTGTAATCCCACCACTTTGGGAGGCTGAGGCAGGCAGGTCACCTGAGGTCAGGAGTTCCAGACCAGCCTGGCCAACATGGTGAAACCTTGTCTCGGCTATTAGCCTGGCATGGTGGTGCGTGCCCATAATCCCAGCTACTCAGGAGGCTGAGGCAGGAGAATCGCTTGAACCCAGAAGGTGGAGGTTGCAGTGAGCCAAGATAGCACCACTGCAACTCCAGTCTGGGCAACAGAATGAGACTCTGTCTCAAAAAAAAAAAACAAAAAACAAAAAGAA"
"GL873571","4209418","4209704","chr11","32517699","32517985","80","28308281","GGCTTGGCAAGGTGGCTTACACCTCAAATCCTAGCACTGTGGGAGACTGAGGCAGGTGGATTGTTTGAGCTCAGGAGGTCAAGATAGAGAGCAAGAGCAAGTCTCTGTCTCTACTAAAAATAGAAAAGAACTACTTCCCGGGGGTCATGGCAGTAGCCTGTAATCCCAGTTACTAGGTAGAATGAGGCAAGAGGATCTGTTGAAGCCAAGAGACTGAGGTTGTTATGAGCATGCCACAGCACTCTACCCAGGGTGACAGAATGAGACTCTGTTGAAAGAAAAAAAGA","GGCCGGGTGCAGTGGCTCACACCTGTAATCCCAGCACTTTGGGAGGCTGAGGCGGGTGGATCACCTGAGGTCAGGAGTTCAAGACCAGCCTGACAAACATAGTGAAACCCTGTCTCTACTGAAAATACAAAATTAGCCAGGTGTGGTGGCGCATGCCTGTAATCCCAGCTACTCGGGAGGCTGAGGCAGGAGAATTGCTTGAATCCAGGAGGTGGAGGTTGTGTGATCACACCACTGCACTCCAGCCTGGGCGACAGAGTGAGACTCTGTCTCAAAAAAAAAAGAAA"
"GL873571","4209985","4210154","chr3","175781758","175781928","60","171571773","GAAAGAAATGAAAAGAAAGAAGTTAGCTGGTTGTTGGGGTATGCTTCTATAGTCCCACCTACTCAGAAAGCTGAAATCTGGAGTTTGGGGTTGTTGTAAGGTAGGCTGATGACATAGCACTGTAGCTTGGGCAAGAGAGTGTGACTTTGTCTCAAAAAAAATTAAAACAA","ATTAAAAACACAAAGATTAGCCAGGTGTGATGGCACACAACTGTAATCCCAACTACTCAGGAGAATCGCTTGAACCTGGGAGATAGGGTTTGCAGTGAGCCAAGATTGTGCCACTGCACTCCAGCCTGGGTGACAGAGTGAGACTCTGTCTCCAAAAAAAAAAAAAAAAAA"
"GL873571","4210444","4210570","chr17","16655655","16655789","35","12445211","GCCAGGCAGATGGCTCACACTTCATCCTAGCCCTCTGGAAGGCTGAGGCAGGCTAATTTTTTGAGGTTAGGAGTTTGAGACCAGCCTGAGGAAGAGACCCATCTCTACTTTAAAAAATAAATGGAAA","GCCAGGCATGGTGGCTCACACCTGTAATCCTAGCACTTTGGGAGACTGAGGCGGGTGAATCACCTGAGGTCAGGAGTTTGAGACCAGCCTGACCAGTATGGTGAAACCCAGTCTCTACTAAAAATACAGAAATTA"
"GL873571","4391733","4391878","chr11","33723808","33723943","46","29332075","AACTTAGCTGGGAATGGTGGCTCAAGCCTGTAATCCTAGCACTCTGGGAGGCTCAGGTGGGAGGATCACTTGAGGTTGCTGTGAGCTTGGCTGATGCCAGGACACTCTAGTGTGGGCAAGAGAGTGAGACTCCGCCTCAACAACAA","GCCGGGTGCAGTGGCTCATACCTGTAATCCCAGCACTTTGGGAGGCTGAGGTAGGCGGATCACGAGGTCAGGAGCTGAGATGGCGCCACTGCACCCCAGCCTGGGTGACAGAGCAAGACTCTGTCTCAAAAAAAAA"
"GL873571","6307773","6307841","chr9","62429628","62429694","22","56121855","CTGGGTGTGGTGGCATTGCACCTGTAATCCTAGCTACTTGGAAATCTTAAGCCCAGGAGTTGAAGACTG","CCCAGCATGGTGGTGCATACCTATAATCTCAGCTACTTGGAGGCTTGAGCTCAGAAGTTTGAGACCG"
"GL873571","6496217","6496306","chr1","27257765","27257856","27","20761548","GCAGGGTGTGTTGACCCACACCCACAATTCCAGGACTCTGGGGGGCCAGGGATGGTGGGTTCCCTCAGATCAGGAGCTCCTTACCAGCCT","GACTGGGCATGATGGCTCAAATCTGTAATTCCAGCACTTTGGGAGGCCGAGGTGGGTGGATTGCCTGAGATCAGGAGTTCAAGACCAGCCTG"
"GL873571","6499738","6499903","chr1","38976375","38976555","47","32476637","AAAATAACATGAATTGACTAGGCGAGGTGGCTCACATCTCTAATCCTAGCACTCTGGGAGGCTGAGGCAGGAGAATTGCATGAGGTTGCTGTGAGCTATGATGATACCACGGCATTCTAATCAGGGTGACAGAGTGAGATTCTGTCTTAAAACAAACAAACAAAAA","AAAATAAATAAATTAGCAGGGCCTGGTGGCGCACACCTGTAATCCCAGCTACTTGGGAAGCTGAGGCAGGAGAACCCACTTGAACCTGGGAGCCGGAGGTTGCAGTGAGCTGAGATGGCACCACTGCACTCCAGACTGCGTGACAGAGTGAGACTCCGTCTCAAAAACAAACAAACAAAAA"
"GL873571","11399575","11399872","chr15","109458692","109458994","79","98059117","CAGTGGCTCACACCTGTAAATCTAACACTCTGGGAGGCCAAGGTGGGTGGATCCCTTGAGCTCAGGAATTTGATACCAGCCTGAGCAAGAGTGAGACCTTGTCTCTACTAATAATAGAAAAATAGCCCGTGTTGTGGCACTTGTCCCAACCACTGGGGAGGCTTTAGGCGGGAGGATTACTTGAATTGGGAGTTTGATATTGCTGTGAGCTGGGCTGATGCCTTGGCATTCTAGCTTGGGTAACAGCGTAAGACTCCGTCTCAAATAAATAAATAAATAAATAAAAAGAAAAAAAGAA","GTGGCTCACACCTGTAATCTCAGCACTTTGGGAGACCGAGGCAGGTGGATCACCTGAGGTCGGGAGTTTGAGACCAGCCTGACCAACGTGGAGAAACCCCGTCTCTACTAACAATACAAAATCAGCTGGGCGTGGTGGTGCATGCTTGTAATCCCAGCTACTCGGGAGGCTGAGGTAGGAGAATCGCTTGAACCTGGGAGGTGGAGGTTGCGGTGAGCCGAGATCGAGCCACTGCACTCCAGCCTGGGTGACAGAGCAAGACTCCATCTCAAAAAAAAAAAAAAAAAAAAAAAAAAAAAAAAA"
"GL873572","114760","114841","chr8","26280134","26280211","16","26165374","GGCCAGGCATGGCGGCTCTTCCCTGTAATCCTAGCACTCTGGGAGGGCGAGGCAGGCAGATCACCTAGGCTAGGGTGAGATC","GGCCAGGAATGGTGGCTCATGCCTGTAATCCCAGCACTTTGGGAGGCTGAGGCAGGCAGATCACCTGAGGTCAGGAGT"
"GL873572","9421791","9421892","chr11","8089184","8089269","35","1332607","TACTAAATATATAGCAAGGCCAGGCACAGTGGTTCATGGCTGTAATCCCAGTACTCTGGGAGGCCTAGTCAGAGTTGACCTGAGATCAGGCTAGAAGCCTGG","ATAAAAATAATTGGAGGCCAGGCACGGTGGCTCATGCTTGTAATTCTAGCAATTTGGGAGGCTGACGCGGGTGAGATCATACTGAG"
"GL873572","11052834","11053035","chr14","11857478","11857657","65","804644","TCCACAAAGAAAGCAGAAGTGTGGCCGGGTGGTAGCTCAAGGCAGGAATCCCAGCACTCTGGGAGCTGGGAGGTGGGGGAGGATCCCTTGAGATCAGGAGTTGGAGGGCACAGTGAGCCTGGGGGAGGCCACTGTCTCTGTACTCTAGCAGGGAGACAGAGCAAGACTGCCCATTCAAAGAAAAACAACAAACAAAACAAAA","TACAAAAATTAGCTGGGCACGGTGCCACAAGCCTGTAATCCCAGCTACTCGGGAGGCTGGGCAGGGGAATAGCTTGAACCCAGAGGTGGAGGTTGCAGTGAGCCAAGATCAAGCCACAGCACTCCAGCCTGGGTGACAGAGCAAGACTCCATCTCAAAAAAAAAAAAAAAAAAAAAAAAA"
"GL873573","2564195","2564244","chr1","109985445","109985491","12","107421250","TACAAAAATTAGGCTGGGCTTGGTGGTTCACGCCTATAATCCTAGCACTT","ACTAAAATTAGCTGGGCATGGTGGTGCATGCCTGTAATTCCAGCTAC"
"GL873573","7423371","7423533","chr2","202783328","202783513","56","195359957","GGTGGCTCACACCTGTAATCCCAGCACTCTGGGAGCCCTGGTGGCTCATGTCTATAATCCTAGTACTCTGGGAGACCATGGTGGCTCATGTCTATAATCCTAGTACTCTGGGAGCCATGGTGGCTCACGCCTATAATCCTAGTACTCTGGGAGACCATGGTGG","GGCTGAGGCGCGGGGGCTCACGCCTGTAATCCCAGCACTGTGGGAGGCCGAGGCGGGTGGATCACGCCTGTAATCCCAGCACTGTGGGAGGCCAAGGCGGGTGGATCACGCCTGTAATCCCAGCACTGTGGGAGGCCGAGGCGGGTGGATCACGCCTGTAATCCCAGCACTGTGGGAGGCTGAGGC"
"GL873573","9657648","9657710","chr19","10207852","10207913","10","550204","TAAAAATAAAAAATTTAGCTGGATGTGGTGGCTCACACCTGTAATCCTAGCACTCTGGGAGAC","TAAAAATACAAAATTAGCTGGGTGTGGTGGCACACACCTGTAATCCCAGCTACTCAAGAGGC"
"GL873574","1624662","1624783","chr9","814961","815079","36","809701","GACTGGGTGGGTTGGATCATGCCTGGAATCCTAGCACCCTGGGAGGCCAAGGTGAAAGGATTGCTTGAGGTTAGGAGTTCCAGAAATGTAGCAGTCATGGTGACTTCATCCTTCTCTACCAA","GGCTGGGTGCTTTGATTCATGCCTGTAATCCCAGCACTCTGGGAGGCCGAGGCAGGTGGATCACCTGAGGTTAGGAGTTCGAGACCAGCTTGGCTAACATGGTGAAACCTCGTCTCTAC"
"GL873574","4459477","4459612","chr1","29437872","29437991","29","24978395","GGCCGGGCGTGGTGGCGCACGCCTGTAGTCCCAGCGCTATGGGAGGCCGAGGCGGGTGGATCACCTGAGCTCAGAGGTTCGAGACCAGCCAAGACCCCCCTGAGCCAAACGAGCCAGAGTGAGACCCCGTCTCTAC","GGCCGGGCGTGGTGGCTCACGCCTGTAATCCCAACATTTTGGGAGGCCAAGGCGGGTGGATCACCTGAGGTCAGAAGTTCGAGACCAACCTGGCCAACATGGTGAAACCCCTGTCTCTAC"
"GL873574","4681987","4682216","chr6","153082888","153083127","73","148400901","GGGTGCGGTGGCTCAGACCTATAATCCCAGCACTCTGAGAGGCCGAAGTGGGTGGATCACCTGAGCTCAGGAATTTGAGACCAGCCGTCTCTAAAAATAGCTGAGTGTTGTGGCAGTGGCTGTAAGTCCCAGCTGTTTGGAAAGCTGAAGCAAGGGAATCACTTGAACCCAAGAGTTTGAGGTTGCTGTGATGACAAAGTGAGACTCTATCTCAAAAAAAAAAAAAAAAA","GGCCGTGCGCGGCGGCTCACGCCTGTAATCCCAGCACTTTGGGAGGCTGAGGTGGGTGGATCACCTGAGGTCAGGAGTTTGAGACCAGCCCGACCAGAAATTAGATGGGTGTGGTGGTGCGCTCCTGCAGCCCCAGCTACTTAAGAGGCTGAGGCAGGGTAATCACTTGAACCCGGGAGGCGGAGGTTGCAGTGAGCCGAGCTCACGCCACTGCACTCCAGCCTGGGTAACAGAGCGAGA"
"GL873574","4709916","4710039","chr19","13152422","13152536","46","8442506","AAAAATAGAAAAACTAGCCAAGCATGGTGGTGCACCCCCTATAGTCTGAGCTCCTCAGCGGGCTGAAGCAAAAGGACGGCTGGAGCCCTGGAGTTTGAGGTTGCTGTGAGGCAAGGTGATGCCA","ACACATAAATTAGCCAGACATGATGGTGAGTATCTGTAATTCCAGCTCCTTGGGGGGCTGAGGCGGGAGAATTGCTTGAACCTGGGAGGCAGAGATTGCAGTGAGCCAAGATCGC"
"GL873574","6353839","6353913","chr5","25768079","25768163","22","19414240","AAAAATATAGCAAGGCCAGGCATGGTGGCTCACACCTATAATCCCAGTACTTGGGAGCTGGAATTTGAACCTAGG","AAAAAACTCAAACAAGGCTGGGCGTGGTGGCTCACACCTGTAATCCCAGCACTTTGGGAGGCTGAGGTGGGTGGATCACCTGAGG"
"GL873574","6533061","6533332","chr5","85182161","85182439","81","78649100","GGCTGGGCGAGGTGGCTTACACCTATAATCCTAGTACTCTGGGAGGCCAAGGTGGGTGGATTGCCTGAGCGCACAGTTTCAAGACCAGCTGGAGCCAGAGAGAGAGAGAGAGACCCTGCCTCTAAAAATAGCCAGGCATTGTGGCAGGCACCTGTAGTCCCAGCTACTTGGCAGGCGGAGGTATGAGAATCGCTAGAGGTTGCTGTTAGCTATGATGCCATAGCACTCTACCAAGGGCGACAAAGTGAAACTCTGCCTCAAAAAAAAGAAGA","GCCAGGCGTGGTGACTCAAGCCTGTAATCCTAGCACTTTGGGAGGCCAAGGTGGGCGGATTGCCTGAGCTCAAGAGTTTGAGACCAGCCTGGGCAACACGGTGAAACCCAATCCCTACTAAATACAAAAAAAATTAGCCGGGTGTGGTGGTGTGAACCTGTAGTCCCAGCTACTCGGGAGGCTGAGGCAGGAGAAGGCAGAAGTTGCAGTGAGCCGAGATCACACCACTGCACTCCAGCCTGAGTGACAGAGCAAAACTCTTTCTCAAAAAAAAAAAAA"
"GL873574","6643746","6643907","chr2","92627944","92628105","46","85984198","AAATAGCCAGGCGTTGTGGCAGGCACCTATAGTCCCAGCTACTTGGGAGGCTGAGGCAAGAGAATCACTTAAGCCCAAGTGACAGAGGTTGCCAGGGCACTCTACGTAGGCAACAGAGTGAGACTCTATCTAAGAAAGAAGGAAGGAAGGAAGGAGAAAGAA","TTAGCCGAGCATTGTGGTGCGCGCCTGTAGTCCCAGCTACATGGGAGGCTGAGGCAGGAGAACACCTGAACCCAGGATGTGAGCTGAGTCGCGCCATTGCACTCCAGCCTGGGCAACAGAGTGAGACTCCATCTCAAAAATAAAATAAAATAAAATAAAAAA"
"GL873574","6644163","6644274","chr1","128607504","128607619","20","121963341","CTGTAATCCTAGCACTTGGGAGGCTGAGGCAGGTGGATCACCTGAGTTCAGGAGTTCAAGACCAGCCTAAACAAGAGTGAGACCCTATCTCTACTAAAAATAGAAAAAATAT","GCCTGTAATCCAAGCACTTTGGGAGGCTGAGGCGGGTGGATCACCTGAGGTCAGGTGTTCGAGACCAGCCTGGCCAACGTGGTGAAACCCCAACTCTACTAAAAATACAAAAATTA"
"GL873574","8511822","8512127","chr1","23439759","23440073","84","14927937","GGTGGCTGGTGCCTGTAATCCTAGCACTCTGGGAGACTGAGGCAGGTGGATCACTTGAAATCAGGAGTTTGAGATCAACCTGAGCAAGAGATCTTGTCTCTCCTAAAGATAGAAAAACTAGCTGGGATTTGTGGTGGACACCTGTAATTTCAGCTACTCAGGAAGCTAAGGCAAGAGCATTGCTTAAAACCAGGAGTTTGAAGTTGATGTGAGCTAGGATGTCAGGGCAGGTTACCCAGGGTGACAGAGTGAGACTCTGTGTCAAAATAAACAAACAAACAAACAAACAAAACAAAATAAAATAAA","GGCTGGACATGGTGACTCACGCTTGTAATCCCAACACTTTGGGAGGCTGAAGCAGGCAGATCACCTGAGGTCAGGAGTTTGAGACCAGCCTGACCAACATGGTGAAACCTTGTCTCTACTAAAAATACAAAAATTAGCTGGGAGCAGTGGTGCACACCTGTAATCCCAGCTACTCGGCAAGCTGAGGCAAGATAATTTTTTAAACCTGGGAGGTGGAGGTTGCAGTGAGCCAAGATCGTGCCACTGTACTCCAACCTGGGAGACAGAGCAAGACTCTGTCTCAAAAAAAAAAAAAAAAAAAAAAAAAAAAAAAAA"
"GL873575","2107336","2107519","chr4","38052972","38053149","54","35945636","TCAATTAAAAACTTTTTAAAATGAGGCTGAGCATGGTGGTTCACACCTGTAATCCCAGCACTTTGGGAGGCCGAGGCAGGAGGATCACCTGATCCCAGGAGTCCAAGCCTACAGTGAGCCGTGATAATACCACTGCACTTCAGCCCAAAGCCTCAAAAAGAAAAAAAAAAAAGGATAGACAAGA","TATATATATATATATTATTTTGGGGGGGCATGGTGGTGCACACCTGTAATCCCAGCTACTCGGGAGGCTGAGGCAGGAGAATTGCTTGAGCCCGGGAGGCAAAGGTTGCATTGAGCTGAGATCACACCACTGCACTCCAGCCTGGCGACAGAGTCTCAAAAAAAAGAAAAAATAAAAA"
"GL873575","5831824","5831959","chr1","29437872","29437991","28","23606048","GGCCGGGCGTGGTGGCGCACGCCTGTAGTCCCAGCGCTATGGGAGGCCAAGGCGGGTGGATCACCTGAGCTCAGAGGTTCGAGACCAGCCAAGACCCCCCTGAGCCAAACGAGCCAGAGTGAGACCCCGTCTCTAC","GGCCGGGCGTGGTGGCTCACGCCTGTAATCCCAACATTTTGGGAGGCCAAGGCGGGTGGATCACCTGAGGTCAGAAGTTCGAGACCAACCTGGCCAACATGGTGAAACCCCTGTCTCTAC"
"GL873575","7451097","7451208","chr3","122814630","122814743","22","115363533","GGCCAGGTGTGGTGGCTCACACCTGTTATCCTAGCACTCTGAGAGGCCACAGCAGCTGGATCACTTGAGCTCAGGAGTTCAAGACCAGTCTGAGCAAGAGCAAGACCTCACC","GGCTGGGTGTGGTGGCTCATGCCTGTAATCCCAGCACTTTGAAAGGCCAAGGCAGATGGATCACTTGAGGTCAGGAGTTCCAGACCAGCCTGGCCAACATGGCAAAACCCCATC"
"GL873575","7451277","7451445","chr6","58863249","58863409","41","51411972","AAAAATTCAGCCAGCCACAGTGGAAGTGGATGCCTGCCATCACAGCTACTCTGGGGGCTGGGGCAAGAGAATTGCTTGATCCCAGGAGTCTGAGGTTGCTGTGACCTAGGCTGACACCACAGCACTCTACCCAGGGTGACAGAGTGAGGCTGTGTTTAAAAAAAAAAAA","TTAGCCAGGCATGGTGGCACATGCCAGTAATCCCAGCTACTCAGGAGGATGAGGCAGGAGAATCGCTTGAACCCAGGAGGCAGAGGTTGCAGTGAGCTGAGATTGCGCCACAGCACTCTACCCTGGGTGACAGAAGGAGACTCTGTCTCAAAAAAAAAAAA"
"GL873576","1765109","1765185","chrX","53921180","53921256","12","52156071","GGCCAGGTGCAGTGGCTCATATCTGTAATCCTAGCACCCTGGGAGGCCAAGGTAGGCGAATCACCTGAGGCCAGGAG","GGCCAGGTGCAGTGGCTCACGCCTGTAATCCCAGCACTTTGGGAGGCCGAGGTGGGCGGATCACTTTAGGTCAGGAG"
"GL873576","2711577","2711895","chr7","6620384","6620702","85","3908807","GGTCGAGCTTGGTGGCTCATGCTTGTAATCCTAGCACTCTGGGAGGCCAAGGCAGGTAAGTTGCCCTGAGCTCATAGGTTCCAGATCAGCATGAGCCAGAGTGAGACCCTGTCTCTACCAAAAAATAGCCCGGCATTCTGGCAGGTGCCTGTAATCCCAGCTGCTTGGGAGGCTGAGGCTAGAGAATCACTTAAACCCAAGGGTTAGTGGAGGTTGCTGTGAGCTATGATTCCACCGTACTCTACTGAGGGCCACAAAGTGAGACTCTGTCTCCATAAAAAAGAAAGAAAGAAAGAAAGAAAAATAAAATAAAATAAAA","GGCCAGGCACAGTGGCTCATGTCTGTAATCCCAGCACTTTGGGAGGCCGAGGCGGGTGGATTACCTGAGGTCAGGAGTTCTAGACCAGCCTGGCCAACAAGGCGAAACCCTGTCTCTACTAAAAATACAAAAAATTAGCTGGGCGTTTTGGCACATGCCTGTAATCCCAGCTACTTGGGAGGCTGAGGCAGGAGAATTGCTTGAACTGGGGAAGTGGAGGTTGCAGTGAGCTGAGATCACACCATTGCACGCCTGAGCAACAGAGCGAGACTCTGTCTCAAAAAAAAAAAAAAAAAAAAAAAAGAAAAGAAAAAGAAAA"
"GL873576","4782520","4782652","chr9","61136941","61137074","22","56354421","CCAGGCACGGTGGCTCACCCTTGTAACCCTAGTACTTTGGGAGGCTGAGGTGGGAGGATCCCTTGAGGTCAGGAGTTCAAGACCAGCCTGAACAACAGTGAGACCCCCGTCTCTACTAAAAAATAGAAAAGTT","GCCAGGCACGGTGGCTCACGCCTGTAATCCCAGCACTTTGGGAGGCTGAAGCGGGCGGATCACCTGAGGTCAGGAGTTCAAGACCAGCCTGGGCACCATGATGAAACCCCGTCTCTATTAAAAATACAAAAATT"
"GL873576","4782930","4783078","chr7","57521645","57521803","40","52738715","AGTTAGTCTGGTGTCATGGTGGGTGCCTGTAGTCCCAGCTGCTTGGGAGGCTGAGGCAAGAGAATCACTTGAGCCCAGGAGTTGGAGGTTGCTATGAGCGAGGCTGTAGCCTAGGCAACAGAATGAGACTTTGCCTCAAAAAAATAAAA","TTAGCTGGGCATGGTGGCGCATGCCTGTAGTCCCAGCTACTTGGGAAGCTGAGGCAGGAGAATCACTTGAACCTGGGAGGTGGAGGTTGCAGTGAGCTGAGATCGCACCGCTACACGCCAGCCTGAGCAACAGAGAGAGACTCTGTCTCAAAAGAAAAA"
"GL873576","7828709","7828723","chr5","101042981","101042996","1","93214272","TAAATAAATAAAAAA","TAAATAAATAAATAAA"
"GL873576","7828960","7829230","chr13","49045537","49045844","89","41216577","GCCGGCTGCAGTGGCTATAATCCAAGTACCCTGGGAGGCTTAGGTGGATGGATCACTTGAGCTCAGAAGTTCAAGACCAGCCTCAGCAAGAGGTAGACCTTGCCTCTATTAAANNNNNNNNNNNNNNNNNNNNNNNNNNNNNNNNNNNNNNNNNNNNNNNNNNNNNNNNNNNNNNNNNNNNNNNNNNNNAGTTTGAGGTTGCTGTGAGCTATGATGAAGCCAGGGCATTCTACCCAGGGTGACAGAGTAACTCTTAAAAAAAACTAAACAA","GGCCAGGCAGAGTGGCTCATGCCTGTAATTCCAGCAATTTGGGAGGCCTAGGCAGGCAGATTACCTGAGGTCAGGAGTTTGAGACCAGCCTGGCCAACATGGTGAAACCCCGTCTCTTCTANNNNNNNNNNNNNNNNNNNNNNNNNNNNNNNNNNNNNNNNNNNNNNNNNNNNNNNNNNNNNNNNNNNNNNNNNNNNNNGGAGATAATAGCTTTTGTAGAACGAAGCGATGCAACAGCCAGATCGCCGCCACCACCCTTAGGTCCTGGCGACAGAGTGAGATCCATCTTAAAAAAAAAAAAAAAAAAA"
"GL873576","10622840","10623093","chr7","60266447","60266705","74","49643607","GCTGGGTATGGTGGTTCACACCTATAATCCTAGCACTCTGGGAGGCTGAGGTGGGAGGATTGGTGGAGCTCAGGAGCTCATGAGGTGCCAAATCACTGGTGCCACACACCTGTATTCCCAGCTACTGAGGAGGCTGAGGCAGGAGGATCAGGTAAGCCCAGGAAGTTTGAGGTTGTAGTGAGTTAGGATGATTGAACTCTGCCTTGAGAGACAGAGCAAGATCCTCCTTCCTCCTAAGCAAACAAACAAATAAA","GGCTGGGTGCAGTGGCTCACACCTGTAATCCTAGCACTTTGGGAGGCTGAGGCGGGAAAATTGCCTGAGCTCAGGAGTTCAAGGACAGCCTAGGCAACATAGCATGGTGGTGCACGCCTGTATTCCCTGCTACTTGGGAGGCTGAGGCACAAGAATTGCTTGAATCCGGGAAGTGGAGGTTGCAGTGAGCCATTGTGGCACTGCTCTCCAGTCTGGGTGACAGAGCAAGACTCCATCTCAAAAAAAAAAAAAAAAAAAA"
"GL873576","10819939","10820007","chrX","67133632","67133707","21","56313693","AGGTTGCAGTGAAATTGTACCATTCCAATGAAGCCTGGGGGACAGAGTGAGATTCTCTCAAAATAAAAA","GGAGGTTGCAGTGAACCGAGATCGTGCCACTGCACTCCAGCCTGAGCGACAGAGTGAAACTTCGTCTCAAAAAAAA"
"GL873576","10920306","10920363","chr3","48261745","48261808","16","37341439","GCTGGACCTTGTAGAGAGTGCCTGTAATCCCAGCTACATGGGGGGCAAGAGAATTGCT","GCTGGGCATGGTGGTGCATGCCTGTGATCCCAGCTACTCAGGAGGCTGAGGCAGGAGAATTGCT"
"GL873576","10920398","10920529","chr10","67341428","67341546","30","56421030","GGCCAGGCGTGGTGGCTCACGCCTGTTGTCCCAGCACTGTGGGAGGCCGAGGTGGGTGGATTGCCTGAGCTCAGAGGAGTCCGGAAGACCAGCATGAGGCAGAGTGAGCCAGAGTAAGATCCTGTCTCTACC","GGCTGGGTGTAGTGGCTCATGCCTGTAATCCCAGCACTTTAGGAGGCCAAGGTGGATGGATTGCCTGAGCTCAGGAGTTCGAGACCACCCTGGGCAACAAGCCAAAACCCTGTCTCTAC"
"GL873577","515809","515961","chr7","137660778","137660931","43","137144969","AGCTGGGCATGGTGGCTCATGCCTATAACCCTAGCGTGCTAGGAGATTGCTTGTCAGGAGACTGAGGTTGCAGGAAACTGTGATGATGGCACTGCACTCTACCCAGGGTGACAGAGCAGGACTCTGCCTCAAAAAAAAAAAAAAAAATAGAAA","TTAGCTGGGCATGGTGGCGCATGCCTATAATCCCAGCTACTTGGGAGGCTGAGGCAAGAGAATCGCTTGAACCGGGGAGGCAGAGGTTGCAGACTGCACTCCAGCCTGTGTGACAGAGTGGGACTCCGTCTCAAAAAAAAAAAAAAAAAAAAAA"
"GL873577","1633164","1633256","chrX","38269524","38269615","26","36636360","TCAGCCAGGCATGGTGGCACTTGCCTATAAACCCAGCTCCTTGGGAAGCTGAGCCGGGAGGATCCCTTGCACCCAGGAGCAACGGAAGGCAGT","AATTAGCCAGGCATGGTGGCACATGCCTATAATCCCAGCTACTCAGAAGGTTGAGGCAGGAGAATCACTTGAACCTGGGAGGCAGAGGTTGC"
"GL873577","3979502","3979560","chr20","68909283","68909346","13","64929781","GAGTTTGAGACCAGCCTGAGCAAGACCGAGACCCAGTCTCTACTAAAAATAGAAAAATT","GGAGTTCAAGACCAGCCTGACCAACATGGAGAAACCCTGTCTCTACTAAAAAATACAAAAATTA"
"GL873577","3979839","3980009","chr10","31403126","31403287","39","27423287","ATGAGCAGATTGTCTTGGTGGGCACCTGTAGTCCCAGCTATTGGAGGTGGGAGGCTGAAGCAGGAAAATCTCTTGAGCCCAGGAGTTTGAGGTTGCTGTGAGCTAGGCTGACACCACGGCACTCTAGTCAGGGCGTCAGAGTGAGACTCCGTCTCAAAAAAAAAAAAAAAA","TTAGCTGAGTGTGGTGGCGCACATCTGTACTCCCAGCTATTTGGGAGGCTGAGGCAGGAAAATCGCTTGAACCCAGGAGGTGGAGGTTGCAGTGAGCCAAGATCACACTACTGCACTCCAGCCTGGGTGACAGAGTGAGAATCCATCTCAAAAAAAAGAAAA"
"GL873577","6050882","6051080","chr1","153219820","153220007","59","147168938","GGCTGGGCGTTGTGACTCATGCCTGTAATCCCAGCACTCTAGGAGGCCGAGGTGGGTGGACTGCCTGAACTCAGAGGTTTAAGACCATCCTGAGCCGCAGTGAGCCAGAGCGAGACCCTGTCTCTACCAAAAAAAGCTGGGTGTTGTGGTGGGCGCCTATAGTCCTAGCTACTTGAGGCGCTAAGGGTAAAAAAATTGC","GGCCTGGCACAATGGCTCACGCCTGTAATCCTAGCACTTTGGGAGGCCGGGGTGGGTGGATCACCTGAGATCAGGAGTTTGAGACCAGCCTGGCCAACATGGTGAAACTCCTTCTCTACAAAAATTAGCCAGGTGTGGTGGTGGGTACCTGCAATCCCAGCTATTTGGGAGGCTGAGGCAGGAGAATC"
"GL873577","8463965","8464050","chr9","52134422","52134508","19","43670457","CTGGGTGCTATAGCTCACGCCTATAATCCTAGCACTCTGGGAGTTTGGGGCAAATGGATCACCTAGGCTCAGGAGTTTGATACCAG","GGCTGGGAGCAGTGACTCACGCCTATAATCCCAGCACTTTGGGAGGCTGAGGCAGATGGATCACCTGAAGTCAGGAGTTCGAGACCA"
"GL873577","9471486","9471613","chr16","5178790","5178910","46","4292696","TTAGCCAGGCATAGTAGCCTGTGTGTAGTCCTAGCTACTCAGGAGGCTGAGGTAGATGGGTCACTTGAGGTTGCAGAGATTATGGTAATGTCACTGTACTCTAGCCCTGGCAACAGAGCACAACCCTG","TTAGCCGAGCCTGGTGGCATAAACCTGTAATCCCAGCTACTCAGGAGGCTGAGGCAGGGGAATTGCTTGAACCTGAGAGGAGAAGGTTGCAGTGAGCCGAGATTGCACCATTGCACCCCAG"
"GL873577","9471875","9471998","chr7","17832200","17832315","36","8360325","GGCCAGGTGAAGCAGCTCATGGCTATAATCCTAGCAGTTTGGCAGGCCAAGGTGGGAGGACTGCTTGAGGTCAAGAGTTCAAGACCAACCCATCTTTGCGAAAAATTTAAAAATTACCTAGGCA","GCCAGGAGAGGTGGCTCATGCCTCTAATCCCAGCACTCTGGAAATCCAAGGTGGGTGGATCACCTGAGGTCAGGAATTCCAGACCAGTCTGGCCAATATAAAAAATTAGCCAGGCT"
"GL873577","9853150","9853170","chr3","85044647","85044667","3","75191497","AAACAAACAAACAAAAAAAGA","CAAACAAACAAACAAACAAAA"
"GL873577","9853206","9853473","chr7","130818682","130818963","67","120965476","GCTGGGCGCAGCGTCTCACTCCTGTAATCCCAGCACTTGGGAGGCCAAGGTGAGTGGATTGCCTGAGTTTACAGTTTCGAGACCAGCCTGAGCCAAAGCGAGACCCCCATCTCTAAAAAATAGCTGGGCATTGTGGTGGGCACCTGTAGTCCCAGCTACTTGGGAGGCTGAGGCAAGAGGATCGCTTGAACCTAAGAGTTTGAGGTTGCTGTGAGCTAAGGCTCCATGGCATTCTACCAAGGGTGACTAAGTGAGACTCTGTCTAAAA","GCCGGGCACAGTGGCTCACACCTGTAATCCCAGTACTTTGGGAGGCCAAGGTGGGTGGATCACCTGAGGTCAGGAGTTTGAGACCAGCCTGGCCAACATAGTGAAACTCTACTAAAAATACAAAAAAATAGCTAGGCATGGTGGTGCGCACCTGTAATCCCAGCTACTTGGGAGGCTGAGGCAGGAGAGTTGCTTGAACCCAGCGGGGTTGAGGTTGCAGTGAGTTAAGATCAAGCCACTGTGCTCCAGCCTGGATGACAGAGAGAGACTCCATCTCAAAAA"
"GL873577","10722415","10722478","chr10","12501471","12501539","23","1779056","AATAAAAAAATGCTGGGTACAGTAGTACATGCCTGTACTCTCATCTGGGGAAGCTGAGGCATGA","AAAGTAAAAAATTAGAGCTGGGCATGGTGGCACACACCTGTAATCCCAGTCACTAGGGATGCTGAGGCA"
"GL873578","463331","463568","chr10","28935382","28935620","93","28472051","CAGGTGCTTTGACCCACACCCTCAACTCTAGGACTTTGGACGCCCTGGCTGGGTGGGTCCTTTAAAGTCAGGAGCTTCTTATCAGTCTGGGCAAAAGTGAGACCCCATCTCTACCAAACAAAGAAAGAAATCAGCAGTATGTTGCAGTAGAGACTCACCAATACCTTCTTTCAAAGACCAAAGCTGGAAGGACACTAAAGACCATGATCTCATGGCCTCCCTGAGCCATGACAATGCC","CCAGGTGCAGTGGCTCATGCCTGCAAGCTCAGAACTTTGGGAGGCAGAGGTGAGCAGACTGCCTGAGTTCAGGAGTTCAAGACCAGCTGGGCAACATGGTGAGACCCTATCTCTACTAAAAATACAAATAATTAGCAGGGTGTGGTAGCACACACCTGTAGTCCAGCTACTCAGGAGGCTGAGGCAGGAGAATTGCTTGAACCCAGGAGGCAGAGTTTGCAGTGAGCCAGGACTGGGCC"
"GL873578","1143712","1143827","chr11","52824583","52824692","30","51680871","GGCTGGGTGTGGTGCCTCATGCCTGTAATCTAAGCCCTCTCCGAGGCTGAGGTGGGAGGATCCCTTGAGTTTAGGAGTTTGATTTTGAGACCAGCCTGATCAAGAGAGAGACCTCA","GGCCGGGTGTGGTGGCTCATGTCTGTAATCCCAGCACTTTGGGAGGCTGAGGTGGGTGGATACCCTGAGGTCGGGAGCTCGAGACCAGCCTGACCAACATGGAGAAACCC"
"GL873578","1144101","1144139","chr3","33494224","33494257","11","32350123","GAGAGAGACCTCATGTCTACTAAAATAAATAAATATATA","GTGAAACCCGTCTCTACTAAAAATACAAAAATTA"
"GL873578","1144175","1144343","chr12","119519961","119520131","41","118375786","ATTATCCAGGCCTTCTGGTGGATGCCTGTAGTCCTAGCTACTAGAAAAGCTGGAGCAGAATCACTTGACCCAGGAGCTGGAGGTTGCAGGGAGCTAGGCTGATGCCACAGAATTCTAGCCTGAGGCAAAAGAATTGAGCCACTGTCTCAAAAAGGAACAAAAAAGAAAA","ATTAGCCAGGTGTGGTGGCATGCACTTGTAATCCCAGCTACTAAGAAGGCTGAGGCAGGAGGATCACTTGAACCCGGGAGGTGGAGGTTGCAGTGAGCCAAGATCATGCCACTGCACTCCAGCCTGGGCAACAGAGTAAGACTCTGTCTCAAAAAAAAAAAAAAAAAAAAA"
"GL873578","4593962","4594035","chr16","68825055","68825124","22","64231093","AGCTGGGTACAGTGGCTCACATATAATCCCAGTGACTCAGGAGGCTAAGACAGGAGGATTACTAGGACCTGAGA","GGCTGGGCACAGTGGCTCAGACCTGTAATCTCAGTACTTTGGGTGGCTGAGGCAGGTGGATCACCTGAGG"
"GL873578","6158845","6158972","chr3","500432","500562","24","5658413","GACATGGTGGCTCACACCTGTAATCCTAGCCCTCTGGGAGGCTGAGGCAGGTGGATCACTTGAGTTCAGGAATTCAAGACCAGCTTGAGTGAGAGCAAGACCCTGTCTCTACTAAAAATAGAAAAATT","GCACGGAGGCTCATACCTGTAATCCCAGCACTTTGGGAGGCTGAGGCAGGTGGATCACCTGAGGTCAGGAGTTCCAGACCAGCCTGGCCAACATGGCGAAACCCTGTCTCTACTAAAAATACAAAAAATCT"
"GL873578","6159253","6159444","chr19","34496349","34496541","55","28337096","ATAAAATAAAAATAGAAAAATTAGCCAGGCATTGTGGCAGACATGCGAAGTCTCAGCTACTCCAGAGGCTGAGACAGGAAGATTACTTGAGCCCAAGAATCTTGCTGTGAGCTAAGCTGATGCCATAGCATTGTAACCTAGGCAACAGAGTAAGACTTGGCCTCAAAAATAAAATAAAATAATAAAGTAAAA","TTAGTTAATTAAATTAAACTTAGCTAGGCATAGTGGAACACACCCATAGTCCCAGCTACTCTAGAGGCTGAGGCAGGAGGATTGCTTGAGCCAAGTTGGAGGCTGCAGTGAGCTATGGTGGTGCCACTGCATTCCAGCCTCAGTGACAGAGAGAGACCCTGGCTCAAATAATAATAATAAATAAATAAATAAA"
"GL873578","6766040","6766171","chr2","93098086","93098217","30","86332046","CCAGGCACAGTGGCTCATGCCTATAATCCTAGTAGTCTAGGAGGCTGAGGTGAGTGCATTGCTTGAGCTCAGGAGTTAGATACCAGCCTAACCAAGAATGAGACCCCATCTCTATTAAAAATAGAAAAGTTA","GCCGGGCACAGTGGCTCATGCCTGTAATCCCAGCACTTTGGGAGGCCGAGGCGGGCAAATCACGAGGTCAGGAGTTCAAGACCAGCCTGACCAATATGATGAAACCCCGTCTCTATTAAAAATACAAAAATT"
"GL873578","6766434","6766577","chr9","21128084","21128223","50","14361650","GTTAGCCAGGAGTTGTGGCGGGCACCTACAGTCCTAGCGACTCAGGAGGCTGAAGTAGGCAGAGTTTGATGTGTTGCTGTGAACTACAAGGACACCAATGCACTCTAGGCCGGTAACAGAGTGAGACACTGACTAAAAAAAAAA","TTAGCCAGGTGTGGTGGCACATGCCTGTATTTCCAGCTACTCGGGAGGCTGAGGCAGGAGAATTGCGTGAGCTGAGATCATGCCACTTCATTCCAGTCTGGGTGACAGAGTGAGACTCTGCCTCAAAAAACAAAACAAAA"
"GL873578","7397948","7398119","chr5","40230148","40230319","43","32832200","TAAAAATAGCCATGCATTGTGACAGGCACCTGTAGTCCCAGCTACTCAGGAGGTTGAGGTAAGAGAATCACTTGAACCCAAGAGTTTTGAGGTTGTTATGAGCTAAGACGCCTCGGGACTCTACAAAAGGTAACAAAGTGAGACTCTGTCTCATAAAAAAAGAAAAAAAGAA","AAAATTAGCCAGGCATGGTGACGTACACCTGTAGTCCCAGCTACTCGGGAGGCTAAGGCAAGAGAATCGCTTGAACCCAGGAGGCAGAGGTTGCAGTGAGCTTAGATCACGCTACTGCGCTCCAGCCTGGGTGACGGAGTGAGACGCCATCTCAAAAAAAAAAAAAAAAAAA"
"GL873578","7398378","7398515","chr15","102382935","102383070","35","94984557","GGTCGAGCAAGGTGGCTCACGCCTGTAATCCTAGCACTCTGTGAGGCTGAGGCAGATGGATTGCCTGAGCTCGTGGGTTCGAGACCAGCCTGAGCCAGAGTGAGACCTCATCTCTAAAAATAGCTGGGAAGCTGGGCA","GGCCAGGTGTGGTGGCTCACGCCTGTAATCCTAGCACTTTGGGAGGCTGAGGCGGGTGGATTGCCTGAACTCAGGAGGTCAAGACCAGCCTGGGCAACACAGTAAAACCCCATCTCTACTAAAATACAAAAAATCA"
"GL873579","370235","370429","chr16","38067345","38067552","57","37697110","GCACAGGCCTGAAATCCTAGCACTCTGAAAGGCCAACGGAGGAGAATTTCTGGAGCTCAGGAGTTTGATACCAGCCTAAGCAAATAAAGCTAGACCTCTATCTCTACTAAAATTAGAAAAATTAGGCAGATGTGGTGGTAGGCACCTATAGTCCCAATTACTCCAGAGGCTGAGGCAGAAAGACTCTTGAACCCA","GTCAGGCATGGTGGCTCATGCCTATAATCCTAGCACTTTGGGAGGCCAAGGCCGGTGGATCACCTGAGGTCAGGAGTTTGAGACCAGCCTGGCCAATATGGCAAAACCCCGTCTCTACTAAAAATAAAAAAATTAGCTGGGCACGGTGGTGGGCACCTATAGTCCCAGCTACTCAGGAGGCTGAGGCAGGAGAATTGCTTGAACCCAG"
"GL873579","370936","371046","chr3","3847698","3847802","33","3476762","TGACTCTTGAACCCAGGCACATGAGGTTGCTAAGAGTCTAGGCTGATGTCACGGCACTCTAACCTGGGAAACAGTGTGAGGTTCTGCCTCAATAAATAAATAAATAAATAA","TGGCTTGAACCCAGGAGGCGGAGGTTGCAGTGAGCCGAGATCACGCCACTGCACTCCAGCCTGGGCAACAGAGCGAGACTGTCTCAAAAAAAAAAAAAAAAAAAA"
"GL873579","599436","599605","chr10","38982686","38982853","41","38383250","AAAAAGTCAGACATTGTGGCAGGTGTCTGTAATCCCAGCTATTTGGGAGGCTGAGGCAGGAGTATCATTTGAACCCACGAGTCTGAGGTAACTGTGAGCTAGGCTAACACAACAGCACTCTAGCCTGGGCAATAGAATGAGACTCTATCAAGAAAAGAAATGAAAAGAAA","TATTAGCCTGACACAGTGGCGCGCATCTGTAATCCCAGCTACTTGGGAGGCTGAGGCAGGAGAATCACTTGAACCCAGGAGGCGGAGGTTGCTGTGGGCTGAGATCATGCCACTGCACTCCAGCCTGGGCAACAGAGGGAGGCTCCATCTCAAAAAAAAAAAAAAAAA"
"GL873579","599942","599953","chr3","71473700","71473710","4","70873758","TTTTAAAATAGT","TTTAAAAAAAA"
"GL873579","600232","600365","chr1","16061315","16061447","30","15461083","GGCTAGGCAAGGTGACTCATGTCTGTAATCCTAGTACTCTGGGAGGTTTGAGGCAGGAAGACCACTTTAGCTCAAGAGTTCCAGATCAGCCTGTGCAAGAGTGATACATCATCTCTACTAAAAATCAAAAATTA","GGCTGGGCATGGTGGCTCATGCCTGTAATCCTAGCACTTTGGGAGGTTGAGGCAGGCAGATCACTTGAGGTCAGGAATCTGAGACTAGCCTGGCCAACATGGTGAAACTCCATCTCTACTAAAAAAAAAAAAA"
"GL873579","5650320","5650591","chr6","54938866","54939145","71","49288546","GTCAGGTGTGTTAGCTTACAGTAGTAATCCTAGCACTTTGGGAGGTTGAAGTGGGTGGATTGCTTGAGCTCAGGGGTTCAAGACCAGCCTGAACAAGAGTGGGACCTCATCTCTATTAAAAACAGAAAAACTAGCTGGGTGTTATGGTGGGTGTCTGTAGCCCCAGCTACTCAGGAGGCTGAGGCAGGAGGTTGAGGTTGCTGTGAGCTATTGAGACCACAGCACTCTATCCAGGGCAACAGAGTGAGACCCCTCCCCCCCCCAAAAAAAAA","GGCCAGGTGTGGTGGCTCACGCCTGTAATCCCAACACTTTGGGAGGCCGAGGTGGGTGGATCACCTGAGATCAGGAGTTCAAGACCACCCTGGCCAACATGGTGAAACCCCGTCTCTACTAAAAATACGAAAATTAGCTGAGTGTGGTGGTGCATGCCTGTAGTCCCAGCTACTCAAGAGGCTGAGGCAGGAGGTGGAGGTTGCAGTGAGCCGAGATTGCATCACTGCACTCCAGCCTTGGCGACAGAACGAGAGAGACTCCATCTAAAAAAAAAAAAAA"
"GL873579","7037162","7037347","chr3","37328686","37328893","67","30291524","GAGGTGGGTGGATTGCCTGAGCTCACAGGTTGGAGACCAGCCTGAGCCAGAGCAAGACCTTATCTCAAAAAATAGCCAGGTGTTGTGGCTGGCACCTGTAGTCCCAGCTGCTCAGGAGGCGGAGGCAAGAGAAATGCTTGACCTCAGGAGTTTGAGGTTGCTGTGAGTTCAACTCACACTAATACA","GAGGCAGGGGGATCACCTGAGGTCAGGAGATCGAGACCAGCCTGGCCAACATGGTGAAAACCTGTCTCTACTAAAAATCCAAAAACATTAGCCAGGTGTGGTGGCACGCACCTGTAATCCCAGCTACTTGGGAGGCTGAGGCAGGAGAATCACTTGAACCTGGGAGGCAGAGGTTGTAGCGAGCCGAGATCACACCACTGCACCCCAG"
"GL873579","11077764","11077972","chr19","1200469","1200683","63","9877295","GCCAGGTGCAGTGGCTCATGCCTATAATCCTAGCACCCTAGGAGGCTGAGGAGTTCAAGACCAGCCTAAGCAACTGTGAGACCCCATCTCTACCAAAAATAGAAAAATTAGCTGACTGTTATGGTGTGCACCTACAGTCCTAGCTACTCAGGAGGCTGAGGCAGAAAGAGTCCTTGAACCCAGGAGGCTTTTTTTTGTTGTTGTTGTTG","GGCCAGTCGCGGTAGCTCATGCCTGTAATCCCAGCACTTTGGGAGGCCGAGGCGGGCAGATCACCTGAGACCAGCCTGGCAACATGGTGAAACCCCATGTCTACCCAAACTACAAAAATTAGCTGGGTGTGGTGGTGCACGCCTGTAATCCGAGCTACTCAGCAGGCTGAGGCAGGAGAATCCCTTGAACCTGGGAGGCAGAGGCTGCAGTGAGC"
"GL873579","11078245","11078333","chr19","4926258","4926351","22","6151987","TGAACCCAGGAGTTTGAGTTCGCTGTGAGCTAAGCTGAGGCCACAGCACTCCAGCCTGGGCAACAGAGTGAAAGGAAAAAAATAAAAAA","TGAACCCGGGAGGTGGAGGTTGCAGTGAGCCAAGATCACACCAATGCACTCCAGCCTGGGCAACAAGAGTGAAACTCTGTCTAAAAAAAAAAAA"
"GL873580","320374","320488","chr13","48549305","48549409","42","48228931","GGTAGTGCGTGCCTGCATTCCCAGCTACGGGAGGGCAGGGACTTGAGGCCAGCCTGGGCAAAATAATGAGACCTACTAATGACTCTACTAATACAGAAACAATTAGCTAGGTATG","TGGGAGGCCGAAGTGCGCAGATCACCTGAGGTCAGAAGTTGGAGACCAGCCTGGCCAACATGGTGAAAACCCATCTCTACTAAAAATACAAAAATTAGCTGGGCA"
"GL873580","374969","375091","chr6","147681010","147681135","27","147306041","CGGTGGCTCACACCTATAATCCTAGCATTTTGGAAGGCTGAAGCCGAGGATCTCTGGAAGTCAGAAGTTCAAGACCAGCCTGCCCAAGAGCAAGACCCCATCTCTACTAAAAATAGAAAAACT","GGTGGCTCACACCTGTAATCCCAGCATTTTGGGAGGCTGAGGCAGGCGGATAATCTGAGGTCAAGAATTTGAGACCAGCCTGGCCAACATGGAGAAACCCTATCTCTACTAAAAATACAAAATTAC"
"GL873580","375369","375549","chr7","19977275","19977456","44","19601906","CTAACCAAGTTAGTTAGTTTTAGTTGGCAGGTGCCTGTAGTCCCAGCTCCTTGGGAGGCTGAGGCAAGAGAATGGCTTGAGCCCAGGACTTTGAAGTTGCTGTGAGCTATAATGACACCACAGCACACTACCCAGGGTGACAGAGTGAGACTGTCTCAAAAAAACAAACAAACAAAAAAAA","AACAAACGTTAGCCGAGCATGGTGGTATGTGCCTGTAGTCCCAGCTACTTGGGAGTCTAAGGCAGGAGAATTACTTGAGCCCGGGAGGCAGAGGTTGCTGTGAGCCAAGATCACGCCACTGCACTCCAGCCTGGGTGACAGAGTGAGACTCCATCTCAAAAAAAAAAAAGGAAAAAAAAAAA"
"GL873580","8760922","8761015","chr11","104681322","104681416","19","95920400","GGAGGGAGACACTGCAGTGAACTGCGATCGTGTCTCTGCTTTCCAGGCTGGGTGACAGAGTGAGACTCGGTCTCTAAAATAAAAAATAAATAAA","GGAGACGGAGGTTGCAGTGAGCTGTGATCGCGGCACTGCACTCCAGCCTGGGCAACAGAGTGAGACTCTGTCTCAAAAATAAATAAATAAATAAA"
"GL873580","9391260","9391306","chr14","49279240","49279285","12","39887980","GCCAGTCGAGGTGGCTCACACTTGTGATTCCAGCTACTTGGAAGACT","GGCTGAGATGGTGGCACACACCTGTAATCCCAGCTACTTGGGAGGC"
"GL873581","759283","759365","chr6","46535476","46535542","30","45776193","TAAGAACCTGAAAATAGAGCCAGGCATAGTGGTACATGCGTATAGTCCTGGCTACTCAGGAGGTTGAAACAACAGGATTACTT","CAAAATAGCCAGGCTTGGTGGTGCATGCCTATAATCCAAGCTACTCGGGAAGCTGAGGCAGGAGAAT"
"GL873581","1145844","1145979","chr1","29437872","29437991","29","28292028","GGCCGGGCGTGGTGGCTCACGCCTGTAGTCCCAGCACTATGGGAGGCCGAGGCGGGTGGATCACCTGTGCTCAGAGGTTCGAGACCAGCCAAGACCCCCCTGAGCCAAATGAGCCAGAGTGAGACCCCGTCTCTAC","GGCCGGGCGTGGTGGCTCACGCCTGTAATCCCAACATTTTGGGAGGCCAAGGCGGGTGGATCACCTGAGGTCAGAAGTTCGAGACCAACCTGGCCAACATGGTGAAACCCCTGTCTCTAC"
"GL873581","9628238","9628362","chr5","141044567","141044691","34","131416329","ATCCCAGGTAGTCGGGAGGCTGAGGCAGGAGGATCACTTGAACCCAGGAGGTTGAGGTTGCTGTGAGCAAGGCAGAGGCAACGGCACTCTAGCCACGGGGGCACAGAGACTCTTGTCTTTAAAAA","TAATCTCAGCTACTCGGGAGGCTGAGGCAGGAGAATCGCTTGAGCCCAGAAGGTGGAGGTTGCAGTGAGCCAAGATCGCGCCATTGCACTCCAGCCTGGGCGACAGTGCGAGACTCTGTCTCAAA"
"GL873582","1580485","1580534","chr6","32576760","32576806","12","30996275","CAGCACTTGAGAGGCCAAGGCAGGTGGATCAACTGAGCAAGAATGAGACC","CCAGCACCTTGAGAGGCCAAGGCAGGTGGATCACCTGAGGTCAGGAG"
"GL873582","1644368","1644551","chr1","211626449","211626612","63","209982081","AAAATTTGCCGGGCTCCATAGCTCATGCATGTAATCATAGCACTCTGGGAGGCCAAGATGGGAGGATCTCTCAAGCTCTCTTACTTGGGAGGCTGAGGTTGCTGTGAGTTAGGCTTACGCCACAGCACTCTACTCTAGCGTGAGCAACTCTACTCTTAGTATGAGACTGTCTCAAAAGAAAAAA","AAATTAGCCAGGCGTCGTGGCACATGCCTGTAATCCCAGCTACTCGGGAGGCTGAGGCAGGAGAATAGCTTGATCTCGGGAGGCGGAGGTTGCAGTCAGCCGAGATCACACCACTGCAATCCAGCCTGGACAACAGAATGAGACTCCATCTCAAAAAAAACAAA"
"GL873582","5794385","5794459","chr13","18872784","18872852","27","13078399","ATATTGTTAAGCACAGCCACTATTAAAAATTAAATTATAGGCCAGGCATAGTGGCTCATGCCTGTAATCCTAGCT","TGAAACCACCATCTGGACCAAGATACAAAATGTTGGCTGGGCATGGTGGCTCACACCTGTAATCCTAGC"
"GL873583","102645","102683","chr14","5808766","5808804","14","5706121","GAGCAGATCACCTGAGCTCAGGAGTTTGAGACCAGCCTG","GAGGAATCCCTGTGCTCAGGAAGCTTACATTCTAGTGAG"
"GL873583","6200447","6200560","chr4","17786849","17786963","24","11586402","GGCCAGGAGGGACGGCTCATGCCTGTTATCCTAGCACTATGGGAGACTGAGGTGGGAGGATCACTTGAAGTTAGGAGTTCCAGACCAATCTGACCAAAGTGAGACCTCATCTCT","GGCCAGGCTTGGTGGCTCATGCCTGTAATCTTAGCACTTTGGGAGGCTGAAGTGGGTGGATCACTTGAGGTCAGGAGTTAGAACCAGTCTGGCCAACATGGTGAAACCTCAGCTC"
"GL873583","6200584","6200752","chr6","169626528","169626696","42","163425944","TTAGCTGGATGTGGTAGCACATGCCTATAGTCCCATCTACTCAGGAGGCTGAGACAAGAGAGTTGCTTAAGCCCAGGAGTTTAATTTAACTGTGAACTAGACTGAGACTGTGGCACTCTAGCTGGGGCAACAGAGTGAGACTCTGTCTCAAAAGAAAGCAAGAAAGAAA","TTAGCTGGGTATGGTGTCAGATGCCTGTAGTCCCAGCTACTCAGGAGGCTGAGACAGGAGAATCGTTTGAACCCAGGAGGCCAGAACTGCAGTGAGCTGAGATTCGCACCACTGCGCTCCAGCCTGGGCCAGACAGAGTGAGACTCTATCTCAAAAGAAAAAAAAAAAA"
"GL873583","10217398","10217583","chr3","36257142","36257313","44","26039744","TACTAAAAATAAAGTGTGATAGCCAGGCATGGTGGTGGTGCCTATAGAACCAGGCTATTCAGGAGGCTGAGGCAGAAGGATCACTTGAACCCAGGAGTCTGACGTTGCTGTGAGCTAGGCTGGTGCCATGGTACTCTAGCCTGTGGTAACAGAATGAGACTCTATCTCAAAAATAAAAATAAAAAA","TACAAAATTAGCCAGGCGTGGTGGTGCGTGCCTGTAATCCCAGCTACTTGGGAGGCCGAGGCAGAAGAATGACTTGAACCCAGGAGACAGAGGTTGCAGTGAGCCAAGATCCCACCATTGTACTCCAGCCTGGGCAACACAGTGAGACTCCATCTCAAAAAAAAAAAAAAAA"
"GL873583","10394919","10394983","chr16","12841703","12841771","22","2446784","GAGGTCAGGAAATCAAGATCAGTCTGGGCAATATATTGATACCCTGCCCCTACATAAGGAAGAAA","AGGTCAGGAGTTCAAGACCAGCCTGGCCAATATGTTGAAACCTCATCTCTACTAAAAATACAAAAATTA"
"GL873584","521512","521529","chr1","167402212","167402233","10","166880700","GCATGGAACCCCCCACTC","GGTGAAACCCCATCTTTACTAA"
"GL873584","2079725","2079768","chr15","4338291","4338335","11","2258566","GGCAGGTGGATTACCTGAGTTCAGGAGTTGGAGACCAGCCTGAC","AGGCGGATGGATCACGAGGTCGGGAGTTTGAGACCAGCCTGACCA"
"GL873584","5216877","5217053","chrX","91350057","91350230","49","86133180","CTACTGAAAATGATGACAGAGGCTGGGCATGGGGGCTCCCGCCTGTTATCCTAGCACCCTCGGAGGCTGGGGAATGAGGATTGCTTACGCCCAAGAGTTTGAGGTTGCTGTGAGCTGAGGCCGCTGCACTCTAGCCTGGGCAACAGAGTGAGACTCTGTCTCAAAAAAAAAAAAAAA","TGCAAAAATGAGCTGGGCATGGTGGCACATGCCTGTAATCCCAGCTACACAGGAGGCTGAGGCAGGAGAATCGCTTGAATCTGGGAGGCGGAGGTTGCAGTGAGCTGACATCAGGCCCCTGCACTCTAGCCTGGGCCACAGAGCAAGACTCCGTCTCAAAAAAAAAAAAAAAAA"
"GL873584","7289930","7289950","chr2","51453328","51453345","10","44163398","TGAGGCTCTGTCTCGAAATAA","AATGCCATCTATTAAAAA"
"GL873584","7289975","7290131","chr11","49739997","49740154","37","42450022","CAAGAAAATTAGCTGAGAGTCCTGGTAGGTGCCTGTAATCCCAGCTATTCATGAGGCTGAGGCAGAAGGATCACTTGGGTCCAGGAGTCTGAGGTTGCTGTGAGCTAGTCTGACGCCATAACACGCAAGCCTGGGCAACAGAGTGAGGCTCGGTTTC","CTACAAAAATTAGCTGGGCGTGGTGGCACATGCCTGTAATCCCAGCTACTCGGGAGGCTGAGGCAGGAGAATCACTTGAGCCCAGGAGGCGGAGGTTGCAGTGAGCCAAGATCATGCCATTGCACTCCAACCTGGGCAACAGAGCAAGACTCCATCTC"
"GL873584","7577743","7577867","chr5","48394329","48394446","27","40816586","GGCTGGATGAGGTGGTTCATGCCTGTAATCCTAGCACTCTGGGAGGCCAAGGTGGGTGGATTGCCTGAGCTCAGGAGTTCAAGACCAGCCTGAGCAAGACCCTGTCGCTAAAAATAGCTGGGTGT","GGCTGGGTGCAGTGGCTCATGCCTGTAATCCCAGCACTTTGGGAGGTCAAGGCGGGTGGATCACCTGAGGTCAGGAGTTCAAGACCAGCCTGGCCAACATCTCTACTAAAAATACAAA"
"GL873584","7578135","7578289","chr1","130112713","130112865","31","122534578","GGAGCTGGGTTTTGTGACTGCACCTGTAATCCCAGCTGCTCAGGAGGCTGAGGCAAGAGAATTGCTTGAGCCCAGGAGTTGGAGGTTGCTGTGAGCTGTGATGCCAGGGAACTCTACCAAGGGTGACAAAGTGAAACTCTGTCTCAAAAAAAAAA","TTAGCCAGGTGTGGTGATGCATGCCTGTAATCCCAGCTACTCATGAGGCTGAGGCAGGAGAATTGCTTGAACCTTGGAGCTGGAGGTTGCAGTGAGCTGAGATCAGACCACTCCAACCTGGGTGACAGAGCGAGACTCTGTCTCAAAAAAAAA"
"GL873585","1450952","1451121","chr10","59681079","59681242","48","58230127","TAAAAACAGAAAAAACTAGTCAGGTGGTGTGGTAGGTGCTCATAAGTCCCAGCTGCTTGGGAGACTGAGGCAAGAGAATCACTTGAGCACAAGAGCTTGAGGTGGCTGTGAGCTATAACACCATAGCACTGTACTGAGGGTGACAAAGTAAGACTCTGTCTCAAAAAAAA","TACAAAAATTAGTCAAGGGTGGTGGTATGTGCTTGTAATCCCAGCTATTTGGGAGGCTGAAGCAGGGGAATCCTTGAACCCAGGAGGTGGAGGTTGCAGCGAGCCGAGATCACGTCACTGCACTCTAGCCTGGGCGATAGGGTGAGACTCTGTCTCAAAAAAAA"
"GL873585","1451382","1451515","chr6","17405813","17405948","24","15954431","GGCCCGGCTCGGTGGCTCACACCTATAATCCTAACACTCTGGGAGGCTGAGGCAGGTGGATCACCTGAGCTCAGGAGTTTGAGACCAGCTGAGCAAAAACAAGACCCTATCTCTGCTAAAAATAGAAAAAACTA","GGCCGGGCGGGGTGGCTCACGCCTGTAATCCCAGCACTCTGGGAGGCCAAGGCAGGTGGATCACCTGAGGTCAGGAGTTTGAGACCAGCCTGGCCAACACGCAGAAACCCTATTTCTACTAAAAACACAAAAATTA"
"GL873585","1626960","1627026","chr7","17782729","17782794","22","16155769","AAGATGCCACAGCACTCTACAAGAGTGACCAAGTGAGACTCTGTCTCAAAAAAAAAAAGAAAAGGAA","CAATCGCACTACTGCACTTCAGCCTGGGTGACAGAGTGAGAACCTGTCTCAAAAAAATAAATAAAA"
"GL873585","1627304","1627531","chr11","17033552","17033788","61","15406248","GGCTGGGCACAGTGGCTCACGGCTATAATCTAGGCACTTGGGAGGCTAGGGCAGGTGGATTGCCTGAACTGACAAGTTTGAGACCAACCTGAGCAAGAGCGAGACCCCTGTCTCTAAAACATAGCCAGGCTCTGTGGTGGGCGTCTGTAGTCCCAGCTACTTGGGAGGCTGAGGCAAGAGAATTGCTTGAACTCAAGAGTCTGAGGTTGCTGTGAGTTAAGATGCCAC","GCCCGGCGCAGTGGCTCACGCCTGTAATCCCGGCACTGTGGAGGCCAAGGCAGGCGGATTGCCTAAGCTCAGGGATTCGAGAACAGCCTGGGCAACATGGTGAAACCCCATCTCTACTAAAATACAAAAAACTAGCCGGGCGTGGTGGTATGCGCCTGTAATCCCAGCTACTTGGGAAGCTGAGGCAGGAGAATTGCTTGAACCCGGGAGATGGAGGTTGCAGTGAGCTCAGATCAC"
"GL873585","3626082","3626158","chr1","100916857","100916922","27","97290775","TGCCTGTAATCCCAGCACTTGGGAGGCGGAGGTGGGTAGATTGCCTGACCCAGAGTGGGACCTCATCTCTAAAAGAA","CATGCCTGTAATCCCAGCACCTTGGGAGGCCAAGGTGGGTGGATCACCTGAGGTCAGTAGTTTGAG"
"GL873585","8849829","8849913","chr18","48581945","48582025","18","39732116","GGCTGGACGAGGGGACTCATGCCTGCAATCCCAGCACTGAGAGAGGCCAAGGCAGGTGGATCCCCTGAGCTCAGAAGTTTGAGAC","GCTGGACGCAGTGGCTCACACCTGTAATCCCAGCACTTTGGGAGGCCAAAGCAGGCAGATCTGAGGTCAGGAGTTTGAGAC"
"GL873585","9319890","9319971","chr8","79499361","79499447","14","70179471","GGCCAGGTGTGGTGGCTCACACCTGTCATCCTAGCACTCTGGGAGGACGAGGTGGGTGGACCGCCTGAGTCAGAGTGAGACC","GGCCAGGTGTGGTGGCTCACACCTGTAATCCCAACACTTTGGGAGGCCCAGGTGGGTGGATCACCTGAGGTCAGGAGTTCAAGACCA"
"GL873586","895572","895692","chr17","14501559","14501680","38","13605987","GGCCAGGTGAGGTTTCTCATTCTGGGAGTGAGCCAGCAATTGGGAGGCCAAAGTAAATGGATTGCCTGAGGTTATAGGTTCCAGAACAGCCAGAACAAGATCGAAATCCTGTCTCCAAAAA","GGCCAGGCGTGGTGGCTCATGCGTGTAATCTCAGCACTTTGGAAGGCCGAGGCAGGTGGATCACCCGAGGTCAAGAGTTCAAGACCAGCCTGACCAACATGGCGAGTCTCTGTCTCCACTAA"
"GL873586","5645995","5646150","chr6","58863249","58863409","38","53217254","GGGTATGGTGGCTCATGCCTGTAATCCAAGCACTCTGGGATGGTGAGGCAGGAGAATCCCTTGAACCCAAGAGTCCGAGGTTGCTGCGAGCTAAGCTGATGGCATAACACTCTAGCCTAGGCGACAGAGTGAGACTCTGTTTCCAAAGAGAAAAAA","TTAGCCAGGCATGGTGGCACATGCCAGTAATCCCAGCTACTCAGGAGGATGAGGCAGGAGAATCGCTTGAACCCAGGAGGCAGAGGTTGCAGTGAGCTGAGATTGCGCCACAGCACTCTACCCTGGGTGACAGAAGGAGACTCTGTCTCAAAAAAAAAAAA"
"GL873586","10258686","10258969","chr12","9481260","9481565","81","777426","GGCCGGGCATGGTGGCAGAAATCTAGGAGGCCGAGGCAGGTGGATCGCCTGAGATCACAAGTTCAAGACCAGCCTCAGCTACAGCAAGACCCCATCTCTAAAAATAGCCGGCTGTTGTGGCAGGCGCCTGTAACCCCAGCTACTCGGGAGGCTAAGGCAAGAGAATCGCTTGAGCCCATGAGTCTGAGGTTGCTGCGAGCTGTGACTCCACGGCACTCTACCCGGGGCGATAAAATGAGATTCTGTGTCAAAACAAACAAACAAACAAACAACAACAAAAACAA","GCTGGGCGCGGTGGCTCATGCCTGTAATCCCAGCACTTTGGGAGGCCAAGGCAGGTGGATCACCTGAGGTCAGGAGTTCGAGACCAGCCTAGTCCACATGGTGAAACCCCATCTCTACTAAAAACTAGCCAGGCGTGGTGGTGCGCACCTGTAATCCCAGCTACTCGAGAGGCTGAGGCAGGAGAATCACTTGAGCCTAGGAAGCAGAGGTTGTGGTGAGCTGAGATCACACCACTGCACTCCAGTCTGGGCGACACAGTGAGACTCTTGTCTCAAAAACAAAAAACAAACAAACAAACAAACAAA"
"GL873587","3208032","3208047","chr8","3626746","3626762","2","418714","AAACAACCACAAAAAA","ACAACAACAACAAAAAA"
"GL873587","3208141","3208321","chr19","2057131","2057316","59","1151010","TTTCTTTTAAAAATCACCCATGGGCTGGGTATAGTGGCTCACACCTATAATCCTCGGGAGGCCAAGGTTGGAGGATTGCTTGAATCCAGGAGTTGAAGGTTACAGTGAACTGGGATTTAGCCACTAGACTCTAGCATAGCTGACAAAGCAAGAACCTATTTGTTTAAAACACAAAAAAGAA","TACTAATAATACAAAAATGAGCCGGGTATGGTGGCGGGTGCCTGTAATCCCAGCTACTGAGGAGGCTGAGGCAGGAGACTTGCTTGAACCCAGGAGGTAAAGGTTGCAGTGAGCTGAGATTGCACCACTACACTCCAGCCTGGGCGACAAGAGCAAAACTTTTTCTCCAAAAAAAAAAAAAAAAAA"
"GL873587","3278260","3278367","chr19","19044200","19044312","39","15765940","CAGTCTGAGCAAGAGGGAGAGGCTATTTCTACTAAAAACAGAAAAACTAGCTGGGTGTTGGGGTGTGTTCCTAGTCTCAGTTACTTGGGAGGCTGAAGTAAGAGGATC","ACCAGCCTGGCCAACACGGTGAAATCCCGTCTCTACTAAAAATACAAAAATTACCTAGGCGTGATGGCACGTGCCTGTAGTCCCAGCTACTCATAAGGCAGAGGTGAGAGAAT"
"GL873587","3278673","3278754","chr7","49412503","49412597","28","46133830","GGCCACGAGAGCTAGCTCATGCCTATTCTAGGAGGCCAAAGCAGGCAGACTGCCTGAGCTCAGGAGTTCAAGAGCAGCCTGG","GGCCAGGTGCAGTGGCTCATGCCTGTAATCCGAGCACTTTGAGAGGCCGAGGCAGGCAGATCACCTGAGGTCAGGAGTTCAAGACCAGCCTAGTA"
"GL873587","3782076","3782188","chr9","112128434","112128552","34","108346358","ACTGGGGTGGCTGAGGCAGGAGCGTCACTTGAACTCAGGAGTTTGAGATTGCTGTGAGCTGAGCAGATGTCATGGCACGCTAGCCTAGGTAATAGAGTGAGACTTCGTCTAAA","CAGCTACTCGGGAGGCTGAGGCAGGAGAATCACTTGAACTCGGGAGGCGGAGGTTGCAGTGAGCCGAGATCACGCCATTGCACTCCAGCCTGGGCAACAAGAGCGAAATTCCATCTCAA"
"GL873587","4564996","4565084","chr20","27900350","27900437","14","23335354","GGCGGGGTGTAGTGGCTCATGCCTATTGTCCCAGCACTGTGGGAGGCCGAGGTGGGTGGATCACCTGTGCTCAGAAGTTTGAGACCAGC","GGCCGGGCGTGGTGGCTCATGTCTGTAATCCCAGCACTTTGGGAGGCCGAGGTGGGTGGATCACCTGAGGTCAGGAGTTCAAGACCAG"
"GL873587","6307870","6308175","chr12","112427710","112428020","54","106119840","GGCCAGATATGATGGCTCATGCTTGTAATCCTAGCACTCTGGGAGGCTGAAGTGGGAGGATCACCTGAGATCAGGAGTTCAAGATCACCCTGAGCAAAAGTGAGATCCCATCTCTATTAAAAATAAAAAAATTATCCAGGCATGGTGGTGCAGTCCTTTAGTCCCAGCTACTTGGGAGGCTGAGGCAGGAGAATCTCTTGAACCCAGGAATTAGAGGTTACAGTGAGCTGTGATGATGCTACTGCACTCTAGCAGGATGACAGAGTGAGATACTCCGTGTCAAAAAAAAAAAAAAAAAAAGCAAAA","GGCTGGACATGGTGGTTCATGCTTGTAATCCGAGCACTTTGGGAGGCCAAGGCGGGTGGATCACCTGAGGTTGGGAGTTCGAGACCAGCCTGACCAACATGATGAAACCCCATCTCTACTAAAAATACAAAAAAATTAGCCAGGCATGGTGATGCACGCCTGTAATCCCAGCTACTTGGGAGGCTGAGGCAGGAGAATCACTTGAACCCAGGAGGCAGAGGTTACAGTGAGCCGAGATCATGCCATTGCACTCCAGCCTGGATGACAGAGTGAGCCTCTGTCTCAAAAAAAAAAAAAAAAAAAAAAAAAAA"
"GL873587","6484004","6484128","chr10","67341428","67341546","29","60857424","GACCAGGTTCTGTGGCTCATGCTTGTAATCCTAGCACTCTAGGAGGCCGGAAGAGGGTGGATTGATTGCCTGAGGTCAGGAGTTAGAGACCAGCCTGAGCAAGAGCTAGACCCTGTTTCTTTCTT","GGCTGGGTGTAGTGGCTCATGCCTGTAATCCCAGCACTTTAGGAGGCCAAGGTGGATGGATTGCCTGAGCTCAGGAGTTCGAGACCACCCTGGGCAACAAGCCAAAACCCTGTCTCTAC"
"GL873587","6484407","6484586","chr3","167196537","167196723","48","160712130","TAGACCCTGTTTCTAAAAAAAAAATAGCCAGGTGTTGAGGCAGGTACCTGTAGTCCCAGCTACCTGGGAGGGCTGAGGCAAGAGAATCGCTTGAACCCAAGAGTTTGAGGTTGCTGTGAGCTGAGATGCTATGGCACTCAACCGTGAGCTACAAAGTGAGACTCTGTCTCAAAAAAAAAA","AAAACCTGTCTCTGCTAAAAATACAAAAATTAGCCGGGTGTGGTGATGTGCGCCTGTAGTCCTAGCTACTTGGGAGGCTGAGGCAGGAGAATCACTTGAATCCAGGAGGTGGAGGTTGTAGTGAGTCGAGATCGTGCGACTGCACTCCAGCCTGGGTGACAGCGAGACTCTGTCTCAAAAAAAAAAA"
"GL873587","7466229","7466364","chr1","29437872","29437991","35","21971643","GGCCAGGCGTGGTGGCTCATGCCTGTAGTCCCAGCGCTATGGGAGGCCGAGGTGGGTGGATCACCTGTGCTCAGAGGTTCGAGACCAGCCAAGACCCCCCTGAGCCAAATGAGCCAGAGTGAGATCCCATCTCTAC","GGCCGGGCGTGGTGGCTCACGCCTGTAATCCCAACATTTTGGGAGGCCAAGGCGGGTGGATCACCTGAGGTCAGAAGTTCGAGACCAACCTGGCCAACATGGTGAAACCCCTGTCTCTAC"
"GL873588","1502535","1502718","chr1","34852429","34852590","60","33349894","GGTGCAGTGGCTCACACCTGTTGTCCCAGCGCTGTGGGAGGCCGAGGTGGGTGGATCACCTGTGCTCAGAGGTCGAGACCAGCTGAAGACCTGCCTGAGGCAGAGTGAGCCAGAGTGAGACCCCGTCTCTACTAGAACAACAACAAGACAGCCAGACCTTGTGATCCCAGCTACATGGGGGGCT","GCCAGGTGCAGTGGCTCACACCTGTAATCCCAGCACTTTGGGAGGCCGAGGCGGGCGGATCACCTGAGGTCAGGAGTTTGAGACCAGCTTGACCAACATGGAGAAACCCCGTCTCTACTAAAAATACAAAATTAGCCTGGTGTGGTGTCGCATGCCTGTAAT"
"GL873588","10189037","10189246","chr3","45604681","45604903","65","35415644","GCTGAGATGAGGAGACTCTGTCTCTATTAAAAATAGAAAAATTGGGTGGATGTTGTGGGTACTGTAGTTGCAGCCTCTTGGGGGGCTAAGGCAGGAGGATCAGTTGAAGCCAGGAATTTGCTTTGAGCTAGGCTAAAGCCATGGCACTCTAGCCTGGGCAACAGAGTGAGGCTAGATCTCAAAAAAAGAAAGAAAAGAAAAAGAAAAAAA","CTGGCCAACATGGCAAAACCCCATCTCTACTAAATATACAAAAATTAGCTGGACGTGGTGGCACATACCTGTAATCCCAGCTACTTGGAAGGCTGAGGCAGGAGAATAGCTTGAACCTGGGAGGCAGAGGTTGCAATGAGCTGAGATCACGCCACTGCACTCTAGCCTGGGCAATAGAATGAGACTCTGTCTCAAAAAAAAAAAAAAAAAAAAAGACAAGAAA"
"GL873589","104719","104807","chr20","27900350","27900437","13","27795631","GGCTGGGCGTGGTGGCTCATGCCTGTTGTCCCAGCGCTGTGGGAGGCTGAGGTGGGTGGATCACCTGTGCTCAGAGGTTCGAGACCAGC","GGCCGGGCGTGGTGGCTCATGTCTGTAATCCCAGCACTTTGGGAGGCCGAGGTGGGTGGATCACCTGAGGTCAGGAGTTCAAGACCAG"
"GL873589","796766","796905","chr1","166346372","166346487","49","165549606","GGCTAAGTGTGGTGGCTCACACCTGTCATCTAGTACTTTGGGAGGGTGGGCCTGGGAGTTCAAAGACTGAACTCAGGAGTTCAAGGTGGCTCCGGGGAGGAATTCAAGACCAACCTGAGCCAGAGCGAGACCTCGACTCT","GGCCAGTGGGGTGGCTCACGCCTGTAATCCCAGCACTTTGGGAGGCTGAGGTGGTCAAATGACCTGAGGTCAGGAGTTTGAGACCAACCTGGCCAACATGGTGACACCTCGTCTCT"
"GL873589","1023679","1023690","chr1","205890061","205890072","1","204866382","AAAAAAAAAAAA","ACAAAAAAAAAA"
"GL873589","1023771","1024047","chr4","103012712","103012993","70","101988941","GGCTTGGTGGCTCACACCTGTAATCCTAGCACTCTGGGAGGCCGAAGTGGCTGGAATACTTGAGGTCAGGAGTTCAAGACCAGCCTAAGTGAGAGTGAGATCCCCATCTCTAATAAAAATAGAAAAATTAGCAGGGTGTTGTGGCTGGCACTTGTAGTCCCAGCTACCCAGGAGACCGAGGCAGAAGTTTGAGATTATTGTGAGCGAGGCTGATGCCACAGCATTCTAGTGGGACAACAGAGCAAAATTCTATCTCAAAAGAAAAAAAAAAAAAGGA","CGGGCGTGATGGCTCACGCCTGTAATCCCAACACTTTGGGAAGCCGAGGCGGACGTATCACCTGAGGTCAGGAGTTCAAGACCAGCCTGGCCAACATGGTGAAACCCCGTCTCTACTAAAAATACAAAAATTAGCTGGGTGTGGTGGCATGCGCCTGTAATCCCAGCTACCCAGGAGGCTGAGGCAGGAGAATCGCTGAGGCTGCAGTGAACTGAAATTGTGCCACTGCACTCCAGCCTGGGTGACAGAGCAAGACTCTGTCTCAAAAAAAAAAAAAAAAAA"
"GL873589","4820958","4821024","chr8","33633747","33633811","15","28812789","TTAGTCAAGTGCAGTGGCTCACACCTGTCATCCCAGCTACTTGGGAGGCTGAGGCAGGAGAGTTGCT","TTAGCCAGGTGTGGTGGTGCATGCCTCTAATCCCAGCTACTCAGGAGGCTGAGGCAGGAGAATTG"
"GL873589","6763768","6763857","chrX","25814002","25814092","29","19050234","GGTGTGGTGGCTCACACTTGTATCTTAGCATTTTAGGAGGCTGAATGGGGAGAATTGCTTTAAGTCAGGAGTCTGACTTCCACCTTGCCA","GGCTGGGAATGGTGGCTCACACCTGTAATCCCAGCACTTTGGGAGGCTGAGGTGGGCAGATCACCTGAGGTCAGGAGTTTGAGATCAGCCT"
"GL873589","8444551","8444632","chr9","93194085","93194171","17","84749534","CGGGCATGGTGGCTCACAACTATAATCTTAGCACTTTGGGAGGCTGAGACAGGTGGATGCCTGAACTCAAGAGTTTGAAACC","GGCCGAGCATGGTGGCTCACACCTGTAATCCCAGCACTTTGGGAGGCTGAGGCAGGTGGATTACCTGAGGTCAAGAGTTCAAGACCA"
"GL873589","9085365","9085494","chr2","194063347","194063481","42","184977982","GGCCAGGCACAGTGGCTCACACCTATAATCCCAGCACTCTGTGAGACTGAGGCAGGTGAACTGTTGCAAGAGTGAGACCCTGTGCTTGGTGCCTGTAGCTCAGTGGTTAATAATAAGAAAAAAGAAAAAA","GGCCAGGTGCAGTGGCTCACACCTGTAATCCCAGCACTTTGGGAGTCTGAACCAGGCAGATCACCTGAGGTCAGGAGTTCGAGGCCAGCTCGGCCACCATGGTGAAACCCTGTTTCTAATAAGAATACAAAAAAA"
"GL873589","9085767","9086002","chr7","84631446","84631650","75","75545679","GAGTGAAACCCTGTCTCTACTAAAAATAGAAAAACTAGCTGTGCATCAGGGCGCATAACTGTAGTCCCAGGTACTCAGGACACTGAGGCAAGAGAATTGCTCAAGCCCAAGAGTTTGCAAGAATTTGAGGTTGCTATGAGCTATGATGCCATGGCACTCTACCTAGGGTGACAGACAGAGACTCTGTCCCAAAAAAAAAAAAAGAAGAAGAAGAAAAAAAAAAAGAAAGAAAGAAA","ATAGTGAAACCTCGTCTCTACTAAAAATACAAAAATTAGCTGGGCATCATGGTGCACGCTTGTAATTCCAGCTACTTGGGAGGCTGAGGCAGGAGAATTGCTTGAACTCAGGAGGTGGAGGTTGCAATGAGCCAAGATCGCGCCACTGCACACCAGCCTGGGTGACAAAAGACTCTGTCTCAAAAAAAAAAAAAAAAAAAAAAAA"
"GL873589","9992904","9993045","chr16","56427538","56427666","46","46434634","AACCAGCCAGGCATGGTGATTCACACCTATAATCCCAGCTACTTAGGAGTATGGCTTGAGCACACAGGATACCATACCATTCTAGTCATCCCAGGCAACAGAGGGAAACTCTGTTGGTTAAAAAAAAAGAAAAACTTAAAAA","TTAGCCAGGAGTGGTGGTGCACGCCTATAATCCCAGCTACTTGGGAGGCTGAGGCACAAGAATCACTTGAACCATTGCACTCCAGCCAGGGTGATAGAGGGAGACTCTATCCAAAAAAAAAACAAAAAA"
"GL873589","9993319","9993452","chr3","2774534","2774668","28","7218785","GGCCTGAGCCCTGTGACTCATGCCTGTAATCCCAGCACTGGAAGTTCCAAGGCAGGTGGATCGCTTGAGCTCTGGAGTTCAAGACCAGCTCAACCAAGAGTAAGACCCCATCTCTACTAAAAATAGAAAAACCA","GGCTGGGCACGGTGGCTCATGCCTGTAATCCCAGCACTTTGAGAGGCCGAGGCAGGTGGATCTCCTGAGGTCAGGAGTTCAAGACCAGCCTGGGCAACATGGTGAAACCCCATCTCTACTAAAAATACAAAAAAT"
"GL873590","9044589","9044884","chr1","83754525","83754835","84","74709936","GGCCAGGTGCAATGGCTCATGCCTATAATCCTCACACTCTGGGAGGCTGAGGCAGGAGGATCACTTTTCTCAGGGTCAGGGCCAGCCTGACAAAAGTCAGACCCTGTTTCTACTAAAAATAGAAAAACTAGCTGGGTGTTGTGGCAGATGCCTATAGTCCCAGCTACTAAGAGACTGAGACAAGTGCCCAGAGTCTGAGGTTACTGTGAGCAAAGCTGATGCCATAGCATTCTAGCTATAGATCGAGAGTCTGTCTCAAAAACAAACAAACAAACAAACAAACAAACAAAAAAGAA","GGCTGGGTGTGGTGGCTCATGCCTGTAATCCCAGCACTTTGGGAGGCCGAGGCGGGTGGATCATCTGAGGTCAGGAGTTCAAGACCAGCCTGACCAACATGGTGTAACCCTGTCTCAACTAAAAATACAAAAATTAGCTGGGCGTGGTGGTGTGCACCTATAGTCACAGCTACTTGGGAGGCTGAGACAGGAGAATTGCTTCAACCCAGGAAGTGGAGGTTGCAGTGAGCCAAGATCATGTCACTGCACTGCAGCCTGACAGAGCGAGACTCCATCTAAAACAAACAAACAAAAACAAACAAACAAACAAA"
"GL873591","1831505","1831587","chr17","61702818","61702899","25","59871313","CCCAGCACTTTGGGAGGGCAAGATGGGAGAATCATATAAAGTCAGGAGTTTGAGACCAGTTTGGCAGACATGATGAACCCATC","AATCCCAGCACTTTGGGAGGCTGAGGCAGGCGGATCATCTGAGGTCAGGAGTTCAAGACCAGCCTGGCCAACATGGTGAAAC"
"GL873591","2719175","2719275","chr4","86137755","86137847","32","83418580","GTGGGGGCTTAGGCCTGTAATCCCAGCACTCTGAGAGGCCAAGGTGAGCTGGTCACCTGGGTTTAGGAGTTTGGAGACTTGCTCGAGCTAGACTGAGGCTC","GTGGTGGCTCACGCCTGTAACCCTAACAATTTGGGAGGCCAAGGCAGGTGGATCACTTGAGGTCAGAAGTTTGAGACCAGCCTGGACAATATG"
"GL873591","4732974","4733120","chr19","7991801","7991954","55","3258827","ATACGCAGACTGGCCGAGCGTGGTGTCACATGCCTATAATCCCAGTGGCTACTCTGGGGAGGAGAATCTCTTGAAACCAAGAGTTAGAGATTGCAGTGGGGTATGATACAGGGTAACAAAGAGAGACCTTGGATCTGAAAAGAAAAA","AAAATACAGAAACTAGCTGGGCATGGTGATGCACACCTGTAATCCTAGCTACTGGGGAGGCTGAGGCAGGAGAATTGCTTGAACCCAGGAGTCAGAGGTTGCAGTGAGCAACCAGCCTGGGTGATACAGTGAGTGAGACTCTGTCTCGAAAAAA"
"GL873591","6822728","6823009","chr1","20579766","20580052","72","13757038","GGCCAGGCGTGGTGGCTCATGCCTGTAAATCTCAGCACTCTGGGAAGCTGAGGCAGGTGGATTGCTTGAGGTCAGGAGTTTGAGACCAGCCTGTACCAGAGTAAGACCCTGTCTCTAATAAAAATAGAAAAAAAAAAAAAAACTAGTTGGGCATGGTGATGGGTGCCTGTAGTCCCACCTACTTGGGAGGCTGAGGCAATGGCATCTCTTGAGCCCAAGAGTTTGAGGTTGCTGTGCCATGGCACTCTCCCCAGGGTAACAGAGTGAAAATAAAAAAAAGAA","GGCCAGGCGTGGTGACTCATGCCTGTAATCTCAGCACTTTGGGAGGCCGAGGCAGGTGAATCACCTGAGGTCAGGAGTTTGAGACCAGCCTGACCAACATGGTGAAACCTCGTCTCTACTAAAAATACAAAAAGTAGCCAGGCATGGTGGCGCATGCCTGTAATCCCAGCTACTTGGGAGGCTGAGGCAGGAGAATCGCTTGAACCCGAGAGGCAGAGGTTGCATTGAGTCAAGATGGTACCACTGCACTCCAGCCTGGGTGACAGATTGAGACTCAAAAAAAAAAA"
"GL873591","7578706","7578813","chr16","45055441","45055543","42","37476735","AAATTTAGCTACACATAGTGGCATGAGTCTGTAATGCTAGCCACCCAAAAGGCTGTAGTAAGAGGATTGCTCTATCCCAGGAGTTAAAGACCAGCCCGGACATCAGAG","AATTAGCCGGGCGTGGTGACACACACTTGTAATCCTAGATACTCAGGAGGCGAAGGTAGGAGAATTGCTTGAACCCAGGCAGCAGAGGTTGCAACGAGCAGAG"
"GL873591","9282916","9283004","chr1","20744253","20744338","16","11461337","GGCCAGGCGCGGTGGCTCACCCCTGTTGTCCCAGTTCTGTGGGAGGCCGAGGTGGGTGGATCACCTGTGCTCAGAGGTTTGAGACCAGC","GGCCAGGCACGGTGGCCACGCCTGTAATCCCAGCACTTTGGGAGGCCGAAGTGGGTGGATTACCTGAGGTCAAGAGTTTGAGACCA"
"GL873592","835155","835315","chr16","75654291","75654451","43","74819136","CTGGGTGTGGTGGCTCTTGTCTGCAATCTCAGTACACTGGGAGGCTGAGGCAGAAGGATTGCTCCAGCTCAGGAGTTTGAGGCCAGGCTGAGCTAGTGCAAAACCCCATCTCTACTAAAAAAAGAAGGAAAAAAAAAAGAAAAAGAAAAAAAATACGAGCT","CCAGGTGTGGTGACTCACGCCTGCAATCCCAGCACTCTGGGAGGCTGAGGTGGGTAGATTACCGGAGGTTAGGCGTTTGAGACCAGCCTGGCCAACATGGTGAAACCCCATCGCTACTAAAAAAAAAAAAAAAAAAAAAAAAAAAAAAAAAAAAAAAATTA"
"GL873592","835589","835765","chr1","66836166","66836336","48","66000577","ACAAAAAACCTAGCTTAGGGTTGTTATAGCACCTGTAGTCCCAGCTACTCAGGCGCTAAGGCAGGAAAATCTGCCTGAGCTCAGGAGTTTGAGGTTGCAGTAAGTTATGATGATGCTACTGCACTCTAGCTGGGGCAACAGAGTGAGACTCTGTCTGAGGAAAAACCAAAACCAAAA","TAGCCCAGCACGGTGGCTCACACCTGTAGTCTCAGCTACTCAAGAGGCTGAGGCATGAGAATCGCTTGAACCCAGGAGGTAGAGGTTGCAGTGAGCTGAGATCATGCCACTGCGCTCCAGCCTGGGCAACAGAGTGAGACTCAGTCTCAAAAAACAAAACAAAACAAAAAA"
"GL873592","2520661","2520705","chr16","66853217","66853257","11","64332556","TCTGGGAGGCTGAGGCGGGTGGATCACCTGAGCAAGAGTGAGACC","TTTGGGAGGCTGAGGCAGGTGGATCACTTGAGGTCAGGAGT"
"GL873592","4535248","4535388","chr1","12240468","12240612","38","7705220","GGCGGGATGTGGTGGTTCATGGCTGTAATCCCAGCACTCAGGGAGGCTGAGTCGGGTGGATTGCTTGAGTTCAGGAGTTTGAGACCAACCTGAGCAAGAACTAAGCCTGTCTCTACTAAAGATATTATTTCTTATTTTTCT","GGCCGGGCGCGGTGGCTCATGCCTGTAATCCCAGCACTTTGGGAGGCTGAGGCGGGTGGATCACCTGCGGTCAGGAGTTCGAGACCAGCCTGGCCAACGTGGTGAAACCTCATCTCTACTAAAAATATAAAAATTAGCTGGTGTG"
"GL873592","4535654","4535831","chr8","126054004","126054184","54","121518350","TCTACTACAAATATTAACAGAAAAATTAGCTGGGCATTGTGACAGGTGCCTATAGTCCCAGATACTCAGAAGGCTGAAGTAAGAGGATCACTTGAACCCCAGGAGCTAAGGTGGCTGTGAGCTAGGCTGAGGCTCTAGCCTGGGTAACAGAGTGAGACTGTAAAAAAAGAAAGAGAGA","GTCTCTACTAAAAATACAAAAATTAGCTGGGTGTGGTGGTGCATGCCTGTAATCCCAGCTACTCAGGAGGCTGAGGCAGGAGAATCGCTTGAACCCAGGAGGTAGAGGTTGCAGTGAGCCAAGATCATGCCACTGCACTCCAGCCTGGGTGACAGAGGGAGACTCTGTCTCAATAAATAAA"
"GL873592","6794968","6795049","chr3","154764711","154764794","20","147969743","GAAGGTTTGATGAGCTCAGATGATGCCACTGCAGTCTACCCAGAGTGAAGGAGCGAGACTCTGTCTCAAAAACAAAAAAAGA","CAGAGGTTGGCAGTGAGCTGAGACTGTGCCACTGCACTCCAGCCGGGTGACAGAGTGAGACTCTGTCTCAAATTACAAACAAAA"
"GL873592","6881384","6881478","chr5","24882384","24882475","28","18001000","GGGCAGGCATAGTGACTGGTGTCTCTAATCCTAGCAGTCTGGGATGCTGAGGCAAGTGGAATGTCAGAGTTCAGGAGTTGAAGATCACCCTGACT","GGCCGGGCGCAGTGGCTCACATCTATAATCCTAGCATTTTGGGAGGCTGAGGCAGGCGGATCACCTGAAGTCAGGAGTTTAAGACCAGCCTG"
"GL873592","6881755","6881937","chr10","61601371","61601572","66","54719616","TCACCCTGACCAAGAGCAAGACCCTGTCTCTACTAAAAATAGAATAAACTAGCTGGGAATTGTGGTGGGTGCCAGTAGTCCCCGCTACTGAGGCAGGAGGATCATTGAGTCCAAGAGTTTGAGGTTGCTGTAAGTTAGGACACCACAGCACTCTACACAGAGTAAGACTGCCTCAAAAATAAA","AGTAAAGAAAAGAAACCCTGTCTCTACTAAAAATACAAAAATTAGCTGGGTGTGGTGGTGCGCACCTGTAGTCCCAGCTACTTGGGAGGGTGAGGTATGGGAATCACTTGAACCCGGGAGGTGGAGGTTGCAGTGAGCCAAGATCACACCACTGCACTCCAGCCTGGGTGAGAGAGTGAGACTCTGTCTCAAGAAAAAAGAA"
"GL873592","7006080","7006155","chr1","8947061","8947129","24","1940981","CACACTGAGAGGCAAAGGCTGGTGGATCACCTGAGCTCAAGAGTTTGAGACCAGCCAAGCCAGAGATCTTGTCTCT","CACTTTGGAGCCAGGTAGGTGATCACCTGAGTCAGGAGTTCGAGACAGCCTGGCCAACATGTGAAACCC"
"GL873592","8446508","8446655","chr11","122502739","122502874","48","114056231","TTAGCTGGGTGTTGTGGCAGGCACCTGTAGTCCCTCCCAGCTACTTGAAAGGCTGAGGCAAGATGACAGCTTAAACCCAAGAGTTTAAGGTTACTCTATTCAGGGCAACAGAGTGAGACTCCATCTACATAAATAAATAAATAAATAA","GGCTGGGCGTGGTGGTTCACACCTGTAATCCCAACACTTTGGGAGGCTGAGGCCAGCGGATTGCCTGAGCCCAGGAGTTTGAGACCAACCTGGGCAACATGGTGAAACTCCATCTCTACTAAAATACAAAAAGTTA"
"GL873592","8446953","8447008","chr16","44513352","44513404","15","36066399","GACCAGCCTAAGCAAAAAAGAGATCCTATCTCTACTACTAAAAATAGAAAAAATTA","ACCAGCCTCACCAATATGAAGAAACCCCATCTCTACTAAAAATACAAAATATT"
"GL873592","8447239","8447325","chr1","8062863","8062957","21","384376","GGCCAGGAGCAGTGACTCATGCCTAGCACTCTGGGAGGCCAAAGCAGGTGGATCAACTGAGCTCAGGAGTTCAAGACCAGCCTAAGC","GGCCGGGTGCAGTGGCTCATGCCTGTAGTCCCAGGACTTTGGCAGGCCAAGGCCGGTGGATTACCTGAGGTCAGGAGTTCAAAACCAGCCTAGCC"
"GL873592","8723925","8724000","chr3","42066983","42067054","20","33343058","AATTAGCCGGGCATGGTAGTGTGTGCCCATAATCTCAGCTACTCAGAAAGCTAAGATAGGAAAATTGCTTGAGCTC","TTAGCTGGGTGTGGTAGTGCATGCCTATAATCCCAGCTACTCGGGAGGCTGAGGTGGGAGAACTGCTTGAAC"
"GL873593","384022","384146","chr15","102382935","102383070","28","101998913","GGCCACGAGGGCCCATGCCTGTAATCCTAGCACTCTGGGAGGCTGAGGTGAGTAGATTGCTGAGCTCAGGAGTTCAAGACCAGCCTGTGCAAGAGACCCCATCTCTGCTAAAAATAGAAAAACCA","GGCCAGGTGTGGTGGCTCACGCCTGTAATCCTAGCACTTTGGGAGGCTGAGGCGGGTGGATTGCCTGAACTCAGGAGGTCAAGACCAGCCTGGGCAACACAGTAAAACCCCATCTCTACTAAAATACAAAAAATCA"
"GL873593","384425","384607","chr20","28286874","28287058","50","27902449","GAAAGAAAAGAAAAGAAAAACTAGCAAGATGTTGTAGCTGATGCCTATAATCCTAGCTATTGGAGAGGTGGAGGCAAGAGAATTGCGTGAGCCCAAGAGTTGAAGGTTGCTGTGAGCTGCGATGCCAGAGCACTCCAGGGTGACAGAGTAAGACTCTGTCTCAAAAAAAATTACAAAATAAAA","TAATAAAAATAAAAAAATTAGCCAGGAGTCAAAGCACACGCCTATAACCCCAGCTACTTGGGAGGCTGAGGGAGGAGAATTACTTGAACCCGGGAGGTGAAAGTTGCAATGAGCTGAGATCAAGCCACTGCACTCCAGACTGGATGACAGAGTGAGACTCTGTTTCAAAAAAAAAAAAAAGACAA"
"GL873593","1408445","1408467","chr10","88070368","88070389","9","86661923","AATCTAGAGATGGGGAGAGGTTG","AAAGAGATGGAAGAGAAGAAGA"
"GL873593","4856365","4856484","chr7","56497314","56497433","31","51640949","GCAATCCCAGCTGATCGGGAGGCTGACCCAGAAGAATCCCTTGAACCCAAGAGTCTGAGGTTGCTATGGGTGGATTCTACAGCACTCTAGCCTGGGAGACAGAGTGAGACTCTGTCCCAA","ATCCCAGCTACTTGGGAGGCTGAGACAGAAGAATTGCTTGAACCCGGGAGGTGGAGGTTGCAGTGAGCCAAGATTGTACCACTGCACTCCAGCCTGGCAACAGAGTGAGACTCTGTCTCA"
"GL873593","6661298","6661485","chr10","86749316","86749514","55","80088018","GCAGAGGCTCACATATGTAATCCTAGCACTCTGGGAGGATAAGGCAGGTGGACAGCTTGAGCTCAGGGGTTTGACCAGTCTGATCAAGAGCAAGACCTGTGTCTACTAAAAATAGAAAACCTAGCCAGGTATGATGGTAGATGCCTGTATTCCTAGCTACTCTGGAAGCTAAAGCTAAAGAGTTTGAA","GGTGGCTCACACCTGTAATCTTAGCAATTTGGGAGGCCGAGGTGGGTGGATCACTTGAGGTCAGGAGTTTGAGACCAGACTGGCCAACATGGTGAAACTCTGTCTCTACTAAAAATACAAAAATTAGCCAGTCATGGTGGTGCATGCCTGTAATCCCAGCTACTCAGGAAGCTTAGGCAGGAGAATCACTTGAACCCAG"
"GL873593","6710263","6710446","chr14","4390080","4390244","66","2320183","TTGAAGTCAGGAGTTTAAGGCCAGTCTGGGCAACATAGTGAGACCCCCATCTCTACGAAAATATTTTTTAAAAATTAAAAATAGCTGGGCATAGTGAGGCTGTTGTGAGCTATAACTGCACCACTGCACTCAGCCAAGGACAGAGACCCTGTTCCCTGCCTCAAACAAACCAAAACAAAACAAA","AAGTCTAGAGTTTACAGCCTGGACAACGCAGTGAAACCCTGTCTCTACCAAAAATACAAAAATTAGACAGGTGTGAGAGGCGGAGGTTGCAATGAGCTGAGATCGCAGCACTGCAGTCCAGCCTGGATGACAGAGCGAGACCCCATCTCAAAAACAAAAACAAAA"
"GL873593","7159645","7159716","chr6","178318394","178318465","21","171158749","GATCATGTCACTGCTCTCCAACCTGGGCAATTGAGCAGGAATCTGTCTCAAAAAGAAAAAAAAAAAAGAAAA","CGAGTTCACACCACTGCACCCCAGCCTGGGCAACAGAATGAGACTCGGTTTCAAAAAAAAAAAAAAAAAAAA"
"GL873593","7159841","7160050","chr13","33368171","33368368","69","26208330","GGCCAGGCGTGGTGGCTCACACCTGTTGTCCCAGTGCTGTGGGAAGCCGAGGCAGGTGGATCACCTGAGCTCAGCCGAGTTCGAGACCAGTGGAAGACCAGCATGAGGCAGAGTGAGCCAGAGTGAGACCCCATCTCTACAACAACAACAAGAAGAAAAAAAACAGCCGGACCTTGTGATCCCAGCTACGTGGGGAGCTAGAGAATCACT","GGCTAGGCATGGTGGCTCATGCCAGTAATCCCACCACTTTGGGAGGCCGAGGCAGGTGGATCACCTGAGGTCAGGAGTTCAAGACCAGGCTGGCCAACATGTTATGATGAGACCCTCATCTCTACTACAAATACAAAAATCAGCTGGGCATGGTGGCAAGTGCCTGTAATCCCAGCTACTTGGGAGGCTGAGGCAGAA"
"GL873593","8598292","8598391","chr11","118461023","118461129","33","109862731","AGCCAGGTGAGGTGGTTCACACCTGTAACCCTAGCTGCTTGGGAGGCTGAGGCCTCTCTATCCTGGGCAGTGTGGAGAAACTTTGTTTCAAAAAAAAGAA","GCCGGGCGCGGTGGCTCACGTCTGTAATCCCAGCGCTTTGGGAAGCCGAGGCGGGACTATCCTGGCCAACATGGTGAAACCCCGTCTCTACTAAAAATACAAGAATC"
"GL873594","357249","357377","chr2","75702890","75703011","36","75345641","CCTGGTACCGTAGGTCATGCCTGTAATCCTAGCACTTTGGGATGCTGAGGTGGGCAGATTGCCTGAGCTCACGAGTTCAAGCCATTAGAACTGAGCCTGACCTAGAGTGGGACCTCCAACTCTTTTTTT","GCCAGGCACAGTGGCTCATGCCTGTAATCCCAGCAGTTTGGGAGGCTGAGGTGGGCAGATCACTTGAGGTCAGGAGTTCAAGACCAGCCTGGCTGACATGGTGAAACCCCATCTATACCAAA"
"GL873594","357656","357834","chr7","17608776","17608965","55","17251120","GGGACCTCCAACTCTTAAAATAGCTGGGCATTGTGGTGGGCACCTACAGTCACAGCTACTTGGGAGGCTAAGGCAAGAGACTTGTTTGCAGCCAAGAGTTAGAGGTTGCTGTGAGCTATGAGGCTAGGGCACTCTACAGGGGGCGACAAGTGAGACTGTAAAAAAAAAAAAAGAAAAAA","GTCCCTACTAAAAATACAAAAAATTAGCTGGGCCTGGTGGCAGGCACCTGTAATCCCAGCTACTTGGGAAGCTGAGGCAAGAGAATTGCTTGAACCCAGGAGGCAGAGGTTGCAGTGAGCTGACATCAAGCCACTGTACTCCAGCCTAGGCAACAAGAGCAAGACTCTGTCTCAAAAAAAAAAAAAAAAA"
"GL873594","1410711","1410996","chr5","151340503","151340797","76","149929792","CACAGTGGCTCATACCTATAATCCTAACACTCTGGGAGGCCAAGGTGGGTGGACTGTCTGAGTTTGGGACCAGCCTGAGCAAAAGCAAGACTCCCATCTCTACTAAAAACAAAGACAGCCAGGTATGAGGGCAGGTGCCTATCATCCCAGCTACTTGGGAGGCTGAGGAAGGAGGATCACCTAAGCCCAGGACTTTAAGGTTTCTGTGAACTAAGATGATGTTACAACACTCTAGCCAGGGTAACAAGGCAAGATTCTGTTTCAAAAGACAAAAAAAAAAAAAAAA","GGTGGTTCATGCCTGTAATCCCAGCACTTTGGGAGGCTGAGGCAGGTGGATCACCTGAGGTCAGGAGTTCGGGACCAGCCTGGCCAACATGGGGAAACCCCATCTCTACTAAAATACAAAAATTAGCCAGGTATGGTGGCACATGCCTATAATCCCAGCTACTTGGGAGGCTGAGGCAGGAGAATCACTTGAACCCAGGAGGCTAAGGTTGCAGTGAGCCGAGATTGTGCCACTGTACTCCAGCCTGGGTGACAGACTGAAACTCTGTGTCCAAAAAACAAAACAAAACAAAAAA"
"GL873594","5528090","5528162","chr2","69013639","69013718","24","63485549","GGTACAGTGGCTCACGCTTGTGATCCCAGGTTGAGGTGGGTGGATCGCCTGAGCTCAGGAGTTGGATGCCAGC","GGTGTGGTGCCTCACGCCTATAATCCCAGCACTTTGGGAGGCAGGTGGATCACTTGAGGTCAGGAGTTTGAGAACAGCCT"
"GL873594","5834047","5834168","chr2","82491537","82491662","28","76657490","GGCTGGGCCCAGTAGCTCACGACTGTAATCCCAGCACTCTGGGAAGCTGAGGTGGGCGGATCACCTGAGCTCATAGGTTCGAGACCAGCTCCAGTTAGAGTGAGAGCCTGTCTCTAAAAATA","GGCTGGGCACAGTGGCTCATGCCTGCAATCCCAGCACTTTGGGAGGCTGAGGTGGGCAGATCACCTGAAGTCAGGAGTTCAAGACCAGCCTGGCCAACACAGTGAAACCCCATCTCTACTAAAAAT"
"GL873594","5834396","5834461","chr13","14688151","14688212","20","8853755","TATATAATAATAATAACCAGGTATTGTGGCAGGTGCCTCTAGTCCCAGCTACTCGGGAGGCAAAGG","ATAAAAAAATTAGCTGGCCATGGTGGCACATACCAATAATCCCAGCTACTCAGGAGGCTGAG"
"GL873594","7786130","7786294","chr14","12217087","12217250","37","4430957","GGGTGTGCTGGCTCATACCTATAATCCTAGCACTCTGGGAGGCTGAGGTAGGTGTATTGCTTGAACCCAGGAGTCTGAGGTTGCTGTGCGCTAAGCTGATACCATAGCACTCTAGCCTGGGCAACAGAGTGAGACTCTGTCTCAAAACAAATAAATAGTAAAAAA","GCTGGGCGTGGTGGCTCACACCTGTAATCCCAGCACTTTGGGAGGCCAAGGCATGAGAATTGCTTGAAAACAGGAGGCGGAGGTTGCAGTAAGCTGAGACTGTGCCATTGCACTCCAGCCTGGGCAACAAGAGTGAAACTCTGTCTCAGAAAAAAAGAAAAAAA"
"GL873595","723579","723774","chr19","6045933","6046125","65","5322354","GCCTGAGCAGGAGAGAGACCCCATCTCTGCTGAAAGTGGAAAAGTTGGCTGAGTGTAGTGGCGGGCTGCTGCCCCAGTCACTCAGGAGGCTTAGGAAGGAGTATCGCTTGGGCCCAAGATTTGAGGTTGCTGTGAGCGCTACAAAGACATTAGGGTACTCTACACAGGGGAATAGAGTGAGACTGTCTCAAAAAAA","CAACATGGAGAAACCCCGTCTCTACTAAAAATACAAAATTAGGCAGCGTGGTGGTGGGTGCCTATAATCCCAGCTACTCAGGAGGCTGAGGCAGGAGAATCGCTTGACCGGGAGTGGAGGTTGCGGTGAGCTGAGATTGCACCATTGCACTCCAGCCTGGGCAACAAGAGTGAAACTCCGTCTCAAAAAGAAA"
"GL873595","724114","724204","chr20","18199749","18199840","22","17475635","GGCCATGCTTGGTGGTTCTCATCTGTAATCCTAGCACTCTGGAAGGTCTACAGGGGTGGATGGCTGGAGGTCAGGAGTTCAAGACTGGCCT","GGCCGGGCATGGTGGCTCACACCTGTAATCCCAGCACTTTGGGAGGCTGAGGCAGGCGGATCACCTGAGGTCAGGAGTTCGAGACCGGCCTG"
"GL873595","1065346","1065667","chr18","10529729","10530057","74","9464383","GGCCAGGTGCAGCAGCTCATGCCTGGAATCTTCCTGCTCTGTATGGCCAAGGCAGGTGGATCGCCTGACCTCAGGAGTTCCAGACCAGCCTGAACAAGAGCAAGACTCTGTCTCTACTAAAAGTAGAAAAAAAACTAGCCAGTCATAGTGGCAGGTGCCTGTAGTCCCAGCTGCTTGGGAGGCTGAGGCAAGAGGATCACTTGAACCTAAGAGTTTGAGGTTGCTGTGAGCTAAGATGCCACATCACTCTATCAAGGGTGACCAAGTGAGACTCTGTCTCAAAAATAAATAAATAAATAAATAAAAAGAAAGGCAAAAAGAA","GGCCCGGCGTGGTGGCTCATGCCTATAATCCCAGCCCTTTGGGAGGCCAAGGCAGGTGGATCACCTGAGGTCAGGCGTTCGAGACCAGCCTGACCAACGTGGTGAAACCTCATCTCTACTAAATACAAAAAAAATTTAGCCAGGCATGGAGGCACATGCCTGTAATCCCAGCTACTTGGGAGGCTGTGGCAGGAGAATCACTTGAACCTGGGAGGTGGAAGTTGCAGTGAGCTGAGATTGTACCACTGCACTCCAACCTGGGTGACAAAGCAAGACTCGGTCTCAATAAATAAATAAATAAATAAATAAATAAATAAAGTGAAAAAAAA"
"GL873595","1254878","1255146","chr4","42822326","42822607","67","41567448","GGCTGGGCATGGTGGCTCATGCCTGTAATCCTACCGCTCTGGGAGGCTGAGGCAGAGGATCACTTGAGCTCAGGAGTTTCAGACCAGCCTGCAAGAAGGACCCAGTCTCTGCCGAAAATAGAAAAGTTAGCAAGGCGTTGTCGTGAGCACATGTATCCCAGCTACCTAGAACTCTGAGGCAGGAGGATCCCTTGAACCCACAGAAGTTGCTGTTATCTAAACTGATGCCACTGGACTCTAGCCTGGGCAACAGAGTGAGACTGGTCTCA","GGCCGGGCACGGTGGCTCATGCCTGTAATCCTAGCATTTTGGGAGGCTGAGACAGGCAGATTGCCTGAGCTCAGGAGTTCAAGACCAGCCTGGGCTAGATTGTGAAACCCCATCTCTACTAAAATATAAAAATTAGCTGGGTGTGGTGGCACACGCCTGTAATCCCAGCTACCTGGGAGGCTGAGGCAGGAGAATCGCTTGAACCAGGAGACAGAGGTTGCAGTGAGCTGAGATCACGCCACTGCACTTTAGCCTGGGCAACAGAGTGATACTCTGTCTCAA"
"GL873595","3417105","3417297","chr12","115674238","115674427","44","112257133","GGCCGGGCGCTGTGCCTCACGCCTGTAATCCTAATACTCTGAGAGGCCGAGGCAGGTGGATTGCCTGAGCTCAGGTGCTCAAGACAGCCTGACTGAGCAAGCCCTGAGATCCCATCTCCACTAACAATAGTAAAACTAGCCGGGCATTGTGGTGGTGCTTGTAATCCCAGCTACTGGGAGGCTAAGACAGGAG","CCAGGCCTGGTGGCTCACGCCTGTAATCCCAGCACTTTGGGAGGCCGAGGTGGGTAGATCACCTGAGGTCAGGAGTTCAAGACCAGCCTGGCCAACATGGCGAAACCCCATCTCTACTAAAAATACAAAAATTAGCTGGGCATGGTGGTGTATGCCTGTAATCCCAGCTACTCGGGAGGCTGAGGCAGGA"
"GL873595","6098380","6098457","chr3","87492619","87492702","21","81394239","GCTGTGGCTCATGCTGATAATACCAGCACTCTGGGAGAACAAGGTAGGCAGATCACAAGAGGTCACCTGTGCAAGACC","GGGCTGGTGGTGGCTCATGCCTGTAATACCAGCACTTTGGGAGGCCAAGACAGGTGGATCACCAAAGGTCAAGAGTTCAAGACC"
"GL873596","134190","134307","chr1","203207333","203207443","31","203073143","GGCTGGGCGAGGTGGCTCACACCTGTAATCCTAGCACTCTGGAAGGCCCTAGCACTCAGGCAGTTGGATTGCCTGAGCTCACAAGTTCAAGACCAGCCTGAAAAAGAGCAAGACCTCA","GGCTGGGTGCAGTGGCTCACACCTGTAATCCCAGCACTTTGGGAGGCCGAGATGGGTGGATCACTTGAGGTCAAGAGTTGAAGACCAGCCTGGACAACATGATGAGACCCC"
"GL873596","134578","134681","chr11","50235285","50235387","37","50100707","CAAACAAAAGAGGAAGACCTCGTCTCTAAAAAAATAGCTGGGCATTGTGAGGAGTACCTGTAGTCCTAGCTACTCAGAAGGCTGAGACAAGAGAATCACTTAAA","CAACATTGTGAAACCCTGTCTCTACTAAAATAGAAAATTAGCCAGGTGTGTGGGCGTGCCTATAATCCTAGCTACTGGGGAGGGTGAGGCATGAGAATCGCCT"
"GL873596","8160215","8160350","chr1","29437872","29437991","30","21277657","GGCCGGGCGTGGTGGCGCACACCTGTAGTCCCAGCGCTATGGGAGGCCGAGGCGGGTGGATCACCTGAGCTCAGAGGTTCGAGACCAGCCAAGACCCCCCTGAGCCAAACGAGCCAGAGTGAGACCCCGTCTCTAC","GGCCGGGCGTGGTGGCTCACGCCTGTAATCCCAACATTTTGGGAGGCCAAGGCGGGTGGATCACCTGAGGTCAGAAGTTCGAGACCAACCTGGCCAACATGGTGAAACCCCTGTCTCTAC"
"GL873596","8421071","8421132","chr20","1874027","1874093","12","6547044","GTCAGGCGCAGTGGCTCACGCCTGTAATCTCAGCACTCTGAGAAGCCAAGGCAGGATCATCT","GGCCAGGCGCAGTGGCTCAGGCCTGTAATCCCAGCACTTTGGGAAGCCAAGGTGAGCAGATCACCTG"
"GL873598","4416400","4416489","chr5","39418145","39418231","15","35001745","GGCCAAGTGTGGTGGCTCATGCCTGTTGTCCCAGCACCGTGGGAGGCCGAGGCTGGTGGAACACCTGAGCTCAGCTGAGTTTGAGACCAG","GGCCAGTTGCGGTGGCTCATGCCTGTAATCCCAGCACTTTGGCAGGCTGAGGCAGGTGGATCACCTGAGGTCAGGAGTTTGAGACCA"
"GL873598","4416855","4416947","chr3","94091253","94091337","31","89674398","GTGAGACCCTGTCTCTACAAAAAAAAAAGCTGGGCACTGTGGCATGTGCCTGTAATCCCAGCTACTTGGGAGGCAAAGGGAAAGAGAATCACT","AAACCTTGCCTTTACTAGAAATACAAAAATTAGCTGGGCATGGTGGCAGGTACCTGTAATCCCAGCTACTTGGGAGGCTGAGGCA"
"GL873598","5126074","5126161","chr1","12339306","12339394","19","7213232","GCCTGGTGCACTGGTTCACACCTGGAATCCTTGCATTCTGAGAGGCCCAGGTAGGCAGATCACCTCAGCTCAGAAGTTCGAGACCAGC","GCTGGGTGCGGTGGTTCACGTCTGTAATCCCAGCACTTTGGGAGGCCGAGGCGGGCAGATCACCTGAGGTCAGGAGTTCGAGACCAGCC"
"GL873598","5467584","5467662","chr1","9313328","9313403","17","3845744","GCGAGGTGGCTCACGCCTGTAATCCCAGCACATTTGGAAGGCCAAGGAGGGTGGATCACCCGAGCTCACCAGTTGGAGA","CGCAGTGGCTCACGCCTGTAATCCCAGCACTTTGGGAGGCCGAGGCAGGCAGATCACCTGAAGTCAGGAGTTTGAG"
"GL873598","6917752","6917856","chr14","9558287","9558382","22","2640535","GGCCAGGCATGGTGGCTTGTGCCTGTTGTCCCAGCACTGTGGAAGGCCGAGGCGGGTGGATCGCCTGAGCTCAGCTGAATTCGAGACCAGCATAAGACCAGTATG","GGCCAGGCATGGTGGCTTATGCCTGTAATCCCAGCACCTTGGAAGGCCGAAGCGGGCAGATCACCTGAGCTCAGGAGTTTGAGACCAGCCTGTCCA"
"GL873598","8078910","8079062","chr7","164825511","164825660","43","156746601","AACAGCCAGGCATTGTGGTGGGCACCTGTAATCCCAGCTACTTGGGAGGCTGAGGCAAGAGAATTGCTTGAGCCCAACAGTCTCAGGTTACTGTGAGTTATGACACCATGGCACTCTATTGAGGGCAAGAAAGTGAGACTGTCTTGGAAAAAA","CTAGCCAGGCATGGTGGTGCGCACCTGTAGTCCCAGTTACTTGGGAGGTTGAGGCAAGAGAATTGCTTGAGCCTGGAAGGCAGAAGTTGCAGTGAGCTGAGATCACACCACTGCATTCCAGCCTGGGCGAAAGAGCAAGACTCTGTTGAA"
"GL873598","8079328","8079454","chr6","10381248","10381379","32","2301920","GCCCGGCGTGGTGGCTCACGCCTGTAATTCCAGCACTCTGGGGAGGCCGAGGAGGGCAGATTGCCTGAGCTCACAGGTTTGAGCTAGAGCGAGACCCTGTCTCTTAAAAAGAAAAAAAAGGAAAGAA","GCTGGGCGCGGTGGCTCACGCCTGTAATCCCAACACTTTGGGAGGCCGAGGCGGGCAGATCACCAGAGGTGATCTCCAGCCTGGGCAGGAGAGCAAGACCCTGTCTCAAAAAATTTAGAAAAAGGAAAGAAA"
"GL873599","3943256","3943456","chr9","35892110","35892312","79","31948854","GGCAGGCTGCTTTGACCCATATCTACAACTCCAGAACTTTAGAGGCTGAGCTGGGTGGGTCCCTTGAGATTAGAAACTGCTTAGTAGCCTGGCAAAAACCAGACCCCACCTCCACCATGTAGAAAAATTAGCAGTATGCCATAGTGGGAACCTACCAATACAGTCTTTCCAAAGGCCAAAGCTAGAAGGACCGTGAGCTTG","GGCTGGGTGTGGTGGCTCATGCCTATAATTCCAGCACTTTGGGAGGCCGAGGCAGGTGGATCACCTGAGGCCAGGAGTTTGAGACCAGCCTGGCCAATATGGTGAAACCCCATCTCTACTAAAAGTACAGAAAATTAGTCAGTCATGATGGCGCATGCCTATAATCCCAGTTACTCGGGAGGCTAAGGTAGGAGAATTGCTTG"
"GL873599","6693284","6693349","chr1","100916857","100916922","15","94223573","TCACGTCTATAATCCTAGCACTCTGGGAGTCCTTGGCAGGTGGATCACCTGAGCTCAGGAGTTTGA","CATGCCTGTAATCCCAGCACCTTGGGAGGCCAAGGTGGGTGGATCACCTGAGGTCAGTAGTTTGAG"
"GL873600","991618","991705","chr15","13850109","13850195","15","12858491","GGCTGGGCGTGGTGGCTCACACCTGTTGTCCCAGCGCTGTGGGAGGCTGAGGCAGGTGGATCACCTGTGCTCAGAGGTTGAGACCAGC","GCCGGGCGCTGTGGCTCACACTTGTAATCCCAGCACTTTGGGAGGCTGAGGCAGGTGGATCACCTGAGGTCAGGAGTTAGAGACCAG"
"GL873600","8825981","8826014","chr16","43605817","43605844","11","34779836","AGTCTGGGGCAACAGAGCAAGACTCTGTCTCAAA","CAGTCTGGGTGACAGAGCAAGATTCCAT"
"GL873600","8826039","8826157","chr13","87428402","87428520","35","78602363","ATTAGCCTGGTGTGGTGGTATATGCCTTCCTGCCTGCTTGGGAGGCTGAGGCAGGAAGTATGCTTTAACTGTGGAGTCTGAGGTTGCTATGAGCTAGGTTGAGGCCATGGCACTCTAAA","TTAGCCGGGTGTGGTGGTGCACGCCTGTAATCCCAGCTACTCAGGAGGCTGAAGCAGGAGAGTTGCTTGAACCCAGGAGTTGGAGGTTGCAGTGAGCTGAGATCACGCCATTGCACTCC"
"GL873601","269289","269338","chr14","49279240","49279285","14","49009951","GACTGGGTGTGGTGGCTCACACCTTTAATCCTAACACCCTGGGAGGCTTA","GGCTGAGATGGTGGCACACACCTGTAATCCCAGCTACTTGGGAGGC"
"GL873601","269431","269678","chr1","184453273","184453521","76","184183842","AGAAGATCACTCAAGATCAGGAGTTTGAGAACAGCCTGAGCAAGACCCCCATCTTTACTAAAAATGGAAAAGTTTTTACCCAGGCATGGTAGTGCGTGCCTGTATCCCATCTACTCCGGAGGCTGATAGGAGGATTGCTTCAACCAAGGAGTTTGAGGTTCCAGAGACTTAAGATGACACAACTGCATTTTACCCAGTGTGACACAGCGAGACTCTTTCAGAAGAATTTTTAAAAGGAAAAAAAAGAA","GGTCAGATCACCTGAGGTCAGGAGTTTGAGACCAGCCTGACCAACATGGTAAAACCCCATCTCTGCTAAAAATACAAAAAATTAGCCAGGCATGGTGGTGAACGCCTGTAATCCTAGCTACTCAGGAGGCAAAGACAGGAGAATCGCTTGAATCTGGAAGGTGGAGGTTGCAATGAGCCAAGATGACGCCACTGCACTCCAACCTGGGTGACAGAGGAAGACTCCATCAAAAAAAAAAAAAAAAAAAAA"
"GL873601","1397978","1398117","chr16","24839455","24839591","34","23441477","GCCTATAATCCTAGCACTCTGGAAGGCTGAGGCAGGAAGATCACTAGAGCTTGGGAGTTTGAGATTGCTGTGAGGGAGACTGACTCCATGGCACTCTAGCCTGAGGCAACAGAGTAAGACTCCATCTCAAAAAAAAAAAA","CTCTAACTCCAGCTACTCAGGAGGCTGAAGCAGGAAAATCACTTGAACCTGGGAGGTGGAGGTTACAGTGAGCCAAGATCACACCATTGCACTCCAGCCTGAGCGACAGAGCGAGACTCTGTCTCAAAATAAATAAA"
"GL873601","4065502","4065590","chr11","108711352","108711444","19","104645850","GCTGGATGTGGTGGCTCTCACCTATAATCCTAGCACTCTGGGAGGTCAAAACAGGTGGATCACCTGAGCTCAGGAGCAAGAACACCAGC","GTCAGGGGTGGTGGCTCACGCCTGTAATCCCAGCACTTTGGGAGGCCAAGGCAGGTGGATCGCCTGAGCTCAGGAGTTCAAGACCAGCCTTGC"
"GL873601","8241370","8241465","chrY","9469734","9469829","34","1228364","AAAAAAGGTGGAGATGAGCCATGCGCAGTGGTGTAGGCCTGTAATCCCAGCCCTTGGGAGGCCAAAATGGTGGATTGCCTGAAGCAGAGCAAGACC","AAAGTACAAAGAGTCTGGGTACAGTGGCCCAAGCCTGTAATCCCAGCAGTTTGGGAGGACAAGATGGGTAGATCACCTGACATCATGAATTAGAGA"
"GL873569","7519122","7519191","chrX","79016364","79016431","16","71497242","TTGGCCAGGCATGGTCGCTCAGGCTGTAATACCAGCTACTTGGGAAGCTGAAGCAGGAGGATCACTTGAA","TTGGCCAGGCACGGTGGCTCATGCTTATAATCCCAGCTACTCGTGAGGCTGAGGCAGGGGAATCGCTT"
"GL873569","7989158","7989286","chr8","41505677","41505810","35","33516519","AGTCCCACCTATTTGGAAGGCTGAGGCAAGAGGATCACTTGAACTCAGCAGTTTGACATTGCTATGAGTTAGATTGACTCCATGGCACTCTAGCCCAGGCAACAGAGCAAGACTCCGTCTCAAAACAAA","TAATACCAGCTACGTGGGAGGCTGAGGCAGGAGAATCACTTGAACCCGGGAGGTGGAGGTTGCAGTGAGCTGAGATTGCACCGTTGCACTCTAACCTGGGCAACAAAAGCAAAACTCTGTCTCAAAAAAAAAAA"
"GL873569","7989575","7989702","chr1","62231025","62231129","47","54241450","GGCTGGGTAATGCAGTGGCTCACGCCTATAATCCTAGTGCTTTGAGAGGCCAAGAGTGAGACTCTGTGTACTAAAAATAGAAAAATTACCTAGGCATTCTGGTGGGCACCAGTAGTCCCACCTATTTG","GGCTGGGCATGGTGGCTCACGCCTATAATCCCAGCACTTTGGGAGGCCGAGGCAGGTGGATCACCTGAGATCAGGAGTTTGAGACCAGACTGGCCAACATGGTGA"
"GL873569","10034363","10034556","chr10","61268396","61268605","62","51234033","CAGCTTGAGCAAAAGTGAGCCCCTGTCTCTACTGAAAATAGAAAAAATTAGCCAGGCGTGGTGGCACACACTTATAGTCCCAGCCACTTAGGAGGCTGAGGCAGGAGTTTGAGGTTGACATAATCTAAGCTGATACCATAGCACTCTAGCCTGGGCAATAGAGTGAGACTCTGTCTCAAAGAAGAAATTTATCT","CCTGACCAATGGTGAAACCCTGTCTCTACCAAAAATACAAAATTTAGCTGGGCATGGGGGCACGCACCTGTAGTCCTAGCTACTCGGGAGGCTGAGACAGGAGAACTGCTTGAACTCGGGAGGCAGAGGTTGCAGTGAGCTGAGATCATGCCACTGCACTCTAGCCTGGGCAATAGAGTGAGACTCCGTCTCAAAAAAAAAAAAAAAAAA"
"GL873569","10034830","10034845","chr1","217667782","217667796","2","207632952","AAAAAAGAAGAAAAAA","AAGAAAAAGAAAAAA"
"GL873569","10203815","10203922","chr8","96374555","96374671","35","86170740","GCCAGGTGTAGTGGTTCACACCTATAATCCTAGCACTCTGGGAGCCTGAAGCAGGTAAATGGACTGAGCAAGAGTGAGACTTCCACCTCTATTGAAAATAGAAAAATT","GGCTAGGTATGGTGGCTGATGCCTATAATCCCAGAATTTTGGGAGGCCGAGGCAGGCAGATCATCTGAGGTCAGGAGTTTGAGACCAGTCCCGTCTCTACTAAAAATACAAAAATTA"
"GL873569","10204196","10204373","chr20","1304385","1304559","47","8899811","GAAAATAGAAAAATTAGCCAGGCATTATAGCAGGCACCAGTAATCCCAGTTACTTGGGAGGCTAAGGCAAAAGAATCTCTTGAGCCCAAGTTTGGGGTTGCTAGGAAGTAAAACACCACAGCACTATACCCAGAACAAGAGAGTGAAGACTCAGTCTCAAAAAGATAAATAAATAAAA","AAAAATACAAAAATTAGCCAGGCATGGTGGCGGGCGTCTGTAACTCCAGCTACTTGGGAGACTGAGGCAGGAGAATCGCTTGAACCCAGGAGGCAGAGGTTACAGGTGAAATCACACCACTGCACTCCAGCCTGGGCAACAGGGCAAGACTCTGTCTCAAAAAAAAAAAAAAAAA"
"GL873569","10473375","10473444","chr8","20660648","20660717","21","10187273","TGTAGTCCCAGCACTTTGGGAGGTTAAGGCAAGAGTAGCACCCAACATGAGGAGATCAAGACCAATCTGG","CTGTAGTCCCAGCACTTTGGGAGGCTGAGGCAGGTGGATCCTTTGAGGGCAGAACTTTAAGACCAGCCTG"
"GL873570","9287350","9287485","chr1","29437872","29437991","30","20150522","GGCCGGGCGTGGTGGCGCACGCCTGTAGTCCCAGCGCTATGGGAGGCCGAGGCGGGTGGATCACCTGTGCTCAGAGGTTCGAGACCAGCCAAGACCCCCCTGAGCCAAACGAGCCAGAGTGAGACCCCGTCTCTAC","GGCCGGGCGTGGTGGCTCACGCCTGTAATCCCAACATTTTGGGAGGCCAAGGCGGGTGGATCACCTGAGGTCAGAAGTTCGAGACCAACCTGGCCAACATGGTGAAACCCCTGTCTCTAC"
"GL873571","3669989","3670207","chr4","116777080","116777297","60","113107091","AGACCAGCCTGAGGAAGAGCAAGATCCCATCTCTATTAAAAATAGAAAAATTAGCCAGGCATTCTGGTGGGCACCTGTAGTTCTAACCACCTGGGAGGCTAAGGCAAGAGGAACTCTTCAACCCAAGAGTTTGAGGTTGCTGAGAGCTAGGCTAAGGCTGCAGCACTCTAGCCTGGGCAACAGAGTGAGACTGTTTCTCAAAAACAAAAAACAAAAAAA","CGAGACCAGCCTGGTCAATATGGTGAAACCCCGTCCCTACTAAAAATACAAAAATTAGCCAGGCATGGTGGCAGGCACCTGTAGTCCCAGCTACTCGGAAGGCTGAGGCAGGAGAATCGCTTGAACCACAGAGGCAGAGGTTGCAGTGAGCCGAGACTGCACCACTGCACTCCAGCCTGGGCGACAGAGTGAGACTCAGTCTCAAAAAAAAAAAAAAA"
"GL873571","106134","106236","chr4","18143723","18143826","27","18037589","GGCCAGTCTCAGTGGCTCACACCTGTAATCCAGCATTCTGGGAGGCTGAAGCACACGGTCACCTGAGCTCAAAGGTTGGAGACCAGAGTGAGACCCCACCTCT","GGCCAGGCGCAGTGGCTCACTCCTGTAATCCCAGCACTTTGAGGCTGAGGCAGGCGGATCACCTGAGGTCAGGAGTTTGAGACCAGCCTGGCCGAAACCCCATC"
"GL873571","3670496","3670589","chr7","50468399","50468491","15","46797903","GGGCAGGCATGGTGGCTCACACCTGTAATTCTAGCACTCTTGGAGGCTGAGGCAGGAAAATGGCTTGAGGTCAGGAGTTCAAGACCAGCCTGAG","GGCCAGTCATGGTTGCTCACACCTGTAATACCAGCACTTTGGGAGGCCGAGGCAGGCGAATCACCTGAAGTCAGGAGTTCAAGACCAGCCTGG"
"GL873571","4059090","4059389","chr7","52903696","52903994","88","48844606","GGCCAGGTGCAGTGGTTCACACTTATAATCCTAGCACTCTGGGAGGCCGAGGCGAGTGAAGTGCCTGAGCTCATGGGTTCAAGACCAACCTAAGCCAGAGACCCCTGACTCTTATAATAGCCTGGCATTGTGGTGGGCGCCAATATTTCCAGCTACTCTGAGGCTAAGGCAAGAGAATTGCTTGAGCCCAGGAGTTGGAGGTTTCTGTGAGCACTGACGCCGCAGCTCTCTACCAAGGGCAACAAAGACTCTGTCTCAAAAAATAAATAAATAAATAAATAACAGAATGAAAATGAAAAA","GGCCGGGTGCGGTGGTTCACGCCTGTAATCCCACCACTTTGGGAGGCTGAGGCAGGCAGGTCACCTGAGGTCAGGAGTTCCAGACCAGCCTGGCCAACATGGTGAAACCTTGTCTCGGCTATTAGCCTGGCATGGTGGTGCGTGCCCATAATCCCAGCTACTCAGGAGGCTGAGGCAGGAGAATCGCTTGAACCCAGAAGGTGGAGGTTGCAGTGAGCCAAGATAGCACCACTGCAACTCCAGTCTGGGCAACAGAATGAGACTCTGTCTCAAAAAAAAAAAACAAAAAACAAAAAGAA"
"GL873571","4209418","4209704","chr11","32517699","32517985","80","28308281","GGCTTGGCAAGGTGGCTTACACCTCAAATCCTAGCACTGTGGGAGACTGAGGCAGGTGGATTGTTTGAGCTCAGGAGGTCAAGATAGAGAGCAAGAGCAAGTCTCTGTCTCTACTAAAAATAGAAAAGAACTACTTCCCGGGGGTCATGGCAGTAGCCTGTAATCCCAGTTACTAGGTAGAATGAGGCAAGAGGATCTGTTGAAGCCAAGAGACTGAGGTTGTTATGAGCATGCCACAGCACTCTACCCAGGGTGACAGAATGAGACTCTGTTGAAAGAAAAAAAGA","GGCCGGGTGCAGTGGCTCACACCTGTAATCCCAGCACTTTGGGAGGCTGAGGCGGGTGGATCACCTGAGGTCAGGAGTTCAAGACCAGCCTGACAAACATAGTGAAACCCTGTCTCTACTGAAAATACAAAATTAGCCAGGTGTGGTGGCGCATGCCTGTAATCCCAGCTACTCGGGAGGCTGAGGCAGGAGAATTGCTTGAATCCAGGAGGTGGAGGTTGTGTGATCACACCACTGCACTCCAGCCTGGGCGACAGAGTGAGACTCTGTCTCAAAAAAAAAAGAAA"
"GL873571","4209985","4210154","chr3","175781758","175781928","60","171571773","GAAAGAAATGAAAAGAAAGAAGTTAGCTGGTTGTTGGGGTATGCTTCTATAGTCCCACCTACTCAGAAAGCTGAAATCTGGAGTTTGGGGTTGTTGTAAGGTAGGCTGATGACATAGCACTGTAGCTTGGGCAAGAGAGTGTGACTTTGTCTCAAAAAAAATTAAAACAA","ATTAAAAACACAAAGATTAGCCAGGTGTGATGGCACACAACTGTAATCCCAACTACTCAGGAGAATCGCTTGAACCTGGGAGATAGGGTTTGCAGTGAGCCAAGATTGTGCCACTGCACTCCAGCCTGGGTGACAGAGTGAGACTCTGTCTCCAAAAAAAAAAAAAAAAAA"
"GL873571","4210444","4210570","chr17","16655655","16655789","35","12445211","GCCAGGCAGATGGCTCACACTTCATCCTAGCCCTCTGGAAGGCTGAGGCAGGCTAATTTTTTGAGGTTAGGAGTTTGAGACCAGCCTGAGGAAGAGACCCATCTCTACTTTAAAAAATAAATGGAAA","GCCAGGCATGGTGGCTCACACCTGTAATCCTAGCACTTTGGGAGACTGAGGCGGGTGAATCACCTGAGGTCAGGAGTTTGAGACCAGCCTGACCAGTATGGTGAAACCCAGTCTCTACTAAAAATACAGAAATTA"
"GL873571","4391733","4391878","chr11","33723808","33723943","46","29332075","AACTTAGCTGGGAATGGTGGCTCAAGCCTGTAATCCTAGCACTCTGGGAGGCTCAGGTGGGAGGATCACTTGAGGTTGCTGTGAGCTTGGCTGATGCCAGGACACTCTAGTGTGGGCAAGAGAGTGAGACTCCGCCTCAACAACAA","GCCGGGTGCAGTGGCTCATACCTGTAATCCCAGCACTTTGGGAGGCTGAGGTAGGCGGATCACGAGGTCAGGAGCTGAGATGGCGCCACTGCACCCCAGCCTGGGTGACAGAGCAAGACTCTGTCTCAAAAAAAAA"
"GL873571","6307773","6307841","chr9","62429628","62429694","22","56121855","CTGGGTGTGGTGGCATTGCACCTGTAATCCTAGCTACTTGGAAATCTTAAGCCCAGGAGTTGAAGACTG","CCCAGCATGGTGGTGCATACCTATAATCTCAGCTACTTGGAGGCTTGAGCTCAGAAGTTTGAGACCG"
"GL873571","6496217","6496306","chr1","27257765","27257856","27","20761548","GCAGGGTGTGTTGACCCACACCCACAATTCCAGGACTCTGGGGGGCCAGGGATGGTGGGTTCCCTCAGATCAGGAGCTCCTTACCAGCCT","GACTGGGCATGATGGCTCAAATCTGTAATTCCAGCACTTTGGGAGGCCGAGGTGGGTGGATTGCCTGAGATCAGGAGTTCAAGACCAGCCTG"
"GL873571","6499738","6499903","chr1","38976375","38976555","47","32476637","AAAATAACATGAATTGACTAGGCGAGGTGGCTCACATCTCTAATCCTAGCACTCTGGGAGGCTGAGGCAGGAGAATTGCATGAGGTTGCTGTGAGCTATGATGATACCACGGCATTCTAATCAGGGTGACAGAGTGAGATTCTGTCTTAAAACAAACAAACAAAAA","AAAATAAATAAATTAGCAGGGCCTGGTGGCGCACACCTGTAATCCCAGCTACTTGGGAAGCTGAGGCAGGAGAACCCACTTGAACCTGGGAGCCGGAGGTTGCAGTGAGCTGAGATGGCACCACTGCACTCCAGACTGCGTGACAGAGTGAGACTCCGTCTCAAAAACAAACAAACAAAAA"
"GL873571","11399575","11399872","chr15","109458692","109458994","79","98059117","CAGTGGCTCACACCTGTAAATCTAACACTCTGGGAGGCCAAGGTGGGTGGATCCCTTGAGCTCAGGAATTTGATACCAGCCTGAGCAAGAGTGAGACCTTGTCTCTACTAATAATAGAAAAATAGCCCGTGTTGTGGCACTTGTCCCAACCACTGGGGAGGCTTTAGGCGGGAGGATTACTTGAATTGGGAGTTTGATATTGCTGTGAGCTGGGCTGATGCCTTGGCATTCTAGCTTGGGTAACAGCGTAAGACTCCGTCTCAAATAAATAAATAAATAAATAAAAAGAAAAAAAGAA","GTGGCTCACACCTGTAATCTCAGCACTTTGGGAGACCGAGGCAGGTGGATCACCTGAGGTCGGGAGTTTGAGACCAGCCTGACCAACGTGGAGAAACCCCGTCTCTACTAACAATACAAAATCAGCTGGGCGTGGTGGTGCATGCTTGTAATCCCAGCTACTCGGGAGGCTGAGGTAGGAGAATCGCTTGAACCTGGGAGGTGGAGGTTGCGGTGAGCCGAGATCGAGCCACTGCACTCCAGCCTGGGTGACAGAGCAAGACTCCATCTCAAAAAAAAAAAAAAAAAAAAAAAAAAAAAAAAA"
"GL873572","114760","114841","chr8","26280134","26280211","16","26165374","GGCCAGGCATGGCGGCTCTTCCCTGTAATCCTAGCACTCTGGGAGGGCGAGGCAGGCAGATCACCTAGGCTAGGGTGAGATC","GGCCAGGAATGGTGGCTCATGCCTGTAATCCCAGCACTTTGGGAGGCTGAGGCAGGCAGATCACCTGAGGTCAGGAGT"
"GL873572","9421791","9421892","chr11","8089184","8089269","35","1332607","TACTAAATATATAGCAAGGCCAGGCACAGTGGTTCATGGCTGTAATCCCAGTACTCTGGGAGGCCTAGTCAGAGTTGACCTGAGATCAGGCTAGAAGCCTGG","ATAAAAATAATTGGAGGCCAGGCACGGTGGCTCATGCTTGTAATTCTAGCAATTTGGGAGGCTGACGCGGGTGAGATCATACTGAG"
"GL873572","11052834","11053035","chr14","11857478","11857657","65","804644","TCCACAAAGAAAGCAGAAGTGTGGCCGGGTGGTAGCTCAAGGCAGGAATCCCAGCACTCTGGGAGCTGGGAGGTGGGGGAGGATCCCTTGAGATCAGGAGTTGGAGGGCACAGTGAGCCTGGGGGAGGCCACTGTCTCTGTACTCTAGCAGGGAGACAGAGCAAGACTGCCCATTCAAAGAAAAACAACAAACAAAACAAAA","TACAAAAATTAGCTGGGCACGGTGCCACAAGCCTGTAATCCCAGCTACTCGGGAGGCTGGGCAGGGGAATAGCTTGAACCCAGAGGTGGAGGTTGCAGTGAGCCAAGATCAAGCCACAGCACTCCAGCCTGGGTGACAGAGCAAGACTCCATCTCAAAAAAAAAAAAAAAAAAAAAAAAA"
"GL873573","2564195","2564244","chr1","109985445","109985491","12","107421250","TACAAAAATTAGGCTGGGCTTGGTGGTTCACGCCTATAATCCTAGCACTT","ACTAAAATTAGCTGGGCATGGTGGTGCATGCCTGTAATTCCAGCTAC"
"GL873573","7423371","7423533","chr2","202783328","202783513","56","195359957","GGTGGCTCACACCTGTAATCCCAGCACTCTGGGAGCCCTGGTGGCTCATGTCTATAATCCTAGTACTCTGGGAGACCATGGTGGCTCATGTCTATAATCCTAGTACTCTGGGAGCCATGGTGGCTCACGCCTATAATCCTAGTACTCTGGGAGACCATGGTGG","GGCTGAGGCGCGGGGGCTCACGCCTGTAATCCCAGCACTGTGGGAGGCCGAGGCGGGTGGATCACGCCTGTAATCCCAGCACTGTGGGAGGCCAAGGCGGGTGGATCACGCCTGTAATCCCAGCACTGTGGGAGGCCGAGGCGGGTGGATCACGCCTGTAATCCCAGCACTGTGGGAGGCTGAGGC"
"GL873573","9657648","9657710","chr19","10207852","10207913","10","550204","TAAAAATAAAAAATTTAGCTGGATGTGGTGGCTCACACCTGTAATCCTAGCACTCTGGGAGAC","TAAAAATACAAAATTAGCTGGGTGTGGTGGCACACACCTGTAATCCCAGCTACTCAAGAGGC"
"GL873574","1624662","1624783","chr9","814961","815079","36","809701","GACTGGGTGGGTTGGATCATGCCTGGAATCCTAGCACCCTGGGAGGCCAAGGTGAAAGGATTGCTTGAGGTTAGGAGTTCCAGAAATGTAGCAGTCATGGTGACTTCATCCTTCTCTACCAA","GGCTGGGTGCTTTGATTCATGCCTGTAATCCCAGCACTCTGGGAGGCCGAGGCAGGTGGATCACCTGAGGTTAGGAGTTCGAGACCAGCTTGGCTAACATGGTGAAACCTCGTCTCTAC"
"GL873574","4459477","4459612","chr1","29437872","29437991","29","24978395","GGCCGGGCGTGGTGGCGCACGCCTGTAGTCCCAGCGCTATGGGAGGCCGAGGCGGGTGGATCACCTGAGCTCAGAGGTTCGAGACCAGCCAAGACCCCCCTGAGCCAAACGAGCCAGAGTGAGACCCCGTCTCTAC","GGCCGGGCGTGGTGGCTCACGCCTGTAATCCCAACATTTTGGGAGGCCAAGGCGGGTGGATCACCTGAGGTCAGAAGTTCGAGACCAACCTGGCCAACATGGTGAAACCCCTGTCTCTAC"
"GL873574","4681987","4682216","chr6","153082888","153083127","73","148400901","GGGTGCGGTGGCTCAGACCTATAATCCCAGCACTCTGAGAGGCCGAAGTGGGTGGATCACCTGAGCTCAGGAATTTGAGACCAGCCGTCTCTAAAAATAGCTGAGTGTTGTGGCAGTGGCTGTAAGTCCCAGCTGTTTGGAAAGCTGAAGCAAGGGAATCACTTGAACCCAAGAGTTTGAGGTTGCTGTGATGACAAAGTGAGACTCTATCTCAAAAAAAAAAAAAAAAA","GGCCGTGCGCGGCGGCTCACGCCTGTAATCCCAGCACTTTGGGAGGCTGAGGTGGGTGGATCACCTGAGGTCAGGAGTTTGAGACCAGCCCGACCAGAAATTAGATGGGTGTGGTGGTGCGCTCCTGCAGCCCCAGCTACTTAAGAGGCTGAGGCAGGGTAATCACTTGAACCCGGGAGGCGGAGGTTGCAGTGAGCCGAGCTCACGCCACTGCACTCCAGCCTGGGTAACAGAGCGAGA"
"GL873574","4709916","4710039","chr19","13152422","13152536","46","8442506","AAAAATAGAAAAACTAGCCAAGCATGGTGGTGCACCCCCTATAGTCTGAGCTCCTCAGCGGGCTGAAGCAAAAGGACGGCTGGAGCCCTGGAGTTTGAGGTTGCTGTGAGGCAAGGTGATGCCA","ACACATAAATTAGCCAGACATGATGGTGAGTATCTGTAATTCCAGCTCCTTGGGGGGCTGAGGCGGGAGAATTGCTTGAACCTGGGAGGCAGAGATTGCAGTGAGCCAAGATCGC"
"GL873574","6353839","6353913","chr5","25768079","25768163","22","19414240","AAAAATATAGCAAGGCCAGGCATGGTGGCTCACACCTATAATCCCAGTACTTGGGAGCTGGAATTTGAACCTAGG","AAAAAACTCAAACAAGGCTGGGCGTGGTGGCTCACACCTGTAATCCCAGCACTTTGGGAGGCTGAGGTGGGTGGATCACCTGAGG"
"GL873574","6533061","6533332","chr5","85182161","85182439","81","78649100","GGCTGGGCGAGGTGGCTTACACCTATAATCCTAGTACTCTGGGAGGCCAAGGTGGGTGGATTGCCTGAGCGCACAGTTTCAAGACCAGCTGGAGCCAGAGAGAGAGAGAGAGACCCTGCCTCTAAAAATAGCCAGGCATTGTGGCAGGCACCTGTAGTCCCAGCTACTTGGCAGGCGGAGGTATGAGAATCGCTAGAGGTTGCTGTTAGCTATGATGCCATAGCACTCTACCAAGGGCGACAAAGTGAAACTCTGCCTCAAAAAAAAGAAGA","GCCAGGCGTGGTGACTCAAGCCTGTAATCCTAGCACTTTGGGAGGCCAAGGTGGGCGGATTGCCTGAGCTCAAGAGTTTGAGACCAGCCTGGGCAACACGGTGAAACCCAATCCCTACTAAATACAAAAAAAATTAGCCGGGTGTGGTGGTGTGAACCTGTAGTCCCAGCTACTCGGGAGGCTGAGGCAGGAGAAGGCAGAAGTTGCAGTGAGCCGAGATCACACCACTGCACTCCAGCCTGAGTGACAGAGCAAAACTCTTTCTCAAAAAAAAAAAAA"
"GL873574","6643746","6643907","chr2","92627944","92628105","46","85984198","AAATAGCCAGGCGTTGTGGCAGGCACCTATAGTCCCAGCTACTTGGGAGGCTGAGGCAAGAGAATCACTTAAGCCCAAGTGACAGAGGTTGCCAGGGCACTCTACGTAGGCAACAGAGTGAGACTCTATCTAAGAAAGAAGGAAGGAAGGAAGGAGAAAGAA","TTAGCCGAGCATTGTGGTGCGCGCCTGTAGTCCCAGCTACATGGGAGGCTGAGGCAGGAGAACACCTGAACCCAGGATGTGAGCTGAGTCGCGCCATTGCACTCCAGCCTGGGCAACAGAGTGAGACTCCATCTCAAAAATAAAATAAAATAAAATAAAAAA"
"GL873574","6644163","6644274","chr1","128607504","128607619","20","121963341","CTGTAATCCTAGCACTTGGGAGGCTGAGGCAGGTGGATCACCTGAGTTCAGGAGTTCAAGACCAGCCTAAACAAGAGTGAGACCCTATCTCTACTAAAAATAGAAAAAATAT","GCCTGTAATCCAAGCACTTTGGGAGGCTGAGGCGGGTGGATCACCTGAGGTCAGGTGTTCGAGACCAGCCTGGCCAACGTGGTGAAACCCCAACTCTACTAAAAATACAAAAATTA"
"GL873574","8511822","8512127","chr1","23439759","23440073","84","14927937","GGTGGCTGGTGCCTGTAATCCTAGCACTCTGGGAGACTGAGGCAGGTGGATCACTTGAAATCAGGAGTTTGAGATCAACCTGAGCAAGAGATCTTGTCTCTCCTAAAGATAGAAAAACTAGCTGGGATTTGTGGTGGACACCTGTAATTTCAGCTACTCAGGAAGCTAAGGCAAGAGCATTGCTTAAAACCAGGAGTTTGAAGTTGATGTGAGCTAGGATGTCAGGGCAGGTTACCCAGGGTGACAGAGTGAGACTCTGTGTCAAAATAAACAAACAAACAAACAAACAAAACAAAATAAAATAAA","GGCTGGACATGGTGACTCACGCTTGTAATCCCAACACTTTGGGAGGCTGAAGCAGGCAGATCACCTGAGGTCAGGAGTTTGAGACCAGCCTGACCAACATGGTGAAACCTTGTCTCTACTAAAAATACAAAAATTAGCTGGGAGCAGTGGTGCACACCTGTAATCCCAGCTACTCGGCAAGCTGAGGCAAGATAATTTTTTAAACCTGGGAGGTGGAGGTTGCAGTGAGCCAAGATCGTGCCACTGTACTCCAACCTGGGAGACAGAGCAAGACTCTGTCTCAAAAAAAAAAAAAAAAAAAAAAAAAAAAAAAAA"
"GL873575","2107336","2107519","chr4","38052972","38053149","54","35945636","TCAATTAAAAACTTTTTAAAATGAGGCTGAGCATGGTGGTTCACACCTGTAATCCCAGCACTTTGGGAGGCCGAGGCAGGAGGATCACCTGATCCCAGGAGTCCAAGCCTACAGTGAGCCGTGATAATACCACTGCACTTCAGCCCAAAGCCTCAAAAAGAAAAAAAAAAAAGGATAGACAAGA","TATATATATATATATTATTTTGGGGGGGCATGGTGGTGCACACCTGTAATCCCAGCTACTCGGGAGGCTGAGGCAGGAGAATTGCTTGAGCCCGGGAGGCAAAGGTTGCATTGAGCTGAGATCACACCACTGCACTCCAGCCTGGCGACAGAGTCTCAAAAAAAAGAAAAAATAAAAA"
"GL873575","5831824","5831959","chr1","29437872","29437991","28","23606048","GGCCGGGCGTGGTGGCGCACGCCTGTAGTCCCAGCGCTATGGGAGGCCAAGGCGGGTGGATCACCTGAGCTCAGAGGTTCGAGACCAGCCAAGACCCCCCTGAGCCAAACGAGCCAGAGTGAGACCCCGTCTCTAC","GGCCGGGCGTGGTGGCTCACGCCTGTAATCCCAACATTTTGGGAGGCCAAGGCGGGTGGATCACCTGAGGTCAGAAGTTCGAGACCAACCTGGCCAACATGGTGAAACCCCTGTCTCTAC"
"GL873575","7451097","7451208","chr3","122814630","122814743","22","115363533","GGCCAGGTGTGGTGGCTCACACCTGTTATCCTAGCACTCTGAGAGGCCACAGCAGCTGGATCACTTGAGCTCAGGAGTTCAAGACCAGTCTGAGCAAGAGCAAGACCTCACC","GGCTGGGTGTGGTGGCTCATGCCTGTAATCCCAGCACTTTGAAAGGCCAAGGCAGATGGATCACTTGAGGTCAGGAGTTCCAGACCAGCCTGGCCAACATGGCAAAACCCCATC"
"GL873575","7451277","7451445","chr6","58863249","58863409","41","51411972","AAAAATTCAGCCAGCCACAGTGGAAGTGGATGCCTGCCATCACAGCTACTCTGGGGGCTGGGGCAAGAGAATTGCTTGATCCCAGGAGTCTGAGGTTGCTGTGACCTAGGCTGACACCACAGCACTCTACCCAGGGTGACAGAGTGAGGCTGTGTTTAAAAAAAAAAAA","TTAGCCAGGCATGGTGGCACATGCCAGTAATCCCAGCTACTCAGGAGGATGAGGCAGGAGAATCGCTTGAACCCAGGAGGCAGAGGTTGCAGTGAGCTGAGATTGCGCCACAGCACTCTACCCTGGGTGACAGAAGGAGACTCTGTCTCAAAAAAAAAAAA"
"GL873576","1765109","1765185","chrX","53921180","53921256","12","52156071","GGCCAGGTGCAGTGGCTCATATCTGTAATCCTAGCACCCTGGGAGGCCAAGGTAGGCGAATCACCTGAGGCCAGGAG","GGCCAGGTGCAGTGGCTCACGCCTGTAATCCCAGCACTTTGGGAGGCCGAGGTGGGCGGATCACTTTAGGTCAGGAG"
"GL873576","2711577","2711895","chr7","6620384","6620702","85","3908807","GGTCGAGCTTGGTGGCTCATGCTTGTAATCCTAGCACTCTGGGAGGCCAAGGCAGGTAAGTTGCCCTGAGCTCATAGGTTCCAGATCAGCATGAGCCAGAGTGAGACCCTGTCTCTACCAAAAAATAGCCCGGCATTCTGGCAGGTGCCTGTAATCCCAGCTGCTTGGGAGGCTGAGGCTAGAGAATCACTTAAACCCAAGGGTTAGTGGAGGTTGCTGTGAGCTATGATTCCACCGTACTCTACTGAGGGCCACAAAGTGAGACTCTGTCTCCATAAAAAAGAAAGAAAGAAAGAAAGAAAAATAAAATAAAATAAAA","GGCCAGGCACAGTGGCTCATGTCTGTAATCCCAGCACTTTGGGAGGCCGAGGCGGGTGGATTACCTGAGGTCAGGAGTTCTAGACCAGCCTGGCCAACAAGGCGAAACCCTGTCTCTACTAAAAATACAAAAAATTAGCTGGGCGTTTTGGCACATGCCTGTAATCCCAGCTACTTGGGAGGCTGAGGCAGGAGAATTGCTTGAACTGGGGAAGTGGAGGTTGCAGTGAGCTGAGATCACACCATTGCACGCCTGAGCAACAGAGCGAGACTCTGTCTCAAAAAAAAAAAAAAAAAAAAAAAAGAAAAGAAAAAGAAAA"
"GL873576","4782520","4782652","chr9","61136941","61137074","22","56354421","CCAGGCACGGTGGCTCACCCTTGTAACCCTAGTACTTTGGGAGGCTGAGGTGGGAGGATCCCTTGAGGTCAGGAGTTCAAGACCAGCCTGAACAACAGTGAGACCCCCGTCTCTACTAAAAAATAGAAAAGTT","GCCAGGCACGGTGGCTCACGCCTGTAATCCCAGCACTTTGGGAGGCTGAAGCGGGCGGATCACCTGAGGTCAGGAGTTCAAGACCAGCCTGGGCACCATGATGAAACCCCGTCTCTATTAAAAATACAAAAATT"
"GL873576","4782930","4783078","chr7","57521645","57521803","40","52738715","AGTTAGTCTGGTGTCATGGTGGGTGCCTGTAGTCCCAGCTGCTTGGGAGGCTGAGGCAAGAGAATCACTTGAGCCCAGGAGTTGGAGGTTGCTATGAGCGAGGCTGTAGCCTAGGCAACAGAATGAGACTTTGCCTCAAAAAAATAAAA","TTAGCTGGGCATGGTGGCGCATGCCTGTAGTCCCAGCTACTTGGGAAGCTGAGGCAGGAGAATCACTTGAACCTGGGAGGTGGAGGTTGCAGTGAGCTGAGATCGCACCGCTACACGCCAGCCTGAGCAACAGAGAGAGACTCTGTCTCAAAAGAAAAA"
"GL873576","7828709","7828723","chr5","101042981","101042996","1","93214272","TAAATAAATAAAAAA","TAAATAAATAAATAAA"
"GL873576","7828960","7829230","chr13","49045537","49045844","89","41216577","GCCGGCTGCAGTGGCTATAATCCAAGTACCCTGGGAGGCTTAGGTGGATGGATCACTTGAGCTCAGAAGTTCAAGACCAGCCTCAGCAAGAGGTAGACCTTGCCTCTATTAAANNNNNNNNNNNNNNNNNNNNNNNNNNNNNNNNNNNNNNNNNNNNNNNNNNNNNNNNNNNNNNNNNNNNNNNNNNNNAGTTTGAGGTTGCTGTGAGCTATGATGAAGCCAGGGCATTCTACCCAGGGTGACAGAGTAACTCTTAAAAAAAACTAAACAA","GGCCAGGCAGAGTGGCTCATGCCTGTAATTCCAGCAATTTGGGAGGCCTAGGCAGGCAGATTACCTGAGGTCAGGAGTTTGAGACCAGCCTGGCCAACATGGTGAAACCCCGTCTCTTCTANNNNNNNNNNNNNNNNNNNNNNNNNNNNNNNNNNNNNNNNNNNNNNNNNNNNNNNNNNNNNNNNNNNNNNNNNNNNNNGGAGATAATAGCTTTTGTAGAACGAAGCGATGCAACAGCCAGATCGCCGCCACCACCCTTAGGTCCTGGCGACAGAGTGAGATCCATCTTAAAAAAAAAAAAAAAAAAA"
"GL873576","10622840","10623093","chr7","60266447","60266705","74","49643607","GCTGGGTATGGTGGTTCACACCTATAATCCTAGCACTCTGGGAGGCTGAGGTGGGAGGATTGGTGGAGCTCAGGAGCTCATGAGGTGCCAAATCACTGGTGCCACACACCTGTATTCCCAGCTACTGAGGAGGCTGAGGCAGGAGGATCAGGTAAGCCCAGGAAGTTTGAGGTTGTAGTGAGTTAGGATGATTGAACTCTGCCTTGAGAGACAGAGCAAGATCCTCCTTCCTCCTAAGCAAACAAACAAATAAA","GGCTGGGTGCAGTGGCTCACACCTGTAATCCTAGCACTTTGGGAGGCTGAGGCGGGAAAATTGCCTGAGCTCAGGAGTTCAAGGACAGCCTAGGCAACATAGCATGGTGGTGCACGCCTGTATTCCCTGCTACTTGGGAGGCTGAGGCACAAGAATTGCTTGAATCCGGGAAGTGGAGGTTGCAGTGAGCCATTGTGGCACTGCTCTCCAGTCTGGGTGACAGAGCAAGACTCCATCTCAAAAAAAAAAAAAAAAAAAA"
"GL873576","10819939","10820007","chrX","67133632","67133707","21","56313693","AGGTTGCAGTGAAATTGTACCATTCCAATGAAGCCTGGGGGACAGAGTGAGATTCTCTCAAAATAAAAA","GGAGGTTGCAGTGAACCGAGATCGTGCCACTGCACTCCAGCCTGAGCGACAGAGTGAAACTTCGTCTCAAAAAAAA"
"GL873576","10920306","10920363","chr3","48261745","48261808","16","37341439","GCTGGACCTTGTAGAGAGTGCCTGTAATCCCAGCTACATGGGGGGCAAGAGAATTGCT","GCTGGGCATGGTGGTGCATGCCTGTGATCCCAGCTACTCAGGAGGCTGAGGCAGGAGAATTGCT"
"GL873576","10920398","10920529","chr10","67341428","67341546","30","56421030","GGCCAGGCGTGGTGGCTCACGCCTGTTGTCCCAGCACTGTGGGAGGCCGAGGTGGGTGGATTGCCTGAGCTCAGAGGAGTCCGGAAGACCAGCATGAGGCAGAGTGAGCCAGAGTAAGATCCTGTCTCTACC","GGCTGGGTGTAGTGGCTCATGCCTGTAATCCCAGCACTTTAGGAGGCCAAGGTGGATGGATTGCCTGAGCTCAGGAGTTCGAGACCACCCTGGGCAACAAGCCAAAACCCTGTCTCTAC"
"GL873577","515809","515961","chr7","137660778","137660931","43","137144969","AGCTGGGCATGGTGGCTCATGCCTATAACCCTAGCGTGCTAGGAGATTGCTTGTCAGGAGACTGAGGTTGCAGGAAACTGTGATGATGGCACTGCACTCTACCCAGGGTGACAGAGCAGGACTCTGCCTCAAAAAAAAAAAAAAAAATAGAAA","TTAGCTGGGCATGGTGGCGCATGCCTATAATCCCAGCTACTTGGGAGGCTGAGGCAAGAGAATCGCTTGAACCGGGGAGGCAGAGGTTGCAGACTGCACTCCAGCCTGTGTGACAGAGTGGGACTCCGTCTCAAAAAAAAAAAAAAAAAAAAAA"
"GL873577","1633164","1633256","chrX","38269524","38269615","26","36636360","TCAGCCAGGCATGGTGGCACTTGCCTATAAACCCAGCTCCTTGGGAAGCTGAGCCGGGAGGATCCCTTGCACCCAGGAGCAACGGAAGGCAGT","AATTAGCCAGGCATGGTGGCACATGCCTATAATCCCAGCTACTCAGAAGGTTGAGGCAGGAGAATCACTTGAACCTGGGAGGCAGAGGTTGC"
"GL873577","3979502","3979560","chr20","68909283","68909346","13","64929781","GAGTTTGAGACCAGCCTGAGCAAGACCGAGACCCAGTCTCTACTAAAAATAGAAAAATT","GGAGTTCAAGACCAGCCTGACCAACATGGAGAAACCCTGTCTCTACTAAAAAATACAAAAATTA"
"GL873577","3979839","3980009","chr10","31403126","31403287","39","27423287","ATGAGCAGATTGTCTTGGTGGGCACCTGTAGTCCCAGCTATTGGAGGTGGGAGGCTGAAGCAGGAAAATCTCTTGAGCCCAGGAGTTTGAGGTTGCTGTGAGCTAGGCTGACACCACGGCACTCTAGTCAGGGCGTCAGAGTGAGACTCCGTCTCAAAAAAAAAAAAAAAA","TTAGCTGAGTGTGGTGGCGCACATCTGTACTCCCAGCTATTTGGGAGGCTGAGGCAGGAAAATCGCTTGAACCCAGGAGGTGGAGGTTGCAGTGAGCCAAGATCACACTACTGCACTCCAGCCTGGGTGACAGAGTGAGAATCCATCTCAAAAAAAAGAAAA"
"GL873577","6050882","6051080","chr1","153219820","153220007","59","147168938","GGCTGGGCGTTGTGACTCATGCCTGTAATCCCAGCACTCTAGGAGGCCGAGGTGGGTGGACTGCCTGAACTCAGAGGTTTAAGACCATCCTGAGCCGCAGTGAGCCAGAGCGAGACCCTGTCTCTACCAAAAAAAGCTGGGTGTTGTGGTGGGCGCCTATAGTCCTAGCTACTTGAGGCGCTAAGGGTAAAAAAATTGC","GGCCTGGCACAATGGCTCACGCCTGTAATCCTAGCACTTTGGGAGGCCGGGGTGGGTGGATCACCTGAGATCAGGAGTTTGAGACCAGCCTGGCCAACATGGTGAAACTCCTTCTCTACAAAAATTAGCCAGGTGTGGTGGTGGGTACCTGCAATCCCAGCTATTTGGGAGGCTGAGGCAGGAGAATC"
"GL873577","8463965","8464050","chr9","52134422","52134508","19","43670457","CTGGGTGCTATAGCTCACGCCTATAATCCTAGCACTCTGGGAGTTTGGGGCAAATGGATCACCTAGGCTCAGGAGTTTGATACCAG","GGCTGGGAGCAGTGACTCACGCCTATAATCCCAGCACTTTGGGAGGCTGAGGCAGATGGATCACCTGAAGTCAGGAGTTCGAGACCA"
"GL873577","9471486","9471613","chr16","5178790","5178910","46","4292696","TTAGCCAGGCATAGTAGCCTGTGTGTAGTCCTAGCTACTCAGGAGGCTGAGGTAGATGGGTCACTTGAGGTTGCAGAGATTATGGTAATGTCACTGTACTCTAGCCCTGGCAACAGAGCACAACCCTG","TTAGCCGAGCCTGGTGGCATAAACCTGTAATCCCAGCTACTCAGGAGGCTGAGGCAGGGGAATTGCTTGAACCTGAGAGGAGAAGGTTGCAGTGAGCCGAGATTGCACCATTGCACCCCAG"
"GL873577","9471875","9471998","chr7","17832200","17832315","36","8360325","GGCCAGGTGAAGCAGCTCATGGCTATAATCCTAGCAGTTTGGCAGGCCAAGGTGGGAGGACTGCTTGAGGTCAAGAGTTCAAGACCAACCCATCTTTGCGAAAAATTTAAAAATTACCTAGGCA","GCCAGGAGAGGTGGCTCATGCCTCTAATCCCAGCACTCTGGAAATCCAAGGTGGGTGGATCACCTGAGGTCAGGAATTCCAGACCAGTCTGGCCAATATAAAAAATTAGCCAGGCT"
"GL873577","9853150","9853170","chr3","85044647","85044667","3","75191497","AAACAAACAAACAAAAAAAGA","CAAACAAACAAACAAACAAAA"
"GL873577","9853206","9853473","chr7","130818682","130818963","67","120965476","GCTGGGCGCAGCGTCTCACTCCTGTAATCCCAGCACTTGGGAGGCCAAGGTGAGTGGATTGCCTGAGTTTACAGTTTCGAGACCAGCCTGAGCCAAAGCGAGACCCCCATCTCTAAAAAATAGCTGGGCATTGTGGTGGGCACCTGTAGTCCCAGCTACTTGGGAGGCTGAGGCAAGAGGATCGCTTGAACCTAAGAGTTTGAGGTTGCTGTGAGCTAAGGCTCCATGGCATTCTACCAAGGGTGACTAAGTGAGACTCTGTCTAAAA","GCCGGGCACAGTGGCTCACACCTGTAATCCCAGTACTTTGGGAGGCCAAGGTGGGTGGATCACCTGAGGTCAGGAGTTTGAGACCAGCCTGGCCAACATAGTGAAACTCTACTAAAAATACAAAAAAATAGCTAGGCATGGTGGTGCGCACCTGTAATCCCAGCTACTTGGGAGGCTGAGGCAGGAGAGTTGCTTGAACCCAGCGGGGTTGAGGTTGCAGTGAGTTAAGATCAAGCCACTGTGCTCCAGCCTGGATGACAGAGAGAGACTCCATCTCAAAAA"
"GL873577","10722415","10722478","chr10","12501471","12501539","23","1779056","AATAAAAAAATGCTGGGTACAGTAGTACATGCCTGTACTCTCATCTGGGGAAGCTGAGGCATGA","AAAGTAAAAAATTAGAGCTGGGCATGGTGGCACACACCTGTAATCCCAGTCACTAGGGATGCTGAGGCA"
"GL873578","463331","463568","chr10","28935382","28935620","93","28472051","CAGGTGCTTTGACCCACACCCTCAACTCTAGGACTTTGGACGCCCTGGCTGGGTGGGTCCTTTAAAGTCAGGAGCTTCTTATCAGTCTGGGCAAAAGTGAGACCCCATCTCTACCAAACAAAGAAAGAAATCAGCAGTATGTTGCAGTAGAGACTCACCAATACCTTCTTTCAAAGACCAAAGCTGGAAGGACACTAAAGACCATGATCTCATGGCCTCCCTGAGCCATGACAATGCC","CCAGGTGCAGTGGCTCATGCCTGCAAGCTCAGAACTTTGGGAGGCAGAGGTGAGCAGACTGCCTGAGTTCAGGAGTTCAAGACCAGCTGGGCAACATGGTGAGACCCTATCTCTACTAAAAATACAAATAATTAGCAGGGTGTGGTAGCACACACCTGTAGTCCAGCTACTCAGGAGGCTGAGGCAGGAGAATTGCTTGAACCCAGGAGGCAGAGTTTGCAGTGAGCCAGGACTGGGCC"
"GL873578","1143712","1143827","chr11","52824583","52824692","30","51680871","GGCTGGGTGTGGTGCCTCATGCCTGTAATCTAAGCCCTCTCCGAGGCTGAGGTGGGAGGATCCCTTGAGTTTAGGAGTTTGATTTTGAGACCAGCCTGATCAAGAGAGAGACCTCA","GGCCGGGTGTGGTGGCTCATGTCTGTAATCCCAGCACTTTGGGAGGCTGAGGTGGGTGGATACCCTGAGGTCGGGAGCTCGAGACCAGCCTGACCAACATGGAGAAACCC"
"GL873578","1144101","1144139","chr3","33494224","33494257","11","32350123","GAGAGAGACCTCATGTCTACTAAAATAAATAAATATATA","GTGAAACCCGTCTCTACTAAAAATACAAAAATTA"
"GL873578","1144175","1144343","chr12","119519961","119520131","41","118375786","ATTATCCAGGCCTTCTGGTGGATGCCTGTAGTCCTAGCTACTAGAAAAGCTGGAGCAGAATCACTTGACCCAGGAGCTGGAGGTTGCAGGGAGCTAGGCTGATGCCACAGAATTCTAGCCTGAGGCAAAAGAATTGAGCCACTGTCTCAAAAAGGAACAAAAAAGAAAA","ATTAGCCAGGTGTGGTGGCATGCACTTGTAATCCCAGCTACTAAGAAGGCTGAGGCAGGAGGATCACTTGAACCCGGGAGGTGGAGGTTGCAGTGAGCCAAGATCATGCCACTGCACTCCAGCCTGGGCAACAGAGTAAGACTCTGTCTCAAAAAAAAAAAAAAAAAAAAA"
"GL873578","4593962","4594035","chr16","68825055","68825124","22","64231093","AGCTGGGTACAGTGGCTCACATATAATCCCAGTGACTCAGGAGGCTAAGACAGGAGGATTACTAGGACCTGAGA","GGCTGGGCACAGTGGCTCAGACCTGTAATCTCAGTACTTTGGGTGGCTGAGGCAGGTGGATCACCTGAGG"
"GL873578","6158845","6158972","chr3","500432","500562","24","5658413","GACATGGTGGCTCACACCTGTAATCCTAGCCCTCTGGGAGGCTGAGGCAGGTGGATCACTTGAGTTCAGGAATTCAAGACCAGCTTGAGTGAGAGCAAGACCCTGTCTCTACTAAAAATAGAAAAATT","GCACGGAGGCTCATACCTGTAATCCCAGCACTTTGGGAGGCTGAGGCAGGTGGATCACCTGAGGTCAGGAGTTCCAGACCAGCCTGGCCAACATGGCGAAACCCTGTCTCTACTAAAAATACAAAAAATCT"
"GL873578","6159253","6159444","chr19","34496349","34496541","55","28337096","ATAAAATAAAAATAGAAAAATTAGCCAGGCATTGTGGCAGACATGCGAAGTCTCAGCTACTCCAGAGGCTGAGACAGGAAGATTACTTGAGCCCAAGAATCTTGCTGTGAGCTAAGCTGATGCCATAGCATTGTAACCTAGGCAACAGAGTAAGACTTGGCCTCAAAAATAAAATAAAATAATAAAGTAAAA","TTAGTTAATTAAATTAAACTTAGCTAGGCATAGTGGAACACACCCATAGTCCCAGCTACTCTAGAGGCTGAGGCAGGAGGATTGCTTGAGCCAAGTTGGAGGCTGCAGTGAGCTATGGTGGTGCCACTGCATTCCAGCCTCAGTGACAGAGAGAGACCCTGGCTCAAATAATAATAATAAATAAATAAATAAA"
"GL873578","6766040","6766171","chr2","93098086","93098217","30","86332046","CCAGGCACAGTGGCTCATGCCTATAATCCTAGTAGTCTAGGAGGCTGAGGTGAGTGCATTGCTTGAGCTCAGGAGTTAGATACCAGCCTAACCAAGAATGAGACCCCATCTCTATTAAAAATAGAAAAGTTA","GCCGGGCACAGTGGCTCATGCCTGTAATCCCAGCACTTTGGGAGGCCGAGGCGGGCAAATCACGAGGTCAGGAGTTCAAGACCAGCCTGACCAATATGATGAAACCCCGTCTCTATTAAAAATACAAAAATT"
"GL873578","6766434","6766577","chr9","21128084","21128223","50","14361650","GTTAGCCAGGAGTTGTGGCGGGCACCTACAGTCCTAGCGACTCAGGAGGCTGAAGTAGGCAGAGTTTGATGTGTTGCTGTGAACTACAAGGACACCAATGCACTCTAGGCCGGTAACAGAGTGAGACACTGACTAAAAAAAAAA","TTAGCCAGGTGTGGTGGCACATGCCTGTATTTCCAGCTACTCGGGAGGCTGAGGCAGGAGAATTGCGTGAGCTGAGATCATGCCACTTCATTCCAGTCTGGGTGACAGAGTGAGACTCTGCCTCAAAAAACAAAACAAAA"
"GL873578","7397948","7398119","chr5","40230148","40230319","43","32832200","TAAAAATAGCCATGCATTGTGACAGGCACCTGTAGTCCCAGCTACTCAGGAGGTTGAGGTAAGAGAATCACTTGAACCCAAGAGTTTTGAGGTTGTTATGAGCTAAGACGCCTCGGGACTCTACAAAAGGTAACAAAGTGAGACTCTGTCTCATAAAAAAAGAAAAAAAGAA","AAAATTAGCCAGGCATGGTGACGTACACCTGTAGTCCCAGCTACTCGGGAGGCTAAGGCAAGAGAATCGCTTGAACCCAGGAGGCAGAGGTTGCAGTGAGCTTAGATCACGCTACTGCGCTCCAGCCTGGGTGACGGAGTGAGACGCCATCTCAAAAAAAAAAAAAAAAAAA"
"GL873578","7398378","7398515","chr15","102382935","102383070","35","94984557","GGTCGAGCAAGGTGGCTCACGCCTGTAATCCTAGCACTCTGTGAGGCTGAGGCAGATGGATTGCCTGAGCTCGTGGGTTCGAGACCAGCCTGAGCCAGAGTGAGACCTCATCTCTAAAAATAGCTGGGAAGCTGGGCA","GGCCAGGTGTGGTGGCTCACGCCTGTAATCCTAGCACTTTGGGAGGCTGAGGCGGGTGGATTGCCTGAACTCAGGAGGTCAAGACCAGCCTGGGCAACACAGTAAAACCCCATCTCTACTAAAATACAAAAAATCA"
"GL873579","370235","370429","chr16","38067345","38067552","57","37697110","GCACAGGCCTGAAATCCTAGCACTCTGAAAGGCCAACGGAGGAGAATTTCTGGAGCTCAGGAGTTTGATACCAGCCTAAGCAAATAAAGCTAGACCTCTATCTCTACTAAAATTAGAAAAATTAGGCAGATGTGGTGGTAGGCACCTATAGTCCCAATTACTCCAGAGGCTGAGGCAGAAAGACTCTTGAACCCA","GTCAGGCATGGTGGCTCATGCCTATAATCCTAGCACTTTGGGAGGCCAAGGCCGGTGGATCACCTGAGGTCAGGAGTTTGAGACCAGCCTGGCCAATATGGCAAAACCCCGTCTCTACTAAAAATAAAAAAATTAGCTGGGCACGGTGGTGGGCACCTATAGTCCCAGCTACTCAGGAGGCTGAGGCAGGAGAATTGCTTGAACCCAG"
"GL873579","370936","371046","chr3","3847698","3847802","33","3476762","TGACTCTTGAACCCAGGCACATGAGGTTGCTAAGAGTCTAGGCTGATGTCACGGCACTCTAACCTGGGAAACAGTGTGAGGTTCTGCCTCAATAAATAAATAAATAAATAA","TGGCTTGAACCCAGGAGGCGGAGGTTGCAGTGAGCCGAGATCACGCCACTGCACTCCAGCCTGGGCAACAGAGCGAGACTGTCTCAAAAAAAAAAAAAAAAAAAA"
"GL873579","599436","599605","chr10","38982686","38982853","41","38383250","AAAAAGTCAGACATTGTGGCAGGTGTCTGTAATCCCAGCTATTTGGGAGGCTGAGGCAGGAGTATCATTTGAACCCACGAGTCTGAGGTAACTGTGAGCTAGGCTAACACAACAGCACTCTAGCCTGGGCAATAGAATGAGACTCTATCAAGAAAAGAAATGAAAAGAAA","TATTAGCCTGACACAGTGGCGCGCATCTGTAATCCCAGCTACTTGGGAGGCTGAGGCAGGAGAATCACTTGAACCCAGGAGGCGGAGGTTGCTGTGGGCTGAGATCATGCCACTGCACTCCAGCCTGGGCAACAGAGGGAGGCTCCATCTCAAAAAAAAAAAAAAAAA"
"GL873579","599942","599953","chr3","71473700","71473710","4","70873758","TTTTAAAATAGT","TTTAAAAAAAA"
"GL873579","600232","600365","chr1","16061315","16061447","30","15461083","GGCTAGGCAAGGTGACTCATGTCTGTAATCCTAGTACTCTGGGAGGTTTGAGGCAGGAAGACCACTTTAGCTCAAGAGTTCCAGATCAGCCTGTGCAAGAGTGATACATCATCTCTACTAAAAATCAAAAATTA","GGCTGGGCATGGTGGCTCATGCCTGTAATCCTAGCACTTTGGGAGGTTGAGGCAGGCAGATCACTTGAGGTCAGGAATCTGAGACTAGCCTGGCCAACATGGTGAAACTCCATCTCTACTAAAAAAAAAAAAA"
"GL873579","5650320","5650591","chr6","54938866","54939145","71","49288546","GTCAGGTGTGTTAGCTTACAGTAGTAATCCTAGCACTTTGGGAGGTTGAAGTGGGTGGATTGCTTGAGCTCAGGGGTTCAAGACCAGCCTGAACAAGAGTGGGACCTCATCTCTATTAAAAACAGAAAAACTAGCTGGGTGTTATGGTGGGTGTCTGTAGCCCCAGCTACTCAGGAGGCTGAGGCAGGAGGTTGAGGTTGCTGTGAGCTATTGAGACCACAGCACTCTATCCAGGGCAACAGAGTGAGACCCCTCCCCCCCCCAAAAAAAAA","GGCCAGGTGTGGTGGCTCACGCCTGTAATCCCAACACTTTGGGAGGCCGAGGTGGGTGGATCACCTGAGATCAGGAGTTCAAGACCACCCTGGCCAACATGGTGAAACCCCGTCTCTACTAAAAATACGAAAATTAGCTGAGTGTGGTGGTGCATGCCTGTAGTCCCAGCTACTCAAGAGGCTGAGGCAGGAGGTGGAGGTTGCAGTGAGCCGAGATTGCATCACTGCACTCCAGCCTTGGCGACAGAACGAGAGAGACTCCATCTAAAAAAAAAAAAAA"
"GL873579","7037162","7037347","chr3","37328686","37328893","67","30291524","GAGGTGGGTGGATTGCCTGAGCTCACAGGTTGGAGACCAGCCTGAGCCAGAGCAAGACCTTATCTCAAAAAATAGCCAGGTGTTGTGGCTGGCACCTGTAGTCCCAGCTGCTCAGGAGGCGGAGGCAAGAGAAATGCTTGACCTCAGGAGTTTGAGGTTGCTGTGAGTTCAACTCACACTAATACA","GAGGCAGGGGGATCACCTGAGGTCAGGAGATCGAGACCAGCCTGGCCAACATGGTGAAAACCTGTCTCTACTAAAAATCCAAAAACATTAGCCAGGTGTGGTGGCACGCACCTGTAATCCCAGCTACTTGGGAGGCTGAGGCAGGAGAATCACTTGAACCTGGGAGGCAGAGGTTGTAGCGAGCCGAGATCACACCACTGCACCCCAG"
"GL873579","11077764","11077972","chr19","1200469","1200683","63","9877295","GCCAGGTGCAGTGGCTCATGCCTATAATCCTAGCACCCTAGGAGGCTGAGGAGTTCAAGACCAGCCTAAGCAACTGTGAGACCCCATCTCTACCAAAAATAGAAAAATTAGCTGACTGTTATGGTGTGCACCTACAGTCCTAGCTACTCAGGAGGCTGAGGCAGAAAGAGTCCTTGAACCCAGGAGGCTTTTTTTTGTTGTTGTTGTTG","GGCCAGTCGCGGTAGCTCATGCCTGTAATCCCAGCACTTTGGGAGGCCGAGGCGGGCAGATCACCTGAGACCAGCCTGGCAACATGGTGAAACCCCATGTCTACCCAAACTACAAAAATTAGCTGGGTGTGGTGGTGCACGCCTGTAATCCGAGCTACTCAGCAGGCTGAGGCAGGAGAATCCCTTGAACCTGGGAGGCAGAGGCTGCAGTGAGC"
"GL873579","11078245","11078333","chr19","4926258","4926351","22","6151987","TGAACCCAGGAGTTTGAGTTCGCTGTGAGCTAAGCTGAGGCCACAGCACTCCAGCCTGGGCAACAGAGTGAAAGGAAAAAAATAAAAAA","TGAACCCGGGAGGTGGAGGTTGCAGTGAGCCAAGATCACACCAATGCACTCCAGCCTGGGCAACAAGAGTGAAACTCTGTCTAAAAAAAAAAAA"
"GL873580","320374","320488","chr13","48549305","48549409","42","48228931","GGTAGTGCGTGCCTGCATTCCCAGCTACGGGAGGGCAGGGACTTGAGGCCAGCCTGGGCAAAATAATGAGACCTACTAATGACTCTACTAATACAGAAACAATTAGCTAGGTATG","TGGGAGGCCGAAGTGCGCAGATCACCTGAGGTCAGAAGTTGGAGACCAGCCTGGCCAACATGGTGAAAACCCATCTCTACTAAAAATACAAAAATTAGCTGGGCA"
"GL873580","374969","375091","chr6","147681010","147681135","27","147306041","CGGTGGCTCACACCTATAATCCTAGCATTTTGGAAGGCTGAAGCCGAGGATCTCTGGAAGTCAGAAGTTCAAGACCAGCCTGCCCAAGAGCAAGACCCCATCTCTACTAAAAATAGAAAAACT","GGTGGCTCACACCTGTAATCCCAGCATTTTGGGAGGCTGAGGCAGGCGGATAATCTGAGGTCAAGAATTTGAGACCAGCCTGGCCAACATGGAGAAACCCTATCTCTACTAAAAATACAAAATTAC"
"GL873580","375369","375549","chr7","19977275","19977456","44","19601906","CTAACCAAGTTAGTTAGTTTTAGTTGGCAGGTGCCTGTAGTCCCAGCTCCTTGGGAGGCTGAGGCAAGAGAATGGCTTGAGCCCAGGACTTTGAAGTTGCTGTGAGCTATAATGACACCACAGCACACTACCCAGGGTGACAGAGTGAGACTGTCTCAAAAAAACAAACAAACAAAAAAAA","AACAAACGTTAGCCGAGCATGGTGGTATGTGCCTGTAGTCCCAGCTACTTGGGAGTCTAAGGCAGGAGAATTACTTGAGCCCGGGAGGCAGAGGTTGCTGTGAGCCAAGATCACGCCACTGCACTCCAGCCTGGGTGACAGAGTGAGACTCCATCTCAAAAAAAAAAAAGGAAAAAAAAAAA"
"GL873580","8760922","8761015","chr11","104681322","104681416","19","95920400","GGAGGGAGACACTGCAGTGAACTGCGATCGTGTCTCTGCTTTCCAGGCTGGGTGACAGAGTGAGACTCGGTCTCTAAAATAAAAAATAAATAAA","GGAGACGGAGGTTGCAGTGAGCTGTGATCGCGGCACTGCACTCCAGCCTGGGCAACAGAGTGAGACTCTGTCTCAAAAATAAATAAATAAATAAA"
"GL873580","9391260","9391306","chr14","49279240","49279285","12","39887980","GCCAGTCGAGGTGGCTCACACTTGTGATTCCAGCTACTTGGAAGACT","GGCTGAGATGGTGGCACACACCTGTAATCCCAGCTACTTGGGAGGC"
"GL873581","759283","759365","chr6","46535476","46535542","30","45776193","TAAGAACCTGAAAATAGAGCCAGGCATAGTGGTACATGCGTATAGTCCTGGCTACTCAGGAGGTTGAAACAACAGGATTACTT","CAAAATAGCCAGGCTTGGTGGTGCATGCCTATAATCCAAGCTACTCGGGAAGCTGAGGCAGGAGAAT"
"GL873581","1145844","1145979","chr1","29437872","29437991","29","28292028","GGCCGGGCGTGGTGGCTCACGCCTGTAGTCCCAGCACTATGGGAGGCCGAGGCGGGTGGATCACCTGTGCTCAGAGGTTCGAGACCAGCCAAGACCCCCCTGAGCCAAATGAGCCAGAGTGAGACCCCGTCTCTAC","GGCCGGGCGTGGTGGCTCACGCCTGTAATCCCAACATTTTGGGAGGCCAAGGCGGGTGGATCACCTGAGGTCAGAAGTTCGAGACCAACCTGGCCAACATGGTGAAACCCCTGTCTCTAC"
"GL873581","9628238","9628362","chr5","141044567","141044691","34","131416329","ATCCCAGGTAGTCGGGAGGCTGAGGCAGGAGGATCACTTGAACCCAGGAGGTTGAGGTTGCTGTGAGCAAGGCAGAGGCAACGGCACTCTAGCCACGGGGGCACAGAGACTCTTGTCTTTAAAAA","TAATCTCAGCTACTCGGGAGGCTGAGGCAGGAGAATCGCTTGAGCCCAGAAGGTGGAGGTTGCAGTGAGCCAAGATCGCGCCATTGCACTCCAGCCTGGGCGACAGTGCGAGACTCTGTCTCAAA"
"GL873582","1580485","1580534","chr6","32576760","32576806","12","30996275","CAGCACTTGAGAGGCCAAGGCAGGTGGATCAACTGAGCAAGAATGAGACC","CCAGCACCTTGAGAGGCCAAGGCAGGTGGATCACCTGAGGTCAGGAG"
"GL873582","1644368","1644551","chr1","211626449","211626612","63","209982081","AAAATTTGCCGGGCTCCATAGCTCATGCATGTAATCATAGCACTCTGGGAGGCCAAGATGGGAGGATCTCTCAAGCTCTCTTACTTGGGAGGCTGAGGTTGCTGTGAGTTAGGCTTACGCCACAGCACTCTACTCTAGCGTGAGCAACTCTACTCTTAGTATGAGACTGTCTCAAAAGAAAAAA","AAATTAGCCAGGCGTCGTGGCACATGCCTGTAATCCCAGCTACTCGGGAGGCTGAGGCAGGAGAATAGCTTGATCTCGGGAGGCGGAGGTTGCAGTCAGCCGAGATCACACCACTGCAATCCAGCCTGGACAACAGAATGAGACTCCATCTCAAAAAAAACAAA"
"GL873582","5794385","5794459","chr13","18872784","18872852","27","13078399","ATATTGTTAAGCACAGCCACTATTAAAAATTAAATTATAGGCCAGGCATAGTGGCTCATGCCTGTAATCCTAGCT","TGAAACCACCATCTGGACCAAGATACAAAATGTTGGCTGGGCATGGTGGCTCACACCTGTAATCCTAGC"
"GL873583","102645","102683","chr14","5808766","5808804","14","5706121","GAGCAGATCACCTGAGCTCAGGAGTTTGAGACCAGCCTG","GAGGAATCCCTGTGCTCAGGAAGCTTACATTCTAGTGAG"
"GL873583","6200447","6200560","chr4","17786849","17786963","24","11586402","GGCCAGGAGGGACGGCTCATGCCTGTTATCCTAGCACTATGGGAGACTGAGGTGGGAGGATCACTTGAAGTTAGGAGTTCCAGACCAATCTGACCAAAGTGAGACCTCATCTCT","GGCCAGGCTTGGTGGCTCATGCCTGTAATCTTAGCACTTTGGGAGGCTGAAGTGGGTGGATCACTTGAGGTCAGGAGTTAGAACCAGTCTGGCCAACATGGTGAAACCTCAGCTC"
"GL873583","6200584","6200752","chr6","169626528","169626696","42","163425944","TTAGCTGGATGTGGTAGCACATGCCTATAGTCCCATCTACTCAGGAGGCTGAGACAAGAGAGTTGCTTAAGCCCAGGAGTTTAATTTAACTGTGAACTAGACTGAGACTGTGGCACTCTAGCTGGGGCAACAGAGTGAGACTCTGTCTCAAAAGAAAGCAAGAAAGAAA","TTAGCTGGGTATGGTGTCAGATGCCTGTAGTCCCAGCTACTCAGGAGGCTGAGACAGGAGAATCGTTTGAACCCAGGAGGCCAGAACTGCAGTGAGCTGAGATTCGCACCACTGCGCTCCAGCCTGGGCCAGACAGAGTGAGACTCTATCTCAAAAGAAAAAAAAAAAA"
"GL873583","10217398","10217583","chr3","36257142","36257313","44","26039744","TACTAAAAATAAAGTGTGATAGCCAGGCATGGTGGTGGTGCCTATAGAACCAGGCTATTCAGGAGGCTGAGGCAGAAGGATCACTTGAACCCAGGAGTCTGACGTTGCTGTGAGCTAGGCTGGTGCCATGGTACTCTAGCCTGTGGTAACAGAATGAGACTCTATCTCAAAAATAAAAATAAAAAA","TACAAAATTAGCCAGGCGTGGTGGTGCGTGCCTGTAATCCCAGCTACTTGGGAGGCCGAGGCAGAAGAATGACTTGAACCCAGGAGACAGAGGTTGCAGTGAGCCAAGATCCCACCATTGTACTCCAGCCTGGGCAACACAGTGAGACTCCATCTCAAAAAAAAAAAAAAAA"
"GL873583","10394919","10394983","chr16","12841703","12841771","22","2446784","GAGGTCAGGAAATCAAGATCAGTCTGGGCAATATATTGATACCCTGCCCCTACATAAGGAAGAAA","AGGTCAGGAGTTCAAGACCAGCCTGGCCAATATGTTGAAACCTCATCTCTACTAAAAATACAAAAATTA"
"GL873584","521512","521529","chr1","167402212","167402233","10","166880700","GCATGGAACCCCCCACTC","GGTGAAACCCCATCTTTACTAA"
"GL873584","2079725","2079768","chr15","4338291","4338335","11","2258566","GGCAGGTGGATTACCTGAGTTCAGGAGTTGGAGACCAGCCTGAC","AGGCGGATGGATCACGAGGTCGGGAGTTTGAGACCAGCCTGACCA"
"GL873584","5216877","5217053","chrX","91350057","91350230","49","86133180","CTACTGAAAATGATGACAGAGGCTGGGCATGGGGGCTCCCGCCTGTTATCCTAGCACCCTCGGAGGCTGGGGAATGAGGATTGCTTACGCCCAAGAGTTTGAGGTTGCTGTGAGCTGAGGCCGCTGCACTCTAGCCTGGGCAACAGAGTGAGACTCTGTCTCAAAAAAAAAAAAAAA","TGCAAAAATGAGCTGGGCATGGTGGCACATGCCTGTAATCCCAGCTACACAGGAGGCTGAGGCAGGAGAATCGCTTGAATCTGGGAGGCGGAGGTTGCAGTGAGCTGACATCAGGCCCCTGCACTCTAGCCTGGGCCACAGAGCAAGACTCCGTCTCAAAAAAAAAAAAAAAAA"
"GL873584","7289930","7289950","chr2","51453328","51453345","10","44163398","TGAGGCTCTGTCTCGAAATAA","AATGCCATCTATTAAAAA"
"GL873584","7289975","7290131","chr11","49739997","49740154","37","42450022","CAAGAAAATTAGCTGAGAGTCCTGGTAGGTGCCTGTAATCCCAGCTATTCATGAGGCTGAGGCAGAAGGATCACTTGGGTCCAGGAGTCTGAGGTTGCTGTGAGCTAGTCTGACGCCATAACACGCAAGCCTGGGCAACAGAGTGAGGCTCGGTTTC","CTACAAAAATTAGCTGGGCGTGGTGGCACATGCCTGTAATCCCAGCTACTCGGGAGGCTGAGGCAGGAGAATCACTTGAGCCCAGGAGGCGGAGGTTGCAGTGAGCCAAGATCATGCCATTGCACTCCAACCTGGGCAACAGAGCAAGACTCCATCTC"
"GL873584","7577743","7577867","chr5","48394329","48394446","27","40816586","GGCTGGATGAGGTGGTTCATGCCTGTAATCCTAGCACTCTGGGAGGCCAAGGTGGGTGGATTGCCTGAGCTCAGGAGTTCAAGACCAGCCTGAGCAAGACCCTGTCGCTAAAAATAGCTGGGTGT","GGCTGGGTGCAGTGGCTCATGCCTGTAATCCCAGCACTTTGGGAGGTCAAGGCGGGTGGATCACCTGAGGTCAGGAGTTCAAGACCAGCCTGGCCAACATCTCTACTAAAAATACAAA"
"GL873584","7578135","7578289","chr1","130112713","130112865","31","122534578","GGAGCTGGGTTTTGTGACTGCACCTGTAATCCCAGCTGCTCAGGAGGCTGAGGCAAGAGAATTGCTTGAGCCCAGGAGTTGGAGGTTGCTGTGAGCTGTGATGCCAGGGAACTCTACCAAGGGTGACAAAGTGAAACTCTGTCTCAAAAAAAAAA","TTAGCCAGGTGTGGTGATGCATGCCTGTAATCCCAGCTACTCATGAGGCTGAGGCAGGAGAATTGCTTGAACCTTGGAGCTGGAGGTTGCAGTGAGCTGAGATCAGACCACTCCAACCTGGGTGACAGAGCGAGACTCTGTCTCAAAAAAAAA"
"GL873585","1450952","1451121","chr10","59681079","59681242","48","58230127","TAAAAACAGAAAAAACTAGTCAGGTGGTGTGGTAGGTGCTCATAAGTCCCAGCTGCTTGGGAGACTGAGGCAAGAGAATCACTTGAGCACAAGAGCTTGAGGTGGCTGTGAGCTATAACACCATAGCACTGTACTGAGGGTGACAAAGTAAGACTCTGTCTCAAAAAAAA","TACAAAAATTAGTCAAGGGTGGTGGTATGTGCTTGTAATCCCAGCTATTTGGGAGGCTGAAGCAGGGGAATCCTTGAACCCAGGAGGTGGAGGTTGCAGCGAGCCGAGATCACGTCACTGCACTCTAGCCTGGGCGATAGGGTGAGACTCTGTCTCAAAAAAAA"
"GL873585","1451382","1451515","chr6","17405813","17405948","24","15954431","GGCCCGGCTCGGTGGCTCACACCTATAATCCTAACACTCTGGGAGGCTGAGGCAGGTGGATCACCTGAGCTCAGGAGTTTGAGACCAGCTGAGCAAAAACAAGACCCTATCTCTGCTAAAAATAGAAAAAACTA","GGCCGGGCGGGGTGGCTCACGCCTGTAATCCCAGCACTCTGGGAGGCCAAGGCAGGTGGATCACCTGAGGTCAGGAGTTTGAGACCAGCCTGGCCAACACGCAGAAACCCTATTTCTACTAAAAACACAAAAATTA"
"GL873585","1626960","1627026","chr7","17782729","17782794","22","16155769","AAGATGCCACAGCACTCTACAAGAGTGACCAAGTGAGACTCTGTCTCAAAAAAAAAAAGAAAAGGAA","CAATCGCACTACTGCACTTCAGCCTGGGTGACAGAGTGAGAACCTGTCTCAAAAAAATAAATAAAA"
"GL873585","1627304","1627531","chr11","17033552","17033788","61","15406248","GGCTGGGCACAGTGGCTCACGGCTATAATCTAGGCACTTGGGAGGCTAGGGCAGGTGGATTGCCTGAACTGACAAGTTTGAGACCAACCTGAGCAAGAGCGAGACCCCTGTCTCTAAAACATAGCCAGGCTCTGTGGTGGGCGTCTGTAGTCCCAGCTACTTGGGAGGCTGAGGCAAGAGAATTGCTTGAACTCAAGAGTCTGAGGTTGCTGTGAGTTAAGATGCCAC","GCCCGGCGCAGTGGCTCACGCCTGTAATCCCGGCACTGTGGAGGCCAAGGCAGGCGGATTGCCTAAGCTCAGGGATTCGAGAACAGCCTGGGCAACATGGTGAAACCCCATCTCTACTAAAATACAAAAAACTAGCCGGGCGTGGTGGTATGCGCCTGTAATCCCAGCTACTTGGGAAGCTGAGGCAGGAGAATTGCTTGAACCCGGGAGATGGAGGTTGCAGTGAGCTCAGATCAC"
"GL873585","3626082","3626158","chr1","100916857","100916922","27","97290775","TGCCTGTAATCCCAGCACTTGGGAGGCGGAGGTGGGTAGATTGCCTGACCCAGAGTGGGACCTCATCTCTAAAAGAA","CATGCCTGTAATCCCAGCACCTTGGGAGGCCAAGGTGGGTGGATCACCTGAGGTCAGTAGTTTGAG"
"GL873585","8849829","8849913","chr18","48581945","48582025","18","39732116","GGCTGGACGAGGGGACTCATGCCTGCAATCCCAGCACTGAGAGAGGCCAAGGCAGGTGGATCCCCTGAGCTCAGAAGTTTGAGAC","GCTGGACGCAGTGGCTCACACCTGTAATCCCAGCACTTTGGGAGGCCAAAGCAGGCAGATCTGAGGTCAGGAGTTTGAGAC"
"GL873585","9319890","9319971","chr8","79499361","79499447","14","70179471","GGCCAGGTGTGGTGGCTCACACCTGTCATCCTAGCACTCTGGGAGGACGAGGTGGGTGGACCGCCTGAGTCAGAGTGAGACC","GGCCAGGTGTGGTGGCTCACACCTGTAATCCCAACACTTTGGGAGGCCCAGGTGGGTGGATCACCTGAGGTCAGGAGTTCAAGACCA"
"GL873586","895572","895692","chr17","14501559","14501680","38","13605987","GGCCAGGTGAGGTTTCTCATTCTGGGAGTGAGCCAGCAATTGGGAGGCCAAAGTAAATGGATTGCCTGAGGTTATAGGTTCCAGAACAGCCAGAACAAGATCGAAATCCTGTCTCCAAAAA","GGCCAGGCGTGGTGGCTCATGCGTGTAATCTCAGCACTTTGGAAGGCCGAGGCAGGTGGATCACCCGAGGTCAAGAGTTCAAGACCAGCCTGACCAACATGGCGAGTCTCTGTCTCCACTAA"
"GL873586","5645995","5646150","chr6","58863249","58863409","38","53217254","GGGTATGGTGGCTCATGCCTGTAATCCAAGCACTCTGGGATGGTGAGGCAGGAGAATCCCTTGAACCCAAGAGTCCGAGGTTGCTGCGAGCTAAGCTGATGGCATAACACTCTAGCCTAGGCGACAGAGTGAGACTCTGTTTCCAAAGAGAAAAAA","TTAGCCAGGCATGGTGGCACATGCCAGTAATCCCAGCTACTCAGGAGGATGAGGCAGGAGAATCGCTTGAACCCAGGAGGCAGAGGTTGCAGTGAGCTGAGATTGCGCCACAGCACTCTACCCTGGGTGACAGAAGGAGACTCTGTCTCAAAAAAAAAAAA"
"GL873586","10258686","10258969","chr12","9481260","9481565","81","777426","GGCCGGGCATGGTGGCAGAAATCTAGGAGGCCGAGGCAGGTGGATCGCCTGAGATCACAAGTTCAAGACCAGCCTCAGCTACAGCAAGACCCCATCTCTAAAAATAGCCGGCTGTTGTGGCAGGCGCCTGTAACCCCAGCTACTCGGGAGGCTAAGGCAAGAGAATCGCTTGAGCCCATGAGTCTGAGGTTGCTGCGAGCTGTGACTCCACGGCACTCTACCCGGGGCGATAAAATGAGATTCTGTGTCAAAACAAACAAACAAACAAACAACAACAAAAACAA","GCTGGGCGCGGTGGCTCATGCCTGTAATCCCAGCACTTTGGGAGGCCAAGGCAGGTGGATCACCTGAGGTCAGGAGTTCGAGACCAGCCTAGTCCACATGGTGAAACCCCATCTCTACTAAAAACTAGCCAGGCGTGGTGGTGCGCACCTGTAATCCCAGCTACTCGAGAGGCTGAGGCAGGAGAATCACTTGAGCCTAGGAAGCAGAGGTTGTGGTGAGCTGAGATCACACCACTGCACTCCAGTCTGGGCGACACAGTGAGACTCTTGTCTCAAAAACAAAAAACAAACAAACAAACAAACAAA"
"GL873587","3208032","3208047","chr8","3626746","3626762","2","418714","AAACAACCACAAAAAA","ACAACAACAACAAAAAA"
"GL873587","3208141","3208321","chr19","2057131","2057316","59","1151010","TTTCTTTTAAAAATCACCCATGGGCTGGGTATAGTGGCTCACACCTATAATCCTCGGGAGGCCAAGGTTGGAGGATTGCTTGAATCCAGGAGTTGAAGGTTACAGTGAACTGGGATTTAGCCACTAGACTCTAGCATAGCTGACAAAGCAAGAACCTATTTGTTTAAAACACAAAAAAGAA","TACTAATAATACAAAAATGAGCCGGGTATGGTGGCGGGTGCCTGTAATCCCAGCTACTGAGGAGGCTGAGGCAGGAGACTTGCTTGAACCCAGGAGGTAAAGGTTGCAGTGAGCTGAGATTGCACCACTACACTCCAGCCTGGGCGACAAGAGCAAAACTTTTTCTCCAAAAAAAAAAAAAAAAAA"
"GL873587","3278260","3278367","chr19","19044200","19044312","39","15765940","CAGTCTGAGCAAGAGGGAGAGGCTATTTCTACTAAAAACAGAAAAACTAGCTGGGTGTTGGGGTGTGTTCCTAGTCTCAGTTACTTGGGAGGCTGAAGTAAGAGGATC","ACCAGCCTGGCCAACACGGTGAAATCCCGTCTCTACTAAAAATACAAAAATTACCTAGGCGTGATGGCACGTGCCTGTAGTCCCAGCTACTCATAAGGCAGAGGTGAGAGAAT"
"GL873587","3278673","3278754","chr7","49412503","49412597","28","46133830","GGCCACGAGAGCTAGCTCATGCCTATTCTAGGAGGCCAAAGCAGGCAGACTGCCTGAGCTCAGGAGTTCAAGAGCAGCCTGG","GGCCAGGTGCAGTGGCTCATGCCTGTAATCCGAGCACTTTGAGAGGCCGAGGCAGGCAGATCACCTGAGGTCAGGAGTTCAAGACCAGCCTAGTA"
"GL873587","3782076","3782188","chr9","112128434","112128552","34","108346358","ACTGGGGTGGCTGAGGCAGGAGCGTCACTTGAACTCAGGAGTTTGAGATTGCTGTGAGCTGAGCAGATGTCATGGCACGCTAGCCTAGGTAATAGAGTGAGACTTCGTCTAAA","CAGCTACTCGGGAGGCTGAGGCAGGAGAATCACTTGAACTCGGGAGGCGGAGGTTGCAGTGAGCCGAGATCACGCCATTGCACTCCAGCCTGGGCAACAAGAGCGAAATTCCATCTCAA"
"GL873587","4564996","4565084","chr20","27900350","27900437","14","23335354","GGCGGGGTGTAGTGGCTCATGCCTATTGTCCCAGCACTGTGGGAGGCCGAGGTGGGTGGATCACCTGTGCTCAGAAGTTTGAGACCAGC","GGCCGGGCGTGGTGGCTCATGTCTGTAATCCCAGCACTTTGGGAGGCCGAGGTGGGTGGATCACCTGAGGTCAGGAGTTCAAGACCAG"
"GL873587","6307870","6308175","chr12","112427710","112428020","54","106119840","GGCCAGATATGATGGCTCATGCTTGTAATCCTAGCACTCTGGGAGGCTGAAGTGGGAGGATCACCTGAGATCAGGAGTTCAAGATCACCCTGAGCAAAAGTGAGATCCCATCTCTATTAAAAATAAAAAAATTATCCAGGCATGGTGGTGCAGTCCTTTAGTCCCAGCTACTTGGGAGGCTGAGGCAGGAGAATCTCTTGAACCCAGGAATTAGAGGTTACAGTGAGCTGTGATGATGCTACTGCACTCTAGCAGGATGACAGAGTGAGATACTCCGTGTCAAAAAAAAAAAAAAAAAAAGCAAAA","GGCTGGACATGGTGGTTCATGCTTGTAATCCGAGCACTTTGGGAGGCCAAGGCGGGTGGATCACCTGAGGTTGGGAGTTCGAGACCAGCCTGACCAACATGATGAAACCCCATCTCTACTAAAAATACAAAAAAATTAGCCAGGCATGGTGATGCACGCCTGTAATCCCAGCTACTTGGGAGGCTGAGGCAGGAGAATCACTTGAACCCAGGAGGCAGAGGTTACAGTGAGCCGAGATCATGCCATTGCACTCCAGCCTGGATGACAGAGTGAGCCTCTGTCTCAAAAAAAAAAAAAAAAAAAAAAAAAAA"
"GL873587","6484004","6484128","chr10","67341428","67341546","29","60857424","GACCAGGTTCTGTGGCTCATGCTTGTAATCCTAGCACTCTAGGAGGCCGGAAGAGGGTGGATTGATTGCCTGAGGTCAGGAGTTAGAGACCAGCCTGAGCAAGAGCTAGACCCTGTTTCTTTCTT","GGCTGGGTGTAGTGGCTCATGCCTGTAATCCCAGCACTTTAGGAGGCCAAGGTGGATGGATTGCCTGAGCTCAGGAGTTCGAGACCACCCTGGGCAACAAGCCAAAACCCTGTCTCTAC"
"GL873587","6484407","6484586","chr3","167196537","167196723","48","160712130","TAGACCCTGTTTCTAAAAAAAAAATAGCCAGGTGTTGAGGCAGGTACCTGTAGTCCCAGCTACCTGGGAGGGCTGAGGCAAGAGAATCGCTTGAACCCAAGAGTTTGAGGTTGCTGTGAGCTGAGATGCTATGGCACTCAACCGTGAGCTACAAAGTGAGACTCTGTCTCAAAAAAAAAA","AAAACCTGTCTCTGCTAAAAATACAAAAATTAGCCGGGTGTGGTGATGTGCGCCTGTAGTCCTAGCTACTTGGGAGGCTGAGGCAGGAGAATCACTTGAATCCAGGAGGTGGAGGTTGTAGTGAGTCGAGATCGTGCGACTGCACTCCAGCCTGGGTGACAGCGAGACTCTGTCTCAAAAAAAAAAA"
"GL873587","7466229","7466364","chr1","29437872","29437991","35","21971643","GGCCAGGCGTGGTGGCTCATGCCTGTAGTCCCAGCGCTATGGGAGGCCGAGGTGGGTGGATCACCTGTGCTCAGAGGTTCGAGACCAGCCAAGACCCCCCTGAGCCAAATGAGCCAGAGTGAGATCCCATCTCTAC","GGCCGGGCGTGGTGGCTCACGCCTGTAATCCCAACATTTTGGGAGGCCAAGGCGGGTGGATCACCTGAGGTCAGAAGTTCGAGACCAACCTGGCCAACATGGTGAAACCCCTGTCTCTAC"
"GL873588","1502535","1502718","chr1","34852429","34852590","60","33349894","GGTGCAGTGGCTCACACCTGTTGTCCCAGCGCTGTGGGAGGCCGAGGTGGGTGGATCACCTGTGCTCAGAGGTCGAGACCAGCTGAAGACCTGCCTGAGGCAGAGTGAGCCAGAGTGAGACCCCGTCTCTACTAGAACAACAACAAGACAGCCAGACCTTGTGATCCCAGCTACATGGGGGGCT","GCCAGGTGCAGTGGCTCACACCTGTAATCCCAGCACTTTGGGAGGCCGAGGCGGGCGGATCACCTGAGGTCAGGAGTTTGAGACCAGCTTGACCAACATGGAGAAACCCCGTCTCTACTAAAAATACAAAATTAGCCTGGTGTGGTGTCGCATGCCTGTAAT"
"GL873588","10189037","10189246","chr3","45604681","45604903","65","35415644","GCTGAGATGAGGAGACTCTGTCTCTATTAAAAATAGAAAAATTGGGTGGATGTTGTGGGTACTGTAGTTGCAGCCTCTTGGGGGGCTAAGGCAGGAGGATCAGTTGAAGCCAGGAATTTGCTTTGAGCTAGGCTAAAGCCATGGCACTCTAGCCTGGGCAACAGAGTGAGGCTAGATCTCAAAAAAAGAAAGAAAAGAAAAAGAAAAAAA","CTGGCCAACATGGCAAAACCCCATCTCTACTAAATATACAAAAATTAGCTGGACGTGGTGGCACATACCTGTAATCCCAGCTACTTGGAAGGCTGAGGCAGGAGAATAGCTTGAACCTGGGAGGCAGAGGTTGCAATGAGCTGAGATCACGCCACTGCACTCTAGCCTGGGCAATAGAATGAGACTCTGTCTCAAAAAAAAAAAAAAAAAAAAAGACAAGAAA"
"GL873589","104719","104807","chr20","27900350","27900437","13","27795631","GGCTGGGCGTGGTGGCTCATGCCTGTTGTCCCAGCGCTGTGGGAGGCTGAGGTGGGTGGATCACCTGTGCTCAGAGGTTCGAGACCAGC","GGCCGGGCGTGGTGGCTCATGTCTGTAATCCCAGCACTTTGGGAGGCCGAGGTGGGTGGATCACCTGAGGTCAGGAGTTCAAGACCAG"
"GL873589","796766","796905","chr1","166346372","166346487","49","165549606","GGCTAAGTGTGGTGGCTCACACCTGTCATCTAGTACTTTGGGAGGGTGGGCCTGGGAGTTCAAAGACTGAACTCAGGAGTTCAAGGTGGCTCCGGGGAGGAATTCAAGACCAACCTGAGCCAGAGCGAGACCTCGACTCT","GGCCAGTGGGGTGGCTCACGCCTGTAATCCCAGCACTTTGGGAGGCTGAGGTGGTCAAATGACCTGAGGTCAGGAGTTTGAGACCAACCTGGCCAACATGGTGACACCTCGTCTCT"
"GL873589","1023679","1023690","chr1","205890061","205890072","1","204866382","AAAAAAAAAAAA","ACAAAAAAAAAA"
"GL873589","1023771","1024047","chr4","103012712","103012993","70","101988941","GGCTTGGTGGCTCACACCTGTAATCCTAGCACTCTGGGAGGCCGAAGTGGCTGGAATACTTGAGGTCAGGAGTTCAAGACCAGCCTAAGTGAGAGTGAGATCCCCATCTCTAATAAAAATAGAAAAATTAGCAGGGTGTTGTGGCTGGCACTTGTAGTCCCAGCTACCCAGGAGACCGAGGCAGAAGTTTGAGATTATTGTGAGCGAGGCTGATGCCACAGCATTCTAGTGGGACAACAGAGCAAAATTCTATCTCAAAAGAAAAAAAAAAAAAGGA","CGGGCGTGATGGCTCACGCCTGTAATCCCAACACTTTGGGAAGCCGAGGCGGACGTATCACCTGAGGTCAGGAGTTCAAGACCAGCCTGGCCAACATGGTGAAACCCCGTCTCTACTAAAAATACAAAAATTAGCTGGGTGTGGTGGCATGCGCCTGTAATCCCAGCTACCCAGGAGGCTGAGGCAGGAGAATCGCTGAGGCTGCAGTGAACTGAAATTGTGCCACTGCACTCCAGCCTGGGTGACAGAGCAAGACTCTGTCTCAAAAAAAAAAAAAAAAAA"
"GL873589","4820958","4821024","chr8","33633747","33633811","15","28812789","TTAGTCAAGTGCAGTGGCTCACACCTGTCATCCCAGCTACTTGGGAGGCTGAGGCAGGAGAGTTGCT","TTAGCCAGGTGTGGTGGTGCATGCCTCTAATCCCAGCTACTCAGGAGGCTGAGGCAGGAGAATTG"
"GL873589","6763768","6763857","chrX","25814002","25814092","29","19050234","GGTGTGGTGGCTCACACTTGTATCTTAGCATTTTAGGAGGCTGAATGGGGAGAATTGCTTTAAGTCAGGAGTCTGACTTCCACCTTGCCA","GGCTGGGAATGGTGGCTCACACCTGTAATCCCAGCACTTTGGGAGGCTGAGGTGGGCAGATCACCTGAGGTCAGGAGTTTGAGATCAGCCT"
"GL873589","8444551","8444632","chr9","93194085","93194171","17","84749534","CGGGCATGGTGGCTCACAACTATAATCTTAGCACTTTGGGAGGCTGAGACAGGTGGATGCCTGAACTCAAGAGTTTGAAACC","GGCCGAGCATGGTGGCTCACACCTGTAATCCCAGCACTTTGGGAGGCTGAGGCAGGTGGATTACCTGAGGTCAAGAGTTCAAGACCA"
"GL873589","9085365","9085494","chr2","194063347","194063481","42","184977982","GGCCAGGCACAGTGGCTCACACCTATAATCCCAGCACTCTGTGAGACTGAGGCAGGTGAACTGTTGCAAGAGTGAGACCCTGTGCTTGGTGCCTGTAGCTCAGTGGTTAATAATAAGAAAAAAGAAAAAA","GGCCAGGTGCAGTGGCTCACACCTGTAATCCCAGCACTTTGGGAGTCTGAACCAGGCAGATCACCTGAGGTCAGGAGTTCGAGGCCAGCTCGGCCACCATGGTGAAACCCTGTTTCTAATAAGAATACAAAAAAA"
"GL873589","9085767","9086002","chr7","84631446","84631650","75","75545679","GAGTGAAACCCTGTCTCTACTAAAAATAGAAAAACTAGCTGTGCATCAGGGCGCATAACTGTAGTCCCAGGTACTCAGGACACTGAGGCAAGAGAATTGCTCAAGCCCAAGAGTTTGCAAGAATTTGAGGTTGCTATGAGCTATGATGCCATGGCACTCTACCTAGGGTGACAGACAGAGACTCTGTCCCAAAAAAAAAAAAAGAAGAAGAAGAAAAAAAAAAAGAAAGAAAGAAA","ATAGTGAAACCTCGTCTCTACTAAAAATACAAAAATTAGCTGGGCATCATGGTGCACGCTTGTAATTCCAGCTACTTGGGAGGCTGAGGCAGGAGAATTGCTTGAACTCAGGAGGTGGAGGTTGCAATGAGCCAAGATCGCGCCACTGCACACCAGCCTGGGTGACAAAAGACTCTGTCTCAAAAAAAAAAAAAAAAAAAAAAAA"
"GL873589","9992904","9993045","chr16","56427538","56427666","46","46434634","AACCAGCCAGGCATGGTGATTCACACCTATAATCCCAGCTACTTAGGAGTATGGCTTGAGCACACAGGATACCATACCATTCTAGTCATCCCAGGCAACAGAGGGAAACTCTGTTGGTTAAAAAAAAAGAAAAACTTAAAAA","TTAGCCAGGAGTGGTGGTGCACGCCTATAATCCCAGCTACTTGGGAGGCTGAGGCACAAGAATCACTTGAACCATTGCACTCCAGCCAGGGTGATAGAGGGAGACTCTATCCAAAAAAAAAACAAAAAA"
"GL873589","9993319","9993452","chr3","2774534","2774668","28","7218785","GGCCTGAGCCCTGTGACTCATGCCTGTAATCCCAGCACTGGAAGTTCCAAGGCAGGTGGATCGCTTGAGCTCTGGAGTTCAAGACCAGCTCAACCAAGAGTAAGACCCCATCTCTACTAAAAATAGAAAAACCA","GGCTGGGCACGGTGGCTCATGCCTGTAATCCCAGCACTTTGAGAGGCCGAGGCAGGTGGATCTCCTGAGGTCAGGAGTTCAAGACCAGCCTGGGCAACATGGTGAAACCCCATCTCTACTAAAAATACAAAAAAT"
"GL873590","9044589","9044884","chr1","83754525","83754835","84","74709936","GGCCAGGTGCAATGGCTCATGCCTATAATCCTCACACTCTGGGAGGCTGAGGCAGGAGGATCACTTTTCTCAGGGTCAGGGCCAGCCTGACAAAAGTCAGACCCTGTTTCTACTAAAAATAGAAAAACTAGCTGGGTGTTGTGGCAGATGCCTATAGTCCCAGCTACTAAGAGACTGAGACAAGTGCCCAGAGTCTGAGGTTACTGTGAGCAAAGCTGATGCCATAGCATTCTAGCTATAGATCGAGAGTCTGTCTCAAAAACAAACAAACAAACAAACAAACAAACAAAAAAGAA","GGCTGGGTGTGGTGGCTCATGCCTGTAATCCCAGCACTTTGGGAGGCCGAGGCGGGTGGATCATCTGAGGTCAGGAGTTCAAGACCAGCCTGACCAACATGGTGTAACCCTGTCTCAACTAAAAATACAAAAATTAGCTGGGCGTGGTGGTGTGCACCTATAGTCACAGCTACTTGGGAGGCTGAGACAGGAGAATTGCTTCAACCCAGGAAGTGGAGGTTGCAGTGAGCCAAGATCATGTCACTGCACTGCAGCCTGACAGAGCGAGACTCCATCTAAAACAAACAAACAAAAACAAACAAACAAACAAA"
"GL873591","1831505","1831587","chr17","61702818","61702899","25","59871313","CCCAGCACTTTGGGAGGGCAAGATGGGAGAATCATATAAAGTCAGGAGTTTGAGACCAGTTTGGCAGACATGATGAACCCATC","AATCCCAGCACTTTGGGAGGCTGAGGCAGGCGGATCATCTGAGGTCAGGAGTTCAAGACCAGCCTGGCCAACATGGTGAAAC"
"GL873591","2719175","2719275","chr4","86137755","86137847","32","83418580","GTGGGGGCTTAGGCCTGTAATCCCAGCACTCTGAGAGGCCAAGGTGAGCTGGTCACCTGGGTTTAGGAGTTTGGAGACTTGCTCGAGCTAGACTGAGGCTC","GTGGTGGCTCACGCCTGTAACCCTAACAATTTGGGAGGCCAAGGCAGGTGGATCACTTGAGGTCAGAAGTTTGAGACCAGCCTGGACAATATG"
"GL873591","4732974","4733120","chr19","7991801","7991954","55","3258827","ATACGCAGACTGGCCGAGCGTGGTGTCACATGCCTATAATCCCAGTGGCTACTCTGGGGAGGAGAATCTCTTGAAACCAAGAGTTAGAGATTGCAGTGGGGTATGATACAGGGTAACAAAGAGAGACCTTGGATCTGAAAAGAAAAA","AAAATACAGAAACTAGCTGGGCATGGTGATGCACACCTGTAATCCTAGCTACTGGGGAGGCTGAGGCAGGAGAATTGCTTGAACCCAGGAGTCAGAGGTTGCAGTGAGCAACCAGCCTGGGTGATACAGTGAGTGAGACTCTGTCTCGAAAAAA"
"GL873591","6822728","6823009","chr1","20579766","20580052","72","13757038","GGCCAGGCGTGGTGGCTCATGCCTGTAAATCTCAGCACTCTGGGAAGCTGAGGCAGGTGGATTGCTTGAGGTCAGGAGTTTGAGACCAGCCTGTACCAGAGTAAGACCCTGTCTCTAATAAAAATAGAAAAAAAAAAAAAAACTAGTTGGGCATGGTGATGGGTGCCTGTAGTCCCACCTACTTGGGAGGCTGAGGCAATGGCATCTCTTGAGCCCAAGAGTTTGAGGTTGCTGTGCCATGGCACTCTCCCCAGGGTAACAGAGTGAAAATAAAAAAAAGAA","GGCCAGGCGTGGTGACTCATGCCTGTAATCTCAGCACTTTGGGAGGCCGAGGCAGGTGAATCACCTGAGGTCAGGAGTTTGAGACCAGCCTGACCAACATGGTGAAACCTCGTCTCTACTAAAAATACAAAAAGTAGCCAGGCATGGTGGCGCATGCCTGTAATCCCAGCTACTTGGGAGGCTGAGGCAGGAGAATCGCTTGAACCCGAGAGGCAGAGGTTGCATTGAGTCAAGATGGTACCACTGCACTCCAGCCTGGGTGACAGATTGAGACTCAAAAAAAAAAA"
"GL873591","7578706","7578813","chr16","45055441","45055543","42","37476735","AAATTTAGCTACACATAGTGGCATGAGTCTGTAATGCTAGCCACCCAAAAGGCTGTAGTAAGAGGATTGCTCTATCCCAGGAGTTAAAGACCAGCCCGGACATCAGAG","AATTAGCCGGGCGTGGTGACACACACTTGTAATCCTAGATACTCAGGAGGCGAAGGTAGGAGAATTGCTTGAACCCAGGCAGCAGAGGTTGCAACGAGCAGAG"
"GL873591","9282916","9283004","chr1","20744253","20744338","16","11461337","GGCCAGGCGCGGTGGCTCACCCCTGTTGTCCCAGTTCTGTGGGAGGCCGAGGTGGGTGGATCACCTGTGCTCAGAGGTTTGAGACCAGC","GGCCAGGCACGGTGGCCACGCCTGTAATCCCAGCACTTTGGGAGGCCGAAGTGGGTGGATTACCTGAGGTCAAGAGTTTGAGACCA"
"GL873592","835155","835315","chr16","75654291","75654451","43","74819136","CTGGGTGTGGTGGCTCTTGTCTGCAATCTCAGTACACTGGGAGGCTGAGGCAGAAGGATTGCTCCAGCTCAGGAGTTTGAGGCCAGGCTGAGCTAGTGCAAAACCCCATCTCTACTAAAAAAAGAAGGAAAAAAAAAAGAAAAAGAAAAAAAATACGAGCT","CCAGGTGTGGTGACTCACGCCTGCAATCCCAGCACTCTGGGAGGCTGAGGTGGGTAGATTACCGGAGGTTAGGCGTTTGAGACCAGCCTGGCCAACATGGTGAAACCCCATCGCTACTAAAAAAAAAAAAAAAAAAAAAAAAAAAAAAAAAAAAAAAATTA"
"GL873592","835589","835765","chr1","66836166","66836336","48","66000577","ACAAAAAACCTAGCTTAGGGTTGTTATAGCACCTGTAGTCCCAGCTACTCAGGCGCTAAGGCAGGAAAATCTGCCTGAGCTCAGGAGTTTGAGGTTGCAGTAAGTTATGATGATGCTACTGCACTCTAGCTGGGGCAACAGAGTGAGACTCTGTCTGAGGAAAAACCAAAACCAAAA","TAGCCCAGCACGGTGGCTCACACCTGTAGTCTCAGCTACTCAAGAGGCTGAGGCATGAGAATCGCTTGAACCCAGGAGGTAGAGGTTGCAGTGAGCTGAGATCATGCCACTGCGCTCCAGCCTGGGCAACAGAGTGAGACTCAGTCTCAAAAAACAAAACAAAACAAAAAA"
"GL873592","2520661","2520705","chr16","66853217","66853257","11","64332556","TCTGGGAGGCTGAGGCGGGTGGATCACCTGAGCAAGAGTGAGACC","TTTGGGAGGCTGAGGCAGGTGGATCACTTGAGGTCAGGAGT"
"GL873592","4535248","4535388","chr1","12240468","12240612","38","7705220","GGCGGGATGTGGTGGTTCATGGCTGTAATCCCAGCACTCAGGGAGGCTGAGTCGGGTGGATTGCTTGAGTTCAGGAGTTTGAGACCAACCTGAGCAAGAACTAAGCCTGTCTCTACTAAAGATATTATTTCTTATTTTTCT","GGCCGGGCGCGGTGGCTCATGCCTGTAATCCCAGCACTTTGGGAGGCTGAGGCGGGTGGATCACCTGCGGTCAGGAGTTCGAGACCAGCCTGGCCAACGTGGTGAAACCTCATCTCTACTAAAAATATAAAAATTAGCTGGTGTG"
"GL873592","4535654","4535831","chr8","126054004","126054184","54","121518350","TCTACTACAAATATTAACAGAAAAATTAGCTGGGCATTGTGACAGGTGCCTATAGTCCCAGATACTCAGAAGGCTGAAGTAAGAGGATCACTTGAACCCCAGGAGCTAAGGTGGCTGTGAGCTAGGCTGAGGCTCTAGCCTGGGTAACAGAGTGAGACTGTAAAAAAAGAAAGAGAGA","GTCTCTACTAAAAATACAAAAATTAGCTGGGTGTGGTGGTGCATGCCTGTAATCCCAGCTACTCAGGAGGCTGAGGCAGGAGAATCGCTTGAACCCAGGAGGTAGAGGTTGCAGTGAGCCAAGATCATGCCACTGCACTCCAGCCTGGGTGACAGAGGGAGACTCTGTCTCAATAAATAAA"
"GL873592","6794968","6795049","chr3","154764711","154764794","20","147969743","GAAGGTTTGATGAGCTCAGATGATGCCACTGCAGTCTACCCAGAGTGAAGGAGCGAGACTCTGTCTCAAAAACAAAAAAAGA","CAGAGGTTGGCAGTGAGCTGAGACTGTGCCACTGCACTCCAGCCGGGTGACAGAGTGAGACTCTGTCTCAAATTACAAACAAAA"
"GL873592","6881384","6881478","chr5","24882384","24882475","28","18001000","GGGCAGGCATAGTGACTGGTGTCTCTAATCCTAGCAGTCTGGGATGCTGAGGCAAGTGGAATGTCAGAGTTCAGGAGTTGAAGATCACCCTGACT","GGCCGGGCGCAGTGGCTCACATCTATAATCCTAGCATTTTGGGAGGCTGAGGCAGGCGGATCACCTGAAGTCAGGAGTTTAAGACCAGCCTG"
"GL873592","6881755","6881937","chr10","61601371","61601572","66","54719616","TCACCCTGACCAAGAGCAAGACCCTGTCTCTACTAAAAATAGAATAAACTAGCTGGGAATTGTGGTGGGTGCCAGTAGTCCCCGCTACTGAGGCAGGAGGATCATTGAGTCCAAGAGTTTGAGGTTGCTGTAAGTTAGGACACCACAGCACTCTACACAGAGTAAGACTGCCTCAAAAATAAA","AGTAAAGAAAAGAAACCCTGTCTCTACTAAAAATACAAAAATTAGCTGGGTGTGGTGGTGCGCACCTGTAGTCCCAGCTACTTGGGAGGGTGAGGTATGGGAATCACTTGAACCCGGGAGGTGGAGGTTGCAGTGAGCCAAGATCACACCACTGCACTCCAGCCTGGGTGAGAGAGTGAGACTCTGTCTCAAGAAAAAAGAA"
"GL873592","7006080","7006155","chr1","8947061","8947129","24","1940981","CACACTGAGAGGCAAAGGCTGGTGGATCACCTGAGCTCAAGAGTTTGAGACCAGCCAAGCCAGAGATCTTGTCTCT","CACTTTGGAGCCAGGTAGGTGATCACCTGAGTCAGGAGTTCGAGACAGCCTGGCCAACATGTGAAACCC"
"GL873592","8446508","8446655","chr11","122502739","122502874","48","114056231","TTAGCTGGGTGTTGTGGCAGGCACCTGTAGTCCCTCCCAGCTACTTGAAAGGCTGAGGCAAGATGACAGCTTAAACCCAAGAGTTTAAGGTTACTCTATTCAGGGCAACAGAGTGAGACTCCATCTACATAAATAAATAAATAAATAA","GGCTGGGCGTGGTGGTTCACACCTGTAATCCCAACACTTTGGGAGGCTGAGGCCAGCGGATTGCCTGAGCCCAGGAGTTTGAGACCAACCTGGGCAACATGGTGAAACTCCATCTCTACTAAAATACAAAAAGTTA"
"GL873592","8446953","8447008","chr16","44513352","44513404","15","36066399","GACCAGCCTAAGCAAAAAAGAGATCCTATCTCTACTACTAAAAATAGAAAAAATTA","ACCAGCCTCACCAATATGAAGAAACCCCATCTCTACTAAAAATACAAAATATT"
"GL873592","8447239","8447325","chr1","8062863","8062957","21","384376","GGCCAGGAGCAGTGACTCATGCCTAGCACTCTGGGAGGCCAAAGCAGGTGGATCAACTGAGCTCAGGAGTTCAAGACCAGCCTAAGC","GGCCGGGTGCAGTGGCTCATGCCTGTAGTCCCAGGACTTTGGCAGGCCAAGGCCGGTGGATTACCTGAGGTCAGGAGTTCAAAACCAGCCTAGCC"
"GL873592","8723925","8724000","chr3","42066983","42067054","20","33343058","AATTAGCCGGGCATGGTAGTGTGTGCCCATAATCTCAGCTACTCAGAAAGCTAAGATAGGAAAATTGCTTGAGCTC","TTAGCTGGGTGTGGTAGTGCATGCCTATAATCCCAGCTACTCGGGAGGCTGAGGTGGGAGAACTGCTTGAAC"
"GL873593","384022","384146","chr15","102382935","102383070","28","101998913","GGCCACGAGGGCCCATGCCTGTAATCCTAGCACTCTGGGAGGCTGAGGTGAGTAGATTGCTGAGCTCAGGAGTTCAAGACCAGCCTGTGCAAGAGACCCCATCTCTGCTAAAAATAGAAAAACCA","GGCCAGGTGTGGTGGCTCACGCCTGTAATCCTAGCACTTTGGGAGGCTGAGGCGGGTGGATTGCCTGAACTCAGGAGGTCAAGACCAGCCTGGGCAACACAGTAAAACCCCATCTCTACTAAAATACAAAAAATCA"
"GL873593","384425","384607","chr20","28286874","28287058","50","27902449","GAAAGAAAAGAAAAGAAAAACTAGCAAGATGTTGTAGCTGATGCCTATAATCCTAGCTATTGGAGAGGTGGAGGCAAGAGAATTGCGTGAGCCCAAGAGTTGAAGGTTGCTGTGAGCTGCGATGCCAGAGCACTCCAGGGTGACAGAGTAAGACTCTGTCTCAAAAAAAATTACAAAATAAAA","TAATAAAAATAAAAAAATTAGCCAGGAGTCAAAGCACACGCCTATAACCCCAGCTACTTGGGAGGCTGAGGGAGGAGAATTACTTGAACCCGGGAGGTGAAAGTTGCAATGAGCTGAGATCAAGCCACTGCACTCCAGACTGGATGACAGAGTGAGACTCTGTTTCAAAAAAAAAAAAAAGACAA"
"GL873593","1408445","1408467","chr10","88070368","88070389","9","86661923","AATCTAGAGATGGGGAGAGGTTG","AAAGAGATGGAAGAGAAGAAGA"
"GL873593","4856365","4856484","chr7","56497314","56497433","31","51640949","GCAATCCCAGCTGATCGGGAGGCTGACCCAGAAGAATCCCTTGAACCCAAGAGTCTGAGGTTGCTATGGGTGGATTCTACAGCACTCTAGCCTGGGAGACAGAGTGAGACTCTGTCCCAA","ATCCCAGCTACTTGGGAGGCTGAGACAGAAGAATTGCTTGAACCCGGGAGGTGGAGGTTGCAGTGAGCCAAGATTGTACCACTGCACTCCAGCCTGGCAACAGAGTGAGACTCTGTCTCA"
"GL873593","6661298","6661485","chr10","86749316","86749514","55","80088018","GCAGAGGCTCACATATGTAATCCTAGCACTCTGGGAGGATAAGGCAGGTGGACAGCTTGAGCTCAGGGGTTTGACCAGTCTGATCAAGAGCAAGACCTGTGTCTACTAAAAATAGAAAACCTAGCCAGGTATGATGGTAGATGCCTGTATTCCTAGCTACTCTGGAAGCTAAAGCTAAAGAGTTTGAA","GGTGGCTCACACCTGTAATCTTAGCAATTTGGGAGGCCGAGGTGGGTGGATCACTTGAGGTCAGGAGTTTGAGACCAGACTGGCCAACATGGTGAAACTCTGTCTCTACTAAAAATACAAAAATTAGCCAGTCATGGTGGTGCATGCCTGTAATCCCAGCTACTCAGGAAGCTTAGGCAGGAGAATCACTTGAACCCAG"
"GL873593","6710263","6710446","chr14","4390080","4390244","66","2320183","TTGAAGTCAGGAGTTTAAGGCCAGTCTGGGCAACATAGTGAGACCCCCATCTCTACGAAAATATTTTTTAAAAATTAAAAATAGCTGGGCATAGTGAGGCTGTTGTGAGCTATAACTGCACCACTGCACTCAGCCAAGGACAGAGACCCTGTTCCCTGCCTCAAACAAACCAAAACAAAACAAA","AAGTCTAGAGTTTACAGCCTGGACAACGCAGTGAAACCCTGTCTCTACCAAAAATACAAAAATTAGACAGGTGTGAGAGGCGGAGGTTGCAATGAGCTGAGATCGCAGCACTGCAGTCCAGCCTGGATGACAGAGCGAGACCCCATCTCAAAAACAAAAACAAAA"
"GL873593","7159645","7159716","chr6","178318394","178318465","21","171158749","GATCATGTCACTGCTCTCCAACCTGGGCAATTGAGCAGGAATCTGTCTCAAAAAGAAAAAAAAAAAAGAAAA","CGAGTTCACACCACTGCACCCCAGCCTGGGCAACAGAATGAGACTCGGTTTCAAAAAAAAAAAAAAAAAAAA"
"GL873593","7159841","7160050","chr13","33368171","33368368","69","26208330","GGCCAGGCGTGGTGGCTCACACCTGTTGTCCCAGTGCTGTGGGAAGCCGAGGCAGGTGGATCACCTGAGCTCAGCCGAGTTCGAGACCAGTGGAAGACCAGCATGAGGCAGAGTGAGCCAGAGTGAGACCCCATCTCTACAACAACAACAAGAAGAAAAAAAACAGCCGGACCTTGTGATCCCAGCTACGTGGGGAGCTAGAGAATCACT","GGCTAGGCATGGTGGCTCATGCCAGTAATCCCACCACTTTGGGAGGCCGAGGCAGGTGGATCACCTGAGGTCAGGAGTTCAAGACCAGGCTGGCCAACATGTTATGATGAGACCCTCATCTCTACTACAAATACAAAAATCAGCTGGGCATGGTGGCAAGTGCCTGTAATCCCAGCTACTTGGGAGGCTGAGGCAGAA"
"GL873593","8598292","8598391","chr11","118461023","118461129","33","109862731","AGCCAGGTGAGGTGGTTCACACCTGTAACCCTAGCTGCTTGGGAGGCTGAGGCCTCTCTATCCTGGGCAGTGTGGAGAAACTTTGTTTCAAAAAAAAGAA","GCCGGGCGCGGTGGCTCACGTCTGTAATCCCAGCGCTTTGGGAAGCCGAGGCGGGACTATCCTGGCCAACATGGTGAAACCCCGTCTCTACTAAAAATACAAGAATC"
"GL873594","357249","357377","chr2","75702890","75703011","36","75345641","CCTGGTACCGTAGGTCATGCCTGTAATCCTAGCACTTTGGGATGCTGAGGTGGGCAGATTGCCTGAGCTCACGAGTTCAAGCCATTAGAACTGAGCCTGACCTAGAGTGGGACCTCCAACTCTTTTTTT","GCCAGGCACAGTGGCTCATGCCTGTAATCCCAGCAGTTTGGGAGGCTGAGGTGGGCAGATCACTTGAGGTCAGGAGTTCAAGACCAGCCTGGCTGACATGGTGAAACCCCATCTATACCAAA"
"GL873594","357656","357834","chr7","17608776","17608965","55","17251120","GGGACCTCCAACTCTTAAAATAGCTGGGCATTGTGGTGGGCACCTACAGTCACAGCTACTTGGGAGGCTAAGGCAAGAGACTTGTTTGCAGCCAAGAGTTAGAGGTTGCTGTGAGCTATGAGGCTAGGGCACTCTACAGGGGGCGACAAGTGAGACTGTAAAAAAAAAAAAAGAAAAAA","GTCCCTACTAAAAATACAAAAAATTAGCTGGGCCTGGTGGCAGGCACCTGTAATCCCAGCTACTTGGGAAGCTGAGGCAAGAGAATTGCTTGAACCCAGGAGGCAGAGGTTGCAGTGAGCTGACATCAAGCCACTGTACTCCAGCCTAGGCAACAAGAGCAAGACTCTGTCTCAAAAAAAAAAAAAAAAA"
"GL873594","1410711","1410996","chr5","151340503","151340797","76","149929792","CACAGTGGCTCATACCTATAATCCTAACACTCTGGGAGGCCAAGGTGGGTGGACTGTCTGAGTTTGGGACCAGCCTGAGCAAAAGCAAGACTCCCATCTCTACTAAAAACAAAGACAGCCAGGTATGAGGGCAGGTGCCTATCATCCCAGCTACTTGGGAGGCTGAGGAAGGAGGATCACCTAAGCCCAGGACTTTAAGGTTTCTGTGAACTAAGATGATGTTACAACACTCTAGCCAGGGTAACAAGGCAAGATTCTGTTTCAAAAGACAAAAAAAAAAAAAAAA","GGTGGTTCATGCCTGTAATCCCAGCACTTTGGGAGGCTGAGGCAGGTGGATCACCTGAGGTCAGGAGTTCGGGACCAGCCTGGCCAACATGGGGAAACCCCATCTCTACTAAAATACAAAAATTAGCCAGGTATGGTGGCACATGCCTATAATCCCAGCTACTTGGGAGGCTGAGGCAGGAGAATCACTTGAACCCAGGAGGCTAAGGTTGCAGTGAGCCGAGATTGTGCCACTGTACTCCAGCCTGGGTGACAGACTGAAACTCTGTGTCCAAAAAACAAAACAAAACAAAAAA"
"GL873594","5528090","5528162","chr2","69013639","69013718","24","63485549","GGTACAGTGGCTCACGCTTGTGATCCCAGGTTGAGGTGGGTGGATCGCCTGAGCTCAGGAGTTGGATGCCAGC","GGTGTGGTGCCTCACGCCTATAATCCCAGCACTTTGGGAGGCAGGTGGATCACTTGAGGTCAGGAGTTTGAGAACAGCCT"
"GL873594","5834047","5834168","chr2","82491537","82491662","28","76657490","GGCTGGGCCCAGTAGCTCACGACTGTAATCCCAGCACTCTGGGAAGCTGAGGTGGGCGGATCACCTGAGCTCATAGGTTCGAGACCAGCTCCAGTTAGAGTGAGAGCCTGTCTCTAAAAATA","GGCTGGGCACAGTGGCTCATGCCTGCAATCCCAGCACTTTGGGAGGCTGAGGTGGGCAGATCACCTGAAGTCAGGAGTTCAAGACCAGCCTGGCCAACACAGTGAAACCCCATCTCTACTAAAAAT"
"GL873594","5834396","5834461","chr13","14688151","14688212","20","8853755","TATATAATAATAATAACCAGGTATTGTGGCAGGTGCCTCTAGTCCCAGCTACTCGGGAGGCAAAGG","ATAAAAAAATTAGCTGGCCATGGTGGCACATACCAATAATCCCAGCTACTCAGGAGGCTGAG"
"GL873594","7786130","7786294","chr14","12217087","12217250","37","4430957","GGGTGTGCTGGCTCATACCTATAATCCTAGCACTCTGGGAGGCTGAGGTAGGTGTATTGCTTGAACCCAGGAGTCTGAGGTTGCTGTGCGCTAAGCTGATACCATAGCACTCTAGCCTGGGCAACAGAGTGAGACTCTGTCTCAAAACAAATAAATAGTAAAAAA","GCTGGGCGTGGTGGCTCACACCTGTAATCCCAGCACTTTGGGAGGCCAAGGCATGAGAATTGCTTGAAAACAGGAGGCGGAGGTTGCAGTAAGCTGAGACTGTGCCATTGCACTCCAGCCTGGGCAACAAGAGTGAAACTCTGTCTCAGAAAAAAAGAAAAAAA"
"GL873595","723579","723774","chr19","6045933","6046125","65","5322354","GCCTGAGCAGGAGAGAGACCCCATCTCTGCTGAAAGTGGAAAAGTTGGCTGAGTGTAGTGGCGGGCTGCTGCCCCAGTCACTCAGGAGGCTTAGGAAGGAGTATCGCTTGGGCCCAAGATTTGAGGTTGCTGTGAGCGCTACAAAGACATTAGGGTACTCTACACAGGGGAATAGAGTGAGACTGTCTCAAAAAAA","CAACATGGAGAAACCCCGTCTCTACTAAAAATACAAAATTAGGCAGCGTGGTGGTGGGTGCCTATAATCCCAGCTACTCAGGAGGCTGAGGCAGGAGAATCGCTTGACCGGGAGTGGAGGTTGCGGTGAGCTGAGATTGCACCATTGCACTCCAGCCTGGGCAACAAGAGTGAAACTCCGTCTCAAAAAGAAA"
"GL873595","724114","724204","chr20","18199749","18199840","22","17475635","GGCCATGCTTGGTGGTTCTCATCTGTAATCCTAGCACTCTGGAAGGTCTACAGGGGTGGATGGCTGGAGGTCAGGAGTTCAAGACTGGCCT","GGCCGGGCATGGTGGCTCACACCTGTAATCCCAGCACTTTGGGAGGCTGAGGCAGGCGGATCACCTGAGGTCAGGAGTTCGAGACCGGCCTG"
"GL873595","1065346","1065667","chr18","10529729","10530057","74","9464383","GGCCAGGTGCAGCAGCTCATGCCTGGAATCTTCCTGCTCTGTATGGCCAAGGCAGGTGGATCGCCTGACCTCAGGAGTTCCAGACCAGCCTGAACAAGAGCAAGACTCTGTCTCTACTAAAAGTAGAAAAAAAACTAGCCAGTCATAGTGGCAGGTGCCTGTAGTCCCAGCTGCTTGGGAGGCTGAGGCAAGAGGATCACTTGAACCTAAGAGTTTGAGGTTGCTGTGAGCTAAGATGCCACATCACTCTATCAAGGGTGACCAAGTGAGACTCTGTCTCAAAAATAAATAAATAAATAAATAAAAAGAAAGGCAAAAAGAA","GGCCCGGCGTGGTGGCTCATGCCTATAATCCCAGCCCTTTGGGAGGCCAAGGCAGGTGGATCACCTGAGGTCAGGCGTTCGAGACCAGCCTGACCAACGTGGTGAAACCTCATCTCTACTAAATACAAAAAAAATTTAGCCAGGCATGGAGGCACATGCCTGTAATCCCAGCTACTTGGGAGGCTGTGGCAGGAGAATCACTTGAACCTGGGAGGTGGAAGTTGCAGTGAGCTGAGATTGTACCACTGCACTCCAACCTGGGTGACAAAGCAAGACTCGGTCTCAATAAATAAATAAATAAATAAATAAATAAATAAAGTGAAAAAAAA"
"GL873595","1254878","1255146","chr4","42822326","42822607","67","41567448","GGCTGGGCATGGTGGCTCATGCCTGTAATCCTACCGCTCTGGGAGGCTGAGGCAGAGGATCACTTGAGCTCAGGAGTTTCAGACCAGCCTGCAAGAAGGACCCAGTCTCTGCCGAAAATAGAAAAGTTAGCAAGGCGTTGTCGTGAGCACATGTATCCCAGCTACCTAGAACTCTGAGGCAGGAGGATCCCTTGAACCCACAGAAGTTGCTGTTATCTAAACTGATGCCACTGGACTCTAGCCTGGGCAACAGAGTGAGACTGGTCTCA","GGCCGGGCACGGTGGCTCATGCCTGTAATCCTAGCATTTTGGGAGGCTGAGACAGGCAGATTGCCTGAGCTCAGGAGTTCAAGACCAGCCTGGGCTAGATTGTGAAACCCCATCTCTACTAAAATATAAAAATTAGCTGGGTGTGGTGGCACACGCCTGTAATCCCAGCTACCTGGGAGGCTGAGGCAGGAGAATCGCTTGAACCAGGAGACAGAGGTTGCAGTGAGCTGAGATCACGCCACTGCACTTTAGCCTGGGCAACAGAGTGATACTCTGTCTCAA"
"GL873595","3417105","3417297","chr12","115674238","115674427","44","112257133","GGCCGGGCGCTGTGCCTCACGCCTGTAATCCTAATACTCTGAGAGGCCGAGGCAGGTGGATTGCCTGAGCTCAGGTGCTCAAGACAGCCTGACTGAGCAAGCCCTGAGATCCCATCTCCACTAACAATAGTAAAACTAGCCGGGCATTGTGGTGGTGCTTGTAATCCCAGCTACTGGGAGGCTAAGACAGGAG","CCAGGCCTGGTGGCTCACGCCTGTAATCCCAGCACTTTGGGAGGCCGAGGTGGGTAGATCACCTGAGGTCAGGAGTTCAAGACCAGCCTGGCCAACATGGCGAAACCCCATCTCTACTAAAAATACAAAAATTAGCTGGGCATGGTGGTGTATGCCTGTAATCCCAGCTACTCGGGAGGCTGAGGCAGGA"
"GL873595","6098380","6098457","chr3","87492619","87492702","21","81394239","GCTGTGGCTCATGCTGATAATACCAGCACTCTGGGAGAACAAGGTAGGCAGATCACAAGAGGTCACCTGTGCAAGACC","GGGCTGGTGGTGGCTCATGCCTGTAATACCAGCACTTTGGGAGGCCAAGACAGGTGGATCACCAAAGGTCAAGAGTTCAAGACC"
"GL873596","134190","134307","chr1","203207333","203207443","31","203073143","GGCTGGGCGAGGTGGCTCACACCTGTAATCCTAGCACTCTGGAAGGCCCTAGCACTCAGGCAGTTGGATTGCCTGAGCTCACAAGTTCAAGACCAGCCTGAAAAAGAGCAAGACCTCA","GGCTGGGTGCAGTGGCTCACACCTGTAATCCCAGCACTTTGGGAGGCCGAGATGGGTGGATCACTTGAGGTCAAGAGTTGAAGACCAGCCTGGACAACATGATGAGACCCC"
"GL873596","134578","134681","chr11","50235285","50235387","37","50100707","CAAACAAAAGAGGAAGACCTCGTCTCTAAAAAAATAGCTGGGCATTGTGAGGAGTACCTGTAGTCCTAGCTACTCAGAAGGCTGAGACAAGAGAATCACTTAAA","CAACATTGTGAAACCCTGTCTCTACTAAAATAGAAAATTAGCCAGGTGTGTGGGCGTGCCTATAATCCTAGCTACTGGGGAGGGTGAGGCATGAGAATCGCCT"
"GL873596","8160215","8160350","chr1","29437872","29437991","30","21277657","GGCCGGGCGTGGTGGCGCACACCTGTAGTCCCAGCGCTATGGGAGGCCGAGGCGGGTGGATCACCTGAGCTCAGAGGTTCGAGACCAGCCAAGACCCCCCTGAGCCAAACGAGCCAGAGTGAGACCCCGTCTCTAC","GGCCGGGCGTGGTGGCTCACGCCTGTAATCCCAACATTTTGGGAGGCCAAGGCGGGTGGATCACCTGAGGTCAGAAGTTCGAGACCAACCTGGCCAACATGGTGAAACCCCTGTCTCTAC"
"GL873596","8421071","8421132","chr20","1874027","1874093","12","6547044","GTCAGGCGCAGTGGCTCACGCCTGTAATCTCAGCACTCTGAGAAGCCAAGGCAGGATCATCT","GGCCAGGCGCAGTGGCTCAGGCCTGTAATCCCAGCACTTTGGGAAGCCAAGGTGAGCAGATCACCTG"
"GL873598","4416400","4416489","chr5","39418145","39418231","15","35001745","GGCCAAGTGTGGTGGCTCATGCCTGTTGTCCCAGCACCGTGGGAGGCCGAGGCTGGTGGAACACCTGAGCTCAGCTGAGTTTGAGACCAG","GGCCAGTTGCGGTGGCTCATGCCTGTAATCCCAGCACTTTGGCAGGCTGAGGCAGGTGGATCACCTGAGGTCAGGAGTTTGAGACCA"
"GL873598","4416855","4416947","chr3","94091253","94091337","31","89674398","GTGAGACCCTGTCTCTACAAAAAAAAAAGCTGGGCACTGTGGCATGTGCCTGTAATCCCAGCTACTTGGGAGGCAAAGGGAAAGAGAATCACT","AAACCTTGCCTTTACTAGAAATACAAAAATTAGCTGGGCATGGTGGCAGGTACCTGTAATCCCAGCTACTTGGGAGGCTGAGGCA"
"GL873598","5126074","5126161","chr1","12339306","12339394","19","7213232","GCCTGGTGCACTGGTTCACACCTGGAATCCTTGCATTCTGAGAGGCCCAGGTAGGCAGATCACCTCAGCTCAGAAGTTCGAGACCAGC","GCTGGGTGCGGTGGTTCACGTCTGTAATCCCAGCACTTTGGGAGGCCGAGGCGGGCAGATCACCTGAGGTCAGGAGTTCGAGACCAGCC"
"GL873598","5467584","5467662","chr1","9313328","9313403","17","3845744","GCGAGGTGGCTCACGCCTGTAATCCCAGCACATTTGGAAGGCCAAGGAGGGTGGATCACCCGAGCTCACCAGTTGGAGA","CGCAGTGGCTCACGCCTGTAATCCCAGCACTTTGGGAGGCCGAGGCAGGCAGATCACCTGAAGTCAGGAGTTTGAG"
"GL873598","6917752","6917856","chr14","9558287","9558382","22","2640535","GGCCAGGCATGGTGGCTTGTGCCTGTTGTCCCAGCACTGTGGAAGGCCGAGGCGGGTGGATCGCCTGAGCTCAGCTGAATTCGAGACCAGCATAAGACCAGTATG","GGCCAGGCATGGTGGCTTATGCCTGTAATCCCAGCACCTTGGAAGGCCGAAGCGGGCAGATCACCTGAGCTCAGGAGTTTGAGACCAGCCTGTCCA"
"GL873598","8078910","8079062","chr7","164825511","164825660","43","156746601","AACAGCCAGGCATTGTGGTGGGCACCTGTAATCCCAGCTACTTGGGAGGCTGAGGCAAGAGAATTGCTTGAGCCCAACAGTCTCAGGTTACTGTGAGTTATGACACCATGGCACTCTATTGAGGGCAAGAAAGTGAGACTGTCTTGGAAAAAA","CTAGCCAGGCATGGTGGTGCGCACCTGTAGTCCCAGTTACTTGGGAGGTTGAGGCAAGAGAATTGCTTGAGCCTGGAAGGCAGAAGTTGCAGTGAGCTGAGATCACACCACTGCATTCCAGCCTGGGCGAAAGAGCAAGACTCTGTTGAA"
"GL873598","8079328","8079454","chr6","10381248","10381379","32","2301920","GCCCGGCGTGGTGGCTCACGCCTGTAATTCCAGCACTCTGGGGAGGCCGAGGAGGGCAGATTGCCTGAGCTCACAGGTTTGAGCTAGAGCGAGACCCTGTCTCTTAAAAAGAAAAAAAAGGAAAGAA","GCTGGGCGCGGTGGCTCACGCCTGTAATCCCAACACTTTGGGAGGCCGAGGCGGGCAGATCACCAGAGGTGATCTCCAGCCTGGGCAGGAGAGCAAGACCCTGTCTCAAAAAATTTAGAAAAAGGAAAGAAA"
"GL873599","3943256","3943456","chr9","35892110","35892312","79","31948854","GGCAGGCTGCTTTGACCCATATCTACAACTCCAGAACTTTAGAGGCTGAGCTGGGTGGGTCCCTTGAGATTAGAAACTGCTTAGTAGCCTGGCAAAAACCAGACCCCACCTCCACCATGTAGAAAAATTAGCAGTATGCCATAGTGGGAACCTACCAATACAGTCTTTCCAAAGGCCAAAGCTAGAAGGACCGTGAGCTTG","GGCTGGGTGTGGTGGCTCATGCCTATAATTCCAGCACTTTGGGAGGCCGAGGCAGGTGGATCACCTGAGGCCAGGAGTTTGAGACCAGCCTGGCCAATATGGTGAAACCCCATCTCTACTAAAAGTACAGAAAATTAGTCAGTCATGATGGCGCATGCCTATAATCCCAGTTACTCGGGAGGCTAAGGTAGGAGAATTGCTTG"
"GL873599","6693284","6693349","chr1","100916857","100916922","15","94223573","TCACGTCTATAATCCTAGCACTCTGGGAGTCCTTGGCAGGTGGATCACCTGAGCTCAGGAGTTTGA","CATGCCTGTAATCCCAGCACCTTGGGAGGCCAAGGTGGGTGGATCACCTGAGGTCAGTAGTTTGAG"
"GL873600","991618","991705","chr15","13850109","13850195","15","12858491","GGCTGGGCGTGGTGGCTCACACCTGTTGTCCCAGCGCTGTGGGAGGCTGAGGCAGGTGGATCACCTGTGCTCAGAGGTTGAGACCAGC","GCCGGGCGCTGTGGCTCACACTTGTAATCCCAGCACTTTGGGAGGCTGAGGCAGGTGGATCACCTGAGGTCAGGAGTTAGAGACCAG"
"GL873600","8825981","8826014","chr16","43605817","43605844","11","34779836","AGTCTGGGGCAACAGAGCAAGACTCTGTCTCAAA","CAGTCTGGGTGACAGAGCAAGATTCCAT"
"GL873600","8826039","8826157","chr13","87428402","87428520","35","78602363","ATTAGCCTGGTGTGGTGGTATATGCCTTCCTGCCTGCTTGGGAGGCTGAGGCAGGAAGTATGCTTTAACTGTGGAGTCTGAGGTTGCTATGAGCTAGGTTGAGGCCATGGCACTCTAAA","TTAGCCGGGTGTGGTGGTGCACGCCTGTAATCCCAGCTACTCAGGAGGCTGAAGCAGGAGAGTTGCTTGAACCCAGGAGTTGGAGGTTGCAGTGAGCTGAGATCACGCCATTGCACTCC"
"GL873601","269289","269338","chr14","49279240","49279285","14","49009951","GACTGGGTGTGGTGGCTCACACCTTTAATCCTAACACCCTGGGAGGCTTA","GGCTGAGATGGTGGCACACACCTGTAATCCCAGCTACTTGGGAGGC"
"GL873601","269431","269678","chr1","184453273","184453521","76","184183842","AGAAGATCACTCAAGATCAGGAGTTTGAGAACAGCCTGAGCAAGACCCCCATCTTTACTAAAAATGGAAAAGTTTTTACCCAGGCATGGTAGTGCGTGCCTGTATCCCATCTACTCCGGAGGCTGATAGGAGGATTGCTTCAACCAAGGAGTTTGAGGTTCCAGAGACTTAAGATGACACAACTGCATTTTACCCAGTGTGACACAGCGAGACTCTTTCAGAAGAATTTTTAAAAGGAAAAAAAAGAA","GGTCAGATCACCTGAGGTCAGGAGTTTGAGACCAGCCTGACCAACATGGTAAAACCCCATCTCTGCTAAAAATACAAAAAATTAGCCAGGCATGGTGGTGAACGCCTGTAATCCTAGCTACTCAGGAGGCAAAGACAGGAGAATCGCTTGAATCTGGAAGGTGGAGGTTGCAATGAGCCAAGATGACGCCACTGCACTCCAACCTGGGTGACAGAGGAAGACTCCATCAAAAAAAAAAAAAAAAAAAAA"
"GL873601","1397978","1398117","chr16","24839455","24839591","34","23441477","GCCTATAATCCTAGCACTCTGGAAGGCTGAGGCAGGAAGATCACTAGAGCTTGGGAGTTTGAGATTGCTGTGAGGGAGACTGACTCCATGGCACTCTAGCCTGAGGCAACAGAGTAAGACTCCATCTCAAAAAAAAAAAA","CTCTAACTCCAGCTACTCAGGAGGCTGAAGCAGGAAAATCACTTGAACCTGGGAGGTGGAGGTTACAGTGAGCCAAGATCACACCATTGCACTCCAGCCTGAGCGACAGAGCGAGACTCTGTCTCAAAATAAATAAA"
"GL873601","4065502","4065590","chr11","108711352","108711444","19","104645850","GCTGGATGTGGTGGCTCTCACCTATAATCCTAGCACTCTGGGAGGTCAAAACAGGTGGATCACCTGAGCTCAGGAGCAAGAACACCAGC","GTCAGGGGTGGTGGCTCACGCCTGTAATCCCAGCACTTTGGGAGGCCAAGGCAGGTGGATCGCCTGAGCTCAGGAGTTCAAGACCAGCCTTGC"
"GL873601","8241370","8241465","chrY","9469734","9469829","34","1228364","AAAAAAGGTGGAGATGAGCCATGCGCAGTGGTGTAGGCCTGTAATCCCAGCCCTTGGGAGGCCAAAATGGTGGATTGCCTGAAGCAGAGCAAGACC","AAAGTACAAAGAGTCTGGGTACAGTGGCCCAAGCCTGTAATCCCAGCAGTTTGGGAGGACAAGATGGGTAGATCACCTGACATCATGAATTAGAGA"
"GL873569","7519122","7519191","chrX","79016364","79016431","16","71497242","TTGGCCAGGCATGGTCGCTCAGGCTGTAATACCAGCTACTTGGGAAGCTGAAGCAGGAGGATCACTTGAA","TTGGCCAGGCACGGTGGCTCATGCTTATAATCCCAGCTACTCGTGAGGCTGAGGCAGGGGAATCGCTT"
"GL873569","7989158","7989286","chr8","41505677","41505810","35","33516519","AGTCCCACCTATTTGGAAGGCTGAGGCAAGAGGATCACTTGAACTCAGCAGTTTGACATTGCTATGAGTTAGATTGACTCCATGGCACTCTAGCCCAGGCAACAGAGCAAGACTCCGTCTCAAAACAAA","TAATACCAGCTACGTGGGAGGCTGAGGCAGGAGAATCACTTGAACCCGGGAGGTGGAGGTTGCAGTGAGCTGAGATTGCACCGTTGCACTCTAACCTGGGCAACAAAAGCAAAACTCTGTCTCAAAAAAAAAAA"
"GL873569","7989575","7989702","chr1","62231025","62231129","47","54241450","GGCTGGGTAATGCAGTGGCTCACGCCTATAATCCTAGTGCTTTGAGAGGCCAAGAGTGAGACTCTGTGTACTAAAAATAGAAAAATTACCTAGGCATTCTGGTGGGCACCAGTAGTCCCACCTATTTG","GGCTGGGCATGGTGGCTCACGCCTATAATCCCAGCACTTTGGGAGGCCGAGGCAGGTGGATCACCTGAGATCAGGAGTTTGAGACCAGACTGGCCAACATGGTGA"
"GL873569","10034363","10034556","chr10","61268396","61268605","62","51234033","CAGCTTGAGCAAAAGTGAGCCCCTGTCTCTACTGAAAATAGAAAAAATTAGCCAGGCGTGGTGGCACACACTTATAGTCCCAGCCACTTAGGAGGCTGAGGCAGGAGTTTGAGGTTGACATAATCTAAGCTGATACCATAGCACTCTAGCCTGGGCAATAGAGTGAGACTCTGTCTCAAAGAAGAAATTTATCT","CCTGACCAATGGTGAAACCCTGTCTCTACCAAAAATACAAAATTTAGCTGGGCATGGGGGCACGCACCTGTAGTCCTAGCTACTCGGGAGGCTGAGACAGGAGAACTGCTTGAACTCGGGAGGCAGAGGTTGCAGTGAGCTGAGATCATGCCACTGCACTCTAGCCTGGGCAATAGAGTGAGACTCCGTCTCAAAAAAAAAAAAAAAAAA"
"GL873569","10034830","10034845","chr1","217667782","217667796","2","207632952","AAAAAAGAAGAAAAAA","AAGAAAAAGAAAAAA"
"GL873569","10203815","10203922","chr8","96374555","96374671","35","86170740","GCCAGGTGTAGTGGTTCACACCTATAATCCTAGCACTCTGGGAGCCTGAAGCAGGTAAATGGACTGAGCAAGAGTGAGACTTCCACCTCTATTGAAAATAGAAAAATT","GGCTAGGTATGGTGGCTGATGCCTATAATCCCAGAATTTTGGGAGGCCGAGGCAGGCAGATCATCTGAGGTCAGGAGTTTGAGACCAGTCCCGTCTCTACTAAAAATACAAAAATTA"
"GL873569","10204196","10204373","chr20","1304385","1304559","47","8899811","GAAAATAGAAAAATTAGCCAGGCATTATAGCAGGCACCAGTAATCCCAGTTACTTGGGAGGCTAAGGCAAAAGAATCTCTTGAGCCCAAGTTTGGGGTTGCTAGGAAGTAAAACACCACAGCACTATACCCAGAACAAGAGAGTGAAGACTCAGTCTCAAAAAGATAAATAAATAAAA","AAAAATACAAAAATTAGCCAGGCATGGTGGCGGGCGTCTGTAACTCCAGCTACTTGGGAGACTGAGGCAGGAGAATCGCTTGAACCCAGGAGGCAGAGGTTACAGGTGAAATCACACCACTGCACTCCAGCCTGGGCAACAGGGCAAGACTCTGTCTCAAAAAAAAAAAAAAAAA"
"GL873569","10473375","10473444","chr8","20660648","20660717","21","10187273","TGTAGTCCCAGCACTTTGGGAGGTTAAGGCAAGAGTAGCACCCAACATGAGGAGATCAAGACCAATCTGG","CTGTAGTCCCAGCACTTTGGGAGGCTGAGGCAGGTGGATCCTTTGAGGGCAGAACTTTAAGACCAGCCTG"
"GL873570","9287350","9287485","chr1","29437872","29437991","30","20150522","GGCCGGGCGTGGTGGCGCACGCCTGTAGTCCCAGCGCTATGGGAGGCCGAGGCGGGTGGATCACCTGTGCTCAGAGGTTCGAGACCAGCCAAGACCCCCCTGAGCCAAACGAGCCAGAGTGAGACCCCGTCTCTAC","GGCCGGGCGTGGTGGCTCACGCCTGTAATCCCAACATTTTGGGAGGCCAAGGCGGGTGGATCACCTGAGGTCAGAAGTTCGAGACCAACCTGGCCAACATGGTGAAACCCCTGTCTCTAC"
"GL873571","3669989","3670207","chr4","116777080","116777297","60","113107091","AGACCAGCCTGAGGAAGAGCAAGATCCCATCTCTATTAAAAATAGAAAAATTAGCCAGGCATTCTGGTGGGCACCTGTAGTTCTAACCACCTGGGAGGCTAAGGCAAGAGGAACTCTTCAACCCAAGAGTTTGAGGTTGCTGAGAGCTAGGCTAAGGCTGCAGCACTCTAGCCTGGGCAACAGAGTGAGACTGTTTCTCAAAAACAAAAAACAAAAAAA","CGAGACCAGCCTGGTCAATATGGTGAAACCCCGTCCCTACTAAAAATACAAAAATTAGCCAGGCATGGTGGCAGGCACCTGTAGTCCCAGCTACTCGGAAGGCTGAGGCAGGAGAATCGCTTGAACCACAGAGGCAGAGGTTGCAGTGAGCCGAGACTGCACCACTGCACTCCAGCCTGGGCGACAGAGTGAGACTCAGTCTCAAAAAAAAAAAAAAA"
"GL873571","106134","106236","chr4","18143723","18143826","27","18037589","GGCCAGTCTCAGTGGCTCACACCTGTAATCCAGCATTCTGGGAGGCTGAAGCACACGGTCACCTGAGCTCAAAGGTTGGAGACCAGAGTGAGACCCCACCTCT","GGCCAGGCGCAGTGGCTCACTCCTGTAATCCCAGCACTTTGAGGCTGAGGCAGGCGGATCACCTGAGGTCAGGAGTTTGAGACCAGCCTGGCCGAAACCCCATC"
"GL873571","3670496","3670589","chr7","50468399","50468491","15","46797903","GGGCAGGCATGGTGGCTCACACCTGTAATTCTAGCACTCTTGGAGGCTGAGGCAGGAAAATGGCTTGAGGTCAGGAGTTCAAGACCAGCCTGAG","GGCCAGTCATGGTTGCTCACACCTGTAATACCAGCACTTTGGGAGGCCGAGGCAGGCGAATCACCTGAAGTCAGGAGTTCAAGACCAGCCTGG"
"GL873571","4059090","4059389","chr7","52903696","52903994","88","48844606","GGCCAGGTGCAGTGGTTCACACTTATAATCCTAGCACTCTGGGAGGCCGAGGCGAGTGAAGTGCCTGAGCTCATGGGTTCAAGACCAACCTAAGCCAGAGACCCCTGACTCTTATAATAGCCTGGCATTGTGGTGGGCGCCAATATTTCCAGCTACTCTGAGGCTAAGGCAAGAGAATTGCTTGAGCCCAGGAGTTGGAGGTTTCTGTGAGCACTGACGCCGCAGCTCTCTACCAAGGGCAACAAAGACTCTGTCTCAAAAAATAAATAAATAAATAAATAACAGAATGAAAATGAAAAA","GGCCGGGTGCGGTGGTTCACGCCTGTAATCCCACCACTTTGGGAGGCTGAGGCAGGCAGGTCACCTGAGGTCAGGAGTTCCAGACCAGCCTGGCCAACATGGTGAAACCTTGTCTCGGCTATTAGCCTGGCATGGTGGTGCGTGCCCATAATCCCAGCTACTCAGGAGGCTGAGGCAGGAGAATCGCTTGAACCCAGAAGGTGGAGGTTGCAGTGAGCCAAGATAGCACCACTGCAACTCCAGTCTGGGCAACAGAATGAGACTCTGTCTCAAAAAAAAAAAACAAAAAACAAAAAGAA"
"GL873571","4209418","4209704","chr11","32517699","32517985","80","28308281","GGCTTGGCAAGGTGGCTTACACCTCAAATCCTAGCACTGTGGGAGACTGAGGCAGGTGGATTGTTTGAGCTCAGGAGGTCAAGATAGAGAGCAAGAGCAAGTCTCTGTCTCTACTAAAAATAGAAAAGAACTACTTCCCGGGGGTCATGGCAGTAGCCTGTAATCCCAGTTACTAGGTAGAATGAGGCAAGAGGATCTGTTGAAGCCAAGAGACTGAGGTTGTTATGAGCATGCCACAGCACTCTACCCAGGGTGACAGAATGAGACTCTGTTGAAAGAAAAAAAGA","GGCCGGGTGCAGTGGCTCACACCTGTAATCCCAGCACTTTGGGAGGCTGAGGCGGGTGGATCACCTGAGGTCAGGAGTTCAAGACCAGCCTGACAAACATAGTGAAACCCTGTCTCTACTGAAAATACAAAATTAGCCAGGTGTGGTGGCGCATGCCTGTAATCCCAGCTACTCGGGAGGCTGAGGCAGGAGAATTGCTTGAATCCAGGAGGTGGAGGTTGTGTGATCACACCACTGCACTCCAGCCTGGGCGACAGAGTGAGACTCTGTCTCAAAAAAAAAAGAAA"
"GL873571","4209985","4210154","chr3","175781758","175781928","60","171571773","GAAAGAAATGAAAAGAAAGAAGTTAGCTGGTTGTTGGGGTATGCTTCTATAGTCCCACCTACTCAGAAAGCTGAAATCTGGAGTTTGGGGTTGTTGTAAGGTAGGCTGATGACATAGCACTGTAGCTTGGGCAAGAGAGTGTGACTTTGTCTCAAAAAAAATTAAAACAA","ATTAAAAACACAAAGATTAGCCAGGTGTGATGGCACACAACTGTAATCCCAACTACTCAGGAGAATCGCTTGAACCTGGGAGATAGGGTTTGCAGTGAGCCAAGATTGTGCCACTGCACTCCAGCCTGGGTGACAGAGTGAGACTCTGTCTCCAAAAAAAAAAAAAAAAAA"
"GL873571","4210444","4210570","chr17","16655655","16655789","35","12445211","GCCAGGCAGATGGCTCACACTTCATCCTAGCCCTCTGGAAGGCTGAGGCAGGCTAATTTTTTGAGGTTAGGAGTTTGAGACCAGCCTGAGGAAGAGACCCATCTCTACTTTAAAAAATAAATGGAAA","GCCAGGCATGGTGGCTCACACCTGTAATCCTAGCACTTTGGGAGACTGAGGCGGGTGAATCACCTGAGGTCAGGAGTTTGAGACCAGCCTGACCAGTATGGTGAAACCCAGTCTCTACTAAAAATACAGAAATTA"
"GL873571","4391733","4391878","chr11","33723808","33723943","46","29332075","AACTTAGCTGGGAATGGTGGCTCAAGCCTGTAATCCTAGCACTCTGGGAGGCTCAGGTGGGAGGATCACTTGAGGTTGCTGTGAGCTTGGCTGATGCCAGGACACTCTAGTGTGGGCAAGAGAGTGAGACTCCGCCTCAACAACAA","GCCGGGTGCAGTGGCTCATACCTGTAATCCCAGCACTTTGGGAGGCTGAGGTAGGCGGATCACGAGGTCAGGAGCTGAGATGGCGCCACTGCACCCCAGCCTGGGTGACAGAGCAAGACTCTGTCTCAAAAAAAAA"
"GL873571","6307773","6307841","chr9","62429628","62429694","22","56121855","CTGGGTGTGGTGGCATTGCACCTGTAATCCTAGCTACTTGGAAATCTTAAGCCCAGGAGTTGAAGACTG","CCCAGCATGGTGGTGCATACCTATAATCTCAGCTACTTGGAGGCTTGAGCTCAGAAGTTTGAGACCG"
"GL873571","6496217","6496306","chr1","27257765","27257856","27","20761548","GCAGGGTGTGTTGACCCACACCCACAATTCCAGGACTCTGGGGGGCCAGGGATGGTGGGTTCCCTCAGATCAGGAGCTCCTTACCAGCCT","GACTGGGCATGATGGCTCAAATCTGTAATTCCAGCACTTTGGGAGGCCGAGGTGGGTGGATTGCCTGAGATCAGGAGTTCAAGACCAGCCTG"
"GL873571","6499738","6499903","chr1","38976375","38976555","47","32476637","AAAATAACATGAATTGACTAGGCGAGGTGGCTCACATCTCTAATCCTAGCACTCTGGGAGGCTGAGGCAGGAGAATTGCATGAGGTTGCTGTGAGCTATGATGATACCACGGCATTCTAATCAGGGTGACAGAGTGAGATTCTGTCTTAAAACAAACAAACAAAAA","AAAATAAATAAATTAGCAGGGCCTGGTGGCGCACACCTGTAATCCCAGCTACTTGGGAAGCTGAGGCAGGAGAACCCACTTGAACCTGGGAGCCGGAGGTTGCAGTGAGCTGAGATGGCACCACTGCACTCCAGACTGCGTGACAGAGTGAGACTCCGTCTCAAAAACAAACAAACAAAAA"
"GL873571","11399575","11399872","chr15","109458692","109458994","79","98059117","CAGTGGCTCACACCTGTAAATCTAACACTCTGGGAGGCCAAGGTGGGTGGATCCCTTGAGCTCAGGAATTTGATACCAGCCTGAGCAAGAGTGAGACCTTGTCTCTACTAATAATAGAAAAATAGCCCGTGTTGTGGCACTTGTCCCAACCACTGGGGAGGCTTTAGGCGGGAGGATTACTTGAATTGGGAGTTTGATATTGCTGTGAGCTGGGCTGATGCCTTGGCATTCTAGCTTGGGTAACAGCGTAAGACTCCGTCTCAAATAAATAAATAAATAAATAAAAAGAAAAAAAGAA","GTGGCTCACACCTGTAATCTCAGCACTTTGGGAGACCGAGGCAGGTGGATCACCTGAGGTCGGGAGTTTGAGACCAGCCTGACCAACGTGGAGAAACCCCGTCTCTACTAACAATACAAAATCAGCTGGGCGTGGTGGTGCATGCTTGTAATCCCAGCTACTCGGGAGGCTGAGGTAGGAGAATCGCTTGAACCTGGGAGGTGGAGGTTGCGGTGAGCCGAGATCGAGCCACTGCACTCCAGCCTGGGTGACAGAGCAAGACTCCATCTCAAAAAAAAAAAAAAAAAAAAAAAAAAAAAAAAA"
"GL873572","114760","114841","chr8","26280134","26280211","16","26165374","GGCCAGGCATGGCGGCTCTTCCCTGTAATCCTAGCACTCTGGGAGGGCGAGGCAGGCAGATCACCTAGGCTAGGGTGAGATC","GGCCAGGAATGGTGGCTCATGCCTGTAATCCCAGCACTTTGGGAGGCTGAGGCAGGCAGATCACCTGAGGTCAGGAGT"
"GL873572","9421791","9421892","chr11","8089184","8089269","35","1332607","TACTAAATATATAGCAAGGCCAGGCACAGTGGTTCATGGCTGTAATCCCAGTACTCTGGGAGGCCTAGTCAGAGTTGACCTGAGATCAGGCTAGAAGCCTGG","ATAAAAATAATTGGAGGCCAGGCACGGTGGCTCATGCTTGTAATTCTAGCAATTTGGGAGGCTGACGCGGGTGAGATCATACTGAG"
"GL873572","11052834","11053035","chr14","11857478","11857657","65","804644","TCCACAAAGAAAGCAGAAGTGTGGCCGGGTGGTAGCTCAAGGCAGGAATCCCAGCACTCTGGGAGCTGGGAGGTGGGGGAGGATCCCTTGAGATCAGGAGTTGGAGGGCACAGTGAGCCTGGGGGAGGCCACTGTCTCTGTACTCTAGCAGGGAGACAGAGCAAGACTGCCCATTCAAAGAAAAACAACAAACAAAACAAAA","TACAAAAATTAGCTGGGCACGGTGCCACAAGCCTGTAATCCCAGCTACTCGGGAGGCTGGGCAGGGGAATAGCTTGAACCCAGAGGTGGAGGTTGCAGTGAGCCAAGATCAAGCCACAGCACTCCAGCCTGGGTGACAGAGCAAGACTCCATCTCAAAAAAAAAAAAAAAAAAAAAAAAA"
"GL873573","2564195","2564244","chr1","109985445","109985491","12","107421250","TACAAAAATTAGGCTGGGCTTGGTGGTTCACGCCTATAATCCTAGCACTT","ACTAAAATTAGCTGGGCATGGTGGTGCATGCCTGTAATTCCAGCTAC"
"GL873573","7423371","7423533","chr2","202783328","202783513","56","195359957","GGTGGCTCACACCTGTAATCCCAGCACTCTGGGAGCCCTGGTGGCTCATGTCTATAATCCTAGTACTCTGGGAGACCATGGTGGCTCATGTCTATAATCCTAGTACTCTGGGAGCCATGGTGGCTCACGCCTATAATCCTAGTACTCTGGGAGACCATGGTGG","GGCTGAGGCGCGGGGGCTCACGCCTGTAATCCCAGCACTGTGGGAGGCCGAGGCGGGTGGATCACGCCTGTAATCCCAGCACTGTGGGAGGCCAAGGCGGGTGGATCACGCCTGTAATCCCAGCACTGTGGGAGGCCGAGGCGGGTGGATCACGCCTGTAATCCCAGCACTGTGGGAGGCTGAGGC"
"GL873573","9657648","9657710","chr19","10207852","10207913","10","550204","TAAAAATAAAAAATTTAGCTGGATGTGGTGGCTCACACCTGTAATCCTAGCACTCTGGGAGAC","TAAAAATACAAAATTAGCTGGGTGTGGTGGCACACACCTGTAATCCCAGCTACTCAAGAGGC"
"GL873574","1624662","1624783","chr9","814961","815079","36","809701","GACTGGGTGGGTTGGATCATGCCTGGAATCCTAGCACCCTGGGAGGCCAAGGTGAAAGGATTGCTTGAGGTTAGGAGTTCCAGAAATGTAGCAGTCATGGTGACTTCATCCTTCTCTACCAA","GGCTGGGTGCTTTGATTCATGCCTGTAATCCCAGCACTCTGGGAGGCCGAGGCAGGTGGATCACCTGAGGTTAGGAGTTCGAGACCAGCTTGGCTAACATGGTGAAACCTCGTCTCTAC"
"GL873574","4459477","4459612","chr1","29437872","29437991","29","24978395","GGCCGGGCGTGGTGGCGCACGCCTGTAGTCCCAGCGCTATGGGAGGCCGAGGCGGGTGGATCACCTGAGCTCAGAGGTTCGAGACCAGCCAAGACCCCCCTGAGCCAAACGAGCCAGAGTGAGACCCCGTCTCTAC","GGCCGGGCGTGGTGGCTCACGCCTGTAATCCCAACATTTTGGGAGGCCAAGGCGGGTGGATCACCTGAGGTCAGAAGTTCGAGACCAACCTGGCCAACATGGTGAAACCCCTGTCTCTAC"
"GL873574","4681987","4682216","chr6","153082888","153083127","73","148400901","GGGTGCGGTGGCTCAGACCTATAATCCCAGCACTCTGAGAGGCCGAAGTGGGTGGATCACCTGAGCTCAGGAATTTGAGACCAGCCGTCTCTAAAAATAGCTGAGTGTTGTGGCAGTGGCTGTAAGTCCCAGCTGTTTGGAAAGCTGAAGCAAGGGAATCACTTGAACCCAAGAGTTTGAGGTTGCTGTGATGACAAAGTGAGACTCTATCTCAAAAAAAAAAAAAAAAA","GGCCGTGCGCGGCGGCTCACGCCTGTAATCCCAGCACTTTGGGAGGCTGAGGTGGGTGGATCACCTGAGGTCAGGAGTTTGAGACCAGCCCGACCAGAAATTAGATGGGTGTGGTGGTGCGCTCCTGCAGCCCCAGCTACTTAAGAGGCTGAGGCAGGGTAATCACTTGAACCCGGGAGGCGGAGGTTGCAGTGAGCCGAGCTCACGCCACTGCACTCCAGCCTGGGTAACAGAGCGAGA"
"GL873574","4709916","4710039","chr19","13152422","13152536","46","8442506","AAAAATAGAAAAACTAGCCAAGCATGGTGGTGCACCCCCTATAGTCTGAGCTCCTCAGCGGGCTGAAGCAAAAGGACGGCTGGAGCCCTGGAGTTTGAGGTTGCTGTGAGGCAAGGTGATGCCA","ACACATAAATTAGCCAGACATGATGGTGAGTATCTGTAATTCCAGCTCCTTGGGGGGCTGAGGCGGGAGAATTGCTTGAACCTGGGAGGCAGAGATTGCAGTGAGCCAAGATCGC"
"GL873574","6353839","6353913","chr5","25768079","25768163","22","19414240","AAAAATATAGCAAGGCCAGGCATGGTGGCTCACACCTATAATCCCAGTACTTGGGAGCTGGAATTTGAACCTAGG","AAAAAACTCAAACAAGGCTGGGCGTGGTGGCTCACACCTGTAATCCCAGCACTTTGGGAGGCTGAGGTGGGTGGATCACCTGAGG"
"GL873574","6533061","6533332","chr5","85182161","85182439","81","78649100","GGCTGGGCGAGGTGGCTTACACCTATAATCCTAGTACTCTGGGAGGCCAAGGTGGGTGGATTGCCTGAGCGCACAGTTTCAAGACCAGCTGGAGCCAGAGAGAGAGAGAGAGACCCTGCCTCTAAAAATAGCCAGGCATTGTGGCAGGCACCTGTAGTCCCAGCTACTTGGCAGGCGGAGGTATGAGAATCGCTAGAGGTTGCTGTTAGCTATGATGCCATAGCACTCTACCAAGGGCGACAAAGTGAAACTCTGCCTCAAAAAAAAGAAGA","GCCAGGCGTGGTGACTCAAGCCTGTAATCCTAGCACTTTGGGAGGCCAAGGTGGGCGGATTGCCTGAGCTCAAGAGTTTGAGACCAGCCTGGGCAACACGGTGAAACCCAATCCCTACTAAATACAAAAAAAATTAGCCGGGTGTGGTGGTGTGAACCTGTAGTCCCAGCTACTCGGGAGGCTGAGGCAGGAGAAGGCAGAAGTTGCAGTGAGCCGAGATCACACCACTGCACTCCAGCCTGAGTGACAGAGCAAAACTCTTTCTCAAAAAAAAAAAAA"
"GL873574","6643746","6643907","chr2","92627944","92628105","46","85984198","AAATAGCCAGGCGTTGTGGCAGGCACCTATAGTCCCAGCTACTTGGGAGGCTGAGGCAAGAGAATCACTTAAGCCCAAGTGACAGAGGTTGCCAGGGCACTCTACGTAGGCAACAGAGTGAGACTCTATCTAAGAAAGAAGGAAGGAAGGAAGGAGAAAGAA","TTAGCCGAGCATTGTGGTGCGCGCCTGTAGTCCCAGCTACATGGGAGGCTGAGGCAGGAGAACACCTGAACCCAGGATGTGAGCTGAGTCGCGCCATTGCACTCCAGCCTGGGCAACAGAGTGAGACTCCATCTCAAAAATAAAATAAAATAAAATAAAAAA"
"GL873574","6644163","6644274","chr1","128607504","128607619","20","121963341","CTGTAATCCTAGCACTTGGGAGGCTGAGGCAGGTGGATCACCTGAGTTCAGGAGTTCAAGACCAGCCTAAACAAGAGTGAGACCCTATCTCTACTAAAAATAGAAAAAATAT","GCCTGTAATCCAAGCACTTTGGGAGGCTGAGGCGGGTGGATCACCTGAGGTCAGGTGTTCGAGACCAGCCTGGCCAACGTGGTGAAACCCCAACTCTACTAAAAATACAAAAATTA"
"GL873574","8511822","8512127","chr1","23439759","23440073","84","14927937","GGTGGCTGGTGCCTGTAATCCTAGCACTCTGGGAGACTGAGGCAGGTGGATCACTTGAAATCAGGAGTTTGAGATCAACCTGAGCAAGAGATCTTGTCTCTCCTAAAGATAGAAAAACTAGCTGGGATTTGTGGTGGACACCTGTAATTTCAGCTACTCAGGAAGCTAAGGCAAGAGCATTGCTTAAAACCAGGAGTTTGAAGTTGATGTGAGCTAGGATGTCAGGGCAGGTTACCCAGGGTGACAGAGTGAGACTCTGTGTCAAAATAAACAAACAAACAAACAAACAAAACAAAATAAAATAAA","GGCTGGACATGGTGACTCACGCTTGTAATCCCAACACTTTGGGAGGCTGAAGCAGGCAGATCACCTGAGGTCAGGAGTTTGAGACCAGCCTGACCAACATGGTGAAACCTTGTCTCTACTAAAAATACAAAAATTAGCTGGGAGCAGTGGTGCACACCTGTAATCCCAGCTACTCGGCAAGCTGAGGCAAGATAATTTTTTAAACCTGGGAGGTGGAGGTTGCAGTGAGCCAAGATCGTGCCACTGTACTCCAACCTGGGAGACAGAGCAAGACTCTGTCTCAAAAAAAAAAAAAAAAAAAAAAAAAAAAAAAAA"
"GL873575","2107336","2107519","chr4","38052972","38053149","54","35945636","TCAATTAAAAACTTTTTAAAATGAGGCTGAGCATGGTGGTTCACACCTGTAATCCCAGCACTTTGGGAGGCCGAGGCAGGAGGATCACCTGATCCCAGGAGTCCAAGCCTACAGTGAGCCGTGATAATACCACTGCACTTCAGCCCAAAGCCTCAAAAAGAAAAAAAAAAAAGGATAGACAAGA","TATATATATATATATTATTTTGGGGGGGCATGGTGGTGCACACCTGTAATCCCAGCTACTCGGGAGGCTGAGGCAGGAGAATTGCTTGAGCCCGGGAGGCAAAGGTTGCATTGAGCTGAGATCACACCACTGCACTCCAGCCTGGCGACAGAGTCTCAAAAAAAAGAAAAAATAAAAA"
"GL873575","5831824","5831959","chr1","29437872","29437991","28","23606048","GGCCGGGCGTGGTGGCGCACGCCTGTAGTCCCAGCGCTATGGGAGGCCAAGGCGGGTGGATCACCTGAGCTCAGAGGTTCGAGACCAGCCAAGACCCCCCTGAGCCAAACGAGCCAGAGTGAGACCCCGTCTCTAC","GGCCGGGCGTGGTGGCTCACGCCTGTAATCCCAACATTTTGGGAGGCCAAGGCGGGTGGATCACCTGAGGTCAGAAGTTCGAGACCAACCTGGCCAACATGGTGAAACCCCTGTCTCTAC"
"GL873575","7451097","7451208","chr3","122814630","122814743","22","115363533","GGCCAGGTGTGGTGGCTCACACCTGTTATCCTAGCACTCTGAGAGGCCACAGCAGCTGGATCACTTGAGCTCAGGAGTTCAAGACCAGTCTGAGCAAGAGCAAGACCTCACC","GGCTGGGTGTGGTGGCTCATGCCTGTAATCCCAGCACTTTGAAAGGCCAAGGCAGATGGATCACTTGAGGTCAGGAGTTCCAGACCAGCCTGGCCAACATGGCAAAACCCCATC"
"GL873575","7451277","7451445","chr6","58863249","58863409","41","51411972","AAAAATTCAGCCAGCCACAGTGGAAGTGGATGCCTGCCATCACAGCTACTCTGGGGGCTGGGGCAAGAGAATTGCTTGATCCCAGGAGTCTGAGGTTGCTGTGACCTAGGCTGACACCACAGCACTCTACCCAGGGTGACAGAGTGAGGCTGTGTTTAAAAAAAAAAAA","TTAGCCAGGCATGGTGGCACATGCCAGTAATCCCAGCTACTCAGGAGGATGAGGCAGGAGAATCGCTTGAACCCAGGAGGCAGAGGTTGCAGTGAGCTGAGATTGCGCCACAGCACTCTACCCTGGGTGACAGAAGGAGACTCTGTCTCAAAAAAAAAAAA"
"GL873576","1765109","1765185","chrX","53921180","53921256","12","52156071","GGCCAGGTGCAGTGGCTCATATCTGTAATCCTAGCACCCTGGGAGGCCAAGGTAGGCGAATCACCTGAGGCCAGGAG","GGCCAGGTGCAGTGGCTCACGCCTGTAATCCCAGCACTTTGGGAGGCCGAGGTGGGCGGATCACTTTAGGTCAGGAG"
"GL873576","2711577","2711895","chr7","6620384","6620702","85","3908807","GGTCGAGCTTGGTGGCTCATGCTTGTAATCCTAGCACTCTGGGAGGCCAAGGCAGGTAAGTTGCCCTGAGCTCATAGGTTCCAGATCAGCATGAGCCAGAGTGAGACCCTGTCTCTACCAAAAAATAGCCCGGCATTCTGGCAGGTGCCTGTAATCCCAGCTGCTTGGGAGGCTGAGGCTAGAGAATCACTTAAACCCAAGGGTTAGTGGAGGTTGCTGTGAGCTATGATTCCACCGTACTCTACTGAGGGCCACAAAGTGAGACTCTGTCTCCATAAAAAAGAAAGAAAGAAAGAAAGAAAAATAAAATAAAATAAAA","GGCCAGGCACAGTGGCTCATGTCTGTAATCCCAGCACTTTGGGAGGCCGAGGCGGGTGGATTACCTGAGGTCAGGAGTTCTAGACCAGCCTGGCCAACAAGGCGAAACCCTGTCTCTACTAAAAATACAAAAAATTAGCTGGGCGTTTTGGCACATGCCTGTAATCCCAGCTACTTGGGAGGCTGAGGCAGGAGAATTGCTTGAACTGGGGAAGTGGAGGTTGCAGTGAGCTGAGATCACACCATTGCACGCCTGAGCAACAGAGCGAGACTCTGTCTCAAAAAAAAAAAAAAAAAAAAAAAAGAAAAGAAAAAGAAAA"
"GL873576","4782520","4782652","chr9","61136941","61137074","22","56354421","CCAGGCACGGTGGCTCACCCTTGTAACCCTAGTACTTTGGGAGGCTGAGGTGGGAGGATCCCTTGAGGTCAGGAGTTCAAGACCAGCCTGAACAACAGTGAGACCCCCGTCTCTACTAAAAAATAGAAAAGTT","GCCAGGCACGGTGGCTCACGCCTGTAATCCCAGCACTTTGGGAGGCTGAAGCGGGCGGATCACCTGAGGTCAGGAGTTCAAGACCAGCCTGGGCACCATGATGAAACCCCGTCTCTATTAAAAATACAAAAATT"
"GL873576","4782930","4783078","chr7","57521645","57521803","40","52738715","AGTTAGTCTGGTGTCATGGTGGGTGCCTGTAGTCCCAGCTGCTTGGGAGGCTGAGGCAAGAGAATCACTTGAGCCCAGGAGTTGGAGGTTGCTATGAGCGAGGCTGTAGCCTAGGCAACAGAATGAGACTTTGCCTCAAAAAAATAAAA","TTAGCTGGGCATGGTGGCGCATGCCTGTAGTCCCAGCTACTTGGGAAGCTGAGGCAGGAGAATCACTTGAACCTGGGAGGTGGAGGTTGCAGTGAGCTGAGATCGCACCGCTACACGCCAGCCTGAGCAACAGAGAGAGACTCTGTCTCAAAAGAAAAA"
"GL873576","7828709","7828723","chr5","101042981","101042996","1","93214272","TAAATAAATAAAAAA","TAAATAAATAAATAAA"
"GL873576","7828960","7829230","chr13","49045537","49045844","89","41216577","GCCGGCTGCAGTGGCTATAATCCAAGTACCCTGGGAGGCTTAGGTGGATGGATCACTTGAGCTCAGAAGTTCAAGACCAGCCTCAGCAAGAGGTAGACCTTGCCTCTATTAAANNNNNNNNNNNNNNNNNNNNNNNNNNNNNNNNNNNNNNNNNNNNNNNNNNNNNNNNNNNNNNNNNNNNNNNNNNNNAGTTTGAGGTTGCTGTGAGCTATGATGAAGCCAGGGCATTCTACCCAGGGTGACAGAGTAACTCTTAAAAAAAACTAAACAA","GGCCAGGCAGAGTGGCTCATGCCTGTAATTCCAGCAATTTGGGAGGCCTAGGCAGGCAGATTACCTGAGGTCAGGAGTTTGAGACCAGCCTGGCCAACATGGTGAAACCCCGTCTCTTCTANNNNNNNNNNNNNNNNNNNNNNNNNNNNNNNNNNNNNNNNNNNNNNNNNNNNNNNNNNNNNNNNNNNNNNNNNNNNNNGGAGATAATAGCTTTTGTAGAACGAAGCGATGCAACAGCCAGATCGCCGCCACCACCCTTAGGTCCTGGCGACAGAGTGAGATCCATCTTAAAAAAAAAAAAAAAAAAA"
"GL873576","10622840","10623093","chr7","60266447","60266705","74","49643607","GCTGGGTATGGTGGTTCACACCTATAATCCTAGCACTCTGGGAGGCTGAGGTGGGAGGATTGGTGGAGCTCAGGAGCTCATGAGGTGCCAAATCACTGGTGCCACACACCTGTATTCCCAGCTACTGAGGAGGCTGAGGCAGGAGGATCAGGTAAGCCCAGGAAGTTTGAGGTTGTAGTGAGTTAGGATGATTGAACTCTGCCTTGAGAGACAGAGCAAGATCCTCCTTCCTCCTAAGCAAACAAACAAATAAA","GGCTGGGTGCAGTGGCTCACACCTGTAATCCTAGCACTTTGGGAGGCTGAGGCGGGAAAATTGCCTGAGCTCAGGAGTTCAAGGACAGCCTAGGCAACATAGCATGGTGGTGCACGCCTGTATTCCCTGCTACTTGGGAGGCTGAGGCACAAGAATTGCTTGAATCCGGGAAGTGGAGGTTGCAGTGAGCCATTGTGGCACTGCTCTCCAGTCTGGGTGACAGAGCAAGACTCCATCTCAAAAAAAAAAAAAAAAAAAA"
"GL873576","10819939","10820007","chrX","67133632","67133707","21","56313693","AGGTTGCAGTGAAATTGTACCATTCCAATGAAGCCTGGGGGACAGAGTGAGATTCTCTCAAAATAAAAA","GGAGGTTGCAGTGAACCGAGATCGTGCCACTGCACTCCAGCCTGAGCGACAGAGTGAAACTTCGTCTCAAAAAAAA"
"GL873576","10920306","10920363","chr3","48261745","48261808","16","37341439","GCTGGACCTTGTAGAGAGTGCCTGTAATCCCAGCTACATGGGGGGCAAGAGAATTGCT","GCTGGGCATGGTGGTGCATGCCTGTGATCCCAGCTACTCAGGAGGCTGAGGCAGGAGAATTGCT"
"GL873576","10920398","10920529","chr10","67341428","67341546","30","56421030","GGCCAGGCGTGGTGGCTCACGCCTGTTGTCCCAGCACTGTGGGAGGCCGAGGTGGGTGGATTGCCTGAGCTCAGAGGAGTCCGGAAGACCAGCATGAGGCAGAGTGAGCCAGAGTAAGATCCTGTCTCTACC","GGCTGGGTGTAGTGGCTCATGCCTGTAATCCCAGCACTTTAGGAGGCCAAGGTGGATGGATTGCCTGAGCTCAGGAGTTCGAGACCACCCTGGGCAACAAGCCAAAACCCTGTCTCTAC"
"GL873577","515809","515961","chr7","137660778","137660931","43","137144969","AGCTGGGCATGGTGGCTCATGCCTATAACCCTAGCGTGCTAGGAGATTGCTTGTCAGGAGACTGAGGTTGCAGGAAACTGTGATGATGGCACTGCACTCTACCCAGGGTGACAGAGCAGGACTCTGCCTCAAAAAAAAAAAAAAAAATAGAAA","TTAGCTGGGCATGGTGGCGCATGCCTATAATCCCAGCTACTTGGGAGGCTGAGGCAAGAGAATCGCTTGAACCGGGGAGGCAGAGGTTGCAGACTGCACTCCAGCCTGTGTGACAGAGTGGGACTCCGTCTCAAAAAAAAAAAAAAAAAAAAAA"
"GL873577","1633164","1633256","chrX","38269524","38269615","26","36636360","TCAGCCAGGCATGGTGGCACTTGCCTATAAACCCAGCTCCTTGGGAAGCTGAGCCGGGAGGATCCCTTGCACCCAGGAGCAACGGAAGGCAGT","AATTAGCCAGGCATGGTGGCACATGCCTATAATCCCAGCTACTCAGAAGGTTGAGGCAGGAGAATCACTTGAACCTGGGAGGCAGAGGTTGC"
"GL873577","3979502","3979560","chr20","68909283","68909346","13","64929781","GAGTTTGAGACCAGCCTGAGCAAGACCGAGACCCAGTCTCTACTAAAAATAGAAAAATT","GGAGTTCAAGACCAGCCTGACCAACATGGAGAAACCCTGTCTCTACTAAAAAATACAAAAATTA"
"GL873577","3979839","3980009","chr10","31403126","31403287","39","27423287","ATGAGCAGATTGTCTTGGTGGGCACCTGTAGTCCCAGCTATTGGAGGTGGGAGGCTGAAGCAGGAAAATCTCTTGAGCCCAGGAGTTTGAGGTTGCTGTGAGCTAGGCTGACACCACGGCACTCTAGTCAGGGCGTCAGAGTGAGACTCCGTCTCAAAAAAAAAAAAAAAA","TTAGCTGAGTGTGGTGGCGCACATCTGTACTCCCAGCTATTTGGGAGGCTGAGGCAGGAAAATCGCTTGAACCCAGGAGGTGGAGGTTGCAGTGAGCCAAGATCACACTACTGCACTCCAGCCTGGGTGACAGAGTGAGAATCCATCTCAAAAAAAAGAAAA"
"GL873577","6050882","6051080","chr1","153219820","153220007","59","147168938","GGCTGGGCGTTGTGACTCATGCCTGTAATCCCAGCACTCTAGGAGGCCGAGGTGGGTGGACTGCCTGAACTCAGAGGTTTAAGACCATCCTGAGCCGCAGTGAGCCAGAGCGAGACCCTGTCTCTACCAAAAAAAGCTGGGTGTTGTGGTGGGCGCCTATAGTCCTAGCTACTTGAGGCGCTAAGGGTAAAAAAATTGC","GGCCTGGCACAATGGCTCACGCCTGTAATCCTAGCACTTTGGGAGGCCGGGGTGGGTGGATCACCTGAGATCAGGAGTTTGAGACCAGCCTGGCCAACATGGTGAAACTCCTTCTCTACAAAAATTAGCCAGGTGTGGTGGTGGGTACCTGCAATCCCAGCTATTTGGGAGGCTGAGGCAGGAGAATC"
"GL873577","8463965","8464050","chr9","52134422","52134508","19","43670457","CTGGGTGCTATAGCTCACGCCTATAATCCTAGCACTCTGGGAGTTTGGGGCAAATGGATCACCTAGGCTCAGGAGTTTGATACCAG","GGCTGGGAGCAGTGACTCACGCCTATAATCCCAGCACTTTGGGAGGCTGAGGCAGATGGATCACCTGAAGTCAGGAGTTCGAGACCA"
"GL873577","9471486","9471613","chr16","5178790","5178910","46","4292696","TTAGCCAGGCATAGTAGCCTGTGTGTAGTCCTAGCTACTCAGGAGGCTGAGGTAGATGGGTCACTTGAGGTTGCAGAGATTATGGTAATGTCACTGTACTCTAGCCCTGGCAACAGAGCACAACCCTG","TTAGCCGAGCCTGGTGGCATAAACCTGTAATCCCAGCTACTCAGGAGGCTGAGGCAGGGGAATTGCTTGAACCTGAGAGGAGAAGGTTGCAGTGAGCCGAGATTGCACCATTGCACCCCAG"
"GL873577","9471875","9471998","chr7","17832200","17832315","36","8360325","GGCCAGGTGAAGCAGCTCATGGCTATAATCCTAGCAGTTTGGCAGGCCAAGGTGGGAGGACTGCTTGAGGTCAAGAGTTCAAGACCAACCCATCTTTGCGAAAAATTTAAAAATTACCTAGGCA","GCCAGGAGAGGTGGCTCATGCCTCTAATCCCAGCACTCTGGAAATCCAAGGTGGGTGGATCACCTGAGGTCAGGAATTCCAGACCAGTCTGGCCAATATAAAAAATTAGCCAGGCT"
"GL873577","9853150","9853170","chr3","85044647","85044667","3","75191497","AAACAAACAAACAAAAAAAGA","CAAACAAACAAACAAACAAAA"
"GL873577","9853206","9853473","chr7","130818682","130818963","67","120965476","GCTGGGCGCAGCGTCTCACTCCTGTAATCCCAGCACTTGGGAGGCCAAGGTGAGTGGATTGCCTGAGTTTACAGTTTCGAGACCAGCCTGAGCCAAAGCGAGACCCCCATCTCTAAAAAATAGCTGGGCATTGTGGTGGGCACCTGTAGTCCCAGCTACTTGGGAGGCTGAGGCAAGAGGATCGCTTGAACCTAAGAGTTTGAGGTTGCTGTGAGCTAAGGCTCCATGGCATTCTACCAAGGGTGACTAAGTGAGACTCTGTCTAAAA","GCCGGGCACAGTGGCTCACACCTGTAATCCCAGTACTTTGGGAGGCCAAGGTGGGTGGATCACCTGAGGTCAGGAGTTTGAGACCAGCCTGGCCAACATAGTGAAACTCTACTAAAAATACAAAAAAATAGCTAGGCATGGTGGTGCGCACCTGTAATCCCAGCTACTTGGGAGGCTGAGGCAGGAGAGTTGCTTGAACCCAGCGGGGTTGAGGTTGCAGTGAGTTAAGATCAAGCCACTGTGCTCCAGCCTGGATGACAGAGAGAGACTCCATCTCAAAAA"
"GL873577","10722415","10722478","chr10","12501471","12501539","23","1779056","AATAAAAAAATGCTGGGTACAGTAGTACATGCCTGTACTCTCATCTGGGGAAGCTGAGGCATGA","AAAGTAAAAAATTAGAGCTGGGCATGGTGGCACACACCTGTAATCCCAGTCACTAGGGATGCTGAGGCA"
"GL873578","463331","463568","chr10","28935382","28935620","93","28472051","CAGGTGCTTTGACCCACACCCTCAACTCTAGGACTTTGGACGCCCTGGCTGGGTGGGTCCTTTAAAGTCAGGAGCTTCTTATCAGTCTGGGCAAAAGTGAGACCCCATCTCTACCAAACAAAGAAAGAAATCAGCAGTATGTTGCAGTAGAGACTCACCAATACCTTCTTTCAAAGACCAAAGCTGGAAGGACACTAAAGACCATGATCTCATGGCCTCCCTGAGCCATGACAATGCC","CCAGGTGCAGTGGCTCATGCCTGCAAGCTCAGAACTTTGGGAGGCAGAGGTGAGCAGACTGCCTGAGTTCAGGAGTTCAAGACCAGCTGGGCAACATGGTGAGACCCTATCTCTACTAAAAATACAAATAATTAGCAGGGTGTGGTAGCACACACCTGTAGTCCAGCTACTCAGGAGGCTGAGGCAGGAGAATTGCTTGAACCCAGGAGGCAGAGTTTGCAGTGAGCCAGGACTGGGCC"
"GL873578","1143712","1143827","chr11","52824583","52824692","30","51680871","GGCTGGGTGTGGTGCCTCATGCCTGTAATCTAAGCCCTCTCCGAGGCTGAGGTGGGAGGATCCCTTGAGTTTAGGAGTTTGATTTTGAGACCAGCCTGATCAAGAGAGAGACCTCA","GGCCGGGTGTGGTGGCTCATGTCTGTAATCCCAGCACTTTGGGAGGCTGAGGTGGGTGGATACCCTGAGGTCGGGAGCTCGAGACCAGCCTGACCAACATGGAGAAACCC"
"GL873578","1144101","1144139","chr3","33494224","33494257","11","32350123","GAGAGAGACCTCATGTCTACTAAAATAAATAAATATATA","GTGAAACCCGTCTCTACTAAAAATACAAAAATTA"
"GL873578","1144175","1144343","chr12","119519961","119520131","41","118375786","ATTATCCAGGCCTTCTGGTGGATGCCTGTAGTCCTAGCTACTAGAAAAGCTGGAGCAGAATCACTTGACCCAGGAGCTGGAGGTTGCAGGGAGCTAGGCTGATGCCACAGAATTCTAGCCTGAGGCAAAAGAATTGAGCCACTGTCTCAAAAAGGAACAAAAAAGAAAA","ATTAGCCAGGTGTGGTGGCATGCACTTGTAATCCCAGCTACTAAGAAGGCTGAGGCAGGAGGATCACTTGAACCCGGGAGGTGGAGGTTGCAGTGAGCCAAGATCATGCCACTGCACTCCAGCCTGGGCAACAGAGTAAGACTCTGTCTCAAAAAAAAAAAAAAAAAAAAA"
"GL873578","4593962","4594035","chr16","68825055","68825124","22","64231093","AGCTGGGTACAGTGGCTCACATATAATCCCAGTGACTCAGGAGGCTAAGACAGGAGGATTACTAGGACCTGAGA","GGCTGGGCACAGTGGCTCAGACCTGTAATCTCAGTACTTTGGGTGGCTGAGGCAGGTGGATCACCTGAGG"
"GL873578","6158845","6158972","chr3","500432","500562","24","5658413","GACATGGTGGCTCACACCTGTAATCCTAGCCCTCTGGGAGGCTGAGGCAGGTGGATCACTTGAGTTCAGGAATTCAAGACCAGCTTGAGTGAGAGCAAGACCCTGTCTCTACTAAAAATAGAAAAATT","GCACGGAGGCTCATACCTGTAATCCCAGCACTTTGGGAGGCTGAGGCAGGTGGATCACCTGAGGTCAGGAGTTCCAGACCAGCCTGGCCAACATGGCGAAACCCTGTCTCTACTAAAAATACAAAAAATCT"
"GL873578","6159253","6159444","chr19","34496349","34496541","55","28337096","ATAAAATAAAAATAGAAAAATTAGCCAGGCATTGTGGCAGACATGCGAAGTCTCAGCTACTCCAGAGGCTGAGACAGGAAGATTACTTGAGCCCAAGAATCTTGCTGTGAGCTAAGCTGATGCCATAGCATTGTAACCTAGGCAACAGAGTAAGACTTGGCCTCAAAAATAAAATAAAATAATAAAGTAAAA","TTAGTTAATTAAATTAAACTTAGCTAGGCATAGTGGAACACACCCATAGTCCCAGCTACTCTAGAGGCTGAGGCAGGAGGATTGCTTGAGCCAAGTTGGAGGCTGCAGTGAGCTATGGTGGTGCCACTGCATTCCAGCCTCAGTGACAGAGAGAGACCCTGGCTCAAATAATAATAATAAATAAATAAATAAA"
"GL873578","6766040","6766171","chr2","93098086","93098217","30","86332046","CCAGGCACAGTGGCTCATGCCTATAATCCTAGTAGTCTAGGAGGCTGAGGTGAGTGCATTGCTTGAGCTCAGGAGTTAGATACCAGCCTAACCAAGAATGAGACCCCATCTCTATTAAAAATAGAAAAGTTA","GCCGGGCACAGTGGCTCATGCCTGTAATCCCAGCACTTTGGGAGGCCGAGGCGGGCAAATCACGAGGTCAGGAGTTCAAGACCAGCCTGACCAATATGATGAAACCCCGTCTCTATTAAAAATACAAAAATT"
"GL873578","6766434","6766577","chr9","21128084","21128223","50","14361650","GTTAGCCAGGAGTTGTGGCGGGCACCTACAGTCCTAGCGACTCAGGAGGCTGAAGTAGGCAGAGTTTGATGTGTTGCTGTGAACTACAAGGACACCAATGCACTCTAGGCCGGTAACAGAGTGAGACACTGACTAAAAAAAAAA","TTAGCCAGGTGTGGTGGCACATGCCTGTATTTCCAGCTACTCGGGAGGCTGAGGCAGGAGAATTGCGTGAGCTGAGATCATGCCACTTCATTCCAGTCTGGGTGACAGAGTGAGACTCTGCCTCAAAAAACAAAACAAAA"
"GL873578","7397948","7398119","chr5","40230148","40230319","43","32832200","TAAAAATAGCCATGCATTGTGACAGGCACCTGTAGTCCCAGCTACTCAGGAGGTTGAGGTAAGAGAATCACTTGAACCCAAGAGTTTTGAGGTTGTTATGAGCTAAGACGCCTCGGGACTCTACAAAAGGTAACAAAGTGAGACTCTGTCTCATAAAAAAAGAAAAAAAGAA","AAAATTAGCCAGGCATGGTGACGTACACCTGTAGTCCCAGCTACTCGGGAGGCTAAGGCAAGAGAATCGCTTGAACCCAGGAGGCAGAGGTTGCAGTGAGCTTAGATCACGCTACTGCGCTCCAGCCTGGGTGACGGAGTGAGACGCCATCTCAAAAAAAAAAAAAAAAAAA"
"GL873578","7398378","7398515","chr15","102382935","102383070","35","94984557","GGTCGAGCAAGGTGGCTCACGCCTGTAATCCTAGCACTCTGTGAGGCTGAGGCAGATGGATTGCCTGAGCTCGTGGGTTCGAGACCAGCCTGAGCCAGAGTGAGACCTCATCTCTAAAAATAGCTGGGAAGCTGGGCA","GGCCAGGTGTGGTGGCTCACGCCTGTAATCCTAGCACTTTGGGAGGCTGAGGCGGGTGGATTGCCTGAACTCAGGAGGTCAAGACCAGCCTGGGCAACACAGTAAAACCCCATCTCTACTAAAATACAAAAAATCA"
"GL873579","370235","370429","chr16","38067345","38067552","57","37697110","GCACAGGCCTGAAATCCTAGCACTCTGAAAGGCCAACGGAGGAGAATTTCTGGAGCTCAGGAGTTTGATACCAGCCTAAGCAAATAAAGCTAGACCTCTATCTCTACTAAAATTAGAAAAATTAGGCAGATGTGGTGGTAGGCACCTATAGTCCCAATTACTCCAGAGGCTGAGGCAGAAAGACTCTTGAACCCA","GTCAGGCATGGTGGCTCATGCCTATAATCCTAGCACTTTGGGAGGCCAAGGCCGGTGGATCACCTGAGGTCAGGAGTTTGAGACCAGCCTGGCCAATATGGCAAAACCCCGTCTCTACTAAAAATAAAAAAATTAGCTGGGCACGGTGGTGGGCACCTATAGTCCCAGCTACTCAGGAGGCTGAGGCAGGAGAATTGCTTGAACCCAG"
"GL873579","370936","371046","chr3","3847698","3847802","33","3476762","TGACTCTTGAACCCAGGCACATGAGGTTGCTAAGAGTCTAGGCTGATGTCACGGCACTCTAACCTGGGAAACAGTGTGAGGTTCTGCCTCAATAAATAAATAAATAAATAA","TGGCTTGAACCCAGGAGGCGGAGGTTGCAGTGAGCCGAGATCACGCCACTGCACTCCAGCCTGGGCAACAGAGCGAGACTGTCTCAAAAAAAAAAAAAAAAAAAA"
"GL873579","599436","599605","chr10","38982686","38982853","41","38383250","AAAAAGTCAGACATTGTGGCAGGTGTCTGTAATCCCAGCTATTTGGGAGGCTGAGGCAGGAGTATCATTTGAACCCACGAGTCTGAGGTAACTGTGAGCTAGGCTAACACAACAGCACTCTAGCCTGGGCAATAGAATGAGACTCTATCAAGAAAAGAAATGAAAAGAAA","TATTAGCCTGACACAGTGGCGCGCATCTGTAATCCCAGCTACTTGGGAGGCTGAGGCAGGAGAATCACTTGAACCCAGGAGGCGGAGGTTGCTGTGGGCTGAGATCATGCCACTGCACTCCAGCCTGGGCAACAGAGGGAGGCTCCATCTCAAAAAAAAAAAAAAAAA"
"GL873579","599942","599953","chr3","71473700","71473710","4","70873758","TTTTAAAATAGT","TTTAAAAAAAA"
"GL873579","600232","600365","chr1","16061315","16061447","30","15461083","GGCTAGGCAAGGTGACTCATGTCTGTAATCCTAGTACTCTGGGAGGTTTGAGGCAGGAAGACCACTTTAGCTCAAGAGTTCCAGATCAGCCTGTGCAAGAGTGATACATCATCTCTACTAAAAATCAAAAATTA","GGCTGGGCATGGTGGCTCATGCCTGTAATCCTAGCACTTTGGGAGGTTGAGGCAGGCAGATCACTTGAGGTCAGGAATCTGAGACTAGCCTGGCCAACATGGTGAAACTCCATCTCTACTAAAAAAAAAAAAA"
"GL873579","5650320","5650591","chr6","54938866","54939145","71","49288546","GTCAGGTGTGTTAGCTTACAGTAGTAATCCTAGCACTTTGGGAGGTTGAAGTGGGTGGATTGCTTGAGCTCAGGGGTTCAAGACCAGCCTGAACAAGAGTGGGACCTCATCTCTATTAAAAACAGAAAAACTAGCTGGGTGTTATGGTGGGTGTCTGTAGCCCCAGCTACTCAGGAGGCTGAGGCAGGAGGTTGAGGTTGCTGTGAGCTATTGAGACCACAGCACTCTATCCAGGGCAACAGAGTGAGACCCCTCCCCCCCCCAAAAAAAAA","GGCCAGGTGTGGTGGCTCACGCCTGTAATCCCAACACTTTGGGAGGCCGAGGTGGGTGGATCACCTGAGATCAGGAGTTCAAGACCACCCTGGCCAACATGGTGAAACCCCGTCTCTACTAAAAATACGAAAATTAGCTGAGTGTGGTGGTGCATGCCTGTAGTCCCAGCTACTCAAGAGGCTGAGGCAGGAGGTGGAGGTTGCAGTGAGCCGAGATTGCATCACTGCACTCCAGCCTTGGCGACAGAACGAGAGAGACTCCATCTAAAAAAAAAAAAAA"
"GL873579","7037162","7037347","chr3","37328686","37328893","67","30291524","GAGGTGGGTGGATTGCCTGAGCTCACAGGTTGGAGACCAGCCTGAGCCAGAGCAAGACCTTATCTCAAAAAATAGCCAGGTGTTGTGGCTGGCACCTGTAGTCCCAGCTGCTCAGGAGGCGGAGGCAAGAGAAATGCTTGACCTCAGGAGTTTGAGGTTGCTGTGAGTTCAACTCACACTAATACA","GAGGCAGGGGGATCACCTGAGGTCAGGAGATCGAGACCAGCCTGGCCAACATGGTGAAAACCTGTCTCTACTAAAAATCCAAAAACATTAGCCAGGTGTGGTGGCACGCACCTGTAATCCCAGCTACTTGGGAGGCTGAGGCAGGAGAATCACTTGAACCTGGGAGGCAGAGGTTGTAGCGAGCCGAGATCACACCACTGCACCCCAG"
"GL873579","11077764","11077972","chr19","1200469","1200683","63","9877295","GCCAGGTGCAGTGGCTCATGCCTATAATCCTAGCACCCTAGGAGGCTGAGGAGTTCAAGACCAGCCTAAGCAACTGTGAGACCCCATCTCTACCAAAAATAGAAAAATTAGCTGACTGTTATGGTGTGCACCTACAGTCCTAGCTACTCAGGAGGCTGAGGCAGAAAGAGTCCTTGAACCCAGGAGGCTTTTTTTTGTTGTTGTTGTTG","GGCCAGTCGCGGTAGCTCATGCCTGTAATCCCAGCACTTTGGGAGGCCGAGGCGGGCAGATCACCTGAGACCAGCCTGGCAACATGGTGAAACCCCATGTCTACCCAAACTACAAAAATTAGCTGGGTGTGGTGGTGCACGCCTGTAATCCGAGCTACTCAGCAGGCTGAGGCAGGAGAATCCCTTGAACCTGGGAGGCAGAGGCTGCAGTGAGC"
"GL873579","11078245","11078333","chr19","4926258","4926351","22","6151987","TGAACCCAGGAGTTTGAGTTCGCTGTGAGCTAAGCTGAGGCCACAGCACTCCAGCCTGGGCAACAGAGTGAAAGGAAAAAAATAAAAAA","TGAACCCGGGAGGTGGAGGTTGCAGTGAGCCAAGATCACACCAATGCACTCCAGCCTGGGCAACAAGAGTGAAACTCTGTCTAAAAAAAAAAAA"
"GL873580","320374","320488","chr13","48549305","48549409","42","48228931","GGTAGTGCGTGCCTGCATTCCCAGCTACGGGAGGGCAGGGACTTGAGGCCAGCCTGGGCAAAATAATGAGACCTACTAATGACTCTACTAATACAGAAACAATTAGCTAGGTATG","TGGGAGGCCGAAGTGCGCAGATCACCTGAGGTCAGAAGTTGGAGACCAGCCTGGCCAACATGGTGAAAACCCATCTCTACTAAAAATACAAAAATTAGCTGGGCA"
"GL873580","374969","375091","chr6","147681010","147681135","27","147306041","CGGTGGCTCACACCTATAATCCTAGCATTTTGGAAGGCTGAAGCCGAGGATCTCTGGAAGTCAGAAGTTCAAGACCAGCCTGCCCAAGAGCAAGACCCCATCTCTACTAAAAATAGAAAAACT","GGTGGCTCACACCTGTAATCCCAGCATTTTGGGAGGCTGAGGCAGGCGGATAATCTGAGGTCAAGAATTTGAGACCAGCCTGGCCAACATGGAGAAACCCTATCTCTACTAAAAATACAAAATTAC"
"GL873580","375369","375549","chr7","19977275","19977456","44","19601906","CTAACCAAGTTAGTTAGTTTTAGTTGGCAGGTGCCTGTAGTCCCAGCTCCTTGGGAGGCTGAGGCAAGAGAATGGCTTGAGCCCAGGACTTTGAAGTTGCTGTGAGCTATAATGACACCACAGCACACTACCCAGGGTGACAGAGTGAGACTGTCTCAAAAAAACAAACAAACAAAAAAAA","AACAAACGTTAGCCGAGCATGGTGGTATGTGCCTGTAGTCCCAGCTACTTGGGAGTCTAAGGCAGGAGAATTACTTGAGCCCGGGAGGCAGAGGTTGCTGTGAGCCAAGATCACGCCACTGCACTCCAGCCTGGGTGACAGAGTGAGACTCCATCTCAAAAAAAAAAAAGGAAAAAAAAAAA"
"GL873580","8760922","8761015","chr11","104681322","104681416","19","95920400","GGAGGGAGACACTGCAGTGAACTGCGATCGTGTCTCTGCTTTCCAGGCTGGGTGACAGAGTGAGACTCGGTCTCTAAAATAAAAAATAAATAAA","GGAGACGGAGGTTGCAGTGAGCTGTGATCGCGGCACTGCACTCCAGCCTGGGCAACAGAGTGAGACTCTGTCTCAAAAATAAATAAATAAATAAA"
"GL873580","9391260","9391306","chr14","49279240","49279285","12","39887980","GCCAGTCGAGGTGGCTCACACTTGTGATTCCAGCTACTTGGAAGACT","GGCTGAGATGGTGGCACACACCTGTAATCCCAGCTACTTGGGAGGC"
"GL873581","759283","759365","chr6","46535476","46535542","30","45776193","TAAGAACCTGAAAATAGAGCCAGGCATAGTGGTACATGCGTATAGTCCTGGCTACTCAGGAGGTTGAAACAACAGGATTACTT","CAAAATAGCCAGGCTTGGTGGTGCATGCCTATAATCCAAGCTACTCGGGAAGCTGAGGCAGGAGAAT"
"GL873581","1145844","1145979","chr1","29437872","29437991","29","28292028","GGCCGGGCGTGGTGGCTCACGCCTGTAGTCCCAGCACTATGGGAGGCCGAGGCGGGTGGATCACCTGTGCTCAGAGGTTCGAGACCAGCCAAGACCCCCCTGAGCCAAATGAGCCAGAGTGAGACCCCGTCTCTAC","GGCCGGGCGTGGTGGCTCACGCCTGTAATCCCAACATTTTGGGAGGCCAAGGCGGGTGGATCACCTGAGGTCAGAAGTTCGAGACCAACCTGGCCAACATGGTGAAACCCCTGTCTCTAC"
"GL873581","9628238","9628362","chr5","141044567","141044691","34","131416329","ATCCCAGGTAGTCGGGAGGCTGAGGCAGGAGGATCACTTGAACCCAGGAGGTTGAGGTTGCTGTGAGCAAGGCAGAGGCAACGGCACTCTAGCCACGGGGGCACAGAGACTCTTGTCTTTAAAAA","TAATCTCAGCTACTCGGGAGGCTGAGGCAGGAGAATCGCTTGAGCCCAGAAGGTGGAGGTTGCAGTGAGCCAAGATCGCGCCATTGCACTCCAGCCTGGGCGACAGTGCGAGACTCTGTCTCAAA"
"GL873582","1580485","1580534","chr6","32576760","32576806","12","30996275","CAGCACTTGAGAGGCCAAGGCAGGTGGATCAACTGAGCAAGAATGAGACC","CCAGCACCTTGAGAGGCCAAGGCAGGTGGATCACCTGAGGTCAGGAG"
"GL873582","1644368","1644551","chr1","211626449","211626612","63","209982081","AAAATTTGCCGGGCTCCATAGCTCATGCATGTAATCATAGCACTCTGGGAGGCCAAGATGGGAGGATCTCTCAAGCTCTCTTACTTGGGAGGCTGAGGTTGCTGTGAGTTAGGCTTACGCCACAGCACTCTACTCTAGCGTGAGCAACTCTACTCTTAGTATGAGACTGTCTCAAAAGAAAAAA","AAATTAGCCAGGCGTCGTGGCACATGCCTGTAATCCCAGCTACTCGGGAGGCTGAGGCAGGAGAATAGCTTGATCTCGGGAGGCGGAGGTTGCAGTCAGCCGAGATCACACCACTGCAATCCAGCCTGGACAACAGAATGAGACTCCATCTCAAAAAAAACAAA"
"GL873582","5794385","5794459","chr13","18872784","18872852","27","13078399","ATATTGTTAAGCACAGCCACTATTAAAAATTAAATTATAGGCCAGGCATAGTGGCTCATGCCTGTAATCCTAGCT","TGAAACCACCATCTGGACCAAGATACAAAATGTTGGCTGGGCATGGTGGCTCACACCTGTAATCCTAGC"
"GL873583","102645","102683","chr14","5808766","5808804","14","5706121","GAGCAGATCACCTGAGCTCAGGAGTTTGAGACCAGCCTG","GAGGAATCCCTGTGCTCAGGAAGCTTACATTCTAGTGAG"
"GL873583","6200447","6200560","chr4","17786849","17786963","24","11586402","GGCCAGGAGGGACGGCTCATGCCTGTTATCCTAGCACTATGGGAGACTGAGGTGGGAGGATCACTTGAAGTTAGGAGTTCCAGACCAATCTGACCAAAGTGAGACCTCATCTCT","GGCCAGGCTTGGTGGCTCATGCCTGTAATCTTAGCACTTTGGGAGGCTGAAGTGGGTGGATCACTTGAGGTCAGGAGTTAGAACCAGTCTGGCCAACATGGTGAAACCTCAGCTC"
"GL873583","6200584","6200752","chr6","169626528","169626696","42","163425944","TTAGCTGGATGTGGTAGCACATGCCTATAGTCCCATCTACTCAGGAGGCTGAGACAAGAGAGTTGCTTAAGCCCAGGAGTTTAATTTAACTGTGAACTAGACTGAGACTGTGGCACTCTAGCTGGGGCAACAGAGTGAGACTCTGTCTCAAAAGAAAGCAAGAAAGAAA","TTAGCTGGGTATGGTGTCAGATGCCTGTAGTCCCAGCTACTCAGGAGGCTGAGACAGGAGAATCGTTTGAACCCAGGAGGCCAGAACTGCAGTGAGCTGAGATTCGCACCACTGCGCTCCAGCCTGGGCCAGACAGAGTGAGACTCTATCTCAAAAGAAAAAAAAAAAA"
"GL873583","10217398","10217583","chr3","36257142","36257313","44","26039744","TACTAAAAATAAAGTGTGATAGCCAGGCATGGTGGTGGTGCCTATAGAACCAGGCTATTCAGGAGGCTGAGGCAGAAGGATCACTTGAACCCAGGAGTCTGACGTTGCTGTGAGCTAGGCTGGTGCCATGGTACTCTAGCCTGTGGTAACAGAATGAGACTCTATCTCAAAAATAAAAATAAAAAA","TACAAAATTAGCCAGGCGTGGTGGTGCGTGCCTGTAATCCCAGCTACTTGGGAGGCCGAGGCAGAAGAATGACTTGAACCCAGGAGACAGAGGTTGCAGTGAGCCAAGATCCCACCATTGTACTCCAGCCTGGGCAACACAGTGAGACTCCATCTCAAAAAAAAAAAAAAAA"
"GL873583","10394919","10394983","chr16","12841703","12841771","22","2446784","GAGGTCAGGAAATCAAGATCAGTCTGGGCAATATATTGATACCCTGCCCCTACATAAGGAAGAAA","AGGTCAGGAGTTCAAGACCAGCCTGGCCAATATGTTGAAACCTCATCTCTACTAAAAATACAAAAATTA"
"GL873584","521512","521529","chr1","167402212","167402233","10","166880700","GCATGGAACCCCCCACTC","GGTGAAACCCCATCTTTACTAA"
"GL873584","2079725","2079768","chr15","4338291","4338335","11","2258566","GGCAGGTGGATTACCTGAGTTCAGGAGTTGGAGACCAGCCTGAC","AGGCGGATGGATCACGAGGTCGGGAGTTTGAGACCAGCCTGACCA"
"GL873584","5216877","5217053","chrX","91350057","91350230","49","86133180","CTACTGAAAATGATGACAGAGGCTGGGCATGGGGGCTCCCGCCTGTTATCCTAGCACCCTCGGAGGCTGGGGAATGAGGATTGCTTACGCCCAAGAGTTTGAGGTTGCTGTGAGCTGAGGCCGCTGCACTCTAGCCTGGGCAACAGAGTGAGACTCTGTCTCAAAAAAAAAAAAAAA","TGCAAAAATGAGCTGGGCATGGTGGCACATGCCTGTAATCCCAGCTACACAGGAGGCTGAGGCAGGAGAATCGCTTGAATCTGGGAGGCGGAGGTTGCAGTGAGCTGACATCAGGCCCCTGCACTCTAGCCTGGGCCACAGAGCAAGACTCCGTCTCAAAAAAAAAAAAAAAAA"
"GL873584","7289930","7289950","chr2","51453328","51453345","10","44163398","TGAGGCTCTGTCTCGAAATAA","AATGCCATCTATTAAAAA"
"GL873584","7289975","7290131","chr11","49739997","49740154","37","42450022","CAAGAAAATTAGCTGAGAGTCCTGGTAGGTGCCTGTAATCCCAGCTATTCATGAGGCTGAGGCAGAAGGATCACTTGGGTCCAGGAGTCTGAGGTTGCTGTGAGCTAGTCTGACGCCATAACACGCAAGCCTGGGCAACAGAGTGAGGCTCGGTTTC","CTACAAAAATTAGCTGGGCGTGGTGGCACATGCCTGTAATCCCAGCTACTCGGGAGGCTGAGGCAGGAGAATCACTTGAGCCCAGGAGGCGGAGGTTGCAGTGAGCCAAGATCATGCCATTGCACTCCAACCTGGGCAACAGAGCAAGACTCCATCTC"
"GL873584","7577743","7577867","chr5","48394329","48394446","27","40816586","GGCTGGATGAGGTGGTTCATGCCTGTAATCCTAGCACTCTGGGAGGCCAAGGTGGGTGGATTGCCTGAGCTCAGGAGTTCAAGACCAGCCTGAGCAAGACCCTGTCGCTAAAAATAGCTGGGTGT","GGCTGGGTGCAGTGGCTCATGCCTGTAATCCCAGCACTTTGGGAGGTCAAGGCGGGTGGATCACCTGAGGTCAGGAGTTCAAGACCAGCCTGGCCAACATCTCTACTAAAAATACAAA"
"GL873584","7578135","7578289","chr1","130112713","130112865","31","122534578","GGAGCTGGGTTTTGTGACTGCACCTGTAATCCCAGCTGCTCAGGAGGCTGAGGCAAGAGAATTGCTTGAGCCCAGGAGTTGGAGGTTGCTGTGAGCTGTGATGCCAGGGAACTCTACCAAGGGTGACAAAGTGAAACTCTGTCTCAAAAAAAAAA","TTAGCCAGGTGTGGTGATGCATGCCTGTAATCCCAGCTACTCATGAGGCTGAGGCAGGAGAATTGCTTGAACCTTGGAGCTGGAGGTTGCAGTGAGCTGAGATCAGACCACTCCAACCTGGGTGACAGAGCGAGACTCTGTCTCAAAAAAAAA"
"GL873585","1450952","1451121","chr10","59681079","59681242","48","58230127","TAAAAACAGAAAAAACTAGTCAGGTGGTGTGGTAGGTGCTCATAAGTCCCAGCTGCTTGGGAGACTGAGGCAAGAGAATCACTTGAGCACAAGAGCTTGAGGTGGCTGTGAGCTATAACACCATAGCACTGTACTGAGGGTGACAAAGTAAGACTCTGTCTCAAAAAAAA","TACAAAAATTAGTCAAGGGTGGTGGTATGTGCTTGTAATCCCAGCTATTTGGGAGGCTGAAGCAGGGGAATCCTTGAACCCAGGAGGTGGAGGTTGCAGCGAGCCGAGATCACGTCACTGCACTCTAGCCTGGGCGATAGGGTGAGACTCTGTCTCAAAAAAAA"
"GL873585","1451382","1451515","chr6","17405813","17405948","24","15954431","GGCCCGGCTCGGTGGCTCACACCTATAATCCTAACACTCTGGGAGGCTGAGGCAGGTGGATCACCTGAGCTCAGGAGTTTGAGACCAGCTGAGCAAAAACAAGACCCTATCTCTGCTAAAAATAGAAAAAACTA","GGCCGGGCGGGGTGGCTCACGCCTGTAATCCCAGCACTCTGGGAGGCCAAGGCAGGTGGATCACCTGAGGTCAGGAGTTTGAGACCAGCCTGGCCAACACGCAGAAACCCTATTTCTACTAAAAACACAAAAATTA"
"GL873585","1626960","1627026","chr7","17782729","17782794","22","16155769","AAGATGCCACAGCACTCTACAAGAGTGACCAAGTGAGACTCTGTCTCAAAAAAAAAAAGAAAAGGAA","CAATCGCACTACTGCACTTCAGCCTGGGTGACAGAGTGAGAACCTGTCTCAAAAAAATAAATAAAA"
"GL873585","1627304","1627531","chr11","17033552","17033788","61","15406248","GGCTGGGCACAGTGGCTCACGGCTATAATCTAGGCACTTGGGAGGCTAGGGCAGGTGGATTGCCTGAACTGACAAGTTTGAGACCAACCTGAGCAAGAGCGAGACCCCTGTCTCTAAAACATAGCCAGGCTCTGTGGTGGGCGTCTGTAGTCCCAGCTACTTGGGAGGCTGAGGCAAGAGAATTGCTTGAACTCAAGAGTCTGAGGTTGCTGTGAGTTAAGATGCCAC","GCCCGGCGCAGTGGCTCACGCCTGTAATCCCGGCACTGTGGAGGCCAAGGCAGGCGGATTGCCTAAGCTCAGGGATTCGAGAACAGCCTGGGCAACATGGTGAAACCCCATCTCTACTAAAATACAAAAAACTAGCCGGGCGTGGTGGTATGCGCCTGTAATCCCAGCTACTTGGGAAGCTGAGGCAGGAGAATTGCTTGAACCCGGGAGATGGAGGTTGCAGTGAGCTCAGATCAC"
"GL873585","3626082","3626158","chr1","100916857","100916922","27","97290775","TGCCTGTAATCCCAGCACTTGGGAGGCGGAGGTGGGTAGATTGCCTGACCCAGAGTGGGACCTCATCTCTAAAAGAA","CATGCCTGTAATCCCAGCACCTTGGGAGGCCAAGGTGGGTGGATCACCTGAGGTCAGTAGTTTGAG"
"GL873585","8849829","8849913","chr18","48581945","48582025","18","39732116","GGCTGGACGAGGGGACTCATGCCTGCAATCCCAGCACTGAGAGAGGCCAAGGCAGGTGGATCCCCTGAGCTCAGAAGTTTGAGAC","GCTGGACGCAGTGGCTCACACCTGTAATCCCAGCACTTTGGGAGGCCAAAGCAGGCAGATCTGAGGTCAGGAGTTTGAGAC"
"GL873585","9319890","9319971","chr8","79499361","79499447","14","70179471","GGCCAGGTGTGGTGGCTCACACCTGTCATCCTAGCACTCTGGGAGGACGAGGTGGGTGGACCGCCTGAGTCAGAGTGAGACC","GGCCAGGTGTGGTGGCTCACACCTGTAATCCCAACACTTTGGGAGGCCCAGGTGGGTGGATCACCTGAGGTCAGGAGTTCAAGACCA"
"GL873586","895572","895692","chr17","14501559","14501680","38","13605987","GGCCAGGTGAGGTTTCTCATTCTGGGAGTGAGCCAGCAATTGGGAGGCCAAAGTAAATGGATTGCCTGAGGTTATAGGTTCCAGAACAGCCAGAACAAGATCGAAATCCTGTCTCCAAAAA","GGCCAGGCGTGGTGGCTCATGCGTGTAATCTCAGCACTTTGGAAGGCCGAGGCAGGTGGATCACCCGAGGTCAAGAGTTCAAGACCAGCCTGACCAACATGGCGAGTCTCTGTCTCCACTAA"
"GL873586","5645995","5646150","chr6","58863249","58863409","38","53217254","GGGTATGGTGGCTCATGCCTGTAATCCAAGCACTCTGGGATGGTGAGGCAGGAGAATCCCTTGAACCCAAGAGTCCGAGGTTGCTGCGAGCTAAGCTGATGGCATAACACTCTAGCCTAGGCGACAGAGTGAGACTCTGTTTCCAAAGAGAAAAAA","TTAGCCAGGCATGGTGGCACATGCCAGTAATCCCAGCTACTCAGGAGGATGAGGCAGGAGAATCGCTTGAACCCAGGAGGCAGAGGTTGCAGTGAGCTGAGATTGCGCCACAGCACTCTACCCTGGGTGACAGAAGGAGACTCTGTCTCAAAAAAAAAAAA"
"GL873586","10258686","10258969","chr12","9481260","9481565","81","777426","GGCCGGGCATGGTGGCAGAAATCTAGGAGGCCGAGGCAGGTGGATCGCCTGAGATCACAAGTTCAAGACCAGCCTCAGCTACAGCAAGACCCCATCTCTAAAAATAGCCGGCTGTTGTGGCAGGCGCCTGTAACCCCAGCTACTCGGGAGGCTAAGGCAAGAGAATCGCTTGAGCCCATGAGTCTGAGGTTGCTGCGAGCTGTGACTCCACGGCACTCTACCCGGGGCGATAAAATGAGATTCTGTGTCAAAACAAACAAACAAACAAACAACAACAAAAACAA","GCTGGGCGCGGTGGCTCATGCCTGTAATCCCAGCACTTTGGGAGGCCAAGGCAGGTGGATCACCTGAGGTCAGGAGTTCGAGACCAGCCTAGTCCACATGGTGAAACCCCATCTCTACTAAAAACTAGCCAGGCGTGGTGGTGCGCACCTGTAATCCCAGCTACTCGAGAGGCTGAGGCAGGAGAATCACTTGAGCCTAGGAAGCAGAGGTTGTGGTGAGCTGAGATCACACCACTGCACTCCAGTCTGGGCGACACAGTGAGACTCTTGTCTCAAAAACAAAAAACAAACAAACAAACAAACAAA"
"GL873587","3208032","3208047","chr8","3626746","3626762","2","418714","AAACAACCACAAAAAA","ACAACAACAACAAAAAA"
"GL873587","3208141","3208321","chr19","2057131","2057316","59","1151010","TTTCTTTTAAAAATCACCCATGGGCTGGGTATAGTGGCTCACACCTATAATCCTCGGGAGGCCAAGGTTGGAGGATTGCTTGAATCCAGGAGTTGAAGGTTACAGTGAACTGGGATTTAGCCACTAGACTCTAGCATAGCTGACAAAGCAAGAACCTATTTGTTTAAAACACAAAAAAGAA","TACTAATAATACAAAAATGAGCCGGGTATGGTGGCGGGTGCCTGTAATCCCAGCTACTGAGGAGGCTGAGGCAGGAGACTTGCTTGAACCCAGGAGGTAAAGGTTGCAGTGAGCTGAGATTGCACCACTACACTCCAGCCTGGGCGACAAGAGCAAAACTTTTTCTCCAAAAAAAAAAAAAAAAAA"
"GL873587","3278260","3278367","chr19","19044200","19044312","39","15765940","CAGTCTGAGCAAGAGGGAGAGGCTATTTCTACTAAAAACAGAAAAACTAGCTGGGTGTTGGGGTGTGTTCCTAGTCTCAGTTACTTGGGAGGCTGAAGTAAGAGGATC","ACCAGCCTGGCCAACACGGTGAAATCCCGTCTCTACTAAAAATACAAAAATTACCTAGGCGTGATGGCACGTGCCTGTAGTCCCAGCTACTCATAAGGCAGAGGTGAGAGAAT"
"GL873587","3278673","3278754","chr7","49412503","49412597","28","46133830","GGCCACGAGAGCTAGCTCATGCCTATTCTAGGAGGCCAAAGCAGGCAGACTGCCTGAGCTCAGGAGTTCAAGAGCAGCCTGG","GGCCAGGTGCAGTGGCTCATGCCTGTAATCCGAGCACTTTGAGAGGCCGAGGCAGGCAGATCACCTGAGGTCAGGAGTTCAAGACCAGCCTAGTA"
"GL873587","3782076","3782188","chr9","112128434","112128552","34","108346358","ACTGGGGTGGCTGAGGCAGGAGCGTCACTTGAACTCAGGAGTTTGAGATTGCTGTGAGCTGAGCAGATGTCATGGCACGCTAGCCTAGGTAATAGAGTGAGACTTCGTCTAAA","CAGCTACTCGGGAGGCTGAGGCAGGAGAATCACTTGAACTCGGGAGGCGGAGGTTGCAGTGAGCCGAGATCACGCCATTGCACTCCAGCCTGGGCAACAAGAGCGAAATTCCATCTCAA"
"GL873587","4564996","4565084","chr20","27900350","27900437","14","23335354","GGCGGGGTGTAGTGGCTCATGCCTATTGTCCCAGCACTGTGGGAGGCCGAGGTGGGTGGATCACCTGTGCTCAGAAGTTTGAGACCAGC","GGCCGGGCGTGGTGGCTCATGTCTGTAATCCCAGCACTTTGGGAGGCCGAGGTGGGTGGATCACCTGAGGTCAGGAGTTCAAGACCAG"
"GL873587","6307870","6308175","chr12","112427710","112428020","54","106119840","GGCCAGATATGATGGCTCATGCTTGTAATCCTAGCACTCTGGGAGGCTGAAGTGGGAGGATCACCTGAGATCAGGAGTTCAAGATCACCCTGAGCAAAAGTGAGATCCCATCTCTATTAAAAATAAAAAAATTATCCAGGCATGGTGGTGCAGTCCTTTAGTCCCAGCTACTTGGGAGGCTGAGGCAGGAGAATCTCTTGAACCCAGGAATTAGAGGTTACAGTGAGCTGTGATGATGCTACTGCACTCTAGCAGGATGACAGAGTGAGATACTCCGTGTCAAAAAAAAAAAAAAAAAAAGCAAAA","GGCTGGACATGGTGGTTCATGCTTGTAATCCGAGCACTTTGGGAGGCCAAGGCGGGTGGATCACCTGAGGTTGGGAGTTCGAGACCAGCCTGACCAACATGATGAAACCCCATCTCTACTAAAAATACAAAAAAATTAGCCAGGCATGGTGATGCACGCCTGTAATCCCAGCTACTTGGGAGGCTGAGGCAGGAGAATCACTTGAACCCAGGAGGCAGAGGTTACAGTGAGCCGAGATCATGCCATTGCACTCCAGCCTGGATGACAGAGTGAGCCTCTGTCTCAAAAAAAAAAAAAAAAAAAAAAAAAAA"
"GL873587","6484004","6484128","chr10","67341428","67341546","29","60857424","GACCAGGTTCTGTGGCTCATGCTTGTAATCCTAGCACTCTAGGAGGCCGGAAGAGGGTGGATTGATTGCCTGAGGTCAGGAGTTAGAGACCAGCCTGAGCAAGAGCTAGACCCTGTTTCTTTCTT","GGCTGGGTGTAGTGGCTCATGCCTGTAATCCCAGCACTTTAGGAGGCCAAGGTGGATGGATTGCCTGAGCTCAGGAGTTCGAGACCACCCTGGGCAACAAGCCAAAACCCTGTCTCTAC"
"GL873587","6484407","6484586","chr3","167196537","167196723","48","160712130","TAGACCCTGTTTCTAAAAAAAAAATAGCCAGGTGTTGAGGCAGGTACCTGTAGTCCCAGCTACCTGGGAGGGCTGAGGCAAGAGAATCGCTTGAACCCAAGAGTTTGAGGTTGCTGTGAGCTGAGATGCTATGGCACTCAACCGTGAGCTACAAAGTGAGACTCTGTCTCAAAAAAAAAA","AAAACCTGTCTCTGCTAAAAATACAAAAATTAGCCGGGTGTGGTGATGTGCGCCTGTAGTCCTAGCTACTTGGGAGGCTGAGGCAGGAGAATCACTTGAATCCAGGAGGTGGAGGTTGTAGTGAGTCGAGATCGTGCGACTGCACTCCAGCCTGGGTGACAGCGAGACTCTGTCTCAAAAAAAAAAA"
"GL873587","7466229","7466364","chr1","29437872","29437991","35","21971643","GGCCAGGCGTGGTGGCTCATGCCTGTAGTCCCAGCGCTATGGGAGGCCGAGGTGGGTGGATCACCTGTGCTCAGAGGTTCGAGACCAGCCAAGACCCCCCTGAGCCAAATGAGCCAGAGTGAGATCCCATCTCTAC","GGCCGGGCGTGGTGGCTCACGCCTGTAATCCCAACATTTTGGGAGGCCAAGGCGGGTGGATCACCTGAGGTCAGAAGTTCGAGACCAACCTGGCCAACATGGTGAAACCCCTGTCTCTAC"
"GL873588","1502535","1502718","chr1","34852429","34852590","60","33349894","GGTGCAGTGGCTCACACCTGTTGTCCCAGCGCTGTGGGAGGCCGAGGTGGGTGGATCACCTGTGCTCAGAGGTCGAGACCAGCTGAAGACCTGCCTGAGGCAGAGTGAGCCAGAGTGAGACCCCGTCTCTACTAGAACAACAACAAGACAGCCAGACCTTGTGATCCCAGCTACATGGGGGGCT","GCCAGGTGCAGTGGCTCACACCTGTAATCCCAGCACTTTGGGAGGCCGAGGCGGGCGGATCACCTGAGGTCAGGAGTTTGAGACCAGCTTGACCAACATGGAGAAACCCCGTCTCTACTAAAAATACAAAATTAGCCTGGTGTGGTGTCGCATGCCTGTAAT"
"GL873588","10189037","10189246","chr3","45604681","45604903","65","35415644","GCTGAGATGAGGAGACTCTGTCTCTATTAAAAATAGAAAAATTGGGTGGATGTTGTGGGTACTGTAGTTGCAGCCTCTTGGGGGGCTAAGGCAGGAGGATCAGTTGAAGCCAGGAATTTGCTTTGAGCTAGGCTAAAGCCATGGCACTCTAGCCTGGGCAACAGAGTGAGGCTAGATCTCAAAAAAAGAAAGAAAAGAAAAAGAAAAAAA","CTGGCCAACATGGCAAAACCCCATCTCTACTAAATATACAAAAATTAGCTGGACGTGGTGGCACATACCTGTAATCCCAGCTACTTGGAAGGCTGAGGCAGGAGAATAGCTTGAACCTGGGAGGCAGAGGTTGCAATGAGCTGAGATCACGCCACTGCACTCTAGCCTGGGCAATAGAATGAGACTCTGTCTCAAAAAAAAAAAAAAAAAAAAAGACAAGAAA"
"GL873589","104719","104807","chr20","27900350","27900437","13","27795631","GGCTGGGCGTGGTGGCTCATGCCTGTTGTCCCAGCGCTGTGGGAGGCTGAGGTGGGTGGATCACCTGTGCTCAGAGGTTCGAGACCAGC","GGCCGGGCGTGGTGGCTCATGTCTGTAATCCCAGCACTTTGGGAGGCCGAGGTGGGTGGATCACCTGAGGTCAGGAGTTCAAGACCAG"
"GL873589","796766","796905","chr1","166346372","166346487","49","165549606","GGCTAAGTGTGGTGGCTCACACCTGTCATCTAGTACTTTGGGAGGGTGGGCCTGGGAGTTCAAAGACTGAACTCAGGAGTTCAAGGTGGCTCCGGGGAGGAATTCAAGACCAACCTGAGCCAGAGCGAGACCTCGACTCT","GGCCAGTGGGGTGGCTCACGCCTGTAATCCCAGCACTTTGGGAGGCTGAGGTGGTCAAATGACCTGAGGTCAGGAGTTTGAGACCAACCTGGCCAACATGGTGACACCTCGTCTCT"
"GL873589","1023679","1023690","chr1","205890061","205890072","1","204866382","AAAAAAAAAAAA","ACAAAAAAAAAA"
"GL873589","1023771","1024047","chr4","103012712","103012993","70","101988941","GGCTTGGTGGCTCACACCTGTAATCCTAGCACTCTGGGAGGCCGAAGTGGCTGGAATACTTGAGGTCAGGAGTTCAAGACCAGCCTAAGTGAGAGTGAGATCCCCATCTCTAATAAAAATAGAAAAATTAGCAGGGTGTTGTGGCTGGCACTTGTAGTCCCAGCTACCCAGGAGACCGAGGCAGAAGTTTGAGATTATTGTGAGCGAGGCTGATGCCACAGCATTCTAGTGGGACAACAGAGCAAAATTCTATCTCAAAAGAAAAAAAAAAAAAGGA","CGGGCGTGATGGCTCACGCCTGTAATCCCAACACTTTGGGAAGCCGAGGCGGACGTATCACCTGAGGTCAGGAGTTCAAGACCAGCCTGGCCAACATGGTGAAACCCCGTCTCTACTAAAAATACAAAAATTAGCTGGGTGTGGTGGCATGCGCCTGTAATCCCAGCTACCCAGGAGGCTGAGGCAGGAGAATCGCTGAGGCTGCAGTGAACTGAAATTGTGCCACTGCACTCCAGCCTGGGTGACAGAGCAAGACTCTGTCTCAAAAAAAAAAAAAAAAAA"
"GL873589","4820958","4821024","chr8","33633747","33633811","15","28812789","TTAGTCAAGTGCAGTGGCTCACACCTGTCATCCCAGCTACTTGGGAGGCTGAGGCAGGAGAGTTGCT","TTAGCCAGGTGTGGTGGTGCATGCCTCTAATCCCAGCTACTCAGGAGGCTGAGGCAGGAGAATTG"
"GL873589","6763768","6763857","chrX","25814002","25814092","29","19050234","GGTGTGGTGGCTCACACTTGTATCTTAGCATTTTAGGAGGCTGAATGGGGAGAATTGCTTTAAGTCAGGAGTCTGACTTCCACCTTGCCA","GGCTGGGAATGGTGGCTCACACCTGTAATCCCAGCACTTTGGGAGGCTGAGGTGGGCAGATCACCTGAGGTCAGGAGTTTGAGATCAGCCT"
"GL873589","8444551","8444632","chr9","93194085","93194171","17","84749534","CGGGCATGGTGGCTCACAACTATAATCTTAGCACTTTGGGAGGCTGAGACAGGTGGATGCCTGAACTCAAGAGTTTGAAACC","GGCCGAGCATGGTGGCTCACACCTGTAATCCCAGCACTTTGGGAGGCTGAGGCAGGTGGATTACCTGAGGTCAAGAGTTCAAGACCA"
"GL873589","9085365","9085494","chr2","194063347","194063481","42","184977982","GGCCAGGCACAGTGGCTCACACCTATAATCCCAGCACTCTGTGAGACTGAGGCAGGTGAACTGTTGCAAGAGTGAGACCCTGTGCTTGGTGCCTGTAGCTCAGTGGTTAATAATAAGAAAAAAGAAAAAA","GGCCAGGTGCAGTGGCTCACACCTGTAATCCCAGCACTTTGGGAGTCTGAACCAGGCAGATCACCTGAGGTCAGGAGTTCGAGGCCAGCTCGGCCACCATGGTGAAACCCTGTTTCTAATAAGAATACAAAAAAA"
"GL873589","9085767","9086002","chr7","84631446","84631650","75","75545679","GAGTGAAACCCTGTCTCTACTAAAAATAGAAAAACTAGCTGTGCATCAGGGCGCATAACTGTAGTCCCAGGTACTCAGGACACTGAGGCAAGAGAATTGCTCAAGCCCAAGAGTTTGCAAGAATTTGAGGTTGCTATGAGCTATGATGCCATGGCACTCTACCTAGGGTGACAGACAGAGACTCTGTCCCAAAAAAAAAAAAAGAAGAAGAAGAAAAAAAAAAAGAAAGAAAGAAA","ATAGTGAAACCTCGTCTCTACTAAAAATACAAAAATTAGCTGGGCATCATGGTGCACGCTTGTAATTCCAGCTACTTGGGAGGCTGAGGCAGGAGAATTGCTTGAACTCAGGAGGTGGAGGTTGCAATGAGCCAAGATCGCGCCACTGCACACCAGCCTGGGTGACAAAAGACTCTGTCTCAAAAAAAAAAAAAAAAAAAAAAAA"
"GL873589","9992904","9993045","chr16","56427538","56427666","46","46434634","AACCAGCCAGGCATGGTGATTCACACCTATAATCCCAGCTACTTAGGAGTATGGCTTGAGCACACAGGATACCATACCATTCTAGTCATCCCAGGCAACAGAGGGAAACTCTGTTGGTTAAAAAAAAAGAAAAACTTAAAAA","TTAGCCAGGAGTGGTGGTGCACGCCTATAATCCCAGCTACTTGGGAGGCTGAGGCACAAGAATCACTTGAACCATTGCACTCCAGCCAGGGTGATAGAGGGAGACTCTATCCAAAAAAAAAACAAAAAA"
"GL873589","9993319","9993452","chr3","2774534","2774668","28","7218785","GGCCTGAGCCCTGTGACTCATGCCTGTAATCCCAGCACTGGAAGTTCCAAGGCAGGTGGATCGCTTGAGCTCTGGAGTTCAAGACCAGCTCAACCAAGAGTAAGACCCCATCTCTACTAAAAATAGAAAAACCA","GGCTGGGCACGGTGGCTCATGCCTGTAATCCCAGCACTTTGAGAGGCCGAGGCAGGTGGATCTCCTGAGGTCAGGAGTTCAAGACCAGCCTGGGCAACATGGTGAAACCCCATCTCTACTAAAAATACAAAAAAT"
"GL873590","9044589","9044884","chr1","83754525","83754835","84","74709936","GGCCAGGTGCAATGGCTCATGCCTATAATCCTCACACTCTGGGAGGCTGAGGCAGGAGGATCACTTTTCTCAGGGTCAGGGCCAGCCTGACAAAAGTCAGACCCTGTTTCTACTAAAAATAGAAAAACTAGCTGGGTGTTGTGGCAGATGCCTATAGTCCCAGCTACTAAGAGACTGAGACAAGTGCCCAGAGTCTGAGGTTACTGTGAGCAAAGCTGATGCCATAGCATTCTAGCTATAGATCGAGAGTCTGTCTCAAAAACAAACAAACAAACAAACAAACAAACAAAAAAGAA","GGCTGGGTGTGGTGGCTCATGCCTGTAATCCCAGCACTTTGGGAGGCCGAGGCGGGTGGATCATCTGAGGTCAGGAGTTCAAGACCAGCCTGACCAACATGGTGTAACCCTGTCTCAACTAAAAATACAAAAATTAGCTGGGCGTGGTGGTGTGCACCTATAGTCACAGCTACTTGGGAGGCTGAGACAGGAGAATTGCTTCAACCCAGGAAGTGGAGGTTGCAGTGAGCCAAGATCATGTCACTGCACTGCAGCCTGACAGAGCGAGACTCCATCTAAAACAAACAAACAAAAACAAACAAACAAACAAA"
"GL873591","1831505","1831587","chr17","61702818","61702899","25","59871313","CCCAGCACTTTGGGAGGGCAAGATGGGAGAATCATATAAAGTCAGGAGTTTGAGACCAGTTTGGCAGACATGATGAACCCATC","AATCCCAGCACTTTGGGAGGCTGAGGCAGGCGGATCATCTGAGGTCAGGAGTTCAAGACCAGCCTGGCCAACATGGTGAAAC"
"GL873591","2719175","2719275","chr4","86137755","86137847","32","83418580","GTGGGGGCTTAGGCCTGTAATCCCAGCACTCTGAGAGGCCAAGGTGAGCTGGTCACCTGGGTTTAGGAGTTTGGAGACTTGCTCGAGCTAGACTGAGGCTC","GTGGTGGCTCACGCCTGTAACCCTAACAATTTGGGAGGCCAAGGCAGGTGGATCACTTGAGGTCAGAAGTTTGAGACCAGCCTGGACAATATG"
"GL873591","4732974","4733120","chr19","7991801","7991954","55","3258827","ATACGCAGACTGGCCGAGCGTGGTGTCACATGCCTATAATCCCAGTGGCTACTCTGGGGAGGAGAATCTCTTGAAACCAAGAGTTAGAGATTGCAGTGGGGTATGATACAGGGTAACAAAGAGAGACCTTGGATCTGAAAAGAAAAA","AAAATACAGAAACTAGCTGGGCATGGTGATGCACACCTGTAATCCTAGCTACTGGGGAGGCTGAGGCAGGAGAATTGCTTGAACCCAGGAGTCAGAGGTTGCAGTGAGCAACCAGCCTGGGTGATACAGTGAGTGAGACTCTGTCTCGAAAAAA"
"GL873591","6822728","6823009","chr1","20579766","20580052","72","13757038","GGCCAGGCGTGGTGGCTCATGCCTGTAAATCTCAGCACTCTGGGAAGCTGAGGCAGGTGGATTGCTTGAGGTCAGGAGTTTGAGACCAGCCTGTACCAGAGTAAGACCCTGTCTCTAATAAAAATAGAAAAAAAAAAAAAAACTAGTTGGGCATGGTGATGGGTGCCTGTAGTCCCACCTACTTGGGAGGCTGAGGCAATGGCATCTCTTGAGCCCAAGAGTTTGAGGTTGCTGTGCCATGGCACTCTCCCCAGGGTAACAGAGTGAAAATAAAAAAAAGAA","GGCCAGGCGTGGTGACTCATGCCTGTAATCTCAGCACTTTGGGAGGCCGAGGCAGGTGAATCACCTGAGGTCAGGAGTTTGAGACCAGCCTGACCAACATGGTGAAACCTCGTCTCTACTAAAAATACAAAAAGTAGCCAGGCATGGTGGCGCATGCCTGTAATCCCAGCTACTTGGGAGGCTGAGGCAGGAGAATCGCTTGAACCCGAGAGGCAGAGGTTGCATTGAGTCAAGATGGTACCACTGCACTCCAGCCTGGGTGACAGATTGAGACTCAAAAAAAAAAA"
"GL873591","7578706","7578813","chr16","45055441","45055543","42","37476735","AAATTTAGCTACACATAGTGGCATGAGTCTGTAATGCTAGCCACCCAAAAGGCTGTAGTAAGAGGATTGCTCTATCCCAGGAGTTAAAGACCAGCCCGGACATCAGAG","AATTAGCCGGGCGTGGTGACACACACTTGTAATCCTAGATACTCAGGAGGCGAAGGTAGGAGAATTGCTTGAACCCAGGCAGCAGAGGTTGCAACGAGCAGAG"
"GL873591","9282916","9283004","chr1","20744253","20744338","16","11461337","GGCCAGGCGCGGTGGCTCACCCCTGTTGTCCCAGTTCTGTGGGAGGCCGAGGTGGGTGGATCACCTGTGCTCAGAGGTTTGAGACCAGC","GGCCAGGCACGGTGGCCACGCCTGTAATCCCAGCACTTTGGGAGGCCGAAGTGGGTGGATTACCTGAGGTCAAGAGTTTGAGACCA"
"GL873592","835155","835315","chr16","75654291","75654451","43","74819136","CTGGGTGTGGTGGCTCTTGTCTGCAATCTCAGTACACTGGGAGGCTGAGGCAGAAGGATTGCTCCAGCTCAGGAGTTTGAGGCCAGGCTGAGCTAGTGCAAAACCCCATCTCTACTAAAAAAAGAAGGAAAAAAAAAAGAAAAAGAAAAAAAATACGAGCT","CCAGGTGTGGTGACTCACGCCTGCAATCCCAGCACTCTGGGAGGCTGAGGTGGGTAGATTACCGGAGGTTAGGCGTTTGAGACCAGCCTGGCCAACATGGTGAAACCCCATCGCTACTAAAAAAAAAAAAAAAAAAAAAAAAAAAAAAAAAAAAAAAATTA"
"GL873592","835589","835765","chr1","66836166","66836336","48","66000577","ACAAAAAACCTAGCTTAGGGTTGTTATAGCACCTGTAGTCCCAGCTACTCAGGCGCTAAGGCAGGAAAATCTGCCTGAGCTCAGGAGTTTGAGGTTGCAGTAAGTTATGATGATGCTACTGCACTCTAGCTGGGGCAACAGAGTGAGACTCTGTCTGAGGAAAAACCAAAACCAAAA","TAGCCCAGCACGGTGGCTCACACCTGTAGTCTCAGCTACTCAAGAGGCTGAGGCATGAGAATCGCTTGAACCCAGGAGGTAGAGGTTGCAGTGAGCTGAGATCATGCCACTGCGCTCCAGCCTGGGCAACAGAGTGAGACTCAGTCTCAAAAAACAAAACAAAACAAAAAA"
"GL873592","2520661","2520705","chr16","66853217","66853257","11","64332556","TCTGGGAGGCTGAGGCGGGTGGATCACCTGAGCAAGAGTGAGACC","TTTGGGAGGCTGAGGCAGGTGGATCACTTGAGGTCAGGAGT"
"GL873592","4535248","4535388","chr1","12240468","12240612","38","7705220","GGCGGGATGTGGTGGTTCATGGCTGTAATCCCAGCACTCAGGGAGGCTGAGTCGGGTGGATTGCTTGAGTTCAGGAGTTTGAGACCAACCTGAGCAAGAACTAAGCCTGTCTCTACTAAAGATATTATTTCTTATTTTTCT","GGCCGGGCGCGGTGGCTCATGCCTGTAATCCCAGCACTTTGGGAGGCTGAGGCGGGTGGATCACCTGCGGTCAGGAGTTCGAGACCAGCCTGGCCAACGTGGTGAAACCTCATCTCTACTAAAAATATAAAAATTAGCTGGTGTG"
"GL873592","4535654","4535831","chr8","126054004","126054184","54","121518350","TCTACTACAAATATTAACAGAAAAATTAGCTGGGCATTGTGACAGGTGCCTATAGTCCCAGATACTCAGAAGGCTGAAGTAAGAGGATCACTTGAACCCCAGGAGCTAAGGTGGCTGTGAGCTAGGCTGAGGCTCTAGCCTGGGTAACAGAGTGAGACTGTAAAAAAAGAAAGAGAGA","GTCTCTACTAAAAATACAAAAATTAGCTGGGTGTGGTGGTGCATGCCTGTAATCCCAGCTACTCAGGAGGCTGAGGCAGGAGAATCGCTTGAACCCAGGAGGTAGAGGTTGCAGTGAGCCAAGATCATGCCACTGCACTCCAGCCTGGGTGACAGAGGGAGACTCTGTCTCAATAAATAAA"
"GL873592","6794968","6795049","chr3","154764711","154764794","20","147969743","GAAGGTTTGATGAGCTCAGATGATGCCACTGCAGTCTACCCAGAGTGAAGGAGCGAGACTCTGTCTCAAAAACAAAAAAAGA","CAGAGGTTGGCAGTGAGCTGAGACTGTGCCACTGCACTCCAGCCGGGTGACAGAGTGAGACTCTGTCTCAAATTACAAACAAAA"
"GL873592","6881384","6881478","chr5","24882384","24882475","28","18001000","GGGCAGGCATAGTGACTGGTGTCTCTAATCCTAGCAGTCTGGGATGCTGAGGCAAGTGGAATGTCAGAGTTCAGGAGTTGAAGATCACCCTGACT","GGCCGGGCGCAGTGGCTCACATCTATAATCCTAGCATTTTGGGAGGCTGAGGCAGGCGGATCACCTGAAGTCAGGAGTTTAAGACCAGCCTG"
"GL873592","6881755","6881937","chr10","61601371","61601572","66","54719616","TCACCCTGACCAAGAGCAAGACCCTGTCTCTACTAAAAATAGAATAAACTAGCTGGGAATTGTGGTGGGTGCCAGTAGTCCCCGCTACTGAGGCAGGAGGATCATTGAGTCCAAGAGTTTGAGGTTGCTGTAAGTTAGGACACCACAGCACTCTACACAGAGTAAGACTGCCTCAAAAATAAA","AGTAAAGAAAAGAAACCCTGTCTCTACTAAAAATACAAAAATTAGCTGGGTGTGGTGGTGCGCACCTGTAGTCCCAGCTACTTGGGAGGGTGAGGTATGGGAATCACTTGAACCCGGGAGGTGGAGGTTGCAGTGAGCCAAGATCACACCACTGCACTCCAGCCTGGGTGAGAGAGTGAGACTCTGTCTCAAGAAAAAAGAA"
"GL873592","7006080","7006155","chr1","8947061","8947129","24","1940981","CACACTGAGAGGCAAAGGCTGGTGGATCACCTGAGCTCAAGAGTTTGAGACCAGCCAAGCCAGAGATCTTGTCTCT","CACTTTGGAGCCAGGTAGGTGATCACCTGAGTCAGGAGTTCGAGACAGCCTGGCCAACATGTGAAACCC"
"GL873592","8446508","8446655","chr11","122502739","122502874","48","114056231","TTAGCTGGGTGTTGTGGCAGGCACCTGTAGTCCCTCCCAGCTACTTGAAAGGCTGAGGCAAGATGACAGCTTAAACCCAAGAGTTTAAGGTTACTCTATTCAGGGCAACAGAGTGAGACTCCATCTACATAAATAAATAAATAAATAA","GGCTGGGCGTGGTGGTTCACACCTGTAATCCCAACACTTTGGGAGGCTGAGGCCAGCGGATTGCCTGAGCCCAGGAGTTTGAGACCAACCTGGGCAACATGGTGAAACTCCATCTCTACTAAAATACAAAAAGTTA"
"GL873592","8446953","8447008","chr16","44513352","44513404","15","36066399","GACCAGCCTAAGCAAAAAAGAGATCCTATCTCTACTACTAAAAATAGAAAAAATTA","ACCAGCCTCACCAATATGAAGAAACCCCATCTCTACTAAAAATACAAAATATT"
"GL873592","8447239","8447325","chr1","8062863","8062957","21","384376","GGCCAGGAGCAGTGACTCATGCCTAGCACTCTGGGAGGCCAAAGCAGGTGGATCAACTGAGCTCAGGAGTTCAAGACCAGCCTAAGC","GGCCGGGTGCAGTGGCTCATGCCTGTAGTCCCAGGACTTTGGCAGGCCAAGGCCGGTGGATTACCTGAGGTCAGGAGTTCAAAACCAGCCTAGCC"
"GL873592","8723925","8724000","chr3","42066983","42067054","20","33343058","AATTAGCCGGGCATGGTAGTGTGTGCCCATAATCTCAGCTACTCAGAAAGCTAAGATAGGAAAATTGCTTGAGCTC","TTAGCTGGGTGTGGTAGTGCATGCCTATAATCCCAGCTACTCGGGAGGCTGAGGTGGGAGAACTGCTTGAAC"
"GL873593","384022","384146","chr15","102382935","102383070","28","101998913","GGCCACGAGGGCCCATGCCTGTAATCCTAGCACTCTGGGAGGCTGAGGTGAGTAGATTGCTGAGCTCAGGAGTTCAAGACCAGCCTGTGCAAGAGACCCCATCTCTGCTAAAAATAGAAAAACCA","GGCCAGGTGTGGTGGCTCACGCCTGTAATCCTAGCACTTTGGGAGGCTGAGGCGGGTGGATTGCCTGAACTCAGGAGGTCAAGACCAGCCTGGGCAACACAGTAAAACCCCATCTCTACTAAAATACAAAAAATCA"
"GL873593","384425","384607","chr20","28286874","28287058","50","27902449","GAAAGAAAAGAAAAGAAAAACTAGCAAGATGTTGTAGCTGATGCCTATAATCCTAGCTATTGGAGAGGTGGAGGCAAGAGAATTGCGTGAGCCCAAGAGTTGAAGGTTGCTGTGAGCTGCGATGCCAGAGCACTCCAGGGTGACAGAGTAAGACTCTGTCTCAAAAAAAATTACAAAATAAAA","TAATAAAAATAAAAAAATTAGCCAGGAGTCAAAGCACACGCCTATAACCCCAGCTACTTGGGAGGCTGAGGGAGGAGAATTACTTGAACCCGGGAGGTGAAAGTTGCAATGAGCTGAGATCAAGCCACTGCACTCCAGACTGGATGACAGAGTGAGACTCTGTTTCAAAAAAAAAAAAAAGACAA"
"GL873593","1408445","1408467","chr10","88070368","88070389","9","86661923","AATCTAGAGATGGGGAGAGGTTG","AAAGAGATGGAAGAGAAGAAGA"
"GL873593","4856365","4856484","chr7","56497314","56497433","31","51640949","GCAATCCCAGCTGATCGGGAGGCTGACCCAGAAGAATCCCTTGAACCCAAGAGTCTGAGGTTGCTATGGGTGGATTCTACAGCACTCTAGCCTGGGAGACAGAGTGAGACTCTGTCCCAA","ATCCCAGCTACTTGGGAGGCTGAGACAGAAGAATTGCTTGAACCCGGGAGGTGGAGGTTGCAGTGAGCCAAGATTGTACCACTGCACTCCAGCCTGGCAACAGAGTGAGACTCTGTCTCA"
"GL873593","6661298","6661485","chr10","86749316","86749514","55","80088018","GCAGAGGCTCACATATGTAATCCTAGCACTCTGGGAGGATAAGGCAGGTGGACAGCTTGAGCTCAGGGGTTTGACCAGTCTGATCAAGAGCAAGACCTGTGTCTACTAAAAATAGAAAACCTAGCCAGGTATGATGGTAGATGCCTGTATTCCTAGCTACTCTGGAAGCTAAAGCTAAAGAGTTTGAA","GGTGGCTCACACCTGTAATCTTAGCAATTTGGGAGGCCGAGGTGGGTGGATCACTTGAGGTCAGGAGTTTGAGACCAGACTGGCCAACATGGTGAAACTCTGTCTCTACTAAAAATACAAAAATTAGCCAGTCATGGTGGTGCATGCCTGTAATCCCAGCTACTCAGGAAGCTTAGGCAGGAGAATCACTTGAACCCAG"
"GL873593","6710263","6710446","chr14","4390080","4390244","66","2320183","TTGAAGTCAGGAGTTTAAGGCCAGTCTGGGCAACATAGTGAGACCCCCATCTCTACGAAAATATTTTTTAAAAATTAAAAATAGCTGGGCATAGTGAGGCTGTTGTGAGCTATAACTGCACCACTGCACTCAGCCAAGGACAGAGACCCTGTTCCCTGCCTCAAACAAACCAAAACAAAACAAA","AAGTCTAGAGTTTACAGCCTGGACAACGCAGTGAAACCCTGTCTCTACCAAAAATACAAAAATTAGACAGGTGTGAGAGGCGGAGGTTGCAATGAGCTGAGATCGCAGCACTGCAGTCCAGCCTGGATGACAGAGCGAGACCCCATCTCAAAAACAAAAACAAAA"
"GL873593","7159645","7159716","chr6","178318394","178318465","21","171158749","GATCATGTCACTGCTCTCCAACCTGGGCAATTGAGCAGGAATCTGTCTCAAAAAGAAAAAAAAAAAAGAAAA","CGAGTTCACACCACTGCACCCCAGCCTGGGCAACAGAATGAGACTCGGTTTCAAAAAAAAAAAAAAAAAAAA"
"GL873593","7159841","7160050","chr13","33368171","33368368","69","26208330","GGCCAGGCGTGGTGGCTCACACCTGTTGTCCCAGTGCTGTGGGAAGCCGAGGCAGGTGGATCACCTGAGCTCAGCCGAGTTCGAGACCAGTGGAAGACCAGCATGAGGCAGAGTGAGCCAGAGTGAGACCCCATCTCTACAACAACAACAAGAAGAAAAAAAACAGCCGGACCTTGTGATCCCAGCTACGTGGGGAGCTAGAGAATCACT","GGCTAGGCATGGTGGCTCATGCCAGTAATCCCACCACTTTGGGAGGCCGAGGCAGGTGGATCACCTGAGGTCAGGAGTTCAAGACCAGGCTGGCCAACATGTTATGATGAGACCCTCATCTCTACTACAAATACAAAAATCAGCTGGGCATGGTGGCAAGTGCCTGTAATCCCAGCTACTTGGGAGGCTGAGGCAGAA"
"GL873593","8598292","8598391","chr11","118461023","118461129","33","109862731","AGCCAGGTGAGGTGGTTCACACCTGTAACCCTAGCTGCTTGGGAGGCTGAGGCCTCTCTATCCTGGGCAGTGTGGAGAAACTTTGTTTCAAAAAAAAGAA","GCCGGGCGCGGTGGCTCACGTCTGTAATCCCAGCGCTTTGGGAAGCCGAGGCGGGACTATCCTGGCCAACATGGTGAAACCCCGTCTCTACTAAAAATACAAGAATC"
"GL873594","357249","357377","chr2","75702890","75703011","36","75345641","CCTGGTACCGTAGGTCATGCCTGTAATCCTAGCACTTTGGGATGCTGAGGTGGGCAGATTGCCTGAGCTCACGAGTTCAAGCCATTAGAACTGAGCCTGACCTAGAGTGGGACCTCCAACTCTTTTTTT","GCCAGGCACAGTGGCTCATGCCTGTAATCCCAGCAGTTTGGGAGGCTGAGGTGGGCAGATCACTTGAGGTCAGGAGTTCAAGACCAGCCTGGCTGACATGGTGAAACCCCATCTATACCAAA"
"GL873594","357656","357834","chr7","17608776","17608965","55","17251120","GGGACCTCCAACTCTTAAAATAGCTGGGCATTGTGGTGGGCACCTACAGTCACAGCTACTTGGGAGGCTAAGGCAAGAGACTTGTTTGCAGCCAAGAGTTAGAGGTTGCTGTGAGCTATGAGGCTAGGGCACTCTACAGGGGGCGACAAGTGAGACTGTAAAAAAAAAAAAAGAAAAAA","GTCCCTACTAAAAATACAAAAAATTAGCTGGGCCTGGTGGCAGGCACCTGTAATCCCAGCTACTTGGGAAGCTGAGGCAAGAGAATTGCTTGAACCCAGGAGGCAGAGGTTGCAGTGAGCTGACATCAAGCCACTGTACTCCAGCCTAGGCAACAAGAGCAAGACTCTGTCTCAAAAAAAAAAAAAAAAA"
"GL873594","1410711","1410996","chr5","151340503","151340797","76","149929792","CACAGTGGCTCATACCTATAATCCTAACACTCTGGGAGGCCAAGGTGGGTGGACTGTCTGAGTTTGGGACCAGCCTGAGCAAAAGCAAGACTCCCATCTCTACTAAAAACAAAGACAGCCAGGTATGAGGGCAGGTGCCTATCATCCCAGCTACTTGGGAGGCTGAGGAAGGAGGATCACCTAAGCCCAGGACTTTAAGGTTTCTGTGAACTAAGATGATGTTACAACACTCTAGCCAGGGTAACAAGGCAAGATTCTGTTTCAAAAGACAAAAAAAAAAAAAAAA","GGTGGTTCATGCCTGTAATCCCAGCACTTTGGGAGGCTGAGGCAGGTGGATCACCTGAGGTCAGGAGTTCGGGACCAGCCTGGCCAACATGGGGAAACCCCATCTCTACTAAAATACAAAAATTAGCCAGGTATGGTGGCACATGCCTATAATCCCAGCTACTTGGGAGGCTGAGGCAGGAGAATCACTTGAACCCAGGAGGCTAAGGTTGCAGTGAGCCGAGATTGTGCCACTGTACTCCAGCCTGGGTGACAGACTGAAACTCTGTGTCCAAAAAACAAAACAAAACAAAAAA"
"GL873594","5528090","5528162","chr2","69013639","69013718","24","63485549","GGTACAGTGGCTCACGCTTGTGATCCCAGGTTGAGGTGGGTGGATCGCCTGAGCTCAGGAGTTGGATGCCAGC","GGTGTGGTGCCTCACGCCTATAATCCCAGCACTTTGGGAGGCAGGTGGATCACTTGAGGTCAGGAGTTTGAGAACAGCCT"
"GL873594","5834047","5834168","chr2","82491537","82491662","28","76657490","GGCTGGGCCCAGTAGCTCACGACTGTAATCCCAGCACTCTGGGAAGCTGAGGTGGGCGGATCACCTGAGCTCATAGGTTCGAGACCAGCTCCAGTTAGAGTGAGAGCCTGTCTCTAAAAATA","GGCTGGGCACAGTGGCTCATGCCTGCAATCCCAGCACTTTGGGAGGCTGAGGTGGGCAGATCACCTGAAGTCAGGAGTTCAAGACCAGCCTGGCCAACACAGTGAAACCCCATCTCTACTAAAAAT"
"GL873594","5834396","5834461","chr13","14688151","14688212","20","8853755","TATATAATAATAATAACCAGGTATTGTGGCAGGTGCCTCTAGTCCCAGCTACTCGGGAGGCAAAGG","ATAAAAAAATTAGCTGGCCATGGTGGCACATACCAATAATCCCAGCTACTCAGGAGGCTGAG"
"GL873594","7786130","7786294","chr14","12217087","12217250","37","4430957","GGGTGTGCTGGCTCATACCTATAATCCTAGCACTCTGGGAGGCTGAGGTAGGTGTATTGCTTGAACCCAGGAGTCTGAGGTTGCTGTGCGCTAAGCTGATACCATAGCACTCTAGCCTGGGCAACAGAGTGAGACTCTGTCTCAAAACAAATAAATAGTAAAAAA","GCTGGGCGTGGTGGCTCACACCTGTAATCCCAGCACTTTGGGAGGCCAAGGCATGAGAATTGCTTGAAAACAGGAGGCGGAGGTTGCAGTAAGCTGAGACTGTGCCATTGCACTCCAGCCTGGGCAACAAGAGTGAAACTCTGTCTCAGAAAAAAAGAAAAAAA"
"GL873595","723579","723774","chr19","6045933","6046125","65","5322354","GCCTGAGCAGGAGAGAGACCCCATCTCTGCTGAAAGTGGAAAAGTTGGCTGAGTGTAGTGGCGGGCTGCTGCCCCAGTCACTCAGGAGGCTTAGGAAGGAGTATCGCTTGGGCCCAAGATTTGAGGTTGCTGTGAGCGCTACAAAGACATTAGGGTACTCTACACAGGGGAATAGAGTGAGACTGTCTCAAAAAAA","CAACATGGAGAAACCCCGTCTCTACTAAAAATACAAAATTAGGCAGCGTGGTGGTGGGTGCCTATAATCCCAGCTACTCAGGAGGCTGAGGCAGGAGAATCGCTTGACCGGGAGTGGAGGTTGCGGTGAGCTGAGATTGCACCATTGCACTCCAGCCTGGGCAACAAGAGTGAAACTCCGTCTCAAAAAGAAA"
"GL873595","724114","724204","chr20","18199749","18199840","22","17475635","GGCCATGCTTGGTGGTTCTCATCTGTAATCCTAGCACTCTGGAAGGTCTACAGGGGTGGATGGCTGGAGGTCAGGAGTTCAAGACTGGCCT","GGCCGGGCATGGTGGCTCACACCTGTAATCCCAGCACTTTGGGAGGCTGAGGCAGGCGGATCACCTGAGGTCAGGAGTTCGAGACCGGCCTG"
"GL873595","1065346","1065667","chr18","10529729","10530057","74","9464383","GGCCAGGTGCAGCAGCTCATGCCTGGAATCTTCCTGCTCTGTATGGCCAAGGCAGGTGGATCGCCTGACCTCAGGAGTTCCAGACCAGCCTGAACAAGAGCAAGACTCTGTCTCTACTAAAAGTAGAAAAAAAACTAGCCAGTCATAGTGGCAGGTGCCTGTAGTCCCAGCTGCTTGGGAGGCTGAGGCAAGAGGATCACTTGAACCTAAGAGTTTGAGGTTGCTGTGAGCTAAGATGCCACATCACTCTATCAAGGGTGACCAAGTGAGACTCTGTCTCAAAAATAAATAAATAAATAAATAAAAAGAAAGGCAAAAAGAA","GGCCCGGCGTGGTGGCTCATGCCTATAATCCCAGCCCTTTGGGAGGCCAAGGCAGGTGGATCACCTGAGGTCAGGCGTTCGAGACCAGCCTGACCAACGTGGTGAAACCTCATCTCTACTAAATACAAAAAAAATTTAGCCAGGCATGGAGGCACATGCCTGTAATCCCAGCTACTTGGGAGGCTGTGGCAGGAGAATCACTTGAACCTGGGAGGTGGAAGTTGCAGTGAGCTGAGATTGTACCACTGCACTCCAACCTGGGTGACAAAGCAAGACTCGGTCTCAATAAATAAATAAATAAATAAATAAATAAATAAAGTGAAAAAAAA"
"GL873595","1254878","1255146","chr4","42822326","42822607","67","41567448","GGCTGGGCATGGTGGCTCATGCCTGTAATCCTACCGCTCTGGGAGGCTGAGGCAGAGGATCACTTGAGCTCAGGAGTTTCAGACCAGCCTGCAAGAAGGACCCAGTCTCTGCCGAAAATAGAAAAGTTAGCAAGGCGTTGTCGTGAGCACATGTATCCCAGCTACCTAGAACTCTGAGGCAGGAGGATCCCTTGAACCCACAGAAGTTGCTGTTATCTAAACTGATGCCACTGGACTCTAGCCTGGGCAACAGAGTGAGACTGGTCTCA","GGCCGGGCACGGTGGCTCATGCCTGTAATCCTAGCATTTTGGGAGGCTGAGACAGGCAGATTGCCTGAGCTCAGGAGTTCAAGACCAGCCTGGGCTAGATTGTGAAACCCCATCTCTACTAAAATATAAAAATTAGCTGGGTGTGGTGGCACACGCCTGTAATCCCAGCTACCTGGGAGGCTGAGGCAGGAGAATCGCTTGAACCAGGAGACAGAGGTTGCAGTGAGCTGAGATCACGCCACTGCACTTTAGCCTGGGCAACAGAGTGATACTCTGTCTCAA"
"GL873595","3417105","3417297","chr12","115674238","115674427","44","112257133","GGCCGGGCGCTGTGCCTCACGCCTGTAATCCTAATACTCTGAGAGGCCGAGGCAGGTGGATTGCCTGAGCTCAGGTGCTCAAGACAGCCTGACTGAGCAAGCCCTGAGATCCCATCTCCACTAACAATAGTAAAACTAGCCGGGCATTGTGGTGGTGCTTGTAATCCCAGCTACTGGGAGGCTAAGACAGGAG","CCAGGCCTGGTGGCTCACGCCTGTAATCCCAGCACTTTGGGAGGCCGAGGTGGGTAGATCACCTGAGGTCAGGAGTTCAAGACCAGCCTGGCCAACATGGCGAAACCCCATCTCTACTAAAAATACAAAAATTAGCTGGGCATGGTGGTGTATGCCTGTAATCCCAGCTACTCGGGAGGCTGAGGCAGGA"
"GL873595","6098380","6098457","chr3","87492619","87492702","21","81394239","GCTGTGGCTCATGCTGATAATACCAGCACTCTGGGAGAACAAGGTAGGCAGATCACAAGAGGTCACCTGTGCAAGACC","GGGCTGGTGGTGGCTCATGCCTGTAATACCAGCACTTTGGGAGGCCAAGACAGGTGGATCACCAAAGGTCAAGAGTTCAAGACC"
"GL873596","134190","134307","chr1","203207333","203207443","31","203073143","GGCTGGGCGAGGTGGCTCACACCTGTAATCCTAGCACTCTGGAAGGCCCTAGCACTCAGGCAGTTGGATTGCCTGAGCTCACAAGTTCAAGACCAGCCTGAAAAAGAGCAAGACCTCA","GGCTGGGTGCAGTGGCTCACACCTGTAATCCCAGCACTTTGGGAGGCCGAGATGGGTGGATCACTTGAGGTCAAGAGTTGAAGACCAGCCTGGACAACATGATGAGACCCC"
"GL873596","134578","134681","chr11","50235285","50235387","37","50100707","CAAACAAAAGAGGAAGACCTCGTCTCTAAAAAAATAGCTGGGCATTGTGAGGAGTACCTGTAGTCCTAGCTACTCAGAAGGCTGAGACAAGAGAATCACTTAAA","CAACATTGTGAAACCCTGTCTCTACTAAAATAGAAAATTAGCCAGGTGTGTGGGCGTGCCTATAATCCTAGCTACTGGGGAGGGTGAGGCATGAGAATCGCCT"
"GL873596","8160215","8160350","chr1","29437872","29437991","30","21277657","GGCCGGGCGTGGTGGCGCACACCTGTAGTCCCAGCGCTATGGGAGGCCGAGGCGGGTGGATCACCTGAGCTCAGAGGTTCGAGACCAGCCAAGACCCCCCTGAGCCAAACGAGCCAGAGTGAGACCCCGTCTCTAC","GGCCGGGCGTGGTGGCTCACGCCTGTAATCCCAACATTTTGGGAGGCCAAGGCGGGTGGATCACCTGAGGTCAGAAGTTCGAGACCAACCTGGCCAACATGGTGAAACCCCTGTCTCTAC"
"GL873596","8421071","8421132","chr20","1874027","1874093","12","6547044","GTCAGGCGCAGTGGCTCACGCCTGTAATCTCAGCACTCTGAGAAGCCAAGGCAGGATCATCT","GGCCAGGCGCAGTGGCTCAGGCCTGTAATCCCAGCACTTTGGGAAGCCAAGGTGAGCAGATCACCTG"
"GL873598","4416400","4416489","chr5","39418145","39418231","15","35001745","GGCCAAGTGTGGTGGCTCATGCCTGTTGTCCCAGCACCGTGGGAGGCCGAGGCTGGTGGAACACCTGAGCTCAGCTGAGTTTGAGACCAG","GGCCAGTTGCGGTGGCTCATGCCTGTAATCCCAGCACTTTGGCAGGCTGAGGCAGGTGGATCACCTGAGGTCAGGAGTTTGAGACCA"
"GL873598","4416855","4416947","chr3","94091253","94091337","31","89674398","GTGAGACCCTGTCTCTACAAAAAAAAAAGCTGGGCACTGTGGCATGTGCCTGTAATCCCAGCTACTTGGGAGGCAAAGGGAAAGAGAATCACT","AAACCTTGCCTTTACTAGAAATACAAAAATTAGCTGGGCATGGTGGCAGGTACCTGTAATCCCAGCTACTTGGGAGGCTGAGGCA"
"GL873598","5126074","5126161","chr1","12339306","12339394","19","7213232","GCCTGGTGCACTGGTTCACACCTGGAATCCTTGCATTCTGAGAGGCCCAGGTAGGCAGATCACCTCAGCTCAGAAGTTCGAGACCAGC","GCTGGGTGCGGTGGTTCACGTCTGTAATCCCAGCACTTTGGGAGGCCGAGGCGGGCAGATCACCTGAGGTCAGGAGTTCGAGACCAGCC"
"GL873598","5467584","5467662","chr1","9313328","9313403","17","3845744","GCGAGGTGGCTCACGCCTGTAATCCCAGCACATTTGGAAGGCCAAGGAGGGTGGATCACCCGAGCTCACCAGTTGGAGA","CGCAGTGGCTCACGCCTGTAATCCCAGCACTTTGGGAGGCCGAGGCAGGCAGATCACCTGAAGTCAGGAGTTTGAG"
"GL873598","6917752","6917856","chr14","9558287","9558382","22","2640535","GGCCAGGCATGGTGGCTTGTGCCTGTTGTCCCAGCACTGTGGAAGGCCGAGGCGGGTGGATCGCCTGAGCTCAGCTGAATTCGAGACCAGCATAAGACCAGTATG","GGCCAGGCATGGTGGCTTATGCCTGTAATCCCAGCACCTTGGAAGGCCGAAGCGGGCAGATCACCTGAGCTCAGGAGTTTGAGACCAGCCTGTCCA"
"GL873598","8078910","8079062","chr7","164825511","164825660","43","156746601","AACAGCCAGGCATTGTGGTGGGCACCTGTAATCCCAGCTACTTGGGAGGCTGAGGCAAGAGAATTGCTTGAGCCCAACAGTCTCAGGTTACTGTGAGTTATGACACCATGGCACTCTATTGAGGGCAAGAAAGTGAGACTGTCTTGGAAAAAA","CTAGCCAGGCATGGTGGTGCGCACCTGTAGTCCCAGTTACTTGGGAGGTTGAGGCAAGAGAATTGCTTGAGCCTGGAAGGCAGAAGTTGCAGTGAGCTGAGATCACACCACTGCATTCCAGCCTGGGCGAAAGAGCAAGACTCTGTTGAA"
"GL873598","8079328","8079454","chr6","10381248","10381379","32","2301920","GCCCGGCGTGGTGGCTCACGCCTGTAATTCCAGCACTCTGGGGAGGCCGAGGAGGGCAGATTGCCTGAGCTCACAGGTTTGAGCTAGAGCGAGACCCTGTCTCTTAAAAAGAAAAAAAAGGAAAGAA","GCTGGGCGCGGTGGCTCACGCCTGTAATCCCAACACTTTGGGAGGCCGAGGCGGGCAGATCACCAGAGGTGATCTCCAGCCTGGGCAGGAGAGCAAGACCCTGTCTCAAAAAATTTAGAAAAAGGAAAGAAA"
"GL873599","3943256","3943456","chr9","35892110","35892312","79","31948854","GGCAGGCTGCTTTGACCCATATCTACAACTCCAGAACTTTAGAGGCTGAGCTGGGTGGGTCCCTTGAGATTAGAAACTGCTTAGTAGCCTGGCAAAAACCAGACCCCACCTCCACCATGTAGAAAAATTAGCAGTATGCCATAGTGGGAACCTACCAATACAGTCTTTCCAAAGGCCAAAGCTAGAAGGACCGTGAGCTTG","GGCTGGGTGTGGTGGCTCATGCCTATAATTCCAGCACTTTGGGAGGCCGAGGCAGGTGGATCACCTGAGGCCAGGAGTTTGAGACCAGCCTGGCCAATATGGTGAAACCCCATCTCTACTAAAAGTACAGAAAATTAGTCAGTCATGATGGCGCATGCCTATAATCCCAGTTACTCGGGAGGCTAAGGTAGGAGAATTGCTTG"
"GL873599","6693284","6693349","chr1","100916857","100916922","15","94223573","TCACGTCTATAATCCTAGCACTCTGGGAGTCCTTGGCAGGTGGATCACCTGAGCTCAGGAGTTTGA","CATGCCTGTAATCCCAGCACCTTGGGAGGCCAAGGTGGGTGGATCACCTGAGGTCAGTAGTTTGAG"
"GL873600","991618","991705","chr15","13850109","13850195","15","12858491","GGCTGGGCGTGGTGGCTCACACCTGTTGTCCCAGCGCTGTGGGAGGCTGAGGCAGGTGGATCACCTGTGCTCAGAGGTTGAGACCAGC","GCCGGGCGCTGTGGCTCACACTTGTAATCCCAGCACTTTGGGAGGCTGAGGCAGGTGGATCACCTGAGGTCAGGAGTTAGAGACCAG"
"GL873600","8825981","8826014","chr16","43605817","43605844","11","34779836","AGTCTGGGGCAACAGAGCAAGACTCTGTCTCAAA","CAGTCTGGGTGACAGAGCAAGATTCCAT"
"GL873600","8826039","8826157","chr13","87428402","87428520","35","78602363","ATTAGCCTGGTGTGGTGGTATATGCCTTCCTGCCTGCTTGGGAGGCTGAGGCAGGAAGTATGCTTTAACTGTGGAGTCTGAGGTTGCTATGAGCTAGGTTGAGGCCATGGCACTCTAAA","TTAGCCGGGTGTGGTGGTGCACGCCTGTAATCCCAGCTACTCAGGAGGCTGAAGCAGGAGAGTTGCTTGAACCCAGGAGTTGGAGGTTGCAGTGAGCTGAGATCACGCCATTGCACTCC"
"GL873601","269289","269338","chr14","49279240","49279285","14","49009951","GACTGGGTGTGGTGGCTCACACCTTTAATCCTAACACCCTGGGAGGCTTA","GGCTGAGATGGTGGCACACACCTGTAATCCCAGCTACTTGGGAGGC"
"GL873601","269431","269678","chr1","184453273","184453521","76","184183842","AGAAGATCACTCAAGATCAGGAGTTTGAGAACAGCCTGAGCAAGACCCCCATCTTTACTAAAAATGGAAAAGTTTTTACCCAGGCATGGTAGTGCGTGCCTGTATCCCATCTACTCCGGAGGCTGATAGGAGGATTGCTTCAACCAAGGAGTTTGAGGTTCCAGAGACTTAAGATGACACAACTGCATTTTACCCAGTGTGACACAGCGAGACTCTTTCAGAAGAATTTTTAAAAGGAAAAAAAAGAA","GGTCAGATCACCTGAGGTCAGGAGTTTGAGACCAGCCTGACCAACATGGTAAAACCCCATCTCTGCTAAAAATACAAAAAATTAGCCAGGCATGGTGGTGAACGCCTGTAATCCTAGCTACTCAGGAGGCAAAGACAGGAGAATCGCTTGAATCTGGAAGGTGGAGGTTGCAATGAGCCAAGATGACGCCACTGCACTCCAACCTGGGTGACAGAGGAAGACTCCATCAAAAAAAAAAAAAAAAAAAAA"
"GL873601","1397978","1398117","chr16","24839455","24839591","34","23441477","GCCTATAATCCTAGCACTCTGGAAGGCTGAGGCAGGAAGATCACTAGAGCTTGGGAGTTTGAGATTGCTGTGAGGGAGACTGACTCCATGGCACTCTAGCCTGAGGCAACAGAGTAAGACTCCATCTCAAAAAAAAAAAA","CTCTAACTCCAGCTACTCAGGAGGCTGAAGCAGGAAAATCACTTGAACCTGGGAGGTGGAGGTTACAGTGAGCCAAGATCACACCATTGCACTCCAGCCTGAGCGACAGAGCGAGACTCTGTCTCAAAATAAATAAA"
"GL873601","4065502","4065590","chr11","108711352","108711444","19","104645850","GCTGGATGTGGTGGCTCTCACCTATAATCCTAGCACTCTGGGAGGTCAAAACAGGTGGATCACCTGAGCTCAGGAGCAAGAACACCAGC","GTCAGGGGTGGTGGCTCACGCCTGTAATCCCAGCACTTTGGGAGGCCAAGGCAGGTGGATCGCCTGAGCTCAGGAGTTCAAGACCAGCCTTGC"
"GL873601","8241370","8241465","chrY","9469734","9469829","34","1228364","AAAAAAGGTGGAGATGAGCCATGCGCAGTGGTGTAGGCCTGTAATCCCAGCCCTTGGGAGGCCAAAATGGTGGATTGCCTGAAGCAGAGCAAGACC","AAAGTACAAAGAGTCTGGGTACAGTGGCCCAAGCCTGTAATCCCAGCAGTTTGGGAGGACAAGATGGGTAGATCACCTGACATCATGAATTAGAGA"
"GL873569","7519122","7519191","chrX","79016364","79016431","16","71497242","TTGGCCAGGCATGGTCGCTCAGGCTGTAATACCAGCTACTTGGGAAGCTGAAGCAGGAGGATCACTTGAA","TTGGCCAGGCACGGTGGCTCATGCTTATAATCCCAGCTACTCGTGAGGCTGAGGCAGGGGAATCGCTT"
"GL873569","7989158","7989286","chr8","41505677","41505810","35","33516519","AGTCCCACCTATTTGGAAGGCTGAGGCAAGAGGATCACTTGAACTCAGCAGTTTGACATTGCTATGAGTTAGATTGACTCCATGGCACTCTAGCCCAGGCAACAGAGCAAGACTCCGTCTCAAAACAAA","TAATACCAGCTACGTGGGAGGCTGAGGCAGGAGAATCACTTGAACCCGGGAGGTGGAGGTTGCAGTGAGCTGAGATTGCACCGTTGCACTCTAACCTGGGCAACAAAAGCAAAACTCTGTCTCAAAAAAAAAAA"
"GL873569","7989575","7989702","chr1","62231025","62231129","47","54241450","GGCTGGGTAATGCAGTGGCTCACGCCTATAATCCTAGTGCTTTGAGAGGCCAAGAGTGAGACTCTGTGTACTAAAAATAGAAAAATTACCTAGGCATTCTGGTGGGCACCAGTAGTCCCACCTATTTG","GGCTGGGCATGGTGGCTCACGCCTATAATCCCAGCACTTTGGGAGGCCGAGGCAGGTGGATCACCTGAGATCAGGAGTTTGAGACCAGACTGGCCAACATGGTGA"
"GL873569","10034363","10034556","chr10","61268396","61268605","62","51234033","CAGCTTGAGCAAAAGTGAGCCCCTGTCTCTACTGAAAATAGAAAAAATTAGCCAGGCGTGGTGGCACACACTTATAGTCCCAGCCACTTAGGAGGCTGAGGCAGGAGTTTGAGGTTGACATAATCTAAGCTGATACCATAGCACTCTAGCCTGGGCAATAGAGTGAGACTCTGTCTCAAAGAAGAAATTTATCT","CCTGACCAATGGTGAAACCCTGTCTCTACCAAAAATACAAAATTTAGCTGGGCATGGGGGCACGCACCTGTAGTCCTAGCTACTCGGGAGGCTGAGACAGGAGAACTGCTTGAACTCGGGAGGCAGAGGTTGCAGTGAGCTGAGATCATGCCACTGCACTCTAGCCTGGGCAATAGAGTGAGACTCCGTCTCAAAAAAAAAAAAAAAAAA"
"GL873569","10034830","10034845","chr1","217667782","217667796","2","207632952","AAAAAAGAAGAAAAAA","AAGAAAAAGAAAAAA"
"GL873569","10203815","10203922","chr8","96374555","96374671","35","86170740","GCCAGGTGTAGTGGTTCACACCTATAATCCTAGCACTCTGGGAGCCTGAAGCAGGTAAATGGACTGAGCAAGAGTGAGACTTCCACCTCTATTGAAAATAGAAAAATT","GGCTAGGTATGGTGGCTGATGCCTATAATCCCAGAATTTTGGGAGGCCGAGGCAGGCAGATCATCTGAGGTCAGGAGTTTGAGACCAGTCCCGTCTCTACTAAAAATACAAAAATTA"
"GL873569","10204196","10204373","chr20","1304385","1304559","47","8899811","GAAAATAGAAAAATTAGCCAGGCATTATAGCAGGCACCAGTAATCCCAGTTACTTGGGAGGCTAAGGCAAAAGAATCTCTTGAGCCCAAGTTTGGGGTTGCTAGGAAGTAAAACACCACAGCACTATACCCAGAACAAGAGAGTGAAGACTCAGTCTCAAAAAGATAAATAAATAAAA","AAAAATACAAAAATTAGCCAGGCATGGTGGCGGGCGTCTGTAACTCCAGCTACTTGGGAGACTGAGGCAGGAGAATCGCTTGAACCCAGGAGGCAGAGGTTACAGGTGAAATCACACCACTGCACTCCAGCCTGGGCAACAGGGCAAGACTCTGTCTCAAAAAAAAAAAAAAAAA"
"GL873569","10473375","10473444","chr8","20660648","20660717","21","10187273","TGTAGTCCCAGCACTTTGGGAGGTTAAGGCAAGAGTAGCACCCAACATGAGGAGATCAAGACCAATCTGG","CTGTAGTCCCAGCACTTTGGGAGGCTGAGGCAGGTGGATCCTTTGAGGGCAGAACTTTAAGACCAGCCTG"
"GL873570","9287350","9287485","chr1","29437872","29437991","30","20150522","GGCCGGGCGTGGTGGCGCACGCCTGTAGTCCCAGCGCTATGGGAGGCCGAGGCGGGTGGATCACCTGTGCTCAGAGGTTCGAGACCAGCCAAGACCCCCCTGAGCCAAACGAGCCAGAGTGAGACCCCGTCTCTAC","GGCCGGGCGTGGTGGCTCACGCCTGTAATCCCAACATTTTGGGAGGCCAAGGCGGGTGGATCACCTGAGGTCAGAAGTTCGAGACCAACCTGGCCAACATGGTGAAACCCCTGTCTCTAC"
"GL873571","3669989","3670207","chr4","116777080","116777297","60","113107091","AGACCAGCCTGAGGAAGAGCAAGATCCCATCTCTATTAAAAATAGAAAAATTAGCCAGGCATTCTGGTGGGCACCTGTAGTTCTAACCACCTGGGAGGCTAAGGCAAGAGGAACTCTTCAACCCAAGAGTTTGAGGTTGCTGAGAGCTAGGCTAAGGCTGCAGCACTCTAGCCTGGGCAACAGAGTGAGACTGTTTCTCAAAAACAAAAAACAAAAAAA","CGAGACCAGCCTGGTCAATATGGTGAAACCCCGTCCCTACTAAAAATACAAAAATTAGCCAGGCATGGTGGCAGGCACCTGTAGTCCCAGCTACTCGGAAGGCTGAGGCAGGAGAATCGCTTGAACCACAGAGGCAGAGGTTGCAGTGAGCCGAGACTGCACCACTGCACTCCAGCCTGGGCGACAGAGTGAGACTCAGTCTCAAAAAAAAAAAAAAA"
"GL873571","106134","106236","chr4","18143723","18143826","27","18037589","GGCCAGTCTCAGTGGCTCACACCTGTAATCCAGCATTCTGGGAGGCTGAAGCACACGGTCACCTGAGCTCAAAGGTTGGAGACCAGAGTGAGACCCCACCTCT","GGCCAGGCGCAGTGGCTCACTCCTGTAATCCCAGCACTTTGAGGCTGAGGCAGGCGGATCACCTGAGGTCAGGAGTTTGAGACCAGCCTGGCCGAAACCCCATC"
"GL873571","3670496","3670589","chr7","50468399","50468491","15","46797903","GGGCAGGCATGGTGGCTCACACCTGTAATTCTAGCACTCTTGGAGGCTGAGGCAGGAAAATGGCTTGAGGTCAGGAGTTCAAGACCAGCCTGAG","GGCCAGTCATGGTTGCTCACACCTGTAATACCAGCACTTTGGGAGGCCGAGGCAGGCGAATCACCTGAAGTCAGGAGTTCAAGACCAGCCTGG"
"GL873571","4059090","4059389","chr7","52903696","52903994","88","48844606","GGCCAGGTGCAGTGGTTCACACTTATAATCCTAGCACTCTGGGAGGCCGAGGCGAGTGAAGTGCCTGAGCTCATGGGTTCAAGACCAACCTAAGCCAGAGACCCCTGACTCTTATAATAGCCTGGCATTGTGGTGGGCGCCAATATTTCCAGCTACTCTGAGGCTAAGGCAAGAGAATTGCTTGAGCCCAGGAGTTGGAGGTTTCTGTGAGCACTGACGCCGCAGCTCTCTACCAAGGGCAACAAAGACTCTGTCTCAAAAAATAAATAAATAAATAAATAACAGAATGAAAATGAAAAA","GGCCGGGTGCGGTGGTTCACGCCTGTAATCCCACCACTTTGGGAGGCTGAGGCAGGCAGGTCACCTGAGGTCAGGAGTTCCAGACCAGCCTGGCCAACATGGTGAAACCTTGTCTCGGCTATTAGCCTGGCATGGTGGTGCGTGCCCATAATCCCAGCTACTCAGGAGGCTGAGGCAGGAGAATCGCTTGAACCCAGAAGGTGGAGGTTGCAGTGAGCCAAGATAGCACCACTGCAACTCCAGTCTGGGCAACAGAATGAGACTCTGTCTCAAAAAAAAAAAACAAAAAACAAAAAGAA"
"GL873571","4209418","4209704","chr11","32517699","32517985","80","28308281","GGCTTGGCAAGGTGGCTTACACCTCAAATCCTAGCACTGTGGGAGACTGAGGCAGGTGGATTGTTTGAGCTCAGGAGGTCAAGATAGAGAGCAAGAGCAAGTCTCTGTCTCTACTAAAAATAGAAAAGAACTACTTCCCGGGGGTCATGGCAGTAGCCTGTAATCCCAGTTACTAGGTAGAATGAGGCAAGAGGATCTGTTGAAGCCAAGAGACTGAGGTTGTTATGAGCATGCCACAGCACTCTACCCAGGGTGACAGAATGAGACTCTGTTGAAAGAAAAAAAGA","GGCCGGGTGCAGTGGCTCACACCTGTAATCCCAGCACTTTGGGAGGCTGAGGCGGGTGGATCACCTGAGGTCAGGAGTTCAAGACCAGCCTGACAAACATAGTGAAACCCTGTCTCTACTGAAAATACAAAATTAGCCAGGTGTGGTGGCGCATGCCTGTAATCCCAGCTACTCGGGAGGCTGAGGCAGGAGAATTGCTTGAATCCAGGAGGTGGAGGTTGTGTGATCACACCACTGCACTCCAGCCTGGGCGACAGAGTGAGACTCTGTCTCAAAAAAAAAAGAAA"
"GL873571","4209985","4210154","chr3","175781758","175781928","60","171571773","GAAAGAAATGAAAAGAAAGAAGTTAGCTGGTTGTTGGGGTATGCTTCTATAGTCCCACCTACTCAGAAAGCTGAAATCTGGAGTTTGGGGTTGTTGTAAGGTAGGCTGATGACATAGCACTGTAGCTTGGGCAAGAGAGTGTGACTTTGTCTCAAAAAAAATTAAAACAA","ATTAAAAACACAAAGATTAGCCAGGTGTGATGGCACACAACTGTAATCCCAACTACTCAGGAGAATCGCTTGAACCTGGGAGATAGGGTTTGCAGTGAGCCAAGATTGTGCCACTGCACTCCAGCCTGGGTGACAGAGTGAGACTCTGTCTCCAAAAAAAAAAAAAAAAAA"
"GL873571","4210444","4210570","chr17","16655655","16655789","35","12445211","GCCAGGCAGATGGCTCACACTTCATCCTAGCCCTCTGGAAGGCTGAGGCAGGCTAATTTTTTGAGGTTAGGAGTTTGAGACCAGCCTGAGGAAGAGACCCATCTCTACTTTAAAAAATAAATGGAAA","GCCAGGCATGGTGGCTCACACCTGTAATCCTAGCACTTTGGGAGACTGAGGCGGGTGAATCACCTGAGGTCAGGAGTTTGAGACCAGCCTGACCAGTATGGTGAAACCCAGTCTCTACTAAAAATACAGAAATTA"
"GL873571","4391733","4391878","chr11","33723808","33723943","46","29332075","AACTTAGCTGGGAATGGTGGCTCAAGCCTGTAATCCTAGCACTCTGGGAGGCTCAGGTGGGAGGATCACTTGAGGTTGCTGTGAGCTTGGCTGATGCCAGGACACTCTAGTGTGGGCAAGAGAGTGAGACTCCGCCTCAACAACAA","GCCGGGTGCAGTGGCTCATACCTGTAATCCCAGCACTTTGGGAGGCTGAGGTAGGCGGATCACGAGGTCAGGAGCTGAGATGGCGCCACTGCACCCCAGCCTGGGTGACAGAGCAAGACTCTGTCTCAAAAAAAAA"
"GL873571","6307773","6307841","chr9","62429628","62429694","22","56121855","CTGGGTGTGGTGGCATTGCACCTGTAATCCTAGCTACTTGGAAATCTTAAGCCCAGGAGTTGAAGACTG","CCCAGCATGGTGGTGCATACCTATAATCTCAGCTACTTGGAGGCTTGAGCTCAGAAGTTTGAGACCG"
"GL873571","6496217","6496306","chr1","27257765","27257856","27","20761548","GCAGGGTGTGTTGACCCACACCCACAATTCCAGGACTCTGGGGGGCCAGGGATGGTGGGTTCCCTCAGATCAGGAGCTCCTTACCAGCCT","GACTGGGCATGATGGCTCAAATCTGTAATTCCAGCACTTTGGGAGGCCGAGGTGGGTGGATTGCCTGAGATCAGGAGTTCAAGACCAGCCTG"
"GL873571","6499738","6499903","chr1","38976375","38976555","47","32476637","AAAATAACATGAATTGACTAGGCGAGGTGGCTCACATCTCTAATCCTAGCACTCTGGGAGGCTGAGGCAGGAGAATTGCATGAGGTTGCTGTGAGCTATGATGATACCACGGCATTCTAATCAGGGTGACAGAGTGAGATTCTGTCTTAAAACAAACAAACAAAAA","AAAATAAATAAATTAGCAGGGCCTGGTGGCGCACACCTGTAATCCCAGCTACTTGGGAAGCTGAGGCAGGAGAACCCACTTGAACCTGGGAGCCGGAGGTTGCAGTGAGCTGAGATGGCACCACTGCACTCCAGACTGCGTGACAGAGTGAGACTCCGTCTCAAAAACAAACAAACAAAAA"
"GL873571","11399575","11399872","chr15","109458692","109458994","79","98059117","CAGTGGCTCACACCTGTAAATCTAACACTCTGGGAGGCCAAGGTGGGTGGATCCCTTGAGCTCAGGAATTTGATACCAGCCTGAGCAAGAGTGAGACCTTGTCTCTACTAATAATAGAAAAATAGCCCGTGTTGTGGCACTTGTCCCAACCACTGGGGAGGCTTTAGGCGGGAGGATTACTTGAATTGGGAGTTTGATATTGCTGTGAGCTGGGCTGATGCCTTGGCATTCTAGCTTGGGTAACAGCGTAAGACTCCGTCTCAAATAAATAAATAAATAAATAAAAAGAAAAAAAGAA","GTGGCTCACACCTGTAATCTCAGCACTTTGGGAGACCGAGGCAGGTGGATCACCTGAGGTCGGGAGTTTGAGACCAGCCTGACCAACGTGGAGAAACCCCGTCTCTACTAACAATACAAAATCAGCTGGGCGTGGTGGTGCATGCTTGTAATCCCAGCTACTCGGGAGGCTGAGGTAGGAGAATCGCTTGAACCTGGGAGGTGGAGGTTGCGGTGAGCCGAGATCGAGCCACTGCACTCCAGCCTGGGTGACAGAGCAAGACTCCATCTCAAAAAAAAAAAAAAAAAAAAAAAAAAAAAAAAA"
"GL873572","114760","114841","chr8","26280134","26280211","16","26165374","GGCCAGGCATGGCGGCTCTTCCCTGTAATCCTAGCACTCTGGGAGGGCGAGGCAGGCAGATCACCTAGGCTAGGGTGAGATC","GGCCAGGAATGGTGGCTCATGCCTGTAATCCCAGCACTTTGGGAGGCTGAGGCAGGCAGATCACCTGAGGTCAGGAGT"
"GL873572","9421791","9421892","chr11","8089184","8089269","35","1332607","TACTAAATATATAGCAAGGCCAGGCACAGTGGTTCATGGCTGTAATCCCAGTACTCTGGGAGGCCTAGTCAGAGTTGACCTGAGATCAGGCTAGAAGCCTGG","ATAAAAATAATTGGAGGCCAGGCACGGTGGCTCATGCTTGTAATTCTAGCAATTTGGGAGGCTGACGCGGGTGAGATCATACTGAG"
"GL873572","11052834","11053035","chr14","11857478","11857657","65","804644","TCCACAAAGAAAGCAGAAGTGTGGCCGGGTGGTAGCTCAAGGCAGGAATCCCAGCACTCTGGGAGCTGGGAGGTGGGGGAGGATCCCTTGAGATCAGGAGTTGGAGGGCACAGTGAGCCTGGGGGAGGCCACTGTCTCTGTACTCTAGCAGGGAGACAGAGCAAGACTGCCCATTCAAAGAAAAACAACAAACAAAACAAAA","TACAAAAATTAGCTGGGCACGGTGCCACAAGCCTGTAATCCCAGCTACTCGGGAGGCTGGGCAGGGGAATAGCTTGAACCCAGAGGTGGAGGTTGCAGTGAGCCAAGATCAAGCCACAGCACTCCAGCCTGGGTGACAGAGCAAGACTCCATCTCAAAAAAAAAAAAAAAAAAAAAAAAA"
"GL873573","2564195","2564244","chr1","109985445","109985491","12","107421250","TACAAAAATTAGGCTGGGCTTGGTGGTTCACGCCTATAATCCTAGCACTT","ACTAAAATTAGCTGGGCATGGTGGTGCATGCCTGTAATTCCAGCTAC"
"GL873573","7423371","7423533","chr2","202783328","202783513","56","195359957","GGTGGCTCACACCTGTAATCCCAGCACTCTGGGAGCCCTGGTGGCTCATGTCTATAATCCTAGTACTCTGGGAGACCATGGTGGCTCATGTCTATAATCCTAGTACTCTGGGAGCCATGGTGGCTCACGCCTATAATCCTAGTACTCTGGGAGACCATGGTGG","GGCTGAGGCGCGGGGGCTCACGCCTGTAATCCCAGCACTGTGGGAGGCCGAGGCGGGTGGATCACGCCTGTAATCCCAGCACTGTGGGAGGCCAAGGCGGGTGGATCACGCCTGTAATCCCAGCACTGTGGGAGGCCGAGGCGGGTGGATCACGCCTGTAATCCCAGCACTGTGGGAGGCTGAGGC"
"GL873573","9657648","9657710","chr19","10207852","10207913","10","550204","TAAAAATAAAAAATTTAGCTGGATGTGGTGGCTCACACCTGTAATCCTAGCACTCTGGGAGAC","TAAAAATACAAAATTAGCTGGGTGTGGTGGCACACACCTGTAATCCCAGCTACTCAAGAGGC"
"GL873574","1624662","1624783","chr9","814961","815079","36","809701","GACTGGGTGGGTTGGATCATGCCTGGAATCCTAGCACCCTGGGAGGCCAAGGTGAAAGGATTGCTTGAGGTTAGGAGTTCCAGAAATGTAGCAGTCATGGTGACTTCATCCTTCTCTACCAA","GGCTGGGTGCTTTGATTCATGCCTGTAATCCCAGCACTCTGGGAGGCCGAGGCAGGTGGATCACCTGAGGTTAGGAGTTCGAGACCAGCTTGGCTAACATGGTGAAACCTCGTCTCTAC"
"GL873574","4459477","4459612","chr1","29437872","29437991","29","24978395","GGCCGGGCGTGGTGGCGCACGCCTGTAGTCCCAGCGCTATGGGAGGCCGAGGCGGGTGGATCACCTGAGCTCAGAGGTTCGAGACCAGCCAAGACCCCCCTGAGCCAAACGAGCCAGAGTGAGACCCCGTCTCTAC","GGCCGGGCGTGGTGGCTCACGCCTGTAATCCCAACATTTTGGGAGGCCAAGGCGGGTGGATCACCTGAGGTCAGAAGTTCGAGACCAACCTGGCCAACATGGTGAAACCCCTGTCTCTAC"
"GL873574","4681987","4682216","chr6","153082888","153083127","73","148400901","GGGTGCGGTGGCTCAGACCTATAATCCCAGCACTCTGAGAGGCCGAAGTGGGTGGATCACCTGAGCTCAGGAATTTGAGACCAGCCGTCTCTAAAAATAGCTGAGTGTTGTGGCAGTGGCTGTAAGTCCCAGCTGTTTGGAAAGCTGAAGCAAGGGAATCACTTGAACCCAAGAGTTTGAGGTTGCTGTGATGACAAAGTGAGACTCTATCTCAAAAAAAAAAAAAAAAA","GGCCGTGCGCGGCGGCTCACGCCTGTAATCCCAGCACTTTGGGAGGCTGAGGTGGGTGGATCACCTGAGGTCAGGAGTTTGAGACCAGCCCGACCAGAAATTAGATGGGTGTGGTGGTGCGCTCCTGCAGCCCCAGCTACTTAAGAGGCTGAGGCAGGGTAATCACTTGAACCCGGGAGGCGGAGGTTGCAGTGAGCCGAGCTCACGCCACTGCACTCCAGCCTGGGTAACAGAGCGAGA"
"GL873574","4709916","4710039","chr19","13152422","13152536","46","8442506","AAAAATAGAAAAACTAGCCAAGCATGGTGGTGCACCCCCTATAGTCTGAGCTCCTCAGCGGGCTGAAGCAAAAGGACGGCTGGAGCCCTGGAGTTTGAGGTTGCTGTGAGGCAAGGTGATGCCA","ACACATAAATTAGCCAGACATGATGGTGAGTATCTGTAATTCCAGCTCCTTGGGGGGCTGAGGCGGGAGAATTGCTTGAACCTGGGAGGCAGAGATTGCAGTGAGCCAAGATCGC"
"GL873574","6353839","6353913","chr5","25768079","25768163","22","19414240","AAAAATATAGCAAGGCCAGGCATGGTGGCTCACACCTATAATCCCAGTACTTGGGAGCTGGAATTTGAACCTAGG","AAAAAACTCAAACAAGGCTGGGCGTGGTGGCTCACACCTGTAATCCCAGCACTTTGGGAGGCTGAGGTGGGTGGATCACCTGAGG"
"GL873574","6533061","6533332","chr5","85182161","85182439","81","78649100","GGCTGGGCGAGGTGGCTTACACCTATAATCCTAGTACTCTGGGAGGCCAAGGTGGGTGGATTGCCTGAGCGCACAGTTTCAAGACCAGCTGGAGCCAGAGAGAGAGAGAGAGACCCTGCCTCTAAAAATAGCCAGGCATTGTGGCAGGCACCTGTAGTCCCAGCTACTTGGCAGGCGGAGGTATGAGAATCGCTAGAGGTTGCTGTTAGCTATGATGCCATAGCACTCTACCAAGGGCGACAAAGTGAAACTCTGCCTCAAAAAAAAGAAGA","GCCAGGCGTGGTGACTCAAGCCTGTAATCCTAGCACTTTGGGAGGCCAAGGTGGGCGGATTGCCTGAGCTCAAGAGTTTGAGACCAGCCTGGGCAACACGGTGAAACCCAATCCCTACTAAATACAAAAAAAATTAGCCGGGTGTGGTGGTGTGAACCTGTAGTCCCAGCTACTCGGGAGGCTGAGGCAGGAGAAGGCAGAAGTTGCAGTGAGCCGAGATCACACCACTGCACTCCAGCCTGAGTGACAGAGCAAAACTCTTTCTCAAAAAAAAAAAAA"
"GL873574","6643746","6643907","chr2","92627944","92628105","46","85984198","AAATAGCCAGGCGTTGTGGCAGGCACCTATAGTCCCAGCTACTTGGGAGGCTGAGGCAAGAGAATCACTTAAGCCCAAGTGACAGAGGTTGCCAGGGCACTCTACGTAGGCAACAGAGTGAGACTCTATCTAAGAAAGAAGGAAGGAAGGAAGGAGAAAGAA","TTAGCCGAGCATTGTGGTGCGCGCCTGTAGTCCCAGCTACATGGGAGGCTGAGGCAGGAGAACACCTGAACCCAGGATGTGAGCTGAGTCGCGCCATTGCACTCCAGCCTGGGCAACAGAGTGAGACTCCATCTCAAAAATAAAATAAAATAAAATAAAAAA"
"GL873574","6644163","6644274","chr1","128607504","128607619","20","121963341","CTGTAATCCTAGCACTTGGGAGGCTGAGGCAGGTGGATCACCTGAGTTCAGGAGTTCAAGACCAGCCTAAACAAGAGTGAGACCCTATCTCTACTAAAAATAGAAAAAATAT","GCCTGTAATCCAAGCACTTTGGGAGGCTGAGGCGGGTGGATCACCTGAGGTCAGGTGTTCGAGACCAGCCTGGCCAACGTGGTGAAACCCCAACTCTACTAAAAATACAAAAATTA"
"GL873574","8511822","8512127","chr1","23439759","23440073","84","14927937","GGTGGCTGGTGCCTGTAATCCTAGCACTCTGGGAGACTGAGGCAGGTGGATCACTTGAAATCAGGAGTTTGAGATCAACCTGAGCAAGAGATCTTGTCTCTCCTAAAGATAGAAAAACTAGCTGGGATTTGTGGTGGACACCTGTAATTTCAGCTACTCAGGAAGCTAAGGCAAGAGCATTGCTTAAAACCAGGAGTTTGAAGTTGATGTGAGCTAGGATGTCAGGGCAGGTTACCCAGGGTGACAGAGTGAGACTCTGTGTCAAAATAAACAAACAAACAAACAAACAAAACAAAATAAAATAAA","GGCTGGACATGGTGACTCACGCTTGTAATCCCAACACTTTGGGAGGCTGAAGCAGGCAGATCACCTGAGGTCAGGAGTTTGAGACCAGCCTGACCAACATGGTGAAACCTTGTCTCTACTAAAAATACAAAAATTAGCTGGGAGCAGTGGTGCACACCTGTAATCCCAGCTACTCGGCAAGCTGAGGCAAGATAATTTTTTAAACCTGGGAGGTGGAGGTTGCAGTGAGCCAAGATCGTGCCACTGTACTCCAACCTGGGAGACAGAGCAAGACTCTGTCTCAAAAAAAAAAAAAAAAAAAAAAAAAAAAAAAAA"
"GL873575","2107336","2107519","chr4","38052972","38053149","54","35945636","TCAATTAAAAACTTTTTAAAATGAGGCTGAGCATGGTGGTTCACACCTGTAATCCCAGCACTTTGGGAGGCCGAGGCAGGAGGATCACCTGATCCCAGGAGTCCAAGCCTACAGTGAGCCGTGATAATACCACTGCACTTCAGCCCAAAGCCTCAAAAAGAAAAAAAAAAAAGGATAGACAAGA","TATATATATATATATTATTTTGGGGGGGCATGGTGGTGCACACCTGTAATCCCAGCTACTCGGGAGGCTGAGGCAGGAGAATTGCTTGAGCCCGGGAGGCAAAGGTTGCATTGAGCTGAGATCACACCACTGCACTCCAGCCTGGCGACAGAGTCTCAAAAAAAAGAAAAAATAAAAA"
"GL873575","5831824","5831959","chr1","29437872","29437991","28","23606048","GGCCGGGCGTGGTGGCGCACGCCTGTAGTCCCAGCGCTATGGGAGGCCAAGGCGGGTGGATCACCTGAGCTCAGAGGTTCGAGACCAGCCAAGACCCCCCTGAGCCAAACGAGCCAGAGTGAGACCCCGTCTCTAC","GGCCGGGCGTGGTGGCTCACGCCTGTAATCCCAACATTTTGGGAGGCCAAGGCGGGTGGATCACCTGAGGTCAGAAGTTCGAGACCAACCTGGCCAACATGGTGAAACCCCTGTCTCTAC"
"GL873575","7451097","7451208","chr3","122814630","122814743","22","115363533","GGCCAGGTGTGGTGGCTCACACCTGTTATCCTAGCACTCTGAGAGGCCACAGCAGCTGGATCACTTGAGCTCAGGAGTTCAAGACCAGTCTGAGCAAGAGCAAGACCTCACC","GGCTGGGTGTGGTGGCTCATGCCTGTAATCCCAGCACTTTGAAAGGCCAAGGCAGATGGATCACTTGAGGTCAGGAGTTCCAGACCAGCCTGGCCAACATGGCAAAACCCCATC"
"GL873575","7451277","7451445","chr6","58863249","58863409","41","51411972","AAAAATTCAGCCAGCCACAGTGGAAGTGGATGCCTGCCATCACAGCTACTCTGGGGGCTGGGGCAAGAGAATTGCTTGATCCCAGGAGTCTGAGGTTGCTGTGACCTAGGCTGACACCACAGCACTCTACCCAGGGTGACAGAGTGAGGCTGTGTTTAAAAAAAAAAAA","TTAGCCAGGCATGGTGGCACATGCCAGTAATCCCAGCTACTCAGGAGGATGAGGCAGGAGAATCGCTTGAACCCAGGAGGCAGAGGTTGCAGTGAGCTGAGATTGCGCCACAGCACTCTACCCTGGGTGACAGAAGGAGACTCTGTCTCAAAAAAAAAAAA"
"GL873576","1765109","1765185","chrX","53921180","53921256","12","52156071","GGCCAGGTGCAGTGGCTCATATCTGTAATCCTAGCACCCTGGGAGGCCAAGGTAGGCGAATCACCTGAGGCCAGGAG","GGCCAGGTGCAGTGGCTCACGCCTGTAATCCCAGCACTTTGGGAGGCCGAGGTGGGCGGATCACTTTAGGTCAGGAG"
"GL873576","2711577","2711895","chr7","6620384","6620702","85","3908807","GGTCGAGCTTGGTGGCTCATGCTTGTAATCCTAGCACTCTGGGAGGCCAAGGCAGGTAAGTTGCCCTGAGCTCATAGGTTCCAGATCAGCATGAGCCAGAGTGAGACCCTGTCTCTACCAAAAAATAGCCCGGCATTCTGGCAGGTGCCTGTAATCCCAGCTGCTTGGGAGGCTGAGGCTAGAGAATCACTTAAACCCAAGGGTTAGTGGAGGTTGCTGTGAGCTATGATTCCACCGTACTCTACTGAGGGCCACAAAGTGAGACTCTGTCTCCATAAAAAAGAAAGAAAGAAAGAAAGAAAAATAAAATAAAATAAAA","GGCCAGGCACAGTGGCTCATGTCTGTAATCCCAGCACTTTGGGAGGCCGAGGCGGGTGGATTACCTGAGGTCAGGAGTTCTAGACCAGCCTGGCCAACAAGGCGAAACCCTGTCTCTACTAAAAATACAAAAAATTAGCTGGGCGTTTTGGCACATGCCTGTAATCCCAGCTACTTGGGAGGCTGAGGCAGGAGAATTGCTTGAACTGGGGAAGTGGAGGTTGCAGTGAGCTGAGATCACACCATTGCACGCCTGAGCAACAGAGCGAGACTCTGTCTCAAAAAAAAAAAAAAAAAAAAAAAAGAAAAGAAAAAGAAAA"
"GL873576","4782520","4782652","chr9","61136941","61137074","22","56354421","CCAGGCACGGTGGCTCACCCTTGTAACCCTAGTACTTTGGGAGGCTGAGGTGGGAGGATCCCTTGAGGTCAGGAGTTCAAGACCAGCCTGAACAACAGTGAGACCCCCGTCTCTACTAAAAAATAGAAAAGTT","GCCAGGCACGGTGGCTCACGCCTGTAATCCCAGCACTTTGGGAGGCTGAAGCGGGCGGATCACCTGAGGTCAGGAGTTCAAGACCAGCCTGGGCACCATGATGAAACCCCGTCTCTATTAAAAATACAAAAATT"
"GL873576","4782930","4783078","chr7","57521645","57521803","40","52738715","AGTTAGTCTGGTGTCATGGTGGGTGCCTGTAGTCCCAGCTGCTTGGGAGGCTGAGGCAAGAGAATCACTTGAGCCCAGGAGTTGGAGGTTGCTATGAGCGAGGCTGTAGCCTAGGCAACAGAATGAGACTTTGCCTCAAAAAAATAAAA","TTAGCTGGGCATGGTGGCGCATGCCTGTAGTCCCAGCTACTTGGGAAGCTGAGGCAGGAGAATCACTTGAACCTGGGAGGTGGAGGTTGCAGTGAGCTGAGATCGCACCGCTACACGCCAGCCTGAGCAACAGAGAGAGACTCTGTCTCAAAAGAAAAA"
"GL873576","7828709","7828723","chr5","101042981","101042996","1","93214272","TAAATAAATAAAAAA","TAAATAAATAAATAAA"
"GL873576","7828960","7829230","chr13","49045537","49045844","89","41216577","GCCGGCTGCAGTGGCTATAATCCAAGTACCCTGGGAGGCTTAGGTGGATGGATCACTTGAGCTCAGAAGTTCAAGACCAGCCTCAGCAAGAGGTAGACCTTGCCTCTATTAAANNNNNNNNNNNNNNNNNNNNNNNNNNNNNNNNNNNNNNNNNNNNNNNNNNNNNNNNNNNNNNNNNNNNNNNNNNNNAGTTTGAGGTTGCTGTGAGCTATGATGAAGCCAGGGCATTCTACCCAGGGTGACAGAGTAACTCTTAAAAAAAACTAAACAA","GGCCAGGCAGAGTGGCTCATGCCTGTAATTCCAGCAATTTGGGAGGCCTAGGCAGGCAGATTACCTGAGGTCAGGAGTTTGAGACCAGCCTGGCCAACATGGTGAAACCCCGTCTCTTCTANNNNNNNNNNNNNNNNNNNNNNNNNNNNNNNNNNNNNNNNNNNNNNNNNNNNNNNNNNNNNNNNNNNNNNNNNNNNNNGGAGATAATAGCTTTTGTAGAACGAAGCGATGCAACAGCCAGATCGCCGCCACCACCCTTAGGTCCTGGCGACAGAGTGAGATCCATCTTAAAAAAAAAAAAAAAAAAA"
"GL873576","10622840","10623093","chr7","60266447","60266705","74","49643607","GCTGGGTATGGTGGTTCACACCTATAATCCTAGCACTCTGGGAGGCTGAGGTGGGAGGATTGGTGGAGCTCAGGAGCTCATGAGGTGCCAAATCACTGGTGCCACACACCTGTATTCCCAGCTACTGAGGAGGCTGAGGCAGGAGGATCAGGTAAGCCCAGGAAGTTTGAGGTTGTAGTGAGTTAGGATGATTGAACTCTGCCTTGAGAGACAGAGCAAGATCCTCCTTCCTCCTAAGCAAACAAACAAATAAA","GGCTGGGTGCAGTGGCTCACACCTGTAATCCTAGCACTTTGGGAGGCTGAGGCGGGAAAATTGCCTGAGCTCAGGAGTTCAAGGACAGCCTAGGCAACATAGCATGGTGGTGCACGCCTGTATTCCCTGCTACTTGGGAGGCTGAGGCACAAGAATTGCTTGAATCCGGGAAGTGGAGGTTGCAGTGAGCCATTGTGGCACTGCTCTCCAGTCTGGGTGACAGAGCAAGACTCCATCTCAAAAAAAAAAAAAAAAAAAA"
"GL873576","10819939","10820007","chrX","67133632","67133707","21","56313693","AGGTTGCAGTGAAATTGTACCATTCCAATGAAGCCTGGGGGACAGAGTGAGATTCTCTCAAAATAAAAA","GGAGGTTGCAGTGAACCGAGATCGTGCCACTGCACTCCAGCCTGAGCGACAGAGTGAAACTTCGTCTCAAAAAAAA"
"GL873576","10920306","10920363","chr3","48261745","48261808","16","37341439","GCTGGACCTTGTAGAGAGTGCCTGTAATCCCAGCTACATGGGGGGCAAGAGAATTGCT","GCTGGGCATGGTGGTGCATGCCTGTGATCCCAGCTACTCAGGAGGCTGAGGCAGGAGAATTGCT"
"GL873576","10920398","10920529","chr10","67341428","67341546","30","56421030","GGCCAGGCGTGGTGGCTCACGCCTGTTGTCCCAGCACTGTGGGAGGCCGAGGTGGGTGGATTGCCTGAGCTCAGAGGAGTCCGGAAGACCAGCATGAGGCAGAGTGAGCCAGAGTAAGATCCTGTCTCTACC","GGCTGGGTGTAGTGGCTCATGCCTGTAATCCCAGCACTTTAGGAGGCCAAGGTGGATGGATTGCCTGAGCTCAGGAGTTCGAGACCACCCTGGGCAACAAGCCAAAACCCTGTCTCTAC"
"GL873577","515809","515961","chr7","137660778","137660931","43","137144969","AGCTGGGCATGGTGGCTCATGCCTATAACCCTAGCGTGCTAGGAGATTGCTTGTCAGGAGACTGAGGTTGCAGGAAACTGTGATGATGGCACTGCACTCTACCCAGGGTGACAGAGCAGGACTCTGCCTCAAAAAAAAAAAAAAAAATAGAAA","TTAGCTGGGCATGGTGGCGCATGCCTATAATCCCAGCTACTTGGGAGGCTGAGGCAAGAGAATCGCTTGAACCGGGGAGGCAGAGGTTGCAGACTGCACTCCAGCCTGTGTGACAGAGTGGGACTCCGTCTCAAAAAAAAAAAAAAAAAAAAAA"
"GL873577","1633164","1633256","chrX","38269524","38269615","26","36636360","TCAGCCAGGCATGGTGGCACTTGCCTATAAACCCAGCTCCTTGGGAAGCTGAGCCGGGAGGATCCCTTGCACCCAGGAGCAACGGAAGGCAGT","AATTAGCCAGGCATGGTGGCACATGCCTATAATCCCAGCTACTCAGAAGGTTGAGGCAGGAGAATCACTTGAACCTGGGAGGCAGAGGTTGC"
"GL873577","3979502","3979560","chr20","68909283","68909346","13","64929781","GAGTTTGAGACCAGCCTGAGCAAGACCGAGACCCAGTCTCTACTAAAAATAGAAAAATT","GGAGTTCAAGACCAGCCTGACCAACATGGAGAAACCCTGTCTCTACTAAAAAATACAAAAATTA"
"GL873577","3979839","3980009","chr10","31403126","31403287","39","27423287","ATGAGCAGATTGTCTTGGTGGGCACCTGTAGTCCCAGCTATTGGAGGTGGGAGGCTGAAGCAGGAAAATCTCTTGAGCCCAGGAGTTTGAGGTTGCTGTGAGCTAGGCTGACACCACGGCACTCTAGTCAGGGCGTCAGAGTGAGACTCCGTCTCAAAAAAAAAAAAAAAA","TTAGCTGAGTGTGGTGGCGCACATCTGTACTCCCAGCTATTTGGGAGGCTGAGGCAGGAAAATCGCTTGAACCCAGGAGGTGGAGGTTGCAGTGAGCCAAGATCACACTACTGCACTCCAGCCTGGGTGACAGAGTGAGAATCCATCTCAAAAAAAAGAAAA"
"GL873577","6050882","6051080","chr1","153219820","153220007","59","147168938","GGCTGGGCGTTGTGACTCATGCCTGTAATCCCAGCACTCTAGGAGGCCGAGGTGGGTGGACTGCCTGAACTCAGAGGTTTAAGACCATCCTGAGCCGCAGTGAGCCAGAGCGAGACCCTGTCTCTACCAAAAAAAGCTGGGTGTTGTGGTGGGCGCCTATAGTCCTAGCTACTTGAGGCGCTAAGGGTAAAAAAATTGC","GGCCTGGCACAATGGCTCACGCCTGTAATCCTAGCACTTTGGGAGGCCGGGGTGGGTGGATCACCTGAGATCAGGAGTTTGAGACCAGCCTGGCCAACATGGTGAAACTCCTTCTCTACAAAAATTAGCCAGGTGTGGTGGTGGGTACCTGCAATCCCAGCTATTTGGGAGGCTGAGGCAGGAGAATC"
"GL873577","8463965","8464050","chr9","52134422","52134508","19","43670457","CTGGGTGCTATAGCTCACGCCTATAATCCTAGCACTCTGGGAGTTTGGGGCAAATGGATCACCTAGGCTCAGGAGTTTGATACCAG","GGCTGGGAGCAGTGACTCACGCCTATAATCCCAGCACTTTGGGAGGCTGAGGCAGATGGATCACCTGAAGTCAGGAGTTCGAGACCA"
"GL873577","9471486","9471613","chr16","5178790","5178910","46","4292696","TTAGCCAGGCATAGTAGCCTGTGTGTAGTCCTAGCTACTCAGGAGGCTGAGGTAGATGGGTCACTTGAGGTTGCAGAGATTATGGTAATGTCACTGTACTCTAGCCCTGGCAACAGAGCACAACCCTG","TTAGCCGAGCCTGGTGGCATAAACCTGTAATCCCAGCTACTCAGGAGGCTGAGGCAGGGGAATTGCTTGAACCTGAGAGGAGAAGGTTGCAGTGAGCCGAGATTGCACCATTGCACCCCAG"
"GL873577","9471875","9471998","chr7","17832200","17832315","36","8360325","GGCCAGGTGAAGCAGCTCATGGCTATAATCCTAGCAGTTTGGCAGGCCAAGGTGGGAGGACTGCTTGAGGTCAAGAGTTCAAGACCAACCCATCTTTGCGAAAAATTTAAAAATTACCTAGGCA","GCCAGGAGAGGTGGCTCATGCCTCTAATCCCAGCACTCTGGAAATCCAAGGTGGGTGGATCACCTGAGGTCAGGAATTCCAGACCAGTCTGGCCAATATAAAAAATTAGCCAGGCT"
"GL873577","9853150","9853170","chr3","85044647","85044667","3","75191497","AAACAAACAAACAAAAAAAGA","CAAACAAACAAACAAACAAAA"
"GL873577","9853206","9853473","chr7","130818682","130818963","67","120965476","GCTGGGCGCAGCGTCTCACTCCTGTAATCCCAGCACTTGGGAGGCCAAGGTGAGTGGATTGCCTGAGTTTACAGTTTCGAGACCAGCCTGAGCCAAAGCGAGACCCCCATCTCTAAAAAATAGCTGGGCATTGTGGTGGGCACCTGTAGTCCCAGCTACTTGGGAGGCTGAGGCAAGAGGATCGCTTGAACCTAAGAGTTTGAGGTTGCTGTGAGCTAAGGCTCCATGGCATTCTACCAAGGGTGACTAAGTGAGACTCTGTCTAAAA","GCCGGGCACAGTGGCTCACACCTGTAATCCCAGTACTTTGGGAGGCCAAGGTGGGTGGATCACCTGAGGTCAGGAGTTTGAGACCAGCCTGGCCAACATAGTGAAACTCTACTAAAAATACAAAAAAATAGCTAGGCATGGTGGTGCGCACCTGTAATCCCAGCTACTTGGGAGGCTGAGGCAGGAGAGTTGCTTGAACCCAGCGGGGTTGAGGTTGCAGTGAGTTAAGATCAAGCCACTGTGCTCCAGCCTGGATGACAGAGAGAGACTCCATCTCAAAAA"
"GL873577","10722415","10722478","chr10","12501471","12501539","23","1779056","AATAAAAAAATGCTGGGTACAGTAGTACATGCCTGTACTCTCATCTGGGGAAGCTGAGGCATGA","AAAGTAAAAAATTAGAGCTGGGCATGGTGGCACACACCTGTAATCCCAGTCACTAGGGATGCTGAGGCA"
"GL873578","463331","463568","chr10","28935382","28935620","93","28472051","CAGGTGCTTTGACCCACACCCTCAACTCTAGGACTTTGGACGCCCTGGCTGGGTGGGTCCTTTAAAGTCAGGAGCTTCTTATCAGTCTGGGCAAAAGTGAGACCCCATCTCTACCAAACAAAGAAAGAAATCAGCAGTATGTTGCAGTAGAGACTCACCAATACCTTCTTTCAAAGACCAAAGCTGGAAGGACACTAAAGACCATGATCTCATGGCCTCCCTGAGCCATGACAATGCC","CCAGGTGCAGTGGCTCATGCCTGCAAGCTCAGAACTTTGGGAGGCAGAGGTGAGCAGACTGCCTGAGTTCAGGAGTTCAAGACCAGCTGGGCAACATGGTGAGACCCTATCTCTACTAAAAATACAAATAATTAGCAGGGTGTGGTAGCACACACCTGTAGTCCAGCTACTCAGGAGGCTGAGGCAGGAGAATTGCTTGAACCCAGGAGGCAGAGTTTGCAGTGAGCCAGGACTGGGCC"
"GL873578","1143712","1143827","chr11","52824583","52824692","30","51680871","GGCTGGGTGTGGTGCCTCATGCCTGTAATCTAAGCCCTCTCCGAGGCTGAGGTGGGAGGATCCCTTGAGTTTAGGAGTTTGATTTTGAGACCAGCCTGATCAAGAGAGAGACCTCA","GGCCGGGTGTGGTGGCTCATGTCTGTAATCCCAGCACTTTGGGAGGCTGAGGTGGGTGGATACCCTGAGGTCGGGAGCTCGAGACCAGCCTGACCAACATGGAGAAACCC"
"GL873578","1144101","1144139","chr3","33494224","33494257","11","32350123","GAGAGAGACCTCATGTCTACTAAAATAAATAAATATATA","GTGAAACCCGTCTCTACTAAAAATACAAAAATTA"
"GL873578","1144175","1144343","chr12","119519961","119520131","41","118375786","ATTATCCAGGCCTTCTGGTGGATGCCTGTAGTCCTAGCTACTAGAAAAGCTGGAGCAGAATCACTTGACCCAGGAGCTGGAGGTTGCAGGGAGCTAGGCTGATGCCACAGAATTCTAGCCTGAGGCAAAAGAATTGAGCCACTGTCTCAAAAAGGAACAAAAAAGAAAA","ATTAGCCAGGTGTGGTGGCATGCACTTGTAATCCCAGCTACTAAGAAGGCTGAGGCAGGAGGATCACTTGAACCCGGGAGGTGGAGGTTGCAGTGAGCCAAGATCATGCCACTGCACTCCAGCCTGGGCAACAGAGTAAGACTCTGTCTCAAAAAAAAAAAAAAAAAAAAA"
"GL873578","4593962","4594035","chr16","68825055","68825124","22","64231093","AGCTGGGTACAGTGGCTCACATATAATCCCAGTGACTCAGGAGGCTAAGACAGGAGGATTACTAGGACCTGAGA","GGCTGGGCACAGTGGCTCAGACCTGTAATCTCAGTACTTTGGGTGGCTGAGGCAGGTGGATCACCTGAGG"
"GL873578","6158845","6158972","chr3","500432","500562","24","5658413","GACATGGTGGCTCACACCTGTAATCCTAGCCCTCTGGGAGGCTGAGGCAGGTGGATCACTTGAGTTCAGGAATTCAAGACCAGCTTGAGTGAGAGCAAGACCCTGTCTCTACTAAAAATAGAAAAATT","GCACGGAGGCTCATACCTGTAATCCCAGCACTTTGGGAGGCTGAGGCAGGTGGATCACCTGAGGTCAGGAGTTCCAGACCAGCCTGGCCAACATGGCGAAACCCTGTCTCTACTAAAAATACAAAAAATCT"
"GL873578","6159253","6159444","chr19","34496349","34496541","55","28337096","ATAAAATAAAAATAGAAAAATTAGCCAGGCATTGTGGCAGACATGCGAAGTCTCAGCTACTCCAGAGGCTGAGACAGGAAGATTACTTGAGCCCAAGAATCTTGCTGTGAGCTAAGCTGATGCCATAGCATTGTAACCTAGGCAACAGAGTAAGACTTGGCCTCAAAAATAAAATAAAATAATAAAGTAAAA","TTAGTTAATTAAATTAAACTTAGCTAGGCATAGTGGAACACACCCATAGTCCCAGCTACTCTAGAGGCTGAGGCAGGAGGATTGCTTGAGCCAAGTTGGAGGCTGCAGTGAGCTATGGTGGTGCCACTGCATTCCAGCCTCAGTGACAGAGAGAGACCCTGGCTCAAATAATAATAATAAATAAATAAATAAA"
"GL873578","6766040","6766171","chr2","93098086","93098217","30","86332046","CCAGGCACAGTGGCTCATGCCTATAATCCTAGTAGTCTAGGAGGCTGAGGTGAGTGCATTGCTTGAGCTCAGGAGTTAGATACCAGCCTAACCAAGAATGAGACCCCATCTCTATTAAAAATAGAAAAGTTA","GCCGGGCACAGTGGCTCATGCCTGTAATCCCAGCACTTTGGGAGGCCGAGGCGGGCAAATCACGAGGTCAGGAGTTCAAGACCAGCCTGACCAATATGATGAAACCCCGTCTCTATTAAAAATACAAAAATT"
"GL873578","6766434","6766577","chr9","21128084","21128223","50","14361650","GTTAGCCAGGAGTTGTGGCGGGCACCTACAGTCCTAGCGACTCAGGAGGCTGAAGTAGGCAGAGTTTGATGTGTTGCTGTGAACTACAAGGACACCAATGCACTCTAGGCCGGTAACAGAGTGAGACACTGACTAAAAAAAAAA","TTAGCCAGGTGTGGTGGCACATGCCTGTATTTCCAGCTACTCGGGAGGCTGAGGCAGGAGAATTGCGTGAGCTGAGATCATGCCACTTCATTCCAGTCTGGGTGACAGAGTGAGACTCTGCCTCAAAAAACAAAACAAAA"
"GL873578","7397948","7398119","chr5","40230148","40230319","43","32832200","TAAAAATAGCCATGCATTGTGACAGGCACCTGTAGTCCCAGCTACTCAGGAGGTTGAGGTAAGAGAATCACTTGAACCCAAGAGTTTTGAGGTTGTTATGAGCTAAGACGCCTCGGGACTCTACAAAAGGTAACAAAGTGAGACTCTGTCTCATAAAAAAAGAAAAAAAGAA","AAAATTAGCCAGGCATGGTGACGTACACCTGTAGTCCCAGCTACTCGGGAGGCTAAGGCAAGAGAATCGCTTGAACCCAGGAGGCAGAGGTTGCAGTGAGCTTAGATCACGCTACTGCGCTCCAGCCTGGGTGACGGAGTGAGACGCCATCTCAAAAAAAAAAAAAAAAAAA"
"GL873578","7398378","7398515","chr15","102382935","102383070","35","94984557","GGTCGAGCAAGGTGGCTCACGCCTGTAATCCTAGCACTCTGTGAGGCTGAGGCAGATGGATTGCCTGAGCTCGTGGGTTCGAGACCAGCCTGAGCCAGAGTGAGACCTCATCTCTAAAAATAGCTGGGAAGCTGGGCA","GGCCAGGTGTGGTGGCTCACGCCTGTAATCCTAGCACTTTGGGAGGCTGAGGCGGGTGGATTGCCTGAACTCAGGAGGTCAAGACCAGCCTGGGCAACACAGTAAAACCCCATCTCTACTAAAATACAAAAAATCA"
"GL873579","370235","370429","chr16","38067345","38067552","57","37697110","GCACAGGCCTGAAATCCTAGCACTCTGAAAGGCCAACGGAGGAGAATTTCTGGAGCTCAGGAGTTTGATACCAGCCTAAGCAAATAAAGCTAGACCTCTATCTCTACTAAAATTAGAAAAATTAGGCAGATGTGGTGGTAGGCACCTATAGTCCCAATTACTCCAGAGGCTGAGGCAGAAAGACTCTTGAACCCA","GTCAGGCATGGTGGCTCATGCCTATAATCCTAGCACTTTGGGAGGCCAAGGCCGGTGGATCACCTGAGGTCAGGAGTTTGAGACCAGCCTGGCCAATATGGCAAAACCCCGTCTCTACTAAAAATAAAAAAATTAGCTGGGCACGGTGGTGGGCACCTATAGTCCCAGCTACTCAGGAGGCTGAGGCAGGAGAATTGCTTGAACCCAG"
"GL873579","370936","371046","chr3","3847698","3847802","33","3476762","TGACTCTTGAACCCAGGCACATGAGGTTGCTAAGAGTCTAGGCTGATGTCACGGCACTCTAACCTGGGAAACAGTGTGAGGTTCTGCCTCAATAAATAAATAAATAAATAA","TGGCTTGAACCCAGGAGGCGGAGGTTGCAGTGAGCCGAGATCACGCCACTGCACTCCAGCCTGGGCAACAGAGCGAGACTGTCTCAAAAAAAAAAAAAAAAAAAA"
"GL873579","599436","599605","chr10","38982686","38982853","41","38383250","AAAAAGTCAGACATTGTGGCAGGTGTCTGTAATCCCAGCTATTTGGGAGGCTGAGGCAGGAGTATCATTTGAACCCACGAGTCTGAGGTAACTGTGAGCTAGGCTAACACAACAGCACTCTAGCCTGGGCAATAGAATGAGACTCTATCAAGAAAAGAAATGAAAAGAAA","TATTAGCCTGACACAGTGGCGCGCATCTGTAATCCCAGCTACTTGGGAGGCTGAGGCAGGAGAATCACTTGAACCCAGGAGGCGGAGGTTGCTGTGGGCTGAGATCATGCCACTGCACTCCAGCCTGGGCAACAGAGGGAGGCTCCATCTCAAAAAAAAAAAAAAAAA"
"GL873579","599942","599953","chr3","71473700","71473710","4","70873758","TTTTAAAATAGT","TTTAAAAAAAA"
"GL873579","600232","600365","chr1","16061315","16061447","30","15461083","GGCTAGGCAAGGTGACTCATGTCTGTAATCCTAGTACTCTGGGAGGTTTGAGGCAGGAAGACCACTTTAGCTCAAGAGTTCCAGATCAGCCTGTGCAAGAGTGATACATCATCTCTACTAAAAATCAAAAATTA","GGCTGGGCATGGTGGCTCATGCCTGTAATCCTAGCACTTTGGGAGGTTGAGGCAGGCAGATCACTTGAGGTCAGGAATCTGAGACTAGCCTGGCCAACATGGTGAAACTCCATCTCTACTAAAAAAAAAAAAA"
"GL873579","5650320","5650591","chr6","54938866","54939145","71","49288546","GTCAGGTGTGTTAGCTTACAGTAGTAATCCTAGCACTTTGGGAGGTTGAAGTGGGTGGATTGCTTGAGCTCAGGGGTTCAAGACCAGCCTGAACAAGAGTGGGACCTCATCTCTATTAAAAACAGAAAAACTAGCTGGGTGTTATGGTGGGTGTCTGTAGCCCCAGCTACTCAGGAGGCTGAGGCAGGAGGTTGAGGTTGCTGTGAGCTATTGAGACCACAGCACTCTATCCAGGGCAACAGAGTGAGACCCCTCCCCCCCCCAAAAAAAAA","GGCCAGGTGTGGTGGCTCACGCCTGTAATCCCAACACTTTGGGAGGCCGAGGTGGGTGGATCACCTGAGATCAGGAGTTCAAGACCACCCTGGCCAACATGGTGAAACCCCGTCTCTACTAAAAATACGAAAATTAGCTGAGTGTGGTGGTGCATGCCTGTAGTCCCAGCTACTCAAGAGGCTGAGGCAGGAGGTGGAGGTTGCAGTGAGCCGAGATTGCATCACTGCACTCCAGCCTTGGCGACAGAACGAGAGAGACTCCATCTAAAAAAAAAAAAAA"
"GL873579","7037162","7037347","chr3","37328686","37328893","67","30291524","GAGGTGGGTGGATTGCCTGAGCTCACAGGTTGGAGACCAGCCTGAGCCAGAGCAAGACCTTATCTCAAAAAATAGCCAGGTGTTGTGGCTGGCACCTGTAGTCCCAGCTGCTCAGGAGGCGGAGGCAAGAGAAATGCTTGACCTCAGGAGTTTGAGGTTGCTGTGAGTTCAACTCACACTAATACA","GAGGCAGGGGGATCACCTGAGGTCAGGAGATCGAGACCAGCCTGGCCAACATGGTGAAAACCTGTCTCTACTAAAAATCCAAAAACATTAGCCAGGTGTGGTGGCACGCACCTGTAATCCCAGCTACTTGGGAGGCTGAGGCAGGAGAATCACTTGAACCTGGGAGGCAGAGGTTGTAGCGAGCCGAGATCACACCACTGCACCCCAG"
"GL873579","11077764","11077972","chr19","1200469","1200683","63","9877295","GCCAGGTGCAGTGGCTCATGCCTATAATCCTAGCACCCTAGGAGGCTGAGGAGTTCAAGACCAGCCTAAGCAACTGTGAGACCCCATCTCTACCAAAAATAGAAAAATTAGCTGACTGTTATGGTGTGCACCTACAGTCCTAGCTACTCAGGAGGCTGAGGCAGAAAGAGTCCTTGAACCCAGGAGGCTTTTTTTTGTTGTTGTTGTTG","GGCCAGTCGCGGTAGCTCATGCCTGTAATCCCAGCACTTTGGGAGGCCGAGGCGGGCAGATCACCTGAGACCAGCCTGGCAACATGGTGAAACCCCATGTCTACCCAAACTACAAAAATTAGCTGGGTGTGGTGGTGCACGCCTGTAATCCGAGCTACTCAGCAGGCTGAGGCAGGAGAATCCCTTGAACCTGGGAGGCAGAGGCTGCAGTGAGC"
"GL873579","11078245","11078333","chr19","4926258","4926351","22","6151987","TGAACCCAGGAGTTTGAGTTCGCTGTGAGCTAAGCTGAGGCCACAGCACTCCAGCCTGGGCAACAGAGTGAAAGGAAAAAAATAAAAAA","TGAACCCGGGAGGTGGAGGTTGCAGTGAGCCAAGATCACACCAATGCACTCCAGCCTGGGCAACAAGAGTGAAACTCTGTCTAAAAAAAAAAAA"
"GL873580","320374","320488","chr13","48549305","48549409","42","48228931","GGTAGTGCGTGCCTGCATTCCCAGCTACGGGAGGGCAGGGACTTGAGGCCAGCCTGGGCAAAATAATGAGACCTACTAATGACTCTACTAATACAGAAACAATTAGCTAGGTATG","TGGGAGGCCGAAGTGCGCAGATCACCTGAGGTCAGAAGTTGGAGACCAGCCTGGCCAACATGGTGAAAACCCATCTCTACTAAAAATACAAAAATTAGCTGGGCA"
"GL873580","374969","375091","chr6","147681010","147681135","27","147306041","CGGTGGCTCACACCTATAATCCTAGCATTTTGGAAGGCTGAAGCCGAGGATCTCTGGAAGTCAGAAGTTCAAGACCAGCCTGCCCAAGAGCAAGACCCCATCTCTACTAAAAATAGAAAAACT","GGTGGCTCACACCTGTAATCCCAGCATTTTGGGAGGCTGAGGCAGGCGGATAATCTGAGGTCAAGAATTTGAGACCAGCCTGGCCAACATGGAGAAACCCTATCTCTACTAAAAATACAAAATTAC"
"GL873580","375369","375549","chr7","19977275","19977456","44","19601906","CTAACCAAGTTAGTTAGTTTTAGTTGGCAGGTGCCTGTAGTCCCAGCTCCTTGGGAGGCTGAGGCAAGAGAATGGCTTGAGCCCAGGACTTTGAAGTTGCTGTGAGCTATAATGACACCACAGCACACTACCCAGGGTGACAGAGTGAGACTGTCTCAAAAAAACAAACAAACAAAAAAAA","AACAAACGTTAGCCGAGCATGGTGGTATGTGCCTGTAGTCCCAGCTACTTGGGAGTCTAAGGCAGGAGAATTACTTGAGCCCGGGAGGCAGAGGTTGCTGTGAGCCAAGATCACGCCACTGCACTCCAGCCTGGGTGACAGAGTGAGACTCCATCTCAAAAAAAAAAAAGGAAAAAAAAAAA"
"GL873580","8760922","8761015","chr11","104681322","104681416","19","95920400","GGAGGGAGACACTGCAGTGAACTGCGATCGTGTCTCTGCTTTCCAGGCTGGGTGACAGAGTGAGACTCGGTCTCTAAAATAAAAAATAAATAAA","GGAGACGGAGGTTGCAGTGAGCTGTGATCGCGGCACTGCACTCCAGCCTGGGCAACAGAGTGAGACTCTGTCTCAAAAATAAATAAATAAATAAA"
"GL873580","9391260","9391306","chr14","49279240","49279285","12","39887980","GCCAGTCGAGGTGGCTCACACTTGTGATTCCAGCTACTTGGAAGACT","GGCTGAGATGGTGGCACACACCTGTAATCCCAGCTACTTGGGAGGC"
"GL873581","759283","759365","chr6","46535476","46535542","30","45776193","TAAGAACCTGAAAATAGAGCCAGGCATAGTGGTACATGCGTATAGTCCTGGCTACTCAGGAGGTTGAAACAACAGGATTACTT","CAAAATAGCCAGGCTTGGTGGTGCATGCCTATAATCCAAGCTACTCGGGAAGCTGAGGCAGGAGAAT"
"GL873581","1145844","1145979","chr1","29437872","29437991","29","28292028","GGCCGGGCGTGGTGGCTCACGCCTGTAGTCCCAGCACTATGGGAGGCCGAGGCGGGTGGATCACCTGTGCTCAGAGGTTCGAGACCAGCCAAGACCCCCCTGAGCCAAATGAGCCAGAGTGAGACCCCGTCTCTAC","GGCCGGGCGTGGTGGCTCACGCCTGTAATCCCAACATTTTGGGAGGCCAAGGCGGGTGGATCACCTGAGGTCAGAAGTTCGAGACCAACCTGGCCAACATGGTGAAACCCCTGTCTCTAC"
"GL873581","9628238","9628362","chr5","141044567","141044691","34","131416329","ATCCCAGGTAGTCGGGAGGCTGAGGCAGGAGGATCACTTGAACCCAGGAGGTTGAGGTTGCTGTGAGCAAGGCAGAGGCAACGGCACTCTAGCCACGGGGGCACAGAGACTCTTGTCTTTAAAAA","TAATCTCAGCTACTCGGGAGGCTGAGGCAGGAGAATCGCTTGAGCCCAGAAGGTGGAGGTTGCAGTGAGCCAAGATCGCGCCATTGCACTCCAGCCTGGGCGACAGTGCGAGACTCTGTCTCAAA"
"GL873582","1580485","1580534","chr6","32576760","32576806","12","30996275","CAGCACTTGAGAGGCCAAGGCAGGTGGATCAACTGAGCAAGAATGAGACC","CCAGCACCTTGAGAGGCCAAGGCAGGTGGATCACCTGAGGTCAGGAG"
"GL873582","1644368","1644551","chr1","211626449","211626612","63","209982081","AAAATTTGCCGGGCTCCATAGCTCATGCATGTAATCATAGCACTCTGGGAGGCCAAGATGGGAGGATCTCTCAAGCTCTCTTACTTGGGAGGCTGAGGTTGCTGTGAGTTAGGCTTACGCCACAGCACTCTACTCTAGCGTGAGCAACTCTACTCTTAGTATGAGACTGTCTCAAAAGAAAAAA","AAATTAGCCAGGCGTCGTGGCACATGCCTGTAATCCCAGCTACTCGGGAGGCTGAGGCAGGAGAATAGCTTGATCTCGGGAGGCGGAGGTTGCAGTCAGCCGAGATCACACCACTGCAATCCAGCCTGGACAACAGAATGAGACTCCATCTCAAAAAAAACAAA"
"GL873582","5794385","5794459","chr13","18872784","18872852","27","13078399","ATATTGTTAAGCACAGCCACTATTAAAAATTAAATTATAGGCCAGGCATAGTGGCTCATGCCTGTAATCCTAGCT","TGAAACCACCATCTGGACCAAGATACAAAATGTTGGCTGGGCATGGTGGCTCACACCTGTAATCCTAGC"
"GL873583","102645","102683","chr14","5808766","5808804","14","5706121","GAGCAGATCACCTGAGCTCAGGAGTTTGAGACCAGCCTG","GAGGAATCCCTGTGCTCAGGAAGCTTACATTCTAGTGAG"
"GL873583","6200447","6200560","chr4","17786849","17786963","24","11586402","GGCCAGGAGGGACGGCTCATGCCTGTTATCCTAGCACTATGGGAGACTGAGGTGGGAGGATCACTTGAAGTTAGGAGTTCCAGACCAATCTGACCAAAGTGAGACCTCATCTCT","GGCCAGGCTTGGTGGCTCATGCCTGTAATCTTAGCACTTTGGGAGGCTGAAGTGGGTGGATCACTTGAGGTCAGGAGTTAGAACCAGTCTGGCCAACATGGTGAAACCTCAGCTC"
"GL873583","6200584","6200752","chr6","169626528","169626696","42","163425944","TTAGCTGGATGTGGTAGCACATGCCTATAGTCCCATCTACTCAGGAGGCTGAGACAAGAGAGTTGCTTAAGCCCAGGAGTTTAATTTAACTGTGAACTAGACTGAGACTGTGGCACTCTAGCTGGGGCAACAGAGTGAGACTCTGTCTCAAAAGAAAGCAAGAAAGAAA","TTAGCTGGGTATGGTGTCAGATGCCTGTAGTCCCAGCTACTCAGGAGGCTGAGACAGGAGAATCGTTTGAACCCAGGAGGCCAGAACTGCAGTGAGCTGAGATTCGCACCACTGCGCTCCAGCCTGGGCCAGACAGAGTGAGACTCTATCTCAAAAGAAAAAAAAAAAA"
"GL873583","10217398","10217583","chr3","36257142","36257313","44","26039744","TACTAAAAATAAAGTGTGATAGCCAGGCATGGTGGTGGTGCCTATAGAACCAGGCTATTCAGGAGGCTGAGGCAGAAGGATCACTTGAACCCAGGAGTCTGACGTTGCTGTGAGCTAGGCTGGTGCCATGGTACTCTAGCCTGTGGTAACAGAATGAGACTCTATCTCAAAAATAAAAATAAAAAA","TACAAAATTAGCCAGGCGTGGTGGTGCGTGCCTGTAATCCCAGCTACTTGGGAGGCCGAGGCAGAAGAATGACTTGAACCCAGGAGACAGAGGTTGCAGTGAGCCAAGATCCCACCATTGTACTCCAGCCTGGGCAACACAGTGAGACTCCATCTCAAAAAAAAAAAAAAAA"
"GL873583","10394919","10394983","chr16","12841703","12841771","22","2446784","GAGGTCAGGAAATCAAGATCAGTCTGGGCAATATATTGATACCCTGCCCCTACATAAGGAAGAAA","AGGTCAGGAGTTCAAGACCAGCCTGGCCAATATGTTGAAACCTCATCTCTACTAAAAATACAAAAATTA"
"GL873584","521512","521529","chr1","167402212","167402233","10","166880700","GCATGGAACCCCCCACTC","GGTGAAACCCCATCTTTACTAA"
"GL873584","2079725","2079768","chr15","4338291","4338335","11","2258566","GGCAGGTGGATTACCTGAGTTCAGGAGTTGGAGACCAGCCTGAC","AGGCGGATGGATCACGAGGTCGGGAGTTTGAGACCAGCCTGACCA"
"GL873584","5216877","5217053","chrX","91350057","91350230","49","86133180","CTACTGAAAATGATGACAGAGGCTGGGCATGGGGGCTCCCGCCTGTTATCCTAGCACCCTCGGAGGCTGGGGAATGAGGATTGCTTACGCCCAAGAGTTTGAGGTTGCTGTGAGCTGAGGCCGCTGCACTCTAGCCTGGGCAACAGAGTGAGACTCTGTCTCAAAAAAAAAAAAAAA","TGCAAAAATGAGCTGGGCATGGTGGCACATGCCTGTAATCCCAGCTACACAGGAGGCTGAGGCAGGAGAATCGCTTGAATCTGGGAGGCGGAGGTTGCAGTGAGCTGACATCAGGCCCCTGCACTCTAGCCTGGGCCACAGAGCAAGACTCCGTCTCAAAAAAAAAAAAAAAAA"
"GL873584","7289930","7289950","chr2","51453328","51453345","10","44163398","TGAGGCTCTGTCTCGAAATAA","AATGCCATCTATTAAAAA"
"GL873584","7289975","7290131","chr11","49739997","49740154","37","42450022","CAAGAAAATTAGCTGAGAGTCCTGGTAGGTGCCTGTAATCCCAGCTATTCATGAGGCTGAGGCAGAAGGATCACTTGGGTCCAGGAGTCTGAGGTTGCTGTGAGCTAGTCTGACGCCATAACACGCAAGCCTGGGCAACAGAGTGAGGCTCGGTTTC","CTACAAAAATTAGCTGGGCGTGGTGGCACATGCCTGTAATCCCAGCTACTCGGGAGGCTGAGGCAGGAGAATCACTTGAGCCCAGGAGGCGGAGGTTGCAGTGAGCCAAGATCATGCCATTGCACTCCAACCTGGGCAACAGAGCAAGACTCCATCTC"
"GL873584","7577743","7577867","chr5","48394329","48394446","27","40816586","GGCTGGATGAGGTGGTTCATGCCTGTAATCCTAGCACTCTGGGAGGCCAAGGTGGGTGGATTGCCTGAGCTCAGGAGTTCAAGACCAGCCTGAGCAAGACCCTGTCGCTAAAAATAGCTGGGTGT","GGCTGGGTGCAGTGGCTCATGCCTGTAATCCCAGCACTTTGGGAGGTCAAGGCGGGTGGATCACCTGAGGTCAGGAGTTCAAGACCAGCCTGGCCAACATCTCTACTAAAAATACAAA"
"GL873584","7578135","7578289","chr1","130112713","130112865","31","122534578","GGAGCTGGGTTTTGTGACTGCACCTGTAATCCCAGCTGCTCAGGAGGCTGAGGCAAGAGAATTGCTTGAGCCCAGGAGTTGGAGGTTGCTGTGAGCTGTGATGCCAGGGAACTCTACCAAGGGTGACAAAGTGAAACTCTGTCTCAAAAAAAAAA","TTAGCCAGGTGTGGTGATGCATGCCTGTAATCCCAGCTACTCATGAGGCTGAGGCAGGAGAATTGCTTGAACCTTGGAGCTGGAGGTTGCAGTGAGCTGAGATCAGACCACTCCAACCTGGGTGACAGAGCGAGACTCTGTCTCAAAAAAAAA"
"GL873585","1450952","1451121","chr10","59681079","59681242","48","58230127","TAAAAACAGAAAAAACTAGTCAGGTGGTGTGGTAGGTGCTCATAAGTCCCAGCTGCTTGGGAGACTGAGGCAAGAGAATCACTTGAGCACAAGAGCTTGAGGTGGCTGTGAGCTATAACACCATAGCACTGTACTGAGGGTGACAAAGTAAGACTCTGTCTCAAAAAAAA","TACAAAAATTAGTCAAGGGTGGTGGTATGTGCTTGTAATCCCAGCTATTTGGGAGGCTGAAGCAGGGGAATCCTTGAACCCAGGAGGTGGAGGTTGCAGCGAGCCGAGATCACGTCACTGCACTCTAGCCTGGGCGATAGGGTGAGACTCTGTCTCAAAAAAAA"
"GL873585","1451382","1451515","chr6","17405813","17405948","24","15954431","GGCCCGGCTCGGTGGCTCACACCTATAATCCTAACACTCTGGGAGGCTGAGGCAGGTGGATCACCTGAGCTCAGGAGTTTGAGACCAGCTGAGCAAAAACAAGACCCTATCTCTGCTAAAAATAGAAAAAACTA","GGCCGGGCGGGGTGGCTCACGCCTGTAATCCCAGCACTCTGGGAGGCCAAGGCAGGTGGATCACCTGAGGTCAGGAGTTTGAGACCAGCCTGGCCAACACGCAGAAACCCTATTTCTACTAAAAACACAAAAATTA"
"GL873585","1626960","1627026","chr7","17782729","17782794","22","16155769","AAGATGCCACAGCACTCTACAAGAGTGACCAAGTGAGACTCTGTCTCAAAAAAAAAAAGAAAAGGAA","CAATCGCACTACTGCACTTCAGCCTGGGTGACAGAGTGAGAACCTGTCTCAAAAAAATAAATAAAA"
"GL873585","1627304","1627531","chr11","17033552","17033788","61","15406248","GGCTGGGCACAGTGGCTCACGGCTATAATCTAGGCACTTGGGAGGCTAGGGCAGGTGGATTGCCTGAACTGACAAGTTTGAGACCAACCTGAGCAAGAGCGAGACCCCTGTCTCTAAAACATAGCCAGGCTCTGTGGTGGGCGTCTGTAGTCCCAGCTACTTGGGAGGCTGAGGCAAGAGAATTGCTTGAACTCAAGAGTCTGAGGTTGCTGTGAGTTAAGATGCCAC","GCCCGGCGCAGTGGCTCACGCCTGTAATCCCGGCACTGTGGAGGCCAAGGCAGGCGGATTGCCTAAGCTCAGGGATTCGAGAACAGCCTGGGCAACATGGTGAAACCCCATCTCTACTAAAATACAAAAAACTAGCCGGGCGTGGTGGTATGCGCCTGTAATCCCAGCTACTTGGGAAGCTGAGGCAGGAGAATTGCTTGAACCCGGGAGATGGAGGTTGCAGTGAGCTCAGATCAC"
"GL873585","3626082","3626158","chr1","100916857","100916922","27","97290775","TGCCTGTAATCCCAGCACTTGGGAGGCGGAGGTGGGTAGATTGCCTGACCCAGAGTGGGACCTCATCTCTAAAAGAA","CATGCCTGTAATCCCAGCACCTTGGGAGGCCAAGGTGGGTGGATCACCTGAGGTCAGTAGTTTGAG"
"GL873585","8849829","8849913","chr18","48581945","48582025","18","39732116","GGCTGGACGAGGGGACTCATGCCTGCAATCCCAGCACTGAGAGAGGCCAAGGCAGGTGGATCCCCTGAGCTCAGAAGTTTGAGAC","GCTGGACGCAGTGGCTCACACCTGTAATCCCAGCACTTTGGGAGGCCAAAGCAGGCAGATCTGAGGTCAGGAGTTTGAGAC"
"GL873585","9319890","9319971","chr8","79499361","79499447","14","70179471","GGCCAGGTGTGGTGGCTCACACCTGTCATCCTAGCACTCTGGGAGGACGAGGTGGGTGGACCGCCTGAGTCAGAGTGAGACC","GGCCAGGTGTGGTGGCTCACACCTGTAATCCCAACACTTTGGGAGGCCCAGGTGGGTGGATCACCTGAGGTCAGGAGTTCAAGACCA"
"GL873586","895572","895692","chr17","14501559","14501680","38","13605987","GGCCAGGTGAGGTTTCTCATTCTGGGAGTGAGCCAGCAATTGGGAGGCCAAAGTAAATGGATTGCCTGAGGTTATAGGTTCCAGAACAGCCAGAACAAGATCGAAATCCTGTCTCCAAAAA","GGCCAGGCGTGGTGGCTCATGCGTGTAATCTCAGCACTTTGGAAGGCCGAGGCAGGTGGATCACCCGAGGTCAAGAGTTCAAGACCAGCCTGACCAACATGGCGAGTCTCTGTCTCCACTAA"
"GL873586","5645995","5646150","chr6","58863249","58863409","38","53217254","GGGTATGGTGGCTCATGCCTGTAATCCAAGCACTCTGGGATGGTGAGGCAGGAGAATCCCTTGAACCCAAGAGTCCGAGGTTGCTGCGAGCTAAGCTGATGGCATAACACTCTAGCCTAGGCGACAGAGTGAGACTCTGTTTCCAAAGAGAAAAAA","TTAGCCAGGCATGGTGGCACATGCCAGTAATCCCAGCTACTCAGGAGGATGAGGCAGGAGAATCGCTTGAACCCAGGAGGCAGAGGTTGCAGTGAGCTGAGATTGCGCCACAGCACTCTACCCTGGGTGACAGAAGGAGACTCTGTCTCAAAAAAAAAAAA"
"GL873586","10258686","10258969","chr12","9481260","9481565","81","777426","GGCCGGGCATGGTGGCAGAAATCTAGGAGGCCGAGGCAGGTGGATCGCCTGAGATCACAAGTTCAAGACCAGCCTCAGCTACAGCAAGACCCCATCTCTAAAAATAGCCGGCTGTTGTGGCAGGCGCCTGTAACCCCAGCTACTCGGGAGGCTAAGGCAAGAGAATCGCTTGAGCCCATGAGTCTGAGGTTGCTGCGAGCTGTGACTCCACGGCACTCTACCCGGGGCGATAAAATGAGATTCTGTGTCAAAACAAACAAACAAACAAACAACAACAAAAACAA","GCTGGGCGCGGTGGCTCATGCCTGTAATCCCAGCACTTTGGGAGGCCAAGGCAGGTGGATCACCTGAGGTCAGGAGTTCGAGACCAGCCTAGTCCACATGGTGAAACCCCATCTCTACTAAAAACTAGCCAGGCGTGGTGGTGCGCACCTGTAATCCCAGCTACTCGAGAGGCTGAGGCAGGAGAATCACTTGAGCCTAGGAAGCAGAGGTTGTGGTGAGCTGAGATCACACCACTGCACTCCAGTCTGGGCGACACAGTGAGACTCTTGTCTCAAAAACAAAAAACAAACAAACAAACAAACAAA"
"GL873587","3208032","3208047","chr8","3626746","3626762","2","418714","AAACAACCACAAAAAA","ACAACAACAACAAAAAA"
"GL873587","3208141","3208321","chr19","2057131","2057316","59","1151010","TTTCTTTTAAAAATCACCCATGGGCTGGGTATAGTGGCTCACACCTATAATCCTCGGGAGGCCAAGGTTGGAGGATTGCTTGAATCCAGGAGTTGAAGGTTACAGTGAACTGGGATTTAGCCACTAGACTCTAGCATAGCTGACAAAGCAAGAACCTATTTGTTTAAAACACAAAAAAGAA","TACTAATAATACAAAAATGAGCCGGGTATGGTGGCGGGTGCCTGTAATCCCAGCTACTGAGGAGGCTGAGGCAGGAGACTTGCTTGAACCCAGGAGGTAAAGGTTGCAGTGAGCTGAGATTGCACCACTACACTCCAGCCTGGGCGACAAGAGCAAAACTTTTTCTCCAAAAAAAAAAAAAAAAAA"
"GL873587","3278260","3278367","chr19","19044200","19044312","39","15765940","CAGTCTGAGCAAGAGGGAGAGGCTATTTCTACTAAAAACAGAAAAACTAGCTGGGTGTTGGGGTGTGTTCCTAGTCTCAGTTACTTGGGAGGCTGAAGTAAGAGGATC","ACCAGCCTGGCCAACACGGTGAAATCCCGTCTCTACTAAAAATACAAAAATTACCTAGGCGTGATGGCACGTGCCTGTAGTCCCAGCTACTCATAAGGCAGAGGTGAGAGAAT"
"GL873587","3278673","3278754","chr7","49412503","49412597","28","46133830","GGCCACGAGAGCTAGCTCATGCCTATTCTAGGAGGCCAAAGCAGGCAGACTGCCTGAGCTCAGGAGTTCAAGAGCAGCCTGG","GGCCAGGTGCAGTGGCTCATGCCTGTAATCCGAGCACTTTGAGAGGCCGAGGCAGGCAGATCACCTGAGGTCAGGAGTTCAAGACCAGCCTAGTA"
"GL873587","3782076","3782188","chr9","112128434","112128552","34","108346358","ACTGGGGTGGCTGAGGCAGGAGCGTCACTTGAACTCAGGAGTTTGAGATTGCTGTGAGCTGAGCAGATGTCATGGCACGCTAGCCTAGGTAATAGAGTGAGACTTCGTCTAAA","CAGCTACTCGGGAGGCTGAGGCAGGAGAATCACTTGAACTCGGGAGGCGGAGGTTGCAGTGAGCCGAGATCACGCCATTGCACTCCAGCCTGGGCAACAAGAGCGAAATTCCATCTCAA"
"GL873587","4564996","4565084","chr20","27900350","27900437","14","23335354","GGCGGGGTGTAGTGGCTCATGCCTATTGTCCCAGCACTGTGGGAGGCCGAGGTGGGTGGATCACCTGTGCTCAGAAGTTTGAGACCAGC","GGCCGGGCGTGGTGGCTCATGTCTGTAATCCCAGCACTTTGGGAGGCCGAGGTGGGTGGATCACCTGAGGTCAGGAGTTCAAGACCAG"
"GL873587","6307870","6308175","chr12","112427710","112428020","54","106119840","GGCCAGATATGATGGCTCATGCTTGTAATCCTAGCACTCTGGGAGGCTGAAGTGGGAGGATCACCTGAGATCAGGAGTTCAAGATCACCCTGAGCAAAAGTGAGATCCCATCTCTATTAAAAATAAAAAAATTATCCAGGCATGGTGGTGCAGTCCTTTAGTCCCAGCTACTTGGGAGGCTGAGGCAGGAGAATCTCTTGAACCCAGGAATTAGAGGTTACAGTGAGCTGTGATGATGCTACTGCACTCTAGCAGGATGACAGAGTGAGATACTCCGTGTCAAAAAAAAAAAAAAAAAAAGCAAAA","GGCTGGACATGGTGGTTCATGCTTGTAATCCGAGCACTTTGGGAGGCCAAGGCGGGTGGATCACCTGAGGTTGGGAGTTCGAGACCAGCCTGACCAACATGATGAAACCCCATCTCTACTAAAAATACAAAAAAATTAGCCAGGCATGGTGATGCACGCCTGTAATCCCAGCTACTTGGGAGGCTGAGGCAGGAGAATCACTTGAACCCAGGAGGCAGAGGTTACAGTGAGCCGAGATCATGCCATTGCACTCCAGCCTGGATGACAGAGTGAGCCTCTGTCTCAAAAAAAAAAAAAAAAAAAAAAAAAAA"
"GL873587","6484004","6484128","chr10","67341428","67341546","29","60857424","GACCAGGTTCTGTGGCTCATGCTTGTAATCCTAGCACTCTAGGAGGCCGGAAGAGGGTGGATTGATTGCCTGAGGTCAGGAGTTAGAGACCAGCCTGAGCAAGAGCTAGACCCTGTTTCTTTCTT","GGCTGGGTGTAGTGGCTCATGCCTGTAATCCCAGCACTTTAGGAGGCCAAGGTGGATGGATTGCCTGAGCTCAGGAGTTCGAGACCACCCTGGGCAACAAGCCAAAACCCTGTCTCTAC"
"GL873587","6484407","6484586","chr3","167196537","167196723","48","160712130","TAGACCCTGTTTCTAAAAAAAAAATAGCCAGGTGTTGAGGCAGGTACCTGTAGTCCCAGCTACCTGGGAGGGCTGAGGCAAGAGAATCGCTTGAACCCAAGAGTTTGAGGTTGCTGTGAGCTGAGATGCTATGGCACTCAACCGTGAGCTACAAAGTGAGACTCTGTCTCAAAAAAAAAA","AAAACCTGTCTCTGCTAAAAATACAAAAATTAGCCGGGTGTGGTGATGTGCGCCTGTAGTCCTAGCTACTTGGGAGGCTGAGGCAGGAGAATCACTTGAATCCAGGAGGTGGAGGTTGTAGTGAGTCGAGATCGTGCGACTGCACTCCAGCCTGGGTGACAGCGAGACTCTGTCTCAAAAAAAAAAA"
"GL873587","7466229","7466364","chr1","29437872","29437991","35","21971643","GGCCAGGCGTGGTGGCTCATGCCTGTAGTCCCAGCGCTATGGGAGGCCGAGGTGGGTGGATCACCTGTGCTCAGAGGTTCGAGACCAGCCAAGACCCCCCTGAGCCAAATGAGCCAGAGTGAGATCCCATCTCTAC","GGCCGGGCGTGGTGGCTCACGCCTGTAATCCCAACATTTTGGGAGGCCAAGGCGGGTGGATCACCTGAGGTCAGAAGTTCGAGACCAACCTGGCCAACATGGTGAAACCCCTGTCTCTAC"
"GL873588","1502535","1502718","chr1","34852429","34852590","60","33349894","GGTGCAGTGGCTCACACCTGTTGTCCCAGCGCTGTGGGAGGCCGAGGTGGGTGGATCACCTGTGCTCAGAGGTCGAGACCAGCTGAAGACCTGCCTGAGGCAGAGTGAGCCAGAGTGAGACCCCGTCTCTACTAGAACAACAACAAGACAGCCAGACCTTGTGATCCCAGCTACATGGGGGGCT","GCCAGGTGCAGTGGCTCACACCTGTAATCCCAGCACTTTGGGAGGCCGAGGCGGGCGGATCACCTGAGGTCAGGAGTTTGAGACCAGCTTGACCAACATGGAGAAACCCCGTCTCTACTAAAAATACAAAATTAGCCTGGTGTGGTGTCGCATGCCTGTAAT"
"GL873588","10189037","10189246","chr3","45604681","45604903","65","35415644","GCTGAGATGAGGAGACTCTGTCTCTATTAAAAATAGAAAAATTGGGTGGATGTTGTGGGTACTGTAGTTGCAGCCTCTTGGGGGGCTAAGGCAGGAGGATCAGTTGAAGCCAGGAATTTGCTTTGAGCTAGGCTAAAGCCATGGCACTCTAGCCTGGGCAACAGAGTGAGGCTAGATCTCAAAAAAAGAAAGAAAAGAAAAAGAAAAAAA","CTGGCCAACATGGCAAAACCCCATCTCTACTAAATATACAAAAATTAGCTGGACGTGGTGGCACATACCTGTAATCCCAGCTACTTGGAAGGCTGAGGCAGGAGAATAGCTTGAACCTGGGAGGCAGAGGTTGCAATGAGCTGAGATCACGCCACTGCACTCTAGCCTGGGCAATAGAATGAGACTCTGTCTCAAAAAAAAAAAAAAAAAAAAAGACAAGAAA"
"GL873589","104719","104807","chr20","27900350","27900437","13","27795631","GGCTGGGCGTGGTGGCTCATGCCTGTTGTCCCAGCGCTGTGGGAGGCTGAGGTGGGTGGATCACCTGTGCTCAGAGGTTCGAGACCAGC","GGCCGGGCGTGGTGGCTCATGTCTGTAATCCCAGCACTTTGGGAGGCCGAGGTGGGTGGATCACCTGAGGTCAGGAGTTCAAGACCAG"
"GL873589","796766","796905","chr1","166346372","166346487","49","165549606","GGCTAAGTGTGGTGGCTCACACCTGTCATCTAGTACTTTGGGAGGGTGGGCCTGGGAGTTCAAAGACTGAACTCAGGAGTTCAAGGTGGCTCCGGGGAGGAATTCAAGACCAACCTGAGCCAGAGCGAGACCTCGACTCT","GGCCAGTGGGGTGGCTCACGCCTGTAATCCCAGCACTTTGGGAGGCTGAGGTGGTCAAATGACCTGAGGTCAGGAGTTTGAGACCAACCTGGCCAACATGGTGACACCTCGTCTCT"
"GL873589","1023679","1023690","chr1","205890061","205890072","1","204866382","AAAAAAAAAAAA","ACAAAAAAAAAA"
"GL873589","1023771","1024047","chr4","103012712","103012993","70","101988941","GGCTTGGTGGCTCACACCTGTAATCCTAGCACTCTGGGAGGCCGAAGTGGCTGGAATACTTGAGGTCAGGAGTTCAAGACCAGCCTAAGTGAGAGTGAGATCCCCATCTCTAATAAAAATAGAAAAATTAGCAGGGTGTTGTGGCTGGCACTTGTAGTCCCAGCTACCCAGGAGACCGAGGCAGAAGTTTGAGATTATTGTGAGCGAGGCTGATGCCACAGCATTCTAGTGGGACAACAGAGCAAAATTCTATCTCAAAAGAAAAAAAAAAAAAGGA","CGGGCGTGATGGCTCACGCCTGTAATCCCAACACTTTGGGAAGCCGAGGCGGACGTATCACCTGAGGTCAGGAGTTCAAGACCAGCCTGGCCAACATGGTGAAACCCCGTCTCTACTAAAAATACAAAAATTAGCTGGGTGTGGTGGCATGCGCCTGTAATCCCAGCTACCCAGGAGGCTGAGGCAGGAGAATCGCTGAGGCTGCAGTGAACTGAAATTGTGCCACTGCACTCCAGCCTGGGTGACAGAGCAAGACTCTGTCTCAAAAAAAAAAAAAAAAAA"
"GL873589","4820958","4821024","chr8","33633747","33633811","15","28812789","TTAGTCAAGTGCAGTGGCTCACACCTGTCATCCCAGCTACTTGGGAGGCTGAGGCAGGAGAGTTGCT","TTAGCCAGGTGTGGTGGTGCATGCCTCTAATCCCAGCTACTCAGGAGGCTGAGGCAGGAGAATTG"
"GL873589","6763768","6763857","chrX","25814002","25814092","29","19050234","GGTGTGGTGGCTCACACTTGTATCTTAGCATTTTAGGAGGCTGAATGGGGAGAATTGCTTTAAGTCAGGAGTCTGACTTCCACCTTGCCA","GGCTGGGAATGGTGGCTCACACCTGTAATCCCAGCACTTTGGGAGGCTGAGGTGGGCAGATCACCTGAGGTCAGGAGTTTGAGATCAGCCT"
"GL873589","8444551","8444632","chr9","93194085","93194171","17","84749534","CGGGCATGGTGGCTCACAACTATAATCTTAGCACTTTGGGAGGCTGAGACAGGTGGATGCCTGAACTCAAGAGTTTGAAACC","GGCCGAGCATGGTGGCTCACACCTGTAATCCCAGCACTTTGGGAGGCTGAGGCAGGTGGATTACCTGAGGTCAAGAGTTCAAGACCA"
"GL873589","9085365","9085494","chr2","194063347","194063481","42","184977982","GGCCAGGCACAGTGGCTCACACCTATAATCCCAGCACTCTGTGAGACTGAGGCAGGTGAACTGTTGCAAGAGTGAGACCCTGTGCTTGGTGCCTGTAGCTCAGTGGTTAATAATAAGAAAAAAGAAAAAA","GGCCAGGTGCAGTGGCTCACACCTGTAATCCCAGCACTTTGGGAGTCTGAACCAGGCAGATCACCTGAGGTCAGGAGTTCGAGGCCAGCTCGGCCACCATGGTGAAACCCTGTTTCTAATAAGAATACAAAAAAA"
"GL873589","9085767","9086002","chr7","84631446","84631650","75","75545679","GAGTGAAACCCTGTCTCTACTAAAAATAGAAAAACTAGCTGTGCATCAGGGCGCATAACTGTAGTCCCAGGTACTCAGGACACTGAGGCAAGAGAATTGCTCAAGCCCAAGAGTTTGCAAGAATTTGAGGTTGCTATGAGCTATGATGCCATGGCACTCTACCTAGGGTGACAGACAGAGACTCTGTCCCAAAAAAAAAAAAAGAAGAAGAAGAAAAAAAAAAAGAAAGAAAGAAA","ATAGTGAAACCTCGTCTCTACTAAAAATACAAAAATTAGCTGGGCATCATGGTGCACGCTTGTAATTCCAGCTACTTGGGAGGCTGAGGCAGGAGAATTGCTTGAACTCAGGAGGTGGAGGTTGCAATGAGCCAAGATCGCGCCACTGCACACCAGCCTGGGTGACAAAAGACTCTGTCTCAAAAAAAAAAAAAAAAAAAAAAAA"
"GL873589","9992904","9993045","chr16","56427538","56427666","46","46434634","AACCAGCCAGGCATGGTGATTCACACCTATAATCCCAGCTACTTAGGAGTATGGCTTGAGCACACAGGATACCATACCATTCTAGTCATCCCAGGCAACAGAGGGAAACTCTGTTGGTTAAAAAAAAAGAAAAACTTAAAAA","TTAGCCAGGAGTGGTGGTGCACGCCTATAATCCCAGCTACTTGGGAGGCTGAGGCACAAGAATCACTTGAACCATTGCACTCCAGCCAGGGTGATAGAGGGAGACTCTATCCAAAAAAAAAACAAAAAA"
"GL873589","9993319","9993452","chr3","2774534","2774668","28","7218785","GGCCTGAGCCCTGTGACTCATGCCTGTAATCCCAGCACTGGAAGTTCCAAGGCAGGTGGATCGCTTGAGCTCTGGAGTTCAAGACCAGCTCAACCAAGAGTAAGACCCCATCTCTACTAAAAATAGAAAAACCA","GGCTGGGCACGGTGGCTCATGCCTGTAATCCCAGCACTTTGAGAGGCCGAGGCAGGTGGATCTCCTGAGGTCAGGAGTTCAAGACCAGCCTGGGCAACATGGTGAAACCCCATCTCTACTAAAAATACAAAAAAT"
"GL873590","9044589","9044884","chr1","83754525","83754835","84","74709936","GGCCAGGTGCAATGGCTCATGCCTATAATCCTCACACTCTGGGAGGCTGAGGCAGGAGGATCACTTTTCTCAGGGTCAGGGCCAGCCTGACAAAAGTCAGACCCTGTTTCTACTAAAAATAGAAAAACTAGCTGGGTGTTGTGGCAGATGCCTATAGTCCCAGCTACTAAGAGACTGAGACAAGTGCCCAGAGTCTGAGGTTACTGTGAGCAAAGCTGATGCCATAGCATTCTAGCTATAGATCGAGAGTCTGTCTCAAAAACAAACAAACAAACAAACAAACAAACAAAAAAGAA","GGCTGGGTGTGGTGGCTCATGCCTGTAATCCCAGCACTTTGGGAGGCCGAGGCGGGTGGATCATCTGAGGTCAGGAGTTCAAGACCAGCCTGACCAACATGGTGTAACCCTGTCTCAACTAAAAATACAAAAATTAGCTGGGCGTGGTGGTGTGCACCTATAGTCACAGCTACTTGGGAGGCTGAGACAGGAGAATTGCTTCAACCCAGGAAGTGGAGGTTGCAGTGAGCCAAGATCATGTCACTGCACTGCAGCCTGACAGAGCGAGACTCCATCTAAAACAAACAAACAAAAACAAACAAACAAACAAA"
"GL873591","1831505","1831587","chr17","61702818","61702899","25","59871313","CCCAGCACTTTGGGAGGGCAAGATGGGAGAATCATATAAAGTCAGGAGTTTGAGACCAGTTTGGCAGACATGATGAACCCATC","AATCCCAGCACTTTGGGAGGCTGAGGCAGGCGGATCATCTGAGGTCAGGAGTTCAAGACCAGCCTGGCCAACATGGTGAAAC"
"GL873591","2719175","2719275","chr4","86137755","86137847","32","83418580","GTGGGGGCTTAGGCCTGTAATCCCAGCACTCTGAGAGGCCAAGGTGAGCTGGTCACCTGGGTTTAGGAGTTTGGAGACTTGCTCGAGCTAGACTGAGGCTC","GTGGTGGCTCACGCCTGTAACCCTAACAATTTGGGAGGCCAAGGCAGGTGGATCACTTGAGGTCAGAAGTTTGAGACCAGCCTGGACAATATG"
"GL873591","4732974","4733120","chr19","7991801","7991954","55","3258827","ATACGCAGACTGGCCGAGCGTGGTGTCACATGCCTATAATCCCAGTGGCTACTCTGGGGAGGAGAATCTCTTGAAACCAAGAGTTAGAGATTGCAGTGGGGTATGATACAGGGTAACAAAGAGAGACCTTGGATCTGAAAAGAAAAA","AAAATACAGAAACTAGCTGGGCATGGTGATGCACACCTGTAATCCTAGCTACTGGGGAGGCTGAGGCAGGAGAATTGCTTGAACCCAGGAGTCAGAGGTTGCAGTGAGCAACCAGCCTGGGTGATACAGTGAGTGAGACTCTGTCTCGAAAAAA"
"GL873591","6822728","6823009","chr1","20579766","20580052","72","13757038","GGCCAGGCGTGGTGGCTCATGCCTGTAAATCTCAGCACTCTGGGAAGCTGAGGCAGGTGGATTGCTTGAGGTCAGGAGTTTGAGACCAGCCTGTACCAGAGTAAGACCCTGTCTCTAATAAAAATAGAAAAAAAAAAAAAAACTAGTTGGGCATGGTGATGGGTGCCTGTAGTCCCACCTACTTGGGAGGCTGAGGCAATGGCATCTCTTGAGCCCAAGAGTTTGAGGTTGCTGTGCCATGGCACTCTCCCCAGGGTAACAGAGTGAAAATAAAAAAAAGAA","GGCCAGGCGTGGTGACTCATGCCTGTAATCTCAGCACTTTGGGAGGCCGAGGCAGGTGAATCACCTGAGGTCAGGAGTTTGAGACCAGCCTGACCAACATGGTGAAACCTCGTCTCTACTAAAAATACAAAAAGTAGCCAGGCATGGTGGCGCATGCCTGTAATCCCAGCTACTTGGGAGGCTGAGGCAGGAGAATCGCTTGAACCCGAGAGGCAGAGGTTGCATTGAGTCAAGATGGTACCACTGCACTCCAGCCTGGGTGACAGATTGAGACTCAAAAAAAAAAA"
"GL873591","7578706","7578813","chr16","45055441","45055543","42","37476735","AAATTTAGCTACACATAGTGGCATGAGTCTGTAATGCTAGCCACCCAAAAGGCTGTAGTAAGAGGATTGCTCTATCCCAGGAGTTAAAGACCAGCCCGGACATCAGAG","AATTAGCCGGGCGTGGTGACACACACTTGTAATCCTAGATACTCAGGAGGCGAAGGTAGGAGAATTGCTTGAACCCAGGCAGCAGAGGTTGCAACGAGCAGAG"
"GL873591","9282916","9283004","chr1","20744253","20744338","16","11461337","GGCCAGGCGCGGTGGCTCACCCCTGTTGTCCCAGTTCTGTGGGAGGCCGAGGTGGGTGGATCACCTGTGCTCAGAGGTTTGAGACCAGC","GGCCAGGCACGGTGGCCACGCCTGTAATCCCAGCACTTTGGGAGGCCGAAGTGGGTGGATTACCTGAGGTCAAGAGTTTGAGACCA"
"GL873592","835155","835315","chr16","75654291","75654451","43","74819136","CTGGGTGTGGTGGCTCTTGTCTGCAATCTCAGTACACTGGGAGGCTGAGGCAGAAGGATTGCTCCAGCTCAGGAGTTTGAGGCCAGGCTGAGCTAGTGCAAAACCCCATCTCTACTAAAAAAAGAAGGAAAAAAAAAAGAAAAAGAAAAAAAATACGAGCT","CCAGGTGTGGTGACTCACGCCTGCAATCCCAGCACTCTGGGAGGCTGAGGTGGGTAGATTACCGGAGGTTAGGCGTTTGAGACCAGCCTGGCCAACATGGTGAAACCCCATCGCTACTAAAAAAAAAAAAAAAAAAAAAAAAAAAAAAAAAAAAAAAATTA"
"GL873592","835589","835765","chr1","66836166","66836336","48","66000577","ACAAAAAACCTAGCTTAGGGTTGTTATAGCACCTGTAGTCCCAGCTACTCAGGCGCTAAGGCAGGAAAATCTGCCTGAGCTCAGGAGTTTGAGGTTGCAGTAAGTTATGATGATGCTACTGCACTCTAGCTGGGGCAACAGAGTGAGACTCTGTCTGAGGAAAAACCAAAACCAAAA","TAGCCCAGCACGGTGGCTCACACCTGTAGTCTCAGCTACTCAAGAGGCTGAGGCATGAGAATCGCTTGAACCCAGGAGGTAGAGGTTGCAGTGAGCTGAGATCATGCCACTGCGCTCCAGCCTGGGCAACAGAGTGAGACTCAGTCTCAAAAAACAAAACAAAACAAAAAA"
"GL873592","2520661","2520705","chr16","66853217","66853257","11","64332556","TCTGGGAGGCTGAGGCGGGTGGATCACCTGAGCAAGAGTGAGACC","TTTGGGAGGCTGAGGCAGGTGGATCACTTGAGGTCAGGAGT"
"GL873592","4535248","4535388","chr1","12240468","12240612","38","7705220","GGCGGGATGTGGTGGTTCATGGCTGTAATCCCAGCACTCAGGGAGGCTGAGTCGGGTGGATTGCTTGAGTTCAGGAGTTTGAGACCAACCTGAGCAAGAACTAAGCCTGTCTCTACTAAAGATATTATTTCTTATTTTTCT","GGCCGGGCGCGGTGGCTCATGCCTGTAATCCCAGCACTTTGGGAGGCTGAGGCGGGTGGATCACCTGCGGTCAGGAGTTCGAGACCAGCCTGGCCAACGTGGTGAAACCTCATCTCTACTAAAAATATAAAAATTAGCTGGTGTG"
"GL873592","4535654","4535831","chr8","126054004","126054184","54","121518350","TCTACTACAAATATTAACAGAAAAATTAGCTGGGCATTGTGACAGGTGCCTATAGTCCCAGATACTCAGAAGGCTGAAGTAAGAGGATCACTTGAACCCCAGGAGCTAAGGTGGCTGTGAGCTAGGCTGAGGCTCTAGCCTGGGTAACAGAGTGAGACTGTAAAAAAAGAAAGAGAGA","GTCTCTACTAAAAATACAAAAATTAGCTGGGTGTGGTGGTGCATGCCTGTAATCCCAGCTACTCAGGAGGCTGAGGCAGGAGAATCGCTTGAACCCAGGAGGTAGAGGTTGCAGTGAGCCAAGATCATGCCACTGCACTCCAGCCTGGGTGACAGAGGGAGACTCTGTCTCAATAAATAAA"
"GL873592","6794968","6795049","chr3","154764711","154764794","20","147969743","GAAGGTTTGATGAGCTCAGATGATGCCACTGCAGTCTACCCAGAGTGAAGGAGCGAGACTCTGTCTCAAAAACAAAAAAAGA","CAGAGGTTGGCAGTGAGCTGAGACTGTGCCACTGCACTCCAGCCGGGTGACAGAGTGAGACTCTGTCTCAAATTACAAACAAAA"
"GL873592","6881384","6881478","chr5","24882384","24882475","28","18001000","GGGCAGGCATAGTGACTGGTGTCTCTAATCCTAGCAGTCTGGGATGCTGAGGCAAGTGGAATGTCAGAGTTCAGGAGTTGAAGATCACCCTGACT","GGCCGGGCGCAGTGGCTCACATCTATAATCCTAGCATTTTGGGAGGCTGAGGCAGGCGGATCACCTGAAGTCAGGAGTTTAAGACCAGCCTG"
"GL873592","6881755","6881937","chr10","61601371","61601572","66","54719616","TCACCCTGACCAAGAGCAAGACCCTGTCTCTACTAAAAATAGAATAAACTAGCTGGGAATTGTGGTGGGTGCCAGTAGTCCCCGCTACTGAGGCAGGAGGATCATTGAGTCCAAGAGTTTGAGGTTGCTGTAAGTTAGGACACCACAGCACTCTACACAGAGTAAGACTGCCTCAAAAATAAA","AGTAAAGAAAAGAAACCCTGTCTCTACTAAAAATACAAAAATTAGCTGGGTGTGGTGGTGCGCACCTGTAGTCCCAGCTACTTGGGAGGGTGAGGTATGGGAATCACTTGAACCCGGGAGGTGGAGGTTGCAGTGAGCCAAGATCACACCACTGCACTCCAGCCTGGGTGAGAGAGTGAGACTCTGTCTCAAGAAAAAAGAA"
"GL873592","7006080","7006155","chr1","8947061","8947129","24","1940981","CACACTGAGAGGCAAAGGCTGGTGGATCACCTGAGCTCAAGAGTTTGAGACCAGCCAAGCCAGAGATCTTGTCTCT","CACTTTGGAGCCAGGTAGGTGATCACCTGAGTCAGGAGTTCGAGACAGCCTGGCCAACATGTGAAACCC"
"GL873592","8446508","8446655","chr11","122502739","122502874","48","114056231","TTAGCTGGGTGTTGTGGCAGGCACCTGTAGTCCCTCCCAGCTACTTGAAAGGCTGAGGCAAGATGACAGCTTAAACCCAAGAGTTTAAGGTTACTCTATTCAGGGCAACAGAGTGAGACTCCATCTACATAAATAAATAAATAAATAA","GGCTGGGCGTGGTGGTTCACACCTGTAATCCCAACACTTTGGGAGGCTGAGGCCAGCGGATTGCCTGAGCCCAGGAGTTTGAGACCAACCTGGGCAACATGGTGAAACTCCATCTCTACTAAAATACAAAAAGTTA"
"GL873592","8446953","8447008","chr16","44513352","44513404","15","36066399","GACCAGCCTAAGCAAAAAAGAGATCCTATCTCTACTACTAAAAATAGAAAAAATTA","ACCAGCCTCACCAATATGAAGAAACCCCATCTCTACTAAAAATACAAAATATT"
"GL873592","8447239","8447325","chr1","8062863","8062957","21","384376","GGCCAGGAGCAGTGACTCATGCCTAGCACTCTGGGAGGCCAAAGCAGGTGGATCAACTGAGCTCAGGAGTTCAAGACCAGCCTAAGC","GGCCGGGTGCAGTGGCTCATGCCTGTAGTCCCAGGACTTTGGCAGGCCAAGGCCGGTGGATTACCTGAGGTCAGGAGTTCAAAACCAGCCTAGCC"
"GL873592","8723925","8724000","chr3","42066983","42067054","20","33343058","AATTAGCCGGGCATGGTAGTGTGTGCCCATAATCTCAGCTACTCAGAAAGCTAAGATAGGAAAATTGCTTGAGCTC","TTAGCTGGGTGTGGTAGTGCATGCCTATAATCCCAGCTACTCGGGAGGCTGAGGTGGGAGAACTGCTTGAAC"
"GL873593","384022","384146","chr15","102382935","102383070","28","101998913","GGCCACGAGGGCCCATGCCTGTAATCCTAGCACTCTGGGAGGCTGAGGTGAGTAGATTGCTGAGCTCAGGAGTTCAAGACCAGCCTGTGCAAGAGACCCCATCTCTGCTAAAAATAGAAAAACCA","GGCCAGGTGTGGTGGCTCACGCCTGTAATCCTAGCACTTTGGGAGGCTGAGGCGGGTGGATTGCCTGAACTCAGGAGGTCAAGACCAGCCTGGGCAACACAGTAAAACCCCATCTCTACTAAAATACAAAAAATCA"
"GL873593","384425","384607","chr20","28286874","28287058","50","27902449","GAAAGAAAAGAAAAGAAAAACTAGCAAGATGTTGTAGCTGATGCCTATAATCCTAGCTATTGGAGAGGTGGAGGCAAGAGAATTGCGTGAGCCCAAGAGTTGAAGGTTGCTGTGAGCTGCGATGCCAGAGCACTCCAGGGTGACAGAGTAAGACTCTGTCTCAAAAAAAATTACAAAATAAAA","TAATAAAAATAAAAAAATTAGCCAGGAGTCAAAGCACACGCCTATAACCCCAGCTACTTGGGAGGCTGAGGGAGGAGAATTACTTGAACCCGGGAGGTGAAAGTTGCAATGAGCTGAGATCAAGCCACTGCACTCCAGACTGGATGACAGAGTGAGACTCTGTTTCAAAAAAAAAAAAAAGACAA"
"GL873593","1408445","1408467","chr10","88070368","88070389","9","86661923","AATCTAGAGATGGGGAGAGGTTG","AAAGAGATGGAAGAGAAGAAGA"
"GL873593","4856365","4856484","chr7","56497314","56497433","31","51640949","GCAATCCCAGCTGATCGGGAGGCTGACCCAGAAGAATCCCTTGAACCCAAGAGTCTGAGGTTGCTATGGGTGGATTCTACAGCACTCTAGCCTGGGAGACAGAGTGAGACTCTGTCCCAA","ATCCCAGCTACTTGGGAGGCTGAGACAGAAGAATTGCTTGAACCCGGGAGGTGGAGGTTGCAGTGAGCCAAGATTGTACCACTGCACTCCAGCCTGGCAACAGAGTGAGACTCTGTCTCA"
"GL873593","6661298","6661485","chr10","86749316","86749514","55","80088018","GCAGAGGCTCACATATGTAATCCTAGCACTCTGGGAGGATAAGGCAGGTGGACAGCTTGAGCTCAGGGGTTTGACCAGTCTGATCAAGAGCAAGACCTGTGTCTACTAAAAATAGAAAACCTAGCCAGGTATGATGGTAGATGCCTGTATTCCTAGCTACTCTGGAAGCTAAAGCTAAAGAGTTTGAA","GGTGGCTCACACCTGTAATCTTAGCAATTTGGGAGGCCGAGGTGGGTGGATCACTTGAGGTCAGGAGTTTGAGACCAGACTGGCCAACATGGTGAAACTCTGTCTCTACTAAAAATACAAAAATTAGCCAGTCATGGTGGTGCATGCCTGTAATCCCAGCTACTCAGGAAGCTTAGGCAGGAGAATCACTTGAACCCAG"
"GL873593","6710263","6710446","chr14","4390080","4390244","66","2320183","TTGAAGTCAGGAGTTTAAGGCCAGTCTGGGCAACATAGTGAGACCCCCATCTCTACGAAAATATTTTTTAAAAATTAAAAATAGCTGGGCATAGTGAGGCTGTTGTGAGCTATAACTGCACCACTGCACTCAGCCAAGGACAGAGACCCTGTTCCCTGCCTCAAACAAACCAAAACAAAACAAA","AAGTCTAGAGTTTACAGCCTGGACAACGCAGTGAAACCCTGTCTCTACCAAAAATACAAAAATTAGACAGGTGTGAGAGGCGGAGGTTGCAATGAGCTGAGATCGCAGCACTGCAGTCCAGCCTGGATGACAGAGCGAGACCCCATCTCAAAAACAAAAACAAAA"
"GL873593","7159645","7159716","chr6","178318394","178318465","21","171158749","GATCATGTCACTGCTCTCCAACCTGGGCAATTGAGCAGGAATCTGTCTCAAAAAGAAAAAAAAAAAAGAAAA","CGAGTTCACACCACTGCACCCCAGCCTGGGCAACAGAATGAGACTCGGTTTCAAAAAAAAAAAAAAAAAAAA"
"GL873593","7159841","7160050","chr13","33368171","33368368","69","26208330","GGCCAGGCGTGGTGGCTCACACCTGTTGTCCCAGTGCTGTGGGAAGCCGAGGCAGGTGGATCACCTGAGCTCAGCCGAGTTCGAGACCAGTGGAAGACCAGCATGAGGCAGAGTGAGCCAGAGTGAGACCCCATCTCTACAACAACAACAAGAAGAAAAAAAACAGCCGGACCTTGTGATCCCAGCTACGTGGGGAGCTAGAGAATCACT","GGCTAGGCATGGTGGCTCATGCCAGTAATCCCACCACTTTGGGAGGCCGAGGCAGGTGGATCACCTGAGGTCAGGAGTTCAAGACCAGGCTGGCCAACATGTTATGATGAGACCCTCATCTCTACTACAAATACAAAAATCAGCTGGGCATGGTGGCAAGTGCCTGTAATCCCAGCTACTTGGGAGGCTGAGGCAGAA"
"GL873593","8598292","8598391","chr11","118461023","118461129","33","109862731","AGCCAGGTGAGGTGGTTCACACCTGTAACCCTAGCTGCTTGGGAGGCTGAGGCCTCTCTATCCTGGGCAGTGTGGAGAAACTTTGTTTCAAAAAAAAGAA","GCCGGGCGCGGTGGCTCACGTCTGTAATCCCAGCGCTTTGGGAAGCCGAGGCGGGACTATCCTGGCCAACATGGTGAAACCCCGTCTCTACTAAAAATACAAGAATC"
"GL873594","357249","357377","chr2","75702890","75703011","36","75345641","CCTGGTACCGTAGGTCATGCCTGTAATCCTAGCACTTTGGGATGCTGAGGTGGGCAGATTGCCTGAGCTCACGAGTTCAAGCCATTAGAACTGAGCCTGACCTAGAGTGGGACCTCCAACTCTTTTTTT","GCCAGGCACAGTGGCTCATGCCTGTAATCCCAGCAGTTTGGGAGGCTGAGGTGGGCAGATCACTTGAGGTCAGGAGTTCAAGACCAGCCTGGCTGACATGGTGAAACCCCATCTATACCAAA"
"GL873594","357656","357834","chr7","17608776","17608965","55","17251120","GGGACCTCCAACTCTTAAAATAGCTGGGCATTGTGGTGGGCACCTACAGTCACAGCTACTTGGGAGGCTAAGGCAAGAGACTTGTTTGCAGCCAAGAGTTAGAGGTTGCTGTGAGCTATGAGGCTAGGGCACTCTACAGGGGGCGACAAGTGAGACTGTAAAAAAAAAAAAAGAAAAAA","GTCCCTACTAAAAATACAAAAAATTAGCTGGGCCTGGTGGCAGGCACCTGTAATCCCAGCTACTTGGGAAGCTGAGGCAAGAGAATTGCTTGAACCCAGGAGGCAGAGGTTGCAGTGAGCTGACATCAAGCCACTGTACTCCAGCCTAGGCAACAAGAGCAAGACTCTGTCTCAAAAAAAAAAAAAAAAA"
"GL873594","1410711","1410996","chr5","151340503","151340797","76","149929792","CACAGTGGCTCATACCTATAATCCTAACACTCTGGGAGGCCAAGGTGGGTGGACTGTCTGAGTTTGGGACCAGCCTGAGCAAAAGCAAGACTCCCATCTCTACTAAAAACAAAGACAGCCAGGTATGAGGGCAGGTGCCTATCATCCCAGCTACTTGGGAGGCTGAGGAAGGAGGATCACCTAAGCCCAGGACTTTAAGGTTTCTGTGAACTAAGATGATGTTACAACACTCTAGCCAGGGTAACAAGGCAAGATTCTGTTTCAAAAGACAAAAAAAAAAAAAAAA","GGTGGTTCATGCCTGTAATCCCAGCACTTTGGGAGGCTGAGGCAGGTGGATCACCTGAGGTCAGGAGTTCGGGACCAGCCTGGCCAACATGGGGAAACCCCATCTCTACTAAAATACAAAAATTAGCCAGGTATGGTGGCACATGCCTATAATCCCAGCTACTTGGGAGGCTGAGGCAGGAGAATCACTTGAACCCAGGAGGCTAAGGTTGCAGTGAGCCGAGATTGTGCCACTGTACTCCAGCCTGGGTGACAGACTGAAACTCTGTGTCCAAAAAACAAAACAAAACAAAAAA"
"GL873594","5528090","5528162","chr2","69013639","69013718","24","63485549","GGTACAGTGGCTCACGCTTGTGATCCCAGGTTGAGGTGGGTGGATCGCCTGAGCTCAGGAGTTGGATGCCAGC","GGTGTGGTGCCTCACGCCTATAATCCCAGCACTTTGGGAGGCAGGTGGATCACTTGAGGTCAGGAGTTTGAGAACAGCCT"
"GL873594","5834047","5834168","chr2","82491537","82491662","28","76657490","GGCTGGGCCCAGTAGCTCACGACTGTAATCCCAGCACTCTGGGAAGCTGAGGTGGGCGGATCACCTGAGCTCATAGGTTCGAGACCAGCTCCAGTTAGAGTGAGAGCCTGTCTCTAAAAATA","GGCTGGGCACAGTGGCTCATGCCTGCAATCCCAGCACTTTGGGAGGCTGAGGTGGGCAGATCACCTGAAGTCAGGAGTTCAAGACCAGCCTGGCCAACACAGTGAAACCCCATCTCTACTAAAAAT"
"GL873594","5834396","5834461","chr13","14688151","14688212","20","8853755","TATATAATAATAATAACCAGGTATTGTGGCAGGTGCCTCTAGTCCCAGCTACTCGGGAGGCAAAGG","ATAAAAAAATTAGCTGGCCATGGTGGCACATACCAATAATCCCAGCTACTCAGGAGGCTGAG"
"GL873594","7786130","7786294","chr14","12217087","12217250","37","4430957","GGGTGTGCTGGCTCATACCTATAATCCTAGCACTCTGGGAGGCTGAGGTAGGTGTATTGCTTGAACCCAGGAGTCTGAGGTTGCTGTGCGCTAAGCTGATACCATAGCACTCTAGCCTGGGCAACAGAGTGAGACTCTGTCTCAAAACAAATAAATAGTAAAAAA","GCTGGGCGTGGTGGCTCACACCTGTAATCCCAGCACTTTGGGAGGCCAAGGCATGAGAATTGCTTGAAAACAGGAGGCGGAGGTTGCAGTAAGCTGAGACTGTGCCATTGCACTCCAGCCTGGGCAACAAGAGTGAAACTCTGTCTCAGAAAAAAAGAAAAAAA"
"GL873595","723579","723774","chr19","6045933","6046125","65","5322354","GCCTGAGCAGGAGAGAGACCCCATCTCTGCTGAAAGTGGAAAAGTTGGCTGAGTGTAGTGGCGGGCTGCTGCCCCAGTCACTCAGGAGGCTTAGGAAGGAGTATCGCTTGGGCCCAAGATTTGAGGTTGCTGTGAGCGCTACAAAGACATTAGGGTACTCTACACAGGGGAATAGAGTGAGACTGTCTCAAAAAAA","CAACATGGAGAAACCCCGTCTCTACTAAAAATACAAAATTAGGCAGCGTGGTGGTGGGTGCCTATAATCCCAGCTACTCAGGAGGCTGAGGCAGGAGAATCGCTTGACCGGGAGTGGAGGTTGCGGTGAGCTGAGATTGCACCATTGCACTCCAGCCTGGGCAACAAGAGTGAAACTCCGTCTCAAAAAGAAA"
"GL873595","724114","724204","chr20","18199749","18199840","22","17475635","GGCCATGCTTGGTGGTTCTCATCTGTAATCCTAGCACTCTGGAAGGTCTACAGGGGTGGATGGCTGGAGGTCAGGAGTTCAAGACTGGCCT","GGCCGGGCATGGTGGCTCACACCTGTAATCCCAGCACTTTGGGAGGCTGAGGCAGGCGGATCACCTGAGGTCAGGAGTTCGAGACCGGCCTG"
"GL873595","1065346","1065667","chr18","10529729","10530057","74","9464383","GGCCAGGTGCAGCAGCTCATGCCTGGAATCTTCCTGCTCTGTATGGCCAAGGCAGGTGGATCGCCTGACCTCAGGAGTTCCAGACCAGCCTGAACAAGAGCAAGACTCTGTCTCTACTAAAAGTAGAAAAAAAACTAGCCAGTCATAGTGGCAGGTGCCTGTAGTCCCAGCTGCTTGGGAGGCTGAGGCAAGAGGATCACTTGAACCTAAGAGTTTGAGGTTGCTGTGAGCTAAGATGCCACATCACTCTATCAAGGGTGACCAAGTGAGACTCTGTCTCAAAAATAAATAAATAAATAAATAAAAAGAAAGGCAAAAAGAA","GGCCCGGCGTGGTGGCTCATGCCTATAATCCCAGCCCTTTGGGAGGCCAAGGCAGGTGGATCACCTGAGGTCAGGCGTTCGAGACCAGCCTGACCAACGTGGTGAAACCTCATCTCTACTAAATACAAAAAAAATTTAGCCAGGCATGGAGGCACATGCCTGTAATCCCAGCTACTTGGGAGGCTGTGGCAGGAGAATCACTTGAACCTGGGAGGTGGAAGTTGCAGTGAGCTGAGATTGTACCACTGCACTCCAACCTGGGTGACAAAGCAAGACTCGGTCTCAATAAATAAATAAATAAATAAATAAATAAATAAAGTGAAAAAAAA"
"GL873595","1254878","1255146","chr4","42822326","42822607","67","41567448","GGCTGGGCATGGTGGCTCATGCCTGTAATCCTACCGCTCTGGGAGGCTGAGGCAGAGGATCACTTGAGCTCAGGAGTTTCAGACCAGCCTGCAAGAAGGACCCAGTCTCTGCCGAAAATAGAAAAGTTAGCAAGGCGTTGTCGTGAGCACATGTATCCCAGCTACCTAGAACTCTGAGGCAGGAGGATCCCTTGAACCCACAGAAGTTGCTGTTATCTAAACTGATGCCACTGGACTCTAGCCTGGGCAACAGAGTGAGACTGGTCTCA","GGCCGGGCACGGTGGCTCATGCCTGTAATCCTAGCATTTTGGGAGGCTGAGACAGGCAGATTGCCTGAGCTCAGGAGTTCAAGACCAGCCTGGGCTAGATTGTGAAACCCCATCTCTACTAAAATATAAAAATTAGCTGGGTGTGGTGGCACACGCCTGTAATCCCAGCTACCTGGGAGGCTGAGGCAGGAGAATCGCTTGAACCAGGAGACAGAGGTTGCAGTGAGCTGAGATCACGCCACTGCACTTTAGCCTGGGCAACAGAGTGATACTCTGTCTCAA"
"GL873595","3417105","3417297","chr12","115674238","115674427","44","112257133","GGCCGGGCGCTGTGCCTCACGCCTGTAATCCTAATACTCTGAGAGGCCGAGGCAGGTGGATTGCCTGAGCTCAGGTGCTCAAGACAGCCTGACTGAGCAAGCCCTGAGATCCCATCTCCACTAACAATAGTAAAACTAGCCGGGCATTGTGGTGGTGCTTGTAATCCCAGCTACTGGGAGGCTAAGACAGGAG","CCAGGCCTGGTGGCTCACGCCTGTAATCCCAGCACTTTGGGAGGCCGAGGTGGGTAGATCACCTGAGGTCAGGAGTTCAAGACCAGCCTGGCCAACATGGCGAAACCCCATCTCTACTAAAAATACAAAAATTAGCTGGGCATGGTGGTGTATGCCTGTAATCCCAGCTACTCGGGAGGCTGAGGCAGGA"
"GL873595","6098380","6098457","chr3","87492619","87492702","21","81394239","GCTGTGGCTCATGCTGATAATACCAGCACTCTGGGAGAACAAGGTAGGCAGATCACAAGAGGTCACCTGTGCAAGACC","GGGCTGGTGGTGGCTCATGCCTGTAATACCAGCACTTTGGGAGGCCAAGACAGGTGGATCACCAAAGGTCAAGAGTTCAAGACC"
"GL873596","134190","134307","chr1","203207333","203207443","31","203073143","GGCTGGGCGAGGTGGCTCACACCTGTAATCCTAGCACTCTGGAAGGCCCTAGCACTCAGGCAGTTGGATTGCCTGAGCTCACAAGTTCAAGACCAGCCTGAAAAAGAGCAAGACCTCA","GGCTGGGTGCAGTGGCTCACACCTGTAATCCCAGCACTTTGGGAGGCCGAGATGGGTGGATCACTTGAGGTCAAGAGTTGAAGACCAGCCTGGACAACATGATGAGACCCC"
"GL873596","134578","134681","chr11","50235285","50235387","37","50100707","CAAACAAAAGAGGAAGACCTCGTCTCTAAAAAAATAGCTGGGCATTGTGAGGAGTACCTGTAGTCCTAGCTACTCAGAAGGCTGAGACAAGAGAATCACTTAAA","CAACATTGTGAAACCCTGTCTCTACTAAAATAGAAAATTAGCCAGGTGTGTGGGCGTGCCTATAATCCTAGCTACTGGGGAGGGTGAGGCATGAGAATCGCCT"
"GL873596","8160215","8160350","chr1","29437872","29437991","30","21277657","GGCCGGGCGTGGTGGCGCACACCTGTAGTCCCAGCGCTATGGGAGGCCGAGGCGGGTGGATCACCTGAGCTCAGAGGTTCGAGACCAGCCAAGACCCCCCTGAGCCAAACGAGCCAGAGTGAGACCCCGTCTCTAC","GGCCGGGCGTGGTGGCTCACGCCTGTAATCCCAACATTTTGGGAGGCCAAGGCGGGTGGATCACCTGAGGTCAGAAGTTCGAGACCAACCTGGCCAACATGGTGAAACCCCTGTCTCTAC"
"GL873596","8421071","8421132","chr20","1874027","1874093","12","6547044","GTCAGGCGCAGTGGCTCACGCCTGTAATCTCAGCACTCTGAGAAGCCAAGGCAGGATCATCT","GGCCAGGCGCAGTGGCTCAGGCCTGTAATCCCAGCACTTTGGGAAGCCAAGGTGAGCAGATCACCTG"
"GL873598","4416400","4416489","chr5","39418145","39418231","15","35001745","GGCCAAGTGTGGTGGCTCATGCCTGTTGTCCCAGCACCGTGGGAGGCCGAGGCTGGTGGAACACCTGAGCTCAGCTGAGTTTGAGACCAG","GGCCAGTTGCGGTGGCTCATGCCTGTAATCCCAGCACTTTGGCAGGCTGAGGCAGGTGGATCACCTGAGGTCAGGAGTTTGAGACCA"
"GL873598","4416855","4416947","chr3","94091253","94091337","31","89674398","GTGAGACCCTGTCTCTACAAAAAAAAAAGCTGGGCACTGTGGCATGTGCCTGTAATCCCAGCTACTTGGGAGGCAAAGGGAAAGAGAATCACT","AAACCTTGCCTTTACTAGAAATACAAAAATTAGCTGGGCATGGTGGCAGGTACCTGTAATCCCAGCTACTTGGGAGGCTGAGGCA"
"GL873598","5126074","5126161","chr1","12339306","12339394","19","7213232","GCCTGGTGCACTGGTTCACACCTGGAATCCTTGCATTCTGAGAGGCCCAGGTAGGCAGATCACCTCAGCTCAGAAGTTCGAGACCAGC","GCTGGGTGCGGTGGTTCACGTCTGTAATCCCAGCACTTTGGGAGGCCGAGGCGGGCAGATCACCTGAGGTCAGGAGTTCGAGACCAGCC"
"GL873598","5467584","5467662","chr1","9313328","9313403","17","3845744","GCGAGGTGGCTCACGCCTGTAATCCCAGCACATTTGGAAGGCCAAGGAGGGTGGATCACCCGAGCTCACCAGTTGGAGA","CGCAGTGGCTCACGCCTGTAATCCCAGCACTTTGGGAGGCCGAGGCAGGCAGATCACCTGAAGTCAGGAGTTTGAG"
"GL873598","6917752","6917856","chr14","9558287","9558382","22","2640535","GGCCAGGCATGGTGGCTTGTGCCTGTTGTCCCAGCACTGTGGAAGGCCGAGGCGGGTGGATCGCCTGAGCTCAGCTGAATTCGAGACCAGCATAAGACCAGTATG","GGCCAGGCATGGTGGCTTATGCCTGTAATCCCAGCACCTTGGAAGGCCGAAGCGGGCAGATCACCTGAGCTCAGGAGTTTGAGACCAGCCTGTCCA"
"GL873598","8078910","8079062","chr7","164825511","164825660","43","156746601","AACAGCCAGGCATTGTGGTGGGCACCTGTAATCCCAGCTACTTGGGAGGCTGAGGCAAGAGAATTGCTTGAGCCCAACAGTCTCAGGTTACTGTGAGTTATGACACCATGGCACTCTATTGAGGGCAAGAAAGTGAGACTGTCTTGGAAAAAA","CTAGCCAGGCATGGTGGTGCGCACCTGTAGTCCCAGTTACTTGGGAGGTTGAGGCAAGAGAATTGCTTGAGCCTGGAAGGCAGAAGTTGCAGTGAGCTGAGATCACACCACTGCATTCCAGCCTGGGCGAAAGAGCAAGACTCTGTTGAA"
"GL873598","8079328","8079454","chr6","10381248","10381379","32","2301920","GCCCGGCGTGGTGGCTCACGCCTGTAATTCCAGCACTCTGGGGAGGCCGAGGAGGGCAGATTGCCTGAGCTCACAGGTTTGAGCTAGAGCGAGACCCTGTCTCTTAAAAAGAAAAAAAAGGAAAGAA","GCTGGGCGCGGTGGCTCACGCCTGTAATCCCAACACTTTGGGAGGCCGAGGCGGGCAGATCACCAGAGGTGATCTCCAGCCTGGGCAGGAGAGCAAGACCCTGTCTCAAAAAATTTAGAAAAAGGAAAGAAA"
"GL873599","3943256","3943456","chr9","35892110","35892312","79","31948854","GGCAGGCTGCTTTGACCCATATCTACAACTCCAGAACTTTAGAGGCTGAGCTGGGTGGGTCCCTTGAGATTAGAAACTGCTTAGTAGCCTGGCAAAAACCAGACCCCACCTCCACCATGTAGAAAAATTAGCAGTATGCCATAGTGGGAACCTACCAATACAGTCTTTCCAAAGGCCAAAGCTAGAAGGACCGTGAGCTTG","GGCTGGGTGTGGTGGCTCATGCCTATAATTCCAGCACTTTGGGAGGCCGAGGCAGGTGGATCACCTGAGGCCAGGAGTTTGAGACCAGCCTGGCCAATATGGTGAAACCCCATCTCTACTAAAAGTACAGAAAATTAGTCAGTCATGATGGCGCATGCCTATAATCCCAGTTACTCGGGAGGCTAAGGTAGGAGAATTGCTTG"
"GL873599","6693284","6693349","chr1","100916857","100916922","15","94223573","TCACGTCTATAATCCTAGCACTCTGGGAGTCCTTGGCAGGTGGATCACCTGAGCTCAGGAGTTTGA","CATGCCTGTAATCCCAGCACCTTGGGAGGCCAAGGTGGGTGGATCACCTGAGGTCAGTAGTTTGAG"
"GL873600","991618","991705","chr15","13850109","13850195","15","12858491","GGCTGGGCGTGGTGGCTCACACCTGTTGTCCCAGCGCTGTGGGAGGCTGAGGCAGGTGGATCACCTGTGCTCAGAGGTTGAGACCAGC","GCCGGGCGCTGTGGCTCACACTTGTAATCCCAGCACTTTGGGAGGCTGAGGCAGGTGGATCACCTGAGGTCAGGAGTTAGAGACCAG"
"GL873600","8825981","8826014","chr16","43605817","43605844","11","34779836","AGTCTGGGGCAACAGAGCAAGACTCTGTCTCAAA","CAGTCTGGGTGACAGAGCAAGATTCCAT"
"GL873600","8826039","8826157","chr13","87428402","87428520","35","78602363","ATTAGCCTGGTGTGGTGGTATATGCCTTCCTGCCTGCTTGGGAGGCTGAGGCAGGAAGTATGCTTTAACTGTGGAGTCTGAGGTTGCTATGAGCTAGGTTGAGGCCATGGCACTCTAAA","TTAGCCGGGTGTGGTGGTGCACGCCTGTAATCCCAGCTACTCAGGAGGCTGAAGCAGGAGAGTTGCTTGAACCCAGGAGTTGGAGGTTGCAGTGAGCTGAGATCACGCCATTGCACTCC"
"GL873601","269289","269338","chr14","49279240","49279285","14","49009951","GACTGGGTGTGGTGGCTCACACCTTTAATCCTAACACCCTGGGAGGCTTA","GGCTGAGATGGTGGCACACACCTGTAATCCCAGCTACTTGGGAGGC"
"GL873601","269431","269678","chr1","184453273","184453521","76","184183842","AGAAGATCACTCAAGATCAGGAGTTTGAGAACAGCCTGAGCAAGACCCCCATCTTTACTAAAAATGGAAAAGTTTTTACCCAGGCATGGTAGTGCGTGCCTGTATCCCATCTACTCCGGAGGCTGATAGGAGGATTGCTTCAACCAAGGAGTTTGAGGTTCCAGAGACTTAAGATGACACAACTGCATTTTACCCAGTGTGACACAGCGAGACTCTTTCAGAAGAATTTTTAAAAGGAAAAAAAAGAA","GGTCAGATCACCTGAGGTCAGGAGTTTGAGACCAGCCTGACCAACATGGTAAAACCCCATCTCTGCTAAAAATACAAAAAATTAGCCAGGCATGGTGGTGAACGCCTGTAATCCTAGCTACTCAGGAGGCAAAGACAGGAGAATCGCTTGAATCTGGAAGGTGGAGGTTGCAATGAGCCAAGATGACGCCACTGCACTCCAACCTGGGTGACAGAGGAAGACTCCATCAAAAAAAAAAAAAAAAAAAAA"
"GL873601","1397978","1398117","chr16","24839455","24839591","34","23441477","GCCTATAATCCTAGCACTCTGGAAGGCTGAGGCAGGAAGATCACTAGAGCTTGGGAGTTTGAGATTGCTGTGAGGGAGACTGACTCCATGGCACTCTAGCCTGAGGCAACAGAGTAAGACTCCATCTCAAAAAAAAAAAA","CTCTAACTCCAGCTACTCAGGAGGCTGAAGCAGGAAAATCACTTGAACCTGGGAGGTGGAGGTTACAGTGAGCCAAGATCACACCATTGCACTCCAGCCTGAGCGACAGAGCGAGACTCTGTCTCAAAATAAATAAA"
"GL873601","4065502","4065590","chr11","108711352","108711444","19","104645850","GCTGGATGTGGTGGCTCTCACCTATAATCCTAGCACTCTGGGAGGTCAAAACAGGTGGATCACCTGAGCTCAGGAGCAAGAACACCAGC","GTCAGGGGTGGTGGCTCACGCCTGTAATCCCAGCACTTTGGGAGGCCAAGGCAGGTGGATCGCCTGAGCTCAGGAGTTCAAGACCAGCCTTGC"
"GL873601","8241370","8241465","chrY","9469734","9469829","34","1228364","AAAAAAGGTGGAGATGAGCCATGCGCAGTGGTGTAGGCCTGTAATCCCAGCCCTTGGGAGGCCAAAATGGTGGATTGCCTGAAGCAGAGCAAGACC","AAAGTACAAAGAGTCTGGGTACAGTGGCCCAAGCCTGTAATCCCAGCAGTTTGGGAGGACAAGATGGGTAGATCACCTGACATCATGAATTAGAGA"
"GL873569","7519122","7519191","chrX","79016364","79016431","16","71497242","TTGGCCAGGCATGGTCGCTCAGGCTGTAATACCAGCTACTTGGGAAGCTGAAGCAGGAGGATCACTTGAA","TTGGCCAGGCACGGTGGCTCATGCTTATAATCCCAGCTACTCGTGAGGCTGAGGCAGGGGAATCGCTT"
"GL873569","7989158","7989286","chr8","41505677","41505810","35","33516519","AGTCCCACCTATTTGGAAGGCTGAGGCAAGAGGATCACTTGAACTCAGCAGTTTGACATTGCTATGAGTTAGATTGACTCCATGGCACTCTAGCCCAGGCAACAGAGCAAGACTCCGTCTCAAAACAAA","TAATACCAGCTACGTGGGAGGCTGAGGCAGGAGAATCACTTGAACCCGGGAGGTGGAGGTTGCAGTGAGCTGAGATTGCACCGTTGCACTCTAACCTGGGCAACAAAAGCAAAACTCTGTCTCAAAAAAAAAAA"
"GL873569","7989575","7989702","chr1","62231025","62231129","47","54241450","GGCTGGGTAATGCAGTGGCTCACGCCTATAATCCTAGTGCTTTGAGAGGCCAAGAGTGAGACTCTGTGTACTAAAAATAGAAAAATTACCTAGGCATTCTGGTGGGCACCAGTAGTCCCACCTATTTG","GGCTGGGCATGGTGGCTCACGCCTATAATCCCAGCACTTTGGGAGGCCGAGGCAGGTGGATCACCTGAGATCAGGAGTTTGAGACCAGACTGGCCAACATGGTGA"
"GL873569","10034363","10034556","chr10","61268396","61268605","62","51234033","CAGCTTGAGCAAAAGTGAGCCCCTGTCTCTACTGAAAATAGAAAAAATTAGCCAGGCGTGGTGGCACACACTTATAGTCCCAGCCACTTAGGAGGCTGAGGCAGGAGTTTGAGGTTGACATAATCTAAGCTGATACCATAGCACTCTAGCCTGGGCAATAGAGTGAGACTCTGTCTCAAAGAAGAAATTTATCT","CCTGACCAATGGTGAAACCCTGTCTCTACCAAAAATACAAAATTTAGCTGGGCATGGGGGCACGCACCTGTAGTCCTAGCTACTCGGGAGGCTGAGACAGGAGAACTGCTTGAACTCGGGAGGCAGAGGTTGCAGTGAGCTGAGATCATGCCACTGCACTCTAGCCTGGGCAATAGAGTGAGACTCCGTCTCAAAAAAAAAAAAAAAAAA"
"GL873569","10034830","10034845","chr1","217667782","217667796","2","207632952","AAAAAAGAAGAAAAAA","AAGAAAAAGAAAAAA"
"GL873569","10203815","10203922","chr8","96374555","96374671","35","86170740","GCCAGGTGTAGTGGTTCACACCTATAATCCTAGCACTCTGGGAGCCTGAAGCAGGTAAATGGACTGAGCAAGAGTGAGACTTCCACCTCTATTGAAAATAGAAAAATT","GGCTAGGTATGGTGGCTGATGCCTATAATCCCAGAATTTTGGGAGGCCGAGGCAGGCAGATCATCTGAGGTCAGGAGTTTGAGACCAGTCCCGTCTCTACTAAAAATACAAAAATTA"
"GL873569","10204196","10204373","chr20","1304385","1304559","47","8899811","GAAAATAGAAAAATTAGCCAGGCATTATAGCAGGCACCAGTAATCCCAGTTACTTGGGAGGCTAAGGCAAAAGAATCTCTTGAGCCCAAGTTTGGGGTTGCTAGGAAGTAAAACACCACAGCACTATACCCAGAACAAGAGAGTGAAGACTCAGTCTCAAAAAGATAAATAAATAAAA","AAAAATACAAAAATTAGCCAGGCATGGTGGCGGGCGTCTGTAACTCCAGCTACTTGGGAGACTGAGGCAGGAGAATCGCTTGAACCCAGGAGGCAGAGGTTACAGGTGAAATCACACCACTGCACTCCAGCCTGGGCAACAGGGCAAGACTCTGTCTCAAAAAAAAAAAAAAAAA"
"GL873569","10473375","10473444","chr8","20660648","20660717","21","10187273","TGTAGTCCCAGCACTTTGGGAGGTTAAGGCAAGAGTAGCACCCAACATGAGGAGATCAAGACCAATCTGG","CTGTAGTCCCAGCACTTTGGGAGGCTGAGGCAGGTGGATCCTTTGAGGGCAGAACTTTAAGACCAGCCTG"
"GL873570","9287350","9287485","chr1","29437872","29437991","30","20150522","GGCCGGGCGTGGTGGCGCACGCCTGTAGTCCCAGCGCTATGGGAGGCCGAGGCGGGTGGATCACCTGTGCTCAGAGGTTCGAGACCAGCCAAGACCCCCCTGAGCCAAACGAGCCAGAGTGAGACCCCGTCTCTAC","GGCCGGGCGTGGTGGCTCACGCCTGTAATCCCAACATTTTGGGAGGCCAAGGCGGGTGGATCACCTGAGGTCAGAAGTTCGAGACCAACCTGGCCAACATGGTGAAACCCCTGTCTCTAC"
"GL873571","3669989","3670207","chr4","116777080","116777297","60","113107091","AGACCAGCCTGAGGAAGAGCAAGATCCCATCTCTATTAAAAATAGAAAAATTAGCCAGGCATTCTGGTGGGCACCTGTAGTTCTAACCACCTGGGAGGCTAAGGCAAGAGGAACTCTTCAACCCAAGAGTTTGAGGTTGCTGAGAGCTAGGCTAAGGCTGCAGCACTCTAGCCTGGGCAACAGAGTGAGACTGTTTCTCAAAAACAAAAAACAAAAAAA","CGAGACCAGCCTGGTCAATATGGTGAAACCCCGTCCCTACTAAAAATACAAAAATTAGCCAGGCATGGTGGCAGGCACCTGTAGTCCCAGCTACTCGGAAGGCTGAGGCAGGAGAATCGCTTGAACCACAGAGGCAGAGGTTGCAGTGAGCCGAGACTGCACCACTGCACTCCAGCCTGGGCGACAGAGTGAGACTCAGTCTCAAAAAAAAAAAAAAA"
"GL873571","106134","106236","chr4","18143723","18143826","27","18037589","GGCCAGTCTCAGTGGCTCACACCTGTAATCCAGCATTCTGGGAGGCTGAAGCACACGGTCACCTGAGCTCAAAGGTTGGAGACCAGAGTGAGACCCCACCTCT","GGCCAGGCGCAGTGGCTCACTCCTGTAATCCCAGCACTTTGAGGCTGAGGCAGGCGGATCACCTGAGGTCAGGAGTTTGAGACCAGCCTGGCCGAAACCCCATC"
"GL873571","3670496","3670589","chr7","50468399","50468491","15","46797903","GGGCAGGCATGGTGGCTCACACCTGTAATTCTAGCACTCTTGGAGGCTGAGGCAGGAAAATGGCTTGAGGTCAGGAGTTCAAGACCAGCCTGAG","GGCCAGTCATGGTTGCTCACACCTGTAATACCAGCACTTTGGGAGGCCGAGGCAGGCGAATCACCTGAAGTCAGGAGTTCAAGACCAGCCTGG"
"GL873571","4059090","4059389","chr7","52903696","52903994","88","48844606","GGCCAGGTGCAGTGGTTCACACTTATAATCCTAGCACTCTGGGAGGCCGAGGCGAGTGAAGTGCCTGAGCTCATGGGTTCAAGACCAACCTAAGCCAGAGACCCCTGACTCTTATAATAGCCTGGCATTGTGGTGGGCGCCAATATTTCCAGCTACTCTGAGGCTAAGGCAAGAGAATTGCTTGAGCCCAGGAGTTGGAGGTTTCTGTGAGCACTGACGCCGCAGCTCTCTACCAAGGGCAACAAAGACTCTGTCTCAAAAAATAAATAAATAAATAAATAACAGAATGAAAATGAAAAA","GGCCGGGTGCGGTGGTTCACGCCTGTAATCCCACCACTTTGGGAGGCTGAGGCAGGCAGGTCACCTGAGGTCAGGAGTTCCAGACCAGCCTGGCCAACATGGTGAAACCTTGTCTCGGCTATTAGCCTGGCATGGTGGTGCGTGCCCATAATCCCAGCTACTCAGGAGGCTGAGGCAGGAGAATCGCTTGAACCCAGAAGGTGGAGGTTGCAGTGAGCCAAGATAGCACCACTGCAACTCCAGTCTGGGCAACAGAATGAGACTCTGTCTCAAAAAAAAAAAACAAAAAACAAAAAGAA"
"GL873571","4209418","4209704","chr11","32517699","32517985","80","28308281","GGCTTGGCAAGGTGGCTTACACCTCAAATCCTAGCACTGTGGGAGACTGAGGCAGGTGGATTGTTTGAGCTCAGGAGGTCAAGATAGAGAGCAAGAGCAAGTCTCTGTCTCTACTAAAAATAGAAAAGAACTACTTCCCGGGGGTCATGGCAGTAGCCTGTAATCCCAGTTACTAGGTAGAATGAGGCAAGAGGATCTGTTGAAGCCAAGAGACTGAGGTTGTTATGAGCATGCCACAGCACTCTACCCAGGGTGACAGAATGAGACTCTGTTGAAAGAAAAAAAGA","GGCCGGGTGCAGTGGCTCACACCTGTAATCCCAGCACTTTGGGAGGCTGAGGCGGGTGGATCACCTGAGGTCAGGAGTTCAAGACCAGCCTGACAAACATAGTGAAACCCTGTCTCTACTGAAAATACAAAATTAGCCAGGTGTGGTGGCGCATGCCTGTAATCCCAGCTACTCGGGAGGCTGAGGCAGGAGAATTGCTTGAATCCAGGAGGTGGAGGTTGTGTGATCACACCACTGCACTCCAGCCTGGGCGACAGAGTGAGACTCTGTCTCAAAAAAAAAAGAAA"
"GL873571","4209985","4210154","chr3","175781758","175781928","60","171571773","GAAAGAAATGAAAAGAAAGAAGTTAGCTGGTTGTTGGGGTATGCTTCTATAGTCCCACCTACTCAGAAAGCTGAAATCTGGAGTTTGGGGTTGTTGTAAGGTAGGCTGATGACATAGCACTGTAGCTTGGGCAAGAGAGTGTGACTTTGTCTCAAAAAAAATTAAAACAA","ATTAAAAACACAAAGATTAGCCAGGTGTGATGGCACACAACTGTAATCCCAACTACTCAGGAGAATCGCTTGAACCTGGGAGATAGGGTTTGCAGTGAGCCAAGATTGTGCCACTGCACTCCAGCCTGGGTGACAGAGTGAGACTCTGTCTCCAAAAAAAAAAAAAAAAAA"
"GL873571","4210444","4210570","chr17","16655655","16655789","35","12445211","GCCAGGCAGATGGCTCACACTTCATCCTAGCCCTCTGGAAGGCTGAGGCAGGCTAATTTTTTGAGGTTAGGAGTTTGAGACCAGCCTGAGGAAGAGACCCATCTCTACTTTAAAAAATAAATGGAAA","GCCAGGCATGGTGGCTCACACCTGTAATCCTAGCACTTTGGGAGACTGAGGCGGGTGAATCACCTGAGGTCAGGAGTTTGAGACCAGCCTGACCAGTATGGTGAAACCCAGTCTCTACTAAAAATACAGAAATTA"
"GL873571","4391733","4391878","chr11","33723808","33723943","46","29332075","AACTTAGCTGGGAATGGTGGCTCAAGCCTGTAATCCTAGCACTCTGGGAGGCTCAGGTGGGAGGATCACTTGAGGTTGCTGTGAGCTTGGCTGATGCCAGGACACTCTAGTGTGGGCAAGAGAGTGAGACTCCGCCTCAACAACAA","GCCGGGTGCAGTGGCTCATACCTGTAATCCCAGCACTTTGGGAGGCTGAGGTAGGCGGATCACGAGGTCAGGAGCTGAGATGGCGCCACTGCACCCCAGCCTGGGTGACAGAGCAAGACTCTGTCTCAAAAAAAAA"
"GL873571","6307773","6307841","chr9","62429628","62429694","22","56121855","CTGGGTGTGGTGGCATTGCACCTGTAATCCTAGCTACTTGGAAATCTTAAGCCCAGGAGTTGAAGACTG","CCCAGCATGGTGGTGCATACCTATAATCTCAGCTACTTGGAGGCTTGAGCTCAGAAGTTTGAGACCG"
"GL873571","6496217","6496306","chr1","27257765","27257856","27","20761548","GCAGGGTGTGTTGACCCACACCCACAATTCCAGGACTCTGGGGGGCCAGGGATGGTGGGTTCCCTCAGATCAGGAGCTCCTTACCAGCCT","GACTGGGCATGATGGCTCAAATCTGTAATTCCAGCACTTTGGGAGGCCGAGGTGGGTGGATTGCCTGAGATCAGGAGTTCAAGACCAGCCTG"
"GL873571","6499738","6499903","chr1","38976375","38976555","47","32476637","AAAATAACATGAATTGACTAGGCGAGGTGGCTCACATCTCTAATCCTAGCACTCTGGGAGGCTGAGGCAGGAGAATTGCATGAGGTTGCTGTGAGCTATGATGATACCACGGCATTCTAATCAGGGTGACAGAGTGAGATTCTGTCTTAAAACAAACAAACAAAAA","AAAATAAATAAATTAGCAGGGCCTGGTGGCGCACACCTGTAATCCCAGCTACTTGGGAAGCTGAGGCAGGAGAACCCACTTGAACCTGGGAGCCGGAGGTTGCAGTGAGCTGAGATGGCACCACTGCACTCCAGACTGCGTGACAGAGTGAGACTCCGTCTCAAAAACAAACAAACAAAAA"
"GL873571","11399575","11399872","chr15","109458692","109458994","79","98059117","CAGTGGCTCACACCTGTAAATCTAACACTCTGGGAGGCCAAGGTGGGTGGATCCCTTGAGCTCAGGAATTTGATACCAGCCTGAGCAAGAGTGAGACCTTGTCTCTACTAATAATAGAAAAATAGCCCGTGTTGTGGCACTTGTCCCAACCACTGGGGAGGCTTTAGGCGGGAGGATTACTTGAATTGGGAGTTTGATATTGCTGTGAGCTGGGCTGATGCCTTGGCATTCTAGCTTGGGTAACAGCGTAAGACTCCGTCTCAAATAAATAAATAAATAAATAAAAAGAAAAAAAGAA","GTGGCTCACACCTGTAATCTCAGCACTTTGGGAGACCGAGGCAGGTGGATCACCTGAGGTCGGGAGTTTGAGACCAGCCTGACCAACGTGGAGAAACCCCGTCTCTACTAACAATACAAAATCAGCTGGGCGTGGTGGTGCATGCTTGTAATCCCAGCTACTCGGGAGGCTGAGGTAGGAGAATCGCTTGAACCTGGGAGGTGGAGGTTGCGGTGAGCCGAGATCGAGCCACTGCACTCCAGCCTGGGTGACAGAGCAAGACTCCATCTCAAAAAAAAAAAAAAAAAAAAAAAAAAAAAAAAA"
"GL873572","114760","114841","chr8","26280134","26280211","16","26165374","GGCCAGGCATGGCGGCTCTTCCCTGTAATCCTAGCACTCTGGGAGGGCGAGGCAGGCAGATCACCTAGGCTAGGGTGAGATC","GGCCAGGAATGGTGGCTCATGCCTGTAATCCCAGCACTTTGGGAGGCTGAGGCAGGCAGATCACCTGAGGTCAGGAGT"
"GL873572","9421791","9421892","chr11","8089184","8089269","35","1332607","TACTAAATATATAGCAAGGCCAGGCACAGTGGTTCATGGCTGTAATCCCAGTACTCTGGGAGGCCTAGTCAGAGTTGACCTGAGATCAGGCTAGAAGCCTGG","ATAAAAATAATTGGAGGCCAGGCACGGTGGCTCATGCTTGTAATTCTAGCAATTTGGGAGGCTGACGCGGGTGAGATCATACTGAG"
"GL873572","11052834","11053035","chr14","11857478","11857657","65","804644","TCCACAAAGAAAGCAGAAGTGTGGCCGGGTGGTAGCTCAAGGCAGGAATCCCAGCACTCTGGGAGCTGGGAGGTGGGGGAGGATCCCTTGAGATCAGGAGTTGGAGGGCACAGTGAGCCTGGGGGAGGCCACTGTCTCTGTACTCTAGCAGGGAGACAGAGCAAGACTGCCCATTCAAAGAAAAACAACAAACAAAACAAAA","TACAAAAATTAGCTGGGCACGGTGCCACAAGCCTGTAATCCCAGCTACTCGGGAGGCTGGGCAGGGGAATAGCTTGAACCCAGAGGTGGAGGTTGCAGTGAGCCAAGATCAAGCCACAGCACTCCAGCCTGGGTGACAGAGCAAGACTCCATCTCAAAAAAAAAAAAAAAAAAAAAAAAA"
"GL873573","2564195","2564244","chr1","109985445","109985491","12","107421250","TACAAAAATTAGGCTGGGCTTGGTGGTTCACGCCTATAATCCTAGCACTT","ACTAAAATTAGCTGGGCATGGTGGTGCATGCCTGTAATTCCAGCTAC"
"GL873573","7423371","7423533","chr2","202783328","202783513","56","195359957","GGTGGCTCACACCTGTAATCCCAGCACTCTGGGAGCCCTGGTGGCTCATGTCTATAATCCTAGTACTCTGGGAGACCATGGTGGCTCATGTCTATAATCCTAGTACTCTGGGAGCCATGGTGGCTCACGCCTATAATCCTAGTACTCTGGGAGACCATGGTGG","GGCTGAGGCGCGGGGGCTCACGCCTGTAATCCCAGCACTGTGGGAGGCCGAGGCGGGTGGATCACGCCTGTAATCCCAGCACTGTGGGAGGCCAAGGCGGGTGGATCACGCCTGTAATCCCAGCACTGTGGGAGGCCGAGGCGGGTGGATCACGCCTGTAATCCCAGCACTGTGGGAGGCTGAGGC"
"GL873573","9657648","9657710","chr19","10207852","10207913","10","550204","TAAAAATAAAAAATTTAGCTGGATGTGGTGGCTCACACCTGTAATCCTAGCACTCTGGGAGAC","TAAAAATACAAAATTAGCTGGGTGTGGTGGCACACACCTGTAATCCCAGCTACTCAAGAGGC"
"GL873574","1624662","1624783","chr9","814961","815079","36","809701","GACTGGGTGGGTTGGATCATGCCTGGAATCCTAGCACCCTGGGAGGCCAAGGTGAAAGGATTGCTTGAGGTTAGGAGTTCCAGAAATGTAGCAGTCATGGTGACTTCATCCTTCTCTACCAA","GGCTGGGTGCTTTGATTCATGCCTGTAATCCCAGCACTCTGGGAGGCCGAGGCAGGTGGATCACCTGAGGTTAGGAGTTCGAGACCAGCTTGGCTAACATGGTGAAACCTCGTCTCTAC"
"GL873574","4459477","4459612","chr1","29437872","29437991","29","24978395","GGCCGGGCGTGGTGGCGCACGCCTGTAGTCCCAGCGCTATGGGAGGCCGAGGCGGGTGGATCACCTGAGCTCAGAGGTTCGAGACCAGCCAAGACCCCCCTGAGCCAAACGAGCCAGAGTGAGACCCCGTCTCTAC","GGCCGGGCGTGGTGGCTCACGCCTGTAATCCCAACATTTTGGGAGGCCAAGGCGGGTGGATCACCTGAGGTCAGAAGTTCGAGACCAACCTGGCCAACATGGTGAAACCCCTGTCTCTAC"
"GL873574","4681987","4682216","chr6","153082888","153083127","73","148400901","GGGTGCGGTGGCTCAGACCTATAATCCCAGCACTCTGAGAGGCCGAAGTGGGTGGATCACCTGAGCTCAGGAATTTGAGACCAGCCGTCTCTAAAAATAGCTGAGTGTTGTGGCAGTGGCTGTAAGTCCCAGCTGTTTGGAAAGCTGAAGCAAGGGAATCACTTGAACCCAAGAGTTTGAGGTTGCTGTGATGACAAAGTGAGACTCTATCTCAAAAAAAAAAAAAAAAA","GGCCGTGCGCGGCGGCTCACGCCTGTAATCCCAGCACTTTGGGAGGCTGAGGTGGGTGGATCACCTGAGGTCAGGAGTTTGAGACCAGCCCGACCAGAAATTAGATGGGTGTGGTGGTGCGCTCCTGCAGCCCCAGCTACTTAAGAGGCTGAGGCAGGGTAATCACTTGAACCCGGGAGGCGGAGGTTGCAGTGAGCCGAGCTCACGCCACTGCACTCCAGCCTGGGTAACAGAGCGAGA"
"GL873574","4709916","4710039","chr19","13152422","13152536","46","8442506","AAAAATAGAAAAACTAGCCAAGCATGGTGGTGCACCCCCTATAGTCTGAGCTCCTCAGCGGGCTGAAGCAAAAGGACGGCTGGAGCCCTGGAGTTTGAGGTTGCTGTGAGGCAAGGTGATGCCA","ACACATAAATTAGCCAGACATGATGGTGAGTATCTGTAATTCCAGCTCCTTGGGGGGCTGAGGCGGGAGAATTGCTTGAACCTGGGAGGCAGAGATTGCAGTGAGCCAAGATCGC"
"GL873574","6353839","6353913","chr5","25768079","25768163","22","19414240","AAAAATATAGCAAGGCCAGGCATGGTGGCTCACACCTATAATCCCAGTACTTGGGAGCTGGAATTTGAACCTAGG","AAAAAACTCAAACAAGGCTGGGCGTGGTGGCTCACACCTGTAATCCCAGCACTTTGGGAGGCTGAGGTGGGTGGATCACCTGAGG"
"GL873574","6533061","6533332","chr5","85182161","85182439","81","78649100","GGCTGGGCGAGGTGGCTTACACCTATAATCCTAGTACTCTGGGAGGCCAAGGTGGGTGGATTGCCTGAGCGCACAGTTTCAAGACCAGCTGGAGCCAGAGAGAGAGAGAGAGACCCTGCCTCTAAAAATAGCCAGGCATTGTGGCAGGCACCTGTAGTCCCAGCTACTTGGCAGGCGGAGGTATGAGAATCGCTAGAGGTTGCTGTTAGCTATGATGCCATAGCACTCTACCAAGGGCGACAAAGTGAAACTCTGCCTCAAAAAAAAGAAGA","GCCAGGCGTGGTGACTCAAGCCTGTAATCCTAGCACTTTGGGAGGCCAAGGTGGGCGGATTGCCTGAGCTCAAGAGTTTGAGACCAGCCTGGGCAACACGGTGAAACCCAATCCCTACTAAATACAAAAAAAATTAGCCGGGTGTGGTGGTGTGAACCTGTAGTCCCAGCTACTCGGGAGGCTGAGGCAGGAGAAGGCAGAAGTTGCAGTGAGCCGAGATCACACCACTGCACTCCAGCCTGAGTGACAGAGCAAAACTCTTTCTCAAAAAAAAAAAAA"
"GL873574","6643746","6643907","chr2","92627944","92628105","46","85984198","AAATAGCCAGGCGTTGTGGCAGGCACCTATAGTCCCAGCTACTTGGGAGGCTGAGGCAAGAGAATCACTTAAGCCCAAGTGACAGAGGTTGCCAGGGCACTCTACGTAGGCAACAGAGTGAGACTCTATCTAAGAAAGAAGGAAGGAAGGAAGGAGAAAGAA","TTAGCCGAGCATTGTGGTGCGCGCCTGTAGTCCCAGCTACATGGGAGGCTGAGGCAGGAGAACACCTGAACCCAGGATGTGAGCTGAGTCGCGCCATTGCACTCCAGCCTGGGCAACAGAGTGAGACTCCATCTCAAAAATAAAATAAAATAAAATAAAAAA"
"GL873574","6644163","6644274","chr1","128607504","128607619","20","121963341","CTGTAATCCTAGCACTTGGGAGGCTGAGGCAGGTGGATCACCTGAGTTCAGGAGTTCAAGACCAGCCTAAACAAGAGTGAGACCCTATCTCTACTAAAAATAGAAAAAATAT","GCCTGTAATCCAAGCACTTTGGGAGGCTGAGGCGGGTGGATCACCTGAGGTCAGGTGTTCGAGACCAGCCTGGCCAACGTGGTGAAACCCCAACTCTACTAAAAATACAAAAATTA"
"GL873574","8511822","8512127","chr1","23439759","23440073","84","14927937","GGTGGCTGGTGCCTGTAATCCTAGCACTCTGGGAGACTGAGGCAGGTGGATCACTTGAAATCAGGAGTTTGAGATCAACCTGAGCAAGAGATCTTGTCTCTCCTAAAGATAGAAAAACTAGCTGGGATTTGTGGTGGACACCTGTAATTTCAGCTACTCAGGAAGCTAAGGCAAGAGCATTGCTTAAAACCAGGAGTTTGAAGTTGATGTGAGCTAGGATGTCAGGGCAGGTTACCCAGGGTGACAGAGTGAGACTCTGTGTCAAAATAAACAAACAAACAAACAAACAAAACAAAATAAAATAAA","GGCTGGACATGGTGACTCACGCTTGTAATCCCAACACTTTGGGAGGCTGAAGCAGGCAGATCACCTGAGGTCAGGAGTTTGAGACCAGCCTGACCAACATGGTGAAACCTTGTCTCTACTAAAAATACAAAAATTAGCTGGGAGCAGTGGTGCACACCTGTAATCCCAGCTACTCGGCAAGCTGAGGCAAGATAATTTTTTAAACCTGGGAGGTGGAGGTTGCAGTGAGCCAAGATCGTGCCACTGTACTCCAACCTGGGAGACAGAGCAAGACTCTGTCTCAAAAAAAAAAAAAAAAAAAAAAAAAAAAAAAAA"
"GL873575","2107336","2107519","chr4","38052972","38053149","54","35945636","TCAATTAAAAACTTTTTAAAATGAGGCTGAGCATGGTGGTTCACACCTGTAATCCCAGCACTTTGGGAGGCCGAGGCAGGAGGATCACCTGATCCCAGGAGTCCAAGCCTACAGTGAGCCGTGATAATACCACTGCACTTCAGCCCAAAGCCTCAAAAAGAAAAAAAAAAAAGGATAGACAAGA","TATATATATATATATTATTTTGGGGGGGCATGGTGGTGCACACCTGTAATCCCAGCTACTCGGGAGGCTGAGGCAGGAGAATTGCTTGAGCCCGGGAGGCAAAGGTTGCATTGAGCTGAGATCACACCACTGCACTCCAGCCTGGCGACAGAGTCTCAAAAAAAAGAAAAAATAAAAA"
"GL873575","5831824","5831959","chr1","29437872","29437991","28","23606048","GGCCGGGCGTGGTGGCGCACGCCTGTAGTCCCAGCGCTATGGGAGGCCAAGGCGGGTGGATCACCTGAGCTCAGAGGTTCGAGACCAGCCAAGACCCCCCTGAGCCAAACGAGCCAGAGTGAGACCCCGTCTCTAC","GGCCGGGCGTGGTGGCTCACGCCTGTAATCCCAACATTTTGGGAGGCCAAGGCGGGTGGATCACCTGAGGTCAGAAGTTCGAGACCAACCTGGCCAACATGGTGAAACCCCTGTCTCTAC"
"GL873575","7451097","7451208","chr3","122814630","122814743","22","115363533","GGCCAGGTGTGGTGGCTCACACCTGTTATCCTAGCACTCTGAGAGGCCACAGCAGCTGGATCACTTGAGCTCAGGAGTTCAAGACCAGTCTGAGCAAGAGCAAGACCTCACC","GGCTGGGTGTGGTGGCTCATGCCTGTAATCCCAGCACTTTGAAAGGCCAAGGCAGATGGATCACTTGAGGTCAGGAGTTCCAGACCAGCCTGGCCAACATGGCAAAACCCCATC"
"GL873575","7451277","7451445","chr6","58863249","58863409","41","51411972","AAAAATTCAGCCAGCCACAGTGGAAGTGGATGCCTGCCATCACAGCTACTCTGGGGGCTGGGGCAAGAGAATTGCTTGATCCCAGGAGTCTGAGGTTGCTGTGACCTAGGCTGACACCACAGCACTCTACCCAGGGTGACAGAGTGAGGCTGTGTTTAAAAAAAAAAAA","TTAGCCAGGCATGGTGGCACATGCCAGTAATCCCAGCTACTCAGGAGGATGAGGCAGGAGAATCGCTTGAACCCAGGAGGCAGAGGTTGCAGTGAGCTGAGATTGCGCCACAGCACTCTACCCTGGGTGACAGAAGGAGACTCTGTCTCAAAAAAAAAAAA"
"GL873576","1765109","1765185","chrX","53921180","53921256","12","52156071","GGCCAGGTGCAGTGGCTCATATCTGTAATCCTAGCACCCTGGGAGGCCAAGGTAGGCGAATCACCTGAGGCCAGGAG","GGCCAGGTGCAGTGGCTCACGCCTGTAATCCCAGCACTTTGGGAGGCCGAGGTGGGCGGATCACTTTAGGTCAGGAG"
"GL873576","2711577","2711895","chr7","6620384","6620702","85","3908807","GGTCGAGCTTGGTGGCTCATGCTTGTAATCCTAGCACTCTGGGAGGCCAAGGCAGGTAAGTTGCCCTGAGCTCATAGGTTCCAGATCAGCATGAGCCAGAGTGAGACCCTGTCTCTACCAAAAAATAGCCCGGCATTCTGGCAGGTGCCTGTAATCCCAGCTGCTTGGGAGGCTGAGGCTAGAGAATCACTTAAACCCAAGGGTTAGTGGAGGTTGCTGTGAGCTATGATTCCACCGTACTCTACTGAGGGCCACAAAGTGAGACTCTGTCTCCATAAAAAAGAAAGAAAGAAAGAAAGAAAAATAAAATAAAATAAAA","GGCCAGGCACAGTGGCTCATGTCTGTAATCCCAGCACTTTGGGAGGCCGAGGCGGGTGGATTACCTGAGGTCAGGAGTTCTAGACCAGCCTGGCCAACAAGGCGAAACCCTGTCTCTACTAAAAATACAAAAAATTAGCTGGGCGTTTTGGCACATGCCTGTAATCCCAGCTACTTGGGAGGCTGAGGCAGGAGAATTGCTTGAACTGGGGAAGTGGAGGTTGCAGTGAGCTGAGATCACACCATTGCACGCCTGAGCAACAGAGCGAGACTCTGTCTCAAAAAAAAAAAAAAAAAAAAAAAAGAAAAGAAAAAGAAAA"
"GL873576","4782520","4782652","chr9","61136941","61137074","22","56354421","CCAGGCACGGTGGCTCACCCTTGTAACCCTAGTACTTTGGGAGGCTGAGGTGGGAGGATCCCTTGAGGTCAGGAGTTCAAGACCAGCCTGAACAACAGTGAGACCCCCGTCTCTACTAAAAAATAGAAAAGTT","GCCAGGCACGGTGGCTCACGCCTGTAATCCCAGCACTTTGGGAGGCTGAAGCGGGCGGATCACCTGAGGTCAGGAGTTCAAGACCAGCCTGGGCACCATGATGAAACCCCGTCTCTATTAAAAATACAAAAATT"
"GL873576","4782930","4783078","chr7","57521645","57521803","40","52738715","AGTTAGTCTGGTGTCATGGTGGGTGCCTGTAGTCCCAGCTGCTTGGGAGGCTGAGGCAAGAGAATCACTTGAGCCCAGGAGTTGGAGGTTGCTATGAGCGAGGCTGTAGCCTAGGCAACAGAATGAGACTTTGCCTCAAAAAAATAAAA","TTAGCTGGGCATGGTGGCGCATGCCTGTAGTCCCAGCTACTTGGGAAGCTGAGGCAGGAGAATCACTTGAACCTGGGAGGTGGAGGTTGCAGTGAGCTGAGATCGCACCGCTACACGCCAGCCTGAGCAACAGAGAGAGACTCTGTCTCAAAAGAAAAA"
"GL873576","7828709","7828723","chr5","101042981","101042996","1","93214272","TAAATAAATAAAAAA","TAAATAAATAAATAAA"
"GL873576","7828960","7829230","chr13","49045537","49045844","89","41216577","GCCGGCTGCAGTGGCTATAATCCAAGTACCCTGGGAGGCTTAGGTGGATGGATCACTTGAGCTCAGAAGTTCAAGACCAGCCTCAGCAAGAGGTAGACCTTGCCTCTATTAAANNNNNNNNNNNNNNNNNNNNNNNNNNNNNNNNNNNNNNNNNNNNNNNNNNNNNNNNNNNNNNNNNNNNNNNNNNNNAGTTTGAGGTTGCTGTGAGCTATGATGAAGCCAGGGCATTCTACCCAGGGTGACAGAGTAACTCTTAAAAAAAACTAAACAA","GGCCAGGCAGAGTGGCTCATGCCTGTAATTCCAGCAATTTGGGAGGCCTAGGCAGGCAGATTACCTGAGGTCAGGAGTTTGAGACCAGCCTGGCCAACATGGTGAAACCCCGTCTCTTCTANNNNNNNNNNNNNNNNNNNNNNNNNNNNNNNNNNNNNNNNNNNNNNNNNNNNNNNNNNNNNNNNNNNNNNNNNNNNNNGGAGATAATAGCTTTTGTAGAACGAAGCGATGCAACAGCCAGATCGCCGCCACCACCCTTAGGTCCTGGCGACAGAGTGAGATCCATCTTAAAAAAAAAAAAAAAAAAA"
"GL873576","10622840","10623093","chr7","60266447","60266705","74","49643607","GCTGGGTATGGTGGTTCACACCTATAATCCTAGCACTCTGGGAGGCTGAGGTGGGAGGATTGGTGGAGCTCAGGAGCTCATGAGGTGCCAAATCACTGGTGCCACACACCTGTATTCCCAGCTACTGAGGAGGCTGAGGCAGGAGGATCAGGTAAGCCCAGGAAGTTTGAGGTTGTAGTGAGTTAGGATGATTGAACTCTGCCTTGAGAGACAGAGCAAGATCCTCCTTCCTCCTAAGCAAACAAACAAATAAA","GGCTGGGTGCAGTGGCTCACACCTGTAATCCTAGCACTTTGGGAGGCTGAGGCGGGAAAATTGCCTGAGCTCAGGAGTTCAAGGACAGCCTAGGCAACATAGCATGGTGGTGCACGCCTGTATTCCCTGCTACTTGGGAGGCTGAGGCACAAGAATTGCTTGAATCCGGGAAGTGGAGGTTGCAGTGAGCCATTGTGGCACTGCTCTCCAGTCTGGGTGACAGAGCAAGACTCCATCTCAAAAAAAAAAAAAAAAAAAA"
"GL873576","10819939","10820007","chrX","67133632","67133707","21","56313693","AGGTTGCAGTGAAATTGTACCATTCCAATGAAGCCTGGGGGACAGAGTGAGATTCTCTCAAAATAAAAA","GGAGGTTGCAGTGAACCGAGATCGTGCCACTGCACTCCAGCCTGAGCGACAGAGTGAAACTTCGTCTCAAAAAAAA"
"GL873576","10920306","10920363","chr3","48261745","48261808","16","37341439","GCTGGACCTTGTAGAGAGTGCCTGTAATCCCAGCTACATGGGGGGCAAGAGAATTGCT","GCTGGGCATGGTGGTGCATGCCTGTGATCCCAGCTACTCAGGAGGCTGAGGCAGGAGAATTGCT"
"GL873576","10920398","10920529","chr10","67341428","67341546","30","56421030","GGCCAGGCGTGGTGGCTCACGCCTGTTGTCCCAGCACTGTGGGAGGCCGAGGTGGGTGGATTGCCTGAGCTCAGAGGAGTCCGGAAGACCAGCATGAGGCAGAGTGAGCCAGAGTAAGATCCTGTCTCTACC","GGCTGGGTGTAGTGGCTCATGCCTGTAATCCCAGCACTTTAGGAGGCCAAGGTGGATGGATTGCCTGAGCTCAGGAGTTCGAGACCACCCTGGGCAACAAGCCAAAACCCTGTCTCTAC"
"GL873577","515809","515961","chr7","137660778","137660931","43","137144969","AGCTGGGCATGGTGGCTCATGCCTATAACCCTAGCGTGCTAGGAGATTGCTTGTCAGGAGACTGAGGTTGCAGGAAACTGTGATGATGGCACTGCACTCTACCCAGGGTGACAGAGCAGGACTCTGCCTCAAAAAAAAAAAAAAAAATAGAAA","TTAGCTGGGCATGGTGGCGCATGCCTATAATCCCAGCTACTTGGGAGGCTGAGGCAAGAGAATCGCTTGAACCGGGGAGGCAGAGGTTGCAGACTGCACTCCAGCCTGTGTGACAGAGTGGGACTCCGTCTCAAAAAAAAAAAAAAAAAAAAAA"
"GL873577","1633164","1633256","chrX","38269524","38269615","26","36636360","TCAGCCAGGCATGGTGGCACTTGCCTATAAACCCAGCTCCTTGGGAAGCTGAGCCGGGAGGATCCCTTGCACCCAGGAGCAACGGAAGGCAGT","AATTAGCCAGGCATGGTGGCACATGCCTATAATCCCAGCTACTCAGAAGGTTGAGGCAGGAGAATCACTTGAACCTGGGAGGCAGAGGTTGC"
"GL873577","3979502","3979560","chr20","68909283","68909346","13","64929781","GAGTTTGAGACCAGCCTGAGCAAGACCGAGACCCAGTCTCTACTAAAAATAGAAAAATT","GGAGTTCAAGACCAGCCTGACCAACATGGAGAAACCCTGTCTCTACTAAAAAATACAAAAATTA"
"GL873577","3979839","3980009","chr10","31403126","31403287","39","27423287","ATGAGCAGATTGTCTTGGTGGGCACCTGTAGTCCCAGCTATTGGAGGTGGGAGGCTGAAGCAGGAAAATCTCTTGAGCCCAGGAGTTTGAGGTTGCTGTGAGCTAGGCTGACACCACGGCACTCTAGTCAGGGCGTCAGAGTGAGACTCCGTCTCAAAAAAAAAAAAAAAA","TTAGCTGAGTGTGGTGGCGCACATCTGTACTCCCAGCTATTTGGGAGGCTGAGGCAGGAAAATCGCTTGAACCCAGGAGGTGGAGGTTGCAGTGAGCCAAGATCACACTACTGCACTCCAGCCTGGGTGACAGAGTGAGAATCCATCTCAAAAAAAAGAAAA"
"GL873577","6050882","6051080","chr1","153219820","153220007","59","147168938","GGCTGGGCGTTGTGACTCATGCCTGTAATCCCAGCACTCTAGGAGGCCGAGGTGGGTGGACTGCCTGAACTCAGAGGTTTAAGACCATCCTGAGCCGCAGTGAGCCAGAGCGAGACCCTGTCTCTACCAAAAAAAGCTGGGTGTTGTGGTGGGCGCCTATAGTCCTAGCTACTTGAGGCGCTAAGGGTAAAAAAATTGC","GGCCTGGCACAATGGCTCACGCCTGTAATCCTAGCACTTTGGGAGGCCGGGGTGGGTGGATCACCTGAGATCAGGAGTTTGAGACCAGCCTGGCCAACATGGTGAAACTCCTTCTCTACAAAAATTAGCCAGGTGTGGTGGTGGGTACCTGCAATCCCAGCTATTTGGGAGGCTGAGGCAGGAGAATC"
"GL873577","8463965","8464050","chr9","52134422","52134508","19","43670457","CTGGGTGCTATAGCTCACGCCTATAATCCTAGCACTCTGGGAGTTTGGGGCAAATGGATCACCTAGGCTCAGGAGTTTGATACCAG","GGCTGGGAGCAGTGACTCACGCCTATAATCCCAGCACTTTGGGAGGCTGAGGCAGATGGATCACCTGAAGTCAGGAGTTCGAGACCA"
"GL873577","9471486","9471613","chr16","5178790","5178910","46","4292696","TTAGCCAGGCATAGTAGCCTGTGTGTAGTCCTAGCTACTCAGGAGGCTGAGGTAGATGGGTCACTTGAGGTTGCAGAGATTATGGTAATGTCACTGTACTCTAGCCCTGGCAACAGAGCACAACCCTG","TTAGCCGAGCCTGGTGGCATAAACCTGTAATCCCAGCTACTCAGGAGGCTGAGGCAGGGGAATTGCTTGAACCTGAGAGGAGAAGGTTGCAGTGAGCCGAGATTGCACCATTGCACCCCAG"
"GL873577","9471875","9471998","chr7","17832200","17832315","36","8360325","GGCCAGGTGAAGCAGCTCATGGCTATAATCCTAGCAGTTTGGCAGGCCAAGGTGGGAGGACTGCTTGAGGTCAAGAGTTCAAGACCAACCCATCTTTGCGAAAAATTTAAAAATTACCTAGGCA","GCCAGGAGAGGTGGCTCATGCCTCTAATCCCAGCACTCTGGAAATCCAAGGTGGGTGGATCACCTGAGGTCAGGAATTCCAGACCAGTCTGGCCAATATAAAAAATTAGCCAGGCT"
"GL873577","9853150","9853170","chr3","85044647","85044667","3","75191497","AAACAAACAAACAAAAAAAGA","CAAACAAACAAACAAACAAAA"
"GL873577","9853206","9853473","chr7","130818682","130818963","67","120965476","GCTGGGCGCAGCGTCTCACTCCTGTAATCCCAGCACTTGGGAGGCCAAGGTGAGTGGATTGCCTGAGTTTACAGTTTCGAGACCAGCCTGAGCCAAAGCGAGACCCCCATCTCTAAAAAATAGCTGGGCATTGTGGTGGGCACCTGTAGTCCCAGCTACTTGGGAGGCTGAGGCAAGAGGATCGCTTGAACCTAAGAGTTTGAGGTTGCTGTGAGCTAAGGCTCCATGGCATTCTACCAAGGGTGACTAAGTGAGACTCTGTCTAAAA","GCCGGGCACAGTGGCTCACACCTGTAATCCCAGTACTTTGGGAGGCCAAGGTGGGTGGATCACCTGAGGTCAGGAGTTTGAGACCAGCCTGGCCAACATAGTGAAACTCTACTAAAAATACAAAAAAATAGCTAGGCATGGTGGTGCGCACCTGTAATCCCAGCTACTTGGGAGGCTGAGGCAGGAGAGTTGCTTGAACCCAGCGGGGTTGAGGTTGCAGTGAGTTAAGATCAAGCCACTGTGCTCCAGCCTGGATGACAGAGAGAGACTCCATCTCAAAAA"
"GL873577","10722415","10722478","chr10","12501471","12501539","23","1779056","AATAAAAAAATGCTGGGTACAGTAGTACATGCCTGTACTCTCATCTGGGGAAGCTGAGGCATGA","AAAGTAAAAAATTAGAGCTGGGCATGGTGGCACACACCTGTAATCCCAGTCACTAGGGATGCTGAGGCA"
"GL873578","463331","463568","chr10","28935382","28935620","93","28472051","CAGGTGCTTTGACCCACACCCTCAACTCTAGGACTTTGGACGCCCTGGCTGGGTGGGTCCTTTAAAGTCAGGAGCTTCTTATCAGTCTGGGCAAAAGTGAGACCCCATCTCTACCAAACAAAGAAAGAAATCAGCAGTATGTTGCAGTAGAGACTCACCAATACCTTCTTTCAAAGACCAAAGCTGGAAGGACACTAAAGACCATGATCTCATGGCCTCCCTGAGCCATGACAATGCC","CCAGGTGCAGTGGCTCATGCCTGCAAGCTCAGAACTTTGGGAGGCAGAGGTGAGCAGACTGCCTGAGTTCAGGAGTTCAAGACCAGCTGGGCAACATGGTGAGACCCTATCTCTACTAAAAATACAAATAATTAGCAGGGTGTGGTAGCACACACCTGTAGTCCAGCTACTCAGGAGGCTGAGGCAGGAGAATTGCTTGAACCCAGGAGGCAGAGTTTGCAGTGAGCCAGGACTGGGCC"
"GL873578","1143712","1143827","chr11","52824583","52824692","30","51680871","GGCTGGGTGTGGTGCCTCATGCCTGTAATCTAAGCCCTCTCCGAGGCTGAGGTGGGAGGATCCCTTGAGTTTAGGAGTTTGATTTTGAGACCAGCCTGATCAAGAGAGAGACCTCA","GGCCGGGTGTGGTGGCTCATGTCTGTAATCCCAGCACTTTGGGAGGCTGAGGTGGGTGGATACCCTGAGGTCGGGAGCTCGAGACCAGCCTGACCAACATGGAGAAACCC"
"GL873578","1144101","1144139","chr3","33494224","33494257","11","32350123","GAGAGAGACCTCATGTCTACTAAAATAAATAAATATATA","GTGAAACCCGTCTCTACTAAAAATACAAAAATTA"
"GL873578","1144175","1144343","chr12","119519961","119520131","41","118375786","ATTATCCAGGCCTTCTGGTGGATGCCTGTAGTCCTAGCTACTAGAAAAGCTGGAGCAGAATCACTTGACCCAGGAGCTGGAGGTTGCAGGGAGCTAGGCTGATGCCACAGAATTCTAGCCTGAGGCAAAAGAATTGAGCCACTGTCTCAAAAAGGAACAAAAAAGAAAA","ATTAGCCAGGTGTGGTGGCATGCACTTGTAATCCCAGCTACTAAGAAGGCTGAGGCAGGAGGATCACTTGAACCCGGGAGGTGGAGGTTGCAGTGAGCCAAGATCATGCCACTGCACTCCAGCCTGGGCAACAGAGTAAGACTCTGTCTCAAAAAAAAAAAAAAAAAAAAA"
"GL873578","4593962","4594035","chr16","68825055","68825124","22","64231093","AGCTGGGTACAGTGGCTCACATATAATCCCAGTGACTCAGGAGGCTAAGACAGGAGGATTACTAGGACCTGAGA","GGCTGGGCACAGTGGCTCAGACCTGTAATCTCAGTACTTTGGGTGGCTGAGGCAGGTGGATCACCTGAGG"
"GL873578","6158845","6158972","chr3","500432","500562","24","5658413","GACATGGTGGCTCACACCTGTAATCCTAGCCCTCTGGGAGGCTGAGGCAGGTGGATCACTTGAGTTCAGGAATTCAAGACCAGCTTGAGTGAGAGCAAGACCCTGTCTCTACTAAAAATAGAAAAATT","GCACGGAGGCTCATACCTGTAATCCCAGCACTTTGGGAGGCTGAGGCAGGTGGATCACCTGAGGTCAGGAGTTCCAGACCAGCCTGGCCAACATGGCGAAACCCTGTCTCTACTAAAAATACAAAAAATCT"
"GL873578","6159253","6159444","chr19","34496349","34496541","55","28337096","ATAAAATAAAAATAGAAAAATTAGCCAGGCATTGTGGCAGACATGCGAAGTCTCAGCTACTCCAGAGGCTGAGACAGGAAGATTACTTGAGCCCAAGAATCTTGCTGTGAGCTAAGCTGATGCCATAGCATTGTAACCTAGGCAACAGAGTAAGACTTGGCCTCAAAAATAAAATAAAATAATAAAGTAAAA","TTAGTTAATTAAATTAAACTTAGCTAGGCATAGTGGAACACACCCATAGTCCCAGCTACTCTAGAGGCTGAGGCAGGAGGATTGCTTGAGCCAAGTTGGAGGCTGCAGTGAGCTATGGTGGTGCCACTGCATTCCAGCCTCAGTGACAGAGAGAGACCCTGGCTCAAATAATAATAATAAATAAATAAATAAA"
"GL873578","6766040","6766171","chr2","93098086","93098217","30","86332046","CCAGGCACAGTGGCTCATGCCTATAATCCTAGTAGTCTAGGAGGCTGAGGTGAGTGCATTGCTTGAGCTCAGGAGTTAGATACCAGCCTAACCAAGAATGAGACCCCATCTCTATTAAAAATAGAAAAGTTA","GCCGGGCACAGTGGCTCATGCCTGTAATCCCAGCACTTTGGGAGGCCGAGGCGGGCAAATCACGAGGTCAGGAGTTCAAGACCAGCCTGACCAATATGATGAAACCCCGTCTCTATTAAAAATACAAAAATT"
"GL873578","6766434","6766577","chr9","21128084","21128223","50","14361650","GTTAGCCAGGAGTTGTGGCGGGCACCTACAGTCCTAGCGACTCAGGAGGCTGAAGTAGGCAGAGTTTGATGTGTTGCTGTGAACTACAAGGACACCAATGCACTCTAGGCCGGTAACAGAGTGAGACACTGACTAAAAAAAAAA","TTAGCCAGGTGTGGTGGCACATGCCTGTATTTCCAGCTACTCGGGAGGCTGAGGCAGGAGAATTGCGTGAGCTGAGATCATGCCACTTCATTCCAGTCTGGGTGACAGAGTGAGACTCTGCCTCAAAAAACAAAACAAAA"
"GL873578","7397948","7398119","chr5","40230148","40230319","43","32832200","TAAAAATAGCCATGCATTGTGACAGGCACCTGTAGTCCCAGCTACTCAGGAGGTTGAGGTAAGAGAATCACTTGAACCCAAGAGTTTTGAGGTTGTTATGAGCTAAGACGCCTCGGGACTCTACAAAAGGTAACAAAGTGAGACTCTGTCTCATAAAAAAAGAAAAAAAGAA","AAAATTAGCCAGGCATGGTGACGTACACCTGTAGTCCCAGCTACTCGGGAGGCTAAGGCAAGAGAATCGCTTGAACCCAGGAGGCAGAGGTTGCAGTGAGCTTAGATCACGCTACTGCGCTCCAGCCTGGGTGACGGAGTGAGACGCCATCTCAAAAAAAAAAAAAAAAAAA"
"GL873578","7398378","7398515","chr15","102382935","102383070","35","94984557","GGTCGAGCAAGGTGGCTCACGCCTGTAATCCTAGCACTCTGTGAGGCTGAGGCAGATGGATTGCCTGAGCTCGTGGGTTCGAGACCAGCCTGAGCCAGAGTGAGACCTCATCTCTAAAAATAGCTGGGAAGCTGGGCA","GGCCAGGTGTGGTGGCTCACGCCTGTAATCCTAGCACTTTGGGAGGCTGAGGCGGGTGGATTGCCTGAACTCAGGAGGTCAAGACCAGCCTGGGCAACACAGTAAAACCCCATCTCTACTAAAATACAAAAAATCA"
"GL873579","370235","370429","chr16","38067345","38067552","57","37697110","GCACAGGCCTGAAATCCTAGCACTCTGAAAGGCCAACGGAGGAGAATTTCTGGAGCTCAGGAGTTTGATACCAGCCTAAGCAAATAAAGCTAGACCTCTATCTCTACTAAAATTAGAAAAATTAGGCAGATGTGGTGGTAGGCACCTATAGTCCCAATTACTCCAGAGGCTGAGGCAGAAAGACTCTTGAACCCA","GTCAGGCATGGTGGCTCATGCCTATAATCCTAGCACTTTGGGAGGCCAAGGCCGGTGGATCACCTGAGGTCAGGAGTTTGAGACCAGCCTGGCCAATATGGCAAAACCCCGTCTCTACTAAAAATAAAAAAATTAGCTGGGCACGGTGGTGGGCACCTATAGTCCCAGCTACTCAGGAGGCTGAGGCAGGAGAATTGCTTGAACCCAG"
"GL873579","370936","371046","chr3","3847698","3847802","33","3476762","TGACTCTTGAACCCAGGCACATGAGGTTGCTAAGAGTCTAGGCTGATGTCACGGCACTCTAACCTGGGAAACAGTGTGAGGTTCTGCCTCAATAAATAAATAAATAAATAA","TGGCTTGAACCCAGGAGGCGGAGGTTGCAGTGAGCCGAGATCACGCCACTGCACTCCAGCCTGGGCAACAGAGCGAGACTGTCTCAAAAAAAAAAAAAAAAAAAA"
"GL873579","599436","599605","chr10","38982686","38982853","41","38383250","AAAAAGTCAGACATTGTGGCAGGTGTCTGTAATCCCAGCTATTTGGGAGGCTGAGGCAGGAGTATCATTTGAACCCACGAGTCTGAGGTAACTGTGAGCTAGGCTAACACAACAGCACTCTAGCCTGGGCAATAGAATGAGACTCTATCAAGAAAAGAAATGAAAAGAAA","TATTAGCCTGACACAGTGGCGCGCATCTGTAATCCCAGCTACTTGGGAGGCTGAGGCAGGAGAATCACTTGAACCCAGGAGGCGGAGGTTGCTGTGGGCTGAGATCATGCCACTGCACTCCAGCCTGGGCAACAGAGGGAGGCTCCATCTCAAAAAAAAAAAAAAAAA"
"GL873579","599942","599953","chr3","71473700","71473710","4","70873758","TTTTAAAATAGT","TTTAAAAAAAA"
"GL873579","600232","600365","chr1","16061315","16061447","30","15461083","GGCTAGGCAAGGTGACTCATGTCTGTAATCCTAGTACTCTGGGAGGTTTGAGGCAGGAAGACCACTTTAGCTCAAGAGTTCCAGATCAGCCTGTGCAAGAGTGATACATCATCTCTACTAAAAATCAAAAATTA","GGCTGGGCATGGTGGCTCATGCCTGTAATCCTAGCACTTTGGGAGGTTGAGGCAGGCAGATCACTTGAGGTCAGGAATCTGAGACTAGCCTGGCCAACATGGTGAAACTCCATCTCTACTAAAAAAAAAAAAA"
"GL873579","5650320","5650591","chr6","54938866","54939145","71","49288546","GTCAGGTGTGTTAGCTTACAGTAGTAATCCTAGCACTTTGGGAGGTTGAAGTGGGTGGATTGCTTGAGCTCAGGGGTTCAAGACCAGCCTGAACAAGAGTGGGACCTCATCTCTATTAAAAACAGAAAAACTAGCTGGGTGTTATGGTGGGTGTCTGTAGCCCCAGCTACTCAGGAGGCTGAGGCAGGAGGTTGAGGTTGCTGTGAGCTATTGAGACCACAGCACTCTATCCAGGGCAACAGAGTGAGACCCCTCCCCCCCCCAAAAAAAAA","GGCCAGGTGTGGTGGCTCACGCCTGTAATCCCAACACTTTGGGAGGCCGAGGTGGGTGGATCACCTGAGATCAGGAGTTCAAGACCACCCTGGCCAACATGGTGAAACCCCGTCTCTACTAAAAATACGAAAATTAGCTGAGTGTGGTGGTGCATGCCTGTAGTCCCAGCTACTCAAGAGGCTGAGGCAGGAGGTGGAGGTTGCAGTGAGCCGAGATTGCATCACTGCACTCCAGCCTTGGCGACAGAACGAGAGAGACTCCATCTAAAAAAAAAAAAAA"
"GL873579","7037162","7037347","chr3","37328686","37328893","67","30291524","GAGGTGGGTGGATTGCCTGAGCTCACAGGTTGGAGACCAGCCTGAGCCAGAGCAAGACCTTATCTCAAAAAATAGCCAGGTGTTGTGGCTGGCACCTGTAGTCCCAGCTGCTCAGGAGGCGGAGGCAAGAGAAATGCTTGACCTCAGGAGTTTGAGGTTGCTGTGAGTTCAACTCACACTAATACA","GAGGCAGGGGGATCACCTGAGGTCAGGAGATCGAGACCAGCCTGGCCAACATGGTGAAAACCTGTCTCTACTAAAAATCCAAAAACATTAGCCAGGTGTGGTGGCACGCACCTGTAATCCCAGCTACTTGGGAGGCTGAGGCAGGAGAATCACTTGAACCTGGGAGGCAGAGGTTGTAGCGAGCCGAGATCACACCACTGCACCCCAG"
"GL873579","11077764","11077972","chr19","1200469","1200683","63","9877295","GCCAGGTGCAGTGGCTCATGCCTATAATCCTAGCACCCTAGGAGGCTGAGGAGTTCAAGACCAGCCTAAGCAACTGTGAGACCCCATCTCTACCAAAAATAGAAAAATTAGCTGACTGTTATGGTGTGCACCTACAGTCCTAGCTACTCAGGAGGCTGAGGCAGAAAGAGTCCTTGAACCCAGGAGGCTTTTTTTTGTTGTTGTTGTTG","GGCCAGTCGCGGTAGCTCATGCCTGTAATCCCAGCACTTTGGGAGGCCGAGGCGGGCAGATCACCTGAGACCAGCCTGGCAACATGGTGAAACCCCATGTCTACCCAAACTACAAAAATTAGCTGGGTGTGGTGGTGCACGCCTGTAATCCGAGCTACTCAGCAGGCTGAGGCAGGAGAATCCCTTGAACCTGGGAGGCAGAGGCTGCAGTGAGC"
"GL873579","11078245","11078333","chr19","4926258","4926351","22","6151987","TGAACCCAGGAGTTTGAGTTCGCTGTGAGCTAAGCTGAGGCCACAGCACTCCAGCCTGGGCAACAGAGTGAAAGGAAAAAAATAAAAAA","TGAACCCGGGAGGTGGAGGTTGCAGTGAGCCAAGATCACACCAATGCACTCCAGCCTGGGCAACAAGAGTGAAACTCTGTCTAAAAAAAAAAAA"
"GL873580","320374","320488","chr13","48549305","48549409","42","48228931","GGTAGTGCGTGCCTGCATTCCCAGCTACGGGAGGGCAGGGACTTGAGGCCAGCCTGGGCAAAATAATGAGACCTACTAATGACTCTACTAATACAGAAACAATTAGCTAGGTATG","TGGGAGGCCGAAGTGCGCAGATCACCTGAGGTCAGAAGTTGGAGACCAGCCTGGCCAACATGGTGAAAACCCATCTCTACTAAAAATACAAAAATTAGCTGGGCA"
"GL873580","374969","375091","chr6","147681010","147681135","27","147306041","CGGTGGCTCACACCTATAATCCTAGCATTTTGGAAGGCTGAAGCCGAGGATCTCTGGAAGTCAGAAGTTCAAGACCAGCCTGCCCAAGAGCAAGACCCCATCTCTACTAAAAATAGAAAAACT","GGTGGCTCACACCTGTAATCCCAGCATTTTGGGAGGCTGAGGCAGGCGGATAATCTGAGGTCAAGAATTTGAGACCAGCCTGGCCAACATGGAGAAACCCTATCTCTACTAAAAATACAAAATTAC"
"GL873580","375369","375549","chr7","19977275","19977456","44","19601906","CTAACCAAGTTAGTTAGTTTTAGTTGGCAGGTGCCTGTAGTCCCAGCTCCTTGGGAGGCTGAGGCAAGAGAATGGCTTGAGCCCAGGACTTTGAAGTTGCTGTGAGCTATAATGACACCACAGCACACTACCCAGGGTGACAGAGTGAGACTGTCTCAAAAAAACAAACAAACAAAAAAAA","AACAAACGTTAGCCGAGCATGGTGGTATGTGCCTGTAGTCCCAGCTACTTGGGAGTCTAAGGCAGGAGAATTACTTGAGCCCGGGAGGCAGAGGTTGCTGTGAGCCAAGATCACGCCACTGCACTCCAGCCTGGGTGACAGAGTGAGACTCCATCTCAAAAAAAAAAAAGGAAAAAAAAAAA"
"GL873580","8760922","8761015","chr11","104681322","104681416","19","95920400","GGAGGGAGACACTGCAGTGAACTGCGATCGTGTCTCTGCTTTCCAGGCTGGGTGACAGAGTGAGACTCGGTCTCTAAAATAAAAAATAAATAAA","GGAGACGGAGGTTGCAGTGAGCTGTGATCGCGGCACTGCACTCCAGCCTGGGCAACAGAGTGAGACTCTGTCTCAAAAATAAATAAATAAATAAA"
"GL873580","9391260","9391306","chr14","49279240","49279285","12","39887980","GCCAGTCGAGGTGGCTCACACTTGTGATTCCAGCTACTTGGAAGACT","GGCTGAGATGGTGGCACACACCTGTAATCCCAGCTACTTGGGAGGC"
"GL873581","759283","759365","chr6","46535476","46535542","30","45776193","TAAGAACCTGAAAATAGAGCCAGGCATAGTGGTACATGCGTATAGTCCTGGCTACTCAGGAGGTTGAAACAACAGGATTACTT","CAAAATAGCCAGGCTTGGTGGTGCATGCCTATAATCCAAGCTACTCGGGAAGCTGAGGCAGGAGAAT"
"GL873581","1145844","1145979","chr1","29437872","29437991","29","28292028","GGCCGGGCGTGGTGGCTCACGCCTGTAGTCCCAGCACTATGGGAGGCCGAGGCGGGTGGATCACCTGTGCTCAGAGGTTCGAGACCAGCCAAGACCCCCCTGAGCCAAATGAGCCAGAGTGAGACCCCGTCTCTAC","GGCCGGGCGTGGTGGCTCACGCCTGTAATCCCAACATTTTGGGAGGCCAAGGCGGGTGGATCACCTGAGGTCAGAAGTTCGAGACCAACCTGGCCAACATGGTGAAACCCCTGTCTCTAC"
"GL873581","9628238","9628362","chr5","141044567","141044691","34","131416329","ATCCCAGGTAGTCGGGAGGCTGAGGCAGGAGGATCACTTGAACCCAGGAGGTTGAGGTTGCTGTGAGCAAGGCAGAGGCAACGGCACTCTAGCCACGGGGGCACAGAGACTCTTGTCTTTAAAAA","TAATCTCAGCTACTCGGGAGGCTGAGGCAGGAGAATCGCTTGAGCCCAGAAGGTGGAGGTTGCAGTGAGCCAAGATCGCGCCATTGCACTCCAGCCTGGGCGACAGTGCGAGACTCTGTCTCAAA"
"GL873582","1580485","1580534","chr6","32576760","32576806","12","30996275","CAGCACTTGAGAGGCCAAGGCAGGTGGATCAACTGAGCAAGAATGAGACC","CCAGCACCTTGAGAGGCCAAGGCAGGTGGATCACCTGAGGTCAGGAG"
"GL873582","1644368","1644551","chr1","211626449","211626612","63","209982081","AAAATTTGCCGGGCTCCATAGCTCATGCATGTAATCATAGCACTCTGGGAGGCCAAGATGGGAGGATCTCTCAAGCTCTCTTACTTGGGAGGCTGAGGTTGCTGTGAGTTAGGCTTACGCCACAGCACTCTACTCTAGCGTGAGCAACTCTACTCTTAGTATGAGACTGTCTCAAAAGAAAAAA","AAATTAGCCAGGCGTCGTGGCACATGCCTGTAATCCCAGCTACTCGGGAGGCTGAGGCAGGAGAATAGCTTGATCTCGGGAGGCGGAGGTTGCAGTCAGCCGAGATCACACCACTGCAATCCAGCCTGGACAACAGAATGAGACTCCATCTCAAAAAAAACAAA"
"GL873582","5794385","5794459","chr13","18872784","18872852","27","13078399","ATATTGTTAAGCACAGCCACTATTAAAAATTAAATTATAGGCCAGGCATAGTGGCTCATGCCTGTAATCCTAGCT","TGAAACCACCATCTGGACCAAGATACAAAATGTTGGCTGGGCATGGTGGCTCACACCTGTAATCCTAGC"
"GL873583","102645","102683","chr14","5808766","5808804","14","5706121","GAGCAGATCACCTGAGCTCAGGAGTTTGAGACCAGCCTG","GAGGAATCCCTGTGCTCAGGAAGCTTACATTCTAGTGAG"
"GL873583","6200447","6200560","chr4","17786849","17786963","24","11586402","GGCCAGGAGGGACGGCTCATGCCTGTTATCCTAGCACTATGGGAGACTGAGGTGGGAGGATCACTTGAAGTTAGGAGTTCCAGACCAATCTGACCAAAGTGAGACCTCATCTCT","GGCCAGGCTTGGTGGCTCATGCCTGTAATCTTAGCACTTTGGGAGGCTGAAGTGGGTGGATCACTTGAGGTCAGGAGTTAGAACCAGTCTGGCCAACATGGTGAAACCTCAGCTC"
"GL873583","6200584","6200752","chr6","169626528","169626696","42","163425944","TTAGCTGGATGTGGTAGCACATGCCTATAGTCCCATCTACTCAGGAGGCTGAGACAAGAGAGTTGCTTAAGCCCAGGAGTTTAATTTAACTGTGAACTAGACTGAGACTGTGGCACTCTAGCTGGGGCAACAGAGTGAGACTCTGTCTCAAAAGAAAGCAAGAAAGAAA","TTAGCTGGGTATGGTGTCAGATGCCTGTAGTCCCAGCTACTCAGGAGGCTGAGACAGGAGAATCGTTTGAACCCAGGAGGCCAGAACTGCAGTGAGCTGAGATTCGCACCACTGCGCTCCAGCCTGGGCCAGACAGAGTGAGACTCTATCTCAAAAGAAAAAAAAAAAA"
"GL873583","10217398","10217583","chr3","36257142","36257313","44","26039744","TACTAAAAATAAAGTGTGATAGCCAGGCATGGTGGTGGTGCCTATAGAACCAGGCTATTCAGGAGGCTGAGGCAGAAGGATCACTTGAACCCAGGAGTCTGACGTTGCTGTGAGCTAGGCTGGTGCCATGGTACTCTAGCCTGTGGTAACAGAATGAGACTCTATCTCAAAAATAAAAATAAAAAA","TACAAAATTAGCCAGGCGTGGTGGTGCGTGCCTGTAATCCCAGCTACTTGGGAGGCCGAGGCAGAAGAATGACTTGAACCCAGGAGACAGAGGTTGCAGTGAGCCAAGATCCCACCATTGTACTCCAGCCTGGGCAACACAGTGAGACTCCATCTCAAAAAAAAAAAAAAAA"
"GL873583","10394919","10394983","chr16","12841703","12841771","22","2446784","GAGGTCAGGAAATCAAGATCAGTCTGGGCAATATATTGATACCCTGCCCCTACATAAGGAAGAAA","AGGTCAGGAGTTCAAGACCAGCCTGGCCAATATGTTGAAACCTCATCTCTACTAAAAATACAAAAATTA"
"GL873584","521512","521529","chr1","167402212","167402233","10","166880700","GCATGGAACCCCCCACTC","GGTGAAACCCCATCTTTACTAA"
"GL873584","2079725","2079768","chr15","4338291","4338335","11","2258566","GGCAGGTGGATTACCTGAGTTCAGGAGTTGGAGACCAGCCTGAC","AGGCGGATGGATCACGAGGTCGGGAGTTTGAGACCAGCCTGACCA"
"GL873584","5216877","5217053","chrX","91350057","91350230","49","86133180","CTACTGAAAATGATGACAGAGGCTGGGCATGGGGGCTCCCGCCTGTTATCCTAGCACCCTCGGAGGCTGGGGAATGAGGATTGCTTACGCCCAAGAGTTTGAGGTTGCTGTGAGCTGAGGCCGCTGCACTCTAGCCTGGGCAACAGAGTGAGACTCTGTCTCAAAAAAAAAAAAAAA","TGCAAAAATGAGCTGGGCATGGTGGCACATGCCTGTAATCCCAGCTACACAGGAGGCTGAGGCAGGAGAATCGCTTGAATCTGGGAGGCGGAGGTTGCAGTGAGCTGACATCAGGCCCCTGCACTCTAGCCTGGGCCACAGAGCAAGACTCCGTCTCAAAAAAAAAAAAAAAAA"
"GL873584","7289930","7289950","chr2","51453328","51453345","10","44163398","TGAGGCTCTGTCTCGAAATAA","AATGCCATCTATTAAAAA"
"GL873584","7289975","7290131","chr11","49739997","49740154","37","42450022","CAAGAAAATTAGCTGAGAGTCCTGGTAGGTGCCTGTAATCCCAGCTATTCATGAGGCTGAGGCAGAAGGATCACTTGGGTCCAGGAGTCTGAGGTTGCTGTGAGCTAGTCTGACGCCATAACACGCAAGCCTGGGCAACAGAGTGAGGCTCGGTTTC","CTACAAAAATTAGCTGGGCGTGGTGGCACATGCCTGTAATCCCAGCTACTCGGGAGGCTGAGGCAGGAGAATCACTTGAGCCCAGGAGGCGGAGGTTGCAGTGAGCCAAGATCATGCCATTGCACTCCAACCTGGGCAACAGAGCAAGACTCCATCTC"
"GL873584","7577743","7577867","chr5","48394329","48394446","27","40816586","GGCTGGATGAGGTGGTTCATGCCTGTAATCCTAGCACTCTGGGAGGCCAAGGTGGGTGGATTGCCTGAGCTCAGGAGTTCAAGACCAGCCTGAGCAAGACCCTGTCGCTAAAAATAGCTGGGTGT","GGCTGGGTGCAGTGGCTCATGCCTGTAATCCCAGCACTTTGGGAGGTCAAGGCGGGTGGATCACCTGAGGTCAGGAGTTCAAGACCAGCCTGGCCAACATCTCTACTAAAAATACAAA"
"GL873584","7578135","7578289","chr1","130112713","130112865","31","122534578","GGAGCTGGGTTTTGTGACTGCACCTGTAATCCCAGCTGCTCAGGAGGCTGAGGCAAGAGAATTGCTTGAGCCCAGGAGTTGGAGGTTGCTGTGAGCTGTGATGCCAGGGAACTCTACCAAGGGTGACAAAGTGAAACTCTGTCTCAAAAAAAAAA","TTAGCCAGGTGTGGTGATGCATGCCTGTAATCCCAGCTACTCATGAGGCTGAGGCAGGAGAATTGCTTGAACCTTGGAGCTGGAGGTTGCAGTGAGCTGAGATCAGACCACTCCAACCTGGGTGACAGAGCGAGACTCTGTCTCAAAAAAAAA"
"GL873585","1450952","1451121","chr10","59681079","59681242","48","58230127","TAAAAACAGAAAAAACTAGTCAGGTGGTGTGGTAGGTGCTCATAAGTCCCAGCTGCTTGGGAGACTGAGGCAAGAGAATCACTTGAGCACAAGAGCTTGAGGTGGCTGTGAGCTATAACACCATAGCACTGTACTGAGGGTGACAAAGTAAGACTCTGTCTCAAAAAAAA","TACAAAAATTAGTCAAGGGTGGTGGTATGTGCTTGTAATCCCAGCTATTTGGGAGGCTGAAGCAGGGGAATCCTTGAACCCAGGAGGTGGAGGTTGCAGCGAGCCGAGATCACGTCACTGCACTCTAGCCTGGGCGATAGGGTGAGACTCTGTCTCAAAAAAAA"
"GL873585","1451382","1451515","chr6","17405813","17405948","24","15954431","GGCCCGGCTCGGTGGCTCACACCTATAATCCTAACACTCTGGGAGGCTGAGGCAGGTGGATCACCTGAGCTCAGGAGTTTGAGACCAGCTGAGCAAAAACAAGACCCTATCTCTGCTAAAAATAGAAAAAACTA","GGCCGGGCGGGGTGGCTCACGCCTGTAATCCCAGCACTCTGGGAGGCCAAGGCAGGTGGATCACCTGAGGTCAGGAGTTTGAGACCAGCCTGGCCAACACGCAGAAACCCTATTTCTACTAAAAACACAAAAATTA"
"GL873585","1626960","1627026","chr7","17782729","17782794","22","16155769","AAGATGCCACAGCACTCTACAAGAGTGACCAAGTGAGACTCTGTCTCAAAAAAAAAAAGAAAAGGAA","CAATCGCACTACTGCACTTCAGCCTGGGTGACAGAGTGAGAACCTGTCTCAAAAAAATAAATAAAA"
"GL873585","1627304","1627531","chr11","17033552","17033788","61","15406248","GGCTGGGCACAGTGGCTCACGGCTATAATCTAGGCACTTGGGAGGCTAGGGCAGGTGGATTGCCTGAACTGACAAGTTTGAGACCAACCTGAGCAAGAGCGAGACCCCTGTCTCTAAAACATAGCCAGGCTCTGTGGTGGGCGTCTGTAGTCCCAGCTACTTGGGAGGCTGAGGCAAGAGAATTGCTTGAACTCAAGAGTCTGAGGTTGCTGTGAGTTAAGATGCCAC","GCCCGGCGCAGTGGCTCACGCCTGTAATCCCGGCACTGTGGAGGCCAAGGCAGGCGGATTGCCTAAGCTCAGGGATTCGAGAACAGCCTGGGCAACATGGTGAAACCCCATCTCTACTAAAATACAAAAAACTAGCCGGGCGTGGTGGTATGCGCCTGTAATCCCAGCTACTTGGGAAGCTGAGGCAGGAGAATTGCTTGAACCCGGGAGATGGAGGTTGCAGTGAGCTCAGATCAC"
"GL873585","3626082","3626158","chr1","100916857","100916922","27","97290775","TGCCTGTAATCCCAGCACTTGGGAGGCGGAGGTGGGTAGATTGCCTGACCCAGAGTGGGACCTCATCTCTAAAAGAA","CATGCCTGTAATCCCAGCACCTTGGGAGGCCAAGGTGGGTGGATCACCTGAGGTCAGTAGTTTGAG"
"GL873585","8849829","8849913","chr18","48581945","48582025","18","39732116","GGCTGGACGAGGGGACTCATGCCTGCAATCCCAGCACTGAGAGAGGCCAAGGCAGGTGGATCCCCTGAGCTCAGAAGTTTGAGAC","GCTGGACGCAGTGGCTCACACCTGTAATCCCAGCACTTTGGGAGGCCAAAGCAGGCAGATCTGAGGTCAGGAGTTTGAGAC"
"GL873585","9319890","9319971","chr8","79499361","79499447","14","70179471","GGCCAGGTGTGGTGGCTCACACCTGTCATCCTAGCACTCTGGGAGGACGAGGTGGGTGGACCGCCTGAGTCAGAGTGAGACC","GGCCAGGTGTGGTGGCTCACACCTGTAATCCCAACACTTTGGGAGGCCCAGGTGGGTGGATCACCTGAGGTCAGGAGTTCAAGACCA"
"GL873586","895572","895692","chr17","14501559","14501680","38","13605987","GGCCAGGTGAGGTTTCTCATTCTGGGAGTGAGCCAGCAATTGGGAGGCCAAAGTAAATGGATTGCCTGAGGTTATAGGTTCCAGAACAGCCAGAACAAGATCGAAATCCTGTCTCCAAAAA","GGCCAGGCGTGGTGGCTCATGCGTGTAATCTCAGCACTTTGGAAGGCCGAGGCAGGTGGATCACCCGAGGTCAAGAGTTCAAGACCAGCCTGACCAACATGGCGAGTCTCTGTCTCCACTAA"
"GL873586","5645995","5646150","chr6","58863249","58863409","38","53217254","GGGTATGGTGGCTCATGCCTGTAATCCAAGCACTCTGGGATGGTGAGGCAGGAGAATCCCTTGAACCCAAGAGTCCGAGGTTGCTGCGAGCTAAGCTGATGGCATAACACTCTAGCCTAGGCGACAGAGTGAGACTCTGTTTCCAAAGAGAAAAAA","TTAGCCAGGCATGGTGGCACATGCCAGTAATCCCAGCTACTCAGGAGGATGAGGCAGGAGAATCGCTTGAACCCAGGAGGCAGAGGTTGCAGTGAGCTGAGATTGCGCCACAGCACTCTACCCTGGGTGACAGAAGGAGACTCTGTCTCAAAAAAAAAAAA"
"GL873586","10258686","10258969","chr12","9481260","9481565","81","777426","GGCCGGGCATGGTGGCAGAAATCTAGGAGGCCGAGGCAGGTGGATCGCCTGAGATCACAAGTTCAAGACCAGCCTCAGCTACAGCAAGACCCCATCTCTAAAAATAGCCGGCTGTTGTGGCAGGCGCCTGTAACCCCAGCTACTCGGGAGGCTAAGGCAAGAGAATCGCTTGAGCCCATGAGTCTGAGGTTGCTGCGAGCTGTGACTCCACGGCACTCTACCCGGGGCGATAAAATGAGATTCTGTGTCAAAACAAACAAACAAACAAACAACAACAAAAACAA","GCTGGGCGCGGTGGCTCATGCCTGTAATCCCAGCACTTTGGGAGGCCAAGGCAGGTGGATCACCTGAGGTCAGGAGTTCGAGACCAGCCTAGTCCACATGGTGAAACCCCATCTCTACTAAAAACTAGCCAGGCGTGGTGGTGCGCACCTGTAATCCCAGCTACTCGAGAGGCTGAGGCAGGAGAATCACTTGAGCCTAGGAAGCAGAGGTTGTGGTGAGCTGAGATCACACCACTGCACTCCAGTCTGGGCGACACAGTGAGACTCTTGTCTCAAAAACAAAAAACAAACAAACAAACAAACAAA"
"GL873587","3208032","3208047","chr8","3626746","3626762","2","418714","AAACAACCACAAAAAA","ACAACAACAACAAAAAA"
"GL873587","3208141","3208321","chr19","2057131","2057316","59","1151010","TTTCTTTTAAAAATCACCCATGGGCTGGGTATAGTGGCTCACACCTATAATCCTCGGGAGGCCAAGGTTGGAGGATTGCTTGAATCCAGGAGTTGAAGGTTACAGTGAACTGGGATTTAGCCACTAGACTCTAGCATAGCTGACAAAGCAAGAACCTATTTGTTTAAAACACAAAAAAGAA","TACTAATAATACAAAAATGAGCCGGGTATGGTGGCGGGTGCCTGTAATCCCAGCTACTGAGGAGGCTGAGGCAGGAGACTTGCTTGAACCCAGGAGGTAAAGGTTGCAGTGAGCTGAGATTGCACCACTACACTCCAGCCTGGGCGACAAGAGCAAAACTTTTTCTCCAAAAAAAAAAAAAAAAAA"
"GL873587","3278260","3278367","chr19","19044200","19044312","39","15765940","CAGTCTGAGCAAGAGGGAGAGGCTATTTCTACTAAAAACAGAAAAACTAGCTGGGTGTTGGGGTGTGTTCCTAGTCTCAGTTACTTGGGAGGCTGAAGTAAGAGGATC","ACCAGCCTGGCCAACACGGTGAAATCCCGTCTCTACTAAAAATACAAAAATTACCTAGGCGTGATGGCACGTGCCTGTAGTCCCAGCTACTCATAAGGCAGAGGTGAGAGAAT"
"GL873587","3278673","3278754","chr7","49412503","49412597","28","46133830","GGCCACGAGAGCTAGCTCATGCCTATTCTAGGAGGCCAAAGCAGGCAGACTGCCTGAGCTCAGGAGTTCAAGAGCAGCCTGG","GGCCAGGTGCAGTGGCTCATGCCTGTAATCCGAGCACTTTGAGAGGCCGAGGCAGGCAGATCACCTGAGGTCAGGAGTTCAAGACCAGCCTAGTA"
"GL873587","3782076","3782188","chr9","112128434","112128552","34","108346358","ACTGGGGTGGCTGAGGCAGGAGCGTCACTTGAACTCAGGAGTTTGAGATTGCTGTGAGCTGAGCAGATGTCATGGCACGCTAGCCTAGGTAATAGAGTGAGACTTCGTCTAAA","CAGCTACTCGGGAGGCTGAGGCAGGAGAATCACTTGAACTCGGGAGGCGGAGGTTGCAGTGAGCCGAGATCACGCCATTGCACTCCAGCCTGGGCAACAAGAGCGAAATTCCATCTCAA"
"GL873587","4564996","4565084","chr20","27900350","27900437","14","23335354","GGCGGGGTGTAGTGGCTCATGCCTATTGTCCCAGCACTGTGGGAGGCCGAGGTGGGTGGATCACCTGTGCTCAGAAGTTTGAGACCAGC","GGCCGGGCGTGGTGGCTCATGTCTGTAATCCCAGCACTTTGGGAGGCCGAGGTGGGTGGATCACCTGAGGTCAGGAGTTCAAGACCAG"
"GL873587","6307870","6308175","chr12","112427710","112428020","54","106119840","GGCCAGATATGATGGCTCATGCTTGTAATCCTAGCACTCTGGGAGGCTGAAGTGGGAGGATCACCTGAGATCAGGAGTTCAAGATCACCCTGAGCAAAAGTGAGATCCCATCTCTATTAAAAATAAAAAAATTATCCAGGCATGGTGGTGCAGTCCTTTAGTCCCAGCTACTTGGGAGGCTGAGGCAGGAGAATCTCTTGAACCCAGGAATTAGAGGTTACAGTGAGCTGTGATGATGCTACTGCACTCTAGCAGGATGACAGAGTGAGATACTCCGTGTCAAAAAAAAAAAAAAAAAAAGCAAAA","GGCTGGACATGGTGGTTCATGCTTGTAATCCGAGCACTTTGGGAGGCCAAGGCGGGTGGATCACCTGAGGTTGGGAGTTCGAGACCAGCCTGACCAACATGATGAAACCCCATCTCTACTAAAAATACAAAAAAATTAGCCAGGCATGGTGATGCACGCCTGTAATCCCAGCTACTTGGGAGGCTGAGGCAGGAGAATCACTTGAACCCAGGAGGCAGAGGTTACAGTGAGCCGAGATCATGCCATTGCACTCCAGCCTGGATGACAGAGTGAGCCTCTGTCTCAAAAAAAAAAAAAAAAAAAAAAAAAAA"
"GL873587","6484004","6484128","chr10","67341428","67341546","29","60857424","GACCAGGTTCTGTGGCTCATGCTTGTAATCCTAGCACTCTAGGAGGCCGGAAGAGGGTGGATTGATTGCCTGAGGTCAGGAGTTAGAGACCAGCCTGAGCAAGAGCTAGACCCTGTTTCTTTCTT","GGCTGGGTGTAGTGGCTCATGCCTGTAATCCCAGCACTTTAGGAGGCCAAGGTGGATGGATTGCCTGAGCTCAGGAGTTCGAGACCACCCTGGGCAACAAGCCAAAACCCTGTCTCTAC"
"GL873587","6484407","6484586","chr3","167196537","167196723","48","160712130","TAGACCCTGTTTCTAAAAAAAAAATAGCCAGGTGTTGAGGCAGGTACCTGTAGTCCCAGCTACCTGGGAGGGCTGAGGCAAGAGAATCGCTTGAACCCAAGAGTTTGAGGTTGCTGTGAGCTGAGATGCTATGGCACTCAACCGTGAGCTACAAAGTGAGACTCTGTCTCAAAAAAAAAA","AAAACCTGTCTCTGCTAAAAATACAAAAATTAGCCGGGTGTGGTGATGTGCGCCTGTAGTCCTAGCTACTTGGGAGGCTGAGGCAGGAGAATCACTTGAATCCAGGAGGTGGAGGTTGTAGTGAGTCGAGATCGTGCGACTGCACTCCAGCCTGGGTGACAGCGAGACTCTGTCTCAAAAAAAAAAA"
"GL873587","7466229","7466364","chr1","29437872","29437991","35","21971643","GGCCAGGCGTGGTGGCTCATGCCTGTAGTCCCAGCGCTATGGGAGGCCGAGGTGGGTGGATCACCTGTGCTCAGAGGTTCGAGACCAGCCAAGACCCCCCTGAGCCAAATGAGCCAGAGTGAGATCCCATCTCTAC","GGCCGGGCGTGGTGGCTCACGCCTGTAATCCCAACATTTTGGGAGGCCAAGGCGGGTGGATCACCTGAGGTCAGAAGTTCGAGACCAACCTGGCCAACATGGTGAAACCCCTGTCTCTAC"
"GL873588","1502535","1502718","chr1","34852429","34852590","60","33349894","GGTGCAGTGGCTCACACCTGTTGTCCCAGCGCTGTGGGAGGCCGAGGTGGGTGGATCACCTGTGCTCAGAGGTCGAGACCAGCTGAAGACCTGCCTGAGGCAGAGTGAGCCAGAGTGAGACCCCGTCTCTACTAGAACAACAACAAGACAGCCAGACCTTGTGATCCCAGCTACATGGGGGGCT","GCCAGGTGCAGTGGCTCACACCTGTAATCCCAGCACTTTGGGAGGCCGAGGCGGGCGGATCACCTGAGGTCAGGAGTTTGAGACCAGCTTGACCAACATGGAGAAACCCCGTCTCTACTAAAAATACAAAATTAGCCTGGTGTGGTGTCGCATGCCTGTAAT"
"GL873588","10189037","10189246","chr3","45604681","45604903","65","35415644","GCTGAGATGAGGAGACTCTGTCTCTATTAAAAATAGAAAAATTGGGTGGATGTTGTGGGTACTGTAGTTGCAGCCTCTTGGGGGGCTAAGGCAGGAGGATCAGTTGAAGCCAGGAATTTGCTTTGAGCTAGGCTAAAGCCATGGCACTCTAGCCTGGGCAACAGAGTGAGGCTAGATCTCAAAAAAAGAAAGAAAAGAAAAAGAAAAAAA","CTGGCCAACATGGCAAAACCCCATCTCTACTAAATATACAAAAATTAGCTGGACGTGGTGGCACATACCTGTAATCCCAGCTACTTGGAAGGCTGAGGCAGGAGAATAGCTTGAACCTGGGAGGCAGAGGTTGCAATGAGCTGAGATCACGCCACTGCACTCTAGCCTGGGCAATAGAATGAGACTCTGTCTCAAAAAAAAAAAAAAAAAAAAAGACAAGAAA"
"GL873589","104719","104807","chr20","27900350","27900437","13","27795631","GGCTGGGCGTGGTGGCTCATGCCTGTTGTCCCAGCGCTGTGGGAGGCTGAGGTGGGTGGATCACCTGTGCTCAGAGGTTCGAGACCAGC","GGCCGGGCGTGGTGGCTCATGTCTGTAATCCCAGCACTTTGGGAGGCCGAGGTGGGTGGATCACCTGAGGTCAGGAGTTCAAGACCAG"
"GL873589","796766","796905","chr1","166346372","166346487","49","165549606","GGCTAAGTGTGGTGGCTCACACCTGTCATCTAGTACTTTGGGAGGGTGGGCCTGGGAGTTCAAAGACTGAACTCAGGAGTTCAAGGTGGCTCCGGGGAGGAATTCAAGACCAACCTGAGCCAGAGCGAGACCTCGACTCT","GGCCAGTGGGGTGGCTCACGCCTGTAATCCCAGCACTTTGGGAGGCTGAGGTGGTCAAATGACCTGAGGTCAGGAGTTTGAGACCAACCTGGCCAACATGGTGACACCTCGTCTCT"
"GL873589","1023679","1023690","chr1","205890061","205890072","1","204866382","AAAAAAAAAAAA","ACAAAAAAAAAA"
"GL873589","1023771","1024047","chr4","103012712","103012993","70","101988941","GGCTTGGTGGCTCACACCTGTAATCCTAGCACTCTGGGAGGCCGAAGTGGCTGGAATACTTGAGGTCAGGAGTTCAAGACCAGCCTAAGTGAGAGTGAGATCCCCATCTCTAATAAAAATAGAAAAATTAGCAGGGTGTTGTGGCTGGCACTTGTAGTCCCAGCTACCCAGGAGACCGAGGCAGAAGTTTGAGATTATTGTGAGCGAGGCTGATGCCACAGCATTCTAGTGGGACAACAGAGCAAAATTCTATCTCAAAAGAAAAAAAAAAAAAGGA","CGGGCGTGATGGCTCACGCCTGTAATCCCAACACTTTGGGAAGCCGAGGCGGACGTATCACCTGAGGTCAGGAGTTCAAGACCAGCCTGGCCAACATGGTGAAACCCCGTCTCTACTAAAAATACAAAAATTAGCTGGGTGTGGTGGCATGCGCCTGTAATCCCAGCTACCCAGGAGGCTGAGGCAGGAGAATCGCTGAGGCTGCAGTGAACTGAAATTGTGCCACTGCACTCCAGCCTGGGTGACAGAGCAAGACTCTGTCTCAAAAAAAAAAAAAAAAAA"
"GL873589","4820958","4821024","chr8","33633747","33633811","15","28812789","TTAGTCAAGTGCAGTGGCTCACACCTGTCATCCCAGCTACTTGGGAGGCTGAGGCAGGAGAGTTGCT","TTAGCCAGGTGTGGTGGTGCATGCCTCTAATCCCAGCTACTCAGGAGGCTGAGGCAGGAGAATTG"
"GL873589","6763768","6763857","chrX","25814002","25814092","29","19050234","GGTGTGGTGGCTCACACTTGTATCTTAGCATTTTAGGAGGCTGAATGGGGAGAATTGCTTTAAGTCAGGAGTCTGACTTCCACCTTGCCA","GGCTGGGAATGGTGGCTCACACCTGTAATCCCAGCACTTTGGGAGGCTGAGGTGGGCAGATCACCTGAGGTCAGGAGTTTGAGATCAGCCT"
"GL873589","8444551","8444632","chr9","93194085","93194171","17","84749534","CGGGCATGGTGGCTCACAACTATAATCTTAGCACTTTGGGAGGCTGAGACAGGTGGATGCCTGAACTCAAGAGTTTGAAACC","GGCCGAGCATGGTGGCTCACACCTGTAATCCCAGCACTTTGGGAGGCTGAGGCAGGTGGATTACCTGAGGTCAAGAGTTCAAGACCA"
"GL873589","9085365","9085494","chr2","194063347","194063481","42","184977982","GGCCAGGCACAGTGGCTCACACCTATAATCCCAGCACTCTGTGAGACTGAGGCAGGTGAACTGTTGCAAGAGTGAGACCCTGTGCTTGGTGCCTGTAGCTCAGTGGTTAATAATAAGAAAAAAGAAAAAA","GGCCAGGTGCAGTGGCTCACACCTGTAATCCCAGCACTTTGGGAGTCTGAACCAGGCAGATCACCTGAGGTCAGGAGTTCGAGGCCAGCTCGGCCACCATGGTGAAACCCTGTTTCTAATAAGAATACAAAAAAA"
"GL873589","9085767","9086002","chr7","84631446","84631650","75","75545679","GAGTGAAACCCTGTCTCTACTAAAAATAGAAAAACTAGCTGTGCATCAGGGCGCATAACTGTAGTCCCAGGTACTCAGGACACTGAGGCAAGAGAATTGCTCAAGCCCAAGAGTTTGCAAGAATTTGAGGTTGCTATGAGCTATGATGCCATGGCACTCTACCTAGGGTGACAGACAGAGACTCTGTCCCAAAAAAAAAAAAAGAAGAAGAAGAAAAAAAAAAAGAAAGAAAGAAA","ATAGTGAAACCTCGTCTCTACTAAAAATACAAAAATTAGCTGGGCATCATGGTGCACGCTTGTAATTCCAGCTACTTGGGAGGCTGAGGCAGGAGAATTGCTTGAACTCAGGAGGTGGAGGTTGCAATGAGCCAAGATCGCGCCACTGCACACCAGCCTGGGTGACAAAAGACTCTGTCTCAAAAAAAAAAAAAAAAAAAAAAAA"
"GL873589","9992904","9993045","chr16","56427538","56427666","46","46434634","AACCAGCCAGGCATGGTGATTCACACCTATAATCCCAGCTACTTAGGAGTATGGCTTGAGCACACAGGATACCATACCATTCTAGTCATCCCAGGCAACAGAGGGAAACTCTGTTGGTTAAAAAAAAAGAAAAACTTAAAAA","TTAGCCAGGAGTGGTGGTGCACGCCTATAATCCCAGCTACTTGGGAGGCTGAGGCACAAGAATCACTTGAACCATTGCACTCCAGCCAGGGTGATAGAGGGAGACTCTATCCAAAAAAAAAACAAAAAA"
"GL873589","9993319","9993452","chr3","2774534","2774668","28","7218785","GGCCTGAGCCCTGTGACTCATGCCTGTAATCCCAGCACTGGAAGTTCCAAGGCAGGTGGATCGCTTGAGCTCTGGAGTTCAAGACCAGCTCAACCAAGAGTAAGACCCCATCTCTACTAAAAATAGAAAAACCA","GGCTGGGCACGGTGGCTCATGCCTGTAATCCCAGCACTTTGAGAGGCCGAGGCAGGTGGATCTCCTGAGGTCAGGAGTTCAAGACCAGCCTGGGCAACATGGTGAAACCCCATCTCTACTAAAAATACAAAAAAT"
"GL873590","9044589","9044884","chr1","83754525","83754835","84","74709936","GGCCAGGTGCAATGGCTCATGCCTATAATCCTCACACTCTGGGAGGCTGAGGCAGGAGGATCACTTTTCTCAGGGTCAGGGCCAGCCTGACAAAAGTCAGACCCTGTTTCTACTAAAAATAGAAAAACTAGCTGGGTGTTGTGGCAGATGCCTATAGTCCCAGCTACTAAGAGACTGAGACAAGTGCCCAGAGTCTGAGGTTACTGTGAGCAAAGCTGATGCCATAGCATTCTAGCTATAGATCGAGAGTCTGTCTCAAAAACAAACAAACAAACAAACAAACAAACAAAAAAGAA","GGCTGGGTGTGGTGGCTCATGCCTGTAATCCCAGCACTTTGGGAGGCCGAGGCGGGTGGATCATCTGAGGTCAGGAGTTCAAGACCAGCCTGACCAACATGGTGTAACCCTGTCTCAACTAAAAATACAAAAATTAGCTGGGCGTGGTGGTGTGCACCTATAGTCACAGCTACTTGGGAGGCTGAGACAGGAGAATTGCTTCAACCCAGGAAGTGGAGGTTGCAGTGAGCCAAGATCATGTCACTGCACTGCAGCCTGACAGAGCGAGACTCCATCTAAAACAAACAAACAAAAACAAACAAACAAACAAA"
"GL873591","1831505","1831587","chr17","61702818","61702899","25","59871313","CCCAGCACTTTGGGAGGGCAAGATGGGAGAATCATATAAAGTCAGGAGTTTGAGACCAGTTTGGCAGACATGATGAACCCATC","AATCCCAGCACTTTGGGAGGCTGAGGCAGGCGGATCATCTGAGGTCAGGAGTTCAAGACCAGCCTGGCCAACATGGTGAAAC"
"GL873591","2719175","2719275","chr4","86137755","86137847","32","83418580","GTGGGGGCTTAGGCCTGTAATCCCAGCACTCTGAGAGGCCAAGGTGAGCTGGTCACCTGGGTTTAGGAGTTTGGAGACTTGCTCGAGCTAGACTGAGGCTC","GTGGTGGCTCACGCCTGTAACCCTAACAATTTGGGAGGCCAAGGCAGGTGGATCACTTGAGGTCAGAAGTTTGAGACCAGCCTGGACAATATG"
"GL873591","4732974","4733120","chr19","7991801","7991954","55","3258827","ATACGCAGACTGGCCGAGCGTGGTGTCACATGCCTATAATCCCAGTGGCTACTCTGGGGAGGAGAATCTCTTGAAACCAAGAGTTAGAGATTGCAGTGGGGTATGATACAGGGTAACAAAGAGAGACCTTGGATCTGAAAAGAAAAA","AAAATACAGAAACTAGCTGGGCATGGTGATGCACACCTGTAATCCTAGCTACTGGGGAGGCTGAGGCAGGAGAATTGCTTGAACCCAGGAGTCAGAGGTTGCAGTGAGCAACCAGCCTGGGTGATACAGTGAGTGAGACTCTGTCTCGAAAAAA"
"GL873591","6822728","6823009","chr1","20579766","20580052","72","13757038","GGCCAGGCGTGGTGGCTCATGCCTGTAAATCTCAGCACTCTGGGAAGCTGAGGCAGGTGGATTGCTTGAGGTCAGGAGTTTGAGACCAGCCTGTACCAGAGTAAGACCCTGTCTCTAATAAAAATAGAAAAAAAAAAAAAAACTAGTTGGGCATGGTGATGGGTGCCTGTAGTCCCACCTACTTGGGAGGCTGAGGCAATGGCATCTCTTGAGCCCAAGAGTTTGAGGTTGCTGTGCCATGGCACTCTCCCCAGGGTAACAGAGTGAAAATAAAAAAAAGAA","GGCCAGGCGTGGTGACTCATGCCTGTAATCTCAGCACTTTGGGAGGCCGAGGCAGGTGAATCACCTGAGGTCAGGAGTTTGAGACCAGCCTGACCAACATGGTGAAACCTCGTCTCTACTAAAAATACAAAAAGTAGCCAGGCATGGTGGCGCATGCCTGTAATCCCAGCTACTTGGGAGGCTGAGGCAGGAGAATCGCTTGAACCCGAGAGGCAGAGGTTGCATTGAGTCAAGATGGTACCACTGCACTCCAGCCTGGGTGACAGATTGAGACTCAAAAAAAAAAA"
"GL873591","7578706","7578813","chr16","45055441","45055543","42","37476735","AAATTTAGCTACACATAGTGGCATGAGTCTGTAATGCTAGCCACCCAAAAGGCTGTAGTAAGAGGATTGCTCTATCCCAGGAGTTAAAGACCAGCCCGGACATCAGAG","AATTAGCCGGGCGTGGTGACACACACTTGTAATCCTAGATACTCAGGAGGCGAAGGTAGGAGAATTGCTTGAACCCAGGCAGCAGAGGTTGCAACGAGCAGAG"
"GL873591","9282916","9283004","chr1","20744253","20744338","16","11461337","GGCCAGGCGCGGTGGCTCACCCCTGTTGTCCCAGTTCTGTGGGAGGCCGAGGTGGGTGGATCACCTGTGCTCAGAGGTTTGAGACCAGC","GGCCAGGCACGGTGGCCACGCCTGTAATCCCAGCACTTTGGGAGGCCGAAGTGGGTGGATTACCTGAGGTCAAGAGTTTGAGACCA"
"GL873592","835155","835315","chr16","75654291","75654451","43","74819136","CTGGGTGTGGTGGCTCTTGTCTGCAATCTCAGTACACTGGGAGGCTGAGGCAGAAGGATTGCTCCAGCTCAGGAGTTTGAGGCCAGGCTGAGCTAGTGCAAAACCCCATCTCTACTAAAAAAAGAAGGAAAAAAAAAAGAAAAAGAAAAAAAATACGAGCT","CCAGGTGTGGTGACTCACGCCTGCAATCCCAGCACTCTGGGAGGCTGAGGTGGGTAGATTACCGGAGGTTAGGCGTTTGAGACCAGCCTGGCCAACATGGTGAAACCCCATCGCTACTAAAAAAAAAAAAAAAAAAAAAAAAAAAAAAAAAAAAAAAATTA"
"GL873592","835589","835765","chr1","66836166","66836336","48","66000577","ACAAAAAACCTAGCTTAGGGTTGTTATAGCACCTGTAGTCCCAGCTACTCAGGCGCTAAGGCAGGAAAATCTGCCTGAGCTCAGGAGTTTGAGGTTGCAGTAAGTTATGATGATGCTACTGCACTCTAGCTGGGGCAACAGAGTGAGACTCTGTCTGAGGAAAAACCAAAACCAAAA","TAGCCCAGCACGGTGGCTCACACCTGTAGTCTCAGCTACTCAAGAGGCTGAGGCATGAGAATCGCTTGAACCCAGGAGGTAGAGGTTGCAGTGAGCTGAGATCATGCCACTGCGCTCCAGCCTGGGCAACAGAGTGAGACTCAGTCTCAAAAAACAAAACAAAACAAAAAA"
"GL873592","2520661","2520705","chr16","66853217","66853257","11","64332556","TCTGGGAGGCTGAGGCGGGTGGATCACCTGAGCAAGAGTGAGACC","TTTGGGAGGCTGAGGCAGGTGGATCACTTGAGGTCAGGAGT"
"GL873592","4535248","4535388","chr1","12240468","12240612","38","7705220","GGCGGGATGTGGTGGTTCATGGCTGTAATCCCAGCACTCAGGGAGGCTGAGTCGGGTGGATTGCTTGAGTTCAGGAGTTTGAGACCAACCTGAGCAAGAACTAAGCCTGTCTCTACTAAAGATATTATTTCTTATTTTTCT","GGCCGGGCGCGGTGGCTCATGCCTGTAATCCCAGCACTTTGGGAGGCTGAGGCGGGTGGATCACCTGCGGTCAGGAGTTCGAGACCAGCCTGGCCAACGTGGTGAAACCTCATCTCTACTAAAAATATAAAAATTAGCTGGTGTG"
"GL873592","4535654","4535831","chr8","126054004","126054184","54","121518350","TCTACTACAAATATTAACAGAAAAATTAGCTGGGCATTGTGACAGGTGCCTATAGTCCCAGATACTCAGAAGGCTGAAGTAAGAGGATCACTTGAACCCCAGGAGCTAAGGTGGCTGTGAGCTAGGCTGAGGCTCTAGCCTGGGTAACAGAGTGAGACTGTAAAAAAAGAAAGAGAGA","GTCTCTACTAAAAATACAAAAATTAGCTGGGTGTGGTGGTGCATGCCTGTAATCCCAGCTACTCAGGAGGCTGAGGCAGGAGAATCGCTTGAACCCAGGAGGTAGAGGTTGCAGTGAGCCAAGATCATGCCACTGCACTCCAGCCTGGGTGACAGAGGGAGACTCTGTCTCAATAAATAAA"
"GL873592","6794968","6795049","chr3","154764711","154764794","20","147969743","GAAGGTTTGATGAGCTCAGATGATGCCACTGCAGTCTACCCAGAGTGAAGGAGCGAGACTCTGTCTCAAAAACAAAAAAAGA","CAGAGGTTGGCAGTGAGCTGAGACTGTGCCACTGCACTCCAGCCGGGTGACAGAGTGAGACTCTGTCTCAAATTACAAACAAAA"
"GL873592","6881384","6881478","chr5","24882384","24882475","28","18001000","GGGCAGGCATAGTGACTGGTGTCTCTAATCCTAGCAGTCTGGGATGCTGAGGCAAGTGGAATGTCAGAGTTCAGGAGTTGAAGATCACCCTGACT","GGCCGGGCGCAGTGGCTCACATCTATAATCCTAGCATTTTGGGAGGCTGAGGCAGGCGGATCACCTGAAGTCAGGAGTTTAAGACCAGCCTG"
"GL873592","6881755","6881937","chr10","61601371","61601572","66","54719616","TCACCCTGACCAAGAGCAAGACCCTGTCTCTACTAAAAATAGAATAAACTAGCTGGGAATTGTGGTGGGTGCCAGTAGTCCCCGCTACTGAGGCAGGAGGATCATTGAGTCCAAGAGTTTGAGGTTGCTGTAAGTTAGGACACCACAGCACTCTACACAGAGTAAGACTGCCTCAAAAATAAA","AGTAAAGAAAAGAAACCCTGTCTCTACTAAAAATACAAAAATTAGCTGGGTGTGGTGGTGCGCACCTGTAGTCCCAGCTACTTGGGAGGGTGAGGTATGGGAATCACTTGAACCCGGGAGGTGGAGGTTGCAGTGAGCCAAGATCACACCACTGCACTCCAGCCTGGGTGAGAGAGTGAGACTCTGTCTCAAGAAAAAAGAA"
"GL873592","7006080","7006155","chr1","8947061","8947129","24","1940981","CACACTGAGAGGCAAAGGCTGGTGGATCACCTGAGCTCAAGAGTTTGAGACCAGCCAAGCCAGAGATCTTGTCTCT","CACTTTGGAGCCAGGTAGGTGATCACCTGAGTCAGGAGTTCGAGACAGCCTGGCCAACATGTGAAACCC"
"GL873592","8446508","8446655","chr11","122502739","122502874","48","114056231","TTAGCTGGGTGTTGTGGCAGGCACCTGTAGTCCCTCCCAGCTACTTGAAAGGCTGAGGCAAGATGACAGCTTAAACCCAAGAGTTTAAGGTTACTCTATTCAGGGCAACAGAGTGAGACTCCATCTACATAAATAAATAAATAAATAA","GGCTGGGCGTGGTGGTTCACACCTGTAATCCCAACACTTTGGGAGGCTGAGGCCAGCGGATTGCCTGAGCCCAGGAGTTTGAGACCAACCTGGGCAACATGGTGAAACTCCATCTCTACTAAAATACAAAAAGTTA"
"GL873592","8446953","8447008","chr16","44513352","44513404","15","36066399","GACCAGCCTAAGCAAAAAAGAGATCCTATCTCTACTACTAAAAATAGAAAAAATTA","ACCAGCCTCACCAATATGAAGAAACCCCATCTCTACTAAAAATACAAAATATT"
"GL873592","8447239","8447325","chr1","8062863","8062957","21","384376","GGCCAGGAGCAGTGACTCATGCCTAGCACTCTGGGAGGCCAAAGCAGGTGGATCAACTGAGCTCAGGAGTTCAAGACCAGCCTAAGC","GGCCGGGTGCAGTGGCTCATGCCTGTAGTCCCAGGACTTTGGCAGGCCAAGGCCGGTGGATTACCTGAGGTCAGGAGTTCAAAACCAGCCTAGCC"
"GL873592","8723925","8724000","chr3","42066983","42067054","20","33343058","AATTAGCCGGGCATGGTAGTGTGTGCCCATAATCTCAGCTACTCAGAAAGCTAAGATAGGAAAATTGCTTGAGCTC","TTAGCTGGGTGTGGTAGTGCATGCCTATAATCCCAGCTACTCGGGAGGCTGAGGTGGGAGAACTGCTTGAAC"
"GL873593","384022","384146","chr15","102382935","102383070","28","101998913","GGCCACGAGGGCCCATGCCTGTAATCCTAGCACTCTGGGAGGCTGAGGTGAGTAGATTGCTGAGCTCAGGAGTTCAAGACCAGCCTGTGCAAGAGACCCCATCTCTGCTAAAAATAGAAAAACCA","GGCCAGGTGTGGTGGCTCACGCCTGTAATCCTAGCACTTTGGGAGGCTGAGGCGGGTGGATTGCCTGAACTCAGGAGGTCAAGACCAGCCTGGGCAACACAGTAAAACCCCATCTCTACTAAAATACAAAAAATCA"
"GL873593","384425","384607","chr20","28286874","28287058","50","27902449","GAAAGAAAAGAAAAGAAAAACTAGCAAGATGTTGTAGCTGATGCCTATAATCCTAGCTATTGGAGAGGTGGAGGCAAGAGAATTGCGTGAGCCCAAGAGTTGAAGGTTGCTGTGAGCTGCGATGCCAGAGCACTCCAGGGTGACAGAGTAAGACTCTGTCTCAAAAAAAATTACAAAATAAAA","TAATAAAAATAAAAAAATTAGCCAGGAGTCAAAGCACACGCCTATAACCCCAGCTACTTGGGAGGCTGAGGGAGGAGAATTACTTGAACCCGGGAGGTGAAAGTTGCAATGAGCTGAGATCAAGCCACTGCACTCCAGACTGGATGACAGAGTGAGACTCTGTTTCAAAAAAAAAAAAAAGACAA"
"GL873593","1408445","1408467","chr10","88070368","88070389","9","86661923","AATCTAGAGATGGGGAGAGGTTG","AAAGAGATGGAAGAGAAGAAGA"
"GL873593","4856365","4856484","chr7","56497314","56497433","31","51640949","GCAATCCCAGCTGATCGGGAGGCTGACCCAGAAGAATCCCTTGAACCCAAGAGTCTGAGGTTGCTATGGGTGGATTCTACAGCACTCTAGCCTGGGAGACAGAGTGAGACTCTGTCCCAA","ATCCCAGCTACTTGGGAGGCTGAGACAGAAGAATTGCTTGAACCCGGGAGGTGGAGGTTGCAGTGAGCCAAGATTGTACCACTGCACTCCAGCCTGGCAACAGAGTGAGACTCTGTCTCA"
"GL873593","6661298","6661485","chr10","86749316","86749514","55","80088018","GCAGAGGCTCACATATGTAATCCTAGCACTCTGGGAGGATAAGGCAGGTGGACAGCTTGAGCTCAGGGGTTTGACCAGTCTGATCAAGAGCAAGACCTGTGTCTACTAAAAATAGAAAACCTAGCCAGGTATGATGGTAGATGCCTGTATTCCTAGCTACTCTGGAAGCTAAAGCTAAAGAGTTTGAA","GGTGGCTCACACCTGTAATCTTAGCAATTTGGGAGGCCGAGGTGGGTGGATCACTTGAGGTCAGGAGTTTGAGACCAGACTGGCCAACATGGTGAAACTCTGTCTCTACTAAAAATACAAAAATTAGCCAGTCATGGTGGTGCATGCCTGTAATCCCAGCTACTCAGGAAGCTTAGGCAGGAGAATCACTTGAACCCAG"
"GL873593","6710263","6710446","chr14","4390080","4390244","66","2320183","TTGAAGTCAGGAGTTTAAGGCCAGTCTGGGCAACATAGTGAGACCCCCATCTCTACGAAAATATTTTTTAAAAATTAAAAATAGCTGGGCATAGTGAGGCTGTTGTGAGCTATAACTGCACCACTGCACTCAGCCAAGGACAGAGACCCTGTTCCCTGCCTCAAACAAACCAAAACAAAACAAA","AAGTCTAGAGTTTACAGCCTGGACAACGCAGTGAAACCCTGTCTCTACCAAAAATACAAAAATTAGACAGGTGTGAGAGGCGGAGGTTGCAATGAGCTGAGATCGCAGCACTGCAGTCCAGCCTGGATGACAGAGCGAGACCCCATCTCAAAAACAAAAACAAAA"
"GL873593","7159645","7159716","chr6","178318394","178318465","21","171158749","GATCATGTCACTGCTCTCCAACCTGGGCAATTGAGCAGGAATCTGTCTCAAAAAGAAAAAAAAAAAAGAAAA","CGAGTTCACACCACTGCACCCCAGCCTGGGCAACAGAATGAGACTCGGTTTCAAAAAAAAAAAAAAAAAAAA"
"GL873593","7159841","7160050","chr13","33368171","33368368","69","26208330","GGCCAGGCGTGGTGGCTCACACCTGTTGTCCCAGTGCTGTGGGAAGCCGAGGCAGGTGGATCACCTGAGCTCAGCCGAGTTCGAGACCAGTGGAAGACCAGCATGAGGCAGAGTGAGCCAGAGTGAGACCCCATCTCTACAACAACAACAAGAAGAAAAAAAACAGCCGGACCTTGTGATCCCAGCTACGTGGGGAGCTAGAGAATCACT","GGCTAGGCATGGTGGCTCATGCCAGTAATCCCACCACTTTGGGAGGCCGAGGCAGGTGGATCACCTGAGGTCAGGAGTTCAAGACCAGGCTGGCCAACATGTTATGATGAGACCCTCATCTCTACTACAAATACAAAAATCAGCTGGGCATGGTGGCAAGTGCCTGTAATCCCAGCTACTTGGGAGGCTGAGGCAGAA"
"GL873593","8598292","8598391","chr11","118461023","118461129","33","109862731","AGCCAGGTGAGGTGGTTCACACCTGTAACCCTAGCTGCTTGGGAGGCTGAGGCCTCTCTATCCTGGGCAGTGTGGAGAAACTTTGTTTCAAAAAAAAGAA","GCCGGGCGCGGTGGCTCACGTCTGTAATCCCAGCGCTTTGGGAAGCCGAGGCGGGACTATCCTGGCCAACATGGTGAAACCCCGTCTCTACTAAAAATACAAGAATC"
"GL873594","357249","357377","chr2","75702890","75703011","36","75345641","CCTGGTACCGTAGGTCATGCCTGTAATCCTAGCACTTTGGGATGCTGAGGTGGGCAGATTGCCTGAGCTCACGAGTTCAAGCCATTAGAACTGAGCCTGACCTAGAGTGGGACCTCCAACTCTTTTTTT","GCCAGGCACAGTGGCTCATGCCTGTAATCCCAGCAGTTTGGGAGGCTGAGGTGGGCAGATCACTTGAGGTCAGGAGTTCAAGACCAGCCTGGCTGACATGGTGAAACCCCATCTATACCAAA"
"GL873594","357656","357834","chr7","17608776","17608965","55","17251120","GGGACCTCCAACTCTTAAAATAGCTGGGCATTGTGGTGGGCACCTACAGTCACAGCTACTTGGGAGGCTAAGGCAAGAGACTTGTTTGCAGCCAAGAGTTAGAGGTTGCTGTGAGCTATGAGGCTAGGGCACTCTACAGGGGGCGACAAGTGAGACTGTAAAAAAAAAAAAAGAAAAAA","GTCCCTACTAAAAATACAAAAAATTAGCTGGGCCTGGTGGCAGGCACCTGTAATCCCAGCTACTTGGGAAGCTGAGGCAAGAGAATTGCTTGAACCCAGGAGGCAGAGGTTGCAGTGAGCTGACATCAAGCCACTGTACTCCAGCCTAGGCAACAAGAGCAAGACTCTGTCTCAAAAAAAAAAAAAAAAA"
"GL873594","1410711","1410996","chr5","151340503","151340797","76","149929792","CACAGTGGCTCATACCTATAATCCTAACACTCTGGGAGGCCAAGGTGGGTGGACTGTCTGAGTTTGGGACCAGCCTGAGCAAAAGCAAGACTCCCATCTCTACTAAAAACAAAGACAGCCAGGTATGAGGGCAGGTGCCTATCATCCCAGCTACTTGGGAGGCTGAGGAAGGAGGATCACCTAAGCCCAGGACTTTAAGGTTTCTGTGAACTAAGATGATGTTACAACACTCTAGCCAGGGTAACAAGGCAAGATTCTGTTTCAAAAGACAAAAAAAAAAAAAAAA","GGTGGTTCATGCCTGTAATCCCAGCACTTTGGGAGGCTGAGGCAGGTGGATCACCTGAGGTCAGGAGTTCGGGACCAGCCTGGCCAACATGGGGAAACCCCATCTCTACTAAAATACAAAAATTAGCCAGGTATGGTGGCACATGCCTATAATCCCAGCTACTTGGGAGGCTGAGGCAGGAGAATCACTTGAACCCAGGAGGCTAAGGTTGCAGTGAGCCGAGATTGTGCCACTGTACTCCAGCCTGGGTGACAGACTGAAACTCTGTGTCCAAAAAACAAAACAAAACAAAAAA"
"GL873594","5528090","5528162","chr2","69013639","69013718","24","63485549","GGTACAGTGGCTCACGCTTGTGATCCCAGGTTGAGGTGGGTGGATCGCCTGAGCTCAGGAGTTGGATGCCAGC","GGTGTGGTGCCTCACGCCTATAATCCCAGCACTTTGGGAGGCAGGTGGATCACTTGAGGTCAGGAGTTTGAGAACAGCCT"
"GL873594","5834047","5834168","chr2","82491537","82491662","28","76657490","GGCTGGGCCCAGTAGCTCACGACTGTAATCCCAGCACTCTGGGAAGCTGAGGTGGGCGGATCACCTGAGCTCATAGGTTCGAGACCAGCTCCAGTTAGAGTGAGAGCCTGTCTCTAAAAATA","GGCTGGGCACAGTGGCTCATGCCTGCAATCCCAGCACTTTGGGAGGCTGAGGTGGGCAGATCACCTGAAGTCAGGAGTTCAAGACCAGCCTGGCCAACACAGTGAAACCCCATCTCTACTAAAAAT"
"GL873594","5834396","5834461","chr13","14688151","14688212","20","8853755","TATATAATAATAATAACCAGGTATTGTGGCAGGTGCCTCTAGTCCCAGCTACTCGGGAGGCAAAGG","ATAAAAAAATTAGCTGGCCATGGTGGCACATACCAATAATCCCAGCTACTCAGGAGGCTGAG"
"GL873594","7786130","7786294","chr14","12217087","12217250","37","4430957","GGGTGTGCTGGCTCATACCTATAATCCTAGCACTCTGGGAGGCTGAGGTAGGTGTATTGCTTGAACCCAGGAGTCTGAGGTTGCTGTGCGCTAAGCTGATACCATAGCACTCTAGCCTGGGCAACAGAGTGAGACTCTGTCTCAAAACAAATAAATAGTAAAAAA","GCTGGGCGTGGTGGCTCACACCTGTAATCCCAGCACTTTGGGAGGCCAAGGCATGAGAATTGCTTGAAAACAGGAGGCGGAGGTTGCAGTAAGCTGAGACTGTGCCATTGCACTCCAGCCTGGGCAACAAGAGTGAAACTCTGTCTCAGAAAAAAAGAAAAAAA"
"GL873595","723579","723774","chr19","6045933","6046125","65","5322354","GCCTGAGCAGGAGAGAGACCCCATCTCTGCTGAAAGTGGAAAAGTTGGCTGAGTGTAGTGGCGGGCTGCTGCCCCAGTCACTCAGGAGGCTTAGGAAGGAGTATCGCTTGGGCCCAAGATTTGAGGTTGCTGTGAGCGCTACAAAGACATTAGGGTACTCTACACAGGGGAATAGAGTGAGACTGTCTCAAAAAAA","CAACATGGAGAAACCCCGTCTCTACTAAAAATACAAAATTAGGCAGCGTGGTGGTGGGTGCCTATAATCCCAGCTACTCAGGAGGCTGAGGCAGGAGAATCGCTTGACCGGGAGTGGAGGTTGCGGTGAGCTGAGATTGCACCATTGCACTCCAGCCTGGGCAACAAGAGTGAAACTCCGTCTCAAAAAGAAA"
"GL873595","724114","724204","chr20","18199749","18199840","22","17475635","GGCCATGCTTGGTGGTTCTCATCTGTAATCCTAGCACTCTGGAAGGTCTACAGGGGTGGATGGCTGGAGGTCAGGAGTTCAAGACTGGCCT","GGCCGGGCATGGTGGCTCACACCTGTAATCCCAGCACTTTGGGAGGCTGAGGCAGGCGGATCACCTGAGGTCAGGAGTTCGAGACCGGCCTG"
"GL873595","1065346","1065667","chr18","10529729","10530057","74","9464383","GGCCAGGTGCAGCAGCTCATGCCTGGAATCTTCCTGCTCTGTATGGCCAAGGCAGGTGGATCGCCTGACCTCAGGAGTTCCAGACCAGCCTGAACAAGAGCAAGACTCTGTCTCTACTAAAAGTAGAAAAAAAACTAGCCAGTCATAGTGGCAGGTGCCTGTAGTCCCAGCTGCTTGGGAGGCTGAGGCAAGAGGATCACTTGAACCTAAGAGTTTGAGGTTGCTGTGAGCTAAGATGCCACATCACTCTATCAAGGGTGACCAAGTGAGACTCTGTCTCAAAAATAAATAAATAAATAAATAAAAAGAAAGGCAAAAAGAA","GGCCCGGCGTGGTGGCTCATGCCTATAATCCCAGCCCTTTGGGAGGCCAAGGCAGGTGGATCACCTGAGGTCAGGCGTTCGAGACCAGCCTGACCAACGTGGTGAAACCTCATCTCTACTAAATACAAAAAAAATTTAGCCAGGCATGGAGGCACATGCCTGTAATCCCAGCTACTTGGGAGGCTGTGGCAGGAGAATCACTTGAACCTGGGAGGTGGAAGTTGCAGTGAGCTGAGATTGTACCACTGCACTCCAACCTGGGTGACAAAGCAAGACTCGGTCTCAATAAATAAATAAATAAATAAATAAATAAATAAAGTGAAAAAAAA"
"GL873595","1254878","1255146","chr4","42822326","42822607","67","41567448","GGCTGGGCATGGTGGCTCATGCCTGTAATCCTACCGCTCTGGGAGGCTGAGGCAGAGGATCACTTGAGCTCAGGAGTTTCAGACCAGCCTGCAAGAAGGACCCAGTCTCTGCCGAAAATAGAAAAGTTAGCAAGGCGTTGTCGTGAGCACATGTATCCCAGCTACCTAGAACTCTGAGGCAGGAGGATCCCTTGAACCCACAGAAGTTGCTGTTATCTAAACTGATGCCACTGGACTCTAGCCTGGGCAACAGAGTGAGACTGGTCTCA","GGCCGGGCACGGTGGCTCATGCCTGTAATCCTAGCATTTTGGGAGGCTGAGACAGGCAGATTGCCTGAGCTCAGGAGTTCAAGACCAGCCTGGGCTAGATTGTGAAACCCCATCTCTACTAAAATATAAAAATTAGCTGGGTGTGGTGGCACACGCCTGTAATCCCAGCTACCTGGGAGGCTGAGGCAGGAGAATCGCTTGAACCAGGAGACAGAGGTTGCAGTGAGCTGAGATCACGCCACTGCACTTTAGCCTGGGCAACAGAGTGATACTCTGTCTCAA"
"GL873595","3417105","3417297","chr12","115674238","115674427","44","112257133","GGCCGGGCGCTGTGCCTCACGCCTGTAATCCTAATACTCTGAGAGGCCGAGGCAGGTGGATTGCCTGAGCTCAGGTGCTCAAGACAGCCTGACTGAGCAAGCCCTGAGATCCCATCTCCACTAACAATAGTAAAACTAGCCGGGCATTGTGGTGGTGCTTGTAATCCCAGCTACTGGGAGGCTAAGACAGGAG","CCAGGCCTGGTGGCTCACGCCTGTAATCCCAGCACTTTGGGAGGCCGAGGTGGGTAGATCACCTGAGGTCAGGAGTTCAAGACCAGCCTGGCCAACATGGCGAAACCCCATCTCTACTAAAAATACAAAAATTAGCTGGGCATGGTGGTGTATGCCTGTAATCCCAGCTACTCGGGAGGCTGAGGCAGGA"
"GL873595","6098380","6098457","chr3","87492619","87492702","21","81394239","GCTGTGGCTCATGCTGATAATACCAGCACTCTGGGAGAACAAGGTAGGCAGATCACAAGAGGTCACCTGTGCAAGACC","GGGCTGGTGGTGGCTCATGCCTGTAATACCAGCACTTTGGGAGGCCAAGACAGGTGGATCACCAAAGGTCAAGAGTTCAAGACC"
"GL873596","134190","134307","chr1","203207333","203207443","31","203073143","GGCTGGGCGAGGTGGCTCACACCTGTAATCCTAGCACTCTGGAAGGCCCTAGCACTCAGGCAGTTGGATTGCCTGAGCTCACAAGTTCAAGACCAGCCTGAAAAAGAGCAAGACCTCA","GGCTGGGTGCAGTGGCTCACACCTGTAATCCCAGCACTTTGGGAGGCCGAGATGGGTGGATCACTTGAGGTCAAGAGTTGAAGACCAGCCTGGACAACATGATGAGACCCC"
"GL873596","134578","134681","chr11","50235285","50235387","37","50100707","CAAACAAAAGAGGAAGACCTCGTCTCTAAAAAAATAGCTGGGCATTGTGAGGAGTACCTGTAGTCCTAGCTACTCAGAAGGCTGAGACAAGAGAATCACTTAAA","CAACATTGTGAAACCCTGTCTCTACTAAAATAGAAAATTAGCCAGGTGTGTGGGCGTGCCTATAATCCTAGCTACTGGGGAGGGTGAGGCATGAGAATCGCCT"
"GL873596","8160215","8160350","chr1","29437872","29437991","30","21277657","GGCCGGGCGTGGTGGCGCACACCTGTAGTCCCAGCGCTATGGGAGGCCGAGGCGGGTGGATCACCTGAGCTCAGAGGTTCGAGACCAGCCAAGACCCCCCTGAGCCAAACGAGCCAGAGTGAGACCCCGTCTCTAC","GGCCGGGCGTGGTGGCTCACGCCTGTAATCCCAACATTTTGGGAGGCCAAGGCGGGTGGATCACCTGAGGTCAGAAGTTCGAGACCAACCTGGCCAACATGGTGAAACCCCTGTCTCTAC"
"GL873596","8421071","8421132","chr20","1874027","1874093","12","6547044","GTCAGGCGCAGTGGCTCACGCCTGTAATCTCAGCACTCTGAGAAGCCAAGGCAGGATCATCT","GGCCAGGCGCAGTGGCTCAGGCCTGTAATCCCAGCACTTTGGGAAGCCAAGGTGAGCAGATCACCTG"
"GL873598","4416400","4416489","chr5","39418145","39418231","15","35001745","GGCCAAGTGTGGTGGCTCATGCCTGTTGTCCCAGCACCGTGGGAGGCCGAGGCTGGTGGAACACCTGAGCTCAGCTGAGTTTGAGACCAG","GGCCAGTTGCGGTGGCTCATGCCTGTAATCCCAGCACTTTGGCAGGCTGAGGCAGGTGGATCACCTGAGGTCAGGAGTTTGAGACCA"
"GL873598","4416855","4416947","chr3","94091253","94091337","31","89674398","GTGAGACCCTGTCTCTACAAAAAAAAAAGCTGGGCACTGTGGCATGTGCCTGTAATCCCAGCTACTTGGGAGGCAAAGGGAAAGAGAATCACT","AAACCTTGCCTTTACTAGAAATACAAAAATTAGCTGGGCATGGTGGCAGGTACCTGTAATCCCAGCTACTTGGGAGGCTGAGGCA"
"GL873598","5126074","5126161","chr1","12339306","12339394","19","7213232","GCCTGGTGCACTGGTTCACACCTGGAATCCTTGCATTCTGAGAGGCCCAGGTAGGCAGATCACCTCAGCTCAGAAGTTCGAGACCAGC","GCTGGGTGCGGTGGTTCACGTCTGTAATCCCAGCACTTTGGGAGGCCGAGGCGGGCAGATCACCTGAGGTCAGGAGTTCGAGACCAGCC"
"GL873598","5467584","5467662","chr1","9313328","9313403","17","3845744","GCGAGGTGGCTCACGCCTGTAATCCCAGCACATTTGGAAGGCCAAGGAGGGTGGATCACCCGAGCTCACCAGTTGGAGA","CGCAGTGGCTCACGCCTGTAATCCCAGCACTTTGGGAGGCCGAGGCAGGCAGATCACCTGAAGTCAGGAGTTTGAG"
"GL873598","6917752","6917856","chr14","9558287","9558382","22","2640535","GGCCAGGCATGGTGGCTTGTGCCTGTTGTCCCAGCACTGTGGAAGGCCGAGGCGGGTGGATCGCCTGAGCTCAGCTGAATTCGAGACCAGCATAAGACCAGTATG","GGCCAGGCATGGTGGCTTATGCCTGTAATCCCAGCACCTTGGAAGGCCGAAGCGGGCAGATCACCTGAGCTCAGGAGTTTGAGACCAGCCTGTCCA"
"GL873598","8078910","8079062","chr7","164825511","164825660","43","156746601","AACAGCCAGGCATTGTGGTGGGCACCTGTAATCCCAGCTACTTGGGAGGCTGAGGCAAGAGAATTGCTTGAGCCCAACAGTCTCAGGTTACTGTGAGTTATGACACCATGGCACTCTATTGAGGGCAAGAAAGTGAGACTGTCTTGGAAAAAA","CTAGCCAGGCATGGTGGTGCGCACCTGTAGTCCCAGTTACTTGGGAGGTTGAGGCAAGAGAATTGCTTGAGCCTGGAAGGCAGAAGTTGCAGTGAGCTGAGATCACACCACTGCATTCCAGCCTGGGCGAAAGAGCAAGACTCTGTTGAA"
"GL873598","8079328","8079454","chr6","10381248","10381379","32","2301920","GCCCGGCGTGGTGGCTCACGCCTGTAATTCCAGCACTCTGGGGAGGCCGAGGAGGGCAGATTGCCTGAGCTCACAGGTTTGAGCTAGAGCGAGACCCTGTCTCTTAAAAAGAAAAAAAAGGAAAGAA","GCTGGGCGCGGTGGCTCACGCCTGTAATCCCAACACTTTGGGAGGCCGAGGCGGGCAGATCACCAGAGGTGATCTCCAGCCTGGGCAGGAGAGCAAGACCCTGTCTCAAAAAATTTAGAAAAAGGAAAGAAA"
"GL873599","3943256","3943456","chr9","35892110","35892312","79","31948854","GGCAGGCTGCTTTGACCCATATCTACAACTCCAGAACTTTAGAGGCTGAGCTGGGTGGGTCCCTTGAGATTAGAAACTGCTTAGTAGCCTGGCAAAAACCAGACCCCACCTCCACCATGTAGAAAAATTAGCAGTATGCCATAGTGGGAACCTACCAATACAGTCTTTCCAAAGGCCAAAGCTAGAAGGACCGTGAGCTTG","GGCTGGGTGTGGTGGCTCATGCCTATAATTCCAGCACTTTGGGAGGCCGAGGCAGGTGGATCACCTGAGGCCAGGAGTTTGAGACCAGCCTGGCCAATATGGTGAAACCCCATCTCTACTAAAAGTACAGAAAATTAGTCAGTCATGATGGCGCATGCCTATAATCCCAGTTACTCGGGAGGCTAAGGTAGGAGAATTGCTTG"
"GL873599","6693284","6693349","chr1","100916857","100916922","15","94223573","TCACGTCTATAATCCTAGCACTCTGGGAGTCCTTGGCAGGTGGATCACCTGAGCTCAGGAGTTTGA","CATGCCTGTAATCCCAGCACCTTGGGAGGCCAAGGTGGGTGGATCACCTGAGGTCAGTAGTTTGAG"
"GL873600","991618","991705","chr15","13850109","13850195","15","12858491","GGCTGGGCGTGGTGGCTCACACCTGTTGTCCCAGCGCTGTGGGAGGCTGAGGCAGGTGGATCACCTGTGCTCAGAGGTTGAGACCAGC","GCCGGGCGCTGTGGCTCACACTTGTAATCCCAGCACTTTGGGAGGCTGAGGCAGGTGGATCACCTGAGGTCAGGAGTTAGAGACCAG"
"GL873600","8825981","8826014","chr16","43605817","43605844","11","34779836","AGTCTGGGGCAACAGAGCAAGACTCTGTCTCAAA","CAGTCTGGGTGACAGAGCAAGATTCCAT"
"GL873600","8826039","8826157","chr13","87428402","87428520","35","78602363","ATTAGCCTGGTGTGGTGGTATATGCCTTCCTGCCTGCTTGGGAGGCTGAGGCAGGAAGTATGCTTTAACTGTGGAGTCTGAGGTTGCTATGAGCTAGGTTGAGGCCATGGCACTCTAAA","TTAGCCGGGTGTGGTGGTGCACGCCTGTAATCCCAGCTACTCAGGAGGCTGAAGCAGGAGAGTTGCTTGAACCCAGGAGTTGGAGGTTGCAGTGAGCTGAGATCACGCCATTGCACTCC"
"GL873601","269289","269338","chr14","49279240","49279285","14","49009951","GACTGGGTGTGGTGGCTCACACCTTTAATCCTAACACCCTGGGAGGCTTA","GGCTGAGATGGTGGCACACACCTGTAATCCCAGCTACTTGGGAGGC"
"GL873601","269431","269678","chr1","184453273","184453521","76","184183842","AGAAGATCACTCAAGATCAGGAGTTTGAGAACAGCCTGAGCAAGACCCCCATCTTTACTAAAAATGGAAAAGTTTTTACCCAGGCATGGTAGTGCGTGCCTGTATCCCATCTACTCCGGAGGCTGATAGGAGGATTGCTTCAACCAAGGAGTTTGAGGTTCCAGAGACTTAAGATGACACAACTGCATTTTACCCAGTGTGACACAGCGAGACTCTTTCAGAAGAATTTTTAAAAGGAAAAAAAAGAA","GGTCAGATCACCTGAGGTCAGGAGTTTGAGACCAGCCTGACCAACATGGTAAAACCCCATCTCTGCTAAAAATACAAAAAATTAGCCAGGCATGGTGGTGAACGCCTGTAATCCTAGCTACTCAGGAGGCAAAGACAGGAGAATCGCTTGAATCTGGAAGGTGGAGGTTGCAATGAGCCAAGATGACGCCACTGCACTCCAACCTGGGTGACAGAGGAAGACTCCATCAAAAAAAAAAAAAAAAAAAAA"
"GL873601","1397978","1398117","chr16","24839455","24839591","34","23441477","GCCTATAATCCTAGCACTCTGGAAGGCTGAGGCAGGAAGATCACTAGAGCTTGGGAGTTTGAGATTGCTGTGAGGGAGACTGACTCCATGGCACTCTAGCCTGAGGCAACAGAGTAAGACTCCATCTCAAAAAAAAAAAA","CTCTAACTCCAGCTACTCAGGAGGCTGAAGCAGGAAAATCACTTGAACCTGGGAGGTGGAGGTTACAGTGAGCCAAGATCACACCATTGCACTCCAGCCTGAGCGACAGAGCGAGACTCTGTCTCAAAATAAATAAA"
"GL873601","4065502","4065590","chr11","108711352","108711444","19","104645850","GCTGGATGTGGTGGCTCTCACCTATAATCCTAGCACTCTGGGAGGTCAAAACAGGTGGATCACCTGAGCTCAGGAGCAAGAACACCAGC","GTCAGGGGTGGTGGCTCACGCCTGTAATCCCAGCACTTTGGGAGGCCAAGGCAGGTGGATCGCCTGAGCTCAGGAGTTCAAGACCAGCCTTGC"
"GL873601","8241370","8241465","chrY","9469734","9469829","34","1228364","AAAAAAGGTGGAGATGAGCCATGCGCAGTGGTGTAGGCCTGTAATCCCAGCCCTTGGGAGGCCAAAATGGTGGATTGCCTGAAGCAGAGCAAGACC","AAAGTACAAAGAGTCTGGGTACAGTGGCCCAAGCCTGTAATCCCAGCAGTTTGGGAGGACAAGATGGGTAGATCACCTGACATCATGAATTAGAGA"
"GL873569","7519122","7519191","chrX","79016364","79016431","16","71497242","TTGGCCAGGCATGGTCGCTCAGGCTGTAATACCAGCTACTTGGGAAGCTGAAGCAGGAGGATCACTTGAA","TTGGCCAGGCACGGTGGCTCATGCTTATAATCCCAGCTACTCGTGAGGCTGAGGCAGGGGAATCGCTT"
"GL873569","7989158","7989286","chr8","41505677","41505810","35","33516519","AGTCCCACCTATTTGGAAGGCTGAGGCAAGAGGATCACTTGAACTCAGCAGTTTGACATTGCTATGAGTTAGATTGACTCCATGGCACTCTAGCCCAGGCAACAGAGCAAGACTCCGTCTCAAAACAAA","TAATACCAGCTACGTGGGAGGCTGAGGCAGGAGAATCACTTGAACCCGGGAGGTGGAGGTTGCAGTGAGCTGAGATTGCACCGTTGCACTCTAACCTGGGCAACAAAAGCAAAACTCTGTCTCAAAAAAAAAAA"
"GL873569","7989575","7989702","chr1","62231025","62231129","47","54241450","GGCTGGGTAATGCAGTGGCTCACGCCTATAATCCTAGTGCTTTGAGAGGCCAAGAGTGAGACTCTGTGTACTAAAAATAGAAAAATTACCTAGGCATTCTGGTGGGCACCAGTAGTCCCACCTATTTG","GGCTGGGCATGGTGGCTCACGCCTATAATCCCAGCACTTTGGGAGGCCGAGGCAGGTGGATCACCTGAGATCAGGAGTTTGAGACCAGACTGGCCAACATGGTGA"
"GL873569","10034363","10034556","chr10","61268396","61268605","62","51234033","CAGCTTGAGCAAAAGTGAGCCCCTGTCTCTACTGAAAATAGAAAAAATTAGCCAGGCGTGGTGGCACACACTTATAGTCCCAGCCACTTAGGAGGCTGAGGCAGGAGTTTGAGGTTGACATAATCTAAGCTGATACCATAGCACTCTAGCCTGGGCAATAGAGTGAGACTCTGTCTCAAAGAAGAAATTTATCT","CCTGACCAATGGTGAAACCCTGTCTCTACCAAAAATACAAAATTTAGCTGGGCATGGGGGCACGCACCTGTAGTCCTAGCTACTCGGGAGGCTGAGACAGGAGAACTGCTTGAACTCGGGAGGCAGAGGTTGCAGTGAGCTGAGATCATGCCACTGCACTCTAGCCTGGGCAATAGAGTGAGACTCCGTCTCAAAAAAAAAAAAAAAAAA"
"GL873569","10034830","10034845","chr1","217667782","217667796","2","207632952","AAAAAAGAAGAAAAAA","AAGAAAAAGAAAAAA"
"GL873569","10203815","10203922","chr8","96374555","96374671","35","86170740","GCCAGGTGTAGTGGTTCACACCTATAATCCTAGCACTCTGGGAGCCTGAAGCAGGTAAATGGACTGAGCAAGAGTGAGACTTCCACCTCTATTGAAAATAGAAAAATT","GGCTAGGTATGGTGGCTGATGCCTATAATCCCAGAATTTTGGGAGGCCGAGGCAGGCAGATCATCTGAGGTCAGGAGTTTGAGACCAGTCCCGTCTCTACTAAAAATACAAAAATTA"
"GL873569","10204196","10204373","chr20","1304385","1304559","47","8899811","GAAAATAGAAAAATTAGCCAGGCATTATAGCAGGCACCAGTAATCCCAGTTACTTGGGAGGCTAAGGCAAAAGAATCTCTTGAGCCCAAGTTTGGGGTTGCTAGGAAGTAAAACACCACAGCACTATACCCAGAACAAGAGAGTGAAGACTCAGTCTCAAAAAGATAAATAAATAAAA","AAAAATACAAAAATTAGCCAGGCATGGTGGCGGGCGTCTGTAACTCCAGCTACTTGGGAGACTGAGGCAGGAGAATCGCTTGAACCCAGGAGGCAGAGGTTACAGGTGAAATCACACCACTGCACTCCAGCCTGGGCAACAGGGCAAGACTCTGTCTCAAAAAAAAAAAAAAAAA"
"GL873569","10473375","10473444","chr8","20660648","20660717","21","10187273","TGTAGTCCCAGCACTTTGGGAGGTTAAGGCAAGAGTAGCACCCAACATGAGGAGATCAAGACCAATCTGG","CTGTAGTCCCAGCACTTTGGGAGGCTGAGGCAGGTGGATCCTTTGAGGGCAGAACTTTAAGACCAGCCTG"
"GL873570","9287350","9287485","chr1","29437872","29437991","30","20150522","GGCCGGGCGTGGTGGCGCACGCCTGTAGTCCCAGCGCTATGGGAGGCCGAGGCGGGTGGATCACCTGTGCTCAGAGGTTCGAGACCAGCCAAGACCCCCCTGAGCCAAACGAGCCAGAGTGAGACCCCGTCTCTAC","GGCCGGGCGTGGTGGCTCACGCCTGTAATCCCAACATTTTGGGAGGCCAAGGCGGGTGGATCACCTGAGGTCAGAAGTTCGAGACCAACCTGGCCAACATGGTGAAACCCCTGTCTCTAC"
"GL873571","3669989","3670207","chr4","116777080","116777297","60","113107091","AGACCAGCCTGAGGAAGAGCAAGATCCCATCTCTATTAAAAATAGAAAAATTAGCCAGGCATTCTGGTGGGCACCTGTAGTTCTAACCACCTGGGAGGCTAAGGCAAGAGGAACTCTTCAACCCAAGAGTTTGAGGTTGCTGAGAGCTAGGCTAAGGCTGCAGCACTCTAGCCTGGGCAACAGAGTGAGACTGTTTCTCAAAAACAAAAAACAAAAAAA","CGAGACCAGCCTGGTCAATATGGTGAAACCCCGTCCCTACTAAAAATACAAAAATTAGCCAGGCATGGTGGCAGGCACCTGTAGTCCCAGCTACTCGGAAGGCTGAGGCAGGAGAATCGCTTGAACCACAGAGGCAGAGGTTGCAGTGAGCCGAGACTGCACCACTGCACTCCAGCCTGGGCGACAGAGTGAGACTCAGTCTCAAAAAAAAAAAAAAA"
"GL873571","106134","106236","chr4","18143723","18143826","27","18037589","GGCCAGTCTCAGTGGCTCACACCTGTAATCCAGCATTCTGGGAGGCTGAAGCACACGGTCACCTGAGCTCAAAGGTTGGAGACCAGAGTGAGACCCCACCTCT","GGCCAGGCGCAGTGGCTCACTCCTGTAATCCCAGCACTTTGAGGCTGAGGCAGGCGGATCACCTGAGGTCAGGAGTTTGAGACCAGCCTGGCCGAAACCCCATC"
"GL873571","3670496","3670589","chr7","50468399","50468491","15","46797903","GGGCAGGCATGGTGGCTCACACCTGTAATTCTAGCACTCTTGGAGGCTGAGGCAGGAAAATGGCTTGAGGTCAGGAGTTCAAGACCAGCCTGAG","GGCCAGTCATGGTTGCTCACACCTGTAATACCAGCACTTTGGGAGGCCGAGGCAGGCGAATCACCTGAAGTCAGGAGTTCAAGACCAGCCTGG"
"GL873571","4059090","4059389","chr7","52903696","52903994","88","48844606","GGCCAGGTGCAGTGGTTCACACTTATAATCCTAGCACTCTGGGAGGCCGAGGCGAGTGAAGTGCCTGAGCTCATGGGTTCAAGACCAACCTAAGCCAGAGACCCCTGACTCTTATAATAGCCTGGCATTGTGGTGGGCGCCAATATTTCCAGCTACTCTGAGGCTAAGGCAAGAGAATTGCTTGAGCCCAGGAGTTGGAGGTTTCTGTGAGCACTGACGCCGCAGCTCTCTACCAAGGGCAACAAAGACTCTGTCTCAAAAAATAAATAAATAAATAAATAACAGAATGAAAATGAAAAA","GGCCGGGTGCGGTGGTTCACGCCTGTAATCCCACCACTTTGGGAGGCTGAGGCAGGCAGGTCACCTGAGGTCAGGAGTTCCAGACCAGCCTGGCCAACATGGTGAAACCTTGTCTCGGCTATTAGCCTGGCATGGTGGTGCGTGCCCATAATCCCAGCTACTCAGGAGGCTGAGGCAGGAGAATCGCTTGAACCCAGAAGGTGGAGGTTGCAGTGAGCCAAGATAGCACCACTGCAACTCCAGTCTGGGCAACAGAATGAGACTCTGTCTCAAAAAAAAAAAACAAAAAACAAAAAGAA"
"GL873571","4209418","4209704","chr11","32517699","32517985","80","28308281","GGCTTGGCAAGGTGGCTTACACCTCAAATCCTAGCACTGTGGGAGACTGAGGCAGGTGGATTGTTTGAGCTCAGGAGGTCAAGATAGAGAGCAAGAGCAAGTCTCTGTCTCTACTAAAAATAGAAAAGAACTACTTCCCGGGGGTCATGGCAGTAGCCTGTAATCCCAGTTACTAGGTAGAATGAGGCAAGAGGATCTGTTGAAGCCAAGAGACTGAGGTTGTTATGAGCATGCCACAGCACTCTACCCAGGGTGACAGAATGAGACTCTGTTGAAAGAAAAAAAGA","GGCCGGGTGCAGTGGCTCACACCTGTAATCCCAGCACTTTGGGAGGCTGAGGCGGGTGGATCACCTGAGGTCAGGAGTTCAAGACCAGCCTGACAAACATAGTGAAACCCTGTCTCTACTGAAAATACAAAATTAGCCAGGTGTGGTGGCGCATGCCTGTAATCCCAGCTACTCGGGAGGCTGAGGCAGGAGAATTGCTTGAATCCAGGAGGTGGAGGTTGTGTGATCACACCACTGCACTCCAGCCTGGGCGACAGAGTGAGACTCTGTCTCAAAAAAAAAAGAAA"
"GL873571","4209985","4210154","chr3","175781758","175781928","60","171571773","GAAAGAAATGAAAAGAAAGAAGTTAGCTGGTTGTTGGGGTATGCTTCTATAGTCCCACCTACTCAGAAAGCTGAAATCTGGAGTTTGGGGTTGTTGTAAGGTAGGCTGATGACATAGCACTGTAGCTTGGGCAAGAGAGTGTGACTTTGTCTCAAAAAAAATTAAAACAA","ATTAAAAACACAAAGATTAGCCAGGTGTGATGGCACACAACTGTAATCCCAACTACTCAGGAGAATCGCTTGAACCTGGGAGATAGGGTTTGCAGTGAGCCAAGATTGTGCCACTGCACTCCAGCCTGGGTGACAGAGTGAGACTCTGTCTCCAAAAAAAAAAAAAAAAAA"
"GL873571","4210444","4210570","chr17","16655655","16655789","35","12445211","GCCAGGCAGATGGCTCACACTTCATCCTAGCCCTCTGGAAGGCTGAGGCAGGCTAATTTTTTGAGGTTAGGAGTTTGAGACCAGCCTGAGGAAGAGACCCATCTCTACTTTAAAAAATAAATGGAAA","GCCAGGCATGGTGGCTCACACCTGTAATCCTAGCACTTTGGGAGACTGAGGCGGGTGAATCACCTGAGGTCAGGAGTTTGAGACCAGCCTGACCAGTATGGTGAAACCCAGTCTCTACTAAAAATACAGAAATTA"
"GL873571","4391733","4391878","chr11","33723808","33723943","46","29332075","AACTTAGCTGGGAATGGTGGCTCAAGCCTGTAATCCTAGCACTCTGGGAGGCTCAGGTGGGAGGATCACTTGAGGTTGCTGTGAGCTTGGCTGATGCCAGGACACTCTAGTGTGGGCAAGAGAGTGAGACTCCGCCTCAACAACAA","GCCGGGTGCAGTGGCTCATACCTGTAATCCCAGCACTTTGGGAGGCTGAGGTAGGCGGATCACGAGGTCAGGAGCTGAGATGGCGCCACTGCACCCCAGCCTGGGTGACAGAGCAAGACTCTGTCTCAAAAAAAAA"
"GL873571","6307773","6307841","chr9","62429628","62429694","22","56121855","CTGGGTGTGGTGGCATTGCACCTGTAATCCTAGCTACTTGGAAATCTTAAGCCCAGGAGTTGAAGACTG","CCCAGCATGGTGGTGCATACCTATAATCTCAGCTACTTGGAGGCTTGAGCTCAGAAGTTTGAGACCG"
"GL873571","6496217","6496306","chr1","27257765","27257856","27","20761548","GCAGGGTGTGTTGACCCACACCCACAATTCCAGGACTCTGGGGGGCCAGGGATGGTGGGTTCCCTCAGATCAGGAGCTCCTTACCAGCCT","GACTGGGCATGATGGCTCAAATCTGTAATTCCAGCACTTTGGGAGGCCGAGGTGGGTGGATTGCCTGAGATCAGGAGTTCAAGACCAGCCTG"
"GL873571","6499738","6499903","chr1","38976375","38976555","47","32476637","AAAATAACATGAATTGACTAGGCGAGGTGGCTCACATCTCTAATCCTAGCACTCTGGGAGGCTGAGGCAGGAGAATTGCATGAGGTTGCTGTGAGCTATGATGATACCACGGCATTCTAATCAGGGTGACAGAGTGAGATTCTGTCTTAAAACAAACAAACAAAAA","AAAATAAATAAATTAGCAGGGCCTGGTGGCGCACACCTGTAATCCCAGCTACTTGGGAAGCTGAGGCAGGAGAACCCACTTGAACCTGGGAGCCGGAGGTTGCAGTGAGCTGAGATGGCACCACTGCACTCCAGACTGCGTGACAGAGTGAGACTCCGTCTCAAAAACAAACAAACAAAAA"
"GL873571","11399575","11399872","chr15","109458692","109458994","79","98059117","CAGTGGCTCACACCTGTAAATCTAACACTCTGGGAGGCCAAGGTGGGTGGATCCCTTGAGCTCAGGAATTTGATACCAGCCTGAGCAAGAGTGAGACCTTGTCTCTACTAATAATAGAAAAATAGCCCGTGTTGTGGCACTTGTCCCAACCACTGGGGAGGCTTTAGGCGGGAGGATTACTTGAATTGGGAGTTTGATATTGCTGTGAGCTGGGCTGATGCCTTGGCATTCTAGCTTGGGTAACAGCGTAAGACTCCGTCTCAAATAAATAAATAAATAAATAAAAAGAAAAAAAGAA","GTGGCTCACACCTGTAATCTCAGCACTTTGGGAGACCGAGGCAGGTGGATCACCTGAGGTCGGGAGTTTGAGACCAGCCTGACCAACGTGGAGAAACCCCGTCTCTACTAACAATACAAAATCAGCTGGGCGTGGTGGTGCATGCTTGTAATCCCAGCTACTCGGGAGGCTGAGGTAGGAGAATCGCTTGAACCTGGGAGGTGGAGGTTGCGGTGAGCCGAGATCGAGCCACTGCACTCCAGCCTGGGTGACAGAGCAAGACTCCATCTCAAAAAAAAAAAAAAAAAAAAAAAAAAAAAAAAA"
"GL873572","114760","114841","chr8","26280134","26280211","16","26165374","GGCCAGGCATGGCGGCTCTTCCCTGTAATCCTAGCACTCTGGGAGGGCGAGGCAGGCAGATCACCTAGGCTAGGGTGAGATC","GGCCAGGAATGGTGGCTCATGCCTGTAATCCCAGCACTTTGGGAGGCTGAGGCAGGCAGATCACCTGAGGTCAGGAGT"
"GL873572","9421791","9421892","chr11","8089184","8089269","35","1332607","TACTAAATATATAGCAAGGCCAGGCACAGTGGTTCATGGCTGTAATCCCAGTACTCTGGGAGGCCTAGTCAGAGTTGACCTGAGATCAGGCTAGAAGCCTGG","ATAAAAATAATTGGAGGCCAGGCACGGTGGCTCATGCTTGTAATTCTAGCAATTTGGGAGGCTGACGCGGGTGAGATCATACTGAG"
"GL873572","11052834","11053035","chr14","11857478","11857657","65","804644","TCCACAAAGAAAGCAGAAGTGTGGCCGGGTGGTAGCTCAAGGCAGGAATCCCAGCACTCTGGGAGCTGGGAGGTGGGGGAGGATCCCTTGAGATCAGGAGTTGGAGGGCACAGTGAGCCTGGGGGAGGCCACTGTCTCTGTACTCTAGCAGGGAGACAGAGCAAGACTGCCCATTCAAAGAAAAACAACAAACAAAACAAAA","TACAAAAATTAGCTGGGCACGGTGCCACAAGCCTGTAATCCCAGCTACTCGGGAGGCTGGGCAGGGGAATAGCTTGAACCCAGAGGTGGAGGTTGCAGTGAGCCAAGATCAAGCCACAGCACTCCAGCCTGGGTGACAGAGCAAGACTCCATCTCAAAAAAAAAAAAAAAAAAAAAAAAA"
"GL873573","2564195","2564244","chr1","109985445","109985491","12","107421250","TACAAAAATTAGGCTGGGCTTGGTGGTTCACGCCTATAATCCTAGCACTT","ACTAAAATTAGCTGGGCATGGTGGTGCATGCCTGTAATTCCAGCTAC"
"GL873573","7423371","7423533","chr2","202783328","202783513","56","195359957","GGTGGCTCACACCTGTAATCCCAGCACTCTGGGAGCCCTGGTGGCTCATGTCTATAATCCTAGTACTCTGGGAGACCATGGTGGCTCATGTCTATAATCCTAGTACTCTGGGAGCCATGGTGGCTCACGCCTATAATCCTAGTACTCTGGGAGACCATGGTGG","GGCTGAGGCGCGGGGGCTCACGCCTGTAATCCCAGCACTGTGGGAGGCCGAGGCGGGTGGATCACGCCTGTAATCCCAGCACTGTGGGAGGCCAAGGCGGGTGGATCACGCCTGTAATCCCAGCACTGTGGGAGGCCGAGGCGGGTGGATCACGCCTGTAATCCCAGCACTGTGGGAGGCTGAGGC"
"GL873573","9657648","9657710","chr19","10207852","10207913","10","550204","TAAAAATAAAAAATTTAGCTGGATGTGGTGGCTCACACCTGTAATCCTAGCACTCTGGGAGAC","TAAAAATACAAAATTAGCTGGGTGTGGTGGCACACACCTGTAATCCCAGCTACTCAAGAGGC"
"GL873574","1624662","1624783","chr9","814961","815079","36","809701","GACTGGGTGGGTTGGATCATGCCTGGAATCCTAGCACCCTGGGAGGCCAAGGTGAAAGGATTGCTTGAGGTTAGGAGTTCCAGAAATGTAGCAGTCATGGTGACTTCATCCTTCTCTACCAA","GGCTGGGTGCTTTGATTCATGCCTGTAATCCCAGCACTCTGGGAGGCCGAGGCAGGTGGATCACCTGAGGTTAGGAGTTCGAGACCAGCTTGGCTAACATGGTGAAACCTCGTCTCTAC"
"GL873574","4459477","4459612","chr1","29437872","29437991","29","24978395","GGCCGGGCGTGGTGGCGCACGCCTGTAGTCCCAGCGCTATGGGAGGCCGAGGCGGGTGGATCACCTGAGCTCAGAGGTTCGAGACCAGCCAAGACCCCCCTGAGCCAAACGAGCCAGAGTGAGACCCCGTCTCTAC","GGCCGGGCGTGGTGGCTCACGCCTGTAATCCCAACATTTTGGGAGGCCAAGGCGGGTGGATCACCTGAGGTCAGAAGTTCGAGACCAACCTGGCCAACATGGTGAAACCCCTGTCTCTAC"
"GL873574","4681987","4682216","chr6","153082888","153083127","73","148400901","GGGTGCGGTGGCTCAGACCTATAATCCCAGCACTCTGAGAGGCCGAAGTGGGTGGATCACCTGAGCTCAGGAATTTGAGACCAGCCGTCTCTAAAAATAGCTGAGTGTTGTGGCAGTGGCTGTAAGTCCCAGCTGTTTGGAAAGCTGAAGCAAGGGAATCACTTGAACCCAAGAGTTTGAGGTTGCTGTGATGACAAAGTGAGACTCTATCTCAAAAAAAAAAAAAAAAA","GGCCGTGCGCGGCGGCTCACGCCTGTAATCCCAGCACTTTGGGAGGCTGAGGTGGGTGGATCACCTGAGGTCAGGAGTTTGAGACCAGCCCGACCAGAAATTAGATGGGTGTGGTGGTGCGCTCCTGCAGCCCCAGCTACTTAAGAGGCTGAGGCAGGGTAATCACTTGAACCCGGGAGGCGGAGGTTGCAGTGAGCCGAGCTCACGCCACTGCACTCCAGCCTGGGTAACAGAGCGAGA"
"GL873574","4709916","4710039","chr19","13152422","13152536","46","8442506","AAAAATAGAAAAACTAGCCAAGCATGGTGGTGCACCCCCTATAGTCTGAGCTCCTCAGCGGGCTGAAGCAAAAGGACGGCTGGAGCCCTGGAGTTTGAGGTTGCTGTGAGGCAAGGTGATGCCA","ACACATAAATTAGCCAGACATGATGGTGAGTATCTGTAATTCCAGCTCCTTGGGGGGCTGAGGCGGGAGAATTGCTTGAACCTGGGAGGCAGAGATTGCAGTGAGCCAAGATCGC"
"GL873574","6353839","6353913","chr5","25768079","25768163","22","19414240","AAAAATATAGCAAGGCCAGGCATGGTGGCTCACACCTATAATCCCAGTACTTGGGAGCTGGAATTTGAACCTAGG","AAAAAACTCAAACAAGGCTGGGCGTGGTGGCTCACACCTGTAATCCCAGCACTTTGGGAGGCTGAGGTGGGTGGATCACCTGAGG"
"GL873574","6533061","6533332","chr5","85182161","85182439","81","78649100","GGCTGGGCGAGGTGGCTTACACCTATAATCCTAGTACTCTGGGAGGCCAAGGTGGGTGGATTGCCTGAGCGCACAGTTTCAAGACCAGCTGGAGCCAGAGAGAGAGAGAGAGACCCTGCCTCTAAAAATAGCCAGGCATTGTGGCAGGCACCTGTAGTCCCAGCTACTTGGCAGGCGGAGGTATGAGAATCGCTAGAGGTTGCTGTTAGCTATGATGCCATAGCACTCTACCAAGGGCGACAAAGTGAAACTCTGCCTCAAAAAAAAGAAGA","GCCAGGCGTGGTGACTCAAGCCTGTAATCCTAGCACTTTGGGAGGCCAAGGTGGGCGGATTGCCTGAGCTCAAGAGTTTGAGACCAGCCTGGGCAACACGGTGAAACCCAATCCCTACTAAATACAAAAAAAATTAGCCGGGTGTGGTGGTGTGAACCTGTAGTCCCAGCTACTCGGGAGGCTGAGGCAGGAGAAGGCAGAAGTTGCAGTGAGCCGAGATCACACCACTGCACTCCAGCCTGAGTGACAGAGCAAAACTCTTTCTCAAAAAAAAAAAAA"
"GL873574","6643746","6643907","chr2","92627944","92628105","46","85984198","AAATAGCCAGGCGTTGTGGCAGGCACCTATAGTCCCAGCTACTTGGGAGGCTGAGGCAAGAGAATCACTTAAGCCCAAGTGACAGAGGTTGCCAGGGCACTCTACGTAGGCAACAGAGTGAGACTCTATCTAAGAAAGAAGGAAGGAAGGAAGGAGAAAGAA","TTAGCCGAGCATTGTGGTGCGCGCCTGTAGTCCCAGCTACATGGGAGGCTGAGGCAGGAGAACACCTGAACCCAGGATGTGAGCTGAGTCGCGCCATTGCACTCCAGCCTGGGCAACAGAGTGAGACTCCATCTCAAAAATAAAATAAAATAAAATAAAAAA"
"GL873574","6644163","6644274","chr1","128607504","128607619","20","121963341","CTGTAATCCTAGCACTTGGGAGGCTGAGGCAGGTGGATCACCTGAGTTCAGGAGTTCAAGACCAGCCTAAACAAGAGTGAGACCCTATCTCTACTAAAAATAGAAAAAATAT","GCCTGTAATCCAAGCACTTTGGGAGGCTGAGGCGGGTGGATCACCTGAGGTCAGGTGTTCGAGACCAGCCTGGCCAACGTGGTGAAACCCCAACTCTACTAAAAATACAAAAATTA"
"GL873574","8511822","8512127","chr1","23439759","23440073","84","14927937","GGTGGCTGGTGCCTGTAATCCTAGCACTCTGGGAGACTGAGGCAGGTGGATCACTTGAAATCAGGAGTTTGAGATCAACCTGAGCAAGAGATCTTGTCTCTCCTAAAGATAGAAAAACTAGCTGGGATTTGTGGTGGACACCTGTAATTTCAGCTACTCAGGAAGCTAAGGCAAGAGCATTGCTTAAAACCAGGAGTTTGAAGTTGATGTGAGCTAGGATGTCAGGGCAGGTTACCCAGGGTGACAGAGTGAGACTCTGTGTCAAAATAAACAAACAAACAAACAAACAAAACAAAATAAAATAAA","GGCTGGACATGGTGACTCACGCTTGTAATCCCAACACTTTGGGAGGCTGAAGCAGGCAGATCACCTGAGGTCAGGAGTTTGAGACCAGCCTGACCAACATGGTGAAACCTTGTCTCTACTAAAAATACAAAAATTAGCTGGGAGCAGTGGTGCACACCTGTAATCCCAGCTACTCGGCAAGCTGAGGCAAGATAATTTTTTAAACCTGGGAGGTGGAGGTTGCAGTGAGCCAAGATCGTGCCACTGTACTCCAACCTGGGAGACAGAGCAAGACTCTGTCTCAAAAAAAAAAAAAAAAAAAAAAAAAAAAAAAAA"
"GL873575","2107336","2107519","chr4","38052972","38053149","54","35945636","TCAATTAAAAACTTTTTAAAATGAGGCTGAGCATGGTGGTTCACACCTGTAATCCCAGCACTTTGGGAGGCCGAGGCAGGAGGATCACCTGATCCCAGGAGTCCAAGCCTACAGTGAGCCGTGATAATACCACTGCACTTCAGCCCAAAGCCTCAAAAAGAAAAAAAAAAAAGGATAGACAAGA","TATATATATATATATTATTTTGGGGGGGCATGGTGGTGCACACCTGTAATCCCAGCTACTCGGGAGGCTGAGGCAGGAGAATTGCTTGAGCCCGGGAGGCAAAGGTTGCATTGAGCTGAGATCACACCACTGCACTCCAGCCTGGCGACAGAGTCTCAAAAAAAAGAAAAAATAAAAA"
"GL873575","5831824","5831959","chr1","29437872","29437991","28","23606048","GGCCGGGCGTGGTGGCGCACGCCTGTAGTCCCAGCGCTATGGGAGGCCAAGGCGGGTGGATCACCTGAGCTCAGAGGTTCGAGACCAGCCAAGACCCCCCTGAGCCAAACGAGCCAGAGTGAGACCCCGTCTCTAC","GGCCGGGCGTGGTGGCTCACGCCTGTAATCCCAACATTTTGGGAGGCCAAGGCGGGTGGATCACCTGAGGTCAGAAGTTCGAGACCAACCTGGCCAACATGGTGAAACCCCTGTCTCTAC"
"GL873575","7451097","7451208","chr3","122814630","122814743","22","115363533","GGCCAGGTGTGGTGGCTCACACCTGTTATCCTAGCACTCTGAGAGGCCACAGCAGCTGGATCACTTGAGCTCAGGAGTTCAAGACCAGTCTGAGCAAGAGCAAGACCTCACC","GGCTGGGTGTGGTGGCTCATGCCTGTAATCCCAGCACTTTGAAAGGCCAAGGCAGATGGATCACTTGAGGTCAGGAGTTCCAGACCAGCCTGGCCAACATGGCAAAACCCCATC"
"GL873575","7451277","7451445","chr6","58863249","58863409","41","51411972","AAAAATTCAGCCAGCCACAGTGGAAGTGGATGCCTGCCATCACAGCTACTCTGGGGGCTGGGGCAAGAGAATTGCTTGATCCCAGGAGTCTGAGGTTGCTGTGACCTAGGCTGACACCACAGCACTCTACCCAGGGTGACAGAGTGAGGCTGTGTTTAAAAAAAAAAAA","TTAGCCAGGCATGGTGGCACATGCCAGTAATCCCAGCTACTCAGGAGGATGAGGCAGGAGAATCGCTTGAACCCAGGAGGCAGAGGTTGCAGTGAGCTGAGATTGCGCCACAGCACTCTACCCTGGGTGACAGAAGGAGACTCTGTCTCAAAAAAAAAAAA"
"GL873576","1765109","1765185","chrX","53921180","53921256","12","52156071","GGCCAGGTGCAGTGGCTCATATCTGTAATCCTAGCACCCTGGGAGGCCAAGGTAGGCGAATCACCTGAGGCCAGGAG","GGCCAGGTGCAGTGGCTCACGCCTGTAATCCCAGCACTTTGGGAGGCCGAGGTGGGCGGATCACTTTAGGTCAGGAG"
"GL873576","2711577","2711895","chr7","6620384","6620702","85","3908807","GGTCGAGCTTGGTGGCTCATGCTTGTAATCCTAGCACTCTGGGAGGCCAAGGCAGGTAAGTTGCCCTGAGCTCATAGGTTCCAGATCAGCATGAGCCAGAGTGAGACCCTGTCTCTACCAAAAAATAGCCCGGCATTCTGGCAGGTGCCTGTAATCCCAGCTGCTTGGGAGGCTGAGGCTAGAGAATCACTTAAACCCAAGGGTTAGTGGAGGTTGCTGTGAGCTATGATTCCACCGTACTCTACTGAGGGCCACAAAGTGAGACTCTGTCTCCATAAAAAAGAAAGAAAGAAAGAAAGAAAAATAAAATAAAATAAAA","GGCCAGGCACAGTGGCTCATGTCTGTAATCCCAGCACTTTGGGAGGCCGAGGCGGGTGGATTACCTGAGGTCAGGAGTTCTAGACCAGCCTGGCCAACAAGGCGAAACCCTGTCTCTACTAAAAATACAAAAAATTAGCTGGGCGTTTTGGCACATGCCTGTAATCCCAGCTACTTGGGAGGCTGAGGCAGGAGAATTGCTTGAACTGGGGAAGTGGAGGTTGCAGTGAGCTGAGATCACACCATTGCACGCCTGAGCAACAGAGCGAGACTCTGTCTCAAAAAAAAAAAAAAAAAAAAAAAAGAAAAGAAAAAGAAAA"
"GL873576","4782520","4782652","chr9","61136941","61137074","22","56354421","CCAGGCACGGTGGCTCACCCTTGTAACCCTAGTACTTTGGGAGGCTGAGGTGGGAGGATCCCTTGAGGTCAGGAGTTCAAGACCAGCCTGAACAACAGTGAGACCCCCGTCTCTACTAAAAAATAGAAAAGTT","GCCAGGCACGGTGGCTCACGCCTGTAATCCCAGCACTTTGGGAGGCTGAAGCGGGCGGATCACCTGAGGTCAGGAGTTCAAGACCAGCCTGGGCACCATGATGAAACCCCGTCTCTATTAAAAATACAAAAATT"
"GL873576","4782930","4783078","chr7","57521645","57521803","40","52738715","AGTTAGTCTGGTGTCATGGTGGGTGCCTGTAGTCCCAGCTGCTTGGGAGGCTGAGGCAAGAGAATCACTTGAGCCCAGGAGTTGGAGGTTGCTATGAGCGAGGCTGTAGCCTAGGCAACAGAATGAGACTTTGCCTCAAAAAAATAAAA","TTAGCTGGGCATGGTGGCGCATGCCTGTAGTCCCAGCTACTTGGGAAGCTGAGGCAGGAGAATCACTTGAACCTGGGAGGTGGAGGTTGCAGTGAGCTGAGATCGCACCGCTACACGCCAGCCTGAGCAACAGAGAGAGACTCTGTCTCAAAAGAAAAA"
"GL873576","7828709","7828723","chr5","101042981","101042996","1","93214272","TAAATAAATAAAAAA","TAAATAAATAAATAAA"
"GL873576","7828960","7829230","chr13","49045537","49045844","89","41216577","GCCGGCTGCAGTGGCTATAATCCAAGTACCCTGGGAGGCTTAGGTGGATGGATCACTTGAGCTCAGAAGTTCAAGACCAGCCTCAGCAAGAGGTAGACCTTGCCTCTATTAAANNNNNNNNNNNNNNNNNNNNNNNNNNNNNNNNNNNNNNNNNNNNNNNNNNNNNNNNNNNNNNNNNNNNNNNNNNNNAGTTTGAGGTTGCTGTGAGCTATGATGAAGCCAGGGCATTCTACCCAGGGTGACAGAGTAACTCTTAAAAAAAACTAAACAA","GGCCAGGCAGAGTGGCTCATGCCTGTAATTCCAGCAATTTGGGAGGCCTAGGCAGGCAGATTACCTGAGGTCAGGAGTTTGAGACCAGCCTGGCCAACATGGTGAAACCCCGTCTCTTCTANNNNNNNNNNNNNNNNNNNNNNNNNNNNNNNNNNNNNNNNNNNNNNNNNNNNNNNNNNNNNNNNNNNNNNNNNNNNNNGGAGATAATAGCTTTTGTAGAACGAAGCGATGCAACAGCCAGATCGCCGCCACCACCCTTAGGTCCTGGCGACAGAGTGAGATCCATCTTAAAAAAAAAAAAAAAAAAA"
"GL873576","10622840","10623093","chr7","60266447","60266705","74","49643607","GCTGGGTATGGTGGTTCACACCTATAATCCTAGCACTCTGGGAGGCTGAGGTGGGAGGATTGGTGGAGCTCAGGAGCTCATGAGGTGCCAAATCACTGGTGCCACACACCTGTATTCCCAGCTACTGAGGAGGCTGAGGCAGGAGGATCAGGTAAGCCCAGGAAGTTTGAGGTTGTAGTGAGTTAGGATGATTGAACTCTGCCTTGAGAGACAGAGCAAGATCCTCCTTCCTCCTAAGCAAACAAACAAATAAA","GGCTGGGTGCAGTGGCTCACACCTGTAATCCTAGCACTTTGGGAGGCTGAGGCGGGAAAATTGCCTGAGCTCAGGAGTTCAAGGACAGCCTAGGCAACATAGCATGGTGGTGCACGCCTGTATTCCCTGCTACTTGGGAGGCTGAGGCACAAGAATTGCTTGAATCCGGGAAGTGGAGGTTGCAGTGAGCCATTGTGGCACTGCTCTCCAGTCTGGGTGACAGAGCAAGACTCCATCTCAAAAAAAAAAAAAAAAAAAA"
"GL873576","10819939","10820007","chrX","67133632","67133707","21","56313693","AGGTTGCAGTGAAATTGTACCATTCCAATGAAGCCTGGGGGACAGAGTGAGATTCTCTCAAAATAAAAA","GGAGGTTGCAGTGAACCGAGATCGTGCCACTGCACTCCAGCCTGAGCGACAGAGTGAAACTTCGTCTCAAAAAAAA"
"GL873576","10920306","10920363","chr3","48261745","48261808","16","37341439","GCTGGACCTTGTAGAGAGTGCCTGTAATCCCAGCTACATGGGGGGCAAGAGAATTGCT","GCTGGGCATGGTGGTGCATGCCTGTGATCCCAGCTACTCAGGAGGCTGAGGCAGGAGAATTGCT"
"GL873576","10920398","10920529","chr10","67341428","67341546","30","56421030","GGCCAGGCGTGGTGGCTCACGCCTGTTGTCCCAGCACTGTGGGAGGCCGAGGTGGGTGGATTGCCTGAGCTCAGAGGAGTCCGGAAGACCAGCATGAGGCAGAGTGAGCCAGAGTAAGATCCTGTCTCTACC","GGCTGGGTGTAGTGGCTCATGCCTGTAATCCCAGCACTTTAGGAGGCCAAGGTGGATGGATTGCCTGAGCTCAGGAGTTCGAGACCACCCTGGGCAACAAGCCAAAACCCTGTCTCTAC"
"GL873577","515809","515961","chr7","137660778","137660931","43","137144969","AGCTGGGCATGGTGGCTCATGCCTATAACCCTAGCGTGCTAGGAGATTGCTTGTCAGGAGACTGAGGTTGCAGGAAACTGTGATGATGGCACTGCACTCTACCCAGGGTGACAGAGCAGGACTCTGCCTCAAAAAAAAAAAAAAAAATAGAAA","TTAGCTGGGCATGGTGGCGCATGCCTATAATCCCAGCTACTTGGGAGGCTGAGGCAAGAGAATCGCTTGAACCGGGGAGGCAGAGGTTGCAGACTGCACTCCAGCCTGTGTGACAGAGTGGGACTCCGTCTCAAAAAAAAAAAAAAAAAAAAAA"
"GL873577","1633164","1633256","chrX","38269524","38269615","26","36636360","TCAGCCAGGCATGGTGGCACTTGCCTATAAACCCAGCTCCTTGGGAAGCTGAGCCGGGAGGATCCCTTGCACCCAGGAGCAACGGAAGGCAGT","AATTAGCCAGGCATGGTGGCACATGCCTATAATCCCAGCTACTCAGAAGGTTGAGGCAGGAGAATCACTTGAACCTGGGAGGCAGAGGTTGC"
"GL873577","3979502","3979560","chr20","68909283","68909346","13","64929781","GAGTTTGAGACCAGCCTGAGCAAGACCGAGACCCAGTCTCTACTAAAAATAGAAAAATT","GGAGTTCAAGACCAGCCTGACCAACATGGAGAAACCCTGTCTCTACTAAAAAATACAAAAATTA"
"GL873577","3979839","3980009","chr10","31403126","31403287","39","27423287","ATGAGCAGATTGTCTTGGTGGGCACCTGTAGTCCCAGCTATTGGAGGTGGGAGGCTGAAGCAGGAAAATCTCTTGAGCCCAGGAGTTTGAGGTTGCTGTGAGCTAGGCTGACACCACGGCACTCTAGTCAGGGCGTCAGAGTGAGACTCCGTCTCAAAAAAAAAAAAAAAA","TTAGCTGAGTGTGGTGGCGCACATCTGTACTCCCAGCTATTTGGGAGGCTGAGGCAGGAAAATCGCTTGAACCCAGGAGGTGGAGGTTGCAGTGAGCCAAGATCACACTACTGCACTCCAGCCTGGGTGACAGAGTGAGAATCCATCTCAAAAAAAAGAAAA"
"GL873577","6050882","6051080","chr1","153219820","153220007","59","147168938","GGCTGGGCGTTGTGACTCATGCCTGTAATCCCAGCACTCTAGGAGGCCGAGGTGGGTGGACTGCCTGAACTCAGAGGTTTAAGACCATCCTGAGCCGCAGTGAGCCAGAGCGAGACCCTGTCTCTACCAAAAAAAGCTGGGTGTTGTGGTGGGCGCCTATAGTCCTAGCTACTTGAGGCGCTAAGGGTAAAAAAATTGC","GGCCTGGCACAATGGCTCACGCCTGTAATCCTAGCACTTTGGGAGGCCGGGGTGGGTGGATCACCTGAGATCAGGAGTTTGAGACCAGCCTGGCCAACATGGTGAAACTCCTTCTCTACAAAAATTAGCCAGGTGTGGTGGTGGGTACCTGCAATCCCAGCTATTTGGGAGGCTGAGGCAGGAGAATC"
"GL873577","8463965","8464050","chr9","52134422","52134508","19","43670457","CTGGGTGCTATAGCTCACGCCTATAATCCTAGCACTCTGGGAGTTTGGGGCAAATGGATCACCTAGGCTCAGGAGTTTGATACCAG","GGCTGGGAGCAGTGACTCACGCCTATAATCCCAGCACTTTGGGAGGCTGAGGCAGATGGATCACCTGAAGTCAGGAGTTCGAGACCA"
"GL873577","9471486","9471613","chr16","5178790","5178910","46","4292696","TTAGCCAGGCATAGTAGCCTGTGTGTAGTCCTAGCTACTCAGGAGGCTGAGGTAGATGGGTCACTTGAGGTTGCAGAGATTATGGTAATGTCACTGTACTCTAGCCCTGGCAACAGAGCACAACCCTG","TTAGCCGAGCCTGGTGGCATAAACCTGTAATCCCAGCTACTCAGGAGGCTGAGGCAGGGGAATTGCTTGAACCTGAGAGGAGAAGGTTGCAGTGAGCCGAGATTGCACCATTGCACCCCAG"
"GL873577","9471875","9471998","chr7","17832200","17832315","36","8360325","GGCCAGGTGAAGCAGCTCATGGCTATAATCCTAGCAGTTTGGCAGGCCAAGGTGGGAGGACTGCTTGAGGTCAAGAGTTCAAGACCAACCCATCTTTGCGAAAAATTTAAAAATTACCTAGGCA","GCCAGGAGAGGTGGCTCATGCCTCTAATCCCAGCACTCTGGAAATCCAAGGTGGGTGGATCACCTGAGGTCAGGAATTCCAGACCAGTCTGGCCAATATAAAAAATTAGCCAGGCT"
"GL873577","9853150","9853170","chr3","85044647","85044667","3","75191497","AAACAAACAAACAAAAAAAGA","CAAACAAACAAACAAACAAAA"
"GL873577","9853206","9853473","chr7","130818682","130818963","67","120965476","GCTGGGCGCAGCGTCTCACTCCTGTAATCCCAGCACTTGGGAGGCCAAGGTGAGTGGATTGCCTGAGTTTACAGTTTCGAGACCAGCCTGAGCCAAAGCGAGACCCCCATCTCTAAAAAATAGCTGGGCATTGTGGTGGGCACCTGTAGTCCCAGCTACTTGGGAGGCTGAGGCAAGAGGATCGCTTGAACCTAAGAGTTTGAGGTTGCTGTGAGCTAAGGCTCCATGGCATTCTACCAAGGGTGACTAAGTGAGACTCTGTCTAAAA","GCCGGGCACAGTGGCTCACACCTGTAATCCCAGTACTTTGGGAGGCCAAGGTGGGTGGATCACCTGAGGTCAGGAGTTTGAGACCAGCCTGGCCAACATAGTGAAACTCTACTAAAAATACAAAAAAATAGCTAGGCATGGTGGTGCGCACCTGTAATCCCAGCTACTTGGGAGGCTGAGGCAGGAGAGTTGCTTGAACCCAGCGGGGTTGAGGTTGCAGTGAGTTAAGATCAAGCCACTGTGCTCCAGCCTGGATGACAGAGAGAGACTCCATCTCAAAAA"
"GL873577","10722415","10722478","chr10","12501471","12501539","23","1779056","AATAAAAAAATGCTGGGTACAGTAGTACATGCCTGTACTCTCATCTGGGGAAGCTGAGGCATGA","AAAGTAAAAAATTAGAGCTGGGCATGGTGGCACACACCTGTAATCCCAGTCACTAGGGATGCTGAGGCA"
"GL873578","463331","463568","chr10","28935382","28935620","93","28472051","CAGGTGCTTTGACCCACACCCTCAACTCTAGGACTTTGGACGCCCTGGCTGGGTGGGTCCTTTAAAGTCAGGAGCTTCTTATCAGTCTGGGCAAAAGTGAGACCCCATCTCTACCAAACAAAGAAAGAAATCAGCAGTATGTTGCAGTAGAGACTCACCAATACCTTCTTTCAAAGACCAAAGCTGGAAGGACACTAAAGACCATGATCTCATGGCCTCCCTGAGCCATGACAATGCC","CCAGGTGCAGTGGCTCATGCCTGCAAGCTCAGAACTTTGGGAGGCAGAGGTGAGCAGACTGCCTGAGTTCAGGAGTTCAAGACCAGCTGGGCAACATGGTGAGACCCTATCTCTACTAAAAATACAAATAATTAGCAGGGTGTGGTAGCACACACCTGTAGTCCAGCTACTCAGGAGGCTGAGGCAGGAGAATTGCTTGAACCCAGGAGGCAGAGTTTGCAGTGAGCCAGGACTGGGCC"
"GL873578","1143712","1143827","chr11","52824583","52824692","30","51680871","GGCTGGGTGTGGTGCCTCATGCCTGTAATCTAAGCCCTCTCCGAGGCTGAGGTGGGAGGATCCCTTGAGTTTAGGAGTTTGATTTTGAGACCAGCCTGATCAAGAGAGAGACCTCA","GGCCGGGTGTGGTGGCTCATGTCTGTAATCCCAGCACTTTGGGAGGCTGAGGTGGGTGGATACCCTGAGGTCGGGAGCTCGAGACCAGCCTGACCAACATGGAGAAACCC"
"GL873578","1144101","1144139","chr3","33494224","33494257","11","32350123","GAGAGAGACCTCATGTCTACTAAAATAAATAAATATATA","GTGAAACCCGTCTCTACTAAAAATACAAAAATTA"
"GL873578","1144175","1144343","chr12","119519961","119520131","41","118375786","ATTATCCAGGCCTTCTGGTGGATGCCTGTAGTCCTAGCTACTAGAAAAGCTGGAGCAGAATCACTTGACCCAGGAGCTGGAGGTTGCAGGGAGCTAGGCTGATGCCACAGAATTCTAGCCTGAGGCAAAAGAATTGAGCCACTGTCTCAAAAAGGAACAAAAAAGAAAA","ATTAGCCAGGTGTGGTGGCATGCACTTGTAATCCCAGCTACTAAGAAGGCTGAGGCAGGAGGATCACTTGAACCCGGGAGGTGGAGGTTGCAGTGAGCCAAGATCATGCCACTGCACTCCAGCCTGGGCAACAGAGTAAGACTCTGTCTCAAAAAAAAAAAAAAAAAAAAA"
"GL873578","4593962","4594035","chr16","68825055","68825124","22","64231093","AGCTGGGTACAGTGGCTCACATATAATCCCAGTGACTCAGGAGGCTAAGACAGGAGGATTACTAGGACCTGAGA","GGCTGGGCACAGTGGCTCAGACCTGTAATCTCAGTACTTTGGGTGGCTGAGGCAGGTGGATCACCTGAGG"
"GL873578","6158845","6158972","chr3","500432","500562","24","5658413","GACATGGTGGCTCACACCTGTAATCCTAGCCCTCTGGGAGGCTGAGGCAGGTGGATCACTTGAGTTCAGGAATTCAAGACCAGCTTGAGTGAGAGCAAGACCCTGTCTCTACTAAAAATAGAAAAATT","GCACGGAGGCTCATACCTGTAATCCCAGCACTTTGGGAGGCTGAGGCAGGTGGATCACCTGAGGTCAGGAGTTCCAGACCAGCCTGGCCAACATGGCGAAACCCTGTCTCTACTAAAAATACAAAAAATCT"
"GL873578","6159253","6159444","chr19","34496349","34496541","55","28337096","ATAAAATAAAAATAGAAAAATTAGCCAGGCATTGTGGCAGACATGCGAAGTCTCAGCTACTCCAGAGGCTGAGACAGGAAGATTACTTGAGCCCAAGAATCTTGCTGTGAGCTAAGCTGATGCCATAGCATTGTAACCTAGGCAACAGAGTAAGACTTGGCCTCAAAAATAAAATAAAATAATAAAGTAAAA","TTAGTTAATTAAATTAAACTTAGCTAGGCATAGTGGAACACACCCATAGTCCCAGCTACTCTAGAGGCTGAGGCAGGAGGATTGCTTGAGCCAAGTTGGAGGCTGCAGTGAGCTATGGTGGTGCCACTGCATTCCAGCCTCAGTGACAGAGAGAGACCCTGGCTCAAATAATAATAATAAATAAATAAATAAA"
"GL873578","6766040","6766171","chr2","93098086","93098217","30","86332046","CCAGGCACAGTGGCTCATGCCTATAATCCTAGTAGTCTAGGAGGCTGAGGTGAGTGCATTGCTTGAGCTCAGGAGTTAGATACCAGCCTAACCAAGAATGAGACCCCATCTCTATTAAAAATAGAAAAGTTA","GCCGGGCACAGTGGCTCATGCCTGTAATCCCAGCACTTTGGGAGGCCGAGGCGGGCAAATCACGAGGTCAGGAGTTCAAGACCAGCCTGACCAATATGATGAAACCCCGTCTCTATTAAAAATACAAAAATT"
"GL873578","6766434","6766577","chr9","21128084","21128223","50","14361650","GTTAGCCAGGAGTTGTGGCGGGCACCTACAGTCCTAGCGACTCAGGAGGCTGAAGTAGGCAGAGTTTGATGTGTTGCTGTGAACTACAAGGACACCAATGCACTCTAGGCCGGTAACAGAGTGAGACACTGACTAAAAAAAAAA","TTAGCCAGGTGTGGTGGCACATGCCTGTATTTCCAGCTACTCGGGAGGCTGAGGCAGGAGAATTGCGTGAGCTGAGATCATGCCACTTCATTCCAGTCTGGGTGACAGAGTGAGACTCTGCCTCAAAAAACAAAACAAAA"
"GL873578","7397948","7398119","chr5","40230148","40230319","43","32832200","TAAAAATAGCCATGCATTGTGACAGGCACCTGTAGTCCCAGCTACTCAGGAGGTTGAGGTAAGAGAATCACTTGAACCCAAGAGTTTTGAGGTTGTTATGAGCTAAGACGCCTCGGGACTCTACAAAAGGTAACAAAGTGAGACTCTGTCTCATAAAAAAAGAAAAAAAGAA","AAAATTAGCCAGGCATGGTGACGTACACCTGTAGTCCCAGCTACTCGGGAGGCTAAGGCAAGAGAATCGCTTGAACCCAGGAGGCAGAGGTTGCAGTGAGCTTAGATCACGCTACTGCGCTCCAGCCTGGGTGACGGAGTGAGACGCCATCTCAAAAAAAAAAAAAAAAAAA"
"GL873578","7398378","7398515","chr15","102382935","102383070","35","94984557","GGTCGAGCAAGGTGGCTCACGCCTGTAATCCTAGCACTCTGTGAGGCTGAGGCAGATGGATTGCCTGAGCTCGTGGGTTCGAGACCAGCCTGAGCCAGAGTGAGACCTCATCTCTAAAAATAGCTGGGAAGCTGGGCA","GGCCAGGTGTGGTGGCTCACGCCTGTAATCCTAGCACTTTGGGAGGCTGAGGCGGGTGGATTGCCTGAACTCAGGAGGTCAAGACCAGCCTGGGCAACACAGTAAAACCCCATCTCTACTAAAATACAAAAAATCA"
"GL873579","370235","370429","chr16","38067345","38067552","57","37697110","GCACAGGCCTGAAATCCTAGCACTCTGAAAGGCCAACGGAGGAGAATTTCTGGAGCTCAGGAGTTTGATACCAGCCTAAGCAAATAAAGCTAGACCTCTATCTCTACTAAAATTAGAAAAATTAGGCAGATGTGGTGGTAGGCACCTATAGTCCCAATTACTCCAGAGGCTGAGGCAGAAAGACTCTTGAACCCA","GTCAGGCATGGTGGCTCATGCCTATAATCCTAGCACTTTGGGAGGCCAAGGCCGGTGGATCACCTGAGGTCAGGAGTTTGAGACCAGCCTGGCCAATATGGCAAAACCCCGTCTCTACTAAAAATAAAAAAATTAGCTGGGCACGGTGGTGGGCACCTATAGTCCCAGCTACTCAGGAGGCTGAGGCAGGAGAATTGCTTGAACCCAG"
"GL873579","370936","371046","chr3","3847698","3847802","33","3476762","TGACTCTTGAACCCAGGCACATGAGGTTGCTAAGAGTCTAGGCTGATGTCACGGCACTCTAACCTGGGAAACAGTGTGAGGTTCTGCCTCAATAAATAAATAAATAAATAA","TGGCTTGAACCCAGGAGGCGGAGGTTGCAGTGAGCCGAGATCACGCCACTGCACTCCAGCCTGGGCAACAGAGCGAGACTGTCTCAAAAAAAAAAAAAAAAAAAA"
"GL873579","599436","599605","chr10","38982686","38982853","41","38383250","AAAAAGTCAGACATTGTGGCAGGTGTCTGTAATCCCAGCTATTTGGGAGGCTGAGGCAGGAGTATCATTTGAACCCACGAGTCTGAGGTAACTGTGAGCTAGGCTAACACAACAGCACTCTAGCCTGGGCAATAGAATGAGACTCTATCAAGAAAAGAAATGAAAAGAAA","TATTAGCCTGACACAGTGGCGCGCATCTGTAATCCCAGCTACTTGGGAGGCTGAGGCAGGAGAATCACTTGAACCCAGGAGGCGGAGGTTGCTGTGGGCTGAGATCATGCCACTGCACTCCAGCCTGGGCAACAGAGGGAGGCTCCATCTCAAAAAAAAAAAAAAAAA"
"GL873579","599942","599953","chr3","71473700","71473710","4","70873758","TTTTAAAATAGT","TTTAAAAAAAA"
"GL873579","600232","600365","chr1","16061315","16061447","30","15461083","GGCTAGGCAAGGTGACTCATGTCTGTAATCCTAGTACTCTGGGAGGTTTGAGGCAGGAAGACCACTTTAGCTCAAGAGTTCCAGATCAGCCTGTGCAAGAGTGATACATCATCTCTACTAAAAATCAAAAATTA","GGCTGGGCATGGTGGCTCATGCCTGTAATCCTAGCACTTTGGGAGGTTGAGGCAGGCAGATCACTTGAGGTCAGGAATCTGAGACTAGCCTGGCCAACATGGTGAAACTCCATCTCTACTAAAAAAAAAAAAA"
"GL873579","5650320","5650591","chr6","54938866","54939145","71","49288546","GTCAGGTGTGTTAGCTTACAGTAGTAATCCTAGCACTTTGGGAGGTTGAAGTGGGTGGATTGCTTGAGCTCAGGGGTTCAAGACCAGCCTGAACAAGAGTGGGACCTCATCTCTATTAAAAACAGAAAAACTAGCTGGGTGTTATGGTGGGTGTCTGTAGCCCCAGCTACTCAGGAGGCTGAGGCAGGAGGTTGAGGTTGCTGTGAGCTATTGAGACCACAGCACTCTATCCAGGGCAACAGAGTGAGACCCCTCCCCCCCCCAAAAAAAAA","GGCCAGGTGTGGTGGCTCACGCCTGTAATCCCAACACTTTGGGAGGCCGAGGTGGGTGGATCACCTGAGATCAGGAGTTCAAGACCACCCTGGCCAACATGGTGAAACCCCGTCTCTACTAAAAATACGAAAATTAGCTGAGTGTGGTGGTGCATGCCTGTAGTCCCAGCTACTCAAGAGGCTGAGGCAGGAGGTGGAGGTTGCAGTGAGCCGAGATTGCATCACTGCACTCCAGCCTTGGCGACAGAACGAGAGAGACTCCATCTAAAAAAAAAAAAAA"
"GL873579","7037162","7037347","chr3","37328686","37328893","67","30291524","GAGGTGGGTGGATTGCCTGAGCTCACAGGTTGGAGACCAGCCTGAGCCAGAGCAAGACCTTATCTCAAAAAATAGCCAGGTGTTGTGGCTGGCACCTGTAGTCCCAGCTGCTCAGGAGGCGGAGGCAAGAGAAATGCTTGACCTCAGGAGTTTGAGGTTGCTGTGAGTTCAACTCACACTAATACA","GAGGCAGGGGGATCACCTGAGGTCAGGAGATCGAGACCAGCCTGGCCAACATGGTGAAAACCTGTCTCTACTAAAAATCCAAAAACATTAGCCAGGTGTGGTGGCACGCACCTGTAATCCCAGCTACTTGGGAGGCTGAGGCAGGAGAATCACTTGAACCTGGGAGGCAGAGGTTGTAGCGAGCCGAGATCACACCACTGCACCCCAG"
"GL873579","11077764","11077972","chr19","1200469","1200683","63","9877295","GCCAGGTGCAGTGGCTCATGCCTATAATCCTAGCACCCTAGGAGGCTGAGGAGTTCAAGACCAGCCTAAGCAACTGTGAGACCCCATCTCTACCAAAAATAGAAAAATTAGCTGACTGTTATGGTGTGCACCTACAGTCCTAGCTACTCAGGAGGCTGAGGCAGAAAGAGTCCTTGAACCCAGGAGGCTTTTTTTTGTTGTTGTTGTTG","GGCCAGTCGCGGTAGCTCATGCCTGTAATCCCAGCACTTTGGGAGGCCGAGGCGGGCAGATCACCTGAGACCAGCCTGGCAACATGGTGAAACCCCATGTCTACCCAAACTACAAAAATTAGCTGGGTGTGGTGGTGCACGCCTGTAATCCGAGCTACTCAGCAGGCTGAGGCAGGAGAATCCCTTGAACCTGGGAGGCAGAGGCTGCAGTGAGC"
"GL873579","11078245","11078333","chr19","4926258","4926351","22","6151987","TGAACCCAGGAGTTTGAGTTCGCTGTGAGCTAAGCTGAGGCCACAGCACTCCAGCCTGGGCAACAGAGTGAAAGGAAAAAAATAAAAAA","TGAACCCGGGAGGTGGAGGTTGCAGTGAGCCAAGATCACACCAATGCACTCCAGCCTGGGCAACAAGAGTGAAACTCTGTCTAAAAAAAAAAAA"
"GL873580","320374","320488","chr13","48549305","48549409","42","48228931","GGTAGTGCGTGCCTGCATTCCCAGCTACGGGAGGGCAGGGACTTGAGGCCAGCCTGGGCAAAATAATGAGACCTACTAATGACTCTACTAATACAGAAACAATTAGCTAGGTATG","TGGGAGGCCGAAGTGCGCAGATCACCTGAGGTCAGAAGTTGGAGACCAGCCTGGCCAACATGGTGAAAACCCATCTCTACTAAAAATACAAAAATTAGCTGGGCA"
"GL873580","374969","375091","chr6","147681010","147681135","27","147306041","CGGTGGCTCACACCTATAATCCTAGCATTTTGGAAGGCTGAAGCCGAGGATCTCTGGAAGTCAGAAGTTCAAGACCAGCCTGCCCAAGAGCAAGACCCCATCTCTACTAAAAATAGAAAAACT","GGTGGCTCACACCTGTAATCCCAGCATTTTGGGAGGCTGAGGCAGGCGGATAATCTGAGGTCAAGAATTTGAGACCAGCCTGGCCAACATGGAGAAACCCTATCTCTACTAAAAATACAAAATTAC"
"GL873580","375369","375549","chr7","19977275","19977456","44","19601906","CTAACCAAGTTAGTTAGTTTTAGTTGGCAGGTGCCTGTAGTCCCAGCTCCTTGGGAGGCTGAGGCAAGAGAATGGCTTGAGCCCAGGACTTTGAAGTTGCTGTGAGCTATAATGACACCACAGCACACTACCCAGGGTGACAGAGTGAGACTGTCTCAAAAAAACAAACAAACAAAAAAAA","AACAAACGTTAGCCGAGCATGGTGGTATGTGCCTGTAGTCCCAGCTACTTGGGAGTCTAAGGCAGGAGAATTACTTGAGCCCGGGAGGCAGAGGTTGCTGTGAGCCAAGATCACGCCACTGCACTCCAGCCTGGGTGACAGAGTGAGACTCCATCTCAAAAAAAAAAAAGGAAAAAAAAAAA"
"GL873580","8760922","8761015","chr11","104681322","104681416","19","95920400","GGAGGGAGACACTGCAGTGAACTGCGATCGTGTCTCTGCTTTCCAGGCTGGGTGACAGAGTGAGACTCGGTCTCTAAAATAAAAAATAAATAAA","GGAGACGGAGGTTGCAGTGAGCTGTGATCGCGGCACTGCACTCCAGCCTGGGCAACAGAGTGAGACTCTGTCTCAAAAATAAATAAATAAATAAA"
"GL873580","9391260","9391306","chr14","49279240","49279285","12","39887980","GCCAGTCGAGGTGGCTCACACTTGTGATTCCAGCTACTTGGAAGACT","GGCTGAGATGGTGGCACACACCTGTAATCCCAGCTACTTGGGAGGC"
"GL873581","759283","759365","chr6","46535476","46535542","30","45776193","TAAGAACCTGAAAATAGAGCCAGGCATAGTGGTACATGCGTATAGTCCTGGCTACTCAGGAGGTTGAAACAACAGGATTACTT","CAAAATAGCCAGGCTTGGTGGTGCATGCCTATAATCCAAGCTACTCGGGAAGCTGAGGCAGGAGAAT"
"GL873581","1145844","1145979","chr1","29437872","29437991","29","28292028","GGCCGGGCGTGGTGGCTCACGCCTGTAGTCCCAGCACTATGGGAGGCCGAGGCGGGTGGATCACCTGTGCTCAGAGGTTCGAGACCAGCCAAGACCCCCCTGAGCCAAATGAGCCAGAGTGAGACCCCGTCTCTAC","GGCCGGGCGTGGTGGCTCACGCCTGTAATCCCAACATTTTGGGAGGCCAAGGCGGGTGGATCACCTGAGGTCAGAAGTTCGAGACCAACCTGGCCAACATGGTGAAACCCCTGTCTCTAC"
"GL873581","9628238","9628362","chr5","141044567","141044691","34","131416329","ATCCCAGGTAGTCGGGAGGCTGAGGCAGGAGGATCACTTGAACCCAGGAGGTTGAGGTTGCTGTGAGCAAGGCAGAGGCAACGGCACTCTAGCCACGGGGGCACAGAGACTCTTGTCTTTAAAAA","TAATCTCAGCTACTCGGGAGGCTGAGGCAGGAGAATCGCTTGAGCCCAGAAGGTGGAGGTTGCAGTGAGCCAAGATCGCGCCATTGCACTCCAGCCTGGGCGACAGTGCGAGACTCTGTCTCAAA"
"GL873582","1580485","1580534","chr6","32576760","32576806","12","30996275","CAGCACTTGAGAGGCCAAGGCAGGTGGATCAACTGAGCAAGAATGAGACC","CCAGCACCTTGAGAGGCCAAGGCAGGTGGATCACCTGAGGTCAGGAG"
"GL873582","1644368","1644551","chr1","211626449","211626612","63","209982081","AAAATTTGCCGGGCTCCATAGCTCATGCATGTAATCATAGCACTCTGGGAGGCCAAGATGGGAGGATCTCTCAAGCTCTCTTACTTGGGAGGCTGAGGTTGCTGTGAGTTAGGCTTACGCCACAGCACTCTACTCTAGCGTGAGCAACTCTACTCTTAGTATGAGACTGTCTCAAAAGAAAAAA","AAATTAGCCAGGCGTCGTGGCACATGCCTGTAATCCCAGCTACTCGGGAGGCTGAGGCAGGAGAATAGCTTGATCTCGGGAGGCGGAGGTTGCAGTCAGCCGAGATCACACCACTGCAATCCAGCCTGGACAACAGAATGAGACTCCATCTCAAAAAAAACAAA"
"GL873582","5794385","5794459","chr13","18872784","18872852","27","13078399","ATATTGTTAAGCACAGCCACTATTAAAAATTAAATTATAGGCCAGGCATAGTGGCTCATGCCTGTAATCCTAGCT","TGAAACCACCATCTGGACCAAGATACAAAATGTTGGCTGGGCATGGTGGCTCACACCTGTAATCCTAGC"
"GL873583","102645","102683","chr14","5808766","5808804","14","5706121","GAGCAGATCACCTGAGCTCAGGAGTTTGAGACCAGCCTG","GAGGAATCCCTGTGCTCAGGAAGCTTACATTCTAGTGAG"
"GL873583","6200447","6200560","chr4","17786849","17786963","24","11586402","GGCCAGGAGGGACGGCTCATGCCTGTTATCCTAGCACTATGGGAGACTGAGGTGGGAGGATCACTTGAAGTTAGGAGTTCCAGACCAATCTGACCAAAGTGAGACCTCATCTCT","GGCCAGGCTTGGTGGCTCATGCCTGTAATCTTAGCACTTTGGGAGGCTGAAGTGGGTGGATCACTTGAGGTCAGGAGTTAGAACCAGTCTGGCCAACATGGTGAAACCTCAGCTC"
"GL873583","6200584","6200752","chr6","169626528","169626696","42","163425944","TTAGCTGGATGTGGTAGCACATGCCTATAGTCCCATCTACTCAGGAGGCTGAGACAAGAGAGTTGCTTAAGCCCAGGAGTTTAATTTAACTGTGAACTAGACTGAGACTGTGGCACTCTAGCTGGGGCAACAGAGTGAGACTCTGTCTCAAAAGAAAGCAAGAAAGAAA","TTAGCTGGGTATGGTGTCAGATGCCTGTAGTCCCAGCTACTCAGGAGGCTGAGACAGGAGAATCGTTTGAACCCAGGAGGCCAGAACTGCAGTGAGCTGAGATTCGCACCACTGCGCTCCAGCCTGGGCCAGACAGAGTGAGACTCTATCTCAAAAGAAAAAAAAAAAA"
"GL873583","10217398","10217583","chr3","36257142","36257313","44","26039744","TACTAAAAATAAAGTGTGATAGCCAGGCATGGTGGTGGTGCCTATAGAACCAGGCTATTCAGGAGGCTGAGGCAGAAGGATCACTTGAACCCAGGAGTCTGACGTTGCTGTGAGCTAGGCTGGTGCCATGGTACTCTAGCCTGTGGTAACAGAATGAGACTCTATCTCAAAAATAAAAATAAAAAA","TACAAAATTAGCCAGGCGTGGTGGTGCGTGCCTGTAATCCCAGCTACTTGGGAGGCCGAGGCAGAAGAATGACTTGAACCCAGGAGACAGAGGTTGCAGTGAGCCAAGATCCCACCATTGTACTCCAGCCTGGGCAACACAGTGAGACTCCATCTCAAAAAAAAAAAAAAAA"
"GL873583","10394919","10394983","chr16","12841703","12841771","22","2446784","GAGGTCAGGAAATCAAGATCAGTCTGGGCAATATATTGATACCCTGCCCCTACATAAGGAAGAAA","AGGTCAGGAGTTCAAGACCAGCCTGGCCAATATGTTGAAACCTCATCTCTACTAAAAATACAAAAATTA"
"GL873584","521512","521529","chr1","167402212","167402233","10","166880700","GCATGGAACCCCCCACTC","GGTGAAACCCCATCTTTACTAA"
"GL873584","2079725","2079768","chr15","4338291","4338335","11","2258566","GGCAGGTGGATTACCTGAGTTCAGGAGTTGGAGACCAGCCTGAC","AGGCGGATGGATCACGAGGTCGGGAGTTTGAGACCAGCCTGACCA"
"GL873584","5216877","5217053","chrX","91350057","91350230","49","86133180","CTACTGAAAATGATGACAGAGGCTGGGCATGGGGGCTCCCGCCTGTTATCCTAGCACCCTCGGAGGCTGGGGAATGAGGATTGCTTACGCCCAAGAGTTTGAGGTTGCTGTGAGCTGAGGCCGCTGCACTCTAGCCTGGGCAACAGAGTGAGACTCTGTCTCAAAAAAAAAAAAAAA","TGCAAAAATGAGCTGGGCATGGTGGCACATGCCTGTAATCCCAGCTACACAGGAGGCTGAGGCAGGAGAATCGCTTGAATCTGGGAGGCGGAGGTTGCAGTGAGCTGACATCAGGCCCCTGCACTCTAGCCTGGGCCACAGAGCAAGACTCCGTCTCAAAAAAAAAAAAAAAAA"
"GL873584","7289930","7289950","chr2","51453328","51453345","10","44163398","TGAGGCTCTGTCTCGAAATAA","AATGCCATCTATTAAAAA"
"GL873584","7289975","7290131","chr11","49739997","49740154","37","42450022","CAAGAAAATTAGCTGAGAGTCCTGGTAGGTGCCTGTAATCCCAGCTATTCATGAGGCTGAGGCAGAAGGATCACTTGGGTCCAGGAGTCTGAGGTTGCTGTGAGCTAGTCTGACGCCATAACACGCAAGCCTGGGCAACAGAGTGAGGCTCGGTTTC","CTACAAAAATTAGCTGGGCGTGGTGGCACATGCCTGTAATCCCAGCTACTCGGGAGGCTGAGGCAGGAGAATCACTTGAGCCCAGGAGGCGGAGGTTGCAGTGAGCCAAGATCATGCCATTGCACTCCAACCTGGGCAACAGAGCAAGACTCCATCTC"
"GL873584","7577743","7577867","chr5","48394329","48394446","27","40816586","GGCTGGATGAGGTGGTTCATGCCTGTAATCCTAGCACTCTGGGAGGCCAAGGTGGGTGGATTGCCTGAGCTCAGGAGTTCAAGACCAGCCTGAGCAAGACCCTGTCGCTAAAAATAGCTGGGTGT","GGCTGGGTGCAGTGGCTCATGCCTGTAATCCCAGCACTTTGGGAGGTCAAGGCGGGTGGATCACCTGAGGTCAGGAGTTCAAGACCAGCCTGGCCAACATCTCTACTAAAAATACAAA"
"GL873584","7578135","7578289","chr1","130112713","130112865","31","122534578","GGAGCTGGGTTTTGTGACTGCACCTGTAATCCCAGCTGCTCAGGAGGCTGAGGCAAGAGAATTGCTTGAGCCCAGGAGTTGGAGGTTGCTGTGAGCTGTGATGCCAGGGAACTCTACCAAGGGTGACAAAGTGAAACTCTGTCTCAAAAAAAAAA","TTAGCCAGGTGTGGTGATGCATGCCTGTAATCCCAGCTACTCATGAGGCTGAGGCAGGAGAATTGCTTGAACCTTGGAGCTGGAGGTTGCAGTGAGCTGAGATCAGACCACTCCAACCTGGGTGACAGAGCGAGACTCTGTCTCAAAAAAAAA"
"GL873585","1450952","1451121","chr10","59681079","59681242","48","58230127","TAAAAACAGAAAAAACTAGTCAGGTGGTGTGGTAGGTGCTCATAAGTCCCAGCTGCTTGGGAGACTGAGGCAAGAGAATCACTTGAGCACAAGAGCTTGAGGTGGCTGTGAGCTATAACACCATAGCACTGTACTGAGGGTGACAAAGTAAGACTCTGTCTCAAAAAAAA","TACAAAAATTAGTCAAGGGTGGTGGTATGTGCTTGTAATCCCAGCTATTTGGGAGGCTGAAGCAGGGGAATCCTTGAACCCAGGAGGTGGAGGTTGCAGCGAGCCGAGATCACGTCACTGCACTCTAGCCTGGGCGATAGGGTGAGACTCTGTCTCAAAAAAAA"
"GL873585","1451382","1451515","chr6","17405813","17405948","24","15954431","GGCCCGGCTCGGTGGCTCACACCTATAATCCTAACACTCTGGGAGGCTGAGGCAGGTGGATCACCTGAGCTCAGGAGTTTGAGACCAGCTGAGCAAAAACAAGACCCTATCTCTGCTAAAAATAGAAAAAACTA","GGCCGGGCGGGGTGGCTCACGCCTGTAATCCCAGCACTCTGGGAGGCCAAGGCAGGTGGATCACCTGAGGTCAGGAGTTTGAGACCAGCCTGGCCAACACGCAGAAACCCTATTTCTACTAAAAACACAAAAATTA"
"GL873585","1626960","1627026","chr7","17782729","17782794","22","16155769","AAGATGCCACAGCACTCTACAAGAGTGACCAAGTGAGACTCTGTCTCAAAAAAAAAAAGAAAAGGAA","CAATCGCACTACTGCACTTCAGCCTGGGTGACAGAGTGAGAACCTGTCTCAAAAAAATAAATAAAA"
"GL873585","1627304","1627531","chr11","17033552","17033788","61","15406248","GGCTGGGCACAGTGGCTCACGGCTATAATCTAGGCACTTGGGAGGCTAGGGCAGGTGGATTGCCTGAACTGACAAGTTTGAGACCAACCTGAGCAAGAGCGAGACCCCTGTCTCTAAAACATAGCCAGGCTCTGTGGTGGGCGTCTGTAGTCCCAGCTACTTGGGAGGCTGAGGCAAGAGAATTGCTTGAACTCAAGAGTCTGAGGTTGCTGTGAGTTAAGATGCCAC","GCCCGGCGCAGTGGCTCACGCCTGTAATCCCGGCACTGTGGAGGCCAAGGCAGGCGGATTGCCTAAGCTCAGGGATTCGAGAACAGCCTGGGCAACATGGTGAAACCCCATCTCTACTAAAATACAAAAAACTAGCCGGGCGTGGTGGTATGCGCCTGTAATCCCAGCTACTTGGGAAGCTGAGGCAGGAGAATTGCTTGAACCCGGGAGATGGAGGTTGCAGTGAGCTCAGATCAC"
"GL873585","3626082","3626158","chr1","100916857","100916922","27","97290775","TGCCTGTAATCCCAGCACTTGGGAGGCGGAGGTGGGTAGATTGCCTGACCCAGAGTGGGACCTCATCTCTAAAAGAA","CATGCCTGTAATCCCAGCACCTTGGGAGGCCAAGGTGGGTGGATCACCTGAGGTCAGTAGTTTGAG"
"GL873585","8849829","8849913","chr18","48581945","48582025","18","39732116","GGCTGGACGAGGGGACTCATGCCTGCAATCCCAGCACTGAGAGAGGCCAAGGCAGGTGGATCCCCTGAGCTCAGAAGTTTGAGAC","GCTGGACGCAGTGGCTCACACCTGTAATCCCAGCACTTTGGGAGGCCAAAGCAGGCAGATCTGAGGTCAGGAGTTTGAGAC"
"GL873585","9319890","9319971","chr8","79499361","79499447","14","70179471","GGCCAGGTGTGGTGGCTCACACCTGTCATCCTAGCACTCTGGGAGGACGAGGTGGGTGGACCGCCTGAGTCAGAGTGAGACC","GGCCAGGTGTGGTGGCTCACACCTGTAATCCCAACACTTTGGGAGGCCCAGGTGGGTGGATCACCTGAGGTCAGGAGTTCAAGACCA"
"GL873586","895572","895692","chr17","14501559","14501680","38","13605987","GGCCAGGTGAGGTTTCTCATTCTGGGAGTGAGCCAGCAATTGGGAGGCCAAAGTAAATGGATTGCCTGAGGTTATAGGTTCCAGAACAGCCAGAACAAGATCGAAATCCTGTCTCCAAAAA","GGCCAGGCGTGGTGGCTCATGCGTGTAATCTCAGCACTTTGGAAGGCCGAGGCAGGTGGATCACCCGAGGTCAAGAGTTCAAGACCAGCCTGACCAACATGGCGAGTCTCTGTCTCCACTAA"
"GL873586","5645995","5646150","chr6","58863249","58863409","38","53217254","GGGTATGGTGGCTCATGCCTGTAATCCAAGCACTCTGGGATGGTGAGGCAGGAGAATCCCTTGAACCCAAGAGTCCGAGGTTGCTGCGAGCTAAGCTGATGGCATAACACTCTAGCCTAGGCGACAGAGTGAGACTCTGTTTCCAAAGAGAAAAAA","TTAGCCAGGCATGGTGGCACATGCCAGTAATCCCAGCTACTCAGGAGGATGAGGCAGGAGAATCGCTTGAACCCAGGAGGCAGAGGTTGCAGTGAGCTGAGATTGCGCCACAGCACTCTACCCTGGGTGACAGAAGGAGACTCTGTCTCAAAAAAAAAAAA"
"GL873586","10258686","10258969","chr12","9481260","9481565","81","777426","GGCCGGGCATGGTGGCAGAAATCTAGGAGGCCGAGGCAGGTGGATCGCCTGAGATCACAAGTTCAAGACCAGCCTCAGCTACAGCAAGACCCCATCTCTAAAAATAGCCGGCTGTTGTGGCAGGCGCCTGTAACCCCAGCTACTCGGGAGGCTAAGGCAAGAGAATCGCTTGAGCCCATGAGTCTGAGGTTGCTGCGAGCTGTGACTCCACGGCACTCTACCCGGGGCGATAAAATGAGATTCTGTGTCAAAACAAACAAACAAACAAACAACAACAAAAACAA","GCTGGGCGCGGTGGCTCATGCCTGTAATCCCAGCACTTTGGGAGGCCAAGGCAGGTGGATCACCTGAGGTCAGGAGTTCGAGACCAGCCTAGTCCACATGGTGAAACCCCATCTCTACTAAAAACTAGCCAGGCGTGGTGGTGCGCACCTGTAATCCCAGCTACTCGAGAGGCTGAGGCAGGAGAATCACTTGAGCCTAGGAAGCAGAGGTTGTGGTGAGCTGAGATCACACCACTGCACTCCAGTCTGGGCGACACAGTGAGACTCTTGTCTCAAAAACAAAAAACAAACAAACAAACAAACAAA"
"GL873587","3208032","3208047","chr8","3626746","3626762","2","418714","AAACAACCACAAAAAA","ACAACAACAACAAAAAA"
"GL873587","3208141","3208321","chr19","2057131","2057316","59","1151010","TTTCTTTTAAAAATCACCCATGGGCTGGGTATAGTGGCTCACACCTATAATCCTCGGGAGGCCAAGGTTGGAGGATTGCTTGAATCCAGGAGTTGAAGGTTACAGTGAACTGGGATTTAGCCACTAGACTCTAGCATAGCTGACAAAGCAAGAACCTATTTGTTTAAAACACAAAAAAGAA","TACTAATAATACAAAAATGAGCCGGGTATGGTGGCGGGTGCCTGTAATCCCAGCTACTGAGGAGGCTGAGGCAGGAGACTTGCTTGAACCCAGGAGGTAAAGGTTGCAGTGAGCTGAGATTGCACCACTACACTCCAGCCTGGGCGACAAGAGCAAAACTTTTTCTCCAAAAAAAAAAAAAAAAAA"
"GL873587","3278260","3278367","chr19","19044200","19044312","39","15765940","CAGTCTGAGCAAGAGGGAGAGGCTATTTCTACTAAAAACAGAAAAACTAGCTGGGTGTTGGGGTGTGTTCCTAGTCTCAGTTACTTGGGAGGCTGAAGTAAGAGGATC","ACCAGCCTGGCCAACACGGTGAAATCCCGTCTCTACTAAAAATACAAAAATTACCTAGGCGTGATGGCACGTGCCTGTAGTCCCAGCTACTCATAAGGCAGAGGTGAGAGAAT"
"GL873587","3278673","3278754","chr7","49412503","49412597","28","46133830","GGCCACGAGAGCTAGCTCATGCCTATTCTAGGAGGCCAAAGCAGGCAGACTGCCTGAGCTCAGGAGTTCAAGAGCAGCCTGG","GGCCAGGTGCAGTGGCTCATGCCTGTAATCCGAGCACTTTGAGAGGCCGAGGCAGGCAGATCACCTGAGGTCAGGAGTTCAAGACCAGCCTAGTA"
"GL873587","3782076","3782188","chr9","112128434","112128552","34","108346358","ACTGGGGTGGCTGAGGCAGGAGCGTCACTTGAACTCAGGAGTTTGAGATTGCTGTGAGCTGAGCAGATGTCATGGCACGCTAGCCTAGGTAATAGAGTGAGACTTCGTCTAAA","CAGCTACTCGGGAGGCTGAGGCAGGAGAATCACTTGAACTCGGGAGGCGGAGGTTGCAGTGAGCCGAGATCACGCCATTGCACTCCAGCCTGGGCAACAAGAGCGAAATTCCATCTCAA"
"GL873587","4564996","4565084","chr20","27900350","27900437","14","23335354","GGCGGGGTGTAGTGGCTCATGCCTATTGTCCCAGCACTGTGGGAGGCCGAGGTGGGTGGATCACCTGTGCTCAGAAGTTTGAGACCAGC","GGCCGGGCGTGGTGGCTCATGTCTGTAATCCCAGCACTTTGGGAGGCCGAGGTGGGTGGATCACCTGAGGTCAGGAGTTCAAGACCAG"
"GL873587","6307870","6308175","chr12","112427710","112428020","54","106119840","GGCCAGATATGATGGCTCATGCTTGTAATCCTAGCACTCTGGGAGGCTGAAGTGGGAGGATCACCTGAGATCAGGAGTTCAAGATCACCCTGAGCAAAAGTGAGATCCCATCTCTATTAAAAATAAAAAAATTATCCAGGCATGGTGGTGCAGTCCTTTAGTCCCAGCTACTTGGGAGGCTGAGGCAGGAGAATCTCTTGAACCCAGGAATTAGAGGTTACAGTGAGCTGTGATGATGCTACTGCACTCTAGCAGGATGACAGAGTGAGATACTCCGTGTCAAAAAAAAAAAAAAAAAAAGCAAAA","GGCTGGACATGGTGGTTCATGCTTGTAATCCGAGCACTTTGGGAGGCCAAGGCGGGTGGATCACCTGAGGTTGGGAGTTCGAGACCAGCCTGACCAACATGATGAAACCCCATCTCTACTAAAAATACAAAAAAATTAGCCAGGCATGGTGATGCACGCCTGTAATCCCAGCTACTTGGGAGGCTGAGGCAGGAGAATCACTTGAACCCAGGAGGCAGAGGTTACAGTGAGCCGAGATCATGCCATTGCACTCCAGCCTGGATGACAGAGTGAGCCTCTGTCTCAAAAAAAAAAAAAAAAAAAAAAAAAAA"
"GL873587","6484004","6484128","chr10","67341428","67341546","29","60857424","GACCAGGTTCTGTGGCTCATGCTTGTAATCCTAGCACTCTAGGAGGCCGGAAGAGGGTGGATTGATTGCCTGAGGTCAGGAGTTAGAGACCAGCCTGAGCAAGAGCTAGACCCTGTTTCTTTCTT","GGCTGGGTGTAGTGGCTCATGCCTGTAATCCCAGCACTTTAGGAGGCCAAGGTGGATGGATTGCCTGAGCTCAGGAGTTCGAGACCACCCTGGGCAACAAGCCAAAACCCTGTCTCTAC"
"GL873587","6484407","6484586","chr3","167196537","167196723","48","160712130","TAGACCCTGTTTCTAAAAAAAAAATAGCCAGGTGTTGAGGCAGGTACCTGTAGTCCCAGCTACCTGGGAGGGCTGAGGCAAGAGAATCGCTTGAACCCAAGAGTTTGAGGTTGCTGTGAGCTGAGATGCTATGGCACTCAACCGTGAGCTACAAAGTGAGACTCTGTCTCAAAAAAAAAA","AAAACCTGTCTCTGCTAAAAATACAAAAATTAGCCGGGTGTGGTGATGTGCGCCTGTAGTCCTAGCTACTTGGGAGGCTGAGGCAGGAGAATCACTTGAATCCAGGAGGTGGAGGTTGTAGTGAGTCGAGATCGTGCGACTGCACTCCAGCCTGGGTGACAGCGAGACTCTGTCTCAAAAAAAAAAA"
"GL873587","7466229","7466364","chr1","29437872","29437991","35","21971643","GGCCAGGCGTGGTGGCTCATGCCTGTAGTCCCAGCGCTATGGGAGGCCGAGGTGGGTGGATCACCTGTGCTCAGAGGTTCGAGACCAGCCAAGACCCCCCTGAGCCAAATGAGCCAGAGTGAGATCCCATCTCTAC","GGCCGGGCGTGGTGGCTCACGCCTGTAATCCCAACATTTTGGGAGGCCAAGGCGGGTGGATCACCTGAGGTCAGAAGTTCGAGACCAACCTGGCCAACATGGTGAAACCCCTGTCTCTAC"
"GL873588","1502535","1502718","chr1","34852429","34852590","60","33349894","GGTGCAGTGGCTCACACCTGTTGTCCCAGCGCTGTGGGAGGCCGAGGTGGGTGGATCACCTGTGCTCAGAGGTCGAGACCAGCTGAAGACCTGCCTGAGGCAGAGTGAGCCAGAGTGAGACCCCGTCTCTACTAGAACAACAACAAGACAGCCAGACCTTGTGATCCCAGCTACATGGGGGGCT","GCCAGGTGCAGTGGCTCACACCTGTAATCCCAGCACTTTGGGAGGCCGAGGCGGGCGGATCACCTGAGGTCAGGAGTTTGAGACCAGCTTGACCAACATGGAGAAACCCCGTCTCTACTAAAAATACAAAATTAGCCTGGTGTGGTGTCGCATGCCTGTAAT"
"GL873588","10189037","10189246","chr3","45604681","45604903","65","35415644","GCTGAGATGAGGAGACTCTGTCTCTATTAAAAATAGAAAAATTGGGTGGATGTTGTGGGTACTGTAGTTGCAGCCTCTTGGGGGGCTAAGGCAGGAGGATCAGTTGAAGCCAGGAATTTGCTTTGAGCTAGGCTAAAGCCATGGCACTCTAGCCTGGGCAACAGAGTGAGGCTAGATCTCAAAAAAAGAAAGAAAAGAAAAAGAAAAAAA","CTGGCCAACATGGCAAAACCCCATCTCTACTAAATATACAAAAATTAGCTGGACGTGGTGGCACATACCTGTAATCCCAGCTACTTGGAAGGCTGAGGCAGGAGAATAGCTTGAACCTGGGAGGCAGAGGTTGCAATGAGCTGAGATCACGCCACTGCACTCTAGCCTGGGCAATAGAATGAGACTCTGTCTCAAAAAAAAAAAAAAAAAAAAAGACAAGAAA"
"GL873589","104719","104807","chr20","27900350","27900437","13","27795631","GGCTGGGCGTGGTGGCTCATGCCTGTTGTCCCAGCGCTGTGGGAGGCTGAGGTGGGTGGATCACCTGTGCTCAGAGGTTCGAGACCAGC","GGCCGGGCGTGGTGGCTCATGTCTGTAATCCCAGCACTTTGGGAGGCCGAGGTGGGTGGATCACCTGAGGTCAGGAGTTCAAGACCAG"
"GL873589","796766","796905","chr1","166346372","166346487","49","165549606","GGCTAAGTGTGGTGGCTCACACCTGTCATCTAGTACTTTGGGAGGGTGGGCCTGGGAGTTCAAAGACTGAACTCAGGAGTTCAAGGTGGCTCCGGGGAGGAATTCAAGACCAACCTGAGCCAGAGCGAGACCTCGACTCT","GGCCAGTGGGGTGGCTCACGCCTGTAATCCCAGCACTTTGGGAGGCTGAGGTGGTCAAATGACCTGAGGTCAGGAGTTTGAGACCAACCTGGCCAACATGGTGACACCTCGTCTCT"
"GL873589","1023679","1023690","chr1","205890061","205890072","1","204866382","AAAAAAAAAAAA","ACAAAAAAAAAA"
"GL873589","1023771","1024047","chr4","103012712","103012993","70","101988941","GGCTTGGTGGCTCACACCTGTAATCCTAGCACTCTGGGAGGCCGAAGTGGCTGGAATACTTGAGGTCAGGAGTTCAAGACCAGCCTAAGTGAGAGTGAGATCCCCATCTCTAATAAAAATAGAAAAATTAGCAGGGTGTTGTGGCTGGCACTTGTAGTCCCAGCTACCCAGGAGACCGAGGCAGAAGTTTGAGATTATTGTGAGCGAGGCTGATGCCACAGCATTCTAGTGGGACAACAGAGCAAAATTCTATCTCAAAAGAAAAAAAAAAAAAGGA","CGGGCGTGATGGCTCACGCCTGTAATCCCAACACTTTGGGAAGCCGAGGCGGACGTATCACCTGAGGTCAGGAGTTCAAGACCAGCCTGGCCAACATGGTGAAACCCCGTCTCTACTAAAAATACAAAAATTAGCTGGGTGTGGTGGCATGCGCCTGTAATCCCAGCTACCCAGGAGGCTGAGGCAGGAGAATCGCTGAGGCTGCAGTGAACTGAAATTGTGCCACTGCACTCCAGCCTGGGTGACAGAGCAAGACTCTGTCTCAAAAAAAAAAAAAAAAAA"
"GL873589","4820958","4821024","chr8","33633747","33633811","15","28812789","TTAGTCAAGTGCAGTGGCTCACACCTGTCATCCCAGCTACTTGGGAGGCTGAGGCAGGAGAGTTGCT","TTAGCCAGGTGTGGTGGTGCATGCCTCTAATCCCAGCTACTCAGGAGGCTGAGGCAGGAGAATTG"
"GL873589","6763768","6763857","chrX","25814002","25814092","29","19050234","GGTGTGGTGGCTCACACTTGTATCTTAGCATTTTAGGAGGCTGAATGGGGAGAATTGCTTTAAGTCAGGAGTCTGACTTCCACCTTGCCA","GGCTGGGAATGGTGGCTCACACCTGTAATCCCAGCACTTTGGGAGGCTGAGGTGGGCAGATCACCTGAGGTCAGGAGTTTGAGATCAGCCT"
"GL873589","8444551","8444632","chr9","93194085","93194171","17","84749534","CGGGCATGGTGGCTCACAACTATAATCTTAGCACTTTGGGAGGCTGAGACAGGTGGATGCCTGAACTCAAGAGTTTGAAACC","GGCCGAGCATGGTGGCTCACACCTGTAATCCCAGCACTTTGGGAGGCTGAGGCAGGTGGATTACCTGAGGTCAAGAGTTCAAGACCA"
"GL873589","9085365","9085494","chr2","194063347","194063481","42","184977982","GGCCAGGCACAGTGGCTCACACCTATAATCCCAGCACTCTGTGAGACTGAGGCAGGTGAACTGTTGCAAGAGTGAGACCCTGTGCTTGGTGCCTGTAGCTCAGTGGTTAATAATAAGAAAAAAGAAAAAA","GGCCAGGTGCAGTGGCTCACACCTGTAATCCCAGCACTTTGGGAGTCTGAACCAGGCAGATCACCTGAGGTCAGGAGTTCGAGGCCAGCTCGGCCACCATGGTGAAACCCTGTTTCTAATAAGAATACAAAAAAA"
"GL873589","9085767","9086002","chr7","84631446","84631650","75","75545679","GAGTGAAACCCTGTCTCTACTAAAAATAGAAAAACTAGCTGTGCATCAGGGCGCATAACTGTAGTCCCAGGTACTCAGGACACTGAGGCAAGAGAATTGCTCAAGCCCAAGAGTTTGCAAGAATTTGAGGTTGCTATGAGCTATGATGCCATGGCACTCTACCTAGGGTGACAGACAGAGACTCTGTCCCAAAAAAAAAAAAAGAAGAAGAAGAAAAAAAAAAAGAAAGAAAGAAA","ATAGTGAAACCTCGTCTCTACTAAAAATACAAAAATTAGCTGGGCATCATGGTGCACGCTTGTAATTCCAGCTACTTGGGAGGCTGAGGCAGGAGAATTGCTTGAACTCAGGAGGTGGAGGTTGCAATGAGCCAAGATCGCGCCACTGCACACCAGCCTGGGTGACAAAAGACTCTGTCTCAAAAAAAAAAAAAAAAAAAAAAAA"
"GL873589","9992904","9993045","chr16","56427538","56427666","46","46434634","AACCAGCCAGGCATGGTGATTCACACCTATAATCCCAGCTACTTAGGAGTATGGCTTGAGCACACAGGATACCATACCATTCTAGTCATCCCAGGCAACAGAGGGAAACTCTGTTGGTTAAAAAAAAAGAAAAACTTAAAAA","TTAGCCAGGAGTGGTGGTGCACGCCTATAATCCCAGCTACTTGGGAGGCTGAGGCACAAGAATCACTTGAACCATTGCACTCCAGCCAGGGTGATAGAGGGAGACTCTATCCAAAAAAAAAACAAAAAA"
"GL873589","9993319","9993452","chr3","2774534","2774668","28","7218785","GGCCTGAGCCCTGTGACTCATGCCTGTAATCCCAGCACTGGAAGTTCCAAGGCAGGTGGATCGCTTGAGCTCTGGAGTTCAAGACCAGCTCAACCAAGAGTAAGACCCCATCTCTACTAAAAATAGAAAAACCA","GGCTGGGCACGGTGGCTCATGCCTGTAATCCCAGCACTTTGAGAGGCCGAGGCAGGTGGATCTCCTGAGGTCAGGAGTTCAAGACCAGCCTGGGCAACATGGTGAAACCCCATCTCTACTAAAAATACAAAAAAT"
"GL873590","9044589","9044884","chr1","83754525","83754835","84","74709936","GGCCAGGTGCAATGGCTCATGCCTATAATCCTCACACTCTGGGAGGCTGAGGCAGGAGGATCACTTTTCTCAGGGTCAGGGCCAGCCTGACAAAAGTCAGACCCTGTTTCTACTAAAAATAGAAAAACTAGCTGGGTGTTGTGGCAGATGCCTATAGTCCCAGCTACTAAGAGACTGAGACAAGTGCCCAGAGTCTGAGGTTACTGTGAGCAAAGCTGATGCCATAGCATTCTAGCTATAGATCGAGAGTCTGTCTCAAAAACAAACAAACAAACAAACAAACAAACAAAAAAGAA","GGCTGGGTGTGGTGGCTCATGCCTGTAATCCCAGCACTTTGGGAGGCCGAGGCGGGTGGATCATCTGAGGTCAGGAGTTCAAGACCAGCCTGACCAACATGGTGTAACCCTGTCTCAACTAAAAATACAAAAATTAGCTGGGCGTGGTGGTGTGCACCTATAGTCACAGCTACTTGGGAGGCTGAGACAGGAGAATTGCTTCAACCCAGGAAGTGGAGGTTGCAGTGAGCCAAGATCATGTCACTGCACTGCAGCCTGACAGAGCGAGACTCCATCTAAAACAAACAAACAAAAACAAACAAACAAACAAA"
"GL873591","1831505","1831587","chr17","61702818","61702899","25","59871313","CCCAGCACTTTGGGAGGGCAAGATGGGAGAATCATATAAAGTCAGGAGTTTGAGACCAGTTTGGCAGACATGATGAACCCATC","AATCCCAGCACTTTGGGAGGCTGAGGCAGGCGGATCATCTGAGGTCAGGAGTTCAAGACCAGCCTGGCCAACATGGTGAAAC"
"GL873591","2719175","2719275","chr4","86137755","86137847","32","83418580","GTGGGGGCTTAGGCCTGTAATCCCAGCACTCTGAGAGGCCAAGGTGAGCTGGTCACCTGGGTTTAGGAGTTTGGAGACTTGCTCGAGCTAGACTGAGGCTC","GTGGTGGCTCACGCCTGTAACCCTAACAATTTGGGAGGCCAAGGCAGGTGGATCACTTGAGGTCAGAAGTTTGAGACCAGCCTGGACAATATG"
"GL873591","4732974","4733120","chr19","7991801","7991954","55","3258827","ATACGCAGACTGGCCGAGCGTGGTGTCACATGCCTATAATCCCAGTGGCTACTCTGGGGAGGAGAATCTCTTGAAACCAAGAGTTAGAGATTGCAGTGGGGTATGATACAGGGTAACAAAGAGAGACCTTGGATCTGAAAAGAAAAA","AAAATACAGAAACTAGCTGGGCATGGTGATGCACACCTGTAATCCTAGCTACTGGGGAGGCTGAGGCAGGAGAATTGCTTGAACCCAGGAGTCAGAGGTTGCAGTGAGCAACCAGCCTGGGTGATACAGTGAGTGAGACTCTGTCTCGAAAAAA"
"GL873591","6822728","6823009","chr1","20579766","20580052","72","13757038","GGCCAGGCGTGGTGGCTCATGCCTGTAAATCTCAGCACTCTGGGAAGCTGAGGCAGGTGGATTGCTTGAGGTCAGGAGTTTGAGACCAGCCTGTACCAGAGTAAGACCCTGTCTCTAATAAAAATAGAAAAAAAAAAAAAAACTAGTTGGGCATGGTGATGGGTGCCTGTAGTCCCACCTACTTGGGAGGCTGAGGCAATGGCATCTCTTGAGCCCAAGAGTTTGAGGTTGCTGTGCCATGGCACTCTCCCCAGGGTAACAGAGTGAAAATAAAAAAAAGAA","GGCCAGGCGTGGTGACTCATGCCTGTAATCTCAGCACTTTGGGAGGCCGAGGCAGGTGAATCACCTGAGGTCAGGAGTTTGAGACCAGCCTGACCAACATGGTGAAACCTCGTCTCTACTAAAAATACAAAAAGTAGCCAGGCATGGTGGCGCATGCCTGTAATCCCAGCTACTTGGGAGGCTGAGGCAGGAGAATCGCTTGAACCCGAGAGGCAGAGGTTGCATTGAGTCAAGATGGTACCACTGCACTCCAGCCTGGGTGACAGATTGAGACTCAAAAAAAAAAA"
"GL873591","7578706","7578813","chr16","45055441","45055543","42","37476735","AAATTTAGCTACACATAGTGGCATGAGTCTGTAATGCTAGCCACCCAAAAGGCTGTAGTAAGAGGATTGCTCTATCCCAGGAGTTAAAGACCAGCCCGGACATCAGAG","AATTAGCCGGGCGTGGTGACACACACTTGTAATCCTAGATACTCAGGAGGCGAAGGTAGGAGAATTGCTTGAACCCAGGCAGCAGAGGTTGCAACGAGCAGAG"
"GL873591","9282916","9283004","chr1","20744253","20744338","16","11461337","GGCCAGGCGCGGTGGCTCACCCCTGTTGTCCCAGTTCTGTGGGAGGCCGAGGTGGGTGGATCACCTGTGCTCAGAGGTTTGAGACCAGC","GGCCAGGCACGGTGGCCACGCCTGTAATCCCAGCACTTTGGGAGGCCGAAGTGGGTGGATTACCTGAGGTCAAGAGTTTGAGACCA"
"GL873592","835155","835315","chr16","75654291","75654451","43","74819136","CTGGGTGTGGTGGCTCTTGTCTGCAATCTCAGTACACTGGGAGGCTGAGGCAGAAGGATTGCTCCAGCTCAGGAGTTTGAGGCCAGGCTGAGCTAGTGCAAAACCCCATCTCTACTAAAAAAAGAAGGAAAAAAAAAAGAAAAAGAAAAAAAATACGAGCT","CCAGGTGTGGTGACTCACGCCTGCAATCCCAGCACTCTGGGAGGCTGAGGTGGGTAGATTACCGGAGGTTAGGCGTTTGAGACCAGCCTGGCCAACATGGTGAAACCCCATCGCTACTAAAAAAAAAAAAAAAAAAAAAAAAAAAAAAAAAAAAAAAATTA"
"GL873592","835589","835765","chr1","66836166","66836336","48","66000577","ACAAAAAACCTAGCTTAGGGTTGTTATAGCACCTGTAGTCCCAGCTACTCAGGCGCTAAGGCAGGAAAATCTGCCTGAGCTCAGGAGTTTGAGGTTGCAGTAAGTTATGATGATGCTACTGCACTCTAGCTGGGGCAACAGAGTGAGACTCTGTCTGAGGAAAAACCAAAACCAAAA","TAGCCCAGCACGGTGGCTCACACCTGTAGTCTCAGCTACTCAAGAGGCTGAGGCATGAGAATCGCTTGAACCCAGGAGGTAGAGGTTGCAGTGAGCTGAGATCATGCCACTGCGCTCCAGCCTGGGCAACAGAGTGAGACTCAGTCTCAAAAAACAAAACAAAACAAAAAA"
"GL873592","2520661","2520705","chr16","66853217","66853257","11","64332556","TCTGGGAGGCTGAGGCGGGTGGATCACCTGAGCAAGAGTGAGACC","TTTGGGAGGCTGAGGCAGGTGGATCACTTGAGGTCAGGAGT"
"GL873592","4535248","4535388","chr1","12240468","12240612","38","7705220","GGCGGGATGTGGTGGTTCATGGCTGTAATCCCAGCACTCAGGGAGGCTGAGTCGGGTGGATTGCTTGAGTTCAGGAGTTTGAGACCAACCTGAGCAAGAACTAAGCCTGTCTCTACTAAAGATATTATTTCTTATTTTTCT","GGCCGGGCGCGGTGGCTCATGCCTGTAATCCCAGCACTTTGGGAGGCTGAGGCGGGTGGATCACCTGCGGTCAGGAGTTCGAGACCAGCCTGGCCAACGTGGTGAAACCTCATCTCTACTAAAAATATAAAAATTAGCTGGTGTG"
"GL873592","4535654","4535831","chr8","126054004","126054184","54","121518350","TCTACTACAAATATTAACAGAAAAATTAGCTGGGCATTGTGACAGGTGCCTATAGTCCCAGATACTCAGAAGGCTGAAGTAAGAGGATCACTTGAACCCCAGGAGCTAAGGTGGCTGTGAGCTAGGCTGAGGCTCTAGCCTGGGTAACAGAGTGAGACTGTAAAAAAAGAAAGAGAGA","GTCTCTACTAAAAATACAAAAATTAGCTGGGTGTGGTGGTGCATGCCTGTAATCCCAGCTACTCAGGAGGCTGAGGCAGGAGAATCGCTTGAACCCAGGAGGTAGAGGTTGCAGTGAGCCAAGATCATGCCACTGCACTCCAGCCTGGGTGACAGAGGGAGACTCTGTCTCAATAAATAAA"
"GL873592","6794968","6795049","chr3","154764711","154764794","20","147969743","GAAGGTTTGATGAGCTCAGATGATGCCACTGCAGTCTACCCAGAGTGAAGGAGCGAGACTCTGTCTCAAAAACAAAAAAAGA","CAGAGGTTGGCAGTGAGCTGAGACTGTGCCACTGCACTCCAGCCGGGTGACAGAGTGAGACTCTGTCTCAAATTACAAACAAAA"
"GL873592","6881384","6881478","chr5","24882384","24882475","28","18001000","GGGCAGGCATAGTGACTGGTGTCTCTAATCCTAGCAGTCTGGGATGCTGAGGCAAGTGGAATGTCAGAGTTCAGGAGTTGAAGATCACCCTGACT","GGCCGGGCGCAGTGGCTCACATCTATAATCCTAGCATTTTGGGAGGCTGAGGCAGGCGGATCACCTGAAGTCAGGAGTTTAAGACCAGCCTG"
"GL873592","6881755","6881937","chr10","61601371","61601572","66","54719616","TCACCCTGACCAAGAGCAAGACCCTGTCTCTACTAAAAATAGAATAAACTAGCTGGGAATTGTGGTGGGTGCCAGTAGTCCCCGCTACTGAGGCAGGAGGATCATTGAGTCCAAGAGTTTGAGGTTGCTGTAAGTTAGGACACCACAGCACTCTACACAGAGTAAGACTGCCTCAAAAATAAA","AGTAAAGAAAAGAAACCCTGTCTCTACTAAAAATACAAAAATTAGCTGGGTGTGGTGGTGCGCACCTGTAGTCCCAGCTACTTGGGAGGGTGAGGTATGGGAATCACTTGAACCCGGGAGGTGGAGGTTGCAGTGAGCCAAGATCACACCACTGCACTCCAGCCTGGGTGAGAGAGTGAGACTCTGTCTCAAGAAAAAAGAA"
"GL873592","7006080","7006155","chr1","8947061","8947129","24","1940981","CACACTGAGAGGCAAAGGCTGGTGGATCACCTGAGCTCAAGAGTTTGAGACCAGCCAAGCCAGAGATCTTGTCTCT","CACTTTGGAGCCAGGTAGGTGATCACCTGAGTCAGGAGTTCGAGACAGCCTGGCCAACATGTGAAACCC"
"GL873592","8446508","8446655","chr11","122502739","122502874","48","114056231","TTAGCTGGGTGTTGTGGCAGGCACCTGTAGTCCCTCCCAGCTACTTGAAAGGCTGAGGCAAGATGACAGCTTAAACCCAAGAGTTTAAGGTTACTCTATTCAGGGCAACAGAGTGAGACTCCATCTACATAAATAAATAAATAAATAA","GGCTGGGCGTGGTGGTTCACACCTGTAATCCCAACACTTTGGGAGGCTGAGGCCAGCGGATTGCCTGAGCCCAGGAGTTTGAGACCAACCTGGGCAACATGGTGAAACTCCATCTCTACTAAAATACAAAAAGTTA"
"GL873592","8446953","8447008","chr16","44513352","44513404","15","36066399","GACCAGCCTAAGCAAAAAAGAGATCCTATCTCTACTACTAAAAATAGAAAAAATTA","ACCAGCCTCACCAATATGAAGAAACCCCATCTCTACTAAAAATACAAAATATT"
"GL873592","8447239","8447325","chr1","8062863","8062957","21","384376","GGCCAGGAGCAGTGACTCATGCCTAGCACTCTGGGAGGCCAAAGCAGGTGGATCAACTGAGCTCAGGAGTTCAAGACCAGCCTAAGC","GGCCGGGTGCAGTGGCTCATGCCTGTAGTCCCAGGACTTTGGCAGGCCAAGGCCGGTGGATTACCTGAGGTCAGGAGTTCAAAACCAGCCTAGCC"
"GL873592","8723925","8724000","chr3","42066983","42067054","20","33343058","AATTAGCCGGGCATGGTAGTGTGTGCCCATAATCTCAGCTACTCAGAAAGCTAAGATAGGAAAATTGCTTGAGCTC","TTAGCTGGGTGTGGTAGTGCATGCCTATAATCCCAGCTACTCGGGAGGCTGAGGTGGGAGAACTGCTTGAAC"
"GL873593","384022","384146","chr15","102382935","102383070","28","101998913","GGCCACGAGGGCCCATGCCTGTAATCCTAGCACTCTGGGAGGCTGAGGTGAGTAGATTGCTGAGCTCAGGAGTTCAAGACCAGCCTGTGCAAGAGACCCCATCTCTGCTAAAAATAGAAAAACCA","GGCCAGGTGTGGTGGCTCACGCCTGTAATCCTAGCACTTTGGGAGGCTGAGGCGGGTGGATTGCCTGAACTCAGGAGGTCAAGACCAGCCTGGGCAACACAGTAAAACCCCATCTCTACTAAAATACAAAAAATCA"
"GL873593","384425","384607","chr20","28286874","28287058","50","27902449","GAAAGAAAAGAAAAGAAAAACTAGCAAGATGTTGTAGCTGATGCCTATAATCCTAGCTATTGGAGAGGTGGAGGCAAGAGAATTGCGTGAGCCCAAGAGTTGAAGGTTGCTGTGAGCTGCGATGCCAGAGCACTCCAGGGTGACAGAGTAAGACTCTGTCTCAAAAAAAATTACAAAATAAAA","TAATAAAAATAAAAAAATTAGCCAGGAGTCAAAGCACACGCCTATAACCCCAGCTACTTGGGAGGCTGAGGGAGGAGAATTACTTGAACCCGGGAGGTGAAAGTTGCAATGAGCTGAGATCAAGCCACTGCACTCCAGACTGGATGACAGAGTGAGACTCTGTTTCAAAAAAAAAAAAAAGACAA"
"GL873593","1408445","1408467","chr10","88070368","88070389","9","86661923","AATCTAGAGATGGGGAGAGGTTG","AAAGAGATGGAAGAGAAGAAGA"
"GL873593","4856365","4856484","chr7","56497314","56497433","31","51640949","GCAATCCCAGCTGATCGGGAGGCTGACCCAGAAGAATCCCTTGAACCCAAGAGTCTGAGGTTGCTATGGGTGGATTCTACAGCACTCTAGCCTGGGAGACAGAGTGAGACTCTGTCCCAA","ATCCCAGCTACTTGGGAGGCTGAGACAGAAGAATTGCTTGAACCCGGGAGGTGGAGGTTGCAGTGAGCCAAGATTGTACCACTGCACTCCAGCCTGGCAACAGAGTGAGACTCTGTCTCA"
"GL873593","6661298","6661485","chr10","86749316","86749514","55","80088018","GCAGAGGCTCACATATGTAATCCTAGCACTCTGGGAGGATAAGGCAGGTGGACAGCTTGAGCTCAGGGGTTTGACCAGTCTGATCAAGAGCAAGACCTGTGTCTACTAAAAATAGAAAACCTAGCCAGGTATGATGGTAGATGCCTGTATTCCTAGCTACTCTGGAAGCTAAAGCTAAAGAGTTTGAA","GGTGGCTCACACCTGTAATCTTAGCAATTTGGGAGGCCGAGGTGGGTGGATCACTTGAGGTCAGGAGTTTGAGACCAGACTGGCCAACATGGTGAAACTCTGTCTCTACTAAAAATACAAAAATTAGCCAGTCATGGTGGTGCATGCCTGTAATCCCAGCTACTCAGGAAGCTTAGGCAGGAGAATCACTTGAACCCAG"
"GL873593","6710263","6710446","chr14","4390080","4390244","66","2320183","TTGAAGTCAGGAGTTTAAGGCCAGTCTGGGCAACATAGTGAGACCCCCATCTCTACGAAAATATTTTTTAAAAATTAAAAATAGCTGGGCATAGTGAGGCTGTTGTGAGCTATAACTGCACCACTGCACTCAGCCAAGGACAGAGACCCTGTTCCCTGCCTCAAACAAACCAAAACAAAACAAA","AAGTCTAGAGTTTACAGCCTGGACAACGCAGTGAAACCCTGTCTCTACCAAAAATACAAAAATTAGACAGGTGTGAGAGGCGGAGGTTGCAATGAGCTGAGATCGCAGCACTGCAGTCCAGCCTGGATGACAGAGCGAGACCCCATCTCAAAAACAAAAACAAAA"
"GL873593","7159645","7159716","chr6","178318394","178318465","21","171158749","GATCATGTCACTGCTCTCCAACCTGGGCAATTGAGCAGGAATCTGTCTCAAAAAGAAAAAAAAAAAAGAAAA","CGAGTTCACACCACTGCACCCCAGCCTGGGCAACAGAATGAGACTCGGTTTCAAAAAAAAAAAAAAAAAAAA"
"GL873593","7159841","7160050","chr13","33368171","33368368","69","26208330","GGCCAGGCGTGGTGGCTCACACCTGTTGTCCCAGTGCTGTGGGAAGCCGAGGCAGGTGGATCACCTGAGCTCAGCCGAGTTCGAGACCAGTGGAAGACCAGCATGAGGCAGAGTGAGCCAGAGTGAGACCCCATCTCTACAACAACAACAAGAAGAAAAAAAACAGCCGGACCTTGTGATCCCAGCTACGTGGGGAGCTAGAGAATCACT","GGCTAGGCATGGTGGCTCATGCCAGTAATCCCACCACTTTGGGAGGCCGAGGCAGGTGGATCACCTGAGGTCAGGAGTTCAAGACCAGGCTGGCCAACATGTTATGATGAGACCCTCATCTCTACTACAAATACAAAAATCAGCTGGGCATGGTGGCAAGTGCCTGTAATCCCAGCTACTTGGGAGGCTGAGGCAGAA"
"GL873593","8598292","8598391","chr11","118461023","118461129","33","109862731","AGCCAGGTGAGGTGGTTCACACCTGTAACCCTAGCTGCTTGGGAGGCTGAGGCCTCTCTATCCTGGGCAGTGTGGAGAAACTTTGTTTCAAAAAAAAGAA","GCCGGGCGCGGTGGCTCACGTCTGTAATCCCAGCGCTTTGGGAAGCCGAGGCGGGACTATCCTGGCCAACATGGTGAAACCCCGTCTCTACTAAAAATACAAGAATC"
"GL873594","357249","357377","chr2","75702890","75703011","36","75345641","CCTGGTACCGTAGGTCATGCCTGTAATCCTAGCACTTTGGGATGCTGAGGTGGGCAGATTGCCTGAGCTCACGAGTTCAAGCCATTAGAACTGAGCCTGACCTAGAGTGGGACCTCCAACTCTTTTTTT","GCCAGGCACAGTGGCTCATGCCTGTAATCCCAGCAGTTTGGGAGGCTGAGGTGGGCAGATCACTTGAGGTCAGGAGTTCAAGACCAGCCTGGCTGACATGGTGAAACCCCATCTATACCAAA"
"GL873594","357656","357834","chr7","17608776","17608965","55","17251120","GGGACCTCCAACTCTTAAAATAGCTGGGCATTGTGGTGGGCACCTACAGTCACAGCTACTTGGGAGGCTAAGGCAAGAGACTTGTTTGCAGCCAAGAGTTAGAGGTTGCTGTGAGCTATGAGGCTAGGGCACTCTACAGGGGGCGACAAGTGAGACTGTAAAAAAAAAAAAAGAAAAAA","GTCCCTACTAAAAATACAAAAAATTAGCTGGGCCTGGTGGCAGGCACCTGTAATCCCAGCTACTTGGGAAGCTGAGGCAAGAGAATTGCTTGAACCCAGGAGGCAGAGGTTGCAGTGAGCTGACATCAAGCCACTGTACTCCAGCCTAGGCAACAAGAGCAAGACTCTGTCTCAAAAAAAAAAAAAAAAA"
"GL873594","1410711","1410996","chr5","151340503","151340797","76","149929792","CACAGTGGCTCATACCTATAATCCTAACACTCTGGGAGGCCAAGGTGGGTGGACTGTCTGAGTTTGGGACCAGCCTGAGCAAAAGCAAGACTCCCATCTCTACTAAAAACAAAGACAGCCAGGTATGAGGGCAGGTGCCTATCATCCCAGCTACTTGGGAGGCTGAGGAAGGAGGATCACCTAAGCCCAGGACTTTAAGGTTTCTGTGAACTAAGATGATGTTACAACACTCTAGCCAGGGTAACAAGGCAAGATTCTGTTTCAAAAGACAAAAAAAAAAAAAAAA","GGTGGTTCATGCCTGTAATCCCAGCACTTTGGGAGGCTGAGGCAGGTGGATCACCTGAGGTCAGGAGTTCGGGACCAGCCTGGCCAACATGGGGAAACCCCATCTCTACTAAAATACAAAAATTAGCCAGGTATGGTGGCACATGCCTATAATCCCAGCTACTTGGGAGGCTGAGGCAGGAGAATCACTTGAACCCAGGAGGCTAAGGTTGCAGTGAGCCGAGATTGTGCCACTGTACTCCAGCCTGGGTGACAGACTGAAACTCTGTGTCCAAAAAACAAAACAAAACAAAAAA"
"GL873594","5528090","5528162","chr2","69013639","69013718","24","63485549","GGTACAGTGGCTCACGCTTGTGATCCCAGGTTGAGGTGGGTGGATCGCCTGAGCTCAGGAGTTGGATGCCAGC","GGTGTGGTGCCTCACGCCTATAATCCCAGCACTTTGGGAGGCAGGTGGATCACTTGAGGTCAGGAGTTTGAGAACAGCCT"
"GL873594","5834047","5834168","chr2","82491537","82491662","28","76657490","GGCTGGGCCCAGTAGCTCACGACTGTAATCCCAGCACTCTGGGAAGCTGAGGTGGGCGGATCACCTGAGCTCATAGGTTCGAGACCAGCTCCAGTTAGAGTGAGAGCCTGTCTCTAAAAATA","GGCTGGGCACAGTGGCTCATGCCTGCAATCCCAGCACTTTGGGAGGCTGAGGTGGGCAGATCACCTGAAGTCAGGAGTTCAAGACCAGCCTGGCCAACACAGTGAAACCCCATCTCTACTAAAAAT"
"GL873594","5834396","5834461","chr13","14688151","14688212","20","8853755","TATATAATAATAATAACCAGGTATTGTGGCAGGTGCCTCTAGTCCCAGCTACTCGGGAGGCAAAGG","ATAAAAAAATTAGCTGGCCATGGTGGCACATACCAATAATCCCAGCTACTCAGGAGGCTGAG"
"GL873594","7786130","7786294","chr14","12217087","12217250","37","4430957","GGGTGTGCTGGCTCATACCTATAATCCTAGCACTCTGGGAGGCTGAGGTAGGTGTATTGCTTGAACCCAGGAGTCTGAGGTTGCTGTGCGCTAAGCTGATACCATAGCACTCTAGCCTGGGCAACAGAGTGAGACTCTGTCTCAAAACAAATAAATAGTAAAAAA","GCTGGGCGTGGTGGCTCACACCTGTAATCCCAGCACTTTGGGAGGCCAAGGCATGAGAATTGCTTGAAAACAGGAGGCGGAGGTTGCAGTAAGCTGAGACTGTGCCATTGCACTCCAGCCTGGGCAACAAGAGTGAAACTCTGTCTCAGAAAAAAAGAAAAAAA"
"GL873595","723579","723774","chr19","6045933","6046125","65","5322354","GCCTGAGCAGGAGAGAGACCCCATCTCTGCTGAAAGTGGAAAAGTTGGCTGAGTGTAGTGGCGGGCTGCTGCCCCAGTCACTCAGGAGGCTTAGGAAGGAGTATCGCTTGGGCCCAAGATTTGAGGTTGCTGTGAGCGCTACAAAGACATTAGGGTACTCTACACAGGGGAATAGAGTGAGACTGTCTCAAAAAAA","CAACATGGAGAAACCCCGTCTCTACTAAAAATACAAAATTAGGCAGCGTGGTGGTGGGTGCCTATAATCCCAGCTACTCAGGAGGCTGAGGCAGGAGAATCGCTTGACCGGGAGTGGAGGTTGCGGTGAGCTGAGATTGCACCATTGCACTCCAGCCTGGGCAACAAGAGTGAAACTCCGTCTCAAAAAGAAA"
"GL873595","724114","724204","chr20","18199749","18199840","22","17475635","GGCCATGCTTGGTGGTTCTCATCTGTAATCCTAGCACTCTGGAAGGTCTACAGGGGTGGATGGCTGGAGGTCAGGAGTTCAAGACTGGCCT","GGCCGGGCATGGTGGCTCACACCTGTAATCCCAGCACTTTGGGAGGCTGAGGCAGGCGGATCACCTGAGGTCAGGAGTTCGAGACCGGCCTG"
"GL873595","1065346","1065667","chr18","10529729","10530057","74","9464383","GGCCAGGTGCAGCAGCTCATGCCTGGAATCTTCCTGCTCTGTATGGCCAAGGCAGGTGGATCGCCTGACCTCAGGAGTTCCAGACCAGCCTGAACAAGAGCAAGACTCTGTCTCTACTAAAAGTAGAAAAAAAACTAGCCAGTCATAGTGGCAGGTGCCTGTAGTCCCAGCTGCTTGGGAGGCTGAGGCAAGAGGATCACTTGAACCTAAGAGTTTGAGGTTGCTGTGAGCTAAGATGCCACATCACTCTATCAAGGGTGACCAAGTGAGACTCTGTCTCAAAAATAAATAAATAAATAAATAAAAAGAAAGGCAAAAAGAA","GGCCCGGCGTGGTGGCTCATGCCTATAATCCCAGCCCTTTGGGAGGCCAAGGCAGGTGGATCACCTGAGGTCAGGCGTTCGAGACCAGCCTGACCAACGTGGTGAAACCTCATCTCTACTAAATACAAAAAAAATTTAGCCAGGCATGGAGGCACATGCCTGTAATCCCAGCTACTTGGGAGGCTGTGGCAGGAGAATCACTTGAACCTGGGAGGTGGAAGTTGCAGTGAGCTGAGATTGTACCACTGCACTCCAACCTGGGTGACAAAGCAAGACTCGGTCTCAATAAATAAATAAATAAATAAATAAATAAATAAAGTGAAAAAAAA"
"GL873595","1254878","1255146","chr4","42822326","42822607","67","41567448","GGCTGGGCATGGTGGCTCATGCCTGTAATCCTACCGCTCTGGGAGGCTGAGGCAGAGGATCACTTGAGCTCAGGAGTTTCAGACCAGCCTGCAAGAAGGACCCAGTCTCTGCCGAAAATAGAAAAGTTAGCAAGGCGTTGTCGTGAGCACATGTATCCCAGCTACCTAGAACTCTGAGGCAGGAGGATCCCTTGAACCCACAGAAGTTGCTGTTATCTAAACTGATGCCACTGGACTCTAGCCTGGGCAACAGAGTGAGACTGGTCTCA","GGCCGGGCACGGTGGCTCATGCCTGTAATCCTAGCATTTTGGGAGGCTGAGACAGGCAGATTGCCTGAGCTCAGGAGTTCAAGACCAGCCTGGGCTAGATTGTGAAACCCCATCTCTACTAAAATATAAAAATTAGCTGGGTGTGGTGGCACACGCCTGTAATCCCAGCTACCTGGGAGGCTGAGGCAGGAGAATCGCTTGAACCAGGAGACAGAGGTTGCAGTGAGCTGAGATCACGCCACTGCACTTTAGCCTGGGCAACAGAGTGATACTCTGTCTCAA"
"GL873595","3417105","3417297","chr12","115674238","115674427","44","112257133","GGCCGGGCGCTGTGCCTCACGCCTGTAATCCTAATACTCTGAGAGGCCGAGGCAGGTGGATTGCCTGAGCTCAGGTGCTCAAGACAGCCTGACTGAGCAAGCCCTGAGATCCCATCTCCACTAACAATAGTAAAACTAGCCGGGCATTGTGGTGGTGCTTGTAATCCCAGCTACTGGGAGGCTAAGACAGGAG","CCAGGCCTGGTGGCTCACGCCTGTAATCCCAGCACTTTGGGAGGCCGAGGTGGGTAGATCACCTGAGGTCAGGAGTTCAAGACCAGCCTGGCCAACATGGCGAAACCCCATCTCTACTAAAAATACAAAAATTAGCTGGGCATGGTGGTGTATGCCTGTAATCCCAGCTACTCGGGAGGCTGAGGCAGGA"
"GL873595","6098380","6098457","chr3","87492619","87492702","21","81394239","GCTGTGGCTCATGCTGATAATACCAGCACTCTGGGAGAACAAGGTAGGCAGATCACAAGAGGTCACCTGTGCAAGACC","GGGCTGGTGGTGGCTCATGCCTGTAATACCAGCACTTTGGGAGGCCAAGACAGGTGGATCACCAAAGGTCAAGAGTTCAAGACC"
"GL873596","134190","134307","chr1","203207333","203207443","31","203073143","GGCTGGGCGAGGTGGCTCACACCTGTAATCCTAGCACTCTGGAAGGCCCTAGCACTCAGGCAGTTGGATTGCCTGAGCTCACAAGTTCAAGACCAGCCTGAAAAAGAGCAAGACCTCA","GGCTGGGTGCAGTGGCTCACACCTGTAATCCCAGCACTTTGGGAGGCCGAGATGGGTGGATCACTTGAGGTCAAGAGTTGAAGACCAGCCTGGACAACATGATGAGACCCC"
"GL873596","134578","134681","chr11","50235285","50235387","37","50100707","CAAACAAAAGAGGAAGACCTCGTCTCTAAAAAAATAGCTGGGCATTGTGAGGAGTACCTGTAGTCCTAGCTACTCAGAAGGCTGAGACAAGAGAATCACTTAAA","CAACATTGTGAAACCCTGTCTCTACTAAAATAGAAAATTAGCCAGGTGTGTGGGCGTGCCTATAATCCTAGCTACTGGGGAGGGTGAGGCATGAGAATCGCCT"
"GL873596","8160215","8160350","chr1","29437872","29437991","30","21277657","GGCCGGGCGTGGTGGCGCACACCTGTAGTCCCAGCGCTATGGGAGGCCGAGGCGGGTGGATCACCTGAGCTCAGAGGTTCGAGACCAGCCAAGACCCCCCTGAGCCAAACGAGCCAGAGTGAGACCCCGTCTCTAC","GGCCGGGCGTGGTGGCTCACGCCTGTAATCCCAACATTTTGGGAGGCCAAGGCGGGTGGATCACCTGAGGTCAGAAGTTCGAGACCAACCTGGCCAACATGGTGAAACCCCTGTCTCTAC"
"GL873596","8421071","8421132","chr20","1874027","1874093","12","6547044","GTCAGGCGCAGTGGCTCACGCCTGTAATCTCAGCACTCTGAGAAGCCAAGGCAGGATCATCT","GGCCAGGCGCAGTGGCTCAGGCCTGTAATCCCAGCACTTTGGGAAGCCAAGGTGAGCAGATCACCTG"
"GL873598","4416400","4416489","chr5","39418145","39418231","15","35001745","GGCCAAGTGTGGTGGCTCATGCCTGTTGTCCCAGCACCGTGGGAGGCCGAGGCTGGTGGAACACCTGAGCTCAGCTGAGTTTGAGACCAG","GGCCAGTTGCGGTGGCTCATGCCTGTAATCCCAGCACTTTGGCAGGCTGAGGCAGGTGGATCACCTGAGGTCAGGAGTTTGAGACCA"
"GL873598","4416855","4416947","chr3","94091253","94091337","31","89674398","GTGAGACCCTGTCTCTACAAAAAAAAAAGCTGGGCACTGTGGCATGTGCCTGTAATCCCAGCTACTTGGGAGGCAAAGGGAAAGAGAATCACT","AAACCTTGCCTTTACTAGAAATACAAAAATTAGCTGGGCATGGTGGCAGGTACCTGTAATCCCAGCTACTTGGGAGGCTGAGGCA"
"GL873598","5126074","5126161","chr1","12339306","12339394","19","7213232","GCCTGGTGCACTGGTTCACACCTGGAATCCTTGCATTCTGAGAGGCCCAGGTAGGCAGATCACCTCAGCTCAGAAGTTCGAGACCAGC","GCTGGGTGCGGTGGTTCACGTCTGTAATCCCAGCACTTTGGGAGGCCGAGGCGGGCAGATCACCTGAGGTCAGGAGTTCGAGACCAGCC"
"GL873598","5467584","5467662","chr1","9313328","9313403","17","3845744","GCGAGGTGGCTCACGCCTGTAATCCCAGCACATTTGGAAGGCCAAGGAGGGTGGATCACCCGAGCTCACCAGTTGGAGA","CGCAGTGGCTCACGCCTGTAATCCCAGCACTTTGGGAGGCCGAGGCAGGCAGATCACCTGAAGTCAGGAGTTTGAG"
"GL873598","6917752","6917856","chr14","9558287","9558382","22","2640535","GGCCAGGCATGGTGGCTTGTGCCTGTTGTCCCAGCACTGTGGAAGGCCGAGGCGGGTGGATCGCCTGAGCTCAGCTGAATTCGAGACCAGCATAAGACCAGTATG","GGCCAGGCATGGTGGCTTATGCCTGTAATCCCAGCACCTTGGAAGGCCGAAGCGGGCAGATCACCTGAGCTCAGGAGTTTGAGACCAGCCTGTCCA"
"GL873598","8078910","8079062","chr7","164825511","164825660","43","156746601","AACAGCCAGGCATTGTGGTGGGCACCTGTAATCCCAGCTACTTGGGAGGCTGAGGCAAGAGAATTGCTTGAGCCCAACAGTCTCAGGTTACTGTGAGTTATGACACCATGGCACTCTATTGAGGGCAAGAAAGTGAGACTGTCTTGGAAAAAA","CTAGCCAGGCATGGTGGTGCGCACCTGTAGTCCCAGTTACTTGGGAGGTTGAGGCAAGAGAATTGCTTGAGCCTGGAAGGCAGAAGTTGCAGTGAGCTGAGATCACACCACTGCATTCCAGCCTGGGCGAAAGAGCAAGACTCTGTTGAA"
"GL873598","8079328","8079454","chr6","10381248","10381379","32","2301920","GCCCGGCGTGGTGGCTCACGCCTGTAATTCCAGCACTCTGGGGAGGCCGAGGAGGGCAGATTGCCTGAGCTCACAGGTTTGAGCTAGAGCGAGACCCTGTCTCTTAAAAAGAAAAAAAAGGAAAGAA","GCTGGGCGCGGTGGCTCACGCCTGTAATCCCAACACTTTGGGAGGCCGAGGCGGGCAGATCACCAGAGGTGATCTCCAGCCTGGGCAGGAGAGCAAGACCCTGTCTCAAAAAATTTAGAAAAAGGAAAGAAA"
"GL873599","3943256","3943456","chr9","35892110","35892312","79","31948854","GGCAGGCTGCTTTGACCCATATCTACAACTCCAGAACTTTAGAGGCTGAGCTGGGTGGGTCCCTTGAGATTAGAAACTGCTTAGTAGCCTGGCAAAAACCAGACCCCACCTCCACCATGTAGAAAAATTAGCAGTATGCCATAGTGGGAACCTACCAATACAGTCTTTCCAAAGGCCAAAGCTAGAAGGACCGTGAGCTTG","GGCTGGGTGTGGTGGCTCATGCCTATAATTCCAGCACTTTGGGAGGCCGAGGCAGGTGGATCACCTGAGGCCAGGAGTTTGAGACCAGCCTGGCCAATATGGTGAAACCCCATCTCTACTAAAAGTACAGAAAATTAGTCAGTCATGATGGCGCATGCCTATAATCCCAGTTACTCGGGAGGCTAAGGTAGGAGAATTGCTTG"
"GL873599","6693284","6693349","chr1","100916857","100916922","15","94223573","TCACGTCTATAATCCTAGCACTCTGGGAGTCCTTGGCAGGTGGATCACCTGAGCTCAGGAGTTTGA","CATGCCTGTAATCCCAGCACCTTGGGAGGCCAAGGTGGGTGGATCACCTGAGGTCAGTAGTTTGAG"
"GL873600","991618","991705","chr15","13850109","13850195","15","12858491","GGCTGGGCGTGGTGGCTCACACCTGTTGTCCCAGCGCTGTGGGAGGCTGAGGCAGGTGGATCACCTGTGCTCAGAGGTTGAGACCAGC","GCCGGGCGCTGTGGCTCACACTTGTAATCCCAGCACTTTGGGAGGCTGAGGCAGGTGGATCACCTGAGGTCAGGAGTTAGAGACCAG"
"GL873600","8825981","8826014","chr16","43605817","43605844","11","34779836","AGTCTGGGGCAACAGAGCAAGACTCTGTCTCAAA","CAGTCTGGGTGACAGAGCAAGATTCCAT"
"GL873600","8826039","8826157","chr13","87428402","87428520","35","78602363","ATTAGCCTGGTGTGGTGGTATATGCCTTCCTGCCTGCTTGGGAGGCTGAGGCAGGAAGTATGCTTTAACTGTGGAGTCTGAGGTTGCTATGAGCTAGGTTGAGGCCATGGCACTCTAAA","TTAGCCGGGTGTGGTGGTGCACGCCTGTAATCCCAGCTACTCAGGAGGCTGAAGCAGGAGAGTTGCTTGAACCCAGGAGTTGGAGGTTGCAGTGAGCTGAGATCACGCCATTGCACTCC"
"GL873601","269289","269338","chr14","49279240","49279285","14","49009951","GACTGGGTGTGGTGGCTCACACCTTTAATCCTAACACCCTGGGAGGCTTA","GGCTGAGATGGTGGCACACACCTGTAATCCCAGCTACTTGGGAGGC"
"GL873601","269431","269678","chr1","184453273","184453521","76","184183842","AGAAGATCACTCAAGATCAGGAGTTTGAGAACAGCCTGAGCAAGACCCCCATCTTTACTAAAAATGGAAAAGTTTTTACCCAGGCATGGTAGTGCGTGCCTGTATCCCATCTACTCCGGAGGCTGATAGGAGGATTGCTTCAACCAAGGAGTTTGAGGTTCCAGAGACTTAAGATGACACAACTGCATTTTACCCAGTGTGACACAGCGAGACTCTTTCAGAAGAATTTTTAAAAGGAAAAAAAAGAA","GGTCAGATCACCTGAGGTCAGGAGTTTGAGACCAGCCTGACCAACATGGTAAAACCCCATCTCTGCTAAAAATACAAAAAATTAGCCAGGCATGGTGGTGAACGCCTGTAATCCTAGCTACTCAGGAGGCAAAGACAGGAGAATCGCTTGAATCTGGAAGGTGGAGGTTGCAATGAGCCAAGATGACGCCACTGCACTCCAACCTGGGTGACAGAGGAAGACTCCATCAAAAAAAAAAAAAAAAAAAAA"
"GL873601","1397978","1398117","chr16","24839455","24839591","34","23441477","GCCTATAATCCTAGCACTCTGGAAGGCTGAGGCAGGAAGATCACTAGAGCTTGGGAGTTTGAGATTGCTGTGAGGGAGACTGACTCCATGGCACTCTAGCCTGAGGCAACAGAGTAAGACTCCATCTCAAAAAAAAAAAA","CTCTAACTCCAGCTACTCAGGAGGCTGAAGCAGGAAAATCACTTGAACCTGGGAGGTGGAGGTTACAGTGAGCCAAGATCACACCATTGCACTCCAGCCTGAGCGACAGAGCGAGACTCTGTCTCAAAATAAATAAA"
"GL873601","4065502","4065590","chr11","108711352","108711444","19","104645850","GCTGGATGTGGTGGCTCTCACCTATAATCCTAGCACTCTGGGAGGTCAAAACAGGTGGATCACCTGAGCTCAGGAGCAAGAACACCAGC","GTCAGGGGTGGTGGCTCACGCCTGTAATCCCAGCACTTTGGGAGGCCAAGGCAGGTGGATCGCCTGAGCTCAGGAGTTCAAGACCAGCCTTGC"
"GL873601","8241370","8241465","chrY","9469734","9469829","34","1228364","AAAAAAGGTGGAGATGAGCCATGCGCAGTGGTGTAGGCCTGTAATCCCAGCCCTTGGGAGGCCAAAATGGTGGATTGCCTGAAGCAGAGCAAGACC","AAAGTACAAAGAGTCTGGGTACAGTGGCCCAAGCCTGTAATCCCAGCAGTTTGGGAGGACAAGATGGGTAGATCACCTGACATCATGAATTAGAGA"
"GL873569","7519122","7519191","chrX","79016364","79016431","16","71497242","TTGGCCAGGCATGGTCGCTCAGGCTGTAATACCAGCTACTTGGGAAGCTGAAGCAGGAGGATCACTTGAA","TTGGCCAGGCACGGTGGCTCATGCTTATAATCCCAGCTACTCGTGAGGCTGAGGCAGGGGAATCGCTT"
"GL873569","7989158","7989286","chr8","41505677","41505810","35","33516519","AGTCCCACCTATTTGGAAGGCTGAGGCAAGAGGATCACTTGAACTCAGCAGTTTGACATTGCTATGAGTTAGATTGACTCCATGGCACTCTAGCCCAGGCAACAGAGCAAGACTCCGTCTCAAAACAAA","TAATACCAGCTACGTGGGAGGCTGAGGCAGGAGAATCACTTGAACCCGGGAGGTGGAGGTTGCAGTGAGCTGAGATTGCACCGTTGCACTCTAACCTGGGCAACAAAAGCAAAACTCTGTCTCAAAAAAAAAAA"
"GL873569","7989575","7989702","chr1","62231025","62231129","47","54241450","GGCTGGGTAATGCAGTGGCTCACGCCTATAATCCTAGTGCTTTGAGAGGCCAAGAGTGAGACTCTGTGTACTAAAAATAGAAAAATTACCTAGGCATTCTGGTGGGCACCAGTAGTCCCACCTATTTG","GGCTGGGCATGGTGGCTCACGCCTATAATCCCAGCACTTTGGGAGGCCGAGGCAGGTGGATCACCTGAGATCAGGAGTTTGAGACCAGACTGGCCAACATGGTGA"
"GL873569","10034363","10034556","chr10","61268396","61268605","62","51234033","CAGCTTGAGCAAAAGTGAGCCCCTGTCTCTACTGAAAATAGAAAAAATTAGCCAGGCGTGGTGGCACACACTTATAGTCCCAGCCACTTAGGAGGCTGAGGCAGGAGTTTGAGGTTGACATAATCTAAGCTGATACCATAGCACTCTAGCCTGGGCAATAGAGTGAGACTCTGTCTCAAAGAAGAAATTTATCT","CCTGACCAATGGTGAAACCCTGTCTCTACCAAAAATACAAAATTTAGCTGGGCATGGGGGCACGCACCTGTAGTCCTAGCTACTCGGGAGGCTGAGACAGGAGAACTGCTTGAACTCGGGAGGCAGAGGTTGCAGTGAGCTGAGATCATGCCACTGCACTCTAGCCTGGGCAATAGAGTGAGACTCCGTCTCAAAAAAAAAAAAAAAAAA"
"GL873569","10034830","10034845","chr1","217667782","217667796","2","207632952","AAAAAAGAAGAAAAAA","AAGAAAAAGAAAAAA"
"GL873569","10203815","10203922","chr8","96374555","96374671","35","86170740","GCCAGGTGTAGTGGTTCACACCTATAATCCTAGCACTCTGGGAGCCTGAAGCAGGTAAATGGACTGAGCAAGAGTGAGACTTCCACCTCTATTGAAAATAGAAAAATT","GGCTAGGTATGGTGGCTGATGCCTATAATCCCAGAATTTTGGGAGGCCGAGGCAGGCAGATCATCTGAGGTCAGGAGTTTGAGACCAGTCCCGTCTCTACTAAAAATACAAAAATTA"
"GL873569","10204196","10204373","chr20","1304385","1304559","47","8899811","GAAAATAGAAAAATTAGCCAGGCATTATAGCAGGCACCAGTAATCCCAGTTACTTGGGAGGCTAAGGCAAAAGAATCTCTTGAGCCCAAGTTTGGGGTTGCTAGGAAGTAAAACACCACAGCACTATACCCAGAACAAGAGAGTGAAGACTCAGTCTCAAAAAGATAAATAAATAAAA","AAAAATACAAAAATTAGCCAGGCATGGTGGCGGGCGTCTGTAACTCCAGCTACTTGGGAGACTGAGGCAGGAGAATCGCTTGAACCCAGGAGGCAGAGGTTACAGGTGAAATCACACCACTGCACTCCAGCCTGGGCAACAGGGCAAGACTCTGTCTCAAAAAAAAAAAAAAAAA"
"GL873569","10473375","10473444","chr8","20660648","20660717","21","10187273","TGTAGTCCCAGCACTTTGGGAGGTTAAGGCAAGAGTAGCACCCAACATGAGGAGATCAAGACCAATCTGG","CTGTAGTCCCAGCACTTTGGGAGGCTGAGGCAGGTGGATCCTTTGAGGGCAGAACTTTAAGACCAGCCTG"
"GL873570","9287350","9287485","chr1","29437872","29437991","30","20150522","GGCCGGGCGTGGTGGCGCACGCCTGTAGTCCCAGCGCTATGGGAGGCCGAGGCGGGTGGATCACCTGTGCTCAGAGGTTCGAGACCAGCCAAGACCCCCCTGAGCCAAACGAGCCAGAGTGAGACCCCGTCTCTAC","GGCCGGGCGTGGTGGCTCACGCCTGTAATCCCAACATTTTGGGAGGCCAAGGCGGGTGGATCACCTGAGGTCAGAAGTTCGAGACCAACCTGGCCAACATGGTGAAACCCCTGTCTCTAC"
"GL873571","3669989","3670207","chr4","116777080","116777297","60","113107091","AGACCAGCCTGAGGAAGAGCAAGATCCCATCTCTATTAAAAATAGAAAAATTAGCCAGGCATTCTGGTGGGCACCTGTAGTTCTAACCACCTGGGAGGCTAAGGCAAGAGGAACTCTTCAACCCAAGAGTTTGAGGTTGCTGAGAGCTAGGCTAAGGCTGCAGCACTCTAGCCTGGGCAACAGAGTGAGACTGTTTCTCAAAAACAAAAAACAAAAAAA","CGAGACCAGCCTGGTCAATATGGTGAAACCCCGTCCCTACTAAAAATACAAAAATTAGCCAGGCATGGTGGCAGGCACCTGTAGTCCCAGCTACTCGGAAGGCTGAGGCAGGAGAATCGCTTGAACCACAGAGGCAGAGGTTGCAGTGAGCCGAGACTGCACCACTGCACTCCAGCCTGGGCGACAGAGTGAGACTCAGTCTCAAAAAAAAAAAAAAA"
"GL873571","106134","106236","chr4","18143723","18143826","27","18037589","GGCCAGTCTCAGTGGCTCACACCTGTAATCCAGCATTCTGGGAGGCTGAAGCACACGGTCACCTGAGCTCAAAGGTTGGAGACCAGAGTGAGACCCCACCTCT","GGCCAGGCGCAGTGGCTCACTCCTGTAATCCCAGCACTTTGAGGCTGAGGCAGGCGGATCACCTGAGGTCAGGAGTTTGAGACCAGCCTGGCCGAAACCCCATC"
"GL873571","3670496","3670589","chr7","50468399","50468491","15","46797903","GGGCAGGCATGGTGGCTCACACCTGTAATTCTAGCACTCTTGGAGGCTGAGGCAGGAAAATGGCTTGAGGTCAGGAGTTCAAGACCAGCCTGAG","GGCCAGTCATGGTTGCTCACACCTGTAATACCAGCACTTTGGGAGGCCGAGGCAGGCGAATCACCTGAAGTCAGGAGTTCAAGACCAGCCTGG"
"GL873571","4059090","4059389","chr7","52903696","52903994","88","48844606","GGCCAGGTGCAGTGGTTCACACTTATAATCCTAGCACTCTGGGAGGCCGAGGCGAGTGAAGTGCCTGAGCTCATGGGTTCAAGACCAACCTAAGCCAGAGACCCCTGACTCTTATAATAGCCTGGCATTGTGGTGGGCGCCAATATTTCCAGCTACTCTGAGGCTAAGGCAAGAGAATTGCTTGAGCCCAGGAGTTGGAGGTTTCTGTGAGCACTGACGCCGCAGCTCTCTACCAAGGGCAACAAAGACTCTGTCTCAAAAAATAAATAAATAAATAAATAACAGAATGAAAATGAAAAA","GGCCGGGTGCGGTGGTTCACGCCTGTAATCCCACCACTTTGGGAGGCTGAGGCAGGCAGGTCACCTGAGGTCAGGAGTTCCAGACCAGCCTGGCCAACATGGTGAAACCTTGTCTCGGCTATTAGCCTGGCATGGTGGTGCGTGCCCATAATCCCAGCTACTCAGGAGGCTGAGGCAGGAGAATCGCTTGAACCCAGAAGGTGGAGGTTGCAGTGAGCCAAGATAGCACCACTGCAACTCCAGTCTGGGCAACAGAATGAGACTCTGTCTCAAAAAAAAAAAACAAAAAACAAAAAGAA"
"GL873571","4209418","4209704","chr11","32517699","32517985","80","28308281","GGCTTGGCAAGGTGGCTTACACCTCAAATCCTAGCACTGTGGGAGACTGAGGCAGGTGGATTGTTTGAGCTCAGGAGGTCAAGATAGAGAGCAAGAGCAAGTCTCTGTCTCTACTAAAAATAGAAAAGAACTACTTCCCGGGGGTCATGGCAGTAGCCTGTAATCCCAGTTACTAGGTAGAATGAGGCAAGAGGATCTGTTGAAGCCAAGAGACTGAGGTTGTTATGAGCATGCCACAGCACTCTACCCAGGGTGACAGAATGAGACTCTGTTGAAAGAAAAAAAGA","GGCCGGGTGCAGTGGCTCACACCTGTAATCCCAGCACTTTGGGAGGCTGAGGCGGGTGGATCACCTGAGGTCAGGAGTTCAAGACCAGCCTGACAAACATAGTGAAACCCTGTCTCTACTGAAAATACAAAATTAGCCAGGTGTGGTGGCGCATGCCTGTAATCCCAGCTACTCGGGAGGCTGAGGCAGGAGAATTGCTTGAATCCAGGAGGTGGAGGTTGTGTGATCACACCACTGCACTCCAGCCTGGGCGACAGAGTGAGACTCTGTCTCAAAAAAAAAAGAAA"
"GL873571","4209985","4210154","chr3","175781758","175781928","60","171571773","GAAAGAAATGAAAAGAAAGAAGTTAGCTGGTTGTTGGGGTATGCTTCTATAGTCCCACCTACTCAGAAAGCTGAAATCTGGAGTTTGGGGTTGTTGTAAGGTAGGCTGATGACATAGCACTGTAGCTTGGGCAAGAGAGTGTGACTTTGTCTCAAAAAAAATTAAAACAA","ATTAAAAACACAAAGATTAGCCAGGTGTGATGGCACACAACTGTAATCCCAACTACTCAGGAGAATCGCTTGAACCTGGGAGATAGGGTTTGCAGTGAGCCAAGATTGTGCCACTGCACTCCAGCCTGGGTGACAGAGTGAGACTCTGTCTCCAAAAAAAAAAAAAAAAAA"
"GL873571","4210444","4210570","chr17","16655655","16655789","35","12445211","GCCAGGCAGATGGCTCACACTTCATCCTAGCCCTCTGGAAGGCTGAGGCAGGCTAATTTTTTGAGGTTAGGAGTTTGAGACCAGCCTGAGGAAGAGACCCATCTCTACTTTAAAAAATAAATGGAAA","GCCAGGCATGGTGGCTCACACCTGTAATCCTAGCACTTTGGGAGACTGAGGCGGGTGAATCACCTGAGGTCAGGAGTTTGAGACCAGCCTGACCAGTATGGTGAAACCCAGTCTCTACTAAAAATACAGAAATTA"
"GL873571","4391733","4391878","chr11","33723808","33723943","46","29332075","AACTTAGCTGGGAATGGTGGCTCAAGCCTGTAATCCTAGCACTCTGGGAGGCTCAGGTGGGAGGATCACTTGAGGTTGCTGTGAGCTTGGCTGATGCCAGGACACTCTAGTGTGGGCAAGAGAGTGAGACTCCGCCTCAACAACAA","GCCGGGTGCAGTGGCTCATACCTGTAATCCCAGCACTTTGGGAGGCTGAGGTAGGCGGATCACGAGGTCAGGAGCTGAGATGGCGCCACTGCACCCCAGCCTGGGTGACAGAGCAAGACTCTGTCTCAAAAAAAAA"
"GL873571","6307773","6307841","chr9","62429628","62429694","22","56121855","CTGGGTGTGGTGGCATTGCACCTGTAATCCTAGCTACTTGGAAATCTTAAGCCCAGGAGTTGAAGACTG","CCCAGCATGGTGGTGCATACCTATAATCTCAGCTACTTGGAGGCTTGAGCTCAGAAGTTTGAGACCG"
"GL873571","6496217","6496306","chr1","27257765","27257856","27","20761548","GCAGGGTGTGTTGACCCACACCCACAATTCCAGGACTCTGGGGGGCCAGGGATGGTGGGTTCCCTCAGATCAGGAGCTCCTTACCAGCCT","GACTGGGCATGATGGCTCAAATCTGTAATTCCAGCACTTTGGGAGGCCGAGGTGGGTGGATTGCCTGAGATCAGGAGTTCAAGACCAGCCTG"
"GL873571","6499738","6499903","chr1","38976375","38976555","47","32476637","AAAATAACATGAATTGACTAGGCGAGGTGGCTCACATCTCTAATCCTAGCACTCTGGGAGGCTGAGGCAGGAGAATTGCATGAGGTTGCTGTGAGCTATGATGATACCACGGCATTCTAATCAGGGTGACAGAGTGAGATTCTGTCTTAAAACAAACAAACAAAAA","AAAATAAATAAATTAGCAGGGCCTGGTGGCGCACACCTGTAATCCCAGCTACTTGGGAAGCTGAGGCAGGAGAACCCACTTGAACCTGGGAGCCGGAGGTTGCAGTGAGCTGAGATGGCACCACTGCACTCCAGACTGCGTGACAGAGTGAGACTCCGTCTCAAAAACAAACAAACAAAAA"
"GL873571","11399575","11399872","chr15","109458692","109458994","79","98059117","CAGTGGCTCACACCTGTAAATCTAACACTCTGGGAGGCCAAGGTGGGTGGATCCCTTGAGCTCAGGAATTTGATACCAGCCTGAGCAAGAGTGAGACCTTGTCTCTACTAATAATAGAAAAATAGCCCGTGTTGTGGCACTTGTCCCAACCACTGGGGAGGCTTTAGGCGGGAGGATTACTTGAATTGGGAGTTTGATATTGCTGTGAGCTGGGCTGATGCCTTGGCATTCTAGCTTGGGTAACAGCGTAAGACTCCGTCTCAAATAAATAAATAAATAAATAAAAAGAAAAAAAGAA","GTGGCTCACACCTGTAATCTCAGCACTTTGGGAGACCGAGGCAGGTGGATCACCTGAGGTCGGGAGTTTGAGACCAGCCTGACCAACGTGGAGAAACCCCGTCTCTACTAACAATACAAAATCAGCTGGGCGTGGTGGTGCATGCTTGTAATCCCAGCTACTCGGGAGGCTGAGGTAGGAGAATCGCTTGAACCTGGGAGGTGGAGGTTGCGGTGAGCCGAGATCGAGCCACTGCACTCCAGCCTGGGTGACAGAGCAAGACTCCATCTCAAAAAAAAAAAAAAAAAAAAAAAAAAAAAAAAA"
"GL873572","114760","114841","chr8","26280134","26280211","16","26165374","GGCCAGGCATGGCGGCTCTTCCCTGTAATCCTAGCACTCTGGGAGGGCGAGGCAGGCAGATCACCTAGGCTAGGGTGAGATC","GGCCAGGAATGGTGGCTCATGCCTGTAATCCCAGCACTTTGGGAGGCTGAGGCAGGCAGATCACCTGAGGTCAGGAGT"
"GL873572","9421791","9421892","chr11","8089184","8089269","35","1332607","TACTAAATATATAGCAAGGCCAGGCACAGTGGTTCATGGCTGTAATCCCAGTACTCTGGGAGGCCTAGTCAGAGTTGACCTGAGATCAGGCTAGAAGCCTGG","ATAAAAATAATTGGAGGCCAGGCACGGTGGCTCATGCTTGTAATTCTAGCAATTTGGGAGGCTGACGCGGGTGAGATCATACTGAG"
"GL873572","11052834","11053035","chr14","11857478","11857657","65","804644","TCCACAAAGAAAGCAGAAGTGTGGCCGGGTGGTAGCTCAAGGCAGGAATCCCAGCACTCTGGGAGCTGGGAGGTGGGGGAGGATCCCTTGAGATCAGGAGTTGGAGGGCACAGTGAGCCTGGGGGAGGCCACTGTCTCTGTACTCTAGCAGGGAGACAGAGCAAGACTGCCCATTCAAAGAAAAACAACAAACAAAACAAAA","TACAAAAATTAGCTGGGCACGGTGCCACAAGCCTGTAATCCCAGCTACTCGGGAGGCTGGGCAGGGGAATAGCTTGAACCCAGAGGTGGAGGTTGCAGTGAGCCAAGATCAAGCCACAGCACTCCAGCCTGGGTGACAGAGCAAGACTCCATCTCAAAAAAAAAAAAAAAAAAAAAAAAA"
"GL873573","2564195","2564244","chr1","109985445","109985491","12","107421250","TACAAAAATTAGGCTGGGCTTGGTGGTTCACGCCTATAATCCTAGCACTT","ACTAAAATTAGCTGGGCATGGTGGTGCATGCCTGTAATTCCAGCTAC"
"GL873573","7423371","7423533","chr2","202783328","202783513","56","195359957","GGTGGCTCACACCTGTAATCCCAGCACTCTGGGAGCCCTGGTGGCTCATGTCTATAATCCTAGTACTCTGGGAGACCATGGTGGCTCATGTCTATAATCCTAGTACTCTGGGAGCCATGGTGGCTCACGCCTATAATCCTAGTACTCTGGGAGACCATGGTGG","GGCTGAGGCGCGGGGGCTCACGCCTGTAATCCCAGCACTGTGGGAGGCCGAGGCGGGTGGATCACGCCTGTAATCCCAGCACTGTGGGAGGCCAAGGCGGGTGGATCACGCCTGTAATCCCAGCACTGTGGGAGGCCGAGGCGGGTGGATCACGCCTGTAATCCCAGCACTGTGGGAGGCTGAGGC"
"GL873573","9657648","9657710","chr19","10207852","10207913","10","550204","TAAAAATAAAAAATTTAGCTGGATGTGGTGGCTCACACCTGTAATCCTAGCACTCTGGGAGAC","TAAAAATACAAAATTAGCTGGGTGTGGTGGCACACACCTGTAATCCCAGCTACTCAAGAGGC"
"GL873574","1624662","1624783","chr9","814961","815079","36","809701","GACTGGGTGGGTTGGATCATGCCTGGAATCCTAGCACCCTGGGAGGCCAAGGTGAAAGGATTGCTTGAGGTTAGGAGTTCCAGAAATGTAGCAGTCATGGTGACTTCATCCTTCTCTACCAA","GGCTGGGTGCTTTGATTCATGCCTGTAATCCCAGCACTCTGGGAGGCCGAGGCAGGTGGATCACCTGAGGTTAGGAGTTCGAGACCAGCTTGGCTAACATGGTGAAACCTCGTCTCTAC"
"GL873574","4459477","4459612","chr1","29437872","29437991","29","24978395","GGCCGGGCGTGGTGGCGCACGCCTGTAGTCCCAGCGCTATGGGAGGCCGAGGCGGGTGGATCACCTGAGCTCAGAGGTTCGAGACCAGCCAAGACCCCCCTGAGCCAAACGAGCCAGAGTGAGACCCCGTCTCTAC","GGCCGGGCGTGGTGGCTCACGCCTGTAATCCCAACATTTTGGGAGGCCAAGGCGGGTGGATCACCTGAGGTCAGAAGTTCGAGACCAACCTGGCCAACATGGTGAAACCCCTGTCTCTAC"
"GL873574","4681987","4682216","chr6","153082888","153083127","73","148400901","GGGTGCGGTGGCTCAGACCTATAATCCCAGCACTCTGAGAGGCCGAAGTGGGTGGATCACCTGAGCTCAGGAATTTGAGACCAGCCGTCTCTAAAAATAGCTGAGTGTTGTGGCAGTGGCTGTAAGTCCCAGCTGTTTGGAAAGCTGAAGCAAGGGAATCACTTGAACCCAAGAGTTTGAGGTTGCTGTGATGACAAAGTGAGACTCTATCTCAAAAAAAAAAAAAAAAA","GGCCGTGCGCGGCGGCTCACGCCTGTAATCCCAGCACTTTGGGAGGCTGAGGTGGGTGGATCACCTGAGGTCAGGAGTTTGAGACCAGCCCGACCAGAAATTAGATGGGTGTGGTGGTGCGCTCCTGCAGCCCCAGCTACTTAAGAGGCTGAGGCAGGGTAATCACTTGAACCCGGGAGGCGGAGGTTGCAGTGAGCCGAGCTCACGCCACTGCACTCCAGCCTGGGTAACAGAGCGAGA"
"GL873574","4709916","4710039","chr19","13152422","13152536","46","8442506","AAAAATAGAAAAACTAGCCAAGCATGGTGGTGCACCCCCTATAGTCTGAGCTCCTCAGCGGGCTGAAGCAAAAGGACGGCTGGAGCCCTGGAGTTTGAGGTTGCTGTGAGGCAAGGTGATGCCA","ACACATAAATTAGCCAGACATGATGGTGAGTATCTGTAATTCCAGCTCCTTGGGGGGCTGAGGCGGGAGAATTGCTTGAACCTGGGAGGCAGAGATTGCAGTGAGCCAAGATCGC"
"GL873574","6353839","6353913","chr5","25768079","25768163","22","19414240","AAAAATATAGCAAGGCCAGGCATGGTGGCTCACACCTATAATCCCAGTACTTGGGAGCTGGAATTTGAACCTAGG","AAAAAACTCAAACAAGGCTGGGCGTGGTGGCTCACACCTGTAATCCCAGCACTTTGGGAGGCTGAGGTGGGTGGATCACCTGAGG"
"GL873574","6533061","6533332","chr5","85182161","85182439","81","78649100","GGCTGGGCGAGGTGGCTTACACCTATAATCCTAGTACTCTGGGAGGCCAAGGTGGGTGGATTGCCTGAGCGCACAGTTTCAAGACCAGCTGGAGCCAGAGAGAGAGAGAGAGACCCTGCCTCTAAAAATAGCCAGGCATTGTGGCAGGCACCTGTAGTCCCAGCTACTTGGCAGGCGGAGGTATGAGAATCGCTAGAGGTTGCTGTTAGCTATGATGCCATAGCACTCTACCAAGGGCGACAAAGTGAAACTCTGCCTCAAAAAAAAGAAGA","GCCAGGCGTGGTGACTCAAGCCTGTAATCCTAGCACTTTGGGAGGCCAAGGTGGGCGGATTGCCTGAGCTCAAGAGTTTGAGACCAGCCTGGGCAACACGGTGAAACCCAATCCCTACTAAATACAAAAAAAATTAGCCGGGTGTGGTGGTGTGAACCTGTAGTCCCAGCTACTCGGGAGGCTGAGGCAGGAGAAGGCAGAAGTTGCAGTGAGCCGAGATCACACCACTGCACTCCAGCCTGAGTGACAGAGCAAAACTCTTTCTCAAAAAAAAAAAAA"
"GL873574","6643746","6643907","chr2","92627944","92628105","46","85984198","AAATAGCCAGGCGTTGTGGCAGGCACCTATAGTCCCAGCTACTTGGGAGGCTGAGGCAAGAGAATCACTTAAGCCCAAGTGACAGAGGTTGCCAGGGCACTCTACGTAGGCAACAGAGTGAGACTCTATCTAAGAAAGAAGGAAGGAAGGAAGGAGAAAGAA","TTAGCCGAGCATTGTGGTGCGCGCCTGTAGTCCCAGCTACATGGGAGGCTGAGGCAGGAGAACACCTGAACCCAGGATGTGAGCTGAGTCGCGCCATTGCACTCCAGCCTGGGCAACAGAGTGAGACTCCATCTCAAAAATAAAATAAAATAAAATAAAAAA"
"GL873574","6644163","6644274","chr1","128607504","128607619","20","121963341","CTGTAATCCTAGCACTTGGGAGGCTGAGGCAGGTGGATCACCTGAGTTCAGGAGTTCAAGACCAGCCTAAACAAGAGTGAGACCCTATCTCTACTAAAAATAGAAAAAATAT","GCCTGTAATCCAAGCACTTTGGGAGGCTGAGGCGGGTGGATCACCTGAGGTCAGGTGTTCGAGACCAGCCTGGCCAACGTGGTGAAACCCCAACTCTACTAAAAATACAAAAATTA"
"GL873574","8511822","8512127","chr1","23439759","23440073","84","14927937","GGTGGCTGGTGCCTGTAATCCTAGCACTCTGGGAGACTGAGGCAGGTGGATCACTTGAAATCAGGAGTTTGAGATCAACCTGAGCAAGAGATCTTGTCTCTCCTAAAGATAGAAAAACTAGCTGGGATTTGTGGTGGACACCTGTAATTTCAGCTACTCAGGAAGCTAAGGCAAGAGCATTGCTTAAAACCAGGAGTTTGAAGTTGATGTGAGCTAGGATGTCAGGGCAGGTTACCCAGGGTGACAGAGTGAGACTCTGTGTCAAAATAAACAAACAAACAAACAAACAAAACAAAATAAAATAAA","GGCTGGACATGGTGACTCACGCTTGTAATCCCAACACTTTGGGAGGCTGAAGCAGGCAGATCACCTGAGGTCAGGAGTTTGAGACCAGCCTGACCAACATGGTGAAACCTTGTCTCTACTAAAAATACAAAAATTAGCTGGGAGCAGTGGTGCACACCTGTAATCCCAGCTACTCGGCAAGCTGAGGCAAGATAATTTTTTAAACCTGGGAGGTGGAGGTTGCAGTGAGCCAAGATCGTGCCACTGTACTCCAACCTGGGAGACAGAGCAAGACTCTGTCTCAAAAAAAAAAAAAAAAAAAAAAAAAAAAAAAAA"
"GL873575","2107336","2107519","chr4","38052972","38053149","54","35945636","TCAATTAAAAACTTTTTAAAATGAGGCTGAGCATGGTGGTTCACACCTGTAATCCCAGCACTTTGGGAGGCCGAGGCAGGAGGATCACCTGATCCCAGGAGTCCAAGCCTACAGTGAGCCGTGATAATACCACTGCACTTCAGCCCAAAGCCTCAAAAAGAAAAAAAAAAAAGGATAGACAAGA","TATATATATATATATTATTTTGGGGGGGCATGGTGGTGCACACCTGTAATCCCAGCTACTCGGGAGGCTGAGGCAGGAGAATTGCTTGAGCCCGGGAGGCAAAGGTTGCATTGAGCTGAGATCACACCACTGCACTCCAGCCTGGCGACAGAGTCTCAAAAAAAAGAAAAAATAAAAA"
"GL873575","5831824","5831959","chr1","29437872","29437991","28","23606048","GGCCGGGCGTGGTGGCGCACGCCTGTAGTCCCAGCGCTATGGGAGGCCAAGGCGGGTGGATCACCTGAGCTCAGAGGTTCGAGACCAGCCAAGACCCCCCTGAGCCAAACGAGCCAGAGTGAGACCCCGTCTCTAC","GGCCGGGCGTGGTGGCTCACGCCTGTAATCCCAACATTTTGGGAGGCCAAGGCGGGTGGATCACCTGAGGTCAGAAGTTCGAGACCAACCTGGCCAACATGGTGAAACCCCTGTCTCTAC"
"GL873575","7451097","7451208","chr3","122814630","122814743","22","115363533","GGCCAGGTGTGGTGGCTCACACCTGTTATCCTAGCACTCTGAGAGGCCACAGCAGCTGGATCACTTGAGCTCAGGAGTTCAAGACCAGTCTGAGCAAGAGCAAGACCTCACC","GGCTGGGTGTGGTGGCTCATGCCTGTAATCCCAGCACTTTGAAAGGCCAAGGCAGATGGATCACTTGAGGTCAGGAGTTCCAGACCAGCCTGGCCAACATGGCAAAACCCCATC"
"GL873575","7451277","7451445","chr6","58863249","58863409","41","51411972","AAAAATTCAGCCAGCCACAGTGGAAGTGGATGCCTGCCATCACAGCTACTCTGGGGGCTGGGGCAAGAGAATTGCTTGATCCCAGGAGTCTGAGGTTGCTGTGACCTAGGCTGACACCACAGCACTCTACCCAGGGTGACAGAGTGAGGCTGTGTTTAAAAAAAAAAAA","TTAGCCAGGCATGGTGGCACATGCCAGTAATCCCAGCTACTCAGGAGGATGAGGCAGGAGAATCGCTTGAACCCAGGAGGCAGAGGTTGCAGTGAGCTGAGATTGCGCCACAGCACTCTACCCTGGGTGACAGAAGGAGACTCTGTCTCAAAAAAAAAAAA"
"GL873576","1765109","1765185","chrX","53921180","53921256","12","52156071","GGCCAGGTGCAGTGGCTCATATCTGTAATCCTAGCACCCTGGGAGGCCAAGGTAGGCGAATCACCTGAGGCCAGGAG","GGCCAGGTGCAGTGGCTCACGCCTGTAATCCCAGCACTTTGGGAGGCCGAGGTGGGCGGATCACTTTAGGTCAGGAG"
"GL873576","2711577","2711895","chr7","6620384","6620702","85","3908807","GGTCGAGCTTGGTGGCTCATGCTTGTAATCCTAGCACTCTGGGAGGCCAAGGCAGGTAAGTTGCCCTGAGCTCATAGGTTCCAGATCAGCATGAGCCAGAGTGAGACCCTGTCTCTACCAAAAAATAGCCCGGCATTCTGGCAGGTGCCTGTAATCCCAGCTGCTTGGGAGGCTGAGGCTAGAGAATCACTTAAACCCAAGGGTTAGTGGAGGTTGCTGTGAGCTATGATTCCACCGTACTCTACTGAGGGCCACAAAGTGAGACTCTGTCTCCATAAAAAAGAAAGAAAGAAAGAAAGAAAAATAAAATAAAATAAAA","GGCCAGGCACAGTGGCTCATGTCTGTAATCCCAGCACTTTGGGAGGCCGAGGCGGGTGGATTACCTGAGGTCAGGAGTTCTAGACCAGCCTGGCCAACAAGGCGAAACCCTGTCTCTACTAAAAATACAAAAAATTAGCTGGGCGTTTTGGCACATGCCTGTAATCCCAGCTACTTGGGAGGCTGAGGCAGGAGAATTGCTTGAACTGGGGAAGTGGAGGTTGCAGTGAGCTGAGATCACACCATTGCACGCCTGAGCAACAGAGCGAGACTCTGTCTCAAAAAAAAAAAAAAAAAAAAAAAAGAAAAGAAAAAGAAAA"
"GL873576","4782520","4782652","chr9","61136941","61137074","22","56354421","CCAGGCACGGTGGCTCACCCTTGTAACCCTAGTACTTTGGGAGGCTGAGGTGGGAGGATCCCTTGAGGTCAGGAGTTCAAGACCAGCCTGAACAACAGTGAGACCCCCGTCTCTACTAAAAAATAGAAAAGTT","GCCAGGCACGGTGGCTCACGCCTGTAATCCCAGCACTTTGGGAGGCTGAAGCGGGCGGATCACCTGAGGTCAGGAGTTCAAGACCAGCCTGGGCACCATGATGAAACCCCGTCTCTATTAAAAATACAAAAATT"
"GL873576","4782930","4783078","chr7","57521645","57521803","40","52738715","AGTTAGTCTGGTGTCATGGTGGGTGCCTGTAGTCCCAGCTGCTTGGGAGGCTGAGGCAAGAGAATCACTTGAGCCCAGGAGTTGGAGGTTGCTATGAGCGAGGCTGTAGCCTAGGCAACAGAATGAGACTTTGCCTCAAAAAAATAAAA","TTAGCTGGGCATGGTGGCGCATGCCTGTAGTCCCAGCTACTTGGGAAGCTGAGGCAGGAGAATCACTTGAACCTGGGAGGTGGAGGTTGCAGTGAGCTGAGATCGCACCGCTACACGCCAGCCTGAGCAACAGAGAGAGACTCTGTCTCAAAAGAAAAA"
"GL873576","7828709","7828723","chr5","101042981","101042996","1","93214272","TAAATAAATAAAAAA","TAAATAAATAAATAAA"
"GL873576","7828960","7829230","chr13","49045537","49045844","89","41216577","GCCGGCTGCAGTGGCTATAATCCAAGTACCCTGGGAGGCTTAGGTGGATGGATCACTTGAGCTCAGAAGTTCAAGACCAGCCTCAGCAAGAGGTAGACCTTGCCTCTATTAAANNNNNNNNNNNNNNNNNNNNNNNNNNNNNNNNNNNNNNNNNNNNNNNNNNNNNNNNNNNNNNNNNNNNNNNNNNNNAGTTTGAGGTTGCTGTGAGCTATGATGAAGCCAGGGCATTCTACCCAGGGTGACAGAGTAACTCTTAAAAAAAACTAAACAA","GGCCAGGCAGAGTGGCTCATGCCTGTAATTCCAGCAATTTGGGAGGCCTAGGCAGGCAGATTACCTGAGGTCAGGAGTTTGAGACCAGCCTGGCCAACATGGTGAAACCCCGTCTCTTCTANNNNNNNNNNNNNNNNNNNNNNNNNNNNNNNNNNNNNNNNNNNNNNNNNNNNNNNNNNNNNNNNNNNNNNNNNNNNNNGGAGATAATAGCTTTTGTAGAACGAAGCGATGCAACAGCCAGATCGCCGCCACCACCCTTAGGTCCTGGCGACAGAGTGAGATCCATCTTAAAAAAAAAAAAAAAAAAA"
"GL873576","10622840","10623093","chr7","60266447","60266705","74","49643607","GCTGGGTATGGTGGTTCACACCTATAATCCTAGCACTCTGGGAGGCTGAGGTGGGAGGATTGGTGGAGCTCAGGAGCTCATGAGGTGCCAAATCACTGGTGCCACACACCTGTATTCCCAGCTACTGAGGAGGCTGAGGCAGGAGGATCAGGTAAGCCCAGGAAGTTTGAGGTTGTAGTGAGTTAGGATGATTGAACTCTGCCTTGAGAGACAGAGCAAGATCCTCCTTCCTCCTAAGCAAACAAACAAATAAA","GGCTGGGTGCAGTGGCTCACACCTGTAATCCTAGCACTTTGGGAGGCTGAGGCGGGAAAATTGCCTGAGCTCAGGAGTTCAAGGACAGCCTAGGCAACATAGCATGGTGGTGCACGCCTGTATTCCCTGCTACTTGGGAGGCTGAGGCACAAGAATTGCTTGAATCCGGGAAGTGGAGGTTGCAGTGAGCCATTGTGGCACTGCTCTCCAGTCTGGGTGACAGAGCAAGACTCCATCTCAAAAAAAAAAAAAAAAAAAA"
"GL873576","10819939","10820007","chrX","67133632","67133707","21","56313693","AGGTTGCAGTGAAATTGTACCATTCCAATGAAGCCTGGGGGACAGAGTGAGATTCTCTCAAAATAAAAA","GGAGGTTGCAGTGAACCGAGATCGTGCCACTGCACTCCAGCCTGAGCGACAGAGTGAAACTTCGTCTCAAAAAAAA"
"GL873576","10920306","10920363","chr3","48261745","48261808","16","37341439","GCTGGACCTTGTAGAGAGTGCCTGTAATCCCAGCTACATGGGGGGCAAGAGAATTGCT","GCTGGGCATGGTGGTGCATGCCTGTGATCCCAGCTACTCAGGAGGCTGAGGCAGGAGAATTGCT"
"GL873576","10920398","10920529","chr10","67341428","67341546","30","56421030","GGCCAGGCGTGGTGGCTCACGCCTGTTGTCCCAGCACTGTGGGAGGCCGAGGTGGGTGGATTGCCTGAGCTCAGAGGAGTCCGGAAGACCAGCATGAGGCAGAGTGAGCCAGAGTAAGATCCTGTCTCTACC","GGCTGGGTGTAGTGGCTCATGCCTGTAATCCCAGCACTTTAGGAGGCCAAGGTGGATGGATTGCCTGAGCTCAGGAGTTCGAGACCACCCTGGGCAACAAGCCAAAACCCTGTCTCTAC"
"GL873577","515809","515961","chr7","137660778","137660931","43","137144969","AGCTGGGCATGGTGGCTCATGCCTATAACCCTAGCGTGCTAGGAGATTGCTTGTCAGGAGACTGAGGTTGCAGGAAACTGTGATGATGGCACTGCACTCTACCCAGGGTGACAGAGCAGGACTCTGCCTCAAAAAAAAAAAAAAAAATAGAAA","TTAGCTGGGCATGGTGGCGCATGCCTATAATCCCAGCTACTTGGGAGGCTGAGGCAAGAGAATCGCTTGAACCGGGGAGGCAGAGGTTGCAGACTGCACTCCAGCCTGTGTGACAGAGTGGGACTCCGTCTCAAAAAAAAAAAAAAAAAAAAAA"
"GL873577","1633164","1633256","chrX","38269524","38269615","26","36636360","TCAGCCAGGCATGGTGGCACTTGCCTATAAACCCAGCTCCTTGGGAAGCTGAGCCGGGAGGATCCCTTGCACCCAGGAGCAACGGAAGGCAGT","AATTAGCCAGGCATGGTGGCACATGCCTATAATCCCAGCTACTCAGAAGGTTGAGGCAGGAGAATCACTTGAACCTGGGAGGCAGAGGTTGC"
"GL873577","3979502","3979560","chr20","68909283","68909346","13","64929781","GAGTTTGAGACCAGCCTGAGCAAGACCGAGACCCAGTCTCTACTAAAAATAGAAAAATT","GGAGTTCAAGACCAGCCTGACCAACATGGAGAAACCCTGTCTCTACTAAAAAATACAAAAATTA"
"GL873577","3979839","3980009","chr10","31403126","31403287","39","27423287","ATGAGCAGATTGTCTTGGTGGGCACCTGTAGTCCCAGCTATTGGAGGTGGGAGGCTGAAGCAGGAAAATCTCTTGAGCCCAGGAGTTTGAGGTTGCTGTGAGCTAGGCTGACACCACGGCACTCTAGTCAGGGCGTCAGAGTGAGACTCCGTCTCAAAAAAAAAAAAAAAA","TTAGCTGAGTGTGGTGGCGCACATCTGTACTCCCAGCTATTTGGGAGGCTGAGGCAGGAAAATCGCTTGAACCCAGGAGGTGGAGGTTGCAGTGAGCCAAGATCACACTACTGCACTCCAGCCTGGGTGACAGAGTGAGAATCCATCTCAAAAAAAAGAAAA"
"GL873577","6050882","6051080","chr1","153219820","153220007","59","147168938","GGCTGGGCGTTGTGACTCATGCCTGTAATCCCAGCACTCTAGGAGGCCGAGGTGGGTGGACTGCCTGAACTCAGAGGTTTAAGACCATCCTGAGCCGCAGTGAGCCAGAGCGAGACCCTGTCTCTACCAAAAAAAGCTGGGTGTTGTGGTGGGCGCCTATAGTCCTAGCTACTTGAGGCGCTAAGGGTAAAAAAATTGC","GGCCTGGCACAATGGCTCACGCCTGTAATCCTAGCACTTTGGGAGGCCGGGGTGGGTGGATCACCTGAGATCAGGAGTTTGAGACCAGCCTGGCCAACATGGTGAAACTCCTTCTCTACAAAAATTAGCCAGGTGTGGTGGTGGGTACCTGCAATCCCAGCTATTTGGGAGGCTGAGGCAGGAGAATC"
"GL873577","8463965","8464050","chr9","52134422","52134508","19","43670457","CTGGGTGCTATAGCTCACGCCTATAATCCTAGCACTCTGGGAGTTTGGGGCAAATGGATCACCTAGGCTCAGGAGTTTGATACCAG","GGCTGGGAGCAGTGACTCACGCCTATAATCCCAGCACTTTGGGAGGCTGAGGCAGATGGATCACCTGAAGTCAGGAGTTCGAGACCA"
"GL873577","9471486","9471613","chr16","5178790","5178910","46","4292696","TTAGCCAGGCATAGTAGCCTGTGTGTAGTCCTAGCTACTCAGGAGGCTGAGGTAGATGGGTCACTTGAGGTTGCAGAGATTATGGTAATGTCACTGTACTCTAGCCCTGGCAACAGAGCACAACCCTG","TTAGCCGAGCCTGGTGGCATAAACCTGTAATCCCAGCTACTCAGGAGGCTGAGGCAGGGGAATTGCTTGAACCTGAGAGGAGAAGGTTGCAGTGAGCCGAGATTGCACCATTGCACCCCAG"
"GL873577","9471875","9471998","chr7","17832200","17832315","36","8360325","GGCCAGGTGAAGCAGCTCATGGCTATAATCCTAGCAGTTTGGCAGGCCAAGGTGGGAGGACTGCTTGAGGTCAAGAGTTCAAGACCAACCCATCTTTGCGAAAAATTTAAAAATTACCTAGGCA","GCCAGGAGAGGTGGCTCATGCCTCTAATCCCAGCACTCTGGAAATCCAAGGTGGGTGGATCACCTGAGGTCAGGAATTCCAGACCAGTCTGGCCAATATAAAAAATTAGCCAGGCT"
"GL873577","9853150","9853170","chr3","85044647","85044667","3","75191497","AAACAAACAAACAAAAAAAGA","CAAACAAACAAACAAACAAAA"
"GL873577","9853206","9853473","chr7","130818682","130818963","67","120965476","GCTGGGCGCAGCGTCTCACTCCTGTAATCCCAGCACTTGGGAGGCCAAGGTGAGTGGATTGCCTGAGTTTACAGTTTCGAGACCAGCCTGAGCCAAAGCGAGACCCCCATCTCTAAAAAATAGCTGGGCATTGTGGTGGGCACCTGTAGTCCCAGCTACTTGGGAGGCTGAGGCAAGAGGATCGCTTGAACCTAAGAGTTTGAGGTTGCTGTGAGCTAAGGCTCCATGGCATTCTACCAAGGGTGACTAAGTGAGACTCTGTCTAAAA","GCCGGGCACAGTGGCTCACACCTGTAATCCCAGTACTTTGGGAGGCCAAGGTGGGTGGATCACCTGAGGTCAGGAGTTTGAGACCAGCCTGGCCAACATAGTGAAACTCTACTAAAAATACAAAAAAATAGCTAGGCATGGTGGTGCGCACCTGTAATCCCAGCTACTTGGGAGGCTGAGGCAGGAGAGTTGCTTGAACCCAGCGGGGTTGAGGTTGCAGTGAGTTAAGATCAAGCCACTGTGCTCCAGCCTGGATGACAGAGAGAGACTCCATCTCAAAAA"
"GL873577","10722415","10722478","chr10","12501471","12501539","23","1779056","AATAAAAAAATGCTGGGTACAGTAGTACATGCCTGTACTCTCATCTGGGGAAGCTGAGGCATGA","AAAGTAAAAAATTAGAGCTGGGCATGGTGGCACACACCTGTAATCCCAGTCACTAGGGATGCTGAGGCA"
"GL873578","463331","463568","chr10","28935382","28935620","93","28472051","CAGGTGCTTTGACCCACACCCTCAACTCTAGGACTTTGGACGCCCTGGCTGGGTGGGTCCTTTAAAGTCAGGAGCTTCTTATCAGTCTGGGCAAAAGTGAGACCCCATCTCTACCAAACAAAGAAAGAAATCAGCAGTATGTTGCAGTAGAGACTCACCAATACCTTCTTTCAAAGACCAAAGCTGGAAGGACACTAAAGACCATGATCTCATGGCCTCCCTGAGCCATGACAATGCC","CCAGGTGCAGTGGCTCATGCCTGCAAGCTCAGAACTTTGGGAGGCAGAGGTGAGCAGACTGCCTGAGTTCAGGAGTTCAAGACCAGCTGGGCAACATGGTGAGACCCTATCTCTACTAAAAATACAAATAATTAGCAGGGTGTGGTAGCACACACCTGTAGTCCAGCTACTCAGGAGGCTGAGGCAGGAGAATTGCTTGAACCCAGGAGGCAGAGTTTGCAGTGAGCCAGGACTGGGCC"
"GL873578","1143712","1143827","chr11","52824583","52824692","30","51680871","GGCTGGGTGTGGTGCCTCATGCCTGTAATCTAAGCCCTCTCCGAGGCTGAGGTGGGAGGATCCCTTGAGTTTAGGAGTTTGATTTTGAGACCAGCCTGATCAAGAGAGAGACCTCA","GGCCGGGTGTGGTGGCTCATGTCTGTAATCCCAGCACTTTGGGAGGCTGAGGTGGGTGGATACCCTGAGGTCGGGAGCTCGAGACCAGCCTGACCAACATGGAGAAACCC"
"GL873578","1144101","1144139","chr3","33494224","33494257","11","32350123","GAGAGAGACCTCATGTCTACTAAAATAAATAAATATATA","GTGAAACCCGTCTCTACTAAAAATACAAAAATTA"
"GL873578","1144175","1144343","chr12","119519961","119520131","41","118375786","ATTATCCAGGCCTTCTGGTGGATGCCTGTAGTCCTAGCTACTAGAAAAGCTGGAGCAGAATCACTTGACCCAGGAGCTGGAGGTTGCAGGGAGCTAGGCTGATGCCACAGAATTCTAGCCTGAGGCAAAAGAATTGAGCCACTGTCTCAAAAAGGAACAAAAAAGAAAA","ATTAGCCAGGTGTGGTGGCATGCACTTGTAATCCCAGCTACTAAGAAGGCTGAGGCAGGAGGATCACTTGAACCCGGGAGGTGGAGGTTGCAGTGAGCCAAGATCATGCCACTGCACTCCAGCCTGGGCAACAGAGTAAGACTCTGTCTCAAAAAAAAAAAAAAAAAAAAA"
"GL873578","4593962","4594035","chr16","68825055","68825124","22","64231093","AGCTGGGTACAGTGGCTCACATATAATCCCAGTGACTCAGGAGGCTAAGACAGGAGGATTACTAGGACCTGAGA","GGCTGGGCACAGTGGCTCAGACCTGTAATCTCAGTACTTTGGGTGGCTGAGGCAGGTGGATCACCTGAGG"
"GL873578","6158845","6158972","chr3","500432","500562","24","5658413","GACATGGTGGCTCACACCTGTAATCCTAGCCCTCTGGGAGGCTGAGGCAGGTGGATCACTTGAGTTCAGGAATTCAAGACCAGCTTGAGTGAGAGCAAGACCCTGTCTCTACTAAAAATAGAAAAATT","GCACGGAGGCTCATACCTGTAATCCCAGCACTTTGGGAGGCTGAGGCAGGTGGATCACCTGAGGTCAGGAGTTCCAGACCAGCCTGGCCAACATGGCGAAACCCTGTCTCTACTAAAAATACAAAAAATCT"
"GL873578","6159253","6159444","chr19","34496349","34496541","55","28337096","ATAAAATAAAAATAGAAAAATTAGCCAGGCATTGTGGCAGACATGCGAAGTCTCAGCTACTCCAGAGGCTGAGACAGGAAGATTACTTGAGCCCAAGAATCTTGCTGTGAGCTAAGCTGATGCCATAGCATTGTAACCTAGGCAACAGAGTAAGACTTGGCCTCAAAAATAAAATAAAATAATAAAGTAAAA","TTAGTTAATTAAATTAAACTTAGCTAGGCATAGTGGAACACACCCATAGTCCCAGCTACTCTAGAGGCTGAGGCAGGAGGATTGCTTGAGCCAAGTTGGAGGCTGCAGTGAGCTATGGTGGTGCCACTGCATTCCAGCCTCAGTGACAGAGAGAGACCCTGGCTCAAATAATAATAATAAATAAATAAATAAA"
"GL873578","6766040","6766171","chr2","93098086","93098217","30","86332046","CCAGGCACAGTGGCTCATGCCTATAATCCTAGTAGTCTAGGAGGCTGAGGTGAGTGCATTGCTTGAGCTCAGGAGTTAGATACCAGCCTAACCAAGAATGAGACCCCATCTCTATTAAAAATAGAAAAGTTA","GCCGGGCACAGTGGCTCATGCCTGTAATCCCAGCACTTTGGGAGGCCGAGGCGGGCAAATCACGAGGTCAGGAGTTCAAGACCAGCCTGACCAATATGATGAAACCCCGTCTCTATTAAAAATACAAAAATT"
"GL873578","6766434","6766577","chr9","21128084","21128223","50","14361650","GTTAGCCAGGAGTTGTGGCGGGCACCTACAGTCCTAGCGACTCAGGAGGCTGAAGTAGGCAGAGTTTGATGTGTTGCTGTGAACTACAAGGACACCAATGCACTCTAGGCCGGTAACAGAGTGAGACACTGACTAAAAAAAAAA","TTAGCCAGGTGTGGTGGCACATGCCTGTATTTCCAGCTACTCGGGAGGCTGAGGCAGGAGAATTGCGTGAGCTGAGATCATGCCACTTCATTCCAGTCTGGGTGACAGAGTGAGACTCTGCCTCAAAAAACAAAACAAAA"
"GL873578","7397948","7398119","chr5","40230148","40230319","43","32832200","TAAAAATAGCCATGCATTGTGACAGGCACCTGTAGTCCCAGCTACTCAGGAGGTTGAGGTAAGAGAATCACTTGAACCCAAGAGTTTTGAGGTTGTTATGAGCTAAGACGCCTCGGGACTCTACAAAAGGTAACAAAGTGAGACTCTGTCTCATAAAAAAAGAAAAAAAGAA","AAAATTAGCCAGGCATGGTGACGTACACCTGTAGTCCCAGCTACTCGGGAGGCTAAGGCAAGAGAATCGCTTGAACCCAGGAGGCAGAGGTTGCAGTGAGCTTAGATCACGCTACTGCGCTCCAGCCTGGGTGACGGAGTGAGACGCCATCTCAAAAAAAAAAAAAAAAAAA"
"GL873578","7398378","7398515","chr15","102382935","102383070","35","94984557","GGTCGAGCAAGGTGGCTCACGCCTGTAATCCTAGCACTCTGTGAGGCTGAGGCAGATGGATTGCCTGAGCTCGTGGGTTCGAGACCAGCCTGAGCCAGAGTGAGACCTCATCTCTAAAAATAGCTGGGAAGCTGGGCA","GGCCAGGTGTGGTGGCTCACGCCTGTAATCCTAGCACTTTGGGAGGCTGAGGCGGGTGGATTGCCTGAACTCAGGAGGTCAAGACCAGCCTGGGCAACACAGTAAAACCCCATCTCTACTAAAATACAAAAAATCA"
"GL873579","370235","370429","chr16","38067345","38067552","57","37697110","GCACAGGCCTGAAATCCTAGCACTCTGAAAGGCCAACGGAGGAGAATTTCTGGAGCTCAGGAGTTTGATACCAGCCTAAGCAAATAAAGCTAGACCTCTATCTCTACTAAAATTAGAAAAATTAGGCAGATGTGGTGGTAGGCACCTATAGTCCCAATTACTCCAGAGGCTGAGGCAGAAAGACTCTTGAACCCA","GTCAGGCATGGTGGCTCATGCCTATAATCCTAGCACTTTGGGAGGCCAAGGCCGGTGGATCACCTGAGGTCAGGAGTTTGAGACCAGCCTGGCCAATATGGCAAAACCCCGTCTCTACTAAAAATAAAAAAATTAGCTGGGCACGGTGGTGGGCACCTATAGTCCCAGCTACTCAGGAGGCTGAGGCAGGAGAATTGCTTGAACCCAG"
"GL873579","370936","371046","chr3","3847698","3847802","33","3476762","TGACTCTTGAACCCAGGCACATGAGGTTGCTAAGAGTCTAGGCTGATGTCACGGCACTCTAACCTGGGAAACAGTGTGAGGTTCTGCCTCAATAAATAAATAAATAAATAA","TGGCTTGAACCCAGGAGGCGGAGGTTGCAGTGAGCCGAGATCACGCCACTGCACTCCAGCCTGGGCAACAGAGCGAGACTGTCTCAAAAAAAAAAAAAAAAAAAA"
"GL873579","599436","599605","chr10","38982686","38982853","41","38383250","AAAAAGTCAGACATTGTGGCAGGTGTCTGTAATCCCAGCTATTTGGGAGGCTGAGGCAGGAGTATCATTTGAACCCACGAGTCTGAGGTAACTGTGAGCTAGGCTAACACAACAGCACTCTAGCCTGGGCAATAGAATGAGACTCTATCAAGAAAAGAAATGAAAAGAAA","TATTAGCCTGACACAGTGGCGCGCATCTGTAATCCCAGCTACTTGGGAGGCTGAGGCAGGAGAATCACTTGAACCCAGGAGGCGGAGGTTGCTGTGGGCTGAGATCATGCCACTGCACTCCAGCCTGGGCAACAGAGGGAGGCTCCATCTCAAAAAAAAAAAAAAAAA"
"GL873579","599942","599953","chr3","71473700","71473710","4","70873758","TTTTAAAATAGT","TTTAAAAAAAA"
"GL873579","600232","600365","chr1","16061315","16061447","30","15461083","GGCTAGGCAAGGTGACTCATGTCTGTAATCCTAGTACTCTGGGAGGTTTGAGGCAGGAAGACCACTTTAGCTCAAGAGTTCCAGATCAGCCTGTGCAAGAGTGATACATCATCTCTACTAAAAATCAAAAATTA","GGCTGGGCATGGTGGCTCATGCCTGTAATCCTAGCACTTTGGGAGGTTGAGGCAGGCAGATCACTTGAGGTCAGGAATCTGAGACTAGCCTGGCCAACATGGTGAAACTCCATCTCTACTAAAAAAAAAAAAA"
"GL873579","5650320","5650591","chr6","54938866","54939145","71","49288546","GTCAGGTGTGTTAGCTTACAGTAGTAATCCTAGCACTTTGGGAGGTTGAAGTGGGTGGATTGCTTGAGCTCAGGGGTTCAAGACCAGCCTGAACAAGAGTGGGACCTCATCTCTATTAAAAACAGAAAAACTAGCTGGGTGTTATGGTGGGTGTCTGTAGCCCCAGCTACTCAGGAGGCTGAGGCAGGAGGTTGAGGTTGCTGTGAGCTATTGAGACCACAGCACTCTATCCAGGGCAACAGAGTGAGACCCCTCCCCCCCCCAAAAAAAAA","GGCCAGGTGTGGTGGCTCACGCCTGTAATCCCAACACTTTGGGAGGCCGAGGTGGGTGGATCACCTGAGATCAGGAGTTCAAGACCACCCTGGCCAACATGGTGAAACCCCGTCTCTACTAAAAATACGAAAATTAGCTGAGTGTGGTGGTGCATGCCTGTAGTCCCAGCTACTCAAGAGGCTGAGGCAGGAGGTGGAGGTTGCAGTGAGCCGAGATTGCATCACTGCACTCCAGCCTTGGCGACAGAACGAGAGAGACTCCATCTAAAAAAAAAAAAAA"
"GL873579","7037162","7037347","chr3","37328686","37328893","67","30291524","GAGGTGGGTGGATTGCCTGAGCTCACAGGTTGGAGACCAGCCTGAGCCAGAGCAAGACCTTATCTCAAAAAATAGCCAGGTGTTGTGGCTGGCACCTGTAGTCCCAGCTGCTCAGGAGGCGGAGGCAAGAGAAATGCTTGACCTCAGGAGTTTGAGGTTGCTGTGAGTTCAACTCACACTAATACA","GAGGCAGGGGGATCACCTGAGGTCAGGAGATCGAGACCAGCCTGGCCAACATGGTGAAAACCTGTCTCTACTAAAAATCCAAAAACATTAGCCAGGTGTGGTGGCACGCACCTGTAATCCCAGCTACTTGGGAGGCTGAGGCAGGAGAATCACTTGAACCTGGGAGGCAGAGGTTGTAGCGAGCCGAGATCACACCACTGCACCCCAG"
"GL873579","11077764","11077972","chr19","1200469","1200683","63","9877295","GCCAGGTGCAGTGGCTCATGCCTATAATCCTAGCACCCTAGGAGGCTGAGGAGTTCAAGACCAGCCTAAGCAACTGTGAGACCCCATCTCTACCAAAAATAGAAAAATTAGCTGACTGTTATGGTGTGCACCTACAGTCCTAGCTACTCAGGAGGCTGAGGCAGAAAGAGTCCTTGAACCCAGGAGGCTTTTTTTTGTTGTTGTTGTTG","GGCCAGTCGCGGTAGCTCATGCCTGTAATCCCAGCACTTTGGGAGGCCGAGGCGGGCAGATCACCTGAGACCAGCCTGGCAACATGGTGAAACCCCATGTCTACCCAAACTACAAAAATTAGCTGGGTGTGGTGGTGCACGCCTGTAATCCGAGCTACTCAGCAGGCTGAGGCAGGAGAATCCCTTGAACCTGGGAGGCAGAGGCTGCAGTGAGC"
"GL873579","11078245","11078333","chr19","4926258","4926351","22","6151987","TGAACCCAGGAGTTTGAGTTCGCTGTGAGCTAAGCTGAGGCCACAGCACTCCAGCCTGGGCAACAGAGTGAAAGGAAAAAAATAAAAAA","TGAACCCGGGAGGTGGAGGTTGCAGTGAGCCAAGATCACACCAATGCACTCCAGCCTGGGCAACAAGAGTGAAACTCTGTCTAAAAAAAAAAAA"
"GL873580","320374","320488","chr13","48549305","48549409","42","48228931","GGTAGTGCGTGCCTGCATTCCCAGCTACGGGAGGGCAGGGACTTGAGGCCAGCCTGGGCAAAATAATGAGACCTACTAATGACTCTACTAATACAGAAACAATTAGCTAGGTATG","TGGGAGGCCGAAGTGCGCAGATCACCTGAGGTCAGAAGTTGGAGACCAGCCTGGCCAACATGGTGAAAACCCATCTCTACTAAAAATACAAAAATTAGCTGGGCA"
"GL873580","374969","375091","chr6","147681010","147681135","27","147306041","CGGTGGCTCACACCTATAATCCTAGCATTTTGGAAGGCTGAAGCCGAGGATCTCTGGAAGTCAGAAGTTCAAGACCAGCCTGCCCAAGAGCAAGACCCCATCTCTACTAAAAATAGAAAAACT","GGTGGCTCACACCTGTAATCCCAGCATTTTGGGAGGCTGAGGCAGGCGGATAATCTGAGGTCAAGAATTTGAGACCAGCCTGGCCAACATGGAGAAACCCTATCTCTACTAAAAATACAAAATTAC"
"GL873580","375369","375549","chr7","19977275","19977456","44","19601906","CTAACCAAGTTAGTTAGTTTTAGTTGGCAGGTGCCTGTAGTCCCAGCTCCTTGGGAGGCTGAGGCAAGAGAATGGCTTGAGCCCAGGACTTTGAAGTTGCTGTGAGCTATAATGACACCACAGCACACTACCCAGGGTGACAGAGTGAGACTGTCTCAAAAAAACAAACAAACAAAAAAAA","AACAAACGTTAGCCGAGCATGGTGGTATGTGCCTGTAGTCCCAGCTACTTGGGAGTCTAAGGCAGGAGAATTACTTGAGCCCGGGAGGCAGAGGTTGCTGTGAGCCAAGATCACGCCACTGCACTCCAGCCTGGGTGACAGAGTGAGACTCCATCTCAAAAAAAAAAAAGGAAAAAAAAAAA"
"GL873580","8760922","8761015","chr11","104681322","104681416","19","95920400","GGAGGGAGACACTGCAGTGAACTGCGATCGTGTCTCTGCTTTCCAGGCTGGGTGACAGAGTGAGACTCGGTCTCTAAAATAAAAAATAAATAAA","GGAGACGGAGGTTGCAGTGAGCTGTGATCGCGGCACTGCACTCCAGCCTGGGCAACAGAGTGAGACTCTGTCTCAAAAATAAATAAATAAATAAA"
"GL873580","9391260","9391306","chr14","49279240","49279285","12","39887980","GCCAGTCGAGGTGGCTCACACTTGTGATTCCAGCTACTTGGAAGACT","GGCTGAGATGGTGGCACACACCTGTAATCCCAGCTACTTGGGAGGC"
"GL873581","759283","759365","chr6","46535476","46535542","30","45776193","TAAGAACCTGAAAATAGAGCCAGGCATAGTGGTACATGCGTATAGTCCTGGCTACTCAGGAGGTTGAAACAACAGGATTACTT","CAAAATAGCCAGGCTTGGTGGTGCATGCCTATAATCCAAGCTACTCGGGAAGCTGAGGCAGGAGAAT"
"GL873581","1145844","1145979","chr1","29437872","29437991","29","28292028","GGCCGGGCGTGGTGGCTCACGCCTGTAGTCCCAGCACTATGGGAGGCCGAGGCGGGTGGATCACCTGTGCTCAGAGGTTCGAGACCAGCCAAGACCCCCCTGAGCCAAATGAGCCAGAGTGAGACCCCGTCTCTAC","GGCCGGGCGTGGTGGCTCACGCCTGTAATCCCAACATTTTGGGAGGCCAAGGCGGGTGGATCACCTGAGGTCAGAAGTTCGAGACCAACCTGGCCAACATGGTGAAACCCCTGTCTCTAC"
"GL873581","9628238","9628362","chr5","141044567","141044691","34","131416329","ATCCCAGGTAGTCGGGAGGCTGAGGCAGGAGGATCACTTGAACCCAGGAGGTTGAGGTTGCTGTGAGCAAGGCAGAGGCAACGGCACTCTAGCCACGGGGGCACAGAGACTCTTGTCTTTAAAAA","TAATCTCAGCTACTCGGGAGGCTGAGGCAGGAGAATCGCTTGAGCCCAGAAGGTGGAGGTTGCAGTGAGCCAAGATCGCGCCATTGCACTCCAGCCTGGGCGACAGTGCGAGACTCTGTCTCAAA"
"GL873582","1580485","1580534","chr6","32576760","32576806","12","30996275","CAGCACTTGAGAGGCCAAGGCAGGTGGATCAACTGAGCAAGAATGAGACC","CCAGCACCTTGAGAGGCCAAGGCAGGTGGATCACCTGAGGTCAGGAG"
"GL873582","1644368","1644551","chr1","211626449","211626612","63","209982081","AAAATTTGCCGGGCTCCATAGCTCATGCATGTAATCATAGCACTCTGGGAGGCCAAGATGGGAGGATCTCTCAAGCTCTCTTACTTGGGAGGCTGAGGTTGCTGTGAGTTAGGCTTACGCCACAGCACTCTACTCTAGCGTGAGCAACTCTACTCTTAGTATGAGACTGTCTCAAAAGAAAAAA","AAATTAGCCAGGCGTCGTGGCACATGCCTGTAATCCCAGCTACTCGGGAGGCTGAGGCAGGAGAATAGCTTGATCTCGGGAGGCGGAGGTTGCAGTCAGCCGAGATCACACCACTGCAATCCAGCCTGGACAACAGAATGAGACTCCATCTCAAAAAAAACAAA"
"GL873582","5794385","5794459","chr13","18872784","18872852","27","13078399","ATATTGTTAAGCACAGCCACTATTAAAAATTAAATTATAGGCCAGGCATAGTGGCTCATGCCTGTAATCCTAGCT","TGAAACCACCATCTGGACCAAGATACAAAATGTTGGCTGGGCATGGTGGCTCACACCTGTAATCCTAGC"
"GL873583","102645","102683","chr14","5808766","5808804","14","5706121","GAGCAGATCACCTGAGCTCAGGAGTTTGAGACCAGCCTG","GAGGAATCCCTGTGCTCAGGAAGCTTACATTCTAGTGAG"
"GL873583","6200447","6200560","chr4","17786849","17786963","24","11586402","GGCCAGGAGGGACGGCTCATGCCTGTTATCCTAGCACTATGGGAGACTGAGGTGGGAGGATCACTTGAAGTTAGGAGTTCCAGACCAATCTGACCAAAGTGAGACCTCATCTCT","GGCCAGGCTTGGTGGCTCATGCCTGTAATCTTAGCACTTTGGGAGGCTGAAGTGGGTGGATCACTTGAGGTCAGGAGTTAGAACCAGTCTGGCCAACATGGTGAAACCTCAGCTC"
"GL873583","6200584","6200752","chr6","169626528","169626696","42","163425944","TTAGCTGGATGTGGTAGCACATGCCTATAGTCCCATCTACTCAGGAGGCTGAGACAAGAGAGTTGCTTAAGCCCAGGAGTTTAATTTAACTGTGAACTAGACTGAGACTGTGGCACTCTAGCTGGGGCAACAGAGTGAGACTCTGTCTCAAAAGAAAGCAAGAAAGAAA","TTAGCTGGGTATGGTGTCAGATGCCTGTAGTCCCAGCTACTCAGGAGGCTGAGACAGGAGAATCGTTTGAACCCAGGAGGCCAGAACTGCAGTGAGCTGAGATTCGCACCACTGCGCTCCAGCCTGGGCCAGACAGAGTGAGACTCTATCTCAAAAGAAAAAAAAAAAA"
"GL873583","10217398","10217583","chr3","36257142","36257313","44","26039744","TACTAAAAATAAAGTGTGATAGCCAGGCATGGTGGTGGTGCCTATAGAACCAGGCTATTCAGGAGGCTGAGGCAGAAGGATCACTTGAACCCAGGAGTCTGACGTTGCTGTGAGCTAGGCTGGTGCCATGGTACTCTAGCCTGTGGTAACAGAATGAGACTCTATCTCAAAAATAAAAATAAAAAA","TACAAAATTAGCCAGGCGTGGTGGTGCGTGCCTGTAATCCCAGCTACTTGGGAGGCCGAGGCAGAAGAATGACTTGAACCCAGGAGACAGAGGTTGCAGTGAGCCAAGATCCCACCATTGTACTCCAGCCTGGGCAACACAGTGAGACTCCATCTCAAAAAAAAAAAAAAAA"
"GL873583","10394919","10394983","chr16","12841703","12841771","22","2446784","GAGGTCAGGAAATCAAGATCAGTCTGGGCAATATATTGATACCCTGCCCCTACATAAGGAAGAAA","AGGTCAGGAGTTCAAGACCAGCCTGGCCAATATGTTGAAACCTCATCTCTACTAAAAATACAAAAATTA"
"GL873584","521512","521529","chr1","167402212","167402233","10","166880700","GCATGGAACCCCCCACTC","GGTGAAACCCCATCTTTACTAA"
"GL873584","2079725","2079768","chr15","4338291","4338335","11","2258566","GGCAGGTGGATTACCTGAGTTCAGGAGTTGGAGACCAGCCTGAC","AGGCGGATGGATCACGAGGTCGGGAGTTTGAGACCAGCCTGACCA"
"GL873584","5216877","5217053","chrX","91350057","91350230","49","86133180","CTACTGAAAATGATGACAGAGGCTGGGCATGGGGGCTCCCGCCTGTTATCCTAGCACCCTCGGAGGCTGGGGAATGAGGATTGCTTACGCCCAAGAGTTTGAGGTTGCTGTGAGCTGAGGCCGCTGCACTCTAGCCTGGGCAACAGAGTGAGACTCTGTCTCAAAAAAAAAAAAAAA","TGCAAAAATGAGCTGGGCATGGTGGCACATGCCTGTAATCCCAGCTACACAGGAGGCTGAGGCAGGAGAATCGCTTGAATCTGGGAGGCGGAGGTTGCAGTGAGCTGACATCAGGCCCCTGCACTCTAGCCTGGGCCACAGAGCAAGACTCCGTCTCAAAAAAAAAAAAAAAAA"
"GL873584","7289930","7289950","chr2","51453328","51453345","10","44163398","TGAGGCTCTGTCTCGAAATAA","AATGCCATCTATTAAAAA"
"GL873584","7289975","7290131","chr11","49739997","49740154","37","42450022","CAAGAAAATTAGCTGAGAGTCCTGGTAGGTGCCTGTAATCCCAGCTATTCATGAGGCTGAGGCAGAAGGATCACTTGGGTCCAGGAGTCTGAGGTTGCTGTGAGCTAGTCTGACGCCATAACACGCAAGCCTGGGCAACAGAGTGAGGCTCGGTTTC","CTACAAAAATTAGCTGGGCGTGGTGGCACATGCCTGTAATCCCAGCTACTCGGGAGGCTGAGGCAGGAGAATCACTTGAGCCCAGGAGGCGGAGGTTGCAGTGAGCCAAGATCATGCCATTGCACTCCAACCTGGGCAACAGAGCAAGACTCCATCTC"
"GL873584","7577743","7577867","chr5","48394329","48394446","27","40816586","GGCTGGATGAGGTGGTTCATGCCTGTAATCCTAGCACTCTGGGAGGCCAAGGTGGGTGGATTGCCTGAGCTCAGGAGTTCAAGACCAGCCTGAGCAAGACCCTGTCGCTAAAAATAGCTGGGTGT","GGCTGGGTGCAGTGGCTCATGCCTGTAATCCCAGCACTTTGGGAGGTCAAGGCGGGTGGATCACCTGAGGTCAGGAGTTCAAGACCAGCCTGGCCAACATCTCTACTAAAAATACAAA"
"GL873584","7578135","7578289","chr1","130112713","130112865","31","122534578","GGAGCTGGGTTTTGTGACTGCACCTGTAATCCCAGCTGCTCAGGAGGCTGAGGCAAGAGAATTGCTTGAGCCCAGGAGTTGGAGGTTGCTGTGAGCTGTGATGCCAGGGAACTCTACCAAGGGTGACAAAGTGAAACTCTGTCTCAAAAAAAAAA","TTAGCCAGGTGTGGTGATGCATGCCTGTAATCCCAGCTACTCATGAGGCTGAGGCAGGAGAATTGCTTGAACCTTGGAGCTGGAGGTTGCAGTGAGCTGAGATCAGACCACTCCAACCTGGGTGACAGAGCGAGACTCTGTCTCAAAAAAAAA"
"GL873585","1450952","1451121","chr10","59681079","59681242","48","58230127","TAAAAACAGAAAAAACTAGTCAGGTGGTGTGGTAGGTGCTCATAAGTCCCAGCTGCTTGGGAGACTGAGGCAAGAGAATCACTTGAGCACAAGAGCTTGAGGTGGCTGTGAGCTATAACACCATAGCACTGTACTGAGGGTGACAAAGTAAGACTCTGTCTCAAAAAAAA","TACAAAAATTAGTCAAGGGTGGTGGTATGTGCTTGTAATCCCAGCTATTTGGGAGGCTGAAGCAGGGGAATCCTTGAACCCAGGAGGTGGAGGTTGCAGCGAGCCGAGATCACGTCACTGCACTCTAGCCTGGGCGATAGGGTGAGACTCTGTCTCAAAAAAAA"
"GL873585","1451382","1451515","chr6","17405813","17405948","24","15954431","GGCCCGGCTCGGTGGCTCACACCTATAATCCTAACACTCTGGGAGGCTGAGGCAGGTGGATCACCTGAGCTCAGGAGTTTGAGACCAGCTGAGCAAAAACAAGACCCTATCTCTGCTAAAAATAGAAAAAACTA","GGCCGGGCGGGGTGGCTCACGCCTGTAATCCCAGCACTCTGGGAGGCCAAGGCAGGTGGATCACCTGAGGTCAGGAGTTTGAGACCAGCCTGGCCAACACGCAGAAACCCTATTTCTACTAAAAACACAAAAATTA"
"GL873585","1626960","1627026","chr7","17782729","17782794","22","16155769","AAGATGCCACAGCACTCTACAAGAGTGACCAAGTGAGACTCTGTCTCAAAAAAAAAAAGAAAAGGAA","CAATCGCACTACTGCACTTCAGCCTGGGTGACAGAGTGAGAACCTGTCTCAAAAAAATAAATAAAA"
"GL873585","1627304","1627531","chr11","17033552","17033788","61","15406248","GGCTGGGCACAGTGGCTCACGGCTATAATCTAGGCACTTGGGAGGCTAGGGCAGGTGGATTGCCTGAACTGACAAGTTTGAGACCAACCTGAGCAAGAGCGAGACCCCTGTCTCTAAAACATAGCCAGGCTCTGTGGTGGGCGTCTGTAGTCCCAGCTACTTGGGAGGCTGAGGCAAGAGAATTGCTTGAACTCAAGAGTCTGAGGTTGCTGTGAGTTAAGATGCCAC","GCCCGGCGCAGTGGCTCACGCCTGTAATCCCGGCACTGTGGAGGCCAAGGCAGGCGGATTGCCTAAGCTCAGGGATTCGAGAACAGCCTGGGCAACATGGTGAAACCCCATCTCTACTAAAATACAAAAAACTAGCCGGGCGTGGTGGTATGCGCCTGTAATCCCAGCTACTTGGGAAGCTGAGGCAGGAGAATTGCTTGAACCCGGGAGATGGAGGTTGCAGTGAGCTCAGATCAC"
"GL873585","3626082","3626158","chr1","100916857","100916922","27","97290775","TGCCTGTAATCCCAGCACTTGGGAGGCGGAGGTGGGTAGATTGCCTGACCCAGAGTGGGACCTCATCTCTAAAAGAA","CATGCCTGTAATCCCAGCACCTTGGGAGGCCAAGGTGGGTGGATCACCTGAGGTCAGTAGTTTGAG"
"GL873585","8849829","8849913","chr18","48581945","48582025","18","39732116","GGCTGGACGAGGGGACTCATGCCTGCAATCCCAGCACTGAGAGAGGCCAAGGCAGGTGGATCCCCTGAGCTCAGAAGTTTGAGAC","GCTGGACGCAGTGGCTCACACCTGTAATCCCAGCACTTTGGGAGGCCAAAGCAGGCAGATCTGAGGTCAGGAGTTTGAGAC"
"GL873585","9319890","9319971","chr8","79499361","79499447","14","70179471","GGCCAGGTGTGGTGGCTCACACCTGTCATCCTAGCACTCTGGGAGGACGAGGTGGGTGGACCGCCTGAGTCAGAGTGAGACC","GGCCAGGTGTGGTGGCTCACACCTGTAATCCCAACACTTTGGGAGGCCCAGGTGGGTGGATCACCTGAGGTCAGGAGTTCAAGACCA"
"GL873586","895572","895692","chr17","14501559","14501680","38","13605987","GGCCAGGTGAGGTTTCTCATTCTGGGAGTGAGCCAGCAATTGGGAGGCCAAAGTAAATGGATTGCCTGAGGTTATAGGTTCCAGAACAGCCAGAACAAGATCGAAATCCTGTCTCCAAAAA","GGCCAGGCGTGGTGGCTCATGCGTGTAATCTCAGCACTTTGGAAGGCCGAGGCAGGTGGATCACCCGAGGTCAAGAGTTCAAGACCAGCCTGACCAACATGGCGAGTCTCTGTCTCCACTAA"
"GL873586","5645995","5646150","chr6","58863249","58863409","38","53217254","GGGTATGGTGGCTCATGCCTGTAATCCAAGCACTCTGGGATGGTGAGGCAGGAGAATCCCTTGAACCCAAGAGTCCGAGGTTGCTGCGAGCTAAGCTGATGGCATAACACTCTAGCCTAGGCGACAGAGTGAGACTCTGTTTCCAAAGAGAAAAAA","TTAGCCAGGCATGGTGGCACATGCCAGTAATCCCAGCTACTCAGGAGGATGAGGCAGGAGAATCGCTTGAACCCAGGAGGCAGAGGTTGCAGTGAGCTGAGATTGCGCCACAGCACTCTACCCTGGGTGACAGAAGGAGACTCTGTCTCAAAAAAAAAAAA"
"GL873586","10258686","10258969","chr12","9481260","9481565","81","777426","GGCCGGGCATGGTGGCAGAAATCTAGGAGGCCGAGGCAGGTGGATCGCCTGAGATCACAAGTTCAAGACCAGCCTCAGCTACAGCAAGACCCCATCTCTAAAAATAGCCGGCTGTTGTGGCAGGCGCCTGTAACCCCAGCTACTCGGGAGGCTAAGGCAAGAGAATCGCTTGAGCCCATGAGTCTGAGGTTGCTGCGAGCTGTGACTCCACGGCACTCTACCCGGGGCGATAAAATGAGATTCTGTGTCAAAACAAACAAACAAACAAACAACAACAAAAACAA","GCTGGGCGCGGTGGCTCATGCCTGTAATCCCAGCACTTTGGGAGGCCAAGGCAGGTGGATCACCTGAGGTCAGGAGTTCGAGACCAGCCTAGTCCACATGGTGAAACCCCATCTCTACTAAAAACTAGCCAGGCGTGGTGGTGCGCACCTGTAATCCCAGCTACTCGAGAGGCTGAGGCAGGAGAATCACTTGAGCCTAGGAAGCAGAGGTTGTGGTGAGCTGAGATCACACCACTGCACTCCAGTCTGGGCGACACAGTGAGACTCTTGTCTCAAAAACAAAAAACAAACAAACAAACAAACAAA"
"GL873587","3208032","3208047","chr8","3626746","3626762","2","418714","AAACAACCACAAAAAA","ACAACAACAACAAAAAA"
"GL873587","3208141","3208321","chr19","2057131","2057316","59","1151010","TTTCTTTTAAAAATCACCCATGGGCTGGGTATAGTGGCTCACACCTATAATCCTCGGGAGGCCAAGGTTGGAGGATTGCTTGAATCCAGGAGTTGAAGGTTACAGTGAACTGGGATTTAGCCACTAGACTCTAGCATAGCTGACAAAGCAAGAACCTATTTGTTTAAAACACAAAAAAGAA","TACTAATAATACAAAAATGAGCCGGGTATGGTGGCGGGTGCCTGTAATCCCAGCTACTGAGGAGGCTGAGGCAGGAGACTTGCTTGAACCCAGGAGGTAAAGGTTGCAGTGAGCTGAGATTGCACCACTACACTCCAGCCTGGGCGACAAGAGCAAAACTTTTTCTCCAAAAAAAAAAAAAAAAAA"
"GL873587","3278260","3278367","chr19","19044200","19044312","39","15765940","CAGTCTGAGCAAGAGGGAGAGGCTATTTCTACTAAAAACAGAAAAACTAGCTGGGTGTTGGGGTGTGTTCCTAGTCTCAGTTACTTGGGAGGCTGAAGTAAGAGGATC","ACCAGCCTGGCCAACACGGTGAAATCCCGTCTCTACTAAAAATACAAAAATTACCTAGGCGTGATGGCACGTGCCTGTAGTCCCAGCTACTCATAAGGCAGAGGTGAGAGAAT"
"GL873587","3278673","3278754","chr7","49412503","49412597","28","46133830","GGCCACGAGAGCTAGCTCATGCCTATTCTAGGAGGCCAAAGCAGGCAGACTGCCTGAGCTCAGGAGTTCAAGAGCAGCCTGG","GGCCAGGTGCAGTGGCTCATGCCTGTAATCCGAGCACTTTGAGAGGCCGAGGCAGGCAGATCACCTGAGGTCAGGAGTTCAAGACCAGCCTAGTA"
"GL873587","3782076","3782188","chr9","112128434","112128552","34","108346358","ACTGGGGTGGCTGAGGCAGGAGCGTCACTTGAACTCAGGAGTTTGAGATTGCTGTGAGCTGAGCAGATGTCATGGCACGCTAGCCTAGGTAATAGAGTGAGACTTCGTCTAAA","CAGCTACTCGGGAGGCTGAGGCAGGAGAATCACTTGAACTCGGGAGGCGGAGGTTGCAGTGAGCCGAGATCACGCCATTGCACTCCAGCCTGGGCAACAAGAGCGAAATTCCATCTCAA"
"GL873587","4564996","4565084","chr20","27900350","27900437","14","23335354","GGCGGGGTGTAGTGGCTCATGCCTATTGTCCCAGCACTGTGGGAGGCCGAGGTGGGTGGATCACCTGTGCTCAGAAGTTTGAGACCAGC","GGCCGGGCGTGGTGGCTCATGTCTGTAATCCCAGCACTTTGGGAGGCCGAGGTGGGTGGATCACCTGAGGTCAGGAGTTCAAGACCAG"
"GL873587","6307870","6308175","chr12","112427710","112428020","54","106119840","GGCCAGATATGATGGCTCATGCTTGTAATCCTAGCACTCTGGGAGGCTGAAGTGGGAGGATCACCTGAGATCAGGAGTTCAAGATCACCCTGAGCAAAAGTGAGATCCCATCTCTATTAAAAATAAAAAAATTATCCAGGCATGGTGGTGCAGTCCTTTAGTCCCAGCTACTTGGGAGGCTGAGGCAGGAGAATCTCTTGAACCCAGGAATTAGAGGTTACAGTGAGCTGTGATGATGCTACTGCACTCTAGCAGGATGACAGAGTGAGATACTCCGTGTCAAAAAAAAAAAAAAAAAAAGCAAAA","GGCTGGACATGGTGGTTCATGCTTGTAATCCGAGCACTTTGGGAGGCCAAGGCGGGTGGATCACCTGAGGTTGGGAGTTCGAGACCAGCCTGACCAACATGATGAAACCCCATCTCTACTAAAAATACAAAAAAATTAGCCAGGCATGGTGATGCACGCCTGTAATCCCAGCTACTTGGGAGGCTGAGGCAGGAGAATCACTTGAACCCAGGAGGCAGAGGTTACAGTGAGCCGAGATCATGCCATTGCACTCCAGCCTGGATGACAGAGTGAGCCTCTGTCTCAAAAAAAAAAAAAAAAAAAAAAAAAAA"
"GL873587","6484004","6484128","chr10","67341428","67341546","29","60857424","GACCAGGTTCTGTGGCTCATGCTTGTAATCCTAGCACTCTAGGAGGCCGGAAGAGGGTGGATTGATTGCCTGAGGTCAGGAGTTAGAGACCAGCCTGAGCAAGAGCTAGACCCTGTTTCTTTCTT","GGCTGGGTGTAGTGGCTCATGCCTGTAATCCCAGCACTTTAGGAGGCCAAGGTGGATGGATTGCCTGAGCTCAGGAGTTCGAGACCACCCTGGGCAACAAGCCAAAACCCTGTCTCTAC"
"GL873587","6484407","6484586","chr3","167196537","167196723","48","160712130","TAGACCCTGTTTCTAAAAAAAAAATAGCCAGGTGTTGAGGCAGGTACCTGTAGTCCCAGCTACCTGGGAGGGCTGAGGCAAGAGAATCGCTTGAACCCAAGAGTTTGAGGTTGCTGTGAGCTGAGATGCTATGGCACTCAACCGTGAGCTACAAAGTGAGACTCTGTCTCAAAAAAAAAA","AAAACCTGTCTCTGCTAAAAATACAAAAATTAGCCGGGTGTGGTGATGTGCGCCTGTAGTCCTAGCTACTTGGGAGGCTGAGGCAGGAGAATCACTTGAATCCAGGAGGTGGAGGTTGTAGTGAGTCGAGATCGTGCGACTGCACTCCAGCCTGGGTGACAGCGAGACTCTGTCTCAAAAAAAAAAA"
"GL873587","7466229","7466364","chr1","29437872","29437991","35","21971643","GGCCAGGCGTGGTGGCTCATGCCTGTAGTCCCAGCGCTATGGGAGGCCGAGGTGGGTGGATCACCTGTGCTCAGAGGTTCGAGACCAGCCAAGACCCCCCTGAGCCAAATGAGCCAGAGTGAGATCCCATCTCTAC","GGCCGGGCGTGGTGGCTCACGCCTGTAATCCCAACATTTTGGGAGGCCAAGGCGGGTGGATCACCTGAGGTCAGAAGTTCGAGACCAACCTGGCCAACATGGTGAAACCCCTGTCTCTAC"
"GL873588","1502535","1502718","chr1","34852429","34852590","60","33349894","GGTGCAGTGGCTCACACCTGTTGTCCCAGCGCTGTGGGAGGCCGAGGTGGGTGGATCACCTGTGCTCAGAGGTCGAGACCAGCTGAAGACCTGCCTGAGGCAGAGTGAGCCAGAGTGAGACCCCGTCTCTACTAGAACAACAACAAGACAGCCAGACCTTGTGATCCCAGCTACATGGGGGGCT","GCCAGGTGCAGTGGCTCACACCTGTAATCCCAGCACTTTGGGAGGCCGAGGCGGGCGGATCACCTGAGGTCAGGAGTTTGAGACCAGCTTGACCAACATGGAGAAACCCCGTCTCTACTAAAAATACAAAATTAGCCTGGTGTGGTGTCGCATGCCTGTAAT"
"GL873588","10189037","10189246","chr3","45604681","45604903","65","35415644","GCTGAGATGAGGAGACTCTGTCTCTATTAAAAATAGAAAAATTGGGTGGATGTTGTGGGTACTGTAGTTGCAGCCTCTTGGGGGGCTAAGGCAGGAGGATCAGTTGAAGCCAGGAATTTGCTTTGAGCTAGGCTAAAGCCATGGCACTCTAGCCTGGGCAACAGAGTGAGGCTAGATCTCAAAAAAAGAAAGAAAAGAAAAAGAAAAAAA","CTGGCCAACATGGCAAAACCCCATCTCTACTAAATATACAAAAATTAGCTGGACGTGGTGGCACATACCTGTAATCCCAGCTACTTGGAAGGCTGAGGCAGGAGAATAGCTTGAACCTGGGAGGCAGAGGTTGCAATGAGCTGAGATCACGCCACTGCACTCTAGCCTGGGCAATAGAATGAGACTCTGTCTCAAAAAAAAAAAAAAAAAAAAAGACAAGAAA"
"GL873589","104719","104807","chr20","27900350","27900437","13","27795631","GGCTGGGCGTGGTGGCTCATGCCTGTTGTCCCAGCGCTGTGGGAGGCTGAGGTGGGTGGATCACCTGTGCTCAGAGGTTCGAGACCAGC","GGCCGGGCGTGGTGGCTCATGTCTGTAATCCCAGCACTTTGGGAGGCCGAGGTGGGTGGATCACCTGAGGTCAGGAGTTCAAGACCAG"
"GL873589","796766","796905","chr1","166346372","166346487","49","165549606","GGCTAAGTGTGGTGGCTCACACCTGTCATCTAGTACTTTGGGAGGGTGGGCCTGGGAGTTCAAAGACTGAACTCAGGAGTTCAAGGTGGCTCCGGGGAGGAATTCAAGACCAACCTGAGCCAGAGCGAGACCTCGACTCT","GGCCAGTGGGGTGGCTCACGCCTGTAATCCCAGCACTTTGGGAGGCTGAGGTGGTCAAATGACCTGAGGTCAGGAGTTTGAGACCAACCTGGCCAACATGGTGACACCTCGTCTCT"
"GL873589","1023679","1023690","chr1","205890061","205890072","1","204866382","AAAAAAAAAAAA","ACAAAAAAAAAA"
"GL873589","1023771","1024047","chr4","103012712","103012993","70","101988941","GGCTTGGTGGCTCACACCTGTAATCCTAGCACTCTGGGAGGCCGAAGTGGCTGGAATACTTGAGGTCAGGAGTTCAAGACCAGCCTAAGTGAGAGTGAGATCCCCATCTCTAATAAAAATAGAAAAATTAGCAGGGTGTTGTGGCTGGCACTTGTAGTCCCAGCTACCCAGGAGACCGAGGCAGAAGTTTGAGATTATTGTGAGCGAGGCTGATGCCACAGCATTCTAGTGGGACAACAGAGCAAAATTCTATCTCAAAAGAAAAAAAAAAAAAGGA","CGGGCGTGATGGCTCACGCCTGTAATCCCAACACTTTGGGAAGCCGAGGCGGACGTATCACCTGAGGTCAGGAGTTCAAGACCAGCCTGGCCAACATGGTGAAACCCCGTCTCTACTAAAAATACAAAAATTAGCTGGGTGTGGTGGCATGCGCCTGTAATCCCAGCTACCCAGGAGGCTGAGGCAGGAGAATCGCTGAGGCTGCAGTGAACTGAAATTGTGCCACTGCACTCCAGCCTGGGTGACAGAGCAAGACTCTGTCTCAAAAAAAAAAAAAAAAAA"
"GL873589","4820958","4821024","chr8","33633747","33633811","15","28812789","TTAGTCAAGTGCAGTGGCTCACACCTGTCATCCCAGCTACTTGGGAGGCTGAGGCAGGAGAGTTGCT","TTAGCCAGGTGTGGTGGTGCATGCCTCTAATCCCAGCTACTCAGGAGGCTGAGGCAGGAGAATTG"
"GL873589","6763768","6763857","chrX","25814002","25814092","29","19050234","GGTGTGGTGGCTCACACTTGTATCTTAGCATTTTAGGAGGCTGAATGGGGAGAATTGCTTTAAGTCAGGAGTCTGACTTCCACCTTGCCA","GGCTGGGAATGGTGGCTCACACCTGTAATCCCAGCACTTTGGGAGGCTGAGGTGGGCAGATCACCTGAGGTCAGGAGTTTGAGATCAGCCT"
"GL873589","8444551","8444632","chr9","93194085","93194171","17","84749534","CGGGCATGGTGGCTCACAACTATAATCTTAGCACTTTGGGAGGCTGAGACAGGTGGATGCCTGAACTCAAGAGTTTGAAACC","GGCCGAGCATGGTGGCTCACACCTGTAATCCCAGCACTTTGGGAGGCTGAGGCAGGTGGATTACCTGAGGTCAAGAGTTCAAGACCA"
"GL873589","9085365","9085494","chr2","194063347","194063481","42","184977982","GGCCAGGCACAGTGGCTCACACCTATAATCCCAGCACTCTGTGAGACTGAGGCAGGTGAACTGTTGCAAGAGTGAGACCCTGTGCTTGGTGCCTGTAGCTCAGTGGTTAATAATAAGAAAAAAGAAAAAA","GGCCAGGTGCAGTGGCTCACACCTGTAATCCCAGCACTTTGGGAGTCTGAACCAGGCAGATCACCTGAGGTCAGGAGTTCGAGGCCAGCTCGGCCACCATGGTGAAACCCTGTTTCTAATAAGAATACAAAAAAA"
"GL873589","9085767","9086002","chr7","84631446","84631650","75","75545679","GAGTGAAACCCTGTCTCTACTAAAAATAGAAAAACTAGCTGTGCATCAGGGCGCATAACTGTAGTCCCAGGTACTCAGGACACTGAGGCAAGAGAATTGCTCAAGCCCAAGAGTTTGCAAGAATTTGAGGTTGCTATGAGCTATGATGCCATGGCACTCTACCTAGGGTGACAGACAGAGACTCTGTCCCAAAAAAAAAAAAAGAAGAAGAAGAAAAAAAAAAAGAAAGAAAGAAA","ATAGTGAAACCTCGTCTCTACTAAAAATACAAAAATTAGCTGGGCATCATGGTGCACGCTTGTAATTCCAGCTACTTGGGAGGCTGAGGCAGGAGAATTGCTTGAACTCAGGAGGTGGAGGTTGCAATGAGCCAAGATCGCGCCACTGCACACCAGCCTGGGTGACAAAAGACTCTGTCTCAAAAAAAAAAAAAAAAAAAAAAAA"
"GL873589","9992904","9993045","chr16","56427538","56427666","46","46434634","AACCAGCCAGGCATGGTGATTCACACCTATAATCCCAGCTACTTAGGAGTATGGCTTGAGCACACAGGATACCATACCATTCTAGTCATCCCAGGCAACAGAGGGAAACTCTGTTGGTTAAAAAAAAAGAAAAACTTAAAAA","TTAGCCAGGAGTGGTGGTGCACGCCTATAATCCCAGCTACTTGGGAGGCTGAGGCACAAGAATCACTTGAACCATTGCACTCCAGCCAGGGTGATAGAGGGAGACTCTATCCAAAAAAAAAACAAAAAA"
"GL873589","9993319","9993452","chr3","2774534","2774668","28","7218785","GGCCTGAGCCCTGTGACTCATGCCTGTAATCCCAGCACTGGAAGTTCCAAGGCAGGTGGATCGCTTGAGCTCTGGAGTTCAAGACCAGCTCAACCAAGAGTAAGACCCCATCTCTACTAAAAATAGAAAAACCA","GGCTGGGCACGGTGGCTCATGCCTGTAATCCCAGCACTTTGAGAGGCCGAGGCAGGTGGATCTCCTGAGGTCAGGAGTTCAAGACCAGCCTGGGCAACATGGTGAAACCCCATCTCTACTAAAAATACAAAAAAT"
"GL873590","9044589","9044884","chr1","83754525","83754835","84","74709936","GGCCAGGTGCAATGGCTCATGCCTATAATCCTCACACTCTGGGAGGCTGAGGCAGGAGGATCACTTTTCTCAGGGTCAGGGCCAGCCTGACAAAAGTCAGACCCTGTTTCTACTAAAAATAGAAAAACTAGCTGGGTGTTGTGGCAGATGCCTATAGTCCCAGCTACTAAGAGACTGAGACAAGTGCCCAGAGTCTGAGGTTACTGTGAGCAAAGCTGATGCCATAGCATTCTAGCTATAGATCGAGAGTCTGTCTCAAAAACAAACAAACAAACAAACAAACAAACAAAAAAGAA","GGCTGGGTGTGGTGGCTCATGCCTGTAATCCCAGCACTTTGGGAGGCCGAGGCGGGTGGATCATCTGAGGTCAGGAGTTCAAGACCAGCCTGACCAACATGGTGTAACCCTGTCTCAACTAAAAATACAAAAATTAGCTGGGCGTGGTGGTGTGCACCTATAGTCACAGCTACTTGGGAGGCTGAGACAGGAGAATTGCTTCAACCCAGGAAGTGGAGGTTGCAGTGAGCCAAGATCATGTCACTGCACTGCAGCCTGACAGAGCGAGACTCCATCTAAAACAAACAAACAAAAACAAACAAACAAACAAA"
"GL873591","1831505","1831587","chr17","61702818","61702899","25","59871313","CCCAGCACTTTGGGAGGGCAAGATGGGAGAATCATATAAAGTCAGGAGTTTGAGACCAGTTTGGCAGACATGATGAACCCATC","AATCCCAGCACTTTGGGAGGCTGAGGCAGGCGGATCATCTGAGGTCAGGAGTTCAAGACCAGCCTGGCCAACATGGTGAAAC"
"GL873591","2719175","2719275","chr4","86137755","86137847","32","83418580","GTGGGGGCTTAGGCCTGTAATCCCAGCACTCTGAGAGGCCAAGGTGAGCTGGTCACCTGGGTTTAGGAGTTTGGAGACTTGCTCGAGCTAGACTGAGGCTC","GTGGTGGCTCACGCCTGTAACCCTAACAATTTGGGAGGCCAAGGCAGGTGGATCACTTGAGGTCAGAAGTTTGAGACCAGCCTGGACAATATG"
"GL873591","4732974","4733120","chr19","7991801","7991954","55","3258827","ATACGCAGACTGGCCGAGCGTGGTGTCACATGCCTATAATCCCAGTGGCTACTCTGGGGAGGAGAATCTCTTGAAACCAAGAGTTAGAGATTGCAGTGGGGTATGATACAGGGTAACAAAGAGAGACCTTGGATCTGAAAAGAAAAA","AAAATACAGAAACTAGCTGGGCATGGTGATGCACACCTGTAATCCTAGCTACTGGGGAGGCTGAGGCAGGAGAATTGCTTGAACCCAGGAGTCAGAGGTTGCAGTGAGCAACCAGCCTGGGTGATACAGTGAGTGAGACTCTGTCTCGAAAAAA"
"GL873591","6822728","6823009","chr1","20579766","20580052","72","13757038","GGCCAGGCGTGGTGGCTCATGCCTGTAAATCTCAGCACTCTGGGAAGCTGAGGCAGGTGGATTGCTTGAGGTCAGGAGTTTGAGACCAGCCTGTACCAGAGTAAGACCCTGTCTCTAATAAAAATAGAAAAAAAAAAAAAAACTAGTTGGGCATGGTGATGGGTGCCTGTAGTCCCACCTACTTGGGAGGCTGAGGCAATGGCATCTCTTGAGCCCAAGAGTTTGAGGTTGCTGTGCCATGGCACTCTCCCCAGGGTAACAGAGTGAAAATAAAAAAAAGAA","GGCCAGGCGTGGTGACTCATGCCTGTAATCTCAGCACTTTGGGAGGCCGAGGCAGGTGAATCACCTGAGGTCAGGAGTTTGAGACCAGCCTGACCAACATGGTGAAACCTCGTCTCTACTAAAAATACAAAAAGTAGCCAGGCATGGTGGCGCATGCCTGTAATCCCAGCTACTTGGGAGGCTGAGGCAGGAGAATCGCTTGAACCCGAGAGGCAGAGGTTGCATTGAGTCAAGATGGTACCACTGCACTCCAGCCTGGGTGACAGATTGAGACTCAAAAAAAAAAA"
"GL873591","7578706","7578813","chr16","45055441","45055543","42","37476735","AAATTTAGCTACACATAGTGGCATGAGTCTGTAATGCTAGCCACCCAAAAGGCTGTAGTAAGAGGATTGCTCTATCCCAGGAGTTAAAGACCAGCCCGGACATCAGAG","AATTAGCCGGGCGTGGTGACACACACTTGTAATCCTAGATACTCAGGAGGCGAAGGTAGGAGAATTGCTTGAACCCAGGCAGCAGAGGTTGCAACGAGCAGAG"
"GL873591","9282916","9283004","chr1","20744253","20744338","16","11461337","GGCCAGGCGCGGTGGCTCACCCCTGTTGTCCCAGTTCTGTGGGAGGCCGAGGTGGGTGGATCACCTGTGCTCAGAGGTTTGAGACCAGC","GGCCAGGCACGGTGGCCACGCCTGTAATCCCAGCACTTTGGGAGGCCGAAGTGGGTGGATTACCTGAGGTCAAGAGTTTGAGACCA"
"GL873592","835155","835315","chr16","75654291","75654451","43","74819136","CTGGGTGTGGTGGCTCTTGTCTGCAATCTCAGTACACTGGGAGGCTGAGGCAGAAGGATTGCTCCAGCTCAGGAGTTTGAGGCCAGGCTGAGCTAGTGCAAAACCCCATCTCTACTAAAAAAAGAAGGAAAAAAAAAAGAAAAAGAAAAAAAATACGAGCT","CCAGGTGTGGTGACTCACGCCTGCAATCCCAGCACTCTGGGAGGCTGAGGTGGGTAGATTACCGGAGGTTAGGCGTTTGAGACCAGCCTGGCCAACATGGTGAAACCCCATCGCTACTAAAAAAAAAAAAAAAAAAAAAAAAAAAAAAAAAAAAAAAATTA"
"GL873592","835589","835765","chr1","66836166","66836336","48","66000577","ACAAAAAACCTAGCTTAGGGTTGTTATAGCACCTGTAGTCCCAGCTACTCAGGCGCTAAGGCAGGAAAATCTGCCTGAGCTCAGGAGTTTGAGGTTGCAGTAAGTTATGATGATGCTACTGCACTCTAGCTGGGGCAACAGAGTGAGACTCTGTCTGAGGAAAAACCAAAACCAAAA","TAGCCCAGCACGGTGGCTCACACCTGTAGTCTCAGCTACTCAAGAGGCTGAGGCATGAGAATCGCTTGAACCCAGGAGGTAGAGGTTGCAGTGAGCTGAGATCATGCCACTGCGCTCCAGCCTGGGCAACAGAGTGAGACTCAGTCTCAAAAAACAAAACAAAACAAAAAA"
"GL873592","2520661","2520705","chr16","66853217","66853257","11","64332556","TCTGGGAGGCTGAGGCGGGTGGATCACCTGAGCAAGAGTGAGACC","TTTGGGAGGCTGAGGCAGGTGGATCACTTGAGGTCAGGAGT"
"GL873592","4535248","4535388","chr1","12240468","12240612","38","7705220","GGCGGGATGTGGTGGTTCATGGCTGTAATCCCAGCACTCAGGGAGGCTGAGTCGGGTGGATTGCTTGAGTTCAGGAGTTTGAGACCAACCTGAGCAAGAACTAAGCCTGTCTCTACTAAAGATATTATTTCTTATTTTTCT","GGCCGGGCGCGGTGGCTCATGCCTGTAATCCCAGCACTTTGGGAGGCTGAGGCGGGTGGATCACCTGCGGTCAGGAGTTCGAGACCAGCCTGGCCAACGTGGTGAAACCTCATCTCTACTAAAAATATAAAAATTAGCTGGTGTG"
"GL873592","4535654","4535831","chr8","126054004","126054184","54","121518350","TCTACTACAAATATTAACAGAAAAATTAGCTGGGCATTGTGACAGGTGCCTATAGTCCCAGATACTCAGAAGGCTGAAGTAAGAGGATCACTTGAACCCCAGGAGCTAAGGTGGCTGTGAGCTAGGCTGAGGCTCTAGCCTGGGTAACAGAGTGAGACTGTAAAAAAAGAAAGAGAGA","GTCTCTACTAAAAATACAAAAATTAGCTGGGTGTGGTGGTGCATGCCTGTAATCCCAGCTACTCAGGAGGCTGAGGCAGGAGAATCGCTTGAACCCAGGAGGTAGAGGTTGCAGTGAGCCAAGATCATGCCACTGCACTCCAGCCTGGGTGACAGAGGGAGACTCTGTCTCAATAAATAAA"
"GL873592","6794968","6795049","chr3","154764711","154764794","20","147969743","GAAGGTTTGATGAGCTCAGATGATGCCACTGCAGTCTACCCAGAGTGAAGGAGCGAGACTCTGTCTCAAAAACAAAAAAAGA","CAGAGGTTGGCAGTGAGCTGAGACTGTGCCACTGCACTCCAGCCGGGTGACAGAGTGAGACTCTGTCTCAAATTACAAACAAAA"
"GL873592","6881384","6881478","chr5","24882384","24882475","28","18001000","GGGCAGGCATAGTGACTGGTGTCTCTAATCCTAGCAGTCTGGGATGCTGAGGCAAGTGGAATGTCAGAGTTCAGGAGTTGAAGATCACCCTGACT","GGCCGGGCGCAGTGGCTCACATCTATAATCCTAGCATTTTGGGAGGCTGAGGCAGGCGGATCACCTGAAGTCAGGAGTTTAAGACCAGCCTG"
"GL873592","6881755","6881937","chr10","61601371","61601572","66","54719616","TCACCCTGACCAAGAGCAAGACCCTGTCTCTACTAAAAATAGAATAAACTAGCTGGGAATTGTGGTGGGTGCCAGTAGTCCCCGCTACTGAGGCAGGAGGATCATTGAGTCCAAGAGTTTGAGGTTGCTGTAAGTTAGGACACCACAGCACTCTACACAGAGTAAGACTGCCTCAAAAATAAA","AGTAAAGAAAAGAAACCCTGTCTCTACTAAAAATACAAAAATTAGCTGGGTGTGGTGGTGCGCACCTGTAGTCCCAGCTACTTGGGAGGGTGAGGTATGGGAATCACTTGAACCCGGGAGGTGGAGGTTGCAGTGAGCCAAGATCACACCACTGCACTCCAGCCTGGGTGAGAGAGTGAGACTCTGTCTCAAGAAAAAAGAA"
"GL873592","7006080","7006155","chr1","8947061","8947129","24","1940981","CACACTGAGAGGCAAAGGCTGGTGGATCACCTGAGCTCAAGAGTTTGAGACCAGCCAAGCCAGAGATCTTGTCTCT","CACTTTGGAGCCAGGTAGGTGATCACCTGAGTCAGGAGTTCGAGACAGCCTGGCCAACATGTGAAACCC"
"GL873592","8446508","8446655","chr11","122502739","122502874","48","114056231","TTAGCTGGGTGTTGTGGCAGGCACCTGTAGTCCCTCCCAGCTACTTGAAAGGCTGAGGCAAGATGACAGCTTAAACCCAAGAGTTTAAGGTTACTCTATTCAGGGCAACAGAGTGAGACTCCATCTACATAAATAAATAAATAAATAA","GGCTGGGCGTGGTGGTTCACACCTGTAATCCCAACACTTTGGGAGGCTGAGGCCAGCGGATTGCCTGAGCCCAGGAGTTTGAGACCAACCTGGGCAACATGGTGAAACTCCATCTCTACTAAAATACAAAAAGTTA"
"GL873592","8446953","8447008","chr16","44513352","44513404","15","36066399","GACCAGCCTAAGCAAAAAAGAGATCCTATCTCTACTACTAAAAATAGAAAAAATTA","ACCAGCCTCACCAATATGAAGAAACCCCATCTCTACTAAAAATACAAAATATT"
"GL873592","8447239","8447325","chr1","8062863","8062957","21","384376","GGCCAGGAGCAGTGACTCATGCCTAGCACTCTGGGAGGCCAAAGCAGGTGGATCAACTGAGCTCAGGAGTTCAAGACCAGCCTAAGC","GGCCGGGTGCAGTGGCTCATGCCTGTAGTCCCAGGACTTTGGCAGGCCAAGGCCGGTGGATTACCTGAGGTCAGGAGTTCAAAACCAGCCTAGCC"
"GL873592","8723925","8724000","chr3","42066983","42067054","20","33343058","AATTAGCCGGGCATGGTAGTGTGTGCCCATAATCTCAGCTACTCAGAAAGCTAAGATAGGAAAATTGCTTGAGCTC","TTAGCTGGGTGTGGTAGTGCATGCCTATAATCCCAGCTACTCGGGAGGCTGAGGTGGGAGAACTGCTTGAAC"
"GL873593","384022","384146","chr15","102382935","102383070","28","101998913","GGCCACGAGGGCCCATGCCTGTAATCCTAGCACTCTGGGAGGCTGAGGTGAGTAGATTGCTGAGCTCAGGAGTTCAAGACCAGCCTGTGCAAGAGACCCCATCTCTGCTAAAAATAGAAAAACCA","GGCCAGGTGTGGTGGCTCACGCCTGTAATCCTAGCACTTTGGGAGGCTGAGGCGGGTGGATTGCCTGAACTCAGGAGGTCAAGACCAGCCTGGGCAACACAGTAAAACCCCATCTCTACTAAAATACAAAAAATCA"
"GL873593","384425","384607","chr20","28286874","28287058","50","27902449","GAAAGAAAAGAAAAGAAAAACTAGCAAGATGTTGTAGCTGATGCCTATAATCCTAGCTATTGGAGAGGTGGAGGCAAGAGAATTGCGTGAGCCCAAGAGTTGAAGGTTGCTGTGAGCTGCGATGCCAGAGCACTCCAGGGTGACAGAGTAAGACTCTGTCTCAAAAAAAATTACAAAATAAAA","TAATAAAAATAAAAAAATTAGCCAGGAGTCAAAGCACACGCCTATAACCCCAGCTACTTGGGAGGCTGAGGGAGGAGAATTACTTGAACCCGGGAGGTGAAAGTTGCAATGAGCTGAGATCAAGCCACTGCACTCCAGACTGGATGACAGAGTGAGACTCTGTTTCAAAAAAAAAAAAAAGACAA"
"GL873593","1408445","1408467","chr10","88070368","88070389","9","86661923","AATCTAGAGATGGGGAGAGGTTG","AAAGAGATGGAAGAGAAGAAGA"
"GL873593","4856365","4856484","chr7","56497314","56497433","31","51640949","GCAATCCCAGCTGATCGGGAGGCTGACCCAGAAGAATCCCTTGAACCCAAGAGTCTGAGGTTGCTATGGGTGGATTCTACAGCACTCTAGCCTGGGAGACAGAGTGAGACTCTGTCCCAA","ATCCCAGCTACTTGGGAGGCTGAGACAGAAGAATTGCTTGAACCCGGGAGGTGGAGGTTGCAGTGAGCCAAGATTGTACCACTGCACTCCAGCCTGGCAACAGAGTGAGACTCTGTCTCA"
"GL873593","6661298","6661485","chr10","86749316","86749514","55","80088018","GCAGAGGCTCACATATGTAATCCTAGCACTCTGGGAGGATAAGGCAGGTGGACAGCTTGAGCTCAGGGGTTTGACCAGTCTGATCAAGAGCAAGACCTGTGTCTACTAAAAATAGAAAACCTAGCCAGGTATGATGGTAGATGCCTGTATTCCTAGCTACTCTGGAAGCTAAAGCTAAAGAGTTTGAA","GGTGGCTCACACCTGTAATCTTAGCAATTTGGGAGGCCGAGGTGGGTGGATCACTTGAGGTCAGGAGTTTGAGACCAGACTGGCCAACATGGTGAAACTCTGTCTCTACTAAAAATACAAAAATTAGCCAGTCATGGTGGTGCATGCCTGTAATCCCAGCTACTCAGGAAGCTTAGGCAGGAGAATCACTTGAACCCAG"
"GL873593","6710263","6710446","chr14","4390080","4390244","66","2320183","TTGAAGTCAGGAGTTTAAGGCCAGTCTGGGCAACATAGTGAGACCCCCATCTCTACGAAAATATTTTTTAAAAATTAAAAATAGCTGGGCATAGTGAGGCTGTTGTGAGCTATAACTGCACCACTGCACTCAGCCAAGGACAGAGACCCTGTTCCCTGCCTCAAACAAACCAAAACAAAACAAA","AAGTCTAGAGTTTACAGCCTGGACAACGCAGTGAAACCCTGTCTCTACCAAAAATACAAAAATTAGACAGGTGTGAGAGGCGGAGGTTGCAATGAGCTGAGATCGCAGCACTGCAGTCCAGCCTGGATGACAGAGCGAGACCCCATCTCAAAAACAAAAACAAAA"
"GL873593","7159645","7159716","chr6","178318394","178318465","21","171158749","GATCATGTCACTGCTCTCCAACCTGGGCAATTGAGCAGGAATCTGTCTCAAAAAGAAAAAAAAAAAAGAAAA","CGAGTTCACACCACTGCACCCCAGCCTGGGCAACAGAATGAGACTCGGTTTCAAAAAAAAAAAAAAAAAAAA"
"GL873593","7159841","7160050","chr13","33368171","33368368","69","26208330","GGCCAGGCGTGGTGGCTCACACCTGTTGTCCCAGTGCTGTGGGAAGCCGAGGCAGGTGGATCACCTGAGCTCAGCCGAGTTCGAGACCAGTGGAAGACCAGCATGAGGCAGAGTGAGCCAGAGTGAGACCCCATCTCTACAACAACAACAAGAAGAAAAAAAACAGCCGGACCTTGTGATCCCAGCTACGTGGGGAGCTAGAGAATCACT","GGCTAGGCATGGTGGCTCATGCCAGTAATCCCACCACTTTGGGAGGCCGAGGCAGGTGGATCACCTGAGGTCAGGAGTTCAAGACCAGGCTGGCCAACATGTTATGATGAGACCCTCATCTCTACTACAAATACAAAAATCAGCTGGGCATGGTGGCAAGTGCCTGTAATCCCAGCTACTTGGGAGGCTGAGGCAGAA"
"GL873593","8598292","8598391","chr11","118461023","118461129","33","109862731","AGCCAGGTGAGGTGGTTCACACCTGTAACCCTAGCTGCTTGGGAGGCTGAGGCCTCTCTATCCTGGGCAGTGTGGAGAAACTTTGTTTCAAAAAAAAGAA","GCCGGGCGCGGTGGCTCACGTCTGTAATCCCAGCGCTTTGGGAAGCCGAGGCGGGACTATCCTGGCCAACATGGTGAAACCCCGTCTCTACTAAAAATACAAGAATC"
"GL873594","357249","357377","chr2","75702890","75703011","36","75345641","CCTGGTACCGTAGGTCATGCCTGTAATCCTAGCACTTTGGGATGCTGAGGTGGGCAGATTGCCTGAGCTCACGAGTTCAAGCCATTAGAACTGAGCCTGACCTAGAGTGGGACCTCCAACTCTTTTTTT","GCCAGGCACAGTGGCTCATGCCTGTAATCCCAGCAGTTTGGGAGGCTGAGGTGGGCAGATCACTTGAGGTCAGGAGTTCAAGACCAGCCTGGCTGACATGGTGAAACCCCATCTATACCAAA"
"GL873594","357656","357834","chr7","17608776","17608965","55","17251120","GGGACCTCCAACTCTTAAAATAGCTGGGCATTGTGGTGGGCACCTACAGTCACAGCTACTTGGGAGGCTAAGGCAAGAGACTTGTTTGCAGCCAAGAGTTAGAGGTTGCTGTGAGCTATGAGGCTAGGGCACTCTACAGGGGGCGACAAGTGAGACTGTAAAAAAAAAAAAAGAAAAAA","GTCCCTACTAAAAATACAAAAAATTAGCTGGGCCTGGTGGCAGGCACCTGTAATCCCAGCTACTTGGGAAGCTGAGGCAAGAGAATTGCTTGAACCCAGGAGGCAGAGGTTGCAGTGAGCTGACATCAAGCCACTGTACTCCAGCCTAGGCAACAAGAGCAAGACTCTGTCTCAAAAAAAAAAAAAAAAA"
"GL873594","1410711","1410996","chr5","151340503","151340797","76","149929792","CACAGTGGCTCATACCTATAATCCTAACACTCTGGGAGGCCAAGGTGGGTGGACTGTCTGAGTTTGGGACCAGCCTGAGCAAAAGCAAGACTCCCATCTCTACTAAAAACAAAGACAGCCAGGTATGAGGGCAGGTGCCTATCATCCCAGCTACTTGGGAGGCTGAGGAAGGAGGATCACCTAAGCCCAGGACTTTAAGGTTTCTGTGAACTAAGATGATGTTACAACACTCTAGCCAGGGTAACAAGGCAAGATTCTGTTTCAAAAGACAAAAAAAAAAAAAAAA","GGTGGTTCATGCCTGTAATCCCAGCACTTTGGGAGGCTGAGGCAGGTGGATCACCTGAGGTCAGGAGTTCGGGACCAGCCTGGCCAACATGGGGAAACCCCATCTCTACTAAAATACAAAAATTAGCCAGGTATGGTGGCACATGCCTATAATCCCAGCTACTTGGGAGGCTGAGGCAGGAGAATCACTTGAACCCAGGAGGCTAAGGTTGCAGTGAGCCGAGATTGTGCCACTGTACTCCAGCCTGGGTGACAGACTGAAACTCTGTGTCCAAAAAACAAAACAAAACAAAAAA"
"GL873594","5528090","5528162","chr2","69013639","69013718","24","63485549","GGTACAGTGGCTCACGCTTGTGATCCCAGGTTGAGGTGGGTGGATCGCCTGAGCTCAGGAGTTGGATGCCAGC","GGTGTGGTGCCTCACGCCTATAATCCCAGCACTTTGGGAGGCAGGTGGATCACTTGAGGTCAGGAGTTTGAGAACAGCCT"
"GL873594","5834047","5834168","chr2","82491537","82491662","28","76657490","GGCTGGGCCCAGTAGCTCACGACTGTAATCCCAGCACTCTGGGAAGCTGAGGTGGGCGGATCACCTGAGCTCATAGGTTCGAGACCAGCTCCAGTTAGAGTGAGAGCCTGTCTCTAAAAATA","GGCTGGGCACAGTGGCTCATGCCTGCAATCCCAGCACTTTGGGAGGCTGAGGTGGGCAGATCACCTGAAGTCAGGAGTTCAAGACCAGCCTGGCCAACACAGTGAAACCCCATCTCTACTAAAAAT"
"GL873594","5834396","5834461","chr13","14688151","14688212","20","8853755","TATATAATAATAATAACCAGGTATTGTGGCAGGTGCCTCTAGTCCCAGCTACTCGGGAGGCAAAGG","ATAAAAAAATTAGCTGGCCATGGTGGCACATACCAATAATCCCAGCTACTCAGGAGGCTGAG"
"GL873594","7786130","7786294","chr14","12217087","12217250","37","4430957","GGGTGTGCTGGCTCATACCTATAATCCTAGCACTCTGGGAGGCTGAGGTAGGTGTATTGCTTGAACCCAGGAGTCTGAGGTTGCTGTGCGCTAAGCTGATACCATAGCACTCTAGCCTGGGCAACAGAGTGAGACTCTGTCTCAAAACAAATAAATAGTAAAAAA","GCTGGGCGTGGTGGCTCACACCTGTAATCCCAGCACTTTGGGAGGCCAAGGCATGAGAATTGCTTGAAAACAGGAGGCGGAGGTTGCAGTAAGCTGAGACTGTGCCATTGCACTCCAGCCTGGGCAACAAGAGTGAAACTCTGTCTCAGAAAAAAAGAAAAAAA"
"GL873595","723579","723774","chr19","6045933","6046125","65","5322354","GCCTGAGCAGGAGAGAGACCCCATCTCTGCTGAAAGTGGAAAAGTTGGCTGAGTGTAGTGGCGGGCTGCTGCCCCAGTCACTCAGGAGGCTTAGGAAGGAGTATCGCTTGGGCCCAAGATTTGAGGTTGCTGTGAGCGCTACAAAGACATTAGGGTACTCTACACAGGGGAATAGAGTGAGACTGTCTCAAAAAAA","CAACATGGAGAAACCCCGTCTCTACTAAAAATACAAAATTAGGCAGCGTGGTGGTGGGTGCCTATAATCCCAGCTACTCAGGAGGCTGAGGCAGGAGAATCGCTTGACCGGGAGTGGAGGTTGCGGTGAGCTGAGATTGCACCATTGCACTCCAGCCTGGGCAACAAGAGTGAAACTCCGTCTCAAAAAGAAA"
"GL873595","724114","724204","chr20","18199749","18199840","22","17475635","GGCCATGCTTGGTGGTTCTCATCTGTAATCCTAGCACTCTGGAAGGTCTACAGGGGTGGATGGCTGGAGGTCAGGAGTTCAAGACTGGCCT","GGCCGGGCATGGTGGCTCACACCTGTAATCCCAGCACTTTGGGAGGCTGAGGCAGGCGGATCACCTGAGGTCAGGAGTTCGAGACCGGCCTG"
"GL873595","1065346","1065667","chr18","10529729","10530057","74","9464383","GGCCAGGTGCAGCAGCTCATGCCTGGAATCTTCCTGCTCTGTATGGCCAAGGCAGGTGGATCGCCTGACCTCAGGAGTTCCAGACCAGCCTGAACAAGAGCAAGACTCTGTCTCTACTAAAAGTAGAAAAAAAACTAGCCAGTCATAGTGGCAGGTGCCTGTAGTCCCAGCTGCTTGGGAGGCTGAGGCAAGAGGATCACTTGAACCTAAGAGTTTGAGGTTGCTGTGAGCTAAGATGCCACATCACTCTATCAAGGGTGACCAAGTGAGACTCTGTCTCAAAAATAAATAAATAAATAAATAAAAAGAAAGGCAAAAAGAA","GGCCCGGCGTGGTGGCTCATGCCTATAATCCCAGCCCTTTGGGAGGCCAAGGCAGGTGGATCACCTGAGGTCAGGCGTTCGAGACCAGCCTGACCAACGTGGTGAAACCTCATCTCTACTAAATACAAAAAAAATTTAGCCAGGCATGGAGGCACATGCCTGTAATCCCAGCTACTTGGGAGGCTGTGGCAGGAGAATCACTTGAACCTGGGAGGTGGAAGTTGCAGTGAGCTGAGATTGTACCACTGCACTCCAACCTGGGTGACAAAGCAAGACTCGGTCTCAATAAATAAATAAATAAATAAATAAATAAATAAAGTGAAAAAAAA"
"GL873595","1254878","1255146","chr4","42822326","42822607","67","41567448","GGCTGGGCATGGTGGCTCATGCCTGTAATCCTACCGCTCTGGGAGGCTGAGGCAGAGGATCACTTGAGCTCAGGAGTTTCAGACCAGCCTGCAAGAAGGACCCAGTCTCTGCCGAAAATAGAAAAGTTAGCAAGGCGTTGTCGTGAGCACATGTATCCCAGCTACCTAGAACTCTGAGGCAGGAGGATCCCTTGAACCCACAGAAGTTGCTGTTATCTAAACTGATGCCACTGGACTCTAGCCTGGGCAACAGAGTGAGACTGGTCTCA","GGCCGGGCACGGTGGCTCATGCCTGTAATCCTAGCATTTTGGGAGGCTGAGACAGGCAGATTGCCTGAGCTCAGGAGTTCAAGACCAGCCTGGGCTAGATTGTGAAACCCCATCTCTACTAAAATATAAAAATTAGCTGGGTGTGGTGGCACACGCCTGTAATCCCAGCTACCTGGGAGGCTGAGGCAGGAGAATCGCTTGAACCAGGAGACAGAGGTTGCAGTGAGCTGAGATCACGCCACTGCACTTTAGCCTGGGCAACAGAGTGATACTCTGTCTCAA"
"GL873595","3417105","3417297","chr12","115674238","115674427","44","112257133","GGCCGGGCGCTGTGCCTCACGCCTGTAATCCTAATACTCTGAGAGGCCGAGGCAGGTGGATTGCCTGAGCTCAGGTGCTCAAGACAGCCTGACTGAGCAAGCCCTGAGATCCCATCTCCACTAACAATAGTAAAACTAGCCGGGCATTGTGGTGGTGCTTGTAATCCCAGCTACTGGGAGGCTAAGACAGGAG","CCAGGCCTGGTGGCTCACGCCTGTAATCCCAGCACTTTGGGAGGCCGAGGTGGGTAGATCACCTGAGGTCAGGAGTTCAAGACCAGCCTGGCCAACATGGCGAAACCCCATCTCTACTAAAAATACAAAAATTAGCTGGGCATGGTGGTGTATGCCTGTAATCCCAGCTACTCGGGAGGCTGAGGCAGGA"
"GL873595","6098380","6098457","chr3","87492619","87492702","21","81394239","GCTGTGGCTCATGCTGATAATACCAGCACTCTGGGAGAACAAGGTAGGCAGATCACAAGAGGTCACCTGTGCAAGACC","GGGCTGGTGGTGGCTCATGCCTGTAATACCAGCACTTTGGGAGGCCAAGACAGGTGGATCACCAAAGGTCAAGAGTTCAAGACC"
"GL873596","134190","134307","chr1","203207333","203207443","31","203073143","GGCTGGGCGAGGTGGCTCACACCTGTAATCCTAGCACTCTGGAAGGCCCTAGCACTCAGGCAGTTGGATTGCCTGAGCTCACAAGTTCAAGACCAGCCTGAAAAAGAGCAAGACCTCA","GGCTGGGTGCAGTGGCTCACACCTGTAATCCCAGCACTTTGGGAGGCCGAGATGGGTGGATCACTTGAGGTCAAGAGTTGAAGACCAGCCTGGACAACATGATGAGACCCC"
"GL873596","134578","134681","chr11","50235285","50235387","37","50100707","CAAACAAAAGAGGAAGACCTCGTCTCTAAAAAAATAGCTGGGCATTGTGAGGAGTACCTGTAGTCCTAGCTACTCAGAAGGCTGAGACAAGAGAATCACTTAAA","CAACATTGTGAAACCCTGTCTCTACTAAAATAGAAAATTAGCCAGGTGTGTGGGCGTGCCTATAATCCTAGCTACTGGGGAGGGTGAGGCATGAGAATCGCCT"
"GL873596","8160215","8160350","chr1","29437872","29437991","30","21277657","GGCCGGGCGTGGTGGCGCACACCTGTAGTCCCAGCGCTATGGGAGGCCGAGGCGGGTGGATCACCTGAGCTCAGAGGTTCGAGACCAGCCAAGACCCCCCTGAGCCAAACGAGCCAGAGTGAGACCCCGTCTCTAC","GGCCGGGCGTGGTGGCTCACGCCTGTAATCCCAACATTTTGGGAGGCCAAGGCGGGTGGATCACCTGAGGTCAGAAGTTCGAGACCAACCTGGCCAACATGGTGAAACCCCTGTCTCTAC"
"GL873596","8421071","8421132","chr20","1874027","1874093","12","6547044","GTCAGGCGCAGTGGCTCACGCCTGTAATCTCAGCACTCTGAGAAGCCAAGGCAGGATCATCT","GGCCAGGCGCAGTGGCTCAGGCCTGTAATCCCAGCACTTTGGGAAGCCAAGGTGAGCAGATCACCTG"
"GL873598","4416400","4416489","chr5","39418145","39418231","15","35001745","GGCCAAGTGTGGTGGCTCATGCCTGTTGTCCCAGCACCGTGGGAGGCCGAGGCTGGTGGAACACCTGAGCTCAGCTGAGTTTGAGACCAG","GGCCAGTTGCGGTGGCTCATGCCTGTAATCCCAGCACTTTGGCAGGCTGAGGCAGGTGGATCACCTGAGGTCAGGAGTTTGAGACCA"
"GL873598","4416855","4416947","chr3","94091253","94091337","31","89674398","GTGAGACCCTGTCTCTACAAAAAAAAAAGCTGGGCACTGTGGCATGTGCCTGTAATCCCAGCTACTTGGGAGGCAAAGGGAAAGAGAATCACT","AAACCTTGCCTTTACTAGAAATACAAAAATTAGCTGGGCATGGTGGCAGGTACCTGTAATCCCAGCTACTTGGGAGGCTGAGGCA"
"GL873598","5126074","5126161","chr1","12339306","12339394","19","7213232","GCCTGGTGCACTGGTTCACACCTGGAATCCTTGCATTCTGAGAGGCCCAGGTAGGCAGATCACCTCAGCTCAGAAGTTCGAGACCAGC","GCTGGGTGCGGTGGTTCACGTCTGTAATCCCAGCACTTTGGGAGGCCGAGGCGGGCAGATCACCTGAGGTCAGGAGTTCGAGACCAGCC"
"GL873598","5467584","5467662","chr1","9313328","9313403","17","3845744","GCGAGGTGGCTCACGCCTGTAATCCCAGCACATTTGGAAGGCCAAGGAGGGTGGATCACCCGAGCTCACCAGTTGGAGA","CGCAGTGGCTCACGCCTGTAATCCCAGCACTTTGGGAGGCCGAGGCAGGCAGATCACCTGAAGTCAGGAGTTTGAG"
"GL873598","6917752","6917856","chr14","9558287","9558382","22","2640535","GGCCAGGCATGGTGGCTTGTGCCTGTTGTCCCAGCACTGTGGAAGGCCGAGGCGGGTGGATCGCCTGAGCTCAGCTGAATTCGAGACCAGCATAAGACCAGTATG","GGCCAGGCATGGTGGCTTATGCCTGTAATCCCAGCACCTTGGAAGGCCGAAGCGGGCAGATCACCTGAGCTCAGGAGTTTGAGACCAGCCTGTCCA"
"GL873598","8078910","8079062","chr7","164825511","164825660","43","156746601","AACAGCCAGGCATTGTGGTGGGCACCTGTAATCCCAGCTACTTGGGAGGCTGAGGCAAGAGAATTGCTTGAGCCCAACAGTCTCAGGTTACTGTGAGTTATGACACCATGGCACTCTATTGAGGGCAAGAAAGTGAGACTGTCTTGGAAAAAA","CTAGCCAGGCATGGTGGTGCGCACCTGTAGTCCCAGTTACTTGGGAGGTTGAGGCAAGAGAATTGCTTGAGCCTGGAAGGCAGAAGTTGCAGTGAGCTGAGATCACACCACTGCATTCCAGCCTGGGCGAAAGAGCAAGACTCTGTTGAA"
"GL873598","8079328","8079454","chr6","10381248","10381379","32","2301920","GCCCGGCGTGGTGGCTCACGCCTGTAATTCCAGCACTCTGGGGAGGCCGAGGAGGGCAGATTGCCTGAGCTCACAGGTTTGAGCTAGAGCGAGACCCTGTCTCTTAAAAAGAAAAAAAAGGAAAGAA","GCTGGGCGCGGTGGCTCACGCCTGTAATCCCAACACTTTGGGAGGCCGAGGCGGGCAGATCACCAGAGGTGATCTCCAGCCTGGGCAGGAGAGCAAGACCCTGTCTCAAAAAATTTAGAAAAAGGAAAGAAA"
"GL873599","3943256","3943456","chr9","35892110","35892312","79","31948854","GGCAGGCTGCTTTGACCCATATCTACAACTCCAGAACTTTAGAGGCTGAGCTGGGTGGGTCCCTTGAGATTAGAAACTGCTTAGTAGCCTGGCAAAAACCAGACCCCACCTCCACCATGTAGAAAAATTAGCAGTATGCCATAGTGGGAACCTACCAATACAGTCTTTCCAAAGGCCAAAGCTAGAAGGACCGTGAGCTTG","GGCTGGGTGTGGTGGCTCATGCCTATAATTCCAGCACTTTGGGAGGCCGAGGCAGGTGGATCACCTGAGGCCAGGAGTTTGAGACCAGCCTGGCCAATATGGTGAAACCCCATCTCTACTAAAAGTACAGAAAATTAGTCAGTCATGATGGCGCATGCCTATAATCCCAGTTACTCGGGAGGCTAAGGTAGGAGAATTGCTTG"
"GL873599","6693284","6693349","chr1","100916857","100916922","15","94223573","TCACGTCTATAATCCTAGCACTCTGGGAGTCCTTGGCAGGTGGATCACCTGAGCTCAGGAGTTTGA","CATGCCTGTAATCCCAGCACCTTGGGAGGCCAAGGTGGGTGGATCACCTGAGGTCAGTAGTTTGAG"
"GL873600","991618","991705","chr15","13850109","13850195","15","12858491","GGCTGGGCGTGGTGGCTCACACCTGTTGTCCCAGCGCTGTGGGAGGCTGAGGCAGGTGGATCACCTGTGCTCAGAGGTTGAGACCAGC","GCCGGGCGCTGTGGCTCACACTTGTAATCCCAGCACTTTGGGAGGCTGAGGCAGGTGGATCACCTGAGGTCAGGAGTTAGAGACCAG"
"GL873600","8825981","8826014","chr16","43605817","43605844","11","34779836","AGTCTGGGGCAACAGAGCAAGACTCTGTCTCAAA","CAGTCTGGGTGACAGAGCAAGATTCCAT"
"GL873600","8826039","8826157","chr13","87428402","87428520","35","78602363","ATTAGCCTGGTGTGGTGGTATATGCCTTCCTGCCTGCTTGGGAGGCTGAGGCAGGAAGTATGCTTTAACTGTGGAGTCTGAGGTTGCTATGAGCTAGGTTGAGGCCATGGCACTCTAAA","TTAGCCGGGTGTGGTGGTGCACGCCTGTAATCCCAGCTACTCAGGAGGCTGAAGCAGGAGAGTTGCTTGAACCCAGGAGTTGGAGGTTGCAGTGAGCTGAGATCACGCCATTGCACTCC"
"GL873601","269289","269338","chr14","49279240","49279285","14","49009951","GACTGGGTGTGGTGGCTCACACCTTTAATCCTAACACCCTGGGAGGCTTA","GGCTGAGATGGTGGCACACACCTGTAATCCCAGCTACTTGGGAGGC"
"GL873601","269431","269678","chr1","184453273","184453521","76","184183842","AGAAGATCACTCAAGATCAGGAGTTTGAGAACAGCCTGAGCAAGACCCCCATCTTTACTAAAAATGGAAAAGTTTTTACCCAGGCATGGTAGTGCGTGCCTGTATCCCATCTACTCCGGAGGCTGATAGGAGGATTGCTTCAACCAAGGAGTTTGAGGTTCCAGAGACTTAAGATGACACAACTGCATTTTACCCAGTGTGACACAGCGAGACTCTTTCAGAAGAATTTTTAAAAGGAAAAAAAAGAA","GGTCAGATCACCTGAGGTCAGGAGTTTGAGACCAGCCTGACCAACATGGTAAAACCCCATCTCTGCTAAAAATACAAAAAATTAGCCAGGCATGGTGGTGAACGCCTGTAATCCTAGCTACTCAGGAGGCAAAGACAGGAGAATCGCTTGAATCTGGAAGGTGGAGGTTGCAATGAGCCAAGATGACGCCACTGCACTCCAACCTGGGTGACAGAGGAAGACTCCATCAAAAAAAAAAAAAAAAAAAAA"
"GL873601","1397978","1398117","chr16","24839455","24839591","34","23441477","GCCTATAATCCTAGCACTCTGGAAGGCTGAGGCAGGAAGATCACTAGAGCTTGGGAGTTTGAGATTGCTGTGAGGGAGACTGACTCCATGGCACTCTAGCCTGAGGCAACAGAGTAAGACTCCATCTCAAAAAAAAAAAA","CTCTAACTCCAGCTACTCAGGAGGCTGAAGCAGGAAAATCACTTGAACCTGGGAGGTGGAGGTTACAGTGAGCCAAGATCACACCATTGCACTCCAGCCTGAGCGACAGAGCGAGACTCTGTCTCAAAATAAATAAA"
"GL873601","4065502","4065590","chr11","108711352","108711444","19","104645850","GCTGGATGTGGTGGCTCTCACCTATAATCCTAGCACTCTGGGAGGTCAAAACAGGTGGATCACCTGAGCTCAGGAGCAAGAACACCAGC","GTCAGGGGTGGTGGCTCACGCCTGTAATCCCAGCACTTTGGGAGGCCAAGGCAGGTGGATCGCCTGAGCTCAGGAGTTCAAGACCAGCCTTGC"
"GL873601","8241370","8241465","chrY","9469734","9469829","34","1228364","AAAAAAGGTGGAGATGAGCCATGCGCAGTGGTGTAGGCCTGTAATCCCAGCCCTTGGGAGGCCAAAATGGTGGATTGCCTGAAGCAGAGCAAGACC","AAAGTACAAAGAGTCTGGGTACAGTGGCCCAAGCCTGTAATCCCAGCAGTTTGGGAGGACAAGATGGGTAGATCACCTGACATCATGAATTAGAGA"
"GL873569","7519122","7519191","chrX","79016364","79016431","16","71497242","TTGGCCAGGCATGGTCGCTCAGGCTGTAATACCAGCTACTTGGGAAGCTGAAGCAGGAGGATCACTTGAA","TTGGCCAGGCACGGTGGCTCATGCTTATAATCCCAGCTACTCGTGAGGCTGAGGCAGGGGAATCGCTT"
"GL873569","7989158","7989286","chr8","41505677","41505810","35","33516519","AGTCCCACCTATTTGGAAGGCTGAGGCAAGAGGATCACTTGAACTCAGCAGTTTGACATTGCTATGAGTTAGATTGACTCCATGGCACTCTAGCCCAGGCAACAGAGCAAGACTCCGTCTCAAAACAAA","TAATACCAGCTACGTGGGAGGCTGAGGCAGGAGAATCACTTGAACCCGGGAGGTGGAGGTTGCAGTGAGCTGAGATTGCACCGTTGCACTCTAACCTGGGCAACAAAAGCAAAACTCTGTCTCAAAAAAAAAAA"
"GL873569","7989575","7989702","chr1","62231025","62231129","47","54241450","GGCTGGGTAATGCAGTGGCTCACGCCTATAATCCTAGTGCTTTGAGAGGCCAAGAGTGAGACTCTGTGTACTAAAAATAGAAAAATTACCTAGGCATTCTGGTGGGCACCAGTAGTCCCACCTATTTG","GGCTGGGCATGGTGGCTCACGCCTATAATCCCAGCACTTTGGGAGGCCGAGGCAGGTGGATCACCTGAGATCAGGAGTTTGAGACCAGACTGGCCAACATGGTGA"
"GL873569","10034363","10034556","chr10","61268396","61268605","62","51234033","CAGCTTGAGCAAAAGTGAGCCCCTGTCTCTACTGAAAATAGAAAAAATTAGCCAGGCGTGGTGGCACACACTTATAGTCCCAGCCACTTAGGAGGCTGAGGCAGGAGTTTGAGGTTGACATAATCTAAGCTGATACCATAGCACTCTAGCCTGGGCAATAGAGTGAGACTCTGTCTCAAAGAAGAAATTTATCT","CCTGACCAATGGTGAAACCCTGTCTCTACCAAAAATACAAAATTTAGCTGGGCATGGGGGCACGCACCTGTAGTCCTAGCTACTCGGGAGGCTGAGACAGGAGAACTGCTTGAACTCGGGAGGCAGAGGTTGCAGTGAGCTGAGATCATGCCACTGCACTCTAGCCTGGGCAATAGAGTGAGACTCCGTCTCAAAAAAAAAAAAAAAAAA"
"GL873569","10034830","10034845","chr1","217667782","217667796","2","207632952","AAAAAAGAAGAAAAAA","AAGAAAAAGAAAAAA"
"GL873569","10203815","10203922","chr8","96374555","96374671","35","86170740","GCCAGGTGTAGTGGTTCACACCTATAATCCTAGCACTCTGGGAGCCTGAAGCAGGTAAATGGACTGAGCAAGAGTGAGACTTCCACCTCTATTGAAAATAGAAAAATT","GGCTAGGTATGGTGGCTGATGCCTATAATCCCAGAATTTTGGGAGGCCGAGGCAGGCAGATCATCTGAGGTCAGGAGTTTGAGACCAGTCCCGTCTCTACTAAAAATACAAAAATTA"
"GL873569","10204196","10204373","chr20","1304385","1304559","47","8899811","GAAAATAGAAAAATTAGCCAGGCATTATAGCAGGCACCAGTAATCCCAGTTACTTGGGAGGCTAAGGCAAAAGAATCTCTTGAGCCCAAGTTTGGGGTTGCTAGGAAGTAAAACACCACAGCACTATACCCAGAACAAGAGAGTGAAGACTCAGTCTCAAAAAGATAAATAAATAAAA","AAAAATACAAAAATTAGCCAGGCATGGTGGCGGGCGTCTGTAACTCCAGCTACTTGGGAGACTGAGGCAGGAGAATCGCTTGAACCCAGGAGGCAGAGGTTACAGGTGAAATCACACCACTGCACTCCAGCCTGGGCAACAGGGCAAGACTCTGTCTCAAAAAAAAAAAAAAAAA"
"GL873569","10473375","10473444","chr8","20660648","20660717","21","10187273","TGTAGTCCCAGCACTTTGGGAGGTTAAGGCAAGAGTAGCACCCAACATGAGGAGATCAAGACCAATCTGG","CTGTAGTCCCAGCACTTTGGGAGGCTGAGGCAGGTGGATCCTTTGAGGGCAGAACTTTAAGACCAGCCTG"
"GL873570","9287350","9287485","chr1","29437872","29437991","30","20150522","GGCCGGGCGTGGTGGCGCACGCCTGTAGTCCCAGCGCTATGGGAGGCCGAGGCGGGTGGATCACCTGTGCTCAGAGGTTCGAGACCAGCCAAGACCCCCCTGAGCCAAACGAGCCAGAGTGAGACCCCGTCTCTAC","GGCCGGGCGTGGTGGCTCACGCCTGTAATCCCAACATTTTGGGAGGCCAAGGCGGGTGGATCACCTGAGGTCAGAAGTTCGAGACCAACCTGGCCAACATGGTGAAACCCCTGTCTCTAC"
"GL873571","3669989","3670207","chr4","116777080","116777297","60","113107091","AGACCAGCCTGAGGAAGAGCAAGATCCCATCTCTATTAAAAATAGAAAAATTAGCCAGGCATTCTGGTGGGCACCTGTAGTTCTAACCACCTGGGAGGCTAAGGCAAGAGGAACTCTTCAACCCAAGAGTTTGAGGTTGCTGAGAGCTAGGCTAAGGCTGCAGCACTCTAGCCTGGGCAACAGAGTGAGACTGTTTCTCAAAAACAAAAAACAAAAAAA","CGAGACCAGCCTGGTCAATATGGTGAAACCCCGTCCCTACTAAAAATACAAAAATTAGCCAGGCATGGTGGCAGGCACCTGTAGTCCCAGCTACTCGGAAGGCTGAGGCAGGAGAATCGCTTGAACCACAGAGGCAGAGGTTGCAGTGAGCCGAGACTGCACCACTGCACTCCAGCCTGGGCGACAGAGTGAGACTCAGTCTCAAAAAAAAAAAAAAA"
"GL873571","106134","106236","chr4","18143723","18143826","27","18037589","GGCCAGTCTCAGTGGCTCACACCTGTAATCCAGCATTCTGGGAGGCTGAAGCACACGGTCACCTGAGCTCAAAGGTTGGAGACCAGAGTGAGACCCCACCTCT","GGCCAGGCGCAGTGGCTCACTCCTGTAATCCCAGCACTTTGAGGCTGAGGCAGGCGGATCACCTGAGGTCAGGAGTTTGAGACCAGCCTGGCCGAAACCCCATC"
"GL873571","3670496","3670589","chr7","50468399","50468491","15","46797903","GGGCAGGCATGGTGGCTCACACCTGTAATTCTAGCACTCTTGGAGGCTGAGGCAGGAAAATGGCTTGAGGTCAGGAGTTCAAGACCAGCCTGAG","GGCCAGTCATGGTTGCTCACACCTGTAATACCAGCACTTTGGGAGGCCGAGGCAGGCGAATCACCTGAAGTCAGGAGTTCAAGACCAGCCTGG"
"GL873571","4059090","4059389","chr7","52903696","52903994","88","48844606","GGCCAGGTGCAGTGGTTCACACTTATAATCCTAGCACTCTGGGAGGCCGAGGCGAGTGAAGTGCCTGAGCTCATGGGTTCAAGACCAACCTAAGCCAGAGACCCCTGACTCTTATAATAGCCTGGCATTGTGGTGGGCGCCAATATTTCCAGCTACTCTGAGGCTAAGGCAAGAGAATTGCTTGAGCCCAGGAGTTGGAGGTTTCTGTGAGCACTGACGCCGCAGCTCTCTACCAAGGGCAACAAAGACTCTGTCTCAAAAAATAAATAAATAAATAAATAACAGAATGAAAATGAAAAA","GGCCGGGTGCGGTGGTTCACGCCTGTAATCCCACCACTTTGGGAGGCTGAGGCAGGCAGGTCACCTGAGGTCAGGAGTTCCAGACCAGCCTGGCCAACATGGTGAAACCTTGTCTCGGCTATTAGCCTGGCATGGTGGTGCGTGCCCATAATCCCAGCTACTCAGGAGGCTGAGGCAGGAGAATCGCTTGAACCCAGAAGGTGGAGGTTGCAGTGAGCCAAGATAGCACCACTGCAACTCCAGTCTGGGCAACAGAATGAGACTCTGTCTCAAAAAAAAAAAACAAAAAACAAAAAGAA"
"GL873571","4209418","4209704","chr11","32517699","32517985","80","28308281","GGCTTGGCAAGGTGGCTTACACCTCAAATCCTAGCACTGTGGGAGACTGAGGCAGGTGGATTGTTTGAGCTCAGGAGGTCAAGATAGAGAGCAAGAGCAAGTCTCTGTCTCTACTAAAAATAGAAAAGAACTACTTCCCGGGGGTCATGGCAGTAGCCTGTAATCCCAGTTACTAGGTAGAATGAGGCAAGAGGATCTGTTGAAGCCAAGAGACTGAGGTTGTTATGAGCATGCCACAGCACTCTACCCAGGGTGACAGAATGAGACTCTGTTGAAAGAAAAAAAGA","GGCCGGGTGCAGTGGCTCACACCTGTAATCCCAGCACTTTGGGAGGCTGAGGCGGGTGGATCACCTGAGGTCAGGAGTTCAAGACCAGCCTGACAAACATAGTGAAACCCTGTCTCTACTGAAAATACAAAATTAGCCAGGTGTGGTGGCGCATGCCTGTAATCCCAGCTACTCGGGAGGCTGAGGCAGGAGAATTGCTTGAATCCAGGAGGTGGAGGTTGTGTGATCACACCACTGCACTCCAGCCTGGGCGACAGAGTGAGACTCTGTCTCAAAAAAAAAAGAAA"
"GL873571","4209985","4210154","chr3","175781758","175781928","60","171571773","GAAAGAAATGAAAAGAAAGAAGTTAGCTGGTTGTTGGGGTATGCTTCTATAGTCCCACCTACTCAGAAAGCTGAAATCTGGAGTTTGGGGTTGTTGTAAGGTAGGCTGATGACATAGCACTGTAGCTTGGGCAAGAGAGTGTGACTTTGTCTCAAAAAAAATTAAAACAA","ATTAAAAACACAAAGATTAGCCAGGTGTGATGGCACACAACTGTAATCCCAACTACTCAGGAGAATCGCTTGAACCTGGGAGATAGGGTTTGCAGTGAGCCAAGATTGTGCCACTGCACTCCAGCCTGGGTGACAGAGTGAGACTCTGTCTCCAAAAAAAAAAAAAAAAAA"
"GL873571","4210444","4210570","chr17","16655655","16655789","35","12445211","GCCAGGCAGATGGCTCACACTTCATCCTAGCCCTCTGGAAGGCTGAGGCAGGCTAATTTTTTGAGGTTAGGAGTTTGAGACCAGCCTGAGGAAGAGACCCATCTCTACTTTAAAAAATAAATGGAAA","GCCAGGCATGGTGGCTCACACCTGTAATCCTAGCACTTTGGGAGACTGAGGCGGGTGAATCACCTGAGGTCAGGAGTTTGAGACCAGCCTGACCAGTATGGTGAAACCCAGTCTCTACTAAAAATACAGAAATTA"
"GL873571","4391733","4391878","chr11","33723808","33723943","46","29332075","AACTTAGCTGGGAATGGTGGCTCAAGCCTGTAATCCTAGCACTCTGGGAGGCTCAGGTGGGAGGATCACTTGAGGTTGCTGTGAGCTTGGCTGATGCCAGGACACTCTAGTGTGGGCAAGAGAGTGAGACTCCGCCTCAACAACAA","GCCGGGTGCAGTGGCTCATACCTGTAATCCCAGCACTTTGGGAGGCTGAGGTAGGCGGATCACGAGGTCAGGAGCTGAGATGGCGCCACTGCACCCCAGCCTGGGTGACAGAGCAAGACTCTGTCTCAAAAAAAAA"
"GL873571","6307773","6307841","chr9","62429628","62429694","22","56121855","CTGGGTGTGGTGGCATTGCACCTGTAATCCTAGCTACTTGGAAATCTTAAGCCCAGGAGTTGAAGACTG","CCCAGCATGGTGGTGCATACCTATAATCTCAGCTACTTGGAGGCTTGAGCTCAGAAGTTTGAGACCG"
"GL873571","6496217","6496306","chr1","27257765","27257856","27","20761548","GCAGGGTGTGTTGACCCACACCCACAATTCCAGGACTCTGGGGGGCCAGGGATGGTGGGTTCCCTCAGATCAGGAGCTCCTTACCAGCCT","GACTGGGCATGATGGCTCAAATCTGTAATTCCAGCACTTTGGGAGGCCGAGGTGGGTGGATTGCCTGAGATCAGGAGTTCAAGACCAGCCTG"
"GL873571","6499738","6499903","chr1","38976375","38976555","47","32476637","AAAATAACATGAATTGACTAGGCGAGGTGGCTCACATCTCTAATCCTAGCACTCTGGGAGGCTGAGGCAGGAGAATTGCATGAGGTTGCTGTGAGCTATGATGATACCACGGCATTCTAATCAGGGTGACAGAGTGAGATTCTGTCTTAAAACAAACAAACAAAAA","AAAATAAATAAATTAGCAGGGCCTGGTGGCGCACACCTGTAATCCCAGCTACTTGGGAAGCTGAGGCAGGAGAACCCACTTGAACCTGGGAGCCGGAGGTTGCAGTGAGCTGAGATGGCACCACTGCACTCCAGACTGCGTGACAGAGTGAGACTCCGTCTCAAAAACAAACAAACAAAAA"
"GL873571","11399575","11399872","chr15","109458692","109458994","79","98059117","CAGTGGCTCACACCTGTAAATCTAACACTCTGGGAGGCCAAGGTGGGTGGATCCCTTGAGCTCAGGAATTTGATACCAGCCTGAGCAAGAGTGAGACCTTGTCTCTACTAATAATAGAAAAATAGCCCGTGTTGTGGCACTTGTCCCAACCACTGGGGAGGCTTTAGGCGGGAGGATTACTTGAATTGGGAGTTTGATATTGCTGTGAGCTGGGCTGATGCCTTGGCATTCTAGCTTGGGTAACAGCGTAAGACTCCGTCTCAAATAAATAAATAAATAAATAAAAAGAAAAAAAGAA","GTGGCTCACACCTGTAATCTCAGCACTTTGGGAGACCGAGGCAGGTGGATCACCTGAGGTCGGGAGTTTGAGACCAGCCTGACCAACGTGGAGAAACCCCGTCTCTACTAACAATACAAAATCAGCTGGGCGTGGTGGTGCATGCTTGTAATCCCAGCTACTCGGGAGGCTGAGGTAGGAGAATCGCTTGAACCTGGGAGGTGGAGGTTGCGGTGAGCCGAGATCGAGCCACTGCACTCCAGCCTGGGTGACAGAGCAAGACTCCATCTCAAAAAAAAAAAAAAAAAAAAAAAAAAAAAAAAA"
"GL873572","114760","114841","chr8","26280134","26280211","16","26165374","GGCCAGGCATGGCGGCTCTTCCCTGTAATCCTAGCACTCTGGGAGGGCGAGGCAGGCAGATCACCTAGGCTAGGGTGAGATC","GGCCAGGAATGGTGGCTCATGCCTGTAATCCCAGCACTTTGGGAGGCTGAGGCAGGCAGATCACCTGAGGTCAGGAGT"
"GL873572","9421791","9421892","chr11","8089184","8089269","35","1332607","TACTAAATATATAGCAAGGCCAGGCACAGTGGTTCATGGCTGTAATCCCAGTACTCTGGGAGGCCTAGTCAGAGTTGACCTGAGATCAGGCTAGAAGCCTGG","ATAAAAATAATTGGAGGCCAGGCACGGTGGCTCATGCTTGTAATTCTAGCAATTTGGGAGGCTGACGCGGGTGAGATCATACTGAG"
"GL873572","11052834","11053035","chr14","11857478","11857657","65","804644","TCCACAAAGAAAGCAGAAGTGTGGCCGGGTGGTAGCTCAAGGCAGGAATCCCAGCACTCTGGGAGCTGGGAGGTGGGGGAGGATCCCTTGAGATCAGGAGTTGGAGGGCACAGTGAGCCTGGGGGAGGCCACTGTCTCTGTACTCTAGCAGGGAGACAGAGCAAGACTGCCCATTCAAAGAAAAACAACAAACAAAACAAAA","TACAAAAATTAGCTGGGCACGGTGCCACAAGCCTGTAATCCCAGCTACTCGGGAGGCTGGGCAGGGGAATAGCTTGAACCCAGAGGTGGAGGTTGCAGTGAGCCAAGATCAAGCCACAGCACTCCAGCCTGGGTGACAGAGCAAGACTCCATCTCAAAAAAAAAAAAAAAAAAAAAAAAA"
"GL873573","2564195","2564244","chr1","109985445","109985491","12","107421250","TACAAAAATTAGGCTGGGCTTGGTGGTTCACGCCTATAATCCTAGCACTT","ACTAAAATTAGCTGGGCATGGTGGTGCATGCCTGTAATTCCAGCTAC"
"GL873573","7423371","7423533","chr2","202783328","202783513","56","195359957","GGTGGCTCACACCTGTAATCCCAGCACTCTGGGAGCCCTGGTGGCTCATGTCTATAATCCTAGTACTCTGGGAGACCATGGTGGCTCATGTCTATAATCCTAGTACTCTGGGAGCCATGGTGGCTCACGCCTATAATCCTAGTACTCTGGGAGACCATGGTGG","GGCTGAGGCGCGGGGGCTCACGCCTGTAATCCCAGCACTGTGGGAGGCCGAGGCGGGTGGATCACGCCTGTAATCCCAGCACTGTGGGAGGCCAAGGCGGGTGGATCACGCCTGTAATCCCAGCACTGTGGGAGGCCGAGGCGGGTGGATCACGCCTGTAATCCCAGCACTGTGGGAGGCTGAGGC"
"GL873573","9657648","9657710","chr19","10207852","10207913","10","550204","TAAAAATAAAAAATTTAGCTGGATGTGGTGGCTCACACCTGTAATCCTAGCACTCTGGGAGAC","TAAAAATACAAAATTAGCTGGGTGTGGTGGCACACACCTGTAATCCCAGCTACTCAAGAGGC"
"GL873574","1624662","1624783","chr9","814961","815079","36","809701","GACTGGGTGGGTTGGATCATGCCTGGAATCCTAGCACCCTGGGAGGCCAAGGTGAAAGGATTGCTTGAGGTTAGGAGTTCCAGAAATGTAGCAGTCATGGTGACTTCATCCTTCTCTACCAA","GGCTGGGTGCTTTGATTCATGCCTGTAATCCCAGCACTCTGGGAGGCCGAGGCAGGTGGATCACCTGAGGTTAGGAGTTCGAGACCAGCTTGGCTAACATGGTGAAACCTCGTCTCTAC"
"GL873574","4459477","4459612","chr1","29437872","29437991","29","24978395","GGCCGGGCGTGGTGGCGCACGCCTGTAGTCCCAGCGCTATGGGAGGCCGAGGCGGGTGGATCACCTGAGCTCAGAGGTTCGAGACCAGCCAAGACCCCCCTGAGCCAAACGAGCCAGAGTGAGACCCCGTCTCTAC","GGCCGGGCGTGGTGGCTCACGCCTGTAATCCCAACATTTTGGGAGGCCAAGGCGGGTGGATCACCTGAGGTCAGAAGTTCGAGACCAACCTGGCCAACATGGTGAAACCCCTGTCTCTAC"
"GL873574","4681987","4682216","chr6","153082888","153083127","73","148400901","GGGTGCGGTGGCTCAGACCTATAATCCCAGCACTCTGAGAGGCCGAAGTGGGTGGATCACCTGAGCTCAGGAATTTGAGACCAGCCGTCTCTAAAAATAGCTGAGTGTTGTGGCAGTGGCTGTAAGTCCCAGCTGTTTGGAAAGCTGAAGCAAGGGAATCACTTGAACCCAAGAGTTTGAGGTTGCTGTGATGACAAAGTGAGACTCTATCTCAAAAAAAAAAAAAAAAA","GGCCGTGCGCGGCGGCTCACGCCTGTAATCCCAGCACTTTGGGAGGCTGAGGTGGGTGGATCACCTGAGGTCAGGAGTTTGAGACCAGCCCGACCAGAAATTAGATGGGTGTGGTGGTGCGCTCCTGCAGCCCCAGCTACTTAAGAGGCTGAGGCAGGGTAATCACTTGAACCCGGGAGGCGGAGGTTGCAGTGAGCCGAGCTCACGCCACTGCACTCCAGCCTGGGTAACAGAGCGAGA"
"GL873574","4709916","4710039","chr19","13152422","13152536","46","8442506","AAAAATAGAAAAACTAGCCAAGCATGGTGGTGCACCCCCTATAGTCTGAGCTCCTCAGCGGGCTGAAGCAAAAGGACGGCTGGAGCCCTGGAGTTTGAGGTTGCTGTGAGGCAAGGTGATGCCA","ACACATAAATTAGCCAGACATGATGGTGAGTATCTGTAATTCCAGCTCCTTGGGGGGCTGAGGCGGGAGAATTGCTTGAACCTGGGAGGCAGAGATTGCAGTGAGCCAAGATCGC"
"GL873574","6353839","6353913","chr5","25768079","25768163","22","19414240","AAAAATATAGCAAGGCCAGGCATGGTGGCTCACACCTATAATCCCAGTACTTGGGAGCTGGAATTTGAACCTAGG","AAAAAACTCAAACAAGGCTGGGCGTGGTGGCTCACACCTGTAATCCCAGCACTTTGGGAGGCTGAGGTGGGTGGATCACCTGAGG"
"GL873574","6533061","6533332","chr5","85182161","85182439","81","78649100","GGCTGGGCGAGGTGGCTTACACCTATAATCCTAGTACTCTGGGAGGCCAAGGTGGGTGGATTGCCTGAGCGCACAGTTTCAAGACCAGCTGGAGCCAGAGAGAGAGAGAGAGACCCTGCCTCTAAAAATAGCCAGGCATTGTGGCAGGCACCTGTAGTCCCAGCTACTTGGCAGGCGGAGGTATGAGAATCGCTAGAGGTTGCTGTTAGCTATGATGCCATAGCACTCTACCAAGGGCGACAAAGTGAAACTCTGCCTCAAAAAAAAGAAGA","GCCAGGCGTGGTGACTCAAGCCTGTAATCCTAGCACTTTGGGAGGCCAAGGTGGGCGGATTGCCTGAGCTCAAGAGTTTGAGACCAGCCTGGGCAACACGGTGAAACCCAATCCCTACTAAATACAAAAAAAATTAGCCGGGTGTGGTGGTGTGAACCTGTAGTCCCAGCTACTCGGGAGGCTGAGGCAGGAGAAGGCAGAAGTTGCAGTGAGCCGAGATCACACCACTGCACTCCAGCCTGAGTGACAGAGCAAAACTCTTTCTCAAAAAAAAAAAAA"
"GL873574","6643746","6643907","chr2","92627944","92628105","46","85984198","AAATAGCCAGGCGTTGTGGCAGGCACCTATAGTCCCAGCTACTTGGGAGGCTGAGGCAAGAGAATCACTTAAGCCCAAGTGACAGAGGTTGCCAGGGCACTCTACGTAGGCAACAGAGTGAGACTCTATCTAAGAAAGAAGGAAGGAAGGAAGGAGAAAGAA","TTAGCCGAGCATTGTGGTGCGCGCCTGTAGTCCCAGCTACATGGGAGGCTGAGGCAGGAGAACACCTGAACCCAGGATGTGAGCTGAGTCGCGCCATTGCACTCCAGCCTGGGCAACAGAGTGAGACTCCATCTCAAAAATAAAATAAAATAAAATAAAAAA"
"GL873574","6644163","6644274","chr1","128607504","128607619","20","121963341","CTGTAATCCTAGCACTTGGGAGGCTGAGGCAGGTGGATCACCTGAGTTCAGGAGTTCAAGACCAGCCTAAACAAGAGTGAGACCCTATCTCTACTAAAAATAGAAAAAATAT","GCCTGTAATCCAAGCACTTTGGGAGGCTGAGGCGGGTGGATCACCTGAGGTCAGGTGTTCGAGACCAGCCTGGCCAACGTGGTGAAACCCCAACTCTACTAAAAATACAAAAATTA"
"GL873574","8511822","8512127","chr1","23439759","23440073","84","14927937","GGTGGCTGGTGCCTGTAATCCTAGCACTCTGGGAGACTGAGGCAGGTGGATCACTTGAAATCAGGAGTTTGAGATCAACCTGAGCAAGAGATCTTGTCTCTCCTAAAGATAGAAAAACTAGCTGGGATTTGTGGTGGACACCTGTAATTTCAGCTACTCAGGAAGCTAAGGCAAGAGCATTGCTTAAAACCAGGAGTTTGAAGTTGATGTGAGCTAGGATGTCAGGGCAGGTTACCCAGGGTGACAGAGTGAGACTCTGTGTCAAAATAAACAAACAAACAAACAAACAAAACAAAATAAAATAAA","GGCTGGACATGGTGACTCACGCTTGTAATCCCAACACTTTGGGAGGCTGAAGCAGGCAGATCACCTGAGGTCAGGAGTTTGAGACCAGCCTGACCAACATGGTGAAACCTTGTCTCTACTAAAAATACAAAAATTAGCTGGGAGCAGTGGTGCACACCTGTAATCCCAGCTACTCGGCAAGCTGAGGCAAGATAATTTTTTAAACCTGGGAGGTGGAGGTTGCAGTGAGCCAAGATCGTGCCACTGTACTCCAACCTGGGAGACAGAGCAAGACTCTGTCTCAAAAAAAAAAAAAAAAAAAAAAAAAAAAAAAAA"
"GL873575","2107336","2107519","chr4","38052972","38053149","54","35945636","TCAATTAAAAACTTTTTAAAATGAGGCTGAGCATGGTGGTTCACACCTGTAATCCCAGCACTTTGGGAGGCCGAGGCAGGAGGATCACCTGATCCCAGGAGTCCAAGCCTACAGTGAGCCGTGATAATACCACTGCACTTCAGCCCAAAGCCTCAAAAAGAAAAAAAAAAAAGGATAGACAAGA","TATATATATATATATTATTTTGGGGGGGCATGGTGGTGCACACCTGTAATCCCAGCTACTCGGGAGGCTGAGGCAGGAGAATTGCTTGAGCCCGGGAGGCAAAGGTTGCATTGAGCTGAGATCACACCACTGCACTCCAGCCTGGCGACAGAGTCTCAAAAAAAAGAAAAAATAAAAA"
"GL873575","5831824","5831959","chr1","29437872","29437991","28","23606048","GGCCGGGCGTGGTGGCGCACGCCTGTAGTCCCAGCGCTATGGGAGGCCAAGGCGGGTGGATCACCTGAGCTCAGAGGTTCGAGACCAGCCAAGACCCCCCTGAGCCAAACGAGCCAGAGTGAGACCCCGTCTCTAC","GGCCGGGCGTGGTGGCTCACGCCTGTAATCCCAACATTTTGGGAGGCCAAGGCGGGTGGATCACCTGAGGTCAGAAGTTCGAGACCAACCTGGCCAACATGGTGAAACCCCTGTCTCTAC"
"GL873575","7451097","7451208","chr3","122814630","122814743","22","115363533","GGCCAGGTGTGGTGGCTCACACCTGTTATCCTAGCACTCTGAGAGGCCACAGCAGCTGGATCACTTGAGCTCAGGAGTTCAAGACCAGTCTGAGCAAGAGCAAGACCTCACC","GGCTGGGTGTGGTGGCTCATGCCTGTAATCCCAGCACTTTGAAAGGCCAAGGCAGATGGATCACTTGAGGTCAGGAGTTCCAGACCAGCCTGGCCAACATGGCAAAACCCCATC"
"GL873575","7451277","7451445","chr6","58863249","58863409","41","51411972","AAAAATTCAGCCAGCCACAGTGGAAGTGGATGCCTGCCATCACAGCTACTCTGGGGGCTGGGGCAAGAGAATTGCTTGATCCCAGGAGTCTGAGGTTGCTGTGACCTAGGCTGACACCACAGCACTCTACCCAGGGTGACAGAGTGAGGCTGTGTTTAAAAAAAAAAAA","TTAGCCAGGCATGGTGGCACATGCCAGTAATCCCAGCTACTCAGGAGGATGAGGCAGGAGAATCGCTTGAACCCAGGAGGCAGAGGTTGCAGTGAGCTGAGATTGCGCCACAGCACTCTACCCTGGGTGACAGAAGGAGACTCTGTCTCAAAAAAAAAAAA"
"GL873576","1765109","1765185","chrX","53921180","53921256","12","52156071","GGCCAGGTGCAGTGGCTCATATCTGTAATCCTAGCACCCTGGGAGGCCAAGGTAGGCGAATCACCTGAGGCCAGGAG","GGCCAGGTGCAGTGGCTCACGCCTGTAATCCCAGCACTTTGGGAGGCCGAGGTGGGCGGATCACTTTAGGTCAGGAG"
"GL873576","2711577","2711895","chr7","6620384","6620702","85","3908807","GGTCGAGCTTGGTGGCTCATGCTTGTAATCCTAGCACTCTGGGAGGCCAAGGCAGGTAAGTTGCCCTGAGCTCATAGGTTCCAGATCAGCATGAGCCAGAGTGAGACCCTGTCTCTACCAAAAAATAGCCCGGCATTCTGGCAGGTGCCTGTAATCCCAGCTGCTTGGGAGGCTGAGGCTAGAGAATCACTTAAACCCAAGGGTTAGTGGAGGTTGCTGTGAGCTATGATTCCACCGTACTCTACTGAGGGCCACAAAGTGAGACTCTGTCTCCATAAAAAAGAAAGAAAGAAAGAAAGAAAAATAAAATAAAATAAAA","GGCCAGGCACAGTGGCTCATGTCTGTAATCCCAGCACTTTGGGAGGCCGAGGCGGGTGGATTACCTGAGGTCAGGAGTTCTAGACCAGCCTGGCCAACAAGGCGAAACCCTGTCTCTACTAAAAATACAAAAAATTAGCTGGGCGTTTTGGCACATGCCTGTAATCCCAGCTACTTGGGAGGCTGAGGCAGGAGAATTGCTTGAACTGGGGAAGTGGAGGTTGCAGTGAGCTGAGATCACACCATTGCACGCCTGAGCAACAGAGCGAGACTCTGTCTCAAAAAAAAAAAAAAAAAAAAAAAAGAAAAGAAAAAGAAAA"
"GL873576","4782520","4782652","chr9","61136941","61137074","22","56354421","CCAGGCACGGTGGCTCACCCTTGTAACCCTAGTACTTTGGGAGGCTGAGGTGGGAGGATCCCTTGAGGTCAGGAGTTCAAGACCAGCCTGAACAACAGTGAGACCCCCGTCTCTACTAAAAAATAGAAAAGTT","GCCAGGCACGGTGGCTCACGCCTGTAATCCCAGCACTTTGGGAGGCTGAAGCGGGCGGATCACCTGAGGTCAGGAGTTCAAGACCAGCCTGGGCACCATGATGAAACCCCGTCTCTATTAAAAATACAAAAATT"
"GL873576","4782930","4783078","chr7","57521645","57521803","40","52738715","AGTTAGTCTGGTGTCATGGTGGGTGCCTGTAGTCCCAGCTGCTTGGGAGGCTGAGGCAAGAGAATCACTTGAGCCCAGGAGTTGGAGGTTGCTATGAGCGAGGCTGTAGCCTAGGCAACAGAATGAGACTTTGCCTCAAAAAAATAAAA","TTAGCTGGGCATGGTGGCGCATGCCTGTAGTCCCAGCTACTTGGGAAGCTGAGGCAGGAGAATCACTTGAACCTGGGAGGTGGAGGTTGCAGTGAGCTGAGATCGCACCGCTACACGCCAGCCTGAGCAACAGAGAGAGACTCTGTCTCAAAAGAAAAA"
"GL873576","7828709","7828723","chr5","101042981","101042996","1","93214272","TAAATAAATAAAAAA","TAAATAAATAAATAAA"
"GL873576","7828960","7829230","chr13","49045537","49045844","89","41216577","GCCGGCTGCAGTGGCTATAATCCAAGTACCCTGGGAGGCTTAGGTGGATGGATCACTTGAGCTCAGAAGTTCAAGACCAGCCTCAGCAAGAGGTAGACCTTGCCTCTATTAAANNNNNNNNNNNNNNNNNNNNNNNNNNNNNNNNNNNNNNNNNNNNNNNNNNNNNNNNNNNNNNNNNNNNNNNNNNNNAGTTTGAGGTTGCTGTGAGCTATGATGAAGCCAGGGCATTCTACCCAGGGTGACAGAGTAACTCTTAAAAAAAACTAAACAA","GGCCAGGCAGAGTGGCTCATGCCTGTAATTCCAGCAATTTGGGAGGCCTAGGCAGGCAGATTACCTGAGGTCAGGAGTTTGAGACCAGCCTGGCCAACATGGTGAAACCCCGTCTCTTCTANNNNNNNNNNNNNNNNNNNNNNNNNNNNNNNNNNNNNNNNNNNNNNNNNNNNNNNNNNNNNNNNNNNNNNNNNNNNNNGGAGATAATAGCTTTTGTAGAACGAAGCGATGCAACAGCCAGATCGCCGCCACCACCCTTAGGTCCTGGCGACAGAGTGAGATCCATCTTAAAAAAAAAAAAAAAAAAA"
"GL873576","10622840","10623093","chr7","60266447","60266705","74","49643607","GCTGGGTATGGTGGTTCACACCTATAATCCTAGCACTCTGGGAGGCTGAGGTGGGAGGATTGGTGGAGCTCAGGAGCTCATGAGGTGCCAAATCACTGGTGCCACACACCTGTATTCCCAGCTACTGAGGAGGCTGAGGCAGGAGGATCAGGTAAGCCCAGGAAGTTTGAGGTTGTAGTGAGTTAGGATGATTGAACTCTGCCTTGAGAGACAGAGCAAGATCCTCCTTCCTCCTAAGCAAACAAACAAATAAA","GGCTGGGTGCAGTGGCTCACACCTGTAATCCTAGCACTTTGGGAGGCTGAGGCGGGAAAATTGCCTGAGCTCAGGAGTTCAAGGACAGCCTAGGCAACATAGCATGGTGGTGCACGCCTGTATTCCCTGCTACTTGGGAGGCTGAGGCACAAGAATTGCTTGAATCCGGGAAGTGGAGGTTGCAGTGAGCCATTGTGGCACTGCTCTCCAGTCTGGGTGACAGAGCAAGACTCCATCTCAAAAAAAAAAAAAAAAAAAA"
"GL873576","10819939","10820007","chrX","67133632","67133707","21","56313693","AGGTTGCAGTGAAATTGTACCATTCCAATGAAGCCTGGGGGACAGAGTGAGATTCTCTCAAAATAAAAA","GGAGGTTGCAGTGAACCGAGATCGTGCCACTGCACTCCAGCCTGAGCGACAGAGTGAAACTTCGTCTCAAAAAAAA"
"GL873576","10920306","10920363","chr3","48261745","48261808","16","37341439","GCTGGACCTTGTAGAGAGTGCCTGTAATCCCAGCTACATGGGGGGCAAGAGAATTGCT","GCTGGGCATGGTGGTGCATGCCTGTGATCCCAGCTACTCAGGAGGCTGAGGCAGGAGAATTGCT"
"GL873576","10920398","10920529","chr10","67341428","67341546","30","56421030","GGCCAGGCGTGGTGGCTCACGCCTGTTGTCCCAGCACTGTGGGAGGCCGAGGTGGGTGGATTGCCTGAGCTCAGAGGAGTCCGGAAGACCAGCATGAGGCAGAGTGAGCCAGAGTAAGATCCTGTCTCTACC","GGCTGGGTGTAGTGGCTCATGCCTGTAATCCCAGCACTTTAGGAGGCCAAGGTGGATGGATTGCCTGAGCTCAGGAGTTCGAGACCACCCTGGGCAACAAGCCAAAACCCTGTCTCTAC"
"GL873577","515809","515961","chr7","137660778","137660931","43","137144969","AGCTGGGCATGGTGGCTCATGCCTATAACCCTAGCGTGCTAGGAGATTGCTTGTCAGGAGACTGAGGTTGCAGGAAACTGTGATGATGGCACTGCACTCTACCCAGGGTGACAGAGCAGGACTCTGCCTCAAAAAAAAAAAAAAAAATAGAAA","TTAGCTGGGCATGGTGGCGCATGCCTATAATCCCAGCTACTTGGGAGGCTGAGGCAAGAGAATCGCTTGAACCGGGGAGGCAGAGGTTGCAGACTGCACTCCAGCCTGTGTGACAGAGTGGGACTCCGTCTCAAAAAAAAAAAAAAAAAAAAAA"
"GL873577","1633164","1633256","chrX","38269524","38269615","26","36636360","TCAGCCAGGCATGGTGGCACTTGCCTATAAACCCAGCTCCTTGGGAAGCTGAGCCGGGAGGATCCCTTGCACCCAGGAGCAACGGAAGGCAGT","AATTAGCCAGGCATGGTGGCACATGCCTATAATCCCAGCTACTCAGAAGGTTGAGGCAGGAGAATCACTTGAACCTGGGAGGCAGAGGTTGC"
"GL873577","3979502","3979560","chr20","68909283","68909346","13","64929781","GAGTTTGAGACCAGCCTGAGCAAGACCGAGACCCAGTCTCTACTAAAAATAGAAAAATT","GGAGTTCAAGACCAGCCTGACCAACATGGAGAAACCCTGTCTCTACTAAAAAATACAAAAATTA"
"GL873577","3979839","3980009","chr10","31403126","31403287","39","27423287","ATGAGCAGATTGTCTTGGTGGGCACCTGTAGTCCCAGCTATTGGAGGTGGGAGGCTGAAGCAGGAAAATCTCTTGAGCCCAGGAGTTTGAGGTTGCTGTGAGCTAGGCTGACACCACGGCACTCTAGTCAGGGCGTCAGAGTGAGACTCCGTCTCAAAAAAAAAAAAAAAA","TTAGCTGAGTGTGGTGGCGCACATCTGTACTCCCAGCTATTTGGGAGGCTGAGGCAGGAAAATCGCTTGAACCCAGGAGGTGGAGGTTGCAGTGAGCCAAGATCACACTACTGCACTCCAGCCTGGGTGACAGAGTGAGAATCCATCTCAAAAAAAAGAAAA"
"GL873577","6050882","6051080","chr1","153219820","153220007","59","147168938","GGCTGGGCGTTGTGACTCATGCCTGTAATCCCAGCACTCTAGGAGGCCGAGGTGGGTGGACTGCCTGAACTCAGAGGTTTAAGACCATCCTGAGCCGCAGTGAGCCAGAGCGAGACCCTGTCTCTACCAAAAAAAGCTGGGTGTTGTGGTGGGCGCCTATAGTCCTAGCTACTTGAGGCGCTAAGGGTAAAAAAATTGC","GGCCTGGCACAATGGCTCACGCCTGTAATCCTAGCACTTTGGGAGGCCGGGGTGGGTGGATCACCTGAGATCAGGAGTTTGAGACCAGCCTGGCCAACATGGTGAAACTCCTTCTCTACAAAAATTAGCCAGGTGTGGTGGTGGGTACCTGCAATCCCAGCTATTTGGGAGGCTGAGGCAGGAGAATC"
"GL873577","8463965","8464050","chr9","52134422","52134508","19","43670457","CTGGGTGCTATAGCTCACGCCTATAATCCTAGCACTCTGGGAGTTTGGGGCAAATGGATCACCTAGGCTCAGGAGTTTGATACCAG","GGCTGGGAGCAGTGACTCACGCCTATAATCCCAGCACTTTGGGAGGCTGAGGCAGATGGATCACCTGAAGTCAGGAGTTCGAGACCA"
"GL873577","9471486","9471613","chr16","5178790","5178910","46","4292696","TTAGCCAGGCATAGTAGCCTGTGTGTAGTCCTAGCTACTCAGGAGGCTGAGGTAGATGGGTCACTTGAGGTTGCAGAGATTATGGTAATGTCACTGTACTCTAGCCCTGGCAACAGAGCACAACCCTG","TTAGCCGAGCCTGGTGGCATAAACCTGTAATCCCAGCTACTCAGGAGGCTGAGGCAGGGGAATTGCTTGAACCTGAGAGGAGAAGGTTGCAGTGAGCCGAGATTGCACCATTGCACCCCAG"
"GL873577","9471875","9471998","chr7","17832200","17832315","36","8360325","GGCCAGGTGAAGCAGCTCATGGCTATAATCCTAGCAGTTTGGCAGGCCAAGGTGGGAGGACTGCTTGAGGTCAAGAGTTCAAGACCAACCCATCTTTGCGAAAAATTTAAAAATTACCTAGGCA","GCCAGGAGAGGTGGCTCATGCCTCTAATCCCAGCACTCTGGAAATCCAAGGTGGGTGGATCACCTGAGGTCAGGAATTCCAGACCAGTCTGGCCAATATAAAAAATTAGCCAGGCT"
"GL873577","9853150","9853170","chr3","85044647","85044667","3","75191497","AAACAAACAAACAAAAAAAGA","CAAACAAACAAACAAACAAAA"
"GL873577","9853206","9853473","chr7","130818682","130818963","67","120965476","GCTGGGCGCAGCGTCTCACTCCTGTAATCCCAGCACTTGGGAGGCCAAGGTGAGTGGATTGCCTGAGTTTACAGTTTCGAGACCAGCCTGAGCCAAAGCGAGACCCCCATCTCTAAAAAATAGCTGGGCATTGTGGTGGGCACCTGTAGTCCCAGCTACTTGGGAGGCTGAGGCAAGAGGATCGCTTGAACCTAAGAGTTTGAGGTTGCTGTGAGCTAAGGCTCCATGGCATTCTACCAAGGGTGACTAAGTGAGACTCTGTCTAAAA","GCCGGGCACAGTGGCTCACACCTGTAATCCCAGTACTTTGGGAGGCCAAGGTGGGTGGATCACCTGAGGTCAGGAGTTTGAGACCAGCCTGGCCAACATAGTGAAACTCTACTAAAAATACAAAAAAATAGCTAGGCATGGTGGTGCGCACCTGTAATCCCAGCTACTTGGGAGGCTGAGGCAGGAGAGTTGCTTGAACCCAGCGGGGTTGAGGTTGCAGTGAGTTAAGATCAAGCCACTGTGCTCCAGCCTGGATGACAGAGAGAGACTCCATCTCAAAAA"
"GL873577","10722415","10722478","chr10","12501471","12501539","23","1779056","AATAAAAAAATGCTGGGTACAGTAGTACATGCCTGTACTCTCATCTGGGGAAGCTGAGGCATGA","AAAGTAAAAAATTAGAGCTGGGCATGGTGGCACACACCTGTAATCCCAGTCACTAGGGATGCTGAGGCA"
"GL873578","463331","463568","chr10","28935382","28935620","93","28472051","CAGGTGCTTTGACCCACACCCTCAACTCTAGGACTTTGGACGCCCTGGCTGGGTGGGTCCTTTAAAGTCAGGAGCTTCTTATCAGTCTGGGCAAAAGTGAGACCCCATCTCTACCAAACAAAGAAAGAAATCAGCAGTATGTTGCAGTAGAGACTCACCAATACCTTCTTTCAAAGACCAAAGCTGGAAGGACACTAAAGACCATGATCTCATGGCCTCCCTGAGCCATGACAATGCC","CCAGGTGCAGTGGCTCATGCCTGCAAGCTCAGAACTTTGGGAGGCAGAGGTGAGCAGACTGCCTGAGTTCAGGAGTTCAAGACCAGCTGGGCAACATGGTGAGACCCTATCTCTACTAAAAATACAAATAATTAGCAGGGTGTGGTAGCACACACCTGTAGTCCAGCTACTCAGGAGGCTGAGGCAGGAGAATTGCTTGAACCCAGGAGGCAGAGTTTGCAGTGAGCCAGGACTGGGCC"
"GL873578","1143712","1143827","chr11","52824583","52824692","30","51680871","GGCTGGGTGTGGTGCCTCATGCCTGTAATCTAAGCCCTCTCCGAGGCTGAGGTGGGAGGATCCCTTGAGTTTAGGAGTTTGATTTTGAGACCAGCCTGATCAAGAGAGAGACCTCA","GGCCGGGTGTGGTGGCTCATGTCTGTAATCCCAGCACTTTGGGAGGCTGAGGTGGGTGGATACCCTGAGGTCGGGAGCTCGAGACCAGCCTGACCAACATGGAGAAACCC"
"GL873578","1144101","1144139","chr3","33494224","33494257","11","32350123","GAGAGAGACCTCATGTCTACTAAAATAAATAAATATATA","GTGAAACCCGTCTCTACTAAAAATACAAAAATTA"
"GL873578","1144175","1144343","chr12","119519961","119520131","41","118375786","ATTATCCAGGCCTTCTGGTGGATGCCTGTAGTCCTAGCTACTAGAAAAGCTGGAGCAGAATCACTTGACCCAGGAGCTGGAGGTTGCAGGGAGCTAGGCTGATGCCACAGAATTCTAGCCTGAGGCAAAAGAATTGAGCCACTGTCTCAAAAAGGAACAAAAAAGAAAA","ATTAGCCAGGTGTGGTGGCATGCACTTGTAATCCCAGCTACTAAGAAGGCTGAGGCAGGAGGATCACTTGAACCCGGGAGGTGGAGGTTGCAGTGAGCCAAGATCATGCCACTGCACTCCAGCCTGGGCAACAGAGTAAGACTCTGTCTCAAAAAAAAAAAAAAAAAAAAA"
"GL873578","4593962","4594035","chr16","68825055","68825124","22","64231093","AGCTGGGTACAGTGGCTCACATATAATCCCAGTGACTCAGGAGGCTAAGACAGGAGGATTACTAGGACCTGAGA","GGCTGGGCACAGTGGCTCAGACCTGTAATCTCAGTACTTTGGGTGGCTGAGGCAGGTGGATCACCTGAGG"
"GL873578","6158845","6158972","chr3","500432","500562","24","5658413","GACATGGTGGCTCACACCTGTAATCCTAGCCCTCTGGGAGGCTGAGGCAGGTGGATCACTTGAGTTCAGGAATTCAAGACCAGCTTGAGTGAGAGCAAGACCCTGTCTCTACTAAAAATAGAAAAATT","GCACGGAGGCTCATACCTGTAATCCCAGCACTTTGGGAGGCTGAGGCAGGTGGATCACCTGAGGTCAGGAGTTCCAGACCAGCCTGGCCAACATGGCGAAACCCTGTCTCTACTAAAAATACAAAAAATCT"
"GL873578","6159253","6159444","chr19","34496349","34496541","55","28337096","ATAAAATAAAAATAGAAAAATTAGCCAGGCATTGTGGCAGACATGCGAAGTCTCAGCTACTCCAGAGGCTGAGACAGGAAGATTACTTGAGCCCAAGAATCTTGCTGTGAGCTAAGCTGATGCCATAGCATTGTAACCTAGGCAACAGAGTAAGACTTGGCCTCAAAAATAAAATAAAATAATAAAGTAAAA","TTAGTTAATTAAATTAAACTTAGCTAGGCATAGTGGAACACACCCATAGTCCCAGCTACTCTAGAGGCTGAGGCAGGAGGATTGCTTGAGCCAAGTTGGAGGCTGCAGTGAGCTATGGTGGTGCCACTGCATTCCAGCCTCAGTGACAGAGAGAGACCCTGGCTCAAATAATAATAATAAATAAATAAATAAA"
"GL873578","6766040","6766171","chr2","93098086","93098217","30","86332046","CCAGGCACAGTGGCTCATGCCTATAATCCTAGTAGTCTAGGAGGCTGAGGTGAGTGCATTGCTTGAGCTCAGGAGTTAGATACCAGCCTAACCAAGAATGAGACCCCATCTCTATTAAAAATAGAAAAGTTA","GCCGGGCACAGTGGCTCATGCCTGTAATCCCAGCACTTTGGGAGGCCGAGGCGGGCAAATCACGAGGTCAGGAGTTCAAGACCAGCCTGACCAATATGATGAAACCCCGTCTCTATTAAAAATACAAAAATT"
"GL873578","6766434","6766577","chr9","21128084","21128223","50","14361650","GTTAGCCAGGAGTTGTGGCGGGCACCTACAGTCCTAGCGACTCAGGAGGCTGAAGTAGGCAGAGTTTGATGTGTTGCTGTGAACTACAAGGACACCAATGCACTCTAGGCCGGTAACAGAGTGAGACACTGACTAAAAAAAAAA","TTAGCCAGGTGTGGTGGCACATGCCTGTATTTCCAGCTACTCGGGAGGCTGAGGCAGGAGAATTGCGTGAGCTGAGATCATGCCACTTCATTCCAGTCTGGGTGACAGAGTGAGACTCTGCCTCAAAAAACAAAACAAAA"
"GL873578","7397948","7398119","chr5","40230148","40230319","43","32832200","TAAAAATAGCCATGCATTGTGACAGGCACCTGTAGTCCCAGCTACTCAGGAGGTTGAGGTAAGAGAATCACTTGAACCCAAGAGTTTTGAGGTTGTTATGAGCTAAGACGCCTCGGGACTCTACAAAAGGTAACAAAGTGAGACTCTGTCTCATAAAAAAAGAAAAAAAGAA","AAAATTAGCCAGGCATGGTGACGTACACCTGTAGTCCCAGCTACTCGGGAGGCTAAGGCAAGAGAATCGCTTGAACCCAGGAGGCAGAGGTTGCAGTGAGCTTAGATCACGCTACTGCGCTCCAGCCTGGGTGACGGAGTGAGACGCCATCTCAAAAAAAAAAAAAAAAAAA"
"GL873578","7398378","7398515","chr15","102382935","102383070","35","94984557","GGTCGAGCAAGGTGGCTCACGCCTGTAATCCTAGCACTCTGTGAGGCTGAGGCAGATGGATTGCCTGAGCTCGTGGGTTCGAGACCAGCCTGAGCCAGAGTGAGACCTCATCTCTAAAAATAGCTGGGAAGCTGGGCA","GGCCAGGTGTGGTGGCTCACGCCTGTAATCCTAGCACTTTGGGAGGCTGAGGCGGGTGGATTGCCTGAACTCAGGAGGTCAAGACCAGCCTGGGCAACACAGTAAAACCCCATCTCTACTAAAATACAAAAAATCA"
"GL873579","370235","370429","chr16","38067345","38067552","57","37697110","GCACAGGCCTGAAATCCTAGCACTCTGAAAGGCCAACGGAGGAGAATTTCTGGAGCTCAGGAGTTTGATACCAGCCTAAGCAAATAAAGCTAGACCTCTATCTCTACTAAAATTAGAAAAATTAGGCAGATGTGGTGGTAGGCACCTATAGTCCCAATTACTCCAGAGGCTGAGGCAGAAAGACTCTTGAACCCA","GTCAGGCATGGTGGCTCATGCCTATAATCCTAGCACTTTGGGAGGCCAAGGCCGGTGGATCACCTGAGGTCAGGAGTTTGAGACCAGCCTGGCCAATATGGCAAAACCCCGTCTCTACTAAAAATAAAAAAATTAGCTGGGCACGGTGGTGGGCACCTATAGTCCCAGCTACTCAGGAGGCTGAGGCAGGAGAATTGCTTGAACCCAG"
"GL873579","370936","371046","chr3","3847698","3847802","33","3476762","TGACTCTTGAACCCAGGCACATGAGGTTGCTAAGAGTCTAGGCTGATGTCACGGCACTCTAACCTGGGAAACAGTGTGAGGTTCTGCCTCAATAAATAAATAAATAAATAA","TGGCTTGAACCCAGGAGGCGGAGGTTGCAGTGAGCCGAGATCACGCCACTGCACTCCAGCCTGGGCAACAGAGCGAGACTGTCTCAAAAAAAAAAAAAAAAAAAA"
"GL873579","599436","599605","chr10","38982686","38982853","41","38383250","AAAAAGTCAGACATTGTGGCAGGTGTCTGTAATCCCAGCTATTTGGGAGGCTGAGGCAGGAGTATCATTTGAACCCACGAGTCTGAGGTAACTGTGAGCTAGGCTAACACAACAGCACTCTAGCCTGGGCAATAGAATGAGACTCTATCAAGAAAAGAAATGAAAAGAAA","TATTAGCCTGACACAGTGGCGCGCATCTGTAATCCCAGCTACTTGGGAGGCTGAGGCAGGAGAATCACTTGAACCCAGGAGGCGGAGGTTGCTGTGGGCTGAGATCATGCCACTGCACTCCAGCCTGGGCAACAGAGGGAGGCTCCATCTCAAAAAAAAAAAAAAAAA"
"GL873579","599942","599953","chr3","71473700","71473710","4","70873758","TTTTAAAATAGT","TTTAAAAAAAA"
"GL873579","600232","600365","chr1","16061315","16061447","30","15461083","GGCTAGGCAAGGTGACTCATGTCTGTAATCCTAGTACTCTGGGAGGTTTGAGGCAGGAAGACCACTTTAGCTCAAGAGTTCCAGATCAGCCTGTGCAAGAGTGATACATCATCTCTACTAAAAATCAAAAATTA","GGCTGGGCATGGTGGCTCATGCCTGTAATCCTAGCACTTTGGGAGGTTGAGGCAGGCAGATCACTTGAGGTCAGGAATCTGAGACTAGCCTGGCCAACATGGTGAAACTCCATCTCTACTAAAAAAAAAAAAA"
"GL873579","5650320","5650591","chr6","54938866","54939145","71","49288546","GTCAGGTGTGTTAGCTTACAGTAGTAATCCTAGCACTTTGGGAGGTTGAAGTGGGTGGATTGCTTGAGCTCAGGGGTTCAAGACCAGCCTGAACAAGAGTGGGACCTCATCTCTATTAAAAACAGAAAAACTAGCTGGGTGTTATGGTGGGTGTCTGTAGCCCCAGCTACTCAGGAGGCTGAGGCAGGAGGTTGAGGTTGCTGTGAGCTATTGAGACCACAGCACTCTATCCAGGGCAACAGAGTGAGACCCCTCCCCCCCCCAAAAAAAAA","GGCCAGGTGTGGTGGCTCACGCCTGTAATCCCAACACTTTGGGAGGCCGAGGTGGGTGGATCACCTGAGATCAGGAGTTCAAGACCACCCTGGCCAACATGGTGAAACCCCGTCTCTACTAAAAATACGAAAATTAGCTGAGTGTGGTGGTGCATGCCTGTAGTCCCAGCTACTCAAGAGGCTGAGGCAGGAGGTGGAGGTTGCAGTGAGCCGAGATTGCATCACTGCACTCCAGCCTTGGCGACAGAACGAGAGAGACTCCATCTAAAAAAAAAAAAAA"
"GL873579","7037162","7037347","chr3","37328686","37328893","67","30291524","GAGGTGGGTGGATTGCCTGAGCTCACAGGTTGGAGACCAGCCTGAGCCAGAGCAAGACCTTATCTCAAAAAATAGCCAGGTGTTGTGGCTGGCACCTGTAGTCCCAGCTGCTCAGGAGGCGGAGGCAAGAGAAATGCTTGACCTCAGGAGTTTGAGGTTGCTGTGAGTTCAACTCACACTAATACA","GAGGCAGGGGGATCACCTGAGGTCAGGAGATCGAGACCAGCCTGGCCAACATGGTGAAAACCTGTCTCTACTAAAAATCCAAAAACATTAGCCAGGTGTGGTGGCACGCACCTGTAATCCCAGCTACTTGGGAGGCTGAGGCAGGAGAATCACTTGAACCTGGGAGGCAGAGGTTGTAGCGAGCCGAGATCACACCACTGCACCCCAG"
"GL873579","11077764","11077972","chr19","1200469","1200683","63","9877295","GCCAGGTGCAGTGGCTCATGCCTATAATCCTAGCACCCTAGGAGGCTGAGGAGTTCAAGACCAGCCTAAGCAACTGTGAGACCCCATCTCTACCAAAAATAGAAAAATTAGCTGACTGTTATGGTGTGCACCTACAGTCCTAGCTACTCAGGAGGCTGAGGCAGAAAGAGTCCTTGAACCCAGGAGGCTTTTTTTTGTTGTTGTTGTTG","GGCCAGTCGCGGTAGCTCATGCCTGTAATCCCAGCACTTTGGGAGGCCGAGGCGGGCAGATCACCTGAGACCAGCCTGGCAACATGGTGAAACCCCATGTCTACCCAAACTACAAAAATTAGCTGGGTGTGGTGGTGCACGCCTGTAATCCGAGCTACTCAGCAGGCTGAGGCAGGAGAATCCCTTGAACCTGGGAGGCAGAGGCTGCAGTGAGC"
"GL873579","11078245","11078333","chr19","4926258","4926351","22","6151987","TGAACCCAGGAGTTTGAGTTCGCTGTGAGCTAAGCTGAGGCCACAGCACTCCAGCCTGGGCAACAGAGTGAAAGGAAAAAAATAAAAAA","TGAACCCGGGAGGTGGAGGTTGCAGTGAGCCAAGATCACACCAATGCACTCCAGCCTGGGCAACAAGAGTGAAACTCTGTCTAAAAAAAAAAAA"
"GL873580","320374","320488","chr13","48549305","48549409","42","48228931","GGTAGTGCGTGCCTGCATTCCCAGCTACGGGAGGGCAGGGACTTGAGGCCAGCCTGGGCAAAATAATGAGACCTACTAATGACTCTACTAATACAGAAACAATTAGCTAGGTATG","TGGGAGGCCGAAGTGCGCAGATCACCTGAGGTCAGAAGTTGGAGACCAGCCTGGCCAACATGGTGAAAACCCATCTCTACTAAAAATACAAAAATTAGCTGGGCA"
"GL873580","374969","375091","chr6","147681010","147681135","27","147306041","CGGTGGCTCACACCTATAATCCTAGCATTTTGGAAGGCTGAAGCCGAGGATCTCTGGAAGTCAGAAGTTCAAGACCAGCCTGCCCAAGAGCAAGACCCCATCTCTACTAAAAATAGAAAAACT","GGTGGCTCACACCTGTAATCCCAGCATTTTGGGAGGCTGAGGCAGGCGGATAATCTGAGGTCAAGAATTTGAGACCAGCCTGGCCAACATGGAGAAACCCTATCTCTACTAAAAATACAAAATTAC"
"GL873580","375369","375549","chr7","19977275","19977456","44","19601906","CTAACCAAGTTAGTTAGTTTTAGTTGGCAGGTGCCTGTAGTCCCAGCTCCTTGGGAGGCTGAGGCAAGAGAATGGCTTGAGCCCAGGACTTTGAAGTTGCTGTGAGCTATAATGACACCACAGCACACTACCCAGGGTGACAGAGTGAGACTGTCTCAAAAAAACAAACAAACAAAAAAAA","AACAAACGTTAGCCGAGCATGGTGGTATGTGCCTGTAGTCCCAGCTACTTGGGAGTCTAAGGCAGGAGAATTACTTGAGCCCGGGAGGCAGAGGTTGCTGTGAGCCAAGATCACGCCACTGCACTCCAGCCTGGGTGACAGAGTGAGACTCCATCTCAAAAAAAAAAAAGGAAAAAAAAAAA"
"GL873580","8760922","8761015","chr11","104681322","104681416","19","95920400","GGAGGGAGACACTGCAGTGAACTGCGATCGTGTCTCTGCTTTCCAGGCTGGGTGACAGAGTGAGACTCGGTCTCTAAAATAAAAAATAAATAAA","GGAGACGGAGGTTGCAGTGAGCTGTGATCGCGGCACTGCACTCCAGCCTGGGCAACAGAGTGAGACTCTGTCTCAAAAATAAATAAATAAATAAA"
"GL873580","9391260","9391306","chr14","49279240","49279285","12","39887980","GCCAGTCGAGGTGGCTCACACTTGTGATTCCAGCTACTTGGAAGACT","GGCTGAGATGGTGGCACACACCTGTAATCCCAGCTACTTGGGAGGC"
"GL873581","759283","759365","chr6","46535476","46535542","30","45776193","TAAGAACCTGAAAATAGAGCCAGGCATAGTGGTACATGCGTATAGTCCTGGCTACTCAGGAGGTTGAAACAACAGGATTACTT","CAAAATAGCCAGGCTTGGTGGTGCATGCCTATAATCCAAGCTACTCGGGAAGCTGAGGCAGGAGAAT"
"GL873581","1145844","1145979","chr1","29437872","29437991","29","28292028","GGCCGGGCGTGGTGGCTCACGCCTGTAGTCCCAGCACTATGGGAGGCCGAGGCGGGTGGATCACCTGTGCTCAGAGGTTCGAGACCAGCCAAGACCCCCCTGAGCCAAATGAGCCAGAGTGAGACCCCGTCTCTAC","GGCCGGGCGTGGTGGCTCACGCCTGTAATCCCAACATTTTGGGAGGCCAAGGCGGGTGGATCACCTGAGGTCAGAAGTTCGAGACCAACCTGGCCAACATGGTGAAACCCCTGTCTCTAC"
"GL873581","9628238","9628362","chr5","141044567","141044691","34","131416329","ATCCCAGGTAGTCGGGAGGCTGAGGCAGGAGGATCACTTGAACCCAGGAGGTTGAGGTTGCTGTGAGCAAGGCAGAGGCAACGGCACTCTAGCCACGGGGGCACAGAGACTCTTGTCTTTAAAAA","TAATCTCAGCTACTCGGGAGGCTGAGGCAGGAGAATCGCTTGAGCCCAGAAGGTGGAGGTTGCAGTGAGCCAAGATCGCGCCATTGCACTCCAGCCTGGGCGACAGTGCGAGACTCTGTCTCAAA"
"GL873582","1580485","1580534","chr6","32576760","32576806","12","30996275","CAGCACTTGAGAGGCCAAGGCAGGTGGATCAACTGAGCAAGAATGAGACC","CCAGCACCTTGAGAGGCCAAGGCAGGTGGATCACCTGAGGTCAGGAG"
"GL873582","1644368","1644551","chr1","211626449","211626612","63","209982081","AAAATTTGCCGGGCTCCATAGCTCATGCATGTAATCATAGCACTCTGGGAGGCCAAGATGGGAGGATCTCTCAAGCTCTCTTACTTGGGAGGCTGAGGTTGCTGTGAGTTAGGCTTACGCCACAGCACTCTACTCTAGCGTGAGCAACTCTACTCTTAGTATGAGACTGTCTCAAAAGAAAAAA","AAATTAGCCAGGCGTCGTGGCACATGCCTGTAATCCCAGCTACTCGGGAGGCTGAGGCAGGAGAATAGCTTGATCTCGGGAGGCGGAGGTTGCAGTCAGCCGAGATCACACCACTGCAATCCAGCCTGGACAACAGAATGAGACTCCATCTCAAAAAAAACAAA"
"GL873582","5794385","5794459","chr13","18872784","18872852","27","13078399","ATATTGTTAAGCACAGCCACTATTAAAAATTAAATTATAGGCCAGGCATAGTGGCTCATGCCTGTAATCCTAGCT","TGAAACCACCATCTGGACCAAGATACAAAATGTTGGCTGGGCATGGTGGCTCACACCTGTAATCCTAGC"
"GL873583","102645","102683","chr14","5808766","5808804","14","5706121","GAGCAGATCACCTGAGCTCAGGAGTTTGAGACCAGCCTG","GAGGAATCCCTGTGCTCAGGAAGCTTACATTCTAGTGAG"
"GL873583","6200447","6200560","chr4","17786849","17786963","24","11586402","GGCCAGGAGGGACGGCTCATGCCTGTTATCCTAGCACTATGGGAGACTGAGGTGGGAGGATCACTTGAAGTTAGGAGTTCCAGACCAATCTGACCAAAGTGAGACCTCATCTCT","GGCCAGGCTTGGTGGCTCATGCCTGTAATCTTAGCACTTTGGGAGGCTGAAGTGGGTGGATCACTTGAGGTCAGGAGTTAGAACCAGTCTGGCCAACATGGTGAAACCTCAGCTC"
"GL873583","6200584","6200752","chr6","169626528","169626696","42","163425944","TTAGCTGGATGTGGTAGCACATGCCTATAGTCCCATCTACTCAGGAGGCTGAGACAAGAGAGTTGCTTAAGCCCAGGAGTTTAATTTAACTGTGAACTAGACTGAGACTGTGGCACTCTAGCTGGGGCAACAGAGTGAGACTCTGTCTCAAAAGAAAGCAAGAAAGAAA","TTAGCTGGGTATGGTGTCAGATGCCTGTAGTCCCAGCTACTCAGGAGGCTGAGACAGGAGAATCGTTTGAACCCAGGAGGCCAGAACTGCAGTGAGCTGAGATTCGCACCACTGCGCTCCAGCCTGGGCCAGACAGAGTGAGACTCTATCTCAAAAGAAAAAAAAAAAA"
"GL873583","10217398","10217583","chr3","36257142","36257313","44","26039744","TACTAAAAATAAAGTGTGATAGCCAGGCATGGTGGTGGTGCCTATAGAACCAGGCTATTCAGGAGGCTGAGGCAGAAGGATCACTTGAACCCAGGAGTCTGACGTTGCTGTGAGCTAGGCTGGTGCCATGGTACTCTAGCCTGTGGTAACAGAATGAGACTCTATCTCAAAAATAAAAATAAAAAA","TACAAAATTAGCCAGGCGTGGTGGTGCGTGCCTGTAATCCCAGCTACTTGGGAGGCCGAGGCAGAAGAATGACTTGAACCCAGGAGACAGAGGTTGCAGTGAGCCAAGATCCCACCATTGTACTCCAGCCTGGGCAACACAGTGAGACTCCATCTCAAAAAAAAAAAAAAAA"
"GL873583","10394919","10394983","chr16","12841703","12841771","22","2446784","GAGGTCAGGAAATCAAGATCAGTCTGGGCAATATATTGATACCCTGCCCCTACATAAGGAAGAAA","AGGTCAGGAGTTCAAGACCAGCCTGGCCAATATGTTGAAACCTCATCTCTACTAAAAATACAAAAATTA"
"GL873584","521512","521529","chr1","167402212","167402233","10","166880700","GCATGGAACCCCCCACTC","GGTGAAACCCCATCTTTACTAA"
"GL873584","2079725","2079768","chr15","4338291","4338335","11","2258566","GGCAGGTGGATTACCTGAGTTCAGGAGTTGGAGACCAGCCTGAC","AGGCGGATGGATCACGAGGTCGGGAGTTTGAGACCAGCCTGACCA"
"GL873584","5216877","5217053","chrX","91350057","91350230","49","86133180","CTACTGAAAATGATGACAGAGGCTGGGCATGGGGGCTCCCGCCTGTTATCCTAGCACCCTCGGAGGCTGGGGAATGAGGATTGCTTACGCCCAAGAGTTTGAGGTTGCTGTGAGCTGAGGCCGCTGCACTCTAGCCTGGGCAACAGAGTGAGACTCTGTCTCAAAAAAAAAAAAAAA","TGCAAAAATGAGCTGGGCATGGTGGCACATGCCTGTAATCCCAGCTACACAGGAGGCTGAGGCAGGAGAATCGCTTGAATCTGGGAGGCGGAGGTTGCAGTGAGCTGACATCAGGCCCCTGCACTCTAGCCTGGGCCACAGAGCAAGACTCCGTCTCAAAAAAAAAAAAAAAAA"
"GL873584","7289930","7289950","chr2","51453328","51453345","10","44163398","TGAGGCTCTGTCTCGAAATAA","AATGCCATCTATTAAAAA"
"GL873584","7289975","7290131","chr11","49739997","49740154","37","42450022","CAAGAAAATTAGCTGAGAGTCCTGGTAGGTGCCTGTAATCCCAGCTATTCATGAGGCTGAGGCAGAAGGATCACTTGGGTCCAGGAGTCTGAGGTTGCTGTGAGCTAGTCTGACGCCATAACACGCAAGCCTGGGCAACAGAGTGAGGCTCGGTTTC","CTACAAAAATTAGCTGGGCGTGGTGGCACATGCCTGTAATCCCAGCTACTCGGGAGGCTGAGGCAGGAGAATCACTTGAGCCCAGGAGGCGGAGGTTGCAGTGAGCCAAGATCATGCCATTGCACTCCAACCTGGGCAACAGAGCAAGACTCCATCTC"
"GL873584","7577743","7577867","chr5","48394329","48394446","27","40816586","GGCTGGATGAGGTGGTTCATGCCTGTAATCCTAGCACTCTGGGAGGCCAAGGTGGGTGGATTGCCTGAGCTCAGGAGTTCAAGACCAGCCTGAGCAAGACCCTGTCGCTAAAAATAGCTGGGTGT","GGCTGGGTGCAGTGGCTCATGCCTGTAATCCCAGCACTTTGGGAGGTCAAGGCGGGTGGATCACCTGAGGTCAGGAGTTCAAGACCAGCCTGGCCAACATCTCTACTAAAAATACAAA"
"GL873584","7578135","7578289","chr1","130112713","130112865","31","122534578","GGAGCTGGGTTTTGTGACTGCACCTGTAATCCCAGCTGCTCAGGAGGCTGAGGCAAGAGAATTGCTTGAGCCCAGGAGTTGGAGGTTGCTGTGAGCTGTGATGCCAGGGAACTCTACCAAGGGTGACAAAGTGAAACTCTGTCTCAAAAAAAAAA","TTAGCCAGGTGTGGTGATGCATGCCTGTAATCCCAGCTACTCATGAGGCTGAGGCAGGAGAATTGCTTGAACCTTGGAGCTGGAGGTTGCAGTGAGCTGAGATCAGACCACTCCAACCTGGGTGACAGAGCGAGACTCTGTCTCAAAAAAAAA"
"GL873585","1450952","1451121","chr10","59681079","59681242","48","58230127","TAAAAACAGAAAAAACTAGTCAGGTGGTGTGGTAGGTGCTCATAAGTCCCAGCTGCTTGGGAGACTGAGGCAAGAGAATCACTTGAGCACAAGAGCTTGAGGTGGCTGTGAGCTATAACACCATAGCACTGTACTGAGGGTGACAAAGTAAGACTCTGTCTCAAAAAAAA","TACAAAAATTAGTCAAGGGTGGTGGTATGTGCTTGTAATCCCAGCTATTTGGGAGGCTGAAGCAGGGGAATCCTTGAACCCAGGAGGTGGAGGTTGCAGCGAGCCGAGATCACGTCACTGCACTCTAGCCTGGGCGATAGGGTGAGACTCTGTCTCAAAAAAAA"
"GL873585","1451382","1451515","chr6","17405813","17405948","24","15954431","GGCCCGGCTCGGTGGCTCACACCTATAATCCTAACACTCTGGGAGGCTGAGGCAGGTGGATCACCTGAGCTCAGGAGTTTGAGACCAGCTGAGCAAAAACAAGACCCTATCTCTGCTAAAAATAGAAAAAACTA","GGCCGGGCGGGGTGGCTCACGCCTGTAATCCCAGCACTCTGGGAGGCCAAGGCAGGTGGATCACCTGAGGTCAGGAGTTTGAGACCAGCCTGGCCAACACGCAGAAACCCTATTTCTACTAAAAACACAAAAATTA"
"GL873585","1626960","1627026","chr7","17782729","17782794","22","16155769","AAGATGCCACAGCACTCTACAAGAGTGACCAAGTGAGACTCTGTCTCAAAAAAAAAAAGAAAAGGAA","CAATCGCACTACTGCACTTCAGCCTGGGTGACAGAGTGAGAACCTGTCTCAAAAAAATAAATAAAA"
"GL873585","1627304","1627531","chr11","17033552","17033788","61","15406248","GGCTGGGCACAGTGGCTCACGGCTATAATCTAGGCACTTGGGAGGCTAGGGCAGGTGGATTGCCTGAACTGACAAGTTTGAGACCAACCTGAGCAAGAGCGAGACCCCTGTCTCTAAAACATAGCCAGGCTCTGTGGTGGGCGTCTGTAGTCCCAGCTACTTGGGAGGCTGAGGCAAGAGAATTGCTTGAACTCAAGAGTCTGAGGTTGCTGTGAGTTAAGATGCCAC","GCCCGGCGCAGTGGCTCACGCCTGTAATCCCGGCACTGTGGAGGCCAAGGCAGGCGGATTGCCTAAGCTCAGGGATTCGAGAACAGCCTGGGCAACATGGTGAAACCCCATCTCTACTAAAATACAAAAAACTAGCCGGGCGTGGTGGTATGCGCCTGTAATCCCAGCTACTTGGGAAGCTGAGGCAGGAGAATTGCTTGAACCCGGGAGATGGAGGTTGCAGTGAGCTCAGATCAC"
"GL873585","3626082","3626158","chr1","100916857","100916922","27","97290775","TGCCTGTAATCCCAGCACTTGGGAGGCGGAGGTGGGTAGATTGCCTGACCCAGAGTGGGACCTCATCTCTAAAAGAA","CATGCCTGTAATCCCAGCACCTTGGGAGGCCAAGGTGGGTGGATCACCTGAGGTCAGTAGTTTGAG"
"GL873585","8849829","8849913","chr18","48581945","48582025","18","39732116","GGCTGGACGAGGGGACTCATGCCTGCAATCCCAGCACTGAGAGAGGCCAAGGCAGGTGGATCCCCTGAGCTCAGAAGTTTGAGAC","GCTGGACGCAGTGGCTCACACCTGTAATCCCAGCACTTTGGGAGGCCAAAGCAGGCAGATCTGAGGTCAGGAGTTTGAGAC"
"GL873585","9319890","9319971","chr8","79499361","79499447","14","70179471","GGCCAGGTGTGGTGGCTCACACCTGTCATCCTAGCACTCTGGGAGGACGAGGTGGGTGGACCGCCTGAGTCAGAGTGAGACC","GGCCAGGTGTGGTGGCTCACACCTGTAATCCCAACACTTTGGGAGGCCCAGGTGGGTGGATCACCTGAGGTCAGGAGTTCAAGACCA"
"GL873586","895572","895692","chr17","14501559","14501680","38","13605987","GGCCAGGTGAGGTTTCTCATTCTGGGAGTGAGCCAGCAATTGGGAGGCCAAAGTAAATGGATTGCCTGAGGTTATAGGTTCCAGAACAGCCAGAACAAGATCGAAATCCTGTCTCCAAAAA","GGCCAGGCGTGGTGGCTCATGCGTGTAATCTCAGCACTTTGGAAGGCCGAGGCAGGTGGATCACCCGAGGTCAAGAGTTCAAGACCAGCCTGACCAACATGGCGAGTCTCTGTCTCCACTAA"
"GL873586","5645995","5646150","chr6","58863249","58863409","38","53217254","GGGTATGGTGGCTCATGCCTGTAATCCAAGCACTCTGGGATGGTGAGGCAGGAGAATCCCTTGAACCCAAGAGTCCGAGGTTGCTGCGAGCTAAGCTGATGGCATAACACTCTAGCCTAGGCGACAGAGTGAGACTCTGTTTCCAAAGAGAAAAAA","TTAGCCAGGCATGGTGGCACATGCCAGTAATCCCAGCTACTCAGGAGGATGAGGCAGGAGAATCGCTTGAACCCAGGAGGCAGAGGTTGCAGTGAGCTGAGATTGCGCCACAGCACTCTACCCTGGGTGACAGAAGGAGACTCTGTCTCAAAAAAAAAAAA"
"GL873586","10258686","10258969","chr12","9481260","9481565","81","777426","GGCCGGGCATGGTGGCAGAAATCTAGGAGGCCGAGGCAGGTGGATCGCCTGAGATCACAAGTTCAAGACCAGCCTCAGCTACAGCAAGACCCCATCTCTAAAAATAGCCGGCTGTTGTGGCAGGCGCCTGTAACCCCAGCTACTCGGGAGGCTAAGGCAAGAGAATCGCTTGAGCCCATGAGTCTGAGGTTGCTGCGAGCTGTGACTCCACGGCACTCTACCCGGGGCGATAAAATGAGATTCTGTGTCAAAACAAACAAACAAACAAACAACAACAAAAACAA","GCTGGGCGCGGTGGCTCATGCCTGTAATCCCAGCACTTTGGGAGGCCAAGGCAGGTGGATCACCTGAGGTCAGGAGTTCGAGACCAGCCTAGTCCACATGGTGAAACCCCATCTCTACTAAAAACTAGCCAGGCGTGGTGGTGCGCACCTGTAATCCCAGCTACTCGAGAGGCTGAGGCAGGAGAATCACTTGAGCCTAGGAAGCAGAGGTTGTGGTGAGCTGAGATCACACCACTGCACTCCAGTCTGGGCGACACAGTGAGACTCTTGTCTCAAAAACAAAAAACAAACAAACAAACAAACAAA"
"GL873587","3208032","3208047","chr8","3626746","3626762","2","418714","AAACAACCACAAAAAA","ACAACAACAACAAAAAA"
"GL873587","3208141","3208321","chr19","2057131","2057316","59","1151010","TTTCTTTTAAAAATCACCCATGGGCTGGGTATAGTGGCTCACACCTATAATCCTCGGGAGGCCAAGGTTGGAGGATTGCTTGAATCCAGGAGTTGAAGGTTACAGTGAACTGGGATTTAGCCACTAGACTCTAGCATAGCTGACAAAGCAAGAACCTATTTGTTTAAAACACAAAAAAGAA","TACTAATAATACAAAAATGAGCCGGGTATGGTGGCGGGTGCCTGTAATCCCAGCTACTGAGGAGGCTGAGGCAGGAGACTTGCTTGAACCCAGGAGGTAAAGGTTGCAGTGAGCTGAGATTGCACCACTACACTCCAGCCTGGGCGACAAGAGCAAAACTTTTTCTCCAAAAAAAAAAAAAAAAAA"
"GL873587","3278260","3278367","chr19","19044200","19044312","39","15765940","CAGTCTGAGCAAGAGGGAGAGGCTATTTCTACTAAAAACAGAAAAACTAGCTGGGTGTTGGGGTGTGTTCCTAGTCTCAGTTACTTGGGAGGCTGAAGTAAGAGGATC","ACCAGCCTGGCCAACACGGTGAAATCCCGTCTCTACTAAAAATACAAAAATTACCTAGGCGTGATGGCACGTGCCTGTAGTCCCAGCTACTCATAAGGCAGAGGTGAGAGAAT"
"GL873587","3278673","3278754","chr7","49412503","49412597","28","46133830","GGCCACGAGAGCTAGCTCATGCCTATTCTAGGAGGCCAAAGCAGGCAGACTGCCTGAGCTCAGGAGTTCAAGAGCAGCCTGG","GGCCAGGTGCAGTGGCTCATGCCTGTAATCCGAGCACTTTGAGAGGCCGAGGCAGGCAGATCACCTGAGGTCAGGAGTTCAAGACCAGCCTAGTA"
"GL873587","3782076","3782188","chr9","112128434","112128552","34","108346358","ACTGGGGTGGCTGAGGCAGGAGCGTCACTTGAACTCAGGAGTTTGAGATTGCTGTGAGCTGAGCAGATGTCATGGCACGCTAGCCTAGGTAATAGAGTGAGACTTCGTCTAAA","CAGCTACTCGGGAGGCTGAGGCAGGAGAATCACTTGAACTCGGGAGGCGGAGGTTGCAGTGAGCCGAGATCACGCCATTGCACTCCAGCCTGGGCAACAAGAGCGAAATTCCATCTCAA"
"GL873587","4564996","4565084","chr20","27900350","27900437","14","23335354","GGCGGGGTGTAGTGGCTCATGCCTATTGTCCCAGCACTGTGGGAGGCCGAGGTGGGTGGATCACCTGTGCTCAGAAGTTTGAGACCAGC","GGCCGGGCGTGGTGGCTCATGTCTGTAATCCCAGCACTTTGGGAGGCCGAGGTGGGTGGATCACCTGAGGTCAGGAGTTCAAGACCAG"
"GL873587","6307870","6308175","chr12","112427710","112428020","54","106119840","GGCCAGATATGATGGCTCATGCTTGTAATCCTAGCACTCTGGGAGGCTGAAGTGGGAGGATCACCTGAGATCAGGAGTTCAAGATCACCCTGAGCAAAAGTGAGATCCCATCTCTATTAAAAATAAAAAAATTATCCAGGCATGGTGGTGCAGTCCTTTAGTCCCAGCTACTTGGGAGGCTGAGGCAGGAGAATCTCTTGAACCCAGGAATTAGAGGTTACAGTGAGCTGTGATGATGCTACTGCACTCTAGCAGGATGACAGAGTGAGATACTCCGTGTCAAAAAAAAAAAAAAAAAAAGCAAAA","GGCTGGACATGGTGGTTCATGCTTGTAATCCGAGCACTTTGGGAGGCCAAGGCGGGTGGATCACCTGAGGTTGGGAGTTCGAGACCAGCCTGACCAACATGATGAAACCCCATCTCTACTAAAAATACAAAAAAATTAGCCAGGCATGGTGATGCACGCCTGTAATCCCAGCTACTTGGGAGGCTGAGGCAGGAGAATCACTTGAACCCAGGAGGCAGAGGTTACAGTGAGCCGAGATCATGCCATTGCACTCCAGCCTGGATGACAGAGTGAGCCTCTGTCTCAAAAAAAAAAAAAAAAAAAAAAAAAAA"
"GL873587","6484004","6484128","chr10","67341428","67341546","29","60857424","GACCAGGTTCTGTGGCTCATGCTTGTAATCCTAGCACTCTAGGAGGCCGGAAGAGGGTGGATTGATTGCCTGAGGTCAGGAGTTAGAGACCAGCCTGAGCAAGAGCTAGACCCTGTTTCTTTCTT","GGCTGGGTGTAGTGGCTCATGCCTGTAATCCCAGCACTTTAGGAGGCCAAGGTGGATGGATTGCCTGAGCTCAGGAGTTCGAGACCACCCTGGGCAACAAGCCAAAACCCTGTCTCTAC"
"GL873587","6484407","6484586","chr3","167196537","167196723","48","160712130","TAGACCCTGTTTCTAAAAAAAAAATAGCCAGGTGTTGAGGCAGGTACCTGTAGTCCCAGCTACCTGGGAGGGCTGAGGCAAGAGAATCGCTTGAACCCAAGAGTTTGAGGTTGCTGTGAGCTGAGATGCTATGGCACTCAACCGTGAGCTACAAAGTGAGACTCTGTCTCAAAAAAAAAA","AAAACCTGTCTCTGCTAAAAATACAAAAATTAGCCGGGTGTGGTGATGTGCGCCTGTAGTCCTAGCTACTTGGGAGGCTGAGGCAGGAGAATCACTTGAATCCAGGAGGTGGAGGTTGTAGTGAGTCGAGATCGTGCGACTGCACTCCAGCCTGGGTGACAGCGAGACTCTGTCTCAAAAAAAAAAA"
"GL873587","7466229","7466364","chr1","29437872","29437991","35","21971643","GGCCAGGCGTGGTGGCTCATGCCTGTAGTCCCAGCGCTATGGGAGGCCGAGGTGGGTGGATCACCTGTGCTCAGAGGTTCGAGACCAGCCAAGACCCCCCTGAGCCAAATGAGCCAGAGTGAGATCCCATCTCTAC","GGCCGGGCGTGGTGGCTCACGCCTGTAATCCCAACATTTTGGGAGGCCAAGGCGGGTGGATCACCTGAGGTCAGAAGTTCGAGACCAACCTGGCCAACATGGTGAAACCCCTGTCTCTAC"
"GL873588","1502535","1502718","chr1","34852429","34852590","60","33349894","GGTGCAGTGGCTCACACCTGTTGTCCCAGCGCTGTGGGAGGCCGAGGTGGGTGGATCACCTGTGCTCAGAGGTCGAGACCAGCTGAAGACCTGCCTGAGGCAGAGTGAGCCAGAGTGAGACCCCGTCTCTACTAGAACAACAACAAGACAGCCAGACCTTGTGATCCCAGCTACATGGGGGGCT","GCCAGGTGCAGTGGCTCACACCTGTAATCCCAGCACTTTGGGAGGCCGAGGCGGGCGGATCACCTGAGGTCAGGAGTTTGAGACCAGCTTGACCAACATGGAGAAACCCCGTCTCTACTAAAAATACAAAATTAGCCTGGTGTGGTGTCGCATGCCTGTAAT"
"GL873588","10189037","10189246","chr3","45604681","45604903","65","35415644","GCTGAGATGAGGAGACTCTGTCTCTATTAAAAATAGAAAAATTGGGTGGATGTTGTGGGTACTGTAGTTGCAGCCTCTTGGGGGGCTAAGGCAGGAGGATCAGTTGAAGCCAGGAATTTGCTTTGAGCTAGGCTAAAGCCATGGCACTCTAGCCTGGGCAACAGAGTGAGGCTAGATCTCAAAAAAAGAAAGAAAAGAAAAAGAAAAAAA","CTGGCCAACATGGCAAAACCCCATCTCTACTAAATATACAAAAATTAGCTGGACGTGGTGGCACATACCTGTAATCCCAGCTACTTGGAAGGCTGAGGCAGGAGAATAGCTTGAACCTGGGAGGCAGAGGTTGCAATGAGCTGAGATCACGCCACTGCACTCTAGCCTGGGCAATAGAATGAGACTCTGTCTCAAAAAAAAAAAAAAAAAAAAAGACAAGAAA"
"GL873589","104719","104807","chr20","27900350","27900437","13","27795631","GGCTGGGCGTGGTGGCTCATGCCTGTTGTCCCAGCGCTGTGGGAGGCTGAGGTGGGTGGATCACCTGTGCTCAGAGGTTCGAGACCAGC","GGCCGGGCGTGGTGGCTCATGTCTGTAATCCCAGCACTTTGGGAGGCCGAGGTGGGTGGATCACCTGAGGTCAGGAGTTCAAGACCAG"
"GL873589","796766","796905","chr1","166346372","166346487","49","165549606","GGCTAAGTGTGGTGGCTCACACCTGTCATCTAGTACTTTGGGAGGGTGGGCCTGGGAGTTCAAAGACTGAACTCAGGAGTTCAAGGTGGCTCCGGGGAGGAATTCAAGACCAACCTGAGCCAGAGCGAGACCTCGACTCT","GGCCAGTGGGGTGGCTCACGCCTGTAATCCCAGCACTTTGGGAGGCTGAGGTGGTCAAATGACCTGAGGTCAGGAGTTTGAGACCAACCTGGCCAACATGGTGACACCTCGTCTCT"
"GL873589","1023679","1023690","chr1","205890061","205890072","1","204866382","AAAAAAAAAAAA","ACAAAAAAAAAA"
"GL873589","1023771","1024047","chr4","103012712","103012993","70","101988941","GGCTTGGTGGCTCACACCTGTAATCCTAGCACTCTGGGAGGCCGAAGTGGCTGGAATACTTGAGGTCAGGAGTTCAAGACCAGCCTAAGTGAGAGTGAGATCCCCATCTCTAATAAAAATAGAAAAATTAGCAGGGTGTTGTGGCTGGCACTTGTAGTCCCAGCTACCCAGGAGACCGAGGCAGAAGTTTGAGATTATTGTGAGCGAGGCTGATGCCACAGCATTCTAGTGGGACAACAGAGCAAAATTCTATCTCAAAAGAAAAAAAAAAAAAGGA","CGGGCGTGATGGCTCACGCCTGTAATCCCAACACTTTGGGAAGCCGAGGCGGACGTATCACCTGAGGTCAGGAGTTCAAGACCAGCCTGGCCAACATGGTGAAACCCCGTCTCTACTAAAAATACAAAAATTAGCTGGGTGTGGTGGCATGCGCCTGTAATCCCAGCTACCCAGGAGGCTGAGGCAGGAGAATCGCTGAGGCTGCAGTGAACTGAAATTGTGCCACTGCACTCCAGCCTGGGTGACAGAGCAAGACTCTGTCTCAAAAAAAAAAAAAAAAAA"
"GL873589","4820958","4821024","chr8","33633747","33633811","15","28812789","TTAGTCAAGTGCAGTGGCTCACACCTGTCATCCCAGCTACTTGGGAGGCTGAGGCAGGAGAGTTGCT","TTAGCCAGGTGTGGTGGTGCATGCCTCTAATCCCAGCTACTCAGGAGGCTGAGGCAGGAGAATTG"
"GL873589","6763768","6763857","chrX","25814002","25814092","29","19050234","GGTGTGGTGGCTCACACTTGTATCTTAGCATTTTAGGAGGCTGAATGGGGAGAATTGCTTTAAGTCAGGAGTCTGACTTCCACCTTGCCA","GGCTGGGAATGGTGGCTCACACCTGTAATCCCAGCACTTTGGGAGGCTGAGGTGGGCAGATCACCTGAGGTCAGGAGTTTGAGATCAGCCT"
"GL873589","8444551","8444632","chr9","93194085","93194171","17","84749534","CGGGCATGGTGGCTCACAACTATAATCTTAGCACTTTGGGAGGCTGAGACAGGTGGATGCCTGAACTCAAGAGTTTGAAACC","GGCCGAGCATGGTGGCTCACACCTGTAATCCCAGCACTTTGGGAGGCTGAGGCAGGTGGATTACCTGAGGTCAAGAGTTCAAGACCA"
"GL873589","9085365","9085494","chr2","194063347","194063481","42","184977982","GGCCAGGCACAGTGGCTCACACCTATAATCCCAGCACTCTGTGAGACTGAGGCAGGTGAACTGTTGCAAGAGTGAGACCCTGTGCTTGGTGCCTGTAGCTCAGTGGTTAATAATAAGAAAAAAGAAAAAA","GGCCAGGTGCAGTGGCTCACACCTGTAATCCCAGCACTTTGGGAGTCTGAACCAGGCAGATCACCTGAGGTCAGGAGTTCGAGGCCAGCTCGGCCACCATGGTGAAACCCTGTTTCTAATAAGAATACAAAAAAA"
"GL873589","9085767","9086002","chr7","84631446","84631650","75","75545679","GAGTGAAACCCTGTCTCTACTAAAAATAGAAAAACTAGCTGTGCATCAGGGCGCATAACTGTAGTCCCAGGTACTCAGGACACTGAGGCAAGAGAATTGCTCAAGCCCAAGAGTTTGCAAGAATTTGAGGTTGCTATGAGCTATGATGCCATGGCACTCTACCTAGGGTGACAGACAGAGACTCTGTCCCAAAAAAAAAAAAAGAAGAAGAAGAAAAAAAAAAAGAAAGAAAGAAA","ATAGTGAAACCTCGTCTCTACTAAAAATACAAAAATTAGCTGGGCATCATGGTGCACGCTTGTAATTCCAGCTACTTGGGAGGCTGAGGCAGGAGAATTGCTTGAACTCAGGAGGTGGAGGTTGCAATGAGCCAAGATCGCGCCACTGCACACCAGCCTGGGTGACAAAAGACTCTGTCTCAAAAAAAAAAAAAAAAAAAAAAAA"
"GL873589","9992904","9993045","chr16","56427538","56427666","46","46434634","AACCAGCCAGGCATGGTGATTCACACCTATAATCCCAGCTACTTAGGAGTATGGCTTGAGCACACAGGATACCATACCATTCTAGTCATCCCAGGCAACAGAGGGAAACTCTGTTGGTTAAAAAAAAAGAAAAACTTAAAAA","TTAGCCAGGAGTGGTGGTGCACGCCTATAATCCCAGCTACTTGGGAGGCTGAGGCACAAGAATCACTTGAACCATTGCACTCCAGCCAGGGTGATAGAGGGAGACTCTATCCAAAAAAAAAACAAAAAA"
"GL873589","9993319","9993452","chr3","2774534","2774668","28","7218785","GGCCTGAGCCCTGTGACTCATGCCTGTAATCCCAGCACTGGAAGTTCCAAGGCAGGTGGATCGCTTGAGCTCTGGAGTTCAAGACCAGCTCAACCAAGAGTAAGACCCCATCTCTACTAAAAATAGAAAAACCA","GGCTGGGCACGGTGGCTCATGCCTGTAATCCCAGCACTTTGAGAGGCCGAGGCAGGTGGATCTCCTGAGGTCAGGAGTTCAAGACCAGCCTGGGCAACATGGTGAAACCCCATCTCTACTAAAAATACAAAAAAT"
"GL873590","9044589","9044884","chr1","83754525","83754835","84","74709936","GGCCAGGTGCAATGGCTCATGCCTATAATCCTCACACTCTGGGAGGCTGAGGCAGGAGGATCACTTTTCTCAGGGTCAGGGCCAGCCTGACAAAAGTCAGACCCTGTTTCTACTAAAAATAGAAAAACTAGCTGGGTGTTGTGGCAGATGCCTATAGTCCCAGCTACTAAGAGACTGAGACAAGTGCCCAGAGTCTGAGGTTACTGTGAGCAAAGCTGATGCCATAGCATTCTAGCTATAGATCGAGAGTCTGTCTCAAAAACAAACAAACAAACAAACAAACAAACAAAAAAGAA","GGCTGGGTGTGGTGGCTCATGCCTGTAATCCCAGCACTTTGGGAGGCCGAGGCGGGTGGATCATCTGAGGTCAGGAGTTCAAGACCAGCCTGACCAACATGGTGTAACCCTGTCTCAACTAAAAATACAAAAATTAGCTGGGCGTGGTGGTGTGCACCTATAGTCACAGCTACTTGGGAGGCTGAGACAGGAGAATTGCTTCAACCCAGGAAGTGGAGGTTGCAGTGAGCCAAGATCATGTCACTGCACTGCAGCCTGACAGAGCGAGACTCCATCTAAAACAAACAAACAAAAACAAACAAACAAACAAA"
"GL873591","1831505","1831587","chr17","61702818","61702899","25","59871313","CCCAGCACTTTGGGAGGGCAAGATGGGAGAATCATATAAAGTCAGGAGTTTGAGACCAGTTTGGCAGACATGATGAACCCATC","AATCCCAGCACTTTGGGAGGCTGAGGCAGGCGGATCATCTGAGGTCAGGAGTTCAAGACCAGCCTGGCCAACATGGTGAAAC"
"GL873591","2719175","2719275","chr4","86137755","86137847","32","83418580","GTGGGGGCTTAGGCCTGTAATCCCAGCACTCTGAGAGGCCAAGGTGAGCTGGTCACCTGGGTTTAGGAGTTTGGAGACTTGCTCGAGCTAGACTGAGGCTC","GTGGTGGCTCACGCCTGTAACCCTAACAATTTGGGAGGCCAAGGCAGGTGGATCACTTGAGGTCAGAAGTTTGAGACCAGCCTGGACAATATG"
"GL873591","4732974","4733120","chr19","7991801","7991954","55","3258827","ATACGCAGACTGGCCGAGCGTGGTGTCACATGCCTATAATCCCAGTGGCTACTCTGGGGAGGAGAATCTCTTGAAACCAAGAGTTAGAGATTGCAGTGGGGTATGATACAGGGTAACAAAGAGAGACCTTGGATCTGAAAAGAAAAA","AAAATACAGAAACTAGCTGGGCATGGTGATGCACACCTGTAATCCTAGCTACTGGGGAGGCTGAGGCAGGAGAATTGCTTGAACCCAGGAGTCAGAGGTTGCAGTGAGCAACCAGCCTGGGTGATACAGTGAGTGAGACTCTGTCTCGAAAAAA"
"GL873591","6822728","6823009","chr1","20579766","20580052","72","13757038","GGCCAGGCGTGGTGGCTCATGCCTGTAAATCTCAGCACTCTGGGAAGCTGAGGCAGGTGGATTGCTTGAGGTCAGGAGTTTGAGACCAGCCTGTACCAGAGTAAGACCCTGTCTCTAATAAAAATAGAAAAAAAAAAAAAAACTAGTTGGGCATGGTGATGGGTGCCTGTAGTCCCACCTACTTGGGAGGCTGAGGCAATGGCATCTCTTGAGCCCAAGAGTTTGAGGTTGCTGTGCCATGGCACTCTCCCCAGGGTAACAGAGTGAAAATAAAAAAAAGAA","GGCCAGGCGTGGTGACTCATGCCTGTAATCTCAGCACTTTGGGAGGCCGAGGCAGGTGAATCACCTGAGGTCAGGAGTTTGAGACCAGCCTGACCAACATGGTGAAACCTCGTCTCTACTAAAAATACAAAAAGTAGCCAGGCATGGTGGCGCATGCCTGTAATCCCAGCTACTTGGGAGGCTGAGGCAGGAGAATCGCTTGAACCCGAGAGGCAGAGGTTGCATTGAGTCAAGATGGTACCACTGCACTCCAGCCTGGGTGACAGATTGAGACTCAAAAAAAAAAA"
"GL873591","7578706","7578813","chr16","45055441","45055543","42","37476735","AAATTTAGCTACACATAGTGGCATGAGTCTGTAATGCTAGCCACCCAAAAGGCTGTAGTAAGAGGATTGCTCTATCCCAGGAGTTAAAGACCAGCCCGGACATCAGAG","AATTAGCCGGGCGTGGTGACACACACTTGTAATCCTAGATACTCAGGAGGCGAAGGTAGGAGAATTGCTTGAACCCAGGCAGCAGAGGTTGCAACGAGCAGAG"
"GL873591","9282916","9283004","chr1","20744253","20744338","16","11461337","GGCCAGGCGCGGTGGCTCACCCCTGTTGTCCCAGTTCTGTGGGAGGCCGAGGTGGGTGGATCACCTGTGCTCAGAGGTTTGAGACCAGC","GGCCAGGCACGGTGGCCACGCCTGTAATCCCAGCACTTTGGGAGGCCGAAGTGGGTGGATTACCTGAGGTCAAGAGTTTGAGACCA"
"GL873592","835155","835315","chr16","75654291","75654451","43","74819136","CTGGGTGTGGTGGCTCTTGTCTGCAATCTCAGTACACTGGGAGGCTGAGGCAGAAGGATTGCTCCAGCTCAGGAGTTTGAGGCCAGGCTGAGCTAGTGCAAAACCCCATCTCTACTAAAAAAAGAAGGAAAAAAAAAAGAAAAAGAAAAAAAATACGAGCT","CCAGGTGTGGTGACTCACGCCTGCAATCCCAGCACTCTGGGAGGCTGAGGTGGGTAGATTACCGGAGGTTAGGCGTTTGAGACCAGCCTGGCCAACATGGTGAAACCCCATCGCTACTAAAAAAAAAAAAAAAAAAAAAAAAAAAAAAAAAAAAAAAATTA"
"GL873592","835589","835765","chr1","66836166","66836336","48","66000577","ACAAAAAACCTAGCTTAGGGTTGTTATAGCACCTGTAGTCCCAGCTACTCAGGCGCTAAGGCAGGAAAATCTGCCTGAGCTCAGGAGTTTGAGGTTGCAGTAAGTTATGATGATGCTACTGCACTCTAGCTGGGGCAACAGAGTGAGACTCTGTCTGAGGAAAAACCAAAACCAAAA","TAGCCCAGCACGGTGGCTCACACCTGTAGTCTCAGCTACTCAAGAGGCTGAGGCATGAGAATCGCTTGAACCCAGGAGGTAGAGGTTGCAGTGAGCTGAGATCATGCCACTGCGCTCCAGCCTGGGCAACAGAGTGAGACTCAGTCTCAAAAAACAAAACAAAACAAAAAA"
"GL873592","2520661","2520705","chr16","66853217","66853257","11","64332556","TCTGGGAGGCTGAGGCGGGTGGATCACCTGAGCAAGAGTGAGACC","TTTGGGAGGCTGAGGCAGGTGGATCACTTGAGGTCAGGAGT"
"GL873592","4535248","4535388","chr1","12240468","12240612","38","7705220","GGCGGGATGTGGTGGTTCATGGCTGTAATCCCAGCACTCAGGGAGGCTGAGTCGGGTGGATTGCTTGAGTTCAGGAGTTTGAGACCAACCTGAGCAAGAACTAAGCCTGTCTCTACTAAAGATATTATTTCTTATTTTTCT","GGCCGGGCGCGGTGGCTCATGCCTGTAATCCCAGCACTTTGGGAGGCTGAGGCGGGTGGATCACCTGCGGTCAGGAGTTCGAGACCAGCCTGGCCAACGTGGTGAAACCTCATCTCTACTAAAAATATAAAAATTAGCTGGTGTG"
"GL873592","4535654","4535831","chr8","126054004","126054184","54","121518350","TCTACTACAAATATTAACAGAAAAATTAGCTGGGCATTGTGACAGGTGCCTATAGTCCCAGATACTCAGAAGGCTGAAGTAAGAGGATCACTTGAACCCCAGGAGCTAAGGTGGCTGTGAGCTAGGCTGAGGCTCTAGCCTGGGTAACAGAGTGAGACTGTAAAAAAAGAAAGAGAGA","GTCTCTACTAAAAATACAAAAATTAGCTGGGTGTGGTGGTGCATGCCTGTAATCCCAGCTACTCAGGAGGCTGAGGCAGGAGAATCGCTTGAACCCAGGAGGTAGAGGTTGCAGTGAGCCAAGATCATGCCACTGCACTCCAGCCTGGGTGACAGAGGGAGACTCTGTCTCAATAAATAAA"
"GL873592","6794968","6795049","chr3","154764711","154764794","20","147969743","GAAGGTTTGATGAGCTCAGATGATGCCACTGCAGTCTACCCAGAGTGAAGGAGCGAGACTCTGTCTCAAAAACAAAAAAAGA","CAGAGGTTGGCAGTGAGCTGAGACTGTGCCACTGCACTCCAGCCGGGTGACAGAGTGAGACTCTGTCTCAAATTACAAACAAAA"
"GL873592","6881384","6881478","chr5","24882384","24882475","28","18001000","GGGCAGGCATAGTGACTGGTGTCTCTAATCCTAGCAGTCTGGGATGCTGAGGCAAGTGGAATGTCAGAGTTCAGGAGTTGAAGATCACCCTGACT","GGCCGGGCGCAGTGGCTCACATCTATAATCCTAGCATTTTGGGAGGCTGAGGCAGGCGGATCACCTGAAGTCAGGAGTTTAAGACCAGCCTG"
"GL873592","6881755","6881937","chr10","61601371","61601572","66","54719616","TCACCCTGACCAAGAGCAAGACCCTGTCTCTACTAAAAATAGAATAAACTAGCTGGGAATTGTGGTGGGTGCCAGTAGTCCCCGCTACTGAGGCAGGAGGATCATTGAGTCCAAGAGTTTGAGGTTGCTGTAAGTTAGGACACCACAGCACTCTACACAGAGTAAGACTGCCTCAAAAATAAA","AGTAAAGAAAAGAAACCCTGTCTCTACTAAAAATACAAAAATTAGCTGGGTGTGGTGGTGCGCACCTGTAGTCCCAGCTACTTGGGAGGGTGAGGTATGGGAATCACTTGAACCCGGGAGGTGGAGGTTGCAGTGAGCCAAGATCACACCACTGCACTCCAGCCTGGGTGAGAGAGTGAGACTCTGTCTCAAGAAAAAAGAA"
"GL873592","7006080","7006155","chr1","8947061","8947129","24","1940981","CACACTGAGAGGCAAAGGCTGGTGGATCACCTGAGCTCAAGAGTTTGAGACCAGCCAAGCCAGAGATCTTGTCTCT","CACTTTGGAGCCAGGTAGGTGATCACCTGAGTCAGGAGTTCGAGACAGCCTGGCCAACATGTGAAACCC"
"GL873592","8446508","8446655","chr11","122502739","122502874","48","114056231","TTAGCTGGGTGTTGTGGCAGGCACCTGTAGTCCCTCCCAGCTACTTGAAAGGCTGAGGCAAGATGACAGCTTAAACCCAAGAGTTTAAGGTTACTCTATTCAGGGCAACAGAGTGAGACTCCATCTACATAAATAAATAAATAAATAA","GGCTGGGCGTGGTGGTTCACACCTGTAATCCCAACACTTTGGGAGGCTGAGGCCAGCGGATTGCCTGAGCCCAGGAGTTTGAGACCAACCTGGGCAACATGGTGAAACTCCATCTCTACTAAAATACAAAAAGTTA"
"GL873592","8446953","8447008","chr16","44513352","44513404","15","36066399","GACCAGCCTAAGCAAAAAAGAGATCCTATCTCTACTACTAAAAATAGAAAAAATTA","ACCAGCCTCACCAATATGAAGAAACCCCATCTCTACTAAAAATACAAAATATT"
"GL873592","8447239","8447325","chr1","8062863","8062957","21","384376","GGCCAGGAGCAGTGACTCATGCCTAGCACTCTGGGAGGCCAAAGCAGGTGGATCAACTGAGCTCAGGAGTTCAAGACCAGCCTAAGC","GGCCGGGTGCAGTGGCTCATGCCTGTAGTCCCAGGACTTTGGCAGGCCAAGGCCGGTGGATTACCTGAGGTCAGGAGTTCAAAACCAGCCTAGCC"
"GL873592","8723925","8724000","chr3","42066983","42067054","20","33343058","AATTAGCCGGGCATGGTAGTGTGTGCCCATAATCTCAGCTACTCAGAAAGCTAAGATAGGAAAATTGCTTGAGCTC","TTAGCTGGGTGTGGTAGTGCATGCCTATAATCCCAGCTACTCGGGAGGCTGAGGTGGGAGAACTGCTTGAAC"
"GL873593","384022","384146","chr15","102382935","102383070","28","101998913","GGCCACGAGGGCCCATGCCTGTAATCCTAGCACTCTGGGAGGCTGAGGTGAGTAGATTGCTGAGCTCAGGAGTTCAAGACCAGCCTGTGCAAGAGACCCCATCTCTGCTAAAAATAGAAAAACCA","GGCCAGGTGTGGTGGCTCACGCCTGTAATCCTAGCACTTTGGGAGGCTGAGGCGGGTGGATTGCCTGAACTCAGGAGGTCAAGACCAGCCTGGGCAACACAGTAAAACCCCATCTCTACTAAAATACAAAAAATCA"
"GL873593","384425","384607","chr20","28286874","28287058","50","27902449","GAAAGAAAAGAAAAGAAAAACTAGCAAGATGTTGTAGCTGATGCCTATAATCCTAGCTATTGGAGAGGTGGAGGCAAGAGAATTGCGTGAGCCCAAGAGTTGAAGGTTGCTGTGAGCTGCGATGCCAGAGCACTCCAGGGTGACAGAGTAAGACTCTGTCTCAAAAAAAATTACAAAATAAAA","TAATAAAAATAAAAAAATTAGCCAGGAGTCAAAGCACACGCCTATAACCCCAGCTACTTGGGAGGCTGAGGGAGGAGAATTACTTGAACCCGGGAGGTGAAAGTTGCAATGAGCTGAGATCAAGCCACTGCACTCCAGACTGGATGACAGAGTGAGACTCTGTTTCAAAAAAAAAAAAAAGACAA"
"GL873593","1408445","1408467","chr10","88070368","88070389","9","86661923","AATCTAGAGATGGGGAGAGGTTG","AAAGAGATGGAAGAGAAGAAGA"
"GL873593","4856365","4856484","chr7","56497314","56497433","31","51640949","GCAATCCCAGCTGATCGGGAGGCTGACCCAGAAGAATCCCTTGAACCCAAGAGTCTGAGGTTGCTATGGGTGGATTCTACAGCACTCTAGCCTGGGAGACAGAGTGAGACTCTGTCCCAA","ATCCCAGCTACTTGGGAGGCTGAGACAGAAGAATTGCTTGAACCCGGGAGGTGGAGGTTGCAGTGAGCCAAGATTGTACCACTGCACTCCAGCCTGGCAACAGAGTGAGACTCTGTCTCA"
"GL873593","6661298","6661485","chr10","86749316","86749514","55","80088018","GCAGAGGCTCACATATGTAATCCTAGCACTCTGGGAGGATAAGGCAGGTGGACAGCTTGAGCTCAGGGGTTTGACCAGTCTGATCAAGAGCAAGACCTGTGTCTACTAAAAATAGAAAACCTAGCCAGGTATGATGGTAGATGCCTGTATTCCTAGCTACTCTGGAAGCTAAAGCTAAAGAGTTTGAA","GGTGGCTCACACCTGTAATCTTAGCAATTTGGGAGGCCGAGGTGGGTGGATCACTTGAGGTCAGGAGTTTGAGACCAGACTGGCCAACATGGTGAAACTCTGTCTCTACTAAAAATACAAAAATTAGCCAGTCATGGTGGTGCATGCCTGTAATCCCAGCTACTCAGGAAGCTTAGGCAGGAGAATCACTTGAACCCAG"
"GL873593","6710263","6710446","chr14","4390080","4390244","66","2320183","TTGAAGTCAGGAGTTTAAGGCCAGTCTGGGCAACATAGTGAGACCCCCATCTCTACGAAAATATTTTTTAAAAATTAAAAATAGCTGGGCATAGTGAGGCTGTTGTGAGCTATAACTGCACCACTGCACTCAGCCAAGGACAGAGACCCTGTTCCCTGCCTCAAACAAACCAAAACAAAACAAA","AAGTCTAGAGTTTACAGCCTGGACAACGCAGTGAAACCCTGTCTCTACCAAAAATACAAAAATTAGACAGGTGTGAGAGGCGGAGGTTGCAATGAGCTGAGATCGCAGCACTGCAGTCCAGCCTGGATGACAGAGCGAGACCCCATCTCAAAAACAAAAACAAAA"
"GL873593","7159645","7159716","chr6","178318394","178318465","21","171158749","GATCATGTCACTGCTCTCCAACCTGGGCAATTGAGCAGGAATCTGTCTCAAAAAGAAAAAAAAAAAAGAAAA","CGAGTTCACACCACTGCACCCCAGCCTGGGCAACAGAATGAGACTCGGTTTCAAAAAAAAAAAAAAAAAAAA"
"GL873593","7159841","7160050","chr13","33368171","33368368","69","26208330","GGCCAGGCGTGGTGGCTCACACCTGTTGTCCCAGTGCTGTGGGAAGCCGAGGCAGGTGGATCACCTGAGCTCAGCCGAGTTCGAGACCAGTGGAAGACCAGCATGAGGCAGAGTGAGCCAGAGTGAGACCCCATCTCTACAACAACAACAAGAAGAAAAAAAACAGCCGGACCTTGTGATCCCAGCTACGTGGGGAGCTAGAGAATCACT","GGCTAGGCATGGTGGCTCATGCCAGTAATCCCACCACTTTGGGAGGCCGAGGCAGGTGGATCACCTGAGGTCAGGAGTTCAAGACCAGGCTGGCCAACATGTTATGATGAGACCCTCATCTCTACTACAAATACAAAAATCAGCTGGGCATGGTGGCAAGTGCCTGTAATCCCAGCTACTTGGGAGGCTGAGGCAGAA"
"GL873593","8598292","8598391","chr11","118461023","118461129","33","109862731","AGCCAGGTGAGGTGGTTCACACCTGTAACCCTAGCTGCTTGGGAGGCTGAGGCCTCTCTATCCTGGGCAGTGTGGAGAAACTTTGTTTCAAAAAAAAGAA","GCCGGGCGCGGTGGCTCACGTCTGTAATCCCAGCGCTTTGGGAAGCCGAGGCGGGACTATCCTGGCCAACATGGTGAAACCCCGTCTCTACTAAAAATACAAGAATC"
"GL873594","357249","357377","chr2","75702890","75703011","36","75345641","CCTGGTACCGTAGGTCATGCCTGTAATCCTAGCACTTTGGGATGCTGAGGTGGGCAGATTGCCTGAGCTCACGAGTTCAAGCCATTAGAACTGAGCCTGACCTAGAGTGGGACCTCCAACTCTTTTTTT","GCCAGGCACAGTGGCTCATGCCTGTAATCCCAGCAGTTTGGGAGGCTGAGGTGGGCAGATCACTTGAGGTCAGGAGTTCAAGACCAGCCTGGCTGACATGGTGAAACCCCATCTATACCAAA"
"GL873594","357656","357834","chr7","17608776","17608965","55","17251120","GGGACCTCCAACTCTTAAAATAGCTGGGCATTGTGGTGGGCACCTACAGTCACAGCTACTTGGGAGGCTAAGGCAAGAGACTTGTTTGCAGCCAAGAGTTAGAGGTTGCTGTGAGCTATGAGGCTAGGGCACTCTACAGGGGGCGACAAGTGAGACTGTAAAAAAAAAAAAAGAAAAAA","GTCCCTACTAAAAATACAAAAAATTAGCTGGGCCTGGTGGCAGGCACCTGTAATCCCAGCTACTTGGGAAGCTGAGGCAAGAGAATTGCTTGAACCCAGGAGGCAGAGGTTGCAGTGAGCTGACATCAAGCCACTGTACTCCAGCCTAGGCAACAAGAGCAAGACTCTGTCTCAAAAAAAAAAAAAAAAA"
"GL873594","1410711","1410996","chr5","151340503","151340797","76","149929792","CACAGTGGCTCATACCTATAATCCTAACACTCTGGGAGGCCAAGGTGGGTGGACTGTCTGAGTTTGGGACCAGCCTGAGCAAAAGCAAGACTCCCATCTCTACTAAAAACAAAGACAGCCAGGTATGAGGGCAGGTGCCTATCATCCCAGCTACTTGGGAGGCTGAGGAAGGAGGATCACCTAAGCCCAGGACTTTAAGGTTTCTGTGAACTAAGATGATGTTACAACACTCTAGCCAGGGTAACAAGGCAAGATTCTGTTTCAAAAGACAAAAAAAAAAAAAAAA","GGTGGTTCATGCCTGTAATCCCAGCACTTTGGGAGGCTGAGGCAGGTGGATCACCTGAGGTCAGGAGTTCGGGACCAGCCTGGCCAACATGGGGAAACCCCATCTCTACTAAAATACAAAAATTAGCCAGGTATGGTGGCACATGCCTATAATCCCAGCTACTTGGGAGGCTGAGGCAGGAGAATCACTTGAACCCAGGAGGCTAAGGTTGCAGTGAGCCGAGATTGTGCCACTGTACTCCAGCCTGGGTGACAGACTGAAACTCTGTGTCCAAAAAACAAAACAAAACAAAAAA"
"GL873594","5528090","5528162","chr2","69013639","69013718","24","63485549","GGTACAGTGGCTCACGCTTGTGATCCCAGGTTGAGGTGGGTGGATCGCCTGAGCTCAGGAGTTGGATGCCAGC","GGTGTGGTGCCTCACGCCTATAATCCCAGCACTTTGGGAGGCAGGTGGATCACTTGAGGTCAGGAGTTTGAGAACAGCCT"
"GL873594","5834047","5834168","chr2","82491537","82491662","28","76657490","GGCTGGGCCCAGTAGCTCACGACTGTAATCCCAGCACTCTGGGAAGCTGAGGTGGGCGGATCACCTGAGCTCATAGGTTCGAGACCAGCTCCAGTTAGAGTGAGAGCCTGTCTCTAAAAATA","GGCTGGGCACAGTGGCTCATGCCTGCAATCCCAGCACTTTGGGAGGCTGAGGTGGGCAGATCACCTGAAGTCAGGAGTTCAAGACCAGCCTGGCCAACACAGTGAAACCCCATCTCTACTAAAAAT"
"GL873594","5834396","5834461","chr13","14688151","14688212","20","8853755","TATATAATAATAATAACCAGGTATTGTGGCAGGTGCCTCTAGTCCCAGCTACTCGGGAGGCAAAGG","ATAAAAAAATTAGCTGGCCATGGTGGCACATACCAATAATCCCAGCTACTCAGGAGGCTGAG"
"GL873594","7786130","7786294","chr14","12217087","12217250","37","4430957","GGGTGTGCTGGCTCATACCTATAATCCTAGCACTCTGGGAGGCTGAGGTAGGTGTATTGCTTGAACCCAGGAGTCTGAGGTTGCTGTGCGCTAAGCTGATACCATAGCACTCTAGCCTGGGCAACAGAGTGAGACTCTGTCTCAAAACAAATAAATAGTAAAAAA","GCTGGGCGTGGTGGCTCACACCTGTAATCCCAGCACTTTGGGAGGCCAAGGCATGAGAATTGCTTGAAAACAGGAGGCGGAGGTTGCAGTAAGCTGAGACTGTGCCATTGCACTCCAGCCTGGGCAACAAGAGTGAAACTCTGTCTCAGAAAAAAAGAAAAAAA"
"GL873595","723579","723774","chr19","6045933","6046125","65","5322354","GCCTGAGCAGGAGAGAGACCCCATCTCTGCTGAAAGTGGAAAAGTTGGCTGAGTGTAGTGGCGGGCTGCTGCCCCAGTCACTCAGGAGGCTTAGGAAGGAGTATCGCTTGGGCCCAAGATTTGAGGTTGCTGTGAGCGCTACAAAGACATTAGGGTACTCTACACAGGGGAATAGAGTGAGACTGTCTCAAAAAAA","CAACATGGAGAAACCCCGTCTCTACTAAAAATACAAAATTAGGCAGCGTGGTGGTGGGTGCCTATAATCCCAGCTACTCAGGAGGCTGAGGCAGGAGAATCGCTTGACCGGGAGTGGAGGTTGCGGTGAGCTGAGATTGCACCATTGCACTCCAGCCTGGGCAACAAGAGTGAAACTCCGTCTCAAAAAGAAA"
"GL873595","724114","724204","chr20","18199749","18199840","22","17475635","GGCCATGCTTGGTGGTTCTCATCTGTAATCCTAGCACTCTGGAAGGTCTACAGGGGTGGATGGCTGGAGGTCAGGAGTTCAAGACTGGCCT","GGCCGGGCATGGTGGCTCACACCTGTAATCCCAGCACTTTGGGAGGCTGAGGCAGGCGGATCACCTGAGGTCAGGAGTTCGAGACCGGCCTG"
"GL873595","1065346","1065667","chr18","10529729","10530057","74","9464383","GGCCAGGTGCAGCAGCTCATGCCTGGAATCTTCCTGCTCTGTATGGCCAAGGCAGGTGGATCGCCTGACCTCAGGAGTTCCAGACCAGCCTGAACAAGAGCAAGACTCTGTCTCTACTAAAAGTAGAAAAAAAACTAGCCAGTCATAGTGGCAGGTGCCTGTAGTCCCAGCTGCTTGGGAGGCTGAGGCAAGAGGATCACTTGAACCTAAGAGTTTGAGGTTGCTGTGAGCTAAGATGCCACATCACTCTATCAAGGGTGACCAAGTGAGACTCTGTCTCAAAAATAAATAAATAAATAAATAAAAAGAAAGGCAAAAAGAA","GGCCCGGCGTGGTGGCTCATGCCTATAATCCCAGCCCTTTGGGAGGCCAAGGCAGGTGGATCACCTGAGGTCAGGCGTTCGAGACCAGCCTGACCAACGTGGTGAAACCTCATCTCTACTAAATACAAAAAAAATTTAGCCAGGCATGGAGGCACATGCCTGTAATCCCAGCTACTTGGGAGGCTGTGGCAGGAGAATCACTTGAACCTGGGAGGTGGAAGTTGCAGTGAGCTGAGATTGTACCACTGCACTCCAACCTGGGTGACAAAGCAAGACTCGGTCTCAATAAATAAATAAATAAATAAATAAATAAATAAAGTGAAAAAAAA"
"GL873595","1254878","1255146","chr4","42822326","42822607","67","41567448","GGCTGGGCATGGTGGCTCATGCCTGTAATCCTACCGCTCTGGGAGGCTGAGGCAGAGGATCACTTGAGCTCAGGAGTTTCAGACCAGCCTGCAAGAAGGACCCAGTCTCTGCCGAAAATAGAAAAGTTAGCAAGGCGTTGTCGTGAGCACATGTATCCCAGCTACCTAGAACTCTGAGGCAGGAGGATCCCTTGAACCCACAGAAGTTGCTGTTATCTAAACTGATGCCACTGGACTCTAGCCTGGGCAACAGAGTGAGACTGGTCTCA","GGCCGGGCACGGTGGCTCATGCCTGTAATCCTAGCATTTTGGGAGGCTGAGACAGGCAGATTGCCTGAGCTCAGGAGTTCAAGACCAGCCTGGGCTAGATTGTGAAACCCCATCTCTACTAAAATATAAAAATTAGCTGGGTGTGGTGGCACACGCCTGTAATCCCAGCTACCTGGGAGGCTGAGGCAGGAGAATCGCTTGAACCAGGAGACAGAGGTTGCAGTGAGCTGAGATCACGCCACTGCACTTTAGCCTGGGCAACAGAGTGATACTCTGTCTCAA"
"GL873595","3417105","3417297","chr12","115674238","115674427","44","112257133","GGCCGGGCGCTGTGCCTCACGCCTGTAATCCTAATACTCTGAGAGGCCGAGGCAGGTGGATTGCCTGAGCTCAGGTGCTCAAGACAGCCTGACTGAGCAAGCCCTGAGATCCCATCTCCACTAACAATAGTAAAACTAGCCGGGCATTGTGGTGGTGCTTGTAATCCCAGCTACTGGGAGGCTAAGACAGGAG","CCAGGCCTGGTGGCTCACGCCTGTAATCCCAGCACTTTGGGAGGCCGAGGTGGGTAGATCACCTGAGGTCAGGAGTTCAAGACCAGCCTGGCCAACATGGCGAAACCCCATCTCTACTAAAAATACAAAAATTAGCTGGGCATGGTGGTGTATGCCTGTAATCCCAGCTACTCGGGAGGCTGAGGCAGGA"
"GL873595","6098380","6098457","chr3","87492619","87492702","21","81394239","GCTGTGGCTCATGCTGATAATACCAGCACTCTGGGAGAACAAGGTAGGCAGATCACAAGAGGTCACCTGTGCAAGACC","GGGCTGGTGGTGGCTCATGCCTGTAATACCAGCACTTTGGGAGGCCAAGACAGGTGGATCACCAAAGGTCAAGAGTTCAAGACC"
"GL873596","134190","134307","chr1","203207333","203207443","31","203073143","GGCTGGGCGAGGTGGCTCACACCTGTAATCCTAGCACTCTGGAAGGCCCTAGCACTCAGGCAGTTGGATTGCCTGAGCTCACAAGTTCAAGACCAGCCTGAAAAAGAGCAAGACCTCA","GGCTGGGTGCAGTGGCTCACACCTGTAATCCCAGCACTTTGGGAGGCCGAGATGGGTGGATCACTTGAGGTCAAGAGTTGAAGACCAGCCTGGACAACATGATGAGACCCC"
"GL873596","134578","134681","chr11","50235285","50235387","37","50100707","CAAACAAAAGAGGAAGACCTCGTCTCTAAAAAAATAGCTGGGCATTGTGAGGAGTACCTGTAGTCCTAGCTACTCAGAAGGCTGAGACAAGAGAATCACTTAAA","CAACATTGTGAAACCCTGTCTCTACTAAAATAGAAAATTAGCCAGGTGTGTGGGCGTGCCTATAATCCTAGCTACTGGGGAGGGTGAGGCATGAGAATCGCCT"
"GL873596","8160215","8160350","chr1","29437872","29437991","30","21277657","GGCCGGGCGTGGTGGCGCACACCTGTAGTCCCAGCGCTATGGGAGGCCGAGGCGGGTGGATCACCTGAGCTCAGAGGTTCGAGACCAGCCAAGACCCCCCTGAGCCAAACGAGCCAGAGTGAGACCCCGTCTCTAC","GGCCGGGCGTGGTGGCTCACGCCTGTAATCCCAACATTTTGGGAGGCCAAGGCGGGTGGATCACCTGAGGTCAGAAGTTCGAGACCAACCTGGCCAACATGGTGAAACCCCTGTCTCTAC"
"GL873596","8421071","8421132","chr20","1874027","1874093","12","6547044","GTCAGGCGCAGTGGCTCACGCCTGTAATCTCAGCACTCTGAGAAGCCAAGGCAGGATCATCT","GGCCAGGCGCAGTGGCTCAGGCCTGTAATCCCAGCACTTTGGGAAGCCAAGGTGAGCAGATCACCTG"
"GL873598","4416400","4416489","chr5","39418145","39418231","15","35001745","GGCCAAGTGTGGTGGCTCATGCCTGTTGTCCCAGCACCGTGGGAGGCCGAGGCTGGTGGAACACCTGAGCTCAGCTGAGTTTGAGACCAG","GGCCAGTTGCGGTGGCTCATGCCTGTAATCCCAGCACTTTGGCAGGCTGAGGCAGGTGGATCACCTGAGGTCAGGAGTTTGAGACCA"
"GL873598","4416855","4416947","chr3","94091253","94091337","31","89674398","GTGAGACCCTGTCTCTACAAAAAAAAAAGCTGGGCACTGTGGCATGTGCCTGTAATCCCAGCTACTTGGGAGGCAAAGGGAAAGAGAATCACT","AAACCTTGCCTTTACTAGAAATACAAAAATTAGCTGGGCATGGTGGCAGGTACCTGTAATCCCAGCTACTTGGGAGGCTGAGGCA"
"GL873598","5126074","5126161","chr1","12339306","12339394","19","7213232","GCCTGGTGCACTGGTTCACACCTGGAATCCTTGCATTCTGAGAGGCCCAGGTAGGCAGATCACCTCAGCTCAGAAGTTCGAGACCAGC","GCTGGGTGCGGTGGTTCACGTCTGTAATCCCAGCACTTTGGGAGGCCGAGGCGGGCAGATCACCTGAGGTCAGGAGTTCGAGACCAGCC"
"GL873598","5467584","5467662","chr1","9313328","9313403","17","3845744","GCGAGGTGGCTCACGCCTGTAATCCCAGCACATTTGGAAGGCCAAGGAGGGTGGATCACCCGAGCTCACCAGTTGGAGA","CGCAGTGGCTCACGCCTGTAATCCCAGCACTTTGGGAGGCCGAGGCAGGCAGATCACCTGAAGTCAGGAGTTTGAG"
"GL873598","6917752","6917856","chr14","9558287","9558382","22","2640535","GGCCAGGCATGGTGGCTTGTGCCTGTTGTCCCAGCACTGTGGAAGGCCGAGGCGGGTGGATCGCCTGAGCTCAGCTGAATTCGAGACCAGCATAAGACCAGTATG","GGCCAGGCATGGTGGCTTATGCCTGTAATCCCAGCACCTTGGAAGGCCGAAGCGGGCAGATCACCTGAGCTCAGGAGTTTGAGACCAGCCTGTCCA"
"GL873598","8078910","8079062","chr7","164825511","164825660","43","156746601","AACAGCCAGGCATTGTGGTGGGCACCTGTAATCCCAGCTACTTGGGAGGCTGAGGCAAGAGAATTGCTTGAGCCCAACAGTCTCAGGTTACTGTGAGTTATGACACCATGGCACTCTATTGAGGGCAAGAAAGTGAGACTGTCTTGGAAAAAA","CTAGCCAGGCATGGTGGTGCGCACCTGTAGTCCCAGTTACTTGGGAGGTTGAGGCAAGAGAATTGCTTGAGCCTGGAAGGCAGAAGTTGCAGTGAGCTGAGATCACACCACTGCATTCCAGCCTGGGCGAAAGAGCAAGACTCTGTTGAA"
"GL873598","8079328","8079454","chr6","10381248","10381379","32","2301920","GCCCGGCGTGGTGGCTCACGCCTGTAATTCCAGCACTCTGGGGAGGCCGAGGAGGGCAGATTGCCTGAGCTCACAGGTTTGAGCTAGAGCGAGACCCTGTCTCTTAAAAAGAAAAAAAAGGAAAGAA","GCTGGGCGCGGTGGCTCACGCCTGTAATCCCAACACTTTGGGAGGCCGAGGCGGGCAGATCACCAGAGGTGATCTCCAGCCTGGGCAGGAGAGCAAGACCCTGTCTCAAAAAATTTAGAAAAAGGAAAGAAA"
"GL873599","3943256","3943456","chr9","35892110","35892312","79","31948854","GGCAGGCTGCTTTGACCCATATCTACAACTCCAGAACTTTAGAGGCTGAGCTGGGTGGGTCCCTTGAGATTAGAAACTGCTTAGTAGCCTGGCAAAAACCAGACCCCACCTCCACCATGTAGAAAAATTAGCAGTATGCCATAGTGGGAACCTACCAATACAGTCTTTCCAAAGGCCAAAGCTAGAAGGACCGTGAGCTTG","GGCTGGGTGTGGTGGCTCATGCCTATAATTCCAGCACTTTGGGAGGCCGAGGCAGGTGGATCACCTGAGGCCAGGAGTTTGAGACCAGCCTGGCCAATATGGTGAAACCCCATCTCTACTAAAAGTACAGAAAATTAGTCAGTCATGATGGCGCATGCCTATAATCCCAGTTACTCGGGAGGCTAAGGTAGGAGAATTGCTTG"
"GL873599","6693284","6693349","chr1","100916857","100916922","15","94223573","TCACGTCTATAATCCTAGCACTCTGGGAGTCCTTGGCAGGTGGATCACCTGAGCTCAGGAGTTTGA","CATGCCTGTAATCCCAGCACCTTGGGAGGCCAAGGTGGGTGGATCACCTGAGGTCAGTAGTTTGAG"
"GL873600","991618","991705","chr15","13850109","13850195","15","12858491","GGCTGGGCGTGGTGGCTCACACCTGTTGTCCCAGCGCTGTGGGAGGCTGAGGCAGGTGGATCACCTGTGCTCAGAGGTTGAGACCAGC","GCCGGGCGCTGTGGCTCACACTTGTAATCCCAGCACTTTGGGAGGCTGAGGCAGGTGGATCACCTGAGGTCAGGAGTTAGAGACCAG"
"GL873600","8825981","8826014","chr16","43605817","43605844","11","34779836","AGTCTGGGGCAACAGAGCAAGACTCTGTCTCAAA","CAGTCTGGGTGACAGAGCAAGATTCCAT"
"GL873600","8826039","8826157","chr13","87428402","87428520","35","78602363","ATTAGCCTGGTGTGGTGGTATATGCCTTCCTGCCTGCTTGGGAGGCTGAGGCAGGAAGTATGCTTTAACTGTGGAGTCTGAGGTTGCTATGAGCTAGGTTGAGGCCATGGCACTCTAAA","TTAGCCGGGTGTGGTGGTGCACGCCTGTAATCCCAGCTACTCAGGAGGCTGAAGCAGGAGAGTTGCTTGAACCCAGGAGTTGGAGGTTGCAGTGAGCTGAGATCACGCCATTGCACTCC"
"GL873601","269289","269338","chr14","49279240","49279285","14","49009951","GACTGGGTGTGGTGGCTCACACCTTTAATCCTAACACCCTGGGAGGCTTA","GGCTGAGATGGTGGCACACACCTGTAATCCCAGCTACTTGGGAGGC"
"GL873601","269431","269678","chr1","184453273","184453521","76","184183842","AGAAGATCACTCAAGATCAGGAGTTTGAGAACAGCCTGAGCAAGACCCCCATCTTTACTAAAAATGGAAAAGTTTTTACCCAGGCATGGTAGTGCGTGCCTGTATCCCATCTACTCCGGAGGCTGATAGGAGGATTGCTTCAACCAAGGAGTTTGAGGTTCCAGAGACTTAAGATGACACAACTGCATTTTACCCAGTGTGACACAGCGAGACTCTTTCAGAAGAATTTTTAAAAGGAAAAAAAAGAA","GGTCAGATCACCTGAGGTCAGGAGTTTGAGACCAGCCTGACCAACATGGTAAAACCCCATCTCTGCTAAAAATACAAAAAATTAGCCAGGCATGGTGGTGAACGCCTGTAATCCTAGCTACTCAGGAGGCAAAGACAGGAGAATCGCTTGAATCTGGAAGGTGGAGGTTGCAATGAGCCAAGATGACGCCACTGCACTCCAACCTGGGTGACAGAGGAAGACTCCATCAAAAAAAAAAAAAAAAAAAAA"
"GL873601","1397978","1398117","chr16","24839455","24839591","34","23441477","GCCTATAATCCTAGCACTCTGGAAGGCTGAGGCAGGAAGATCACTAGAGCTTGGGAGTTTGAGATTGCTGTGAGGGAGACTGACTCCATGGCACTCTAGCCTGAGGCAACAGAGTAAGACTCCATCTCAAAAAAAAAAAA","CTCTAACTCCAGCTACTCAGGAGGCTGAAGCAGGAAAATCACTTGAACCTGGGAGGTGGAGGTTACAGTGAGCCAAGATCACACCATTGCACTCCAGCCTGAGCGACAGAGCGAGACTCTGTCTCAAAATAAATAAA"
"GL873601","4065502","4065590","chr11","108711352","108711444","19","104645850","GCTGGATGTGGTGGCTCTCACCTATAATCCTAGCACTCTGGGAGGTCAAAACAGGTGGATCACCTGAGCTCAGGAGCAAGAACACCAGC","GTCAGGGGTGGTGGCTCACGCCTGTAATCCCAGCACTTTGGGAGGCCAAGGCAGGTGGATCGCCTGAGCTCAGGAGTTCAAGACCAGCCTTGC"
"GL873601","8241370","8241465","chrY","9469734","9469829","34","1228364","AAAAAAGGTGGAGATGAGCCATGCGCAGTGGTGTAGGCCTGTAATCCCAGCCCTTGGGAGGCCAAAATGGTGGATTGCCTGAAGCAGAGCAAGACC","AAAGTACAAAGAGTCTGGGTACAGTGGCCCAAGCCTGTAATCCCAGCAGTTTGGGAGGACAAGATGGGTAGATCACCTGACATCATGAATTAGAGA"
"GL873569","7519122","7519191","chrX","79016364","79016431","16","71497242","TTGGCCAGGCATGGTCGCTCAGGCTGTAATACCAGCTACTTGGGAAGCTGAAGCAGGAGGATCACTTGAA","TTGGCCAGGCACGGTGGCTCATGCTTATAATCCCAGCTACTCGTGAGGCTGAGGCAGGGGAATCGCTT"
"GL873569","7989158","7989286","chr8","41505677","41505810","35","33516519","AGTCCCACCTATTTGGAAGGCTGAGGCAAGAGGATCACTTGAACTCAGCAGTTTGACATTGCTATGAGTTAGATTGACTCCATGGCACTCTAGCCCAGGCAACAGAGCAAGACTCCGTCTCAAAACAAA","TAATACCAGCTACGTGGGAGGCTGAGGCAGGAGAATCACTTGAACCCGGGAGGTGGAGGTTGCAGTGAGCTGAGATTGCACCGTTGCACTCTAACCTGGGCAACAAAAGCAAAACTCTGTCTCAAAAAAAAAAA"
"GL873569","7989575","7989702","chr1","62231025","62231129","47","54241450","GGCTGGGTAATGCAGTGGCTCACGCCTATAATCCTAGTGCTTTGAGAGGCCAAGAGTGAGACTCTGTGTACTAAAAATAGAAAAATTACCTAGGCATTCTGGTGGGCACCAGTAGTCCCACCTATTTG","GGCTGGGCATGGTGGCTCACGCCTATAATCCCAGCACTTTGGGAGGCCGAGGCAGGTGGATCACCTGAGATCAGGAGTTTGAGACCAGACTGGCCAACATGGTGA"
"GL873569","10034363","10034556","chr10","61268396","61268605","62","51234033","CAGCTTGAGCAAAAGTGAGCCCCTGTCTCTACTGAAAATAGAAAAAATTAGCCAGGCGTGGTGGCACACACTTATAGTCCCAGCCACTTAGGAGGCTGAGGCAGGAGTTTGAGGTTGACATAATCTAAGCTGATACCATAGCACTCTAGCCTGGGCAATAGAGTGAGACTCTGTCTCAAAGAAGAAATTTATCT","CCTGACCAATGGTGAAACCCTGTCTCTACCAAAAATACAAAATTTAGCTGGGCATGGGGGCACGCACCTGTAGTCCTAGCTACTCGGGAGGCTGAGACAGGAGAACTGCTTGAACTCGGGAGGCAGAGGTTGCAGTGAGCTGAGATCATGCCACTGCACTCTAGCCTGGGCAATAGAGTGAGACTCCGTCTCAAAAAAAAAAAAAAAAAA"
"GL873569","10034830","10034845","chr1","217667782","217667796","2","207632952","AAAAAAGAAGAAAAAA","AAGAAAAAGAAAAAA"
"GL873569","10203815","10203922","chr8","96374555","96374671","35","86170740","GCCAGGTGTAGTGGTTCACACCTATAATCCTAGCACTCTGGGAGCCTGAAGCAGGTAAATGGACTGAGCAAGAGTGAGACTTCCACCTCTATTGAAAATAGAAAAATT","GGCTAGGTATGGTGGCTGATGCCTATAATCCCAGAATTTTGGGAGGCCGAGGCAGGCAGATCATCTGAGGTCAGGAGTTTGAGACCAGTCCCGTCTCTACTAAAAATACAAAAATTA"
"GL873569","10204196","10204373","chr20","1304385","1304559","47","8899811","GAAAATAGAAAAATTAGCCAGGCATTATAGCAGGCACCAGTAATCCCAGTTACTTGGGAGGCTAAGGCAAAAGAATCTCTTGAGCCCAAGTTTGGGGTTGCTAGGAAGTAAAACACCACAGCACTATACCCAGAACAAGAGAGTGAAGACTCAGTCTCAAAAAGATAAATAAATAAAA","AAAAATACAAAAATTAGCCAGGCATGGTGGCGGGCGTCTGTAACTCCAGCTACTTGGGAGACTGAGGCAGGAGAATCGCTTGAACCCAGGAGGCAGAGGTTACAGGTGAAATCACACCACTGCACTCCAGCCTGGGCAACAGGGCAAGACTCTGTCTCAAAAAAAAAAAAAAAAA"
"GL873569","10473375","10473444","chr8","20660648","20660717","21","10187273","TGTAGTCCCAGCACTTTGGGAGGTTAAGGCAAGAGTAGCACCCAACATGAGGAGATCAAGACCAATCTGG","CTGTAGTCCCAGCACTTTGGGAGGCTGAGGCAGGTGGATCCTTTGAGGGCAGAACTTTAAGACCAGCCTG"
"GL873570","9287350","9287485","chr1","29437872","29437991","30","20150522","GGCCGGGCGTGGTGGCGCACGCCTGTAGTCCCAGCGCTATGGGAGGCCGAGGCGGGTGGATCACCTGTGCTCAGAGGTTCGAGACCAGCCAAGACCCCCCTGAGCCAAACGAGCCAGAGTGAGACCCCGTCTCTAC","GGCCGGGCGTGGTGGCTCACGCCTGTAATCCCAACATTTTGGGAGGCCAAGGCGGGTGGATCACCTGAGGTCAGAAGTTCGAGACCAACCTGGCCAACATGGTGAAACCCCTGTCTCTAC"
"GL873571","3669989","3670207","chr4","116777080","116777297","60","113107091","AGACCAGCCTGAGGAAGAGCAAGATCCCATCTCTATTAAAAATAGAAAAATTAGCCAGGCATTCTGGTGGGCACCTGTAGTTCTAACCACCTGGGAGGCTAAGGCAAGAGGAACTCTTCAACCCAAGAGTTTGAGGTTGCTGAGAGCTAGGCTAAGGCTGCAGCACTCTAGCCTGGGCAACAGAGTGAGACTGTTTCTCAAAAACAAAAAACAAAAAAA","CGAGACCAGCCTGGTCAATATGGTGAAACCCCGTCCCTACTAAAAATACAAAAATTAGCCAGGCATGGTGGCAGGCACCTGTAGTCCCAGCTACTCGGAAGGCTGAGGCAGGAGAATCGCTTGAACCACAGAGGCAGAGGTTGCAGTGAGCCGAGACTGCACCACTGCACTCCAGCCTGGGCGACAGAGTGAGACTCAGTCTCAAAAAAAAAAAAAAA"
"GL873571","106134","106236","chr4","18143723","18143826","27","18037589","GGCCAGTCTCAGTGGCTCACACCTGTAATCCAGCATTCTGGGAGGCTGAAGCACACGGTCACCTGAGCTCAAAGGTTGGAGACCAGAGTGAGACCCCACCTCT","GGCCAGGCGCAGTGGCTCACTCCTGTAATCCCAGCACTTTGAGGCTGAGGCAGGCGGATCACCTGAGGTCAGGAGTTTGAGACCAGCCTGGCCGAAACCCCATC"
"GL873571","3670496","3670589","chr7","50468399","50468491","15","46797903","GGGCAGGCATGGTGGCTCACACCTGTAATTCTAGCACTCTTGGAGGCTGAGGCAGGAAAATGGCTTGAGGTCAGGAGTTCAAGACCAGCCTGAG","GGCCAGTCATGGTTGCTCACACCTGTAATACCAGCACTTTGGGAGGCCGAGGCAGGCGAATCACCTGAAGTCAGGAGTTCAAGACCAGCCTGG"
"GL873571","4059090","4059389","chr7","52903696","52903994","88","48844606","GGCCAGGTGCAGTGGTTCACACTTATAATCCTAGCACTCTGGGAGGCCGAGGCGAGTGAAGTGCCTGAGCTCATGGGTTCAAGACCAACCTAAGCCAGAGACCCCTGACTCTTATAATAGCCTGGCATTGTGGTGGGCGCCAATATTTCCAGCTACTCTGAGGCTAAGGCAAGAGAATTGCTTGAGCCCAGGAGTTGGAGGTTTCTGTGAGCACTGACGCCGCAGCTCTCTACCAAGGGCAACAAAGACTCTGTCTCAAAAAATAAATAAATAAATAAATAACAGAATGAAAATGAAAAA","GGCCGGGTGCGGTGGTTCACGCCTGTAATCCCACCACTTTGGGAGGCTGAGGCAGGCAGGTCACCTGAGGTCAGGAGTTCCAGACCAGCCTGGCCAACATGGTGAAACCTTGTCTCGGCTATTAGCCTGGCATGGTGGTGCGTGCCCATAATCCCAGCTACTCAGGAGGCTGAGGCAGGAGAATCGCTTGAACCCAGAAGGTGGAGGTTGCAGTGAGCCAAGATAGCACCACTGCAACTCCAGTCTGGGCAACAGAATGAGACTCTGTCTCAAAAAAAAAAAACAAAAAACAAAAAGAA"
"GL873571","4209418","4209704","chr11","32517699","32517985","80","28308281","GGCTTGGCAAGGTGGCTTACACCTCAAATCCTAGCACTGTGGGAGACTGAGGCAGGTGGATTGTTTGAGCTCAGGAGGTCAAGATAGAGAGCAAGAGCAAGTCTCTGTCTCTACTAAAAATAGAAAAGAACTACTTCCCGGGGGTCATGGCAGTAGCCTGTAATCCCAGTTACTAGGTAGAATGAGGCAAGAGGATCTGTTGAAGCCAAGAGACTGAGGTTGTTATGAGCATGCCACAGCACTCTACCCAGGGTGACAGAATGAGACTCTGTTGAAAGAAAAAAAGA","GGCCGGGTGCAGTGGCTCACACCTGTAATCCCAGCACTTTGGGAGGCTGAGGCGGGTGGATCACCTGAGGTCAGGAGTTCAAGACCAGCCTGACAAACATAGTGAAACCCTGTCTCTACTGAAAATACAAAATTAGCCAGGTGTGGTGGCGCATGCCTGTAATCCCAGCTACTCGGGAGGCTGAGGCAGGAGAATTGCTTGAATCCAGGAGGTGGAGGTTGTGTGATCACACCACTGCACTCCAGCCTGGGCGACAGAGTGAGACTCTGTCTCAAAAAAAAAAGAAA"
"GL873571","4209985","4210154","chr3","175781758","175781928","60","171571773","GAAAGAAATGAAAAGAAAGAAGTTAGCTGGTTGTTGGGGTATGCTTCTATAGTCCCACCTACTCAGAAAGCTGAAATCTGGAGTTTGGGGTTGTTGTAAGGTAGGCTGATGACATAGCACTGTAGCTTGGGCAAGAGAGTGTGACTTTGTCTCAAAAAAAATTAAAACAA","ATTAAAAACACAAAGATTAGCCAGGTGTGATGGCACACAACTGTAATCCCAACTACTCAGGAGAATCGCTTGAACCTGGGAGATAGGGTTTGCAGTGAGCCAAGATTGTGCCACTGCACTCCAGCCTGGGTGACAGAGTGAGACTCTGTCTCCAAAAAAAAAAAAAAAAAA"
"GL873571","4210444","4210570","chr17","16655655","16655789","35","12445211","GCCAGGCAGATGGCTCACACTTCATCCTAGCCCTCTGGAAGGCTGAGGCAGGCTAATTTTTTGAGGTTAGGAGTTTGAGACCAGCCTGAGGAAGAGACCCATCTCTACTTTAAAAAATAAATGGAAA","GCCAGGCATGGTGGCTCACACCTGTAATCCTAGCACTTTGGGAGACTGAGGCGGGTGAATCACCTGAGGTCAGGAGTTTGAGACCAGCCTGACCAGTATGGTGAAACCCAGTCTCTACTAAAAATACAGAAATTA"
"GL873571","4391733","4391878","chr11","33723808","33723943","46","29332075","AACTTAGCTGGGAATGGTGGCTCAAGCCTGTAATCCTAGCACTCTGGGAGGCTCAGGTGGGAGGATCACTTGAGGTTGCTGTGAGCTTGGCTGATGCCAGGACACTCTAGTGTGGGCAAGAGAGTGAGACTCCGCCTCAACAACAA","GCCGGGTGCAGTGGCTCATACCTGTAATCCCAGCACTTTGGGAGGCTGAGGTAGGCGGATCACGAGGTCAGGAGCTGAGATGGCGCCACTGCACCCCAGCCTGGGTGACAGAGCAAGACTCTGTCTCAAAAAAAAA"
"GL873571","6307773","6307841","chr9","62429628","62429694","22","56121855","CTGGGTGTGGTGGCATTGCACCTGTAATCCTAGCTACTTGGAAATCTTAAGCCCAGGAGTTGAAGACTG","CCCAGCATGGTGGTGCATACCTATAATCTCAGCTACTTGGAGGCTTGAGCTCAGAAGTTTGAGACCG"
"GL873571","6496217","6496306","chr1","27257765","27257856","27","20761548","GCAGGGTGTGTTGACCCACACCCACAATTCCAGGACTCTGGGGGGCCAGGGATGGTGGGTTCCCTCAGATCAGGAGCTCCTTACCAGCCT","GACTGGGCATGATGGCTCAAATCTGTAATTCCAGCACTTTGGGAGGCCGAGGTGGGTGGATTGCCTGAGATCAGGAGTTCAAGACCAGCCTG"
"GL873571","6499738","6499903","chr1","38976375","38976555","47","32476637","AAAATAACATGAATTGACTAGGCGAGGTGGCTCACATCTCTAATCCTAGCACTCTGGGAGGCTGAGGCAGGAGAATTGCATGAGGTTGCTGTGAGCTATGATGATACCACGGCATTCTAATCAGGGTGACAGAGTGAGATTCTGTCTTAAAACAAACAAACAAAAA","AAAATAAATAAATTAGCAGGGCCTGGTGGCGCACACCTGTAATCCCAGCTACTTGGGAAGCTGAGGCAGGAGAACCCACTTGAACCTGGGAGCCGGAGGTTGCAGTGAGCTGAGATGGCACCACTGCACTCCAGACTGCGTGACAGAGTGAGACTCCGTCTCAAAAACAAACAAACAAAAA"
"GL873571","11399575","11399872","chr15","109458692","109458994","79","98059117","CAGTGGCTCACACCTGTAAATCTAACACTCTGGGAGGCCAAGGTGGGTGGATCCCTTGAGCTCAGGAATTTGATACCAGCCTGAGCAAGAGTGAGACCTTGTCTCTACTAATAATAGAAAAATAGCCCGTGTTGTGGCACTTGTCCCAACCACTGGGGAGGCTTTAGGCGGGAGGATTACTTGAATTGGGAGTTTGATATTGCTGTGAGCTGGGCTGATGCCTTGGCATTCTAGCTTGGGTAACAGCGTAAGACTCCGTCTCAAATAAATAAATAAATAAATAAAAAGAAAAAAAGAA","GTGGCTCACACCTGTAATCTCAGCACTTTGGGAGACCGAGGCAGGTGGATCACCTGAGGTCGGGAGTTTGAGACCAGCCTGACCAACGTGGAGAAACCCCGTCTCTACTAACAATACAAAATCAGCTGGGCGTGGTGGTGCATGCTTGTAATCCCAGCTACTCGGGAGGCTGAGGTAGGAGAATCGCTTGAACCTGGGAGGTGGAGGTTGCGGTGAGCCGAGATCGAGCCACTGCACTCCAGCCTGGGTGACAGAGCAAGACTCCATCTCAAAAAAAAAAAAAAAAAAAAAAAAAAAAAAAAA"
"GL873572","114760","114841","chr8","26280134","26280211","16","26165374","GGCCAGGCATGGCGGCTCTTCCCTGTAATCCTAGCACTCTGGGAGGGCGAGGCAGGCAGATCACCTAGGCTAGGGTGAGATC","GGCCAGGAATGGTGGCTCATGCCTGTAATCCCAGCACTTTGGGAGGCTGAGGCAGGCAGATCACCTGAGGTCAGGAGT"
"GL873572","9421791","9421892","chr11","8089184","8089269","35","1332607","TACTAAATATATAGCAAGGCCAGGCACAGTGGTTCATGGCTGTAATCCCAGTACTCTGGGAGGCCTAGTCAGAGTTGACCTGAGATCAGGCTAGAAGCCTGG","ATAAAAATAATTGGAGGCCAGGCACGGTGGCTCATGCTTGTAATTCTAGCAATTTGGGAGGCTGACGCGGGTGAGATCATACTGAG"
"GL873572","11052834","11053035","chr14","11857478","11857657","65","804644","TCCACAAAGAAAGCAGAAGTGTGGCCGGGTGGTAGCTCAAGGCAGGAATCCCAGCACTCTGGGAGCTGGGAGGTGGGGGAGGATCCCTTGAGATCAGGAGTTGGAGGGCACAGTGAGCCTGGGGGAGGCCACTGTCTCTGTACTCTAGCAGGGAGACAGAGCAAGACTGCCCATTCAAAGAAAAACAACAAACAAAACAAAA","TACAAAAATTAGCTGGGCACGGTGCCACAAGCCTGTAATCCCAGCTACTCGGGAGGCTGGGCAGGGGAATAGCTTGAACCCAGAGGTGGAGGTTGCAGTGAGCCAAGATCAAGCCACAGCACTCCAGCCTGGGTGACAGAGCAAGACTCCATCTCAAAAAAAAAAAAAAAAAAAAAAAAA"
"GL873573","2564195","2564244","chr1","109985445","109985491","12","107421250","TACAAAAATTAGGCTGGGCTTGGTGGTTCACGCCTATAATCCTAGCACTT","ACTAAAATTAGCTGGGCATGGTGGTGCATGCCTGTAATTCCAGCTAC"
"GL873573","7423371","7423533","chr2","202783328","202783513","56","195359957","GGTGGCTCACACCTGTAATCCCAGCACTCTGGGAGCCCTGGTGGCTCATGTCTATAATCCTAGTACTCTGGGAGACCATGGTGGCTCATGTCTATAATCCTAGTACTCTGGGAGCCATGGTGGCTCACGCCTATAATCCTAGTACTCTGGGAGACCATGGTGG","GGCTGAGGCGCGGGGGCTCACGCCTGTAATCCCAGCACTGTGGGAGGCCGAGGCGGGTGGATCACGCCTGTAATCCCAGCACTGTGGGAGGCCAAGGCGGGTGGATCACGCCTGTAATCCCAGCACTGTGGGAGGCCGAGGCGGGTGGATCACGCCTGTAATCCCAGCACTGTGGGAGGCTGAGGC"
"GL873573","9657648","9657710","chr19","10207852","10207913","10","550204","TAAAAATAAAAAATTTAGCTGGATGTGGTGGCTCACACCTGTAATCCTAGCACTCTGGGAGAC","TAAAAATACAAAATTAGCTGGGTGTGGTGGCACACACCTGTAATCCCAGCTACTCAAGAGGC"
"GL873574","1624662","1624783","chr9","814961","815079","36","809701","GACTGGGTGGGTTGGATCATGCCTGGAATCCTAGCACCCTGGGAGGCCAAGGTGAAAGGATTGCTTGAGGTTAGGAGTTCCAGAAATGTAGCAGTCATGGTGACTTCATCCTTCTCTACCAA","GGCTGGGTGCTTTGATTCATGCCTGTAATCCCAGCACTCTGGGAGGCCGAGGCAGGTGGATCACCTGAGGTTAGGAGTTCGAGACCAGCTTGGCTAACATGGTGAAACCTCGTCTCTAC"
"GL873574","4459477","4459612","chr1","29437872","29437991","29","24978395","GGCCGGGCGTGGTGGCGCACGCCTGTAGTCCCAGCGCTATGGGAGGCCGAGGCGGGTGGATCACCTGAGCTCAGAGGTTCGAGACCAGCCAAGACCCCCCTGAGCCAAACGAGCCAGAGTGAGACCCCGTCTCTAC","GGCCGGGCGTGGTGGCTCACGCCTGTAATCCCAACATTTTGGGAGGCCAAGGCGGGTGGATCACCTGAGGTCAGAAGTTCGAGACCAACCTGGCCAACATGGTGAAACCCCTGTCTCTAC"
"GL873574","4681987","4682216","chr6","153082888","153083127","73","148400901","GGGTGCGGTGGCTCAGACCTATAATCCCAGCACTCTGAGAGGCCGAAGTGGGTGGATCACCTGAGCTCAGGAATTTGAGACCAGCCGTCTCTAAAAATAGCTGAGTGTTGTGGCAGTGGCTGTAAGTCCCAGCTGTTTGGAAAGCTGAAGCAAGGGAATCACTTGAACCCAAGAGTTTGAGGTTGCTGTGATGACAAAGTGAGACTCTATCTCAAAAAAAAAAAAAAAAA","GGCCGTGCGCGGCGGCTCACGCCTGTAATCCCAGCACTTTGGGAGGCTGAGGTGGGTGGATCACCTGAGGTCAGGAGTTTGAGACCAGCCCGACCAGAAATTAGATGGGTGTGGTGGTGCGCTCCTGCAGCCCCAGCTACTTAAGAGGCTGAGGCAGGGTAATCACTTGAACCCGGGAGGCGGAGGTTGCAGTGAGCCGAGCTCACGCCACTGCACTCCAGCCTGGGTAACAGAGCGAGA"
"GL873574","4709916","4710039","chr19","13152422","13152536","46","8442506","AAAAATAGAAAAACTAGCCAAGCATGGTGGTGCACCCCCTATAGTCTGAGCTCCTCAGCGGGCTGAAGCAAAAGGACGGCTGGAGCCCTGGAGTTTGAGGTTGCTGTGAGGCAAGGTGATGCCA","ACACATAAATTAGCCAGACATGATGGTGAGTATCTGTAATTCCAGCTCCTTGGGGGGCTGAGGCGGGAGAATTGCTTGAACCTGGGAGGCAGAGATTGCAGTGAGCCAAGATCGC"
"GL873574","6353839","6353913","chr5","25768079","25768163","22","19414240","AAAAATATAGCAAGGCCAGGCATGGTGGCTCACACCTATAATCCCAGTACTTGGGAGCTGGAATTTGAACCTAGG","AAAAAACTCAAACAAGGCTGGGCGTGGTGGCTCACACCTGTAATCCCAGCACTTTGGGAGGCTGAGGTGGGTGGATCACCTGAGG"
"GL873574","6533061","6533332","chr5","85182161","85182439","81","78649100","GGCTGGGCGAGGTGGCTTACACCTATAATCCTAGTACTCTGGGAGGCCAAGGTGGGTGGATTGCCTGAGCGCACAGTTTCAAGACCAGCTGGAGCCAGAGAGAGAGAGAGAGACCCTGCCTCTAAAAATAGCCAGGCATTGTGGCAGGCACCTGTAGTCCCAGCTACTTGGCAGGCGGAGGTATGAGAATCGCTAGAGGTTGCTGTTAGCTATGATGCCATAGCACTCTACCAAGGGCGACAAAGTGAAACTCTGCCTCAAAAAAAAGAAGA","GCCAGGCGTGGTGACTCAAGCCTGTAATCCTAGCACTTTGGGAGGCCAAGGTGGGCGGATTGCCTGAGCTCAAGAGTTTGAGACCAGCCTGGGCAACACGGTGAAACCCAATCCCTACTAAATACAAAAAAAATTAGCCGGGTGTGGTGGTGTGAACCTGTAGTCCCAGCTACTCGGGAGGCTGAGGCAGGAGAAGGCAGAAGTTGCAGTGAGCCGAGATCACACCACTGCACTCCAGCCTGAGTGACAGAGCAAAACTCTTTCTCAAAAAAAAAAAAA"
"GL873574","6643746","6643907","chr2","92627944","92628105","46","85984198","AAATAGCCAGGCGTTGTGGCAGGCACCTATAGTCCCAGCTACTTGGGAGGCTGAGGCAAGAGAATCACTTAAGCCCAAGTGACAGAGGTTGCCAGGGCACTCTACGTAGGCAACAGAGTGAGACTCTATCTAAGAAAGAAGGAAGGAAGGAAGGAGAAAGAA","TTAGCCGAGCATTGTGGTGCGCGCCTGTAGTCCCAGCTACATGGGAGGCTGAGGCAGGAGAACACCTGAACCCAGGATGTGAGCTGAGTCGCGCCATTGCACTCCAGCCTGGGCAACAGAGTGAGACTCCATCTCAAAAATAAAATAAAATAAAATAAAAAA"
"GL873574","6644163","6644274","chr1","128607504","128607619","20","121963341","CTGTAATCCTAGCACTTGGGAGGCTGAGGCAGGTGGATCACCTGAGTTCAGGAGTTCAAGACCAGCCTAAACAAGAGTGAGACCCTATCTCTACTAAAAATAGAAAAAATAT","GCCTGTAATCCAAGCACTTTGGGAGGCTGAGGCGGGTGGATCACCTGAGGTCAGGTGTTCGAGACCAGCCTGGCCAACGTGGTGAAACCCCAACTCTACTAAAAATACAAAAATTA"
"GL873574","8511822","8512127","chr1","23439759","23440073","84","14927937","GGTGGCTGGTGCCTGTAATCCTAGCACTCTGGGAGACTGAGGCAGGTGGATCACTTGAAATCAGGAGTTTGAGATCAACCTGAGCAAGAGATCTTGTCTCTCCTAAAGATAGAAAAACTAGCTGGGATTTGTGGTGGACACCTGTAATTTCAGCTACTCAGGAAGCTAAGGCAAGAGCATTGCTTAAAACCAGGAGTTTGAAGTTGATGTGAGCTAGGATGTCAGGGCAGGTTACCCAGGGTGACAGAGTGAGACTCTGTGTCAAAATAAACAAACAAACAAACAAACAAAACAAAATAAAATAAA","GGCTGGACATGGTGACTCACGCTTGTAATCCCAACACTTTGGGAGGCTGAAGCAGGCAGATCACCTGAGGTCAGGAGTTTGAGACCAGCCTGACCAACATGGTGAAACCTTGTCTCTACTAAAAATACAAAAATTAGCTGGGAGCAGTGGTGCACACCTGTAATCCCAGCTACTCGGCAAGCTGAGGCAAGATAATTTTTTAAACCTGGGAGGTGGAGGTTGCAGTGAGCCAAGATCGTGCCACTGTACTCCAACCTGGGAGACAGAGCAAGACTCTGTCTCAAAAAAAAAAAAAAAAAAAAAAAAAAAAAAAAA"
"GL873575","2107336","2107519","chr4","38052972","38053149","54","35945636","TCAATTAAAAACTTTTTAAAATGAGGCTGAGCATGGTGGTTCACACCTGTAATCCCAGCACTTTGGGAGGCCGAGGCAGGAGGATCACCTGATCCCAGGAGTCCAAGCCTACAGTGAGCCGTGATAATACCACTGCACTTCAGCCCAAAGCCTCAAAAAGAAAAAAAAAAAAGGATAGACAAGA","TATATATATATATATTATTTTGGGGGGGCATGGTGGTGCACACCTGTAATCCCAGCTACTCGGGAGGCTGAGGCAGGAGAATTGCTTGAGCCCGGGAGGCAAAGGTTGCATTGAGCTGAGATCACACCACTGCACTCCAGCCTGGCGACAGAGTCTCAAAAAAAAGAAAAAATAAAAA"
"GL873575","5831824","5831959","chr1","29437872","29437991","28","23606048","GGCCGGGCGTGGTGGCGCACGCCTGTAGTCCCAGCGCTATGGGAGGCCAAGGCGGGTGGATCACCTGAGCTCAGAGGTTCGAGACCAGCCAAGACCCCCCTGAGCCAAACGAGCCAGAGTGAGACCCCGTCTCTAC","GGCCGGGCGTGGTGGCTCACGCCTGTAATCCCAACATTTTGGGAGGCCAAGGCGGGTGGATCACCTGAGGTCAGAAGTTCGAGACCAACCTGGCCAACATGGTGAAACCCCTGTCTCTAC"
"GL873575","7451097","7451208","chr3","122814630","122814743","22","115363533","GGCCAGGTGTGGTGGCTCACACCTGTTATCCTAGCACTCTGAGAGGCCACAGCAGCTGGATCACTTGAGCTCAGGAGTTCAAGACCAGTCTGAGCAAGAGCAAGACCTCACC","GGCTGGGTGTGGTGGCTCATGCCTGTAATCCCAGCACTTTGAAAGGCCAAGGCAGATGGATCACTTGAGGTCAGGAGTTCCAGACCAGCCTGGCCAACATGGCAAAACCCCATC"
"GL873575","7451277","7451445","chr6","58863249","58863409","41","51411972","AAAAATTCAGCCAGCCACAGTGGAAGTGGATGCCTGCCATCACAGCTACTCTGGGGGCTGGGGCAAGAGAATTGCTTGATCCCAGGAGTCTGAGGTTGCTGTGACCTAGGCTGACACCACAGCACTCTACCCAGGGTGACAGAGTGAGGCTGTGTTTAAAAAAAAAAAA","TTAGCCAGGCATGGTGGCACATGCCAGTAATCCCAGCTACTCAGGAGGATGAGGCAGGAGAATCGCTTGAACCCAGGAGGCAGAGGTTGCAGTGAGCTGAGATTGCGCCACAGCACTCTACCCTGGGTGACAGAAGGAGACTCTGTCTCAAAAAAAAAAAA"
"GL873576","1765109","1765185","chrX","53921180","53921256","12","52156071","GGCCAGGTGCAGTGGCTCATATCTGTAATCCTAGCACCCTGGGAGGCCAAGGTAGGCGAATCACCTGAGGCCAGGAG","GGCCAGGTGCAGTGGCTCACGCCTGTAATCCCAGCACTTTGGGAGGCCGAGGTGGGCGGATCACTTTAGGTCAGGAG"
"GL873576","2711577","2711895","chr7","6620384","6620702","85","3908807","GGTCGAGCTTGGTGGCTCATGCTTGTAATCCTAGCACTCTGGGAGGCCAAGGCAGGTAAGTTGCCCTGAGCTCATAGGTTCCAGATCAGCATGAGCCAGAGTGAGACCCTGTCTCTACCAAAAAATAGCCCGGCATTCTGGCAGGTGCCTGTAATCCCAGCTGCTTGGGAGGCTGAGGCTAGAGAATCACTTAAACCCAAGGGTTAGTGGAGGTTGCTGTGAGCTATGATTCCACCGTACTCTACTGAGGGCCACAAAGTGAGACTCTGTCTCCATAAAAAAGAAAGAAAGAAAGAAAGAAAAATAAAATAAAATAAAA","GGCCAGGCACAGTGGCTCATGTCTGTAATCCCAGCACTTTGGGAGGCCGAGGCGGGTGGATTACCTGAGGTCAGGAGTTCTAGACCAGCCTGGCCAACAAGGCGAAACCCTGTCTCTACTAAAAATACAAAAAATTAGCTGGGCGTTTTGGCACATGCCTGTAATCCCAGCTACTTGGGAGGCTGAGGCAGGAGAATTGCTTGAACTGGGGAAGTGGAGGTTGCAGTGAGCTGAGATCACACCATTGCACGCCTGAGCAACAGAGCGAGACTCTGTCTCAAAAAAAAAAAAAAAAAAAAAAAAGAAAAGAAAAAGAAAA"
"GL873576","4782520","4782652","chr9","61136941","61137074","22","56354421","CCAGGCACGGTGGCTCACCCTTGTAACCCTAGTACTTTGGGAGGCTGAGGTGGGAGGATCCCTTGAGGTCAGGAGTTCAAGACCAGCCTGAACAACAGTGAGACCCCCGTCTCTACTAAAAAATAGAAAAGTT","GCCAGGCACGGTGGCTCACGCCTGTAATCCCAGCACTTTGGGAGGCTGAAGCGGGCGGATCACCTGAGGTCAGGAGTTCAAGACCAGCCTGGGCACCATGATGAAACCCCGTCTCTATTAAAAATACAAAAATT"
"GL873576","4782930","4783078","chr7","57521645","57521803","40","52738715","AGTTAGTCTGGTGTCATGGTGGGTGCCTGTAGTCCCAGCTGCTTGGGAGGCTGAGGCAAGAGAATCACTTGAGCCCAGGAGTTGGAGGTTGCTATGAGCGAGGCTGTAGCCTAGGCAACAGAATGAGACTTTGCCTCAAAAAAATAAAA","TTAGCTGGGCATGGTGGCGCATGCCTGTAGTCCCAGCTACTTGGGAAGCTGAGGCAGGAGAATCACTTGAACCTGGGAGGTGGAGGTTGCAGTGAGCTGAGATCGCACCGCTACACGCCAGCCTGAGCAACAGAGAGAGACTCTGTCTCAAAAGAAAAA"
"GL873576","7828709","7828723","chr5","101042981","101042996","1","93214272","TAAATAAATAAAAAA","TAAATAAATAAATAAA"
"GL873576","7828960","7829230","chr13","49045537","49045844","89","41216577","GCCGGCTGCAGTGGCTATAATCCAAGTACCCTGGGAGGCTTAGGTGGATGGATCACTTGAGCTCAGAAGTTCAAGACCAGCCTCAGCAAGAGGTAGACCTTGCCTCTATTAAANNNNNNNNNNNNNNNNNNNNNNNNNNNNNNNNNNNNNNNNNNNNNNNNNNNNNNNNNNNNNNNNNNNNNNNNNNNNAGTTTGAGGTTGCTGTGAGCTATGATGAAGCCAGGGCATTCTACCCAGGGTGACAGAGTAACTCTTAAAAAAAACTAAACAA","GGCCAGGCAGAGTGGCTCATGCCTGTAATTCCAGCAATTTGGGAGGCCTAGGCAGGCAGATTACCTGAGGTCAGGAGTTTGAGACCAGCCTGGCCAACATGGTGAAACCCCGTCTCTTCTANNNNNNNNNNNNNNNNNNNNNNNNNNNNNNNNNNNNNNNNNNNNNNNNNNNNNNNNNNNNNNNNNNNNNNNNNNNNNNGGAGATAATAGCTTTTGTAGAACGAAGCGATGCAACAGCCAGATCGCCGCCACCACCCTTAGGTCCTGGCGACAGAGTGAGATCCATCTTAAAAAAAAAAAAAAAAAAA"
"GL873576","10622840","10623093","chr7","60266447","60266705","74","49643607","GCTGGGTATGGTGGTTCACACCTATAATCCTAGCACTCTGGGAGGCTGAGGTGGGAGGATTGGTGGAGCTCAGGAGCTCATGAGGTGCCAAATCACTGGTGCCACACACCTGTATTCCCAGCTACTGAGGAGGCTGAGGCAGGAGGATCAGGTAAGCCCAGGAAGTTTGAGGTTGTAGTGAGTTAGGATGATTGAACTCTGCCTTGAGAGACAGAGCAAGATCCTCCTTCCTCCTAAGCAAACAAACAAATAAA","GGCTGGGTGCAGTGGCTCACACCTGTAATCCTAGCACTTTGGGAGGCTGAGGCGGGAAAATTGCCTGAGCTCAGGAGTTCAAGGACAGCCTAGGCAACATAGCATGGTGGTGCACGCCTGTATTCCCTGCTACTTGGGAGGCTGAGGCACAAGAATTGCTTGAATCCGGGAAGTGGAGGTTGCAGTGAGCCATTGTGGCACTGCTCTCCAGTCTGGGTGACAGAGCAAGACTCCATCTCAAAAAAAAAAAAAAAAAAAA"
"GL873576","10819939","10820007","chrX","67133632","67133707","21","56313693","AGGTTGCAGTGAAATTGTACCATTCCAATGAAGCCTGGGGGACAGAGTGAGATTCTCTCAAAATAAAAA","GGAGGTTGCAGTGAACCGAGATCGTGCCACTGCACTCCAGCCTGAGCGACAGAGTGAAACTTCGTCTCAAAAAAAA"
"GL873576","10920306","10920363","chr3","48261745","48261808","16","37341439","GCTGGACCTTGTAGAGAGTGCCTGTAATCCCAGCTACATGGGGGGCAAGAGAATTGCT","GCTGGGCATGGTGGTGCATGCCTGTGATCCCAGCTACTCAGGAGGCTGAGGCAGGAGAATTGCT"
"GL873576","10920398","10920529","chr10","67341428","67341546","30","56421030","GGCCAGGCGTGGTGGCTCACGCCTGTTGTCCCAGCACTGTGGGAGGCCGAGGTGGGTGGATTGCCTGAGCTCAGAGGAGTCCGGAAGACCAGCATGAGGCAGAGTGAGCCAGAGTAAGATCCTGTCTCTACC","GGCTGGGTGTAGTGGCTCATGCCTGTAATCCCAGCACTTTAGGAGGCCAAGGTGGATGGATTGCCTGAGCTCAGGAGTTCGAGACCACCCTGGGCAACAAGCCAAAACCCTGTCTCTAC"
"GL873577","515809","515961","chr7","137660778","137660931","43","137144969","AGCTGGGCATGGTGGCTCATGCCTATAACCCTAGCGTGCTAGGAGATTGCTTGTCAGGAGACTGAGGTTGCAGGAAACTGTGATGATGGCACTGCACTCTACCCAGGGTGACAGAGCAGGACTCTGCCTCAAAAAAAAAAAAAAAAATAGAAA","TTAGCTGGGCATGGTGGCGCATGCCTATAATCCCAGCTACTTGGGAGGCTGAGGCAAGAGAATCGCTTGAACCGGGGAGGCAGAGGTTGCAGACTGCACTCCAGCCTGTGTGACAGAGTGGGACTCCGTCTCAAAAAAAAAAAAAAAAAAAAAA"
"GL873577","1633164","1633256","chrX","38269524","38269615","26","36636360","TCAGCCAGGCATGGTGGCACTTGCCTATAAACCCAGCTCCTTGGGAAGCTGAGCCGGGAGGATCCCTTGCACCCAGGAGCAACGGAAGGCAGT","AATTAGCCAGGCATGGTGGCACATGCCTATAATCCCAGCTACTCAGAAGGTTGAGGCAGGAGAATCACTTGAACCTGGGAGGCAGAGGTTGC"
"GL873577","3979502","3979560","chr20","68909283","68909346","13","64929781","GAGTTTGAGACCAGCCTGAGCAAGACCGAGACCCAGTCTCTACTAAAAATAGAAAAATT","GGAGTTCAAGACCAGCCTGACCAACATGGAGAAACCCTGTCTCTACTAAAAAATACAAAAATTA"
"GL873577","3979839","3980009","chr10","31403126","31403287","39","27423287","ATGAGCAGATTGTCTTGGTGGGCACCTGTAGTCCCAGCTATTGGAGGTGGGAGGCTGAAGCAGGAAAATCTCTTGAGCCCAGGAGTTTGAGGTTGCTGTGAGCTAGGCTGACACCACGGCACTCTAGTCAGGGCGTCAGAGTGAGACTCCGTCTCAAAAAAAAAAAAAAAA","TTAGCTGAGTGTGGTGGCGCACATCTGTACTCCCAGCTATTTGGGAGGCTGAGGCAGGAAAATCGCTTGAACCCAGGAGGTGGAGGTTGCAGTGAGCCAAGATCACACTACTGCACTCCAGCCTGGGTGACAGAGTGAGAATCCATCTCAAAAAAAAGAAAA"
"GL873577","6050882","6051080","chr1","153219820","153220007","59","147168938","GGCTGGGCGTTGTGACTCATGCCTGTAATCCCAGCACTCTAGGAGGCCGAGGTGGGTGGACTGCCTGAACTCAGAGGTTTAAGACCATCCTGAGCCGCAGTGAGCCAGAGCGAGACCCTGTCTCTACCAAAAAAAGCTGGGTGTTGTGGTGGGCGCCTATAGTCCTAGCTACTTGAGGCGCTAAGGGTAAAAAAATTGC","GGCCTGGCACAATGGCTCACGCCTGTAATCCTAGCACTTTGGGAGGCCGGGGTGGGTGGATCACCTGAGATCAGGAGTTTGAGACCAGCCTGGCCAACATGGTGAAACTCCTTCTCTACAAAAATTAGCCAGGTGTGGTGGTGGGTACCTGCAATCCCAGCTATTTGGGAGGCTGAGGCAGGAGAATC"
"GL873577","8463965","8464050","chr9","52134422","52134508","19","43670457","CTGGGTGCTATAGCTCACGCCTATAATCCTAGCACTCTGGGAGTTTGGGGCAAATGGATCACCTAGGCTCAGGAGTTTGATACCAG","GGCTGGGAGCAGTGACTCACGCCTATAATCCCAGCACTTTGGGAGGCTGAGGCAGATGGATCACCTGAAGTCAGGAGTTCGAGACCA"
"GL873577","9471486","9471613","chr16","5178790","5178910","46","4292696","TTAGCCAGGCATAGTAGCCTGTGTGTAGTCCTAGCTACTCAGGAGGCTGAGGTAGATGGGTCACTTGAGGTTGCAGAGATTATGGTAATGTCACTGTACTCTAGCCCTGGCAACAGAGCACAACCCTG","TTAGCCGAGCCTGGTGGCATAAACCTGTAATCCCAGCTACTCAGGAGGCTGAGGCAGGGGAATTGCTTGAACCTGAGAGGAGAAGGTTGCAGTGAGCCGAGATTGCACCATTGCACCCCAG"
"GL873577","9471875","9471998","chr7","17832200","17832315","36","8360325","GGCCAGGTGAAGCAGCTCATGGCTATAATCCTAGCAGTTTGGCAGGCCAAGGTGGGAGGACTGCTTGAGGTCAAGAGTTCAAGACCAACCCATCTTTGCGAAAAATTTAAAAATTACCTAGGCA","GCCAGGAGAGGTGGCTCATGCCTCTAATCCCAGCACTCTGGAAATCCAAGGTGGGTGGATCACCTGAGGTCAGGAATTCCAGACCAGTCTGGCCAATATAAAAAATTAGCCAGGCT"
"GL873577","9853150","9853170","chr3","85044647","85044667","3","75191497","AAACAAACAAACAAAAAAAGA","CAAACAAACAAACAAACAAAA"
"GL873577","9853206","9853473","chr7","130818682","130818963","67","120965476","GCTGGGCGCAGCGTCTCACTCCTGTAATCCCAGCACTTGGGAGGCCAAGGTGAGTGGATTGCCTGAGTTTACAGTTTCGAGACCAGCCTGAGCCAAAGCGAGACCCCCATCTCTAAAAAATAGCTGGGCATTGTGGTGGGCACCTGTAGTCCCAGCTACTTGGGAGGCTGAGGCAAGAGGATCGCTTGAACCTAAGAGTTTGAGGTTGCTGTGAGCTAAGGCTCCATGGCATTCTACCAAGGGTGACTAAGTGAGACTCTGTCTAAAA","GCCGGGCACAGTGGCTCACACCTGTAATCCCAGTACTTTGGGAGGCCAAGGTGGGTGGATCACCTGAGGTCAGGAGTTTGAGACCAGCCTGGCCAACATAGTGAAACTCTACTAAAAATACAAAAAAATAGCTAGGCATGGTGGTGCGCACCTGTAATCCCAGCTACTTGGGAGGCTGAGGCAGGAGAGTTGCTTGAACCCAGCGGGGTTGAGGTTGCAGTGAGTTAAGATCAAGCCACTGTGCTCCAGCCTGGATGACAGAGAGAGACTCCATCTCAAAAA"
"GL873577","10722415","10722478","chr10","12501471","12501539","23","1779056","AATAAAAAAATGCTGGGTACAGTAGTACATGCCTGTACTCTCATCTGGGGAAGCTGAGGCATGA","AAAGTAAAAAATTAGAGCTGGGCATGGTGGCACACACCTGTAATCCCAGTCACTAGGGATGCTGAGGCA"
"GL873578","463331","463568","chr10","28935382","28935620","93","28472051","CAGGTGCTTTGACCCACACCCTCAACTCTAGGACTTTGGACGCCCTGGCTGGGTGGGTCCTTTAAAGTCAGGAGCTTCTTATCAGTCTGGGCAAAAGTGAGACCCCATCTCTACCAAACAAAGAAAGAAATCAGCAGTATGTTGCAGTAGAGACTCACCAATACCTTCTTTCAAAGACCAAAGCTGGAAGGACACTAAAGACCATGATCTCATGGCCTCCCTGAGCCATGACAATGCC","CCAGGTGCAGTGGCTCATGCCTGCAAGCTCAGAACTTTGGGAGGCAGAGGTGAGCAGACTGCCTGAGTTCAGGAGTTCAAGACCAGCTGGGCAACATGGTGAGACCCTATCTCTACTAAAAATACAAATAATTAGCAGGGTGTGGTAGCACACACCTGTAGTCCAGCTACTCAGGAGGCTGAGGCAGGAGAATTGCTTGAACCCAGGAGGCAGAGTTTGCAGTGAGCCAGGACTGGGCC"
"GL873578","1143712","1143827","chr11","52824583","52824692","30","51680871","GGCTGGGTGTGGTGCCTCATGCCTGTAATCTAAGCCCTCTCCGAGGCTGAGGTGGGAGGATCCCTTGAGTTTAGGAGTTTGATTTTGAGACCAGCCTGATCAAGAGAGAGACCTCA","GGCCGGGTGTGGTGGCTCATGTCTGTAATCCCAGCACTTTGGGAGGCTGAGGTGGGTGGATACCCTGAGGTCGGGAGCTCGAGACCAGCCTGACCAACATGGAGAAACCC"
"GL873578","1144101","1144139","chr3","33494224","33494257","11","32350123","GAGAGAGACCTCATGTCTACTAAAATAAATAAATATATA","GTGAAACCCGTCTCTACTAAAAATACAAAAATTA"
"GL873578","1144175","1144343","chr12","119519961","119520131","41","118375786","ATTATCCAGGCCTTCTGGTGGATGCCTGTAGTCCTAGCTACTAGAAAAGCTGGAGCAGAATCACTTGACCCAGGAGCTGGAGGTTGCAGGGAGCTAGGCTGATGCCACAGAATTCTAGCCTGAGGCAAAAGAATTGAGCCACTGTCTCAAAAAGGAACAAAAAAGAAAA","ATTAGCCAGGTGTGGTGGCATGCACTTGTAATCCCAGCTACTAAGAAGGCTGAGGCAGGAGGATCACTTGAACCCGGGAGGTGGAGGTTGCAGTGAGCCAAGATCATGCCACTGCACTCCAGCCTGGGCAACAGAGTAAGACTCTGTCTCAAAAAAAAAAAAAAAAAAAAA"
"GL873578","4593962","4594035","chr16","68825055","68825124","22","64231093","AGCTGGGTACAGTGGCTCACATATAATCCCAGTGACTCAGGAGGCTAAGACAGGAGGATTACTAGGACCTGAGA","GGCTGGGCACAGTGGCTCAGACCTGTAATCTCAGTACTTTGGGTGGCTGAGGCAGGTGGATCACCTGAGG"
"GL873578","6158845","6158972","chr3","500432","500562","24","5658413","GACATGGTGGCTCACACCTGTAATCCTAGCCCTCTGGGAGGCTGAGGCAGGTGGATCACTTGAGTTCAGGAATTCAAGACCAGCTTGAGTGAGAGCAAGACCCTGTCTCTACTAAAAATAGAAAAATT","GCACGGAGGCTCATACCTGTAATCCCAGCACTTTGGGAGGCTGAGGCAGGTGGATCACCTGAGGTCAGGAGTTCCAGACCAGCCTGGCCAACATGGCGAAACCCTGTCTCTACTAAAAATACAAAAAATCT"
"GL873578","6159253","6159444","chr19","34496349","34496541","55","28337096","ATAAAATAAAAATAGAAAAATTAGCCAGGCATTGTGGCAGACATGCGAAGTCTCAGCTACTCCAGAGGCTGAGACAGGAAGATTACTTGAGCCCAAGAATCTTGCTGTGAGCTAAGCTGATGCCATAGCATTGTAACCTAGGCAACAGAGTAAGACTTGGCCTCAAAAATAAAATAAAATAATAAAGTAAAA","TTAGTTAATTAAATTAAACTTAGCTAGGCATAGTGGAACACACCCATAGTCCCAGCTACTCTAGAGGCTGAGGCAGGAGGATTGCTTGAGCCAAGTTGGAGGCTGCAGTGAGCTATGGTGGTGCCACTGCATTCCAGCCTCAGTGACAGAGAGAGACCCTGGCTCAAATAATAATAATAAATAAATAAATAAA"
"GL873578","6766040","6766171","chr2","93098086","93098217","30","86332046","CCAGGCACAGTGGCTCATGCCTATAATCCTAGTAGTCTAGGAGGCTGAGGTGAGTGCATTGCTTGAGCTCAGGAGTTAGATACCAGCCTAACCAAGAATGAGACCCCATCTCTATTAAAAATAGAAAAGTTA","GCCGGGCACAGTGGCTCATGCCTGTAATCCCAGCACTTTGGGAGGCCGAGGCGGGCAAATCACGAGGTCAGGAGTTCAAGACCAGCCTGACCAATATGATGAAACCCCGTCTCTATTAAAAATACAAAAATT"
"GL873578","6766434","6766577","chr9","21128084","21128223","50","14361650","GTTAGCCAGGAGTTGTGGCGGGCACCTACAGTCCTAGCGACTCAGGAGGCTGAAGTAGGCAGAGTTTGATGTGTTGCTGTGAACTACAAGGACACCAATGCACTCTAGGCCGGTAACAGAGTGAGACACTGACTAAAAAAAAAA","TTAGCCAGGTGTGGTGGCACATGCCTGTATTTCCAGCTACTCGGGAGGCTGAGGCAGGAGAATTGCGTGAGCTGAGATCATGCCACTTCATTCCAGTCTGGGTGACAGAGTGAGACTCTGCCTCAAAAAACAAAACAAAA"
"GL873578","7397948","7398119","chr5","40230148","40230319","43","32832200","TAAAAATAGCCATGCATTGTGACAGGCACCTGTAGTCCCAGCTACTCAGGAGGTTGAGGTAAGAGAATCACTTGAACCCAAGAGTTTTGAGGTTGTTATGAGCTAAGACGCCTCGGGACTCTACAAAAGGTAACAAAGTGAGACTCTGTCTCATAAAAAAAGAAAAAAAGAA","AAAATTAGCCAGGCATGGTGACGTACACCTGTAGTCCCAGCTACTCGGGAGGCTAAGGCAAGAGAATCGCTTGAACCCAGGAGGCAGAGGTTGCAGTGAGCTTAGATCACGCTACTGCGCTCCAGCCTGGGTGACGGAGTGAGACGCCATCTCAAAAAAAAAAAAAAAAAAA"
"GL873578","7398378","7398515","chr15","102382935","102383070","35","94984557","GGTCGAGCAAGGTGGCTCACGCCTGTAATCCTAGCACTCTGTGAGGCTGAGGCAGATGGATTGCCTGAGCTCGTGGGTTCGAGACCAGCCTGAGCCAGAGTGAGACCTCATCTCTAAAAATAGCTGGGAAGCTGGGCA","GGCCAGGTGTGGTGGCTCACGCCTGTAATCCTAGCACTTTGGGAGGCTGAGGCGGGTGGATTGCCTGAACTCAGGAGGTCAAGACCAGCCTGGGCAACACAGTAAAACCCCATCTCTACTAAAATACAAAAAATCA"
"GL873579","370235","370429","chr16","38067345","38067552","57","37697110","GCACAGGCCTGAAATCCTAGCACTCTGAAAGGCCAACGGAGGAGAATTTCTGGAGCTCAGGAGTTTGATACCAGCCTAAGCAAATAAAGCTAGACCTCTATCTCTACTAAAATTAGAAAAATTAGGCAGATGTGGTGGTAGGCACCTATAGTCCCAATTACTCCAGAGGCTGAGGCAGAAAGACTCTTGAACCCA","GTCAGGCATGGTGGCTCATGCCTATAATCCTAGCACTTTGGGAGGCCAAGGCCGGTGGATCACCTGAGGTCAGGAGTTTGAGACCAGCCTGGCCAATATGGCAAAACCCCGTCTCTACTAAAAATAAAAAAATTAGCTGGGCACGGTGGTGGGCACCTATAGTCCCAGCTACTCAGGAGGCTGAGGCAGGAGAATTGCTTGAACCCAG"
"GL873579","370936","371046","chr3","3847698","3847802","33","3476762","TGACTCTTGAACCCAGGCACATGAGGTTGCTAAGAGTCTAGGCTGATGTCACGGCACTCTAACCTGGGAAACAGTGTGAGGTTCTGCCTCAATAAATAAATAAATAAATAA","TGGCTTGAACCCAGGAGGCGGAGGTTGCAGTGAGCCGAGATCACGCCACTGCACTCCAGCCTGGGCAACAGAGCGAGACTGTCTCAAAAAAAAAAAAAAAAAAAA"
"GL873579","599436","599605","chr10","38982686","38982853","41","38383250","AAAAAGTCAGACATTGTGGCAGGTGTCTGTAATCCCAGCTATTTGGGAGGCTGAGGCAGGAGTATCATTTGAACCCACGAGTCTGAGGTAACTGTGAGCTAGGCTAACACAACAGCACTCTAGCCTGGGCAATAGAATGAGACTCTATCAAGAAAAGAAATGAAAAGAAA","TATTAGCCTGACACAGTGGCGCGCATCTGTAATCCCAGCTACTTGGGAGGCTGAGGCAGGAGAATCACTTGAACCCAGGAGGCGGAGGTTGCTGTGGGCTGAGATCATGCCACTGCACTCCAGCCTGGGCAACAGAGGGAGGCTCCATCTCAAAAAAAAAAAAAAAAA"
"GL873579","599942","599953","chr3","71473700","71473710","4","70873758","TTTTAAAATAGT","TTTAAAAAAAA"
"GL873579","600232","600365","chr1","16061315","16061447","30","15461083","GGCTAGGCAAGGTGACTCATGTCTGTAATCCTAGTACTCTGGGAGGTTTGAGGCAGGAAGACCACTTTAGCTCAAGAGTTCCAGATCAGCCTGTGCAAGAGTGATACATCATCTCTACTAAAAATCAAAAATTA","GGCTGGGCATGGTGGCTCATGCCTGTAATCCTAGCACTTTGGGAGGTTGAGGCAGGCAGATCACTTGAGGTCAGGAATCTGAGACTAGCCTGGCCAACATGGTGAAACTCCATCTCTACTAAAAAAAAAAAAA"
"GL873579","5650320","5650591","chr6","54938866","54939145","71","49288546","GTCAGGTGTGTTAGCTTACAGTAGTAATCCTAGCACTTTGGGAGGTTGAAGTGGGTGGATTGCTTGAGCTCAGGGGTTCAAGACCAGCCTGAACAAGAGTGGGACCTCATCTCTATTAAAAACAGAAAAACTAGCTGGGTGTTATGGTGGGTGTCTGTAGCCCCAGCTACTCAGGAGGCTGAGGCAGGAGGTTGAGGTTGCTGTGAGCTATTGAGACCACAGCACTCTATCCAGGGCAACAGAGTGAGACCCCTCCCCCCCCCAAAAAAAAA","GGCCAGGTGTGGTGGCTCACGCCTGTAATCCCAACACTTTGGGAGGCCGAGGTGGGTGGATCACCTGAGATCAGGAGTTCAAGACCACCCTGGCCAACATGGTGAAACCCCGTCTCTACTAAAAATACGAAAATTAGCTGAGTGTGGTGGTGCATGCCTGTAGTCCCAGCTACTCAAGAGGCTGAGGCAGGAGGTGGAGGTTGCAGTGAGCCGAGATTGCATCACTGCACTCCAGCCTTGGCGACAGAACGAGAGAGACTCCATCTAAAAAAAAAAAAAA"
"GL873579","7037162","7037347","chr3","37328686","37328893","67","30291524","GAGGTGGGTGGATTGCCTGAGCTCACAGGTTGGAGACCAGCCTGAGCCAGAGCAAGACCTTATCTCAAAAAATAGCCAGGTGTTGTGGCTGGCACCTGTAGTCCCAGCTGCTCAGGAGGCGGAGGCAAGAGAAATGCTTGACCTCAGGAGTTTGAGGTTGCTGTGAGTTCAACTCACACTAATACA","GAGGCAGGGGGATCACCTGAGGTCAGGAGATCGAGACCAGCCTGGCCAACATGGTGAAAACCTGTCTCTACTAAAAATCCAAAAACATTAGCCAGGTGTGGTGGCACGCACCTGTAATCCCAGCTACTTGGGAGGCTGAGGCAGGAGAATCACTTGAACCTGGGAGGCAGAGGTTGTAGCGAGCCGAGATCACACCACTGCACCCCAG"
"GL873579","11077764","11077972","chr19","1200469","1200683","63","9877295","GCCAGGTGCAGTGGCTCATGCCTATAATCCTAGCACCCTAGGAGGCTGAGGAGTTCAAGACCAGCCTAAGCAACTGTGAGACCCCATCTCTACCAAAAATAGAAAAATTAGCTGACTGTTATGGTGTGCACCTACAGTCCTAGCTACTCAGGAGGCTGAGGCAGAAAGAGTCCTTGAACCCAGGAGGCTTTTTTTTGTTGTTGTTGTTG","GGCCAGTCGCGGTAGCTCATGCCTGTAATCCCAGCACTTTGGGAGGCCGAGGCGGGCAGATCACCTGAGACCAGCCTGGCAACATGGTGAAACCCCATGTCTACCCAAACTACAAAAATTAGCTGGGTGTGGTGGTGCACGCCTGTAATCCGAGCTACTCAGCAGGCTGAGGCAGGAGAATCCCTTGAACCTGGGAGGCAGAGGCTGCAGTGAGC"
"GL873579","11078245","11078333","chr19","4926258","4926351","22","6151987","TGAACCCAGGAGTTTGAGTTCGCTGTGAGCTAAGCTGAGGCCACAGCACTCCAGCCTGGGCAACAGAGTGAAAGGAAAAAAATAAAAAA","TGAACCCGGGAGGTGGAGGTTGCAGTGAGCCAAGATCACACCAATGCACTCCAGCCTGGGCAACAAGAGTGAAACTCTGTCTAAAAAAAAAAAA"
"GL873580","320374","320488","chr13","48549305","48549409","42","48228931","GGTAGTGCGTGCCTGCATTCCCAGCTACGGGAGGGCAGGGACTTGAGGCCAGCCTGGGCAAAATAATGAGACCTACTAATGACTCTACTAATACAGAAACAATTAGCTAGGTATG","TGGGAGGCCGAAGTGCGCAGATCACCTGAGGTCAGAAGTTGGAGACCAGCCTGGCCAACATGGTGAAAACCCATCTCTACTAAAAATACAAAAATTAGCTGGGCA"
"GL873580","374969","375091","chr6","147681010","147681135","27","147306041","CGGTGGCTCACACCTATAATCCTAGCATTTTGGAAGGCTGAAGCCGAGGATCTCTGGAAGTCAGAAGTTCAAGACCAGCCTGCCCAAGAGCAAGACCCCATCTCTACTAAAAATAGAAAAACT","GGTGGCTCACACCTGTAATCCCAGCATTTTGGGAGGCTGAGGCAGGCGGATAATCTGAGGTCAAGAATTTGAGACCAGCCTGGCCAACATGGAGAAACCCTATCTCTACTAAAAATACAAAATTAC"
"GL873580","375369","375549","chr7","19977275","19977456","44","19601906","CTAACCAAGTTAGTTAGTTTTAGTTGGCAGGTGCCTGTAGTCCCAGCTCCTTGGGAGGCTGAGGCAAGAGAATGGCTTGAGCCCAGGACTTTGAAGTTGCTGTGAGCTATAATGACACCACAGCACACTACCCAGGGTGACAGAGTGAGACTGTCTCAAAAAAACAAACAAACAAAAAAAA","AACAAACGTTAGCCGAGCATGGTGGTATGTGCCTGTAGTCCCAGCTACTTGGGAGTCTAAGGCAGGAGAATTACTTGAGCCCGGGAGGCAGAGGTTGCTGTGAGCCAAGATCACGCCACTGCACTCCAGCCTGGGTGACAGAGTGAGACTCCATCTCAAAAAAAAAAAAGGAAAAAAAAAAA"
"GL873580","8760922","8761015","chr11","104681322","104681416","19","95920400","GGAGGGAGACACTGCAGTGAACTGCGATCGTGTCTCTGCTTTCCAGGCTGGGTGACAGAGTGAGACTCGGTCTCTAAAATAAAAAATAAATAAA","GGAGACGGAGGTTGCAGTGAGCTGTGATCGCGGCACTGCACTCCAGCCTGGGCAACAGAGTGAGACTCTGTCTCAAAAATAAATAAATAAATAAA"
"GL873580","9391260","9391306","chr14","49279240","49279285","12","39887980","GCCAGTCGAGGTGGCTCACACTTGTGATTCCAGCTACTTGGAAGACT","GGCTGAGATGGTGGCACACACCTGTAATCCCAGCTACTTGGGAGGC"
"GL873581","759283","759365","chr6","46535476","46535542","30","45776193","TAAGAACCTGAAAATAGAGCCAGGCATAGTGGTACATGCGTATAGTCCTGGCTACTCAGGAGGTTGAAACAACAGGATTACTT","CAAAATAGCCAGGCTTGGTGGTGCATGCCTATAATCCAAGCTACTCGGGAAGCTGAGGCAGGAGAAT"
"GL873581","1145844","1145979","chr1","29437872","29437991","29","28292028","GGCCGGGCGTGGTGGCTCACGCCTGTAGTCCCAGCACTATGGGAGGCCGAGGCGGGTGGATCACCTGTGCTCAGAGGTTCGAGACCAGCCAAGACCCCCCTGAGCCAAATGAGCCAGAGTGAGACCCCGTCTCTAC","GGCCGGGCGTGGTGGCTCACGCCTGTAATCCCAACATTTTGGGAGGCCAAGGCGGGTGGATCACCTGAGGTCAGAAGTTCGAGACCAACCTGGCCAACATGGTGAAACCCCTGTCTCTAC"
"GL873581","9628238","9628362","chr5","141044567","141044691","34","131416329","ATCCCAGGTAGTCGGGAGGCTGAGGCAGGAGGATCACTTGAACCCAGGAGGTTGAGGTTGCTGTGAGCAAGGCAGAGGCAACGGCACTCTAGCCACGGGGGCACAGAGACTCTTGTCTTTAAAAA","TAATCTCAGCTACTCGGGAGGCTGAGGCAGGAGAATCGCTTGAGCCCAGAAGGTGGAGGTTGCAGTGAGCCAAGATCGCGCCATTGCACTCCAGCCTGGGCGACAGTGCGAGACTCTGTCTCAAA"
"GL873582","1580485","1580534","chr6","32576760","32576806","12","30996275","CAGCACTTGAGAGGCCAAGGCAGGTGGATCAACTGAGCAAGAATGAGACC","CCAGCACCTTGAGAGGCCAAGGCAGGTGGATCACCTGAGGTCAGGAG"
"GL873582","1644368","1644551","chr1","211626449","211626612","63","209982081","AAAATTTGCCGGGCTCCATAGCTCATGCATGTAATCATAGCACTCTGGGAGGCCAAGATGGGAGGATCTCTCAAGCTCTCTTACTTGGGAGGCTGAGGTTGCTGTGAGTTAGGCTTACGCCACAGCACTCTACTCTAGCGTGAGCAACTCTACTCTTAGTATGAGACTGTCTCAAAAGAAAAAA","AAATTAGCCAGGCGTCGTGGCACATGCCTGTAATCCCAGCTACTCGGGAGGCTGAGGCAGGAGAATAGCTTGATCTCGGGAGGCGGAGGTTGCAGTCAGCCGAGATCACACCACTGCAATCCAGCCTGGACAACAGAATGAGACTCCATCTCAAAAAAAACAAA"
"GL873582","5794385","5794459","chr13","18872784","18872852","27","13078399","ATATTGTTAAGCACAGCCACTATTAAAAATTAAATTATAGGCCAGGCATAGTGGCTCATGCCTGTAATCCTAGCT","TGAAACCACCATCTGGACCAAGATACAAAATGTTGGCTGGGCATGGTGGCTCACACCTGTAATCCTAGC"
"GL873583","102645","102683","chr14","5808766","5808804","14","5706121","GAGCAGATCACCTGAGCTCAGGAGTTTGAGACCAGCCTG","GAGGAATCCCTGTGCTCAGGAAGCTTACATTCTAGTGAG"
"GL873583","6200447","6200560","chr4","17786849","17786963","24","11586402","GGCCAGGAGGGACGGCTCATGCCTGTTATCCTAGCACTATGGGAGACTGAGGTGGGAGGATCACTTGAAGTTAGGAGTTCCAGACCAATCTGACCAAAGTGAGACCTCATCTCT","GGCCAGGCTTGGTGGCTCATGCCTGTAATCTTAGCACTTTGGGAGGCTGAAGTGGGTGGATCACTTGAGGTCAGGAGTTAGAACCAGTCTGGCCAACATGGTGAAACCTCAGCTC"
"GL873583","6200584","6200752","chr6","169626528","169626696","42","163425944","TTAGCTGGATGTGGTAGCACATGCCTATAGTCCCATCTACTCAGGAGGCTGAGACAAGAGAGTTGCTTAAGCCCAGGAGTTTAATTTAACTGTGAACTAGACTGAGACTGTGGCACTCTAGCTGGGGCAACAGAGTGAGACTCTGTCTCAAAAGAAAGCAAGAAAGAAA","TTAGCTGGGTATGGTGTCAGATGCCTGTAGTCCCAGCTACTCAGGAGGCTGAGACAGGAGAATCGTTTGAACCCAGGAGGCCAGAACTGCAGTGAGCTGAGATTCGCACCACTGCGCTCCAGCCTGGGCCAGACAGAGTGAGACTCTATCTCAAAAGAAAAAAAAAAAA"
"GL873583","10217398","10217583","chr3","36257142","36257313","44","26039744","TACTAAAAATAAAGTGTGATAGCCAGGCATGGTGGTGGTGCCTATAGAACCAGGCTATTCAGGAGGCTGAGGCAGAAGGATCACTTGAACCCAGGAGTCTGACGTTGCTGTGAGCTAGGCTGGTGCCATGGTACTCTAGCCTGTGGTAACAGAATGAGACTCTATCTCAAAAATAAAAATAAAAAA","TACAAAATTAGCCAGGCGTGGTGGTGCGTGCCTGTAATCCCAGCTACTTGGGAGGCCGAGGCAGAAGAATGACTTGAACCCAGGAGACAGAGGTTGCAGTGAGCCAAGATCCCACCATTGTACTCCAGCCTGGGCAACACAGTGAGACTCCATCTCAAAAAAAAAAAAAAAA"
"GL873583","10394919","10394983","chr16","12841703","12841771","22","2446784","GAGGTCAGGAAATCAAGATCAGTCTGGGCAATATATTGATACCCTGCCCCTACATAAGGAAGAAA","AGGTCAGGAGTTCAAGACCAGCCTGGCCAATATGTTGAAACCTCATCTCTACTAAAAATACAAAAATTA"
"GL873584","521512","521529","chr1","167402212","167402233","10","166880700","GCATGGAACCCCCCACTC","GGTGAAACCCCATCTTTACTAA"
"GL873584","2079725","2079768","chr15","4338291","4338335","11","2258566","GGCAGGTGGATTACCTGAGTTCAGGAGTTGGAGACCAGCCTGAC","AGGCGGATGGATCACGAGGTCGGGAGTTTGAGACCAGCCTGACCA"
"GL873584","5216877","5217053","chrX","91350057","91350230","49","86133180","CTACTGAAAATGATGACAGAGGCTGGGCATGGGGGCTCCCGCCTGTTATCCTAGCACCCTCGGAGGCTGGGGAATGAGGATTGCTTACGCCCAAGAGTTTGAGGTTGCTGTGAGCTGAGGCCGCTGCACTCTAGCCTGGGCAACAGAGTGAGACTCTGTCTCAAAAAAAAAAAAAAA","TGCAAAAATGAGCTGGGCATGGTGGCACATGCCTGTAATCCCAGCTACACAGGAGGCTGAGGCAGGAGAATCGCTTGAATCTGGGAGGCGGAGGTTGCAGTGAGCTGACATCAGGCCCCTGCACTCTAGCCTGGGCCACAGAGCAAGACTCCGTCTCAAAAAAAAAAAAAAAAA"
"GL873584","7289930","7289950","chr2","51453328","51453345","10","44163398","TGAGGCTCTGTCTCGAAATAA","AATGCCATCTATTAAAAA"
"GL873584","7289975","7290131","chr11","49739997","49740154","37","42450022","CAAGAAAATTAGCTGAGAGTCCTGGTAGGTGCCTGTAATCCCAGCTATTCATGAGGCTGAGGCAGAAGGATCACTTGGGTCCAGGAGTCTGAGGTTGCTGTGAGCTAGTCTGACGCCATAACACGCAAGCCTGGGCAACAGAGTGAGGCTCGGTTTC","CTACAAAAATTAGCTGGGCGTGGTGGCACATGCCTGTAATCCCAGCTACTCGGGAGGCTGAGGCAGGAGAATCACTTGAGCCCAGGAGGCGGAGGTTGCAGTGAGCCAAGATCATGCCATTGCACTCCAACCTGGGCAACAGAGCAAGACTCCATCTC"
"GL873584","7577743","7577867","chr5","48394329","48394446","27","40816586","GGCTGGATGAGGTGGTTCATGCCTGTAATCCTAGCACTCTGGGAGGCCAAGGTGGGTGGATTGCCTGAGCTCAGGAGTTCAAGACCAGCCTGAGCAAGACCCTGTCGCTAAAAATAGCTGGGTGT","GGCTGGGTGCAGTGGCTCATGCCTGTAATCCCAGCACTTTGGGAGGTCAAGGCGGGTGGATCACCTGAGGTCAGGAGTTCAAGACCAGCCTGGCCAACATCTCTACTAAAAATACAAA"
"GL873584","7578135","7578289","chr1","130112713","130112865","31","122534578","GGAGCTGGGTTTTGTGACTGCACCTGTAATCCCAGCTGCTCAGGAGGCTGAGGCAAGAGAATTGCTTGAGCCCAGGAGTTGGAGGTTGCTGTGAGCTGTGATGCCAGGGAACTCTACCAAGGGTGACAAAGTGAAACTCTGTCTCAAAAAAAAAA","TTAGCCAGGTGTGGTGATGCATGCCTGTAATCCCAGCTACTCATGAGGCTGAGGCAGGAGAATTGCTTGAACCTTGGAGCTGGAGGTTGCAGTGAGCTGAGATCAGACCACTCCAACCTGGGTGACAGAGCGAGACTCTGTCTCAAAAAAAAA"
"GL873585","1450952","1451121","chr10","59681079","59681242","48","58230127","TAAAAACAGAAAAAACTAGTCAGGTGGTGTGGTAGGTGCTCATAAGTCCCAGCTGCTTGGGAGACTGAGGCAAGAGAATCACTTGAGCACAAGAGCTTGAGGTGGCTGTGAGCTATAACACCATAGCACTGTACTGAGGGTGACAAAGTAAGACTCTGTCTCAAAAAAAA","TACAAAAATTAGTCAAGGGTGGTGGTATGTGCTTGTAATCCCAGCTATTTGGGAGGCTGAAGCAGGGGAATCCTTGAACCCAGGAGGTGGAGGTTGCAGCGAGCCGAGATCACGTCACTGCACTCTAGCCTGGGCGATAGGGTGAGACTCTGTCTCAAAAAAAA"
"GL873585","1451382","1451515","chr6","17405813","17405948","24","15954431","GGCCCGGCTCGGTGGCTCACACCTATAATCCTAACACTCTGGGAGGCTGAGGCAGGTGGATCACCTGAGCTCAGGAGTTTGAGACCAGCTGAGCAAAAACAAGACCCTATCTCTGCTAAAAATAGAAAAAACTA","GGCCGGGCGGGGTGGCTCACGCCTGTAATCCCAGCACTCTGGGAGGCCAAGGCAGGTGGATCACCTGAGGTCAGGAGTTTGAGACCAGCCTGGCCAACACGCAGAAACCCTATTTCTACTAAAAACACAAAAATTA"
"GL873585","1626960","1627026","chr7","17782729","17782794","22","16155769","AAGATGCCACAGCACTCTACAAGAGTGACCAAGTGAGACTCTGTCTCAAAAAAAAAAAGAAAAGGAA","CAATCGCACTACTGCACTTCAGCCTGGGTGACAGAGTGAGAACCTGTCTCAAAAAAATAAATAAAA"
"GL873585","1627304","1627531","chr11","17033552","17033788","61","15406248","GGCTGGGCACAGTGGCTCACGGCTATAATCTAGGCACTTGGGAGGCTAGGGCAGGTGGATTGCCTGAACTGACAAGTTTGAGACCAACCTGAGCAAGAGCGAGACCCCTGTCTCTAAAACATAGCCAGGCTCTGTGGTGGGCGTCTGTAGTCCCAGCTACTTGGGAGGCTGAGGCAAGAGAATTGCTTGAACTCAAGAGTCTGAGGTTGCTGTGAGTTAAGATGCCAC","GCCCGGCGCAGTGGCTCACGCCTGTAATCCCGGCACTGTGGAGGCCAAGGCAGGCGGATTGCCTAAGCTCAGGGATTCGAGAACAGCCTGGGCAACATGGTGAAACCCCATCTCTACTAAAATACAAAAAACTAGCCGGGCGTGGTGGTATGCGCCTGTAATCCCAGCTACTTGGGAAGCTGAGGCAGGAGAATTGCTTGAACCCGGGAGATGGAGGTTGCAGTGAGCTCAGATCAC"
"GL873585","3626082","3626158","chr1","100916857","100916922","27","97290775","TGCCTGTAATCCCAGCACTTGGGAGGCGGAGGTGGGTAGATTGCCTGACCCAGAGTGGGACCTCATCTCTAAAAGAA","CATGCCTGTAATCCCAGCACCTTGGGAGGCCAAGGTGGGTGGATCACCTGAGGTCAGTAGTTTGAG"
"GL873585","8849829","8849913","chr18","48581945","48582025","18","39732116","GGCTGGACGAGGGGACTCATGCCTGCAATCCCAGCACTGAGAGAGGCCAAGGCAGGTGGATCCCCTGAGCTCAGAAGTTTGAGAC","GCTGGACGCAGTGGCTCACACCTGTAATCCCAGCACTTTGGGAGGCCAAAGCAGGCAGATCTGAGGTCAGGAGTTTGAGAC"
"GL873585","9319890","9319971","chr8","79499361","79499447","14","70179471","GGCCAGGTGTGGTGGCTCACACCTGTCATCCTAGCACTCTGGGAGGACGAGGTGGGTGGACCGCCTGAGTCAGAGTGAGACC","GGCCAGGTGTGGTGGCTCACACCTGTAATCCCAACACTTTGGGAGGCCCAGGTGGGTGGATCACCTGAGGTCAGGAGTTCAAGACCA"
"GL873586","895572","895692","chr17","14501559","14501680","38","13605987","GGCCAGGTGAGGTTTCTCATTCTGGGAGTGAGCCAGCAATTGGGAGGCCAAAGTAAATGGATTGCCTGAGGTTATAGGTTCCAGAACAGCCAGAACAAGATCGAAATCCTGTCTCCAAAAA","GGCCAGGCGTGGTGGCTCATGCGTGTAATCTCAGCACTTTGGAAGGCCGAGGCAGGTGGATCACCCGAGGTCAAGAGTTCAAGACCAGCCTGACCAACATGGCGAGTCTCTGTCTCCACTAA"
"GL873586","5645995","5646150","chr6","58863249","58863409","38","53217254","GGGTATGGTGGCTCATGCCTGTAATCCAAGCACTCTGGGATGGTGAGGCAGGAGAATCCCTTGAACCCAAGAGTCCGAGGTTGCTGCGAGCTAAGCTGATGGCATAACACTCTAGCCTAGGCGACAGAGTGAGACTCTGTTTCCAAAGAGAAAAAA","TTAGCCAGGCATGGTGGCACATGCCAGTAATCCCAGCTACTCAGGAGGATGAGGCAGGAGAATCGCTTGAACCCAGGAGGCAGAGGTTGCAGTGAGCTGAGATTGCGCCACAGCACTCTACCCTGGGTGACAGAAGGAGACTCTGTCTCAAAAAAAAAAAA"
"GL873586","10258686","10258969","chr12","9481260","9481565","81","777426","GGCCGGGCATGGTGGCAGAAATCTAGGAGGCCGAGGCAGGTGGATCGCCTGAGATCACAAGTTCAAGACCAGCCTCAGCTACAGCAAGACCCCATCTCTAAAAATAGCCGGCTGTTGTGGCAGGCGCCTGTAACCCCAGCTACTCGGGAGGCTAAGGCAAGAGAATCGCTTGAGCCCATGAGTCTGAGGTTGCTGCGAGCTGTGACTCCACGGCACTCTACCCGGGGCGATAAAATGAGATTCTGTGTCAAAACAAACAAACAAACAAACAACAACAAAAACAA","GCTGGGCGCGGTGGCTCATGCCTGTAATCCCAGCACTTTGGGAGGCCAAGGCAGGTGGATCACCTGAGGTCAGGAGTTCGAGACCAGCCTAGTCCACATGGTGAAACCCCATCTCTACTAAAAACTAGCCAGGCGTGGTGGTGCGCACCTGTAATCCCAGCTACTCGAGAGGCTGAGGCAGGAGAATCACTTGAGCCTAGGAAGCAGAGGTTGTGGTGAGCTGAGATCACACCACTGCACTCCAGTCTGGGCGACACAGTGAGACTCTTGTCTCAAAAACAAAAAACAAACAAACAAACAAACAAA"
"GL873587","3208032","3208047","chr8","3626746","3626762","2","418714","AAACAACCACAAAAAA","ACAACAACAACAAAAAA"
"GL873587","3208141","3208321","chr19","2057131","2057316","59","1151010","TTTCTTTTAAAAATCACCCATGGGCTGGGTATAGTGGCTCACACCTATAATCCTCGGGAGGCCAAGGTTGGAGGATTGCTTGAATCCAGGAGTTGAAGGTTACAGTGAACTGGGATTTAGCCACTAGACTCTAGCATAGCTGACAAAGCAAGAACCTATTTGTTTAAAACACAAAAAAGAA","TACTAATAATACAAAAATGAGCCGGGTATGGTGGCGGGTGCCTGTAATCCCAGCTACTGAGGAGGCTGAGGCAGGAGACTTGCTTGAACCCAGGAGGTAAAGGTTGCAGTGAGCTGAGATTGCACCACTACACTCCAGCCTGGGCGACAAGAGCAAAACTTTTTCTCCAAAAAAAAAAAAAAAAAA"
"GL873587","3278260","3278367","chr19","19044200","19044312","39","15765940","CAGTCTGAGCAAGAGGGAGAGGCTATTTCTACTAAAAACAGAAAAACTAGCTGGGTGTTGGGGTGTGTTCCTAGTCTCAGTTACTTGGGAGGCTGAAGTAAGAGGATC","ACCAGCCTGGCCAACACGGTGAAATCCCGTCTCTACTAAAAATACAAAAATTACCTAGGCGTGATGGCACGTGCCTGTAGTCCCAGCTACTCATAAGGCAGAGGTGAGAGAAT"
"GL873587","3278673","3278754","chr7","49412503","49412597","28","46133830","GGCCACGAGAGCTAGCTCATGCCTATTCTAGGAGGCCAAAGCAGGCAGACTGCCTGAGCTCAGGAGTTCAAGAGCAGCCTGG","GGCCAGGTGCAGTGGCTCATGCCTGTAATCCGAGCACTTTGAGAGGCCGAGGCAGGCAGATCACCTGAGGTCAGGAGTTCAAGACCAGCCTAGTA"
"GL873587","3782076","3782188","chr9","112128434","112128552","34","108346358","ACTGGGGTGGCTGAGGCAGGAGCGTCACTTGAACTCAGGAGTTTGAGATTGCTGTGAGCTGAGCAGATGTCATGGCACGCTAGCCTAGGTAATAGAGTGAGACTTCGTCTAAA","CAGCTACTCGGGAGGCTGAGGCAGGAGAATCACTTGAACTCGGGAGGCGGAGGTTGCAGTGAGCCGAGATCACGCCATTGCACTCCAGCCTGGGCAACAAGAGCGAAATTCCATCTCAA"
"GL873587","4564996","4565084","chr20","27900350","27900437","14","23335354","GGCGGGGTGTAGTGGCTCATGCCTATTGTCCCAGCACTGTGGGAGGCCGAGGTGGGTGGATCACCTGTGCTCAGAAGTTTGAGACCAGC","GGCCGGGCGTGGTGGCTCATGTCTGTAATCCCAGCACTTTGGGAGGCCGAGGTGGGTGGATCACCTGAGGTCAGGAGTTCAAGACCAG"
"GL873587","6307870","6308175","chr12","112427710","112428020","54","106119840","GGCCAGATATGATGGCTCATGCTTGTAATCCTAGCACTCTGGGAGGCTGAAGTGGGAGGATCACCTGAGATCAGGAGTTCAAGATCACCCTGAGCAAAAGTGAGATCCCATCTCTATTAAAAATAAAAAAATTATCCAGGCATGGTGGTGCAGTCCTTTAGTCCCAGCTACTTGGGAGGCTGAGGCAGGAGAATCTCTTGAACCCAGGAATTAGAGGTTACAGTGAGCTGTGATGATGCTACTGCACTCTAGCAGGATGACAGAGTGAGATACTCCGTGTCAAAAAAAAAAAAAAAAAAAGCAAAA","GGCTGGACATGGTGGTTCATGCTTGTAATCCGAGCACTTTGGGAGGCCAAGGCGGGTGGATCACCTGAGGTTGGGAGTTCGAGACCAGCCTGACCAACATGATGAAACCCCATCTCTACTAAAAATACAAAAAAATTAGCCAGGCATGGTGATGCACGCCTGTAATCCCAGCTACTTGGGAGGCTGAGGCAGGAGAATCACTTGAACCCAGGAGGCAGAGGTTACAGTGAGCCGAGATCATGCCATTGCACTCCAGCCTGGATGACAGAGTGAGCCTCTGTCTCAAAAAAAAAAAAAAAAAAAAAAAAAAA"
"GL873587","6484004","6484128","chr10","67341428","67341546","29","60857424","GACCAGGTTCTGTGGCTCATGCTTGTAATCCTAGCACTCTAGGAGGCCGGAAGAGGGTGGATTGATTGCCTGAGGTCAGGAGTTAGAGACCAGCCTGAGCAAGAGCTAGACCCTGTTTCTTTCTT","GGCTGGGTGTAGTGGCTCATGCCTGTAATCCCAGCACTTTAGGAGGCCAAGGTGGATGGATTGCCTGAGCTCAGGAGTTCGAGACCACCCTGGGCAACAAGCCAAAACCCTGTCTCTAC"
"GL873587","6484407","6484586","chr3","167196537","167196723","48","160712130","TAGACCCTGTTTCTAAAAAAAAAATAGCCAGGTGTTGAGGCAGGTACCTGTAGTCCCAGCTACCTGGGAGGGCTGAGGCAAGAGAATCGCTTGAACCCAAGAGTTTGAGGTTGCTGTGAGCTGAGATGCTATGGCACTCAACCGTGAGCTACAAAGTGAGACTCTGTCTCAAAAAAAAAA","AAAACCTGTCTCTGCTAAAAATACAAAAATTAGCCGGGTGTGGTGATGTGCGCCTGTAGTCCTAGCTACTTGGGAGGCTGAGGCAGGAGAATCACTTGAATCCAGGAGGTGGAGGTTGTAGTGAGTCGAGATCGTGCGACTGCACTCCAGCCTGGGTGACAGCGAGACTCTGTCTCAAAAAAAAAAA"
"GL873587","7466229","7466364","chr1","29437872","29437991","35","21971643","GGCCAGGCGTGGTGGCTCATGCCTGTAGTCCCAGCGCTATGGGAGGCCGAGGTGGGTGGATCACCTGTGCTCAGAGGTTCGAGACCAGCCAAGACCCCCCTGAGCCAAATGAGCCAGAGTGAGATCCCATCTCTAC","GGCCGGGCGTGGTGGCTCACGCCTGTAATCCCAACATTTTGGGAGGCCAAGGCGGGTGGATCACCTGAGGTCAGAAGTTCGAGACCAACCTGGCCAACATGGTGAAACCCCTGTCTCTAC"
"GL873588","1502535","1502718","chr1","34852429","34852590","60","33349894","GGTGCAGTGGCTCACACCTGTTGTCCCAGCGCTGTGGGAGGCCGAGGTGGGTGGATCACCTGTGCTCAGAGGTCGAGACCAGCTGAAGACCTGCCTGAGGCAGAGTGAGCCAGAGTGAGACCCCGTCTCTACTAGAACAACAACAAGACAGCCAGACCTTGTGATCCCAGCTACATGGGGGGCT","GCCAGGTGCAGTGGCTCACACCTGTAATCCCAGCACTTTGGGAGGCCGAGGCGGGCGGATCACCTGAGGTCAGGAGTTTGAGACCAGCTTGACCAACATGGAGAAACCCCGTCTCTACTAAAAATACAAAATTAGCCTGGTGTGGTGTCGCATGCCTGTAAT"
"GL873588","10189037","10189246","chr3","45604681","45604903","65","35415644","GCTGAGATGAGGAGACTCTGTCTCTATTAAAAATAGAAAAATTGGGTGGATGTTGTGGGTACTGTAGTTGCAGCCTCTTGGGGGGCTAAGGCAGGAGGATCAGTTGAAGCCAGGAATTTGCTTTGAGCTAGGCTAAAGCCATGGCACTCTAGCCTGGGCAACAGAGTGAGGCTAGATCTCAAAAAAAGAAAGAAAAGAAAAAGAAAAAAA","CTGGCCAACATGGCAAAACCCCATCTCTACTAAATATACAAAAATTAGCTGGACGTGGTGGCACATACCTGTAATCCCAGCTACTTGGAAGGCTGAGGCAGGAGAATAGCTTGAACCTGGGAGGCAGAGGTTGCAATGAGCTGAGATCACGCCACTGCACTCTAGCCTGGGCAATAGAATGAGACTCTGTCTCAAAAAAAAAAAAAAAAAAAAAGACAAGAAA"
"GL873589","104719","104807","chr20","27900350","27900437","13","27795631","GGCTGGGCGTGGTGGCTCATGCCTGTTGTCCCAGCGCTGTGGGAGGCTGAGGTGGGTGGATCACCTGTGCTCAGAGGTTCGAGACCAGC","GGCCGGGCGTGGTGGCTCATGTCTGTAATCCCAGCACTTTGGGAGGCCGAGGTGGGTGGATCACCTGAGGTCAGGAGTTCAAGACCAG"
"GL873589","796766","796905","chr1","166346372","166346487","49","165549606","GGCTAAGTGTGGTGGCTCACACCTGTCATCTAGTACTTTGGGAGGGTGGGCCTGGGAGTTCAAAGACTGAACTCAGGAGTTCAAGGTGGCTCCGGGGAGGAATTCAAGACCAACCTGAGCCAGAGCGAGACCTCGACTCT","GGCCAGTGGGGTGGCTCACGCCTGTAATCCCAGCACTTTGGGAGGCTGAGGTGGTCAAATGACCTGAGGTCAGGAGTTTGAGACCAACCTGGCCAACATGGTGACACCTCGTCTCT"
"GL873589","1023679","1023690","chr1","205890061","205890072","1","204866382","AAAAAAAAAAAA","ACAAAAAAAAAA"
"GL873589","1023771","1024047","chr4","103012712","103012993","70","101988941","GGCTTGGTGGCTCACACCTGTAATCCTAGCACTCTGGGAGGCCGAAGTGGCTGGAATACTTGAGGTCAGGAGTTCAAGACCAGCCTAAGTGAGAGTGAGATCCCCATCTCTAATAAAAATAGAAAAATTAGCAGGGTGTTGTGGCTGGCACTTGTAGTCCCAGCTACCCAGGAGACCGAGGCAGAAGTTTGAGATTATTGTGAGCGAGGCTGATGCCACAGCATTCTAGTGGGACAACAGAGCAAAATTCTATCTCAAAAGAAAAAAAAAAAAAGGA","CGGGCGTGATGGCTCACGCCTGTAATCCCAACACTTTGGGAAGCCGAGGCGGACGTATCACCTGAGGTCAGGAGTTCAAGACCAGCCTGGCCAACATGGTGAAACCCCGTCTCTACTAAAAATACAAAAATTAGCTGGGTGTGGTGGCATGCGCCTGTAATCCCAGCTACCCAGGAGGCTGAGGCAGGAGAATCGCTGAGGCTGCAGTGAACTGAAATTGTGCCACTGCACTCCAGCCTGGGTGACAGAGCAAGACTCTGTCTCAAAAAAAAAAAAAAAAAA"
"GL873589","4820958","4821024","chr8","33633747","33633811","15","28812789","TTAGTCAAGTGCAGTGGCTCACACCTGTCATCCCAGCTACTTGGGAGGCTGAGGCAGGAGAGTTGCT","TTAGCCAGGTGTGGTGGTGCATGCCTCTAATCCCAGCTACTCAGGAGGCTGAGGCAGGAGAATTG"
"GL873589","6763768","6763857","chrX","25814002","25814092","29","19050234","GGTGTGGTGGCTCACACTTGTATCTTAGCATTTTAGGAGGCTGAATGGGGAGAATTGCTTTAAGTCAGGAGTCTGACTTCCACCTTGCCA","GGCTGGGAATGGTGGCTCACACCTGTAATCCCAGCACTTTGGGAGGCTGAGGTGGGCAGATCACCTGAGGTCAGGAGTTTGAGATCAGCCT"
"GL873589","8444551","8444632","chr9","93194085","93194171","17","84749534","CGGGCATGGTGGCTCACAACTATAATCTTAGCACTTTGGGAGGCTGAGACAGGTGGATGCCTGAACTCAAGAGTTTGAAACC","GGCCGAGCATGGTGGCTCACACCTGTAATCCCAGCACTTTGGGAGGCTGAGGCAGGTGGATTACCTGAGGTCAAGAGTTCAAGACCA"
"GL873589","9085365","9085494","chr2","194063347","194063481","42","184977982","GGCCAGGCACAGTGGCTCACACCTATAATCCCAGCACTCTGTGAGACTGAGGCAGGTGAACTGTTGCAAGAGTGAGACCCTGTGCTTGGTGCCTGTAGCTCAGTGGTTAATAATAAGAAAAAAGAAAAAA","GGCCAGGTGCAGTGGCTCACACCTGTAATCCCAGCACTTTGGGAGTCTGAACCAGGCAGATCACCTGAGGTCAGGAGTTCGAGGCCAGCTCGGCCACCATGGTGAAACCCTGTTTCTAATAAGAATACAAAAAAA"
"GL873589","9085767","9086002","chr7","84631446","84631650","75","75545679","GAGTGAAACCCTGTCTCTACTAAAAATAGAAAAACTAGCTGTGCATCAGGGCGCATAACTGTAGTCCCAGGTACTCAGGACACTGAGGCAAGAGAATTGCTCAAGCCCAAGAGTTTGCAAGAATTTGAGGTTGCTATGAGCTATGATGCCATGGCACTCTACCTAGGGTGACAGACAGAGACTCTGTCCCAAAAAAAAAAAAAGAAGAAGAAGAAAAAAAAAAAGAAAGAAAGAAA","ATAGTGAAACCTCGTCTCTACTAAAAATACAAAAATTAGCTGGGCATCATGGTGCACGCTTGTAATTCCAGCTACTTGGGAGGCTGAGGCAGGAGAATTGCTTGAACTCAGGAGGTGGAGGTTGCAATGAGCCAAGATCGCGCCACTGCACACCAGCCTGGGTGACAAAAGACTCTGTCTCAAAAAAAAAAAAAAAAAAAAAAAA"
"GL873589","9992904","9993045","chr16","56427538","56427666","46","46434634","AACCAGCCAGGCATGGTGATTCACACCTATAATCCCAGCTACTTAGGAGTATGGCTTGAGCACACAGGATACCATACCATTCTAGTCATCCCAGGCAACAGAGGGAAACTCTGTTGGTTAAAAAAAAAGAAAAACTTAAAAA","TTAGCCAGGAGTGGTGGTGCACGCCTATAATCCCAGCTACTTGGGAGGCTGAGGCACAAGAATCACTTGAACCATTGCACTCCAGCCAGGGTGATAGAGGGAGACTCTATCCAAAAAAAAAACAAAAAA"
"GL873589","9993319","9993452","chr3","2774534","2774668","28","7218785","GGCCTGAGCCCTGTGACTCATGCCTGTAATCCCAGCACTGGAAGTTCCAAGGCAGGTGGATCGCTTGAGCTCTGGAGTTCAAGACCAGCTCAACCAAGAGTAAGACCCCATCTCTACTAAAAATAGAAAAACCA","GGCTGGGCACGGTGGCTCATGCCTGTAATCCCAGCACTTTGAGAGGCCGAGGCAGGTGGATCTCCTGAGGTCAGGAGTTCAAGACCAGCCTGGGCAACATGGTGAAACCCCATCTCTACTAAAAATACAAAAAAT"
"GL873590","9044589","9044884","chr1","83754525","83754835","84","74709936","GGCCAGGTGCAATGGCTCATGCCTATAATCCTCACACTCTGGGAGGCTGAGGCAGGAGGATCACTTTTCTCAGGGTCAGGGCCAGCCTGACAAAAGTCAGACCCTGTTTCTACTAAAAATAGAAAAACTAGCTGGGTGTTGTGGCAGATGCCTATAGTCCCAGCTACTAAGAGACTGAGACAAGTGCCCAGAGTCTGAGGTTACTGTGAGCAAAGCTGATGCCATAGCATTCTAGCTATAGATCGAGAGTCTGTCTCAAAAACAAACAAACAAACAAACAAACAAACAAAAAAGAA","GGCTGGGTGTGGTGGCTCATGCCTGTAATCCCAGCACTTTGGGAGGCCGAGGCGGGTGGATCATCTGAGGTCAGGAGTTCAAGACCAGCCTGACCAACATGGTGTAACCCTGTCTCAACTAAAAATACAAAAATTAGCTGGGCGTGGTGGTGTGCACCTATAGTCACAGCTACTTGGGAGGCTGAGACAGGAGAATTGCTTCAACCCAGGAAGTGGAGGTTGCAGTGAGCCAAGATCATGTCACTGCACTGCAGCCTGACAGAGCGAGACTCCATCTAAAACAAACAAACAAAAACAAACAAACAAACAAA"
"GL873591","1831505","1831587","chr17","61702818","61702899","25","59871313","CCCAGCACTTTGGGAGGGCAAGATGGGAGAATCATATAAAGTCAGGAGTTTGAGACCAGTTTGGCAGACATGATGAACCCATC","AATCCCAGCACTTTGGGAGGCTGAGGCAGGCGGATCATCTGAGGTCAGGAGTTCAAGACCAGCCTGGCCAACATGGTGAAAC"
"GL873591","2719175","2719275","chr4","86137755","86137847","32","83418580","GTGGGGGCTTAGGCCTGTAATCCCAGCACTCTGAGAGGCCAAGGTGAGCTGGTCACCTGGGTTTAGGAGTTTGGAGACTTGCTCGAGCTAGACTGAGGCTC","GTGGTGGCTCACGCCTGTAACCCTAACAATTTGGGAGGCCAAGGCAGGTGGATCACTTGAGGTCAGAAGTTTGAGACCAGCCTGGACAATATG"
"GL873591","4732974","4733120","chr19","7991801","7991954","55","3258827","ATACGCAGACTGGCCGAGCGTGGTGTCACATGCCTATAATCCCAGTGGCTACTCTGGGGAGGAGAATCTCTTGAAACCAAGAGTTAGAGATTGCAGTGGGGTATGATACAGGGTAACAAAGAGAGACCTTGGATCTGAAAAGAAAAA","AAAATACAGAAACTAGCTGGGCATGGTGATGCACACCTGTAATCCTAGCTACTGGGGAGGCTGAGGCAGGAGAATTGCTTGAACCCAGGAGTCAGAGGTTGCAGTGAGCAACCAGCCTGGGTGATACAGTGAGTGAGACTCTGTCTCGAAAAAA"
"GL873591","6822728","6823009","chr1","20579766","20580052","72","13757038","GGCCAGGCGTGGTGGCTCATGCCTGTAAATCTCAGCACTCTGGGAAGCTGAGGCAGGTGGATTGCTTGAGGTCAGGAGTTTGAGACCAGCCTGTACCAGAGTAAGACCCTGTCTCTAATAAAAATAGAAAAAAAAAAAAAAACTAGTTGGGCATGGTGATGGGTGCCTGTAGTCCCACCTACTTGGGAGGCTGAGGCAATGGCATCTCTTGAGCCCAAGAGTTTGAGGTTGCTGTGCCATGGCACTCTCCCCAGGGTAACAGAGTGAAAATAAAAAAAAGAA","GGCCAGGCGTGGTGACTCATGCCTGTAATCTCAGCACTTTGGGAGGCCGAGGCAGGTGAATCACCTGAGGTCAGGAGTTTGAGACCAGCCTGACCAACATGGTGAAACCTCGTCTCTACTAAAAATACAAAAAGTAGCCAGGCATGGTGGCGCATGCCTGTAATCCCAGCTACTTGGGAGGCTGAGGCAGGAGAATCGCTTGAACCCGAGAGGCAGAGGTTGCATTGAGTCAAGATGGTACCACTGCACTCCAGCCTGGGTGACAGATTGAGACTCAAAAAAAAAAA"
"GL873591","7578706","7578813","chr16","45055441","45055543","42","37476735","AAATTTAGCTACACATAGTGGCATGAGTCTGTAATGCTAGCCACCCAAAAGGCTGTAGTAAGAGGATTGCTCTATCCCAGGAGTTAAAGACCAGCCCGGACATCAGAG","AATTAGCCGGGCGTGGTGACACACACTTGTAATCCTAGATACTCAGGAGGCGAAGGTAGGAGAATTGCTTGAACCCAGGCAGCAGAGGTTGCAACGAGCAGAG"
"GL873591","9282916","9283004","chr1","20744253","20744338","16","11461337","GGCCAGGCGCGGTGGCTCACCCCTGTTGTCCCAGTTCTGTGGGAGGCCGAGGTGGGTGGATCACCTGTGCTCAGAGGTTTGAGACCAGC","GGCCAGGCACGGTGGCCACGCCTGTAATCCCAGCACTTTGGGAGGCCGAAGTGGGTGGATTACCTGAGGTCAAGAGTTTGAGACCA"
"GL873592","835155","835315","chr16","75654291","75654451","43","74819136","CTGGGTGTGGTGGCTCTTGTCTGCAATCTCAGTACACTGGGAGGCTGAGGCAGAAGGATTGCTCCAGCTCAGGAGTTTGAGGCCAGGCTGAGCTAGTGCAAAACCCCATCTCTACTAAAAAAAGAAGGAAAAAAAAAAGAAAAAGAAAAAAAATACGAGCT","CCAGGTGTGGTGACTCACGCCTGCAATCCCAGCACTCTGGGAGGCTGAGGTGGGTAGATTACCGGAGGTTAGGCGTTTGAGACCAGCCTGGCCAACATGGTGAAACCCCATCGCTACTAAAAAAAAAAAAAAAAAAAAAAAAAAAAAAAAAAAAAAAATTA"
"GL873592","835589","835765","chr1","66836166","66836336","48","66000577","ACAAAAAACCTAGCTTAGGGTTGTTATAGCACCTGTAGTCCCAGCTACTCAGGCGCTAAGGCAGGAAAATCTGCCTGAGCTCAGGAGTTTGAGGTTGCAGTAAGTTATGATGATGCTACTGCACTCTAGCTGGGGCAACAGAGTGAGACTCTGTCTGAGGAAAAACCAAAACCAAAA","TAGCCCAGCACGGTGGCTCACACCTGTAGTCTCAGCTACTCAAGAGGCTGAGGCATGAGAATCGCTTGAACCCAGGAGGTAGAGGTTGCAGTGAGCTGAGATCATGCCACTGCGCTCCAGCCTGGGCAACAGAGTGAGACTCAGTCTCAAAAAACAAAACAAAACAAAAAA"
"GL873592","2520661","2520705","chr16","66853217","66853257","11","64332556","TCTGGGAGGCTGAGGCGGGTGGATCACCTGAGCAAGAGTGAGACC","TTTGGGAGGCTGAGGCAGGTGGATCACTTGAGGTCAGGAGT"
"GL873592","4535248","4535388","chr1","12240468","12240612","38","7705220","GGCGGGATGTGGTGGTTCATGGCTGTAATCCCAGCACTCAGGGAGGCTGAGTCGGGTGGATTGCTTGAGTTCAGGAGTTTGAGACCAACCTGAGCAAGAACTAAGCCTGTCTCTACTAAAGATATTATTTCTTATTTTTCT","GGCCGGGCGCGGTGGCTCATGCCTGTAATCCCAGCACTTTGGGAGGCTGAGGCGGGTGGATCACCTGCGGTCAGGAGTTCGAGACCAGCCTGGCCAACGTGGTGAAACCTCATCTCTACTAAAAATATAAAAATTAGCTGGTGTG"
"GL873592","4535654","4535831","chr8","126054004","126054184","54","121518350","TCTACTACAAATATTAACAGAAAAATTAGCTGGGCATTGTGACAGGTGCCTATAGTCCCAGATACTCAGAAGGCTGAAGTAAGAGGATCACTTGAACCCCAGGAGCTAAGGTGGCTGTGAGCTAGGCTGAGGCTCTAGCCTGGGTAACAGAGTGAGACTGTAAAAAAAGAAAGAGAGA","GTCTCTACTAAAAATACAAAAATTAGCTGGGTGTGGTGGTGCATGCCTGTAATCCCAGCTACTCAGGAGGCTGAGGCAGGAGAATCGCTTGAACCCAGGAGGTAGAGGTTGCAGTGAGCCAAGATCATGCCACTGCACTCCAGCCTGGGTGACAGAGGGAGACTCTGTCTCAATAAATAAA"
"GL873592","6794968","6795049","chr3","154764711","154764794","20","147969743","GAAGGTTTGATGAGCTCAGATGATGCCACTGCAGTCTACCCAGAGTGAAGGAGCGAGACTCTGTCTCAAAAACAAAAAAAGA","CAGAGGTTGGCAGTGAGCTGAGACTGTGCCACTGCACTCCAGCCGGGTGACAGAGTGAGACTCTGTCTCAAATTACAAACAAAA"
"GL873592","6881384","6881478","chr5","24882384","24882475","28","18001000","GGGCAGGCATAGTGACTGGTGTCTCTAATCCTAGCAGTCTGGGATGCTGAGGCAAGTGGAATGTCAGAGTTCAGGAGTTGAAGATCACCCTGACT","GGCCGGGCGCAGTGGCTCACATCTATAATCCTAGCATTTTGGGAGGCTGAGGCAGGCGGATCACCTGAAGTCAGGAGTTTAAGACCAGCCTG"
"GL873592","6881755","6881937","chr10","61601371","61601572","66","54719616","TCACCCTGACCAAGAGCAAGACCCTGTCTCTACTAAAAATAGAATAAACTAGCTGGGAATTGTGGTGGGTGCCAGTAGTCCCCGCTACTGAGGCAGGAGGATCATTGAGTCCAAGAGTTTGAGGTTGCTGTAAGTTAGGACACCACAGCACTCTACACAGAGTAAGACTGCCTCAAAAATAAA","AGTAAAGAAAAGAAACCCTGTCTCTACTAAAAATACAAAAATTAGCTGGGTGTGGTGGTGCGCACCTGTAGTCCCAGCTACTTGGGAGGGTGAGGTATGGGAATCACTTGAACCCGGGAGGTGGAGGTTGCAGTGAGCCAAGATCACACCACTGCACTCCAGCCTGGGTGAGAGAGTGAGACTCTGTCTCAAGAAAAAAGAA"
"GL873592","7006080","7006155","chr1","8947061","8947129","24","1940981","CACACTGAGAGGCAAAGGCTGGTGGATCACCTGAGCTCAAGAGTTTGAGACCAGCCAAGCCAGAGATCTTGTCTCT","CACTTTGGAGCCAGGTAGGTGATCACCTGAGTCAGGAGTTCGAGACAGCCTGGCCAACATGTGAAACCC"
"GL873592","8446508","8446655","chr11","122502739","122502874","48","114056231","TTAGCTGGGTGTTGTGGCAGGCACCTGTAGTCCCTCCCAGCTACTTGAAAGGCTGAGGCAAGATGACAGCTTAAACCCAAGAGTTTAAGGTTACTCTATTCAGGGCAACAGAGTGAGACTCCATCTACATAAATAAATAAATAAATAA","GGCTGGGCGTGGTGGTTCACACCTGTAATCCCAACACTTTGGGAGGCTGAGGCCAGCGGATTGCCTGAGCCCAGGAGTTTGAGACCAACCTGGGCAACATGGTGAAACTCCATCTCTACTAAAATACAAAAAGTTA"
"GL873592","8446953","8447008","chr16","44513352","44513404","15","36066399","GACCAGCCTAAGCAAAAAAGAGATCCTATCTCTACTACTAAAAATAGAAAAAATTA","ACCAGCCTCACCAATATGAAGAAACCCCATCTCTACTAAAAATACAAAATATT"
"GL873592","8447239","8447325","chr1","8062863","8062957","21","384376","GGCCAGGAGCAGTGACTCATGCCTAGCACTCTGGGAGGCCAAAGCAGGTGGATCAACTGAGCTCAGGAGTTCAAGACCAGCCTAAGC","GGCCGGGTGCAGTGGCTCATGCCTGTAGTCCCAGGACTTTGGCAGGCCAAGGCCGGTGGATTACCTGAGGTCAGGAGTTCAAAACCAGCCTAGCC"
"GL873592","8723925","8724000","chr3","42066983","42067054","20","33343058","AATTAGCCGGGCATGGTAGTGTGTGCCCATAATCTCAGCTACTCAGAAAGCTAAGATAGGAAAATTGCTTGAGCTC","TTAGCTGGGTGTGGTAGTGCATGCCTATAATCCCAGCTACTCGGGAGGCTGAGGTGGGAGAACTGCTTGAAC"
"GL873593","384022","384146","chr15","102382935","102383070","28","101998913","GGCCACGAGGGCCCATGCCTGTAATCCTAGCACTCTGGGAGGCTGAGGTGAGTAGATTGCTGAGCTCAGGAGTTCAAGACCAGCCTGTGCAAGAGACCCCATCTCTGCTAAAAATAGAAAAACCA","GGCCAGGTGTGGTGGCTCACGCCTGTAATCCTAGCACTTTGGGAGGCTGAGGCGGGTGGATTGCCTGAACTCAGGAGGTCAAGACCAGCCTGGGCAACACAGTAAAACCCCATCTCTACTAAAATACAAAAAATCA"
"GL873593","384425","384607","chr20","28286874","28287058","50","27902449","GAAAGAAAAGAAAAGAAAAACTAGCAAGATGTTGTAGCTGATGCCTATAATCCTAGCTATTGGAGAGGTGGAGGCAAGAGAATTGCGTGAGCCCAAGAGTTGAAGGTTGCTGTGAGCTGCGATGCCAGAGCACTCCAGGGTGACAGAGTAAGACTCTGTCTCAAAAAAAATTACAAAATAAAA","TAATAAAAATAAAAAAATTAGCCAGGAGTCAAAGCACACGCCTATAACCCCAGCTACTTGGGAGGCTGAGGGAGGAGAATTACTTGAACCCGGGAGGTGAAAGTTGCAATGAGCTGAGATCAAGCCACTGCACTCCAGACTGGATGACAGAGTGAGACTCTGTTTCAAAAAAAAAAAAAAGACAA"
"GL873593","1408445","1408467","chr10","88070368","88070389","9","86661923","AATCTAGAGATGGGGAGAGGTTG","AAAGAGATGGAAGAGAAGAAGA"
"GL873593","4856365","4856484","chr7","56497314","56497433","31","51640949","GCAATCCCAGCTGATCGGGAGGCTGACCCAGAAGAATCCCTTGAACCCAAGAGTCTGAGGTTGCTATGGGTGGATTCTACAGCACTCTAGCCTGGGAGACAGAGTGAGACTCTGTCCCAA","ATCCCAGCTACTTGGGAGGCTGAGACAGAAGAATTGCTTGAACCCGGGAGGTGGAGGTTGCAGTGAGCCAAGATTGTACCACTGCACTCCAGCCTGGCAACAGAGTGAGACTCTGTCTCA"
"GL873593","6661298","6661485","chr10","86749316","86749514","55","80088018","GCAGAGGCTCACATATGTAATCCTAGCACTCTGGGAGGATAAGGCAGGTGGACAGCTTGAGCTCAGGGGTTTGACCAGTCTGATCAAGAGCAAGACCTGTGTCTACTAAAAATAGAAAACCTAGCCAGGTATGATGGTAGATGCCTGTATTCCTAGCTACTCTGGAAGCTAAAGCTAAAGAGTTTGAA","GGTGGCTCACACCTGTAATCTTAGCAATTTGGGAGGCCGAGGTGGGTGGATCACTTGAGGTCAGGAGTTTGAGACCAGACTGGCCAACATGGTGAAACTCTGTCTCTACTAAAAATACAAAAATTAGCCAGTCATGGTGGTGCATGCCTGTAATCCCAGCTACTCAGGAAGCTTAGGCAGGAGAATCACTTGAACCCAG"
"GL873593","6710263","6710446","chr14","4390080","4390244","66","2320183","TTGAAGTCAGGAGTTTAAGGCCAGTCTGGGCAACATAGTGAGACCCCCATCTCTACGAAAATATTTTTTAAAAATTAAAAATAGCTGGGCATAGTGAGGCTGTTGTGAGCTATAACTGCACCACTGCACTCAGCCAAGGACAGAGACCCTGTTCCCTGCCTCAAACAAACCAAAACAAAACAAA","AAGTCTAGAGTTTACAGCCTGGACAACGCAGTGAAACCCTGTCTCTACCAAAAATACAAAAATTAGACAGGTGTGAGAGGCGGAGGTTGCAATGAGCTGAGATCGCAGCACTGCAGTCCAGCCTGGATGACAGAGCGAGACCCCATCTCAAAAACAAAAACAAAA"
"GL873593","7159645","7159716","chr6","178318394","178318465","21","171158749","GATCATGTCACTGCTCTCCAACCTGGGCAATTGAGCAGGAATCTGTCTCAAAAAGAAAAAAAAAAAAGAAAA","CGAGTTCACACCACTGCACCCCAGCCTGGGCAACAGAATGAGACTCGGTTTCAAAAAAAAAAAAAAAAAAAA"
"GL873593","7159841","7160050","chr13","33368171","33368368","69","26208330","GGCCAGGCGTGGTGGCTCACACCTGTTGTCCCAGTGCTGTGGGAAGCCGAGGCAGGTGGATCACCTGAGCTCAGCCGAGTTCGAGACCAGTGGAAGACCAGCATGAGGCAGAGTGAGCCAGAGTGAGACCCCATCTCTACAACAACAACAAGAAGAAAAAAAACAGCCGGACCTTGTGATCCCAGCTACGTGGGGAGCTAGAGAATCACT","GGCTAGGCATGGTGGCTCATGCCAGTAATCCCACCACTTTGGGAGGCCGAGGCAGGTGGATCACCTGAGGTCAGGAGTTCAAGACCAGGCTGGCCAACATGTTATGATGAGACCCTCATCTCTACTACAAATACAAAAATCAGCTGGGCATGGTGGCAAGTGCCTGTAATCCCAGCTACTTGGGAGGCTGAGGCAGAA"
"GL873593","8598292","8598391","chr11","118461023","118461129","33","109862731","AGCCAGGTGAGGTGGTTCACACCTGTAACCCTAGCTGCTTGGGAGGCTGAGGCCTCTCTATCCTGGGCAGTGTGGAGAAACTTTGTTTCAAAAAAAAGAA","GCCGGGCGCGGTGGCTCACGTCTGTAATCCCAGCGCTTTGGGAAGCCGAGGCGGGACTATCCTGGCCAACATGGTGAAACCCCGTCTCTACTAAAAATACAAGAATC"
"GL873594","357249","357377","chr2","75702890","75703011","36","75345641","CCTGGTACCGTAGGTCATGCCTGTAATCCTAGCACTTTGGGATGCTGAGGTGGGCAGATTGCCTGAGCTCACGAGTTCAAGCCATTAGAACTGAGCCTGACCTAGAGTGGGACCTCCAACTCTTTTTTT","GCCAGGCACAGTGGCTCATGCCTGTAATCCCAGCAGTTTGGGAGGCTGAGGTGGGCAGATCACTTGAGGTCAGGAGTTCAAGACCAGCCTGGCTGACATGGTGAAACCCCATCTATACCAAA"
"GL873594","357656","357834","chr7","17608776","17608965","55","17251120","GGGACCTCCAACTCTTAAAATAGCTGGGCATTGTGGTGGGCACCTACAGTCACAGCTACTTGGGAGGCTAAGGCAAGAGACTTGTTTGCAGCCAAGAGTTAGAGGTTGCTGTGAGCTATGAGGCTAGGGCACTCTACAGGGGGCGACAAGTGAGACTGTAAAAAAAAAAAAAGAAAAAA","GTCCCTACTAAAAATACAAAAAATTAGCTGGGCCTGGTGGCAGGCACCTGTAATCCCAGCTACTTGGGAAGCTGAGGCAAGAGAATTGCTTGAACCCAGGAGGCAGAGGTTGCAGTGAGCTGACATCAAGCCACTGTACTCCAGCCTAGGCAACAAGAGCAAGACTCTGTCTCAAAAAAAAAAAAAAAAA"
"GL873594","1410711","1410996","chr5","151340503","151340797","76","149929792","CACAGTGGCTCATACCTATAATCCTAACACTCTGGGAGGCCAAGGTGGGTGGACTGTCTGAGTTTGGGACCAGCCTGAGCAAAAGCAAGACTCCCATCTCTACTAAAAACAAAGACAGCCAGGTATGAGGGCAGGTGCCTATCATCCCAGCTACTTGGGAGGCTGAGGAAGGAGGATCACCTAAGCCCAGGACTTTAAGGTTTCTGTGAACTAAGATGATGTTACAACACTCTAGCCAGGGTAACAAGGCAAGATTCTGTTTCAAAAGACAAAAAAAAAAAAAAAA","GGTGGTTCATGCCTGTAATCCCAGCACTTTGGGAGGCTGAGGCAGGTGGATCACCTGAGGTCAGGAGTTCGGGACCAGCCTGGCCAACATGGGGAAACCCCATCTCTACTAAAATACAAAAATTAGCCAGGTATGGTGGCACATGCCTATAATCCCAGCTACTTGGGAGGCTGAGGCAGGAGAATCACTTGAACCCAGGAGGCTAAGGTTGCAGTGAGCCGAGATTGTGCCACTGTACTCCAGCCTGGGTGACAGACTGAAACTCTGTGTCCAAAAAACAAAACAAAACAAAAAA"
"GL873594","5528090","5528162","chr2","69013639","69013718","24","63485549","GGTACAGTGGCTCACGCTTGTGATCCCAGGTTGAGGTGGGTGGATCGCCTGAGCTCAGGAGTTGGATGCCAGC","GGTGTGGTGCCTCACGCCTATAATCCCAGCACTTTGGGAGGCAGGTGGATCACTTGAGGTCAGGAGTTTGAGAACAGCCT"
"GL873594","5834047","5834168","chr2","82491537","82491662","28","76657490","GGCTGGGCCCAGTAGCTCACGACTGTAATCCCAGCACTCTGGGAAGCTGAGGTGGGCGGATCACCTGAGCTCATAGGTTCGAGACCAGCTCCAGTTAGAGTGAGAGCCTGTCTCTAAAAATA","GGCTGGGCACAGTGGCTCATGCCTGCAATCCCAGCACTTTGGGAGGCTGAGGTGGGCAGATCACCTGAAGTCAGGAGTTCAAGACCAGCCTGGCCAACACAGTGAAACCCCATCTCTACTAAAAAT"
"GL873594","5834396","5834461","chr13","14688151","14688212","20","8853755","TATATAATAATAATAACCAGGTATTGTGGCAGGTGCCTCTAGTCCCAGCTACTCGGGAGGCAAAGG","ATAAAAAAATTAGCTGGCCATGGTGGCACATACCAATAATCCCAGCTACTCAGGAGGCTGAG"
"GL873594","7786130","7786294","chr14","12217087","12217250","37","4430957","GGGTGTGCTGGCTCATACCTATAATCCTAGCACTCTGGGAGGCTGAGGTAGGTGTATTGCTTGAACCCAGGAGTCTGAGGTTGCTGTGCGCTAAGCTGATACCATAGCACTCTAGCCTGGGCAACAGAGTGAGACTCTGTCTCAAAACAAATAAATAGTAAAAAA","GCTGGGCGTGGTGGCTCACACCTGTAATCCCAGCACTTTGGGAGGCCAAGGCATGAGAATTGCTTGAAAACAGGAGGCGGAGGTTGCAGTAAGCTGAGACTGTGCCATTGCACTCCAGCCTGGGCAACAAGAGTGAAACTCTGTCTCAGAAAAAAAGAAAAAAA"
"GL873595","723579","723774","chr19","6045933","6046125","65","5322354","GCCTGAGCAGGAGAGAGACCCCATCTCTGCTGAAAGTGGAAAAGTTGGCTGAGTGTAGTGGCGGGCTGCTGCCCCAGTCACTCAGGAGGCTTAGGAAGGAGTATCGCTTGGGCCCAAGATTTGAGGTTGCTGTGAGCGCTACAAAGACATTAGGGTACTCTACACAGGGGAATAGAGTGAGACTGTCTCAAAAAAA","CAACATGGAGAAACCCCGTCTCTACTAAAAATACAAAATTAGGCAGCGTGGTGGTGGGTGCCTATAATCCCAGCTACTCAGGAGGCTGAGGCAGGAGAATCGCTTGACCGGGAGTGGAGGTTGCGGTGAGCTGAGATTGCACCATTGCACTCCAGCCTGGGCAACAAGAGTGAAACTCCGTCTCAAAAAGAAA"
"GL873595","724114","724204","chr20","18199749","18199840","22","17475635","GGCCATGCTTGGTGGTTCTCATCTGTAATCCTAGCACTCTGGAAGGTCTACAGGGGTGGATGGCTGGAGGTCAGGAGTTCAAGACTGGCCT","GGCCGGGCATGGTGGCTCACACCTGTAATCCCAGCACTTTGGGAGGCTGAGGCAGGCGGATCACCTGAGGTCAGGAGTTCGAGACCGGCCTG"
"GL873595","1065346","1065667","chr18","10529729","10530057","74","9464383","GGCCAGGTGCAGCAGCTCATGCCTGGAATCTTCCTGCTCTGTATGGCCAAGGCAGGTGGATCGCCTGACCTCAGGAGTTCCAGACCAGCCTGAACAAGAGCAAGACTCTGTCTCTACTAAAAGTAGAAAAAAAACTAGCCAGTCATAGTGGCAGGTGCCTGTAGTCCCAGCTGCTTGGGAGGCTGAGGCAAGAGGATCACTTGAACCTAAGAGTTTGAGGTTGCTGTGAGCTAAGATGCCACATCACTCTATCAAGGGTGACCAAGTGAGACTCTGTCTCAAAAATAAATAAATAAATAAATAAAAAGAAAGGCAAAAAGAA","GGCCCGGCGTGGTGGCTCATGCCTATAATCCCAGCCCTTTGGGAGGCCAAGGCAGGTGGATCACCTGAGGTCAGGCGTTCGAGACCAGCCTGACCAACGTGGTGAAACCTCATCTCTACTAAATACAAAAAAAATTTAGCCAGGCATGGAGGCACATGCCTGTAATCCCAGCTACTTGGGAGGCTGTGGCAGGAGAATCACTTGAACCTGGGAGGTGGAAGTTGCAGTGAGCTGAGATTGTACCACTGCACTCCAACCTGGGTGACAAAGCAAGACTCGGTCTCAATAAATAAATAAATAAATAAATAAATAAATAAAGTGAAAAAAAA"
"GL873595","1254878","1255146","chr4","42822326","42822607","67","41567448","GGCTGGGCATGGTGGCTCATGCCTGTAATCCTACCGCTCTGGGAGGCTGAGGCAGAGGATCACTTGAGCTCAGGAGTTTCAGACCAGCCTGCAAGAAGGACCCAGTCTCTGCCGAAAATAGAAAAGTTAGCAAGGCGTTGTCGTGAGCACATGTATCCCAGCTACCTAGAACTCTGAGGCAGGAGGATCCCTTGAACCCACAGAAGTTGCTGTTATCTAAACTGATGCCACTGGACTCTAGCCTGGGCAACAGAGTGAGACTGGTCTCA","GGCCGGGCACGGTGGCTCATGCCTGTAATCCTAGCATTTTGGGAGGCTGAGACAGGCAGATTGCCTGAGCTCAGGAGTTCAAGACCAGCCTGGGCTAGATTGTGAAACCCCATCTCTACTAAAATATAAAAATTAGCTGGGTGTGGTGGCACACGCCTGTAATCCCAGCTACCTGGGAGGCTGAGGCAGGAGAATCGCTTGAACCAGGAGACAGAGGTTGCAGTGAGCTGAGATCACGCCACTGCACTTTAGCCTGGGCAACAGAGTGATACTCTGTCTCAA"
"GL873595","3417105","3417297","chr12","115674238","115674427","44","112257133","GGCCGGGCGCTGTGCCTCACGCCTGTAATCCTAATACTCTGAGAGGCCGAGGCAGGTGGATTGCCTGAGCTCAGGTGCTCAAGACAGCCTGACTGAGCAAGCCCTGAGATCCCATCTCCACTAACAATAGTAAAACTAGCCGGGCATTGTGGTGGTGCTTGTAATCCCAGCTACTGGGAGGCTAAGACAGGAG","CCAGGCCTGGTGGCTCACGCCTGTAATCCCAGCACTTTGGGAGGCCGAGGTGGGTAGATCACCTGAGGTCAGGAGTTCAAGACCAGCCTGGCCAACATGGCGAAACCCCATCTCTACTAAAAATACAAAAATTAGCTGGGCATGGTGGTGTATGCCTGTAATCCCAGCTACTCGGGAGGCTGAGGCAGGA"
"GL873595","6098380","6098457","chr3","87492619","87492702","21","81394239","GCTGTGGCTCATGCTGATAATACCAGCACTCTGGGAGAACAAGGTAGGCAGATCACAAGAGGTCACCTGTGCAAGACC","GGGCTGGTGGTGGCTCATGCCTGTAATACCAGCACTTTGGGAGGCCAAGACAGGTGGATCACCAAAGGTCAAGAGTTCAAGACC"
"GL873596","134190","134307","chr1","203207333","203207443","31","203073143","GGCTGGGCGAGGTGGCTCACACCTGTAATCCTAGCACTCTGGAAGGCCCTAGCACTCAGGCAGTTGGATTGCCTGAGCTCACAAGTTCAAGACCAGCCTGAAAAAGAGCAAGACCTCA","GGCTGGGTGCAGTGGCTCACACCTGTAATCCCAGCACTTTGGGAGGCCGAGATGGGTGGATCACTTGAGGTCAAGAGTTGAAGACCAGCCTGGACAACATGATGAGACCCC"
"GL873596","134578","134681","chr11","50235285","50235387","37","50100707","CAAACAAAAGAGGAAGACCTCGTCTCTAAAAAAATAGCTGGGCATTGTGAGGAGTACCTGTAGTCCTAGCTACTCAGAAGGCTGAGACAAGAGAATCACTTAAA","CAACATTGTGAAACCCTGTCTCTACTAAAATAGAAAATTAGCCAGGTGTGTGGGCGTGCCTATAATCCTAGCTACTGGGGAGGGTGAGGCATGAGAATCGCCT"
"GL873596","8160215","8160350","chr1","29437872","29437991","30","21277657","GGCCGGGCGTGGTGGCGCACACCTGTAGTCCCAGCGCTATGGGAGGCCGAGGCGGGTGGATCACCTGAGCTCAGAGGTTCGAGACCAGCCAAGACCCCCCTGAGCCAAACGAGCCAGAGTGAGACCCCGTCTCTAC","GGCCGGGCGTGGTGGCTCACGCCTGTAATCCCAACATTTTGGGAGGCCAAGGCGGGTGGATCACCTGAGGTCAGAAGTTCGAGACCAACCTGGCCAACATGGTGAAACCCCTGTCTCTAC"
"GL873596","8421071","8421132","chr20","1874027","1874093","12","6547044","GTCAGGCGCAGTGGCTCACGCCTGTAATCTCAGCACTCTGAGAAGCCAAGGCAGGATCATCT","GGCCAGGCGCAGTGGCTCAGGCCTGTAATCCCAGCACTTTGGGAAGCCAAGGTGAGCAGATCACCTG"
"GL873598","4416400","4416489","chr5","39418145","39418231","15","35001745","GGCCAAGTGTGGTGGCTCATGCCTGTTGTCCCAGCACCGTGGGAGGCCGAGGCTGGTGGAACACCTGAGCTCAGCTGAGTTTGAGACCAG","GGCCAGTTGCGGTGGCTCATGCCTGTAATCCCAGCACTTTGGCAGGCTGAGGCAGGTGGATCACCTGAGGTCAGGAGTTTGAGACCA"
"GL873598","4416855","4416947","chr3","94091253","94091337","31","89674398","GTGAGACCCTGTCTCTACAAAAAAAAAAGCTGGGCACTGTGGCATGTGCCTGTAATCCCAGCTACTTGGGAGGCAAAGGGAAAGAGAATCACT","AAACCTTGCCTTTACTAGAAATACAAAAATTAGCTGGGCATGGTGGCAGGTACCTGTAATCCCAGCTACTTGGGAGGCTGAGGCA"
"GL873598","5126074","5126161","chr1","12339306","12339394","19","7213232","GCCTGGTGCACTGGTTCACACCTGGAATCCTTGCATTCTGAGAGGCCCAGGTAGGCAGATCACCTCAGCTCAGAAGTTCGAGACCAGC","GCTGGGTGCGGTGGTTCACGTCTGTAATCCCAGCACTTTGGGAGGCCGAGGCGGGCAGATCACCTGAGGTCAGGAGTTCGAGACCAGCC"
"GL873598","5467584","5467662","chr1","9313328","9313403","17","3845744","GCGAGGTGGCTCACGCCTGTAATCCCAGCACATTTGGAAGGCCAAGGAGGGTGGATCACCCGAGCTCACCAGTTGGAGA","CGCAGTGGCTCACGCCTGTAATCCCAGCACTTTGGGAGGCCGAGGCAGGCAGATCACCTGAAGTCAGGAGTTTGAG"
"GL873598","6917752","6917856","chr14","9558287","9558382","22","2640535","GGCCAGGCATGGTGGCTTGTGCCTGTTGTCCCAGCACTGTGGAAGGCCGAGGCGGGTGGATCGCCTGAGCTCAGCTGAATTCGAGACCAGCATAAGACCAGTATG","GGCCAGGCATGGTGGCTTATGCCTGTAATCCCAGCACCTTGGAAGGCCGAAGCGGGCAGATCACCTGAGCTCAGGAGTTTGAGACCAGCCTGTCCA"
"GL873598","8078910","8079062","chr7","164825511","164825660","43","156746601","AACAGCCAGGCATTGTGGTGGGCACCTGTAATCCCAGCTACTTGGGAGGCTGAGGCAAGAGAATTGCTTGAGCCCAACAGTCTCAGGTTACTGTGAGTTATGACACCATGGCACTCTATTGAGGGCAAGAAAGTGAGACTGTCTTGGAAAAAA","CTAGCCAGGCATGGTGGTGCGCACCTGTAGTCCCAGTTACTTGGGAGGTTGAGGCAAGAGAATTGCTTGAGCCTGGAAGGCAGAAGTTGCAGTGAGCTGAGATCACACCACTGCATTCCAGCCTGGGCGAAAGAGCAAGACTCTGTTGAA"
"GL873598","8079328","8079454","chr6","10381248","10381379","32","2301920","GCCCGGCGTGGTGGCTCACGCCTGTAATTCCAGCACTCTGGGGAGGCCGAGGAGGGCAGATTGCCTGAGCTCACAGGTTTGAGCTAGAGCGAGACCCTGTCTCTTAAAAAGAAAAAAAAGGAAAGAA","GCTGGGCGCGGTGGCTCACGCCTGTAATCCCAACACTTTGGGAGGCCGAGGCGGGCAGATCACCAGAGGTGATCTCCAGCCTGGGCAGGAGAGCAAGACCCTGTCTCAAAAAATTTAGAAAAAGGAAAGAAA"
"GL873599","3943256","3943456","chr9","35892110","35892312","79","31948854","GGCAGGCTGCTTTGACCCATATCTACAACTCCAGAACTTTAGAGGCTGAGCTGGGTGGGTCCCTTGAGATTAGAAACTGCTTAGTAGCCTGGCAAAAACCAGACCCCACCTCCACCATGTAGAAAAATTAGCAGTATGCCATAGTGGGAACCTACCAATACAGTCTTTCCAAAGGCCAAAGCTAGAAGGACCGTGAGCTTG","GGCTGGGTGTGGTGGCTCATGCCTATAATTCCAGCACTTTGGGAGGCCGAGGCAGGTGGATCACCTGAGGCCAGGAGTTTGAGACCAGCCTGGCCAATATGGTGAAACCCCATCTCTACTAAAAGTACAGAAAATTAGTCAGTCATGATGGCGCATGCCTATAATCCCAGTTACTCGGGAGGCTAAGGTAGGAGAATTGCTTG"
"GL873599","6693284","6693349","chr1","100916857","100916922","15","94223573","TCACGTCTATAATCCTAGCACTCTGGGAGTCCTTGGCAGGTGGATCACCTGAGCTCAGGAGTTTGA","CATGCCTGTAATCCCAGCACCTTGGGAGGCCAAGGTGGGTGGATCACCTGAGGTCAGTAGTTTGAG"
"GL873600","991618","991705","chr15","13850109","13850195","15","12858491","GGCTGGGCGTGGTGGCTCACACCTGTTGTCCCAGCGCTGTGGGAGGCTGAGGCAGGTGGATCACCTGTGCTCAGAGGTTGAGACCAGC","GCCGGGCGCTGTGGCTCACACTTGTAATCCCAGCACTTTGGGAGGCTGAGGCAGGTGGATCACCTGAGGTCAGGAGTTAGAGACCAG"
"GL873600","8825981","8826014","chr16","43605817","43605844","11","34779836","AGTCTGGGGCAACAGAGCAAGACTCTGTCTCAAA","CAGTCTGGGTGACAGAGCAAGATTCCAT"
"GL873600","8826039","8826157","chr13","87428402","87428520","35","78602363","ATTAGCCTGGTGTGGTGGTATATGCCTTCCTGCCTGCTTGGGAGGCTGAGGCAGGAAGTATGCTTTAACTGTGGAGTCTGAGGTTGCTATGAGCTAGGTTGAGGCCATGGCACTCTAAA","TTAGCCGGGTGTGGTGGTGCACGCCTGTAATCCCAGCTACTCAGGAGGCTGAAGCAGGAGAGTTGCTTGAACCCAGGAGTTGGAGGTTGCAGTGAGCTGAGATCACGCCATTGCACTCC"
"GL873601","269289","269338","chr14","49279240","49279285","14","49009951","GACTGGGTGTGGTGGCTCACACCTTTAATCCTAACACCCTGGGAGGCTTA","GGCTGAGATGGTGGCACACACCTGTAATCCCAGCTACTTGGGAGGC"
"GL873601","269431","269678","chr1","184453273","184453521","76","184183842","AGAAGATCACTCAAGATCAGGAGTTTGAGAACAGCCTGAGCAAGACCCCCATCTTTACTAAAAATGGAAAAGTTTTTACCCAGGCATGGTAGTGCGTGCCTGTATCCCATCTACTCCGGAGGCTGATAGGAGGATTGCTTCAACCAAGGAGTTTGAGGTTCCAGAGACTTAAGATGACACAACTGCATTTTACCCAGTGTGACACAGCGAGACTCTTTCAGAAGAATTTTTAAAAGGAAAAAAAAGAA","GGTCAGATCACCTGAGGTCAGGAGTTTGAGACCAGCCTGACCAACATGGTAAAACCCCATCTCTGCTAAAAATACAAAAAATTAGCCAGGCATGGTGGTGAACGCCTGTAATCCTAGCTACTCAGGAGGCAAAGACAGGAGAATCGCTTGAATCTGGAAGGTGGAGGTTGCAATGAGCCAAGATGACGCCACTGCACTCCAACCTGGGTGACAGAGGAAGACTCCATCAAAAAAAAAAAAAAAAAAAAA"
"GL873601","1397978","1398117","chr16","24839455","24839591","34","23441477","GCCTATAATCCTAGCACTCTGGAAGGCTGAGGCAGGAAGATCACTAGAGCTTGGGAGTTTGAGATTGCTGTGAGGGAGACTGACTCCATGGCACTCTAGCCTGAGGCAACAGAGTAAGACTCCATCTCAAAAAAAAAAAA","CTCTAACTCCAGCTACTCAGGAGGCTGAAGCAGGAAAATCACTTGAACCTGGGAGGTGGAGGTTACAGTGAGCCAAGATCACACCATTGCACTCCAGCCTGAGCGACAGAGCGAGACTCTGTCTCAAAATAAATAAA"
"GL873601","4065502","4065590","chr11","108711352","108711444","19","104645850","GCTGGATGTGGTGGCTCTCACCTATAATCCTAGCACTCTGGGAGGTCAAAACAGGTGGATCACCTGAGCTCAGGAGCAAGAACACCAGC","GTCAGGGGTGGTGGCTCACGCCTGTAATCCCAGCACTTTGGGAGGCCAAGGCAGGTGGATCGCCTGAGCTCAGGAGTTCAAGACCAGCCTTGC"
"GL873601","8241370","8241465","chrY","9469734","9469829","34","1228364","AAAAAAGGTGGAGATGAGCCATGCGCAGTGGTGTAGGCCTGTAATCCCAGCCCTTGGGAGGCCAAAATGGTGGATTGCCTGAAGCAGAGCAAGACC","AAAGTACAAAGAGTCTGGGTACAGTGGCCCAAGCCTGTAATCCCAGCAGTTTGGGAGGACAAGATGGGTAGATCACCTGACATCATGAATTAGAGA"
"GL873569","7519122","7519191","chrX","79016364","79016431","16","71497242","TTGGCCAGGCATGGTCGCTCAGGCTGTAATACCAGCTACTTGGGAAGCTGAAGCAGGAGGATCACTTGAA","TTGGCCAGGCACGGTGGCTCATGCTTATAATCCCAGCTACTCGTGAGGCTGAGGCAGGGGAATCGCTT"
"GL873569","7989158","7989286","chr8","41505677","41505810","35","33516519","AGTCCCACCTATTTGGAAGGCTGAGGCAAGAGGATCACTTGAACTCAGCAGTTTGACATTGCTATGAGTTAGATTGACTCCATGGCACTCTAGCCCAGGCAACAGAGCAAGACTCCGTCTCAAAACAAA","TAATACCAGCTACGTGGGAGGCTGAGGCAGGAGAATCACTTGAACCCGGGAGGTGGAGGTTGCAGTGAGCTGAGATTGCACCGTTGCACTCTAACCTGGGCAACAAAAGCAAAACTCTGTCTCAAAAAAAAAAA"
"GL873569","7989575","7989702","chr1","62231025","62231129","47","54241450","GGCTGGGTAATGCAGTGGCTCACGCCTATAATCCTAGTGCTTTGAGAGGCCAAGAGTGAGACTCTGTGTACTAAAAATAGAAAAATTACCTAGGCATTCTGGTGGGCACCAGTAGTCCCACCTATTTG","GGCTGGGCATGGTGGCTCACGCCTATAATCCCAGCACTTTGGGAGGCCGAGGCAGGTGGATCACCTGAGATCAGGAGTTTGAGACCAGACTGGCCAACATGGTGA"
"GL873569","10034363","10034556","chr10","61268396","61268605","62","51234033","CAGCTTGAGCAAAAGTGAGCCCCTGTCTCTACTGAAAATAGAAAAAATTAGCCAGGCGTGGTGGCACACACTTATAGTCCCAGCCACTTAGGAGGCTGAGGCAGGAGTTTGAGGTTGACATAATCTAAGCTGATACCATAGCACTCTAGCCTGGGCAATAGAGTGAGACTCTGTCTCAAAGAAGAAATTTATCT","CCTGACCAATGGTGAAACCCTGTCTCTACCAAAAATACAAAATTTAGCTGGGCATGGGGGCACGCACCTGTAGTCCTAGCTACTCGGGAGGCTGAGACAGGAGAACTGCTTGAACTCGGGAGGCAGAGGTTGCAGTGAGCTGAGATCATGCCACTGCACTCTAGCCTGGGCAATAGAGTGAGACTCCGTCTCAAAAAAAAAAAAAAAAAA"
"GL873569","10034830","10034845","chr1","217667782","217667796","2","207632952","AAAAAAGAAGAAAAAA","AAGAAAAAGAAAAAA"
"GL873569","10203815","10203922","chr8","96374555","96374671","35","86170740","GCCAGGTGTAGTGGTTCACACCTATAATCCTAGCACTCTGGGAGCCTGAAGCAGGTAAATGGACTGAGCAAGAGTGAGACTTCCACCTCTATTGAAAATAGAAAAATT","GGCTAGGTATGGTGGCTGATGCCTATAATCCCAGAATTTTGGGAGGCCGAGGCAGGCAGATCATCTGAGGTCAGGAGTTTGAGACCAGTCCCGTCTCTACTAAAAATACAAAAATTA"
"GL873569","10204196","10204373","chr20","1304385","1304559","47","8899811","GAAAATAGAAAAATTAGCCAGGCATTATAGCAGGCACCAGTAATCCCAGTTACTTGGGAGGCTAAGGCAAAAGAATCTCTTGAGCCCAAGTTTGGGGTTGCTAGGAAGTAAAACACCACAGCACTATACCCAGAACAAGAGAGTGAAGACTCAGTCTCAAAAAGATAAATAAATAAAA","AAAAATACAAAAATTAGCCAGGCATGGTGGCGGGCGTCTGTAACTCCAGCTACTTGGGAGACTGAGGCAGGAGAATCGCTTGAACCCAGGAGGCAGAGGTTACAGGTGAAATCACACCACTGCACTCCAGCCTGGGCAACAGGGCAAGACTCTGTCTCAAAAAAAAAAAAAAAAA"
"GL873569","10473375","10473444","chr8","20660648","20660717","21","10187273","TGTAGTCCCAGCACTTTGGGAGGTTAAGGCAAGAGTAGCACCCAACATGAGGAGATCAAGACCAATCTGG","CTGTAGTCCCAGCACTTTGGGAGGCTGAGGCAGGTGGATCCTTTGAGGGCAGAACTTTAAGACCAGCCTG"
"GL873570","9287350","9287485","chr1","29437872","29437991","30","20150522","GGCCGGGCGTGGTGGCGCACGCCTGTAGTCCCAGCGCTATGGGAGGCCGAGGCGGGTGGATCACCTGTGCTCAGAGGTTCGAGACCAGCCAAGACCCCCCTGAGCCAAACGAGCCAGAGTGAGACCCCGTCTCTAC","GGCCGGGCGTGGTGGCTCACGCCTGTAATCCCAACATTTTGGGAGGCCAAGGCGGGTGGATCACCTGAGGTCAGAAGTTCGAGACCAACCTGGCCAACATGGTGAAACCCCTGTCTCTAC"
"GL873571","3669989","3670207","chr4","116777080","116777297","60","113107091","AGACCAGCCTGAGGAAGAGCAAGATCCCATCTCTATTAAAAATAGAAAAATTAGCCAGGCATTCTGGTGGGCACCTGTAGTTCTAACCACCTGGGAGGCTAAGGCAAGAGGAACTCTTCAACCCAAGAGTTTGAGGTTGCTGAGAGCTAGGCTAAGGCTGCAGCACTCTAGCCTGGGCAACAGAGTGAGACTGTTTCTCAAAAACAAAAAACAAAAAAA","CGAGACCAGCCTGGTCAATATGGTGAAACCCCGTCCCTACTAAAAATACAAAAATTAGCCAGGCATGGTGGCAGGCACCTGTAGTCCCAGCTACTCGGAAGGCTGAGGCAGGAGAATCGCTTGAACCACAGAGGCAGAGGTTGCAGTGAGCCGAGACTGCACCACTGCACTCCAGCCTGGGCGACAGAGTGAGACTCAGTCTCAAAAAAAAAAAAAAA"
"GL873571","106134","106236","chr4","18143723","18143826","27","18037589","GGCCAGTCTCAGTGGCTCACACCTGTAATCCAGCATTCTGGGAGGCTGAAGCACACGGTCACCTGAGCTCAAAGGTTGGAGACCAGAGTGAGACCCCACCTCT","GGCCAGGCGCAGTGGCTCACTCCTGTAATCCCAGCACTTTGAGGCTGAGGCAGGCGGATCACCTGAGGTCAGGAGTTTGAGACCAGCCTGGCCGAAACCCCATC"
"GL873571","3670496","3670589","chr7","50468399","50468491","15","46797903","GGGCAGGCATGGTGGCTCACACCTGTAATTCTAGCACTCTTGGAGGCTGAGGCAGGAAAATGGCTTGAGGTCAGGAGTTCAAGACCAGCCTGAG","GGCCAGTCATGGTTGCTCACACCTGTAATACCAGCACTTTGGGAGGCCGAGGCAGGCGAATCACCTGAAGTCAGGAGTTCAAGACCAGCCTGG"
"GL873571","4059090","4059389","chr7","52903696","52903994","88","48844606","GGCCAGGTGCAGTGGTTCACACTTATAATCCTAGCACTCTGGGAGGCCGAGGCGAGTGAAGTGCCTGAGCTCATGGGTTCAAGACCAACCTAAGCCAGAGACCCCTGACTCTTATAATAGCCTGGCATTGTGGTGGGCGCCAATATTTCCAGCTACTCTGAGGCTAAGGCAAGAGAATTGCTTGAGCCCAGGAGTTGGAGGTTTCTGTGAGCACTGACGCCGCAGCTCTCTACCAAGGGCAACAAAGACTCTGTCTCAAAAAATAAATAAATAAATAAATAACAGAATGAAAATGAAAAA","GGCCGGGTGCGGTGGTTCACGCCTGTAATCCCACCACTTTGGGAGGCTGAGGCAGGCAGGTCACCTGAGGTCAGGAGTTCCAGACCAGCCTGGCCAACATGGTGAAACCTTGTCTCGGCTATTAGCCTGGCATGGTGGTGCGTGCCCATAATCCCAGCTACTCAGGAGGCTGAGGCAGGAGAATCGCTTGAACCCAGAAGGTGGAGGTTGCAGTGAGCCAAGATAGCACCACTGCAACTCCAGTCTGGGCAACAGAATGAGACTCTGTCTCAAAAAAAAAAAACAAAAAACAAAAAGAA"
"GL873571","4209418","4209704","chr11","32517699","32517985","80","28308281","GGCTTGGCAAGGTGGCTTACACCTCAAATCCTAGCACTGTGGGAGACTGAGGCAGGTGGATTGTTTGAGCTCAGGAGGTCAAGATAGAGAGCAAGAGCAAGTCTCTGTCTCTACTAAAAATAGAAAAGAACTACTTCCCGGGGGTCATGGCAGTAGCCTGTAATCCCAGTTACTAGGTAGAATGAGGCAAGAGGATCTGTTGAAGCCAAGAGACTGAGGTTGTTATGAGCATGCCACAGCACTCTACCCAGGGTGACAGAATGAGACTCTGTTGAAAGAAAAAAAGA","GGCCGGGTGCAGTGGCTCACACCTGTAATCCCAGCACTTTGGGAGGCTGAGGCGGGTGGATCACCTGAGGTCAGGAGTTCAAGACCAGCCTGACAAACATAGTGAAACCCTGTCTCTACTGAAAATACAAAATTAGCCAGGTGTGGTGGCGCATGCCTGTAATCCCAGCTACTCGGGAGGCTGAGGCAGGAGAATTGCTTGAATCCAGGAGGTGGAGGTTGTGTGATCACACCACTGCACTCCAGCCTGGGCGACAGAGTGAGACTCTGTCTCAAAAAAAAAAGAAA"
"GL873571","4209985","4210154","chr3","175781758","175781928","60","171571773","GAAAGAAATGAAAAGAAAGAAGTTAGCTGGTTGTTGGGGTATGCTTCTATAGTCCCACCTACTCAGAAAGCTGAAATCTGGAGTTTGGGGTTGTTGTAAGGTAGGCTGATGACATAGCACTGTAGCTTGGGCAAGAGAGTGTGACTTTGTCTCAAAAAAAATTAAAACAA","ATTAAAAACACAAAGATTAGCCAGGTGTGATGGCACACAACTGTAATCCCAACTACTCAGGAGAATCGCTTGAACCTGGGAGATAGGGTTTGCAGTGAGCCAAGATTGTGCCACTGCACTCCAGCCTGGGTGACAGAGTGAGACTCTGTCTCCAAAAAAAAAAAAAAAAAA"
"GL873571","4210444","4210570","chr17","16655655","16655789","35","12445211","GCCAGGCAGATGGCTCACACTTCATCCTAGCCCTCTGGAAGGCTGAGGCAGGCTAATTTTTTGAGGTTAGGAGTTTGAGACCAGCCTGAGGAAGAGACCCATCTCTACTTTAAAAAATAAATGGAAA","GCCAGGCATGGTGGCTCACACCTGTAATCCTAGCACTTTGGGAGACTGAGGCGGGTGAATCACCTGAGGTCAGGAGTTTGAGACCAGCCTGACCAGTATGGTGAAACCCAGTCTCTACTAAAAATACAGAAATTA"
"GL873571","4391733","4391878","chr11","33723808","33723943","46","29332075","AACTTAGCTGGGAATGGTGGCTCAAGCCTGTAATCCTAGCACTCTGGGAGGCTCAGGTGGGAGGATCACTTGAGGTTGCTGTGAGCTTGGCTGATGCCAGGACACTCTAGTGTGGGCAAGAGAGTGAGACTCCGCCTCAACAACAA","GCCGGGTGCAGTGGCTCATACCTGTAATCCCAGCACTTTGGGAGGCTGAGGTAGGCGGATCACGAGGTCAGGAGCTGAGATGGCGCCACTGCACCCCAGCCTGGGTGACAGAGCAAGACTCTGTCTCAAAAAAAAA"
"GL873571","6307773","6307841","chr9","62429628","62429694","22","56121855","CTGGGTGTGGTGGCATTGCACCTGTAATCCTAGCTACTTGGAAATCTTAAGCCCAGGAGTTGAAGACTG","CCCAGCATGGTGGTGCATACCTATAATCTCAGCTACTTGGAGGCTTGAGCTCAGAAGTTTGAGACCG"
"GL873571","6496217","6496306","chr1","27257765","27257856","27","20761548","GCAGGGTGTGTTGACCCACACCCACAATTCCAGGACTCTGGGGGGCCAGGGATGGTGGGTTCCCTCAGATCAGGAGCTCCTTACCAGCCT","GACTGGGCATGATGGCTCAAATCTGTAATTCCAGCACTTTGGGAGGCCGAGGTGGGTGGATTGCCTGAGATCAGGAGTTCAAGACCAGCCTG"
"GL873571","6499738","6499903","chr1","38976375","38976555","47","32476637","AAAATAACATGAATTGACTAGGCGAGGTGGCTCACATCTCTAATCCTAGCACTCTGGGAGGCTGAGGCAGGAGAATTGCATGAGGTTGCTGTGAGCTATGATGATACCACGGCATTCTAATCAGGGTGACAGAGTGAGATTCTGTCTTAAAACAAACAAACAAAAA","AAAATAAATAAATTAGCAGGGCCTGGTGGCGCACACCTGTAATCCCAGCTACTTGGGAAGCTGAGGCAGGAGAACCCACTTGAACCTGGGAGCCGGAGGTTGCAGTGAGCTGAGATGGCACCACTGCACTCCAGACTGCGTGACAGAGTGAGACTCCGTCTCAAAAACAAACAAACAAAAA"
"GL873571","11399575","11399872","chr15","109458692","109458994","79","98059117","CAGTGGCTCACACCTGTAAATCTAACACTCTGGGAGGCCAAGGTGGGTGGATCCCTTGAGCTCAGGAATTTGATACCAGCCTGAGCAAGAGTGAGACCTTGTCTCTACTAATAATAGAAAAATAGCCCGTGTTGTGGCACTTGTCCCAACCACTGGGGAGGCTTTAGGCGGGAGGATTACTTGAATTGGGAGTTTGATATTGCTGTGAGCTGGGCTGATGCCTTGGCATTCTAGCTTGGGTAACAGCGTAAGACTCCGTCTCAAATAAATAAATAAATAAATAAAAAGAAAAAAAGAA","GTGGCTCACACCTGTAATCTCAGCACTTTGGGAGACCGAGGCAGGTGGATCACCTGAGGTCGGGAGTTTGAGACCAGCCTGACCAACGTGGAGAAACCCCGTCTCTACTAACAATACAAAATCAGCTGGGCGTGGTGGTGCATGCTTGTAATCCCAGCTACTCGGGAGGCTGAGGTAGGAGAATCGCTTGAACCTGGGAGGTGGAGGTTGCGGTGAGCCGAGATCGAGCCACTGCACTCCAGCCTGGGTGACAGAGCAAGACTCCATCTCAAAAAAAAAAAAAAAAAAAAAAAAAAAAAAAAA"
"GL873572","114760","114841","chr8","26280134","26280211","16","26165374","GGCCAGGCATGGCGGCTCTTCCCTGTAATCCTAGCACTCTGGGAGGGCGAGGCAGGCAGATCACCTAGGCTAGGGTGAGATC","GGCCAGGAATGGTGGCTCATGCCTGTAATCCCAGCACTTTGGGAGGCTGAGGCAGGCAGATCACCTGAGGTCAGGAGT"
"GL873572","9421791","9421892","chr11","8089184","8089269","35","1332607","TACTAAATATATAGCAAGGCCAGGCACAGTGGTTCATGGCTGTAATCCCAGTACTCTGGGAGGCCTAGTCAGAGTTGACCTGAGATCAGGCTAGAAGCCTGG","ATAAAAATAATTGGAGGCCAGGCACGGTGGCTCATGCTTGTAATTCTAGCAATTTGGGAGGCTGACGCGGGTGAGATCATACTGAG"
"GL873572","11052834","11053035","chr14","11857478","11857657","65","804644","TCCACAAAGAAAGCAGAAGTGTGGCCGGGTGGTAGCTCAAGGCAGGAATCCCAGCACTCTGGGAGCTGGGAGGTGGGGGAGGATCCCTTGAGATCAGGAGTTGGAGGGCACAGTGAGCCTGGGGGAGGCCACTGTCTCTGTACTCTAGCAGGGAGACAGAGCAAGACTGCCCATTCAAAGAAAAACAACAAACAAAACAAAA","TACAAAAATTAGCTGGGCACGGTGCCACAAGCCTGTAATCCCAGCTACTCGGGAGGCTGGGCAGGGGAATAGCTTGAACCCAGAGGTGGAGGTTGCAGTGAGCCAAGATCAAGCCACAGCACTCCAGCCTGGGTGACAGAGCAAGACTCCATCTCAAAAAAAAAAAAAAAAAAAAAAAAA"
"GL873573","2564195","2564244","chr1","109985445","109985491","12","107421250","TACAAAAATTAGGCTGGGCTTGGTGGTTCACGCCTATAATCCTAGCACTT","ACTAAAATTAGCTGGGCATGGTGGTGCATGCCTGTAATTCCAGCTAC"
"GL873573","7423371","7423533","chr2","202783328","202783513","56","195359957","GGTGGCTCACACCTGTAATCCCAGCACTCTGGGAGCCCTGGTGGCTCATGTCTATAATCCTAGTACTCTGGGAGACCATGGTGGCTCATGTCTATAATCCTAGTACTCTGGGAGCCATGGTGGCTCACGCCTATAATCCTAGTACTCTGGGAGACCATGGTGG","GGCTGAGGCGCGGGGGCTCACGCCTGTAATCCCAGCACTGTGGGAGGCCGAGGCGGGTGGATCACGCCTGTAATCCCAGCACTGTGGGAGGCCAAGGCGGGTGGATCACGCCTGTAATCCCAGCACTGTGGGAGGCCGAGGCGGGTGGATCACGCCTGTAATCCCAGCACTGTGGGAGGCTGAGGC"
"GL873573","9657648","9657710","chr19","10207852","10207913","10","550204","TAAAAATAAAAAATTTAGCTGGATGTGGTGGCTCACACCTGTAATCCTAGCACTCTGGGAGAC","TAAAAATACAAAATTAGCTGGGTGTGGTGGCACACACCTGTAATCCCAGCTACTCAAGAGGC"
"GL873574","1624662","1624783","chr9","814961","815079","36","809701","GACTGGGTGGGTTGGATCATGCCTGGAATCCTAGCACCCTGGGAGGCCAAGGTGAAAGGATTGCTTGAGGTTAGGAGTTCCAGAAATGTAGCAGTCATGGTGACTTCATCCTTCTCTACCAA","GGCTGGGTGCTTTGATTCATGCCTGTAATCCCAGCACTCTGGGAGGCCGAGGCAGGTGGATCACCTGAGGTTAGGAGTTCGAGACCAGCTTGGCTAACATGGTGAAACCTCGTCTCTAC"
"GL873574","4459477","4459612","chr1","29437872","29437991","29","24978395","GGCCGGGCGTGGTGGCGCACGCCTGTAGTCCCAGCGCTATGGGAGGCCGAGGCGGGTGGATCACCTGAGCTCAGAGGTTCGAGACCAGCCAAGACCCCCCTGAGCCAAACGAGCCAGAGTGAGACCCCGTCTCTAC","GGCCGGGCGTGGTGGCTCACGCCTGTAATCCCAACATTTTGGGAGGCCAAGGCGGGTGGATCACCTGAGGTCAGAAGTTCGAGACCAACCTGGCCAACATGGTGAAACCCCTGTCTCTAC"
"GL873574","4681987","4682216","chr6","153082888","153083127","73","148400901","GGGTGCGGTGGCTCAGACCTATAATCCCAGCACTCTGAGAGGCCGAAGTGGGTGGATCACCTGAGCTCAGGAATTTGAGACCAGCCGTCTCTAAAAATAGCTGAGTGTTGTGGCAGTGGCTGTAAGTCCCAGCTGTTTGGAAAGCTGAAGCAAGGGAATCACTTGAACCCAAGAGTTTGAGGTTGCTGTGATGACAAAGTGAGACTCTATCTCAAAAAAAAAAAAAAAAA","GGCCGTGCGCGGCGGCTCACGCCTGTAATCCCAGCACTTTGGGAGGCTGAGGTGGGTGGATCACCTGAGGTCAGGAGTTTGAGACCAGCCCGACCAGAAATTAGATGGGTGTGGTGGTGCGCTCCTGCAGCCCCAGCTACTTAAGAGGCTGAGGCAGGGTAATCACTTGAACCCGGGAGGCGGAGGTTGCAGTGAGCCGAGCTCACGCCACTGCACTCCAGCCTGGGTAACAGAGCGAGA"
"GL873574","4709916","4710039","chr19","13152422","13152536","46","8442506","AAAAATAGAAAAACTAGCCAAGCATGGTGGTGCACCCCCTATAGTCTGAGCTCCTCAGCGGGCTGAAGCAAAAGGACGGCTGGAGCCCTGGAGTTTGAGGTTGCTGTGAGGCAAGGTGATGCCA","ACACATAAATTAGCCAGACATGATGGTGAGTATCTGTAATTCCAGCTCCTTGGGGGGCTGAGGCGGGAGAATTGCTTGAACCTGGGAGGCAGAGATTGCAGTGAGCCAAGATCGC"
"GL873574","6353839","6353913","chr5","25768079","25768163","22","19414240","AAAAATATAGCAAGGCCAGGCATGGTGGCTCACACCTATAATCCCAGTACTTGGGAGCTGGAATTTGAACCTAGG","AAAAAACTCAAACAAGGCTGGGCGTGGTGGCTCACACCTGTAATCCCAGCACTTTGGGAGGCTGAGGTGGGTGGATCACCTGAGG"
"GL873574","6533061","6533332","chr5","85182161","85182439","81","78649100","GGCTGGGCGAGGTGGCTTACACCTATAATCCTAGTACTCTGGGAGGCCAAGGTGGGTGGATTGCCTGAGCGCACAGTTTCAAGACCAGCTGGAGCCAGAGAGAGAGAGAGAGACCCTGCCTCTAAAAATAGCCAGGCATTGTGGCAGGCACCTGTAGTCCCAGCTACTTGGCAGGCGGAGGTATGAGAATCGCTAGAGGTTGCTGTTAGCTATGATGCCATAGCACTCTACCAAGGGCGACAAAGTGAAACTCTGCCTCAAAAAAAAGAAGA","GCCAGGCGTGGTGACTCAAGCCTGTAATCCTAGCACTTTGGGAGGCCAAGGTGGGCGGATTGCCTGAGCTCAAGAGTTTGAGACCAGCCTGGGCAACACGGTGAAACCCAATCCCTACTAAATACAAAAAAAATTAGCCGGGTGTGGTGGTGTGAACCTGTAGTCCCAGCTACTCGGGAGGCTGAGGCAGGAGAAGGCAGAAGTTGCAGTGAGCCGAGATCACACCACTGCACTCCAGCCTGAGTGACAGAGCAAAACTCTTTCTCAAAAAAAAAAAAA"
"GL873574","6643746","6643907","chr2","92627944","92628105","46","85984198","AAATAGCCAGGCGTTGTGGCAGGCACCTATAGTCCCAGCTACTTGGGAGGCTGAGGCAAGAGAATCACTTAAGCCCAAGTGACAGAGGTTGCCAGGGCACTCTACGTAGGCAACAGAGTGAGACTCTATCTAAGAAAGAAGGAAGGAAGGAAGGAGAAAGAA","TTAGCCGAGCATTGTGGTGCGCGCCTGTAGTCCCAGCTACATGGGAGGCTGAGGCAGGAGAACACCTGAACCCAGGATGTGAGCTGAGTCGCGCCATTGCACTCCAGCCTGGGCAACAGAGTGAGACTCCATCTCAAAAATAAAATAAAATAAAATAAAAAA"
"GL873574","6644163","6644274","chr1","128607504","128607619","20","121963341","CTGTAATCCTAGCACTTGGGAGGCTGAGGCAGGTGGATCACCTGAGTTCAGGAGTTCAAGACCAGCCTAAACAAGAGTGAGACCCTATCTCTACTAAAAATAGAAAAAATAT","GCCTGTAATCCAAGCACTTTGGGAGGCTGAGGCGGGTGGATCACCTGAGGTCAGGTGTTCGAGACCAGCCTGGCCAACGTGGTGAAACCCCAACTCTACTAAAAATACAAAAATTA"
"GL873574","8511822","8512127","chr1","23439759","23440073","84","14927937","GGTGGCTGGTGCCTGTAATCCTAGCACTCTGGGAGACTGAGGCAGGTGGATCACTTGAAATCAGGAGTTTGAGATCAACCTGAGCAAGAGATCTTGTCTCTCCTAAAGATAGAAAAACTAGCTGGGATTTGTGGTGGACACCTGTAATTTCAGCTACTCAGGAAGCTAAGGCAAGAGCATTGCTTAAAACCAGGAGTTTGAAGTTGATGTGAGCTAGGATGTCAGGGCAGGTTACCCAGGGTGACAGAGTGAGACTCTGTGTCAAAATAAACAAACAAACAAACAAACAAAACAAAATAAAATAAA","GGCTGGACATGGTGACTCACGCTTGTAATCCCAACACTTTGGGAGGCTGAAGCAGGCAGATCACCTGAGGTCAGGAGTTTGAGACCAGCCTGACCAACATGGTGAAACCTTGTCTCTACTAAAAATACAAAAATTAGCTGGGAGCAGTGGTGCACACCTGTAATCCCAGCTACTCGGCAAGCTGAGGCAAGATAATTTTTTAAACCTGGGAGGTGGAGGTTGCAGTGAGCCAAGATCGTGCCACTGTACTCCAACCTGGGAGACAGAGCAAGACTCTGTCTCAAAAAAAAAAAAAAAAAAAAAAAAAAAAAAAAA"
"GL873575","2107336","2107519","chr4","38052972","38053149","54","35945636","TCAATTAAAAACTTTTTAAAATGAGGCTGAGCATGGTGGTTCACACCTGTAATCCCAGCACTTTGGGAGGCCGAGGCAGGAGGATCACCTGATCCCAGGAGTCCAAGCCTACAGTGAGCCGTGATAATACCACTGCACTTCAGCCCAAAGCCTCAAAAAGAAAAAAAAAAAAGGATAGACAAGA","TATATATATATATATTATTTTGGGGGGGCATGGTGGTGCACACCTGTAATCCCAGCTACTCGGGAGGCTGAGGCAGGAGAATTGCTTGAGCCCGGGAGGCAAAGGTTGCATTGAGCTGAGATCACACCACTGCACTCCAGCCTGGCGACAGAGTCTCAAAAAAAAGAAAAAATAAAAA"
"GL873575","5831824","5831959","chr1","29437872","29437991","28","23606048","GGCCGGGCGTGGTGGCGCACGCCTGTAGTCCCAGCGCTATGGGAGGCCAAGGCGGGTGGATCACCTGAGCTCAGAGGTTCGAGACCAGCCAAGACCCCCCTGAGCCAAACGAGCCAGAGTGAGACCCCGTCTCTAC","GGCCGGGCGTGGTGGCTCACGCCTGTAATCCCAACATTTTGGGAGGCCAAGGCGGGTGGATCACCTGAGGTCAGAAGTTCGAGACCAACCTGGCCAACATGGTGAAACCCCTGTCTCTAC"
"GL873575","7451097","7451208","chr3","122814630","122814743","22","115363533","GGCCAGGTGTGGTGGCTCACACCTGTTATCCTAGCACTCTGAGAGGCCACAGCAGCTGGATCACTTGAGCTCAGGAGTTCAAGACCAGTCTGAGCAAGAGCAAGACCTCACC","GGCTGGGTGTGGTGGCTCATGCCTGTAATCCCAGCACTTTGAAAGGCCAAGGCAGATGGATCACTTGAGGTCAGGAGTTCCAGACCAGCCTGGCCAACATGGCAAAACCCCATC"
"GL873575","7451277","7451445","chr6","58863249","58863409","41","51411972","AAAAATTCAGCCAGCCACAGTGGAAGTGGATGCCTGCCATCACAGCTACTCTGGGGGCTGGGGCAAGAGAATTGCTTGATCCCAGGAGTCTGAGGTTGCTGTGACCTAGGCTGACACCACAGCACTCTACCCAGGGTGACAGAGTGAGGCTGTGTTTAAAAAAAAAAAA","TTAGCCAGGCATGGTGGCACATGCCAGTAATCCCAGCTACTCAGGAGGATGAGGCAGGAGAATCGCTTGAACCCAGGAGGCAGAGGTTGCAGTGAGCTGAGATTGCGCCACAGCACTCTACCCTGGGTGACAGAAGGAGACTCTGTCTCAAAAAAAAAAAA"
"GL873576","1765109","1765185","chrX","53921180","53921256","12","52156071","GGCCAGGTGCAGTGGCTCATATCTGTAATCCTAGCACCCTGGGAGGCCAAGGTAGGCGAATCACCTGAGGCCAGGAG","GGCCAGGTGCAGTGGCTCACGCCTGTAATCCCAGCACTTTGGGAGGCCGAGGTGGGCGGATCACTTTAGGTCAGGAG"
"GL873576","2711577","2711895","chr7","6620384","6620702","85","3908807","GGTCGAGCTTGGTGGCTCATGCTTGTAATCCTAGCACTCTGGGAGGCCAAGGCAGGTAAGTTGCCCTGAGCTCATAGGTTCCAGATCAGCATGAGCCAGAGTGAGACCCTGTCTCTACCAAAAAATAGCCCGGCATTCTGGCAGGTGCCTGTAATCCCAGCTGCTTGGGAGGCTGAGGCTAGAGAATCACTTAAACCCAAGGGTTAGTGGAGGTTGCTGTGAGCTATGATTCCACCGTACTCTACTGAGGGCCACAAAGTGAGACTCTGTCTCCATAAAAAAGAAAGAAAGAAAGAAAGAAAAATAAAATAAAATAAAA","GGCCAGGCACAGTGGCTCATGTCTGTAATCCCAGCACTTTGGGAGGCCGAGGCGGGTGGATTACCTGAGGTCAGGAGTTCTAGACCAGCCTGGCCAACAAGGCGAAACCCTGTCTCTACTAAAAATACAAAAAATTAGCTGGGCGTTTTGGCACATGCCTGTAATCCCAGCTACTTGGGAGGCTGAGGCAGGAGAATTGCTTGAACTGGGGAAGTGGAGGTTGCAGTGAGCTGAGATCACACCATTGCACGCCTGAGCAACAGAGCGAGACTCTGTCTCAAAAAAAAAAAAAAAAAAAAAAAAGAAAAGAAAAAGAAAA"
"GL873576","4782520","4782652","chr9","61136941","61137074","22","56354421","CCAGGCACGGTGGCTCACCCTTGTAACCCTAGTACTTTGGGAGGCTGAGGTGGGAGGATCCCTTGAGGTCAGGAGTTCAAGACCAGCCTGAACAACAGTGAGACCCCCGTCTCTACTAAAAAATAGAAAAGTT","GCCAGGCACGGTGGCTCACGCCTGTAATCCCAGCACTTTGGGAGGCTGAAGCGGGCGGATCACCTGAGGTCAGGAGTTCAAGACCAGCCTGGGCACCATGATGAAACCCCGTCTCTATTAAAAATACAAAAATT"
"GL873576","4782930","4783078","chr7","57521645","57521803","40","52738715","AGTTAGTCTGGTGTCATGGTGGGTGCCTGTAGTCCCAGCTGCTTGGGAGGCTGAGGCAAGAGAATCACTTGAGCCCAGGAGTTGGAGGTTGCTATGAGCGAGGCTGTAGCCTAGGCAACAGAATGAGACTTTGCCTCAAAAAAATAAAA","TTAGCTGGGCATGGTGGCGCATGCCTGTAGTCCCAGCTACTTGGGAAGCTGAGGCAGGAGAATCACTTGAACCTGGGAGGTGGAGGTTGCAGTGAGCTGAGATCGCACCGCTACACGCCAGCCTGAGCAACAGAGAGAGACTCTGTCTCAAAAGAAAAA"
"GL873576","7828709","7828723","chr5","101042981","101042996","1","93214272","TAAATAAATAAAAAA","TAAATAAATAAATAAA"
"GL873576","7828960","7829230","chr13","49045537","49045844","89","41216577","GCCGGCTGCAGTGGCTATAATCCAAGTACCCTGGGAGGCTTAGGTGGATGGATCACTTGAGCTCAGAAGTTCAAGACCAGCCTCAGCAAGAGGTAGACCTTGCCTCTATTAAANNNNNNNNNNNNNNNNNNNNNNNNNNNNNNNNNNNNNNNNNNNNNNNNNNNNNNNNNNNNNNNNNNNNNNNNNNNNAGTTTGAGGTTGCTGTGAGCTATGATGAAGCCAGGGCATTCTACCCAGGGTGACAGAGTAACTCTTAAAAAAAACTAAACAA","GGCCAGGCAGAGTGGCTCATGCCTGTAATTCCAGCAATTTGGGAGGCCTAGGCAGGCAGATTACCTGAGGTCAGGAGTTTGAGACCAGCCTGGCCAACATGGTGAAACCCCGTCTCTTCTANNNNNNNNNNNNNNNNNNNNNNNNNNNNNNNNNNNNNNNNNNNNNNNNNNNNNNNNNNNNNNNNNNNNNNNNNNNNNNGGAGATAATAGCTTTTGTAGAACGAAGCGATGCAACAGCCAGATCGCCGCCACCACCCTTAGGTCCTGGCGACAGAGTGAGATCCATCTTAAAAAAAAAAAAAAAAAAA"
"GL873576","10622840","10623093","chr7","60266447","60266705","74","49643607","GCTGGGTATGGTGGTTCACACCTATAATCCTAGCACTCTGGGAGGCTGAGGTGGGAGGATTGGTGGAGCTCAGGAGCTCATGAGGTGCCAAATCACTGGTGCCACACACCTGTATTCCCAGCTACTGAGGAGGCTGAGGCAGGAGGATCAGGTAAGCCCAGGAAGTTTGAGGTTGTAGTGAGTTAGGATGATTGAACTCTGCCTTGAGAGACAGAGCAAGATCCTCCTTCCTCCTAAGCAAACAAACAAATAAA","GGCTGGGTGCAGTGGCTCACACCTGTAATCCTAGCACTTTGGGAGGCTGAGGCGGGAAAATTGCCTGAGCTCAGGAGTTCAAGGACAGCCTAGGCAACATAGCATGGTGGTGCACGCCTGTATTCCCTGCTACTTGGGAGGCTGAGGCACAAGAATTGCTTGAATCCGGGAAGTGGAGGTTGCAGTGAGCCATTGTGGCACTGCTCTCCAGTCTGGGTGACAGAGCAAGACTCCATCTCAAAAAAAAAAAAAAAAAAAA"
"GL873576","10819939","10820007","chrX","67133632","67133707","21","56313693","AGGTTGCAGTGAAATTGTACCATTCCAATGAAGCCTGGGGGACAGAGTGAGATTCTCTCAAAATAAAAA","GGAGGTTGCAGTGAACCGAGATCGTGCCACTGCACTCCAGCCTGAGCGACAGAGTGAAACTTCGTCTCAAAAAAAA"
"GL873576","10920306","10920363","chr3","48261745","48261808","16","37341439","GCTGGACCTTGTAGAGAGTGCCTGTAATCCCAGCTACATGGGGGGCAAGAGAATTGCT","GCTGGGCATGGTGGTGCATGCCTGTGATCCCAGCTACTCAGGAGGCTGAGGCAGGAGAATTGCT"
"GL873576","10920398","10920529","chr10","67341428","67341546","30","56421030","GGCCAGGCGTGGTGGCTCACGCCTGTTGTCCCAGCACTGTGGGAGGCCGAGGTGGGTGGATTGCCTGAGCTCAGAGGAGTCCGGAAGACCAGCATGAGGCAGAGTGAGCCAGAGTAAGATCCTGTCTCTACC","GGCTGGGTGTAGTGGCTCATGCCTGTAATCCCAGCACTTTAGGAGGCCAAGGTGGATGGATTGCCTGAGCTCAGGAGTTCGAGACCACCCTGGGCAACAAGCCAAAACCCTGTCTCTAC"
"GL873577","515809","515961","chr7","137660778","137660931","43","137144969","AGCTGGGCATGGTGGCTCATGCCTATAACCCTAGCGTGCTAGGAGATTGCTTGTCAGGAGACTGAGGTTGCAGGAAACTGTGATGATGGCACTGCACTCTACCCAGGGTGACAGAGCAGGACTCTGCCTCAAAAAAAAAAAAAAAAATAGAAA","TTAGCTGGGCATGGTGGCGCATGCCTATAATCCCAGCTACTTGGGAGGCTGAGGCAAGAGAATCGCTTGAACCGGGGAGGCAGAGGTTGCAGACTGCACTCCAGCCTGTGTGACAGAGTGGGACTCCGTCTCAAAAAAAAAAAAAAAAAAAAAA"
"GL873577","1633164","1633256","chrX","38269524","38269615","26","36636360","TCAGCCAGGCATGGTGGCACTTGCCTATAAACCCAGCTCCTTGGGAAGCTGAGCCGGGAGGATCCCTTGCACCCAGGAGCAACGGAAGGCAGT","AATTAGCCAGGCATGGTGGCACATGCCTATAATCCCAGCTACTCAGAAGGTTGAGGCAGGAGAATCACTTGAACCTGGGAGGCAGAGGTTGC"
"GL873577","3979502","3979560","chr20","68909283","68909346","13","64929781","GAGTTTGAGACCAGCCTGAGCAAGACCGAGACCCAGTCTCTACTAAAAATAGAAAAATT","GGAGTTCAAGACCAGCCTGACCAACATGGAGAAACCCTGTCTCTACTAAAAAATACAAAAATTA"
"GL873577","3979839","3980009","chr10","31403126","31403287","39","27423287","ATGAGCAGATTGTCTTGGTGGGCACCTGTAGTCCCAGCTATTGGAGGTGGGAGGCTGAAGCAGGAAAATCTCTTGAGCCCAGGAGTTTGAGGTTGCTGTGAGCTAGGCTGACACCACGGCACTCTAGTCAGGGCGTCAGAGTGAGACTCCGTCTCAAAAAAAAAAAAAAAA","TTAGCTGAGTGTGGTGGCGCACATCTGTACTCCCAGCTATTTGGGAGGCTGAGGCAGGAAAATCGCTTGAACCCAGGAGGTGGAGGTTGCAGTGAGCCAAGATCACACTACTGCACTCCAGCCTGGGTGACAGAGTGAGAATCCATCTCAAAAAAAAGAAAA"
"GL873577","6050882","6051080","chr1","153219820","153220007","59","147168938","GGCTGGGCGTTGTGACTCATGCCTGTAATCCCAGCACTCTAGGAGGCCGAGGTGGGTGGACTGCCTGAACTCAGAGGTTTAAGACCATCCTGAGCCGCAGTGAGCCAGAGCGAGACCCTGTCTCTACCAAAAAAAGCTGGGTGTTGTGGTGGGCGCCTATAGTCCTAGCTACTTGAGGCGCTAAGGGTAAAAAAATTGC","GGCCTGGCACAATGGCTCACGCCTGTAATCCTAGCACTTTGGGAGGCCGGGGTGGGTGGATCACCTGAGATCAGGAGTTTGAGACCAGCCTGGCCAACATGGTGAAACTCCTTCTCTACAAAAATTAGCCAGGTGTGGTGGTGGGTACCTGCAATCCCAGCTATTTGGGAGGCTGAGGCAGGAGAATC"
"GL873577","8463965","8464050","chr9","52134422","52134508","19","43670457","CTGGGTGCTATAGCTCACGCCTATAATCCTAGCACTCTGGGAGTTTGGGGCAAATGGATCACCTAGGCTCAGGAGTTTGATACCAG","GGCTGGGAGCAGTGACTCACGCCTATAATCCCAGCACTTTGGGAGGCTGAGGCAGATGGATCACCTGAAGTCAGGAGTTCGAGACCA"
"GL873577","9471486","9471613","chr16","5178790","5178910","46","4292696","TTAGCCAGGCATAGTAGCCTGTGTGTAGTCCTAGCTACTCAGGAGGCTGAGGTAGATGGGTCACTTGAGGTTGCAGAGATTATGGTAATGTCACTGTACTCTAGCCCTGGCAACAGAGCACAACCCTG","TTAGCCGAGCCTGGTGGCATAAACCTGTAATCCCAGCTACTCAGGAGGCTGAGGCAGGGGAATTGCTTGAACCTGAGAGGAGAAGGTTGCAGTGAGCCGAGATTGCACCATTGCACCCCAG"
"GL873577","9471875","9471998","chr7","17832200","17832315","36","8360325","GGCCAGGTGAAGCAGCTCATGGCTATAATCCTAGCAGTTTGGCAGGCCAAGGTGGGAGGACTGCTTGAGGTCAAGAGTTCAAGACCAACCCATCTTTGCGAAAAATTTAAAAATTACCTAGGCA","GCCAGGAGAGGTGGCTCATGCCTCTAATCCCAGCACTCTGGAAATCCAAGGTGGGTGGATCACCTGAGGTCAGGAATTCCAGACCAGTCTGGCCAATATAAAAAATTAGCCAGGCT"
"GL873577","9853150","9853170","chr3","85044647","85044667","3","75191497","AAACAAACAAACAAAAAAAGA","CAAACAAACAAACAAACAAAA"
"GL873577","9853206","9853473","chr7","130818682","130818963","67","120965476","GCTGGGCGCAGCGTCTCACTCCTGTAATCCCAGCACTTGGGAGGCCAAGGTGAGTGGATTGCCTGAGTTTACAGTTTCGAGACCAGCCTGAGCCAAAGCGAGACCCCCATCTCTAAAAAATAGCTGGGCATTGTGGTGGGCACCTGTAGTCCCAGCTACTTGGGAGGCTGAGGCAAGAGGATCGCTTGAACCTAAGAGTTTGAGGTTGCTGTGAGCTAAGGCTCCATGGCATTCTACCAAGGGTGACTAAGTGAGACTCTGTCTAAAA","GCCGGGCACAGTGGCTCACACCTGTAATCCCAGTACTTTGGGAGGCCAAGGTGGGTGGATCACCTGAGGTCAGGAGTTTGAGACCAGCCTGGCCAACATAGTGAAACTCTACTAAAAATACAAAAAAATAGCTAGGCATGGTGGTGCGCACCTGTAATCCCAGCTACTTGGGAGGCTGAGGCAGGAGAGTTGCTTGAACCCAGCGGGGTTGAGGTTGCAGTGAGTTAAGATCAAGCCACTGTGCTCCAGCCTGGATGACAGAGAGAGACTCCATCTCAAAAA"
"GL873577","10722415","10722478","chr10","12501471","12501539","23","1779056","AATAAAAAAATGCTGGGTACAGTAGTACATGCCTGTACTCTCATCTGGGGAAGCTGAGGCATGA","AAAGTAAAAAATTAGAGCTGGGCATGGTGGCACACACCTGTAATCCCAGTCACTAGGGATGCTGAGGCA"
"GL873578","463331","463568","chr10","28935382","28935620","93","28472051","CAGGTGCTTTGACCCACACCCTCAACTCTAGGACTTTGGACGCCCTGGCTGGGTGGGTCCTTTAAAGTCAGGAGCTTCTTATCAGTCTGGGCAAAAGTGAGACCCCATCTCTACCAAACAAAGAAAGAAATCAGCAGTATGTTGCAGTAGAGACTCACCAATACCTTCTTTCAAAGACCAAAGCTGGAAGGACACTAAAGACCATGATCTCATGGCCTCCCTGAGCCATGACAATGCC","CCAGGTGCAGTGGCTCATGCCTGCAAGCTCAGAACTTTGGGAGGCAGAGGTGAGCAGACTGCCTGAGTTCAGGAGTTCAAGACCAGCTGGGCAACATGGTGAGACCCTATCTCTACTAAAAATACAAATAATTAGCAGGGTGTGGTAGCACACACCTGTAGTCCAGCTACTCAGGAGGCTGAGGCAGGAGAATTGCTTGAACCCAGGAGGCAGAGTTTGCAGTGAGCCAGGACTGGGCC"
"GL873578","1143712","1143827","chr11","52824583","52824692","30","51680871","GGCTGGGTGTGGTGCCTCATGCCTGTAATCTAAGCCCTCTCCGAGGCTGAGGTGGGAGGATCCCTTGAGTTTAGGAGTTTGATTTTGAGACCAGCCTGATCAAGAGAGAGACCTCA","GGCCGGGTGTGGTGGCTCATGTCTGTAATCCCAGCACTTTGGGAGGCTGAGGTGGGTGGATACCCTGAGGTCGGGAGCTCGAGACCAGCCTGACCAACATGGAGAAACCC"
"GL873578","1144101","1144139","chr3","33494224","33494257","11","32350123","GAGAGAGACCTCATGTCTACTAAAATAAATAAATATATA","GTGAAACCCGTCTCTACTAAAAATACAAAAATTA"
"GL873578","1144175","1144343","chr12","119519961","119520131","41","118375786","ATTATCCAGGCCTTCTGGTGGATGCCTGTAGTCCTAGCTACTAGAAAAGCTGGAGCAGAATCACTTGACCCAGGAGCTGGAGGTTGCAGGGAGCTAGGCTGATGCCACAGAATTCTAGCCTGAGGCAAAAGAATTGAGCCACTGTCTCAAAAAGGAACAAAAAAGAAAA","ATTAGCCAGGTGTGGTGGCATGCACTTGTAATCCCAGCTACTAAGAAGGCTGAGGCAGGAGGATCACTTGAACCCGGGAGGTGGAGGTTGCAGTGAGCCAAGATCATGCCACTGCACTCCAGCCTGGGCAACAGAGTAAGACTCTGTCTCAAAAAAAAAAAAAAAAAAAAA"
"GL873578","4593962","4594035","chr16","68825055","68825124","22","64231093","AGCTGGGTACAGTGGCTCACATATAATCCCAGTGACTCAGGAGGCTAAGACAGGAGGATTACTAGGACCTGAGA","GGCTGGGCACAGTGGCTCAGACCTGTAATCTCAGTACTTTGGGTGGCTGAGGCAGGTGGATCACCTGAGG"
"GL873578","6158845","6158972","chr3","500432","500562","24","5658413","GACATGGTGGCTCACACCTGTAATCCTAGCCCTCTGGGAGGCTGAGGCAGGTGGATCACTTGAGTTCAGGAATTCAAGACCAGCTTGAGTGAGAGCAAGACCCTGTCTCTACTAAAAATAGAAAAATT","GCACGGAGGCTCATACCTGTAATCCCAGCACTTTGGGAGGCTGAGGCAGGTGGATCACCTGAGGTCAGGAGTTCCAGACCAGCCTGGCCAACATGGCGAAACCCTGTCTCTACTAAAAATACAAAAAATCT"
"GL873578","6159253","6159444","chr19","34496349","34496541","55","28337096","ATAAAATAAAAATAGAAAAATTAGCCAGGCATTGTGGCAGACATGCGAAGTCTCAGCTACTCCAGAGGCTGAGACAGGAAGATTACTTGAGCCCAAGAATCTTGCTGTGAGCTAAGCTGATGCCATAGCATTGTAACCTAGGCAACAGAGTAAGACTTGGCCTCAAAAATAAAATAAAATAATAAAGTAAAA","TTAGTTAATTAAATTAAACTTAGCTAGGCATAGTGGAACACACCCATAGTCCCAGCTACTCTAGAGGCTGAGGCAGGAGGATTGCTTGAGCCAAGTTGGAGGCTGCAGTGAGCTATGGTGGTGCCACTGCATTCCAGCCTCAGTGACAGAGAGAGACCCTGGCTCAAATAATAATAATAAATAAATAAATAAA"
"GL873578","6766040","6766171","chr2","93098086","93098217","30","86332046","CCAGGCACAGTGGCTCATGCCTATAATCCTAGTAGTCTAGGAGGCTGAGGTGAGTGCATTGCTTGAGCTCAGGAGTTAGATACCAGCCTAACCAAGAATGAGACCCCATCTCTATTAAAAATAGAAAAGTTA","GCCGGGCACAGTGGCTCATGCCTGTAATCCCAGCACTTTGGGAGGCCGAGGCGGGCAAATCACGAGGTCAGGAGTTCAAGACCAGCCTGACCAATATGATGAAACCCCGTCTCTATTAAAAATACAAAAATT"
"GL873578","6766434","6766577","chr9","21128084","21128223","50","14361650","GTTAGCCAGGAGTTGTGGCGGGCACCTACAGTCCTAGCGACTCAGGAGGCTGAAGTAGGCAGAGTTTGATGTGTTGCTGTGAACTACAAGGACACCAATGCACTCTAGGCCGGTAACAGAGTGAGACACTGACTAAAAAAAAAA","TTAGCCAGGTGTGGTGGCACATGCCTGTATTTCCAGCTACTCGGGAGGCTGAGGCAGGAGAATTGCGTGAGCTGAGATCATGCCACTTCATTCCAGTCTGGGTGACAGAGTGAGACTCTGCCTCAAAAAACAAAACAAAA"
"GL873578","7397948","7398119","chr5","40230148","40230319","43","32832200","TAAAAATAGCCATGCATTGTGACAGGCACCTGTAGTCCCAGCTACTCAGGAGGTTGAGGTAAGAGAATCACTTGAACCCAAGAGTTTTGAGGTTGTTATGAGCTAAGACGCCTCGGGACTCTACAAAAGGTAACAAAGTGAGACTCTGTCTCATAAAAAAAGAAAAAAAGAA","AAAATTAGCCAGGCATGGTGACGTACACCTGTAGTCCCAGCTACTCGGGAGGCTAAGGCAAGAGAATCGCTTGAACCCAGGAGGCAGAGGTTGCAGTGAGCTTAGATCACGCTACTGCGCTCCAGCCTGGGTGACGGAGTGAGACGCCATCTCAAAAAAAAAAAAAAAAAAA"
"GL873578","7398378","7398515","chr15","102382935","102383070","35","94984557","GGTCGAGCAAGGTGGCTCACGCCTGTAATCCTAGCACTCTGTGAGGCTGAGGCAGATGGATTGCCTGAGCTCGTGGGTTCGAGACCAGCCTGAGCCAGAGTGAGACCTCATCTCTAAAAATAGCTGGGAAGCTGGGCA","GGCCAGGTGTGGTGGCTCACGCCTGTAATCCTAGCACTTTGGGAGGCTGAGGCGGGTGGATTGCCTGAACTCAGGAGGTCAAGACCAGCCTGGGCAACACAGTAAAACCCCATCTCTACTAAAATACAAAAAATCA"
"GL873579","370235","370429","chr16","38067345","38067552","57","37697110","GCACAGGCCTGAAATCCTAGCACTCTGAAAGGCCAACGGAGGAGAATTTCTGGAGCTCAGGAGTTTGATACCAGCCTAAGCAAATAAAGCTAGACCTCTATCTCTACTAAAATTAGAAAAATTAGGCAGATGTGGTGGTAGGCACCTATAGTCCCAATTACTCCAGAGGCTGAGGCAGAAAGACTCTTGAACCCA","GTCAGGCATGGTGGCTCATGCCTATAATCCTAGCACTTTGGGAGGCCAAGGCCGGTGGATCACCTGAGGTCAGGAGTTTGAGACCAGCCTGGCCAATATGGCAAAACCCCGTCTCTACTAAAAATAAAAAAATTAGCTGGGCACGGTGGTGGGCACCTATAGTCCCAGCTACTCAGGAGGCTGAGGCAGGAGAATTGCTTGAACCCAG"
"GL873579","370936","371046","chr3","3847698","3847802","33","3476762","TGACTCTTGAACCCAGGCACATGAGGTTGCTAAGAGTCTAGGCTGATGTCACGGCACTCTAACCTGGGAAACAGTGTGAGGTTCTGCCTCAATAAATAAATAAATAAATAA","TGGCTTGAACCCAGGAGGCGGAGGTTGCAGTGAGCCGAGATCACGCCACTGCACTCCAGCCTGGGCAACAGAGCGAGACTGTCTCAAAAAAAAAAAAAAAAAAAA"
"GL873579","599436","599605","chr10","38982686","38982853","41","38383250","AAAAAGTCAGACATTGTGGCAGGTGTCTGTAATCCCAGCTATTTGGGAGGCTGAGGCAGGAGTATCATTTGAACCCACGAGTCTGAGGTAACTGTGAGCTAGGCTAACACAACAGCACTCTAGCCTGGGCAATAGAATGAGACTCTATCAAGAAAAGAAATGAAAAGAAA","TATTAGCCTGACACAGTGGCGCGCATCTGTAATCCCAGCTACTTGGGAGGCTGAGGCAGGAGAATCACTTGAACCCAGGAGGCGGAGGTTGCTGTGGGCTGAGATCATGCCACTGCACTCCAGCCTGGGCAACAGAGGGAGGCTCCATCTCAAAAAAAAAAAAAAAAA"
"GL873579","599942","599953","chr3","71473700","71473710","4","70873758","TTTTAAAATAGT","TTTAAAAAAAA"
"GL873579","600232","600365","chr1","16061315","16061447","30","15461083","GGCTAGGCAAGGTGACTCATGTCTGTAATCCTAGTACTCTGGGAGGTTTGAGGCAGGAAGACCACTTTAGCTCAAGAGTTCCAGATCAGCCTGTGCAAGAGTGATACATCATCTCTACTAAAAATCAAAAATTA","GGCTGGGCATGGTGGCTCATGCCTGTAATCCTAGCACTTTGGGAGGTTGAGGCAGGCAGATCACTTGAGGTCAGGAATCTGAGACTAGCCTGGCCAACATGGTGAAACTCCATCTCTACTAAAAAAAAAAAAA"
"GL873579","5650320","5650591","chr6","54938866","54939145","71","49288546","GTCAGGTGTGTTAGCTTACAGTAGTAATCCTAGCACTTTGGGAGGTTGAAGTGGGTGGATTGCTTGAGCTCAGGGGTTCAAGACCAGCCTGAACAAGAGTGGGACCTCATCTCTATTAAAAACAGAAAAACTAGCTGGGTGTTATGGTGGGTGTCTGTAGCCCCAGCTACTCAGGAGGCTGAGGCAGGAGGTTGAGGTTGCTGTGAGCTATTGAGACCACAGCACTCTATCCAGGGCAACAGAGTGAGACCCCTCCCCCCCCCAAAAAAAAA","GGCCAGGTGTGGTGGCTCACGCCTGTAATCCCAACACTTTGGGAGGCCGAGGTGGGTGGATCACCTGAGATCAGGAGTTCAAGACCACCCTGGCCAACATGGTGAAACCCCGTCTCTACTAAAAATACGAAAATTAGCTGAGTGTGGTGGTGCATGCCTGTAGTCCCAGCTACTCAAGAGGCTGAGGCAGGAGGTGGAGGTTGCAGTGAGCCGAGATTGCATCACTGCACTCCAGCCTTGGCGACAGAACGAGAGAGACTCCATCTAAAAAAAAAAAAAA"
"GL873579","7037162","7037347","chr3","37328686","37328893","67","30291524","GAGGTGGGTGGATTGCCTGAGCTCACAGGTTGGAGACCAGCCTGAGCCAGAGCAAGACCTTATCTCAAAAAATAGCCAGGTGTTGTGGCTGGCACCTGTAGTCCCAGCTGCTCAGGAGGCGGAGGCAAGAGAAATGCTTGACCTCAGGAGTTTGAGGTTGCTGTGAGTTCAACTCACACTAATACA","GAGGCAGGGGGATCACCTGAGGTCAGGAGATCGAGACCAGCCTGGCCAACATGGTGAAAACCTGTCTCTACTAAAAATCCAAAAACATTAGCCAGGTGTGGTGGCACGCACCTGTAATCCCAGCTACTTGGGAGGCTGAGGCAGGAGAATCACTTGAACCTGGGAGGCAGAGGTTGTAGCGAGCCGAGATCACACCACTGCACCCCAG"
"GL873579","11077764","11077972","chr19","1200469","1200683","63","9877295","GCCAGGTGCAGTGGCTCATGCCTATAATCCTAGCACCCTAGGAGGCTGAGGAGTTCAAGACCAGCCTAAGCAACTGTGAGACCCCATCTCTACCAAAAATAGAAAAATTAGCTGACTGTTATGGTGTGCACCTACAGTCCTAGCTACTCAGGAGGCTGAGGCAGAAAGAGTCCTTGAACCCAGGAGGCTTTTTTTTGTTGTTGTTGTTG","GGCCAGTCGCGGTAGCTCATGCCTGTAATCCCAGCACTTTGGGAGGCCGAGGCGGGCAGATCACCTGAGACCAGCCTGGCAACATGGTGAAACCCCATGTCTACCCAAACTACAAAAATTAGCTGGGTGTGGTGGTGCACGCCTGTAATCCGAGCTACTCAGCAGGCTGAGGCAGGAGAATCCCTTGAACCTGGGAGGCAGAGGCTGCAGTGAGC"
"GL873579","11078245","11078333","chr19","4926258","4926351","22","6151987","TGAACCCAGGAGTTTGAGTTCGCTGTGAGCTAAGCTGAGGCCACAGCACTCCAGCCTGGGCAACAGAGTGAAAGGAAAAAAATAAAAAA","TGAACCCGGGAGGTGGAGGTTGCAGTGAGCCAAGATCACACCAATGCACTCCAGCCTGGGCAACAAGAGTGAAACTCTGTCTAAAAAAAAAAAA"
"GL873580","320374","320488","chr13","48549305","48549409","42","48228931","GGTAGTGCGTGCCTGCATTCCCAGCTACGGGAGGGCAGGGACTTGAGGCCAGCCTGGGCAAAATAATGAGACCTACTAATGACTCTACTAATACAGAAACAATTAGCTAGGTATG","TGGGAGGCCGAAGTGCGCAGATCACCTGAGGTCAGAAGTTGGAGACCAGCCTGGCCAACATGGTGAAAACCCATCTCTACTAAAAATACAAAAATTAGCTGGGCA"
"GL873580","374969","375091","chr6","147681010","147681135","27","147306041","CGGTGGCTCACACCTATAATCCTAGCATTTTGGAAGGCTGAAGCCGAGGATCTCTGGAAGTCAGAAGTTCAAGACCAGCCTGCCCAAGAGCAAGACCCCATCTCTACTAAAAATAGAAAAACT","GGTGGCTCACACCTGTAATCCCAGCATTTTGGGAGGCTGAGGCAGGCGGATAATCTGAGGTCAAGAATTTGAGACCAGCCTGGCCAACATGGAGAAACCCTATCTCTACTAAAAATACAAAATTAC"
"GL873580","375369","375549","chr7","19977275","19977456","44","19601906","CTAACCAAGTTAGTTAGTTTTAGTTGGCAGGTGCCTGTAGTCCCAGCTCCTTGGGAGGCTGAGGCAAGAGAATGGCTTGAGCCCAGGACTTTGAAGTTGCTGTGAGCTATAATGACACCACAGCACACTACCCAGGGTGACAGAGTGAGACTGTCTCAAAAAAACAAACAAACAAAAAAAA","AACAAACGTTAGCCGAGCATGGTGGTATGTGCCTGTAGTCCCAGCTACTTGGGAGTCTAAGGCAGGAGAATTACTTGAGCCCGGGAGGCAGAGGTTGCTGTGAGCCAAGATCACGCCACTGCACTCCAGCCTGGGTGACAGAGTGAGACTCCATCTCAAAAAAAAAAAAGGAAAAAAAAAAA"
"GL873580","8760922","8761015","chr11","104681322","104681416","19","95920400","GGAGGGAGACACTGCAGTGAACTGCGATCGTGTCTCTGCTTTCCAGGCTGGGTGACAGAGTGAGACTCGGTCTCTAAAATAAAAAATAAATAAA","GGAGACGGAGGTTGCAGTGAGCTGTGATCGCGGCACTGCACTCCAGCCTGGGCAACAGAGTGAGACTCTGTCTCAAAAATAAATAAATAAATAAA"
"GL873580","9391260","9391306","chr14","49279240","49279285","12","39887980","GCCAGTCGAGGTGGCTCACACTTGTGATTCCAGCTACTTGGAAGACT","GGCTGAGATGGTGGCACACACCTGTAATCCCAGCTACTTGGGAGGC"
"GL873581","759283","759365","chr6","46535476","46535542","30","45776193","TAAGAACCTGAAAATAGAGCCAGGCATAGTGGTACATGCGTATAGTCCTGGCTACTCAGGAGGTTGAAACAACAGGATTACTT","CAAAATAGCCAGGCTTGGTGGTGCATGCCTATAATCCAAGCTACTCGGGAAGCTGAGGCAGGAGAAT"
"GL873581","1145844","1145979","chr1","29437872","29437991","29","28292028","GGCCGGGCGTGGTGGCTCACGCCTGTAGTCCCAGCACTATGGGAGGCCGAGGCGGGTGGATCACCTGTGCTCAGAGGTTCGAGACCAGCCAAGACCCCCCTGAGCCAAATGAGCCAGAGTGAGACCCCGTCTCTAC","GGCCGGGCGTGGTGGCTCACGCCTGTAATCCCAACATTTTGGGAGGCCAAGGCGGGTGGATCACCTGAGGTCAGAAGTTCGAGACCAACCTGGCCAACATGGTGAAACCCCTGTCTCTAC"
"GL873581","9628238","9628362","chr5","141044567","141044691","34","131416329","ATCCCAGGTAGTCGGGAGGCTGAGGCAGGAGGATCACTTGAACCCAGGAGGTTGAGGTTGCTGTGAGCAAGGCAGAGGCAACGGCACTCTAGCCACGGGGGCACAGAGACTCTTGTCTTTAAAAA","TAATCTCAGCTACTCGGGAGGCTGAGGCAGGAGAATCGCTTGAGCCCAGAAGGTGGAGGTTGCAGTGAGCCAAGATCGCGCCATTGCACTCCAGCCTGGGCGACAGTGCGAGACTCTGTCTCAAA"
"GL873582","1580485","1580534","chr6","32576760","32576806","12","30996275","CAGCACTTGAGAGGCCAAGGCAGGTGGATCAACTGAGCAAGAATGAGACC","CCAGCACCTTGAGAGGCCAAGGCAGGTGGATCACCTGAGGTCAGGAG"
"GL873582","1644368","1644551","chr1","211626449","211626612","63","209982081","AAAATTTGCCGGGCTCCATAGCTCATGCATGTAATCATAGCACTCTGGGAGGCCAAGATGGGAGGATCTCTCAAGCTCTCTTACTTGGGAGGCTGAGGTTGCTGTGAGTTAGGCTTACGCCACAGCACTCTACTCTAGCGTGAGCAACTCTACTCTTAGTATGAGACTGTCTCAAAAGAAAAAA","AAATTAGCCAGGCGTCGTGGCACATGCCTGTAATCCCAGCTACTCGGGAGGCTGAGGCAGGAGAATAGCTTGATCTCGGGAGGCGGAGGTTGCAGTCAGCCGAGATCACACCACTGCAATCCAGCCTGGACAACAGAATGAGACTCCATCTCAAAAAAAACAAA"
"GL873582","5794385","5794459","chr13","18872784","18872852","27","13078399","ATATTGTTAAGCACAGCCACTATTAAAAATTAAATTATAGGCCAGGCATAGTGGCTCATGCCTGTAATCCTAGCT","TGAAACCACCATCTGGACCAAGATACAAAATGTTGGCTGGGCATGGTGGCTCACACCTGTAATCCTAGC"
"GL873583","102645","102683","chr14","5808766","5808804","14","5706121","GAGCAGATCACCTGAGCTCAGGAGTTTGAGACCAGCCTG","GAGGAATCCCTGTGCTCAGGAAGCTTACATTCTAGTGAG"
"GL873583","6200447","6200560","chr4","17786849","17786963","24","11586402","GGCCAGGAGGGACGGCTCATGCCTGTTATCCTAGCACTATGGGAGACTGAGGTGGGAGGATCACTTGAAGTTAGGAGTTCCAGACCAATCTGACCAAAGTGAGACCTCATCTCT","GGCCAGGCTTGGTGGCTCATGCCTGTAATCTTAGCACTTTGGGAGGCTGAAGTGGGTGGATCACTTGAGGTCAGGAGTTAGAACCAGTCTGGCCAACATGGTGAAACCTCAGCTC"
"GL873583","6200584","6200752","chr6","169626528","169626696","42","163425944","TTAGCTGGATGTGGTAGCACATGCCTATAGTCCCATCTACTCAGGAGGCTGAGACAAGAGAGTTGCTTAAGCCCAGGAGTTTAATTTAACTGTGAACTAGACTGAGACTGTGGCACTCTAGCTGGGGCAACAGAGTGAGACTCTGTCTCAAAAGAAAGCAAGAAAGAAA","TTAGCTGGGTATGGTGTCAGATGCCTGTAGTCCCAGCTACTCAGGAGGCTGAGACAGGAGAATCGTTTGAACCCAGGAGGCCAGAACTGCAGTGAGCTGAGATTCGCACCACTGCGCTCCAGCCTGGGCCAGACAGAGTGAGACTCTATCTCAAAAGAAAAAAAAAAAA"
"GL873583","10217398","10217583","chr3","36257142","36257313","44","26039744","TACTAAAAATAAAGTGTGATAGCCAGGCATGGTGGTGGTGCCTATAGAACCAGGCTATTCAGGAGGCTGAGGCAGAAGGATCACTTGAACCCAGGAGTCTGACGTTGCTGTGAGCTAGGCTGGTGCCATGGTACTCTAGCCTGTGGTAACAGAATGAGACTCTATCTCAAAAATAAAAATAAAAAA","TACAAAATTAGCCAGGCGTGGTGGTGCGTGCCTGTAATCCCAGCTACTTGGGAGGCCGAGGCAGAAGAATGACTTGAACCCAGGAGACAGAGGTTGCAGTGAGCCAAGATCCCACCATTGTACTCCAGCCTGGGCAACACAGTGAGACTCCATCTCAAAAAAAAAAAAAAAA"
"GL873583","10394919","10394983","chr16","12841703","12841771","22","2446784","GAGGTCAGGAAATCAAGATCAGTCTGGGCAATATATTGATACCCTGCCCCTACATAAGGAAGAAA","AGGTCAGGAGTTCAAGACCAGCCTGGCCAATATGTTGAAACCTCATCTCTACTAAAAATACAAAAATTA"
"GL873584","521512","521529","chr1","167402212","167402233","10","166880700","GCATGGAACCCCCCACTC","GGTGAAACCCCATCTTTACTAA"
"GL873584","2079725","2079768","chr15","4338291","4338335","11","2258566","GGCAGGTGGATTACCTGAGTTCAGGAGTTGGAGACCAGCCTGAC","AGGCGGATGGATCACGAGGTCGGGAGTTTGAGACCAGCCTGACCA"
"GL873584","5216877","5217053","chrX","91350057","91350230","49","86133180","CTACTGAAAATGATGACAGAGGCTGGGCATGGGGGCTCCCGCCTGTTATCCTAGCACCCTCGGAGGCTGGGGAATGAGGATTGCTTACGCCCAAGAGTTTGAGGTTGCTGTGAGCTGAGGCCGCTGCACTCTAGCCTGGGCAACAGAGTGAGACTCTGTCTCAAAAAAAAAAAAAAA","TGCAAAAATGAGCTGGGCATGGTGGCACATGCCTGTAATCCCAGCTACACAGGAGGCTGAGGCAGGAGAATCGCTTGAATCTGGGAGGCGGAGGTTGCAGTGAGCTGACATCAGGCCCCTGCACTCTAGCCTGGGCCACAGAGCAAGACTCCGTCTCAAAAAAAAAAAAAAAAA"
"GL873584","7289930","7289950","chr2","51453328","51453345","10","44163398","TGAGGCTCTGTCTCGAAATAA","AATGCCATCTATTAAAAA"
"GL873584","7289975","7290131","chr11","49739997","49740154","37","42450022","CAAGAAAATTAGCTGAGAGTCCTGGTAGGTGCCTGTAATCCCAGCTATTCATGAGGCTGAGGCAGAAGGATCACTTGGGTCCAGGAGTCTGAGGTTGCTGTGAGCTAGTCTGACGCCATAACACGCAAGCCTGGGCAACAGAGTGAGGCTCGGTTTC","CTACAAAAATTAGCTGGGCGTGGTGGCACATGCCTGTAATCCCAGCTACTCGGGAGGCTGAGGCAGGAGAATCACTTGAGCCCAGGAGGCGGAGGTTGCAGTGAGCCAAGATCATGCCATTGCACTCCAACCTGGGCAACAGAGCAAGACTCCATCTC"
"GL873584","7577743","7577867","chr5","48394329","48394446","27","40816586","GGCTGGATGAGGTGGTTCATGCCTGTAATCCTAGCACTCTGGGAGGCCAAGGTGGGTGGATTGCCTGAGCTCAGGAGTTCAAGACCAGCCTGAGCAAGACCCTGTCGCTAAAAATAGCTGGGTGT","GGCTGGGTGCAGTGGCTCATGCCTGTAATCCCAGCACTTTGGGAGGTCAAGGCGGGTGGATCACCTGAGGTCAGGAGTTCAAGACCAGCCTGGCCAACATCTCTACTAAAAATACAAA"
"GL873584","7578135","7578289","chr1","130112713","130112865","31","122534578","GGAGCTGGGTTTTGTGACTGCACCTGTAATCCCAGCTGCTCAGGAGGCTGAGGCAAGAGAATTGCTTGAGCCCAGGAGTTGGAGGTTGCTGTGAGCTGTGATGCCAGGGAACTCTACCAAGGGTGACAAAGTGAAACTCTGTCTCAAAAAAAAAA","TTAGCCAGGTGTGGTGATGCATGCCTGTAATCCCAGCTACTCATGAGGCTGAGGCAGGAGAATTGCTTGAACCTTGGAGCTGGAGGTTGCAGTGAGCTGAGATCAGACCACTCCAACCTGGGTGACAGAGCGAGACTCTGTCTCAAAAAAAAA"
"GL873585","1450952","1451121","chr10","59681079","59681242","48","58230127","TAAAAACAGAAAAAACTAGTCAGGTGGTGTGGTAGGTGCTCATAAGTCCCAGCTGCTTGGGAGACTGAGGCAAGAGAATCACTTGAGCACAAGAGCTTGAGGTGGCTGTGAGCTATAACACCATAGCACTGTACTGAGGGTGACAAAGTAAGACTCTGTCTCAAAAAAAA","TACAAAAATTAGTCAAGGGTGGTGGTATGTGCTTGTAATCCCAGCTATTTGGGAGGCTGAAGCAGGGGAATCCTTGAACCCAGGAGGTGGAGGTTGCAGCGAGCCGAGATCACGTCACTGCACTCTAGCCTGGGCGATAGGGTGAGACTCTGTCTCAAAAAAAA"
"GL873585","1451382","1451515","chr6","17405813","17405948","24","15954431","GGCCCGGCTCGGTGGCTCACACCTATAATCCTAACACTCTGGGAGGCTGAGGCAGGTGGATCACCTGAGCTCAGGAGTTTGAGACCAGCTGAGCAAAAACAAGACCCTATCTCTGCTAAAAATAGAAAAAACTA","GGCCGGGCGGGGTGGCTCACGCCTGTAATCCCAGCACTCTGGGAGGCCAAGGCAGGTGGATCACCTGAGGTCAGGAGTTTGAGACCAGCCTGGCCAACACGCAGAAACCCTATTTCTACTAAAAACACAAAAATTA"
"GL873585","1626960","1627026","chr7","17782729","17782794","22","16155769","AAGATGCCACAGCACTCTACAAGAGTGACCAAGTGAGACTCTGTCTCAAAAAAAAAAAGAAAAGGAA","CAATCGCACTACTGCACTTCAGCCTGGGTGACAGAGTGAGAACCTGTCTCAAAAAAATAAATAAAA"
"GL873585","1627304","1627531","chr11","17033552","17033788","61","15406248","GGCTGGGCACAGTGGCTCACGGCTATAATCTAGGCACTTGGGAGGCTAGGGCAGGTGGATTGCCTGAACTGACAAGTTTGAGACCAACCTGAGCAAGAGCGAGACCCCTGTCTCTAAAACATAGCCAGGCTCTGTGGTGGGCGTCTGTAGTCCCAGCTACTTGGGAGGCTGAGGCAAGAGAATTGCTTGAACTCAAGAGTCTGAGGTTGCTGTGAGTTAAGATGCCAC","GCCCGGCGCAGTGGCTCACGCCTGTAATCCCGGCACTGTGGAGGCCAAGGCAGGCGGATTGCCTAAGCTCAGGGATTCGAGAACAGCCTGGGCAACATGGTGAAACCCCATCTCTACTAAAATACAAAAAACTAGCCGGGCGTGGTGGTATGCGCCTGTAATCCCAGCTACTTGGGAAGCTGAGGCAGGAGAATTGCTTGAACCCGGGAGATGGAGGTTGCAGTGAGCTCAGATCAC"
"GL873585","3626082","3626158","chr1","100916857","100916922","27","97290775","TGCCTGTAATCCCAGCACTTGGGAGGCGGAGGTGGGTAGATTGCCTGACCCAGAGTGGGACCTCATCTCTAAAAGAA","CATGCCTGTAATCCCAGCACCTTGGGAGGCCAAGGTGGGTGGATCACCTGAGGTCAGTAGTTTGAG"
"GL873585","8849829","8849913","chr18","48581945","48582025","18","39732116","GGCTGGACGAGGGGACTCATGCCTGCAATCCCAGCACTGAGAGAGGCCAAGGCAGGTGGATCCCCTGAGCTCAGAAGTTTGAGAC","GCTGGACGCAGTGGCTCACACCTGTAATCCCAGCACTTTGGGAGGCCAAAGCAGGCAGATCTGAGGTCAGGAGTTTGAGAC"
"GL873585","9319890","9319971","chr8","79499361","79499447","14","70179471","GGCCAGGTGTGGTGGCTCACACCTGTCATCCTAGCACTCTGGGAGGACGAGGTGGGTGGACCGCCTGAGTCAGAGTGAGACC","GGCCAGGTGTGGTGGCTCACACCTGTAATCCCAACACTTTGGGAGGCCCAGGTGGGTGGATCACCTGAGGTCAGGAGTTCAAGACCA"
"GL873586","895572","895692","chr17","14501559","14501680","38","13605987","GGCCAGGTGAGGTTTCTCATTCTGGGAGTGAGCCAGCAATTGGGAGGCCAAAGTAAATGGATTGCCTGAGGTTATAGGTTCCAGAACAGCCAGAACAAGATCGAAATCCTGTCTCCAAAAA","GGCCAGGCGTGGTGGCTCATGCGTGTAATCTCAGCACTTTGGAAGGCCGAGGCAGGTGGATCACCCGAGGTCAAGAGTTCAAGACCAGCCTGACCAACATGGCGAGTCTCTGTCTCCACTAA"
"GL873586","5645995","5646150","chr6","58863249","58863409","38","53217254","GGGTATGGTGGCTCATGCCTGTAATCCAAGCACTCTGGGATGGTGAGGCAGGAGAATCCCTTGAACCCAAGAGTCCGAGGTTGCTGCGAGCTAAGCTGATGGCATAACACTCTAGCCTAGGCGACAGAGTGAGACTCTGTTTCCAAAGAGAAAAAA","TTAGCCAGGCATGGTGGCACATGCCAGTAATCCCAGCTACTCAGGAGGATGAGGCAGGAGAATCGCTTGAACCCAGGAGGCAGAGGTTGCAGTGAGCTGAGATTGCGCCACAGCACTCTACCCTGGGTGACAGAAGGAGACTCTGTCTCAAAAAAAAAAAA"
"GL873586","10258686","10258969","chr12","9481260","9481565","81","777426","GGCCGGGCATGGTGGCAGAAATCTAGGAGGCCGAGGCAGGTGGATCGCCTGAGATCACAAGTTCAAGACCAGCCTCAGCTACAGCAAGACCCCATCTCTAAAAATAGCCGGCTGTTGTGGCAGGCGCCTGTAACCCCAGCTACTCGGGAGGCTAAGGCAAGAGAATCGCTTGAGCCCATGAGTCTGAGGTTGCTGCGAGCTGTGACTCCACGGCACTCTACCCGGGGCGATAAAATGAGATTCTGTGTCAAAACAAACAAACAAACAAACAACAACAAAAACAA","GCTGGGCGCGGTGGCTCATGCCTGTAATCCCAGCACTTTGGGAGGCCAAGGCAGGTGGATCACCTGAGGTCAGGAGTTCGAGACCAGCCTAGTCCACATGGTGAAACCCCATCTCTACTAAAAACTAGCCAGGCGTGGTGGTGCGCACCTGTAATCCCAGCTACTCGAGAGGCTGAGGCAGGAGAATCACTTGAGCCTAGGAAGCAGAGGTTGTGGTGAGCTGAGATCACACCACTGCACTCCAGTCTGGGCGACACAGTGAGACTCTTGTCTCAAAAACAAAAAACAAACAAACAAACAAACAAA"
"GL873587","3208032","3208047","chr8","3626746","3626762","2","418714","AAACAACCACAAAAAA","ACAACAACAACAAAAAA"
"GL873587","3208141","3208321","chr19","2057131","2057316","59","1151010","TTTCTTTTAAAAATCACCCATGGGCTGGGTATAGTGGCTCACACCTATAATCCTCGGGAGGCCAAGGTTGGAGGATTGCTTGAATCCAGGAGTTGAAGGTTACAGTGAACTGGGATTTAGCCACTAGACTCTAGCATAGCTGACAAAGCAAGAACCTATTTGTTTAAAACACAAAAAAGAA","TACTAATAATACAAAAATGAGCCGGGTATGGTGGCGGGTGCCTGTAATCCCAGCTACTGAGGAGGCTGAGGCAGGAGACTTGCTTGAACCCAGGAGGTAAAGGTTGCAGTGAGCTGAGATTGCACCACTACACTCCAGCCTGGGCGACAAGAGCAAAACTTTTTCTCCAAAAAAAAAAAAAAAAAA"
"GL873587","3278260","3278367","chr19","19044200","19044312","39","15765940","CAGTCTGAGCAAGAGGGAGAGGCTATTTCTACTAAAAACAGAAAAACTAGCTGGGTGTTGGGGTGTGTTCCTAGTCTCAGTTACTTGGGAGGCTGAAGTAAGAGGATC","ACCAGCCTGGCCAACACGGTGAAATCCCGTCTCTACTAAAAATACAAAAATTACCTAGGCGTGATGGCACGTGCCTGTAGTCCCAGCTACTCATAAGGCAGAGGTGAGAGAAT"
"GL873587","3278673","3278754","chr7","49412503","49412597","28","46133830","GGCCACGAGAGCTAGCTCATGCCTATTCTAGGAGGCCAAAGCAGGCAGACTGCCTGAGCTCAGGAGTTCAAGAGCAGCCTGG","GGCCAGGTGCAGTGGCTCATGCCTGTAATCCGAGCACTTTGAGAGGCCGAGGCAGGCAGATCACCTGAGGTCAGGAGTTCAAGACCAGCCTAGTA"
"GL873587","3782076","3782188","chr9","112128434","112128552","34","108346358","ACTGGGGTGGCTGAGGCAGGAGCGTCACTTGAACTCAGGAGTTTGAGATTGCTGTGAGCTGAGCAGATGTCATGGCACGCTAGCCTAGGTAATAGAGTGAGACTTCGTCTAAA","CAGCTACTCGGGAGGCTGAGGCAGGAGAATCACTTGAACTCGGGAGGCGGAGGTTGCAGTGAGCCGAGATCACGCCATTGCACTCCAGCCTGGGCAACAAGAGCGAAATTCCATCTCAA"
"GL873587","4564996","4565084","chr20","27900350","27900437","14","23335354","GGCGGGGTGTAGTGGCTCATGCCTATTGTCCCAGCACTGTGGGAGGCCGAGGTGGGTGGATCACCTGTGCTCAGAAGTTTGAGACCAGC","GGCCGGGCGTGGTGGCTCATGTCTGTAATCCCAGCACTTTGGGAGGCCGAGGTGGGTGGATCACCTGAGGTCAGGAGTTCAAGACCAG"
"GL873587","6307870","6308175","chr12","112427710","112428020","54","106119840","GGCCAGATATGATGGCTCATGCTTGTAATCCTAGCACTCTGGGAGGCTGAAGTGGGAGGATCACCTGAGATCAGGAGTTCAAGATCACCCTGAGCAAAAGTGAGATCCCATCTCTATTAAAAATAAAAAAATTATCCAGGCATGGTGGTGCAGTCCTTTAGTCCCAGCTACTTGGGAGGCTGAGGCAGGAGAATCTCTTGAACCCAGGAATTAGAGGTTACAGTGAGCTGTGATGATGCTACTGCACTCTAGCAGGATGACAGAGTGAGATACTCCGTGTCAAAAAAAAAAAAAAAAAAAGCAAAA","GGCTGGACATGGTGGTTCATGCTTGTAATCCGAGCACTTTGGGAGGCCAAGGCGGGTGGATCACCTGAGGTTGGGAGTTCGAGACCAGCCTGACCAACATGATGAAACCCCATCTCTACTAAAAATACAAAAAAATTAGCCAGGCATGGTGATGCACGCCTGTAATCCCAGCTACTTGGGAGGCTGAGGCAGGAGAATCACTTGAACCCAGGAGGCAGAGGTTACAGTGAGCCGAGATCATGCCATTGCACTCCAGCCTGGATGACAGAGTGAGCCTCTGTCTCAAAAAAAAAAAAAAAAAAAAAAAAAAA"
"GL873587","6484004","6484128","chr10","67341428","67341546","29","60857424","GACCAGGTTCTGTGGCTCATGCTTGTAATCCTAGCACTCTAGGAGGCCGGAAGAGGGTGGATTGATTGCCTGAGGTCAGGAGTTAGAGACCAGCCTGAGCAAGAGCTAGACCCTGTTTCTTTCTT","GGCTGGGTGTAGTGGCTCATGCCTGTAATCCCAGCACTTTAGGAGGCCAAGGTGGATGGATTGCCTGAGCTCAGGAGTTCGAGACCACCCTGGGCAACAAGCCAAAACCCTGTCTCTAC"
"GL873587","6484407","6484586","chr3","167196537","167196723","48","160712130","TAGACCCTGTTTCTAAAAAAAAAATAGCCAGGTGTTGAGGCAGGTACCTGTAGTCCCAGCTACCTGGGAGGGCTGAGGCAAGAGAATCGCTTGAACCCAAGAGTTTGAGGTTGCTGTGAGCTGAGATGCTATGGCACTCAACCGTGAGCTACAAAGTGAGACTCTGTCTCAAAAAAAAAA","AAAACCTGTCTCTGCTAAAAATACAAAAATTAGCCGGGTGTGGTGATGTGCGCCTGTAGTCCTAGCTACTTGGGAGGCTGAGGCAGGAGAATCACTTGAATCCAGGAGGTGGAGGTTGTAGTGAGTCGAGATCGTGCGACTGCACTCCAGCCTGGGTGACAGCGAGACTCTGTCTCAAAAAAAAAAA"
"GL873587","7466229","7466364","chr1","29437872","29437991","35","21971643","GGCCAGGCGTGGTGGCTCATGCCTGTAGTCCCAGCGCTATGGGAGGCCGAGGTGGGTGGATCACCTGTGCTCAGAGGTTCGAGACCAGCCAAGACCCCCCTGAGCCAAATGAGCCAGAGTGAGATCCCATCTCTAC","GGCCGGGCGTGGTGGCTCACGCCTGTAATCCCAACATTTTGGGAGGCCAAGGCGGGTGGATCACCTGAGGTCAGAAGTTCGAGACCAACCTGGCCAACATGGTGAAACCCCTGTCTCTAC"
"GL873588","1502535","1502718","chr1","34852429","34852590","60","33349894","GGTGCAGTGGCTCACACCTGTTGTCCCAGCGCTGTGGGAGGCCGAGGTGGGTGGATCACCTGTGCTCAGAGGTCGAGACCAGCTGAAGACCTGCCTGAGGCAGAGTGAGCCAGAGTGAGACCCCGTCTCTACTAGAACAACAACAAGACAGCCAGACCTTGTGATCCCAGCTACATGGGGGGCT","GCCAGGTGCAGTGGCTCACACCTGTAATCCCAGCACTTTGGGAGGCCGAGGCGGGCGGATCACCTGAGGTCAGGAGTTTGAGACCAGCTTGACCAACATGGAGAAACCCCGTCTCTACTAAAAATACAAAATTAGCCTGGTGTGGTGTCGCATGCCTGTAAT"
"GL873588","10189037","10189246","chr3","45604681","45604903","65","35415644","GCTGAGATGAGGAGACTCTGTCTCTATTAAAAATAGAAAAATTGGGTGGATGTTGTGGGTACTGTAGTTGCAGCCTCTTGGGGGGCTAAGGCAGGAGGATCAGTTGAAGCCAGGAATTTGCTTTGAGCTAGGCTAAAGCCATGGCACTCTAGCCTGGGCAACAGAGTGAGGCTAGATCTCAAAAAAAGAAAGAAAAGAAAAAGAAAAAAA","CTGGCCAACATGGCAAAACCCCATCTCTACTAAATATACAAAAATTAGCTGGACGTGGTGGCACATACCTGTAATCCCAGCTACTTGGAAGGCTGAGGCAGGAGAATAGCTTGAACCTGGGAGGCAGAGGTTGCAATGAGCTGAGATCACGCCACTGCACTCTAGCCTGGGCAATAGAATGAGACTCTGTCTCAAAAAAAAAAAAAAAAAAAAAGACAAGAAA"
"GL873589","104719","104807","chr20","27900350","27900437","13","27795631","GGCTGGGCGTGGTGGCTCATGCCTGTTGTCCCAGCGCTGTGGGAGGCTGAGGTGGGTGGATCACCTGTGCTCAGAGGTTCGAGACCAGC","GGCCGGGCGTGGTGGCTCATGTCTGTAATCCCAGCACTTTGGGAGGCCGAGGTGGGTGGATCACCTGAGGTCAGGAGTTCAAGACCAG"
"GL873589","796766","796905","chr1","166346372","166346487","49","165549606","GGCTAAGTGTGGTGGCTCACACCTGTCATCTAGTACTTTGGGAGGGTGGGCCTGGGAGTTCAAAGACTGAACTCAGGAGTTCAAGGTGGCTCCGGGGAGGAATTCAAGACCAACCTGAGCCAGAGCGAGACCTCGACTCT","GGCCAGTGGGGTGGCTCACGCCTGTAATCCCAGCACTTTGGGAGGCTGAGGTGGTCAAATGACCTGAGGTCAGGAGTTTGAGACCAACCTGGCCAACATGGTGACACCTCGTCTCT"
"GL873589","1023679","1023690","chr1","205890061","205890072","1","204866382","AAAAAAAAAAAA","ACAAAAAAAAAA"
"GL873589","1023771","1024047","chr4","103012712","103012993","70","101988941","GGCTTGGTGGCTCACACCTGTAATCCTAGCACTCTGGGAGGCCGAAGTGGCTGGAATACTTGAGGTCAGGAGTTCAAGACCAGCCTAAGTGAGAGTGAGATCCCCATCTCTAATAAAAATAGAAAAATTAGCAGGGTGTTGTGGCTGGCACTTGTAGTCCCAGCTACCCAGGAGACCGAGGCAGAAGTTTGAGATTATTGTGAGCGAGGCTGATGCCACAGCATTCTAGTGGGACAACAGAGCAAAATTCTATCTCAAAAGAAAAAAAAAAAAAGGA","CGGGCGTGATGGCTCACGCCTGTAATCCCAACACTTTGGGAAGCCGAGGCGGACGTATCACCTGAGGTCAGGAGTTCAAGACCAGCCTGGCCAACATGGTGAAACCCCGTCTCTACTAAAAATACAAAAATTAGCTGGGTGTGGTGGCATGCGCCTGTAATCCCAGCTACCCAGGAGGCTGAGGCAGGAGAATCGCTGAGGCTGCAGTGAACTGAAATTGTGCCACTGCACTCCAGCCTGGGTGACAGAGCAAGACTCTGTCTCAAAAAAAAAAAAAAAAAA"
"GL873589","4820958","4821024","chr8","33633747","33633811","15","28812789","TTAGTCAAGTGCAGTGGCTCACACCTGTCATCCCAGCTACTTGGGAGGCTGAGGCAGGAGAGTTGCT","TTAGCCAGGTGTGGTGGTGCATGCCTCTAATCCCAGCTACTCAGGAGGCTGAGGCAGGAGAATTG"
"GL873589","6763768","6763857","chrX","25814002","25814092","29","19050234","GGTGTGGTGGCTCACACTTGTATCTTAGCATTTTAGGAGGCTGAATGGGGAGAATTGCTTTAAGTCAGGAGTCTGACTTCCACCTTGCCA","GGCTGGGAATGGTGGCTCACACCTGTAATCCCAGCACTTTGGGAGGCTGAGGTGGGCAGATCACCTGAGGTCAGGAGTTTGAGATCAGCCT"
"GL873589","8444551","8444632","chr9","93194085","93194171","17","84749534","CGGGCATGGTGGCTCACAACTATAATCTTAGCACTTTGGGAGGCTGAGACAGGTGGATGCCTGAACTCAAGAGTTTGAAACC","GGCCGAGCATGGTGGCTCACACCTGTAATCCCAGCACTTTGGGAGGCTGAGGCAGGTGGATTACCTGAGGTCAAGAGTTCAAGACCA"
"GL873589","9085365","9085494","chr2","194063347","194063481","42","184977982","GGCCAGGCACAGTGGCTCACACCTATAATCCCAGCACTCTGTGAGACTGAGGCAGGTGAACTGTTGCAAGAGTGAGACCCTGTGCTTGGTGCCTGTAGCTCAGTGGTTAATAATAAGAAAAAAGAAAAAA","GGCCAGGTGCAGTGGCTCACACCTGTAATCCCAGCACTTTGGGAGTCTGAACCAGGCAGATCACCTGAGGTCAGGAGTTCGAGGCCAGCTCGGCCACCATGGTGAAACCCTGTTTCTAATAAGAATACAAAAAAA"
"GL873589","9085767","9086002","chr7","84631446","84631650","75","75545679","GAGTGAAACCCTGTCTCTACTAAAAATAGAAAAACTAGCTGTGCATCAGGGCGCATAACTGTAGTCCCAGGTACTCAGGACACTGAGGCAAGAGAATTGCTCAAGCCCAAGAGTTTGCAAGAATTTGAGGTTGCTATGAGCTATGATGCCATGGCACTCTACCTAGGGTGACAGACAGAGACTCTGTCCCAAAAAAAAAAAAAGAAGAAGAAGAAAAAAAAAAAGAAAGAAAGAAA","ATAGTGAAACCTCGTCTCTACTAAAAATACAAAAATTAGCTGGGCATCATGGTGCACGCTTGTAATTCCAGCTACTTGGGAGGCTGAGGCAGGAGAATTGCTTGAACTCAGGAGGTGGAGGTTGCAATGAGCCAAGATCGCGCCACTGCACACCAGCCTGGGTGACAAAAGACTCTGTCTCAAAAAAAAAAAAAAAAAAAAAAAA"
"GL873589","9992904","9993045","chr16","56427538","56427666","46","46434634","AACCAGCCAGGCATGGTGATTCACACCTATAATCCCAGCTACTTAGGAGTATGGCTTGAGCACACAGGATACCATACCATTCTAGTCATCCCAGGCAACAGAGGGAAACTCTGTTGGTTAAAAAAAAAGAAAAACTTAAAAA","TTAGCCAGGAGTGGTGGTGCACGCCTATAATCCCAGCTACTTGGGAGGCTGAGGCACAAGAATCACTTGAACCATTGCACTCCAGCCAGGGTGATAGAGGGAGACTCTATCCAAAAAAAAAACAAAAAA"
"GL873589","9993319","9993452","chr3","2774534","2774668","28","7218785","GGCCTGAGCCCTGTGACTCATGCCTGTAATCCCAGCACTGGAAGTTCCAAGGCAGGTGGATCGCTTGAGCTCTGGAGTTCAAGACCAGCTCAACCAAGAGTAAGACCCCATCTCTACTAAAAATAGAAAAACCA","GGCTGGGCACGGTGGCTCATGCCTGTAATCCCAGCACTTTGAGAGGCCGAGGCAGGTGGATCTCCTGAGGTCAGGAGTTCAAGACCAGCCTGGGCAACATGGTGAAACCCCATCTCTACTAAAAATACAAAAAAT"
"GL873590","9044589","9044884","chr1","83754525","83754835","84","74709936","GGCCAGGTGCAATGGCTCATGCCTATAATCCTCACACTCTGGGAGGCTGAGGCAGGAGGATCACTTTTCTCAGGGTCAGGGCCAGCCTGACAAAAGTCAGACCCTGTTTCTACTAAAAATAGAAAAACTAGCTGGGTGTTGTGGCAGATGCCTATAGTCCCAGCTACTAAGAGACTGAGACAAGTGCCCAGAGTCTGAGGTTACTGTGAGCAAAGCTGATGCCATAGCATTCTAGCTATAGATCGAGAGTCTGTCTCAAAAACAAACAAACAAACAAACAAACAAACAAAAAAGAA","GGCTGGGTGTGGTGGCTCATGCCTGTAATCCCAGCACTTTGGGAGGCCGAGGCGGGTGGATCATCTGAGGTCAGGAGTTCAAGACCAGCCTGACCAACATGGTGTAACCCTGTCTCAACTAAAAATACAAAAATTAGCTGGGCGTGGTGGTGTGCACCTATAGTCACAGCTACTTGGGAGGCTGAGACAGGAGAATTGCTTCAACCCAGGAAGTGGAGGTTGCAGTGAGCCAAGATCATGTCACTGCACTGCAGCCTGACAGAGCGAGACTCCATCTAAAACAAACAAACAAAAACAAACAAACAAACAAA"
"GL873591","1831505","1831587","chr17","61702818","61702899","25","59871313","CCCAGCACTTTGGGAGGGCAAGATGGGAGAATCATATAAAGTCAGGAGTTTGAGACCAGTTTGGCAGACATGATGAACCCATC","AATCCCAGCACTTTGGGAGGCTGAGGCAGGCGGATCATCTGAGGTCAGGAGTTCAAGACCAGCCTGGCCAACATGGTGAAAC"
"GL873591","2719175","2719275","chr4","86137755","86137847","32","83418580","GTGGGGGCTTAGGCCTGTAATCCCAGCACTCTGAGAGGCCAAGGTGAGCTGGTCACCTGGGTTTAGGAGTTTGGAGACTTGCTCGAGCTAGACTGAGGCTC","GTGGTGGCTCACGCCTGTAACCCTAACAATTTGGGAGGCCAAGGCAGGTGGATCACTTGAGGTCAGAAGTTTGAGACCAGCCTGGACAATATG"
"GL873591","4732974","4733120","chr19","7991801","7991954","55","3258827","ATACGCAGACTGGCCGAGCGTGGTGTCACATGCCTATAATCCCAGTGGCTACTCTGGGGAGGAGAATCTCTTGAAACCAAGAGTTAGAGATTGCAGTGGGGTATGATACAGGGTAACAAAGAGAGACCTTGGATCTGAAAAGAAAAA","AAAATACAGAAACTAGCTGGGCATGGTGATGCACACCTGTAATCCTAGCTACTGGGGAGGCTGAGGCAGGAGAATTGCTTGAACCCAGGAGTCAGAGGTTGCAGTGAGCAACCAGCCTGGGTGATACAGTGAGTGAGACTCTGTCTCGAAAAAA"
"GL873591","6822728","6823009","chr1","20579766","20580052","72","13757038","GGCCAGGCGTGGTGGCTCATGCCTGTAAATCTCAGCACTCTGGGAAGCTGAGGCAGGTGGATTGCTTGAGGTCAGGAGTTTGAGACCAGCCTGTACCAGAGTAAGACCCTGTCTCTAATAAAAATAGAAAAAAAAAAAAAAACTAGTTGGGCATGGTGATGGGTGCCTGTAGTCCCACCTACTTGGGAGGCTGAGGCAATGGCATCTCTTGAGCCCAAGAGTTTGAGGTTGCTGTGCCATGGCACTCTCCCCAGGGTAACAGAGTGAAAATAAAAAAAAGAA","GGCCAGGCGTGGTGACTCATGCCTGTAATCTCAGCACTTTGGGAGGCCGAGGCAGGTGAATCACCTGAGGTCAGGAGTTTGAGACCAGCCTGACCAACATGGTGAAACCTCGTCTCTACTAAAAATACAAAAAGTAGCCAGGCATGGTGGCGCATGCCTGTAATCCCAGCTACTTGGGAGGCTGAGGCAGGAGAATCGCTTGAACCCGAGAGGCAGAGGTTGCATTGAGTCAAGATGGTACCACTGCACTCCAGCCTGGGTGACAGATTGAGACTCAAAAAAAAAAA"
"GL873591","7578706","7578813","chr16","45055441","45055543","42","37476735","AAATTTAGCTACACATAGTGGCATGAGTCTGTAATGCTAGCCACCCAAAAGGCTGTAGTAAGAGGATTGCTCTATCCCAGGAGTTAAAGACCAGCCCGGACATCAGAG","AATTAGCCGGGCGTGGTGACACACACTTGTAATCCTAGATACTCAGGAGGCGAAGGTAGGAGAATTGCTTGAACCCAGGCAGCAGAGGTTGCAACGAGCAGAG"
"GL873591","9282916","9283004","chr1","20744253","20744338","16","11461337","GGCCAGGCGCGGTGGCTCACCCCTGTTGTCCCAGTTCTGTGGGAGGCCGAGGTGGGTGGATCACCTGTGCTCAGAGGTTTGAGACCAGC","GGCCAGGCACGGTGGCCACGCCTGTAATCCCAGCACTTTGGGAGGCCGAAGTGGGTGGATTACCTGAGGTCAAGAGTTTGAGACCA"
"GL873592","835155","835315","chr16","75654291","75654451","43","74819136","CTGGGTGTGGTGGCTCTTGTCTGCAATCTCAGTACACTGGGAGGCTGAGGCAGAAGGATTGCTCCAGCTCAGGAGTTTGAGGCCAGGCTGAGCTAGTGCAAAACCCCATCTCTACTAAAAAAAGAAGGAAAAAAAAAAGAAAAAGAAAAAAAATACGAGCT","CCAGGTGTGGTGACTCACGCCTGCAATCCCAGCACTCTGGGAGGCTGAGGTGGGTAGATTACCGGAGGTTAGGCGTTTGAGACCAGCCTGGCCAACATGGTGAAACCCCATCGCTACTAAAAAAAAAAAAAAAAAAAAAAAAAAAAAAAAAAAAAAAATTA"
"GL873592","835589","835765","chr1","66836166","66836336","48","66000577","ACAAAAAACCTAGCTTAGGGTTGTTATAGCACCTGTAGTCCCAGCTACTCAGGCGCTAAGGCAGGAAAATCTGCCTGAGCTCAGGAGTTTGAGGTTGCAGTAAGTTATGATGATGCTACTGCACTCTAGCTGGGGCAACAGAGTGAGACTCTGTCTGAGGAAAAACCAAAACCAAAA","TAGCCCAGCACGGTGGCTCACACCTGTAGTCTCAGCTACTCAAGAGGCTGAGGCATGAGAATCGCTTGAACCCAGGAGGTAGAGGTTGCAGTGAGCTGAGATCATGCCACTGCGCTCCAGCCTGGGCAACAGAGTGAGACTCAGTCTCAAAAAACAAAACAAAACAAAAAA"
"GL873592","2520661","2520705","chr16","66853217","66853257","11","64332556","TCTGGGAGGCTGAGGCGGGTGGATCACCTGAGCAAGAGTGAGACC","TTTGGGAGGCTGAGGCAGGTGGATCACTTGAGGTCAGGAGT"
"GL873592","4535248","4535388","chr1","12240468","12240612","38","7705220","GGCGGGATGTGGTGGTTCATGGCTGTAATCCCAGCACTCAGGGAGGCTGAGTCGGGTGGATTGCTTGAGTTCAGGAGTTTGAGACCAACCTGAGCAAGAACTAAGCCTGTCTCTACTAAAGATATTATTTCTTATTTTTCT","GGCCGGGCGCGGTGGCTCATGCCTGTAATCCCAGCACTTTGGGAGGCTGAGGCGGGTGGATCACCTGCGGTCAGGAGTTCGAGACCAGCCTGGCCAACGTGGTGAAACCTCATCTCTACTAAAAATATAAAAATTAGCTGGTGTG"
"GL873592","4535654","4535831","chr8","126054004","126054184","54","121518350","TCTACTACAAATATTAACAGAAAAATTAGCTGGGCATTGTGACAGGTGCCTATAGTCCCAGATACTCAGAAGGCTGAAGTAAGAGGATCACTTGAACCCCAGGAGCTAAGGTGGCTGTGAGCTAGGCTGAGGCTCTAGCCTGGGTAACAGAGTGAGACTGTAAAAAAAGAAAGAGAGA","GTCTCTACTAAAAATACAAAAATTAGCTGGGTGTGGTGGTGCATGCCTGTAATCCCAGCTACTCAGGAGGCTGAGGCAGGAGAATCGCTTGAACCCAGGAGGTAGAGGTTGCAGTGAGCCAAGATCATGCCACTGCACTCCAGCCTGGGTGACAGAGGGAGACTCTGTCTCAATAAATAAA"
"GL873592","6794968","6795049","chr3","154764711","154764794","20","147969743","GAAGGTTTGATGAGCTCAGATGATGCCACTGCAGTCTACCCAGAGTGAAGGAGCGAGACTCTGTCTCAAAAACAAAAAAAGA","CAGAGGTTGGCAGTGAGCTGAGACTGTGCCACTGCACTCCAGCCGGGTGACAGAGTGAGACTCTGTCTCAAATTACAAACAAAA"
"GL873592","6881384","6881478","chr5","24882384","24882475","28","18001000","GGGCAGGCATAGTGACTGGTGTCTCTAATCCTAGCAGTCTGGGATGCTGAGGCAAGTGGAATGTCAGAGTTCAGGAGTTGAAGATCACCCTGACT","GGCCGGGCGCAGTGGCTCACATCTATAATCCTAGCATTTTGGGAGGCTGAGGCAGGCGGATCACCTGAAGTCAGGAGTTTAAGACCAGCCTG"
"GL873592","6881755","6881937","chr10","61601371","61601572","66","54719616","TCACCCTGACCAAGAGCAAGACCCTGTCTCTACTAAAAATAGAATAAACTAGCTGGGAATTGTGGTGGGTGCCAGTAGTCCCCGCTACTGAGGCAGGAGGATCATTGAGTCCAAGAGTTTGAGGTTGCTGTAAGTTAGGACACCACAGCACTCTACACAGAGTAAGACTGCCTCAAAAATAAA","AGTAAAGAAAAGAAACCCTGTCTCTACTAAAAATACAAAAATTAGCTGGGTGTGGTGGTGCGCACCTGTAGTCCCAGCTACTTGGGAGGGTGAGGTATGGGAATCACTTGAACCCGGGAGGTGGAGGTTGCAGTGAGCCAAGATCACACCACTGCACTCCAGCCTGGGTGAGAGAGTGAGACTCTGTCTCAAGAAAAAAGAA"
"GL873592","7006080","7006155","chr1","8947061","8947129","24","1940981","CACACTGAGAGGCAAAGGCTGGTGGATCACCTGAGCTCAAGAGTTTGAGACCAGCCAAGCCAGAGATCTTGTCTCT","CACTTTGGAGCCAGGTAGGTGATCACCTGAGTCAGGAGTTCGAGACAGCCTGGCCAACATGTGAAACCC"
"GL873592","8446508","8446655","chr11","122502739","122502874","48","114056231","TTAGCTGGGTGTTGTGGCAGGCACCTGTAGTCCCTCCCAGCTACTTGAAAGGCTGAGGCAAGATGACAGCTTAAACCCAAGAGTTTAAGGTTACTCTATTCAGGGCAACAGAGTGAGACTCCATCTACATAAATAAATAAATAAATAA","GGCTGGGCGTGGTGGTTCACACCTGTAATCCCAACACTTTGGGAGGCTGAGGCCAGCGGATTGCCTGAGCCCAGGAGTTTGAGACCAACCTGGGCAACATGGTGAAACTCCATCTCTACTAAAATACAAAAAGTTA"
"GL873592","8446953","8447008","chr16","44513352","44513404","15","36066399","GACCAGCCTAAGCAAAAAAGAGATCCTATCTCTACTACTAAAAATAGAAAAAATTA","ACCAGCCTCACCAATATGAAGAAACCCCATCTCTACTAAAAATACAAAATATT"
"GL873592","8447239","8447325","chr1","8062863","8062957","21","384376","GGCCAGGAGCAGTGACTCATGCCTAGCACTCTGGGAGGCCAAAGCAGGTGGATCAACTGAGCTCAGGAGTTCAAGACCAGCCTAAGC","GGCCGGGTGCAGTGGCTCATGCCTGTAGTCCCAGGACTTTGGCAGGCCAAGGCCGGTGGATTACCTGAGGTCAGGAGTTCAAAACCAGCCTAGCC"
"GL873592","8723925","8724000","chr3","42066983","42067054","20","33343058","AATTAGCCGGGCATGGTAGTGTGTGCCCATAATCTCAGCTACTCAGAAAGCTAAGATAGGAAAATTGCTTGAGCTC","TTAGCTGGGTGTGGTAGTGCATGCCTATAATCCCAGCTACTCGGGAGGCTGAGGTGGGAGAACTGCTTGAAC"
"GL873593","384022","384146","chr15","102382935","102383070","28","101998913","GGCCACGAGGGCCCATGCCTGTAATCCTAGCACTCTGGGAGGCTGAGGTGAGTAGATTGCTGAGCTCAGGAGTTCAAGACCAGCCTGTGCAAGAGACCCCATCTCTGCTAAAAATAGAAAAACCA","GGCCAGGTGTGGTGGCTCACGCCTGTAATCCTAGCACTTTGGGAGGCTGAGGCGGGTGGATTGCCTGAACTCAGGAGGTCAAGACCAGCCTGGGCAACACAGTAAAACCCCATCTCTACTAAAATACAAAAAATCA"
"GL873593","384425","384607","chr20","28286874","28287058","50","27902449","GAAAGAAAAGAAAAGAAAAACTAGCAAGATGTTGTAGCTGATGCCTATAATCCTAGCTATTGGAGAGGTGGAGGCAAGAGAATTGCGTGAGCCCAAGAGTTGAAGGTTGCTGTGAGCTGCGATGCCAGAGCACTCCAGGGTGACAGAGTAAGACTCTGTCTCAAAAAAAATTACAAAATAAAA","TAATAAAAATAAAAAAATTAGCCAGGAGTCAAAGCACACGCCTATAACCCCAGCTACTTGGGAGGCTGAGGGAGGAGAATTACTTGAACCCGGGAGGTGAAAGTTGCAATGAGCTGAGATCAAGCCACTGCACTCCAGACTGGATGACAGAGTGAGACTCTGTTTCAAAAAAAAAAAAAAGACAA"
"GL873593","1408445","1408467","chr10","88070368","88070389","9","86661923","AATCTAGAGATGGGGAGAGGTTG","AAAGAGATGGAAGAGAAGAAGA"
"GL873593","4856365","4856484","chr7","56497314","56497433","31","51640949","GCAATCCCAGCTGATCGGGAGGCTGACCCAGAAGAATCCCTTGAACCCAAGAGTCTGAGGTTGCTATGGGTGGATTCTACAGCACTCTAGCCTGGGAGACAGAGTGAGACTCTGTCCCAA","ATCCCAGCTACTTGGGAGGCTGAGACAGAAGAATTGCTTGAACCCGGGAGGTGGAGGTTGCAGTGAGCCAAGATTGTACCACTGCACTCCAGCCTGGCAACAGAGTGAGACTCTGTCTCA"
"GL873593","6661298","6661485","chr10","86749316","86749514","55","80088018","GCAGAGGCTCACATATGTAATCCTAGCACTCTGGGAGGATAAGGCAGGTGGACAGCTTGAGCTCAGGGGTTTGACCAGTCTGATCAAGAGCAAGACCTGTGTCTACTAAAAATAGAAAACCTAGCCAGGTATGATGGTAGATGCCTGTATTCCTAGCTACTCTGGAAGCTAAAGCTAAAGAGTTTGAA","GGTGGCTCACACCTGTAATCTTAGCAATTTGGGAGGCCGAGGTGGGTGGATCACTTGAGGTCAGGAGTTTGAGACCAGACTGGCCAACATGGTGAAACTCTGTCTCTACTAAAAATACAAAAATTAGCCAGTCATGGTGGTGCATGCCTGTAATCCCAGCTACTCAGGAAGCTTAGGCAGGAGAATCACTTGAACCCAG"
"GL873593","6710263","6710446","chr14","4390080","4390244","66","2320183","TTGAAGTCAGGAGTTTAAGGCCAGTCTGGGCAACATAGTGAGACCCCCATCTCTACGAAAATATTTTTTAAAAATTAAAAATAGCTGGGCATAGTGAGGCTGTTGTGAGCTATAACTGCACCACTGCACTCAGCCAAGGACAGAGACCCTGTTCCCTGCCTCAAACAAACCAAAACAAAACAAA","AAGTCTAGAGTTTACAGCCTGGACAACGCAGTGAAACCCTGTCTCTACCAAAAATACAAAAATTAGACAGGTGTGAGAGGCGGAGGTTGCAATGAGCTGAGATCGCAGCACTGCAGTCCAGCCTGGATGACAGAGCGAGACCCCATCTCAAAAACAAAAACAAAA"
"GL873593","7159645","7159716","chr6","178318394","178318465","21","171158749","GATCATGTCACTGCTCTCCAACCTGGGCAATTGAGCAGGAATCTGTCTCAAAAAGAAAAAAAAAAAAGAAAA","CGAGTTCACACCACTGCACCCCAGCCTGGGCAACAGAATGAGACTCGGTTTCAAAAAAAAAAAAAAAAAAAA"
"GL873593","7159841","7160050","chr13","33368171","33368368","69","26208330","GGCCAGGCGTGGTGGCTCACACCTGTTGTCCCAGTGCTGTGGGAAGCCGAGGCAGGTGGATCACCTGAGCTCAGCCGAGTTCGAGACCAGTGGAAGACCAGCATGAGGCAGAGTGAGCCAGAGTGAGACCCCATCTCTACAACAACAACAAGAAGAAAAAAAACAGCCGGACCTTGTGATCCCAGCTACGTGGGGAGCTAGAGAATCACT","GGCTAGGCATGGTGGCTCATGCCAGTAATCCCACCACTTTGGGAGGCCGAGGCAGGTGGATCACCTGAGGTCAGGAGTTCAAGACCAGGCTGGCCAACATGTTATGATGAGACCCTCATCTCTACTACAAATACAAAAATCAGCTGGGCATGGTGGCAAGTGCCTGTAATCCCAGCTACTTGGGAGGCTGAGGCAGAA"
"GL873593","8598292","8598391","chr11","118461023","118461129","33","109862731","AGCCAGGTGAGGTGGTTCACACCTGTAACCCTAGCTGCTTGGGAGGCTGAGGCCTCTCTATCCTGGGCAGTGTGGAGAAACTTTGTTTCAAAAAAAAGAA","GCCGGGCGCGGTGGCTCACGTCTGTAATCCCAGCGCTTTGGGAAGCCGAGGCGGGACTATCCTGGCCAACATGGTGAAACCCCGTCTCTACTAAAAATACAAGAATC"
"GL873594","357249","357377","chr2","75702890","75703011","36","75345641","CCTGGTACCGTAGGTCATGCCTGTAATCCTAGCACTTTGGGATGCTGAGGTGGGCAGATTGCCTGAGCTCACGAGTTCAAGCCATTAGAACTGAGCCTGACCTAGAGTGGGACCTCCAACTCTTTTTTT","GCCAGGCACAGTGGCTCATGCCTGTAATCCCAGCAGTTTGGGAGGCTGAGGTGGGCAGATCACTTGAGGTCAGGAGTTCAAGACCAGCCTGGCTGACATGGTGAAACCCCATCTATACCAAA"
"GL873594","357656","357834","chr7","17608776","17608965","55","17251120","GGGACCTCCAACTCTTAAAATAGCTGGGCATTGTGGTGGGCACCTACAGTCACAGCTACTTGGGAGGCTAAGGCAAGAGACTTGTTTGCAGCCAAGAGTTAGAGGTTGCTGTGAGCTATGAGGCTAGGGCACTCTACAGGGGGCGACAAGTGAGACTGTAAAAAAAAAAAAAGAAAAAA","GTCCCTACTAAAAATACAAAAAATTAGCTGGGCCTGGTGGCAGGCACCTGTAATCCCAGCTACTTGGGAAGCTGAGGCAAGAGAATTGCTTGAACCCAGGAGGCAGAGGTTGCAGTGAGCTGACATCAAGCCACTGTACTCCAGCCTAGGCAACAAGAGCAAGACTCTGTCTCAAAAAAAAAAAAAAAAA"
"GL873594","1410711","1410996","chr5","151340503","151340797","76","149929792","CACAGTGGCTCATACCTATAATCCTAACACTCTGGGAGGCCAAGGTGGGTGGACTGTCTGAGTTTGGGACCAGCCTGAGCAAAAGCAAGACTCCCATCTCTACTAAAAACAAAGACAGCCAGGTATGAGGGCAGGTGCCTATCATCCCAGCTACTTGGGAGGCTGAGGAAGGAGGATCACCTAAGCCCAGGACTTTAAGGTTTCTGTGAACTAAGATGATGTTACAACACTCTAGCCAGGGTAACAAGGCAAGATTCTGTTTCAAAAGACAAAAAAAAAAAAAAAA","GGTGGTTCATGCCTGTAATCCCAGCACTTTGGGAGGCTGAGGCAGGTGGATCACCTGAGGTCAGGAGTTCGGGACCAGCCTGGCCAACATGGGGAAACCCCATCTCTACTAAAATACAAAAATTAGCCAGGTATGGTGGCACATGCCTATAATCCCAGCTACTTGGGAGGCTGAGGCAGGAGAATCACTTGAACCCAGGAGGCTAAGGTTGCAGTGAGCCGAGATTGTGCCACTGTACTCCAGCCTGGGTGACAGACTGAAACTCTGTGTCCAAAAAACAAAACAAAACAAAAAA"
"GL873594","5528090","5528162","chr2","69013639","69013718","24","63485549","GGTACAGTGGCTCACGCTTGTGATCCCAGGTTGAGGTGGGTGGATCGCCTGAGCTCAGGAGTTGGATGCCAGC","GGTGTGGTGCCTCACGCCTATAATCCCAGCACTTTGGGAGGCAGGTGGATCACTTGAGGTCAGGAGTTTGAGAACAGCCT"
"GL873594","5834047","5834168","chr2","82491537","82491662","28","76657490","GGCTGGGCCCAGTAGCTCACGACTGTAATCCCAGCACTCTGGGAAGCTGAGGTGGGCGGATCACCTGAGCTCATAGGTTCGAGACCAGCTCCAGTTAGAGTGAGAGCCTGTCTCTAAAAATA","GGCTGGGCACAGTGGCTCATGCCTGCAATCCCAGCACTTTGGGAGGCTGAGGTGGGCAGATCACCTGAAGTCAGGAGTTCAAGACCAGCCTGGCCAACACAGTGAAACCCCATCTCTACTAAAAAT"
"GL873594","5834396","5834461","chr13","14688151","14688212","20","8853755","TATATAATAATAATAACCAGGTATTGTGGCAGGTGCCTCTAGTCCCAGCTACTCGGGAGGCAAAGG","ATAAAAAAATTAGCTGGCCATGGTGGCACATACCAATAATCCCAGCTACTCAGGAGGCTGAG"
"GL873594","7786130","7786294","chr14","12217087","12217250","37","4430957","GGGTGTGCTGGCTCATACCTATAATCCTAGCACTCTGGGAGGCTGAGGTAGGTGTATTGCTTGAACCCAGGAGTCTGAGGTTGCTGTGCGCTAAGCTGATACCATAGCACTCTAGCCTGGGCAACAGAGTGAGACTCTGTCTCAAAACAAATAAATAGTAAAAAA","GCTGGGCGTGGTGGCTCACACCTGTAATCCCAGCACTTTGGGAGGCCAAGGCATGAGAATTGCTTGAAAACAGGAGGCGGAGGTTGCAGTAAGCTGAGACTGTGCCATTGCACTCCAGCCTGGGCAACAAGAGTGAAACTCTGTCTCAGAAAAAAAGAAAAAAA"
"GL873595","723579","723774","chr19","6045933","6046125","65","5322354","GCCTGAGCAGGAGAGAGACCCCATCTCTGCTGAAAGTGGAAAAGTTGGCTGAGTGTAGTGGCGGGCTGCTGCCCCAGTCACTCAGGAGGCTTAGGAAGGAGTATCGCTTGGGCCCAAGATTTGAGGTTGCTGTGAGCGCTACAAAGACATTAGGGTACTCTACACAGGGGAATAGAGTGAGACTGTCTCAAAAAAA","CAACATGGAGAAACCCCGTCTCTACTAAAAATACAAAATTAGGCAGCGTGGTGGTGGGTGCCTATAATCCCAGCTACTCAGGAGGCTGAGGCAGGAGAATCGCTTGACCGGGAGTGGAGGTTGCGGTGAGCTGAGATTGCACCATTGCACTCCAGCCTGGGCAACAAGAGTGAAACTCCGTCTCAAAAAGAAA"
"GL873595","724114","724204","chr20","18199749","18199840","22","17475635","GGCCATGCTTGGTGGTTCTCATCTGTAATCCTAGCACTCTGGAAGGTCTACAGGGGTGGATGGCTGGAGGTCAGGAGTTCAAGACTGGCCT","GGCCGGGCATGGTGGCTCACACCTGTAATCCCAGCACTTTGGGAGGCTGAGGCAGGCGGATCACCTGAGGTCAGGAGTTCGAGACCGGCCTG"
"GL873595","1065346","1065667","chr18","10529729","10530057","74","9464383","GGCCAGGTGCAGCAGCTCATGCCTGGAATCTTCCTGCTCTGTATGGCCAAGGCAGGTGGATCGCCTGACCTCAGGAGTTCCAGACCAGCCTGAACAAGAGCAAGACTCTGTCTCTACTAAAAGTAGAAAAAAAACTAGCCAGTCATAGTGGCAGGTGCCTGTAGTCCCAGCTGCTTGGGAGGCTGAGGCAAGAGGATCACTTGAACCTAAGAGTTTGAGGTTGCTGTGAGCTAAGATGCCACATCACTCTATCAAGGGTGACCAAGTGAGACTCTGTCTCAAAAATAAATAAATAAATAAATAAAAAGAAAGGCAAAAAGAA","GGCCCGGCGTGGTGGCTCATGCCTATAATCCCAGCCCTTTGGGAGGCCAAGGCAGGTGGATCACCTGAGGTCAGGCGTTCGAGACCAGCCTGACCAACGTGGTGAAACCTCATCTCTACTAAATACAAAAAAAATTTAGCCAGGCATGGAGGCACATGCCTGTAATCCCAGCTACTTGGGAGGCTGTGGCAGGAGAATCACTTGAACCTGGGAGGTGGAAGTTGCAGTGAGCTGAGATTGTACCACTGCACTCCAACCTGGGTGACAAAGCAAGACTCGGTCTCAATAAATAAATAAATAAATAAATAAATAAATAAAGTGAAAAAAAA"
"GL873595","1254878","1255146","chr4","42822326","42822607","67","41567448","GGCTGGGCATGGTGGCTCATGCCTGTAATCCTACCGCTCTGGGAGGCTGAGGCAGAGGATCACTTGAGCTCAGGAGTTTCAGACCAGCCTGCAAGAAGGACCCAGTCTCTGCCGAAAATAGAAAAGTTAGCAAGGCGTTGTCGTGAGCACATGTATCCCAGCTACCTAGAACTCTGAGGCAGGAGGATCCCTTGAACCCACAGAAGTTGCTGTTATCTAAACTGATGCCACTGGACTCTAGCCTGGGCAACAGAGTGAGACTGGTCTCA","GGCCGGGCACGGTGGCTCATGCCTGTAATCCTAGCATTTTGGGAGGCTGAGACAGGCAGATTGCCTGAGCTCAGGAGTTCAAGACCAGCCTGGGCTAGATTGTGAAACCCCATCTCTACTAAAATATAAAAATTAGCTGGGTGTGGTGGCACACGCCTGTAATCCCAGCTACCTGGGAGGCTGAGGCAGGAGAATCGCTTGAACCAGGAGACAGAGGTTGCAGTGAGCTGAGATCACGCCACTGCACTTTAGCCTGGGCAACAGAGTGATACTCTGTCTCAA"
"GL873595","3417105","3417297","chr12","115674238","115674427","44","112257133","GGCCGGGCGCTGTGCCTCACGCCTGTAATCCTAATACTCTGAGAGGCCGAGGCAGGTGGATTGCCTGAGCTCAGGTGCTCAAGACAGCCTGACTGAGCAAGCCCTGAGATCCCATCTCCACTAACAATAGTAAAACTAGCCGGGCATTGTGGTGGTGCTTGTAATCCCAGCTACTGGGAGGCTAAGACAGGAG","CCAGGCCTGGTGGCTCACGCCTGTAATCCCAGCACTTTGGGAGGCCGAGGTGGGTAGATCACCTGAGGTCAGGAGTTCAAGACCAGCCTGGCCAACATGGCGAAACCCCATCTCTACTAAAAATACAAAAATTAGCTGGGCATGGTGGTGTATGCCTGTAATCCCAGCTACTCGGGAGGCTGAGGCAGGA"
"GL873595","6098380","6098457","chr3","87492619","87492702","21","81394239","GCTGTGGCTCATGCTGATAATACCAGCACTCTGGGAGAACAAGGTAGGCAGATCACAAGAGGTCACCTGTGCAAGACC","GGGCTGGTGGTGGCTCATGCCTGTAATACCAGCACTTTGGGAGGCCAAGACAGGTGGATCACCAAAGGTCAAGAGTTCAAGACC"
"GL873596","134190","134307","chr1","203207333","203207443","31","203073143","GGCTGGGCGAGGTGGCTCACACCTGTAATCCTAGCACTCTGGAAGGCCCTAGCACTCAGGCAGTTGGATTGCCTGAGCTCACAAGTTCAAGACCAGCCTGAAAAAGAGCAAGACCTCA","GGCTGGGTGCAGTGGCTCACACCTGTAATCCCAGCACTTTGGGAGGCCGAGATGGGTGGATCACTTGAGGTCAAGAGTTGAAGACCAGCCTGGACAACATGATGAGACCCC"
"GL873596","134578","134681","chr11","50235285","50235387","37","50100707","CAAACAAAAGAGGAAGACCTCGTCTCTAAAAAAATAGCTGGGCATTGTGAGGAGTACCTGTAGTCCTAGCTACTCAGAAGGCTGAGACAAGAGAATCACTTAAA","CAACATTGTGAAACCCTGTCTCTACTAAAATAGAAAATTAGCCAGGTGTGTGGGCGTGCCTATAATCCTAGCTACTGGGGAGGGTGAGGCATGAGAATCGCCT"
"GL873596","8160215","8160350","chr1","29437872","29437991","30","21277657","GGCCGGGCGTGGTGGCGCACACCTGTAGTCCCAGCGCTATGGGAGGCCGAGGCGGGTGGATCACCTGAGCTCAGAGGTTCGAGACCAGCCAAGACCCCCCTGAGCCAAACGAGCCAGAGTGAGACCCCGTCTCTAC","GGCCGGGCGTGGTGGCTCACGCCTGTAATCCCAACATTTTGGGAGGCCAAGGCGGGTGGATCACCTGAGGTCAGAAGTTCGAGACCAACCTGGCCAACATGGTGAAACCCCTGTCTCTAC"
"GL873596","8421071","8421132","chr20","1874027","1874093","12","6547044","GTCAGGCGCAGTGGCTCACGCCTGTAATCTCAGCACTCTGAGAAGCCAAGGCAGGATCATCT","GGCCAGGCGCAGTGGCTCAGGCCTGTAATCCCAGCACTTTGGGAAGCCAAGGTGAGCAGATCACCTG"
"GL873598","4416400","4416489","chr5","39418145","39418231","15","35001745","GGCCAAGTGTGGTGGCTCATGCCTGTTGTCCCAGCACCGTGGGAGGCCGAGGCTGGTGGAACACCTGAGCTCAGCTGAGTTTGAGACCAG","GGCCAGTTGCGGTGGCTCATGCCTGTAATCCCAGCACTTTGGCAGGCTGAGGCAGGTGGATCACCTGAGGTCAGGAGTTTGAGACCA"
"GL873598","4416855","4416947","chr3","94091253","94091337","31","89674398","GTGAGACCCTGTCTCTACAAAAAAAAAAGCTGGGCACTGTGGCATGTGCCTGTAATCCCAGCTACTTGGGAGGCAAAGGGAAAGAGAATCACT","AAACCTTGCCTTTACTAGAAATACAAAAATTAGCTGGGCATGGTGGCAGGTACCTGTAATCCCAGCTACTTGGGAGGCTGAGGCA"
"GL873598","5126074","5126161","chr1","12339306","12339394","19","7213232","GCCTGGTGCACTGGTTCACACCTGGAATCCTTGCATTCTGAGAGGCCCAGGTAGGCAGATCACCTCAGCTCAGAAGTTCGAGACCAGC","GCTGGGTGCGGTGGTTCACGTCTGTAATCCCAGCACTTTGGGAGGCCGAGGCGGGCAGATCACCTGAGGTCAGGAGTTCGAGACCAGCC"
"GL873598","5467584","5467662","chr1","9313328","9313403","17","3845744","GCGAGGTGGCTCACGCCTGTAATCCCAGCACATTTGGAAGGCCAAGGAGGGTGGATCACCCGAGCTCACCAGTTGGAGA","CGCAGTGGCTCACGCCTGTAATCCCAGCACTTTGGGAGGCCGAGGCAGGCAGATCACCTGAAGTCAGGAGTTTGAG"
"GL873598","6917752","6917856","chr14","9558287","9558382","22","2640535","GGCCAGGCATGGTGGCTTGTGCCTGTTGTCCCAGCACTGTGGAAGGCCGAGGCGGGTGGATCGCCTGAGCTCAGCTGAATTCGAGACCAGCATAAGACCAGTATG","GGCCAGGCATGGTGGCTTATGCCTGTAATCCCAGCACCTTGGAAGGCCGAAGCGGGCAGATCACCTGAGCTCAGGAGTTTGAGACCAGCCTGTCCA"
"GL873598","8078910","8079062","chr7","164825511","164825660","43","156746601","AACAGCCAGGCATTGTGGTGGGCACCTGTAATCCCAGCTACTTGGGAGGCTGAGGCAAGAGAATTGCTTGAGCCCAACAGTCTCAGGTTACTGTGAGTTATGACACCATGGCACTCTATTGAGGGCAAGAAAGTGAGACTGTCTTGGAAAAAA","CTAGCCAGGCATGGTGGTGCGCACCTGTAGTCCCAGTTACTTGGGAGGTTGAGGCAAGAGAATTGCTTGAGCCTGGAAGGCAGAAGTTGCAGTGAGCTGAGATCACACCACTGCATTCCAGCCTGGGCGAAAGAGCAAGACTCTGTTGAA"
"GL873598","8079328","8079454","chr6","10381248","10381379","32","2301920","GCCCGGCGTGGTGGCTCACGCCTGTAATTCCAGCACTCTGGGGAGGCCGAGGAGGGCAGATTGCCTGAGCTCACAGGTTTGAGCTAGAGCGAGACCCTGTCTCTTAAAAAGAAAAAAAAGGAAAGAA","GCTGGGCGCGGTGGCTCACGCCTGTAATCCCAACACTTTGGGAGGCCGAGGCGGGCAGATCACCAGAGGTGATCTCCAGCCTGGGCAGGAGAGCAAGACCCTGTCTCAAAAAATTTAGAAAAAGGAAAGAAA"
"GL873599","3943256","3943456","chr9","35892110","35892312","79","31948854","GGCAGGCTGCTTTGACCCATATCTACAACTCCAGAACTTTAGAGGCTGAGCTGGGTGGGTCCCTTGAGATTAGAAACTGCTTAGTAGCCTGGCAAAAACCAGACCCCACCTCCACCATGTAGAAAAATTAGCAGTATGCCATAGTGGGAACCTACCAATACAGTCTTTCCAAAGGCCAAAGCTAGAAGGACCGTGAGCTTG","GGCTGGGTGTGGTGGCTCATGCCTATAATTCCAGCACTTTGGGAGGCCGAGGCAGGTGGATCACCTGAGGCCAGGAGTTTGAGACCAGCCTGGCCAATATGGTGAAACCCCATCTCTACTAAAAGTACAGAAAATTAGTCAGTCATGATGGCGCATGCCTATAATCCCAGTTACTCGGGAGGCTAAGGTAGGAGAATTGCTTG"
"GL873599","6693284","6693349","chr1","100916857","100916922","15","94223573","TCACGTCTATAATCCTAGCACTCTGGGAGTCCTTGGCAGGTGGATCACCTGAGCTCAGGAGTTTGA","CATGCCTGTAATCCCAGCACCTTGGGAGGCCAAGGTGGGTGGATCACCTGAGGTCAGTAGTTTGAG"
"GL873600","991618","991705","chr15","13850109","13850195","15","12858491","GGCTGGGCGTGGTGGCTCACACCTGTTGTCCCAGCGCTGTGGGAGGCTGAGGCAGGTGGATCACCTGTGCTCAGAGGTTGAGACCAGC","GCCGGGCGCTGTGGCTCACACTTGTAATCCCAGCACTTTGGGAGGCTGAGGCAGGTGGATCACCTGAGGTCAGGAGTTAGAGACCAG"
"GL873600","8825981","8826014","chr16","43605817","43605844","11","34779836","AGTCTGGGGCAACAGAGCAAGACTCTGTCTCAAA","CAGTCTGGGTGACAGAGCAAGATTCCAT"
"GL873600","8826039","8826157","chr13","87428402","87428520","35","78602363","ATTAGCCTGGTGTGGTGGTATATGCCTTCCTGCCTGCTTGGGAGGCTGAGGCAGGAAGTATGCTTTAACTGTGGAGTCTGAGGTTGCTATGAGCTAGGTTGAGGCCATGGCACTCTAAA","TTAGCCGGGTGTGGTGGTGCACGCCTGTAATCCCAGCTACTCAGGAGGCTGAAGCAGGAGAGTTGCTTGAACCCAGGAGTTGGAGGTTGCAGTGAGCTGAGATCACGCCATTGCACTCC"
"GL873601","269289","269338","chr14","49279240","49279285","14","49009951","GACTGGGTGTGGTGGCTCACACCTTTAATCCTAACACCCTGGGAGGCTTA","GGCTGAGATGGTGGCACACACCTGTAATCCCAGCTACTTGGGAGGC"
"GL873601","269431","269678","chr1","184453273","184453521","76","184183842","AGAAGATCACTCAAGATCAGGAGTTTGAGAACAGCCTGAGCAAGACCCCCATCTTTACTAAAAATGGAAAAGTTTTTACCCAGGCATGGTAGTGCGTGCCTGTATCCCATCTACTCCGGAGGCTGATAGGAGGATTGCTTCAACCAAGGAGTTTGAGGTTCCAGAGACTTAAGATGACACAACTGCATTTTACCCAGTGTGACACAGCGAGACTCTTTCAGAAGAATTTTTAAAAGGAAAAAAAAGAA","GGTCAGATCACCTGAGGTCAGGAGTTTGAGACCAGCCTGACCAACATGGTAAAACCCCATCTCTGCTAAAAATACAAAAAATTAGCCAGGCATGGTGGTGAACGCCTGTAATCCTAGCTACTCAGGAGGCAAAGACAGGAGAATCGCTTGAATCTGGAAGGTGGAGGTTGCAATGAGCCAAGATGACGCCACTGCACTCCAACCTGGGTGACAGAGGAAGACTCCATCAAAAAAAAAAAAAAAAAAAAA"
"GL873601","1397978","1398117","chr16","24839455","24839591","34","23441477","GCCTATAATCCTAGCACTCTGGAAGGCTGAGGCAGGAAGATCACTAGAGCTTGGGAGTTTGAGATTGCTGTGAGGGAGACTGACTCCATGGCACTCTAGCCTGAGGCAACAGAGTAAGACTCCATCTCAAAAAAAAAAAA","CTCTAACTCCAGCTACTCAGGAGGCTGAAGCAGGAAAATCACTTGAACCTGGGAGGTGGAGGTTACAGTGAGCCAAGATCACACCATTGCACTCCAGCCTGAGCGACAGAGCGAGACTCTGTCTCAAAATAAATAAA"
"GL873601","4065502","4065590","chr11","108711352","108711444","19","104645850","GCTGGATGTGGTGGCTCTCACCTATAATCCTAGCACTCTGGGAGGTCAAAACAGGTGGATCACCTGAGCTCAGGAGCAAGAACACCAGC","GTCAGGGGTGGTGGCTCACGCCTGTAATCCCAGCACTTTGGGAGGCCAAGGCAGGTGGATCGCCTGAGCTCAGGAGTTCAAGACCAGCCTTGC"
"GL873601","8241370","8241465","chrY","9469734","9469829","34","1228364","AAAAAAGGTGGAGATGAGCCATGCGCAGTGGTGTAGGCCTGTAATCCCAGCCCTTGGGAGGCCAAAATGGTGGATTGCCTGAAGCAGAGCAAGACC","AAAGTACAAAGAGTCTGGGTACAGTGGCCCAAGCCTGTAATCCCAGCAGTTTGGGAGGACAAGATGGGTAGATCACCTGACATCATGAATTAGAGA"
"GL873569","7519122","7519191","chrX","79016364","79016431","16","71497242","TTGGCCAGGCATGGTCGCTCAGGCTGTAATACCAGCTACTTGGGAAGCTGAAGCAGGAGGATCACTTGAA","TTGGCCAGGCACGGTGGCTCATGCTTATAATCCCAGCTACTCGTGAGGCTGAGGCAGGGGAATCGCTT"
"GL873569","7989158","7989286","chr8","41505677","41505810","35","33516519","AGTCCCACCTATTTGGAAGGCTGAGGCAAGAGGATCACTTGAACTCAGCAGTTTGACATTGCTATGAGTTAGATTGACTCCATGGCACTCTAGCCCAGGCAACAGAGCAAGACTCCGTCTCAAAACAAA","TAATACCAGCTACGTGGGAGGCTGAGGCAGGAGAATCACTTGAACCCGGGAGGTGGAGGTTGCAGTGAGCTGAGATTGCACCGTTGCACTCTAACCTGGGCAACAAAAGCAAAACTCTGTCTCAAAAAAAAAAA"
"GL873569","7989575","7989702","chr1","62231025","62231129","47","54241450","GGCTGGGTAATGCAGTGGCTCACGCCTATAATCCTAGTGCTTTGAGAGGCCAAGAGTGAGACTCTGTGTACTAAAAATAGAAAAATTACCTAGGCATTCTGGTGGGCACCAGTAGTCCCACCTATTTG","GGCTGGGCATGGTGGCTCACGCCTATAATCCCAGCACTTTGGGAGGCCGAGGCAGGTGGATCACCTGAGATCAGGAGTTTGAGACCAGACTGGCCAACATGGTGA"
"GL873569","10034363","10034556","chr10","61268396","61268605","62","51234033","CAGCTTGAGCAAAAGTGAGCCCCTGTCTCTACTGAAAATAGAAAAAATTAGCCAGGCGTGGTGGCACACACTTATAGTCCCAGCCACTTAGGAGGCTGAGGCAGGAGTTTGAGGTTGACATAATCTAAGCTGATACCATAGCACTCTAGCCTGGGCAATAGAGTGAGACTCTGTCTCAAAGAAGAAATTTATCT","CCTGACCAATGGTGAAACCCTGTCTCTACCAAAAATACAAAATTTAGCTGGGCATGGGGGCACGCACCTGTAGTCCTAGCTACTCGGGAGGCTGAGACAGGAGAACTGCTTGAACTCGGGAGGCAGAGGTTGCAGTGAGCTGAGATCATGCCACTGCACTCTAGCCTGGGCAATAGAGTGAGACTCCGTCTCAAAAAAAAAAAAAAAAAA"
"GL873569","10034830","10034845","chr1","217667782","217667796","2","207632952","AAAAAAGAAGAAAAAA","AAGAAAAAGAAAAAA"
"GL873569","10203815","10203922","chr8","96374555","96374671","35","86170740","GCCAGGTGTAGTGGTTCACACCTATAATCCTAGCACTCTGGGAGCCTGAAGCAGGTAAATGGACTGAGCAAGAGTGAGACTTCCACCTCTATTGAAAATAGAAAAATT","GGCTAGGTATGGTGGCTGATGCCTATAATCCCAGAATTTTGGGAGGCCGAGGCAGGCAGATCATCTGAGGTCAGGAGTTTGAGACCAGTCCCGTCTCTACTAAAAATACAAAAATTA"
"GL873569","10204196","10204373","chr20","1304385","1304559","47","8899811","GAAAATAGAAAAATTAGCCAGGCATTATAGCAGGCACCAGTAATCCCAGTTACTTGGGAGGCTAAGGCAAAAGAATCTCTTGAGCCCAAGTTTGGGGTTGCTAGGAAGTAAAACACCACAGCACTATACCCAGAACAAGAGAGTGAAGACTCAGTCTCAAAAAGATAAATAAATAAAA","AAAAATACAAAAATTAGCCAGGCATGGTGGCGGGCGTCTGTAACTCCAGCTACTTGGGAGACTGAGGCAGGAGAATCGCTTGAACCCAGGAGGCAGAGGTTACAGGTGAAATCACACCACTGCACTCCAGCCTGGGCAACAGGGCAAGACTCTGTCTCAAAAAAAAAAAAAAAAA"
"GL873569","10473375","10473444","chr8","20660648","20660717","21","10187273","TGTAGTCCCAGCACTTTGGGAGGTTAAGGCAAGAGTAGCACCCAACATGAGGAGATCAAGACCAATCTGG","CTGTAGTCCCAGCACTTTGGGAGGCTGAGGCAGGTGGATCCTTTGAGGGCAGAACTTTAAGACCAGCCTG"
"GL873570","9287350","9287485","chr1","29437872","29437991","30","20150522","GGCCGGGCGTGGTGGCGCACGCCTGTAGTCCCAGCGCTATGGGAGGCCGAGGCGGGTGGATCACCTGTGCTCAGAGGTTCGAGACCAGCCAAGACCCCCCTGAGCCAAACGAGCCAGAGTGAGACCCCGTCTCTAC","GGCCGGGCGTGGTGGCTCACGCCTGTAATCCCAACATTTTGGGAGGCCAAGGCGGGTGGATCACCTGAGGTCAGAAGTTCGAGACCAACCTGGCCAACATGGTGAAACCCCTGTCTCTAC"
"GL873571","3669989","3670207","chr4","116777080","116777297","60","113107091","AGACCAGCCTGAGGAAGAGCAAGATCCCATCTCTATTAAAAATAGAAAAATTAGCCAGGCATTCTGGTGGGCACCTGTAGTTCTAACCACCTGGGAGGCTAAGGCAAGAGGAACTCTTCAACCCAAGAGTTTGAGGTTGCTGAGAGCTAGGCTAAGGCTGCAGCACTCTAGCCTGGGCAACAGAGTGAGACTGTTTCTCAAAAACAAAAAACAAAAAAA","CGAGACCAGCCTGGTCAATATGGTGAAACCCCGTCCCTACTAAAAATACAAAAATTAGCCAGGCATGGTGGCAGGCACCTGTAGTCCCAGCTACTCGGAAGGCTGAGGCAGGAGAATCGCTTGAACCACAGAGGCAGAGGTTGCAGTGAGCCGAGACTGCACCACTGCACTCCAGCCTGGGCGACAGAGTGAGACTCAGTCTCAAAAAAAAAAAAAAA"
"GL873571","106134","106236","chr4","18143723","18143826","27","18037589","GGCCAGTCTCAGTGGCTCACACCTGTAATCCAGCATTCTGGGAGGCTGAAGCACACGGTCACCTGAGCTCAAAGGTTGGAGACCAGAGTGAGACCCCACCTCT","GGCCAGGCGCAGTGGCTCACTCCTGTAATCCCAGCACTTTGAGGCTGAGGCAGGCGGATCACCTGAGGTCAGGAGTTTGAGACCAGCCTGGCCGAAACCCCATC"
"GL873571","3670496","3670589","chr7","50468399","50468491","15","46797903","GGGCAGGCATGGTGGCTCACACCTGTAATTCTAGCACTCTTGGAGGCTGAGGCAGGAAAATGGCTTGAGGTCAGGAGTTCAAGACCAGCCTGAG","GGCCAGTCATGGTTGCTCACACCTGTAATACCAGCACTTTGGGAGGCCGAGGCAGGCGAATCACCTGAAGTCAGGAGTTCAAGACCAGCCTGG"
"GL873571","4059090","4059389","chr7","52903696","52903994","88","48844606","GGCCAGGTGCAGTGGTTCACACTTATAATCCTAGCACTCTGGGAGGCCGAGGCGAGTGAAGTGCCTGAGCTCATGGGTTCAAGACCAACCTAAGCCAGAGACCCCTGACTCTTATAATAGCCTGGCATTGTGGTGGGCGCCAATATTTCCAGCTACTCTGAGGCTAAGGCAAGAGAATTGCTTGAGCCCAGGAGTTGGAGGTTTCTGTGAGCACTGACGCCGCAGCTCTCTACCAAGGGCAACAAAGACTCTGTCTCAAAAAATAAATAAATAAATAAATAACAGAATGAAAATGAAAAA","GGCCGGGTGCGGTGGTTCACGCCTGTAATCCCACCACTTTGGGAGGCTGAGGCAGGCAGGTCACCTGAGGTCAGGAGTTCCAGACCAGCCTGGCCAACATGGTGAAACCTTGTCTCGGCTATTAGCCTGGCATGGTGGTGCGTGCCCATAATCCCAGCTACTCAGGAGGCTGAGGCAGGAGAATCGCTTGAACCCAGAAGGTGGAGGTTGCAGTGAGCCAAGATAGCACCACTGCAACTCCAGTCTGGGCAACAGAATGAGACTCTGTCTCAAAAAAAAAAAACAAAAAACAAAAAGAA"
"GL873571","4209418","4209704","chr11","32517699","32517985","80","28308281","GGCTTGGCAAGGTGGCTTACACCTCAAATCCTAGCACTGTGGGAGACTGAGGCAGGTGGATTGTTTGAGCTCAGGAGGTCAAGATAGAGAGCAAGAGCAAGTCTCTGTCTCTACTAAAAATAGAAAAGAACTACTTCCCGGGGGTCATGGCAGTAGCCTGTAATCCCAGTTACTAGGTAGAATGAGGCAAGAGGATCTGTTGAAGCCAAGAGACTGAGGTTGTTATGAGCATGCCACAGCACTCTACCCAGGGTGACAGAATGAGACTCTGTTGAAAGAAAAAAAGA","GGCCGGGTGCAGTGGCTCACACCTGTAATCCCAGCACTTTGGGAGGCTGAGGCGGGTGGATCACCTGAGGTCAGGAGTTCAAGACCAGCCTGACAAACATAGTGAAACCCTGTCTCTACTGAAAATACAAAATTAGCCAGGTGTGGTGGCGCATGCCTGTAATCCCAGCTACTCGGGAGGCTGAGGCAGGAGAATTGCTTGAATCCAGGAGGTGGAGGTTGTGTGATCACACCACTGCACTCCAGCCTGGGCGACAGAGTGAGACTCTGTCTCAAAAAAAAAAGAAA"
"GL873571","4209985","4210154","chr3","175781758","175781928","60","171571773","GAAAGAAATGAAAAGAAAGAAGTTAGCTGGTTGTTGGGGTATGCTTCTATAGTCCCACCTACTCAGAAAGCTGAAATCTGGAGTTTGGGGTTGTTGTAAGGTAGGCTGATGACATAGCACTGTAGCTTGGGCAAGAGAGTGTGACTTTGTCTCAAAAAAAATTAAAACAA","ATTAAAAACACAAAGATTAGCCAGGTGTGATGGCACACAACTGTAATCCCAACTACTCAGGAGAATCGCTTGAACCTGGGAGATAGGGTTTGCAGTGAGCCAAGATTGTGCCACTGCACTCCAGCCTGGGTGACAGAGTGAGACTCTGTCTCCAAAAAAAAAAAAAAAAAA"
"GL873571","4210444","4210570","chr17","16655655","16655789","35","12445211","GCCAGGCAGATGGCTCACACTTCATCCTAGCCCTCTGGAAGGCTGAGGCAGGCTAATTTTTTGAGGTTAGGAGTTTGAGACCAGCCTGAGGAAGAGACCCATCTCTACTTTAAAAAATAAATGGAAA","GCCAGGCATGGTGGCTCACACCTGTAATCCTAGCACTTTGGGAGACTGAGGCGGGTGAATCACCTGAGGTCAGGAGTTTGAGACCAGCCTGACCAGTATGGTGAAACCCAGTCTCTACTAAAAATACAGAAATTA"
"GL873571","4391733","4391878","chr11","33723808","33723943","46","29332075","AACTTAGCTGGGAATGGTGGCTCAAGCCTGTAATCCTAGCACTCTGGGAGGCTCAGGTGGGAGGATCACTTGAGGTTGCTGTGAGCTTGGCTGATGCCAGGACACTCTAGTGTGGGCAAGAGAGTGAGACTCCGCCTCAACAACAA","GCCGGGTGCAGTGGCTCATACCTGTAATCCCAGCACTTTGGGAGGCTGAGGTAGGCGGATCACGAGGTCAGGAGCTGAGATGGCGCCACTGCACCCCAGCCTGGGTGACAGAGCAAGACTCTGTCTCAAAAAAAAA"
"GL873571","6307773","6307841","chr9","62429628","62429694","22","56121855","CTGGGTGTGGTGGCATTGCACCTGTAATCCTAGCTACTTGGAAATCTTAAGCCCAGGAGTTGAAGACTG","CCCAGCATGGTGGTGCATACCTATAATCTCAGCTACTTGGAGGCTTGAGCTCAGAAGTTTGAGACCG"
"GL873571","6496217","6496306","chr1","27257765","27257856","27","20761548","GCAGGGTGTGTTGACCCACACCCACAATTCCAGGACTCTGGGGGGCCAGGGATGGTGGGTTCCCTCAGATCAGGAGCTCCTTACCAGCCT","GACTGGGCATGATGGCTCAAATCTGTAATTCCAGCACTTTGGGAGGCCGAGGTGGGTGGATTGCCTGAGATCAGGAGTTCAAGACCAGCCTG"
"GL873571","6499738","6499903","chr1","38976375","38976555","47","32476637","AAAATAACATGAATTGACTAGGCGAGGTGGCTCACATCTCTAATCCTAGCACTCTGGGAGGCTGAGGCAGGAGAATTGCATGAGGTTGCTGTGAGCTATGATGATACCACGGCATTCTAATCAGGGTGACAGAGTGAGATTCTGTCTTAAAACAAACAAACAAAAA","AAAATAAATAAATTAGCAGGGCCTGGTGGCGCACACCTGTAATCCCAGCTACTTGGGAAGCTGAGGCAGGAGAACCCACTTGAACCTGGGAGCCGGAGGTTGCAGTGAGCTGAGATGGCACCACTGCACTCCAGACTGCGTGACAGAGTGAGACTCCGTCTCAAAAACAAACAAACAAAAA"
"GL873571","11399575","11399872","chr15","109458692","109458994","79","98059117","CAGTGGCTCACACCTGTAAATCTAACACTCTGGGAGGCCAAGGTGGGTGGATCCCTTGAGCTCAGGAATTTGATACCAGCCTGAGCAAGAGTGAGACCTTGTCTCTACTAATAATAGAAAAATAGCCCGTGTTGTGGCACTTGTCCCAACCACTGGGGAGGCTTTAGGCGGGAGGATTACTTGAATTGGGAGTTTGATATTGCTGTGAGCTGGGCTGATGCCTTGGCATTCTAGCTTGGGTAACAGCGTAAGACTCCGTCTCAAATAAATAAATAAATAAATAAAAAGAAAAAAAGAA","GTGGCTCACACCTGTAATCTCAGCACTTTGGGAGACCGAGGCAGGTGGATCACCTGAGGTCGGGAGTTTGAGACCAGCCTGACCAACGTGGAGAAACCCCGTCTCTACTAACAATACAAAATCAGCTGGGCGTGGTGGTGCATGCTTGTAATCCCAGCTACTCGGGAGGCTGAGGTAGGAGAATCGCTTGAACCTGGGAGGTGGAGGTTGCGGTGAGCCGAGATCGAGCCACTGCACTCCAGCCTGGGTGACAGAGCAAGACTCCATCTCAAAAAAAAAAAAAAAAAAAAAAAAAAAAAAAAA"
"GL873572","114760","114841","chr8","26280134","26280211","16","26165374","GGCCAGGCATGGCGGCTCTTCCCTGTAATCCTAGCACTCTGGGAGGGCGAGGCAGGCAGATCACCTAGGCTAGGGTGAGATC","GGCCAGGAATGGTGGCTCATGCCTGTAATCCCAGCACTTTGGGAGGCTGAGGCAGGCAGATCACCTGAGGTCAGGAGT"
"GL873572","9421791","9421892","chr11","8089184","8089269","35","1332607","TACTAAATATATAGCAAGGCCAGGCACAGTGGTTCATGGCTGTAATCCCAGTACTCTGGGAGGCCTAGTCAGAGTTGACCTGAGATCAGGCTAGAAGCCTGG","ATAAAAATAATTGGAGGCCAGGCACGGTGGCTCATGCTTGTAATTCTAGCAATTTGGGAGGCTGACGCGGGTGAGATCATACTGAG"
"GL873572","11052834","11053035","chr14","11857478","11857657","65","804644","TCCACAAAGAAAGCAGAAGTGTGGCCGGGTGGTAGCTCAAGGCAGGAATCCCAGCACTCTGGGAGCTGGGAGGTGGGGGAGGATCCCTTGAGATCAGGAGTTGGAGGGCACAGTGAGCCTGGGGGAGGCCACTGTCTCTGTACTCTAGCAGGGAGACAGAGCAAGACTGCCCATTCAAAGAAAAACAACAAACAAAACAAAA","TACAAAAATTAGCTGGGCACGGTGCCACAAGCCTGTAATCCCAGCTACTCGGGAGGCTGGGCAGGGGAATAGCTTGAACCCAGAGGTGGAGGTTGCAGTGAGCCAAGATCAAGCCACAGCACTCCAGCCTGGGTGACAGAGCAAGACTCCATCTCAAAAAAAAAAAAAAAAAAAAAAAAA"
"GL873573","2564195","2564244","chr1","109985445","109985491","12","107421250","TACAAAAATTAGGCTGGGCTTGGTGGTTCACGCCTATAATCCTAGCACTT","ACTAAAATTAGCTGGGCATGGTGGTGCATGCCTGTAATTCCAGCTAC"
"GL873573","7423371","7423533","chr2","202783328","202783513","56","195359957","GGTGGCTCACACCTGTAATCCCAGCACTCTGGGAGCCCTGGTGGCTCATGTCTATAATCCTAGTACTCTGGGAGACCATGGTGGCTCATGTCTATAATCCTAGTACTCTGGGAGCCATGGTGGCTCACGCCTATAATCCTAGTACTCTGGGAGACCATGGTGG","GGCTGAGGCGCGGGGGCTCACGCCTGTAATCCCAGCACTGTGGGAGGCCGAGGCGGGTGGATCACGCCTGTAATCCCAGCACTGTGGGAGGCCAAGGCGGGTGGATCACGCCTGTAATCCCAGCACTGTGGGAGGCCGAGGCGGGTGGATCACGCCTGTAATCCCAGCACTGTGGGAGGCTGAGGC"
"GL873573","9657648","9657710","chr19","10207852","10207913","10","550204","TAAAAATAAAAAATTTAGCTGGATGTGGTGGCTCACACCTGTAATCCTAGCACTCTGGGAGAC","TAAAAATACAAAATTAGCTGGGTGTGGTGGCACACACCTGTAATCCCAGCTACTCAAGAGGC"
"GL873574","1624662","1624783","chr9","814961","815079","36","809701","GACTGGGTGGGTTGGATCATGCCTGGAATCCTAGCACCCTGGGAGGCCAAGGTGAAAGGATTGCTTGAGGTTAGGAGTTCCAGAAATGTAGCAGTCATGGTGACTTCATCCTTCTCTACCAA","GGCTGGGTGCTTTGATTCATGCCTGTAATCCCAGCACTCTGGGAGGCCGAGGCAGGTGGATCACCTGAGGTTAGGAGTTCGAGACCAGCTTGGCTAACATGGTGAAACCTCGTCTCTAC"
"GL873574","4459477","4459612","chr1","29437872","29437991","29","24978395","GGCCGGGCGTGGTGGCGCACGCCTGTAGTCCCAGCGCTATGGGAGGCCGAGGCGGGTGGATCACCTGAGCTCAGAGGTTCGAGACCAGCCAAGACCCCCCTGAGCCAAACGAGCCAGAGTGAGACCCCGTCTCTAC","GGCCGGGCGTGGTGGCTCACGCCTGTAATCCCAACATTTTGGGAGGCCAAGGCGGGTGGATCACCTGAGGTCAGAAGTTCGAGACCAACCTGGCCAACATGGTGAAACCCCTGTCTCTAC"
"GL873574","4681987","4682216","chr6","153082888","153083127","73","148400901","GGGTGCGGTGGCTCAGACCTATAATCCCAGCACTCTGAGAGGCCGAAGTGGGTGGATCACCTGAGCTCAGGAATTTGAGACCAGCCGTCTCTAAAAATAGCTGAGTGTTGTGGCAGTGGCTGTAAGTCCCAGCTGTTTGGAAAGCTGAAGCAAGGGAATCACTTGAACCCAAGAGTTTGAGGTTGCTGTGATGACAAAGTGAGACTCTATCTCAAAAAAAAAAAAAAAAA","GGCCGTGCGCGGCGGCTCACGCCTGTAATCCCAGCACTTTGGGAGGCTGAGGTGGGTGGATCACCTGAGGTCAGGAGTTTGAGACCAGCCCGACCAGAAATTAGATGGGTGTGGTGGTGCGCTCCTGCAGCCCCAGCTACTTAAGAGGCTGAGGCAGGGTAATCACTTGAACCCGGGAGGCGGAGGTTGCAGTGAGCCGAGCTCACGCCACTGCACTCCAGCCTGGGTAACAGAGCGAGA"
"GL873574","4709916","4710039","chr19","13152422","13152536","46","8442506","AAAAATAGAAAAACTAGCCAAGCATGGTGGTGCACCCCCTATAGTCTGAGCTCCTCAGCGGGCTGAAGCAAAAGGACGGCTGGAGCCCTGGAGTTTGAGGTTGCTGTGAGGCAAGGTGATGCCA","ACACATAAATTAGCCAGACATGATGGTGAGTATCTGTAATTCCAGCTCCTTGGGGGGCTGAGGCGGGAGAATTGCTTGAACCTGGGAGGCAGAGATTGCAGTGAGCCAAGATCGC"
"GL873574","6353839","6353913","chr5","25768079","25768163","22","19414240","AAAAATATAGCAAGGCCAGGCATGGTGGCTCACACCTATAATCCCAGTACTTGGGAGCTGGAATTTGAACCTAGG","AAAAAACTCAAACAAGGCTGGGCGTGGTGGCTCACACCTGTAATCCCAGCACTTTGGGAGGCTGAGGTGGGTGGATCACCTGAGG"
"GL873574","6533061","6533332","chr5","85182161","85182439","81","78649100","GGCTGGGCGAGGTGGCTTACACCTATAATCCTAGTACTCTGGGAGGCCAAGGTGGGTGGATTGCCTGAGCGCACAGTTTCAAGACCAGCTGGAGCCAGAGAGAGAGAGAGAGACCCTGCCTCTAAAAATAGCCAGGCATTGTGGCAGGCACCTGTAGTCCCAGCTACTTGGCAGGCGGAGGTATGAGAATCGCTAGAGGTTGCTGTTAGCTATGATGCCATAGCACTCTACCAAGGGCGACAAAGTGAAACTCTGCCTCAAAAAAAAGAAGA","GCCAGGCGTGGTGACTCAAGCCTGTAATCCTAGCACTTTGGGAGGCCAAGGTGGGCGGATTGCCTGAGCTCAAGAGTTTGAGACCAGCCTGGGCAACACGGTGAAACCCAATCCCTACTAAATACAAAAAAAATTAGCCGGGTGTGGTGGTGTGAACCTGTAGTCCCAGCTACTCGGGAGGCTGAGGCAGGAGAAGGCAGAAGTTGCAGTGAGCCGAGATCACACCACTGCACTCCAGCCTGAGTGACAGAGCAAAACTCTTTCTCAAAAAAAAAAAAA"
"GL873574","6643746","6643907","chr2","92627944","92628105","46","85984198","AAATAGCCAGGCGTTGTGGCAGGCACCTATAGTCCCAGCTACTTGGGAGGCTGAGGCAAGAGAATCACTTAAGCCCAAGTGACAGAGGTTGCCAGGGCACTCTACGTAGGCAACAGAGTGAGACTCTATCTAAGAAAGAAGGAAGGAAGGAAGGAGAAAGAA","TTAGCCGAGCATTGTGGTGCGCGCCTGTAGTCCCAGCTACATGGGAGGCTGAGGCAGGAGAACACCTGAACCCAGGATGTGAGCTGAGTCGCGCCATTGCACTCCAGCCTGGGCAACAGAGTGAGACTCCATCTCAAAAATAAAATAAAATAAAATAAAAAA"
"GL873574","6644163","6644274","chr1","128607504","128607619","20","121963341","CTGTAATCCTAGCACTTGGGAGGCTGAGGCAGGTGGATCACCTGAGTTCAGGAGTTCAAGACCAGCCTAAACAAGAGTGAGACCCTATCTCTACTAAAAATAGAAAAAATAT","GCCTGTAATCCAAGCACTTTGGGAGGCTGAGGCGGGTGGATCACCTGAGGTCAGGTGTTCGAGACCAGCCTGGCCAACGTGGTGAAACCCCAACTCTACTAAAAATACAAAAATTA"
"GL873574","8511822","8512127","chr1","23439759","23440073","84","14927937","GGTGGCTGGTGCCTGTAATCCTAGCACTCTGGGAGACTGAGGCAGGTGGATCACTTGAAATCAGGAGTTTGAGATCAACCTGAGCAAGAGATCTTGTCTCTCCTAAAGATAGAAAAACTAGCTGGGATTTGTGGTGGACACCTGTAATTTCAGCTACTCAGGAAGCTAAGGCAAGAGCATTGCTTAAAACCAGGAGTTTGAAGTTGATGTGAGCTAGGATGTCAGGGCAGGTTACCCAGGGTGACAGAGTGAGACTCTGTGTCAAAATAAACAAACAAACAAACAAACAAAACAAAATAAAATAAA","GGCTGGACATGGTGACTCACGCTTGTAATCCCAACACTTTGGGAGGCTGAAGCAGGCAGATCACCTGAGGTCAGGAGTTTGAGACCAGCCTGACCAACATGGTGAAACCTTGTCTCTACTAAAAATACAAAAATTAGCTGGGAGCAGTGGTGCACACCTGTAATCCCAGCTACTCGGCAAGCTGAGGCAAGATAATTTTTTAAACCTGGGAGGTGGAGGTTGCAGTGAGCCAAGATCGTGCCACTGTACTCCAACCTGGGAGACAGAGCAAGACTCTGTCTCAAAAAAAAAAAAAAAAAAAAAAAAAAAAAAAAA"
"GL873575","2107336","2107519","chr4","38052972","38053149","54","35945636","TCAATTAAAAACTTTTTAAAATGAGGCTGAGCATGGTGGTTCACACCTGTAATCCCAGCACTTTGGGAGGCCGAGGCAGGAGGATCACCTGATCCCAGGAGTCCAAGCCTACAGTGAGCCGTGATAATACCACTGCACTTCAGCCCAAAGCCTCAAAAAGAAAAAAAAAAAAGGATAGACAAGA","TATATATATATATATTATTTTGGGGGGGCATGGTGGTGCACACCTGTAATCCCAGCTACTCGGGAGGCTGAGGCAGGAGAATTGCTTGAGCCCGGGAGGCAAAGGTTGCATTGAGCTGAGATCACACCACTGCACTCCAGCCTGGCGACAGAGTCTCAAAAAAAAGAAAAAATAAAAA"
"GL873575","5831824","5831959","chr1","29437872","29437991","28","23606048","GGCCGGGCGTGGTGGCGCACGCCTGTAGTCCCAGCGCTATGGGAGGCCAAGGCGGGTGGATCACCTGAGCTCAGAGGTTCGAGACCAGCCAAGACCCCCCTGAGCCAAACGAGCCAGAGTGAGACCCCGTCTCTAC","GGCCGGGCGTGGTGGCTCACGCCTGTAATCCCAACATTTTGGGAGGCCAAGGCGGGTGGATCACCTGAGGTCAGAAGTTCGAGACCAACCTGGCCAACATGGTGAAACCCCTGTCTCTAC"
"GL873575","7451097","7451208","chr3","122814630","122814743","22","115363533","GGCCAGGTGTGGTGGCTCACACCTGTTATCCTAGCACTCTGAGAGGCCACAGCAGCTGGATCACTTGAGCTCAGGAGTTCAAGACCAGTCTGAGCAAGAGCAAGACCTCACC","GGCTGGGTGTGGTGGCTCATGCCTGTAATCCCAGCACTTTGAAAGGCCAAGGCAGATGGATCACTTGAGGTCAGGAGTTCCAGACCAGCCTGGCCAACATGGCAAAACCCCATC"
"GL873575","7451277","7451445","chr6","58863249","58863409","41","51411972","AAAAATTCAGCCAGCCACAGTGGAAGTGGATGCCTGCCATCACAGCTACTCTGGGGGCTGGGGCAAGAGAATTGCTTGATCCCAGGAGTCTGAGGTTGCTGTGACCTAGGCTGACACCACAGCACTCTACCCAGGGTGACAGAGTGAGGCTGTGTTTAAAAAAAAAAAA","TTAGCCAGGCATGGTGGCACATGCCAGTAATCCCAGCTACTCAGGAGGATGAGGCAGGAGAATCGCTTGAACCCAGGAGGCAGAGGTTGCAGTGAGCTGAGATTGCGCCACAGCACTCTACCCTGGGTGACAGAAGGAGACTCTGTCTCAAAAAAAAAAAA"
"GL873576","1765109","1765185","chrX","53921180","53921256","12","52156071","GGCCAGGTGCAGTGGCTCATATCTGTAATCCTAGCACCCTGGGAGGCCAAGGTAGGCGAATCACCTGAGGCCAGGAG","GGCCAGGTGCAGTGGCTCACGCCTGTAATCCCAGCACTTTGGGAGGCCGAGGTGGGCGGATCACTTTAGGTCAGGAG"
"GL873576","2711577","2711895","chr7","6620384","6620702","85","3908807","GGTCGAGCTTGGTGGCTCATGCTTGTAATCCTAGCACTCTGGGAGGCCAAGGCAGGTAAGTTGCCCTGAGCTCATAGGTTCCAGATCAGCATGAGCCAGAGTGAGACCCTGTCTCTACCAAAAAATAGCCCGGCATTCTGGCAGGTGCCTGTAATCCCAGCTGCTTGGGAGGCTGAGGCTAGAGAATCACTTAAACCCAAGGGTTAGTGGAGGTTGCTGTGAGCTATGATTCCACCGTACTCTACTGAGGGCCACAAAGTGAGACTCTGTCTCCATAAAAAAGAAAGAAAGAAAGAAAGAAAAATAAAATAAAATAAAA","GGCCAGGCACAGTGGCTCATGTCTGTAATCCCAGCACTTTGGGAGGCCGAGGCGGGTGGATTACCTGAGGTCAGGAGTTCTAGACCAGCCTGGCCAACAAGGCGAAACCCTGTCTCTACTAAAAATACAAAAAATTAGCTGGGCGTTTTGGCACATGCCTGTAATCCCAGCTACTTGGGAGGCTGAGGCAGGAGAATTGCTTGAACTGGGGAAGTGGAGGTTGCAGTGAGCTGAGATCACACCATTGCACGCCTGAGCAACAGAGCGAGACTCTGTCTCAAAAAAAAAAAAAAAAAAAAAAAAGAAAAGAAAAAGAAAA"
"GL873576","4782520","4782652","chr9","61136941","61137074","22","56354421","CCAGGCACGGTGGCTCACCCTTGTAACCCTAGTACTTTGGGAGGCTGAGGTGGGAGGATCCCTTGAGGTCAGGAGTTCAAGACCAGCCTGAACAACAGTGAGACCCCCGTCTCTACTAAAAAATAGAAAAGTT","GCCAGGCACGGTGGCTCACGCCTGTAATCCCAGCACTTTGGGAGGCTGAAGCGGGCGGATCACCTGAGGTCAGGAGTTCAAGACCAGCCTGGGCACCATGATGAAACCCCGTCTCTATTAAAAATACAAAAATT"
"GL873576","4782930","4783078","chr7","57521645","57521803","40","52738715","AGTTAGTCTGGTGTCATGGTGGGTGCCTGTAGTCCCAGCTGCTTGGGAGGCTGAGGCAAGAGAATCACTTGAGCCCAGGAGTTGGAGGTTGCTATGAGCGAGGCTGTAGCCTAGGCAACAGAATGAGACTTTGCCTCAAAAAAATAAAA","TTAGCTGGGCATGGTGGCGCATGCCTGTAGTCCCAGCTACTTGGGAAGCTGAGGCAGGAGAATCACTTGAACCTGGGAGGTGGAGGTTGCAGTGAGCTGAGATCGCACCGCTACACGCCAGCCTGAGCAACAGAGAGAGACTCTGTCTCAAAAGAAAAA"
"GL873576","7828709","7828723","chr5","101042981","101042996","1","93214272","TAAATAAATAAAAAA","TAAATAAATAAATAAA"
"GL873576","7828960","7829230","chr13","49045537","49045844","89","41216577","GCCGGCTGCAGTGGCTATAATCCAAGTACCCTGGGAGGCTTAGGTGGATGGATCACTTGAGCTCAGAAGTTCAAGACCAGCCTCAGCAAGAGGTAGACCTTGCCTCTATTAAANNNNNNNNNNNNNNNNNNNNNNNNNNNNNNNNNNNNNNNNNNNNNNNNNNNNNNNNNNNNNNNNNNNNNNNNNNNNAGTTTGAGGTTGCTGTGAGCTATGATGAAGCCAGGGCATTCTACCCAGGGTGACAGAGTAACTCTTAAAAAAAACTAAACAA","GGCCAGGCAGAGTGGCTCATGCCTGTAATTCCAGCAATTTGGGAGGCCTAGGCAGGCAGATTACCTGAGGTCAGGAGTTTGAGACCAGCCTGGCCAACATGGTGAAACCCCGTCTCTTCTANNNNNNNNNNNNNNNNNNNNNNNNNNNNNNNNNNNNNNNNNNNNNNNNNNNNNNNNNNNNNNNNNNNNNNNNNNNNNNGGAGATAATAGCTTTTGTAGAACGAAGCGATGCAACAGCCAGATCGCCGCCACCACCCTTAGGTCCTGGCGACAGAGTGAGATCCATCTTAAAAAAAAAAAAAAAAAAA"
"GL873576","10622840","10623093","chr7","60266447","60266705","74","49643607","GCTGGGTATGGTGGTTCACACCTATAATCCTAGCACTCTGGGAGGCTGAGGTGGGAGGATTGGTGGAGCTCAGGAGCTCATGAGGTGCCAAATCACTGGTGCCACACACCTGTATTCCCAGCTACTGAGGAGGCTGAGGCAGGAGGATCAGGTAAGCCCAGGAAGTTTGAGGTTGTAGTGAGTTAGGATGATTGAACTCTGCCTTGAGAGACAGAGCAAGATCCTCCTTCCTCCTAAGCAAACAAACAAATAAA","GGCTGGGTGCAGTGGCTCACACCTGTAATCCTAGCACTTTGGGAGGCTGAGGCGGGAAAATTGCCTGAGCTCAGGAGTTCAAGGACAGCCTAGGCAACATAGCATGGTGGTGCACGCCTGTATTCCCTGCTACTTGGGAGGCTGAGGCACAAGAATTGCTTGAATCCGGGAAGTGGAGGTTGCAGTGAGCCATTGTGGCACTGCTCTCCAGTCTGGGTGACAGAGCAAGACTCCATCTCAAAAAAAAAAAAAAAAAAAA"
"GL873576","10819939","10820007","chrX","67133632","67133707","21","56313693","AGGTTGCAGTGAAATTGTACCATTCCAATGAAGCCTGGGGGACAGAGTGAGATTCTCTCAAAATAAAAA","GGAGGTTGCAGTGAACCGAGATCGTGCCACTGCACTCCAGCCTGAGCGACAGAGTGAAACTTCGTCTCAAAAAAAA"
"GL873576","10920306","10920363","chr3","48261745","48261808","16","37341439","GCTGGACCTTGTAGAGAGTGCCTGTAATCCCAGCTACATGGGGGGCAAGAGAATTGCT","GCTGGGCATGGTGGTGCATGCCTGTGATCCCAGCTACTCAGGAGGCTGAGGCAGGAGAATTGCT"
"GL873576","10920398","10920529","chr10","67341428","67341546","30","56421030","GGCCAGGCGTGGTGGCTCACGCCTGTTGTCCCAGCACTGTGGGAGGCCGAGGTGGGTGGATTGCCTGAGCTCAGAGGAGTCCGGAAGACCAGCATGAGGCAGAGTGAGCCAGAGTAAGATCCTGTCTCTACC","GGCTGGGTGTAGTGGCTCATGCCTGTAATCCCAGCACTTTAGGAGGCCAAGGTGGATGGATTGCCTGAGCTCAGGAGTTCGAGACCACCCTGGGCAACAAGCCAAAACCCTGTCTCTAC"
"GL873577","515809","515961","chr7","137660778","137660931","43","137144969","AGCTGGGCATGGTGGCTCATGCCTATAACCCTAGCGTGCTAGGAGATTGCTTGTCAGGAGACTGAGGTTGCAGGAAACTGTGATGATGGCACTGCACTCTACCCAGGGTGACAGAGCAGGACTCTGCCTCAAAAAAAAAAAAAAAAATAGAAA","TTAGCTGGGCATGGTGGCGCATGCCTATAATCCCAGCTACTTGGGAGGCTGAGGCAAGAGAATCGCTTGAACCGGGGAGGCAGAGGTTGCAGACTGCACTCCAGCCTGTGTGACAGAGTGGGACTCCGTCTCAAAAAAAAAAAAAAAAAAAAAA"
"GL873577","1633164","1633256","chrX","38269524","38269615","26","36636360","TCAGCCAGGCATGGTGGCACTTGCCTATAAACCCAGCTCCTTGGGAAGCTGAGCCGGGAGGATCCCTTGCACCCAGGAGCAACGGAAGGCAGT","AATTAGCCAGGCATGGTGGCACATGCCTATAATCCCAGCTACTCAGAAGGTTGAGGCAGGAGAATCACTTGAACCTGGGAGGCAGAGGTTGC"
"GL873577","3979502","3979560","chr20","68909283","68909346","13","64929781","GAGTTTGAGACCAGCCTGAGCAAGACCGAGACCCAGTCTCTACTAAAAATAGAAAAATT","GGAGTTCAAGACCAGCCTGACCAACATGGAGAAACCCTGTCTCTACTAAAAAATACAAAAATTA"
"GL873577","3979839","3980009","chr10","31403126","31403287","39","27423287","ATGAGCAGATTGTCTTGGTGGGCACCTGTAGTCCCAGCTATTGGAGGTGGGAGGCTGAAGCAGGAAAATCTCTTGAGCCCAGGAGTTTGAGGTTGCTGTGAGCTAGGCTGACACCACGGCACTCTAGTCAGGGCGTCAGAGTGAGACTCCGTCTCAAAAAAAAAAAAAAAA","TTAGCTGAGTGTGGTGGCGCACATCTGTACTCCCAGCTATTTGGGAGGCTGAGGCAGGAAAATCGCTTGAACCCAGGAGGTGGAGGTTGCAGTGAGCCAAGATCACACTACTGCACTCCAGCCTGGGTGACAGAGTGAGAATCCATCTCAAAAAAAAGAAAA"
"GL873577","6050882","6051080","chr1","153219820","153220007","59","147168938","GGCTGGGCGTTGTGACTCATGCCTGTAATCCCAGCACTCTAGGAGGCCGAGGTGGGTGGACTGCCTGAACTCAGAGGTTTAAGACCATCCTGAGCCGCAGTGAGCCAGAGCGAGACCCTGTCTCTACCAAAAAAAGCTGGGTGTTGTGGTGGGCGCCTATAGTCCTAGCTACTTGAGGCGCTAAGGGTAAAAAAATTGC","GGCCTGGCACAATGGCTCACGCCTGTAATCCTAGCACTTTGGGAGGCCGGGGTGGGTGGATCACCTGAGATCAGGAGTTTGAGACCAGCCTGGCCAACATGGTGAAACTCCTTCTCTACAAAAATTAGCCAGGTGTGGTGGTGGGTACCTGCAATCCCAGCTATTTGGGAGGCTGAGGCAGGAGAATC"
"GL873577","8463965","8464050","chr9","52134422","52134508","19","43670457","CTGGGTGCTATAGCTCACGCCTATAATCCTAGCACTCTGGGAGTTTGGGGCAAATGGATCACCTAGGCTCAGGAGTTTGATACCAG","GGCTGGGAGCAGTGACTCACGCCTATAATCCCAGCACTTTGGGAGGCTGAGGCAGATGGATCACCTGAAGTCAGGAGTTCGAGACCA"
"GL873577","9471486","9471613","chr16","5178790","5178910","46","4292696","TTAGCCAGGCATAGTAGCCTGTGTGTAGTCCTAGCTACTCAGGAGGCTGAGGTAGATGGGTCACTTGAGGTTGCAGAGATTATGGTAATGTCACTGTACTCTAGCCCTGGCAACAGAGCACAACCCTG","TTAGCCGAGCCTGGTGGCATAAACCTGTAATCCCAGCTACTCAGGAGGCTGAGGCAGGGGAATTGCTTGAACCTGAGAGGAGAAGGTTGCAGTGAGCCGAGATTGCACCATTGCACCCCAG"
"GL873577","9471875","9471998","chr7","17832200","17832315","36","8360325","GGCCAGGTGAAGCAGCTCATGGCTATAATCCTAGCAGTTTGGCAGGCCAAGGTGGGAGGACTGCTTGAGGTCAAGAGTTCAAGACCAACCCATCTTTGCGAAAAATTTAAAAATTACCTAGGCA","GCCAGGAGAGGTGGCTCATGCCTCTAATCCCAGCACTCTGGAAATCCAAGGTGGGTGGATCACCTGAGGTCAGGAATTCCAGACCAGTCTGGCCAATATAAAAAATTAGCCAGGCT"
"GL873577","9853150","9853170","chr3","85044647","85044667","3","75191497","AAACAAACAAACAAAAAAAGA","CAAACAAACAAACAAACAAAA"
"GL873577","9853206","9853473","chr7","130818682","130818963","67","120965476","GCTGGGCGCAGCGTCTCACTCCTGTAATCCCAGCACTTGGGAGGCCAAGGTGAGTGGATTGCCTGAGTTTACAGTTTCGAGACCAGCCTGAGCCAAAGCGAGACCCCCATCTCTAAAAAATAGCTGGGCATTGTGGTGGGCACCTGTAGTCCCAGCTACTTGGGAGGCTGAGGCAAGAGGATCGCTTGAACCTAAGAGTTTGAGGTTGCTGTGAGCTAAGGCTCCATGGCATTCTACCAAGGGTGACTAAGTGAGACTCTGTCTAAAA","GCCGGGCACAGTGGCTCACACCTGTAATCCCAGTACTTTGGGAGGCCAAGGTGGGTGGATCACCTGAGGTCAGGAGTTTGAGACCAGCCTGGCCAACATAGTGAAACTCTACTAAAAATACAAAAAAATAGCTAGGCATGGTGGTGCGCACCTGTAATCCCAGCTACTTGGGAGGCTGAGGCAGGAGAGTTGCTTGAACCCAGCGGGGTTGAGGTTGCAGTGAGTTAAGATCAAGCCACTGTGCTCCAGCCTGGATGACAGAGAGAGACTCCATCTCAAAAA"
"GL873577","10722415","10722478","chr10","12501471","12501539","23","1779056","AATAAAAAAATGCTGGGTACAGTAGTACATGCCTGTACTCTCATCTGGGGAAGCTGAGGCATGA","AAAGTAAAAAATTAGAGCTGGGCATGGTGGCACACACCTGTAATCCCAGTCACTAGGGATGCTGAGGCA"
"GL873578","463331","463568","chr10","28935382","28935620","93","28472051","CAGGTGCTTTGACCCACACCCTCAACTCTAGGACTTTGGACGCCCTGGCTGGGTGGGTCCTTTAAAGTCAGGAGCTTCTTATCAGTCTGGGCAAAAGTGAGACCCCATCTCTACCAAACAAAGAAAGAAATCAGCAGTATGTTGCAGTAGAGACTCACCAATACCTTCTTTCAAAGACCAAAGCTGGAAGGACACTAAAGACCATGATCTCATGGCCTCCCTGAGCCATGACAATGCC","CCAGGTGCAGTGGCTCATGCCTGCAAGCTCAGAACTTTGGGAGGCAGAGGTGAGCAGACTGCCTGAGTTCAGGAGTTCAAGACCAGCTGGGCAACATGGTGAGACCCTATCTCTACTAAAAATACAAATAATTAGCAGGGTGTGGTAGCACACACCTGTAGTCCAGCTACTCAGGAGGCTGAGGCAGGAGAATTGCTTGAACCCAGGAGGCAGAGTTTGCAGTGAGCCAGGACTGGGCC"
"GL873578","1143712","1143827","chr11","52824583","52824692","30","51680871","GGCTGGGTGTGGTGCCTCATGCCTGTAATCTAAGCCCTCTCCGAGGCTGAGGTGGGAGGATCCCTTGAGTTTAGGAGTTTGATTTTGAGACCAGCCTGATCAAGAGAGAGACCTCA","GGCCGGGTGTGGTGGCTCATGTCTGTAATCCCAGCACTTTGGGAGGCTGAGGTGGGTGGATACCCTGAGGTCGGGAGCTCGAGACCAGCCTGACCAACATGGAGAAACCC"
"GL873578","1144101","1144139","chr3","33494224","33494257","11","32350123","GAGAGAGACCTCATGTCTACTAAAATAAATAAATATATA","GTGAAACCCGTCTCTACTAAAAATACAAAAATTA"
"GL873578","1144175","1144343","chr12","119519961","119520131","41","118375786","ATTATCCAGGCCTTCTGGTGGATGCCTGTAGTCCTAGCTACTAGAAAAGCTGGAGCAGAATCACTTGACCCAGGAGCTGGAGGTTGCAGGGAGCTAGGCTGATGCCACAGAATTCTAGCCTGAGGCAAAAGAATTGAGCCACTGTCTCAAAAAGGAACAAAAAAGAAAA","ATTAGCCAGGTGTGGTGGCATGCACTTGTAATCCCAGCTACTAAGAAGGCTGAGGCAGGAGGATCACTTGAACCCGGGAGGTGGAGGTTGCAGTGAGCCAAGATCATGCCACTGCACTCCAGCCTGGGCAACAGAGTAAGACTCTGTCTCAAAAAAAAAAAAAAAAAAAAA"
"GL873578","4593962","4594035","chr16","68825055","68825124","22","64231093","AGCTGGGTACAGTGGCTCACATATAATCCCAGTGACTCAGGAGGCTAAGACAGGAGGATTACTAGGACCTGAGA","GGCTGGGCACAGTGGCTCAGACCTGTAATCTCAGTACTTTGGGTGGCTGAGGCAGGTGGATCACCTGAGG"
"GL873578","6158845","6158972","chr3","500432","500562","24","5658413","GACATGGTGGCTCACACCTGTAATCCTAGCCCTCTGGGAGGCTGAGGCAGGTGGATCACTTGAGTTCAGGAATTCAAGACCAGCTTGAGTGAGAGCAAGACCCTGTCTCTACTAAAAATAGAAAAATT","GCACGGAGGCTCATACCTGTAATCCCAGCACTTTGGGAGGCTGAGGCAGGTGGATCACCTGAGGTCAGGAGTTCCAGACCAGCCTGGCCAACATGGCGAAACCCTGTCTCTACTAAAAATACAAAAAATCT"
"GL873578","6159253","6159444","chr19","34496349","34496541","55","28337096","ATAAAATAAAAATAGAAAAATTAGCCAGGCATTGTGGCAGACATGCGAAGTCTCAGCTACTCCAGAGGCTGAGACAGGAAGATTACTTGAGCCCAAGAATCTTGCTGTGAGCTAAGCTGATGCCATAGCATTGTAACCTAGGCAACAGAGTAAGACTTGGCCTCAAAAATAAAATAAAATAATAAAGTAAAA","TTAGTTAATTAAATTAAACTTAGCTAGGCATAGTGGAACACACCCATAGTCCCAGCTACTCTAGAGGCTGAGGCAGGAGGATTGCTTGAGCCAAGTTGGAGGCTGCAGTGAGCTATGGTGGTGCCACTGCATTCCAGCCTCAGTGACAGAGAGAGACCCTGGCTCAAATAATAATAATAAATAAATAAATAAA"
"GL873578","6766040","6766171","chr2","93098086","93098217","30","86332046","CCAGGCACAGTGGCTCATGCCTATAATCCTAGTAGTCTAGGAGGCTGAGGTGAGTGCATTGCTTGAGCTCAGGAGTTAGATACCAGCCTAACCAAGAATGAGACCCCATCTCTATTAAAAATAGAAAAGTTA","GCCGGGCACAGTGGCTCATGCCTGTAATCCCAGCACTTTGGGAGGCCGAGGCGGGCAAATCACGAGGTCAGGAGTTCAAGACCAGCCTGACCAATATGATGAAACCCCGTCTCTATTAAAAATACAAAAATT"
"GL873578","6766434","6766577","chr9","21128084","21128223","50","14361650","GTTAGCCAGGAGTTGTGGCGGGCACCTACAGTCCTAGCGACTCAGGAGGCTGAAGTAGGCAGAGTTTGATGTGTTGCTGTGAACTACAAGGACACCAATGCACTCTAGGCCGGTAACAGAGTGAGACACTGACTAAAAAAAAAA","TTAGCCAGGTGTGGTGGCACATGCCTGTATTTCCAGCTACTCGGGAGGCTGAGGCAGGAGAATTGCGTGAGCTGAGATCATGCCACTTCATTCCAGTCTGGGTGACAGAGTGAGACTCTGCCTCAAAAAACAAAACAAAA"
"GL873578","7397948","7398119","chr5","40230148","40230319","43","32832200","TAAAAATAGCCATGCATTGTGACAGGCACCTGTAGTCCCAGCTACTCAGGAGGTTGAGGTAAGAGAATCACTTGAACCCAAGAGTTTTGAGGTTGTTATGAGCTAAGACGCCTCGGGACTCTACAAAAGGTAACAAAGTGAGACTCTGTCTCATAAAAAAAGAAAAAAAGAA","AAAATTAGCCAGGCATGGTGACGTACACCTGTAGTCCCAGCTACTCGGGAGGCTAAGGCAAGAGAATCGCTTGAACCCAGGAGGCAGAGGTTGCAGTGAGCTTAGATCACGCTACTGCGCTCCAGCCTGGGTGACGGAGTGAGACGCCATCTCAAAAAAAAAAAAAAAAAAA"
"GL873578","7398378","7398515","chr15","102382935","102383070","35","94984557","GGTCGAGCAAGGTGGCTCACGCCTGTAATCCTAGCACTCTGTGAGGCTGAGGCAGATGGATTGCCTGAGCTCGTGGGTTCGAGACCAGCCTGAGCCAGAGTGAGACCTCATCTCTAAAAATAGCTGGGAAGCTGGGCA","GGCCAGGTGTGGTGGCTCACGCCTGTAATCCTAGCACTTTGGGAGGCTGAGGCGGGTGGATTGCCTGAACTCAGGAGGTCAAGACCAGCCTGGGCAACACAGTAAAACCCCATCTCTACTAAAATACAAAAAATCA"
"GL873579","370235","370429","chr16","38067345","38067552","57","37697110","GCACAGGCCTGAAATCCTAGCACTCTGAAAGGCCAACGGAGGAGAATTTCTGGAGCTCAGGAGTTTGATACCAGCCTAAGCAAATAAAGCTAGACCTCTATCTCTACTAAAATTAGAAAAATTAGGCAGATGTGGTGGTAGGCACCTATAGTCCCAATTACTCCAGAGGCTGAGGCAGAAAGACTCTTGAACCCA","GTCAGGCATGGTGGCTCATGCCTATAATCCTAGCACTTTGGGAGGCCAAGGCCGGTGGATCACCTGAGGTCAGGAGTTTGAGACCAGCCTGGCCAATATGGCAAAACCCCGTCTCTACTAAAAATAAAAAAATTAGCTGGGCACGGTGGTGGGCACCTATAGTCCCAGCTACTCAGGAGGCTGAGGCAGGAGAATTGCTTGAACCCAG"
"GL873579","370936","371046","chr3","3847698","3847802","33","3476762","TGACTCTTGAACCCAGGCACATGAGGTTGCTAAGAGTCTAGGCTGATGTCACGGCACTCTAACCTGGGAAACAGTGTGAGGTTCTGCCTCAATAAATAAATAAATAAATAA","TGGCTTGAACCCAGGAGGCGGAGGTTGCAGTGAGCCGAGATCACGCCACTGCACTCCAGCCTGGGCAACAGAGCGAGACTGTCTCAAAAAAAAAAAAAAAAAAAA"
"GL873579","599436","599605","chr10","38982686","38982853","41","38383250","AAAAAGTCAGACATTGTGGCAGGTGTCTGTAATCCCAGCTATTTGGGAGGCTGAGGCAGGAGTATCATTTGAACCCACGAGTCTGAGGTAACTGTGAGCTAGGCTAACACAACAGCACTCTAGCCTGGGCAATAGAATGAGACTCTATCAAGAAAAGAAATGAAAAGAAA","TATTAGCCTGACACAGTGGCGCGCATCTGTAATCCCAGCTACTTGGGAGGCTGAGGCAGGAGAATCACTTGAACCCAGGAGGCGGAGGTTGCTGTGGGCTGAGATCATGCCACTGCACTCCAGCCTGGGCAACAGAGGGAGGCTCCATCTCAAAAAAAAAAAAAAAAA"
"GL873579","599942","599953","chr3","71473700","71473710","4","70873758","TTTTAAAATAGT","TTTAAAAAAAA"
"GL873579","600232","600365","chr1","16061315","16061447","30","15461083","GGCTAGGCAAGGTGACTCATGTCTGTAATCCTAGTACTCTGGGAGGTTTGAGGCAGGAAGACCACTTTAGCTCAAGAGTTCCAGATCAGCCTGTGCAAGAGTGATACATCATCTCTACTAAAAATCAAAAATTA","GGCTGGGCATGGTGGCTCATGCCTGTAATCCTAGCACTTTGGGAGGTTGAGGCAGGCAGATCACTTGAGGTCAGGAATCTGAGACTAGCCTGGCCAACATGGTGAAACTCCATCTCTACTAAAAAAAAAAAAA"
"GL873579","5650320","5650591","chr6","54938866","54939145","71","49288546","GTCAGGTGTGTTAGCTTACAGTAGTAATCCTAGCACTTTGGGAGGTTGAAGTGGGTGGATTGCTTGAGCTCAGGGGTTCAAGACCAGCCTGAACAAGAGTGGGACCTCATCTCTATTAAAAACAGAAAAACTAGCTGGGTGTTATGGTGGGTGTCTGTAGCCCCAGCTACTCAGGAGGCTGAGGCAGGAGGTTGAGGTTGCTGTGAGCTATTGAGACCACAGCACTCTATCCAGGGCAACAGAGTGAGACCCCTCCCCCCCCCAAAAAAAAA","GGCCAGGTGTGGTGGCTCACGCCTGTAATCCCAACACTTTGGGAGGCCGAGGTGGGTGGATCACCTGAGATCAGGAGTTCAAGACCACCCTGGCCAACATGGTGAAACCCCGTCTCTACTAAAAATACGAAAATTAGCTGAGTGTGGTGGTGCATGCCTGTAGTCCCAGCTACTCAAGAGGCTGAGGCAGGAGGTGGAGGTTGCAGTGAGCCGAGATTGCATCACTGCACTCCAGCCTTGGCGACAGAACGAGAGAGACTCCATCTAAAAAAAAAAAAAA"
"GL873579","7037162","7037347","chr3","37328686","37328893","67","30291524","GAGGTGGGTGGATTGCCTGAGCTCACAGGTTGGAGACCAGCCTGAGCCAGAGCAAGACCTTATCTCAAAAAATAGCCAGGTGTTGTGGCTGGCACCTGTAGTCCCAGCTGCTCAGGAGGCGGAGGCAAGAGAAATGCTTGACCTCAGGAGTTTGAGGTTGCTGTGAGTTCAACTCACACTAATACA","GAGGCAGGGGGATCACCTGAGGTCAGGAGATCGAGACCAGCCTGGCCAACATGGTGAAAACCTGTCTCTACTAAAAATCCAAAAACATTAGCCAGGTGTGGTGGCACGCACCTGTAATCCCAGCTACTTGGGAGGCTGAGGCAGGAGAATCACTTGAACCTGGGAGGCAGAGGTTGTAGCGAGCCGAGATCACACCACTGCACCCCAG"
"GL873579","11077764","11077972","chr19","1200469","1200683","63","9877295","GCCAGGTGCAGTGGCTCATGCCTATAATCCTAGCACCCTAGGAGGCTGAGGAGTTCAAGACCAGCCTAAGCAACTGTGAGACCCCATCTCTACCAAAAATAGAAAAATTAGCTGACTGTTATGGTGTGCACCTACAGTCCTAGCTACTCAGGAGGCTGAGGCAGAAAGAGTCCTTGAACCCAGGAGGCTTTTTTTTGTTGTTGTTGTTG","GGCCAGTCGCGGTAGCTCATGCCTGTAATCCCAGCACTTTGGGAGGCCGAGGCGGGCAGATCACCTGAGACCAGCCTGGCAACATGGTGAAACCCCATGTCTACCCAAACTACAAAAATTAGCTGGGTGTGGTGGTGCACGCCTGTAATCCGAGCTACTCAGCAGGCTGAGGCAGGAGAATCCCTTGAACCTGGGAGGCAGAGGCTGCAGTGAGC"
"GL873579","11078245","11078333","chr19","4926258","4926351","22","6151987","TGAACCCAGGAGTTTGAGTTCGCTGTGAGCTAAGCTGAGGCCACAGCACTCCAGCCTGGGCAACAGAGTGAAAGGAAAAAAATAAAAAA","TGAACCCGGGAGGTGGAGGTTGCAGTGAGCCAAGATCACACCAATGCACTCCAGCCTGGGCAACAAGAGTGAAACTCTGTCTAAAAAAAAAAAA"
"GL873580","320374","320488","chr13","48549305","48549409","42","48228931","GGTAGTGCGTGCCTGCATTCCCAGCTACGGGAGGGCAGGGACTTGAGGCCAGCCTGGGCAAAATAATGAGACCTACTAATGACTCTACTAATACAGAAACAATTAGCTAGGTATG","TGGGAGGCCGAAGTGCGCAGATCACCTGAGGTCAGAAGTTGGAGACCAGCCTGGCCAACATGGTGAAAACCCATCTCTACTAAAAATACAAAAATTAGCTGGGCA"
"GL873580","374969","375091","chr6","147681010","147681135","27","147306041","CGGTGGCTCACACCTATAATCCTAGCATTTTGGAAGGCTGAAGCCGAGGATCTCTGGAAGTCAGAAGTTCAAGACCAGCCTGCCCAAGAGCAAGACCCCATCTCTACTAAAAATAGAAAAACT","GGTGGCTCACACCTGTAATCCCAGCATTTTGGGAGGCTGAGGCAGGCGGATAATCTGAGGTCAAGAATTTGAGACCAGCCTGGCCAACATGGAGAAACCCTATCTCTACTAAAAATACAAAATTAC"
"GL873580","375369","375549","chr7","19977275","19977456","44","19601906","CTAACCAAGTTAGTTAGTTTTAGTTGGCAGGTGCCTGTAGTCCCAGCTCCTTGGGAGGCTGAGGCAAGAGAATGGCTTGAGCCCAGGACTTTGAAGTTGCTGTGAGCTATAATGACACCACAGCACACTACCCAGGGTGACAGAGTGAGACTGTCTCAAAAAAACAAACAAACAAAAAAAA","AACAAACGTTAGCCGAGCATGGTGGTATGTGCCTGTAGTCCCAGCTACTTGGGAGTCTAAGGCAGGAGAATTACTTGAGCCCGGGAGGCAGAGGTTGCTGTGAGCCAAGATCACGCCACTGCACTCCAGCCTGGGTGACAGAGTGAGACTCCATCTCAAAAAAAAAAAAGGAAAAAAAAAAA"
"GL873580","8760922","8761015","chr11","104681322","104681416","19","95920400","GGAGGGAGACACTGCAGTGAACTGCGATCGTGTCTCTGCTTTCCAGGCTGGGTGACAGAGTGAGACTCGGTCTCTAAAATAAAAAATAAATAAA","GGAGACGGAGGTTGCAGTGAGCTGTGATCGCGGCACTGCACTCCAGCCTGGGCAACAGAGTGAGACTCTGTCTCAAAAATAAATAAATAAATAAA"
"GL873580","9391260","9391306","chr14","49279240","49279285","12","39887980","GCCAGTCGAGGTGGCTCACACTTGTGATTCCAGCTACTTGGAAGACT","GGCTGAGATGGTGGCACACACCTGTAATCCCAGCTACTTGGGAGGC"
"GL873581","759283","759365","chr6","46535476","46535542","30","45776193","TAAGAACCTGAAAATAGAGCCAGGCATAGTGGTACATGCGTATAGTCCTGGCTACTCAGGAGGTTGAAACAACAGGATTACTT","CAAAATAGCCAGGCTTGGTGGTGCATGCCTATAATCCAAGCTACTCGGGAAGCTGAGGCAGGAGAAT"
"GL873581","1145844","1145979","chr1","29437872","29437991","29","28292028","GGCCGGGCGTGGTGGCTCACGCCTGTAGTCCCAGCACTATGGGAGGCCGAGGCGGGTGGATCACCTGTGCTCAGAGGTTCGAGACCAGCCAAGACCCCCCTGAGCCAAATGAGCCAGAGTGAGACCCCGTCTCTAC","GGCCGGGCGTGGTGGCTCACGCCTGTAATCCCAACATTTTGGGAGGCCAAGGCGGGTGGATCACCTGAGGTCAGAAGTTCGAGACCAACCTGGCCAACATGGTGAAACCCCTGTCTCTAC"
"GL873581","9628238","9628362","chr5","141044567","141044691","34","131416329","ATCCCAGGTAGTCGGGAGGCTGAGGCAGGAGGATCACTTGAACCCAGGAGGTTGAGGTTGCTGTGAGCAAGGCAGAGGCAACGGCACTCTAGCCACGGGGGCACAGAGACTCTTGTCTTTAAAAA","TAATCTCAGCTACTCGGGAGGCTGAGGCAGGAGAATCGCTTGAGCCCAGAAGGTGGAGGTTGCAGTGAGCCAAGATCGCGCCATTGCACTCCAGCCTGGGCGACAGTGCGAGACTCTGTCTCAAA"
"GL873582","1580485","1580534","chr6","32576760","32576806","12","30996275","CAGCACTTGAGAGGCCAAGGCAGGTGGATCAACTGAGCAAGAATGAGACC","CCAGCACCTTGAGAGGCCAAGGCAGGTGGATCACCTGAGGTCAGGAG"
"GL873582","1644368","1644551","chr1","211626449","211626612","63","209982081","AAAATTTGCCGGGCTCCATAGCTCATGCATGTAATCATAGCACTCTGGGAGGCCAAGATGGGAGGATCTCTCAAGCTCTCTTACTTGGGAGGCTGAGGTTGCTGTGAGTTAGGCTTACGCCACAGCACTCTACTCTAGCGTGAGCAACTCTACTCTTAGTATGAGACTGTCTCAAAAGAAAAAA","AAATTAGCCAGGCGTCGTGGCACATGCCTGTAATCCCAGCTACTCGGGAGGCTGAGGCAGGAGAATAGCTTGATCTCGGGAGGCGGAGGTTGCAGTCAGCCGAGATCACACCACTGCAATCCAGCCTGGACAACAGAATGAGACTCCATCTCAAAAAAAACAAA"
"GL873582","5794385","5794459","chr13","18872784","18872852","27","13078399","ATATTGTTAAGCACAGCCACTATTAAAAATTAAATTATAGGCCAGGCATAGTGGCTCATGCCTGTAATCCTAGCT","TGAAACCACCATCTGGACCAAGATACAAAATGTTGGCTGGGCATGGTGGCTCACACCTGTAATCCTAGC"
"GL873583","102645","102683","chr14","5808766","5808804","14","5706121","GAGCAGATCACCTGAGCTCAGGAGTTTGAGACCAGCCTG","GAGGAATCCCTGTGCTCAGGAAGCTTACATTCTAGTGAG"
"GL873583","6200447","6200560","chr4","17786849","17786963","24","11586402","GGCCAGGAGGGACGGCTCATGCCTGTTATCCTAGCACTATGGGAGACTGAGGTGGGAGGATCACTTGAAGTTAGGAGTTCCAGACCAATCTGACCAAAGTGAGACCTCATCTCT","GGCCAGGCTTGGTGGCTCATGCCTGTAATCTTAGCACTTTGGGAGGCTGAAGTGGGTGGATCACTTGAGGTCAGGAGTTAGAACCAGTCTGGCCAACATGGTGAAACCTCAGCTC"
"GL873583","6200584","6200752","chr6","169626528","169626696","42","163425944","TTAGCTGGATGTGGTAGCACATGCCTATAGTCCCATCTACTCAGGAGGCTGAGACAAGAGAGTTGCTTAAGCCCAGGAGTTTAATTTAACTGTGAACTAGACTGAGACTGTGGCACTCTAGCTGGGGCAACAGAGTGAGACTCTGTCTCAAAAGAAAGCAAGAAAGAAA","TTAGCTGGGTATGGTGTCAGATGCCTGTAGTCCCAGCTACTCAGGAGGCTGAGACAGGAGAATCGTTTGAACCCAGGAGGCCAGAACTGCAGTGAGCTGAGATTCGCACCACTGCGCTCCAGCCTGGGCCAGACAGAGTGAGACTCTATCTCAAAAGAAAAAAAAAAAA"
"GL873583","10217398","10217583","chr3","36257142","36257313","44","26039744","TACTAAAAATAAAGTGTGATAGCCAGGCATGGTGGTGGTGCCTATAGAACCAGGCTATTCAGGAGGCTGAGGCAGAAGGATCACTTGAACCCAGGAGTCTGACGTTGCTGTGAGCTAGGCTGGTGCCATGGTACTCTAGCCTGTGGTAACAGAATGAGACTCTATCTCAAAAATAAAAATAAAAAA","TACAAAATTAGCCAGGCGTGGTGGTGCGTGCCTGTAATCCCAGCTACTTGGGAGGCCGAGGCAGAAGAATGACTTGAACCCAGGAGACAGAGGTTGCAGTGAGCCAAGATCCCACCATTGTACTCCAGCCTGGGCAACACAGTGAGACTCCATCTCAAAAAAAAAAAAAAAA"
"GL873583","10394919","10394983","chr16","12841703","12841771","22","2446784","GAGGTCAGGAAATCAAGATCAGTCTGGGCAATATATTGATACCCTGCCCCTACATAAGGAAGAAA","AGGTCAGGAGTTCAAGACCAGCCTGGCCAATATGTTGAAACCTCATCTCTACTAAAAATACAAAAATTA"
"GL873584","521512","521529","chr1","167402212","167402233","10","166880700","GCATGGAACCCCCCACTC","GGTGAAACCCCATCTTTACTAA"
"GL873584","2079725","2079768","chr15","4338291","4338335","11","2258566","GGCAGGTGGATTACCTGAGTTCAGGAGTTGGAGACCAGCCTGAC","AGGCGGATGGATCACGAGGTCGGGAGTTTGAGACCAGCCTGACCA"
"GL873584","5216877","5217053","chrX","91350057","91350230","49","86133180","CTACTGAAAATGATGACAGAGGCTGGGCATGGGGGCTCCCGCCTGTTATCCTAGCACCCTCGGAGGCTGGGGAATGAGGATTGCTTACGCCCAAGAGTTTGAGGTTGCTGTGAGCTGAGGCCGCTGCACTCTAGCCTGGGCAACAGAGTGAGACTCTGTCTCAAAAAAAAAAAAAAA","TGCAAAAATGAGCTGGGCATGGTGGCACATGCCTGTAATCCCAGCTACACAGGAGGCTGAGGCAGGAGAATCGCTTGAATCTGGGAGGCGGAGGTTGCAGTGAGCTGACATCAGGCCCCTGCACTCTAGCCTGGGCCACAGAGCAAGACTCCGTCTCAAAAAAAAAAAAAAAAA"
"GL873584","7289930","7289950","chr2","51453328","51453345","10","44163398","TGAGGCTCTGTCTCGAAATAA","AATGCCATCTATTAAAAA"
"GL873584","7289975","7290131","chr11","49739997","49740154","37","42450022","CAAGAAAATTAGCTGAGAGTCCTGGTAGGTGCCTGTAATCCCAGCTATTCATGAGGCTGAGGCAGAAGGATCACTTGGGTCCAGGAGTCTGAGGTTGCTGTGAGCTAGTCTGACGCCATAACACGCAAGCCTGGGCAACAGAGTGAGGCTCGGTTTC","CTACAAAAATTAGCTGGGCGTGGTGGCACATGCCTGTAATCCCAGCTACTCGGGAGGCTGAGGCAGGAGAATCACTTGAGCCCAGGAGGCGGAGGTTGCAGTGAGCCAAGATCATGCCATTGCACTCCAACCTGGGCAACAGAGCAAGACTCCATCTC"
"GL873584","7577743","7577867","chr5","48394329","48394446","27","40816586","GGCTGGATGAGGTGGTTCATGCCTGTAATCCTAGCACTCTGGGAGGCCAAGGTGGGTGGATTGCCTGAGCTCAGGAGTTCAAGACCAGCCTGAGCAAGACCCTGTCGCTAAAAATAGCTGGGTGT","GGCTGGGTGCAGTGGCTCATGCCTGTAATCCCAGCACTTTGGGAGGTCAAGGCGGGTGGATCACCTGAGGTCAGGAGTTCAAGACCAGCCTGGCCAACATCTCTACTAAAAATACAAA"
"GL873584","7578135","7578289","chr1","130112713","130112865","31","122534578","GGAGCTGGGTTTTGTGACTGCACCTGTAATCCCAGCTGCTCAGGAGGCTGAGGCAAGAGAATTGCTTGAGCCCAGGAGTTGGAGGTTGCTGTGAGCTGTGATGCCAGGGAACTCTACCAAGGGTGACAAAGTGAAACTCTGTCTCAAAAAAAAAA","TTAGCCAGGTGTGGTGATGCATGCCTGTAATCCCAGCTACTCATGAGGCTGAGGCAGGAGAATTGCTTGAACCTTGGAGCTGGAGGTTGCAGTGAGCTGAGATCAGACCACTCCAACCTGGGTGACAGAGCGAGACTCTGTCTCAAAAAAAAA"
"GL873585","1450952","1451121","chr10","59681079","59681242","48","58230127","TAAAAACAGAAAAAACTAGTCAGGTGGTGTGGTAGGTGCTCATAAGTCCCAGCTGCTTGGGAGACTGAGGCAAGAGAATCACTTGAGCACAAGAGCTTGAGGTGGCTGTGAGCTATAACACCATAGCACTGTACTGAGGGTGACAAAGTAAGACTCTGTCTCAAAAAAAA","TACAAAAATTAGTCAAGGGTGGTGGTATGTGCTTGTAATCCCAGCTATTTGGGAGGCTGAAGCAGGGGAATCCTTGAACCCAGGAGGTGGAGGTTGCAGCGAGCCGAGATCACGTCACTGCACTCTAGCCTGGGCGATAGGGTGAGACTCTGTCTCAAAAAAAA"
"GL873585","1451382","1451515","chr6","17405813","17405948","24","15954431","GGCCCGGCTCGGTGGCTCACACCTATAATCCTAACACTCTGGGAGGCTGAGGCAGGTGGATCACCTGAGCTCAGGAGTTTGAGACCAGCTGAGCAAAAACAAGACCCTATCTCTGCTAAAAATAGAAAAAACTA","GGCCGGGCGGGGTGGCTCACGCCTGTAATCCCAGCACTCTGGGAGGCCAAGGCAGGTGGATCACCTGAGGTCAGGAGTTTGAGACCAGCCTGGCCAACACGCAGAAACCCTATTTCTACTAAAAACACAAAAATTA"
"GL873585","1626960","1627026","chr7","17782729","17782794","22","16155769","AAGATGCCACAGCACTCTACAAGAGTGACCAAGTGAGACTCTGTCTCAAAAAAAAAAAGAAAAGGAA","CAATCGCACTACTGCACTTCAGCCTGGGTGACAGAGTGAGAACCTGTCTCAAAAAAATAAATAAAA"
"GL873585","1627304","1627531","chr11","17033552","17033788","61","15406248","GGCTGGGCACAGTGGCTCACGGCTATAATCTAGGCACTTGGGAGGCTAGGGCAGGTGGATTGCCTGAACTGACAAGTTTGAGACCAACCTGAGCAAGAGCGAGACCCCTGTCTCTAAAACATAGCCAGGCTCTGTGGTGGGCGTCTGTAGTCCCAGCTACTTGGGAGGCTGAGGCAAGAGAATTGCTTGAACTCAAGAGTCTGAGGTTGCTGTGAGTTAAGATGCCAC","GCCCGGCGCAGTGGCTCACGCCTGTAATCCCGGCACTGTGGAGGCCAAGGCAGGCGGATTGCCTAAGCTCAGGGATTCGAGAACAGCCTGGGCAACATGGTGAAACCCCATCTCTACTAAAATACAAAAAACTAGCCGGGCGTGGTGGTATGCGCCTGTAATCCCAGCTACTTGGGAAGCTGAGGCAGGAGAATTGCTTGAACCCGGGAGATGGAGGTTGCAGTGAGCTCAGATCAC"
"GL873585","3626082","3626158","chr1","100916857","100916922","27","97290775","TGCCTGTAATCCCAGCACTTGGGAGGCGGAGGTGGGTAGATTGCCTGACCCAGAGTGGGACCTCATCTCTAAAAGAA","CATGCCTGTAATCCCAGCACCTTGGGAGGCCAAGGTGGGTGGATCACCTGAGGTCAGTAGTTTGAG"
"GL873585","8849829","8849913","chr18","48581945","48582025","18","39732116","GGCTGGACGAGGGGACTCATGCCTGCAATCCCAGCACTGAGAGAGGCCAAGGCAGGTGGATCCCCTGAGCTCAGAAGTTTGAGAC","GCTGGACGCAGTGGCTCACACCTGTAATCCCAGCACTTTGGGAGGCCAAAGCAGGCAGATCTGAGGTCAGGAGTTTGAGAC"
"GL873585","9319890","9319971","chr8","79499361","79499447","14","70179471","GGCCAGGTGTGGTGGCTCACACCTGTCATCCTAGCACTCTGGGAGGACGAGGTGGGTGGACCGCCTGAGTCAGAGTGAGACC","GGCCAGGTGTGGTGGCTCACACCTGTAATCCCAACACTTTGGGAGGCCCAGGTGGGTGGATCACCTGAGGTCAGGAGTTCAAGACCA"
"GL873586","895572","895692","chr17","14501559","14501680","38","13605987","GGCCAGGTGAGGTTTCTCATTCTGGGAGTGAGCCAGCAATTGGGAGGCCAAAGTAAATGGATTGCCTGAGGTTATAGGTTCCAGAACAGCCAGAACAAGATCGAAATCCTGTCTCCAAAAA","GGCCAGGCGTGGTGGCTCATGCGTGTAATCTCAGCACTTTGGAAGGCCGAGGCAGGTGGATCACCCGAGGTCAAGAGTTCAAGACCAGCCTGACCAACATGGCGAGTCTCTGTCTCCACTAA"
"GL873586","5645995","5646150","chr6","58863249","58863409","38","53217254","GGGTATGGTGGCTCATGCCTGTAATCCAAGCACTCTGGGATGGTGAGGCAGGAGAATCCCTTGAACCCAAGAGTCCGAGGTTGCTGCGAGCTAAGCTGATGGCATAACACTCTAGCCTAGGCGACAGAGTGAGACTCTGTTTCCAAAGAGAAAAAA","TTAGCCAGGCATGGTGGCACATGCCAGTAATCCCAGCTACTCAGGAGGATGAGGCAGGAGAATCGCTTGAACCCAGGAGGCAGAGGTTGCAGTGAGCTGAGATTGCGCCACAGCACTCTACCCTGGGTGACAGAAGGAGACTCTGTCTCAAAAAAAAAAAA"
"GL873586","10258686","10258969","chr12","9481260","9481565","81","777426","GGCCGGGCATGGTGGCAGAAATCTAGGAGGCCGAGGCAGGTGGATCGCCTGAGATCACAAGTTCAAGACCAGCCTCAGCTACAGCAAGACCCCATCTCTAAAAATAGCCGGCTGTTGTGGCAGGCGCCTGTAACCCCAGCTACTCGGGAGGCTAAGGCAAGAGAATCGCTTGAGCCCATGAGTCTGAGGTTGCTGCGAGCTGTGACTCCACGGCACTCTACCCGGGGCGATAAAATGAGATTCTGTGTCAAAACAAACAAACAAACAAACAACAACAAAAACAA","GCTGGGCGCGGTGGCTCATGCCTGTAATCCCAGCACTTTGGGAGGCCAAGGCAGGTGGATCACCTGAGGTCAGGAGTTCGAGACCAGCCTAGTCCACATGGTGAAACCCCATCTCTACTAAAAACTAGCCAGGCGTGGTGGTGCGCACCTGTAATCCCAGCTACTCGAGAGGCTGAGGCAGGAGAATCACTTGAGCCTAGGAAGCAGAGGTTGTGGTGAGCTGAGATCACACCACTGCACTCCAGTCTGGGCGACACAGTGAGACTCTTGTCTCAAAAACAAAAAACAAACAAACAAACAAACAAA"
"GL873587","3208032","3208047","chr8","3626746","3626762","2","418714","AAACAACCACAAAAAA","ACAACAACAACAAAAAA"
"GL873587","3208141","3208321","chr19","2057131","2057316","59","1151010","TTTCTTTTAAAAATCACCCATGGGCTGGGTATAGTGGCTCACACCTATAATCCTCGGGAGGCCAAGGTTGGAGGATTGCTTGAATCCAGGAGTTGAAGGTTACAGTGAACTGGGATTTAGCCACTAGACTCTAGCATAGCTGACAAAGCAAGAACCTATTTGTTTAAAACACAAAAAAGAA","TACTAATAATACAAAAATGAGCCGGGTATGGTGGCGGGTGCCTGTAATCCCAGCTACTGAGGAGGCTGAGGCAGGAGACTTGCTTGAACCCAGGAGGTAAAGGTTGCAGTGAGCTGAGATTGCACCACTACACTCCAGCCTGGGCGACAAGAGCAAAACTTTTTCTCCAAAAAAAAAAAAAAAAAA"
"GL873587","3278260","3278367","chr19","19044200","19044312","39","15765940","CAGTCTGAGCAAGAGGGAGAGGCTATTTCTACTAAAAACAGAAAAACTAGCTGGGTGTTGGGGTGTGTTCCTAGTCTCAGTTACTTGGGAGGCTGAAGTAAGAGGATC","ACCAGCCTGGCCAACACGGTGAAATCCCGTCTCTACTAAAAATACAAAAATTACCTAGGCGTGATGGCACGTGCCTGTAGTCCCAGCTACTCATAAGGCAGAGGTGAGAGAAT"
"GL873587","3278673","3278754","chr7","49412503","49412597","28","46133830","GGCCACGAGAGCTAGCTCATGCCTATTCTAGGAGGCCAAAGCAGGCAGACTGCCTGAGCTCAGGAGTTCAAGAGCAGCCTGG","GGCCAGGTGCAGTGGCTCATGCCTGTAATCCGAGCACTTTGAGAGGCCGAGGCAGGCAGATCACCTGAGGTCAGGAGTTCAAGACCAGCCTAGTA"
"GL873587","3782076","3782188","chr9","112128434","112128552","34","108346358","ACTGGGGTGGCTGAGGCAGGAGCGTCACTTGAACTCAGGAGTTTGAGATTGCTGTGAGCTGAGCAGATGTCATGGCACGCTAGCCTAGGTAATAGAGTGAGACTTCGTCTAAA","CAGCTACTCGGGAGGCTGAGGCAGGAGAATCACTTGAACTCGGGAGGCGGAGGTTGCAGTGAGCCGAGATCACGCCATTGCACTCCAGCCTGGGCAACAAGAGCGAAATTCCATCTCAA"
"GL873587","4564996","4565084","chr20","27900350","27900437","14","23335354","GGCGGGGTGTAGTGGCTCATGCCTATTGTCCCAGCACTGTGGGAGGCCGAGGTGGGTGGATCACCTGTGCTCAGAAGTTTGAGACCAGC","GGCCGGGCGTGGTGGCTCATGTCTGTAATCCCAGCACTTTGGGAGGCCGAGGTGGGTGGATCACCTGAGGTCAGGAGTTCAAGACCAG"
"GL873587","6307870","6308175","chr12","112427710","112428020","54","106119840","GGCCAGATATGATGGCTCATGCTTGTAATCCTAGCACTCTGGGAGGCTGAAGTGGGAGGATCACCTGAGATCAGGAGTTCAAGATCACCCTGAGCAAAAGTGAGATCCCATCTCTATTAAAAATAAAAAAATTATCCAGGCATGGTGGTGCAGTCCTTTAGTCCCAGCTACTTGGGAGGCTGAGGCAGGAGAATCTCTTGAACCCAGGAATTAGAGGTTACAGTGAGCTGTGATGATGCTACTGCACTCTAGCAGGATGACAGAGTGAGATACTCCGTGTCAAAAAAAAAAAAAAAAAAAGCAAAA","GGCTGGACATGGTGGTTCATGCTTGTAATCCGAGCACTTTGGGAGGCCAAGGCGGGTGGATCACCTGAGGTTGGGAGTTCGAGACCAGCCTGACCAACATGATGAAACCCCATCTCTACTAAAAATACAAAAAAATTAGCCAGGCATGGTGATGCACGCCTGTAATCCCAGCTACTTGGGAGGCTGAGGCAGGAGAATCACTTGAACCCAGGAGGCAGAGGTTACAGTGAGCCGAGATCATGCCATTGCACTCCAGCCTGGATGACAGAGTGAGCCTCTGTCTCAAAAAAAAAAAAAAAAAAAAAAAAAAA"
"GL873587","6484004","6484128","chr10","67341428","67341546","29","60857424","GACCAGGTTCTGTGGCTCATGCTTGTAATCCTAGCACTCTAGGAGGCCGGAAGAGGGTGGATTGATTGCCTGAGGTCAGGAGTTAGAGACCAGCCTGAGCAAGAGCTAGACCCTGTTTCTTTCTT","GGCTGGGTGTAGTGGCTCATGCCTGTAATCCCAGCACTTTAGGAGGCCAAGGTGGATGGATTGCCTGAGCTCAGGAGTTCGAGACCACCCTGGGCAACAAGCCAAAACCCTGTCTCTAC"
"GL873587","6484407","6484586","chr3","167196537","167196723","48","160712130","TAGACCCTGTTTCTAAAAAAAAAATAGCCAGGTGTTGAGGCAGGTACCTGTAGTCCCAGCTACCTGGGAGGGCTGAGGCAAGAGAATCGCTTGAACCCAAGAGTTTGAGGTTGCTGTGAGCTGAGATGCTATGGCACTCAACCGTGAGCTACAAAGTGAGACTCTGTCTCAAAAAAAAAA","AAAACCTGTCTCTGCTAAAAATACAAAAATTAGCCGGGTGTGGTGATGTGCGCCTGTAGTCCTAGCTACTTGGGAGGCTGAGGCAGGAGAATCACTTGAATCCAGGAGGTGGAGGTTGTAGTGAGTCGAGATCGTGCGACTGCACTCCAGCCTGGGTGACAGCGAGACTCTGTCTCAAAAAAAAAAA"
"GL873587","7466229","7466364","chr1","29437872","29437991","35","21971643","GGCCAGGCGTGGTGGCTCATGCCTGTAGTCCCAGCGCTATGGGAGGCCGAGGTGGGTGGATCACCTGTGCTCAGAGGTTCGAGACCAGCCAAGACCCCCCTGAGCCAAATGAGCCAGAGTGAGATCCCATCTCTAC","GGCCGGGCGTGGTGGCTCACGCCTGTAATCCCAACATTTTGGGAGGCCAAGGCGGGTGGATCACCTGAGGTCAGAAGTTCGAGACCAACCTGGCCAACATGGTGAAACCCCTGTCTCTAC"
"GL873588","1502535","1502718","chr1","34852429","34852590","60","33349894","GGTGCAGTGGCTCACACCTGTTGTCCCAGCGCTGTGGGAGGCCGAGGTGGGTGGATCACCTGTGCTCAGAGGTCGAGACCAGCTGAAGACCTGCCTGAGGCAGAGTGAGCCAGAGTGAGACCCCGTCTCTACTAGAACAACAACAAGACAGCCAGACCTTGTGATCCCAGCTACATGGGGGGCT","GCCAGGTGCAGTGGCTCACACCTGTAATCCCAGCACTTTGGGAGGCCGAGGCGGGCGGATCACCTGAGGTCAGGAGTTTGAGACCAGCTTGACCAACATGGAGAAACCCCGTCTCTACTAAAAATACAAAATTAGCCTGGTGTGGTGTCGCATGCCTGTAAT"
"GL873588","10189037","10189246","chr3","45604681","45604903","65","35415644","GCTGAGATGAGGAGACTCTGTCTCTATTAAAAATAGAAAAATTGGGTGGATGTTGTGGGTACTGTAGTTGCAGCCTCTTGGGGGGCTAAGGCAGGAGGATCAGTTGAAGCCAGGAATTTGCTTTGAGCTAGGCTAAAGCCATGGCACTCTAGCCTGGGCAACAGAGTGAGGCTAGATCTCAAAAAAAGAAAGAAAAGAAAAAGAAAAAAA","CTGGCCAACATGGCAAAACCCCATCTCTACTAAATATACAAAAATTAGCTGGACGTGGTGGCACATACCTGTAATCCCAGCTACTTGGAAGGCTGAGGCAGGAGAATAGCTTGAACCTGGGAGGCAGAGGTTGCAATGAGCTGAGATCACGCCACTGCACTCTAGCCTGGGCAATAGAATGAGACTCTGTCTCAAAAAAAAAAAAAAAAAAAAAGACAAGAAA"
"GL873589","104719","104807","chr20","27900350","27900437","13","27795631","GGCTGGGCGTGGTGGCTCATGCCTGTTGTCCCAGCGCTGTGGGAGGCTGAGGTGGGTGGATCACCTGTGCTCAGAGGTTCGAGACCAGC","GGCCGGGCGTGGTGGCTCATGTCTGTAATCCCAGCACTTTGGGAGGCCGAGGTGGGTGGATCACCTGAGGTCAGGAGTTCAAGACCAG"
"GL873589","796766","796905","chr1","166346372","166346487","49","165549606","GGCTAAGTGTGGTGGCTCACACCTGTCATCTAGTACTTTGGGAGGGTGGGCCTGGGAGTTCAAAGACTGAACTCAGGAGTTCAAGGTGGCTCCGGGGAGGAATTCAAGACCAACCTGAGCCAGAGCGAGACCTCGACTCT","GGCCAGTGGGGTGGCTCACGCCTGTAATCCCAGCACTTTGGGAGGCTGAGGTGGTCAAATGACCTGAGGTCAGGAGTTTGAGACCAACCTGGCCAACATGGTGACACCTCGTCTCT"
"GL873589","1023679","1023690","chr1","205890061","205890072","1","204866382","AAAAAAAAAAAA","ACAAAAAAAAAA"
"GL873589","1023771","1024047","chr4","103012712","103012993","70","101988941","GGCTTGGTGGCTCACACCTGTAATCCTAGCACTCTGGGAGGCCGAAGTGGCTGGAATACTTGAGGTCAGGAGTTCAAGACCAGCCTAAGTGAGAGTGAGATCCCCATCTCTAATAAAAATAGAAAAATTAGCAGGGTGTTGTGGCTGGCACTTGTAGTCCCAGCTACCCAGGAGACCGAGGCAGAAGTTTGAGATTATTGTGAGCGAGGCTGATGCCACAGCATTCTAGTGGGACAACAGAGCAAAATTCTATCTCAAAAGAAAAAAAAAAAAAGGA","CGGGCGTGATGGCTCACGCCTGTAATCCCAACACTTTGGGAAGCCGAGGCGGACGTATCACCTGAGGTCAGGAGTTCAAGACCAGCCTGGCCAACATGGTGAAACCCCGTCTCTACTAAAAATACAAAAATTAGCTGGGTGTGGTGGCATGCGCCTGTAATCCCAGCTACCCAGGAGGCTGAGGCAGGAGAATCGCTGAGGCTGCAGTGAACTGAAATTGTGCCACTGCACTCCAGCCTGGGTGACAGAGCAAGACTCTGTCTCAAAAAAAAAAAAAAAAAA"
"GL873589","4820958","4821024","chr8","33633747","33633811","15","28812789","TTAGTCAAGTGCAGTGGCTCACACCTGTCATCCCAGCTACTTGGGAGGCTGAGGCAGGAGAGTTGCT","TTAGCCAGGTGTGGTGGTGCATGCCTCTAATCCCAGCTACTCAGGAGGCTGAGGCAGGAGAATTG"
"GL873589","6763768","6763857","chrX","25814002","25814092","29","19050234","GGTGTGGTGGCTCACACTTGTATCTTAGCATTTTAGGAGGCTGAATGGGGAGAATTGCTTTAAGTCAGGAGTCTGACTTCCACCTTGCCA","GGCTGGGAATGGTGGCTCACACCTGTAATCCCAGCACTTTGGGAGGCTGAGGTGGGCAGATCACCTGAGGTCAGGAGTTTGAGATCAGCCT"
"GL873589","8444551","8444632","chr9","93194085","93194171","17","84749534","CGGGCATGGTGGCTCACAACTATAATCTTAGCACTTTGGGAGGCTGAGACAGGTGGATGCCTGAACTCAAGAGTTTGAAACC","GGCCGAGCATGGTGGCTCACACCTGTAATCCCAGCACTTTGGGAGGCTGAGGCAGGTGGATTACCTGAGGTCAAGAGTTCAAGACCA"
"GL873589","9085365","9085494","chr2","194063347","194063481","42","184977982","GGCCAGGCACAGTGGCTCACACCTATAATCCCAGCACTCTGTGAGACTGAGGCAGGTGAACTGTTGCAAGAGTGAGACCCTGTGCTTGGTGCCTGTAGCTCAGTGGTTAATAATAAGAAAAAAGAAAAAA","GGCCAGGTGCAGTGGCTCACACCTGTAATCCCAGCACTTTGGGAGTCTGAACCAGGCAGATCACCTGAGGTCAGGAGTTCGAGGCCAGCTCGGCCACCATGGTGAAACCCTGTTTCTAATAAGAATACAAAAAAA"
"GL873589","9085767","9086002","chr7","84631446","84631650","75","75545679","GAGTGAAACCCTGTCTCTACTAAAAATAGAAAAACTAGCTGTGCATCAGGGCGCATAACTGTAGTCCCAGGTACTCAGGACACTGAGGCAAGAGAATTGCTCAAGCCCAAGAGTTTGCAAGAATTTGAGGTTGCTATGAGCTATGATGCCATGGCACTCTACCTAGGGTGACAGACAGAGACTCTGTCCCAAAAAAAAAAAAAGAAGAAGAAGAAAAAAAAAAAGAAAGAAAGAAA","ATAGTGAAACCTCGTCTCTACTAAAAATACAAAAATTAGCTGGGCATCATGGTGCACGCTTGTAATTCCAGCTACTTGGGAGGCTGAGGCAGGAGAATTGCTTGAACTCAGGAGGTGGAGGTTGCAATGAGCCAAGATCGCGCCACTGCACACCAGCCTGGGTGACAAAAGACTCTGTCTCAAAAAAAAAAAAAAAAAAAAAAAA"
"GL873589","9992904","9993045","chr16","56427538","56427666","46","46434634","AACCAGCCAGGCATGGTGATTCACACCTATAATCCCAGCTACTTAGGAGTATGGCTTGAGCACACAGGATACCATACCATTCTAGTCATCCCAGGCAACAGAGGGAAACTCTGTTGGTTAAAAAAAAAGAAAAACTTAAAAA","TTAGCCAGGAGTGGTGGTGCACGCCTATAATCCCAGCTACTTGGGAGGCTGAGGCACAAGAATCACTTGAACCATTGCACTCCAGCCAGGGTGATAGAGGGAGACTCTATCCAAAAAAAAAACAAAAAA"
"GL873589","9993319","9993452","chr3","2774534","2774668","28","7218785","GGCCTGAGCCCTGTGACTCATGCCTGTAATCCCAGCACTGGAAGTTCCAAGGCAGGTGGATCGCTTGAGCTCTGGAGTTCAAGACCAGCTCAACCAAGAGTAAGACCCCATCTCTACTAAAAATAGAAAAACCA","GGCTGGGCACGGTGGCTCATGCCTGTAATCCCAGCACTTTGAGAGGCCGAGGCAGGTGGATCTCCTGAGGTCAGGAGTTCAAGACCAGCCTGGGCAACATGGTGAAACCCCATCTCTACTAAAAATACAAAAAAT"
"GL873590","9044589","9044884","chr1","83754525","83754835","84","74709936","GGCCAGGTGCAATGGCTCATGCCTATAATCCTCACACTCTGGGAGGCTGAGGCAGGAGGATCACTTTTCTCAGGGTCAGGGCCAGCCTGACAAAAGTCAGACCCTGTTTCTACTAAAAATAGAAAAACTAGCTGGGTGTTGTGGCAGATGCCTATAGTCCCAGCTACTAAGAGACTGAGACAAGTGCCCAGAGTCTGAGGTTACTGTGAGCAAAGCTGATGCCATAGCATTCTAGCTATAGATCGAGAGTCTGTCTCAAAAACAAACAAACAAACAAACAAACAAACAAAAAAGAA","GGCTGGGTGTGGTGGCTCATGCCTGTAATCCCAGCACTTTGGGAGGCCGAGGCGGGTGGATCATCTGAGGTCAGGAGTTCAAGACCAGCCTGACCAACATGGTGTAACCCTGTCTCAACTAAAAATACAAAAATTAGCTGGGCGTGGTGGTGTGCACCTATAGTCACAGCTACTTGGGAGGCTGAGACAGGAGAATTGCTTCAACCCAGGAAGTGGAGGTTGCAGTGAGCCAAGATCATGTCACTGCACTGCAGCCTGACAGAGCGAGACTCCATCTAAAACAAACAAACAAAAACAAACAAACAAACAAA"
"GL873591","1831505","1831587","chr17","61702818","61702899","25","59871313","CCCAGCACTTTGGGAGGGCAAGATGGGAGAATCATATAAAGTCAGGAGTTTGAGACCAGTTTGGCAGACATGATGAACCCATC","AATCCCAGCACTTTGGGAGGCTGAGGCAGGCGGATCATCTGAGGTCAGGAGTTCAAGACCAGCCTGGCCAACATGGTGAAAC"
"GL873591","2719175","2719275","chr4","86137755","86137847","32","83418580","GTGGGGGCTTAGGCCTGTAATCCCAGCACTCTGAGAGGCCAAGGTGAGCTGGTCACCTGGGTTTAGGAGTTTGGAGACTTGCTCGAGCTAGACTGAGGCTC","GTGGTGGCTCACGCCTGTAACCCTAACAATTTGGGAGGCCAAGGCAGGTGGATCACTTGAGGTCAGAAGTTTGAGACCAGCCTGGACAATATG"
"GL873591","4732974","4733120","chr19","7991801","7991954","55","3258827","ATACGCAGACTGGCCGAGCGTGGTGTCACATGCCTATAATCCCAGTGGCTACTCTGGGGAGGAGAATCTCTTGAAACCAAGAGTTAGAGATTGCAGTGGGGTATGATACAGGGTAACAAAGAGAGACCTTGGATCTGAAAAGAAAAA","AAAATACAGAAACTAGCTGGGCATGGTGATGCACACCTGTAATCCTAGCTACTGGGGAGGCTGAGGCAGGAGAATTGCTTGAACCCAGGAGTCAGAGGTTGCAGTGAGCAACCAGCCTGGGTGATACAGTGAGTGAGACTCTGTCTCGAAAAAA"
"GL873591","6822728","6823009","chr1","20579766","20580052","72","13757038","GGCCAGGCGTGGTGGCTCATGCCTGTAAATCTCAGCACTCTGGGAAGCTGAGGCAGGTGGATTGCTTGAGGTCAGGAGTTTGAGACCAGCCTGTACCAGAGTAAGACCCTGTCTCTAATAAAAATAGAAAAAAAAAAAAAAACTAGTTGGGCATGGTGATGGGTGCCTGTAGTCCCACCTACTTGGGAGGCTGAGGCAATGGCATCTCTTGAGCCCAAGAGTTTGAGGTTGCTGTGCCATGGCACTCTCCCCAGGGTAACAGAGTGAAAATAAAAAAAAGAA","GGCCAGGCGTGGTGACTCATGCCTGTAATCTCAGCACTTTGGGAGGCCGAGGCAGGTGAATCACCTGAGGTCAGGAGTTTGAGACCAGCCTGACCAACATGGTGAAACCTCGTCTCTACTAAAAATACAAAAAGTAGCCAGGCATGGTGGCGCATGCCTGTAATCCCAGCTACTTGGGAGGCTGAGGCAGGAGAATCGCTTGAACCCGAGAGGCAGAGGTTGCATTGAGTCAAGATGGTACCACTGCACTCCAGCCTGGGTGACAGATTGAGACTCAAAAAAAAAAA"
"GL873591","7578706","7578813","chr16","45055441","45055543","42","37476735","AAATTTAGCTACACATAGTGGCATGAGTCTGTAATGCTAGCCACCCAAAAGGCTGTAGTAAGAGGATTGCTCTATCCCAGGAGTTAAAGACCAGCCCGGACATCAGAG","AATTAGCCGGGCGTGGTGACACACACTTGTAATCCTAGATACTCAGGAGGCGAAGGTAGGAGAATTGCTTGAACCCAGGCAGCAGAGGTTGCAACGAGCAGAG"
"GL873591","9282916","9283004","chr1","20744253","20744338","16","11461337","GGCCAGGCGCGGTGGCTCACCCCTGTTGTCCCAGTTCTGTGGGAGGCCGAGGTGGGTGGATCACCTGTGCTCAGAGGTTTGAGACCAGC","GGCCAGGCACGGTGGCCACGCCTGTAATCCCAGCACTTTGGGAGGCCGAAGTGGGTGGATTACCTGAGGTCAAGAGTTTGAGACCA"
"GL873592","835155","835315","chr16","75654291","75654451","43","74819136","CTGGGTGTGGTGGCTCTTGTCTGCAATCTCAGTACACTGGGAGGCTGAGGCAGAAGGATTGCTCCAGCTCAGGAGTTTGAGGCCAGGCTGAGCTAGTGCAAAACCCCATCTCTACTAAAAAAAGAAGGAAAAAAAAAAGAAAAAGAAAAAAAATACGAGCT","CCAGGTGTGGTGACTCACGCCTGCAATCCCAGCACTCTGGGAGGCTGAGGTGGGTAGATTACCGGAGGTTAGGCGTTTGAGACCAGCCTGGCCAACATGGTGAAACCCCATCGCTACTAAAAAAAAAAAAAAAAAAAAAAAAAAAAAAAAAAAAAAAATTA"
"GL873592","835589","835765","chr1","66836166","66836336","48","66000577","ACAAAAAACCTAGCTTAGGGTTGTTATAGCACCTGTAGTCCCAGCTACTCAGGCGCTAAGGCAGGAAAATCTGCCTGAGCTCAGGAGTTTGAGGTTGCAGTAAGTTATGATGATGCTACTGCACTCTAGCTGGGGCAACAGAGTGAGACTCTGTCTGAGGAAAAACCAAAACCAAAA","TAGCCCAGCACGGTGGCTCACACCTGTAGTCTCAGCTACTCAAGAGGCTGAGGCATGAGAATCGCTTGAACCCAGGAGGTAGAGGTTGCAGTGAGCTGAGATCATGCCACTGCGCTCCAGCCTGGGCAACAGAGTGAGACTCAGTCTCAAAAAACAAAACAAAACAAAAAA"
"GL873592","2520661","2520705","chr16","66853217","66853257","11","64332556","TCTGGGAGGCTGAGGCGGGTGGATCACCTGAGCAAGAGTGAGACC","TTTGGGAGGCTGAGGCAGGTGGATCACTTGAGGTCAGGAGT"
"GL873592","4535248","4535388","chr1","12240468","12240612","38","7705220","GGCGGGATGTGGTGGTTCATGGCTGTAATCCCAGCACTCAGGGAGGCTGAGTCGGGTGGATTGCTTGAGTTCAGGAGTTTGAGACCAACCTGAGCAAGAACTAAGCCTGTCTCTACTAAAGATATTATTTCTTATTTTTCT","GGCCGGGCGCGGTGGCTCATGCCTGTAATCCCAGCACTTTGGGAGGCTGAGGCGGGTGGATCACCTGCGGTCAGGAGTTCGAGACCAGCCTGGCCAACGTGGTGAAACCTCATCTCTACTAAAAATATAAAAATTAGCTGGTGTG"
"GL873592","4535654","4535831","chr8","126054004","126054184","54","121518350","TCTACTACAAATATTAACAGAAAAATTAGCTGGGCATTGTGACAGGTGCCTATAGTCCCAGATACTCAGAAGGCTGAAGTAAGAGGATCACTTGAACCCCAGGAGCTAAGGTGGCTGTGAGCTAGGCTGAGGCTCTAGCCTGGGTAACAGAGTGAGACTGTAAAAAAAGAAAGAGAGA","GTCTCTACTAAAAATACAAAAATTAGCTGGGTGTGGTGGTGCATGCCTGTAATCCCAGCTACTCAGGAGGCTGAGGCAGGAGAATCGCTTGAACCCAGGAGGTAGAGGTTGCAGTGAGCCAAGATCATGCCACTGCACTCCAGCCTGGGTGACAGAGGGAGACTCTGTCTCAATAAATAAA"
"GL873592","6794968","6795049","chr3","154764711","154764794","20","147969743","GAAGGTTTGATGAGCTCAGATGATGCCACTGCAGTCTACCCAGAGTGAAGGAGCGAGACTCTGTCTCAAAAACAAAAAAAGA","CAGAGGTTGGCAGTGAGCTGAGACTGTGCCACTGCACTCCAGCCGGGTGACAGAGTGAGACTCTGTCTCAAATTACAAACAAAA"
"GL873592","6881384","6881478","chr5","24882384","24882475","28","18001000","GGGCAGGCATAGTGACTGGTGTCTCTAATCCTAGCAGTCTGGGATGCTGAGGCAAGTGGAATGTCAGAGTTCAGGAGTTGAAGATCACCCTGACT","GGCCGGGCGCAGTGGCTCACATCTATAATCCTAGCATTTTGGGAGGCTGAGGCAGGCGGATCACCTGAAGTCAGGAGTTTAAGACCAGCCTG"
"GL873592","6881755","6881937","chr10","61601371","61601572","66","54719616","TCACCCTGACCAAGAGCAAGACCCTGTCTCTACTAAAAATAGAATAAACTAGCTGGGAATTGTGGTGGGTGCCAGTAGTCCCCGCTACTGAGGCAGGAGGATCATTGAGTCCAAGAGTTTGAGGTTGCTGTAAGTTAGGACACCACAGCACTCTACACAGAGTAAGACTGCCTCAAAAATAAA","AGTAAAGAAAAGAAACCCTGTCTCTACTAAAAATACAAAAATTAGCTGGGTGTGGTGGTGCGCACCTGTAGTCCCAGCTACTTGGGAGGGTGAGGTATGGGAATCACTTGAACCCGGGAGGTGGAGGTTGCAGTGAGCCAAGATCACACCACTGCACTCCAGCCTGGGTGAGAGAGTGAGACTCTGTCTCAAGAAAAAAGAA"
"GL873592","7006080","7006155","chr1","8947061","8947129","24","1940981","CACACTGAGAGGCAAAGGCTGGTGGATCACCTGAGCTCAAGAGTTTGAGACCAGCCAAGCCAGAGATCTTGTCTCT","CACTTTGGAGCCAGGTAGGTGATCACCTGAGTCAGGAGTTCGAGACAGCCTGGCCAACATGTGAAACCC"
"GL873592","8446508","8446655","chr11","122502739","122502874","48","114056231","TTAGCTGGGTGTTGTGGCAGGCACCTGTAGTCCCTCCCAGCTACTTGAAAGGCTGAGGCAAGATGACAGCTTAAACCCAAGAGTTTAAGGTTACTCTATTCAGGGCAACAGAGTGAGACTCCATCTACATAAATAAATAAATAAATAA","GGCTGGGCGTGGTGGTTCACACCTGTAATCCCAACACTTTGGGAGGCTGAGGCCAGCGGATTGCCTGAGCCCAGGAGTTTGAGACCAACCTGGGCAACATGGTGAAACTCCATCTCTACTAAAATACAAAAAGTTA"
"GL873592","8446953","8447008","chr16","44513352","44513404","15","36066399","GACCAGCCTAAGCAAAAAAGAGATCCTATCTCTACTACTAAAAATAGAAAAAATTA","ACCAGCCTCACCAATATGAAGAAACCCCATCTCTACTAAAAATACAAAATATT"
"GL873592","8447239","8447325","chr1","8062863","8062957","21","384376","GGCCAGGAGCAGTGACTCATGCCTAGCACTCTGGGAGGCCAAAGCAGGTGGATCAACTGAGCTCAGGAGTTCAAGACCAGCCTAAGC","GGCCGGGTGCAGTGGCTCATGCCTGTAGTCCCAGGACTTTGGCAGGCCAAGGCCGGTGGATTACCTGAGGTCAGGAGTTCAAAACCAGCCTAGCC"
"GL873592","8723925","8724000","chr3","42066983","42067054","20","33343058","AATTAGCCGGGCATGGTAGTGTGTGCCCATAATCTCAGCTACTCAGAAAGCTAAGATAGGAAAATTGCTTGAGCTC","TTAGCTGGGTGTGGTAGTGCATGCCTATAATCCCAGCTACTCGGGAGGCTGAGGTGGGAGAACTGCTTGAAC"
"GL873593","384022","384146","chr15","102382935","102383070","28","101998913","GGCCACGAGGGCCCATGCCTGTAATCCTAGCACTCTGGGAGGCTGAGGTGAGTAGATTGCTGAGCTCAGGAGTTCAAGACCAGCCTGTGCAAGAGACCCCATCTCTGCTAAAAATAGAAAAACCA","GGCCAGGTGTGGTGGCTCACGCCTGTAATCCTAGCACTTTGGGAGGCTGAGGCGGGTGGATTGCCTGAACTCAGGAGGTCAAGACCAGCCTGGGCAACACAGTAAAACCCCATCTCTACTAAAATACAAAAAATCA"
"GL873593","384425","384607","chr20","28286874","28287058","50","27902449","GAAAGAAAAGAAAAGAAAAACTAGCAAGATGTTGTAGCTGATGCCTATAATCCTAGCTATTGGAGAGGTGGAGGCAAGAGAATTGCGTGAGCCCAAGAGTTGAAGGTTGCTGTGAGCTGCGATGCCAGAGCACTCCAGGGTGACAGAGTAAGACTCTGTCTCAAAAAAAATTACAAAATAAAA","TAATAAAAATAAAAAAATTAGCCAGGAGTCAAAGCACACGCCTATAACCCCAGCTACTTGGGAGGCTGAGGGAGGAGAATTACTTGAACCCGGGAGGTGAAAGTTGCAATGAGCTGAGATCAAGCCACTGCACTCCAGACTGGATGACAGAGTGAGACTCTGTTTCAAAAAAAAAAAAAAGACAA"
"GL873593","1408445","1408467","chr10","88070368","88070389","9","86661923","AATCTAGAGATGGGGAGAGGTTG","AAAGAGATGGAAGAGAAGAAGA"
"GL873593","4856365","4856484","chr7","56497314","56497433","31","51640949","GCAATCCCAGCTGATCGGGAGGCTGACCCAGAAGAATCCCTTGAACCCAAGAGTCTGAGGTTGCTATGGGTGGATTCTACAGCACTCTAGCCTGGGAGACAGAGTGAGACTCTGTCCCAA","ATCCCAGCTACTTGGGAGGCTGAGACAGAAGAATTGCTTGAACCCGGGAGGTGGAGGTTGCAGTGAGCCAAGATTGTACCACTGCACTCCAGCCTGGCAACAGAGTGAGACTCTGTCTCA"
"GL873593","6661298","6661485","chr10","86749316","86749514","55","80088018","GCAGAGGCTCACATATGTAATCCTAGCACTCTGGGAGGATAAGGCAGGTGGACAGCTTGAGCTCAGGGGTTTGACCAGTCTGATCAAGAGCAAGACCTGTGTCTACTAAAAATAGAAAACCTAGCCAGGTATGATGGTAGATGCCTGTATTCCTAGCTACTCTGGAAGCTAAAGCTAAAGAGTTTGAA","GGTGGCTCACACCTGTAATCTTAGCAATTTGGGAGGCCGAGGTGGGTGGATCACTTGAGGTCAGGAGTTTGAGACCAGACTGGCCAACATGGTGAAACTCTGTCTCTACTAAAAATACAAAAATTAGCCAGTCATGGTGGTGCATGCCTGTAATCCCAGCTACTCAGGAAGCTTAGGCAGGAGAATCACTTGAACCCAG"
"GL873593","6710263","6710446","chr14","4390080","4390244","66","2320183","TTGAAGTCAGGAGTTTAAGGCCAGTCTGGGCAACATAGTGAGACCCCCATCTCTACGAAAATATTTTTTAAAAATTAAAAATAGCTGGGCATAGTGAGGCTGTTGTGAGCTATAACTGCACCACTGCACTCAGCCAAGGACAGAGACCCTGTTCCCTGCCTCAAACAAACCAAAACAAAACAAA","AAGTCTAGAGTTTACAGCCTGGACAACGCAGTGAAACCCTGTCTCTACCAAAAATACAAAAATTAGACAGGTGTGAGAGGCGGAGGTTGCAATGAGCTGAGATCGCAGCACTGCAGTCCAGCCTGGATGACAGAGCGAGACCCCATCTCAAAAACAAAAACAAAA"
"GL873593","7159645","7159716","chr6","178318394","178318465","21","171158749","GATCATGTCACTGCTCTCCAACCTGGGCAATTGAGCAGGAATCTGTCTCAAAAAGAAAAAAAAAAAAGAAAA","CGAGTTCACACCACTGCACCCCAGCCTGGGCAACAGAATGAGACTCGGTTTCAAAAAAAAAAAAAAAAAAAA"
"GL873593","7159841","7160050","chr13","33368171","33368368","69","26208330","GGCCAGGCGTGGTGGCTCACACCTGTTGTCCCAGTGCTGTGGGAAGCCGAGGCAGGTGGATCACCTGAGCTCAGCCGAGTTCGAGACCAGTGGAAGACCAGCATGAGGCAGAGTGAGCCAGAGTGAGACCCCATCTCTACAACAACAACAAGAAGAAAAAAAACAGCCGGACCTTGTGATCCCAGCTACGTGGGGAGCTAGAGAATCACT","GGCTAGGCATGGTGGCTCATGCCAGTAATCCCACCACTTTGGGAGGCCGAGGCAGGTGGATCACCTGAGGTCAGGAGTTCAAGACCAGGCTGGCCAACATGTTATGATGAGACCCTCATCTCTACTACAAATACAAAAATCAGCTGGGCATGGTGGCAAGTGCCTGTAATCCCAGCTACTTGGGAGGCTGAGGCAGAA"
"GL873593","8598292","8598391","chr11","118461023","118461129","33","109862731","AGCCAGGTGAGGTGGTTCACACCTGTAACCCTAGCTGCTTGGGAGGCTGAGGCCTCTCTATCCTGGGCAGTGTGGAGAAACTTTGTTTCAAAAAAAAGAA","GCCGGGCGCGGTGGCTCACGTCTGTAATCCCAGCGCTTTGGGAAGCCGAGGCGGGACTATCCTGGCCAACATGGTGAAACCCCGTCTCTACTAAAAATACAAGAATC"
"GL873594","357249","357377","chr2","75702890","75703011","36","75345641","CCTGGTACCGTAGGTCATGCCTGTAATCCTAGCACTTTGGGATGCTGAGGTGGGCAGATTGCCTGAGCTCACGAGTTCAAGCCATTAGAACTGAGCCTGACCTAGAGTGGGACCTCCAACTCTTTTTTT","GCCAGGCACAGTGGCTCATGCCTGTAATCCCAGCAGTTTGGGAGGCTGAGGTGGGCAGATCACTTGAGGTCAGGAGTTCAAGACCAGCCTGGCTGACATGGTGAAACCCCATCTATACCAAA"
"GL873594","357656","357834","chr7","17608776","17608965","55","17251120","GGGACCTCCAACTCTTAAAATAGCTGGGCATTGTGGTGGGCACCTACAGTCACAGCTACTTGGGAGGCTAAGGCAAGAGACTTGTTTGCAGCCAAGAGTTAGAGGTTGCTGTGAGCTATGAGGCTAGGGCACTCTACAGGGGGCGACAAGTGAGACTGTAAAAAAAAAAAAAGAAAAAA","GTCCCTACTAAAAATACAAAAAATTAGCTGGGCCTGGTGGCAGGCACCTGTAATCCCAGCTACTTGGGAAGCTGAGGCAAGAGAATTGCTTGAACCCAGGAGGCAGAGGTTGCAGTGAGCTGACATCAAGCCACTGTACTCCAGCCTAGGCAACAAGAGCAAGACTCTGTCTCAAAAAAAAAAAAAAAAA"
"GL873594","1410711","1410996","chr5","151340503","151340797","76","149929792","CACAGTGGCTCATACCTATAATCCTAACACTCTGGGAGGCCAAGGTGGGTGGACTGTCTGAGTTTGGGACCAGCCTGAGCAAAAGCAAGACTCCCATCTCTACTAAAAACAAAGACAGCCAGGTATGAGGGCAGGTGCCTATCATCCCAGCTACTTGGGAGGCTGAGGAAGGAGGATCACCTAAGCCCAGGACTTTAAGGTTTCTGTGAACTAAGATGATGTTACAACACTCTAGCCAGGGTAACAAGGCAAGATTCTGTTTCAAAAGACAAAAAAAAAAAAAAAA","GGTGGTTCATGCCTGTAATCCCAGCACTTTGGGAGGCTGAGGCAGGTGGATCACCTGAGGTCAGGAGTTCGGGACCAGCCTGGCCAACATGGGGAAACCCCATCTCTACTAAAATACAAAAATTAGCCAGGTATGGTGGCACATGCCTATAATCCCAGCTACTTGGGAGGCTGAGGCAGGAGAATCACTTGAACCCAGGAGGCTAAGGTTGCAGTGAGCCGAGATTGTGCCACTGTACTCCAGCCTGGGTGACAGACTGAAACTCTGTGTCCAAAAAACAAAACAAAACAAAAAA"
"GL873594","5528090","5528162","chr2","69013639","69013718","24","63485549","GGTACAGTGGCTCACGCTTGTGATCCCAGGTTGAGGTGGGTGGATCGCCTGAGCTCAGGAGTTGGATGCCAGC","GGTGTGGTGCCTCACGCCTATAATCCCAGCACTTTGGGAGGCAGGTGGATCACTTGAGGTCAGGAGTTTGAGAACAGCCT"
"GL873594","5834047","5834168","chr2","82491537","82491662","28","76657490","GGCTGGGCCCAGTAGCTCACGACTGTAATCCCAGCACTCTGGGAAGCTGAGGTGGGCGGATCACCTGAGCTCATAGGTTCGAGACCAGCTCCAGTTAGAGTGAGAGCCTGTCTCTAAAAATA","GGCTGGGCACAGTGGCTCATGCCTGCAATCCCAGCACTTTGGGAGGCTGAGGTGGGCAGATCACCTGAAGTCAGGAGTTCAAGACCAGCCTGGCCAACACAGTGAAACCCCATCTCTACTAAAAAT"
"GL873594","5834396","5834461","chr13","14688151","14688212","20","8853755","TATATAATAATAATAACCAGGTATTGTGGCAGGTGCCTCTAGTCCCAGCTACTCGGGAGGCAAAGG","ATAAAAAAATTAGCTGGCCATGGTGGCACATACCAATAATCCCAGCTACTCAGGAGGCTGAG"
"GL873594","7786130","7786294","chr14","12217087","12217250","37","4430957","GGGTGTGCTGGCTCATACCTATAATCCTAGCACTCTGGGAGGCTGAGGTAGGTGTATTGCTTGAACCCAGGAGTCTGAGGTTGCTGTGCGCTAAGCTGATACCATAGCACTCTAGCCTGGGCAACAGAGTGAGACTCTGTCTCAAAACAAATAAATAGTAAAAAA","GCTGGGCGTGGTGGCTCACACCTGTAATCCCAGCACTTTGGGAGGCCAAGGCATGAGAATTGCTTGAAAACAGGAGGCGGAGGTTGCAGTAAGCTGAGACTGTGCCATTGCACTCCAGCCTGGGCAACAAGAGTGAAACTCTGTCTCAGAAAAAAAGAAAAAAA"
"GL873595","723579","723774","chr19","6045933","6046125","65","5322354","GCCTGAGCAGGAGAGAGACCCCATCTCTGCTGAAAGTGGAAAAGTTGGCTGAGTGTAGTGGCGGGCTGCTGCCCCAGTCACTCAGGAGGCTTAGGAAGGAGTATCGCTTGGGCCCAAGATTTGAGGTTGCTGTGAGCGCTACAAAGACATTAGGGTACTCTACACAGGGGAATAGAGTGAGACTGTCTCAAAAAAA","CAACATGGAGAAACCCCGTCTCTACTAAAAATACAAAATTAGGCAGCGTGGTGGTGGGTGCCTATAATCCCAGCTACTCAGGAGGCTGAGGCAGGAGAATCGCTTGACCGGGAGTGGAGGTTGCGGTGAGCTGAGATTGCACCATTGCACTCCAGCCTGGGCAACAAGAGTGAAACTCCGTCTCAAAAAGAAA"
"GL873595","724114","724204","chr20","18199749","18199840","22","17475635","GGCCATGCTTGGTGGTTCTCATCTGTAATCCTAGCACTCTGGAAGGTCTACAGGGGTGGATGGCTGGAGGTCAGGAGTTCAAGACTGGCCT","GGCCGGGCATGGTGGCTCACACCTGTAATCCCAGCACTTTGGGAGGCTGAGGCAGGCGGATCACCTGAGGTCAGGAGTTCGAGACCGGCCTG"
"GL873595","1065346","1065667","chr18","10529729","10530057","74","9464383","GGCCAGGTGCAGCAGCTCATGCCTGGAATCTTCCTGCTCTGTATGGCCAAGGCAGGTGGATCGCCTGACCTCAGGAGTTCCAGACCAGCCTGAACAAGAGCAAGACTCTGTCTCTACTAAAAGTAGAAAAAAAACTAGCCAGTCATAGTGGCAGGTGCCTGTAGTCCCAGCTGCTTGGGAGGCTGAGGCAAGAGGATCACTTGAACCTAAGAGTTTGAGGTTGCTGTGAGCTAAGATGCCACATCACTCTATCAAGGGTGACCAAGTGAGACTCTGTCTCAAAAATAAATAAATAAATAAATAAAAAGAAAGGCAAAAAGAA","GGCCCGGCGTGGTGGCTCATGCCTATAATCCCAGCCCTTTGGGAGGCCAAGGCAGGTGGATCACCTGAGGTCAGGCGTTCGAGACCAGCCTGACCAACGTGGTGAAACCTCATCTCTACTAAATACAAAAAAAATTTAGCCAGGCATGGAGGCACATGCCTGTAATCCCAGCTACTTGGGAGGCTGTGGCAGGAGAATCACTTGAACCTGGGAGGTGGAAGTTGCAGTGAGCTGAGATTGTACCACTGCACTCCAACCTGGGTGACAAAGCAAGACTCGGTCTCAATAAATAAATAAATAAATAAATAAATAAATAAAGTGAAAAAAAA"
"GL873595","1254878","1255146","chr4","42822326","42822607","67","41567448","GGCTGGGCATGGTGGCTCATGCCTGTAATCCTACCGCTCTGGGAGGCTGAGGCAGAGGATCACTTGAGCTCAGGAGTTTCAGACCAGCCTGCAAGAAGGACCCAGTCTCTGCCGAAAATAGAAAAGTTAGCAAGGCGTTGTCGTGAGCACATGTATCCCAGCTACCTAGAACTCTGAGGCAGGAGGATCCCTTGAACCCACAGAAGTTGCTGTTATCTAAACTGATGCCACTGGACTCTAGCCTGGGCAACAGAGTGAGACTGGTCTCA","GGCCGGGCACGGTGGCTCATGCCTGTAATCCTAGCATTTTGGGAGGCTGAGACAGGCAGATTGCCTGAGCTCAGGAGTTCAAGACCAGCCTGGGCTAGATTGTGAAACCCCATCTCTACTAAAATATAAAAATTAGCTGGGTGTGGTGGCACACGCCTGTAATCCCAGCTACCTGGGAGGCTGAGGCAGGAGAATCGCTTGAACCAGGAGACAGAGGTTGCAGTGAGCTGAGATCACGCCACTGCACTTTAGCCTGGGCAACAGAGTGATACTCTGTCTCAA"
"GL873595","3417105","3417297","chr12","115674238","115674427","44","112257133","GGCCGGGCGCTGTGCCTCACGCCTGTAATCCTAATACTCTGAGAGGCCGAGGCAGGTGGATTGCCTGAGCTCAGGTGCTCAAGACAGCCTGACTGAGCAAGCCCTGAGATCCCATCTCCACTAACAATAGTAAAACTAGCCGGGCATTGTGGTGGTGCTTGTAATCCCAGCTACTGGGAGGCTAAGACAGGAG","CCAGGCCTGGTGGCTCACGCCTGTAATCCCAGCACTTTGGGAGGCCGAGGTGGGTAGATCACCTGAGGTCAGGAGTTCAAGACCAGCCTGGCCAACATGGCGAAACCCCATCTCTACTAAAAATACAAAAATTAGCTGGGCATGGTGGTGTATGCCTGTAATCCCAGCTACTCGGGAGGCTGAGGCAGGA"
"GL873595","6098380","6098457","chr3","87492619","87492702","21","81394239","GCTGTGGCTCATGCTGATAATACCAGCACTCTGGGAGAACAAGGTAGGCAGATCACAAGAGGTCACCTGTGCAAGACC","GGGCTGGTGGTGGCTCATGCCTGTAATACCAGCACTTTGGGAGGCCAAGACAGGTGGATCACCAAAGGTCAAGAGTTCAAGACC"
"GL873596","134190","134307","chr1","203207333","203207443","31","203073143","GGCTGGGCGAGGTGGCTCACACCTGTAATCCTAGCACTCTGGAAGGCCCTAGCACTCAGGCAGTTGGATTGCCTGAGCTCACAAGTTCAAGACCAGCCTGAAAAAGAGCAAGACCTCA","GGCTGGGTGCAGTGGCTCACACCTGTAATCCCAGCACTTTGGGAGGCCGAGATGGGTGGATCACTTGAGGTCAAGAGTTGAAGACCAGCCTGGACAACATGATGAGACCCC"
"GL873596","134578","134681","chr11","50235285","50235387","37","50100707","CAAACAAAAGAGGAAGACCTCGTCTCTAAAAAAATAGCTGGGCATTGTGAGGAGTACCTGTAGTCCTAGCTACTCAGAAGGCTGAGACAAGAGAATCACTTAAA","CAACATTGTGAAACCCTGTCTCTACTAAAATAGAAAATTAGCCAGGTGTGTGGGCGTGCCTATAATCCTAGCTACTGGGGAGGGTGAGGCATGAGAATCGCCT"
"GL873596","8160215","8160350","chr1","29437872","29437991","30","21277657","GGCCGGGCGTGGTGGCGCACACCTGTAGTCCCAGCGCTATGGGAGGCCGAGGCGGGTGGATCACCTGAGCTCAGAGGTTCGAGACCAGCCAAGACCCCCCTGAGCCAAACGAGCCAGAGTGAGACCCCGTCTCTAC","GGCCGGGCGTGGTGGCTCACGCCTGTAATCCCAACATTTTGGGAGGCCAAGGCGGGTGGATCACCTGAGGTCAGAAGTTCGAGACCAACCTGGCCAACATGGTGAAACCCCTGTCTCTAC"
"GL873596","8421071","8421132","chr20","1874027","1874093","12","6547044","GTCAGGCGCAGTGGCTCACGCCTGTAATCTCAGCACTCTGAGAAGCCAAGGCAGGATCATCT","GGCCAGGCGCAGTGGCTCAGGCCTGTAATCCCAGCACTTTGGGAAGCCAAGGTGAGCAGATCACCTG"
"GL873598","4416400","4416489","chr5","39418145","39418231","15","35001745","GGCCAAGTGTGGTGGCTCATGCCTGTTGTCCCAGCACCGTGGGAGGCCGAGGCTGGTGGAACACCTGAGCTCAGCTGAGTTTGAGACCAG","GGCCAGTTGCGGTGGCTCATGCCTGTAATCCCAGCACTTTGGCAGGCTGAGGCAGGTGGATCACCTGAGGTCAGGAGTTTGAGACCA"
"GL873598","4416855","4416947","chr3","94091253","94091337","31","89674398","GTGAGACCCTGTCTCTACAAAAAAAAAAGCTGGGCACTGTGGCATGTGCCTGTAATCCCAGCTACTTGGGAGGCAAAGGGAAAGAGAATCACT","AAACCTTGCCTTTACTAGAAATACAAAAATTAGCTGGGCATGGTGGCAGGTACCTGTAATCCCAGCTACTTGGGAGGCTGAGGCA"
"GL873598","5126074","5126161","chr1","12339306","12339394","19","7213232","GCCTGGTGCACTGGTTCACACCTGGAATCCTTGCATTCTGAGAGGCCCAGGTAGGCAGATCACCTCAGCTCAGAAGTTCGAGACCAGC","GCTGGGTGCGGTGGTTCACGTCTGTAATCCCAGCACTTTGGGAGGCCGAGGCGGGCAGATCACCTGAGGTCAGGAGTTCGAGACCAGCC"
"GL873598","5467584","5467662","chr1","9313328","9313403","17","3845744","GCGAGGTGGCTCACGCCTGTAATCCCAGCACATTTGGAAGGCCAAGGAGGGTGGATCACCCGAGCTCACCAGTTGGAGA","CGCAGTGGCTCACGCCTGTAATCCCAGCACTTTGGGAGGCCGAGGCAGGCAGATCACCTGAAGTCAGGAGTTTGAG"
"GL873598","6917752","6917856","chr14","9558287","9558382","22","2640535","GGCCAGGCATGGTGGCTTGTGCCTGTTGTCCCAGCACTGTGGAAGGCCGAGGCGGGTGGATCGCCTGAGCTCAGCTGAATTCGAGACCAGCATAAGACCAGTATG","GGCCAGGCATGGTGGCTTATGCCTGTAATCCCAGCACCTTGGAAGGCCGAAGCGGGCAGATCACCTGAGCTCAGGAGTTTGAGACCAGCCTGTCCA"
"GL873598","8078910","8079062","chr7","164825511","164825660","43","156746601","AACAGCCAGGCATTGTGGTGGGCACCTGTAATCCCAGCTACTTGGGAGGCTGAGGCAAGAGAATTGCTTGAGCCCAACAGTCTCAGGTTACTGTGAGTTATGACACCATGGCACTCTATTGAGGGCAAGAAAGTGAGACTGTCTTGGAAAAAA","CTAGCCAGGCATGGTGGTGCGCACCTGTAGTCCCAGTTACTTGGGAGGTTGAGGCAAGAGAATTGCTTGAGCCTGGAAGGCAGAAGTTGCAGTGAGCTGAGATCACACCACTGCATTCCAGCCTGGGCGAAAGAGCAAGACTCTGTTGAA"
"GL873598","8079328","8079454","chr6","10381248","10381379","32","2301920","GCCCGGCGTGGTGGCTCACGCCTGTAATTCCAGCACTCTGGGGAGGCCGAGGAGGGCAGATTGCCTGAGCTCACAGGTTTGAGCTAGAGCGAGACCCTGTCTCTTAAAAAGAAAAAAAAGGAAAGAA","GCTGGGCGCGGTGGCTCACGCCTGTAATCCCAACACTTTGGGAGGCCGAGGCGGGCAGATCACCAGAGGTGATCTCCAGCCTGGGCAGGAGAGCAAGACCCTGTCTCAAAAAATTTAGAAAAAGGAAAGAAA"
"GL873599","3943256","3943456","chr9","35892110","35892312","79","31948854","GGCAGGCTGCTTTGACCCATATCTACAACTCCAGAACTTTAGAGGCTGAGCTGGGTGGGTCCCTTGAGATTAGAAACTGCTTAGTAGCCTGGCAAAAACCAGACCCCACCTCCACCATGTAGAAAAATTAGCAGTATGCCATAGTGGGAACCTACCAATACAGTCTTTCCAAAGGCCAAAGCTAGAAGGACCGTGAGCTTG","GGCTGGGTGTGGTGGCTCATGCCTATAATTCCAGCACTTTGGGAGGCCGAGGCAGGTGGATCACCTGAGGCCAGGAGTTTGAGACCAGCCTGGCCAATATGGTGAAACCCCATCTCTACTAAAAGTACAGAAAATTAGTCAGTCATGATGGCGCATGCCTATAATCCCAGTTACTCGGGAGGCTAAGGTAGGAGAATTGCTTG"
"GL873599","6693284","6693349","chr1","100916857","100916922","15","94223573","TCACGTCTATAATCCTAGCACTCTGGGAGTCCTTGGCAGGTGGATCACCTGAGCTCAGGAGTTTGA","CATGCCTGTAATCCCAGCACCTTGGGAGGCCAAGGTGGGTGGATCACCTGAGGTCAGTAGTTTGAG"
"GL873600","991618","991705","chr15","13850109","13850195","15","12858491","GGCTGGGCGTGGTGGCTCACACCTGTTGTCCCAGCGCTGTGGGAGGCTGAGGCAGGTGGATCACCTGTGCTCAGAGGTTGAGACCAGC","GCCGGGCGCTGTGGCTCACACTTGTAATCCCAGCACTTTGGGAGGCTGAGGCAGGTGGATCACCTGAGGTCAGGAGTTAGAGACCAG"
"GL873600","8825981","8826014","chr16","43605817","43605844","11","34779836","AGTCTGGGGCAACAGAGCAAGACTCTGTCTCAAA","CAGTCTGGGTGACAGAGCAAGATTCCAT"
"GL873600","8826039","8826157","chr13","87428402","87428520","35","78602363","ATTAGCCTGGTGTGGTGGTATATGCCTTCCTGCCTGCTTGGGAGGCTGAGGCAGGAAGTATGCTTTAACTGTGGAGTCTGAGGTTGCTATGAGCTAGGTTGAGGCCATGGCACTCTAAA","TTAGCCGGGTGTGGTGGTGCACGCCTGTAATCCCAGCTACTCAGGAGGCTGAAGCAGGAGAGTTGCTTGAACCCAGGAGTTGGAGGTTGCAGTGAGCTGAGATCACGCCATTGCACTCC"
"GL873601","269289","269338","chr14","49279240","49279285","14","49009951","GACTGGGTGTGGTGGCTCACACCTTTAATCCTAACACCCTGGGAGGCTTA","GGCTGAGATGGTGGCACACACCTGTAATCCCAGCTACTTGGGAGGC"
"GL873601","269431","269678","chr1","184453273","184453521","76","184183842","AGAAGATCACTCAAGATCAGGAGTTTGAGAACAGCCTGAGCAAGACCCCCATCTTTACTAAAAATGGAAAAGTTTTTACCCAGGCATGGTAGTGCGTGCCTGTATCCCATCTACTCCGGAGGCTGATAGGAGGATTGCTTCAACCAAGGAGTTTGAGGTTCCAGAGACTTAAGATGACACAACTGCATTTTACCCAGTGTGACACAGCGAGACTCTTTCAGAAGAATTTTTAAAAGGAAAAAAAAGAA","GGTCAGATCACCTGAGGTCAGGAGTTTGAGACCAGCCTGACCAACATGGTAAAACCCCATCTCTGCTAAAAATACAAAAAATTAGCCAGGCATGGTGGTGAACGCCTGTAATCCTAGCTACTCAGGAGGCAAAGACAGGAGAATCGCTTGAATCTGGAAGGTGGAGGTTGCAATGAGCCAAGATGACGCCACTGCACTCCAACCTGGGTGACAGAGGAAGACTCCATCAAAAAAAAAAAAAAAAAAAAA"
"GL873601","1397978","1398117","chr16","24839455","24839591","34","23441477","GCCTATAATCCTAGCACTCTGGAAGGCTGAGGCAGGAAGATCACTAGAGCTTGGGAGTTTGAGATTGCTGTGAGGGAGACTGACTCCATGGCACTCTAGCCTGAGGCAACAGAGTAAGACTCCATCTCAAAAAAAAAAAA","CTCTAACTCCAGCTACTCAGGAGGCTGAAGCAGGAAAATCACTTGAACCTGGGAGGTGGAGGTTACAGTGAGCCAAGATCACACCATTGCACTCCAGCCTGAGCGACAGAGCGAGACTCTGTCTCAAAATAAATAAA"
"GL873601","4065502","4065590","chr11","108711352","108711444","19","104645850","GCTGGATGTGGTGGCTCTCACCTATAATCCTAGCACTCTGGGAGGTCAAAACAGGTGGATCACCTGAGCTCAGGAGCAAGAACACCAGC","GTCAGGGGTGGTGGCTCACGCCTGTAATCCCAGCACTTTGGGAGGCCAAGGCAGGTGGATCGCCTGAGCTCAGGAGTTCAAGACCAGCCTTGC"
"GL873601","8241370","8241465","chrY","9469734","9469829","34","1228364","AAAAAAGGTGGAGATGAGCCATGCGCAGTGGTGTAGGCCTGTAATCCCAGCCCTTGGGAGGCCAAAATGGTGGATTGCCTGAAGCAGAGCAAGACC","AAAGTACAAAGAGTCTGGGTACAGTGGCCCAAGCCTGTAATCCCAGCAGTTTGGGAGGACAAGATGGGTAGATCACCTGACATCATGAATTAGAGA"
"GL873569","7519122","7519191","chrX","79016364","79016431","16","71497242","TTGGCCAGGCATGGTCGCTCAGGCTGTAATACCAGCTACTTGGGAAGCTGAAGCAGGAGGATCACTTGAA","TTGGCCAGGCACGGTGGCTCATGCTTATAATCCCAGCTACTCGTGAGGCTGAGGCAGGGGAATCGCTT"
"GL873569","7989158","7989286","chr8","41505677","41505810","35","33516519","AGTCCCACCTATTTGGAAGGCTGAGGCAAGAGGATCACTTGAACTCAGCAGTTTGACATTGCTATGAGTTAGATTGACTCCATGGCACTCTAGCCCAGGCAACAGAGCAAGACTCCGTCTCAAAACAAA","TAATACCAGCTACGTGGGAGGCTGAGGCAGGAGAATCACTTGAACCCGGGAGGTGGAGGTTGCAGTGAGCTGAGATTGCACCGTTGCACTCTAACCTGGGCAACAAAAGCAAAACTCTGTCTCAAAAAAAAAAA"
"GL873569","7989575","7989702","chr1","62231025","62231129","47","54241450","GGCTGGGTAATGCAGTGGCTCACGCCTATAATCCTAGTGCTTTGAGAGGCCAAGAGTGAGACTCTGTGTACTAAAAATAGAAAAATTACCTAGGCATTCTGGTGGGCACCAGTAGTCCCACCTATTTG","GGCTGGGCATGGTGGCTCACGCCTATAATCCCAGCACTTTGGGAGGCCGAGGCAGGTGGATCACCTGAGATCAGGAGTTTGAGACCAGACTGGCCAACATGGTGA"
"GL873569","10034363","10034556","chr10","61268396","61268605","62","51234033","CAGCTTGAGCAAAAGTGAGCCCCTGTCTCTACTGAAAATAGAAAAAATTAGCCAGGCGTGGTGGCACACACTTATAGTCCCAGCCACTTAGGAGGCTGAGGCAGGAGTTTGAGGTTGACATAATCTAAGCTGATACCATAGCACTCTAGCCTGGGCAATAGAGTGAGACTCTGTCTCAAAGAAGAAATTTATCT","CCTGACCAATGGTGAAACCCTGTCTCTACCAAAAATACAAAATTTAGCTGGGCATGGGGGCACGCACCTGTAGTCCTAGCTACTCGGGAGGCTGAGACAGGAGAACTGCTTGAACTCGGGAGGCAGAGGTTGCAGTGAGCTGAGATCATGCCACTGCACTCTAGCCTGGGCAATAGAGTGAGACTCCGTCTCAAAAAAAAAAAAAAAAAA"
"GL873569","10034830","10034845","chr1","217667782","217667796","2","207632952","AAAAAAGAAGAAAAAA","AAGAAAAAGAAAAAA"
"GL873569","10203815","10203922","chr8","96374555","96374671","35","86170740","GCCAGGTGTAGTGGTTCACACCTATAATCCTAGCACTCTGGGAGCCTGAAGCAGGTAAATGGACTGAGCAAGAGTGAGACTTCCACCTCTATTGAAAATAGAAAAATT","GGCTAGGTATGGTGGCTGATGCCTATAATCCCAGAATTTTGGGAGGCCGAGGCAGGCAGATCATCTGAGGTCAGGAGTTTGAGACCAGTCCCGTCTCTACTAAAAATACAAAAATTA"
"GL873569","10204196","10204373","chr20","1304385","1304559","47","8899811","GAAAATAGAAAAATTAGCCAGGCATTATAGCAGGCACCAGTAATCCCAGTTACTTGGGAGGCTAAGGCAAAAGAATCTCTTGAGCCCAAGTTTGGGGTTGCTAGGAAGTAAAACACCACAGCACTATACCCAGAACAAGAGAGTGAAGACTCAGTCTCAAAAAGATAAATAAATAAAA","AAAAATACAAAAATTAGCCAGGCATGGTGGCGGGCGTCTGTAACTCCAGCTACTTGGGAGACTGAGGCAGGAGAATCGCTTGAACCCAGGAGGCAGAGGTTACAGGTGAAATCACACCACTGCACTCCAGCCTGGGCAACAGGGCAAGACTCTGTCTCAAAAAAAAAAAAAAAAA"
"GL873569","10473375","10473444","chr8","20660648","20660717","21","10187273","TGTAGTCCCAGCACTTTGGGAGGTTAAGGCAAGAGTAGCACCCAACATGAGGAGATCAAGACCAATCTGG","CTGTAGTCCCAGCACTTTGGGAGGCTGAGGCAGGTGGATCCTTTGAGGGCAGAACTTTAAGACCAGCCTG"
"GL873570","9287350","9287485","chr1","29437872","29437991","30","20150522","GGCCGGGCGTGGTGGCGCACGCCTGTAGTCCCAGCGCTATGGGAGGCCGAGGCGGGTGGATCACCTGTGCTCAGAGGTTCGAGACCAGCCAAGACCCCCCTGAGCCAAACGAGCCAGAGTGAGACCCCGTCTCTAC","GGCCGGGCGTGGTGGCTCACGCCTGTAATCCCAACATTTTGGGAGGCCAAGGCGGGTGGATCACCTGAGGTCAGAAGTTCGAGACCAACCTGGCCAACATGGTGAAACCCCTGTCTCTAC"
"GL873571","3669989","3670207","chr4","116777080","116777297","60","113107091","AGACCAGCCTGAGGAAGAGCAAGATCCCATCTCTATTAAAAATAGAAAAATTAGCCAGGCATTCTGGTGGGCACCTGTAGTTCTAACCACCTGGGAGGCTAAGGCAAGAGGAACTCTTCAACCCAAGAGTTTGAGGTTGCTGAGAGCTAGGCTAAGGCTGCAGCACTCTAGCCTGGGCAACAGAGTGAGACTGTTTCTCAAAAACAAAAAACAAAAAAA","CGAGACCAGCCTGGTCAATATGGTGAAACCCCGTCCCTACTAAAAATACAAAAATTAGCCAGGCATGGTGGCAGGCACCTGTAGTCCCAGCTACTCGGAAGGCTGAGGCAGGAGAATCGCTTGAACCACAGAGGCAGAGGTTGCAGTGAGCCGAGACTGCACCACTGCACTCCAGCCTGGGCGACAGAGTGAGACTCAGTCTCAAAAAAAAAAAAAAA"
"GL873571","106134","106236","chr4","18143723","18143826","27","18037589","GGCCAGTCTCAGTGGCTCACACCTGTAATCCAGCATTCTGGGAGGCTGAAGCACACGGTCACCTGAGCTCAAAGGTTGGAGACCAGAGTGAGACCCCACCTCT","GGCCAGGCGCAGTGGCTCACTCCTGTAATCCCAGCACTTTGAGGCTGAGGCAGGCGGATCACCTGAGGTCAGGAGTTTGAGACCAGCCTGGCCGAAACCCCATC"
"GL873571","3670496","3670589","chr7","50468399","50468491","15","46797903","GGGCAGGCATGGTGGCTCACACCTGTAATTCTAGCACTCTTGGAGGCTGAGGCAGGAAAATGGCTTGAGGTCAGGAGTTCAAGACCAGCCTGAG","GGCCAGTCATGGTTGCTCACACCTGTAATACCAGCACTTTGGGAGGCCGAGGCAGGCGAATCACCTGAAGTCAGGAGTTCAAGACCAGCCTGG"
"GL873571","4059090","4059389","chr7","52903696","52903994","88","48844606","GGCCAGGTGCAGTGGTTCACACTTATAATCCTAGCACTCTGGGAGGCCGAGGCGAGTGAAGTGCCTGAGCTCATGGGTTCAAGACCAACCTAAGCCAGAGACCCCTGACTCTTATAATAGCCTGGCATTGTGGTGGGCGCCAATATTTCCAGCTACTCTGAGGCTAAGGCAAGAGAATTGCTTGAGCCCAGGAGTTGGAGGTTTCTGTGAGCACTGACGCCGCAGCTCTCTACCAAGGGCAACAAAGACTCTGTCTCAAAAAATAAATAAATAAATAAATAACAGAATGAAAATGAAAAA","GGCCGGGTGCGGTGGTTCACGCCTGTAATCCCACCACTTTGGGAGGCTGAGGCAGGCAGGTCACCTGAGGTCAGGAGTTCCAGACCAGCCTGGCCAACATGGTGAAACCTTGTCTCGGCTATTAGCCTGGCATGGTGGTGCGTGCCCATAATCCCAGCTACTCAGGAGGCTGAGGCAGGAGAATCGCTTGAACCCAGAAGGTGGAGGTTGCAGTGAGCCAAGATAGCACCACTGCAACTCCAGTCTGGGCAACAGAATGAGACTCTGTCTCAAAAAAAAAAAACAAAAAACAAAAAGAA"
"GL873571","4209418","4209704","chr11","32517699","32517985","80","28308281","GGCTTGGCAAGGTGGCTTACACCTCAAATCCTAGCACTGTGGGAGACTGAGGCAGGTGGATTGTTTGAGCTCAGGAGGTCAAGATAGAGAGCAAGAGCAAGTCTCTGTCTCTACTAAAAATAGAAAAGAACTACTTCCCGGGGGTCATGGCAGTAGCCTGTAATCCCAGTTACTAGGTAGAATGAGGCAAGAGGATCTGTTGAAGCCAAGAGACTGAGGTTGTTATGAGCATGCCACAGCACTCTACCCAGGGTGACAGAATGAGACTCTGTTGAAAGAAAAAAAGA","GGCCGGGTGCAGTGGCTCACACCTGTAATCCCAGCACTTTGGGAGGCTGAGGCGGGTGGATCACCTGAGGTCAGGAGTTCAAGACCAGCCTGACAAACATAGTGAAACCCTGTCTCTACTGAAAATACAAAATTAGCCAGGTGTGGTGGCGCATGCCTGTAATCCCAGCTACTCGGGAGGCTGAGGCAGGAGAATTGCTTGAATCCAGGAGGTGGAGGTTGTGTGATCACACCACTGCACTCCAGCCTGGGCGACAGAGTGAGACTCTGTCTCAAAAAAAAAAGAAA"
"GL873571","4209985","4210154","chr3","175781758","175781928","60","171571773","GAAAGAAATGAAAAGAAAGAAGTTAGCTGGTTGTTGGGGTATGCTTCTATAGTCCCACCTACTCAGAAAGCTGAAATCTGGAGTTTGGGGTTGTTGTAAGGTAGGCTGATGACATAGCACTGTAGCTTGGGCAAGAGAGTGTGACTTTGTCTCAAAAAAAATTAAAACAA","ATTAAAAACACAAAGATTAGCCAGGTGTGATGGCACACAACTGTAATCCCAACTACTCAGGAGAATCGCTTGAACCTGGGAGATAGGGTTTGCAGTGAGCCAAGATTGTGCCACTGCACTCCAGCCTGGGTGACAGAGTGAGACTCTGTCTCCAAAAAAAAAAAAAAAAAA"
"GL873571","4210444","4210570","chr17","16655655","16655789","35","12445211","GCCAGGCAGATGGCTCACACTTCATCCTAGCCCTCTGGAAGGCTGAGGCAGGCTAATTTTTTGAGGTTAGGAGTTTGAGACCAGCCTGAGGAAGAGACCCATCTCTACTTTAAAAAATAAATGGAAA","GCCAGGCATGGTGGCTCACACCTGTAATCCTAGCACTTTGGGAGACTGAGGCGGGTGAATCACCTGAGGTCAGGAGTTTGAGACCAGCCTGACCAGTATGGTGAAACCCAGTCTCTACTAAAAATACAGAAATTA"
"GL873571","4391733","4391878","chr11","33723808","33723943","46","29332075","AACTTAGCTGGGAATGGTGGCTCAAGCCTGTAATCCTAGCACTCTGGGAGGCTCAGGTGGGAGGATCACTTGAGGTTGCTGTGAGCTTGGCTGATGCCAGGACACTCTAGTGTGGGCAAGAGAGTGAGACTCCGCCTCAACAACAA","GCCGGGTGCAGTGGCTCATACCTGTAATCCCAGCACTTTGGGAGGCTGAGGTAGGCGGATCACGAGGTCAGGAGCTGAGATGGCGCCACTGCACCCCAGCCTGGGTGACAGAGCAAGACTCTGTCTCAAAAAAAAA"
"GL873571","6307773","6307841","chr9","62429628","62429694","22","56121855","CTGGGTGTGGTGGCATTGCACCTGTAATCCTAGCTACTTGGAAATCTTAAGCCCAGGAGTTGAAGACTG","CCCAGCATGGTGGTGCATACCTATAATCTCAGCTACTTGGAGGCTTGAGCTCAGAAGTTTGAGACCG"
"GL873571","6496217","6496306","chr1","27257765","27257856","27","20761548","GCAGGGTGTGTTGACCCACACCCACAATTCCAGGACTCTGGGGGGCCAGGGATGGTGGGTTCCCTCAGATCAGGAGCTCCTTACCAGCCT","GACTGGGCATGATGGCTCAAATCTGTAATTCCAGCACTTTGGGAGGCCGAGGTGGGTGGATTGCCTGAGATCAGGAGTTCAAGACCAGCCTG"
"GL873571","6499738","6499903","chr1","38976375","38976555","47","32476637","AAAATAACATGAATTGACTAGGCGAGGTGGCTCACATCTCTAATCCTAGCACTCTGGGAGGCTGAGGCAGGAGAATTGCATGAGGTTGCTGTGAGCTATGATGATACCACGGCATTCTAATCAGGGTGACAGAGTGAGATTCTGTCTTAAAACAAACAAACAAAAA","AAAATAAATAAATTAGCAGGGCCTGGTGGCGCACACCTGTAATCCCAGCTACTTGGGAAGCTGAGGCAGGAGAACCCACTTGAACCTGGGAGCCGGAGGTTGCAGTGAGCTGAGATGGCACCACTGCACTCCAGACTGCGTGACAGAGTGAGACTCCGTCTCAAAAACAAACAAACAAAAA"
"GL873571","11399575","11399872","chr15","109458692","109458994","79","98059117","CAGTGGCTCACACCTGTAAATCTAACACTCTGGGAGGCCAAGGTGGGTGGATCCCTTGAGCTCAGGAATTTGATACCAGCCTGAGCAAGAGTGAGACCTTGTCTCTACTAATAATAGAAAAATAGCCCGTGTTGTGGCACTTGTCCCAACCACTGGGGAGGCTTTAGGCGGGAGGATTACTTGAATTGGGAGTTTGATATTGCTGTGAGCTGGGCTGATGCCTTGGCATTCTAGCTTGGGTAACAGCGTAAGACTCCGTCTCAAATAAATAAATAAATAAATAAAAAGAAAAAAAGAA","GTGGCTCACACCTGTAATCTCAGCACTTTGGGAGACCGAGGCAGGTGGATCACCTGAGGTCGGGAGTTTGAGACCAGCCTGACCAACGTGGAGAAACCCCGTCTCTACTAACAATACAAAATCAGCTGGGCGTGGTGGTGCATGCTTGTAATCCCAGCTACTCGGGAGGCTGAGGTAGGAGAATCGCTTGAACCTGGGAGGTGGAGGTTGCGGTGAGCCGAGATCGAGCCACTGCACTCCAGCCTGGGTGACAGAGCAAGACTCCATCTCAAAAAAAAAAAAAAAAAAAAAAAAAAAAAAAAA"
"GL873572","114760","114841","chr8","26280134","26280211","16","26165374","GGCCAGGCATGGCGGCTCTTCCCTGTAATCCTAGCACTCTGGGAGGGCGAGGCAGGCAGATCACCTAGGCTAGGGTGAGATC","GGCCAGGAATGGTGGCTCATGCCTGTAATCCCAGCACTTTGGGAGGCTGAGGCAGGCAGATCACCTGAGGTCAGGAGT"
"GL873572","9421791","9421892","chr11","8089184","8089269","35","1332607","TACTAAATATATAGCAAGGCCAGGCACAGTGGTTCATGGCTGTAATCCCAGTACTCTGGGAGGCCTAGTCAGAGTTGACCTGAGATCAGGCTAGAAGCCTGG","ATAAAAATAATTGGAGGCCAGGCACGGTGGCTCATGCTTGTAATTCTAGCAATTTGGGAGGCTGACGCGGGTGAGATCATACTGAG"
"GL873572","11052834","11053035","chr14","11857478","11857657","65","804644","TCCACAAAGAAAGCAGAAGTGTGGCCGGGTGGTAGCTCAAGGCAGGAATCCCAGCACTCTGGGAGCTGGGAGGTGGGGGAGGATCCCTTGAGATCAGGAGTTGGAGGGCACAGTGAGCCTGGGGGAGGCCACTGTCTCTGTACTCTAGCAGGGAGACAGAGCAAGACTGCCCATTCAAAGAAAAACAACAAACAAAACAAAA","TACAAAAATTAGCTGGGCACGGTGCCACAAGCCTGTAATCCCAGCTACTCGGGAGGCTGGGCAGGGGAATAGCTTGAACCCAGAGGTGGAGGTTGCAGTGAGCCAAGATCAAGCCACAGCACTCCAGCCTGGGTGACAGAGCAAGACTCCATCTCAAAAAAAAAAAAAAAAAAAAAAAAA"
"GL873573","2564195","2564244","chr1","109985445","109985491","12","107421250","TACAAAAATTAGGCTGGGCTTGGTGGTTCACGCCTATAATCCTAGCACTT","ACTAAAATTAGCTGGGCATGGTGGTGCATGCCTGTAATTCCAGCTAC"
"GL873573","7423371","7423533","chr2","202783328","202783513","56","195359957","GGTGGCTCACACCTGTAATCCCAGCACTCTGGGAGCCCTGGTGGCTCATGTCTATAATCCTAGTACTCTGGGAGACCATGGTGGCTCATGTCTATAATCCTAGTACTCTGGGAGCCATGGTGGCTCACGCCTATAATCCTAGTACTCTGGGAGACCATGGTGG","GGCTGAGGCGCGGGGGCTCACGCCTGTAATCCCAGCACTGTGGGAGGCCGAGGCGGGTGGATCACGCCTGTAATCCCAGCACTGTGGGAGGCCAAGGCGGGTGGATCACGCCTGTAATCCCAGCACTGTGGGAGGCCGAGGCGGGTGGATCACGCCTGTAATCCCAGCACTGTGGGAGGCTGAGGC"
"GL873573","9657648","9657710","chr19","10207852","10207913","10","550204","TAAAAATAAAAAATTTAGCTGGATGTGGTGGCTCACACCTGTAATCCTAGCACTCTGGGAGAC","TAAAAATACAAAATTAGCTGGGTGTGGTGGCACACACCTGTAATCCCAGCTACTCAAGAGGC"
"GL873574","1624662","1624783","chr9","814961","815079","36","809701","GACTGGGTGGGTTGGATCATGCCTGGAATCCTAGCACCCTGGGAGGCCAAGGTGAAAGGATTGCTTGAGGTTAGGAGTTCCAGAAATGTAGCAGTCATGGTGACTTCATCCTTCTCTACCAA","GGCTGGGTGCTTTGATTCATGCCTGTAATCCCAGCACTCTGGGAGGCCGAGGCAGGTGGATCACCTGAGGTTAGGAGTTCGAGACCAGCTTGGCTAACATGGTGAAACCTCGTCTCTAC"
"GL873574","4459477","4459612","chr1","29437872","29437991","29","24978395","GGCCGGGCGTGGTGGCGCACGCCTGTAGTCCCAGCGCTATGGGAGGCCGAGGCGGGTGGATCACCTGAGCTCAGAGGTTCGAGACCAGCCAAGACCCCCCTGAGCCAAACGAGCCAGAGTGAGACCCCGTCTCTAC","GGCCGGGCGTGGTGGCTCACGCCTGTAATCCCAACATTTTGGGAGGCCAAGGCGGGTGGATCACCTGAGGTCAGAAGTTCGAGACCAACCTGGCCAACATGGTGAAACCCCTGTCTCTAC"
"GL873574","4681987","4682216","chr6","153082888","153083127","73","148400901","GGGTGCGGTGGCTCAGACCTATAATCCCAGCACTCTGAGAGGCCGAAGTGGGTGGATCACCTGAGCTCAGGAATTTGAGACCAGCCGTCTCTAAAAATAGCTGAGTGTTGTGGCAGTGGCTGTAAGTCCCAGCTGTTTGGAAAGCTGAAGCAAGGGAATCACTTGAACCCAAGAGTTTGAGGTTGCTGTGATGACAAAGTGAGACTCTATCTCAAAAAAAAAAAAAAAAA","GGCCGTGCGCGGCGGCTCACGCCTGTAATCCCAGCACTTTGGGAGGCTGAGGTGGGTGGATCACCTGAGGTCAGGAGTTTGAGACCAGCCCGACCAGAAATTAGATGGGTGTGGTGGTGCGCTCCTGCAGCCCCAGCTACTTAAGAGGCTGAGGCAGGGTAATCACTTGAACCCGGGAGGCGGAGGTTGCAGTGAGCCGAGCTCACGCCACTGCACTCCAGCCTGGGTAACAGAGCGAGA"
"GL873574","4709916","4710039","chr19","13152422","13152536","46","8442506","AAAAATAGAAAAACTAGCCAAGCATGGTGGTGCACCCCCTATAGTCTGAGCTCCTCAGCGGGCTGAAGCAAAAGGACGGCTGGAGCCCTGGAGTTTGAGGTTGCTGTGAGGCAAGGTGATGCCA","ACACATAAATTAGCCAGACATGATGGTGAGTATCTGTAATTCCAGCTCCTTGGGGGGCTGAGGCGGGAGAATTGCTTGAACCTGGGAGGCAGAGATTGCAGTGAGCCAAGATCGC"
"GL873574","6353839","6353913","chr5","25768079","25768163","22","19414240","AAAAATATAGCAAGGCCAGGCATGGTGGCTCACACCTATAATCCCAGTACTTGGGAGCTGGAATTTGAACCTAGG","AAAAAACTCAAACAAGGCTGGGCGTGGTGGCTCACACCTGTAATCCCAGCACTTTGGGAGGCTGAGGTGGGTGGATCACCTGAGG"
"GL873574","6533061","6533332","chr5","85182161","85182439","81","78649100","GGCTGGGCGAGGTGGCTTACACCTATAATCCTAGTACTCTGGGAGGCCAAGGTGGGTGGATTGCCTGAGCGCACAGTTTCAAGACCAGCTGGAGCCAGAGAGAGAGAGAGAGACCCTGCCTCTAAAAATAGCCAGGCATTGTGGCAGGCACCTGTAGTCCCAGCTACTTGGCAGGCGGAGGTATGAGAATCGCTAGAGGTTGCTGTTAGCTATGATGCCATAGCACTCTACCAAGGGCGACAAAGTGAAACTCTGCCTCAAAAAAAAGAAGA","GCCAGGCGTGGTGACTCAAGCCTGTAATCCTAGCACTTTGGGAGGCCAAGGTGGGCGGATTGCCTGAGCTCAAGAGTTTGAGACCAGCCTGGGCAACACGGTGAAACCCAATCCCTACTAAATACAAAAAAAATTAGCCGGGTGTGGTGGTGTGAACCTGTAGTCCCAGCTACTCGGGAGGCTGAGGCAGGAGAAGGCAGAAGTTGCAGTGAGCCGAGATCACACCACTGCACTCCAGCCTGAGTGACAGAGCAAAACTCTTTCTCAAAAAAAAAAAAA"
"GL873574","6643746","6643907","chr2","92627944","92628105","46","85984198","AAATAGCCAGGCGTTGTGGCAGGCACCTATAGTCCCAGCTACTTGGGAGGCTGAGGCAAGAGAATCACTTAAGCCCAAGTGACAGAGGTTGCCAGGGCACTCTACGTAGGCAACAGAGTGAGACTCTATCTAAGAAAGAAGGAAGGAAGGAAGGAGAAAGAA","TTAGCCGAGCATTGTGGTGCGCGCCTGTAGTCCCAGCTACATGGGAGGCTGAGGCAGGAGAACACCTGAACCCAGGATGTGAGCTGAGTCGCGCCATTGCACTCCAGCCTGGGCAACAGAGTGAGACTCCATCTCAAAAATAAAATAAAATAAAATAAAAAA"
"GL873574","6644163","6644274","chr1","128607504","128607619","20","121963341","CTGTAATCCTAGCACTTGGGAGGCTGAGGCAGGTGGATCACCTGAGTTCAGGAGTTCAAGACCAGCCTAAACAAGAGTGAGACCCTATCTCTACTAAAAATAGAAAAAATAT","GCCTGTAATCCAAGCACTTTGGGAGGCTGAGGCGGGTGGATCACCTGAGGTCAGGTGTTCGAGACCAGCCTGGCCAACGTGGTGAAACCCCAACTCTACTAAAAATACAAAAATTA"
"GL873574","8511822","8512127","chr1","23439759","23440073","84","14927937","GGTGGCTGGTGCCTGTAATCCTAGCACTCTGGGAGACTGAGGCAGGTGGATCACTTGAAATCAGGAGTTTGAGATCAACCTGAGCAAGAGATCTTGTCTCTCCTAAAGATAGAAAAACTAGCTGGGATTTGTGGTGGACACCTGTAATTTCAGCTACTCAGGAAGCTAAGGCAAGAGCATTGCTTAAAACCAGGAGTTTGAAGTTGATGTGAGCTAGGATGTCAGGGCAGGTTACCCAGGGTGACAGAGTGAGACTCTGTGTCAAAATAAACAAACAAACAAACAAACAAAACAAAATAAAATAAA","GGCTGGACATGGTGACTCACGCTTGTAATCCCAACACTTTGGGAGGCTGAAGCAGGCAGATCACCTGAGGTCAGGAGTTTGAGACCAGCCTGACCAACATGGTGAAACCTTGTCTCTACTAAAAATACAAAAATTAGCTGGGAGCAGTGGTGCACACCTGTAATCCCAGCTACTCGGCAAGCTGAGGCAAGATAATTTTTTAAACCTGGGAGGTGGAGGTTGCAGTGAGCCAAGATCGTGCCACTGTACTCCAACCTGGGAGACAGAGCAAGACTCTGTCTCAAAAAAAAAAAAAAAAAAAAAAAAAAAAAAAAA"
"GL873575","2107336","2107519","chr4","38052972","38053149","54","35945636","TCAATTAAAAACTTTTTAAAATGAGGCTGAGCATGGTGGTTCACACCTGTAATCCCAGCACTTTGGGAGGCCGAGGCAGGAGGATCACCTGATCCCAGGAGTCCAAGCCTACAGTGAGCCGTGATAATACCACTGCACTTCAGCCCAAAGCCTCAAAAAGAAAAAAAAAAAAGGATAGACAAGA","TATATATATATATATTATTTTGGGGGGGCATGGTGGTGCACACCTGTAATCCCAGCTACTCGGGAGGCTGAGGCAGGAGAATTGCTTGAGCCCGGGAGGCAAAGGTTGCATTGAGCTGAGATCACACCACTGCACTCCAGCCTGGCGACAGAGTCTCAAAAAAAAGAAAAAATAAAAA"
"GL873575","5831824","5831959","chr1","29437872","29437991","28","23606048","GGCCGGGCGTGGTGGCGCACGCCTGTAGTCCCAGCGCTATGGGAGGCCAAGGCGGGTGGATCACCTGAGCTCAGAGGTTCGAGACCAGCCAAGACCCCCCTGAGCCAAACGAGCCAGAGTGAGACCCCGTCTCTAC","GGCCGGGCGTGGTGGCTCACGCCTGTAATCCCAACATTTTGGGAGGCCAAGGCGGGTGGATCACCTGAGGTCAGAAGTTCGAGACCAACCTGGCCAACATGGTGAAACCCCTGTCTCTAC"
"GL873575","7451097","7451208","chr3","122814630","122814743","22","115363533","GGCCAGGTGTGGTGGCTCACACCTGTTATCCTAGCACTCTGAGAGGCCACAGCAGCTGGATCACTTGAGCTCAGGAGTTCAAGACCAGTCTGAGCAAGAGCAAGACCTCACC","GGCTGGGTGTGGTGGCTCATGCCTGTAATCCCAGCACTTTGAAAGGCCAAGGCAGATGGATCACTTGAGGTCAGGAGTTCCAGACCAGCCTGGCCAACATGGCAAAACCCCATC"
"GL873575","7451277","7451445","chr6","58863249","58863409","41","51411972","AAAAATTCAGCCAGCCACAGTGGAAGTGGATGCCTGCCATCACAGCTACTCTGGGGGCTGGGGCAAGAGAATTGCTTGATCCCAGGAGTCTGAGGTTGCTGTGACCTAGGCTGACACCACAGCACTCTACCCAGGGTGACAGAGTGAGGCTGTGTTTAAAAAAAAAAAA","TTAGCCAGGCATGGTGGCACATGCCAGTAATCCCAGCTACTCAGGAGGATGAGGCAGGAGAATCGCTTGAACCCAGGAGGCAGAGGTTGCAGTGAGCTGAGATTGCGCCACAGCACTCTACCCTGGGTGACAGAAGGAGACTCTGTCTCAAAAAAAAAAAA"
"GL873576","1765109","1765185","chrX","53921180","53921256","12","52156071","GGCCAGGTGCAGTGGCTCATATCTGTAATCCTAGCACCCTGGGAGGCCAAGGTAGGCGAATCACCTGAGGCCAGGAG","GGCCAGGTGCAGTGGCTCACGCCTGTAATCCCAGCACTTTGGGAGGCCGAGGTGGGCGGATCACTTTAGGTCAGGAG"
"GL873576","2711577","2711895","chr7","6620384","6620702","85","3908807","GGTCGAGCTTGGTGGCTCATGCTTGTAATCCTAGCACTCTGGGAGGCCAAGGCAGGTAAGTTGCCCTGAGCTCATAGGTTCCAGATCAGCATGAGCCAGAGTGAGACCCTGTCTCTACCAAAAAATAGCCCGGCATTCTGGCAGGTGCCTGTAATCCCAGCTGCTTGGGAGGCTGAGGCTAGAGAATCACTTAAACCCAAGGGTTAGTGGAGGTTGCTGTGAGCTATGATTCCACCGTACTCTACTGAGGGCCACAAAGTGAGACTCTGTCTCCATAAAAAAGAAAGAAAGAAAGAAAGAAAAATAAAATAAAATAAAA","GGCCAGGCACAGTGGCTCATGTCTGTAATCCCAGCACTTTGGGAGGCCGAGGCGGGTGGATTACCTGAGGTCAGGAGTTCTAGACCAGCCTGGCCAACAAGGCGAAACCCTGTCTCTACTAAAAATACAAAAAATTAGCTGGGCGTTTTGGCACATGCCTGTAATCCCAGCTACTTGGGAGGCTGAGGCAGGAGAATTGCTTGAACTGGGGAAGTGGAGGTTGCAGTGAGCTGAGATCACACCATTGCACGCCTGAGCAACAGAGCGAGACTCTGTCTCAAAAAAAAAAAAAAAAAAAAAAAAGAAAAGAAAAAGAAAA"
"GL873576","4782520","4782652","chr9","61136941","61137074","22","56354421","CCAGGCACGGTGGCTCACCCTTGTAACCCTAGTACTTTGGGAGGCTGAGGTGGGAGGATCCCTTGAGGTCAGGAGTTCAAGACCAGCCTGAACAACAGTGAGACCCCCGTCTCTACTAAAAAATAGAAAAGTT","GCCAGGCACGGTGGCTCACGCCTGTAATCCCAGCACTTTGGGAGGCTGAAGCGGGCGGATCACCTGAGGTCAGGAGTTCAAGACCAGCCTGGGCACCATGATGAAACCCCGTCTCTATTAAAAATACAAAAATT"
"GL873576","4782930","4783078","chr7","57521645","57521803","40","52738715","AGTTAGTCTGGTGTCATGGTGGGTGCCTGTAGTCCCAGCTGCTTGGGAGGCTGAGGCAAGAGAATCACTTGAGCCCAGGAGTTGGAGGTTGCTATGAGCGAGGCTGTAGCCTAGGCAACAGAATGAGACTTTGCCTCAAAAAAATAAAA","TTAGCTGGGCATGGTGGCGCATGCCTGTAGTCCCAGCTACTTGGGAAGCTGAGGCAGGAGAATCACTTGAACCTGGGAGGTGGAGGTTGCAGTGAGCTGAGATCGCACCGCTACACGCCAGCCTGAGCAACAGAGAGAGACTCTGTCTCAAAAGAAAAA"
"GL873576","7828709","7828723","chr5","101042981","101042996","1","93214272","TAAATAAATAAAAAA","TAAATAAATAAATAAA"
"GL873576","7828960","7829230","chr13","49045537","49045844","89","41216577","GCCGGCTGCAGTGGCTATAATCCAAGTACCCTGGGAGGCTTAGGTGGATGGATCACTTGAGCTCAGAAGTTCAAGACCAGCCTCAGCAAGAGGTAGACCTTGCCTCTATTAAANNNNNNNNNNNNNNNNNNNNNNNNNNNNNNNNNNNNNNNNNNNNNNNNNNNNNNNNNNNNNNNNNNNNNNNNNNNNAGTTTGAGGTTGCTGTGAGCTATGATGAAGCCAGGGCATTCTACCCAGGGTGACAGAGTAACTCTTAAAAAAAACTAAACAA","GGCCAGGCAGAGTGGCTCATGCCTGTAATTCCAGCAATTTGGGAGGCCTAGGCAGGCAGATTACCTGAGGTCAGGAGTTTGAGACCAGCCTGGCCAACATGGTGAAACCCCGTCTCTTCTANNNNNNNNNNNNNNNNNNNNNNNNNNNNNNNNNNNNNNNNNNNNNNNNNNNNNNNNNNNNNNNNNNNNNNNNNNNNNNGGAGATAATAGCTTTTGTAGAACGAAGCGATGCAACAGCCAGATCGCCGCCACCACCCTTAGGTCCTGGCGACAGAGTGAGATCCATCTTAAAAAAAAAAAAAAAAAAA"
"GL873576","10622840","10623093","chr7","60266447","60266705","74","49643607","GCTGGGTATGGTGGTTCACACCTATAATCCTAGCACTCTGGGAGGCTGAGGTGGGAGGATTGGTGGAGCTCAGGAGCTCATGAGGTGCCAAATCACTGGTGCCACACACCTGTATTCCCAGCTACTGAGGAGGCTGAGGCAGGAGGATCAGGTAAGCCCAGGAAGTTTGAGGTTGTAGTGAGTTAGGATGATTGAACTCTGCCTTGAGAGACAGAGCAAGATCCTCCTTCCTCCTAAGCAAACAAACAAATAAA","GGCTGGGTGCAGTGGCTCACACCTGTAATCCTAGCACTTTGGGAGGCTGAGGCGGGAAAATTGCCTGAGCTCAGGAGTTCAAGGACAGCCTAGGCAACATAGCATGGTGGTGCACGCCTGTATTCCCTGCTACTTGGGAGGCTGAGGCACAAGAATTGCTTGAATCCGGGAAGTGGAGGTTGCAGTGAGCCATTGTGGCACTGCTCTCCAGTCTGGGTGACAGAGCAAGACTCCATCTCAAAAAAAAAAAAAAAAAAAA"
"GL873576","10819939","10820007","chrX","67133632","67133707","21","56313693","AGGTTGCAGTGAAATTGTACCATTCCAATGAAGCCTGGGGGACAGAGTGAGATTCTCTCAAAATAAAAA","GGAGGTTGCAGTGAACCGAGATCGTGCCACTGCACTCCAGCCTGAGCGACAGAGTGAAACTTCGTCTCAAAAAAAA"
"GL873576","10920306","10920363","chr3","48261745","48261808","16","37341439","GCTGGACCTTGTAGAGAGTGCCTGTAATCCCAGCTACATGGGGGGCAAGAGAATTGCT","GCTGGGCATGGTGGTGCATGCCTGTGATCCCAGCTACTCAGGAGGCTGAGGCAGGAGAATTGCT"
"GL873576","10920398","10920529","chr10","67341428","67341546","30","56421030","GGCCAGGCGTGGTGGCTCACGCCTGTTGTCCCAGCACTGTGGGAGGCCGAGGTGGGTGGATTGCCTGAGCTCAGAGGAGTCCGGAAGACCAGCATGAGGCAGAGTGAGCCAGAGTAAGATCCTGTCTCTACC","GGCTGGGTGTAGTGGCTCATGCCTGTAATCCCAGCACTTTAGGAGGCCAAGGTGGATGGATTGCCTGAGCTCAGGAGTTCGAGACCACCCTGGGCAACAAGCCAAAACCCTGTCTCTAC"
"GL873577","515809","515961","chr7","137660778","137660931","43","137144969","AGCTGGGCATGGTGGCTCATGCCTATAACCCTAGCGTGCTAGGAGATTGCTTGTCAGGAGACTGAGGTTGCAGGAAACTGTGATGATGGCACTGCACTCTACCCAGGGTGACAGAGCAGGACTCTGCCTCAAAAAAAAAAAAAAAAATAGAAA","TTAGCTGGGCATGGTGGCGCATGCCTATAATCCCAGCTACTTGGGAGGCTGAGGCAAGAGAATCGCTTGAACCGGGGAGGCAGAGGTTGCAGACTGCACTCCAGCCTGTGTGACAGAGTGGGACTCCGTCTCAAAAAAAAAAAAAAAAAAAAAA"
"GL873577","1633164","1633256","chrX","38269524","38269615","26","36636360","TCAGCCAGGCATGGTGGCACTTGCCTATAAACCCAGCTCCTTGGGAAGCTGAGCCGGGAGGATCCCTTGCACCCAGGAGCAACGGAAGGCAGT","AATTAGCCAGGCATGGTGGCACATGCCTATAATCCCAGCTACTCAGAAGGTTGAGGCAGGAGAATCACTTGAACCTGGGAGGCAGAGGTTGC"
"GL873577","3979502","3979560","chr20","68909283","68909346","13","64929781","GAGTTTGAGACCAGCCTGAGCAAGACCGAGACCCAGTCTCTACTAAAAATAGAAAAATT","GGAGTTCAAGACCAGCCTGACCAACATGGAGAAACCCTGTCTCTACTAAAAAATACAAAAATTA"
"GL873577","3979839","3980009","chr10","31403126","31403287","39","27423287","ATGAGCAGATTGTCTTGGTGGGCACCTGTAGTCCCAGCTATTGGAGGTGGGAGGCTGAAGCAGGAAAATCTCTTGAGCCCAGGAGTTTGAGGTTGCTGTGAGCTAGGCTGACACCACGGCACTCTAGTCAGGGCGTCAGAGTGAGACTCCGTCTCAAAAAAAAAAAAAAAA","TTAGCTGAGTGTGGTGGCGCACATCTGTACTCCCAGCTATTTGGGAGGCTGAGGCAGGAAAATCGCTTGAACCCAGGAGGTGGAGGTTGCAGTGAGCCAAGATCACACTACTGCACTCCAGCCTGGGTGACAGAGTGAGAATCCATCTCAAAAAAAAGAAAA"
"GL873577","6050882","6051080","chr1","153219820","153220007","59","147168938","GGCTGGGCGTTGTGACTCATGCCTGTAATCCCAGCACTCTAGGAGGCCGAGGTGGGTGGACTGCCTGAACTCAGAGGTTTAAGACCATCCTGAGCCGCAGTGAGCCAGAGCGAGACCCTGTCTCTACCAAAAAAAGCTGGGTGTTGTGGTGGGCGCCTATAGTCCTAGCTACTTGAGGCGCTAAGGGTAAAAAAATTGC","GGCCTGGCACAATGGCTCACGCCTGTAATCCTAGCACTTTGGGAGGCCGGGGTGGGTGGATCACCTGAGATCAGGAGTTTGAGACCAGCCTGGCCAACATGGTGAAACTCCTTCTCTACAAAAATTAGCCAGGTGTGGTGGTGGGTACCTGCAATCCCAGCTATTTGGGAGGCTGAGGCAGGAGAATC"
"GL873577","8463965","8464050","chr9","52134422","52134508","19","43670457","CTGGGTGCTATAGCTCACGCCTATAATCCTAGCACTCTGGGAGTTTGGGGCAAATGGATCACCTAGGCTCAGGAGTTTGATACCAG","GGCTGGGAGCAGTGACTCACGCCTATAATCCCAGCACTTTGGGAGGCTGAGGCAGATGGATCACCTGAAGTCAGGAGTTCGAGACCA"
"GL873577","9471486","9471613","chr16","5178790","5178910","46","4292696","TTAGCCAGGCATAGTAGCCTGTGTGTAGTCCTAGCTACTCAGGAGGCTGAGGTAGATGGGTCACTTGAGGTTGCAGAGATTATGGTAATGTCACTGTACTCTAGCCCTGGCAACAGAGCACAACCCTG","TTAGCCGAGCCTGGTGGCATAAACCTGTAATCCCAGCTACTCAGGAGGCTGAGGCAGGGGAATTGCTTGAACCTGAGAGGAGAAGGTTGCAGTGAGCCGAGATTGCACCATTGCACCCCAG"
"GL873577","9471875","9471998","chr7","17832200","17832315","36","8360325","GGCCAGGTGAAGCAGCTCATGGCTATAATCCTAGCAGTTTGGCAGGCCAAGGTGGGAGGACTGCTTGAGGTCAAGAGTTCAAGACCAACCCATCTTTGCGAAAAATTTAAAAATTACCTAGGCA","GCCAGGAGAGGTGGCTCATGCCTCTAATCCCAGCACTCTGGAAATCCAAGGTGGGTGGATCACCTGAGGTCAGGAATTCCAGACCAGTCTGGCCAATATAAAAAATTAGCCAGGCT"
"GL873577","9853150","9853170","chr3","85044647","85044667","3","75191497","AAACAAACAAACAAAAAAAGA","CAAACAAACAAACAAACAAAA"
"GL873577","9853206","9853473","chr7","130818682","130818963","67","120965476","GCTGGGCGCAGCGTCTCACTCCTGTAATCCCAGCACTTGGGAGGCCAAGGTGAGTGGATTGCCTGAGTTTACAGTTTCGAGACCAGCCTGAGCCAAAGCGAGACCCCCATCTCTAAAAAATAGCTGGGCATTGTGGTGGGCACCTGTAGTCCCAGCTACTTGGGAGGCTGAGGCAAGAGGATCGCTTGAACCTAAGAGTTTGAGGTTGCTGTGAGCTAAGGCTCCATGGCATTCTACCAAGGGTGACTAAGTGAGACTCTGTCTAAAA","GCCGGGCACAGTGGCTCACACCTGTAATCCCAGTACTTTGGGAGGCCAAGGTGGGTGGATCACCTGAGGTCAGGAGTTTGAGACCAGCCTGGCCAACATAGTGAAACTCTACTAAAAATACAAAAAAATAGCTAGGCATGGTGGTGCGCACCTGTAATCCCAGCTACTTGGGAGGCTGAGGCAGGAGAGTTGCTTGAACCCAGCGGGGTTGAGGTTGCAGTGAGTTAAGATCAAGCCACTGTGCTCCAGCCTGGATGACAGAGAGAGACTCCATCTCAAAAA"
"GL873577","10722415","10722478","chr10","12501471","12501539","23","1779056","AATAAAAAAATGCTGGGTACAGTAGTACATGCCTGTACTCTCATCTGGGGAAGCTGAGGCATGA","AAAGTAAAAAATTAGAGCTGGGCATGGTGGCACACACCTGTAATCCCAGTCACTAGGGATGCTGAGGCA"
"GL873578","463331","463568","chr10","28935382","28935620","93","28472051","CAGGTGCTTTGACCCACACCCTCAACTCTAGGACTTTGGACGCCCTGGCTGGGTGGGTCCTTTAAAGTCAGGAGCTTCTTATCAGTCTGGGCAAAAGTGAGACCCCATCTCTACCAAACAAAGAAAGAAATCAGCAGTATGTTGCAGTAGAGACTCACCAATACCTTCTTTCAAAGACCAAAGCTGGAAGGACACTAAAGACCATGATCTCATGGCCTCCCTGAGCCATGACAATGCC","CCAGGTGCAGTGGCTCATGCCTGCAAGCTCAGAACTTTGGGAGGCAGAGGTGAGCAGACTGCCTGAGTTCAGGAGTTCAAGACCAGCTGGGCAACATGGTGAGACCCTATCTCTACTAAAAATACAAATAATTAGCAGGGTGTGGTAGCACACACCTGTAGTCCAGCTACTCAGGAGGCTGAGGCAGGAGAATTGCTTGAACCCAGGAGGCAGAGTTTGCAGTGAGCCAGGACTGGGCC"
"GL873578","1143712","1143827","chr11","52824583","52824692","30","51680871","GGCTGGGTGTGGTGCCTCATGCCTGTAATCTAAGCCCTCTCCGAGGCTGAGGTGGGAGGATCCCTTGAGTTTAGGAGTTTGATTTTGAGACCAGCCTGATCAAGAGAGAGACCTCA","GGCCGGGTGTGGTGGCTCATGTCTGTAATCCCAGCACTTTGGGAGGCTGAGGTGGGTGGATACCCTGAGGTCGGGAGCTCGAGACCAGCCTGACCAACATGGAGAAACCC"
"GL873578","1144101","1144139","chr3","33494224","33494257","11","32350123","GAGAGAGACCTCATGTCTACTAAAATAAATAAATATATA","GTGAAACCCGTCTCTACTAAAAATACAAAAATTA"
"GL873578","1144175","1144343","chr12","119519961","119520131","41","118375786","ATTATCCAGGCCTTCTGGTGGATGCCTGTAGTCCTAGCTACTAGAAAAGCTGGAGCAGAATCACTTGACCCAGGAGCTGGAGGTTGCAGGGAGCTAGGCTGATGCCACAGAATTCTAGCCTGAGGCAAAAGAATTGAGCCACTGTCTCAAAAAGGAACAAAAAAGAAAA","ATTAGCCAGGTGTGGTGGCATGCACTTGTAATCCCAGCTACTAAGAAGGCTGAGGCAGGAGGATCACTTGAACCCGGGAGGTGGAGGTTGCAGTGAGCCAAGATCATGCCACTGCACTCCAGCCTGGGCAACAGAGTAAGACTCTGTCTCAAAAAAAAAAAAAAAAAAAAA"
"GL873578","4593962","4594035","chr16","68825055","68825124","22","64231093","AGCTGGGTACAGTGGCTCACATATAATCCCAGTGACTCAGGAGGCTAAGACAGGAGGATTACTAGGACCTGAGA","GGCTGGGCACAGTGGCTCAGACCTGTAATCTCAGTACTTTGGGTGGCTGAGGCAGGTGGATCACCTGAGG"
"GL873578","6158845","6158972","chr3","500432","500562","24","5658413","GACATGGTGGCTCACACCTGTAATCCTAGCCCTCTGGGAGGCTGAGGCAGGTGGATCACTTGAGTTCAGGAATTCAAGACCAGCTTGAGTGAGAGCAAGACCCTGTCTCTACTAAAAATAGAAAAATT","GCACGGAGGCTCATACCTGTAATCCCAGCACTTTGGGAGGCTGAGGCAGGTGGATCACCTGAGGTCAGGAGTTCCAGACCAGCCTGGCCAACATGGCGAAACCCTGTCTCTACTAAAAATACAAAAAATCT"
"GL873578","6159253","6159444","chr19","34496349","34496541","55","28337096","ATAAAATAAAAATAGAAAAATTAGCCAGGCATTGTGGCAGACATGCGAAGTCTCAGCTACTCCAGAGGCTGAGACAGGAAGATTACTTGAGCCCAAGAATCTTGCTGTGAGCTAAGCTGATGCCATAGCATTGTAACCTAGGCAACAGAGTAAGACTTGGCCTCAAAAATAAAATAAAATAATAAAGTAAAA","TTAGTTAATTAAATTAAACTTAGCTAGGCATAGTGGAACACACCCATAGTCCCAGCTACTCTAGAGGCTGAGGCAGGAGGATTGCTTGAGCCAAGTTGGAGGCTGCAGTGAGCTATGGTGGTGCCACTGCATTCCAGCCTCAGTGACAGAGAGAGACCCTGGCTCAAATAATAATAATAAATAAATAAATAAA"
"GL873578","6766040","6766171","chr2","93098086","93098217","30","86332046","CCAGGCACAGTGGCTCATGCCTATAATCCTAGTAGTCTAGGAGGCTGAGGTGAGTGCATTGCTTGAGCTCAGGAGTTAGATACCAGCCTAACCAAGAATGAGACCCCATCTCTATTAAAAATAGAAAAGTTA","GCCGGGCACAGTGGCTCATGCCTGTAATCCCAGCACTTTGGGAGGCCGAGGCGGGCAAATCACGAGGTCAGGAGTTCAAGACCAGCCTGACCAATATGATGAAACCCCGTCTCTATTAAAAATACAAAAATT"
"GL873578","6766434","6766577","chr9","21128084","21128223","50","14361650","GTTAGCCAGGAGTTGTGGCGGGCACCTACAGTCCTAGCGACTCAGGAGGCTGAAGTAGGCAGAGTTTGATGTGTTGCTGTGAACTACAAGGACACCAATGCACTCTAGGCCGGTAACAGAGTGAGACACTGACTAAAAAAAAAA","TTAGCCAGGTGTGGTGGCACATGCCTGTATTTCCAGCTACTCGGGAGGCTGAGGCAGGAGAATTGCGTGAGCTGAGATCATGCCACTTCATTCCAGTCTGGGTGACAGAGTGAGACTCTGCCTCAAAAAACAAAACAAAA"
"GL873578","7397948","7398119","chr5","40230148","40230319","43","32832200","TAAAAATAGCCATGCATTGTGACAGGCACCTGTAGTCCCAGCTACTCAGGAGGTTGAGGTAAGAGAATCACTTGAACCCAAGAGTTTTGAGGTTGTTATGAGCTAAGACGCCTCGGGACTCTACAAAAGGTAACAAAGTGAGACTCTGTCTCATAAAAAAAGAAAAAAAGAA","AAAATTAGCCAGGCATGGTGACGTACACCTGTAGTCCCAGCTACTCGGGAGGCTAAGGCAAGAGAATCGCTTGAACCCAGGAGGCAGAGGTTGCAGTGAGCTTAGATCACGCTACTGCGCTCCAGCCTGGGTGACGGAGTGAGACGCCATCTCAAAAAAAAAAAAAAAAAAA"
"GL873578","7398378","7398515","chr15","102382935","102383070","35","94984557","GGTCGAGCAAGGTGGCTCACGCCTGTAATCCTAGCACTCTGTGAGGCTGAGGCAGATGGATTGCCTGAGCTCGTGGGTTCGAGACCAGCCTGAGCCAGAGTGAGACCTCATCTCTAAAAATAGCTGGGAAGCTGGGCA","GGCCAGGTGTGGTGGCTCACGCCTGTAATCCTAGCACTTTGGGAGGCTGAGGCGGGTGGATTGCCTGAACTCAGGAGGTCAAGACCAGCCTGGGCAACACAGTAAAACCCCATCTCTACTAAAATACAAAAAATCA"
"GL873579","370235","370429","chr16","38067345","38067552","57","37697110","GCACAGGCCTGAAATCCTAGCACTCTGAAAGGCCAACGGAGGAGAATTTCTGGAGCTCAGGAGTTTGATACCAGCCTAAGCAAATAAAGCTAGACCTCTATCTCTACTAAAATTAGAAAAATTAGGCAGATGTGGTGGTAGGCACCTATAGTCCCAATTACTCCAGAGGCTGAGGCAGAAAGACTCTTGAACCCA","GTCAGGCATGGTGGCTCATGCCTATAATCCTAGCACTTTGGGAGGCCAAGGCCGGTGGATCACCTGAGGTCAGGAGTTTGAGACCAGCCTGGCCAATATGGCAAAACCCCGTCTCTACTAAAAATAAAAAAATTAGCTGGGCACGGTGGTGGGCACCTATAGTCCCAGCTACTCAGGAGGCTGAGGCAGGAGAATTGCTTGAACCCAG"
"GL873579","370936","371046","chr3","3847698","3847802","33","3476762","TGACTCTTGAACCCAGGCACATGAGGTTGCTAAGAGTCTAGGCTGATGTCACGGCACTCTAACCTGGGAAACAGTGTGAGGTTCTGCCTCAATAAATAAATAAATAAATAA","TGGCTTGAACCCAGGAGGCGGAGGTTGCAGTGAGCCGAGATCACGCCACTGCACTCCAGCCTGGGCAACAGAGCGAGACTGTCTCAAAAAAAAAAAAAAAAAAAA"
"GL873579","599436","599605","chr10","38982686","38982853","41","38383250","AAAAAGTCAGACATTGTGGCAGGTGTCTGTAATCCCAGCTATTTGGGAGGCTGAGGCAGGAGTATCATTTGAACCCACGAGTCTGAGGTAACTGTGAGCTAGGCTAACACAACAGCACTCTAGCCTGGGCAATAGAATGAGACTCTATCAAGAAAAGAAATGAAAAGAAA","TATTAGCCTGACACAGTGGCGCGCATCTGTAATCCCAGCTACTTGGGAGGCTGAGGCAGGAGAATCACTTGAACCCAGGAGGCGGAGGTTGCTGTGGGCTGAGATCATGCCACTGCACTCCAGCCTGGGCAACAGAGGGAGGCTCCATCTCAAAAAAAAAAAAAAAAA"
"GL873579","599942","599953","chr3","71473700","71473710","4","70873758","TTTTAAAATAGT","TTTAAAAAAAA"
"GL873579","600232","600365","chr1","16061315","16061447","30","15461083","GGCTAGGCAAGGTGACTCATGTCTGTAATCCTAGTACTCTGGGAGGTTTGAGGCAGGAAGACCACTTTAGCTCAAGAGTTCCAGATCAGCCTGTGCAAGAGTGATACATCATCTCTACTAAAAATCAAAAATTA","GGCTGGGCATGGTGGCTCATGCCTGTAATCCTAGCACTTTGGGAGGTTGAGGCAGGCAGATCACTTGAGGTCAGGAATCTGAGACTAGCCTGGCCAACATGGTGAAACTCCATCTCTACTAAAAAAAAAAAAA"
"GL873579","5650320","5650591","chr6","54938866","54939145","71","49288546","GTCAGGTGTGTTAGCTTACAGTAGTAATCCTAGCACTTTGGGAGGTTGAAGTGGGTGGATTGCTTGAGCTCAGGGGTTCAAGACCAGCCTGAACAAGAGTGGGACCTCATCTCTATTAAAAACAGAAAAACTAGCTGGGTGTTATGGTGGGTGTCTGTAGCCCCAGCTACTCAGGAGGCTGAGGCAGGAGGTTGAGGTTGCTGTGAGCTATTGAGACCACAGCACTCTATCCAGGGCAACAGAGTGAGACCCCTCCCCCCCCCAAAAAAAAA","GGCCAGGTGTGGTGGCTCACGCCTGTAATCCCAACACTTTGGGAGGCCGAGGTGGGTGGATCACCTGAGATCAGGAGTTCAAGACCACCCTGGCCAACATGGTGAAACCCCGTCTCTACTAAAAATACGAAAATTAGCTGAGTGTGGTGGTGCATGCCTGTAGTCCCAGCTACTCAAGAGGCTGAGGCAGGAGGTGGAGGTTGCAGTGAGCCGAGATTGCATCACTGCACTCCAGCCTTGGCGACAGAACGAGAGAGACTCCATCTAAAAAAAAAAAAAA"
"GL873579","7037162","7037347","chr3","37328686","37328893","67","30291524","GAGGTGGGTGGATTGCCTGAGCTCACAGGTTGGAGACCAGCCTGAGCCAGAGCAAGACCTTATCTCAAAAAATAGCCAGGTGTTGTGGCTGGCACCTGTAGTCCCAGCTGCTCAGGAGGCGGAGGCAAGAGAAATGCTTGACCTCAGGAGTTTGAGGTTGCTGTGAGTTCAACTCACACTAATACA","GAGGCAGGGGGATCACCTGAGGTCAGGAGATCGAGACCAGCCTGGCCAACATGGTGAAAACCTGTCTCTACTAAAAATCCAAAAACATTAGCCAGGTGTGGTGGCACGCACCTGTAATCCCAGCTACTTGGGAGGCTGAGGCAGGAGAATCACTTGAACCTGGGAGGCAGAGGTTGTAGCGAGCCGAGATCACACCACTGCACCCCAG"
"GL873579","11077764","11077972","chr19","1200469","1200683","63","9877295","GCCAGGTGCAGTGGCTCATGCCTATAATCCTAGCACCCTAGGAGGCTGAGGAGTTCAAGACCAGCCTAAGCAACTGTGAGACCCCATCTCTACCAAAAATAGAAAAATTAGCTGACTGTTATGGTGTGCACCTACAGTCCTAGCTACTCAGGAGGCTGAGGCAGAAAGAGTCCTTGAACCCAGGAGGCTTTTTTTTGTTGTTGTTGTTG","GGCCAGTCGCGGTAGCTCATGCCTGTAATCCCAGCACTTTGGGAGGCCGAGGCGGGCAGATCACCTGAGACCAGCCTGGCAACATGGTGAAACCCCATGTCTACCCAAACTACAAAAATTAGCTGGGTGTGGTGGTGCACGCCTGTAATCCGAGCTACTCAGCAGGCTGAGGCAGGAGAATCCCTTGAACCTGGGAGGCAGAGGCTGCAGTGAGC"
"GL873579","11078245","11078333","chr19","4926258","4926351","22","6151987","TGAACCCAGGAGTTTGAGTTCGCTGTGAGCTAAGCTGAGGCCACAGCACTCCAGCCTGGGCAACAGAGTGAAAGGAAAAAAATAAAAAA","TGAACCCGGGAGGTGGAGGTTGCAGTGAGCCAAGATCACACCAATGCACTCCAGCCTGGGCAACAAGAGTGAAACTCTGTCTAAAAAAAAAAAA"
"GL873580","320374","320488","chr13","48549305","48549409","42","48228931","GGTAGTGCGTGCCTGCATTCCCAGCTACGGGAGGGCAGGGACTTGAGGCCAGCCTGGGCAAAATAATGAGACCTACTAATGACTCTACTAATACAGAAACAATTAGCTAGGTATG","TGGGAGGCCGAAGTGCGCAGATCACCTGAGGTCAGAAGTTGGAGACCAGCCTGGCCAACATGGTGAAAACCCATCTCTACTAAAAATACAAAAATTAGCTGGGCA"
"GL873580","374969","375091","chr6","147681010","147681135","27","147306041","CGGTGGCTCACACCTATAATCCTAGCATTTTGGAAGGCTGAAGCCGAGGATCTCTGGAAGTCAGAAGTTCAAGACCAGCCTGCCCAAGAGCAAGACCCCATCTCTACTAAAAATAGAAAAACT","GGTGGCTCACACCTGTAATCCCAGCATTTTGGGAGGCTGAGGCAGGCGGATAATCTGAGGTCAAGAATTTGAGACCAGCCTGGCCAACATGGAGAAACCCTATCTCTACTAAAAATACAAAATTAC"
"GL873580","375369","375549","chr7","19977275","19977456","44","19601906","CTAACCAAGTTAGTTAGTTTTAGTTGGCAGGTGCCTGTAGTCCCAGCTCCTTGGGAGGCTGAGGCAAGAGAATGGCTTGAGCCCAGGACTTTGAAGTTGCTGTGAGCTATAATGACACCACAGCACACTACCCAGGGTGACAGAGTGAGACTGTCTCAAAAAAACAAACAAACAAAAAAAA","AACAAACGTTAGCCGAGCATGGTGGTATGTGCCTGTAGTCCCAGCTACTTGGGAGTCTAAGGCAGGAGAATTACTTGAGCCCGGGAGGCAGAGGTTGCTGTGAGCCAAGATCACGCCACTGCACTCCAGCCTGGGTGACAGAGTGAGACTCCATCTCAAAAAAAAAAAAGGAAAAAAAAAAA"
"GL873580","8760922","8761015","chr11","104681322","104681416","19","95920400","GGAGGGAGACACTGCAGTGAACTGCGATCGTGTCTCTGCTTTCCAGGCTGGGTGACAGAGTGAGACTCGGTCTCTAAAATAAAAAATAAATAAA","GGAGACGGAGGTTGCAGTGAGCTGTGATCGCGGCACTGCACTCCAGCCTGGGCAACAGAGTGAGACTCTGTCTCAAAAATAAATAAATAAATAAA"
"GL873580","9391260","9391306","chr14","49279240","49279285","12","39887980","GCCAGTCGAGGTGGCTCACACTTGTGATTCCAGCTACTTGGAAGACT","GGCTGAGATGGTGGCACACACCTGTAATCCCAGCTACTTGGGAGGC"
"GL873581","759283","759365","chr6","46535476","46535542","30","45776193","TAAGAACCTGAAAATAGAGCCAGGCATAGTGGTACATGCGTATAGTCCTGGCTACTCAGGAGGTTGAAACAACAGGATTACTT","CAAAATAGCCAGGCTTGGTGGTGCATGCCTATAATCCAAGCTACTCGGGAAGCTGAGGCAGGAGAAT"
"GL873581","1145844","1145979","chr1","29437872","29437991","29","28292028","GGCCGGGCGTGGTGGCTCACGCCTGTAGTCCCAGCACTATGGGAGGCCGAGGCGGGTGGATCACCTGTGCTCAGAGGTTCGAGACCAGCCAAGACCCCCCTGAGCCAAATGAGCCAGAGTGAGACCCCGTCTCTAC","GGCCGGGCGTGGTGGCTCACGCCTGTAATCCCAACATTTTGGGAGGCCAAGGCGGGTGGATCACCTGAGGTCAGAAGTTCGAGACCAACCTGGCCAACATGGTGAAACCCCTGTCTCTAC"
"GL873581","9628238","9628362","chr5","141044567","141044691","34","131416329","ATCCCAGGTAGTCGGGAGGCTGAGGCAGGAGGATCACTTGAACCCAGGAGGTTGAGGTTGCTGTGAGCAAGGCAGAGGCAACGGCACTCTAGCCACGGGGGCACAGAGACTCTTGTCTTTAAAAA","TAATCTCAGCTACTCGGGAGGCTGAGGCAGGAGAATCGCTTGAGCCCAGAAGGTGGAGGTTGCAGTGAGCCAAGATCGCGCCATTGCACTCCAGCCTGGGCGACAGTGCGAGACTCTGTCTCAAA"
"GL873582","1580485","1580534","chr6","32576760","32576806","12","30996275","CAGCACTTGAGAGGCCAAGGCAGGTGGATCAACTGAGCAAGAATGAGACC","CCAGCACCTTGAGAGGCCAAGGCAGGTGGATCACCTGAGGTCAGGAG"
"GL873582","1644368","1644551","chr1","211626449","211626612","63","209982081","AAAATTTGCCGGGCTCCATAGCTCATGCATGTAATCATAGCACTCTGGGAGGCCAAGATGGGAGGATCTCTCAAGCTCTCTTACTTGGGAGGCTGAGGTTGCTGTGAGTTAGGCTTACGCCACAGCACTCTACTCTAGCGTGAGCAACTCTACTCTTAGTATGAGACTGTCTCAAAAGAAAAAA","AAATTAGCCAGGCGTCGTGGCACATGCCTGTAATCCCAGCTACTCGGGAGGCTGAGGCAGGAGAATAGCTTGATCTCGGGAGGCGGAGGTTGCAGTCAGCCGAGATCACACCACTGCAATCCAGCCTGGACAACAGAATGAGACTCCATCTCAAAAAAAACAAA"
"GL873582","5794385","5794459","chr13","18872784","18872852","27","13078399","ATATTGTTAAGCACAGCCACTATTAAAAATTAAATTATAGGCCAGGCATAGTGGCTCATGCCTGTAATCCTAGCT","TGAAACCACCATCTGGACCAAGATACAAAATGTTGGCTGGGCATGGTGGCTCACACCTGTAATCCTAGC"
"GL873583","102645","102683","chr14","5808766","5808804","14","5706121","GAGCAGATCACCTGAGCTCAGGAGTTTGAGACCAGCCTG","GAGGAATCCCTGTGCTCAGGAAGCTTACATTCTAGTGAG"
"GL873583","6200447","6200560","chr4","17786849","17786963","24","11586402","GGCCAGGAGGGACGGCTCATGCCTGTTATCCTAGCACTATGGGAGACTGAGGTGGGAGGATCACTTGAAGTTAGGAGTTCCAGACCAATCTGACCAAAGTGAGACCTCATCTCT","GGCCAGGCTTGGTGGCTCATGCCTGTAATCTTAGCACTTTGGGAGGCTGAAGTGGGTGGATCACTTGAGGTCAGGAGTTAGAACCAGTCTGGCCAACATGGTGAAACCTCAGCTC"
"GL873583","6200584","6200752","chr6","169626528","169626696","42","163425944","TTAGCTGGATGTGGTAGCACATGCCTATAGTCCCATCTACTCAGGAGGCTGAGACAAGAGAGTTGCTTAAGCCCAGGAGTTTAATTTAACTGTGAACTAGACTGAGACTGTGGCACTCTAGCTGGGGCAACAGAGTGAGACTCTGTCTCAAAAGAAAGCAAGAAAGAAA","TTAGCTGGGTATGGTGTCAGATGCCTGTAGTCCCAGCTACTCAGGAGGCTGAGACAGGAGAATCGTTTGAACCCAGGAGGCCAGAACTGCAGTGAGCTGAGATTCGCACCACTGCGCTCCAGCCTGGGCCAGACAGAGTGAGACTCTATCTCAAAAGAAAAAAAAAAAA"
"GL873583","10217398","10217583","chr3","36257142","36257313","44","26039744","TACTAAAAATAAAGTGTGATAGCCAGGCATGGTGGTGGTGCCTATAGAACCAGGCTATTCAGGAGGCTGAGGCAGAAGGATCACTTGAACCCAGGAGTCTGACGTTGCTGTGAGCTAGGCTGGTGCCATGGTACTCTAGCCTGTGGTAACAGAATGAGACTCTATCTCAAAAATAAAAATAAAAAA","TACAAAATTAGCCAGGCGTGGTGGTGCGTGCCTGTAATCCCAGCTACTTGGGAGGCCGAGGCAGAAGAATGACTTGAACCCAGGAGACAGAGGTTGCAGTGAGCCAAGATCCCACCATTGTACTCCAGCCTGGGCAACACAGTGAGACTCCATCTCAAAAAAAAAAAAAAAA"
"GL873583","10394919","10394983","chr16","12841703","12841771","22","2446784","GAGGTCAGGAAATCAAGATCAGTCTGGGCAATATATTGATACCCTGCCCCTACATAAGGAAGAAA","AGGTCAGGAGTTCAAGACCAGCCTGGCCAATATGTTGAAACCTCATCTCTACTAAAAATACAAAAATTA"
"GL873584","521512","521529","chr1","167402212","167402233","10","166880700","GCATGGAACCCCCCACTC","GGTGAAACCCCATCTTTACTAA"
"GL873584","2079725","2079768","chr15","4338291","4338335","11","2258566","GGCAGGTGGATTACCTGAGTTCAGGAGTTGGAGACCAGCCTGAC","AGGCGGATGGATCACGAGGTCGGGAGTTTGAGACCAGCCTGACCA"
"GL873584","5216877","5217053","chrX","91350057","91350230","49","86133180","CTACTGAAAATGATGACAGAGGCTGGGCATGGGGGCTCCCGCCTGTTATCCTAGCACCCTCGGAGGCTGGGGAATGAGGATTGCTTACGCCCAAGAGTTTGAGGTTGCTGTGAGCTGAGGCCGCTGCACTCTAGCCTGGGCAACAGAGTGAGACTCTGTCTCAAAAAAAAAAAAAAA","TGCAAAAATGAGCTGGGCATGGTGGCACATGCCTGTAATCCCAGCTACACAGGAGGCTGAGGCAGGAGAATCGCTTGAATCTGGGAGGCGGAGGTTGCAGTGAGCTGACATCAGGCCCCTGCACTCTAGCCTGGGCCACAGAGCAAGACTCCGTCTCAAAAAAAAAAAAAAAAA"
"GL873584","7289930","7289950","chr2","51453328","51453345","10","44163398","TGAGGCTCTGTCTCGAAATAA","AATGCCATCTATTAAAAA"
"GL873584","7289975","7290131","chr11","49739997","49740154","37","42450022","CAAGAAAATTAGCTGAGAGTCCTGGTAGGTGCCTGTAATCCCAGCTATTCATGAGGCTGAGGCAGAAGGATCACTTGGGTCCAGGAGTCTGAGGTTGCTGTGAGCTAGTCTGACGCCATAACACGCAAGCCTGGGCAACAGAGTGAGGCTCGGTTTC","CTACAAAAATTAGCTGGGCGTGGTGGCACATGCCTGTAATCCCAGCTACTCGGGAGGCTGAGGCAGGAGAATCACTTGAGCCCAGGAGGCGGAGGTTGCAGTGAGCCAAGATCATGCCATTGCACTCCAACCTGGGCAACAGAGCAAGACTCCATCTC"
"GL873584","7577743","7577867","chr5","48394329","48394446","27","40816586","GGCTGGATGAGGTGGTTCATGCCTGTAATCCTAGCACTCTGGGAGGCCAAGGTGGGTGGATTGCCTGAGCTCAGGAGTTCAAGACCAGCCTGAGCAAGACCCTGTCGCTAAAAATAGCTGGGTGT","GGCTGGGTGCAGTGGCTCATGCCTGTAATCCCAGCACTTTGGGAGGTCAAGGCGGGTGGATCACCTGAGGTCAGGAGTTCAAGACCAGCCTGGCCAACATCTCTACTAAAAATACAAA"
"GL873584","7578135","7578289","chr1","130112713","130112865","31","122534578","GGAGCTGGGTTTTGTGACTGCACCTGTAATCCCAGCTGCTCAGGAGGCTGAGGCAAGAGAATTGCTTGAGCCCAGGAGTTGGAGGTTGCTGTGAGCTGTGATGCCAGGGAACTCTACCAAGGGTGACAAAGTGAAACTCTGTCTCAAAAAAAAAA","TTAGCCAGGTGTGGTGATGCATGCCTGTAATCCCAGCTACTCATGAGGCTGAGGCAGGAGAATTGCTTGAACCTTGGAGCTGGAGGTTGCAGTGAGCTGAGATCAGACCACTCCAACCTGGGTGACAGAGCGAGACTCTGTCTCAAAAAAAAA"
"GL873585","1450952","1451121","chr10","59681079","59681242","48","58230127","TAAAAACAGAAAAAACTAGTCAGGTGGTGTGGTAGGTGCTCATAAGTCCCAGCTGCTTGGGAGACTGAGGCAAGAGAATCACTTGAGCACAAGAGCTTGAGGTGGCTGTGAGCTATAACACCATAGCACTGTACTGAGGGTGACAAAGTAAGACTCTGTCTCAAAAAAAA","TACAAAAATTAGTCAAGGGTGGTGGTATGTGCTTGTAATCCCAGCTATTTGGGAGGCTGAAGCAGGGGAATCCTTGAACCCAGGAGGTGGAGGTTGCAGCGAGCCGAGATCACGTCACTGCACTCTAGCCTGGGCGATAGGGTGAGACTCTGTCTCAAAAAAAA"
"GL873585","1451382","1451515","chr6","17405813","17405948","24","15954431","GGCCCGGCTCGGTGGCTCACACCTATAATCCTAACACTCTGGGAGGCTGAGGCAGGTGGATCACCTGAGCTCAGGAGTTTGAGACCAGCTGAGCAAAAACAAGACCCTATCTCTGCTAAAAATAGAAAAAACTA","GGCCGGGCGGGGTGGCTCACGCCTGTAATCCCAGCACTCTGGGAGGCCAAGGCAGGTGGATCACCTGAGGTCAGGAGTTTGAGACCAGCCTGGCCAACACGCAGAAACCCTATTTCTACTAAAAACACAAAAATTA"
"GL873585","1626960","1627026","chr7","17782729","17782794","22","16155769","AAGATGCCACAGCACTCTACAAGAGTGACCAAGTGAGACTCTGTCTCAAAAAAAAAAAGAAAAGGAA","CAATCGCACTACTGCACTTCAGCCTGGGTGACAGAGTGAGAACCTGTCTCAAAAAAATAAATAAAA"
"GL873585","1627304","1627531","chr11","17033552","17033788","61","15406248","GGCTGGGCACAGTGGCTCACGGCTATAATCTAGGCACTTGGGAGGCTAGGGCAGGTGGATTGCCTGAACTGACAAGTTTGAGACCAACCTGAGCAAGAGCGAGACCCCTGTCTCTAAAACATAGCCAGGCTCTGTGGTGGGCGTCTGTAGTCCCAGCTACTTGGGAGGCTGAGGCAAGAGAATTGCTTGAACTCAAGAGTCTGAGGTTGCTGTGAGTTAAGATGCCAC","GCCCGGCGCAGTGGCTCACGCCTGTAATCCCGGCACTGTGGAGGCCAAGGCAGGCGGATTGCCTAAGCTCAGGGATTCGAGAACAGCCTGGGCAACATGGTGAAACCCCATCTCTACTAAAATACAAAAAACTAGCCGGGCGTGGTGGTATGCGCCTGTAATCCCAGCTACTTGGGAAGCTGAGGCAGGAGAATTGCTTGAACCCGGGAGATGGAGGTTGCAGTGAGCTCAGATCAC"
"GL873585","3626082","3626158","chr1","100916857","100916922","27","97290775","TGCCTGTAATCCCAGCACTTGGGAGGCGGAGGTGGGTAGATTGCCTGACCCAGAGTGGGACCTCATCTCTAAAAGAA","CATGCCTGTAATCCCAGCACCTTGGGAGGCCAAGGTGGGTGGATCACCTGAGGTCAGTAGTTTGAG"
"GL873585","8849829","8849913","chr18","48581945","48582025","18","39732116","GGCTGGACGAGGGGACTCATGCCTGCAATCCCAGCACTGAGAGAGGCCAAGGCAGGTGGATCCCCTGAGCTCAGAAGTTTGAGAC","GCTGGACGCAGTGGCTCACACCTGTAATCCCAGCACTTTGGGAGGCCAAAGCAGGCAGATCTGAGGTCAGGAGTTTGAGAC"
"GL873585","9319890","9319971","chr8","79499361","79499447","14","70179471","GGCCAGGTGTGGTGGCTCACACCTGTCATCCTAGCACTCTGGGAGGACGAGGTGGGTGGACCGCCTGAGTCAGAGTGAGACC","GGCCAGGTGTGGTGGCTCACACCTGTAATCCCAACACTTTGGGAGGCCCAGGTGGGTGGATCACCTGAGGTCAGGAGTTCAAGACCA"
"GL873586","895572","895692","chr17","14501559","14501680","38","13605987","GGCCAGGTGAGGTTTCTCATTCTGGGAGTGAGCCAGCAATTGGGAGGCCAAAGTAAATGGATTGCCTGAGGTTATAGGTTCCAGAACAGCCAGAACAAGATCGAAATCCTGTCTCCAAAAA","GGCCAGGCGTGGTGGCTCATGCGTGTAATCTCAGCACTTTGGAAGGCCGAGGCAGGTGGATCACCCGAGGTCAAGAGTTCAAGACCAGCCTGACCAACATGGCGAGTCTCTGTCTCCACTAA"
"GL873586","5645995","5646150","chr6","58863249","58863409","38","53217254","GGGTATGGTGGCTCATGCCTGTAATCCAAGCACTCTGGGATGGTGAGGCAGGAGAATCCCTTGAACCCAAGAGTCCGAGGTTGCTGCGAGCTAAGCTGATGGCATAACACTCTAGCCTAGGCGACAGAGTGAGACTCTGTTTCCAAAGAGAAAAAA","TTAGCCAGGCATGGTGGCACATGCCAGTAATCCCAGCTACTCAGGAGGATGAGGCAGGAGAATCGCTTGAACCCAGGAGGCAGAGGTTGCAGTGAGCTGAGATTGCGCCACAGCACTCTACCCTGGGTGACAGAAGGAGACTCTGTCTCAAAAAAAAAAAA"
"GL873586","10258686","10258969","chr12","9481260","9481565","81","777426","GGCCGGGCATGGTGGCAGAAATCTAGGAGGCCGAGGCAGGTGGATCGCCTGAGATCACAAGTTCAAGACCAGCCTCAGCTACAGCAAGACCCCATCTCTAAAAATAGCCGGCTGTTGTGGCAGGCGCCTGTAACCCCAGCTACTCGGGAGGCTAAGGCAAGAGAATCGCTTGAGCCCATGAGTCTGAGGTTGCTGCGAGCTGTGACTCCACGGCACTCTACCCGGGGCGATAAAATGAGATTCTGTGTCAAAACAAACAAACAAACAAACAACAACAAAAACAA","GCTGGGCGCGGTGGCTCATGCCTGTAATCCCAGCACTTTGGGAGGCCAAGGCAGGTGGATCACCTGAGGTCAGGAGTTCGAGACCAGCCTAGTCCACATGGTGAAACCCCATCTCTACTAAAAACTAGCCAGGCGTGGTGGTGCGCACCTGTAATCCCAGCTACTCGAGAGGCTGAGGCAGGAGAATCACTTGAGCCTAGGAAGCAGAGGTTGTGGTGAGCTGAGATCACACCACTGCACTCCAGTCTGGGCGACACAGTGAGACTCTTGTCTCAAAAACAAAAAACAAACAAACAAACAAACAAA"
"GL873587","3208032","3208047","chr8","3626746","3626762","2","418714","AAACAACCACAAAAAA","ACAACAACAACAAAAAA"
"GL873587","3208141","3208321","chr19","2057131","2057316","59","1151010","TTTCTTTTAAAAATCACCCATGGGCTGGGTATAGTGGCTCACACCTATAATCCTCGGGAGGCCAAGGTTGGAGGATTGCTTGAATCCAGGAGTTGAAGGTTACAGTGAACTGGGATTTAGCCACTAGACTCTAGCATAGCTGACAAAGCAAGAACCTATTTGTTTAAAACACAAAAAAGAA","TACTAATAATACAAAAATGAGCCGGGTATGGTGGCGGGTGCCTGTAATCCCAGCTACTGAGGAGGCTGAGGCAGGAGACTTGCTTGAACCCAGGAGGTAAAGGTTGCAGTGAGCTGAGATTGCACCACTACACTCCAGCCTGGGCGACAAGAGCAAAACTTTTTCTCCAAAAAAAAAAAAAAAAAA"
"GL873587","3278260","3278367","chr19","19044200","19044312","39","15765940","CAGTCTGAGCAAGAGGGAGAGGCTATTTCTACTAAAAACAGAAAAACTAGCTGGGTGTTGGGGTGTGTTCCTAGTCTCAGTTACTTGGGAGGCTGAAGTAAGAGGATC","ACCAGCCTGGCCAACACGGTGAAATCCCGTCTCTACTAAAAATACAAAAATTACCTAGGCGTGATGGCACGTGCCTGTAGTCCCAGCTACTCATAAGGCAGAGGTGAGAGAAT"
"GL873587","3278673","3278754","chr7","49412503","49412597","28","46133830","GGCCACGAGAGCTAGCTCATGCCTATTCTAGGAGGCCAAAGCAGGCAGACTGCCTGAGCTCAGGAGTTCAAGAGCAGCCTGG","GGCCAGGTGCAGTGGCTCATGCCTGTAATCCGAGCACTTTGAGAGGCCGAGGCAGGCAGATCACCTGAGGTCAGGAGTTCAAGACCAGCCTAGTA"
"GL873587","3782076","3782188","chr9","112128434","112128552","34","108346358","ACTGGGGTGGCTGAGGCAGGAGCGTCACTTGAACTCAGGAGTTTGAGATTGCTGTGAGCTGAGCAGATGTCATGGCACGCTAGCCTAGGTAATAGAGTGAGACTTCGTCTAAA","CAGCTACTCGGGAGGCTGAGGCAGGAGAATCACTTGAACTCGGGAGGCGGAGGTTGCAGTGAGCCGAGATCACGCCATTGCACTCCAGCCTGGGCAACAAGAGCGAAATTCCATCTCAA"
"GL873587","4564996","4565084","chr20","27900350","27900437","14","23335354","GGCGGGGTGTAGTGGCTCATGCCTATTGTCCCAGCACTGTGGGAGGCCGAGGTGGGTGGATCACCTGTGCTCAGAAGTTTGAGACCAGC","GGCCGGGCGTGGTGGCTCATGTCTGTAATCCCAGCACTTTGGGAGGCCGAGGTGGGTGGATCACCTGAGGTCAGGAGTTCAAGACCAG"
"GL873587","6307870","6308175","chr12","112427710","112428020","54","106119840","GGCCAGATATGATGGCTCATGCTTGTAATCCTAGCACTCTGGGAGGCTGAAGTGGGAGGATCACCTGAGATCAGGAGTTCAAGATCACCCTGAGCAAAAGTGAGATCCCATCTCTATTAAAAATAAAAAAATTATCCAGGCATGGTGGTGCAGTCCTTTAGTCCCAGCTACTTGGGAGGCTGAGGCAGGAGAATCTCTTGAACCCAGGAATTAGAGGTTACAGTGAGCTGTGATGATGCTACTGCACTCTAGCAGGATGACAGAGTGAGATACTCCGTGTCAAAAAAAAAAAAAAAAAAAGCAAAA","GGCTGGACATGGTGGTTCATGCTTGTAATCCGAGCACTTTGGGAGGCCAAGGCGGGTGGATCACCTGAGGTTGGGAGTTCGAGACCAGCCTGACCAACATGATGAAACCCCATCTCTACTAAAAATACAAAAAAATTAGCCAGGCATGGTGATGCACGCCTGTAATCCCAGCTACTTGGGAGGCTGAGGCAGGAGAATCACTTGAACCCAGGAGGCAGAGGTTACAGTGAGCCGAGATCATGCCATTGCACTCCAGCCTGGATGACAGAGTGAGCCTCTGTCTCAAAAAAAAAAAAAAAAAAAAAAAAAAA"
"GL873587","6484004","6484128","chr10","67341428","67341546","29","60857424","GACCAGGTTCTGTGGCTCATGCTTGTAATCCTAGCACTCTAGGAGGCCGGAAGAGGGTGGATTGATTGCCTGAGGTCAGGAGTTAGAGACCAGCCTGAGCAAGAGCTAGACCCTGTTTCTTTCTT","GGCTGGGTGTAGTGGCTCATGCCTGTAATCCCAGCACTTTAGGAGGCCAAGGTGGATGGATTGCCTGAGCTCAGGAGTTCGAGACCACCCTGGGCAACAAGCCAAAACCCTGTCTCTAC"
"GL873587","6484407","6484586","chr3","167196537","167196723","48","160712130","TAGACCCTGTTTCTAAAAAAAAAATAGCCAGGTGTTGAGGCAGGTACCTGTAGTCCCAGCTACCTGGGAGGGCTGAGGCAAGAGAATCGCTTGAACCCAAGAGTTTGAGGTTGCTGTGAGCTGAGATGCTATGGCACTCAACCGTGAGCTACAAAGTGAGACTCTGTCTCAAAAAAAAAA","AAAACCTGTCTCTGCTAAAAATACAAAAATTAGCCGGGTGTGGTGATGTGCGCCTGTAGTCCTAGCTACTTGGGAGGCTGAGGCAGGAGAATCACTTGAATCCAGGAGGTGGAGGTTGTAGTGAGTCGAGATCGTGCGACTGCACTCCAGCCTGGGTGACAGCGAGACTCTGTCTCAAAAAAAAAAA"
"GL873587","7466229","7466364","chr1","29437872","29437991","35","21971643","GGCCAGGCGTGGTGGCTCATGCCTGTAGTCCCAGCGCTATGGGAGGCCGAGGTGGGTGGATCACCTGTGCTCAGAGGTTCGAGACCAGCCAAGACCCCCCTGAGCCAAATGAGCCAGAGTGAGATCCCATCTCTAC","GGCCGGGCGTGGTGGCTCACGCCTGTAATCCCAACATTTTGGGAGGCCAAGGCGGGTGGATCACCTGAGGTCAGAAGTTCGAGACCAACCTGGCCAACATGGTGAAACCCCTGTCTCTAC"
"GL873588","1502535","1502718","chr1","34852429","34852590","60","33349894","GGTGCAGTGGCTCACACCTGTTGTCCCAGCGCTGTGGGAGGCCGAGGTGGGTGGATCACCTGTGCTCAGAGGTCGAGACCAGCTGAAGACCTGCCTGAGGCAGAGTGAGCCAGAGTGAGACCCCGTCTCTACTAGAACAACAACAAGACAGCCAGACCTTGTGATCCCAGCTACATGGGGGGCT","GCCAGGTGCAGTGGCTCACACCTGTAATCCCAGCACTTTGGGAGGCCGAGGCGGGCGGATCACCTGAGGTCAGGAGTTTGAGACCAGCTTGACCAACATGGAGAAACCCCGTCTCTACTAAAAATACAAAATTAGCCTGGTGTGGTGTCGCATGCCTGTAAT"
"GL873588","10189037","10189246","chr3","45604681","45604903","65","35415644","GCTGAGATGAGGAGACTCTGTCTCTATTAAAAATAGAAAAATTGGGTGGATGTTGTGGGTACTGTAGTTGCAGCCTCTTGGGGGGCTAAGGCAGGAGGATCAGTTGAAGCCAGGAATTTGCTTTGAGCTAGGCTAAAGCCATGGCACTCTAGCCTGGGCAACAGAGTGAGGCTAGATCTCAAAAAAAGAAAGAAAAGAAAAAGAAAAAAA","CTGGCCAACATGGCAAAACCCCATCTCTACTAAATATACAAAAATTAGCTGGACGTGGTGGCACATACCTGTAATCCCAGCTACTTGGAAGGCTGAGGCAGGAGAATAGCTTGAACCTGGGAGGCAGAGGTTGCAATGAGCTGAGATCACGCCACTGCACTCTAGCCTGGGCAATAGAATGAGACTCTGTCTCAAAAAAAAAAAAAAAAAAAAAGACAAGAAA"
"GL873589","104719","104807","chr20","27900350","27900437","13","27795631","GGCTGGGCGTGGTGGCTCATGCCTGTTGTCCCAGCGCTGTGGGAGGCTGAGGTGGGTGGATCACCTGTGCTCAGAGGTTCGAGACCAGC","GGCCGGGCGTGGTGGCTCATGTCTGTAATCCCAGCACTTTGGGAGGCCGAGGTGGGTGGATCACCTGAGGTCAGGAGTTCAAGACCAG"
"GL873589","796766","796905","chr1","166346372","166346487","49","165549606","GGCTAAGTGTGGTGGCTCACACCTGTCATCTAGTACTTTGGGAGGGTGGGCCTGGGAGTTCAAAGACTGAACTCAGGAGTTCAAGGTGGCTCCGGGGAGGAATTCAAGACCAACCTGAGCCAGAGCGAGACCTCGACTCT","GGCCAGTGGGGTGGCTCACGCCTGTAATCCCAGCACTTTGGGAGGCTGAGGTGGTCAAATGACCTGAGGTCAGGAGTTTGAGACCAACCTGGCCAACATGGTGACACCTCGTCTCT"
"GL873589","1023679","1023690","chr1","205890061","205890072","1","204866382","AAAAAAAAAAAA","ACAAAAAAAAAA"
"GL873589","1023771","1024047","chr4","103012712","103012993","70","101988941","GGCTTGGTGGCTCACACCTGTAATCCTAGCACTCTGGGAGGCCGAAGTGGCTGGAATACTTGAGGTCAGGAGTTCAAGACCAGCCTAAGTGAGAGTGAGATCCCCATCTCTAATAAAAATAGAAAAATTAGCAGGGTGTTGTGGCTGGCACTTGTAGTCCCAGCTACCCAGGAGACCGAGGCAGAAGTTTGAGATTATTGTGAGCGAGGCTGATGCCACAGCATTCTAGTGGGACAACAGAGCAAAATTCTATCTCAAAAGAAAAAAAAAAAAAGGA","CGGGCGTGATGGCTCACGCCTGTAATCCCAACACTTTGGGAAGCCGAGGCGGACGTATCACCTGAGGTCAGGAGTTCAAGACCAGCCTGGCCAACATGGTGAAACCCCGTCTCTACTAAAAATACAAAAATTAGCTGGGTGTGGTGGCATGCGCCTGTAATCCCAGCTACCCAGGAGGCTGAGGCAGGAGAATCGCTGAGGCTGCAGTGAACTGAAATTGTGCCACTGCACTCCAGCCTGGGTGACAGAGCAAGACTCTGTCTCAAAAAAAAAAAAAAAAAA"
"GL873589","4820958","4821024","chr8","33633747","33633811","15","28812789","TTAGTCAAGTGCAGTGGCTCACACCTGTCATCCCAGCTACTTGGGAGGCTGAGGCAGGAGAGTTGCT","TTAGCCAGGTGTGGTGGTGCATGCCTCTAATCCCAGCTACTCAGGAGGCTGAGGCAGGAGAATTG"
"GL873589","6763768","6763857","chrX","25814002","25814092","29","19050234","GGTGTGGTGGCTCACACTTGTATCTTAGCATTTTAGGAGGCTGAATGGGGAGAATTGCTTTAAGTCAGGAGTCTGACTTCCACCTTGCCA","GGCTGGGAATGGTGGCTCACACCTGTAATCCCAGCACTTTGGGAGGCTGAGGTGGGCAGATCACCTGAGGTCAGGAGTTTGAGATCAGCCT"
"GL873589","8444551","8444632","chr9","93194085","93194171","17","84749534","CGGGCATGGTGGCTCACAACTATAATCTTAGCACTTTGGGAGGCTGAGACAGGTGGATGCCTGAACTCAAGAGTTTGAAACC","GGCCGAGCATGGTGGCTCACACCTGTAATCCCAGCACTTTGGGAGGCTGAGGCAGGTGGATTACCTGAGGTCAAGAGTTCAAGACCA"
"GL873589","9085365","9085494","chr2","194063347","194063481","42","184977982","GGCCAGGCACAGTGGCTCACACCTATAATCCCAGCACTCTGTGAGACTGAGGCAGGTGAACTGTTGCAAGAGTGAGACCCTGTGCTTGGTGCCTGTAGCTCAGTGGTTAATAATAAGAAAAAAGAAAAAA","GGCCAGGTGCAGTGGCTCACACCTGTAATCCCAGCACTTTGGGAGTCTGAACCAGGCAGATCACCTGAGGTCAGGAGTTCGAGGCCAGCTCGGCCACCATGGTGAAACCCTGTTTCTAATAAGAATACAAAAAAA"
"GL873589","9085767","9086002","chr7","84631446","84631650","75","75545679","GAGTGAAACCCTGTCTCTACTAAAAATAGAAAAACTAGCTGTGCATCAGGGCGCATAACTGTAGTCCCAGGTACTCAGGACACTGAGGCAAGAGAATTGCTCAAGCCCAAGAGTTTGCAAGAATTTGAGGTTGCTATGAGCTATGATGCCATGGCACTCTACCTAGGGTGACAGACAGAGACTCTGTCCCAAAAAAAAAAAAAGAAGAAGAAGAAAAAAAAAAAGAAAGAAAGAAA","ATAGTGAAACCTCGTCTCTACTAAAAATACAAAAATTAGCTGGGCATCATGGTGCACGCTTGTAATTCCAGCTACTTGGGAGGCTGAGGCAGGAGAATTGCTTGAACTCAGGAGGTGGAGGTTGCAATGAGCCAAGATCGCGCCACTGCACACCAGCCTGGGTGACAAAAGACTCTGTCTCAAAAAAAAAAAAAAAAAAAAAAAA"
"GL873589","9992904","9993045","chr16","56427538","56427666","46","46434634","AACCAGCCAGGCATGGTGATTCACACCTATAATCCCAGCTACTTAGGAGTATGGCTTGAGCACACAGGATACCATACCATTCTAGTCATCCCAGGCAACAGAGGGAAACTCTGTTGGTTAAAAAAAAAGAAAAACTTAAAAA","TTAGCCAGGAGTGGTGGTGCACGCCTATAATCCCAGCTACTTGGGAGGCTGAGGCACAAGAATCACTTGAACCATTGCACTCCAGCCAGGGTGATAGAGGGAGACTCTATCCAAAAAAAAAACAAAAAA"
"GL873589","9993319","9993452","chr3","2774534","2774668","28","7218785","GGCCTGAGCCCTGTGACTCATGCCTGTAATCCCAGCACTGGAAGTTCCAAGGCAGGTGGATCGCTTGAGCTCTGGAGTTCAAGACCAGCTCAACCAAGAGTAAGACCCCATCTCTACTAAAAATAGAAAAACCA","GGCTGGGCACGGTGGCTCATGCCTGTAATCCCAGCACTTTGAGAGGCCGAGGCAGGTGGATCTCCTGAGGTCAGGAGTTCAAGACCAGCCTGGGCAACATGGTGAAACCCCATCTCTACTAAAAATACAAAAAAT"
"GL873590","9044589","9044884","chr1","83754525","83754835","84","74709936","GGCCAGGTGCAATGGCTCATGCCTATAATCCTCACACTCTGGGAGGCTGAGGCAGGAGGATCACTTTTCTCAGGGTCAGGGCCAGCCTGACAAAAGTCAGACCCTGTTTCTACTAAAAATAGAAAAACTAGCTGGGTGTTGTGGCAGATGCCTATAGTCCCAGCTACTAAGAGACTGAGACAAGTGCCCAGAGTCTGAGGTTACTGTGAGCAAAGCTGATGCCATAGCATTCTAGCTATAGATCGAGAGTCTGTCTCAAAAACAAACAAACAAACAAACAAACAAACAAAAAAGAA","GGCTGGGTGTGGTGGCTCATGCCTGTAATCCCAGCACTTTGGGAGGCCGAGGCGGGTGGATCATCTGAGGTCAGGAGTTCAAGACCAGCCTGACCAACATGGTGTAACCCTGTCTCAACTAAAAATACAAAAATTAGCTGGGCGTGGTGGTGTGCACCTATAGTCACAGCTACTTGGGAGGCTGAGACAGGAGAATTGCTTCAACCCAGGAAGTGGAGGTTGCAGTGAGCCAAGATCATGTCACTGCACTGCAGCCTGACAGAGCGAGACTCCATCTAAAACAAACAAACAAAAACAAACAAACAAACAAA"
"GL873591","1831505","1831587","chr17","61702818","61702899","25","59871313","CCCAGCACTTTGGGAGGGCAAGATGGGAGAATCATATAAAGTCAGGAGTTTGAGACCAGTTTGGCAGACATGATGAACCCATC","AATCCCAGCACTTTGGGAGGCTGAGGCAGGCGGATCATCTGAGGTCAGGAGTTCAAGACCAGCCTGGCCAACATGGTGAAAC"
"GL873591","2719175","2719275","chr4","86137755","86137847","32","83418580","GTGGGGGCTTAGGCCTGTAATCCCAGCACTCTGAGAGGCCAAGGTGAGCTGGTCACCTGGGTTTAGGAGTTTGGAGACTTGCTCGAGCTAGACTGAGGCTC","GTGGTGGCTCACGCCTGTAACCCTAACAATTTGGGAGGCCAAGGCAGGTGGATCACTTGAGGTCAGAAGTTTGAGACCAGCCTGGACAATATG"
"GL873591","4732974","4733120","chr19","7991801","7991954","55","3258827","ATACGCAGACTGGCCGAGCGTGGTGTCACATGCCTATAATCCCAGTGGCTACTCTGGGGAGGAGAATCTCTTGAAACCAAGAGTTAGAGATTGCAGTGGGGTATGATACAGGGTAACAAAGAGAGACCTTGGATCTGAAAAGAAAAA","AAAATACAGAAACTAGCTGGGCATGGTGATGCACACCTGTAATCCTAGCTACTGGGGAGGCTGAGGCAGGAGAATTGCTTGAACCCAGGAGTCAGAGGTTGCAGTGAGCAACCAGCCTGGGTGATACAGTGAGTGAGACTCTGTCTCGAAAAAA"
"GL873591","6822728","6823009","chr1","20579766","20580052","72","13757038","GGCCAGGCGTGGTGGCTCATGCCTGTAAATCTCAGCACTCTGGGAAGCTGAGGCAGGTGGATTGCTTGAGGTCAGGAGTTTGAGACCAGCCTGTACCAGAGTAAGACCCTGTCTCTAATAAAAATAGAAAAAAAAAAAAAAACTAGTTGGGCATGGTGATGGGTGCCTGTAGTCCCACCTACTTGGGAGGCTGAGGCAATGGCATCTCTTGAGCCCAAGAGTTTGAGGTTGCTGTGCCATGGCACTCTCCCCAGGGTAACAGAGTGAAAATAAAAAAAAGAA","GGCCAGGCGTGGTGACTCATGCCTGTAATCTCAGCACTTTGGGAGGCCGAGGCAGGTGAATCACCTGAGGTCAGGAGTTTGAGACCAGCCTGACCAACATGGTGAAACCTCGTCTCTACTAAAAATACAAAAAGTAGCCAGGCATGGTGGCGCATGCCTGTAATCCCAGCTACTTGGGAGGCTGAGGCAGGAGAATCGCTTGAACCCGAGAGGCAGAGGTTGCATTGAGTCAAGATGGTACCACTGCACTCCAGCCTGGGTGACAGATTGAGACTCAAAAAAAAAAA"
"GL873591","7578706","7578813","chr16","45055441","45055543","42","37476735","AAATTTAGCTACACATAGTGGCATGAGTCTGTAATGCTAGCCACCCAAAAGGCTGTAGTAAGAGGATTGCTCTATCCCAGGAGTTAAAGACCAGCCCGGACATCAGAG","AATTAGCCGGGCGTGGTGACACACACTTGTAATCCTAGATACTCAGGAGGCGAAGGTAGGAGAATTGCTTGAACCCAGGCAGCAGAGGTTGCAACGAGCAGAG"
"GL873591","9282916","9283004","chr1","20744253","20744338","16","11461337","GGCCAGGCGCGGTGGCTCACCCCTGTTGTCCCAGTTCTGTGGGAGGCCGAGGTGGGTGGATCACCTGTGCTCAGAGGTTTGAGACCAGC","GGCCAGGCACGGTGGCCACGCCTGTAATCCCAGCACTTTGGGAGGCCGAAGTGGGTGGATTACCTGAGGTCAAGAGTTTGAGACCA"
"GL873592","835155","835315","chr16","75654291","75654451","43","74819136","CTGGGTGTGGTGGCTCTTGTCTGCAATCTCAGTACACTGGGAGGCTGAGGCAGAAGGATTGCTCCAGCTCAGGAGTTTGAGGCCAGGCTGAGCTAGTGCAAAACCCCATCTCTACTAAAAAAAGAAGGAAAAAAAAAAGAAAAAGAAAAAAAATACGAGCT","CCAGGTGTGGTGACTCACGCCTGCAATCCCAGCACTCTGGGAGGCTGAGGTGGGTAGATTACCGGAGGTTAGGCGTTTGAGACCAGCCTGGCCAACATGGTGAAACCCCATCGCTACTAAAAAAAAAAAAAAAAAAAAAAAAAAAAAAAAAAAAAAAATTA"
"GL873592","835589","835765","chr1","66836166","66836336","48","66000577","ACAAAAAACCTAGCTTAGGGTTGTTATAGCACCTGTAGTCCCAGCTACTCAGGCGCTAAGGCAGGAAAATCTGCCTGAGCTCAGGAGTTTGAGGTTGCAGTAAGTTATGATGATGCTACTGCACTCTAGCTGGGGCAACAGAGTGAGACTCTGTCTGAGGAAAAACCAAAACCAAAA","TAGCCCAGCACGGTGGCTCACACCTGTAGTCTCAGCTACTCAAGAGGCTGAGGCATGAGAATCGCTTGAACCCAGGAGGTAGAGGTTGCAGTGAGCTGAGATCATGCCACTGCGCTCCAGCCTGGGCAACAGAGTGAGACTCAGTCTCAAAAAACAAAACAAAACAAAAAA"
"GL873592","2520661","2520705","chr16","66853217","66853257","11","64332556","TCTGGGAGGCTGAGGCGGGTGGATCACCTGAGCAAGAGTGAGACC","TTTGGGAGGCTGAGGCAGGTGGATCACTTGAGGTCAGGAGT"
"GL873592","4535248","4535388","chr1","12240468","12240612","38","7705220","GGCGGGATGTGGTGGTTCATGGCTGTAATCCCAGCACTCAGGGAGGCTGAGTCGGGTGGATTGCTTGAGTTCAGGAGTTTGAGACCAACCTGAGCAAGAACTAAGCCTGTCTCTACTAAAGATATTATTTCTTATTTTTCT","GGCCGGGCGCGGTGGCTCATGCCTGTAATCCCAGCACTTTGGGAGGCTGAGGCGGGTGGATCACCTGCGGTCAGGAGTTCGAGACCAGCCTGGCCAACGTGGTGAAACCTCATCTCTACTAAAAATATAAAAATTAGCTGGTGTG"
"GL873592","4535654","4535831","chr8","126054004","126054184","54","121518350","TCTACTACAAATATTAACAGAAAAATTAGCTGGGCATTGTGACAGGTGCCTATAGTCCCAGATACTCAGAAGGCTGAAGTAAGAGGATCACTTGAACCCCAGGAGCTAAGGTGGCTGTGAGCTAGGCTGAGGCTCTAGCCTGGGTAACAGAGTGAGACTGTAAAAAAAGAAAGAGAGA","GTCTCTACTAAAAATACAAAAATTAGCTGGGTGTGGTGGTGCATGCCTGTAATCCCAGCTACTCAGGAGGCTGAGGCAGGAGAATCGCTTGAACCCAGGAGGTAGAGGTTGCAGTGAGCCAAGATCATGCCACTGCACTCCAGCCTGGGTGACAGAGGGAGACTCTGTCTCAATAAATAAA"
"GL873592","6794968","6795049","chr3","154764711","154764794","20","147969743","GAAGGTTTGATGAGCTCAGATGATGCCACTGCAGTCTACCCAGAGTGAAGGAGCGAGACTCTGTCTCAAAAACAAAAAAAGA","CAGAGGTTGGCAGTGAGCTGAGACTGTGCCACTGCACTCCAGCCGGGTGACAGAGTGAGACTCTGTCTCAAATTACAAACAAAA"
"GL873592","6881384","6881478","chr5","24882384","24882475","28","18001000","GGGCAGGCATAGTGACTGGTGTCTCTAATCCTAGCAGTCTGGGATGCTGAGGCAAGTGGAATGTCAGAGTTCAGGAGTTGAAGATCACCCTGACT","GGCCGGGCGCAGTGGCTCACATCTATAATCCTAGCATTTTGGGAGGCTGAGGCAGGCGGATCACCTGAAGTCAGGAGTTTAAGACCAGCCTG"
"GL873592","6881755","6881937","chr10","61601371","61601572","66","54719616","TCACCCTGACCAAGAGCAAGACCCTGTCTCTACTAAAAATAGAATAAACTAGCTGGGAATTGTGGTGGGTGCCAGTAGTCCCCGCTACTGAGGCAGGAGGATCATTGAGTCCAAGAGTTTGAGGTTGCTGTAAGTTAGGACACCACAGCACTCTACACAGAGTAAGACTGCCTCAAAAATAAA","AGTAAAGAAAAGAAACCCTGTCTCTACTAAAAATACAAAAATTAGCTGGGTGTGGTGGTGCGCACCTGTAGTCCCAGCTACTTGGGAGGGTGAGGTATGGGAATCACTTGAACCCGGGAGGTGGAGGTTGCAGTGAGCCAAGATCACACCACTGCACTCCAGCCTGGGTGAGAGAGTGAGACTCTGTCTCAAGAAAAAAGAA"
"GL873592","7006080","7006155","chr1","8947061","8947129","24","1940981","CACACTGAGAGGCAAAGGCTGGTGGATCACCTGAGCTCAAGAGTTTGAGACCAGCCAAGCCAGAGATCTTGTCTCT","CACTTTGGAGCCAGGTAGGTGATCACCTGAGTCAGGAGTTCGAGACAGCCTGGCCAACATGTGAAACCC"
"GL873592","8446508","8446655","chr11","122502739","122502874","48","114056231","TTAGCTGGGTGTTGTGGCAGGCACCTGTAGTCCCTCCCAGCTACTTGAAAGGCTGAGGCAAGATGACAGCTTAAACCCAAGAGTTTAAGGTTACTCTATTCAGGGCAACAGAGTGAGACTCCATCTACATAAATAAATAAATAAATAA","GGCTGGGCGTGGTGGTTCACACCTGTAATCCCAACACTTTGGGAGGCTGAGGCCAGCGGATTGCCTGAGCCCAGGAGTTTGAGACCAACCTGGGCAACATGGTGAAACTCCATCTCTACTAAAATACAAAAAGTTA"
"GL873592","8446953","8447008","chr16","44513352","44513404","15","36066399","GACCAGCCTAAGCAAAAAAGAGATCCTATCTCTACTACTAAAAATAGAAAAAATTA","ACCAGCCTCACCAATATGAAGAAACCCCATCTCTACTAAAAATACAAAATATT"
"GL873592","8447239","8447325","chr1","8062863","8062957","21","384376","GGCCAGGAGCAGTGACTCATGCCTAGCACTCTGGGAGGCCAAAGCAGGTGGATCAACTGAGCTCAGGAGTTCAAGACCAGCCTAAGC","GGCCGGGTGCAGTGGCTCATGCCTGTAGTCCCAGGACTTTGGCAGGCCAAGGCCGGTGGATTACCTGAGGTCAGGAGTTCAAAACCAGCCTAGCC"
"GL873592","8723925","8724000","chr3","42066983","42067054","20","33343058","AATTAGCCGGGCATGGTAGTGTGTGCCCATAATCTCAGCTACTCAGAAAGCTAAGATAGGAAAATTGCTTGAGCTC","TTAGCTGGGTGTGGTAGTGCATGCCTATAATCCCAGCTACTCGGGAGGCTGAGGTGGGAGAACTGCTTGAAC"
"GL873593","384022","384146","chr15","102382935","102383070","28","101998913","GGCCACGAGGGCCCATGCCTGTAATCCTAGCACTCTGGGAGGCTGAGGTGAGTAGATTGCTGAGCTCAGGAGTTCAAGACCAGCCTGTGCAAGAGACCCCATCTCTGCTAAAAATAGAAAAACCA","GGCCAGGTGTGGTGGCTCACGCCTGTAATCCTAGCACTTTGGGAGGCTGAGGCGGGTGGATTGCCTGAACTCAGGAGGTCAAGACCAGCCTGGGCAACACAGTAAAACCCCATCTCTACTAAAATACAAAAAATCA"
"GL873593","384425","384607","chr20","28286874","28287058","50","27902449","GAAAGAAAAGAAAAGAAAAACTAGCAAGATGTTGTAGCTGATGCCTATAATCCTAGCTATTGGAGAGGTGGAGGCAAGAGAATTGCGTGAGCCCAAGAGTTGAAGGTTGCTGTGAGCTGCGATGCCAGAGCACTCCAGGGTGACAGAGTAAGACTCTGTCTCAAAAAAAATTACAAAATAAAA","TAATAAAAATAAAAAAATTAGCCAGGAGTCAAAGCACACGCCTATAACCCCAGCTACTTGGGAGGCTGAGGGAGGAGAATTACTTGAACCCGGGAGGTGAAAGTTGCAATGAGCTGAGATCAAGCCACTGCACTCCAGACTGGATGACAGAGTGAGACTCTGTTTCAAAAAAAAAAAAAAGACAA"
"GL873593","1408445","1408467","chr10","88070368","88070389","9","86661923","AATCTAGAGATGGGGAGAGGTTG","AAAGAGATGGAAGAGAAGAAGA"
"GL873593","4856365","4856484","chr7","56497314","56497433","31","51640949","GCAATCCCAGCTGATCGGGAGGCTGACCCAGAAGAATCCCTTGAACCCAAGAGTCTGAGGTTGCTATGGGTGGATTCTACAGCACTCTAGCCTGGGAGACAGAGTGAGACTCTGTCCCAA","ATCCCAGCTACTTGGGAGGCTGAGACAGAAGAATTGCTTGAACCCGGGAGGTGGAGGTTGCAGTGAGCCAAGATTGTACCACTGCACTCCAGCCTGGCAACAGAGTGAGACTCTGTCTCA"
"GL873593","6661298","6661485","chr10","86749316","86749514","55","80088018","GCAGAGGCTCACATATGTAATCCTAGCACTCTGGGAGGATAAGGCAGGTGGACAGCTTGAGCTCAGGGGTTTGACCAGTCTGATCAAGAGCAAGACCTGTGTCTACTAAAAATAGAAAACCTAGCCAGGTATGATGGTAGATGCCTGTATTCCTAGCTACTCTGGAAGCTAAAGCTAAAGAGTTTGAA","GGTGGCTCACACCTGTAATCTTAGCAATTTGGGAGGCCGAGGTGGGTGGATCACTTGAGGTCAGGAGTTTGAGACCAGACTGGCCAACATGGTGAAACTCTGTCTCTACTAAAAATACAAAAATTAGCCAGTCATGGTGGTGCATGCCTGTAATCCCAGCTACTCAGGAAGCTTAGGCAGGAGAATCACTTGAACCCAG"
"GL873593","6710263","6710446","chr14","4390080","4390244","66","2320183","TTGAAGTCAGGAGTTTAAGGCCAGTCTGGGCAACATAGTGAGACCCCCATCTCTACGAAAATATTTTTTAAAAATTAAAAATAGCTGGGCATAGTGAGGCTGTTGTGAGCTATAACTGCACCACTGCACTCAGCCAAGGACAGAGACCCTGTTCCCTGCCTCAAACAAACCAAAACAAAACAAA","AAGTCTAGAGTTTACAGCCTGGACAACGCAGTGAAACCCTGTCTCTACCAAAAATACAAAAATTAGACAGGTGTGAGAGGCGGAGGTTGCAATGAGCTGAGATCGCAGCACTGCAGTCCAGCCTGGATGACAGAGCGAGACCCCATCTCAAAAACAAAAACAAAA"
"GL873593","7159645","7159716","chr6","178318394","178318465","21","171158749","GATCATGTCACTGCTCTCCAACCTGGGCAATTGAGCAGGAATCTGTCTCAAAAAGAAAAAAAAAAAAGAAAA","CGAGTTCACACCACTGCACCCCAGCCTGGGCAACAGAATGAGACTCGGTTTCAAAAAAAAAAAAAAAAAAAA"
"GL873593","7159841","7160050","chr13","33368171","33368368","69","26208330","GGCCAGGCGTGGTGGCTCACACCTGTTGTCCCAGTGCTGTGGGAAGCCGAGGCAGGTGGATCACCTGAGCTCAGCCGAGTTCGAGACCAGTGGAAGACCAGCATGAGGCAGAGTGAGCCAGAGTGAGACCCCATCTCTACAACAACAACAAGAAGAAAAAAAACAGCCGGACCTTGTGATCCCAGCTACGTGGGGAGCTAGAGAATCACT","GGCTAGGCATGGTGGCTCATGCCAGTAATCCCACCACTTTGGGAGGCCGAGGCAGGTGGATCACCTGAGGTCAGGAGTTCAAGACCAGGCTGGCCAACATGTTATGATGAGACCCTCATCTCTACTACAAATACAAAAATCAGCTGGGCATGGTGGCAAGTGCCTGTAATCCCAGCTACTTGGGAGGCTGAGGCAGAA"
"GL873593","8598292","8598391","chr11","118461023","118461129","33","109862731","AGCCAGGTGAGGTGGTTCACACCTGTAACCCTAGCTGCTTGGGAGGCTGAGGCCTCTCTATCCTGGGCAGTGTGGAGAAACTTTGTTTCAAAAAAAAGAA","GCCGGGCGCGGTGGCTCACGTCTGTAATCCCAGCGCTTTGGGAAGCCGAGGCGGGACTATCCTGGCCAACATGGTGAAACCCCGTCTCTACTAAAAATACAAGAATC"
"GL873594","357249","357377","chr2","75702890","75703011","36","75345641","CCTGGTACCGTAGGTCATGCCTGTAATCCTAGCACTTTGGGATGCTGAGGTGGGCAGATTGCCTGAGCTCACGAGTTCAAGCCATTAGAACTGAGCCTGACCTAGAGTGGGACCTCCAACTCTTTTTTT","GCCAGGCACAGTGGCTCATGCCTGTAATCCCAGCAGTTTGGGAGGCTGAGGTGGGCAGATCACTTGAGGTCAGGAGTTCAAGACCAGCCTGGCTGACATGGTGAAACCCCATCTATACCAAA"
"GL873594","357656","357834","chr7","17608776","17608965","55","17251120","GGGACCTCCAACTCTTAAAATAGCTGGGCATTGTGGTGGGCACCTACAGTCACAGCTACTTGGGAGGCTAAGGCAAGAGACTTGTTTGCAGCCAAGAGTTAGAGGTTGCTGTGAGCTATGAGGCTAGGGCACTCTACAGGGGGCGACAAGTGAGACTGTAAAAAAAAAAAAAGAAAAAA","GTCCCTACTAAAAATACAAAAAATTAGCTGGGCCTGGTGGCAGGCACCTGTAATCCCAGCTACTTGGGAAGCTGAGGCAAGAGAATTGCTTGAACCCAGGAGGCAGAGGTTGCAGTGAGCTGACATCAAGCCACTGTACTCCAGCCTAGGCAACAAGAGCAAGACTCTGTCTCAAAAAAAAAAAAAAAAA"
"GL873594","1410711","1410996","chr5","151340503","151340797","76","149929792","CACAGTGGCTCATACCTATAATCCTAACACTCTGGGAGGCCAAGGTGGGTGGACTGTCTGAGTTTGGGACCAGCCTGAGCAAAAGCAAGACTCCCATCTCTACTAAAAACAAAGACAGCCAGGTATGAGGGCAGGTGCCTATCATCCCAGCTACTTGGGAGGCTGAGGAAGGAGGATCACCTAAGCCCAGGACTTTAAGGTTTCTGTGAACTAAGATGATGTTACAACACTCTAGCCAGGGTAACAAGGCAAGATTCTGTTTCAAAAGACAAAAAAAAAAAAAAAA","GGTGGTTCATGCCTGTAATCCCAGCACTTTGGGAGGCTGAGGCAGGTGGATCACCTGAGGTCAGGAGTTCGGGACCAGCCTGGCCAACATGGGGAAACCCCATCTCTACTAAAATACAAAAATTAGCCAGGTATGGTGGCACATGCCTATAATCCCAGCTACTTGGGAGGCTGAGGCAGGAGAATCACTTGAACCCAGGAGGCTAAGGTTGCAGTGAGCCGAGATTGTGCCACTGTACTCCAGCCTGGGTGACAGACTGAAACTCTGTGTCCAAAAAACAAAACAAAACAAAAAA"
"GL873594","5528090","5528162","chr2","69013639","69013718","24","63485549","GGTACAGTGGCTCACGCTTGTGATCCCAGGTTGAGGTGGGTGGATCGCCTGAGCTCAGGAGTTGGATGCCAGC","GGTGTGGTGCCTCACGCCTATAATCCCAGCACTTTGGGAGGCAGGTGGATCACTTGAGGTCAGGAGTTTGAGAACAGCCT"
"GL873594","5834047","5834168","chr2","82491537","82491662","28","76657490","GGCTGGGCCCAGTAGCTCACGACTGTAATCCCAGCACTCTGGGAAGCTGAGGTGGGCGGATCACCTGAGCTCATAGGTTCGAGACCAGCTCCAGTTAGAGTGAGAGCCTGTCTCTAAAAATA","GGCTGGGCACAGTGGCTCATGCCTGCAATCCCAGCACTTTGGGAGGCTGAGGTGGGCAGATCACCTGAAGTCAGGAGTTCAAGACCAGCCTGGCCAACACAGTGAAACCCCATCTCTACTAAAAAT"
"GL873594","5834396","5834461","chr13","14688151","14688212","20","8853755","TATATAATAATAATAACCAGGTATTGTGGCAGGTGCCTCTAGTCCCAGCTACTCGGGAGGCAAAGG","ATAAAAAAATTAGCTGGCCATGGTGGCACATACCAATAATCCCAGCTACTCAGGAGGCTGAG"
"GL873594","7786130","7786294","chr14","12217087","12217250","37","4430957","GGGTGTGCTGGCTCATACCTATAATCCTAGCACTCTGGGAGGCTGAGGTAGGTGTATTGCTTGAACCCAGGAGTCTGAGGTTGCTGTGCGCTAAGCTGATACCATAGCACTCTAGCCTGGGCAACAGAGTGAGACTCTGTCTCAAAACAAATAAATAGTAAAAAA","GCTGGGCGTGGTGGCTCACACCTGTAATCCCAGCACTTTGGGAGGCCAAGGCATGAGAATTGCTTGAAAACAGGAGGCGGAGGTTGCAGTAAGCTGAGACTGTGCCATTGCACTCCAGCCTGGGCAACAAGAGTGAAACTCTGTCTCAGAAAAAAAGAAAAAAA"
"GL873595","723579","723774","chr19","6045933","6046125","65","5322354","GCCTGAGCAGGAGAGAGACCCCATCTCTGCTGAAAGTGGAAAAGTTGGCTGAGTGTAGTGGCGGGCTGCTGCCCCAGTCACTCAGGAGGCTTAGGAAGGAGTATCGCTTGGGCCCAAGATTTGAGGTTGCTGTGAGCGCTACAAAGACATTAGGGTACTCTACACAGGGGAATAGAGTGAGACTGTCTCAAAAAAA","CAACATGGAGAAACCCCGTCTCTACTAAAAATACAAAATTAGGCAGCGTGGTGGTGGGTGCCTATAATCCCAGCTACTCAGGAGGCTGAGGCAGGAGAATCGCTTGACCGGGAGTGGAGGTTGCGGTGAGCTGAGATTGCACCATTGCACTCCAGCCTGGGCAACAAGAGTGAAACTCCGTCTCAAAAAGAAA"
"GL873595","724114","724204","chr20","18199749","18199840","22","17475635","GGCCATGCTTGGTGGTTCTCATCTGTAATCCTAGCACTCTGGAAGGTCTACAGGGGTGGATGGCTGGAGGTCAGGAGTTCAAGACTGGCCT","GGCCGGGCATGGTGGCTCACACCTGTAATCCCAGCACTTTGGGAGGCTGAGGCAGGCGGATCACCTGAGGTCAGGAGTTCGAGACCGGCCTG"
"GL873595","1065346","1065667","chr18","10529729","10530057","74","9464383","GGCCAGGTGCAGCAGCTCATGCCTGGAATCTTCCTGCTCTGTATGGCCAAGGCAGGTGGATCGCCTGACCTCAGGAGTTCCAGACCAGCCTGAACAAGAGCAAGACTCTGTCTCTACTAAAAGTAGAAAAAAAACTAGCCAGTCATAGTGGCAGGTGCCTGTAGTCCCAGCTGCTTGGGAGGCTGAGGCAAGAGGATCACTTGAACCTAAGAGTTTGAGGTTGCTGTGAGCTAAGATGCCACATCACTCTATCAAGGGTGACCAAGTGAGACTCTGTCTCAAAAATAAATAAATAAATAAATAAAAAGAAAGGCAAAAAGAA","GGCCCGGCGTGGTGGCTCATGCCTATAATCCCAGCCCTTTGGGAGGCCAAGGCAGGTGGATCACCTGAGGTCAGGCGTTCGAGACCAGCCTGACCAACGTGGTGAAACCTCATCTCTACTAAATACAAAAAAAATTTAGCCAGGCATGGAGGCACATGCCTGTAATCCCAGCTACTTGGGAGGCTGTGGCAGGAGAATCACTTGAACCTGGGAGGTGGAAGTTGCAGTGAGCTGAGATTGTACCACTGCACTCCAACCTGGGTGACAAAGCAAGACTCGGTCTCAATAAATAAATAAATAAATAAATAAATAAATAAAGTGAAAAAAAA"
"GL873595","1254878","1255146","chr4","42822326","42822607","67","41567448","GGCTGGGCATGGTGGCTCATGCCTGTAATCCTACCGCTCTGGGAGGCTGAGGCAGAGGATCACTTGAGCTCAGGAGTTTCAGACCAGCCTGCAAGAAGGACCCAGTCTCTGCCGAAAATAGAAAAGTTAGCAAGGCGTTGTCGTGAGCACATGTATCCCAGCTACCTAGAACTCTGAGGCAGGAGGATCCCTTGAACCCACAGAAGTTGCTGTTATCTAAACTGATGCCACTGGACTCTAGCCTGGGCAACAGAGTGAGACTGGTCTCA","GGCCGGGCACGGTGGCTCATGCCTGTAATCCTAGCATTTTGGGAGGCTGAGACAGGCAGATTGCCTGAGCTCAGGAGTTCAAGACCAGCCTGGGCTAGATTGTGAAACCCCATCTCTACTAAAATATAAAAATTAGCTGGGTGTGGTGGCACACGCCTGTAATCCCAGCTACCTGGGAGGCTGAGGCAGGAGAATCGCTTGAACCAGGAGACAGAGGTTGCAGTGAGCTGAGATCACGCCACTGCACTTTAGCCTGGGCAACAGAGTGATACTCTGTCTCAA"
"GL873595","3417105","3417297","chr12","115674238","115674427","44","112257133","GGCCGGGCGCTGTGCCTCACGCCTGTAATCCTAATACTCTGAGAGGCCGAGGCAGGTGGATTGCCTGAGCTCAGGTGCTCAAGACAGCCTGACTGAGCAAGCCCTGAGATCCCATCTCCACTAACAATAGTAAAACTAGCCGGGCATTGTGGTGGTGCTTGTAATCCCAGCTACTGGGAGGCTAAGACAGGAG","CCAGGCCTGGTGGCTCACGCCTGTAATCCCAGCACTTTGGGAGGCCGAGGTGGGTAGATCACCTGAGGTCAGGAGTTCAAGACCAGCCTGGCCAACATGGCGAAACCCCATCTCTACTAAAAATACAAAAATTAGCTGGGCATGGTGGTGTATGCCTGTAATCCCAGCTACTCGGGAGGCTGAGGCAGGA"
"GL873595","6098380","6098457","chr3","87492619","87492702","21","81394239","GCTGTGGCTCATGCTGATAATACCAGCACTCTGGGAGAACAAGGTAGGCAGATCACAAGAGGTCACCTGTGCAAGACC","GGGCTGGTGGTGGCTCATGCCTGTAATACCAGCACTTTGGGAGGCCAAGACAGGTGGATCACCAAAGGTCAAGAGTTCAAGACC"
"GL873596","134190","134307","chr1","203207333","203207443","31","203073143","GGCTGGGCGAGGTGGCTCACACCTGTAATCCTAGCACTCTGGAAGGCCCTAGCACTCAGGCAGTTGGATTGCCTGAGCTCACAAGTTCAAGACCAGCCTGAAAAAGAGCAAGACCTCA","GGCTGGGTGCAGTGGCTCACACCTGTAATCCCAGCACTTTGGGAGGCCGAGATGGGTGGATCACTTGAGGTCAAGAGTTGAAGACCAGCCTGGACAACATGATGAGACCCC"
"GL873596","134578","134681","chr11","50235285","50235387","37","50100707","CAAACAAAAGAGGAAGACCTCGTCTCTAAAAAAATAGCTGGGCATTGTGAGGAGTACCTGTAGTCCTAGCTACTCAGAAGGCTGAGACAAGAGAATCACTTAAA","CAACATTGTGAAACCCTGTCTCTACTAAAATAGAAAATTAGCCAGGTGTGTGGGCGTGCCTATAATCCTAGCTACTGGGGAGGGTGAGGCATGAGAATCGCCT"
"GL873596","8160215","8160350","chr1","29437872","29437991","30","21277657","GGCCGGGCGTGGTGGCGCACACCTGTAGTCCCAGCGCTATGGGAGGCCGAGGCGGGTGGATCACCTGAGCTCAGAGGTTCGAGACCAGCCAAGACCCCCCTGAGCCAAACGAGCCAGAGTGAGACCCCGTCTCTAC","GGCCGGGCGTGGTGGCTCACGCCTGTAATCCCAACATTTTGGGAGGCCAAGGCGGGTGGATCACCTGAGGTCAGAAGTTCGAGACCAACCTGGCCAACATGGTGAAACCCCTGTCTCTAC"
"GL873596","8421071","8421132","chr20","1874027","1874093","12","6547044","GTCAGGCGCAGTGGCTCACGCCTGTAATCTCAGCACTCTGAGAAGCCAAGGCAGGATCATCT","GGCCAGGCGCAGTGGCTCAGGCCTGTAATCCCAGCACTTTGGGAAGCCAAGGTGAGCAGATCACCTG"
"GL873598","4416400","4416489","chr5","39418145","39418231","15","35001745","GGCCAAGTGTGGTGGCTCATGCCTGTTGTCCCAGCACCGTGGGAGGCCGAGGCTGGTGGAACACCTGAGCTCAGCTGAGTTTGAGACCAG","GGCCAGTTGCGGTGGCTCATGCCTGTAATCCCAGCACTTTGGCAGGCTGAGGCAGGTGGATCACCTGAGGTCAGGAGTTTGAGACCA"
"GL873598","4416855","4416947","chr3","94091253","94091337","31","89674398","GTGAGACCCTGTCTCTACAAAAAAAAAAGCTGGGCACTGTGGCATGTGCCTGTAATCCCAGCTACTTGGGAGGCAAAGGGAAAGAGAATCACT","AAACCTTGCCTTTACTAGAAATACAAAAATTAGCTGGGCATGGTGGCAGGTACCTGTAATCCCAGCTACTTGGGAGGCTGAGGCA"
"GL873598","5126074","5126161","chr1","12339306","12339394","19","7213232","GCCTGGTGCACTGGTTCACACCTGGAATCCTTGCATTCTGAGAGGCCCAGGTAGGCAGATCACCTCAGCTCAGAAGTTCGAGACCAGC","GCTGGGTGCGGTGGTTCACGTCTGTAATCCCAGCACTTTGGGAGGCCGAGGCGGGCAGATCACCTGAGGTCAGGAGTTCGAGACCAGCC"
"GL873598","5467584","5467662","chr1","9313328","9313403","17","3845744","GCGAGGTGGCTCACGCCTGTAATCCCAGCACATTTGGAAGGCCAAGGAGGGTGGATCACCCGAGCTCACCAGTTGGAGA","CGCAGTGGCTCACGCCTGTAATCCCAGCACTTTGGGAGGCCGAGGCAGGCAGATCACCTGAAGTCAGGAGTTTGAG"
"GL873598","6917752","6917856","chr14","9558287","9558382","22","2640535","GGCCAGGCATGGTGGCTTGTGCCTGTTGTCCCAGCACTGTGGAAGGCCGAGGCGGGTGGATCGCCTGAGCTCAGCTGAATTCGAGACCAGCATAAGACCAGTATG","GGCCAGGCATGGTGGCTTATGCCTGTAATCCCAGCACCTTGGAAGGCCGAAGCGGGCAGATCACCTGAGCTCAGGAGTTTGAGACCAGCCTGTCCA"
"GL873598","8078910","8079062","chr7","164825511","164825660","43","156746601","AACAGCCAGGCATTGTGGTGGGCACCTGTAATCCCAGCTACTTGGGAGGCTGAGGCAAGAGAATTGCTTGAGCCCAACAGTCTCAGGTTACTGTGAGTTATGACACCATGGCACTCTATTGAGGGCAAGAAAGTGAGACTGTCTTGGAAAAAA","CTAGCCAGGCATGGTGGTGCGCACCTGTAGTCCCAGTTACTTGGGAGGTTGAGGCAAGAGAATTGCTTGAGCCTGGAAGGCAGAAGTTGCAGTGAGCTGAGATCACACCACTGCATTCCAGCCTGGGCGAAAGAGCAAGACTCTGTTGAA"
"GL873598","8079328","8079454","chr6","10381248","10381379","32","2301920","GCCCGGCGTGGTGGCTCACGCCTGTAATTCCAGCACTCTGGGGAGGCCGAGGAGGGCAGATTGCCTGAGCTCACAGGTTTGAGCTAGAGCGAGACCCTGTCTCTTAAAAAGAAAAAAAAGGAAAGAA","GCTGGGCGCGGTGGCTCACGCCTGTAATCCCAACACTTTGGGAGGCCGAGGCGGGCAGATCACCAGAGGTGATCTCCAGCCTGGGCAGGAGAGCAAGACCCTGTCTCAAAAAATTTAGAAAAAGGAAAGAAA"
"GL873599","3943256","3943456","chr9","35892110","35892312","79","31948854","GGCAGGCTGCTTTGACCCATATCTACAACTCCAGAACTTTAGAGGCTGAGCTGGGTGGGTCCCTTGAGATTAGAAACTGCTTAGTAGCCTGGCAAAAACCAGACCCCACCTCCACCATGTAGAAAAATTAGCAGTATGCCATAGTGGGAACCTACCAATACAGTCTTTCCAAAGGCCAAAGCTAGAAGGACCGTGAGCTTG","GGCTGGGTGTGGTGGCTCATGCCTATAATTCCAGCACTTTGGGAGGCCGAGGCAGGTGGATCACCTGAGGCCAGGAGTTTGAGACCAGCCTGGCCAATATGGTGAAACCCCATCTCTACTAAAAGTACAGAAAATTAGTCAGTCATGATGGCGCATGCCTATAATCCCAGTTACTCGGGAGGCTAAGGTAGGAGAATTGCTTG"
"GL873599","6693284","6693349","chr1","100916857","100916922","15","94223573","TCACGTCTATAATCCTAGCACTCTGGGAGTCCTTGGCAGGTGGATCACCTGAGCTCAGGAGTTTGA","CATGCCTGTAATCCCAGCACCTTGGGAGGCCAAGGTGGGTGGATCACCTGAGGTCAGTAGTTTGAG"
"GL873600","991618","991705","chr15","13850109","13850195","15","12858491","GGCTGGGCGTGGTGGCTCACACCTGTTGTCCCAGCGCTGTGGGAGGCTGAGGCAGGTGGATCACCTGTGCTCAGAGGTTGAGACCAGC","GCCGGGCGCTGTGGCTCACACTTGTAATCCCAGCACTTTGGGAGGCTGAGGCAGGTGGATCACCTGAGGTCAGGAGTTAGAGACCAG"
"GL873600","8825981","8826014","chr16","43605817","43605844","11","34779836","AGTCTGGGGCAACAGAGCAAGACTCTGTCTCAAA","CAGTCTGGGTGACAGAGCAAGATTCCAT"
"GL873600","8826039","8826157","chr13","87428402","87428520","35","78602363","ATTAGCCTGGTGTGGTGGTATATGCCTTCCTGCCTGCTTGGGAGGCTGAGGCAGGAAGTATGCTTTAACTGTGGAGTCTGAGGTTGCTATGAGCTAGGTTGAGGCCATGGCACTCTAAA","TTAGCCGGGTGTGGTGGTGCACGCCTGTAATCCCAGCTACTCAGGAGGCTGAAGCAGGAGAGTTGCTTGAACCCAGGAGTTGGAGGTTGCAGTGAGCTGAGATCACGCCATTGCACTCC"
"GL873601","269289","269338","chr14","49279240","49279285","14","49009951","GACTGGGTGTGGTGGCTCACACCTTTAATCCTAACACCCTGGGAGGCTTA","GGCTGAGATGGTGGCACACACCTGTAATCCCAGCTACTTGGGAGGC"
"GL873601","269431","269678","chr1","184453273","184453521","76","184183842","AGAAGATCACTCAAGATCAGGAGTTTGAGAACAGCCTGAGCAAGACCCCCATCTTTACTAAAAATGGAAAAGTTTTTACCCAGGCATGGTAGTGCGTGCCTGTATCCCATCTACTCCGGAGGCTGATAGGAGGATTGCTTCAACCAAGGAGTTTGAGGTTCCAGAGACTTAAGATGACACAACTGCATTTTACCCAGTGTGACACAGCGAGACTCTTTCAGAAGAATTTTTAAAAGGAAAAAAAAGAA","GGTCAGATCACCTGAGGTCAGGAGTTTGAGACCAGCCTGACCAACATGGTAAAACCCCATCTCTGCTAAAAATACAAAAAATTAGCCAGGCATGGTGGTGAACGCCTGTAATCCTAGCTACTCAGGAGGCAAAGACAGGAGAATCGCTTGAATCTGGAAGGTGGAGGTTGCAATGAGCCAAGATGACGCCACTGCACTCCAACCTGGGTGACAGAGGAAGACTCCATCAAAAAAAAAAAAAAAAAAAAA"
"GL873601","1397978","1398117","chr16","24839455","24839591","34","23441477","GCCTATAATCCTAGCACTCTGGAAGGCTGAGGCAGGAAGATCACTAGAGCTTGGGAGTTTGAGATTGCTGTGAGGGAGACTGACTCCATGGCACTCTAGCCTGAGGCAACAGAGTAAGACTCCATCTCAAAAAAAAAAAA","CTCTAACTCCAGCTACTCAGGAGGCTGAAGCAGGAAAATCACTTGAACCTGGGAGGTGGAGGTTACAGTGAGCCAAGATCACACCATTGCACTCCAGCCTGAGCGACAGAGCGAGACTCTGTCTCAAAATAAATAAA"
"GL873601","4065502","4065590","chr11","108711352","108711444","19","104645850","GCTGGATGTGGTGGCTCTCACCTATAATCCTAGCACTCTGGGAGGTCAAAACAGGTGGATCACCTGAGCTCAGGAGCAAGAACACCAGC","GTCAGGGGTGGTGGCTCACGCCTGTAATCCCAGCACTTTGGGAGGCCAAGGCAGGTGGATCGCCTGAGCTCAGGAGTTCAAGACCAGCCTTGC"
"GL873601","8241370","8241465","chrY","9469734","9469829","34","1228364","AAAAAAGGTGGAGATGAGCCATGCGCAGTGGTGTAGGCCTGTAATCCCAGCCCTTGGGAGGCCAAAATGGTGGATTGCCTGAAGCAGAGCAAGACC","AAAGTACAAAGAGTCTGGGTACAGTGGCCCAAGCCTGTAATCCCAGCAGTTTGGGAGGACAAGATGGGTAGATCACCTGACATCATGAATTAGAGA"
"GL873569","7519122","7519191","chrX","79016364","79016431","16","71497242","TTGGCCAGGCATGGTCGCTCAGGCTGTAATACCAGCTACTTGGGAAGCTGAAGCAGGAGGATCACTTGAA","TTGGCCAGGCACGGTGGCTCATGCTTATAATCCCAGCTACTCGTGAGGCTGAGGCAGGGGAATCGCTT"
"GL873569","7989158","7989286","chr8","41505677","41505810","35","33516519","AGTCCCACCTATTTGGAAGGCTGAGGCAAGAGGATCACTTGAACTCAGCAGTTTGACATTGCTATGAGTTAGATTGACTCCATGGCACTCTAGCCCAGGCAACAGAGCAAGACTCCGTCTCAAAACAAA","TAATACCAGCTACGTGGGAGGCTGAGGCAGGAGAATCACTTGAACCCGGGAGGTGGAGGTTGCAGTGAGCTGAGATTGCACCGTTGCACTCTAACCTGGGCAACAAAAGCAAAACTCTGTCTCAAAAAAAAAAA"
"GL873569","7989575","7989702","chr1","62231025","62231129","47","54241450","GGCTGGGTAATGCAGTGGCTCACGCCTATAATCCTAGTGCTTTGAGAGGCCAAGAGTGAGACTCTGTGTACTAAAAATAGAAAAATTACCTAGGCATTCTGGTGGGCACCAGTAGTCCCACCTATTTG","GGCTGGGCATGGTGGCTCACGCCTATAATCCCAGCACTTTGGGAGGCCGAGGCAGGTGGATCACCTGAGATCAGGAGTTTGAGACCAGACTGGCCAACATGGTGA"
"GL873569","10034363","10034556","chr10","61268396","61268605","62","51234033","CAGCTTGAGCAAAAGTGAGCCCCTGTCTCTACTGAAAATAGAAAAAATTAGCCAGGCGTGGTGGCACACACTTATAGTCCCAGCCACTTAGGAGGCTGAGGCAGGAGTTTGAGGTTGACATAATCTAAGCTGATACCATAGCACTCTAGCCTGGGCAATAGAGTGAGACTCTGTCTCAAAGAAGAAATTTATCT","CCTGACCAATGGTGAAACCCTGTCTCTACCAAAAATACAAAATTTAGCTGGGCATGGGGGCACGCACCTGTAGTCCTAGCTACTCGGGAGGCTGAGACAGGAGAACTGCTTGAACTCGGGAGGCAGAGGTTGCAGTGAGCTGAGATCATGCCACTGCACTCTAGCCTGGGCAATAGAGTGAGACTCCGTCTCAAAAAAAAAAAAAAAAAA"
"GL873569","10034830","10034845","chr1","217667782","217667796","2","207632952","AAAAAAGAAGAAAAAA","AAGAAAAAGAAAAAA"
"GL873569","10203815","10203922","chr8","96374555","96374671","35","86170740","GCCAGGTGTAGTGGTTCACACCTATAATCCTAGCACTCTGGGAGCCTGAAGCAGGTAAATGGACTGAGCAAGAGTGAGACTTCCACCTCTATTGAAAATAGAAAAATT","GGCTAGGTATGGTGGCTGATGCCTATAATCCCAGAATTTTGGGAGGCCGAGGCAGGCAGATCATCTGAGGTCAGGAGTTTGAGACCAGTCCCGTCTCTACTAAAAATACAAAAATTA"
"GL873569","10204196","10204373","chr20","1304385","1304559","47","8899811","GAAAATAGAAAAATTAGCCAGGCATTATAGCAGGCACCAGTAATCCCAGTTACTTGGGAGGCTAAGGCAAAAGAATCTCTTGAGCCCAAGTTTGGGGTTGCTAGGAAGTAAAACACCACAGCACTATACCCAGAACAAGAGAGTGAAGACTCAGTCTCAAAAAGATAAATAAATAAAA","AAAAATACAAAAATTAGCCAGGCATGGTGGCGGGCGTCTGTAACTCCAGCTACTTGGGAGACTGAGGCAGGAGAATCGCTTGAACCCAGGAGGCAGAGGTTACAGGTGAAATCACACCACTGCACTCCAGCCTGGGCAACAGGGCAAGACTCTGTCTCAAAAAAAAAAAAAAAAA"
"GL873569","10473375","10473444","chr8","20660648","20660717","21","10187273","TGTAGTCCCAGCACTTTGGGAGGTTAAGGCAAGAGTAGCACCCAACATGAGGAGATCAAGACCAATCTGG","CTGTAGTCCCAGCACTTTGGGAGGCTGAGGCAGGTGGATCCTTTGAGGGCAGAACTTTAAGACCAGCCTG"
"GL873570","9287350","9287485","chr1","29437872","29437991","30","20150522","GGCCGGGCGTGGTGGCGCACGCCTGTAGTCCCAGCGCTATGGGAGGCCGAGGCGGGTGGATCACCTGTGCTCAGAGGTTCGAGACCAGCCAAGACCCCCCTGAGCCAAACGAGCCAGAGTGAGACCCCGTCTCTAC","GGCCGGGCGTGGTGGCTCACGCCTGTAATCCCAACATTTTGGGAGGCCAAGGCGGGTGGATCACCTGAGGTCAGAAGTTCGAGACCAACCTGGCCAACATGGTGAAACCCCTGTCTCTAC"
"GL873571","3669989","3670207","chr4","116777080","116777297","60","113107091","AGACCAGCCTGAGGAAGAGCAAGATCCCATCTCTATTAAAAATAGAAAAATTAGCCAGGCATTCTGGTGGGCACCTGTAGTTCTAACCACCTGGGAGGCTAAGGCAAGAGGAACTCTTCAACCCAAGAGTTTGAGGTTGCTGAGAGCTAGGCTAAGGCTGCAGCACTCTAGCCTGGGCAACAGAGTGAGACTGTTTCTCAAAAACAAAAAACAAAAAAA","CGAGACCAGCCTGGTCAATATGGTGAAACCCCGTCCCTACTAAAAATACAAAAATTAGCCAGGCATGGTGGCAGGCACCTGTAGTCCCAGCTACTCGGAAGGCTGAGGCAGGAGAATCGCTTGAACCACAGAGGCAGAGGTTGCAGTGAGCCGAGACTGCACCACTGCACTCCAGCCTGGGCGACAGAGTGAGACTCAGTCTCAAAAAAAAAAAAAAA"
"GL873571","106134","106236","chr4","18143723","18143826","27","18037589","GGCCAGTCTCAGTGGCTCACACCTGTAATCCAGCATTCTGGGAGGCTGAAGCACACGGTCACCTGAGCTCAAAGGTTGGAGACCAGAGTGAGACCCCACCTCT","GGCCAGGCGCAGTGGCTCACTCCTGTAATCCCAGCACTTTGAGGCTGAGGCAGGCGGATCACCTGAGGTCAGGAGTTTGAGACCAGCCTGGCCGAAACCCCATC"
"GL873571","3670496","3670589","chr7","50468399","50468491","15","46797903","GGGCAGGCATGGTGGCTCACACCTGTAATTCTAGCACTCTTGGAGGCTGAGGCAGGAAAATGGCTTGAGGTCAGGAGTTCAAGACCAGCCTGAG","GGCCAGTCATGGTTGCTCACACCTGTAATACCAGCACTTTGGGAGGCCGAGGCAGGCGAATCACCTGAAGTCAGGAGTTCAAGACCAGCCTGG"
"GL873571","4059090","4059389","chr7","52903696","52903994","88","48844606","GGCCAGGTGCAGTGGTTCACACTTATAATCCTAGCACTCTGGGAGGCCGAGGCGAGTGAAGTGCCTGAGCTCATGGGTTCAAGACCAACCTAAGCCAGAGACCCCTGACTCTTATAATAGCCTGGCATTGTGGTGGGCGCCAATATTTCCAGCTACTCTGAGGCTAAGGCAAGAGAATTGCTTGAGCCCAGGAGTTGGAGGTTTCTGTGAGCACTGACGCCGCAGCTCTCTACCAAGGGCAACAAAGACTCTGTCTCAAAAAATAAATAAATAAATAAATAACAGAATGAAAATGAAAAA","GGCCGGGTGCGGTGGTTCACGCCTGTAATCCCACCACTTTGGGAGGCTGAGGCAGGCAGGTCACCTGAGGTCAGGAGTTCCAGACCAGCCTGGCCAACATGGTGAAACCTTGTCTCGGCTATTAGCCTGGCATGGTGGTGCGTGCCCATAATCCCAGCTACTCAGGAGGCTGAGGCAGGAGAATCGCTTGAACCCAGAAGGTGGAGGTTGCAGTGAGCCAAGATAGCACCACTGCAACTCCAGTCTGGGCAACAGAATGAGACTCTGTCTCAAAAAAAAAAAACAAAAAACAAAAAGAA"
"GL873571","4209418","4209704","chr11","32517699","32517985","80","28308281","GGCTTGGCAAGGTGGCTTACACCTCAAATCCTAGCACTGTGGGAGACTGAGGCAGGTGGATTGTTTGAGCTCAGGAGGTCAAGATAGAGAGCAAGAGCAAGTCTCTGTCTCTACTAAAAATAGAAAAGAACTACTTCCCGGGGGTCATGGCAGTAGCCTGTAATCCCAGTTACTAGGTAGAATGAGGCAAGAGGATCTGTTGAAGCCAAGAGACTGAGGTTGTTATGAGCATGCCACAGCACTCTACCCAGGGTGACAGAATGAGACTCTGTTGAAAGAAAAAAAGA","GGCCGGGTGCAGTGGCTCACACCTGTAATCCCAGCACTTTGGGAGGCTGAGGCGGGTGGATCACCTGAGGTCAGGAGTTCAAGACCAGCCTGACAAACATAGTGAAACCCTGTCTCTACTGAAAATACAAAATTAGCCAGGTGTGGTGGCGCATGCCTGTAATCCCAGCTACTCGGGAGGCTGAGGCAGGAGAATTGCTTGAATCCAGGAGGTGGAGGTTGTGTGATCACACCACTGCACTCCAGCCTGGGCGACAGAGTGAGACTCTGTCTCAAAAAAAAAAGAAA"
"GL873571","4209985","4210154","chr3","175781758","175781928","60","171571773","GAAAGAAATGAAAAGAAAGAAGTTAGCTGGTTGTTGGGGTATGCTTCTATAGTCCCACCTACTCAGAAAGCTGAAATCTGGAGTTTGGGGTTGTTGTAAGGTAGGCTGATGACATAGCACTGTAGCTTGGGCAAGAGAGTGTGACTTTGTCTCAAAAAAAATTAAAACAA","ATTAAAAACACAAAGATTAGCCAGGTGTGATGGCACACAACTGTAATCCCAACTACTCAGGAGAATCGCTTGAACCTGGGAGATAGGGTTTGCAGTGAGCCAAGATTGTGCCACTGCACTCCAGCCTGGGTGACAGAGTGAGACTCTGTCTCCAAAAAAAAAAAAAAAAAA"
"GL873571","4210444","4210570","chr17","16655655","16655789","35","12445211","GCCAGGCAGATGGCTCACACTTCATCCTAGCCCTCTGGAAGGCTGAGGCAGGCTAATTTTTTGAGGTTAGGAGTTTGAGACCAGCCTGAGGAAGAGACCCATCTCTACTTTAAAAAATAAATGGAAA","GCCAGGCATGGTGGCTCACACCTGTAATCCTAGCACTTTGGGAGACTGAGGCGGGTGAATCACCTGAGGTCAGGAGTTTGAGACCAGCCTGACCAGTATGGTGAAACCCAGTCTCTACTAAAAATACAGAAATTA"
"GL873571","4391733","4391878","chr11","33723808","33723943","46","29332075","AACTTAGCTGGGAATGGTGGCTCAAGCCTGTAATCCTAGCACTCTGGGAGGCTCAGGTGGGAGGATCACTTGAGGTTGCTGTGAGCTTGGCTGATGCCAGGACACTCTAGTGTGGGCAAGAGAGTGAGACTCCGCCTCAACAACAA","GCCGGGTGCAGTGGCTCATACCTGTAATCCCAGCACTTTGGGAGGCTGAGGTAGGCGGATCACGAGGTCAGGAGCTGAGATGGCGCCACTGCACCCCAGCCTGGGTGACAGAGCAAGACTCTGTCTCAAAAAAAAA"
"GL873571","6307773","6307841","chr9","62429628","62429694","22","56121855","CTGGGTGTGGTGGCATTGCACCTGTAATCCTAGCTACTTGGAAATCTTAAGCCCAGGAGTTGAAGACTG","CCCAGCATGGTGGTGCATACCTATAATCTCAGCTACTTGGAGGCTTGAGCTCAGAAGTTTGAGACCG"
"GL873571","6496217","6496306","chr1","27257765","27257856","27","20761548","GCAGGGTGTGTTGACCCACACCCACAATTCCAGGACTCTGGGGGGCCAGGGATGGTGGGTTCCCTCAGATCAGGAGCTCCTTACCAGCCT","GACTGGGCATGATGGCTCAAATCTGTAATTCCAGCACTTTGGGAGGCCGAGGTGGGTGGATTGCCTGAGATCAGGAGTTCAAGACCAGCCTG"
"GL873571","6499738","6499903","chr1","38976375","38976555","47","32476637","AAAATAACATGAATTGACTAGGCGAGGTGGCTCACATCTCTAATCCTAGCACTCTGGGAGGCTGAGGCAGGAGAATTGCATGAGGTTGCTGTGAGCTATGATGATACCACGGCATTCTAATCAGGGTGACAGAGTGAGATTCTGTCTTAAAACAAACAAACAAAAA","AAAATAAATAAATTAGCAGGGCCTGGTGGCGCACACCTGTAATCCCAGCTACTTGGGAAGCTGAGGCAGGAGAACCCACTTGAACCTGGGAGCCGGAGGTTGCAGTGAGCTGAGATGGCACCACTGCACTCCAGACTGCGTGACAGAGTGAGACTCCGTCTCAAAAACAAACAAACAAAAA"
"GL873571","11399575","11399872","chr15","109458692","109458994","79","98059117","CAGTGGCTCACACCTGTAAATCTAACACTCTGGGAGGCCAAGGTGGGTGGATCCCTTGAGCTCAGGAATTTGATACCAGCCTGAGCAAGAGTGAGACCTTGTCTCTACTAATAATAGAAAAATAGCCCGTGTTGTGGCACTTGTCCCAACCACTGGGGAGGCTTTAGGCGGGAGGATTACTTGAATTGGGAGTTTGATATTGCTGTGAGCTGGGCTGATGCCTTGGCATTCTAGCTTGGGTAACAGCGTAAGACTCCGTCTCAAATAAATAAATAAATAAATAAAAAGAAAAAAAGAA","GTGGCTCACACCTGTAATCTCAGCACTTTGGGAGACCGAGGCAGGTGGATCACCTGAGGTCGGGAGTTTGAGACCAGCCTGACCAACGTGGAGAAACCCCGTCTCTACTAACAATACAAAATCAGCTGGGCGTGGTGGTGCATGCTTGTAATCCCAGCTACTCGGGAGGCTGAGGTAGGAGAATCGCTTGAACCTGGGAGGTGGAGGTTGCGGTGAGCCGAGATCGAGCCACTGCACTCCAGCCTGGGTGACAGAGCAAGACTCCATCTCAAAAAAAAAAAAAAAAAAAAAAAAAAAAAAAAA"
"GL873572","114760","114841","chr8","26280134","26280211","16","26165374","GGCCAGGCATGGCGGCTCTTCCCTGTAATCCTAGCACTCTGGGAGGGCGAGGCAGGCAGATCACCTAGGCTAGGGTGAGATC","GGCCAGGAATGGTGGCTCATGCCTGTAATCCCAGCACTTTGGGAGGCTGAGGCAGGCAGATCACCTGAGGTCAGGAGT"
"GL873572","9421791","9421892","chr11","8089184","8089269","35","1332607","TACTAAATATATAGCAAGGCCAGGCACAGTGGTTCATGGCTGTAATCCCAGTACTCTGGGAGGCCTAGTCAGAGTTGACCTGAGATCAGGCTAGAAGCCTGG","ATAAAAATAATTGGAGGCCAGGCACGGTGGCTCATGCTTGTAATTCTAGCAATTTGGGAGGCTGACGCGGGTGAGATCATACTGAG"
"GL873572","11052834","11053035","chr14","11857478","11857657","65","804644","TCCACAAAGAAAGCAGAAGTGTGGCCGGGTGGTAGCTCAAGGCAGGAATCCCAGCACTCTGGGAGCTGGGAGGTGGGGGAGGATCCCTTGAGATCAGGAGTTGGAGGGCACAGTGAGCCTGGGGGAGGCCACTGTCTCTGTACTCTAGCAGGGAGACAGAGCAAGACTGCCCATTCAAAGAAAAACAACAAACAAAACAAAA","TACAAAAATTAGCTGGGCACGGTGCCACAAGCCTGTAATCCCAGCTACTCGGGAGGCTGGGCAGGGGAATAGCTTGAACCCAGAGGTGGAGGTTGCAGTGAGCCAAGATCAAGCCACAGCACTCCAGCCTGGGTGACAGAGCAAGACTCCATCTCAAAAAAAAAAAAAAAAAAAAAAAAA"
"GL873573","2564195","2564244","chr1","109985445","109985491","12","107421250","TACAAAAATTAGGCTGGGCTTGGTGGTTCACGCCTATAATCCTAGCACTT","ACTAAAATTAGCTGGGCATGGTGGTGCATGCCTGTAATTCCAGCTAC"
"GL873573","7423371","7423533","chr2","202783328","202783513","56","195359957","GGTGGCTCACACCTGTAATCCCAGCACTCTGGGAGCCCTGGTGGCTCATGTCTATAATCCTAGTACTCTGGGAGACCATGGTGGCTCATGTCTATAATCCTAGTACTCTGGGAGCCATGGTGGCTCACGCCTATAATCCTAGTACTCTGGGAGACCATGGTGG","GGCTGAGGCGCGGGGGCTCACGCCTGTAATCCCAGCACTGTGGGAGGCCGAGGCGGGTGGATCACGCCTGTAATCCCAGCACTGTGGGAGGCCAAGGCGGGTGGATCACGCCTGTAATCCCAGCACTGTGGGAGGCCGAGGCGGGTGGATCACGCCTGTAATCCCAGCACTGTGGGAGGCTGAGGC"
"GL873573","9657648","9657710","chr19","10207852","10207913","10","550204","TAAAAATAAAAAATTTAGCTGGATGTGGTGGCTCACACCTGTAATCCTAGCACTCTGGGAGAC","TAAAAATACAAAATTAGCTGGGTGTGGTGGCACACACCTGTAATCCCAGCTACTCAAGAGGC"
"GL873574","1624662","1624783","chr9","814961","815079","36","809701","GACTGGGTGGGTTGGATCATGCCTGGAATCCTAGCACCCTGGGAGGCCAAGGTGAAAGGATTGCTTGAGGTTAGGAGTTCCAGAAATGTAGCAGTCATGGTGACTTCATCCTTCTCTACCAA","GGCTGGGTGCTTTGATTCATGCCTGTAATCCCAGCACTCTGGGAGGCCGAGGCAGGTGGATCACCTGAGGTTAGGAGTTCGAGACCAGCTTGGCTAACATGGTGAAACCTCGTCTCTAC"
"GL873574","4459477","4459612","chr1","29437872","29437991","29","24978395","GGCCGGGCGTGGTGGCGCACGCCTGTAGTCCCAGCGCTATGGGAGGCCGAGGCGGGTGGATCACCTGAGCTCAGAGGTTCGAGACCAGCCAAGACCCCCCTGAGCCAAACGAGCCAGAGTGAGACCCCGTCTCTAC","GGCCGGGCGTGGTGGCTCACGCCTGTAATCCCAACATTTTGGGAGGCCAAGGCGGGTGGATCACCTGAGGTCAGAAGTTCGAGACCAACCTGGCCAACATGGTGAAACCCCTGTCTCTAC"
"GL873574","4681987","4682216","chr6","153082888","153083127","73","148400901","GGGTGCGGTGGCTCAGACCTATAATCCCAGCACTCTGAGAGGCCGAAGTGGGTGGATCACCTGAGCTCAGGAATTTGAGACCAGCCGTCTCTAAAAATAGCTGAGTGTTGTGGCAGTGGCTGTAAGTCCCAGCTGTTTGGAAAGCTGAAGCAAGGGAATCACTTGAACCCAAGAGTTTGAGGTTGCTGTGATGACAAAGTGAGACTCTATCTCAAAAAAAAAAAAAAAAA","GGCCGTGCGCGGCGGCTCACGCCTGTAATCCCAGCACTTTGGGAGGCTGAGGTGGGTGGATCACCTGAGGTCAGGAGTTTGAGACCAGCCCGACCAGAAATTAGATGGGTGTGGTGGTGCGCTCCTGCAGCCCCAGCTACTTAAGAGGCTGAGGCAGGGTAATCACTTGAACCCGGGAGGCGGAGGTTGCAGTGAGCCGAGCTCACGCCACTGCACTCCAGCCTGGGTAACAGAGCGAGA"
"GL873574","4709916","4710039","chr19","13152422","13152536","46","8442506","AAAAATAGAAAAACTAGCCAAGCATGGTGGTGCACCCCCTATAGTCTGAGCTCCTCAGCGGGCTGAAGCAAAAGGACGGCTGGAGCCCTGGAGTTTGAGGTTGCTGTGAGGCAAGGTGATGCCA","ACACATAAATTAGCCAGACATGATGGTGAGTATCTGTAATTCCAGCTCCTTGGGGGGCTGAGGCGGGAGAATTGCTTGAACCTGGGAGGCAGAGATTGCAGTGAGCCAAGATCGC"
"GL873574","6353839","6353913","chr5","25768079","25768163","22","19414240","AAAAATATAGCAAGGCCAGGCATGGTGGCTCACACCTATAATCCCAGTACTTGGGAGCTGGAATTTGAACCTAGG","AAAAAACTCAAACAAGGCTGGGCGTGGTGGCTCACACCTGTAATCCCAGCACTTTGGGAGGCTGAGGTGGGTGGATCACCTGAGG"
"GL873574","6533061","6533332","chr5","85182161","85182439","81","78649100","GGCTGGGCGAGGTGGCTTACACCTATAATCCTAGTACTCTGGGAGGCCAAGGTGGGTGGATTGCCTGAGCGCACAGTTTCAAGACCAGCTGGAGCCAGAGAGAGAGAGAGAGACCCTGCCTCTAAAAATAGCCAGGCATTGTGGCAGGCACCTGTAGTCCCAGCTACTTGGCAGGCGGAGGTATGAGAATCGCTAGAGGTTGCTGTTAGCTATGATGCCATAGCACTCTACCAAGGGCGACAAAGTGAAACTCTGCCTCAAAAAAAAGAAGA","GCCAGGCGTGGTGACTCAAGCCTGTAATCCTAGCACTTTGGGAGGCCAAGGTGGGCGGATTGCCTGAGCTCAAGAGTTTGAGACCAGCCTGGGCAACACGGTGAAACCCAATCCCTACTAAATACAAAAAAAATTAGCCGGGTGTGGTGGTGTGAACCTGTAGTCCCAGCTACTCGGGAGGCTGAGGCAGGAGAAGGCAGAAGTTGCAGTGAGCCGAGATCACACCACTGCACTCCAGCCTGAGTGACAGAGCAAAACTCTTTCTCAAAAAAAAAAAAA"
"GL873574","6643746","6643907","chr2","92627944","92628105","46","85984198","AAATAGCCAGGCGTTGTGGCAGGCACCTATAGTCCCAGCTACTTGGGAGGCTGAGGCAAGAGAATCACTTAAGCCCAAGTGACAGAGGTTGCCAGGGCACTCTACGTAGGCAACAGAGTGAGACTCTATCTAAGAAAGAAGGAAGGAAGGAAGGAGAAAGAA","TTAGCCGAGCATTGTGGTGCGCGCCTGTAGTCCCAGCTACATGGGAGGCTGAGGCAGGAGAACACCTGAACCCAGGATGTGAGCTGAGTCGCGCCATTGCACTCCAGCCTGGGCAACAGAGTGAGACTCCATCTCAAAAATAAAATAAAATAAAATAAAAAA"
"GL873574","6644163","6644274","chr1","128607504","128607619","20","121963341","CTGTAATCCTAGCACTTGGGAGGCTGAGGCAGGTGGATCACCTGAGTTCAGGAGTTCAAGACCAGCCTAAACAAGAGTGAGACCCTATCTCTACTAAAAATAGAAAAAATAT","GCCTGTAATCCAAGCACTTTGGGAGGCTGAGGCGGGTGGATCACCTGAGGTCAGGTGTTCGAGACCAGCCTGGCCAACGTGGTGAAACCCCAACTCTACTAAAAATACAAAAATTA"
"GL873574","8511822","8512127","chr1","23439759","23440073","84","14927937","GGTGGCTGGTGCCTGTAATCCTAGCACTCTGGGAGACTGAGGCAGGTGGATCACTTGAAATCAGGAGTTTGAGATCAACCTGAGCAAGAGATCTTGTCTCTCCTAAAGATAGAAAAACTAGCTGGGATTTGTGGTGGACACCTGTAATTTCAGCTACTCAGGAAGCTAAGGCAAGAGCATTGCTTAAAACCAGGAGTTTGAAGTTGATGTGAGCTAGGATGTCAGGGCAGGTTACCCAGGGTGACAGAGTGAGACTCTGTGTCAAAATAAACAAACAAACAAACAAACAAAACAAAATAAAATAAA","GGCTGGACATGGTGACTCACGCTTGTAATCCCAACACTTTGGGAGGCTGAAGCAGGCAGATCACCTGAGGTCAGGAGTTTGAGACCAGCCTGACCAACATGGTGAAACCTTGTCTCTACTAAAAATACAAAAATTAGCTGGGAGCAGTGGTGCACACCTGTAATCCCAGCTACTCGGCAAGCTGAGGCAAGATAATTTTTTAAACCTGGGAGGTGGAGGTTGCAGTGAGCCAAGATCGTGCCACTGTACTCCAACCTGGGAGACAGAGCAAGACTCTGTCTCAAAAAAAAAAAAAAAAAAAAAAAAAAAAAAAAA"
"GL873575","2107336","2107519","chr4","38052972","38053149","54","35945636","TCAATTAAAAACTTTTTAAAATGAGGCTGAGCATGGTGGTTCACACCTGTAATCCCAGCACTTTGGGAGGCCGAGGCAGGAGGATCACCTGATCCCAGGAGTCCAAGCCTACAGTGAGCCGTGATAATACCACTGCACTTCAGCCCAAAGCCTCAAAAAGAAAAAAAAAAAAGGATAGACAAGA","TATATATATATATATTATTTTGGGGGGGCATGGTGGTGCACACCTGTAATCCCAGCTACTCGGGAGGCTGAGGCAGGAGAATTGCTTGAGCCCGGGAGGCAAAGGTTGCATTGAGCTGAGATCACACCACTGCACTCCAGCCTGGCGACAGAGTCTCAAAAAAAAGAAAAAATAAAAA"
"GL873575","5831824","5831959","chr1","29437872","29437991","28","23606048","GGCCGGGCGTGGTGGCGCACGCCTGTAGTCCCAGCGCTATGGGAGGCCAAGGCGGGTGGATCACCTGAGCTCAGAGGTTCGAGACCAGCCAAGACCCCCCTGAGCCAAACGAGCCAGAGTGAGACCCCGTCTCTAC","GGCCGGGCGTGGTGGCTCACGCCTGTAATCCCAACATTTTGGGAGGCCAAGGCGGGTGGATCACCTGAGGTCAGAAGTTCGAGACCAACCTGGCCAACATGGTGAAACCCCTGTCTCTAC"
"GL873575","7451097","7451208","chr3","122814630","122814743","22","115363533","GGCCAGGTGTGGTGGCTCACACCTGTTATCCTAGCACTCTGAGAGGCCACAGCAGCTGGATCACTTGAGCTCAGGAGTTCAAGACCAGTCTGAGCAAGAGCAAGACCTCACC","GGCTGGGTGTGGTGGCTCATGCCTGTAATCCCAGCACTTTGAAAGGCCAAGGCAGATGGATCACTTGAGGTCAGGAGTTCCAGACCAGCCTGGCCAACATGGCAAAACCCCATC"
"GL873575","7451277","7451445","chr6","58863249","58863409","41","51411972","AAAAATTCAGCCAGCCACAGTGGAAGTGGATGCCTGCCATCACAGCTACTCTGGGGGCTGGGGCAAGAGAATTGCTTGATCCCAGGAGTCTGAGGTTGCTGTGACCTAGGCTGACACCACAGCACTCTACCCAGGGTGACAGAGTGAGGCTGTGTTTAAAAAAAAAAAA","TTAGCCAGGCATGGTGGCACATGCCAGTAATCCCAGCTACTCAGGAGGATGAGGCAGGAGAATCGCTTGAACCCAGGAGGCAGAGGTTGCAGTGAGCTGAGATTGCGCCACAGCACTCTACCCTGGGTGACAGAAGGAGACTCTGTCTCAAAAAAAAAAAA"
"GL873576","1765109","1765185","chrX","53921180","53921256","12","52156071","GGCCAGGTGCAGTGGCTCATATCTGTAATCCTAGCACCCTGGGAGGCCAAGGTAGGCGAATCACCTGAGGCCAGGAG","GGCCAGGTGCAGTGGCTCACGCCTGTAATCCCAGCACTTTGGGAGGCCGAGGTGGGCGGATCACTTTAGGTCAGGAG"
"GL873576","2711577","2711895","chr7","6620384","6620702","85","3908807","GGTCGAGCTTGGTGGCTCATGCTTGTAATCCTAGCACTCTGGGAGGCCAAGGCAGGTAAGTTGCCCTGAGCTCATAGGTTCCAGATCAGCATGAGCCAGAGTGAGACCCTGTCTCTACCAAAAAATAGCCCGGCATTCTGGCAGGTGCCTGTAATCCCAGCTGCTTGGGAGGCTGAGGCTAGAGAATCACTTAAACCCAAGGGTTAGTGGAGGTTGCTGTGAGCTATGATTCCACCGTACTCTACTGAGGGCCACAAAGTGAGACTCTGTCTCCATAAAAAAGAAAGAAAGAAAGAAAGAAAAATAAAATAAAATAAAA","GGCCAGGCACAGTGGCTCATGTCTGTAATCCCAGCACTTTGGGAGGCCGAGGCGGGTGGATTACCTGAGGTCAGGAGTTCTAGACCAGCCTGGCCAACAAGGCGAAACCCTGTCTCTACTAAAAATACAAAAAATTAGCTGGGCGTTTTGGCACATGCCTGTAATCCCAGCTACTTGGGAGGCTGAGGCAGGAGAATTGCTTGAACTGGGGAAGTGGAGGTTGCAGTGAGCTGAGATCACACCATTGCACGCCTGAGCAACAGAGCGAGACTCTGTCTCAAAAAAAAAAAAAAAAAAAAAAAAGAAAAGAAAAAGAAAA"
"GL873576","4782520","4782652","chr9","61136941","61137074","22","56354421","CCAGGCACGGTGGCTCACCCTTGTAACCCTAGTACTTTGGGAGGCTGAGGTGGGAGGATCCCTTGAGGTCAGGAGTTCAAGACCAGCCTGAACAACAGTGAGACCCCCGTCTCTACTAAAAAATAGAAAAGTT","GCCAGGCACGGTGGCTCACGCCTGTAATCCCAGCACTTTGGGAGGCTGAAGCGGGCGGATCACCTGAGGTCAGGAGTTCAAGACCAGCCTGGGCACCATGATGAAACCCCGTCTCTATTAAAAATACAAAAATT"
"GL873576","4782930","4783078","chr7","57521645","57521803","40","52738715","AGTTAGTCTGGTGTCATGGTGGGTGCCTGTAGTCCCAGCTGCTTGGGAGGCTGAGGCAAGAGAATCACTTGAGCCCAGGAGTTGGAGGTTGCTATGAGCGAGGCTGTAGCCTAGGCAACAGAATGAGACTTTGCCTCAAAAAAATAAAA","TTAGCTGGGCATGGTGGCGCATGCCTGTAGTCCCAGCTACTTGGGAAGCTGAGGCAGGAGAATCACTTGAACCTGGGAGGTGGAGGTTGCAGTGAGCTGAGATCGCACCGCTACACGCCAGCCTGAGCAACAGAGAGAGACTCTGTCTCAAAAGAAAAA"
"GL873576","7828709","7828723","chr5","101042981","101042996","1","93214272","TAAATAAATAAAAAA","TAAATAAATAAATAAA"
"GL873576","7828960","7829230","chr13","49045537","49045844","89","41216577","GCCGGCTGCAGTGGCTATAATCCAAGTACCCTGGGAGGCTTAGGTGGATGGATCACTTGAGCTCAGAAGTTCAAGACCAGCCTCAGCAAGAGGTAGACCTTGCCTCTATTAAANNNNNNNNNNNNNNNNNNNNNNNNNNNNNNNNNNNNNNNNNNNNNNNNNNNNNNNNNNNNNNNNNNNNNNNNNNNNAGTTTGAGGTTGCTGTGAGCTATGATGAAGCCAGGGCATTCTACCCAGGGTGACAGAGTAACTCTTAAAAAAAACTAAACAA","GGCCAGGCAGAGTGGCTCATGCCTGTAATTCCAGCAATTTGGGAGGCCTAGGCAGGCAGATTACCTGAGGTCAGGAGTTTGAGACCAGCCTGGCCAACATGGTGAAACCCCGTCTCTTCTANNNNNNNNNNNNNNNNNNNNNNNNNNNNNNNNNNNNNNNNNNNNNNNNNNNNNNNNNNNNNNNNNNNNNNNNNNNNNNGGAGATAATAGCTTTTGTAGAACGAAGCGATGCAACAGCCAGATCGCCGCCACCACCCTTAGGTCCTGGCGACAGAGTGAGATCCATCTTAAAAAAAAAAAAAAAAAAA"
"GL873576","10622840","10623093","chr7","60266447","60266705","74","49643607","GCTGGGTATGGTGGTTCACACCTATAATCCTAGCACTCTGGGAGGCTGAGGTGGGAGGATTGGTGGAGCTCAGGAGCTCATGAGGTGCCAAATCACTGGTGCCACACACCTGTATTCCCAGCTACTGAGGAGGCTGAGGCAGGAGGATCAGGTAAGCCCAGGAAGTTTGAGGTTGTAGTGAGTTAGGATGATTGAACTCTGCCTTGAGAGACAGAGCAAGATCCTCCTTCCTCCTAAGCAAACAAACAAATAAA","GGCTGGGTGCAGTGGCTCACACCTGTAATCCTAGCACTTTGGGAGGCTGAGGCGGGAAAATTGCCTGAGCTCAGGAGTTCAAGGACAGCCTAGGCAACATAGCATGGTGGTGCACGCCTGTATTCCCTGCTACTTGGGAGGCTGAGGCACAAGAATTGCTTGAATCCGGGAAGTGGAGGTTGCAGTGAGCCATTGTGGCACTGCTCTCCAGTCTGGGTGACAGAGCAAGACTCCATCTCAAAAAAAAAAAAAAAAAAAA"
"GL873576","10819939","10820007","chrX","67133632","67133707","21","56313693","AGGTTGCAGTGAAATTGTACCATTCCAATGAAGCCTGGGGGACAGAGTGAGATTCTCTCAAAATAAAAA","GGAGGTTGCAGTGAACCGAGATCGTGCCACTGCACTCCAGCCTGAGCGACAGAGTGAAACTTCGTCTCAAAAAAAA"
"GL873576","10920306","10920363","chr3","48261745","48261808","16","37341439","GCTGGACCTTGTAGAGAGTGCCTGTAATCCCAGCTACATGGGGGGCAAGAGAATTGCT","GCTGGGCATGGTGGTGCATGCCTGTGATCCCAGCTACTCAGGAGGCTGAGGCAGGAGAATTGCT"
"GL873576","10920398","10920529","chr10","67341428","67341546","30","56421030","GGCCAGGCGTGGTGGCTCACGCCTGTTGTCCCAGCACTGTGGGAGGCCGAGGTGGGTGGATTGCCTGAGCTCAGAGGAGTCCGGAAGACCAGCATGAGGCAGAGTGAGCCAGAGTAAGATCCTGTCTCTACC","GGCTGGGTGTAGTGGCTCATGCCTGTAATCCCAGCACTTTAGGAGGCCAAGGTGGATGGATTGCCTGAGCTCAGGAGTTCGAGACCACCCTGGGCAACAAGCCAAAACCCTGTCTCTAC"
"GL873577","515809","515961","chr7","137660778","137660931","43","137144969","AGCTGGGCATGGTGGCTCATGCCTATAACCCTAGCGTGCTAGGAGATTGCTTGTCAGGAGACTGAGGTTGCAGGAAACTGTGATGATGGCACTGCACTCTACCCAGGGTGACAGAGCAGGACTCTGCCTCAAAAAAAAAAAAAAAAATAGAAA","TTAGCTGGGCATGGTGGCGCATGCCTATAATCCCAGCTACTTGGGAGGCTGAGGCAAGAGAATCGCTTGAACCGGGGAGGCAGAGGTTGCAGACTGCACTCCAGCCTGTGTGACAGAGTGGGACTCCGTCTCAAAAAAAAAAAAAAAAAAAAAA"
"GL873577","1633164","1633256","chrX","38269524","38269615","26","36636360","TCAGCCAGGCATGGTGGCACTTGCCTATAAACCCAGCTCCTTGGGAAGCTGAGCCGGGAGGATCCCTTGCACCCAGGAGCAACGGAAGGCAGT","AATTAGCCAGGCATGGTGGCACATGCCTATAATCCCAGCTACTCAGAAGGTTGAGGCAGGAGAATCACTTGAACCTGGGAGGCAGAGGTTGC"
"GL873577","3979502","3979560","chr20","68909283","68909346","13","64929781","GAGTTTGAGACCAGCCTGAGCAAGACCGAGACCCAGTCTCTACTAAAAATAGAAAAATT","GGAGTTCAAGACCAGCCTGACCAACATGGAGAAACCCTGTCTCTACTAAAAAATACAAAAATTA"
"GL873577","3979839","3980009","chr10","31403126","31403287","39","27423287","ATGAGCAGATTGTCTTGGTGGGCACCTGTAGTCCCAGCTATTGGAGGTGGGAGGCTGAAGCAGGAAAATCTCTTGAGCCCAGGAGTTTGAGGTTGCTGTGAGCTAGGCTGACACCACGGCACTCTAGTCAGGGCGTCAGAGTGAGACTCCGTCTCAAAAAAAAAAAAAAAA","TTAGCTGAGTGTGGTGGCGCACATCTGTACTCCCAGCTATTTGGGAGGCTGAGGCAGGAAAATCGCTTGAACCCAGGAGGTGGAGGTTGCAGTGAGCCAAGATCACACTACTGCACTCCAGCCTGGGTGACAGAGTGAGAATCCATCTCAAAAAAAAGAAAA"
"GL873577","6050882","6051080","chr1","153219820","153220007","59","147168938","GGCTGGGCGTTGTGACTCATGCCTGTAATCCCAGCACTCTAGGAGGCCGAGGTGGGTGGACTGCCTGAACTCAGAGGTTTAAGACCATCCTGAGCCGCAGTGAGCCAGAGCGAGACCCTGTCTCTACCAAAAAAAGCTGGGTGTTGTGGTGGGCGCCTATAGTCCTAGCTACTTGAGGCGCTAAGGGTAAAAAAATTGC","GGCCTGGCACAATGGCTCACGCCTGTAATCCTAGCACTTTGGGAGGCCGGGGTGGGTGGATCACCTGAGATCAGGAGTTTGAGACCAGCCTGGCCAACATGGTGAAACTCCTTCTCTACAAAAATTAGCCAGGTGTGGTGGTGGGTACCTGCAATCCCAGCTATTTGGGAGGCTGAGGCAGGAGAATC"
"GL873577","8463965","8464050","chr9","52134422","52134508","19","43670457","CTGGGTGCTATAGCTCACGCCTATAATCCTAGCACTCTGGGAGTTTGGGGCAAATGGATCACCTAGGCTCAGGAGTTTGATACCAG","GGCTGGGAGCAGTGACTCACGCCTATAATCCCAGCACTTTGGGAGGCTGAGGCAGATGGATCACCTGAAGTCAGGAGTTCGAGACCA"
"GL873577","9471486","9471613","chr16","5178790","5178910","46","4292696","TTAGCCAGGCATAGTAGCCTGTGTGTAGTCCTAGCTACTCAGGAGGCTGAGGTAGATGGGTCACTTGAGGTTGCAGAGATTATGGTAATGTCACTGTACTCTAGCCCTGGCAACAGAGCACAACCCTG","TTAGCCGAGCCTGGTGGCATAAACCTGTAATCCCAGCTACTCAGGAGGCTGAGGCAGGGGAATTGCTTGAACCTGAGAGGAGAAGGTTGCAGTGAGCCGAGATTGCACCATTGCACCCCAG"
"GL873577","9471875","9471998","chr7","17832200","17832315","36","8360325","GGCCAGGTGAAGCAGCTCATGGCTATAATCCTAGCAGTTTGGCAGGCCAAGGTGGGAGGACTGCTTGAGGTCAAGAGTTCAAGACCAACCCATCTTTGCGAAAAATTTAAAAATTACCTAGGCA","GCCAGGAGAGGTGGCTCATGCCTCTAATCCCAGCACTCTGGAAATCCAAGGTGGGTGGATCACCTGAGGTCAGGAATTCCAGACCAGTCTGGCCAATATAAAAAATTAGCCAGGCT"
"GL873577","9853150","9853170","chr3","85044647","85044667","3","75191497","AAACAAACAAACAAAAAAAGA","CAAACAAACAAACAAACAAAA"
"GL873577","9853206","9853473","chr7","130818682","130818963","67","120965476","GCTGGGCGCAGCGTCTCACTCCTGTAATCCCAGCACTTGGGAGGCCAAGGTGAGTGGATTGCCTGAGTTTACAGTTTCGAGACCAGCCTGAGCCAAAGCGAGACCCCCATCTCTAAAAAATAGCTGGGCATTGTGGTGGGCACCTGTAGTCCCAGCTACTTGGGAGGCTGAGGCAAGAGGATCGCTTGAACCTAAGAGTTTGAGGTTGCTGTGAGCTAAGGCTCCATGGCATTCTACCAAGGGTGACTAAGTGAGACTCTGTCTAAAA","GCCGGGCACAGTGGCTCACACCTGTAATCCCAGTACTTTGGGAGGCCAAGGTGGGTGGATCACCTGAGGTCAGGAGTTTGAGACCAGCCTGGCCAACATAGTGAAACTCTACTAAAAATACAAAAAAATAGCTAGGCATGGTGGTGCGCACCTGTAATCCCAGCTACTTGGGAGGCTGAGGCAGGAGAGTTGCTTGAACCCAGCGGGGTTGAGGTTGCAGTGAGTTAAGATCAAGCCACTGTGCTCCAGCCTGGATGACAGAGAGAGACTCCATCTCAAAAA"
"GL873577","10722415","10722478","chr10","12501471","12501539","23","1779056","AATAAAAAAATGCTGGGTACAGTAGTACATGCCTGTACTCTCATCTGGGGAAGCTGAGGCATGA","AAAGTAAAAAATTAGAGCTGGGCATGGTGGCACACACCTGTAATCCCAGTCACTAGGGATGCTGAGGCA"
"GL873578","463331","463568","chr10","28935382","28935620","93","28472051","CAGGTGCTTTGACCCACACCCTCAACTCTAGGACTTTGGACGCCCTGGCTGGGTGGGTCCTTTAAAGTCAGGAGCTTCTTATCAGTCTGGGCAAAAGTGAGACCCCATCTCTACCAAACAAAGAAAGAAATCAGCAGTATGTTGCAGTAGAGACTCACCAATACCTTCTTTCAAAGACCAAAGCTGGAAGGACACTAAAGACCATGATCTCATGGCCTCCCTGAGCCATGACAATGCC","CCAGGTGCAGTGGCTCATGCCTGCAAGCTCAGAACTTTGGGAGGCAGAGGTGAGCAGACTGCCTGAGTTCAGGAGTTCAAGACCAGCTGGGCAACATGGTGAGACCCTATCTCTACTAAAAATACAAATAATTAGCAGGGTGTGGTAGCACACACCTGTAGTCCAGCTACTCAGGAGGCTGAGGCAGGAGAATTGCTTGAACCCAGGAGGCAGAGTTTGCAGTGAGCCAGGACTGGGCC"
"GL873578","1143712","1143827","chr11","52824583","52824692","30","51680871","GGCTGGGTGTGGTGCCTCATGCCTGTAATCTAAGCCCTCTCCGAGGCTGAGGTGGGAGGATCCCTTGAGTTTAGGAGTTTGATTTTGAGACCAGCCTGATCAAGAGAGAGACCTCA","GGCCGGGTGTGGTGGCTCATGTCTGTAATCCCAGCACTTTGGGAGGCTGAGGTGGGTGGATACCCTGAGGTCGGGAGCTCGAGACCAGCCTGACCAACATGGAGAAACCC"
"GL873578","1144101","1144139","chr3","33494224","33494257","11","32350123","GAGAGAGACCTCATGTCTACTAAAATAAATAAATATATA","GTGAAACCCGTCTCTACTAAAAATACAAAAATTA"
"GL873578","1144175","1144343","chr12","119519961","119520131","41","118375786","ATTATCCAGGCCTTCTGGTGGATGCCTGTAGTCCTAGCTACTAGAAAAGCTGGAGCAGAATCACTTGACCCAGGAGCTGGAGGTTGCAGGGAGCTAGGCTGATGCCACAGAATTCTAGCCTGAGGCAAAAGAATTGAGCCACTGTCTCAAAAAGGAACAAAAAAGAAAA","ATTAGCCAGGTGTGGTGGCATGCACTTGTAATCCCAGCTACTAAGAAGGCTGAGGCAGGAGGATCACTTGAACCCGGGAGGTGGAGGTTGCAGTGAGCCAAGATCATGCCACTGCACTCCAGCCTGGGCAACAGAGTAAGACTCTGTCTCAAAAAAAAAAAAAAAAAAAAA"
"GL873578","4593962","4594035","chr16","68825055","68825124","22","64231093","AGCTGGGTACAGTGGCTCACATATAATCCCAGTGACTCAGGAGGCTAAGACAGGAGGATTACTAGGACCTGAGA","GGCTGGGCACAGTGGCTCAGACCTGTAATCTCAGTACTTTGGGTGGCTGAGGCAGGTGGATCACCTGAGG"
"GL873578","6158845","6158972","chr3","500432","500562","24","5658413","GACATGGTGGCTCACACCTGTAATCCTAGCCCTCTGGGAGGCTGAGGCAGGTGGATCACTTGAGTTCAGGAATTCAAGACCAGCTTGAGTGAGAGCAAGACCCTGTCTCTACTAAAAATAGAAAAATT","GCACGGAGGCTCATACCTGTAATCCCAGCACTTTGGGAGGCTGAGGCAGGTGGATCACCTGAGGTCAGGAGTTCCAGACCAGCCTGGCCAACATGGCGAAACCCTGTCTCTACTAAAAATACAAAAAATCT"
"GL873578","6159253","6159444","chr19","34496349","34496541","55","28337096","ATAAAATAAAAATAGAAAAATTAGCCAGGCATTGTGGCAGACATGCGAAGTCTCAGCTACTCCAGAGGCTGAGACAGGAAGATTACTTGAGCCCAAGAATCTTGCTGTGAGCTAAGCTGATGCCATAGCATTGTAACCTAGGCAACAGAGTAAGACTTGGCCTCAAAAATAAAATAAAATAATAAAGTAAAA","TTAGTTAATTAAATTAAACTTAGCTAGGCATAGTGGAACACACCCATAGTCCCAGCTACTCTAGAGGCTGAGGCAGGAGGATTGCTTGAGCCAAGTTGGAGGCTGCAGTGAGCTATGGTGGTGCCACTGCATTCCAGCCTCAGTGACAGAGAGAGACCCTGGCTCAAATAATAATAATAAATAAATAAATAAA"
"GL873578","6766040","6766171","chr2","93098086","93098217","30","86332046","CCAGGCACAGTGGCTCATGCCTATAATCCTAGTAGTCTAGGAGGCTGAGGTGAGTGCATTGCTTGAGCTCAGGAGTTAGATACCAGCCTAACCAAGAATGAGACCCCATCTCTATTAAAAATAGAAAAGTTA","GCCGGGCACAGTGGCTCATGCCTGTAATCCCAGCACTTTGGGAGGCCGAGGCGGGCAAATCACGAGGTCAGGAGTTCAAGACCAGCCTGACCAATATGATGAAACCCCGTCTCTATTAAAAATACAAAAATT"
"GL873578","6766434","6766577","chr9","21128084","21128223","50","14361650","GTTAGCCAGGAGTTGTGGCGGGCACCTACAGTCCTAGCGACTCAGGAGGCTGAAGTAGGCAGAGTTTGATGTGTTGCTGTGAACTACAAGGACACCAATGCACTCTAGGCCGGTAACAGAGTGAGACACTGACTAAAAAAAAAA","TTAGCCAGGTGTGGTGGCACATGCCTGTATTTCCAGCTACTCGGGAGGCTGAGGCAGGAGAATTGCGTGAGCTGAGATCATGCCACTTCATTCCAGTCTGGGTGACAGAGTGAGACTCTGCCTCAAAAAACAAAACAAAA"
"GL873578","7397948","7398119","chr5","40230148","40230319","43","32832200","TAAAAATAGCCATGCATTGTGACAGGCACCTGTAGTCCCAGCTACTCAGGAGGTTGAGGTAAGAGAATCACTTGAACCCAAGAGTTTTGAGGTTGTTATGAGCTAAGACGCCTCGGGACTCTACAAAAGGTAACAAAGTGAGACTCTGTCTCATAAAAAAAGAAAAAAAGAA","AAAATTAGCCAGGCATGGTGACGTACACCTGTAGTCCCAGCTACTCGGGAGGCTAAGGCAAGAGAATCGCTTGAACCCAGGAGGCAGAGGTTGCAGTGAGCTTAGATCACGCTACTGCGCTCCAGCCTGGGTGACGGAGTGAGACGCCATCTCAAAAAAAAAAAAAAAAAAA"
"GL873578","7398378","7398515","chr15","102382935","102383070","35","94984557","GGTCGAGCAAGGTGGCTCACGCCTGTAATCCTAGCACTCTGTGAGGCTGAGGCAGATGGATTGCCTGAGCTCGTGGGTTCGAGACCAGCCTGAGCCAGAGTGAGACCTCATCTCTAAAAATAGCTGGGAAGCTGGGCA","GGCCAGGTGTGGTGGCTCACGCCTGTAATCCTAGCACTTTGGGAGGCTGAGGCGGGTGGATTGCCTGAACTCAGGAGGTCAAGACCAGCCTGGGCAACACAGTAAAACCCCATCTCTACTAAAATACAAAAAATCA"
"GL873579","370235","370429","chr16","38067345","38067552","57","37697110","GCACAGGCCTGAAATCCTAGCACTCTGAAAGGCCAACGGAGGAGAATTTCTGGAGCTCAGGAGTTTGATACCAGCCTAAGCAAATAAAGCTAGACCTCTATCTCTACTAAAATTAGAAAAATTAGGCAGATGTGGTGGTAGGCACCTATAGTCCCAATTACTCCAGAGGCTGAGGCAGAAAGACTCTTGAACCCA","GTCAGGCATGGTGGCTCATGCCTATAATCCTAGCACTTTGGGAGGCCAAGGCCGGTGGATCACCTGAGGTCAGGAGTTTGAGACCAGCCTGGCCAATATGGCAAAACCCCGTCTCTACTAAAAATAAAAAAATTAGCTGGGCACGGTGGTGGGCACCTATAGTCCCAGCTACTCAGGAGGCTGAGGCAGGAGAATTGCTTGAACCCAG"
"GL873579","370936","371046","chr3","3847698","3847802","33","3476762","TGACTCTTGAACCCAGGCACATGAGGTTGCTAAGAGTCTAGGCTGATGTCACGGCACTCTAACCTGGGAAACAGTGTGAGGTTCTGCCTCAATAAATAAATAAATAAATAA","TGGCTTGAACCCAGGAGGCGGAGGTTGCAGTGAGCCGAGATCACGCCACTGCACTCCAGCCTGGGCAACAGAGCGAGACTGTCTCAAAAAAAAAAAAAAAAAAAA"
"GL873579","599436","599605","chr10","38982686","38982853","41","38383250","AAAAAGTCAGACATTGTGGCAGGTGTCTGTAATCCCAGCTATTTGGGAGGCTGAGGCAGGAGTATCATTTGAACCCACGAGTCTGAGGTAACTGTGAGCTAGGCTAACACAACAGCACTCTAGCCTGGGCAATAGAATGAGACTCTATCAAGAAAAGAAATGAAAAGAAA","TATTAGCCTGACACAGTGGCGCGCATCTGTAATCCCAGCTACTTGGGAGGCTGAGGCAGGAGAATCACTTGAACCCAGGAGGCGGAGGTTGCTGTGGGCTGAGATCATGCCACTGCACTCCAGCCTGGGCAACAGAGGGAGGCTCCATCTCAAAAAAAAAAAAAAAAA"
"GL873579","599942","599953","chr3","71473700","71473710","4","70873758","TTTTAAAATAGT","TTTAAAAAAAA"
"GL873579","600232","600365","chr1","16061315","16061447","30","15461083","GGCTAGGCAAGGTGACTCATGTCTGTAATCCTAGTACTCTGGGAGGTTTGAGGCAGGAAGACCACTTTAGCTCAAGAGTTCCAGATCAGCCTGTGCAAGAGTGATACATCATCTCTACTAAAAATCAAAAATTA","GGCTGGGCATGGTGGCTCATGCCTGTAATCCTAGCACTTTGGGAGGTTGAGGCAGGCAGATCACTTGAGGTCAGGAATCTGAGACTAGCCTGGCCAACATGGTGAAACTCCATCTCTACTAAAAAAAAAAAAA"
"GL873579","5650320","5650591","chr6","54938866","54939145","71","49288546","GTCAGGTGTGTTAGCTTACAGTAGTAATCCTAGCACTTTGGGAGGTTGAAGTGGGTGGATTGCTTGAGCTCAGGGGTTCAAGACCAGCCTGAACAAGAGTGGGACCTCATCTCTATTAAAAACAGAAAAACTAGCTGGGTGTTATGGTGGGTGTCTGTAGCCCCAGCTACTCAGGAGGCTGAGGCAGGAGGTTGAGGTTGCTGTGAGCTATTGAGACCACAGCACTCTATCCAGGGCAACAGAGTGAGACCCCTCCCCCCCCCAAAAAAAAA","GGCCAGGTGTGGTGGCTCACGCCTGTAATCCCAACACTTTGGGAGGCCGAGGTGGGTGGATCACCTGAGATCAGGAGTTCAAGACCACCCTGGCCAACATGGTGAAACCCCGTCTCTACTAAAAATACGAAAATTAGCTGAGTGTGGTGGTGCATGCCTGTAGTCCCAGCTACTCAAGAGGCTGAGGCAGGAGGTGGAGGTTGCAGTGAGCCGAGATTGCATCACTGCACTCCAGCCTTGGCGACAGAACGAGAGAGACTCCATCTAAAAAAAAAAAAAA"
"GL873579","7037162","7037347","chr3","37328686","37328893","67","30291524","GAGGTGGGTGGATTGCCTGAGCTCACAGGTTGGAGACCAGCCTGAGCCAGAGCAAGACCTTATCTCAAAAAATAGCCAGGTGTTGTGGCTGGCACCTGTAGTCCCAGCTGCTCAGGAGGCGGAGGCAAGAGAAATGCTTGACCTCAGGAGTTTGAGGTTGCTGTGAGTTCAACTCACACTAATACA","GAGGCAGGGGGATCACCTGAGGTCAGGAGATCGAGACCAGCCTGGCCAACATGGTGAAAACCTGTCTCTACTAAAAATCCAAAAACATTAGCCAGGTGTGGTGGCACGCACCTGTAATCCCAGCTACTTGGGAGGCTGAGGCAGGAGAATCACTTGAACCTGGGAGGCAGAGGTTGTAGCGAGCCGAGATCACACCACTGCACCCCAG"
"GL873579","11077764","11077972","chr19","1200469","1200683","63","9877295","GCCAGGTGCAGTGGCTCATGCCTATAATCCTAGCACCCTAGGAGGCTGAGGAGTTCAAGACCAGCCTAAGCAACTGTGAGACCCCATCTCTACCAAAAATAGAAAAATTAGCTGACTGTTATGGTGTGCACCTACAGTCCTAGCTACTCAGGAGGCTGAGGCAGAAAGAGTCCTTGAACCCAGGAGGCTTTTTTTTGTTGTTGTTGTTG","GGCCAGTCGCGGTAGCTCATGCCTGTAATCCCAGCACTTTGGGAGGCCGAGGCGGGCAGATCACCTGAGACCAGCCTGGCAACATGGTGAAACCCCATGTCTACCCAAACTACAAAAATTAGCTGGGTGTGGTGGTGCACGCCTGTAATCCGAGCTACTCAGCAGGCTGAGGCAGGAGAATCCCTTGAACCTGGGAGGCAGAGGCTGCAGTGAGC"
"GL873579","11078245","11078333","chr19","4926258","4926351","22","6151987","TGAACCCAGGAGTTTGAGTTCGCTGTGAGCTAAGCTGAGGCCACAGCACTCCAGCCTGGGCAACAGAGTGAAAGGAAAAAAATAAAAAA","TGAACCCGGGAGGTGGAGGTTGCAGTGAGCCAAGATCACACCAATGCACTCCAGCCTGGGCAACAAGAGTGAAACTCTGTCTAAAAAAAAAAAA"
"GL873580","320374","320488","chr13","48549305","48549409","42","48228931","GGTAGTGCGTGCCTGCATTCCCAGCTACGGGAGGGCAGGGACTTGAGGCCAGCCTGGGCAAAATAATGAGACCTACTAATGACTCTACTAATACAGAAACAATTAGCTAGGTATG","TGGGAGGCCGAAGTGCGCAGATCACCTGAGGTCAGAAGTTGGAGACCAGCCTGGCCAACATGGTGAAAACCCATCTCTACTAAAAATACAAAAATTAGCTGGGCA"
"GL873580","374969","375091","chr6","147681010","147681135","27","147306041","CGGTGGCTCACACCTATAATCCTAGCATTTTGGAAGGCTGAAGCCGAGGATCTCTGGAAGTCAGAAGTTCAAGACCAGCCTGCCCAAGAGCAAGACCCCATCTCTACTAAAAATAGAAAAACT","GGTGGCTCACACCTGTAATCCCAGCATTTTGGGAGGCTGAGGCAGGCGGATAATCTGAGGTCAAGAATTTGAGACCAGCCTGGCCAACATGGAGAAACCCTATCTCTACTAAAAATACAAAATTAC"
"GL873580","375369","375549","chr7","19977275","19977456","44","19601906","CTAACCAAGTTAGTTAGTTTTAGTTGGCAGGTGCCTGTAGTCCCAGCTCCTTGGGAGGCTGAGGCAAGAGAATGGCTTGAGCCCAGGACTTTGAAGTTGCTGTGAGCTATAATGACACCACAGCACACTACCCAGGGTGACAGAGTGAGACTGTCTCAAAAAAACAAACAAACAAAAAAAA","AACAAACGTTAGCCGAGCATGGTGGTATGTGCCTGTAGTCCCAGCTACTTGGGAGTCTAAGGCAGGAGAATTACTTGAGCCCGGGAGGCAGAGGTTGCTGTGAGCCAAGATCACGCCACTGCACTCCAGCCTGGGTGACAGAGTGAGACTCCATCTCAAAAAAAAAAAAGGAAAAAAAAAAA"
"GL873580","8760922","8761015","chr11","104681322","104681416","19","95920400","GGAGGGAGACACTGCAGTGAACTGCGATCGTGTCTCTGCTTTCCAGGCTGGGTGACAGAGTGAGACTCGGTCTCTAAAATAAAAAATAAATAAA","GGAGACGGAGGTTGCAGTGAGCTGTGATCGCGGCACTGCACTCCAGCCTGGGCAACAGAGTGAGACTCTGTCTCAAAAATAAATAAATAAATAAA"
"GL873580","9391260","9391306","chr14","49279240","49279285","12","39887980","GCCAGTCGAGGTGGCTCACACTTGTGATTCCAGCTACTTGGAAGACT","GGCTGAGATGGTGGCACACACCTGTAATCCCAGCTACTTGGGAGGC"
"GL873581","759283","759365","chr6","46535476","46535542","30","45776193","TAAGAACCTGAAAATAGAGCCAGGCATAGTGGTACATGCGTATAGTCCTGGCTACTCAGGAGGTTGAAACAACAGGATTACTT","CAAAATAGCCAGGCTTGGTGGTGCATGCCTATAATCCAAGCTACTCGGGAAGCTGAGGCAGGAGAAT"
"GL873581","1145844","1145979","chr1","29437872","29437991","29","28292028","GGCCGGGCGTGGTGGCTCACGCCTGTAGTCCCAGCACTATGGGAGGCCGAGGCGGGTGGATCACCTGTGCTCAGAGGTTCGAGACCAGCCAAGACCCCCCTGAGCCAAATGAGCCAGAGTGAGACCCCGTCTCTAC","GGCCGGGCGTGGTGGCTCACGCCTGTAATCCCAACATTTTGGGAGGCCAAGGCGGGTGGATCACCTGAGGTCAGAAGTTCGAGACCAACCTGGCCAACATGGTGAAACCCCTGTCTCTAC"
"GL873581","9628238","9628362","chr5","141044567","141044691","34","131416329","ATCCCAGGTAGTCGGGAGGCTGAGGCAGGAGGATCACTTGAACCCAGGAGGTTGAGGTTGCTGTGAGCAAGGCAGAGGCAACGGCACTCTAGCCACGGGGGCACAGAGACTCTTGTCTTTAAAAA","TAATCTCAGCTACTCGGGAGGCTGAGGCAGGAGAATCGCTTGAGCCCAGAAGGTGGAGGTTGCAGTGAGCCAAGATCGCGCCATTGCACTCCAGCCTGGGCGACAGTGCGAGACTCTGTCTCAAA"
"GL873582","1580485","1580534","chr6","32576760","32576806","12","30996275","CAGCACTTGAGAGGCCAAGGCAGGTGGATCAACTGAGCAAGAATGAGACC","CCAGCACCTTGAGAGGCCAAGGCAGGTGGATCACCTGAGGTCAGGAG"
"GL873582","1644368","1644551","chr1","211626449","211626612","63","209982081","AAAATTTGCCGGGCTCCATAGCTCATGCATGTAATCATAGCACTCTGGGAGGCCAAGATGGGAGGATCTCTCAAGCTCTCTTACTTGGGAGGCTGAGGTTGCTGTGAGTTAGGCTTACGCCACAGCACTCTACTCTAGCGTGAGCAACTCTACTCTTAGTATGAGACTGTCTCAAAAGAAAAAA","AAATTAGCCAGGCGTCGTGGCACATGCCTGTAATCCCAGCTACTCGGGAGGCTGAGGCAGGAGAATAGCTTGATCTCGGGAGGCGGAGGTTGCAGTCAGCCGAGATCACACCACTGCAATCCAGCCTGGACAACAGAATGAGACTCCATCTCAAAAAAAACAAA"
"GL873582","5794385","5794459","chr13","18872784","18872852","27","13078399","ATATTGTTAAGCACAGCCACTATTAAAAATTAAATTATAGGCCAGGCATAGTGGCTCATGCCTGTAATCCTAGCT","TGAAACCACCATCTGGACCAAGATACAAAATGTTGGCTGGGCATGGTGGCTCACACCTGTAATCCTAGC"
"GL873583","102645","102683","chr14","5808766","5808804","14","5706121","GAGCAGATCACCTGAGCTCAGGAGTTTGAGACCAGCCTG","GAGGAATCCCTGTGCTCAGGAAGCTTACATTCTAGTGAG"
"GL873583","6200447","6200560","chr4","17786849","17786963","24","11586402","GGCCAGGAGGGACGGCTCATGCCTGTTATCCTAGCACTATGGGAGACTGAGGTGGGAGGATCACTTGAAGTTAGGAGTTCCAGACCAATCTGACCAAAGTGAGACCTCATCTCT","GGCCAGGCTTGGTGGCTCATGCCTGTAATCTTAGCACTTTGGGAGGCTGAAGTGGGTGGATCACTTGAGGTCAGGAGTTAGAACCAGTCTGGCCAACATGGTGAAACCTCAGCTC"
"GL873583","6200584","6200752","chr6","169626528","169626696","42","163425944","TTAGCTGGATGTGGTAGCACATGCCTATAGTCCCATCTACTCAGGAGGCTGAGACAAGAGAGTTGCTTAAGCCCAGGAGTTTAATTTAACTGTGAACTAGACTGAGACTGTGGCACTCTAGCTGGGGCAACAGAGTGAGACTCTGTCTCAAAAGAAAGCAAGAAAGAAA","TTAGCTGGGTATGGTGTCAGATGCCTGTAGTCCCAGCTACTCAGGAGGCTGAGACAGGAGAATCGTTTGAACCCAGGAGGCCAGAACTGCAGTGAGCTGAGATTCGCACCACTGCGCTCCAGCCTGGGCCAGACAGAGTGAGACTCTATCTCAAAAGAAAAAAAAAAAA"
"GL873583","10217398","10217583","chr3","36257142","36257313","44","26039744","TACTAAAAATAAAGTGTGATAGCCAGGCATGGTGGTGGTGCCTATAGAACCAGGCTATTCAGGAGGCTGAGGCAGAAGGATCACTTGAACCCAGGAGTCTGACGTTGCTGTGAGCTAGGCTGGTGCCATGGTACTCTAGCCTGTGGTAACAGAATGAGACTCTATCTCAAAAATAAAAATAAAAAA","TACAAAATTAGCCAGGCGTGGTGGTGCGTGCCTGTAATCCCAGCTACTTGGGAGGCCGAGGCAGAAGAATGACTTGAACCCAGGAGACAGAGGTTGCAGTGAGCCAAGATCCCACCATTGTACTCCAGCCTGGGCAACACAGTGAGACTCCATCTCAAAAAAAAAAAAAAAA"
"GL873583","10394919","10394983","chr16","12841703","12841771","22","2446784","GAGGTCAGGAAATCAAGATCAGTCTGGGCAATATATTGATACCCTGCCCCTACATAAGGAAGAAA","AGGTCAGGAGTTCAAGACCAGCCTGGCCAATATGTTGAAACCTCATCTCTACTAAAAATACAAAAATTA"
"GL873584","521512","521529","chr1","167402212","167402233","10","166880700","GCATGGAACCCCCCACTC","GGTGAAACCCCATCTTTACTAA"
"GL873584","2079725","2079768","chr15","4338291","4338335","11","2258566","GGCAGGTGGATTACCTGAGTTCAGGAGTTGGAGACCAGCCTGAC","AGGCGGATGGATCACGAGGTCGGGAGTTTGAGACCAGCCTGACCA"
"GL873584","5216877","5217053","chrX","91350057","91350230","49","86133180","CTACTGAAAATGATGACAGAGGCTGGGCATGGGGGCTCCCGCCTGTTATCCTAGCACCCTCGGAGGCTGGGGAATGAGGATTGCTTACGCCCAAGAGTTTGAGGTTGCTGTGAGCTGAGGCCGCTGCACTCTAGCCTGGGCAACAGAGTGAGACTCTGTCTCAAAAAAAAAAAAAAA","TGCAAAAATGAGCTGGGCATGGTGGCACATGCCTGTAATCCCAGCTACACAGGAGGCTGAGGCAGGAGAATCGCTTGAATCTGGGAGGCGGAGGTTGCAGTGAGCTGACATCAGGCCCCTGCACTCTAGCCTGGGCCACAGAGCAAGACTCCGTCTCAAAAAAAAAAAAAAAAA"
"GL873584","7289930","7289950","chr2","51453328","51453345","10","44163398","TGAGGCTCTGTCTCGAAATAA","AATGCCATCTATTAAAAA"
"GL873584","7289975","7290131","chr11","49739997","49740154","37","42450022","CAAGAAAATTAGCTGAGAGTCCTGGTAGGTGCCTGTAATCCCAGCTATTCATGAGGCTGAGGCAGAAGGATCACTTGGGTCCAGGAGTCTGAGGTTGCTGTGAGCTAGTCTGACGCCATAACACGCAAGCCTGGGCAACAGAGTGAGGCTCGGTTTC","CTACAAAAATTAGCTGGGCGTGGTGGCACATGCCTGTAATCCCAGCTACTCGGGAGGCTGAGGCAGGAGAATCACTTGAGCCCAGGAGGCGGAGGTTGCAGTGAGCCAAGATCATGCCATTGCACTCCAACCTGGGCAACAGAGCAAGACTCCATCTC"
"GL873584","7577743","7577867","chr5","48394329","48394446","27","40816586","GGCTGGATGAGGTGGTTCATGCCTGTAATCCTAGCACTCTGGGAGGCCAAGGTGGGTGGATTGCCTGAGCTCAGGAGTTCAAGACCAGCCTGAGCAAGACCCTGTCGCTAAAAATAGCTGGGTGT","GGCTGGGTGCAGTGGCTCATGCCTGTAATCCCAGCACTTTGGGAGGTCAAGGCGGGTGGATCACCTGAGGTCAGGAGTTCAAGACCAGCCTGGCCAACATCTCTACTAAAAATACAAA"
"GL873584","7578135","7578289","chr1","130112713","130112865","31","122534578","GGAGCTGGGTTTTGTGACTGCACCTGTAATCCCAGCTGCTCAGGAGGCTGAGGCAAGAGAATTGCTTGAGCCCAGGAGTTGGAGGTTGCTGTGAGCTGTGATGCCAGGGAACTCTACCAAGGGTGACAAAGTGAAACTCTGTCTCAAAAAAAAAA","TTAGCCAGGTGTGGTGATGCATGCCTGTAATCCCAGCTACTCATGAGGCTGAGGCAGGAGAATTGCTTGAACCTTGGAGCTGGAGGTTGCAGTGAGCTGAGATCAGACCACTCCAACCTGGGTGACAGAGCGAGACTCTGTCTCAAAAAAAAA"
"GL873585","1450952","1451121","chr10","59681079","59681242","48","58230127","TAAAAACAGAAAAAACTAGTCAGGTGGTGTGGTAGGTGCTCATAAGTCCCAGCTGCTTGGGAGACTGAGGCAAGAGAATCACTTGAGCACAAGAGCTTGAGGTGGCTGTGAGCTATAACACCATAGCACTGTACTGAGGGTGACAAAGTAAGACTCTGTCTCAAAAAAAA","TACAAAAATTAGTCAAGGGTGGTGGTATGTGCTTGTAATCCCAGCTATTTGGGAGGCTGAAGCAGGGGAATCCTTGAACCCAGGAGGTGGAGGTTGCAGCGAGCCGAGATCACGTCACTGCACTCTAGCCTGGGCGATAGGGTGAGACTCTGTCTCAAAAAAAA"
"GL873585","1451382","1451515","chr6","17405813","17405948","24","15954431","GGCCCGGCTCGGTGGCTCACACCTATAATCCTAACACTCTGGGAGGCTGAGGCAGGTGGATCACCTGAGCTCAGGAGTTTGAGACCAGCTGAGCAAAAACAAGACCCTATCTCTGCTAAAAATAGAAAAAACTA","GGCCGGGCGGGGTGGCTCACGCCTGTAATCCCAGCACTCTGGGAGGCCAAGGCAGGTGGATCACCTGAGGTCAGGAGTTTGAGACCAGCCTGGCCAACACGCAGAAACCCTATTTCTACTAAAAACACAAAAATTA"
"GL873585","1626960","1627026","chr7","17782729","17782794","22","16155769","AAGATGCCACAGCACTCTACAAGAGTGACCAAGTGAGACTCTGTCTCAAAAAAAAAAAGAAAAGGAA","CAATCGCACTACTGCACTTCAGCCTGGGTGACAGAGTGAGAACCTGTCTCAAAAAAATAAATAAAA"
"GL873585","1627304","1627531","chr11","17033552","17033788","61","15406248","GGCTGGGCACAGTGGCTCACGGCTATAATCTAGGCACTTGGGAGGCTAGGGCAGGTGGATTGCCTGAACTGACAAGTTTGAGACCAACCTGAGCAAGAGCGAGACCCCTGTCTCTAAAACATAGCCAGGCTCTGTGGTGGGCGTCTGTAGTCCCAGCTACTTGGGAGGCTGAGGCAAGAGAATTGCTTGAACTCAAGAGTCTGAGGTTGCTGTGAGTTAAGATGCCAC","GCCCGGCGCAGTGGCTCACGCCTGTAATCCCGGCACTGTGGAGGCCAAGGCAGGCGGATTGCCTAAGCTCAGGGATTCGAGAACAGCCTGGGCAACATGGTGAAACCCCATCTCTACTAAAATACAAAAAACTAGCCGGGCGTGGTGGTATGCGCCTGTAATCCCAGCTACTTGGGAAGCTGAGGCAGGAGAATTGCTTGAACCCGGGAGATGGAGGTTGCAGTGAGCTCAGATCAC"
"GL873585","3626082","3626158","chr1","100916857","100916922","27","97290775","TGCCTGTAATCCCAGCACTTGGGAGGCGGAGGTGGGTAGATTGCCTGACCCAGAGTGGGACCTCATCTCTAAAAGAA","CATGCCTGTAATCCCAGCACCTTGGGAGGCCAAGGTGGGTGGATCACCTGAGGTCAGTAGTTTGAG"
"GL873585","8849829","8849913","chr18","48581945","48582025","18","39732116","GGCTGGACGAGGGGACTCATGCCTGCAATCCCAGCACTGAGAGAGGCCAAGGCAGGTGGATCCCCTGAGCTCAGAAGTTTGAGAC","GCTGGACGCAGTGGCTCACACCTGTAATCCCAGCACTTTGGGAGGCCAAAGCAGGCAGATCTGAGGTCAGGAGTTTGAGAC"
"GL873585","9319890","9319971","chr8","79499361","79499447","14","70179471","GGCCAGGTGTGGTGGCTCACACCTGTCATCCTAGCACTCTGGGAGGACGAGGTGGGTGGACCGCCTGAGTCAGAGTGAGACC","GGCCAGGTGTGGTGGCTCACACCTGTAATCCCAACACTTTGGGAGGCCCAGGTGGGTGGATCACCTGAGGTCAGGAGTTCAAGACCA"
"GL873586","895572","895692","chr17","14501559","14501680","38","13605987","GGCCAGGTGAGGTTTCTCATTCTGGGAGTGAGCCAGCAATTGGGAGGCCAAAGTAAATGGATTGCCTGAGGTTATAGGTTCCAGAACAGCCAGAACAAGATCGAAATCCTGTCTCCAAAAA","GGCCAGGCGTGGTGGCTCATGCGTGTAATCTCAGCACTTTGGAAGGCCGAGGCAGGTGGATCACCCGAGGTCAAGAGTTCAAGACCAGCCTGACCAACATGGCGAGTCTCTGTCTCCACTAA"
"GL873586","5645995","5646150","chr6","58863249","58863409","38","53217254","GGGTATGGTGGCTCATGCCTGTAATCCAAGCACTCTGGGATGGTGAGGCAGGAGAATCCCTTGAACCCAAGAGTCCGAGGTTGCTGCGAGCTAAGCTGATGGCATAACACTCTAGCCTAGGCGACAGAGTGAGACTCTGTTTCCAAAGAGAAAAAA","TTAGCCAGGCATGGTGGCACATGCCAGTAATCCCAGCTACTCAGGAGGATGAGGCAGGAGAATCGCTTGAACCCAGGAGGCAGAGGTTGCAGTGAGCTGAGATTGCGCCACAGCACTCTACCCTGGGTGACAGAAGGAGACTCTGTCTCAAAAAAAAAAAA"
"GL873586","10258686","10258969","chr12","9481260","9481565","81","777426","GGCCGGGCATGGTGGCAGAAATCTAGGAGGCCGAGGCAGGTGGATCGCCTGAGATCACAAGTTCAAGACCAGCCTCAGCTACAGCAAGACCCCATCTCTAAAAATAGCCGGCTGTTGTGGCAGGCGCCTGTAACCCCAGCTACTCGGGAGGCTAAGGCAAGAGAATCGCTTGAGCCCATGAGTCTGAGGTTGCTGCGAGCTGTGACTCCACGGCACTCTACCCGGGGCGATAAAATGAGATTCTGTGTCAAAACAAACAAACAAACAAACAACAACAAAAACAA","GCTGGGCGCGGTGGCTCATGCCTGTAATCCCAGCACTTTGGGAGGCCAAGGCAGGTGGATCACCTGAGGTCAGGAGTTCGAGACCAGCCTAGTCCACATGGTGAAACCCCATCTCTACTAAAAACTAGCCAGGCGTGGTGGTGCGCACCTGTAATCCCAGCTACTCGAGAGGCTGAGGCAGGAGAATCACTTGAGCCTAGGAAGCAGAGGTTGTGGTGAGCTGAGATCACACCACTGCACTCCAGTCTGGGCGACACAGTGAGACTCTTGTCTCAAAAACAAAAAACAAACAAACAAACAAACAAA"
"GL873587","3208032","3208047","chr8","3626746","3626762","2","418714","AAACAACCACAAAAAA","ACAACAACAACAAAAAA"
"GL873587","3208141","3208321","chr19","2057131","2057316","59","1151010","TTTCTTTTAAAAATCACCCATGGGCTGGGTATAGTGGCTCACACCTATAATCCTCGGGAGGCCAAGGTTGGAGGATTGCTTGAATCCAGGAGTTGAAGGTTACAGTGAACTGGGATTTAGCCACTAGACTCTAGCATAGCTGACAAAGCAAGAACCTATTTGTTTAAAACACAAAAAAGAA","TACTAATAATACAAAAATGAGCCGGGTATGGTGGCGGGTGCCTGTAATCCCAGCTACTGAGGAGGCTGAGGCAGGAGACTTGCTTGAACCCAGGAGGTAAAGGTTGCAGTGAGCTGAGATTGCACCACTACACTCCAGCCTGGGCGACAAGAGCAAAACTTTTTCTCCAAAAAAAAAAAAAAAAAA"
"GL873587","3278260","3278367","chr19","19044200","19044312","39","15765940","CAGTCTGAGCAAGAGGGAGAGGCTATTTCTACTAAAAACAGAAAAACTAGCTGGGTGTTGGGGTGTGTTCCTAGTCTCAGTTACTTGGGAGGCTGAAGTAAGAGGATC","ACCAGCCTGGCCAACACGGTGAAATCCCGTCTCTACTAAAAATACAAAAATTACCTAGGCGTGATGGCACGTGCCTGTAGTCCCAGCTACTCATAAGGCAGAGGTGAGAGAAT"
"GL873587","3278673","3278754","chr7","49412503","49412597","28","46133830","GGCCACGAGAGCTAGCTCATGCCTATTCTAGGAGGCCAAAGCAGGCAGACTGCCTGAGCTCAGGAGTTCAAGAGCAGCCTGG","GGCCAGGTGCAGTGGCTCATGCCTGTAATCCGAGCACTTTGAGAGGCCGAGGCAGGCAGATCACCTGAGGTCAGGAGTTCAAGACCAGCCTAGTA"
"GL873587","3782076","3782188","chr9","112128434","112128552","34","108346358","ACTGGGGTGGCTGAGGCAGGAGCGTCACTTGAACTCAGGAGTTTGAGATTGCTGTGAGCTGAGCAGATGTCATGGCACGCTAGCCTAGGTAATAGAGTGAGACTTCGTCTAAA","CAGCTACTCGGGAGGCTGAGGCAGGAGAATCACTTGAACTCGGGAGGCGGAGGTTGCAGTGAGCCGAGATCACGCCATTGCACTCCAGCCTGGGCAACAAGAGCGAAATTCCATCTCAA"
"GL873587","4564996","4565084","chr20","27900350","27900437","14","23335354","GGCGGGGTGTAGTGGCTCATGCCTATTGTCCCAGCACTGTGGGAGGCCGAGGTGGGTGGATCACCTGTGCTCAGAAGTTTGAGACCAGC","GGCCGGGCGTGGTGGCTCATGTCTGTAATCCCAGCACTTTGGGAGGCCGAGGTGGGTGGATCACCTGAGGTCAGGAGTTCAAGACCAG"
"GL873587","6307870","6308175","chr12","112427710","112428020","54","106119840","GGCCAGATATGATGGCTCATGCTTGTAATCCTAGCACTCTGGGAGGCTGAAGTGGGAGGATCACCTGAGATCAGGAGTTCAAGATCACCCTGAGCAAAAGTGAGATCCCATCTCTATTAAAAATAAAAAAATTATCCAGGCATGGTGGTGCAGTCCTTTAGTCCCAGCTACTTGGGAGGCTGAGGCAGGAGAATCTCTTGAACCCAGGAATTAGAGGTTACAGTGAGCTGTGATGATGCTACTGCACTCTAGCAGGATGACAGAGTGAGATACTCCGTGTCAAAAAAAAAAAAAAAAAAAGCAAAA","GGCTGGACATGGTGGTTCATGCTTGTAATCCGAGCACTTTGGGAGGCCAAGGCGGGTGGATCACCTGAGGTTGGGAGTTCGAGACCAGCCTGACCAACATGATGAAACCCCATCTCTACTAAAAATACAAAAAAATTAGCCAGGCATGGTGATGCACGCCTGTAATCCCAGCTACTTGGGAGGCTGAGGCAGGAGAATCACTTGAACCCAGGAGGCAGAGGTTACAGTGAGCCGAGATCATGCCATTGCACTCCAGCCTGGATGACAGAGTGAGCCTCTGTCTCAAAAAAAAAAAAAAAAAAAAAAAAAAA"
"GL873587","6484004","6484128","chr10","67341428","67341546","29","60857424","GACCAGGTTCTGTGGCTCATGCTTGTAATCCTAGCACTCTAGGAGGCCGGAAGAGGGTGGATTGATTGCCTGAGGTCAGGAGTTAGAGACCAGCCTGAGCAAGAGCTAGACCCTGTTTCTTTCTT","GGCTGGGTGTAGTGGCTCATGCCTGTAATCCCAGCACTTTAGGAGGCCAAGGTGGATGGATTGCCTGAGCTCAGGAGTTCGAGACCACCCTGGGCAACAAGCCAAAACCCTGTCTCTAC"
"GL873587","6484407","6484586","chr3","167196537","167196723","48","160712130","TAGACCCTGTTTCTAAAAAAAAAATAGCCAGGTGTTGAGGCAGGTACCTGTAGTCCCAGCTACCTGGGAGGGCTGAGGCAAGAGAATCGCTTGAACCCAAGAGTTTGAGGTTGCTGTGAGCTGAGATGCTATGGCACTCAACCGTGAGCTACAAAGTGAGACTCTGTCTCAAAAAAAAAA","AAAACCTGTCTCTGCTAAAAATACAAAAATTAGCCGGGTGTGGTGATGTGCGCCTGTAGTCCTAGCTACTTGGGAGGCTGAGGCAGGAGAATCACTTGAATCCAGGAGGTGGAGGTTGTAGTGAGTCGAGATCGTGCGACTGCACTCCAGCCTGGGTGACAGCGAGACTCTGTCTCAAAAAAAAAAA"
"GL873587","7466229","7466364","chr1","29437872","29437991","35","21971643","GGCCAGGCGTGGTGGCTCATGCCTGTAGTCCCAGCGCTATGGGAGGCCGAGGTGGGTGGATCACCTGTGCTCAGAGGTTCGAGACCAGCCAAGACCCCCCTGAGCCAAATGAGCCAGAGTGAGATCCCATCTCTAC","GGCCGGGCGTGGTGGCTCACGCCTGTAATCCCAACATTTTGGGAGGCCAAGGCGGGTGGATCACCTGAGGTCAGAAGTTCGAGACCAACCTGGCCAACATGGTGAAACCCCTGTCTCTAC"
"GL873588","1502535","1502718","chr1","34852429","34852590","60","33349894","GGTGCAGTGGCTCACACCTGTTGTCCCAGCGCTGTGGGAGGCCGAGGTGGGTGGATCACCTGTGCTCAGAGGTCGAGACCAGCTGAAGACCTGCCTGAGGCAGAGTGAGCCAGAGTGAGACCCCGTCTCTACTAGAACAACAACAAGACAGCCAGACCTTGTGATCCCAGCTACATGGGGGGCT","GCCAGGTGCAGTGGCTCACACCTGTAATCCCAGCACTTTGGGAGGCCGAGGCGGGCGGATCACCTGAGGTCAGGAGTTTGAGACCAGCTTGACCAACATGGAGAAACCCCGTCTCTACTAAAAATACAAAATTAGCCTGGTGTGGTGTCGCATGCCTGTAAT"
"GL873588","10189037","10189246","chr3","45604681","45604903","65","35415644","GCTGAGATGAGGAGACTCTGTCTCTATTAAAAATAGAAAAATTGGGTGGATGTTGTGGGTACTGTAGTTGCAGCCTCTTGGGGGGCTAAGGCAGGAGGATCAGTTGAAGCCAGGAATTTGCTTTGAGCTAGGCTAAAGCCATGGCACTCTAGCCTGGGCAACAGAGTGAGGCTAGATCTCAAAAAAAGAAAGAAAAGAAAAAGAAAAAAA","CTGGCCAACATGGCAAAACCCCATCTCTACTAAATATACAAAAATTAGCTGGACGTGGTGGCACATACCTGTAATCCCAGCTACTTGGAAGGCTGAGGCAGGAGAATAGCTTGAACCTGGGAGGCAGAGGTTGCAATGAGCTGAGATCACGCCACTGCACTCTAGCCTGGGCAATAGAATGAGACTCTGTCTCAAAAAAAAAAAAAAAAAAAAAGACAAGAAA"
"GL873589","104719","104807","chr20","27900350","27900437","13","27795631","GGCTGGGCGTGGTGGCTCATGCCTGTTGTCCCAGCGCTGTGGGAGGCTGAGGTGGGTGGATCACCTGTGCTCAGAGGTTCGAGACCAGC","GGCCGGGCGTGGTGGCTCATGTCTGTAATCCCAGCACTTTGGGAGGCCGAGGTGGGTGGATCACCTGAGGTCAGGAGTTCAAGACCAG"
"GL873589","796766","796905","chr1","166346372","166346487","49","165549606","GGCTAAGTGTGGTGGCTCACACCTGTCATCTAGTACTTTGGGAGGGTGGGCCTGGGAGTTCAAAGACTGAACTCAGGAGTTCAAGGTGGCTCCGGGGAGGAATTCAAGACCAACCTGAGCCAGAGCGAGACCTCGACTCT","GGCCAGTGGGGTGGCTCACGCCTGTAATCCCAGCACTTTGGGAGGCTGAGGTGGTCAAATGACCTGAGGTCAGGAGTTTGAGACCAACCTGGCCAACATGGTGACACCTCGTCTCT"
"GL873589","1023679","1023690","chr1","205890061","205890072","1","204866382","AAAAAAAAAAAA","ACAAAAAAAAAA"
"GL873589","1023771","1024047","chr4","103012712","103012993","70","101988941","GGCTTGGTGGCTCACACCTGTAATCCTAGCACTCTGGGAGGCCGAAGTGGCTGGAATACTTGAGGTCAGGAGTTCAAGACCAGCCTAAGTGAGAGTGAGATCCCCATCTCTAATAAAAATAGAAAAATTAGCAGGGTGTTGTGGCTGGCACTTGTAGTCCCAGCTACCCAGGAGACCGAGGCAGAAGTTTGAGATTATTGTGAGCGAGGCTGATGCCACAGCATTCTAGTGGGACAACAGAGCAAAATTCTATCTCAAAAGAAAAAAAAAAAAAGGA","CGGGCGTGATGGCTCACGCCTGTAATCCCAACACTTTGGGAAGCCGAGGCGGACGTATCACCTGAGGTCAGGAGTTCAAGACCAGCCTGGCCAACATGGTGAAACCCCGTCTCTACTAAAAATACAAAAATTAGCTGGGTGTGGTGGCATGCGCCTGTAATCCCAGCTACCCAGGAGGCTGAGGCAGGAGAATCGCTGAGGCTGCAGTGAACTGAAATTGTGCCACTGCACTCCAGCCTGGGTGACAGAGCAAGACTCTGTCTCAAAAAAAAAAAAAAAAAA"
"GL873589","4820958","4821024","chr8","33633747","33633811","15","28812789","TTAGTCAAGTGCAGTGGCTCACACCTGTCATCCCAGCTACTTGGGAGGCTGAGGCAGGAGAGTTGCT","TTAGCCAGGTGTGGTGGTGCATGCCTCTAATCCCAGCTACTCAGGAGGCTGAGGCAGGAGAATTG"
"GL873589","6763768","6763857","chrX","25814002","25814092","29","19050234","GGTGTGGTGGCTCACACTTGTATCTTAGCATTTTAGGAGGCTGAATGGGGAGAATTGCTTTAAGTCAGGAGTCTGACTTCCACCTTGCCA","GGCTGGGAATGGTGGCTCACACCTGTAATCCCAGCACTTTGGGAGGCTGAGGTGGGCAGATCACCTGAGGTCAGGAGTTTGAGATCAGCCT"
"GL873589","8444551","8444632","chr9","93194085","93194171","17","84749534","CGGGCATGGTGGCTCACAACTATAATCTTAGCACTTTGGGAGGCTGAGACAGGTGGATGCCTGAACTCAAGAGTTTGAAACC","GGCCGAGCATGGTGGCTCACACCTGTAATCCCAGCACTTTGGGAGGCTGAGGCAGGTGGATTACCTGAGGTCAAGAGTTCAAGACCA"
"GL873589","9085365","9085494","chr2","194063347","194063481","42","184977982","GGCCAGGCACAGTGGCTCACACCTATAATCCCAGCACTCTGTGAGACTGAGGCAGGTGAACTGTTGCAAGAGTGAGACCCTGTGCTTGGTGCCTGTAGCTCAGTGGTTAATAATAAGAAAAAAGAAAAAA","GGCCAGGTGCAGTGGCTCACACCTGTAATCCCAGCACTTTGGGAGTCTGAACCAGGCAGATCACCTGAGGTCAGGAGTTCGAGGCCAGCTCGGCCACCATGGTGAAACCCTGTTTCTAATAAGAATACAAAAAAA"
"GL873589","9085767","9086002","chr7","84631446","84631650","75","75545679","GAGTGAAACCCTGTCTCTACTAAAAATAGAAAAACTAGCTGTGCATCAGGGCGCATAACTGTAGTCCCAGGTACTCAGGACACTGAGGCAAGAGAATTGCTCAAGCCCAAGAGTTTGCAAGAATTTGAGGTTGCTATGAGCTATGATGCCATGGCACTCTACCTAGGGTGACAGACAGAGACTCTGTCCCAAAAAAAAAAAAAGAAGAAGAAGAAAAAAAAAAAGAAAGAAAGAAA","ATAGTGAAACCTCGTCTCTACTAAAAATACAAAAATTAGCTGGGCATCATGGTGCACGCTTGTAATTCCAGCTACTTGGGAGGCTGAGGCAGGAGAATTGCTTGAACTCAGGAGGTGGAGGTTGCAATGAGCCAAGATCGCGCCACTGCACACCAGCCTGGGTGACAAAAGACTCTGTCTCAAAAAAAAAAAAAAAAAAAAAAAA"
"GL873589","9992904","9993045","chr16","56427538","56427666","46","46434634","AACCAGCCAGGCATGGTGATTCACACCTATAATCCCAGCTACTTAGGAGTATGGCTTGAGCACACAGGATACCATACCATTCTAGTCATCCCAGGCAACAGAGGGAAACTCTGTTGGTTAAAAAAAAAGAAAAACTTAAAAA","TTAGCCAGGAGTGGTGGTGCACGCCTATAATCCCAGCTACTTGGGAGGCTGAGGCACAAGAATCACTTGAACCATTGCACTCCAGCCAGGGTGATAGAGGGAGACTCTATCCAAAAAAAAAACAAAAAA"
"GL873589","9993319","9993452","chr3","2774534","2774668","28","7218785","GGCCTGAGCCCTGTGACTCATGCCTGTAATCCCAGCACTGGAAGTTCCAAGGCAGGTGGATCGCTTGAGCTCTGGAGTTCAAGACCAGCTCAACCAAGAGTAAGACCCCATCTCTACTAAAAATAGAAAAACCA","GGCTGGGCACGGTGGCTCATGCCTGTAATCCCAGCACTTTGAGAGGCCGAGGCAGGTGGATCTCCTGAGGTCAGGAGTTCAAGACCAGCCTGGGCAACATGGTGAAACCCCATCTCTACTAAAAATACAAAAAAT"
"GL873590","9044589","9044884","chr1","83754525","83754835","84","74709936","GGCCAGGTGCAATGGCTCATGCCTATAATCCTCACACTCTGGGAGGCTGAGGCAGGAGGATCACTTTTCTCAGGGTCAGGGCCAGCCTGACAAAAGTCAGACCCTGTTTCTACTAAAAATAGAAAAACTAGCTGGGTGTTGTGGCAGATGCCTATAGTCCCAGCTACTAAGAGACTGAGACAAGTGCCCAGAGTCTGAGGTTACTGTGAGCAAAGCTGATGCCATAGCATTCTAGCTATAGATCGAGAGTCTGTCTCAAAAACAAACAAACAAACAAACAAACAAACAAAAAAGAA","GGCTGGGTGTGGTGGCTCATGCCTGTAATCCCAGCACTTTGGGAGGCCGAGGCGGGTGGATCATCTGAGGTCAGGAGTTCAAGACCAGCCTGACCAACATGGTGTAACCCTGTCTCAACTAAAAATACAAAAATTAGCTGGGCGTGGTGGTGTGCACCTATAGTCACAGCTACTTGGGAGGCTGAGACAGGAGAATTGCTTCAACCCAGGAAGTGGAGGTTGCAGTGAGCCAAGATCATGTCACTGCACTGCAGCCTGACAGAGCGAGACTCCATCTAAAACAAACAAACAAAAACAAACAAACAAACAAA"
"GL873591","1831505","1831587","chr17","61702818","61702899","25","59871313","CCCAGCACTTTGGGAGGGCAAGATGGGAGAATCATATAAAGTCAGGAGTTTGAGACCAGTTTGGCAGACATGATGAACCCATC","AATCCCAGCACTTTGGGAGGCTGAGGCAGGCGGATCATCTGAGGTCAGGAGTTCAAGACCAGCCTGGCCAACATGGTGAAAC"
"GL873591","2719175","2719275","chr4","86137755","86137847","32","83418580","GTGGGGGCTTAGGCCTGTAATCCCAGCACTCTGAGAGGCCAAGGTGAGCTGGTCACCTGGGTTTAGGAGTTTGGAGACTTGCTCGAGCTAGACTGAGGCTC","GTGGTGGCTCACGCCTGTAACCCTAACAATTTGGGAGGCCAAGGCAGGTGGATCACTTGAGGTCAGAAGTTTGAGACCAGCCTGGACAATATG"
"GL873591","4732974","4733120","chr19","7991801","7991954","55","3258827","ATACGCAGACTGGCCGAGCGTGGTGTCACATGCCTATAATCCCAGTGGCTACTCTGGGGAGGAGAATCTCTTGAAACCAAGAGTTAGAGATTGCAGTGGGGTATGATACAGGGTAACAAAGAGAGACCTTGGATCTGAAAAGAAAAA","AAAATACAGAAACTAGCTGGGCATGGTGATGCACACCTGTAATCCTAGCTACTGGGGAGGCTGAGGCAGGAGAATTGCTTGAACCCAGGAGTCAGAGGTTGCAGTGAGCAACCAGCCTGGGTGATACAGTGAGTGAGACTCTGTCTCGAAAAAA"
"GL873591","6822728","6823009","chr1","20579766","20580052","72","13757038","GGCCAGGCGTGGTGGCTCATGCCTGTAAATCTCAGCACTCTGGGAAGCTGAGGCAGGTGGATTGCTTGAGGTCAGGAGTTTGAGACCAGCCTGTACCAGAGTAAGACCCTGTCTCTAATAAAAATAGAAAAAAAAAAAAAAACTAGTTGGGCATGGTGATGGGTGCCTGTAGTCCCACCTACTTGGGAGGCTGAGGCAATGGCATCTCTTGAGCCCAAGAGTTTGAGGTTGCTGTGCCATGGCACTCTCCCCAGGGTAACAGAGTGAAAATAAAAAAAAGAA","GGCCAGGCGTGGTGACTCATGCCTGTAATCTCAGCACTTTGGGAGGCCGAGGCAGGTGAATCACCTGAGGTCAGGAGTTTGAGACCAGCCTGACCAACATGGTGAAACCTCGTCTCTACTAAAAATACAAAAAGTAGCCAGGCATGGTGGCGCATGCCTGTAATCCCAGCTACTTGGGAGGCTGAGGCAGGAGAATCGCTTGAACCCGAGAGGCAGAGGTTGCATTGAGTCAAGATGGTACCACTGCACTCCAGCCTGGGTGACAGATTGAGACTCAAAAAAAAAAA"
"GL873591","7578706","7578813","chr16","45055441","45055543","42","37476735","AAATTTAGCTACACATAGTGGCATGAGTCTGTAATGCTAGCCACCCAAAAGGCTGTAGTAAGAGGATTGCTCTATCCCAGGAGTTAAAGACCAGCCCGGACATCAGAG","AATTAGCCGGGCGTGGTGACACACACTTGTAATCCTAGATACTCAGGAGGCGAAGGTAGGAGAATTGCTTGAACCCAGGCAGCAGAGGTTGCAACGAGCAGAG"
"GL873591","9282916","9283004","chr1","20744253","20744338","16","11461337","GGCCAGGCGCGGTGGCTCACCCCTGTTGTCCCAGTTCTGTGGGAGGCCGAGGTGGGTGGATCACCTGTGCTCAGAGGTTTGAGACCAGC","GGCCAGGCACGGTGGCCACGCCTGTAATCCCAGCACTTTGGGAGGCCGAAGTGGGTGGATTACCTGAGGTCAAGAGTTTGAGACCA"
"GL873592","835155","835315","chr16","75654291","75654451","43","74819136","CTGGGTGTGGTGGCTCTTGTCTGCAATCTCAGTACACTGGGAGGCTGAGGCAGAAGGATTGCTCCAGCTCAGGAGTTTGAGGCCAGGCTGAGCTAGTGCAAAACCCCATCTCTACTAAAAAAAGAAGGAAAAAAAAAAGAAAAAGAAAAAAAATACGAGCT","CCAGGTGTGGTGACTCACGCCTGCAATCCCAGCACTCTGGGAGGCTGAGGTGGGTAGATTACCGGAGGTTAGGCGTTTGAGACCAGCCTGGCCAACATGGTGAAACCCCATCGCTACTAAAAAAAAAAAAAAAAAAAAAAAAAAAAAAAAAAAAAAAATTA"
"GL873592","835589","835765","chr1","66836166","66836336","48","66000577","ACAAAAAACCTAGCTTAGGGTTGTTATAGCACCTGTAGTCCCAGCTACTCAGGCGCTAAGGCAGGAAAATCTGCCTGAGCTCAGGAGTTTGAGGTTGCAGTAAGTTATGATGATGCTACTGCACTCTAGCTGGGGCAACAGAGTGAGACTCTGTCTGAGGAAAAACCAAAACCAAAA","TAGCCCAGCACGGTGGCTCACACCTGTAGTCTCAGCTACTCAAGAGGCTGAGGCATGAGAATCGCTTGAACCCAGGAGGTAGAGGTTGCAGTGAGCTGAGATCATGCCACTGCGCTCCAGCCTGGGCAACAGAGTGAGACTCAGTCTCAAAAAACAAAACAAAACAAAAAA"
"GL873592","2520661","2520705","chr16","66853217","66853257","11","64332556","TCTGGGAGGCTGAGGCGGGTGGATCACCTGAGCAAGAGTGAGACC","TTTGGGAGGCTGAGGCAGGTGGATCACTTGAGGTCAGGAGT"
"GL873592","4535248","4535388","chr1","12240468","12240612","38","7705220","GGCGGGATGTGGTGGTTCATGGCTGTAATCCCAGCACTCAGGGAGGCTGAGTCGGGTGGATTGCTTGAGTTCAGGAGTTTGAGACCAACCTGAGCAAGAACTAAGCCTGTCTCTACTAAAGATATTATTTCTTATTTTTCT","GGCCGGGCGCGGTGGCTCATGCCTGTAATCCCAGCACTTTGGGAGGCTGAGGCGGGTGGATCACCTGCGGTCAGGAGTTCGAGACCAGCCTGGCCAACGTGGTGAAACCTCATCTCTACTAAAAATATAAAAATTAGCTGGTGTG"
"GL873592","4535654","4535831","chr8","126054004","126054184","54","121518350","TCTACTACAAATATTAACAGAAAAATTAGCTGGGCATTGTGACAGGTGCCTATAGTCCCAGATACTCAGAAGGCTGAAGTAAGAGGATCACTTGAACCCCAGGAGCTAAGGTGGCTGTGAGCTAGGCTGAGGCTCTAGCCTGGGTAACAGAGTGAGACTGTAAAAAAAGAAAGAGAGA","GTCTCTACTAAAAATACAAAAATTAGCTGGGTGTGGTGGTGCATGCCTGTAATCCCAGCTACTCAGGAGGCTGAGGCAGGAGAATCGCTTGAACCCAGGAGGTAGAGGTTGCAGTGAGCCAAGATCATGCCACTGCACTCCAGCCTGGGTGACAGAGGGAGACTCTGTCTCAATAAATAAA"
"GL873592","6794968","6795049","chr3","154764711","154764794","20","147969743","GAAGGTTTGATGAGCTCAGATGATGCCACTGCAGTCTACCCAGAGTGAAGGAGCGAGACTCTGTCTCAAAAACAAAAAAAGA","CAGAGGTTGGCAGTGAGCTGAGACTGTGCCACTGCACTCCAGCCGGGTGACAGAGTGAGACTCTGTCTCAAATTACAAACAAAA"
"GL873592","6881384","6881478","chr5","24882384","24882475","28","18001000","GGGCAGGCATAGTGACTGGTGTCTCTAATCCTAGCAGTCTGGGATGCTGAGGCAAGTGGAATGTCAGAGTTCAGGAGTTGAAGATCACCCTGACT","GGCCGGGCGCAGTGGCTCACATCTATAATCCTAGCATTTTGGGAGGCTGAGGCAGGCGGATCACCTGAAGTCAGGAGTTTAAGACCAGCCTG"
"GL873592","6881755","6881937","chr10","61601371","61601572","66","54719616","TCACCCTGACCAAGAGCAAGACCCTGTCTCTACTAAAAATAGAATAAACTAGCTGGGAATTGTGGTGGGTGCCAGTAGTCCCCGCTACTGAGGCAGGAGGATCATTGAGTCCAAGAGTTTGAGGTTGCTGTAAGTTAGGACACCACAGCACTCTACACAGAGTAAGACTGCCTCAAAAATAAA","AGTAAAGAAAAGAAACCCTGTCTCTACTAAAAATACAAAAATTAGCTGGGTGTGGTGGTGCGCACCTGTAGTCCCAGCTACTTGGGAGGGTGAGGTATGGGAATCACTTGAACCCGGGAGGTGGAGGTTGCAGTGAGCCAAGATCACACCACTGCACTCCAGCCTGGGTGAGAGAGTGAGACTCTGTCTCAAGAAAAAAGAA"
"GL873592","7006080","7006155","chr1","8947061","8947129","24","1940981","CACACTGAGAGGCAAAGGCTGGTGGATCACCTGAGCTCAAGAGTTTGAGACCAGCCAAGCCAGAGATCTTGTCTCT","CACTTTGGAGCCAGGTAGGTGATCACCTGAGTCAGGAGTTCGAGACAGCCTGGCCAACATGTGAAACCC"
"GL873592","8446508","8446655","chr11","122502739","122502874","48","114056231","TTAGCTGGGTGTTGTGGCAGGCACCTGTAGTCCCTCCCAGCTACTTGAAAGGCTGAGGCAAGATGACAGCTTAAACCCAAGAGTTTAAGGTTACTCTATTCAGGGCAACAGAGTGAGACTCCATCTACATAAATAAATAAATAAATAA","GGCTGGGCGTGGTGGTTCACACCTGTAATCCCAACACTTTGGGAGGCTGAGGCCAGCGGATTGCCTGAGCCCAGGAGTTTGAGACCAACCTGGGCAACATGGTGAAACTCCATCTCTACTAAAATACAAAAAGTTA"
"GL873592","8446953","8447008","chr16","44513352","44513404","15","36066399","GACCAGCCTAAGCAAAAAAGAGATCCTATCTCTACTACTAAAAATAGAAAAAATTA","ACCAGCCTCACCAATATGAAGAAACCCCATCTCTACTAAAAATACAAAATATT"
"GL873592","8447239","8447325","chr1","8062863","8062957","21","384376","GGCCAGGAGCAGTGACTCATGCCTAGCACTCTGGGAGGCCAAAGCAGGTGGATCAACTGAGCTCAGGAGTTCAAGACCAGCCTAAGC","GGCCGGGTGCAGTGGCTCATGCCTGTAGTCCCAGGACTTTGGCAGGCCAAGGCCGGTGGATTACCTGAGGTCAGGAGTTCAAAACCAGCCTAGCC"
"GL873592","8723925","8724000","chr3","42066983","42067054","20","33343058","AATTAGCCGGGCATGGTAGTGTGTGCCCATAATCTCAGCTACTCAGAAAGCTAAGATAGGAAAATTGCTTGAGCTC","TTAGCTGGGTGTGGTAGTGCATGCCTATAATCCCAGCTACTCGGGAGGCTGAGGTGGGAGAACTGCTTGAAC"
"GL873593","384022","384146","chr15","102382935","102383070","28","101998913","GGCCACGAGGGCCCATGCCTGTAATCCTAGCACTCTGGGAGGCTGAGGTGAGTAGATTGCTGAGCTCAGGAGTTCAAGACCAGCCTGTGCAAGAGACCCCATCTCTGCTAAAAATAGAAAAACCA","GGCCAGGTGTGGTGGCTCACGCCTGTAATCCTAGCACTTTGGGAGGCTGAGGCGGGTGGATTGCCTGAACTCAGGAGGTCAAGACCAGCCTGGGCAACACAGTAAAACCCCATCTCTACTAAAATACAAAAAATCA"
"GL873593","384425","384607","chr20","28286874","28287058","50","27902449","GAAAGAAAAGAAAAGAAAAACTAGCAAGATGTTGTAGCTGATGCCTATAATCCTAGCTATTGGAGAGGTGGAGGCAAGAGAATTGCGTGAGCCCAAGAGTTGAAGGTTGCTGTGAGCTGCGATGCCAGAGCACTCCAGGGTGACAGAGTAAGACTCTGTCTCAAAAAAAATTACAAAATAAAA","TAATAAAAATAAAAAAATTAGCCAGGAGTCAAAGCACACGCCTATAACCCCAGCTACTTGGGAGGCTGAGGGAGGAGAATTACTTGAACCCGGGAGGTGAAAGTTGCAATGAGCTGAGATCAAGCCACTGCACTCCAGACTGGATGACAGAGTGAGACTCTGTTTCAAAAAAAAAAAAAAGACAA"
"GL873593","1408445","1408467","chr10","88070368","88070389","9","86661923","AATCTAGAGATGGGGAGAGGTTG","AAAGAGATGGAAGAGAAGAAGA"
"GL873593","4856365","4856484","chr7","56497314","56497433","31","51640949","GCAATCCCAGCTGATCGGGAGGCTGACCCAGAAGAATCCCTTGAACCCAAGAGTCTGAGGTTGCTATGGGTGGATTCTACAGCACTCTAGCCTGGGAGACAGAGTGAGACTCTGTCCCAA","ATCCCAGCTACTTGGGAGGCTGAGACAGAAGAATTGCTTGAACCCGGGAGGTGGAGGTTGCAGTGAGCCAAGATTGTACCACTGCACTCCAGCCTGGCAACAGAGTGAGACTCTGTCTCA"
"GL873593","6661298","6661485","chr10","86749316","86749514","55","80088018","GCAGAGGCTCACATATGTAATCCTAGCACTCTGGGAGGATAAGGCAGGTGGACAGCTTGAGCTCAGGGGTTTGACCAGTCTGATCAAGAGCAAGACCTGTGTCTACTAAAAATAGAAAACCTAGCCAGGTATGATGGTAGATGCCTGTATTCCTAGCTACTCTGGAAGCTAAAGCTAAAGAGTTTGAA","GGTGGCTCACACCTGTAATCTTAGCAATTTGGGAGGCCGAGGTGGGTGGATCACTTGAGGTCAGGAGTTTGAGACCAGACTGGCCAACATGGTGAAACTCTGTCTCTACTAAAAATACAAAAATTAGCCAGTCATGGTGGTGCATGCCTGTAATCCCAGCTACTCAGGAAGCTTAGGCAGGAGAATCACTTGAACCCAG"
"GL873593","6710263","6710446","chr14","4390080","4390244","66","2320183","TTGAAGTCAGGAGTTTAAGGCCAGTCTGGGCAACATAGTGAGACCCCCATCTCTACGAAAATATTTTTTAAAAATTAAAAATAGCTGGGCATAGTGAGGCTGTTGTGAGCTATAACTGCACCACTGCACTCAGCCAAGGACAGAGACCCTGTTCCCTGCCTCAAACAAACCAAAACAAAACAAA","AAGTCTAGAGTTTACAGCCTGGACAACGCAGTGAAACCCTGTCTCTACCAAAAATACAAAAATTAGACAGGTGTGAGAGGCGGAGGTTGCAATGAGCTGAGATCGCAGCACTGCAGTCCAGCCTGGATGACAGAGCGAGACCCCATCTCAAAAACAAAAACAAAA"
"GL873593","7159645","7159716","chr6","178318394","178318465","21","171158749","GATCATGTCACTGCTCTCCAACCTGGGCAATTGAGCAGGAATCTGTCTCAAAAAGAAAAAAAAAAAAGAAAA","CGAGTTCACACCACTGCACCCCAGCCTGGGCAACAGAATGAGACTCGGTTTCAAAAAAAAAAAAAAAAAAAA"
"GL873593","7159841","7160050","chr13","33368171","33368368","69","26208330","GGCCAGGCGTGGTGGCTCACACCTGTTGTCCCAGTGCTGTGGGAAGCCGAGGCAGGTGGATCACCTGAGCTCAGCCGAGTTCGAGACCAGTGGAAGACCAGCATGAGGCAGAGTGAGCCAGAGTGAGACCCCATCTCTACAACAACAACAAGAAGAAAAAAAACAGCCGGACCTTGTGATCCCAGCTACGTGGGGAGCTAGAGAATCACT","GGCTAGGCATGGTGGCTCATGCCAGTAATCCCACCACTTTGGGAGGCCGAGGCAGGTGGATCACCTGAGGTCAGGAGTTCAAGACCAGGCTGGCCAACATGTTATGATGAGACCCTCATCTCTACTACAAATACAAAAATCAGCTGGGCATGGTGGCAAGTGCCTGTAATCCCAGCTACTTGGGAGGCTGAGGCAGAA"
"GL873593","8598292","8598391","chr11","118461023","118461129","33","109862731","AGCCAGGTGAGGTGGTTCACACCTGTAACCCTAGCTGCTTGGGAGGCTGAGGCCTCTCTATCCTGGGCAGTGTGGAGAAACTTTGTTTCAAAAAAAAGAA","GCCGGGCGCGGTGGCTCACGTCTGTAATCCCAGCGCTTTGGGAAGCCGAGGCGGGACTATCCTGGCCAACATGGTGAAACCCCGTCTCTACTAAAAATACAAGAATC"
"GL873594","357249","357377","chr2","75702890","75703011","36","75345641","CCTGGTACCGTAGGTCATGCCTGTAATCCTAGCACTTTGGGATGCTGAGGTGGGCAGATTGCCTGAGCTCACGAGTTCAAGCCATTAGAACTGAGCCTGACCTAGAGTGGGACCTCCAACTCTTTTTTT","GCCAGGCACAGTGGCTCATGCCTGTAATCCCAGCAGTTTGGGAGGCTGAGGTGGGCAGATCACTTGAGGTCAGGAGTTCAAGACCAGCCTGGCTGACATGGTGAAACCCCATCTATACCAAA"
"GL873594","357656","357834","chr7","17608776","17608965","55","17251120","GGGACCTCCAACTCTTAAAATAGCTGGGCATTGTGGTGGGCACCTACAGTCACAGCTACTTGGGAGGCTAAGGCAAGAGACTTGTTTGCAGCCAAGAGTTAGAGGTTGCTGTGAGCTATGAGGCTAGGGCACTCTACAGGGGGCGACAAGTGAGACTGTAAAAAAAAAAAAAGAAAAAA","GTCCCTACTAAAAATACAAAAAATTAGCTGGGCCTGGTGGCAGGCACCTGTAATCCCAGCTACTTGGGAAGCTGAGGCAAGAGAATTGCTTGAACCCAGGAGGCAGAGGTTGCAGTGAGCTGACATCAAGCCACTGTACTCCAGCCTAGGCAACAAGAGCAAGACTCTGTCTCAAAAAAAAAAAAAAAAA"
"GL873594","1410711","1410996","chr5","151340503","151340797","76","149929792","CACAGTGGCTCATACCTATAATCCTAACACTCTGGGAGGCCAAGGTGGGTGGACTGTCTGAGTTTGGGACCAGCCTGAGCAAAAGCAAGACTCCCATCTCTACTAAAAACAAAGACAGCCAGGTATGAGGGCAGGTGCCTATCATCCCAGCTACTTGGGAGGCTGAGGAAGGAGGATCACCTAAGCCCAGGACTTTAAGGTTTCTGTGAACTAAGATGATGTTACAACACTCTAGCCAGGGTAACAAGGCAAGATTCTGTTTCAAAAGACAAAAAAAAAAAAAAAA","GGTGGTTCATGCCTGTAATCCCAGCACTTTGGGAGGCTGAGGCAGGTGGATCACCTGAGGTCAGGAGTTCGGGACCAGCCTGGCCAACATGGGGAAACCCCATCTCTACTAAAATACAAAAATTAGCCAGGTATGGTGGCACATGCCTATAATCCCAGCTACTTGGGAGGCTGAGGCAGGAGAATCACTTGAACCCAGGAGGCTAAGGTTGCAGTGAGCCGAGATTGTGCCACTGTACTCCAGCCTGGGTGACAGACTGAAACTCTGTGTCCAAAAAACAAAACAAAACAAAAAA"
"GL873594","5528090","5528162","chr2","69013639","69013718","24","63485549","GGTACAGTGGCTCACGCTTGTGATCCCAGGTTGAGGTGGGTGGATCGCCTGAGCTCAGGAGTTGGATGCCAGC","GGTGTGGTGCCTCACGCCTATAATCCCAGCACTTTGGGAGGCAGGTGGATCACTTGAGGTCAGGAGTTTGAGAACAGCCT"
"GL873594","5834047","5834168","chr2","82491537","82491662","28","76657490","GGCTGGGCCCAGTAGCTCACGACTGTAATCCCAGCACTCTGGGAAGCTGAGGTGGGCGGATCACCTGAGCTCATAGGTTCGAGACCAGCTCCAGTTAGAGTGAGAGCCTGTCTCTAAAAATA","GGCTGGGCACAGTGGCTCATGCCTGCAATCCCAGCACTTTGGGAGGCTGAGGTGGGCAGATCACCTGAAGTCAGGAGTTCAAGACCAGCCTGGCCAACACAGTGAAACCCCATCTCTACTAAAAAT"
"GL873594","5834396","5834461","chr13","14688151","14688212","20","8853755","TATATAATAATAATAACCAGGTATTGTGGCAGGTGCCTCTAGTCCCAGCTACTCGGGAGGCAAAGG","ATAAAAAAATTAGCTGGCCATGGTGGCACATACCAATAATCCCAGCTACTCAGGAGGCTGAG"
"GL873594","7786130","7786294","chr14","12217087","12217250","37","4430957","GGGTGTGCTGGCTCATACCTATAATCCTAGCACTCTGGGAGGCTGAGGTAGGTGTATTGCTTGAACCCAGGAGTCTGAGGTTGCTGTGCGCTAAGCTGATACCATAGCACTCTAGCCTGGGCAACAGAGTGAGACTCTGTCTCAAAACAAATAAATAGTAAAAAA","GCTGGGCGTGGTGGCTCACACCTGTAATCCCAGCACTTTGGGAGGCCAAGGCATGAGAATTGCTTGAAAACAGGAGGCGGAGGTTGCAGTAAGCTGAGACTGTGCCATTGCACTCCAGCCTGGGCAACAAGAGTGAAACTCTGTCTCAGAAAAAAAGAAAAAAA"
"GL873595","723579","723774","chr19","6045933","6046125","65","5322354","GCCTGAGCAGGAGAGAGACCCCATCTCTGCTGAAAGTGGAAAAGTTGGCTGAGTGTAGTGGCGGGCTGCTGCCCCAGTCACTCAGGAGGCTTAGGAAGGAGTATCGCTTGGGCCCAAGATTTGAGGTTGCTGTGAGCGCTACAAAGACATTAGGGTACTCTACACAGGGGAATAGAGTGAGACTGTCTCAAAAAAA","CAACATGGAGAAACCCCGTCTCTACTAAAAATACAAAATTAGGCAGCGTGGTGGTGGGTGCCTATAATCCCAGCTACTCAGGAGGCTGAGGCAGGAGAATCGCTTGACCGGGAGTGGAGGTTGCGGTGAGCTGAGATTGCACCATTGCACTCCAGCCTGGGCAACAAGAGTGAAACTCCGTCTCAAAAAGAAA"
"GL873595","724114","724204","chr20","18199749","18199840","22","17475635","GGCCATGCTTGGTGGTTCTCATCTGTAATCCTAGCACTCTGGAAGGTCTACAGGGGTGGATGGCTGGAGGTCAGGAGTTCAAGACTGGCCT","GGCCGGGCATGGTGGCTCACACCTGTAATCCCAGCACTTTGGGAGGCTGAGGCAGGCGGATCACCTGAGGTCAGGAGTTCGAGACCGGCCTG"
"GL873595","1065346","1065667","chr18","10529729","10530057","74","9464383","GGCCAGGTGCAGCAGCTCATGCCTGGAATCTTCCTGCTCTGTATGGCCAAGGCAGGTGGATCGCCTGACCTCAGGAGTTCCAGACCAGCCTGAACAAGAGCAAGACTCTGTCTCTACTAAAAGTAGAAAAAAAACTAGCCAGTCATAGTGGCAGGTGCCTGTAGTCCCAGCTGCTTGGGAGGCTGAGGCAAGAGGATCACTTGAACCTAAGAGTTTGAGGTTGCTGTGAGCTAAGATGCCACATCACTCTATCAAGGGTGACCAAGTGAGACTCTGTCTCAAAAATAAATAAATAAATAAATAAAAAGAAAGGCAAAAAGAA","GGCCCGGCGTGGTGGCTCATGCCTATAATCCCAGCCCTTTGGGAGGCCAAGGCAGGTGGATCACCTGAGGTCAGGCGTTCGAGACCAGCCTGACCAACGTGGTGAAACCTCATCTCTACTAAATACAAAAAAAATTTAGCCAGGCATGGAGGCACATGCCTGTAATCCCAGCTACTTGGGAGGCTGTGGCAGGAGAATCACTTGAACCTGGGAGGTGGAAGTTGCAGTGAGCTGAGATTGTACCACTGCACTCCAACCTGGGTGACAAAGCAAGACTCGGTCTCAATAAATAAATAAATAAATAAATAAATAAATAAAGTGAAAAAAAA"
"GL873595","1254878","1255146","chr4","42822326","42822607","67","41567448","GGCTGGGCATGGTGGCTCATGCCTGTAATCCTACCGCTCTGGGAGGCTGAGGCAGAGGATCACTTGAGCTCAGGAGTTTCAGACCAGCCTGCAAGAAGGACCCAGTCTCTGCCGAAAATAGAAAAGTTAGCAAGGCGTTGTCGTGAGCACATGTATCCCAGCTACCTAGAACTCTGAGGCAGGAGGATCCCTTGAACCCACAGAAGTTGCTGTTATCTAAACTGATGCCACTGGACTCTAGCCTGGGCAACAGAGTGAGACTGGTCTCA","GGCCGGGCACGGTGGCTCATGCCTGTAATCCTAGCATTTTGGGAGGCTGAGACAGGCAGATTGCCTGAGCTCAGGAGTTCAAGACCAGCCTGGGCTAGATTGTGAAACCCCATCTCTACTAAAATATAAAAATTAGCTGGGTGTGGTGGCACACGCCTGTAATCCCAGCTACCTGGGAGGCTGAGGCAGGAGAATCGCTTGAACCAGGAGACAGAGGTTGCAGTGAGCTGAGATCACGCCACTGCACTTTAGCCTGGGCAACAGAGTGATACTCTGTCTCAA"
"GL873595","3417105","3417297","chr12","115674238","115674427","44","112257133","GGCCGGGCGCTGTGCCTCACGCCTGTAATCCTAATACTCTGAGAGGCCGAGGCAGGTGGATTGCCTGAGCTCAGGTGCTCAAGACAGCCTGACTGAGCAAGCCCTGAGATCCCATCTCCACTAACAATAGTAAAACTAGCCGGGCATTGTGGTGGTGCTTGTAATCCCAGCTACTGGGAGGCTAAGACAGGAG","CCAGGCCTGGTGGCTCACGCCTGTAATCCCAGCACTTTGGGAGGCCGAGGTGGGTAGATCACCTGAGGTCAGGAGTTCAAGACCAGCCTGGCCAACATGGCGAAACCCCATCTCTACTAAAAATACAAAAATTAGCTGGGCATGGTGGTGTATGCCTGTAATCCCAGCTACTCGGGAGGCTGAGGCAGGA"
"GL873595","6098380","6098457","chr3","87492619","87492702","21","81394239","GCTGTGGCTCATGCTGATAATACCAGCACTCTGGGAGAACAAGGTAGGCAGATCACAAGAGGTCACCTGTGCAAGACC","GGGCTGGTGGTGGCTCATGCCTGTAATACCAGCACTTTGGGAGGCCAAGACAGGTGGATCACCAAAGGTCAAGAGTTCAAGACC"
"GL873596","134190","134307","chr1","203207333","203207443","31","203073143","GGCTGGGCGAGGTGGCTCACACCTGTAATCCTAGCACTCTGGAAGGCCCTAGCACTCAGGCAGTTGGATTGCCTGAGCTCACAAGTTCAAGACCAGCCTGAAAAAGAGCAAGACCTCA","GGCTGGGTGCAGTGGCTCACACCTGTAATCCCAGCACTTTGGGAGGCCGAGATGGGTGGATCACTTGAGGTCAAGAGTTGAAGACCAGCCTGGACAACATGATGAGACCCC"
"GL873596","134578","134681","chr11","50235285","50235387","37","50100707","CAAACAAAAGAGGAAGACCTCGTCTCTAAAAAAATAGCTGGGCATTGTGAGGAGTACCTGTAGTCCTAGCTACTCAGAAGGCTGAGACAAGAGAATCACTTAAA","CAACATTGTGAAACCCTGTCTCTACTAAAATAGAAAATTAGCCAGGTGTGTGGGCGTGCCTATAATCCTAGCTACTGGGGAGGGTGAGGCATGAGAATCGCCT"
"GL873596","8160215","8160350","chr1","29437872","29437991","30","21277657","GGCCGGGCGTGGTGGCGCACACCTGTAGTCCCAGCGCTATGGGAGGCCGAGGCGGGTGGATCACCTGAGCTCAGAGGTTCGAGACCAGCCAAGACCCCCCTGAGCCAAACGAGCCAGAGTGAGACCCCGTCTCTAC","GGCCGGGCGTGGTGGCTCACGCCTGTAATCCCAACATTTTGGGAGGCCAAGGCGGGTGGATCACCTGAGGTCAGAAGTTCGAGACCAACCTGGCCAACATGGTGAAACCCCTGTCTCTAC"
"GL873596","8421071","8421132","chr20","1874027","1874093","12","6547044","GTCAGGCGCAGTGGCTCACGCCTGTAATCTCAGCACTCTGAGAAGCCAAGGCAGGATCATCT","GGCCAGGCGCAGTGGCTCAGGCCTGTAATCCCAGCACTTTGGGAAGCCAAGGTGAGCAGATCACCTG"
"GL873598","4416400","4416489","chr5","39418145","39418231","15","35001745","GGCCAAGTGTGGTGGCTCATGCCTGTTGTCCCAGCACCGTGGGAGGCCGAGGCTGGTGGAACACCTGAGCTCAGCTGAGTTTGAGACCAG","GGCCAGTTGCGGTGGCTCATGCCTGTAATCCCAGCACTTTGGCAGGCTGAGGCAGGTGGATCACCTGAGGTCAGGAGTTTGAGACCA"
"GL873598","4416855","4416947","chr3","94091253","94091337","31","89674398","GTGAGACCCTGTCTCTACAAAAAAAAAAGCTGGGCACTGTGGCATGTGCCTGTAATCCCAGCTACTTGGGAGGCAAAGGGAAAGAGAATCACT","AAACCTTGCCTTTACTAGAAATACAAAAATTAGCTGGGCATGGTGGCAGGTACCTGTAATCCCAGCTACTTGGGAGGCTGAGGCA"
"GL873598","5126074","5126161","chr1","12339306","12339394","19","7213232","GCCTGGTGCACTGGTTCACACCTGGAATCCTTGCATTCTGAGAGGCCCAGGTAGGCAGATCACCTCAGCTCAGAAGTTCGAGACCAGC","GCTGGGTGCGGTGGTTCACGTCTGTAATCCCAGCACTTTGGGAGGCCGAGGCGGGCAGATCACCTGAGGTCAGGAGTTCGAGACCAGCC"
"GL873598","5467584","5467662","chr1","9313328","9313403","17","3845744","GCGAGGTGGCTCACGCCTGTAATCCCAGCACATTTGGAAGGCCAAGGAGGGTGGATCACCCGAGCTCACCAGTTGGAGA","CGCAGTGGCTCACGCCTGTAATCCCAGCACTTTGGGAGGCCGAGGCAGGCAGATCACCTGAAGTCAGGAGTTTGAG"
"GL873598","6917752","6917856","chr14","9558287","9558382","22","2640535","GGCCAGGCATGGTGGCTTGTGCCTGTTGTCCCAGCACTGTGGAAGGCCGAGGCGGGTGGATCGCCTGAGCTCAGCTGAATTCGAGACCAGCATAAGACCAGTATG","GGCCAGGCATGGTGGCTTATGCCTGTAATCCCAGCACCTTGGAAGGCCGAAGCGGGCAGATCACCTGAGCTCAGGAGTTTGAGACCAGCCTGTCCA"
"GL873598","8078910","8079062","chr7","164825511","164825660","43","156746601","AACAGCCAGGCATTGTGGTGGGCACCTGTAATCCCAGCTACTTGGGAGGCTGAGGCAAGAGAATTGCTTGAGCCCAACAGTCTCAGGTTACTGTGAGTTATGACACCATGGCACTCTATTGAGGGCAAGAAAGTGAGACTGTCTTGGAAAAAA","CTAGCCAGGCATGGTGGTGCGCACCTGTAGTCCCAGTTACTTGGGAGGTTGAGGCAAGAGAATTGCTTGAGCCTGGAAGGCAGAAGTTGCAGTGAGCTGAGATCACACCACTGCATTCCAGCCTGGGCGAAAGAGCAAGACTCTGTTGAA"
"GL873598","8079328","8079454","chr6","10381248","10381379","32","2301920","GCCCGGCGTGGTGGCTCACGCCTGTAATTCCAGCACTCTGGGGAGGCCGAGGAGGGCAGATTGCCTGAGCTCACAGGTTTGAGCTAGAGCGAGACCCTGTCTCTTAAAAAGAAAAAAAAGGAAAGAA","GCTGGGCGCGGTGGCTCACGCCTGTAATCCCAACACTTTGGGAGGCCGAGGCGGGCAGATCACCAGAGGTGATCTCCAGCCTGGGCAGGAGAGCAAGACCCTGTCTCAAAAAATTTAGAAAAAGGAAAGAAA"
"GL873599","3943256","3943456","chr9","35892110","35892312","79","31948854","GGCAGGCTGCTTTGACCCATATCTACAACTCCAGAACTTTAGAGGCTGAGCTGGGTGGGTCCCTTGAGATTAGAAACTGCTTAGTAGCCTGGCAAAAACCAGACCCCACCTCCACCATGTAGAAAAATTAGCAGTATGCCATAGTGGGAACCTACCAATACAGTCTTTCCAAAGGCCAAAGCTAGAAGGACCGTGAGCTTG","GGCTGGGTGTGGTGGCTCATGCCTATAATTCCAGCACTTTGGGAGGCCGAGGCAGGTGGATCACCTGAGGCCAGGAGTTTGAGACCAGCCTGGCCAATATGGTGAAACCCCATCTCTACTAAAAGTACAGAAAATTAGTCAGTCATGATGGCGCATGCCTATAATCCCAGTTACTCGGGAGGCTAAGGTAGGAGAATTGCTTG"
"GL873599","6693284","6693349","chr1","100916857","100916922","15","94223573","TCACGTCTATAATCCTAGCACTCTGGGAGTCCTTGGCAGGTGGATCACCTGAGCTCAGGAGTTTGA","CATGCCTGTAATCCCAGCACCTTGGGAGGCCAAGGTGGGTGGATCACCTGAGGTCAGTAGTTTGAG"
"GL873600","991618","991705","chr15","13850109","13850195","15","12858491","GGCTGGGCGTGGTGGCTCACACCTGTTGTCCCAGCGCTGTGGGAGGCTGAGGCAGGTGGATCACCTGTGCTCAGAGGTTGAGACCAGC","GCCGGGCGCTGTGGCTCACACTTGTAATCCCAGCACTTTGGGAGGCTGAGGCAGGTGGATCACCTGAGGTCAGGAGTTAGAGACCAG"
"GL873600","8825981","8826014","chr16","43605817","43605844","11","34779836","AGTCTGGGGCAACAGAGCAAGACTCTGTCTCAAA","CAGTCTGGGTGACAGAGCAAGATTCCAT"
"GL873600","8826039","8826157","chr13","87428402","87428520","35","78602363","ATTAGCCTGGTGTGGTGGTATATGCCTTCCTGCCTGCTTGGGAGGCTGAGGCAGGAAGTATGCTTTAACTGTGGAGTCTGAGGTTGCTATGAGCTAGGTTGAGGCCATGGCACTCTAAA","TTAGCCGGGTGTGGTGGTGCACGCCTGTAATCCCAGCTACTCAGGAGGCTGAAGCAGGAGAGTTGCTTGAACCCAGGAGTTGGAGGTTGCAGTGAGCTGAGATCACGCCATTGCACTCC"
"GL873601","269289","269338","chr14","49279240","49279285","14","49009951","GACTGGGTGTGGTGGCTCACACCTTTAATCCTAACACCCTGGGAGGCTTA","GGCTGAGATGGTGGCACACACCTGTAATCCCAGCTACTTGGGAGGC"
"GL873601","269431","269678","chr1","184453273","184453521","76","184183842","AGAAGATCACTCAAGATCAGGAGTTTGAGAACAGCCTGAGCAAGACCCCCATCTTTACTAAAAATGGAAAAGTTTTTACCCAGGCATGGTAGTGCGTGCCTGTATCCCATCTACTCCGGAGGCTGATAGGAGGATTGCTTCAACCAAGGAGTTTGAGGTTCCAGAGACTTAAGATGACACAACTGCATTTTACCCAGTGTGACACAGCGAGACTCTTTCAGAAGAATTTTTAAAAGGAAAAAAAAGAA","GGTCAGATCACCTGAGGTCAGGAGTTTGAGACCAGCCTGACCAACATGGTAAAACCCCATCTCTGCTAAAAATACAAAAAATTAGCCAGGCATGGTGGTGAACGCCTGTAATCCTAGCTACTCAGGAGGCAAAGACAGGAGAATCGCTTGAATCTGGAAGGTGGAGGTTGCAATGAGCCAAGATGACGCCACTGCACTCCAACCTGGGTGACAGAGGAAGACTCCATCAAAAAAAAAAAAAAAAAAAAA"
"GL873601","1397978","1398117","chr16","24839455","24839591","34","23441477","GCCTATAATCCTAGCACTCTGGAAGGCTGAGGCAGGAAGATCACTAGAGCTTGGGAGTTTGAGATTGCTGTGAGGGAGACTGACTCCATGGCACTCTAGCCTGAGGCAACAGAGTAAGACTCCATCTCAAAAAAAAAAAA","CTCTAACTCCAGCTACTCAGGAGGCTGAAGCAGGAAAATCACTTGAACCTGGGAGGTGGAGGTTACAGTGAGCCAAGATCACACCATTGCACTCCAGCCTGAGCGACAGAGCGAGACTCTGTCTCAAAATAAATAAA"
"GL873601","4065502","4065590","chr11","108711352","108711444","19","104645850","GCTGGATGTGGTGGCTCTCACCTATAATCCTAGCACTCTGGGAGGTCAAAACAGGTGGATCACCTGAGCTCAGGAGCAAGAACACCAGC","GTCAGGGGTGGTGGCTCACGCCTGTAATCCCAGCACTTTGGGAGGCCAAGGCAGGTGGATCGCCTGAGCTCAGGAGTTCAAGACCAGCCTTGC"
"GL873601","8241370","8241465","chrY","9469734","9469829","34","1228364","AAAAAAGGTGGAGATGAGCCATGCGCAGTGGTGTAGGCCTGTAATCCCAGCCCTTGGGAGGCCAAAATGGTGGATTGCCTGAAGCAGAGCAAGACC","AAAGTACAAAGAGTCTGGGTACAGTGGCCCAAGCCTGTAATCCCAGCAGTTTGGGAGGACAAGATGGGTAGATCACCTGACATCATGAATTAGAGA"
"GL873569","7519122","7519191","chrX","79016364","79016431","16","71497242","TTGGCCAGGCATGGTCGCTCAGGCTGTAATACCAGCTACTTGGGAAGCTGAAGCAGGAGGATCACTTGAA","TTGGCCAGGCACGGTGGCTCATGCTTATAATCCCAGCTACTCGTGAGGCTGAGGCAGGGGAATCGCTT"
"GL873569","7989158","7989286","chr8","41505677","41505810","35","33516519","AGTCCCACCTATTTGGAAGGCTGAGGCAAGAGGATCACTTGAACTCAGCAGTTTGACATTGCTATGAGTTAGATTGACTCCATGGCACTCTAGCCCAGGCAACAGAGCAAGACTCCGTCTCAAAACAAA","TAATACCAGCTACGTGGGAGGCTGAGGCAGGAGAATCACTTGAACCCGGGAGGTGGAGGTTGCAGTGAGCTGAGATTGCACCGTTGCACTCTAACCTGGGCAACAAAAGCAAAACTCTGTCTCAAAAAAAAAAA"
"GL873569","7989575","7989702","chr1","62231025","62231129","47","54241450","GGCTGGGTAATGCAGTGGCTCACGCCTATAATCCTAGTGCTTTGAGAGGCCAAGAGTGAGACTCTGTGTACTAAAAATAGAAAAATTACCTAGGCATTCTGGTGGGCACCAGTAGTCCCACCTATTTG","GGCTGGGCATGGTGGCTCACGCCTATAATCCCAGCACTTTGGGAGGCCGAGGCAGGTGGATCACCTGAGATCAGGAGTTTGAGACCAGACTGGCCAACATGGTGA"
"GL873569","10034363","10034556","chr10","61268396","61268605","62","51234033","CAGCTTGAGCAAAAGTGAGCCCCTGTCTCTACTGAAAATAGAAAAAATTAGCCAGGCGTGGTGGCACACACTTATAGTCCCAGCCACTTAGGAGGCTGAGGCAGGAGTTTGAGGTTGACATAATCTAAGCTGATACCATAGCACTCTAGCCTGGGCAATAGAGTGAGACTCTGTCTCAAAGAAGAAATTTATCT","CCTGACCAATGGTGAAACCCTGTCTCTACCAAAAATACAAAATTTAGCTGGGCATGGGGGCACGCACCTGTAGTCCTAGCTACTCGGGAGGCTGAGACAGGAGAACTGCTTGAACTCGGGAGGCAGAGGTTGCAGTGAGCTGAGATCATGCCACTGCACTCTAGCCTGGGCAATAGAGTGAGACTCCGTCTCAAAAAAAAAAAAAAAAAA"
"GL873569","10034830","10034845","chr1","217667782","217667796","2","207632952","AAAAAAGAAGAAAAAA","AAGAAAAAGAAAAAA"
"GL873569","10203815","10203922","chr8","96374555","96374671","35","86170740","GCCAGGTGTAGTGGTTCACACCTATAATCCTAGCACTCTGGGAGCCTGAAGCAGGTAAATGGACTGAGCAAGAGTGAGACTTCCACCTCTATTGAAAATAGAAAAATT","GGCTAGGTATGGTGGCTGATGCCTATAATCCCAGAATTTTGGGAGGCCGAGGCAGGCAGATCATCTGAGGTCAGGAGTTTGAGACCAGTCCCGTCTCTACTAAAAATACAAAAATTA"
"GL873569","10204196","10204373","chr20","1304385","1304559","47","8899811","GAAAATAGAAAAATTAGCCAGGCATTATAGCAGGCACCAGTAATCCCAGTTACTTGGGAGGCTAAGGCAAAAGAATCTCTTGAGCCCAAGTTTGGGGTTGCTAGGAAGTAAAACACCACAGCACTATACCCAGAACAAGAGAGTGAAGACTCAGTCTCAAAAAGATAAATAAATAAAA","AAAAATACAAAAATTAGCCAGGCATGGTGGCGGGCGTCTGTAACTCCAGCTACTTGGGAGACTGAGGCAGGAGAATCGCTTGAACCCAGGAGGCAGAGGTTACAGGTGAAATCACACCACTGCACTCCAGCCTGGGCAACAGGGCAAGACTCTGTCTCAAAAAAAAAAAAAAAAA"
"GL873569","10473375","10473444","chr8","20660648","20660717","21","10187273","TGTAGTCCCAGCACTTTGGGAGGTTAAGGCAAGAGTAGCACCCAACATGAGGAGATCAAGACCAATCTGG","CTGTAGTCCCAGCACTTTGGGAGGCTGAGGCAGGTGGATCCTTTGAGGGCAGAACTTTAAGACCAGCCTG"
"GL873570","9287350","9287485","chr1","29437872","29437991","30","20150522","GGCCGGGCGTGGTGGCGCACGCCTGTAGTCCCAGCGCTATGGGAGGCCGAGGCGGGTGGATCACCTGTGCTCAGAGGTTCGAGACCAGCCAAGACCCCCCTGAGCCAAACGAGCCAGAGTGAGACCCCGTCTCTAC","GGCCGGGCGTGGTGGCTCACGCCTGTAATCCCAACATTTTGGGAGGCCAAGGCGGGTGGATCACCTGAGGTCAGAAGTTCGAGACCAACCTGGCCAACATGGTGAAACCCCTGTCTCTAC"
"GL873571","3669989","3670207","chr4","116777080","116777297","60","113107091","AGACCAGCCTGAGGAAGAGCAAGATCCCATCTCTATTAAAAATAGAAAAATTAGCCAGGCATTCTGGTGGGCACCTGTAGTTCTAACCACCTGGGAGGCTAAGGCAAGAGGAACTCTTCAACCCAAGAGTTTGAGGTTGCTGAGAGCTAGGCTAAGGCTGCAGCACTCTAGCCTGGGCAACAGAGTGAGACTGTTTCTCAAAAACAAAAAACAAAAAAA","CGAGACCAGCCTGGTCAATATGGTGAAACCCCGTCCCTACTAAAAATACAAAAATTAGCCAGGCATGGTGGCAGGCACCTGTAGTCCCAGCTACTCGGAAGGCTGAGGCAGGAGAATCGCTTGAACCACAGAGGCAGAGGTTGCAGTGAGCCGAGACTGCACCACTGCACTCCAGCCTGGGCGACAGAGTGAGACTCAGTCTCAAAAAAAAAAAAAAA"
"GL873571","106134","106236","chr4","18143723","18143826","27","18037589","GGCCAGTCTCAGTGGCTCACACCTGTAATCCAGCATTCTGGGAGGCTGAAGCACACGGTCACCTGAGCTCAAAGGTTGGAGACCAGAGTGAGACCCCACCTCT","GGCCAGGCGCAGTGGCTCACTCCTGTAATCCCAGCACTTTGAGGCTGAGGCAGGCGGATCACCTGAGGTCAGGAGTTTGAGACCAGCCTGGCCGAAACCCCATC"
"GL873571","3670496","3670589","chr7","50468399","50468491","15","46797903","GGGCAGGCATGGTGGCTCACACCTGTAATTCTAGCACTCTTGGAGGCTGAGGCAGGAAAATGGCTTGAGGTCAGGAGTTCAAGACCAGCCTGAG","GGCCAGTCATGGTTGCTCACACCTGTAATACCAGCACTTTGGGAGGCCGAGGCAGGCGAATCACCTGAAGTCAGGAGTTCAAGACCAGCCTGG"
"GL873571","4059090","4059389","chr7","52903696","52903994","88","48844606","GGCCAGGTGCAGTGGTTCACACTTATAATCCTAGCACTCTGGGAGGCCGAGGCGAGTGAAGTGCCTGAGCTCATGGGTTCAAGACCAACCTAAGCCAGAGACCCCTGACTCTTATAATAGCCTGGCATTGTGGTGGGCGCCAATATTTCCAGCTACTCTGAGGCTAAGGCAAGAGAATTGCTTGAGCCCAGGAGTTGGAGGTTTCTGTGAGCACTGACGCCGCAGCTCTCTACCAAGGGCAACAAAGACTCTGTCTCAAAAAATAAATAAATAAATAAATAACAGAATGAAAATGAAAAA","GGCCGGGTGCGGTGGTTCACGCCTGTAATCCCACCACTTTGGGAGGCTGAGGCAGGCAGGTCACCTGAGGTCAGGAGTTCCAGACCAGCCTGGCCAACATGGTGAAACCTTGTCTCGGCTATTAGCCTGGCATGGTGGTGCGTGCCCATAATCCCAGCTACTCAGGAGGCTGAGGCAGGAGAATCGCTTGAACCCAGAAGGTGGAGGTTGCAGTGAGCCAAGATAGCACCACTGCAACTCCAGTCTGGGCAACAGAATGAGACTCTGTCTCAAAAAAAAAAAACAAAAAACAAAAAGAA"
"GL873571","4209418","4209704","chr11","32517699","32517985","80","28308281","GGCTTGGCAAGGTGGCTTACACCTCAAATCCTAGCACTGTGGGAGACTGAGGCAGGTGGATTGTTTGAGCTCAGGAGGTCAAGATAGAGAGCAAGAGCAAGTCTCTGTCTCTACTAAAAATAGAAAAGAACTACTTCCCGGGGGTCATGGCAGTAGCCTGTAATCCCAGTTACTAGGTAGAATGAGGCAAGAGGATCTGTTGAAGCCAAGAGACTGAGGTTGTTATGAGCATGCCACAGCACTCTACCCAGGGTGACAGAATGAGACTCTGTTGAAAGAAAAAAAGA","GGCCGGGTGCAGTGGCTCACACCTGTAATCCCAGCACTTTGGGAGGCTGAGGCGGGTGGATCACCTGAGGTCAGGAGTTCAAGACCAGCCTGACAAACATAGTGAAACCCTGTCTCTACTGAAAATACAAAATTAGCCAGGTGTGGTGGCGCATGCCTGTAATCCCAGCTACTCGGGAGGCTGAGGCAGGAGAATTGCTTGAATCCAGGAGGTGGAGGTTGTGTGATCACACCACTGCACTCCAGCCTGGGCGACAGAGTGAGACTCTGTCTCAAAAAAAAAAGAAA"
"GL873571","4209985","4210154","chr3","175781758","175781928","60","171571773","GAAAGAAATGAAAAGAAAGAAGTTAGCTGGTTGTTGGGGTATGCTTCTATAGTCCCACCTACTCAGAAAGCTGAAATCTGGAGTTTGGGGTTGTTGTAAGGTAGGCTGATGACATAGCACTGTAGCTTGGGCAAGAGAGTGTGACTTTGTCTCAAAAAAAATTAAAACAA","ATTAAAAACACAAAGATTAGCCAGGTGTGATGGCACACAACTGTAATCCCAACTACTCAGGAGAATCGCTTGAACCTGGGAGATAGGGTTTGCAGTGAGCCAAGATTGTGCCACTGCACTCCAGCCTGGGTGACAGAGTGAGACTCTGTCTCCAAAAAAAAAAAAAAAAAA"
"GL873571","4210444","4210570","chr17","16655655","16655789","35","12445211","GCCAGGCAGATGGCTCACACTTCATCCTAGCCCTCTGGAAGGCTGAGGCAGGCTAATTTTTTGAGGTTAGGAGTTTGAGACCAGCCTGAGGAAGAGACCCATCTCTACTTTAAAAAATAAATGGAAA","GCCAGGCATGGTGGCTCACACCTGTAATCCTAGCACTTTGGGAGACTGAGGCGGGTGAATCACCTGAGGTCAGGAGTTTGAGACCAGCCTGACCAGTATGGTGAAACCCAGTCTCTACTAAAAATACAGAAATTA"
"GL873571","4391733","4391878","chr11","33723808","33723943","46","29332075","AACTTAGCTGGGAATGGTGGCTCAAGCCTGTAATCCTAGCACTCTGGGAGGCTCAGGTGGGAGGATCACTTGAGGTTGCTGTGAGCTTGGCTGATGCCAGGACACTCTAGTGTGGGCAAGAGAGTGAGACTCCGCCTCAACAACAA","GCCGGGTGCAGTGGCTCATACCTGTAATCCCAGCACTTTGGGAGGCTGAGGTAGGCGGATCACGAGGTCAGGAGCTGAGATGGCGCCACTGCACCCCAGCCTGGGTGACAGAGCAAGACTCTGTCTCAAAAAAAAA"
"GL873571","6307773","6307841","chr9","62429628","62429694","22","56121855","CTGGGTGTGGTGGCATTGCACCTGTAATCCTAGCTACTTGGAAATCTTAAGCCCAGGAGTTGAAGACTG","CCCAGCATGGTGGTGCATACCTATAATCTCAGCTACTTGGAGGCTTGAGCTCAGAAGTTTGAGACCG"
"GL873571","6496217","6496306","chr1","27257765","27257856","27","20761548","GCAGGGTGTGTTGACCCACACCCACAATTCCAGGACTCTGGGGGGCCAGGGATGGTGGGTTCCCTCAGATCAGGAGCTCCTTACCAGCCT","GACTGGGCATGATGGCTCAAATCTGTAATTCCAGCACTTTGGGAGGCCGAGGTGGGTGGATTGCCTGAGATCAGGAGTTCAAGACCAGCCTG"
"GL873571","6499738","6499903","chr1","38976375","38976555","47","32476637","AAAATAACATGAATTGACTAGGCGAGGTGGCTCACATCTCTAATCCTAGCACTCTGGGAGGCTGAGGCAGGAGAATTGCATGAGGTTGCTGTGAGCTATGATGATACCACGGCATTCTAATCAGGGTGACAGAGTGAGATTCTGTCTTAAAACAAACAAACAAAAA","AAAATAAATAAATTAGCAGGGCCTGGTGGCGCACACCTGTAATCCCAGCTACTTGGGAAGCTGAGGCAGGAGAACCCACTTGAACCTGGGAGCCGGAGGTTGCAGTGAGCTGAGATGGCACCACTGCACTCCAGACTGCGTGACAGAGTGAGACTCCGTCTCAAAAACAAACAAACAAAAA"
"GL873571","11399575","11399872","chr15","109458692","109458994","79","98059117","CAGTGGCTCACACCTGTAAATCTAACACTCTGGGAGGCCAAGGTGGGTGGATCCCTTGAGCTCAGGAATTTGATACCAGCCTGAGCAAGAGTGAGACCTTGTCTCTACTAATAATAGAAAAATAGCCCGTGTTGTGGCACTTGTCCCAACCACTGGGGAGGCTTTAGGCGGGAGGATTACTTGAATTGGGAGTTTGATATTGCTGTGAGCTGGGCTGATGCCTTGGCATTCTAGCTTGGGTAACAGCGTAAGACTCCGTCTCAAATAAATAAATAAATAAATAAAAAGAAAAAAAGAA","GTGGCTCACACCTGTAATCTCAGCACTTTGGGAGACCGAGGCAGGTGGATCACCTGAGGTCGGGAGTTTGAGACCAGCCTGACCAACGTGGAGAAACCCCGTCTCTACTAACAATACAAAATCAGCTGGGCGTGGTGGTGCATGCTTGTAATCCCAGCTACTCGGGAGGCTGAGGTAGGAGAATCGCTTGAACCTGGGAGGTGGAGGTTGCGGTGAGCCGAGATCGAGCCACTGCACTCCAGCCTGGGTGACAGAGCAAGACTCCATCTCAAAAAAAAAAAAAAAAAAAAAAAAAAAAAAAAA"
"GL873572","114760","114841","chr8","26280134","26280211","16","26165374","GGCCAGGCATGGCGGCTCTTCCCTGTAATCCTAGCACTCTGGGAGGGCGAGGCAGGCAGATCACCTAGGCTAGGGTGAGATC","GGCCAGGAATGGTGGCTCATGCCTGTAATCCCAGCACTTTGGGAGGCTGAGGCAGGCAGATCACCTGAGGTCAGGAGT"
"GL873572","9421791","9421892","chr11","8089184","8089269","35","1332607","TACTAAATATATAGCAAGGCCAGGCACAGTGGTTCATGGCTGTAATCCCAGTACTCTGGGAGGCCTAGTCAGAGTTGACCTGAGATCAGGCTAGAAGCCTGG","ATAAAAATAATTGGAGGCCAGGCACGGTGGCTCATGCTTGTAATTCTAGCAATTTGGGAGGCTGACGCGGGTGAGATCATACTGAG"
"GL873572","11052834","11053035","chr14","11857478","11857657","65","804644","TCCACAAAGAAAGCAGAAGTGTGGCCGGGTGGTAGCTCAAGGCAGGAATCCCAGCACTCTGGGAGCTGGGAGGTGGGGGAGGATCCCTTGAGATCAGGAGTTGGAGGGCACAGTGAGCCTGGGGGAGGCCACTGTCTCTGTACTCTAGCAGGGAGACAGAGCAAGACTGCCCATTCAAAGAAAAACAACAAACAAAACAAAA","TACAAAAATTAGCTGGGCACGGTGCCACAAGCCTGTAATCCCAGCTACTCGGGAGGCTGGGCAGGGGAATAGCTTGAACCCAGAGGTGGAGGTTGCAGTGAGCCAAGATCAAGCCACAGCACTCCAGCCTGGGTGACAGAGCAAGACTCCATCTCAAAAAAAAAAAAAAAAAAAAAAAAA"
"GL873573","2564195","2564244","chr1","109985445","109985491","12","107421250","TACAAAAATTAGGCTGGGCTTGGTGGTTCACGCCTATAATCCTAGCACTT","ACTAAAATTAGCTGGGCATGGTGGTGCATGCCTGTAATTCCAGCTAC"
"GL873573","7423371","7423533","chr2","202783328","202783513","56","195359957","GGTGGCTCACACCTGTAATCCCAGCACTCTGGGAGCCCTGGTGGCTCATGTCTATAATCCTAGTACTCTGGGAGACCATGGTGGCTCATGTCTATAATCCTAGTACTCTGGGAGCCATGGTGGCTCACGCCTATAATCCTAGTACTCTGGGAGACCATGGTGG","GGCTGAGGCGCGGGGGCTCACGCCTGTAATCCCAGCACTGTGGGAGGCCGAGGCGGGTGGATCACGCCTGTAATCCCAGCACTGTGGGAGGCCAAGGCGGGTGGATCACGCCTGTAATCCCAGCACTGTGGGAGGCCGAGGCGGGTGGATCACGCCTGTAATCCCAGCACTGTGGGAGGCTGAGGC"
"GL873573","9657648","9657710","chr19","10207852","10207913","10","550204","TAAAAATAAAAAATTTAGCTGGATGTGGTGGCTCACACCTGTAATCCTAGCACTCTGGGAGAC","TAAAAATACAAAATTAGCTGGGTGTGGTGGCACACACCTGTAATCCCAGCTACTCAAGAGGC"
"GL873574","1624662","1624783","chr9","814961","815079","36","809701","GACTGGGTGGGTTGGATCATGCCTGGAATCCTAGCACCCTGGGAGGCCAAGGTGAAAGGATTGCTTGAGGTTAGGAGTTCCAGAAATGTAGCAGTCATGGTGACTTCATCCTTCTCTACCAA","GGCTGGGTGCTTTGATTCATGCCTGTAATCCCAGCACTCTGGGAGGCCGAGGCAGGTGGATCACCTGAGGTTAGGAGTTCGAGACCAGCTTGGCTAACATGGTGAAACCTCGTCTCTAC"
"GL873574","4459477","4459612","chr1","29437872","29437991","29","24978395","GGCCGGGCGTGGTGGCGCACGCCTGTAGTCCCAGCGCTATGGGAGGCCGAGGCGGGTGGATCACCTGAGCTCAGAGGTTCGAGACCAGCCAAGACCCCCCTGAGCCAAACGAGCCAGAGTGAGACCCCGTCTCTAC","GGCCGGGCGTGGTGGCTCACGCCTGTAATCCCAACATTTTGGGAGGCCAAGGCGGGTGGATCACCTGAGGTCAGAAGTTCGAGACCAACCTGGCCAACATGGTGAAACCCCTGTCTCTAC"
"GL873574","4681987","4682216","chr6","153082888","153083127","73","148400901","GGGTGCGGTGGCTCAGACCTATAATCCCAGCACTCTGAGAGGCCGAAGTGGGTGGATCACCTGAGCTCAGGAATTTGAGACCAGCCGTCTCTAAAAATAGCTGAGTGTTGTGGCAGTGGCTGTAAGTCCCAGCTGTTTGGAAAGCTGAAGCAAGGGAATCACTTGAACCCAAGAGTTTGAGGTTGCTGTGATGACAAAGTGAGACTCTATCTCAAAAAAAAAAAAAAAAA","GGCCGTGCGCGGCGGCTCACGCCTGTAATCCCAGCACTTTGGGAGGCTGAGGTGGGTGGATCACCTGAGGTCAGGAGTTTGAGACCAGCCCGACCAGAAATTAGATGGGTGTGGTGGTGCGCTCCTGCAGCCCCAGCTACTTAAGAGGCTGAGGCAGGGTAATCACTTGAACCCGGGAGGCGGAGGTTGCAGTGAGCCGAGCTCACGCCACTGCACTCCAGCCTGGGTAACAGAGCGAGA"
"GL873574","4709916","4710039","chr19","13152422","13152536","46","8442506","AAAAATAGAAAAACTAGCCAAGCATGGTGGTGCACCCCCTATAGTCTGAGCTCCTCAGCGGGCTGAAGCAAAAGGACGGCTGGAGCCCTGGAGTTTGAGGTTGCTGTGAGGCAAGGTGATGCCA","ACACATAAATTAGCCAGACATGATGGTGAGTATCTGTAATTCCAGCTCCTTGGGGGGCTGAGGCGGGAGAATTGCTTGAACCTGGGAGGCAGAGATTGCAGTGAGCCAAGATCGC"
"GL873574","6353839","6353913","chr5","25768079","25768163","22","19414240","AAAAATATAGCAAGGCCAGGCATGGTGGCTCACACCTATAATCCCAGTACTTGGGAGCTGGAATTTGAACCTAGG","AAAAAACTCAAACAAGGCTGGGCGTGGTGGCTCACACCTGTAATCCCAGCACTTTGGGAGGCTGAGGTGGGTGGATCACCTGAGG"
"GL873574","6533061","6533332","chr5","85182161","85182439","81","78649100","GGCTGGGCGAGGTGGCTTACACCTATAATCCTAGTACTCTGGGAGGCCAAGGTGGGTGGATTGCCTGAGCGCACAGTTTCAAGACCAGCTGGAGCCAGAGAGAGAGAGAGAGACCCTGCCTCTAAAAATAGCCAGGCATTGTGGCAGGCACCTGTAGTCCCAGCTACTTGGCAGGCGGAGGTATGAGAATCGCTAGAGGTTGCTGTTAGCTATGATGCCATAGCACTCTACCAAGGGCGACAAAGTGAAACTCTGCCTCAAAAAAAAGAAGA","GCCAGGCGTGGTGACTCAAGCCTGTAATCCTAGCACTTTGGGAGGCCAAGGTGGGCGGATTGCCTGAGCTCAAGAGTTTGAGACCAGCCTGGGCAACACGGTGAAACCCAATCCCTACTAAATACAAAAAAAATTAGCCGGGTGTGGTGGTGTGAACCTGTAGTCCCAGCTACTCGGGAGGCTGAGGCAGGAGAAGGCAGAAGTTGCAGTGAGCCGAGATCACACCACTGCACTCCAGCCTGAGTGACAGAGCAAAACTCTTTCTCAAAAAAAAAAAAA"
"GL873574","6643746","6643907","chr2","92627944","92628105","46","85984198","AAATAGCCAGGCGTTGTGGCAGGCACCTATAGTCCCAGCTACTTGGGAGGCTGAGGCAAGAGAATCACTTAAGCCCAAGTGACAGAGGTTGCCAGGGCACTCTACGTAGGCAACAGAGTGAGACTCTATCTAAGAAAGAAGGAAGGAAGGAAGGAGAAAGAA","TTAGCCGAGCATTGTGGTGCGCGCCTGTAGTCCCAGCTACATGGGAGGCTGAGGCAGGAGAACACCTGAACCCAGGATGTGAGCTGAGTCGCGCCATTGCACTCCAGCCTGGGCAACAGAGTGAGACTCCATCTCAAAAATAAAATAAAATAAAATAAAAAA"
"GL873574","6644163","6644274","chr1","128607504","128607619","20","121963341","CTGTAATCCTAGCACTTGGGAGGCTGAGGCAGGTGGATCACCTGAGTTCAGGAGTTCAAGACCAGCCTAAACAAGAGTGAGACCCTATCTCTACTAAAAATAGAAAAAATAT","GCCTGTAATCCAAGCACTTTGGGAGGCTGAGGCGGGTGGATCACCTGAGGTCAGGTGTTCGAGACCAGCCTGGCCAACGTGGTGAAACCCCAACTCTACTAAAAATACAAAAATTA"
"GL873574","8511822","8512127","chr1","23439759","23440073","84","14927937","GGTGGCTGGTGCCTGTAATCCTAGCACTCTGGGAGACTGAGGCAGGTGGATCACTTGAAATCAGGAGTTTGAGATCAACCTGAGCAAGAGATCTTGTCTCTCCTAAAGATAGAAAAACTAGCTGGGATTTGTGGTGGACACCTGTAATTTCAGCTACTCAGGAAGCTAAGGCAAGAGCATTGCTTAAAACCAGGAGTTTGAAGTTGATGTGAGCTAGGATGTCAGGGCAGGTTACCCAGGGTGACAGAGTGAGACTCTGTGTCAAAATAAACAAACAAACAAACAAACAAAACAAAATAAAATAAA","GGCTGGACATGGTGACTCACGCTTGTAATCCCAACACTTTGGGAGGCTGAAGCAGGCAGATCACCTGAGGTCAGGAGTTTGAGACCAGCCTGACCAACATGGTGAAACCTTGTCTCTACTAAAAATACAAAAATTAGCTGGGAGCAGTGGTGCACACCTGTAATCCCAGCTACTCGGCAAGCTGAGGCAAGATAATTTTTTAAACCTGGGAGGTGGAGGTTGCAGTGAGCCAAGATCGTGCCACTGTACTCCAACCTGGGAGACAGAGCAAGACTCTGTCTCAAAAAAAAAAAAAAAAAAAAAAAAAAAAAAAAA"
"GL873575","2107336","2107519","chr4","38052972","38053149","54","35945636","TCAATTAAAAACTTTTTAAAATGAGGCTGAGCATGGTGGTTCACACCTGTAATCCCAGCACTTTGGGAGGCCGAGGCAGGAGGATCACCTGATCCCAGGAGTCCAAGCCTACAGTGAGCCGTGATAATACCACTGCACTTCAGCCCAAAGCCTCAAAAAGAAAAAAAAAAAAGGATAGACAAGA","TATATATATATATATTATTTTGGGGGGGCATGGTGGTGCACACCTGTAATCCCAGCTACTCGGGAGGCTGAGGCAGGAGAATTGCTTGAGCCCGGGAGGCAAAGGTTGCATTGAGCTGAGATCACACCACTGCACTCCAGCCTGGCGACAGAGTCTCAAAAAAAAGAAAAAATAAAAA"
"GL873575","5831824","5831959","chr1","29437872","29437991","28","23606048","GGCCGGGCGTGGTGGCGCACGCCTGTAGTCCCAGCGCTATGGGAGGCCAAGGCGGGTGGATCACCTGAGCTCAGAGGTTCGAGACCAGCCAAGACCCCCCTGAGCCAAACGAGCCAGAGTGAGACCCCGTCTCTAC","GGCCGGGCGTGGTGGCTCACGCCTGTAATCCCAACATTTTGGGAGGCCAAGGCGGGTGGATCACCTGAGGTCAGAAGTTCGAGACCAACCTGGCCAACATGGTGAAACCCCTGTCTCTAC"
"GL873575","7451097","7451208","chr3","122814630","122814743","22","115363533","GGCCAGGTGTGGTGGCTCACACCTGTTATCCTAGCACTCTGAGAGGCCACAGCAGCTGGATCACTTGAGCTCAGGAGTTCAAGACCAGTCTGAGCAAGAGCAAGACCTCACC","GGCTGGGTGTGGTGGCTCATGCCTGTAATCCCAGCACTTTGAAAGGCCAAGGCAGATGGATCACTTGAGGTCAGGAGTTCCAGACCAGCCTGGCCAACATGGCAAAACCCCATC"
"GL873575","7451277","7451445","chr6","58863249","58863409","41","51411972","AAAAATTCAGCCAGCCACAGTGGAAGTGGATGCCTGCCATCACAGCTACTCTGGGGGCTGGGGCAAGAGAATTGCTTGATCCCAGGAGTCTGAGGTTGCTGTGACCTAGGCTGACACCACAGCACTCTACCCAGGGTGACAGAGTGAGGCTGTGTTTAAAAAAAAAAAA","TTAGCCAGGCATGGTGGCACATGCCAGTAATCCCAGCTACTCAGGAGGATGAGGCAGGAGAATCGCTTGAACCCAGGAGGCAGAGGTTGCAGTGAGCTGAGATTGCGCCACAGCACTCTACCCTGGGTGACAGAAGGAGACTCTGTCTCAAAAAAAAAAAA"
"GL873576","1765109","1765185","chrX","53921180","53921256","12","52156071","GGCCAGGTGCAGTGGCTCATATCTGTAATCCTAGCACCCTGGGAGGCCAAGGTAGGCGAATCACCTGAGGCCAGGAG","GGCCAGGTGCAGTGGCTCACGCCTGTAATCCCAGCACTTTGGGAGGCCGAGGTGGGCGGATCACTTTAGGTCAGGAG"
"GL873576","2711577","2711895","chr7","6620384","6620702","85","3908807","GGTCGAGCTTGGTGGCTCATGCTTGTAATCCTAGCACTCTGGGAGGCCAAGGCAGGTAAGTTGCCCTGAGCTCATAGGTTCCAGATCAGCATGAGCCAGAGTGAGACCCTGTCTCTACCAAAAAATAGCCCGGCATTCTGGCAGGTGCCTGTAATCCCAGCTGCTTGGGAGGCTGAGGCTAGAGAATCACTTAAACCCAAGGGTTAGTGGAGGTTGCTGTGAGCTATGATTCCACCGTACTCTACTGAGGGCCACAAAGTGAGACTCTGTCTCCATAAAAAAGAAAGAAAGAAAGAAAGAAAAATAAAATAAAATAAAA","GGCCAGGCACAGTGGCTCATGTCTGTAATCCCAGCACTTTGGGAGGCCGAGGCGGGTGGATTACCTGAGGTCAGGAGTTCTAGACCAGCCTGGCCAACAAGGCGAAACCCTGTCTCTACTAAAAATACAAAAAATTAGCTGGGCGTTTTGGCACATGCCTGTAATCCCAGCTACTTGGGAGGCTGAGGCAGGAGAATTGCTTGAACTGGGGAAGTGGAGGTTGCAGTGAGCTGAGATCACACCATTGCACGCCTGAGCAACAGAGCGAGACTCTGTCTCAAAAAAAAAAAAAAAAAAAAAAAAGAAAAGAAAAAGAAAA"
"GL873576","4782520","4782652","chr9","61136941","61137074","22","56354421","CCAGGCACGGTGGCTCACCCTTGTAACCCTAGTACTTTGGGAGGCTGAGGTGGGAGGATCCCTTGAGGTCAGGAGTTCAAGACCAGCCTGAACAACAGTGAGACCCCCGTCTCTACTAAAAAATAGAAAAGTT","GCCAGGCACGGTGGCTCACGCCTGTAATCCCAGCACTTTGGGAGGCTGAAGCGGGCGGATCACCTGAGGTCAGGAGTTCAAGACCAGCCTGGGCACCATGATGAAACCCCGTCTCTATTAAAAATACAAAAATT"
"GL873576","4782930","4783078","chr7","57521645","57521803","40","52738715","AGTTAGTCTGGTGTCATGGTGGGTGCCTGTAGTCCCAGCTGCTTGGGAGGCTGAGGCAAGAGAATCACTTGAGCCCAGGAGTTGGAGGTTGCTATGAGCGAGGCTGTAGCCTAGGCAACAGAATGAGACTTTGCCTCAAAAAAATAAAA","TTAGCTGGGCATGGTGGCGCATGCCTGTAGTCCCAGCTACTTGGGAAGCTGAGGCAGGAGAATCACTTGAACCTGGGAGGTGGAGGTTGCAGTGAGCTGAGATCGCACCGCTACACGCCAGCCTGAGCAACAGAGAGAGACTCTGTCTCAAAAGAAAAA"
"GL873576","7828709","7828723","chr5","101042981","101042996","1","93214272","TAAATAAATAAAAAA","TAAATAAATAAATAAA"
"GL873576","7828960","7829230","chr13","49045537","49045844","89","41216577","GCCGGCTGCAGTGGCTATAATCCAAGTACCCTGGGAGGCTTAGGTGGATGGATCACTTGAGCTCAGAAGTTCAAGACCAGCCTCAGCAAGAGGTAGACCTTGCCTCTATTAAANNNNNNNNNNNNNNNNNNNNNNNNNNNNNNNNNNNNNNNNNNNNNNNNNNNNNNNNNNNNNNNNNNNNNNNNNNNNAGTTTGAGGTTGCTGTGAGCTATGATGAAGCCAGGGCATTCTACCCAGGGTGACAGAGTAACTCTTAAAAAAAACTAAACAA","GGCCAGGCAGAGTGGCTCATGCCTGTAATTCCAGCAATTTGGGAGGCCTAGGCAGGCAGATTACCTGAGGTCAGGAGTTTGAGACCAGCCTGGCCAACATGGTGAAACCCCGTCTCTTCTANNNNNNNNNNNNNNNNNNNNNNNNNNNNNNNNNNNNNNNNNNNNNNNNNNNNNNNNNNNNNNNNNNNNNNNNNNNNNNGGAGATAATAGCTTTTGTAGAACGAAGCGATGCAACAGCCAGATCGCCGCCACCACCCTTAGGTCCTGGCGACAGAGTGAGATCCATCTTAAAAAAAAAAAAAAAAAAA"
"GL873576","10622840","10623093","chr7","60266447","60266705","74","49643607","GCTGGGTATGGTGGTTCACACCTATAATCCTAGCACTCTGGGAGGCTGAGGTGGGAGGATTGGTGGAGCTCAGGAGCTCATGAGGTGCCAAATCACTGGTGCCACACACCTGTATTCCCAGCTACTGAGGAGGCTGAGGCAGGAGGATCAGGTAAGCCCAGGAAGTTTGAGGTTGTAGTGAGTTAGGATGATTGAACTCTGCCTTGAGAGACAGAGCAAGATCCTCCTTCCTCCTAAGCAAACAAACAAATAAA","GGCTGGGTGCAGTGGCTCACACCTGTAATCCTAGCACTTTGGGAGGCTGAGGCGGGAAAATTGCCTGAGCTCAGGAGTTCAAGGACAGCCTAGGCAACATAGCATGGTGGTGCACGCCTGTATTCCCTGCTACTTGGGAGGCTGAGGCACAAGAATTGCTTGAATCCGGGAAGTGGAGGTTGCAGTGAGCCATTGTGGCACTGCTCTCCAGTCTGGGTGACAGAGCAAGACTCCATCTCAAAAAAAAAAAAAAAAAAAA"
"GL873576","10819939","10820007","chrX","67133632","67133707","21","56313693","AGGTTGCAGTGAAATTGTACCATTCCAATGAAGCCTGGGGGACAGAGTGAGATTCTCTCAAAATAAAAA","GGAGGTTGCAGTGAACCGAGATCGTGCCACTGCACTCCAGCCTGAGCGACAGAGTGAAACTTCGTCTCAAAAAAAA"
"GL873576","10920306","10920363","chr3","48261745","48261808","16","37341439","GCTGGACCTTGTAGAGAGTGCCTGTAATCCCAGCTACATGGGGGGCAAGAGAATTGCT","GCTGGGCATGGTGGTGCATGCCTGTGATCCCAGCTACTCAGGAGGCTGAGGCAGGAGAATTGCT"
"GL873576","10920398","10920529","chr10","67341428","67341546","30","56421030","GGCCAGGCGTGGTGGCTCACGCCTGTTGTCCCAGCACTGTGGGAGGCCGAGGTGGGTGGATTGCCTGAGCTCAGAGGAGTCCGGAAGACCAGCATGAGGCAGAGTGAGCCAGAGTAAGATCCTGTCTCTACC","GGCTGGGTGTAGTGGCTCATGCCTGTAATCCCAGCACTTTAGGAGGCCAAGGTGGATGGATTGCCTGAGCTCAGGAGTTCGAGACCACCCTGGGCAACAAGCCAAAACCCTGTCTCTAC"
"GL873577","515809","515961","chr7","137660778","137660931","43","137144969","AGCTGGGCATGGTGGCTCATGCCTATAACCCTAGCGTGCTAGGAGATTGCTTGTCAGGAGACTGAGGTTGCAGGAAACTGTGATGATGGCACTGCACTCTACCCAGGGTGACAGAGCAGGACTCTGCCTCAAAAAAAAAAAAAAAAATAGAAA","TTAGCTGGGCATGGTGGCGCATGCCTATAATCCCAGCTACTTGGGAGGCTGAGGCAAGAGAATCGCTTGAACCGGGGAGGCAGAGGTTGCAGACTGCACTCCAGCCTGTGTGACAGAGTGGGACTCCGTCTCAAAAAAAAAAAAAAAAAAAAAA"
"GL873577","1633164","1633256","chrX","38269524","38269615","26","36636360","TCAGCCAGGCATGGTGGCACTTGCCTATAAACCCAGCTCCTTGGGAAGCTGAGCCGGGAGGATCCCTTGCACCCAGGAGCAACGGAAGGCAGT","AATTAGCCAGGCATGGTGGCACATGCCTATAATCCCAGCTACTCAGAAGGTTGAGGCAGGAGAATCACTTGAACCTGGGAGGCAGAGGTTGC"
"GL873577","3979502","3979560","chr20","68909283","68909346","13","64929781","GAGTTTGAGACCAGCCTGAGCAAGACCGAGACCCAGTCTCTACTAAAAATAGAAAAATT","GGAGTTCAAGACCAGCCTGACCAACATGGAGAAACCCTGTCTCTACTAAAAAATACAAAAATTA"
"GL873577","3979839","3980009","chr10","31403126","31403287","39","27423287","ATGAGCAGATTGTCTTGGTGGGCACCTGTAGTCCCAGCTATTGGAGGTGGGAGGCTGAAGCAGGAAAATCTCTTGAGCCCAGGAGTTTGAGGTTGCTGTGAGCTAGGCTGACACCACGGCACTCTAGTCAGGGCGTCAGAGTGAGACTCCGTCTCAAAAAAAAAAAAAAAA","TTAGCTGAGTGTGGTGGCGCACATCTGTACTCCCAGCTATTTGGGAGGCTGAGGCAGGAAAATCGCTTGAACCCAGGAGGTGGAGGTTGCAGTGAGCCAAGATCACACTACTGCACTCCAGCCTGGGTGACAGAGTGAGAATCCATCTCAAAAAAAAGAAAA"
"GL873577","6050882","6051080","chr1","153219820","153220007","59","147168938","GGCTGGGCGTTGTGACTCATGCCTGTAATCCCAGCACTCTAGGAGGCCGAGGTGGGTGGACTGCCTGAACTCAGAGGTTTAAGACCATCCTGAGCCGCAGTGAGCCAGAGCGAGACCCTGTCTCTACCAAAAAAAGCTGGGTGTTGTGGTGGGCGCCTATAGTCCTAGCTACTTGAGGCGCTAAGGGTAAAAAAATTGC","GGCCTGGCACAATGGCTCACGCCTGTAATCCTAGCACTTTGGGAGGCCGGGGTGGGTGGATCACCTGAGATCAGGAGTTTGAGACCAGCCTGGCCAACATGGTGAAACTCCTTCTCTACAAAAATTAGCCAGGTGTGGTGGTGGGTACCTGCAATCCCAGCTATTTGGGAGGCTGAGGCAGGAGAATC"
"GL873577","8463965","8464050","chr9","52134422","52134508","19","43670457","CTGGGTGCTATAGCTCACGCCTATAATCCTAGCACTCTGGGAGTTTGGGGCAAATGGATCACCTAGGCTCAGGAGTTTGATACCAG","GGCTGGGAGCAGTGACTCACGCCTATAATCCCAGCACTTTGGGAGGCTGAGGCAGATGGATCACCTGAAGTCAGGAGTTCGAGACCA"
"GL873577","9471486","9471613","chr16","5178790","5178910","46","4292696","TTAGCCAGGCATAGTAGCCTGTGTGTAGTCCTAGCTACTCAGGAGGCTGAGGTAGATGGGTCACTTGAGGTTGCAGAGATTATGGTAATGTCACTGTACTCTAGCCCTGGCAACAGAGCACAACCCTG","TTAGCCGAGCCTGGTGGCATAAACCTGTAATCCCAGCTACTCAGGAGGCTGAGGCAGGGGAATTGCTTGAACCTGAGAGGAGAAGGTTGCAGTGAGCCGAGATTGCACCATTGCACCCCAG"
"GL873577","9471875","9471998","chr7","17832200","17832315","36","8360325","GGCCAGGTGAAGCAGCTCATGGCTATAATCCTAGCAGTTTGGCAGGCCAAGGTGGGAGGACTGCTTGAGGTCAAGAGTTCAAGACCAACCCATCTTTGCGAAAAATTTAAAAATTACCTAGGCA","GCCAGGAGAGGTGGCTCATGCCTCTAATCCCAGCACTCTGGAAATCCAAGGTGGGTGGATCACCTGAGGTCAGGAATTCCAGACCAGTCTGGCCAATATAAAAAATTAGCCAGGCT"
"GL873577","9853150","9853170","chr3","85044647","85044667","3","75191497","AAACAAACAAACAAAAAAAGA","CAAACAAACAAACAAACAAAA"
"GL873577","9853206","9853473","chr7","130818682","130818963","67","120965476","GCTGGGCGCAGCGTCTCACTCCTGTAATCCCAGCACTTGGGAGGCCAAGGTGAGTGGATTGCCTGAGTTTACAGTTTCGAGACCAGCCTGAGCCAAAGCGAGACCCCCATCTCTAAAAAATAGCTGGGCATTGTGGTGGGCACCTGTAGTCCCAGCTACTTGGGAGGCTGAGGCAAGAGGATCGCTTGAACCTAAGAGTTTGAGGTTGCTGTGAGCTAAGGCTCCATGGCATTCTACCAAGGGTGACTAAGTGAGACTCTGTCTAAAA","GCCGGGCACAGTGGCTCACACCTGTAATCCCAGTACTTTGGGAGGCCAAGGTGGGTGGATCACCTGAGGTCAGGAGTTTGAGACCAGCCTGGCCAACATAGTGAAACTCTACTAAAAATACAAAAAAATAGCTAGGCATGGTGGTGCGCACCTGTAATCCCAGCTACTTGGGAGGCTGAGGCAGGAGAGTTGCTTGAACCCAGCGGGGTTGAGGTTGCAGTGAGTTAAGATCAAGCCACTGTGCTCCAGCCTGGATGACAGAGAGAGACTCCATCTCAAAAA"
"GL873577","10722415","10722478","chr10","12501471","12501539","23","1779056","AATAAAAAAATGCTGGGTACAGTAGTACATGCCTGTACTCTCATCTGGGGAAGCTGAGGCATGA","AAAGTAAAAAATTAGAGCTGGGCATGGTGGCACACACCTGTAATCCCAGTCACTAGGGATGCTGAGGCA"
"GL873578","463331","463568","chr10","28935382","28935620","93","28472051","CAGGTGCTTTGACCCACACCCTCAACTCTAGGACTTTGGACGCCCTGGCTGGGTGGGTCCTTTAAAGTCAGGAGCTTCTTATCAGTCTGGGCAAAAGTGAGACCCCATCTCTACCAAACAAAGAAAGAAATCAGCAGTATGTTGCAGTAGAGACTCACCAATACCTTCTTTCAAAGACCAAAGCTGGAAGGACACTAAAGACCATGATCTCATGGCCTCCCTGAGCCATGACAATGCC","CCAGGTGCAGTGGCTCATGCCTGCAAGCTCAGAACTTTGGGAGGCAGAGGTGAGCAGACTGCCTGAGTTCAGGAGTTCAAGACCAGCTGGGCAACATGGTGAGACCCTATCTCTACTAAAAATACAAATAATTAGCAGGGTGTGGTAGCACACACCTGTAGTCCAGCTACTCAGGAGGCTGAGGCAGGAGAATTGCTTGAACCCAGGAGGCAGAGTTTGCAGTGAGCCAGGACTGGGCC"
"GL873578","1143712","1143827","chr11","52824583","52824692","30","51680871","GGCTGGGTGTGGTGCCTCATGCCTGTAATCTAAGCCCTCTCCGAGGCTGAGGTGGGAGGATCCCTTGAGTTTAGGAGTTTGATTTTGAGACCAGCCTGATCAAGAGAGAGACCTCA","GGCCGGGTGTGGTGGCTCATGTCTGTAATCCCAGCACTTTGGGAGGCTGAGGTGGGTGGATACCCTGAGGTCGGGAGCTCGAGACCAGCCTGACCAACATGGAGAAACCC"
"GL873578","1144101","1144139","chr3","33494224","33494257","11","32350123","GAGAGAGACCTCATGTCTACTAAAATAAATAAATATATA","GTGAAACCCGTCTCTACTAAAAATACAAAAATTA"
"GL873578","1144175","1144343","chr12","119519961","119520131","41","118375786","ATTATCCAGGCCTTCTGGTGGATGCCTGTAGTCCTAGCTACTAGAAAAGCTGGAGCAGAATCACTTGACCCAGGAGCTGGAGGTTGCAGGGAGCTAGGCTGATGCCACAGAATTCTAGCCTGAGGCAAAAGAATTGAGCCACTGTCTCAAAAAGGAACAAAAAAGAAAA","ATTAGCCAGGTGTGGTGGCATGCACTTGTAATCCCAGCTACTAAGAAGGCTGAGGCAGGAGGATCACTTGAACCCGGGAGGTGGAGGTTGCAGTGAGCCAAGATCATGCCACTGCACTCCAGCCTGGGCAACAGAGTAAGACTCTGTCTCAAAAAAAAAAAAAAAAAAAAA"
"GL873578","4593962","4594035","chr16","68825055","68825124","22","64231093","AGCTGGGTACAGTGGCTCACATATAATCCCAGTGACTCAGGAGGCTAAGACAGGAGGATTACTAGGACCTGAGA","GGCTGGGCACAGTGGCTCAGACCTGTAATCTCAGTACTTTGGGTGGCTGAGGCAGGTGGATCACCTGAGG"
"GL873578","6158845","6158972","chr3","500432","500562","24","5658413","GACATGGTGGCTCACACCTGTAATCCTAGCCCTCTGGGAGGCTGAGGCAGGTGGATCACTTGAGTTCAGGAATTCAAGACCAGCTTGAGTGAGAGCAAGACCCTGTCTCTACTAAAAATAGAAAAATT","GCACGGAGGCTCATACCTGTAATCCCAGCACTTTGGGAGGCTGAGGCAGGTGGATCACCTGAGGTCAGGAGTTCCAGACCAGCCTGGCCAACATGGCGAAACCCTGTCTCTACTAAAAATACAAAAAATCT"
"GL873578","6159253","6159444","chr19","34496349","34496541","55","28337096","ATAAAATAAAAATAGAAAAATTAGCCAGGCATTGTGGCAGACATGCGAAGTCTCAGCTACTCCAGAGGCTGAGACAGGAAGATTACTTGAGCCCAAGAATCTTGCTGTGAGCTAAGCTGATGCCATAGCATTGTAACCTAGGCAACAGAGTAAGACTTGGCCTCAAAAATAAAATAAAATAATAAAGTAAAA","TTAGTTAATTAAATTAAACTTAGCTAGGCATAGTGGAACACACCCATAGTCCCAGCTACTCTAGAGGCTGAGGCAGGAGGATTGCTTGAGCCAAGTTGGAGGCTGCAGTGAGCTATGGTGGTGCCACTGCATTCCAGCCTCAGTGACAGAGAGAGACCCTGGCTCAAATAATAATAATAAATAAATAAATAAA"
"GL873578","6766040","6766171","chr2","93098086","93098217","30","86332046","CCAGGCACAGTGGCTCATGCCTATAATCCTAGTAGTCTAGGAGGCTGAGGTGAGTGCATTGCTTGAGCTCAGGAGTTAGATACCAGCCTAACCAAGAATGAGACCCCATCTCTATTAAAAATAGAAAAGTTA","GCCGGGCACAGTGGCTCATGCCTGTAATCCCAGCACTTTGGGAGGCCGAGGCGGGCAAATCACGAGGTCAGGAGTTCAAGACCAGCCTGACCAATATGATGAAACCCCGTCTCTATTAAAAATACAAAAATT"
"GL873578","6766434","6766577","chr9","21128084","21128223","50","14361650","GTTAGCCAGGAGTTGTGGCGGGCACCTACAGTCCTAGCGACTCAGGAGGCTGAAGTAGGCAGAGTTTGATGTGTTGCTGTGAACTACAAGGACACCAATGCACTCTAGGCCGGTAACAGAGTGAGACACTGACTAAAAAAAAAA","TTAGCCAGGTGTGGTGGCACATGCCTGTATTTCCAGCTACTCGGGAGGCTGAGGCAGGAGAATTGCGTGAGCTGAGATCATGCCACTTCATTCCAGTCTGGGTGACAGAGTGAGACTCTGCCTCAAAAAACAAAACAAAA"
"GL873578","7397948","7398119","chr5","40230148","40230319","43","32832200","TAAAAATAGCCATGCATTGTGACAGGCACCTGTAGTCCCAGCTACTCAGGAGGTTGAGGTAAGAGAATCACTTGAACCCAAGAGTTTTGAGGTTGTTATGAGCTAAGACGCCTCGGGACTCTACAAAAGGTAACAAAGTGAGACTCTGTCTCATAAAAAAAGAAAAAAAGAA","AAAATTAGCCAGGCATGGTGACGTACACCTGTAGTCCCAGCTACTCGGGAGGCTAAGGCAAGAGAATCGCTTGAACCCAGGAGGCAGAGGTTGCAGTGAGCTTAGATCACGCTACTGCGCTCCAGCCTGGGTGACGGAGTGAGACGCCATCTCAAAAAAAAAAAAAAAAAAA"
"GL873578","7398378","7398515","chr15","102382935","102383070","35","94984557","GGTCGAGCAAGGTGGCTCACGCCTGTAATCCTAGCACTCTGTGAGGCTGAGGCAGATGGATTGCCTGAGCTCGTGGGTTCGAGACCAGCCTGAGCCAGAGTGAGACCTCATCTCTAAAAATAGCTGGGAAGCTGGGCA","GGCCAGGTGTGGTGGCTCACGCCTGTAATCCTAGCACTTTGGGAGGCTGAGGCGGGTGGATTGCCTGAACTCAGGAGGTCAAGACCAGCCTGGGCAACACAGTAAAACCCCATCTCTACTAAAATACAAAAAATCA"
"GL873579","370235","370429","chr16","38067345","38067552","57","37697110","GCACAGGCCTGAAATCCTAGCACTCTGAAAGGCCAACGGAGGAGAATTTCTGGAGCTCAGGAGTTTGATACCAGCCTAAGCAAATAAAGCTAGACCTCTATCTCTACTAAAATTAGAAAAATTAGGCAGATGTGGTGGTAGGCACCTATAGTCCCAATTACTCCAGAGGCTGAGGCAGAAAGACTCTTGAACCCA","GTCAGGCATGGTGGCTCATGCCTATAATCCTAGCACTTTGGGAGGCCAAGGCCGGTGGATCACCTGAGGTCAGGAGTTTGAGACCAGCCTGGCCAATATGGCAAAACCCCGTCTCTACTAAAAATAAAAAAATTAGCTGGGCACGGTGGTGGGCACCTATAGTCCCAGCTACTCAGGAGGCTGAGGCAGGAGAATTGCTTGAACCCAG"
"GL873579","370936","371046","chr3","3847698","3847802","33","3476762","TGACTCTTGAACCCAGGCACATGAGGTTGCTAAGAGTCTAGGCTGATGTCACGGCACTCTAACCTGGGAAACAGTGTGAGGTTCTGCCTCAATAAATAAATAAATAAATAA","TGGCTTGAACCCAGGAGGCGGAGGTTGCAGTGAGCCGAGATCACGCCACTGCACTCCAGCCTGGGCAACAGAGCGAGACTGTCTCAAAAAAAAAAAAAAAAAAAA"
"GL873579","599436","599605","chr10","38982686","38982853","41","38383250","AAAAAGTCAGACATTGTGGCAGGTGTCTGTAATCCCAGCTATTTGGGAGGCTGAGGCAGGAGTATCATTTGAACCCACGAGTCTGAGGTAACTGTGAGCTAGGCTAACACAACAGCACTCTAGCCTGGGCAATAGAATGAGACTCTATCAAGAAAAGAAATGAAAAGAAA","TATTAGCCTGACACAGTGGCGCGCATCTGTAATCCCAGCTACTTGGGAGGCTGAGGCAGGAGAATCACTTGAACCCAGGAGGCGGAGGTTGCTGTGGGCTGAGATCATGCCACTGCACTCCAGCCTGGGCAACAGAGGGAGGCTCCATCTCAAAAAAAAAAAAAAAAA"
"GL873579","599942","599953","chr3","71473700","71473710","4","70873758","TTTTAAAATAGT","TTTAAAAAAAA"
"GL873579","600232","600365","chr1","16061315","16061447","30","15461083","GGCTAGGCAAGGTGACTCATGTCTGTAATCCTAGTACTCTGGGAGGTTTGAGGCAGGAAGACCACTTTAGCTCAAGAGTTCCAGATCAGCCTGTGCAAGAGTGATACATCATCTCTACTAAAAATCAAAAATTA","GGCTGGGCATGGTGGCTCATGCCTGTAATCCTAGCACTTTGGGAGGTTGAGGCAGGCAGATCACTTGAGGTCAGGAATCTGAGACTAGCCTGGCCAACATGGTGAAACTCCATCTCTACTAAAAAAAAAAAAA"
"GL873579","5650320","5650591","chr6","54938866","54939145","71","49288546","GTCAGGTGTGTTAGCTTACAGTAGTAATCCTAGCACTTTGGGAGGTTGAAGTGGGTGGATTGCTTGAGCTCAGGGGTTCAAGACCAGCCTGAACAAGAGTGGGACCTCATCTCTATTAAAAACAGAAAAACTAGCTGGGTGTTATGGTGGGTGTCTGTAGCCCCAGCTACTCAGGAGGCTGAGGCAGGAGGTTGAGGTTGCTGTGAGCTATTGAGACCACAGCACTCTATCCAGGGCAACAGAGTGAGACCCCTCCCCCCCCCAAAAAAAAA","GGCCAGGTGTGGTGGCTCACGCCTGTAATCCCAACACTTTGGGAGGCCGAGGTGGGTGGATCACCTGAGATCAGGAGTTCAAGACCACCCTGGCCAACATGGTGAAACCCCGTCTCTACTAAAAATACGAAAATTAGCTGAGTGTGGTGGTGCATGCCTGTAGTCCCAGCTACTCAAGAGGCTGAGGCAGGAGGTGGAGGTTGCAGTGAGCCGAGATTGCATCACTGCACTCCAGCCTTGGCGACAGAACGAGAGAGACTCCATCTAAAAAAAAAAAAAA"
"GL873579","7037162","7037347","chr3","37328686","37328893","67","30291524","GAGGTGGGTGGATTGCCTGAGCTCACAGGTTGGAGACCAGCCTGAGCCAGAGCAAGACCTTATCTCAAAAAATAGCCAGGTGTTGTGGCTGGCACCTGTAGTCCCAGCTGCTCAGGAGGCGGAGGCAAGAGAAATGCTTGACCTCAGGAGTTTGAGGTTGCTGTGAGTTCAACTCACACTAATACA","GAGGCAGGGGGATCACCTGAGGTCAGGAGATCGAGACCAGCCTGGCCAACATGGTGAAAACCTGTCTCTACTAAAAATCCAAAAACATTAGCCAGGTGTGGTGGCACGCACCTGTAATCCCAGCTACTTGGGAGGCTGAGGCAGGAGAATCACTTGAACCTGGGAGGCAGAGGTTGTAGCGAGCCGAGATCACACCACTGCACCCCAG"
"GL873579","11077764","11077972","chr19","1200469","1200683","63","9877295","GCCAGGTGCAGTGGCTCATGCCTATAATCCTAGCACCCTAGGAGGCTGAGGAGTTCAAGACCAGCCTAAGCAACTGTGAGACCCCATCTCTACCAAAAATAGAAAAATTAGCTGACTGTTATGGTGTGCACCTACAGTCCTAGCTACTCAGGAGGCTGAGGCAGAAAGAGTCCTTGAACCCAGGAGGCTTTTTTTTGTTGTTGTTGTTG","GGCCAGTCGCGGTAGCTCATGCCTGTAATCCCAGCACTTTGGGAGGCCGAGGCGGGCAGATCACCTGAGACCAGCCTGGCAACATGGTGAAACCCCATGTCTACCCAAACTACAAAAATTAGCTGGGTGTGGTGGTGCACGCCTGTAATCCGAGCTACTCAGCAGGCTGAGGCAGGAGAATCCCTTGAACCTGGGAGGCAGAGGCTGCAGTGAGC"
"GL873579","11078245","11078333","chr19","4926258","4926351","22","6151987","TGAACCCAGGAGTTTGAGTTCGCTGTGAGCTAAGCTGAGGCCACAGCACTCCAGCCTGGGCAACAGAGTGAAAGGAAAAAAATAAAAAA","TGAACCCGGGAGGTGGAGGTTGCAGTGAGCCAAGATCACACCAATGCACTCCAGCCTGGGCAACAAGAGTGAAACTCTGTCTAAAAAAAAAAAA"
"GL873580","320374","320488","chr13","48549305","48549409","42","48228931","GGTAGTGCGTGCCTGCATTCCCAGCTACGGGAGGGCAGGGACTTGAGGCCAGCCTGGGCAAAATAATGAGACCTACTAATGACTCTACTAATACAGAAACAATTAGCTAGGTATG","TGGGAGGCCGAAGTGCGCAGATCACCTGAGGTCAGAAGTTGGAGACCAGCCTGGCCAACATGGTGAAAACCCATCTCTACTAAAAATACAAAAATTAGCTGGGCA"
"GL873580","374969","375091","chr6","147681010","147681135","27","147306041","CGGTGGCTCACACCTATAATCCTAGCATTTTGGAAGGCTGAAGCCGAGGATCTCTGGAAGTCAGAAGTTCAAGACCAGCCTGCCCAAGAGCAAGACCCCATCTCTACTAAAAATAGAAAAACT","GGTGGCTCACACCTGTAATCCCAGCATTTTGGGAGGCTGAGGCAGGCGGATAATCTGAGGTCAAGAATTTGAGACCAGCCTGGCCAACATGGAGAAACCCTATCTCTACTAAAAATACAAAATTAC"
"GL873580","375369","375549","chr7","19977275","19977456","44","19601906","CTAACCAAGTTAGTTAGTTTTAGTTGGCAGGTGCCTGTAGTCCCAGCTCCTTGGGAGGCTGAGGCAAGAGAATGGCTTGAGCCCAGGACTTTGAAGTTGCTGTGAGCTATAATGACACCACAGCACACTACCCAGGGTGACAGAGTGAGACTGTCTCAAAAAAACAAACAAACAAAAAAAA","AACAAACGTTAGCCGAGCATGGTGGTATGTGCCTGTAGTCCCAGCTACTTGGGAGTCTAAGGCAGGAGAATTACTTGAGCCCGGGAGGCAGAGGTTGCTGTGAGCCAAGATCACGCCACTGCACTCCAGCCTGGGTGACAGAGTGAGACTCCATCTCAAAAAAAAAAAAGGAAAAAAAAAAA"
"GL873580","8760922","8761015","chr11","104681322","104681416","19","95920400","GGAGGGAGACACTGCAGTGAACTGCGATCGTGTCTCTGCTTTCCAGGCTGGGTGACAGAGTGAGACTCGGTCTCTAAAATAAAAAATAAATAAA","GGAGACGGAGGTTGCAGTGAGCTGTGATCGCGGCACTGCACTCCAGCCTGGGCAACAGAGTGAGACTCTGTCTCAAAAATAAATAAATAAATAAA"
"GL873580","9391260","9391306","chr14","49279240","49279285","12","39887980","GCCAGTCGAGGTGGCTCACACTTGTGATTCCAGCTACTTGGAAGACT","GGCTGAGATGGTGGCACACACCTGTAATCCCAGCTACTTGGGAGGC"
"GL873581","759283","759365","chr6","46535476","46535542","30","45776193","TAAGAACCTGAAAATAGAGCCAGGCATAGTGGTACATGCGTATAGTCCTGGCTACTCAGGAGGTTGAAACAACAGGATTACTT","CAAAATAGCCAGGCTTGGTGGTGCATGCCTATAATCCAAGCTACTCGGGAAGCTGAGGCAGGAGAAT"
"GL873581","1145844","1145979","chr1","29437872","29437991","29","28292028","GGCCGGGCGTGGTGGCTCACGCCTGTAGTCCCAGCACTATGGGAGGCCGAGGCGGGTGGATCACCTGTGCTCAGAGGTTCGAGACCAGCCAAGACCCCCCTGAGCCAAATGAGCCAGAGTGAGACCCCGTCTCTAC","GGCCGGGCGTGGTGGCTCACGCCTGTAATCCCAACATTTTGGGAGGCCAAGGCGGGTGGATCACCTGAGGTCAGAAGTTCGAGACCAACCTGGCCAACATGGTGAAACCCCTGTCTCTAC"
"GL873581","9628238","9628362","chr5","141044567","141044691","34","131416329","ATCCCAGGTAGTCGGGAGGCTGAGGCAGGAGGATCACTTGAACCCAGGAGGTTGAGGTTGCTGTGAGCAAGGCAGAGGCAACGGCACTCTAGCCACGGGGGCACAGAGACTCTTGTCTTTAAAAA","TAATCTCAGCTACTCGGGAGGCTGAGGCAGGAGAATCGCTTGAGCCCAGAAGGTGGAGGTTGCAGTGAGCCAAGATCGCGCCATTGCACTCCAGCCTGGGCGACAGTGCGAGACTCTGTCTCAAA"
"GL873582","1580485","1580534","chr6","32576760","32576806","12","30996275","CAGCACTTGAGAGGCCAAGGCAGGTGGATCAACTGAGCAAGAATGAGACC","CCAGCACCTTGAGAGGCCAAGGCAGGTGGATCACCTGAGGTCAGGAG"
"GL873582","1644368","1644551","chr1","211626449","211626612","63","209982081","AAAATTTGCCGGGCTCCATAGCTCATGCATGTAATCATAGCACTCTGGGAGGCCAAGATGGGAGGATCTCTCAAGCTCTCTTACTTGGGAGGCTGAGGTTGCTGTGAGTTAGGCTTACGCCACAGCACTCTACTCTAGCGTGAGCAACTCTACTCTTAGTATGAGACTGTCTCAAAAGAAAAAA","AAATTAGCCAGGCGTCGTGGCACATGCCTGTAATCCCAGCTACTCGGGAGGCTGAGGCAGGAGAATAGCTTGATCTCGGGAGGCGGAGGTTGCAGTCAGCCGAGATCACACCACTGCAATCCAGCCTGGACAACAGAATGAGACTCCATCTCAAAAAAAACAAA"
"GL873582","5794385","5794459","chr13","18872784","18872852","27","13078399","ATATTGTTAAGCACAGCCACTATTAAAAATTAAATTATAGGCCAGGCATAGTGGCTCATGCCTGTAATCCTAGCT","TGAAACCACCATCTGGACCAAGATACAAAATGTTGGCTGGGCATGGTGGCTCACACCTGTAATCCTAGC"
"GL873583","102645","102683","chr14","5808766","5808804","14","5706121","GAGCAGATCACCTGAGCTCAGGAGTTTGAGACCAGCCTG","GAGGAATCCCTGTGCTCAGGAAGCTTACATTCTAGTGAG"
"GL873583","6200447","6200560","chr4","17786849","17786963","24","11586402","GGCCAGGAGGGACGGCTCATGCCTGTTATCCTAGCACTATGGGAGACTGAGGTGGGAGGATCACTTGAAGTTAGGAGTTCCAGACCAATCTGACCAAAGTGAGACCTCATCTCT","GGCCAGGCTTGGTGGCTCATGCCTGTAATCTTAGCACTTTGGGAGGCTGAAGTGGGTGGATCACTTGAGGTCAGGAGTTAGAACCAGTCTGGCCAACATGGTGAAACCTCAGCTC"
"GL873583","6200584","6200752","chr6","169626528","169626696","42","163425944","TTAGCTGGATGTGGTAGCACATGCCTATAGTCCCATCTACTCAGGAGGCTGAGACAAGAGAGTTGCTTAAGCCCAGGAGTTTAATTTAACTGTGAACTAGACTGAGACTGTGGCACTCTAGCTGGGGCAACAGAGTGAGACTCTGTCTCAAAAGAAAGCAAGAAAGAAA","TTAGCTGGGTATGGTGTCAGATGCCTGTAGTCCCAGCTACTCAGGAGGCTGAGACAGGAGAATCGTTTGAACCCAGGAGGCCAGAACTGCAGTGAGCTGAGATTCGCACCACTGCGCTCCAGCCTGGGCCAGACAGAGTGAGACTCTATCTCAAAAGAAAAAAAAAAAA"
"GL873583","10217398","10217583","chr3","36257142","36257313","44","26039744","TACTAAAAATAAAGTGTGATAGCCAGGCATGGTGGTGGTGCCTATAGAACCAGGCTATTCAGGAGGCTGAGGCAGAAGGATCACTTGAACCCAGGAGTCTGACGTTGCTGTGAGCTAGGCTGGTGCCATGGTACTCTAGCCTGTGGTAACAGAATGAGACTCTATCTCAAAAATAAAAATAAAAAA","TACAAAATTAGCCAGGCGTGGTGGTGCGTGCCTGTAATCCCAGCTACTTGGGAGGCCGAGGCAGAAGAATGACTTGAACCCAGGAGACAGAGGTTGCAGTGAGCCAAGATCCCACCATTGTACTCCAGCCTGGGCAACACAGTGAGACTCCATCTCAAAAAAAAAAAAAAAA"
"GL873583","10394919","10394983","chr16","12841703","12841771","22","2446784","GAGGTCAGGAAATCAAGATCAGTCTGGGCAATATATTGATACCCTGCCCCTACATAAGGAAGAAA","AGGTCAGGAGTTCAAGACCAGCCTGGCCAATATGTTGAAACCTCATCTCTACTAAAAATACAAAAATTA"
"GL873584","521512","521529","chr1","167402212","167402233","10","166880700","GCATGGAACCCCCCACTC","GGTGAAACCCCATCTTTACTAA"
"GL873584","2079725","2079768","chr15","4338291","4338335","11","2258566","GGCAGGTGGATTACCTGAGTTCAGGAGTTGGAGACCAGCCTGAC","AGGCGGATGGATCACGAGGTCGGGAGTTTGAGACCAGCCTGACCA"
"GL873584","5216877","5217053","chrX","91350057","91350230","49","86133180","CTACTGAAAATGATGACAGAGGCTGGGCATGGGGGCTCCCGCCTGTTATCCTAGCACCCTCGGAGGCTGGGGAATGAGGATTGCTTACGCCCAAGAGTTTGAGGTTGCTGTGAGCTGAGGCCGCTGCACTCTAGCCTGGGCAACAGAGTGAGACTCTGTCTCAAAAAAAAAAAAAAA","TGCAAAAATGAGCTGGGCATGGTGGCACATGCCTGTAATCCCAGCTACACAGGAGGCTGAGGCAGGAGAATCGCTTGAATCTGGGAGGCGGAGGTTGCAGTGAGCTGACATCAGGCCCCTGCACTCTAGCCTGGGCCACAGAGCAAGACTCCGTCTCAAAAAAAAAAAAAAAAA"
"GL873584","7289930","7289950","chr2","51453328","51453345","10","44163398","TGAGGCTCTGTCTCGAAATAA","AATGCCATCTATTAAAAA"
"GL873584","7289975","7290131","chr11","49739997","49740154","37","42450022","CAAGAAAATTAGCTGAGAGTCCTGGTAGGTGCCTGTAATCCCAGCTATTCATGAGGCTGAGGCAGAAGGATCACTTGGGTCCAGGAGTCTGAGGTTGCTGTGAGCTAGTCTGACGCCATAACACGCAAGCCTGGGCAACAGAGTGAGGCTCGGTTTC","CTACAAAAATTAGCTGGGCGTGGTGGCACATGCCTGTAATCCCAGCTACTCGGGAGGCTGAGGCAGGAGAATCACTTGAGCCCAGGAGGCGGAGGTTGCAGTGAGCCAAGATCATGCCATTGCACTCCAACCTGGGCAACAGAGCAAGACTCCATCTC"
"GL873584","7577743","7577867","chr5","48394329","48394446","27","40816586","GGCTGGATGAGGTGGTTCATGCCTGTAATCCTAGCACTCTGGGAGGCCAAGGTGGGTGGATTGCCTGAGCTCAGGAGTTCAAGACCAGCCTGAGCAAGACCCTGTCGCTAAAAATAGCTGGGTGT","GGCTGGGTGCAGTGGCTCATGCCTGTAATCCCAGCACTTTGGGAGGTCAAGGCGGGTGGATCACCTGAGGTCAGGAGTTCAAGACCAGCCTGGCCAACATCTCTACTAAAAATACAAA"
"GL873584","7578135","7578289","chr1","130112713","130112865","31","122534578","GGAGCTGGGTTTTGTGACTGCACCTGTAATCCCAGCTGCTCAGGAGGCTGAGGCAAGAGAATTGCTTGAGCCCAGGAGTTGGAGGTTGCTGTGAGCTGTGATGCCAGGGAACTCTACCAAGGGTGACAAAGTGAAACTCTGTCTCAAAAAAAAAA","TTAGCCAGGTGTGGTGATGCATGCCTGTAATCCCAGCTACTCATGAGGCTGAGGCAGGAGAATTGCTTGAACCTTGGAGCTGGAGGTTGCAGTGAGCTGAGATCAGACCACTCCAACCTGGGTGACAGAGCGAGACTCTGTCTCAAAAAAAAA"
"GL873585","1450952","1451121","chr10","59681079","59681242","48","58230127","TAAAAACAGAAAAAACTAGTCAGGTGGTGTGGTAGGTGCTCATAAGTCCCAGCTGCTTGGGAGACTGAGGCAAGAGAATCACTTGAGCACAAGAGCTTGAGGTGGCTGTGAGCTATAACACCATAGCACTGTACTGAGGGTGACAAAGTAAGACTCTGTCTCAAAAAAAA","TACAAAAATTAGTCAAGGGTGGTGGTATGTGCTTGTAATCCCAGCTATTTGGGAGGCTGAAGCAGGGGAATCCTTGAACCCAGGAGGTGGAGGTTGCAGCGAGCCGAGATCACGTCACTGCACTCTAGCCTGGGCGATAGGGTGAGACTCTGTCTCAAAAAAAA"
"GL873585","1451382","1451515","chr6","17405813","17405948","24","15954431","GGCCCGGCTCGGTGGCTCACACCTATAATCCTAACACTCTGGGAGGCTGAGGCAGGTGGATCACCTGAGCTCAGGAGTTTGAGACCAGCTGAGCAAAAACAAGACCCTATCTCTGCTAAAAATAGAAAAAACTA","GGCCGGGCGGGGTGGCTCACGCCTGTAATCCCAGCACTCTGGGAGGCCAAGGCAGGTGGATCACCTGAGGTCAGGAGTTTGAGACCAGCCTGGCCAACACGCAGAAACCCTATTTCTACTAAAAACACAAAAATTA"
"GL873585","1626960","1627026","chr7","17782729","17782794","22","16155769","AAGATGCCACAGCACTCTACAAGAGTGACCAAGTGAGACTCTGTCTCAAAAAAAAAAAGAAAAGGAA","CAATCGCACTACTGCACTTCAGCCTGGGTGACAGAGTGAGAACCTGTCTCAAAAAAATAAATAAAA"
"GL873585","1627304","1627531","chr11","17033552","17033788","61","15406248","GGCTGGGCACAGTGGCTCACGGCTATAATCTAGGCACTTGGGAGGCTAGGGCAGGTGGATTGCCTGAACTGACAAGTTTGAGACCAACCTGAGCAAGAGCGAGACCCCTGTCTCTAAAACATAGCCAGGCTCTGTGGTGGGCGTCTGTAGTCCCAGCTACTTGGGAGGCTGAGGCAAGAGAATTGCTTGAACTCAAGAGTCTGAGGTTGCTGTGAGTTAAGATGCCAC","GCCCGGCGCAGTGGCTCACGCCTGTAATCCCGGCACTGTGGAGGCCAAGGCAGGCGGATTGCCTAAGCTCAGGGATTCGAGAACAGCCTGGGCAACATGGTGAAACCCCATCTCTACTAAAATACAAAAAACTAGCCGGGCGTGGTGGTATGCGCCTGTAATCCCAGCTACTTGGGAAGCTGAGGCAGGAGAATTGCTTGAACCCGGGAGATGGAGGTTGCAGTGAGCTCAGATCAC"
"GL873585","3626082","3626158","chr1","100916857","100916922","27","97290775","TGCCTGTAATCCCAGCACTTGGGAGGCGGAGGTGGGTAGATTGCCTGACCCAGAGTGGGACCTCATCTCTAAAAGAA","CATGCCTGTAATCCCAGCACCTTGGGAGGCCAAGGTGGGTGGATCACCTGAGGTCAGTAGTTTGAG"
"GL873585","8849829","8849913","chr18","48581945","48582025","18","39732116","GGCTGGACGAGGGGACTCATGCCTGCAATCCCAGCACTGAGAGAGGCCAAGGCAGGTGGATCCCCTGAGCTCAGAAGTTTGAGAC","GCTGGACGCAGTGGCTCACACCTGTAATCCCAGCACTTTGGGAGGCCAAAGCAGGCAGATCTGAGGTCAGGAGTTTGAGAC"
"GL873585","9319890","9319971","chr8","79499361","79499447","14","70179471","GGCCAGGTGTGGTGGCTCACACCTGTCATCCTAGCACTCTGGGAGGACGAGGTGGGTGGACCGCCTGAGTCAGAGTGAGACC","GGCCAGGTGTGGTGGCTCACACCTGTAATCCCAACACTTTGGGAGGCCCAGGTGGGTGGATCACCTGAGGTCAGGAGTTCAAGACCA"
"GL873586","895572","895692","chr17","14501559","14501680","38","13605987","GGCCAGGTGAGGTTTCTCATTCTGGGAGTGAGCCAGCAATTGGGAGGCCAAAGTAAATGGATTGCCTGAGGTTATAGGTTCCAGAACAGCCAGAACAAGATCGAAATCCTGTCTCCAAAAA","GGCCAGGCGTGGTGGCTCATGCGTGTAATCTCAGCACTTTGGAAGGCCGAGGCAGGTGGATCACCCGAGGTCAAGAGTTCAAGACCAGCCTGACCAACATGGCGAGTCTCTGTCTCCACTAA"
"GL873586","5645995","5646150","chr6","58863249","58863409","38","53217254","GGGTATGGTGGCTCATGCCTGTAATCCAAGCACTCTGGGATGGTGAGGCAGGAGAATCCCTTGAACCCAAGAGTCCGAGGTTGCTGCGAGCTAAGCTGATGGCATAACACTCTAGCCTAGGCGACAGAGTGAGACTCTGTTTCCAAAGAGAAAAAA","TTAGCCAGGCATGGTGGCACATGCCAGTAATCCCAGCTACTCAGGAGGATGAGGCAGGAGAATCGCTTGAACCCAGGAGGCAGAGGTTGCAGTGAGCTGAGATTGCGCCACAGCACTCTACCCTGGGTGACAGAAGGAGACTCTGTCTCAAAAAAAAAAAA"
"GL873586","10258686","10258969","chr12","9481260","9481565","81","777426","GGCCGGGCATGGTGGCAGAAATCTAGGAGGCCGAGGCAGGTGGATCGCCTGAGATCACAAGTTCAAGACCAGCCTCAGCTACAGCAAGACCCCATCTCTAAAAATAGCCGGCTGTTGTGGCAGGCGCCTGTAACCCCAGCTACTCGGGAGGCTAAGGCAAGAGAATCGCTTGAGCCCATGAGTCTGAGGTTGCTGCGAGCTGTGACTCCACGGCACTCTACCCGGGGCGATAAAATGAGATTCTGTGTCAAAACAAACAAACAAACAAACAACAACAAAAACAA","GCTGGGCGCGGTGGCTCATGCCTGTAATCCCAGCACTTTGGGAGGCCAAGGCAGGTGGATCACCTGAGGTCAGGAGTTCGAGACCAGCCTAGTCCACATGGTGAAACCCCATCTCTACTAAAAACTAGCCAGGCGTGGTGGTGCGCACCTGTAATCCCAGCTACTCGAGAGGCTGAGGCAGGAGAATCACTTGAGCCTAGGAAGCAGAGGTTGTGGTGAGCTGAGATCACACCACTGCACTCCAGTCTGGGCGACACAGTGAGACTCTTGTCTCAAAAACAAAAAACAAACAAACAAACAAACAAA"
"GL873587","3208032","3208047","chr8","3626746","3626762","2","418714","AAACAACCACAAAAAA","ACAACAACAACAAAAAA"
"GL873587","3208141","3208321","chr19","2057131","2057316","59","1151010","TTTCTTTTAAAAATCACCCATGGGCTGGGTATAGTGGCTCACACCTATAATCCTCGGGAGGCCAAGGTTGGAGGATTGCTTGAATCCAGGAGTTGAAGGTTACAGTGAACTGGGATTTAGCCACTAGACTCTAGCATAGCTGACAAAGCAAGAACCTATTTGTTTAAAACACAAAAAAGAA","TACTAATAATACAAAAATGAGCCGGGTATGGTGGCGGGTGCCTGTAATCCCAGCTACTGAGGAGGCTGAGGCAGGAGACTTGCTTGAACCCAGGAGGTAAAGGTTGCAGTGAGCTGAGATTGCACCACTACACTCCAGCCTGGGCGACAAGAGCAAAACTTTTTCTCCAAAAAAAAAAAAAAAAAA"
"GL873587","3278260","3278367","chr19","19044200","19044312","39","15765940","CAGTCTGAGCAAGAGGGAGAGGCTATTTCTACTAAAAACAGAAAAACTAGCTGGGTGTTGGGGTGTGTTCCTAGTCTCAGTTACTTGGGAGGCTGAAGTAAGAGGATC","ACCAGCCTGGCCAACACGGTGAAATCCCGTCTCTACTAAAAATACAAAAATTACCTAGGCGTGATGGCACGTGCCTGTAGTCCCAGCTACTCATAAGGCAGAGGTGAGAGAAT"
"GL873587","3278673","3278754","chr7","49412503","49412597","28","46133830","GGCCACGAGAGCTAGCTCATGCCTATTCTAGGAGGCCAAAGCAGGCAGACTGCCTGAGCTCAGGAGTTCAAGAGCAGCCTGG","GGCCAGGTGCAGTGGCTCATGCCTGTAATCCGAGCACTTTGAGAGGCCGAGGCAGGCAGATCACCTGAGGTCAGGAGTTCAAGACCAGCCTAGTA"
"GL873587","3782076","3782188","chr9","112128434","112128552","34","108346358","ACTGGGGTGGCTGAGGCAGGAGCGTCACTTGAACTCAGGAGTTTGAGATTGCTGTGAGCTGAGCAGATGTCATGGCACGCTAGCCTAGGTAATAGAGTGAGACTTCGTCTAAA","CAGCTACTCGGGAGGCTGAGGCAGGAGAATCACTTGAACTCGGGAGGCGGAGGTTGCAGTGAGCCGAGATCACGCCATTGCACTCCAGCCTGGGCAACAAGAGCGAAATTCCATCTCAA"
"GL873587","4564996","4565084","chr20","27900350","27900437","14","23335354","GGCGGGGTGTAGTGGCTCATGCCTATTGTCCCAGCACTGTGGGAGGCCGAGGTGGGTGGATCACCTGTGCTCAGAAGTTTGAGACCAGC","GGCCGGGCGTGGTGGCTCATGTCTGTAATCCCAGCACTTTGGGAGGCCGAGGTGGGTGGATCACCTGAGGTCAGGAGTTCAAGACCAG"
"GL873587","6307870","6308175","chr12","112427710","112428020","54","106119840","GGCCAGATATGATGGCTCATGCTTGTAATCCTAGCACTCTGGGAGGCTGAAGTGGGAGGATCACCTGAGATCAGGAGTTCAAGATCACCCTGAGCAAAAGTGAGATCCCATCTCTATTAAAAATAAAAAAATTATCCAGGCATGGTGGTGCAGTCCTTTAGTCCCAGCTACTTGGGAGGCTGAGGCAGGAGAATCTCTTGAACCCAGGAATTAGAGGTTACAGTGAGCTGTGATGATGCTACTGCACTCTAGCAGGATGACAGAGTGAGATACTCCGTGTCAAAAAAAAAAAAAAAAAAAGCAAAA","GGCTGGACATGGTGGTTCATGCTTGTAATCCGAGCACTTTGGGAGGCCAAGGCGGGTGGATCACCTGAGGTTGGGAGTTCGAGACCAGCCTGACCAACATGATGAAACCCCATCTCTACTAAAAATACAAAAAAATTAGCCAGGCATGGTGATGCACGCCTGTAATCCCAGCTACTTGGGAGGCTGAGGCAGGAGAATCACTTGAACCCAGGAGGCAGAGGTTACAGTGAGCCGAGATCATGCCATTGCACTCCAGCCTGGATGACAGAGTGAGCCTCTGTCTCAAAAAAAAAAAAAAAAAAAAAAAAAAA"
"GL873587","6484004","6484128","chr10","67341428","67341546","29","60857424","GACCAGGTTCTGTGGCTCATGCTTGTAATCCTAGCACTCTAGGAGGCCGGAAGAGGGTGGATTGATTGCCTGAGGTCAGGAGTTAGAGACCAGCCTGAGCAAGAGCTAGACCCTGTTTCTTTCTT","GGCTGGGTGTAGTGGCTCATGCCTGTAATCCCAGCACTTTAGGAGGCCAAGGTGGATGGATTGCCTGAGCTCAGGAGTTCGAGACCACCCTGGGCAACAAGCCAAAACCCTGTCTCTAC"
"GL873587","6484407","6484586","chr3","167196537","167196723","48","160712130","TAGACCCTGTTTCTAAAAAAAAAATAGCCAGGTGTTGAGGCAGGTACCTGTAGTCCCAGCTACCTGGGAGGGCTGAGGCAAGAGAATCGCTTGAACCCAAGAGTTTGAGGTTGCTGTGAGCTGAGATGCTATGGCACTCAACCGTGAGCTACAAAGTGAGACTCTGTCTCAAAAAAAAAA","AAAACCTGTCTCTGCTAAAAATACAAAAATTAGCCGGGTGTGGTGATGTGCGCCTGTAGTCCTAGCTACTTGGGAGGCTGAGGCAGGAGAATCACTTGAATCCAGGAGGTGGAGGTTGTAGTGAGTCGAGATCGTGCGACTGCACTCCAGCCTGGGTGACAGCGAGACTCTGTCTCAAAAAAAAAAA"
"GL873587","7466229","7466364","chr1","29437872","29437991","35","21971643","GGCCAGGCGTGGTGGCTCATGCCTGTAGTCCCAGCGCTATGGGAGGCCGAGGTGGGTGGATCACCTGTGCTCAGAGGTTCGAGACCAGCCAAGACCCCCCTGAGCCAAATGAGCCAGAGTGAGATCCCATCTCTAC","GGCCGGGCGTGGTGGCTCACGCCTGTAATCCCAACATTTTGGGAGGCCAAGGCGGGTGGATCACCTGAGGTCAGAAGTTCGAGACCAACCTGGCCAACATGGTGAAACCCCTGTCTCTAC"
"GL873588","1502535","1502718","chr1","34852429","34852590","60","33349894","GGTGCAGTGGCTCACACCTGTTGTCCCAGCGCTGTGGGAGGCCGAGGTGGGTGGATCACCTGTGCTCAGAGGTCGAGACCAGCTGAAGACCTGCCTGAGGCAGAGTGAGCCAGAGTGAGACCCCGTCTCTACTAGAACAACAACAAGACAGCCAGACCTTGTGATCCCAGCTACATGGGGGGCT","GCCAGGTGCAGTGGCTCACACCTGTAATCCCAGCACTTTGGGAGGCCGAGGCGGGCGGATCACCTGAGGTCAGGAGTTTGAGACCAGCTTGACCAACATGGAGAAACCCCGTCTCTACTAAAAATACAAAATTAGCCTGGTGTGGTGTCGCATGCCTGTAAT"
"GL873588","10189037","10189246","chr3","45604681","45604903","65","35415644","GCTGAGATGAGGAGACTCTGTCTCTATTAAAAATAGAAAAATTGGGTGGATGTTGTGGGTACTGTAGTTGCAGCCTCTTGGGGGGCTAAGGCAGGAGGATCAGTTGAAGCCAGGAATTTGCTTTGAGCTAGGCTAAAGCCATGGCACTCTAGCCTGGGCAACAGAGTGAGGCTAGATCTCAAAAAAAGAAAGAAAAGAAAAAGAAAAAAA","CTGGCCAACATGGCAAAACCCCATCTCTACTAAATATACAAAAATTAGCTGGACGTGGTGGCACATACCTGTAATCCCAGCTACTTGGAAGGCTGAGGCAGGAGAATAGCTTGAACCTGGGAGGCAGAGGTTGCAATGAGCTGAGATCACGCCACTGCACTCTAGCCTGGGCAATAGAATGAGACTCTGTCTCAAAAAAAAAAAAAAAAAAAAAGACAAGAAA"
"GL873589","104719","104807","chr20","27900350","27900437","13","27795631","GGCTGGGCGTGGTGGCTCATGCCTGTTGTCCCAGCGCTGTGGGAGGCTGAGGTGGGTGGATCACCTGTGCTCAGAGGTTCGAGACCAGC","GGCCGGGCGTGGTGGCTCATGTCTGTAATCCCAGCACTTTGGGAGGCCGAGGTGGGTGGATCACCTGAGGTCAGGAGTTCAAGACCAG"
"GL873589","796766","796905","chr1","166346372","166346487","49","165549606","GGCTAAGTGTGGTGGCTCACACCTGTCATCTAGTACTTTGGGAGGGTGGGCCTGGGAGTTCAAAGACTGAACTCAGGAGTTCAAGGTGGCTCCGGGGAGGAATTCAAGACCAACCTGAGCCAGAGCGAGACCTCGACTCT","GGCCAGTGGGGTGGCTCACGCCTGTAATCCCAGCACTTTGGGAGGCTGAGGTGGTCAAATGACCTGAGGTCAGGAGTTTGAGACCAACCTGGCCAACATGGTGACACCTCGTCTCT"
"GL873589","1023679","1023690","chr1","205890061","205890072","1","204866382","AAAAAAAAAAAA","ACAAAAAAAAAA"
"GL873589","1023771","1024047","chr4","103012712","103012993","70","101988941","GGCTTGGTGGCTCACACCTGTAATCCTAGCACTCTGGGAGGCCGAAGTGGCTGGAATACTTGAGGTCAGGAGTTCAAGACCAGCCTAAGTGAGAGTGAGATCCCCATCTCTAATAAAAATAGAAAAATTAGCAGGGTGTTGTGGCTGGCACTTGTAGTCCCAGCTACCCAGGAGACCGAGGCAGAAGTTTGAGATTATTGTGAGCGAGGCTGATGCCACAGCATTCTAGTGGGACAACAGAGCAAAATTCTATCTCAAAAGAAAAAAAAAAAAAGGA","CGGGCGTGATGGCTCACGCCTGTAATCCCAACACTTTGGGAAGCCGAGGCGGACGTATCACCTGAGGTCAGGAGTTCAAGACCAGCCTGGCCAACATGGTGAAACCCCGTCTCTACTAAAAATACAAAAATTAGCTGGGTGTGGTGGCATGCGCCTGTAATCCCAGCTACCCAGGAGGCTGAGGCAGGAGAATCGCTGAGGCTGCAGTGAACTGAAATTGTGCCACTGCACTCCAGCCTGGGTGACAGAGCAAGACTCTGTCTCAAAAAAAAAAAAAAAAAA"
"GL873589","4820958","4821024","chr8","33633747","33633811","15","28812789","TTAGTCAAGTGCAGTGGCTCACACCTGTCATCCCAGCTACTTGGGAGGCTGAGGCAGGAGAGTTGCT","TTAGCCAGGTGTGGTGGTGCATGCCTCTAATCCCAGCTACTCAGGAGGCTGAGGCAGGAGAATTG"
"GL873589","6763768","6763857","chrX","25814002","25814092","29","19050234","GGTGTGGTGGCTCACACTTGTATCTTAGCATTTTAGGAGGCTGAATGGGGAGAATTGCTTTAAGTCAGGAGTCTGACTTCCACCTTGCCA","GGCTGGGAATGGTGGCTCACACCTGTAATCCCAGCACTTTGGGAGGCTGAGGTGGGCAGATCACCTGAGGTCAGGAGTTTGAGATCAGCCT"
"GL873589","8444551","8444632","chr9","93194085","93194171","17","84749534","CGGGCATGGTGGCTCACAACTATAATCTTAGCACTTTGGGAGGCTGAGACAGGTGGATGCCTGAACTCAAGAGTTTGAAACC","GGCCGAGCATGGTGGCTCACACCTGTAATCCCAGCACTTTGGGAGGCTGAGGCAGGTGGATTACCTGAGGTCAAGAGTTCAAGACCA"
"GL873589","9085365","9085494","chr2","194063347","194063481","42","184977982","GGCCAGGCACAGTGGCTCACACCTATAATCCCAGCACTCTGTGAGACTGAGGCAGGTGAACTGTTGCAAGAGTGAGACCCTGTGCTTGGTGCCTGTAGCTCAGTGGTTAATAATAAGAAAAAAGAAAAAA","GGCCAGGTGCAGTGGCTCACACCTGTAATCCCAGCACTTTGGGAGTCTGAACCAGGCAGATCACCTGAGGTCAGGAGTTCGAGGCCAGCTCGGCCACCATGGTGAAACCCTGTTTCTAATAAGAATACAAAAAAA"
"GL873589","9085767","9086002","chr7","84631446","84631650","75","75545679","GAGTGAAACCCTGTCTCTACTAAAAATAGAAAAACTAGCTGTGCATCAGGGCGCATAACTGTAGTCCCAGGTACTCAGGACACTGAGGCAAGAGAATTGCTCAAGCCCAAGAGTTTGCAAGAATTTGAGGTTGCTATGAGCTATGATGCCATGGCACTCTACCTAGGGTGACAGACAGAGACTCTGTCCCAAAAAAAAAAAAAGAAGAAGAAGAAAAAAAAAAAGAAAGAAAGAAA","ATAGTGAAACCTCGTCTCTACTAAAAATACAAAAATTAGCTGGGCATCATGGTGCACGCTTGTAATTCCAGCTACTTGGGAGGCTGAGGCAGGAGAATTGCTTGAACTCAGGAGGTGGAGGTTGCAATGAGCCAAGATCGCGCCACTGCACACCAGCCTGGGTGACAAAAGACTCTGTCTCAAAAAAAAAAAAAAAAAAAAAAAA"
"GL873589","9992904","9993045","chr16","56427538","56427666","46","46434634","AACCAGCCAGGCATGGTGATTCACACCTATAATCCCAGCTACTTAGGAGTATGGCTTGAGCACACAGGATACCATACCATTCTAGTCATCCCAGGCAACAGAGGGAAACTCTGTTGGTTAAAAAAAAAGAAAAACTTAAAAA","TTAGCCAGGAGTGGTGGTGCACGCCTATAATCCCAGCTACTTGGGAGGCTGAGGCACAAGAATCACTTGAACCATTGCACTCCAGCCAGGGTGATAGAGGGAGACTCTATCCAAAAAAAAAACAAAAAA"
"GL873589","9993319","9993452","chr3","2774534","2774668","28","7218785","GGCCTGAGCCCTGTGACTCATGCCTGTAATCCCAGCACTGGAAGTTCCAAGGCAGGTGGATCGCTTGAGCTCTGGAGTTCAAGACCAGCTCAACCAAGAGTAAGACCCCATCTCTACTAAAAATAGAAAAACCA","GGCTGGGCACGGTGGCTCATGCCTGTAATCCCAGCACTTTGAGAGGCCGAGGCAGGTGGATCTCCTGAGGTCAGGAGTTCAAGACCAGCCTGGGCAACATGGTGAAACCCCATCTCTACTAAAAATACAAAAAAT"
"GL873590","9044589","9044884","chr1","83754525","83754835","84","74709936","GGCCAGGTGCAATGGCTCATGCCTATAATCCTCACACTCTGGGAGGCTGAGGCAGGAGGATCACTTTTCTCAGGGTCAGGGCCAGCCTGACAAAAGTCAGACCCTGTTTCTACTAAAAATAGAAAAACTAGCTGGGTGTTGTGGCAGATGCCTATAGTCCCAGCTACTAAGAGACTGAGACAAGTGCCCAGAGTCTGAGGTTACTGTGAGCAAAGCTGATGCCATAGCATTCTAGCTATAGATCGAGAGTCTGTCTCAAAAACAAACAAACAAACAAACAAACAAACAAAAAAGAA","GGCTGGGTGTGGTGGCTCATGCCTGTAATCCCAGCACTTTGGGAGGCCGAGGCGGGTGGATCATCTGAGGTCAGGAGTTCAAGACCAGCCTGACCAACATGGTGTAACCCTGTCTCAACTAAAAATACAAAAATTAGCTGGGCGTGGTGGTGTGCACCTATAGTCACAGCTACTTGGGAGGCTGAGACAGGAGAATTGCTTCAACCCAGGAAGTGGAGGTTGCAGTGAGCCAAGATCATGTCACTGCACTGCAGCCTGACAGAGCGAGACTCCATCTAAAACAAACAAACAAAAACAAACAAACAAACAAA"
"GL873591","1831505","1831587","chr17","61702818","61702899","25","59871313","CCCAGCACTTTGGGAGGGCAAGATGGGAGAATCATATAAAGTCAGGAGTTTGAGACCAGTTTGGCAGACATGATGAACCCATC","AATCCCAGCACTTTGGGAGGCTGAGGCAGGCGGATCATCTGAGGTCAGGAGTTCAAGACCAGCCTGGCCAACATGGTGAAAC"
"GL873591","2719175","2719275","chr4","86137755","86137847","32","83418580","GTGGGGGCTTAGGCCTGTAATCCCAGCACTCTGAGAGGCCAAGGTGAGCTGGTCACCTGGGTTTAGGAGTTTGGAGACTTGCTCGAGCTAGACTGAGGCTC","GTGGTGGCTCACGCCTGTAACCCTAACAATTTGGGAGGCCAAGGCAGGTGGATCACTTGAGGTCAGAAGTTTGAGACCAGCCTGGACAATATG"
"GL873591","4732974","4733120","chr19","7991801","7991954","55","3258827","ATACGCAGACTGGCCGAGCGTGGTGTCACATGCCTATAATCCCAGTGGCTACTCTGGGGAGGAGAATCTCTTGAAACCAAGAGTTAGAGATTGCAGTGGGGTATGATACAGGGTAACAAAGAGAGACCTTGGATCTGAAAAGAAAAA","AAAATACAGAAACTAGCTGGGCATGGTGATGCACACCTGTAATCCTAGCTACTGGGGAGGCTGAGGCAGGAGAATTGCTTGAACCCAGGAGTCAGAGGTTGCAGTGAGCAACCAGCCTGGGTGATACAGTGAGTGAGACTCTGTCTCGAAAAAA"
"GL873591","6822728","6823009","chr1","20579766","20580052","72","13757038","GGCCAGGCGTGGTGGCTCATGCCTGTAAATCTCAGCACTCTGGGAAGCTGAGGCAGGTGGATTGCTTGAGGTCAGGAGTTTGAGACCAGCCTGTACCAGAGTAAGACCCTGTCTCTAATAAAAATAGAAAAAAAAAAAAAAACTAGTTGGGCATGGTGATGGGTGCCTGTAGTCCCACCTACTTGGGAGGCTGAGGCAATGGCATCTCTTGAGCCCAAGAGTTTGAGGTTGCTGTGCCATGGCACTCTCCCCAGGGTAACAGAGTGAAAATAAAAAAAAGAA","GGCCAGGCGTGGTGACTCATGCCTGTAATCTCAGCACTTTGGGAGGCCGAGGCAGGTGAATCACCTGAGGTCAGGAGTTTGAGACCAGCCTGACCAACATGGTGAAACCTCGTCTCTACTAAAAATACAAAAAGTAGCCAGGCATGGTGGCGCATGCCTGTAATCCCAGCTACTTGGGAGGCTGAGGCAGGAGAATCGCTTGAACCCGAGAGGCAGAGGTTGCATTGAGTCAAGATGGTACCACTGCACTCCAGCCTGGGTGACAGATTGAGACTCAAAAAAAAAAA"
"GL873591","7578706","7578813","chr16","45055441","45055543","42","37476735","AAATTTAGCTACACATAGTGGCATGAGTCTGTAATGCTAGCCACCCAAAAGGCTGTAGTAAGAGGATTGCTCTATCCCAGGAGTTAAAGACCAGCCCGGACATCAGAG","AATTAGCCGGGCGTGGTGACACACACTTGTAATCCTAGATACTCAGGAGGCGAAGGTAGGAGAATTGCTTGAACCCAGGCAGCAGAGGTTGCAACGAGCAGAG"
"GL873591","9282916","9283004","chr1","20744253","20744338","16","11461337","GGCCAGGCGCGGTGGCTCACCCCTGTTGTCCCAGTTCTGTGGGAGGCCGAGGTGGGTGGATCACCTGTGCTCAGAGGTTTGAGACCAGC","GGCCAGGCACGGTGGCCACGCCTGTAATCCCAGCACTTTGGGAGGCCGAAGTGGGTGGATTACCTGAGGTCAAGAGTTTGAGACCA"
"GL873592","835155","835315","chr16","75654291","75654451","43","74819136","CTGGGTGTGGTGGCTCTTGTCTGCAATCTCAGTACACTGGGAGGCTGAGGCAGAAGGATTGCTCCAGCTCAGGAGTTTGAGGCCAGGCTGAGCTAGTGCAAAACCCCATCTCTACTAAAAAAAGAAGGAAAAAAAAAAGAAAAAGAAAAAAAATACGAGCT","CCAGGTGTGGTGACTCACGCCTGCAATCCCAGCACTCTGGGAGGCTGAGGTGGGTAGATTACCGGAGGTTAGGCGTTTGAGACCAGCCTGGCCAACATGGTGAAACCCCATCGCTACTAAAAAAAAAAAAAAAAAAAAAAAAAAAAAAAAAAAAAAAATTA"
"GL873592","835589","835765","chr1","66836166","66836336","48","66000577","ACAAAAAACCTAGCTTAGGGTTGTTATAGCACCTGTAGTCCCAGCTACTCAGGCGCTAAGGCAGGAAAATCTGCCTGAGCTCAGGAGTTTGAGGTTGCAGTAAGTTATGATGATGCTACTGCACTCTAGCTGGGGCAACAGAGTGAGACTCTGTCTGAGGAAAAACCAAAACCAAAA","TAGCCCAGCACGGTGGCTCACACCTGTAGTCTCAGCTACTCAAGAGGCTGAGGCATGAGAATCGCTTGAACCCAGGAGGTAGAGGTTGCAGTGAGCTGAGATCATGCCACTGCGCTCCAGCCTGGGCAACAGAGTGAGACTCAGTCTCAAAAAACAAAACAAAACAAAAAA"
"GL873592","2520661","2520705","chr16","66853217","66853257","11","64332556","TCTGGGAGGCTGAGGCGGGTGGATCACCTGAGCAAGAGTGAGACC","TTTGGGAGGCTGAGGCAGGTGGATCACTTGAGGTCAGGAGT"
"GL873592","4535248","4535388","chr1","12240468","12240612","38","7705220","GGCGGGATGTGGTGGTTCATGGCTGTAATCCCAGCACTCAGGGAGGCTGAGTCGGGTGGATTGCTTGAGTTCAGGAGTTTGAGACCAACCTGAGCAAGAACTAAGCCTGTCTCTACTAAAGATATTATTTCTTATTTTTCT","GGCCGGGCGCGGTGGCTCATGCCTGTAATCCCAGCACTTTGGGAGGCTGAGGCGGGTGGATCACCTGCGGTCAGGAGTTCGAGACCAGCCTGGCCAACGTGGTGAAACCTCATCTCTACTAAAAATATAAAAATTAGCTGGTGTG"
"GL873592","4535654","4535831","chr8","126054004","126054184","54","121518350","TCTACTACAAATATTAACAGAAAAATTAGCTGGGCATTGTGACAGGTGCCTATAGTCCCAGATACTCAGAAGGCTGAAGTAAGAGGATCACTTGAACCCCAGGAGCTAAGGTGGCTGTGAGCTAGGCTGAGGCTCTAGCCTGGGTAACAGAGTGAGACTGTAAAAAAAGAAAGAGAGA","GTCTCTACTAAAAATACAAAAATTAGCTGGGTGTGGTGGTGCATGCCTGTAATCCCAGCTACTCAGGAGGCTGAGGCAGGAGAATCGCTTGAACCCAGGAGGTAGAGGTTGCAGTGAGCCAAGATCATGCCACTGCACTCCAGCCTGGGTGACAGAGGGAGACTCTGTCTCAATAAATAAA"
"GL873592","6794968","6795049","chr3","154764711","154764794","20","147969743","GAAGGTTTGATGAGCTCAGATGATGCCACTGCAGTCTACCCAGAGTGAAGGAGCGAGACTCTGTCTCAAAAACAAAAAAAGA","CAGAGGTTGGCAGTGAGCTGAGACTGTGCCACTGCACTCCAGCCGGGTGACAGAGTGAGACTCTGTCTCAAATTACAAACAAAA"
"GL873592","6881384","6881478","chr5","24882384","24882475","28","18001000","GGGCAGGCATAGTGACTGGTGTCTCTAATCCTAGCAGTCTGGGATGCTGAGGCAAGTGGAATGTCAGAGTTCAGGAGTTGAAGATCACCCTGACT","GGCCGGGCGCAGTGGCTCACATCTATAATCCTAGCATTTTGGGAGGCTGAGGCAGGCGGATCACCTGAAGTCAGGAGTTTAAGACCAGCCTG"
"GL873592","6881755","6881937","chr10","61601371","61601572","66","54719616","TCACCCTGACCAAGAGCAAGACCCTGTCTCTACTAAAAATAGAATAAACTAGCTGGGAATTGTGGTGGGTGCCAGTAGTCCCCGCTACTGAGGCAGGAGGATCATTGAGTCCAAGAGTTTGAGGTTGCTGTAAGTTAGGACACCACAGCACTCTACACAGAGTAAGACTGCCTCAAAAATAAA","AGTAAAGAAAAGAAACCCTGTCTCTACTAAAAATACAAAAATTAGCTGGGTGTGGTGGTGCGCACCTGTAGTCCCAGCTACTTGGGAGGGTGAGGTATGGGAATCACTTGAACCCGGGAGGTGGAGGTTGCAGTGAGCCAAGATCACACCACTGCACTCCAGCCTGGGTGAGAGAGTGAGACTCTGTCTCAAGAAAAAAGAA"
"GL873592","7006080","7006155","chr1","8947061","8947129","24","1940981","CACACTGAGAGGCAAAGGCTGGTGGATCACCTGAGCTCAAGAGTTTGAGACCAGCCAAGCCAGAGATCTTGTCTCT","CACTTTGGAGCCAGGTAGGTGATCACCTGAGTCAGGAGTTCGAGACAGCCTGGCCAACATGTGAAACCC"
"GL873592","8446508","8446655","chr11","122502739","122502874","48","114056231","TTAGCTGGGTGTTGTGGCAGGCACCTGTAGTCCCTCCCAGCTACTTGAAAGGCTGAGGCAAGATGACAGCTTAAACCCAAGAGTTTAAGGTTACTCTATTCAGGGCAACAGAGTGAGACTCCATCTACATAAATAAATAAATAAATAA","GGCTGGGCGTGGTGGTTCACACCTGTAATCCCAACACTTTGGGAGGCTGAGGCCAGCGGATTGCCTGAGCCCAGGAGTTTGAGACCAACCTGGGCAACATGGTGAAACTCCATCTCTACTAAAATACAAAAAGTTA"
"GL873592","8446953","8447008","chr16","44513352","44513404","15","36066399","GACCAGCCTAAGCAAAAAAGAGATCCTATCTCTACTACTAAAAATAGAAAAAATTA","ACCAGCCTCACCAATATGAAGAAACCCCATCTCTACTAAAAATACAAAATATT"
"GL873592","8447239","8447325","chr1","8062863","8062957","21","384376","GGCCAGGAGCAGTGACTCATGCCTAGCACTCTGGGAGGCCAAAGCAGGTGGATCAACTGAGCTCAGGAGTTCAAGACCAGCCTAAGC","GGCCGGGTGCAGTGGCTCATGCCTGTAGTCCCAGGACTTTGGCAGGCCAAGGCCGGTGGATTACCTGAGGTCAGGAGTTCAAAACCAGCCTAGCC"
"GL873592","8723925","8724000","chr3","42066983","42067054","20","33343058","AATTAGCCGGGCATGGTAGTGTGTGCCCATAATCTCAGCTACTCAGAAAGCTAAGATAGGAAAATTGCTTGAGCTC","TTAGCTGGGTGTGGTAGTGCATGCCTATAATCCCAGCTACTCGGGAGGCTGAGGTGGGAGAACTGCTTGAAC"
"GL873593","384022","384146","chr15","102382935","102383070","28","101998913","GGCCACGAGGGCCCATGCCTGTAATCCTAGCACTCTGGGAGGCTGAGGTGAGTAGATTGCTGAGCTCAGGAGTTCAAGACCAGCCTGTGCAAGAGACCCCATCTCTGCTAAAAATAGAAAAACCA","GGCCAGGTGTGGTGGCTCACGCCTGTAATCCTAGCACTTTGGGAGGCTGAGGCGGGTGGATTGCCTGAACTCAGGAGGTCAAGACCAGCCTGGGCAACACAGTAAAACCCCATCTCTACTAAAATACAAAAAATCA"
"GL873593","384425","384607","chr20","28286874","28287058","50","27902449","GAAAGAAAAGAAAAGAAAAACTAGCAAGATGTTGTAGCTGATGCCTATAATCCTAGCTATTGGAGAGGTGGAGGCAAGAGAATTGCGTGAGCCCAAGAGTTGAAGGTTGCTGTGAGCTGCGATGCCAGAGCACTCCAGGGTGACAGAGTAAGACTCTGTCTCAAAAAAAATTACAAAATAAAA","TAATAAAAATAAAAAAATTAGCCAGGAGTCAAAGCACACGCCTATAACCCCAGCTACTTGGGAGGCTGAGGGAGGAGAATTACTTGAACCCGGGAGGTGAAAGTTGCAATGAGCTGAGATCAAGCCACTGCACTCCAGACTGGATGACAGAGTGAGACTCTGTTTCAAAAAAAAAAAAAAGACAA"
"GL873593","1408445","1408467","chr10","88070368","88070389","9","86661923","AATCTAGAGATGGGGAGAGGTTG","AAAGAGATGGAAGAGAAGAAGA"
"GL873593","4856365","4856484","chr7","56497314","56497433","31","51640949","GCAATCCCAGCTGATCGGGAGGCTGACCCAGAAGAATCCCTTGAACCCAAGAGTCTGAGGTTGCTATGGGTGGATTCTACAGCACTCTAGCCTGGGAGACAGAGTGAGACTCTGTCCCAA","ATCCCAGCTACTTGGGAGGCTGAGACAGAAGAATTGCTTGAACCCGGGAGGTGGAGGTTGCAGTGAGCCAAGATTGTACCACTGCACTCCAGCCTGGCAACAGAGTGAGACTCTGTCTCA"
"GL873593","6661298","6661485","chr10","86749316","86749514","55","80088018","GCAGAGGCTCACATATGTAATCCTAGCACTCTGGGAGGATAAGGCAGGTGGACAGCTTGAGCTCAGGGGTTTGACCAGTCTGATCAAGAGCAAGACCTGTGTCTACTAAAAATAGAAAACCTAGCCAGGTATGATGGTAGATGCCTGTATTCCTAGCTACTCTGGAAGCTAAAGCTAAAGAGTTTGAA","GGTGGCTCACACCTGTAATCTTAGCAATTTGGGAGGCCGAGGTGGGTGGATCACTTGAGGTCAGGAGTTTGAGACCAGACTGGCCAACATGGTGAAACTCTGTCTCTACTAAAAATACAAAAATTAGCCAGTCATGGTGGTGCATGCCTGTAATCCCAGCTACTCAGGAAGCTTAGGCAGGAGAATCACTTGAACCCAG"
"GL873593","6710263","6710446","chr14","4390080","4390244","66","2320183","TTGAAGTCAGGAGTTTAAGGCCAGTCTGGGCAACATAGTGAGACCCCCATCTCTACGAAAATATTTTTTAAAAATTAAAAATAGCTGGGCATAGTGAGGCTGTTGTGAGCTATAACTGCACCACTGCACTCAGCCAAGGACAGAGACCCTGTTCCCTGCCTCAAACAAACCAAAACAAAACAAA","AAGTCTAGAGTTTACAGCCTGGACAACGCAGTGAAACCCTGTCTCTACCAAAAATACAAAAATTAGACAGGTGTGAGAGGCGGAGGTTGCAATGAGCTGAGATCGCAGCACTGCAGTCCAGCCTGGATGACAGAGCGAGACCCCATCTCAAAAACAAAAACAAAA"
"GL873593","7159645","7159716","chr6","178318394","178318465","21","171158749","GATCATGTCACTGCTCTCCAACCTGGGCAATTGAGCAGGAATCTGTCTCAAAAAGAAAAAAAAAAAAGAAAA","CGAGTTCACACCACTGCACCCCAGCCTGGGCAACAGAATGAGACTCGGTTTCAAAAAAAAAAAAAAAAAAAA"
"GL873593","7159841","7160050","chr13","33368171","33368368","69","26208330","GGCCAGGCGTGGTGGCTCACACCTGTTGTCCCAGTGCTGTGGGAAGCCGAGGCAGGTGGATCACCTGAGCTCAGCCGAGTTCGAGACCAGTGGAAGACCAGCATGAGGCAGAGTGAGCCAGAGTGAGACCCCATCTCTACAACAACAACAAGAAGAAAAAAAACAGCCGGACCTTGTGATCCCAGCTACGTGGGGAGCTAGAGAATCACT","GGCTAGGCATGGTGGCTCATGCCAGTAATCCCACCACTTTGGGAGGCCGAGGCAGGTGGATCACCTGAGGTCAGGAGTTCAAGACCAGGCTGGCCAACATGTTATGATGAGACCCTCATCTCTACTACAAATACAAAAATCAGCTGGGCATGGTGGCAAGTGCCTGTAATCCCAGCTACTTGGGAGGCTGAGGCAGAA"
"GL873593","8598292","8598391","chr11","118461023","118461129","33","109862731","AGCCAGGTGAGGTGGTTCACACCTGTAACCCTAGCTGCTTGGGAGGCTGAGGCCTCTCTATCCTGGGCAGTGTGGAGAAACTTTGTTTCAAAAAAAAGAA","GCCGGGCGCGGTGGCTCACGTCTGTAATCCCAGCGCTTTGGGAAGCCGAGGCGGGACTATCCTGGCCAACATGGTGAAACCCCGTCTCTACTAAAAATACAAGAATC"
"GL873594","357249","357377","chr2","75702890","75703011","36","75345641","CCTGGTACCGTAGGTCATGCCTGTAATCCTAGCACTTTGGGATGCTGAGGTGGGCAGATTGCCTGAGCTCACGAGTTCAAGCCATTAGAACTGAGCCTGACCTAGAGTGGGACCTCCAACTCTTTTTTT","GCCAGGCACAGTGGCTCATGCCTGTAATCCCAGCAGTTTGGGAGGCTGAGGTGGGCAGATCACTTGAGGTCAGGAGTTCAAGACCAGCCTGGCTGACATGGTGAAACCCCATCTATACCAAA"
"GL873594","357656","357834","chr7","17608776","17608965","55","17251120","GGGACCTCCAACTCTTAAAATAGCTGGGCATTGTGGTGGGCACCTACAGTCACAGCTACTTGGGAGGCTAAGGCAAGAGACTTGTTTGCAGCCAAGAGTTAGAGGTTGCTGTGAGCTATGAGGCTAGGGCACTCTACAGGGGGCGACAAGTGAGACTGTAAAAAAAAAAAAAGAAAAAA","GTCCCTACTAAAAATACAAAAAATTAGCTGGGCCTGGTGGCAGGCACCTGTAATCCCAGCTACTTGGGAAGCTGAGGCAAGAGAATTGCTTGAACCCAGGAGGCAGAGGTTGCAGTGAGCTGACATCAAGCCACTGTACTCCAGCCTAGGCAACAAGAGCAAGACTCTGTCTCAAAAAAAAAAAAAAAAA"
"GL873594","1410711","1410996","chr5","151340503","151340797","76","149929792","CACAGTGGCTCATACCTATAATCCTAACACTCTGGGAGGCCAAGGTGGGTGGACTGTCTGAGTTTGGGACCAGCCTGAGCAAAAGCAAGACTCCCATCTCTACTAAAAACAAAGACAGCCAGGTATGAGGGCAGGTGCCTATCATCCCAGCTACTTGGGAGGCTGAGGAAGGAGGATCACCTAAGCCCAGGACTTTAAGGTTTCTGTGAACTAAGATGATGTTACAACACTCTAGCCAGGGTAACAAGGCAAGATTCTGTTTCAAAAGACAAAAAAAAAAAAAAAA","GGTGGTTCATGCCTGTAATCCCAGCACTTTGGGAGGCTGAGGCAGGTGGATCACCTGAGGTCAGGAGTTCGGGACCAGCCTGGCCAACATGGGGAAACCCCATCTCTACTAAAATACAAAAATTAGCCAGGTATGGTGGCACATGCCTATAATCCCAGCTACTTGGGAGGCTGAGGCAGGAGAATCACTTGAACCCAGGAGGCTAAGGTTGCAGTGAGCCGAGATTGTGCCACTGTACTCCAGCCTGGGTGACAGACTGAAACTCTGTGTCCAAAAAACAAAACAAAACAAAAAA"
"GL873594","5528090","5528162","chr2","69013639","69013718","24","63485549","GGTACAGTGGCTCACGCTTGTGATCCCAGGTTGAGGTGGGTGGATCGCCTGAGCTCAGGAGTTGGATGCCAGC","GGTGTGGTGCCTCACGCCTATAATCCCAGCACTTTGGGAGGCAGGTGGATCACTTGAGGTCAGGAGTTTGAGAACAGCCT"
"GL873594","5834047","5834168","chr2","82491537","82491662","28","76657490","GGCTGGGCCCAGTAGCTCACGACTGTAATCCCAGCACTCTGGGAAGCTGAGGTGGGCGGATCACCTGAGCTCATAGGTTCGAGACCAGCTCCAGTTAGAGTGAGAGCCTGTCTCTAAAAATA","GGCTGGGCACAGTGGCTCATGCCTGCAATCCCAGCACTTTGGGAGGCTGAGGTGGGCAGATCACCTGAAGTCAGGAGTTCAAGACCAGCCTGGCCAACACAGTGAAACCCCATCTCTACTAAAAAT"
"GL873594","5834396","5834461","chr13","14688151","14688212","20","8853755","TATATAATAATAATAACCAGGTATTGTGGCAGGTGCCTCTAGTCCCAGCTACTCGGGAGGCAAAGG","ATAAAAAAATTAGCTGGCCATGGTGGCACATACCAATAATCCCAGCTACTCAGGAGGCTGAG"
"GL873594","7786130","7786294","chr14","12217087","12217250","37","4430957","GGGTGTGCTGGCTCATACCTATAATCCTAGCACTCTGGGAGGCTGAGGTAGGTGTATTGCTTGAACCCAGGAGTCTGAGGTTGCTGTGCGCTAAGCTGATACCATAGCACTCTAGCCTGGGCAACAGAGTGAGACTCTGTCTCAAAACAAATAAATAGTAAAAAA","GCTGGGCGTGGTGGCTCACACCTGTAATCCCAGCACTTTGGGAGGCCAAGGCATGAGAATTGCTTGAAAACAGGAGGCGGAGGTTGCAGTAAGCTGAGACTGTGCCATTGCACTCCAGCCTGGGCAACAAGAGTGAAACTCTGTCTCAGAAAAAAAGAAAAAAA"
"GL873595","723579","723774","chr19","6045933","6046125","65","5322354","GCCTGAGCAGGAGAGAGACCCCATCTCTGCTGAAAGTGGAAAAGTTGGCTGAGTGTAGTGGCGGGCTGCTGCCCCAGTCACTCAGGAGGCTTAGGAAGGAGTATCGCTTGGGCCCAAGATTTGAGGTTGCTGTGAGCGCTACAAAGACATTAGGGTACTCTACACAGGGGAATAGAGTGAGACTGTCTCAAAAAAA","CAACATGGAGAAACCCCGTCTCTACTAAAAATACAAAATTAGGCAGCGTGGTGGTGGGTGCCTATAATCCCAGCTACTCAGGAGGCTGAGGCAGGAGAATCGCTTGACCGGGAGTGGAGGTTGCGGTGAGCTGAGATTGCACCATTGCACTCCAGCCTGGGCAACAAGAGTGAAACTCCGTCTCAAAAAGAAA"
"GL873595","724114","724204","chr20","18199749","18199840","22","17475635","GGCCATGCTTGGTGGTTCTCATCTGTAATCCTAGCACTCTGGAAGGTCTACAGGGGTGGATGGCTGGAGGTCAGGAGTTCAAGACTGGCCT","GGCCGGGCATGGTGGCTCACACCTGTAATCCCAGCACTTTGGGAGGCTGAGGCAGGCGGATCACCTGAGGTCAGGAGTTCGAGACCGGCCTG"
"GL873595","1065346","1065667","chr18","10529729","10530057","74","9464383","GGCCAGGTGCAGCAGCTCATGCCTGGAATCTTCCTGCTCTGTATGGCCAAGGCAGGTGGATCGCCTGACCTCAGGAGTTCCAGACCAGCCTGAACAAGAGCAAGACTCTGTCTCTACTAAAAGTAGAAAAAAAACTAGCCAGTCATAGTGGCAGGTGCCTGTAGTCCCAGCTGCTTGGGAGGCTGAGGCAAGAGGATCACTTGAACCTAAGAGTTTGAGGTTGCTGTGAGCTAAGATGCCACATCACTCTATCAAGGGTGACCAAGTGAGACTCTGTCTCAAAAATAAATAAATAAATAAATAAAAAGAAAGGCAAAAAGAA","GGCCCGGCGTGGTGGCTCATGCCTATAATCCCAGCCCTTTGGGAGGCCAAGGCAGGTGGATCACCTGAGGTCAGGCGTTCGAGACCAGCCTGACCAACGTGGTGAAACCTCATCTCTACTAAATACAAAAAAAATTTAGCCAGGCATGGAGGCACATGCCTGTAATCCCAGCTACTTGGGAGGCTGTGGCAGGAGAATCACTTGAACCTGGGAGGTGGAAGTTGCAGTGAGCTGAGATTGTACCACTGCACTCCAACCTGGGTGACAAAGCAAGACTCGGTCTCAATAAATAAATAAATAAATAAATAAATAAATAAAGTGAAAAAAAA"
"GL873595","1254878","1255146","chr4","42822326","42822607","67","41567448","GGCTGGGCATGGTGGCTCATGCCTGTAATCCTACCGCTCTGGGAGGCTGAGGCAGAGGATCACTTGAGCTCAGGAGTTTCAGACCAGCCTGCAAGAAGGACCCAGTCTCTGCCGAAAATAGAAAAGTTAGCAAGGCGTTGTCGTGAGCACATGTATCCCAGCTACCTAGAACTCTGAGGCAGGAGGATCCCTTGAACCCACAGAAGTTGCTGTTATCTAAACTGATGCCACTGGACTCTAGCCTGGGCAACAGAGTGAGACTGGTCTCA","GGCCGGGCACGGTGGCTCATGCCTGTAATCCTAGCATTTTGGGAGGCTGAGACAGGCAGATTGCCTGAGCTCAGGAGTTCAAGACCAGCCTGGGCTAGATTGTGAAACCCCATCTCTACTAAAATATAAAAATTAGCTGGGTGTGGTGGCACACGCCTGTAATCCCAGCTACCTGGGAGGCTGAGGCAGGAGAATCGCTTGAACCAGGAGACAGAGGTTGCAGTGAGCTGAGATCACGCCACTGCACTTTAGCCTGGGCAACAGAGTGATACTCTGTCTCAA"
"GL873595","3417105","3417297","chr12","115674238","115674427","44","112257133","GGCCGGGCGCTGTGCCTCACGCCTGTAATCCTAATACTCTGAGAGGCCGAGGCAGGTGGATTGCCTGAGCTCAGGTGCTCAAGACAGCCTGACTGAGCAAGCCCTGAGATCCCATCTCCACTAACAATAGTAAAACTAGCCGGGCATTGTGGTGGTGCTTGTAATCCCAGCTACTGGGAGGCTAAGACAGGAG","CCAGGCCTGGTGGCTCACGCCTGTAATCCCAGCACTTTGGGAGGCCGAGGTGGGTAGATCACCTGAGGTCAGGAGTTCAAGACCAGCCTGGCCAACATGGCGAAACCCCATCTCTACTAAAAATACAAAAATTAGCTGGGCATGGTGGTGTATGCCTGTAATCCCAGCTACTCGGGAGGCTGAGGCAGGA"
"GL873595","6098380","6098457","chr3","87492619","87492702","21","81394239","GCTGTGGCTCATGCTGATAATACCAGCACTCTGGGAGAACAAGGTAGGCAGATCACAAGAGGTCACCTGTGCAAGACC","GGGCTGGTGGTGGCTCATGCCTGTAATACCAGCACTTTGGGAGGCCAAGACAGGTGGATCACCAAAGGTCAAGAGTTCAAGACC"
"GL873596","134190","134307","chr1","203207333","203207443","31","203073143","GGCTGGGCGAGGTGGCTCACACCTGTAATCCTAGCACTCTGGAAGGCCCTAGCACTCAGGCAGTTGGATTGCCTGAGCTCACAAGTTCAAGACCAGCCTGAAAAAGAGCAAGACCTCA","GGCTGGGTGCAGTGGCTCACACCTGTAATCCCAGCACTTTGGGAGGCCGAGATGGGTGGATCACTTGAGGTCAAGAGTTGAAGACCAGCCTGGACAACATGATGAGACCCC"
"GL873596","134578","134681","chr11","50235285","50235387","37","50100707","CAAACAAAAGAGGAAGACCTCGTCTCTAAAAAAATAGCTGGGCATTGTGAGGAGTACCTGTAGTCCTAGCTACTCAGAAGGCTGAGACAAGAGAATCACTTAAA","CAACATTGTGAAACCCTGTCTCTACTAAAATAGAAAATTAGCCAGGTGTGTGGGCGTGCCTATAATCCTAGCTACTGGGGAGGGTGAGGCATGAGAATCGCCT"
"GL873596","8160215","8160350","chr1","29437872","29437991","30","21277657","GGCCGGGCGTGGTGGCGCACACCTGTAGTCCCAGCGCTATGGGAGGCCGAGGCGGGTGGATCACCTGAGCTCAGAGGTTCGAGACCAGCCAAGACCCCCCTGAGCCAAACGAGCCAGAGTGAGACCCCGTCTCTAC","GGCCGGGCGTGGTGGCTCACGCCTGTAATCCCAACATTTTGGGAGGCCAAGGCGGGTGGATCACCTGAGGTCAGAAGTTCGAGACCAACCTGGCCAACATGGTGAAACCCCTGTCTCTAC"
"GL873596","8421071","8421132","chr20","1874027","1874093","12","6547044","GTCAGGCGCAGTGGCTCACGCCTGTAATCTCAGCACTCTGAGAAGCCAAGGCAGGATCATCT","GGCCAGGCGCAGTGGCTCAGGCCTGTAATCCCAGCACTTTGGGAAGCCAAGGTGAGCAGATCACCTG"
"GL873598","4416400","4416489","chr5","39418145","39418231","15","35001745","GGCCAAGTGTGGTGGCTCATGCCTGTTGTCCCAGCACCGTGGGAGGCCGAGGCTGGTGGAACACCTGAGCTCAGCTGAGTTTGAGACCAG","GGCCAGTTGCGGTGGCTCATGCCTGTAATCCCAGCACTTTGGCAGGCTGAGGCAGGTGGATCACCTGAGGTCAGGAGTTTGAGACCA"
"GL873598","4416855","4416947","chr3","94091253","94091337","31","89674398","GTGAGACCCTGTCTCTACAAAAAAAAAAGCTGGGCACTGTGGCATGTGCCTGTAATCCCAGCTACTTGGGAGGCAAAGGGAAAGAGAATCACT","AAACCTTGCCTTTACTAGAAATACAAAAATTAGCTGGGCATGGTGGCAGGTACCTGTAATCCCAGCTACTTGGGAGGCTGAGGCA"
"GL873598","5126074","5126161","chr1","12339306","12339394","19","7213232","GCCTGGTGCACTGGTTCACACCTGGAATCCTTGCATTCTGAGAGGCCCAGGTAGGCAGATCACCTCAGCTCAGAAGTTCGAGACCAGC","GCTGGGTGCGGTGGTTCACGTCTGTAATCCCAGCACTTTGGGAGGCCGAGGCGGGCAGATCACCTGAGGTCAGGAGTTCGAGACCAGCC"
"GL873598","5467584","5467662","chr1","9313328","9313403","17","3845744","GCGAGGTGGCTCACGCCTGTAATCCCAGCACATTTGGAAGGCCAAGGAGGGTGGATCACCCGAGCTCACCAGTTGGAGA","CGCAGTGGCTCACGCCTGTAATCCCAGCACTTTGGGAGGCCGAGGCAGGCAGATCACCTGAAGTCAGGAGTTTGAG"
"GL873598","6917752","6917856","chr14","9558287","9558382","22","2640535","GGCCAGGCATGGTGGCTTGTGCCTGTTGTCCCAGCACTGTGGAAGGCCGAGGCGGGTGGATCGCCTGAGCTCAGCTGAATTCGAGACCAGCATAAGACCAGTATG","GGCCAGGCATGGTGGCTTATGCCTGTAATCCCAGCACCTTGGAAGGCCGAAGCGGGCAGATCACCTGAGCTCAGGAGTTTGAGACCAGCCTGTCCA"
"GL873598","8078910","8079062","chr7","164825511","164825660","43","156746601","AACAGCCAGGCATTGTGGTGGGCACCTGTAATCCCAGCTACTTGGGAGGCTGAGGCAAGAGAATTGCTTGAGCCCAACAGTCTCAGGTTACTGTGAGTTATGACACCATGGCACTCTATTGAGGGCAAGAAAGTGAGACTGTCTTGGAAAAAA","CTAGCCAGGCATGGTGGTGCGCACCTGTAGTCCCAGTTACTTGGGAGGTTGAGGCAAGAGAATTGCTTGAGCCTGGAAGGCAGAAGTTGCAGTGAGCTGAGATCACACCACTGCATTCCAGCCTGGGCGAAAGAGCAAGACTCTGTTGAA"
"GL873598","8079328","8079454","chr6","10381248","10381379","32","2301920","GCCCGGCGTGGTGGCTCACGCCTGTAATTCCAGCACTCTGGGGAGGCCGAGGAGGGCAGATTGCCTGAGCTCACAGGTTTGAGCTAGAGCGAGACCCTGTCTCTTAAAAAGAAAAAAAAGGAAAGAA","GCTGGGCGCGGTGGCTCACGCCTGTAATCCCAACACTTTGGGAGGCCGAGGCGGGCAGATCACCAGAGGTGATCTCCAGCCTGGGCAGGAGAGCAAGACCCTGTCTCAAAAAATTTAGAAAAAGGAAAGAAA"
"GL873599","3943256","3943456","chr9","35892110","35892312","79","31948854","GGCAGGCTGCTTTGACCCATATCTACAACTCCAGAACTTTAGAGGCTGAGCTGGGTGGGTCCCTTGAGATTAGAAACTGCTTAGTAGCCTGGCAAAAACCAGACCCCACCTCCACCATGTAGAAAAATTAGCAGTATGCCATAGTGGGAACCTACCAATACAGTCTTTCCAAAGGCCAAAGCTAGAAGGACCGTGAGCTTG","GGCTGGGTGTGGTGGCTCATGCCTATAATTCCAGCACTTTGGGAGGCCGAGGCAGGTGGATCACCTGAGGCCAGGAGTTTGAGACCAGCCTGGCCAATATGGTGAAACCCCATCTCTACTAAAAGTACAGAAAATTAGTCAGTCATGATGGCGCATGCCTATAATCCCAGTTACTCGGGAGGCTAAGGTAGGAGAATTGCTTG"
"GL873599","6693284","6693349","chr1","100916857","100916922","15","94223573","TCACGTCTATAATCCTAGCACTCTGGGAGTCCTTGGCAGGTGGATCACCTGAGCTCAGGAGTTTGA","CATGCCTGTAATCCCAGCACCTTGGGAGGCCAAGGTGGGTGGATCACCTGAGGTCAGTAGTTTGAG"
"GL873600","991618","991705","chr15","13850109","13850195","15","12858491","GGCTGGGCGTGGTGGCTCACACCTGTTGTCCCAGCGCTGTGGGAGGCTGAGGCAGGTGGATCACCTGTGCTCAGAGGTTGAGACCAGC","GCCGGGCGCTGTGGCTCACACTTGTAATCCCAGCACTTTGGGAGGCTGAGGCAGGTGGATCACCTGAGGTCAGGAGTTAGAGACCAG"
"GL873600","8825981","8826014","chr16","43605817","43605844","11","34779836","AGTCTGGGGCAACAGAGCAAGACTCTGTCTCAAA","CAGTCTGGGTGACAGAGCAAGATTCCAT"
"GL873600","8826039","8826157","chr13","87428402","87428520","35","78602363","ATTAGCCTGGTGTGGTGGTATATGCCTTCCTGCCTGCTTGGGAGGCTGAGGCAGGAAGTATGCTTTAACTGTGGAGTCTGAGGTTGCTATGAGCTAGGTTGAGGCCATGGCACTCTAAA","TTAGCCGGGTGTGGTGGTGCACGCCTGTAATCCCAGCTACTCAGGAGGCTGAAGCAGGAGAGTTGCTTGAACCCAGGAGTTGGAGGTTGCAGTGAGCTGAGATCACGCCATTGCACTCC"
"GL873601","269289","269338","chr14","49279240","49279285","14","49009951","GACTGGGTGTGGTGGCTCACACCTTTAATCCTAACACCCTGGGAGGCTTA","GGCTGAGATGGTGGCACACACCTGTAATCCCAGCTACTTGGGAGGC"
"GL873601","269431","269678","chr1","184453273","184453521","76","184183842","AGAAGATCACTCAAGATCAGGAGTTTGAGAACAGCCTGAGCAAGACCCCCATCTTTACTAAAAATGGAAAAGTTTTTACCCAGGCATGGTAGTGCGTGCCTGTATCCCATCTACTCCGGAGGCTGATAGGAGGATTGCTTCAACCAAGGAGTTTGAGGTTCCAGAGACTTAAGATGACACAACTGCATTTTACCCAGTGTGACACAGCGAGACTCTTTCAGAAGAATTTTTAAAAGGAAAAAAAAGAA","GGTCAGATCACCTGAGGTCAGGAGTTTGAGACCAGCCTGACCAACATGGTAAAACCCCATCTCTGCTAAAAATACAAAAAATTAGCCAGGCATGGTGGTGAACGCCTGTAATCCTAGCTACTCAGGAGGCAAAGACAGGAGAATCGCTTGAATCTGGAAGGTGGAGGTTGCAATGAGCCAAGATGACGCCACTGCACTCCAACCTGGGTGACAGAGGAAGACTCCATCAAAAAAAAAAAAAAAAAAAAA"
"GL873601","1397978","1398117","chr16","24839455","24839591","34","23441477","GCCTATAATCCTAGCACTCTGGAAGGCTGAGGCAGGAAGATCACTAGAGCTTGGGAGTTTGAGATTGCTGTGAGGGAGACTGACTCCATGGCACTCTAGCCTGAGGCAACAGAGTAAGACTCCATCTCAAAAAAAAAAAA","CTCTAACTCCAGCTACTCAGGAGGCTGAAGCAGGAAAATCACTTGAACCTGGGAGGTGGAGGTTACAGTGAGCCAAGATCACACCATTGCACTCCAGCCTGAGCGACAGAGCGAGACTCTGTCTCAAAATAAATAAA"
"GL873601","4065502","4065590","chr11","108711352","108711444","19","104645850","GCTGGATGTGGTGGCTCTCACCTATAATCCTAGCACTCTGGGAGGTCAAAACAGGTGGATCACCTGAGCTCAGGAGCAAGAACACCAGC","GTCAGGGGTGGTGGCTCACGCCTGTAATCCCAGCACTTTGGGAGGCCAAGGCAGGTGGATCGCCTGAGCTCAGGAGTTCAAGACCAGCCTTGC"
"GL873601","8241370","8241465","chrY","9469734","9469829","34","1228364","AAAAAAGGTGGAGATGAGCCATGCGCAGTGGTGTAGGCCTGTAATCCCAGCCCTTGGGAGGCCAAAATGGTGGATTGCCTGAAGCAGAGCAAGACC","AAAGTACAAAGAGTCTGGGTACAGTGGCCCAAGCCTGTAATCCCAGCAGTTTGGGAGGACAAGATGGGTAGATCACCTGACATCATGAATTAGAGA"
"GL873569","7519122","7519191","chrX","79016364","79016431","16","71497242","TTGGCCAGGCATGGTCGCTCAGGCTGTAATACCAGCTACTTGGGAAGCTGAAGCAGGAGGATCACTTGAA","TTGGCCAGGCACGGTGGCTCATGCTTATAATCCCAGCTACTCGTGAGGCTGAGGCAGGGGAATCGCTT"
"GL873569","7989158","7989286","chr8","41505677","41505810","35","33516519","AGTCCCACCTATTTGGAAGGCTGAGGCAAGAGGATCACTTGAACTCAGCAGTTTGACATTGCTATGAGTTAGATTGACTCCATGGCACTCTAGCCCAGGCAACAGAGCAAGACTCCGTCTCAAAACAAA","TAATACCAGCTACGTGGGAGGCTGAGGCAGGAGAATCACTTGAACCCGGGAGGTGGAGGTTGCAGTGAGCTGAGATTGCACCGTTGCACTCTAACCTGGGCAACAAAAGCAAAACTCTGTCTCAAAAAAAAAAA"
"GL873569","7989575","7989702","chr1","62231025","62231129","47","54241450","GGCTGGGTAATGCAGTGGCTCACGCCTATAATCCTAGTGCTTTGAGAGGCCAAGAGTGAGACTCTGTGTACTAAAAATAGAAAAATTACCTAGGCATTCTGGTGGGCACCAGTAGTCCCACCTATTTG","GGCTGGGCATGGTGGCTCACGCCTATAATCCCAGCACTTTGGGAGGCCGAGGCAGGTGGATCACCTGAGATCAGGAGTTTGAGACCAGACTGGCCAACATGGTGA"
"GL873569","10034363","10034556","chr10","61268396","61268605","62","51234033","CAGCTTGAGCAAAAGTGAGCCCCTGTCTCTACTGAAAATAGAAAAAATTAGCCAGGCGTGGTGGCACACACTTATAGTCCCAGCCACTTAGGAGGCTGAGGCAGGAGTTTGAGGTTGACATAATCTAAGCTGATACCATAGCACTCTAGCCTGGGCAATAGAGTGAGACTCTGTCTCAAAGAAGAAATTTATCT","CCTGACCAATGGTGAAACCCTGTCTCTACCAAAAATACAAAATTTAGCTGGGCATGGGGGCACGCACCTGTAGTCCTAGCTACTCGGGAGGCTGAGACAGGAGAACTGCTTGAACTCGGGAGGCAGAGGTTGCAGTGAGCTGAGATCATGCCACTGCACTCTAGCCTGGGCAATAGAGTGAGACTCCGTCTCAAAAAAAAAAAAAAAAAA"
"GL873569","10034830","10034845","chr1","217667782","217667796","2","207632952","AAAAAAGAAGAAAAAA","AAGAAAAAGAAAAAA"
"GL873569","10203815","10203922","chr8","96374555","96374671","35","86170740","GCCAGGTGTAGTGGTTCACACCTATAATCCTAGCACTCTGGGAGCCTGAAGCAGGTAAATGGACTGAGCAAGAGTGAGACTTCCACCTCTATTGAAAATAGAAAAATT","GGCTAGGTATGGTGGCTGATGCCTATAATCCCAGAATTTTGGGAGGCCGAGGCAGGCAGATCATCTGAGGTCAGGAGTTTGAGACCAGTCCCGTCTCTACTAAAAATACAAAAATTA"
"GL873569","10204196","10204373","chr20","1304385","1304559","47","8899811","GAAAATAGAAAAATTAGCCAGGCATTATAGCAGGCACCAGTAATCCCAGTTACTTGGGAGGCTAAGGCAAAAGAATCTCTTGAGCCCAAGTTTGGGGTTGCTAGGAAGTAAAACACCACAGCACTATACCCAGAACAAGAGAGTGAAGACTCAGTCTCAAAAAGATAAATAAATAAAA","AAAAATACAAAAATTAGCCAGGCATGGTGGCGGGCGTCTGTAACTCCAGCTACTTGGGAGACTGAGGCAGGAGAATCGCTTGAACCCAGGAGGCAGAGGTTACAGGTGAAATCACACCACTGCACTCCAGCCTGGGCAACAGGGCAAGACTCTGTCTCAAAAAAAAAAAAAAAAA"
"GL873569","10473375","10473444","chr8","20660648","20660717","21","10187273","TGTAGTCCCAGCACTTTGGGAGGTTAAGGCAAGAGTAGCACCCAACATGAGGAGATCAAGACCAATCTGG","CTGTAGTCCCAGCACTTTGGGAGGCTGAGGCAGGTGGATCCTTTGAGGGCAGAACTTTAAGACCAGCCTG"
"GL873570","9287350","9287485","chr1","29437872","29437991","30","20150522","GGCCGGGCGTGGTGGCGCACGCCTGTAGTCCCAGCGCTATGGGAGGCCGAGGCGGGTGGATCACCTGTGCTCAGAGGTTCGAGACCAGCCAAGACCCCCCTGAGCCAAACGAGCCAGAGTGAGACCCCGTCTCTAC","GGCCGGGCGTGGTGGCTCACGCCTGTAATCCCAACATTTTGGGAGGCCAAGGCGGGTGGATCACCTGAGGTCAGAAGTTCGAGACCAACCTGGCCAACATGGTGAAACCCCTGTCTCTAC"
"GL873571","3669989","3670207","chr4","116777080","116777297","60","113107091","AGACCAGCCTGAGGAAGAGCAAGATCCCATCTCTATTAAAAATAGAAAAATTAGCCAGGCATTCTGGTGGGCACCTGTAGTTCTAACCACCTGGGAGGCTAAGGCAAGAGGAACTCTTCAACCCAAGAGTTTGAGGTTGCTGAGAGCTAGGCTAAGGCTGCAGCACTCTAGCCTGGGCAACAGAGTGAGACTGTTTCTCAAAAACAAAAAACAAAAAAA","CGAGACCAGCCTGGTCAATATGGTGAAACCCCGTCCCTACTAAAAATACAAAAATTAGCCAGGCATGGTGGCAGGCACCTGTAGTCCCAGCTACTCGGAAGGCTGAGGCAGGAGAATCGCTTGAACCACAGAGGCAGAGGTTGCAGTGAGCCGAGACTGCACCACTGCACTCCAGCCTGGGCGACAGAGTGAGACTCAGTCTCAAAAAAAAAAAAAAA"
"GL873571","106134","106236","chr4","18143723","18143826","27","18037589","GGCCAGTCTCAGTGGCTCACACCTGTAATCCAGCATTCTGGGAGGCTGAAGCACACGGTCACCTGAGCTCAAAGGTTGGAGACCAGAGTGAGACCCCACCTCT","GGCCAGGCGCAGTGGCTCACTCCTGTAATCCCAGCACTTTGAGGCTGAGGCAGGCGGATCACCTGAGGTCAGGAGTTTGAGACCAGCCTGGCCGAAACCCCATC"
"GL873571","3670496","3670589","chr7","50468399","50468491","15","46797903","GGGCAGGCATGGTGGCTCACACCTGTAATTCTAGCACTCTTGGAGGCTGAGGCAGGAAAATGGCTTGAGGTCAGGAGTTCAAGACCAGCCTGAG","GGCCAGTCATGGTTGCTCACACCTGTAATACCAGCACTTTGGGAGGCCGAGGCAGGCGAATCACCTGAAGTCAGGAGTTCAAGACCAGCCTGG"
"GL873571","4059090","4059389","chr7","52903696","52903994","88","48844606","GGCCAGGTGCAGTGGTTCACACTTATAATCCTAGCACTCTGGGAGGCCGAGGCGAGTGAAGTGCCTGAGCTCATGGGTTCAAGACCAACCTAAGCCAGAGACCCCTGACTCTTATAATAGCCTGGCATTGTGGTGGGCGCCAATATTTCCAGCTACTCTGAGGCTAAGGCAAGAGAATTGCTTGAGCCCAGGAGTTGGAGGTTTCTGTGAGCACTGACGCCGCAGCTCTCTACCAAGGGCAACAAAGACTCTGTCTCAAAAAATAAATAAATAAATAAATAACAGAATGAAAATGAAAAA","GGCCGGGTGCGGTGGTTCACGCCTGTAATCCCACCACTTTGGGAGGCTGAGGCAGGCAGGTCACCTGAGGTCAGGAGTTCCAGACCAGCCTGGCCAACATGGTGAAACCTTGTCTCGGCTATTAGCCTGGCATGGTGGTGCGTGCCCATAATCCCAGCTACTCAGGAGGCTGAGGCAGGAGAATCGCTTGAACCCAGAAGGTGGAGGTTGCAGTGAGCCAAGATAGCACCACTGCAACTCCAGTCTGGGCAACAGAATGAGACTCTGTCTCAAAAAAAAAAAACAAAAAACAAAAAGAA"
"GL873571","4209418","4209704","chr11","32517699","32517985","80","28308281","GGCTTGGCAAGGTGGCTTACACCTCAAATCCTAGCACTGTGGGAGACTGAGGCAGGTGGATTGTTTGAGCTCAGGAGGTCAAGATAGAGAGCAAGAGCAAGTCTCTGTCTCTACTAAAAATAGAAAAGAACTACTTCCCGGGGGTCATGGCAGTAGCCTGTAATCCCAGTTACTAGGTAGAATGAGGCAAGAGGATCTGTTGAAGCCAAGAGACTGAGGTTGTTATGAGCATGCCACAGCACTCTACCCAGGGTGACAGAATGAGACTCTGTTGAAAGAAAAAAAGA","GGCCGGGTGCAGTGGCTCACACCTGTAATCCCAGCACTTTGGGAGGCTGAGGCGGGTGGATCACCTGAGGTCAGGAGTTCAAGACCAGCCTGACAAACATAGTGAAACCCTGTCTCTACTGAAAATACAAAATTAGCCAGGTGTGGTGGCGCATGCCTGTAATCCCAGCTACTCGGGAGGCTGAGGCAGGAGAATTGCTTGAATCCAGGAGGTGGAGGTTGTGTGATCACACCACTGCACTCCAGCCTGGGCGACAGAGTGAGACTCTGTCTCAAAAAAAAAAGAAA"
"GL873571","4209985","4210154","chr3","175781758","175781928","60","171571773","GAAAGAAATGAAAAGAAAGAAGTTAGCTGGTTGTTGGGGTATGCTTCTATAGTCCCACCTACTCAGAAAGCTGAAATCTGGAGTTTGGGGTTGTTGTAAGGTAGGCTGATGACATAGCACTGTAGCTTGGGCAAGAGAGTGTGACTTTGTCTCAAAAAAAATTAAAACAA","ATTAAAAACACAAAGATTAGCCAGGTGTGATGGCACACAACTGTAATCCCAACTACTCAGGAGAATCGCTTGAACCTGGGAGATAGGGTTTGCAGTGAGCCAAGATTGTGCCACTGCACTCCAGCCTGGGTGACAGAGTGAGACTCTGTCTCCAAAAAAAAAAAAAAAAAA"
"GL873571","4210444","4210570","chr17","16655655","16655789","35","12445211","GCCAGGCAGATGGCTCACACTTCATCCTAGCCCTCTGGAAGGCTGAGGCAGGCTAATTTTTTGAGGTTAGGAGTTTGAGACCAGCCTGAGGAAGAGACCCATCTCTACTTTAAAAAATAAATGGAAA","GCCAGGCATGGTGGCTCACACCTGTAATCCTAGCACTTTGGGAGACTGAGGCGGGTGAATCACCTGAGGTCAGGAGTTTGAGACCAGCCTGACCAGTATGGTGAAACCCAGTCTCTACTAAAAATACAGAAATTA"
"GL873571","4391733","4391878","chr11","33723808","33723943","46","29332075","AACTTAGCTGGGAATGGTGGCTCAAGCCTGTAATCCTAGCACTCTGGGAGGCTCAGGTGGGAGGATCACTTGAGGTTGCTGTGAGCTTGGCTGATGCCAGGACACTCTAGTGTGGGCAAGAGAGTGAGACTCCGCCTCAACAACAA","GCCGGGTGCAGTGGCTCATACCTGTAATCCCAGCACTTTGGGAGGCTGAGGTAGGCGGATCACGAGGTCAGGAGCTGAGATGGCGCCACTGCACCCCAGCCTGGGTGACAGAGCAAGACTCTGTCTCAAAAAAAAA"
"GL873571","6307773","6307841","chr9","62429628","62429694","22","56121855","CTGGGTGTGGTGGCATTGCACCTGTAATCCTAGCTACTTGGAAATCTTAAGCCCAGGAGTTGAAGACTG","CCCAGCATGGTGGTGCATACCTATAATCTCAGCTACTTGGAGGCTTGAGCTCAGAAGTTTGAGACCG"
"GL873571","6496217","6496306","chr1","27257765","27257856","27","20761548","GCAGGGTGTGTTGACCCACACCCACAATTCCAGGACTCTGGGGGGCCAGGGATGGTGGGTTCCCTCAGATCAGGAGCTCCTTACCAGCCT","GACTGGGCATGATGGCTCAAATCTGTAATTCCAGCACTTTGGGAGGCCGAGGTGGGTGGATTGCCTGAGATCAGGAGTTCAAGACCAGCCTG"
"GL873571","6499738","6499903","chr1","38976375","38976555","47","32476637","AAAATAACATGAATTGACTAGGCGAGGTGGCTCACATCTCTAATCCTAGCACTCTGGGAGGCTGAGGCAGGAGAATTGCATGAGGTTGCTGTGAGCTATGATGATACCACGGCATTCTAATCAGGGTGACAGAGTGAGATTCTGTCTTAAAACAAACAAACAAAAA","AAAATAAATAAATTAGCAGGGCCTGGTGGCGCACACCTGTAATCCCAGCTACTTGGGAAGCTGAGGCAGGAGAACCCACTTGAACCTGGGAGCCGGAGGTTGCAGTGAGCTGAGATGGCACCACTGCACTCCAGACTGCGTGACAGAGTGAGACTCCGTCTCAAAAACAAACAAACAAAAA"
"GL873571","11399575","11399872","chr15","109458692","109458994","79","98059117","CAGTGGCTCACACCTGTAAATCTAACACTCTGGGAGGCCAAGGTGGGTGGATCCCTTGAGCTCAGGAATTTGATACCAGCCTGAGCAAGAGTGAGACCTTGTCTCTACTAATAATAGAAAAATAGCCCGTGTTGTGGCACTTGTCCCAACCACTGGGGAGGCTTTAGGCGGGAGGATTACTTGAATTGGGAGTTTGATATTGCTGTGAGCTGGGCTGATGCCTTGGCATTCTAGCTTGGGTAACAGCGTAAGACTCCGTCTCAAATAAATAAATAAATAAATAAAAAGAAAAAAAGAA","GTGGCTCACACCTGTAATCTCAGCACTTTGGGAGACCGAGGCAGGTGGATCACCTGAGGTCGGGAGTTTGAGACCAGCCTGACCAACGTGGAGAAACCCCGTCTCTACTAACAATACAAAATCAGCTGGGCGTGGTGGTGCATGCTTGTAATCCCAGCTACTCGGGAGGCTGAGGTAGGAGAATCGCTTGAACCTGGGAGGTGGAGGTTGCGGTGAGCCGAGATCGAGCCACTGCACTCCAGCCTGGGTGACAGAGCAAGACTCCATCTCAAAAAAAAAAAAAAAAAAAAAAAAAAAAAAAAA"
"GL873572","114760","114841","chr8","26280134","26280211","16","26165374","GGCCAGGCATGGCGGCTCTTCCCTGTAATCCTAGCACTCTGGGAGGGCGAGGCAGGCAGATCACCTAGGCTAGGGTGAGATC","GGCCAGGAATGGTGGCTCATGCCTGTAATCCCAGCACTTTGGGAGGCTGAGGCAGGCAGATCACCTGAGGTCAGGAGT"
"GL873572","9421791","9421892","chr11","8089184","8089269","35","1332607","TACTAAATATATAGCAAGGCCAGGCACAGTGGTTCATGGCTGTAATCCCAGTACTCTGGGAGGCCTAGTCAGAGTTGACCTGAGATCAGGCTAGAAGCCTGG","ATAAAAATAATTGGAGGCCAGGCACGGTGGCTCATGCTTGTAATTCTAGCAATTTGGGAGGCTGACGCGGGTGAGATCATACTGAG"
"GL873572","11052834","11053035","chr14","11857478","11857657","65","804644","TCCACAAAGAAAGCAGAAGTGTGGCCGGGTGGTAGCTCAAGGCAGGAATCCCAGCACTCTGGGAGCTGGGAGGTGGGGGAGGATCCCTTGAGATCAGGAGTTGGAGGGCACAGTGAGCCTGGGGGAGGCCACTGTCTCTGTACTCTAGCAGGGAGACAGAGCAAGACTGCCCATTCAAAGAAAAACAACAAACAAAACAAAA","TACAAAAATTAGCTGGGCACGGTGCCACAAGCCTGTAATCCCAGCTACTCGGGAGGCTGGGCAGGGGAATAGCTTGAACCCAGAGGTGGAGGTTGCAGTGAGCCAAGATCAAGCCACAGCACTCCAGCCTGGGTGACAGAGCAAGACTCCATCTCAAAAAAAAAAAAAAAAAAAAAAAAA"
"GL873573","2564195","2564244","chr1","109985445","109985491","12","107421250","TACAAAAATTAGGCTGGGCTTGGTGGTTCACGCCTATAATCCTAGCACTT","ACTAAAATTAGCTGGGCATGGTGGTGCATGCCTGTAATTCCAGCTAC"
"GL873573","7423371","7423533","chr2","202783328","202783513","56","195359957","GGTGGCTCACACCTGTAATCCCAGCACTCTGGGAGCCCTGGTGGCTCATGTCTATAATCCTAGTACTCTGGGAGACCATGGTGGCTCATGTCTATAATCCTAGTACTCTGGGAGCCATGGTGGCTCACGCCTATAATCCTAGTACTCTGGGAGACCATGGTGG","GGCTGAGGCGCGGGGGCTCACGCCTGTAATCCCAGCACTGTGGGAGGCCGAGGCGGGTGGATCACGCCTGTAATCCCAGCACTGTGGGAGGCCAAGGCGGGTGGATCACGCCTGTAATCCCAGCACTGTGGGAGGCCGAGGCGGGTGGATCACGCCTGTAATCCCAGCACTGTGGGAGGCTGAGGC"
"GL873573","9657648","9657710","chr19","10207852","10207913","10","550204","TAAAAATAAAAAATTTAGCTGGATGTGGTGGCTCACACCTGTAATCCTAGCACTCTGGGAGAC","TAAAAATACAAAATTAGCTGGGTGTGGTGGCACACACCTGTAATCCCAGCTACTCAAGAGGC"
"GL873574","1624662","1624783","chr9","814961","815079","36","809701","GACTGGGTGGGTTGGATCATGCCTGGAATCCTAGCACCCTGGGAGGCCAAGGTGAAAGGATTGCTTGAGGTTAGGAGTTCCAGAAATGTAGCAGTCATGGTGACTTCATCCTTCTCTACCAA","GGCTGGGTGCTTTGATTCATGCCTGTAATCCCAGCACTCTGGGAGGCCGAGGCAGGTGGATCACCTGAGGTTAGGAGTTCGAGACCAGCTTGGCTAACATGGTGAAACCTCGTCTCTAC"
"GL873574","4459477","4459612","chr1","29437872","29437991","29","24978395","GGCCGGGCGTGGTGGCGCACGCCTGTAGTCCCAGCGCTATGGGAGGCCGAGGCGGGTGGATCACCTGAGCTCAGAGGTTCGAGACCAGCCAAGACCCCCCTGAGCCAAACGAGCCAGAGTGAGACCCCGTCTCTAC","GGCCGGGCGTGGTGGCTCACGCCTGTAATCCCAACATTTTGGGAGGCCAAGGCGGGTGGATCACCTGAGGTCAGAAGTTCGAGACCAACCTGGCCAACATGGTGAAACCCCTGTCTCTAC"
"GL873574","4681987","4682216","chr6","153082888","153083127","73","148400901","GGGTGCGGTGGCTCAGACCTATAATCCCAGCACTCTGAGAGGCCGAAGTGGGTGGATCACCTGAGCTCAGGAATTTGAGACCAGCCGTCTCTAAAAATAGCTGAGTGTTGTGGCAGTGGCTGTAAGTCCCAGCTGTTTGGAAAGCTGAAGCAAGGGAATCACTTGAACCCAAGAGTTTGAGGTTGCTGTGATGACAAAGTGAGACTCTATCTCAAAAAAAAAAAAAAAAA","GGCCGTGCGCGGCGGCTCACGCCTGTAATCCCAGCACTTTGGGAGGCTGAGGTGGGTGGATCACCTGAGGTCAGGAGTTTGAGACCAGCCCGACCAGAAATTAGATGGGTGTGGTGGTGCGCTCCTGCAGCCCCAGCTACTTAAGAGGCTGAGGCAGGGTAATCACTTGAACCCGGGAGGCGGAGGTTGCAGTGAGCCGAGCTCACGCCACTGCACTCCAGCCTGGGTAACAGAGCGAGA"
"GL873574","4709916","4710039","chr19","13152422","13152536","46","8442506","AAAAATAGAAAAACTAGCCAAGCATGGTGGTGCACCCCCTATAGTCTGAGCTCCTCAGCGGGCTGAAGCAAAAGGACGGCTGGAGCCCTGGAGTTTGAGGTTGCTGTGAGGCAAGGTGATGCCA","ACACATAAATTAGCCAGACATGATGGTGAGTATCTGTAATTCCAGCTCCTTGGGGGGCTGAGGCGGGAGAATTGCTTGAACCTGGGAGGCAGAGATTGCAGTGAGCCAAGATCGC"
"GL873574","6353839","6353913","chr5","25768079","25768163","22","19414240","AAAAATATAGCAAGGCCAGGCATGGTGGCTCACACCTATAATCCCAGTACTTGGGAGCTGGAATTTGAACCTAGG","AAAAAACTCAAACAAGGCTGGGCGTGGTGGCTCACACCTGTAATCCCAGCACTTTGGGAGGCTGAGGTGGGTGGATCACCTGAGG"
"GL873574","6533061","6533332","chr5","85182161","85182439","81","78649100","GGCTGGGCGAGGTGGCTTACACCTATAATCCTAGTACTCTGGGAGGCCAAGGTGGGTGGATTGCCTGAGCGCACAGTTTCAAGACCAGCTGGAGCCAGAGAGAGAGAGAGAGACCCTGCCTCTAAAAATAGCCAGGCATTGTGGCAGGCACCTGTAGTCCCAGCTACTTGGCAGGCGGAGGTATGAGAATCGCTAGAGGTTGCTGTTAGCTATGATGCCATAGCACTCTACCAAGGGCGACAAAGTGAAACTCTGCCTCAAAAAAAAGAAGA","GCCAGGCGTGGTGACTCAAGCCTGTAATCCTAGCACTTTGGGAGGCCAAGGTGGGCGGATTGCCTGAGCTCAAGAGTTTGAGACCAGCCTGGGCAACACGGTGAAACCCAATCCCTACTAAATACAAAAAAAATTAGCCGGGTGTGGTGGTGTGAACCTGTAGTCCCAGCTACTCGGGAGGCTGAGGCAGGAGAAGGCAGAAGTTGCAGTGAGCCGAGATCACACCACTGCACTCCAGCCTGAGTGACAGAGCAAAACTCTTTCTCAAAAAAAAAAAAA"
"GL873574","6643746","6643907","chr2","92627944","92628105","46","85984198","AAATAGCCAGGCGTTGTGGCAGGCACCTATAGTCCCAGCTACTTGGGAGGCTGAGGCAAGAGAATCACTTAAGCCCAAGTGACAGAGGTTGCCAGGGCACTCTACGTAGGCAACAGAGTGAGACTCTATCTAAGAAAGAAGGAAGGAAGGAAGGAGAAAGAA","TTAGCCGAGCATTGTGGTGCGCGCCTGTAGTCCCAGCTACATGGGAGGCTGAGGCAGGAGAACACCTGAACCCAGGATGTGAGCTGAGTCGCGCCATTGCACTCCAGCCTGGGCAACAGAGTGAGACTCCATCTCAAAAATAAAATAAAATAAAATAAAAAA"
"GL873574","6644163","6644274","chr1","128607504","128607619","20","121963341","CTGTAATCCTAGCACTTGGGAGGCTGAGGCAGGTGGATCACCTGAGTTCAGGAGTTCAAGACCAGCCTAAACAAGAGTGAGACCCTATCTCTACTAAAAATAGAAAAAATAT","GCCTGTAATCCAAGCACTTTGGGAGGCTGAGGCGGGTGGATCACCTGAGGTCAGGTGTTCGAGACCAGCCTGGCCAACGTGGTGAAACCCCAACTCTACTAAAAATACAAAAATTA"
"GL873574","8511822","8512127","chr1","23439759","23440073","84","14927937","GGTGGCTGGTGCCTGTAATCCTAGCACTCTGGGAGACTGAGGCAGGTGGATCACTTGAAATCAGGAGTTTGAGATCAACCTGAGCAAGAGATCTTGTCTCTCCTAAAGATAGAAAAACTAGCTGGGATTTGTGGTGGACACCTGTAATTTCAGCTACTCAGGAAGCTAAGGCAAGAGCATTGCTTAAAACCAGGAGTTTGAAGTTGATGTGAGCTAGGATGTCAGGGCAGGTTACCCAGGGTGACAGAGTGAGACTCTGTGTCAAAATAAACAAACAAACAAACAAACAAAACAAAATAAAATAAA","GGCTGGACATGGTGACTCACGCTTGTAATCCCAACACTTTGGGAGGCTGAAGCAGGCAGATCACCTGAGGTCAGGAGTTTGAGACCAGCCTGACCAACATGGTGAAACCTTGTCTCTACTAAAAATACAAAAATTAGCTGGGAGCAGTGGTGCACACCTGTAATCCCAGCTACTCGGCAAGCTGAGGCAAGATAATTTTTTAAACCTGGGAGGTGGAGGTTGCAGTGAGCCAAGATCGTGCCACTGTACTCCAACCTGGGAGACAGAGCAAGACTCTGTCTCAAAAAAAAAAAAAAAAAAAAAAAAAAAAAAAAA"
"GL873575","2107336","2107519","chr4","38052972","38053149","54","35945636","TCAATTAAAAACTTTTTAAAATGAGGCTGAGCATGGTGGTTCACACCTGTAATCCCAGCACTTTGGGAGGCCGAGGCAGGAGGATCACCTGATCCCAGGAGTCCAAGCCTACAGTGAGCCGTGATAATACCACTGCACTTCAGCCCAAAGCCTCAAAAAGAAAAAAAAAAAAGGATAGACAAGA","TATATATATATATATTATTTTGGGGGGGCATGGTGGTGCACACCTGTAATCCCAGCTACTCGGGAGGCTGAGGCAGGAGAATTGCTTGAGCCCGGGAGGCAAAGGTTGCATTGAGCTGAGATCACACCACTGCACTCCAGCCTGGCGACAGAGTCTCAAAAAAAAGAAAAAATAAAAA"
"GL873575","5831824","5831959","chr1","29437872","29437991","28","23606048","GGCCGGGCGTGGTGGCGCACGCCTGTAGTCCCAGCGCTATGGGAGGCCAAGGCGGGTGGATCACCTGAGCTCAGAGGTTCGAGACCAGCCAAGACCCCCCTGAGCCAAACGAGCCAGAGTGAGACCCCGTCTCTAC","GGCCGGGCGTGGTGGCTCACGCCTGTAATCCCAACATTTTGGGAGGCCAAGGCGGGTGGATCACCTGAGGTCAGAAGTTCGAGACCAACCTGGCCAACATGGTGAAACCCCTGTCTCTAC"
"GL873575","7451097","7451208","chr3","122814630","122814743","22","115363533","GGCCAGGTGTGGTGGCTCACACCTGTTATCCTAGCACTCTGAGAGGCCACAGCAGCTGGATCACTTGAGCTCAGGAGTTCAAGACCAGTCTGAGCAAGAGCAAGACCTCACC","GGCTGGGTGTGGTGGCTCATGCCTGTAATCCCAGCACTTTGAAAGGCCAAGGCAGATGGATCACTTGAGGTCAGGAGTTCCAGACCAGCCTGGCCAACATGGCAAAACCCCATC"
"GL873575","7451277","7451445","chr6","58863249","58863409","41","51411972","AAAAATTCAGCCAGCCACAGTGGAAGTGGATGCCTGCCATCACAGCTACTCTGGGGGCTGGGGCAAGAGAATTGCTTGATCCCAGGAGTCTGAGGTTGCTGTGACCTAGGCTGACACCACAGCACTCTACCCAGGGTGACAGAGTGAGGCTGTGTTTAAAAAAAAAAAA","TTAGCCAGGCATGGTGGCACATGCCAGTAATCCCAGCTACTCAGGAGGATGAGGCAGGAGAATCGCTTGAACCCAGGAGGCAGAGGTTGCAGTGAGCTGAGATTGCGCCACAGCACTCTACCCTGGGTGACAGAAGGAGACTCTGTCTCAAAAAAAAAAAA"
"GL873576","1765109","1765185","chrX","53921180","53921256","12","52156071","GGCCAGGTGCAGTGGCTCATATCTGTAATCCTAGCACCCTGGGAGGCCAAGGTAGGCGAATCACCTGAGGCCAGGAG","GGCCAGGTGCAGTGGCTCACGCCTGTAATCCCAGCACTTTGGGAGGCCGAGGTGGGCGGATCACTTTAGGTCAGGAG"
"GL873576","2711577","2711895","chr7","6620384","6620702","85","3908807","GGTCGAGCTTGGTGGCTCATGCTTGTAATCCTAGCACTCTGGGAGGCCAAGGCAGGTAAGTTGCCCTGAGCTCATAGGTTCCAGATCAGCATGAGCCAGAGTGAGACCCTGTCTCTACCAAAAAATAGCCCGGCATTCTGGCAGGTGCCTGTAATCCCAGCTGCTTGGGAGGCTGAGGCTAGAGAATCACTTAAACCCAAGGGTTAGTGGAGGTTGCTGTGAGCTATGATTCCACCGTACTCTACTGAGGGCCACAAAGTGAGACTCTGTCTCCATAAAAAAGAAAGAAAGAAAGAAAGAAAAATAAAATAAAATAAAA","GGCCAGGCACAGTGGCTCATGTCTGTAATCCCAGCACTTTGGGAGGCCGAGGCGGGTGGATTACCTGAGGTCAGGAGTTCTAGACCAGCCTGGCCAACAAGGCGAAACCCTGTCTCTACTAAAAATACAAAAAATTAGCTGGGCGTTTTGGCACATGCCTGTAATCCCAGCTACTTGGGAGGCTGAGGCAGGAGAATTGCTTGAACTGGGGAAGTGGAGGTTGCAGTGAGCTGAGATCACACCATTGCACGCCTGAGCAACAGAGCGAGACTCTGTCTCAAAAAAAAAAAAAAAAAAAAAAAAGAAAAGAAAAAGAAAA"
"GL873576","4782520","4782652","chr9","61136941","61137074","22","56354421","CCAGGCACGGTGGCTCACCCTTGTAACCCTAGTACTTTGGGAGGCTGAGGTGGGAGGATCCCTTGAGGTCAGGAGTTCAAGACCAGCCTGAACAACAGTGAGACCCCCGTCTCTACTAAAAAATAGAAAAGTT","GCCAGGCACGGTGGCTCACGCCTGTAATCCCAGCACTTTGGGAGGCTGAAGCGGGCGGATCACCTGAGGTCAGGAGTTCAAGACCAGCCTGGGCACCATGATGAAACCCCGTCTCTATTAAAAATACAAAAATT"
"GL873576","4782930","4783078","chr7","57521645","57521803","40","52738715","AGTTAGTCTGGTGTCATGGTGGGTGCCTGTAGTCCCAGCTGCTTGGGAGGCTGAGGCAAGAGAATCACTTGAGCCCAGGAGTTGGAGGTTGCTATGAGCGAGGCTGTAGCCTAGGCAACAGAATGAGACTTTGCCTCAAAAAAATAAAA","TTAGCTGGGCATGGTGGCGCATGCCTGTAGTCCCAGCTACTTGGGAAGCTGAGGCAGGAGAATCACTTGAACCTGGGAGGTGGAGGTTGCAGTGAGCTGAGATCGCACCGCTACACGCCAGCCTGAGCAACAGAGAGAGACTCTGTCTCAAAAGAAAAA"
"GL873576","7828709","7828723","chr5","101042981","101042996","1","93214272","TAAATAAATAAAAAA","TAAATAAATAAATAAA"
"GL873576","7828960","7829230","chr13","49045537","49045844","89","41216577","GCCGGCTGCAGTGGCTATAATCCAAGTACCCTGGGAGGCTTAGGTGGATGGATCACTTGAGCTCAGAAGTTCAAGACCAGCCTCAGCAAGAGGTAGACCTTGCCTCTATTAAANNNNNNNNNNNNNNNNNNNNNNNNNNNNNNNNNNNNNNNNNNNNNNNNNNNNNNNNNNNNNNNNNNNNNNNNNNNNAGTTTGAGGTTGCTGTGAGCTATGATGAAGCCAGGGCATTCTACCCAGGGTGACAGAGTAACTCTTAAAAAAAACTAAACAA","GGCCAGGCAGAGTGGCTCATGCCTGTAATTCCAGCAATTTGGGAGGCCTAGGCAGGCAGATTACCTGAGGTCAGGAGTTTGAGACCAGCCTGGCCAACATGGTGAAACCCCGTCTCTTCTANNNNNNNNNNNNNNNNNNNNNNNNNNNNNNNNNNNNNNNNNNNNNNNNNNNNNNNNNNNNNNNNNNNNNNNNNNNNNNGGAGATAATAGCTTTTGTAGAACGAAGCGATGCAACAGCCAGATCGCCGCCACCACCCTTAGGTCCTGGCGACAGAGTGAGATCCATCTTAAAAAAAAAAAAAAAAAAA"
"GL873576","10622840","10623093","chr7","60266447","60266705","74","49643607","GCTGGGTATGGTGGTTCACACCTATAATCCTAGCACTCTGGGAGGCTGAGGTGGGAGGATTGGTGGAGCTCAGGAGCTCATGAGGTGCCAAATCACTGGTGCCACACACCTGTATTCCCAGCTACTGAGGAGGCTGAGGCAGGAGGATCAGGTAAGCCCAGGAAGTTTGAGGTTGTAGTGAGTTAGGATGATTGAACTCTGCCTTGAGAGACAGAGCAAGATCCTCCTTCCTCCTAAGCAAACAAACAAATAAA","GGCTGGGTGCAGTGGCTCACACCTGTAATCCTAGCACTTTGGGAGGCTGAGGCGGGAAAATTGCCTGAGCTCAGGAGTTCAAGGACAGCCTAGGCAACATAGCATGGTGGTGCACGCCTGTATTCCCTGCTACTTGGGAGGCTGAGGCACAAGAATTGCTTGAATCCGGGAAGTGGAGGTTGCAGTGAGCCATTGTGGCACTGCTCTCCAGTCTGGGTGACAGAGCAAGACTCCATCTCAAAAAAAAAAAAAAAAAAAA"
"GL873576","10819939","10820007","chrX","67133632","67133707","21","56313693","AGGTTGCAGTGAAATTGTACCATTCCAATGAAGCCTGGGGGACAGAGTGAGATTCTCTCAAAATAAAAA","GGAGGTTGCAGTGAACCGAGATCGTGCCACTGCACTCCAGCCTGAGCGACAGAGTGAAACTTCGTCTCAAAAAAAA"
"GL873576","10920306","10920363","chr3","48261745","48261808","16","37341439","GCTGGACCTTGTAGAGAGTGCCTGTAATCCCAGCTACATGGGGGGCAAGAGAATTGCT","GCTGGGCATGGTGGTGCATGCCTGTGATCCCAGCTACTCAGGAGGCTGAGGCAGGAGAATTGCT"
"GL873576","10920398","10920529","chr10","67341428","67341546","30","56421030","GGCCAGGCGTGGTGGCTCACGCCTGTTGTCCCAGCACTGTGGGAGGCCGAGGTGGGTGGATTGCCTGAGCTCAGAGGAGTCCGGAAGACCAGCATGAGGCAGAGTGAGCCAGAGTAAGATCCTGTCTCTACC","GGCTGGGTGTAGTGGCTCATGCCTGTAATCCCAGCACTTTAGGAGGCCAAGGTGGATGGATTGCCTGAGCTCAGGAGTTCGAGACCACCCTGGGCAACAAGCCAAAACCCTGTCTCTAC"
"GL873577","515809","515961","chr7","137660778","137660931","43","137144969","AGCTGGGCATGGTGGCTCATGCCTATAACCCTAGCGTGCTAGGAGATTGCTTGTCAGGAGACTGAGGTTGCAGGAAACTGTGATGATGGCACTGCACTCTACCCAGGGTGACAGAGCAGGACTCTGCCTCAAAAAAAAAAAAAAAAATAGAAA","TTAGCTGGGCATGGTGGCGCATGCCTATAATCCCAGCTACTTGGGAGGCTGAGGCAAGAGAATCGCTTGAACCGGGGAGGCAGAGGTTGCAGACTGCACTCCAGCCTGTGTGACAGAGTGGGACTCCGTCTCAAAAAAAAAAAAAAAAAAAAAA"
"GL873577","1633164","1633256","chrX","38269524","38269615","26","36636360","TCAGCCAGGCATGGTGGCACTTGCCTATAAACCCAGCTCCTTGGGAAGCTGAGCCGGGAGGATCCCTTGCACCCAGGAGCAACGGAAGGCAGT","AATTAGCCAGGCATGGTGGCACATGCCTATAATCCCAGCTACTCAGAAGGTTGAGGCAGGAGAATCACTTGAACCTGGGAGGCAGAGGTTGC"
"GL873577","3979502","3979560","chr20","68909283","68909346","13","64929781","GAGTTTGAGACCAGCCTGAGCAAGACCGAGACCCAGTCTCTACTAAAAATAGAAAAATT","GGAGTTCAAGACCAGCCTGACCAACATGGAGAAACCCTGTCTCTACTAAAAAATACAAAAATTA"
"GL873577","3979839","3980009","chr10","31403126","31403287","39","27423287","ATGAGCAGATTGTCTTGGTGGGCACCTGTAGTCCCAGCTATTGGAGGTGGGAGGCTGAAGCAGGAAAATCTCTTGAGCCCAGGAGTTTGAGGTTGCTGTGAGCTAGGCTGACACCACGGCACTCTAGTCAGGGCGTCAGAGTGAGACTCCGTCTCAAAAAAAAAAAAAAAA","TTAGCTGAGTGTGGTGGCGCACATCTGTACTCCCAGCTATTTGGGAGGCTGAGGCAGGAAAATCGCTTGAACCCAGGAGGTGGAGGTTGCAGTGAGCCAAGATCACACTACTGCACTCCAGCCTGGGTGACAGAGTGAGAATCCATCTCAAAAAAAAGAAAA"
"GL873577","6050882","6051080","chr1","153219820","153220007","59","147168938","GGCTGGGCGTTGTGACTCATGCCTGTAATCCCAGCACTCTAGGAGGCCGAGGTGGGTGGACTGCCTGAACTCAGAGGTTTAAGACCATCCTGAGCCGCAGTGAGCCAGAGCGAGACCCTGTCTCTACCAAAAAAAGCTGGGTGTTGTGGTGGGCGCCTATAGTCCTAGCTACTTGAGGCGCTAAGGGTAAAAAAATTGC","GGCCTGGCACAATGGCTCACGCCTGTAATCCTAGCACTTTGGGAGGCCGGGGTGGGTGGATCACCTGAGATCAGGAGTTTGAGACCAGCCTGGCCAACATGGTGAAACTCCTTCTCTACAAAAATTAGCCAGGTGTGGTGGTGGGTACCTGCAATCCCAGCTATTTGGGAGGCTGAGGCAGGAGAATC"
"GL873577","8463965","8464050","chr9","52134422","52134508","19","43670457","CTGGGTGCTATAGCTCACGCCTATAATCCTAGCACTCTGGGAGTTTGGGGCAAATGGATCACCTAGGCTCAGGAGTTTGATACCAG","GGCTGGGAGCAGTGACTCACGCCTATAATCCCAGCACTTTGGGAGGCTGAGGCAGATGGATCACCTGAAGTCAGGAGTTCGAGACCA"
"GL873577","9471486","9471613","chr16","5178790","5178910","46","4292696","TTAGCCAGGCATAGTAGCCTGTGTGTAGTCCTAGCTACTCAGGAGGCTGAGGTAGATGGGTCACTTGAGGTTGCAGAGATTATGGTAATGTCACTGTACTCTAGCCCTGGCAACAGAGCACAACCCTG","TTAGCCGAGCCTGGTGGCATAAACCTGTAATCCCAGCTACTCAGGAGGCTGAGGCAGGGGAATTGCTTGAACCTGAGAGGAGAAGGTTGCAGTGAGCCGAGATTGCACCATTGCACCCCAG"
"GL873577","9471875","9471998","chr7","17832200","17832315","36","8360325","GGCCAGGTGAAGCAGCTCATGGCTATAATCCTAGCAGTTTGGCAGGCCAAGGTGGGAGGACTGCTTGAGGTCAAGAGTTCAAGACCAACCCATCTTTGCGAAAAATTTAAAAATTACCTAGGCA","GCCAGGAGAGGTGGCTCATGCCTCTAATCCCAGCACTCTGGAAATCCAAGGTGGGTGGATCACCTGAGGTCAGGAATTCCAGACCAGTCTGGCCAATATAAAAAATTAGCCAGGCT"
"GL873577","9853150","9853170","chr3","85044647","85044667","3","75191497","AAACAAACAAACAAAAAAAGA","CAAACAAACAAACAAACAAAA"
"GL873577","9853206","9853473","chr7","130818682","130818963","67","120965476","GCTGGGCGCAGCGTCTCACTCCTGTAATCCCAGCACTTGGGAGGCCAAGGTGAGTGGATTGCCTGAGTTTACAGTTTCGAGACCAGCCTGAGCCAAAGCGAGACCCCCATCTCTAAAAAATAGCTGGGCATTGTGGTGGGCACCTGTAGTCCCAGCTACTTGGGAGGCTGAGGCAAGAGGATCGCTTGAACCTAAGAGTTTGAGGTTGCTGTGAGCTAAGGCTCCATGGCATTCTACCAAGGGTGACTAAGTGAGACTCTGTCTAAAA","GCCGGGCACAGTGGCTCACACCTGTAATCCCAGTACTTTGGGAGGCCAAGGTGGGTGGATCACCTGAGGTCAGGAGTTTGAGACCAGCCTGGCCAACATAGTGAAACTCTACTAAAAATACAAAAAAATAGCTAGGCATGGTGGTGCGCACCTGTAATCCCAGCTACTTGGGAGGCTGAGGCAGGAGAGTTGCTTGAACCCAGCGGGGTTGAGGTTGCAGTGAGTTAAGATCAAGCCACTGTGCTCCAGCCTGGATGACAGAGAGAGACTCCATCTCAAAAA"
"GL873577","10722415","10722478","chr10","12501471","12501539","23","1779056","AATAAAAAAATGCTGGGTACAGTAGTACATGCCTGTACTCTCATCTGGGGAAGCTGAGGCATGA","AAAGTAAAAAATTAGAGCTGGGCATGGTGGCACACACCTGTAATCCCAGTCACTAGGGATGCTGAGGCA"
"GL873578","463331","463568","chr10","28935382","28935620","93","28472051","CAGGTGCTTTGACCCACACCCTCAACTCTAGGACTTTGGACGCCCTGGCTGGGTGGGTCCTTTAAAGTCAGGAGCTTCTTATCAGTCTGGGCAAAAGTGAGACCCCATCTCTACCAAACAAAGAAAGAAATCAGCAGTATGTTGCAGTAGAGACTCACCAATACCTTCTTTCAAAGACCAAAGCTGGAAGGACACTAAAGACCATGATCTCATGGCCTCCCTGAGCCATGACAATGCC","CCAGGTGCAGTGGCTCATGCCTGCAAGCTCAGAACTTTGGGAGGCAGAGGTGAGCAGACTGCCTGAGTTCAGGAGTTCAAGACCAGCTGGGCAACATGGTGAGACCCTATCTCTACTAAAAATACAAATAATTAGCAGGGTGTGGTAGCACACACCTGTAGTCCAGCTACTCAGGAGGCTGAGGCAGGAGAATTGCTTGAACCCAGGAGGCAGAGTTTGCAGTGAGCCAGGACTGGGCC"
"GL873578","1143712","1143827","chr11","52824583","52824692","30","51680871","GGCTGGGTGTGGTGCCTCATGCCTGTAATCTAAGCCCTCTCCGAGGCTGAGGTGGGAGGATCCCTTGAGTTTAGGAGTTTGATTTTGAGACCAGCCTGATCAAGAGAGAGACCTCA","GGCCGGGTGTGGTGGCTCATGTCTGTAATCCCAGCACTTTGGGAGGCTGAGGTGGGTGGATACCCTGAGGTCGGGAGCTCGAGACCAGCCTGACCAACATGGAGAAACCC"
"GL873578","1144101","1144139","chr3","33494224","33494257","11","32350123","GAGAGAGACCTCATGTCTACTAAAATAAATAAATATATA","GTGAAACCCGTCTCTACTAAAAATACAAAAATTA"
"GL873578","1144175","1144343","chr12","119519961","119520131","41","118375786","ATTATCCAGGCCTTCTGGTGGATGCCTGTAGTCCTAGCTACTAGAAAAGCTGGAGCAGAATCACTTGACCCAGGAGCTGGAGGTTGCAGGGAGCTAGGCTGATGCCACAGAATTCTAGCCTGAGGCAAAAGAATTGAGCCACTGTCTCAAAAAGGAACAAAAAAGAAAA","ATTAGCCAGGTGTGGTGGCATGCACTTGTAATCCCAGCTACTAAGAAGGCTGAGGCAGGAGGATCACTTGAACCCGGGAGGTGGAGGTTGCAGTGAGCCAAGATCATGCCACTGCACTCCAGCCTGGGCAACAGAGTAAGACTCTGTCTCAAAAAAAAAAAAAAAAAAAAA"
"GL873578","4593962","4594035","chr16","68825055","68825124","22","64231093","AGCTGGGTACAGTGGCTCACATATAATCCCAGTGACTCAGGAGGCTAAGACAGGAGGATTACTAGGACCTGAGA","GGCTGGGCACAGTGGCTCAGACCTGTAATCTCAGTACTTTGGGTGGCTGAGGCAGGTGGATCACCTGAGG"
"GL873578","6158845","6158972","chr3","500432","500562","24","5658413","GACATGGTGGCTCACACCTGTAATCCTAGCCCTCTGGGAGGCTGAGGCAGGTGGATCACTTGAGTTCAGGAATTCAAGACCAGCTTGAGTGAGAGCAAGACCCTGTCTCTACTAAAAATAGAAAAATT","GCACGGAGGCTCATACCTGTAATCCCAGCACTTTGGGAGGCTGAGGCAGGTGGATCACCTGAGGTCAGGAGTTCCAGACCAGCCTGGCCAACATGGCGAAACCCTGTCTCTACTAAAAATACAAAAAATCT"
"GL873578","6159253","6159444","chr19","34496349","34496541","55","28337096","ATAAAATAAAAATAGAAAAATTAGCCAGGCATTGTGGCAGACATGCGAAGTCTCAGCTACTCCAGAGGCTGAGACAGGAAGATTACTTGAGCCCAAGAATCTTGCTGTGAGCTAAGCTGATGCCATAGCATTGTAACCTAGGCAACAGAGTAAGACTTGGCCTCAAAAATAAAATAAAATAATAAAGTAAAA","TTAGTTAATTAAATTAAACTTAGCTAGGCATAGTGGAACACACCCATAGTCCCAGCTACTCTAGAGGCTGAGGCAGGAGGATTGCTTGAGCCAAGTTGGAGGCTGCAGTGAGCTATGGTGGTGCCACTGCATTCCAGCCTCAGTGACAGAGAGAGACCCTGGCTCAAATAATAATAATAAATAAATAAATAAA"
"GL873578","6766040","6766171","chr2","93098086","93098217","30","86332046","CCAGGCACAGTGGCTCATGCCTATAATCCTAGTAGTCTAGGAGGCTGAGGTGAGTGCATTGCTTGAGCTCAGGAGTTAGATACCAGCCTAACCAAGAATGAGACCCCATCTCTATTAAAAATAGAAAAGTTA","GCCGGGCACAGTGGCTCATGCCTGTAATCCCAGCACTTTGGGAGGCCGAGGCGGGCAAATCACGAGGTCAGGAGTTCAAGACCAGCCTGACCAATATGATGAAACCCCGTCTCTATTAAAAATACAAAAATT"
"GL873578","6766434","6766577","chr9","21128084","21128223","50","14361650","GTTAGCCAGGAGTTGTGGCGGGCACCTACAGTCCTAGCGACTCAGGAGGCTGAAGTAGGCAGAGTTTGATGTGTTGCTGTGAACTACAAGGACACCAATGCACTCTAGGCCGGTAACAGAGTGAGACACTGACTAAAAAAAAAA","TTAGCCAGGTGTGGTGGCACATGCCTGTATTTCCAGCTACTCGGGAGGCTGAGGCAGGAGAATTGCGTGAGCTGAGATCATGCCACTTCATTCCAGTCTGGGTGACAGAGTGAGACTCTGCCTCAAAAAACAAAACAAAA"
"GL873578","7397948","7398119","chr5","40230148","40230319","43","32832200","TAAAAATAGCCATGCATTGTGACAGGCACCTGTAGTCCCAGCTACTCAGGAGGTTGAGGTAAGAGAATCACTTGAACCCAAGAGTTTTGAGGTTGTTATGAGCTAAGACGCCTCGGGACTCTACAAAAGGTAACAAAGTGAGACTCTGTCTCATAAAAAAAGAAAAAAAGAA","AAAATTAGCCAGGCATGGTGACGTACACCTGTAGTCCCAGCTACTCGGGAGGCTAAGGCAAGAGAATCGCTTGAACCCAGGAGGCAGAGGTTGCAGTGAGCTTAGATCACGCTACTGCGCTCCAGCCTGGGTGACGGAGTGAGACGCCATCTCAAAAAAAAAAAAAAAAAAA"
"GL873578","7398378","7398515","chr15","102382935","102383070","35","94984557","GGTCGAGCAAGGTGGCTCACGCCTGTAATCCTAGCACTCTGTGAGGCTGAGGCAGATGGATTGCCTGAGCTCGTGGGTTCGAGACCAGCCTGAGCCAGAGTGAGACCTCATCTCTAAAAATAGCTGGGAAGCTGGGCA","GGCCAGGTGTGGTGGCTCACGCCTGTAATCCTAGCACTTTGGGAGGCTGAGGCGGGTGGATTGCCTGAACTCAGGAGGTCAAGACCAGCCTGGGCAACACAGTAAAACCCCATCTCTACTAAAATACAAAAAATCA"
"GL873579","370235","370429","chr16","38067345","38067552","57","37697110","GCACAGGCCTGAAATCCTAGCACTCTGAAAGGCCAACGGAGGAGAATTTCTGGAGCTCAGGAGTTTGATACCAGCCTAAGCAAATAAAGCTAGACCTCTATCTCTACTAAAATTAGAAAAATTAGGCAGATGTGGTGGTAGGCACCTATAGTCCCAATTACTCCAGAGGCTGAGGCAGAAAGACTCTTGAACCCA","GTCAGGCATGGTGGCTCATGCCTATAATCCTAGCACTTTGGGAGGCCAAGGCCGGTGGATCACCTGAGGTCAGGAGTTTGAGACCAGCCTGGCCAATATGGCAAAACCCCGTCTCTACTAAAAATAAAAAAATTAGCTGGGCACGGTGGTGGGCACCTATAGTCCCAGCTACTCAGGAGGCTGAGGCAGGAGAATTGCTTGAACCCAG"
"GL873579","370936","371046","chr3","3847698","3847802","33","3476762","TGACTCTTGAACCCAGGCACATGAGGTTGCTAAGAGTCTAGGCTGATGTCACGGCACTCTAACCTGGGAAACAGTGTGAGGTTCTGCCTCAATAAATAAATAAATAAATAA","TGGCTTGAACCCAGGAGGCGGAGGTTGCAGTGAGCCGAGATCACGCCACTGCACTCCAGCCTGGGCAACAGAGCGAGACTGTCTCAAAAAAAAAAAAAAAAAAAA"
"GL873579","599436","599605","chr10","38982686","38982853","41","38383250","AAAAAGTCAGACATTGTGGCAGGTGTCTGTAATCCCAGCTATTTGGGAGGCTGAGGCAGGAGTATCATTTGAACCCACGAGTCTGAGGTAACTGTGAGCTAGGCTAACACAACAGCACTCTAGCCTGGGCAATAGAATGAGACTCTATCAAGAAAAGAAATGAAAAGAAA","TATTAGCCTGACACAGTGGCGCGCATCTGTAATCCCAGCTACTTGGGAGGCTGAGGCAGGAGAATCACTTGAACCCAGGAGGCGGAGGTTGCTGTGGGCTGAGATCATGCCACTGCACTCCAGCCTGGGCAACAGAGGGAGGCTCCATCTCAAAAAAAAAAAAAAAAA"
"GL873579","599942","599953","chr3","71473700","71473710","4","70873758","TTTTAAAATAGT","TTTAAAAAAAA"
"GL873579","600232","600365","chr1","16061315","16061447","30","15461083","GGCTAGGCAAGGTGACTCATGTCTGTAATCCTAGTACTCTGGGAGGTTTGAGGCAGGAAGACCACTTTAGCTCAAGAGTTCCAGATCAGCCTGTGCAAGAGTGATACATCATCTCTACTAAAAATCAAAAATTA","GGCTGGGCATGGTGGCTCATGCCTGTAATCCTAGCACTTTGGGAGGTTGAGGCAGGCAGATCACTTGAGGTCAGGAATCTGAGACTAGCCTGGCCAACATGGTGAAACTCCATCTCTACTAAAAAAAAAAAAA"
"GL873579","5650320","5650591","chr6","54938866","54939145","71","49288546","GTCAGGTGTGTTAGCTTACAGTAGTAATCCTAGCACTTTGGGAGGTTGAAGTGGGTGGATTGCTTGAGCTCAGGGGTTCAAGACCAGCCTGAACAAGAGTGGGACCTCATCTCTATTAAAAACAGAAAAACTAGCTGGGTGTTATGGTGGGTGTCTGTAGCCCCAGCTACTCAGGAGGCTGAGGCAGGAGGTTGAGGTTGCTGTGAGCTATTGAGACCACAGCACTCTATCCAGGGCAACAGAGTGAGACCCCTCCCCCCCCCAAAAAAAAA","GGCCAGGTGTGGTGGCTCACGCCTGTAATCCCAACACTTTGGGAGGCCGAGGTGGGTGGATCACCTGAGATCAGGAGTTCAAGACCACCCTGGCCAACATGGTGAAACCCCGTCTCTACTAAAAATACGAAAATTAGCTGAGTGTGGTGGTGCATGCCTGTAGTCCCAGCTACTCAAGAGGCTGAGGCAGGAGGTGGAGGTTGCAGTGAGCCGAGATTGCATCACTGCACTCCAGCCTTGGCGACAGAACGAGAGAGACTCCATCTAAAAAAAAAAAAAA"
"GL873579","7037162","7037347","chr3","37328686","37328893","67","30291524","GAGGTGGGTGGATTGCCTGAGCTCACAGGTTGGAGACCAGCCTGAGCCAGAGCAAGACCTTATCTCAAAAAATAGCCAGGTGTTGTGGCTGGCACCTGTAGTCCCAGCTGCTCAGGAGGCGGAGGCAAGAGAAATGCTTGACCTCAGGAGTTTGAGGTTGCTGTGAGTTCAACTCACACTAATACA","GAGGCAGGGGGATCACCTGAGGTCAGGAGATCGAGACCAGCCTGGCCAACATGGTGAAAACCTGTCTCTACTAAAAATCCAAAAACATTAGCCAGGTGTGGTGGCACGCACCTGTAATCCCAGCTACTTGGGAGGCTGAGGCAGGAGAATCACTTGAACCTGGGAGGCAGAGGTTGTAGCGAGCCGAGATCACACCACTGCACCCCAG"
"GL873579","11077764","11077972","chr19","1200469","1200683","63","9877295","GCCAGGTGCAGTGGCTCATGCCTATAATCCTAGCACCCTAGGAGGCTGAGGAGTTCAAGACCAGCCTAAGCAACTGTGAGACCCCATCTCTACCAAAAATAGAAAAATTAGCTGACTGTTATGGTGTGCACCTACAGTCCTAGCTACTCAGGAGGCTGAGGCAGAAAGAGTCCTTGAACCCAGGAGGCTTTTTTTTGTTGTTGTTGTTG","GGCCAGTCGCGGTAGCTCATGCCTGTAATCCCAGCACTTTGGGAGGCCGAGGCGGGCAGATCACCTGAGACCAGCCTGGCAACATGGTGAAACCCCATGTCTACCCAAACTACAAAAATTAGCTGGGTGTGGTGGTGCACGCCTGTAATCCGAGCTACTCAGCAGGCTGAGGCAGGAGAATCCCTTGAACCTGGGAGGCAGAGGCTGCAGTGAGC"
"GL873579","11078245","11078333","chr19","4926258","4926351","22","6151987","TGAACCCAGGAGTTTGAGTTCGCTGTGAGCTAAGCTGAGGCCACAGCACTCCAGCCTGGGCAACAGAGTGAAAGGAAAAAAATAAAAAA","TGAACCCGGGAGGTGGAGGTTGCAGTGAGCCAAGATCACACCAATGCACTCCAGCCTGGGCAACAAGAGTGAAACTCTGTCTAAAAAAAAAAAA"
"GL873580","320374","320488","chr13","48549305","48549409","42","48228931","GGTAGTGCGTGCCTGCATTCCCAGCTACGGGAGGGCAGGGACTTGAGGCCAGCCTGGGCAAAATAATGAGACCTACTAATGACTCTACTAATACAGAAACAATTAGCTAGGTATG","TGGGAGGCCGAAGTGCGCAGATCACCTGAGGTCAGAAGTTGGAGACCAGCCTGGCCAACATGGTGAAAACCCATCTCTACTAAAAATACAAAAATTAGCTGGGCA"
"GL873580","374969","375091","chr6","147681010","147681135","27","147306041","CGGTGGCTCACACCTATAATCCTAGCATTTTGGAAGGCTGAAGCCGAGGATCTCTGGAAGTCAGAAGTTCAAGACCAGCCTGCCCAAGAGCAAGACCCCATCTCTACTAAAAATAGAAAAACT","GGTGGCTCACACCTGTAATCCCAGCATTTTGGGAGGCTGAGGCAGGCGGATAATCTGAGGTCAAGAATTTGAGACCAGCCTGGCCAACATGGAGAAACCCTATCTCTACTAAAAATACAAAATTAC"
"GL873580","375369","375549","chr7","19977275","19977456","44","19601906","CTAACCAAGTTAGTTAGTTTTAGTTGGCAGGTGCCTGTAGTCCCAGCTCCTTGGGAGGCTGAGGCAAGAGAATGGCTTGAGCCCAGGACTTTGAAGTTGCTGTGAGCTATAATGACACCACAGCACACTACCCAGGGTGACAGAGTGAGACTGTCTCAAAAAAACAAACAAACAAAAAAAA","AACAAACGTTAGCCGAGCATGGTGGTATGTGCCTGTAGTCCCAGCTACTTGGGAGTCTAAGGCAGGAGAATTACTTGAGCCCGGGAGGCAGAGGTTGCTGTGAGCCAAGATCACGCCACTGCACTCCAGCCTGGGTGACAGAGTGAGACTCCATCTCAAAAAAAAAAAAGGAAAAAAAAAAA"
"GL873580","8760922","8761015","chr11","104681322","104681416","19","95920400","GGAGGGAGACACTGCAGTGAACTGCGATCGTGTCTCTGCTTTCCAGGCTGGGTGACAGAGTGAGACTCGGTCTCTAAAATAAAAAATAAATAAA","GGAGACGGAGGTTGCAGTGAGCTGTGATCGCGGCACTGCACTCCAGCCTGGGCAACAGAGTGAGACTCTGTCTCAAAAATAAATAAATAAATAAA"
"GL873580","9391260","9391306","chr14","49279240","49279285","12","39887980","GCCAGTCGAGGTGGCTCACACTTGTGATTCCAGCTACTTGGAAGACT","GGCTGAGATGGTGGCACACACCTGTAATCCCAGCTACTTGGGAGGC"
"GL873581","759283","759365","chr6","46535476","46535542","30","45776193","TAAGAACCTGAAAATAGAGCCAGGCATAGTGGTACATGCGTATAGTCCTGGCTACTCAGGAGGTTGAAACAACAGGATTACTT","CAAAATAGCCAGGCTTGGTGGTGCATGCCTATAATCCAAGCTACTCGGGAAGCTGAGGCAGGAGAAT"
"GL873581","1145844","1145979","chr1","29437872","29437991","29","28292028","GGCCGGGCGTGGTGGCTCACGCCTGTAGTCCCAGCACTATGGGAGGCCGAGGCGGGTGGATCACCTGTGCTCAGAGGTTCGAGACCAGCCAAGACCCCCCTGAGCCAAATGAGCCAGAGTGAGACCCCGTCTCTAC","GGCCGGGCGTGGTGGCTCACGCCTGTAATCCCAACATTTTGGGAGGCCAAGGCGGGTGGATCACCTGAGGTCAGAAGTTCGAGACCAACCTGGCCAACATGGTGAAACCCCTGTCTCTAC"
"GL873581","9628238","9628362","chr5","141044567","141044691","34","131416329","ATCCCAGGTAGTCGGGAGGCTGAGGCAGGAGGATCACTTGAACCCAGGAGGTTGAGGTTGCTGTGAGCAAGGCAGAGGCAACGGCACTCTAGCCACGGGGGCACAGAGACTCTTGTCTTTAAAAA","TAATCTCAGCTACTCGGGAGGCTGAGGCAGGAGAATCGCTTGAGCCCAGAAGGTGGAGGTTGCAGTGAGCCAAGATCGCGCCATTGCACTCCAGCCTGGGCGACAGTGCGAGACTCTGTCTCAAA"
"GL873582","1580485","1580534","chr6","32576760","32576806","12","30996275","CAGCACTTGAGAGGCCAAGGCAGGTGGATCAACTGAGCAAGAATGAGACC","CCAGCACCTTGAGAGGCCAAGGCAGGTGGATCACCTGAGGTCAGGAG"
"GL873582","1644368","1644551","chr1","211626449","211626612","63","209982081","AAAATTTGCCGGGCTCCATAGCTCATGCATGTAATCATAGCACTCTGGGAGGCCAAGATGGGAGGATCTCTCAAGCTCTCTTACTTGGGAGGCTGAGGTTGCTGTGAGTTAGGCTTACGCCACAGCACTCTACTCTAGCGTGAGCAACTCTACTCTTAGTATGAGACTGTCTCAAAAGAAAAAA","AAATTAGCCAGGCGTCGTGGCACATGCCTGTAATCCCAGCTACTCGGGAGGCTGAGGCAGGAGAATAGCTTGATCTCGGGAGGCGGAGGTTGCAGTCAGCCGAGATCACACCACTGCAATCCAGCCTGGACAACAGAATGAGACTCCATCTCAAAAAAAACAAA"
"GL873582","5794385","5794459","chr13","18872784","18872852","27","13078399","ATATTGTTAAGCACAGCCACTATTAAAAATTAAATTATAGGCCAGGCATAGTGGCTCATGCCTGTAATCCTAGCT","TGAAACCACCATCTGGACCAAGATACAAAATGTTGGCTGGGCATGGTGGCTCACACCTGTAATCCTAGC"
"GL873583","102645","102683","chr14","5808766","5808804","14","5706121","GAGCAGATCACCTGAGCTCAGGAGTTTGAGACCAGCCTG","GAGGAATCCCTGTGCTCAGGAAGCTTACATTCTAGTGAG"
"GL873583","6200447","6200560","chr4","17786849","17786963","24","11586402","GGCCAGGAGGGACGGCTCATGCCTGTTATCCTAGCACTATGGGAGACTGAGGTGGGAGGATCACTTGAAGTTAGGAGTTCCAGACCAATCTGACCAAAGTGAGACCTCATCTCT","GGCCAGGCTTGGTGGCTCATGCCTGTAATCTTAGCACTTTGGGAGGCTGAAGTGGGTGGATCACTTGAGGTCAGGAGTTAGAACCAGTCTGGCCAACATGGTGAAACCTCAGCTC"
"GL873583","6200584","6200752","chr6","169626528","169626696","42","163425944","TTAGCTGGATGTGGTAGCACATGCCTATAGTCCCATCTACTCAGGAGGCTGAGACAAGAGAGTTGCTTAAGCCCAGGAGTTTAATTTAACTGTGAACTAGACTGAGACTGTGGCACTCTAGCTGGGGCAACAGAGTGAGACTCTGTCTCAAAAGAAAGCAAGAAAGAAA","TTAGCTGGGTATGGTGTCAGATGCCTGTAGTCCCAGCTACTCAGGAGGCTGAGACAGGAGAATCGTTTGAACCCAGGAGGCCAGAACTGCAGTGAGCTGAGATTCGCACCACTGCGCTCCAGCCTGGGCCAGACAGAGTGAGACTCTATCTCAAAAGAAAAAAAAAAAA"
"GL873583","10217398","10217583","chr3","36257142","36257313","44","26039744","TACTAAAAATAAAGTGTGATAGCCAGGCATGGTGGTGGTGCCTATAGAACCAGGCTATTCAGGAGGCTGAGGCAGAAGGATCACTTGAACCCAGGAGTCTGACGTTGCTGTGAGCTAGGCTGGTGCCATGGTACTCTAGCCTGTGGTAACAGAATGAGACTCTATCTCAAAAATAAAAATAAAAAA","TACAAAATTAGCCAGGCGTGGTGGTGCGTGCCTGTAATCCCAGCTACTTGGGAGGCCGAGGCAGAAGAATGACTTGAACCCAGGAGACAGAGGTTGCAGTGAGCCAAGATCCCACCATTGTACTCCAGCCTGGGCAACACAGTGAGACTCCATCTCAAAAAAAAAAAAAAAA"
"GL873583","10394919","10394983","chr16","12841703","12841771","22","2446784","GAGGTCAGGAAATCAAGATCAGTCTGGGCAATATATTGATACCCTGCCCCTACATAAGGAAGAAA","AGGTCAGGAGTTCAAGACCAGCCTGGCCAATATGTTGAAACCTCATCTCTACTAAAAATACAAAAATTA"
"GL873584","521512","521529","chr1","167402212","167402233","10","166880700","GCATGGAACCCCCCACTC","GGTGAAACCCCATCTTTACTAA"
"GL873584","2079725","2079768","chr15","4338291","4338335","11","2258566","GGCAGGTGGATTACCTGAGTTCAGGAGTTGGAGACCAGCCTGAC","AGGCGGATGGATCACGAGGTCGGGAGTTTGAGACCAGCCTGACCA"
"GL873584","5216877","5217053","chrX","91350057","91350230","49","86133180","CTACTGAAAATGATGACAGAGGCTGGGCATGGGGGCTCCCGCCTGTTATCCTAGCACCCTCGGAGGCTGGGGAATGAGGATTGCTTACGCCCAAGAGTTTGAGGTTGCTGTGAGCTGAGGCCGCTGCACTCTAGCCTGGGCAACAGAGTGAGACTCTGTCTCAAAAAAAAAAAAAAA","TGCAAAAATGAGCTGGGCATGGTGGCACATGCCTGTAATCCCAGCTACACAGGAGGCTGAGGCAGGAGAATCGCTTGAATCTGGGAGGCGGAGGTTGCAGTGAGCTGACATCAGGCCCCTGCACTCTAGCCTGGGCCACAGAGCAAGACTCCGTCTCAAAAAAAAAAAAAAAAA"
"GL873584","7289930","7289950","chr2","51453328","51453345","10","44163398","TGAGGCTCTGTCTCGAAATAA","AATGCCATCTATTAAAAA"
"GL873584","7289975","7290131","chr11","49739997","49740154","37","42450022","CAAGAAAATTAGCTGAGAGTCCTGGTAGGTGCCTGTAATCCCAGCTATTCATGAGGCTGAGGCAGAAGGATCACTTGGGTCCAGGAGTCTGAGGTTGCTGTGAGCTAGTCTGACGCCATAACACGCAAGCCTGGGCAACAGAGTGAGGCTCGGTTTC","CTACAAAAATTAGCTGGGCGTGGTGGCACATGCCTGTAATCCCAGCTACTCGGGAGGCTGAGGCAGGAGAATCACTTGAGCCCAGGAGGCGGAGGTTGCAGTGAGCCAAGATCATGCCATTGCACTCCAACCTGGGCAACAGAGCAAGACTCCATCTC"
"GL873584","7577743","7577867","chr5","48394329","48394446","27","40816586","GGCTGGATGAGGTGGTTCATGCCTGTAATCCTAGCACTCTGGGAGGCCAAGGTGGGTGGATTGCCTGAGCTCAGGAGTTCAAGACCAGCCTGAGCAAGACCCTGTCGCTAAAAATAGCTGGGTGT","GGCTGGGTGCAGTGGCTCATGCCTGTAATCCCAGCACTTTGGGAGGTCAAGGCGGGTGGATCACCTGAGGTCAGGAGTTCAAGACCAGCCTGGCCAACATCTCTACTAAAAATACAAA"
"GL873584","7578135","7578289","chr1","130112713","130112865","31","122534578","GGAGCTGGGTTTTGTGACTGCACCTGTAATCCCAGCTGCTCAGGAGGCTGAGGCAAGAGAATTGCTTGAGCCCAGGAGTTGGAGGTTGCTGTGAGCTGTGATGCCAGGGAACTCTACCAAGGGTGACAAAGTGAAACTCTGTCTCAAAAAAAAAA","TTAGCCAGGTGTGGTGATGCATGCCTGTAATCCCAGCTACTCATGAGGCTGAGGCAGGAGAATTGCTTGAACCTTGGAGCTGGAGGTTGCAGTGAGCTGAGATCAGACCACTCCAACCTGGGTGACAGAGCGAGACTCTGTCTCAAAAAAAAA"
"GL873585","1450952","1451121","chr10","59681079","59681242","48","58230127","TAAAAACAGAAAAAACTAGTCAGGTGGTGTGGTAGGTGCTCATAAGTCCCAGCTGCTTGGGAGACTGAGGCAAGAGAATCACTTGAGCACAAGAGCTTGAGGTGGCTGTGAGCTATAACACCATAGCACTGTACTGAGGGTGACAAAGTAAGACTCTGTCTCAAAAAAAA","TACAAAAATTAGTCAAGGGTGGTGGTATGTGCTTGTAATCCCAGCTATTTGGGAGGCTGAAGCAGGGGAATCCTTGAACCCAGGAGGTGGAGGTTGCAGCGAGCCGAGATCACGTCACTGCACTCTAGCCTGGGCGATAGGGTGAGACTCTGTCTCAAAAAAAA"
"GL873585","1451382","1451515","chr6","17405813","17405948","24","15954431","GGCCCGGCTCGGTGGCTCACACCTATAATCCTAACACTCTGGGAGGCTGAGGCAGGTGGATCACCTGAGCTCAGGAGTTTGAGACCAGCTGAGCAAAAACAAGACCCTATCTCTGCTAAAAATAGAAAAAACTA","GGCCGGGCGGGGTGGCTCACGCCTGTAATCCCAGCACTCTGGGAGGCCAAGGCAGGTGGATCACCTGAGGTCAGGAGTTTGAGACCAGCCTGGCCAACACGCAGAAACCCTATTTCTACTAAAAACACAAAAATTA"
"GL873585","1626960","1627026","chr7","17782729","17782794","22","16155769","AAGATGCCACAGCACTCTACAAGAGTGACCAAGTGAGACTCTGTCTCAAAAAAAAAAAGAAAAGGAA","CAATCGCACTACTGCACTTCAGCCTGGGTGACAGAGTGAGAACCTGTCTCAAAAAAATAAATAAAA"
"GL873585","1627304","1627531","chr11","17033552","17033788","61","15406248","GGCTGGGCACAGTGGCTCACGGCTATAATCTAGGCACTTGGGAGGCTAGGGCAGGTGGATTGCCTGAACTGACAAGTTTGAGACCAACCTGAGCAAGAGCGAGACCCCTGTCTCTAAAACATAGCCAGGCTCTGTGGTGGGCGTCTGTAGTCCCAGCTACTTGGGAGGCTGAGGCAAGAGAATTGCTTGAACTCAAGAGTCTGAGGTTGCTGTGAGTTAAGATGCCAC","GCCCGGCGCAGTGGCTCACGCCTGTAATCCCGGCACTGTGGAGGCCAAGGCAGGCGGATTGCCTAAGCTCAGGGATTCGAGAACAGCCTGGGCAACATGGTGAAACCCCATCTCTACTAAAATACAAAAAACTAGCCGGGCGTGGTGGTATGCGCCTGTAATCCCAGCTACTTGGGAAGCTGAGGCAGGAGAATTGCTTGAACCCGGGAGATGGAGGTTGCAGTGAGCTCAGATCAC"
"GL873585","3626082","3626158","chr1","100916857","100916922","27","97290775","TGCCTGTAATCCCAGCACTTGGGAGGCGGAGGTGGGTAGATTGCCTGACCCAGAGTGGGACCTCATCTCTAAAAGAA","CATGCCTGTAATCCCAGCACCTTGGGAGGCCAAGGTGGGTGGATCACCTGAGGTCAGTAGTTTGAG"
"GL873585","8849829","8849913","chr18","48581945","48582025","18","39732116","GGCTGGACGAGGGGACTCATGCCTGCAATCCCAGCACTGAGAGAGGCCAAGGCAGGTGGATCCCCTGAGCTCAGAAGTTTGAGAC","GCTGGACGCAGTGGCTCACACCTGTAATCCCAGCACTTTGGGAGGCCAAAGCAGGCAGATCTGAGGTCAGGAGTTTGAGAC"
"GL873585","9319890","9319971","chr8","79499361","79499447","14","70179471","GGCCAGGTGTGGTGGCTCACACCTGTCATCCTAGCACTCTGGGAGGACGAGGTGGGTGGACCGCCTGAGTCAGAGTGAGACC","GGCCAGGTGTGGTGGCTCACACCTGTAATCCCAACACTTTGGGAGGCCCAGGTGGGTGGATCACCTGAGGTCAGGAGTTCAAGACCA"
"GL873586","895572","895692","chr17","14501559","14501680","38","13605987","GGCCAGGTGAGGTTTCTCATTCTGGGAGTGAGCCAGCAATTGGGAGGCCAAAGTAAATGGATTGCCTGAGGTTATAGGTTCCAGAACAGCCAGAACAAGATCGAAATCCTGTCTCCAAAAA","GGCCAGGCGTGGTGGCTCATGCGTGTAATCTCAGCACTTTGGAAGGCCGAGGCAGGTGGATCACCCGAGGTCAAGAGTTCAAGACCAGCCTGACCAACATGGCGAGTCTCTGTCTCCACTAA"
"GL873586","5645995","5646150","chr6","58863249","58863409","38","53217254","GGGTATGGTGGCTCATGCCTGTAATCCAAGCACTCTGGGATGGTGAGGCAGGAGAATCCCTTGAACCCAAGAGTCCGAGGTTGCTGCGAGCTAAGCTGATGGCATAACACTCTAGCCTAGGCGACAGAGTGAGACTCTGTTTCCAAAGAGAAAAAA","TTAGCCAGGCATGGTGGCACATGCCAGTAATCCCAGCTACTCAGGAGGATGAGGCAGGAGAATCGCTTGAACCCAGGAGGCAGAGGTTGCAGTGAGCTGAGATTGCGCCACAGCACTCTACCCTGGGTGACAGAAGGAGACTCTGTCTCAAAAAAAAAAAA"
"GL873586","10258686","10258969","chr12","9481260","9481565","81","777426","GGCCGGGCATGGTGGCAGAAATCTAGGAGGCCGAGGCAGGTGGATCGCCTGAGATCACAAGTTCAAGACCAGCCTCAGCTACAGCAAGACCCCATCTCTAAAAATAGCCGGCTGTTGTGGCAGGCGCCTGTAACCCCAGCTACTCGGGAGGCTAAGGCAAGAGAATCGCTTGAGCCCATGAGTCTGAGGTTGCTGCGAGCTGTGACTCCACGGCACTCTACCCGGGGCGATAAAATGAGATTCTGTGTCAAAACAAACAAACAAACAAACAACAACAAAAACAA","GCTGGGCGCGGTGGCTCATGCCTGTAATCCCAGCACTTTGGGAGGCCAAGGCAGGTGGATCACCTGAGGTCAGGAGTTCGAGACCAGCCTAGTCCACATGGTGAAACCCCATCTCTACTAAAAACTAGCCAGGCGTGGTGGTGCGCACCTGTAATCCCAGCTACTCGAGAGGCTGAGGCAGGAGAATCACTTGAGCCTAGGAAGCAGAGGTTGTGGTGAGCTGAGATCACACCACTGCACTCCAGTCTGGGCGACACAGTGAGACTCTTGTCTCAAAAACAAAAAACAAACAAACAAACAAACAAA"
"GL873587","3208032","3208047","chr8","3626746","3626762","2","418714","AAACAACCACAAAAAA","ACAACAACAACAAAAAA"
"GL873587","3208141","3208321","chr19","2057131","2057316","59","1151010","TTTCTTTTAAAAATCACCCATGGGCTGGGTATAGTGGCTCACACCTATAATCCTCGGGAGGCCAAGGTTGGAGGATTGCTTGAATCCAGGAGTTGAAGGTTACAGTGAACTGGGATTTAGCCACTAGACTCTAGCATAGCTGACAAAGCAAGAACCTATTTGTTTAAAACACAAAAAAGAA","TACTAATAATACAAAAATGAGCCGGGTATGGTGGCGGGTGCCTGTAATCCCAGCTACTGAGGAGGCTGAGGCAGGAGACTTGCTTGAACCCAGGAGGTAAAGGTTGCAGTGAGCTGAGATTGCACCACTACACTCCAGCCTGGGCGACAAGAGCAAAACTTTTTCTCCAAAAAAAAAAAAAAAAAA"
"GL873587","3278260","3278367","chr19","19044200","19044312","39","15765940","CAGTCTGAGCAAGAGGGAGAGGCTATTTCTACTAAAAACAGAAAAACTAGCTGGGTGTTGGGGTGTGTTCCTAGTCTCAGTTACTTGGGAGGCTGAAGTAAGAGGATC","ACCAGCCTGGCCAACACGGTGAAATCCCGTCTCTACTAAAAATACAAAAATTACCTAGGCGTGATGGCACGTGCCTGTAGTCCCAGCTACTCATAAGGCAGAGGTGAGAGAAT"
"GL873587","3278673","3278754","chr7","49412503","49412597","28","46133830","GGCCACGAGAGCTAGCTCATGCCTATTCTAGGAGGCCAAAGCAGGCAGACTGCCTGAGCTCAGGAGTTCAAGAGCAGCCTGG","GGCCAGGTGCAGTGGCTCATGCCTGTAATCCGAGCACTTTGAGAGGCCGAGGCAGGCAGATCACCTGAGGTCAGGAGTTCAAGACCAGCCTAGTA"
"GL873587","3782076","3782188","chr9","112128434","112128552","34","108346358","ACTGGGGTGGCTGAGGCAGGAGCGTCACTTGAACTCAGGAGTTTGAGATTGCTGTGAGCTGAGCAGATGTCATGGCACGCTAGCCTAGGTAATAGAGTGAGACTTCGTCTAAA","CAGCTACTCGGGAGGCTGAGGCAGGAGAATCACTTGAACTCGGGAGGCGGAGGTTGCAGTGAGCCGAGATCACGCCATTGCACTCCAGCCTGGGCAACAAGAGCGAAATTCCATCTCAA"
"GL873587","4564996","4565084","chr20","27900350","27900437","14","23335354","GGCGGGGTGTAGTGGCTCATGCCTATTGTCCCAGCACTGTGGGAGGCCGAGGTGGGTGGATCACCTGTGCTCAGAAGTTTGAGACCAGC","GGCCGGGCGTGGTGGCTCATGTCTGTAATCCCAGCACTTTGGGAGGCCGAGGTGGGTGGATCACCTGAGGTCAGGAGTTCAAGACCAG"
"GL873587","6307870","6308175","chr12","112427710","112428020","54","106119840","GGCCAGATATGATGGCTCATGCTTGTAATCCTAGCACTCTGGGAGGCTGAAGTGGGAGGATCACCTGAGATCAGGAGTTCAAGATCACCCTGAGCAAAAGTGAGATCCCATCTCTATTAAAAATAAAAAAATTATCCAGGCATGGTGGTGCAGTCCTTTAGTCCCAGCTACTTGGGAGGCTGAGGCAGGAGAATCTCTTGAACCCAGGAATTAGAGGTTACAGTGAGCTGTGATGATGCTACTGCACTCTAGCAGGATGACAGAGTGAGATACTCCGTGTCAAAAAAAAAAAAAAAAAAAGCAAAA","GGCTGGACATGGTGGTTCATGCTTGTAATCCGAGCACTTTGGGAGGCCAAGGCGGGTGGATCACCTGAGGTTGGGAGTTCGAGACCAGCCTGACCAACATGATGAAACCCCATCTCTACTAAAAATACAAAAAAATTAGCCAGGCATGGTGATGCACGCCTGTAATCCCAGCTACTTGGGAGGCTGAGGCAGGAGAATCACTTGAACCCAGGAGGCAGAGGTTACAGTGAGCCGAGATCATGCCATTGCACTCCAGCCTGGATGACAGAGTGAGCCTCTGTCTCAAAAAAAAAAAAAAAAAAAAAAAAAAA"
"GL873587","6484004","6484128","chr10","67341428","67341546","29","60857424","GACCAGGTTCTGTGGCTCATGCTTGTAATCCTAGCACTCTAGGAGGCCGGAAGAGGGTGGATTGATTGCCTGAGGTCAGGAGTTAGAGACCAGCCTGAGCAAGAGCTAGACCCTGTTTCTTTCTT","GGCTGGGTGTAGTGGCTCATGCCTGTAATCCCAGCACTTTAGGAGGCCAAGGTGGATGGATTGCCTGAGCTCAGGAGTTCGAGACCACCCTGGGCAACAAGCCAAAACCCTGTCTCTAC"
"GL873587","6484407","6484586","chr3","167196537","167196723","48","160712130","TAGACCCTGTTTCTAAAAAAAAAATAGCCAGGTGTTGAGGCAGGTACCTGTAGTCCCAGCTACCTGGGAGGGCTGAGGCAAGAGAATCGCTTGAACCCAAGAGTTTGAGGTTGCTGTGAGCTGAGATGCTATGGCACTCAACCGTGAGCTACAAAGTGAGACTCTGTCTCAAAAAAAAAA","AAAACCTGTCTCTGCTAAAAATACAAAAATTAGCCGGGTGTGGTGATGTGCGCCTGTAGTCCTAGCTACTTGGGAGGCTGAGGCAGGAGAATCACTTGAATCCAGGAGGTGGAGGTTGTAGTGAGTCGAGATCGTGCGACTGCACTCCAGCCTGGGTGACAGCGAGACTCTGTCTCAAAAAAAAAAA"
"GL873587","7466229","7466364","chr1","29437872","29437991","35","21971643","GGCCAGGCGTGGTGGCTCATGCCTGTAGTCCCAGCGCTATGGGAGGCCGAGGTGGGTGGATCACCTGTGCTCAGAGGTTCGAGACCAGCCAAGACCCCCCTGAGCCAAATGAGCCAGAGTGAGATCCCATCTCTAC","GGCCGGGCGTGGTGGCTCACGCCTGTAATCCCAACATTTTGGGAGGCCAAGGCGGGTGGATCACCTGAGGTCAGAAGTTCGAGACCAACCTGGCCAACATGGTGAAACCCCTGTCTCTAC"
"GL873588","1502535","1502718","chr1","34852429","34852590","60","33349894","GGTGCAGTGGCTCACACCTGTTGTCCCAGCGCTGTGGGAGGCCGAGGTGGGTGGATCACCTGTGCTCAGAGGTCGAGACCAGCTGAAGACCTGCCTGAGGCAGAGTGAGCCAGAGTGAGACCCCGTCTCTACTAGAACAACAACAAGACAGCCAGACCTTGTGATCCCAGCTACATGGGGGGCT","GCCAGGTGCAGTGGCTCACACCTGTAATCCCAGCACTTTGGGAGGCCGAGGCGGGCGGATCACCTGAGGTCAGGAGTTTGAGACCAGCTTGACCAACATGGAGAAACCCCGTCTCTACTAAAAATACAAAATTAGCCTGGTGTGGTGTCGCATGCCTGTAAT"
"GL873588","10189037","10189246","chr3","45604681","45604903","65","35415644","GCTGAGATGAGGAGACTCTGTCTCTATTAAAAATAGAAAAATTGGGTGGATGTTGTGGGTACTGTAGTTGCAGCCTCTTGGGGGGCTAAGGCAGGAGGATCAGTTGAAGCCAGGAATTTGCTTTGAGCTAGGCTAAAGCCATGGCACTCTAGCCTGGGCAACAGAGTGAGGCTAGATCTCAAAAAAAGAAAGAAAAGAAAAAGAAAAAAA","CTGGCCAACATGGCAAAACCCCATCTCTACTAAATATACAAAAATTAGCTGGACGTGGTGGCACATACCTGTAATCCCAGCTACTTGGAAGGCTGAGGCAGGAGAATAGCTTGAACCTGGGAGGCAGAGGTTGCAATGAGCTGAGATCACGCCACTGCACTCTAGCCTGGGCAATAGAATGAGACTCTGTCTCAAAAAAAAAAAAAAAAAAAAAGACAAGAAA"
"GL873589","104719","104807","chr20","27900350","27900437","13","27795631","GGCTGGGCGTGGTGGCTCATGCCTGTTGTCCCAGCGCTGTGGGAGGCTGAGGTGGGTGGATCACCTGTGCTCAGAGGTTCGAGACCAGC","GGCCGGGCGTGGTGGCTCATGTCTGTAATCCCAGCACTTTGGGAGGCCGAGGTGGGTGGATCACCTGAGGTCAGGAGTTCAAGACCAG"
"GL873589","796766","796905","chr1","166346372","166346487","49","165549606","GGCTAAGTGTGGTGGCTCACACCTGTCATCTAGTACTTTGGGAGGGTGGGCCTGGGAGTTCAAAGACTGAACTCAGGAGTTCAAGGTGGCTCCGGGGAGGAATTCAAGACCAACCTGAGCCAGAGCGAGACCTCGACTCT","GGCCAGTGGGGTGGCTCACGCCTGTAATCCCAGCACTTTGGGAGGCTGAGGTGGTCAAATGACCTGAGGTCAGGAGTTTGAGACCAACCTGGCCAACATGGTGACACCTCGTCTCT"
"GL873589","1023679","1023690","chr1","205890061","205890072","1","204866382","AAAAAAAAAAAA","ACAAAAAAAAAA"
"GL873589","1023771","1024047","chr4","103012712","103012993","70","101988941","GGCTTGGTGGCTCACACCTGTAATCCTAGCACTCTGGGAGGCCGAAGTGGCTGGAATACTTGAGGTCAGGAGTTCAAGACCAGCCTAAGTGAGAGTGAGATCCCCATCTCTAATAAAAATAGAAAAATTAGCAGGGTGTTGTGGCTGGCACTTGTAGTCCCAGCTACCCAGGAGACCGAGGCAGAAGTTTGAGATTATTGTGAGCGAGGCTGATGCCACAGCATTCTAGTGGGACAACAGAGCAAAATTCTATCTCAAAAGAAAAAAAAAAAAAGGA","CGGGCGTGATGGCTCACGCCTGTAATCCCAACACTTTGGGAAGCCGAGGCGGACGTATCACCTGAGGTCAGGAGTTCAAGACCAGCCTGGCCAACATGGTGAAACCCCGTCTCTACTAAAAATACAAAAATTAGCTGGGTGTGGTGGCATGCGCCTGTAATCCCAGCTACCCAGGAGGCTGAGGCAGGAGAATCGCTGAGGCTGCAGTGAACTGAAATTGTGCCACTGCACTCCAGCCTGGGTGACAGAGCAAGACTCTGTCTCAAAAAAAAAAAAAAAAAA"
"GL873589","4820958","4821024","chr8","33633747","33633811","15","28812789","TTAGTCAAGTGCAGTGGCTCACACCTGTCATCCCAGCTACTTGGGAGGCTGAGGCAGGAGAGTTGCT","TTAGCCAGGTGTGGTGGTGCATGCCTCTAATCCCAGCTACTCAGGAGGCTGAGGCAGGAGAATTG"
"GL873589","6763768","6763857","chrX","25814002","25814092","29","19050234","GGTGTGGTGGCTCACACTTGTATCTTAGCATTTTAGGAGGCTGAATGGGGAGAATTGCTTTAAGTCAGGAGTCTGACTTCCACCTTGCCA","GGCTGGGAATGGTGGCTCACACCTGTAATCCCAGCACTTTGGGAGGCTGAGGTGGGCAGATCACCTGAGGTCAGGAGTTTGAGATCAGCCT"
"GL873589","8444551","8444632","chr9","93194085","93194171","17","84749534","CGGGCATGGTGGCTCACAACTATAATCTTAGCACTTTGGGAGGCTGAGACAGGTGGATGCCTGAACTCAAGAGTTTGAAACC","GGCCGAGCATGGTGGCTCACACCTGTAATCCCAGCACTTTGGGAGGCTGAGGCAGGTGGATTACCTGAGGTCAAGAGTTCAAGACCA"
"GL873589","9085365","9085494","chr2","194063347","194063481","42","184977982","GGCCAGGCACAGTGGCTCACACCTATAATCCCAGCACTCTGTGAGACTGAGGCAGGTGAACTGTTGCAAGAGTGAGACCCTGTGCTTGGTGCCTGTAGCTCAGTGGTTAATAATAAGAAAAAAGAAAAAA","GGCCAGGTGCAGTGGCTCACACCTGTAATCCCAGCACTTTGGGAGTCTGAACCAGGCAGATCACCTGAGGTCAGGAGTTCGAGGCCAGCTCGGCCACCATGGTGAAACCCTGTTTCTAATAAGAATACAAAAAAA"
"GL873589","9085767","9086002","chr7","84631446","84631650","75","75545679","GAGTGAAACCCTGTCTCTACTAAAAATAGAAAAACTAGCTGTGCATCAGGGCGCATAACTGTAGTCCCAGGTACTCAGGACACTGAGGCAAGAGAATTGCTCAAGCCCAAGAGTTTGCAAGAATTTGAGGTTGCTATGAGCTATGATGCCATGGCACTCTACCTAGGGTGACAGACAGAGACTCTGTCCCAAAAAAAAAAAAAGAAGAAGAAGAAAAAAAAAAAGAAAGAAAGAAA","ATAGTGAAACCTCGTCTCTACTAAAAATACAAAAATTAGCTGGGCATCATGGTGCACGCTTGTAATTCCAGCTACTTGGGAGGCTGAGGCAGGAGAATTGCTTGAACTCAGGAGGTGGAGGTTGCAATGAGCCAAGATCGCGCCACTGCACACCAGCCTGGGTGACAAAAGACTCTGTCTCAAAAAAAAAAAAAAAAAAAAAAAA"
"GL873589","9992904","9993045","chr16","56427538","56427666","46","46434634","AACCAGCCAGGCATGGTGATTCACACCTATAATCCCAGCTACTTAGGAGTATGGCTTGAGCACACAGGATACCATACCATTCTAGTCATCCCAGGCAACAGAGGGAAACTCTGTTGGTTAAAAAAAAAGAAAAACTTAAAAA","TTAGCCAGGAGTGGTGGTGCACGCCTATAATCCCAGCTACTTGGGAGGCTGAGGCACAAGAATCACTTGAACCATTGCACTCCAGCCAGGGTGATAGAGGGAGACTCTATCCAAAAAAAAAACAAAAAA"
"GL873589","9993319","9993452","chr3","2774534","2774668","28","7218785","GGCCTGAGCCCTGTGACTCATGCCTGTAATCCCAGCACTGGAAGTTCCAAGGCAGGTGGATCGCTTGAGCTCTGGAGTTCAAGACCAGCTCAACCAAGAGTAAGACCCCATCTCTACTAAAAATAGAAAAACCA","GGCTGGGCACGGTGGCTCATGCCTGTAATCCCAGCACTTTGAGAGGCCGAGGCAGGTGGATCTCCTGAGGTCAGGAGTTCAAGACCAGCCTGGGCAACATGGTGAAACCCCATCTCTACTAAAAATACAAAAAAT"
"GL873590","9044589","9044884","chr1","83754525","83754835","84","74709936","GGCCAGGTGCAATGGCTCATGCCTATAATCCTCACACTCTGGGAGGCTGAGGCAGGAGGATCACTTTTCTCAGGGTCAGGGCCAGCCTGACAAAAGTCAGACCCTGTTTCTACTAAAAATAGAAAAACTAGCTGGGTGTTGTGGCAGATGCCTATAGTCCCAGCTACTAAGAGACTGAGACAAGTGCCCAGAGTCTGAGGTTACTGTGAGCAAAGCTGATGCCATAGCATTCTAGCTATAGATCGAGAGTCTGTCTCAAAAACAAACAAACAAACAAACAAACAAACAAAAAAGAA","GGCTGGGTGTGGTGGCTCATGCCTGTAATCCCAGCACTTTGGGAGGCCGAGGCGGGTGGATCATCTGAGGTCAGGAGTTCAAGACCAGCCTGACCAACATGGTGTAACCCTGTCTCAACTAAAAATACAAAAATTAGCTGGGCGTGGTGGTGTGCACCTATAGTCACAGCTACTTGGGAGGCTGAGACAGGAGAATTGCTTCAACCCAGGAAGTGGAGGTTGCAGTGAGCCAAGATCATGTCACTGCACTGCAGCCTGACAGAGCGAGACTCCATCTAAAACAAACAAACAAAAACAAACAAACAAACAAA"
"GL873591","1831505","1831587","chr17","61702818","61702899","25","59871313","CCCAGCACTTTGGGAGGGCAAGATGGGAGAATCATATAAAGTCAGGAGTTTGAGACCAGTTTGGCAGACATGATGAACCCATC","AATCCCAGCACTTTGGGAGGCTGAGGCAGGCGGATCATCTGAGGTCAGGAGTTCAAGACCAGCCTGGCCAACATGGTGAAAC"
"GL873591","2719175","2719275","chr4","86137755","86137847","32","83418580","GTGGGGGCTTAGGCCTGTAATCCCAGCACTCTGAGAGGCCAAGGTGAGCTGGTCACCTGGGTTTAGGAGTTTGGAGACTTGCTCGAGCTAGACTGAGGCTC","GTGGTGGCTCACGCCTGTAACCCTAACAATTTGGGAGGCCAAGGCAGGTGGATCACTTGAGGTCAGAAGTTTGAGACCAGCCTGGACAATATG"
"GL873591","4732974","4733120","chr19","7991801","7991954","55","3258827","ATACGCAGACTGGCCGAGCGTGGTGTCACATGCCTATAATCCCAGTGGCTACTCTGGGGAGGAGAATCTCTTGAAACCAAGAGTTAGAGATTGCAGTGGGGTATGATACAGGGTAACAAAGAGAGACCTTGGATCTGAAAAGAAAAA","AAAATACAGAAACTAGCTGGGCATGGTGATGCACACCTGTAATCCTAGCTACTGGGGAGGCTGAGGCAGGAGAATTGCTTGAACCCAGGAGTCAGAGGTTGCAGTGAGCAACCAGCCTGGGTGATACAGTGAGTGAGACTCTGTCTCGAAAAAA"
"GL873591","6822728","6823009","chr1","20579766","20580052","72","13757038","GGCCAGGCGTGGTGGCTCATGCCTGTAAATCTCAGCACTCTGGGAAGCTGAGGCAGGTGGATTGCTTGAGGTCAGGAGTTTGAGACCAGCCTGTACCAGAGTAAGACCCTGTCTCTAATAAAAATAGAAAAAAAAAAAAAAACTAGTTGGGCATGGTGATGGGTGCCTGTAGTCCCACCTACTTGGGAGGCTGAGGCAATGGCATCTCTTGAGCCCAAGAGTTTGAGGTTGCTGTGCCATGGCACTCTCCCCAGGGTAACAGAGTGAAAATAAAAAAAAGAA","GGCCAGGCGTGGTGACTCATGCCTGTAATCTCAGCACTTTGGGAGGCCGAGGCAGGTGAATCACCTGAGGTCAGGAGTTTGAGACCAGCCTGACCAACATGGTGAAACCTCGTCTCTACTAAAAATACAAAAAGTAGCCAGGCATGGTGGCGCATGCCTGTAATCCCAGCTACTTGGGAGGCTGAGGCAGGAGAATCGCTTGAACCCGAGAGGCAGAGGTTGCATTGAGTCAAGATGGTACCACTGCACTCCAGCCTGGGTGACAGATTGAGACTCAAAAAAAAAAA"
"GL873591","7578706","7578813","chr16","45055441","45055543","42","37476735","AAATTTAGCTACACATAGTGGCATGAGTCTGTAATGCTAGCCACCCAAAAGGCTGTAGTAAGAGGATTGCTCTATCCCAGGAGTTAAAGACCAGCCCGGACATCAGAG","AATTAGCCGGGCGTGGTGACACACACTTGTAATCCTAGATACTCAGGAGGCGAAGGTAGGAGAATTGCTTGAACCCAGGCAGCAGAGGTTGCAACGAGCAGAG"
"GL873591","9282916","9283004","chr1","20744253","20744338","16","11461337","GGCCAGGCGCGGTGGCTCACCCCTGTTGTCCCAGTTCTGTGGGAGGCCGAGGTGGGTGGATCACCTGTGCTCAGAGGTTTGAGACCAGC","GGCCAGGCACGGTGGCCACGCCTGTAATCCCAGCACTTTGGGAGGCCGAAGTGGGTGGATTACCTGAGGTCAAGAGTTTGAGACCA"
"GL873592","835155","835315","chr16","75654291","75654451","43","74819136","CTGGGTGTGGTGGCTCTTGTCTGCAATCTCAGTACACTGGGAGGCTGAGGCAGAAGGATTGCTCCAGCTCAGGAGTTTGAGGCCAGGCTGAGCTAGTGCAAAACCCCATCTCTACTAAAAAAAGAAGGAAAAAAAAAAGAAAAAGAAAAAAAATACGAGCT","CCAGGTGTGGTGACTCACGCCTGCAATCCCAGCACTCTGGGAGGCTGAGGTGGGTAGATTACCGGAGGTTAGGCGTTTGAGACCAGCCTGGCCAACATGGTGAAACCCCATCGCTACTAAAAAAAAAAAAAAAAAAAAAAAAAAAAAAAAAAAAAAAATTA"
"GL873592","835589","835765","chr1","66836166","66836336","48","66000577","ACAAAAAACCTAGCTTAGGGTTGTTATAGCACCTGTAGTCCCAGCTACTCAGGCGCTAAGGCAGGAAAATCTGCCTGAGCTCAGGAGTTTGAGGTTGCAGTAAGTTATGATGATGCTACTGCACTCTAGCTGGGGCAACAGAGTGAGACTCTGTCTGAGGAAAAACCAAAACCAAAA","TAGCCCAGCACGGTGGCTCACACCTGTAGTCTCAGCTACTCAAGAGGCTGAGGCATGAGAATCGCTTGAACCCAGGAGGTAGAGGTTGCAGTGAGCTGAGATCATGCCACTGCGCTCCAGCCTGGGCAACAGAGTGAGACTCAGTCTCAAAAAACAAAACAAAACAAAAAA"
"GL873592","2520661","2520705","chr16","66853217","66853257","11","64332556","TCTGGGAGGCTGAGGCGGGTGGATCACCTGAGCAAGAGTGAGACC","TTTGGGAGGCTGAGGCAGGTGGATCACTTGAGGTCAGGAGT"
"GL873592","4535248","4535388","chr1","12240468","12240612","38","7705220","GGCGGGATGTGGTGGTTCATGGCTGTAATCCCAGCACTCAGGGAGGCTGAGTCGGGTGGATTGCTTGAGTTCAGGAGTTTGAGACCAACCTGAGCAAGAACTAAGCCTGTCTCTACTAAAGATATTATTTCTTATTTTTCT","GGCCGGGCGCGGTGGCTCATGCCTGTAATCCCAGCACTTTGGGAGGCTGAGGCGGGTGGATCACCTGCGGTCAGGAGTTCGAGACCAGCCTGGCCAACGTGGTGAAACCTCATCTCTACTAAAAATATAAAAATTAGCTGGTGTG"
"GL873592","4535654","4535831","chr8","126054004","126054184","54","121518350","TCTACTACAAATATTAACAGAAAAATTAGCTGGGCATTGTGACAGGTGCCTATAGTCCCAGATACTCAGAAGGCTGAAGTAAGAGGATCACTTGAACCCCAGGAGCTAAGGTGGCTGTGAGCTAGGCTGAGGCTCTAGCCTGGGTAACAGAGTGAGACTGTAAAAAAAGAAAGAGAGA","GTCTCTACTAAAAATACAAAAATTAGCTGGGTGTGGTGGTGCATGCCTGTAATCCCAGCTACTCAGGAGGCTGAGGCAGGAGAATCGCTTGAACCCAGGAGGTAGAGGTTGCAGTGAGCCAAGATCATGCCACTGCACTCCAGCCTGGGTGACAGAGGGAGACTCTGTCTCAATAAATAAA"
"GL873592","6794968","6795049","chr3","154764711","154764794","20","147969743","GAAGGTTTGATGAGCTCAGATGATGCCACTGCAGTCTACCCAGAGTGAAGGAGCGAGACTCTGTCTCAAAAACAAAAAAAGA","CAGAGGTTGGCAGTGAGCTGAGACTGTGCCACTGCACTCCAGCCGGGTGACAGAGTGAGACTCTGTCTCAAATTACAAACAAAA"
"GL873592","6881384","6881478","chr5","24882384","24882475","28","18001000","GGGCAGGCATAGTGACTGGTGTCTCTAATCCTAGCAGTCTGGGATGCTGAGGCAAGTGGAATGTCAGAGTTCAGGAGTTGAAGATCACCCTGACT","GGCCGGGCGCAGTGGCTCACATCTATAATCCTAGCATTTTGGGAGGCTGAGGCAGGCGGATCACCTGAAGTCAGGAGTTTAAGACCAGCCTG"
"GL873592","6881755","6881937","chr10","61601371","61601572","66","54719616","TCACCCTGACCAAGAGCAAGACCCTGTCTCTACTAAAAATAGAATAAACTAGCTGGGAATTGTGGTGGGTGCCAGTAGTCCCCGCTACTGAGGCAGGAGGATCATTGAGTCCAAGAGTTTGAGGTTGCTGTAAGTTAGGACACCACAGCACTCTACACAGAGTAAGACTGCCTCAAAAATAAA","AGTAAAGAAAAGAAACCCTGTCTCTACTAAAAATACAAAAATTAGCTGGGTGTGGTGGTGCGCACCTGTAGTCCCAGCTACTTGGGAGGGTGAGGTATGGGAATCACTTGAACCCGGGAGGTGGAGGTTGCAGTGAGCCAAGATCACACCACTGCACTCCAGCCTGGGTGAGAGAGTGAGACTCTGTCTCAAGAAAAAAGAA"
"GL873592","7006080","7006155","chr1","8947061","8947129","24","1940981","CACACTGAGAGGCAAAGGCTGGTGGATCACCTGAGCTCAAGAGTTTGAGACCAGCCAAGCCAGAGATCTTGTCTCT","CACTTTGGAGCCAGGTAGGTGATCACCTGAGTCAGGAGTTCGAGACAGCCTGGCCAACATGTGAAACCC"
"GL873592","8446508","8446655","chr11","122502739","122502874","48","114056231","TTAGCTGGGTGTTGTGGCAGGCACCTGTAGTCCCTCCCAGCTACTTGAAAGGCTGAGGCAAGATGACAGCTTAAACCCAAGAGTTTAAGGTTACTCTATTCAGGGCAACAGAGTGAGACTCCATCTACATAAATAAATAAATAAATAA","GGCTGGGCGTGGTGGTTCACACCTGTAATCCCAACACTTTGGGAGGCTGAGGCCAGCGGATTGCCTGAGCCCAGGAGTTTGAGACCAACCTGGGCAACATGGTGAAACTCCATCTCTACTAAAATACAAAAAGTTA"
"GL873592","8446953","8447008","chr16","44513352","44513404","15","36066399","GACCAGCCTAAGCAAAAAAGAGATCCTATCTCTACTACTAAAAATAGAAAAAATTA","ACCAGCCTCACCAATATGAAGAAACCCCATCTCTACTAAAAATACAAAATATT"
"GL873592","8447239","8447325","chr1","8062863","8062957","21","384376","GGCCAGGAGCAGTGACTCATGCCTAGCACTCTGGGAGGCCAAAGCAGGTGGATCAACTGAGCTCAGGAGTTCAAGACCAGCCTAAGC","GGCCGGGTGCAGTGGCTCATGCCTGTAGTCCCAGGACTTTGGCAGGCCAAGGCCGGTGGATTACCTGAGGTCAGGAGTTCAAAACCAGCCTAGCC"
"GL873592","8723925","8724000","chr3","42066983","42067054","20","33343058","AATTAGCCGGGCATGGTAGTGTGTGCCCATAATCTCAGCTACTCAGAAAGCTAAGATAGGAAAATTGCTTGAGCTC","TTAGCTGGGTGTGGTAGTGCATGCCTATAATCCCAGCTACTCGGGAGGCTGAGGTGGGAGAACTGCTTGAAC"
"GL873593","384022","384146","chr15","102382935","102383070","28","101998913","GGCCACGAGGGCCCATGCCTGTAATCCTAGCACTCTGGGAGGCTGAGGTGAGTAGATTGCTGAGCTCAGGAGTTCAAGACCAGCCTGTGCAAGAGACCCCATCTCTGCTAAAAATAGAAAAACCA","GGCCAGGTGTGGTGGCTCACGCCTGTAATCCTAGCACTTTGGGAGGCTGAGGCGGGTGGATTGCCTGAACTCAGGAGGTCAAGACCAGCCTGGGCAACACAGTAAAACCCCATCTCTACTAAAATACAAAAAATCA"
"GL873593","384425","384607","chr20","28286874","28287058","50","27902449","GAAAGAAAAGAAAAGAAAAACTAGCAAGATGTTGTAGCTGATGCCTATAATCCTAGCTATTGGAGAGGTGGAGGCAAGAGAATTGCGTGAGCCCAAGAGTTGAAGGTTGCTGTGAGCTGCGATGCCAGAGCACTCCAGGGTGACAGAGTAAGACTCTGTCTCAAAAAAAATTACAAAATAAAA","TAATAAAAATAAAAAAATTAGCCAGGAGTCAAAGCACACGCCTATAACCCCAGCTACTTGGGAGGCTGAGGGAGGAGAATTACTTGAACCCGGGAGGTGAAAGTTGCAATGAGCTGAGATCAAGCCACTGCACTCCAGACTGGATGACAGAGTGAGACTCTGTTTCAAAAAAAAAAAAAAGACAA"
"GL873593","1408445","1408467","chr10","88070368","88070389","9","86661923","AATCTAGAGATGGGGAGAGGTTG","AAAGAGATGGAAGAGAAGAAGA"
"GL873593","4856365","4856484","chr7","56497314","56497433","31","51640949","GCAATCCCAGCTGATCGGGAGGCTGACCCAGAAGAATCCCTTGAACCCAAGAGTCTGAGGTTGCTATGGGTGGATTCTACAGCACTCTAGCCTGGGAGACAGAGTGAGACTCTGTCCCAA","ATCCCAGCTACTTGGGAGGCTGAGACAGAAGAATTGCTTGAACCCGGGAGGTGGAGGTTGCAGTGAGCCAAGATTGTACCACTGCACTCCAGCCTGGCAACAGAGTGAGACTCTGTCTCA"
"GL873593","6661298","6661485","chr10","86749316","86749514","55","80088018","GCAGAGGCTCACATATGTAATCCTAGCACTCTGGGAGGATAAGGCAGGTGGACAGCTTGAGCTCAGGGGTTTGACCAGTCTGATCAAGAGCAAGACCTGTGTCTACTAAAAATAGAAAACCTAGCCAGGTATGATGGTAGATGCCTGTATTCCTAGCTACTCTGGAAGCTAAAGCTAAAGAGTTTGAA","GGTGGCTCACACCTGTAATCTTAGCAATTTGGGAGGCCGAGGTGGGTGGATCACTTGAGGTCAGGAGTTTGAGACCAGACTGGCCAACATGGTGAAACTCTGTCTCTACTAAAAATACAAAAATTAGCCAGTCATGGTGGTGCATGCCTGTAATCCCAGCTACTCAGGAAGCTTAGGCAGGAGAATCACTTGAACCCAG"
"GL873593","6710263","6710446","chr14","4390080","4390244","66","2320183","TTGAAGTCAGGAGTTTAAGGCCAGTCTGGGCAACATAGTGAGACCCCCATCTCTACGAAAATATTTTTTAAAAATTAAAAATAGCTGGGCATAGTGAGGCTGTTGTGAGCTATAACTGCACCACTGCACTCAGCCAAGGACAGAGACCCTGTTCCCTGCCTCAAACAAACCAAAACAAAACAAA","AAGTCTAGAGTTTACAGCCTGGACAACGCAGTGAAACCCTGTCTCTACCAAAAATACAAAAATTAGACAGGTGTGAGAGGCGGAGGTTGCAATGAGCTGAGATCGCAGCACTGCAGTCCAGCCTGGATGACAGAGCGAGACCCCATCTCAAAAACAAAAACAAAA"
"GL873593","7159645","7159716","chr6","178318394","178318465","21","171158749","GATCATGTCACTGCTCTCCAACCTGGGCAATTGAGCAGGAATCTGTCTCAAAAAGAAAAAAAAAAAAGAAAA","CGAGTTCACACCACTGCACCCCAGCCTGGGCAACAGAATGAGACTCGGTTTCAAAAAAAAAAAAAAAAAAAA"
"GL873593","7159841","7160050","chr13","33368171","33368368","69","26208330","GGCCAGGCGTGGTGGCTCACACCTGTTGTCCCAGTGCTGTGGGAAGCCGAGGCAGGTGGATCACCTGAGCTCAGCCGAGTTCGAGACCAGTGGAAGACCAGCATGAGGCAGAGTGAGCCAGAGTGAGACCCCATCTCTACAACAACAACAAGAAGAAAAAAAACAGCCGGACCTTGTGATCCCAGCTACGTGGGGAGCTAGAGAATCACT","GGCTAGGCATGGTGGCTCATGCCAGTAATCCCACCACTTTGGGAGGCCGAGGCAGGTGGATCACCTGAGGTCAGGAGTTCAAGACCAGGCTGGCCAACATGTTATGATGAGACCCTCATCTCTACTACAAATACAAAAATCAGCTGGGCATGGTGGCAAGTGCCTGTAATCCCAGCTACTTGGGAGGCTGAGGCAGAA"
"GL873593","8598292","8598391","chr11","118461023","118461129","33","109862731","AGCCAGGTGAGGTGGTTCACACCTGTAACCCTAGCTGCTTGGGAGGCTGAGGCCTCTCTATCCTGGGCAGTGTGGAGAAACTTTGTTTCAAAAAAAAGAA","GCCGGGCGCGGTGGCTCACGTCTGTAATCCCAGCGCTTTGGGAAGCCGAGGCGGGACTATCCTGGCCAACATGGTGAAACCCCGTCTCTACTAAAAATACAAGAATC"
"GL873594","357249","357377","chr2","75702890","75703011","36","75345641","CCTGGTACCGTAGGTCATGCCTGTAATCCTAGCACTTTGGGATGCTGAGGTGGGCAGATTGCCTGAGCTCACGAGTTCAAGCCATTAGAACTGAGCCTGACCTAGAGTGGGACCTCCAACTCTTTTTTT","GCCAGGCACAGTGGCTCATGCCTGTAATCCCAGCAGTTTGGGAGGCTGAGGTGGGCAGATCACTTGAGGTCAGGAGTTCAAGACCAGCCTGGCTGACATGGTGAAACCCCATCTATACCAAA"
"GL873594","357656","357834","chr7","17608776","17608965","55","17251120","GGGACCTCCAACTCTTAAAATAGCTGGGCATTGTGGTGGGCACCTACAGTCACAGCTACTTGGGAGGCTAAGGCAAGAGACTTGTTTGCAGCCAAGAGTTAGAGGTTGCTGTGAGCTATGAGGCTAGGGCACTCTACAGGGGGCGACAAGTGAGACTGTAAAAAAAAAAAAAGAAAAAA","GTCCCTACTAAAAATACAAAAAATTAGCTGGGCCTGGTGGCAGGCACCTGTAATCCCAGCTACTTGGGAAGCTGAGGCAAGAGAATTGCTTGAACCCAGGAGGCAGAGGTTGCAGTGAGCTGACATCAAGCCACTGTACTCCAGCCTAGGCAACAAGAGCAAGACTCTGTCTCAAAAAAAAAAAAAAAAA"
"GL873594","1410711","1410996","chr5","151340503","151340797","76","149929792","CACAGTGGCTCATACCTATAATCCTAACACTCTGGGAGGCCAAGGTGGGTGGACTGTCTGAGTTTGGGACCAGCCTGAGCAAAAGCAAGACTCCCATCTCTACTAAAAACAAAGACAGCCAGGTATGAGGGCAGGTGCCTATCATCCCAGCTACTTGGGAGGCTGAGGAAGGAGGATCACCTAAGCCCAGGACTTTAAGGTTTCTGTGAACTAAGATGATGTTACAACACTCTAGCCAGGGTAACAAGGCAAGATTCTGTTTCAAAAGACAAAAAAAAAAAAAAAA","GGTGGTTCATGCCTGTAATCCCAGCACTTTGGGAGGCTGAGGCAGGTGGATCACCTGAGGTCAGGAGTTCGGGACCAGCCTGGCCAACATGGGGAAACCCCATCTCTACTAAAATACAAAAATTAGCCAGGTATGGTGGCACATGCCTATAATCCCAGCTACTTGGGAGGCTGAGGCAGGAGAATCACTTGAACCCAGGAGGCTAAGGTTGCAGTGAGCCGAGATTGTGCCACTGTACTCCAGCCTGGGTGACAGACTGAAACTCTGTGTCCAAAAAACAAAACAAAACAAAAAA"
"GL873594","5528090","5528162","chr2","69013639","69013718","24","63485549","GGTACAGTGGCTCACGCTTGTGATCCCAGGTTGAGGTGGGTGGATCGCCTGAGCTCAGGAGTTGGATGCCAGC","GGTGTGGTGCCTCACGCCTATAATCCCAGCACTTTGGGAGGCAGGTGGATCACTTGAGGTCAGGAGTTTGAGAACAGCCT"
"GL873594","5834047","5834168","chr2","82491537","82491662","28","76657490","GGCTGGGCCCAGTAGCTCACGACTGTAATCCCAGCACTCTGGGAAGCTGAGGTGGGCGGATCACCTGAGCTCATAGGTTCGAGACCAGCTCCAGTTAGAGTGAGAGCCTGTCTCTAAAAATA","GGCTGGGCACAGTGGCTCATGCCTGCAATCCCAGCACTTTGGGAGGCTGAGGTGGGCAGATCACCTGAAGTCAGGAGTTCAAGACCAGCCTGGCCAACACAGTGAAACCCCATCTCTACTAAAAAT"
"GL873594","5834396","5834461","chr13","14688151","14688212","20","8853755","TATATAATAATAATAACCAGGTATTGTGGCAGGTGCCTCTAGTCCCAGCTACTCGGGAGGCAAAGG","ATAAAAAAATTAGCTGGCCATGGTGGCACATACCAATAATCCCAGCTACTCAGGAGGCTGAG"
"GL873594","7786130","7786294","chr14","12217087","12217250","37","4430957","GGGTGTGCTGGCTCATACCTATAATCCTAGCACTCTGGGAGGCTGAGGTAGGTGTATTGCTTGAACCCAGGAGTCTGAGGTTGCTGTGCGCTAAGCTGATACCATAGCACTCTAGCCTGGGCAACAGAGTGAGACTCTGTCTCAAAACAAATAAATAGTAAAAAA","GCTGGGCGTGGTGGCTCACACCTGTAATCCCAGCACTTTGGGAGGCCAAGGCATGAGAATTGCTTGAAAACAGGAGGCGGAGGTTGCAGTAAGCTGAGACTGTGCCATTGCACTCCAGCCTGGGCAACAAGAGTGAAACTCTGTCTCAGAAAAAAAGAAAAAAA"
"GL873595","723579","723774","chr19","6045933","6046125","65","5322354","GCCTGAGCAGGAGAGAGACCCCATCTCTGCTGAAAGTGGAAAAGTTGGCTGAGTGTAGTGGCGGGCTGCTGCCCCAGTCACTCAGGAGGCTTAGGAAGGAGTATCGCTTGGGCCCAAGATTTGAGGTTGCTGTGAGCGCTACAAAGACATTAGGGTACTCTACACAGGGGAATAGAGTGAGACTGTCTCAAAAAAA","CAACATGGAGAAACCCCGTCTCTACTAAAAATACAAAATTAGGCAGCGTGGTGGTGGGTGCCTATAATCCCAGCTACTCAGGAGGCTGAGGCAGGAGAATCGCTTGACCGGGAGTGGAGGTTGCGGTGAGCTGAGATTGCACCATTGCACTCCAGCCTGGGCAACAAGAGTGAAACTCCGTCTCAAAAAGAAA"
"GL873595","724114","724204","chr20","18199749","18199840","22","17475635","GGCCATGCTTGGTGGTTCTCATCTGTAATCCTAGCACTCTGGAAGGTCTACAGGGGTGGATGGCTGGAGGTCAGGAGTTCAAGACTGGCCT","GGCCGGGCATGGTGGCTCACACCTGTAATCCCAGCACTTTGGGAGGCTGAGGCAGGCGGATCACCTGAGGTCAGGAGTTCGAGACCGGCCTG"
"GL873595","1065346","1065667","chr18","10529729","10530057","74","9464383","GGCCAGGTGCAGCAGCTCATGCCTGGAATCTTCCTGCTCTGTATGGCCAAGGCAGGTGGATCGCCTGACCTCAGGAGTTCCAGACCAGCCTGAACAAGAGCAAGACTCTGTCTCTACTAAAAGTAGAAAAAAAACTAGCCAGTCATAGTGGCAGGTGCCTGTAGTCCCAGCTGCTTGGGAGGCTGAGGCAAGAGGATCACTTGAACCTAAGAGTTTGAGGTTGCTGTGAGCTAAGATGCCACATCACTCTATCAAGGGTGACCAAGTGAGACTCTGTCTCAAAAATAAATAAATAAATAAATAAAAAGAAAGGCAAAAAGAA","GGCCCGGCGTGGTGGCTCATGCCTATAATCCCAGCCCTTTGGGAGGCCAAGGCAGGTGGATCACCTGAGGTCAGGCGTTCGAGACCAGCCTGACCAACGTGGTGAAACCTCATCTCTACTAAATACAAAAAAAATTTAGCCAGGCATGGAGGCACATGCCTGTAATCCCAGCTACTTGGGAGGCTGTGGCAGGAGAATCACTTGAACCTGGGAGGTGGAAGTTGCAGTGAGCTGAGATTGTACCACTGCACTCCAACCTGGGTGACAAAGCAAGACTCGGTCTCAATAAATAAATAAATAAATAAATAAATAAATAAAGTGAAAAAAAA"
"GL873595","1254878","1255146","chr4","42822326","42822607","67","41567448","GGCTGGGCATGGTGGCTCATGCCTGTAATCCTACCGCTCTGGGAGGCTGAGGCAGAGGATCACTTGAGCTCAGGAGTTTCAGACCAGCCTGCAAGAAGGACCCAGTCTCTGCCGAAAATAGAAAAGTTAGCAAGGCGTTGTCGTGAGCACATGTATCCCAGCTACCTAGAACTCTGAGGCAGGAGGATCCCTTGAACCCACAGAAGTTGCTGTTATCTAAACTGATGCCACTGGACTCTAGCCTGGGCAACAGAGTGAGACTGGTCTCA","GGCCGGGCACGGTGGCTCATGCCTGTAATCCTAGCATTTTGGGAGGCTGAGACAGGCAGATTGCCTGAGCTCAGGAGTTCAAGACCAGCCTGGGCTAGATTGTGAAACCCCATCTCTACTAAAATATAAAAATTAGCTGGGTGTGGTGGCACACGCCTGTAATCCCAGCTACCTGGGAGGCTGAGGCAGGAGAATCGCTTGAACCAGGAGACAGAGGTTGCAGTGAGCTGAGATCACGCCACTGCACTTTAGCCTGGGCAACAGAGTGATACTCTGTCTCAA"
"GL873595","3417105","3417297","chr12","115674238","115674427","44","112257133","GGCCGGGCGCTGTGCCTCACGCCTGTAATCCTAATACTCTGAGAGGCCGAGGCAGGTGGATTGCCTGAGCTCAGGTGCTCAAGACAGCCTGACTGAGCAAGCCCTGAGATCCCATCTCCACTAACAATAGTAAAACTAGCCGGGCATTGTGGTGGTGCTTGTAATCCCAGCTACTGGGAGGCTAAGACAGGAG","CCAGGCCTGGTGGCTCACGCCTGTAATCCCAGCACTTTGGGAGGCCGAGGTGGGTAGATCACCTGAGGTCAGGAGTTCAAGACCAGCCTGGCCAACATGGCGAAACCCCATCTCTACTAAAAATACAAAAATTAGCTGGGCATGGTGGTGTATGCCTGTAATCCCAGCTACTCGGGAGGCTGAGGCAGGA"
"GL873595","6098380","6098457","chr3","87492619","87492702","21","81394239","GCTGTGGCTCATGCTGATAATACCAGCACTCTGGGAGAACAAGGTAGGCAGATCACAAGAGGTCACCTGTGCAAGACC","GGGCTGGTGGTGGCTCATGCCTGTAATACCAGCACTTTGGGAGGCCAAGACAGGTGGATCACCAAAGGTCAAGAGTTCAAGACC"
"GL873596","134190","134307","chr1","203207333","203207443","31","203073143","GGCTGGGCGAGGTGGCTCACACCTGTAATCCTAGCACTCTGGAAGGCCCTAGCACTCAGGCAGTTGGATTGCCTGAGCTCACAAGTTCAAGACCAGCCTGAAAAAGAGCAAGACCTCA","GGCTGGGTGCAGTGGCTCACACCTGTAATCCCAGCACTTTGGGAGGCCGAGATGGGTGGATCACTTGAGGTCAAGAGTTGAAGACCAGCCTGGACAACATGATGAGACCCC"
"GL873596","134578","134681","chr11","50235285","50235387","37","50100707","CAAACAAAAGAGGAAGACCTCGTCTCTAAAAAAATAGCTGGGCATTGTGAGGAGTACCTGTAGTCCTAGCTACTCAGAAGGCTGAGACAAGAGAATCACTTAAA","CAACATTGTGAAACCCTGTCTCTACTAAAATAGAAAATTAGCCAGGTGTGTGGGCGTGCCTATAATCCTAGCTACTGGGGAGGGTGAGGCATGAGAATCGCCT"
"GL873596","8160215","8160350","chr1","29437872","29437991","30","21277657","GGCCGGGCGTGGTGGCGCACACCTGTAGTCCCAGCGCTATGGGAGGCCGAGGCGGGTGGATCACCTGAGCTCAGAGGTTCGAGACCAGCCAAGACCCCCCTGAGCCAAACGAGCCAGAGTGAGACCCCGTCTCTAC","GGCCGGGCGTGGTGGCTCACGCCTGTAATCCCAACATTTTGGGAGGCCAAGGCGGGTGGATCACCTGAGGTCAGAAGTTCGAGACCAACCTGGCCAACATGGTGAAACCCCTGTCTCTAC"
"GL873596","8421071","8421132","chr20","1874027","1874093","12","6547044","GTCAGGCGCAGTGGCTCACGCCTGTAATCTCAGCACTCTGAGAAGCCAAGGCAGGATCATCT","GGCCAGGCGCAGTGGCTCAGGCCTGTAATCCCAGCACTTTGGGAAGCCAAGGTGAGCAGATCACCTG"
"GL873598","4416400","4416489","chr5","39418145","39418231","15","35001745","GGCCAAGTGTGGTGGCTCATGCCTGTTGTCCCAGCACCGTGGGAGGCCGAGGCTGGTGGAACACCTGAGCTCAGCTGAGTTTGAGACCAG","GGCCAGTTGCGGTGGCTCATGCCTGTAATCCCAGCACTTTGGCAGGCTGAGGCAGGTGGATCACCTGAGGTCAGGAGTTTGAGACCA"
"GL873598","4416855","4416947","chr3","94091253","94091337","31","89674398","GTGAGACCCTGTCTCTACAAAAAAAAAAGCTGGGCACTGTGGCATGTGCCTGTAATCCCAGCTACTTGGGAGGCAAAGGGAAAGAGAATCACT","AAACCTTGCCTTTACTAGAAATACAAAAATTAGCTGGGCATGGTGGCAGGTACCTGTAATCCCAGCTACTTGGGAGGCTGAGGCA"
"GL873598","5126074","5126161","chr1","12339306","12339394","19","7213232","GCCTGGTGCACTGGTTCACACCTGGAATCCTTGCATTCTGAGAGGCCCAGGTAGGCAGATCACCTCAGCTCAGAAGTTCGAGACCAGC","GCTGGGTGCGGTGGTTCACGTCTGTAATCCCAGCACTTTGGGAGGCCGAGGCGGGCAGATCACCTGAGGTCAGGAGTTCGAGACCAGCC"
"GL873598","5467584","5467662","chr1","9313328","9313403","17","3845744","GCGAGGTGGCTCACGCCTGTAATCCCAGCACATTTGGAAGGCCAAGGAGGGTGGATCACCCGAGCTCACCAGTTGGAGA","CGCAGTGGCTCACGCCTGTAATCCCAGCACTTTGGGAGGCCGAGGCAGGCAGATCACCTGAAGTCAGGAGTTTGAG"
"GL873598","6917752","6917856","chr14","9558287","9558382","22","2640535","GGCCAGGCATGGTGGCTTGTGCCTGTTGTCCCAGCACTGTGGAAGGCCGAGGCGGGTGGATCGCCTGAGCTCAGCTGAATTCGAGACCAGCATAAGACCAGTATG","GGCCAGGCATGGTGGCTTATGCCTGTAATCCCAGCACCTTGGAAGGCCGAAGCGGGCAGATCACCTGAGCTCAGGAGTTTGAGACCAGCCTGTCCA"
"GL873598","8078910","8079062","chr7","164825511","164825660","43","156746601","AACAGCCAGGCATTGTGGTGGGCACCTGTAATCCCAGCTACTTGGGAGGCTGAGGCAAGAGAATTGCTTGAGCCCAACAGTCTCAGGTTACTGTGAGTTATGACACCATGGCACTCTATTGAGGGCAAGAAAGTGAGACTGTCTTGGAAAAAA","CTAGCCAGGCATGGTGGTGCGCACCTGTAGTCCCAGTTACTTGGGAGGTTGAGGCAAGAGAATTGCTTGAGCCTGGAAGGCAGAAGTTGCAGTGAGCTGAGATCACACCACTGCATTCCAGCCTGGGCGAAAGAGCAAGACTCTGTTGAA"
"GL873598","8079328","8079454","chr6","10381248","10381379","32","2301920","GCCCGGCGTGGTGGCTCACGCCTGTAATTCCAGCACTCTGGGGAGGCCGAGGAGGGCAGATTGCCTGAGCTCACAGGTTTGAGCTAGAGCGAGACCCTGTCTCTTAAAAAGAAAAAAAAGGAAAGAA","GCTGGGCGCGGTGGCTCACGCCTGTAATCCCAACACTTTGGGAGGCCGAGGCGGGCAGATCACCAGAGGTGATCTCCAGCCTGGGCAGGAGAGCAAGACCCTGTCTCAAAAAATTTAGAAAAAGGAAAGAAA"
"GL873599","3943256","3943456","chr9","35892110","35892312","79","31948854","GGCAGGCTGCTTTGACCCATATCTACAACTCCAGAACTTTAGAGGCTGAGCTGGGTGGGTCCCTTGAGATTAGAAACTGCTTAGTAGCCTGGCAAAAACCAGACCCCACCTCCACCATGTAGAAAAATTAGCAGTATGCCATAGTGGGAACCTACCAATACAGTCTTTCCAAAGGCCAAAGCTAGAAGGACCGTGAGCTTG","GGCTGGGTGTGGTGGCTCATGCCTATAATTCCAGCACTTTGGGAGGCCGAGGCAGGTGGATCACCTGAGGCCAGGAGTTTGAGACCAGCCTGGCCAATATGGTGAAACCCCATCTCTACTAAAAGTACAGAAAATTAGTCAGTCATGATGGCGCATGCCTATAATCCCAGTTACTCGGGAGGCTAAGGTAGGAGAATTGCTTG"
"GL873599","6693284","6693349","chr1","100916857","100916922","15","94223573","TCACGTCTATAATCCTAGCACTCTGGGAGTCCTTGGCAGGTGGATCACCTGAGCTCAGGAGTTTGA","CATGCCTGTAATCCCAGCACCTTGGGAGGCCAAGGTGGGTGGATCACCTGAGGTCAGTAGTTTGAG"
"GL873600","991618","991705","chr15","13850109","13850195","15","12858491","GGCTGGGCGTGGTGGCTCACACCTGTTGTCCCAGCGCTGTGGGAGGCTGAGGCAGGTGGATCACCTGTGCTCAGAGGTTGAGACCAGC","GCCGGGCGCTGTGGCTCACACTTGTAATCCCAGCACTTTGGGAGGCTGAGGCAGGTGGATCACCTGAGGTCAGGAGTTAGAGACCAG"
"GL873600","8825981","8826014","chr16","43605817","43605844","11","34779836","AGTCTGGGGCAACAGAGCAAGACTCTGTCTCAAA","CAGTCTGGGTGACAGAGCAAGATTCCAT"
"GL873600","8826039","8826157","chr13","87428402","87428520","35","78602363","ATTAGCCTGGTGTGGTGGTATATGCCTTCCTGCCTGCTTGGGAGGCTGAGGCAGGAAGTATGCTTTAACTGTGGAGTCTGAGGTTGCTATGAGCTAGGTTGAGGCCATGGCACTCTAAA","TTAGCCGGGTGTGGTGGTGCACGCCTGTAATCCCAGCTACTCAGGAGGCTGAAGCAGGAGAGTTGCTTGAACCCAGGAGTTGGAGGTTGCAGTGAGCTGAGATCACGCCATTGCACTCC"
"GL873601","269289","269338","chr14","49279240","49279285","14","49009951","GACTGGGTGTGGTGGCTCACACCTTTAATCCTAACACCCTGGGAGGCTTA","GGCTGAGATGGTGGCACACACCTGTAATCCCAGCTACTTGGGAGGC"
"GL873601","269431","269678","chr1","184453273","184453521","76","184183842","AGAAGATCACTCAAGATCAGGAGTTTGAGAACAGCCTGAGCAAGACCCCCATCTTTACTAAAAATGGAAAAGTTTTTACCCAGGCATGGTAGTGCGTGCCTGTATCCCATCTACTCCGGAGGCTGATAGGAGGATTGCTTCAACCAAGGAGTTTGAGGTTCCAGAGACTTAAGATGACACAACTGCATTTTACCCAGTGTGACACAGCGAGACTCTTTCAGAAGAATTTTTAAAAGGAAAAAAAAGAA","GGTCAGATCACCTGAGGTCAGGAGTTTGAGACCAGCCTGACCAACATGGTAAAACCCCATCTCTGCTAAAAATACAAAAAATTAGCCAGGCATGGTGGTGAACGCCTGTAATCCTAGCTACTCAGGAGGCAAAGACAGGAGAATCGCTTGAATCTGGAAGGTGGAGGTTGCAATGAGCCAAGATGACGCCACTGCACTCCAACCTGGGTGACAGAGGAAGACTCCATCAAAAAAAAAAAAAAAAAAAAA"
"GL873601","1397978","1398117","chr16","24839455","24839591","34","23441477","GCCTATAATCCTAGCACTCTGGAAGGCTGAGGCAGGAAGATCACTAGAGCTTGGGAGTTTGAGATTGCTGTGAGGGAGACTGACTCCATGGCACTCTAGCCTGAGGCAACAGAGTAAGACTCCATCTCAAAAAAAAAAAA","CTCTAACTCCAGCTACTCAGGAGGCTGAAGCAGGAAAATCACTTGAACCTGGGAGGTGGAGGTTACAGTGAGCCAAGATCACACCATTGCACTCCAGCCTGAGCGACAGAGCGAGACTCTGTCTCAAAATAAATAAA"
"GL873601","4065502","4065590","chr11","108711352","108711444","19","104645850","GCTGGATGTGGTGGCTCTCACCTATAATCCTAGCACTCTGGGAGGTCAAAACAGGTGGATCACCTGAGCTCAGGAGCAAGAACACCAGC","GTCAGGGGTGGTGGCTCACGCCTGTAATCCCAGCACTTTGGGAGGCCAAGGCAGGTGGATCGCCTGAGCTCAGGAGTTCAAGACCAGCCTTGC"
"GL873601","8241370","8241465","chrY","9469734","9469829","34","1228364","AAAAAAGGTGGAGATGAGCCATGCGCAGTGGTGTAGGCCTGTAATCCCAGCCCTTGGGAGGCCAAAATGGTGGATTGCCTGAAGCAGAGCAAGACC","AAAGTACAAAGAGTCTGGGTACAGTGGCCCAAGCCTGTAATCCCAGCAGTTTGGGAGGACAAGATGGGTAGATCACCTGACATCATGAATTAGAGA"
"GL873569","7519122","7519191","chrX","79016364","79016431","16","71497242","TTGGCCAGGCATGGTCGCTCAGGCTGTAATACCAGCTACTTGGGAAGCTGAAGCAGGAGGATCACTTGAA","TTGGCCAGGCACGGTGGCTCATGCTTATAATCCCAGCTACTCGTGAGGCTGAGGCAGGGGAATCGCTT"
"GL873569","7989158","7989286","chr8","41505677","41505810","35","33516519","AGTCCCACCTATTTGGAAGGCTGAGGCAAGAGGATCACTTGAACTCAGCAGTTTGACATTGCTATGAGTTAGATTGACTCCATGGCACTCTAGCCCAGGCAACAGAGCAAGACTCCGTCTCAAAACAAA","TAATACCAGCTACGTGGGAGGCTGAGGCAGGAGAATCACTTGAACCCGGGAGGTGGAGGTTGCAGTGAGCTGAGATTGCACCGTTGCACTCTAACCTGGGCAACAAAAGCAAAACTCTGTCTCAAAAAAAAAAA"
"GL873569","7989575","7989702","chr1","62231025","62231129","47","54241450","GGCTGGGTAATGCAGTGGCTCACGCCTATAATCCTAGTGCTTTGAGAGGCCAAGAGTGAGACTCTGTGTACTAAAAATAGAAAAATTACCTAGGCATTCTGGTGGGCACCAGTAGTCCCACCTATTTG","GGCTGGGCATGGTGGCTCACGCCTATAATCCCAGCACTTTGGGAGGCCGAGGCAGGTGGATCACCTGAGATCAGGAGTTTGAGACCAGACTGGCCAACATGGTGA"
"GL873569","10034363","10034556","chr10","61268396","61268605","62","51234033","CAGCTTGAGCAAAAGTGAGCCCCTGTCTCTACTGAAAATAGAAAAAATTAGCCAGGCGTGGTGGCACACACTTATAGTCCCAGCCACTTAGGAGGCTGAGGCAGGAGTTTGAGGTTGACATAATCTAAGCTGATACCATAGCACTCTAGCCTGGGCAATAGAGTGAGACTCTGTCTCAAAGAAGAAATTTATCT","CCTGACCAATGGTGAAACCCTGTCTCTACCAAAAATACAAAATTTAGCTGGGCATGGGGGCACGCACCTGTAGTCCTAGCTACTCGGGAGGCTGAGACAGGAGAACTGCTTGAACTCGGGAGGCAGAGGTTGCAGTGAGCTGAGATCATGCCACTGCACTCTAGCCTGGGCAATAGAGTGAGACTCCGTCTCAAAAAAAAAAAAAAAAAA"
"GL873569","10034830","10034845","chr1","217667782","217667796","2","207632952","AAAAAAGAAGAAAAAA","AAGAAAAAGAAAAAA"
"GL873569","10203815","10203922","chr8","96374555","96374671","35","86170740","GCCAGGTGTAGTGGTTCACACCTATAATCCTAGCACTCTGGGAGCCTGAAGCAGGTAAATGGACTGAGCAAGAGTGAGACTTCCACCTCTATTGAAAATAGAAAAATT","GGCTAGGTATGGTGGCTGATGCCTATAATCCCAGAATTTTGGGAGGCCGAGGCAGGCAGATCATCTGAGGTCAGGAGTTTGAGACCAGTCCCGTCTCTACTAAAAATACAAAAATTA"
"GL873569","10204196","10204373","chr20","1304385","1304559","47","8899811","GAAAATAGAAAAATTAGCCAGGCATTATAGCAGGCACCAGTAATCCCAGTTACTTGGGAGGCTAAGGCAAAAGAATCTCTTGAGCCCAAGTTTGGGGTTGCTAGGAAGTAAAACACCACAGCACTATACCCAGAACAAGAGAGTGAAGACTCAGTCTCAAAAAGATAAATAAATAAAA","AAAAATACAAAAATTAGCCAGGCATGGTGGCGGGCGTCTGTAACTCCAGCTACTTGGGAGACTGAGGCAGGAGAATCGCTTGAACCCAGGAGGCAGAGGTTACAGGTGAAATCACACCACTGCACTCCAGCCTGGGCAACAGGGCAAGACTCTGTCTCAAAAAAAAAAAAAAAAA"
"GL873569","10473375","10473444","chr8","20660648","20660717","21","10187273","TGTAGTCCCAGCACTTTGGGAGGTTAAGGCAAGAGTAGCACCCAACATGAGGAGATCAAGACCAATCTGG","CTGTAGTCCCAGCACTTTGGGAGGCTGAGGCAGGTGGATCCTTTGAGGGCAGAACTTTAAGACCAGCCTG"
"GL873570","9287350","9287485","chr1","29437872","29437991","30","20150522","GGCCGGGCGTGGTGGCGCACGCCTGTAGTCCCAGCGCTATGGGAGGCCGAGGCGGGTGGATCACCTGTGCTCAGAGGTTCGAGACCAGCCAAGACCCCCCTGAGCCAAACGAGCCAGAGTGAGACCCCGTCTCTAC","GGCCGGGCGTGGTGGCTCACGCCTGTAATCCCAACATTTTGGGAGGCCAAGGCGGGTGGATCACCTGAGGTCAGAAGTTCGAGACCAACCTGGCCAACATGGTGAAACCCCTGTCTCTAC"
"GL873571","3669989","3670207","chr4","116777080","116777297","60","113107091","AGACCAGCCTGAGGAAGAGCAAGATCCCATCTCTATTAAAAATAGAAAAATTAGCCAGGCATTCTGGTGGGCACCTGTAGTTCTAACCACCTGGGAGGCTAAGGCAAGAGGAACTCTTCAACCCAAGAGTTTGAGGTTGCTGAGAGCTAGGCTAAGGCTGCAGCACTCTAGCCTGGGCAACAGAGTGAGACTGTTTCTCAAAAACAAAAAACAAAAAAA","CGAGACCAGCCTGGTCAATATGGTGAAACCCCGTCCCTACTAAAAATACAAAAATTAGCCAGGCATGGTGGCAGGCACCTGTAGTCCCAGCTACTCGGAAGGCTGAGGCAGGAGAATCGCTTGAACCACAGAGGCAGAGGTTGCAGTGAGCCGAGACTGCACCACTGCACTCCAGCCTGGGCGACAGAGTGAGACTCAGTCTCAAAAAAAAAAAAAAA"
"GL873571","106134","106236","chr4","18143723","18143826","27","18037589","GGCCAGTCTCAGTGGCTCACACCTGTAATCCAGCATTCTGGGAGGCTGAAGCACACGGTCACCTGAGCTCAAAGGTTGGAGACCAGAGTGAGACCCCACCTCT","GGCCAGGCGCAGTGGCTCACTCCTGTAATCCCAGCACTTTGAGGCTGAGGCAGGCGGATCACCTGAGGTCAGGAGTTTGAGACCAGCCTGGCCGAAACCCCATC"
"GL873571","3670496","3670589","chr7","50468399","50468491","15","46797903","GGGCAGGCATGGTGGCTCACACCTGTAATTCTAGCACTCTTGGAGGCTGAGGCAGGAAAATGGCTTGAGGTCAGGAGTTCAAGACCAGCCTGAG","GGCCAGTCATGGTTGCTCACACCTGTAATACCAGCACTTTGGGAGGCCGAGGCAGGCGAATCACCTGAAGTCAGGAGTTCAAGACCAGCCTGG"
"GL873571","4059090","4059389","chr7","52903696","52903994","88","48844606","GGCCAGGTGCAGTGGTTCACACTTATAATCCTAGCACTCTGGGAGGCCGAGGCGAGTGAAGTGCCTGAGCTCATGGGTTCAAGACCAACCTAAGCCAGAGACCCCTGACTCTTATAATAGCCTGGCATTGTGGTGGGCGCCAATATTTCCAGCTACTCTGAGGCTAAGGCAAGAGAATTGCTTGAGCCCAGGAGTTGGAGGTTTCTGTGAGCACTGACGCCGCAGCTCTCTACCAAGGGCAACAAAGACTCTGTCTCAAAAAATAAATAAATAAATAAATAACAGAATGAAAATGAAAAA","GGCCGGGTGCGGTGGTTCACGCCTGTAATCCCACCACTTTGGGAGGCTGAGGCAGGCAGGTCACCTGAGGTCAGGAGTTCCAGACCAGCCTGGCCAACATGGTGAAACCTTGTCTCGGCTATTAGCCTGGCATGGTGGTGCGTGCCCATAATCCCAGCTACTCAGGAGGCTGAGGCAGGAGAATCGCTTGAACCCAGAAGGTGGAGGTTGCAGTGAGCCAAGATAGCACCACTGCAACTCCAGTCTGGGCAACAGAATGAGACTCTGTCTCAAAAAAAAAAAACAAAAAACAAAAAGAA"
"GL873571","4209418","4209704","chr11","32517699","32517985","80","28308281","GGCTTGGCAAGGTGGCTTACACCTCAAATCCTAGCACTGTGGGAGACTGAGGCAGGTGGATTGTTTGAGCTCAGGAGGTCAAGATAGAGAGCAAGAGCAAGTCTCTGTCTCTACTAAAAATAGAAAAGAACTACTTCCCGGGGGTCATGGCAGTAGCCTGTAATCCCAGTTACTAGGTAGAATGAGGCAAGAGGATCTGTTGAAGCCAAGAGACTGAGGTTGTTATGAGCATGCCACAGCACTCTACCCAGGGTGACAGAATGAGACTCTGTTGAAAGAAAAAAAGA","GGCCGGGTGCAGTGGCTCACACCTGTAATCCCAGCACTTTGGGAGGCTGAGGCGGGTGGATCACCTGAGGTCAGGAGTTCAAGACCAGCCTGACAAACATAGTGAAACCCTGTCTCTACTGAAAATACAAAATTAGCCAGGTGTGGTGGCGCATGCCTGTAATCCCAGCTACTCGGGAGGCTGAGGCAGGAGAATTGCTTGAATCCAGGAGGTGGAGGTTGTGTGATCACACCACTGCACTCCAGCCTGGGCGACAGAGTGAGACTCTGTCTCAAAAAAAAAAGAAA"
"GL873571","4209985","4210154","chr3","175781758","175781928","60","171571773","GAAAGAAATGAAAAGAAAGAAGTTAGCTGGTTGTTGGGGTATGCTTCTATAGTCCCACCTACTCAGAAAGCTGAAATCTGGAGTTTGGGGTTGTTGTAAGGTAGGCTGATGACATAGCACTGTAGCTTGGGCAAGAGAGTGTGACTTTGTCTCAAAAAAAATTAAAACAA","ATTAAAAACACAAAGATTAGCCAGGTGTGATGGCACACAACTGTAATCCCAACTACTCAGGAGAATCGCTTGAACCTGGGAGATAGGGTTTGCAGTGAGCCAAGATTGTGCCACTGCACTCCAGCCTGGGTGACAGAGTGAGACTCTGTCTCCAAAAAAAAAAAAAAAAAA"
"GL873571","4210444","4210570","chr17","16655655","16655789","35","12445211","GCCAGGCAGATGGCTCACACTTCATCCTAGCCCTCTGGAAGGCTGAGGCAGGCTAATTTTTTGAGGTTAGGAGTTTGAGACCAGCCTGAGGAAGAGACCCATCTCTACTTTAAAAAATAAATGGAAA","GCCAGGCATGGTGGCTCACACCTGTAATCCTAGCACTTTGGGAGACTGAGGCGGGTGAATCACCTGAGGTCAGGAGTTTGAGACCAGCCTGACCAGTATGGTGAAACCCAGTCTCTACTAAAAATACAGAAATTA"
"GL873571","4391733","4391878","chr11","33723808","33723943","46","29332075","AACTTAGCTGGGAATGGTGGCTCAAGCCTGTAATCCTAGCACTCTGGGAGGCTCAGGTGGGAGGATCACTTGAGGTTGCTGTGAGCTTGGCTGATGCCAGGACACTCTAGTGTGGGCAAGAGAGTGAGACTCCGCCTCAACAACAA","GCCGGGTGCAGTGGCTCATACCTGTAATCCCAGCACTTTGGGAGGCTGAGGTAGGCGGATCACGAGGTCAGGAGCTGAGATGGCGCCACTGCACCCCAGCCTGGGTGACAGAGCAAGACTCTGTCTCAAAAAAAAA"
"GL873571","6307773","6307841","chr9","62429628","62429694","22","56121855","CTGGGTGTGGTGGCATTGCACCTGTAATCCTAGCTACTTGGAAATCTTAAGCCCAGGAGTTGAAGACTG","CCCAGCATGGTGGTGCATACCTATAATCTCAGCTACTTGGAGGCTTGAGCTCAGAAGTTTGAGACCG"
"GL873571","6496217","6496306","chr1","27257765","27257856","27","20761548","GCAGGGTGTGTTGACCCACACCCACAATTCCAGGACTCTGGGGGGCCAGGGATGGTGGGTTCCCTCAGATCAGGAGCTCCTTACCAGCCT","GACTGGGCATGATGGCTCAAATCTGTAATTCCAGCACTTTGGGAGGCCGAGGTGGGTGGATTGCCTGAGATCAGGAGTTCAAGACCAGCCTG"
"GL873571","6499738","6499903","chr1","38976375","38976555","47","32476637","AAAATAACATGAATTGACTAGGCGAGGTGGCTCACATCTCTAATCCTAGCACTCTGGGAGGCTGAGGCAGGAGAATTGCATGAGGTTGCTGTGAGCTATGATGATACCACGGCATTCTAATCAGGGTGACAGAGTGAGATTCTGTCTTAAAACAAACAAACAAAAA","AAAATAAATAAATTAGCAGGGCCTGGTGGCGCACACCTGTAATCCCAGCTACTTGGGAAGCTGAGGCAGGAGAACCCACTTGAACCTGGGAGCCGGAGGTTGCAGTGAGCTGAGATGGCACCACTGCACTCCAGACTGCGTGACAGAGTGAGACTCCGTCTCAAAAACAAACAAACAAAAA"
"GL873571","11399575","11399872","chr15","109458692","109458994","79","98059117","CAGTGGCTCACACCTGTAAATCTAACACTCTGGGAGGCCAAGGTGGGTGGATCCCTTGAGCTCAGGAATTTGATACCAGCCTGAGCAAGAGTGAGACCTTGTCTCTACTAATAATAGAAAAATAGCCCGTGTTGTGGCACTTGTCCCAACCACTGGGGAGGCTTTAGGCGGGAGGATTACTTGAATTGGGAGTTTGATATTGCTGTGAGCTGGGCTGATGCCTTGGCATTCTAGCTTGGGTAACAGCGTAAGACTCCGTCTCAAATAAATAAATAAATAAATAAAAAGAAAAAAAGAA","GTGGCTCACACCTGTAATCTCAGCACTTTGGGAGACCGAGGCAGGTGGATCACCTGAGGTCGGGAGTTTGAGACCAGCCTGACCAACGTGGAGAAACCCCGTCTCTACTAACAATACAAAATCAGCTGGGCGTGGTGGTGCATGCTTGTAATCCCAGCTACTCGGGAGGCTGAGGTAGGAGAATCGCTTGAACCTGGGAGGTGGAGGTTGCGGTGAGCCGAGATCGAGCCACTGCACTCCAGCCTGGGTGACAGAGCAAGACTCCATCTCAAAAAAAAAAAAAAAAAAAAAAAAAAAAAAAAA"
"GL873572","114760","114841","chr8","26280134","26280211","16","26165374","GGCCAGGCATGGCGGCTCTTCCCTGTAATCCTAGCACTCTGGGAGGGCGAGGCAGGCAGATCACCTAGGCTAGGGTGAGATC","GGCCAGGAATGGTGGCTCATGCCTGTAATCCCAGCACTTTGGGAGGCTGAGGCAGGCAGATCACCTGAGGTCAGGAGT"
"GL873572","9421791","9421892","chr11","8089184","8089269","35","1332607","TACTAAATATATAGCAAGGCCAGGCACAGTGGTTCATGGCTGTAATCCCAGTACTCTGGGAGGCCTAGTCAGAGTTGACCTGAGATCAGGCTAGAAGCCTGG","ATAAAAATAATTGGAGGCCAGGCACGGTGGCTCATGCTTGTAATTCTAGCAATTTGGGAGGCTGACGCGGGTGAGATCATACTGAG"
"GL873572","11052834","11053035","chr14","11857478","11857657","65","804644","TCCACAAAGAAAGCAGAAGTGTGGCCGGGTGGTAGCTCAAGGCAGGAATCCCAGCACTCTGGGAGCTGGGAGGTGGGGGAGGATCCCTTGAGATCAGGAGTTGGAGGGCACAGTGAGCCTGGGGGAGGCCACTGTCTCTGTACTCTAGCAGGGAGACAGAGCAAGACTGCCCATTCAAAGAAAAACAACAAACAAAACAAAA","TACAAAAATTAGCTGGGCACGGTGCCACAAGCCTGTAATCCCAGCTACTCGGGAGGCTGGGCAGGGGAATAGCTTGAACCCAGAGGTGGAGGTTGCAGTGAGCCAAGATCAAGCCACAGCACTCCAGCCTGGGTGACAGAGCAAGACTCCATCTCAAAAAAAAAAAAAAAAAAAAAAAAA"
"GL873573","2564195","2564244","chr1","109985445","109985491","12","107421250","TACAAAAATTAGGCTGGGCTTGGTGGTTCACGCCTATAATCCTAGCACTT","ACTAAAATTAGCTGGGCATGGTGGTGCATGCCTGTAATTCCAGCTAC"
"GL873573","7423371","7423533","chr2","202783328","202783513","56","195359957","GGTGGCTCACACCTGTAATCCCAGCACTCTGGGAGCCCTGGTGGCTCATGTCTATAATCCTAGTACTCTGGGAGACCATGGTGGCTCATGTCTATAATCCTAGTACTCTGGGAGCCATGGTGGCTCACGCCTATAATCCTAGTACTCTGGGAGACCATGGTGG","GGCTGAGGCGCGGGGGCTCACGCCTGTAATCCCAGCACTGTGGGAGGCCGAGGCGGGTGGATCACGCCTGTAATCCCAGCACTGTGGGAGGCCAAGGCGGGTGGATCACGCCTGTAATCCCAGCACTGTGGGAGGCCGAGGCGGGTGGATCACGCCTGTAATCCCAGCACTGTGGGAGGCTGAGGC"
"GL873573","9657648","9657710","chr19","10207852","10207913","10","550204","TAAAAATAAAAAATTTAGCTGGATGTGGTGGCTCACACCTGTAATCCTAGCACTCTGGGAGAC","TAAAAATACAAAATTAGCTGGGTGTGGTGGCACACACCTGTAATCCCAGCTACTCAAGAGGC"
"GL873574","1624662","1624783","chr9","814961","815079","36","809701","GACTGGGTGGGTTGGATCATGCCTGGAATCCTAGCACCCTGGGAGGCCAAGGTGAAAGGATTGCTTGAGGTTAGGAGTTCCAGAAATGTAGCAGTCATGGTGACTTCATCCTTCTCTACCAA","GGCTGGGTGCTTTGATTCATGCCTGTAATCCCAGCACTCTGGGAGGCCGAGGCAGGTGGATCACCTGAGGTTAGGAGTTCGAGACCAGCTTGGCTAACATGGTGAAACCTCGTCTCTAC"
"GL873574","4459477","4459612","chr1","29437872","29437991","29","24978395","GGCCGGGCGTGGTGGCGCACGCCTGTAGTCCCAGCGCTATGGGAGGCCGAGGCGGGTGGATCACCTGAGCTCAGAGGTTCGAGACCAGCCAAGACCCCCCTGAGCCAAACGAGCCAGAGTGAGACCCCGTCTCTAC","GGCCGGGCGTGGTGGCTCACGCCTGTAATCCCAACATTTTGGGAGGCCAAGGCGGGTGGATCACCTGAGGTCAGAAGTTCGAGACCAACCTGGCCAACATGGTGAAACCCCTGTCTCTAC"
"GL873574","4681987","4682216","chr6","153082888","153083127","73","148400901","GGGTGCGGTGGCTCAGACCTATAATCCCAGCACTCTGAGAGGCCGAAGTGGGTGGATCACCTGAGCTCAGGAATTTGAGACCAGCCGTCTCTAAAAATAGCTGAGTGTTGTGGCAGTGGCTGTAAGTCCCAGCTGTTTGGAAAGCTGAAGCAAGGGAATCACTTGAACCCAAGAGTTTGAGGTTGCTGTGATGACAAAGTGAGACTCTATCTCAAAAAAAAAAAAAAAAA","GGCCGTGCGCGGCGGCTCACGCCTGTAATCCCAGCACTTTGGGAGGCTGAGGTGGGTGGATCACCTGAGGTCAGGAGTTTGAGACCAGCCCGACCAGAAATTAGATGGGTGTGGTGGTGCGCTCCTGCAGCCCCAGCTACTTAAGAGGCTGAGGCAGGGTAATCACTTGAACCCGGGAGGCGGAGGTTGCAGTGAGCCGAGCTCACGCCACTGCACTCCAGCCTGGGTAACAGAGCGAGA"
"GL873574","4709916","4710039","chr19","13152422","13152536","46","8442506","AAAAATAGAAAAACTAGCCAAGCATGGTGGTGCACCCCCTATAGTCTGAGCTCCTCAGCGGGCTGAAGCAAAAGGACGGCTGGAGCCCTGGAGTTTGAGGTTGCTGTGAGGCAAGGTGATGCCA","ACACATAAATTAGCCAGACATGATGGTGAGTATCTGTAATTCCAGCTCCTTGGGGGGCTGAGGCGGGAGAATTGCTTGAACCTGGGAGGCAGAGATTGCAGTGAGCCAAGATCGC"
"GL873574","6353839","6353913","chr5","25768079","25768163","22","19414240","AAAAATATAGCAAGGCCAGGCATGGTGGCTCACACCTATAATCCCAGTACTTGGGAGCTGGAATTTGAACCTAGG","AAAAAACTCAAACAAGGCTGGGCGTGGTGGCTCACACCTGTAATCCCAGCACTTTGGGAGGCTGAGGTGGGTGGATCACCTGAGG"
"GL873574","6533061","6533332","chr5","85182161","85182439","81","78649100","GGCTGGGCGAGGTGGCTTACACCTATAATCCTAGTACTCTGGGAGGCCAAGGTGGGTGGATTGCCTGAGCGCACAGTTTCAAGACCAGCTGGAGCCAGAGAGAGAGAGAGAGACCCTGCCTCTAAAAATAGCCAGGCATTGTGGCAGGCACCTGTAGTCCCAGCTACTTGGCAGGCGGAGGTATGAGAATCGCTAGAGGTTGCTGTTAGCTATGATGCCATAGCACTCTACCAAGGGCGACAAAGTGAAACTCTGCCTCAAAAAAAAGAAGA","GCCAGGCGTGGTGACTCAAGCCTGTAATCCTAGCACTTTGGGAGGCCAAGGTGGGCGGATTGCCTGAGCTCAAGAGTTTGAGACCAGCCTGGGCAACACGGTGAAACCCAATCCCTACTAAATACAAAAAAAATTAGCCGGGTGTGGTGGTGTGAACCTGTAGTCCCAGCTACTCGGGAGGCTGAGGCAGGAGAAGGCAGAAGTTGCAGTGAGCCGAGATCACACCACTGCACTCCAGCCTGAGTGACAGAGCAAAACTCTTTCTCAAAAAAAAAAAAA"
"GL873574","6643746","6643907","chr2","92627944","92628105","46","85984198","AAATAGCCAGGCGTTGTGGCAGGCACCTATAGTCCCAGCTACTTGGGAGGCTGAGGCAAGAGAATCACTTAAGCCCAAGTGACAGAGGTTGCCAGGGCACTCTACGTAGGCAACAGAGTGAGACTCTATCTAAGAAAGAAGGAAGGAAGGAAGGAGAAAGAA","TTAGCCGAGCATTGTGGTGCGCGCCTGTAGTCCCAGCTACATGGGAGGCTGAGGCAGGAGAACACCTGAACCCAGGATGTGAGCTGAGTCGCGCCATTGCACTCCAGCCTGGGCAACAGAGTGAGACTCCATCTCAAAAATAAAATAAAATAAAATAAAAAA"
"GL873574","6644163","6644274","chr1","128607504","128607619","20","121963341","CTGTAATCCTAGCACTTGGGAGGCTGAGGCAGGTGGATCACCTGAGTTCAGGAGTTCAAGACCAGCCTAAACAAGAGTGAGACCCTATCTCTACTAAAAATAGAAAAAATAT","GCCTGTAATCCAAGCACTTTGGGAGGCTGAGGCGGGTGGATCACCTGAGGTCAGGTGTTCGAGACCAGCCTGGCCAACGTGGTGAAACCCCAACTCTACTAAAAATACAAAAATTA"
"GL873574","8511822","8512127","chr1","23439759","23440073","84","14927937","GGTGGCTGGTGCCTGTAATCCTAGCACTCTGGGAGACTGAGGCAGGTGGATCACTTGAAATCAGGAGTTTGAGATCAACCTGAGCAAGAGATCTTGTCTCTCCTAAAGATAGAAAAACTAGCTGGGATTTGTGGTGGACACCTGTAATTTCAGCTACTCAGGAAGCTAAGGCAAGAGCATTGCTTAAAACCAGGAGTTTGAAGTTGATGTGAGCTAGGATGTCAGGGCAGGTTACCCAGGGTGACAGAGTGAGACTCTGTGTCAAAATAAACAAACAAACAAACAAACAAAACAAAATAAAATAAA","GGCTGGACATGGTGACTCACGCTTGTAATCCCAACACTTTGGGAGGCTGAAGCAGGCAGATCACCTGAGGTCAGGAGTTTGAGACCAGCCTGACCAACATGGTGAAACCTTGTCTCTACTAAAAATACAAAAATTAGCTGGGAGCAGTGGTGCACACCTGTAATCCCAGCTACTCGGCAAGCTGAGGCAAGATAATTTTTTAAACCTGGGAGGTGGAGGTTGCAGTGAGCCAAGATCGTGCCACTGTACTCCAACCTGGGAGACAGAGCAAGACTCTGTCTCAAAAAAAAAAAAAAAAAAAAAAAAAAAAAAAAA"
"GL873575","2107336","2107519","chr4","38052972","38053149","54","35945636","TCAATTAAAAACTTTTTAAAATGAGGCTGAGCATGGTGGTTCACACCTGTAATCCCAGCACTTTGGGAGGCCGAGGCAGGAGGATCACCTGATCCCAGGAGTCCAAGCCTACAGTGAGCCGTGATAATACCACTGCACTTCAGCCCAAAGCCTCAAAAAGAAAAAAAAAAAAGGATAGACAAGA","TATATATATATATATTATTTTGGGGGGGCATGGTGGTGCACACCTGTAATCCCAGCTACTCGGGAGGCTGAGGCAGGAGAATTGCTTGAGCCCGGGAGGCAAAGGTTGCATTGAGCTGAGATCACACCACTGCACTCCAGCCTGGCGACAGAGTCTCAAAAAAAAGAAAAAATAAAAA"
"GL873575","5831824","5831959","chr1","29437872","29437991","28","23606048","GGCCGGGCGTGGTGGCGCACGCCTGTAGTCCCAGCGCTATGGGAGGCCAAGGCGGGTGGATCACCTGAGCTCAGAGGTTCGAGACCAGCCAAGACCCCCCTGAGCCAAACGAGCCAGAGTGAGACCCCGTCTCTAC","GGCCGGGCGTGGTGGCTCACGCCTGTAATCCCAACATTTTGGGAGGCCAAGGCGGGTGGATCACCTGAGGTCAGAAGTTCGAGACCAACCTGGCCAACATGGTGAAACCCCTGTCTCTAC"
"GL873575","7451097","7451208","chr3","122814630","122814743","22","115363533","GGCCAGGTGTGGTGGCTCACACCTGTTATCCTAGCACTCTGAGAGGCCACAGCAGCTGGATCACTTGAGCTCAGGAGTTCAAGACCAGTCTGAGCAAGAGCAAGACCTCACC","GGCTGGGTGTGGTGGCTCATGCCTGTAATCCCAGCACTTTGAAAGGCCAAGGCAGATGGATCACTTGAGGTCAGGAGTTCCAGACCAGCCTGGCCAACATGGCAAAACCCCATC"
"GL873575","7451277","7451445","chr6","58863249","58863409","41","51411972","AAAAATTCAGCCAGCCACAGTGGAAGTGGATGCCTGCCATCACAGCTACTCTGGGGGCTGGGGCAAGAGAATTGCTTGATCCCAGGAGTCTGAGGTTGCTGTGACCTAGGCTGACACCACAGCACTCTACCCAGGGTGACAGAGTGAGGCTGTGTTTAAAAAAAAAAAA","TTAGCCAGGCATGGTGGCACATGCCAGTAATCCCAGCTACTCAGGAGGATGAGGCAGGAGAATCGCTTGAACCCAGGAGGCAGAGGTTGCAGTGAGCTGAGATTGCGCCACAGCACTCTACCCTGGGTGACAGAAGGAGACTCTGTCTCAAAAAAAAAAAA"
"GL873576","1765109","1765185","chrX","53921180","53921256","12","52156071","GGCCAGGTGCAGTGGCTCATATCTGTAATCCTAGCACCCTGGGAGGCCAAGGTAGGCGAATCACCTGAGGCCAGGAG","GGCCAGGTGCAGTGGCTCACGCCTGTAATCCCAGCACTTTGGGAGGCCGAGGTGGGCGGATCACTTTAGGTCAGGAG"
"GL873576","2711577","2711895","chr7","6620384","6620702","85","3908807","GGTCGAGCTTGGTGGCTCATGCTTGTAATCCTAGCACTCTGGGAGGCCAAGGCAGGTAAGTTGCCCTGAGCTCATAGGTTCCAGATCAGCATGAGCCAGAGTGAGACCCTGTCTCTACCAAAAAATAGCCCGGCATTCTGGCAGGTGCCTGTAATCCCAGCTGCTTGGGAGGCTGAGGCTAGAGAATCACTTAAACCCAAGGGTTAGTGGAGGTTGCTGTGAGCTATGATTCCACCGTACTCTACTGAGGGCCACAAAGTGAGACTCTGTCTCCATAAAAAAGAAAGAAAGAAAGAAAGAAAAATAAAATAAAATAAAA","GGCCAGGCACAGTGGCTCATGTCTGTAATCCCAGCACTTTGGGAGGCCGAGGCGGGTGGATTACCTGAGGTCAGGAGTTCTAGACCAGCCTGGCCAACAAGGCGAAACCCTGTCTCTACTAAAAATACAAAAAATTAGCTGGGCGTTTTGGCACATGCCTGTAATCCCAGCTACTTGGGAGGCTGAGGCAGGAGAATTGCTTGAACTGGGGAAGTGGAGGTTGCAGTGAGCTGAGATCACACCATTGCACGCCTGAGCAACAGAGCGAGACTCTGTCTCAAAAAAAAAAAAAAAAAAAAAAAAGAAAAGAAAAAGAAAA"
"GL873576","4782520","4782652","chr9","61136941","61137074","22","56354421","CCAGGCACGGTGGCTCACCCTTGTAACCCTAGTACTTTGGGAGGCTGAGGTGGGAGGATCCCTTGAGGTCAGGAGTTCAAGACCAGCCTGAACAACAGTGAGACCCCCGTCTCTACTAAAAAATAGAAAAGTT","GCCAGGCACGGTGGCTCACGCCTGTAATCCCAGCACTTTGGGAGGCTGAAGCGGGCGGATCACCTGAGGTCAGGAGTTCAAGACCAGCCTGGGCACCATGATGAAACCCCGTCTCTATTAAAAATACAAAAATT"
"GL873576","4782930","4783078","chr7","57521645","57521803","40","52738715","AGTTAGTCTGGTGTCATGGTGGGTGCCTGTAGTCCCAGCTGCTTGGGAGGCTGAGGCAAGAGAATCACTTGAGCCCAGGAGTTGGAGGTTGCTATGAGCGAGGCTGTAGCCTAGGCAACAGAATGAGACTTTGCCTCAAAAAAATAAAA","TTAGCTGGGCATGGTGGCGCATGCCTGTAGTCCCAGCTACTTGGGAAGCTGAGGCAGGAGAATCACTTGAACCTGGGAGGTGGAGGTTGCAGTGAGCTGAGATCGCACCGCTACACGCCAGCCTGAGCAACAGAGAGAGACTCTGTCTCAAAAGAAAAA"
"GL873576","7828709","7828723","chr5","101042981","101042996","1","93214272","TAAATAAATAAAAAA","TAAATAAATAAATAAA"
"GL873576","7828960","7829230","chr13","49045537","49045844","89","41216577","GCCGGCTGCAGTGGCTATAATCCAAGTACCCTGGGAGGCTTAGGTGGATGGATCACTTGAGCTCAGAAGTTCAAGACCAGCCTCAGCAAGAGGTAGACCTTGCCTCTATTAAANNNNNNNNNNNNNNNNNNNNNNNNNNNNNNNNNNNNNNNNNNNNNNNNNNNNNNNNNNNNNNNNNNNNNNNNNNNNAGTTTGAGGTTGCTGTGAGCTATGATGAAGCCAGGGCATTCTACCCAGGGTGACAGAGTAACTCTTAAAAAAAACTAAACAA","GGCCAGGCAGAGTGGCTCATGCCTGTAATTCCAGCAATTTGGGAGGCCTAGGCAGGCAGATTACCTGAGGTCAGGAGTTTGAGACCAGCCTGGCCAACATGGTGAAACCCCGTCTCTTCTANNNNNNNNNNNNNNNNNNNNNNNNNNNNNNNNNNNNNNNNNNNNNNNNNNNNNNNNNNNNNNNNNNNNNNNNNNNNNNGGAGATAATAGCTTTTGTAGAACGAAGCGATGCAACAGCCAGATCGCCGCCACCACCCTTAGGTCCTGGCGACAGAGTGAGATCCATCTTAAAAAAAAAAAAAAAAAAA"
"GL873576","10622840","10623093","chr7","60266447","60266705","74","49643607","GCTGGGTATGGTGGTTCACACCTATAATCCTAGCACTCTGGGAGGCTGAGGTGGGAGGATTGGTGGAGCTCAGGAGCTCATGAGGTGCCAAATCACTGGTGCCACACACCTGTATTCCCAGCTACTGAGGAGGCTGAGGCAGGAGGATCAGGTAAGCCCAGGAAGTTTGAGGTTGTAGTGAGTTAGGATGATTGAACTCTGCCTTGAGAGACAGAGCAAGATCCTCCTTCCTCCTAAGCAAACAAACAAATAAA","GGCTGGGTGCAGTGGCTCACACCTGTAATCCTAGCACTTTGGGAGGCTGAGGCGGGAAAATTGCCTGAGCTCAGGAGTTCAAGGACAGCCTAGGCAACATAGCATGGTGGTGCACGCCTGTATTCCCTGCTACTTGGGAGGCTGAGGCACAAGAATTGCTTGAATCCGGGAAGTGGAGGTTGCAGTGAGCCATTGTGGCACTGCTCTCCAGTCTGGGTGACAGAGCAAGACTCCATCTCAAAAAAAAAAAAAAAAAAAA"
"GL873576","10819939","10820007","chrX","67133632","67133707","21","56313693","AGGTTGCAGTGAAATTGTACCATTCCAATGAAGCCTGGGGGACAGAGTGAGATTCTCTCAAAATAAAAA","GGAGGTTGCAGTGAACCGAGATCGTGCCACTGCACTCCAGCCTGAGCGACAGAGTGAAACTTCGTCTCAAAAAAAA"
"GL873576","10920306","10920363","chr3","48261745","48261808","16","37341439","GCTGGACCTTGTAGAGAGTGCCTGTAATCCCAGCTACATGGGGGGCAAGAGAATTGCT","GCTGGGCATGGTGGTGCATGCCTGTGATCCCAGCTACTCAGGAGGCTGAGGCAGGAGAATTGCT"
"GL873576","10920398","10920529","chr10","67341428","67341546","30","56421030","GGCCAGGCGTGGTGGCTCACGCCTGTTGTCCCAGCACTGTGGGAGGCCGAGGTGGGTGGATTGCCTGAGCTCAGAGGAGTCCGGAAGACCAGCATGAGGCAGAGTGAGCCAGAGTAAGATCCTGTCTCTACC","GGCTGGGTGTAGTGGCTCATGCCTGTAATCCCAGCACTTTAGGAGGCCAAGGTGGATGGATTGCCTGAGCTCAGGAGTTCGAGACCACCCTGGGCAACAAGCCAAAACCCTGTCTCTAC"
"GL873577","515809","515961","chr7","137660778","137660931","43","137144969","AGCTGGGCATGGTGGCTCATGCCTATAACCCTAGCGTGCTAGGAGATTGCTTGTCAGGAGACTGAGGTTGCAGGAAACTGTGATGATGGCACTGCACTCTACCCAGGGTGACAGAGCAGGACTCTGCCTCAAAAAAAAAAAAAAAAATAGAAA","TTAGCTGGGCATGGTGGCGCATGCCTATAATCCCAGCTACTTGGGAGGCTGAGGCAAGAGAATCGCTTGAACCGGGGAGGCAGAGGTTGCAGACTGCACTCCAGCCTGTGTGACAGAGTGGGACTCCGTCTCAAAAAAAAAAAAAAAAAAAAAA"
"GL873577","1633164","1633256","chrX","38269524","38269615","26","36636360","TCAGCCAGGCATGGTGGCACTTGCCTATAAACCCAGCTCCTTGGGAAGCTGAGCCGGGAGGATCCCTTGCACCCAGGAGCAACGGAAGGCAGT","AATTAGCCAGGCATGGTGGCACATGCCTATAATCCCAGCTACTCAGAAGGTTGAGGCAGGAGAATCACTTGAACCTGGGAGGCAGAGGTTGC"
"GL873577","3979502","3979560","chr20","68909283","68909346","13","64929781","GAGTTTGAGACCAGCCTGAGCAAGACCGAGACCCAGTCTCTACTAAAAATAGAAAAATT","GGAGTTCAAGACCAGCCTGACCAACATGGAGAAACCCTGTCTCTACTAAAAAATACAAAAATTA"
"GL873577","3979839","3980009","chr10","31403126","31403287","39","27423287","ATGAGCAGATTGTCTTGGTGGGCACCTGTAGTCCCAGCTATTGGAGGTGGGAGGCTGAAGCAGGAAAATCTCTTGAGCCCAGGAGTTTGAGGTTGCTGTGAGCTAGGCTGACACCACGGCACTCTAGTCAGGGCGTCAGAGTGAGACTCCGTCTCAAAAAAAAAAAAAAAA","TTAGCTGAGTGTGGTGGCGCACATCTGTACTCCCAGCTATTTGGGAGGCTGAGGCAGGAAAATCGCTTGAACCCAGGAGGTGGAGGTTGCAGTGAGCCAAGATCACACTACTGCACTCCAGCCTGGGTGACAGAGTGAGAATCCATCTCAAAAAAAAGAAAA"
"GL873577","6050882","6051080","chr1","153219820","153220007","59","147168938","GGCTGGGCGTTGTGACTCATGCCTGTAATCCCAGCACTCTAGGAGGCCGAGGTGGGTGGACTGCCTGAACTCAGAGGTTTAAGACCATCCTGAGCCGCAGTGAGCCAGAGCGAGACCCTGTCTCTACCAAAAAAAGCTGGGTGTTGTGGTGGGCGCCTATAGTCCTAGCTACTTGAGGCGCTAAGGGTAAAAAAATTGC","GGCCTGGCACAATGGCTCACGCCTGTAATCCTAGCACTTTGGGAGGCCGGGGTGGGTGGATCACCTGAGATCAGGAGTTTGAGACCAGCCTGGCCAACATGGTGAAACTCCTTCTCTACAAAAATTAGCCAGGTGTGGTGGTGGGTACCTGCAATCCCAGCTATTTGGGAGGCTGAGGCAGGAGAATC"
"GL873577","8463965","8464050","chr9","52134422","52134508","19","43670457","CTGGGTGCTATAGCTCACGCCTATAATCCTAGCACTCTGGGAGTTTGGGGCAAATGGATCACCTAGGCTCAGGAGTTTGATACCAG","GGCTGGGAGCAGTGACTCACGCCTATAATCCCAGCACTTTGGGAGGCTGAGGCAGATGGATCACCTGAAGTCAGGAGTTCGAGACCA"
"GL873577","9471486","9471613","chr16","5178790","5178910","46","4292696","TTAGCCAGGCATAGTAGCCTGTGTGTAGTCCTAGCTACTCAGGAGGCTGAGGTAGATGGGTCACTTGAGGTTGCAGAGATTATGGTAATGTCACTGTACTCTAGCCCTGGCAACAGAGCACAACCCTG","TTAGCCGAGCCTGGTGGCATAAACCTGTAATCCCAGCTACTCAGGAGGCTGAGGCAGGGGAATTGCTTGAACCTGAGAGGAGAAGGTTGCAGTGAGCCGAGATTGCACCATTGCACCCCAG"
"GL873577","9471875","9471998","chr7","17832200","17832315","36","8360325","GGCCAGGTGAAGCAGCTCATGGCTATAATCCTAGCAGTTTGGCAGGCCAAGGTGGGAGGACTGCTTGAGGTCAAGAGTTCAAGACCAACCCATCTTTGCGAAAAATTTAAAAATTACCTAGGCA","GCCAGGAGAGGTGGCTCATGCCTCTAATCCCAGCACTCTGGAAATCCAAGGTGGGTGGATCACCTGAGGTCAGGAATTCCAGACCAGTCTGGCCAATATAAAAAATTAGCCAGGCT"
"GL873577","9853150","9853170","chr3","85044647","85044667","3","75191497","AAACAAACAAACAAAAAAAGA","CAAACAAACAAACAAACAAAA"
"GL873577","9853206","9853473","chr7","130818682","130818963","67","120965476","GCTGGGCGCAGCGTCTCACTCCTGTAATCCCAGCACTTGGGAGGCCAAGGTGAGTGGATTGCCTGAGTTTACAGTTTCGAGACCAGCCTGAGCCAAAGCGAGACCCCCATCTCTAAAAAATAGCTGGGCATTGTGGTGGGCACCTGTAGTCCCAGCTACTTGGGAGGCTGAGGCAAGAGGATCGCTTGAACCTAAGAGTTTGAGGTTGCTGTGAGCTAAGGCTCCATGGCATTCTACCAAGGGTGACTAAGTGAGACTCTGTCTAAAA","GCCGGGCACAGTGGCTCACACCTGTAATCCCAGTACTTTGGGAGGCCAAGGTGGGTGGATCACCTGAGGTCAGGAGTTTGAGACCAGCCTGGCCAACATAGTGAAACTCTACTAAAAATACAAAAAAATAGCTAGGCATGGTGGTGCGCACCTGTAATCCCAGCTACTTGGGAGGCTGAGGCAGGAGAGTTGCTTGAACCCAGCGGGGTTGAGGTTGCAGTGAGTTAAGATCAAGCCACTGTGCTCCAGCCTGGATGACAGAGAGAGACTCCATCTCAAAAA"
"GL873577","10722415","10722478","chr10","12501471","12501539","23","1779056","AATAAAAAAATGCTGGGTACAGTAGTACATGCCTGTACTCTCATCTGGGGAAGCTGAGGCATGA","AAAGTAAAAAATTAGAGCTGGGCATGGTGGCACACACCTGTAATCCCAGTCACTAGGGATGCTGAGGCA"
"GL873578","463331","463568","chr10","28935382","28935620","93","28472051","CAGGTGCTTTGACCCACACCCTCAACTCTAGGACTTTGGACGCCCTGGCTGGGTGGGTCCTTTAAAGTCAGGAGCTTCTTATCAGTCTGGGCAAAAGTGAGACCCCATCTCTACCAAACAAAGAAAGAAATCAGCAGTATGTTGCAGTAGAGACTCACCAATACCTTCTTTCAAAGACCAAAGCTGGAAGGACACTAAAGACCATGATCTCATGGCCTCCCTGAGCCATGACAATGCC","CCAGGTGCAGTGGCTCATGCCTGCAAGCTCAGAACTTTGGGAGGCAGAGGTGAGCAGACTGCCTGAGTTCAGGAGTTCAAGACCAGCTGGGCAACATGGTGAGACCCTATCTCTACTAAAAATACAAATAATTAGCAGGGTGTGGTAGCACACACCTGTAGTCCAGCTACTCAGGAGGCTGAGGCAGGAGAATTGCTTGAACCCAGGAGGCAGAGTTTGCAGTGAGCCAGGACTGGGCC"
"GL873578","1143712","1143827","chr11","52824583","52824692","30","51680871","GGCTGGGTGTGGTGCCTCATGCCTGTAATCTAAGCCCTCTCCGAGGCTGAGGTGGGAGGATCCCTTGAGTTTAGGAGTTTGATTTTGAGACCAGCCTGATCAAGAGAGAGACCTCA","GGCCGGGTGTGGTGGCTCATGTCTGTAATCCCAGCACTTTGGGAGGCTGAGGTGGGTGGATACCCTGAGGTCGGGAGCTCGAGACCAGCCTGACCAACATGGAGAAACCC"
"GL873578","1144101","1144139","chr3","33494224","33494257","11","32350123","GAGAGAGACCTCATGTCTACTAAAATAAATAAATATATA","GTGAAACCCGTCTCTACTAAAAATACAAAAATTA"
"GL873578","1144175","1144343","chr12","119519961","119520131","41","118375786","ATTATCCAGGCCTTCTGGTGGATGCCTGTAGTCCTAGCTACTAGAAAAGCTGGAGCAGAATCACTTGACCCAGGAGCTGGAGGTTGCAGGGAGCTAGGCTGATGCCACAGAATTCTAGCCTGAGGCAAAAGAATTGAGCCACTGTCTCAAAAAGGAACAAAAAAGAAAA","ATTAGCCAGGTGTGGTGGCATGCACTTGTAATCCCAGCTACTAAGAAGGCTGAGGCAGGAGGATCACTTGAACCCGGGAGGTGGAGGTTGCAGTGAGCCAAGATCATGCCACTGCACTCCAGCCTGGGCAACAGAGTAAGACTCTGTCTCAAAAAAAAAAAAAAAAAAAAA"
"GL873578","4593962","4594035","chr16","68825055","68825124","22","64231093","AGCTGGGTACAGTGGCTCACATATAATCCCAGTGACTCAGGAGGCTAAGACAGGAGGATTACTAGGACCTGAGA","GGCTGGGCACAGTGGCTCAGACCTGTAATCTCAGTACTTTGGGTGGCTGAGGCAGGTGGATCACCTGAGG"
"GL873578","6158845","6158972","chr3","500432","500562","24","5658413","GACATGGTGGCTCACACCTGTAATCCTAGCCCTCTGGGAGGCTGAGGCAGGTGGATCACTTGAGTTCAGGAATTCAAGACCAGCTTGAGTGAGAGCAAGACCCTGTCTCTACTAAAAATAGAAAAATT","GCACGGAGGCTCATACCTGTAATCCCAGCACTTTGGGAGGCTGAGGCAGGTGGATCACCTGAGGTCAGGAGTTCCAGACCAGCCTGGCCAACATGGCGAAACCCTGTCTCTACTAAAAATACAAAAAATCT"
"GL873578","6159253","6159444","chr19","34496349","34496541","55","28337096","ATAAAATAAAAATAGAAAAATTAGCCAGGCATTGTGGCAGACATGCGAAGTCTCAGCTACTCCAGAGGCTGAGACAGGAAGATTACTTGAGCCCAAGAATCTTGCTGTGAGCTAAGCTGATGCCATAGCATTGTAACCTAGGCAACAGAGTAAGACTTGGCCTCAAAAATAAAATAAAATAATAAAGTAAAA","TTAGTTAATTAAATTAAACTTAGCTAGGCATAGTGGAACACACCCATAGTCCCAGCTACTCTAGAGGCTGAGGCAGGAGGATTGCTTGAGCCAAGTTGGAGGCTGCAGTGAGCTATGGTGGTGCCACTGCATTCCAGCCTCAGTGACAGAGAGAGACCCTGGCTCAAATAATAATAATAAATAAATAAATAAA"
"GL873578","6766040","6766171","chr2","93098086","93098217","30","86332046","CCAGGCACAGTGGCTCATGCCTATAATCCTAGTAGTCTAGGAGGCTGAGGTGAGTGCATTGCTTGAGCTCAGGAGTTAGATACCAGCCTAACCAAGAATGAGACCCCATCTCTATTAAAAATAGAAAAGTTA","GCCGGGCACAGTGGCTCATGCCTGTAATCCCAGCACTTTGGGAGGCCGAGGCGGGCAAATCACGAGGTCAGGAGTTCAAGACCAGCCTGACCAATATGATGAAACCCCGTCTCTATTAAAAATACAAAAATT"
"GL873578","6766434","6766577","chr9","21128084","21128223","50","14361650","GTTAGCCAGGAGTTGTGGCGGGCACCTACAGTCCTAGCGACTCAGGAGGCTGAAGTAGGCAGAGTTTGATGTGTTGCTGTGAACTACAAGGACACCAATGCACTCTAGGCCGGTAACAGAGTGAGACACTGACTAAAAAAAAAA","TTAGCCAGGTGTGGTGGCACATGCCTGTATTTCCAGCTACTCGGGAGGCTGAGGCAGGAGAATTGCGTGAGCTGAGATCATGCCACTTCATTCCAGTCTGGGTGACAGAGTGAGACTCTGCCTCAAAAAACAAAACAAAA"
"GL873578","7397948","7398119","chr5","40230148","40230319","43","32832200","TAAAAATAGCCATGCATTGTGACAGGCACCTGTAGTCCCAGCTACTCAGGAGGTTGAGGTAAGAGAATCACTTGAACCCAAGAGTTTTGAGGTTGTTATGAGCTAAGACGCCTCGGGACTCTACAAAAGGTAACAAAGTGAGACTCTGTCTCATAAAAAAAGAAAAAAAGAA","AAAATTAGCCAGGCATGGTGACGTACACCTGTAGTCCCAGCTACTCGGGAGGCTAAGGCAAGAGAATCGCTTGAACCCAGGAGGCAGAGGTTGCAGTGAGCTTAGATCACGCTACTGCGCTCCAGCCTGGGTGACGGAGTGAGACGCCATCTCAAAAAAAAAAAAAAAAAAA"
"GL873578","7398378","7398515","chr15","102382935","102383070","35","94984557","GGTCGAGCAAGGTGGCTCACGCCTGTAATCCTAGCACTCTGTGAGGCTGAGGCAGATGGATTGCCTGAGCTCGTGGGTTCGAGACCAGCCTGAGCCAGAGTGAGACCTCATCTCTAAAAATAGCTGGGAAGCTGGGCA","GGCCAGGTGTGGTGGCTCACGCCTGTAATCCTAGCACTTTGGGAGGCTGAGGCGGGTGGATTGCCTGAACTCAGGAGGTCAAGACCAGCCTGGGCAACACAGTAAAACCCCATCTCTACTAAAATACAAAAAATCA"
"GL873579","370235","370429","chr16","38067345","38067552","57","37697110","GCACAGGCCTGAAATCCTAGCACTCTGAAAGGCCAACGGAGGAGAATTTCTGGAGCTCAGGAGTTTGATACCAGCCTAAGCAAATAAAGCTAGACCTCTATCTCTACTAAAATTAGAAAAATTAGGCAGATGTGGTGGTAGGCACCTATAGTCCCAATTACTCCAGAGGCTGAGGCAGAAAGACTCTTGAACCCA","GTCAGGCATGGTGGCTCATGCCTATAATCCTAGCACTTTGGGAGGCCAAGGCCGGTGGATCACCTGAGGTCAGGAGTTTGAGACCAGCCTGGCCAATATGGCAAAACCCCGTCTCTACTAAAAATAAAAAAATTAGCTGGGCACGGTGGTGGGCACCTATAGTCCCAGCTACTCAGGAGGCTGAGGCAGGAGAATTGCTTGAACCCAG"
"GL873579","370936","371046","chr3","3847698","3847802","33","3476762","TGACTCTTGAACCCAGGCACATGAGGTTGCTAAGAGTCTAGGCTGATGTCACGGCACTCTAACCTGGGAAACAGTGTGAGGTTCTGCCTCAATAAATAAATAAATAAATAA","TGGCTTGAACCCAGGAGGCGGAGGTTGCAGTGAGCCGAGATCACGCCACTGCACTCCAGCCTGGGCAACAGAGCGAGACTGTCTCAAAAAAAAAAAAAAAAAAAA"
"GL873579","599436","599605","chr10","38982686","38982853","41","38383250","AAAAAGTCAGACATTGTGGCAGGTGTCTGTAATCCCAGCTATTTGGGAGGCTGAGGCAGGAGTATCATTTGAACCCACGAGTCTGAGGTAACTGTGAGCTAGGCTAACACAACAGCACTCTAGCCTGGGCAATAGAATGAGACTCTATCAAGAAAAGAAATGAAAAGAAA","TATTAGCCTGACACAGTGGCGCGCATCTGTAATCCCAGCTACTTGGGAGGCTGAGGCAGGAGAATCACTTGAACCCAGGAGGCGGAGGTTGCTGTGGGCTGAGATCATGCCACTGCACTCCAGCCTGGGCAACAGAGGGAGGCTCCATCTCAAAAAAAAAAAAAAAAA"
"GL873579","599942","599953","chr3","71473700","71473710","4","70873758","TTTTAAAATAGT","TTTAAAAAAAA"
"GL873579","600232","600365","chr1","16061315","16061447","30","15461083","GGCTAGGCAAGGTGACTCATGTCTGTAATCCTAGTACTCTGGGAGGTTTGAGGCAGGAAGACCACTTTAGCTCAAGAGTTCCAGATCAGCCTGTGCAAGAGTGATACATCATCTCTACTAAAAATCAAAAATTA","GGCTGGGCATGGTGGCTCATGCCTGTAATCCTAGCACTTTGGGAGGTTGAGGCAGGCAGATCACTTGAGGTCAGGAATCTGAGACTAGCCTGGCCAACATGGTGAAACTCCATCTCTACTAAAAAAAAAAAAA"
"GL873579","5650320","5650591","chr6","54938866","54939145","71","49288546","GTCAGGTGTGTTAGCTTACAGTAGTAATCCTAGCACTTTGGGAGGTTGAAGTGGGTGGATTGCTTGAGCTCAGGGGTTCAAGACCAGCCTGAACAAGAGTGGGACCTCATCTCTATTAAAAACAGAAAAACTAGCTGGGTGTTATGGTGGGTGTCTGTAGCCCCAGCTACTCAGGAGGCTGAGGCAGGAGGTTGAGGTTGCTGTGAGCTATTGAGACCACAGCACTCTATCCAGGGCAACAGAGTGAGACCCCTCCCCCCCCCAAAAAAAAA","GGCCAGGTGTGGTGGCTCACGCCTGTAATCCCAACACTTTGGGAGGCCGAGGTGGGTGGATCACCTGAGATCAGGAGTTCAAGACCACCCTGGCCAACATGGTGAAACCCCGTCTCTACTAAAAATACGAAAATTAGCTGAGTGTGGTGGTGCATGCCTGTAGTCCCAGCTACTCAAGAGGCTGAGGCAGGAGGTGGAGGTTGCAGTGAGCCGAGATTGCATCACTGCACTCCAGCCTTGGCGACAGAACGAGAGAGACTCCATCTAAAAAAAAAAAAAA"
"GL873579","7037162","7037347","chr3","37328686","37328893","67","30291524","GAGGTGGGTGGATTGCCTGAGCTCACAGGTTGGAGACCAGCCTGAGCCAGAGCAAGACCTTATCTCAAAAAATAGCCAGGTGTTGTGGCTGGCACCTGTAGTCCCAGCTGCTCAGGAGGCGGAGGCAAGAGAAATGCTTGACCTCAGGAGTTTGAGGTTGCTGTGAGTTCAACTCACACTAATACA","GAGGCAGGGGGATCACCTGAGGTCAGGAGATCGAGACCAGCCTGGCCAACATGGTGAAAACCTGTCTCTACTAAAAATCCAAAAACATTAGCCAGGTGTGGTGGCACGCACCTGTAATCCCAGCTACTTGGGAGGCTGAGGCAGGAGAATCACTTGAACCTGGGAGGCAGAGGTTGTAGCGAGCCGAGATCACACCACTGCACCCCAG"
"GL873579","11077764","11077972","chr19","1200469","1200683","63","9877295","GCCAGGTGCAGTGGCTCATGCCTATAATCCTAGCACCCTAGGAGGCTGAGGAGTTCAAGACCAGCCTAAGCAACTGTGAGACCCCATCTCTACCAAAAATAGAAAAATTAGCTGACTGTTATGGTGTGCACCTACAGTCCTAGCTACTCAGGAGGCTGAGGCAGAAAGAGTCCTTGAACCCAGGAGGCTTTTTTTTGTTGTTGTTGTTG","GGCCAGTCGCGGTAGCTCATGCCTGTAATCCCAGCACTTTGGGAGGCCGAGGCGGGCAGATCACCTGAGACCAGCCTGGCAACATGGTGAAACCCCATGTCTACCCAAACTACAAAAATTAGCTGGGTGTGGTGGTGCACGCCTGTAATCCGAGCTACTCAGCAGGCTGAGGCAGGAGAATCCCTTGAACCTGGGAGGCAGAGGCTGCAGTGAGC"
"GL873579","11078245","11078333","chr19","4926258","4926351","22","6151987","TGAACCCAGGAGTTTGAGTTCGCTGTGAGCTAAGCTGAGGCCACAGCACTCCAGCCTGGGCAACAGAGTGAAAGGAAAAAAATAAAAAA","TGAACCCGGGAGGTGGAGGTTGCAGTGAGCCAAGATCACACCAATGCACTCCAGCCTGGGCAACAAGAGTGAAACTCTGTCTAAAAAAAAAAAA"
"GL873580","320374","320488","chr13","48549305","48549409","42","48228931","GGTAGTGCGTGCCTGCATTCCCAGCTACGGGAGGGCAGGGACTTGAGGCCAGCCTGGGCAAAATAATGAGACCTACTAATGACTCTACTAATACAGAAACAATTAGCTAGGTATG","TGGGAGGCCGAAGTGCGCAGATCACCTGAGGTCAGAAGTTGGAGACCAGCCTGGCCAACATGGTGAAAACCCATCTCTACTAAAAATACAAAAATTAGCTGGGCA"
"GL873580","374969","375091","chr6","147681010","147681135","27","147306041","CGGTGGCTCACACCTATAATCCTAGCATTTTGGAAGGCTGAAGCCGAGGATCTCTGGAAGTCAGAAGTTCAAGACCAGCCTGCCCAAGAGCAAGACCCCATCTCTACTAAAAATAGAAAAACT","GGTGGCTCACACCTGTAATCCCAGCATTTTGGGAGGCTGAGGCAGGCGGATAATCTGAGGTCAAGAATTTGAGACCAGCCTGGCCAACATGGAGAAACCCTATCTCTACTAAAAATACAAAATTAC"
"GL873580","375369","375549","chr7","19977275","19977456","44","19601906","CTAACCAAGTTAGTTAGTTTTAGTTGGCAGGTGCCTGTAGTCCCAGCTCCTTGGGAGGCTGAGGCAAGAGAATGGCTTGAGCCCAGGACTTTGAAGTTGCTGTGAGCTATAATGACACCACAGCACACTACCCAGGGTGACAGAGTGAGACTGTCTCAAAAAAACAAACAAACAAAAAAAA","AACAAACGTTAGCCGAGCATGGTGGTATGTGCCTGTAGTCCCAGCTACTTGGGAGTCTAAGGCAGGAGAATTACTTGAGCCCGGGAGGCAGAGGTTGCTGTGAGCCAAGATCACGCCACTGCACTCCAGCCTGGGTGACAGAGTGAGACTCCATCTCAAAAAAAAAAAAGGAAAAAAAAAAA"
"GL873580","8760922","8761015","chr11","104681322","104681416","19","95920400","GGAGGGAGACACTGCAGTGAACTGCGATCGTGTCTCTGCTTTCCAGGCTGGGTGACAGAGTGAGACTCGGTCTCTAAAATAAAAAATAAATAAA","GGAGACGGAGGTTGCAGTGAGCTGTGATCGCGGCACTGCACTCCAGCCTGGGCAACAGAGTGAGACTCTGTCTCAAAAATAAATAAATAAATAAA"
"GL873580","9391260","9391306","chr14","49279240","49279285","12","39887980","GCCAGTCGAGGTGGCTCACACTTGTGATTCCAGCTACTTGGAAGACT","GGCTGAGATGGTGGCACACACCTGTAATCCCAGCTACTTGGGAGGC"
"GL873581","759283","759365","chr6","46535476","46535542","30","45776193","TAAGAACCTGAAAATAGAGCCAGGCATAGTGGTACATGCGTATAGTCCTGGCTACTCAGGAGGTTGAAACAACAGGATTACTT","CAAAATAGCCAGGCTTGGTGGTGCATGCCTATAATCCAAGCTACTCGGGAAGCTGAGGCAGGAGAAT"
"GL873581","1145844","1145979","chr1","29437872","29437991","29","28292028","GGCCGGGCGTGGTGGCTCACGCCTGTAGTCCCAGCACTATGGGAGGCCGAGGCGGGTGGATCACCTGTGCTCAGAGGTTCGAGACCAGCCAAGACCCCCCTGAGCCAAATGAGCCAGAGTGAGACCCCGTCTCTAC","GGCCGGGCGTGGTGGCTCACGCCTGTAATCCCAACATTTTGGGAGGCCAAGGCGGGTGGATCACCTGAGGTCAGAAGTTCGAGACCAACCTGGCCAACATGGTGAAACCCCTGTCTCTAC"
"GL873581","9628238","9628362","chr5","141044567","141044691","34","131416329","ATCCCAGGTAGTCGGGAGGCTGAGGCAGGAGGATCACTTGAACCCAGGAGGTTGAGGTTGCTGTGAGCAAGGCAGAGGCAACGGCACTCTAGCCACGGGGGCACAGAGACTCTTGTCTTTAAAAA","TAATCTCAGCTACTCGGGAGGCTGAGGCAGGAGAATCGCTTGAGCCCAGAAGGTGGAGGTTGCAGTGAGCCAAGATCGCGCCATTGCACTCCAGCCTGGGCGACAGTGCGAGACTCTGTCTCAAA"
"GL873582","1580485","1580534","chr6","32576760","32576806","12","30996275","CAGCACTTGAGAGGCCAAGGCAGGTGGATCAACTGAGCAAGAATGAGACC","CCAGCACCTTGAGAGGCCAAGGCAGGTGGATCACCTGAGGTCAGGAG"
"GL873582","1644368","1644551","chr1","211626449","211626612","63","209982081","AAAATTTGCCGGGCTCCATAGCTCATGCATGTAATCATAGCACTCTGGGAGGCCAAGATGGGAGGATCTCTCAAGCTCTCTTACTTGGGAGGCTGAGGTTGCTGTGAGTTAGGCTTACGCCACAGCACTCTACTCTAGCGTGAGCAACTCTACTCTTAGTATGAGACTGTCTCAAAAGAAAAAA","AAATTAGCCAGGCGTCGTGGCACATGCCTGTAATCCCAGCTACTCGGGAGGCTGAGGCAGGAGAATAGCTTGATCTCGGGAGGCGGAGGTTGCAGTCAGCCGAGATCACACCACTGCAATCCAGCCTGGACAACAGAATGAGACTCCATCTCAAAAAAAACAAA"
"GL873582","5794385","5794459","chr13","18872784","18872852","27","13078399","ATATTGTTAAGCACAGCCACTATTAAAAATTAAATTATAGGCCAGGCATAGTGGCTCATGCCTGTAATCCTAGCT","TGAAACCACCATCTGGACCAAGATACAAAATGTTGGCTGGGCATGGTGGCTCACACCTGTAATCCTAGC"
"GL873583","102645","102683","chr14","5808766","5808804","14","5706121","GAGCAGATCACCTGAGCTCAGGAGTTTGAGACCAGCCTG","GAGGAATCCCTGTGCTCAGGAAGCTTACATTCTAGTGAG"
"GL873583","6200447","6200560","chr4","17786849","17786963","24","11586402","GGCCAGGAGGGACGGCTCATGCCTGTTATCCTAGCACTATGGGAGACTGAGGTGGGAGGATCACTTGAAGTTAGGAGTTCCAGACCAATCTGACCAAAGTGAGACCTCATCTCT","GGCCAGGCTTGGTGGCTCATGCCTGTAATCTTAGCACTTTGGGAGGCTGAAGTGGGTGGATCACTTGAGGTCAGGAGTTAGAACCAGTCTGGCCAACATGGTGAAACCTCAGCTC"
"GL873583","6200584","6200752","chr6","169626528","169626696","42","163425944","TTAGCTGGATGTGGTAGCACATGCCTATAGTCCCATCTACTCAGGAGGCTGAGACAAGAGAGTTGCTTAAGCCCAGGAGTTTAATTTAACTGTGAACTAGACTGAGACTGTGGCACTCTAGCTGGGGCAACAGAGTGAGACTCTGTCTCAAAAGAAAGCAAGAAAGAAA","TTAGCTGGGTATGGTGTCAGATGCCTGTAGTCCCAGCTACTCAGGAGGCTGAGACAGGAGAATCGTTTGAACCCAGGAGGCCAGAACTGCAGTGAGCTGAGATTCGCACCACTGCGCTCCAGCCTGGGCCAGACAGAGTGAGACTCTATCTCAAAAGAAAAAAAAAAAA"
"GL873583","10217398","10217583","chr3","36257142","36257313","44","26039744","TACTAAAAATAAAGTGTGATAGCCAGGCATGGTGGTGGTGCCTATAGAACCAGGCTATTCAGGAGGCTGAGGCAGAAGGATCACTTGAACCCAGGAGTCTGACGTTGCTGTGAGCTAGGCTGGTGCCATGGTACTCTAGCCTGTGGTAACAGAATGAGACTCTATCTCAAAAATAAAAATAAAAAA","TACAAAATTAGCCAGGCGTGGTGGTGCGTGCCTGTAATCCCAGCTACTTGGGAGGCCGAGGCAGAAGAATGACTTGAACCCAGGAGACAGAGGTTGCAGTGAGCCAAGATCCCACCATTGTACTCCAGCCTGGGCAACACAGTGAGACTCCATCTCAAAAAAAAAAAAAAAA"
"GL873583","10394919","10394983","chr16","12841703","12841771","22","2446784","GAGGTCAGGAAATCAAGATCAGTCTGGGCAATATATTGATACCCTGCCCCTACATAAGGAAGAAA","AGGTCAGGAGTTCAAGACCAGCCTGGCCAATATGTTGAAACCTCATCTCTACTAAAAATACAAAAATTA"
"GL873584","521512","521529","chr1","167402212","167402233","10","166880700","GCATGGAACCCCCCACTC","GGTGAAACCCCATCTTTACTAA"
"GL873584","2079725","2079768","chr15","4338291","4338335","11","2258566","GGCAGGTGGATTACCTGAGTTCAGGAGTTGGAGACCAGCCTGAC","AGGCGGATGGATCACGAGGTCGGGAGTTTGAGACCAGCCTGACCA"
"GL873584","5216877","5217053","chrX","91350057","91350230","49","86133180","CTACTGAAAATGATGACAGAGGCTGGGCATGGGGGCTCCCGCCTGTTATCCTAGCACCCTCGGAGGCTGGGGAATGAGGATTGCTTACGCCCAAGAGTTTGAGGTTGCTGTGAGCTGAGGCCGCTGCACTCTAGCCTGGGCAACAGAGTGAGACTCTGTCTCAAAAAAAAAAAAAAA","TGCAAAAATGAGCTGGGCATGGTGGCACATGCCTGTAATCCCAGCTACACAGGAGGCTGAGGCAGGAGAATCGCTTGAATCTGGGAGGCGGAGGTTGCAGTGAGCTGACATCAGGCCCCTGCACTCTAGCCTGGGCCACAGAGCAAGACTCCGTCTCAAAAAAAAAAAAAAAAA"
"GL873584","7289930","7289950","chr2","51453328","51453345","10","44163398","TGAGGCTCTGTCTCGAAATAA","AATGCCATCTATTAAAAA"
"GL873584","7289975","7290131","chr11","49739997","49740154","37","42450022","CAAGAAAATTAGCTGAGAGTCCTGGTAGGTGCCTGTAATCCCAGCTATTCATGAGGCTGAGGCAGAAGGATCACTTGGGTCCAGGAGTCTGAGGTTGCTGTGAGCTAGTCTGACGCCATAACACGCAAGCCTGGGCAACAGAGTGAGGCTCGGTTTC","CTACAAAAATTAGCTGGGCGTGGTGGCACATGCCTGTAATCCCAGCTACTCGGGAGGCTGAGGCAGGAGAATCACTTGAGCCCAGGAGGCGGAGGTTGCAGTGAGCCAAGATCATGCCATTGCACTCCAACCTGGGCAACAGAGCAAGACTCCATCTC"
"GL873584","7577743","7577867","chr5","48394329","48394446","27","40816586","GGCTGGATGAGGTGGTTCATGCCTGTAATCCTAGCACTCTGGGAGGCCAAGGTGGGTGGATTGCCTGAGCTCAGGAGTTCAAGACCAGCCTGAGCAAGACCCTGTCGCTAAAAATAGCTGGGTGT","GGCTGGGTGCAGTGGCTCATGCCTGTAATCCCAGCACTTTGGGAGGTCAAGGCGGGTGGATCACCTGAGGTCAGGAGTTCAAGACCAGCCTGGCCAACATCTCTACTAAAAATACAAA"
"GL873584","7578135","7578289","chr1","130112713","130112865","31","122534578","GGAGCTGGGTTTTGTGACTGCACCTGTAATCCCAGCTGCTCAGGAGGCTGAGGCAAGAGAATTGCTTGAGCCCAGGAGTTGGAGGTTGCTGTGAGCTGTGATGCCAGGGAACTCTACCAAGGGTGACAAAGTGAAACTCTGTCTCAAAAAAAAAA","TTAGCCAGGTGTGGTGATGCATGCCTGTAATCCCAGCTACTCATGAGGCTGAGGCAGGAGAATTGCTTGAACCTTGGAGCTGGAGGTTGCAGTGAGCTGAGATCAGACCACTCCAACCTGGGTGACAGAGCGAGACTCTGTCTCAAAAAAAAA"
"GL873585","1450952","1451121","chr10","59681079","59681242","48","58230127","TAAAAACAGAAAAAACTAGTCAGGTGGTGTGGTAGGTGCTCATAAGTCCCAGCTGCTTGGGAGACTGAGGCAAGAGAATCACTTGAGCACAAGAGCTTGAGGTGGCTGTGAGCTATAACACCATAGCACTGTACTGAGGGTGACAAAGTAAGACTCTGTCTCAAAAAAAA","TACAAAAATTAGTCAAGGGTGGTGGTATGTGCTTGTAATCCCAGCTATTTGGGAGGCTGAAGCAGGGGAATCCTTGAACCCAGGAGGTGGAGGTTGCAGCGAGCCGAGATCACGTCACTGCACTCTAGCCTGGGCGATAGGGTGAGACTCTGTCTCAAAAAAAA"
"GL873585","1451382","1451515","chr6","17405813","17405948","24","15954431","GGCCCGGCTCGGTGGCTCACACCTATAATCCTAACACTCTGGGAGGCTGAGGCAGGTGGATCACCTGAGCTCAGGAGTTTGAGACCAGCTGAGCAAAAACAAGACCCTATCTCTGCTAAAAATAGAAAAAACTA","GGCCGGGCGGGGTGGCTCACGCCTGTAATCCCAGCACTCTGGGAGGCCAAGGCAGGTGGATCACCTGAGGTCAGGAGTTTGAGACCAGCCTGGCCAACACGCAGAAACCCTATTTCTACTAAAAACACAAAAATTA"
"GL873585","1626960","1627026","chr7","17782729","17782794","22","16155769","AAGATGCCACAGCACTCTACAAGAGTGACCAAGTGAGACTCTGTCTCAAAAAAAAAAAGAAAAGGAA","CAATCGCACTACTGCACTTCAGCCTGGGTGACAGAGTGAGAACCTGTCTCAAAAAAATAAATAAAA"
"GL873585","1627304","1627531","chr11","17033552","17033788","61","15406248","GGCTGGGCACAGTGGCTCACGGCTATAATCTAGGCACTTGGGAGGCTAGGGCAGGTGGATTGCCTGAACTGACAAGTTTGAGACCAACCTGAGCAAGAGCGAGACCCCTGTCTCTAAAACATAGCCAGGCTCTGTGGTGGGCGTCTGTAGTCCCAGCTACTTGGGAGGCTGAGGCAAGAGAATTGCTTGAACTCAAGAGTCTGAGGTTGCTGTGAGTTAAGATGCCAC","GCCCGGCGCAGTGGCTCACGCCTGTAATCCCGGCACTGTGGAGGCCAAGGCAGGCGGATTGCCTAAGCTCAGGGATTCGAGAACAGCCTGGGCAACATGGTGAAACCCCATCTCTACTAAAATACAAAAAACTAGCCGGGCGTGGTGGTATGCGCCTGTAATCCCAGCTACTTGGGAAGCTGAGGCAGGAGAATTGCTTGAACCCGGGAGATGGAGGTTGCAGTGAGCTCAGATCAC"
"GL873585","3626082","3626158","chr1","100916857","100916922","27","97290775","TGCCTGTAATCCCAGCACTTGGGAGGCGGAGGTGGGTAGATTGCCTGACCCAGAGTGGGACCTCATCTCTAAAAGAA","CATGCCTGTAATCCCAGCACCTTGGGAGGCCAAGGTGGGTGGATCACCTGAGGTCAGTAGTTTGAG"
"GL873585","8849829","8849913","chr18","48581945","48582025","18","39732116","GGCTGGACGAGGGGACTCATGCCTGCAATCCCAGCACTGAGAGAGGCCAAGGCAGGTGGATCCCCTGAGCTCAGAAGTTTGAGAC","GCTGGACGCAGTGGCTCACACCTGTAATCCCAGCACTTTGGGAGGCCAAAGCAGGCAGATCTGAGGTCAGGAGTTTGAGAC"
"GL873585","9319890","9319971","chr8","79499361","79499447","14","70179471","GGCCAGGTGTGGTGGCTCACACCTGTCATCCTAGCACTCTGGGAGGACGAGGTGGGTGGACCGCCTGAGTCAGAGTGAGACC","GGCCAGGTGTGGTGGCTCACACCTGTAATCCCAACACTTTGGGAGGCCCAGGTGGGTGGATCACCTGAGGTCAGGAGTTCAAGACCA"
"GL873586","895572","895692","chr17","14501559","14501680","38","13605987","GGCCAGGTGAGGTTTCTCATTCTGGGAGTGAGCCAGCAATTGGGAGGCCAAAGTAAATGGATTGCCTGAGGTTATAGGTTCCAGAACAGCCAGAACAAGATCGAAATCCTGTCTCCAAAAA","GGCCAGGCGTGGTGGCTCATGCGTGTAATCTCAGCACTTTGGAAGGCCGAGGCAGGTGGATCACCCGAGGTCAAGAGTTCAAGACCAGCCTGACCAACATGGCGAGTCTCTGTCTCCACTAA"
"GL873586","5645995","5646150","chr6","58863249","58863409","38","53217254","GGGTATGGTGGCTCATGCCTGTAATCCAAGCACTCTGGGATGGTGAGGCAGGAGAATCCCTTGAACCCAAGAGTCCGAGGTTGCTGCGAGCTAAGCTGATGGCATAACACTCTAGCCTAGGCGACAGAGTGAGACTCTGTTTCCAAAGAGAAAAAA","TTAGCCAGGCATGGTGGCACATGCCAGTAATCCCAGCTACTCAGGAGGATGAGGCAGGAGAATCGCTTGAACCCAGGAGGCAGAGGTTGCAGTGAGCTGAGATTGCGCCACAGCACTCTACCCTGGGTGACAGAAGGAGACTCTGTCTCAAAAAAAAAAAA"
"GL873586","10258686","10258969","chr12","9481260","9481565","81","777426","GGCCGGGCATGGTGGCAGAAATCTAGGAGGCCGAGGCAGGTGGATCGCCTGAGATCACAAGTTCAAGACCAGCCTCAGCTACAGCAAGACCCCATCTCTAAAAATAGCCGGCTGTTGTGGCAGGCGCCTGTAACCCCAGCTACTCGGGAGGCTAAGGCAAGAGAATCGCTTGAGCCCATGAGTCTGAGGTTGCTGCGAGCTGTGACTCCACGGCACTCTACCCGGGGCGATAAAATGAGATTCTGTGTCAAAACAAACAAACAAACAAACAACAACAAAAACAA","GCTGGGCGCGGTGGCTCATGCCTGTAATCCCAGCACTTTGGGAGGCCAAGGCAGGTGGATCACCTGAGGTCAGGAGTTCGAGACCAGCCTAGTCCACATGGTGAAACCCCATCTCTACTAAAAACTAGCCAGGCGTGGTGGTGCGCACCTGTAATCCCAGCTACTCGAGAGGCTGAGGCAGGAGAATCACTTGAGCCTAGGAAGCAGAGGTTGTGGTGAGCTGAGATCACACCACTGCACTCCAGTCTGGGCGACACAGTGAGACTCTTGTCTCAAAAACAAAAAACAAACAAACAAACAAACAAA"
"GL873587","3208032","3208047","chr8","3626746","3626762","2","418714","AAACAACCACAAAAAA","ACAACAACAACAAAAAA"
"GL873587","3208141","3208321","chr19","2057131","2057316","59","1151010","TTTCTTTTAAAAATCACCCATGGGCTGGGTATAGTGGCTCACACCTATAATCCTCGGGAGGCCAAGGTTGGAGGATTGCTTGAATCCAGGAGTTGAAGGTTACAGTGAACTGGGATTTAGCCACTAGACTCTAGCATAGCTGACAAAGCAAGAACCTATTTGTTTAAAACACAAAAAAGAA","TACTAATAATACAAAAATGAGCCGGGTATGGTGGCGGGTGCCTGTAATCCCAGCTACTGAGGAGGCTGAGGCAGGAGACTTGCTTGAACCCAGGAGGTAAAGGTTGCAGTGAGCTGAGATTGCACCACTACACTCCAGCCTGGGCGACAAGAGCAAAACTTTTTCTCCAAAAAAAAAAAAAAAAAA"
"GL873587","3278260","3278367","chr19","19044200","19044312","39","15765940","CAGTCTGAGCAAGAGGGAGAGGCTATTTCTACTAAAAACAGAAAAACTAGCTGGGTGTTGGGGTGTGTTCCTAGTCTCAGTTACTTGGGAGGCTGAAGTAAGAGGATC","ACCAGCCTGGCCAACACGGTGAAATCCCGTCTCTACTAAAAATACAAAAATTACCTAGGCGTGATGGCACGTGCCTGTAGTCCCAGCTACTCATAAGGCAGAGGTGAGAGAAT"
"GL873587","3278673","3278754","chr7","49412503","49412597","28","46133830","GGCCACGAGAGCTAGCTCATGCCTATTCTAGGAGGCCAAAGCAGGCAGACTGCCTGAGCTCAGGAGTTCAAGAGCAGCCTGG","GGCCAGGTGCAGTGGCTCATGCCTGTAATCCGAGCACTTTGAGAGGCCGAGGCAGGCAGATCACCTGAGGTCAGGAGTTCAAGACCAGCCTAGTA"
"GL873587","3782076","3782188","chr9","112128434","112128552","34","108346358","ACTGGGGTGGCTGAGGCAGGAGCGTCACTTGAACTCAGGAGTTTGAGATTGCTGTGAGCTGAGCAGATGTCATGGCACGCTAGCCTAGGTAATAGAGTGAGACTTCGTCTAAA","CAGCTACTCGGGAGGCTGAGGCAGGAGAATCACTTGAACTCGGGAGGCGGAGGTTGCAGTGAGCCGAGATCACGCCATTGCACTCCAGCCTGGGCAACAAGAGCGAAATTCCATCTCAA"
"GL873587","4564996","4565084","chr20","27900350","27900437","14","23335354","GGCGGGGTGTAGTGGCTCATGCCTATTGTCCCAGCACTGTGGGAGGCCGAGGTGGGTGGATCACCTGTGCTCAGAAGTTTGAGACCAGC","GGCCGGGCGTGGTGGCTCATGTCTGTAATCCCAGCACTTTGGGAGGCCGAGGTGGGTGGATCACCTGAGGTCAGGAGTTCAAGACCAG"
"GL873587","6307870","6308175","chr12","112427710","112428020","54","106119840","GGCCAGATATGATGGCTCATGCTTGTAATCCTAGCACTCTGGGAGGCTGAAGTGGGAGGATCACCTGAGATCAGGAGTTCAAGATCACCCTGAGCAAAAGTGAGATCCCATCTCTATTAAAAATAAAAAAATTATCCAGGCATGGTGGTGCAGTCCTTTAGTCCCAGCTACTTGGGAGGCTGAGGCAGGAGAATCTCTTGAACCCAGGAATTAGAGGTTACAGTGAGCTGTGATGATGCTACTGCACTCTAGCAGGATGACAGAGTGAGATACTCCGTGTCAAAAAAAAAAAAAAAAAAAGCAAAA","GGCTGGACATGGTGGTTCATGCTTGTAATCCGAGCACTTTGGGAGGCCAAGGCGGGTGGATCACCTGAGGTTGGGAGTTCGAGACCAGCCTGACCAACATGATGAAACCCCATCTCTACTAAAAATACAAAAAAATTAGCCAGGCATGGTGATGCACGCCTGTAATCCCAGCTACTTGGGAGGCTGAGGCAGGAGAATCACTTGAACCCAGGAGGCAGAGGTTACAGTGAGCCGAGATCATGCCATTGCACTCCAGCCTGGATGACAGAGTGAGCCTCTGTCTCAAAAAAAAAAAAAAAAAAAAAAAAAAA"
"GL873587","6484004","6484128","chr10","67341428","67341546","29","60857424","GACCAGGTTCTGTGGCTCATGCTTGTAATCCTAGCACTCTAGGAGGCCGGAAGAGGGTGGATTGATTGCCTGAGGTCAGGAGTTAGAGACCAGCCTGAGCAAGAGCTAGACCCTGTTTCTTTCTT","GGCTGGGTGTAGTGGCTCATGCCTGTAATCCCAGCACTTTAGGAGGCCAAGGTGGATGGATTGCCTGAGCTCAGGAGTTCGAGACCACCCTGGGCAACAAGCCAAAACCCTGTCTCTAC"
"GL873587","6484407","6484586","chr3","167196537","167196723","48","160712130","TAGACCCTGTTTCTAAAAAAAAAATAGCCAGGTGTTGAGGCAGGTACCTGTAGTCCCAGCTACCTGGGAGGGCTGAGGCAAGAGAATCGCTTGAACCCAAGAGTTTGAGGTTGCTGTGAGCTGAGATGCTATGGCACTCAACCGTGAGCTACAAAGTGAGACTCTGTCTCAAAAAAAAAA","AAAACCTGTCTCTGCTAAAAATACAAAAATTAGCCGGGTGTGGTGATGTGCGCCTGTAGTCCTAGCTACTTGGGAGGCTGAGGCAGGAGAATCACTTGAATCCAGGAGGTGGAGGTTGTAGTGAGTCGAGATCGTGCGACTGCACTCCAGCCTGGGTGACAGCGAGACTCTGTCTCAAAAAAAAAAA"
"GL873587","7466229","7466364","chr1","29437872","29437991","35","21971643","GGCCAGGCGTGGTGGCTCATGCCTGTAGTCCCAGCGCTATGGGAGGCCGAGGTGGGTGGATCACCTGTGCTCAGAGGTTCGAGACCAGCCAAGACCCCCCTGAGCCAAATGAGCCAGAGTGAGATCCCATCTCTAC","GGCCGGGCGTGGTGGCTCACGCCTGTAATCCCAACATTTTGGGAGGCCAAGGCGGGTGGATCACCTGAGGTCAGAAGTTCGAGACCAACCTGGCCAACATGGTGAAACCCCTGTCTCTAC"
"GL873588","1502535","1502718","chr1","34852429","34852590","60","33349894","GGTGCAGTGGCTCACACCTGTTGTCCCAGCGCTGTGGGAGGCCGAGGTGGGTGGATCACCTGTGCTCAGAGGTCGAGACCAGCTGAAGACCTGCCTGAGGCAGAGTGAGCCAGAGTGAGACCCCGTCTCTACTAGAACAACAACAAGACAGCCAGACCTTGTGATCCCAGCTACATGGGGGGCT","GCCAGGTGCAGTGGCTCACACCTGTAATCCCAGCACTTTGGGAGGCCGAGGCGGGCGGATCACCTGAGGTCAGGAGTTTGAGACCAGCTTGACCAACATGGAGAAACCCCGTCTCTACTAAAAATACAAAATTAGCCTGGTGTGGTGTCGCATGCCTGTAAT"
"GL873588","10189037","10189246","chr3","45604681","45604903","65","35415644","GCTGAGATGAGGAGACTCTGTCTCTATTAAAAATAGAAAAATTGGGTGGATGTTGTGGGTACTGTAGTTGCAGCCTCTTGGGGGGCTAAGGCAGGAGGATCAGTTGAAGCCAGGAATTTGCTTTGAGCTAGGCTAAAGCCATGGCACTCTAGCCTGGGCAACAGAGTGAGGCTAGATCTCAAAAAAAGAAAGAAAAGAAAAAGAAAAAAA","CTGGCCAACATGGCAAAACCCCATCTCTACTAAATATACAAAAATTAGCTGGACGTGGTGGCACATACCTGTAATCCCAGCTACTTGGAAGGCTGAGGCAGGAGAATAGCTTGAACCTGGGAGGCAGAGGTTGCAATGAGCTGAGATCACGCCACTGCACTCTAGCCTGGGCAATAGAATGAGACTCTGTCTCAAAAAAAAAAAAAAAAAAAAAGACAAGAAA"
"GL873589","104719","104807","chr20","27900350","27900437","13","27795631","GGCTGGGCGTGGTGGCTCATGCCTGTTGTCCCAGCGCTGTGGGAGGCTGAGGTGGGTGGATCACCTGTGCTCAGAGGTTCGAGACCAGC","GGCCGGGCGTGGTGGCTCATGTCTGTAATCCCAGCACTTTGGGAGGCCGAGGTGGGTGGATCACCTGAGGTCAGGAGTTCAAGACCAG"
"GL873589","796766","796905","chr1","166346372","166346487","49","165549606","GGCTAAGTGTGGTGGCTCACACCTGTCATCTAGTACTTTGGGAGGGTGGGCCTGGGAGTTCAAAGACTGAACTCAGGAGTTCAAGGTGGCTCCGGGGAGGAATTCAAGACCAACCTGAGCCAGAGCGAGACCTCGACTCT","GGCCAGTGGGGTGGCTCACGCCTGTAATCCCAGCACTTTGGGAGGCTGAGGTGGTCAAATGACCTGAGGTCAGGAGTTTGAGACCAACCTGGCCAACATGGTGACACCTCGTCTCT"
"GL873589","1023679","1023690","chr1","205890061","205890072","1","204866382","AAAAAAAAAAAA","ACAAAAAAAAAA"
"GL873589","1023771","1024047","chr4","103012712","103012993","70","101988941","GGCTTGGTGGCTCACACCTGTAATCCTAGCACTCTGGGAGGCCGAAGTGGCTGGAATACTTGAGGTCAGGAGTTCAAGACCAGCCTAAGTGAGAGTGAGATCCCCATCTCTAATAAAAATAGAAAAATTAGCAGGGTGTTGTGGCTGGCACTTGTAGTCCCAGCTACCCAGGAGACCGAGGCAGAAGTTTGAGATTATTGTGAGCGAGGCTGATGCCACAGCATTCTAGTGGGACAACAGAGCAAAATTCTATCTCAAAAGAAAAAAAAAAAAAGGA","CGGGCGTGATGGCTCACGCCTGTAATCCCAACACTTTGGGAAGCCGAGGCGGACGTATCACCTGAGGTCAGGAGTTCAAGACCAGCCTGGCCAACATGGTGAAACCCCGTCTCTACTAAAAATACAAAAATTAGCTGGGTGTGGTGGCATGCGCCTGTAATCCCAGCTACCCAGGAGGCTGAGGCAGGAGAATCGCTGAGGCTGCAGTGAACTGAAATTGTGCCACTGCACTCCAGCCTGGGTGACAGAGCAAGACTCTGTCTCAAAAAAAAAAAAAAAAAA"
"GL873589","4820958","4821024","chr8","33633747","33633811","15","28812789","TTAGTCAAGTGCAGTGGCTCACACCTGTCATCCCAGCTACTTGGGAGGCTGAGGCAGGAGAGTTGCT","TTAGCCAGGTGTGGTGGTGCATGCCTCTAATCCCAGCTACTCAGGAGGCTGAGGCAGGAGAATTG"
"GL873589","6763768","6763857","chrX","25814002","25814092","29","19050234","GGTGTGGTGGCTCACACTTGTATCTTAGCATTTTAGGAGGCTGAATGGGGAGAATTGCTTTAAGTCAGGAGTCTGACTTCCACCTTGCCA","GGCTGGGAATGGTGGCTCACACCTGTAATCCCAGCACTTTGGGAGGCTGAGGTGGGCAGATCACCTGAGGTCAGGAGTTTGAGATCAGCCT"
"GL873589","8444551","8444632","chr9","93194085","93194171","17","84749534","CGGGCATGGTGGCTCACAACTATAATCTTAGCACTTTGGGAGGCTGAGACAGGTGGATGCCTGAACTCAAGAGTTTGAAACC","GGCCGAGCATGGTGGCTCACACCTGTAATCCCAGCACTTTGGGAGGCTGAGGCAGGTGGATTACCTGAGGTCAAGAGTTCAAGACCA"
"GL873589","9085365","9085494","chr2","194063347","194063481","42","184977982","GGCCAGGCACAGTGGCTCACACCTATAATCCCAGCACTCTGTGAGACTGAGGCAGGTGAACTGTTGCAAGAGTGAGACCCTGTGCTTGGTGCCTGTAGCTCAGTGGTTAATAATAAGAAAAAAGAAAAAA","GGCCAGGTGCAGTGGCTCACACCTGTAATCCCAGCACTTTGGGAGTCTGAACCAGGCAGATCACCTGAGGTCAGGAGTTCGAGGCCAGCTCGGCCACCATGGTGAAACCCTGTTTCTAATAAGAATACAAAAAAA"
"GL873589","9085767","9086002","chr7","84631446","84631650","75","75545679","GAGTGAAACCCTGTCTCTACTAAAAATAGAAAAACTAGCTGTGCATCAGGGCGCATAACTGTAGTCCCAGGTACTCAGGACACTGAGGCAAGAGAATTGCTCAAGCCCAAGAGTTTGCAAGAATTTGAGGTTGCTATGAGCTATGATGCCATGGCACTCTACCTAGGGTGACAGACAGAGACTCTGTCCCAAAAAAAAAAAAAGAAGAAGAAGAAAAAAAAAAAGAAAGAAAGAAA","ATAGTGAAACCTCGTCTCTACTAAAAATACAAAAATTAGCTGGGCATCATGGTGCACGCTTGTAATTCCAGCTACTTGGGAGGCTGAGGCAGGAGAATTGCTTGAACTCAGGAGGTGGAGGTTGCAATGAGCCAAGATCGCGCCACTGCACACCAGCCTGGGTGACAAAAGACTCTGTCTCAAAAAAAAAAAAAAAAAAAAAAAA"
"GL873589","9992904","9993045","chr16","56427538","56427666","46","46434634","AACCAGCCAGGCATGGTGATTCACACCTATAATCCCAGCTACTTAGGAGTATGGCTTGAGCACACAGGATACCATACCATTCTAGTCATCCCAGGCAACAGAGGGAAACTCTGTTGGTTAAAAAAAAAGAAAAACTTAAAAA","TTAGCCAGGAGTGGTGGTGCACGCCTATAATCCCAGCTACTTGGGAGGCTGAGGCACAAGAATCACTTGAACCATTGCACTCCAGCCAGGGTGATAGAGGGAGACTCTATCCAAAAAAAAAACAAAAAA"
"GL873589","9993319","9993452","chr3","2774534","2774668","28","7218785","GGCCTGAGCCCTGTGACTCATGCCTGTAATCCCAGCACTGGAAGTTCCAAGGCAGGTGGATCGCTTGAGCTCTGGAGTTCAAGACCAGCTCAACCAAGAGTAAGACCCCATCTCTACTAAAAATAGAAAAACCA","GGCTGGGCACGGTGGCTCATGCCTGTAATCCCAGCACTTTGAGAGGCCGAGGCAGGTGGATCTCCTGAGGTCAGGAGTTCAAGACCAGCCTGGGCAACATGGTGAAACCCCATCTCTACTAAAAATACAAAAAAT"
"GL873590","9044589","9044884","chr1","83754525","83754835","84","74709936","GGCCAGGTGCAATGGCTCATGCCTATAATCCTCACACTCTGGGAGGCTGAGGCAGGAGGATCACTTTTCTCAGGGTCAGGGCCAGCCTGACAAAAGTCAGACCCTGTTTCTACTAAAAATAGAAAAACTAGCTGGGTGTTGTGGCAGATGCCTATAGTCCCAGCTACTAAGAGACTGAGACAAGTGCCCAGAGTCTGAGGTTACTGTGAGCAAAGCTGATGCCATAGCATTCTAGCTATAGATCGAGAGTCTGTCTCAAAAACAAACAAACAAACAAACAAACAAACAAAAAAGAA","GGCTGGGTGTGGTGGCTCATGCCTGTAATCCCAGCACTTTGGGAGGCCGAGGCGGGTGGATCATCTGAGGTCAGGAGTTCAAGACCAGCCTGACCAACATGGTGTAACCCTGTCTCAACTAAAAATACAAAAATTAGCTGGGCGTGGTGGTGTGCACCTATAGTCACAGCTACTTGGGAGGCTGAGACAGGAGAATTGCTTCAACCCAGGAAGTGGAGGTTGCAGTGAGCCAAGATCATGTCACTGCACTGCAGCCTGACAGAGCGAGACTCCATCTAAAACAAACAAACAAAAACAAACAAACAAACAAA"
"GL873591","1831505","1831587","chr17","61702818","61702899","25","59871313","CCCAGCACTTTGGGAGGGCAAGATGGGAGAATCATATAAAGTCAGGAGTTTGAGACCAGTTTGGCAGACATGATGAACCCATC","AATCCCAGCACTTTGGGAGGCTGAGGCAGGCGGATCATCTGAGGTCAGGAGTTCAAGACCAGCCTGGCCAACATGGTGAAAC"
"GL873591","2719175","2719275","chr4","86137755","86137847","32","83418580","GTGGGGGCTTAGGCCTGTAATCCCAGCACTCTGAGAGGCCAAGGTGAGCTGGTCACCTGGGTTTAGGAGTTTGGAGACTTGCTCGAGCTAGACTGAGGCTC","GTGGTGGCTCACGCCTGTAACCCTAACAATTTGGGAGGCCAAGGCAGGTGGATCACTTGAGGTCAGAAGTTTGAGACCAGCCTGGACAATATG"
"GL873591","4732974","4733120","chr19","7991801","7991954","55","3258827","ATACGCAGACTGGCCGAGCGTGGTGTCACATGCCTATAATCCCAGTGGCTACTCTGGGGAGGAGAATCTCTTGAAACCAAGAGTTAGAGATTGCAGTGGGGTATGATACAGGGTAACAAAGAGAGACCTTGGATCTGAAAAGAAAAA","AAAATACAGAAACTAGCTGGGCATGGTGATGCACACCTGTAATCCTAGCTACTGGGGAGGCTGAGGCAGGAGAATTGCTTGAACCCAGGAGTCAGAGGTTGCAGTGAGCAACCAGCCTGGGTGATACAGTGAGTGAGACTCTGTCTCGAAAAAA"
"GL873591","6822728","6823009","chr1","20579766","20580052","72","13757038","GGCCAGGCGTGGTGGCTCATGCCTGTAAATCTCAGCACTCTGGGAAGCTGAGGCAGGTGGATTGCTTGAGGTCAGGAGTTTGAGACCAGCCTGTACCAGAGTAAGACCCTGTCTCTAATAAAAATAGAAAAAAAAAAAAAAACTAGTTGGGCATGGTGATGGGTGCCTGTAGTCCCACCTACTTGGGAGGCTGAGGCAATGGCATCTCTTGAGCCCAAGAGTTTGAGGTTGCTGTGCCATGGCACTCTCCCCAGGGTAACAGAGTGAAAATAAAAAAAAGAA","GGCCAGGCGTGGTGACTCATGCCTGTAATCTCAGCACTTTGGGAGGCCGAGGCAGGTGAATCACCTGAGGTCAGGAGTTTGAGACCAGCCTGACCAACATGGTGAAACCTCGTCTCTACTAAAAATACAAAAAGTAGCCAGGCATGGTGGCGCATGCCTGTAATCCCAGCTACTTGGGAGGCTGAGGCAGGAGAATCGCTTGAACCCGAGAGGCAGAGGTTGCATTGAGTCAAGATGGTACCACTGCACTCCAGCCTGGGTGACAGATTGAGACTCAAAAAAAAAAA"
"GL873591","7578706","7578813","chr16","45055441","45055543","42","37476735","AAATTTAGCTACACATAGTGGCATGAGTCTGTAATGCTAGCCACCCAAAAGGCTGTAGTAAGAGGATTGCTCTATCCCAGGAGTTAAAGACCAGCCCGGACATCAGAG","AATTAGCCGGGCGTGGTGACACACACTTGTAATCCTAGATACTCAGGAGGCGAAGGTAGGAGAATTGCTTGAACCCAGGCAGCAGAGGTTGCAACGAGCAGAG"
"GL873591","9282916","9283004","chr1","20744253","20744338","16","11461337","GGCCAGGCGCGGTGGCTCACCCCTGTTGTCCCAGTTCTGTGGGAGGCCGAGGTGGGTGGATCACCTGTGCTCAGAGGTTTGAGACCAGC","GGCCAGGCACGGTGGCCACGCCTGTAATCCCAGCACTTTGGGAGGCCGAAGTGGGTGGATTACCTGAGGTCAAGAGTTTGAGACCA"
"GL873592","835155","835315","chr16","75654291","75654451","43","74819136","CTGGGTGTGGTGGCTCTTGTCTGCAATCTCAGTACACTGGGAGGCTGAGGCAGAAGGATTGCTCCAGCTCAGGAGTTTGAGGCCAGGCTGAGCTAGTGCAAAACCCCATCTCTACTAAAAAAAGAAGGAAAAAAAAAAGAAAAAGAAAAAAAATACGAGCT","CCAGGTGTGGTGACTCACGCCTGCAATCCCAGCACTCTGGGAGGCTGAGGTGGGTAGATTACCGGAGGTTAGGCGTTTGAGACCAGCCTGGCCAACATGGTGAAACCCCATCGCTACTAAAAAAAAAAAAAAAAAAAAAAAAAAAAAAAAAAAAAAAATTA"
"GL873592","835589","835765","chr1","66836166","66836336","48","66000577","ACAAAAAACCTAGCTTAGGGTTGTTATAGCACCTGTAGTCCCAGCTACTCAGGCGCTAAGGCAGGAAAATCTGCCTGAGCTCAGGAGTTTGAGGTTGCAGTAAGTTATGATGATGCTACTGCACTCTAGCTGGGGCAACAGAGTGAGACTCTGTCTGAGGAAAAACCAAAACCAAAA","TAGCCCAGCACGGTGGCTCACACCTGTAGTCTCAGCTACTCAAGAGGCTGAGGCATGAGAATCGCTTGAACCCAGGAGGTAGAGGTTGCAGTGAGCTGAGATCATGCCACTGCGCTCCAGCCTGGGCAACAGAGTGAGACTCAGTCTCAAAAAACAAAACAAAACAAAAAA"
"GL873592","2520661","2520705","chr16","66853217","66853257","11","64332556","TCTGGGAGGCTGAGGCGGGTGGATCACCTGAGCAAGAGTGAGACC","TTTGGGAGGCTGAGGCAGGTGGATCACTTGAGGTCAGGAGT"
"GL873592","4535248","4535388","chr1","12240468","12240612","38","7705220","GGCGGGATGTGGTGGTTCATGGCTGTAATCCCAGCACTCAGGGAGGCTGAGTCGGGTGGATTGCTTGAGTTCAGGAGTTTGAGACCAACCTGAGCAAGAACTAAGCCTGTCTCTACTAAAGATATTATTTCTTATTTTTCT","GGCCGGGCGCGGTGGCTCATGCCTGTAATCCCAGCACTTTGGGAGGCTGAGGCGGGTGGATCACCTGCGGTCAGGAGTTCGAGACCAGCCTGGCCAACGTGGTGAAACCTCATCTCTACTAAAAATATAAAAATTAGCTGGTGTG"
"GL873592","4535654","4535831","chr8","126054004","126054184","54","121518350","TCTACTACAAATATTAACAGAAAAATTAGCTGGGCATTGTGACAGGTGCCTATAGTCCCAGATACTCAGAAGGCTGAAGTAAGAGGATCACTTGAACCCCAGGAGCTAAGGTGGCTGTGAGCTAGGCTGAGGCTCTAGCCTGGGTAACAGAGTGAGACTGTAAAAAAAGAAAGAGAGA","GTCTCTACTAAAAATACAAAAATTAGCTGGGTGTGGTGGTGCATGCCTGTAATCCCAGCTACTCAGGAGGCTGAGGCAGGAGAATCGCTTGAACCCAGGAGGTAGAGGTTGCAGTGAGCCAAGATCATGCCACTGCACTCCAGCCTGGGTGACAGAGGGAGACTCTGTCTCAATAAATAAA"
"GL873592","6794968","6795049","chr3","154764711","154764794","20","147969743","GAAGGTTTGATGAGCTCAGATGATGCCACTGCAGTCTACCCAGAGTGAAGGAGCGAGACTCTGTCTCAAAAACAAAAAAAGA","CAGAGGTTGGCAGTGAGCTGAGACTGTGCCACTGCACTCCAGCCGGGTGACAGAGTGAGACTCTGTCTCAAATTACAAACAAAA"
"GL873592","6881384","6881478","chr5","24882384","24882475","28","18001000","GGGCAGGCATAGTGACTGGTGTCTCTAATCCTAGCAGTCTGGGATGCTGAGGCAAGTGGAATGTCAGAGTTCAGGAGTTGAAGATCACCCTGACT","GGCCGGGCGCAGTGGCTCACATCTATAATCCTAGCATTTTGGGAGGCTGAGGCAGGCGGATCACCTGAAGTCAGGAGTTTAAGACCAGCCTG"
"GL873592","6881755","6881937","chr10","61601371","61601572","66","54719616","TCACCCTGACCAAGAGCAAGACCCTGTCTCTACTAAAAATAGAATAAACTAGCTGGGAATTGTGGTGGGTGCCAGTAGTCCCCGCTACTGAGGCAGGAGGATCATTGAGTCCAAGAGTTTGAGGTTGCTGTAAGTTAGGACACCACAGCACTCTACACAGAGTAAGACTGCCTCAAAAATAAA","AGTAAAGAAAAGAAACCCTGTCTCTACTAAAAATACAAAAATTAGCTGGGTGTGGTGGTGCGCACCTGTAGTCCCAGCTACTTGGGAGGGTGAGGTATGGGAATCACTTGAACCCGGGAGGTGGAGGTTGCAGTGAGCCAAGATCACACCACTGCACTCCAGCCTGGGTGAGAGAGTGAGACTCTGTCTCAAGAAAAAAGAA"
"GL873592","7006080","7006155","chr1","8947061","8947129","24","1940981","CACACTGAGAGGCAAAGGCTGGTGGATCACCTGAGCTCAAGAGTTTGAGACCAGCCAAGCCAGAGATCTTGTCTCT","CACTTTGGAGCCAGGTAGGTGATCACCTGAGTCAGGAGTTCGAGACAGCCTGGCCAACATGTGAAACCC"
"GL873592","8446508","8446655","chr11","122502739","122502874","48","114056231","TTAGCTGGGTGTTGTGGCAGGCACCTGTAGTCCCTCCCAGCTACTTGAAAGGCTGAGGCAAGATGACAGCTTAAACCCAAGAGTTTAAGGTTACTCTATTCAGGGCAACAGAGTGAGACTCCATCTACATAAATAAATAAATAAATAA","GGCTGGGCGTGGTGGTTCACACCTGTAATCCCAACACTTTGGGAGGCTGAGGCCAGCGGATTGCCTGAGCCCAGGAGTTTGAGACCAACCTGGGCAACATGGTGAAACTCCATCTCTACTAAAATACAAAAAGTTA"
"GL873592","8446953","8447008","chr16","44513352","44513404","15","36066399","GACCAGCCTAAGCAAAAAAGAGATCCTATCTCTACTACTAAAAATAGAAAAAATTA","ACCAGCCTCACCAATATGAAGAAACCCCATCTCTACTAAAAATACAAAATATT"
"GL873592","8447239","8447325","chr1","8062863","8062957","21","384376","GGCCAGGAGCAGTGACTCATGCCTAGCACTCTGGGAGGCCAAAGCAGGTGGATCAACTGAGCTCAGGAGTTCAAGACCAGCCTAAGC","GGCCGGGTGCAGTGGCTCATGCCTGTAGTCCCAGGACTTTGGCAGGCCAAGGCCGGTGGATTACCTGAGGTCAGGAGTTCAAAACCAGCCTAGCC"
"GL873592","8723925","8724000","chr3","42066983","42067054","20","33343058","AATTAGCCGGGCATGGTAGTGTGTGCCCATAATCTCAGCTACTCAGAAAGCTAAGATAGGAAAATTGCTTGAGCTC","TTAGCTGGGTGTGGTAGTGCATGCCTATAATCCCAGCTACTCGGGAGGCTGAGGTGGGAGAACTGCTTGAAC"
"GL873593","384022","384146","chr15","102382935","102383070","28","101998913","GGCCACGAGGGCCCATGCCTGTAATCCTAGCACTCTGGGAGGCTGAGGTGAGTAGATTGCTGAGCTCAGGAGTTCAAGACCAGCCTGTGCAAGAGACCCCATCTCTGCTAAAAATAGAAAAACCA","GGCCAGGTGTGGTGGCTCACGCCTGTAATCCTAGCACTTTGGGAGGCTGAGGCGGGTGGATTGCCTGAACTCAGGAGGTCAAGACCAGCCTGGGCAACACAGTAAAACCCCATCTCTACTAAAATACAAAAAATCA"
"GL873593","384425","384607","chr20","28286874","28287058","50","27902449","GAAAGAAAAGAAAAGAAAAACTAGCAAGATGTTGTAGCTGATGCCTATAATCCTAGCTATTGGAGAGGTGGAGGCAAGAGAATTGCGTGAGCCCAAGAGTTGAAGGTTGCTGTGAGCTGCGATGCCAGAGCACTCCAGGGTGACAGAGTAAGACTCTGTCTCAAAAAAAATTACAAAATAAAA","TAATAAAAATAAAAAAATTAGCCAGGAGTCAAAGCACACGCCTATAACCCCAGCTACTTGGGAGGCTGAGGGAGGAGAATTACTTGAACCCGGGAGGTGAAAGTTGCAATGAGCTGAGATCAAGCCACTGCACTCCAGACTGGATGACAGAGTGAGACTCTGTTTCAAAAAAAAAAAAAAGACAA"
"GL873593","1408445","1408467","chr10","88070368","88070389","9","86661923","AATCTAGAGATGGGGAGAGGTTG","AAAGAGATGGAAGAGAAGAAGA"
"GL873593","4856365","4856484","chr7","56497314","56497433","31","51640949","GCAATCCCAGCTGATCGGGAGGCTGACCCAGAAGAATCCCTTGAACCCAAGAGTCTGAGGTTGCTATGGGTGGATTCTACAGCACTCTAGCCTGGGAGACAGAGTGAGACTCTGTCCCAA","ATCCCAGCTACTTGGGAGGCTGAGACAGAAGAATTGCTTGAACCCGGGAGGTGGAGGTTGCAGTGAGCCAAGATTGTACCACTGCACTCCAGCCTGGCAACAGAGTGAGACTCTGTCTCA"
"GL873593","6661298","6661485","chr10","86749316","86749514","55","80088018","GCAGAGGCTCACATATGTAATCCTAGCACTCTGGGAGGATAAGGCAGGTGGACAGCTTGAGCTCAGGGGTTTGACCAGTCTGATCAAGAGCAAGACCTGTGTCTACTAAAAATAGAAAACCTAGCCAGGTATGATGGTAGATGCCTGTATTCCTAGCTACTCTGGAAGCTAAAGCTAAAGAGTTTGAA","GGTGGCTCACACCTGTAATCTTAGCAATTTGGGAGGCCGAGGTGGGTGGATCACTTGAGGTCAGGAGTTTGAGACCAGACTGGCCAACATGGTGAAACTCTGTCTCTACTAAAAATACAAAAATTAGCCAGTCATGGTGGTGCATGCCTGTAATCCCAGCTACTCAGGAAGCTTAGGCAGGAGAATCACTTGAACCCAG"
"GL873593","6710263","6710446","chr14","4390080","4390244","66","2320183","TTGAAGTCAGGAGTTTAAGGCCAGTCTGGGCAACATAGTGAGACCCCCATCTCTACGAAAATATTTTTTAAAAATTAAAAATAGCTGGGCATAGTGAGGCTGTTGTGAGCTATAACTGCACCACTGCACTCAGCCAAGGACAGAGACCCTGTTCCCTGCCTCAAACAAACCAAAACAAAACAAA","AAGTCTAGAGTTTACAGCCTGGACAACGCAGTGAAACCCTGTCTCTACCAAAAATACAAAAATTAGACAGGTGTGAGAGGCGGAGGTTGCAATGAGCTGAGATCGCAGCACTGCAGTCCAGCCTGGATGACAGAGCGAGACCCCATCTCAAAAACAAAAACAAAA"
"GL873593","7159645","7159716","chr6","178318394","178318465","21","171158749","GATCATGTCACTGCTCTCCAACCTGGGCAATTGAGCAGGAATCTGTCTCAAAAAGAAAAAAAAAAAAGAAAA","CGAGTTCACACCACTGCACCCCAGCCTGGGCAACAGAATGAGACTCGGTTTCAAAAAAAAAAAAAAAAAAAA"
"GL873593","7159841","7160050","chr13","33368171","33368368","69","26208330","GGCCAGGCGTGGTGGCTCACACCTGTTGTCCCAGTGCTGTGGGAAGCCGAGGCAGGTGGATCACCTGAGCTCAGCCGAGTTCGAGACCAGTGGAAGACCAGCATGAGGCAGAGTGAGCCAGAGTGAGACCCCATCTCTACAACAACAACAAGAAGAAAAAAAACAGCCGGACCTTGTGATCCCAGCTACGTGGGGAGCTAGAGAATCACT","GGCTAGGCATGGTGGCTCATGCCAGTAATCCCACCACTTTGGGAGGCCGAGGCAGGTGGATCACCTGAGGTCAGGAGTTCAAGACCAGGCTGGCCAACATGTTATGATGAGACCCTCATCTCTACTACAAATACAAAAATCAGCTGGGCATGGTGGCAAGTGCCTGTAATCCCAGCTACTTGGGAGGCTGAGGCAGAA"
"GL873593","8598292","8598391","chr11","118461023","118461129","33","109862731","AGCCAGGTGAGGTGGTTCACACCTGTAACCCTAGCTGCTTGGGAGGCTGAGGCCTCTCTATCCTGGGCAGTGTGGAGAAACTTTGTTTCAAAAAAAAGAA","GCCGGGCGCGGTGGCTCACGTCTGTAATCCCAGCGCTTTGGGAAGCCGAGGCGGGACTATCCTGGCCAACATGGTGAAACCCCGTCTCTACTAAAAATACAAGAATC"
"GL873594","357249","357377","chr2","75702890","75703011","36","75345641","CCTGGTACCGTAGGTCATGCCTGTAATCCTAGCACTTTGGGATGCTGAGGTGGGCAGATTGCCTGAGCTCACGAGTTCAAGCCATTAGAACTGAGCCTGACCTAGAGTGGGACCTCCAACTCTTTTTTT","GCCAGGCACAGTGGCTCATGCCTGTAATCCCAGCAGTTTGGGAGGCTGAGGTGGGCAGATCACTTGAGGTCAGGAGTTCAAGACCAGCCTGGCTGACATGGTGAAACCCCATCTATACCAAA"
"GL873594","357656","357834","chr7","17608776","17608965","55","17251120","GGGACCTCCAACTCTTAAAATAGCTGGGCATTGTGGTGGGCACCTACAGTCACAGCTACTTGGGAGGCTAAGGCAAGAGACTTGTTTGCAGCCAAGAGTTAGAGGTTGCTGTGAGCTATGAGGCTAGGGCACTCTACAGGGGGCGACAAGTGAGACTGTAAAAAAAAAAAAAGAAAAAA","GTCCCTACTAAAAATACAAAAAATTAGCTGGGCCTGGTGGCAGGCACCTGTAATCCCAGCTACTTGGGAAGCTGAGGCAAGAGAATTGCTTGAACCCAGGAGGCAGAGGTTGCAGTGAGCTGACATCAAGCCACTGTACTCCAGCCTAGGCAACAAGAGCAAGACTCTGTCTCAAAAAAAAAAAAAAAAA"
"GL873594","1410711","1410996","chr5","151340503","151340797","76","149929792","CACAGTGGCTCATACCTATAATCCTAACACTCTGGGAGGCCAAGGTGGGTGGACTGTCTGAGTTTGGGACCAGCCTGAGCAAAAGCAAGACTCCCATCTCTACTAAAAACAAAGACAGCCAGGTATGAGGGCAGGTGCCTATCATCCCAGCTACTTGGGAGGCTGAGGAAGGAGGATCACCTAAGCCCAGGACTTTAAGGTTTCTGTGAACTAAGATGATGTTACAACACTCTAGCCAGGGTAACAAGGCAAGATTCTGTTTCAAAAGACAAAAAAAAAAAAAAAA","GGTGGTTCATGCCTGTAATCCCAGCACTTTGGGAGGCTGAGGCAGGTGGATCACCTGAGGTCAGGAGTTCGGGACCAGCCTGGCCAACATGGGGAAACCCCATCTCTACTAAAATACAAAAATTAGCCAGGTATGGTGGCACATGCCTATAATCCCAGCTACTTGGGAGGCTGAGGCAGGAGAATCACTTGAACCCAGGAGGCTAAGGTTGCAGTGAGCCGAGATTGTGCCACTGTACTCCAGCCTGGGTGACAGACTGAAACTCTGTGTCCAAAAAACAAAACAAAACAAAAAA"
"GL873594","5528090","5528162","chr2","69013639","69013718","24","63485549","GGTACAGTGGCTCACGCTTGTGATCCCAGGTTGAGGTGGGTGGATCGCCTGAGCTCAGGAGTTGGATGCCAGC","GGTGTGGTGCCTCACGCCTATAATCCCAGCACTTTGGGAGGCAGGTGGATCACTTGAGGTCAGGAGTTTGAGAACAGCCT"
"GL873594","5834047","5834168","chr2","82491537","82491662","28","76657490","GGCTGGGCCCAGTAGCTCACGACTGTAATCCCAGCACTCTGGGAAGCTGAGGTGGGCGGATCACCTGAGCTCATAGGTTCGAGACCAGCTCCAGTTAGAGTGAGAGCCTGTCTCTAAAAATA","GGCTGGGCACAGTGGCTCATGCCTGCAATCCCAGCACTTTGGGAGGCTGAGGTGGGCAGATCACCTGAAGTCAGGAGTTCAAGACCAGCCTGGCCAACACAGTGAAACCCCATCTCTACTAAAAAT"
"GL873594","5834396","5834461","chr13","14688151","14688212","20","8853755","TATATAATAATAATAACCAGGTATTGTGGCAGGTGCCTCTAGTCCCAGCTACTCGGGAGGCAAAGG","ATAAAAAAATTAGCTGGCCATGGTGGCACATACCAATAATCCCAGCTACTCAGGAGGCTGAG"
"GL873594","7786130","7786294","chr14","12217087","12217250","37","4430957","GGGTGTGCTGGCTCATACCTATAATCCTAGCACTCTGGGAGGCTGAGGTAGGTGTATTGCTTGAACCCAGGAGTCTGAGGTTGCTGTGCGCTAAGCTGATACCATAGCACTCTAGCCTGGGCAACAGAGTGAGACTCTGTCTCAAAACAAATAAATAGTAAAAAA","GCTGGGCGTGGTGGCTCACACCTGTAATCCCAGCACTTTGGGAGGCCAAGGCATGAGAATTGCTTGAAAACAGGAGGCGGAGGTTGCAGTAAGCTGAGACTGTGCCATTGCACTCCAGCCTGGGCAACAAGAGTGAAACTCTGTCTCAGAAAAAAAGAAAAAAA"
"GL873595","723579","723774","chr19","6045933","6046125","65","5322354","GCCTGAGCAGGAGAGAGACCCCATCTCTGCTGAAAGTGGAAAAGTTGGCTGAGTGTAGTGGCGGGCTGCTGCCCCAGTCACTCAGGAGGCTTAGGAAGGAGTATCGCTTGGGCCCAAGATTTGAGGTTGCTGTGAGCGCTACAAAGACATTAGGGTACTCTACACAGGGGAATAGAGTGAGACTGTCTCAAAAAAA","CAACATGGAGAAACCCCGTCTCTACTAAAAATACAAAATTAGGCAGCGTGGTGGTGGGTGCCTATAATCCCAGCTACTCAGGAGGCTGAGGCAGGAGAATCGCTTGACCGGGAGTGGAGGTTGCGGTGAGCTGAGATTGCACCATTGCACTCCAGCCTGGGCAACAAGAGTGAAACTCCGTCTCAAAAAGAAA"
"GL873595","724114","724204","chr20","18199749","18199840","22","17475635","GGCCATGCTTGGTGGTTCTCATCTGTAATCCTAGCACTCTGGAAGGTCTACAGGGGTGGATGGCTGGAGGTCAGGAGTTCAAGACTGGCCT","GGCCGGGCATGGTGGCTCACACCTGTAATCCCAGCACTTTGGGAGGCTGAGGCAGGCGGATCACCTGAGGTCAGGAGTTCGAGACCGGCCTG"
"GL873595","1065346","1065667","chr18","10529729","10530057","74","9464383","GGCCAGGTGCAGCAGCTCATGCCTGGAATCTTCCTGCTCTGTATGGCCAAGGCAGGTGGATCGCCTGACCTCAGGAGTTCCAGACCAGCCTGAACAAGAGCAAGACTCTGTCTCTACTAAAAGTAGAAAAAAAACTAGCCAGTCATAGTGGCAGGTGCCTGTAGTCCCAGCTGCTTGGGAGGCTGAGGCAAGAGGATCACTTGAACCTAAGAGTTTGAGGTTGCTGTGAGCTAAGATGCCACATCACTCTATCAAGGGTGACCAAGTGAGACTCTGTCTCAAAAATAAATAAATAAATAAATAAAAAGAAAGGCAAAAAGAA","GGCCCGGCGTGGTGGCTCATGCCTATAATCCCAGCCCTTTGGGAGGCCAAGGCAGGTGGATCACCTGAGGTCAGGCGTTCGAGACCAGCCTGACCAACGTGGTGAAACCTCATCTCTACTAAATACAAAAAAAATTTAGCCAGGCATGGAGGCACATGCCTGTAATCCCAGCTACTTGGGAGGCTGTGGCAGGAGAATCACTTGAACCTGGGAGGTGGAAGTTGCAGTGAGCTGAGATTGTACCACTGCACTCCAACCTGGGTGACAAAGCAAGACTCGGTCTCAATAAATAAATAAATAAATAAATAAATAAATAAAGTGAAAAAAAA"
"GL873595","1254878","1255146","chr4","42822326","42822607","67","41567448","GGCTGGGCATGGTGGCTCATGCCTGTAATCCTACCGCTCTGGGAGGCTGAGGCAGAGGATCACTTGAGCTCAGGAGTTTCAGACCAGCCTGCAAGAAGGACCCAGTCTCTGCCGAAAATAGAAAAGTTAGCAAGGCGTTGTCGTGAGCACATGTATCCCAGCTACCTAGAACTCTGAGGCAGGAGGATCCCTTGAACCCACAGAAGTTGCTGTTATCTAAACTGATGCCACTGGACTCTAGCCTGGGCAACAGAGTGAGACTGGTCTCA","GGCCGGGCACGGTGGCTCATGCCTGTAATCCTAGCATTTTGGGAGGCTGAGACAGGCAGATTGCCTGAGCTCAGGAGTTCAAGACCAGCCTGGGCTAGATTGTGAAACCCCATCTCTACTAAAATATAAAAATTAGCTGGGTGTGGTGGCACACGCCTGTAATCCCAGCTACCTGGGAGGCTGAGGCAGGAGAATCGCTTGAACCAGGAGACAGAGGTTGCAGTGAGCTGAGATCACGCCACTGCACTTTAGCCTGGGCAACAGAGTGATACTCTGTCTCAA"
"GL873595","3417105","3417297","chr12","115674238","115674427","44","112257133","GGCCGGGCGCTGTGCCTCACGCCTGTAATCCTAATACTCTGAGAGGCCGAGGCAGGTGGATTGCCTGAGCTCAGGTGCTCAAGACAGCCTGACTGAGCAAGCCCTGAGATCCCATCTCCACTAACAATAGTAAAACTAGCCGGGCATTGTGGTGGTGCTTGTAATCCCAGCTACTGGGAGGCTAAGACAGGAG","CCAGGCCTGGTGGCTCACGCCTGTAATCCCAGCACTTTGGGAGGCCGAGGTGGGTAGATCACCTGAGGTCAGGAGTTCAAGACCAGCCTGGCCAACATGGCGAAACCCCATCTCTACTAAAAATACAAAAATTAGCTGGGCATGGTGGTGTATGCCTGTAATCCCAGCTACTCGGGAGGCTGAGGCAGGA"
"GL873595","6098380","6098457","chr3","87492619","87492702","21","81394239","GCTGTGGCTCATGCTGATAATACCAGCACTCTGGGAGAACAAGGTAGGCAGATCACAAGAGGTCACCTGTGCAAGACC","GGGCTGGTGGTGGCTCATGCCTGTAATACCAGCACTTTGGGAGGCCAAGACAGGTGGATCACCAAAGGTCAAGAGTTCAAGACC"
"GL873596","134190","134307","chr1","203207333","203207443","31","203073143","GGCTGGGCGAGGTGGCTCACACCTGTAATCCTAGCACTCTGGAAGGCCCTAGCACTCAGGCAGTTGGATTGCCTGAGCTCACAAGTTCAAGACCAGCCTGAAAAAGAGCAAGACCTCA","GGCTGGGTGCAGTGGCTCACACCTGTAATCCCAGCACTTTGGGAGGCCGAGATGGGTGGATCACTTGAGGTCAAGAGTTGAAGACCAGCCTGGACAACATGATGAGACCCC"
"GL873596","134578","134681","chr11","50235285","50235387","37","50100707","CAAACAAAAGAGGAAGACCTCGTCTCTAAAAAAATAGCTGGGCATTGTGAGGAGTACCTGTAGTCCTAGCTACTCAGAAGGCTGAGACAAGAGAATCACTTAAA","CAACATTGTGAAACCCTGTCTCTACTAAAATAGAAAATTAGCCAGGTGTGTGGGCGTGCCTATAATCCTAGCTACTGGGGAGGGTGAGGCATGAGAATCGCCT"
"GL873596","8160215","8160350","chr1","29437872","29437991","30","21277657","GGCCGGGCGTGGTGGCGCACACCTGTAGTCCCAGCGCTATGGGAGGCCGAGGCGGGTGGATCACCTGAGCTCAGAGGTTCGAGACCAGCCAAGACCCCCCTGAGCCAAACGAGCCAGAGTGAGACCCCGTCTCTAC","GGCCGGGCGTGGTGGCTCACGCCTGTAATCCCAACATTTTGGGAGGCCAAGGCGGGTGGATCACCTGAGGTCAGAAGTTCGAGACCAACCTGGCCAACATGGTGAAACCCCTGTCTCTAC"
"GL873596","8421071","8421132","chr20","1874027","1874093","12","6547044","GTCAGGCGCAGTGGCTCACGCCTGTAATCTCAGCACTCTGAGAAGCCAAGGCAGGATCATCT","GGCCAGGCGCAGTGGCTCAGGCCTGTAATCCCAGCACTTTGGGAAGCCAAGGTGAGCAGATCACCTG"
"GL873598","4416400","4416489","chr5","39418145","39418231","15","35001745","GGCCAAGTGTGGTGGCTCATGCCTGTTGTCCCAGCACCGTGGGAGGCCGAGGCTGGTGGAACACCTGAGCTCAGCTGAGTTTGAGACCAG","GGCCAGTTGCGGTGGCTCATGCCTGTAATCCCAGCACTTTGGCAGGCTGAGGCAGGTGGATCACCTGAGGTCAGGAGTTTGAGACCA"
"GL873598","4416855","4416947","chr3","94091253","94091337","31","89674398","GTGAGACCCTGTCTCTACAAAAAAAAAAGCTGGGCACTGTGGCATGTGCCTGTAATCCCAGCTACTTGGGAGGCAAAGGGAAAGAGAATCACT","AAACCTTGCCTTTACTAGAAATACAAAAATTAGCTGGGCATGGTGGCAGGTACCTGTAATCCCAGCTACTTGGGAGGCTGAGGCA"
"GL873598","5126074","5126161","chr1","12339306","12339394","19","7213232","GCCTGGTGCACTGGTTCACACCTGGAATCCTTGCATTCTGAGAGGCCCAGGTAGGCAGATCACCTCAGCTCAGAAGTTCGAGACCAGC","GCTGGGTGCGGTGGTTCACGTCTGTAATCCCAGCACTTTGGGAGGCCGAGGCGGGCAGATCACCTGAGGTCAGGAGTTCGAGACCAGCC"
"GL873598","5467584","5467662","chr1","9313328","9313403","17","3845744","GCGAGGTGGCTCACGCCTGTAATCCCAGCACATTTGGAAGGCCAAGGAGGGTGGATCACCCGAGCTCACCAGTTGGAGA","CGCAGTGGCTCACGCCTGTAATCCCAGCACTTTGGGAGGCCGAGGCAGGCAGATCACCTGAAGTCAGGAGTTTGAG"
"GL873598","6917752","6917856","chr14","9558287","9558382","22","2640535","GGCCAGGCATGGTGGCTTGTGCCTGTTGTCCCAGCACTGTGGAAGGCCGAGGCGGGTGGATCGCCTGAGCTCAGCTGAATTCGAGACCAGCATAAGACCAGTATG","GGCCAGGCATGGTGGCTTATGCCTGTAATCCCAGCACCTTGGAAGGCCGAAGCGGGCAGATCACCTGAGCTCAGGAGTTTGAGACCAGCCTGTCCA"
"GL873598","8078910","8079062","chr7","164825511","164825660","43","156746601","AACAGCCAGGCATTGTGGTGGGCACCTGTAATCCCAGCTACTTGGGAGGCTGAGGCAAGAGAATTGCTTGAGCCCAACAGTCTCAGGTTACTGTGAGTTATGACACCATGGCACTCTATTGAGGGCAAGAAAGTGAGACTGTCTTGGAAAAAA","CTAGCCAGGCATGGTGGTGCGCACCTGTAGTCCCAGTTACTTGGGAGGTTGAGGCAAGAGAATTGCTTGAGCCTGGAAGGCAGAAGTTGCAGTGAGCTGAGATCACACCACTGCATTCCAGCCTGGGCGAAAGAGCAAGACTCTGTTGAA"
"GL873598","8079328","8079454","chr6","10381248","10381379","32","2301920","GCCCGGCGTGGTGGCTCACGCCTGTAATTCCAGCACTCTGGGGAGGCCGAGGAGGGCAGATTGCCTGAGCTCACAGGTTTGAGCTAGAGCGAGACCCTGTCTCTTAAAAAGAAAAAAAAGGAAAGAA","GCTGGGCGCGGTGGCTCACGCCTGTAATCCCAACACTTTGGGAGGCCGAGGCGGGCAGATCACCAGAGGTGATCTCCAGCCTGGGCAGGAGAGCAAGACCCTGTCTCAAAAAATTTAGAAAAAGGAAAGAAA"
"GL873599","3943256","3943456","chr9","35892110","35892312","79","31948854","GGCAGGCTGCTTTGACCCATATCTACAACTCCAGAACTTTAGAGGCTGAGCTGGGTGGGTCCCTTGAGATTAGAAACTGCTTAGTAGCCTGGCAAAAACCAGACCCCACCTCCACCATGTAGAAAAATTAGCAGTATGCCATAGTGGGAACCTACCAATACAGTCTTTCCAAAGGCCAAAGCTAGAAGGACCGTGAGCTTG","GGCTGGGTGTGGTGGCTCATGCCTATAATTCCAGCACTTTGGGAGGCCGAGGCAGGTGGATCACCTGAGGCCAGGAGTTTGAGACCAGCCTGGCCAATATGGTGAAACCCCATCTCTACTAAAAGTACAGAAAATTAGTCAGTCATGATGGCGCATGCCTATAATCCCAGTTACTCGGGAGGCTAAGGTAGGAGAATTGCTTG"
"GL873599","6693284","6693349","chr1","100916857","100916922","15","94223573","TCACGTCTATAATCCTAGCACTCTGGGAGTCCTTGGCAGGTGGATCACCTGAGCTCAGGAGTTTGA","CATGCCTGTAATCCCAGCACCTTGGGAGGCCAAGGTGGGTGGATCACCTGAGGTCAGTAGTTTGAG"
"GL873600","991618","991705","chr15","13850109","13850195","15","12858491","GGCTGGGCGTGGTGGCTCACACCTGTTGTCCCAGCGCTGTGGGAGGCTGAGGCAGGTGGATCACCTGTGCTCAGAGGTTGAGACCAGC","GCCGGGCGCTGTGGCTCACACTTGTAATCCCAGCACTTTGGGAGGCTGAGGCAGGTGGATCACCTGAGGTCAGGAGTTAGAGACCAG"
"GL873600","8825981","8826014","chr16","43605817","43605844","11","34779836","AGTCTGGGGCAACAGAGCAAGACTCTGTCTCAAA","CAGTCTGGGTGACAGAGCAAGATTCCAT"
"GL873600","8826039","8826157","chr13","87428402","87428520","35","78602363","ATTAGCCTGGTGTGGTGGTATATGCCTTCCTGCCTGCTTGGGAGGCTGAGGCAGGAAGTATGCTTTAACTGTGGAGTCTGAGGTTGCTATGAGCTAGGTTGAGGCCATGGCACTCTAAA","TTAGCCGGGTGTGGTGGTGCACGCCTGTAATCCCAGCTACTCAGGAGGCTGAAGCAGGAGAGTTGCTTGAACCCAGGAGTTGGAGGTTGCAGTGAGCTGAGATCACGCCATTGCACTCC"
"GL873601","269289","269338","chr14","49279240","49279285","14","49009951","GACTGGGTGTGGTGGCTCACACCTTTAATCCTAACACCCTGGGAGGCTTA","GGCTGAGATGGTGGCACACACCTGTAATCCCAGCTACTTGGGAGGC"
"GL873601","269431","269678","chr1","184453273","184453521","76","184183842","AGAAGATCACTCAAGATCAGGAGTTTGAGAACAGCCTGAGCAAGACCCCCATCTTTACTAAAAATGGAAAAGTTTTTACCCAGGCATGGTAGTGCGTGCCTGTATCCCATCTACTCCGGAGGCTGATAGGAGGATTGCTTCAACCAAGGAGTTTGAGGTTCCAGAGACTTAAGATGACACAACTGCATTTTACCCAGTGTGACACAGCGAGACTCTTTCAGAAGAATTTTTAAAAGGAAAAAAAAGAA","GGTCAGATCACCTGAGGTCAGGAGTTTGAGACCAGCCTGACCAACATGGTAAAACCCCATCTCTGCTAAAAATACAAAAAATTAGCCAGGCATGGTGGTGAACGCCTGTAATCCTAGCTACTCAGGAGGCAAAGACAGGAGAATCGCTTGAATCTGGAAGGTGGAGGTTGCAATGAGCCAAGATGACGCCACTGCACTCCAACCTGGGTGACAGAGGAAGACTCCATCAAAAAAAAAAAAAAAAAAAAA"
"GL873601","1397978","1398117","chr16","24839455","24839591","34","23441477","GCCTATAATCCTAGCACTCTGGAAGGCTGAGGCAGGAAGATCACTAGAGCTTGGGAGTTTGAGATTGCTGTGAGGGAGACTGACTCCATGGCACTCTAGCCTGAGGCAACAGAGTAAGACTCCATCTCAAAAAAAAAAAA","CTCTAACTCCAGCTACTCAGGAGGCTGAAGCAGGAAAATCACTTGAACCTGGGAGGTGGAGGTTACAGTGAGCCAAGATCACACCATTGCACTCCAGCCTGAGCGACAGAGCGAGACTCTGTCTCAAAATAAATAAA"
"GL873601","4065502","4065590","chr11","108711352","108711444","19","104645850","GCTGGATGTGGTGGCTCTCACCTATAATCCTAGCACTCTGGGAGGTCAAAACAGGTGGATCACCTGAGCTCAGGAGCAAGAACACCAGC","GTCAGGGGTGGTGGCTCACGCCTGTAATCCCAGCACTTTGGGAGGCCAAGGCAGGTGGATCGCCTGAGCTCAGGAGTTCAAGACCAGCCTTGC"
"GL873601","8241370","8241465","chrY","9469734","9469829","34","1228364","AAAAAAGGTGGAGATGAGCCATGCGCAGTGGTGTAGGCCTGTAATCCCAGCCCTTGGGAGGCCAAAATGGTGGATTGCCTGAAGCAGAGCAAGACC","AAAGTACAAAGAGTCTGGGTACAGTGGCCCAAGCCTGTAATCCCAGCAGTTTGGGAGGACAAGATGGGTAGATCACCTGACATCATGAATTAGAGA"
"GL873569","7519122","7519191","chrX","79016364","79016431","16","71497242","TTGGCCAGGCATGGTCGCTCAGGCTGTAATACCAGCTACTTGGGAAGCTGAAGCAGGAGGATCACTTGAA","TTGGCCAGGCACGGTGGCTCATGCTTATAATCCCAGCTACTCGTGAGGCTGAGGCAGGGGAATCGCTT"
"GL873569","7989158","7989286","chr8","41505677","41505810","35","33516519","AGTCCCACCTATTTGGAAGGCTGAGGCAAGAGGATCACTTGAACTCAGCAGTTTGACATTGCTATGAGTTAGATTGACTCCATGGCACTCTAGCCCAGGCAACAGAGCAAGACTCCGTCTCAAAACAAA","TAATACCAGCTACGTGGGAGGCTGAGGCAGGAGAATCACTTGAACCCGGGAGGTGGAGGTTGCAGTGAGCTGAGATTGCACCGTTGCACTCTAACCTGGGCAACAAAAGCAAAACTCTGTCTCAAAAAAAAAAA"
"GL873569","7989575","7989702","chr1","62231025","62231129","47","54241450","GGCTGGGTAATGCAGTGGCTCACGCCTATAATCCTAGTGCTTTGAGAGGCCAAGAGTGAGACTCTGTGTACTAAAAATAGAAAAATTACCTAGGCATTCTGGTGGGCACCAGTAGTCCCACCTATTTG","GGCTGGGCATGGTGGCTCACGCCTATAATCCCAGCACTTTGGGAGGCCGAGGCAGGTGGATCACCTGAGATCAGGAGTTTGAGACCAGACTGGCCAACATGGTGA"
"GL873569","10034363","10034556","chr10","61268396","61268605","62","51234033","CAGCTTGAGCAAAAGTGAGCCCCTGTCTCTACTGAAAATAGAAAAAATTAGCCAGGCGTGGTGGCACACACTTATAGTCCCAGCCACTTAGGAGGCTGAGGCAGGAGTTTGAGGTTGACATAATCTAAGCTGATACCATAGCACTCTAGCCTGGGCAATAGAGTGAGACTCTGTCTCAAAGAAGAAATTTATCT","CCTGACCAATGGTGAAACCCTGTCTCTACCAAAAATACAAAATTTAGCTGGGCATGGGGGCACGCACCTGTAGTCCTAGCTACTCGGGAGGCTGAGACAGGAGAACTGCTTGAACTCGGGAGGCAGAGGTTGCAGTGAGCTGAGATCATGCCACTGCACTCTAGCCTGGGCAATAGAGTGAGACTCCGTCTCAAAAAAAAAAAAAAAAAA"
"GL873569","10034830","10034845","chr1","217667782","217667796","2","207632952","AAAAAAGAAGAAAAAA","AAGAAAAAGAAAAAA"
"GL873569","10203815","10203922","chr8","96374555","96374671","35","86170740","GCCAGGTGTAGTGGTTCACACCTATAATCCTAGCACTCTGGGAGCCTGAAGCAGGTAAATGGACTGAGCAAGAGTGAGACTTCCACCTCTATTGAAAATAGAAAAATT","GGCTAGGTATGGTGGCTGATGCCTATAATCCCAGAATTTTGGGAGGCCGAGGCAGGCAGATCATCTGAGGTCAGGAGTTTGAGACCAGTCCCGTCTCTACTAAAAATACAAAAATTA"
"GL873569","10204196","10204373","chr20","1304385","1304559","47","8899811","GAAAATAGAAAAATTAGCCAGGCATTATAGCAGGCACCAGTAATCCCAGTTACTTGGGAGGCTAAGGCAAAAGAATCTCTTGAGCCCAAGTTTGGGGTTGCTAGGAAGTAAAACACCACAGCACTATACCCAGAACAAGAGAGTGAAGACTCAGTCTCAAAAAGATAAATAAATAAAA","AAAAATACAAAAATTAGCCAGGCATGGTGGCGGGCGTCTGTAACTCCAGCTACTTGGGAGACTGAGGCAGGAGAATCGCTTGAACCCAGGAGGCAGAGGTTACAGGTGAAATCACACCACTGCACTCCAGCCTGGGCAACAGGGCAAGACTCTGTCTCAAAAAAAAAAAAAAAAA"
"GL873569","10473375","10473444","chr8","20660648","20660717","21","10187273","TGTAGTCCCAGCACTTTGGGAGGTTAAGGCAAGAGTAGCACCCAACATGAGGAGATCAAGACCAATCTGG","CTGTAGTCCCAGCACTTTGGGAGGCTGAGGCAGGTGGATCCTTTGAGGGCAGAACTTTAAGACCAGCCTG"
"GL873570","9287350","9287485","chr1","29437872","29437991","30","20150522","GGCCGGGCGTGGTGGCGCACGCCTGTAGTCCCAGCGCTATGGGAGGCCGAGGCGGGTGGATCACCTGTGCTCAGAGGTTCGAGACCAGCCAAGACCCCCCTGAGCCAAACGAGCCAGAGTGAGACCCCGTCTCTAC","GGCCGGGCGTGGTGGCTCACGCCTGTAATCCCAACATTTTGGGAGGCCAAGGCGGGTGGATCACCTGAGGTCAGAAGTTCGAGACCAACCTGGCCAACATGGTGAAACCCCTGTCTCTAC"
"GL873571","3669989","3670207","chr4","116777080","116777297","60","113107091","AGACCAGCCTGAGGAAGAGCAAGATCCCATCTCTATTAAAAATAGAAAAATTAGCCAGGCATTCTGGTGGGCACCTGTAGTTCTAACCACCTGGGAGGCTAAGGCAAGAGGAACTCTTCAACCCAAGAGTTTGAGGTTGCTGAGAGCTAGGCTAAGGCTGCAGCACTCTAGCCTGGGCAACAGAGTGAGACTGTTTCTCAAAAACAAAAAACAAAAAAA","CGAGACCAGCCTGGTCAATATGGTGAAACCCCGTCCCTACTAAAAATACAAAAATTAGCCAGGCATGGTGGCAGGCACCTGTAGTCCCAGCTACTCGGAAGGCTGAGGCAGGAGAATCGCTTGAACCACAGAGGCAGAGGTTGCAGTGAGCCGAGACTGCACCACTGCACTCCAGCCTGGGCGACAGAGTGAGACTCAGTCTCAAAAAAAAAAAAAAA"
"GL873571","106134","106236","chr4","18143723","18143826","27","18037589","GGCCAGTCTCAGTGGCTCACACCTGTAATCCAGCATTCTGGGAGGCTGAAGCACACGGTCACCTGAGCTCAAAGGTTGGAGACCAGAGTGAGACCCCACCTCT","GGCCAGGCGCAGTGGCTCACTCCTGTAATCCCAGCACTTTGAGGCTGAGGCAGGCGGATCACCTGAGGTCAGGAGTTTGAGACCAGCCTGGCCGAAACCCCATC"
"GL873571","3670496","3670589","chr7","50468399","50468491","15","46797903","GGGCAGGCATGGTGGCTCACACCTGTAATTCTAGCACTCTTGGAGGCTGAGGCAGGAAAATGGCTTGAGGTCAGGAGTTCAAGACCAGCCTGAG","GGCCAGTCATGGTTGCTCACACCTGTAATACCAGCACTTTGGGAGGCCGAGGCAGGCGAATCACCTGAAGTCAGGAGTTCAAGACCAGCCTGG"
"GL873571","4059090","4059389","chr7","52903696","52903994","88","48844606","GGCCAGGTGCAGTGGTTCACACTTATAATCCTAGCACTCTGGGAGGCCGAGGCGAGTGAAGTGCCTGAGCTCATGGGTTCAAGACCAACCTAAGCCAGAGACCCCTGACTCTTATAATAGCCTGGCATTGTGGTGGGCGCCAATATTTCCAGCTACTCTGAGGCTAAGGCAAGAGAATTGCTTGAGCCCAGGAGTTGGAGGTTTCTGTGAGCACTGACGCCGCAGCTCTCTACCAAGGGCAACAAAGACTCTGTCTCAAAAAATAAATAAATAAATAAATAACAGAATGAAAATGAAAAA","GGCCGGGTGCGGTGGTTCACGCCTGTAATCCCACCACTTTGGGAGGCTGAGGCAGGCAGGTCACCTGAGGTCAGGAGTTCCAGACCAGCCTGGCCAACATGGTGAAACCTTGTCTCGGCTATTAGCCTGGCATGGTGGTGCGTGCCCATAATCCCAGCTACTCAGGAGGCTGAGGCAGGAGAATCGCTTGAACCCAGAAGGTGGAGGTTGCAGTGAGCCAAGATAGCACCACTGCAACTCCAGTCTGGGCAACAGAATGAGACTCTGTCTCAAAAAAAAAAAACAAAAAACAAAAAGAA"
"GL873571","4209418","4209704","chr11","32517699","32517985","80","28308281","GGCTTGGCAAGGTGGCTTACACCTCAAATCCTAGCACTGTGGGAGACTGAGGCAGGTGGATTGTTTGAGCTCAGGAGGTCAAGATAGAGAGCAAGAGCAAGTCTCTGTCTCTACTAAAAATAGAAAAGAACTACTTCCCGGGGGTCATGGCAGTAGCCTGTAATCCCAGTTACTAGGTAGAATGAGGCAAGAGGATCTGTTGAAGCCAAGAGACTGAGGTTGTTATGAGCATGCCACAGCACTCTACCCAGGGTGACAGAATGAGACTCTGTTGAAAGAAAAAAAGA","GGCCGGGTGCAGTGGCTCACACCTGTAATCCCAGCACTTTGGGAGGCTGAGGCGGGTGGATCACCTGAGGTCAGGAGTTCAAGACCAGCCTGACAAACATAGTGAAACCCTGTCTCTACTGAAAATACAAAATTAGCCAGGTGTGGTGGCGCATGCCTGTAATCCCAGCTACTCGGGAGGCTGAGGCAGGAGAATTGCTTGAATCCAGGAGGTGGAGGTTGTGTGATCACACCACTGCACTCCAGCCTGGGCGACAGAGTGAGACTCTGTCTCAAAAAAAAAAGAAA"
"GL873571","4209985","4210154","chr3","175781758","175781928","60","171571773","GAAAGAAATGAAAAGAAAGAAGTTAGCTGGTTGTTGGGGTATGCTTCTATAGTCCCACCTACTCAGAAAGCTGAAATCTGGAGTTTGGGGTTGTTGTAAGGTAGGCTGATGACATAGCACTGTAGCTTGGGCAAGAGAGTGTGACTTTGTCTCAAAAAAAATTAAAACAA","ATTAAAAACACAAAGATTAGCCAGGTGTGATGGCACACAACTGTAATCCCAACTACTCAGGAGAATCGCTTGAACCTGGGAGATAGGGTTTGCAGTGAGCCAAGATTGTGCCACTGCACTCCAGCCTGGGTGACAGAGTGAGACTCTGTCTCCAAAAAAAAAAAAAAAAAA"
"GL873571","4210444","4210570","chr17","16655655","16655789","35","12445211","GCCAGGCAGATGGCTCACACTTCATCCTAGCCCTCTGGAAGGCTGAGGCAGGCTAATTTTTTGAGGTTAGGAGTTTGAGACCAGCCTGAGGAAGAGACCCATCTCTACTTTAAAAAATAAATGGAAA","GCCAGGCATGGTGGCTCACACCTGTAATCCTAGCACTTTGGGAGACTGAGGCGGGTGAATCACCTGAGGTCAGGAGTTTGAGACCAGCCTGACCAGTATGGTGAAACCCAGTCTCTACTAAAAATACAGAAATTA"
"GL873571","4391733","4391878","chr11","33723808","33723943","46","29332075","AACTTAGCTGGGAATGGTGGCTCAAGCCTGTAATCCTAGCACTCTGGGAGGCTCAGGTGGGAGGATCACTTGAGGTTGCTGTGAGCTTGGCTGATGCCAGGACACTCTAGTGTGGGCAAGAGAGTGAGACTCCGCCTCAACAACAA","GCCGGGTGCAGTGGCTCATACCTGTAATCCCAGCACTTTGGGAGGCTGAGGTAGGCGGATCACGAGGTCAGGAGCTGAGATGGCGCCACTGCACCCCAGCCTGGGTGACAGAGCAAGACTCTGTCTCAAAAAAAAA"
"GL873571","6307773","6307841","chr9","62429628","62429694","22","56121855","CTGGGTGTGGTGGCATTGCACCTGTAATCCTAGCTACTTGGAAATCTTAAGCCCAGGAGTTGAAGACTG","CCCAGCATGGTGGTGCATACCTATAATCTCAGCTACTTGGAGGCTTGAGCTCAGAAGTTTGAGACCG"
"GL873571","6496217","6496306","chr1","27257765","27257856","27","20761548","GCAGGGTGTGTTGACCCACACCCACAATTCCAGGACTCTGGGGGGCCAGGGATGGTGGGTTCCCTCAGATCAGGAGCTCCTTACCAGCCT","GACTGGGCATGATGGCTCAAATCTGTAATTCCAGCACTTTGGGAGGCCGAGGTGGGTGGATTGCCTGAGATCAGGAGTTCAAGACCAGCCTG"
"GL873571","6499738","6499903","chr1","38976375","38976555","47","32476637","AAAATAACATGAATTGACTAGGCGAGGTGGCTCACATCTCTAATCCTAGCACTCTGGGAGGCTGAGGCAGGAGAATTGCATGAGGTTGCTGTGAGCTATGATGATACCACGGCATTCTAATCAGGGTGACAGAGTGAGATTCTGTCTTAAAACAAACAAACAAAAA","AAAATAAATAAATTAGCAGGGCCTGGTGGCGCACACCTGTAATCCCAGCTACTTGGGAAGCTGAGGCAGGAGAACCCACTTGAACCTGGGAGCCGGAGGTTGCAGTGAGCTGAGATGGCACCACTGCACTCCAGACTGCGTGACAGAGTGAGACTCCGTCTCAAAAACAAACAAACAAAAA"
"GL873571","11399575","11399872","chr15","109458692","109458994","79","98059117","CAGTGGCTCACACCTGTAAATCTAACACTCTGGGAGGCCAAGGTGGGTGGATCCCTTGAGCTCAGGAATTTGATACCAGCCTGAGCAAGAGTGAGACCTTGTCTCTACTAATAATAGAAAAATAGCCCGTGTTGTGGCACTTGTCCCAACCACTGGGGAGGCTTTAGGCGGGAGGATTACTTGAATTGGGAGTTTGATATTGCTGTGAGCTGGGCTGATGCCTTGGCATTCTAGCTTGGGTAACAGCGTAAGACTCCGTCTCAAATAAATAAATAAATAAATAAAAAGAAAAAAAGAA","GTGGCTCACACCTGTAATCTCAGCACTTTGGGAGACCGAGGCAGGTGGATCACCTGAGGTCGGGAGTTTGAGACCAGCCTGACCAACGTGGAGAAACCCCGTCTCTACTAACAATACAAAATCAGCTGGGCGTGGTGGTGCATGCTTGTAATCCCAGCTACTCGGGAGGCTGAGGTAGGAGAATCGCTTGAACCTGGGAGGTGGAGGTTGCGGTGAGCCGAGATCGAGCCACTGCACTCCAGCCTGGGTGACAGAGCAAGACTCCATCTCAAAAAAAAAAAAAAAAAAAAAAAAAAAAAAAAA"
"GL873572","114760","114841","chr8","26280134","26280211","16","26165374","GGCCAGGCATGGCGGCTCTTCCCTGTAATCCTAGCACTCTGGGAGGGCGAGGCAGGCAGATCACCTAGGCTAGGGTGAGATC","GGCCAGGAATGGTGGCTCATGCCTGTAATCCCAGCACTTTGGGAGGCTGAGGCAGGCAGATCACCTGAGGTCAGGAGT"
"GL873572","9421791","9421892","chr11","8089184","8089269","35","1332607","TACTAAATATATAGCAAGGCCAGGCACAGTGGTTCATGGCTGTAATCCCAGTACTCTGGGAGGCCTAGTCAGAGTTGACCTGAGATCAGGCTAGAAGCCTGG","ATAAAAATAATTGGAGGCCAGGCACGGTGGCTCATGCTTGTAATTCTAGCAATTTGGGAGGCTGACGCGGGTGAGATCATACTGAG"
"GL873572","11052834","11053035","chr14","11857478","11857657","65","804644","TCCACAAAGAAAGCAGAAGTGTGGCCGGGTGGTAGCTCAAGGCAGGAATCCCAGCACTCTGGGAGCTGGGAGGTGGGGGAGGATCCCTTGAGATCAGGAGTTGGAGGGCACAGTGAGCCTGGGGGAGGCCACTGTCTCTGTACTCTAGCAGGGAGACAGAGCAAGACTGCCCATTCAAAGAAAAACAACAAACAAAACAAAA","TACAAAAATTAGCTGGGCACGGTGCCACAAGCCTGTAATCCCAGCTACTCGGGAGGCTGGGCAGGGGAATAGCTTGAACCCAGAGGTGGAGGTTGCAGTGAGCCAAGATCAAGCCACAGCACTCCAGCCTGGGTGACAGAGCAAGACTCCATCTCAAAAAAAAAAAAAAAAAAAAAAAAA"
"GL873573","2564195","2564244","chr1","109985445","109985491","12","107421250","TACAAAAATTAGGCTGGGCTTGGTGGTTCACGCCTATAATCCTAGCACTT","ACTAAAATTAGCTGGGCATGGTGGTGCATGCCTGTAATTCCAGCTAC"
"GL873573","7423371","7423533","chr2","202783328","202783513","56","195359957","GGTGGCTCACACCTGTAATCCCAGCACTCTGGGAGCCCTGGTGGCTCATGTCTATAATCCTAGTACTCTGGGAGACCATGGTGGCTCATGTCTATAATCCTAGTACTCTGGGAGCCATGGTGGCTCACGCCTATAATCCTAGTACTCTGGGAGACCATGGTGG","GGCTGAGGCGCGGGGGCTCACGCCTGTAATCCCAGCACTGTGGGAGGCCGAGGCGGGTGGATCACGCCTGTAATCCCAGCACTGTGGGAGGCCAAGGCGGGTGGATCACGCCTGTAATCCCAGCACTGTGGGAGGCCGAGGCGGGTGGATCACGCCTGTAATCCCAGCACTGTGGGAGGCTGAGGC"
"GL873573","9657648","9657710","chr19","10207852","10207913","10","550204","TAAAAATAAAAAATTTAGCTGGATGTGGTGGCTCACACCTGTAATCCTAGCACTCTGGGAGAC","TAAAAATACAAAATTAGCTGGGTGTGGTGGCACACACCTGTAATCCCAGCTACTCAAGAGGC"
"GL873574","1624662","1624783","chr9","814961","815079","36","809701","GACTGGGTGGGTTGGATCATGCCTGGAATCCTAGCACCCTGGGAGGCCAAGGTGAAAGGATTGCTTGAGGTTAGGAGTTCCAGAAATGTAGCAGTCATGGTGACTTCATCCTTCTCTACCAA","GGCTGGGTGCTTTGATTCATGCCTGTAATCCCAGCACTCTGGGAGGCCGAGGCAGGTGGATCACCTGAGGTTAGGAGTTCGAGACCAGCTTGGCTAACATGGTGAAACCTCGTCTCTAC"
"GL873574","4459477","4459612","chr1","29437872","29437991","29","24978395","GGCCGGGCGTGGTGGCGCACGCCTGTAGTCCCAGCGCTATGGGAGGCCGAGGCGGGTGGATCACCTGAGCTCAGAGGTTCGAGACCAGCCAAGACCCCCCTGAGCCAAACGAGCCAGAGTGAGACCCCGTCTCTAC","GGCCGGGCGTGGTGGCTCACGCCTGTAATCCCAACATTTTGGGAGGCCAAGGCGGGTGGATCACCTGAGGTCAGAAGTTCGAGACCAACCTGGCCAACATGGTGAAACCCCTGTCTCTAC"
"GL873574","4681987","4682216","chr6","153082888","153083127","73","148400901","GGGTGCGGTGGCTCAGACCTATAATCCCAGCACTCTGAGAGGCCGAAGTGGGTGGATCACCTGAGCTCAGGAATTTGAGACCAGCCGTCTCTAAAAATAGCTGAGTGTTGTGGCAGTGGCTGTAAGTCCCAGCTGTTTGGAAAGCTGAAGCAAGGGAATCACTTGAACCCAAGAGTTTGAGGTTGCTGTGATGACAAAGTGAGACTCTATCTCAAAAAAAAAAAAAAAAA","GGCCGTGCGCGGCGGCTCACGCCTGTAATCCCAGCACTTTGGGAGGCTGAGGTGGGTGGATCACCTGAGGTCAGGAGTTTGAGACCAGCCCGACCAGAAATTAGATGGGTGTGGTGGTGCGCTCCTGCAGCCCCAGCTACTTAAGAGGCTGAGGCAGGGTAATCACTTGAACCCGGGAGGCGGAGGTTGCAGTGAGCCGAGCTCACGCCACTGCACTCCAGCCTGGGTAACAGAGCGAGA"
"GL873574","4709916","4710039","chr19","13152422","13152536","46","8442506","AAAAATAGAAAAACTAGCCAAGCATGGTGGTGCACCCCCTATAGTCTGAGCTCCTCAGCGGGCTGAAGCAAAAGGACGGCTGGAGCCCTGGAGTTTGAGGTTGCTGTGAGGCAAGGTGATGCCA","ACACATAAATTAGCCAGACATGATGGTGAGTATCTGTAATTCCAGCTCCTTGGGGGGCTGAGGCGGGAGAATTGCTTGAACCTGGGAGGCAGAGATTGCAGTGAGCCAAGATCGC"
"GL873574","6353839","6353913","chr5","25768079","25768163","22","19414240","AAAAATATAGCAAGGCCAGGCATGGTGGCTCACACCTATAATCCCAGTACTTGGGAGCTGGAATTTGAACCTAGG","AAAAAACTCAAACAAGGCTGGGCGTGGTGGCTCACACCTGTAATCCCAGCACTTTGGGAGGCTGAGGTGGGTGGATCACCTGAGG"
"GL873574","6533061","6533332","chr5","85182161","85182439","81","78649100","GGCTGGGCGAGGTGGCTTACACCTATAATCCTAGTACTCTGGGAGGCCAAGGTGGGTGGATTGCCTGAGCGCACAGTTTCAAGACCAGCTGGAGCCAGAGAGAGAGAGAGAGACCCTGCCTCTAAAAATAGCCAGGCATTGTGGCAGGCACCTGTAGTCCCAGCTACTTGGCAGGCGGAGGTATGAGAATCGCTAGAGGTTGCTGTTAGCTATGATGCCATAGCACTCTACCAAGGGCGACAAAGTGAAACTCTGCCTCAAAAAAAAGAAGA","GCCAGGCGTGGTGACTCAAGCCTGTAATCCTAGCACTTTGGGAGGCCAAGGTGGGCGGATTGCCTGAGCTCAAGAGTTTGAGACCAGCCTGGGCAACACGGTGAAACCCAATCCCTACTAAATACAAAAAAAATTAGCCGGGTGTGGTGGTGTGAACCTGTAGTCCCAGCTACTCGGGAGGCTGAGGCAGGAGAAGGCAGAAGTTGCAGTGAGCCGAGATCACACCACTGCACTCCAGCCTGAGTGACAGAGCAAAACTCTTTCTCAAAAAAAAAAAAA"
"GL873574","6643746","6643907","chr2","92627944","92628105","46","85984198","AAATAGCCAGGCGTTGTGGCAGGCACCTATAGTCCCAGCTACTTGGGAGGCTGAGGCAAGAGAATCACTTAAGCCCAAGTGACAGAGGTTGCCAGGGCACTCTACGTAGGCAACAGAGTGAGACTCTATCTAAGAAAGAAGGAAGGAAGGAAGGAGAAAGAA","TTAGCCGAGCATTGTGGTGCGCGCCTGTAGTCCCAGCTACATGGGAGGCTGAGGCAGGAGAACACCTGAACCCAGGATGTGAGCTGAGTCGCGCCATTGCACTCCAGCCTGGGCAACAGAGTGAGACTCCATCTCAAAAATAAAATAAAATAAAATAAAAAA"
"GL873574","6644163","6644274","chr1","128607504","128607619","20","121963341","CTGTAATCCTAGCACTTGGGAGGCTGAGGCAGGTGGATCACCTGAGTTCAGGAGTTCAAGACCAGCCTAAACAAGAGTGAGACCCTATCTCTACTAAAAATAGAAAAAATAT","GCCTGTAATCCAAGCACTTTGGGAGGCTGAGGCGGGTGGATCACCTGAGGTCAGGTGTTCGAGACCAGCCTGGCCAACGTGGTGAAACCCCAACTCTACTAAAAATACAAAAATTA"
"GL873574","8511822","8512127","chr1","23439759","23440073","84","14927937","GGTGGCTGGTGCCTGTAATCCTAGCACTCTGGGAGACTGAGGCAGGTGGATCACTTGAAATCAGGAGTTTGAGATCAACCTGAGCAAGAGATCTTGTCTCTCCTAAAGATAGAAAAACTAGCTGGGATTTGTGGTGGACACCTGTAATTTCAGCTACTCAGGAAGCTAAGGCAAGAGCATTGCTTAAAACCAGGAGTTTGAAGTTGATGTGAGCTAGGATGTCAGGGCAGGTTACCCAGGGTGACAGAGTGAGACTCTGTGTCAAAATAAACAAACAAACAAACAAACAAAACAAAATAAAATAAA","GGCTGGACATGGTGACTCACGCTTGTAATCCCAACACTTTGGGAGGCTGAAGCAGGCAGATCACCTGAGGTCAGGAGTTTGAGACCAGCCTGACCAACATGGTGAAACCTTGTCTCTACTAAAAATACAAAAATTAGCTGGGAGCAGTGGTGCACACCTGTAATCCCAGCTACTCGGCAAGCTGAGGCAAGATAATTTTTTAAACCTGGGAGGTGGAGGTTGCAGTGAGCCAAGATCGTGCCACTGTACTCCAACCTGGGAGACAGAGCAAGACTCTGTCTCAAAAAAAAAAAAAAAAAAAAAAAAAAAAAAAAA"
"GL873575","2107336","2107519","chr4","38052972","38053149","54","35945636","TCAATTAAAAACTTTTTAAAATGAGGCTGAGCATGGTGGTTCACACCTGTAATCCCAGCACTTTGGGAGGCCGAGGCAGGAGGATCACCTGATCCCAGGAGTCCAAGCCTACAGTGAGCCGTGATAATACCACTGCACTTCAGCCCAAAGCCTCAAAAAGAAAAAAAAAAAAGGATAGACAAGA","TATATATATATATATTATTTTGGGGGGGCATGGTGGTGCACACCTGTAATCCCAGCTACTCGGGAGGCTGAGGCAGGAGAATTGCTTGAGCCCGGGAGGCAAAGGTTGCATTGAGCTGAGATCACACCACTGCACTCCAGCCTGGCGACAGAGTCTCAAAAAAAAGAAAAAATAAAAA"
"GL873575","5831824","5831959","chr1","29437872","29437991","28","23606048","GGCCGGGCGTGGTGGCGCACGCCTGTAGTCCCAGCGCTATGGGAGGCCAAGGCGGGTGGATCACCTGAGCTCAGAGGTTCGAGACCAGCCAAGACCCCCCTGAGCCAAACGAGCCAGAGTGAGACCCCGTCTCTAC","GGCCGGGCGTGGTGGCTCACGCCTGTAATCCCAACATTTTGGGAGGCCAAGGCGGGTGGATCACCTGAGGTCAGAAGTTCGAGACCAACCTGGCCAACATGGTGAAACCCCTGTCTCTAC"
"GL873575","7451097","7451208","chr3","122814630","122814743","22","115363533","GGCCAGGTGTGGTGGCTCACACCTGTTATCCTAGCACTCTGAGAGGCCACAGCAGCTGGATCACTTGAGCTCAGGAGTTCAAGACCAGTCTGAGCAAGAGCAAGACCTCACC","GGCTGGGTGTGGTGGCTCATGCCTGTAATCCCAGCACTTTGAAAGGCCAAGGCAGATGGATCACTTGAGGTCAGGAGTTCCAGACCAGCCTGGCCAACATGGCAAAACCCCATC"
"GL873575","7451277","7451445","chr6","58863249","58863409","41","51411972","AAAAATTCAGCCAGCCACAGTGGAAGTGGATGCCTGCCATCACAGCTACTCTGGGGGCTGGGGCAAGAGAATTGCTTGATCCCAGGAGTCTGAGGTTGCTGTGACCTAGGCTGACACCACAGCACTCTACCCAGGGTGACAGAGTGAGGCTGTGTTTAAAAAAAAAAAA","TTAGCCAGGCATGGTGGCACATGCCAGTAATCCCAGCTACTCAGGAGGATGAGGCAGGAGAATCGCTTGAACCCAGGAGGCAGAGGTTGCAGTGAGCTGAGATTGCGCCACAGCACTCTACCCTGGGTGACAGAAGGAGACTCTGTCTCAAAAAAAAAAAA"
"GL873576","1765109","1765185","chrX","53921180","53921256","12","52156071","GGCCAGGTGCAGTGGCTCATATCTGTAATCCTAGCACCCTGGGAGGCCAAGGTAGGCGAATCACCTGAGGCCAGGAG","GGCCAGGTGCAGTGGCTCACGCCTGTAATCCCAGCACTTTGGGAGGCCGAGGTGGGCGGATCACTTTAGGTCAGGAG"
"GL873576","2711577","2711895","chr7","6620384","6620702","85","3908807","GGTCGAGCTTGGTGGCTCATGCTTGTAATCCTAGCACTCTGGGAGGCCAAGGCAGGTAAGTTGCCCTGAGCTCATAGGTTCCAGATCAGCATGAGCCAGAGTGAGACCCTGTCTCTACCAAAAAATAGCCCGGCATTCTGGCAGGTGCCTGTAATCCCAGCTGCTTGGGAGGCTGAGGCTAGAGAATCACTTAAACCCAAGGGTTAGTGGAGGTTGCTGTGAGCTATGATTCCACCGTACTCTACTGAGGGCCACAAAGTGAGACTCTGTCTCCATAAAAAAGAAAGAAAGAAAGAAAGAAAAATAAAATAAAATAAAA","GGCCAGGCACAGTGGCTCATGTCTGTAATCCCAGCACTTTGGGAGGCCGAGGCGGGTGGATTACCTGAGGTCAGGAGTTCTAGACCAGCCTGGCCAACAAGGCGAAACCCTGTCTCTACTAAAAATACAAAAAATTAGCTGGGCGTTTTGGCACATGCCTGTAATCCCAGCTACTTGGGAGGCTGAGGCAGGAGAATTGCTTGAACTGGGGAAGTGGAGGTTGCAGTGAGCTGAGATCACACCATTGCACGCCTGAGCAACAGAGCGAGACTCTGTCTCAAAAAAAAAAAAAAAAAAAAAAAAGAAAAGAAAAAGAAAA"
"GL873576","4782520","4782652","chr9","61136941","61137074","22","56354421","CCAGGCACGGTGGCTCACCCTTGTAACCCTAGTACTTTGGGAGGCTGAGGTGGGAGGATCCCTTGAGGTCAGGAGTTCAAGACCAGCCTGAACAACAGTGAGACCCCCGTCTCTACTAAAAAATAGAAAAGTT","GCCAGGCACGGTGGCTCACGCCTGTAATCCCAGCACTTTGGGAGGCTGAAGCGGGCGGATCACCTGAGGTCAGGAGTTCAAGACCAGCCTGGGCACCATGATGAAACCCCGTCTCTATTAAAAATACAAAAATT"
"GL873576","4782930","4783078","chr7","57521645","57521803","40","52738715","AGTTAGTCTGGTGTCATGGTGGGTGCCTGTAGTCCCAGCTGCTTGGGAGGCTGAGGCAAGAGAATCACTTGAGCCCAGGAGTTGGAGGTTGCTATGAGCGAGGCTGTAGCCTAGGCAACAGAATGAGACTTTGCCTCAAAAAAATAAAA","TTAGCTGGGCATGGTGGCGCATGCCTGTAGTCCCAGCTACTTGGGAAGCTGAGGCAGGAGAATCACTTGAACCTGGGAGGTGGAGGTTGCAGTGAGCTGAGATCGCACCGCTACACGCCAGCCTGAGCAACAGAGAGAGACTCTGTCTCAAAAGAAAAA"
"GL873576","7828709","7828723","chr5","101042981","101042996","1","93214272","TAAATAAATAAAAAA","TAAATAAATAAATAAA"
"GL873576","7828960","7829230","chr13","49045537","49045844","89","41216577","GCCGGCTGCAGTGGCTATAATCCAAGTACCCTGGGAGGCTTAGGTGGATGGATCACTTGAGCTCAGAAGTTCAAGACCAGCCTCAGCAAGAGGTAGACCTTGCCTCTATTAAANNNNNNNNNNNNNNNNNNNNNNNNNNNNNNNNNNNNNNNNNNNNNNNNNNNNNNNNNNNNNNNNNNNNNNNNNNNNAGTTTGAGGTTGCTGTGAGCTATGATGAAGCCAGGGCATTCTACCCAGGGTGACAGAGTAACTCTTAAAAAAAACTAAACAA","GGCCAGGCAGAGTGGCTCATGCCTGTAATTCCAGCAATTTGGGAGGCCTAGGCAGGCAGATTACCTGAGGTCAGGAGTTTGAGACCAGCCTGGCCAACATGGTGAAACCCCGTCTCTTCTANNNNNNNNNNNNNNNNNNNNNNNNNNNNNNNNNNNNNNNNNNNNNNNNNNNNNNNNNNNNNNNNNNNNNNNNNNNNNNGGAGATAATAGCTTTTGTAGAACGAAGCGATGCAACAGCCAGATCGCCGCCACCACCCTTAGGTCCTGGCGACAGAGTGAGATCCATCTTAAAAAAAAAAAAAAAAAAA"
"GL873576","10622840","10623093","chr7","60266447","60266705","74","49643607","GCTGGGTATGGTGGTTCACACCTATAATCCTAGCACTCTGGGAGGCTGAGGTGGGAGGATTGGTGGAGCTCAGGAGCTCATGAGGTGCCAAATCACTGGTGCCACACACCTGTATTCCCAGCTACTGAGGAGGCTGAGGCAGGAGGATCAGGTAAGCCCAGGAAGTTTGAGGTTGTAGTGAGTTAGGATGATTGAACTCTGCCTTGAGAGACAGAGCAAGATCCTCCTTCCTCCTAAGCAAACAAACAAATAAA","GGCTGGGTGCAGTGGCTCACACCTGTAATCCTAGCACTTTGGGAGGCTGAGGCGGGAAAATTGCCTGAGCTCAGGAGTTCAAGGACAGCCTAGGCAACATAGCATGGTGGTGCACGCCTGTATTCCCTGCTACTTGGGAGGCTGAGGCACAAGAATTGCTTGAATCCGGGAAGTGGAGGTTGCAGTGAGCCATTGTGGCACTGCTCTCCAGTCTGGGTGACAGAGCAAGACTCCATCTCAAAAAAAAAAAAAAAAAAAA"
"GL873576","10819939","10820007","chrX","67133632","67133707","21","56313693","AGGTTGCAGTGAAATTGTACCATTCCAATGAAGCCTGGGGGACAGAGTGAGATTCTCTCAAAATAAAAA","GGAGGTTGCAGTGAACCGAGATCGTGCCACTGCACTCCAGCCTGAGCGACAGAGTGAAACTTCGTCTCAAAAAAAA"
"GL873576","10920306","10920363","chr3","48261745","48261808","16","37341439","GCTGGACCTTGTAGAGAGTGCCTGTAATCCCAGCTACATGGGGGGCAAGAGAATTGCT","GCTGGGCATGGTGGTGCATGCCTGTGATCCCAGCTACTCAGGAGGCTGAGGCAGGAGAATTGCT"
"GL873576","10920398","10920529","chr10","67341428","67341546","30","56421030","GGCCAGGCGTGGTGGCTCACGCCTGTTGTCCCAGCACTGTGGGAGGCCGAGGTGGGTGGATTGCCTGAGCTCAGAGGAGTCCGGAAGACCAGCATGAGGCAGAGTGAGCCAGAGTAAGATCCTGTCTCTACC","GGCTGGGTGTAGTGGCTCATGCCTGTAATCCCAGCACTTTAGGAGGCCAAGGTGGATGGATTGCCTGAGCTCAGGAGTTCGAGACCACCCTGGGCAACAAGCCAAAACCCTGTCTCTAC"
"GL873577","515809","515961","chr7","137660778","137660931","43","137144969","AGCTGGGCATGGTGGCTCATGCCTATAACCCTAGCGTGCTAGGAGATTGCTTGTCAGGAGACTGAGGTTGCAGGAAACTGTGATGATGGCACTGCACTCTACCCAGGGTGACAGAGCAGGACTCTGCCTCAAAAAAAAAAAAAAAAATAGAAA","TTAGCTGGGCATGGTGGCGCATGCCTATAATCCCAGCTACTTGGGAGGCTGAGGCAAGAGAATCGCTTGAACCGGGGAGGCAGAGGTTGCAGACTGCACTCCAGCCTGTGTGACAGAGTGGGACTCCGTCTCAAAAAAAAAAAAAAAAAAAAAA"
"GL873577","1633164","1633256","chrX","38269524","38269615","26","36636360","TCAGCCAGGCATGGTGGCACTTGCCTATAAACCCAGCTCCTTGGGAAGCTGAGCCGGGAGGATCCCTTGCACCCAGGAGCAACGGAAGGCAGT","AATTAGCCAGGCATGGTGGCACATGCCTATAATCCCAGCTACTCAGAAGGTTGAGGCAGGAGAATCACTTGAACCTGGGAGGCAGAGGTTGC"
"GL873577","3979502","3979560","chr20","68909283","68909346","13","64929781","GAGTTTGAGACCAGCCTGAGCAAGACCGAGACCCAGTCTCTACTAAAAATAGAAAAATT","GGAGTTCAAGACCAGCCTGACCAACATGGAGAAACCCTGTCTCTACTAAAAAATACAAAAATTA"
"GL873577","3979839","3980009","chr10","31403126","31403287","39","27423287","ATGAGCAGATTGTCTTGGTGGGCACCTGTAGTCCCAGCTATTGGAGGTGGGAGGCTGAAGCAGGAAAATCTCTTGAGCCCAGGAGTTTGAGGTTGCTGTGAGCTAGGCTGACACCACGGCACTCTAGTCAGGGCGTCAGAGTGAGACTCCGTCTCAAAAAAAAAAAAAAAA","TTAGCTGAGTGTGGTGGCGCACATCTGTACTCCCAGCTATTTGGGAGGCTGAGGCAGGAAAATCGCTTGAACCCAGGAGGTGGAGGTTGCAGTGAGCCAAGATCACACTACTGCACTCCAGCCTGGGTGACAGAGTGAGAATCCATCTCAAAAAAAAGAAAA"
"GL873577","6050882","6051080","chr1","153219820","153220007","59","147168938","GGCTGGGCGTTGTGACTCATGCCTGTAATCCCAGCACTCTAGGAGGCCGAGGTGGGTGGACTGCCTGAACTCAGAGGTTTAAGACCATCCTGAGCCGCAGTGAGCCAGAGCGAGACCCTGTCTCTACCAAAAAAAGCTGGGTGTTGTGGTGGGCGCCTATAGTCCTAGCTACTTGAGGCGCTAAGGGTAAAAAAATTGC","GGCCTGGCACAATGGCTCACGCCTGTAATCCTAGCACTTTGGGAGGCCGGGGTGGGTGGATCACCTGAGATCAGGAGTTTGAGACCAGCCTGGCCAACATGGTGAAACTCCTTCTCTACAAAAATTAGCCAGGTGTGGTGGTGGGTACCTGCAATCCCAGCTATTTGGGAGGCTGAGGCAGGAGAATC"
"GL873577","8463965","8464050","chr9","52134422","52134508","19","43670457","CTGGGTGCTATAGCTCACGCCTATAATCCTAGCACTCTGGGAGTTTGGGGCAAATGGATCACCTAGGCTCAGGAGTTTGATACCAG","GGCTGGGAGCAGTGACTCACGCCTATAATCCCAGCACTTTGGGAGGCTGAGGCAGATGGATCACCTGAAGTCAGGAGTTCGAGACCA"
"GL873577","9471486","9471613","chr16","5178790","5178910","46","4292696","TTAGCCAGGCATAGTAGCCTGTGTGTAGTCCTAGCTACTCAGGAGGCTGAGGTAGATGGGTCACTTGAGGTTGCAGAGATTATGGTAATGTCACTGTACTCTAGCCCTGGCAACAGAGCACAACCCTG","TTAGCCGAGCCTGGTGGCATAAACCTGTAATCCCAGCTACTCAGGAGGCTGAGGCAGGGGAATTGCTTGAACCTGAGAGGAGAAGGTTGCAGTGAGCCGAGATTGCACCATTGCACCCCAG"
"GL873577","9471875","9471998","chr7","17832200","17832315","36","8360325","GGCCAGGTGAAGCAGCTCATGGCTATAATCCTAGCAGTTTGGCAGGCCAAGGTGGGAGGACTGCTTGAGGTCAAGAGTTCAAGACCAACCCATCTTTGCGAAAAATTTAAAAATTACCTAGGCA","GCCAGGAGAGGTGGCTCATGCCTCTAATCCCAGCACTCTGGAAATCCAAGGTGGGTGGATCACCTGAGGTCAGGAATTCCAGACCAGTCTGGCCAATATAAAAAATTAGCCAGGCT"
"GL873577","9853150","9853170","chr3","85044647","85044667","3","75191497","AAACAAACAAACAAAAAAAGA","CAAACAAACAAACAAACAAAA"
"GL873577","9853206","9853473","chr7","130818682","130818963","67","120965476","GCTGGGCGCAGCGTCTCACTCCTGTAATCCCAGCACTTGGGAGGCCAAGGTGAGTGGATTGCCTGAGTTTACAGTTTCGAGACCAGCCTGAGCCAAAGCGAGACCCCCATCTCTAAAAAATAGCTGGGCATTGTGGTGGGCACCTGTAGTCCCAGCTACTTGGGAGGCTGAGGCAAGAGGATCGCTTGAACCTAAGAGTTTGAGGTTGCTGTGAGCTAAGGCTCCATGGCATTCTACCAAGGGTGACTAAGTGAGACTCTGTCTAAAA","GCCGGGCACAGTGGCTCACACCTGTAATCCCAGTACTTTGGGAGGCCAAGGTGGGTGGATCACCTGAGGTCAGGAGTTTGAGACCAGCCTGGCCAACATAGTGAAACTCTACTAAAAATACAAAAAAATAGCTAGGCATGGTGGTGCGCACCTGTAATCCCAGCTACTTGGGAGGCTGAGGCAGGAGAGTTGCTTGAACCCAGCGGGGTTGAGGTTGCAGTGAGTTAAGATCAAGCCACTGTGCTCCAGCCTGGATGACAGAGAGAGACTCCATCTCAAAAA"
"GL873577","10722415","10722478","chr10","12501471","12501539","23","1779056","AATAAAAAAATGCTGGGTACAGTAGTACATGCCTGTACTCTCATCTGGGGAAGCTGAGGCATGA","AAAGTAAAAAATTAGAGCTGGGCATGGTGGCACACACCTGTAATCCCAGTCACTAGGGATGCTGAGGCA"
"GL873578","463331","463568","chr10","28935382","28935620","93","28472051","CAGGTGCTTTGACCCACACCCTCAACTCTAGGACTTTGGACGCCCTGGCTGGGTGGGTCCTTTAAAGTCAGGAGCTTCTTATCAGTCTGGGCAAAAGTGAGACCCCATCTCTACCAAACAAAGAAAGAAATCAGCAGTATGTTGCAGTAGAGACTCACCAATACCTTCTTTCAAAGACCAAAGCTGGAAGGACACTAAAGACCATGATCTCATGGCCTCCCTGAGCCATGACAATGCC","CCAGGTGCAGTGGCTCATGCCTGCAAGCTCAGAACTTTGGGAGGCAGAGGTGAGCAGACTGCCTGAGTTCAGGAGTTCAAGACCAGCTGGGCAACATGGTGAGACCCTATCTCTACTAAAAATACAAATAATTAGCAGGGTGTGGTAGCACACACCTGTAGTCCAGCTACTCAGGAGGCTGAGGCAGGAGAATTGCTTGAACCCAGGAGGCAGAGTTTGCAGTGAGCCAGGACTGGGCC"
"GL873578","1143712","1143827","chr11","52824583","52824692","30","51680871","GGCTGGGTGTGGTGCCTCATGCCTGTAATCTAAGCCCTCTCCGAGGCTGAGGTGGGAGGATCCCTTGAGTTTAGGAGTTTGATTTTGAGACCAGCCTGATCAAGAGAGAGACCTCA","GGCCGGGTGTGGTGGCTCATGTCTGTAATCCCAGCACTTTGGGAGGCTGAGGTGGGTGGATACCCTGAGGTCGGGAGCTCGAGACCAGCCTGACCAACATGGAGAAACCC"
"GL873578","1144101","1144139","chr3","33494224","33494257","11","32350123","GAGAGAGACCTCATGTCTACTAAAATAAATAAATATATA","GTGAAACCCGTCTCTACTAAAAATACAAAAATTA"
"GL873578","1144175","1144343","chr12","119519961","119520131","41","118375786","ATTATCCAGGCCTTCTGGTGGATGCCTGTAGTCCTAGCTACTAGAAAAGCTGGAGCAGAATCACTTGACCCAGGAGCTGGAGGTTGCAGGGAGCTAGGCTGATGCCACAGAATTCTAGCCTGAGGCAAAAGAATTGAGCCACTGTCTCAAAAAGGAACAAAAAAGAAAA","ATTAGCCAGGTGTGGTGGCATGCACTTGTAATCCCAGCTACTAAGAAGGCTGAGGCAGGAGGATCACTTGAACCCGGGAGGTGGAGGTTGCAGTGAGCCAAGATCATGCCACTGCACTCCAGCCTGGGCAACAGAGTAAGACTCTGTCTCAAAAAAAAAAAAAAAAAAAAA"
"GL873578","4593962","4594035","chr16","68825055","68825124","22","64231093","AGCTGGGTACAGTGGCTCACATATAATCCCAGTGACTCAGGAGGCTAAGACAGGAGGATTACTAGGACCTGAGA","GGCTGGGCACAGTGGCTCAGACCTGTAATCTCAGTACTTTGGGTGGCTGAGGCAGGTGGATCACCTGAGG"
"GL873578","6158845","6158972","chr3","500432","500562","24","5658413","GACATGGTGGCTCACACCTGTAATCCTAGCCCTCTGGGAGGCTGAGGCAGGTGGATCACTTGAGTTCAGGAATTCAAGACCAGCTTGAGTGAGAGCAAGACCCTGTCTCTACTAAAAATAGAAAAATT","GCACGGAGGCTCATACCTGTAATCCCAGCACTTTGGGAGGCTGAGGCAGGTGGATCACCTGAGGTCAGGAGTTCCAGACCAGCCTGGCCAACATGGCGAAACCCTGTCTCTACTAAAAATACAAAAAATCT"
"GL873578","6159253","6159444","chr19","34496349","34496541","55","28337096","ATAAAATAAAAATAGAAAAATTAGCCAGGCATTGTGGCAGACATGCGAAGTCTCAGCTACTCCAGAGGCTGAGACAGGAAGATTACTTGAGCCCAAGAATCTTGCTGTGAGCTAAGCTGATGCCATAGCATTGTAACCTAGGCAACAGAGTAAGACTTGGCCTCAAAAATAAAATAAAATAATAAAGTAAAA","TTAGTTAATTAAATTAAACTTAGCTAGGCATAGTGGAACACACCCATAGTCCCAGCTACTCTAGAGGCTGAGGCAGGAGGATTGCTTGAGCCAAGTTGGAGGCTGCAGTGAGCTATGGTGGTGCCACTGCATTCCAGCCTCAGTGACAGAGAGAGACCCTGGCTCAAATAATAATAATAAATAAATAAATAAA"
"GL873578","6766040","6766171","chr2","93098086","93098217","30","86332046","CCAGGCACAGTGGCTCATGCCTATAATCCTAGTAGTCTAGGAGGCTGAGGTGAGTGCATTGCTTGAGCTCAGGAGTTAGATACCAGCCTAACCAAGAATGAGACCCCATCTCTATTAAAAATAGAAAAGTTA","GCCGGGCACAGTGGCTCATGCCTGTAATCCCAGCACTTTGGGAGGCCGAGGCGGGCAAATCACGAGGTCAGGAGTTCAAGACCAGCCTGACCAATATGATGAAACCCCGTCTCTATTAAAAATACAAAAATT"
"GL873578","6766434","6766577","chr9","21128084","21128223","50","14361650","GTTAGCCAGGAGTTGTGGCGGGCACCTACAGTCCTAGCGACTCAGGAGGCTGAAGTAGGCAGAGTTTGATGTGTTGCTGTGAACTACAAGGACACCAATGCACTCTAGGCCGGTAACAGAGTGAGACACTGACTAAAAAAAAAA","TTAGCCAGGTGTGGTGGCACATGCCTGTATTTCCAGCTACTCGGGAGGCTGAGGCAGGAGAATTGCGTGAGCTGAGATCATGCCACTTCATTCCAGTCTGGGTGACAGAGTGAGACTCTGCCTCAAAAAACAAAACAAAA"
"GL873578","7397948","7398119","chr5","40230148","40230319","43","32832200","TAAAAATAGCCATGCATTGTGACAGGCACCTGTAGTCCCAGCTACTCAGGAGGTTGAGGTAAGAGAATCACTTGAACCCAAGAGTTTTGAGGTTGTTATGAGCTAAGACGCCTCGGGACTCTACAAAAGGTAACAAAGTGAGACTCTGTCTCATAAAAAAAGAAAAAAAGAA","AAAATTAGCCAGGCATGGTGACGTACACCTGTAGTCCCAGCTACTCGGGAGGCTAAGGCAAGAGAATCGCTTGAACCCAGGAGGCAGAGGTTGCAGTGAGCTTAGATCACGCTACTGCGCTCCAGCCTGGGTGACGGAGTGAGACGCCATCTCAAAAAAAAAAAAAAAAAAA"
"GL873578","7398378","7398515","chr15","102382935","102383070","35","94984557","GGTCGAGCAAGGTGGCTCACGCCTGTAATCCTAGCACTCTGTGAGGCTGAGGCAGATGGATTGCCTGAGCTCGTGGGTTCGAGACCAGCCTGAGCCAGAGTGAGACCTCATCTCTAAAAATAGCTGGGAAGCTGGGCA","GGCCAGGTGTGGTGGCTCACGCCTGTAATCCTAGCACTTTGGGAGGCTGAGGCGGGTGGATTGCCTGAACTCAGGAGGTCAAGACCAGCCTGGGCAACACAGTAAAACCCCATCTCTACTAAAATACAAAAAATCA"
"GL873579","370235","370429","chr16","38067345","38067552","57","37697110","GCACAGGCCTGAAATCCTAGCACTCTGAAAGGCCAACGGAGGAGAATTTCTGGAGCTCAGGAGTTTGATACCAGCCTAAGCAAATAAAGCTAGACCTCTATCTCTACTAAAATTAGAAAAATTAGGCAGATGTGGTGGTAGGCACCTATAGTCCCAATTACTCCAGAGGCTGAGGCAGAAAGACTCTTGAACCCA","GTCAGGCATGGTGGCTCATGCCTATAATCCTAGCACTTTGGGAGGCCAAGGCCGGTGGATCACCTGAGGTCAGGAGTTTGAGACCAGCCTGGCCAATATGGCAAAACCCCGTCTCTACTAAAAATAAAAAAATTAGCTGGGCACGGTGGTGGGCACCTATAGTCCCAGCTACTCAGGAGGCTGAGGCAGGAGAATTGCTTGAACCCAG"
"GL873579","370936","371046","chr3","3847698","3847802","33","3476762","TGACTCTTGAACCCAGGCACATGAGGTTGCTAAGAGTCTAGGCTGATGTCACGGCACTCTAACCTGGGAAACAGTGTGAGGTTCTGCCTCAATAAATAAATAAATAAATAA","TGGCTTGAACCCAGGAGGCGGAGGTTGCAGTGAGCCGAGATCACGCCACTGCACTCCAGCCTGGGCAACAGAGCGAGACTGTCTCAAAAAAAAAAAAAAAAAAAA"
"GL873579","599436","599605","chr10","38982686","38982853","41","38383250","AAAAAGTCAGACATTGTGGCAGGTGTCTGTAATCCCAGCTATTTGGGAGGCTGAGGCAGGAGTATCATTTGAACCCACGAGTCTGAGGTAACTGTGAGCTAGGCTAACACAACAGCACTCTAGCCTGGGCAATAGAATGAGACTCTATCAAGAAAAGAAATGAAAAGAAA","TATTAGCCTGACACAGTGGCGCGCATCTGTAATCCCAGCTACTTGGGAGGCTGAGGCAGGAGAATCACTTGAACCCAGGAGGCGGAGGTTGCTGTGGGCTGAGATCATGCCACTGCACTCCAGCCTGGGCAACAGAGGGAGGCTCCATCTCAAAAAAAAAAAAAAAAA"
"GL873579","599942","599953","chr3","71473700","71473710","4","70873758","TTTTAAAATAGT","TTTAAAAAAAA"
"GL873579","600232","600365","chr1","16061315","16061447","30","15461083","GGCTAGGCAAGGTGACTCATGTCTGTAATCCTAGTACTCTGGGAGGTTTGAGGCAGGAAGACCACTTTAGCTCAAGAGTTCCAGATCAGCCTGTGCAAGAGTGATACATCATCTCTACTAAAAATCAAAAATTA","GGCTGGGCATGGTGGCTCATGCCTGTAATCCTAGCACTTTGGGAGGTTGAGGCAGGCAGATCACTTGAGGTCAGGAATCTGAGACTAGCCTGGCCAACATGGTGAAACTCCATCTCTACTAAAAAAAAAAAAA"
"GL873579","5650320","5650591","chr6","54938866","54939145","71","49288546","GTCAGGTGTGTTAGCTTACAGTAGTAATCCTAGCACTTTGGGAGGTTGAAGTGGGTGGATTGCTTGAGCTCAGGGGTTCAAGACCAGCCTGAACAAGAGTGGGACCTCATCTCTATTAAAAACAGAAAAACTAGCTGGGTGTTATGGTGGGTGTCTGTAGCCCCAGCTACTCAGGAGGCTGAGGCAGGAGGTTGAGGTTGCTGTGAGCTATTGAGACCACAGCACTCTATCCAGGGCAACAGAGTGAGACCCCTCCCCCCCCCAAAAAAAAA","GGCCAGGTGTGGTGGCTCACGCCTGTAATCCCAACACTTTGGGAGGCCGAGGTGGGTGGATCACCTGAGATCAGGAGTTCAAGACCACCCTGGCCAACATGGTGAAACCCCGTCTCTACTAAAAATACGAAAATTAGCTGAGTGTGGTGGTGCATGCCTGTAGTCCCAGCTACTCAAGAGGCTGAGGCAGGAGGTGGAGGTTGCAGTGAGCCGAGATTGCATCACTGCACTCCAGCCTTGGCGACAGAACGAGAGAGACTCCATCTAAAAAAAAAAAAAA"
"GL873579","7037162","7037347","chr3","37328686","37328893","67","30291524","GAGGTGGGTGGATTGCCTGAGCTCACAGGTTGGAGACCAGCCTGAGCCAGAGCAAGACCTTATCTCAAAAAATAGCCAGGTGTTGTGGCTGGCACCTGTAGTCCCAGCTGCTCAGGAGGCGGAGGCAAGAGAAATGCTTGACCTCAGGAGTTTGAGGTTGCTGTGAGTTCAACTCACACTAATACA","GAGGCAGGGGGATCACCTGAGGTCAGGAGATCGAGACCAGCCTGGCCAACATGGTGAAAACCTGTCTCTACTAAAAATCCAAAAACATTAGCCAGGTGTGGTGGCACGCACCTGTAATCCCAGCTACTTGGGAGGCTGAGGCAGGAGAATCACTTGAACCTGGGAGGCAGAGGTTGTAGCGAGCCGAGATCACACCACTGCACCCCAG"
"GL873579","11077764","11077972","chr19","1200469","1200683","63","9877295","GCCAGGTGCAGTGGCTCATGCCTATAATCCTAGCACCCTAGGAGGCTGAGGAGTTCAAGACCAGCCTAAGCAACTGTGAGACCCCATCTCTACCAAAAATAGAAAAATTAGCTGACTGTTATGGTGTGCACCTACAGTCCTAGCTACTCAGGAGGCTGAGGCAGAAAGAGTCCTTGAACCCAGGAGGCTTTTTTTTGTTGTTGTTGTTG","GGCCAGTCGCGGTAGCTCATGCCTGTAATCCCAGCACTTTGGGAGGCCGAGGCGGGCAGATCACCTGAGACCAGCCTGGCAACATGGTGAAACCCCATGTCTACCCAAACTACAAAAATTAGCTGGGTGTGGTGGTGCACGCCTGTAATCCGAGCTACTCAGCAGGCTGAGGCAGGAGAATCCCTTGAACCTGGGAGGCAGAGGCTGCAGTGAGC"
"GL873579","11078245","11078333","chr19","4926258","4926351","22","6151987","TGAACCCAGGAGTTTGAGTTCGCTGTGAGCTAAGCTGAGGCCACAGCACTCCAGCCTGGGCAACAGAGTGAAAGGAAAAAAATAAAAAA","TGAACCCGGGAGGTGGAGGTTGCAGTGAGCCAAGATCACACCAATGCACTCCAGCCTGGGCAACAAGAGTGAAACTCTGTCTAAAAAAAAAAAA"
"GL873580","320374","320488","chr13","48549305","48549409","42","48228931","GGTAGTGCGTGCCTGCATTCCCAGCTACGGGAGGGCAGGGACTTGAGGCCAGCCTGGGCAAAATAATGAGACCTACTAATGACTCTACTAATACAGAAACAATTAGCTAGGTATG","TGGGAGGCCGAAGTGCGCAGATCACCTGAGGTCAGAAGTTGGAGACCAGCCTGGCCAACATGGTGAAAACCCATCTCTACTAAAAATACAAAAATTAGCTGGGCA"
"GL873580","374969","375091","chr6","147681010","147681135","27","147306041","CGGTGGCTCACACCTATAATCCTAGCATTTTGGAAGGCTGAAGCCGAGGATCTCTGGAAGTCAGAAGTTCAAGACCAGCCTGCCCAAGAGCAAGACCCCATCTCTACTAAAAATAGAAAAACT","GGTGGCTCACACCTGTAATCCCAGCATTTTGGGAGGCTGAGGCAGGCGGATAATCTGAGGTCAAGAATTTGAGACCAGCCTGGCCAACATGGAGAAACCCTATCTCTACTAAAAATACAAAATTAC"
"GL873580","375369","375549","chr7","19977275","19977456","44","19601906","CTAACCAAGTTAGTTAGTTTTAGTTGGCAGGTGCCTGTAGTCCCAGCTCCTTGGGAGGCTGAGGCAAGAGAATGGCTTGAGCCCAGGACTTTGAAGTTGCTGTGAGCTATAATGACACCACAGCACACTACCCAGGGTGACAGAGTGAGACTGTCTCAAAAAAACAAACAAACAAAAAAAA","AACAAACGTTAGCCGAGCATGGTGGTATGTGCCTGTAGTCCCAGCTACTTGGGAGTCTAAGGCAGGAGAATTACTTGAGCCCGGGAGGCAGAGGTTGCTGTGAGCCAAGATCACGCCACTGCACTCCAGCCTGGGTGACAGAGTGAGACTCCATCTCAAAAAAAAAAAAGGAAAAAAAAAAA"
"GL873580","8760922","8761015","chr11","104681322","104681416","19","95920400","GGAGGGAGACACTGCAGTGAACTGCGATCGTGTCTCTGCTTTCCAGGCTGGGTGACAGAGTGAGACTCGGTCTCTAAAATAAAAAATAAATAAA","GGAGACGGAGGTTGCAGTGAGCTGTGATCGCGGCACTGCACTCCAGCCTGGGCAACAGAGTGAGACTCTGTCTCAAAAATAAATAAATAAATAAA"
"GL873580","9391260","9391306","chr14","49279240","49279285","12","39887980","GCCAGTCGAGGTGGCTCACACTTGTGATTCCAGCTACTTGGAAGACT","GGCTGAGATGGTGGCACACACCTGTAATCCCAGCTACTTGGGAGGC"
"GL873581","759283","759365","chr6","46535476","46535542","30","45776193","TAAGAACCTGAAAATAGAGCCAGGCATAGTGGTACATGCGTATAGTCCTGGCTACTCAGGAGGTTGAAACAACAGGATTACTT","CAAAATAGCCAGGCTTGGTGGTGCATGCCTATAATCCAAGCTACTCGGGAAGCTGAGGCAGGAGAAT"
"GL873581","1145844","1145979","chr1","29437872","29437991","29","28292028","GGCCGGGCGTGGTGGCTCACGCCTGTAGTCCCAGCACTATGGGAGGCCGAGGCGGGTGGATCACCTGTGCTCAGAGGTTCGAGACCAGCCAAGACCCCCCTGAGCCAAATGAGCCAGAGTGAGACCCCGTCTCTAC","GGCCGGGCGTGGTGGCTCACGCCTGTAATCCCAACATTTTGGGAGGCCAAGGCGGGTGGATCACCTGAGGTCAGAAGTTCGAGACCAACCTGGCCAACATGGTGAAACCCCTGTCTCTAC"
"GL873581","9628238","9628362","chr5","141044567","141044691","34","131416329","ATCCCAGGTAGTCGGGAGGCTGAGGCAGGAGGATCACTTGAACCCAGGAGGTTGAGGTTGCTGTGAGCAAGGCAGAGGCAACGGCACTCTAGCCACGGGGGCACAGAGACTCTTGTCTTTAAAAA","TAATCTCAGCTACTCGGGAGGCTGAGGCAGGAGAATCGCTTGAGCCCAGAAGGTGGAGGTTGCAGTGAGCCAAGATCGCGCCATTGCACTCCAGCCTGGGCGACAGTGCGAGACTCTGTCTCAAA"
"GL873582","1580485","1580534","chr6","32576760","32576806","12","30996275","CAGCACTTGAGAGGCCAAGGCAGGTGGATCAACTGAGCAAGAATGAGACC","CCAGCACCTTGAGAGGCCAAGGCAGGTGGATCACCTGAGGTCAGGAG"
"GL873582","1644368","1644551","chr1","211626449","211626612","63","209982081","AAAATTTGCCGGGCTCCATAGCTCATGCATGTAATCATAGCACTCTGGGAGGCCAAGATGGGAGGATCTCTCAAGCTCTCTTACTTGGGAGGCTGAGGTTGCTGTGAGTTAGGCTTACGCCACAGCACTCTACTCTAGCGTGAGCAACTCTACTCTTAGTATGAGACTGTCTCAAAAGAAAAAA","AAATTAGCCAGGCGTCGTGGCACATGCCTGTAATCCCAGCTACTCGGGAGGCTGAGGCAGGAGAATAGCTTGATCTCGGGAGGCGGAGGTTGCAGTCAGCCGAGATCACACCACTGCAATCCAGCCTGGACAACAGAATGAGACTCCATCTCAAAAAAAACAAA"
"GL873582","5794385","5794459","chr13","18872784","18872852","27","13078399","ATATTGTTAAGCACAGCCACTATTAAAAATTAAATTATAGGCCAGGCATAGTGGCTCATGCCTGTAATCCTAGCT","TGAAACCACCATCTGGACCAAGATACAAAATGTTGGCTGGGCATGGTGGCTCACACCTGTAATCCTAGC"
"GL873583","102645","102683","chr14","5808766","5808804","14","5706121","GAGCAGATCACCTGAGCTCAGGAGTTTGAGACCAGCCTG","GAGGAATCCCTGTGCTCAGGAAGCTTACATTCTAGTGAG"
"GL873583","6200447","6200560","chr4","17786849","17786963","24","11586402","GGCCAGGAGGGACGGCTCATGCCTGTTATCCTAGCACTATGGGAGACTGAGGTGGGAGGATCACTTGAAGTTAGGAGTTCCAGACCAATCTGACCAAAGTGAGACCTCATCTCT","GGCCAGGCTTGGTGGCTCATGCCTGTAATCTTAGCACTTTGGGAGGCTGAAGTGGGTGGATCACTTGAGGTCAGGAGTTAGAACCAGTCTGGCCAACATGGTGAAACCTCAGCTC"
"GL873583","6200584","6200752","chr6","169626528","169626696","42","163425944","TTAGCTGGATGTGGTAGCACATGCCTATAGTCCCATCTACTCAGGAGGCTGAGACAAGAGAGTTGCTTAAGCCCAGGAGTTTAATTTAACTGTGAACTAGACTGAGACTGTGGCACTCTAGCTGGGGCAACAGAGTGAGACTCTGTCTCAAAAGAAAGCAAGAAAGAAA","TTAGCTGGGTATGGTGTCAGATGCCTGTAGTCCCAGCTACTCAGGAGGCTGAGACAGGAGAATCGTTTGAACCCAGGAGGCCAGAACTGCAGTGAGCTGAGATTCGCACCACTGCGCTCCAGCCTGGGCCAGACAGAGTGAGACTCTATCTCAAAAGAAAAAAAAAAAA"
"GL873583","10217398","10217583","chr3","36257142","36257313","44","26039744","TACTAAAAATAAAGTGTGATAGCCAGGCATGGTGGTGGTGCCTATAGAACCAGGCTATTCAGGAGGCTGAGGCAGAAGGATCACTTGAACCCAGGAGTCTGACGTTGCTGTGAGCTAGGCTGGTGCCATGGTACTCTAGCCTGTGGTAACAGAATGAGACTCTATCTCAAAAATAAAAATAAAAAA","TACAAAATTAGCCAGGCGTGGTGGTGCGTGCCTGTAATCCCAGCTACTTGGGAGGCCGAGGCAGAAGAATGACTTGAACCCAGGAGACAGAGGTTGCAGTGAGCCAAGATCCCACCATTGTACTCCAGCCTGGGCAACACAGTGAGACTCCATCTCAAAAAAAAAAAAAAAA"
"GL873583","10394919","10394983","chr16","12841703","12841771","22","2446784","GAGGTCAGGAAATCAAGATCAGTCTGGGCAATATATTGATACCCTGCCCCTACATAAGGAAGAAA","AGGTCAGGAGTTCAAGACCAGCCTGGCCAATATGTTGAAACCTCATCTCTACTAAAAATACAAAAATTA"
"GL873584","521512","521529","chr1","167402212","167402233","10","166880700","GCATGGAACCCCCCACTC","GGTGAAACCCCATCTTTACTAA"
"GL873584","2079725","2079768","chr15","4338291","4338335","11","2258566","GGCAGGTGGATTACCTGAGTTCAGGAGTTGGAGACCAGCCTGAC","AGGCGGATGGATCACGAGGTCGGGAGTTTGAGACCAGCCTGACCA"
"GL873584","5216877","5217053","chrX","91350057","91350230","49","86133180","CTACTGAAAATGATGACAGAGGCTGGGCATGGGGGCTCCCGCCTGTTATCCTAGCACCCTCGGAGGCTGGGGAATGAGGATTGCTTACGCCCAAGAGTTTGAGGTTGCTGTGAGCTGAGGCCGCTGCACTCTAGCCTGGGCAACAGAGTGAGACTCTGTCTCAAAAAAAAAAAAAAA","TGCAAAAATGAGCTGGGCATGGTGGCACATGCCTGTAATCCCAGCTACACAGGAGGCTGAGGCAGGAGAATCGCTTGAATCTGGGAGGCGGAGGTTGCAGTGAGCTGACATCAGGCCCCTGCACTCTAGCCTGGGCCACAGAGCAAGACTCCGTCTCAAAAAAAAAAAAAAAAA"
"GL873584","7289930","7289950","chr2","51453328","51453345","10","44163398","TGAGGCTCTGTCTCGAAATAA","AATGCCATCTATTAAAAA"
"GL873584","7289975","7290131","chr11","49739997","49740154","37","42450022","CAAGAAAATTAGCTGAGAGTCCTGGTAGGTGCCTGTAATCCCAGCTATTCATGAGGCTGAGGCAGAAGGATCACTTGGGTCCAGGAGTCTGAGGTTGCTGTGAGCTAGTCTGACGCCATAACACGCAAGCCTGGGCAACAGAGTGAGGCTCGGTTTC","CTACAAAAATTAGCTGGGCGTGGTGGCACATGCCTGTAATCCCAGCTACTCGGGAGGCTGAGGCAGGAGAATCACTTGAGCCCAGGAGGCGGAGGTTGCAGTGAGCCAAGATCATGCCATTGCACTCCAACCTGGGCAACAGAGCAAGACTCCATCTC"
"GL873584","7577743","7577867","chr5","48394329","48394446","27","40816586","GGCTGGATGAGGTGGTTCATGCCTGTAATCCTAGCACTCTGGGAGGCCAAGGTGGGTGGATTGCCTGAGCTCAGGAGTTCAAGACCAGCCTGAGCAAGACCCTGTCGCTAAAAATAGCTGGGTGT","GGCTGGGTGCAGTGGCTCATGCCTGTAATCCCAGCACTTTGGGAGGTCAAGGCGGGTGGATCACCTGAGGTCAGGAGTTCAAGACCAGCCTGGCCAACATCTCTACTAAAAATACAAA"
"GL873584","7578135","7578289","chr1","130112713","130112865","31","122534578","GGAGCTGGGTTTTGTGACTGCACCTGTAATCCCAGCTGCTCAGGAGGCTGAGGCAAGAGAATTGCTTGAGCCCAGGAGTTGGAGGTTGCTGTGAGCTGTGATGCCAGGGAACTCTACCAAGGGTGACAAAGTGAAACTCTGTCTCAAAAAAAAAA","TTAGCCAGGTGTGGTGATGCATGCCTGTAATCCCAGCTACTCATGAGGCTGAGGCAGGAGAATTGCTTGAACCTTGGAGCTGGAGGTTGCAGTGAGCTGAGATCAGACCACTCCAACCTGGGTGACAGAGCGAGACTCTGTCTCAAAAAAAAA"
"GL873585","1450952","1451121","chr10","59681079","59681242","48","58230127","TAAAAACAGAAAAAACTAGTCAGGTGGTGTGGTAGGTGCTCATAAGTCCCAGCTGCTTGGGAGACTGAGGCAAGAGAATCACTTGAGCACAAGAGCTTGAGGTGGCTGTGAGCTATAACACCATAGCACTGTACTGAGGGTGACAAAGTAAGACTCTGTCTCAAAAAAAA","TACAAAAATTAGTCAAGGGTGGTGGTATGTGCTTGTAATCCCAGCTATTTGGGAGGCTGAAGCAGGGGAATCCTTGAACCCAGGAGGTGGAGGTTGCAGCGAGCCGAGATCACGTCACTGCACTCTAGCCTGGGCGATAGGGTGAGACTCTGTCTCAAAAAAAA"
"GL873585","1451382","1451515","chr6","17405813","17405948","24","15954431","GGCCCGGCTCGGTGGCTCACACCTATAATCCTAACACTCTGGGAGGCTGAGGCAGGTGGATCACCTGAGCTCAGGAGTTTGAGACCAGCTGAGCAAAAACAAGACCCTATCTCTGCTAAAAATAGAAAAAACTA","GGCCGGGCGGGGTGGCTCACGCCTGTAATCCCAGCACTCTGGGAGGCCAAGGCAGGTGGATCACCTGAGGTCAGGAGTTTGAGACCAGCCTGGCCAACACGCAGAAACCCTATTTCTACTAAAAACACAAAAATTA"
"GL873585","1626960","1627026","chr7","17782729","17782794","22","16155769","AAGATGCCACAGCACTCTACAAGAGTGACCAAGTGAGACTCTGTCTCAAAAAAAAAAAGAAAAGGAA","CAATCGCACTACTGCACTTCAGCCTGGGTGACAGAGTGAGAACCTGTCTCAAAAAAATAAATAAAA"
"GL873585","1627304","1627531","chr11","17033552","17033788","61","15406248","GGCTGGGCACAGTGGCTCACGGCTATAATCTAGGCACTTGGGAGGCTAGGGCAGGTGGATTGCCTGAACTGACAAGTTTGAGACCAACCTGAGCAAGAGCGAGACCCCTGTCTCTAAAACATAGCCAGGCTCTGTGGTGGGCGTCTGTAGTCCCAGCTACTTGGGAGGCTGAGGCAAGAGAATTGCTTGAACTCAAGAGTCTGAGGTTGCTGTGAGTTAAGATGCCAC","GCCCGGCGCAGTGGCTCACGCCTGTAATCCCGGCACTGTGGAGGCCAAGGCAGGCGGATTGCCTAAGCTCAGGGATTCGAGAACAGCCTGGGCAACATGGTGAAACCCCATCTCTACTAAAATACAAAAAACTAGCCGGGCGTGGTGGTATGCGCCTGTAATCCCAGCTACTTGGGAAGCTGAGGCAGGAGAATTGCTTGAACCCGGGAGATGGAGGTTGCAGTGAGCTCAGATCAC"
"GL873585","3626082","3626158","chr1","100916857","100916922","27","97290775","TGCCTGTAATCCCAGCACTTGGGAGGCGGAGGTGGGTAGATTGCCTGACCCAGAGTGGGACCTCATCTCTAAAAGAA","CATGCCTGTAATCCCAGCACCTTGGGAGGCCAAGGTGGGTGGATCACCTGAGGTCAGTAGTTTGAG"
"GL873585","8849829","8849913","chr18","48581945","48582025","18","39732116","GGCTGGACGAGGGGACTCATGCCTGCAATCCCAGCACTGAGAGAGGCCAAGGCAGGTGGATCCCCTGAGCTCAGAAGTTTGAGAC","GCTGGACGCAGTGGCTCACACCTGTAATCCCAGCACTTTGGGAGGCCAAAGCAGGCAGATCTGAGGTCAGGAGTTTGAGAC"
"GL873585","9319890","9319971","chr8","79499361","79499447","14","70179471","GGCCAGGTGTGGTGGCTCACACCTGTCATCCTAGCACTCTGGGAGGACGAGGTGGGTGGACCGCCTGAGTCAGAGTGAGACC","GGCCAGGTGTGGTGGCTCACACCTGTAATCCCAACACTTTGGGAGGCCCAGGTGGGTGGATCACCTGAGGTCAGGAGTTCAAGACCA"
"GL873586","895572","895692","chr17","14501559","14501680","38","13605987","GGCCAGGTGAGGTTTCTCATTCTGGGAGTGAGCCAGCAATTGGGAGGCCAAAGTAAATGGATTGCCTGAGGTTATAGGTTCCAGAACAGCCAGAACAAGATCGAAATCCTGTCTCCAAAAA","GGCCAGGCGTGGTGGCTCATGCGTGTAATCTCAGCACTTTGGAAGGCCGAGGCAGGTGGATCACCCGAGGTCAAGAGTTCAAGACCAGCCTGACCAACATGGCGAGTCTCTGTCTCCACTAA"
"GL873586","5645995","5646150","chr6","58863249","58863409","38","53217254","GGGTATGGTGGCTCATGCCTGTAATCCAAGCACTCTGGGATGGTGAGGCAGGAGAATCCCTTGAACCCAAGAGTCCGAGGTTGCTGCGAGCTAAGCTGATGGCATAACACTCTAGCCTAGGCGACAGAGTGAGACTCTGTTTCCAAAGAGAAAAAA","TTAGCCAGGCATGGTGGCACATGCCAGTAATCCCAGCTACTCAGGAGGATGAGGCAGGAGAATCGCTTGAACCCAGGAGGCAGAGGTTGCAGTGAGCTGAGATTGCGCCACAGCACTCTACCCTGGGTGACAGAAGGAGACTCTGTCTCAAAAAAAAAAAA"
"GL873586","10258686","10258969","chr12","9481260","9481565","81","777426","GGCCGGGCATGGTGGCAGAAATCTAGGAGGCCGAGGCAGGTGGATCGCCTGAGATCACAAGTTCAAGACCAGCCTCAGCTACAGCAAGACCCCATCTCTAAAAATAGCCGGCTGTTGTGGCAGGCGCCTGTAACCCCAGCTACTCGGGAGGCTAAGGCAAGAGAATCGCTTGAGCCCATGAGTCTGAGGTTGCTGCGAGCTGTGACTCCACGGCACTCTACCCGGGGCGATAAAATGAGATTCTGTGTCAAAACAAACAAACAAACAAACAACAACAAAAACAA","GCTGGGCGCGGTGGCTCATGCCTGTAATCCCAGCACTTTGGGAGGCCAAGGCAGGTGGATCACCTGAGGTCAGGAGTTCGAGACCAGCCTAGTCCACATGGTGAAACCCCATCTCTACTAAAAACTAGCCAGGCGTGGTGGTGCGCACCTGTAATCCCAGCTACTCGAGAGGCTGAGGCAGGAGAATCACTTGAGCCTAGGAAGCAGAGGTTGTGGTGAGCTGAGATCACACCACTGCACTCCAGTCTGGGCGACACAGTGAGACTCTTGTCTCAAAAACAAAAAACAAACAAACAAACAAACAAA"
"GL873587","3208032","3208047","chr8","3626746","3626762","2","418714","AAACAACCACAAAAAA","ACAACAACAACAAAAAA"
"GL873587","3208141","3208321","chr19","2057131","2057316","59","1151010","TTTCTTTTAAAAATCACCCATGGGCTGGGTATAGTGGCTCACACCTATAATCCTCGGGAGGCCAAGGTTGGAGGATTGCTTGAATCCAGGAGTTGAAGGTTACAGTGAACTGGGATTTAGCCACTAGACTCTAGCATAGCTGACAAAGCAAGAACCTATTTGTTTAAAACACAAAAAAGAA","TACTAATAATACAAAAATGAGCCGGGTATGGTGGCGGGTGCCTGTAATCCCAGCTACTGAGGAGGCTGAGGCAGGAGACTTGCTTGAACCCAGGAGGTAAAGGTTGCAGTGAGCTGAGATTGCACCACTACACTCCAGCCTGGGCGACAAGAGCAAAACTTTTTCTCCAAAAAAAAAAAAAAAAAA"
"GL873587","3278260","3278367","chr19","19044200","19044312","39","15765940","CAGTCTGAGCAAGAGGGAGAGGCTATTTCTACTAAAAACAGAAAAACTAGCTGGGTGTTGGGGTGTGTTCCTAGTCTCAGTTACTTGGGAGGCTGAAGTAAGAGGATC","ACCAGCCTGGCCAACACGGTGAAATCCCGTCTCTACTAAAAATACAAAAATTACCTAGGCGTGATGGCACGTGCCTGTAGTCCCAGCTACTCATAAGGCAGAGGTGAGAGAAT"
"GL873587","3278673","3278754","chr7","49412503","49412597","28","46133830","GGCCACGAGAGCTAGCTCATGCCTATTCTAGGAGGCCAAAGCAGGCAGACTGCCTGAGCTCAGGAGTTCAAGAGCAGCCTGG","GGCCAGGTGCAGTGGCTCATGCCTGTAATCCGAGCACTTTGAGAGGCCGAGGCAGGCAGATCACCTGAGGTCAGGAGTTCAAGACCAGCCTAGTA"
"GL873587","3782076","3782188","chr9","112128434","112128552","34","108346358","ACTGGGGTGGCTGAGGCAGGAGCGTCACTTGAACTCAGGAGTTTGAGATTGCTGTGAGCTGAGCAGATGTCATGGCACGCTAGCCTAGGTAATAGAGTGAGACTTCGTCTAAA","CAGCTACTCGGGAGGCTGAGGCAGGAGAATCACTTGAACTCGGGAGGCGGAGGTTGCAGTGAGCCGAGATCACGCCATTGCACTCCAGCCTGGGCAACAAGAGCGAAATTCCATCTCAA"
"GL873587","4564996","4565084","chr20","27900350","27900437","14","23335354","GGCGGGGTGTAGTGGCTCATGCCTATTGTCCCAGCACTGTGGGAGGCCGAGGTGGGTGGATCACCTGTGCTCAGAAGTTTGAGACCAGC","GGCCGGGCGTGGTGGCTCATGTCTGTAATCCCAGCACTTTGGGAGGCCGAGGTGGGTGGATCACCTGAGGTCAGGAGTTCAAGACCAG"
"GL873587","6307870","6308175","chr12","112427710","112428020","54","106119840","GGCCAGATATGATGGCTCATGCTTGTAATCCTAGCACTCTGGGAGGCTGAAGTGGGAGGATCACCTGAGATCAGGAGTTCAAGATCACCCTGAGCAAAAGTGAGATCCCATCTCTATTAAAAATAAAAAAATTATCCAGGCATGGTGGTGCAGTCCTTTAGTCCCAGCTACTTGGGAGGCTGAGGCAGGAGAATCTCTTGAACCCAGGAATTAGAGGTTACAGTGAGCTGTGATGATGCTACTGCACTCTAGCAGGATGACAGAGTGAGATACTCCGTGTCAAAAAAAAAAAAAAAAAAAGCAAAA","GGCTGGACATGGTGGTTCATGCTTGTAATCCGAGCACTTTGGGAGGCCAAGGCGGGTGGATCACCTGAGGTTGGGAGTTCGAGACCAGCCTGACCAACATGATGAAACCCCATCTCTACTAAAAATACAAAAAAATTAGCCAGGCATGGTGATGCACGCCTGTAATCCCAGCTACTTGGGAGGCTGAGGCAGGAGAATCACTTGAACCCAGGAGGCAGAGGTTACAGTGAGCCGAGATCATGCCATTGCACTCCAGCCTGGATGACAGAGTGAGCCTCTGTCTCAAAAAAAAAAAAAAAAAAAAAAAAAAA"
"GL873587","6484004","6484128","chr10","67341428","67341546","29","60857424","GACCAGGTTCTGTGGCTCATGCTTGTAATCCTAGCACTCTAGGAGGCCGGAAGAGGGTGGATTGATTGCCTGAGGTCAGGAGTTAGAGACCAGCCTGAGCAAGAGCTAGACCCTGTTTCTTTCTT","GGCTGGGTGTAGTGGCTCATGCCTGTAATCCCAGCACTTTAGGAGGCCAAGGTGGATGGATTGCCTGAGCTCAGGAGTTCGAGACCACCCTGGGCAACAAGCCAAAACCCTGTCTCTAC"
"GL873587","6484407","6484586","chr3","167196537","167196723","48","160712130","TAGACCCTGTTTCTAAAAAAAAAATAGCCAGGTGTTGAGGCAGGTACCTGTAGTCCCAGCTACCTGGGAGGGCTGAGGCAAGAGAATCGCTTGAACCCAAGAGTTTGAGGTTGCTGTGAGCTGAGATGCTATGGCACTCAACCGTGAGCTACAAAGTGAGACTCTGTCTCAAAAAAAAAA","AAAACCTGTCTCTGCTAAAAATACAAAAATTAGCCGGGTGTGGTGATGTGCGCCTGTAGTCCTAGCTACTTGGGAGGCTGAGGCAGGAGAATCACTTGAATCCAGGAGGTGGAGGTTGTAGTGAGTCGAGATCGTGCGACTGCACTCCAGCCTGGGTGACAGCGAGACTCTGTCTCAAAAAAAAAAA"
"GL873587","7466229","7466364","chr1","29437872","29437991","35","21971643","GGCCAGGCGTGGTGGCTCATGCCTGTAGTCCCAGCGCTATGGGAGGCCGAGGTGGGTGGATCACCTGTGCTCAGAGGTTCGAGACCAGCCAAGACCCCCCTGAGCCAAATGAGCCAGAGTGAGATCCCATCTCTAC","GGCCGGGCGTGGTGGCTCACGCCTGTAATCCCAACATTTTGGGAGGCCAAGGCGGGTGGATCACCTGAGGTCAGAAGTTCGAGACCAACCTGGCCAACATGGTGAAACCCCTGTCTCTAC"
"GL873588","1502535","1502718","chr1","34852429","34852590","60","33349894","GGTGCAGTGGCTCACACCTGTTGTCCCAGCGCTGTGGGAGGCCGAGGTGGGTGGATCACCTGTGCTCAGAGGTCGAGACCAGCTGAAGACCTGCCTGAGGCAGAGTGAGCCAGAGTGAGACCCCGTCTCTACTAGAACAACAACAAGACAGCCAGACCTTGTGATCCCAGCTACATGGGGGGCT","GCCAGGTGCAGTGGCTCACACCTGTAATCCCAGCACTTTGGGAGGCCGAGGCGGGCGGATCACCTGAGGTCAGGAGTTTGAGACCAGCTTGACCAACATGGAGAAACCCCGTCTCTACTAAAAATACAAAATTAGCCTGGTGTGGTGTCGCATGCCTGTAAT"
"GL873588","10189037","10189246","chr3","45604681","45604903","65","35415644","GCTGAGATGAGGAGACTCTGTCTCTATTAAAAATAGAAAAATTGGGTGGATGTTGTGGGTACTGTAGTTGCAGCCTCTTGGGGGGCTAAGGCAGGAGGATCAGTTGAAGCCAGGAATTTGCTTTGAGCTAGGCTAAAGCCATGGCACTCTAGCCTGGGCAACAGAGTGAGGCTAGATCTCAAAAAAAGAAAGAAAAGAAAAAGAAAAAAA","CTGGCCAACATGGCAAAACCCCATCTCTACTAAATATACAAAAATTAGCTGGACGTGGTGGCACATACCTGTAATCCCAGCTACTTGGAAGGCTGAGGCAGGAGAATAGCTTGAACCTGGGAGGCAGAGGTTGCAATGAGCTGAGATCACGCCACTGCACTCTAGCCTGGGCAATAGAATGAGACTCTGTCTCAAAAAAAAAAAAAAAAAAAAAGACAAGAAA"
"GL873589","104719","104807","chr20","27900350","27900437","13","27795631","GGCTGGGCGTGGTGGCTCATGCCTGTTGTCCCAGCGCTGTGGGAGGCTGAGGTGGGTGGATCACCTGTGCTCAGAGGTTCGAGACCAGC","GGCCGGGCGTGGTGGCTCATGTCTGTAATCCCAGCACTTTGGGAGGCCGAGGTGGGTGGATCACCTGAGGTCAGGAGTTCAAGACCAG"
"GL873589","796766","796905","chr1","166346372","166346487","49","165549606","GGCTAAGTGTGGTGGCTCACACCTGTCATCTAGTACTTTGGGAGGGTGGGCCTGGGAGTTCAAAGACTGAACTCAGGAGTTCAAGGTGGCTCCGGGGAGGAATTCAAGACCAACCTGAGCCAGAGCGAGACCTCGACTCT","GGCCAGTGGGGTGGCTCACGCCTGTAATCCCAGCACTTTGGGAGGCTGAGGTGGTCAAATGACCTGAGGTCAGGAGTTTGAGACCAACCTGGCCAACATGGTGACACCTCGTCTCT"
"GL873589","1023679","1023690","chr1","205890061","205890072","1","204866382","AAAAAAAAAAAA","ACAAAAAAAAAA"
"GL873589","1023771","1024047","chr4","103012712","103012993","70","101988941","GGCTTGGTGGCTCACACCTGTAATCCTAGCACTCTGGGAGGCCGAAGTGGCTGGAATACTTGAGGTCAGGAGTTCAAGACCAGCCTAAGTGAGAGTGAGATCCCCATCTCTAATAAAAATAGAAAAATTAGCAGGGTGTTGTGGCTGGCACTTGTAGTCCCAGCTACCCAGGAGACCGAGGCAGAAGTTTGAGATTATTGTGAGCGAGGCTGATGCCACAGCATTCTAGTGGGACAACAGAGCAAAATTCTATCTCAAAAGAAAAAAAAAAAAAGGA","CGGGCGTGATGGCTCACGCCTGTAATCCCAACACTTTGGGAAGCCGAGGCGGACGTATCACCTGAGGTCAGGAGTTCAAGACCAGCCTGGCCAACATGGTGAAACCCCGTCTCTACTAAAAATACAAAAATTAGCTGGGTGTGGTGGCATGCGCCTGTAATCCCAGCTACCCAGGAGGCTGAGGCAGGAGAATCGCTGAGGCTGCAGTGAACTGAAATTGTGCCACTGCACTCCAGCCTGGGTGACAGAGCAAGACTCTGTCTCAAAAAAAAAAAAAAAAAA"
"GL873589","4820958","4821024","chr8","33633747","33633811","15","28812789","TTAGTCAAGTGCAGTGGCTCACACCTGTCATCCCAGCTACTTGGGAGGCTGAGGCAGGAGAGTTGCT","TTAGCCAGGTGTGGTGGTGCATGCCTCTAATCCCAGCTACTCAGGAGGCTGAGGCAGGAGAATTG"
"GL873589","6763768","6763857","chrX","25814002","25814092","29","19050234","GGTGTGGTGGCTCACACTTGTATCTTAGCATTTTAGGAGGCTGAATGGGGAGAATTGCTTTAAGTCAGGAGTCTGACTTCCACCTTGCCA","GGCTGGGAATGGTGGCTCACACCTGTAATCCCAGCACTTTGGGAGGCTGAGGTGGGCAGATCACCTGAGGTCAGGAGTTTGAGATCAGCCT"
"GL873589","8444551","8444632","chr9","93194085","93194171","17","84749534","CGGGCATGGTGGCTCACAACTATAATCTTAGCACTTTGGGAGGCTGAGACAGGTGGATGCCTGAACTCAAGAGTTTGAAACC","GGCCGAGCATGGTGGCTCACACCTGTAATCCCAGCACTTTGGGAGGCTGAGGCAGGTGGATTACCTGAGGTCAAGAGTTCAAGACCA"
"GL873589","9085365","9085494","chr2","194063347","194063481","42","184977982","GGCCAGGCACAGTGGCTCACACCTATAATCCCAGCACTCTGTGAGACTGAGGCAGGTGAACTGTTGCAAGAGTGAGACCCTGTGCTTGGTGCCTGTAGCTCAGTGGTTAATAATAAGAAAAAAGAAAAAA","GGCCAGGTGCAGTGGCTCACACCTGTAATCCCAGCACTTTGGGAGTCTGAACCAGGCAGATCACCTGAGGTCAGGAGTTCGAGGCCAGCTCGGCCACCATGGTGAAACCCTGTTTCTAATAAGAATACAAAAAAA"
"GL873589","9085767","9086002","chr7","84631446","84631650","75","75545679","GAGTGAAACCCTGTCTCTACTAAAAATAGAAAAACTAGCTGTGCATCAGGGCGCATAACTGTAGTCCCAGGTACTCAGGACACTGAGGCAAGAGAATTGCTCAAGCCCAAGAGTTTGCAAGAATTTGAGGTTGCTATGAGCTATGATGCCATGGCACTCTACCTAGGGTGACAGACAGAGACTCTGTCCCAAAAAAAAAAAAAGAAGAAGAAGAAAAAAAAAAAGAAAGAAAGAAA","ATAGTGAAACCTCGTCTCTACTAAAAATACAAAAATTAGCTGGGCATCATGGTGCACGCTTGTAATTCCAGCTACTTGGGAGGCTGAGGCAGGAGAATTGCTTGAACTCAGGAGGTGGAGGTTGCAATGAGCCAAGATCGCGCCACTGCACACCAGCCTGGGTGACAAAAGACTCTGTCTCAAAAAAAAAAAAAAAAAAAAAAAA"
"GL873589","9992904","9993045","chr16","56427538","56427666","46","46434634","AACCAGCCAGGCATGGTGATTCACACCTATAATCCCAGCTACTTAGGAGTATGGCTTGAGCACACAGGATACCATACCATTCTAGTCATCCCAGGCAACAGAGGGAAACTCTGTTGGTTAAAAAAAAAGAAAAACTTAAAAA","TTAGCCAGGAGTGGTGGTGCACGCCTATAATCCCAGCTACTTGGGAGGCTGAGGCACAAGAATCACTTGAACCATTGCACTCCAGCCAGGGTGATAGAGGGAGACTCTATCCAAAAAAAAAACAAAAAA"
"GL873589","9993319","9993452","chr3","2774534","2774668","28","7218785","GGCCTGAGCCCTGTGACTCATGCCTGTAATCCCAGCACTGGAAGTTCCAAGGCAGGTGGATCGCTTGAGCTCTGGAGTTCAAGACCAGCTCAACCAAGAGTAAGACCCCATCTCTACTAAAAATAGAAAAACCA","GGCTGGGCACGGTGGCTCATGCCTGTAATCCCAGCACTTTGAGAGGCCGAGGCAGGTGGATCTCCTGAGGTCAGGAGTTCAAGACCAGCCTGGGCAACATGGTGAAACCCCATCTCTACTAAAAATACAAAAAAT"
"GL873590","9044589","9044884","chr1","83754525","83754835","84","74709936","GGCCAGGTGCAATGGCTCATGCCTATAATCCTCACACTCTGGGAGGCTGAGGCAGGAGGATCACTTTTCTCAGGGTCAGGGCCAGCCTGACAAAAGTCAGACCCTGTTTCTACTAAAAATAGAAAAACTAGCTGGGTGTTGTGGCAGATGCCTATAGTCCCAGCTACTAAGAGACTGAGACAAGTGCCCAGAGTCTGAGGTTACTGTGAGCAAAGCTGATGCCATAGCATTCTAGCTATAGATCGAGAGTCTGTCTCAAAAACAAACAAACAAACAAACAAACAAACAAAAAAGAA","GGCTGGGTGTGGTGGCTCATGCCTGTAATCCCAGCACTTTGGGAGGCCGAGGCGGGTGGATCATCTGAGGTCAGGAGTTCAAGACCAGCCTGACCAACATGGTGTAACCCTGTCTCAACTAAAAATACAAAAATTAGCTGGGCGTGGTGGTGTGCACCTATAGTCACAGCTACTTGGGAGGCTGAGACAGGAGAATTGCTTCAACCCAGGAAGTGGAGGTTGCAGTGAGCCAAGATCATGTCACTGCACTGCAGCCTGACAGAGCGAGACTCCATCTAAAACAAACAAACAAAAACAAACAAACAAACAAA"
"GL873591","1831505","1831587","chr17","61702818","61702899","25","59871313","CCCAGCACTTTGGGAGGGCAAGATGGGAGAATCATATAAAGTCAGGAGTTTGAGACCAGTTTGGCAGACATGATGAACCCATC","AATCCCAGCACTTTGGGAGGCTGAGGCAGGCGGATCATCTGAGGTCAGGAGTTCAAGACCAGCCTGGCCAACATGGTGAAAC"
"GL873591","2719175","2719275","chr4","86137755","86137847","32","83418580","GTGGGGGCTTAGGCCTGTAATCCCAGCACTCTGAGAGGCCAAGGTGAGCTGGTCACCTGGGTTTAGGAGTTTGGAGACTTGCTCGAGCTAGACTGAGGCTC","GTGGTGGCTCACGCCTGTAACCCTAACAATTTGGGAGGCCAAGGCAGGTGGATCACTTGAGGTCAGAAGTTTGAGACCAGCCTGGACAATATG"
"GL873591","4732974","4733120","chr19","7991801","7991954","55","3258827","ATACGCAGACTGGCCGAGCGTGGTGTCACATGCCTATAATCCCAGTGGCTACTCTGGGGAGGAGAATCTCTTGAAACCAAGAGTTAGAGATTGCAGTGGGGTATGATACAGGGTAACAAAGAGAGACCTTGGATCTGAAAAGAAAAA","AAAATACAGAAACTAGCTGGGCATGGTGATGCACACCTGTAATCCTAGCTACTGGGGAGGCTGAGGCAGGAGAATTGCTTGAACCCAGGAGTCAGAGGTTGCAGTGAGCAACCAGCCTGGGTGATACAGTGAGTGAGACTCTGTCTCGAAAAAA"
"GL873591","6822728","6823009","chr1","20579766","20580052","72","13757038","GGCCAGGCGTGGTGGCTCATGCCTGTAAATCTCAGCACTCTGGGAAGCTGAGGCAGGTGGATTGCTTGAGGTCAGGAGTTTGAGACCAGCCTGTACCAGAGTAAGACCCTGTCTCTAATAAAAATAGAAAAAAAAAAAAAAACTAGTTGGGCATGGTGATGGGTGCCTGTAGTCCCACCTACTTGGGAGGCTGAGGCAATGGCATCTCTTGAGCCCAAGAGTTTGAGGTTGCTGTGCCATGGCACTCTCCCCAGGGTAACAGAGTGAAAATAAAAAAAAGAA","GGCCAGGCGTGGTGACTCATGCCTGTAATCTCAGCACTTTGGGAGGCCGAGGCAGGTGAATCACCTGAGGTCAGGAGTTTGAGACCAGCCTGACCAACATGGTGAAACCTCGTCTCTACTAAAAATACAAAAAGTAGCCAGGCATGGTGGCGCATGCCTGTAATCCCAGCTACTTGGGAGGCTGAGGCAGGAGAATCGCTTGAACCCGAGAGGCAGAGGTTGCATTGAGTCAAGATGGTACCACTGCACTCCAGCCTGGGTGACAGATTGAGACTCAAAAAAAAAAA"
"GL873591","7578706","7578813","chr16","45055441","45055543","42","37476735","AAATTTAGCTACACATAGTGGCATGAGTCTGTAATGCTAGCCACCCAAAAGGCTGTAGTAAGAGGATTGCTCTATCCCAGGAGTTAAAGACCAGCCCGGACATCAGAG","AATTAGCCGGGCGTGGTGACACACACTTGTAATCCTAGATACTCAGGAGGCGAAGGTAGGAGAATTGCTTGAACCCAGGCAGCAGAGGTTGCAACGAGCAGAG"
"GL873591","9282916","9283004","chr1","20744253","20744338","16","11461337","GGCCAGGCGCGGTGGCTCACCCCTGTTGTCCCAGTTCTGTGGGAGGCCGAGGTGGGTGGATCACCTGTGCTCAGAGGTTTGAGACCAGC","GGCCAGGCACGGTGGCCACGCCTGTAATCCCAGCACTTTGGGAGGCCGAAGTGGGTGGATTACCTGAGGTCAAGAGTTTGAGACCA"
"GL873592","835155","835315","chr16","75654291","75654451","43","74819136","CTGGGTGTGGTGGCTCTTGTCTGCAATCTCAGTACACTGGGAGGCTGAGGCAGAAGGATTGCTCCAGCTCAGGAGTTTGAGGCCAGGCTGAGCTAGTGCAAAACCCCATCTCTACTAAAAAAAGAAGGAAAAAAAAAAGAAAAAGAAAAAAAATACGAGCT","CCAGGTGTGGTGACTCACGCCTGCAATCCCAGCACTCTGGGAGGCTGAGGTGGGTAGATTACCGGAGGTTAGGCGTTTGAGACCAGCCTGGCCAACATGGTGAAACCCCATCGCTACTAAAAAAAAAAAAAAAAAAAAAAAAAAAAAAAAAAAAAAAATTA"
"GL873592","835589","835765","chr1","66836166","66836336","48","66000577","ACAAAAAACCTAGCTTAGGGTTGTTATAGCACCTGTAGTCCCAGCTACTCAGGCGCTAAGGCAGGAAAATCTGCCTGAGCTCAGGAGTTTGAGGTTGCAGTAAGTTATGATGATGCTACTGCACTCTAGCTGGGGCAACAGAGTGAGACTCTGTCTGAGGAAAAACCAAAACCAAAA","TAGCCCAGCACGGTGGCTCACACCTGTAGTCTCAGCTACTCAAGAGGCTGAGGCATGAGAATCGCTTGAACCCAGGAGGTAGAGGTTGCAGTGAGCTGAGATCATGCCACTGCGCTCCAGCCTGGGCAACAGAGTGAGACTCAGTCTCAAAAAACAAAACAAAACAAAAAA"
"GL873592","2520661","2520705","chr16","66853217","66853257","11","64332556","TCTGGGAGGCTGAGGCGGGTGGATCACCTGAGCAAGAGTGAGACC","TTTGGGAGGCTGAGGCAGGTGGATCACTTGAGGTCAGGAGT"
"GL873592","4535248","4535388","chr1","12240468","12240612","38","7705220","GGCGGGATGTGGTGGTTCATGGCTGTAATCCCAGCACTCAGGGAGGCTGAGTCGGGTGGATTGCTTGAGTTCAGGAGTTTGAGACCAACCTGAGCAAGAACTAAGCCTGTCTCTACTAAAGATATTATTTCTTATTTTTCT","GGCCGGGCGCGGTGGCTCATGCCTGTAATCCCAGCACTTTGGGAGGCTGAGGCGGGTGGATCACCTGCGGTCAGGAGTTCGAGACCAGCCTGGCCAACGTGGTGAAACCTCATCTCTACTAAAAATATAAAAATTAGCTGGTGTG"
"GL873592","4535654","4535831","chr8","126054004","126054184","54","121518350","TCTACTACAAATATTAACAGAAAAATTAGCTGGGCATTGTGACAGGTGCCTATAGTCCCAGATACTCAGAAGGCTGAAGTAAGAGGATCACTTGAACCCCAGGAGCTAAGGTGGCTGTGAGCTAGGCTGAGGCTCTAGCCTGGGTAACAGAGTGAGACTGTAAAAAAAGAAAGAGAGA","GTCTCTACTAAAAATACAAAAATTAGCTGGGTGTGGTGGTGCATGCCTGTAATCCCAGCTACTCAGGAGGCTGAGGCAGGAGAATCGCTTGAACCCAGGAGGTAGAGGTTGCAGTGAGCCAAGATCATGCCACTGCACTCCAGCCTGGGTGACAGAGGGAGACTCTGTCTCAATAAATAAA"
"GL873592","6794968","6795049","chr3","154764711","154764794","20","147969743","GAAGGTTTGATGAGCTCAGATGATGCCACTGCAGTCTACCCAGAGTGAAGGAGCGAGACTCTGTCTCAAAAACAAAAAAAGA","CAGAGGTTGGCAGTGAGCTGAGACTGTGCCACTGCACTCCAGCCGGGTGACAGAGTGAGACTCTGTCTCAAATTACAAACAAAA"
"GL873592","6881384","6881478","chr5","24882384","24882475","28","18001000","GGGCAGGCATAGTGACTGGTGTCTCTAATCCTAGCAGTCTGGGATGCTGAGGCAAGTGGAATGTCAGAGTTCAGGAGTTGAAGATCACCCTGACT","GGCCGGGCGCAGTGGCTCACATCTATAATCCTAGCATTTTGGGAGGCTGAGGCAGGCGGATCACCTGAAGTCAGGAGTTTAAGACCAGCCTG"
"GL873592","6881755","6881937","chr10","61601371","61601572","66","54719616","TCACCCTGACCAAGAGCAAGACCCTGTCTCTACTAAAAATAGAATAAACTAGCTGGGAATTGTGGTGGGTGCCAGTAGTCCCCGCTACTGAGGCAGGAGGATCATTGAGTCCAAGAGTTTGAGGTTGCTGTAAGTTAGGACACCACAGCACTCTACACAGAGTAAGACTGCCTCAAAAATAAA","AGTAAAGAAAAGAAACCCTGTCTCTACTAAAAATACAAAAATTAGCTGGGTGTGGTGGTGCGCACCTGTAGTCCCAGCTACTTGGGAGGGTGAGGTATGGGAATCACTTGAACCCGGGAGGTGGAGGTTGCAGTGAGCCAAGATCACACCACTGCACTCCAGCCTGGGTGAGAGAGTGAGACTCTGTCTCAAGAAAAAAGAA"
"GL873592","7006080","7006155","chr1","8947061","8947129","24","1940981","CACACTGAGAGGCAAAGGCTGGTGGATCACCTGAGCTCAAGAGTTTGAGACCAGCCAAGCCAGAGATCTTGTCTCT","CACTTTGGAGCCAGGTAGGTGATCACCTGAGTCAGGAGTTCGAGACAGCCTGGCCAACATGTGAAACCC"
"GL873592","8446508","8446655","chr11","122502739","122502874","48","114056231","TTAGCTGGGTGTTGTGGCAGGCACCTGTAGTCCCTCCCAGCTACTTGAAAGGCTGAGGCAAGATGACAGCTTAAACCCAAGAGTTTAAGGTTACTCTATTCAGGGCAACAGAGTGAGACTCCATCTACATAAATAAATAAATAAATAA","GGCTGGGCGTGGTGGTTCACACCTGTAATCCCAACACTTTGGGAGGCTGAGGCCAGCGGATTGCCTGAGCCCAGGAGTTTGAGACCAACCTGGGCAACATGGTGAAACTCCATCTCTACTAAAATACAAAAAGTTA"
"GL873592","8446953","8447008","chr16","44513352","44513404","15","36066399","GACCAGCCTAAGCAAAAAAGAGATCCTATCTCTACTACTAAAAATAGAAAAAATTA","ACCAGCCTCACCAATATGAAGAAACCCCATCTCTACTAAAAATACAAAATATT"
"GL873592","8447239","8447325","chr1","8062863","8062957","21","384376","GGCCAGGAGCAGTGACTCATGCCTAGCACTCTGGGAGGCCAAAGCAGGTGGATCAACTGAGCTCAGGAGTTCAAGACCAGCCTAAGC","GGCCGGGTGCAGTGGCTCATGCCTGTAGTCCCAGGACTTTGGCAGGCCAAGGCCGGTGGATTACCTGAGGTCAGGAGTTCAAAACCAGCCTAGCC"
"GL873592","8723925","8724000","chr3","42066983","42067054","20","33343058","AATTAGCCGGGCATGGTAGTGTGTGCCCATAATCTCAGCTACTCAGAAAGCTAAGATAGGAAAATTGCTTGAGCTC","TTAGCTGGGTGTGGTAGTGCATGCCTATAATCCCAGCTACTCGGGAGGCTGAGGTGGGAGAACTGCTTGAAC"
"GL873593","384022","384146","chr15","102382935","102383070","28","101998913","GGCCACGAGGGCCCATGCCTGTAATCCTAGCACTCTGGGAGGCTGAGGTGAGTAGATTGCTGAGCTCAGGAGTTCAAGACCAGCCTGTGCAAGAGACCCCATCTCTGCTAAAAATAGAAAAACCA","GGCCAGGTGTGGTGGCTCACGCCTGTAATCCTAGCACTTTGGGAGGCTGAGGCGGGTGGATTGCCTGAACTCAGGAGGTCAAGACCAGCCTGGGCAACACAGTAAAACCCCATCTCTACTAAAATACAAAAAATCA"
"GL873593","384425","384607","chr20","28286874","28287058","50","27902449","GAAAGAAAAGAAAAGAAAAACTAGCAAGATGTTGTAGCTGATGCCTATAATCCTAGCTATTGGAGAGGTGGAGGCAAGAGAATTGCGTGAGCCCAAGAGTTGAAGGTTGCTGTGAGCTGCGATGCCAGAGCACTCCAGGGTGACAGAGTAAGACTCTGTCTCAAAAAAAATTACAAAATAAAA","TAATAAAAATAAAAAAATTAGCCAGGAGTCAAAGCACACGCCTATAACCCCAGCTACTTGGGAGGCTGAGGGAGGAGAATTACTTGAACCCGGGAGGTGAAAGTTGCAATGAGCTGAGATCAAGCCACTGCACTCCAGACTGGATGACAGAGTGAGACTCTGTTTCAAAAAAAAAAAAAAGACAA"
"GL873593","1408445","1408467","chr10","88070368","88070389","9","86661923","AATCTAGAGATGGGGAGAGGTTG","AAAGAGATGGAAGAGAAGAAGA"
"GL873593","4856365","4856484","chr7","56497314","56497433","31","51640949","GCAATCCCAGCTGATCGGGAGGCTGACCCAGAAGAATCCCTTGAACCCAAGAGTCTGAGGTTGCTATGGGTGGATTCTACAGCACTCTAGCCTGGGAGACAGAGTGAGACTCTGTCCCAA","ATCCCAGCTACTTGGGAGGCTGAGACAGAAGAATTGCTTGAACCCGGGAGGTGGAGGTTGCAGTGAGCCAAGATTGTACCACTGCACTCCAGCCTGGCAACAGAGTGAGACTCTGTCTCA"
"GL873593","6661298","6661485","chr10","86749316","86749514","55","80088018","GCAGAGGCTCACATATGTAATCCTAGCACTCTGGGAGGATAAGGCAGGTGGACAGCTTGAGCTCAGGGGTTTGACCAGTCTGATCAAGAGCAAGACCTGTGTCTACTAAAAATAGAAAACCTAGCCAGGTATGATGGTAGATGCCTGTATTCCTAGCTACTCTGGAAGCTAAAGCTAAAGAGTTTGAA","GGTGGCTCACACCTGTAATCTTAGCAATTTGGGAGGCCGAGGTGGGTGGATCACTTGAGGTCAGGAGTTTGAGACCAGACTGGCCAACATGGTGAAACTCTGTCTCTACTAAAAATACAAAAATTAGCCAGTCATGGTGGTGCATGCCTGTAATCCCAGCTACTCAGGAAGCTTAGGCAGGAGAATCACTTGAACCCAG"
"GL873593","6710263","6710446","chr14","4390080","4390244","66","2320183","TTGAAGTCAGGAGTTTAAGGCCAGTCTGGGCAACATAGTGAGACCCCCATCTCTACGAAAATATTTTTTAAAAATTAAAAATAGCTGGGCATAGTGAGGCTGTTGTGAGCTATAACTGCACCACTGCACTCAGCCAAGGACAGAGACCCTGTTCCCTGCCTCAAACAAACCAAAACAAAACAAA","AAGTCTAGAGTTTACAGCCTGGACAACGCAGTGAAACCCTGTCTCTACCAAAAATACAAAAATTAGACAGGTGTGAGAGGCGGAGGTTGCAATGAGCTGAGATCGCAGCACTGCAGTCCAGCCTGGATGACAGAGCGAGACCCCATCTCAAAAACAAAAACAAAA"
"GL873593","7159645","7159716","chr6","178318394","178318465","21","171158749","GATCATGTCACTGCTCTCCAACCTGGGCAATTGAGCAGGAATCTGTCTCAAAAAGAAAAAAAAAAAAGAAAA","CGAGTTCACACCACTGCACCCCAGCCTGGGCAACAGAATGAGACTCGGTTTCAAAAAAAAAAAAAAAAAAAA"
"GL873593","7159841","7160050","chr13","33368171","33368368","69","26208330","GGCCAGGCGTGGTGGCTCACACCTGTTGTCCCAGTGCTGTGGGAAGCCGAGGCAGGTGGATCACCTGAGCTCAGCCGAGTTCGAGACCAGTGGAAGACCAGCATGAGGCAGAGTGAGCCAGAGTGAGACCCCATCTCTACAACAACAACAAGAAGAAAAAAAACAGCCGGACCTTGTGATCCCAGCTACGTGGGGAGCTAGAGAATCACT","GGCTAGGCATGGTGGCTCATGCCAGTAATCCCACCACTTTGGGAGGCCGAGGCAGGTGGATCACCTGAGGTCAGGAGTTCAAGACCAGGCTGGCCAACATGTTATGATGAGACCCTCATCTCTACTACAAATACAAAAATCAGCTGGGCATGGTGGCAAGTGCCTGTAATCCCAGCTACTTGGGAGGCTGAGGCAGAA"
"GL873593","8598292","8598391","chr11","118461023","118461129","33","109862731","AGCCAGGTGAGGTGGTTCACACCTGTAACCCTAGCTGCTTGGGAGGCTGAGGCCTCTCTATCCTGGGCAGTGTGGAGAAACTTTGTTTCAAAAAAAAGAA","GCCGGGCGCGGTGGCTCACGTCTGTAATCCCAGCGCTTTGGGAAGCCGAGGCGGGACTATCCTGGCCAACATGGTGAAACCCCGTCTCTACTAAAAATACAAGAATC"
"GL873594","357249","357377","chr2","75702890","75703011","36","75345641","CCTGGTACCGTAGGTCATGCCTGTAATCCTAGCACTTTGGGATGCTGAGGTGGGCAGATTGCCTGAGCTCACGAGTTCAAGCCATTAGAACTGAGCCTGACCTAGAGTGGGACCTCCAACTCTTTTTTT","GCCAGGCACAGTGGCTCATGCCTGTAATCCCAGCAGTTTGGGAGGCTGAGGTGGGCAGATCACTTGAGGTCAGGAGTTCAAGACCAGCCTGGCTGACATGGTGAAACCCCATCTATACCAAA"
"GL873594","357656","357834","chr7","17608776","17608965","55","17251120","GGGACCTCCAACTCTTAAAATAGCTGGGCATTGTGGTGGGCACCTACAGTCACAGCTACTTGGGAGGCTAAGGCAAGAGACTTGTTTGCAGCCAAGAGTTAGAGGTTGCTGTGAGCTATGAGGCTAGGGCACTCTACAGGGGGCGACAAGTGAGACTGTAAAAAAAAAAAAAGAAAAAA","GTCCCTACTAAAAATACAAAAAATTAGCTGGGCCTGGTGGCAGGCACCTGTAATCCCAGCTACTTGGGAAGCTGAGGCAAGAGAATTGCTTGAACCCAGGAGGCAGAGGTTGCAGTGAGCTGACATCAAGCCACTGTACTCCAGCCTAGGCAACAAGAGCAAGACTCTGTCTCAAAAAAAAAAAAAAAAA"
"GL873594","1410711","1410996","chr5","151340503","151340797","76","149929792","CACAGTGGCTCATACCTATAATCCTAACACTCTGGGAGGCCAAGGTGGGTGGACTGTCTGAGTTTGGGACCAGCCTGAGCAAAAGCAAGACTCCCATCTCTACTAAAAACAAAGACAGCCAGGTATGAGGGCAGGTGCCTATCATCCCAGCTACTTGGGAGGCTGAGGAAGGAGGATCACCTAAGCCCAGGACTTTAAGGTTTCTGTGAACTAAGATGATGTTACAACACTCTAGCCAGGGTAACAAGGCAAGATTCTGTTTCAAAAGACAAAAAAAAAAAAAAAA","GGTGGTTCATGCCTGTAATCCCAGCACTTTGGGAGGCTGAGGCAGGTGGATCACCTGAGGTCAGGAGTTCGGGACCAGCCTGGCCAACATGGGGAAACCCCATCTCTACTAAAATACAAAAATTAGCCAGGTATGGTGGCACATGCCTATAATCCCAGCTACTTGGGAGGCTGAGGCAGGAGAATCACTTGAACCCAGGAGGCTAAGGTTGCAGTGAGCCGAGATTGTGCCACTGTACTCCAGCCTGGGTGACAGACTGAAACTCTGTGTCCAAAAAACAAAACAAAACAAAAAA"
"GL873594","5528090","5528162","chr2","69013639","69013718","24","63485549","GGTACAGTGGCTCACGCTTGTGATCCCAGGTTGAGGTGGGTGGATCGCCTGAGCTCAGGAGTTGGATGCCAGC","GGTGTGGTGCCTCACGCCTATAATCCCAGCACTTTGGGAGGCAGGTGGATCACTTGAGGTCAGGAGTTTGAGAACAGCCT"
"GL873594","5834047","5834168","chr2","82491537","82491662","28","76657490","GGCTGGGCCCAGTAGCTCACGACTGTAATCCCAGCACTCTGGGAAGCTGAGGTGGGCGGATCACCTGAGCTCATAGGTTCGAGACCAGCTCCAGTTAGAGTGAGAGCCTGTCTCTAAAAATA","GGCTGGGCACAGTGGCTCATGCCTGCAATCCCAGCACTTTGGGAGGCTGAGGTGGGCAGATCACCTGAAGTCAGGAGTTCAAGACCAGCCTGGCCAACACAGTGAAACCCCATCTCTACTAAAAAT"
"GL873594","5834396","5834461","chr13","14688151","14688212","20","8853755","TATATAATAATAATAACCAGGTATTGTGGCAGGTGCCTCTAGTCCCAGCTACTCGGGAGGCAAAGG","ATAAAAAAATTAGCTGGCCATGGTGGCACATACCAATAATCCCAGCTACTCAGGAGGCTGAG"
"GL873594","7786130","7786294","chr14","12217087","12217250","37","4430957","GGGTGTGCTGGCTCATACCTATAATCCTAGCACTCTGGGAGGCTGAGGTAGGTGTATTGCTTGAACCCAGGAGTCTGAGGTTGCTGTGCGCTAAGCTGATACCATAGCACTCTAGCCTGGGCAACAGAGTGAGACTCTGTCTCAAAACAAATAAATAGTAAAAAA","GCTGGGCGTGGTGGCTCACACCTGTAATCCCAGCACTTTGGGAGGCCAAGGCATGAGAATTGCTTGAAAACAGGAGGCGGAGGTTGCAGTAAGCTGAGACTGTGCCATTGCACTCCAGCCTGGGCAACAAGAGTGAAACTCTGTCTCAGAAAAAAAGAAAAAAA"
"GL873595","723579","723774","chr19","6045933","6046125","65","5322354","GCCTGAGCAGGAGAGAGACCCCATCTCTGCTGAAAGTGGAAAAGTTGGCTGAGTGTAGTGGCGGGCTGCTGCCCCAGTCACTCAGGAGGCTTAGGAAGGAGTATCGCTTGGGCCCAAGATTTGAGGTTGCTGTGAGCGCTACAAAGACATTAGGGTACTCTACACAGGGGAATAGAGTGAGACTGTCTCAAAAAAA","CAACATGGAGAAACCCCGTCTCTACTAAAAATACAAAATTAGGCAGCGTGGTGGTGGGTGCCTATAATCCCAGCTACTCAGGAGGCTGAGGCAGGAGAATCGCTTGACCGGGAGTGGAGGTTGCGGTGAGCTGAGATTGCACCATTGCACTCCAGCCTGGGCAACAAGAGTGAAACTCCGTCTCAAAAAGAAA"
"GL873595","724114","724204","chr20","18199749","18199840","22","17475635","GGCCATGCTTGGTGGTTCTCATCTGTAATCCTAGCACTCTGGAAGGTCTACAGGGGTGGATGGCTGGAGGTCAGGAGTTCAAGACTGGCCT","GGCCGGGCATGGTGGCTCACACCTGTAATCCCAGCACTTTGGGAGGCTGAGGCAGGCGGATCACCTGAGGTCAGGAGTTCGAGACCGGCCTG"
"GL873595","1065346","1065667","chr18","10529729","10530057","74","9464383","GGCCAGGTGCAGCAGCTCATGCCTGGAATCTTCCTGCTCTGTATGGCCAAGGCAGGTGGATCGCCTGACCTCAGGAGTTCCAGACCAGCCTGAACAAGAGCAAGACTCTGTCTCTACTAAAAGTAGAAAAAAAACTAGCCAGTCATAGTGGCAGGTGCCTGTAGTCCCAGCTGCTTGGGAGGCTGAGGCAAGAGGATCACTTGAACCTAAGAGTTTGAGGTTGCTGTGAGCTAAGATGCCACATCACTCTATCAAGGGTGACCAAGTGAGACTCTGTCTCAAAAATAAATAAATAAATAAATAAAAAGAAAGGCAAAAAGAA","GGCCCGGCGTGGTGGCTCATGCCTATAATCCCAGCCCTTTGGGAGGCCAAGGCAGGTGGATCACCTGAGGTCAGGCGTTCGAGACCAGCCTGACCAACGTGGTGAAACCTCATCTCTACTAAATACAAAAAAAATTTAGCCAGGCATGGAGGCACATGCCTGTAATCCCAGCTACTTGGGAGGCTGTGGCAGGAGAATCACTTGAACCTGGGAGGTGGAAGTTGCAGTGAGCTGAGATTGTACCACTGCACTCCAACCTGGGTGACAAAGCAAGACTCGGTCTCAATAAATAAATAAATAAATAAATAAATAAATAAAGTGAAAAAAAA"
"GL873595","1254878","1255146","chr4","42822326","42822607","67","41567448","GGCTGGGCATGGTGGCTCATGCCTGTAATCCTACCGCTCTGGGAGGCTGAGGCAGAGGATCACTTGAGCTCAGGAGTTTCAGACCAGCCTGCAAGAAGGACCCAGTCTCTGCCGAAAATAGAAAAGTTAGCAAGGCGTTGTCGTGAGCACATGTATCCCAGCTACCTAGAACTCTGAGGCAGGAGGATCCCTTGAACCCACAGAAGTTGCTGTTATCTAAACTGATGCCACTGGACTCTAGCCTGGGCAACAGAGTGAGACTGGTCTCA","GGCCGGGCACGGTGGCTCATGCCTGTAATCCTAGCATTTTGGGAGGCTGAGACAGGCAGATTGCCTGAGCTCAGGAGTTCAAGACCAGCCTGGGCTAGATTGTGAAACCCCATCTCTACTAAAATATAAAAATTAGCTGGGTGTGGTGGCACACGCCTGTAATCCCAGCTACCTGGGAGGCTGAGGCAGGAGAATCGCTTGAACCAGGAGACAGAGGTTGCAGTGAGCTGAGATCACGCCACTGCACTTTAGCCTGGGCAACAGAGTGATACTCTGTCTCAA"
"GL873595","3417105","3417297","chr12","115674238","115674427","44","112257133","GGCCGGGCGCTGTGCCTCACGCCTGTAATCCTAATACTCTGAGAGGCCGAGGCAGGTGGATTGCCTGAGCTCAGGTGCTCAAGACAGCCTGACTGAGCAAGCCCTGAGATCCCATCTCCACTAACAATAGTAAAACTAGCCGGGCATTGTGGTGGTGCTTGTAATCCCAGCTACTGGGAGGCTAAGACAGGAG","CCAGGCCTGGTGGCTCACGCCTGTAATCCCAGCACTTTGGGAGGCCGAGGTGGGTAGATCACCTGAGGTCAGGAGTTCAAGACCAGCCTGGCCAACATGGCGAAACCCCATCTCTACTAAAAATACAAAAATTAGCTGGGCATGGTGGTGTATGCCTGTAATCCCAGCTACTCGGGAGGCTGAGGCAGGA"
"GL873595","6098380","6098457","chr3","87492619","87492702","21","81394239","GCTGTGGCTCATGCTGATAATACCAGCACTCTGGGAGAACAAGGTAGGCAGATCACAAGAGGTCACCTGTGCAAGACC","GGGCTGGTGGTGGCTCATGCCTGTAATACCAGCACTTTGGGAGGCCAAGACAGGTGGATCACCAAAGGTCAAGAGTTCAAGACC"
"GL873596","134190","134307","chr1","203207333","203207443","31","203073143","GGCTGGGCGAGGTGGCTCACACCTGTAATCCTAGCACTCTGGAAGGCCCTAGCACTCAGGCAGTTGGATTGCCTGAGCTCACAAGTTCAAGACCAGCCTGAAAAAGAGCAAGACCTCA","GGCTGGGTGCAGTGGCTCACACCTGTAATCCCAGCACTTTGGGAGGCCGAGATGGGTGGATCACTTGAGGTCAAGAGTTGAAGACCAGCCTGGACAACATGATGAGACCCC"
"GL873596","134578","134681","chr11","50235285","50235387","37","50100707","CAAACAAAAGAGGAAGACCTCGTCTCTAAAAAAATAGCTGGGCATTGTGAGGAGTACCTGTAGTCCTAGCTACTCAGAAGGCTGAGACAAGAGAATCACTTAAA","CAACATTGTGAAACCCTGTCTCTACTAAAATAGAAAATTAGCCAGGTGTGTGGGCGTGCCTATAATCCTAGCTACTGGGGAGGGTGAGGCATGAGAATCGCCT"
"GL873596","8160215","8160350","chr1","29437872","29437991","30","21277657","GGCCGGGCGTGGTGGCGCACACCTGTAGTCCCAGCGCTATGGGAGGCCGAGGCGGGTGGATCACCTGAGCTCAGAGGTTCGAGACCAGCCAAGACCCCCCTGAGCCAAACGAGCCAGAGTGAGACCCCGTCTCTAC","GGCCGGGCGTGGTGGCTCACGCCTGTAATCCCAACATTTTGGGAGGCCAAGGCGGGTGGATCACCTGAGGTCAGAAGTTCGAGACCAACCTGGCCAACATGGTGAAACCCCTGTCTCTAC"
"GL873596","8421071","8421132","chr20","1874027","1874093","12","6547044","GTCAGGCGCAGTGGCTCACGCCTGTAATCTCAGCACTCTGAGAAGCCAAGGCAGGATCATCT","GGCCAGGCGCAGTGGCTCAGGCCTGTAATCCCAGCACTTTGGGAAGCCAAGGTGAGCAGATCACCTG"
"GL873598","4416400","4416489","chr5","39418145","39418231","15","35001745","GGCCAAGTGTGGTGGCTCATGCCTGTTGTCCCAGCACCGTGGGAGGCCGAGGCTGGTGGAACACCTGAGCTCAGCTGAGTTTGAGACCAG","GGCCAGTTGCGGTGGCTCATGCCTGTAATCCCAGCACTTTGGCAGGCTGAGGCAGGTGGATCACCTGAGGTCAGGAGTTTGAGACCA"
"GL873598","4416855","4416947","chr3","94091253","94091337","31","89674398","GTGAGACCCTGTCTCTACAAAAAAAAAAGCTGGGCACTGTGGCATGTGCCTGTAATCCCAGCTACTTGGGAGGCAAAGGGAAAGAGAATCACT","AAACCTTGCCTTTACTAGAAATACAAAAATTAGCTGGGCATGGTGGCAGGTACCTGTAATCCCAGCTACTTGGGAGGCTGAGGCA"
"GL873598","5126074","5126161","chr1","12339306","12339394","19","7213232","GCCTGGTGCACTGGTTCACACCTGGAATCCTTGCATTCTGAGAGGCCCAGGTAGGCAGATCACCTCAGCTCAGAAGTTCGAGACCAGC","GCTGGGTGCGGTGGTTCACGTCTGTAATCCCAGCACTTTGGGAGGCCGAGGCGGGCAGATCACCTGAGGTCAGGAGTTCGAGACCAGCC"
"GL873598","5467584","5467662","chr1","9313328","9313403","17","3845744","GCGAGGTGGCTCACGCCTGTAATCCCAGCACATTTGGAAGGCCAAGGAGGGTGGATCACCCGAGCTCACCAGTTGGAGA","CGCAGTGGCTCACGCCTGTAATCCCAGCACTTTGGGAGGCCGAGGCAGGCAGATCACCTGAAGTCAGGAGTTTGAG"
"GL873598","6917752","6917856","chr14","9558287","9558382","22","2640535","GGCCAGGCATGGTGGCTTGTGCCTGTTGTCCCAGCACTGTGGAAGGCCGAGGCGGGTGGATCGCCTGAGCTCAGCTGAATTCGAGACCAGCATAAGACCAGTATG","GGCCAGGCATGGTGGCTTATGCCTGTAATCCCAGCACCTTGGAAGGCCGAAGCGGGCAGATCACCTGAGCTCAGGAGTTTGAGACCAGCCTGTCCA"
"GL873598","8078910","8079062","chr7","164825511","164825660","43","156746601","AACAGCCAGGCATTGTGGTGGGCACCTGTAATCCCAGCTACTTGGGAGGCTGAGGCAAGAGAATTGCTTGAGCCCAACAGTCTCAGGTTACTGTGAGTTATGACACCATGGCACTCTATTGAGGGCAAGAAAGTGAGACTGTCTTGGAAAAAA","CTAGCCAGGCATGGTGGTGCGCACCTGTAGTCCCAGTTACTTGGGAGGTTGAGGCAAGAGAATTGCTTGAGCCTGGAAGGCAGAAGTTGCAGTGAGCTGAGATCACACCACTGCATTCCAGCCTGGGCGAAAGAGCAAGACTCTGTTGAA"
"GL873598","8079328","8079454","chr6","10381248","10381379","32","2301920","GCCCGGCGTGGTGGCTCACGCCTGTAATTCCAGCACTCTGGGGAGGCCGAGGAGGGCAGATTGCCTGAGCTCACAGGTTTGAGCTAGAGCGAGACCCTGTCTCTTAAAAAGAAAAAAAAGGAAAGAA","GCTGGGCGCGGTGGCTCACGCCTGTAATCCCAACACTTTGGGAGGCCGAGGCGGGCAGATCACCAGAGGTGATCTCCAGCCTGGGCAGGAGAGCAAGACCCTGTCTCAAAAAATTTAGAAAAAGGAAAGAAA"
"GL873599","3943256","3943456","chr9","35892110","35892312","79","31948854","GGCAGGCTGCTTTGACCCATATCTACAACTCCAGAACTTTAGAGGCTGAGCTGGGTGGGTCCCTTGAGATTAGAAACTGCTTAGTAGCCTGGCAAAAACCAGACCCCACCTCCACCATGTAGAAAAATTAGCAGTATGCCATAGTGGGAACCTACCAATACAGTCTTTCCAAAGGCCAAAGCTAGAAGGACCGTGAGCTTG","GGCTGGGTGTGGTGGCTCATGCCTATAATTCCAGCACTTTGGGAGGCCGAGGCAGGTGGATCACCTGAGGCCAGGAGTTTGAGACCAGCCTGGCCAATATGGTGAAACCCCATCTCTACTAAAAGTACAGAAAATTAGTCAGTCATGATGGCGCATGCCTATAATCCCAGTTACTCGGGAGGCTAAGGTAGGAGAATTGCTTG"
"GL873599","6693284","6693349","chr1","100916857","100916922","15","94223573","TCACGTCTATAATCCTAGCACTCTGGGAGTCCTTGGCAGGTGGATCACCTGAGCTCAGGAGTTTGA","CATGCCTGTAATCCCAGCACCTTGGGAGGCCAAGGTGGGTGGATCACCTGAGGTCAGTAGTTTGAG"
"GL873600","991618","991705","chr15","13850109","13850195","15","12858491","GGCTGGGCGTGGTGGCTCACACCTGTTGTCCCAGCGCTGTGGGAGGCTGAGGCAGGTGGATCACCTGTGCTCAGAGGTTGAGACCAGC","GCCGGGCGCTGTGGCTCACACTTGTAATCCCAGCACTTTGGGAGGCTGAGGCAGGTGGATCACCTGAGGTCAGGAGTTAGAGACCAG"
"GL873600","8825981","8826014","chr16","43605817","43605844","11","34779836","AGTCTGGGGCAACAGAGCAAGACTCTGTCTCAAA","CAGTCTGGGTGACAGAGCAAGATTCCAT"
"GL873600","8826039","8826157","chr13","87428402","87428520","35","78602363","ATTAGCCTGGTGTGGTGGTATATGCCTTCCTGCCTGCTTGGGAGGCTGAGGCAGGAAGTATGCTTTAACTGTGGAGTCTGAGGTTGCTATGAGCTAGGTTGAGGCCATGGCACTCTAAA","TTAGCCGGGTGTGGTGGTGCACGCCTGTAATCCCAGCTACTCAGGAGGCTGAAGCAGGAGAGTTGCTTGAACCCAGGAGTTGGAGGTTGCAGTGAGCTGAGATCACGCCATTGCACTCC"
"GL873601","269289","269338","chr14","49279240","49279285","14","49009951","GACTGGGTGTGGTGGCTCACACCTTTAATCCTAACACCCTGGGAGGCTTA","GGCTGAGATGGTGGCACACACCTGTAATCCCAGCTACTTGGGAGGC"
"GL873601","269431","269678","chr1","184453273","184453521","76","184183842","AGAAGATCACTCAAGATCAGGAGTTTGAGAACAGCCTGAGCAAGACCCCCATCTTTACTAAAAATGGAAAAGTTTTTACCCAGGCATGGTAGTGCGTGCCTGTATCCCATCTACTCCGGAGGCTGATAGGAGGATTGCTTCAACCAAGGAGTTTGAGGTTCCAGAGACTTAAGATGACACAACTGCATTTTACCCAGTGTGACACAGCGAGACTCTTTCAGAAGAATTTTTAAAAGGAAAAAAAAGAA","GGTCAGATCACCTGAGGTCAGGAGTTTGAGACCAGCCTGACCAACATGGTAAAACCCCATCTCTGCTAAAAATACAAAAAATTAGCCAGGCATGGTGGTGAACGCCTGTAATCCTAGCTACTCAGGAGGCAAAGACAGGAGAATCGCTTGAATCTGGAAGGTGGAGGTTGCAATGAGCCAAGATGACGCCACTGCACTCCAACCTGGGTGACAGAGGAAGACTCCATCAAAAAAAAAAAAAAAAAAAAA"
"GL873601","1397978","1398117","chr16","24839455","24839591","34","23441477","GCCTATAATCCTAGCACTCTGGAAGGCTGAGGCAGGAAGATCACTAGAGCTTGGGAGTTTGAGATTGCTGTGAGGGAGACTGACTCCATGGCACTCTAGCCTGAGGCAACAGAGTAAGACTCCATCTCAAAAAAAAAAAA","CTCTAACTCCAGCTACTCAGGAGGCTGAAGCAGGAAAATCACTTGAACCTGGGAGGTGGAGGTTACAGTGAGCCAAGATCACACCATTGCACTCCAGCCTGAGCGACAGAGCGAGACTCTGTCTCAAAATAAATAAA"
"GL873601","4065502","4065590","chr11","108711352","108711444","19","104645850","GCTGGATGTGGTGGCTCTCACCTATAATCCTAGCACTCTGGGAGGTCAAAACAGGTGGATCACCTGAGCTCAGGAGCAAGAACACCAGC","GTCAGGGGTGGTGGCTCACGCCTGTAATCCCAGCACTTTGGGAGGCCAAGGCAGGTGGATCGCCTGAGCTCAGGAGTTCAAGACCAGCCTTGC"
"GL873601","8241370","8241465","chrY","9469734","9469829","34","1228364","AAAAAAGGTGGAGATGAGCCATGCGCAGTGGTGTAGGCCTGTAATCCCAGCCCTTGGGAGGCCAAAATGGTGGATTGCCTGAAGCAGAGCAAGACC","AAAGTACAAAGAGTCTGGGTACAGTGGCCCAAGCCTGTAATCCCAGCAGTTTGGGAGGACAAGATGGGTAGATCACCTGACATCATGAATTAGAGA"
"GL873569","7519122","7519191","chrX","79016364","79016431","16","71497242","TTGGCCAGGCATGGTCGCTCAGGCTGTAATACCAGCTACTTGGGAAGCTGAAGCAGGAGGATCACTTGAA","TTGGCCAGGCACGGTGGCTCATGCTTATAATCCCAGCTACTCGTGAGGCTGAGGCAGGGGAATCGCTT"
"GL873569","7989158","7989286","chr8","41505677","41505810","35","33516519","AGTCCCACCTATTTGGAAGGCTGAGGCAAGAGGATCACTTGAACTCAGCAGTTTGACATTGCTATGAGTTAGATTGACTCCATGGCACTCTAGCCCAGGCAACAGAGCAAGACTCCGTCTCAAAACAAA","TAATACCAGCTACGTGGGAGGCTGAGGCAGGAGAATCACTTGAACCCGGGAGGTGGAGGTTGCAGTGAGCTGAGATTGCACCGTTGCACTCTAACCTGGGCAACAAAAGCAAAACTCTGTCTCAAAAAAAAAAA"
"GL873569","7989575","7989702","chr1","62231025","62231129","47","54241450","GGCTGGGTAATGCAGTGGCTCACGCCTATAATCCTAGTGCTTTGAGAGGCCAAGAGTGAGACTCTGTGTACTAAAAATAGAAAAATTACCTAGGCATTCTGGTGGGCACCAGTAGTCCCACCTATTTG","GGCTGGGCATGGTGGCTCACGCCTATAATCCCAGCACTTTGGGAGGCCGAGGCAGGTGGATCACCTGAGATCAGGAGTTTGAGACCAGACTGGCCAACATGGTGA"
"GL873569","10034363","10034556","chr10","61268396","61268605","62","51234033","CAGCTTGAGCAAAAGTGAGCCCCTGTCTCTACTGAAAATAGAAAAAATTAGCCAGGCGTGGTGGCACACACTTATAGTCCCAGCCACTTAGGAGGCTGAGGCAGGAGTTTGAGGTTGACATAATCTAAGCTGATACCATAGCACTCTAGCCTGGGCAATAGAGTGAGACTCTGTCTCAAAGAAGAAATTTATCT","CCTGACCAATGGTGAAACCCTGTCTCTACCAAAAATACAAAATTTAGCTGGGCATGGGGGCACGCACCTGTAGTCCTAGCTACTCGGGAGGCTGAGACAGGAGAACTGCTTGAACTCGGGAGGCAGAGGTTGCAGTGAGCTGAGATCATGCCACTGCACTCTAGCCTGGGCAATAGAGTGAGACTCCGTCTCAAAAAAAAAAAAAAAAAA"
"GL873569","10034830","10034845","chr1","217667782","217667796","2","207632952","AAAAAAGAAGAAAAAA","AAGAAAAAGAAAAAA"
"GL873569","10203815","10203922","chr8","96374555","96374671","35","86170740","GCCAGGTGTAGTGGTTCACACCTATAATCCTAGCACTCTGGGAGCCTGAAGCAGGTAAATGGACTGAGCAAGAGTGAGACTTCCACCTCTATTGAAAATAGAAAAATT","GGCTAGGTATGGTGGCTGATGCCTATAATCCCAGAATTTTGGGAGGCCGAGGCAGGCAGATCATCTGAGGTCAGGAGTTTGAGACCAGTCCCGTCTCTACTAAAAATACAAAAATTA"
"GL873569","10204196","10204373","chr20","1304385","1304559","47","8899811","GAAAATAGAAAAATTAGCCAGGCATTATAGCAGGCACCAGTAATCCCAGTTACTTGGGAGGCTAAGGCAAAAGAATCTCTTGAGCCCAAGTTTGGGGTTGCTAGGAAGTAAAACACCACAGCACTATACCCAGAACAAGAGAGTGAAGACTCAGTCTCAAAAAGATAAATAAATAAAA","AAAAATACAAAAATTAGCCAGGCATGGTGGCGGGCGTCTGTAACTCCAGCTACTTGGGAGACTGAGGCAGGAGAATCGCTTGAACCCAGGAGGCAGAGGTTACAGGTGAAATCACACCACTGCACTCCAGCCTGGGCAACAGGGCAAGACTCTGTCTCAAAAAAAAAAAAAAAAA"
"GL873569","10473375","10473444","chr8","20660648","20660717","21","10187273","TGTAGTCCCAGCACTTTGGGAGGTTAAGGCAAGAGTAGCACCCAACATGAGGAGATCAAGACCAATCTGG","CTGTAGTCCCAGCACTTTGGGAGGCTGAGGCAGGTGGATCCTTTGAGGGCAGAACTTTAAGACCAGCCTG"
"GL873570","9287350","9287485","chr1","29437872","29437991","30","20150522","GGCCGGGCGTGGTGGCGCACGCCTGTAGTCCCAGCGCTATGGGAGGCCGAGGCGGGTGGATCACCTGTGCTCAGAGGTTCGAGACCAGCCAAGACCCCCCTGAGCCAAACGAGCCAGAGTGAGACCCCGTCTCTAC","GGCCGGGCGTGGTGGCTCACGCCTGTAATCCCAACATTTTGGGAGGCCAAGGCGGGTGGATCACCTGAGGTCAGAAGTTCGAGACCAACCTGGCCAACATGGTGAAACCCCTGTCTCTAC"
"GL873571","3669989","3670207","chr4","116777080","116777297","60","113107091","AGACCAGCCTGAGGAAGAGCAAGATCCCATCTCTATTAAAAATAGAAAAATTAGCCAGGCATTCTGGTGGGCACCTGTAGTTCTAACCACCTGGGAGGCTAAGGCAAGAGGAACTCTTCAACCCAAGAGTTTGAGGTTGCTGAGAGCTAGGCTAAGGCTGCAGCACTCTAGCCTGGGCAACAGAGTGAGACTGTTTCTCAAAAACAAAAAACAAAAAAA","CGAGACCAGCCTGGTCAATATGGTGAAACCCCGTCCCTACTAAAAATACAAAAATTAGCCAGGCATGGTGGCAGGCACCTGTAGTCCCAGCTACTCGGAAGGCTGAGGCAGGAGAATCGCTTGAACCACAGAGGCAGAGGTTGCAGTGAGCCGAGACTGCACCACTGCACTCCAGCCTGGGCGACAGAGTGAGACTCAGTCTCAAAAAAAAAAAAAAA"
"GL873571","106134","106236","chr4","18143723","18143826","27","18037589","GGCCAGTCTCAGTGGCTCACACCTGTAATCCAGCATTCTGGGAGGCTGAAGCACACGGTCACCTGAGCTCAAAGGTTGGAGACCAGAGTGAGACCCCACCTCT","GGCCAGGCGCAGTGGCTCACTCCTGTAATCCCAGCACTTTGAGGCTGAGGCAGGCGGATCACCTGAGGTCAGGAGTTTGAGACCAGCCTGGCCGAAACCCCATC"
"GL873571","3670496","3670589","chr7","50468399","50468491","15","46797903","GGGCAGGCATGGTGGCTCACACCTGTAATTCTAGCACTCTTGGAGGCTGAGGCAGGAAAATGGCTTGAGGTCAGGAGTTCAAGACCAGCCTGAG","GGCCAGTCATGGTTGCTCACACCTGTAATACCAGCACTTTGGGAGGCCGAGGCAGGCGAATCACCTGAAGTCAGGAGTTCAAGACCAGCCTGG"
"GL873571","4059090","4059389","chr7","52903696","52903994","88","48844606","GGCCAGGTGCAGTGGTTCACACTTATAATCCTAGCACTCTGGGAGGCCGAGGCGAGTGAAGTGCCTGAGCTCATGGGTTCAAGACCAACCTAAGCCAGAGACCCCTGACTCTTATAATAGCCTGGCATTGTGGTGGGCGCCAATATTTCCAGCTACTCTGAGGCTAAGGCAAGAGAATTGCTTGAGCCCAGGAGTTGGAGGTTTCTGTGAGCACTGACGCCGCAGCTCTCTACCAAGGGCAACAAAGACTCTGTCTCAAAAAATAAATAAATAAATAAATAACAGAATGAAAATGAAAAA","GGCCGGGTGCGGTGGTTCACGCCTGTAATCCCACCACTTTGGGAGGCTGAGGCAGGCAGGTCACCTGAGGTCAGGAGTTCCAGACCAGCCTGGCCAACATGGTGAAACCTTGTCTCGGCTATTAGCCTGGCATGGTGGTGCGTGCCCATAATCCCAGCTACTCAGGAGGCTGAGGCAGGAGAATCGCTTGAACCCAGAAGGTGGAGGTTGCAGTGAGCCAAGATAGCACCACTGCAACTCCAGTCTGGGCAACAGAATGAGACTCTGTCTCAAAAAAAAAAAACAAAAAACAAAAAGAA"
"GL873571","4209418","4209704","chr11","32517699","32517985","80","28308281","GGCTTGGCAAGGTGGCTTACACCTCAAATCCTAGCACTGTGGGAGACTGAGGCAGGTGGATTGTTTGAGCTCAGGAGGTCAAGATAGAGAGCAAGAGCAAGTCTCTGTCTCTACTAAAAATAGAAAAGAACTACTTCCCGGGGGTCATGGCAGTAGCCTGTAATCCCAGTTACTAGGTAGAATGAGGCAAGAGGATCTGTTGAAGCCAAGAGACTGAGGTTGTTATGAGCATGCCACAGCACTCTACCCAGGGTGACAGAATGAGACTCTGTTGAAAGAAAAAAAGA","GGCCGGGTGCAGTGGCTCACACCTGTAATCCCAGCACTTTGGGAGGCTGAGGCGGGTGGATCACCTGAGGTCAGGAGTTCAAGACCAGCCTGACAAACATAGTGAAACCCTGTCTCTACTGAAAATACAAAATTAGCCAGGTGTGGTGGCGCATGCCTGTAATCCCAGCTACTCGGGAGGCTGAGGCAGGAGAATTGCTTGAATCCAGGAGGTGGAGGTTGTGTGATCACACCACTGCACTCCAGCCTGGGCGACAGAGTGAGACTCTGTCTCAAAAAAAAAAGAAA"
"GL873571","4209985","4210154","chr3","175781758","175781928","60","171571773","GAAAGAAATGAAAAGAAAGAAGTTAGCTGGTTGTTGGGGTATGCTTCTATAGTCCCACCTACTCAGAAAGCTGAAATCTGGAGTTTGGGGTTGTTGTAAGGTAGGCTGATGACATAGCACTGTAGCTTGGGCAAGAGAGTGTGACTTTGTCTCAAAAAAAATTAAAACAA","ATTAAAAACACAAAGATTAGCCAGGTGTGATGGCACACAACTGTAATCCCAACTACTCAGGAGAATCGCTTGAACCTGGGAGATAGGGTTTGCAGTGAGCCAAGATTGTGCCACTGCACTCCAGCCTGGGTGACAGAGTGAGACTCTGTCTCCAAAAAAAAAAAAAAAAAA"
"GL873571","4210444","4210570","chr17","16655655","16655789","35","12445211","GCCAGGCAGATGGCTCACACTTCATCCTAGCCCTCTGGAAGGCTGAGGCAGGCTAATTTTTTGAGGTTAGGAGTTTGAGACCAGCCTGAGGAAGAGACCCATCTCTACTTTAAAAAATAAATGGAAA","GCCAGGCATGGTGGCTCACACCTGTAATCCTAGCACTTTGGGAGACTGAGGCGGGTGAATCACCTGAGGTCAGGAGTTTGAGACCAGCCTGACCAGTATGGTGAAACCCAGTCTCTACTAAAAATACAGAAATTA"
"GL873571","4391733","4391878","chr11","33723808","33723943","46","29332075","AACTTAGCTGGGAATGGTGGCTCAAGCCTGTAATCCTAGCACTCTGGGAGGCTCAGGTGGGAGGATCACTTGAGGTTGCTGTGAGCTTGGCTGATGCCAGGACACTCTAGTGTGGGCAAGAGAGTGAGACTCCGCCTCAACAACAA","GCCGGGTGCAGTGGCTCATACCTGTAATCCCAGCACTTTGGGAGGCTGAGGTAGGCGGATCACGAGGTCAGGAGCTGAGATGGCGCCACTGCACCCCAGCCTGGGTGACAGAGCAAGACTCTGTCTCAAAAAAAAA"
"GL873571","6307773","6307841","chr9","62429628","62429694","22","56121855","CTGGGTGTGGTGGCATTGCACCTGTAATCCTAGCTACTTGGAAATCTTAAGCCCAGGAGTTGAAGACTG","CCCAGCATGGTGGTGCATACCTATAATCTCAGCTACTTGGAGGCTTGAGCTCAGAAGTTTGAGACCG"
"GL873571","6496217","6496306","chr1","27257765","27257856","27","20761548","GCAGGGTGTGTTGACCCACACCCACAATTCCAGGACTCTGGGGGGCCAGGGATGGTGGGTTCCCTCAGATCAGGAGCTCCTTACCAGCCT","GACTGGGCATGATGGCTCAAATCTGTAATTCCAGCACTTTGGGAGGCCGAGGTGGGTGGATTGCCTGAGATCAGGAGTTCAAGACCAGCCTG"
"GL873571","6499738","6499903","chr1","38976375","38976555","47","32476637","AAAATAACATGAATTGACTAGGCGAGGTGGCTCACATCTCTAATCCTAGCACTCTGGGAGGCTGAGGCAGGAGAATTGCATGAGGTTGCTGTGAGCTATGATGATACCACGGCATTCTAATCAGGGTGACAGAGTGAGATTCTGTCTTAAAACAAACAAACAAAAA","AAAATAAATAAATTAGCAGGGCCTGGTGGCGCACACCTGTAATCCCAGCTACTTGGGAAGCTGAGGCAGGAGAACCCACTTGAACCTGGGAGCCGGAGGTTGCAGTGAGCTGAGATGGCACCACTGCACTCCAGACTGCGTGACAGAGTGAGACTCCGTCTCAAAAACAAACAAACAAAAA"
"GL873571","11399575","11399872","chr15","109458692","109458994","79","98059117","CAGTGGCTCACACCTGTAAATCTAACACTCTGGGAGGCCAAGGTGGGTGGATCCCTTGAGCTCAGGAATTTGATACCAGCCTGAGCAAGAGTGAGACCTTGTCTCTACTAATAATAGAAAAATAGCCCGTGTTGTGGCACTTGTCCCAACCACTGGGGAGGCTTTAGGCGGGAGGATTACTTGAATTGGGAGTTTGATATTGCTGTGAGCTGGGCTGATGCCTTGGCATTCTAGCTTGGGTAACAGCGTAAGACTCCGTCTCAAATAAATAAATAAATAAATAAAAAGAAAAAAAGAA","GTGGCTCACACCTGTAATCTCAGCACTTTGGGAGACCGAGGCAGGTGGATCACCTGAGGTCGGGAGTTTGAGACCAGCCTGACCAACGTGGAGAAACCCCGTCTCTACTAACAATACAAAATCAGCTGGGCGTGGTGGTGCATGCTTGTAATCCCAGCTACTCGGGAGGCTGAGGTAGGAGAATCGCTTGAACCTGGGAGGTGGAGGTTGCGGTGAGCCGAGATCGAGCCACTGCACTCCAGCCTGGGTGACAGAGCAAGACTCCATCTCAAAAAAAAAAAAAAAAAAAAAAAAAAAAAAAAA"
"GL873572","114760","114841","chr8","26280134","26280211","16","26165374","GGCCAGGCATGGCGGCTCTTCCCTGTAATCCTAGCACTCTGGGAGGGCGAGGCAGGCAGATCACCTAGGCTAGGGTGAGATC","GGCCAGGAATGGTGGCTCATGCCTGTAATCCCAGCACTTTGGGAGGCTGAGGCAGGCAGATCACCTGAGGTCAGGAGT"
"GL873572","9421791","9421892","chr11","8089184","8089269","35","1332607","TACTAAATATATAGCAAGGCCAGGCACAGTGGTTCATGGCTGTAATCCCAGTACTCTGGGAGGCCTAGTCAGAGTTGACCTGAGATCAGGCTAGAAGCCTGG","ATAAAAATAATTGGAGGCCAGGCACGGTGGCTCATGCTTGTAATTCTAGCAATTTGGGAGGCTGACGCGGGTGAGATCATACTGAG"
"GL873572","11052834","11053035","chr14","11857478","11857657","65","804644","TCCACAAAGAAAGCAGAAGTGTGGCCGGGTGGTAGCTCAAGGCAGGAATCCCAGCACTCTGGGAGCTGGGAGGTGGGGGAGGATCCCTTGAGATCAGGAGTTGGAGGGCACAGTGAGCCTGGGGGAGGCCACTGTCTCTGTACTCTAGCAGGGAGACAGAGCAAGACTGCCCATTCAAAGAAAAACAACAAACAAAACAAAA","TACAAAAATTAGCTGGGCACGGTGCCACAAGCCTGTAATCCCAGCTACTCGGGAGGCTGGGCAGGGGAATAGCTTGAACCCAGAGGTGGAGGTTGCAGTGAGCCAAGATCAAGCCACAGCACTCCAGCCTGGGTGACAGAGCAAGACTCCATCTCAAAAAAAAAAAAAAAAAAAAAAAAA"
"GL873573","2564195","2564244","chr1","109985445","109985491","12","107421250","TACAAAAATTAGGCTGGGCTTGGTGGTTCACGCCTATAATCCTAGCACTT","ACTAAAATTAGCTGGGCATGGTGGTGCATGCCTGTAATTCCAGCTAC"
"GL873573","7423371","7423533","chr2","202783328","202783513","56","195359957","GGTGGCTCACACCTGTAATCCCAGCACTCTGGGAGCCCTGGTGGCTCATGTCTATAATCCTAGTACTCTGGGAGACCATGGTGGCTCATGTCTATAATCCTAGTACTCTGGGAGCCATGGTGGCTCACGCCTATAATCCTAGTACTCTGGGAGACCATGGTGG","GGCTGAGGCGCGGGGGCTCACGCCTGTAATCCCAGCACTGTGGGAGGCCGAGGCGGGTGGATCACGCCTGTAATCCCAGCACTGTGGGAGGCCAAGGCGGGTGGATCACGCCTGTAATCCCAGCACTGTGGGAGGCCGAGGCGGGTGGATCACGCCTGTAATCCCAGCACTGTGGGAGGCTGAGGC"
"GL873573","9657648","9657710","chr19","10207852","10207913","10","550204","TAAAAATAAAAAATTTAGCTGGATGTGGTGGCTCACACCTGTAATCCTAGCACTCTGGGAGAC","TAAAAATACAAAATTAGCTGGGTGTGGTGGCACACACCTGTAATCCCAGCTACTCAAGAGGC"
"GL873574","1624662","1624783","chr9","814961","815079","36","809701","GACTGGGTGGGTTGGATCATGCCTGGAATCCTAGCACCCTGGGAGGCCAAGGTGAAAGGATTGCTTGAGGTTAGGAGTTCCAGAAATGTAGCAGTCATGGTGACTTCATCCTTCTCTACCAA","GGCTGGGTGCTTTGATTCATGCCTGTAATCCCAGCACTCTGGGAGGCCGAGGCAGGTGGATCACCTGAGGTTAGGAGTTCGAGACCAGCTTGGCTAACATGGTGAAACCTCGTCTCTAC"
"GL873574","4459477","4459612","chr1","29437872","29437991","29","24978395","GGCCGGGCGTGGTGGCGCACGCCTGTAGTCCCAGCGCTATGGGAGGCCGAGGCGGGTGGATCACCTGAGCTCAGAGGTTCGAGACCAGCCAAGACCCCCCTGAGCCAAACGAGCCAGAGTGAGACCCCGTCTCTAC","GGCCGGGCGTGGTGGCTCACGCCTGTAATCCCAACATTTTGGGAGGCCAAGGCGGGTGGATCACCTGAGGTCAGAAGTTCGAGACCAACCTGGCCAACATGGTGAAACCCCTGTCTCTAC"
"GL873574","4681987","4682216","chr6","153082888","153083127","73","148400901","GGGTGCGGTGGCTCAGACCTATAATCCCAGCACTCTGAGAGGCCGAAGTGGGTGGATCACCTGAGCTCAGGAATTTGAGACCAGCCGTCTCTAAAAATAGCTGAGTGTTGTGGCAGTGGCTGTAAGTCCCAGCTGTTTGGAAAGCTGAAGCAAGGGAATCACTTGAACCCAAGAGTTTGAGGTTGCTGTGATGACAAAGTGAGACTCTATCTCAAAAAAAAAAAAAAAAA","GGCCGTGCGCGGCGGCTCACGCCTGTAATCCCAGCACTTTGGGAGGCTGAGGTGGGTGGATCACCTGAGGTCAGGAGTTTGAGACCAGCCCGACCAGAAATTAGATGGGTGTGGTGGTGCGCTCCTGCAGCCCCAGCTACTTAAGAGGCTGAGGCAGGGTAATCACTTGAACCCGGGAGGCGGAGGTTGCAGTGAGCCGAGCTCACGCCACTGCACTCCAGCCTGGGTAACAGAGCGAGA"
"GL873574","4709916","4710039","chr19","13152422","13152536","46","8442506","AAAAATAGAAAAACTAGCCAAGCATGGTGGTGCACCCCCTATAGTCTGAGCTCCTCAGCGGGCTGAAGCAAAAGGACGGCTGGAGCCCTGGAGTTTGAGGTTGCTGTGAGGCAAGGTGATGCCA","ACACATAAATTAGCCAGACATGATGGTGAGTATCTGTAATTCCAGCTCCTTGGGGGGCTGAGGCGGGAGAATTGCTTGAACCTGGGAGGCAGAGATTGCAGTGAGCCAAGATCGC"
"GL873574","6353839","6353913","chr5","25768079","25768163","22","19414240","AAAAATATAGCAAGGCCAGGCATGGTGGCTCACACCTATAATCCCAGTACTTGGGAGCTGGAATTTGAACCTAGG","AAAAAACTCAAACAAGGCTGGGCGTGGTGGCTCACACCTGTAATCCCAGCACTTTGGGAGGCTGAGGTGGGTGGATCACCTGAGG"
"GL873574","6533061","6533332","chr5","85182161","85182439","81","78649100","GGCTGGGCGAGGTGGCTTACACCTATAATCCTAGTACTCTGGGAGGCCAAGGTGGGTGGATTGCCTGAGCGCACAGTTTCAAGACCAGCTGGAGCCAGAGAGAGAGAGAGAGACCCTGCCTCTAAAAATAGCCAGGCATTGTGGCAGGCACCTGTAGTCCCAGCTACTTGGCAGGCGGAGGTATGAGAATCGCTAGAGGTTGCTGTTAGCTATGATGCCATAGCACTCTACCAAGGGCGACAAAGTGAAACTCTGCCTCAAAAAAAAGAAGA","GCCAGGCGTGGTGACTCAAGCCTGTAATCCTAGCACTTTGGGAGGCCAAGGTGGGCGGATTGCCTGAGCTCAAGAGTTTGAGACCAGCCTGGGCAACACGGTGAAACCCAATCCCTACTAAATACAAAAAAAATTAGCCGGGTGTGGTGGTGTGAACCTGTAGTCCCAGCTACTCGGGAGGCTGAGGCAGGAGAAGGCAGAAGTTGCAGTGAGCCGAGATCACACCACTGCACTCCAGCCTGAGTGACAGAGCAAAACTCTTTCTCAAAAAAAAAAAAA"
"GL873574","6643746","6643907","chr2","92627944","92628105","46","85984198","AAATAGCCAGGCGTTGTGGCAGGCACCTATAGTCCCAGCTACTTGGGAGGCTGAGGCAAGAGAATCACTTAAGCCCAAGTGACAGAGGTTGCCAGGGCACTCTACGTAGGCAACAGAGTGAGACTCTATCTAAGAAAGAAGGAAGGAAGGAAGGAGAAAGAA","TTAGCCGAGCATTGTGGTGCGCGCCTGTAGTCCCAGCTACATGGGAGGCTGAGGCAGGAGAACACCTGAACCCAGGATGTGAGCTGAGTCGCGCCATTGCACTCCAGCCTGGGCAACAGAGTGAGACTCCATCTCAAAAATAAAATAAAATAAAATAAAAAA"
"GL873574","6644163","6644274","chr1","128607504","128607619","20","121963341","CTGTAATCCTAGCACTTGGGAGGCTGAGGCAGGTGGATCACCTGAGTTCAGGAGTTCAAGACCAGCCTAAACAAGAGTGAGACCCTATCTCTACTAAAAATAGAAAAAATAT","GCCTGTAATCCAAGCACTTTGGGAGGCTGAGGCGGGTGGATCACCTGAGGTCAGGTGTTCGAGACCAGCCTGGCCAACGTGGTGAAACCCCAACTCTACTAAAAATACAAAAATTA"
"GL873574","8511822","8512127","chr1","23439759","23440073","84","14927937","GGTGGCTGGTGCCTGTAATCCTAGCACTCTGGGAGACTGAGGCAGGTGGATCACTTGAAATCAGGAGTTTGAGATCAACCTGAGCAAGAGATCTTGTCTCTCCTAAAGATAGAAAAACTAGCTGGGATTTGTGGTGGACACCTGTAATTTCAGCTACTCAGGAAGCTAAGGCAAGAGCATTGCTTAAAACCAGGAGTTTGAAGTTGATGTGAGCTAGGATGTCAGGGCAGGTTACCCAGGGTGACAGAGTGAGACTCTGTGTCAAAATAAACAAACAAACAAACAAACAAAACAAAATAAAATAAA","GGCTGGACATGGTGACTCACGCTTGTAATCCCAACACTTTGGGAGGCTGAAGCAGGCAGATCACCTGAGGTCAGGAGTTTGAGACCAGCCTGACCAACATGGTGAAACCTTGTCTCTACTAAAAATACAAAAATTAGCTGGGAGCAGTGGTGCACACCTGTAATCCCAGCTACTCGGCAAGCTGAGGCAAGATAATTTTTTAAACCTGGGAGGTGGAGGTTGCAGTGAGCCAAGATCGTGCCACTGTACTCCAACCTGGGAGACAGAGCAAGACTCTGTCTCAAAAAAAAAAAAAAAAAAAAAAAAAAAAAAAAA"
"GL873575","2107336","2107519","chr4","38052972","38053149","54","35945636","TCAATTAAAAACTTTTTAAAATGAGGCTGAGCATGGTGGTTCACACCTGTAATCCCAGCACTTTGGGAGGCCGAGGCAGGAGGATCACCTGATCCCAGGAGTCCAAGCCTACAGTGAGCCGTGATAATACCACTGCACTTCAGCCCAAAGCCTCAAAAAGAAAAAAAAAAAAGGATAGACAAGA","TATATATATATATATTATTTTGGGGGGGCATGGTGGTGCACACCTGTAATCCCAGCTACTCGGGAGGCTGAGGCAGGAGAATTGCTTGAGCCCGGGAGGCAAAGGTTGCATTGAGCTGAGATCACACCACTGCACTCCAGCCTGGCGACAGAGTCTCAAAAAAAAGAAAAAATAAAAA"
"GL873575","5831824","5831959","chr1","29437872","29437991","28","23606048","GGCCGGGCGTGGTGGCGCACGCCTGTAGTCCCAGCGCTATGGGAGGCCAAGGCGGGTGGATCACCTGAGCTCAGAGGTTCGAGACCAGCCAAGACCCCCCTGAGCCAAACGAGCCAGAGTGAGACCCCGTCTCTAC","GGCCGGGCGTGGTGGCTCACGCCTGTAATCCCAACATTTTGGGAGGCCAAGGCGGGTGGATCACCTGAGGTCAGAAGTTCGAGACCAACCTGGCCAACATGGTGAAACCCCTGTCTCTAC"
"GL873575","7451097","7451208","chr3","122814630","122814743","22","115363533","GGCCAGGTGTGGTGGCTCACACCTGTTATCCTAGCACTCTGAGAGGCCACAGCAGCTGGATCACTTGAGCTCAGGAGTTCAAGACCAGTCTGAGCAAGAGCAAGACCTCACC","GGCTGGGTGTGGTGGCTCATGCCTGTAATCCCAGCACTTTGAAAGGCCAAGGCAGATGGATCACTTGAGGTCAGGAGTTCCAGACCAGCCTGGCCAACATGGCAAAACCCCATC"
"GL873575","7451277","7451445","chr6","58863249","58863409","41","51411972","AAAAATTCAGCCAGCCACAGTGGAAGTGGATGCCTGCCATCACAGCTACTCTGGGGGCTGGGGCAAGAGAATTGCTTGATCCCAGGAGTCTGAGGTTGCTGTGACCTAGGCTGACACCACAGCACTCTACCCAGGGTGACAGAGTGAGGCTGTGTTTAAAAAAAAAAAA","TTAGCCAGGCATGGTGGCACATGCCAGTAATCCCAGCTACTCAGGAGGATGAGGCAGGAGAATCGCTTGAACCCAGGAGGCAGAGGTTGCAGTGAGCTGAGATTGCGCCACAGCACTCTACCCTGGGTGACAGAAGGAGACTCTGTCTCAAAAAAAAAAAA"
"GL873576","1765109","1765185","chrX","53921180","53921256","12","52156071","GGCCAGGTGCAGTGGCTCATATCTGTAATCCTAGCACCCTGGGAGGCCAAGGTAGGCGAATCACCTGAGGCCAGGAG","GGCCAGGTGCAGTGGCTCACGCCTGTAATCCCAGCACTTTGGGAGGCCGAGGTGGGCGGATCACTTTAGGTCAGGAG"
"GL873576","2711577","2711895","chr7","6620384","6620702","85","3908807","GGTCGAGCTTGGTGGCTCATGCTTGTAATCCTAGCACTCTGGGAGGCCAAGGCAGGTAAGTTGCCCTGAGCTCATAGGTTCCAGATCAGCATGAGCCAGAGTGAGACCCTGTCTCTACCAAAAAATAGCCCGGCATTCTGGCAGGTGCCTGTAATCCCAGCTGCTTGGGAGGCTGAGGCTAGAGAATCACTTAAACCCAAGGGTTAGTGGAGGTTGCTGTGAGCTATGATTCCACCGTACTCTACTGAGGGCCACAAAGTGAGACTCTGTCTCCATAAAAAAGAAAGAAAGAAAGAAAGAAAAATAAAATAAAATAAAA","GGCCAGGCACAGTGGCTCATGTCTGTAATCCCAGCACTTTGGGAGGCCGAGGCGGGTGGATTACCTGAGGTCAGGAGTTCTAGACCAGCCTGGCCAACAAGGCGAAACCCTGTCTCTACTAAAAATACAAAAAATTAGCTGGGCGTTTTGGCACATGCCTGTAATCCCAGCTACTTGGGAGGCTGAGGCAGGAGAATTGCTTGAACTGGGGAAGTGGAGGTTGCAGTGAGCTGAGATCACACCATTGCACGCCTGAGCAACAGAGCGAGACTCTGTCTCAAAAAAAAAAAAAAAAAAAAAAAAGAAAAGAAAAAGAAAA"
"GL873576","4782520","4782652","chr9","61136941","61137074","22","56354421","CCAGGCACGGTGGCTCACCCTTGTAACCCTAGTACTTTGGGAGGCTGAGGTGGGAGGATCCCTTGAGGTCAGGAGTTCAAGACCAGCCTGAACAACAGTGAGACCCCCGTCTCTACTAAAAAATAGAAAAGTT","GCCAGGCACGGTGGCTCACGCCTGTAATCCCAGCACTTTGGGAGGCTGAAGCGGGCGGATCACCTGAGGTCAGGAGTTCAAGACCAGCCTGGGCACCATGATGAAACCCCGTCTCTATTAAAAATACAAAAATT"
"GL873576","4782930","4783078","chr7","57521645","57521803","40","52738715","AGTTAGTCTGGTGTCATGGTGGGTGCCTGTAGTCCCAGCTGCTTGGGAGGCTGAGGCAAGAGAATCACTTGAGCCCAGGAGTTGGAGGTTGCTATGAGCGAGGCTGTAGCCTAGGCAACAGAATGAGACTTTGCCTCAAAAAAATAAAA","TTAGCTGGGCATGGTGGCGCATGCCTGTAGTCCCAGCTACTTGGGAAGCTGAGGCAGGAGAATCACTTGAACCTGGGAGGTGGAGGTTGCAGTGAGCTGAGATCGCACCGCTACACGCCAGCCTGAGCAACAGAGAGAGACTCTGTCTCAAAAGAAAAA"
"GL873576","7828709","7828723","chr5","101042981","101042996","1","93214272","TAAATAAATAAAAAA","TAAATAAATAAATAAA"
"GL873576","7828960","7829230","chr13","49045537","49045844","89","41216577","GCCGGCTGCAGTGGCTATAATCCAAGTACCCTGGGAGGCTTAGGTGGATGGATCACTTGAGCTCAGAAGTTCAAGACCAGCCTCAGCAAGAGGTAGACCTTGCCTCTATTAAANNNNNNNNNNNNNNNNNNNNNNNNNNNNNNNNNNNNNNNNNNNNNNNNNNNNNNNNNNNNNNNNNNNNNNNNNNNNAGTTTGAGGTTGCTGTGAGCTATGATGAAGCCAGGGCATTCTACCCAGGGTGACAGAGTAACTCTTAAAAAAAACTAAACAA","GGCCAGGCAGAGTGGCTCATGCCTGTAATTCCAGCAATTTGGGAGGCCTAGGCAGGCAGATTACCTGAGGTCAGGAGTTTGAGACCAGCCTGGCCAACATGGTGAAACCCCGTCTCTTCTANNNNNNNNNNNNNNNNNNNNNNNNNNNNNNNNNNNNNNNNNNNNNNNNNNNNNNNNNNNNNNNNNNNNNNNNNNNNNNGGAGATAATAGCTTTTGTAGAACGAAGCGATGCAACAGCCAGATCGCCGCCACCACCCTTAGGTCCTGGCGACAGAGTGAGATCCATCTTAAAAAAAAAAAAAAAAAAA"
"GL873576","10622840","10623093","chr7","60266447","60266705","74","49643607","GCTGGGTATGGTGGTTCACACCTATAATCCTAGCACTCTGGGAGGCTGAGGTGGGAGGATTGGTGGAGCTCAGGAGCTCATGAGGTGCCAAATCACTGGTGCCACACACCTGTATTCCCAGCTACTGAGGAGGCTGAGGCAGGAGGATCAGGTAAGCCCAGGAAGTTTGAGGTTGTAGTGAGTTAGGATGATTGAACTCTGCCTTGAGAGACAGAGCAAGATCCTCCTTCCTCCTAAGCAAACAAACAAATAAA","GGCTGGGTGCAGTGGCTCACACCTGTAATCCTAGCACTTTGGGAGGCTGAGGCGGGAAAATTGCCTGAGCTCAGGAGTTCAAGGACAGCCTAGGCAACATAGCATGGTGGTGCACGCCTGTATTCCCTGCTACTTGGGAGGCTGAGGCACAAGAATTGCTTGAATCCGGGAAGTGGAGGTTGCAGTGAGCCATTGTGGCACTGCTCTCCAGTCTGGGTGACAGAGCAAGACTCCATCTCAAAAAAAAAAAAAAAAAAAA"
"GL873576","10819939","10820007","chrX","67133632","67133707","21","56313693","AGGTTGCAGTGAAATTGTACCATTCCAATGAAGCCTGGGGGACAGAGTGAGATTCTCTCAAAATAAAAA","GGAGGTTGCAGTGAACCGAGATCGTGCCACTGCACTCCAGCCTGAGCGACAGAGTGAAACTTCGTCTCAAAAAAAA"
"GL873576","10920306","10920363","chr3","48261745","48261808","16","37341439","GCTGGACCTTGTAGAGAGTGCCTGTAATCCCAGCTACATGGGGGGCAAGAGAATTGCT","GCTGGGCATGGTGGTGCATGCCTGTGATCCCAGCTACTCAGGAGGCTGAGGCAGGAGAATTGCT"
"GL873576","10920398","10920529","chr10","67341428","67341546","30","56421030","GGCCAGGCGTGGTGGCTCACGCCTGTTGTCCCAGCACTGTGGGAGGCCGAGGTGGGTGGATTGCCTGAGCTCAGAGGAGTCCGGAAGACCAGCATGAGGCAGAGTGAGCCAGAGTAAGATCCTGTCTCTACC","GGCTGGGTGTAGTGGCTCATGCCTGTAATCCCAGCACTTTAGGAGGCCAAGGTGGATGGATTGCCTGAGCTCAGGAGTTCGAGACCACCCTGGGCAACAAGCCAAAACCCTGTCTCTAC"
"GL873577","515809","515961","chr7","137660778","137660931","43","137144969","AGCTGGGCATGGTGGCTCATGCCTATAACCCTAGCGTGCTAGGAGATTGCTTGTCAGGAGACTGAGGTTGCAGGAAACTGTGATGATGGCACTGCACTCTACCCAGGGTGACAGAGCAGGACTCTGCCTCAAAAAAAAAAAAAAAAATAGAAA","TTAGCTGGGCATGGTGGCGCATGCCTATAATCCCAGCTACTTGGGAGGCTGAGGCAAGAGAATCGCTTGAACCGGGGAGGCAGAGGTTGCAGACTGCACTCCAGCCTGTGTGACAGAGTGGGACTCCGTCTCAAAAAAAAAAAAAAAAAAAAAA"
"GL873577","1633164","1633256","chrX","38269524","38269615","26","36636360","TCAGCCAGGCATGGTGGCACTTGCCTATAAACCCAGCTCCTTGGGAAGCTGAGCCGGGAGGATCCCTTGCACCCAGGAGCAACGGAAGGCAGT","AATTAGCCAGGCATGGTGGCACATGCCTATAATCCCAGCTACTCAGAAGGTTGAGGCAGGAGAATCACTTGAACCTGGGAGGCAGAGGTTGC"
"GL873577","3979502","3979560","chr20","68909283","68909346","13","64929781","GAGTTTGAGACCAGCCTGAGCAAGACCGAGACCCAGTCTCTACTAAAAATAGAAAAATT","GGAGTTCAAGACCAGCCTGACCAACATGGAGAAACCCTGTCTCTACTAAAAAATACAAAAATTA"
"GL873577","3979839","3980009","chr10","31403126","31403287","39","27423287","ATGAGCAGATTGTCTTGGTGGGCACCTGTAGTCCCAGCTATTGGAGGTGGGAGGCTGAAGCAGGAAAATCTCTTGAGCCCAGGAGTTTGAGGTTGCTGTGAGCTAGGCTGACACCACGGCACTCTAGTCAGGGCGTCAGAGTGAGACTCCGTCTCAAAAAAAAAAAAAAAA","TTAGCTGAGTGTGGTGGCGCACATCTGTACTCCCAGCTATTTGGGAGGCTGAGGCAGGAAAATCGCTTGAACCCAGGAGGTGGAGGTTGCAGTGAGCCAAGATCACACTACTGCACTCCAGCCTGGGTGACAGAGTGAGAATCCATCTCAAAAAAAAGAAAA"
"GL873577","6050882","6051080","chr1","153219820","153220007","59","147168938","GGCTGGGCGTTGTGACTCATGCCTGTAATCCCAGCACTCTAGGAGGCCGAGGTGGGTGGACTGCCTGAACTCAGAGGTTTAAGACCATCCTGAGCCGCAGTGAGCCAGAGCGAGACCCTGTCTCTACCAAAAAAAGCTGGGTGTTGTGGTGGGCGCCTATAGTCCTAGCTACTTGAGGCGCTAAGGGTAAAAAAATTGC","GGCCTGGCACAATGGCTCACGCCTGTAATCCTAGCACTTTGGGAGGCCGGGGTGGGTGGATCACCTGAGATCAGGAGTTTGAGACCAGCCTGGCCAACATGGTGAAACTCCTTCTCTACAAAAATTAGCCAGGTGTGGTGGTGGGTACCTGCAATCCCAGCTATTTGGGAGGCTGAGGCAGGAGAATC"
"GL873577","8463965","8464050","chr9","52134422","52134508","19","43670457","CTGGGTGCTATAGCTCACGCCTATAATCCTAGCACTCTGGGAGTTTGGGGCAAATGGATCACCTAGGCTCAGGAGTTTGATACCAG","GGCTGGGAGCAGTGACTCACGCCTATAATCCCAGCACTTTGGGAGGCTGAGGCAGATGGATCACCTGAAGTCAGGAGTTCGAGACCA"
"GL873577","9471486","9471613","chr16","5178790","5178910","46","4292696","TTAGCCAGGCATAGTAGCCTGTGTGTAGTCCTAGCTACTCAGGAGGCTGAGGTAGATGGGTCACTTGAGGTTGCAGAGATTATGGTAATGTCACTGTACTCTAGCCCTGGCAACAGAGCACAACCCTG","TTAGCCGAGCCTGGTGGCATAAACCTGTAATCCCAGCTACTCAGGAGGCTGAGGCAGGGGAATTGCTTGAACCTGAGAGGAGAAGGTTGCAGTGAGCCGAGATTGCACCATTGCACCCCAG"
"GL873577","9471875","9471998","chr7","17832200","17832315","36","8360325","GGCCAGGTGAAGCAGCTCATGGCTATAATCCTAGCAGTTTGGCAGGCCAAGGTGGGAGGACTGCTTGAGGTCAAGAGTTCAAGACCAACCCATCTTTGCGAAAAATTTAAAAATTACCTAGGCA","GCCAGGAGAGGTGGCTCATGCCTCTAATCCCAGCACTCTGGAAATCCAAGGTGGGTGGATCACCTGAGGTCAGGAATTCCAGACCAGTCTGGCCAATATAAAAAATTAGCCAGGCT"
"GL873577","9853150","9853170","chr3","85044647","85044667","3","75191497","AAACAAACAAACAAAAAAAGA","CAAACAAACAAACAAACAAAA"
"GL873577","9853206","9853473","chr7","130818682","130818963","67","120965476","GCTGGGCGCAGCGTCTCACTCCTGTAATCCCAGCACTTGGGAGGCCAAGGTGAGTGGATTGCCTGAGTTTACAGTTTCGAGACCAGCCTGAGCCAAAGCGAGACCCCCATCTCTAAAAAATAGCTGGGCATTGTGGTGGGCACCTGTAGTCCCAGCTACTTGGGAGGCTGAGGCAAGAGGATCGCTTGAACCTAAGAGTTTGAGGTTGCTGTGAGCTAAGGCTCCATGGCATTCTACCAAGGGTGACTAAGTGAGACTCTGTCTAAAA","GCCGGGCACAGTGGCTCACACCTGTAATCCCAGTACTTTGGGAGGCCAAGGTGGGTGGATCACCTGAGGTCAGGAGTTTGAGACCAGCCTGGCCAACATAGTGAAACTCTACTAAAAATACAAAAAAATAGCTAGGCATGGTGGTGCGCACCTGTAATCCCAGCTACTTGGGAGGCTGAGGCAGGAGAGTTGCTTGAACCCAGCGGGGTTGAGGTTGCAGTGAGTTAAGATCAAGCCACTGTGCTCCAGCCTGGATGACAGAGAGAGACTCCATCTCAAAAA"
"GL873577","10722415","10722478","chr10","12501471","12501539","23","1779056","AATAAAAAAATGCTGGGTACAGTAGTACATGCCTGTACTCTCATCTGGGGAAGCTGAGGCATGA","AAAGTAAAAAATTAGAGCTGGGCATGGTGGCACACACCTGTAATCCCAGTCACTAGGGATGCTGAGGCA"
"GL873578","463331","463568","chr10","28935382","28935620","93","28472051","CAGGTGCTTTGACCCACACCCTCAACTCTAGGACTTTGGACGCCCTGGCTGGGTGGGTCCTTTAAAGTCAGGAGCTTCTTATCAGTCTGGGCAAAAGTGAGACCCCATCTCTACCAAACAAAGAAAGAAATCAGCAGTATGTTGCAGTAGAGACTCACCAATACCTTCTTTCAAAGACCAAAGCTGGAAGGACACTAAAGACCATGATCTCATGGCCTCCCTGAGCCATGACAATGCC","CCAGGTGCAGTGGCTCATGCCTGCAAGCTCAGAACTTTGGGAGGCAGAGGTGAGCAGACTGCCTGAGTTCAGGAGTTCAAGACCAGCTGGGCAACATGGTGAGACCCTATCTCTACTAAAAATACAAATAATTAGCAGGGTGTGGTAGCACACACCTGTAGTCCAGCTACTCAGGAGGCTGAGGCAGGAGAATTGCTTGAACCCAGGAGGCAGAGTTTGCAGTGAGCCAGGACTGGGCC"
"GL873578","1143712","1143827","chr11","52824583","52824692","30","51680871","GGCTGGGTGTGGTGCCTCATGCCTGTAATCTAAGCCCTCTCCGAGGCTGAGGTGGGAGGATCCCTTGAGTTTAGGAGTTTGATTTTGAGACCAGCCTGATCAAGAGAGAGACCTCA","GGCCGGGTGTGGTGGCTCATGTCTGTAATCCCAGCACTTTGGGAGGCTGAGGTGGGTGGATACCCTGAGGTCGGGAGCTCGAGACCAGCCTGACCAACATGGAGAAACCC"
"GL873578","1144101","1144139","chr3","33494224","33494257","11","32350123","GAGAGAGACCTCATGTCTACTAAAATAAATAAATATATA","GTGAAACCCGTCTCTACTAAAAATACAAAAATTA"
"GL873578","1144175","1144343","chr12","119519961","119520131","41","118375786","ATTATCCAGGCCTTCTGGTGGATGCCTGTAGTCCTAGCTACTAGAAAAGCTGGAGCAGAATCACTTGACCCAGGAGCTGGAGGTTGCAGGGAGCTAGGCTGATGCCACAGAATTCTAGCCTGAGGCAAAAGAATTGAGCCACTGTCTCAAAAAGGAACAAAAAAGAAAA","ATTAGCCAGGTGTGGTGGCATGCACTTGTAATCCCAGCTACTAAGAAGGCTGAGGCAGGAGGATCACTTGAACCCGGGAGGTGGAGGTTGCAGTGAGCCAAGATCATGCCACTGCACTCCAGCCTGGGCAACAGAGTAAGACTCTGTCTCAAAAAAAAAAAAAAAAAAAAA"
"GL873578","4593962","4594035","chr16","68825055","68825124","22","64231093","AGCTGGGTACAGTGGCTCACATATAATCCCAGTGACTCAGGAGGCTAAGACAGGAGGATTACTAGGACCTGAGA","GGCTGGGCACAGTGGCTCAGACCTGTAATCTCAGTACTTTGGGTGGCTGAGGCAGGTGGATCACCTGAGG"
"GL873578","6158845","6158972","chr3","500432","500562","24","5658413","GACATGGTGGCTCACACCTGTAATCCTAGCCCTCTGGGAGGCTGAGGCAGGTGGATCACTTGAGTTCAGGAATTCAAGACCAGCTTGAGTGAGAGCAAGACCCTGTCTCTACTAAAAATAGAAAAATT","GCACGGAGGCTCATACCTGTAATCCCAGCACTTTGGGAGGCTGAGGCAGGTGGATCACCTGAGGTCAGGAGTTCCAGACCAGCCTGGCCAACATGGCGAAACCCTGTCTCTACTAAAAATACAAAAAATCT"
"GL873578","6159253","6159444","chr19","34496349","34496541","55","28337096","ATAAAATAAAAATAGAAAAATTAGCCAGGCATTGTGGCAGACATGCGAAGTCTCAGCTACTCCAGAGGCTGAGACAGGAAGATTACTTGAGCCCAAGAATCTTGCTGTGAGCTAAGCTGATGCCATAGCATTGTAACCTAGGCAACAGAGTAAGACTTGGCCTCAAAAATAAAATAAAATAATAAAGTAAAA","TTAGTTAATTAAATTAAACTTAGCTAGGCATAGTGGAACACACCCATAGTCCCAGCTACTCTAGAGGCTGAGGCAGGAGGATTGCTTGAGCCAAGTTGGAGGCTGCAGTGAGCTATGGTGGTGCCACTGCATTCCAGCCTCAGTGACAGAGAGAGACCCTGGCTCAAATAATAATAATAAATAAATAAATAAA"
"GL873578","6766040","6766171","chr2","93098086","93098217","30","86332046","CCAGGCACAGTGGCTCATGCCTATAATCCTAGTAGTCTAGGAGGCTGAGGTGAGTGCATTGCTTGAGCTCAGGAGTTAGATACCAGCCTAACCAAGAATGAGACCCCATCTCTATTAAAAATAGAAAAGTTA","GCCGGGCACAGTGGCTCATGCCTGTAATCCCAGCACTTTGGGAGGCCGAGGCGGGCAAATCACGAGGTCAGGAGTTCAAGACCAGCCTGACCAATATGATGAAACCCCGTCTCTATTAAAAATACAAAAATT"
"GL873578","6766434","6766577","chr9","21128084","21128223","50","14361650","GTTAGCCAGGAGTTGTGGCGGGCACCTACAGTCCTAGCGACTCAGGAGGCTGAAGTAGGCAGAGTTTGATGTGTTGCTGTGAACTACAAGGACACCAATGCACTCTAGGCCGGTAACAGAGTGAGACACTGACTAAAAAAAAAA","TTAGCCAGGTGTGGTGGCACATGCCTGTATTTCCAGCTACTCGGGAGGCTGAGGCAGGAGAATTGCGTGAGCTGAGATCATGCCACTTCATTCCAGTCTGGGTGACAGAGTGAGACTCTGCCTCAAAAAACAAAACAAAA"
"GL873578","7397948","7398119","chr5","40230148","40230319","43","32832200","TAAAAATAGCCATGCATTGTGACAGGCACCTGTAGTCCCAGCTACTCAGGAGGTTGAGGTAAGAGAATCACTTGAACCCAAGAGTTTTGAGGTTGTTATGAGCTAAGACGCCTCGGGACTCTACAAAAGGTAACAAAGTGAGACTCTGTCTCATAAAAAAAGAAAAAAAGAA","AAAATTAGCCAGGCATGGTGACGTACACCTGTAGTCCCAGCTACTCGGGAGGCTAAGGCAAGAGAATCGCTTGAACCCAGGAGGCAGAGGTTGCAGTGAGCTTAGATCACGCTACTGCGCTCCAGCCTGGGTGACGGAGTGAGACGCCATCTCAAAAAAAAAAAAAAAAAAA"
"GL873578","7398378","7398515","chr15","102382935","102383070","35","94984557","GGTCGAGCAAGGTGGCTCACGCCTGTAATCCTAGCACTCTGTGAGGCTGAGGCAGATGGATTGCCTGAGCTCGTGGGTTCGAGACCAGCCTGAGCCAGAGTGAGACCTCATCTCTAAAAATAGCTGGGAAGCTGGGCA","GGCCAGGTGTGGTGGCTCACGCCTGTAATCCTAGCACTTTGGGAGGCTGAGGCGGGTGGATTGCCTGAACTCAGGAGGTCAAGACCAGCCTGGGCAACACAGTAAAACCCCATCTCTACTAAAATACAAAAAATCA"
"GL873579","370235","370429","chr16","38067345","38067552","57","37697110","GCACAGGCCTGAAATCCTAGCACTCTGAAAGGCCAACGGAGGAGAATTTCTGGAGCTCAGGAGTTTGATACCAGCCTAAGCAAATAAAGCTAGACCTCTATCTCTACTAAAATTAGAAAAATTAGGCAGATGTGGTGGTAGGCACCTATAGTCCCAATTACTCCAGAGGCTGAGGCAGAAAGACTCTTGAACCCA","GTCAGGCATGGTGGCTCATGCCTATAATCCTAGCACTTTGGGAGGCCAAGGCCGGTGGATCACCTGAGGTCAGGAGTTTGAGACCAGCCTGGCCAATATGGCAAAACCCCGTCTCTACTAAAAATAAAAAAATTAGCTGGGCACGGTGGTGGGCACCTATAGTCCCAGCTACTCAGGAGGCTGAGGCAGGAGAATTGCTTGAACCCAG"
"GL873579","370936","371046","chr3","3847698","3847802","33","3476762","TGACTCTTGAACCCAGGCACATGAGGTTGCTAAGAGTCTAGGCTGATGTCACGGCACTCTAACCTGGGAAACAGTGTGAGGTTCTGCCTCAATAAATAAATAAATAAATAA","TGGCTTGAACCCAGGAGGCGGAGGTTGCAGTGAGCCGAGATCACGCCACTGCACTCCAGCCTGGGCAACAGAGCGAGACTGTCTCAAAAAAAAAAAAAAAAAAAA"
"GL873579","599436","599605","chr10","38982686","38982853","41","38383250","AAAAAGTCAGACATTGTGGCAGGTGTCTGTAATCCCAGCTATTTGGGAGGCTGAGGCAGGAGTATCATTTGAACCCACGAGTCTGAGGTAACTGTGAGCTAGGCTAACACAACAGCACTCTAGCCTGGGCAATAGAATGAGACTCTATCAAGAAAAGAAATGAAAAGAAA","TATTAGCCTGACACAGTGGCGCGCATCTGTAATCCCAGCTACTTGGGAGGCTGAGGCAGGAGAATCACTTGAACCCAGGAGGCGGAGGTTGCTGTGGGCTGAGATCATGCCACTGCACTCCAGCCTGGGCAACAGAGGGAGGCTCCATCTCAAAAAAAAAAAAAAAAA"
"GL873579","599942","599953","chr3","71473700","71473710","4","70873758","TTTTAAAATAGT","TTTAAAAAAAA"
"GL873579","600232","600365","chr1","16061315","16061447","30","15461083","GGCTAGGCAAGGTGACTCATGTCTGTAATCCTAGTACTCTGGGAGGTTTGAGGCAGGAAGACCACTTTAGCTCAAGAGTTCCAGATCAGCCTGTGCAAGAGTGATACATCATCTCTACTAAAAATCAAAAATTA","GGCTGGGCATGGTGGCTCATGCCTGTAATCCTAGCACTTTGGGAGGTTGAGGCAGGCAGATCACTTGAGGTCAGGAATCTGAGACTAGCCTGGCCAACATGGTGAAACTCCATCTCTACTAAAAAAAAAAAAA"
"GL873579","5650320","5650591","chr6","54938866","54939145","71","49288546","GTCAGGTGTGTTAGCTTACAGTAGTAATCCTAGCACTTTGGGAGGTTGAAGTGGGTGGATTGCTTGAGCTCAGGGGTTCAAGACCAGCCTGAACAAGAGTGGGACCTCATCTCTATTAAAAACAGAAAAACTAGCTGGGTGTTATGGTGGGTGTCTGTAGCCCCAGCTACTCAGGAGGCTGAGGCAGGAGGTTGAGGTTGCTGTGAGCTATTGAGACCACAGCACTCTATCCAGGGCAACAGAGTGAGACCCCTCCCCCCCCCAAAAAAAAA","GGCCAGGTGTGGTGGCTCACGCCTGTAATCCCAACACTTTGGGAGGCCGAGGTGGGTGGATCACCTGAGATCAGGAGTTCAAGACCACCCTGGCCAACATGGTGAAACCCCGTCTCTACTAAAAATACGAAAATTAGCTGAGTGTGGTGGTGCATGCCTGTAGTCCCAGCTACTCAAGAGGCTGAGGCAGGAGGTGGAGGTTGCAGTGAGCCGAGATTGCATCACTGCACTCCAGCCTTGGCGACAGAACGAGAGAGACTCCATCTAAAAAAAAAAAAAA"
"GL873579","7037162","7037347","chr3","37328686","37328893","67","30291524","GAGGTGGGTGGATTGCCTGAGCTCACAGGTTGGAGACCAGCCTGAGCCAGAGCAAGACCTTATCTCAAAAAATAGCCAGGTGTTGTGGCTGGCACCTGTAGTCCCAGCTGCTCAGGAGGCGGAGGCAAGAGAAATGCTTGACCTCAGGAGTTTGAGGTTGCTGTGAGTTCAACTCACACTAATACA","GAGGCAGGGGGATCACCTGAGGTCAGGAGATCGAGACCAGCCTGGCCAACATGGTGAAAACCTGTCTCTACTAAAAATCCAAAAACATTAGCCAGGTGTGGTGGCACGCACCTGTAATCCCAGCTACTTGGGAGGCTGAGGCAGGAGAATCACTTGAACCTGGGAGGCAGAGGTTGTAGCGAGCCGAGATCACACCACTGCACCCCAG"
"GL873579","11077764","11077972","chr19","1200469","1200683","63","9877295","GCCAGGTGCAGTGGCTCATGCCTATAATCCTAGCACCCTAGGAGGCTGAGGAGTTCAAGACCAGCCTAAGCAACTGTGAGACCCCATCTCTACCAAAAATAGAAAAATTAGCTGACTGTTATGGTGTGCACCTACAGTCCTAGCTACTCAGGAGGCTGAGGCAGAAAGAGTCCTTGAACCCAGGAGGCTTTTTTTTGTTGTTGTTGTTG","GGCCAGTCGCGGTAGCTCATGCCTGTAATCCCAGCACTTTGGGAGGCCGAGGCGGGCAGATCACCTGAGACCAGCCTGGCAACATGGTGAAACCCCATGTCTACCCAAACTACAAAAATTAGCTGGGTGTGGTGGTGCACGCCTGTAATCCGAGCTACTCAGCAGGCTGAGGCAGGAGAATCCCTTGAACCTGGGAGGCAGAGGCTGCAGTGAGC"
"GL873579","11078245","11078333","chr19","4926258","4926351","22","6151987","TGAACCCAGGAGTTTGAGTTCGCTGTGAGCTAAGCTGAGGCCACAGCACTCCAGCCTGGGCAACAGAGTGAAAGGAAAAAAATAAAAAA","TGAACCCGGGAGGTGGAGGTTGCAGTGAGCCAAGATCACACCAATGCACTCCAGCCTGGGCAACAAGAGTGAAACTCTGTCTAAAAAAAAAAAA"
"GL873580","320374","320488","chr13","48549305","48549409","42","48228931","GGTAGTGCGTGCCTGCATTCCCAGCTACGGGAGGGCAGGGACTTGAGGCCAGCCTGGGCAAAATAATGAGACCTACTAATGACTCTACTAATACAGAAACAATTAGCTAGGTATG","TGGGAGGCCGAAGTGCGCAGATCACCTGAGGTCAGAAGTTGGAGACCAGCCTGGCCAACATGGTGAAAACCCATCTCTACTAAAAATACAAAAATTAGCTGGGCA"
"GL873580","374969","375091","chr6","147681010","147681135","27","147306041","CGGTGGCTCACACCTATAATCCTAGCATTTTGGAAGGCTGAAGCCGAGGATCTCTGGAAGTCAGAAGTTCAAGACCAGCCTGCCCAAGAGCAAGACCCCATCTCTACTAAAAATAGAAAAACT","GGTGGCTCACACCTGTAATCCCAGCATTTTGGGAGGCTGAGGCAGGCGGATAATCTGAGGTCAAGAATTTGAGACCAGCCTGGCCAACATGGAGAAACCCTATCTCTACTAAAAATACAAAATTAC"
"GL873580","375369","375549","chr7","19977275","19977456","44","19601906","CTAACCAAGTTAGTTAGTTTTAGTTGGCAGGTGCCTGTAGTCCCAGCTCCTTGGGAGGCTGAGGCAAGAGAATGGCTTGAGCCCAGGACTTTGAAGTTGCTGTGAGCTATAATGACACCACAGCACACTACCCAGGGTGACAGAGTGAGACTGTCTCAAAAAAACAAACAAACAAAAAAAA","AACAAACGTTAGCCGAGCATGGTGGTATGTGCCTGTAGTCCCAGCTACTTGGGAGTCTAAGGCAGGAGAATTACTTGAGCCCGGGAGGCAGAGGTTGCTGTGAGCCAAGATCACGCCACTGCACTCCAGCCTGGGTGACAGAGTGAGACTCCATCTCAAAAAAAAAAAAGGAAAAAAAAAAA"
"GL873580","8760922","8761015","chr11","104681322","104681416","19","95920400","GGAGGGAGACACTGCAGTGAACTGCGATCGTGTCTCTGCTTTCCAGGCTGGGTGACAGAGTGAGACTCGGTCTCTAAAATAAAAAATAAATAAA","GGAGACGGAGGTTGCAGTGAGCTGTGATCGCGGCACTGCACTCCAGCCTGGGCAACAGAGTGAGACTCTGTCTCAAAAATAAATAAATAAATAAA"
"GL873580","9391260","9391306","chr14","49279240","49279285","12","39887980","GCCAGTCGAGGTGGCTCACACTTGTGATTCCAGCTACTTGGAAGACT","GGCTGAGATGGTGGCACACACCTGTAATCCCAGCTACTTGGGAGGC"
"GL873581","759283","759365","chr6","46535476","46535542","30","45776193","TAAGAACCTGAAAATAGAGCCAGGCATAGTGGTACATGCGTATAGTCCTGGCTACTCAGGAGGTTGAAACAACAGGATTACTT","CAAAATAGCCAGGCTTGGTGGTGCATGCCTATAATCCAAGCTACTCGGGAAGCTGAGGCAGGAGAAT"
"GL873581","1145844","1145979","chr1","29437872","29437991","29","28292028","GGCCGGGCGTGGTGGCTCACGCCTGTAGTCCCAGCACTATGGGAGGCCGAGGCGGGTGGATCACCTGTGCTCAGAGGTTCGAGACCAGCCAAGACCCCCCTGAGCCAAATGAGCCAGAGTGAGACCCCGTCTCTAC","GGCCGGGCGTGGTGGCTCACGCCTGTAATCCCAACATTTTGGGAGGCCAAGGCGGGTGGATCACCTGAGGTCAGAAGTTCGAGACCAACCTGGCCAACATGGTGAAACCCCTGTCTCTAC"
"GL873581","9628238","9628362","chr5","141044567","141044691","34","131416329","ATCCCAGGTAGTCGGGAGGCTGAGGCAGGAGGATCACTTGAACCCAGGAGGTTGAGGTTGCTGTGAGCAAGGCAGAGGCAACGGCACTCTAGCCACGGGGGCACAGAGACTCTTGTCTTTAAAAA","TAATCTCAGCTACTCGGGAGGCTGAGGCAGGAGAATCGCTTGAGCCCAGAAGGTGGAGGTTGCAGTGAGCCAAGATCGCGCCATTGCACTCCAGCCTGGGCGACAGTGCGAGACTCTGTCTCAAA"
"GL873582","1580485","1580534","chr6","32576760","32576806","12","30996275","CAGCACTTGAGAGGCCAAGGCAGGTGGATCAACTGAGCAAGAATGAGACC","CCAGCACCTTGAGAGGCCAAGGCAGGTGGATCACCTGAGGTCAGGAG"
"GL873582","1644368","1644551","chr1","211626449","211626612","63","209982081","AAAATTTGCCGGGCTCCATAGCTCATGCATGTAATCATAGCACTCTGGGAGGCCAAGATGGGAGGATCTCTCAAGCTCTCTTACTTGGGAGGCTGAGGTTGCTGTGAGTTAGGCTTACGCCACAGCACTCTACTCTAGCGTGAGCAACTCTACTCTTAGTATGAGACTGTCTCAAAAGAAAAAA","AAATTAGCCAGGCGTCGTGGCACATGCCTGTAATCCCAGCTACTCGGGAGGCTGAGGCAGGAGAATAGCTTGATCTCGGGAGGCGGAGGTTGCAGTCAGCCGAGATCACACCACTGCAATCCAGCCTGGACAACAGAATGAGACTCCATCTCAAAAAAAACAAA"
"GL873582","5794385","5794459","chr13","18872784","18872852","27","13078399","ATATTGTTAAGCACAGCCACTATTAAAAATTAAATTATAGGCCAGGCATAGTGGCTCATGCCTGTAATCCTAGCT","TGAAACCACCATCTGGACCAAGATACAAAATGTTGGCTGGGCATGGTGGCTCACACCTGTAATCCTAGC"
"GL873583","102645","102683","chr14","5808766","5808804","14","5706121","GAGCAGATCACCTGAGCTCAGGAGTTTGAGACCAGCCTG","GAGGAATCCCTGTGCTCAGGAAGCTTACATTCTAGTGAG"
"GL873583","6200447","6200560","chr4","17786849","17786963","24","11586402","GGCCAGGAGGGACGGCTCATGCCTGTTATCCTAGCACTATGGGAGACTGAGGTGGGAGGATCACTTGAAGTTAGGAGTTCCAGACCAATCTGACCAAAGTGAGACCTCATCTCT","GGCCAGGCTTGGTGGCTCATGCCTGTAATCTTAGCACTTTGGGAGGCTGAAGTGGGTGGATCACTTGAGGTCAGGAGTTAGAACCAGTCTGGCCAACATGGTGAAACCTCAGCTC"
"GL873583","6200584","6200752","chr6","169626528","169626696","42","163425944","TTAGCTGGATGTGGTAGCACATGCCTATAGTCCCATCTACTCAGGAGGCTGAGACAAGAGAGTTGCTTAAGCCCAGGAGTTTAATTTAACTGTGAACTAGACTGAGACTGTGGCACTCTAGCTGGGGCAACAGAGTGAGACTCTGTCTCAAAAGAAAGCAAGAAAGAAA","TTAGCTGGGTATGGTGTCAGATGCCTGTAGTCCCAGCTACTCAGGAGGCTGAGACAGGAGAATCGTTTGAACCCAGGAGGCCAGAACTGCAGTGAGCTGAGATTCGCACCACTGCGCTCCAGCCTGGGCCAGACAGAGTGAGACTCTATCTCAAAAGAAAAAAAAAAAA"
"GL873583","10217398","10217583","chr3","36257142","36257313","44","26039744","TACTAAAAATAAAGTGTGATAGCCAGGCATGGTGGTGGTGCCTATAGAACCAGGCTATTCAGGAGGCTGAGGCAGAAGGATCACTTGAACCCAGGAGTCTGACGTTGCTGTGAGCTAGGCTGGTGCCATGGTACTCTAGCCTGTGGTAACAGAATGAGACTCTATCTCAAAAATAAAAATAAAAAA","TACAAAATTAGCCAGGCGTGGTGGTGCGTGCCTGTAATCCCAGCTACTTGGGAGGCCGAGGCAGAAGAATGACTTGAACCCAGGAGACAGAGGTTGCAGTGAGCCAAGATCCCACCATTGTACTCCAGCCTGGGCAACACAGTGAGACTCCATCTCAAAAAAAAAAAAAAAA"
"GL873583","10394919","10394983","chr16","12841703","12841771","22","2446784","GAGGTCAGGAAATCAAGATCAGTCTGGGCAATATATTGATACCCTGCCCCTACATAAGGAAGAAA","AGGTCAGGAGTTCAAGACCAGCCTGGCCAATATGTTGAAACCTCATCTCTACTAAAAATACAAAAATTA"
"GL873584","521512","521529","chr1","167402212","167402233","10","166880700","GCATGGAACCCCCCACTC","GGTGAAACCCCATCTTTACTAA"
"GL873584","2079725","2079768","chr15","4338291","4338335","11","2258566","GGCAGGTGGATTACCTGAGTTCAGGAGTTGGAGACCAGCCTGAC","AGGCGGATGGATCACGAGGTCGGGAGTTTGAGACCAGCCTGACCA"
"GL873584","5216877","5217053","chrX","91350057","91350230","49","86133180","CTACTGAAAATGATGACAGAGGCTGGGCATGGGGGCTCCCGCCTGTTATCCTAGCACCCTCGGAGGCTGGGGAATGAGGATTGCTTACGCCCAAGAGTTTGAGGTTGCTGTGAGCTGAGGCCGCTGCACTCTAGCCTGGGCAACAGAGTGAGACTCTGTCTCAAAAAAAAAAAAAAA","TGCAAAAATGAGCTGGGCATGGTGGCACATGCCTGTAATCCCAGCTACACAGGAGGCTGAGGCAGGAGAATCGCTTGAATCTGGGAGGCGGAGGTTGCAGTGAGCTGACATCAGGCCCCTGCACTCTAGCCTGGGCCACAGAGCAAGACTCCGTCTCAAAAAAAAAAAAAAAAA"
"GL873584","7289930","7289950","chr2","51453328","51453345","10","44163398","TGAGGCTCTGTCTCGAAATAA","AATGCCATCTATTAAAAA"
"GL873584","7289975","7290131","chr11","49739997","49740154","37","42450022","CAAGAAAATTAGCTGAGAGTCCTGGTAGGTGCCTGTAATCCCAGCTATTCATGAGGCTGAGGCAGAAGGATCACTTGGGTCCAGGAGTCTGAGGTTGCTGTGAGCTAGTCTGACGCCATAACACGCAAGCCTGGGCAACAGAGTGAGGCTCGGTTTC","CTACAAAAATTAGCTGGGCGTGGTGGCACATGCCTGTAATCCCAGCTACTCGGGAGGCTGAGGCAGGAGAATCACTTGAGCCCAGGAGGCGGAGGTTGCAGTGAGCCAAGATCATGCCATTGCACTCCAACCTGGGCAACAGAGCAAGACTCCATCTC"
"GL873584","7577743","7577867","chr5","48394329","48394446","27","40816586","GGCTGGATGAGGTGGTTCATGCCTGTAATCCTAGCACTCTGGGAGGCCAAGGTGGGTGGATTGCCTGAGCTCAGGAGTTCAAGACCAGCCTGAGCAAGACCCTGTCGCTAAAAATAGCTGGGTGT","GGCTGGGTGCAGTGGCTCATGCCTGTAATCCCAGCACTTTGGGAGGTCAAGGCGGGTGGATCACCTGAGGTCAGGAGTTCAAGACCAGCCTGGCCAACATCTCTACTAAAAATACAAA"
"GL873584","7578135","7578289","chr1","130112713","130112865","31","122534578","GGAGCTGGGTTTTGTGACTGCACCTGTAATCCCAGCTGCTCAGGAGGCTGAGGCAAGAGAATTGCTTGAGCCCAGGAGTTGGAGGTTGCTGTGAGCTGTGATGCCAGGGAACTCTACCAAGGGTGACAAAGTGAAACTCTGTCTCAAAAAAAAAA","TTAGCCAGGTGTGGTGATGCATGCCTGTAATCCCAGCTACTCATGAGGCTGAGGCAGGAGAATTGCTTGAACCTTGGAGCTGGAGGTTGCAGTGAGCTGAGATCAGACCACTCCAACCTGGGTGACAGAGCGAGACTCTGTCTCAAAAAAAAA"
"GL873585","1450952","1451121","chr10","59681079","59681242","48","58230127","TAAAAACAGAAAAAACTAGTCAGGTGGTGTGGTAGGTGCTCATAAGTCCCAGCTGCTTGGGAGACTGAGGCAAGAGAATCACTTGAGCACAAGAGCTTGAGGTGGCTGTGAGCTATAACACCATAGCACTGTACTGAGGGTGACAAAGTAAGACTCTGTCTCAAAAAAAA","TACAAAAATTAGTCAAGGGTGGTGGTATGTGCTTGTAATCCCAGCTATTTGGGAGGCTGAAGCAGGGGAATCCTTGAACCCAGGAGGTGGAGGTTGCAGCGAGCCGAGATCACGTCACTGCACTCTAGCCTGGGCGATAGGGTGAGACTCTGTCTCAAAAAAAA"
"GL873585","1451382","1451515","chr6","17405813","17405948","24","15954431","GGCCCGGCTCGGTGGCTCACACCTATAATCCTAACACTCTGGGAGGCTGAGGCAGGTGGATCACCTGAGCTCAGGAGTTTGAGACCAGCTGAGCAAAAACAAGACCCTATCTCTGCTAAAAATAGAAAAAACTA","GGCCGGGCGGGGTGGCTCACGCCTGTAATCCCAGCACTCTGGGAGGCCAAGGCAGGTGGATCACCTGAGGTCAGGAGTTTGAGACCAGCCTGGCCAACACGCAGAAACCCTATTTCTACTAAAAACACAAAAATTA"
"GL873585","1626960","1627026","chr7","17782729","17782794","22","16155769","AAGATGCCACAGCACTCTACAAGAGTGACCAAGTGAGACTCTGTCTCAAAAAAAAAAAGAAAAGGAA","CAATCGCACTACTGCACTTCAGCCTGGGTGACAGAGTGAGAACCTGTCTCAAAAAAATAAATAAAA"
"GL873585","1627304","1627531","chr11","17033552","17033788","61","15406248","GGCTGGGCACAGTGGCTCACGGCTATAATCTAGGCACTTGGGAGGCTAGGGCAGGTGGATTGCCTGAACTGACAAGTTTGAGACCAACCTGAGCAAGAGCGAGACCCCTGTCTCTAAAACATAGCCAGGCTCTGTGGTGGGCGTCTGTAGTCCCAGCTACTTGGGAGGCTGAGGCAAGAGAATTGCTTGAACTCAAGAGTCTGAGGTTGCTGTGAGTTAAGATGCCAC","GCCCGGCGCAGTGGCTCACGCCTGTAATCCCGGCACTGTGGAGGCCAAGGCAGGCGGATTGCCTAAGCTCAGGGATTCGAGAACAGCCTGGGCAACATGGTGAAACCCCATCTCTACTAAAATACAAAAAACTAGCCGGGCGTGGTGGTATGCGCCTGTAATCCCAGCTACTTGGGAAGCTGAGGCAGGAGAATTGCTTGAACCCGGGAGATGGAGGTTGCAGTGAGCTCAGATCAC"
"GL873585","3626082","3626158","chr1","100916857","100916922","27","97290775","TGCCTGTAATCCCAGCACTTGGGAGGCGGAGGTGGGTAGATTGCCTGACCCAGAGTGGGACCTCATCTCTAAAAGAA","CATGCCTGTAATCCCAGCACCTTGGGAGGCCAAGGTGGGTGGATCACCTGAGGTCAGTAGTTTGAG"
"GL873585","8849829","8849913","chr18","48581945","48582025","18","39732116","GGCTGGACGAGGGGACTCATGCCTGCAATCCCAGCACTGAGAGAGGCCAAGGCAGGTGGATCCCCTGAGCTCAGAAGTTTGAGAC","GCTGGACGCAGTGGCTCACACCTGTAATCCCAGCACTTTGGGAGGCCAAAGCAGGCAGATCTGAGGTCAGGAGTTTGAGAC"
"GL873585","9319890","9319971","chr8","79499361","79499447","14","70179471","GGCCAGGTGTGGTGGCTCACACCTGTCATCCTAGCACTCTGGGAGGACGAGGTGGGTGGACCGCCTGAGTCAGAGTGAGACC","GGCCAGGTGTGGTGGCTCACACCTGTAATCCCAACACTTTGGGAGGCCCAGGTGGGTGGATCACCTGAGGTCAGGAGTTCAAGACCA"
"GL873586","895572","895692","chr17","14501559","14501680","38","13605987","GGCCAGGTGAGGTTTCTCATTCTGGGAGTGAGCCAGCAATTGGGAGGCCAAAGTAAATGGATTGCCTGAGGTTATAGGTTCCAGAACAGCCAGAACAAGATCGAAATCCTGTCTCCAAAAA","GGCCAGGCGTGGTGGCTCATGCGTGTAATCTCAGCACTTTGGAAGGCCGAGGCAGGTGGATCACCCGAGGTCAAGAGTTCAAGACCAGCCTGACCAACATGGCGAGTCTCTGTCTCCACTAA"
"GL873586","5645995","5646150","chr6","58863249","58863409","38","53217254","GGGTATGGTGGCTCATGCCTGTAATCCAAGCACTCTGGGATGGTGAGGCAGGAGAATCCCTTGAACCCAAGAGTCCGAGGTTGCTGCGAGCTAAGCTGATGGCATAACACTCTAGCCTAGGCGACAGAGTGAGACTCTGTTTCCAAAGAGAAAAAA","TTAGCCAGGCATGGTGGCACATGCCAGTAATCCCAGCTACTCAGGAGGATGAGGCAGGAGAATCGCTTGAACCCAGGAGGCAGAGGTTGCAGTGAGCTGAGATTGCGCCACAGCACTCTACCCTGGGTGACAGAAGGAGACTCTGTCTCAAAAAAAAAAAA"
"GL873586","10258686","10258969","chr12","9481260","9481565","81","777426","GGCCGGGCATGGTGGCAGAAATCTAGGAGGCCGAGGCAGGTGGATCGCCTGAGATCACAAGTTCAAGACCAGCCTCAGCTACAGCAAGACCCCATCTCTAAAAATAGCCGGCTGTTGTGGCAGGCGCCTGTAACCCCAGCTACTCGGGAGGCTAAGGCAAGAGAATCGCTTGAGCCCATGAGTCTGAGGTTGCTGCGAGCTGTGACTCCACGGCACTCTACCCGGGGCGATAAAATGAGATTCTGTGTCAAAACAAACAAACAAACAAACAACAACAAAAACAA","GCTGGGCGCGGTGGCTCATGCCTGTAATCCCAGCACTTTGGGAGGCCAAGGCAGGTGGATCACCTGAGGTCAGGAGTTCGAGACCAGCCTAGTCCACATGGTGAAACCCCATCTCTACTAAAAACTAGCCAGGCGTGGTGGTGCGCACCTGTAATCCCAGCTACTCGAGAGGCTGAGGCAGGAGAATCACTTGAGCCTAGGAAGCAGAGGTTGTGGTGAGCTGAGATCACACCACTGCACTCCAGTCTGGGCGACACAGTGAGACTCTTGTCTCAAAAACAAAAAACAAACAAACAAACAAACAAA"
"GL873587","3208032","3208047","chr8","3626746","3626762","2","418714","AAACAACCACAAAAAA","ACAACAACAACAAAAAA"
"GL873587","3208141","3208321","chr19","2057131","2057316","59","1151010","TTTCTTTTAAAAATCACCCATGGGCTGGGTATAGTGGCTCACACCTATAATCCTCGGGAGGCCAAGGTTGGAGGATTGCTTGAATCCAGGAGTTGAAGGTTACAGTGAACTGGGATTTAGCCACTAGACTCTAGCATAGCTGACAAAGCAAGAACCTATTTGTTTAAAACACAAAAAAGAA","TACTAATAATACAAAAATGAGCCGGGTATGGTGGCGGGTGCCTGTAATCCCAGCTACTGAGGAGGCTGAGGCAGGAGACTTGCTTGAACCCAGGAGGTAAAGGTTGCAGTGAGCTGAGATTGCACCACTACACTCCAGCCTGGGCGACAAGAGCAAAACTTTTTCTCCAAAAAAAAAAAAAAAAAA"
"GL873587","3278260","3278367","chr19","19044200","19044312","39","15765940","CAGTCTGAGCAAGAGGGAGAGGCTATTTCTACTAAAAACAGAAAAACTAGCTGGGTGTTGGGGTGTGTTCCTAGTCTCAGTTACTTGGGAGGCTGAAGTAAGAGGATC","ACCAGCCTGGCCAACACGGTGAAATCCCGTCTCTACTAAAAATACAAAAATTACCTAGGCGTGATGGCACGTGCCTGTAGTCCCAGCTACTCATAAGGCAGAGGTGAGAGAAT"
"GL873587","3278673","3278754","chr7","49412503","49412597","28","46133830","GGCCACGAGAGCTAGCTCATGCCTATTCTAGGAGGCCAAAGCAGGCAGACTGCCTGAGCTCAGGAGTTCAAGAGCAGCCTGG","GGCCAGGTGCAGTGGCTCATGCCTGTAATCCGAGCACTTTGAGAGGCCGAGGCAGGCAGATCACCTGAGGTCAGGAGTTCAAGACCAGCCTAGTA"
"GL873587","3782076","3782188","chr9","112128434","112128552","34","108346358","ACTGGGGTGGCTGAGGCAGGAGCGTCACTTGAACTCAGGAGTTTGAGATTGCTGTGAGCTGAGCAGATGTCATGGCACGCTAGCCTAGGTAATAGAGTGAGACTTCGTCTAAA","CAGCTACTCGGGAGGCTGAGGCAGGAGAATCACTTGAACTCGGGAGGCGGAGGTTGCAGTGAGCCGAGATCACGCCATTGCACTCCAGCCTGGGCAACAAGAGCGAAATTCCATCTCAA"
"GL873587","4564996","4565084","chr20","27900350","27900437","14","23335354","GGCGGGGTGTAGTGGCTCATGCCTATTGTCCCAGCACTGTGGGAGGCCGAGGTGGGTGGATCACCTGTGCTCAGAAGTTTGAGACCAGC","GGCCGGGCGTGGTGGCTCATGTCTGTAATCCCAGCACTTTGGGAGGCCGAGGTGGGTGGATCACCTGAGGTCAGGAGTTCAAGACCAG"
"GL873587","6307870","6308175","chr12","112427710","112428020","54","106119840","GGCCAGATATGATGGCTCATGCTTGTAATCCTAGCACTCTGGGAGGCTGAAGTGGGAGGATCACCTGAGATCAGGAGTTCAAGATCACCCTGAGCAAAAGTGAGATCCCATCTCTATTAAAAATAAAAAAATTATCCAGGCATGGTGGTGCAGTCCTTTAGTCCCAGCTACTTGGGAGGCTGAGGCAGGAGAATCTCTTGAACCCAGGAATTAGAGGTTACAGTGAGCTGTGATGATGCTACTGCACTCTAGCAGGATGACAGAGTGAGATACTCCGTGTCAAAAAAAAAAAAAAAAAAAGCAAAA","GGCTGGACATGGTGGTTCATGCTTGTAATCCGAGCACTTTGGGAGGCCAAGGCGGGTGGATCACCTGAGGTTGGGAGTTCGAGACCAGCCTGACCAACATGATGAAACCCCATCTCTACTAAAAATACAAAAAAATTAGCCAGGCATGGTGATGCACGCCTGTAATCCCAGCTACTTGGGAGGCTGAGGCAGGAGAATCACTTGAACCCAGGAGGCAGAGGTTACAGTGAGCCGAGATCATGCCATTGCACTCCAGCCTGGATGACAGAGTGAGCCTCTGTCTCAAAAAAAAAAAAAAAAAAAAAAAAAAA"
"GL873587","6484004","6484128","chr10","67341428","67341546","29","60857424","GACCAGGTTCTGTGGCTCATGCTTGTAATCCTAGCACTCTAGGAGGCCGGAAGAGGGTGGATTGATTGCCTGAGGTCAGGAGTTAGAGACCAGCCTGAGCAAGAGCTAGACCCTGTTTCTTTCTT","GGCTGGGTGTAGTGGCTCATGCCTGTAATCCCAGCACTTTAGGAGGCCAAGGTGGATGGATTGCCTGAGCTCAGGAGTTCGAGACCACCCTGGGCAACAAGCCAAAACCCTGTCTCTAC"
"GL873587","6484407","6484586","chr3","167196537","167196723","48","160712130","TAGACCCTGTTTCTAAAAAAAAAATAGCCAGGTGTTGAGGCAGGTACCTGTAGTCCCAGCTACCTGGGAGGGCTGAGGCAAGAGAATCGCTTGAACCCAAGAGTTTGAGGTTGCTGTGAGCTGAGATGCTATGGCACTCAACCGTGAGCTACAAAGTGAGACTCTGTCTCAAAAAAAAAA","AAAACCTGTCTCTGCTAAAAATACAAAAATTAGCCGGGTGTGGTGATGTGCGCCTGTAGTCCTAGCTACTTGGGAGGCTGAGGCAGGAGAATCACTTGAATCCAGGAGGTGGAGGTTGTAGTGAGTCGAGATCGTGCGACTGCACTCCAGCCTGGGTGACAGCGAGACTCTGTCTCAAAAAAAAAAA"
"GL873587","7466229","7466364","chr1","29437872","29437991","35","21971643","GGCCAGGCGTGGTGGCTCATGCCTGTAGTCCCAGCGCTATGGGAGGCCGAGGTGGGTGGATCACCTGTGCTCAGAGGTTCGAGACCAGCCAAGACCCCCCTGAGCCAAATGAGCCAGAGTGAGATCCCATCTCTAC","GGCCGGGCGTGGTGGCTCACGCCTGTAATCCCAACATTTTGGGAGGCCAAGGCGGGTGGATCACCTGAGGTCAGAAGTTCGAGACCAACCTGGCCAACATGGTGAAACCCCTGTCTCTAC"
"GL873588","1502535","1502718","chr1","34852429","34852590","60","33349894","GGTGCAGTGGCTCACACCTGTTGTCCCAGCGCTGTGGGAGGCCGAGGTGGGTGGATCACCTGTGCTCAGAGGTCGAGACCAGCTGAAGACCTGCCTGAGGCAGAGTGAGCCAGAGTGAGACCCCGTCTCTACTAGAACAACAACAAGACAGCCAGACCTTGTGATCCCAGCTACATGGGGGGCT","GCCAGGTGCAGTGGCTCACACCTGTAATCCCAGCACTTTGGGAGGCCGAGGCGGGCGGATCACCTGAGGTCAGGAGTTTGAGACCAGCTTGACCAACATGGAGAAACCCCGTCTCTACTAAAAATACAAAATTAGCCTGGTGTGGTGTCGCATGCCTGTAAT"
"GL873588","10189037","10189246","chr3","45604681","45604903","65","35415644","GCTGAGATGAGGAGACTCTGTCTCTATTAAAAATAGAAAAATTGGGTGGATGTTGTGGGTACTGTAGTTGCAGCCTCTTGGGGGGCTAAGGCAGGAGGATCAGTTGAAGCCAGGAATTTGCTTTGAGCTAGGCTAAAGCCATGGCACTCTAGCCTGGGCAACAGAGTGAGGCTAGATCTCAAAAAAAGAAAGAAAAGAAAAAGAAAAAAA","CTGGCCAACATGGCAAAACCCCATCTCTACTAAATATACAAAAATTAGCTGGACGTGGTGGCACATACCTGTAATCCCAGCTACTTGGAAGGCTGAGGCAGGAGAATAGCTTGAACCTGGGAGGCAGAGGTTGCAATGAGCTGAGATCACGCCACTGCACTCTAGCCTGGGCAATAGAATGAGACTCTGTCTCAAAAAAAAAAAAAAAAAAAAAGACAAGAAA"
"GL873589","104719","104807","chr20","27900350","27900437","13","27795631","GGCTGGGCGTGGTGGCTCATGCCTGTTGTCCCAGCGCTGTGGGAGGCTGAGGTGGGTGGATCACCTGTGCTCAGAGGTTCGAGACCAGC","GGCCGGGCGTGGTGGCTCATGTCTGTAATCCCAGCACTTTGGGAGGCCGAGGTGGGTGGATCACCTGAGGTCAGGAGTTCAAGACCAG"
"GL873589","796766","796905","chr1","166346372","166346487","49","165549606","GGCTAAGTGTGGTGGCTCACACCTGTCATCTAGTACTTTGGGAGGGTGGGCCTGGGAGTTCAAAGACTGAACTCAGGAGTTCAAGGTGGCTCCGGGGAGGAATTCAAGACCAACCTGAGCCAGAGCGAGACCTCGACTCT","GGCCAGTGGGGTGGCTCACGCCTGTAATCCCAGCACTTTGGGAGGCTGAGGTGGTCAAATGACCTGAGGTCAGGAGTTTGAGACCAACCTGGCCAACATGGTGACACCTCGTCTCT"
"GL873589","1023679","1023690","chr1","205890061","205890072","1","204866382","AAAAAAAAAAAA","ACAAAAAAAAAA"
"GL873589","1023771","1024047","chr4","103012712","103012993","70","101988941","GGCTTGGTGGCTCACACCTGTAATCCTAGCACTCTGGGAGGCCGAAGTGGCTGGAATACTTGAGGTCAGGAGTTCAAGACCAGCCTAAGTGAGAGTGAGATCCCCATCTCTAATAAAAATAGAAAAATTAGCAGGGTGTTGTGGCTGGCACTTGTAGTCCCAGCTACCCAGGAGACCGAGGCAGAAGTTTGAGATTATTGTGAGCGAGGCTGATGCCACAGCATTCTAGTGGGACAACAGAGCAAAATTCTATCTCAAAAGAAAAAAAAAAAAAGGA","CGGGCGTGATGGCTCACGCCTGTAATCCCAACACTTTGGGAAGCCGAGGCGGACGTATCACCTGAGGTCAGGAGTTCAAGACCAGCCTGGCCAACATGGTGAAACCCCGTCTCTACTAAAAATACAAAAATTAGCTGGGTGTGGTGGCATGCGCCTGTAATCCCAGCTACCCAGGAGGCTGAGGCAGGAGAATCGCTGAGGCTGCAGTGAACTGAAATTGTGCCACTGCACTCCAGCCTGGGTGACAGAGCAAGACTCTGTCTCAAAAAAAAAAAAAAAAAA"
"GL873589","4820958","4821024","chr8","33633747","33633811","15","28812789","TTAGTCAAGTGCAGTGGCTCACACCTGTCATCCCAGCTACTTGGGAGGCTGAGGCAGGAGAGTTGCT","TTAGCCAGGTGTGGTGGTGCATGCCTCTAATCCCAGCTACTCAGGAGGCTGAGGCAGGAGAATTG"
"GL873589","6763768","6763857","chrX","25814002","25814092","29","19050234","GGTGTGGTGGCTCACACTTGTATCTTAGCATTTTAGGAGGCTGAATGGGGAGAATTGCTTTAAGTCAGGAGTCTGACTTCCACCTTGCCA","GGCTGGGAATGGTGGCTCACACCTGTAATCCCAGCACTTTGGGAGGCTGAGGTGGGCAGATCACCTGAGGTCAGGAGTTTGAGATCAGCCT"
"GL873589","8444551","8444632","chr9","93194085","93194171","17","84749534","CGGGCATGGTGGCTCACAACTATAATCTTAGCACTTTGGGAGGCTGAGACAGGTGGATGCCTGAACTCAAGAGTTTGAAACC","GGCCGAGCATGGTGGCTCACACCTGTAATCCCAGCACTTTGGGAGGCTGAGGCAGGTGGATTACCTGAGGTCAAGAGTTCAAGACCA"
"GL873589","9085365","9085494","chr2","194063347","194063481","42","184977982","GGCCAGGCACAGTGGCTCACACCTATAATCCCAGCACTCTGTGAGACTGAGGCAGGTGAACTGTTGCAAGAGTGAGACCCTGTGCTTGGTGCCTGTAGCTCAGTGGTTAATAATAAGAAAAAAGAAAAAA","GGCCAGGTGCAGTGGCTCACACCTGTAATCCCAGCACTTTGGGAGTCTGAACCAGGCAGATCACCTGAGGTCAGGAGTTCGAGGCCAGCTCGGCCACCATGGTGAAACCCTGTTTCTAATAAGAATACAAAAAAA"
"GL873589","9085767","9086002","chr7","84631446","84631650","75","75545679","GAGTGAAACCCTGTCTCTACTAAAAATAGAAAAACTAGCTGTGCATCAGGGCGCATAACTGTAGTCCCAGGTACTCAGGACACTGAGGCAAGAGAATTGCTCAAGCCCAAGAGTTTGCAAGAATTTGAGGTTGCTATGAGCTATGATGCCATGGCACTCTACCTAGGGTGACAGACAGAGACTCTGTCCCAAAAAAAAAAAAAGAAGAAGAAGAAAAAAAAAAAGAAAGAAAGAAA","ATAGTGAAACCTCGTCTCTACTAAAAATACAAAAATTAGCTGGGCATCATGGTGCACGCTTGTAATTCCAGCTACTTGGGAGGCTGAGGCAGGAGAATTGCTTGAACTCAGGAGGTGGAGGTTGCAATGAGCCAAGATCGCGCCACTGCACACCAGCCTGGGTGACAAAAGACTCTGTCTCAAAAAAAAAAAAAAAAAAAAAAAA"
"GL873589","9992904","9993045","chr16","56427538","56427666","46","46434634","AACCAGCCAGGCATGGTGATTCACACCTATAATCCCAGCTACTTAGGAGTATGGCTTGAGCACACAGGATACCATACCATTCTAGTCATCCCAGGCAACAGAGGGAAACTCTGTTGGTTAAAAAAAAAGAAAAACTTAAAAA","TTAGCCAGGAGTGGTGGTGCACGCCTATAATCCCAGCTACTTGGGAGGCTGAGGCACAAGAATCACTTGAACCATTGCACTCCAGCCAGGGTGATAGAGGGAGACTCTATCCAAAAAAAAAACAAAAAA"
"GL873589","9993319","9993452","chr3","2774534","2774668","28","7218785","GGCCTGAGCCCTGTGACTCATGCCTGTAATCCCAGCACTGGAAGTTCCAAGGCAGGTGGATCGCTTGAGCTCTGGAGTTCAAGACCAGCTCAACCAAGAGTAAGACCCCATCTCTACTAAAAATAGAAAAACCA","GGCTGGGCACGGTGGCTCATGCCTGTAATCCCAGCACTTTGAGAGGCCGAGGCAGGTGGATCTCCTGAGGTCAGGAGTTCAAGACCAGCCTGGGCAACATGGTGAAACCCCATCTCTACTAAAAATACAAAAAAT"
"GL873590","9044589","9044884","chr1","83754525","83754835","84","74709936","GGCCAGGTGCAATGGCTCATGCCTATAATCCTCACACTCTGGGAGGCTGAGGCAGGAGGATCACTTTTCTCAGGGTCAGGGCCAGCCTGACAAAAGTCAGACCCTGTTTCTACTAAAAATAGAAAAACTAGCTGGGTGTTGTGGCAGATGCCTATAGTCCCAGCTACTAAGAGACTGAGACAAGTGCCCAGAGTCTGAGGTTACTGTGAGCAAAGCTGATGCCATAGCATTCTAGCTATAGATCGAGAGTCTGTCTCAAAAACAAACAAACAAACAAACAAACAAACAAAAAAGAA","GGCTGGGTGTGGTGGCTCATGCCTGTAATCCCAGCACTTTGGGAGGCCGAGGCGGGTGGATCATCTGAGGTCAGGAGTTCAAGACCAGCCTGACCAACATGGTGTAACCCTGTCTCAACTAAAAATACAAAAATTAGCTGGGCGTGGTGGTGTGCACCTATAGTCACAGCTACTTGGGAGGCTGAGACAGGAGAATTGCTTCAACCCAGGAAGTGGAGGTTGCAGTGAGCCAAGATCATGTCACTGCACTGCAGCCTGACAGAGCGAGACTCCATCTAAAACAAACAAACAAAAACAAACAAACAAACAAA"
"GL873591","1831505","1831587","chr17","61702818","61702899","25","59871313","CCCAGCACTTTGGGAGGGCAAGATGGGAGAATCATATAAAGTCAGGAGTTTGAGACCAGTTTGGCAGACATGATGAACCCATC","AATCCCAGCACTTTGGGAGGCTGAGGCAGGCGGATCATCTGAGGTCAGGAGTTCAAGACCAGCCTGGCCAACATGGTGAAAC"
"GL873591","2719175","2719275","chr4","86137755","86137847","32","83418580","GTGGGGGCTTAGGCCTGTAATCCCAGCACTCTGAGAGGCCAAGGTGAGCTGGTCACCTGGGTTTAGGAGTTTGGAGACTTGCTCGAGCTAGACTGAGGCTC","GTGGTGGCTCACGCCTGTAACCCTAACAATTTGGGAGGCCAAGGCAGGTGGATCACTTGAGGTCAGAAGTTTGAGACCAGCCTGGACAATATG"
"GL873591","4732974","4733120","chr19","7991801","7991954","55","3258827","ATACGCAGACTGGCCGAGCGTGGTGTCACATGCCTATAATCCCAGTGGCTACTCTGGGGAGGAGAATCTCTTGAAACCAAGAGTTAGAGATTGCAGTGGGGTATGATACAGGGTAACAAAGAGAGACCTTGGATCTGAAAAGAAAAA","AAAATACAGAAACTAGCTGGGCATGGTGATGCACACCTGTAATCCTAGCTACTGGGGAGGCTGAGGCAGGAGAATTGCTTGAACCCAGGAGTCAGAGGTTGCAGTGAGCAACCAGCCTGGGTGATACAGTGAGTGAGACTCTGTCTCGAAAAAA"
"GL873591","6822728","6823009","chr1","20579766","20580052","72","13757038","GGCCAGGCGTGGTGGCTCATGCCTGTAAATCTCAGCACTCTGGGAAGCTGAGGCAGGTGGATTGCTTGAGGTCAGGAGTTTGAGACCAGCCTGTACCAGAGTAAGACCCTGTCTCTAATAAAAATAGAAAAAAAAAAAAAAACTAGTTGGGCATGGTGATGGGTGCCTGTAGTCCCACCTACTTGGGAGGCTGAGGCAATGGCATCTCTTGAGCCCAAGAGTTTGAGGTTGCTGTGCCATGGCACTCTCCCCAGGGTAACAGAGTGAAAATAAAAAAAAGAA","GGCCAGGCGTGGTGACTCATGCCTGTAATCTCAGCACTTTGGGAGGCCGAGGCAGGTGAATCACCTGAGGTCAGGAGTTTGAGACCAGCCTGACCAACATGGTGAAACCTCGTCTCTACTAAAAATACAAAAAGTAGCCAGGCATGGTGGCGCATGCCTGTAATCCCAGCTACTTGGGAGGCTGAGGCAGGAGAATCGCTTGAACCCGAGAGGCAGAGGTTGCATTGAGTCAAGATGGTACCACTGCACTCCAGCCTGGGTGACAGATTGAGACTCAAAAAAAAAAA"
"GL873591","7578706","7578813","chr16","45055441","45055543","42","37476735","AAATTTAGCTACACATAGTGGCATGAGTCTGTAATGCTAGCCACCCAAAAGGCTGTAGTAAGAGGATTGCTCTATCCCAGGAGTTAAAGACCAGCCCGGACATCAGAG","AATTAGCCGGGCGTGGTGACACACACTTGTAATCCTAGATACTCAGGAGGCGAAGGTAGGAGAATTGCTTGAACCCAGGCAGCAGAGGTTGCAACGAGCAGAG"
"GL873591","9282916","9283004","chr1","20744253","20744338","16","11461337","GGCCAGGCGCGGTGGCTCACCCCTGTTGTCCCAGTTCTGTGGGAGGCCGAGGTGGGTGGATCACCTGTGCTCAGAGGTTTGAGACCAGC","GGCCAGGCACGGTGGCCACGCCTGTAATCCCAGCACTTTGGGAGGCCGAAGTGGGTGGATTACCTGAGGTCAAGAGTTTGAGACCA"
"GL873592","835155","835315","chr16","75654291","75654451","43","74819136","CTGGGTGTGGTGGCTCTTGTCTGCAATCTCAGTACACTGGGAGGCTGAGGCAGAAGGATTGCTCCAGCTCAGGAGTTTGAGGCCAGGCTGAGCTAGTGCAAAACCCCATCTCTACTAAAAAAAGAAGGAAAAAAAAAAGAAAAAGAAAAAAAATACGAGCT","CCAGGTGTGGTGACTCACGCCTGCAATCCCAGCACTCTGGGAGGCTGAGGTGGGTAGATTACCGGAGGTTAGGCGTTTGAGACCAGCCTGGCCAACATGGTGAAACCCCATCGCTACTAAAAAAAAAAAAAAAAAAAAAAAAAAAAAAAAAAAAAAAATTA"
"GL873592","835589","835765","chr1","66836166","66836336","48","66000577","ACAAAAAACCTAGCTTAGGGTTGTTATAGCACCTGTAGTCCCAGCTACTCAGGCGCTAAGGCAGGAAAATCTGCCTGAGCTCAGGAGTTTGAGGTTGCAGTAAGTTATGATGATGCTACTGCACTCTAGCTGGGGCAACAGAGTGAGACTCTGTCTGAGGAAAAACCAAAACCAAAA","TAGCCCAGCACGGTGGCTCACACCTGTAGTCTCAGCTACTCAAGAGGCTGAGGCATGAGAATCGCTTGAACCCAGGAGGTAGAGGTTGCAGTGAGCTGAGATCATGCCACTGCGCTCCAGCCTGGGCAACAGAGTGAGACTCAGTCTCAAAAAACAAAACAAAACAAAAAA"
"GL873592","2520661","2520705","chr16","66853217","66853257","11","64332556","TCTGGGAGGCTGAGGCGGGTGGATCACCTGAGCAAGAGTGAGACC","TTTGGGAGGCTGAGGCAGGTGGATCACTTGAGGTCAGGAGT"
"GL873592","4535248","4535388","chr1","12240468","12240612","38","7705220","GGCGGGATGTGGTGGTTCATGGCTGTAATCCCAGCACTCAGGGAGGCTGAGTCGGGTGGATTGCTTGAGTTCAGGAGTTTGAGACCAACCTGAGCAAGAACTAAGCCTGTCTCTACTAAAGATATTATTTCTTATTTTTCT","GGCCGGGCGCGGTGGCTCATGCCTGTAATCCCAGCACTTTGGGAGGCTGAGGCGGGTGGATCACCTGCGGTCAGGAGTTCGAGACCAGCCTGGCCAACGTGGTGAAACCTCATCTCTACTAAAAATATAAAAATTAGCTGGTGTG"
"GL873592","4535654","4535831","chr8","126054004","126054184","54","121518350","TCTACTACAAATATTAACAGAAAAATTAGCTGGGCATTGTGACAGGTGCCTATAGTCCCAGATACTCAGAAGGCTGAAGTAAGAGGATCACTTGAACCCCAGGAGCTAAGGTGGCTGTGAGCTAGGCTGAGGCTCTAGCCTGGGTAACAGAGTGAGACTGTAAAAAAAGAAAGAGAGA","GTCTCTACTAAAAATACAAAAATTAGCTGGGTGTGGTGGTGCATGCCTGTAATCCCAGCTACTCAGGAGGCTGAGGCAGGAGAATCGCTTGAACCCAGGAGGTAGAGGTTGCAGTGAGCCAAGATCATGCCACTGCACTCCAGCCTGGGTGACAGAGGGAGACTCTGTCTCAATAAATAAA"
"GL873592","6794968","6795049","chr3","154764711","154764794","20","147969743","GAAGGTTTGATGAGCTCAGATGATGCCACTGCAGTCTACCCAGAGTGAAGGAGCGAGACTCTGTCTCAAAAACAAAAAAAGA","CAGAGGTTGGCAGTGAGCTGAGACTGTGCCACTGCACTCCAGCCGGGTGACAGAGTGAGACTCTGTCTCAAATTACAAACAAAA"
"GL873592","6881384","6881478","chr5","24882384","24882475","28","18001000","GGGCAGGCATAGTGACTGGTGTCTCTAATCCTAGCAGTCTGGGATGCTGAGGCAAGTGGAATGTCAGAGTTCAGGAGTTGAAGATCACCCTGACT","GGCCGGGCGCAGTGGCTCACATCTATAATCCTAGCATTTTGGGAGGCTGAGGCAGGCGGATCACCTGAAGTCAGGAGTTTAAGACCAGCCTG"
"GL873592","6881755","6881937","chr10","61601371","61601572","66","54719616","TCACCCTGACCAAGAGCAAGACCCTGTCTCTACTAAAAATAGAATAAACTAGCTGGGAATTGTGGTGGGTGCCAGTAGTCCCCGCTACTGAGGCAGGAGGATCATTGAGTCCAAGAGTTTGAGGTTGCTGTAAGTTAGGACACCACAGCACTCTACACAGAGTAAGACTGCCTCAAAAATAAA","AGTAAAGAAAAGAAACCCTGTCTCTACTAAAAATACAAAAATTAGCTGGGTGTGGTGGTGCGCACCTGTAGTCCCAGCTACTTGGGAGGGTGAGGTATGGGAATCACTTGAACCCGGGAGGTGGAGGTTGCAGTGAGCCAAGATCACACCACTGCACTCCAGCCTGGGTGAGAGAGTGAGACTCTGTCTCAAGAAAAAAGAA"
"GL873592","7006080","7006155","chr1","8947061","8947129","24","1940981","CACACTGAGAGGCAAAGGCTGGTGGATCACCTGAGCTCAAGAGTTTGAGACCAGCCAAGCCAGAGATCTTGTCTCT","CACTTTGGAGCCAGGTAGGTGATCACCTGAGTCAGGAGTTCGAGACAGCCTGGCCAACATGTGAAACCC"
"GL873592","8446508","8446655","chr11","122502739","122502874","48","114056231","TTAGCTGGGTGTTGTGGCAGGCACCTGTAGTCCCTCCCAGCTACTTGAAAGGCTGAGGCAAGATGACAGCTTAAACCCAAGAGTTTAAGGTTACTCTATTCAGGGCAACAGAGTGAGACTCCATCTACATAAATAAATAAATAAATAA","GGCTGGGCGTGGTGGTTCACACCTGTAATCCCAACACTTTGGGAGGCTGAGGCCAGCGGATTGCCTGAGCCCAGGAGTTTGAGACCAACCTGGGCAACATGGTGAAACTCCATCTCTACTAAAATACAAAAAGTTA"
"GL873592","8446953","8447008","chr16","44513352","44513404","15","36066399","GACCAGCCTAAGCAAAAAAGAGATCCTATCTCTACTACTAAAAATAGAAAAAATTA","ACCAGCCTCACCAATATGAAGAAACCCCATCTCTACTAAAAATACAAAATATT"
"GL873592","8447239","8447325","chr1","8062863","8062957","21","384376","GGCCAGGAGCAGTGACTCATGCCTAGCACTCTGGGAGGCCAAAGCAGGTGGATCAACTGAGCTCAGGAGTTCAAGACCAGCCTAAGC","GGCCGGGTGCAGTGGCTCATGCCTGTAGTCCCAGGACTTTGGCAGGCCAAGGCCGGTGGATTACCTGAGGTCAGGAGTTCAAAACCAGCCTAGCC"
"GL873592","8723925","8724000","chr3","42066983","42067054","20","33343058","AATTAGCCGGGCATGGTAGTGTGTGCCCATAATCTCAGCTACTCAGAAAGCTAAGATAGGAAAATTGCTTGAGCTC","TTAGCTGGGTGTGGTAGTGCATGCCTATAATCCCAGCTACTCGGGAGGCTGAGGTGGGAGAACTGCTTGAAC"
"GL873593","384022","384146","chr15","102382935","102383070","28","101998913","GGCCACGAGGGCCCATGCCTGTAATCCTAGCACTCTGGGAGGCTGAGGTGAGTAGATTGCTGAGCTCAGGAGTTCAAGACCAGCCTGTGCAAGAGACCCCATCTCTGCTAAAAATAGAAAAACCA","GGCCAGGTGTGGTGGCTCACGCCTGTAATCCTAGCACTTTGGGAGGCTGAGGCGGGTGGATTGCCTGAACTCAGGAGGTCAAGACCAGCCTGGGCAACACAGTAAAACCCCATCTCTACTAAAATACAAAAAATCA"
"GL873593","384425","384607","chr20","28286874","28287058","50","27902449","GAAAGAAAAGAAAAGAAAAACTAGCAAGATGTTGTAGCTGATGCCTATAATCCTAGCTATTGGAGAGGTGGAGGCAAGAGAATTGCGTGAGCCCAAGAGTTGAAGGTTGCTGTGAGCTGCGATGCCAGAGCACTCCAGGGTGACAGAGTAAGACTCTGTCTCAAAAAAAATTACAAAATAAAA","TAATAAAAATAAAAAAATTAGCCAGGAGTCAAAGCACACGCCTATAACCCCAGCTACTTGGGAGGCTGAGGGAGGAGAATTACTTGAACCCGGGAGGTGAAAGTTGCAATGAGCTGAGATCAAGCCACTGCACTCCAGACTGGATGACAGAGTGAGACTCTGTTTCAAAAAAAAAAAAAAGACAA"
"GL873593","1408445","1408467","chr10","88070368","88070389","9","86661923","AATCTAGAGATGGGGAGAGGTTG","AAAGAGATGGAAGAGAAGAAGA"
"GL873593","4856365","4856484","chr7","56497314","56497433","31","51640949","GCAATCCCAGCTGATCGGGAGGCTGACCCAGAAGAATCCCTTGAACCCAAGAGTCTGAGGTTGCTATGGGTGGATTCTACAGCACTCTAGCCTGGGAGACAGAGTGAGACTCTGTCCCAA","ATCCCAGCTACTTGGGAGGCTGAGACAGAAGAATTGCTTGAACCCGGGAGGTGGAGGTTGCAGTGAGCCAAGATTGTACCACTGCACTCCAGCCTGGCAACAGAGTGAGACTCTGTCTCA"
"GL873593","6661298","6661485","chr10","86749316","86749514","55","80088018","GCAGAGGCTCACATATGTAATCCTAGCACTCTGGGAGGATAAGGCAGGTGGACAGCTTGAGCTCAGGGGTTTGACCAGTCTGATCAAGAGCAAGACCTGTGTCTACTAAAAATAGAAAACCTAGCCAGGTATGATGGTAGATGCCTGTATTCCTAGCTACTCTGGAAGCTAAAGCTAAAGAGTTTGAA","GGTGGCTCACACCTGTAATCTTAGCAATTTGGGAGGCCGAGGTGGGTGGATCACTTGAGGTCAGGAGTTTGAGACCAGACTGGCCAACATGGTGAAACTCTGTCTCTACTAAAAATACAAAAATTAGCCAGTCATGGTGGTGCATGCCTGTAATCCCAGCTACTCAGGAAGCTTAGGCAGGAGAATCACTTGAACCCAG"
"GL873593","6710263","6710446","chr14","4390080","4390244","66","2320183","TTGAAGTCAGGAGTTTAAGGCCAGTCTGGGCAACATAGTGAGACCCCCATCTCTACGAAAATATTTTTTAAAAATTAAAAATAGCTGGGCATAGTGAGGCTGTTGTGAGCTATAACTGCACCACTGCACTCAGCCAAGGACAGAGACCCTGTTCCCTGCCTCAAACAAACCAAAACAAAACAAA","AAGTCTAGAGTTTACAGCCTGGACAACGCAGTGAAACCCTGTCTCTACCAAAAATACAAAAATTAGACAGGTGTGAGAGGCGGAGGTTGCAATGAGCTGAGATCGCAGCACTGCAGTCCAGCCTGGATGACAGAGCGAGACCCCATCTCAAAAACAAAAACAAAA"
"GL873593","7159645","7159716","chr6","178318394","178318465","21","171158749","GATCATGTCACTGCTCTCCAACCTGGGCAATTGAGCAGGAATCTGTCTCAAAAAGAAAAAAAAAAAAGAAAA","CGAGTTCACACCACTGCACCCCAGCCTGGGCAACAGAATGAGACTCGGTTTCAAAAAAAAAAAAAAAAAAAA"
"GL873593","7159841","7160050","chr13","33368171","33368368","69","26208330","GGCCAGGCGTGGTGGCTCACACCTGTTGTCCCAGTGCTGTGGGAAGCCGAGGCAGGTGGATCACCTGAGCTCAGCCGAGTTCGAGACCAGTGGAAGACCAGCATGAGGCAGAGTGAGCCAGAGTGAGACCCCATCTCTACAACAACAACAAGAAGAAAAAAAACAGCCGGACCTTGTGATCCCAGCTACGTGGGGAGCTAGAGAATCACT","GGCTAGGCATGGTGGCTCATGCCAGTAATCCCACCACTTTGGGAGGCCGAGGCAGGTGGATCACCTGAGGTCAGGAGTTCAAGACCAGGCTGGCCAACATGTTATGATGAGACCCTCATCTCTACTACAAATACAAAAATCAGCTGGGCATGGTGGCAAGTGCCTGTAATCCCAGCTACTTGGGAGGCTGAGGCAGAA"
"GL873593","8598292","8598391","chr11","118461023","118461129","33","109862731","AGCCAGGTGAGGTGGTTCACACCTGTAACCCTAGCTGCTTGGGAGGCTGAGGCCTCTCTATCCTGGGCAGTGTGGAGAAACTTTGTTTCAAAAAAAAGAA","GCCGGGCGCGGTGGCTCACGTCTGTAATCCCAGCGCTTTGGGAAGCCGAGGCGGGACTATCCTGGCCAACATGGTGAAACCCCGTCTCTACTAAAAATACAAGAATC"
"GL873594","357249","357377","chr2","75702890","75703011","36","75345641","CCTGGTACCGTAGGTCATGCCTGTAATCCTAGCACTTTGGGATGCTGAGGTGGGCAGATTGCCTGAGCTCACGAGTTCAAGCCATTAGAACTGAGCCTGACCTAGAGTGGGACCTCCAACTCTTTTTTT","GCCAGGCACAGTGGCTCATGCCTGTAATCCCAGCAGTTTGGGAGGCTGAGGTGGGCAGATCACTTGAGGTCAGGAGTTCAAGACCAGCCTGGCTGACATGGTGAAACCCCATCTATACCAAA"
"GL873594","357656","357834","chr7","17608776","17608965","55","17251120","GGGACCTCCAACTCTTAAAATAGCTGGGCATTGTGGTGGGCACCTACAGTCACAGCTACTTGGGAGGCTAAGGCAAGAGACTTGTTTGCAGCCAAGAGTTAGAGGTTGCTGTGAGCTATGAGGCTAGGGCACTCTACAGGGGGCGACAAGTGAGACTGTAAAAAAAAAAAAAGAAAAAA","GTCCCTACTAAAAATACAAAAAATTAGCTGGGCCTGGTGGCAGGCACCTGTAATCCCAGCTACTTGGGAAGCTGAGGCAAGAGAATTGCTTGAACCCAGGAGGCAGAGGTTGCAGTGAGCTGACATCAAGCCACTGTACTCCAGCCTAGGCAACAAGAGCAAGACTCTGTCTCAAAAAAAAAAAAAAAAA"
"GL873594","1410711","1410996","chr5","151340503","151340797","76","149929792","CACAGTGGCTCATACCTATAATCCTAACACTCTGGGAGGCCAAGGTGGGTGGACTGTCTGAGTTTGGGACCAGCCTGAGCAAAAGCAAGACTCCCATCTCTACTAAAAACAAAGACAGCCAGGTATGAGGGCAGGTGCCTATCATCCCAGCTACTTGGGAGGCTGAGGAAGGAGGATCACCTAAGCCCAGGACTTTAAGGTTTCTGTGAACTAAGATGATGTTACAACACTCTAGCCAGGGTAACAAGGCAAGATTCTGTTTCAAAAGACAAAAAAAAAAAAAAAA","GGTGGTTCATGCCTGTAATCCCAGCACTTTGGGAGGCTGAGGCAGGTGGATCACCTGAGGTCAGGAGTTCGGGACCAGCCTGGCCAACATGGGGAAACCCCATCTCTACTAAAATACAAAAATTAGCCAGGTATGGTGGCACATGCCTATAATCCCAGCTACTTGGGAGGCTGAGGCAGGAGAATCACTTGAACCCAGGAGGCTAAGGTTGCAGTGAGCCGAGATTGTGCCACTGTACTCCAGCCTGGGTGACAGACTGAAACTCTGTGTCCAAAAAACAAAACAAAACAAAAAA"
"GL873594","5528090","5528162","chr2","69013639","69013718","24","63485549","GGTACAGTGGCTCACGCTTGTGATCCCAGGTTGAGGTGGGTGGATCGCCTGAGCTCAGGAGTTGGATGCCAGC","GGTGTGGTGCCTCACGCCTATAATCCCAGCACTTTGGGAGGCAGGTGGATCACTTGAGGTCAGGAGTTTGAGAACAGCCT"
"GL873594","5834047","5834168","chr2","82491537","82491662","28","76657490","GGCTGGGCCCAGTAGCTCACGACTGTAATCCCAGCACTCTGGGAAGCTGAGGTGGGCGGATCACCTGAGCTCATAGGTTCGAGACCAGCTCCAGTTAGAGTGAGAGCCTGTCTCTAAAAATA","GGCTGGGCACAGTGGCTCATGCCTGCAATCCCAGCACTTTGGGAGGCTGAGGTGGGCAGATCACCTGAAGTCAGGAGTTCAAGACCAGCCTGGCCAACACAGTGAAACCCCATCTCTACTAAAAAT"
"GL873594","5834396","5834461","chr13","14688151","14688212","20","8853755","TATATAATAATAATAACCAGGTATTGTGGCAGGTGCCTCTAGTCCCAGCTACTCGGGAGGCAAAGG","ATAAAAAAATTAGCTGGCCATGGTGGCACATACCAATAATCCCAGCTACTCAGGAGGCTGAG"
"GL873594","7786130","7786294","chr14","12217087","12217250","37","4430957","GGGTGTGCTGGCTCATACCTATAATCCTAGCACTCTGGGAGGCTGAGGTAGGTGTATTGCTTGAACCCAGGAGTCTGAGGTTGCTGTGCGCTAAGCTGATACCATAGCACTCTAGCCTGGGCAACAGAGTGAGACTCTGTCTCAAAACAAATAAATAGTAAAAAA","GCTGGGCGTGGTGGCTCACACCTGTAATCCCAGCACTTTGGGAGGCCAAGGCATGAGAATTGCTTGAAAACAGGAGGCGGAGGTTGCAGTAAGCTGAGACTGTGCCATTGCACTCCAGCCTGGGCAACAAGAGTGAAACTCTGTCTCAGAAAAAAAGAAAAAAA"
"GL873595","723579","723774","chr19","6045933","6046125","65","5322354","GCCTGAGCAGGAGAGAGACCCCATCTCTGCTGAAAGTGGAAAAGTTGGCTGAGTGTAGTGGCGGGCTGCTGCCCCAGTCACTCAGGAGGCTTAGGAAGGAGTATCGCTTGGGCCCAAGATTTGAGGTTGCTGTGAGCGCTACAAAGACATTAGGGTACTCTACACAGGGGAATAGAGTGAGACTGTCTCAAAAAAA","CAACATGGAGAAACCCCGTCTCTACTAAAAATACAAAATTAGGCAGCGTGGTGGTGGGTGCCTATAATCCCAGCTACTCAGGAGGCTGAGGCAGGAGAATCGCTTGACCGGGAGTGGAGGTTGCGGTGAGCTGAGATTGCACCATTGCACTCCAGCCTGGGCAACAAGAGTGAAACTCCGTCTCAAAAAGAAA"
"GL873595","724114","724204","chr20","18199749","18199840","22","17475635","GGCCATGCTTGGTGGTTCTCATCTGTAATCCTAGCACTCTGGAAGGTCTACAGGGGTGGATGGCTGGAGGTCAGGAGTTCAAGACTGGCCT","GGCCGGGCATGGTGGCTCACACCTGTAATCCCAGCACTTTGGGAGGCTGAGGCAGGCGGATCACCTGAGGTCAGGAGTTCGAGACCGGCCTG"
"GL873595","1065346","1065667","chr18","10529729","10530057","74","9464383","GGCCAGGTGCAGCAGCTCATGCCTGGAATCTTCCTGCTCTGTATGGCCAAGGCAGGTGGATCGCCTGACCTCAGGAGTTCCAGACCAGCCTGAACAAGAGCAAGACTCTGTCTCTACTAAAAGTAGAAAAAAAACTAGCCAGTCATAGTGGCAGGTGCCTGTAGTCCCAGCTGCTTGGGAGGCTGAGGCAAGAGGATCACTTGAACCTAAGAGTTTGAGGTTGCTGTGAGCTAAGATGCCACATCACTCTATCAAGGGTGACCAAGTGAGACTCTGTCTCAAAAATAAATAAATAAATAAATAAAAAGAAAGGCAAAAAGAA","GGCCCGGCGTGGTGGCTCATGCCTATAATCCCAGCCCTTTGGGAGGCCAAGGCAGGTGGATCACCTGAGGTCAGGCGTTCGAGACCAGCCTGACCAACGTGGTGAAACCTCATCTCTACTAAATACAAAAAAAATTTAGCCAGGCATGGAGGCACATGCCTGTAATCCCAGCTACTTGGGAGGCTGTGGCAGGAGAATCACTTGAACCTGGGAGGTGGAAGTTGCAGTGAGCTGAGATTGTACCACTGCACTCCAACCTGGGTGACAAAGCAAGACTCGGTCTCAATAAATAAATAAATAAATAAATAAATAAATAAAGTGAAAAAAAA"
"GL873595","1254878","1255146","chr4","42822326","42822607","67","41567448","GGCTGGGCATGGTGGCTCATGCCTGTAATCCTACCGCTCTGGGAGGCTGAGGCAGAGGATCACTTGAGCTCAGGAGTTTCAGACCAGCCTGCAAGAAGGACCCAGTCTCTGCCGAAAATAGAAAAGTTAGCAAGGCGTTGTCGTGAGCACATGTATCCCAGCTACCTAGAACTCTGAGGCAGGAGGATCCCTTGAACCCACAGAAGTTGCTGTTATCTAAACTGATGCCACTGGACTCTAGCCTGGGCAACAGAGTGAGACTGGTCTCA","GGCCGGGCACGGTGGCTCATGCCTGTAATCCTAGCATTTTGGGAGGCTGAGACAGGCAGATTGCCTGAGCTCAGGAGTTCAAGACCAGCCTGGGCTAGATTGTGAAACCCCATCTCTACTAAAATATAAAAATTAGCTGGGTGTGGTGGCACACGCCTGTAATCCCAGCTACCTGGGAGGCTGAGGCAGGAGAATCGCTTGAACCAGGAGACAGAGGTTGCAGTGAGCTGAGATCACGCCACTGCACTTTAGCCTGGGCAACAGAGTGATACTCTGTCTCAA"
"GL873595","3417105","3417297","chr12","115674238","115674427","44","112257133","GGCCGGGCGCTGTGCCTCACGCCTGTAATCCTAATACTCTGAGAGGCCGAGGCAGGTGGATTGCCTGAGCTCAGGTGCTCAAGACAGCCTGACTGAGCAAGCCCTGAGATCCCATCTCCACTAACAATAGTAAAACTAGCCGGGCATTGTGGTGGTGCTTGTAATCCCAGCTACTGGGAGGCTAAGACAGGAG","CCAGGCCTGGTGGCTCACGCCTGTAATCCCAGCACTTTGGGAGGCCGAGGTGGGTAGATCACCTGAGGTCAGGAGTTCAAGACCAGCCTGGCCAACATGGCGAAACCCCATCTCTACTAAAAATACAAAAATTAGCTGGGCATGGTGGTGTATGCCTGTAATCCCAGCTACTCGGGAGGCTGAGGCAGGA"
"GL873595","6098380","6098457","chr3","87492619","87492702","21","81394239","GCTGTGGCTCATGCTGATAATACCAGCACTCTGGGAGAACAAGGTAGGCAGATCACAAGAGGTCACCTGTGCAAGACC","GGGCTGGTGGTGGCTCATGCCTGTAATACCAGCACTTTGGGAGGCCAAGACAGGTGGATCACCAAAGGTCAAGAGTTCAAGACC"
"GL873596","134190","134307","chr1","203207333","203207443","31","203073143","GGCTGGGCGAGGTGGCTCACACCTGTAATCCTAGCACTCTGGAAGGCCCTAGCACTCAGGCAGTTGGATTGCCTGAGCTCACAAGTTCAAGACCAGCCTGAAAAAGAGCAAGACCTCA","GGCTGGGTGCAGTGGCTCACACCTGTAATCCCAGCACTTTGGGAGGCCGAGATGGGTGGATCACTTGAGGTCAAGAGTTGAAGACCAGCCTGGACAACATGATGAGACCCC"
"GL873596","134578","134681","chr11","50235285","50235387","37","50100707","CAAACAAAAGAGGAAGACCTCGTCTCTAAAAAAATAGCTGGGCATTGTGAGGAGTACCTGTAGTCCTAGCTACTCAGAAGGCTGAGACAAGAGAATCACTTAAA","CAACATTGTGAAACCCTGTCTCTACTAAAATAGAAAATTAGCCAGGTGTGTGGGCGTGCCTATAATCCTAGCTACTGGGGAGGGTGAGGCATGAGAATCGCCT"
"GL873596","8160215","8160350","chr1","29437872","29437991","30","21277657","GGCCGGGCGTGGTGGCGCACACCTGTAGTCCCAGCGCTATGGGAGGCCGAGGCGGGTGGATCACCTGAGCTCAGAGGTTCGAGACCAGCCAAGACCCCCCTGAGCCAAACGAGCCAGAGTGAGACCCCGTCTCTAC","GGCCGGGCGTGGTGGCTCACGCCTGTAATCCCAACATTTTGGGAGGCCAAGGCGGGTGGATCACCTGAGGTCAGAAGTTCGAGACCAACCTGGCCAACATGGTGAAACCCCTGTCTCTAC"
"GL873596","8421071","8421132","chr20","1874027","1874093","12","6547044","GTCAGGCGCAGTGGCTCACGCCTGTAATCTCAGCACTCTGAGAAGCCAAGGCAGGATCATCT","GGCCAGGCGCAGTGGCTCAGGCCTGTAATCCCAGCACTTTGGGAAGCCAAGGTGAGCAGATCACCTG"
"GL873598","4416400","4416489","chr5","39418145","39418231","15","35001745","GGCCAAGTGTGGTGGCTCATGCCTGTTGTCCCAGCACCGTGGGAGGCCGAGGCTGGTGGAACACCTGAGCTCAGCTGAGTTTGAGACCAG","GGCCAGTTGCGGTGGCTCATGCCTGTAATCCCAGCACTTTGGCAGGCTGAGGCAGGTGGATCACCTGAGGTCAGGAGTTTGAGACCA"
"GL873598","4416855","4416947","chr3","94091253","94091337","31","89674398","GTGAGACCCTGTCTCTACAAAAAAAAAAGCTGGGCACTGTGGCATGTGCCTGTAATCCCAGCTACTTGGGAGGCAAAGGGAAAGAGAATCACT","AAACCTTGCCTTTACTAGAAATACAAAAATTAGCTGGGCATGGTGGCAGGTACCTGTAATCCCAGCTACTTGGGAGGCTGAGGCA"
"GL873598","5126074","5126161","chr1","12339306","12339394","19","7213232","GCCTGGTGCACTGGTTCACACCTGGAATCCTTGCATTCTGAGAGGCCCAGGTAGGCAGATCACCTCAGCTCAGAAGTTCGAGACCAGC","GCTGGGTGCGGTGGTTCACGTCTGTAATCCCAGCACTTTGGGAGGCCGAGGCGGGCAGATCACCTGAGGTCAGGAGTTCGAGACCAGCC"
"GL873598","5467584","5467662","chr1","9313328","9313403","17","3845744","GCGAGGTGGCTCACGCCTGTAATCCCAGCACATTTGGAAGGCCAAGGAGGGTGGATCACCCGAGCTCACCAGTTGGAGA","CGCAGTGGCTCACGCCTGTAATCCCAGCACTTTGGGAGGCCGAGGCAGGCAGATCACCTGAAGTCAGGAGTTTGAG"
"GL873598","6917752","6917856","chr14","9558287","9558382","22","2640535","GGCCAGGCATGGTGGCTTGTGCCTGTTGTCCCAGCACTGTGGAAGGCCGAGGCGGGTGGATCGCCTGAGCTCAGCTGAATTCGAGACCAGCATAAGACCAGTATG","GGCCAGGCATGGTGGCTTATGCCTGTAATCCCAGCACCTTGGAAGGCCGAAGCGGGCAGATCACCTGAGCTCAGGAGTTTGAGACCAGCCTGTCCA"
"GL873598","8078910","8079062","chr7","164825511","164825660","43","156746601","AACAGCCAGGCATTGTGGTGGGCACCTGTAATCCCAGCTACTTGGGAGGCTGAGGCAAGAGAATTGCTTGAGCCCAACAGTCTCAGGTTACTGTGAGTTATGACACCATGGCACTCTATTGAGGGCAAGAAAGTGAGACTGTCTTGGAAAAAA","CTAGCCAGGCATGGTGGTGCGCACCTGTAGTCCCAGTTACTTGGGAGGTTGAGGCAAGAGAATTGCTTGAGCCTGGAAGGCAGAAGTTGCAGTGAGCTGAGATCACACCACTGCATTCCAGCCTGGGCGAAAGAGCAAGACTCTGTTGAA"
"GL873598","8079328","8079454","chr6","10381248","10381379","32","2301920","GCCCGGCGTGGTGGCTCACGCCTGTAATTCCAGCACTCTGGGGAGGCCGAGGAGGGCAGATTGCCTGAGCTCACAGGTTTGAGCTAGAGCGAGACCCTGTCTCTTAAAAAGAAAAAAAAGGAAAGAA","GCTGGGCGCGGTGGCTCACGCCTGTAATCCCAACACTTTGGGAGGCCGAGGCGGGCAGATCACCAGAGGTGATCTCCAGCCTGGGCAGGAGAGCAAGACCCTGTCTCAAAAAATTTAGAAAAAGGAAAGAAA"
"GL873599","3943256","3943456","chr9","35892110","35892312","79","31948854","GGCAGGCTGCTTTGACCCATATCTACAACTCCAGAACTTTAGAGGCTGAGCTGGGTGGGTCCCTTGAGATTAGAAACTGCTTAGTAGCCTGGCAAAAACCAGACCCCACCTCCACCATGTAGAAAAATTAGCAGTATGCCATAGTGGGAACCTACCAATACAGTCTTTCCAAAGGCCAAAGCTAGAAGGACCGTGAGCTTG","GGCTGGGTGTGGTGGCTCATGCCTATAATTCCAGCACTTTGGGAGGCCGAGGCAGGTGGATCACCTGAGGCCAGGAGTTTGAGACCAGCCTGGCCAATATGGTGAAACCCCATCTCTACTAAAAGTACAGAAAATTAGTCAGTCATGATGGCGCATGCCTATAATCCCAGTTACTCGGGAGGCTAAGGTAGGAGAATTGCTTG"
"GL873599","6693284","6693349","chr1","100916857","100916922","15","94223573","TCACGTCTATAATCCTAGCACTCTGGGAGTCCTTGGCAGGTGGATCACCTGAGCTCAGGAGTTTGA","CATGCCTGTAATCCCAGCACCTTGGGAGGCCAAGGTGGGTGGATCACCTGAGGTCAGTAGTTTGAG"
"GL873600","991618","991705","chr15","13850109","13850195","15","12858491","GGCTGGGCGTGGTGGCTCACACCTGTTGTCCCAGCGCTGTGGGAGGCTGAGGCAGGTGGATCACCTGTGCTCAGAGGTTGAGACCAGC","GCCGGGCGCTGTGGCTCACACTTGTAATCCCAGCACTTTGGGAGGCTGAGGCAGGTGGATCACCTGAGGTCAGGAGTTAGAGACCAG"
"GL873600","8825981","8826014","chr16","43605817","43605844","11","34779836","AGTCTGGGGCAACAGAGCAAGACTCTGTCTCAAA","CAGTCTGGGTGACAGAGCAAGATTCCAT"
"GL873600","8826039","8826157","chr13","87428402","87428520","35","78602363","ATTAGCCTGGTGTGGTGGTATATGCCTTCCTGCCTGCTTGGGAGGCTGAGGCAGGAAGTATGCTTTAACTGTGGAGTCTGAGGTTGCTATGAGCTAGGTTGAGGCCATGGCACTCTAAA","TTAGCCGGGTGTGGTGGTGCACGCCTGTAATCCCAGCTACTCAGGAGGCTGAAGCAGGAGAGTTGCTTGAACCCAGGAGTTGGAGGTTGCAGTGAGCTGAGATCACGCCATTGCACTCC"
"GL873601","269289","269338","chr14","49279240","49279285","14","49009951","GACTGGGTGTGGTGGCTCACACCTTTAATCCTAACACCCTGGGAGGCTTA","GGCTGAGATGGTGGCACACACCTGTAATCCCAGCTACTTGGGAGGC"
"GL873601","269431","269678","chr1","184453273","184453521","76","184183842","AGAAGATCACTCAAGATCAGGAGTTTGAGAACAGCCTGAGCAAGACCCCCATCTTTACTAAAAATGGAAAAGTTTTTACCCAGGCATGGTAGTGCGTGCCTGTATCCCATCTACTCCGGAGGCTGATAGGAGGATTGCTTCAACCAAGGAGTTTGAGGTTCCAGAGACTTAAGATGACACAACTGCATTTTACCCAGTGTGACACAGCGAGACTCTTTCAGAAGAATTTTTAAAAGGAAAAAAAAGAA","GGTCAGATCACCTGAGGTCAGGAGTTTGAGACCAGCCTGACCAACATGGTAAAACCCCATCTCTGCTAAAAATACAAAAAATTAGCCAGGCATGGTGGTGAACGCCTGTAATCCTAGCTACTCAGGAGGCAAAGACAGGAGAATCGCTTGAATCTGGAAGGTGGAGGTTGCAATGAGCCAAGATGACGCCACTGCACTCCAACCTGGGTGACAGAGGAAGACTCCATCAAAAAAAAAAAAAAAAAAAAA"
"GL873601","1397978","1398117","chr16","24839455","24839591","34","23441477","GCCTATAATCCTAGCACTCTGGAAGGCTGAGGCAGGAAGATCACTAGAGCTTGGGAGTTTGAGATTGCTGTGAGGGAGACTGACTCCATGGCACTCTAGCCTGAGGCAACAGAGTAAGACTCCATCTCAAAAAAAAAAAA","CTCTAACTCCAGCTACTCAGGAGGCTGAAGCAGGAAAATCACTTGAACCTGGGAGGTGGAGGTTACAGTGAGCCAAGATCACACCATTGCACTCCAGCCTGAGCGACAGAGCGAGACTCTGTCTCAAAATAAATAAA"
"GL873601","4065502","4065590","chr11","108711352","108711444","19","104645850","GCTGGATGTGGTGGCTCTCACCTATAATCCTAGCACTCTGGGAGGTCAAAACAGGTGGATCACCTGAGCTCAGGAGCAAGAACACCAGC","GTCAGGGGTGGTGGCTCACGCCTGTAATCCCAGCACTTTGGGAGGCCAAGGCAGGTGGATCGCCTGAGCTCAGGAGTTCAAGACCAGCCTTGC"
"GL873601","8241370","8241465","chrY","9469734","9469829","34","1228364","AAAAAAGGTGGAGATGAGCCATGCGCAGTGGTGTAGGCCTGTAATCCCAGCCCTTGGGAGGCCAAAATGGTGGATTGCCTGAAGCAGAGCAAGACC","AAAGTACAAAGAGTCTGGGTACAGTGGCCCAAGCCTGTAATCCCAGCAGTTTGGGAGGACAAGATGGGTAGATCACCTGACATCATGAATTAGAGA"
"GL873569","7519122","7519191","chrX","79016364","79016431","16","71497242","TTGGCCAGGCATGGTCGCTCAGGCTGTAATACCAGCTACTTGGGAAGCTGAAGCAGGAGGATCACTTGAA","TTGGCCAGGCACGGTGGCTCATGCTTATAATCCCAGCTACTCGTGAGGCTGAGGCAGGGGAATCGCTT"
"GL873569","7989158","7989286","chr8","41505677","41505810","35","33516519","AGTCCCACCTATTTGGAAGGCTGAGGCAAGAGGATCACTTGAACTCAGCAGTTTGACATTGCTATGAGTTAGATTGACTCCATGGCACTCTAGCCCAGGCAACAGAGCAAGACTCCGTCTCAAAACAAA","TAATACCAGCTACGTGGGAGGCTGAGGCAGGAGAATCACTTGAACCCGGGAGGTGGAGGTTGCAGTGAGCTGAGATTGCACCGTTGCACTCTAACCTGGGCAACAAAAGCAAAACTCTGTCTCAAAAAAAAAAA"
"GL873569","7989575","7989702","chr1","62231025","62231129","47","54241450","GGCTGGGTAATGCAGTGGCTCACGCCTATAATCCTAGTGCTTTGAGAGGCCAAGAGTGAGACTCTGTGTACTAAAAATAGAAAAATTACCTAGGCATTCTGGTGGGCACCAGTAGTCCCACCTATTTG","GGCTGGGCATGGTGGCTCACGCCTATAATCCCAGCACTTTGGGAGGCCGAGGCAGGTGGATCACCTGAGATCAGGAGTTTGAGACCAGACTGGCCAACATGGTGA"
"GL873569","10034363","10034556","chr10","61268396","61268605","62","51234033","CAGCTTGAGCAAAAGTGAGCCCCTGTCTCTACTGAAAATAGAAAAAATTAGCCAGGCGTGGTGGCACACACTTATAGTCCCAGCCACTTAGGAGGCTGAGGCAGGAGTTTGAGGTTGACATAATCTAAGCTGATACCATAGCACTCTAGCCTGGGCAATAGAGTGAGACTCTGTCTCAAAGAAGAAATTTATCT","CCTGACCAATGGTGAAACCCTGTCTCTACCAAAAATACAAAATTTAGCTGGGCATGGGGGCACGCACCTGTAGTCCTAGCTACTCGGGAGGCTGAGACAGGAGAACTGCTTGAACTCGGGAGGCAGAGGTTGCAGTGAGCTGAGATCATGCCACTGCACTCTAGCCTGGGCAATAGAGTGAGACTCCGTCTCAAAAAAAAAAAAAAAAAA"
"GL873569","10034830","10034845","chr1","217667782","217667796","2","207632952","AAAAAAGAAGAAAAAA","AAGAAAAAGAAAAAA"
"GL873569","10203815","10203922","chr8","96374555","96374671","35","86170740","GCCAGGTGTAGTGGTTCACACCTATAATCCTAGCACTCTGGGAGCCTGAAGCAGGTAAATGGACTGAGCAAGAGTGAGACTTCCACCTCTATTGAAAATAGAAAAATT","GGCTAGGTATGGTGGCTGATGCCTATAATCCCAGAATTTTGGGAGGCCGAGGCAGGCAGATCATCTGAGGTCAGGAGTTTGAGACCAGTCCCGTCTCTACTAAAAATACAAAAATTA"
"GL873569","10204196","10204373","chr20","1304385","1304559","47","8899811","GAAAATAGAAAAATTAGCCAGGCATTATAGCAGGCACCAGTAATCCCAGTTACTTGGGAGGCTAAGGCAAAAGAATCTCTTGAGCCCAAGTTTGGGGTTGCTAGGAAGTAAAACACCACAGCACTATACCCAGAACAAGAGAGTGAAGACTCAGTCTCAAAAAGATAAATAAATAAAA","AAAAATACAAAAATTAGCCAGGCATGGTGGCGGGCGTCTGTAACTCCAGCTACTTGGGAGACTGAGGCAGGAGAATCGCTTGAACCCAGGAGGCAGAGGTTACAGGTGAAATCACACCACTGCACTCCAGCCTGGGCAACAGGGCAAGACTCTGTCTCAAAAAAAAAAAAAAAAA"
"GL873569","10473375","10473444","chr8","20660648","20660717","21","10187273","TGTAGTCCCAGCACTTTGGGAGGTTAAGGCAAGAGTAGCACCCAACATGAGGAGATCAAGACCAATCTGG","CTGTAGTCCCAGCACTTTGGGAGGCTGAGGCAGGTGGATCCTTTGAGGGCAGAACTTTAAGACCAGCCTG"
"GL873570","9287350","9287485","chr1","29437872","29437991","30","20150522","GGCCGGGCGTGGTGGCGCACGCCTGTAGTCCCAGCGCTATGGGAGGCCGAGGCGGGTGGATCACCTGTGCTCAGAGGTTCGAGACCAGCCAAGACCCCCCTGAGCCAAACGAGCCAGAGTGAGACCCCGTCTCTAC","GGCCGGGCGTGGTGGCTCACGCCTGTAATCCCAACATTTTGGGAGGCCAAGGCGGGTGGATCACCTGAGGTCAGAAGTTCGAGACCAACCTGGCCAACATGGTGAAACCCCTGTCTCTAC"
"GL873571","3669989","3670207","chr4","116777080","116777297","60","113107091","AGACCAGCCTGAGGAAGAGCAAGATCCCATCTCTATTAAAAATAGAAAAATTAGCCAGGCATTCTGGTGGGCACCTGTAGTTCTAACCACCTGGGAGGCTAAGGCAAGAGGAACTCTTCAACCCAAGAGTTTGAGGTTGCTGAGAGCTAGGCTAAGGCTGCAGCACTCTAGCCTGGGCAACAGAGTGAGACTGTTTCTCAAAAACAAAAAACAAAAAAA","CGAGACCAGCCTGGTCAATATGGTGAAACCCCGTCCCTACTAAAAATACAAAAATTAGCCAGGCATGGTGGCAGGCACCTGTAGTCCCAGCTACTCGGAAGGCTGAGGCAGGAGAATCGCTTGAACCACAGAGGCAGAGGTTGCAGTGAGCCGAGACTGCACCACTGCACTCCAGCCTGGGCGACAGAGTGAGACTCAGTCTCAAAAAAAAAAAAAAA"
"GL873571","106134","106236","chr4","18143723","18143826","27","18037589","GGCCAGTCTCAGTGGCTCACACCTGTAATCCAGCATTCTGGGAGGCTGAAGCACACGGTCACCTGAGCTCAAAGGTTGGAGACCAGAGTGAGACCCCACCTCT","GGCCAGGCGCAGTGGCTCACTCCTGTAATCCCAGCACTTTGAGGCTGAGGCAGGCGGATCACCTGAGGTCAGGAGTTTGAGACCAGCCTGGCCGAAACCCCATC"
"GL873571","3670496","3670589","chr7","50468399","50468491","15","46797903","GGGCAGGCATGGTGGCTCACACCTGTAATTCTAGCACTCTTGGAGGCTGAGGCAGGAAAATGGCTTGAGGTCAGGAGTTCAAGACCAGCCTGAG","GGCCAGTCATGGTTGCTCACACCTGTAATACCAGCACTTTGGGAGGCCGAGGCAGGCGAATCACCTGAAGTCAGGAGTTCAAGACCAGCCTGG"
"GL873571","4059090","4059389","chr7","52903696","52903994","88","48844606","GGCCAGGTGCAGTGGTTCACACTTATAATCCTAGCACTCTGGGAGGCCGAGGCGAGTGAAGTGCCTGAGCTCATGGGTTCAAGACCAACCTAAGCCAGAGACCCCTGACTCTTATAATAGCCTGGCATTGTGGTGGGCGCCAATATTTCCAGCTACTCTGAGGCTAAGGCAAGAGAATTGCTTGAGCCCAGGAGTTGGAGGTTTCTGTGAGCACTGACGCCGCAGCTCTCTACCAAGGGCAACAAAGACTCTGTCTCAAAAAATAAATAAATAAATAAATAACAGAATGAAAATGAAAAA","GGCCGGGTGCGGTGGTTCACGCCTGTAATCCCACCACTTTGGGAGGCTGAGGCAGGCAGGTCACCTGAGGTCAGGAGTTCCAGACCAGCCTGGCCAACATGGTGAAACCTTGTCTCGGCTATTAGCCTGGCATGGTGGTGCGTGCCCATAATCCCAGCTACTCAGGAGGCTGAGGCAGGAGAATCGCTTGAACCCAGAAGGTGGAGGTTGCAGTGAGCCAAGATAGCACCACTGCAACTCCAGTCTGGGCAACAGAATGAGACTCTGTCTCAAAAAAAAAAAACAAAAAACAAAAAGAA"
"GL873571","4209418","4209704","chr11","32517699","32517985","80","28308281","GGCTTGGCAAGGTGGCTTACACCTCAAATCCTAGCACTGTGGGAGACTGAGGCAGGTGGATTGTTTGAGCTCAGGAGGTCAAGATAGAGAGCAAGAGCAAGTCTCTGTCTCTACTAAAAATAGAAAAGAACTACTTCCCGGGGGTCATGGCAGTAGCCTGTAATCCCAGTTACTAGGTAGAATGAGGCAAGAGGATCTGTTGAAGCCAAGAGACTGAGGTTGTTATGAGCATGCCACAGCACTCTACCCAGGGTGACAGAATGAGACTCTGTTGAAAGAAAAAAAGA","GGCCGGGTGCAGTGGCTCACACCTGTAATCCCAGCACTTTGGGAGGCTGAGGCGGGTGGATCACCTGAGGTCAGGAGTTCAAGACCAGCCTGACAAACATAGTGAAACCCTGTCTCTACTGAAAATACAAAATTAGCCAGGTGTGGTGGCGCATGCCTGTAATCCCAGCTACTCGGGAGGCTGAGGCAGGAGAATTGCTTGAATCCAGGAGGTGGAGGTTGTGTGATCACACCACTGCACTCCAGCCTGGGCGACAGAGTGAGACTCTGTCTCAAAAAAAAAAGAAA"
"GL873571","4209985","4210154","chr3","175781758","175781928","60","171571773","GAAAGAAATGAAAAGAAAGAAGTTAGCTGGTTGTTGGGGTATGCTTCTATAGTCCCACCTACTCAGAAAGCTGAAATCTGGAGTTTGGGGTTGTTGTAAGGTAGGCTGATGACATAGCACTGTAGCTTGGGCAAGAGAGTGTGACTTTGTCTCAAAAAAAATTAAAACAA","ATTAAAAACACAAAGATTAGCCAGGTGTGATGGCACACAACTGTAATCCCAACTACTCAGGAGAATCGCTTGAACCTGGGAGATAGGGTTTGCAGTGAGCCAAGATTGTGCCACTGCACTCCAGCCTGGGTGACAGAGTGAGACTCTGTCTCCAAAAAAAAAAAAAAAAAA"
"GL873571","4210444","4210570","chr17","16655655","16655789","35","12445211","GCCAGGCAGATGGCTCACACTTCATCCTAGCCCTCTGGAAGGCTGAGGCAGGCTAATTTTTTGAGGTTAGGAGTTTGAGACCAGCCTGAGGAAGAGACCCATCTCTACTTTAAAAAATAAATGGAAA","GCCAGGCATGGTGGCTCACACCTGTAATCCTAGCACTTTGGGAGACTGAGGCGGGTGAATCACCTGAGGTCAGGAGTTTGAGACCAGCCTGACCAGTATGGTGAAACCCAGTCTCTACTAAAAATACAGAAATTA"
"GL873571","4391733","4391878","chr11","33723808","33723943","46","29332075","AACTTAGCTGGGAATGGTGGCTCAAGCCTGTAATCCTAGCACTCTGGGAGGCTCAGGTGGGAGGATCACTTGAGGTTGCTGTGAGCTTGGCTGATGCCAGGACACTCTAGTGTGGGCAAGAGAGTGAGACTCCGCCTCAACAACAA","GCCGGGTGCAGTGGCTCATACCTGTAATCCCAGCACTTTGGGAGGCTGAGGTAGGCGGATCACGAGGTCAGGAGCTGAGATGGCGCCACTGCACCCCAGCCTGGGTGACAGAGCAAGACTCTGTCTCAAAAAAAAA"
"GL873571","6307773","6307841","chr9","62429628","62429694","22","56121855","CTGGGTGTGGTGGCATTGCACCTGTAATCCTAGCTACTTGGAAATCTTAAGCCCAGGAGTTGAAGACTG","CCCAGCATGGTGGTGCATACCTATAATCTCAGCTACTTGGAGGCTTGAGCTCAGAAGTTTGAGACCG"
"GL873571","6496217","6496306","chr1","27257765","27257856","27","20761548","GCAGGGTGTGTTGACCCACACCCACAATTCCAGGACTCTGGGGGGCCAGGGATGGTGGGTTCCCTCAGATCAGGAGCTCCTTACCAGCCT","GACTGGGCATGATGGCTCAAATCTGTAATTCCAGCACTTTGGGAGGCCGAGGTGGGTGGATTGCCTGAGATCAGGAGTTCAAGACCAGCCTG"
"GL873571","6499738","6499903","chr1","38976375","38976555","47","32476637","AAAATAACATGAATTGACTAGGCGAGGTGGCTCACATCTCTAATCCTAGCACTCTGGGAGGCTGAGGCAGGAGAATTGCATGAGGTTGCTGTGAGCTATGATGATACCACGGCATTCTAATCAGGGTGACAGAGTGAGATTCTGTCTTAAAACAAACAAACAAAAA","AAAATAAATAAATTAGCAGGGCCTGGTGGCGCACACCTGTAATCCCAGCTACTTGGGAAGCTGAGGCAGGAGAACCCACTTGAACCTGGGAGCCGGAGGTTGCAGTGAGCTGAGATGGCACCACTGCACTCCAGACTGCGTGACAGAGTGAGACTCCGTCTCAAAAACAAACAAACAAAAA"
"GL873571","11399575","11399872","chr15","109458692","109458994","79","98059117","CAGTGGCTCACACCTGTAAATCTAACACTCTGGGAGGCCAAGGTGGGTGGATCCCTTGAGCTCAGGAATTTGATACCAGCCTGAGCAAGAGTGAGACCTTGTCTCTACTAATAATAGAAAAATAGCCCGTGTTGTGGCACTTGTCCCAACCACTGGGGAGGCTTTAGGCGGGAGGATTACTTGAATTGGGAGTTTGATATTGCTGTGAGCTGGGCTGATGCCTTGGCATTCTAGCTTGGGTAACAGCGTAAGACTCCGTCTCAAATAAATAAATAAATAAATAAAAAGAAAAAAAGAA","GTGGCTCACACCTGTAATCTCAGCACTTTGGGAGACCGAGGCAGGTGGATCACCTGAGGTCGGGAGTTTGAGACCAGCCTGACCAACGTGGAGAAACCCCGTCTCTACTAACAATACAAAATCAGCTGGGCGTGGTGGTGCATGCTTGTAATCCCAGCTACTCGGGAGGCTGAGGTAGGAGAATCGCTTGAACCTGGGAGGTGGAGGTTGCGGTGAGCCGAGATCGAGCCACTGCACTCCAGCCTGGGTGACAGAGCAAGACTCCATCTCAAAAAAAAAAAAAAAAAAAAAAAAAAAAAAAAA"
"GL873572","114760","114841","chr8","26280134","26280211","16","26165374","GGCCAGGCATGGCGGCTCTTCCCTGTAATCCTAGCACTCTGGGAGGGCGAGGCAGGCAGATCACCTAGGCTAGGGTGAGATC","GGCCAGGAATGGTGGCTCATGCCTGTAATCCCAGCACTTTGGGAGGCTGAGGCAGGCAGATCACCTGAGGTCAGGAGT"
"GL873572","9421791","9421892","chr11","8089184","8089269","35","1332607","TACTAAATATATAGCAAGGCCAGGCACAGTGGTTCATGGCTGTAATCCCAGTACTCTGGGAGGCCTAGTCAGAGTTGACCTGAGATCAGGCTAGAAGCCTGG","ATAAAAATAATTGGAGGCCAGGCACGGTGGCTCATGCTTGTAATTCTAGCAATTTGGGAGGCTGACGCGGGTGAGATCATACTGAG"
"GL873572","11052834","11053035","chr14","11857478","11857657","65","804644","TCCACAAAGAAAGCAGAAGTGTGGCCGGGTGGTAGCTCAAGGCAGGAATCCCAGCACTCTGGGAGCTGGGAGGTGGGGGAGGATCCCTTGAGATCAGGAGTTGGAGGGCACAGTGAGCCTGGGGGAGGCCACTGTCTCTGTACTCTAGCAGGGAGACAGAGCAAGACTGCCCATTCAAAGAAAAACAACAAACAAAACAAAA","TACAAAAATTAGCTGGGCACGGTGCCACAAGCCTGTAATCCCAGCTACTCGGGAGGCTGGGCAGGGGAATAGCTTGAACCCAGAGGTGGAGGTTGCAGTGAGCCAAGATCAAGCCACAGCACTCCAGCCTGGGTGACAGAGCAAGACTCCATCTCAAAAAAAAAAAAAAAAAAAAAAAAA"
"GL873573","2564195","2564244","chr1","109985445","109985491","12","107421250","TACAAAAATTAGGCTGGGCTTGGTGGTTCACGCCTATAATCCTAGCACTT","ACTAAAATTAGCTGGGCATGGTGGTGCATGCCTGTAATTCCAGCTAC"
"GL873573","7423371","7423533","chr2","202783328","202783513","56","195359957","GGTGGCTCACACCTGTAATCCCAGCACTCTGGGAGCCCTGGTGGCTCATGTCTATAATCCTAGTACTCTGGGAGACCATGGTGGCTCATGTCTATAATCCTAGTACTCTGGGAGCCATGGTGGCTCACGCCTATAATCCTAGTACTCTGGGAGACCATGGTGG","GGCTGAGGCGCGGGGGCTCACGCCTGTAATCCCAGCACTGTGGGAGGCCGAGGCGGGTGGATCACGCCTGTAATCCCAGCACTGTGGGAGGCCAAGGCGGGTGGATCACGCCTGTAATCCCAGCACTGTGGGAGGCCGAGGCGGGTGGATCACGCCTGTAATCCCAGCACTGTGGGAGGCTGAGGC"
"GL873573","9657648","9657710","chr19","10207852","10207913","10","550204","TAAAAATAAAAAATTTAGCTGGATGTGGTGGCTCACACCTGTAATCCTAGCACTCTGGGAGAC","TAAAAATACAAAATTAGCTGGGTGTGGTGGCACACACCTGTAATCCCAGCTACTCAAGAGGC"
"GL873574","1624662","1624783","chr9","814961","815079","36","809701","GACTGGGTGGGTTGGATCATGCCTGGAATCCTAGCACCCTGGGAGGCCAAGGTGAAAGGATTGCTTGAGGTTAGGAGTTCCAGAAATGTAGCAGTCATGGTGACTTCATCCTTCTCTACCAA","GGCTGGGTGCTTTGATTCATGCCTGTAATCCCAGCACTCTGGGAGGCCGAGGCAGGTGGATCACCTGAGGTTAGGAGTTCGAGACCAGCTTGGCTAACATGGTGAAACCTCGTCTCTAC"
"GL873574","4459477","4459612","chr1","29437872","29437991","29","24978395","GGCCGGGCGTGGTGGCGCACGCCTGTAGTCCCAGCGCTATGGGAGGCCGAGGCGGGTGGATCACCTGAGCTCAGAGGTTCGAGACCAGCCAAGACCCCCCTGAGCCAAACGAGCCAGAGTGAGACCCCGTCTCTAC","GGCCGGGCGTGGTGGCTCACGCCTGTAATCCCAACATTTTGGGAGGCCAAGGCGGGTGGATCACCTGAGGTCAGAAGTTCGAGACCAACCTGGCCAACATGGTGAAACCCCTGTCTCTAC"
"GL873574","4681987","4682216","chr6","153082888","153083127","73","148400901","GGGTGCGGTGGCTCAGACCTATAATCCCAGCACTCTGAGAGGCCGAAGTGGGTGGATCACCTGAGCTCAGGAATTTGAGACCAGCCGTCTCTAAAAATAGCTGAGTGTTGTGGCAGTGGCTGTAAGTCCCAGCTGTTTGGAAAGCTGAAGCAAGGGAATCACTTGAACCCAAGAGTTTGAGGTTGCTGTGATGACAAAGTGAGACTCTATCTCAAAAAAAAAAAAAAAAA","GGCCGTGCGCGGCGGCTCACGCCTGTAATCCCAGCACTTTGGGAGGCTGAGGTGGGTGGATCACCTGAGGTCAGGAGTTTGAGACCAGCCCGACCAGAAATTAGATGGGTGTGGTGGTGCGCTCCTGCAGCCCCAGCTACTTAAGAGGCTGAGGCAGGGTAATCACTTGAACCCGGGAGGCGGAGGTTGCAGTGAGCCGAGCTCACGCCACTGCACTCCAGCCTGGGTAACAGAGCGAGA"
"GL873574","4709916","4710039","chr19","13152422","13152536","46","8442506","AAAAATAGAAAAACTAGCCAAGCATGGTGGTGCACCCCCTATAGTCTGAGCTCCTCAGCGGGCTGAAGCAAAAGGACGGCTGGAGCCCTGGAGTTTGAGGTTGCTGTGAGGCAAGGTGATGCCA","ACACATAAATTAGCCAGACATGATGGTGAGTATCTGTAATTCCAGCTCCTTGGGGGGCTGAGGCGGGAGAATTGCTTGAACCTGGGAGGCAGAGATTGCAGTGAGCCAAGATCGC"
"GL873574","6353839","6353913","chr5","25768079","25768163","22","19414240","AAAAATATAGCAAGGCCAGGCATGGTGGCTCACACCTATAATCCCAGTACTTGGGAGCTGGAATTTGAACCTAGG","AAAAAACTCAAACAAGGCTGGGCGTGGTGGCTCACACCTGTAATCCCAGCACTTTGGGAGGCTGAGGTGGGTGGATCACCTGAGG"
"GL873574","6533061","6533332","chr5","85182161","85182439","81","78649100","GGCTGGGCGAGGTGGCTTACACCTATAATCCTAGTACTCTGGGAGGCCAAGGTGGGTGGATTGCCTGAGCGCACAGTTTCAAGACCAGCTGGAGCCAGAGAGAGAGAGAGAGACCCTGCCTCTAAAAATAGCCAGGCATTGTGGCAGGCACCTGTAGTCCCAGCTACTTGGCAGGCGGAGGTATGAGAATCGCTAGAGGTTGCTGTTAGCTATGATGCCATAGCACTCTACCAAGGGCGACAAAGTGAAACTCTGCCTCAAAAAAAAGAAGA","GCCAGGCGTGGTGACTCAAGCCTGTAATCCTAGCACTTTGGGAGGCCAAGGTGGGCGGATTGCCTGAGCTCAAGAGTTTGAGACCAGCCTGGGCAACACGGTGAAACCCAATCCCTACTAAATACAAAAAAAATTAGCCGGGTGTGGTGGTGTGAACCTGTAGTCCCAGCTACTCGGGAGGCTGAGGCAGGAGAAGGCAGAAGTTGCAGTGAGCCGAGATCACACCACTGCACTCCAGCCTGAGTGACAGAGCAAAACTCTTTCTCAAAAAAAAAAAAA"
"GL873574","6643746","6643907","chr2","92627944","92628105","46","85984198","AAATAGCCAGGCGTTGTGGCAGGCACCTATAGTCCCAGCTACTTGGGAGGCTGAGGCAAGAGAATCACTTAAGCCCAAGTGACAGAGGTTGCCAGGGCACTCTACGTAGGCAACAGAGTGAGACTCTATCTAAGAAAGAAGGAAGGAAGGAAGGAGAAAGAA","TTAGCCGAGCATTGTGGTGCGCGCCTGTAGTCCCAGCTACATGGGAGGCTGAGGCAGGAGAACACCTGAACCCAGGATGTGAGCTGAGTCGCGCCATTGCACTCCAGCCTGGGCAACAGAGTGAGACTCCATCTCAAAAATAAAATAAAATAAAATAAAAAA"
"GL873574","6644163","6644274","chr1","128607504","128607619","20","121963341","CTGTAATCCTAGCACTTGGGAGGCTGAGGCAGGTGGATCACCTGAGTTCAGGAGTTCAAGACCAGCCTAAACAAGAGTGAGACCCTATCTCTACTAAAAATAGAAAAAATAT","GCCTGTAATCCAAGCACTTTGGGAGGCTGAGGCGGGTGGATCACCTGAGGTCAGGTGTTCGAGACCAGCCTGGCCAACGTGGTGAAACCCCAACTCTACTAAAAATACAAAAATTA"
"GL873574","8511822","8512127","chr1","23439759","23440073","84","14927937","GGTGGCTGGTGCCTGTAATCCTAGCACTCTGGGAGACTGAGGCAGGTGGATCACTTGAAATCAGGAGTTTGAGATCAACCTGAGCAAGAGATCTTGTCTCTCCTAAAGATAGAAAAACTAGCTGGGATTTGTGGTGGACACCTGTAATTTCAGCTACTCAGGAAGCTAAGGCAAGAGCATTGCTTAAAACCAGGAGTTTGAAGTTGATGTGAGCTAGGATGTCAGGGCAGGTTACCCAGGGTGACAGAGTGAGACTCTGTGTCAAAATAAACAAACAAACAAACAAACAAAACAAAATAAAATAAA","GGCTGGACATGGTGACTCACGCTTGTAATCCCAACACTTTGGGAGGCTGAAGCAGGCAGATCACCTGAGGTCAGGAGTTTGAGACCAGCCTGACCAACATGGTGAAACCTTGTCTCTACTAAAAATACAAAAATTAGCTGGGAGCAGTGGTGCACACCTGTAATCCCAGCTACTCGGCAAGCTGAGGCAAGATAATTTTTTAAACCTGGGAGGTGGAGGTTGCAGTGAGCCAAGATCGTGCCACTGTACTCCAACCTGGGAGACAGAGCAAGACTCTGTCTCAAAAAAAAAAAAAAAAAAAAAAAAAAAAAAAAA"
"GL873575","2107336","2107519","chr4","38052972","38053149","54","35945636","TCAATTAAAAACTTTTTAAAATGAGGCTGAGCATGGTGGTTCACACCTGTAATCCCAGCACTTTGGGAGGCCGAGGCAGGAGGATCACCTGATCCCAGGAGTCCAAGCCTACAGTGAGCCGTGATAATACCACTGCACTTCAGCCCAAAGCCTCAAAAAGAAAAAAAAAAAAGGATAGACAAGA","TATATATATATATATTATTTTGGGGGGGCATGGTGGTGCACACCTGTAATCCCAGCTACTCGGGAGGCTGAGGCAGGAGAATTGCTTGAGCCCGGGAGGCAAAGGTTGCATTGAGCTGAGATCACACCACTGCACTCCAGCCTGGCGACAGAGTCTCAAAAAAAAGAAAAAATAAAAA"
"GL873575","5831824","5831959","chr1","29437872","29437991","28","23606048","GGCCGGGCGTGGTGGCGCACGCCTGTAGTCCCAGCGCTATGGGAGGCCAAGGCGGGTGGATCACCTGAGCTCAGAGGTTCGAGACCAGCCAAGACCCCCCTGAGCCAAACGAGCCAGAGTGAGACCCCGTCTCTAC","GGCCGGGCGTGGTGGCTCACGCCTGTAATCCCAACATTTTGGGAGGCCAAGGCGGGTGGATCACCTGAGGTCAGAAGTTCGAGACCAACCTGGCCAACATGGTGAAACCCCTGTCTCTAC"
"GL873575","7451097","7451208","chr3","122814630","122814743","22","115363533","GGCCAGGTGTGGTGGCTCACACCTGTTATCCTAGCACTCTGAGAGGCCACAGCAGCTGGATCACTTGAGCTCAGGAGTTCAAGACCAGTCTGAGCAAGAGCAAGACCTCACC","GGCTGGGTGTGGTGGCTCATGCCTGTAATCCCAGCACTTTGAAAGGCCAAGGCAGATGGATCACTTGAGGTCAGGAGTTCCAGACCAGCCTGGCCAACATGGCAAAACCCCATC"
"GL873575","7451277","7451445","chr6","58863249","58863409","41","51411972","AAAAATTCAGCCAGCCACAGTGGAAGTGGATGCCTGCCATCACAGCTACTCTGGGGGCTGGGGCAAGAGAATTGCTTGATCCCAGGAGTCTGAGGTTGCTGTGACCTAGGCTGACACCACAGCACTCTACCCAGGGTGACAGAGTGAGGCTGTGTTTAAAAAAAAAAAA","TTAGCCAGGCATGGTGGCACATGCCAGTAATCCCAGCTACTCAGGAGGATGAGGCAGGAGAATCGCTTGAACCCAGGAGGCAGAGGTTGCAGTGAGCTGAGATTGCGCCACAGCACTCTACCCTGGGTGACAGAAGGAGACTCTGTCTCAAAAAAAAAAAA"
"GL873576","1765109","1765185","chrX","53921180","53921256","12","52156071","GGCCAGGTGCAGTGGCTCATATCTGTAATCCTAGCACCCTGGGAGGCCAAGGTAGGCGAATCACCTGAGGCCAGGAG","GGCCAGGTGCAGTGGCTCACGCCTGTAATCCCAGCACTTTGGGAGGCCGAGGTGGGCGGATCACTTTAGGTCAGGAG"
"GL873576","2711577","2711895","chr7","6620384","6620702","85","3908807","GGTCGAGCTTGGTGGCTCATGCTTGTAATCCTAGCACTCTGGGAGGCCAAGGCAGGTAAGTTGCCCTGAGCTCATAGGTTCCAGATCAGCATGAGCCAGAGTGAGACCCTGTCTCTACCAAAAAATAGCCCGGCATTCTGGCAGGTGCCTGTAATCCCAGCTGCTTGGGAGGCTGAGGCTAGAGAATCACTTAAACCCAAGGGTTAGTGGAGGTTGCTGTGAGCTATGATTCCACCGTACTCTACTGAGGGCCACAAAGTGAGACTCTGTCTCCATAAAAAAGAAAGAAAGAAAGAAAGAAAAATAAAATAAAATAAAA","GGCCAGGCACAGTGGCTCATGTCTGTAATCCCAGCACTTTGGGAGGCCGAGGCGGGTGGATTACCTGAGGTCAGGAGTTCTAGACCAGCCTGGCCAACAAGGCGAAACCCTGTCTCTACTAAAAATACAAAAAATTAGCTGGGCGTTTTGGCACATGCCTGTAATCCCAGCTACTTGGGAGGCTGAGGCAGGAGAATTGCTTGAACTGGGGAAGTGGAGGTTGCAGTGAGCTGAGATCACACCATTGCACGCCTGAGCAACAGAGCGAGACTCTGTCTCAAAAAAAAAAAAAAAAAAAAAAAAGAAAAGAAAAAGAAAA"
"GL873576","4782520","4782652","chr9","61136941","61137074","22","56354421","CCAGGCACGGTGGCTCACCCTTGTAACCCTAGTACTTTGGGAGGCTGAGGTGGGAGGATCCCTTGAGGTCAGGAGTTCAAGACCAGCCTGAACAACAGTGAGACCCCCGTCTCTACTAAAAAATAGAAAAGTT","GCCAGGCACGGTGGCTCACGCCTGTAATCCCAGCACTTTGGGAGGCTGAAGCGGGCGGATCACCTGAGGTCAGGAGTTCAAGACCAGCCTGGGCACCATGATGAAACCCCGTCTCTATTAAAAATACAAAAATT"
"GL873576","4782930","4783078","chr7","57521645","57521803","40","52738715","AGTTAGTCTGGTGTCATGGTGGGTGCCTGTAGTCCCAGCTGCTTGGGAGGCTGAGGCAAGAGAATCACTTGAGCCCAGGAGTTGGAGGTTGCTATGAGCGAGGCTGTAGCCTAGGCAACAGAATGAGACTTTGCCTCAAAAAAATAAAA","TTAGCTGGGCATGGTGGCGCATGCCTGTAGTCCCAGCTACTTGGGAAGCTGAGGCAGGAGAATCACTTGAACCTGGGAGGTGGAGGTTGCAGTGAGCTGAGATCGCACCGCTACACGCCAGCCTGAGCAACAGAGAGAGACTCTGTCTCAAAAGAAAAA"
"GL873576","7828709","7828723","chr5","101042981","101042996","1","93214272","TAAATAAATAAAAAA","TAAATAAATAAATAAA"
"GL873576","7828960","7829230","chr13","49045537","49045844","89","41216577","GCCGGCTGCAGTGGCTATAATCCAAGTACCCTGGGAGGCTTAGGTGGATGGATCACTTGAGCTCAGAAGTTCAAGACCAGCCTCAGCAAGAGGTAGACCTTGCCTCTATTAAANNNNNNNNNNNNNNNNNNNNNNNNNNNNNNNNNNNNNNNNNNNNNNNNNNNNNNNNNNNNNNNNNNNNNNNNNNNNAGTTTGAGGTTGCTGTGAGCTATGATGAAGCCAGGGCATTCTACCCAGGGTGACAGAGTAACTCTTAAAAAAAACTAAACAA","GGCCAGGCAGAGTGGCTCATGCCTGTAATTCCAGCAATTTGGGAGGCCTAGGCAGGCAGATTACCTGAGGTCAGGAGTTTGAGACCAGCCTGGCCAACATGGTGAAACCCCGTCTCTTCTANNNNNNNNNNNNNNNNNNNNNNNNNNNNNNNNNNNNNNNNNNNNNNNNNNNNNNNNNNNNNNNNNNNNNNNNNNNNNNGGAGATAATAGCTTTTGTAGAACGAAGCGATGCAACAGCCAGATCGCCGCCACCACCCTTAGGTCCTGGCGACAGAGTGAGATCCATCTTAAAAAAAAAAAAAAAAAAA"
"GL873576","10622840","10623093","chr7","60266447","60266705","74","49643607","GCTGGGTATGGTGGTTCACACCTATAATCCTAGCACTCTGGGAGGCTGAGGTGGGAGGATTGGTGGAGCTCAGGAGCTCATGAGGTGCCAAATCACTGGTGCCACACACCTGTATTCCCAGCTACTGAGGAGGCTGAGGCAGGAGGATCAGGTAAGCCCAGGAAGTTTGAGGTTGTAGTGAGTTAGGATGATTGAACTCTGCCTTGAGAGACAGAGCAAGATCCTCCTTCCTCCTAAGCAAACAAACAAATAAA","GGCTGGGTGCAGTGGCTCACACCTGTAATCCTAGCACTTTGGGAGGCTGAGGCGGGAAAATTGCCTGAGCTCAGGAGTTCAAGGACAGCCTAGGCAACATAGCATGGTGGTGCACGCCTGTATTCCCTGCTACTTGGGAGGCTGAGGCACAAGAATTGCTTGAATCCGGGAAGTGGAGGTTGCAGTGAGCCATTGTGGCACTGCTCTCCAGTCTGGGTGACAGAGCAAGACTCCATCTCAAAAAAAAAAAAAAAAAAAA"
"GL873576","10819939","10820007","chrX","67133632","67133707","21","56313693","AGGTTGCAGTGAAATTGTACCATTCCAATGAAGCCTGGGGGACAGAGTGAGATTCTCTCAAAATAAAAA","GGAGGTTGCAGTGAACCGAGATCGTGCCACTGCACTCCAGCCTGAGCGACAGAGTGAAACTTCGTCTCAAAAAAAA"
"GL873576","10920306","10920363","chr3","48261745","48261808","16","37341439","GCTGGACCTTGTAGAGAGTGCCTGTAATCCCAGCTACATGGGGGGCAAGAGAATTGCT","GCTGGGCATGGTGGTGCATGCCTGTGATCCCAGCTACTCAGGAGGCTGAGGCAGGAGAATTGCT"
"GL873576","10920398","10920529","chr10","67341428","67341546","30","56421030","GGCCAGGCGTGGTGGCTCACGCCTGTTGTCCCAGCACTGTGGGAGGCCGAGGTGGGTGGATTGCCTGAGCTCAGAGGAGTCCGGAAGACCAGCATGAGGCAGAGTGAGCCAGAGTAAGATCCTGTCTCTACC","GGCTGGGTGTAGTGGCTCATGCCTGTAATCCCAGCACTTTAGGAGGCCAAGGTGGATGGATTGCCTGAGCTCAGGAGTTCGAGACCACCCTGGGCAACAAGCCAAAACCCTGTCTCTAC"
"GL873577","515809","515961","chr7","137660778","137660931","43","137144969","AGCTGGGCATGGTGGCTCATGCCTATAACCCTAGCGTGCTAGGAGATTGCTTGTCAGGAGACTGAGGTTGCAGGAAACTGTGATGATGGCACTGCACTCTACCCAGGGTGACAGAGCAGGACTCTGCCTCAAAAAAAAAAAAAAAAATAGAAA","TTAGCTGGGCATGGTGGCGCATGCCTATAATCCCAGCTACTTGGGAGGCTGAGGCAAGAGAATCGCTTGAACCGGGGAGGCAGAGGTTGCAGACTGCACTCCAGCCTGTGTGACAGAGTGGGACTCCGTCTCAAAAAAAAAAAAAAAAAAAAAA"
"GL873577","1633164","1633256","chrX","38269524","38269615","26","36636360","TCAGCCAGGCATGGTGGCACTTGCCTATAAACCCAGCTCCTTGGGAAGCTGAGCCGGGAGGATCCCTTGCACCCAGGAGCAACGGAAGGCAGT","AATTAGCCAGGCATGGTGGCACATGCCTATAATCCCAGCTACTCAGAAGGTTGAGGCAGGAGAATCACTTGAACCTGGGAGGCAGAGGTTGC"
"GL873577","3979502","3979560","chr20","68909283","68909346","13","64929781","GAGTTTGAGACCAGCCTGAGCAAGACCGAGACCCAGTCTCTACTAAAAATAGAAAAATT","GGAGTTCAAGACCAGCCTGACCAACATGGAGAAACCCTGTCTCTACTAAAAAATACAAAAATTA"
"GL873577","3979839","3980009","chr10","31403126","31403287","39","27423287","ATGAGCAGATTGTCTTGGTGGGCACCTGTAGTCCCAGCTATTGGAGGTGGGAGGCTGAAGCAGGAAAATCTCTTGAGCCCAGGAGTTTGAGGTTGCTGTGAGCTAGGCTGACACCACGGCACTCTAGTCAGGGCGTCAGAGTGAGACTCCGTCTCAAAAAAAAAAAAAAAA","TTAGCTGAGTGTGGTGGCGCACATCTGTACTCCCAGCTATTTGGGAGGCTGAGGCAGGAAAATCGCTTGAACCCAGGAGGTGGAGGTTGCAGTGAGCCAAGATCACACTACTGCACTCCAGCCTGGGTGACAGAGTGAGAATCCATCTCAAAAAAAAGAAAA"
"GL873577","6050882","6051080","chr1","153219820","153220007","59","147168938","GGCTGGGCGTTGTGACTCATGCCTGTAATCCCAGCACTCTAGGAGGCCGAGGTGGGTGGACTGCCTGAACTCAGAGGTTTAAGACCATCCTGAGCCGCAGTGAGCCAGAGCGAGACCCTGTCTCTACCAAAAAAAGCTGGGTGTTGTGGTGGGCGCCTATAGTCCTAGCTACTTGAGGCGCTAAGGGTAAAAAAATTGC","GGCCTGGCACAATGGCTCACGCCTGTAATCCTAGCACTTTGGGAGGCCGGGGTGGGTGGATCACCTGAGATCAGGAGTTTGAGACCAGCCTGGCCAACATGGTGAAACTCCTTCTCTACAAAAATTAGCCAGGTGTGGTGGTGGGTACCTGCAATCCCAGCTATTTGGGAGGCTGAGGCAGGAGAATC"
"GL873577","8463965","8464050","chr9","52134422","52134508","19","43670457","CTGGGTGCTATAGCTCACGCCTATAATCCTAGCACTCTGGGAGTTTGGGGCAAATGGATCACCTAGGCTCAGGAGTTTGATACCAG","GGCTGGGAGCAGTGACTCACGCCTATAATCCCAGCACTTTGGGAGGCTGAGGCAGATGGATCACCTGAAGTCAGGAGTTCGAGACCA"
"GL873577","9471486","9471613","chr16","5178790","5178910","46","4292696","TTAGCCAGGCATAGTAGCCTGTGTGTAGTCCTAGCTACTCAGGAGGCTGAGGTAGATGGGTCACTTGAGGTTGCAGAGATTATGGTAATGTCACTGTACTCTAGCCCTGGCAACAGAGCACAACCCTG","TTAGCCGAGCCTGGTGGCATAAACCTGTAATCCCAGCTACTCAGGAGGCTGAGGCAGGGGAATTGCTTGAACCTGAGAGGAGAAGGTTGCAGTGAGCCGAGATTGCACCATTGCACCCCAG"
"GL873577","9471875","9471998","chr7","17832200","17832315","36","8360325","GGCCAGGTGAAGCAGCTCATGGCTATAATCCTAGCAGTTTGGCAGGCCAAGGTGGGAGGACTGCTTGAGGTCAAGAGTTCAAGACCAACCCATCTTTGCGAAAAATTTAAAAATTACCTAGGCA","GCCAGGAGAGGTGGCTCATGCCTCTAATCCCAGCACTCTGGAAATCCAAGGTGGGTGGATCACCTGAGGTCAGGAATTCCAGACCAGTCTGGCCAATATAAAAAATTAGCCAGGCT"
"GL873577","9853150","9853170","chr3","85044647","85044667","3","75191497","AAACAAACAAACAAAAAAAGA","CAAACAAACAAACAAACAAAA"
"GL873577","9853206","9853473","chr7","130818682","130818963","67","120965476","GCTGGGCGCAGCGTCTCACTCCTGTAATCCCAGCACTTGGGAGGCCAAGGTGAGTGGATTGCCTGAGTTTACAGTTTCGAGACCAGCCTGAGCCAAAGCGAGACCCCCATCTCTAAAAAATAGCTGGGCATTGTGGTGGGCACCTGTAGTCCCAGCTACTTGGGAGGCTGAGGCAAGAGGATCGCTTGAACCTAAGAGTTTGAGGTTGCTGTGAGCTAAGGCTCCATGGCATTCTACCAAGGGTGACTAAGTGAGACTCTGTCTAAAA","GCCGGGCACAGTGGCTCACACCTGTAATCCCAGTACTTTGGGAGGCCAAGGTGGGTGGATCACCTGAGGTCAGGAGTTTGAGACCAGCCTGGCCAACATAGTGAAACTCTACTAAAAATACAAAAAAATAGCTAGGCATGGTGGTGCGCACCTGTAATCCCAGCTACTTGGGAGGCTGAGGCAGGAGAGTTGCTTGAACCCAGCGGGGTTGAGGTTGCAGTGAGTTAAGATCAAGCCACTGTGCTCCAGCCTGGATGACAGAGAGAGACTCCATCTCAAAAA"
"GL873577","10722415","10722478","chr10","12501471","12501539","23","1779056","AATAAAAAAATGCTGGGTACAGTAGTACATGCCTGTACTCTCATCTGGGGAAGCTGAGGCATGA","AAAGTAAAAAATTAGAGCTGGGCATGGTGGCACACACCTGTAATCCCAGTCACTAGGGATGCTGAGGCA"
"GL873578","463331","463568","chr10","28935382","28935620","93","28472051","CAGGTGCTTTGACCCACACCCTCAACTCTAGGACTTTGGACGCCCTGGCTGGGTGGGTCCTTTAAAGTCAGGAGCTTCTTATCAGTCTGGGCAAAAGTGAGACCCCATCTCTACCAAACAAAGAAAGAAATCAGCAGTATGTTGCAGTAGAGACTCACCAATACCTTCTTTCAAAGACCAAAGCTGGAAGGACACTAAAGACCATGATCTCATGGCCTCCCTGAGCCATGACAATGCC","CCAGGTGCAGTGGCTCATGCCTGCAAGCTCAGAACTTTGGGAGGCAGAGGTGAGCAGACTGCCTGAGTTCAGGAGTTCAAGACCAGCTGGGCAACATGGTGAGACCCTATCTCTACTAAAAATACAAATAATTAGCAGGGTGTGGTAGCACACACCTGTAGTCCAGCTACTCAGGAGGCTGAGGCAGGAGAATTGCTTGAACCCAGGAGGCAGAGTTTGCAGTGAGCCAGGACTGGGCC"
"GL873578","1143712","1143827","chr11","52824583","52824692","30","51680871","GGCTGGGTGTGGTGCCTCATGCCTGTAATCTAAGCCCTCTCCGAGGCTGAGGTGGGAGGATCCCTTGAGTTTAGGAGTTTGATTTTGAGACCAGCCTGATCAAGAGAGAGACCTCA","GGCCGGGTGTGGTGGCTCATGTCTGTAATCCCAGCACTTTGGGAGGCTGAGGTGGGTGGATACCCTGAGGTCGGGAGCTCGAGACCAGCCTGACCAACATGGAGAAACCC"
"GL873578","1144101","1144139","chr3","33494224","33494257","11","32350123","GAGAGAGACCTCATGTCTACTAAAATAAATAAATATATA","GTGAAACCCGTCTCTACTAAAAATACAAAAATTA"
"GL873578","1144175","1144343","chr12","119519961","119520131","41","118375786","ATTATCCAGGCCTTCTGGTGGATGCCTGTAGTCCTAGCTACTAGAAAAGCTGGAGCAGAATCACTTGACCCAGGAGCTGGAGGTTGCAGGGAGCTAGGCTGATGCCACAGAATTCTAGCCTGAGGCAAAAGAATTGAGCCACTGTCTCAAAAAGGAACAAAAAAGAAAA","ATTAGCCAGGTGTGGTGGCATGCACTTGTAATCCCAGCTACTAAGAAGGCTGAGGCAGGAGGATCACTTGAACCCGGGAGGTGGAGGTTGCAGTGAGCCAAGATCATGCCACTGCACTCCAGCCTGGGCAACAGAGTAAGACTCTGTCTCAAAAAAAAAAAAAAAAAAAAA"
"GL873578","4593962","4594035","chr16","68825055","68825124","22","64231093","AGCTGGGTACAGTGGCTCACATATAATCCCAGTGACTCAGGAGGCTAAGACAGGAGGATTACTAGGACCTGAGA","GGCTGGGCACAGTGGCTCAGACCTGTAATCTCAGTACTTTGGGTGGCTGAGGCAGGTGGATCACCTGAGG"
"GL873578","6158845","6158972","chr3","500432","500562","24","5658413","GACATGGTGGCTCACACCTGTAATCCTAGCCCTCTGGGAGGCTGAGGCAGGTGGATCACTTGAGTTCAGGAATTCAAGACCAGCTTGAGTGAGAGCAAGACCCTGTCTCTACTAAAAATAGAAAAATT","GCACGGAGGCTCATACCTGTAATCCCAGCACTTTGGGAGGCTGAGGCAGGTGGATCACCTGAGGTCAGGAGTTCCAGACCAGCCTGGCCAACATGGCGAAACCCTGTCTCTACTAAAAATACAAAAAATCT"
"GL873578","6159253","6159444","chr19","34496349","34496541","55","28337096","ATAAAATAAAAATAGAAAAATTAGCCAGGCATTGTGGCAGACATGCGAAGTCTCAGCTACTCCAGAGGCTGAGACAGGAAGATTACTTGAGCCCAAGAATCTTGCTGTGAGCTAAGCTGATGCCATAGCATTGTAACCTAGGCAACAGAGTAAGACTTGGCCTCAAAAATAAAATAAAATAATAAAGTAAAA","TTAGTTAATTAAATTAAACTTAGCTAGGCATAGTGGAACACACCCATAGTCCCAGCTACTCTAGAGGCTGAGGCAGGAGGATTGCTTGAGCCAAGTTGGAGGCTGCAGTGAGCTATGGTGGTGCCACTGCATTCCAGCCTCAGTGACAGAGAGAGACCCTGGCTCAAATAATAATAATAAATAAATAAATAAA"
"GL873578","6766040","6766171","chr2","93098086","93098217","30","86332046","CCAGGCACAGTGGCTCATGCCTATAATCCTAGTAGTCTAGGAGGCTGAGGTGAGTGCATTGCTTGAGCTCAGGAGTTAGATACCAGCCTAACCAAGAATGAGACCCCATCTCTATTAAAAATAGAAAAGTTA","GCCGGGCACAGTGGCTCATGCCTGTAATCCCAGCACTTTGGGAGGCCGAGGCGGGCAAATCACGAGGTCAGGAGTTCAAGACCAGCCTGACCAATATGATGAAACCCCGTCTCTATTAAAAATACAAAAATT"
"GL873578","6766434","6766577","chr9","21128084","21128223","50","14361650","GTTAGCCAGGAGTTGTGGCGGGCACCTACAGTCCTAGCGACTCAGGAGGCTGAAGTAGGCAGAGTTTGATGTGTTGCTGTGAACTACAAGGACACCAATGCACTCTAGGCCGGTAACAGAGTGAGACACTGACTAAAAAAAAAA","TTAGCCAGGTGTGGTGGCACATGCCTGTATTTCCAGCTACTCGGGAGGCTGAGGCAGGAGAATTGCGTGAGCTGAGATCATGCCACTTCATTCCAGTCTGGGTGACAGAGTGAGACTCTGCCTCAAAAAACAAAACAAAA"
"GL873578","7397948","7398119","chr5","40230148","40230319","43","32832200","TAAAAATAGCCATGCATTGTGACAGGCACCTGTAGTCCCAGCTACTCAGGAGGTTGAGGTAAGAGAATCACTTGAACCCAAGAGTTTTGAGGTTGTTATGAGCTAAGACGCCTCGGGACTCTACAAAAGGTAACAAAGTGAGACTCTGTCTCATAAAAAAAGAAAAAAAGAA","AAAATTAGCCAGGCATGGTGACGTACACCTGTAGTCCCAGCTACTCGGGAGGCTAAGGCAAGAGAATCGCTTGAACCCAGGAGGCAGAGGTTGCAGTGAGCTTAGATCACGCTACTGCGCTCCAGCCTGGGTGACGGAGTGAGACGCCATCTCAAAAAAAAAAAAAAAAAAA"
"GL873578","7398378","7398515","chr15","102382935","102383070","35","94984557","GGTCGAGCAAGGTGGCTCACGCCTGTAATCCTAGCACTCTGTGAGGCTGAGGCAGATGGATTGCCTGAGCTCGTGGGTTCGAGACCAGCCTGAGCCAGAGTGAGACCTCATCTCTAAAAATAGCTGGGAAGCTGGGCA","GGCCAGGTGTGGTGGCTCACGCCTGTAATCCTAGCACTTTGGGAGGCTGAGGCGGGTGGATTGCCTGAACTCAGGAGGTCAAGACCAGCCTGGGCAACACAGTAAAACCCCATCTCTACTAAAATACAAAAAATCA"
"GL873579","370235","370429","chr16","38067345","38067552","57","37697110","GCACAGGCCTGAAATCCTAGCACTCTGAAAGGCCAACGGAGGAGAATTTCTGGAGCTCAGGAGTTTGATACCAGCCTAAGCAAATAAAGCTAGACCTCTATCTCTACTAAAATTAGAAAAATTAGGCAGATGTGGTGGTAGGCACCTATAGTCCCAATTACTCCAGAGGCTGAGGCAGAAAGACTCTTGAACCCA","GTCAGGCATGGTGGCTCATGCCTATAATCCTAGCACTTTGGGAGGCCAAGGCCGGTGGATCACCTGAGGTCAGGAGTTTGAGACCAGCCTGGCCAATATGGCAAAACCCCGTCTCTACTAAAAATAAAAAAATTAGCTGGGCACGGTGGTGGGCACCTATAGTCCCAGCTACTCAGGAGGCTGAGGCAGGAGAATTGCTTGAACCCAG"
"GL873579","370936","371046","chr3","3847698","3847802","33","3476762","TGACTCTTGAACCCAGGCACATGAGGTTGCTAAGAGTCTAGGCTGATGTCACGGCACTCTAACCTGGGAAACAGTGTGAGGTTCTGCCTCAATAAATAAATAAATAAATAA","TGGCTTGAACCCAGGAGGCGGAGGTTGCAGTGAGCCGAGATCACGCCACTGCACTCCAGCCTGGGCAACAGAGCGAGACTGTCTCAAAAAAAAAAAAAAAAAAAA"
"GL873579","599436","599605","chr10","38982686","38982853","41","38383250","AAAAAGTCAGACATTGTGGCAGGTGTCTGTAATCCCAGCTATTTGGGAGGCTGAGGCAGGAGTATCATTTGAACCCACGAGTCTGAGGTAACTGTGAGCTAGGCTAACACAACAGCACTCTAGCCTGGGCAATAGAATGAGACTCTATCAAGAAAAGAAATGAAAAGAAA","TATTAGCCTGACACAGTGGCGCGCATCTGTAATCCCAGCTACTTGGGAGGCTGAGGCAGGAGAATCACTTGAACCCAGGAGGCGGAGGTTGCTGTGGGCTGAGATCATGCCACTGCACTCCAGCCTGGGCAACAGAGGGAGGCTCCATCTCAAAAAAAAAAAAAAAAA"
"GL873579","599942","599953","chr3","71473700","71473710","4","70873758","TTTTAAAATAGT","TTTAAAAAAAA"
"GL873579","600232","600365","chr1","16061315","16061447","30","15461083","GGCTAGGCAAGGTGACTCATGTCTGTAATCCTAGTACTCTGGGAGGTTTGAGGCAGGAAGACCACTTTAGCTCAAGAGTTCCAGATCAGCCTGTGCAAGAGTGATACATCATCTCTACTAAAAATCAAAAATTA","GGCTGGGCATGGTGGCTCATGCCTGTAATCCTAGCACTTTGGGAGGTTGAGGCAGGCAGATCACTTGAGGTCAGGAATCTGAGACTAGCCTGGCCAACATGGTGAAACTCCATCTCTACTAAAAAAAAAAAAA"
"GL873579","5650320","5650591","chr6","54938866","54939145","71","49288546","GTCAGGTGTGTTAGCTTACAGTAGTAATCCTAGCACTTTGGGAGGTTGAAGTGGGTGGATTGCTTGAGCTCAGGGGTTCAAGACCAGCCTGAACAAGAGTGGGACCTCATCTCTATTAAAAACAGAAAAACTAGCTGGGTGTTATGGTGGGTGTCTGTAGCCCCAGCTACTCAGGAGGCTGAGGCAGGAGGTTGAGGTTGCTGTGAGCTATTGAGACCACAGCACTCTATCCAGGGCAACAGAGTGAGACCCCTCCCCCCCCCAAAAAAAAA","GGCCAGGTGTGGTGGCTCACGCCTGTAATCCCAACACTTTGGGAGGCCGAGGTGGGTGGATCACCTGAGATCAGGAGTTCAAGACCACCCTGGCCAACATGGTGAAACCCCGTCTCTACTAAAAATACGAAAATTAGCTGAGTGTGGTGGTGCATGCCTGTAGTCCCAGCTACTCAAGAGGCTGAGGCAGGAGGTGGAGGTTGCAGTGAGCCGAGATTGCATCACTGCACTCCAGCCTTGGCGACAGAACGAGAGAGACTCCATCTAAAAAAAAAAAAAA"
"GL873579","7037162","7037347","chr3","37328686","37328893","67","30291524","GAGGTGGGTGGATTGCCTGAGCTCACAGGTTGGAGACCAGCCTGAGCCAGAGCAAGACCTTATCTCAAAAAATAGCCAGGTGTTGTGGCTGGCACCTGTAGTCCCAGCTGCTCAGGAGGCGGAGGCAAGAGAAATGCTTGACCTCAGGAGTTTGAGGTTGCTGTGAGTTCAACTCACACTAATACA","GAGGCAGGGGGATCACCTGAGGTCAGGAGATCGAGACCAGCCTGGCCAACATGGTGAAAACCTGTCTCTACTAAAAATCCAAAAACATTAGCCAGGTGTGGTGGCACGCACCTGTAATCCCAGCTACTTGGGAGGCTGAGGCAGGAGAATCACTTGAACCTGGGAGGCAGAGGTTGTAGCGAGCCGAGATCACACCACTGCACCCCAG"
"GL873579","11077764","11077972","chr19","1200469","1200683","63","9877295","GCCAGGTGCAGTGGCTCATGCCTATAATCCTAGCACCCTAGGAGGCTGAGGAGTTCAAGACCAGCCTAAGCAACTGTGAGACCCCATCTCTACCAAAAATAGAAAAATTAGCTGACTGTTATGGTGTGCACCTACAGTCCTAGCTACTCAGGAGGCTGAGGCAGAAAGAGTCCTTGAACCCAGGAGGCTTTTTTTTGTTGTTGTTGTTG","GGCCAGTCGCGGTAGCTCATGCCTGTAATCCCAGCACTTTGGGAGGCCGAGGCGGGCAGATCACCTGAGACCAGCCTGGCAACATGGTGAAACCCCATGTCTACCCAAACTACAAAAATTAGCTGGGTGTGGTGGTGCACGCCTGTAATCCGAGCTACTCAGCAGGCTGAGGCAGGAGAATCCCTTGAACCTGGGAGGCAGAGGCTGCAGTGAGC"
"GL873579","11078245","11078333","chr19","4926258","4926351","22","6151987","TGAACCCAGGAGTTTGAGTTCGCTGTGAGCTAAGCTGAGGCCACAGCACTCCAGCCTGGGCAACAGAGTGAAAGGAAAAAAATAAAAAA","TGAACCCGGGAGGTGGAGGTTGCAGTGAGCCAAGATCACACCAATGCACTCCAGCCTGGGCAACAAGAGTGAAACTCTGTCTAAAAAAAAAAAA"
"GL873580","320374","320488","chr13","48549305","48549409","42","48228931","GGTAGTGCGTGCCTGCATTCCCAGCTACGGGAGGGCAGGGACTTGAGGCCAGCCTGGGCAAAATAATGAGACCTACTAATGACTCTACTAATACAGAAACAATTAGCTAGGTATG","TGGGAGGCCGAAGTGCGCAGATCACCTGAGGTCAGAAGTTGGAGACCAGCCTGGCCAACATGGTGAAAACCCATCTCTACTAAAAATACAAAAATTAGCTGGGCA"
"GL873580","374969","375091","chr6","147681010","147681135","27","147306041","CGGTGGCTCACACCTATAATCCTAGCATTTTGGAAGGCTGAAGCCGAGGATCTCTGGAAGTCAGAAGTTCAAGACCAGCCTGCCCAAGAGCAAGACCCCATCTCTACTAAAAATAGAAAAACT","GGTGGCTCACACCTGTAATCCCAGCATTTTGGGAGGCTGAGGCAGGCGGATAATCTGAGGTCAAGAATTTGAGACCAGCCTGGCCAACATGGAGAAACCCTATCTCTACTAAAAATACAAAATTAC"
"GL873580","375369","375549","chr7","19977275","19977456","44","19601906","CTAACCAAGTTAGTTAGTTTTAGTTGGCAGGTGCCTGTAGTCCCAGCTCCTTGGGAGGCTGAGGCAAGAGAATGGCTTGAGCCCAGGACTTTGAAGTTGCTGTGAGCTATAATGACACCACAGCACACTACCCAGGGTGACAGAGTGAGACTGTCTCAAAAAAACAAACAAACAAAAAAAA","AACAAACGTTAGCCGAGCATGGTGGTATGTGCCTGTAGTCCCAGCTACTTGGGAGTCTAAGGCAGGAGAATTACTTGAGCCCGGGAGGCAGAGGTTGCTGTGAGCCAAGATCACGCCACTGCACTCCAGCCTGGGTGACAGAGTGAGACTCCATCTCAAAAAAAAAAAAGGAAAAAAAAAAA"
"GL873580","8760922","8761015","chr11","104681322","104681416","19","95920400","GGAGGGAGACACTGCAGTGAACTGCGATCGTGTCTCTGCTTTCCAGGCTGGGTGACAGAGTGAGACTCGGTCTCTAAAATAAAAAATAAATAAA","GGAGACGGAGGTTGCAGTGAGCTGTGATCGCGGCACTGCACTCCAGCCTGGGCAACAGAGTGAGACTCTGTCTCAAAAATAAATAAATAAATAAA"
"GL873580","9391260","9391306","chr14","49279240","49279285","12","39887980","GCCAGTCGAGGTGGCTCACACTTGTGATTCCAGCTACTTGGAAGACT","GGCTGAGATGGTGGCACACACCTGTAATCCCAGCTACTTGGGAGGC"
"GL873581","759283","759365","chr6","46535476","46535542","30","45776193","TAAGAACCTGAAAATAGAGCCAGGCATAGTGGTACATGCGTATAGTCCTGGCTACTCAGGAGGTTGAAACAACAGGATTACTT","CAAAATAGCCAGGCTTGGTGGTGCATGCCTATAATCCAAGCTACTCGGGAAGCTGAGGCAGGAGAAT"
"GL873581","1145844","1145979","chr1","29437872","29437991","29","28292028","GGCCGGGCGTGGTGGCTCACGCCTGTAGTCCCAGCACTATGGGAGGCCGAGGCGGGTGGATCACCTGTGCTCAGAGGTTCGAGACCAGCCAAGACCCCCCTGAGCCAAATGAGCCAGAGTGAGACCCCGTCTCTAC","GGCCGGGCGTGGTGGCTCACGCCTGTAATCCCAACATTTTGGGAGGCCAAGGCGGGTGGATCACCTGAGGTCAGAAGTTCGAGACCAACCTGGCCAACATGGTGAAACCCCTGTCTCTAC"
"GL873581","9628238","9628362","chr5","141044567","141044691","34","131416329","ATCCCAGGTAGTCGGGAGGCTGAGGCAGGAGGATCACTTGAACCCAGGAGGTTGAGGTTGCTGTGAGCAAGGCAGAGGCAACGGCACTCTAGCCACGGGGGCACAGAGACTCTTGTCTTTAAAAA","TAATCTCAGCTACTCGGGAGGCTGAGGCAGGAGAATCGCTTGAGCCCAGAAGGTGGAGGTTGCAGTGAGCCAAGATCGCGCCATTGCACTCCAGCCTGGGCGACAGTGCGAGACTCTGTCTCAAA"
"GL873582","1580485","1580534","chr6","32576760","32576806","12","30996275","CAGCACTTGAGAGGCCAAGGCAGGTGGATCAACTGAGCAAGAATGAGACC","CCAGCACCTTGAGAGGCCAAGGCAGGTGGATCACCTGAGGTCAGGAG"
"GL873582","1644368","1644551","chr1","211626449","211626612","63","209982081","AAAATTTGCCGGGCTCCATAGCTCATGCATGTAATCATAGCACTCTGGGAGGCCAAGATGGGAGGATCTCTCAAGCTCTCTTACTTGGGAGGCTGAGGTTGCTGTGAGTTAGGCTTACGCCACAGCACTCTACTCTAGCGTGAGCAACTCTACTCTTAGTATGAGACTGTCTCAAAAGAAAAAA","AAATTAGCCAGGCGTCGTGGCACATGCCTGTAATCCCAGCTACTCGGGAGGCTGAGGCAGGAGAATAGCTTGATCTCGGGAGGCGGAGGTTGCAGTCAGCCGAGATCACACCACTGCAATCCAGCCTGGACAACAGAATGAGACTCCATCTCAAAAAAAACAAA"
"GL873582","5794385","5794459","chr13","18872784","18872852","27","13078399","ATATTGTTAAGCACAGCCACTATTAAAAATTAAATTATAGGCCAGGCATAGTGGCTCATGCCTGTAATCCTAGCT","TGAAACCACCATCTGGACCAAGATACAAAATGTTGGCTGGGCATGGTGGCTCACACCTGTAATCCTAGC"
"GL873583","102645","102683","chr14","5808766","5808804","14","5706121","GAGCAGATCACCTGAGCTCAGGAGTTTGAGACCAGCCTG","GAGGAATCCCTGTGCTCAGGAAGCTTACATTCTAGTGAG"
"GL873583","6200447","6200560","chr4","17786849","17786963","24","11586402","GGCCAGGAGGGACGGCTCATGCCTGTTATCCTAGCACTATGGGAGACTGAGGTGGGAGGATCACTTGAAGTTAGGAGTTCCAGACCAATCTGACCAAAGTGAGACCTCATCTCT","GGCCAGGCTTGGTGGCTCATGCCTGTAATCTTAGCACTTTGGGAGGCTGAAGTGGGTGGATCACTTGAGGTCAGGAGTTAGAACCAGTCTGGCCAACATGGTGAAACCTCAGCTC"
"GL873583","6200584","6200752","chr6","169626528","169626696","42","163425944","TTAGCTGGATGTGGTAGCACATGCCTATAGTCCCATCTACTCAGGAGGCTGAGACAAGAGAGTTGCTTAAGCCCAGGAGTTTAATTTAACTGTGAACTAGACTGAGACTGTGGCACTCTAGCTGGGGCAACAGAGTGAGACTCTGTCTCAAAAGAAAGCAAGAAAGAAA","TTAGCTGGGTATGGTGTCAGATGCCTGTAGTCCCAGCTACTCAGGAGGCTGAGACAGGAGAATCGTTTGAACCCAGGAGGCCAGAACTGCAGTGAGCTGAGATTCGCACCACTGCGCTCCAGCCTGGGCCAGACAGAGTGAGACTCTATCTCAAAAGAAAAAAAAAAAA"
"GL873583","10217398","10217583","chr3","36257142","36257313","44","26039744","TACTAAAAATAAAGTGTGATAGCCAGGCATGGTGGTGGTGCCTATAGAACCAGGCTATTCAGGAGGCTGAGGCAGAAGGATCACTTGAACCCAGGAGTCTGACGTTGCTGTGAGCTAGGCTGGTGCCATGGTACTCTAGCCTGTGGTAACAGAATGAGACTCTATCTCAAAAATAAAAATAAAAAA","TACAAAATTAGCCAGGCGTGGTGGTGCGTGCCTGTAATCCCAGCTACTTGGGAGGCCGAGGCAGAAGAATGACTTGAACCCAGGAGACAGAGGTTGCAGTGAGCCAAGATCCCACCATTGTACTCCAGCCTGGGCAACACAGTGAGACTCCATCTCAAAAAAAAAAAAAAAA"
"GL873583","10394919","10394983","chr16","12841703","12841771","22","2446784","GAGGTCAGGAAATCAAGATCAGTCTGGGCAATATATTGATACCCTGCCCCTACATAAGGAAGAAA","AGGTCAGGAGTTCAAGACCAGCCTGGCCAATATGTTGAAACCTCATCTCTACTAAAAATACAAAAATTA"
"GL873584","521512","521529","chr1","167402212","167402233","10","166880700","GCATGGAACCCCCCACTC","GGTGAAACCCCATCTTTACTAA"
"GL873584","2079725","2079768","chr15","4338291","4338335","11","2258566","GGCAGGTGGATTACCTGAGTTCAGGAGTTGGAGACCAGCCTGAC","AGGCGGATGGATCACGAGGTCGGGAGTTTGAGACCAGCCTGACCA"
"GL873584","5216877","5217053","chrX","91350057","91350230","49","86133180","CTACTGAAAATGATGACAGAGGCTGGGCATGGGGGCTCCCGCCTGTTATCCTAGCACCCTCGGAGGCTGGGGAATGAGGATTGCTTACGCCCAAGAGTTTGAGGTTGCTGTGAGCTGAGGCCGCTGCACTCTAGCCTGGGCAACAGAGTGAGACTCTGTCTCAAAAAAAAAAAAAAA","TGCAAAAATGAGCTGGGCATGGTGGCACATGCCTGTAATCCCAGCTACACAGGAGGCTGAGGCAGGAGAATCGCTTGAATCTGGGAGGCGGAGGTTGCAGTGAGCTGACATCAGGCCCCTGCACTCTAGCCTGGGCCACAGAGCAAGACTCCGTCTCAAAAAAAAAAAAAAAAA"
"GL873584","7289930","7289950","chr2","51453328","51453345","10","44163398","TGAGGCTCTGTCTCGAAATAA","AATGCCATCTATTAAAAA"
"GL873584","7289975","7290131","chr11","49739997","49740154","37","42450022","CAAGAAAATTAGCTGAGAGTCCTGGTAGGTGCCTGTAATCCCAGCTATTCATGAGGCTGAGGCAGAAGGATCACTTGGGTCCAGGAGTCTGAGGTTGCTGTGAGCTAGTCTGACGCCATAACACGCAAGCCTGGGCAACAGAGTGAGGCTCGGTTTC","CTACAAAAATTAGCTGGGCGTGGTGGCACATGCCTGTAATCCCAGCTACTCGGGAGGCTGAGGCAGGAGAATCACTTGAGCCCAGGAGGCGGAGGTTGCAGTGAGCCAAGATCATGCCATTGCACTCCAACCTGGGCAACAGAGCAAGACTCCATCTC"
"GL873584","7577743","7577867","chr5","48394329","48394446","27","40816586","GGCTGGATGAGGTGGTTCATGCCTGTAATCCTAGCACTCTGGGAGGCCAAGGTGGGTGGATTGCCTGAGCTCAGGAGTTCAAGACCAGCCTGAGCAAGACCCTGTCGCTAAAAATAGCTGGGTGT","GGCTGGGTGCAGTGGCTCATGCCTGTAATCCCAGCACTTTGGGAGGTCAAGGCGGGTGGATCACCTGAGGTCAGGAGTTCAAGACCAGCCTGGCCAACATCTCTACTAAAAATACAAA"
"GL873584","7578135","7578289","chr1","130112713","130112865","31","122534578","GGAGCTGGGTTTTGTGACTGCACCTGTAATCCCAGCTGCTCAGGAGGCTGAGGCAAGAGAATTGCTTGAGCCCAGGAGTTGGAGGTTGCTGTGAGCTGTGATGCCAGGGAACTCTACCAAGGGTGACAAAGTGAAACTCTGTCTCAAAAAAAAAA","TTAGCCAGGTGTGGTGATGCATGCCTGTAATCCCAGCTACTCATGAGGCTGAGGCAGGAGAATTGCTTGAACCTTGGAGCTGGAGGTTGCAGTGAGCTGAGATCAGACCACTCCAACCTGGGTGACAGAGCGAGACTCTGTCTCAAAAAAAAA"
"GL873585","1450952","1451121","chr10","59681079","59681242","48","58230127","TAAAAACAGAAAAAACTAGTCAGGTGGTGTGGTAGGTGCTCATAAGTCCCAGCTGCTTGGGAGACTGAGGCAAGAGAATCACTTGAGCACAAGAGCTTGAGGTGGCTGTGAGCTATAACACCATAGCACTGTACTGAGGGTGACAAAGTAAGACTCTGTCTCAAAAAAAA","TACAAAAATTAGTCAAGGGTGGTGGTATGTGCTTGTAATCCCAGCTATTTGGGAGGCTGAAGCAGGGGAATCCTTGAACCCAGGAGGTGGAGGTTGCAGCGAGCCGAGATCACGTCACTGCACTCTAGCCTGGGCGATAGGGTGAGACTCTGTCTCAAAAAAAA"
"GL873585","1451382","1451515","chr6","17405813","17405948","24","15954431","GGCCCGGCTCGGTGGCTCACACCTATAATCCTAACACTCTGGGAGGCTGAGGCAGGTGGATCACCTGAGCTCAGGAGTTTGAGACCAGCTGAGCAAAAACAAGACCCTATCTCTGCTAAAAATAGAAAAAACTA","GGCCGGGCGGGGTGGCTCACGCCTGTAATCCCAGCACTCTGGGAGGCCAAGGCAGGTGGATCACCTGAGGTCAGGAGTTTGAGACCAGCCTGGCCAACACGCAGAAACCCTATTTCTACTAAAAACACAAAAATTA"
"GL873585","1626960","1627026","chr7","17782729","17782794","22","16155769","AAGATGCCACAGCACTCTACAAGAGTGACCAAGTGAGACTCTGTCTCAAAAAAAAAAAGAAAAGGAA","CAATCGCACTACTGCACTTCAGCCTGGGTGACAGAGTGAGAACCTGTCTCAAAAAAATAAATAAAA"
"GL873585","1627304","1627531","chr11","17033552","17033788","61","15406248","GGCTGGGCACAGTGGCTCACGGCTATAATCTAGGCACTTGGGAGGCTAGGGCAGGTGGATTGCCTGAACTGACAAGTTTGAGACCAACCTGAGCAAGAGCGAGACCCCTGTCTCTAAAACATAGCCAGGCTCTGTGGTGGGCGTCTGTAGTCCCAGCTACTTGGGAGGCTGAGGCAAGAGAATTGCTTGAACTCAAGAGTCTGAGGTTGCTGTGAGTTAAGATGCCAC","GCCCGGCGCAGTGGCTCACGCCTGTAATCCCGGCACTGTGGAGGCCAAGGCAGGCGGATTGCCTAAGCTCAGGGATTCGAGAACAGCCTGGGCAACATGGTGAAACCCCATCTCTACTAAAATACAAAAAACTAGCCGGGCGTGGTGGTATGCGCCTGTAATCCCAGCTACTTGGGAAGCTGAGGCAGGAGAATTGCTTGAACCCGGGAGATGGAGGTTGCAGTGAGCTCAGATCAC"
"GL873585","3626082","3626158","chr1","100916857","100916922","27","97290775","TGCCTGTAATCCCAGCACTTGGGAGGCGGAGGTGGGTAGATTGCCTGACCCAGAGTGGGACCTCATCTCTAAAAGAA","CATGCCTGTAATCCCAGCACCTTGGGAGGCCAAGGTGGGTGGATCACCTGAGGTCAGTAGTTTGAG"
"GL873585","8849829","8849913","chr18","48581945","48582025","18","39732116","GGCTGGACGAGGGGACTCATGCCTGCAATCCCAGCACTGAGAGAGGCCAAGGCAGGTGGATCCCCTGAGCTCAGAAGTTTGAGAC","GCTGGACGCAGTGGCTCACACCTGTAATCCCAGCACTTTGGGAGGCCAAAGCAGGCAGATCTGAGGTCAGGAGTTTGAGAC"
"GL873585","9319890","9319971","chr8","79499361","79499447","14","70179471","GGCCAGGTGTGGTGGCTCACACCTGTCATCCTAGCACTCTGGGAGGACGAGGTGGGTGGACCGCCTGAGTCAGAGTGAGACC","GGCCAGGTGTGGTGGCTCACACCTGTAATCCCAACACTTTGGGAGGCCCAGGTGGGTGGATCACCTGAGGTCAGGAGTTCAAGACCA"
"GL873586","895572","895692","chr17","14501559","14501680","38","13605987","GGCCAGGTGAGGTTTCTCATTCTGGGAGTGAGCCAGCAATTGGGAGGCCAAAGTAAATGGATTGCCTGAGGTTATAGGTTCCAGAACAGCCAGAACAAGATCGAAATCCTGTCTCCAAAAA","GGCCAGGCGTGGTGGCTCATGCGTGTAATCTCAGCACTTTGGAAGGCCGAGGCAGGTGGATCACCCGAGGTCAAGAGTTCAAGACCAGCCTGACCAACATGGCGAGTCTCTGTCTCCACTAA"
"GL873586","5645995","5646150","chr6","58863249","58863409","38","53217254","GGGTATGGTGGCTCATGCCTGTAATCCAAGCACTCTGGGATGGTGAGGCAGGAGAATCCCTTGAACCCAAGAGTCCGAGGTTGCTGCGAGCTAAGCTGATGGCATAACACTCTAGCCTAGGCGACAGAGTGAGACTCTGTTTCCAAAGAGAAAAAA","TTAGCCAGGCATGGTGGCACATGCCAGTAATCCCAGCTACTCAGGAGGATGAGGCAGGAGAATCGCTTGAACCCAGGAGGCAGAGGTTGCAGTGAGCTGAGATTGCGCCACAGCACTCTACCCTGGGTGACAGAAGGAGACTCTGTCTCAAAAAAAAAAAA"
"GL873586","10258686","10258969","chr12","9481260","9481565","81","777426","GGCCGGGCATGGTGGCAGAAATCTAGGAGGCCGAGGCAGGTGGATCGCCTGAGATCACAAGTTCAAGACCAGCCTCAGCTACAGCAAGACCCCATCTCTAAAAATAGCCGGCTGTTGTGGCAGGCGCCTGTAACCCCAGCTACTCGGGAGGCTAAGGCAAGAGAATCGCTTGAGCCCATGAGTCTGAGGTTGCTGCGAGCTGTGACTCCACGGCACTCTACCCGGGGCGATAAAATGAGATTCTGTGTCAAAACAAACAAACAAACAAACAACAACAAAAACAA","GCTGGGCGCGGTGGCTCATGCCTGTAATCCCAGCACTTTGGGAGGCCAAGGCAGGTGGATCACCTGAGGTCAGGAGTTCGAGACCAGCCTAGTCCACATGGTGAAACCCCATCTCTACTAAAAACTAGCCAGGCGTGGTGGTGCGCACCTGTAATCCCAGCTACTCGAGAGGCTGAGGCAGGAGAATCACTTGAGCCTAGGAAGCAGAGGTTGTGGTGAGCTGAGATCACACCACTGCACTCCAGTCTGGGCGACACAGTGAGACTCTTGTCTCAAAAACAAAAAACAAACAAACAAACAAACAAA"
"GL873587","3208032","3208047","chr8","3626746","3626762","2","418714","AAACAACCACAAAAAA","ACAACAACAACAAAAAA"
"GL873587","3208141","3208321","chr19","2057131","2057316","59","1151010","TTTCTTTTAAAAATCACCCATGGGCTGGGTATAGTGGCTCACACCTATAATCCTCGGGAGGCCAAGGTTGGAGGATTGCTTGAATCCAGGAGTTGAAGGTTACAGTGAACTGGGATTTAGCCACTAGACTCTAGCATAGCTGACAAAGCAAGAACCTATTTGTTTAAAACACAAAAAAGAA","TACTAATAATACAAAAATGAGCCGGGTATGGTGGCGGGTGCCTGTAATCCCAGCTACTGAGGAGGCTGAGGCAGGAGACTTGCTTGAACCCAGGAGGTAAAGGTTGCAGTGAGCTGAGATTGCACCACTACACTCCAGCCTGGGCGACAAGAGCAAAACTTTTTCTCCAAAAAAAAAAAAAAAAAA"
"GL873587","3278260","3278367","chr19","19044200","19044312","39","15765940","CAGTCTGAGCAAGAGGGAGAGGCTATTTCTACTAAAAACAGAAAAACTAGCTGGGTGTTGGGGTGTGTTCCTAGTCTCAGTTACTTGGGAGGCTGAAGTAAGAGGATC","ACCAGCCTGGCCAACACGGTGAAATCCCGTCTCTACTAAAAATACAAAAATTACCTAGGCGTGATGGCACGTGCCTGTAGTCCCAGCTACTCATAAGGCAGAGGTGAGAGAAT"
"GL873587","3278673","3278754","chr7","49412503","49412597","28","46133830","GGCCACGAGAGCTAGCTCATGCCTATTCTAGGAGGCCAAAGCAGGCAGACTGCCTGAGCTCAGGAGTTCAAGAGCAGCCTGG","GGCCAGGTGCAGTGGCTCATGCCTGTAATCCGAGCACTTTGAGAGGCCGAGGCAGGCAGATCACCTGAGGTCAGGAGTTCAAGACCAGCCTAGTA"
"GL873587","3782076","3782188","chr9","112128434","112128552","34","108346358","ACTGGGGTGGCTGAGGCAGGAGCGTCACTTGAACTCAGGAGTTTGAGATTGCTGTGAGCTGAGCAGATGTCATGGCACGCTAGCCTAGGTAATAGAGTGAGACTTCGTCTAAA","CAGCTACTCGGGAGGCTGAGGCAGGAGAATCACTTGAACTCGGGAGGCGGAGGTTGCAGTGAGCCGAGATCACGCCATTGCACTCCAGCCTGGGCAACAAGAGCGAAATTCCATCTCAA"
"GL873587","4564996","4565084","chr20","27900350","27900437","14","23335354","GGCGGGGTGTAGTGGCTCATGCCTATTGTCCCAGCACTGTGGGAGGCCGAGGTGGGTGGATCACCTGTGCTCAGAAGTTTGAGACCAGC","GGCCGGGCGTGGTGGCTCATGTCTGTAATCCCAGCACTTTGGGAGGCCGAGGTGGGTGGATCACCTGAGGTCAGGAGTTCAAGACCAG"
"GL873587","6307870","6308175","chr12","112427710","112428020","54","106119840","GGCCAGATATGATGGCTCATGCTTGTAATCCTAGCACTCTGGGAGGCTGAAGTGGGAGGATCACCTGAGATCAGGAGTTCAAGATCACCCTGAGCAAAAGTGAGATCCCATCTCTATTAAAAATAAAAAAATTATCCAGGCATGGTGGTGCAGTCCTTTAGTCCCAGCTACTTGGGAGGCTGAGGCAGGAGAATCTCTTGAACCCAGGAATTAGAGGTTACAGTGAGCTGTGATGATGCTACTGCACTCTAGCAGGATGACAGAGTGAGATACTCCGTGTCAAAAAAAAAAAAAAAAAAAGCAAAA","GGCTGGACATGGTGGTTCATGCTTGTAATCCGAGCACTTTGGGAGGCCAAGGCGGGTGGATCACCTGAGGTTGGGAGTTCGAGACCAGCCTGACCAACATGATGAAACCCCATCTCTACTAAAAATACAAAAAAATTAGCCAGGCATGGTGATGCACGCCTGTAATCCCAGCTACTTGGGAGGCTGAGGCAGGAGAATCACTTGAACCCAGGAGGCAGAGGTTACAGTGAGCCGAGATCATGCCATTGCACTCCAGCCTGGATGACAGAGTGAGCCTCTGTCTCAAAAAAAAAAAAAAAAAAAAAAAAAAA"
"GL873587","6484004","6484128","chr10","67341428","67341546","29","60857424","GACCAGGTTCTGTGGCTCATGCTTGTAATCCTAGCACTCTAGGAGGCCGGAAGAGGGTGGATTGATTGCCTGAGGTCAGGAGTTAGAGACCAGCCTGAGCAAGAGCTAGACCCTGTTTCTTTCTT","GGCTGGGTGTAGTGGCTCATGCCTGTAATCCCAGCACTTTAGGAGGCCAAGGTGGATGGATTGCCTGAGCTCAGGAGTTCGAGACCACCCTGGGCAACAAGCCAAAACCCTGTCTCTAC"
"GL873587","6484407","6484586","chr3","167196537","167196723","48","160712130","TAGACCCTGTTTCTAAAAAAAAAATAGCCAGGTGTTGAGGCAGGTACCTGTAGTCCCAGCTACCTGGGAGGGCTGAGGCAAGAGAATCGCTTGAACCCAAGAGTTTGAGGTTGCTGTGAGCTGAGATGCTATGGCACTCAACCGTGAGCTACAAAGTGAGACTCTGTCTCAAAAAAAAAA","AAAACCTGTCTCTGCTAAAAATACAAAAATTAGCCGGGTGTGGTGATGTGCGCCTGTAGTCCTAGCTACTTGGGAGGCTGAGGCAGGAGAATCACTTGAATCCAGGAGGTGGAGGTTGTAGTGAGTCGAGATCGTGCGACTGCACTCCAGCCTGGGTGACAGCGAGACTCTGTCTCAAAAAAAAAAA"
"GL873587","7466229","7466364","chr1","29437872","29437991","35","21971643","GGCCAGGCGTGGTGGCTCATGCCTGTAGTCCCAGCGCTATGGGAGGCCGAGGTGGGTGGATCACCTGTGCTCAGAGGTTCGAGACCAGCCAAGACCCCCCTGAGCCAAATGAGCCAGAGTGAGATCCCATCTCTAC","GGCCGGGCGTGGTGGCTCACGCCTGTAATCCCAACATTTTGGGAGGCCAAGGCGGGTGGATCACCTGAGGTCAGAAGTTCGAGACCAACCTGGCCAACATGGTGAAACCCCTGTCTCTAC"
"GL873588","1502535","1502718","chr1","34852429","34852590","60","33349894","GGTGCAGTGGCTCACACCTGTTGTCCCAGCGCTGTGGGAGGCCGAGGTGGGTGGATCACCTGTGCTCAGAGGTCGAGACCAGCTGAAGACCTGCCTGAGGCAGAGTGAGCCAGAGTGAGACCCCGTCTCTACTAGAACAACAACAAGACAGCCAGACCTTGTGATCCCAGCTACATGGGGGGCT","GCCAGGTGCAGTGGCTCACACCTGTAATCCCAGCACTTTGGGAGGCCGAGGCGGGCGGATCACCTGAGGTCAGGAGTTTGAGACCAGCTTGACCAACATGGAGAAACCCCGTCTCTACTAAAAATACAAAATTAGCCTGGTGTGGTGTCGCATGCCTGTAAT"
"GL873588","10189037","10189246","chr3","45604681","45604903","65","35415644","GCTGAGATGAGGAGACTCTGTCTCTATTAAAAATAGAAAAATTGGGTGGATGTTGTGGGTACTGTAGTTGCAGCCTCTTGGGGGGCTAAGGCAGGAGGATCAGTTGAAGCCAGGAATTTGCTTTGAGCTAGGCTAAAGCCATGGCACTCTAGCCTGGGCAACAGAGTGAGGCTAGATCTCAAAAAAAGAAAGAAAAGAAAAAGAAAAAAA","CTGGCCAACATGGCAAAACCCCATCTCTACTAAATATACAAAAATTAGCTGGACGTGGTGGCACATACCTGTAATCCCAGCTACTTGGAAGGCTGAGGCAGGAGAATAGCTTGAACCTGGGAGGCAGAGGTTGCAATGAGCTGAGATCACGCCACTGCACTCTAGCCTGGGCAATAGAATGAGACTCTGTCTCAAAAAAAAAAAAAAAAAAAAAGACAAGAAA"
"GL873589","104719","104807","chr20","27900350","27900437","13","27795631","GGCTGGGCGTGGTGGCTCATGCCTGTTGTCCCAGCGCTGTGGGAGGCTGAGGTGGGTGGATCACCTGTGCTCAGAGGTTCGAGACCAGC","GGCCGGGCGTGGTGGCTCATGTCTGTAATCCCAGCACTTTGGGAGGCCGAGGTGGGTGGATCACCTGAGGTCAGGAGTTCAAGACCAG"
"GL873589","796766","796905","chr1","166346372","166346487","49","165549606","GGCTAAGTGTGGTGGCTCACACCTGTCATCTAGTACTTTGGGAGGGTGGGCCTGGGAGTTCAAAGACTGAACTCAGGAGTTCAAGGTGGCTCCGGGGAGGAATTCAAGACCAACCTGAGCCAGAGCGAGACCTCGACTCT","GGCCAGTGGGGTGGCTCACGCCTGTAATCCCAGCACTTTGGGAGGCTGAGGTGGTCAAATGACCTGAGGTCAGGAGTTTGAGACCAACCTGGCCAACATGGTGACACCTCGTCTCT"
"GL873589","1023679","1023690","chr1","205890061","205890072","1","204866382","AAAAAAAAAAAA","ACAAAAAAAAAA"
"GL873589","1023771","1024047","chr4","103012712","103012993","70","101988941","GGCTTGGTGGCTCACACCTGTAATCCTAGCACTCTGGGAGGCCGAAGTGGCTGGAATACTTGAGGTCAGGAGTTCAAGACCAGCCTAAGTGAGAGTGAGATCCCCATCTCTAATAAAAATAGAAAAATTAGCAGGGTGTTGTGGCTGGCACTTGTAGTCCCAGCTACCCAGGAGACCGAGGCAGAAGTTTGAGATTATTGTGAGCGAGGCTGATGCCACAGCATTCTAGTGGGACAACAGAGCAAAATTCTATCTCAAAAGAAAAAAAAAAAAAGGA","CGGGCGTGATGGCTCACGCCTGTAATCCCAACACTTTGGGAAGCCGAGGCGGACGTATCACCTGAGGTCAGGAGTTCAAGACCAGCCTGGCCAACATGGTGAAACCCCGTCTCTACTAAAAATACAAAAATTAGCTGGGTGTGGTGGCATGCGCCTGTAATCCCAGCTACCCAGGAGGCTGAGGCAGGAGAATCGCTGAGGCTGCAGTGAACTGAAATTGTGCCACTGCACTCCAGCCTGGGTGACAGAGCAAGACTCTGTCTCAAAAAAAAAAAAAAAAAA"
"GL873589","4820958","4821024","chr8","33633747","33633811","15","28812789","TTAGTCAAGTGCAGTGGCTCACACCTGTCATCCCAGCTACTTGGGAGGCTGAGGCAGGAGAGTTGCT","TTAGCCAGGTGTGGTGGTGCATGCCTCTAATCCCAGCTACTCAGGAGGCTGAGGCAGGAGAATTG"
"GL873589","6763768","6763857","chrX","25814002","25814092","29","19050234","GGTGTGGTGGCTCACACTTGTATCTTAGCATTTTAGGAGGCTGAATGGGGAGAATTGCTTTAAGTCAGGAGTCTGACTTCCACCTTGCCA","GGCTGGGAATGGTGGCTCACACCTGTAATCCCAGCACTTTGGGAGGCTGAGGTGGGCAGATCACCTGAGGTCAGGAGTTTGAGATCAGCCT"
"GL873589","8444551","8444632","chr9","93194085","93194171","17","84749534","CGGGCATGGTGGCTCACAACTATAATCTTAGCACTTTGGGAGGCTGAGACAGGTGGATGCCTGAACTCAAGAGTTTGAAACC","GGCCGAGCATGGTGGCTCACACCTGTAATCCCAGCACTTTGGGAGGCTGAGGCAGGTGGATTACCTGAGGTCAAGAGTTCAAGACCA"
"GL873589","9085365","9085494","chr2","194063347","194063481","42","184977982","GGCCAGGCACAGTGGCTCACACCTATAATCCCAGCACTCTGTGAGACTGAGGCAGGTGAACTGTTGCAAGAGTGAGACCCTGTGCTTGGTGCCTGTAGCTCAGTGGTTAATAATAAGAAAAAAGAAAAAA","GGCCAGGTGCAGTGGCTCACACCTGTAATCCCAGCACTTTGGGAGTCTGAACCAGGCAGATCACCTGAGGTCAGGAGTTCGAGGCCAGCTCGGCCACCATGGTGAAACCCTGTTTCTAATAAGAATACAAAAAAA"
"GL873589","9085767","9086002","chr7","84631446","84631650","75","75545679","GAGTGAAACCCTGTCTCTACTAAAAATAGAAAAACTAGCTGTGCATCAGGGCGCATAACTGTAGTCCCAGGTACTCAGGACACTGAGGCAAGAGAATTGCTCAAGCCCAAGAGTTTGCAAGAATTTGAGGTTGCTATGAGCTATGATGCCATGGCACTCTACCTAGGGTGACAGACAGAGACTCTGTCCCAAAAAAAAAAAAAGAAGAAGAAGAAAAAAAAAAAGAAAGAAAGAAA","ATAGTGAAACCTCGTCTCTACTAAAAATACAAAAATTAGCTGGGCATCATGGTGCACGCTTGTAATTCCAGCTACTTGGGAGGCTGAGGCAGGAGAATTGCTTGAACTCAGGAGGTGGAGGTTGCAATGAGCCAAGATCGCGCCACTGCACACCAGCCTGGGTGACAAAAGACTCTGTCTCAAAAAAAAAAAAAAAAAAAAAAAA"
"GL873589","9992904","9993045","chr16","56427538","56427666","46","46434634","AACCAGCCAGGCATGGTGATTCACACCTATAATCCCAGCTACTTAGGAGTATGGCTTGAGCACACAGGATACCATACCATTCTAGTCATCCCAGGCAACAGAGGGAAACTCTGTTGGTTAAAAAAAAAGAAAAACTTAAAAA","TTAGCCAGGAGTGGTGGTGCACGCCTATAATCCCAGCTACTTGGGAGGCTGAGGCACAAGAATCACTTGAACCATTGCACTCCAGCCAGGGTGATAGAGGGAGACTCTATCCAAAAAAAAAACAAAAAA"
"GL873589","9993319","9993452","chr3","2774534","2774668","28","7218785","GGCCTGAGCCCTGTGACTCATGCCTGTAATCCCAGCACTGGAAGTTCCAAGGCAGGTGGATCGCTTGAGCTCTGGAGTTCAAGACCAGCTCAACCAAGAGTAAGACCCCATCTCTACTAAAAATAGAAAAACCA","GGCTGGGCACGGTGGCTCATGCCTGTAATCCCAGCACTTTGAGAGGCCGAGGCAGGTGGATCTCCTGAGGTCAGGAGTTCAAGACCAGCCTGGGCAACATGGTGAAACCCCATCTCTACTAAAAATACAAAAAAT"
"GL873590","9044589","9044884","chr1","83754525","83754835","84","74709936","GGCCAGGTGCAATGGCTCATGCCTATAATCCTCACACTCTGGGAGGCTGAGGCAGGAGGATCACTTTTCTCAGGGTCAGGGCCAGCCTGACAAAAGTCAGACCCTGTTTCTACTAAAAATAGAAAAACTAGCTGGGTGTTGTGGCAGATGCCTATAGTCCCAGCTACTAAGAGACTGAGACAAGTGCCCAGAGTCTGAGGTTACTGTGAGCAAAGCTGATGCCATAGCATTCTAGCTATAGATCGAGAGTCTGTCTCAAAAACAAACAAACAAACAAACAAACAAACAAAAAAGAA","GGCTGGGTGTGGTGGCTCATGCCTGTAATCCCAGCACTTTGGGAGGCCGAGGCGGGTGGATCATCTGAGGTCAGGAGTTCAAGACCAGCCTGACCAACATGGTGTAACCCTGTCTCAACTAAAAATACAAAAATTAGCTGGGCGTGGTGGTGTGCACCTATAGTCACAGCTACTTGGGAGGCTGAGACAGGAGAATTGCTTCAACCCAGGAAGTGGAGGTTGCAGTGAGCCAAGATCATGTCACTGCACTGCAGCCTGACAGAGCGAGACTCCATCTAAAACAAACAAACAAAAACAAACAAACAAACAAA"
"GL873591","1831505","1831587","chr17","61702818","61702899","25","59871313","CCCAGCACTTTGGGAGGGCAAGATGGGAGAATCATATAAAGTCAGGAGTTTGAGACCAGTTTGGCAGACATGATGAACCCATC","AATCCCAGCACTTTGGGAGGCTGAGGCAGGCGGATCATCTGAGGTCAGGAGTTCAAGACCAGCCTGGCCAACATGGTGAAAC"
"GL873591","2719175","2719275","chr4","86137755","86137847","32","83418580","GTGGGGGCTTAGGCCTGTAATCCCAGCACTCTGAGAGGCCAAGGTGAGCTGGTCACCTGGGTTTAGGAGTTTGGAGACTTGCTCGAGCTAGACTGAGGCTC","GTGGTGGCTCACGCCTGTAACCCTAACAATTTGGGAGGCCAAGGCAGGTGGATCACTTGAGGTCAGAAGTTTGAGACCAGCCTGGACAATATG"
"GL873591","4732974","4733120","chr19","7991801","7991954","55","3258827","ATACGCAGACTGGCCGAGCGTGGTGTCACATGCCTATAATCCCAGTGGCTACTCTGGGGAGGAGAATCTCTTGAAACCAAGAGTTAGAGATTGCAGTGGGGTATGATACAGGGTAACAAAGAGAGACCTTGGATCTGAAAAGAAAAA","AAAATACAGAAACTAGCTGGGCATGGTGATGCACACCTGTAATCCTAGCTACTGGGGAGGCTGAGGCAGGAGAATTGCTTGAACCCAGGAGTCAGAGGTTGCAGTGAGCAACCAGCCTGGGTGATACAGTGAGTGAGACTCTGTCTCGAAAAAA"
"GL873591","6822728","6823009","chr1","20579766","20580052","72","13757038","GGCCAGGCGTGGTGGCTCATGCCTGTAAATCTCAGCACTCTGGGAAGCTGAGGCAGGTGGATTGCTTGAGGTCAGGAGTTTGAGACCAGCCTGTACCAGAGTAAGACCCTGTCTCTAATAAAAATAGAAAAAAAAAAAAAAACTAGTTGGGCATGGTGATGGGTGCCTGTAGTCCCACCTACTTGGGAGGCTGAGGCAATGGCATCTCTTGAGCCCAAGAGTTTGAGGTTGCTGTGCCATGGCACTCTCCCCAGGGTAACAGAGTGAAAATAAAAAAAAGAA","GGCCAGGCGTGGTGACTCATGCCTGTAATCTCAGCACTTTGGGAGGCCGAGGCAGGTGAATCACCTGAGGTCAGGAGTTTGAGACCAGCCTGACCAACATGGTGAAACCTCGTCTCTACTAAAAATACAAAAAGTAGCCAGGCATGGTGGCGCATGCCTGTAATCCCAGCTACTTGGGAGGCTGAGGCAGGAGAATCGCTTGAACCCGAGAGGCAGAGGTTGCATTGAGTCAAGATGGTACCACTGCACTCCAGCCTGGGTGACAGATTGAGACTCAAAAAAAAAAA"
"GL873591","7578706","7578813","chr16","45055441","45055543","42","37476735","AAATTTAGCTACACATAGTGGCATGAGTCTGTAATGCTAGCCACCCAAAAGGCTGTAGTAAGAGGATTGCTCTATCCCAGGAGTTAAAGACCAGCCCGGACATCAGAG","AATTAGCCGGGCGTGGTGACACACACTTGTAATCCTAGATACTCAGGAGGCGAAGGTAGGAGAATTGCTTGAACCCAGGCAGCAGAGGTTGCAACGAGCAGAG"
"GL873591","9282916","9283004","chr1","20744253","20744338","16","11461337","GGCCAGGCGCGGTGGCTCACCCCTGTTGTCCCAGTTCTGTGGGAGGCCGAGGTGGGTGGATCACCTGTGCTCAGAGGTTTGAGACCAGC","GGCCAGGCACGGTGGCCACGCCTGTAATCCCAGCACTTTGGGAGGCCGAAGTGGGTGGATTACCTGAGGTCAAGAGTTTGAGACCA"
"GL873592","835155","835315","chr16","75654291","75654451","43","74819136","CTGGGTGTGGTGGCTCTTGTCTGCAATCTCAGTACACTGGGAGGCTGAGGCAGAAGGATTGCTCCAGCTCAGGAGTTTGAGGCCAGGCTGAGCTAGTGCAAAACCCCATCTCTACTAAAAAAAGAAGGAAAAAAAAAAGAAAAAGAAAAAAAATACGAGCT","CCAGGTGTGGTGACTCACGCCTGCAATCCCAGCACTCTGGGAGGCTGAGGTGGGTAGATTACCGGAGGTTAGGCGTTTGAGACCAGCCTGGCCAACATGGTGAAACCCCATCGCTACTAAAAAAAAAAAAAAAAAAAAAAAAAAAAAAAAAAAAAAAATTA"
"GL873592","835589","835765","chr1","66836166","66836336","48","66000577","ACAAAAAACCTAGCTTAGGGTTGTTATAGCACCTGTAGTCCCAGCTACTCAGGCGCTAAGGCAGGAAAATCTGCCTGAGCTCAGGAGTTTGAGGTTGCAGTAAGTTATGATGATGCTACTGCACTCTAGCTGGGGCAACAGAGTGAGACTCTGTCTGAGGAAAAACCAAAACCAAAA","TAGCCCAGCACGGTGGCTCACACCTGTAGTCTCAGCTACTCAAGAGGCTGAGGCATGAGAATCGCTTGAACCCAGGAGGTAGAGGTTGCAGTGAGCTGAGATCATGCCACTGCGCTCCAGCCTGGGCAACAGAGTGAGACTCAGTCTCAAAAAACAAAACAAAACAAAAAA"
"GL873592","2520661","2520705","chr16","66853217","66853257","11","64332556","TCTGGGAGGCTGAGGCGGGTGGATCACCTGAGCAAGAGTGAGACC","TTTGGGAGGCTGAGGCAGGTGGATCACTTGAGGTCAGGAGT"
"GL873592","4535248","4535388","chr1","12240468","12240612","38","7705220","GGCGGGATGTGGTGGTTCATGGCTGTAATCCCAGCACTCAGGGAGGCTGAGTCGGGTGGATTGCTTGAGTTCAGGAGTTTGAGACCAACCTGAGCAAGAACTAAGCCTGTCTCTACTAAAGATATTATTTCTTATTTTTCT","GGCCGGGCGCGGTGGCTCATGCCTGTAATCCCAGCACTTTGGGAGGCTGAGGCGGGTGGATCACCTGCGGTCAGGAGTTCGAGACCAGCCTGGCCAACGTGGTGAAACCTCATCTCTACTAAAAATATAAAAATTAGCTGGTGTG"
"GL873592","4535654","4535831","chr8","126054004","126054184","54","121518350","TCTACTACAAATATTAACAGAAAAATTAGCTGGGCATTGTGACAGGTGCCTATAGTCCCAGATACTCAGAAGGCTGAAGTAAGAGGATCACTTGAACCCCAGGAGCTAAGGTGGCTGTGAGCTAGGCTGAGGCTCTAGCCTGGGTAACAGAGTGAGACTGTAAAAAAAGAAAGAGAGA","GTCTCTACTAAAAATACAAAAATTAGCTGGGTGTGGTGGTGCATGCCTGTAATCCCAGCTACTCAGGAGGCTGAGGCAGGAGAATCGCTTGAACCCAGGAGGTAGAGGTTGCAGTGAGCCAAGATCATGCCACTGCACTCCAGCCTGGGTGACAGAGGGAGACTCTGTCTCAATAAATAAA"
"GL873592","6794968","6795049","chr3","154764711","154764794","20","147969743","GAAGGTTTGATGAGCTCAGATGATGCCACTGCAGTCTACCCAGAGTGAAGGAGCGAGACTCTGTCTCAAAAACAAAAAAAGA","CAGAGGTTGGCAGTGAGCTGAGACTGTGCCACTGCACTCCAGCCGGGTGACAGAGTGAGACTCTGTCTCAAATTACAAACAAAA"
"GL873592","6881384","6881478","chr5","24882384","24882475","28","18001000","GGGCAGGCATAGTGACTGGTGTCTCTAATCCTAGCAGTCTGGGATGCTGAGGCAAGTGGAATGTCAGAGTTCAGGAGTTGAAGATCACCCTGACT","GGCCGGGCGCAGTGGCTCACATCTATAATCCTAGCATTTTGGGAGGCTGAGGCAGGCGGATCACCTGAAGTCAGGAGTTTAAGACCAGCCTG"
"GL873592","6881755","6881937","chr10","61601371","61601572","66","54719616","TCACCCTGACCAAGAGCAAGACCCTGTCTCTACTAAAAATAGAATAAACTAGCTGGGAATTGTGGTGGGTGCCAGTAGTCCCCGCTACTGAGGCAGGAGGATCATTGAGTCCAAGAGTTTGAGGTTGCTGTAAGTTAGGACACCACAGCACTCTACACAGAGTAAGACTGCCTCAAAAATAAA","AGTAAAGAAAAGAAACCCTGTCTCTACTAAAAATACAAAAATTAGCTGGGTGTGGTGGTGCGCACCTGTAGTCCCAGCTACTTGGGAGGGTGAGGTATGGGAATCACTTGAACCCGGGAGGTGGAGGTTGCAGTGAGCCAAGATCACACCACTGCACTCCAGCCTGGGTGAGAGAGTGAGACTCTGTCTCAAGAAAAAAGAA"
"GL873592","7006080","7006155","chr1","8947061","8947129","24","1940981","CACACTGAGAGGCAAAGGCTGGTGGATCACCTGAGCTCAAGAGTTTGAGACCAGCCAAGCCAGAGATCTTGTCTCT","CACTTTGGAGCCAGGTAGGTGATCACCTGAGTCAGGAGTTCGAGACAGCCTGGCCAACATGTGAAACCC"
"GL873592","8446508","8446655","chr11","122502739","122502874","48","114056231","TTAGCTGGGTGTTGTGGCAGGCACCTGTAGTCCCTCCCAGCTACTTGAAAGGCTGAGGCAAGATGACAGCTTAAACCCAAGAGTTTAAGGTTACTCTATTCAGGGCAACAGAGTGAGACTCCATCTACATAAATAAATAAATAAATAA","GGCTGGGCGTGGTGGTTCACACCTGTAATCCCAACACTTTGGGAGGCTGAGGCCAGCGGATTGCCTGAGCCCAGGAGTTTGAGACCAACCTGGGCAACATGGTGAAACTCCATCTCTACTAAAATACAAAAAGTTA"
"GL873592","8446953","8447008","chr16","44513352","44513404","15","36066399","GACCAGCCTAAGCAAAAAAGAGATCCTATCTCTACTACTAAAAATAGAAAAAATTA","ACCAGCCTCACCAATATGAAGAAACCCCATCTCTACTAAAAATACAAAATATT"
"GL873592","8447239","8447325","chr1","8062863","8062957","21","384376","GGCCAGGAGCAGTGACTCATGCCTAGCACTCTGGGAGGCCAAAGCAGGTGGATCAACTGAGCTCAGGAGTTCAAGACCAGCCTAAGC","GGCCGGGTGCAGTGGCTCATGCCTGTAGTCCCAGGACTTTGGCAGGCCAAGGCCGGTGGATTACCTGAGGTCAGGAGTTCAAAACCAGCCTAGCC"
"GL873592","8723925","8724000","chr3","42066983","42067054","20","33343058","AATTAGCCGGGCATGGTAGTGTGTGCCCATAATCTCAGCTACTCAGAAAGCTAAGATAGGAAAATTGCTTGAGCTC","TTAGCTGGGTGTGGTAGTGCATGCCTATAATCCCAGCTACTCGGGAGGCTGAGGTGGGAGAACTGCTTGAAC"
"GL873593","384022","384146","chr15","102382935","102383070","28","101998913","GGCCACGAGGGCCCATGCCTGTAATCCTAGCACTCTGGGAGGCTGAGGTGAGTAGATTGCTGAGCTCAGGAGTTCAAGACCAGCCTGTGCAAGAGACCCCATCTCTGCTAAAAATAGAAAAACCA","GGCCAGGTGTGGTGGCTCACGCCTGTAATCCTAGCACTTTGGGAGGCTGAGGCGGGTGGATTGCCTGAACTCAGGAGGTCAAGACCAGCCTGGGCAACACAGTAAAACCCCATCTCTACTAAAATACAAAAAATCA"
"GL873593","384425","384607","chr20","28286874","28287058","50","27902449","GAAAGAAAAGAAAAGAAAAACTAGCAAGATGTTGTAGCTGATGCCTATAATCCTAGCTATTGGAGAGGTGGAGGCAAGAGAATTGCGTGAGCCCAAGAGTTGAAGGTTGCTGTGAGCTGCGATGCCAGAGCACTCCAGGGTGACAGAGTAAGACTCTGTCTCAAAAAAAATTACAAAATAAAA","TAATAAAAATAAAAAAATTAGCCAGGAGTCAAAGCACACGCCTATAACCCCAGCTACTTGGGAGGCTGAGGGAGGAGAATTACTTGAACCCGGGAGGTGAAAGTTGCAATGAGCTGAGATCAAGCCACTGCACTCCAGACTGGATGACAGAGTGAGACTCTGTTTCAAAAAAAAAAAAAAGACAA"
"GL873593","1408445","1408467","chr10","88070368","88070389","9","86661923","AATCTAGAGATGGGGAGAGGTTG","AAAGAGATGGAAGAGAAGAAGA"
"GL873593","4856365","4856484","chr7","56497314","56497433","31","51640949","GCAATCCCAGCTGATCGGGAGGCTGACCCAGAAGAATCCCTTGAACCCAAGAGTCTGAGGTTGCTATGGGTGGATTCTACAGCACTCTAGCCTGGGAGACAGAGTGAGACTCTGTCCCAA","ATCCCAGCTACTTGGGAGGCTGAGACAGAAGAATTGCTTGAACCCGGGAGGTGGAGGTTGCAGTGAGCCAAGATTGTACCACTGCACTCCAGCCTGGCAACAGAGTGAGACTCTGTCTCA"
"GL873593","6661298","6661485","chr10","86749316","86749514","55","80088018","GCAGAGGCTCACATATGTAATCCTAGCACTCTGGGAGGATAAGGCAGGTGGACAGCTTGAGCTCAGGGGTTTGACCAGTCTGATCAAGAGCAAGACCTGTGTCTACTAAAAATAGAAAACCTAGCCAGGTATGATGGTAGATGCCTGTATTCCTAGCTACTCTGGAAGCTAAAGCTAAAGAGTTTGAA","GGTGGCTCACACCTGTAATCTTAGCAATTTGGGAGGCCGAGGTGGGTGGATCACTTGAGGTCAGGAGTTTGAGACCAGACTGGCCAACATGGTGAAACTCTGTCTCTACTAAAAATACAAAAATTAGCCAGTCATGGTGGTGCATGCCTGTAATCCCAGCTACTCAGGAAGCTTAGGCAGGAGAATCACTTGAACCCAG"
"GL873593","6710263","6710446","chr14","4390080","4390244","66","2320183","TTGAAGTCAGGAGTTTAAGGCCAGTCTGGGCAACATAGTGAGACCCCCATCTCTACGAAAATATTTTTTAAAAATTAAAAATAGCTGGGCATAGTGAGGCTGTTGTGAGCTATAACTGCACCACTGCACTCAGCCAAGGACAGAGACCCTGTTCCCTGCCTCAAACAAACCAAAACAAAACAAA","AAGTCTAGAGTTTACAGCCTGGACAACGCAGTGAAACCCTGTCTCTACCAAAAATACAAAAATTAGACAGGTGTGAGAGGCGGAGGTTGCAATGAGCTGAGATCGCAGCACTGCAGTCCAGCCTGGATGACAGAGCGAGACCCCATCTCAAAAACAAAAACAAAA"
"GL873593","7159645","7159716","chr6","178318394","178318465","21","171158749","GATCATGTCACTGCTCTCCAACCTGGGCAATTGAGCAGGAATCTGTCTCAAAAAGAAAAAAAAAAAAGAAAA","CGAGTTCACACCACTGCACCCCAGCCTGGGCAACAGAATGAGACTCGGTTTCAAAAAAAAAAAAAAAAAAAA"
"GL873593","7159841","7160050","chr13","33368171","33368368","69","26208330","GGCCAGGCGTGGTGGCTCACACCTGTTGTCCCAGTGCTGTGGGAAGCCGAGGCAGGTGGATCACCTGAGCTCAGCCGAGTTCGAGACCAGTGGAAGACCAGCATGAGGCAGAGTGAGCCAGAGTGAGACCCCATCTCTACAACAACAACAAGAAGAAAAAAAACAGCCGGACCTTGTGATCCCAGCTACGTGGGGAGCTAGAGAATCACT","GGCTAGGCATGGTGGCTCATGCCAGTAATCCCACCACTTTGGGAGGCCGAGGCAGGTGGATCACCTGAGGTCAGGAGTTCAAGACCAGGCTGGCCAACATGTTATGATGAGACCCTCATCTCTACTACAAATACAAAAATCAGCTGGGCATGGTGGCAAGTGCCTGTAATCCCAGCTACTTGGGAGGCTGAGGCAGAA"
"GL873593","8598292","8598391","chr11","118461023","118461129","33","109862731","AGCCAGGTGAGGTGGTTCACACCTGTAACCCTAGCTGCTTGGGAGGCTGAGGCCTCTCTATCCTGGGCAGTGTGGAGAAACTTTGTTTCAAAAAAAAGAA","GCCGGGCGCGGTGGCTCACGTCTGTAATCCCAGCGCTTTGGGAAGCCGAGGCGGGACTATCCTGGCCAACATGGTGAAACCCCGTCTCTACTAAAAATACAAGAATC"
"GL873594","357249","357377","chr2","75702890","75703011","36","75345641","CCTGGTACCGTAGGTCATGCCTGTAATCCTAGCACTTTGGGATGCTGAGGTGGGCAGATTGCCTGAGCTCACGAGTTCAAGCCATTAGAACTGAGCCTGACCTAGAGTGGGACCTCCAACTCTTTTTTT","GCCAGGCACAGTGGCTCATGCCTGTAATCCCAGCAGTTTGGGAGGCTGAGGTGGGCAGATCACTTGAGGTCAGGAGTTCAAGACCAGCCTGGCTGACATGGTGAAACCCCATCTATACCAAA"
"GL873594","357656","357834","chr7","17608776","17608965","55","17251120","GGGACCTCCAACTCTTAAAATAGCTGGGCATTGTGGTGGGCACCTACAGTCACAGCTACTTGGGAGGCTAAGGCAAGAGACTTGTTTGCAGCCAAGAGTTAGAGGTTGCTGTGAGCTATGAGGCTAGGGCACTCTACAGGGGGCGACAAGTGAGACTGTAAAAAAAAAAAAAGAAAAAA","GTCCCTACTAAAAATACAAAAAATTAGCTGGGCCTGGTGGCAGGCACCTGTAATCCCAGCTACTTGGGAAGCTGAGGCAAGAGAATTGCTTGAACCCAGGAGGCAGAGGTTGCAGTGAGCTGACATCAAGCCACTGTACTCCAGCCTAGGCAACAAGAGCAAGACTCTGTCTCAAAAAAAAAAAAAAAAA"
"GL873594","1410711","1410996","chr5","151340503","151340797","76","149929792","CACAGTGGCTCATACCTATAATCCTAACACTCTGGGAGGCCAAGGTGGGTGGACTGTCTGAGTTTGGGACCAGCCTGAGCAAAAGCAAGACTCCCATCTCTACTAAAAACAAAGACAGCCAGGTATGAGGGCAGGTGCCTATCATCCCAGCTACTTGGGAGGCTGAGGAAGGAGGATCACCTAAGCCCAGGACTTTAAGGTTTCTGTGAACTAAGATGATGTTACAACACTCTAGCCAGGGTAACAAGGCAAGATTCTGTTTCAAAAGACAAAAAAAAAAAAAAAA","GGTGGTTCATGCCTGTAATCCCAGCACTTTGGGAGGCTGAGGCAGGTGGATCACCTGAGGTCAGGAGTTCGGGACCAGCCTGGCCAACATGGGGAAACCCCATCTCTACTAAAATACAAAAATTAGCCAGGTATGGTGGCACATGCCTATAATCCCAGCTACTTGGGAGGCTGAGGCAGGAGAATCACTTGAACCCAGGAGGCTAAGGTTGCAGTGAGCCGAGATTGTGCCACTGTACTCCAGCCTGGGTGACAGACTGAAACTCTGTGTCCAAAAAACAAAACAAAACAAAAAA"
"GL873594","5528090","5528162","chr2","69013639","69013718","24","63485549","GGTACAGTGGCTCACGCTTGTGATCCCAGGTTGAGGTGGGTGGATCGCCTGAGCTCAGGAGTTGGATGCCAGC","GGTGTGGTGCCTCACGCCTATAATCCCAGCACTTTGGGAGGCAGGTGGATCACTTGAGGTCAGGAGTTTGAGAACAGCCT"
"GL873594","5834047","5834168","chr2","82491537","82491662","28","76657490","GGCTGGGCCCAGTAGCTCACGACTGTAATCCCAGCACTCTGGGAAGCTGAGGTGGGCGGATCACCTGAGCTCATAGGTTCGAGACCAGCTCCAGTTAGAGTGAGAGCCTGTCTCTAAAAATA","GGCTGGGCACAGTGGCTCATGCCTGCAATCCCAGCACTTTGGGAGGCTGAGGTGGGCAGATCACCTGAAGTCAGGAGTTCAAGACCAGCCTGGCCAACACAGTGAAACCCCATCTCTACTAAAAAT"
"GL873594","5834396","5834461","chr13","14688151","14688212","20","8853755","TATATAATAATAATAACCAGGTATTGTGGCAGGTGCCTCTAGTCCCAGCTACTCGGGAGGCAAAGG","ATAAAAAAATTAGCTGGCCATGGTGGCACATACCAATAATCCCAGCTACTCAGGAGGCTGAG"
"GL873594","7786130","7786294","chr14","12217087","12217250","37","4430957","GGGTGTGCTGGCTCATACCTATAATCCTAGCACTCTGGGAGGCTGAGGTAGGTGTATTGCTTGAACCCAGGAGTCTGAGGTTGCTGTGCGCTAAGCTGATACCATAGCACTCTAGCCTGGGCAACAGAGTGAGACTCTGTCTCAAAACAAATAAATAGTAAAAAA","GCTGGGCGTGGTGGCTCACACCTGTAATCCCAGCACTTTGGGAGGCCAAGGCATGAGAATTGCTTGAAAACAGGAGGCGGAGGTTGCAGTAAGCTGAGACTGTGCCATTGCACTCCAGCCTGGGCAACAAGAGTGAAACTCTGTCTCAGAAAAAAAGAAAAAAA"
"GL873595","723579","723774","chr19","6045933","6046125","65","5322354","GCCTGAGCAGGAGAGAGACCCCATCTCTGCTGAAAGTGGAAAAGTTGGCTGAGTGTAGTGGCGGGCTGCTGCCCCAGTCACTCAGGAGGCTTAGGAAGGAGTATCGCTTGGGCCCAAGATTTGAGGTTGCTGTGAGCGCTACAAAGACATTAGGGTACTCTACACAGGGGAATAGAGTGAGACTGTCTCAAAAAAA","CAACATGGAGAAACCCCGTCTCTACTAAAAATACAAAATTAGGCAGCGTGGTGGTGGGTGCCTATAATCCCAGCTACTCAGGAGGCTGAGGCAGGAGAATCGCTTGACCGGGAGTGGAGGTTGCGGTGAGCTGAGATTGCACCATTGCACTCCAGCCTGGGCAACAAGAGTGAAACTCCGTCTCAAAAAGAAA"
"GL873595","724114","724204","chr20","18199749","18199840","22","17475635","GGCCATGCTTGGTGGTTCTCATCTGTAATCCTAGCACTCTGGAAGGTCTACAGGGGTGGATGGCTGGAGGTCAGGAGTTCAAGACTGGCCT","GGCCGGGCATGGTGGCTCACACCTGTAATCCCAGCACTTTGGGAGGCTGAGGCAGGCGGATCACCTGAGGTCAGGAGTTCGAGACCGGCCTG"
"GL873595","1065346","1065667","chr18","10529729","10530057","74","9464383","GGCCAGGTGCAGCAGCTCATGCCTGGAATCTTCCTGCTCTGTATGGCCAAGGCAGGTGGATCGCCTGACCTCAGGAGTTCCAGACCAGCCTGAACAAGAGCAAGACTCTGTCTCTACTAAAAGTAGAAAAAAAACTAGCCAGTCATAGTGGCAGGTGCCTGTAGTCCCAGCTGCTTGGGAGGCTGAGGCAAGAGGATCACTTGAACCTAAGAGTTTGAGGTTGCTGTGAGCTAAGATGCCACATCACTCTATCAAGGGTGACCAAGTGAGACTCTGTCTCAAAAATAAATAAATAAATAAATAAAAAGAAAGGCAAAAAGAA","GGCCCGGCGTGGTGGCTCATGCCTATAATCCCAGCCCTTTGGGAGGCCAAGGCAGGTGGATCACCTGAGGTCAGGCGTTCGAGACCAGCCTGACCAACGTGGTGAAACCTCATCTCTACTAAATACAAAAAAAATTTAGCCAGGCATGGAGGCACATGCCTGTAATCCCAGCTACTTGGGAGGCTGTGGCAGGAGAATCACTTGAACCTGGGAGGTGGAAGTTGCAGTGAGCTGAGATTGTACCACTGCACTCCAACCTGGGTGACAAAGCAAGACTCGGTCTCAATAAATAAATAAATAAATAAATAAATAAATAAAGTGAAAAAAAA"
"GL873595","1254878","1255146","chr4","42822326","42822607","67","41567448","GGCTGGGCATGGTGGCTCATGCCTGTAATCCTACCGCTCTGGGAGGCTGAGGCAGAGGATCACTTGAGCTCAGGAGTTTCAGACCAGCCTGCAAGAAGGACCCAGTCTCTGCCGAAAATAGAAAAGTTAGCAAGGCGTTGTCGTGAGCACATGTATCCCAGCTACCTAGAACTCTGAGGCAGGAGGATCCCTTGAACCCACAGAAGTTGCTGTTATCTAAACTGATGCCACTGGACTCTAGCCTGGGCAACAGAGTGAGACTGGTCTCA","GGCCGGGCACGGTGGCTCATGCCTGTAATCCTAGCATTTTGGGAGGCTGAGACAGGCAGATTGCCTGAGCTCAGGAGTTCAAGACCAGCCTGGGCTAGATTGTGAAACCCCATCTCTACTAAAATATAAAAATTAGCTGGGTGTGGTGGCACACGCCTGTAATCCCAGCTACCTGGGAGGCTGAGGCAGGAGAATCGCTTGAACCAGGAGACAGAGGTTGCAGTGAGCTGAGATCACGCCACTGCACTTTAGCCTGGGCAACAGAGTGATACTCTGTCTCAA"
"GL873595","3417105","3417297","chr12","115674238","115674427","44","112257133","GGCCGGGCGCTGTGCCTCACGCCTGTAATCCTAATACTCTGAGAGGCCGAGGCAGGTGGATTGCCTGAGCTCAGGTGCTCAAGACAGCCTGACTGAGCAAGCCCTGAGATCCCATCTCCACTAACAATAGTAAAACTAGCCGGGCATTGTGGTGGTGCTTGTAATCCCAGCTACTGGGAGGCTAAGACAGGAG","CCAGGCCTGGTGGCTCACGCCTGTAATCCCAGCACTTTGGGAGGCCGAGGTGGGTAGATCACCTGAGGTCAGGAGTTCAAGACCAGCCTGGCCAACATGGCGAAACCCCATCTCTACTAAAAATACAAAAATTAGCTGGGCATGGTGGTGTATGCCTGTAATCCCAGCTACTCGGGAGGCTGAGGCAGGA"
"GL873595","6098380","6098457","chr3","87492619","87492702","21","81394239","GCTGTGGCTCATGCTGATAATACCAGCACTCTGGGAGAACAAGGTAGGCAGATCACAAGAGGTCACCTGTGCAAGACC","GGGCTGGTGGTGGCTCATGCCTGTAATACCAGCACTTTGGGAGGCCAAGACAGGTGGATCACCAAAGGTCAAGAGTTCAAGACC"
"GL873596","134190","134307","chr1","203207333","203207443","31","203073143","GGCTGGGCGAGGTGGCTCACACCTGTAATCCTAGCACTCTGGAAGGCCCTAGCACTCAGGCAGTTGGATTGCCTGAGCTCACAAGTTCAAGACCAGCCTGAAAAAGAGCAAGACCTCA","GGCTGGGTGCAGTGGCTCACACCTGTAATCCCAGCACTTTGGGAGGCCGAGATGGGTGGATCACTTGAGGTCAAGAGTTGAAGACCAGCCTGGACAACATGATGAGACCCC"
"GL873596","134578","134681","chr11","50235285","50235387","37","50100707","CAAACAAAAGAGGAAGACCTCGTCTCTAAAAAAATAGCTGGGCATTGTGAGGAGTACCTGTAGTCCTAGCTACTCAGAAGGCTGAGACAAGAGAATCACTTAAA","CAACATTGTGAAACCCTGTCTCTACTAAAATAGAAAATTAGCCAGGTGTGTGGGCGTGCCTATAATCCTAGCTACTGGGGAGGGTGAGGCATGAGAATCGCCT"
"GL873596","8160215","8160350","chr1","29437872","29437991","30","21277657","GGCCGGGCGTGGTGGCGCACACCTGTAGTCCCAGCGCTATGGGAGGCCGAGGCGGGTGGATCACCTGAGCTCAGAGGTTCGAGACCAGCCAAGACCCCCCTGAGCCAAACGAGCCAGAGTGAGACCCCGTCTCTAC","GGCCGGGCGTGGTGGCTCACGCCTGTAATCCCAACATTTTGGGAGGCCAAGGCGGGTGGATCACCTGAGGTCAGAAGTTCGAGACCAACCTGGCCAACATGGTGAAACCCCTGTCTCTAC"
"GL873596","8421071","8421132","chr20","1874027","1874093","12","6547044","GTCAGGCGCAGTGGCTCACGCCTGTAATCTCAGCACTCTGAGAAGCCAAGGCAGGATCATCT","GGCCAGGCGCAGTGGCTCAGGCCTGTAATCCCAGCACTTTGGGAAGCCAAGGTGAGCAGATCACCTG"
"GL873598","4416400","4416489","chr5","39418145","39418231","15","35001745","GGCCAAGTGTGGTGGCTCATGCCTGTTGTCCCAGCACCGTGGGAGGCCGAGGCTGGTGGAACACCTGAGCTCAGCTGAGTTTGAGACCAG","GGCCAGTTGCGGTGGCTCATGCCTGTAATCCCAGCACTTTGGCAGGCTGAGGCAGGTGGATCACCTGAGGTCAGGAGTTTGAGACCA"
"GL873598","4416855","4416947","chr3","94091253","94091337","31","89674398","GTGAGACCCTGTCTCTACAAAAAAAAAAGCTGGGCACTGTGGCATGTGCCTGTAATCCCAGCTACTTGGGAGGCAAAGGGAAAGAGAATCACT","AAACCTTGCCTTTACTAGAAATACAAAAATTAGCTGGGCATGGTGGCAGGTACCTGTAATCCCAGCTACTTGGGAGGCTGAGGCA"
"GL873598","5126074","5126161","chr1","12339306","12339394","19","7213232","GCCTGGTGCACTGGTTCACACCTGGAATCCTTGCATTCTGAGAGGCCCAGGTAGGCAGATCACCTCAGCTCAGAAGTTCGAGACCAGC","GCTGGGTGCGGTGGTTCACGTCTGTAATCCCAGCACTTTGGGAGGCCGAGGCGGGCAGATCACCTGAGGTCAGGAGTTCGAGACCAGCC"
"GL873598","5467584","5467662","chr1","9313328","9313403","17","3845744","GCGAGGTGGCTCACGCCTGTAATCCCAGCACATTTGGAAGGCCAAGGAGGGTGGATCACCCGAGCTCACCAGTTGGAGA","CGCAGTGGCTCACGCCTGTAATCCCAGCACTTTGGGAGGCCGAGGCAGGCAGATCACCTGAAGTCAGGAGTTTGAG"
"GL873598","6917752","6917856","chr14","9558287","9558382","22","2640535","GGCCAGGCATGGTGGCTTGTGCCTGTTGTCCCAGCACTGTGGAAGGCCGAGGCGGGTGGATCGCCTGAGCTCAGCTGAATTCGAGACCAGCATAAGACCAGTATG","GGCCAGGCATGGTGGCTTATGCCTGTAATCCCAGCACCTTGGAAGGCCGAAGCGGGCAGATCACCTGAGCTCAGGAGTTTGAGACCAGCCTGTCCA"
"GL873598","8078910","8079062","chr7","164825511","164825660","43","156746601","AACAGCCAGGCATTGTGGTGGGCACCTGTAATCCCAGCTACTTGGGAGGCTGAGGCAAGAGAATTGCTTGAGCCCAACAGTCTCAGGTTACTGTGAGTTATGACACCATGGCACTCTATTGAGGGCAAGAAAGTGAGACTGTCTTGGAAAAAA","CTAGCCAGGCATGGTGGTGCGCACCTGTAGTCCCAGTTACTTGGGAGGTTGAGGCAAGAGAATTGCTTGAGCCTGGAAGGCAGAAGTTGCAGTGAGCTGAGATCACACCACTGCATTCCAGCCTGGGCGAAAGAGCAAGACTCTGTTGAA"
"GL873598","8079328","8079454","chr6","10381248","10381379","32","2301920","GCCCGGCGTGGTGGCTCACGCCTGTAATTCCAGCACTCTGGGGAGGCCGAGGAGGGCAGATTGCCTGAGCTCACAGGTTTGAGCTAGAGCGAGACCCTGTCTCTTAAAAAGAAAAAAAAGGAAAGAA","GCTGGGCGCGGTGGCTCACGCCTGTAATCCCAACACTTTGGGAGGCCGAGGCGGGCAGATCACCAGAGGTGATCTCCAGCCTGGGCAGGAGAGCAAGACCCTGTCTCAAAAAATTTAGAAAAAGGAAAGAAA"
"GL873599","3943256","3943456","chr9","35892110","35892312","79","31948854","GGCAGGCTGCTTTGACCCATATCTACAACTCCAGAACTTTAGAGGCTGAGCTGGGTGGGTCCCTTGAGATTAGAAACTGCTTAGTAGCCTGGCAAAAACCAGACCCCACCTCCACCATGTAGAAAAATTAGCAGTATGCCATAGTGGGAACCTACCAATACAGTCTTTCCAAAGGCCAAAGCTAGAAGGACCGTGAGCTTG","GGCTGGGTGTGGTGGCTCATGCCTATAATTCCAGCACTTTGGGAGGCCGAGGCAGGTGGATCACCTGAGGCCAGGAGTTTGAGACCAGCCTGGCCAATATGGTGAAACCCCATCTCTACTAAAAGTACAGAAAATTAGTCAGTCATGATGGCGCATGCCTATAATCCCAGTTACTCGGGAGGCTAAGGTAGGAGAATTGCTTG"
"GL873599","6693284","6693349","chr1","100916857","100916922","15","94223573","TCACGTCTATAATCCTAGCACTCTGGGAGTCCTTGGCAGGTGGATCACCTGAGCTCAGGAGTTTGA","CATGCCTGTAATCCCAGCACCTTGGGAGGCCAAGGTGGGTGGATCACCTGAGGTCAGTAGTTTGAG"
"GL873600","991618","991705","chr15","13850109","13850195","15","12858491","GGCTGGGCGTGGTGGCTCACACCTGTTGTCCCAGCGCTGTGGGAGGCTGAGGCAGGTGGATCACCTGTGCTCAGAGGTTGAGACCAGC","GCCGGGCGCTGTGGCTCACACTTGTAATCCCAGCACTTTGGGAGGCTGAGGCAGGTGGATCACCTGAGGTCAGGAGTTAGAGACCAG"
"GL873600","8825981","8826014","chr16","43605817","43605844","11","34779836","AGTCTGGGGCAACAGAGCAAGACTCTGTCTCAAA","CAGTCTGGGTGACAGAGCAAGATTCCAT"
"GL873600","8826039","8826157","chr13","87428402","87428520","35","78602363","ATTAGCCTGGTGTGGTGGTATATGCCTTCCTGCCTGCTTGGGAGGCTGAGGCAGGAAGTATGCTTTAACTGTGGAGTCTGAGGTTGCTATGAGCTAGGTTGAGGCCATGGCACTCTAAA","TTAGCCGGGTGTGGTGGTGCACGCCTGTAATCCCAGCTACTCAGGAGGCTGAAGCAGGAGAGTTGCTTGAACCCAGGAGTTGGAGGTTGCAGTGAGCTGAGATCACGCCATTGCACTCC"
"GL873601","269289","269338","chr14","49279240","49279285","14","49009951","GACTGGGTGTGGTGGCTCACACCTTTAATCCTAACACCCTGGGAGGCTTA","GGCTGAGATGGTGGCACACACCTGTAATCCCAGCTACTTGGGAGGC"
"GL873601","269431","269678","chr1","184453273","184453521","76","184183842","AGAAGATCACTCAAGATCAGGAGTTTGAGAACAGCCTGAGCAAGACCCCCATCTTTACTAAAAATGGAAAAGTTTTTACCCAGGCATGGTAGTGCGTGCCTGTATCCCATCTACTCCGGAGGCTGATAGGAGGATTGCTTCAACCAAGGAGTTTGAGGTTCCAGAGACTTAAGATGACACAACTGCATTTTACCCAGTGTGACACAGCGAGACTCTTTCAGAAGAATTTTTAAAAGGAAAAAAAAGAA","GGTCAGATCACCTGAGGTCAGGAGTTTGAGACCAGCCTGACCAACATGGTAAAACCCCATCTCTGCTAAAAATACAAAAAATTAGCCAGGCATGGTGGTGAACGCCTGTAATCCTAGCTACTCAGGAGGCAAAGACAGGAGAATCGCTTGAATCTGGAAGGTGGAGGTTGCAATGAGCCAAGATGACGCCACTGCACTCCAACCTGGGTGACAGAGGAAGACTCCATCAAAAAAAAAAAAAAAAAAAAA"
"GL873601","1397978","1398117","chr16","24839455","24839591","34","23441477","GCCTATAATCCTAGCACTCTGGAAGGCTGAGGCAGGAAGATCACTAGAGCTTGGGAGTTTGAGATTGCTGTGAGGGAGACTGACTCCATGGCACTCTAGCCTGAGGCAACAGAGTAAGACTCCATCTCAAAAAAAAAAAA","CTCTAACTCCAGCTACTCAGGAGGCTGAAGCAGGAAAATCACTTGAACCTGGGAGGTGGAGGTTACAGTGAGCCAAGATCACACCATTGCACTCCAGCCTGAGCGACAGAGCGAGACTCTGTCTCAAAATAAATAAA"
"GL873601","4065502","4065590","chr11","108711352","108711444","19","104645850","GCTGGATGTGGTGGCTCTCACCTATAATCCTAGCACTCTGGGAGGTCAAAACAGGTGGATCACCTGAGCTCAGGAGCAAGAACACCAGC","GTCAGGGGTGGTGGCTCACGCCTGTAATCCCAGCACTTTGGGAGGCCAAGGCAGGTGGATCGCCTGAGCTCAGGAGTTCAAGACCAGCCTTGC"
"GL873601","8241370","8241465","chrY","9469734","9469829","34","1228364","AAAAAAGGTGGAGATGAGCCATGCGCAGTGGTGTAGGCCTGTAATCCCAGCCCTTGGGAGGCCAAAATGGTGGATTGCCTGAAGCAGAGCAAGACC","AAAGTACAAAGAGTCTGGGTACAGTGGCCCAAGCCTGTAATCCCAGCAGTTTGGGAGGACAAGATGGGTAGATCACCTGACATCATGAATTAGAGA"
"GL873569","7519122","7519191","chrX","79016364","79016431","16","71497242","TTGGCCAGGCATGGTCGCTCAGGCTGTAATACCAGCTACTTGGGAAGCTGAAGCAGGAGGATCACTTGAA","TTGGCCAGGCACGGTGGCTCATGCTTATAATCCCAGCTACTCGTGAGGCTGAGGCAGGGGAATCGCTT"
"GL873569","7989158","7989286","chr8","41505677","41505810","35","33516519","AGTCCCACCTATTTGGAAGGCTGAGGCAAGAGGATCACTTGAACTCAGCAGTTTGACATTGCTATGAGTTAGATTGACTCCATGGCACTCTAGCCCAGGCAACAGAGCAAGACTCCGTCTCAAAACAAA","TAATACCAGCTACGTGGGAGGCTGAGGCAGGAGAATCACTTGAACCCGGGAGGTGGAGGTTGCAGTGAGCTGAGATTGCACCGTTGCACTCTAACCTGGGCAACAAAAGCAAAACTCTGTCTCAAAAAAAAAAA"
"GL873569","7989575","7989702","chr1","62231025","62231129","47","54241450","GGCTGGGTAATGCAGTGGCTCACGCCTATAATCCTAGTGCTTTGAGAGGCCAAGAGTGAGACTCTGTGTACTAAAAATAGAAAAATTACCTAGGCATTCTGGTGGGCACCAGTAGTCCCACCTATTTG","GGCTGGGCATGGTGGCTCACGCCTATAATCCCAGCACTTTGGGAGGCCGAGGCAGGTGGATCACCTGAGATCAGGAGTTTGAGACCAGACTGGCCAACATGGTGA"
"GL873569","10034363","10034556","chr10","61268396","61268605","62","51234033","CAGCTTGAGCAAAAGTGAGCCCCTGTCTCTACTGAAAATAGAAAAAATTAGCCAGGCGTGGTGGCACACACTTATAGTCCCAGCCACTTAGGAGGCTGAGGCAGGAGTTTGAGGTTGACATAATCTAAGCTGATACCATAGCACTCTAGCCTGGGCAATAGAGTGAGACTCTGTCTCAAAGAAGAAATTTATCT","CCTGACCAATGGTGAAACCCTGTCTCTACCAAAAATACAAAATTTAGCTGGGCATGGGGGCACGCACCTGTAGTCCTAGCTACTCGGGAGGCTGAGACAGGAGAACTGCTTGAACTCGGGAGGCAGAGGTTGCAGTGAGCTGAGATCATGCCACTGCACTCTAGCCTGGGCAATAGAGTGAGACTCCGTCTCAAAAAAAAAAAAAAAAAA"
"GL873569","10034830","10034845","chr1","217667782","217667796","2","207632952","AAAAAAGAAGAAAAAA","AAGAAAAAGAAAAAA"
"GL873569","10203815","10203922","chr8","96374555","96374671","35","86170740","GCCAGGTGTAGTGGTTCACACCTATAATCCTAGCACTCTGGGAGCCTGAAGCAGGTAAATGGACTGAGCAAGAGTGAGACTTCCACCTCTATTGAAAATAGAAAAATT","GGCTAGGTATGGTGGCTGATGCCTATAATCCCAGAATTTTGGGAGGCCGAGGCAGGCAGATCATCTGAGGTCAGGAGTTTGAGACCAGTCCCGTCTCTACTAAAAATACAAAAATTA"
"GL873569","10204196","10204373","chr20","1304385","1304559","47","8899811","GAAAATAGAAAAATTAGCCAGGCATTATAGCAGGCACCAGTAATCCCAGTTACTTGGGAGGCTAAGGCAAAAGAATCTCTTGAGCCCAAGTTTGGGGTTGCTAGGAAGTAAAACACCACAGCACTATACCCAGAACAAGAGAGTGAAGACTCAGTCTCAAAAAGATAAATAAATAAAA","AAAAATACAAAAATTAGCCAGGCATGGTGGCGGGCGTCTGTAACTCCAGCTACTTGGGAGACTGAGGCAGGAGAATCGCTTGAACCCAGGAGGCAGAGGTTACAGGTGAAATCACACCACTGCACTCCAGCCTGGGCAACAGGGCAAGACTCTGTCTCAAAAAAAAAAAAAAAAA"
"GL873569","10473375","10473444","chr8","20660648","20660717","21","10187273","TGTAGTCCCAGCACTTTGGGAGGTTAAGGCAAGAGTAGCACCCAACATGAGGAGATCAAGACCAATCTGG","CTGTAGTCCCAGCACTTTGGGAGGCTGAGGCAGGTGGATCCTTTGAGGGCAGAACTTTAAGACCAGCCTG"
"GL873570","9287350","9287485","chr1","29437872","29437991","30","20150522","GGCCGGGCGTGGTGGCGCACGCCTGTAGTCCCAGCGCTATGGGAGGCCGAGGCGGGTGGATCACCTGTGCTCAGAGGTTCGAGACCAGCCAAGACCCCCCTGAGCCAAACGAGCCAGAGTGAGACCCCGTCTCTAC","GGCCGGGCGTGGTGGCTCACGCCTGTAATCCCAACATTTTGGGAGGCCAAGGCGGGTGGATCACCTGAGGTCAGAAGTTCGAGACCAACCTGGCCAACATGGTGAAACCCCTGTCTCTAC"
"GL873571","3669989","3670207","chr4","116777080","116777297","60","113107091","AGACCAGCCTGAGGAAGAGCAAGATCCCATCTCTATTAAAAATAGAAAAATTAGCCAGGCATTCTGGTGGGCACCTGTAGTTCTAACCACCTGGGAGGCTAAGGCAAGAGGAACTCTTCAACCCAAGAGTTTGAGGTTGCTGAGAGCTAGGCTAAGGCTGCAGCACTCTAGCCTGGGCAACAGAGTGAGACTGTTTCTCAAAAACAAAAAACAAAAAAA","CGAGACCAGCCTGGTCAATATGGTGAAACCCCGTCCCTACTAAAAATACAAAAATTAGCCAGGCATGGTGGCAGGCACCTGTAGTCCCAGCTACTCGGAAGGCTGAGGCAGGAGAATCGCTTGAACCACAGAGGCAGAGGTTGCAGTGAGCCGAGACTGCACCACTGCACTCCAGCCTGGGCGACAGAGTGAGACTCAGTCTCAAAAAAAAAAAAAAA"
"GL873571","106134","106236","chr4","18143723","18143826","27","18037589","GGCCAGTCTCAGTGGCTCACACCTGTAATCCAGCATTCTGGGAGGCTGAAGCACACGGTCACCTGAGCTCAAAGGTTGGAGACCAGAGTGAGACCCCACCTCT","GGCCAGGCGCAGTGGCTCACTCCTGTAATCCCAGCACTTTGAGGCTGAGGCAGGCGGATCACCTGAGGTCAGGAGTTTGAGACCAGCCTGGCCGAAACCCCATC"
"GL873571","3670496","3670589","chr7","50468399","50468491","15","46797903","GGGCAGGCATGGTGGCTCACACCTGTAATTCTAGCACTCTTGGAGGCTGAGGCAGGAAAATGGCTTGAGGTCAGGAGTTCAAGACCAGCCTGAG","GGCCAGTCATGGTTGCTCACACCTGTAATACCAGCACTTTGGGAGGCCGAGGCAGGCGAATCACCTGAAGTCAGGAGTTCAAGACCAGCCTGG"
"GL873571","4059090","4059389","chr7","52903696","52903994","88","48844606","GGCCAGGTGCAGTGGTTCACACTTATAATCCTAGCACTCTGGGAGGCCGAGGCGAGTGAAGTGCCTGAGCTCATGGGTTCAAGACCAACCTAAGCCAGAGACCCCTGACTCTTATAATAGCCTGGCATTGTGGTGGGCGCCAATATTTCCAGCTACTCTGAGGCTAAGGCAAGAGAATTGCTTGAGCCCAGGAGTTGGAGGTTTCTGTGAGCACTGACGCCGCAGCTCTCTACCAAGGGCAACAAAGACTCTGTCTCAAAAAATAAATAAATAAATAAATAACAGAATGAAAATGAAAAA","GGCCGGGTGCGGTGGTTCACGCCTGTAATCCCACCACTTTGGGAGGCTGAGGCAGGCAGGTCACCTGAGGTCAGGAGTTCCAGACCAGCCTGGCCAACATGGTGAAACCTTGTCTCGGCTATTAGCCTGGCATGGTGGTGCGTGCCCATAATCCCAGCTACTCAGGAGGCTGAGGCAGGAGAATCGCTTGAACCCAGAAGGTGGAGGTTGCAGTGAGCCAAGATAGCACCACTGCAACTCCAGTCTGGGCAACAGAATGAGACTCTGTCTCAAAAAAAAAAAACAAAAAACAAAAAGAA"
"GL873571","4209418","4209704","chr11","32517699","32517985","80","28308281","GGCTTGGCAAGGTGGCTTACACCTCAAATCCTAGCACTGTGGGAGACTGAGGCAGGTGGATTGTTTGAGCTCAGGAGGTCAAGATAGAGAGCAAGAGCAAGTCTCTGTCTCTACTAAAAATAGAAAAGAACTACTTCCCGGGGGTCATGGCAGTAGCCTGTAATCCCAGTTACTAGGTAGAATGAGGCAAGAGGATCTGTTGAAGCCAAGAGACTGAGGTTGTTATGAGCATGCCACAGCACTCTACCCAGGGTGACAGAATGAGACTCTGTTGAAAGAAAAAAAGA","GGCCGGGTGCAGTGGCTCACACCTGTAATCCCAGCACTTTGGGAGGCTGAGGCGGGTGGATCACCTGAGGTCAGGAGTTCAAGACCAGCCTGACAAACATAGTGAAACCCTGTCTCTACTGAAAATACAAAATTAGCCAGGTGTGGTGGCGCATGCCTGTAATCCCAGCTACTCGGGAGGCTGAGGCAGGAGAATTGCTTGAATCCAGGAGGTGGAGGTTGTGTGATCACACCACTGCACTCCAGCCTGGGCGACAGAGTGAGACTCTGTCTCAAAAAAAAAAGAAA"
"GL873571","4209985","4210154","chr3","175781758","175781928","60","171571773","GAAAGAAATGAAAAGAAAGAAGTTAGCTGGTTGTTGGGGTATGCTTCTATAGTCCCACCTACTCAGAAAGCTGAAATCTGGAGTTTGGGGTTGTTGTAAGGTAGGCTGATGACATAGCACTGTAGCTTGGGCAAGAGAGTGTGACTTTGTCTCAAAAAAAATTAAAACAA","ATTAAAAACACAAAGATTAGCCAGGTGTGATGGCACACAACTGTAATCCCAACTACTCAGGAGAATCGCTTGAACCTGGGAGATAGGGTTTGCAGTGAGCCAAGATTGTGCCACTGCACTCCAGCCTGGGTGACAGAGTGAGACTCTGTCTCCAAAAAAAAAAAAAAAAAA"
"GL873571","4210444","4210570","chr17","16655655","16655789","35","12445211","GCCAGGCAGATGGCTCACACTTCATCCTAGCCCTCTGGAAGGCTGAGGCAGGCTAATTTTTTGAGGTTAGGAGTTTGAGACCAGCCTGAGGAAGAGACCCATCTCTACTTTAAAAAATAAATGGAAA","GCCAGGCATGGTGGCTCACACCTGTAATCCTAGCACTTTGGGAGACTGAGGCGGGTGAATCACCTGAGGTCAGGAGTTTGAGACCAGCCTGACCAGTATGGTGAAACCCAGTCTCTACTAAAAATACAGAAATTA"
"GL873571","4391733","4391878","chr11","33723808","33723943","46","29332075","AACTTAGCTGGGAATGGTGGCTCAAGCCTGTAATCCTAGCACTCTGGGAGGCTCAGGTGGGAGGATCACTTGAGGTTGCTGTGAGCTTGGCTGATGCCAGGACACTCTAGTGTGGGCAAGAGAGTGAGACTCCGCCTCAACAACAA","GCCGGGTGCAGTGGCTCATACCTGTAATCCCAGCACTTTGGGAGGCTGAGGTAGGCGGATCACGAGGTCAGGAGCTGAGATGGCGCCACTGCACCCCAGCCTGGGTGACAGAGCAAGACTCTGTCTCAAAAAAAAA"
"GL873571","6307773","6307841","chr9","62429628","62429694","22","56121855","CTGGGTGTGGTGGCATTGCACCTGTAATCCTAGCTACTTGGAAATCTTAAGCCCAGGAGTTGAAGACTG","CCCAGCATGGTGGTGCATACCTATAATCTCAGCTACTTGGAGGCTTGAGCTCAGAAGTTTGAGACCG"
"GL873571","6496217","6496306","chr1","27257765","27257856","27","20761548","GCAGGGTGTGTTGACCCACACCCACAATTCCAGGACTCTGGGGGGCCAGGGATGGTGGGTTCCCTCAGATCAGGAGCTCCTTACCAGCCT","GACTGGGCATGATGGCTCAAATCTGTAATTCCAGCACTTTGGGAGGCCGAGGTGGGTGGATTGCCTGAGATCAGGAGTTCAAGACCAGCCTG"
"GL873571","6499738","6499903","chr1","38976375","38976555","47","32476637","AAAATAACATGAATTGACTAGGCGAGGTGGCTCACATCTCTAATCCTAGCACTCTGGGAGGCTGAGGCAGGAGAATTGCATGAGGTTGCTGTGAGCTATGATGATACCACGGCATTCTAATCAGGGTGACAGAGTGAGATTCTGTCTTAAAACAAACAAACAAAAA","AAAATAAATAAATTAGCAGGGCCTGGTGGCGCACACCTGTAATCCCAGCTACTTGGGAAGCTGAGGCAGGAGAACCCACTTGAACCTGGGAGCCGGAGGTTGCAGTGAGCTGAGATGGCACCACTGCACTCCAGACTGCGTGACAGAGTGAGACTCCGTCTCAAAAACAAACAAACAAAAA"
"GL873571","11399575","11399872","chr15","109458692","109458994","79","98059117","CAGTGGCTCACACCTGTAAATCTAACACTCTGGGAGGCCAAGGTGGGTGGATCCCTTGAGCTCAGGAATTTGATACCAGCCTGAGCAAGAGTGAGACCTTGTCTCTACTAATAATAGAAAAATAGCCCGTGTTGTGGCACTTGTCCCAACCACTGGGGAGGCTTTAGGCGGGAGGATTACTTGAATTGGGAGTTTGATATTGCTGTGAGCTGGGCTGATGCCTTGGCATTCTAGCTTGGGTAACAGCGTAAGACTCCGTCTCAAATAAATAAATAAATAAATAAAAAGAAAAAAAGAA","GTGGCTCACACCTGTAATCTCAGCACTTTGGGAGACCGAGGCAGGTGGATCACCTGAGGTCGGGAGTTTGAGACCAGCCTGACCAACGTGGAGAAACCCCGTCTCTACTAACAATACAAAATCAGCTGGGCGTGGTGGTGCATGCTTGTAATCCCAGCTACTCGGGAGGCTGAGGTAGGAGAATCGCTTGAACCTGGGAGGTGGAGGTTGCGGTGAGCCGAGATCGAGCCACTGCACTCCAGCCTGGGTGACAGAGCAAGACTCCATCTCAAAAAAAAAAAAAAAAAAAAAAAAAAAAAAAAA"
"GL873572","114760","114841","chr8","26280134","26280211","16","26165374","GGCCAGGCATGGCGGCTCTTCCCTGTAATCCTAGCACTCTGGGAGGGCGAGGCAGGCAGATCACCTAGGCTAGGGTGAGATC","GGCCAGGAATGGTGGCTCATGCCTGTAATCCCAGCACTTTGGGAGGCTGAGGCAGGCAGATCACCTGAGGTCAGGAGT"
"GL873572","9421791","9421892","chr11","8089184","8089269","35","1332607","TACTAAATATATAGCAAGGCCAGGCACAGTGGTTCATGGCTGTAATCCCAGTACTCTGGGAGGCCTAGTCAGAGTTGACCTGAGATCAGGCTAGAAGCCTGG","ATAAAAATAATTGGAGGCCAGGCACGGTGGCTCATGCTTGTAATTCTAGCAATTTGGGAGGCTGACGCGGGTGAGATCATACTGAG"
"GL873572","11052834","11053035","chr14","11857478","11857657","65","804644","TCCACAAAGAAAGCAGAAGTGTGGCCGGGTGGTAGCTCAAGGCAGGAATCCCAGCACTCTGGGAGCTGGGAGGTGGGGGAGGATCCCTTGAGATCAGGAGTTGGAGGGCACAGTGAGCCTGGGGGAGGCCACTGTCTCTGTACTCTAGCAGGGAGACAGAGCAAGACTGCCCATTCAAAGAAAAACAACAAACAAAACAAAA","TACAAAAATTAGCTGGGCACGGTGCCACAAGCCTGTAATCCCAGCTACTCGGGAGGCTGGGCAGGGGAATAGCTTGAACCCAGAGGTGGAGGTTGCAGTGAGCCAAGATCAAGCCACAGCACTCCAGCCTGGGTGACAGAGCAAGACTCCATCTCAAAAAAAAAAAAAAAAAAAAAAAAA"
"GL873573","2564195","2564244","chr1","109985445","109985491","12","107421250","TACAAAAATTAGGCTGGGCTTGGTGGTTCACGCCTATAATCCTAGCACTT","ACTAAAATTAGCTGGGCATGGTGGTGCATGCCTGTAATTCCAGCTAC"
"GL873573","7423371","7423533","chr2","202783328","202783513","56","195359957","GGTGGCTCACACCTGTAATCCCAGCACTCTGGGAGCCCTGGTGGCTCATGTCTATAATCCTAGTACTCTGGGAGACCATGGTGGCTCATGTCTATAATCCTAGTACTCTGGGAGCCATGGTGGCTCACGCCTATAATCCTAGTACTCTGGGAGACCATGGTGG","GGCTGAGGCGCGGGGGCTCACGCCTGTAATCCCAGCACTGTGGGAGGCCGAGGCGGGTGGATCACGCCTGTAATCCCAGCACTGTGGGAGGCCAAGGCGGGTGGATCACGCCTGTAATCCCAGCACTGTGGGAGGCCGAGGCGGGTGGATCACGCCTGTAATCCCAGCACTGTGGGAGGCTGAGGC"
"GL873573","9657648","9657710","chr19","10207852","10207913","10","550204","TAAAAATAAAAAATTTAGCTGGATGTGGTGGCTCACACCTGTAATCCTAGCACTCTGGGAGAC","TAAAAATACAAAATTAGCTGGGTGTGGTGGCACACACCTGTAATCCCAGCTACTCAAGAGGC"
"GL873574","1624662","1624783","chr9","814961","815079","36","809701","GACTGGGTGGGTTGGATCATGCCTGGAATCCTAGCACCCTGGGAGGCCAAGGTGAAAGGATTGCTTGAGGTTAGGAGTTCCAGAAATGTAGCAGTCATGGTGACTTCATCCTTCTCTACCAA","GGCTGGGTGCTTTGATTCATGCCTGTAATCCCAGCACTCTGGGAGGCCGAGGCAGGTGGATCACCTGAGGTTAGGAGTTCGAGACCAGCTTGGCTAACATGGTGAAACCTCGTCTCTAC"
"GL873574","4459477","4459612","chr1","29437872","29437991","29","24978395","GGCCGGGCGTGGTGGCGCACGCCTGTAGTCCCAGCGCTATGGGAGGCCGAGGCGGGTGGATCACCTGAGCTCAGAGGTTCGAGACCAGCCAAGACCCCCCTGAGCCAAACGAGCCAGAGTGAGACCCCGTCTCTAC","GGCCGGGCGTGGTGGCTCACGCCTGTAATCCCAACATTTTGGGAGGCCAAGGCGGGTGGATCACCTGAGGTCAGAAGTTCGAGACCAACCTGGCCAACATGGTGAAACCCCTGTCTCTAC"
"GL873574","4681987","4682216","chr6","153082888","153083127","73","148400901","GGGTGCGGTGGCTCAGACCTATAATCCCAGCACTCTGAGAGGCCGAAGTGGGTGGATCACCTGAGCTCAGGAATTTGAGACCAGCCGTCTCTAAAAATAGCTGAGTGTTGTGGCAGTGGCTGTAAGTCCCAGCTGTTTGGAAAGCTGAAGCAAGGGAATCACTTGAACCCAAGAGTTTGAGGTTGCTGTGATGACAAAGTGAGACTCTATCTCAAAAAAAAAAAAAAAAA","GGCCGTGCGCGGCGGCTCACGCCTGTAATCCCAGCACTTTGGGAGGCTGAGGTGGGTGGATCACCTGAGGTCAGGAGTTTGAGACCAGCCCGACCAGAAATTAGATGGGTGTGGTGGTGCGCTCCTGCAGCCCCAGCTACTTAAGAGGCTGAGGCAGGGTAATCACTTGAACCCGGGAGGCGGAGGTTGCAGTGAGCCGAGCTCACGCCACTGCACTCCAGCCTGGGTAACAGAGCGAGA"
"GL873574","4709916","4710039","chr19","13152422","13152536","46","8442506","AAAAATAGAAAAACTAGCCAAGCATGGTGGTGCACCCCCTATAGTCTGAGCTCCTCAGCGGGCTGAAGCAAAAGGACGGCTGGAGCCCTGGAGTTTGAGGTTGCTGTGAGGCAAGGTGATGCCA","ACACATAAATTAGCCAGACATGATGGTGAGTATCTGTAATTCCAGCTCCTTGGGGGGCTGAGGCGGGAGAATTGCTTGAACCTGGGAGGCAGAGATTGCAGTGAGCCAAGATCGC"
"GL873574","6353839","6353913","chr5","25768079","25768163","22","19414240","AAAAATATAGCAAGGCCAGGCATGGTGGCTCACACCTATAATCCCAGTACTTGGGAGCTGGAATTTGAACCTAGG","AAAAAACTCAAACAAGGCTGGGCGTGGTGGCTCACACCTGTAATCCCAGCACTTTGGGAGGCTGAGGTGGGTGGATCACCTGAGG"
"GL873574","6533061","6533332","chr5","85182161","85182439","81","78649100","GGCTGGGCGAGGTGGCTTACACCTATAATCCTAGTACTCTGGGAGGCCAAGGTGGGTGGATTGCCTGAGCGCACAGTTTCAAGACCAGCTGGAGCCAGAGAGAGAGAGAGAGACCCTGCCTCTAAAAATAGCCAGGCATTGTGGCAGGCACCTGTAGTCCCAGCTACTTGGCAGGCGGAGGTATGAGAATCGCTAGAGGTTGCTGTTAGCTATGATGCCATAGCACTCTACCAAGGGCGACAAAGTGAAACTCTGCCTCAAAAAAAAGAAGA","GCCAGGCGTGGTGACTCAAGCCTGTAATCCTAGCACTTTGGGAGGCCAAGGTGGGCGGATTGCCTGAGCTCAAGAGTTTGAGACCAGCCTGGGCAACACGGTGAAACCCAATCCCTACTAAATACAAAAAAAATTAGCCGGGTGTGGTGGTGTGAACCTGTAGTCCCAGCTACTCGGGAGGCTGAGGCAGGAGAAGGCAGAAGTTGCAGTGAGCCGAGATCACACCACTGCACTCCAGCCTGAGTGACAGAGCAAAACTCTTTCTCAAAAAAAAAAAAA"
"GL873574","6643746","6643907","chr2","92627944","92628105","46","85984198","AAATAGCCAGGCGTTGTGGCAGGCACCTATAGTCCCAGCTACTTGGGAGGCTGAGGCAAGAGAATCACTTAAGCCCAAGTGACAGAGGTTGCCAGGGCACTCTACGTAGGCAACAGAGTGAGACTCTATCTAAGAAAGAAGGAAGGAAGGAAGGAGAAAGAA","TTAGCCGAGCATTGTGGTGCGCGCCTGTAGTCCCAGCTACATGGGAGGCTGAGGCAGGAGAACACCTGAACCCAGGATGTGAGCTGAGTCGCGCCATTGCACTCCAGCCTGGGCAACAGAGTGAGACTCCATCTCAAAAATAAAATAAAATAAAATAAAAAA"
"GL873574","6644163","6644274","chr1","128607504","128607619","20","121963341","CTGTAATCCTAGCACTTGGGAGGCTGAGGCAGGTGGATCACCTGAGTTCAGGAGTTCAAGACCAGCCTAAACAAGAGTGAGACCCTATCTCTACTAAAAATAGAAAAAATAT","GCCTGTAATCCAAGCACTTTGGGAGGCTGAGGCGGGTGGATCACCTGAGGTCAGGTGTTCGAGACCAGCCTGGCCAACGTGGTGAAACCCCAACTCTACTAAAAATACAAAAATTA"
"GL873574","8511822","8512127","chr1","23439759","23440073","84","14927937","GGTGGCTGGTGCCTGTAATCCTAGCACTCTGGGAGACTGAGGCAGGTGGATCACTTGAAATCAGGAGTTTGAGATCAACCTGAGCAAGAGATCTTGTCTCTCCTAAAGATAGAAAAACTAGCTGGGATTTGTGGTGGACACCTGTAATTTCAGCTACTCAGGAAGCTAAGGCAAGAGCATTGCTTAAAACCAGGAGTTTGAAGTTGATGTGAGCTAGGATGTCAGGGCAGGTTACCCAGGGTGACAGAGTGAGACTCTGTGTCAAAATAAACAAACAAACAAACAAACAAAACAAAATAAAATAAA","GGCTGGACATGGTGACTCACGCTTGTAATCCCAACACTTTGGGAGGCTGAAGCAGGCAGATCACCTGAGGTCAGGAGTTTGAGACCAGCCTGACCAACATGGTGAAACCTTGTCTCTACTAAAAATACAAAAATTAGCTGGGAGCAGTGGTGCACACCTGTAATCCCAGCTACTCGGCAAGCTGAGGCAAGATAATTTTTTAAACCTGGGAGGTGGAGGTTGCAGTGAGCCAAGATCGTGCCACTGTACTCCAACCTGGGAGACAGAGCAAGACTCTGTCTCAAAAAAAAAAAAAAAAAAAAAAAAAAAAAAAAA"
"GL873575","2107336","2107519","chr4","38052972","38053149","54","35945636","TCAATTAAAAACTTTTTAAAATGAGGCTGAGCATGGTGGTTCACACCTGTAATCCCAGCACTTTGGGAGGCCGAGGCAGGAGGATCACCTGATCCCAGGAGTCCAAGCCTACAGTGAGCCGTGATAATACCACTGCACTTCAGCCCAAAGCCTCAAAAAGAAAAAAAAAAAAGGATAGACAAGA","TATATATATATATATTATTTTGGGGGGGCATGGTGGTGCACACCTGTAATCCCAGCTACTCGGGAGGCTGAGGCAGGAGAATTGCTTGAGCCCGGGAGGCAAAGGTTGCATTGAGCTGAGATCACACCACTGCACTCCAGCCTGGCGACAGAGTCTCAAAAAAAAGAAAAAATAAAAA"
"GL873575","5831824","5831959","chr1","29437872","29437991","28","23606048","GGCCGGGCGTGGTGGCGCACGCCTGTAGTCCCAGCGCTATGGGAGGCCAAGGCGGGTGGATCACCTGAGCTCAGAGGTTCGAGACCAGCCAAGACCCCCCTGAGCCAAACGAGCCAGAGTGAGACCCCGTCTCTAC","GGCCGGGCGTGGTGGCTCACGCCTGTAATCCCAACATTTTGGGAGGCCAAGGCGGGTGGATCACCTGAGGTCAGAAGTTCGAGACCAACCTGGCCAACATGGTGAAACCCCTGTCTCTAC"
"GL873575","7451097","7451208","chr3","122814630","122814743","22","115363533","GGCCAGGTGTGGTGGCTCACACCTGTTATCCTAGCACTCTGAGAGGCCACAGCAGCTGGATCACTTGAGCTCAGGAGTTCAAGACCAGTCTGAGCAAGAGCAAGACCTCACC","GGCTGGGTGTGGTGGCTCATGCCTGTAATCCCAGCACTTTGAAAGGCCAAGGCAGATGGATCACTTGAGGTCAGGAGTTCCAGACCAGCCTGGCCAACATGGCAAAACCCCATC"
"GL873575","7451277","7451445","chr6","58863249","58863409","41","51411972","AAAAATTCAGCCAGCCACAGTGGAAGTGGATGCCTGCCATCACAGCTACTCTGGGGGCTGGGGCAAGAGAATTGCTTGATCCCAGGAGTCTGAGGTTGCTGTGACCTAGGCTGACACCACAGCACTCTACCCAGGGTGACAGAGTGAGGCTGTGTTTAAAAAAAAAAAA","TTAGCCAGGCATGGTGGCACATGCCAGTAATCCCAGCTACTCAGGAGGATGAGGCAGGAGAATCGCTTGAACCCAGGAGGCAGAGGTTGCAGTGAGCTGAGATTGCGCCACAGCACTCTACCCTGGGTGACAGAAGGAGACTCTGTCTCAAAAAAAAAAAA"
"GL873576","1765109","1765185","chrX","53921180","53921256","12","52156071","GGCCAGGTGCAGTGGCTCATATCTGTAATCCTAGCACCCTGGGAGGCCAAGGTAGGCGAATCACCTGAGGCCAGGAG","GGCCAGGTGCAGTGGCTCACGCCTGTAATCCCAGCACTTTGGGAGGCCGAGGTGGGCGGATCACTTTAGGTCAGGAG"
"GL873576","2711577","2711895","chr7","6620384","6620702","85","3908807","GGTCGAGCTTGGTGGCTCATGCTTGTAATCCTAGCACTCTGGGAGGCCAAGGCAGGTAAGTTGCCCTGAGCTCATAGGTTCCAGATCAGCATGAGCCAGAGTGAGACCCTGTCTCTACCAAAAAATAGCCCGGCATTCTGGCAGGTGCCTGTAATCCCAGCTGCTTGGGAGGCTGAGGCTAGAGAATCACTTAAACCCAAGGGTTAGTGGAGGTTGCTGTGAGCTATGATTCCACCGTACTCTACTGAGGGCCACAAAGTGAGACTCTGTCTCCATAAAAAAGAAAGAAAGAAAGAAAGAAAAATAAAATAAAATAAAA","GGCCAGGCACAGTGGCTCATGTCTGTAATCCCAGCACTTTGGGAGGCCGAGGCGGGTGGATTACCTGAGGTCAGGAGTTCTAGACCAGCCTGGCCAACAAGGCGAAACCCTGTCTCTACTAAAAATACAAAAAATTAGCTGGGCGTTTTGGCACATGCCTGTAATCCCAGCTACTTGGGAGGCTGAGGCAGGAGAATTGCTTGAACTGGGGAAGTGGAGGTTGCAGTGAGCTGAGATCACACCATTGCACGCCTGAGCAACAGAGCGAGACTCTGTCTCAAAAAAAAAAAAAAAAAAAAAAAAGAAAAGAAAAAGAAAA"
"GL873576","4782520","4782652","chr9","61136941","61137074","22","56354421","CCAGGCACGGTGGCTCACCCTTGTAACCCTAGTACTTTGGGAGGCTGAGGTGGGAGGATCCCTTGAGGTCAGGAGTTCAAGACCAGCCTGAACAACAGTGAGACCCCCGTCTCTACTAAAAAATAGAAAAGTT","GCCAGGCACGGTGGCTCACGCCTGTAATCCCAGCACTTTGGGAGGCTGAAGCGGGCGGATCACCTGAGGTCAGGAGTTCAAGACCAGCCTGGGCACCATGATGAAACCCCGTCTCTATTAAAAATACAAAAATT"
"GL873576","4782930","4783078","chr7","57521645","57521803","40","52738715","AGTTAGTCTGGTGTCATGGTGGGTGCCTGTAGTCCCAGCTGCTTGGGAGGCTGAGGCAAGAGAATCACTTGAGCCCAGGAGTTGGAGGTTGCTATGAGCGAGGCTGTAGCCTAGGCAACAGAATGAGACTTTGCCTCAAAAAAATAAAA","TTAGCTGGGCATGGTGGCGCATGCCTGTAGTCCCAGCTACTTGGGAAGCTGAGGCAGGAGAATCACTTGAACCTGGGAGGTGGAGGTTGCAGTGAGCTGAGATCGCACCGCTACACGCCAGCCTGAGCAACAGAGAGAGACTCTGTCTCAAAAGAAAAA"
"GL873576","7828709","7828723","chr5","101042981","101042996","1","93214272","TAAATAAATAAAAAA","TAAATAAATAAATAAA"
"GL873576","7828960","7829230","chr13","49045537","49045844","89","41216577","GCCGGCTGCAGTGGCTATAATCCAAGTACCCTGGGAGGCTTAGGTGGATGGATCACTTGAGCTCAGAAGTTCAAGACCAGCCTCAGCAAGAGGTAGACCTTGCCTCTATTAAANNNNNNNNNNNNNNNNNNNNNNNNNNNNNNNNNNNNNNNNNNNNNNNNNNNNNNNNNNNNNNNNNNNNNNNNNNNNAGTTTGAGGTTGCTGTGAGCTATGATGAAGCCAGGGCATTCTACCCAGGGTGACAGAGTAACTCTTAAAAAAAACTAAACAA","GGCCAGGCAGAGTGGCTCATGCCTGTAATTCCAGCAATTTGGGAGGCCTAGGCAGGCAGATTACCTGAGGTCAGGAGTTTGAGACCAGCCTGGCCAACATGGTGAAACCCCGTCTCTTCTANNNNNNNNNNNNNNNNNNNNNNNNNNNNNNNNNNNNNNNNNNNNNNNNNNNNNNNNNNNNNNNNNNNNNNNNNNNNNNGGAGATAATAGCTTTTGTAGAACGAAGCGATGCAACAGCCAGATCGCCGCCACCACCCTTAGGTCCTGGCGACAGAGTGAGATCCATCTTAAAAAAAAAAAAAAAAAAA"
"GL873576","10622840","10623093","chr7","60266447","60266705","74","49643607","GCTGGGTATGGTGGTTCACACCTATAATCCTAGCACTCTGGGAGGCTGAGGTGGGAGGATTGGTGGAGCTCAGGAGCTCATGAGGTGCCAAATCACTGGTGCCACACACCTGTATTCCCAGCTACTGAGGAGGCTGAGGCAGGAGGATCAGGTAAGCCCAGGAAGTTTGAGGTTGTAGTGAGTTAGGATGATTGAACTCTGCCTTGAGAGACAGAGCAAGATCCTCCTTCCTCCTAAGCAAACAAACAAATAAA","GGCTGGGTGCAGTGGCTCACACCTGTAATCCTAGCACTTTGGGAGGCTGAGGCGGGAAAATTGCCTGAGCTCAGGAGTTCAAGGACAGCCTAGGCAACATAGCATGGTGGTGCACGCCTGTATTCCCTGCTACTTGGGAGGCTGAGGCACAAGAATTGCTTGAATCCGGGAAGTGGAGGTTGCAGTGAGCCATTGTGGCACTGCTCTCCAGTCTGGGTGACAGAGCAAGACTCCATCTCAAAAAAAAAAAAAAAAAAAA"
"GL873576","10819939","10820007","chrX","67133632","67133707","21","56313693","AGGTTGCAGTGAAATTGTACCATTCCAATGAAGCCTGGGGGACAGAGTGAGATTCTCTCAAAATAAAAA","GGAGGTTGCAGTGAACCGAGATCGTGCCACTGCACTCCAGCCTGAGCGACAGAGTGAAACTTCGTCTCAAAAAAAA"
"GL873576","10920306","10920363","chr3","48261745","48261808","16","37341439","GCTGGACCTTGTAGAGAGTGCCTGTAATCCCAGCTACATGGGGGGCAAGAGAATTGCT","GCTGGGCATGGTGGTGCATGCCTGTGATCCCAGCTACTCAGGAGGCTGAGGCAGGAGAATTGCT"
"GL873576","10920398","10920529","chr10","67341428","67341546","30","56421030","GGCCAGGCGTGGTGGCTCACGCCTGTTGTCCCAGCACTGTGGGAGGCCGAGGTGGGTGGATTGCCTGAGCTCAGAGGAGTCCGGAAGACCAGCATGAGGCAGAGTGAGCCAGAGTAAGATCCTGTCTCTACC","GGCTGGGTGTAGTGGCTCATGCCTGTAATCCCAGCACTTTAGGAGGCCAAGGTGGATGGATTGCCTGAGCTCAGGAGTTCGAGACCACCCTGGGCAACAAGCCAAAACCCTGTCTCTAC"
"GL873577","515809","515961","chr7","137660778","137660931","43","137144969","AGCTGGGCATGGTGGCTCATGCCTATAACCCTAGCGTGCTAGGAGATTGCTTGTCAGGAGACTGAGGTTGCAGGAAACTGTGATGATGGCACTGCACTCTACCCAGGGTGACAGAGCAGGACTCTGCCTCAAAAAAAAAAAAAAAAATAGAAA","TTAGCTGGGCATGGTGGCGCATGCCTATAATCCCAGCTACTTGGGAGGCTGAGGCAAGAGAATCGCTTGAACCGGGGAGGCAGAGGTTGCAGACTGCACTCCAGCCTGTGTGACAGAGTGGGACTCCGTCTCAAAAAAAAAAAAAAAAAAAAAA"
"GL873577","1633164","1633256","chrX","38269524","38269615","26","36636360","TCAGCCAGGCATGGTGGCACTTGCCTATAAACCCAGCTCCTTGGGAAGCTGAGCCGGGAGGATCCCTTGCACCCAGGAGCAACGGAAGGCAGT","AATTAGCCAGGCATGGTGGCACATGCCTATAATCCCAGCTACTCAGAAGGTTGAGGCAGGAGAATCACTTGAACCTGGGAGGCAGAGGTTGC"
"GL873577","3979502","3979560","chr20","68909283","68909346","13","64929781","GAGTTTGAGACCAGCCTGAGCAAGACCGAGACCCAGTCTCTACTAAAAATAGAAAAATT","GGAGTTCAAGACCAGCCTGACCAACATGGAGAAACCCTGTCTCTACTAAAAAATACAAAAATTA"
"GL873577","3979839","3980009","chr10","31403126","31403287","39","27423287","ATGAGCAGATTGTCTTGGTGGGCACCTGTAGTCCCAGCTATTGGAGGTGGGAGGCTGAAGCAGGAAAATCTCTTGAGCCCAGGAGTTTGAGGTTGCTGTGAGCTAGGCTGACACCACGGCACTCTAGTCAGGGCGTCAGAGTGAGACTCCGTCTCAAAAAAAAAAAAAAAA","TTAGCTGAGTGTGGTGGCGCACATCTGTACTCCCAGCTATTTGGGAGGCTGAGGCAGGAAAATCGCTTGAACCCAGGAGGTGGAGGTTGCAGTGAGCCAAGATCACACTACTGCACTCCAGCCTGGGTGACAGAGTGAGAATCCATCTCAAAAAAAAGAAAA"
"GL873577","6050882","6051080","chr1","153219820","153220007","59","147168938","GGCTGGGCGTTGTGACTCATGCCTGTAATCCCAGCACTCTAGGAGGCCGAGGTGGGTGGACTGCCTGAACTCAGAGGTTTAAGACCATCCTGAGCCGCAGTGAGCCAGAGCGAGACCCTGTCTCTACCAAAAAAAGCTGGGTGTTGTGGTGGGCGCCTATAGTCCTAGCTACTTGAGGCGCTAAGGGTAAAAAAATTGC","GGCCTGGCACAATGGCTCACGCCTGTAATCCTAGCACTTTGGGAGGCCGGGGTGGGTGGATCACCTGAGATCAGGAGTTTGAGACCAGCCTGGCCAACATGGTGAAACTCCTTCTCTACAAAAATTAGCCAGGTGTGGTGGTGGGTACCTGCAATCCCAGCTATTTGGGAGGCTGAGGCAGGAGAATC"
"GL873577","8463965","8464050","chr9","52134422","52134508","19","43670457","CTGGGTGCTATAGCTCACGCCTATAATCCTAGCACTCTGGGAGTTTGGGGCAAATGGATCACCTAGGCTCAGGAGTTTGATACCAG","GGCTGGGAGCAGTGACTCACGCCTATAATCCCAGCACTTTGGGAGGCTGAGGCAGATGGATCACCTGAAGTCAGGAGTTCGAGACCA"
"GL873577","9471486","9471613","chr16","5178790","5178910","46","4292696","TTAGCCAGGCATAGTAGCCTGTGTGTAGTCCTAGCTACTCAGGAGGCTGAGGTAGATGGGTCACTTGAGGTTGCAGAGATTATGGTAATGTCACTGTACTCTAGCCCTGGCAACAGAGCACAACCCTG","TTAGCCGAGCCTGGTGGCATAAACCTGTAATCCCAGCTACTCAGGAGGCTGAGGCAGGGGAATTGCTTGAACCTGAGAGGAGAAGGTTGCAGTGAGCCGAGATTGCACCATTGCACCCCAG"
"GL873577","9471875","9471998","chr7","17832200","17832315","36","8360325","GGCCAGGTGAAGCAGCTCATGGCTATAATCCTAGCAGTTTGGCAGGCCAAGGTGGGAGGACTGCTTGAGGTCAAGAGTTCAAGACCAACCCATCTTTGCGAAAAATTTAAAAATTACCTAGGCA","GCCAGGAGAGGTGGCTCATGCCTCTAATCCCAGCACTCTGGAAATCCAAGGTGGGTGGATCACCTGAGGTCAGGAATTCCAGACCAGTCTGGCCAATATAAAAAATTAGCCAGGCT"
"GL873577","9853150","9853170","chr3","85044647","85044667","3","75191497","AAACAAACAAACAAAAAAAGA","CAAACAAACAAACAAACAAAA"
"GL873577","9853206","9853473","chr7","130818682","130818963","67","120965476","GCTGGGCGCAGCGTCTCACTCCTGTAATCCCAGCACTTGGGAGGCCAAGGTGAGTGGATTGCCTGAGTTTACAGTTTCGAGACCAGCCTGAGCCAAAGCGAGACCCCCATCTCTAAAAAATAGCTGGGCATTGTGGTGGGCACCTGTAGTCCCAGCTACTTGGGAGGCTGAGGCAAGAGGATCGCTTGAACCTAAGAGTTTGAGGTTGCTGTGAGCTAAGGCTCCATGGCATTCTACCAAGGGTGACTAAGTGAGACTCTGTCTAAAA","GCCGGGCACAGTGGCTCACACCTGTAATCCCAGTACTTTGGGAGGCCAAGGTGGGTGGATCACCTGAGGTCAGGAGTTTGAGACCAGCCTGGCCAACATAGTGAAACTCTACTAAAAATACAAAAAAATAGCTAGGCATGGTGGTGCGCACCTGTAATCCCAGCTACTTGGGAGGCTGAGGCAGGAGAGTTGCTTGAACCCAGCGGGGTTGAGGTTGCAGTGAGTTAAGATCAAGCCACTGTGCTCCAGCCTGGATGACAGAGAGAGACTCCATCTCAAAAA"
"GL873577","10722415","10722478","chr10","12501471","12501539","23","1779056","AATAAAAAAATGCTGGGTACAGTAGTACATGCCTGTACTCTCATCTGGGGAAGCTGAGGCATGA","AAAGTAAAAAATTAGAGCTGGGCATGGTGGCACACACCTGTAATCCCAGTCACTAGGGATGCTGAGGCA"
"GL873578","463331","463568","chr10","28935382","28935620","93","28472051","CAGGTGCTTTGACCCACACCCTCAACTCTAGGACTTTGGACGCCCTGGCTGGGTGGGTCCTTTAAAGTCAGGAGCTTCTTATCAGTCTGGGCAAAAGTGAGACCCCATCTCTACCAAACAAAGAAAGAAATCAGCAGTATGTTGCAGTAGAGACTCACCAATACCTTCTTTCAAAGACCAAAGCTGGAAGGACACTAAAGACCATGATCTCATGGCCTCCCTGAGCCATGACAATGCC","CCAGGTGCAGTGGCTCATGCCTGCAAGCTCAGAACTTTGGGAGGCAGAGGTGAGCAGACTGCCTGAGTTCAGGAGTTCAAGACCAGCTGGGCAACATGGTGAGACCCTATCTCTACTAAAAATACAAATAATTAGCAGGGTGTGGTAGCACACACCTGTAGTCCAGCTACTCAGGAGGCTGAGGCAGGAGAATTGCTTGAACCCAGGAGGCAGAGTTTGCAGTGAGCCAGGACTGGGCC"
"GL873578","1143712","1143827","chr11","52824583","52824692","30","51680871","GGCTGGGTGTGGTGCCTCATGCCTGTAATCTAAGCCCTCTCCGAGGCTGAGGTGGGAGGATCCCTTGAGTTTAGGAGTTTGATTTTGAGACCAGCCTGATCAAGAGAGAGACCTCA","GGCCGGGTGTGGTGGCTCATGTCTGTAATCCCAGCACTTTGGGAGGCTGAGGTGGGTGGATACCCTGAGGTCGGGAGCTCGAGACCAGCCTGACCAACATGGAGAAACCC"
"GL873578","1144101","1144139","chr3","33494224","33494257","11","32350123","GAGAGAGACCTCATGTCTACTAAAATAAATAAATATATA","GTGAAACCCGTCTCTACTAAAAATACAAAAATTA"
"GL873578","1144175","1144343","chr12","119519961","119520131","41","118375786","ATTATCCAGGCCTTCTGGTGGATGCCTGTAGTCCTAGCTACTAGAAAAGCTGGAGCAGAATCACTTGACCCAGGAGCTGGAGGTTGCAGGGAGCTAGGCTGATGCCACAGAATTCTAGCCTGAGGCAAAAGAATTGAGCCACTGTCTCAAAAAGGAACAAAAAAGAAAA","ATTAGCCAGGTGTGGTGGCATGCACTTGTAATCCCAGCTACTAAGAAGGCTGAGGCAGGAGGATCACTTGAACCCGGGAGGTGGAGGTTGCAGTGAGCCAAGATCATGCCACTGCACTCCAGCCTGGGCAACAGAGTAAGACTCTGTCTCAAAAAAAAAAAAAAAAAAAAA"
"GL873578","4593962","4594035","chr16","68825055","68825124","22","64231093","AGCTGGGTACAGTGGCTCACATATAATCCCAGTGACTCAGGAGGCTAAGACAGGAGGATTACTAGGACCTGAGA","GGCTGGGCACAGTGGCTCAGACCTGTAATCTCAGTACTTTGGGTGGCTGAGGCAGGTGGATCACCTGAGG"
"GL873578","6158845","6158972","chr3","500432","500562","24","5658413","GACATGGTGGCTCACACCTGTAATCCTAGCCCTCTGGGAGGCTGAGGCAGGTGGATCACTTGAGTTCAGGAATTCAAGACCAGCTTGAGTGAGAGCAAGACCCTGTCTCTACTAAAAATAGAAAAATT","GCACGGAGGCTCATACCTGTAATCCCAGCACTTTGGGAGGCTGAGGCAGGTGGATCACCTGAGGTCAGGAGTTCCAGACCAGCCTGGCCAACATGGCGAAACCCTGTCTCTACTAAAAATACAAAAAATCT"
"GL873578","6159253","6159444","chr19","34496349","34496541","55","28337096","ATAAAATAAAAATAGAAAAATTAGCCAGGCATTGTGGCAGACATGCGAAGTCTCAGCTACTCCAGAGGCTGAGACAGGAAGATTACTTGAGCCCAAGAATCTTGCTGTGAGCTAAGCTGATGCCATAGCATTGTAACCTAGGCAACAGAGTAAGACTTGGCCTCAAAAATAAAATAAAATAATAAAGTAAAA","TTAGTTAATTAAATTAAACTTAGCTAGGCATAGTGGAACACACCCATAGTCCCAGCTACTCTAGAGGCTGAGGCAGGAGGATTGCTTGAGCCAAGTTGGAGGCTGCAGTGAGCTATGGTGGTGCCACTGCATTCCAGCCTCAGTGACAGAGAGAGACCCTGGCTCAAATAATAATAATAAATAAATAAATAAA"
"GL873578","6766040","6766171","chr2","93098086","93098217","30","86332046","CCAGGCACAGTGGCTCATGCCTATAATCCTAGTAGTCTAGGAGGCTGAGGTGAGTGCATTGCTTGAGCTCAGGAGTTAGATACCAGCCTAACCAAGAATGAGACCCCATCTCTATTAAAAATAGAAAAGTTA","GCCGGGCACAGTGGCTCATGCCTGTAATCCCAGCACTTTGGGAGGCCGAGGCGGGCAAATCACGAGGTCAGGAGTTCAAGACCAGCCTGACCAATATGATGAAACCCCGTCTCTATTAAAAATACAAAAATT"
"GL873578","6766434","6766577","chr9","21128084","21128223","50","14361650","GTTAGCCAGGAGTTGTGGCGGGCACCTACAGTCCTAGCGACTCAGGAGGCTGAAGTAGGCAGAGTTTGATGTGTTGCTGTGAACTACAAGGACACCAATGCACTCTAGGCCGGTAACAGAGTGAGACACTGACTAAAAAAAAAA","TTAGCCAGGTGTGGTGGCACATGCCTGTATTTCCAGCTACTCGGGAGGCTGAGGCAGGAGAATTGCGTGAGCTGAGATCATGCCACTTCATTCCAGTCTGGGTGACAGAGTGAGACTCTGCCTCAAAAAACAAAACAAAA"
"GL873578","7397948","7398119","chr5","40230148","40230319","43","32832200","TAAAAATAGCCATGCATTGTGACAGGCACCTGTAGTCCCAGCTACTCAGGAGGTTGAGGTAAGAGAATCACTTGAACCCAAGAGTTTTGAGGTTGTTATGAGCTAAGACGCCTCGGGACTCTACAAAAGGTAACAAAGTGAGACTCTGTCTCATAAAAAAAGAAAAAAAGAA","AAAATTAGCCAGGCATGGTGACGTACACCTGTAGTCCCAGCTACTCGGGAGGCTAAGGCAAGAGAATCGCTTGAACCCAGGAGGCAGAGGTTGCAGTGAGCTTAGATCACGCTACTGCGCTCCAGCCTGGGTGACGGAGTGAGACGCCATCTCAAAAAAAAAAAAAAAAAAA"
"GL873578","7398378","7398515","chr15","102382935","102383070","35","94984557","GGTCGAGCAAGGTGGCTCACGCCTGTAATCCTAGCACTCTGTGAGGCTGAGGCAGATGGATTGCCTGAGCTCGTGGGTTCGAGACCAGCCTGAGCCAGAGTGAGACCTCATCTCTAAAAATAGCTGGGAAGCTGGGCA","GGCCAGGTGTGGTGGCTCACGCCTGTAATCCTAGCACTTTGGGAGGCTGAGGCGGGTGGATTGCCTGAACTCAGGAGGTCAAGACCAGCCTGGGCAACACAGTAAAACCCCATCTCTACTAAAATACAAAAAATCA"
"GL873579","370235","370429","chr16","38067345","38067552","57","37697110","GCACAGGCCTGAAATCCTAGCACTCTGAAAGGCCAACGGAGGAGAATTTCTGGAGCTCAGGAGTTTGATACCAGCCTAAGCAAATAAAGCTAGACCTCTATCTCTACTAAAATTAGAAAAATTAGGCAGATGTGGTGGTAGGCACCTATAGTCCCAATTACTCCAGAGGCTGAGGCAGAAAGACTCTTGAACCCA","GTCAGGCATGGTGGCTCATGCCTATAATCCTAGCACTTTGGGAGGCCAAGGCCGGTGGATCACCTGAGGTCAGGAGTTTGAGACCAGCCTGGCCAATATGGCAAAACCCCGTCTCTACTAAAAATAAAAAAATTAGCTGGGCACGGTGGTGGGCACCTATAGTCCCAGCTACTCAGGAGGCTGAGGCAGGAGAATTGCTTGAACCCAG"
"GL873579","370936","371046","chr3","3847698","3847802","33","3476762","TGACTCTTGAACCCAGGCACATGAGGTTGCTAAGAGTCTAGGCTGATGTCACGGCACTCTAACCTGGGAAACAGTGTGAGGTTCTGCCTCAATAAATAAATAAATAAATAA","TGGCTTGAACCCAGGAGGCGGAGGTTGCAGTGAGCCGAGATCACGCCACTGCACTCCAGCCTGGGCAACAGAGCGAGACTGTCTCAAAAAAAAAAAAAAAAAAAA"
"GL873579","599436","599605","chr10","38982686","38982853","41","38383250","AAAAAGTCAGACATTGTGGCAGGTGTCTGTAATCCCAGCTATTTGGGAGGCTGAGGCAGGAGTATCATTTGAACCCACGAGTCTGAGGTAACTGTGAGCTAGGCTAACACAACAGCACTCTAGCCTGGGCAATAGAATGAGACTCTATCAAGAAAAGAAATGAAAAGAAA","TATTAGCCTGACACAGTGGCGCGCATCTGTAATCCCAGCTACTTGGGAGGCTGAGGCAGGAGAATCACTTGAACCCAGGAGGCGGAGGTTGCTGTGGGCTGAGATCATGCCACTGCACTCCAGCCTGGGCAACAGAGGGAGGCTCCATCTCAAAAAAAAAAAAAAAAA"
"GL873579","599942","599953","chr3","71473700","71473710","4","70873758","TTTTAAAATAGT","TTTAAAAAAAA"
"GL873579","600232","600365","chr1","16061315","16061447","30","15461083","GGCTAGGCAAGGTGACTCATGTCTGTAATCCTAGTACTCTGGGAGGTTTGAGGCAGGAAGACCACTTTAGCTCAAGAGTTCCAGATCAGCCTGTGCAAGAGTGATACATCATCTCTACTAAAAATCAAAAATTA","GGCTGGGCATGGTGGCTCATGCCTGTAATCCTAGCACTTTGGGAGGTTGAGGCAGGCAGATCACTTGAGGTCAGGAATCTGAGACTAGCCTGGCCAACATGGTGAAACTCCATCTCTACTAAAAAAAAAAAAA"
"GL873579","5650320","5650591","chr6","54938866","54939145","71","49288546","GTCAGGTGTGTTAGCTTACAGTAGTAATCCTAGCACTTTGGGAGGTTGAAGTGGGTGGATTGCTTGAGCTCAGGGGTTCAAGACCAGCCTGAACAAGAGTGGGACCTCATCTCTATTAAAAACAGAAAAACTAGCTGGGTGTTATGGTGGGTGTCTGTAGCCCCAGCTACTCAGGAGGCTGAGGCAGGAGGTTGAGGTTGCTGTGAGCTATTGAGACCACAGCACTCTATCCAGGGCAACAGAGTGAGACCCCTCCCCCCCCCAAAAAAAAA","GGCCAGGTGTGGTGGCTCACGCCTGTAATCCCAACACTTTGGGAGGCCGAGGTGGGTGGATCACCTGAGATCAGGAGTTCAAGACCACCCTGGCCAACATGGTGAAACCCCGTCTCTACTAAAAATACGAAAATTAGCTGAGTGTGGTGGTGCATGCCTGTAGTCCCAGCTACTCAAGAGGCTGAGGCAGGAGGTGGAGGTTGCAGTGAGCCGAGATTGCATCACTGCACTCCAGCCTTGGCGACAGAACGAGAGAGACTCCATCTAAAAAAAAAAAAAA"
"GL873579","7037162","7037347","chr3","37328686","37328893","67","30291524","GAGGTGGGTGGATTGCCTGAGCTCACAGGTTGGAGACCAGCCTGAGCCAGAGCAAGACCTTATCTCAAAAAATAGCCAGGTGTTGTGGCTGGCACCTGTAGTCCCAGCTGCTCAGGAGGCGGAGGCAAGAGAAATGCTTGACCTCAGGAGTTTGAGGTTGCTGTGAGTTCAACTCACACTAATACA","GAGGCAGGGGGATCACCTGAGGTCAGGAGATCGAGACCAGCCTGGCCAACATGGTGAAAACCTGTCTCTACTAAAAATCCAAAAACATTAGCCAGGTGTGGTGGCACGCACCTGTAATCCCAGCTACTTGGGAGGCTGAGGCAGGAGAATCACTTGAACCTGGGAGGCAGAGGTTGTAGCGAGCCGAGATCACACCACTGCACCCCAG"
"GL873579","11077764","11077972","chr19","1200469","1200683","63","9877295","GCCAGGTGCAGTGGCTCATGCCTATAATCCTAGCACCCTAGGAGGCTGAGGAGTTCAAGACCAGCCTAAGCAACTGTGAGACCCCATCTCTACCAAAAATAGAAAAATTAGCTGACTGTTATGGTGTGCACCTACAGTCCTAGCTACTCAGGAGGCTGAGGCAGAAAGAGTCCTTGAACCCAGGAGGCTTTTTTTTGTTGTTGTTGTTG","GGCCAGTCGCGGTAGCTCATGCCTGTAATCCCAGCACTTTGGGAGGCCGAGGCGGGCAGATCACCTGAGACCAGCCTGGCAACATGGTGAAACCCCATGTCTACCCAAACTACAAAAATTAGCTGGGTGTGGTGGTGCACGCCTGTAATCCGAGCTACTCAGCAGGCTGAGGCAGGAGAATCCCTTGAACCTGGGAGGCAGAGGCTGCAGTGAGC"
"GL873579","11078245","11078333","chr19","4926258","4926351","22","6151987","TGAACCCAGGAGTTTGAGTTCGCTGTGAGCTAAGCTGAGGCCACAGCACTCCAGCCTGGGCAACAGAGTGAAAGGAAAAAAATAAAAAA","TGAACCCGGGAGGTGGAGGTTGCAGTGAGCCAAGATCACACCAATGCACTCCAGCCTGGGCAACAAGAGTGAAACTCTGTCTAAAAAAAAAAAA"
"GL873580","320374","320488","chr13","48549305","48549409","42","48228931","GGTAGTGCGTGCCTGCATTCCCAGCTACGGGAGGGCAGGGACTTGAGGCCAGCCTGGGCAAAATAATGAGACCTACTAATGACTCTACTAATACAGAAACAATTAGCTAGGTATG","TGGGAGGCCGAAGTGCGCAGATCACCTGAGGTCAGAAGTTGGAGACCAGCCTGGCCAACATGGTGAAAACCCATCTCTACTAAAAATACAAAAATTAGCTGGGCA"
"GL873580","374969","375091","chr6","147681010","147681135","27","147306041","CGGTGGCTCACACCTATAATCCTAGCATTTTGGAAGGCTGAAGCCGAGGATCTCTGGAAGTCAGAAGTTCAAGACCAGCCTGCCCAAGAGCAAGACCCCATCTCTACTAAAAATAGAAAAACT","GGTGGCTCACACCTGTAATCCCAGCATTTTGGGAGGCTGAGGCAGGCGGATAATCTGAGGTCAAGAATTTGAGACCAGCCTGGCCAACATGGAGAAACCCTATCTCTACTAAAAATACAAAATTAC"
"GL873580","375369","375549","chr7","19977275","19977456","44","19601906","CTAACCAAGTTAGTTAGTTTTAGTTGGCAGGTGCCTGTAGTCCCAGCTCCTTGGGAGGCTGAGGCAAGAGAATGGCTTGAGCCCAGGACTTTGAAGTTGCTGTGAGCTATAATGACACCACAGCACACTACCCAGGGTGACAGAGTGAGACTGTCTCAAAAAAACAAACAAACAAAAAAAA","AACAAACGTTAGCCGAGCATGGTGGTATGTGCCTGTAGTCCCAGCTACTTGGGAGTCTAAGGCAGGAGAATTACTTGAGCCCGGGAGGCAGAGGTTGCTGTGAGCCAAGATCACGCCACTGCACTCCAGCCTGGGTGACAGAGTGAGACTCCATCTCAAAAAAAAAAAAGGAAAAAAAAAAA"
"GL873580","8760922","8761015","chr11","104681322","104681416","19","95920400","GGAGGGAGACACTGCAGTGAACTGCGATCGTGTCTCTGCTTTCCAGGCTGGGTGACAGAGTGAGACTCGGTCTCTAAAATAAAAAATAAATAAA","GGAGACGGAGGTTGCAGTGAGCTGTGATCGCGGCACTGCACTCCAGCCTGGGCAACAGAGTGAGACTCTGTCTCAAAAATAAATAAATAAATAAA"
"GL873580","9391260","9391306","chr14","49279240","49279285","12","39887980","GCCAGTCGAGGTGGCTCACACTTGTGATTCCAGCTACTTGGAAGACT","GGCTGAGATGGTGGCACACACCTGTAATCCCAGCTACTTGGGAGGC"
"GL873581","759283","759365","chr6","46535476","46535542","30","45776193","TAAGAACCTGAAAATAGAGCCAGGCATAGTGGTACATGCGTATAGTCCTGGCTACTCAGGAGGTTGAAACAACAGGATTACTT","CAAAATAGCCAGGCTTGGTGGTGCATGCCTATAATCCAAGCTACTCGGGAAGCTGAGGCAGGAGAAT"
"GL873581","1145844","1145979","chr1","29437872","29437991","29","28292028","GGCCGGGCGTGGTGGCTCACGCCTGTAGTCCCAGCACTATGGGAGGCCGAGGCGGGTGGATCACCTGTGCTCAGAGGTTCGAGACCAGCCAAGACCCCCCTGAGCCAAATGAGCCAGAGTGAGACCCCGTCTCTAC","GGCCGGGCGTGGTGGCTCACGCCTGTAATCCCAACATTTTGGGAGGCCAAGGCGGGTGGATCACCTGAGGTCAGAAGTTCGAGACCAACCTGGCCAACATGGTGAAACCCCTGTCTCTAC"
"GL873581","9628238","9628362","chr5","141044567","141044691","34","131416329","ATCCCAGGTAGTCGGGAGGCTGAGGCAGGAGGATCACTTGAACCCAGGAGGTTGAGGTTGCTGTGAGCAAGGCAGAGGCAACGGCACTCTAGCCACGGGGGCACAGAGACTCTTGTCTTTAAAAA","TAATCTCAGCTACTCGGGAGGCTGAGGCAGGAGAATCGCTTGAGCCCAGAAGGTGGAGGTTGCAGTGAGCCAAGATCGCGCCATTGCACTCCAGCCTGGGCGACAGTGCGAGACTCTGTCTCAAA"
"GL873582","1580485","1580534","chr6","32576760","32576806","12","30996275","CAGCACTTGAGAGGCCAAGGCAGGTGGATCAACTGAGCAAGAATGAGACC","CCAGCACCTTGAGAGGCCAAGGCAGGTGGATCACCTGAGGTCAGGAG"
"GL873582","1644368","1644551","chr1","211626449","211626612","63","209982081","AAAATTTGCCGGGCTCCATAGCTCATGCATGTAATCATAGCACTCTGGGAGGCCAAGATGGGAGGATCTCTCAAGCTCTCTTACTTGGGAGGCTGAGGTTGCTGTGAGTTAGGCTTACGCCACAGCACTCTACTCTAGCGTGAGCAACTCTACTCTTAGTATGAGACTGTCTCAAAAGAAAAAA","AAATTAGCCAGGCGTCGTGGCACATGCCTGTAATCCCAGCTACTCGGGAGGCTGAGGCAGGAGAATAGCTTGATCTCGGGAGGCGGAGGTTGCAGTCAGCCGAGATCACACCACTGCAATCCAGCCTGGACAACAGAATGAGACTCCATCTCAAAAAAAACAAA"
"GL873582","5794385","5794459","chr13","18872784","18872852","27","13078399","ATATTGTTAAGCACAGCCACTATTAAAAATTAAATTATAGGCCAGGCATAGTGGCTCATGCCTGTAATCCTAGCT","TGAAACCACCATCTGGACCAAGATACAAAATGTTGGCTGGGCATGGTGGCTCACACCTGTAATCCTAGC"
"GL873583","102645","102683","chr14","5808766","5808804","14","5706121","GAGCAGATCACCTGAGCTCAGGAGTTTGAGACCAGCCTG","GAGGAATCCCTGTGCTCAGGAAGCTTACATTCTAGTGAG"
"GL873583","6200447","6200560","chr4","17786849","17786963","24","11586402","GGCCAGGAGGGACGGCTCATGCCTGTTATCCTAGCACTATGGGAGACTGAGGTGGGAGGATCACTTGAAGTTAGGAGTTCCAGACCAATCTGACCAAAGTGAGACCTCATCTCT","GGCCAGGCTTGGTGGCTCATGCCTGTAATCTTAGCACTTTGGGAGGCTGAAGTGGGTGGATCACTTGAGGTCAGGAGTTAGAACCAGTCTGGCCAACATGGTGAAACCTCAGCTC"
"GL873583","6200584","6200752","chr6","169626528","169626696","42","163425944","TTAGCTGGATGTGGTAGCACATGCCTATAGTCCCATCTACTCAGGAGGCTGAGACAAGAGAGTTGCTTAAGCCCAGGAGTTTAATTTAACTGTGAACTAGACTGAGACTGTGGCACTCTAGCTGGGGCAACAGAGTGAGACTCTGTCTCAAAAGAAAGCAAGAAAGAAA","TTAGCTGGGTATGGTGTCAGATGCCTGTAGTCCCAGCTACTCAGGAGGCTGAGACAGGAGAATCGTTTGAACCCAGGAGGCCAGAACTGCAGTGAGCTGAGATTCGCACCACTGCGCTCCAGCCTGGGCCAGACAGAGTGAGACTCTATCTCAAAAGAAAAAAAAAAAA"
"GL873583","10217398","10217583","chr3","36257142","36257313","44","26039744","TACTAAAAATAAAGTGTGATAGCCAGGCATGGTGGTGGTGCCTATAGAACCAGGCTATTCAGGAGGCTGAGGCAGAAGGATCACTTGAACCCAGGAGTCTGACGTTGCTGTGAGCTAGGCTGGTGCCATGGTACTCTAGCCTGTGGTAACAGAATGAGACTCTATCTCAAAAATAAAAATAAAAAA","TACAAAATTAGCCAGGCGTGGTGGTGCGTGCCTGTAATCCCAGCTACTTGGGAGGCCGAGGCAGAAGAATGACTTGAACCCAGGAGACAGAGGTTGCAGTGAGCCAAGATCCCACCATTGTACTCCAGCCTGGGCAACACAGTGAGACTCCATCTCAAAAAAAAAAAAAAAA"
"GL873583","10394919","10394983","chr16","12841703","12841771","22","2446784","GAGGTCAGGAAATCAAGATCAGTCTGGGCAATATATTGATACCCTGCCCCTACATAAGGAAGAAA","AGGTCAGGAGTTCAAGACCAGCCTGGCCAATATGTTGAAACCTCATCTCTACTAAAAATACAAAAATTA"
"GL873584","521512","521529","chr1","167402212","167402233","10","166880700","GCATGGAACCCCCCACTC","GGTGAAACCCCATCTTTACTAA"
"GL873584","2079725","2079768","chr15","4338291","4338335","11","2258566","GGCAGGTGGATTACCTGAGTTCAGGAGTTGGAGACCAGCCTGAC","AGGCGGATGGATCACGAGGTCGGGAGTTTGAGACCAGCCTGACCA"
"GL873584","5216877","5217053","chrX","91350057","91350230","49","86133180","CTACTGAAAATGATGACAGAGGCTGGGCATGGGGGCTCCCGCCTGTTATCCTAGCACCCTCGGAGGCTGGGGAATGAGGATTGCTTACGCCCAAGAGTTTGAGGTTGCTGTGAGCTGAGGCCGCTGCACTCTAGCCTGGGCAACAGAGTGAGACTCTGTCTCAAAAAAAAAAAAAAA","TGCAAAAATGAGCTGGGCATGGTGGCACATGCCTGTAATCCCAGCTACACAGGAGGCTGAGGCAGGAGAATCGCTTGAATCTGGGAGGCGGAGGTTGCAGTGAGCTGACATCAGGCCCCTGCACTCTAGCCTGGGCCACAGAGCAAGACTCCGTCTCAAAAAAAAAAAAAAAAA"
"GL873584","7289930","7289950","chr2","51453328","51453345","10","44163398","TGAGGCTCTGTCTCGAAATAA","AATGCCATCTATTAAAAA"
"GL873584","7289975","7290131","chr11","49739997","49740154","37","42450022","CAAGAAAATTAGCTGAGAGTCCTGGTAGGTGCCTGTAATCCCAGCTATTCATGAGGCTGAGGCAGAAGGATCACTTGGGTCCAGGAGTCTGAGGTTGCTGTGAGCTAGTCTGACGCCATAACACGCAAGCCTGGGCAACAGAGTGAGGCTCGGTTTC","CTACAAAAATTAGCTGGGCGTGGTGGCACATGCCTGTAATCCCAGCTACTCGGGAGGCTGAGGCAGGAGAATCACTTGAGCCCAGGAGGCGGAGGTTGCAGTGAGCCAAGATCATGCCATTGCACTCCAACCTGGGCAACAGAGCAAGACTCCATCTC"
"GL873584","7577743","7577867","chr5","48394329","48394446","27","40816586","GGCTGGATGAGGTGGTTCATGCCTGTAATCCTAGCACTCTGGGAGGCCAAGGTGGGTGGATTGCCTGAGCTCAGGAGTTCAAGACCAGCCTGAGCAAGACCCTGTCGCTAAAAATAGCTGGGTGT","GGCTGGGTGCAGTGGCTCATGCCTGTAATCCCAGCACTTTGGGAGGTCAAGGCGGGTGGATCACCTGAGGTCAGGAGTTCAAGACCAGCCTGGCCAACATCTCTACTAAAAATACAAA"
"GL873584","7578135","7578289","chr1","130112713","130112865","31","122534578","GGAGCTGGGTTTTGTGACTGCACCTGTAATCCCAGCTGCTCAGGAGGCTGAGGCAAGAGAATTGCTTGAGCCCAGGAGTTGGAGGTTGCTGTGAGCTGTGATGCCAGGGAACTCTACCAAGGGTGACAAAGTGAAACTCTGTCTCAAAAAAAAAA","TTAGCCAGGTGTGGTGATGCATGCCTGTAATCCCAGCTACTCATGAGGCTGAGGCAGGAGAATTGCTTGAACCTTGGAGCTGGAGGTTGCAGTGAGCTGAGATCAGACCACTCCAACCTGGGTGACAGAGCGAGACTCTGTCTCAAAAAAAAA"
"GL873585","1450952","1451121","chr10","59681079","59681242","48","58230127","TAAAAACAGAAAAAACTAGTCAGGTGGTGTGGTAGGTGCTCATAAGTCCCAGCTGCTTGGGAGACTGAGGCAAGAGAATCACTTGAGCACAAGAGCTTGAGGTGGCTGTGAGCTATAACACCATAGCACTGTACTGAGGGTGACAAAGTAAGACTCTGTCTCAAAAAAAA","TACAAAAATTAGTCAAGGGTGGTGGTATGTGCTTGTAATCCCAGCTATTTGGGAGGCTGAAGCAGGGGAATCCTTGAACCCAGGAGGTGGAGGTTGCAGCGAGCCGAGATCACGTCACTGCACTCTAGCCTGGGCGATAGGGTGAGACTCTGTCTCAAAAAAAA"
"GL873585","1451382","1451515","chr6","17405813","17405948","24","15954431","GGCCCGGCTCGGTGGCTCACACCTATAATCCTAACACTCTGGGAGGCTGAGGCAGGTGGATCACCTGAGCTCAGGAGTTTGAGACCAGCTGAGCAAAAACAAGACCCTATCTCTGCTAAAAATAGAAAAAACTA","GGCCGGGCGGGGTGGCTCACGCCTGTAATCCCAGCACTCTGGGAGGCCAAGGCAGGTGGATCACCTGAGGTCAGGAGTTTGAGACCAGCCTGGCCAACACGCAGAAACCCTATTTCTACTAAAAACACAAAAATTA"
"GL873585","1626960","1627026","chr7","17782729","17782794","22","16155769","AAGATGCCACAGCACTCTACAAGAGTGACCAAGTGAGACTCTGTCTCAAAAAAAAAAAGAAAAGGAA","CAATCGCACTACTGCACTTCAGCCTGGGTGACAGAGTGAGAACCTGTCTCAAAAAAATAAATAAAA"
"GL873585","1627304","1627531","chr11","17033552","17033788","61","15406248","GGCTGGGCACAGTGGCTCACGGCTATAATCTAGGCACTTGGGAGGCTAGGGCAGGTGGATTGCCTGAACTGACAAGTTTGAGACCAACCTGAGCAAGAGCGAGACCCCTGTCTCTAAAACATAGCCAGGCTCTGTGGTGGGCGTCTGTAGTCCCAGCTACTTGGGAGGCTGAGGCAAGAGAATTGCTTGAACTCAAGAGTCTGAGGTTGCTGTGAGTTAAGATGCCAC","GCCCGGCGCAGTGGCTCACGCCTGTAATCCCGGCACTGTGGAGGCCAAGGCAGGCGGATTGCCTAAGCTCAGGGATTCGAGAACAGCCTGGGCAACATGGTGAAACCCCATCTCTACTAAAATACAAAAAACTAGCCGGGCGTGGTGGTATGCGCCTGTAATCCCAGCTACTTGGGAAGCTGAGGCAGGAGAATTGCTTGAACCCGGGAGATGGAGGTTGCAGTGAGCTCAGATCAC"
"GL873585","3626082","3626158","chr1","100916857","100916922","27","97290775","TGCCTGTAATCCCAGCACTTGGGAGGCGGAGGTGGGTAGATTGCCTGACCCAGAGTGGGACCTCATCTCTAAAAGAA","CATGCCTGTAATCCCAGCACCTTGGGAGGCCAAGGTGGGTGGATCACCTGAGGTCAGTAGTTTGAG"
"GL873585","8849829","8849913","chr18","48581945","48582025","18","39732116","GGCTGGACGAGGGGACTCATGCCTGCAATCCCAGCACTGAGAGAGGCCAAGGCAGGTGGATCCCCTGAGCTCAGAAGTTTGAGAC","GCTGGACGCAGTGGCTCACACCTGTAATCCCAGCACTTTGGGAGGCCAAAGCAGGCAGATCTGAGGTCAGGAGTTTGAGAC"
"GL873585","9319890","9319971","chr8","79499361","79499447","14","70179471","GGCCAGGTGTGGTGGCTCACACCTGTCATCCTAGCACTCTGGGAGGACGAGGTGGGTGGACCGCCTGAGTCAGAGTGAGACC","GGCCAGGTGTGGTGGCTCACACCTGTAATCCCAACACTTTGGGAGGCCCAGGTGGGTGGATCACCTGAGGTCAGGAGTTCAAGACCA"
"GL873586","895572","895692","chr17","14501559","14501680","38","13605987","GGCCAGGTGAGGTTTCTCATTCTGGGAGTGAGCCAGCAATTGGGAGGCCAAAGTAAATGGATTGCCTGAGGTTATAGGTTCCAGAACAGCCAGAACAAGATCGAAATCCTGTCTCCAAAAA","GGCCAGGCGTGGTGGCTCATGCGTGTAATCTCAGCACTTTGGAAGGCCGAGGCAGGTGGATCACCCGAGGTCAAGAGTTCAAGACCAGCCTGACCAACATGGCGAGTCTCTGTCTCCACTAA"
"GL873586","5645995","5646150","chr6","58863249","58863409","38","53217254","GGGTATGGTGGCTCATGCCTGTAATCCAAGCACTCTGGGATGGTGAGGCAGGAGAATCCCTTGAACCCAAGAGTCCGAGGTTGCTGCGAGCTAAGCTGATGGCATAACACTCTAGCCTAGGCGACAGAGTGAGACTCTGTTTCCAAAGAGAAAAAA","TTAGCCAGGCATGGTGGCACATGCCAGTAATCCCAGCTACTCAGGAGGATGAGGCAGGAGAATCGCTTGAACCCAGGAGGCAGAGGTTGCAGTGAGCTGAGATTGCGCCACAGCACTCTACCCTGGGTGACAGAAGGAGACTCTGTCTCAAAAAAAAAAAA"
"GL873586","10258686","10258969","chr12","9481260","9481565","81","777426","GGCCGGGCATGGTGGCAGAAATCTAGGAGGCCGAGGCAGGTGGATCGCCTGAGATCACAAGTTCAAGACCAGCCTCAGCTACAGCAAGACCCCATCTCTAAAAATAGCCGGCTGTTGTGGCAGGCGCCTGTAACCCCAGCTACTCGGGAGGCTAAGGCAAGAGAATCGCTTGAGCCCATGAGTCTGAGGTTGCTGCGAGCTGTGACTCCACGGCACTCTACCCGGGGCGATAAAATGAGATTCTGTGTCAAAACAAACAAACAAACAAACAACAACAAAAACAA","GCTGGGCGCGGTGGCTCATGCCTGTAATCCCAGCACTTTGGGAGGCCAAGGCAGGTGGATCACCTGAGGTCAGGAGTTCGAGACCAGCCTAGTCCACATGGTGAAACCCCATCTCTACTAAAAACTAGCCAGGCGTGGTGGTGCGCACCTGTAATCCCAGCTACTCGAGAGGCTGAGGCAGGAGAATCACTTGAGCCTAGGAAGCAGAGGTTGTGGTGAGCTGAGATCACACCACTGCACTCCAGTCTGGGCGACACAGTGAGACTCTTGTCTCAAAAACAAAAAACAAACAAACAAACAAACAAA"
"GL873587","3208032","3208047","chr8","3626746","3626762","2","418714","AAACAACCACAAAAAA","ACAACAACAACAAAAAA"
"GL873587","3208141","3208321","chr19","2057131","2057316","59","1151010","TTTCTTTTAAAAATCACCCATGGGCTGGGTATAGTGGCTCACACCTATAATCCTCGGGAGGCCAAGGTTGGAGGATTGCTTGAATCCAGGAGTTGAAGGTTACAGTGAACTGGGATTTAGCCACTAGACTCTAGCATAGCTGACAAAGCAAGAACCTATTTGTTTAAAACACAAAAAAGAA","TACTAATAATACAAAAATGAGCCGGGTATGGTGGCGGGTGCCTGTAATCCCAGCTACTGAGGAGGCTGAGGCAGGAGACTTGCTTGAACCCAGGAGGTAAAGGTTGCAGTGAGCTGAGATTGCACCACTACACTCCAGCCTGGGCGACAAGAGCAAAACTTTTTCTCCAAAAAAAAAAAAAAAAAA"
"GL873587","3278260","3278367","chr19","19044200","19044312","39","15765940","CAGTCTGAGCAAGAGGGAGAGGCTATTTCTACTAAAAACAGAAAAACTAGCTGGGTGTTGGGGTGTGTTCCTAGTCTCAGTTACTTGGGAGGCTGAAGTAAGAGGATC","ACCAGCCTGGCCAACACGGTGAAATCCCGTCTCTACTAAAAATACAAAAATTACCTAGGCGTGATGGCACGTGCCTGTAGTCCCAGCTACTCATAAGGCAGAGGTGAGAGAAT"
"GL873587","3278673","3278754","chr7","49412503","49412597","28","46133830","GGCCACGAGAGCTAGCTCATGCCTATTCTAGGAGGCCAAAGCAGGCAGACTGCCTGAGCTCAGGAGTTCAAGAGCAGCCTGG","GGCCAGGTGCAGTGGCTCATGCCTGTAATCCGAGCACTTTGAGAGGCCGAGGCAGGCAGATCACCTGAGGTCAGGAGTTCAAGACCAGCCTAGTA"
"GL873587","3782076","3782188","chr9","112128434","112128552","34","108346358","ACTGGGGTGGCTGAGGCAGGAGCGTCACTTGAACTCAGGAGTTTGAGATTGCTGTGAGCTGAGCAGATGTCATGGCACGCTAGCCTAGGTAATAGAGTGAGACTTCGTCTAAA","CAGCTACTCGGGAGGCTGAGGCAGGAGAATCACTTGAACTCGGGAGGCGGAGGTTGCAGTGAGCCGAGATCACGCCATTGCACTCCAGCCTGGGCAACAAGAGCGAAATTCCATCTCAA"
"GL873587","4564996","4565084","chr20","27900350","27900437","14","23335354","GGCGGGGTGTAGTGGCTCATGCCTATTGTCCCAGCACTGTGGGAGGCCGAGGTGGGTGGATCACCTGTGCTCAGAAGTTTGAGACCAGC","GGCCGGGCGTGGTGGCTCATGTCTGTAATCCCAGCACTTTGGGAGGCCGAGGTGGGTGGATCACCTGAGGTCAGGAGTTCAAGACCAG"
"GL873587","6307870","6308175","chr12","112427710","112428020","54","106119840","GGCCAGATATGATGGCTCATGCTTGTAATCCTAGCACTCTGGGAGGCTGAAGTGGGAGGATCACCTGAGATCAGGAGTTCAAGATCACCCTGAGCAAAAGTGAGATCCCATCTCTATTAAAAATAAAAAAATTATCCAGGCATGGTGGTGCAGTCCTTTAGTCCCAGCTACTTGGGAGGCTGAGGCAGGAGAATCTCTTGAACCCAGGAATTAGAGGTTACAGTGAGCTGTGATGATGCTACTGCACTCTAGCAGGATGACAGAGTGAGATACTCCGTGTCAAAAAAAAAAAAAAAAAAAGCAAAA","GGCTGGACATGGTGGTTCATGCTTGTAATCCGAGCACTTTGGGAGGCCAAGGCGGGTGGATCACCTGAGGTTGGGAGTTCGAGACCAGCCTGACCAACATGATGAAACCCCATCTCTACTAAAAATACAAAAAAATTAGCCAGGCATGGTGATGCACGCCTGTAATCCCAGCTACTTGGGAGGCTGAGGCAGGAGAATCACTTGAACCCAGGAGGCAGAGGTTACAGTGAGCCGAGATCATGCCATTGCACTCCAGCCTGGATGACAGAGTGAGCCTCTGTCTCAAAAAAAAAAAAAAAAAAAAAAAAAAA"
"GL873587","6484004","6484128","chr10","67341428","67341546","29","60857424","GACCAGGTTCTGTGGCTCATGCTTGTAATCCTAGCACTCTAGGAGGCCGGAAGAGGGTGGATTGATTGCCTGAGGTCAGGAGTTAGAGACCAGCCTGAGCAAGAGCTAGACCCTGTTTCTTTCTT","GGCTGGGTGTAGTGGCTCATGCCTGTAATCCCAGCACTTTAGGAGGCCAAGGTGGATGGATTGCCTGAGCTCAGGAGTTCGAGACCACCCTGGGCAACAAGCCAAAACCCTGTCTCTAC"
"GL873587","6484407","6484586","chr3","167196537","167196723","48","160712130","TAGACCCTGTTTCTAAAAAAAAAATAGCCAGGTGTTGAGGCAGGTACCTGTAGTCCCAGCTACCTGGGAGGGCTGAGGCAAGAGAATCGCTTGAACCCAAGAGTTTGAGGTTGCTGTGAGCTGAGATGCTATGGCACTCAACCGTGAGCTACAAAGTGAGACTCTGTCTCAAAAAAAAAA","AAAACCTGTCTCTGCTAAAAATACAAAAATTAGCCGGGTGTGGTGATGTGCGCCTGTAGTCCTAGCTACTTGGGAGGCTGAGGCAGGAGAATCACTTGAATCCAGGAGGTGGAGGTTGTAGTGAGTCGAGATCGTGCGACTGCACTCCAGCCTGGGTGACAGCGAGACTCTGTCTCAAAAAAAAAAA"
"GL873587","7466229","7466364","chr1","29437872","29437991","35","21971643","GGCCAGGCGTGGTGGCTCATGCCTGTAGTCCCAGCGCTATGGGAGGCCGAGGTGGGTGGATCACCTGTGCTCAGAGGTTCGAGACCAGCCAAGACCCCCCTGAGCCAAATGAGCCAGAGTGAGATCCCATCTCTAC","GGCCGGGCGTGGTGGCTCACGCCTGTAATCCCAACATTTTGGGAGGCCAAGGCGGGTGGATCACCTGAGGTCAGAAGTTCGAGACCAACCTGGCCAACATGGTGAAACCCCTGTCTCTAC"
"GL873588","1502535","1502718","chr1","34852429","34852590","60","33349894","GGTGCAGTGGCTCACACCTGTTGTCCCAGCGCTGTGGGAGGCCGAGGTGGGTGGATCACCTGTGCTCAGAGGTCGAGACCAGCTGAAGACCTGCCTGAGGCAGAGTGAGCCAGAGTGAGACCCCGTCTCTACTAGAACAACAACAAGACAGCCAGACCTTGTGATCCCAGCTACATGGGGGGCT","GCCAGGTGCAGTGGCTCACACCTGTAATCCCAGCACTTTGGGAGGCCGAGGCGGGCGGATCACCTGAGGTCAGGAGTTTGAGACCAGCTTGACCAACATGGAGAAACCCCGTCTCTACTAAAAATACAAAATTAGCCTGGTGTGGTGTCGCATGCCTGTAAT"
"GL873588","10189037","10189246","chr3","45604681","45604903","65","35415644","GCTGAGATGAGGAGACTCTGTCTCTATTAAAAATAGAAAAATTGGGTGGATGTTGTGGGTACTGTAGTTGCAGCCTCTTGGGGGGCTAAGGCAGGAGGATCAGTTGAAGCCAGGAATTTGCTTTGAGCTAGGCTAAAGCCATGGCACTCTAGCCTGGGCAACAGAGTGAGGCTAGATCTCAAAAAAAGAAAGAAAAGAAAAAGAAAAAAA","CTGGCCAACATGGCAAAACCCCATCTCTACTAAATATACAAAAATTAGCTGGACGTGGTGGCACATACCTGTAATCCCAGCTACTTGGAAGGCTGAGGCAGGAGAATAGCTTGAACCTGGGAGGCAGAGGTTGCAATGAGCTGAGATCACGCCACTGCACTCTAGCCTGGGCAATAGAATGAGACTCTGTCTCAAAAAAAAAAAAAAAAAAAAAGACAAGAAA"
"GL873589","104719","104807","chr20","27900350","27900437","13","27795631","GGCTGGGCGTGGTGGCTCATGCCTGTTGTCCCAGCGCTGTGGGAGGCTGAGGTGGGTGGATCACCTGTGCTCAGAGGTTCGAGACCAGC","GGCCGGGCGTGGTGGCTCATGTCTGTAATCCCAGCACTTTGGGAGGCCGAGGTGGGTGGATCACCTGAGGTCAGGAGTTCAAGACCAG"
"GL873589","796766","796905","chr1","166346372","166346487","49","165549606","GGCTAAGTGTGGTGGCTCACACCTGTCATCTAGTACTTTGGGAGGGTGGGCCTGGGAGTTCAAAGACTGAACTCAGGAGTTCAAGGTGGCTCCGGGGAGGAATTCAAGACCAACCTGAGCCAGAGCGAGACCTCGACTCT","GGCCAGTGGGGTGGCTCACGCCTGTAATCCCAGCACTTTGGGAGGCTGAGGTGGTCAAATGACCTGAGGTCAGGAGTTTGAGACCAACCTGGCCAACATGGTGACACCTCGTCTCT"
"GL873589","1023679","1023690","chr1","205890061","205890072","1","204866382","AAAAAAAAAAAA","ACAAAAAAAAAA"
"GL873589","1023771","1024047","chr4","103012712","103012993","70","101988941","GGCTTGGTGGCTCACACCTGTAATCCTAGCACTCTGGGAGGCCGAAGTGGCTGGAATACTTGAGGTCAGGAGTTCAAGACCAGCCTAAGTGAGAGTGAGATCCCCATCTCTAATAAAAATAGAAAAATTAGCAGGGTGTTGTGGCTGGCACTTGTAGTCCCAGCTACCCAGGAGACCGAGGCAGAAGTTTGAGATTATTGTGAGCGAGGCTGATGCCACAGCATTCTAGTGGGACAACAGAGCAAAATTCTATCTCAAAAGAAAAAAAAAAAAAGGA","CGGGCGTGATGGCTCACGCCTGTAATCCCAACACTTTGGGAAGCCGAGGCGGACGTATCACCTGAGGTCAGGAGTTCAAGACCAGCCTGGCCAACATGGTGAAACCCCGTCTCTACTAAAAATACAAAAATTAGCTGGGTGTGGTGGCATGCGCCTGTAATCCCAGCTACCCAGGAGGCTGAGGCAGGAGAATCGCTGAGGCTGCAGTGAACTGAAATTGTGCCACTGCACTCCAGCCTGGGTGACAGAGCAAGACTCTGTCTCAAAAAAAAAAAAAAAAAA"
"GL873589","4820958","4821024","chr8","33633747","33633811","15","28812789","TTAGTCAAGTGCAGTGGCTCACACCTGTCATCCCAGCTACTTGGGAGGCTGAGGCAGGAGAGTTGCT","TTAGCCAGGTGTGGTGGTGCATGCCTCTAATCCCAGCTACTCAGGAGGCTGAGGCAGGAGAATTG"
"GL873589","6763768","6763857","chrX","25814002","25814092","29","19050234","GGTGTGGTGGCTCACACTTGTATCTTAGCATTTTAGGAGGCTGAATGGGGAGAATTGCTTTAAGTCAGGAGTCTGACTTCCACCTTGCCA","GGCTGGGAATGGTGGCTCACACCTGTAATCCCAGCACTTTGGGAGGCTGAGGTGGGCAGATCACCTGAGGTCAGGAGTTTGAGATCAGCCT"
"GL873589","8444551","8444632","chr9","93194085","93194171","17","84749534","CGGGCATGGTGGCTCACAACTATAATCTTAGCACTTTGGGAGGCTGAGACAGGTGGATGCCTGAACTCAAGAGTTTGAAACC","GGCCGAGCATGGTGGCTCACACCTGTAATCCCAGCACTTTGGGAGGCTGAGGCAGGTGGATTACCTGAGGTCAAGAGTTCAAGACCA"
"GL873589","9085365","9085494","chr2","194063347","194063481","42","184977982","GGCCAGGCACAGTGGCTCACACCTATAATCCCAGCACTCTGTGAGACTGAGGCAGGTGAACTGTTGCAAGAGTGAGACCCTGTGCTTGGTGCCTGTAGCTCAGTGGTTAATAATAAGAAAAAAGAAAAAA","GGCCAGGTGCAGTGGCTCACACCTGTAATCCCAGCACTTTGGGAGTCTGAACCAGGCAGATCACCTGAGGTCAGGAGTTCGAGGCCAGCTCGGCCACCATGGTGAAACCCTGTTTCTAATAAGAATACAAAAAAA"
"GL873589","9085767","9086002","chr7","84631446","84631650","75","75545679","GAGTGAAACCCTGTCTCTACTAAAAATAGAAAAACTAGCTGTGCATCAGGGCGCATAACTGTAGTCCCAGGTACTCAGGACACTGAGGCAAGAGAATTGCTCAAGCCCAAGAGTTTGCAAGAATTTGAGGTTGCTATGAGCTATGATGCCATGGCACTCTACCTAGGGTGACAGACAGAGACTCTGTCCCAAAAAAAAAAAAAGAAGAAGAAGAAAAAAAAAAAGAAAGAAAGAAA","ATAGTGAAACCTCGTCTCTACTAAAAATACAAAAATTAGCTGGGCATCATGGTGCACGCTTGTAATTCCAGCTACTTGGGAGGCTGAGGCAGGAGAATTGCTTGAACTCAGGAGGTGGAGGTTGCAATGAGCCAAGATCGCGCCACTGCACACCAGCCTGGGTGACAAAAGACTCTGTCTCAAAAAAAAAAAAAAAAAAAAAAAA"
"GL873589","9992904","9993045","chr16","56427538","56427666","46","46434634","AACCAGCCAGGCATGGTGATTCACACCTATAATCCCAGCTACTTAGGAGTATGGCTTGAGCACACAGGATACCATACCATTCTAGTCATCCCAGGCAACAGAGGGAAACTCTGTTGGTTAAAAAAAAAGAAAAACTTAAAAA","TTAGCCAGGAGTGGTGGTGCACGCCTATAATCCCAGCTACTTGGGAGGCTGAGGCACAAGAATCACTTGAACCATTGCACTCCAGCCAGGGTGATAGAGGGAGACTCTATCCAAAAAAAAAACAAAAAA"
"GL873589","9993319","9993452","chr3","2774534","2774668","28","7218785","GGCCTGAGCCCTGTGACTCATGCCTGTAATCCCAGCACTGGAAGTTCCAAGGCAGGTGGATCGCTTGAGCTCTGGAGTTCAAGACCAGCTCAACCAAGAGTAAGACCCCATCTCTACTAAAAATAGAAAAACCA","GGCTGGGCACGGTGGCTCATGCCTGTAATCCCAGCACTTTGAGAGGCCGAGGCAGGTGGATCTCCTGAGGTCAGGAGTTCAAGACCAGCCTGGGCAACATGGTGAAACCCCATCTCTACTAAAAATACAAAAAAT"
"GL873590","9044589","9044884","chr1","83754525","83754835","84","74709936","GGCCAGGTGCAATGGCTCATGCCTATAATCCTCACACTCTGGGAGGCTGAGGCAGGAGGATCACTTTTCTCAGGGTCAGGGCCAGCCTGACAAAAGTCAGACCCTGTTTCTACTAAAAATAGAAAAACTAGCTGGGTGTTGTGGCAGATGCCTATAGTCCCAGCTACTAAGAGACTGAGACAAGTGCCCAGAGTCTGAGGTTACTGTGAGCAAAGCTGATGCCATAGCATTCTAGCTATAGATCGAGAGTCTGTCTCAAAAACAAACAAACAAACAAACAAACAAACAAAAAAGAA","GGCTGGGTGTGGTGGCTCATGCCTGTAATCCCAGCACTTTGGGAGGCCGAGGCGGGTGGATCATCTGAGGTCAGGAGTTCAAGACCAGCCTGACCAACATGGTGTAACCCTGTCTCAACTAAAAATACAAAAATTAGCTGGGCGTGGTGGTGTGCACCTATAGTCACAGCTACTTGGGAGGCTGAGACAGGAGAATTGCTTCAACCCAGGAAGTGGAGGTTGCAGTGAGCCAAGATCATGTCACTGCACTGCAGCCTGACAGAGCGAGACTCCATCTAAAACAAACAAACAAAAACAAACAAACAAACAAA"
"GL873591","1831505","1831587","chr17","61702818","61702899","25","59871313","CCCAGCACTTTGGGAGGGCAAGATGGGAGAATCATATAAAGTCAGGAGTTTGAGACCAGTTTGGCAGACATGATGAACCCATC","AATCCCAGCACTTTGGGAGGCTGAGGCAGGCGGATCATCTGAGGTCAGGAGTTCAAGACCAGCCTGGCCAACATGGTGAAAC"
"GL873591","2719175","2719275","chr4","86137755","86137847","32","83418580","GTGGGGGCTTAGGCCTGTAATCCCAGCACTCTGAGAGGCCAAGGTGAGCTGGTCACCTGGGTTTAGGAGTTTGGAGACTTGCTCGAGCTAGACTGAGGCTC","GTGGTGGCTCACGCCTGTAACCCTAACAATTTGGGAGGCCAAGGCAGGTGGATCACTTGAGGTCAGAAGTTTGAGACCAGCCTGGACAATATG"
"GL873591","4732974","4733120","chr19","7991801","7991954","55","3258827","ATACGCAGACTGGCCGAGCGTGGTGTCACATGCCTATAATCCCAGTGGCTACTCTGGGGAGGAGAATCTCTTGAAACCAAGAGTTAGAGATTGCAGTGGGGTATGATACAGGGTAACAAAGAGAGACCTTGGATCTGAAAAGAAAAA","AAAATACAGAAACTAGCTGGGCATGGTGATGCACACCTGTAATCCTAGCTACTGGGGAGGCTGAGGCAGGAGAATTGCTTGAACCCAGGAGTCAGAGGTTGCAGTGAGCAACCAGCCTGGGTGATACAGTGAGTGAGACTCTGTCTCGAAAAAA"
"GL873591","6822728","6823009","chr1","20579766","20580052","72","13757038","GGCCAGGCGTGGTGGCTCATGCCTGTAAATCTCAGCACTCTGGGAAGCTGAGGCAGGTGGATTGCTTGAGGTCAGGAGTTTGAGACCAGCCTGTACCAGAGTAAGACCCTGTCTCTAATAAAAATAGAAAAAAAAAAAAAAACTAGTTGGGCATGGTGATGGGTGCCTGTAGTCCCACCTACTTGGGAGGCTGAGGCAATGGCATCTCTTGAGCCCAAGAGTTTGAGGTTGCTGTGCCATGGCACTCTCCCCAGGGTAACAGAGTGAAAATAAAAAAAAGAA","GGCCAGGCGTGGTGACTCATGCCTGTAATCTCAGCACTTTGGGAGGCCGAGGCAGGTGAATCACCTGAGGTCAGGAGTTTGAGACCAGCCTGACCAACATGGTGAAACCTCGTCTCTACTAAAAATACAAAAAGTAGCCAGGCATGGTGGCGCATGCCTGTAATCCCAGCTACTTGGGAGGCTGAGGCAGGAGAATCGCTTGAACCCGAGAGGCAGAGGTTGCATTGAGTCAAGATGGTACCACTGCACTCCAGCCTGGGTGACAGATTGAGACTCAAAAAAAAAAA"
"GL873591","7578706","7578813","chr16","45055441","45055543","42","37476735","AAATTTAGCTACACATAGTGGCATGAGTCTGTAATGCTAGCCACCCAAAAGGCTGTAGTAAGAGGATTGCTCTATCCCAGGAGTTAAAGACCAGCCCGGACATCAGAG","AATTAGCCGGGCGTGGTGACACACACTTGTAATCCTAGATACTCAGGAGGCGAAGGTAGGAGAATTGCTTGAACCCAGGCAGCAGAGGTTGCAACGAGCAGAG"
"GL873591","9282916","9283004","chr1","20744253","20744338","16","11461337","GGCCAGGCGCGGTGGCTCACCCCTGTTGTCCCAGTTCTGTGGGAGGCCGAGGTGGGTGGATCACCTGTGCTCAGAGGTTTGAGACCAGC","GGCCAGGCACGGTGGCCACGCCTGTAATCCCAGCACTTTGGGAGGCCGAAGTGGGTGGATTACCTGAGGTCAAGAGTTTGAGACCA"
"GL873592","835155","835315","chr16","75654291","75654451","43","74819136","CTGGGTGTGGTGGCTCTTGTCTGCAATCTCAGTACACTGGGAGGCTGAGGCAGAAGGATTGCTCCAGCTCAGGAGTTTGAGGCCAGGCTGAGCTAGTGCAAAACCCCATCTCTACTAAAAAAAGAAGGAAAAAAAAAAGAAAAAGAAAAAAAATACGAGCT","CCAGGTGTGGTGACTCACGCCTGCAATCCCAGCACTCTGGGAGGCTGAGGTGGGTAGATTACCGGAGGTTAGGCGTTTGAGACCAGCCTGGCCAACATGGTGAAACCCCATCGCTACTAAAAAAAAAAAAAAAAAAAAAAAAAAAAAAAAAAAAAAAATTA"
"GL873592","835589","835765","chr1","66836166","66836336","48","66000577","ACAAAAAACCTAGCTTAGGGTTGTTATAGCACCTGTAGTCCCAGCTACTCAGGCGCTAAGGCAGGAAAATCTGCCTGAGCTCAGGAGTTTGAGGTTGCAGTAAGTTATGATGATGCTACTGCACTCTAGCTGGGGCAACAGAGTGAGACTCTGTCTGAGGAAAAACCAAAACCAAAA","TAGCCCAGCACGGTGGCTCACACCTGTAGTCTCAGCTACTCAAGAGGCTGAGGCATGAGAATCGCTTGAACCCAGGAGGTAGAGGTTGCAGTGAGCTGAGATCATGCCACTGCGCTCCAGCCTGGGCAACAGAGTGAGACTCAGTCTCAAAAAACAAAACAAAACAAAAAA"
"GL873592","2520661","2520705","chr16","66853217","66853257","11","64332556","TCTGGGAGGCTGAGGCGGGTGGATCACCTGAGCAAGAGTGAGACC","TTTGGGAGGCTGAGGCAGGTGGATCACTTGAGGTCAGGAGT"
"GL873592","4535248","4535388","chr1","12240468","12240612","38","7705220","GGCGGGATGTGGTGGTTCATGGCTGTAATCCCAGCACTCAGGGAGGCTGAGTCGGGTGGATTGCTTGAGTTCAGGAGTTTGAGACCAACCTGAGCAAGAACTAAGCCTGTCTCTACTAAAGATATTATTTCTTATTTTTCT","GGCCGGGCGCGGTGGCTCATGCCTGTAATCCCAGCACTTTGGGAGGCTGAGGCGGGTGGATCACCTGCGGTCAGGAGTTCGAGACCAGCCTGGCCAACGTGGTGAAACCTCATCTCTACTAAAAATATAAAAATTAGCTGGTGTG"
"GL873592","4535654","4535831","chr8","126054004","126054184","54","121518350","TCTACTACAAATATTAACAGAAAAATTAGCTGGGCATTGTGACAGGTGCCTATAGTCCCAGATACTCAGAAGGCTGAAGTAAGAGGATCACTTGAACCCCAGGAGCTAAGGTGGCTGTGAGCTAGGCTGAGGCTCTAGCCTGGGTAACAGAGTGAGACTGTAAAAAAAGAAAGAGAGA","GTCTCTACTAAAAATACAAAAATTAGCTGGGTGTGGTGGTGCATGCCTGTAATCCCAGCTACTCAGGAGGCTGAGGCAGGAGAATCGCTTGAACCCAGGAGGTAGAGGTTGCAGTGAGCCAAGATCATGCCACTGCACTCCAGCCTGGGTGACAGAGGGAGACTCTGTCTCAATAAATAAA"
"GL873592","6794968","6795049","chr3","154764711","154764794","20","147969743","GAAGGTTTGATGAGCTCAGATGATGCCACTGCAGTCTACCCAGAGTGAAGGAGCGAGACTCTGTCTCAAAAACAAAAAAAGA","CAGAGGTTGGCAGTGAGCTGAGACTGTGCCACTGCACTCCAGCCGGGTGACAGAGTGAGACTCTGTCTCAAATTACAAACAAAA"
"GL873592","6881384","6881478","chr5","24882384","24882475","28","18001000","GGGCAGGCATAGTGACTGGTGTCTCTAATCCTAGCAGTCTGGGATGCTGAGGCAAGTGGAATGTCAGAGTTCAGGAGTTGAAGATCACCCTGACT","GGCCGGGCGCAGTGGCTCACATCTATAATCCTAGCATTTTGGGAGGCTGAGGCAGGCGGATCACCTGAAGTCAGGAGTTTAAGACCAGCCTG"
"GL873592","6881755","6881937","chr10","61601371","61601572","66","54719616","TCACCCTGACCAAGAGCAAGACCCTGTCTCTACTAAAAATAGAATAAACTAGCTGGGAATTGTGGTGGGTGCCAGTAGTCCCCGCTACTGAGGCAGGAGGATCATTGAGTCCAAGAGTTTGAGGTTGCTGTAAGTTAGGACACCACAGCACTCTACACAGAGTAAGACTGCCTCAAAAATAAA","AGTAAAGAAAAGAAACCCTGTCTCTACTAAAAATACAAAAATTAGCTGGGTGTGGTGGTGCGCACCTGTAGTCCCAGCTACTTGGGAGGGTGAGGTATGGGAATCACTTGAACCCGGGAGGTGGAGGTTGCAGTGAGCCAAGATCACACCACTGCACTCCAGCCTGGGTGAGAGAGTGAGACTCTGTCTCAAGAAAAAAGAA"
"GL873592","7006080","7006155","chr1","8947061","8947129","24","1940981","CACACTGAGAGGCAAAGGCTGGTGGATCACCTGAGCTCAAGAGTTTGAGACCAGCCAAGCCAGAGATCTTGTCTCT","CACTTTGGAGCCAGGTAGGTGATCACCTGAGTCAGGAGTTCGAGACAGCCTGGCCAACATGTGAAACCC"
"GL873592","8446508","8446655","chr11","122502739","122502874","48","114056231","TTAGCTGGGTGTTGTGGCAGGCACCTGTAGTCCCTCCCAGCTACTTGAAAGGCTGAGGCAAGATGACAGCTTAAACCCAAGAGTTTAAGGTTACTCTATTCAGGGCAACAGAGTGAGACTCCATCTACATAAATAAATAAATAAATAA","GGCTGGGCGTGGTGGTTCACACCTGTAATCCCAACACTTTGGGAGGCTGAGGCCAGCGGATTGCCTGAGCCCAGGAGTTTGAGACCAACCTGGGCAACATGGTGAAACTCCATCTCTACTAAAATACAAAAAGTTA"
"GL873592","8446953","8447008","chr16","44513352","44513404","15","36066399","GACCAGCCTAAGCAAAAAAGAGATCCTATCTCTACTACTAAAAATAGAAAAAATTA","ACCAGCCTCACCAATATGAAGAAACCCCATCTCTACTAAAAATACAAAATATT"
"GL873592","8447239","8447325","chr1","8062863","8062957","21","384376","GGCCAGGAGCAGTGACTCATGCCTAGCACTCTGGGAGGCCAAAGCAGGTGGATCAACTGAGCTCAGGAGTTCAAGACCAGCCTAAGC","GGCCGGGTGCAGTGGCTCATGCCTGTAGTCCCAGGACTTTGGCAGGCCAAGGCCGGTGGATTACCTGAGGTCAGGAGTTCAAAACCAGCCTAGCC"
"GL873592","8723925","8724000","chr3","42066983","42067054","20","33343058","AATTAGCCGGGCATGGTAGTGTGTGCCCATAATCTCAGCTACTCAGAAAGCTAAGATAGGAAAATTGCTTGAGCTC","TTAGCTGGGTGTGGTAGTGCATGCCTATAATCCCAGCTACTCGGGAGGCTGAGGTGGGAGAACTGCTTGAAC"
"GL873593","384022","384146","chr15","102382935","102383070","28","101998913","GGCCACGAGGGCCCATGCCTGTAATCCTAGCACTCTGGGAGGCTGAGGTGAGTAGATTGCTGAGCTCAGGAGTTCAAGACCAGCCTGTGCAAGAGACCCCATCTCTGCTAAAAATAGAAAAACCA","GGCCAGGTGTGGTGGCTCACGCCTGTAATCCTAGCACTTTGGGAGGCTGAGGCGGGTGGATTGCCTGAACTCAGGAGGTCAAGACCAGCCTGGGCAACACAGTAAAACCCCATCTCTACTAAAATACAAAAAATCA"
"GL873593","384425","384607","chr20","28286874","28287058","50","27902449","GAAAGAAAAGAAAAGAAAAACTAGCAAGATGTTGTAGCTGATGCCTATAATCCTAGCTATTGGAGAGGTGGAGGCAAGAGAATTGCGTGAGCCCAAGAGTTGAAGGTTGCTGTGAGCTGCGATGCCAGAGCACTCCAGGGTGACAGAGTAAGACTCTGTCTCAAAAAAAATTACAAAATAAAA","TAATAAAAATAAAAAAATTAGCCAGGAGTCAAAGCACACGCCTATAACCCCAGCTACTTGGGAGGCTGAGGGAGGAGAATTACTTGAACCCGGGAGGTGAAAGTTGCAATGAGCTGAGATCAAGCCACTGCACTCCAGACTGGATGACAGAGTGAGACTCTGTTTCAAAAAAAAAAAAAAGACAA"
"GL873593","1408445","1408467","chr10","88070368","88070389","9","86661923","AATCTAGAGATGGGGAGAGGTTG","AAAGAGATGGAAGAGAAGAAGA"
"GL873593","4856365","4856484","chr7","56497314","56497433","31","51640949","GCAATCCCAGCTGATCGGGAGGCTGACCCAGAAGAATCCCTTGAACCCAAGAGTCTGAGGTTGCTATGGGTGGATTCTACAGCACTCTAGCCTGGGAGACAGAGTGAGACTCTGTCCCAA","ATCCCAGCTACTTGGGAGGCTGAGACAGAAGAATTGCTTGAACCCGGGAGGTGGAGGTTGCAGTGAGCCAAGATTGTACCACTGCACTCCAGCCTGGCAACAGAGTGAGACTCTGTCTCA"
"GL873593","6661298","6661485","chr10","86749316","86749514","55","80088018","GCAGAGGCTCACATATGTAATCCTAGCACTCTGGGAGGATAAGGCAGGTGGACAGCTTGAGCTCAGGGGTTTGACCAGTCTGATCAAGAGCAAGACCTGTGTCTACTAAAAATAGAAAACCTAGCCAGGTATGATGGTAGATGCCTGTATTCCTAGCTACTCTGGAAGCTAAAGCTAAAGAGTTTGAA","GGTGGCTCACACCTGTAATCTTAGCAATTTGGGAGGCCGAGGTGGGTGGATCACTTGAGGTCAGGAGTTTGAGACCAGACTGGCCAACATGGTGAAACTCTGTCTCTACTAAAAATACAAAAATTAGCCAGTCATGGTGGTGCATGCCTGTAATCCCAGCTACTCAGGAAGCTTAGGCAGGAGAATCACTTGAACCCAG"
"GL873593","6710263","6710446","chr14","4390080","4390244","66","2320183","TTGAAGTCAGGAGTTTAAGGCCAGTCTGGGCAACATAGTGAGACCCCCATCTCTACGAAAATATTTTTTAAAAATTAAAAATAGCTGGGCATAGTGAGGCTGTTGTGAGCTATAACTGCACCACTGCACTCAGCCAAGGACAGAGACCCTGTTCCCTGCCTCAAACAAACCAAAACAAAACAAA","AAGTCTAGAGTTTACAGCCTGGACAACGCAGTGAAACCCTGTCTCTACCAAAAATACAAAAATTAGACAGGTGTGAGAGGCGGAGGTTGCAATGAGCTGAGATCGCAGCACTGCAGTCCAGCCTGGATGACAGAGCGAGACCCCATCTCAAAAACAAAAACAAAA"
"GL873593","7159645","7159716","chr6","178318394","178318465","21","171158749","GATCATGTCACTGCTCTCCAACCTGGGCAATTGAGCAGGAATCTGTCTCAAAAAGAAAAAAAAAAAAGAAAA","CGAGTTCACACCACTGCACCCCAGCCTGGGCAACAGAATGAGACTCGGTTTCAAAAAAAAAAAAAAAAAAAA"
"GL873593","7159841","7160050","chr13","33368171","33368368","69","26208330","GGCCAGGCGTGGTGGCTCACACCTGTTGTCCCAGTGCTGTGGGAAGCCGAGGCAGGTGGATCACCTGAGCTCAGCCGAGTTCGAGACCAGTGGAAGACCAGCATGAGGCAGAGTGAGCCAGAGTGAGACCCCATCTCTACAACAACAACAAGAAGAAAAAAAACAGCCGGACCTTGTGATCCCAGCTACGTGGGGAGCTAGAGAATCACT","GGCTAGGCATGGTGGCTCATGCCAGTAATCCCACCACTTTGGGAGGCCGAGGCAGGTGGATCACCTGAGGTCAGGAGTTCAAGACCAGGCTGGCCAACATGTTATGATGAGACCCTCATCTCTACTACAAATACAAAAATCAGCTGGGCATGGTGGCAAGTGCCTGTAATCCCAGCTACTTGGGAGGCTGAGGCAGAA"
"GL873593","8598292","8598391","chr11","118461023","118461129","33","109862731","AGCCAGGTGAGGTGGTTCACACCTGTAACCCTAGCTGCTTGGGAGGCTGAGGCCTCTCTATCCTGGGCAGTGTGGAGAAACTTTGTTTCAAAAAAAAGAA","GCCGGGCGCGGTGGCTCACGTCTGTAATCCCAGCGCTTTGGGAAGCCGAGGCGGGACTATCCTGGCCAACATGGTGAAACCCCGTCTCTACTAAAAATACAAGAATC"
"GL873594","357249","357377","chr2","75702890","75703011","36","75345641","CCTGGTACCGTAGGTCATGCCTGTAATCCTAGCACTTTGGGATGCTGAGGTGGGCAGATTGCCTGAGCTCACGAGTTCAAGCCATTAGAACTGAGCCTGACCTAGAGTGGGACCTCCAACTCTTTTTTT","GCCAGGCACAGTGGCTCATGCCTGTAATCCCAGCAGTTTGGGAGGCTGAGGTGGGCAGATCACTTGAGGTCAGGAGTTCAAGACCAGCCTGGCTGACATGGTGAAACCCCATCTATACCAAA"
"GL873594","357656","357834","chr7","17608776","17608965","55","17251120","GGGACCTCCAACTCTTAAAATAGCTGGGCATTGTGGTGGGCACCTACAGTCACAGCTACTTGGGAGGCTAAGGCAAGAGACTTGTTTGCAGCCAAGAGTTAGAGGTTGCTGTGAGCTATGAGGCTAGGGCACTCTACAGGGGGCGACAAGTGAGACTGTAAAAAAAAAAAAAGAAAAAA","GTCCCTACTAAAAATACAAAAAATTAGCTGGGCCTGGTGGCAGGCACCTGTAATCCCAGCTACTTGGGAAGCTGAGGCAAGAGAATTGCTTGAACCCAGGAGGCAGAGGTTGCAGTGAGCTGACATCAAGCCACTGTACTCCAGCCTAGGCAACAAGAGCAAGACTCTGTCTCAAAAAAAAAAAAAAAAA"
"GL873594","1410711","1410996","chr5","151340503","151340797","76","149929792","CACAGTGGCTCATACCTATAATCCTAACACTCTGGGAGGCCAAGGTGGGTGGACTGTCTGAGTTTGGGACCAGCCTGAGCAAAAGCAAGACTCCCATCTCTACTAAAAACAAAGACAGCCAGGTATGAGGGCAGGTGCCTATCATCCCAGCTACTTGGGAGGCTGAGGAAGGAGGATCACCTAAGCCCAGGACTTTAAGGTTTCTGTGAACTAAGATGATGTTACAACACTCTAGCCAGGGTAACAAGGCAAGATTCTGTTTCAAAAGACAAAAAAAAAAAAAAAA","GGTGGTTCATGCCTGTAATCCCAGCACTTTGGGAGGCTGAGGCAGGTGGATCACCTGAGGTCAGGAGTTCGGGACCAGCCTGGCCAACATGGGGAAACCCCATCTCTACTAAAATACAAAAATTAGCCAGGTATGGTGGCACATGCCTATAATCCCAGCTACTTGGGAGGCTGAGGCAGGAGAATCACTTGAACCCAGGAGGCTAAGGTTGCAGTGAGCCGAGATTGTGCCACTGTACTCCAGCCTGGGTGACAGACTGAAACTCTGTGTCCAAAAAACAAAACAAAACAAAAAA"
"GL873594","5528090","5528162","chr2","69013639","69013718","24","63485549","GGTACAGTGGCTCACGCTTGTGATCCCAGGTTGAGGTGGGTGGATCGCCTGAGCTCAGGAGTTGGATGCCAGC","GGTGTGGTGCCTCACGCCTATAATCCCAGCACTTTGGGAGGCAGGTGGATCACTTGAGGTCAGGAGTTTGAGAACAGCCT"
"GL873594","5834047","5834168","chr2","82491537","82491662","28","76657490","GGCTGGGCCCAGTAGCTCACGACTGTAATCCCAGCACTCTGGGAAGCTGAGGTGGGCGGATCACCTGAGCTCATAGGTTCGAGACCAGCTCCAGTTAGAGTGAGAGCCTGTCTCTAAAAATA","GGCTGGGCACAGTGGCTCATGCCTGCAATCCCAGCACTTTGGGAGGCTGAGGTGGGCAGATCACCTGAAGTCAGGAGTTCAAGACCAGCCTGGCCAACACAGTGAAACCCCATCTCTACTAAAAAT"
"GL873594","5834396","5834461","chr13","14688151","14688212","20","8853755","TATATAATAATAATAACCAGGTATTGTGGCAGGTGCCTCTAGTCCCAGCTACTCGGGAGGCAAAGG","ATAAAAAAATTAGCTGGCCATGGTGGCACATACCAATAATCCCAGCTACTCAGGAGGCTGAG"
"GL873594","7786130","7786294","chr14","12217087","12217250","37","4430957","GGGTGTGCTGGCTCATACCTATAATCCTAGCACTCTGGGAGGCTGAGGTAGGTGTATTGCTTGAACCCAGGAGTCTGAGGTTGCTGTGCGCTAAGCTGATACCATAGCACTCTAGCCTGGGCAACAGAGTGAGACTCTGTCTCAAAACAAATAAATAGTAAAAAA","GCTGGGCGTGGTGGCTCACACCTGTAATCCCAGCACTTTGGGAGGCCAAGGCATGAGAATTGCTTGAAAACAGGAGGCGGAGGTTGCAGTAAGCTGAGACTGTGCCATTGCACTCCAGCCTGGGCAACAAGAGTGAAACTCTGTCTCAGAAAAAAAGAAAAAAA"
"GL873595","723579","723774","chr19","6045933","6046125","65","5322354","GCCTGAGCAGGAGAGAGACCCCATCTCTGCTGAAAGTGGAAAAGTTGGCTGAGTGTAGTGGCGGGCTGCTGCCCCAGTCACTCAGGAGGCTTAGGAAGGAGTATCGCTTGGGCCCAAGATTTGAGGTTGCTGTGAGCGCTACAAAGACATTAGGGTACTCTACACAGGGGAATAGAGTGAGACTGTCTCAAAAAAA","CAACATGGAGAAACCCCGTCTCTACTAAAAATACAAAATTAGGCAGCGTGGTGGTGGGTGCCTATAATCCCAGCTACTCAGGAGGCTGAGGCAGGAGAATCGCTTGACCGGGAGTGGAGGTTGCGGTGAGCTGAGATTGCACCATTGCACTCCAGCCTGGGCAACAAGAGTGAAACTCCGTCTCAAAAAGAAA"
"GL873595","724114","724204","chr20","18199749","18199840","22","17475635","GGCCATGCTTGGTGGTTCTCATCTGTAATCCTAGCACTCTGGAAGGTCTACAGGGGTGGATGGCTGGAGGTCAGGAGTTCAAGACTGGCCT","GGCCGGGCATGGTGGCTCACACCTGTAATCCCAGCACTTTGGGAGGCTGAGGCAGGCGGATCACCTGAGGTCAGGAGTTCGAGACCGGCCTG"
"GL873595","1065346","1065667","chr18","10529729","10530057","74","9464383","GGCCAGGTGCAGCAGCTCATGCCTGGAATCTTCCTGCTCTGTATGGCCAAGGCAGGTGGATCGCCTGACCTCAGGAGTTCCAGACCAGCCTGAACAAGAGCAAGACTCTGTCTCTACTAAAAGTAGAAAAAAAACTAGCCAGTCATAGTGGCAGGTGCCTGTAGTCCCAGCTGCTTGGGAGGCTGAGGCAAGAGGATCACTTGAACCTAAGAGTTTGAGGTTGCTGTGAGCTAAGATGCCACATCACTCTATCAAGGGTGACCAAGTGAGACTCTGTCTCAAAAATAAATAAATAAATAAATAAAAAGAAAGGCAAAAAGAA","GGCCCGGCGTGGTGGCTCATGCCTATAATCCCAGCCCTTTGGGAGGCCAAGGCAGGTGGATCACCTGAGGTCAGGCGTTCGAGACCAGCCTGACCAACGTGGTGAAACCTCATCTCTACTAAATACAAAAAAAATTTAGCCAGGCATGGAGGCACATGCCTGTAATCCCAGCTACTTGGGAGGCTGTGGCAGGAGAATCACTTGAACCTGGGAGGTGGAAGTTGCAGTGAGCTGAGATTGTACCACTGCACTCCAACCTGGGTGACAAAGCAAGACTCGGTCTCAATAAATAAATAAATAAATAAATAAATAAATAAAGTGAAAAAAAA"
"GL873595","1254878","1255146","chr4","42822326","42822607","67","41567448","GGCTGGGCATGGTGGCTCATGCCTGTAATCCTACCGCTCTGGGAGGCTGAGGCAGAGGATCACTTGAGCTCAGGAGTTTCAGACCAGCCTGCAAGAAGGACCCAGTCTCTGCCGAAAATAGAAAAGTTAGCAAGGCGTTGTCGTGAGCACATGTATCCCAGCTACCTAGAACTCTGAGGCAGGAGGATCCCTTGAACCCACAGAAGTTGCTGTTATCTAAACTGATGCCACTGGACTCTAGCCTGGGCAACAGAGTGAGACTGGTCTCA","GGCCGGGCACGGTGGCTCATGCCTGTAATCCTAGCATTTTGGGAGGCTGAGACAGGCAGATTGCCTGAGCTCAGGAGTTCAAGACCAGCCTGGGCTAGATTGTGAAACCCCATCTCTACTAAAATATAAAAATTAGCTGGGTGTGGTGGCACACGCCTGTAATCCCAGCTACCTGGGAGGCTGAGGCAGGAGAATCGCTTGAACCAGGAGACAGAGGTTGCAGTGAGCTGAGATCACGCCACTGCACTTTAGCCTGGGCAACAGAGTGATACTCTGTCTCAA"
"GL873595","3417105","3417297","chr12","115674238","115674427","44","112257133","GGCCGGGCGCTGTGCCTCACGCCTGTAATCCTAATACTCTGAGAGGCCGAGGCAGGTGGATTGCCTGAGCTCAGGTGCTCAAGACAGCCTGACTGAGCAAGCCCTGAGATCCCATCTCCACTAACAATAGTAAAACTAGCCGGGCATTGTGGTGGTGCTTGTAATCCCAGCTACTGGGAGGCTAAGACAGGAG","CCAGGCCTGGTGGCTCACGCCTGTAATCCCAGCACTTTGGGAGGCCGAGGTGGGTAGATCACCTGAGGTCAGGAGTTCAAGACCAGCCTGGCCAACATGGCGAAACCCCATCTCTACTAAAAATACAAAAATTAGCTGGGCATGGTGGTGTATGCCTGTAATCCCAGCTACTCGGGAGGCTGAGGCAGGA"
"GL873595","6098380","6098457","chr3","87492619","87492702","21","81394239","GCTGTGGCTCATGCTGATAATACCAGCACTCTGGGAGAACAAGGTAGGCAGATCACAAGAGGTCACCTGTGCAAGACC","GGGCTGGTGGTGGCTCATGCCTGTAATACCAGCACTTTGGGAGGCCAAGACAGGTGGATCACCAAAGGTCAAGAGTTCAAGACC"
"GL873596","134190","134307","chr1","203207333","203207443","31","203073143","GGCTGGGCGAGGTGGCTCACACCTGTAATCCTAGCACTCTGGAAGGCCCTAGCACTCAGGCAGTTGGATTGCCTGAGCTCACAAGTTCAAGACCAGCCTGAAAAAGAGCAAGACCTCA","GGCTGGGTGCAGTGGCTCACACCTGTAATCCCAGCACTTTGGGAGGCCGAGATGGGTGGATCACTTGAGGTCAAGAGTTGAAGACCAGCCTGGACAACATGATGAGACCCC"
"GL873596","134578","134681","chr11","50235285","50235387","37","50100707","CAAACAAAAGAGGAAGACCTCGTCTCTAAAAAAATAGCTGGGCATTGTGAGGAGTACCTGTAGTCCTAGCTACTCAGAAGGCTGAGACAAGAGAATCACTTAAA","CAACATTGTGAAACCCTGTCTCTACTAAAATAGAAAATTAGCCAGGTGTGTGGGCGTGCCTATAATCCTAGCTACTGGGGAGGGTGAGGCATGAGAATCGCCT"
"GL873596","8160215","8160350","chr1","29437872","29437991","30","21277657","GGCCGGGCGTGGTGGCGCACACCTGTAGTCCCAGCGCTATGGGAGGCCGAGGCGGGTGGATCACCTGAGCTCAGAGGTTCGAGACCAGCCAAGACCCCCCTGAGCCAAACGAGCCAGAGTGAGACCCCGTCTCTAC","GGCCGGGCGTGGTGGCTCACGCCTGTAATCCCAACATTTTGGGAGGCCAAGGCGGGTGGATCACCTGAGGTCAGAAGTTCGAGACCAACCTGGCCAACATGGTGAAACCCCTGTCTCTAC"
"GL873596","8421071","8421132","chr20","1874027","1874093","12","6547044","GTCAGGCGCAGTGGCTCACGCCTGTAATCTCAGCACTCTGAGAAGCCAAGGCAGGATCATCT","GGCCAGGCGCAGTGGCTCAGGCCTGTAATCCCAGCACTTTGGGAAGCCAAGGTGAGCAGATCACCTG"
"GL873598","4416400","4416489","chr5","39418145","39418231","15","35001745","GGCCAAGTGTGGTGGCTCATGCCTGTTGTCCCAGCACCGTGGGAGGCCGAGGCTGGTGGAACACCTGAGCTCAGCTGAGTTTGAGACCAG","GGCCAGTTGCGGTGGCTCATGCCTGTAATCCCAGCACTTTGGCAGGCTGAGGCAGGTGGATCACCTGAGGTCAGGAGTTTGAGACCA"
"GL873598","4416855","4416947","chr3","94091253","94091337","31","89674398","GTGAGACCCTGTCTCTACAAAAAAAAAAGCTGGGCACTGTGGCATGTGCCTGTAATCCCAGCTACTTGGGAGGCAAAGGGAAAGAGAATCACT","AAACCTTGCCTTTACTAGAAATACAAAAATTAGCTGGGCATGGTGGCAGGTACCTGTAATCCCAGCTACTTGGGAGGCTGAGGCA"
"GL873598","5126074","5126161","chr1","12339306","12339394","19","7213232","GCCTGGTGCACTGGTTCACACCTGGAATCCTTGCATTCTGAGAGGCCCAGGTAGGCAGATCACCTCAGCTCAGAAGTTCGAGACCAGC","GCTGGGTGCGGTGGTTCACGTCTGTAATCCCAGCACTTTGGGAGGCCGAGGCGGGCAGATCACCTGAGGTCAGGAGTTCGAGACCAGCC"
"GL873598","5467584","5467662","chr1","9313328","9313403","17","3845744","GCGAGGTGGCTCACGCCTGTAATCCCAGCACATTTGGAAGGCCAAGGAGGGTGGATCACCCGAGCTCACCAGTTGGAGA","CGCAGTGGCTCACGCCTGTAATCCCAGCACTTTGGGAGGCCGAGGCAGGCAGATCACCTGAAGTCAGGAGTTTGAG"
"GL873598","6917752","6917856","chr14","9558287","9558382","22","2640535","GGCCAGGCATGGTGGCTTGTGCCTGTTGTCCCAGCACTGTGGAAGGCCGAGGCGGGTGGATCGCCTGAGCTCAGCTGAATTCGAGACCAGCATAAGACCAGTATG","GGCCAGGCATGGTGGCTTATGCCTGTAATCCCAGCACCTTGGAAGGCCGAAGCGGGCAGATCACCTGAGCTCAGGAGTTTGAGACCAGCCTGTCCA"
"GL873598","8078910","8079062","chr7","164825511","164825660","43","156746601","AACAGCCAGGCATTGTGGTGGGCACCTGTAATCCCAGCTACTTGGGAGGCTGAGGCAAGAGAATTGCTTGAGCCCAACAGTCTCAGGTTACTGTGAGTTATGACACCATGGCACTCTATTGAGGGCAAGAAAGTGAGACTGTCTTGGAAAAAA","CTAGCCAGGCATGGTGGTGCGCACCTGTAGTCCCAGTTACTTGGGAGGTTGAGGCAAGAGAATTGCTTGAGCCTGGAAGGCAGAAGTTGCAGTGAGCTGAGATCACACCACTGCATTCCAGCCTGGGCGAAAGAGCAAGACTCTGTTGAA"
"GL873598","8079328","8079454","chr6","10381248","10381379","32","2301920","GCCCGGCGTGGTGGCTCACGCCTGTAATTCCAGCACTCTGGGGAGGCCGAGGAGGGCAGATTGCCTGAGCTCACAGGTTTGAGCTAGAGCGAGACCCTGTCTCTTAAAAAGAAAAAAAAGGAAAGAA","GCTGGGCGCGGTGGCTCACGCCTGTAATCCCAACACTTTGGGAGGCCGAGGCGGGCAGATCACCAGAGGTGATCTCCAGCCTGGGCAGGAGAGCAAGACCCTGTCTCAAAAAATTTAGAAAAAGGAAAGAAA"
"GL873599","3943256","3943456","chr9","35892110","35892312","79","31948854","GGCAGGCTGCTTTGACCCATATCTACAACTCCAGAACTTTAGAGGCTGAGCTGGGTGGGTCCCTTGAGATTAGAAACTGCTTAGTAGCCTGGCAAAAACCAGACCCCACCTCCACCATGTAGAAAAATTAGCAGTATGCCATAGTGGGAACCTACCAATACAGTCTTTCCAAAGGCCAAAGCTAGAAGGACCGTGAGCTTG","GGCTGGGTGTGGTGGCTCATGCCTATAATTCCAGCACTTTGGGAGGCCGAGGCAGGTGGATCACCTGAGGCCAGGAGTTTGAGACCAGCCTGGCCAATATGGTGAAACCCCATCTCTACTAAAAGTACAGAAAATTAGTCAGTCATGATGGCGCATGCCTATAATCCCAGTTACTCGGGAGGCTAAGGTAGGAGAATTGCTTG"
"GL873599","6693284","6693349","chr1","100916857","100916922","15","94223573","TCACGTCTATAATCCTAGCACTCTGGGAGTCCTTGGCAGGTGGATCACCTGAGCTCAGGAGTTTGA","CATGCCTGTAATCCCAGCACCTTGGGAGGCCAAGGTGGGTGGATCACCTGAGGTCAGTAGTTTGAG"
"GL873600","991618","991705","chr15","13850109","13850195","15","12858491","GGCTGGGCGTGGTGGCTCACACCTGTTGTCCCAGCGCTGTGGGAGGCTGAGGCAGGTGGATCACCTGTGCTCAGAGGTTGAGACCAGC","GCCGGGCGCTGTGGCTCACACTTGTAATCCCAGCACTTTGGGAGGCTGAGGCAGGTGGATCACCTGAGGTCAGGAGTTAGAGACCAG"
"GL873600","8825981","8826014","chr16","43605817","43605844","11","34779836","AGTCTGGGGCAACAGAGCAAGACTCTGTCTCAAA","CAGTCTGGGTGACAGAGCAAGATTCCAT"
"GL873600","8826039","8826157","chr13","87428402","87428520","35","78602363","ATTAGCCTGGTGTGGTGGTATATGCCTTCCTGCCTGCTTGGGAGGCTGAGGCAGGAAGTATGCTTTAACTGTGGAGTCTGAGGTTGCTATGAGCTAGGTTGAGGCCATGGCACTCTAAA","TTAGCCGGGTGTGGTGGTGCACGCCTGTAATCCCAGCTACTCAGGAGGCTGAAGCAGGAGAGTTGCTTGAACCCAGGAGTTGGAGGTTGCAGTGAGCTGAGATCACGCCATTGCACTCC"
"GL873601","269289","269338","chr14","49279240","49279285","14","49009951","GACTGGGTGTGGTGGCTCACACCTTTAATCCTAACACCCTGGGAGGCTTA","GGCTGAGATGGTGGCACACACCTGTAATCCCAGCTACTTGGGAGGC"
"GL873601","269431","269678","chr1","184453273","184453521","76","184183842","AGAAGATCACTCAAGATCAGGAGTTTGAGAACAGCCTGAGCAAGACCCCCATCTTTACTAAAAATGGAAAAGTTTTTACCCAGGCATGGTAGTGCGTGCCTGTATCCCATCTACTCCGGAGGCTGATAGGAGGATTGCTTCAACCAAGGAGTTTGAGGTTCCAGAGACTTAAGATGACACAACTGCATTTTACCCAGTGTGACACAGCGAGACTCTTTCAGAAGAATTTTTAAAAGGAAAAAAAAGAA","GGTCAGATCACCTGAGGTCAGGAGTTTGAGACCAGCCTGACCAACATGGTAAAACCCCATCTCTGCTAAAAATACAAAAAATTAGCCAGGCATGGTGGTGAACGCCTGTAATCCTAGCTACTCAGGAGGCAAAGACAGGAGAATCGCTTGAATCTGGAAGGTGGAGGTTGCAATGAGCCAAGATGACGCCACTGCACTCCAACCTGGGTGACAGAGGAAGACTCCATCAAAAAAAAAAAAAAAAAAAAA"
"GL873601","1397978","1398117","chr16","24839455","24839591","34","23441477","GCCTATAATCCTAGCACTCTGGAAGGCTGAGGCAGGAAGATCACTAGAGCTTGGGAGTTTGAGATTGCTGTGAGGGAGACTGACTCCATGGCACTCTAGCCTGAGGCAACAGAGTAAGACTCCATCTCAAAAAAAAAAAA","CTCTAACTCCAGCTACTCAGGAGGCTGAAGCAGGAAAATCACTTGAACCTGGGAGGTGGAGGTTACAGTGAGCCAAGATCACACCATTGCACTCCAGCCTGAGCGACAGAGCGAGACTCTGTCTCAAAATAAATAAA"
"GL873601","4065502","4065590","chr11","108711352","108711444","19","104645850","GCTGGATGTGGTGGCTCTCACCTATAATCCTAGCACTCTGGGAGGTCAAAACAGGTGGATCACCTGAGCTCAGGAGCAAGAACACCAGC","GTCAGGGGTGGTGGCTCACGCCTGTAATCCCAGCACTTTGGGAGGCCAAGGCAGGTGGATCGCCTGAGCTCAGGAGTTCAAGACCAGCCTTGC"
"GL873601","8241370","8241465","chrY","9469734","9469829","34","1228364","AAAAAAGGTGGAGATGAGCCATGCGCAGTGGTGTAGGCCTGTAATCCCAGCCCTTGGGAGGCCAAAATGGTGGATTGCCTGAAGCAGAGCAAGACC","AAAGTACAAAGAGTCTGGGTACAGTGGCCCAAGCCTGTAATCCCAGCAGTTTGGGAGGACAAGATGGGTAGATCACCTGACATCATGAATTAGAGA"
"GL873569","7519122","7519191","chrX","79016364","79016431","16","71497242","TTGGCCAGGCATGGTCGCTCAGGCTGTAATACCAGCTACTTGGGAAGCTGAAGCAGGAGGATCACTTGAA","TTGGCCAGGCACGGTGGCTCATGCTTATAATCCCAGCTACTCGTGAGGCTGAGGCAGGGGAATCGCTT"
"GL873569","7989158","7989286","chr8","41505677","41505810","35","33516519","AGTCCCACCTATTTGGAAGGCTGAGGCAAGAGGATCACTTGAACTCAGCAGTTTGACATTGCTATGAGTTAGATTGACTCCATGGCACTCTAGCCCAGGCAACAGAGCAAGACTCCGTCTCAAAACAAA","TAATACCAGCTACGTGGGAGGCTGAGGCAGGAGAATCACTTGAACCCGGGAGGTGGAGGTTGCAGTGAGCTGAGATTGCACCGTTGCACTCTAACCTGGGCAACAAAAGCAAAACTCTGTCTCAAAAAAAAAAA"
"GL873569","7989575","7989702","chr1","62231025","62231129","47","54241450","GGCTGGGTAATGCAGTGGCTCACGCCTATAATCCTAGTGCTTTGAGAGGCCAAGAGTGAGACTCTGTGTACTAAAAATAGAAAAATTACCTAGGCATTCTGGTGGGCACCAGTAGTCCCACCTATTTG","GGCTGGGCATGGTGGCTCACGCCTATAATCCCAGCACTTTGGGAGGCCGAGGCAGGTGGATCACCTGAGATCAGGAGTTTGAGACCAGACTGGCCAACATGGTGA"
"GL873569","10034363","10034556","chr10","61268396","61268605","62","51234033","CAGCTTGAGCAAAAGTGAGCCCCTGTCTCTACTGAAAATAGAAAAAATTAGCCAGGCGTGGTGGCACACACTTATAGTCCCAGCCACTTAGGAGGCTGAGGCAGGAGTTTGAGGTTGACATAATCTAAGCTGATACCATAGCACTCTAGCCTGGGCAATAGAGTGAGACTCTGTCTCAAAGAAGAAATTTATCT","CCTGACCAATGGTGAAACCCTGTCTCTACCAAAAATACAAAATTTAGCTGGGCATGGGGGCACGCACCTGTAGTCCTAGCTACTCGGGAGGCTGAGACAGGAGAACTGCTTGAACTCGGGAGGCAGAGGTTGCAGTGAGCTGAGATCATGCCACTGCACTCTAGCCTGGGCAATAGAGTGAGACTCCGTCTCAAAAAAAAAAAAAAAAAA"
"GL873569","10034830","10034845","chr1","217667782","217667796","2","207632952","AAAAAAGAAGAAAAAA","AAGAAAAAGAAAAAA"
"GL873569","10203815","10203922","chr8","96374555","96374671","35","86170740","GCCAGGTGTAGTGGTTCACACCTATAATCCTAGCACTCTGGGAGCCTGAAGCAGGTAAATGGACTGAGCAAGAGTGAGACTTCCACCTCTATTGAAAATAGAAAAATT","GGCTAGGTATGGTGGCTGATGCCTATAATCCCAGAATTTTGGGAGGCCGAGGCAGGCAGATCATCTGAGGTCAGGAGTTTGAGACCAGTCCCGTCTCTACTAAAAATACAAAAATTA"
"GL873569","10204196","10204373","chr20","1304385","1304559","47","8899811","GAAAATAGAAAAATTAGCCAGGCATTATAGCAGGCACCAGTAATCCCAGTTACTTGGGAGGCTAAGGCAAAAGAATCTCTTGAGCCCAAGTTTGGGGTTGCTAGGAAGTAAAACACCACAGCACTATACCCAGAACAAGAGAGTGAAGACTCAGTCTCAAAAAGATAAATAAATAAAA","AAAAATACAAAAATTAGCCAGGCATGGTGGCGGGCGTCTGTAACTCCAGCTACTTGGGAGACTGAGGCAGGAGAATCGCTTGAACCCAGGAGGCAGAGGTTACAGGTGAAATCACACCACTGCACTCCAGCCTGGGCAACAGGGCAAGACTCTGTCTCAAAAAAAAAAAAAAAAA"
"GL873569","10473375","10473444","chr8","20660648","20660717","21","10187273","TGTAGTCCCAGCACTTTGGGAGGTTAAGGCAAGAGTAGCACCCAACATGAGGAGATCAAGACCAATCTGG","CTGTAGTCCCAGCACTTTGGGAGGCTGAGGCAGGTGGATCCTTTGAGGGCAGAACTTTAAGACCAGCCTG"
"GL873570","9287350","9287485","chr1","29437872","29437991","30","20150522","GGCCGGGCGTGGTGGCGCACGCCTGTAGTCCCAGCGCTATGGGAGGCCGAGGCGGGTGGATCACCTGTGCTCAGAGGTTCGAGACCAGCCAAGACCCCCCTGAGCCAAACGAGCCAGAGTGAGACCCCGTCTCTAC","GGCCGGGCGTGGTGGCTCACGCCTGTAATCCCAACATTTTGGGAGGCCAAGGCGGGTGGATCACCTGAGGTCAGAAGTTCGAGACCAACCTGGCCAACATGGTGAAACCCCTGTCTCTAC"
"GL873571","3669989","3670207","chr4","116777080","116777297","60","113107091","AGACCAGCCTGAGGAAGAGCAAGATCCCATCTCTATTAAAAATAGAAAAATTAGCCAGGCATTCTGGTGGGCACCTGTAGTTCTAACCACCTGGGAGGCTAAGGCAAGAGGAACTCTTCAACCCAAGAGTTTGAGGTTGCTGAGAGCTAGGCTAAGGCTGCAGCACTCTAGCCTGGGCAACAGAGTGAGACTGTTTCTCAAAAACAAAAAACAAAAAAA","CGAGACCAGCCTGGTCAATATGGTGAAACCCCGTCCCTACTAAAAATACAAAAATTAGCCAGGCATGGTGGCAGGCACCTGTAGTCCCAGCTACTCGGAAGGCTGAGGCAGGAGAATCGCTTGAACCACAGAGGCAGAGGTTGCAGTGAGCCGAGACTGCACCACTGCACTCCAGCCTGGGCGACAGAGTGAGACTCAGTCTCAAAAAAAAAAAAAAA"
"GL873571","106134","106236","chr4","18143723","18143826","27","18037589","GGCCAGTCTCAGTGGCTCACACCTGTAATCCAGCATTCTGGGAGGCTGAAGCACACGGTCACCTGAGCTCAAAGGTTGGAGACCAGAGTGAGACCCCACCTCT","GGCCAGGCGCAGTGGCTCACTCCTGTAATCCCAGCACTTTGAGGCTGAGGCAGGCGGATCACCTGAGGTCAGGAGTTTGAGACCAGCCTGGCCGAAACCCCATC"
"GL873571","3670496","3670589","chr7","50468399","50468491","15","46797903","GGGCAGGCATGGTGGCTCACACCTGTAATTCTAGCACTCTTGGAGGCTGAGGCAGGAAAATGGCTTGAGGTCAGGAGTTCAAGACCAGCCTGAG","GGCCAGTCATGGTTGCTCACACCTGTAATACCAGCACTTTGGGAGGCCGAGGCAGGCGAATCACCTGAAGTCAGGAGTTCAAGACCAGCCTGG"
"GL873571","4059090","4059389","chr7","52903696","52903994","88","48844606","GGCCAGGTGCAGTGGTTCACACTTATAATCCTAGCACTCTGGGAGGCCGAGGCGAGTGAAGTGCCTGAGCTCATGGGTTCAAGACCAACCTAAGCCAGAGACCCCTGACTCTTATAATAGCCTGGCATTGTGGTGGGCGCCAATATTTCCAGCTACTCTGAGGCTAAGGCAAGAGAATTGCTTGAGCCCAGGAGTTGGAGGTTTCTGTGAGCACTGACGCCGCAGCTCTCTACCAAGGGCAACAAAGACTCTGTCTCAAAAAATAAATAAATAAATAAATAACAGAATGAAAATGAAAAA","GGCCGGGTGCGGTGGTTCACGCCTGTAATCCCACCACTTTGGGAGGCTGAGGCAGGCAGGTCACCTGAGGTCAGGAGTTCCAGACCAGCCTGGCCAACATGGTGAAACCTTGTCTCGGCTATTAGCCTGGCATGGTGGTGCGTGCCCATAATCCCAGCTACTCAGGAGGCTGAGGCAGGAGAATCGCTTGAACCCAGAAGGTGGAGGTTGCAGTGAGCCAAGATAGCACCACTGCAACTCCAGTCTGGGCAACAGAATGAGACTCTGTCTCAAAAAAAAAAAACAAAAAACAAAAAGAA"
"GL873571","4209418","4209704","chr11","32517699","32517985","80","28308281","GGCTTGGCAAGGTGGCTTACACCTCAAATCCTAGCACTGTGGGAGACTGAGGCAGGTGGATTGTTTGAGCTCAGGAGGTCAAGATAGAGAGCAAGAGCAAGTCTCTGTCTCTACTAAAAATAGAAAAGAACTACTTCCCGGGGGTCATGGCAGTAGCCTGTAATCCCAGTTACTAGGTAGAATGAGGCAAGAGGATCTGTTGAAGCCAAGAGACTGAGGTTGTTATGAGCATGCCACAGCACTCTACCCAGGGTGACAGAATGAGACTCTGTTGAAAGAAAAAAAGA","GGCCGGGTGCAGTGGCTCACACCTGTAATCCCAGCACTTTGGGAGGCTGAGGCGGGTGGATCACCTGAGGTCAGGAGTTCAAGACCAGCCTGACAAACATAGTGAAACCCTGTCTCTACTGAAAATACAAAATTAGCCAGGTGTGGTGGCGCATGCCTGTAATCCCAGCTACTCGGGAGGCTGAGGCAGGAGAATTGCTTGAATCCAGGAGGTGGAGGTTGTGTGATCACACCACTGCACTCCAGCCTGGGCGACAGAGTGAGACTCTGTCTCAAAAAAAAAAGAAA"
"GL873571","4209985","4210154","chr3","175781758","175781928","60","171571773","GAAAGAAATGAAAAGAAAGAAGTTAGCTGGTTGTTGGGGTATGCTTCTATAGTCCCACCTACTCAGAAAGCTGAAATCTGGAGTTTGGGGTTGTTGTAAGGTAGGCTGATGACATAGCACTGTAGCTTGGGCAAGAGAGTGTGACTTTGTCTCAAAAAAAATTAAAACAA","ATTAAAAACACAAAGATTAGCCAGGTGTGATGGCACACAACTGTAATCCCAACTACTCAGGAGAATCGCTTGAACCTGGGAGATAGGGTTTGCAGTGAGCCAAGATTGTGCCACTGCACTCCAGCCTGGGTGACAGAGTGAGACTCTGTCTCCAAAAAAAAAAAAAAAAAA"
"GL873571","4210444","4210570","chr17","16655655","16655789","35","12445211","GCCAGGCAGATGGCTCACACTTCATCCTAGCCCTCTGGAAGGCTGAGGCAGGCTAATTTTTTGAGGTTAGGAGTTTGAGACCAGCCTGAGGAAGAGACCCATCTCTACTTTAAAAAATAAATGGAAA","GCCAGGCATGGTGGCTCACACCTGTAATCCTAGCACTTTGGGAGACTGAGGCGGGTGAATCACCTGAGGTCAGGAGTTTGAGACCAGCCTGACCAGTATGGTGAAACCCAGTCTCTACTAAAAATACAGAAATTA"
"GL873571","4391733","4391878","chr11","33723808","33723943","46","29332075","AACTTAGCTGGGAATGGTGGCTCAAGCCTGTAATCCTAGCACTCTGGGAGGCTCAGGTGGGAGGATCACTTGAGGTTGCTGTGAGCTTGGCTGATGCCAGGACACTCTAGTGTGGGCAAGAGAGTGAGACTCCGCCTCAACAACAA","GCCGGGTGCAGTGGCTCATACCTGTAATCCCAGCACTTTGGGAGGCTGAGGTAGGCGGATCACGAGGTCAGGAGCTGAGATGGCGCCACTGCACCCCAGCCTGGGTGACAGAGCAAGACTCTGTCTCAAAAAAAAA"
"GL873571","6307773","6307841","chr9","62429628","62429694","22","56121855","CTGGGTGTGGTGGCATTGCACCTGTAATCCTAGCTACTTGGAAATCTTAAGCCCAGGAGTTGAAGACTG","CCCAGCATGGTGGTGCATACCTATAATCTCAGCTACTTGGAGGCTTGAGCTCAGAAGTTTGAGACCG"
"GL873571","6496217","6496306","chr1","27257765","27257856","27","20761548","GCAGGGTGTGTTGACCCACACCCACAATTCCAGGACTCTGGGGGGCCAGGGATGGTGGGTTCCCTCAGATCAGGAGCTCCTTACCAGCCT","GACTGGGCATGATGGCTCAAATCTGTAATTCCAGCACTTTGGGAGGCCGAGGTGGGTGGATTGCCTGAGATCAGGAGTTCAAGACCAGCCTG"
"GL873571","6499738","6499903","chr1","38976375","38976555","47","32476637","AAAATAACATGAATTGACTAGGCGAGGTGGCTCACATCTCTAATCCTAGCACTCTGGGAGGCTGAGGCAGGAGAATTGCATGAGGTTGCTGTGAGCTATGATGATACCACGGCATTCTAATCAGGGTGACAGAGTGAGATTCTGTCTTAAAACAAACAAACAAAAA","AAAATAAATAAATTAGCAGGGCCTGGTGGCGCACACCTGTAATCCCAGCTACTTGGGAAGCTGAGGCAGGAGAACCCACTTGAACCTGGGAGCCGGAGGTTGCAGTGAGCTGAGATGGCACCACTGCACTCCAGACTGCGTGACAGAGTGAGACTCCGTCTCAAAAACAAACAAACAAAAA"
"GL873571","11399575","11399872","chr15","109458692","109458994","79","98059117","CAGTGGCTCACACCTGTAAATCTAACACTCTGGGAGGCCAAGGTGGGTGGATCCCTTGAGCTCAGGAATTTGATACCAGCCTGAGCAAGAGTGAGACCTTGTCTCTACTAATAATAGAAAAATAGCCCGTGTTGTGGCACTTGTCCCAACCACTGGGGAGGCTTTAGGCGGGAGGATTACTTGAATTGGGAGTTTGATATTGCTGTGAGCTGGGCTGATGCCTTGGCATTCTAGCTTGGGTAACAGCGTAAGACTCCGTCTCAAATAAATAAATAAATAAATAAAAAGAAAAAAAGAA","GTGGCTCACACCTGTAATCTCAGCACTTTGGGAGACCGAGGCAGGTGGATCACCTGAGGTCGGGAGTTTGAGACCAGCCTGACCAACGTGGAGAAACCCCGTCTCTACTAACAATACAAAATCAGCTGGGCGTGGTGGTGCATGCTTGTAATCCCAGCTACTCGGGAGGCTGAGGTAGGAGAATCGCTTGAACCTGGGAGGTGGAGGTTGCGGTGAGCCGAGATCGAGCCACTGCACTCCAGCCTGGGTGACAGAGCAAGACTCCATCTCAAAAAAAAAAAAAAAAAAAAAAAAAAAAAAAAA"
"GL873572","114760","114841","chr8","26280134","26280211","16","26165374","GGCCAGGCATGGCGGCTCTTCCCTGTAATCCTAGCACTCTGGGAGGGCGAGGCAGGCAGATCACCTAGGCTAGGGTGAGATC","GGCCAGGAATGGTGGCTCATGCCTGTAATCCCAGCACTTTGGGAGGCTGAGGCAGGCAGATCACCTGAGGTCAGGAGT"
"GL873572","9421791","9421892","chr11","8089184","8089269","35","1332607","TACTAAATATATAGCAAGGCCAGGCACAGTGGTTCATGGCTGTAATCCCAGTACTCTGGGAGGCCTAGTCAGAGTTGACCTGAGATCAGGCTAGAAGCCTGG","ATAAAAATAATTGGAGGCCAGGCACGGTGGCTCATGCTTGTAATTCTAGCAATTTGGGAGGCTGACGCGGGTGAGATCATACTGAG"
"GL873572","11052834","11053035","chr14","11857478","11857657","65","804644","TCCACAAAGAAAGCAGAAGTGTGGCCGGGTGGTAGCTCAAGGCAGGAATCCCAGCACTCTGGGAGCTGGGAGGTGGGGGAGGATCCCTTGAGATCAGGAGTTGGAGGGCACAGTGAGCCTGGGGGAGGCCACTGTCTCTGTACTCTAGCAGGGAGACAGAGCAAGACTGCCCATTCAAAGAAAAACAACAAACAAAACAAAA","TACAAAAATTAGCTGGGCACGGTGCCACAAGCCTGTAATCCCAGCTACTCGGGAGGCTGGGCAGGGGAATAGCTTGAACCCAGAGGTGGAGGTTGCAGTGAGCCAAGATCAAGCCACAGCACTCCAGCCTGGGTGACAGAGCAAGACTCCATCTCAAAAAAAAAAAAAAAAAAAAAAAAA"
"GL873573","2564195","2564244","chr1","109985445","109985491","12","107421250","TACAAAAATTAGGCTGGGCTTGGTGGTTCACGCCTATAATCCTAGCACTT","ACTAAAATTAGCTGGGCATGGTGGTGCATGCCTGTAATTCCAGCTAC"
"GL873573","7423371","7423533","chr2","202783328","202783513","56","195359957","GGTGGCTCACACCTGTAATCCCAGCACTCTGGGAGCCCTGGTGGCTCATGTCTATAATCCTAGTACTCTGGGAGACCATGGTGGCTCATGTCTATAATCCTAGTACTCTGGGAGCCATGGTGGCTCACGCCTATAATCCTAGTACTCTGGGAGACCATGGTGG","GGCTGAGGCGCGGGGGCTCACGCCTGTAATCCCAGCACTGTGGGAGGCCGAGGCGGGTGGATCACGCCTGTAATCCCAGCACTGTGGGAGGCCAAGGCGGGTGGATCACGCCTGTAATCCCAGCACTGTGGGAGGCCGAGGCGGGTGGATCACGCCTGTAATCCCAGCACTGTGGGAGGCTGAGGC"
"GL873573","9657648","9657710","chr19","10207852","10207913","10","550204","TAAAAATAAAAAATTTAGCTGGATGTGGTGGCTCACACCTGTAATCCTAGCACTCTGGGAGAC","TAAAAATACAAAATTAGCTGGGTGTGGTGGCACACACCTGTAATCCCAGCTACTCAAGAGGC"
"GL873574","1624662","1624783","chr9","814961","815079","36","809701","GACTGGGTGGGTTGGATCATGCCTGGAATCCTAGCACCCTGGGAGGCCAAGGTGAAAGGATTGCTTGAGGTTAGGAGTTCCAGAAATGTAGCAGTCATGGTGACTTCATCCTTCTCTACCAA","GGCTGGGTGCTTTGATTCATGCCTGTAATCCCAGCACTCTGGGAGGCCGAGGCAGGTGGATCACCTGAGGTTAGGAGTTCGAGACCAGCTTGGCTAACATGGTGAAACCTCGTCTCTAC"
"GL873574","4459477","4459612","chr1","29437872","29437991","29","24978395","GGCCGGGCGTGGTGGCGCACGCCTGTAGTCCCAGCGCTATGGGAGGCCGAGGCGGGTGGATCACCTGAGCTCAGAGGTTCGAGACCAGCCAAGACCCCCCTGAGCCAAACGAGCCAGAGTGAGACCCCGTCTCTAC","GGCCGGGCGTGGTGGCTCACGCCTGTAATCCCAACATTTTGGGAGGCCAAGGCGGGTGGATCACCTGAGGTCAGAAGTTCGAGACCAACCTGGCCAACATGGTGAAACCCCTGTCTCTAC"
"GL873574","4681987","4682216","chr6","153082888","153083127","73","148400901","GGGTGCGGTGGCTCAGACCTATAATCCCAGCACTCTGAGAGGCCGAAGTGGGTGGATCACCTGAGCTCAGGAATTTGAGACCAGCCGTCTCTAAAAATAGCTGAGTGTTGTGGCAGTGGCTGTAAGTCCCAGCTGTTTGGAAAGCTGAAGCAAGGGAATCACTTGAACCCAAGAGTTTGAGGTTGCTGTGATGACAAAGTGAGACTCTATCTCAAAAAAAAAAAAAAAAA","GGCCGTGCGCGGCGGCTCACGCCTGTAATCCCAGCACTTTGGGAGGCTGAGGTGGGTGGATCACCTGAGGTCAGGAGTTTGAGACCAGCCCGACCAGAAATTAGATGGGTGTGGTGGTGCGCTCCTGCAGCCCCAGCTACTTAAGAGGCTGAGGCAGGGTAATCACTTGAACCCGGGAGGCGGAGGTTGCAGTGAGCCGAGCTCACGCCACTGCACTCCAGCCTGGGTAACAGAGCGAGA"
"GL873574","4709916","4710039","chr19","13152422","13152536","46","8442506","AAAAATAGAAAAACTAGCCAAGCATGGTGGTGCACCCCCTATAGTCTGAGCTCCTCAGCGGGCTGAAGCAAAAGGACGGCTGGAGCCCTGGAGTTTGAGGTTGCTGTGAGGCAAGGTGATGCCA","ACACATAAATTAGCCAGACATGATGGTGAGTATCTGTAATTCCAGCTCCTTGGGGGGCTGAGGCGGGAGAATTGCTTGAACCTGGGAGGCAGAGATTGCAGTGAGCCAAGATCGC"
"GL873574","6353839","6353913","chr5","25768079","25768163","22","19414240","AAAAATATAGCAAGGCCAGGCATGGTGGCTCACACCTATAATCCCAGTACTTGGGAGCTGGAATTTGAACCTAGG","AAAAAACTCAAACAAGGCTGGGCGTGGTGGCTCACACCTGTAATCCCAGCACTTTGGGAGGCTGAGGTGGGTGGATCACCTGAGG"
"GL873574","6533061","6533332","chr5","85182161","85182439","81","78649100","GGCTGGGCGAGGTGGCTTACACCTATAATCCTAGTACTCTGGGAGGCCAAGGTGGGTGGATTGCCTGAGCGCACAGTTTCAAGACCAGCTGGAGCCAGAGAGAGAGAGAGAGACCCTGCCTCTAAAAATAGCCAGGCATTGTGGCAGGCACCTGTAGTCCCAGCTACTTGGCAGGCGGAGGTATGAGAATCGCTAGAGGTTGCTGTTAGCTATGATGCCATAGCACTCTACCAAGGGCGACAAAGTGAAACTCTGCCTCAAAAAAAAGAAGA","GCCAGGCGTGGTGACTCAAGCCTGTAATCCTAGCACTTTGGGAGGCCAAGGTGGGCGGATTGCCTGAGCTCAAGAGTTTGAGACCAGCCTGGGCAACACGGTGAAACCCAATCCCTACTAAATACAAAAAAAATTAGCCGGGTGTGGTGGTGTGAACCTGTAGTCCCAGCTACTCGGGAGGCTGAGGCAGGAGAAGGCAGAAGTTGCAGTGAGCCGAGATCACACCACTGCACTCCAGCCTGAGTGACAGAGCAAAACTCTTTCTCAAAAAAAAAAAAA"
"GL873574","6643746","6643907","chr2","92627944","92628105","46","85984198","AAATAGCCAGGCGTTGTGGCAGGCACCTATAGTCCCAGCTACTTGGGAGGCTGAGGCAAGAGAATCACTTAAGCCCAAGTGACAGAGGTTGCCAGGGCACTCTACGTAGGCAACAGAGTGAGACTCTATCTAAGAAAGAAGGAAGGAAGGAAGGAGAAAGAA","TTAGCCGAGCATTGTGGTGCGCGCCTGTAGTCCCAGCTACATGGGAGGCTGAGGCAGGAGAACACCTGAACCCAGGATGTGAGCTGAGTCGCGCCATTGCACTCCAGCCTGGGCAACAGAGTGAGACTCCATCTCAAAAATAAAATAAAATAAAATAAAAAA"
"GL873574","6644163","6644274","chr1","128607504","128607619","20","121963341","CTGTAATCCTAGCACTTGGGAGGCTGAGGCAGGTGGATCACCTGAGTTCAGGAGTTCAAGACCAGCCTAAACAAGAGTGAGACCCTATCTCTACTAAAAATAGAAAAAATAT","GCCTGTAATCCAAGCACTTTGGGAGGCTGAGGCGGGTGGATCACCTGAGGTCAGGTGTTCGAGACCAGCCTGGCCAACGTGGTGAAACCCCAACTCTACTAAAAATACAAAAATTA"
"GL873574","8511822","8512127","chr1","23439759","23440073","84","14927937","GGTGGCTGGTGCCTGTAATCCTAGCACTCTGGGAGACTGAGGCAGGTGGATCACTTGAAATCAGGAGTTTGAGATCAACCTGAGCAAGAGATCTTGTCTCTCCTAAAGATAGAAAAACTAGCTGGGATTTGTGGTGGACACCTGTAATTTCAGCTACTCAGGAAGCTAAGGCAAGAGCATTGCTTAAAACCAGGAGTTTGAAGTTGATGTGAGCTAGGATGTCAGGGCAGGTTACCCAGGGTGACAGAGTGAGACTCTGTGTCAAAATAAACAAACAAACAAACAAACAAAACAAAATAAAATAAA","GGCTGGACATGGTGACTCACGCTTGTAATCCCAACACTTTGGGAGGCTGAAGCAGGCAGATCACCTGAGGTCAGGAGTTTGAGACCAGCCTGACCAACATGGTGAAACCTTGTCTCTACTAAAAATACAAAAATTAGCTGGGAGCAGTGGTGCACACCTGTAATCCCAGCTACTCGGCAAGCTGAGGCAAGATAATTTTTTAAACCTGGGAGGTGGAGGTTGCAGTGAGCCAAGATCGTGCCACTGTACTCCAACCTGGGAGACAGAGCAAGACTCTGTCTCAAAAAAAAAAAAAAAAAAAAAAAAAAAAAAAAA"
"GL873575","2107336","2107519","chr4","38052972","38053149","54","35945636","TCAATTAAAAACTTTTTAAAATGAGGCTGAGCATGGTGGTTCACACCTGTAATCCCAGCACTTTGGGAGGCCGAGGCAGGAGGATCACCTGATCCCAGGAGTCCAAGCCTACAGTGAGCCGTGATAATACCACTGCACTTCAGCCCAAAGCCTCAAAAAGAAAAAAAAAAAAGGATAGACAAGA","TATATATATATATATTATTTTGGGGGGGCATGGTGGTGCACACCTGTAATCCCAGCTACTCGGGAGGCTGAGGCAGGAGAATTGCTTGAGCCCGGGAGGCAAAGGTTGCATTGAGCTGAGATCACACCACTGCACTCCAGCCTGGCGACAGAGTCTCAAAAAAAAGAAAAAATAAAAA"
"GL873575","5831824","5831959","chr1","29437872","29437991","28","23606048","GGCCGGGCGTGGTGGCGCACGCCTGTAGTCCCAGCGCTATGGGAGGCCAAGGCGGGTGGATCACCTGAGCTCAGAGGTTCGAGACCAGCCAAGACCCCCCTGAGCCAAACGAGCCAGAGTGAGACCCCGTCTCTAC","GGCCGGGCGTGGTGGCTCACGCCTGTAATCCCAACATTTTGGGAGGCCAAGGCGGGTGGATCACCTGAGGTCAGAAGTTCGAGACCAACCTGGCCAACATGGTGAAACCCCTGTCTCTAC"
"GL873575","7451097","7451208","chr3","122814630","122814743","22","115363533","GGCCAGGTGTGGTGGCTCACACCTGTTATCCTAGCACTCTGAGAGGCCACAGCAGCTGGATCACTTGAGCTCAGGAGTTCAAGACCAGTCTGAGCAAGAGCAAGACCTCACC","GGCTGGGTGTGGTGGCTCATGCCTGTAATCCCAGCACTTTGAAAGGCCAAGGCAGATGGATCACTTGAGGTCAGGAGTTCCAGACCAGCCTGGCCAACATGGCAAAACCCCATC"
"GL873575","7451277","7451445","chr6","58863249","58863409","41","51411972","AAAAATTCAGCCAGCCACAGTGGAAGTGGATGCCTGCCATCACAGCTACTCTGGGGGCTGGGGCAAGAGAATTGCTTGATCCCAGGAGTCTGAGGTTGCTGTGACCTAGGCTGACACCACAGCACTCTACCCAGGGTGACAGAGTGAGGCTGTGTTTAAAAAAAAAAAA","TTAGCCAGGCATGGTGGCACATGCCAGTAATCCCAGCTACTCAGGAGGATGAGGCAGGAGAATCGCTTGAACCCAGGAGGCAGAGGTTGCAGTGAGCTGAGATTGCGCCACAGCACTCTACCCTGGGTGACAGAAGGAGACTCTGTCTCAAAAAAAAAAAA"
"GL873576","1765109","1765185","chrX","53921180","53921256","12","52156071","GGCCAGGTGCAGTGGCTCATATCTGTAATCCTAGCACCCTGGGAGGCCAAGGTAGGCGAATCACCTGAGGCCAGGAG","GGCCAGGTGCAGTGGCTCACGCCTGTAATCCCAGCACTTTGGGAGGCCGAGGTGGGCGGATCACTTTAGGTCAGGAG"
"GL873576","2711577","2711895","chr7","6620384","6620702","85","3908807","GGTCGAGCTTGGTGGCTCATGCTTGTAATCCTAGCACTCTGGGAGGCCAAGGCAGGTAAGTTGCCCTGAGCTCATAGGTTCCAGATCAGCATGAGCCAGAGTGAGACCCTGTCTCTACCAAAAAATAGCCCGGCATTCTGGCAGGTGCCTGTAATCCCAGCTGCTTGGGAGGCTGAGGCTAGAGAATCACTTAAACCCAAGGGTTAGTGGAGGTTGCTGTGAGCTATGATTCCACCGTACTCTACTGAGGGCCACAAAGTGAGACTCTGTCTCCATAAAAAAGAAAGAAAGAAAGAAAGAAAAATAAAATAAAATAAAA","GGCCAGGCACAGTGGCTCATGTCTGTAATCCCAGCACTTTGGGAGGCCGAGGCGGGTGGATTACCTGAGGTCAGGAGTTCTAGACCAGCCTGGCCAACAAGGCGAAACCCTGTCTCTACTAAAAATACAAAAAATTAGCTGGGCGTTTTGGCACATGCCTGTAATCCCAGCTACTTGGGAGGCTGAGGCAGGAGAATTGCTTGAACTGGGGAAGTGGAGGTTGCAGTGAGCTGAGATCACACCATTGCACGCCTGAGCAACAGAGCGAGACTCTGTCTCAAAAAAAAAAAAAAAAAAAAAAAAGAAAAGAAAAAGAAAA"
"GL873576","4782520","4782652","chr9","61136941","61137074","22","56354421","CCAGGCACGGTGGCTCACCCTTGTAACCCTAGTACTTTGGGAGGCTGAGGTGGGAGGATCCCTTGAGGTCAGGAGTTCAAGACCAGCCTGAACAACAGTGAGACCCCCGTCTCTACTAAAAAATAGAAAAGTT","GCCAGGCACGGTGGCTCACGCCTGTAATCCCAGCACTTTGGGAGGCTGAAGCGGGCGGATCACCTGAGGTCAGGAGTTCAAGACCAGCCTGGGCACCATGATGAAACCCCGTCTCTATTAAAAATACAAAAATT"
"GL873576","4782930","4783078","chr7","57521645","57521803","40","52738715","AGTTAGTCTGGTGTCATGGTGGGTGCCTGTAGTCCCAGCTGCTTGGGAGGCTGAGGCAAGAGAATCACTTGAGCCCAGGAGTTGGAGGTTGCTATGAGCGAGGCTGTAGCCTAGGCAACAGAATGAGACTTTGCCTCAAAAAAATAAAA","TTAGCTGGGCATGGTGGCGCATGCCTGTAGTCCCAGCTACTTGGGAAGCTGAGGCAGGAGAATCACTTGAACCTGGGAGGTGGAGGTTGCAGTGAGCTGAGATCGCACCGCTACACGCCAGCCTGAGCAACAGAGAGAGACTCTGTCTCAAAAGAAAAA"
"GL873576","7828709","7828723","chr5","101042981","101042996","1","93214272","TAAATAAATAAAAAA","TAAATAAATAAATAAA"
"GL873576","7828960","7829230","chr13","49045537","49045844","89","41216577","GCCGGCTGCAGTGGCTATAATCCAAGTACCCTGGGAGGCTTAGGTGGATGGATCACTTGAGCTCAGAAGTTCAAGACCAGCCTCAGCAAGAGGTAGACCTTGCCTCTATTAAANNNNNNNNNNNNNNNNNNNNNNNNNNNNNNNNNNNNNNNNNNNNNNNNNNNNNNNNNNNNNNNNNNNNNNNNNNNNAGTTTGAGGTTGCTGTGAGCTATGATGAAGCCAGGGCATTCTACCCAGGGTGACAGAGTAACTCTTAAAAAAAACTAAACAA","GGCCAGGCAGAGTGGCTCATGCCTGTAATTCCAGCAATTTGGGAGGCCTAGGCAGGCAGATTACCTGAGGTCAGGAGTTTGAGACCAGCCTGGCCAACATGGTGAAACCCCGTCTCTTCTANNNNNNNNNNNNNNNNNNNNNNNNNNNNNNNNNNNNNNNNNNNNNNNNNNNNNNNNNNNNNNNNNNNNNNNNNNNNNNGGAGATAATAGCTTTTGTAGAACGAAGCGATGCAACAGCCAGATCGCCGCCACCACCCTTAGGTCCTGGCGACAGAGTGAGATCCATCTTAAAAAAAAAAAAAAAAAAA"
"GL873576","10622840","10623093","chr7","60266447","60266705","74","49643607","GCTGGGTATGGTGGTTCACACCTATAATCCTAGCACTCTGGGAGGCTGAGGTGGGAGGATTGGTGGAGCTCAGGAGCTCATGAGGTGCCAAATCACTGGTGCCACACACCTGTATTCCCAGCTACTGAGGAGGCTGAGGCAGGAGGATCAGGTAAGCCCAGGAAGTTTGAGGTTGTAGTGAGTTAGGATGATTGAACTCTGCCTTGAGAGACAGAGCAAGATCCTCCTTCCTCCTAAGCAAACAAACAAATAAA","GGCTGGGTGCAGTGGCTCACACCTGTAATCCTAGCACTTTGGGAGGCTGAGGCGGGAAAATTGCCTGAGCTCAGGAGTTCAAGGACAGCCTAGGCAACATAGCATGGTGGTGCACGCCTGTATTCCCTGCTACTTGGGAGGCTGAGGCACAAGAATTGCTTGAATCCGGGAAGTGGAGGTTGCAGTGAGCCATTGTGGCACTGCTCTCCAGTCTGGGTGACAGAGCAAGACTCCATCTCAAAAAAAAAAAAAAAAAAAA"
"GL873576","10819939","10820007","chrX","67133632","67133707","21","56313693","AGGTTGCAGTGAAATTGTACCATTCCAATGAAGCCTGGGGGACAGAGTGAGATTCTCTCAAAATAAAAA","GGAGGTTGCAGTGAACCGAGATCGTGCCACTGCACTCCAGCCTGAGCGACAGAGTGAAACTTCGTCTCAAAAAAAA"
"GL873576","10920306","10920363","chr3","48261745","48261808","16","37341439","GCTGGACCTTGTAGAGAGTGCCTGTAATCCCAGCTACATGGGGGGCAAGAGAATTGCT","GCTGGGCATGGTGGTGCATGCCTGTGATCCCAGCTACTCAGGAGGCTGAGGCAGGAGAATTGCT"
"GL873576","10920398","10920529","chr10","67341428","67341546","30","56421030","GGCCAGGCGTGGTGGCTCACGCCTGTTGTCCCAGCACTGTGGGAGGCCGAGGTGGGTGGATTGCCTGAGCTCAGAGGAGTCCGGAAGACCAGCATGAGGCAGAGTGAGCCAGAGTAAGATCCTGTCTCTACC","GGCTGGGTGTAGTGGCTCATGCCTGTAATCCCAGCACTTTAGGAGGCCAAGGTGGATGGATTGCCTGAGCTCAGGAGTTCGAGACCACCCTGGGCAACAAGCCAAAACCCTGTCTCTAC"
"GL873577","515809","515961","chr7","137660778","137660931","43","137144969","AGCTGGGCATGGTGGCTCATGCCTATAACCCTAGCGTGCTAGGAGATTGCTTGTCAGGAGACTGAGGTTGCAGGAAACTGTGATGATGGCACTGCACTCTACCCAGGGTGACAGAGCAGGACTCTGCCTCAAAAAAAAAAAAAAAAATAGAAA","TTAGCTGGGCATGGTGGCGCATGCCTATAATCCCAGCTACTTGGGAGGCTGAGGCAAGAGAATCGCTTGAACCGGGGAGGCAGAGGTTGCAGACTGCACTCCAGCCTGTGTGACAGAGTGGGACTCCGTCTCAAAAAAAAAAAAAAAAAAAAAA"
"GL873577","1633164","1633256","chrX","38269524","38269615","26","36636360","TCAGCCAGGCATGGTGGCACTTGCCTATAAACCCAGCTCCTTGGGAAGCTGAGCCGGGAGGATCCCTTGCACCCAGGAGCAACGGAAGGCAGT","AATTAGCCAGGCATGGTGGCACATGCCTATAATCCCAGCTACTCAGAAGGTTGAGGCAGGAGAATCACTTGAACCTGGGAGGCAGAGGTTGC"
"GL873577","3979502","3979560","chr20","68909283","68909346","13","64929781","GAGTTTGAGACCAGCCTGAGCAAGACCGAGACCCAGTCTCTACTAAAAATAGAAAAATT","GGAGTTCAAGACCAGCCTGACCAACATGGAGAAACCCTGTCTCTACTAAAAAATACAAAAATTA"
"GL873577","3979839","3980009","chr10","31403126","31403287","39","27423287","ATGAGCAGATTGTCTTGGTGGGCACCTGTAGTCCCAGCTATTGGAGGTGGGAGGCTGAAGCAGGAAAATCTCTTGAGCCCAGGAGTTTGAGGTTGCTGTGAGCTAGGCTGACACCACGGCACTCTAGTCAGGGCGTCAGAGTGAGACTCCGTCTCAAAAAAAAAAAAAAAA","TTAGCTGAGTGTGGTGGCGCACATCTGTACTCCCAGCTATTTGGGAGGCTGAGGCAGGAAAATCGCTTGAACCCAGGAGGTGGAGGTTGCAGTGAGCCAAGATCACACTACTGCACTCCAGCCTGGGTGACAGAGTGAGAATCCATCTCAAAAAAAAGAAAA"
"GL873577","6050882","6051080","chr1","153219820","153220007","59","147168938","GGCTGGGCGTTGTGACTCATGCCTGTAATCCCAGCACTCTAGGAGGCCGAGGTGGGTGGACTGCCTGAACTCAGAGGTTTAAGACCATCCTGAGCCGCAGTGAGCCAGAGCGAGACCCTGTCTCTACCAAAAAAAGCTGGGTGTTGTGGTGGGCGCCTATAGTCCTAGCTACTTGAGGCGCTAAGGGTAAAAAAATTGC","GGCCTGGCACAATGGCTCACGCCTGTAATCCTAGCACTTTGGGAGGCCGGGGTGGGTGGATCACCTGAGATCAGGAGTTTGAGACCAGCCTGGCCAACATGGTGAAACTCCTTCTCTACAAAAATTAGCCAGGTGTGGTGGTGGGTACCTGCAATCCCAGCTATTTGGGAGGCTGAGGCAGGAGAATC"
"GL873577","8463965","8464050","chr9","52134422","52134508","19","43670457","CTGGGTGCTATAGCTCACGCCTATAATCCTAGCACTCTGGGAGTTTGGGGCAAATGGATCACCTAGGCTCAGGAGTTTGATACCAG","GGCTGGGAGCAGTGACTCACGCCTATAATCCCAGCACTTTGGGAGGCTGAGGCAGATGGATCACCTGAAGTCAGGAGTTCGAGACCA"
"GL873577","9471486","9471613","chr16","5178790","5178910","46","4292696","TTAGCCAGGCATAGTAGCCTGTGTGTAGTCCTAGCTACTCAGGAGGCTGAGGTAGATGGGTCACTTGAGGTTGCAGAGATTATGGTAATGTCACTGTACTCTAGCCCTGGCAACAGAGCACAACCCTG","TTAGCCGAGCCTGGTGGCATAAACCTGTAATCCCAGCTACTCAGGAGGCTGAGGCAGGGGAATTGCTTGAACCTGAGAGGAGAAGGTTGCAGTGAGCCGAGATTGCACCATTGCACCCCAG"
"GL873577","9471875","9471998","chr7","17832200","17832315","36","8360325","GGCCAGGTGAAGCAGCTCATGGCTATAATCCTAGCAGTTTGGCAGGCCAAGGTGGGAGGACTGCTTGAGGTCAAGAGTTCAAGACCAACCCATCTTTGCGAAAAATTTAAAAATTACCTAGGCA","GCCAGGAGAGGTGGCTCATGCCTCTAATCCCAGCACTCTGGAAATCCAAGGTGGGTGGATCACCTGAGGTCAGGAATTCCAGACCAGTCTGGCCAATATAAAAAATTAGCCAGGCT"
"GL873577","9853150","9853170","chr3","85044647","85044667","3","75191497","AAACAAACAAACAAAAAAAGA","CAAACAAACAAACAAACAAAA"
"GL873577","9853206","9853473","chr7","130818682","130818963","67","120965476","GCTGGGCGCAGCGTCTCACTCCTGTAATCCCAGCACTTGGGAGGCCAAGGTGAGTGGATTGCCTGAGTTTACAGTTTCGAGACCAGCCTGAGCCAAAGCGAGACCCCCATCTCTAAAAAATAGCTGGGCATTGTGGTGGGCACCTGTAGTCCCAGCTACTTGGGAGGCTGAGGCAAGAGGATCGCTTGAACCTAAGAGTTTGAGGTTGCTGTGAGCTAAGGCTCCATGGCATTCTACCAAGGGTGACTAAGTGAGACTCTGTCTAAAA","GCCGGGCACAGTGGCTCACACCTGTAATCCCAGTACTTTGGGAGGCCAAGGTGGGTGGATCACCTGAGGTCAGGAGTTTGAGACCAGCCTGGCCAACATAGTGAAACTCTACTAAAAATACAAAAAAATAGCTAGGCATGGTGGTGCGCACCTGTAATCCCAGCTACTTGGGAGGCTGAGGCAGGAGAGTTGCTTGAACCCAGCGGGGTTGAGGTTGCAGTGAGTTAAGATCAAGCCACTGTGCTCCAGCCTGGATGACAGAGAGAGACTCCATCTCAAAAA"
"GL873577","10722415","10722478","chr10","12501471","12501539","23","1779056","AATAAAAAAATGCTGGGTACAGTAGTACATGCCTGTACTCTCATCTGGGGAAGCTGAGGCATGA","AAAGTAAAAAATTAGAGCTGGGCATGGTGGCACACACCTGTAATCCCAGTCACTAGGGATGCTGAGGCA"
"GL873578","463331","463568","chr10","28935382","28935620","93","28472051","CAGGTGCTTTGACCCACACCCTCAACTCTAGGACTTTGGACGCCCTGGCTGGGTGGGTCCTTTAAAGTCAGGAGCTTCTTATCAGTCTGGGCAAAAGTGAGACCCCATCTCTACCAAACAAAGAAAGAAATCAGCAGTATGTTGCAGTAGAGACTCACCAATACCTTCTTTCAAAGACCAAAGCTGGAAGGACACTAAAGACCATGATCTCATGGCCTCCCTGAGCCATGACAATGCC","CCAGGTGCAGTGGCTCATGCCTGCAAGCTCAGAACTTTGGGAGGCAGAGGTGAGCAGACTGCCTGAGTTCAGGAGTTCAAGACCAGCTGGGCAACATGGTGAGACCCTATCTCTACTAAAAATACAAATAATTAGCAGGGTGTGGTAGCACACACCTGTAGTCCAGCTACTCAGGAGGCTGAGGCAGGAGAATTGCTTGAACCCAGGAGGCAGAGTTTGCAGTGAGCCAGGACTGGGCC"
"GL873578","1143712","1143827","chr11","52824583","52824692","30","51680871","GGCTGGGTGTGGTGCCTCATGCCTGTAATCTAAGCCCTCTCCGAGGCTGAGGTGGGAGGATCCCTTGAGTTTAGGAGTTTGATTTTGAGACCAGCCTGATCAAGAGAGAGACCTCA","GGCCGGGTGTGGTGGCTCATGTCTGTAATCCCAGCACTTTGGGAGGCTGAGGTGGGTGGATACCCTGAGGTCGGGAGCTCGAGACCAGCCTGACCAACATGGAGAAACCC"
"GL873578","1144101","1144139","chr3","33494224","33494257","11","32350123","GAGAGAGACCTCATGTCTACTAAAATAAATAAATATATA","GTGAAACCCGTCTCTACTAAAAATACAAAAATTA"
"GL873578","1144175","1144343","chr12","119519961","119520131","41","118375786","ATTATCCAGGCCTTCTGGTGGATGCCTGTAGTCCTAGCTACTAGAAAAGCTGGAGCAGAATCACTTGACCCAGGAGCTGGAGGTTGCAGGGAGCTAGGCTGATGCCACAGAATTCTAGCCTGAGGCAAAAGAATTGAGCCACTGTCTCAAAAAGGAACAAAAAAGAAAA","ATTAGCCAGGTGTGGTGGCATGCACTTGTAATCCCAGCTACTAAGAAGGCTGAGGCAGGAGGATCACTTGAACCCGGGAGGTGGAGGTTGCAGTGAGCCAAGATCATGCCACTGCACTCCAGCCTGGGCAACAGAGTAAGACTCTGTCTCAAAAAAAAAAAAAAAAAAAAA"
"GL873578","4593962","4594035","chr16","68825055","68825124","22","64231093","AGCTGGGTACAGTGGCTCACATATAATCCCAGTGACTCAGGAGGCTAAGACAGGAGGATTACTAGGACCTGAGA","GGCTGGGCACAGTGGCTCAGACCTGTAATCTCAGTACTTTGGGTGGCTGAGGCAGGTGGATCACCTGAGG"
"GL873578","6158845","6158972","chr3","500432","500562","24","5658413","GACATGGTGGCTCACACCTGTAATCCTAGCCCTCTGGGAGGCTGAGGCAGGTGGATCACTTGAGTTCAGGAATTCAAGACCAGCTTGAGTGAGAGCAAGACCCTGTCTCTACTAAAAATAGAAAAATT","GCACGGAGGCTCATACCTGTAATCCCAGCACTTTGGGAGGCTGAGGCAGGTGGATCACCTGAGGTCAGGAGTTCCAGACCAGCCTGGCCAACATGGCGAAACCCTGTCTCTACTAAAAATACAAAAAATCT"
"GL873578","6159253","6159444","chr19","34496349","34496541","55","28337096","ATAAAATAAAAATAGAAAAATTAGCCAGGCATTGTGGCAGACATGCGAAGTCTCAGCTACTCCAGAGGCTGAGACAGGAAGATTACTTGAGCCCAAGAATCTTGCTGTGAGCTAAGCTGATGCCATAGCATTGTAACCTAGGCAACAGAGTAAGACTTGGCCTCAAAAATAAAATAAAATAATAAAGTAAAA","TTAGTTAATTAAATTAAACTTAGCTAGGCATAGTGGAACACACCCATAGTCCCAGCTACTCTAGAGGCTGAGGCAGGAGGATTGCTTGAGCCAAGTTGGAGGCTGCAGTGAGCTATGGTGGTGCCACTGCATTCCAGCCTCAGTGACAGAGAGAGACCCTGGCTCAAATAATAATAATAAATAAATAAATAAA"
"GL873578","6766040","6766171","chr2","93098086","93098217","30","86332046","CCAGGCACAGTGGCTCATGCCTATAATCCTAGTAGTCTAGGAGGCTGAGGTGAGTGCATTGCTTGAGCTCAGGAGTTAGATACCAGCCTAACCAAGAATGAGACCCCATCTCTATTAAAAATAGAAAAGTTA","GCCGGGCACAGTGGCTCATGCCTGTAATCCCAGCACTTTGGGAGGCCGAGGCGGGCAAATCACGAGGTCAGGAGTTCAAGACCAGCCTGACCAATATGATGAAACCCCGTCTCTATTAAAAATACAAAAATT"
"GL873578","6766434","6766577","chr9","21128084","21128223","50","14361650","GTTAGCCAGGAGTTGTGGCGGGCACCTACAGTCCTAGCGACTCAGGAGGCTGAAGTAGGCAGAGTTTGATGTGTTGCTGTGAACTACAAGGACACCAATGCACTCTAGGCCGGTAACAGAGTGAGACACTGACTAAAAAAAAAA","TTAGCCAGGTGTGGTGGCACATGCCTGTATTTCCAGCTACTCGGGAGGCTGAGGCAGGAGAATTGCGTGAGCTGAGATCATGCCACTTCATTCCAGTCTGGGTGACAGAGTGAGACTCTGCCTCAAAAAACAAAACAAAA"
"GL873578","7397948","7398119","chr5","40230148","40230319","43","32832200","TAAAAATAGCCATGCATTGTGACAGGCACCTGTAGTCCCAGCTACTCAGGAGGTTGAGGTAAGAGAATCACTTGAACCCAAGAGTTTTGAGGTTGTTATGAGCTAAGACGCCTCGGGACTCTACAAAAGGTAACAAAGTGAGACTCTGTCTCATAAAAAAAGAAAAAAAGAA","AAAATTAGCCAGGCATGGTGACGTACACCTGTAGTCCCAGCTACTCGGGAGGCTAAGGCAAGAGAATCGCTTGAACCCAGGAGGCAGAGGTTGCAGTGAGCTTAGATCACGCTACTGCGCTCCAGCCTGGGTGACGGAGTGAGACGCCATCTCAAAAAAAAAAAAAAAAAAA"
"GL873578","7398378","7398515","chr15","102382935","102383070","35","94984557","GGTCGAGCAAGGTGGCTCACGCCTGTAATCCTAGCACTCTGTGAGGCTGAGGCAGATGGATTGCCTGAGCTCGTGGGTTCGAGACCAGCCTGAGCCAGAGTGAGACCTCATCTCTAAAAATAGCTGGGAAGCTGGGCA","GGCCAGGTGTGGTGGCTCACGCCTGTAATCCTAGCACTTTGGGAGGCTGAGGCGGGTGGATTGCCTGAACTCAGGAGGTCAAGACCAGCCTGGGCAACACAGTAAAACCCCATCTCTACTAAAATACAAAAAATCA"
"GL873579","370235","370429","chr16","38067345","38067552","57","37697110","GCACAGGCCTGAAATCCTAGCACTCTGAAAGGCCAACGGAGGAGAATTTCTGGAGCTCAGGAGTTTGATACCAGCCTAAGCAAATAAAGCTAGACCTCTATCTCTACTAAAATTAGAAAAATTAGGCAGATGTGGTGGTAGGCACCTATAGTCCCAATTACTCCAGAGGCTGAGGCAGAAAGACTCTTGAACCCA","GTCAGGCATGGTGGCTCATGCCTATAATCCTAGCACTTTGGGAGGCCAAGGCCGGTGGATCACCTGAGGTCAGGAGTTTGAGACCAGCCTGGCCAATATGGCAAAACCCCGTCTCTACTAAAAATAAAAAAATTAGCTGGGCACGGTGGTGGGCACCTATAGTCCCAGCTACTCAGGAGGCTGAGGCAGGAGAATTGCTTGAACCCAG"
"GL873579","370936","371046","chr3","3847698","3847802","33","3476762","TGACTCTTGAACCCAGGCACATGAGGTTGCTAAGAGTCTAGGCTGATGTCACGGCACTCTAACCTGGGAAACAGTGTGAGGTTCTGCCTCAATAAATAAATAAATAAATAA","TGGCTTGAACCCAGGAGGCGGAGGTTGCAGTGAGCCGAGATCACGCCACTGCACTCCAGCCTGGGCAACAGAGCGAGACTGTCTCAAAAAAAAAAAAAAAAAAAA"
"GL873579","599436","599605","chr10","38982686","38982853","41","38383250","AAAAAGTCAGACATTGTGGCAGGTGTCTGTAATCCCAGCTATTTGGGAGGCTGAGGCAGGAGTATCATTTGAACCCACGAGTCTGAGGTAACTGTGAGCTAGGCTAACACAACAGCACTCTAGCCTGGGCAATAGAATGAGACTCTATCAAGAAAAGAAATGAAAAGAAA","TATTAGCCTGACACAGTGGCGCGCATCTGTAATCCCAGCTACTTGGGAGGCTGAGGCAGGAGAATCACTTGAACCCAGGAGGCGGAGGTTGCTGTGGGCTGAGATCATGCCACTGCACTCCAGCCTGGGCAACAGAGGGAGGCTCCATCTCAAAAAAAAAAAAAAAAA"
"GL873579","599942","599953","chr3","71473700","71473710","4","70873758","TTTTAAAATAGT","TTTAAAAAAAA"
"GL873579","600232","600365","chr1","16061315","16061447","30","15461083","GGCTAGGCAAGGTGACTCATGTCTGTAATCCTAGTACTCTGGGAGGTTTGAGGCAGGAAGACCACTTTAGCTCAAGAGTTCCAGATCAGCCTGTGCAAGAGTGATACATCATCTCTACTAAAAATCAAAAATTA","GGCTGGGCATGGTGGCTCATGCCTGTAATCCTAGCACTTTGGGAGGTTGAGGCAGGCAGATCACTTGAGGTCAGGAATCTGAGACTAGCCTGGCCAACATGGTGAAACTCCATCTCTACTAAAAAAAAAAAAA"
"GL873579","5650320","5650591","chr6","54938866","54939145","71","49288546","GTCAGGTGTGTTAGCTTACAGTAGTAATCCTAGCACTTTGGGAGGTTGAAGTGGGTGGATTGCTTGAGCTCAGGGGTTCAAGACCAGCCTGAACAAGAGTGGGACCTCATCTCTATTAAAAACAGAAAAACTAGCTGGGTGTTATGGTGGGTGTCTGTAGCCCCAGCTACTCAGGAGGCTGAGGCAGGAGGTTGAGGTTGCTGTGAGCTATTGAGACCACAGCACTCTATCCAGGGCAACAGAGTGAGACCCCTCCCCCCCCCAAAAAAAAA","GGCCAGGTGTGGTGGCTCACGCCTGTAATCCCAACACTTTGGGAGGCCGAGGTGGGTGGATCACCTGAGATCAGGAGTTCAAGACCACCCTGGCCAACATGGTGAAACCCCGTCTCTACTAAAAATACGAAAATTAGCTGAGTGTGGTGGTGCATGCCTGTAGTCCCAGCTACTCAAGAGGCTGAGGCAGGAGGTGGAGGTTGCAGTGAGCCGAGATTGCATCACTGCACTCCAGCCTTGGCGACAGAACGAGAGAGACTCCATCTAAAAAAAAAAAAAA"
"GL873579","7037162","7037347","chr3","37328686","37328893","67","30291524","GAGGTGGGTGGATTGCCTGAGCTCACAGGTTGGAGACCAGCCTGAGCCAGAGCAAGACCTTATCTCAAAAAATAGCCAGGTGTTGTGGCTGGCACCTGTAGTCCCAGCTGCTCAGGAGGCGGAGGCAAGAGAAATGCTTGACCTCAGGAGTTTGAGGTTGCTGTGAGTTCAACTCACACTAATACA","GAGGCAGGGGGATCACCTGAGGTCAGGAGATCGAGACCAGCCTGGCCAACATGGTGAAAACCTGTCTCTACTAAAAATCCAAAAACATTAGCCAGGTGTGGTGGCACGCACCTGTAATCCCAGCTACTTGGGAGGCTGAGGCAGGAGAATCACTTGAACCTGGGAGGCAGAGGTTGTAGCGAGCCGAGATCACACCACTGCACCCCAG"
"GL873579","11077764","11077972","chr19","1200469","1200683","63","9877295","GCCAGGTGCAGTGGCTCATGCCTATAATCCTAGCACCCTAGGAGGCTGAGGAGTTCAAGACCAGCCTAAGCAACTGTGAGACCCCATCTCTACCAAAAATAGAAAAATTAGCTGACTGTTATGGTGTGCACCTACAGTCCTAGCTACTCAGGAGGCTGAGGCAGAAAGAGTCCTTGAACCCAGGAGGCTTTTTTTTGTTGTTGTTGTTG","GGCCAGTCGCGGTAGCTCATGCCTGTAATCCCAGCACTTTGGGAGGCCGAGGCGGGCAGATCACCTGAGACCAGCCTGGCAACATGGTGAAACCCCATGTCTACCCAAACTACAAAAATTAGCTGGGTGTGGTGGTGCACGCCTGTAATCCGAGCTACTCAGCAGGCTGAGGCAGGAGAATCCCTTGAACCTGGGAGGCAGAGGCTGCAGTGAGC"
"GL873579","11078245","11078333","chr19","4926258","4926351","22","6151987","TGAACCCAGGAGTTTGAGTTCGCTGTGAGCTAAGCTGAGGCCACAGCACTCCAGCCTGGGCAACAGAGTGAAAGGAAAAAAATAAAAAA","TGAACCCGGGAGGTGGAGGTTGCAGTGAGCCAAGATCACACCAATGCACTCCAGCCTGGGCAACAAGAGTGAAACTCTGTCTAAAAAAAAAAAA"
"GL873580","320374","320488","chr13","48549305","48549409","42","48228931","GGTAGTGCGTGCCTGCATTCCCAGCTACGGGAGGGCAGGGACTTGAGGCCAGCCTGGGCAAAATAATGAGACCTACTAATGACTCTACTAATACAGAAACAATTAGCTAGGTATG","TGGGAGGCCGAAGTGCGCAGATCACCTGAGGTCAGAAGTTGGAGACCAGCCTGGCCAACATGGTGAAAACCCATCTCTACTAAAAATACAAAAATTAGCTGGGCA"
"GL873580","374969","375091","chr6","147681010","147681135","27","147306041","CGGTGGCTCACACCTATAATCCTAGCATTTTGGAAGGCTGAAGCCGAGGATCTCTGGAAGTCAGAAGTTCAAGACCAGCCTGCCCAAGAGCAAGACCCCATCTCTACTAAAAATAGAAAAACT","GGTGGCTCACACCTGTAATCCCAGCATTTTGGGAGGCTGAGGCAGGCGGATAATCTGAGGTCAAGAATTTGAGACCAGCCTGGCCAACATGGAGAAACCCTATCTCTACTAAAAATACAAAATTAC"
"GL873580","375369","375549","chr7","19977275","19977456","44","19601906","CTAACCAAGTTAGTTAGTTTTAGTTGGCAGGTGCCTGTAGTCCCAGCTCCTTGGGAGGCTGAGGCAAGAGAATGGCTTGAGCCCAGGACTTTGAAGTTGCTGTGAGCTATAATGACACCACAGCACACTACCCAGGGTGACAGAGTGAGACTGTCTCAAAAAAACAAACAAACAAAAAAAA","AACAAACGTTAGCCGAGCATGGTGGTATGTGCCTGTAGTCCCAGCTACTTGGGAGTCTAAGGCAGGAGAATTACTTGAGCCCGGGAGGCAGAGGTTGCTGTGAGCCAAGATCACGCCACTGCACTCCAGCCTGGGTGACAGAGTGAGACTCCATCTCAAAAAAAAAAAAGGAAAAAAAAAAA"
"GL873580","8760922","8761015","chr11","104681322","104681416","19","95920400","GGAGGGAGACACTGCAGTGAACTGCGATCGTGTCTCTGCTTTCCAGGCTGGGTGACAGAGTGAGACTCGGTCTCTAAAATAAAAAATAAATAAA","GGAGACGGAGGTTGCAGTGAGCTGTGATCGCGGCACTGCACTCCAGCCTGGGCAACAGAGTGAGACTCTGTCTCAAAAATAAATAAATAAATAAA"
"GL873580","9391260","9391306","chr14","49279240","49279285","12","39887980","GCCAGTCGAGGTGGCTCACACTTGTGATTCCAGCTACTTGGAAGACT","GGCTGAGATGGTGGCACACACCTGTAATCCCAGCTACTTGGGAGGC"
"GL873581","759283","759365","chr6","46535476","46535542","30","45776193","TAAGAACCTGAAAATAGAGCCAGGCATAGTGGTACATGCGTATAGTCCTGGCTACTCAGGAGGTTGAAACAACAGGATTACTT","CAAAATAGCCAGGCTTGGTGGTGCATGCCTATAATCCAAGCTACTCGGGAAGCTGAGGCAGGAGAAT"
"GL873581","1145844","1145979","chr1","29437872","29437991","29","28292028","GGCCGGGCGTGGTGGCTCACGCCTGTAGTCCCAGCACTATGGGAGGCCGAGGCGGGTGGATCACCTGTGCTCAGAGGTTCGAGACCAGCCAAGACCCCCCTGAGCCAAATGAGCCAGAGTGAGACCCCGTCTCTAC","GGCCGGGCGTGGTGGCTCACGCCTGTAATCCCAACATTTTGGGAGGCCAAGGCGGGTGGATCACCTGAGGTCAGAAGTTCGAGACCAACCTGGCCAACATGGTGAAACCCCTGTCTCTAC"
"GL873581","9628238","9628362","chr5","141044567","141044691","34","131416329","ATCCCAGGTAGTCGGGAGGCTGAGGCAGGAGGATCACTTGAACCCAGGAGGTTGAGGTTGCTGTGAGCAAGGCAGAGGCAACGGCACTCTAGCCACGGGGGCACAGAGACTCTTGTCTTTAAAAA","TAATCTCAGCTACTCGGGAGGCTGAGGCAGGAGAATCGCTTGAGCCCAGAAGGTGGAGGTTGCAGTGAGCCAAGATCGCGCCATTGCACTCCAGCCTGGGCGACAGTGCGAGACTCTGTCTCAAA"
"GL873582","1580485","1580534","chr6","32576760","32576806","12","30996275","CAGCACTTGAGAGGCCAAGGCAGGTGGATCAACTGAGCAAGAATGAGACC","CCAGCACCTTGAGAGGCCAAGGCAGGTGGATCACCTGAGGTCAGGAG"
"GL873582","1644368","1644551","chr1","211626449","211626612","63","209982081","AAAATTTGCCGGGCTCCATAGCTCATGCATGTAATCATAGCACTCTGGGAGGCCAAGATGGGAGGATCTCTCAAGCTCTCTTACTTGGGAGGCTGAGGTTGCTGTGAGTTAGGCTTACGCCACAGCACTCTACTCTAGCGTGAGCAACTCTACTCTTAGTATGAGACTGTCTCAAAAGAAAAAA","AAATTAGCCAGGCGTCGTGGCACATGCCTGTAATCCCAGCTACTCGGGAGGCTGAGGCAGGAGAATAGCTTGATCTCGGGAGGCGGAGGTTGCAGTCAGCCGAGATCACACCACTGCAATCCAGCCTGGACAACAGAATGAGACTCCATCTCAAAAAAAACAAA"
"GL873582","5794385","5794459","chr13","18872784","18872852","27","13078399","ATATTGTTAAGCACAGCCACTATTAAAAATTAAATTATAGGCCAGGCATAGTGGCTCATGCCTGTAATCCTAGCT","TGAAACCACCATCTGGACCAAGATACAAAATGTTGGCTGGGCATGGTGGCTCACACCTGTAATCCTAGC"
"GL873583","102645","102683","chr14","5808766","5808804","14","5706121","GAGCAGATCACCTGAGCTCAGGAGTTTGAGACCAGCCTG","GAGGAATCCCTGTGCTCAGGAAGCTTACATTCTAGTGAG"
"GL873583","6200447","6200560","chr4","17786849","17786963","24","11586402","GGCCAGGAGGGACGGCTCATGCCTGTTATCCTAGCACTATGGGAGACTGAGGTGGGAGGATCACTTGAAGTTAGGAGTTCCAGACCAATCTGACCAAAGTGAGACCTCATCTCT","GGCCAGGCTTGGTGGCTCATGCCTGTAATCTTAGCACTTTGGGAGGCTGAAGTGGGTGGATCACTTGAGGTCAGGAGTTAGAACCAGTCTGGCCAACATGGTGAAACCTCAGCTC"
"GL873583","6200584","6200752","chr6","169626528","169626696","42","163425944","TTAGCTGGATGTGGTAGCACATGCCTATAGTCCCATCTACTCAGGAGGCTGAGACAAGAGAGTTGCTTAAGCCCAGGAGTTTAATTTAACTGTGAACTAGACTGAGACTGTGGCACTCTAGCTGGGGCAACAGAGTGAGACTCTGTCTCAAAAGAAAGCAAGAAAGAAA","TTAGCTGGGTATGGTGTCAGATGCCTGTAGTCCCAGCTACTCAGGAGGCTGAGACAGGAGAATCGTTTGAACCCAGGAGGCCAGAACTGCAGTGAGCTGAGATTCGCACCACTGCGCTCCAGCCTGGGCCAGACAGAGTGAGACTCTATCTCAAAAGAAAAAAAAAAAA"
"GL873583","10217398","10217583","chr3","36257142","36257313","44","26039744","TACTAAAAATAAAGTGTGATAGCCAGGCATGGTGGTGGTGCCTATAGAACCAGGCTATTCAGGAGGCTGAGGCAGAAGGATCACTTGAACCCAGGAGTCTGACGTTGCTGTGAGCTAGGCTGGTGCCATGGTACTCTAGCCTGTGGTAACAGAATGAGACTCTATCTCAAAAATAAAAATAAAAAA","TACAAAATTAGCCAGGCGTGGTGGTGCGTGCCTGTAATCCCAGCTACTTGGGAGGCCGAGGCAGAAGAATGACTTGAACCCAGGAGACAGAGGTTGCAGTGAGCCAAGATCCCACCATTGTACTCCAGCCTGGGCAACACAGTGAGACTCCATCTCAAAAAAAAAAAAAAAA"
"GL873583","10394919","10394983","chr16","12841703","12841771","22","2446784","GAGGTCAGGAAATCAAGATCAGTCTGGGCAATATATTGATACCCTGCCCCTACATAAGGAAGAAA","AGGTCAGGAGTTCAAGACCAGCCTGGCCAATATGTTGAAACCTCATCTCTACTAAAAATACAAAAATTA"
"GL873584","521512","521529","chr1","167402212","167402233","10","166880700","GCATGGAACCCCCCACTC","GGTGAAACCCCATCTTTACTAA"
"GL873584","2079725","2079768","chr15","4338291","4338335","11","2258566","GGCAGGTGGATTACCTGAGTTCAGGAGTTGGAGACCAGCCTGAC","AGGCGGATGGATCACGAGGTCGGGAGTTTGAGACCAGCCTGACCA"
"GL873584","5216877","5217053","chrX","91350057","91350230","49","86133180","CTACTGAAAATGATGACAGAGGCTGGGCATGGGGGCTCCCGCCTGTTATCCTAGCACCCTCGGAGGCTGGGGAATGAGGATTGCTTACGCCCAAGAGTTTGAGGTTGCTGTGAGCTGAGGCCGCTGCACTCTAGCCTGGGCAACAGAGTGAGACTCTGTCTCAAAAAAAAAAAAAAA","TGCAAAAATGAGCTGGGCATGGTGGCACATGCCTGTAATCCCAGCTACACAGGAGGCTGAGGCAGGAGAATCGCTTGAATCTGGGAGGCGGAGGTTGCAGTGAGCTGACATCAGGCCCCTGCACTCTAGCCTGGGCCACAGAGCAAGACTCCGTCTCAAAAAAAAAAAAAAAAA"
"GL873584","7289930","7289950","chr2","51453328","51453345","10","44163398","TGAGGCTCTGTCTCGAAATAA","AATGCCATCTATTAAAAA"
"GL873584","7289975","7290131","chr11","49739997","49740154","37","42450022","CAAGAAAATTAGCTGAGAGTCCTGGTAGGTGCCTGTAATCCCAGCTATTCATGAGGCTGAGGCAGAAGGATCACTTGGGTCCAGGAGTCTGAGGTTGCTGTGAGCTAGTCTGACGCCATAACACGCAAGCCTGGGCAACAGAGTGAGGCTCGGTTTC","CTACAAAAATTAGCTGGGCGTGGTGGCACATGCCTGTAATCCCAGCTACTCGGGAGGCTGAGGCAGGAGAATCACTTGAGCCCAGGAGGCGGAGGTTGCAGTGAGCCAAGATCATGCCATTGCACTCCAACCTGGGCAACAGAGCAAGACTCCATCTC"
"GL873584","7577743","7577867","chr5","48394329","48394446","27","40816586","GGCTGGATGAGGTGGTTCATGCCTGTAATCCTAGCACTCTGGGAGGCCAAGGTGGGTGGATTGCCTGAGCTCAGGAGTTCAAGACCAGCCTGAGCAAGACCCTGTCGCTAAAAATAGCTGGGTGT","GGCTGGGTGCAGTGGCTCATGCCTGTAATCCCAGCACTTTGGGAGGTCAAGGCGGGTGGATCACCTGAGGTCAGGAGTTCAAGACCAGCCTGGCCAACATCTCTACTAAAAATACAAA"
"GL873584","7578135","7578289","chr1","130112713","130112865","31","122534578","GGAGCTGGGTTTTGTGACTGCACCTGTAATCCCAGCTGCTCAGGAGGCTGAGGCAAGAGAATTGCTTGAGCCCAGGAGTTGGAGGTTGCTGTGAGCTGTGATGCCAGGGAACTCTACCAAGGGTGACAAAGTGAAACTCTGTCTCAAAAAAAAAA","TTAGCCAGGTGTGGTGATGCATGCCTGTAATCCCAGCTACTCATGAGGCTGAGGCAGGAGAATTGCTTGAACCTTGGAGCTGGAGGTTGCAGTGAGCTGAGATCAGACCACTCCAACCTGGGTGACAGAGCGAGACTCTGTCTCAAAAAAAAA"
"GL873585","1450952","1451121","chr10","59681079","59681242","48","58230127","TAAAAACAGAAAAAACTAGTCAGGTGGTGTGGTAGGTGCTCATAAGTCCCAGCTGCTTGGGAGACTGAGGCAAGAGAATCACTTGAGCACAAGAGCTTGAGGTGGCTGTGAGCTATAACACCATAGCACTGTACTGAGGGTGACAAAGTAAGACTCTGTCTCAAAAAAAA","TACAAAAATTAGTCAAGGGTGGTGGTATGTGCTTGTAATCCCAGCTATTTGGGAGGCTGAAGCAGGGGAATCCTTGAACCCAGGAGGTGGAGGTTGCAGCGAGCCGAGATCACGTCACTGCACTCTAGCCTGGGCGATAGGGTGAGACTCTGTCTCAAAAAAAA"
"GL873585","1451382","1451515","chr6","17405813","17405948","24","15954431","GGCCCGGCTCGGTGGCTCACACCTATAATCCTAACACTCTGGGAGGCTGAGGCAGGTGGATCACCTGAGCTCAGGAGTTTGAGACCAGCTGAGCAAAAACAAGACCCTATCTCTGCTAAAAATAGAAAAAACTA","GGCCGGGCGGGGTGGCTCACGCCTGTAATCCCAGCACTCTGGGAGGCCAAGGCAGGTGGATCACCTGAGGTCAGGAGTTTGAGACCAGCCTGGCCAACACGCAGAAACCCTATTTCTACTAAAAACACAAAAATTA"
"GL873585","1626960","1627026","chr7","17782729","17782794","22","16155769","AAGATGCCACAGCACTCTACAAGAGTGACCAAGTGAGACTCTGTCTCAAAAAAAAAAAGAAAAGGAA","CAATCGCACTACTGCACTTCAGCCTGGGTGACAGAGTGAGAACCTGTCTCAAAAAAATAAATAAAA"
"GL873585","1627304","1627531","chr11","17033552","17033788","61","15406248","GGCTGGGCACAGTGGCTCACGGCTATAATCTAGGCACTTGGGAGGCTAGGGCAGGTGGATTGCCTGAACTGACAAGTTTGAGACCAACCTGAGCAAGAGCGAGACCCCTGTCTCTAAAACATAGCCAGGCTCTGTGGTGGGCGTCTGTAGTCCCAGCTACTTGGGAGGCTGAGGCAAGAGAATTGCTTGAACTCAAGAGTCTGAGGTTGCTGTGAGTTAAGATGCCAC","GCCCGGCGCAGTGGCTCACGCCTGTAATCCCGGCACTGTGGAGGCCAAGGCAGGCGGATTGCCTAAGCTCAGGGATTCGAGAACAGCCTGGGCAACATGGTGAAACCCCATCTCTACTAAAATACAAAAAACTAGCCGGGCGTGGTGGTATGCGCCTGTAATCCCAGCTACTTGGGAAGCTGAGGCAGGAGAATTGCTTGAACCCGGGAGATGGAGGTTGCAGTGAGCTCAGATCAC"
"GL873585","3626082","3626158","chr1","100916857","100916922","27","97290775","TGCCTGTAATCCCAGCACTTGGGAGGCGGAGGTGGGTAGATTGCCTGACCCAGAGTGGGACCTCATCTCTAAAAGAA","CATGCCTGTAATCCCAGCACCTTGGGAGGCCAAGGTGGGTGGATCACCTGAGGTCAGTAGTTTGAG"
"GL873585","8849829","8849913","chr18","48581945","48582025","18","39732116","GGCTGGACGAGGGGACTCATGCCTGCAATCCCAGCACTGAGAGAGGCCAAGGCAGGTGGATCCCCTGAGCTCAGAAGTTTGAGAC","GCTGGACGCAGTGGCTCACACCTGTAATCCCAGCACTTTGGGAGGCCAAAGCAGGCAGATCTGAGGTCAGGAGTTTGAGAC"
"GL873585","9319890","9319971","chr8","79499361","79499447","14","70179471","GGCCAGGTGTGGTGGCTCACACCTGTCATCCTAGCACTCTGGGAGGACGAGGTGGGTGGACCGCCTGAGTCAGAGTGAGACC","GGCCAGGTGTGGTGGCTCACACCTGTAATCCCAACACTTTGGGAGGCCCAGGTGGGTGGATCACCTGAGGTCAGGAGTTCAAGACCA"
"GL873586","895572","895692","chr17","14501559","14501680","38","13605987","GGCCAGGTGAGGTTTCTCATTCTGGGAGTGAGCCAGCAATTGGGAGGCCAAAGTAAATGGATTGCCTGAGGTTATAGGTTCCAGAACAGCCAGAACAAGATCGAAATCCTGTCTCCAAAAA","GGCCAGGCGTGGTGGCTCATGCGTGTAATCTCAGCACTTTGGAAGGCCGAGGCAGGTGGATCACCCGAGGTCAAGAGTTCAAGACCAGCCTGACCAACATGGCGAGTCTCTGTCTCCACTAA"
"GL873586","5645995","5646150","chr6","58863249","58863409","38","53217254","GGGTATGGTGGCTCATGCCTGTAATCCAAGCACTCTGGGATGGTGAGGCAGGAGAATCCCTTGAACCCAAGAGTCCGAGGTTGCTGCGAGCTAAGCTGATGGCATAACACTCTAGCCTAGGCGACAGAGTGAGACTCTGTTTCCAAAGAGAAAAAA","TTAGCCAGGCATGGTGGCACATGCCAGTAATCCCAGCTACTCAGGAGGATGAGGCAGGAGAATCGCTTGAACCCAGGAGGCAGAGGTTGCAGTGAGCTGAGATTGCGCCACAGCACTCTACCCTGGGTGACAGAAGGAGACTCTGTCTCAAAAAAAAAAAA"
"GL873586","10258686","10258969","chr12","9481260","9481565","81","777426","GGCCGGGCATGGTGGCAGAAATCTAGGAGGCCGAGGCAGGTGGATCGCCTGAGATCACAAGTTCAAGACCAGCCTCAGCTACAGCAAGACCCCATCTCTAAAAATAGCCGGCTGTTGTGGCAGGCGCCTGTAACCCCAGCTACTCGGGAGGCTAAGGCAAGAGAATCGCTTGAGCCCATGAGTCTGAGGTTGCTGCGAGCTGTGACTCCACGGCACTCTACCCGGGGCGATAAAATGAGATTCTGTGTCAAAACAAACAAACAAACAAACAACAACAAAAACAA","GCTGGGCGCGGTGGCTCATGCCTGTAATCCCAGCACTTTGGGAGGCCAAGGCAGGTGGATCACCTGAGGTCAGGAGTTCGAGACCAGCCTAGTCCACATGGTGAAACCCCATCTCTACTAAAAACTAGCCAGGCGTGGTGGTGCGCACCTGTAATCCCAGCTACTCGAGAGGCTGAGGCAGGAGAATCACTTGAGCCTAGGAAGCAGAGGTTGTGGTGAGCTGAGATCACACCACTGCACTCCAGTCTGGGCGACACAGTGAGACTCTTGTCTCAAAAACAAAAAACAAACAAACAAACAAACAAA"
"GL873587","3208032","3208047","chr8","3626746","3626762","2","418714","AAACAACCACAAAAAA","ACAACAACAACAAAAAA"
"GL873587","3208141","3208321","chr19","2057131","2057316","59","1151010","TTTCTTTTAAAAATCACCCATGGGCTGGGTATAGTGGCTCACACCTATAATCCTCGGGAGGCCAAGGTTGGAGGATTGCTTGAATCCAGGAGTTGAAGGTTACAGTGAACTGGGATTTAGCCACTAGACTCTAGCATAGCTGACAAAGCAAGAACCTATTTGTTTAAAACACAAAAAAGAA","TACTAATAATACAAAAATGAGCCGGGTATGGTGGCGGGTGCCTGTAATCCCAGCTACTGAGGAGGCTGAGGCAGGAGACTTGCTTGAACCCAGGAGGTAAAGGTTGCAGTGAGCTGAGATTGCACCACTACACTCCAGCCTGGGCGACAAGAGCAAAACTTTTTCTCCAAAAAAAAAAAAAAAAAA"
"GL873587","3278260","3278367","chr19","19044200","19044312","39","15765940","CAGTCTGAGCAAGAGGGAGAGGCTATTTCTACTAAAAACAGAAAAACTAGCTGGGTGTTGGGGTGTGTTCCTAGTCTCAGTTACTTGGGAGGCTGAAGTAAGAGGATC","ACCAGCCTGGCCAACACGGTGAAATCCCGTCTCTACTAAAAATACAAAAATTACCTAGGCGTGATGGCACGTGCCTGTAGTCCCAGCTACTCATAAGGCAGAGGTGAGAGAAT"
"GL873587","3278673","3278754","chr7","49412503","49412597","28","46133830","GGCCACGAGAGCTAGCTCATGCCTATTCTAGGAGGCCAAAGCAGGCAGACTGCCTGAGCTCAGGAGTTCAAGAGCAGCCTGG","GGCCAGGTGCAGTGGCTCATGCCTGTAATCCGAGCACTTTGAGAGGCCGAGGCAGGCAGATCACCTGAGGTCAGGAGTTCAAGACCAGCCTAGTA"
"GL873587","3782076","3782188","chr9","112128434","112128552","34","108346358","ACTGGGGTGGCTGAGGCAGGAGCGTCACTTGAACTCAGGAGTTTGAGATTGCTGTGAGCTGAGCAGATGTCATGGCACGCTAGCCTAGGTAATAGAGTGAGACTTCGTCTAAA","CAGCTACTCGGGAGGCTGAGGCAGGAGAATCACTTGAACTCGGGAGGCGGAGGTTGCAGTGAGCCGAGATCACGCCATTGCACTCCAGCCTGGGCAACAAGAGCGAAATTCCATCTCAA"
"GL873587","4564996","4565084","chr20","27900350","27900437","14","23335354","GGCGGGGTGTAGTGGCTCATGCCTATTGTCCCAGCACTGTGGGAGGCCGAGGTGGGTGGATCACCTGTGCTCAGAAGTTTGAGACCAGC","GGCCGGGCGTGGTGGCTCATGTCTGTAATCCCAGCACTTTGGGAGGCCGAGGTGGGTGGATCACCTGAGGTCAGGAGTTCAAGACCAG"
"GL873587","6307870","6308175","chr12","112427710","112428020","54","106119840","GGCCAGATATGATGGCTCATGCTTGTAATCCTAGCACTCTGGGAGGCTGAAGTGGGAGGATCACCTGAGATCAGGAGTTCAAGATCACCCTGAGCAAAAGTGAGATCCCATCTCTATTAAAAATAAAAAAATTATCCAGGCATGGTGGTGCAGTCCTTTAGTCCCAGCTACTTGGGAGGCTGAGGCAGGAGAATCTCTTGAACCCAGGAATTAGAGGTTACAGTGAGCTGTGATGATGCTACTGCACTCTAGCAGGATGACAGAGTGAGATACTCCGTGTCAAAAAAAAAAAAAAAAAAAGCAAAA","GGCTGGACATGGTGGTTCATGCTTGTAATCCGAGCACTTTGGGAGGCCAAGGCGGGTGGATCACCTGAGGTTGGGAGTTCGAGACCAGCCTGACCAACATGATGAAACCCCATCTCTACTAAAAATACAAAAAAATTAGCCAGGCATGGTGATGCACGCCTGTAATCCCAGCTACTTGGGAGGCTGAGGCAGGAGAATCACTTGAACCCAGGAGGCAGAGGTTACAGTGAGCCGAGATCATGCCATTGCACTCCAGCCTGGATGACAGAGTGAGCCTCTGTCTCAAAAAAAAAAAAAAAAAAAAAAAAAAA"
"GL873587","6484004","6484128","chr10","67341428","67341546","29","60857424","GACCAGGTTCTGTGGCTCATGCTTGTAATCCTAGCACTCTAGGAGGCCGGAAGAGGGTGGATTGATTGCCTGAGGTCAGGAGTTAGAGACCAGCCTGAGCAAGAGCTAGACCCTGTTTCTTTCTT","GGCTGGGTGTAGTGGCTCATGCCTGTAATCCCAGCACTTTAGGAGGCCAAGGTGGATGGATTGCCTGAGCTCAGGAGTTCGAGACCACCCTGGGCAACAAGCCAAAACCCTGTCTCTAC"
"GL873587","6484407","6484586","chr3","167196537","167196723","48","160712130","TAGACCCTGTTTCTAAAAAAAAAATAGCCAGGTGTTGAGGCAGGTACCTGTAGTCCCAGCTACCTGGGAGGGCTGAGGCAAGAGAATCGCTTGAACCCAAGAGTTTGAGGTTGCTGTGAGCTGAGATGCTATGGCACTCAACCGTGAGCTACAAAGTGAGACTCTGTCTCAAAAAAAAAA","AAAACCTGTCTCTGCTAAAAATACAAAAATTAGCCGGGTGTGGTGATGTGCGCCTGTAGTCCTAGCTACTTGGGAGGCTGAGGCAGGAGAATCACTTGAATCCAGGAGGTGGAGGTTGTAGTGAGTCGAGATCGTGCGACTGCACTCCAGCCTGGGTGACAGCGAGACTCTGTCTCAAAAAAAAAAA"
"GL873587","7466229","7466364","chr1","29437872","29437991","35","21971643","GGCCAGGCGTGGTGGCTCATGCCTGTAGTCCCAGCGCTATGGGAGGCCGAGGTGGGTGGATCACCTGTGCTCAGAGGTTCGAGACCAGCCAAGACCCCCCTGAGCCAAATGAGCCAGAGTGAGATCCCATCTCTAC","GGCCGGGCGTGGTGGCTCACGCCTGTAATCCCAACATTTTGGGAGGCCAAGGCGGGTGGATCACCTGAGGTCAGAAGTTCGAGACCAACCTGGCCAACATGGTGAAACCCCTGTCTCTAC"
"GL873588","1502535","1502718","chr1","34852429","34852590","60","33349894","GGTGCAGTGGCTCACACCTGTTGTCCCAGCGCTGTGGGAGGCCGAGGTGGGTGGATCACCTGTGCTCAGAGGTCGAGACCAGCTGAAGACCTGCCTGAGGCAGAGTGAGCCAGAGTGAGACCCCGTCTCTACTAGAACAACAACAAGACAGCCAGACCTTGTGATCCCAGCTACATGGGGGGCT","GCCAGGTGCAGTGGCTCACACCTGTAATCCCAGCACTTTGGGAGGCCGAGGCGGGCGGATCACCTGAGGTCAGGAGTTTGAGACCAGCTTGACCAACATGGAGAAACCCCGTCTCTACTAAAAATACAAAATTAGCCTGGTGTGGTGTCGCATGCCTGTAAT"
"GL873588","10189037","10189246","chr3","45604681","45604903","65","35415644","GCTGAGATGAGGAGACTCTGTCTCTATTAAAAATAGAAAAATTGGGTGGATGTTGTGGGTACTGTAGTTGCAGCCTCTTGGGGGGCTAAGGCAGGAGGATCAGTTGAAGCCAGGAATTTGCTTTGAGCTAGGCTAAAGCCATGGCACTCTAGCCTGGGCAACAGAGTGAGGCTAGATCTCAAAAAAAGAAAGAAAAGAAAAAGAAAAAAA","CTGGCCAACATGGCAAAACCCCATCTCTACTAAATATACAAAAATTAGCTGGACGTGGTGGCACATACCTGTAATCCCAGCTACTTGGAAGGCTGAGGCAGGAGAATAGCTTGAACCTGGGAGGCAGAGGTTGCAATGAGCTGAGATCACGCCACTGCACTCTAGCCTGGGCAATAGAATGAGACTCTGTCTCAAAAAAAAAAAAAAAAAAAAAGACAAGAAA"
"GL873589","104719","104807","chr20","27900350","27900437","13","27795631","GGCTGGGCGTGGTGGCTCATGCCTGTTGTCCCAGCGCTGTGGGAGGCTGAGGTGGGTGGATCACCTGTGCTCAGAGGTTCGAGACCAGC","GGCCGGGCGTGGTGGCTCATGTCTGTAATCCCAGCACTTTGGGAGGCCGAGGTGGGTGGATCACCTGAGGTCAGGAGTTCAAGACCAG"
"GL873589","796766","796905","chr1","166346372","166346487","49","165549606","GGCTAAGTGTGGTGGCTCACACCTGTCATCTAGTACTTTGGGAGGGTGGGCCTGGGAGTTCAAAGACTGAACTCAGGAGTTCAAGGTGGCTCCGGGGAGGAATTCAAGACCAACCTGAGCCAGAGCGAGACCTCGACTCT","GGCCAGTGGGGTGGCTCACGCCTGTAATCCCAGCACTTTGGGAGGCTGAGGTGGTCAAATGACCTGAGGTCAGGAGTTTGAGACCAACCTGGCCAACATGGTGACACCTCGTCTCT"
"GL873589","1023679","1023690","chr1","205890061","205890072","1","204866382","AAAAAAAAAAAA","ACAAAAAAAAAA"
"GL873589","1023771","1024047","chr4","103012712","103012993","70","101988941","GGCTTGGTGGCTCACACCTGTAATCCTAGCACTCTGGGAGGCCGAAGTGGCTGGAATACTTGAGGTCAGGAGTTCAAGACCAGCCTAAGTGAGAGTGAGATCCCCATCTCTAATAAAAATAGAAAAATTAGCAGGGTGTTGTGGCTGGCACTTGTAGTCCCAGCTACCCAGGAGACCGAGGCAGAAGTTTGAGATTATTGTGAGCGAGGCTGATGCCACAGCATTCTAGTGGGACAACAGAGCAAAATTCTATCTCAAAAGAAAAAAAAAAAAAGGA","CGGGCGTGATGGCTCACGCCTGTAATCCCAACACTTTGGGAAGCCGAGGCGGACGTATCACCTGAGGTCAGGAGTTCAAGACCAGCCTGGCCAACATGGTGAAACCCCGTCTCTACTAAAAATACAAAAATTAGCTGGGTGTGGTGGCATGCGCCTGTAATCCCAGCTACCCAGGAGGCTGAGGCAGGAGAATCGCTGAGGCTGCAGTGAACTGAAATTGTGCCACTGCACTCCAGCCTGGGTGACAGAGCAAGACTCTGTCTCAAAAAAAAAAAAAAAAAA"
"GL873589","4820958","4821024","chr8","33633747","33633811","15","28812789","TTAGTCAAGTGCAGTGGCTCACACCTGTCATCCCAGCTACTTGGGAGGCTGAGGCAGGAGAGTTGCT","TTAGCCAGGTGTGGTGGTGCATGCCTCTAATCCCAGCTACTCAGGAGGCTGAGGCAGGAGAATTG"
"GL873589","6763768","6763857","chrX","25814002","25814092","29","19050234","GGTGTGGTGGCTCACACTTGTATCTTAGCATTTTAGGAGGCTGAATGGGGAGAATTGCTTTAAGTCAGGAGTCTGACTTCCACCTTGCCA","GGCTGGGAATGGTGGCTCACACCTGTAATCCCAGCACTTTGGGAGGCTGAGGTGGGCAGATCACCTGAGGTCAGGAGTTTGAGATCAGCCT"
"GL873589","8444551","8444632","chr9","93194085","93194171","17","84749534","CGGGCATGGTGGCTCACAACTATAATCTTAGCACTTTGGGAGGCTGAGACAGGTGGATGCCTGAACTCAAGAGTTTGAAACC","GGCCGAGCATGGTGGCTCACACCTGTAATCCCAGCACTTTGGGAGGCTGAGGCAGGTGGATTACCTGAGGTCAAGAGTTCAAGACCA"
"GL873589","9085365","9085494","chr2","194063347","194063481","42","184977982","GGCCAGGCACAGTGGCTCACACCTATAATCCCAGCACTCTGTGAGACTGAGGCAGGTGAACTGTTGCAAGAGTGAGACCCTGTGCTTGGTGCCTGTAGCTCAGTGGTTAATAATAAGAAAAAAGAAAAAA","GGCCAGGTGCAGTGGCTCACACCTGTAATCCCAGCACTTTGGGAGTCTGAACCAGGCAGATCACCTGAGGTCAGGAGTTCGAGGCCAGCTCGGCCACCATGGTGAAACCCTGTTTCTAATAAGAATACAAAAAAA"
"GL873589","9085767","9086002","chr7","84631446","84631650","75","75545679","GAGTGAAACCCTGTCTCTACTAAAAATAGAAAAACTAGCTGTGCATCAGGGCGCATAACTGTAGTCCCAGGTACTCAGGACACTGAGGCAAGAGAATTGCTCAAGCCCAAGAGTTTGCAAGAATTTGAGGTTGCTATGAGCTATGATGCCATGGCACTCTACCTAGGGTGACAGACAGAGACTCTGTCCCAAAAAAAAAAAAAGAAGAAGAAGAAAAAAAAAAAGAAAGAAAGAAA","ATAGTGAAACCTCGTCTCTACTAAAAATACAAAAATTAGCTGGGCATCATGGTGCACGCTTGTAATTCCAGCTACTTGGGAGGCTGAGGCAGGAGAATTGCTTGAACTCAGGAGGTGGAGGTTGCAATGAGCCAAGATCGCGCCACTGCACACCAGCCTGGGTGACAAAAGACTCTGTCTCAAAAAAAAAAAAAAAAAAAAAAAA"
"GL873589","9992904","9993045","chr16","56427538","56427666","46","46434634","AACCAGCCAGGCATGGTGATTCACACCTATAATCCCAGCTACTTAGGAGTATGGCTTGAGCACACAGGATACCATACCATTCTAGTCATCCCAGGCAACAGAGGGAAACTCTGTTGGTTAAAAAAAAAGAAAAACTTAAAAA","TTAGCCAGGAGTGGTGGTGCACGCCTATAATCCCAGCTACTTGGGAGGCTGAGGCACAAGAATCACTTGAACCATTGCACTCCAGCCAGGGTGATAGAGGGAGACTCTATCCAAAAAAAAAACAAAAAA"
"GL873589","9993319","9993452","chr3","2774534","2774668","28","7218785","GGCCTGAGCCCTGTGACTCATGCCTGTAATCCCAGCACTGGAAGTTCCAAGGCAGGTGGATCGCTTGAGCTCTGGAGTTCAAGACCAGCTCAACCAAGAGTAAGACCCCATCTCTACTAAAAATAGAAAAACCA","GGCTGGGCACGGTGGCTCATGCCTGTAATCCCAGCACTTTGAGAGGCCGAGGCAGGTGGATCTCCTGAGGTCAGGAGTTCAAGACCAGCCTGGGCAACATGGTGAAACCCCATCTCTACTAAAAATACAAAAAAT"
"GL873590","9044589","9044884","chr1","83754525","83754835","84","74709936","GGCCAGGTGCAATGGCTCATGCCTATAATCCTCACACTCTGGGAGGCTGAGGCAGGAGGATCACTTTTCTCAGGGTCAGGGCCAGCCTGACAAAAGTCAGACCCTGTTTCTACTAAAAATAGAAAAACTAGCTGGGTGTTGTGGCAGATGCCTATAGTCCCAGCTACTAAGAGACTGAGACAAGTGCCCAGAGTCTGAGGTTACTGTGAGCAAAGCTGATGCCATAGCATTCTAGCTATAGATCGAGAGTCTGTCTCAAAAACAAACAAACAAACAAACAAACAAACAAAAAAGAA","GGCTGGGTGTGGTGGCTCATGCCTGTAATCCCAGCACTTTGGGAGGCCGAGGCGGGTGGATCATCTGAGGTCAGGAGTTCAAGACCAGCCTGACCAACATGGTGTAACCCTGTCTCAACTAAAAATACAAAAATTAGCTGGGCGTGGTGGTGTGCACCTATAGTCACAGCTACTTGGGAGGCTGAGACAGGAGAATTGCTTCAACCCAGGAAGTGGAGGTTGCAGTGAGCCAAGATCATGTCACTGCACTGCAGCCTGACAGAGCGAGACTCCATCTAAAACAAACAAACAAAAACAAACAAACAAACAAA"
"GL873591","1831505","1831587","chr17","61702818","61702899","25","59871313","CCCAGCACTTTGGGAGGGCAAGATGGGAGAATCATATAAAGTCAGGAGTTTGAGACCAGTTTGGCAGACATGATGAACCCATC","AATCCCAGCACTTTGGGAGGCTGAGGCAGGCGGATCATCTGAGGTCAGGAGTTCAAGACCAGCCTGGCCAACATGGTGAAAC"
"GL873591","2719175","2719275","chr4","86137755","86137847","32","83418580","GTGGGGGCTTAGGCCTGTAATCCCAGCACTCTGAGAGGCCAAGGTGAGCTGGTCACCTGGGTTTAGGAGTTTGGAGACTTGCTCGAGCTAGACTGAGGCTC","GTGGTGGCTCACGCCTGTAACCCTAACAATTTGGGAGGCCAAGGCAGGTGGATCACTTGAGGTCAGAAGTTTGAGACCAGCCTGGACAATATG"
"GL873591","4732974","4733120","chr19","7991801","7991954","55","3258827","ATACGCAGACTGGCCGAGCGTGGTGTCACATGCCTATAATCCCAGTGGCTACTCTGGGGAGGAGAATCTCTTGAAACCAAGAGTTAGAGATTGCAGTGGGGTATGATACAGGGTAACAAAGAGAGACCTTGGATCTGAAAAGAAAAA","AAAATACAGAAACTAGCTGGGCATGGTGATGCACACCTGTAATCCTAGCTACTGGGGAGGCTGAGGCAGGAGAATTGCTTGAACCCAGGAGTCAGAGGTTGCAGTGAGCAACCAGCCTGGGTGATACAGTGAGTGAGACTCTGTCTCGAAAAAA"
"GL873591","6822728","6823009","chr1","20579766","20580052","72","13757038","GGCCAGGCGTGGTGGCTCATGCCTGTAAATCTCAGCACTCTGGGAAGCTGAGGCAGGTGGATTGCTTGAGGTCAGGAGTTTGAGACCAGCCTGTACCAGAGTAAGACCCTGTCTCTAATAAAAATAGAAAAAAAAAAAAAAACTAGTTGGGCATGGTGATGGGTGCCTGTAGTCCCACCTACTTGGGAGGCTGAGGCAATGGCATCTCTTGAGCCCAAGAGTTTGAGGTTGCTGTGCCATGGCACTCTCCCCAGGGTAACAGAGTGAAAATAAAAAAAAGAA","GGCCAGGCGTGGTGACTCATGCCTGTAATCTCAGCACTTTGGGAGGCCGAGGCAGGTGAATCACCTGAGGTCAGGAGTTTGAGACCAGCCTGACCAACATGGTGAAACCTCGTCTCTACTAAAAATACAAAAAGTAGCCAGGCATGGTGGCGCATGCCTGTAATCCCAGCTACTTGGGAGGCTGAGGCAGGAGAATCGCTTGAACCCGAGAGGCAGAGGTTGCATTGAGTCAAGATGGTACCACTGCACTCCAGCCTGGGTGACAGATTGAGACTCAAAAAAAAAAA"
"GL873591","7578706","7578813","chr16","45055441","45055543","42","37476735","AAATTTAGCTACACATAGTGGCATGAGTCTGTAATGCTAGCCACCCAAAAGGCTGTAGTAAGAGGATTGCTCTATCCCAGGAGTTAAAGACCAGCCCGGACATCAGAG","AATTAGCCGGGCGTGGTGACACACACTTGTAATCCTAGATACTCAGGAGGCGAAGGTAGGAGAATTGCTTGAACCCAGGCAGCAGAGGTTGCAACGAGCAGAG"
"GL873591","9282916","9283004","chr1","20744253","20744338","16","11461337","GGCCAGGCGCGGTGGCTCACCCCTGTTGTCCCAGTTCTGTGGGAGGCCGAGGTGGGTGGATCACCTGTGCTCAGAGGTTTGAGACCAGC","GGCCAGGCACGGTGGCCACGCCTGTAATCCCAGCACTTTGGGAGGCCGAAGTGGGTGGATTACCTGAGGTCAAGAGTTTGAGACCA"
"GL873592","835155","835315","chr16","75654291","75654451","43","74819136","CTGGGTGTGGTGGCTCTTGTCTGCAATCTCAGTACACTGGGAGGCTGAGGCAGAAGGATTGCTCCAGCTCAGGAGTTTGAGGCCAGGCTGAGCTAGTGCAAAACCCCATCTCTACTAAAAAAAGAAGGAAAAAAAAAAGAAAAAGAAAAAAAATACGAGCT","CCAGGTGTGGTGACTCACGCCTGCAATCCCAGCACTCTGGGAGGCTGAGGTGGGTAGATTACCGGAGGTTAGGCGTTTGAGACCAGCCTGGCCAACATGGTGAAACCCCATCGCTACTAAAAAAAAAAAAAAAAAAAAAAAAAAAAAAAAAAAAAAAATTA"
"GL873592","835589","835765","chr1","66836166","66836336","48","66000577","ACAAAAAACCTAGCTTAGGGTTGTTATAGCACCTGTAGTCCCAGCTACTCAGGCGCTAAGGCAGGAAAATCTGCCTGAGCTCAGGAGTTTGAGGTTGCAGTAAGTTATGATGATGCTACTGCACTCTAGCTGGGGCAACAGAGTGAGACTCTGTCTGAGGAAAAACCAAAACCAAAA","TAGCCCAGCACGGTGGCTCACACCTGTAGTCTCAGCTACTCAAGAGGCTGAGGCATGAGAATCGCTTGAACCCAGGAGGTAGAGGTTGCAGTGAGCTGAGATCATGCCACTGCGCTCCAGCCTGGGCAACAGAGTGAGACTCAGTCTCAAAAAACAAAACAAAACAAAAAA"
"GL873592","2520661","2520705","chr16","66853217","66853257","11","64332556","TCTGGGAGGCTGAGGCGGGTGGATCACCTGAGCAAGAGTGAGACC","TTTGGGAGGCTGAGGCAGGTGGATCACTTGAGGTCAGGAGT"
"GL873592","4535248","4535388","chr1","12240468","12240612","38","7705220","GGCGGGATGTGGTGGTTCATGGCTGTAATCCCAGCACTCAGGGAGGCTGAGTCGGGTGGATTGCTTGAGTTCAGGAGTTTGAGACCAACCTGAGCAAGAACTAAGCCTGTCTCTACTAAAGATATTATTTCTTATTTTTCT","GGCCGGGCGCGGTGGCTCATGCCTGTAATCCCAGCACTTTGGGAGGCTGAGGCGGGTGGATCACCTGCGGTCAGGAGTTCGAGACCAGCCTGGCCAACGTGGTGAAACCTCATCTCTACTAAAAATATAAAAATTAGCTGGTGTG"
"GL873592","4535654","4535831","chr8","126054004","126054184","54","121518350","TCTACTACAAATATTAACAGAAAAATTAGCTGGGCATTGTGACAGGTGCCTATAGTCCCAGATACTCAGAAGGCTGAAGTAAGAGGATCACTTGAACCCCAGGAGCTAAGGTGGCTGTGAGCTAGGCTGAGGCTCTAGCCTGGGTAACAGAGTGAGACTGTAAAAAAAGAAAGAGAGA","GTCTCTACTAAAAATACAAAAATTAGCTGGGTGTGGTGGTGCATGCCTGTAATCCCAGCTACTCAGGAGGCTGAGGCAGGAGAATCGCTTGAACCCAGGAGGTAGAGGTTGCAGTGAGCCAAGATCATGCCACTGCACTCCAGCCTGGGTGACAGAGGGAGACTCTGTCTCAATAAATAAA"
"GL873592","6794968","6795049","chr3","154764711","154764794","20","147969743","GAAGGTTTGATGAGCTCAGATGATGCCACTGCAGTCTACCCAGAGTGAAGGAGCGAGACTCTGTCTCAAAAACAAAAAAAGA","CAGAGGTTGGCAGTGAGCTGAGACTGTGCCACTGCACTCCAGCCGGGTGACAGAGTGAGACTCTGTCTCAAATTACAAACAAAA"
"GL873592","6881384","6881478","chr5","24882384","24882475","28","18001000","GGGCAGGCATAGTGACTGGTGTCTCTAATCCTAGCAGTCTGGGATGCTGAGGCAAGTGGAATGTCAGAGTTCAGGAGTTGAAGATCACCCTGACT","GGCCGGGCGCAGTGGCTCACATCTATAATCCTAGCATTTTGGGAGGCTGAGGCAGGCGGATCACCTGAAGTCAGGAGTTTAAGACCAGCCTG"
"GL873592","6881755","6881937","chr10","61601371","61601572","66","54719616","TCACCCTGACCAAGAGCAAGACCCTGTCTCTACTAAAAATAGAATAAACTAGCTGGGAATTGTGGTGGGTGCCAGTAGTCCCCGCTACTGAGGCAGGAGGATCATTGAGTCCAAGAGTTTGAGGTTGCTGTAAGTTAGGACACCACAGCACTCTACACAGAGTAAGACTGCCTCAAAAATAAA","AGTAAAGAAAAGAAACCCTGTCTCTACTAAAAATACAAAAATTAGCTGGGTGTGGTGGTGCGCACCTGTAGTCCCAGCTACTTGGGAGGGTGAGGTATGGGAATCACTTGAACCCGGGAGGTGGAGGTTGCAGTGAGCCAAGATCACACCACTGCACTCCAGCCTGGGTGAGAGAGTGAGACTCTGTCTCAAGAAAAAAGAA"
"GL873592","7006080","7006155","chr1","8947061","8947129","24","1940981","CACACTGAGAGGCAAAGGCTGGTGGATCACCTGAGCTCAAGAGTTTGAGACCAGCCAAGCCAGAGATCTTGTCTCT","CACTTTGGAGCCAGGTAGGTGATCACCTGAGTCAGGAGTTCGAGACAGCCTGGCCAACATGTGAAACCC"
"GL873592","8446508","8446655","chr11","122502739","122502874","48","114056231","TTAGCTGGGTGTTGTGGCAGGCACCTGTAGTCCCTCCCAGCTACTTGAAAGGCTGAGGCAAGATGACAGCTTAAACCCAAGAGTTTAAGGTTACTCTATTCAGGGCAACAGAGTGAGACTCCATCTACATAAATAAATAAATAAATAA","GGCTGGGCGTGGTGGTTCACACCTGTAATCCCAACACTTTGGGAGGCTGAGGCCAGCGGATTGCCTGAGCCCAGGAGTTTGAGACCAACCTGGGCAACATGGTGAAACTCCATCTCTACTAAAATACAAAAAGTTA"
"GL873592","8446953","8447008","chr16","44513352","44513404","15","36066399","GACCAGCCTAAGCAAAAAAGAGATCCTATCTCTACTACTAAAAATAGAAAAAATTA","ACCAGCCTCACCAATATGAAGAAACCCCATCTCTACTAAAAATACAAAATATT"
"GL873592","8447239","8447325","chr1","8062863","8062957","21","384376","GGCCAGGAGCAGTGACTCATGCCTAGCACTCTGGGAGGCCAAAGCAGGTGGATCAACTGAGCTCAGGAGTTCAAGACCAGCCTAAGC","GGCCGGGTGCAGTGGCTCATGCCTGTAGTCCCAGGACTTTGGCAGGCCAAGGCCGGTGGATTACCTGAGGTCAGGAGTTCAAAACCAGCCTAGCC"
"GL873592","8723925","8724000","chr3","42066983","42067054","20","33343058","AATTAGCCGGGCATGGTAGTGTGTGCCCATAATCTCAGCTACTCAGAAAGCTAAGATAGGAAAATTGCTTGAGCTC","TTAGCTGGGTGTGGTAGTGCATGCCTATAATCCCAGCTACTCGGGAGGCTGAGGTGGGAGAACTGCTTGAAC"
"GL873593","384022","384146","chr15","102382935","102383070","28","101998913","GGCCACGAGGGCCCATGCCTGTAATCCTAGCACTCTGGGAGGCTGAGGTGAGTAGATTGCTGAGCTCAGGAGTTCAAGACCAGCCTGTGCAAGAGACCCCATCTCTGCTAAAAATAGAAAAACCA","GGCCAGGTGTGGTGGCTCACGCCTGTAATCCTAGCACTTTGGGAGGCTGAGGCGGGTGGATTGCCTGAACTCAGGAGGTCAAGACCAGCCTGGGCAACACAGTAAAACCCCATCTCTACTAAAATACAAAAAATCA"
"GL873593","384425","384607","chr20","28286874","28287058","50","27902449","GAAAGAAAAGAAAAGAAAAACTAGCAAGATGTTGTAGCTGATGCCTATAATCCTAGCTATTGGAGAGGTGGAGGCAAGAGAATTGCGTGAGCCCAAGAGTTGAAGGTTGCTGTGAGCTGCGATGCCAGAGCACTCCAGGGTGACAGAGTAAGACTCTGTCTCAAAAAAAATTACAAAATAAAA","TAATAAAAATAAAAAAATTAGCCAGGAGTCAAAGCACACGCCTATAACCCCAGCTACTTGGGAGGCTGAGGGAGGAGAATTACTTGAACCCGGGAGGTGAAAGTTGCAATGAGCTGAGATCAAGCCACTGCACTCCAGACTGGATGACAGAGTGAGACTCTGTTTCAAAAAAAAAAAAAAGACAA"
"GL873593","1408445","1408467","chr10","88070368","88070389","9","86661923","AATCTAGAGATGGGGAGAGGTTG","AAAGAGATGGAAGAGAAGAAGA"
"GL873593","4856365","4856484","chr7","56497314","56497433","31","51640949","GCAATCCCAGCTGATCGGGAGGCTGACCCAGAAGAATCCCTTGAACCCAAGAGTCTGAGGTTGCTATGGGTGGATTCTACAGCACTCTAGCCTGGGAGACAGAGTGAGACTCTGTCCCAA","ATCCCAGCTACTTGGGAGGCTGAGACAGAAGAATTGCTTGAACCCGGGAGGTGGAGGTTGCAGTGAGCCAAGATTGTACCACTGCACTCCAGCCTGGCAACAGAGTGAGACTCTGTCTCA"
"GL873593","6661298","6661485","chr10","86749316","86749514","55","80088018","GCAGAGGCTCACATATGTAATCCTAGCACTCTGGGAGGATAAGGCAGGTGGACAGCTTGAGCTCAGGGGTTTGACCAGTCTGATCAAGAGCAAGACCTGTGTCTACTAAAAATAGAAAACCTAGCCAGGTATGATGGTAGATGCCTGTATTCCTAGCTACTCTGGAAGCTAAAGCTAAAGAGTTTGAA","GGTGGCTCACACCTGTAATCTTAGCAATTTGGGAGGCCGAGGTGGGTGGATCACTTGAGGTCAGGAGTTTGAGACCAGACTGGCCAACATGGTGAAACTCTGTCTCTACTAAAAATACAAAAATTAGCCAGTCATGGTGGTGCATGCCTGTAATCCCAGCTACTCAGGAAGCTTAGGCAGGAGAATCACTTGAACCCAG"
"GL873593","6710263","6710446","chr14","4390080","4390244","66","2320183","TTGAAGTCAGGAGTTTAAGGCCAGTCTGGGCAACATAGTGAGACCCCCATCTCTACGAAAATATTTTTTAAAAATTAAAAATAGCTGGGCATAGTGAGGCTGTTGTGAGCTATAACTGCACCACTGCACTCAGCCAAGGACAGAGACCCTGTTCCCTGCCTCAAACAAACCAAAACAAAACAAA","AAGTCTAGAGTTTACAGCCTGGACAACGCAGTGAAACCCTGTCTCTACCAAAAATACAAAAATTAGACAGGTGTGAGAGGCGGAGGTTGCAATGAGCTGAGATCGCAGCACTGCAGTCCAGCCTGGATGACAGAGCGAGACCCCATCTCAAAAACAAAAACAAAA"
"GL873593","7159645","7159716","chr6","178318394","178318465","21","171158749","GATCATGTCACTGCTCTCCAACCTGGGCAATTGAGCAGGAATCTGTCTCAAAAAGAAAAAAAAAAAAGAAAA","CGAGTTCACACCACTGCACCCCAGCCTGGGCAACAGAATGAGACTCGGTTTCAAAAAAAAAAAAAAAAAAAA"
"GL873593","7159841","7160050","chr13","33368171","33368368","69","26208330","GGCCAGGCGTGGTGGCTCACACCTGTTGTCCCAGTGCTGTGGGAAGCCGAGGCAGGTGGATCACCTGAGCTCAGCCGAGTTCGAGACCAGTGGAAGACCAGCATGAGGCAGAGTGAGCCAGAGTGAGACCCCATCTCTACAACAACAACAAGAAGAAAAAAAACAGCCGGACCTTGTGATCCCAGCTACGTGGGGAGCTAGAGAATCACT","GGCTAGGCATGGTGGCTCATGCCAGTAATCCCACCACTTTGGGAGGCCGAGGCAGGTGGATCACCTGAGGTCAGGAGTTCAAGACCAGGCTGGCCAACATGTTATGATGAGACCCTCATCTCTACTACAAATACAAAAATCAGCTGGGCATGGTGGCAAGTGCCTGTAATCCCAGCTACTTGGGAGGCTGAGGCAGAA"
"GL873593","8598292","8598391","chr11","118461023","118461129","33","109862731","AGCCAGGTGAGGTGGTTCACACCTGTAACCCTAGCTGCTTGGGAGGCTGAGGCCTCTCTATCCTGGGCAGTGTGGAGAAACTTTGTTTCAAAAAAAAGAA","GCCGGGCGCGGTGGCTCACGTCTGTAATCCCAGCGCTTTGGGAAGCCGAGGCGGGACTATCCTGGCCAACATGGTGAAACCCCGTCTCTACTAAAAATACAAGAATC"
"GL873594","357249","357377","chr2","75702890","75703011","36","75345641","CCTGGTACCGTAGGTCATGCCTGTAATCCTAGCACTTTGGGATGCTGAGGTGGGCAGATTGCCTGAGCTCACGAGTTCAAGCCATTAGAACTGAGCCTGACCTAGAGTGGGACCTCCAACTCTTTTTTT","GCCAGGCACAGTGGCTCATGCCTGTAATCCCAGCAGTTTGGGAGGCTGAGGTGGGCAGATCACTTGAGGTCAGGAGTTCAAGACCAGCCTGGCTGACATGGTGAAACCCCATCTATACCAAA"
"GL873594","357656","357834","chr7","17608776","17608965","55","17251120","GGGACCTCCAACTCTTAAAATAGCTGGGCATTGTGGTGGGCACCTACAGTCACAGCTACTTGGGAGGCTAAGGCAAGAGACTTGTTTGCAGCCAAGAGTTAGAGGTTGCTGTGAGCTATGAGGCTAGGGCACTCTACAGGGGGCGACAAGTGAGACTGTAAAAAAAAAAAAAGAAAAAA","GTCCCTACTAAAAATACAAAAAATTAGCTGGGCCTGGTGGCAGGCACCTGTAATCCCAGCTACTTGGGAAGCTGAGGCAAGAGAATTGCTTGAACCCAGGAGGCAGAGGTTGCAGTGAGCTGACATCAAGCCACTGTACTCCAGCCTAGGCAACAAGAGCAAGACTCTGTCTCAAAAAAAAAAAAAAAAA"
"GL873594","1410711","1410996","chr5","151340503","151340797","76","149929792","CACAGTGGCTCATACCTATAATCCTAACACTCTGGGAGGCCAAGGTGGGTGGACTGTCTGAGTTTGGGACCAGCCTGAGCAAAAGCAAGACTCCCATCTCTACTAAAAACAAAGACAGCCAGGTATGAGGGCAGGTGCCTATCATCCCAGCTACTTGGGAGGCTGAGGAAGGAGGATCACCTAAGCCCAGGACTTTAAGGTTTCTGTGAACTAAGATGATGTTACAACACTCTAGCCAGGGTAACAAGGCAAGATTCTGTTTCAAAAGACAAAAAAAAAAAAAAAA","GGTGGTTCATGCCTGTAATCCCAGCACTTTGGGAGGCTGAGGCAGGTGGATCACCTGAGGTCAGGAGTTCGGGACCAGCCTGGCCAACATGGGGAAACCCCATCTCTACTAAAATACAAAAATTAGCCAGGTATGGTGGCACATGCCTATAATCCCAGCTACTTGGGAGGCTGAGGCAGGAGAATCACTTGAACCCAGGAGGCTAAGGTTGCAGTGAGCCGAGATTGTGCCACTGTACTCCAGCCTGGGTGACAGACTGAAACTCTGTGTCCAAAAAACAAAACAAAACAAAAAA"
"GL873594","5528090","5528162","chr2","69013639","69013718","24","63485549","GGTACAGTGGCTCACGCTTGTGATCCCAGGTTGAGGTGGGTGGATCGCCTGAGCTCAGGAGTTGGATGCCAGC","GGTGTGGTGCCTCACGCCTATAATCCCAGCACTTTGGGAGGCAGGTGGATCACTTGAGGTCAGGAGTTTGAGAACAGCCT"
"GL873594","5834047","5834168","chr2","82491537","82491662","28","76657490","GGCTGGGCCCAGTAGCTCACGACTGTAATCCCAGCACTCTGGGAAGCTGAGGTGGGCGGATCACCTGAGCTCATAGGTTCGAGACCAGCTCCAGTTAGAGTGAGAGCCTGTCTCTAAAAATA","GGCTGGGCACAGTGGCTCATGCCTGCAATCCCAGCACTTTGGGAGGCTGAGGTGGGCAGATCACCTGAAGTCAGGAGTTCAAGACCAGCCTGGCCAACACAGTGAAACCCCATCTCTACTAAAAAT"
"GL873594","5834396","5834461","chr13","14688151","14688212","20","8853755","TATATAATAATAATAACCAGGTATTGTGGCAGGTGCCTCTAGTCCCAGCTACTCGGGAGGCAAAGG","ATAAAAAAATTAGCTGGCCATGGTGGCACATACCAATAATCCCAGCTACTCAGGAGGCTGAG"
"GL873594","7786130","7786294","chr14","12217087","12217250","37","4430957","GGGTGTGCTGGCTCATACCTATAATCCTAGCACTCTGGGAGGCTGAGGTAGGTGTATTGCTTGAACCCAGGAGTCTGAGGTTGCTGTGCGCTAAGCTGATACCATAGCACTCTAGCCTGGGCAACAGAGTGAGACTCTGTCTCAAAACAAATAAATAGTAAAAAA","GCTGGGCGTGGTGGCTCACACCTGTAATCCCAGCACTTTGGGAGGCCAAGGCATGAGAATTGCTTGAAAACAGGAGGCGGAGGTTGCAGTAAGCTGAGACTGTGCCATTGCACTCCAGCCTGGGCAACAAGAGTGAAACTCTGTCTCAGAAAAAAAGAAAAAAA"
"GL873595","723579","723774","chr19","6045933","6046125","65","5322354","GCCTGAGCAGGAGAGAGACCCCATCTCTGCTGAAAGTGGAAAAGTTGGCTGAGTGTAGTGGCGGGCTGCTGCCCCAGTCACTCAGGAGGCTTAGGAAGGAGTATCGCTTGGGCCCAAGATTTGAGGTTGCTGTGAGCGCTACAAAGACATTAGGGTACTCTACACAGGGGAATAGAGTGAGACTGTCTCAAAAAAA","CAACATGGAGAAACCCCGTCTCTACTAAAAATACAAAATTAGGCAGCGTGGTGGTGGGTGCCTATAATCCCAGCTACTCAGGAGGCTGAGGCAGGAGAATCGCTTGACCGGGAGTGGAGGTTGCGGTGAGCTGAGATTGCACCATTGCACTCCAGCCTGGGCAACAAGAGTGAAACTCCGTCTCAAAAAGAAA"
"GL873595","724114","724204","chr20","18199749","18199840","22","17475635","GGCCATGCTTGGTGGTTCTCATCTGTAATCCTAGCACTCTGGAAGGTCTACAGGGGTGGATGGCTGGAGGTCAGGAGTTCAAGACTGGCCT","GGCCGGGCATGGTGGCTCACACCTGTAATCCCAGCACTTTGGGAGGCTGAGGCAGGCGGATCACCTGAGGTCAGGAGTTCGAGACCGGCCTG"
"GL873595","1065346","1065667","chr18","10529729","10530057","74","9464383","GGCCAGGTGCAGCAGCTCATGCCTGGAATCTTCCTGCTCTGTATGGCCAAGGCAGGTGGATCGCCTGACCTCAGGAGTTCCAGACCAGCCTGAACAAGAGCAAGACTCTGTCTCTACTAAAAGTAGAAAAAAAACTAGCCAGTCATAGTGGCAGGTGCCTGTAGTCCCAGCTGCTTGGGAGGCTGAGGCAAGAGGATCACTTGAACCTAAGAGTTTGAGGTTGCTGTGAGCTAAGATGCCACATCACTCTATCAAGGGTGACCAAGTGAGACTCTGTCTCAAAAATAAATAAATAAATAAATAAAAAGAAAGGCAAAAAGAA","GGCCCGGCGTGGTGGCTCATGCCTATAATCCCAGCCCTTTGGGAGGCCAAGGCAGGTGGATCACCTGAGGTCAGGCGTTCGAGACCAGCCTGACCAACGTGGTGAAACCTCATCTCTACTAAATACAAAAAAAATTTAGCCAGGCATGGAGGCACATGCCTGTAATCCCAGCTACTTGGGAGGCTGTGGCAGGAGAATCACTTGAACCTGGGAGGTGGAAGTTGCAGTGAGCTGAGATTGTACCACTGCACTCCAACCTGGGTGACAAAGCAAGACTCGGTCTCAATAAATAAATAAATAAATAAATAAATAAATAAAGTGAAAAAAAA"
"GL873595","1254878","1255146","chr4","42822326","42822607","67","41567448","GGCTGGGCATGGTGGCTCATGCCTGTAATCCTACCGCTCTGGGAGGCTGAGGCAGAGGATCACTTGAGCTCAGGAGTTTCAGACCAGCCTGCAAGAAGGACCCAGTCTCTGCCGAAAATAGAAAAGTTAGCAAGGCGTTGTCGTGAGCACATGTATCCCAGCTACCTAGAACTCTGAGGCAGGAGGATCCCTTGAACCCACAGAAGTTGCTGTTATCTAAACTGATGCCACTGGACTCTAGCCTGGGCAACAGAGTGAGACTGGTCTCA","GGCCGGGCACGGTGGCTCATGCCTGTAATCCTAGCATTTTGGGAGGCTGAGACAGGCAGATTGCCTGAGCTCAGGAGTTCAAGACCAGCCTGGGCTAGATTGTGAAACCCCATCTCTACTAAAATATAAAAATTAGCTGGGTGTGGTGGCACACGCCTGTAATCCCAGCTACCTGGGAGGCTGAGGCAGGAGAATCGCTTGAACCAGGAGACAGAGGTTGCAGTGAGCTGAGATCACGCCACTGCACTTTAGCCTGGGCAACAGAGTGATACTCTGTCTCAA"
"GL873595","3417105","3417297","chr12","115674238","115674427","44","112257133","GGCCGGGCGCTGTGCCTCACGCCTGTAATCCTAATACTCTGAGAGGCCGAGGCAGGTGGATTGCCTGAGCTCAGGTGCTCAAGACAGCCTGACTGAGCAAGCCCTGAGATCCCATCTCCACTAACAATAGTAAAACTAGCCGGGCATTGTGGTGGTGCTTGTAATCCCAGCTACTGGGAGGCTAAGACAGGAG","CCAGGCCTGGTGGCTCACGCCTGTAATCCCAGCACTTTGGGAGGCCGAGGTGGGTAGATCACCTGAGGTCAGGAGTTCAAGACCAGCCTGGCCAACATGGCGAAACCCCATCTCTACTAAAAATACAAAAATTAGCTGGGCATGGTGGTGTATGCCTGTAATCCCAGCTACTCGGGAGGCTGAGGCAGGA"
"GL873595","6098380","6098457","chr3","87492619","87492702","21","81394239","GCTGTGGCTCATGCTGATAATACCAGCACTCTGGGAGAACAAGGTAGGCAGATCACAAGAGGTCACCTGTGCAAGACC","GGGCTGGTGGTGGCTCATGCCTGTAATACCAGCACTTTGGGAGGCCAAGACAGGTGGATCACCAAAGGTCAAGAGTTCAAGACC"
"GL873596","134190","134307","chr1","203207333","203207443","31","203073143","GGCTGGGCGAGGTGGCTCACACCTGTAATCCTAGCACTCTGGAAGGCCCTAGCACTCAGGCAGTTGGATTGCCTGAGCTCACAAGTTCAAGACCAGCCTGAAAAAGAGCAAGACCTCA","GGCTGGGTGCAGTGGCTCACACCTGTAATCCCAGCACTTTGGGAGGCCGAGATGGGTGGATCACTTGAGGTCAAGAGTTGAAGACCAGCCTGGACAACATGATGAGACCCC"
"GL873596","134578","134681","chr11","50235285","50235387","37","50100707","CAAACAAAAGAGGAAGACCTCGTCTCTAAAAAAATAGCTGGGCATTGTGAGGAGTACCTGTAGTCCTAGCTACTCAGAAGGCTGAGACAAGAGAATCACTTAAA","CAACATTGTGAAACCCTGTCTCTACTAAAATAGAAAATTAGCCAGGTGTGTGGGCGTGCCTATAATCCTAGCTACTGGGGAGGGTGAGGCATGAGAATCGCCT"
"GL873596","8160215","8160350","chr1","29437872","29437991","30","21277657","GGCCGGGCGTGGTGGCGCACACCTGTAGTCCCAGCGCTATGGGAGGCCGAGGCGGGTGGATCACCTGAGCTCAGAGGTTCGAGACCAGCCAAGACCCCCCTGAGCCAAACGAGCCAGAGTGAGACCCCGTCTCTAC","GGCCGGGCGTGGTGGCTCACGCCTGTAATCCCAACATTTTGGGAGGCCAAGGCGGGTGGATCACCTGAGGTCAGAAGTTCGAGACCAACCTGGCCAACATGGTGAAACCCCTGTCTCTAC"
"GL873596","8421071","8421132","chr20","1874027","1874093","12","6547044","GTCAGGCGCAGTGGCTCACGCCTGTAATCTCAGCACTCTGAGAAGCCAAGGCAGGATCATCT","GGCCAGGCGCAGTGGCTCAGGCCTGTAATCCCAGCACTTTGGGAAGCCAAGGTGAGCAGATCACCTG"
"GL873598","4416400","4416489","chr5","39418145","39418231","15","35001745","GGCCAAGTGTGGTGGCTCATGCCTGTTGTCCCAGCACCGTGGGAGGCCGAGGCTGGTGGAACACCTGAGCTCAGCTGAGTTTGAGACCAG","GGCCAGTTGCGGTGGCTCATGCCTGTAATCCCAGCACTTTGGCAGGCTGAGGCAGGTGGATCACCTGAGGTCAGGAGTTTGAGACCA"
"GL873598","4416855","4416947","chr3","94091253","94091337","31","89674398","GTGAGACCCTGTCTCTACAAAAAAAAAAGCTGGGCACTGTGGCATGTGCCTGTAATCCCAGCTACTTGGGAGGCAAAGGGAAAGAGAATCACT","AAACCTTGCCTTTACTAGAAATACAAAAATTAGCTGGGCATGGTGGCAGGTACCTGTAATCCCAGCTACTTGGGAGGCTGAGGCA"
"GL873598","5126074","5126161","chr1","12339306","12339394","19","7213232","GCCTGGTGCACTGGTTCACACCTGGAATCCTTGCATTCTGAGAGGCCCAGGTAGGCAGATCACCTCAGCTCAGAAGTTCGAGACCAGC","GCTGGGTGCGGTGGTTCACGTCTGTAATCCCAGCACTTTGGGAGGCCGAGGCGGGCAGATCACCTGAGGTCAGGAGTTCGAGACCAGCC"
"GL873598","5467584","5467662","chr1","9313328","9313403","17","3845744","GCGAGGTGGCTCACGCCTGTAATCCCAGCACATTTGGAAGGCCAAGGAGGGTGGATCACCCGAGCTCACCAGTTGGAGA","CGCAGTGGCTCACGCCTGTAATCCCAGCACTTTGGGAGGCCGAGGCAGGCAGATCACCTGAAGTCAGGAGTTTGAG"
"GL873598","6917752","6917856","chr14","9558287","9558382","22","2640535","GGCCAGGCATGGTGGCTTGTGCCTGTTGTCCCAGCACTGTGGAAGGCCGAGGCGGGTGGATCGCCTGAGCTCAGCTGAATTCGAGACCAGCATAAGACCAGTATG","GGCCAGGCATGGTGGCTTATGCCTGTAATCCCAGCACCTTGGAAGGCCGAAGCGGGCAGATCACCTGAGCTCAGGAGTTTGAGACCAGCCTGTCCA"
"GL873598","8078910","8079062","chr7","164825511","164825660","43","156746601","AACAGCCAGGCATTGTGGTGGGCACCTGTAATCCCAGCTACTTGGGAGGCTGAGGCAAGAGAATTGCTTGAGCCCAACAGTCTCAGGTTACTGTGAGTTATGACACCATGGCACTCTATTGAGGGCAAGAAAGTGAGACTGTCTTGGAAAAAA","CTAGCCAGGCATGGTGGTGCGCACCTGTAGTCCCAGTTACTTGGGAGGTTGAGGCAAGAGAATTGCTTGAGCCTGGAAGGCAGAAGTTGCAGTGAGCTGAGATCACACCACTGCATTCCAGCCTGGGCGAAAGAGCAAGACTCTGTTGAA"
"GL873598","8079328","8079454","chr6","10381248","10381379","32","2301920","GCCCGGCGTGGTGGCTCACGCCTGTAATTCCAGCACTCTGGGGAGGCCGAGGAGGGCAGATTGCCTGAGCTCACAGGTTTGAGCTAGAGCGAGACCCTGTCTCTTAAAAAGAAAAAAAAGGAAAGAA","GCTGGGCGCGGTGGCTCACGCCTGTAATCCCAACACTTTGGGAGGCCGAGGCGGGCAGATCACCAGAGGTGATCTCCAGCCTGGGCAGGAGAGCAAGACCCTGTCTCAAAAAATTTAGAAAAAGGAAAGAAA"
"GL873599","3943256","3943456","chr9","35892110","35892312","79","31948854","GGCAGGCTGCTTTGACCCATATCTACAACTCCAGAACTTTAGAGGCTGAGCTGGGTGGGTCCCTTGAGATTAGAAACTGCTTAGTAGCCTGGCAAAAACCAGACCCCACCTCCACCATGTAGAAAAATTAGCAGTATGCCATAGTGGGAACCTACCAATACAGTCTTTCCAAAGGCCAAAGCTAGAAGGACCGTGAGCTTG","GGCTGGGTGTGGTGGCTCATGCCTATAATTCCAGCACTTTGGGAGGCCGAGGCAGGTGGATCACCTGAGGCCAGGAGTTTGAGACCAGCCTGGCCAATATGGTGAAACCCCATCTCTACTAAAAGTACAGAAAATTAGTCAGTCATGATGGCGCATGCCTATAATCCCAGTTACTCGGGAGGCTAAGGTAGGAGAATTGCTTG"
"GL873599","6693284","6693349","chr1","100916857","100916922","15","94223573","TCACGTCTATAATCCTAGCACTCTGGGAGTCCTTGGCAGGTGGATCACCTGAGCTCAGGAGTTTGA","CATGCCTGTAATCCCAGCACCTTGGGAGGCCAAGGTGGGTGGATCACCTGAGGTCAGTAGTTTGAG"
"GL873600","991618","991705","chr15","13850109","13850195","15","12858491","GGCTGGGCGTGGTGGCTCACACCTGTTGTCCCAGCGCTGTGGGAGGCTGAGGCAGGTGGATCACCTGTGCTCAGAGGTTGAGACCAGC","GCCGGGCGCTGTGGCTCACACTTGTAATCCCAGCACTTTGGGAGGCTGAGGCAGGTGGATCACCTGAGGTCAGGAGTTAGAGACCAG"
"GL873600","8825981","8826014","chr16","43605817","43605844","11","34779836","AGTCTGGGGCAACAGAGCAAGACTCTGTCTCAAA","CAGTCTGGGTGACAGAGCAAGATTCCAT"
"GL873600","8826039","8826157","chr13","87428402","87428520","35","78602363","ATTAGCCTGGTGTGGTGGTATATGCCTTCCTGCCTGCTTGGGAGGCTGAGGCAGGAAGTATGCTTTAACTGTGGAGTCTGAGGTTGCTATGAGCTAGGTTGAGGCCATGGCACTCTAAA","TTAGCCGGGTGTGGTGGTGCACGCCTGTAATCCCAGCTACTCAGGAGGCTGAAGCAGGAGAGTTGCTTGAACCCAGGAGTTGGAGGTTGCAGTGAGCTGAGATCACGCCATTGCACTCC"
"GL873601","269289","269338","chr14","49279240","49279285","14","49009951","GACTGGGTGTGGTGGCTCACACCTTTAATCCTAACACCCTGGGAGGCTTA","GGCTGAGATGGTGGCACACACCTGTAATCCCAGCTACTTGGGAGGC"
"GL873601","269431","269678","chr1","184453273","184453521","76","184183842","AGAAGATCACTCAAGATCAGGAGTTTGAGAACAGCCTGAGCAAGACCCCCATCTTTACTAAAAATGGAAAAGTTTTTACCCAGGCATGGTAGTGCGTGCCTGTATCCCATCTACTCCGGAGGCTGATAGGAGGATTGCTTCAACCAAGGAGTTTGAGGTTCCAGAGACTTAAGATGACACAACTGCATTTTACCCAGTGTGACACAGCGAGACTCTTTCAGAAGAATTTTTAAAAGGAAAAAAAAGAA","GGTCAGATCACCTGAGGTCAGGAGTTTGAGACCAGCCTGACCAACATGGTAAAACCCCATCTCTGCTAAAAATACAAAAAATTAGCCAGGCATGGTGGTGAACGCCTGTAATCCTAGCTACTCAGGAGGCAAAGACAGGAGAATCGCTTGAATCTGGAAGGTGGAGGTTGCAATGAGCCAAGATGACGCCACTGCACTCCAACCTGGGTGACAGAGGAAGACTCCATCAAAAAAAAAAAAAAAAAAAAA"
"GL873601","1397978","1398117","chr16","24839455","24839591","34","23441477","GCCTATAATCCTAGCACTCTGGAAGGCTGAGGCAGGAAGATCACTAGAGCTTGGGAGTTTGAGATTGCTGTGAGGGAGACTGACTCCATGGCACTCTAGCCTGAGGCAACAGAGTAAGACTCCATCTCAAAAAAAAAAAA","CTCTAACTCCAGCTACTCAGGAGGCTGAAGCAGGAAAATCACTTGAACCTGGGAGGTGGAGGTTACAGTGAGCCAAGATCACACCATTGCACTCCAGCCTGAGCGACAGAGCGAGACTCTGTCTCAAAATAAATAAA"
"GL873601","4065502","4065590","chr11","108711352","108711444","19","104645850","GCTGGATGTGGTGGCTCTCACCTATAATCCTAGCACTCTGGGAGGTCAAAACAGGTGGATCACCTGAGCTCAGGAGCAAGAACACCAGC","GTCAGGGGTGGTGGCTCACGCCTGTAATCCCAGCACTTTGGGAGGCCAAGGCAGGTGGATCGCCTGAGCTCAGGAGTTCAAGACCAGCCTTGC"
"GL873601","8241370","8241465","chrY","9469734","9469829","34","1228364","AAAAAAGGTGGAGATGAGCCATGCGCAGTGGTGTAGGCCTGTAATCCCAGCCCTTGGGAGGCCAAAATGGTGGATTGCCTGAAGCAGAGCAAGACC","AAAGTACAAAGAGTCTGGGTACAGTGGCCCAAGCCTGTAATCCCAGCAGTTTGGGAGGACAAGATGGGTAGATCACCTGACATCATGAATTAGAGA"
"GL873569","7519122","7519191","chrX","79016364","79016431","16","71497242","TTGGCCAGGCATGGTCGCTCAGGCTGTAATACCAGCTACTTGGGAAGCTGAAGCAGGAGGATCACTTGAA","TTGGCCAGGCACGGTGGCTCATGCTTATAATCCCAGCTACTCGTGAGGCTGAGGCAGGGGAATCGCTT"
"GL873569","7989158","7989286","chr8","41505677","41505810","35","33516519","AGTCCCACCTATTTGGAAGGCTGAGGCAAGAGGATCACTTGAACTCAGCAGTTTGACATTGCTATGAGTTAGATTGACTCCATGGCACTCTAGCCCAGGCAACAGAGCAAGACTCCGTCTCAAAACAAA","TAATACCAGCTACGTGGGAGGCTGAGGCAGGAGAATCACTTGAACCCGGGAGGTGGAGGTTGCAGTGAGCTGAGATTGCACCGTTGCACTCTAACCTGGGCAACAAAAGCAAAACTCTGTCTCAAAAAAAAAAA"
"GL873569","7989575","7989702","chr1","62231025","62231129","47","54241450","GGCTGGGTAATGCAGTGGCTCACGCCTATAATCCTAGTGCTTTGAGAGGCCAAGAGTGAGACTCTGTGTACTAAAAATAGAAAAATTACCTAGGCATTCTGGTGGGCACCAGTAGTCCCACCTATTTG","GGCTGGGCATGGTGGCTCACGCCTATAATCCCAGCACTTTGGGAGGCCGAGGCAGGTGGATCACCTGAGATCAGGAGTTTGAGACCAGACTGGCCAACATGGTGA"
"GL873569","10034363","10034556","chr10","61268396","61268605","62","51234033","CAGCTTGAGCAAAAGTGAGCCCCTGTCTCTACTGAAAATAGAAAAAATTAGCCAGGCGTGGTGGCACACACTTATAGTCCCAGCCACTTAGGAGGCTGAGGCAGGAGTTTGAGGTTGACATAATCTAAGCTGATACCATAGCACTCTAGCCTGGGCAATAGAGTGAGACTCTGTCTCAAAGAAGAAATTTATCT","CCTGACCAATGGTGAAACCCTGTCTCTACCAAAAATACAAAATTTAGCTGGGCATGGGGGCACGCACCTGTAGTCCTAGCTACTCGGGAGGCTGAGACAGGAGAACTGCTTGAACTCGGGAGGCAGAGGTTGCAGTGAGCTGAGATCATGCCACTGCACTCTAGCCTGGGCAATAGAGTGAGACTCCGTCTCAAAAAAAAAAAAAAAAAA"
"GL873569","10034830","10034845","chr1","217667782","217667796","2","207632952","AAAAAAGAAGAAAAAA","AAGAAAAAGAAAAAA"
"GL873569","10203815","10203922","chr8","96374555","96374671","35","86170740","GCCAGGTGTAGTGGTTCACACCTATAATCCTAGCACTCTGGGAGCCTGAAGCAGGTAAATGGACTGAGCAAGAGTGAGACTTCCACCTCTATTGAAAATAGAAAAATT","GGCTAGGTATGGTGGCTGATGCCTATAATCCCAGAATTTTGGGAGGCCGAGGCAGGCAGATCATCTGAGGTCAGGAGTTTGAGACCAGTCCCGTCTCTACTAAAAATACAAAAATTA"
"GL873569","10204196","10204373","chr20","1304385","1304559","47","8899811","GAAAATAGAAAAATTAGCCAGGCATTATAGCAGGCACCAGTAATCCCAGTTACTTGGGAGGCTAAGGCAAAAGAATCTCTTGAGCCCAAGTTTGGGGTTGCTAGGAAGTAAAACACCACAGCACTATACCCAGAACAAGAGAGTGAAGACTCAGTCTCAAAAAGATAAATAAATAAAA","AAAAATACAAAAATTAGCCAGGCATGGTGGCGGGCGTCTGTAACTCCAGCTACTTGGGAGACTGAGGCAGGAGAATCGCTTGAACCCAGGAGGCAGAGGTTACAGGTGAAATCACACCACTGCACTCCAGCCTGGGCAACAGGGCAAGACTCTGTCTCAAAAAAAAAAAAAAAAA"
"GL873569","10473375","10473444","chr8","20660648","20660717","21","10187273","TGTAGTCCCAGCACTTTGGGAGGTTAAGGCAAGAGTAGCACCCAACATGAGGAGATCAAGACCAATCTGG","CTGTAGTCCCAGCACTTTGGGAGGCTGAGGCAGGTGGATCCTTTGAGGGCAGAACTTTAAGACCAGCCTG"
"GL873570","9287350","9287485","chr1","29437872","29437991","30","20150522","GGCCGGGCGTGGTGGCGCACGCCTGTAGTCCCAGCGCTATGGGAGGCCGAGGCGGGTGGATCACCTGTGCTCAGAGGTTCGAGACCAGCCAAGACCCCCCTGAGCCAAACGAGCCAGAGTGAGACCCCGTCTCTAC","GGCCGGGCGTGGTGGCTCACGCCTGTAATCCCAACATTTTGGGAGGCCAAGGCGGGTGGATCACCTGAGGTCAGAAGTTCGAGACCAACCTGGCCAACATGGTGAAACCCCTGTCTCTAC"
"GL873571","3669989","3670207","chr4","116777080","116777297","60","113107091","AGACCAGCCTGAGGAAGAGCAAGATCCCATCTCTATTAAAAATAGAAAAATTAGCCAGGCATTCTGGTGGGCACCTGTAGTTCTAACCACCTGGGAGGCTAAGGCAAGAGGAACTCTTCAACCCAAGAGTTTGAGGTTGCTGAGAGCTAGGCTAAGGCTGCAGCACTCTAGCCTGGGCAACAGAGTGAGACTGTTTCTCAAAAACAAAAAACAAAAAAA","CGAGACCAGCCTGGTCAATATGGTGAAACCCCGTCCCTACTAAAAATACAAAAATTAGCCAGGCATGGTGGCAGGCACCTGTAGTCCCAGCTACTCGGAAGGCTGAGGCAGGAGAATCGCTTGAACCACAGAGGCAGAGGTTGCAGTGAGCCGAGACTGCACCACTGCACTCCAGCCTGGGCGACAGAGTGAGACTCAGTCTCAAAAAAAAAAAAAAA"
"GL873571","106134","106236","chr4","18143723","18143826","27","18037589","GGCCAGTCTCAGTGGCTCACACCTGTAATCCAGCATTCTGGGAGGCTGAAGCACACGGTCACCTGAGCTCAAAGGTTGGAGACCAGAGTGAGACCCCACCTCT","GGCCAGGCGCAGTGGCTCACTCCTGTAATCCCAGCACTTTGAGGCTGAGGCAGGCGGATCACCTGAGGTCAGGAGTTTGAGACCAGCCTGGCCGAAACCCCATC"
"GL873571","3670496","3670589","chr7","50468399","50468491","15","46797903","GGGCAGGCATGGTGGCTCACACCTGTAATTCTAGCACTCTTGGAGGCTGAGGCAGGAAAATGGCTTGAGGTCAGGAGTTCAAGACCAGCCTGAG","GGCCAGTCATGGTTGCTCACACCTGTAATACCAGCACTTTGGGAGGCCGAGGCAGGCGAATCACCTGAAGTCAGGAGTTCAAGACCAGCCTGG"
"GL873571","4059090","4059389","chr7","52903696","52903994","88","48844606","GGCCAGGTGCAGTGGTTCACACTTATAATCCTAGCACTCTGGGAGGCCGAGGCGAGTGAAGTGCCTGAGCTCATGGGTTCAAGACCAACCTAAGCCAGAGACCCCTGACTCTTATAATAGCCTGGCATTGTGGTGGGCGCCAATATTTCCAGCTACTCTGAGGCTAAGGCAAGAGAATTGCTTGAGCCCAGGAGTTGGAGGTTTCTGTGAGCACTGACGCCGCAGCTCTCTACCAAGGGCAACAAAGACTCTGTCTCAAAAAATAAATAAATAAATAAATAACAGAATGAAAATGAAAAA","GGCCGGGTGCGGTGGTTCACGCCTGTAATCCCACCACTTTGGGAGGCTGAGGCAGGCAGGTCACCTGAGGTCAGGAGTTCCAGACCAGCCTGGCCAACATGGTGAAACCTTGTCTCGGCTATTAGCCTGGCATGGTGGTGCGTGCCCATAATCCCAGCTACTCAGGAGGCTGAGGCAGGAGAATCGCTTGAACCCAGAAGGTGGAGGTTGCAGTGAGCCAAGATAGCACCACTGCAACTCCAGTCTGGGCAACAGAATGAGACTCTGTCTCAAAAAAAAAAAACAAAAAACAAAAAGAA"
"GL873571","4209418","4209704","chr11","32517699","32517985","80","28308281","GGCTTGGCAAGGTGGCTTACACCTCAAATCCTAGCACTGTGGGAGACTGAGGCAGGTGGATTGTTTGAGCTCAGGAGGTCAAGATAGAGAGCAAGAGCAAGTCTCTGTCTCTACTAAAAATAGAAAAGAACTACTTCCCGGGGGTCATGGCAGTAGCCTGTAATCCCAGTTACTAGGTAGAATGAGGCAAGAGGATCTGTTGAAGCCAAGAGACTGAGGTTGTTATGAGCATGCCACAGCACTCTACCCAGGGTGACAGAATGAGACTCTGTTGAAAGAAAAAAAGA","GGCCGGGTGCAGTGGCTCACACCTGTAATCCCAGCACTTTGGGAGGCTGAGGCGGGTGGATCACCTGAGGTCAGGAGTTCAAGACCAGCCTGACAAACATAGTGAAACCCTGTCTCTACTGAAAATACAAAATTAGCCAGGTGTGGTGGCGCATGCCTGTAATCCCAGCTACTCGGGAGGCTGAGGCAGGAGAATTGCTTGAATCCAGGAGGTGGAGGTTGTGTGATCACACCACTGCACTCCAGCCTGGGCGACAGAGTGAGACTCTGTCTCAAAAAAAAAAGAAA"
"GL873571","4209985","4210154","chr3","175781758","175781928","60","171571773","GAAAGAAATGAAAAGAAAGAAGTTAGCTGGTTGTTGGGGTATGCTTCTATAGTCCCACCTACTCAGAAAGCTGAAATCTGGAGTTTGGGGTTGTTGTAAGGTAGGCTGATGACATAGCACTGTAGCTTGGGCAAGAGAGTGTGACTTTGTCTCAAAAAAAATTAAAACAA","ATTAAAAACACAAAGATTAGCCAGGTGTGATGGCACACAACTGTAATCCCAACTACTCAGGAGAATCGCTTGAACCTGGGAGATAGGGTTTGCAGTGAGCCAAGATTGTGCCACTGCACTCCAGCCTGGGTGACAGAGTGAGACTCTGTCTCCAAAAAAAAAAAAAAAAAA"
"GL873571","4210444","4210570","chr17","16655655","16655789","35","12445211","GCCAGGCAGATGGCTCACACTTCATCCTAGCCCTCTGGAAGGCTGAGGCAGGCTAATTTTTTGAGGTTAGGAGTTTGAGACCAGCCTGAGGAAGAGACCCATCTCTACTTTAAAAAATAAATGGAAA","GCCAGGCATGGTGGCTCACACCTGTAATCCTAGCACTTTGGGAGACTGAGGCGGGTGAATCACCTGAGGTCAGGAGTTTGAGACCAGCCTGACCAGTATGGTGAAACCCAGTCTCTACTAAAAATACAGAAATTA"
"GL873571","4391733","4391878","chr11","33723808","33723943","46","29332075","AACTTAGCTGGGAATGGTGGCTCAAGCCTGTAATCCTAGCACTCTGGGAGGCTCAGGTGGGAGGATCACTTGAGGTTGCTGTGAGCTTGGCTGATGCCAGGACACTCTAGTGTGGGCAAGAGAGTGAGACTCCGCCTCAACAACAA","GCCGGGTGCAGTGGCTCATACCTGTAATCCCAGCACTTTGGGAGGCTGAGGTAGGCGGATCACGAGGTCAGGAGCTGAGATGGCGCCACTGCACCCCAGCCTGGGTGACAGAGCAAGACTCTGTCTCAAAAAAAAA"
"GL873571","6307773","6307841","chr9","62429628","62429694","22","56121855","CTGGGTGTGGTGGCATTGCACCTGTAATCCTAGCTACTTGGAAATCTTAAGCCCAGGAGTTGAAGACTG","CCCAGCATGGTGGTGCATACCTATAATCTCAGCTACTTGGAGGCTTGAGCTCAGAAGTTTGAGACCG"
"GL873571","6496217","6496306","chr1","27257765","27257856","27","20761548","GCAGGGTGTGTTGACCCACACCCACAATTCCAGGACTCTGGGGGGCCAGGGATGGTGGGTTCCCTCAGATCAGGAGCTCCTTACCAGCCT","GACTGGGCATGATGGCTCAAATCTGTAATTCCAGCACTTTGGGAGGCCGAGGTGGGTGGATTGCCTGAGATCAGGAGTTCAAGACCAGCCTG"
"GL873571","6499738","6499903","chr1","38976375","38976555","47","32476637","AAAATAACATGAATTGACTAGGCGAGGTGGCTCACATCTCTAATCCTAGCACTCTGGGAGGCTGAGGCAGGAGAATTGCATGAGGTTGCTGTGAGCTATGATGATACCACGGCATTCTAATCAGGGTGACAGAGTGAGATTCTGTCTTAAAACAAACAAACAAAAA","AAAATAAATAAATTAGCAGGGCCTGGTGGCGCACACCTGTAATCCCAGCTACTTGGGAAGCTGAGGCAGGAGAACCCACTTGAACCTGGGAGCCGGAGGTTGCAGTGAGCTGAGATGGCACCACTGCACTCCAGACTGCGTGACAGAGTGAGACTCCGTCTCAAAAACAAACAAACAAAAA"
"GL873571","11399575","11399872","chr15","109458692","109458994","79","98059117","CAGTGGCTCACACCTGTAAATCTAACACTCTGGGAGGCCAAGGTGGGTGGATCCCTTGAGCTCAGGAATTTGATACCAGCCTGAGCAAGAGTGAGACCTTGTCTCTACTAATAATAGAAAAATAGCCCGTGTTGTGGCACTTGTCCCAACCACTGGGGAGGCTTTAGGCGGGAGGATTACTTGAATTGGGAGTTTGATATTGCTGTGAGCTGGGCTGATGCCTTGGCATTCTAGCTTGGGTAACAGCGTAAGACTCCGTCTCAAATAAATAAATAAATAAATAAAAAGAAAAAAAGAA","GTGGCTCACACCTGTAATCTCAGCACTTTGGGAGACCGAGGCAGGTGGATCACCTGAGGTCGGGAGTTTGAGACCAGCCTGACCAACGTGGAGAAACCCCGTCTCTACTAACAATACAAAATCAGCTGGGCGTGGTGGTGCATGCTTGTAATCCCAGCTACTCGGGAGGCTGAGGTAGGAGAATCGCTTGAACCTGGGAGGTGGAGGTTGCGGTGAGCCGAGATCGAGCCACTGCACTCCAGCCTGGGTGACAGAGCAAGACTCCATCTCAAAAAAAAAAAAAAAAAAAAAAAAAAAAAAAAA"
"GL873572","114760","114841","chr8","26280134","26280211","16","26165374","GGCCAGGCATGGCGGCTCTTCCCTGTAATCCTAGCACTCTGGGAGGGCGAGGCAGGCAGATCACCTAGGCTAGGGTGAGATC","GGCCAGGAATGGTGGCTCATGCCTGTAATCCCAGCACTTTGGGAGGCTGAGGCAGGCAGATCACCTGAGGTCAGGAGT"
"GL873572","9421791","9421892","chr11","8089184","8089269","35","1332607","TACTAAATATATAGCAAGGCCAGGCACAGTGGTTCATGGCTGTAATCCCAGTACTCTGGGAGGCCTAGTCAGAGTTGACCTGAGATCAGGCTAGAAGCCTGG","ATAAAAATAATTGGAGGCCAGGCACGGTGGCTCATGCTTGTAATTCTAGCAATTTGGGAGGCTGACGCGGGTGAGATCATACTGAG"
"GL873572","11052834","11053035","chr14","11857478","11857657","65","804644","TCCACAAAGAAAGCAGAAGTGTGGCCGGGTGGTAGCTCAAGGCAGGAATCCCAGCACTCTGGGAGCTGGGAGGTGGGGGAGGATCCCTTGAGATCAGGAGTTGGAGGGCACAGTGAGCCTGGGGGAGGCCACTGTCTCTGTACTCTAGCAGGGAGACAGAGCAAGACTGCCCATTCAAAGAAAAACAACAAACAAAACAAAA","TACAAAAATTAGCTGGGCACGGTGCCACAAGCCTGTAATCCCAGCTACTCGGGAGGCTGGGCAGGGGAATAGCTTGAACCCAGAGGTGGAGGTTGCAGTGAGCCAAGATCAAGCCACAGCACTCCAGCCTGGGTGACAGAGCAAGACTCCATCTCAAAAAAAAAAAAAAAAAAAAAAAAA"
"GL873573","2564195","2564244","chr1","109985445","109985491","12","107421250","TACAAAAATTAGGCTGGGCTTGGTGGTTCACGCCTATAATCCTAGCACTT","ACTAAAATTAGCTGGGCATGGTGGTGCATGCCTGTAATTCCAGCTAC"
"GL873573","7423371","7423533","chr2","202783328","202783513","56","195359957","GGTGGCTCACACCTGTAATCCCAGCACTCTGGGAGCCCTGGTGGCTCATGTCTATAATCCTAGTACTCTGGGAGACCATGGTGGCTCATGTCTATAATCCTAGTACTCTGGGAGCCATGGTGGCTCACGCCTATAATCCTAGTACTCTGGGAGACCATGGTGG","GGCTGAGGCGCGGGGGCTCACGCCTGTAATCCCAGCACTGTGGGAGGCCGAGGCGGGTGGATCACGCCTGTAATCCCAGCACTGTGGGAGGCCAAGGCGGGTGGATCACGCCTGTAATCCCAGCACTGTGGGAGGCCGAGGCGGGTGGATCACGCCTGTAATCCCAGCACTGTGGGAGGCTGAGGC"
"GL873573","9657648","9657710","chr19","10207852","10207913","10","550204","TAAAAATAAAAAATTTAGCTGGATGTGGTGGCTCACACCTGTAATCCTAGCACTCTGGGAGAC","TAAAAATACAAAATTAGCTGGGTGTGGTGGCACACACCTGTAATCCCAGCTACTCAAGAGGC"
"GL873574","1624662","1624783","chr9","814961","815079","36","809701","GACTGGGTGGGTTGGATCATGCCTGGAATCCTAGCACCCTGGGAGGCCAAGGTGAAAGGATTGCTTGAGGTTAGGAGTTCCAGAAATGTAGCAGTCATGGTGACTTCATCCTTCTCTACCAA","GGCTGGGTGCTTTGATTCATGCCTGTAATCCCAGCACTCTGGGAGGCCGAGGCAGGTGGATCACCTGAGGTTAGGAGTTCGAGACCAGCTTGGCTAACATGGTGAAACCTCGTCTCTAC"
"GL873574","4459477","4459612","chr1","29437872","29437991","29","24978395","GGCCGGGCGTGGTGGCGCACGCCTGTAGTCCCAGCGCTATGGGAGGCCGAGGCGGGTGGATCACCTGAGCTCAGAGGTTCGAGACCAGCCAAGACCCCCCTGAGCCAAACGAGCCAGAGTGAGACCCCGTCTCTAC","GGCCGGGCGTGGTGGCTCACGCCTGTAATCCCAACATTTTGGGAGGCCAAGGCGGGTGGATCACCTGAGGTCAGAAGTTCGAGACCAACCTGGCCAACATGGTGAAACCCCTGTCTCTAC"
"GL873574","4681987","4682216","chr6","153082888","153083127","73","148400901","GGGTGCGGTGGCTCAGACCTATAATCCCAGCACTCTGAGAGGCCGAAGTGGGTGGATCACCTGAGCTCAGGAATTTGAGACCAGCCGTCTCTAAAAATAGCTGAGTGTTGTGGCAGTGGCTGTAAGTCCCAGCTGTTTGGAAAGCTGAAGCAAGGGAATCACTTGAACCCAAGAGTTTGAGGTTGCTGTGATGACAAAGTGAGACTCTATCTCAAAAAAAAAAAAAAAAA","GGCCGTGCGCGGCGGCTCACGCCTGTAATCCCAGCACTTTGGGAGGCTGAGGTGGGTGGATCACCTGAGGTCAGGAGTTTGAGACCAGCCCGACCAGAAATTAGATGGGTGTGGTGGTGCGCTCCTGCAGCCCCAGCTACTTAAGAGGCTGAGGCAGGGTAATCACTTGAACCCGGGAGGCGGAGGTTGCAGTGAGCCGAGCTCACGCCACTGCACTCCAGCCTGGGTAACAGAGCGAGA"
"GL873574","4709916","4710039","chr19","13152422","13152536","46","8442506","AAAAATAGAAAAACTAGCCAAGCATGGTGGTGCACCCCCTATAGTCTGAGCTCCTCAGCGGGCTGAAGCAAAAGGACGGCTGGAGCCCTGGAGTTTGAGGTTGCTGTGAGGCAAGGTGATGCCA","ACACATAAATTAGCCAGACATGATGGTGAGTATCTGTAATTCCAGCTCCTTGGGGGGCTGAGGCGGGAGAATTGCTTGAACCTGGGAGGCAGAGATTGCAGTGAGCCAAGATCGC"
"GL873574","6353839","6353913","chr5","25768079","25768163","22","19414240","AAAAATATAGCAAGGCCAGGCATGGTGGCTCACACCTATAATCCCAGTACTTGGGAGCTGGAATTTGAACCTAGG","AAAAAACTCAAACAAGGCTGGGCGTGGTGGCTCACACCTGTAATCCCAGCACTTTGGGAGGCTGAGGTGGGTGGATCACCTGAGG"
"GL873574","6533061","6533332","chr5","85182161","85182439","81","78649100","GGCTGGGCGAGGTGGCTTACACCTATAATCCTAGTACTCTGGGAGGCCAAGGTGGGTGGATTGCCTGAGCGCACAGTTTCAAGACCAGCTGGAGCCAGAGAGAGAGAGAGAGACCCTGCCTCTAAAAATAGCCAGGCATTGTGGCAGGCACCTGTAGTCCCAGCTACTTGGCAGGCGGAGGTATGAGAATCGCTAGAGGTTGCTGTTAGCTATGATGCCATAGCACTCTACCAAGGGCGACAAAGTGAAACTCTGCCTCAAAAAAAAGAAGA","GCCAGGCGTGGTGACTCAAGCCTGTAATCCTAGCACTTTGGGAGGCCAAGGTGGGCGGATTGCCTGAGCTCAAGAGTTTGAGACCAGCCTGGGCAACACGGTGAAACCCAATCCCTACTAAATACAAAAAAAATTAGCCGGGTGTGGTGGTGTGAACCTGTAGTCCCAGCTACTCGGGAGGCTGAGGCAGGAGAAGGCAGAAGTTGCAGTGAGCCGAGATCACACCACTGCACTCCAGCCTGAGTGACAGAGCAAAACTCTTTCTCAAAAAAAAAAAAA"
"GL873574","6643746","6643907","chr2","92627944","92628105","46","85984198","AAATAGCCAGGCGTTGTGGCAGGCACCTATAGTCCCAGCTACTTGGGAGGCTGAGGCAAGAGAATCACTTAAGCCCAAGTGACAGAGGTTGCCAGGGCACTCTACGTAGGCAACAGAGTGAGACTCTATCTAAGAAAGAAGGAAGGAAGGAAGGAGAAAGAA","TTAGCCGAGCATTGTGGTGCGCGCCTGTAGTCCCAGCTACATGGGAGGCTGAGGCAGGAGAACACCTGAACCCAGGATGTGAGCTGAGTCGCGCCATTGCACTCCAGCCTGGGCAACAGAGTGAGACTCCATCTCAAAAATAAAATAAAATAAAATAAAAAA"
"GL873574","6644163","6644274","chr1","128607504","128607619","20","121963341","CTGTAATCCTAGCACTTGGGAGGCTGAGGCAGGTGGATCACCTGAGTTCAGGAGTTCAAGACCAGCCTAAACAAGAGTGAGACCCTATCTCTACTAAAAATAGAAAAAATAT","GCCTGTAATCCAAGCACTTTGGGAGGCTGAGGCGGGTGGATCACCTGAGGTCAGGTGTTCGAGACCAGCCTGGCCAACGTGGTGAAACCCCAACTCTACTAAAAATACAAAAATTA"
"GL873574","8511822","8512127","chr1","23439759","23440073","84","14927937","GGTGGCTGGTGCCTGTAATCCTAGCACTCTGGGAGACTGAGGCAGGTGGATCACTTGAAATCAGGAGTTTGAGATCAACCTGAGCAAGAGATCTTGTCTCTCCTAAAGATAGAAAAACTAGCTGGGATTTGTGGTGGACACCTGTAATTTCAGCTACTCAGGAAGCTAAGGCAAGAGCATTGCTTAAAACCAGGAGTTTGAAGTTGATGTGAGCTAGGATGTCAGGGCAGGTTACCCAGGGTGACAGAGTGAGACTCTGTGTCAAAATAAACAAACAAACAAACAAACAAAACAAAATAAAATAAA","GGCTGGACATGGTGACTCACGCTTGTAATCCCAACACTTTGGGAGGCTGAAGCAGGCAGATCACCTGAGGTCAGGAGTTTGAGACCAGCCTGACCAACATGGTGAAACCTTGTCTCTACTAAAAATACAAAAATTAGCTGGGAGCAGTGGTGCACACCTGTAATCCCAGCTACTCGGCAAGCTGAGGCAAGATAATTTTTTAAACCTGGGAGGTGGAGGTTGCAGTGAGCCAAGATCGTGCCACTGTACTCCAACCTGGGAGACAGAGCAAGACTCTGTCTCAAAAAAAAAAAAAAAAAAAAAAAAAAAAAAAAA"
"GL873575","2107336","2107519","chr4","38052972","38053149","54","35945636","TCAATTAAAAACTTTTTAAAATGAGGCTGAGCATGGTGGTTCACACCTGTAATCCCAGCACTTTGGGAGGCCGAGGCAGGAGGATCACCTGATCCCAGGAGTCCAAGCCTACAGTGAGCCGTGATAATACCACTGCACTTCAGCCCAAAGCCTCAAAAAGAAAAAAAAAAAAGGATAGACAAGA","TATATATATATATATTATTTTGGGGGGGCATGGTGGTGCACACCTGTAATCCCAGCTACTCGGGAGGCTGAGGCAGGAGAATTGCTTGAGCCCGGGAGGCAAAGGTTGCATTGAGCTGAGATCACACCACTGCACTCCAGCCTGGCGACAGAGTCTCAAAAAAAAGAAAAAATAAAAA"
"GL873575","5831824","5831959","chr1","29437872","29437991","28","23606048","GGCCGGGCGTGGTGGCGCACGCCTGTAGTCCCAGCGCTATGGGAGGCCAAGGCGGGTGGATCACCTGAGCTCAGAGGTTCGAGACCAGCCAAGACCCCCCTGAGCCAAACGAGCCAGAGTGAGACCCCGTCTCTAC","GGCCGGGCGTGGTGGCTCACGCCTGTAATCCCAACATTTTGGGAGGCCAAGGCGGGTGGATCACCTGAGGTCAGAAGTTCGAGACCAACCTGGCCAACATGGTGAAACCCCTGTCTCTAC"
"GL873575","7451097","7451208","chr3","122814630","122814743","22","115363533","GGCCAGGTGTGGTGGCTCACACCTGTTATCCTAGCACTCTGAGAGGCCACAGCAGCTGGATCACTTGAGCTCAGGAGTTCAAGACCAGTCTGAGCAAGAGCAAGACCTCACC","GGCTGGGTGTGGTGGCTCATGCCTGTAATCCCAGCACTTTGAAAGGCCAAGGCAGATGGATCACTTGAGGTCAGGAGTTCCAGACCAGCCTGGCCAACATGGCAAAACCCCATC"
"GL873575","7451277","7451445","chr6","58863249","58863409","41","51411972","AAAAATTCAGCCAGCCACAGTGGAAGTGGATGCCTGCCATCACAGCTACTCTGGGGGCTGGGGCAAGAGAATTGCTTGATCCCAGGAGTCTGAGGTTGCTGTGACCTAGGCTGACACCACAGCACTCTACCCAGGGTGACAGAGTGAGGCTGTGTTTAAAAAAAAAAAA","TTAGCCAGGCATGGTGGCACATGCCAGTAATCCCAGCTACTCAGGAGGATGAGGCAGGAGAATCGCTTGAACCCAGGAGGCAGAGGTTGCAGTGAGCTGAGATTGCGCCACAGCACTCTACCCTGGGTGACAGAAGGAGACTCTGTCTCAAAAAAAAAAAA"
"GL873576","1765109","1765185","chrX","53921180","53921256","12","52156071","GGCCAGGTGCAGTGGCTCATATCTGTAATCCTAGCACCCTGGGAGGCCAAGGTAGGCGAATCACCTGAGGCCAGGAG","GGCCAGGTGCAGTGGCTCACGCCTGTAATCCCAGCACTTTGGGAGGCCGAGGTGGGCGGATCACTTTAGGTCAGGAG"
"GL873576","2711577","2711895","chr7","6620384","6620702","85","3908807","GGTCGAGCTTGGTGGCTCATGCTTGTAATCCTAGCACTCTGGGAGGCCAAGGCAGGTAAGTTGCCCTGAGCTCATAGGTTCCAGATCAGCATGAGCCAGAGTGAGACCCTGTCTCTACCAAAAAATAGCCCGGCATTCTGGCAGGTGCCTGTAATCCCAGCTGCTTGGGAGGCTGAGGCTAGAGAATCACTTAAACCCAAGGGTTAGTGGAGGTTGCTGTGAGCTATGATTCCACCGTACTCTACTGAGGGCCACAAAGTGAGACTCTGTCTCCATAAAAAAGAAAGAAAGAAAGAAAGAAAAATAAAATAAAATAAAA","GGCCAGGCACAGTGGCTCATGTCTGTAATCCCAGCACTTTGGGAGGCCGAGGCGGGTGGATTACCTGAGGTCAGGAGTTCTAGACCAGCCTGGCCAACAAGGCGAAACCCTGTCTCTACTAAAAATACAAAAAATTAGCTGGGCGTTTTGGCACATGCCTGTAATCCCAGCTACTTGGGAGGCTGAGGCAGGAGAATTGCTTGAACTGGGGAAGTGGAGGTTGCAGTGAGCTGAGATCACACCATTGCACGCCTGAGCAACAGAGCGAGACTCTGTCTCAAAAAAAAAAAAAAAAAAAAAAAAGAAAAGAAAAAGAAAA"
"GL873576","4782520","4782652","chr9","61136941","61137074","22","56354421","CCAGGCACGGTGGCTCACCCTTGTAACCCTAGTACTTTGGGAGGCTGAGGTGGGAGGATCCCTTGAGGTCAGGAGTTCAAGACCAGCCTGAACAACAGTGAGACCCCCGTCTCTACTAAAAAATAGAAAAGTT","GCCAGGCACGGTGGCTCACGCCTGTAATCCCAGCACTTTGGGAGGCTGAAGCGGGCGGATCACCTGAGGTCAGGAGTTCAAGACCAGCCTGGGCACCATGATGAAACCCCGTCTCTATTAAAAATACAAAAATT"
"GL873576","4782930","4783078","chr7","57521645","57521803","40","52738715","AGTTAGTCTGGTGTCATGGTGGGTGCCTGTAGTCCCAGCTGCTTGGGAGGCTGAGGCAAGAGAATCACTTGAGCCCAGGAGTTGGAGGTTGCTATGAGCGAGGCTGTAGCCTAGGCAACAGAATGAGACTTTGCCTCAAAAAAATAAAA","TTAGCTGGGCATGGTGGCGCATGCCTGTAGTCCCAGCTACTTGGGAAGCTGAGGCAGGAGAATCACTTGAACCTGGGAGGTGGAGGTTGCAGTGAGCTGAGATCGCACCGCTACACGCCAGCCTGAGCAACAGAGAGAGACTCTGTCTCAAAAGAAAAA"
"GL873576","7828709","7828723","chr5","101042981","101042996","1","93214272","TAAATAAATAAAAAA","TAAATAAATAAATAAA"
"GL873576","7828960","7829230","chr13","49045537","49045844","89","41216577","GCCGGCTGCAGTGGCTATAATCCAAGTACCCTGGGAGGCTTAGGTGGATGGATCACTTGAGCTCAGAAGTTCAAGACCAGCCTCAGCAAGAGGTAGACCTTGCCTCTATTAAANNNNNNNNNNNNNNNNNNNNNNNNNNNNNNNNNNNNNNNNNNNNNNNNNNNNNNNNNNNNNNNNNNNNNNNNNNNNAGTTTGAGGTTGCTGTGAGCTATGATGAAGCCAGGGCATTCTACCCAGGGTGACAGAGTAACTCTTAAAAAAAACTAAACAA","GGCCAGGCAGAGTGGCTCATGCCTGTAATTCCAGCAATTTGGGAGGCCTAGGCAGGCAGATTACCTGAGGTCAGGAGTTTGAGACCAGCCTGGCCAACATGGTGAAACCCCGTCTCTTCTANNNNNNNNNNNNNNNNNNNNNNNNNNNNNNNNNNNNNNNNNNNNNNNNNNNNNNNNNNNNNNNNNNNNNNNNNNNNNNGGAGATAATAGCTTTTGTAGAACGAAGCGATGCAACAGCCAGATCGCCGCCACCACCCTTAGGTCCTGGCGACAGAGTGAGATCCATCTTAAAAAAAAAAAAAAAAAAA"
"GL873576","10622840","10623093","chr7","60266447","60266705","74","49643607","GCTGGGTATGGTGGTTCACACCTATAATCCTAGCACTCTGGGAGGCTGAGGTGGGAGGATTGGTGGAGCTCAGGAGCTCATGAGGTGCCAAATCACTGGTGCCACACACCTGTATTCCCAGCTACTGAGGAGGCTGAGGCAGGAGGATCAGGTAAGCCCAGGAAGTTTGAGGTTGTAGTGAGTTAGGATGATTGAACTCTGCCTTGAGAGACAGAGCAAGATCCTCCTTCCTCCTAAGCAAACAAACAAATAAA","GGCTGGGTGCAGTGGCTCACACCTGTAATCCTAGCACTTTGGGAGGCTGAGGCGGGAAAATTGCCTGAGCTCAGGAGTTCAAGGACAGCCTAGGCAACATAGCATGGTGGTGCACGCCTGTATTCCCTGCTACTTGGGAGGCTGAGGCACAAGAATTGCTTGAATCCGGGAAGTGGAGGTTGCAGTGAGCCATTGTGGCACTGCTCTCCAGTCTGGGTGACAGAGCAAGACTCCATCTCAAAAAAAAAAAAAAAAAAAA"
"GL873576","10819939","10820007","chrX","67133632","67133707","21","56313693","AGGTTGCAGTGAAATTGTACCATTCCAATGAAGCCTGGGGGACAGAGTGAGATTCTCTCAAAATAAAAA","GGAGGTTGCAGTGAACCGAGATCGTGCCACTGCACTCCAGCCTGAGCGACAGAGTGAAACTTCGTCTCAAAAAAAA"
"GL873576","10920306","10920363","chr3","48261745","48261808","16","37341439","GCTGGACCTTGTAGAGAGTGCCTGTAATCCCAGCTACATGGGGGGCAAGAGAATTGCT","GCTGGGCATGGTGGTGCATGCCTGTGATCCCAGCTACTCAGGAGGCTGAGGCAGGAGAATTGCT"
"GL873576","10920398","10920529","chr10","67341428","67341546","30","56421030","GGCCAGGCGTGGTGGCTCACGCCTGTTGTCCCAGCACTGTGGGAGGCCGAGGTGGGTGGATTGCCTGAGCTCAGAGGAGTCCGGAAGACCAGCATGAGGCAGAGTGAGCCAGAGTAAGATCCTGTCTCTACC","GGCTGGGTGTAGTGGCTCATGCCTGTAATCCCAGCACTTTAGGAGGCCAAGGTGGATGGATTGCCTGAGCTCAGGAGTTCGAGACCACCCTGGGCAACAAGCCAAAACCCTGTCTCTAC"
"GL873577","515809","515961","chr7","137660778","137660931","43","137144969","AGCTGGGCATGGTGGCTCATGCCTATAACCCTAGCGTGCTAGGAGATTGCTTGTCAGGAGACTGAGGTTGCAGGAAACTGTGATGATGGCACTGCACTCTACCCAGGGTGACAGAGCAGGACTCTGCCTCAAAAAAAAAAAAAAAAATAGAAA","TTAGCTGGGCATGGTGGCGCATGCCTATAATCCCAGCTACTTGGGAGGCTGAGGCAAGAGAATCGCTTGAACCGGGGAGGCAGAGGTTGCAGACTGCACTCCAGCCTGTGTGACAGAGTGGGACTCCGTCTCAAAAAAAAAAAAAAAAAAAAAA"
"GL873577","1633164","1633256","chrX","38269524","38269615","26","36636360","TCAGCCAGGCATGGTGGCACTTGCCTATAAACCCAGCTCCTTGGGAAGCTGAGCCGGGAGGATCCCTTGCACCCAGGAGCAACGGAAGGCAGT","AATTAGCCAGGCATGGTGGCACATGCCTATAATCCCAGCTACTCAGAAGGTTGAGGCAGGAGAATCACTTGAACCTGGGAGGCAGAGGTTGC"
"GL873577","3979502","3979560","chr20","68909283","68909346","13","64929781","GAGTTTGAGACCAGCCTGAGCAAGACCGAGACCCAGTCTCTACTAAAAATAGAAAAATT","GGAGTTCAAGACCAGCCTGACCAACATGGAGAAACCCTGTCTCTACTAAAAAATACAAAAATTA"
"GL873577","3979839","3980009","chr10","31403126","31403287","39","27423287","ATGAGCAGATTGTCTTGGTGGGCACCTGTAGTCCCAGCTATTGGAGGTGGGAGGCTGAAGCAGGAAAATCTCTTGAGCCCAGGAGTTTGAGGTTGCTGTGAGCTAGGCTGACACCACGGCACTCTAGTCAGGGCGTCAGAGTGAGACTCCGTCTCAAAAAAAAAAAAAAAA","TTAGCTGAGTGTGGTGGCGCACATCTGTACTCCCAGCTATTTGGGAGGCTGAGGCAGGAAAATCGCTTGAACCCAGGAGGTGGAGGTTGCAGTGAGCCAAGATCACACTACTGCACTCCAGCCTGGGTGACAGAGTGAGAATCCATCTCAAAAAAAAGAAAA"
"GL873577","6050882","6051080","chr1","153219820","153220007","59","147168938","GGCTGGGCGTTGTGACTCATGCCTGTAATCCCAGCACTCTAGGAGGCCGAGGTGGGTGGACTGCCTGAACTCAGAGGTTTAAGACCATCCTGAGCCGCAGTGAGCCAGAGCGAGACCCTGTCTCTACCAAAAAAAGCTGGGTGTTGTGGTGGGCGCCTATAGTCCTAGCTACTTGAGGCGCTAAGGGTAAAAAAATTGC","GGCCTGGCACAATGGCTCACGCCTGTAATCCTAGCACTTTGGGAGGCCGGGGTGGGTGGATCACCTGAGATCAGGAGTTTGAGACCAGCCTGGCCAACATGGTGAAACTCCTTCTCTACAAAAATTAGCCAGGTGTGGTGGTGGGTACCTGCAATCCCAGCTATTTGGGAGGCTGAGGCAGGAGAATC"
"GL873577","8463965","8464050","chr9","52134422","52134508","19","43670457","CTGGGTGCTATAGCTCACGCCTATAATCCTAGCACTCTGGGAGTTTGGGGCAAATGGATCACCTAGGCTCAGGAGTTTGATACCAG","GGCTGGGAGCAGTGACTCACGCCTATAATCCCAGCACTTTGGGAGGCTGAGGCAGATGGATCACCTGAAGTCAGGAGTTCGAGACCA"
"GL873577","9471486","9471613","chr16","5178790","5178910","46","4292696","TTAGCCAGGCATAGTAGCCTGTGTGTAGTCCTAGCTACTCAGGAGGCTGAGGTAGATGGGTCACTTGAGGTTGCAGAGATTATGGTAATGTCACTGTACTCTAGCCCTGGCAACAGAGCACAACCCTG","TTAGCCGAGCCTGGTGGCATAAACCTGTAATCCCAGCTACTCAGGAGGCTGAGGCAGGGGAATTGCTTGAACCTGAGAGGAGAAGGTTGCAGTGAGCCGAGATTGCACCATTGCACCCCAG"
"GL873577","9471875","9471998","chr7","17832200","17832315","36","8360325","GGCCAGGTGAAGCAGCTCATGGCTATAATCCTAGCAGTTTGGCAGGCCAAGGTGGGAGGACTGCTTGAGGTCAAGAGTTCAAGACCAACCCATCTTTGCGAAAAATTTAAAAATTACCTAGGCA","GCCAGGAGAGGTGGCTCATGCCTCTAATCCCAGCACTCTGGAAATCCAAGGTGGGTGGATCACCTGAGGTCAGGAATTCCAGACCAGTCTGGCCAATATAAAAAATTAGCCAGGCT"
"GL873577","9853150","9853170","chr3","85044647","85044667","3","75191497","AAACAAACAAACAAAAAAAGA","CAAACAAACAAACAAACAAAA"
"GL873577","9853206","9853473","chr7","130818682","130818963","67","120965476","GCTGGGCGCAGCGTCTCACTCCTGTAATCCCAGCACTTGGGAGGCCAAGGTGAGTGGATTGCCTGAGTTTACAGTTTCGAGACCAGCCTGAGCCAAAGCGAGACCCCCATCTCTAAAAAATAGCTGGGCATTGTGGTGGGCACCTGTAGTCCCAGCTACTTGGGAGGCTGAGGCAAGAGGATCGCTTGAACCTAAGAGTTTGAGGTTGCTGTGAGCTAAGGCTCCATGGCATTCTACCAAGGGTGACTAAGTGAGACTCTGTCTAAAA","GCCGGGCACAGTGGCTCACACCTGTAATCCCAGTACTTTGGGAGGCCAAGGTGGGTGGATCACCTGAGGTCAGGAGTTTGAGACCAGCCTGGCCAACATAGTGAAACTCTACTAAAAATACAAAAAAATAGCTAGGCATGGTGGTGCGCACCTGTAATCCCAGCTACTTGGGAGGCTGAGGCAGGAGAGTTGCTTGAACCCAGCGGGGTTGAGGTTGCAGTGAGTTAAGATCAAGCCACTGTGCTCCAGCCTGGATGACAGAGAGAGACTCCATCTCAAAAA"
"GL873577","10722415","10722478","chr10","12501471","12501539","23","1779056","AATAAAAAAATGCTGGGTACAGTAGTACATGCCTGTACTCTCATCTGGGGAAGCTGAGGCATGA","AAAGTAAAAAATTAGAGCTGGGCATGGTGGCACACACCTGTAATCCCAGTCACTAGGGATGCTGAGGCA"
"GL873578","463331","463568","chr10","28935382","28935620","93","28472051","CAGGTGCTTTGACCCACACCCTCAACTCTAGGACTTTGGACGCCCTGGCTGGGTGGGTCCTTTAAAGTCAGGAGCTTCTTATCAGTCTGGGCAAAAGTGAGACCCCATCTCTACCAAACAAAGAAAGAAATCAGCAGTATGTTGCAGTAGAGACTCACCAATACCTTCTTTCAAAGACCAAAGCTGGAAGGACACTAAAGACCATGATCTCATGGCCTCCCTGAGCCATGACAATGCC","CCAGGTGCAGTGGCTCATGCCTGCAAGCTCAGAACTTTGGGAGGCAGAGGTGAGCAGACTGCCTGAGTTCAGGAGTTCAAGACCAGCTGGGCAACATGGTGAGACCCTATCTCTACTAAAAATACAAATAATTAGCAGGGTGTGGTAGCACACACCTGTAGTCCAGCTACTCAGGAGGCTGAGGCAGGAGAATTGCTTGAACCCAGGAGGCAGAGTTTGCAGTGAGCCAGGACTGGGCC"
"GL873578","1143712","1143827","chr11","52824583","52824692","30","51680871","GGCTGGGTGTGGTGCCTCATGCCTGTAATCTAAGCCCTCTCCGAGGCTGAGGTGGGAGGATCCCTTGAGTTTAGGAGTTTGATTTTGAGACCAGCCTGATCAAGAGAGAGACCTCA","GGCCGGGTGTGGTGGCTCATGTCTGTAATCCCAGCACTTTGGGAGGCTGAGGTGGGTGGATACCCTGAGGTCGGGAGCTCGAGACCAGCCTGACCAACATGGAGAAACCC"
"GL873578","1144101","1144139","chr3","33494224","33494257","11","32350123","GAGAGAGACCTCATGTCTACTAAAATAAATAAATATATA","GTGAAACCCGTCTCTACTAAAAATACAAAAATTA"
"GL873578","1144175","1144343","chr12","119519961","119520131","41","118375786","ATTATCCAGGCCTTCTGGTGGATGCCTGTAGTCCTAGCTACTAGAAAAGCTGGAGCAGAATCACTTGACCCAGGAGCTGGAGGTTGCAGGGAGCTAGGCTGATGCCACAGAATTCTAGCCTGAGGCAAAAGAATTGAGCCACTGTCTCAAAAAGGAACAAAAAAGAAAA","ATTAGCCAGGTGTGGTGGCATGCACTTGTAATCCCAGCTACTAAGAAGGCTGAGGCAGGAGGATCACTTGAACCCGGGAGGTGGAGGTTGCAGTGAGCCAAGATCATGCCACTGCACTCCAGCCTGGGCAACAGAGTAAGACTCTGTCTCAAAAAAAAAAAAAAAAAAAAA"
"GL873578","4593962","4594035","chr16","68825055","68825124","22","64231093","AGCTGGGTACAGTGGCTCACATATAATCCCAGTGACTCAGGAGGCTAAGACAGGAGGATTACTAGGACCTGAGA","GGCTGGGCACAGTGGCTCAGACCTGTAATCTCAGTACTTTGGGTGGCTGAGGCAGGTGGATCACCTGAGG"
"GL873578","6158845","6158972","chr3","500432","500562","24","5658413","GACATGGTGGCTCACACCTGTAATCCTAGCCCTCTGGGAGGCTGAGGCAGGTGGATCACTTGAGTTCAGGAATTCAAGACCAGCTTGAGTGAGAGCAAGACCCTGTCTCTACTAAAAATAGAAAAATT","GCACGGAGGCTCATACCTGTAATCCCAGCACTTTGGGAGGCTGAGGCAGGTGGATCACCTGAGGTCAGGAGTTCCAGACCAGCCTGGCCAACATGGCGAAACCCTGTCTCTACTAAAAATACAAAAAATCT"
"GL873578","6159253","6159444","chr19","34496349","34496541","55","28337096","ATAAAATAAAAATAGAAAAATTAGCCAGGCATTGTGGCAGACATGCGAAGTCTCAGCTACTCCAGAGGCTGAGACAGGAAGATTACTTGAGCCCAAGAATCTTGCTGTGAGCTAAGCTGATGCCATAGCATTGTAACCTAGGCAACAGAGTAAGACTTGGCCTCAAAAATAAAATAAAATAATAAAGTAAAA","TTAGTTAATTAAATTAAACTTAGCTAGGCATAGTGGAACACACCCATAGTCCCAGCTACTCTAGAGGCTGAGGCAGGAGGATTGCTTGAGCCAAGTTGGAGGCTGCAGTGAGCTATGGTGGTGCCACTGCATTCCAGCCTCAGTGACAGAGAGAGACCCTGGCTCAAATAATAATAATAAATAAATAAATAAA"
"GL873578","6766040","6766171","chr2","93098086","93098217","30","86332046","CCAGGCACAGTGGCTCATGCCTATAATCCTAGTAGTCTAGGAGGCTGAGGTGAGTGCATTGCTTGAGCTCAGGAGTTAGATACCAGCCTAACCAAGAATGAGACCCCATCTCTATTAAAAATAGAAAAGTTA","GCCGGGCACAGTGGCTCATGCCTGTAATCCCAGCACTTTGGGAGGCCGAGGCGGGCAAATCACGAGGTCAGGAGTTCAAGACCAGCCTGACCAATATGATGAAACCCCGTCTCTATTAAAAATACAAAAATT"
"GL873578","6766434","6766577","chr9","21128084","21128223","50","14361650","GTTAGCCAGGAGTTGTGGCGGGCACCTACAGTCCTAGCGACTCAGGAGGCTGAAGTAGGCAGAGTTTGATGTGTTGCTGTGAACTACAAGGACACCAATGCACTCTAGGCCGGTAACAGAGTGAGACACTGACTAAAAAAAAAA","TTAGCCAGGTGTGGTGGCACATGCCTGTATTTCCAGCTACTCGGGAGGCTGAGGCAGGAGAATTGCGTGAGCTGAGATCATGCCACTTCATTCCAGTCTGGGTGACAGAGTGAGACTCTGCCTCAAAAAACAAAACAAAA"
"GL873578","7397948","7398119","chr5","40230148","40230319","43","32832200","TAAAAATAGCCATGCATTGTGACAGGCACCTGTAGTCCCAGCTACTCAGGAGGTTGAGGTAAGAGAATCACTTGAACCCAAGAGTTTTGAGGTTGTTATGAGCTAAGACGCCTCGGGACTCTACAAAAGGTAACAAAGTGAGACTCTGTCTCATAAAAAAAGAAAAAAAGAA","AAAATTAGCCAGGCATGGTGACGTACACCTGTAGTCCCAGCTACTCGGGAGGCTAAGGCAAGAGAATCGCTTGAACCCAGGAGGCAGAGGTTGCAGTGAGCTTAGATCACGCTACTGCGCTCCAGCCTGGGTGACGGAGTGAGACGCCATCTCAAAAAAAAAAAAAAAAAAA"
"GL873578","7398378","7398515","chr15","102382935","102383070","35","94984557","GGTCGAGCAAGGTGGCTCACGCCTGTAATCCTAGCACTCTGTGAGGCTGAGGCAGATGGATTGCCTGAGCTCGTGGGTTCGAGACCAGCCTGAGCCAGAGTGAGACCTCATCTCTAAAAATAGCTGGGAAGCTGGGCA","GGCCAGGTGTGGTGGCTCACGCCTGTAATCCTAGCACTTTGGGAGGCTGAGGCGGGTGGATTGCCTGAACTCAGGAGGTCAAGACCAGCCTGGGCAACACAGTAAAACCCCATCTCTACTAAAATACAAAAAATCA"
"GL873579","370235","370429","chr16","38067345","38067552","57","37697110","GCACAGGCCTGAAATCCTAGCACTCTGAAAGGCCAACGGAGGAGAATTTCTGGAGCTCAGGAGTTTGATACCAGCCTAAGCAAATAAAGCTAGACCTCTATCTCTACTAAAATTAGAAAAATTAGGCAGATGTGGTGGTAGGCACCTATAGTCCCAATTACTCCAGAGGCTGAGGCAGAAAGACTCTTGAACCCA","GTCAGGCATGGTGGCTCATGCCTATAATCCTAGCACTTTGGGAGGCCAAGGCCGGTGGATCACCTGAGGTCAGGAGTTTGAGACCAGCCTGGCCAATATGGCAAAACCCCGTCTCTACTAAAAATAAAAAAATTAGCTGGGCACGGTGGTGGGCACCTATAGTCCCAGCTACTCAGGAGGCTGAGGCAGGAGAATTGCTTGAACCCAG"
"GL873579","370936","371046","chr3","3847698","3847802","33","3476762","TGACTCTTGAACCCAGGCACATGAGGTTGCTAAGAGTCTAGGCTGATGTCACGGCACTCTAACCTGGGAAACAGTGTGAGGTTCTGCCTCAATAAATAAATAAATAAATAA","TGGCTTGAACCCAGGAGGCGGAGGTTGCAGTGAGCCGAGATCACGCCACTGCACTCCAGCCTGGGCAACAGAGCGAGACTGTCTCAAAAAAAAAAAAAAAAAAAA"
"GL873579","599436","599605","chr10","38982686","38982853","41","38383250","AAAAAGTCAGACATTGTGGCAGGTGTCTGTAATCCCAGCTATTTGGGAGGCTGAGGCAGGAGTATCATTTGAACCCACGAGTCTGAGGTAACTGTGAGCTAGGCTAACACAACAGCACTCTAGCCTGGGCAATAGAATGAGACTCTATCAAGAAAAGAAATGAAAAGAAA","TATTAGCCTGACACAGTGGCGCGCATCTGTAATCCCAGCTACTTGGGAGGCTGAGGCAGGAGAATCACTTGAACCCAGGAGGCGGAGGTTGCTGTGGGCTGAGATCATGCCACTGCACTCCAGCCTGGGCAACAGAGGGAGGCTCCATCTCAAAAAAAAAAAAAAAAA"
"GL873579","599942","599953","chr3","71473700","71473710","4","70873758","TTTTAAAATAGT","TTTAAAAAAAA"
"GL873579","600232","600365","chr1","16061315","16061447","30","15461083","GGCTAGGCAAGGTGACTCATGTCTGTAATCCTAGTACTCTGGGAGGTTTGAGGCAGGAAGACCACTTTAGCTCAAGAGTTCCAGATCAGCCTGTGCAAGAGTGATACATCATCTCTACTAAAAATCAAAAATTA","GGCTGGGCATGGTGGCTCATGCCTGTAATCCTAGCACTTTGGGAGGTTGAGGCAGGCAGATCACTTGAGGTCAGGAATCTGAGACTAGCCTGGCCAACATGGTGAAACTCCATCTCTACTAAAAAAAAAAAAA"
"GL873579","5650320","5650591","chr6","54938866","54939145","71","49288546","GTCAGGTGTGTTAGCTTACAGTAGTAATCCTAGCACTTTGGGAGGTTGAAGTGGGTGGATTGCTTGAGCTCAGGGGTTCAAGACCAGCCTGAACAAGAGTGGGACCTCATCTCTATTAAAAACAGAAAAACTAGCTGGGTGTTATGGTGGGTGTCTGTAGCCCCAGCTACTCAGGAGGCTGAGGCAGGAGGTTGAGGTTGCTGTGAGCTATTGAGACCACAGCACTCTATCCAGGGCAACAGAGTGAGACCCCTCCCCCCCCCAAAAAAAAA","GGCCAGGTGTGGTGGCTCACGCCTGTAATCCCAACACTTTGGGAGGCCGAGGTGGGTGGATCACCTGAGATCAGGAGTTCAAGACCACCCTGGCCAACATGGTGAAACCCCGTCTCTACTAAAAATACGAAAATTAGCTGAGTGTGGTGGTGCATGCCTGTAGTCCCAGCTACTCAAGAGGCTGAGGCAGGAGGTGGAGGTTGCAGTGAGCCGAGATTGCATCACTGCACTCCAGCCTTGGCGACAGAACGAGAGAGACTCCATCTAAAAAAAAAAAAAA"
"GL873579","7037162","7037347","chr3","37328686","37328893","67","30291524","GAGGTGGGTGGATTGCCTGAGCTCACAGGTTGGAGACCAGCCTGAGCCAGAGCAAGACCTTATCTCAAAAAATAGCCAGGTGTTGTGGCTGGCACCTGTAGTCCCAGCTGCTCAGGAGGCGGAGGCAAGAGAAATGCTTGACCTCAGGAGTTTGAGGTTGCTGTGAGTTCAACTCACACTAATACA","GAGGCAGGGGGATCACCTGAGGTCAGGAGATCGAGACCAGCCTGGCCAACATGGTGAAAACCTGTCTCTACTAAAAATCCAAAAACATTAGCCAGGTGTGGTGGCACGCACCTGTAATCCCAGCTACTTGGGAGGCTGAGGCAGGAGAATCACTTGAACCTGGGAGGCAGAGGTTGTAGCGAGCCGAGATCACACCACTGCACCCCAG"
"GL873579","11077764","11077972","chr19","1200469","1200683","63","9877295","GCCAGGTGCAGTGGCTCATGCCTATAATCCTAGCACCCTAGGAGGCTGAGGAGTTCAAGACCAGCCTAAGCAACTGTGAGACCCCATCTCTACCAAAAATAGAAAAATTAGCTGACTGTTATGGTGTGCACCTACAGTCCTAGCTACTCAGGAGGCTGAGGCAGAAAGAGTCCTTGAACCCAGGAGGCTTTTTTTTGTTGTTGTTGTTG","GGCCAGTCGCGGTAGCTCATGCCTGTAATCCCAGCACTTTGGGAGGCCGAGGCGGGCAGATCACCTGAGACCAGCCTGGCAACATGGTGAAACCCCATGTCTACCCAAACTACAAAAATTAGCTGGGTGTGGTGGTGCACGCCTGTAATCCGAGCTACTCAGCAGGCTGAGGCAGGAGAATCCCTTGAACCTGGGAGGCAGAGGCTGCAGTGAGC"
"GL873579","11078245","11078333","chr19","4926258","4926351","22","6151987","TGAACCCAGGAGTTTGAGTTCGCTGTGAGCTAAGCTGAGGCCACAGCACTCCAGCCTGGGCAACAGAGTGAAAGGAAAAAAATAAAAAA","TGAACCCGGGAGGTGGAGGTTGCAGTGAGCCAAGATCACACCAATGCACTCCAGCCTGGGCAACAAGAGTGAAACTCTGTCTAAAAAAAAAAAA"
"GL873580","320374","320488","chr13","48549305","48549409","42","48228931","GGTAGTGCGTGCCTGCATTCCCAGCTACGGGAGGGCAGGGACTTGAGGCCAGCCTGGGCAAAATAATGAGACCTACTAATGACTCTACTAATACAGAAACAATTAGCTAGGTATG","TGGGAGGCCGAAGTGCGCAGATCACCTGAGGTCAGAAGTTGGAGACCAGCCTGGCCAACATGGTGAAAACCCATCTCTACTAAAAATACAAAAATTAGCTGGGCA"
"GL873580","374969","375091","chr6","147681010","147681135","27","147306041","CGGTGGCTCACACCTATAATCCTAGCATTTTGGAAGGCTGAAGCCGAGGATCTCTGGAAGTCAGAAGTTCAAGACCAGCCTGCCCAAGAGCAAGACCCCATCTCTACTAAAAATAGAAAAACT","GGTGGCTCACACCTGTAATCCCAGCATTTTGGGAGGCTGAGGCAGGCGGATAATCTGAGGTCAAGAATTTGAGACCAGCCTGGCCAACATGGAGAAACCCTATCTCTACTAAAAATACAAAATTAC"
"GL873580","375369","375549","chr7","19977275","19977456","44","19601906","CTAACCAAGTTAGTTAGTTTTAGTTGGCAGGTGCCTGTAGTCCCAGCTCCTTGGGAGGCTGAGGCAAGAGAATGGCTTGAGCCCAGGACTTTGAAGTTGCTGTGAGCTATAATGACACCACAGCACACTACCCAGGGTGACAGAGTGAGACTGTCTCAAAAAAACAAACAAACAAAAAAAA","AACAAACGTTAGCCGAGCATGGTGGTATGTGCCTGTAGTCCCAGCTACTTGGGAGTCTAAGGCAGGAGAATTACTTGAGCCCGGGAGGCAGAGGTTGCTGTGAGCCAAGATCACGCCACTGCACTCCAGCCTGGGTGACAGAGTGAGACTCCATCTCAAAAAAAAAAAAGGAAAAAAAAAAA"
"GL873580","8760922","8761015","chr11","104681322","104681416","19","95920400","GGAGGGAGACACTGCAGTGAACTGCGATCGTGTCTCTGCTTTCCAGGCTGGGTGACAGAGTGAGACTCGGTCTCTAAAATAAAAAATAAATAAA","GGAGACGGAGGTTGCAGTGAGCTGTGATCGCGGCACTGCACTCCAGCCTGGGCAACAGAGTGAGACTCTGTCTCAAAAATAAATAAATAAATAAA"
"GL873580","9391260","9391306","chr14","49279240","49279285","12","39887980","GCCAGTCGAGGTGGCTCACACTTGTGATTCCAGCTACTTGGAAGACT","GGCTGAGATGGTGGCACACACCTGTAATCCCAGCTACTTGGGAGGC"
"GL873581","759283","759365","chr6","46535476","46535542","30","45776193","TAAGAACCTGAAAATAGAGCCAGGCATAGTGGTACATGCGTATAGTCCTGGCTACTCAGGAGGTTGAAACAACAGGATTACTT","CAAAATAGCCAGGCTTGGTGGTGCATGCCTATAATCCAAGCTACTCGGGAAGCTGAGGCAGGAGAAT"
"GL873581","1145844","1145979","chr1","29437872","29437991","29","28292028","GGCCGGGCGTGGTGGCTCACGCCTGTAGTCCCAGCACTATGGGAGGCCGAGGCGGGTGGATCACCTGTGCTCAGAGGTTCGAGACCAGCCAAGACCCCCCTGAGCCAAATGAGCCAGAGTGAGACCCCGTCTCTAC","GGCCGGGCGTGGTGGCTCACGCCTGTAATCCCAACATTTTGGGAGGCCAAGGCGGGTGGATCACCTGAGGTCAGAAGTTCGAGACCAACCTGGCCAACATGGTGAAACCCCTGTCTCTAC"
"GL873581","9628238","9628362","chr5","141044567","141044691","34","131416329","ATCCCAGGTAGTCGGGAGGCTGAGGCAGGAGGATCACTTGAACCCAGGAGGTTGAGGTTGCTGTGAGCAAGGCAGAGGCAACGGCACTCTAGCCACGGGGGCACAGAGACTCTTGTCTTTAAAAA","TAATCTCAGCTACTCGGGAGGCTGAGGCAGGAGAATCGCTTGAGCCCAGAAGGTGGAGGTTGCAGTGAGCCAAGATCGCGCCATTGCACTCCAGCCTGGGCGACAGTGCGAGACTCTGTCTCAAA"
"GL873582","1580485","1580534","chr6","32576760","32576806","12","30996275","CAGCACTTGAGAGGCCAAGGCAGGTGGATCAACTGAGCAAGAATGAGACC","CCAGCACCTTGAGAGGCCAAGGCAGGTGGATCACCTGAGGTCAGGAG"
"GL873582","1644368","1644551","chr1","211626449","211626612","63","209982081","AAAATTTGCCGGGCTCCATAGCTCATGCATGTAATCATAGCACTCTGGGAGGCCAAGATGGGAGGATCTCTCAAGCTCTCTTACTTGGGAGGCTGAGGTTGCTGTGAGTTAGGCTTACGCCACAGCACTCTACTCTAGCGTGAGCAACTCTACTCTTAGTATGAGACTGTCTCAAAAGAAAAAA","AAATTAGCCAGGCGTCGTGGCACATGCCTGTAATCCCAGCTACTCGGGAGGCTGAGGCAGGAGAATAGCTTGATCTCGGGAGGCGGAGGTTGCAGTCAGCCGAGATCACACCACTGCAATCCAGCCTGGACAACAGAATGAGACTCCATCTCAAAAAAAACAAA"
"GL873582","5794385","5794459","chr13","18872784","18872852","27","13078399","ATATTGTTAAGCACAGCCACTATTAAAAATTAAATTATAGGCCAGGCATAGTGGCTCATGCCTGTAATCCTAGCT","TGAAACCACCATCTGGACCAAGATACAAAATGTTGGCTGGGCATGGTGGCTCACACCTGTAATCCTAGC"
"GL873583","102645","102683","chr14","5808766","5808804","14","5706121","GAGCAGATCACCTGAGCTCAGGAGTTTGAGACCAGCCTG","GAGGAATCCCTGTGCTCAGGAAGCTTACATTCTAGTGAG"
"GL873583","6200447","6200560","chr4","17786849","17786963","24","11586402","GGCCAGGAGGGACGGCTCATGCCTGTTATCCTAGCACTATGGGAGACTGAGGTGGGAGGATCACTTGAAGTTAGGAGTTCCAGACCAATCTGACCAAAGTGAGACCTCATCTCT","GGCCAGGCTTGGTGGCTCATGCCTGTAATCTTAGCACTTTGGGAGGCTGAAGTGGGTGGATCACTTGAGGTCAGGAGTTAGAACCAGTCTGGCCAACATGGTGAAACCTCAGCTC"
"GL873583","6200584","6200752","chr6","169626528","169626696","42","163425944","TTAGCTGGATGTGGTAGCACATGCCTATAGTCCCATCTACTCAGGAGGCTGAGACAAGAGAGTTGCTTAAGCCCAGGAGTTTAATTTAACTGTGAACTAGACTGAGACTGTGGCACTCTAGCTGGGGCAACAGAGTGAGACTCTGTCTCAAAAGAAAGCAAGAAAGAAA","TTAGCTGGGTATGGTGTCAGATGCCTGTAGTCCCAGCTACTCAGGAGGCTGAGACAGGAGAATCGTTTGAACCCAGGAGGCCAGAACTGCAGTGAGCTGAGATTCGCACCACTGCGCTCCAGCCTGGGCCAGACAGAGTGAGACTCTATCTCAAAAGAAAAAAAAAAAA"
"GL873583","10217398","10217583","chr3","36257142","36257313","44","26039744","TACTAAAAATAAAGTGTGATAGCCAGGCATGGTGGTGGTGCCTATAGAACCAGGCTATTCAGGAGGCTGAGGCAGAAGGATCACTTGAACCCAGGAGTCTGACGTTGCTGTGAGCTAGGCTGGTGCCATGGTACTCTAGCCTGTGGTAACAGAATGAGACTCTATCTCAAAAATAAAAATAAAAAA","TACAAAATTAGCCAGGCGTGGTGGTGCGTGCCTGTAATCCCAGCTACTTGGGAGGCCGAGGCAGAAGAATGACTTGAACCCAGGAGACAGAGGTTGCAGTGAGCCAAGATCCCACCATTGTACTCCAGCCTGGGCAACACAGTGAGACTCCATCTCAAAAAAAAAAAAAAAA"
"GL873583","10394919","10394983","chr16","12841703","12841771","22","2446784","GAGGTCAGGAAATCAAGATCAGTCTGGGCAATATATTGATACCCTGCCCCTACATAAGGAAGAAA","AGGTCAGGAGTTCAAGACCAGCCTGGCCAATATGTTGAAACCTCATCTCTACTAAAAATACAAAAATTA"
"GL873584","521512","521529","chr1","167402212","167402233","10","166880700","GCATGGAACCCCCCACTC","GGTGAAACCCCATCTTTACTAA"
"GL873584","2079725","2079768","chr15","4338291","4338335","11","2258566","GGCAGGTGGATTACCTGAGTTCAGGAGTTGGAGACCAGCCTGAC","AGGCGGATGGATCACGAGGTCGGGAGTTTGAGACCAGCCTGACCA"
"GL873584","5216877","5217053","chrX","91350057","91350230","49","86133180","CTACTGAAAATGATGACAGAGGCTGGGCATGGGGGCTCCCGCCTGTTATCCTAGCACCCTCGGAGGCTGGGGAATGAGGATTGCTTACGCCCAAGAGTTTGAGGTTGCTGTGAGCTGAGGCCGCTGCACTCTAGCCTGGGCAACAGAGTGAGACTCTGTCTCAAAAAAAAAAAAAAA","TGCAAAAATGAGCTGGGCATGGTGGCACATGCCTGTAATCCCAGCTACACAGGAGGCTGAGGCAGGAGAATCGCTTGAATCTGGGAGGCGGAGGTTGCAGTGAGCTGACATCAGGCCCCTGCACTCTAGCCTGGGCCACAGAGCAAGACTCCGTCTCAAAAAAAAAAAAAAAAA"
"GL873584","7289930","7289950","chr2","51453328","51453345","10","44163398","TGAGGCTCTGTCTCGAAATAA","AATGCCATCTATTAAAAA"
"GL873584","7289975","7290131","chr11","49739997","49740154","37","42450022","CAAGAAAATTAGCTGAGAGTCCTGGTAGGTGCCTGTAATCCCAGCTATTCATGAGGCTGAGGCAGAAGGATCACTTGGGTCCAGGAGTCTGAGGTTGCTGTGAGCTAGTCTGACGCCATAACACGCAAGCCTGGGCAACAGAGTGAGGCTCGGTTTC","CTACAAAAATTAGCTGGGCGTGGTGGCACATGCCTGTAATCCCAGCTACTCGGGAGGCTGAGGCAGGAGAATCACTTGAGCCCAGGAGGCGGAGGTTGCAGTGAGCCAAGATCATGCCATTGCACTCCAACCTGGGCAACAGAGCAAGACTCCATCTC"
"GL873584","7577743","7577867","chr5","48394329","48394446","27","40816586","GGCTGGATGAGGTGGTTCATGCCTGTAATCCTAGCACTCTGGGAGGCCAAGGTGGGTGGATTGCCTGAGCTCAGGAGTTCAAGACCAGCCTGAGCAAGACCCTGTCGCTAAAAATAGCTGGGTGT","GGCTGGGTGCAGTGGCTCATGCCTGTAATCCCAGCACTTTGGGAGGTCAAGGCGGGTGGATCACCTGAGGTCAGGAGTTCAAGACCAGCCTGGCCAACATCTCTACTAAAAATACAAA"
"GL873584","7578135","7578289","chr1","130112713","130112865","31","122534578","GGAGCTGGGTTTTGTGACTGCACCTGTAATCCCAGCTGCTCAGGAGGCTGAGGCAAGAGAATTGCTTGAGCCCAGGAGTTGGAGGTTGCTGTGAGCTGTGATGCCAGGGAACTCTACCAAGGGTGACAAAGTGAAACTCTGTCTCAAAAAAAAAA","TTAGCCAGGTGTGGTGATGCATGCCTGTAATCCCAGCTACTCATGAGGCTGAGGCAGGAGAATTGCTTGAACCTTGGAGCTGGAGGTTGCAGTGAGCTGAGATCAGACCACTCCAACCTGGGTGACAGAGCGAGACTCTGTCTCAAAAAAAAA"
"GL873585","1450952","1451121","chr10","59681079","59681242","48","58230127","TAAAAACAGAAAAAACTAGTCAGGTGGTGTGGTAGGTGCTCATAAGTCCCAGCTGCTTGGGAGACTGAGGCAAGAGAATCACTTGAGCACAAGAGCTTGAGGTGGCTGTGAGCTATAACACCATAGCACTGTACTGAGGGTGACAAAGTAAGACTCTGTCTCAAAAAAAA","TACAAAAATTAGTCAAGGGTGGTGGTATGTGCTTGTAATCCCAGCTATTTGGGAGGCTGAAGCAGGGGAATCCTTGAACCCAGGAGGTGGAGGTTGCAGCGAGCCGAGATCACGTCACTGCACTCTAGCCTGGGCGATAGGGTGAGACTCTGTCTCAAAAAAAA"
"GL873585","1451382","1451515","chr6","17405813","17405948","24","15954431","GGCCCGGCTCGGTGGCTCACACCTATAATCCTAACACTCTGGGAGGCTGAGGCAGGTGGATCACCTGAGCTCAGGAGTTTGAGACCAGCTGAGCAAAAACAAGACCCTATCTCTGCTAAAAATAGAAAAAACTA","GGCCGGGCGGGGTGGCTCACGCCTGTAATCCCAGCACTCTGGGAGGCCAAGGCAGGTGGATCACCTGAGGTCAGGAGTTTGAGACCAGCCTGGCCAACACGCAGAAACCCTATTTCTACTAAAAACACAAAAATTA"
"GL873585","1626960","1627026","chr7","17782729","17782794","22","16155769","AAGATGCCACAGCACTCTACAAGAGTGACCAAGTGAGACTCTGTCTCAAAAAAAAAAAGAAAAGGAA","CAATCGCACTACTGCACTTCAGCCTGGGTGACAGAGTGAGAACCTGTCTCAAAAAAATAAATAAAA"
"GL873585","1627304","1627531","chr11","17033552","17033788","61","15406248","GGCTGGGCACAGTGGCTCACGGCTATAATCTAGGCACTTGGGAGGCTAGGGCAGGTGGATTGCCTGAACTGACAAGTTTGAGACCAACCTGAGCAAGAGCGAGACCCCTGTCTCTAAAACATAGCCAGGCTCTGTGGTGGGCGTCTGTAGTCCCAGCTACTTGGGAGGCTGAGGCAAGAGAATTGCTTGAACTCAAGAGTCTGAGGTTGCTGTGAGTTAAGATGCCAC","GCCCGGCGCAGTGGCTCACGCCTGTAATCCCGGCACTGTGGAGGCCAAGGCAGGCGGATTGCCTAAGCTCAGGGATTCGAGAACAGCCTGGGCAACATGGTGAAACCCCATCTCTACTAAAATACAAAAAACTAGCCGGGCGTGGTGGTATGCGCCTGTAATCCCAGCTACTTGGGAAGCTGAGGCAGGAGAATTGCTTGAACCCGGGAGATGGAGGTTGCAGTGAGCTCAGATCAC"
"GL873585","3626082","3626158","chr1","100916857","100916922","27","97290775","TGCCTGTAATCCCAGCACTTGGGAGGCGGAGGTGGGTAGATTGCCTGACCCAGAGTGGGACCTCATCTCTAAAAGAA","CATGCCTGTAATCCCAGCACCTTGGGAGGCCAAGGTGGGTGGATCACCTGAGGTCAGTAGTTTGAG"
"GL873585","8849829","8849913","chr18","48581945","48582025","18","39732116","GGCTGGACGAGGGGACTCATGCCTGCAATCCCAGCACTGAGAGAGGCCAAGGCAGGTGGATCCCCTGAGCTCAGAAGTTTGAGAC","GCTGGACGCAGTGGCTCACACCTGTAATCCCAGCACTTTGGGAGGCCAAAGCAGGCAGATCTGAGGTCAGGAGTTTGAGAC"
"GL873585","9319890","9319971","chr8","79499361","79499447","14","70179471","GGCCAGGTGTGGTGGCTCACACCTGTCATCCTAGCACTCTGGGAGGACGAGGTGGGTGGACCGCCTGAGTCAGAGTGAGACC","GGCCAGGTGTGGTGGCTCACACCTGTAATCCCAACACTTTGGGAGGCCCAGGTGGGTGGATCACCTGAGGTCAGGAGTTCAAGACCA"
"GL873586","895572","895692","chr17","14501559","14501680","38","13605987","GGCCAGGTGAGGTTTCTCATTCTGGGAGTGAGCCAGCAATTGGGAGGCCAAAGTAAATGGATTGCCTGAGGTTATAGGTTCCAGAACAGCCAGAACAAGATCGAAATCCTGTCTCCAAAAA","GGCCAGGCGTGGTGGCTCATGCGTGTAATCTCAGCACTTTGGAAGGCCGAGGCAGGTGGATCACCCGAGGTCAAGAGTTCAAGACCAGCCTGACCAACATGGCGAGTCTCTGTCTCCACTAA"
"GL873586","5645995","5646150","chr6","58863249","58863409","38","53217254","GGGTATGGTGGCTCATGCCTGTAATCCAAGCACTCTGGGATGGTGAGGCAGGAGAATCCCTTGAACCCAAGAGTCCGAGGTTGCTGCGAGCTAAGCTGATGGCATAACACTCTAGCCTAGGCGACAGAGTGAGACTCTGTTTCCAAAGAGAAAAAA","TTAGCCAGGCATGGTGGCACATGCCAGTAATCCCAGCTACTCAGGAGGATGAGGCAGGAGAATCGCTTGAACCCAGGAGGCAGAGGTTGCAGTGAGCTGAGATTGCGCCACAGCACTCTACCCTGGGTGACAGAAGGAGACTCTGTCTCAAAAAAAAAAAA"
"GL873586","10258686","10258969","chr12","9481260","9481565","81","777426","GGCCGGGCATGGTGGCAGAAATCTAGGAGGCCGAGGCAGGTGGATCGCCTGAGATCACAAGTTCAAGACCAGCCTCAGCTACAGCAAGACCCCATCTCTAAAAATAGCCGGCTGTTGTGGCAGGCGCCTGTAACCCCAGCTACTCGGGAGGCTAAGGCAAGAGAATCGCTTGAGCCCATGAGTCTGAGGTTGCTGCGAGCTGTGACTCCACGGCACTCTACCCGGGGCGATAAAATGAGATTCTGTGTCAAAACAAACAAACAAACAAACAACAACAAAAACAA","GCTGGGCGCGGTGGCTCATGCCTGTAATCCCAGCACTTTGGGAGGCCAAGGCAGGTGGATCACCTGAGGTCAGGAGTTCGAGACCAGCCTAGTCCACATGGTGAAACCCCATCTCTACTAAAAACTAGCCAGGCGTGGTGGTGCGCACCTGTAATCCCAGCTACTCGAGAGGCTGAGGCAGGAGAATCACTTGAGCCTAGGAAGCAGAGGTTGTGGTGAGCTGAGATCACACCACTGCACTCCAGTCTGGGCGACACAGTGAGACTCTTGTCTCAAAAACAAAAAACAAACAAACAAACAAACAAA"
"GL873587","3208032","3208047","chr8","3626746","3626762","2","418714","AAACAACCACAAAAAA","ACAACAACAACAAAAAA"
"GL873587","3208141","3208321","chr19","2057131","2057316","59","1151010","TTTCTTTTAAAAATCACCCATGGGCTGGGTATAGTGGCTCACACCTATAATCCTCGGGAGGCCAAGGTTGGAGGATTGCTTGAATCCAGGAGTTGAAGGTTACAGTGAACTGGGATTTAGCCACTAGACTCTAGCATAGCTGACAAAGCAAGAACCTATTTGTTTAAAACACAAAAAAGAA","TACTAATAATACAAAAATGAGCCGGGTATGGTGGCGGGTGCCTGTAATCCCAGCTACTGAGGAGGCTGAGGCAGGAGACTTGCTTGAACCCAGGAGGTAAAGGTTGCAGTGAGCTGAGATTGCACCACTACACTCCAGCCTGGGCGACAAGAGCAAAACTTTTTCTCCAAAAAAAAAAAAAAAAAA"
"GL873587","3278260","3278367","chr19","19044200","19044312","39","15765940","CAGTCTGAGCAAGAGGGAGAGGCTATTTCTACTAAAAACAGAAAAACTAGCTGGGTGTTGGGGTGTGTTCCTAGTCTCAGTTACTTGGGAGGCTGAAGTAAGAGGATC","ACCAGCCTGGCCAACACGGTGAAATCCCGTCTCTACTAAAAATACAAAAATTACCTAGGCGTGATGGCACGTGCCTGTAGTCCCAGCTACTCATAAGGCAGAGGTGAGAGAAT"
"GL873587","3278673","3278754","chr7","49412503","49412597","28","46133830","GGCCACGAGAGCTAGCTCATGCCTATTCTAGGAGGCCAAAGCAGGCAGACTGCCTGAGCTCAGGAGTTCAAGAGCAGCCTGG","GGCCAGGTGCAGTGGCTCATGCCTGTAATCCGAGCACTTTGAGAGGCCGAGGCAGGCAGATCACCTGAGGTCAGGAGTTCAAGACCAGCCTAGTA"
"GL873587","3782076","3782188","chr9","112128434","112128552","34","108346358","ACTGGGGTGGCTGAGGCAGGAGCGTCACTTGAACTCAGGAGTTTGAGATTGCTGTGAGCTGAGCAGATGTCATGGCACGCTAGCCTAGGTAATAGAGTGAGACTTCGTCTAAA","CAGCTACTCGGGAGGCTGAGGCAGGAGAATCACTTGAACTCGGGAGGCGGAGGTTGCAGTGAGCCGAGATCACGCCATTGCACTCCAGCCTGGGCAACAAGAGCGAAATTCCATCTCAA"
"GL873587","4564996","4565084","chr20","27900350","27900437","14","23335354","GGCGGGGTGTAGTGGCTCATGCCTATTGTCCCAGCACTGTGGGAGGCCGAGGTGGGTGGATCACCTGTGCTCAGAAGTTTGAGACCAGC","GGCCGGGCGTGGTGGCTCATGTCTGTAATCCCAGCACTTTGGGAGGCCGAGGTGGGTGGATCACCTGAGGTCAGGAGTTCAAGACCAG"
"GL873587","6307870","6308175","chr12","112427710","112428020","54","106119840","GGCCAGATATGATGGCTCATGCTTGTAATCCTAGCACTCTGGGAGGCTGAAGTGGGAGGATCACCTGAGATCAGGAGTTCAAGATCACCCTGAGCAAAAGTGAGATCCCATCTCTATTAAAAATAAAAAAATTATCCAGGCATGGTGGTGCAGTCCTTTAGTCCCAGCTACTTGGGAGGCTGAGGCAGGAGAATCTCTTGAACCCAGGAATTAGAGGTTACAGTGAGCTGTGATGATGCTACTGCACTCTAGCAGGATGACAGAGTGAGATACTCCGTGTCAAAAAAAAAAAAAAAAAAAGCAAAA","GGCTGGACATGGTGGTTCATGCTTGTAATCCGAGCACTTTGGGAGGCCAAGGCGGGTGGATCACCTGAGGTTGGGAGTTCGAGACCAGCCTGACCAACATGATGAAACCCCATCTCTACTAAAAATACAAAAAAATTAGCCAGGCATGGTGATGCACGCCTGTAATCCCAGCTACTTGGGAGGCTGAGGCAGGAGAATCACTTGAACCCAGGAGGCAGAGGTTACAGTGAGCCGAGATCATGCCATTGCACTCCAGCCTGGATGACAGAGTGAGCCTCTGTCTCAAAAAAAAAAAAAAAAAAAAAAAAAAA"
"GL873587","6484004","6484128","chr10","67341428","67341546","29","60857424","GACCAGGTTCTGTGGCTCATGCTTGTAATCCTAGCACTCTAGGAGGCCGGAAGAGGGTGGATTGATTGCCTGAGGTCAGGAGTTAGAGACCAGCCTGAGCAAGAGCTAGACCCTGTTTCTTTCTT","GGCTGGGTGTAGTGGCTCATGCCTGTAATCCCAGCACTTTAGGAGGCCAAGGTGGATGGATTGCCTGAGCTCAGGAGTTCGAGACCACCCTGGGCAACAAGCCAAAACCCTGTCTCTAC"
"GL873587","6484407","6484586","chr3","167196537","167196723","48","160712130","TAGACCCTGTTTCTAAAAAAAAAATAGCCAGGTGTTGAGGCAGGTACCTGTAGTCCCAGCTACCTGGGAGGGCTGAGGCAAGAGAATCGCTTGAACCCAAGAGTTTGAGGTTGCTGTGAGCTGAGATGCTATGGCACTCAACCGTGAGCTACAAAGTGAGACTCTGTCTCAAAAAAAAAA","AAAACCTGTCTCTGCTAAAAATACAAAAATTAGCCGGGTGTGGTGATGTGCGCCTGTAGTCCTAGCTACTTGGGAGGCTGAGGCAGGAGAATCACTTGAATCCAGGAGGTGGAGGTTGTAGTGAGTCGAGATCGTGCGACTGCACTCCAGCCTGGGTGACAGCGAGACTCTGTCTCAAAAAAAAAAA"
"GL873587","7466229","7466364","chr1","29437872","29437991","35","21971643","GGCCAGGCGTGGTGGCTCATGCCTGTAGTCCCAGCGCTATGGGAGGCCGAGGTGGGTGGATCACCTGTGCTCAGAGGTTCGAGACCAGCCAAGACCCCCCTGAGCCAAATGAGCCAGAGTGAGATCCCATCTCTAC","GGCCGGGCGTGGTGGCTCACGCCTGTAATCCCAACATTTTGGGAGGCCAAGGCGGGTGGATCACCTGAGGTCAGAAGTTCGAGACCAACCTGGCCAACATGGTGAAACCCCTGTCTCTAC"
"GL873588","1502535","1502718","chr1","34852429","34852590","60","33349894","GGTGCAGTGGCTCACACCTGTTGTCCCAGCGCTGTGGGAGGCCGAGGTGGGTGGATCACCTGTGCTCAGAGGTCGAGACCAGCTGAAGACCTGCCTGAGGCAGAGTGAGCCAGAGTGAGACCCCGTCTCTACTAGAACAACAACAAGACAGCCAGACCTTGTGATCCCAGCTACATGGGGGGCT","GCCAGGTGCAGTGGCTCACACCTGTAATCCCAGCACTTTGGGAGGCCGAGGCGGGCGGATCACCTGAGGTCAGGAGTTTGAGACCAGCTTGACCAACATGGAGAAACCCCGTCTCTACTAAAAATACAAAATTAGCCTGGTGTGGTGTCGCATGCCTGTAAT"
"GL873588","10189037","10189246","chr3","45604681","45604903","65","35415644","GCTGAGATGAGGAGACTCTGTCTCTATTAAAAATAGAAAAATTGGGTGGATGTTGTGGGTACTGTAGTTGCAGCCTCTTGGGGGGCTAAGGCAGGAGGATCAGTTGAAGCCAGGAATTTGCTTTGAGCTAGGCTAAAGCCATGGCACTCTAGCCTGGGCAACAGAGTGAGGCTAGATCTCAAAAAAAGAAAGAAAAGAAAAAGAAAAAAA","CTGGCCAACATGGCAAAACCCCATCTCTACTAAATATACAAAAATTAGCTGGACGTGGTGGCACATACCTGTAATCCCAGCTACTTGGAAGGCTGAGGCAGGAGAATAGCTTGAACCTGGGAGGCAGAGGTTGCAATGAGCTGAGATCACGCCACTGCACTCTAGCCTGGGCAATAGAATGAGACTCTGTCTCAAAAAAAAAAAAAAAAAAAAAGACAAGAAA"
"GL873589","104719","104807","chr20","27900350","27900437","13","27795631","GGCTGGGCGTGGTGGCTCATGCCTGTTGTCCCAGCGCTGTGGGAGGCTGAGGTGGGTGGATCACCTGTGCTCAGAGGTTCGAGACCAGC","GGCCGGGCGTGGTGGCTCATGTCTGTAATCCCAGCACTTTGGGAGGCCGAGGTGGGTGGATCACCTGAGGTCAGGAGTTCAAGACCAG"
"GL873589","796766","796905","chr1","166346372","166346487","49","165549606","GGCTAAGTGTGGTGGCTCACACCTGTCATCTAGTACTTTGGGAGGGTGGGCCTGGGAGTTCAAAGACTGAACTCAGGAGTTCAAGGTGGCTCCGGGGAGGAATTCAAGACCAACCTGAGCCAGAGCGAGACCTCGACTCT","GGCCAGTGGGGTGGCTCACGCCTGTAATCCCAGCACTTTGGGAGGCTGAGGTGGTCAAATGACCTGAGGTCAGGAGTTTGAGACCAACCTGGCCAACATGGTGACACCTCGTCTCT"
"GL873589","1023679","1023690","chr1","205890061","205890072","1","204866382","AAAAAAAAAAAA","ACAAAAAAAAAA"
"GL873589","1023771","1024047","chr4","103012712","103012993","70","101988941","GGCTTGGTGGCTCACACCTGTAATCCTAGCACTCTGGGAGGCCGAAGTGGCTGGAATACTTGAGGTCAGGAGTTCAAGACCAGCCTAAGTGAGAGTGAGATCCCCATCTCTAATAAAAATAGAAAAATTAGCAGGGTGTTGTGGCTGGCACTTGTAGTCCCAGCTACCCAGGAGACCGAGGCAGAAGTTTGAGATTATTGTGAGCGAGGCTGATGCCACAGCATTCTAGTGGGACAACAGAGCAAAATTCTATCTCAAAAGAAAAAAAAAAAAAGGA","CGGGCGTGATGGCTCACGCCTGTAATCCCAACACTTTGGGAAGCCGAGGCGGACGTATCACCTGAGGTCAGGAGTTCAAGACCAGCCTGGCCAACATGGTGAAACCCCGTCTCTACTAAAAATACAAAAATTAGCTGGGTGTGGTGGCATGCGCCTGTAATCCCAGCTACCCAGGAGGCTGAGGCAGGAGAATCGCTGAGGCTGCAGTGAACTGAAATTGTGCCACTGCACTCCAGCCTGGGTGACAGAGCAAGACTCTGTCTCAAAAAAAAAAAAAAAAAA"
"GL873589","4820958","4821024","chr8","33633747","33633811","15","28812789","TTAGTCAAGTGCAGTGGCTCACACCTGTCATCCCAGCTACTTGGGAGGCTGAGGCAGGAGAGTTGCT","TTAGCCAGGTGTGGTGGTGCATGCCTCTAATCCCAGCTACTCAGGAGGCTGAGGCAGGAGAATTG"
"GL873589","6763768","6763857","chrX","25814002","25814092","29","19050234","GGTGTGGTGGCTCACACTTGTATCTTAGCATTTTAGGAGGCTGAATGGGGAGAATTGCTTTAAGTCAGGAGTCTGACTTCCACCTTGCCA","GGCTGGGAATGGTGGCTCACACCTGTAATCCCAGCACTTTGGGAGGCTGAGGTGGGCAGATCACCTGAGGTCAGGAGTTTGAGATCAGCCT"
"GL873589","8444551","8444632","chr9","93194085","93194171","17","84749534","CGGGCATGGTGGCTCACAACTATAATCTTAGCACTTTGGGAGGCTGAGACAGGTGGATGCCTGAACTCAAGAGTTTGAAACC","GGCCGAGCATGGTGGCTCACACCTGTAATCCCAGCACTTTGGGAGGCTGAGGCAGGTGGATTACCTGAGGTCAAGAGTTCAAGACCA"
"GL873589","9085365","9085494","chr2","194063347","194063481","42","184977982","GGCCAGGCACAGTGGCTCACACCTATAATCCCAGCACTCTGTGAGACTGAGGCAGGTGAACTGTTGCAAGAGTGAGACCCTGTGCTTGGTGCCTGTAGCTCAGTGGTTAATAATAAGAAAAAAGAAAAAA","GGCCAGGTGCAGTGGCTCACACCTGTAATCCCAGCACTTTGGGAGTCTGAACCAGGCAGATCACCTGAGGTCAGGAGTTCGAGGCCAGCTCGGCCACCATGGTGAAACCCTGTTTCTAATAAGAATACAAAAAAA"
"GL873589","9085767","9086002","chr7","84631446","84631650","75","75545679","GAGTGAAACCCTGTCTCTACTAAAAATAGAAAAACTAGCTGTGCATCAGGGCGCATAACTGTAGTCCCAGGTACTCAGGACACTGAGGCAAGAGAATTGCTCAAGCCCAAGAGTTTGCAAGAATTTGAGGTTGCTATGAGCTATGATGCCATGGCACTCTACCTAGGGTGACAGACAGAGACTCTGTCCCAAAAAAAAAAAAAGAAGAAGAAGAAAAAAAAAAAGAAAGAAAGAAA","ATAGTGAAACCTCGTCTCTACTAAAAATACAAAAATTAGCTGGGCATCATGGTGCACGCTTGTAATTCCAGCTACTTGGGAGGCTGAGGCAGGAGAATTGCTTGAACTCAGGAGGTGGAGGTTGCAATGAGCCAAGATCGCGCCACTGCACACCAGCCTGGGTGACAAAAGACTCTGTCTCAAAAAAAAAAAAAAAAAAAAAAAA"
"GL873589","9992904","9993045","chr16","56427538","56427666","46","46434634","AACCAGCCAGGCATGGTGATTCACACCTATAATCCCAGCTACTTAGGAGTATGGCTTGAGCACACAGGATACCATACCATTCTAGTCATCCCAGGCAACAGAGGGAAACTCTGTTGGTTAAAAAAAAAGAAAAACTTAAAAA","TTAGCCAGGAGTGGTGGTGCACGCCTATAATCCCAGCTACTTGGGAGGCTGAGGCACAAGAATCACTTGAACCATTGCACTCCAGCCAGGGTGATAGAGGGAGACTCTATCCAAAAAAAAAACAAAAAA"
"GL873589","9993319","9993452","chr3","2774534","2774668","28","7218785","GGCCTGAGCCCTGTGACTCATGCCTGTAATCCCAGCACTGGAAGTTCCAAGGCAGGTGGATCGCTTGAGCTCTGGAGTTCAAGACCAGCTCAACCAAGAGTAAGACCCCATCTCTACTAAAAATAGAAAAACCA","GGCTGGGCACGGTGGCTCATGCCTGTAATCCCAGCACTTTGAGAGGCCGAGGCAGGTGGATCTCCTGAGGTCAGGAGTTCAAGACCAGCCTGGGCAACATGGTGAAACCCCATCTCTACTAAAAATACAAAAAAT"
"GL873590","9044589","9044884","chr1","83754525","83754835","84","74709936","GGCCAGGTGCAATGGCTCATGCCTATAATCCTCACACTCTGGGAGGCTGAGGCAGGAGGATCACTTTTCTCAGGGTCAGGGCCAGCCTGACAAAAGTCAGACCCTGTTTCTACTAAAAATAGAAAAACTAGCTGGGTGTTGTGGCAGATGCCTATAGTCCCAGCTACTAAGAGACTGAGACAAGTGCCCAGAGTCTGAGGTTACTGTGAGCAAAGCTGATGCCATAGCATTCTAGCTATAGATCGAGAGTCTGTCTCAAAAACAAACAAACAAACAAACAAACAAACAAAAAAGAA","GGCTGGGTGTGGTGGCTCATGCCTGTAATCCCAGCACTTTGGGAGGCCGAGGCGGGTGGATCATCTGAGGTCAGGAGTTCAAGACCAGCCTGACCAACATGGTGTAACCCTGTCTCAACTAAAAATACAAAAATTAGCTGGGCGTGGTGGTGTGCACCTATAGTCACAGCTACTTGGGAGGCTGAGACAGGAGAATTGCTTCAACCCAGGAAGTGGAGGTTGCAGTGAGCCAAGATCATGTCACTGCACTGCAGCCTGACAGAGCGAGACTCCATCTAAAACAAACAAACAAAAACAAACAAACAAACAAA"
"GL873591","1831505","1831587","chr17","61702818","61702899","25","59871313","CCCAGCACTTTGGGAGGGCAAGATGGGAGAATCATATAAAGTCAGGAGTTTGAGACCAGTTTGGCAGACATGATGAACCCATC","AATCCCAGCACTTTGGGAGGCTGAGGCAGGCGGATCATCTGAGGTCAGGAGTTCAAGACCAGCCTGGCCAACATGGTGAAAC"
"GL873591","2719175","2719275","chr4","86137755","86137847","32","83418580","GTGGGGGCTTAGGCCTGTAATCCCAGCACTCTGAGAGGCCAAGGTGAGCTGGTCACCTGGGTTTAGGAGTTTGGAGACTTGCTCGAGCTAGACTGAGGCTC","GTGGTGGCTCACGCCTGTAACCCTAACAATTTGGGAGGCCAAGGCAGGTGGATCACTTGAGGTCAGAAGTTTGAGACCAGCCTGGACAATATG"
"GL873591","4732974","4733120","chr19","7991801","7991954","55","3258827","ATACGCAGACTGGCCGAGCGTGGTGTCACATGCCTATAATCCCAGTGGCTACTCTGGGGAGGAGAATCTCTTGAAACCAAGAGTTAGAGATTGCAGTGGGGTATGATACAGGGTAACAAAGAGAGACCTTGGATCTGAAAAGAAAAA","AAAATACAGAAACTAGCTGGGCATGGTGATGCACACCTGTAATCCTAGCTACTGGGGAGGCTGAGGCAGGAGAATTGCTTGAACCCAGGAGTCAGAGGTTGCAGTGAGCAACCAGCCTGGGTGATACAGTGAGTGAGACTCTGTCTCGAAAAAA"
"GL873591","6822728","6823009","chr1","20579766","20580052","72","13757038","GGCCAGGCGTGGTGGCTCATGCCTGTAAATCTCAGCACTCTGGGAAGCTGAGGCAGGTGGATTGCTTGAGGTCAGGAGTTTGAGACCAGCCTGTACCAGAGTAAGACCCTGTCTCTAATAAAAATAGAAAAAAAAAAAAAAACTAGTTGGGCATGGTGATGGGTGCCTGTAGTCCCACCTACTTGGGAGGCTGAGGCAATGGCATCTCTTGAGCCCAAGAGTTTGAGGTTGCTGTGCCATGGCACTCTCCCCAGGGTAACAGAGTGAAAATAAAAAAAAGAA","GGCCAGGCGTGGTGACTCATGCCTGTAATCTCAGCACTTTGGGAGGCCGAGGCAGGTGAATCACCTGAGGTCAGGAGTTTGAGACCAGCCTGACCAACATGGTGAAACCTCGTCTCTACTAAAAATACAAAAAGTAGCCAGGCATGGTGGCGCATGCCTGTAATCCCAGCTACTTGGGAGGCTGAGGCAGGAGAATCGCTTGAACCCGAGAGGCAGAGGTTGCATTGAGTCAAGATGGTACCACTGCACTCCAGCCTGGGTGACAGATTGAGACTCAAAAAAAAAAA"
"GL873591","7578706","7578813","chr16","45055441","45055543","42","37476735","AAATTTAGCTACACATAGTGGCATGAGTCTGTAATGCTAGCCACCCAAAAGGCTGTAGTAAGAGGATTGCTCTATCCCAGGAGTTAAAGACCAGCCCGGACATCAGAG","AATTAGCCGGGCGTGGTGACACACACTTGTAATCCTAGATACTCAGGAGGCGAAGGTAGGAGAATTGCTTGAACCCAGGCAGCAGAGGTTGCAACGAGCAGAG"
"GL873591","9282916","9283004","chr1","20744253","20744338","16","11461337","GGCCAGGCGCGGTGGCTCACCCCTGTTGTCCCAGTTCTGTGGGAGGCCGAGGTGGGTGGATCACCTGTGCTCAGAGGTTTGAGACCAGC","GGCCAGGCACGGTGGCCACGCCTGTAATCCCAGCACTTTGGGAGGCCGAAGTGGGTGGATTACCTGAGGTCAAGAGTTTGAGACCA"
"GL873592","835155","835315","chr16","75654291","75654451","43","74819136","CTGGGTGTGGTGGCTCTTGTCTGCAATCTCAGTACACTGGGAGGCTGAGGCAGAAGGATTGCTCCAGCTCAGGAGTTTGAGGCCAGGCTGAGCTAGTGCAAAACCCCATCTCTACTAAAAAAAGAAGGAAAAAAAAAAGAAAAAGAAAAAAAATACGAGCT","CCAGGTGTGGTGACTCACGCCTGCAATCCCAGCACTCTGGGAGGCTGAGGTGGGTAGATTACCGGAGGTTAGGCGTTTGAGACCAGCCTGGCCAACATGGTGAAACCCCATCGCTACTAAAAAAAAAAAAAAAAAAAAAAAAAAAAAAAAAAAAAAAATTA"
"GL873592","835589","835765","chr1","66836166","66836336","48","66000577","ACAAAAAACCTAGCTTAGGGTTGTTATAGCACCTGTAGTCCCAGCTACTCAGGCGCTAAGGCAGGAAAATCTGCCTGAGCTCAGGAGTTTGAGGTTGCAGTAAGTTATGATGATGCTACTGCACTCTAGCTGGGGCAACAGAGTGAGACTCTGTCTGAGGAAAAACCAAAACCAAAA","TAGCCCAGCACGGTGGCTCACACCTGTAGTCTCAGCTACTCAAGAGGCTGAGGCATGAGAATCGCTTGAACCCAGGAGGTAGAGGTTGCAGTGAGCTGAGATCATGCCACTGCGCTCCAGCCTGGGCAACAGAGTGAGACTCAGTCTCAAAAAACAAAACAAAACAAAAAA"
"GL873592","2520661","2520705","chr16","66853217","66853257","11","64332556","TCTGGGAGGCTGAGGCGGGTGGATCACCTGAGCAAGAGTGAGACC","TTTGGGAGGCTGAGGCAGGTGGATCACTTGAGGTCAGGAGT"
"GL873592","4535248","4535388","chr1","12240468","12240612","38","7705220","GGCGGGATGTGGTGGTTCATGGCTGTAATCCCAGCACTCAGGGAGGCTGAGTCGGGTGGATTGCTTGAGTTCAGGAGTTTGAGACCAACCTGAGCAAGAACTAAGCCTGTCTCTACTAAAGATATTATTTCTTATTTTTCT","GGCCGGGCGCGGTGGCTCATGCCTGTAATCCCAGCACTTTGGGAGGCTGAGGCGGGTGGATCACCTGCGGTCAGGAGTTCGAGACCAGCCTGGCCAACGTGGTGAAACCTCATCTCTACTAAAAATATAAAAATTAGCTGGTGTG"
"GL873592","4535654","4535831","chr8","126054004","126054184","54","121518350","TCTACTACAAATATTAACAGAAAAATTAGCTGGGCATTGTGACAGGTGCCTATAGTCCCAGATACTCAGAAGGCTGAAGTAAGAGGATCACTTGAACCCCAGGAGCTAAGGTGGCTGTGAGCTAGGCTGAGGCTCTAGCCTGGGTAACAGAGTGAGACTGTAAAAAAAGAAAGAGAGA","GTCTCTACTAAAAATACAAAAATTAGCTGGGTGTGGTGGTGCATGCCTGTAATCCCAGCTACTCAGGAGGCTGAGGCAGGAGAATCGCTTGAACCCAGGAGGTAGAGGTTGCAGTGAGCCAAGATCATGCCACTGCACTCCAGCCTGGGTGACAGAGGGAGACTCTGTCTCAATAAATAAA"
"GL873592","6794968","6795049","chr3","154764711","154764794","20","147969743","GAAGGTTTGATGAGCTCAGATGATGCCACTGCAGTCTACCCAGAGTGAAGGAGCGAGACTCTGTCTCAAAAACAAAAAAAGA","CAGAGGTTGGCAGTGAGCTGAGACTGTGCCACTGCACTCCAGCCGGGTGACAGAGTGAGACTCTGTCTCAAATTACAAACAAAA"
"GL873592","6881384","6881478","chr5","24882384","24882475","28","18001000","GGGCAGGCATAGTGACTGGTGTCTCTAATCCTAGCAGTCTGGGATGCTGAGGCAAGTGGAATGTCAGAGTTCAGGAGTTGAAGATCACCCTGACT","GGCCGGGCGCAGTGGCTCACATCTATAATCCTAGCATTTTGGGAGGCTGAGGCAGGCGGATCACCTGAAGTCAGGAGTTTAAGACCAGCCTG"
"GL873592","6881755","6881937","chr10","61601371","61601572","66","54719616","TCACCCTGACCAAGAGCAAGACCCTGTCTCTACTAAAAATAGAATAAACTAGCTGGGAATTGTGGTGGGTGCCAGTAGTCCCCGCTACTGAGGCAGGAGGATCATTGAGTCCAAGAGTTTGAGGTTGCTGTAAGTTAGGACACCACAGCACTCTACACAGAGTAAGACTGCCTCAAAAATAAA","AGTAAAGAAAAGAAACCCTGTCTCTACTAAAAATACAAAAATTAGCTGGGTGTGGTGGTGCGCACCTGTAGTCCCAGCTACTTGGGAGGGTGAGGTATGGGAATCACTTGAACCCGGGAGGTGGAGGTTGCAGTGAGCCAAGATCACACCACTGCACTCCAGCCTGGGTGAGAGAGTGAGACTCTGTCTCAAGAAAAAAGAA"
"GL873592","7006080","7006155","chr1","8947061","8947129","24","1940981","CACACTGAGAGGCAAAGGCTGGTGGATCACCTGAGCTCAAGAGTTTGAGACCAGCCAAGCCAGAGATCTTGTCTCT","CACTTTGGAGCCAGGTAGGTGATCACCTGAGTCAGGAGTTCGAGACAGCCTGGCCAACATGTGAAACCC"
"GL873592","8446508","8446655","chr11","122502739","122502874","48","114056231","TTAGCTGGGTGTTGTGGCAGGCACCTGTAGTCCCTCCCAGCTACTTGAAAGGCTGAGGCAAGATGACAGCTTAAACCCAAGAGTTTAAGGTTACTCTATTCAGGGCAACAGAGTGAGACTCCATCTACATAAATAAATAAATAAATAA","GGCTGGGCGTGGTGGTTCACACCTGTAATCCCAACACTTTGGGAGGCTGAGGCCAGCGGATTGCCTGAGCCCAGGAGTTTGAGACCAACCTGGGCAACATGGTGAAACTCCATCTCTACTAAAATACAAAAAGTTA"
"GL873592","8446953","8447008","chr16","44513352","44513404","15","36066399","GACCAGCCTAAGCAAAAAAGAGATCCTATCTCTACTACTAAAAATAGAAAAAATTA","ACCAGCCTCACCAATATGAAGAAACCCCATCTCTACTAAAAATACAAAATATT"
"GL873592","8447239","8447325","chr1","8062863","8062957","21","384376","GGCCAGGAGCAGTGACTCATGCCTAGCACTCTGGGAGGCCAAAGCAGGTGGATCAACTGAGCTCAGGAGTTCAAGACCAGCCTAAGC","GGCCGGGTGCAGTGGCTCATGCCTGTAGTCCCAGGACTTTGGCAGGCCAAGGCCGGTGGATTACCTGAGGTCAGGAGTTCAAAACCAGCCTAGCC"
"GL873592","8723925","8724000","chr3","42066983","42067054","20","33343058","AATTAGCCGGGCATGGTAGTGTGTGCCCATAATCTCAGCTACTCAGAAAGCTAAGATAGGAAAATTGCTTGAGCTC","TTAGCTGGGTGTGGTAGTGCATGCCTATAATCCCAGCTACTCGGGAGGCTGAGGTGGGAGAACTGCTTGAAC"
"GL873593","384022","384146","chr15","102382935","102383070","28","101998913","GGCCACGAGGGCCCATGCCTGTAATCCTAGCACTCTGGGAGGCTGAGGTGAGTAGATTGCTGAGCTCAGGAGTTCAAGACCAGCCTGTGCAAGAGACCCCATCTCTGCTAAAAATAGAAAAACCA","GGCCAGGTGTGGTGGCTCACGCCTGTAATCCTAGCACTTTGGGAGGCTGAGGCGGGTGGATTGCCTGAACTCAGGAGGTCAAGACCAGCCTGGGCAACACAGTAAAACCCCATCTCTACTAAAATACAAAAAATCA"
"GL873593","384425","384607","chr20","28286874","28287058","50","27902449","GAAAGAAAAGAAAAGAAAAACTAGCAAGATGTTGTAGCTGATGCCTATAATCCTAGCTATTGGAGAGGTGGAGGCAAGAGAATTGCGTGAGCCCAAGAGTTGAAGGTTGCTGTGAGCTGCGATGCCAGAGCACTCCAGGGTGACAGAGTAAGACTCTGTCTCAAAAAAAATTACAAAATAAAA","TAATAAAAATAAAAAAATTAGCCAGGAGTCAAAGCACACGCCTATAACCCCAGCTACTTGGGAGGCTGAGGGAGGAGAATTACTTGAACCCGGGAGGTGAAAGTTGCAATGAGCTGAGATCAAGCCACTGCACTCCAGACTGGATGACAGAGTGAGACTCTGTTTCAAAAAAAAAAAAAAGACAA"
"GL873593","1408445","1408467","chr10","88070368","88070389","9","86661923","AATCTAGAGATGGGGAGAGGTTG","AAAGAGATGGAAGAGAAGAAGA"
"GL873593","4856365","4856484","chr7","56497314","56497433","31","51640949","GCAATCCCAGCTGATCGGGAGGCTGACCCAGAAGAATCCCTTGAACCCAAGAGTCTGAGGTTGCTATGGGTGGATTCTACAGCACTCTAGCCTGGGAGACAGAGTGAGACTCTGTCCCAA","ATCCCAGCTACTTGGGAGGCTGAGACAGAAGAATTGCTTGAACCCGGGAGGTGGAGGTTGCAGTGAGCCAAGATTGTACCACTGCACTCCAGCCTGGCAACAGAGTGAGACTCTGTCTCA"
"GL873593","6661298","6661485","chr10","86749316","86749514","55","80088018","GCAGAGGCTCACATATGTAATCCTAGCACTCTGGGAGGATAAGGCAGGTGGACAGCTTGAGCTCAGGGGTTTGACCAGTCTGATCAAGAGCAAGACCTGTGTCTACTAAAAATAGAAAACCTAGCCAGGTATGATGGTAGATGCCTGTATTCCTAGCTACTCTGGAAGCTAAAGCTAAAGAGTTTGAA","GGTGGCTCACACCTGTAATCTTAGCAATTTGGGAGGCCGAGGTGGGTGGATCACTTGAGGTCAGGAGTTTGAGACCAGACTGGCCAACATGGTGAAACTCTGTCTCTACTAAAAATACAAAAATTAGCCAGTCATGGTGGTGCATGCCTGTAATCCCAGCTACTCAGGAAGCTTAGGCAGGAGAATCACTTGAACCCAG"
"GL873593","6710263","6710446","chr14","4390080","4390244","66","2320183","TTGAAGTCAGGAGTTTAAGGCCAGTCTGGGCAACATAGTGAGACCCCCATCTCTACGAAAATATTTTTTAAAAATTAAAAATAGCTGGGCATAGTGAGGCTGTTGTGAGCTATAACTGCACCACTGCACTCAGCCAAGGACAGAGACCCTGTTCCCTGCCTCAAACAAACCAAAACAAAACAAA","AAGTCTAGAGTTTACAGCCTGGACAACGCAGTGAAACCCTGTCTCTACCAAAAATACAAAAATTAGACAGGTGTGAGAGGCGGAGGTTGCAATGAGCTGAGATCGCAGCACTGCAGTCCAGCCTGGATGACAGAGCGAGACCCCATCTCAAAAACAAAAACAAAA"
"GL873593","7159645","7159716","chr6","178318394","178318465","21","171158749","GATCATGTCACTGCTCTCCAACCTGGGCAATTGAGCAGGAATCTGTCTCAAAAAGAAAAAAAAAAAAGAAAA","CGAGTTCACACCACTGCACCCCAGCCTGGGCAACAGAATGAGACTCGGTTTCAAAAAAAAAAAAAAAAAAAA"
"GL873593","7159841","7160050","chr13","33368171","33368368","69","26208330","GGCCAGGCGTGGTGGCTCACACCTGTTGTCCCAGTGCTGTGGGAAGCCGAGGCAGGTGGATCACCTGAGCTCAGCCGAGTTCGAGACCAGTGGAAGACCAGCATGAGGCAGAGTGAGCCAGAGTGAGACCCCATCTCTACAACAACAACAAGAAGAAAAAAAACAGCCGGACCTTGTGATCCCAGCTACGTGGGGAGCTAGAGAATCACT","GGCTAGGCATGGTGGCTCATGCCAGTAATCCCACCACTTTGGGAGGCCGAGGCAGGTGGATCACCTGAGGTCAGGAGTTCAAGACCAGGCTGGCCAACATGTTATGATGAGACCCTCATCTCTACTACAAATACAAAAATCAGCTGGGCATGGTGGCAAGTGCCTGTAATCCCAGCTACTTGGGAGGCTGAGGCAGAA"
"GL873593","8598292","8598391","chr11","118461023","118461129","33","109862731","AGCCAGGTGAGGTGGTTCACACCTGTAACCCTAGCTGCTTGGGAGGCTGAGGCCTCTCTATCCTGGGCAGTGTGGAGAAACTTTGTTTCAAAAAAAAGAA","GCCGGGCGCGGTGGCTCACGTCTGTAATCCCAGCGCTTTGGGAAGCCGAGGCGGGACTATCCTGGCCAACATGGTGAAACCCCGTCTCTACTAAAAATACAAGAATC"
"GL873594","357249","357377","chr2","75702890","75703011","36","75345641","CCTGGTACCGTAGGTCATGCCTGTAATCCTAGCACTTTGGGATGCTGAGGTGGGCAGATTGCCTGAGCTCACGAGTTCAAGCCATTAGAACTGAGCCTGACCTAGAGTGGGACCTCCAACTCTTTTTTT","GCCAGGCACAGTGGCTCATGCCTGTAATCCCAGCAGTTTGGGAGGCTGAGGTGGGCAGATCACTTGAGGTCAGGAGTTCAAGACCAGCCTGGCTGACATGGTGAAACCCCATCTATACCAAA"
"GL873594","357656","357834","chr7","17608776","17608965","55","17251120","GGGACCTCCAACTCTTAAAATAGCTGGGCATTGTGGTGGGCACCTACAGTCACAGCTACTTGGGAGGCTAAGGCAAGAGACTTGTTTGCAGCCAAGAGTTAGAGGTTGCTGTGAGCTATGAGGCTAGGGCACTCTACAGGGGGCGACAAGTGAGACTGTAAAAAAAAAAAAAGAAAAAA","GTCCCTACTAAAAATACAAAAAATTAGCTGGGCCTGGTGGCAGGCACCTGTAATCCCAGCTACTTGGGAAGCTGAGGCAAGAGAATTGCTTGAACCCAGGAGGCAGAGGTTGCAGTGAGCTGACATCAAGCCACTGTACTCCAGCCTAGGCAACAAGAGCAAGACTCTGTCTCAAAAAAAAAAAAAAAAA"
"GL873594","1410711","1410996","chr5","151340503","151340797","76","149929792","CACAGTGGCTCATACCTATAATCCTAACACTCTGGGAGGCCAAGGTGGGTGGACTGTCTGAGTTTGGGACCAGCCTGAGCAAAAGCAAGACTCCCATCTCTACTAAAAACAAAGACAGCCAGGTATGAGGGCAGGTGCCTATCATCCCAGCTACTTGGGAGGCTGAGGAAGGAGGATCACCTAAGCCCAGGACTTTAAGGTTTCTGTGAACTAAGATGATGTTACAACACTCTAGCCAGGGTAACAAGGCAAGATTCTGTTTCAAAAGACAAAAAAAAAAAAAAAA","GGTGGTTCATGCCTGTAATCCCAGCACTTTGGGAGGCTGAGGCAGGTGGATCACCTGAGGTCAGGAGTTCGGGACCAGCCTGGCCAACATGGGGAAACCCCATCTCTACTAAAATACAAAAATTAGCCAGGTATGGTGGCACATGCCTATAATCCCAGCTACTTGGGAGGCTGAGGCAGGAGAATCACTTGAACCCAGGAGGCTAAGGTTGCAGTGAGCCGAGATTGTGCCACTGTACTCCAGCCTGGGTGACAGACTGAAACTCTGTGTCCAAAAAACAAAACAAAACAAAAAA"
"GL873594","5528090","5528162","chr2","69013639","69013718","24","63485549","GGTACAGTGGCTCACGCTTGTGATCCCAGGTTGAGGTGGGTGGATCGCCTGAGCTCAGGAGTTGGATGCCAGC","GGTGTGGTGCCTCACGCCTATAATCCCAGCACTTTGGGAGGCAGGTGGATCACTTGAGGTCAGGAGTTTGAGAACAGCCT"
"GL873594","5834047","5834168","chr2","82491537","82491662","28","76657490","GGCTGGGCCCAGTAGCTCACGACTGTAATCCCAGCACTCTGGGAAGCTGAGGTGGGCGGATCACCTGAGCTCATAGGTTCGAGACCAGCTCCAGTTAGAGTGAGAGCCTGTCTCTAAAAATA","GGCTGGGCACAGTGGCTCATGCCTGCAATCCCAGCACTTTGGGAGGCTGAGGTGGGCAGATCACCTGAAGTCAGGAGTTCAAGACCAGCCTGGCCAACACAGTGAAACCCCATCTCTACTAAAAAT"
"GL873594","5834396","5834461","chr13","14688151","14688212","20","8853755","TATATAATAATAATAACCAGGTATTGTGGCAGGTGCCTCTAGTCCCAGCTACTCGGGAGGCAAAGG","ATAAAAAAATTAGCTGGCCATGGTGGCACATACCAATAATCCCAGCTACTCAGGAGGCTGAG"
"GL873594","7786130","7786294","chr14","12217087","12217250","37","4430957","GGGTGTGCTGGCTCATACCTATAATCCTAGCACTCTGGGAGGCTGAGGTAGGTGTATTGCTTGAACCCAGGAGTCTGAGGTTGCTGTGCGCTAAGCTGATACCATAGCACTCTAGCCTGGGCAACAGAGTGAGACTCTGTCTCAAAACAAATAAATAGTAAAAAA","GCTGGGCGTGGTGGCTCACACCTGTAATCCCAGCACTTTGGGAGGCCAAGGCATGAGAATTGCTTGAAAACAGGAGGCGGAGGTTGCAGTAAGCTGAGACTGTGCCATTGCACTCCAGCCTGGGCAACAAGAGTGAAACTCTGTCTCAGAAAAAAAGAAAAAAA"
"GL873595","723579","723774","chr19","6045933","6046125","65","5322354","GCCTGAGCAGGAGAGAGACCCCATCTCTGCTGAAAGTGGAAAAGTTGGCTGAGTGTAGTGGCGGGCTGCTGCCCCAGTCACTCAGGAGGCTTAGGAAGGAGTATCGCTTGGGCCCAAGATTTGAGGTTGCTGTGAGCGCTACAAAGACATTAGGGTACTCTACACAGGGGAATAGAGTGAGACTGTCTCAAAAAAA","CAACATGGAGAAACCCCGTCTCTACTAAAAATACAAAATTAGGCAGCGTGGTGGTGGGTGCCTATAATCCCAGCTACTCAGGAGGCTGAGGCAGGAGAATCGCTTGACCGGGAGTGGAGGTTGCGGTGAGCTGAGATTGCACCATTGCACTCCAGCCTGGGCAACAAGAGTGAAACTCCGTCTCAAAAAGAAA"
"GL873595","724114","724204","chr20","18199749","18199840","22","17475635","GGCCATGCTTGGTGGTTCTCATCTGTAATCCTAGCACTCTGGAAGGTCTACAGGGGTGGATGGCTGGAGGTCAGGAGTTCAAGACTGGCCT","GGCCGGGCATGGTGGCTCACACCTGTAATCCCAGCACTTTGGGAGGCTGAGGCAGGCGGATCACCTGAGGTCAGGAGTTCGAGACCGGCCTG"
"GL873595","1065346","1065667","chr18","10529729","10530057","74","9464383","GGCCAGGTGCAGCAGCTCATGCCTGGAATCTTCCTGCTCTGTATGGCCAAGGCAGGTGGATCGCCTGACCTCAGGAGTTCCAGACCAGCCTGAACAAGAGCAAGACTCTGTCTCTACTAAAAGTAGAAAAAAAACTAGCCAGTCATAGTGGCAGGTGCCTGTAGTCCCAGCTGCTTGGGAGGCTGAGGCAAGAGGATCACTTGAACCTAAGAGTTTGAGGTTGCTGTGAGCTAAGATGCCACATCACTCTATCAAGGGTGACCAAGTGAGACTCTGTCTCAAAAATAAATAAATAAATAAATAAAAAGAAAGGCAAAAAGAA","GGCCCGGCGTGGTGGCTCATGCCTATAATCCCAGCCCTTTGGGAGGCCAAGGCAGGTGGATCACCTGAGGTCAGGCGTTCGAGACCAGCCTGACCAACGTGGTGAAACCTCATCTCTACTAAATACAAAAAAAATTTAGCCAGGCATGGAGGCACATGCCTGTAATCCCAGCTACTTGGGAGGCTGTGGCAGGAGAATCACTTGAACCTGGGAGGTGGAAGTTGCAGTGAGCTGAGATTGTACCACTGCACTCCAACCTGGGTGACAAAGCAAGACTCGGTCTCAATAAATAAATAAATAAATAAATAAATAAATAAAGTGAAAAAAAA"
"GL873595","1254878","1255146","chr4","42822326","42822607","67","41567448","GGCTGGGCATGGTGGCTCATGCCTGTAATCCTACCGCTCTGGGAGGCTGAGGCAGAGGATCACTTGAGCTCAGGAGTTTCAGACCAGCCTGCAAGAAGGACCCAGTCTCTGCCGAAAATAGAAAAGTTAGCAAGGCGTTGTCGTGAGCACATGTATCCCAGCTACCTAGAACTCTGAGGCAGGAGGATCCCTTGAACCCACAGAAGTTGCTGTTATCTAAACTGATGCCACTGGACTCTAGCCTGGGCAACAGAGTGAGACTGGTCTCA","GGCCGGGCACGGTGGCTCATGCCTGTAATCCTAGCATTTTGGGAGGCTGAGACAGGCAGATTGCCTGAGCTCAGGAGTTCAAGACCAGCCTGGGCTAGATTGTGAAACCCCATCTCTACTAAAATATAAAAATTAGCTGGGTGTGGTGGCACACGCCTGTAATCCCAGCTACCTGGGAGGCTGAGGCAGGAGAATCGCTTGAACCAGGAGACAGAGGTTGCAGTGAGCTGAGATCACGCCACTGCACTTTAGCCTGGGCAACAGAGTGATACTCTGTCTCAA"
"GL873595","3417105","3417297","chr12","115674238","115674427","44","112257133","GGCCGGGCGCTGTGCCTCACGCCTGTAATCCTAATACTCTGAGAGGCCGAGGCAGGTGGATTGCCTGAGCTCAGGTGCTCAAGACAGCCTGACTGAGCAAGCCCTGAGATCCCATCTCCACTAACAATAGTAAAACTAGCCGGGCATTGTGGTGGTGCTTGTAATCCCAGCTACTGGGAGGCTAAGACAGGAG","CCAGGCCTGGTGGCTCACGCCTGTAATCCCAGCACTTTGGGAGGCCGAGGTGGGTAGATCACCTGAGGTCAGGAGTTCAAGACCAGCCTGGCCAACATGGCGAAACCCCATCTCTACTAAAAATACAAAAATTAGCTGGGCATGGTGGTGTATGCCTGTAATCCCAGCTACTCGGGAGGCTGAGGCAGGA"
"GL873595","6098380","6098457","chr3","87492619","87492702","21","81394239","GCTGTGGCTCATGCTGATAATACCAGCACTCTGGGAGAACAAGGTAGGCAGATCACAAGAGGTCACCTGTGCAAGACC","GGGCTGGTGGTGGCTCATGCCTGTAATACCAGCACTTTGGGAGGCCAAGACAGGTGGATCACCAAAGGTCAAGAGTTCAAGACC"
"GL873596","134190","134307","chr1","203207333","203207443","31","203073143","GGCTGGGCGAGGTGGCTCACACCTGTAATCCTAGCACTCTGGAAGGCCCTAGCACTCAGGCAGTTGGATTGCCTGAGCTCACAAGTTCAAGACCAGCCTGAAAAAGAGCAAGACCTCA","GGCTGGGTGCAGTGGCTCACACCTGTAATCCCAGCACTTTGGGAGGCCGAGATGGGTGGATCACTTGAGGTCAAGAGTTGAAGACCAGCCTGGACAACATGATGAGACCCC"
"GL873596","134578","134681","chr11","50235285","50235387","37","50100707","CAAACAAAAGAGGAAGACCTCGTCTCTAAAAAAATAGCTGGGCATTGTGAGGAGTACCTGTAGTCCTAGCTACTCAGAAGGCTGAGACAAGAGAATCACTTAAA","CAACATTGTGAAACCCTGTCTCTACTAAAATAGAAAATTAGCCAGGTGTGTGGGCGTGCCTATAATCCTAGCTACTGGGGAGGGTGAGGCATGAGAATCGCCT"
"GL873596","8160215","8160350","chr1","29437872","29437991","30","21277657","GGCCGGGCGTGGTGGCGCACACCTGTAGTCCCAGCGCTATGGGAGGCCGAGGCGGGTGGATCACCTGAGCTCAGAGGTTCGAGACCAGCCAAGACCCCCCTGAGCCAAACGAGCCAGAGTGAGACCCCGTCTCTAC","GGCCGGGCGTGGTGGCTCACGCCTGTAATCCCAACATTTTGGGAGGCCAAGGCGGGTGGATCACCTGAGGTCAGAAGTTCGAGACCAACCTGGCCAACATGGTGAAACCCCTGTCTCTAC"
"GL873596","8421071","8421132","chr20","1874027","1874093","12","6547044","GTCAGGCGCAGTGGCTCACGCCTGTAATCTCAGCACTCTGAGAAGCCAAGGCAGGATCATCT","GGCCAGGCGCAGTGGCTCAGGCCTGTAATCCCAGCACTTTGGGAAGCCAAGGTGAGCAGATCACCTG"
"GL873598","4416400","4416489","chr5","39418145","39418231","15","35001745","GGCCAAGTGTGGTGGCTCATGCCTGTTGTCCCAGCACCGTGGGAGGCCGAGGCTGGTGGAACACCTGAGCTCAGCTGAGTTTGAGACCAG","GGCCAGTTGCGGTGGCTCATGCCTGTAATCCCAGCACTTTGGCAGGCTGAGGCAGGTGGATCACCTGAGGTCAGGAGTTTGAGACCA"
"GL873598","4416855","4416947","chr3","94091253","94091337","31","89674398","GTGAGACCCTGTCTCTACAAAAAAAAAAGCTGGGCACTGTGGCATGTGCCTGTAATCCCAGCTACTTGGGAGGCAAAGGGAAAGAGAATCACT","AAACCTTGCCTTTACTAGAAATACAAAAATTAGCTGGGCATGGTGGCAGGTACCTGTAATCCCAGCTACTTGGGAGGCTGAGGCA"
"GL873598","5126074","5126161","chr1","12339306","12339394","19","7213232","GCCTGGTGCACTGGTTCACACCTGGAATCCTTGCATTCTGAGAGGCCCAGGTAGGCAGATCACCTCAGCTCAGAAGTTCGAGACCAGC","GCTGGGTGCGGTGGTTCACGTCTGTAATCCCAGCACTTTGGGAGGCCGAGGCGGGCAGATCACCTGAGGTCAGGAGTTCGAGACCAGCC"
"GL873598","5467584","5467662","chr1","9313328","9313403","17","3845744","GCGAGGTGGCTCACGCCTGTAATCCCAGCACATTTGGAAGGCCAAGGAGGGTGGATCACCCGAGCTCACCAGTTGGAGA","CGCAGTGGCTCACGCCTGTAATCCCAGCACTTTGGGAGGCCGAGGCAGGCAGATCACCTGAAGTCAGGAGTTTGAG"
"GL873598","6917752","6917856","chr14","9558287","9558382","22","2640535","GGCCAGGCATGGTGGCTTGTGCCTGTTGTCCCAGCACTGTGGAAGGCCGAGGCGGGTGGATCGCCTGAGCTCAGCTGAATTCGAGACCAGCATAAGACCAGTATG","GGCCAGGCATGGTGGCTTATGCCTGTAATCCCAGCACCTTGGAAGGCCGAAGCGGGCAGATCACCTGAGCTCAGGAGTTTGAGACCAGCCTGTCCA"
"GL873598","8078910","8079062","chr7","164825511","164825660","43","156746601","AACAGCCAGGCATTGTGGTGGGCACCTGTAATCCCAGCTACTTGGGAGGCTGAGGCAAGAGAATTGCTTGAGCCCAACAGTCTCAGGTTACTGTGAGTTATGACACCATGGCACTCTATTGAGGGCAAGAAAGTGAGACTGTCTTGGAAAAAA","CTAGCCAGGCATGGTGGTGCGCACCTGTAGTCCCAGTTACTTGGGAGGTTGAGGCAAGAGAATTGCTTGAGCCTGGAAGGCAGAAGTTGCAGTGAGCTGAGATCACACCACTGCATTCCAGCCTGGGCGAAAGAGCAAGACTCTGTTGAA"
"GL873598","8079328","8079454","chr6","10381248","10381379","32","2301920","GCCCGGCGTGGTGGCTCACGCCTGTAATTCCAGCACTCTGGGGAGGCCGAGGAGGGCAGATTGCCTGAGCTCACAGGTTTGAGCTAGAGCGAGACCCTGTCTCTTAAAAAGAAAAAAAAGGAAAGAA","GCTGGGCGCGGTGGCTCACGCCTGTAATCCCAACACTTTGGGAGGCCGAGGCGGGCAGATCACCAGAGGTGATCTCCAGCCTGGGCAGGAGAGCAAGACCCTGTCTCAAAAAATTTAGAAAAAGGAAAGAAA"
"GL873599","3943256","3943456","chr9","35892110","35892312","79","31948854","GGCAGGCTGCTTTGACCCATATCTACAACTCCAGAACTTTAGAGGCTGAGCTGGGTGGGTCCCTTGAGATTAGAAACTGCTTAGTAGCCTGGCAAAAACCAGACCCCACCTCCACCATGTAGAAAAATTAGCAGTATGCCATAGTGGGAACCTACCAATACAGTCTTTCCAAAGGCCAAAGCTAGAAGGACCGTGAGCTTG","GGCTGGGTGTGGTGGCTCATGCCTATAATTCCAGCACTTTGGGAGGCCGAGGCAGGTGGATCACCTGAGGCCAGGAGTTTGAGACCAGCCTGGCCAATATGGTGAAACCCCATCTCTACTAAAAGTACAGAAAATTAGTCAGTCATGATGGCGCATGCCTATAATCCCAGTTACTCGGGAGGCTAAGGTAGGAGAATTGCTTG"
"GL873599","6693284","6693349","chr1","100916857","100916922","15","94223573","TCACGTCTATAATCCTAGCACTCTGGGAGTCCTTGGCAGGTGGATCACCTGAGCTCAGGAGTTTGA","CATGCCTGTAATCCCAGCACCTTGGGAGGCCAAGGTGGGTGGATCACCTGAGGTCAGTAGTTTGAG"
"GL873600","991618","991705","chr15","13850109","13850195","15","12858491","GGCTGGGCGTGGTGGCTCACACCTGTTGTCCCAGCGCTGTGGGAGGCTGAGGCAGGTGGATCACCTGTGCTCAGAGGTTGAGACCAGC","GCCGGGCGCTGTGGCTCACACTTGTAATCCCAGCACTTTGGGAGGCTGAGGCAGGTGGATCACCTGAGGTCAGGAGTTAGAGACCAG"
"GL873600","8825981","8826014","chr16","43605817","43605844","11","34779836","AGTCTGGGGCAACAGAGCAAGACTCTGTCTCAAA","CAGTCTGGGTGACAGAGCAAGATTCCAT"
"GL873600","8826039","8826157","chr13","87428402","87428520","35","78602363","ATTAGCCTGGTGTGGTGGTATATGCCTTCCTGCCTGCTTGGGAGGCTGAGGCAGGAAGTATGCTTTAACTGTGGAGTCTGAGGTTGCTATGAGCTAGGTTGAGGCCATGGCACTCTAAA","TTAGCCGGGTGTGGTGGTGCACGCCTGTAATCCCAGCTACTCAGGAGGCTGAAGCAGGAGAGTTGCTTGAACCCAGGAGTTGGAGGTTGCAGTGAGCTGAGATCACGCCATTGCACTCC"
"GL873601","269289","269338","chr14","49279240","49279285","14","49009951","GACTGGGTGTGGTGGCTCACACCTTTAATCCTAACACCCTGGGAGGCTTA","GGCTGAGATGGTGGCACACACCTGTAATCCCAGCTACTTGGGAGGC"
"GL873601","269431","269678","chr1","184453273","184453521","76","184183842","AGAAGATCACTCAAGATCAGGAGTTTGAGAACAGCCTGAGCAAGACCCCCATCTTTACTAAAAATGGAAAAGTTTTTACCCAGGCATGGTAGTGCGTGCCTGTATCCCATCTACTCCGGAGGCTGATAGGAGGATTGCTTCAACCAAGGAGTTTGAGGTTCCAGAGACTTAAGATGACACAACTGCATTTTACCCAGTGTGACACAGCGAGACTCTTTCAGAAGAATTTTTAAAAGGAAAAAAAAGAA","GGTCAGATCACCTGAGGTCAGGAGTTTGAGACCAGCCTGACCAACATGGTAAAACCCCATCTCTGCTAAAAATACAAAAAATTAGCCAGGCATGGTGGTGAACGCCTGTAATCCTAGCTACTCAGGAGGCAAAGACAGGAGAATCGCTTGAATCTGGAAGGTGGAGGTTGCAATGAGCCAAGATGACGCCACTGCACTCCAACCTGGGTGACAGAGGAAGACTCCATCAAAAAAAAAAAAAAAAAAAAA"
"GL873601","1397978","1398117","chr16","24839455","24839591","34","23441477","GCCTATAATCCTAGCACTCTGGAAGGCTGAGGCAGGAAGATCACTAGAGCTTGGGAGTTTGAGATTGCTGTGAGGGAGACTGACTCCATGGCACTCTAGCCTGAGGCAACAGAGTAAGACTCCATCTCAAAAAAAAAAAA","CTCTAACTCCAGCTACTCAGGAGGCTGAAGCAGGAAAATCACTTGAACCTGGGAGGTGGAGGTTACAGTGAGCCAAGATCACACCATTGCACTCCAGCCTGAGCGACAGAGCGAGACTCTGTCTCAAAATAAATAAA"
"GL873601","4065502","4065590","chr11","108711352","108711444","19","104645850","GCTGGATGTGGTGGCTCTCACCTATAATCCTAGCACTCTGGGAGGTCAAAACAGGTGGATCACCTGAGCTCAGGAGCAAGAACACCAGC","GTCAGGGGTGGTGGCTCACGCCTGTAATCCCAGCACTTTGGGAGGCCAAGGCAGGTGGATCGCCTGAGCTCAGGAGTTCAAGACCAGCCTTGC"
"GL873601","8241370","8241465","chrY","9469734","9469829","34","1228364","AAAAAAGGTGGAGATGAGCCATGCGCAGTGGTGTAGGCCTGTAATCCCAGCCCTTGGGAGGCCAAAATGGTGGATTGCCTGAAGCAGAGCAAGACC","AAAGTACAAAGAGTCTGGGTACAGTGGCCCAAGCCTGTAATCCCAGCAGTTTGGGAGGACAAGATGGGTAGATCACCTGACATCATGAATTAGAGA"
"GL873569","7519122","7519191","chrX","79016364","79016431","16","71497242","TTGGCCAGGCATGGTCGCTCAGGCTGTAATACCAGCTACTTGGGAAGCTGAAGCAGGAGGATCACTTGAA","TTGGCCAGGCACGGTGGCTCATGCTTATAATCCCAGCTACTCGTGAGGCTGAGGCAGGGGAATCGCTT"
"GL873569","7989158","7989286","chr8","41505677","41505810","35","33516519","AGTCCCACCTATTTGGAAGGCTGAGGCAAGAGGATCACTTGAACTCAGCAGTTTGACATTGCTATGAGTTAGATTGACTCCATGGCACTCTAGCCCAGGCAACAGAGCAAGACTCCGTCTCAAAACAAA","TAATACCAGCTACGTGGGAGGCTGAGGCAGGAGAATCACTTGAACCCGGGAGGTGGAGGTTGCAGTGAGCTGAGATTGCACCGTTGCACTCTAACCTGGGCAACAAAAGCAAAACTCTGTCTCAAAAAAAAAAA"
"GL873569","7989575","7989702","chr1","62231025","62231129","47","54241450","GGCTGGGTAATGCAGTGGCTCACGCCTATAATCCTAGTGCTTTGAGAGGCCAAGAGTGAGACTCTGTGTACTAAAAATAGAAAAATTACCTAGGCATTCTGGTGGGCACCAGTAGTCCCACCTATTTG","GGCTGGGCATGGTGGCTCACGCCTATAATCCCAGCACTTTGGGAGGCCGAGGCAGGTGGATCACCTGAGATCAGGAGTTTGAGACCAGACTGGCCAACATGGTGA"
"GL873569","10034363","10034556","chr10","61268396","61268605","62","51234033","CAGCTTGAGCAAAAGTGAGCCCCTGTCTCTACTGAAAATAGAAAAAATTAGCCAGGCGTGGTGGCACACACTTATAGTCCCAGCCACTTAGGAGGCTGAGGCAGGAGTTTGAGGTTGACATAATCTAAGCTGATACCATAGCACTCTAGCCTGGGCAATAGAGTGAGACTCTGTCTCAAAGAAGAAATTTATCT","CCTGACCAATGGTGAAACCCTGTCTCTACCAAAAATACAAAATTTAGCTGGGCATGGGGGCACGCACCTGTAGTCCTAGCTACTCGGGAGGCTGAGACAGGAGAACTGCTTGAACTCGGGAGGCAGAGGTTGCAGTGAGCTGAGATCATGCCACTGCACTCTAGCCTGGGCAATAGAGTGAGACTCCGTCTCAAAAAAAAAAAAAAAAAA"
"GL873569","10034830","10034845","chr1","217667782","217667796","2","207632952","AAAAAAGAAGAAAAAA","AAGAAAAAGAAAAAA"
"GL873569","10203815","10203922","chr8","96374555","96374671","35","86170740","GCCAGGTGTAGTGGTTCACACCTATAATCCTAGCACTCTGGGAGCCTGAAGCAGGTAAATGGACTGAGCAAGAGTGAGACTTCCACCTCTATTGAAAATAGAAAAATT","GGCTAGGTATGGTGGCTGATGCCTATAATCCCAGAATTTTGGGAGGCCGAGGCAGGCAGATCATCTGAGGTCAGGAGTTTGAGACCAGTCCCGTCTCTACTAAAAATACAAAAATTA"
"GL873569","10204196","10204373","chr20","1304385","1304559","47","8899811","GAAAATAGAAAAATTAGCCAGGCATTATAGCAGGCACCAGTAATCCCAGTTACTTGGGAGGCTAAGGCAAAAGAATCTCTTGAGCCCAAGTTTGGGGTTGCTAGGAAGTAAAACACCACAGCACTATACCCAGAACAAGAGAGTGAAGACTCAGTCTCAAAAAGATAAATAAATAAAA","AAAAATACAAAAATTAGCCAGGCATGGTGGCGGGCGTCTGTAACTCCAGCTACTTGGGAGACTGAGGCAGGAGAATCGCTTGAACCCAGGAGGCAGAGGTTACAGGTGAAATCACACCACTGCACTCCAGCCTGGGCAACAGGGCAAGACTCTGTCTCAAAAAAAAAAAAAAAAA"
"GL873569","10473375","10473444","chr8","20660648","20660717","21","10187273","TGTAGTCCCAGCACTTTGGGAGGTTAAGGCAAGAGTAGCACCCAACATGAGGAGATCAAGACCAATCTGG","CTGTAGTCCCAGCACTTTGGGAGGCTGAGGCAGGTGGATCCTTTGAGGGCAGAACTTTAAGACCAGCCTG"
"GL873570","9287350","9287485","chr1","29437872","29437991","30","20150522","GGCCGGGCGTGGTGGCGCACGCCTGTAGTCCCAGCGCTATGGGAGGCCGAGGCGGGTGGATCACCTGTGCTCAGAGGTTCGAGACCAGCCAAGACCCCCCTGAGCCAAACGAGCCAGAGTGAGACCCCGTCTCTAC","GGCCGGGCGTGGTGGCTCACGCCTGTAATCCCAACATTTTGGGAGGCCAAGGCGGGTGGATCACCTGAGGTCAGAAGTTCGAGACCAACCTGGCCAACATGGTGAAACCCCTGTCTCTAC"
"GL873571","3669989","3670207","chr4","116777080","116777297","60","113107091","AGACCAGCCTGAGGAAGAGCAAGATCCCATCTCTATTAAAAATAGAAAAATTAGCCAGGCATTCTGGTGGGCACCTGTAGTTCTAACCACCTGGGAGGCTAAGGCAAGAGGAACTCTTCAACCCAAGAGTTTGAGGTTGCTGAGAGCTAGGCTAAGGCTGCAGCACTCTAGCCTGGGCAACAGAGTGAGACTGTTTCTCAAAAACAAAAAACAAAAAAA","CGAGACCAGCCTGGTCAATATGGTGAAACCCCGTCCCTACTAAAAATACAAAAATTAGCCAGGCATGGTGGCAGGCACCTGTAGTCCCAGCTACTCGGAAGGCTGAGGCAGGAGAATCGCTTGAACCACAGAGGCAGAGGTTGCAGTGAGCCGAGACTGCACCACTGCACTCCAGCCTGGGCGACAGAGTGAGACTCAGTCTCAAAAAAAAAAAAAAA"
"GL873571","106134","106236","chr4","18143723","18143826","27","18037589","GGCCAGTCTCAGTGGCTCACACCTGTAATCCAGCATTCTGGGAGGCTGAAGCACACGGTCACCTGAGCTCAAAGGTTGGAGACCAGAGTGAGACCCCACCTCT","GGCCAGGCGCAGTGGCTCACTCCTGTAATCCCAGCACTTTGAGGCTGAGGCAGGCGGATCACCTGAGGTCAGGAGTTTGAGACCAGCCTGGCCGAAACCCCATC"
"GL873571","3670496","3670589","chr7","50468399","50468491","15","46797903","GGGCAGGCATGGTGGCTCACACCTGTAATTCTAGCACTCTTGGAGGCTGAGGCAGGAAAATGGCTTGAGGTCAGGAGTTCAAGACCAGCCTGAG","GGCCAGTCATGGTTGCTCACACCTGTAATACCAGCACTTTGGGAGGCCGAGGCAGGCGAATCACCTGAAGTCAGGAGTTCAAGACCAGCCTGG"
"GL873571","4059090","4059389","chr7","52903696","52903994","88","48844606","GGCCAGGTGCAGTGGTTCACACTTATAATCCTAGCACTCTGGGAGGCCGAGGCGAGTGAAGTGCCTGAGCTCATGGGTTCAAGACCAACCTAAGCCAGAGACCCCTGACTCTTATAATAGCCTGGCATTGTGGTGGGCGCCAATATTTCCAGCTACTCTGAGGCTAAGGCAAGAGAATTGCTTGAGCCCAGGAGTTGGAGGTTTCTGTGAGCACTGACGCCGCAGCTCTCTACCAAGGGCAACAAAGACTCTGTCTCAAAAAATAAATAAATAAATAAATAACAGAATGAAAATGAAAAA","GGCCGGGTGCGGTGGTTCACGCCTGTAATCCCACCACTTTGGGAGGCTGAGGCAGGCAGGTCACCTGAGGTCAGGAGTTCCAGACCAGCCTGGCCAACATGGTGAAACCTTGTCTCGGCTATTAGCCTGGCATGGTGGTGCGTGCCCATAATCCCAGCTACTCAGGAGGCTGAGGCAGGAGAATCGCTTGAACCCAGAAGGTGGAGGTTGCAGTGAGCCAAGATAGCACCACTGCAACTCCAGTCTGGGCAACAGAATGAGACTCTGTCTCAAAAAAAAAAAACAAAAAACAAAAAGAA"
"GL873571","4209418","4209704","chr11","32517699","32517985","80","28308281","GGCTTGGCAAGGTGGCTTACACCTCAAATCCTAGCACTGTGGGAGACTGAGGCAGGTGGATTGTTTGAGCTCAGGAGGTCAAGATAGAGAGCAAGAGCAAGTCTCTGTCTCTACTAAAAATAGAAAAGAACTACTTCCCGGGGGTCATGGCAGTAGCCTGTAATCCCAGTTACTAGGTAGAATGAGGCAAGAGGATCTGTTGAAGCCAAGAGACTGAGGTTGTTATGAGCATGCCACAGCACTCTACCCAGGGTGACAGAATGAGACTCTGTTGAAAGAAAAAAAGA","GGCCGGGTGCAGTGGCTCACACCTGTAATCCCAGCACTTTGGGAGGCTGAGGCGGGTGGATCACCTGAGGTCAGGAGTTCAAGACCAGCCTGACAAACATAGTGAAACCCTGTCTCTACTGAAAATACAAAATTAGCCAGGTGTGGTGGCGCATGCCTGTAATCCCAGCTACTCGGGAGGCTGAGGCAGGAGAATTGCTTGAATCCAGGAGGTGGAGGTTGTGTGATCACACCACTGCACTCCAGCCTGGGCGACAGAGTGAGACTCTGTCTCAAAAAAAAAAGAAA"
"GL873571","4209985","4210154","chr3","175781758","175781928","60","171571773","GAAAGAAATGAAAAGAAAGAAGTTAGCTGGTTGTTGGGGTATGCTTCTATAGTCCCACCTACTCAGAAAGCTGAAATCTGGAGTTTGGGGTTGTTGTAAGGTAGGCTGATGACATAGCACTGTAGCTTGGGCAAGAGAGTGTGACTTTGTCTCAAAAAAAATTAAAACAA","ATTAAAAACACAAAGATTAGCCAGGTGTGATGGCACACAACTGTAATCCCAACTACTCAGGAGAATCGCTTGAACCTGGGAGATAGGGTTTGCAGTGAGCCAAGATTGTGCCACTGCACTCCAGCCTGGGTGACAGAGTGAGACTCTGTCTCCAAAAAAAAAAAAAAAAAA"
"GL873571","4210444","4210570","chr17","16655655","16655789","35","12445211","GCCAGGCAGATGGCTCACACTTCATCCTAGCCCTCTGGAAGGCTGAGGCAGGCTAATTTTTTGAGGTTAGGAGTTTGAGACCAGCCTGAGGAAGAGACCCATCTCTACTTTAAAAAATAAATGGAAA","GCCAGGCATGGTGGCTCACACCTGTAATCCTAGCACTTTGGGAGACTGAGGCGGGTGAATCACCTGAGGTCAGGAGTTTGAGACCAGCCTGACCAGTATGGTGAAACCCAGTCTCTACTAAAAATACAGAAATTA"
"GL873571","4391733","4391878","chr11","33723808","33723943","46","29332075","AACTTAGCTGGGAATGGTGGCTCAAGCCTGTAATCCTAGCACTCTGGGAGGCTCAGGTGGGAGGATCACTTGAGGTTGCTGTGAGCTTGGCTGATGCCAGGACACTCTAGTGTGGGCAAGAGAGTGAGACTCCGCCTCAACAACAA","GCCGGGTGCAGTGGCTCATACCTGTAATCCCAGCACTTTGGGAGGCTGAGGTAGGCGGATCACGAGGTCAGGAGCTGAGATGGCGCCACTGCACCCCAGCCTGGGTGACAGAGCAAGACTCTGTCTCAAAAAAAAA"
"GL873571","6307773","6307841","chr9","62429628","62429694","22","56121855","CTGGGTGTGGTGGCATTGCACCTGTAATCCTAGCTACTTGGAAATCTTAAGCCCAGGAGTTGAAGACTG","CCCAGCATGGTGGTGCATACCTATAATCTCAGCTACTTGGAGGCTTGAGCTCAGAAGTTTGAGACCG"
"GL873571","6496217","6496306","chr1","27257765","27257856","27","20761548","GCAGGGTGTGTTGACCCACACCCACAATTCCAGGACTCTGGGGGGCCAGGGATGGTGGGTTCCCTCAGATCAGGAGCTCCTTACCAGCCT","GACTGGGCATGATGGCTCAAATCTGTAATTCCAGCACTTTGGGAGGCCGAGGTGGGTGGATTGCCTGAGATCAGGAGTTCAAGACCAGCCTG"
"GL873571","6499738","6499903","chr1","38976375","38976555","47","32476637","AAAATAACATGAATTGACTAGGCGAGGTGGCTCACATCTCTAATCCTAGCACTCTGGGAGGCTGAGGCAGGAGAATTGCATGAGGTTGCTGTGAGCTATGATGATACCACGGCATTCTAATCAGGGTGACAGAGTGAGATTCTGTCTTAAAACAAACAAACAAAAA","AAAATAAATAAATTAGCAGGGCCTGGTGGCGCACACCTGTAATCCCAGCTACTTGGGAAGCTGAGGCAGGAGAACCCACTTGAACCTGGGAGCCGGAGGTTGCAGTGAGCTGAGATGGCACCACTGCACTCCAGACTGCGTGACAGAGTGAGACTCCGTCTCAAAAACAAACAAACAAAAA"
"GL873571","11399575","11399872","chr15","109458692","109458994","79","98059117","CAGTGGCTCACACCTGTAAATCTAACACTCTGGGAGGCCAAGGTGGGTGGATCCCTTGAGCTCAGGAATTTGATACCAGCCTGAGCAAGAGTGAGACCTTGTCTCTACTAATAATAGAAAAATAGCCCGTGTTGTGGCACTTGTCCCAACCACTGGGGAGGCTTTAGGCGGGAGGATTACTTGAATTGGGAGTTTGATATTGCTGTGAGCTGGGCTGATGCCTTGGCATTCTAGCTTGGGTAACAGCGTAAGACTCCGTCTCAAATAAATAAATAAATAAATAAAAAGAAAAAAAGAA","GTGGCTCACACCTGTAATCTCAGCACTTTGGGAGACCGAGGCAGGTGGATCACCTGAGGTCGGGAGTTTGAGACCAGCCTGACCAACGTGGAGAAACCCCGTCTCTACTAACAATACAAAATCAGCTGGGCGTGGTGGTGCATGCTTGTAATCCCAGCTACTCGGGAGGCTGAGGTAGGAGAATCGCTTGAACCTGGGAGGTGGAGGTTGCGGTGAGCCGAGATCGAGCCACTGCACTCCAGCCTGGGTGACAGAGCAAGACTCCATCTCAAAAAAAAAAAAAAAAAAAAAAAAAAAAAAAAA"
"GL873572","114760","114841","chr8","26280134","26280211","16","26165374","GGCCAGGCATGGCGGCTCTTCCCTGTAATCCTAGCACTCTGGGAGGGCGAGGCAGGCAGATCACCTAGGCTAGGGTGAGATC","GGCCAGGAATGGTGGCTCATGCCTGTAATCCCAGCACTTTGGGAGGCTGAGGCAGGCAGATCACCTGAGGTCAGGAGT"
"GL873572","9421791","9421892","chr11","8089184","8089269","35","1332607","TACTAAATATATAGCAAGGCCAGGCACAGTGGTTCATGGCTGTAATCCCAGTACTCTGGGAGGCCTAGTCAGAGTTGACCTGAGATCAGGCTAGAAGCCTGG","ATAAAAATAATTGGAGGCCAGGCACGGTGGCTCATGCTTGTAATTCTAGCAATTTGGGAGGCTGACGCGGGTGAGATCATACTGAG"
"GL873572","11052834","11053035","chr14","11857478","11857657","65","804644","TCCACAAAGAAAGCAGAAGTGTGGCCGGGTGGTAGCTCAAGGCAGGAATCCCAGCACTCTGGGAGCTGGGAGGTGGGGGAGGATCCCTTGAGATCAGGAGTTGGAGGGCACAGTGAGCCTGGGGGAGGCCACTGTCTCTGTACTCTAGCAGGGAGACAGAGCAAGACTGCCCATTCAAAGAAAAACAACAAACAAAACAAAA","TACAAAAATTAGCTGGGCACGGTGCCACAAGCCTGTAATCCCAGCTACTCGGGAGGCTGGGCAGGGGAATAGCTTGAACCCAGAGGTGGAGGTTGCAGTGAGCCAAGATCAAGCCACAGCACTCCAGCCTGGGTGACAGAGCAAGACTCCATCTCAAAAAAAAAAAAAAAAAAAAAAAAA"
"GL873573","2564195","2564244","chr1","109985445","109985491","12","107421250","TACAAAAATTAGGCTGGGCTTGGTGGTTCACGCCTATAATCCTAGCACTT","ACTAAAATTAGCTGGGCATGGTGGTGCATGCCTGTAATTCCAGCTAC"
"GL873573","7423371","7423533","chr2","202783328","202783513","56","195359957","GGTGGCTCACACCTGTAATCCCAGCACTCTGGGAGCCCTGGTGGCTCATGTCTATAATCCTAGTACTCTGGGAGACCATGGTGGCTCATGTCTATAATCCTAGTACTCTGGGAGCCATGGTGGCTCACGCCTATAATCCTAGTACTCTGGGAGACCATGGTGG","GGCTGAGGCGCGGGGGCTCACGCCTGTAATCCCAGCACTGTGGGAGGCCGAGGCGGGTGGATCACGCCTGTAATCCCAGCACTGTGGGAGGCCAAGGCGGGTGGATCACGCCTGTAATCCCAGCACTGTGGGAGGCCGAGGCGGGTGGATCACGCCTGTAATCCCAGCACTGTGGGAGGCTGAGGC"
"GL873573","9657648","9657710","chr19","10207852","10207913","10","550204","TAAAAATAAAAAATTTAGCTGGATGTGGTGGCTCACACCTGTAATCCTAGCACTCTGGGAGAC","TAAAAATACAAAATTAGCTGGGTGTGGTGGCACACACCTGTAATCCCAGCTACTCAAGAGGC"
"GL873574","1624662","1624783","chr9","814961","815079","36","809701","GACTGGGTGGGTTGGATCATGCCTGGAATCCTAGCACCCTGGGAGGCCAAGGTGAAAGGATTGCTTGAGGTTAGGAGTTCCAGAAATGTAGCAGTCATGGTGACTTCATCCTTCTCTACCAA","GGCTGGGTGCTTTGATTCATGCCTGTAATCCCAGCACTCTGGGAGGCCGAGGCAGGTGGATCACCTGAGGTTAGGAGTTCGAGACCAGCTTGGCTAACATGGTGAAACCTCGTCTCTAC"
"GL873574","4459477","4459612","chr1","29437872","29437991","29","24978395","GGCCGGGCGTGGTGGCGCACGCCTGTAGTCCCAGCGCTATGGGAGGCCGAGGCGGGTGGATCACCTGAGCTCAGAGGTTCGAGACCAGCCAAGACCCCCCTGAGCCAAACGAGCCAGAGTGAGACCCCGTCTCTAC","GGCCGGGCGTGGTGGCTCACGCCTGTAATCCCAACATTTTGGGAGGCCAAGGCGGGTGGATCACCTGAGGTCAGAAGTTCGAGACCAACCTGGCCAACATGGTGAAACCCCTGTCTCTAC"
"GL873574","4681987","4682216","chr6","153082888","153083127","73","148400901","GGGTGCGGTGGCTCAGACCTATAATCCCAGCACTCTGAGAGGCCGAAGTGGGTGGATCACCTGAGCTCAGGAATTTGAGACCAGCCGTCTCTAAAAATAGCTGAGTGTTGTGGCAGTGGCTGTAAGTCCCAGCTGTTTGGAAAGCTGAAGCAAGGGAATCACTTGAACCCAAGAGTTTGAGGTTGCTGTGATGACAAAGTGAGACTCTATCTCAAAAAAAAAAAAAAAAA","GGCCGTGCGCGGCGGCTCACGCCTGTAATCCCAGCACTTTGGGAGGCTGAGGTGGGTGGATCACCTGAGGTCAGGAGTTTGAGACCAGCCCGACCAGAAATTAGATGGGTGTGGTGGTGCGCTCCTGCAGCCCCAGCTACTTAAGAGGCTGAGGCAGGGTAATCACTTGAACCCGGGAGGCGGAGGTTGCAGTGAGCCGAGCTCACGCCACTGCACTCCAGCCTGGGTAACAGAGCGAGA"
"GL873574","4709916","4710039","chr19","13152422","13152536","46","8442506","AAAAATAGAAAAACTAGCCAAGCATGGTGGTGCACCCCCTATAGTCTGAGCTCCTCAGCGGGCTGAAGCAAAAGGACGGCTGGAGCCCTGGAGTTTGAGGTTGCTGTGAGGCAAGGTGATGCCA","ACACATAAATTAGCCAGACATGATGGTGAGTATCTGTAATTCCAGCTCCTTGGGGGGCTGAGGCGGGAGAATTGCTTGAACCTGGGAGGCAGAGATTGCAGTGAGCCAAGATCGC"
"GL873574","6353839","6353913","chr5","25768079","25768163","22","19414240","AAAAATATAGCAAGGCCAGGCATGGTGGCTCACACCTATAATCCCAGTACTTGGGAGCTGGAATTTGAACCTAGG","AAAAAACTCAAACAAGGCTGGGCGTGGTGGCTCACACCTGTAATCCCAGCACTTTGGGAGGCTGAGGTGGGTGGATCACCTGAGG"
"GL873574","6533061","6533332","chr5","85182161","85182439","81","78649100","GGCTGGGCGAGGTGGCTTACACCTATAATCCTAGTACTCTGGGAGGCCAAGGTGGGTGGATTGCCTGAGCGCACAGTTTCAAGACCAGCTGGAGCCAGAGAGAGAGAGAGAGACCCTGCCTCTAAAAATAGCCAGGCATTGTGGCAGGCACCTGTAGTCCCAGCTACTTGGCAGGCGGAGGTATGAGAATCGCTAGAGGTTGCTGTTAGCTATGATGCCATAGCACTCTACCAAGGGCGACAAAGTGAAACTCTGCCTCAAAAAAAAGAAGA","GCCAGGCGTGGTGACTCAAGCCTGTAATCCTAGCACTTTGGGAGGCCAAGGTGGGCGGATTGCCTGAGCTCAAGAGTTTGAGACCAGCCTGGGCAACACGGTGAAACCCAATCCCTACTAAATACAAAAAAAATTAGCCGGGTGTGGTGGTGTGAACCTGTAGTCCCAGCTACTCGGGAGGCTGAGGCAGGAGAAGGCAGAAGTTGCAGTGAGCCGAGATCACACCACTGCACTCCAGCCTGAGTGACAGAGCAAAACTCTTTCTCAAAAAAAAAAAAA"
"GL873574","6643746","6643907","chr2","92627944","92628105","46","85984198","AAATAGCCAGGCGTTGTGGCAGGCACCTATAGTCCCAGCTACTTGGGAGGCTGAGGCAAGAGAATCACTTAAGCCCAAGTGACAGAGGTTGCCAGGGCACTCTACGTAGGCAACAGAGTGAGACTCTATCTAAGAAAGAAGGAAGGAAGGAAGGAGAAAGAA","TTAGCCGAGCATTGTGGTGCGCGCCTGTAGTCCCAGCTACATGGGAGGCTGAGGCAGGAGAACACCTGAACCCAGGATGTGAGCTGAGTCGCGCCATTGCACTCCAGCCTGGGCAACAGAGTGAGACTCCATCTCAAAAATAAAATAAAATAAAATAAAAAA"
"GL873574","6644163","6644274","chr1","128607504","128607619","20","121963341","CTGTAATCCTAGCACTTGGGAGGCTGAGGCAGGTGGATCACCTGAGTTCAGGAGTTCAAGACCAGCCTAAACAAGAGTGAGACCCTATCTCTACTAAAAATAGAAAAAATAT","GCCTGTAATCCAAGCACTTTGGGAGGCTGAGGCGGGTGGATCACCTGAGGTCAGGTGTTCGAGACCAGCCTGGCCAACGTGGTGAAACCCCAACTCTACTAAAAATACAAAAATTA"
"GL873574","8511822","8512127","chr1","23439759","23440073","84","14927937","GGTGGCTGGTGCCTGTAATCCTAGCACTCTGGGAGACTGAGGCAGGTGGATCACTTGAAATCAGGAGTTTGAGATCAACCTGAGCAAGAGATCTTGTCTCTCCTAAAGATAGAAAAACTAGCTGGGATTTGTGGTGGACACCTGTAATTTCAGCTACTCAGGAAGCTAAGGCAAGAGCATTGCTTAAAACCAGGAGTTTGAAGTTGATGTGAGCTAGGATGTCAGGGCAGGTTACCCAGGGTGACAGAGTGAGACTCTGTGTCAAAATAAACAAACAAACAAACAAACAAAACAAAATAAAATAAA","GGCTGGACATGGTGACTCACGCTTGTAATCCCAACACTTTGGGAGGCTGAAGCAGGCAGATCACCTGAGGTCAGGAGTTTGAGACCAGCCTGACCAACATGGTGAAACCTTGTCTCTACTAAAAATACAAAAATTAGCTGGGAGCAGTGGTGCACACCTGTAATCCCAGCTACTCGGCAAGCTGAGGCAAGATAATTTTTTAAACCTGGGAGGTGGAGGTTGCAGTGAGCCAAGATCGTGCCACTGTACTCCAACCTGGGAGACAGAGCAAGACTCTGTCTCAAAAAAAAAAAAAAAAAAAAAAAAAAAAAAAAA"
"GL873575","2107336","2107519","chr4","38052972","38053149","54","35945636","TCAATTAAAAACTTTTTAAAATGAGGCTGAGCATGGTGGTTCACACCTGTAATCCCAGCACTTTGGGAGGCCGAGGCAGGAGGATCACCTGATCCCAGGAGTCCAAGCCTACAGTGAGCCGTGATAATACCACTGCACTTCAGCCCAAAGCCTCAAAAAGAAAAAAAAAAAAGGATAGACAAGA","TATATATATATATATTATTTTGGGGGGGCATGGTGGTGCACACCTGTAATCCCAGCTACTCGGGAGGCTGAGGCAGGAGAATTGCTTGAGCCCGGGAGGCAAAGGTTGCATTGAGCTGAGATCACACCACTGCACTCCAGCCTGGCGACAGAGTCTCAAAAAAAAGAAAAAATAAAAA"
"GL873575","5831824","5831959","chr1","29437872","29437991","28","23606048","GGCCGGGCGTGGTGGCGCACGCCTGTAGTCCCAGCGCTATGGGAGGCCAAGGCGGGTGGATCACCTGAGCTCAGAGGTTCGAGACCAGCCAAGACCCCCCTGAGCCAAACGAGCCAGAGTGAGACCCCGTCTCTAC","GGCCGGGCGTGGTGGCTCACGCCTGTAATCCCAACATTTTGGGAGGCCAAGGCGGGTGGATCACCTGAGGTCAGAAGTTCGAGACCAACCTGGCCAACATGGTGAAACCCCTGTCTCTAC"
"GL873575","7451097","7451208","chr3","122814630","122814743","22","115363533","GGCCAGGTGTGGTGGCTCACACCTGTTATCCTAGCACTCTGAGAGGCCACAGCAGCTGGATCACTTGAGCTCAGGAGTTCAAGACCAGTCTGAGCAAGAGCAAGACCTCACC","GGCTGGGTGTGGTGGCTCATGCCTGTAATCCCAGCACTTTGAAAGGCCAAGGCAGATGGATCACTTGAGGTCAGGAGTTCCAGACCAGCCTGGCCAACATGGCAAAACCCCATC"
"GL873575","7451277","7451445","chr6","58863249","58863409","41","51411972","AAAAATTCAGCCAGCCACAGTGGAAGTGGATGCCTGCCATCACAGCTACTCTGGGGGCTGGGGCAAGAGAATTGCTTGATCCCAGGAGTCTGAGGTTGCTGTGACCTAGGCTGACACCACAGCACTCTACCCAGGGTGACAGAGTGAGGCTGTGTTTAAAAAAAAAAAA","TTAGCCAGGCATGGTGGCACATGCCAGTAATCCCAGCTACTCAGGAGGATGAGGCAGGAGAATCGCTTGAACCCAGGAGGCAGAGGTTGCAGTGAGCTGAGATTGCGCCACAGCACTCTACCCTGGGTGACAGAAGGAGACTCTGTCTCAAAAAAAAAAAA"
"GL873576","1765109","1765185","chrX","53921180","53921256","12","52156071","GGCCAGGTGCAGTGGCTCATATCTGTAATCCTAGCACCCTGGGAGGCCAAGGTAGGCGAATCACCTGAGGCCAGGAG","GGCCAGGTGCAGTGGCTCACGCCTGTAATCCCAGCACTTTGGGAGGCCGAGGTGGGCGGATCACTTTAGGTCAGGAG"
"GL873576","2711577","2711895","chr7","6620384","6620702","85","3908807","GGTCGAGCTTGGTGGCTCATGCTTGTAATCCTAGCACTCTGGGAGGCCAAGGCAGGTAAGTTGCCCTGAGCTCATAGGTTCCAGATCAGCATGAGCCAGAGTGAGACCCTGTCTCTACCAAAAAATAGCCCGGCATTCTGGCAGGTGCCTGTAATCCCAGCTGCTTGGGAGGCTGAGGCTAGAGAATCACTTAAACCCAAGGGTTAGTGGAGGTTGCTGTGAGCTATGATTCCACCGTACTCTACTGAGGGCCACAAAGTGAGACTCTGTCTCCATAAAAAAGAAAGAAAGAAAGAAAGAAAAATAAAATAAAATAAAA","GGCCAGGCACAGTGGCTCATGTCTGTAATCCCAGCACTTTGGGAGGCCGAGGCGGGTGGATTACCTGAGGTCAGGAGTTCTAGACCAGCCTGGCCAACAAGGCGAAACCCTGTCTCTACTAAAAATACAAAAAATTAGCTGGGCGTTTTGGCACATGCCTGTAATCCCAGCTACTTGGGAGGCTGAGGCAGGAGAATTGCTTGAACTGGGGAAGTGGAGGTTGCAGTGAGCTGAGATCACACCATTGCACGCCTGAGCAACAGAGCGAGACTCTGTCTCAAAAAAAAAAAAAAAAAAAAAAAAGAAAAGAAAAAGAAAA"
"GL873576","4782520","4782652","chr9","61136941","61137074","22","56354421","CCAGGCACGGTGGCTCACCCTTGTAACCCTAGTACTTTGGGAGGCTGAGGTGGGAGGATCCCTTGAGGTCAGGAGTTCAAGACCAGCCTGAACAACAGTGAGACCCCCGTCTCTACTAAAAAATAGAAAAGTT","GCCAGGCACGGTGGCTCACGCCTGTAATCCCAGCACTTTGGGAGGCTGAAGCGGGCGGATCACCTGAGGTCAGGAGTTCAAGACCAGCCTGGGCACCATGATGAAACCCCGTCTCTATTAAAAATACAAAAATT"
"GL873576","4782930","4783078","chr7","57521645","57521803","40","52738715","AGTTAGTCTGGTGTCATGGTGGGTGCCTGTAGTCCCAGCTGCTTGGGAGGCTGAGGCAAGAGAATCACTTGAGCCCAGGAGTTGGAGGTTGCTATGAGCGAGGCTGTAGCCTAGGCAACAGAATGAGACTTTGCCTCAAAAAAATAAAA","TTAGCTGGGCATGGTGGCGCATGCCTGTAGTCCCAGCTACTTGGGAAGCTGAGGCAGGAGAATCACTTGAACCTGGGAGGTGGAGGTTGCAGTGAGCTGAGATCGCACCGCTACACGCCAGCCTGAGCAACAGAGAGAGACTCTGTCTCAAAAGAAAAA"
"GL873576","7828709","7828723","chr5","101042981","101042996","1","93214272","TAAATAAATAAAAAA","TAAATAAATAAATAAA"
"GL873576","7828960","7829230","chr13","49045537","49045844","89","41216577","GCCGGCTGCAGTGGCTATAATCCAAGTACCCTGGGAGGCTTAGGTGGATGGATCACTTGAGCTCAGAAGTTCAAGACCAGCCTCAGCAAGAGGTAGACCTTGCCTCTATTAAANNNNNNNNNNNNNNNNNNNNNNNNNNNNNNNNNNNNNNNNNNNNNNNNNNNNNNNNNNNNNNNNNNNNNNNNNNNNAGTTTGAGGTTGCTGTGAGCTATGATGAAGCCAGGGCATTCTACCCAGGGTGACAGAGTAACTCTTAAAAAAAACTAAACAA","GGCCAGGCAGAGTGGCTCATGCCTGTAATTCCAGCAATTTGGGAGGCCTAGGCAGGCAGATTACCTGAGGTCAGGAGTTTGAGACCAGCCTGGCCAACATGGTGAAACCCCGTCTCTTCTANNNNNNNNNNNNNNNNNNNNNNNNNNNNNNNNNNNNNNNNNNNNNNNNNNNNNNNNNNNNNNNNNNNNNNNNNNNNNNGGAGATAATAGCTTTTGTAGAACGAAGCGATGCAACAGCCAGATCGCCGCCACCACCCTTAGGTCCTGGCGACAGAGTGAGATCCATCTTAAAAAAAAAAAAAAAAAAA"
"GL873576","10622840","10623093","chr7","60266447","60266705","74","49643607","GCTGGGTATGGTGGTTCACACCTATAATCCTAGCACTCTGGGAGGCTGAGGTGGGAGGATTGGTGGAGCTCAGGAGCTCATGAGGTGCCAAATCACTGGTGCCACACACCTGTATTCCCAGCTACTGAGGAGGCTGAGGCAGGAGGATCAGGTAAGCCCAGGAAGTTTGAGGTTGTAGTGAGTTAGGATGATTGAACTCTGCCTTGAGAGACAGAGCAAGATCCTCCTTCCTCCTAAGCAAACAAACAAATAAA","GGCTGGGTGCAGTGGCTCACACCTGTAATCCTAGCACTTTGGGAGGCTGAGGCGGGAAAATTGCCTGAGCTCAGGAGTTCAAGGACAGCCTAGGCAACATAGCATGGTGGTGCACGCCTGTATTCCCTGCTACTTGGGAGGCTGAGGCACAAGAATTGCTTGAATCCGGGAAGTGGAGGTTGCAGTGAGCCATTGTGGCACTGCTCTCCAGTCTGGGTGACAGAGCAAGACTCCATCTCAAAAAAAAAAAAAAAAAAAA"
"GL873576","10819939","10820007","chrX","67133632","67133707","21","56313693","AGGTTGCAGTGAAATTGTACCATTCCAATGAAGCCTGGGGGACAGAGTGAGATTCTCTCAAAATAAAAA","GGAGGTTGCAGTGAACCGAGATCGTGCCACTGCACTCCAGCCTGAGCGACAGAGTGAAACTTCGTCTCAAAAAAAA"
"GL873576","10920306","10920363","chr3","48261745","48261808","16","37341439","GCTGGACCTTGTAGAGAGTGCCTGTAATCCCAGCTACATGGGGGGCAAGAGAATTGCT","GCTGGGCATGGTGGTGCATGCCTGTGATCCCAGCTACTCAGGAGGCTGAGGCAGGAGAATTGCT"
"GL873576","10920398","10920529","chr10","67341428","67341546","30","56421030","GGCCAGGCGTGGTGGCTCACGCCTGTTGTCCCAGCACTGTGGGAGGCCGAGGTGGGTGGATTGCCTGAGCTCAGAGGAGTCCGGAAGACCAGCATGAGGCAGAGTGAGCCAGAGTAAGATCCTGTCTCTACC","GGCTGGGTGTAGTGGCTCATGCCTGTAATCCCAGCACTTTAGGAGGCCAAGGTGGATGGATTGCCTGAGCTCAGGAGTTCGAGACCACCCTGGGCAACAAGCCAAAACCCTGTCTCTAC"
"GL873577","515809","515961","chr7","137660778","137660931","43","137144969","AGCTGGGCATGGTGGCTCATGCCTATAACCCTAGCGTGCTAGGAGATTGCTTGTCAGGAGACTGAGGTTGCAGGAAACTGTGATGATGGCACTGCACTCTACCCAGGGTGACAGAGCAGGACTCTGCCTCAAAAAAAAAAAAAAAAATAGAAA","TTAGCTGGGCATGGTGGCGCATGCCTATAATCCCAGCTACTTGGGAGGCTGAGGCAAGAGAATCGCTTGAACCGGGGAGGCAGAGGTTGCAGACTGCACTCCAGCCTGTGTGACAGAGTGGGACTCCGTCTCAAAAAAAAAAAAAAAAAAAAAA"
"GL873577","1633164","1633256","chrX","38269524","38269615","26","36636360","TCAGCCAGGCATGGTGGCACTTGCCTATAAACCCAGCTCCTTGGGAAGCTGAGCCGGGAGGATCCCTTGCACCCAGGAGCAACGGAAGGCAGT","AATTAGCCAGGCATGGTGGCACATGCCTATAATCCCAGCTACTCAGAAGGTTGAGGCAGGAGAATCACTTGAACCTGGGAGGCAGAGGTTGC"
"GL873577","3979502","3979560","chr20","68909283","68909346","13","64929781","GAGTTTGAGACCAGCCTGAGCAAGACCGAGACCCAGTCTCTACTAAAAATAGAAAAATT","GGAGTTCAAGACCAGCCTGACCAACATGGAGAAACCCTGTCTCTACTAAAAAATACAAAAATTA"
"GL873577","3979839","3980009","chr10","31403126","31403287","39","27423287","ATGAGCAGATTGTCTTGGTGGGCACCTGTAGTCCCAGCTATTGGAGGTGGGAGGCTGAAGCAGGAAAATCTCTTGAGCCCAGGAGTTTGAGGTTGCTGTGAGCTAGGCTGACACCACGGCACTCTAGTCAGGGCGTCAGAGTGAGACTCCGTCTCAAAAAAAAAAAAAAAA","TTAGCTGAGTGTGGTGGCGCACATCTGTACTCCCAGCTATTTGGGAGGCTGAGGCAGGAAAATCGCTTGAACCCAGGAGGTGGAGGTTGCAGTGAGCCAAGATCACACTACTGCACTCCAGCCTGGGTGACAGAGTGAGAATCCATCTCAAAAAAAAGAAAA"
"GL873577","6050882","6051080","chr1","153219820","153220007","59","147168938","GGCTGGGCGTTGTGACTCATGCCTGTAATCCCAGCACTCTAGGAGGCCGAGGTGGGTGGACTGCCTGAACTCAGAGGTTTAAGACCATCCTGAGCCGCAGTGAGCCAGAGCGAGACCCTGTCTCTACCAAAAAAAGCTGGGTGTTGTGGTGGGCGCCTATAGTCCTAGCTACTTGAGGCGCTAAGGGTAAAAAAATTGC","GGCCTGGCACAATGGCTCACGCCTGTAATCCTAGCACTTTGGGAGGCCGGGGTGGGTGGATCACCTGAGATCAGGAGTTTGAGACCAGCCTGGCCAACATGGTGAAACTCCTTCTCTACAAAAATTAGCCAGGTGTGGTGGTGGGTACCTGCAATCCCAGCTATTTGGGAGGCTGAGGCAGGAGAATC"
"GL873577","8463965","8464050","chr9","52134422","52134508","19","43670457","CTGGGTGCTATAGCTCACGCCTATAATCCTAGCACTCTGGGAGTTTGGGGCAAATGGATCACCTAGGCTCAGGAGTTTGATACCAG","GGCTGGGAGCAGTGACTCACGCCTATAATCCCAGCACTTTGGGAGGCTGAGGCAGATGGATCACCTGAAGTCAGGAGTTCGAGACCA"
"GL873577","9471486","9471613","chr16","5178790","5178910","46","4292696","TTAGCCAGGCATAGTAGCCTGTGTGTAGTCCTAGCTACTCAGGAGGCTGAGGTAGATGGGTCACTTGAGGTTGCAGAGATTATGGTAATGTCACTGTACTCTAGCCCTGGCAACAGAGCACAACCCTG","TTAGCCGAGCCTGGTGGCATAAACCTGTAATCCCAGCTACTCAGGAGGCTGAGGCAGGGGAATTGCTTGAACCTGAGAGGAGAAGGTTGCAGTGAGCCGAGATTGCACCATTGCACCCCAG"
"GL873577","9471875","9471998","chr7","17832200","17832315","36","8360325","GGCCAGGTGAAGCAGCTCATGGCTATAATCCTAGCAGTTTGGCAGGCCAAGGTGGGAGGACTGCTTGAGGTCAAGAGTTCAAGACCAACCCATCTTTGCGAAAAATTTAAAAATTACCTAGGCA","GCCAGGAGAGGTGGCTCATGCCTCTAATCCCAGCACTCTGGAAATCCAAGGTGGGTGGATCACCTGAGGTCAGGAATTCCAGACCAGTCTGGCCAATATAAAAAATTAGCCAGGCT"
"GL873577","9853150","9853170","chr3","85044647","85044667","3","75191497","AAACAAACAAACAAAAAAAGA","CAAACAAACAAACAAACAAAA"
"GL873577","9853206","9853473","chr7","130818682","130818963","67","120965476","GCTGGGCGCAGCGTCTCACTCCTGTAATCCCAGCACTTGGGAGGCCAAGGTGAGTGGATTGCCTGAGTTTACAGTTTCGAGACCAGCCTGAGCCAAAGCGAGACCCCCATCTCTAAAAAATAGCTGGGCATTGTGGTGGGCACCTGTAGTCCCAGCTACTTGGGAGGCTGAGGCAAGAGGATCGCTTGAACCTAAGAGTTTGAGGTTGCTGTGAGCTAAGGCTCCATGGCATTCTACCAAGGGTGACTAAGTGAGACTCTGTCTAAAA","GCCGGGCACAGTGGCTCACACCTGTAATCCCAGTACTTTGGGAGGCCAAGGTGGGTGGATCACCTGAGGTCAGGAGTTTGAGACCAGCCTGGCCAACATAGTGAAACTCTACTAAAAATACAAAAAAATAGCTAGGCATGGTGGTGCGCACCTGTAATCCCAGCTACTTGGGAGGCTGAGGCAGGAGAGTTGCTTGAACCCAGCGGGGTTGAGGTTGCAGTGAGTTAAGATCAAGCCACTGTGCTCCAGCCTGGATGACAGAGAGAGACTCCATCTCAAAAA"
"GL873577","10722415","10722478","chr10","12501471","12501539","23","1779056","AATAAAAAAATGCTGGGTACAGTAGTACATGCCTGTACTCTCATCTGGGGAAGCTGAGGCATGA","AAAGTAAAAAATTAGAGCTGGGCATGGTGGCACACACCTGTAATCCCAGTCACTAGGGATGCTGAGGCA"
"GL873578","463331","463568","chr10","28935382","28935620","93","28472051","CAGGTGCTTTGACCCACACCCTCAACTCTAGGACTTTGGACGCCCTGGCTGGGTGGGTCCTTTAAAGTCAGGAGCTTCTTATCAGTCTGGGCAAAAGTGAGACCCCATCTCTACCAAACAAAGAAAGAAATCAGCAGTATGTTGCAGTAGAGACTCACCAATACCTTCTTTCAAAGACCAAAGCTGGAAGGACACTAAAGACCATGATCTCATGGCCTCCCTGAGCCATGACAATGCC","CCAGGTGCAGTGGCTCATGCCTGCAAGCTCAGAACTTTGGGAGGCAGAGGTGAGCAGACTGCCTGAGTTCAGGAGTTCAAGACCAGCTGGGCAACATGGTGAGACCCTATCTCTACTAAAAATACAAATAATTAGCAGGGTGTGGTAGCACACACCTGTAGTCCAGCTACTCAGGAGGCTGAGGCAGGAGAATTGCTTGAACCCAGGAGGCAGAGTTTGCAGTGAGCCAGGACTGGGCC"
"GL873578","1143712","1143827","chr11","52824583","52824692","30","51680871","GGCTGGGTGTGGTGCCTCATGCCTGTAATCTAAGCCCTCTCCGAGGCTGAGGTGGGAGGATCCCTTGAGTTTAGGAGTTTGATTTTGAGACCAGCCTGATCAAGAGAGAGACCTCA","GGCCGGGTGTGGTGGCTCATGTCTGTAATCCCAGCACTTTGGGAGGCTGAGGTGGGTGGATACCCTGAGGTCGGGAGCTCGAGACCAGCCTGACCAACATGGAGAAACCC"
"GL873578","1144101","1144139","chr3","33494224","33494257","11","32350123","GAGAGAGACCTCATGTCTACTAAAATAAATAAATATATA","GTGAAACCCGTCTCTACTAAAAATACAAAAATTA"
"GL873578","1144175","1144343","chr12","119519961","119520131","41","118375786","ATTATCCAGGCCTTCTGGTGGATGCCTGTAGTCCTAGCTACTAGAAAAGCTGGAGCAGAATCACTTGACCCAGGAGCTGGAGGTTGCAGGGAGCTAGGCTGATGCCACAGAATTCTAGCCTGAGGCAAAAGAATTGAGCCACTGTCTCAAAAAGGAACAAAAAAGAAAA","ATTAGCCAGGTGTGGTGGCATGCACTTGTAATCCCAGCTACTAAGAAGGCTGAGGCAGGAGGATCACTTGAACCCGGGAGGTGGAGGTTGCAGTGAGCCAAGATCATGCCACTGCACTCCAGCCTGGGCAACAGAGTAAGACTCTGTCTCAAAAAAAAAAAAAAAAAAAAA"
"GL873578","4593962","4594035","chr16","68825055","68825124","22","64231093","AGCTGGGTACAGTGGCTCACATATAATCCCAGTGACTCAGGAGGCTAAGACAGGAGGATTACTAGGACCTGAGA","GGCTGGGCACAGTGGCTCAGACCTGTAATCTCAGTACTTTGGGTGGCTGAGGCAGGTGGATCACCTGAGG"
"GL873578","6158845","6158972","chr3","500432","500562","24","5658413","GACATGGTGGCTCACACCTGTAATCCTAGCCCTCTGGGAGGCTGAGGCAGGTGGATCACTTGAGTTCAGGAATTCAAGACCAGCTTGAGTGAGAGCAAGACCCTGTCTCTACTAAAAATAGAAAAATT","GCACGGAGGCTCATACCTGTAATCCCAGCACTTTGGGAGGCTGAGGCAGGTGGATCACCTGAGGTCAGGAGTTCCAGACCAGCCTGGCCAACATGGCGAAACCCTGTCTCTACTAAAAATACAAAAAATCT"
"GL873578","6159253","6159444","chr19","34496349","34496541","55","28337096","ATAAAATAAAAATAGAAAAATTAGCCAGGCATTGTGGCAGACATGCGAAGTCTCAGCTACTCCAGAGGCTGAGACAGGAAGATTACTTGAGCCCAAGAATCTTGCTGTGAGCTAAGCTGATGCCATAGCATTGTAACCTAGGCAACAGAGTAAGACTTGGCCTCAAAAATAAAATAAAATAATAAAGTAAAA","TTAGTTAATTAAATTAAACTTAGCTAGGCATAGTGGAACACACCCATAGTCCCAGCTACTCTAGAGGCTGAGGCAGGAGGATTGCTTGAGCCAAGTTGGAGGCTGCAGTGAGCTATGGTGGTGCCACTGCATTCCAGCCTCAGTGACAGAGAGAGACCCTGGCTCAAATAATAATAATAAATAAATAAATAAA"
"GL873578","6766040","6766171","chr2","93098086","93098217","30","86332046","CCAGGCACAGTGGCTCATGCCTATAATCCTAGTAGTCTAGGAGGCTGAGGTGAGTGCATTGCTTGAGCTCAGGAGTTAGATACCAGCCTAACCAAGAATGAGACCCCATCTCTATTAAAAATAGAAAAGTTA","GCCGGGCACAGTGGCTCATGCCTGTAATCCCAGCACTTTGGGAGGCCGAGGCGGGCAAATCACGAGGTCAGGAGTTCAAGACCAGCCTGACCAATATGATGAAACCCCGTCTCTATTAAAAATACAAAAATT"
"GL873578","6766434","6766577","chr9","21128084","21128223","50","14361650","GTTAGCCAGGAGTTGTGGCGGGCACCTACAGTCCTAGCGACTCAGGAGGCTGAAGTAGGCAGAGTTTGATGTGTTGCTGTGAACTACAAGGACACCAATGCACTCTAGGCCGGTAACAGAGTGAGACACTGACTAAAAAAAAAA","TTAGCCAGGTGTGGTGGCACATGCCTGTATTTCCAGCTACTCGGGAGGCTGAGGCAGGAGAATTGCGTGAGCTGAGATCATGCCACTTCATTCCAGTCTGGGTGACAGAGTGAGACTCTGCCTCAAAAAACAAAACAAAA"
"GL873578","7397948","7398119","chr5","40230148","40230319","43","32832200","TAAAAATAGCCATGCATTGTGACAGGCACCTGTAGTCCCAGCTACTCAGGAGGTTGAGGTAAGAGAATCACTTGAACCCAAGAGTTTTGAGGTTGTTATGAGCTAAGACGCCTCGGGACTCTACAAAAGGTAACAAAGTGAGACTCTGTCTCATAAAAAAAGAAAAAAAGAA","AAAATTAGCCAGGCATGGTGACGTACACCTGTAGTCCCAGCTACTCGGGAGGCTAAGGCAAGAGAATCGCTTGAACCCAGGAGGCAGAGGTTGCAGTGAGCTTAGATCACGCTACTGCGCTCCAGCCTGGGTGACGGAGTGAGACGCCATCTCAAAAAAAAAAAAAAAAAAA"
"GL873578","7398378","7398515","chr15","102382935","102383070","35","94984557","GGTCGAGCAAGGTGGCTCACGCCTGTAATCCTAGCACTCTGTGAGGCTGAGGCAGATGGATTGCCTGAGCTCGTGGGTTCGAGACCAGCCTGAGCCAGAGTGAGACCTCATCTCTAAAAATAGCTGGGAAGCTGGGCA","GGCCAGGTGTGGTGGCTCACGCCTGTAATCCTAGCACTTTGGGAGGCTGAGGCGGGTGGATTGCCTGAACTCAGGAGGTCAAGACCAGCCTGGGCAACACAGTAAAACCCCATCTCTACTAAAATACAAAAAATCA"
"GL873579","370235","370429","chr16","38067345","38067552","57","37697110","GCACAGGCCTGAAATCCTAGCACTCTGAAAGGCCAACGGAGGAGAATTTCTGGAGCTCAGGAGTTTGATACCAGCCTAAGCAAATAAAGCTAGACCTCTATCTCTACTAAAATTAGAAAAATTAGGCAGATGTGGTGGTAGGCACCTATAGTCCCAATTACTCCAGAGGCTGAGGCAGAAAGACTCTTGAACCCA","GTCAGGCATGGTGGCTCATGCCTATAATCCTAGCACTTTGGGAGGCCAAGGCCGGTGGATCACCTGAGGTCAGGAGTTTGAGACCAGCCTGGCCAATATGGCAAAACCCCGTCTCTACTAAAAATAAAAAAATTAGCTGGGCACGGTGGTGGGCACCTATAGTCCCAGCTACTCAGGAGGCTGAGGCAGGAGAATTGCTTGAACCCAG"
"GL873579","370936","371046","chr3","3847698","3847802","33","3476762","TGACTCTTGAACCCAGGCACATGAGGTTGCTAAGAGTCTAGGCTGATGTCACGGCACTCTAACCTGGGAAACAGTGTGAGGTTCTGCCTCAATAAATAAATAAATAAATAA","TGGCTTGAACCCAGGAGGCGGAGGTTGCAGTGAGCCGAGATCACGCCACTGCACTCCAGCCTGGGCAACAGAGCGAGACTGTCTCAAAAAAAAAAAAAAAAAAAA"
"GL873579","599436","599605","chr10","38982686","38982853","41","38383250","AAAAAGTCAGACATTGTGGCAGGTGTCTGTAATCCCAGCTATTTGGGAGGCTGAGGCAGGAGTATCATTTGAACCCACGAGTCTGAGGTAACTGTGAGCTAGGCTAACACAACAGCACTCTAGCCTGGGCAATAGAATGAGACTCTATCAAGAAAAGAAATGAAAAGAAA","TATTAGCCTGACACAGTGGCGCGCATCTGTAATCCCAGCTACTTGGGAGGCTGAGGCAGGAGAATCACTTGAACCCAGGAGGCGGAGGTTGCTGTGGGCTGAGATCATGCCACTGCACTCCAGCCTGGGCAACAGAGGGAGGCTCCATCTCAAAAAAAAAAAAAAAAA"
"GL873579","599942","599953","chr3","71473700","71473710","4","70873758","TTTTAAAATAGT","TTTAAAAAAAA"
"GL873579","600232","600365","chr1","16061315","16061447","30","15461083","GGCTAGGCAAGGTGACTCATGTCTGTAATCCTAGTACTCTGGGAGGTTTGAGGCAGGAAGACCACTTTAGCTCAAGAGTTCCAGATCAGCCTGTGCAAGAGTGATACATCATCTCTACTAAAAATCAAAAATTA","GGCTGGGCATGGTGGCTCATGCCTGTAATCCTAGCACTTTGGGAGGTTGAGGCAGGCAGATCACTTGAGGTCAGGAATCTGAGACTAGCCTGGCCAACATGGTGAAACTCCATCTCTACTAAAAAAAAAAAAA"
"GL873579","5650320","5650591","chr6","54938866","54939145","71","49288546","GTCAGGTGTGTTAGCTTACAGTAGTAATCCTAGCACTTTGGGAGGTTGAAGTGGGTGGATTGCTTGAGCTCAGGGGTTCAAGACCAGCCTGAACAAGAGTGGGACCTCATCTCTATTAAAAACAGAAAAACTAGCTGGGTGTTATGGTGGGTGTCTGTAGCCCCAGCTACTCAGGAGGCTGAGGCAGGAGGTTGAGGTTGCTGTGAGCTATTGAGACCACAGCACTCTATCCAGGGCAACAGAGTGAGACCCCTCCCCCCCCCAAAAAAAAA","GGCCAGGTGTGGTGGCTCACGCCTGTAATCCCAACACTTTGGGAGGCCGAGGTGGGTGGATCACCTGAGATCAGGAGTTCAAGACCACCCTGGCCAACATGGTGAAACCCCGTCTCTACTAAAAATACGAAAATTAGCTGAGTGTGGTGGTGCATGCCTGTAGTCCCAGCTACTCAAGAGGCTGAGGCAGGAGGTGGAGGTTGCAGTGAGCCGAGATTGCATCACTGCACTCCAGCCTTGGCGACAGAACGAGAGAGACTCCATCTAAAAAAAAAAAAAA"
"GL873579","7037162","7037347","chr3","37328686","37328893","67","30291524","GAGGTGGGTGGATTGCCTGAGCTCACAGGTTGGAGACCAGCCTGAGCCAGAGCAAGACCTTATCTCAAAAAATAGCCAGGTGTTGTGGCTGGCACCTGTAGTCCCAGCTGCTCAGGAGGCGGAGGCAAGAGAAATGCTTGACCTCAGGAGTTTGAGGTTGCTGTGAGTTCAACTCACACTAATACA","GAGGCAGGGGGATCACCTGAGGTCAGGAGATCGAGACCAGCCTGGCCAACATGGTGAAAACCTGTCTCTACTAAAAATCCAAAAACATTAGCCAGGTGTGGTGGCACGCACCTGTAATCCCAGCTACTTGGGAGGCTGAGGCAGGAGAATCACTTGAACCTGGGAGGCAGAGGTTGTAGCGAGCCGAGATCACACCACTGCACCCCAG"
"GL873579","11077764","11077972","chr19","1200469","1200683","63","9877295","GCCAGGTGCAGTGGCTCATGCCTATAATCCTAGCACCCTAGGAGGCTGAGGAGTTCAAGACCAGCCTAAGCAACTGTGAGACCCCATCTCTACCAAAAATAGAAAAATTAGCTGACTGTTATGGTGTGCACCTACAGTCCTAGCTACTCAGGAGGCTGAGGCAGAAAGAGTCCTTGAACCCAGGAGGCTTTTTTTTGTTGTTGTTGTTG","GGCCAGTCGCGGTAGCTCATGCCTGTAATCCCAGCACTTTGGGAGGCCGAGGCGGGCAGATCACCTGAGACCAGCCTGGCAACATGGTGAAACCCCATGTCTACCCAAACTACAAAAATTAGCTGGGTGTGGTGGTGCACGCCTGTAATCCGAGCTACTCAGCAGGCTGAGGCAGGAGAATCCCTTGAACCTGGGAGGCAGAGGCTGCAGTGAGC"
"GL873579","11078245","11078333","chr19","4926258","4926351","22","6151987","TGAACCCAGGAGTTTGAGTTCGCTGTGAGCTAAGCTGAGGCCACAGCACTCCAGCCTGGGCAACAGAGTGAAAGGAAAAAAATAAAAAA","TGAACCCGGGAGGTGGAGGTTGCAGTGAGCCAAGATCACACCAATGCACTCCAGCCTGGGCAACAAGAGTGAAACTCTGTCTAAAAAAAAAAAA"
"GL873580","320374","320488","chr13","48549305","48549409","42","48228931","GGTAGTGCGTGCCTGCATTCCCAGCTACGGGAGGGCAGGGACTTGAGGCCAGCCTGGGCAAAATAATGAGACCTACTAATGACTCTACTAATACAGAAACAATTAGCTAGGTATG","TGGGAGGCCGAAGTGCGCAGATCACCTGAGGTCAGAAGTTGGAGACCAGCCTGGCCAACATGGTGAAAACCCATCTCTACTAAAAATACAAAAATTAGCTGGGCA"
"GL873580","374969","375091","chr6","147681010","147681135","27","147306041","CGGTGGCTCACACCTATAATCCTAGCATTTTGGAAGGCTGAAGCCGAGGATCTCTGGAAGTCAGAAGTTCAAGACCAGCCTGCCCAAGAGCAAGACCCCATCTCTACTAAAAATAGAAAAACT","GGTGGCTCACACCTGTAATCCCAGCATTTTGGGAGGCTGAGGCAGGCGGATAATCTGAGGTCAAGAATTTGAGACCAGCCTGGCCAACATGGAGAAACCCTATCTCTACTAAAAATACAAAATTAC"
"GL873580","375369","375549","chr7","19977275","19977456","44","19601906","CTAACCAAGTTAGTTAGTTTTAGTTGGCAGGTGCCTGTAGTCCCAGCTCCTTGGGAGGCTGAGGCAAGAGAATGGCTTGAGCCCAGGACTTTGAAGTTGCTGTGAGCTATAATGACACCACAGCACACTACCCAGGGTGACAGAGTGAGACTGTCTCAAAAAAACAAACAAACAAAAAAAA","AACAAACGTTAGCCGAGCATGGTGGTATGTGCCTGTAGTCCCAGCTACTTGGGAGTCTAAGGCAGGAGAATTACTTGAGCCCGGGAGGCAGAGGTTGCTGTGAGCCAAGATCACGCCACTGCACTCCAGCCTGGGTGACAGAGTGAGACTCCATCTCAAAAAAAAAAAAGGAAAAAAAAAAA"
"GL873580","8760922","8761015","chr11","104681322","104681416","19","95920400","GGAGGGAGACACTGCAGTGAACTGCGATCGTGTCTCTGCTTTCCAGGCTGGGTGACAGAGTGAGACTCGGTCTCTAAAATAAAAAATAAATAAA","GGAGACGGAGGTTGCAGTGAGCTGTGATCGCGGCACTGCACTCCAGCCTGGGCAACAGAGTGAGACTCTGTCTCAAAAATAAATAAATAAATAAA"
"GL873580","9391260","9391306","chr14","49279240","49279285","12","39887980","GCCAGTCGAGGTGGCTCACACTTGTGATTCCAGCTACTTGGAAGACT","GGCTGAGATGGTGGCACACACCTGTAATCCCAGCTACTTGGGAGGC"
"GL873581","759283","759365","chr6","46535476","46535542","30","45776193","TAAGAACCTGAAAATAGAGCCAGGCATAGTGGTACATGCGTATAGTCCTGGCTACTCAGGAGGTTGAAACAACAGGATTACTT","CAAAATAGCCAGGCTTGGTGGTGCATGCCTATAATCCAAGCTACTCGGGAAGCTGAGGCAGGAGAAT"
"GL873581","1145844","1145979","chr1","29437872","29437991","29","28292028","GGCCGGGCGTGGTGGCTCACGCCTGTAGTCCCAGCACTATGGGAGGCCGAGGCGGGTGGATCACCTGTGCTCAGAGGTTCGAGACCAGCCAAGACCCCCCTGAGCCAAATGAGCCAGAGTGAGACCCCGTCTCTAC","GGCCGGGCGTGGTGGCTCACGCCTGTAATCCCAACATTTTGGGAGGCCAAGGCGGGTGGATCACCTGAGGTCAGAAGTTCGAGACCAACCTGGCCAACATGGTGAAACCCCTGTCTCTAC"
"GL873581","9628238","9628362","chr5","141044567","141044691","34","131416329","ATCCCAGGTAGTCGGGAGGCTGAGGCAGGAGGATCACTTGAACCCAGGAGGTTGAGGTTGCTGTGAGCAAGGCAGAGGCAACGGCACTCTAGCCACGGGGGCACAGAGACTCTTGTCTTTAAAAA","TAATCTCAGCTACTCGGGAGGCTGAGGCAGGAGAATCGCTTGAGCCCAGAAGGTGGAGGTTGCAGTGAGCCAAGATCGCGCCATTGCACTCCAGCCTGGGCGACAGTGCGAGACTCTGTCTCAAA"
"GL873582","1580485","1580534","chr6","32576760","32576806","12","30996275","CAGCACTTGAGAGGCCAAGGCAGGTGGATCAACTGAGCAAGAATGAGACC","CCAGCACCTTGAGAGGCCAAGGCAGGTGGATCACCTGAGGTCAGGAG"
"GL873582","1644368","1644551","chr1","211626449","211626612","63","209982081","AAAATTTGCCGGGCTCCATAGCTCATGCATGTAATCATAGCACTCTGGGAGGCCAAGATGGGAGGATCTCTCAAGCTCTCTTACTTGGGAGGCTGAGGTTGCTGTGAGTTAGGCTTACGCCACAGCACTCTACTCTAGCGTGAGCAACTCTACTCTTAGTATGAGACTGTCTCAAAAGAAAAAA","AAATTAGCCAGGCGTCGTGGCACATGCCTGTAATCCCAGCTACTCGGGAGGCTGAGGCAGGAGAATAGCTTGATCTCGGGAGGCGGAGGTTGCAGTCAGCCGAGATCACACCACTGCAATCCAGCCTGGACAACAGAATGAGACTCCATCTCAAAAAAAACAAA"
"GL873582","5794385","5794459","chr13","18872784","18872852","27","13078399","ATATTGTTAAGCACAGCCACTATTAAAAATTAAATTATAGGCCAGGCATAGTGGCTCATGCCTGTAATCCTAGCT","TGAAACCACCATCTGGACCAAGATACAAAATGTTGGCTGGGCATGGTGGCTCACACCTGTAATCCTAGC"
"GL873583","102645","102683","chr14","5808766","5808804","14","5706121","GAGCAGATCACCTGAGCTCAGGAGTTTGAGACCAGCCTG","GAGGAATCCCTGTGCTCAGGAAGCTTACATTCTAGTGAG"
"GL873583","6200447","6200560","chr4","17786849","17786963","24","11586402","GGCCAGGAGGGACGGCTCATGCCTGTTATCCTAGCACTATGGGAGACTGAGGTGGGAGGATCACTTGAAGTTAGGAGTTCCAGACCAATCTGACCAAAGTGAGACCTCATCTCT","GGCCAGGCTTGGTGGCTCATGCCTGTAATCTTAGCACTTTGGGAGGCTGAAGTGGGTGGATCACTTGAGGTCAGGAGTTAGAACCAGTCTGGCCAACATGGTGAAACCTCAGCTC"
"GL873583","6200584","6200752","chr6","169626528","169626696","42","163425944","TTAGCTGGATGTGGTAGCACATGCCTATAGTCCCATCTACTCAGGAGGCTGAGACAAGAGAGTTGCTTAAGCCCAGGAGTTTAATTTAACTGTGAACTAGACTGAGACTGTGGCACTCTAGCTGGGGCAACAGAGTGAGACTCTGTCTCAAAAGAAAGCAAGAAAGAAA","TTAGCTGGGTATGGTGTCAGATGCCTGTAGTCCCAGCTACTCAGGAGGCTGAGACAGGAGAATCGTTTGAACCCAGGAGGCCAGAACTGCAGTGAGCTGAGATTCGCACCACTGCGCTCCAGCCTGGGCCAGACAGAGTGAGACTCTATCTCAAAAGAAAAAAAAAAAA"
"GL873583","10217398","10217583","chr3","36257142","36257313","44","26039744","TACTAAAAATAAAGTGTGATAGCCAGGCATGGTGGTGGTGCCTATAGAACCAGGCTATTCAGGAGGCTGAGGCAGAAGGATCACTTGAACCCAGGAGTCTGACGTTGCTGTGAGCTAGGCTGGTGCCATGGTACTCTAGCCTGTGGTAACAGAATGAGACTCTATCTCAAAAATAAAAATAAAAAA","TACAAAATTAGCCAGGCGTGGTGGTGCGTGCCTGTAATCCCAGCTACTTGGGAGGCCGAGGCAGAAGAATGACTTGAACCCAGGAGACAGAGGTTGCAGTGAGCCAAGATCCCACCATTGTACTCCAGCCTGGGCAACACAGTGAGACTCCATCTCAAAAAAAAAAAAAAAA"
"GL873583","10394919","10394983","chr16","12841703","12841771","22","2446784","GAGGTCAGGAAATCAAGATCAGTCTGGGCAATATATTGATACCCTGCCCCTACATAAGGAAGAAA","AGGTCAGGAGTTCAAGACCAGCCTGGCCAATATGTTGAAACCTCATCTCTACTAAAAATACAAAAATTA"
"GL873584","521512","521529","chr1","167402212","167402233","10","166880700","GCATGGAACCCCCCACTC","GGTGAAACCCCATCTTTACTAA"
"GL873584","2079725","2079768","chr15","4338291","4338335","11","2258566","GGCAGGTGGATTACCTGAGTTCAGGAGTTGGAGACCAGCCTGAC","AGGCGGATGGATCACGAGGTCGGGAGTTTGAGACCAGCCTGACCA"
"GL873584","5216877","5217053","chrX","91350057","91350230","49","86133180","CTACTGAAAATGATGACAGAGGCTGGGCATGGGGGCTCCCGCCTGTTATCCTAGCACCCTCGGAGGCTGGGGAATGAGGATTGCTTACGCCCAAGAGTTTGAGGTTGCTGTGAGCTGAGGCCGCTGCACTCTAGCCTGGGCAACAGAGTGAGACTCTGTCTCAAAAAAAAAAAAAAA","TGCAAAAATGAGCTGGGCATGGTGGCACATGCCTGTAATCCCAGCTACACAGGAGGCTGAGGCAGGAGAATCGCTTGAATCTGGGAGGCGGAGGTTGCAGTGAGCTGACATCAGGCCCCTGCACTCTAGCCTGGGCCACAGAGCAAGACTCCGTCTCAAAAAAAAAAAAAAAAA"
"GL873584","7289930","7289950","chr2","51453328","51453345","10","44163398","TGAGGCTCTGTCTCGAAATAA","AATGCCATCTATTAAAAA"
"GL873584","7289975","7290131","chr11","49739997","49740154","37","42450022","CAAGAAAATTAGCTGAGAGTCCTGGTAGGTGCCTGTAATCCCAGCTATTCATGAGGCTGAGGCAGAAGGATCACTTGGGTCCAGGAGTCTGAGGTTGCTGTGAGCTAGTCTGACGCCATAACACGCAAGCCTGGGCAACAGAGTGAGGCTCGGTTTC","CTACAAAAATTAGCTGGGCGTGGTGGCACATGCCTGTAATCCCAGCTACTCGGGAGGCTGAGGCAGGAGAATCACTTGAGCCCAGGAGGCGGAGGTTGCAGTGAGCCAAGATCATGCCATTGCACTCCAACCTGGGCAACAGAGCAAGACTCCATCTC"
"GL873584","7577743","7577867","chr5","48394329","48394446","27","40816586","GGCTGGATGAGGTGGTTCATGCCTGTAATCCTAGCACTCTGGGAGGCCAAGGTGGGTGGATTGCCTGAGCTCAGGAGTTCAAGACCAGCCTGAGCAAGACCCTGTCGCTAAAAATAGCTGGGTGT","GGCTGGGTGCAGTGGCTCATGCCTGTAATCCCAGCACTTTGGGAGGTCAAGGCGGGTGGATCACCTGAGGTCAGGAGTTCAAGACCAGCCTGGCCAACATCTCTACTAAAAATACAAA"
"GL873584","7578135","7578289","chr1","130112713","130112865","31","122534578","GGAGCTGGGTTTTGTGACTGCACCTGTAATCCCAGCTGCTCAGGAGGCTGAGGCAAGAGAATTGCTTGAGCCCAGGAGTTGGAGGTTGCTGTGAGCTGTGATGCCAGGGAACTCTACCAAGGGTGACAAAGTGAAACTCTGTCTCAAAAAAAAAA","TTAGCCAGGTGTGGTGATGCATGCCTGTAATCCCAGCTACTCATGAGGCTGAGGCAGGAGAATTGCTTGAACCTTGGAGCTGGAGGTTGCAGTGAGCTGAGATCAGACCACTCCAACCTGGGTGACAGAGCGAGACTCTGTCTCAAAAAAAAA"
"GL873585","1450952","1451121","chr10","59681079","59681242","48","58230127","TAAAAACAGAAAAAACTAGTCAGGTGGTGTGGTAGGTGCTCATAAGTCCCAGCTGCTTGGGAGACTGAGGCAAGAGAATCACTTGAGCACAAGAGCTTGAGGTGGCTGTGAGCTATAACACCATAGCACTGTACTGAGGGTGACAAAGTAAGACTCTGTCTCAAAAAAAA","TACAAAAATTAGTCAAGGGTGGTGGTATGTGCTTGTAATCCCAGCTATTTGGGAGGCTGAAGCAGGGGAATCCTTGAACCCAGGAGGTGGAGGTTGCAGCGAGCCGAGATCACGTCACTGCACTCTAGCCTGGGCGATAGGGTGAGACTCTGTCTCAAAAAAAA"
"GL873585","1451382","1451515","chr6","17405813","17405948","24","15954431","GGCCCGGCTCGGTGGCTCACACCTATAATCCTAACACTCTGGGAGGCTGAGGCAGGTGGATCACCTGAGCTCAGGAGTTTGAGACCAGCTGAGCAAAAACAAGACCCTATCTCTGCTAAAAATAGAAAAAACTA","GGCCGGGCGGGGTGGCTCACGCCTGTAATCCCAGCACTCTGGGAGGCCAAGGCAGGTGGATCACCTGAGGTCAGGAGTTTGAGACCAGCCTGGCCAACACGCAGAAACCCTATTTCTACTAAAAACACAAAAATTA"
"GL873585","1626960","1627026","chr7","17782729","17782794","22","16155769","AAGATGCCACAGCACTCTACAAGAGTGACCAAGTGAGACTCTGTCTCAAAAAAAAAAAGAAAAGGAA","CAATCGCACTACTGCACTTCAGCCTGGGTGACAGAGTGAGAACCTGTCTCAAAAAAATAAATAAAA"
"GL873585","1627304","1627531","chr11","17033552","17033788","61","15406248","GGCTGGGCACAGTGGCTCACGGCTATAATCTAGGCACTTGGGAGGCTAGGGCAGGTGGATTGCCTGAACTGACAAGTTTGAGACCAACCTGAGCAAGAGCGAGACCCCTGTCTCTAAAACATAGCCAGGCTCTGTGGTGGGCGTCTGTAGTCCCAGCTACTTGGGAGGCTGAGGCAAGAGAATTGCTTGAACTCAAGAGTCTGAGGTTGCTGTGAGTTAAGATGCCAC","GCCCGGCGCAGTGGCTCACGCCTGTAATCCCGGCACTGTGGAGGCCAAGGCAGGCGGATTGCCTAAGCTCAGGGATTCGAGAACAGCCTGGGCAACATGGTGAAACCCCATCTCTACTAAAATACAAAAAACTAGCCGGGCGTGGTGGTATGCGCCTGTAATCCCAGCTACTTGGGAAGCTGAGGCAGGAGAATTGCTTGAACCCGGGAGATGGAGGTTGCAGTGAGCTCAGATCAC"
"GL873585","3626082","3626158","chr1","100916857","100916922","27","97290775","TGCCTGTAATCCCAGCACTTGGGAGGCGGAGGTGGGTAGATTGCCTGACCCAGAGTGGGACCTCATCTCTAAAAGAA","CATGCCTGTAATCCCAGCACCTTGGGAGGCCAAGGTGGGTGGATCACCTGAGGTCAGTAGTTTGAG"
"GL873585","8849829","8849913","chr18","48581945","48582025","18","39732116","GGCTGGACGAGGGGACTCATGCCTGCAATCCCAGCACTGAGAGAGGCCAAGGCAGGTGGATCCCCTGAGCTCAGAAGTTTGAGAC","GCTGGACGCAGTGGCTCACACCTGTAATCCCAGCACTTTGGGAGGCCAAAGCAGGCAGATCTGAGGTCAGGAGTTTGAGAC"
"GL873585","9319890","9319971","chr8","79499361","79499447","14","70179471","GGCCAGGTGTGGTGGCTCACACCTGTCATCCTAGCACTCTGGGAGGACGAGGTGGGTGGACCGCCTGAGTCAGAGTGAGACC","GGCCAGGTGTGGTGGCTCACACCTGTAATCCCAACACTTTGGGAGGCCCAGGTGGGTGGATCACCTGAGGTCAGGAGTTCAAGACCA"
"GL873586","895572","895692","chr17","14501559","14501680","38","13605987","GGCCAGGTGAGGTTTCTCATTCTGGGAGTGAGCCAGCAATTGGGAGGCCAAAGTAAATGGATTGCCTGAGGTTATAGGTTCCAGAACAGCCAGAACAAGATCGAAATCCTGTCTCCAAAAA","GGCCAGGCGTGGTGGCTCATGCGTGTAATCTCAGCACTTTGGAAGGCCGAGGCAGGTGGATCACCCGAGGTCAAGAGTTCAAGACCAGCCTGACCAACATGGCGAGTCTCTGTCTCCACTAA"
"GL873586","5645995","5646150","chr6","58863249","58863409","38","53217254","GGGTATGGTGGCTCATGCCTGTAATCCAAGCACTCTGGGATGGTGAGGCAGGAGAATCCCTTGAACCCAAGAGTCCGAGGTTGCTGCGAGCTAAGCTGATGGCATAACACTCTAGCCTAGGCGACAGAGTGAGACTCTGTTTCCAAAGAGAAAAAA","TTAGCCAGGCATGGTGGCACATGCCAGTAATCCCAGCTACTCAGGAGGATGAGGCAGGAGAATCGCTTGAACCCAGGAGGCAGAGGTTGCAGTGAGCTGAGATTGCGCCACAGCACTCTACCCTGGGTGACAGAAGGAGACTCTGTCTCAAAAAAAAAAAA"
"GL873586","10258686","10258969","chr12","9481260","9481565","81","777426","GGCCGGGCATGGTGGCAGAAATCTAGGAGGCCGAGGCAGGTGGATCGCCTGAGATCACAAGTTCAAGACCAGCCTCAGCTACAGCAAGACCCCATCTCTAAAAATAGCCGGCTGTTGTGGCAGGCGCCTGTAACCCCAGCTACTCGGGAGGCTAAGGCAAGAGAATCGCTTGAGCCCATGAGTCTGAGGTTGCTGCGAGCTGTGACTCCACGGCACTCTACCCGGGGCGATAAAATGAGATTCTGTGTCAAAACAAACAAACAAACAAACAACAACAAAAACAA","GCTGGGCGCGGTGGCTCATGCCTGTAATCCCAGCACTTTGGGAGGCCAAGGCAGGTGGATCACCTGAGGTCAGGAGTTCGAGACCAGCCTAGTCCACATGGTGAAACCCCATCTCTACTAAAAACTAGCCAGGCGTGGTGGTGCGCACCTGTAATCCCAGCTACTCGAGAGGCTGAGGCAGGAGAATCACTTGAGCCTAGGAAGCAGAGGTTGTGGTGAGCTGAGATCACACCACTGCACTCCAGTCTGGGCGACACAGTGAGACTCTTGTCTCAAAAACAAAAAACAAACAAACAAACAAACAAA"
"GL873587","3208032","3208047","chr8","3626746","3626762","2","418714","AAACAACCACAAAAAA","ACAACAACAACAAAAAA"
"GL873587","3208141","3208321","chr19","2057131","2057316","59","1151010","TTTCTTTTAAAAATCACCCATGGGCTGGGTATAGTGGCTCACACCTATAATCCTCGGGAGGCCAAGGTTGGAGGATTGCTTGAATCCAGGAGTTGAAGGTTACAGTGAACTGGGATTTAGCCACTAGACTCTAGCATAGCTGACAAAGCAAGAACCTATTTGTTTAAAACACAAAAAAGAA","TACTAATAATACAAAAATGAGCCGGGTATGGTGGCGGGTGCCTGTAATCCCAGCTACTGAGGAGGCTGAGGCAGGAGACTTGCTTGAACCCAGGAGGTAAAGGTTGCAGTGAGCTGAGATTGCACCACTACACTCCAGCCTGGGCGACAAGAGCAAAACTTTTTCTCCAAAAAAAAAAAAAAAAAA"
"GL873587","3278260","3278367","chr19","19044200","19044312","39","15765940","CAGTCTGAGCAAGAGGGAGAGGCTATTTCTACTAAAAACAGAAAAACTAGCTGGGTGTTGGGGTGTGTTCCTAGTCTCAGTTACTTGGGAGGCTGAAGTAAGAGGATC","ACCAGCCTGGCCAACACGGTGAAATCCCGTCTCTACTAAAAATACAAAAATTACCTAGGCGTGATGGCACGTGCCTGTAGTCCCAGCTACTCATAAGGCAGAGGTGAGAGAAT"
"GL873587","3278673","3278754","chr7","49412503","49412597","28","46133830","GGCCACGAGAGCTAGCTCATGCCTATTCTAGGAGGCCAAAGCAGGCAGACTGCCTGAGCTCAGGAGTTCAAGAGCAGCCTGG","GGCCAGGTGCAGTGGCTCATGCCTGTAATCCGAGCACTTTGAGAGGCCGAGGCAGGCAGATCACCTGAGGTCAGGAGTTCAAGACCAGCCTAGTA"
"GL873587","3782076","3782188","chr9","112128434","112128552","34","108346358","ACTGGGGTGGCTGAGGCAGGAGCGTCACTTGAACTCAGGAGTTTGAGATTGCTGTGAGCTGAGCAGATGTCATGGCACGCTAGCCTAGGTAATAGAGTGAGACTTCGTCTAAA","CAGCTACTCGGGAGGCTGAGGCAGGAGAATCACTTGAACTCGGGAGGCGGAGGTTGCAGTGAGCCGAGATCACGCCATTGCACTCCAGCCTGGGCAACAAGAGCGAAATTCCATCTCAA"
"GL873587","4564996","4565084","chr20","27900350","27900437","14","23335354","GGCGGGGTGTAGTGGCTCATGCCTATTGTCCCAGCACTGTGGGAGGCCGAGGTGGGTGGATCACCTGTGCTCAGAAGTTTGAGACCAGC","GGCCGGGCGTGGTGGCTCATGTCTGTAATCCCAGCACTTTGGGAGGCCGAGGTGGGTGGATCACCTGAGGTCAGGAGTTCAAGACCAG"
"GL873587","6307870","6308175","chr12","112427710","112428020","54","106119840","GGCCAGATATGATGGCTCATGCTTGTAATCCTAGCACTCTGGGAGGCTGAAGTGGGAGGATCACCTGAGATCAGGAGTTCAAGATCACCCTGAGCAAAAGTGAGATCCCATCTCTATTAAAAATAAAAAAATTATCCAGGCATGGTGGTGCAGTCCTTTAGTCCCAGCTACTTGGGAGGCTGAGGCAGGAGAATCTCTTGAACCCAGGAATTAGAGGTTACAGTGAGCTGTGATGATGCTACTGCACTCTAGCAGGATGACAGAGTGAGATACTCCGTGTCAAAAAAAAAAAAAAAAAAAGCAAAA","GGCTGGACATGGTGGTTCATGCTTGTAATCCGAGCACTTTGGGAGGCCAAGGCGGGTGGATCACCTGAGGTTGGGAGTTCGAGACCAGCCTGACCAACATGATGAAACCCCATCTCTACTAAAAATACAAAAAAATTAGCCAGGCATGGTGATGCACGCCTGTAATCCCAGCTACTTGGGAGGCTGAGGCAGGAGAATCACTTGAACCCAGGAGGCAGAGGTTACAGTGAGCCGAGATCATGCCATTGCACTCCAGCCTGGATGACAGAGTGAGCCTCTGTCTCAAAAAAAAAAAAAAAAAAAAAAAAAAA"
"GL873587","6484004","6484128","chr10","67341428","67341546","29","60857424","GACCAGGTTCTGTGGCTCATGCTTGTAATCCTAGCACTCTAGGAGGCCGGAAGAGGGTGGATTGATTGCCTGAGGTCAGGAGTTAGAGACCAGCCTGAGCAAGAGCTAGACCCTGTTTCTTTCTT","GGCTGGGTGTAGTGGCTCATGCCTGTAATCCCAGCACTTTAGGAGGCCAAGGTGGATGGATTGCCTGAGCTCAGGAGTTCGAGACCACCCTGGGCAACAAGCCAAAACCCTGTCTCTAC"
"GL873587","6484407","6484586","chr3","167196537","167196723","48","160712130","TAGACCCTGTTTCTAAAAAAAAAATAGCCAGGTGTTGAGGCAGGTACCTGTAGTCCCAGCTACCTGGGAGGGCTGAGGCAAGAGAATCGCTTGAACCCAAGAGTTTGAGGTTGCTGTGAGCTGAGATGCTATGGCACTCAACCGTGAGCTACAAAGTGAGACTCTGTCTCAAAAAAAAAA","AAAACCTGTCTCTGCTAAAAATACAAAAATTAGCCGGGTGTGGTGATGTGCGCCTGTAGTCCTAGCTACTTGGGAGGCTGAGGCAGGAGAATCACTTGAATCCAGGAGGTGGAGGTTGTAGTGAGTCGAGATCGTGCGACTGCACTCCAGCCTGGGTGACAGCGAGACTCTGTCTCAAAAAAAAAAA"
"GL873587","7466229","7466364","chr1","29437872","29437991","35","21971643","GGCCAGGCGTGGTGGCTCATGCCTGTAGTCCCAGCGCTATGGGAGGCCGAGGTGGGTGGATCACCTGTGCTCAGAGGTTCGAGACCAGCCAAGACCCCCCTGAGCCAAATGAGCCAGAGTGAGATCCCATCTCTAC","GGCCGGGCGTGGTGGCTCACGCCTGTAATCCCAACATTTTGGGAGGCCAAGGCGGGTGGATCACCTGAGGTCAGAAGTTCGAGACCAACCTGGCCAACATGGTGAAACCCCTGTCTCTAC"
"GL873588","1502535","1502718","chr1","34852429","34852590","60","33349894","GGTGCAGTGGCTCACACCTGTTGTCCCAGCGCTGTGGGAGGCCGAGGTGGGTGGATCACCTGTGCTCAGAGGTCGAGACCAGCTGAAGACCTGCCTGAGGCAGAGTGAGCCAGAGTGAGACCCCGTCTCTACTAGAACAACAACAAGACAGCCAGACCTTGTGATCCCAGCTACATGGGGGGCT","GCCAGGTGCAGTGGCTCACACCTGTAATCCCAGCACTTTGGGAGGCCGAGGCGGGCGGATCACCTGAGGTCAGGAGTTTGAGACCAGCTTGACCAACATGGAGAAACCCCGTCTCTACTAAAAATACAAAATTAGCCTGGTGTGGTGTCGCATGCCTGTAAT"
"GL873588","10189037","10189246","chr3","45604681","45604903","65","35415644","GCTGAGATGAGGAGACTCTGTCTCTATTAAAAATAGAAAAATTGGGTGGATGTTGTGGGTACTGTAGTTGCAGCCTCTTGGGGGGCTAAGGCAGGAGGATCAGTTGAAGCCAGGAATTTGCTTTGAGCTAGGCTAAAGCCATGGCACTCTAGCCTGGGCAACAGAGTGAGGCTAGATCTCAAAAAAAGAAAGAAAAGAAAAAGAAAAAAA","CTGGCCAACATGGCAAAACCCCATCTCTACTAAATATACAAAAATTAGCTGGACGTGGTGGCACATACCTGTAATCCCAGCTACTTGGAAGGCTGAGGCAGGAGAATAGCTTGAACCTGGGAGGCAGAGGTTGCAATGAGCTGAGATCACGCCACTGCACTCTAGCCTGGGCAATAGAATGAGACTCTGTCTCAAAAAAAAAAAAAAAAAAAAAGACAAGAAA"
"GL873589","104719","104807","chr20","27900350","27900437","13","27795631","GGCTGGGCGTGGTGGCTCATGCCTGTTGTCCCAGCGCTGTGGGAGGCTGAGGTGGGTGGATCACCTGTGCTCAGAGGTTCGAGACCAGC","GGCCGGGCGTGGTGGCTCATGTCTGTAATCCCAGCACTTTGGGAGGCCGAGGTGGGTGGATCACCTGAGGTCAGGAGTTCAAGACCAG"
"GL873589","796766","796905","chr1","166346372","166346487","49","165549606","GGCTAAGTGTGGTGGCTCACACCTGTCATCTAGTACTTTGGGAGGGTGGGCCTGGGAGTTCAAAGACTGAACTCAGGAGTTCAAGGTGGCTCCGGGGAGGAATTCAAGACCAACCTGAGCCAGAGCGAGACCTCGACTCT","GGCCAGTGGGGTGGCTCACGCCTGTAATCCCAGCACTTTGGGAGGCTGAGGTGGTCAAATGACCTGAGGTCAGGAGTTTGAGACCAACCTGGCCAACATGGTGACACCTCGTCTCT"
"GL873589","1023679","1023690","chr1","205890061","205890072","1","204866382","AAAAAAAAAAAA","ACAAAAAAAAAA"
"GL873589","1023771","1024047","chr4","103012712","103012993","70","101988941","GGCTTGGTGGCTCACACCTGTAATCCTAGCACTCTGGGAGGCCGAAGTGGCTGGAATACTTGAGGTCAGGAGTTCAAGACCAGCCTAAGTGAGAGTGAGATCCCCATCTCTAATAAAAATAGAAAAATTAGCAGGGTGTTGTGGCTGGCACTTGTAGTCCCAGCTACCCAGGAGACCGAGGCAGAAGTTTGAGATTATTGTGAGCGAGGCTGATGCCACAGCATTCTAGTGGGACAACAGAGCAAAATTCTATCTCAAAAGAAAAAAAAAAAAAGGA","CGGGCGTGATGGCTCACGCCTGTAATCCCAACACTTTGGGAAGCCGAGGCGGACGTATCACCTGAGGTCAGGAGTTCAAGACCAGCCTGGCCAACATGGTGAAACCCCGTCTCTACTAAAAATACAAAAATTAGCTGGGTGTGGTGGCATGCGCCTGTAATCCCAGCTACCCAGGAGGCTGAGGCAGGAGAATCGCTGAGGCTGCAGTGAACTGAAATTGTGCCACTGCACTCCAGCCTGGGTGACAGAGCAAGACTCTGTCTCAAAAAAAAAAAAAAAAAA"
"GL873589","4820958","4821024","chr8","33633747","33633811","15","28812789","TTAGTCAAGTGCAGTGGCTCACACCTGTCATCCCAGCTACTTGGGAGGCTGAGGCAGGAGAGTTGCT","TTAGCCAGGTGTGGTGGTGCATGCCTCTAATCCCAGCTACTCAGGAGGCTGAGGCAGGAGAATTG"
"GL873589","6763768","6763857","chrX","25814002","25814092","29","19050234","GGTGTGGTGGCTCACACTTGTATCTTAGCATTTTAGGAGGCTGAATGGGGAGAATTGCTTTAAGTCAGGAGTCTGACTTCCACCTTGCCA","GGCTGGGAATGGTGGCTCACACCTGTAATCCCAGCACTTTGGGAGGCTGAGGTGGGCAGATCACCTGAGGTCAGGAGTTTGAGATCAGCCT"
"GL873589","8444551","8444632","chr9","93194085","93194171","17","84749534","CGGGCATGGTGGCTCACAACTATAATCTTAGCACTTTGGGAGGCTGAGACAGGTGGATGCCTGAACTCAAGAGTTTGAAACC","GGCCGAGCATGGTGGCTCACACCTGTAATCCCAGCACTTTGGGAGGCTGAGGCAGGTGGATTACCTGAGGTCAAGAGTTCAAGACCA"
"GL873589","9085365","9085494","chr2","194063347","194063481","42","184977982","GGCCAGGCACAGTGGCTCACACCTATAATCCCAGCACTCTGTGAGACTGAGGCAGGTGAACTGTTGCAAGAGTGAGACCCTGTGCTTGGTGCCTGTAGCTCAGTGGTTAATAATAAGAAAAAAGAAAAAA","GGCCAGGTGCAGTGGCTCACACCTGTAATCCCAGCACTTTGGGAGTCTGAACCAGGCAGATCACCTGAGGTCAGGAGTTCGAGGCCAGCTCGGCCACCATGGTGAAACCCTGTTTCTAATAAGAATACAAAAAAA"
"GL873589","9085767","9086002","chr7","84631446","84631650","75","75545679","GAGTGAAACCCTGTCTCTACTAAAAATAGAAAAACTAGCTGTGCATCAGGGCGCATAACTGTAGTCCCAGGTACTCAGGACACTGAGGCAAGAGAATTGCTCAAGCCCAAGAGTTTGCAAGAATTTGAGGTTGCTATGAGCTATGATGCCATGGCACTCTACCTAGGGTGACAGACAGAGACTCTGTCCCAAAAAAAAAAAAAGAAGAAGAAGAAAAAAAAAAAGAAAGAAAGAAA","ATAGTGAAACCTCGTCTCTACTAAAAATACAAAAATTAGCTGGGCATCATGGTGCACGCTTGTAATTCCAGCTACTTGGGAGGCTGAGGCAGGAGAATTGCTTGAACTCAGGAGGTGGAGGTTGCAATGAGCCAAGATCGCGCCACTGCACACCAGCCTGGGTGACAAAAGACTCTGTCTCAAAAAAAAAAAAAAAAAAAAAAAA"
"GL873589","9992904","9993045","chr16","56427538","56427666","46","46434634","AACCAGCCAGGCATGGTGATTCACACCTATAATCCCAGCTACTTAGGAGTATGGCTTGAGCACACAGGATACCATACCATTCTAGTCATCCCAGGCAACAGAGGGAAACTCTGTTGGTTAAAAAAAAAGAAAAACTTAAAAA","TTAGCCAGGAGTGGTGGTGCACGCCTATAATCCCAGCTACTTGGGAGGCTGAGGCACAAGAATCACTTGAACCATTGCACTCCAGCCAGGGTGATAGAGGGAGACTCTATCCAAAAAAAAAACAAAAAA"
"GL873589","9993319","9993452","chr3","2774534","2774668","28","7218785","GGCCTGAGCCCTGTGACTCATGCCTGTAATCCCAGCACTGGAAGTTCCAAGGCAGGTGGATCGCTTGAGCTCTGGAGTTCAAGACCAGCTCAACCAAGAGTAAGACCCCATCTCTACTAAAAATAGAAAAACCA","GGCTGGGCACGGTGGCTCATGCCTGTAATCCCAGCACTTTGAGAGGCCGAGGCAGGTGGATCTCCTGAGGTCAGGAGTTCAAGACCAGCCTGGGCAACATGGTGAAACCCCATCTCTACTAAAAATACAAAAAAT"
"GL873590","9044589","9044884","chr1","83754525","83754835","84","74709936","GGCCAGGTGCAATGGCTCATGCCTATAATCCTCACACTCTGGGAGGCTGAGGCAGGAGGATCACTTTTCTCAGGGTCAGGGCCAGCCTGACAAAAGTCAGACCCTGTTTCTACTAAAAATAGAAAAACTAGCTGGGTGTTGTGGCAGATGCCTATAGTCCCAGCTACTAAGAGACTGAGACAAGTGCCCAGAGTCTGAGGTTACTGTGAGCAAAGCTGATGCCATAGCATTCTAGCTATAGATCGAGAGTCTGTCTCAAAAACAAACAAACAAACAAACAAACAAACAAAAAAGAA","GGCTGGGTGTGGTGGCTCATGCCTGTAATCCCAGCACTTTGGGAGGCCGAGGCGGGTGGATCATCTGAGGTCAGGAGTTCAAGACCAGCCTGACCAACATGGTGTAACCCTGTCTCAACTAAAAATACAAAAATTAGCTGGGCGTGGTGGTGTGCACCTATAGTCACAGCTACTTGGGAGGCTGAGACAGGAGAATTGCTTCAACCCAGGAAGTGGAGGTTGCAGTGAGCCAAGATCATGTCACTGCACTGCAGCCTGACAGAGCGAGACTCCATCTAAAACAAACAAACAAAAACAAACAAACAAACAAA"
"GL873591","1831505","1831587","chr17","61702818","61702899","25","59871313","CCCAGCACTTTGGGAGGGCAAGATGGGAGAATCATATAAAGTCAGGAGTTTGAGACCAGTTTGGCAGACATGATGAACCCATC","AATCCCAGCACTTTGGGAGGCTGAGGCAGGCGGATCATCTGAGGTCAGGAGTTCAAGACCAGCCTGGCCAACATGGTGAAAC"
"GL873591","2719175","2719275","chr4","86137755","86137847","32","83418580","GTGGGGGCTTAGGCCTGTAATCCCAGCACTCTGAGAGGCCAAGGTGAGCTGGTCACCTGGGTTTAGGAGTTTGGAGACTTGCTCGAGCTAGACTGAGGCTC","GTGGTGGCTCACGCCTGTAACCCTAACAATTTGGGAGGCCAAGGCAGGTGGATCACTTGAGGTCAGAAGTTTGAGACCAGCCTGGACAATATG"
"GL873591","4732974","4733120","chr19","7991801","7991954","55","3258827","ATACGCAGACTGGCCGAGCGTGGTGTCACATGCCTATAATCCCAGTGGCTACTCTGGGGAGGAGAATCTCTTGAAACCAAGAGTTAGAGATTGCAGTGGGGTATGATACAGGGTAACAAAGAGAGACCTTGGATCTGAAAAGAAAAA","AAAATACAGAAACTAGCTGGGCATGGTGATGCACACCTGTAATCCTAGCTACTGGGGAGGCTGAGGCAGGAGAATTGCTTGAACCCAGGAGTCAGAGGTTGCAGTGAGCAACCAGCCTGGGTGATACAGTGAGTGAGACTCTGTCTCGAAAAAA"
"GL873591","6822728","6823009","chr1","20579766","20580052","72","13757038","GGCCAGGCGTGGTGGCTCATGCCTGTAAATCTCAGCACTCTGGGAAGCTGAGGCAGGTGGATTGCTTGAGGTCAGGAGTTTGAGACCAGCCTGTACCAGAGTAAGACCCTGTCTCTAATAAAAATAGAAAAAAAAAAAAAAACTAGTTGGGCATGGTGATGGGTGCCTGTAGTCCCACCTACTTGGGAGGCTGAGGCAATGGCATCTCTTGAGCCCAAGAGTTTGAGGTTGCTGTGCCATGGCACTCTCCCCAGGGTAACAGAGTGAAAATAAAAAAAAGAA","GGCCAGGCGTGGTGACTCATGCCTGTAATCTCAGCACTTTGGGAGGCCGAGGCAGGTGAATCACCTGAGGTCAGGAGTTTGAGACCAGCCTGACCAACATGGTGAAACCTCGTCTCTACTAAAAATACAAAAAGTAGCCAGGCATGGTGGCGCATGCCTGTAATCCCAGCTACTTGGGAGGCTGAGGCAGGAGAATCGCTTGAACCCGAGAGGCAGAGGTTGCATTGAGTCAAGATGGTACCACTGCACTCCAGCCTGGGTGACAGATTGAGACTCAAAAAAAAAAA"
"GL873591","7578706","7578813","chr16","45055441","45055543","42","37476735","AAATTTAGCTACACATAGTGGCATGAGTCTGTAATGCTAGCCACCCAAAAGGCTGTAGTAAGAGGATTGCTCTATCCCAGGAGTTAAAGACCAGCCCGGACATCAGAG","AATTAGCCGGGCGTGGTGACACACACTTGTAATCCTAGATACTCAGGAGGCGAAGGTAGGAGAATTGCTTGAACCCAGGCAGCAGAGGTTGCAACGAGCAGAG"
"GL873591","9282916","9283004","chr1","20744253","20744338","16","11461337","GGCCAGGCGCGGTGGCTCACCCCTGTTGTCCCAGTTCTGTGGGAGGCCGAGGTGGGTGGATCACCTGTGCTCAGAGGTTTGAGACCAGC","GGCCAGGCACGGTGGCCACGCCTGTAATCCCAGCACTTTGGGAGGCCGAAGTGGGTGGATTACCTGAGGTCAAGAGTTTGAGACCA"
"GL873592","835155","835315","chr16","75654291","75654451","43","74819136","CTGGGTGTGGTGGCTCTTGTCTGCAATCTCAGTACACTGGGAGGCTGAGGCAGAAGGATTGCTCCAGCTCAGGAGTTTGAGGCCAGGCTGAGCTAGTGCAAAACCCCATCTCTACTAAAAAAAGAAGGAAAAAAAAAAGAAAAAGAAAAAAAATACGAGCT","CCAGGTGTGGTGACTCACGCCTGCAATCCCAGCACTCTGGGAGGCTGAGGTGGGTAGATTACCGGAGGTTAGGCGTTTGAGACCAGCCTGGCCAACATGGTGAAACCCCATCGCTACTAAAAAAAAAAAAAAAAAAAAAAAAAAAAAAAAAAAAAAAATTA"
"GL873592","835589","835765","chr1","66836166","66836336","48","66000577","ACAAAAAACCTAGCTTAGGGTTGTTATAGCACCTGTAGTCCCAGCTACTCAGGCGCTAAGGCAGGAAAATCTGCCTGAGCTCAGGAGTTTGAGGTTGCAGTAAGTTATGATGATGCTACTGCACTCTAGCTGGGGCAACAGAGTGAGACTCTGTCTGAGGAAAAACCAAAACCAAAA","TAGCCCAGCACGGTGGCTCACACCTGTAGTCTCAGCTACTCAAGAGGCTGAGGCATGAGAATCGCTTGAACCCAGGAGGTAGAGGTTGCAGTGAGCTGAGATCATGCCACTGCGCTCCAGCCTGGGCAACAGAGTGAGACTCAGTCTCAAAAAACAAAACAAAACAAAAAA"
"GL873592","2520661","2520705","chr16","66853217","66853257","11","64332556","TCTGGGAGGCTGAGGCGGGTGGATCACCTGAGCAAGAGTGAGACC","TTTGGGAGGCTGAGGCAGGTGGATCACTTGAGGTCAGGAGT"
"GL873592","4535248","4535388","chr1","12240468","12240612","38","7705220","GGCGGGATGTGGTGGTTCATGGCTGTAATCCCAGCACTCAGGGAGGCTGAGTCGGGTGGATTGCTTGAGTTCAGGAGTTTGAGACCAACCTGAGCAAGAACTAAGCCTGTCTCTACTAAAGATATTATTTCTTATTTTTCT","GGCCGGGCGCGGTGGCTCATGCCTGTAATCCCAGCACTTTGGGAGGCTGAGGCGGGTGGATCACCTGCGGTCAGGAGTTCGAGACCAGCCTGGCCAACGTGGTGAAACCTCATCTCTACTAAAAATATAAAAATTAGCTGGTGTG"
"GL873592","4535654","4535831","chr8","126054004","126054184","54","121518350","TCTACTACAAATATTAACAGAAAAATTAGCTGGGCATTGTGACAGGTGCCTATAGTCCCAGATACTCAGAAGGCTGAAGTAAGAGGATCACTTGAACCCCAGGAGCTAAGGTGGCTGTGAGCTAGGCTGAGGCTCTAGCCTGGGTAACAGAGTGAGACTGTAAAAAAAGAAAGAGAGA","GTCTCTACTAAAAATACAAAAATTAGCTGGGTGTGGTGGTGCATGCCTGTAATCCCAGCTACTCAGGAGGCTGAGGCAGGAGAATCGCTTGAACCCAGGAGGTAGAGGTTGCAGTGAGCCAAGATCATGCCACTGCACTCCAGCCTGGGTGACAGAGGGAGACTCTGTCTCAATAAATAAA"
"GL873592","6794968","6795049","chr3","154764711","154764794","20","147969743","GAAGGTTTGATGAGCTCAGATGATGCCACTGCAGTCTACCCAGAGTGAAGGAGCGAGACTCTGTCTCAAAAACAAAAAAAGA","CAGAGGTTGGCAGTGAGCTGAGACTGTGCCACTGCACTCCAGCCGGGTGACAGAGTGAGACTCTGTCTCAAATTACAAACAAAA"
"GL873592","6881384","6881478","chr5","24882384","24882475","28","18001000","GGGCAGGCATAGTGACTGGTGTCTCTAATCCTAGCAGTCTGGGATGCTGAGGCAAGTGGAATGTCAGAGTTCAGGAGTTGAAGATCACCCTGACT","GGCCGGGCGCAGTGGCTCACATCTATAATCCTAGCATTTTGGGAGGCTGAGGCAGGCGGATCACCTGAAGTCAGGAGTTTAAGACCAGCCTG"
"GL873592","6881755","6881937","chr10","61601371","61601572","66","54719616","TCACCCTGACCAAGAGCAAGACCCTGTCTCTACTAAAAATAGAATAAACTAGCTGGGAATTGTGGTGGGTGCCAGTAGTCCCCGCTACTGAGGCAGGAGGATCATTGAGTCCAAGAGTTTGAGGTTGCTGTAAGTTAGGACACCACAGCACTCTACACAGAGTAAGACTGCCTCAAAAATAAA","AGTAAAGAAAAGAAACCCTGTCTCTACTAAAAATACAAAAATTAGCTGGGTGTGGTGGTGCGCACCTGTAGTCCCAGCTACTTGGGAGGGTGAGGTATGGGAATCACTTGAACCCGGGAGGTGGAGGTTGCAGTGAGCCAAGATCACACCACTGCACTCCAGCCTGGGTGAGAGAGTGAGACTCTGTCTCAAGAAAAAAGAA"
"GL873592","7006080","7006155","chr1","8947061","8947129","24","1940981","CACACTGAGAGGCAAAGGCTGGTGGATCACCTGAGCTCAAGAGTTTGAGACCAGCCAAGCCAGAGATCTTGTCTCT","CACTTTGGAGCCAGGTAGGTGATCACCTGAGTCAGGAGTTCGAGACAGCCTGGCCAACATGTGAAACCC"
"GL873592","8446508","8446655","chr11","122502739","122502874","48","114056231","TTAGCTGGGTGTTGTGGCAGGCACCTGTAGTCCCTCCCAGCTACTTGAAAGGCTGAGGCAAGATGACAGCTTAAACCCAAGAGTTTAAGGTTACTCTATTCAGGGCAACAGAGTGAGACTCCATCTACATAAATAAATAAATAAATAA","GGCTGGGCGTGGTGGTTCACACCTGTAATCCCAACACTTTGGGAGGCTGAGGCCAGCGGATTGCCTGAGCCCAGGAGTTTGAGACCAACCTGGGCAACATGGTGAAACTCCATCTCTACTAAAATACAAAAAGTTA"
"GL873592","8446953","8447008","chr16","44513352","44513404","15","36066399","GACCAGCCTAAGCAAAAAAGAGATCCTATCTCTACTACTAAAAATAGAAAAAATTA","ACCAGCCTCACCAATATGAAGAAACCCCATCTCTACTAAAAATACAAAATATT"
"GL873592","8447239","8447325","chr1","8062863","8062957","21","384376","GGCCAGGAGCAGTGACTCATGCCTAGCACTCTGGGAGGCCAAAGCAGGTGGATCAACTGAGCTCAGGAGTTCAAGACCAGCCTAAGC","GGCCGGGTGCAGTGGCTCATGCCTGTAGTCCCAGGACTTTGGCAGGCCAAGGCCGGTGGATTACCTGAGGTCAGGAGTTCAAAACCAGCCTAGCC"
"GL873592","8723925","8724000","chr3","42066983","42067054","20","33343058","AATTAGCCGGGCATGGTAGTGTGTGCCCATAATCTCAGCTACTCAGAAAGCTAAGATAGGAAAATTGCTTGAGCTC","TTAGCTGGGTGTGGTAGTGCATGCCTATAATCCCAGCTACTCGGGAGGCTGAGGTGGGAGAACTGCTTGAAC"
"GL873593","384022","384146","chr15","102382935","102383070","28","101998913","GGCCACGAGGGCCCATGCCTGTAATCCTAGCACTCTGGGAGGCTGAGGTGAGTAGATTGCTGAGCTCAGGAGTTCAAGACCAGCCTGTGCAAGAGACCCCATCTCTGCTAAAAATAGAAAAACCA","GGCCAGGTGTGGTGGCTCACGCCTGTAATCCTAGCACTTTGGGAGGCTGAGGCGGGTGGATTGCCTGAACTCAGGAGGTCAAGACCAGCCTGGGCAACACAGTAAAACCCCATCTCTACTAAAATACAAAAAATCA"
"GL873593","384425","384607","chr20","28286874","28287058","50","27902449","GAAAGAAAAGAAAAGAAAAACTAGCAAGATGTTGTAGCTGATGCCTATAATCCTAGCTATTGGAGAGGTGGAGGCAAGAGAATTGCGTGAGCCCAAGAGTTGAAGGTTGCTGTGAGCTGCGATGCCAGAGCACTCCAGGGTGACAGAGTAAGACTCTGTCTCAAAAAAAATTACAAAATAAAA","TAATAAAAATAAAAAAATTAGCCAGGAGTCAAAGCACACGCCTATAACCCCAGCTACTTGGGAGGCTGAGGGAGGAGAATTACTTGAACCCGGGAGGTGAAAGTTGCAATGAGCTGAGATCAAGCCACTGCACTCCAGACTGGATGACAGAGTGAGACTCTGTTTCAAAAAAAAAAAAAAGACAA"
"GL873593","1408445","1408467","chr10","88070368","88070389","9","86661923","AATCTAGAGATGGGGAGAGGTTG","AAAGAGATGGAAGAGAAGAAGA"
"GL873593","4856365","4856484","chr7","56497314","56497433","31","51640949","GCAATCCCAGCTGATCGGGAGGCTGACCCAGAAGAATCCCTTGAACCCAAGAGTCTGAGGTTGCTATGGGTGGATTCTACAGCACTCTAGCCTGGGAGACAGAGTGAGACTCTGTCCCAA","ATCCCAGCTACTTGGGAGGCTGAGACAGAAGAATTGCTTGAACCCGGGAGGTGGAGGTTGCAGTGAGCCAAGATTGTACCACTGCACTCCAGCCTGGCAACAGAGTGAGACTCTGTCTCA"
"GL873593","6661298","6661485","chr10","86749316","86749514","55","80088018","GCAGAGGCTCACATATGTAATCCTAGCACTCTGGGAGGATAAGGCAGGTGGACAGCTTGAGCTCAGGGGTTTGACCAGTCTGATCAAGAGCAAGACCTGTGTCTACTAAAAATAGAAAACCTAGCCAGGTATGATGGTAGATGCCTGTATTCCTAGCTACTCTGGAAGCTAAAGCTAAAGAGTTTGAA","GGTGGCTCACACCTGTAATCTTAGCAATTTGGGAGGCCGAGGTGGGTGGATCACTTGAGGTCAGGAGTTTGAGACCAGACTGGCCAACATGGTGAAACTCTGTCTCTACTAAAAATACAAAAATTAGCCAGTCATGGTGGTGCATGCCTGTAATCCCAGCTACTCAGGAAGCTTAGGCAGGAGAATCACTTGAACCCAG"
"GL873593","6710263","6710446","chr14","4390080","4390244","66","2320183","TTGAAGTCAGGAGTTTAAGGCCAGTCTGGGCAACATAGTGAGACCCCCATCTCTACGAAAATATTTTTTAAAAATTAAAAATAGCTGGGCATAGTGAGGCTGTTGTGAGCTATAACTGCACCACTGCACTCAGCCAAGGACAGAGACCCTGTTCCCTGCCTCAAACAAACCAAAACAAAACAAA","AAGTCTAGAGTTTACAGCCTGGACAACGCAGTGAAACCCTGTCTCTACCAAAAATACAAAAATTAGACAGGTGTGAGAGGCGGAGGTTGCAATGAGCTGAGATCGCAGCACTGCAGTCCAGCCTGGATGACAGAGCGAGACCCCATCTCAAAAACAAAAACAAAA"
"GL873593","7159645","7159716","chr6","178318394","178318465","21","171158749","GATCATGTCACTGCTCTCCAACCTGGGCAATTGAGCAGGAATCTGTCTCAAAAAGAAAAAAAAAAAAGAAAA","CGAGTTCACACCACTGCACCCCAGCCTGGGCAACAGAATGAGACTCGGTTTCAAAAAAAAAAAAAAAAAAAA"
"GL873593","7159841","7160050","chr13","33368171","33368368","69","26208330","GGCCAGGCGTGGTGGCTCACACCTGTTGTCCCAGTGCTGTGGGAAGCCGAGGCAGGTGGATCACCTGAGCTCAGCCGAGTTCGAGACCAGTGGAAGACCAGCATGAGGCAGAGTGAGCCAGAGTGAGACCCCATCTCTACAACAACAACAAGAAGAAAAAAAACAGCCGGACCTTGTGATCCCAGCTACGTGGGGAGCTAGAGAATCACT","GGCTAGGCATGGTGGCTCATGCCAGTAATCCCACCACTTTGGGAGGCCGAGGCAGGTGGATCACCTGAGGTCAGGAGTTCAAGACCAGGCTGGCCAACATGTTATGATGAGACCCTCATCTCTACTACAAATACAAAAATCAGCTGGGCATGGTGGCAAGTGCCTGTAATCCCAGCTACTTGGGAGGCTGAGGCAGAA"
"GL873593","8598292","8598391","chr11","118461023","118461129","33","109862731","AGCCAGGTGAGGTGGTTCACACCTGTAACCCTAGCTGCTTGGGAGGCTGAGGCCTCTCTATCCTGGGCAGTGTGGAGAAACTTTGTTTCAAAAAAAAGAA","GCCGGGCGCGGTGGCTCACGTCTGTAATCCCAGCGCTTTGGGAAGCCGAGGCGGGACTATCCTGGCCAACATGGTGAAACCCCGTCTCTACTAAAAATACAAGAATC"
"GL873594","357249","357377","chr2","75702890","75703011","36","75345641","CCTGGTACCGTAGGTCATGCCTGTAATCCTAGCACTTTGGGATGCTGAGGTGGGCAGATTGCCTGAGCTCACGAGTTCAAGCCATTAGAACTGAGCCTGACCTAGAGTGGGACCTCCAACTCTTTTTTT","GCCAGGCACAGTGGCTCATGCCTGTAATCCCAGCAGTTTGGGAGGCTGAGGTGGGCAGATCACTTGAGGTCAGGAGTTCAAGACCAGCCTGGCTGACATGGTGAAACCCCATCTATACCAAA"
"GL873594","357656","357834","chr7","17608776","17608965","55","17251120","GGGACCTCCAACTCTTAAAATAGCTGGGCATTGTGGTGGGCACCTACAGTCACAGCTACTTGGGAGGCTAAGGCAAGAGACTTGTTTGCAGCCAAGAGTTAGAGGTTGCTGTGAGCTATGAGGCTAGGGCACTCTACAGGGGGCGACAAGTGAGACTGTAAAAAAAAAAAAAGAAAAAA","GTCCCTACTAAAAATACAAAAAATTAGCTGGGCCTGGTGGCAGGCACCTGTAATCCCAGCTACTTGGGAAGCTGAGGCAAGAGAATTGCTTGAACCCAGGAGGCAGAGGTTGCAGTGAGCTGACATCAAGCCACTGTACTCCAGCCTAGGCAACAAGAGCAAGACTCTGTCTCAAAAAAAAAAAAAAAAA"
"GL873594","1410711","1410996","chr5","151340503","151340797","76","149929792","CACAGTGGCTCATACCTATAATCCTAACACTCTGGGAGGCCAAGGTGGGTGGACTGTCTGAGTTTGGGACCAGCCTGAGCAAAAGCAAGACTCCCATCTCTACTAAAAACAAAGACAGCCAGGTATGAGGGCAGGTGCCTATCATCCCAGCTACTTGGGAGGCTGAGGAAGGAGGATCACCTAAGCCCAGGACTTTAAGGTTTCTGTGAACTAAGATGATGTTACAACACTCTAGCCAGGGTAACAAGGCAAGATTCTGTTTCAAAAGACAAAAAAAAAAAAAAAA","GGTGGTTCATGCCTGTAATCCCAGCACTTTGGGAGGCTGAGGCAGGTGGATCACCTGAGGTCAGGAGTTCGGGACCAGCCTGGCCAACATGGGGAAACCCCATCTCTACTAAAATACAAAAATTAGCCAGGTATGGTGGCACATGCCTATAATCCCAGCTACTTGGGAGGCTGAGGCAGGAGAATCACTTGAACCCAGGAGGCTAAGGTTGCAGTGAGCCGAGATTGTGCCACTGTACTCCAGCCTGGGTGACAGACTGAAACTCTGTGTCCAAAAAACAAAACAAAACAAAAAA"
"GL873594","5528090","5528162","chr2","69013639","69013718","24","63485549","GGTACAGTGGCTCACGCTTGTGATCCCAGGTTGAGGTGGGTGGATCGCCTGAGCTCAGGAGTTGGATGCCAGC","GGTGTGGTGCCTCACGCCTATAATCCCAGCACTTTGGGAGGCAGGTGGATCACTTGAGGTCAGGAGTTTGAGAACAGCCT"
"GL873594","5834047","5834168","chr2","82491537","82491662","28","76657490","GGCTGGGCCCAGTAGCTCACGACTGTAATCCCAGCACTCTGGGAAGCTGAGGTGGGCGGATCACCTGAGCTCATAGGTTCGAGACCAGCTCCAGTTAGAGTGAGAGCCTGTCTCTAAAAATA","GGCTGGGCACAGTGGCTCATGCCTGCAATCCCAGCACTTTGGGAGGCTGAGGTGGGCAGATCACCTGAAGTCAGGAGTTCAAGACCAGCCTGGCCAACACAGTGAAACCCCATCTCTACTAAAAAT"
"GL873594","5834396","5834461","chr13","14688151","14688212","20","8853755","TATATAATAATAATAACCAGGTATTGTGGCAGGTGCCTCTAGTCCCAGCTACTCGGGAGGCAAAGG","ATAAAAAAATTAGCTGGCCATGGTGGCACATACCAATAATCCCAGCTACTCAGGAGGCTGAG"
"GL873594","7786130","7786294","chr14","12217087","12217250","37","4430957","GGGTGTGCTGGCTCATACCTATAATCCTAGCACTCTGGGAGGCTGAGGTAGGTGTATTGCTTGAACCCAGGAGTCTGAGGTTGCTGTGCGCTAAGCTGATACCATAGCACTCTAGCCTGGGCAACAGAGTGAGACTCTGTCTCAAAACAAATAAATAGTAAAAAA","GCTGGGCGTGGTGGCTCACACCTGTAATCCCAGCACTTTGGGAGGCCAAGGCATGAGAATTGCTTGAAAACAGGAGGCGGAGGTTGCAGTAAGCTGAGACTGTGCCATTGCACTCCAGCCTGGGCAACAAGAGTGAAACTCTGTCTCAGAAAAAAAGAAAAAAA"
"GL873595","723579","723774","chr19","6045933","6046125","65","5322354","GCCTGAGCAGGAGAGAGACCCCATCTCTGCTGAAAGTGGAAAAGTTGGCTGAGTGTAGTGGCGGGCTGCTGCCCCAGTCACTCAGGAGGCTTAGGAAGGAGTATCGCTTGGGCCCAAGATTTGAGGTTGCTGTGAGCGCTACAAAGACATTAGGGTACTCTACACAGGGGAATAGAGTGAGACTGTCTCAAAAAAA","CAACATGGAGAAACCCCGTCTCTACTAAAAATACAAAATTAGGCAGCGTGGTGGTGGGTGCCTATAATCCCAGCTACTCAGGAGGCTGAGGCAGGAGAATCGCTTGACCGGGAGTGGAGGTTGCGGTGAGCTGAGATTGCACCATTGCACTCCAGCCTGGGCAACAAGAGTGAAACTCCGTCTCAAAAAGAAA"
"GL873595","724114","724204","chr20","18199749","18199840","22","17475635","GGCCATGCTTGGTGGTTCTCATCTGTAATCCTAGCACTCTGGAAGGTCTACAGGGGTGGATGGCTGGAGGTCAGGAGTTCAAGACTGGCCT","GGCCGGGCATGGTGGCTCACACCTGTAATCCCAGCACTTTGGGAGGCTGAGGCAGGCGGATCACCTGAGGTCAGGAGTTCGAGACCGGCCTG"
"GL873595","1065346","1065667","chr18","10529729","10530057","74","9464383","GGCCAGGTGCAGCAGCTCATGCCTGGAATCTTCCTGCTCTGTATGGCCAAGGCAGGTGGATCGCCTGACCTCAGGAGTTCCAGACCAGCCTGAACAAGAGCAAGACTCTGTCTCTACTAAAAGTAGAAAAAAAACTAGCCAGTCATAGTGGCAGGTGCCTGTAGTCCCAGCTGCTTGGGAGGCTGAGGCAAGAGGATCACTTGAACCTAAGAGTTTGAGGTTGCTGTGAGCTAAGATGCCACATCACTCTATCAAGGGTGACCAAGTGAGACTCTGTCTCAAAAATAAATAAATAAATAAATAAAAAGAAAGGCAAAAAGAA","GGCCCGGCGTGGTGGCTCATGCCTATAATCCCAGCCCTTTGGGAGGCCAAGGCAGGTGGATCACCTGAGGTCAGGCGTTCGAGACCAGCCTGACCAACGTGGTGAAACCTCATCTCTACTAAATACAAAAAAAATTTAGCCAGGCATGGAGGCACATGCCTGTAATCCCAGCTACTTGGGAGGCTGTGGCAGGAGAATCACTTGAACCTGGGAGGTGGAAGTTGCAGTGAGCTGAGATTGTACCACTGCACTCCAACCTGGGTGACAAAGCAAGACTCGGTCTCAATAAATAAATAAATAAATAAATAAATAAATAAAGTGAAAAAAAA"
"GL873595","1254878","1255146","chr4","42822326","42822607","67","41567448","GGCTGGGCATGGTGGCTCATGCCTGTAATCCTACCGCTCTGGGAGGCTGAGGCAGAGGATCACTTGAGCTCAGGAGTTTCAGACCAGCCTGCAAGAAGGACCCAGTCTCTGCCGAAAATAGAAAAGTTAGCAAGGCGTTGTCGTGAGCACATGTATCCCAGCTACCTAGAACTCTGAGGCAGGAGGATCCCTTGAACCCACAGAAGTTGCTGTTATCTAAACTGATGCCACTGGACTCTAGCCTGGGCAACAGAGTGAGACTGGTCTCA","GGCCGGGCACGGTGGCTCATGCCTGTAATCCTAGCATTTTGGGAGGCTGAGACAGGCAGATTGCCTGAGCTCAGGAGTTCAAGACCAGCCTGGGCTAGATTGTGAAACCCCATCTCTACTAAAATATAAAAATTAGCTGGGTGTGGTGGCACACGCCTGTAATCCCAGCTACCTGGGAGGCTGAGGCAGGAGAATCGCTTGAACCAGGAGACAGAGGTTGCAGTGAGCTGAGATCACGCCACTGCACTTTAGCCTGGGCAACAGAGTGATACTCTGTCTCAA"
"GL873595","3417105","3417297","chr12","115674238","115674427","44","112257133","GGCCGGGCGCTGTGCCTCACGCCTGTAATCCTAATACTCTGAGAGGCCGAGGCAGGTGGATTGCCTGAGCTCAGGTGCTCAAGACAGCCTGACTGAGCAAGCCCTGAGATCCCATCTCCACTAACAATAGTAAAACTAGCCGGGCATTGTGGTGGTGCTTGTAATCCCAGCTACTGGGAGGCTAAGACAGGAG","CCAGGCCTGGTGGCTCACGCCTGTAATCCCAGCACTTTGGGAGGCCGAGGTGGGTAGATCACCTGAGGTCAGGAGTTCAAGACCAGCCTGGCCAACATGGCGAAACCCCATCTCTACTAAAAATACAAAAATTAGCTGGGCATGGTGGTGTATGCCTGTAATCCCAGCTACTCGGGAGGCTGAGGCAGGA"
"GL873595","6098380","6098457","chr3","87492619","87492702","21","81394239","GCTGTGGCTCATGCTGATAATACCAGCACTCTGGGAGAACAAGGTAGGCAGATCACAAGAGGTCACCTGTGCAAGACC","GGGCTGGTGGTGGCTCATGCCTGTAATACCAGCACTTTGGGAGGCCAAGACAGGTGGATCACCAAAGGTCAAGAGTTCAAGACC"
"GL873596","134190","134307","chr1","203207333","203207443","31","203073143","GGCTGGGCGAGGTGGCTCACACCTGTAATCCTAGCACTCTGGAAGGCCCTAGCACTCAGGCAGTTGGATTGCCTGAGCTCACAAGTTCAAGACCAGCCTGAAAAAGAGCAAGACCTCA","GGCTGGGTGCAGTGGCTCACACCTGTAATCCCAGCACTTTGGGAGGCCGAGATGGGTGGATCACTTGAGGTCAAGAGTTGAAGACCAGCCTGGACAACATGATGAGACCCC"
"GL873596","134578","134681","chr11","50235285","50235387","37","50100707","CAAACAAAAGAGGAAGACCTCGTCTCTAAAAAAATAGCTGGGCATTGTGAGGAGTACCTGTAGTCCTAGCTACTCAGAAGGCTGAGACAAGAGAATCACTTAAA","CAACATTGTGAAACCCTGTCTCTACTAAAATAGAAAATTAGCCAGGTGTGTGGGCGTGCCTATAATCCTAGCTACTGGGGAGGGTGAGGCATGAGAATCGCCT"
"GL873596","8160215","8160350","chr1","29437872","29437991","30","21277657","GGCCGGGCGTGGTGGCGCACACCTGTAGTCCCAGCGCTATGGGAGGCCGAGGCGGGTGGATCACCTGAGCTCAGAGGTTCGAGACCAGCCAAGACCCCCCTGAGCCAAACGAGCCAGAGTGAGACCCCGTCTCTAC","GGCCGGGCGTGGTGGCTCACGCCTGTAATCCCAACATTTTGGGAGGCCAAGGCGGGTGGATCACCTGAGGTCAGAAGTTCGAGACCAACCTGGCCAACATGGTGAAACCCCTGTCTCTAC"
"GL873596","8421071","8421132","chr20","1874027","1874093","12","6547044","GTCAGGCGCAGTGGCTCACGCCTGTAATCTCAGCACTCTGAGAAGCCAAGGCAGGATCATCT","GGCCAGGCGCAGTGGCTCAGGCCTGTAATCCCAGCACTTTGGGAAGCCAAGGTGAGCAGATCACCTG"
"GL873598","4416400","4416489","chr5","39418145","39418231","15","35001745","GGCCAAGTGTGGTGGCTCATGCCTGTTGTCCCAGCACCGTGGGAGGCCGAGGCTGGTGGAACACCTGAGCTCAGCTGAGTTTGAGACCAG","GGCCAGTTGCGGTGGCTCATGCCTGTAATCCCAGCACTTTGGCAGGCTGAGGCAGGTGGATCACCTGAGGTCAGGAGTTTGAGACCA"
"GL873598","4416855","4416947","chr3","94091253","94091337","31","89674398","GTGAGACCCTGTCTCTACAAAAAAAAAAGCTGGGCACTGTGGCATGTGCCTGTAATCCCAGCTACTTGGGAGGCAAAGGGAAAGAGAATCACT","AAACCTTGCCTTTACTAGAAATACAAAAATTAGCTGGGCATGGTGGCAGGTACCTGTAATCCCAGCTACTTGGGAGGCTGAGGCA"
"GL873598","5126074","5126161","chr1","12339306","12339394","19","7213232","GCCTGGTGCACTGGTTCACACCTGGAATCCTTGCATTCTGAGAGGCCCAGGTAGGCAGATCACCTCAGCTCAGAAGTTCGAGACCAGC","GCTGGGTGCGGTGGTTCACGTCTGTAATCCCAGCACTTTGGGAGGCCGAGGCGGGCAGATCACCTGAGGTCAGGAGTTCGAGACCAGCC"
"GL873598","5467584","5467662","chr1","9313328","9313403","17","3845744","GCGAGGTGGCTCACGCCTGTAATCCCAGCACATTTGGAAGGCCAAGGAGGGTGGATCACCCGAGCTCACCAGTTGGAGA","CGCAGTGGCTCACGCCTGTAATCCCAGCACTTTGGGAGGCCGAGGCAGGCAGATCACCTGAAGTCAGGAGTTTGAG"
"GL873598","6917752","6917856","chr14","9558287","9558382","22","2640535","GGCCAGGCATGGTGGCTTGTGCCTGTTGTCCCAGCACTGTGGAAGGCCGAGGCGGGTGGATCGCCTGAGCTCAGCTGAATTCGAGACCAGCATAAGACCAGTATG","GGCCAGGCATGGTGGCTTATGCCTGTAATCCCAGCACCTTGGAAGGCCGAAGCGGGCAGATCACCTGAGCTCAGGAGTTTGAGACCAGCCTGTCCA"
"GL873598","8078910","8079062","chr7","164825511","164825660","43","156746601","AACAGCCAGGCATTGTGGTGGGCACCTGTAATCCCAGCTACTTGGGAGGCTGAGGCAAGAGAATTGCTTGAGCCCAACAGTCTCAGGTTACTGTGAGTTATGACACCATGGCACTCTATTGAGGGCAAGAAAGTGAGACTGTCTTGGAAAAAA","CTAGCCAGGCATGGTGGTGCGCACCTGTAGTCCCAGTTACTTGGGAGGTTGAGGCAAGAGAATTGCTTGAGCCTGGAAGGCAGAAGTTGCAGTGAGCTGAGATCACACCACTGCATTCCAGCCTGGGCGAAAGAGCAAGACTCTGTTGAA"
"GL873598","8079328","8079454","chr6","10381248","10381379","32","2301920","GCCCGGCGTGGTGGCTCACGCCTGTAATTCCAGCACTCTGGGGAGGCCGAGGAGGGCAGATTGCCTGAGCTCACAGGTTTGAGCTAGAGCGAGACCCTGTCTCTTAAAAAGAAAAAAAAGGAAAGAA","GCTGGGCGCGGTGGCTCACGCCTGTAATCCCAACACTTTGGGAGGCCGAGGCGGGCAGATCACCAGAGGTGATCTCCAGCCTGGGCAGGAGAGCAAGACCCTGTCTCAAAAAATTTAGAAAAAGGAAAGAAA"
"GL873599","3943256","3943456","chr9","35892110","35892312","79","31948854","GGCAGGCTGCTTTGACCCATATCTACAACTCCAGAACTTTAGAGGCTGAGCTGGGTGGGTCCCTTGAGATTAGAAACTGCTTAGTAGCCTGGCAAAAACCAGACCCCACCTCCACCATGTAGAAAAATTAGCAGTATGCCATAGTGGGAACCTACCAATACAGTCTTTCCAAAGGCCAAAGCTAGAAGGACCGTGAGCTTG","GGCTGGGTGTGGTGGCTCATGCCTATAATTCCAGCACTTTGGGAGGCCGAGGCAGGTGGATCACCTGAGGCCAGGAGTTTGAGACCAGCCTGGCCAATATGGTGAAACCCCATCTCTACTAAAAGTACAGAAAATTAGTCAGTCATGATGGCGCATGCCTATAATCCCAGTTACTCGGGAGGCTAAGGTAGGAGAATTGCTTG"
"GL873599","6693284","6693349","chr1","100916857","100916922","15","94223573","TCACGTCTATAATCCTAGCACTCTGGGAGTCCTTGGCAGGTGGATCACCTGAGCTCAGGAGTTTGA","CATGCCTGTAATCCCAGCACCTTGGGAGGCCAAGGTGGGTGGATCACCTGAGGTCAGTAGTTTGAG"
"GL873600","991618","991705","chr15","13850109","13850195","15","12858491","GGCTGGGCGTGGTGGCTCACACCTGTTGTCCCAGCGCTGTGGGAGGCTGAGGCAGGTGGATCACCTGTGCTCAGAGGTTGAGACCAGC","GCCGGGCGCTGTGGCTCACACTTGTAATCCCAGCACTTTGGGAGGCTGAGGCAGGTGGATCACCTGAGGTCAGGAGTTAGAGACCAG"
"GL873600","8825981","8826014","chr16","43605817","43605844","11","34779836","AGTCTGGGGCAACAGAGCAAGACTCTGTCTCAAA","CAGTCTGGGTGACAGAGCAAGATTCCAT"
"GL873600","8826039","8826157","chr13","87428402","87428520","35","78602363","ATTAGCCTGGTGTGGTGGTATATGCCTTCCTGCCTGCTTGGGAGGCTGAGGCAGGAAGTATGCTTTAACTGTGGAGTCTGAGGTTGCTATGAGCTAGGTTGAGGCCATGGCACTCTAAA","TTAGCCGGGTGTGGTGGTGCACGCCTGTAATCCCAGCTACTCAGGAGGCTGAAGCAGGAGAGTTGCTTGAACCCAGGAGTTGGAGGTTGCAGTGAGCTGAGATCACGCCATTGCACTCC"
"GL873601","269289","269338","chr14","49279240","49279285","14","49009951","GACTGGGTGTGGTGGCTCACACCTTTAATCCTAACACCCTGGGAGGCTTA","GGCTGAGATGGTGGCACACACCTGTAATCCCAGCTACTTGGGAGGC"
"GL873601","269431","269678","chr1","184453273","184453521","76","184183842","AGAAGATCACTCAAGATCAGGAGTTTGAGAACAGCCTGAGCAAGACCCCCATCTTTACTAAAAATGGAAAAGTTTTTACCCAGGCATGGTAGTGCGTGCCTGTATCCCATCTACTCCGGAGGCTGATAGGAGGATTGCTTCAACCAAGGAGTTTGAGGTTCCAGAGACTTAAGATGACACAACTGCATTTTACCCAGTGTGACACAGCGAGACTCTTTCAGAAGAATTTTTAAAAGGAAAAAAAAGAA","GGTCAGATCACCTGAGGTCAGGAGTTTGAGACCAGCCTGACCAACATGGTAAAACCCCATCTCTGCTAAAAATACAAAAAATTAGCCAGGCATGGTGGTGAACGCCTGTAATCCTAGCTACTCAGGAGGCAAAGACAGGAGAATCGCTTGAATCTGGAAGGTGGAGGTTGCAATGAGCCAAGATGACGCCACTGCACTCCAACCTGGGTGACAGAGGAAGACTCCATCAAAAAAAAAAAAAAAAAAAAA"
"GL873601","1397978","1398117","chr16","24839455","24839591","34","23441477","GCCTATAATCCTAGCACTCTGGAAGGCTGAGGCAGGAAGATCACTAGAGCTTGGGAGTTTGAGATTGCTGTGAGGGAGACTGACTCCATGGCACTCTAGCCTGAGGCAACAGAGTAAGACTCCATCTCAAAAAAAAAAAA","CTCTAACTCCAGCTACTCAGGAGGCTGAAGCAGGAAAATCACTTGAACCTGGGAGGTGGAGGTTACAGTGAGCCAAGATCACACCATTGCACTCCAGCCTGAGCGACAGAGCGAGACTCTGTCTCAAAATAAATAAA"
"GL873601","4065502","4065590","chr11","108711352","108711444","19","104645850","GCTGGATGTGGTGGCTCTCACCTATAATCCTAGCACTCTGGGAGGTCAAAACAGGTGGATCACCTGAGCTCAGGAGCAAGAACACCAGC","GTCAGGGGTGGTGGCTCACGCCTGTAATCCCAGCACTTTGGGAGGCCAAGGCAGGTGGATCGCCTGAGCTCAGGAGTTCAAGACCAGCCTTGC"
"GL873601","8241370","8241465","chrY","9469734","9469829","34","1228364","AAAAAAGGTGGAGATGAGCCATGCGCAGTGGTGTAGGCCTGTAATCCCAGCCCTTGGGAGGCCAAAATGGTGGATTGCCTGAAGCAGAGCAAGACC","AAAGTACAAAGAGTCTGGGTACAGTGGCCCAAGCCTGTAATCCCAGCAGTTTGGGAGGACAAGATGGGTAGATCACCTGACATCATGAATTAGAGA"
