"chr1","2046048","2046357","JH378107","31269840","31270139","53","29223792","GGCGGGTCGCGGTGGCTTACGCCTGTGATCCCAGCACTTGGGGAGGCTGAGGAGGGAGGATCACATGAGGCCAAGAGTTTGAGACCAGCCTGGCCAACATGGCGAAACCCCGTCTCTGCTAAAAAAAAAAAAAAAAAAAAAAAAAAAAATTTGCCCGGAGTGGTGGCGATCGCCTGTAATCCCAGCTACTCGGGAGGCTGAGGCAGGAGAATCGCGCGAGCCGGGAAGCGGAGGTTACAGTGAGCCGAGATCGTGCCATTGCACTCCAGCTTGGATAATAAAAGCAAAATTCCGTCTCAAAAGAAAAAAA","GGCCGGGCGCGGTGGCTCAAGCCTGTAATCCCAGCACTTTGGGAGGCCGAGGCGGGTGGATGACGAGGTCAAGAGATCGAGACCATCCTGGTCAACATGGTGAAACCCCGTCTCTACTAAAAAAAAAAAAAAAAAAAAAATTAGCCGGACATGGTGGCGTGTGCCTGTAATCCCAGCTACTCAGGAGGCTGAGGCAGGAGAATTGCCTGAACCCAGGAGGCGGAGGTTGCGGTGAGCCGAGATCACGCCATTGCACTCCAGCCTGGGTAACAAGAGCAAAACTCCGTCTCAAAAATAAAA"
"chr1","6235007","6235334","JH378105","46221579","46221896","53","39986572","GGCCAGGTATGGTGGCTCACGCCTGTAATCCCAGCACTTTGGGAGGCCGAGGCGGTTGGATCACGAGGTCAGGAGTTCAAGACCAGCCTGGCCAACATGGCAAAAACCCATCTCTACTAAAAAAAAAAAAAAAAAAAAAAAAAAAAAAAACACACAAAAATTAGCTGGGCATTGTGGCAGGCACCTGTAATCCCACCTACTTGGGAGGCTAAGGCAGGAGAATCGCTTAAACCTGGCAGGCAGAGGTTGCAGTGAGCCGAGATCGTGCCATTGCACTCCAATCTGGGCAACAAGAGCATGACTCGGTCCCAAAAAATAAAAATAAAAA","GACTGGGTGTGATGGCTCATGCCTGTAATCCCAGCACTTTGGGAGGCCAAGGCGGGTGGATCACCTGAGGTCAGGAGTTCAAGACCAGCCTGACCAACATGGTGAAACCCCGTCTCTACTAAAAAAAAAAAAAAAAAAAAAAAACTACAAAATTAGCTGGGCCTGGTGGTACACACCTATAATCCCAGCTACTTGGGAGGCTGAGGCAGGAGAGTTACTTGAACCCAGGAGGCAGAGGTTGCAGTGAGCTGAGATCATGCCATTGCACTCCATCCTGGGCAACAAGAGCGAAACTCTGTCTTAAAAAAAAAAAAAAAA"
"chr1","7152768","7153380","JH378118","18053084","18053501","255","10900316","GGCCGGGCGCGGTGGCTCACGCCTGTAAACTCAGCACTTTGGGAGGCTGAGGCAGGTGGATAACCTGAGGTCAGGAGTTCAAGACCAGCCTGGCCAACATGGTGAAACCCCATCTCTACTAAAAATTTAAAAATCAGGGCTCATGCCTCTAATCCCAGCACTTCGGGAGGCCGAGGTGGGTGGATCACAAGGTCAGAAGTTTGAGACCAGCCTGGCCAAGATGGTGAAACCCCGTCTCTACTAAAAATACAAAAATTAGCCAGGTGCAGTGGTGTGCACCTGTAATCTCAGCTACTCAGGAGGCTGAGGCAGGAGAATCGCTTGAACCCAGGAGGCAGAGATTGCAGTGAGCTGAGATCACACCACTGCACTCTAGCCTGGGTGACAGAGCAAGACTCCATCTCAAAAAATAATAATAATAATAATAATAAAATTAACTGGGCGTGGTGGCAGGCACCTGTAATCCCAGCTACTCGGGAGACTGAGGCAGAAGACTCGCTTGAACCGAGGAGGCAGAGGTTTCAGTGAGCCGAGATCATGCCATTGCATAGCAGCCTGGGCAACAAGAGCAAAAATCTGTCTCAAAAATAAATAAATAAAAATAAAAATAAAA","GGCTGGGCGCAGTGGCTCACACCTGTAATCCCAGCACTTAGGGAAGCTGAGGCGAGTAGATCACCTGAGGTCAGGAGTTAGAGACCAGCCTGGCCATCATGGTGAAACCCCGTCTCTACTAAAGATACCAAAAATTAGCTGAGTGTGGTGCTGGGTGCCTGTAATCCCAGAAACTCAGGGTGCCTGTAATCCCAGCAACTCAGGGTGCCTTTAATCCCAGCAACTGAGGGTACCAGTAATCCCAGCAACTCAGGGTGTCTTTAATCCTAGCAACTGAGGGCACCTGTAATCCCAGCAACTCAGGAAGCTGAGACAGGAGAAGTACTTGAACCCAGAAGGCAGAGGTTGCAGTGAGCCGATATTGCACCATTGCACTCCAGTCTGGGCAACAAGAGTGAAACTCTGTCTCAAAAAAAAA"
"chr1","12681568","12682169","JH378118","18053084","18053501","244","5371516","GCTGGGCGTGGTGGCTCACGCCTGTAATTCCAGCACTTTGGGAGGCTGAGGCAGGCGGAAAACCTGAGGTTAGGAGTTCAAGACCAGCCTGGCCAACATGGTGAGACCCCATCTCTGCTAAAAATACAAAAATCAGGCCAAGTGTGGTGGCTCACGCCTGTAATCCCAGCACTTTGGGAGGCCAAGGCGGGTGGATCACCTGAGGTCAGGGGTTCAAGACCAGCCTGGCCAACATGGTGAAACCCCATCTCTACTAAAAACACAAAAATTAACTGGGCATGGTGGTGGGCGCCTGTAGTCCCAGCTACTTGGGAGGCTGAGGCAGGAGAATCGCTTGAACCCGTGAGATGGAGGTTGCAGTGAGCTGAGATCGTGCCACTGCATTCCAGACAGAGTGGGACTCCGTCTCAAAAAAAAAAAAAAATAGCCGGGCATGGTGGTGGATGCCTGTAATCCCAGCTACTCAGGAGGTTGAGGCACGAGAACCACTTGAACCCAGGAGGCAGAGGTTGCATTGAGCTGAGATCACACCATTGCACTCCAGCCTGGGCAACAAGAGTGAAACTCTGTCTCAAAAAAAAAAAAAAAAAAATTAAGAAAAA","GGCTGGGCGCAGTGGCTCACACCTGTAATCCCAGCACTTAGGGAAGCTGAGGCGAGTAGATCACCTGAGGTCAGGAGTTAGAGACCAGCCTGGCCATCATGGTGAAACCCCGTCTCTACTAAAGATACCAAAAATTAGCTGAGTGTGGTGCTGGGTGCCTGTAATCCCAGAAACTCAGGGTGCCTGTAATCCCAGCAACTCAGGGTGCCTTTAATCCCAGCAACTGAGGGTACCAGTAATCCCAGCAACTCAGGGTGTCTTTAATCCTAGCAACTGAGGGCACCTGTAATCCCAGCAACTCAGGAAGCTGAGACAGGAGAAGTACTTGAACCCAGAAGGCAGAGGTTGCAGTGAGCCGATATTGCACCATTGCACTCCAGTCTGGGCAACAAGAGTGAAACTCTGTCTCAAAAAAAAA"
"chr1","13954697","13955026","JH378115","36823669","36823983","50","22868972","GCTGGGCGCAGTGGCTCACACCTGTAATCCCAGCACTTTGGGAGGCCAAGGCAGGCGGATCACATGGGGTCAGGAGTTCGAGACCAGCCTGGCCAACATGGTGAAACCCCGTCTCTACTAAAAAAAACTACCAAAAATTAGCCTGGCATAGTGGGGGGCACCTGTAATCCCAGCTACTCAGGAGGCTGAGACAGGATAATCACTTAAACCCGGGAGGGTGGAGGTTGCAGTGAGCCGAGATCACACCATTGCGCTCCAGCCTGGGCAACAAGAGCGAAACTCTGTCTCAAAACAAAAAACAAAAAACAAAAAAAAAACAAGAAAGAAAAA","GGCCGGGCGCGGTGGCTCAAGCCTGTAATGCCAGCACTTTGGAGGCCAAGGCAGGTGGATCACGAGGTCAAGAGATCGAGACCATCCTGGTCAACATGGTGAAACCCTGTCTCTACTAAAAATACAAAACATTAGCTGGGCATGGTGGCGTGTACCTGTAATCCCAGCTACTCAGGAGGCTGAGGCAGGAGAATTGCTTGAACCCAGGAGGTGGAGGTTGCAGTGAGCCGAGATCATGCCATTGCACTCCAGCCTGGGTAACAAGAGCGAAACTCCGTCTCAAAAAAAAACAAAAAACAAACAAACAAAAAAACA"
"chr1","14320621","14321251","JH378118","18053084","18053501","274","3732463","GGCCAGGTGCGGTGGCTCACACCTGCAGTCCCAGCATTTTGGGAGGCCAAGGCGGGTGGATCACCTGGGGTCAGGAGTTTGAGACCAGCCTGGCCAACGTGGTGAAACCCCCTCTCTATTAAAAACACAAAAAATTGGCTGGGCACAGTGGCTTATGCCTGTAATCCCAGCACTTTCAGAGGCCAAGGCGGGAGGACCACCTGAGACTGGGAGTTCGAGACCAGCCTGACCAACATGGAGAAATCCCATCTTTACTAAAAATACAAAATTAGCCAGGCATGGTGGCGCATGCCTGCAACCCCAGCTACTCAGGAGGCTGAGGCAGGAGAATCGCTTGAGCCCAGGAGGCAGAGGTTGTGGTGAGCCGAGATCGTGCCATTGCACTCCAGCCTGGGCAACAAAAGCAAAACTCTGTCTCGAAAACAAAAACAAACAAACAAAAAAACAAAAAATTAGCCAGGCATTGTGGTGGGTGCCTGTAATCCCAGCTACTCAGGAGGCTGAGGCAGGAGAATCGCTTGAACCAGGGAGGCACAGGTTGCGGTGAGCTGAGATCGCACTATTGTACTCCAGCCTGGGTGACAAGAGCGAAACTCTGTCTCAAAAAAAAATTAAAAATTTAAAAAAAGAA","GGCTGGGCGCAGTGGCTCACACCTGTAATCCCAGCACTTAGGGAAGCTGAGGCGAGTAGATCACCTGAGGTCAGGAGTTAGAGACCAGCCTGGCCATCATGGTGAAACCCCGTCTCTACTAAAGATACCAAAAATTAGCTGAGTGTGGTGCTGGGTGCCTGTAATCCCAGAAACTCAGGGTGCCTGTAATCCCAGCAACTCAGGGTGCCTTTAATCCCAGCAACTGAGGGTACCAGTAATCCCAGCAACTCAGGGTGTCTTTAATCCTAGCAACTGAGGGCACCTGTAATCCCAGCAACTCAGGAAGCTGAGACAGGAGAAGTACTTGAACCCAGAAGGCAGAGGTTGCAGTGAGCCGATATTGCACCATTGCACTCCAGTCTGGGCAACAAGAGTGAAACTCTGTCTCAAAAAAAAA"
"chr1","14334778","14335400","JH378118","18053084","18053501","267","3718306","GCCAGGCACAATAGCTCACGCCTGCAGTCCTAGCACTTTAGGAGGCCAAGGCAAGTGGATCACCTGAGGTCAGGAATTTGAGACCAGCCTGGCCAGTGTGGCGAAATCCCGTCTCTAGTAAAAATACAAAAATTAGGCTGGGCGCGGTGGCTCATGCCTGTAATCCCAGCATTTTGGGAGTCTGAGGCAGGCGGATCACGAGGTCAGGAGATCGAGACCATCCTGGCTAACATGGTGAAACCCCGTCTCTACTAAAAATACAAAAAAAAAAAAAATTAGCCAGGCATGGTGGCGAGCGCCTATAGTCCCAGCTACTCCGGAGGCTGAGGCAGGAGAATGGCACGAACCTGGGAGGCAGAGCTTGCAGTGAGCTGAGGTTGCACCACTGCACTCCAGCCTGGGTGACAGAGTAAGACTCCGTCTTAAAAAAAATAATAAATAAAAATAAAAAAAAAATTAGCTGGACGTGTTGGCATGCACCTGTAATCCCAGCTACTCAGGAGGCTGAGGCAGGAGAATGGCTTGAACCCAGGGGGGCGGAGGCTGCAGTGAGCCTAGATCGTGCCATTGCACTCCAGTTTGGGCGACAAGAGTGAAACTCCGTCTTAAAAACAATACAAAAA","GGCTGGGCGCAGTGGCTCACACCTGTAATCCCAGCACTTAGGGAAGCTGAGGCGAGTAGATCACCTGAGGTCAGGAGTTAGAGACCAGCCTGGCCATCATGGTGAAACCCCGTCTCTACTAAAGATACCAAAAATTAGCTGAGTGTGGTGCTGGGTGCCTGTAATCCCAGAAACTCAGGGTGCCTGTAATCCCAGCAACTCAGGGTGCCTTTAATCCCAGCAACTGAGGGTACCAGTAATCCCAGCAACTCAGGGTGTCTTTAATCCTAGCAACTGAGGGCACCTGTAATCCCAGCAACTCAGGAAGCTGAGACAGGAGAAGTACTTGAACCCAGAAGGCAGAGGTTGCAGTGAGCCGATATTGCACCATTGCACTCCAGTCTGGGCAACAAGAGTGAAACTCTGTCTCAAAAAAAAA"
"chr1","16571761","16572549","JH378118","18053084","18053501","427","1481323","GGCCGGGTGCAGTGGCTCATGCCTGTAATCCCAGCACTTTGGAGACCAAGGCAAGCAGATCACCAGAGATCAGGTGCTGGGAACAGGCCCACCAAATTGGCCATAAACAGGCCCCAAAACTGGCCATAAACAAAATCTCTGCAGCACTGTGACATGCTCATGATGGCTGTGATGCCCACGCTGAAGGTTGTTGTTGGTTTGCGAGAATGAGATCAAGGAAAACCTGGCCCACCCTGGGTGGAAAACTGCTTAAGGCGTTCCTGAACCACAAACAATAGCATGAGCGATCTGTGCCTTAAGGACATGCTCCTGCTGCAGATAACTAGCCAGGGCCCATCCCTTTGTTTCCCATTTTAGTTAATCTGTAATCTATAGAAACAATGCTTATCACTGGTTTGCTGTCAATATATATGTGGGTAAAACTCTGCTCATGGCTCTCAGCTCTGAAGGCTGTCAGCCCCCTGAATCCCACTCTGCACTCTATATTTCTGTGTGTGTGTGTTTAATTCCTCTAGCGCTGCTGGGTTAGGGTCTCCGTGACCAAGCTGGTCTCGGCAATCAGGAGTTCCAGGACAGCCTGTCCAACATGGTGAAACCCCATATCTACTAAAAATACAAAAAAAAAAAAAAATTAGCTGGACATGGTGGTGTGTGCCTGTAATCCCAGCTACCTGGGAGGCTGAGGCAAGAGAATCGCTTGAACCCAGGAGGTGGAGGTTGCAGTGAGCCAGGATCCTGCCATTGCACTCCATCCTGGGTGACAAGAGTAAGACTCCATCTCAAAAAAAA","GGCTGGGCGCAGTGGCTCACACCTGTAATCCCAGCACTTAGGGAAGCTGAGGCGAGTAGATCACCTGAGGTCAGGAGTTAGAGACCAGCCTGGCCATCATGGTGAAACCCCGTCTCTACTAAAGATACCAAAAATTAGCTGAGTGTGGTGCTGGGTGCCTGTAATCCCAGAAACTCAGGGTGCCTGTAATCCCAGCAACTCAGGGTGCCTTTAATCCCAGCAACTGAGGGTACCAGTAATCCCAGCAACTCAGGGTGTCTTTAATCCTAGCAACTGAGGGCACCTGTAATCCCAGCAACTCAGGAAGCTGAGACAGGAGAAGTACTTGAACCCAGAAGGCAGAGGTTGCAGTGAGCCGATATTGCACCATTGCACTCCAGTCTGGGCAACAAGAGTGAAACTCTGTCTCAAAAAAAAA"
"chr1","16846656","16846775","JH378155","6169149","6169252","29","10677507","GAAGTTGCAGCGAGCCAAGATCGCACCATTGCATTCCAGCCTGGGCAACGAGAGCGAAACTCCATCACACACACACACACACACACACACAAAACAAACAAACAACAACAAAAAAAACAA","TGCAGTGAGCCGAGATCGTGCCATTGCACTCCAGCCTGGGTAACAAGAGCAAAACTCCGTCTCAAAAAACAAACAAACAAACAAACAAAAAAAAAACAAAAAAA"
"chr1","23679158","23679532","JH378109","21565230","21565567","76","2113928","GACCGGGTGCGGTGGCTCATGCTTGCAATCCCAGAAGTTTGGGAGGCCGAGGTGAGCAGATCACTTGAGGTCAGGAGTTTGGGACCAGACTGGCCAACGTGGTGAAACCCCCATCTCTACTAAAAATACAAAAAAAATTAGCCAGGCATGGTGGCGGGCGCCTGTAATCCCAGCTACTCGGGAGGCTGAGAGAGGAGAATTGCTTGAACCCAGGAGGCAGAGGTTGCAGTAAGCCAAGATCACACCATTGCACTCCAGGCTGGGCAACAAGAGCGAAACTCCGTCTCAAAAAATAAATAAATAAATAAATAAATAAATAAATAAATAAATAAATAAGAATAATATTAAAAAAATAATTTGAAAAAGTAAAAAAAA","GGCCGGGCGCGGTGGCTCAAGCCTGTAATACCAGCACTTTGGGAGGCCGAGGCGGGTGGATCACGAGGTCAAGAGATCGAGACCATCCTGGTCAACATGGTGAAACCCCGTCTCTACTAAAAATACAAACAATTAGCTGGGCATGGTGGCGGGTGCCTGTAATCCCAGCTACTCCAGAGGCTGAGGCAGGAGAATTGCCTGAACCCAGGAGACGGAGGTTGCGGTGAGCCAAGATCGCGCCATTGCACTCCAGCCTGGGTGACAAGAGCGAAACTCCGTCTCAATAAATAAATAAATAAATAAATAAATAAAAATAAAATAAATAAATAAATAAATAA"
"chr1","26650861","26651510","JH378118","18053084","18053501","297","8597777","GGCCGGGCACGGTGGCTCACGCCTGTAATCCCAGCACTTTGAGAGGCCAAGGTGGACAGATGGCTTGAGGTCCAGAGTTCACAACCAGCCTGGCCAACATGGCAAAACCCTGTCTCTACTAAAAACACAAGAAAATGGGCCAGGCGCAGTGGCTCACGCCGGTAATCCCAGCATTTTGGAAGGCCGAGGTGGGCGGATCTCCTGAGGTCAGGAGTTTGAGACCAGCCTGACCAACATGGTGAAACCCTGTCTCCAGTAAAAATACAAAAATTAGCCTGGCTTGGTGGCGGGCACCTGTAATCCCAGCTACTCAGGAGGCTGGGGCAGGAGAATCGCTTCAACCTGGAAGGCAGAGATTGCAGTGAGCCGAGATCATACCACTATACTCCAGCCTGGGCGACAGAGCAAGACTCTGTCTCAAAAAAAAAACAAACCCACAAAATTTAGCCAATTTTTGTGGTGGTGTGCGTGGTGTTGGGTGTAGTGGCCAGTGCCTGTAGTCCCAGCTACTCTGGAGGCTGAGGCAGGAAAACTGCTTGAACCTGGGAGGCAGAGGTTGCAGTGAGCCAAGATCATGCCACCGCACTCCAGCCTGGGTGACAAGAGTGAAACCCTGTTTCAAAAAAAGAAAAGAAAAGAACAAAAAAAAA","GGCTGGGCGCAGTGGCTCACACCTGTAATCCCAGCACTTAGGGAAGCTGAGGCGAGTAGATCACCTGAGGTCAGGAGTTAGAGACCAGCCTGGCCATCATGGTGAAACCCCGTCTCTACTAAAGATACCAAAAATTAGCTGAGTGTGGTGCTGGGTGCCTGTAATCCCAGAAACTCAGGGTGCCTGTAATCCCAGCAACTCAGGGTGCCTTTAATCCCAGCAACTGAGGGTACCAGTAATCCCAGCAACTCAGGGTGTCTTTAATCCTAGCAACTGAGGGCACCTGTAATCCCAGCAACTCAGGAAGCTGAGACAGGAGAAGTACTTGAACCCAGAAGGCAGAGGTTGCAGTGAGCCGATATTGCACCATTGCACTCCAGTCTGGGCAACAAGAGTGAAACTCTGTCTCAAAAAAAAA"
"chr1","26871758","26872373","JH378118","18053084","18053501","256","8818674","GGCCGGGCACAGTGGCTCATGCCTGAAATCCCAGCACTTTGGGAGGCCGAGGCGGGTGAATCACCTGAGGTCCAGAGTTCAAGACCAGCCTGGCCAACATGGTGAAATTCCATCTTTCCTAAAAATACAAGAATTAGCGGCCAGGTGCGGTAGCTCACACCTGTAATCCCAGCACTTTGGGAGGCCAAGGCAGGTGGATCACGAGGTCAGGAGTTCAAGACCAGCCTGGCCAGCATGGTGAAACCCCGTTTCTACTAAAAATACAAAAAATTAGCTGGGCATGGTGGCGCATGCCTGTAGTCCCAGCTACTCAGGAAGCTGAGGCAGGATAATTTCTTGAACCCAGCAGGCGAAGGTTGCAGTGAGCCAAGATCATGCCACTGCATTCCAGCCTGGGTGACGGAGCAAGACTCCATCTCAAAAAAAAAAAAAAAAAAAAAAATTAGCTGGATGTGGTGGCAGGCGCCTGTAATCCCAGCTACTTGGGAGGCTGAGGCAGGAGAATCACTTGAACCCAGAAGGCAGAGGTTGCAGTGAGCTGAGACCGTGCCATTGCACTCCAGCCTGGGCAACAAGAGTGAAACTCCATCTCAAAAAGCAATAATAATAAAATAAA","GGCTGGGCGCAGTGGCTCACACCTGTAATCCCAGCACTTAGGGAAGCTGAGGCGAGTAGATCACCTGAGGTCAGGAGTTAGAGACCAGCCTGGCCATCATGGTGAAACCCCGTCTCTACTAAAGATACCAAAAATTAGCTGAGTGTGGTGCTGGGTGCCTGTAATCCCAGAAACTCAGGGTGCCTGTAATCCCAGCAACTCAGGGTGCCTTTAATCCCAGCAACTGAGGGTACCAGTAATCCCAGCAACTCAGGGTGTCTTTAATCCTAGCAACTGAGGGCACCTGTAATCCCAGCAACTCAGGAAGCTGAGACAGGAGAAGTACTTGAACCCAGAAGGCAGAGGTTGCAGTGAGCCGATATTGCACCATTGCACTCCAGTCTGGGCAACAAGAGTGAAACTCTGTCTCAAAAAAAAA"
"chr1","29475257","29475872","JH378118","18053084","18053501","265","11422173","GGCCAGGCGCAGTGACTCACGCCTGTAATCCCAGCACTTTGTGGGGCCGAGGCAGGCGGATCACCTGAGGTCAGGAGTTCAAGACCAGCCTGGCCAACTTGGTGAAATGCCATCTCTACTAAAAATACCAAATAAAGGCCGGGTGTGGTGGCTCACGCCTGTAATCCCAGCACTTTGGGAGGCCGAGGCGGGTGAATCATGAGGTCAGGAGATCGAGACCATCTTGGCTAACACGGTGAAACCTCGTCTGTACTAAAAATACAAAAATTTAGCCAGGTATGGTGGCGGGCACCTGTAGTCCCAGCTACTCGGGAGGCTGAGGCAGGAGAATGGCGTGAACCCAGGAGGTGATGCTGGCAGTGAGCCGAGATCGCGCCACTGCACTCTAGCCTGTGCAATAGAGCAAGACTCTGTCTCACAAAAAAAAAAAAAAAAAAAACCAAAAAATTTAGCCGGGCATGGTAGCAGGTGCCTGTAATCCCAGCTACTCAGGAGGCTGAGGCAAGAAAATTGCTTGAACCTGGGAGGCGGAGGTTGCAGTGAGCTGAGATCATGTCATTGCACTCCAGCCTGGGTGACAAAAGTAAGACTCCATCTCAAAAAAAAAAGAAGAAAA","GGCTGGGCGCAGTGGCTCACACCTGTAATCCCAGCACTTAGGGAAGCTGAGGCGAGTAGATCACCTGAGGTCAGGAGTTAGAGACCAGCCTGGCCATCATGGTGAAACCCCGTCTCTACTAAAGATACCAAAAATTAGCTGAGTGTGGTGCTGGGTGCCTGTAATCCCAGAAACTCAGGGTGCCTGTAATCCCAGCAACTCAGGGTGCCTTTAATCCCAGCAACTGAGGGTACCAGTAATCCCAGCAACTCAGGGTGTCTTTAATCCTAGCAACTGAGGGCACCTGTAATCCCAGCAACTCAGGAAGCTGAGACAGGAGAAGTACTTGAACCCAGAAGGCAGAGGTTGCAGTGAGCCGATATTGCACCATTGCACTCCAGTCTGGGCAACAAGAGTGAAACTCTGTCTCAAAAAAAAA"
"chr1","37349057","37349387","JH378271","2122362","2122678","56","35226695","GGCCGGGCGCGGTGGCTCACGCCTGTAATCCCAGCACTTTGGGAGGTCGAGGCGGGTGTATCACCTGAGGTTGGGAGTTCGAGACAAGCCTGGCCAACATGGCGAAACCCTGTCTCTACTAAAAATACAAAAAAACAACAAACAAACAAACAAACAAACAACCAAAAACAAGAGGGCACGGTGGCCGGCGCCTGTAATCCCAGCTACTCGGGGGGCTGAGGCAGGTGAATCGCTTGAGCCTGGAAGGCAAAGGTTGCAGTGAGCCAAGATCGCGCCATTGCACTCCAGCCTGGGCAACAAGAATGAAACTCGCCTCAAAAAAAAAAAAAAA","GGCCGGGCACGGTGGCTCACACCTGTAATCCCAGCACTTTGGGAGGCTGAGGTGGGTGAATCACCTGAGGTCAGGAGTTTGAGACCAGCCTGACCAACATGATGAAACCCGGTCTCTGCTAAAAATACAAAAAAAAAAAAAAAAAAAAAAAAAAAAAGCTGGGCATGATGGTGGGCACCTGTAATCCCAGCTACTCGGGAGGCTGAGGCAGGAGAATCGCTTGAACACCAGGAGGTGGAGGTTGCTATGAGCCGAGATCGCACCATTGCACTCTAGCTTGGGCAACAAGAGAGAAACTCCATCAAAAAAAAAAAAAA"
"chr1","40464633","40464951","JH378235","1186107","1186418","46","39278526","GGCTGGAGCAATGGCTCACGCCTGTAATCCCAGCACTTTGGGAGGCCAAGGCAGGTGGATCACCTGAGGTCAGGAGTTCGAGACCAGCCTGGCCAGCATGATGAAACCCTATCTCTACTAAAAATACAAAAAAAAAAAAAAAAAAAAAAAAAAATTAGCTGGGCATGGTGGCGGGTGCCTGTAATCCCAGCTACTCAAGAGGCTAAGGCAGAGAATCGCTTGAACCTGGGAGGCGGAGGTTGTAGTGAGCCAAGATCATGACACTGCACTCCAGCCTGGGTGACAAGAGCAAGACTCTGTCTCAAAACAAACAAACAAA","GGCTGGGCGCAGTGGCTCAAGCCTGTAATCCCAGCACTTTGGGAGGCCGAGGGGGGTGGATCACGAGGTCAAGAGATCAAGACCATCCTGGTCAACATGGTGAAACCCCGTCTCTACTAAAAAAAAAAAAAAAAAAAAAAAAAAAAAAAAAAAATTAGCTGGGCATGGTGGCGTGTAATCCCAGCTACTCAGGAGGCTGAGGCAGGAGAATTGCCTGAACCCAGGAGGCGGAGTTTGCGGTGAGCCAAGATCGCGCCATTGCACTCCAGCCTGGGTAACAAGAGCAAAACTCTGTCTCAAAAAAAAAAAAAA"
"chr1","47625271","47625764","JH378145","16080149","16080475","212","31545122","TCATACCTGTCATTTCAACACTGAGAGGCCAAGGTGAGAGCAAGGAGTTCAAGTCCAGCCTAGGCAACAAAGTGAGACCCCATCTCTGCAGAATCAGAATAATTTTAGGCTGGGCACAGTGGCTCACGCCTATAATCTCAGCACTTTGGGAGGCCAAGGCGGGCGGATCACCTGAGGTCAAGAGTTCCAGTCTAGCCTGACCAACATGGAGAAACCTCGTCTCTACTAAAAATACAAAATTAGCCGGGCATGGTGGCGCATGCCTGTGATCCCAGGTACTCGGGAGGCTGAGGCAAGAGAATCGCTTGAACCCGGGAGGCAGAAGTTGTAAAAAAAAAAAAAAAAAAAAAAATTAGCGGGGTCTGGTGGCATGCACCTGTAATCCCAGCTACTCGGGATGGTGAGACAGGAGGCAAAGGTTGCAGTGAGCCAAGATTGCGCCATTGTACTCCAGCTTGAGAAACCAGAGCAAAACTCCGTCTCAAAAGAAAAAA","GGCGGGGAGCGGTGGCTTATGCCTGTAACTCCAGGCTGGTCTCAAACTCCACCCACTTTGGGAGGCTGAGGTGGGCGGATCACCTGAGGTCAGGAGTTCAAGACCAGCCTGACCAACATGGTGAAATCCCATCTCTACTAAAACTACAAAATTAGCCGGGCATGGTGGCACATGCCTATAATCCCGGCTACTCGGGAGGCTGAAGCAGGAGAATGGCTTGAACCCGGGAGGCAGAGGTTACAGTGAGCTGAGAGGTGCCATTGCACTCCAGCCTGGGCAACAAGAGTGAAATGCTGTCTAAAAAAAAAAAAAAAAAGGAAAATAAAA"
"chr1","49669095","49669718","JH378118","18053084","18053501","264","31616011","GCCAGGCATGGTGGCTCACGCCTGTAATCCCAGCACTTTGGGAGGCTGAGGCGGGTGGATCACCTGAGGAGGTCAGGAGTTCCAGACCGGCCTGGTCAACATAGTGAAACCCTGTCTCTTCTAAAAAGACAATAAATTATGGCTAGGCGCAGTGGCTCACACCTGTAATCCCAGCACTTTGGGAGACGAAGGCGGGCGAATCATTTGAGGTCGGGAGTTCGAGACAAGCCTGAACAACATGGAGAAACCCTGTCTCTACTAAAAATACAAAATTAGCCGGGCGTGATGGTGCATGCCTGTAATCCCAGCTATTCGGGAGGCTGAGGCAGGAGAATCACTTGAAGCTGGGAGGCAGAGGTTGCGGTGAGCCGAGATTGCTGCCATTGCACTCCAGCCTGGGCGACAAGAGCAAAATTCTGTCTCAAAAAAAAAAAAAAAAAAATTAGCTAGGCGTGGTGGCAGGCACCTGTAATTCCAGCTACTAGGGAGGCTGAGGCAGGAGAATCGCTTGAACCCGGGAGGCAGAGGTTGCAGTGAGCCGAGATTGCGCCATTGCACTCCAGCCTGGGCAACAAGAGCGAAACTCCGTCTCAAAAATAATAAATAAATAAATAAATAAATAAA","GGCTGGGCGCAGTGGCTCACACCTGTAATCCCAGCACTTAGGGAAGCTGAGGCGAGTAGATCACCTGAGGTCAGGAGTTAGAGACCAGCCTGGCCATCATGGTGAAACCCCGTCTCTACTAAAGATACCAAAAATTAGCTGAGTGTGGTGCTGGGTGCCTGTAATCCCAGAAACTCAGGGTGCCTGTAATCCCAGCAACTCAGGGTGCCTTTAATCCCAGCAACTGAGGGTACCAGTAATCCCAGCAACTCAGGGTGTCTTTAATCCTAGCAACTGAGGGCACCTGTAATCCCAGCAACTCAGGAAGCTGAGACAGGAGAAGTACTTGAACCCAGAAGGCAGAGGTTGCAGTGAGCCGATATTGCACCATTGCACTCCAGTCTGGGCAACAAGAGTGAAACTCTGTCTCAAAAAAAAA"
"chr1","49676852","49677454","JH378118","18053084","18053501","246","31623768","GGCCAGGCATGGTGGCTCACGCCTGTAATCCCAGCACTTTGGGAGGTCAAGGCGGGTGGATTACTTGAAGTCAGGAGTTTGAGACCAGCCTGGCCAACATGGTGAAACCCCATCTCTACTAAAAATACAAAAATTAGGCTGGACGCGGTGGCTCACGCCTGTAATTCCAGCACTTTGGGAGGCCACGGCATGCAGATCACCTGAGGTCGGGAGTTCGAGACCAGCCTGGCCAACATGGAGAAACCCCATCTCTACTAAAAATACAAAATAGCCGGGCATGGTGGCACATGCCTGTAGTCCCAGCTACTCAGGAGGCTGAGGCAGGAGAATCACTTGAACCTGGGAGGCAGAGGTTGCGGTGAGCCGAGATTTCACCATTGTACTCCAGCCTGGGCAACAAGAGTGAAACTCTATCTCAAAAAAAAATAAAAAAAATAAAAAAAATTAGCTGGTCGTGGTGCAGGAACCTGTAATCCCAGCTCCTTGGGAGGTTGAAGCAGGAGAATTGCTTGAACCCAGGAGGCAGAGGTTGCAGTGAGCCGAAATCTAGCCATTGCACTTCAGCCTGGGCGACAAGAGCAACACTCTGTCTCAAAAAAAAAA","GGCTGGGCGCAGTGGCTCACACCTGTAATCCCAGCACTTAGGGAAGCTGAGGCGAGTAGATCACCTGAGGTCAGGAGTTAGAGACCAGCCTGGCCATCATGGTGAAACCCCGTCTCTACTAAAGATACCAAAAATTAGCTGAGTGTGGTGCTGGGTGCCTGTAATCCCAGAAACTCAGGGTGCCTGTAATCCCAGCAACTCAGGGTGCCTTTAATCCCAGCAACTGAGGGTACCAGTAATCCCAGCAACTCAGGGTGTCTTTAATCCTAGCAACTGAGGGCACCTGTAATCCCAGCAACTCAGGAAGCTGAGACAGGAGAAGTACTTGAACCCAGAAGGCAGAGGTTGCAGTGAGCCGATATTGCACCATTGCACTCCAGTCTGGGCAACAAGAGTGAAACTCTGTCTCAAAAAAAAA"
"chr1","66680511","66681095","JH378118","18053084","18053501","237","48627427","GGCCAGGCACAGTAGCTCATGCCTATAATCCCAGCACTCTGGGAGGCCGAGGCGGGCAGATCACCTGAAGTCAGAAGTTCAAGACCAGACTGGCCAAAATGTTGAAACCCCGACTCCACTAAAAATACAAAACTTAGGCCGAATGCATGACTCATGCCTGTAATCCCAGCACTTTGGGAGGCTGAGGTGGGCAGATCACCTGAGGTCAGGAGTTCAAGACCAGCCTAGCCAATGTGGTGAAACCCTGTCTCTATTTAAAAATACAAAAATTAACCAGGTGTGGTGGTGGGAGCCTGTAATCCCAGCTACTTGGTAAGCTGAGGCAGGAGAATCACTTGAACCCAGGAGATGGAGGTTGCAGTGAGCCAAGATCACGCCATTGCACTCCAGCCTGGGCAACAGAAGCAAAACTGTCTAAAAAAAAAAAAAAAAAAATACATTCCAGCTACTAGGGAGGCTGAGGCAGGAGAATCACTTGAACCCAGGAGGCAGAAGTTGCAGTGAGCCGAGATCACACCATTGCACTCCAGCCTGAGCAACAAGAACAAAACTCCATCTCAAAAAAAAAAAAAAAAAAAAAAAGAA","GGCTGGGCGCAGTGGCTCACACCTGTAATCCCAGCACTTAGGGAAGCTGAGGCGAGTAGATCACCTGAGGTCAGGAGTTAGAGACCAGCCTGGCCATCATGGTGAAACCCCGTCTCTACTAAAGATACCAAAAATTAGCTGAGTGTGGTGCTGGGTGCCTGTAATCCCAGAAACTCAGGGTGCCTGTAATCCCAGCAACTCAGGGTGCCTTTAATCCCAGCAACTGAGGGTACCAGTAATCCCAGCAACTCAGGGTGTCTTTAATCCTAGCAACTGAGGGCACCTGTAATCCCAGCAACTCAGGAAGCTGAGACAGGAGAAGTACTTGAACCCAGAAGGCAGAGGTTGCAGTGAGCCGATATTGCACCATTGCACTCCAGTCTGGGCAACAAGAGTGAAACTCTGTCTCAAAAAAAAA"
"chr1","71474367","71474697","JH378152","8831253","8831579","46","62643114","GGCCGGGAGCGGTAGCTCACACCTGTAATCCCAGCACTTTGGGAGCCCAAGGCGGCTGAATCACCTGAGGTCAGGAGTTTGAGACCAGCCTGGCCAACATGGTGAAACCCCATCTCTACTAAAAATACCAAAATTAGCTGGGCTTGTTGGTGGGCACCTGTAACCCCAGCTACACAGGAGGCTGAAGCAGGAGAATTGCTTGAATCTGGGAGGCAGAGGTTGCAGTGAGCTGAGATAGTGCCATTGCACTCCAGCCTGGGTGACAAGAGTGAAACTCCATCTCAATAAATAAATAAATACATAAATAAAAAATAAATAAAAACAGAAAAAA","GGCCGGGCGCGGTGGCTCAAACCTGTAATCCCAGCACTTTGGGAGGCCGAGGCGGGTGGATCACAAGGTCAAGAGATCGAGACCATCCTGGTCAACATGGTGAAACCCCGTCTCTACTAAAAATACAAAAATTAGCTGGGCATGGTGGCGTGTGCCTGTAATCCCAGCCACTCAGGAGGCTGAGGCAGGAGAATTGCCTGAACCCAGGAGGCGGAGGTTGCGGTGAGCCGAGATCGCGCCATTGCACTCCAGCCTGGGTAACAAGAGTGAAACTCCGCCTCAAAAATAAATAAATAAATAAATAAAAAAAATAAAAAAAAAAATAAA"
"chr1","80984676","80985283","JH378118","18053084","18053501","262","62931592","GGCTGAGCATGGTGGCTCATGCCTGTAATCCTAGCACTTTGGGAGGCTGAGGCAGTTGGATCACCTGAGGCTAGGAGTTCAAGACCAGCCGAGCCAAGATGGCGAAACCCCATCTCTACTAAGAATACAAAAAATTGGCCTGGTGCAGTGGCTCATGCCTGTAATCCCAGCACTTTGGGAGGCCAAGGTGGGCAGATCACCTGAGGTTAGGAGTTCAAGATCAGCCTGGCCAAGATGGTGAAACCCCATCTCTACTAAAAATACAAAACATTAGTTGGGCATGGTGGCGGGCACCTGTACTCCCAGCTACTTGGGAGGCTGAAGCAGAGAATTGCTTGAATCTGGGAGGCAGAGGTTGTAGTGAGCCGCGATCACGCCACTGCACTCCAGCCTGGGCGACAGAGCAAAACTCTGTCTCAAAAAAAAAAAAAAAAAATTAGCCGTATGTGGTAGTGGACGCCTGTATTCCCCGCTACTGGAGAGGGCGAGGCAGGCGAATTGCTTGAACCCGGGAGGTGGAGGCTGCAGTGAGCCGAGATCGCGCCATTGCACTCCAGCCTGGGCAACAAGCGAAACTTCATCTCAAAAAAAAACAAAAACAAAAAAAA","GGCTGGGCGCAGTGGCTCACACCTGTAATCCCAGCACTTAGGGAAGCTGAGGCGAGTAGATCACCTGAGGTCAGGAGTTAGAGACCAGCCTGGCCATCATGGTGAAACCCCGTCTCTACTAAAGATACCAAAAATTAGCTGAGTGTGGTGCTGGGTGCCTGTAATCCCAGAAACTCAGGGTGCCTGTAATCCCAGCAACTCAGGGTGCCTTTAATCCCAGCAACTGAGGGTACCAGTAATCCCAGCAACTCAGGGTGTCTTTAATCCTAGCAACTGAGGGCACCTGTAATCCCAGCAACTCAGGAAGCTGAGACAGGAGAAGTACTTGAACCCAGAAGGCAGAGGTTGCAGTGAGCCGATATTGCACCATTGCACTCCAGTCTGGGCAACAAGAGTGAAACTCTGTCTCAAAAAAAAA"
"chr1","87075741","87076393","JH378118","18053084","18053501","312","69022657","GGCCCAGCGTGGTGGCTCACTCCTGTAGTCCCAGCACTTTAGGAGGCCAAGGTGGGCAGATCACTTGAGGTTAGAAGTTTGAGACCAGCTGGCCAACATGGCGAAACCCCGTCTCTATTAAAAATACAAAATTTAAGGCCGGGCGTGGTGGCTCACGCCTGTAATCCCAGCACTTTGGGAGGCCAAGGCCGGGGGGCGTGTGGGAAGGGGGGTGGATCACGAGGTCAGGAGATGGAGACCATCCTGGCTAACACGGTGAAACCCCATCTCTACTAAAAATACAAAAATTTAGCTGGGCGTGGTGGTGGCGGGCACCTGTAGTCCCAGCTACTCGGGAGGCTGAGGCGGGAGAATGGTGTTAACCTGGGAGGCGGAGCTTGCAGTGAGCCAAGATCGTGCCACTGTAATCCAGCCCGGGCGACAGAGCGAGACTCCGTCTCACACACACACACACACACACACACAAAAATACAAAAACTAGCCTGTTGTGGTGGTGGGTGCATGTAGCCCCAGTTATTCACAAGGCTGAGGCAAGAGAATCACTTGAACTCGGGAGGGGGAGATGACAGTGAGCCGAGATTGTGCCATTGCACTTCAGCCTGGGTGACAAGAGCAAGACTCCATCTCAAAAAAATAAAAAAAATTAAAAAAAA","GGCTGGGCGCAGTGGCTCACACCTGTAATCCCAGCACTTAGGGAAGCTGAGGCGAGTAGATCACCTGAGGTCAGGAGTTAGAGACCAGCCTGGCCATCATGGTGAAACCCCGTCTCTACTAAAGATACCAAAAATTAGCTGAGTGTGGTGCTGGGTGCCTGTAATCCCAGAAACTCAGGGTGCCTGTAATCCCAGCAACTCAGGGTGCCTTTAATCCCAGCAACTGAGGGTACCAGTAATCCCAGCAACTCAGGGTGTCTTTAATCCTAGCAACTGAGGGCACCTGTAATCCCAGCAACTCAGGAAGCTGAGACAGGAGAAGTACTTGAACCCAGAAGGCAGAGGTTGCAGTGAGCCGATATTGCACCATTGCACTCCAGTCTGGGCAACAAGAGTGAAACTCTGTCTCAAAAAAAAA"
"chr1","94386408","94386940","JH378118","18053084","18053501","200","76333324","CAGCCTGGCCAACATGGCGAAACCTCATCTCTACTAAAAATACAAAAATTTGGCCAGGCGCGGTGGCTCACACCTCTAATCCCAGCACTTTGGGAGGCTGAGGCAGGCAGATCACGAGGTCAGGAGATCAAGACCATCCTGGCTAACACGGTGAAACCCGGTCTCTATTAAAAAATACAAAAAATTAGCCAGGCGTGGTGGCGGGCACCTGTAGTCCCAGCTACTTGGGAGGCTGAGGCAGGAGAATGGTGTGAACCTGGGAGGCAGAGCTTGCAGTGAGCTGAGATCACGCCACTGCACTCCAGCCTGGGCGACAGAGTGAGACTCCGTCTCAAAAAACAAACAAAAACAAACAAACAAACAAAAAAATTAGCCAGGTATGGTAGCAGGTGCCTGTAATCCCAGCTACTCAGGAGGCTGAGACAGGAGAATCACTTGAACTCAAGAGGCAGAGGTTGCAGTGAGCCAAGATCATGCCGTTGCACTCCAGCCTGGGCAACAAGAGTGAAATTCCATCTCAAAAAAAAAACAAA","GGCTGGGCGCAGTGGCTCACACCTGTAATCCCAGCACTTAGGGAAGCTGAGGCGAGTAGATCACCTGAGGTCAGGAGTTAGAGACCAGCCTGGCCATCATGGTGAAACCCCGTCTCTACTAAAGATACCAAAAATTAGCTGAGTGTGGTGCTGGGTGCCTGTAATCCCAGAAACTCAGGGTGCCTGTAATCCCAGCAACTCAGGGTGCCTTTAATCCCAGCAACTGAGGGTACCAGTAATCCCAGCAACTCAGGGTGTCTTTAATCCTAGCAACTGAGGGCACCTGTAATCCCAGCAACTCAGGAAGCTGAGACAGGAGAAGTACTTGAACCCAGAAGGCAGAGGTTGCAGTGAGCCGATATTGCACCATTGCACTCCAGTCTGGGCAACAAGAGTGAAACTCTGTCTCAAAAAAAAA"
"chr1","95127503","95127913","JH378226","6290102","6290462","151","88837401","AATTAGCTCAGCATGGTGGTGGGTGCCTGTAATCCCAGCTACTTGGGAGGCTGAGGCAGAATTGAATTCCTGAACCCAGGAGGCAGAGGTTGCAGTGAGCCGAGATCAGCTCCATCCCACAATAAAAAATAAAAAAAATAGGCCAGGCGCAGTGGCTCATGCCTGTAATCCCAGCATTTTGGAAGGCCAAGGCGGGTGGATAACATGAGGTCAGAAGTTTGAGACCAGCCTGGCCAGCATGGCGGAACCCTATCTCTACTATAAAAATTCAAAAATTAGCCAGGTATGGTGGCATGTGCCTGTAATCCCAGCTACTAGCAGGGCTGAGGCAGGAGGATCACTTGAACCAAGGAGGCGGAGGTTGCAGTGAGCTGAGATAGGCTCCATCTCAAAATAAAAAATAAAAAAATA","GGCTGGGCTCGGCAGCTCGTGCCTCGTTGTCCCAGCATTTTGGAAGGCTGAGGCAAGAGGATCGCTTTAGCTCAGGAGCTCAGGACCAGCCTGAGCAACATAGTGATGAGACCCCCATCTCTACAAAAATAAAAATAGGGCTGGCGTAGTGGCTCACACCTGTAATCCCAGAACTTTGAGAGGCTGAGGGAGGCGGATCACTTGAGGTTGGGAGTTCAAGACCAGCCTGGCCAACATGGTGAAACCCTTTCTCTACTAAAAACCCAGGAGGCAGAGGTTGCAGTGAGTGGAGATCGCACCATTGCACTCCATCCTGGGTGATGAAAATGAAACTCTGTCTCAAAAAAAAAAAAAAAAAAAA"
"chr1","96997059","96997927","JH378118","18053084","18053501","483","78943975","GGCCAGATGCAGTGGCTCACGCCTGTAATCCCAGCACTTTGGGAGGCTGAGGTGGGCGGATCACCCGAGGTCAGGAGTTCGAGACCAGCCTAGCCAACATGGTGAAACCCTGTCTCTACTAAAAATACAAAAATTAGCCAGGTGCGGTGGTTCGCACCTGTAATCCCAGCACTTTGGGAGGCCAAGGGGGTTGGATCACCAGAGGTGGGGAGTTCGAGACCAGCCTGACCAACATGGAGAAACCCCGTCTCTACAAAAATTAGACTGGCATGGTGGCACATGCCTGTAATTCCAGCTACTTGGGAGGCTGAGGCACGAGAATTGCTTAAACCTGGGAGGCGGAAGTCGAGGTGAGCCAAGATTGCATCATTGCACTCCAGCCAGGGCAACAAGAGCGAAACTCTGACCGGGCGTGGTGGCTCTCGCCTGTAATGCCAGCACTTTGGAAGGCCGAGGAGGGCAGATCACGAGGTCAAGAGATAGAGACTATCCTAGCCAACATGGTGAAAAAACCCTGTCTCTACTAAAAATACAAAAATTAGCTGGGCATTGTGGCACACGCCTGTAGTCCCAGCTACTCGACAGGCTGAGGCAGGAGAATCACTTGAACCCGGGAGGTGGAGGTTGCCGTGAACCGAGATCACGCCACTTCACTCCAGCCTGGGCGACAGAGTGAGACTCCGTCTCAAAAAAAAAAAAAAAAAAAAAATTAGCCAGGCGTGGTGGCAGGCGCCTATAATCCCAGCTTTTCAGGAGGCTGAGGCAGGAGAATCGCTTGAACCTGGGAGGCAGAGGTTGCAGTGAGCCGAGTTGGCATCATTGCACTCCAGTCTGGATGACAAGAGCGAAACACTGTCTCAAAAAAAAAA","GGCTGGGCGCAGTGGCTCACACCTGTAATCCCAGCACTTAGGGAAGCTGAGGCGAGTAGATCACCTGAGGTCAGGAGTTAGAGACCAGCCTGGCCATCATGGTGAAACCCCGTCTCTACTAAAGATACCAAAAATTAGCTGAGTGTGGTGCTGGGTGCCTGTAATCCCAGAAACTCAGGGTGCCTGTAATCCCAGCAACTCAGGGTGCCTTTAATCCCAGCAACTGAGGGTACCAGTAATCCCAGCAACTCAGGGTGTCTTTAATCCTAGCAACTGAGGGCACCTGTAATCCCAGCAACTCAGGAAGCTGAGACAGGAGAAGTACTTGAACCCAGAAGGCAGAGGTTGCAGTGAGCCGATATTGCACCATTGCACTCCAGTCTGGGCAACAAGAGTGAAACTCTGTCTCAAAAAAAAA"
"chr1","98895378","98895979","JH378118","18053084","18053501","254","80842294","GGGCACAGTGGCTCATACCTGTAATCCCAGCACTTTGGGAGGCCGAGGTGGGTGGATCGCCTGAGGTCAGGAGTTTGAGACCAGCCAGGCCAACATGGTGAAACCCCGTCTCTGCTAAAAATACAAAAATTAAGGCCGGGCACAGTGGCTCACTCCTATAATCCCAGCACTTTGGGAGGCTGCAGCGGGCGGATCACGAGGTCAGAAGATTGAGACCATCCTGGCTAACACGGTGAAACCTGTCTCTACTAAAAATACAAAAAATTAACTGGGCGTGGTGGCGGGCGCCTGTAGTCCCAGCTACTCGGGAGTCTGAGGCAGGAGAATGGCGTGAACATGGGAGGCAGAGCTTGCAGTGAGCCAAGATCTCGCCACTGCACTCCAGCCTAGGCGACAGAGTGAGACTGTGTCTCAAAAAAAAAAAAAAAAAAAAAAGTTAGCCAGGCGTAGTGGCGCATGCCTGTAATCCCAGCTACTTGAGAGGCTGAGGCAGGAGAATCGCTTGAACCTGTCAGGTGGAGGTTGCAGTGAGCCGAGATCGCGCCATTGTACTCCAGCCTGGGCAACAAGAACGAAACTCCATCTCAAAAAAAAAAAAAAAA","GGCTGGGCGCAGTGGCTCACACCTGTAATCCCAGCACTTAGGGAAGCTGAGGCGAGTAGATCACCTGAGGTCAGGAGTTAGAGACCAGCCTGGCCATCATGGTGAAACCCCGTCTCTACTAAAGATACCAAAAATTAGCTGAGTGTGGTGCTGGGTGCCTGTAATCCCAGAAACTCAGGGTGCCTGTAATCCCAGCAACTCAGGGTGCCTTTAATCCCAGCAACTGAGGGTACCAGTAATCCCAGCAACTCAGGGTGTCTTTAATCCTAGCAACTGAGGGCACCTGTAATCCCAGCAACTCAGGAAGCTGAGACAGGAGAAGTACTTGAACCCAGAAGGCAGAGGTTGCAGTGAGCCGATATTGCACCATTGCACTCCAGTCTGGGCAACAAGAGTGAAACTCTGTCTCAAAAAAAAA"
"chr1","100456728","100457360","JH378118","18053084","18053501","276","82403644","GGCCGGGAACGGTGGCTCAAGCCTGTAATCCCAGCACTTTGGGAGGCCGAGGCCAGTGGATCACCCGAGGTCAAGAGTTAGAAACCGGCAGCCTGACCAACATGGTGAAACCCCACCTCTACTAAAAATACAGGGCCAGGCACGGTGGCTCACACCTCTAATCCCAGCACTTTGGGAGGCCAAGCGGGGTGGATCACAAGGTCAGGAGTTCAAGACCAGCCTGACCAATATGGTGAAACACCCTCTCTACTAAAATTACAAAAAATTAGCCGGGCGTAGTGGCACATGCCTGTAATCCCAGCTACTCGGGAGGCTGAGGCAGGAGAATTGCTTGAACCTGGGCAGCAGAGGTTGCAGTGAGCCGAGGTCGCGCCACTGCACTCCACCCTGGGTGACAGAGTGAGACTTTGTCTCAAAATAAATACATACATACATAGAATAAAATAAAATAAAATAAAACAAAATTAGCTGGACATGGTGGCAGGTGCCTGTAATCCCAGCTACTTGGGAGGCTGAGGCGGGAGAATCGCTTAAACCTGGGAGGCAGATGTTGCAGTGAGCCAAGATCGCGCCATTGCACTACCACCTGGGCAACAAGACTGAAACTCCCTTTCAAAAAAAGAAAAAGAAAAA","GGCTGGGCGCAGTGGCTCACACCTGTAATCCCAGCACTTAGGGAAGCTGAGGCGAGTAGATCACCTGAGGTCAGGAGTTAGAGACCAGCCTGGCCATCATGGTGAAACCCCGTCTCTACTAAAGATACCAAAAATTAGCTGAGTGTGGTGCTGGGTGCCTGTAATCCCAGAAACTCAGGGTGCCTGTAATCCCAGCAACTCAGGGTGCCTTTAATCCCAGCAACTGAGGGTACCAGTAATCCCAGCAACTCAGGGTGTCTTTAATCCTAGCAACTGAGGGCACCTGTAATCCCAGCAACTCAGGAAGCTGAGACAGGAGAAGTACTTGAACCCAGAAGGCAGAGGTTGCAGTGAGCCGATATTGCACCATTGCACTCCAGTCTGGGCAACAAGAGTGAAACTCTGTCTCAAAAAAAAA"
"chr1","113069441","113070062","JH378118","18053084","18053501","267","95016357","GGCCAGGCGCAGTGGCTCACGCCTGTAATCCCAGCACTTTGGGAGGCCAAAGCGAGTGGATCACCTGAGGTCAGGAATTCAACACCAGCCTGGCTAACATGGCAAAACCCCATCTCTACTAAAATATAAAAAAATTAGGCCAGACGCAGTGGCTCATGCCTGTAATCCTCGCACTTTGGGAGGCCGAGGCAGGTGGATCACCTGAGGTCAGGAGTTCAAGACCAGCCTGGCCAACATGATGAAACCCTGTCTCCACTAAAAATACAAAAAATTTGCTGCGTGTGGTGGTACGCGCTATAATCCCAGCTACTCAGGAGGCTGAGGCAGGAGAATTGCTTGAACCTGGGAGGCAGAGGTTGCAGTAAGCCAAGATCACACCACTGCACTCTAGCCTGGGCAACAAGAGTAAAACTCCATCTCAAAAAAAAAAAAAAAAAAAATTAGCCAGGCGTGGTGGCATGCGCCTGTAATCCCAGCTACTTGGGAAGCTGAGGCAGGAGAATCACTTGAATGCAGGAGGCAGAGGTTGCAATGAGCCAAGATTCTGCCATCGCACTCCAGCCTGGATGACAAGAGTGAGACTTGGTCTCAAAAAAAAAAAAAAAAAAACTAAACAAAAAAA","GGCTGGGCGCAGTGGCTCACACCTGTAATCCCAGCACTTAGGGAAGCTGAGGCGAGTAGATCACCTGAGGTCAGGAGTTAGAGACCAGCCTGGCCATCATGGTGAAACCCCGTCTCTACTAAAGATACCAAAAATTAGCTGAGTGTGGTGCTGGGTGCCTGTAATCCCAGAAACTCAGGGTGCCTGTAATCCCAGCAACTCAGGGTGCCTTTAATCCCAGCAACTGAGGGTACCAGTAATCCCAGCAACTCAGGGTGTCTTTAATCCTAGCAACTGAGGGCACCTGTAATCCCAGCAACTCAGGAAGCTGAGACAGGAGAAGTACTTGAACCCAGAAGGCAGAGGTTGCAGTGAGCCGATATTGCACCATTGCACTCCAGTCTGGGCAACAAGAGTGAAACTCTGTCTCAAAAAAAAA"
"chr1","128939921","128940227","JH378116","25229810","25230116","49","103710111","GGCAGGGCACAGTGGCTCGTGCCTGTAATCCCTGCACTTTGGGAGACCGAGGCGGGCGGATCATCTGAGGTCAGGAATTTGTGACCAGCCTGTCCAACATGGTGAAACCCTGTCTCCACTAAAAAAAAAAAAAAAAAAAAAAAAATTAGCAGGGTGTGGTGGCAGGTGCCTGTAGTCCCAGCTACTTAGGAGGCTGAGACTGGAAAATCACTTGAACCCAGGAGGTGGAAGTTGCAGTGTGCCGAGATCGCACCATTGCAGTCCAGCCTGGGTGACGAGTAAAACTCTGTCTCAAGAAAAAAAAAAA","GCCGGGCGCGGTGGCTCAAGCCTGTAATCCCAGCACTTTGGGAGGCCGAGGCGGGTGGATCACGAGGTCAGGAGATCGAGATCATCCTGGTCAACATGGTGAAACCCCATCTCTACTAAAAATACAAAAAAAAAAAAAAAAATTAGCTGGGCATGGTGGCGCGTGCCTGTAATCCCAGCTACTCAGGAGGCTGAGGCAGGAGAATTGCCTGAACCCAGGAGGTGGAGGTTGCGGTGAGCCGAGATCGCGCCATTGCACTCCAGCCTGGGTAACAAGAGTGAAACTCCGTCTCAAAAAAAAAAAAAAA"
"chr1","132089463","132090091","JH378118","18053084","18053501","283","114036379","GACCAGGTGCAGTGGTTCACACTGTAATCCCAGCAATTTGGGAGGCCAAGACACGTGGATCACCTGAAGGTCAGGAGTTTGAAACCAGCTTGGCCAACATGGTGAAACCCTGTCTCTACTAAAAATACAAAAATGGCCAGGCGCAGTGGCTTACTCCTGTAATGCCTGTAATCCCAGCACTTTGGGAGGCCGAAGTGTGTGGATCACCTGAGGTCAGGAGTTCGAGACCATCCTGGCCAACATAGTAAAACCTCGTCTCTACTAAAAATACAAAAATTAGCTGGGCGTGGTGGCACGTGCCTGTAGACCCAGCTACTTGGGAGGCTGAGGCAGAAGAATTGCTTAAACGCAGGAGGAGGAAGTTGTGGTGGGCCAAGATTGCGACACTGCACTCCAGCCTGGCAACAGAGTGAGACTCCATCTCAAAAACAACAACAAACAAACAAACAAAAACCCCAAAAAACAAATTAGCCAGGGGTGGTCATGGGCACTTGTAATCCCAGCTACTTGGGAGGCTGAGGCAAAATAATTGTTTGAACCTGGGAGGTGGAGGTTGCAGTGAGCCAAGATCACACCATTGAACTCCAGCCTGGGCAACAAGAACAAAACTTCACCTCAAAAAAAAAGAA","GGCTGGGCGCAGTGGCTCACACCTGTAATCCCAGCACTTAGGGAAGCTGAGGCGAGTAGATCACCTGAGGTCAGGAGTTAGAGACCAGCCTGGCCATCATGGTGAAACCCCGTCTCTACTAAAGATACCAAAAATTAGCTGAGTGTGGTGCTGGGTGCCTGTAATCCCAGAAACTCAGGGTGCCTGTAATCCCAGCAACTCAGGGTGCCTTTAATCCCAGCAACTGAGGGTACCAGTAATCCCAGCAACTCAGGGTGTCTTTAATCCTAGCAACTGAGGGCACCTGTAATCCCAGCAACTCAGGAAGCTGAGACAGGAGAAGTACTTGAACCCAGAAGGCAGAGGTTGCAGTGAGCCGATATTGCACCATTGCACTCCAGTCTGGGCAACAAGAGTGAAACTCTGTCTCAAAAAAAAA"
"chr1","140498492","140498800","JH378181","5676350","5676662","46","134822142","GGCAGGGAGCAGTGGCTCATGCCTGTAATCCCAGCACTTTGGGAGGCCGAGGTGTGCAGATCACGAGGTCAGGAGTTTGAGACCAGCCTGGCCAACATGGTGAAACCCCGTCTCTACTGAAAATACAAAAAAAAAAAAAAAAAAAAAAAAATTAGCCGGGCACAGTGGTGAGCACCTGTGATCCCAGCTACTCAGGAGGCTGAGGCAGGAGAATCACTTGAACCCGGGAGGTAGAGGTTGCTGTGAGCAAGATCGTGCCATTGCACTCCAGCCTGGGCAACAAGAGCAAAACACCATCTAAAAAAAAAA","GGCTGGGTGCAGTGGCTCATGCCTATAATCCCAGCACTTTAGGAGGCTGAGGCAGGTGGATCACTTGAGGTCAGGAGCTTGAGACCAGCCTGGCCAACATAGTGAAATCTCATCTCTACTAAAAATGCAAAAAAAAAAAAAAAAAAAAAATTTGCTGGGAGTGGTGGCATGTGCCTGTAATCCCAGCTACTCAGGAGGCTGAGGCAGGAGAATCACTTGAACCCAGGAGGTAGATGTTGCAGTGAGCTGAGATCGTGCCATTGCACTCCAGTCTGGGTGACAAGAGCAAAACTCCATCTCAAAAAAAACAAAA"
"chr1","142016125","142016441","JH378147","15246332","15246643","50","126769793","GGCCGGGCACGGTGGCTCACACCTGTAATTGCAACACTTTGGGAGGCCGAGGCAGGTGGATCACCTGAGGTCAGGAGTTCAAGACCAGCCTGACCAACATGGTGAAACTCCACCTCTACAAAAAAAAAAAAAAAAAAAAAAAAAGCCCGGCGTGGTGGCAAGCGCCTGTAATCCCAGCTACTTGGAAGCCGAGGCAGGATAATCGCTTGAACCTGGGAGGTGGAGGTTGCAGTGAGCCGAGATGGCGTCATTGCACTCCACCCTGGGCAACAAGAGCGAAATGCTGTCTCAAAAAAAAAAAGAAAAGAAAAAGAAAA","GGCCGGGCTCGGTGGCTCACACCTGTAATCCCAGCACTTTGGGAGGCCCAGGCAGGTGGATCACCTGAGGTCAGGAGTTTGAGACCCACCTGGCCAACATGGTGAAACCCCATCTCTACTAAAAATACAAAAACTAGCTGGGCACGTGGTGGCAGGTGCCTGTAATCCCAGCTACTTGGGAGGCTGAGGCAGGAGAATTGCTTGAACCTGGGAGGTGGAGGTTGCAGTGAGCCGAGATCGCCCCATTGCATTCCAGCCTGGGAGACAAGAGTGAAATTCCATCTCAAAAAAAAAAAAAAAAAAAAAAAAAAA"
"chr1","162514372","162514755","JH378145","10876935","10877252","113","151637437","GGGTGCAGTGGTGCATGCCTATAGTCTTAGCTACAGAGGAGGCTAAGGCTGATCACCTGAGGCCAGGAGTTCAAGGCTGTAGTATACTATGATCACTCCTGTGAATAGCCACTCCACTCCAGCCCGGGCAATGTAGTGAGATCCCTGATTCTAAAATTAAAAAAAAAAAAAAAAGCTATACAAAATTAGCTGGGCAAGGTGGCACATGCCTGTAATCCCAGCTACTTGTGAGGCTGAGGCAGGAGAATTGCTTGAACCTGGAAGGCAGAGGTTGCAGTGGGCCGAGATTGCACCATTGCACTCCAGCCTGGGCAACAAGGGTGAAACTCCGTCTCAAACAAAACAAAACAAAACAAAAAAAACAAAAAAAGAAAGAAAAGAGAA","GGCTGGGTGCGGTGGCTCATGCCTTTAGTCCCAGCGCTTTCAGAGGCTGGGATGAGCGAATCACTTGAGGTCAGGAATTCGAAACCAGCCTGGCCAACATGGTGAAACCCTGTCTCTACTAAAAATACAAAAAAATTAGCCAGGCACGGTGGCACATGCCTGTAATCCCAGCTACTTGGGAGGCTGAGGCAGGAGAATTGCTTGGACCTGGGAGGCAGAGGTTGCAATGAGCTGAGATTGCACCATTGCACTCCAGCCTGGGCAACAAGAGTGAAACTCCATCTCAAACAAAACAAAACAAAACAAAACAAAACAAAA"
"chr1","163137705","163138036","JH378179","9671646","9671957","58","153466059","GGCCAGGCGTGGTGGCTCATGCCTGTAATCCCCTTTGGGAGGCTGAGGTGGGCCGATCACCTGAGGTCAGGAGTTCGAGACCAGCCTAGCCAACATAGTGAAATCCCCATCTCTACTAAAAATACAAAAATTAGCCGGACATGGTGGCAGGCGCCTGTAATCCCAGCTACTCGGGAGGCTGAGGCAGAAGAATCGCTTGAACCCGGGAGGCTGAGGTTGCAGTGAGCCAAGATCATGCCATTGGACTCCAGCCTGGGCAACAAAAGTAAAACTCTATCTGAAACACACACACACACACACACACACGCACACAGAGAGAAAGAAAAGAAAAA","GGCTGGGCACGATGGCTCACACCTGTAATCCCAACACTTTGGGAGGCTAAGGTGAGCAGATCACCTGAGGTCAGGATTTCGAGACCAGCCTAGCCAACATAGTGAAACCCAGTCTCTATTAAAAATACAAAAATAAGCAGGGCATGGTGGCAGGTGCCTGTAATTCCAGCTACTTCGGAGGCTGAGGCAGGAGAATCGCTTGAACCTGGGAGGCAGAGGTTGCAGTGAGCCAAGATCATGCCATTGTACTCCAGCCTGGGCAACAAGAGTGAAATACCATCTAAAAAAAAAAAAAAAGAAAAGAAAAAAAAA"
"chr1","165356040","165356648","JH378118","18053084","18053501","262","147302956","GGCTGGGCACGGACTCATGCCTGTAATCCCAGCAGTTTGGGAGGCTGAGGCGGGTGGATCACCTGAGGTCAAGAGTTCGAGACCAGGCCGGGTGCAGTGGCTCACACCTGTAATCCCAGAACTTTGGAAGGCTGAGGCAGGCGGATCACGAGGTCAGGAGATCGAGACCATCCTGGCTAACACGGTGAAAAACTCCGTCTCTACTAAAAATACAAAAAATTAGCTGGGTGTGGTGGCGGGCGCCTGTAGTCCCAGCTACTCAGGAGGCTGAGGCAGGAGAATGGCGTGAACCAGGGAGGCAGAGCTTGCAGTGAACCGAGATTGTGCCACTGCACTCCAGCCTGGGCGACAGAGAGAGACTCTGTCTCAAAAAAAAAAAAAAAAAAAAAAAAAGAGTTCAAGGCCAGCCTGGCCAACATAGTGAAACTCTGTTTTTACCGAAAATACAAAAATTAGCCGGGCCTGGTGGCAGATGCCTGTAATCCCAACTACTCGGGAGGCTGAGGCAGGAGAATCGGTTGAACCCGGGAGGTAGAGTTTGCAGTGAACCGAGATCACACCATTGTACTCCAGCCTGGGCGACAAGAGTGAAAATCCTTCTCAAAAAAA","GGCTGGGCGCAGTGGCTCACACCTGTAATCCCAGCACTTAGGGAAGCTGAGGCGAGTAGATCACCTGAGGTCAGGAGTTAGAGACCAGCCTGGCCATCATGGTGAAACCCCGTCTCTACTAAAGATACCAAAAATTAGCTGAGTGTGGTGCTGGGTGCCTGTAATCCCAGAAACTCAGGGTGCCTGTAATCCCAGCAACTCAGGGTGCCTTTAATCCCAGCAACTGAGGGTACCAGTAATCCCAGCAACTCAGGGTGTCTTTAATCCTAGCAACTGAGGGCACCTGTAATCCCAGCAACTCAGGAAGCTGAGACAGGAGAAGTACTTGAACCCAGAAGGCAGAGGTTGCAGTGAGCCGATATTGCACCATTGCACTCCAGTCTGGGCAACAAGAGTGAAACTCTGTCTCAAAAAAAAA"
"chr1","173007773","173008678","JH378118","18053084","18053501","518","154954689","GGCCAGGCACAGTGGCTCATACTTGTAATCCCAGCACTTTGGGAGGCCAAGGTGGGTAGATCACCTGAGGTCAGGAGTTCAAGACCATCCTGGCCAACATGGTGAAACCCCGTCTCTACTAAAAATACAAAAAAAAATTGGCCCGGCCCGGTGGCTCACGCCTATAATCCCAGCACTTTGGGAGGCTGAGGCAGGCGGATCACCTGAGGTCAGGAGTTTGAGACCAGCCTGGCCAACATGGCGAAACCCCGTCTCTAGTAAAAATACAAAAAAATTAGTCTGGTGTGGTGGTGCCCACCTGTAATCCTAGCTACTTGGGAGGCTGAGGTGGAAGAATTGCTTGAACCCAGGAGGTGGAGGTTGCAGTGAGCCGATATCATGCCACTGCACTCTAGGCTGGGTTACAGAGTGAGACTCTGTCTCAAAAAAAAAAAAAAAAAAAAAAAAAAAAAAAAAAAAAAGGCCAGGTATGGTGGCTCATGCCTGTAATCCCAGAACTTTGGGAGGCCAAGATGGGCAGATCAGGAGGTCAAGAGATCAAGACCATCCTGGACAACATGATGAAACCATCTGTACTAAAAATACAAAAATTAGCTGAGCGTGGTGGTGCACACCTGTAGTCCCAGCTACTTGGGAGGCTGAAGCAGGAGAATCTCTTGAACCTGGGAGGCAGAGGTTGCAGTGAGCCAAGATCACACTCCAGTGACAGAGAGAGACTCCGTTTCAAAAAAAAAACCACAAAAAAATTAGCTGGGTATGGTTGCACATGCCTGTGATCCCAGCTACTTGTGGGGCTGAGGCAGGAGAACCGCTTAGATCCAGGAGGCCGAGGCTGCAGTGAGTTGAGATTGCACCATTGCACTCCAGCTTGGGGGACAAGAATGAAAACTCCGTCTCAAAAAAAAA","GGCTGGGCGCAGTGGCTCACACCTGTAATCCCAGCACTTAGGGAAGCTGAGGCGAGTAGATCACCTGAGGTCAGGAGTTAGAGACCAGCCTGGCCATCATGGTGAAACCCCGTCTCTACTAAAGATACCAAAAATTAGCTGAGTGTGGTGCTGGGTGCCTGTAATCCCAGAAACTCAGGGTGCCTGTAATCCCAGCAACTCAGGGTGCCTTTAATCCCAGCAACTGAGGGTACCAGTAATCCCAGCAACTCAGGGTGTCTTTAATCCTAGCAACTGAGGGCACCTGTAATCCCAGCAACTCAGGAAGCTGAGACAGGAGAAGTACTTGAACCCAGAAGGCAGAGGTTGCAGTGAGCCGATATTGCACCATTGCACTCCAGTCTGGGCAACAAGAGTGAAACTCTGTCTCAAAAAAAAA"
"chr1","173194937","173195564","JH378118","18053084","18053501","275","155141853","GGCCGGATGTGGTGGCTCACACCTGTAATCCCAGCACTTTGGGAGGCCAAGGCAGGCGGATCACCTGAGGTCAAGAGTTCAAGACCAGCCTGGCCAACATGGTGAAATCCCGTCTCTACTATAAATACAAAAATTGGCCAGGTGCAGTGGCTCATGCCTATAATCTCCTAGCACTTTAGGAGGCTGAGGCGGGTGGATCACGAGGTCAGGAGATCGAGACCATCCTGGCTAACATGGTGAAACCCTGTCTCTACTAAAAAAATACAAAAAATTAGCTGGGCATGGTGGCAGGCGCCTGTAGTCCCAGCTACTTGGGAGGCTGAGGCAGGAGAATGGCATGAATCTGGGAGGCGGAGCTTGCAGTGAGCTGACATTGCACCACTGCACTCCTGCCTGGGCAACAGAGCGAGACTCCGTCTCAATAAAAAAAAAAAAAAAAAAAAAAAAAAAATTAGCCAGGCGTGGTGGTGGGCACCTGTAATCCCAGCTACTCGGGAGGCTGAGGCAGGAGAATTGCTTAAACTTGGGAGGCGGAGGTTGCAGTGAGCTGAGATCGTACCATTGCACTCCAGCCCAGGCAACAAGAGCAAAACTATCTCAAAAAAAAAAAAAAAAAGAAAAAGAAAAA","GGCTGGGCGCAGTGGCTCACACCTGTAATCCCAGCACTTAGGGAAGCTGAGGCGAGTAGATCACCTGAGGTCAGGAGTTAGAGACCAGCCTGGCCATCATGGTGAAACCCCGTCTCTACTAAAGATACCAAAAATTAGCTGAGTGTGGTGCTGGGTGCCTGTAATCCCAGAAACTCAGGGTGCCTGTAATCCCAGCAACTCAGGGTGCCTTTAATCCCAGCAACTGAGGGTACCAGTAATCCCAGCAACTCAGGGTGTCTTTAATCCTAGCAACTGAGGGCACCTGTAATCCCAGCAACTCAGGAAGCTGAGACAGGAGAAGTACTTGAACCCAGAAGGCAGAGGTTGCAGTGAGCCGATATTGCACCATTGCACTCCAGTCTGGGCAACAAGAGTGAAACTCTGTCTCAAAAAAAAA"
"chr1","174752078","174752559","JH378118","18053084","18053501","158","156698994","ATTAAAAAAAAAAAAATTAGCTGGGCGTGGCCAGGCGCAGTGGCTCACGCCTGTAATCCCAGCACTTAGGGAGGCTGACGCGGGCGGATCACGAGGTTAGGAGATCGAGACCATCCTGGCTAACACAGTGAAACCCTGTCTCTACTAAAAATACAAAAAATTAGCCAGGCGTGGTGGCGGGCACCTGTAGTCCCAGCTACTCGGGAGGCTGAAGCAGGAGAATGGTGTGAACCCGGGAGGCGGAGCTTGCAGTGAGCTGAGATCGTGCCACTGCATTCCAGCCTGGGCGACAGAGCGAGACTCCGCCTCAAAAAAAAAAAAAAGCCAGGCGTGGTGGTGGCACCTGTAATCCCAGCTACTTGGGAGGCTGAGACAGGAGAATTGCTTGAACTCAGGAAGCAGAGGTTACAGTGAGCCGAGATCATGCCATCGCACTCCAGCCTGGGCAACAAGAGTGAAAATTCATCTTCAAAAAAAAAAAA","GGCTGGGCGCAGTGGCTCACACCTGTAATCCCAGCACTTAGGGAAGCTGAGGCGAGTAGATCACCTGAGGTCAGGAGTTAGAGACCAGCCTGGCCATCATGGTGAAACCCCGTCTCTACTAAAGATACCAAAAATTAGCTGAGTGTGGTGCTGGGTGCCTGTAATCCCAGAAACTCAGGGTGCCTGTAATCCCAGCAACTCAGGGTGCCTTTAATCCCAGCAACTGAGGGTACCAGTAATCCCAGCAACTCAGGGTGTCTTTAATCCTAGCAACTGAGGGCACCTGTAATCCCAGCAACTCAGGAAGCTGAGACAGGAGAAGTACTTGAACCCAGAAGGCAGAGGTTGCAGTGAGCCGATATTGCACCATTGCACTCCAGTCTGGGCAACAAGAGTGAAACTCTGTCTCAAAAAAAAA"
"chr1","175626129","175626760","JH378206","6546474","6546861","287","169079655","CCAAGCTCGGTGGTTCACACCTATAATCCCAGCATTTTGGGAGGCCAATGGAGGTGGATCACCTGAAGGTCAGGAGTTCGACACCAGCCTGGCCAACGTGGTCTTTACTAAAACCCCATCTTTACTAAAAATAGAAAAATTAGGCCGGGCACAATGGCTCACGCTTATAATCCCAGCACTTTGGGAGGCCGAGGCAGGTGGATCACCTGAGTTCAGGAGTTCAAGACCAGCCTGGCCAACATGGCGAAACCCTGTCCCTACTAAAAGTACAAAAATTAGCTGGGCGTGGTGGGGGGGCTCCTGTAATCCCCACTACTCAGGAGGCTGAAGCAGGAGAATAGCTTGAACCCGGGAGGCAGAGGTTACAGTGAGCCAAGATCGCACCACTGGACTCCAGCTTGGGCGACAAGAGCGAGACTCCGTCCCCCACCCCCCCAAAAAAAAAACAAATTAGATGAGCATGGTGATGGGCGCCTGTAATCCCTGCTACTTGGGAGGCAGAGGCAGGAGAATTGCTTGAACCCGGGAGGCGTTCAAGGTTGTGGTGAGCCAAGACCTCGCCATTGCACTCCAGCCTGGGCAACAAGAGCGAAACTCCGTCTCAAACAACAACAACAACAACAACAAAAGAA","GGCCACACATGGTGGCTAACGCCTGTAATCCCAGCACTTTGGGAGGCCAAGTCGGGTGGATCATGAGGTCAGGAGACCAAGACCATCCTGGCCAAATGGTGAAACCCCGTCTCTACTAAAAATACAAAAATTAGCTGGGCATGGTGGCGTGTGCCTGTAATCCCAGCTACTCAGGAGGCTGAGGCAGGACAATTGCCTGAACCCAGGAGAATTAGCTGGGCATGGTGGCGTGTGCCTGTAATCCCAGCTACTCAGGAGGCTGAGGCAGGACAATTGCCTGAACCCAGGAGGCGAAGGTTGCGGTGAGCCGAGATTGTGCCATTGCACTCCAGCCTGGGTAACAAGAGCGACACTCTGTCTCAAAAAAAAAAAAAAAAAAAAAAAAAAA"
"chr1","181497934","181498559","JH378118","18053084","18053501","271","163444850","GACCAGGTGAGGTGGCTCACGCCTGTAATCCCAGCACTTTGGGAGGCCGAGGCAGGTGGATCACCTGAGGTCAGGAGTTTGAGACCAGCCTGGCCAACATGGTGAAACCCTGTCTCTACTAAAAATATAAAAAATTAGCCGGGCGTGGCCGGGCATGGTGGCTCACGCCTGTAATCCCAGCATTTTGGGAGGCCGAGGTGGGCGGATCACAAGGTCAGGAGATCGAGACCATCCTGGCTAACACGGTGAAACCCTGTCTCTACTAAAAATACAAAAAATTAGCCGGGCGAGGTGGCGGGCGCCTGTAGTCCCAGCTACTCGGGAGGCTGAGGCAGGAGAATGGCGTGAACCCCAGGGGGCGGAGCCTGCAGTGAACCGAGATCGCGCCACTGCACTTCAGCCTGGGCAACAGCGAGACTGTCTGTCTCAAAAAAAAAAAAAAAAAAGAAAAACCAAAACAAAAATTAGCCGGGCGTGGTGGCAGTTGCCTGTAATCCCAGCTGAGGCAGAAGAACTGCTTGAATCCGGAGGCAGAGTCTGCAGTGAGCCGAGATCACACCATTGCACTCCACCCTGGGCAACAAGAGTGAAACTGTCTCAAAAAAAAAAAGAAAAGAAAAGAAAAA","GGCTGGGCGCAGTGGCTCACACCTGTAATCCCAGCACTTAGGGAAGCTGAGGCGAGTAGATCACCTGAGGTCAGGAGTTAGAGACCAGCCTGGCCATCATGGTGAAACCCCGTCTCTACTAAAGATACCAAAAATTAGCTGAGTGTGGTGCTGGGTGCCTGTAATCCCAGAAACTCAGGGTGCCTGTAATCCCAGCAACTCAGGGTGCCTTTAATCCCAGCAACTGAGGGTACCAGTAATCCCAGCAACTCAGGGTGTCTTTAATCCTAGCAACTGAGGGCACCTGTAATCCCAGCAACTCAGGAAGCTGAGACAGGAGAAGTACTTGAACCCAGAAGGCAGAGGTTGCAGTGAGCCGATATTGCACCATTGCACTCCAGTCTGGGCAACAAGAGTGAAACTCTGTCTCAAAAAAAAA"
"chr1","183570603","183570969","JH378106","31557967","31558303","76","152012636","GGCCAGGCACGGTGACTCACACCCATAATCCCAGCACTTTGGGAGGCTGAGGCGGGCGGATCACTTGAGGCAGGCAGATCACTTAAGGTCAGGAGTGCGAGACCAGCCTGGCCAACAATGGTGAAACCCTGTCTCTACTAAAAATACAAAAATTAACCAGGTGTGGTGGTGGGCACCTGTAATCCTAGCTGCTCAGGAGGCTGAGGCAGAAGAATCGCTTGAACCCAGGAGGTGGAGGTTGCAGTGAGCTGAGATCCTGCCATTGCACTCCAGCCTGGGCAACAAGAGCAAAACTCCATCACACACACACACACACACACACACCACACACACACACAGAAAAAAAAAAGAAAAAGAAAGAAAGAAA","GGCCGGGCGCGGTGGCTCAAGCCTGTAATCCCAGCACTTTGGGAGGCCGAGGCGGGTGGATCACAAGGTCAAGAGATCGAGACCAACCTGGTCAACATGGTGAAAGCCCGTCTCTACTAAAAATACAAAAATTAGCTGGGCATGGTGGCGCGTGCCTATAATCCCAGCTACTCAGGAGGCTGAGGCAGGAGAATTGCCTGAACCCAGGAGGTGGAGGTTGCAGTGAGCGAGATTGCGCCATTGCACTCCAGCCTGGGTAACAAGAGCGAAACTCCGTCTCACAAAACAAAACAAAACAAAACAAAACAAAACAAAACAAAAAACAAACAAAAAAAAA"
"chr1","184188699","184189314","JH378118","18053084","18053501","253","166135615","GGCCAGGCACGGTGGCTTAAGCCTGTAATCCCAGCACTTTGGGAGGCCAAGGCGGGTGGATCACTTGAAGTCAGGAGTTCGAGACCAGCCTGGCCAACATGGCAAAACCCCATCTCTACTAAAAATACAAAAAATTAGCTGGGCGTGTCCAGGCACGGTGGCTCATGCCTGTAATCCCAGCACTTTGGGAGGCCGAGGTGGGCGGATCATGAGATCAGGAGATCGAGACCATCCTGGCTAACATGGTGAAACCCCGTCTCTACTAAAAATATAAAAAATCAGCCGGGCGTGGTGGCGGGCGCCTGTAGTCCCAGCTACTTGGGAGGCTGAGGCAGGAGAATGGCATGAACATGGAAGGCAGAGCTTGCAGTGAGCCAAGAATGCACCCTGCACTCCAGCCTGGGCGACAGAGCAAGACTCCATCTGAAAAAAAATAAAAAAATAAAAAATTAGCCGGGCGTGGTGGCAGGTGCCTGTGATCCCAGCTACTCAGGAGGCTGAGGCAGGAGAATTGCTTGAACCCAGGTGGCGGAGGTTGCAGTGAGCCGAGATCGCACCATTGCACTCTAGCCTGGGCAACAAGAAAGAAACTCTGCCTCAAAAAAAAAAAAAAAAA","GGCTGGGCGCAGTGGCTCACACCTGTAATCCCAGCACTTAGGGAAGCTGAGGCGAGTAGATCACCTGAGGTCAGGAGTTAGAGACCAGCCTGGCCATCATGGTGAAACCCCGTCTCTACTAAAGATACCAAAAATTAGCTGAGTGTGGTGCTGGGTGCCTGTAATCCCAGAAACTCAGGGTGCCTGTAATCCCAGCAACTCAGGGTGCCTTTAATCCCAGCAACTGAGGGTACCAGTAATCCCAGCAACTCAGGGTGTCTTTAATCCTAGCAACTGAGGGCACCTGTAATCCCAGCAACTCAGGAAGCTGAGACAGGAGAAGTACTTGAACCCAGAAGGCAGAGGTTGCAGTGAGCCGATATTGCACCATTGCACTCCAGTCTGGGCAACAAGAGTGAAACTCTGTCTCAAAAAAAAA"
"chr1","186992586","186992936","JH378165","3784440","3784761","67","183208146","GCTGGGCGCGGTGGCTCACGCCTGTAATCCCAGCACTTTGGGAGGCCGAGGCAGGAGAATCACCTGAGGTCAGGAGTTCAAGACCAGCCTGGCCAACATGGTGAAACTAAAATACAAAATACACTAAAATCTACTAAAAATACAAAATACACTAAAATCTACTAAAAACACAAAATTAGCTGGGCATGGTGACATGCGCCTGTAATCCTAGCTACTGGGGAGGCTGAGGCAGGAGAATCGCTTGAACCCAGGAGGCAGAGGTTGCAGTGAGCCGAGATCGTGCCATTGCACTCCAGCCTGGGAGAGGAGACCAAAAATCCATCTCAAAAAAAAAAAAAAAAAGAAAAAGAA","GGCCGGGCGCGGTGGCTCAAGCCTGTAATCCCAGCACTTTGGGAGGCCGAGGCAGGTGGATCATGAGGTCAAGAGATCAAGACCATCCTGGTCAACATGGTGAAACCCCGTCTCTACTAAAAATACAAAAAAAAAAAAAAAAAAACTAGCTGGGCGTGGTGGCGCATGCCTGTAATCCCAGCTACTCAGGAGGCTGAGGCAGGAGAATTGCTTGAACCCAGGAGGCGGAGGTTGCGGTGAGCCCAGATCGCGCCATTGCACTCCAGCCTGGGTAACAAGAGCAAAACTCCATCTCAAAAAAAAAAAAAAAAAAAAAAAAAAA"
"chr1","187511118","187511436","JH378127","6203059","6203380","46","181308059","GCCGTGTGTGGTGGTCACGCCTGTAATCCCAGCATTTTGGGAGACCGAGGCAGGTGGATCATGAAGTCAGAGGTTTGAGACCATCCTGGCCAAGATGGTGAAACCCCGTCTCTACTAAAAATAGAAAAATTAGCCGGGTGTGGTGGCAGGTACCTGTAGTCCCAGCTACTTGGGAGGCTGAGACAGGAGAATTGCTGGAACCCAGGAGACAGAGGTTGCAGTGAGCCGAGATCACGCCATTGCACTCTGGCCTGGGCAACAAGAGCGAAACTCCTAAATAAATAAATAAATAAATAAATAAATGTAAACAAATAAAAAA","GGCCGGGCGCGGTGGCTCACGCCTGTAATCCCAGCATTTTGGGAGGCCGAGGCTGGTGGATCATGAAGTCAAGAGATCGAGACCATCCTGGTCAACATGGTGAAACCCCGTCTCTACTAAAAATACAAAAAAATTAGCTGGGCATGGTGGCGCGTGCCTGTAATCCCAGCTACTCAGGAGGCTGAGACAGGAGAATTGCCTGAACCCGGGAGGCGGAGGTTGCGGTGAGCCGAGATCGTGCCATTGCACTCCAGCCTGGGTAACAAGAGCGAAACTCCGTCTCAAAAAAATAAATAAATAAATAAATAAATAAATAAACAAA"
"chr1","188019163","188019798","JH378118","18053084","18053501","272","169966079","GGCTGGGCAAGGCGGCTCATGCCTGTAATCCCAGCACTTTGGGAGGCTGAGGTGGGTGGATTACCTGAGGTCAGGAGTTCGAGAACAGCCTGGCCAACATGGTGAAACCCCATCTCTACTAAAAATAAAAAAAAAAATGAGCTGCAGCTGGGCGCAGTGGCTCACATCTGTAATCCAAGCACTTTGGGAAGCTGAGGCAGGTGGATCACGAGGTCAGGAGATCGAGACCATCCTAGCTAACATGGTGAAACCCCATCTCTACTAAAAATACAAAAAAAAAAAAAAAAAATTAGCCGGGCGTGGTGGCAGGCGCCTGTAGTCTCAGCTACTCAGGAGGCTGAGGCAGGAGAATGGCGTGAACCCGGGAGGCAGAGCTTGCAGTGAGCCGAGATCGTGCCACTGCACTCCAGCCTGGGTGACTGAGCAAGACTCCATCTCAAAAAAAAAAAAAAAAAATTAGCTGGGCATGGTGGCAGGTGCCTGTAATCCCCAGGTACTTGGGAGGCTGAGGCAGGAGAATAGCTTGAACCTGGGAAGTGGAGGTTGCAGTGAGCCGAGATTGCACCATTGCACTCCAGCCTGGGCGACAAGAGTGAAACTCTGTCCCAGAAAAGAAAAGAAGAAAGAAAAGAAAAA","GGCTGGGCGCAGTGGCTCACACCTGTAATCCCAGCACTTAGGGAAGCTGAGGCGAGTAGATCACCTGAGGTCAGGAGTTAGAGACCAGCCTGGCCATCATGGTGAAACCCCGTCTCTACTAAAGATACCAAAAATTAGCTGAGTGTGGTGCTGGGTGCCTGTAATCCCAGAAACTCAGGGTGCCTGTAATCCCAGCAACTCAGGGTGCCTTTAATCCCAGCAACTGAGGGTACCAGTAATCCCAGCAACTCAGGGTGTCTTTAATCCTAGCAACTGAGGGCACCTGTAATCCCAGCAACTCAGGAAGCTGAGACAGGAGAAGTACTTGAACCCAGAAGGCAGAGGTTGCAGTGAGCCGATATTGCACCATTGCACTCCAGTCTGGGCAACAAGAGTGAAACTCTGTCTCAAAAAAAAA"
"chr1","188775161","188775747","JH378118","18053084","18053501","234","170722077","GGCCGGGCGTGGTGGCTCATGCCTGTAATCCCAGCACTTTGGGAGGCTGAGGCAGGTGGATCACCTGAGGTCAGGAGTTCGAGACCAGCCTGGCCAACATGGTGAAACCCCATCTCTACTAAAAATACAAAACAGGCCAGGCACGGTGGCTCACGCCTATAATTCCAGCACTTTGGGAGGCCGAGGCAGGCGGATCACAAGGTCAGGAGATCGAGACCACAGTGAAACCCCATCTCTACTAAAAATACAAAAAATTAGCTGGGTGCGGTGGCGGGCGCCTGTAGTCCCAGATACTTGGGAGGCTGAGGCAGGAGAATGGTGTGAACCCGGCAGGCGGAGCTTGCAGTGAGCCTAGATCGCGCCACTGCACTCCAGCCTGGGCGACAGAGCGAGACTCCATCTCAAAAAAAAAACAAAACAATTAGCCGATCATGGTGGTAGACCCCTGTAATCCCAGCTGTTTGAGAGGCTGAGGCAGGAGAATTGCTTGAACCCTGGAGGCAGAGGTTGCAGTGAGCCAAGATCGTGCCATTGCACTCCAGCCTGGGCGACAAGAGCAAAACTCCATCTTAAATAAATAAATAAAA","GGCTGGGCGCAGTGGCTCACACCTGTAATCCCAGCACTTAGGGAAGCTGAGGCGAGTAGATCACCTGAGGTCAGGAGTTAGAGACCAGCCTGGCCATCATGGTGAAACCCCGTCTCTACTAAAGATACCAAAAATTAGCTGAGTGTGGTGCTGGGTGCCTGTAATCCCAGAAACTCAGGGTGCCTGTAATCCCAGCAACTCAGGGTGCCTTTAATCCCAGCAACTGAGGGTACCAGTAATCCCAGCAACTCAGGGTGTCTTTAATCCTAGCAACTGAGGGCACCTGTAATCCCAGCAACTCAGGAAGCTGAGACAGGAGAAGTACTTGAACCCAGAAGGCAGAGGTTGCAGTGAGCCGATATTGCACCATTGCACTCCAGTCTGGGCAACAAGAGTGAAACTCTGTCTCAAAAAAAAA"
"chr1","190017176","190017808","JH378118","18053084","18053501","276","171964092","GGCTGGGCAAGGTGGCTCACGCCTGTAATCCCAGCACTTTTGGAAGCTGAGATGGGCAGGTCACCTGAGGTCAGGAGTTCGAGACTAGCCTGGCCAACGTGGTGAAACCCTGTCTCTACTAAAAATATAAAAATTGGCTAGGCACAGTGGCTCACCCCTGTAATCCCAGCACTTTGGGAGGCCAAAGTGGGCGGATCACCTGAGGTCAGAAGTTTGAGACCAGCCTGCCCAACATGGTAAAACCTGTCTCTACCAAAAAATACAAAAATTAGCAAGGCGTGGTGGCATGCGCCTGTAGTCCCAGCTACTTGGGAGGCTGAGGCAGGAGAATCGCTTGAACGCAGGAGGCGGAAGTTGCAGTAAGCTGAGATTGGTCCACTGCACTCCAGCCTGGGCGACAGAGCCAGACTTTGTCTCAAAAAATAAAATAAAATAAATATAAAAATACAAAAATTAGCCAGGCATAGTGGCAGGTGCCTGTAATCCTAGCTACTTGGGAGGCTGAAGCAGGAGAATTGCTTGAACCCTGGAGGCTGAGGTTGCAGTAAGCCAAGACCGTGCTGTTGCACTCCAGCCCAGATGGGCAACAAGAGTGAAACTTGGTCTCAAAAAAAAAAAAAAAAAAAAAAAAAA","GGCTGGGCGCAGTGGCTCACACCTGTAATCCCAGCACTTAGGGAAGCTGAGGCGAGTAGATCACCTGAGGTCAGGAGTTAGAGACCAGCCTGGCCATCATGGTGAAACCCCGTCTCTACTAAAGATACCAAAAATTAGCTGAGTGTGGTGCTGGGTGCCTGTAATCCCAGAAACTCAGGGTGCCTGTAATCCCAGCAACTCAGGGTGCCTTTAATCCCAGCAACTGAGGGTACCAGTAATCCCAGCAACTCAGGGTGTCTTTAATCCTAGCAACTGAGGGCACCTGTAATCCCAGCAACTCAGGAAGCTGAGACAGGAGAAGTACTTGAACCCAGAAGGCAGAGGTTGCAGTGAGCCGATATTGCACCATTGCACTCCAGTCTGGGCAACAAGAGTGAAACTCTGTCTCAAAAAAAAA"
"chr1","190026338","190026960","JH378118","18053084","18053501","270","171973254","GGCTGAGCGCGGTGGCTCATGCCTATAATCCCAGCACTTTGGGAGGCCGAGGTGGGCGGATCACGAGATCAGGAGTTCAAGACCAGGCTGGGCAACATGACGAAATTCCGTCTCTACTAAAAATATAAAAATTAGGCCAGGCACAGTGGCTTATGCCTGTAATCCCAGCACTTTGGGAGGCTGAGGCAGGCGGATCACAAGGTCAGGAGATCAAGACCATCCTGGCTAACACGGTGAAACCCCATCTCTACTAAAAATACAAAAAAAATTAGCTGGGCATGGTAGTGTGCACCTATAGTCCCAGCTACTCGGGAGGCTGAGGCAGGAGAACCGCTTGAACCCGGGAGGCAGAGGTTGCAGTTAGCCGAGATCACACCACTGCACTCCAGCCTGGGCGAGACTCCATCTCAAAACAAAACAAAACAAAAAACCCCAAAAAAACAGAACTTAGCTGAGCATGGTGGCAGGCACCTGTAATCCCTGCTACTTGGGAAGCTGAGGCAGGAGAATCAGTTGAACCCAGGAGGTGGAGATTGCAGTGAGCCGAGATCGCGACATTGCACTCCATGCACTCCAGTCTGGGCAACAAGAGCAAGACTCTGTCCCCCCCCCCCAAAAAAAAA","GGCTGGGCGCAGTGGCTCACACCTGTAATCCCAGCACTTAGGGAAGCTGAGGCGAGTAGATCACCTGAGGTCAGGAGTTAGAGACCAGCCTGGCCATCATGGTGAAACCCCGTCTCTACTAAAGATACCAAAAATTAGCTGAGTGTGGTGCTGGGTGCCTGTAATCCCAGAAACTCAGGGTGCCTGTAATCCCAGCAACTCAGGGTGCCTTTAATCCCAGCAACTGAGGGTACCAGTAATCCCAGCAACTCAGGGTGTCTTTAATCCTAGCAACTGAGGGCACCTGTAATCCCAGCAACTCAGGAAGCTGAGACAGGAGAAGTACTTGAACCCAGAAGGCAGAGGTTGCAGTGAGCCGATATTGCACCATTGCACTCCAGTCTGGGCAACAAGAGTGAAACTCTGTCTCAAAAAAAAA"
"chr1","192874688","192875272","JH378118","18053084","18053501","247","174821604","GGTATGGTGGCTCACGCCTGTAATCCCAGCACTTTGGGAGGCCGAGGCAGGTGCATCACCTGAGGTCAGGGTTCAAGACCAGCTTGGCCAACATGGTGAAACTCCATCTCAATTAAAAATACAAAATTAGCCAGGTGTGGCGGCTAATGCCTGTAATTCCAGCATTTTGGGAGGCCACGGTGGGTGGATCACGAGTTCAAGAGATTGAGACCATCATGGGAACATGGTGAAACCCTGTCTCTACTAAAAATATAAAAATTAGCTGGGCATGGTGACACACGCCTGTAGGCCCAGCTACTCAGGAGGCTGAGGCAGGAGAATCGCTTGAACCTGAGAGGTGGAGGCTGCAGTGAAGCGAGATAATGCACTGCCCTCCAGCCTGGCAACAGAGCGAGACTCCATCTCAAAACAAACAAAATTATTTGGGTGTGGTGGCATGTGCCTGTGATCCTAGTTACTTGGGAGGCTGAGGCAGGAGCACTGCTTGAACCTGGGTGGCAGAGGTTGCAGCGAGCCAAGATTGTGCCATTGCACTCCAGCCTGGGCAACAAGAGCGGAAACTCCATCTCAAAAAAAAAAAAAAAA","GGCTGGGCGCAGTGGCTCACACCTGTAATCCCAGCACTTAGGGAAGCTGAGGCGAGTAGATCACCTGAGGTCAGGAGTTAGAGACCAGCCTGGCCATCATGGTGAAACCCCGTCTCTACTAAAGATACCAAAAATTAGCTGAGTGTGGTGCTGGGTGCCTGTAATCCCAGAAACTCAGGGTGCCTGTAATCCCAGCAACTCAGGGTGCCTTTAATCCCAGCAACTGAGGGTACCAGTAATCCCAGCAACTCAGGGTGTCTTTAATCCTAGCAACTGAGGGCACCTGTAATCCCAGCAACTCAGGAAGCTGAGACAGGAGAAGTACTTGAACCCAGAAGGCAGAGGTTGCAGTGAGCCGATATTGCACCATTGCACTCCAGTCTGGGCAACAAGAGTGAAACTCTGTCTCAAAAAAAAA"
"chr1","195228795","195229692","JH378118","18053084","18053501","518","177175711","GCACTGTGGCTCACACCTGTAATCCTAGCACTTTGAGAGACTGAGGTGGGCAGATCACCTGAGGTCAAGAGCTCAAGACCGGGCCAGGCGTGGTGGCCCACTCCTGTAATCCCAGCACTTTGGGAGGCCGAGGTGGGCGGATCACTTGAGGTCGGGAGTTCGAGACCAGCCCGACCAACATGGAGAAACAAACCCCCTCTCTACTAAAAATACAAAATTAGCCGGGCGAATCCCAGCTACTGGGGAGGCTGAGGCAGGAGAATCACTTGAACCCAGGAGGTGGAGGTTGCGGTGAGCCAAGACCGCGCCATTGCACTCCAGCCTGGGCAAGAAGAGTGAAACTCCGTCTCAAAAAAAAAAAAGAGTTCGAGTTCGAGACTAGCCTGGCCAACATGGTGAAACCTCATCTCTACTAAAAAAAAATACACAAAGGCCGGGCGTGGTGGCTCACACCTGTAATCCCAGCACTTTGGGAGGCCAAGGTGGGTGGATCACAAGGTCAGGAGTTTGAGACCAGCCTGGTCAATATGGTGAAAGCCCGTCTCTACTAAAAATACAAAAATTAGCAAGGTGCGGTGGCAGGCGCCTGTAATCCCAGCTACTTGGGAGGCTGAGGCAGGAGAATTGCTTGAACCCAGGAGGCAGAGGTTGCAGTAAGCTGAGATCATGCCACTGCACTCAACCTGGGTGACAGAGCAAGACTCCCATCTGGGGGAAAAAAAAAATTAGCTGGGTGTGGTAGCAGGTGCCTGTAATCCCAGCTACTCGGGAGGCTGAGGCAGGAGAATCGCTTGAATCCAGGAGGCAGAGATTGCTGTGAGCCAAGATCGCAGCCATTGCATTCCAGCCTGGGCAAGAGAGCAAAAAAATTCCGTCTCAAAAAAAATAAAATAAAAGA","GGCTGGGCGCAGTGGCTCACACCTGTAATCCCAGCACTTAGGGAAGCTGAGGCGAGTAGATCACCTGAGGTCAGGAGTTAGAGACCAGCCTGGCCATCATGGTGAAACCCCGTCTCTACTAAAGATACCAAAAATTAGCTGAGTGTGGTGCTGGGTGCCTGTAATCCCAGAAACTCAGGGTGCCTGTAATCCCAGCAACTCAGGGTGCCTTTAATCCCAGCAACTGAGGGTACCAGTAATCCCAGCAACTCAGGGTGTCTTTAATCCTAGCAACTGAGGGCACCTGTAATCCCAGCAACTCAGGAAGCTGAGACAGGAGAAGTACTTGAACCCAGAAGGCAGAGGTTGCAGTGAGCCGATATTGCACCATTGCACTCCAGTCTGGGCAACAAGAGTGAAACTCTGTCTCAAAAAAAAA"
"chr1","195474230","195474552","JH378114","40692658","40692994","108","154781572","GCCGGGTGTGGTGGCAGGCACCTGTAATCCCAGCTACTTAGCAGGCTGAGGCAGAAGAATCACTTGAACCCAGGAGGTGGAGGTTGCAGTGAGCCGAGATAGCACCATTGCACTCCAGCCTGGGTGACAAGAGCGAAACTCCATATTAAAAAAAAAAAAAAAAAAAAAAAAAAAAAAGAAAGATAAATATTTAAGGGGATGGATATCCCAATTATCCTGATTCAATCTTTACACATTACACGAATATATCAAATTATCATATGCACCCCGAAAATATGTACATCTATTACGTATAAATAAAAAAAAAATAAAAGGGAAAAAAA","GCTGGGCGTGGTGGCACGTGCCTGTAATCCCAGCTACTCAGGAGGCTGAGGCAGGAGAATTGCCTGAACCCAGGAGGTGGAGGTTGCAGTGAGCCGAGATTGCGCCATTGCACTCCAGCCTGGGTAACAAGAGTGAAACTCTGTCTAAAAAAAAAAAAAAAAAAAAAAAATACAAAAAAGTAGCTGGGCGTGGTGGCACGTGCCTGTAATCCCAGCTACTCAGGAGGCTGAGGCAGGAGAATTGCCTGAACCCAGGAGGTGGAGGTTGCAGTGAGCCGAGATTGCGCCATTGCACTCCAGCCTGGGTAACAAGAGTGAAACTCTGTCTAAAAAAAAA"
"chr1","196992416","196992958","JH378119","32351107","32351490","210","164641309","GCCGGGCACGGTGGCTCACTCCTGTAATCCCAGCACTTTGGGAGGCCGAGGCTGGTGGATCACCTGAGGTCAGGAGTTCGAGAACAGCCTGGCCAACATGGTGAAACCCCATCTCTACTTTAAAAAAAAAAAAAAAAAAAAAAAGACCGGGCACGGTGGCTCACGCTTGTAATCCCAGCACTTTGGGAGGCCGAGGCGGGTGGATCACGAGGTCAGGAGATCGAGACCAACATGTGAAACCGCGTCTCTACTAAAAATACAAAAATTAGCCAGGCGTGGTGGCGCATGCCTTTAATCCCAGGTACTCAGGAGGCTGAGGCAAGAGAATTGCTTGAATCCGGGAAGCGGAGGTTGCATTGATCCGAGATCGTGCCATTGCACTCCAGCCTGGGTGACACAGCTATACTCTGTCTCAAACAAAAAAAAACAAACAATAAAAATTAGCTGTGCTGGAGGCTAAGGCGGAGCTTGCAGTGAGCCGACATCATGCAGTTGTACTCCAGCCCGGGGGACAAGAGCAAGACTCCATCTTAAAAAAAAAAA","GGCCAGGTATGGTGGCTCACACCTGTAATCCCAGCACTTTGGGAGGCCAAGGCAGGCAGACCACCTGAGGTCAGGAGTTCGAGATCAGCCTAGCCAACATGGTGAAACCCCATCTCTAGTAAAAATAAAATTAGCCAGGCATGGTGGTGCATGCCTGTAACGCAGGTCAGGAGTTCGAGATCAGCTTAGCCAACATGGTGAAACCCCATCTCTAGTAAAAATAAAATTAGCCAGGCAGGTGGTGCCGCCTGTACTCGGGAGGCTGAGGCAGGAGAATCACTTGAACCCAAGAGGCAGAGGTTGCAGTCAGCCAAGATCATGCCATTGCACTCCAGCCTAAGCAAAAAGAGTAAAACTCAGTCTCAAAACAAAAAAACAAAAAAA"
"chr1","199416486","199417104","JH378118","18053084","18053501","263","181363402","GGCCAGGCACGGTGGCTCATGCCTGTAATCCCAGCACTTTGGGAAGCTGAGGCGGGTGGATCACCTAAGATCAGGAGTTTGAGACCAGCCTGGCCAACATGGTGAAACCCTGTCTCCATTAAAAATACAAAAAATTGGCTGGCTGTGGTGGCTCACGCCTGTAATCCCAGCACTTTGGGAGGCCGGGGCGGGTGGATCACAAGGTCAGAAGATTGAGACCATCCTGGCTAACACGGTGAAACCCCGTCTCTACTAAAAATACAAAAAATTAGCCGGGTGTGGTGGCGGGCGCCTGTAGTCCCAGCTACTCAGGAGGCTGAGGCGGGAGAATGGCGTGAACCCAGGAGGTGGAGCTTGTGGTGAGCCGAGATCGCACCAGTGCACTCCAGCCTGGGCAACAGAGCGAGACTCCGTCTCAAAAAAAAAAAAAAGAAAAGAAAATTGGCCGTGTGTGGTGGCGGGTGCCTGTAATCCTAGCTACTAGGGAGCTGAGGCAGGAGAATCACTTGAACCTGGGAGGCAGAGGTTGCAGTGAGCCAAGACTGTGCCATTGCACTCCAGCTTGGGCAACAAGAGCGAACTCCGTCTCAAAAAAATAATAATAGATAATAAAGTAAAA","GGCTGGGCGCAGTGGCTCACACCTGTAATCCCAGCACTTAGGGAAGCTGAGGCGAGTAGATCACCTGAGGTCAGGAGTTAGAGACCAGCCTGGCCATCATGGTGAAACCCCGTCTCTACTAAAGATACCAAAAATTAGCTGAGTGTGGTGCTGGGTGCCTGTAATCCCAGAAACTCAGGGTGCCTGTAATCCCAGCAACTCAGGGTGCCTTTAATCCCAGCAACTGAGGGTACCAGTAATCCCAGCAACTCAGGGTGTCTTTAATCCTAGCAACTGAGGGCACCTGTAATCCCAGCAACTCAGGAAGCTGAGACAGGAGAAGTACTTGAACCCAGAAGGCAGAGGTTGCAGTGAGCCGATATTGCACCATTGCACTCCAGTCTGGGCAACAAGAGTGAAACTCTGTCTCAAAAAAAAA"
"chr1","199456779","199457414","JH378206","6546474","6546861","290","192910305","TGGCTCACGCCTGGCTCCTCACTTTGGGAGGCTGAGGCAGGCAGATCACCTGAGGTCAGGAGTTCGAGACCAGCCTGGCTAACATGGTGAAACCCCGTTTCTACTAAAAATACAAAAAATTAGCTGGGGCCAGGTGCGGTGTCTCACGCCTGTAATCCTAGAACTTTGGGAGTTTGAGGCGGGTAGATCACAAGGTCAGGAGTTCAAGACCAGCCTAACCAAGATGGTGAAACCCTGCCTCTACTAAAAATACAAAAATTAGCCGGGTACAGTGGCAGATGCCTGTGATCCCAGCTACTCGGGAGTCTGAGGCAGAAGAATCACTTGAACCCAGGTGGCAGAGGTTTCAGTGAGCCGAGATCGCGCCACTGCACTCCAACCTGGGTAACATAGTGAGACTCCATCTCCAAAAAGTAAAAAATAAAAAAGCCAGGCATGGTGGCACACACCTGTAATCCCAGCTACTCAGGAGTCTGAGGCAGGAGAATTGCTCAAACCTGGCAAATGAGCCTGTGGTGTATTCAGTGTTGAAGCCTGGGAGATTGCAGTGAGTCGAGATTGCGCCATTGCACTCCAGCCTGGGCAACAAGAGCAAAACTCCGTCTTAAAGAAAGAAAGAAATATAAGAAATAAGAA","GGCCACACATGGTGGCTAACGCCTGTAATCCCAGCACTTTGGGAGGCCAAGTCGGGTGGATCATGAGGTCAGGAGACCAAGACCATCCTGGCCAAATGGTGAAACCCCGTCTCTACTAAAAATACAAAAATTAGCTGGGCATGGTGGCGTGTGCCTGTAATCCCAGCTACTCAGGAGGCTGAGGCAGGACAATTGCCTGAACCCAGGAGAATTAGCTGGGCATGGTGGCGTGTGCCTGTAATCCCAGCTACTCAGGAGGCTGAGGCAGGACAATTGCCTGAACCCAGGAGGCGAAGGTTGCGGTGAGCCGAGATTGTGCCATTGCACTCCAGCCTGGGTAACAAGAGCGACACTCTGTCTCAAAAAAAAAAAAAAAAAAAAAAAAAAA"
"chr1","199495820","199496417","JH378118","18053084","18053501","241","181442736","GCCAGGCACGGTGGCTGACACTTGTAATCCCAGCACTTTGGGAGGCTGAGGCAGATGGATCACCTGAGGTCAAGAGTTCGAGACCAGCCTGGCCAACATAGTGAAACCCTGTCTCTACTTTAAAAAAAATACAGGCCAGGCGTGGTGGCTCGTGCCTGTAATCCCAGCACTTTGGGAGGCCGAGGCGGGCAGATCACGAGGTCAGAAGATCAAGACCATCCTGGCTAACATGGTGAAACCCCGTTTCTACTAAAAAAAAATAAAGTCAGCTGGGCGTGGTGGCGGGTGCCTGTAGTCCCAGCTACTCTGGAGGCTGAGGCAGGAGAATGGCATGAACACGGGAGGCGGAGCTTGCAGTGAGTCAAGATGCGCCACTGCACTCCAGCCTGGGCAATAGAGTGAGACTCCGTCTCAAAAAAAAAAAAAAAAAAATCAGTTGCATGTGGTGGCAGGCACCTGTAACCCCAGCTACTAGGGAGGCTGAGGCAGGAGAATTGCTTGAACCCGGAAAGCAGAGGTTGCAGTGAGCCGAGATCACACCATTGCACTCCAGCCTGGGCAACAAGAGTGAAACTCCATCTCAAAAAAAAAGAGAAAA","GGCTGGGCGCAGTGGCTCACACCTGTAATCCCAGCACTTAGGGAAGCTGAGGCGAGTAGATCACCTGAGGTCAGGAGTTAGAGACCAGCCTGGCCATCATGGTGAAACCCCGTCTCTACTAAAGATACCAAAAATTAGCTGAGTGTGGTGCTGGGTGCCTGTAATCCCAGAAACTCAGGGTGCCTGTAATCCCAGCAACTCAGGGTGCCTTTAATCCCAGCAACTGAGGGTACCAGTAATCCCAGCAACTCAGGGTGTCTTTAATCCTAGCAACTGAGGGCACCTGTAATCCCAGCAACTCAGGAAGCTGAGACAGGAGAAGTACTTGAACCCAGAAGGCAGAGGTTGCAGTGAGCCGATATTGCACCATTGCACTCCAGTCTGGGCAACAAGAGTGAAACTCTGTCTCAAAAAAAAA"
"chr1","200674943","200675551","JH378118","18053084","18053501","253","182621859","GGCTGGGCGTGGTGGATCACACCTGTAATCCCAACACTTTGGGAGGCCAAGGCGGTTGGATCACCTGAGGTCAGGAGTTTGTGACCAGCCTGGCCAACAAGGTGAAACCTTGTCTCTACTAAAAATACAAAAAATTGGCCAGGCACAGTGGCTCACGCCAGTAATCCCAGCACTTTGGGAGGCCGAGGTGGGCGGATCACAAGGTCAGGAGATTGAGACCATCCTGGCTAACATGGTGAAACCCTGTCTCTACTAAAAATACAAAAAAATTAGCCAGGCATGGTGGCGGGCGCCTGTAGTCCCAGCTACTCGGGAGGCTGAGGCAGGAGAATGGCGTGAACCTGGGAGGCAGAGCTTGCAGTGAGCCGAGGTGGCGCCACTGCACTCCAGCCTGGGCAACAGAGTGAGACTCCATCTCAAGAAAAAAAAAAAAATTTGCTGGGTGTGGTGGCACACGCCTGTAGTCCCAGCTACTCGGGAGGCTGAGGCAGGAGAATCACTTGAACCCAGAGGCGAAGTCTGCAGGGAGGGACCCGAGATCTCGCCATTGCACTCCAGCCTAGGCAACAAGAGCAAAACTGTCTCAAAAACACAAAAATTAAAAAAAAA","GGCTGGGCGCAGTGGCTCACACCTGTAATCCCAGCACTTAGGGAAGCTGAGGCGAGTAGATCACCTGAGGTCAGGAGTTAGAGACCAGCCTGGCCATCATGGTGAAACCCCGTCTCTACTAAAGATACCAAAAATTAGCTGAGTGTGGTGCTGGGTGCCTGTAATCCCAGAAACTCAGGGTGCCTGTAATCCCAGCAACTCAGGGTGCCTTTAATCCCAGCAACTGAGGGTACCAGTAATCCCAGCAACTCAGGGTGTCTTTAATCCTAGCAACTGAGGGCACCTGTAATCCCAGCAACTCAGGAAGCTGAGACAGGAGAAGTACTTGAACCCAGAAGGCAGAGGTTGCAGTGAGCCGATATTGCACCATTGCACTCCAGTCTGGGCAACAAGAGTGAAACTCTGTCTCAAAAAAAAA"
"chr1","201767179","201767808","JH378118","18053084","18053501","279","183714095","GGCTAGGCACAGTGGTTCATGCCTGTAATCCCAACACTTTGGGAGGCCAAGGTGGGCAGATCACGTGAGGTCAGGAGCTCAAGACCAGCCTGGCCAACATGATAAAACCCCATTTCTACTAAAAATACAAAAATTAGCCAGGCGCAGTGGCTCATGCCTGTAATCCCAGCACTCTGGGAGGCCAAAGTGGGCAGATCACAAGGTCAGGCATTCGAGACCAACCTGGCCAACACAGTGAAACCCCGTCTCTACTAAAAATACAAAAATTAGCCGGGTGTGGTGGTGGGCACCTGTAATCCCAGCTACTTGGGAGTCTGAGGCAGGAGAATTGCTTGAACTCAGGGGGCAGAGGTTGTAGTGAGCCGAGATCACGCCATTGCACTTCAGCCCAGGTGACAGTGCGAGATTCCGTCTCAAAAAACAAAAATACCCCCAAAAATTAGCCAGATGTGGTGGCACAAGCTTGTAATCCCAGCTACTTCGGAGGATGAGGTAGGAGAATCACTTGAACTTGGGAGGTGGAGATTGCAGTGAGCCGAGATCGTGCCATTGCACTCCAATCTGGGCAACAAAAGCAAAACTCCATCTCGAAAAAAAAAAAAAAAAAAAAAAAAAAAAAAAAAAAAAAAA","GGCTGGGCGCAGTGGCTCACACCTGTAATCCCAGCACTTAGGGAAGCTGAGGCGAGTAGATCACCTGAGGTCAGGAGTTAGAGACCAGCCTGGCCATCATGGTGAAACCCCGTCTCTACTAAAGATACCAAAAATTAGCTGAGTGTGGTGCTGGGTGCCTGTAATCCCAGAAACTCAGGGTGCCTGTAATCCCAGCAACTCAGGGTGCCTTTAATCCCAGCAACTGAGGGTACCAGTAATCCCAGCAACTCAGGGTGTCTTTAATCCTAGCAACTGAGGGCACCTGTAATCCCAGCAACTCAGGAAGCTGAGACAGGAGAAGTACTTGAACCCAGAAGGCAGAGGTTGCAGTGAGCCGATATTGCACCATTGCACTCCAGTCTGGGCAACAAGAGTGAAACTCTGTCTCAAAAAAAAA"
"chr1","203292939","203293505","JH378206","6546474","6546861","235","196746465","CCAGCACTTTGGGAGGCTGAGGTGGGTGGATCGCCTGAGGTCAGAAGTTCAAGACTAGCCTGGCCAACATGGTGAAACCTCGTCTCTACTAAAAATACAAAAAATTGTCCAGGTGCGGTGGCTCACGCCTGTAATCCCAGCACTTTGGGAGGCCAAGGCGGGCGGATCAAGAGGTCAAGAGATTGAGACCATCCTGGTCAACACAGTGAAACCTCGTCTCTACTAAAAATACAAAAATCAGCCGGGCATGGTGGTGTGTGCCTGTTGTCCCAGCTCCTCAGGAGGCTAAGACAGGAGAGTCGCTTGAACCCAGGAGGTGGAGGTTGCAGTGAGCCGAGATCACGCCACTGCACTCCAGCCTGGTGACAGAGTCAGACTTCGTCTCAAAAAAAAAAAAAATAGCTGGGCATGTGGCGGGCGCCTGTAATCCCAGCTGCTAGGGAGGCTGAGGCAGGAGAATCACTTGAACCCGGGAGGCAGAGGTTGCGGTGAGCCGAGATCGCGCCATTGCACTCCAGTCTGGGCAACAAGAGCGAAACTCCGTATCAAAAGAACAAAAAAACAAAA","GGCCACACATGGTGGCTAACGCCTGTAATCCCAGCACTTTGGGAGGCCAAGTCGGGTGGATCATGAGGTCAGGAGACCAAGACCATCCTGGCCAAATGGTGAAACCCCGTCTCTACTAAAAATACAAAAATTAGCTGGGCATGGTGGCGTGTGCCTGTAATCCCAGCTACTCAGGAGGCTGAGGCAGGACAATTGCCTGAACCCAGGAGAATTAGCTGGGCATGGTGGCGTGTGCCTGTAATCCCAGCTACTCAGGAGGCTGAGGCAGGACAATTGCCTGAACCCAGGAGGCGAAGGTTGCGGTGAGCCGAGATTGTGCCATTGCACTCCAGCCTGGGTAACAAGAGCGACACTCTGTCTCAAAAAAAAAAAAAAAAAAAAAAAAAAA"
"chr1","203462899","203463216","JH378254","873499","873817","52","202589400","CCTGGCTCTGTGGCTCACGCCTATAATCCCAGCACTTTGAGGGGCCAAAGAGGGCGGATCACCTGAGGTCAGGAGTTCAAGACCAGCCTGGCCAACATGGTGAAACACTGTCTCTACTAAAAATACAAAAAAAAAAAAAAAAAAAAAAAAAATTGCTGGGCATGGTGGCGAGCACCCGTAATCTCAGCTACTTGGAAGGCTGAGGCAGGAGAATCGCTTGAATGGGGAAGGCAGAGGTTGCAGTGAGCCGAGATTGCACCACTGCACTCCAGCCTGGGTGACAAGAGTGAAAGTCTGTTTCAAAAAAAGAAAAAGAAA","GGCCGGGCGAGGTGGCTCAAGCCTGTAATCCCAGCACTTTGGGAGGCCGAGGCGGGTGGTTCATGAGGTCAAGAGATCGAGACCATCCTGGTCAACATGGTGAAACCCCGTCTCTACTAAAAATACAAAAAAAAAAAAAAAAAAAAAAAAAGTTAGCTGGGCATGGTGGCGCTTGCCTGTAATCCCAGCTACTCAGGAGGCTGAGGCAGGAGAATTGCCTGAACCCAGGAGGCGGAGGTTGCGGTGAGCCGAGATTGCGCCATTGCACTCCAGCCTGGGTAACAAGAGTGAAACTCCGTCTCAAAAAAAAAAAAGAAAA"
"chr1","204202275","204202874","JH378118","18053084","18053501","262","186149191","GGCGCACACCTGTAATCCCAGCACTTTGGGAGGCCAAGGCGGGTGGATCACCTGAGGTCAAGAGTTTGAGACCAGCCTGGCCAATATGGTGAAACCCTGTCTCCACTAACAATAGAAAAATTGCTGGGCACAGTGGCTCACGCCTGTAATCCCAACGCTTTGGGAGGCCAGGGTGGGCAGATCGCCTGAGGTCAGGAGTTCGAGACCAGCTTGGCCGAAATGGTGAAACCCCATCTCTACTAAAAATACAAAAATTAGCTGGGTGTGGTGGTGCGCACCTGTAATCCCAACTACTTGGGAGGCTGAGGCAGGAGAATTGCTTGAACCCAGGAGTCGGAGGTTGCAGTGAGCCAAGATCACGCCACTGTACTCCAGCCTGGTGACAGAGTGAGACTCCCTCTCAAAAAAAAAAAAAAAAAAGAAAAGAAAAATTAGCTGGGTGTGGTGGCACACACCTGTAACCCCAGCTACTCAGGAGGCTGAGGCAGGGGAATCACTTGAACACAGGAGGCAGAGGTTGCAGTGAGCTGAGTGCGTGCCATTGCACTCCAGCCTGGGCGACAAGAGCAAACTCTGTCTCCAAAAAAAAAAGAAAGAAAA","GGCTGGGCGCAGTGGCTCACACCTGTAATCCCAGCACTTAGGGAAGCTGAGGCGAGTAGATCACCTGAGGTCAGGAGTTAGAGACCAGCCTGGCCATCATGGTGAAACCCCGTCTCTACTAAAGATACCAAAAATTAGCTGAGTGTGGTGCTGGGTGCCTGTAATCCCAGAAACTCAGGGTGCCTGTAATCCCAGCAACTCAGGGTGCCTTTAATCCCAGCAACTGAGGGTACCAGTAATCCCAGCAACTCAGGGTGTCTTTAATCCTAGCAACTGAGGGCACCTGTAATCCCAGCAACTCAGGAAGCTGAGACAGGAGAAGTACTTGAACCCAGAAGGCAGAGGTTGCAGTGAGCCGATATTGCACCATTGCACTCCAGTCTGGGCAACAAGAGTGAAACTCTGTCTCAAAAAAAAA"
"chr1","206701474","206702117","JH378118","18053084","18053501","268","188648390","GGCCGTGCGTGGTGGCTCACACCTGTAATCCCAGCACTTTGGGAGGACGAGGTGGGCAGATCACCTGAGGTCAGGAGTTCGAGACCAGCCTGGCCAACATGGTGAAACCCCGTCTCTACTAAAAATACAAAAAATTAGTCGGCTGTGGCCGGGCACGGTGGCTTACGCCTGTAGTAATCCCAGCACTTTTGGAGGCCGAGGTGGGCGGATCACGAGGTCAGGAGATTGAGACCATCCTGGCTAACACAGTGAAACCCTGTCTCAACTAAAAATACAAAAAATTAGCCAAGCGTGGTGGCGGGCAGCTGTAGTCCCAGCTACTCAGGAGGCTGAGGTAGGAGAATGGCGTGAACCCAGAAGGTGGAGCTTGCAGTGAGCCGAGATCGCGCCACTGCACTCCAGCCTGGGCGACAGAGCGAGACTCCAGCCTGGGTGACAAAGCGAGACTCTGTCTAAAAAAAAGAAAAAATTTGCCTGGTGTTGTGGCAAATGCCTGTAATCCCAGCTACTTGGGAGGCTGAGACAGGGGCAGGAGAATCGCTTGAACCCAGGAGGCAGAGCTTGCAGTGAGCCGAGATTGCGCCATTGCACTCCAGCCTGGGCAACAAGAGTGAAAGTCCATCTCAAAAAAAACAACAAAAAAA","GGCTGGGCGCAGTGGCTCACACCTGTAATCCCAGCACTTAGGGAAGCTGAGGCGAGTAGATCACCTGAGGTCAGGAGTTAGAGACCAGCCTGGCCATCATGGTGAAACCCCGTCTCTACTAAAGATACCAAAAATTAGCTGAGTGTGGTGCTGGGTGCCTGTAATCCCAGAAACTCAGGGTGCCTGTAATCCCAGCAACTCAGGGTGCCTTTAATCCCAGCAACTGAGGGTACCAGTAATCCCAGCAACTCAGGGTGTCTTTAATCCTAGCAACTGAGGGCACCTGTAATCCCAGCAACTCAGGAAGCTGAGACAGGAGAAGTACTTGAACCCAGAAGGCAGAGGTTGCAGTGAGCCGATATTGCACCATTGCACTCCAGTCTGGGCAACAAGAGTGAAACTCTGTCTCAAAAAAAAA"
"chr1","208492325","208492635","JH378114","37034914","37035209","58","171457411","GTAATCCTAGCACCTTGGGAGGCCGAGGTGGGCGGATCACTTGAGGTCAGAAGTTCGAGACCAGTCTGGCTAACATGGCAAAACCCCGCCTCTACTAAAAAATACAAAAATTAGCTGGGTATGGTGGTGCGTGCCTATAATCCCAGTTACTCCGAAGGCTGAGGTAGGAGAATTGCTTGAACCCAGGAGGCGGAGGTTGCAGTGAGCCAAGATTGCGCCATTGCATTCCAGCCTGGGTGACAACAGTGAAACTCCATCTCAAAAATAAATAAATAAATAAATAAATAATAGTAAAGAAAAGAACAAAAGAA","AATTTCAGCACTTTGGGAGGCTGAGATGGGTGGATCAGTTGAGGTCAGGAGTTCGAGAGCAGTCTGGCCAACATGGTGAAACCCCATCTCTACTAAAAATACAAAAATTAGCTGGGTATGGTGGTGGGTGCCTGTAATCCCAGCTACTCAGGAGGCTGAGGCAGGAGAATTGTTTGAACCCAGGAGATGGAGGTTGCAGTGAGCCGAGATTGTGGCGTTCCACTCCAGCCTGAGCAACAAGAGTGAAACTCCAACAAAAAGCAAAAAACAAAAAACAAAACAAAACAAAACAAAAC"
"chr1","208562159","208562495","JH378262","266823","267148","58","208295336","GGCCTGGCGTGATGGCTCATGCCTGTAATCCCAGCACTTTGGGTGGCTGAGGCAGGTGGATCACCTGAGGTCAGGAGTTCGAGGCCAGCCTGGCCAACATGGTGAAGCCCTGTCTCTACTAAAAAATCCAAAAATTAGCCAGGCATGGTGGCGGGTGCCTGTAATCTCAGCTACTCGGGAGACTGAGGCAGAAGAATTACTGGCACTTGGGAGGCAGAGGTTGCAGTGAGCCGATATCGCACCATTGCACTCAGCCCTGGCCAACAACAGTGAGACTCCATCTCAAAACACACACACACACACACACACACACACAAAAACAAAAAAAAACAAAAAA","GGCCGGGCGCGGTGGCTCAAGCCTGTAATCCCAGCACTTTGGGAGGCCGAGGCGGGTAGATCATGAGGTCAGGAGTTTGAGACCAGCCTGGCCAACATGGTGAAACCCCGTCTCTACTAAAAATACAAAAATTAGCCGGGCATGGTGGCCTGTGCCTGTAATCCTAGCTACCCAGGAAGCTGAGGCAGGAGAATTGCCTGAACCCAGGAGGCGGAGGTTGCGGTGAGCCGAGATCGTGCCATTGCACTCCAGCCTGGGTAACAAGAGCGAAACTCCGTCTCAAAAACAAACAAACAAACAAACAAAAACAAAAAACAAAAAACAAA"
"chr1","211033593","211033923","JH378198","5062782","5063109","50","205970811","GGCTGGGCACGGTGGCTCACAGCTATAATCCCAGCACTTTGGGAGGCCAAGGTGGGCGGATCACCTGAGGTCAGGAGTTCAAGACCAGCCTGGCTAACATGGTGAAACCCCATCTCTACTAAAAATATAAAAATTAGCTCGGCGTGGTAGCAGGCACCTGTAGTCCCAGCTACTCAGGAGGCTGAGGCAGAAGAATCGCTTGAAGCCGGGAGGTGGAGGTTGCAGTGAGCCGAGATCGCACCATTGCAGCCCGGGAGACAAGAGCGAGACCCCGTCTCAAAATAAATAAATAAATAAATAAATATTTTAAAAAATAAATGAAAAATAAAAA","GCCAGGCATGGTGGCTCACGCCTATAATCTCAGCACTTTGGGAGGCTGAGGCAGGCAGATCACTTGAGGTCAGGAGTTCAAGACCAGCCTGGCCAACATGGTGAAACCCTGGCTCTACTAAAAATACAAAAATTAGCCGGGTGTGGTGGCACGTGCCTATAATCCCAGCTACTCAGGAGGCTGAGGCAGAAGAATCGCTTGAATCCAGGAGGTGGAGGTTGCAGCGAGCCGAGATCACACCATTGGACTCCAGCCTGGGTGACAAGAGCGAAACTCCATCTCAAAATAAATAAATAAATACATAAAATTAAAAATAAATAAATAAATA"
"chr1","211471806","211472412","JH378206","6546474","6546861","267","204925332","GTGGCTCACGCCTGTAATCCCAACACTTTAGGAGGCTGAGGTGGGTGGATCACCTGAGATCAGTAGTTCGAGACCAACCTGGTCAGTATGGTGAAACCCCGTCTCTGTTAAAAACACAAAAAATGGCCAGGATCAGTGACTTATGCTTGTAATCCCAGCACTTTGGGAGGCCGAGGCAGGCAGATCACCTGAGGTCAGGAGTTCGAGACCAGCTTGGCCAACATGGGGGAAAAAACCCCGTCTCTACTAGAAATACAAAAAAATTAGCCAGGCGTGGTGGCAGGTGCCTGTAATCCCAGCTACTCAGGAGAGAATCGTTTGAACCCGGGAGGTAGAGGTTGCAGTGAGCCAAGATCGCGCCATCGCACTCCAGCCTGAGGAACAAGAGCAAGACTTTGTCTCCAAAAAAAAAAAACCCACAAAAAAATTAGCTGCGCGTGGTGGCCGGCACCTGTAGTCCCAGCTACTCGGGAGACTGAGGCAGGAGAATCATTTGAACCCAGGAGGCGGAAGCTGCAGTGAGCCGAGATCGTGCCATTGCATTCTAGCCTAGGCAGCGAGTGAAACTCCGTCTCAAAAAACAAAAAAAAAAAGCAAAGGAAAGAAA","GGCCACACATGGTGGCTAACGCCTGTAATCCCAGCACTTTGGGAGGCCAAGTCGGGTGGATCATGAGGTCAGGAGACCAAGACCATCCTGGCCAAATGGTGAAACCCCGTCTCTACTAAAAATACAAAAATTAGCTGGGCATGGTGGCGTGTGCCTGTAATCCCAGCTACTCAGGAGGCTGAGGCAGGACAATTGCCTGAACCCAGGAGAATTAGCTGGGCATGGTGGCGTGTGCCTGTAATCCCAGCTACTCAGGAGGCTGAGGCAGGACAATTGCCTGAACCCAGGAGGCGAAGGTTGCGGTGAGCCGAGATTGTGCCATTGCACTCCAGCCTGGGTAACAAGAGCGACACTCTGTCTCAAAAAAAAAAAAAAAAAAAAAAAAAAA"
"chr1","212217607","212218222","JH378118","18053084","18053501","263","194164523","GGCCAGGCGCGGTGGCTCACGCCTGTAATCCCAGCACTTTGGGAGGCCGAGGAGGGTGGATGACCTGAGGTCAGGAGTTCGAGACCAGCCTGGCCAATGTGGTGAAACCCCATCTCTACTAAGAATACAATAATTAGGCTGTGCACAGTGGCTCATGTCTATAATCCCAGCCCTCTGGGAGGCCAAGGCAGGTGGATCTCCTGAGGTCAGGAGTTTGAGACCAGCCTGACAAACATGGAGAAACCCTGTCTCTACTAAAAATACAACATTAGCCGGGCATGGTGGCACATGCCTGTAGTCCCAGCTACTTGGGAGGCTGAGGAAGGAGAATCGCTTGAACCCGGGAGGTGGAGGTTGCAATGAGCGGAGATCGTGCCATGGCACTCCAGCCTGGGCAACAAGAGCAAAATTCCATCTAAAAAAAAAAAAAAAAAAATTAGCCAGGCGTGGTGGCGCAGGCCTGTAATCCCAGCTATGCGGGAGGCTGAGGGAGGAGAATTGCTTGAACCTGGGAGGTGGAGGTTGCAGTGGGCCAAGATGGCGCCATTGCATTCCAGCCTGGGCAGCAAGAGTGAAAGTCTGTCTCAGAAAAAAAAAAAAAAGAAAGAAAAAGAGA","GGCTGGGCGCAGTGGCTCACACCTGTAATCCCAGCACTTAGGGAAGCTGAGGCGAGTAGATCACCTGAGGTCAGGAGTTAGAGACCAGCCTGGCCATCATGGTGAAACCCCGTCTCTACTAAAGATACCAAAAATTAGCTGAGTGTGGTGCTGGGTGCCTGTAATCCCAGAAACTCAGGGTGCCTGTAATCCCAGCAACTCAGGGTGCCTTTAATCCCAGCAACTGAGGGTACCAGTAATCCCAGCAACTCAGGGTGTCTTTAATCCTAGCAACTGAGGGCACCTGTAATCCCAGCAACTCAGGAAGCTGAGACAGGAGAAGTACTTGAACCCAGAAGGCAGAGGTTGCAGTGAGCCGATATTGCACCATTGCACTCCAGTCTGGGCAACAAGAGTGAAACTCTGTCTCAAAAAAAAA"
"chr1","213897531","213898074","JH378206","6546474","6546861","196","207351057","AGGAGATCAAGACCATCCTGGCCAACATGGTGAAACCCCTTCTGTACTACAAATACAAAAATCAGGCCGGGCGTGGTGGCTCGCACCTGTAATCCCAGCACTTTGGGAGGCGGAGGCAGGCGGATCACAAGGTCAGGAGATCAAGACCATCCTGGCCAACATGGTGAAACCCCGTCTCTACTAAAAATACAAAAAATTAGCTGGGTGTGGTGGCAGGTGCCTGTAATCCCAGCTACTTGGGAGGCTGAGGCAGGAGAATCGCTTGAACCTGGGAGGCAGAGGTGGCAGTGAGCTGAGATCGCGCCATTGCACTCCAGCCTGGGCAAAAAGAGTGAAATTCCGTTTCAAAAAAAAAAAAAAAAAAATAGCCATGTGTGGTGGTGGGTGCCTATAGCCCCAGCTACTCGGGAGGCTGAGGCAGGAGAGTCACTTGAACCTAGGAGGCAGAGGTTGCAGTGAGCCGAGATTGCCCCACTGCACTCCAGCCTGGGCGACAAGAGCAAAAACTCCGTCTCAAAAAAAACAAAAAGAAAAGAAAAGAAAA","GGCCACACATGGTGGCTAACGCCTGTAATCCCAGCACTTTGGGAGGCCAAGTCGGGTGGATCATGAGGTCAGGAGACCAAGACCATCCTGGCCAAATGGTGAAACCCCGTCTCTACTAAAAATACAAAAATTAGCTGGGCATGGTGGCGTGTGCCTGTAATCCCAGCTACTCAGGAGGCTGAGGCAGGACAATTGCCTGAACCCAGGAGAATTAGCTGGGCATGGTGGCGTGTGCCTGTAATCCCAGCTACTCAGGAGGCTGAGGCAGGACAATTGCCTGAACCCAGGAGGCGAAGGTTGCGGTGAGCCGAGATTGTGCCATTGCACTCCAGCCTGGGTAACAAGAGCGACACTCTGTCTCAAAAAAAAAAAAAAAAAAAAAAAAAAA"
"chr1","214894403","214895001","JH378118","18053084","18053501","247","196841319","GGCTGGGCACAGTGGCTCACACCTGTAATCTCTGCACTTTGGGAGGCCAAGGTAGGTGGATCACCTGAGGTCAGGAGTTTGAGACCAGGCTGGCCAATGTGGTGAAATCCCATCTCTACTAAAAATACAAAATTAGGCCAGGTGCAGTGGCTCATGCCTGTAATCCCAGCACTTTGGCAGGGGAAGGCAGGTGGATCATGAGGTCAGGAGTTCAAGACCAGCCTGGCCAAGATGGTGAAACCCTGTCTCTACTAAAAATACACAAAAATTAGCTGGGCATGGTGGCCAGTGCCTGTAATCCCAGCTACTCAGGAGGCTGAGGCAGAGAATTGGTTGAACTCAGGAGGTGGAGGTTGCAGTGAGCCGAGATCATGCCACTGCAGTCCAGCCTGGGTGACAGAGCAAGACTTCATCTAAAAAAAAAAAAAAAAAAAAAATTAGCCGGGCGTGGTAGCACACGCTTGTGATCCCAGCTATTCGGGAGGCTGAGGCAAGAGAAAGGCTTGAATCTGGGAGGCGGAGGTTGCAGTGAGCTGAGATTGAGCCATTGCACTCCAGCCTGGGCGACAAGAGCAAAACTCCATCTAAAAGAAAAAAAA","GGCTGGGCGCAGTGGCTCACACCTGTAATCCCAGCACTTAGGGAAGCTGAGGCGAGTAGATCACCTGAGGTCAGGAGTTAGAGACCAGCCTGGCCATCATGGTGAAACCCCGTCTCTACTAAAGATACCAAAAATTAGCTGAGTGTGGTGCTGGGTGCCTGTAATCCCAGAAACTCAGGGTGCCTGTAATCCCAGCAACTCAGGGTGCCTTTAATCCCAGCAACTGAGGGTACCAGTAATCCCAGCAACTCAGGGTGTCTTTAATCCTAGCAACTGAGGGCACCTGTAATCCCAGCAACTCAGGAAGCTGAGACAGGAGAAGTACTTGAACCCAGAAGGCAGAGGTTGCAGTGAGCCGATATTGCACCATTGCACTCCAGTCTGGGCAACAAGAGTGAAACTCTGTCTCAAAAAAAAA"
"chr1","218644909","218645481","JH378114","15957391","15957789","255","202687518","GCTGGGCGTGGTAGCTCATGCCTGTAATCCCAGCACTTTGAGAGGCCCAGGCAGGCAGATCACCTGAGGTCAGGAGTTCAAGACCAGCCTGGCCAACATGGTGAAACTCCGTTTCTGGCCGGGCGCGGTGGCTCACGCCTGTAATCCCAGCACTTTGGGAGGCAGAGGTGGGTGGATCATGAGGTCAGGAGATCGAGACCATCCTGGCTAACACGGTGAAACCCCGTCTGTACTAAAAAACCAAAAAATTAGCCCAGCGCAGTGGCGGGCGCCTGTAGTCCCAGCTACTCGGGAGGCTGAGGCCAGAGAATCGCTTGAACCCGGGAGGCGGAGCTTGCAGTGAGCCGAGATCGCGCCACTGCACTCCAGCCTGGGGGACAGAGCGAGATTCCGTCTCAAAAAAAAAAAAAAAAGAAAAAGAAGCCCCGTTTCTACTAAAAATACAAAAATTAGCCAGGCGTGGTGGCAGGCGCCTGTAATCCCAGCTACTCGGGAGGCTGAGGCAGAAGAATTGCTTGAACCCGGGAGGCAGAGGTTGCAGTGAGCCGAGATCATGCCATTGCACTCCAGCCT","GCAAGGAACGGTGGCTCATGCCTGTCATCCCAGCACTTTGGGAGGCTAAGGAGGGTGGATTACCGAAGGTCATGAGTTTGAGACCAGCCTGACCAACATGGTGAAAACCCCATCTCTACTAAAAATACAAAAAATTAGCCAGATACAGCTATGCGGCAGACTGGGGCAGGAGAATCGCTTGGACCCAAACCCCATCTCTACTAAAAATACAAAAAATTAGCCGGATACAGCTATGCGGGAGACTGGGGCAGGAGAATCGCTTGGACCCGGGAGGCAGAGATTGCAGTGAGATGAGACCATGCCATTGCTCTCTAGCTTGTGCGATGAGAACAAGACTCTGTCTCAAAAAAAAAAAAAAAAAAAAAAAAAAAAAAAAAAAAAAAAGAGAGAGAGAGAAAA"
"chr1","219020590","219021210","JH378118","18053084","18053501","273","200967506","GGCTAGGTGCAGTGGCTCCTGCCTGTAATCGCAGCACTTTGGGAGGCTGAGGTGGGCGGATCACCTGAGGCCAGGAGTTCGAGACCAGCCTGGCCAACATGGCAAAACCCCATCTCTACTAAAAATAAAAATAAAAATAAAAAATAAAAATTAAAATTAAAATATGGCCAGGCACAGTGTCATGCCTGTAATCCCAGCACTTTGGGAGGCCTAGGCAGGTGGATCACCTGAGGTCAGGGGTTCACGACCAGGCTGGCCAACAGGTGAAACCCCATCTCTACTAAAAATACAAAAAATTAGCTGAGCGTGGTGGCGGGCACCTGTAATCCCAGCTACTCAGGAGGCTGAGGCAGGAGAATTGCTTAAACTCAGGAAGTAGAGGTGCAGTGAGCCAAGATCATGCCATTGCACTCCAGCCTGGGCAACAAGAGCGAAACTCTGTCTCCAAAAAAAAAAAAAAAAAAATTTGCCATTCCTGGTGGTGGGCACTTGTAATCCCAGCTAGTTGGGAGACTGAGGCAGGAGAATTGCCTCAGTGAGCCGAGATCATGCCATTGCACTCCAGCCTGAGCAACAAGAGCGAAGCTTCATCTCAAAAAAAAAAAAAAAAAAAAAATAGAA","GGCTGGGCGCAGTGGCTCACACCTGTAATCCCAGCACTTAGGGAAGCTGAGGCGAGTAGATCACCTGAGGTCAGGAGTTAGAGACCAGCCTGGCCATCATGGTGAAACCCCGTCTCTACTAAAGATACCAAAAATTAGCTGAGTGTGGTGCTGGGTGCCTGTAATCCCAGAAACTCAGGGTGCCTGTAATCCCAGCAACTCAGGGTGCCTTTAATCCCAGCAACTGAGGGTACCAGTAATCCCAGCAACTCAGGGTGTCTTTAATCCTAGCAACTGAGGGCACCTGTAATCCCAGCAACTCAGGAAGCTGAGACAGGAGAAGTACTTGAACCCAGAAGGCAGAGGTTGCAGTGAGCCGATATTGCACCATTGCACTCCAGTCTGGGCAACAAGAGTGAAACTCTGTCTCAAAAAAAAA"
"chr1","219087040","219087347","JH378108","34510794","34511096","65","184576246","GGGCTGGGTGGTTCACGCTTGTAATCCCAGCACTTTGGGAGGGTGAGGCAGGCGGAGGATCACTTGCGCTCAGGAGTTCAAGACTAGCCTGGCAACATGGTGAAACCCTGTCTTTATTTAAAAAAAAAAAAAAAAAAAAAAAAAAAAAAAAAAAAGCTGGGTGCGGTGGTGTGCACTTGTGGTCTCAGCTACTCCAGAGGCTGAGGCAGGAGAATGAAGGACTTGAGCCCAGGAGGCGGAGGTTGCAGTGAGCTGAGATGGCACCATTGCAGTCCAGCTTGGGTGACAGGAGTGACCCTGTCTCAAAA","GGGTGCCGTGTCTCATGCCTGTAATTCCAGCACTTTGGGAGGTCAAGGCAGTCCGATCACCTGAGGTCAGGAGTTTGAGACTAGCCTGGCCAAAATGGTGAAACCCTGTCTCTAGAAAAAATACAAAAAAAAAAAAAAAAAAAAAAAAAAATTAGCTGGATGTAGTGGTGCATACCTGTAGTCCCAGCTACTCTGGAGGCTGAGGCAGGAGAATTGTTTGAACCCAGGAGGCGGAGGTTGCGGTGAGCCGAGATCATGCCATTGCACTCCAGCCTGGGAAACAAGAGTGAAACTCTGTCTCAA"
"chr1","222270991","222271618","JH378118","18053084","18053501","273","204217907","GGCCAGGGGCTGTGGCTCAAGCCTGTAATCCCAGCACTTTGGGAAGCCAAGGCAGGTGGATCATGAGGTCAAGAGATAGAGACCATCCTGGCCAACATGATGAAACCCCATCTCTACTAAAAATACAAAAATTAGCTGGGCGTGGGCCAGGCGTGGTGGCTCATACCTGTAATCCCAGCACTTTGGGAGGCCCAGGTGGGCGGATCACGAGGTCAGGAGATGGAGACCATCCTGGCTAACACGGTGAAACCCCATCTCCACTAAAAATACAAAAAAATTAGCTGGGCGTCGTGGCAGTCGCCTGTAGTCCCAGTGACTTGGGAGGCTGAGGCAGGAGAATGGCGTGAACCCGGGAGGCGGAGCTTGCAGTGAGTCAAGATCCCACCATTGCACTCCAGCCTGGGTGACAGAGCGAGACTTGGTCTCAAAAAAAAAAAGAAAAAAAAATTAGCTGGGCGTGGTGGCGGGTGCCTGTAATCCCAGTTACTTGGGAAGCTGAGGCAGGAGAATCGCTTGAACCTGGGAGGCGGAGGTTGCAGTGAGCCGAGATTGTGCCATTGCACTCCAGCCTGGGTAACAAGAGCAAAACTCCCATCTCCAAAAAAAAAAAAAAAGCAAAACAAAGAAA","GGCTGGGCGCAGTGGCTCACACCTGTAATCCCAGCACTTAGGGAAGCTGAGGCGAGTAGATCACCTGAGGTCAGGAGTTAGAGACCAGCCTGGCCATCATGGTGAAACCCCGTCTCTACTAAAGATACCAAAAATTAGCTGAGTGTGGTGCTGGGTGCCTGTAATCCCAGAAACTCAGGGTGCCTGTAATCCCAGCAACTCAGGGTGCCTTTAATCCCAGCAACTGAGGGTACCAGTAATCCCAGCAACTCAGGGTGTCTTTAATCCTAGCAACTGAGGGCACCTGTAATCCCAGCAACTCAGGAAGCTGAGACAGGAGAAGTACTTGAACCCAGAAGGCAGAGGTTGCAGTGAGCCGATATTGCACCATTGCACTCCAGTCTGGGCAACAAGAGTGAAACTCTGTCTCAAAAAAAAA"
"chr1","222872679","222873086","JH378300","1232743","1233088","114","221639936","CCAGCCTGGCCAATATGGTGAAACTCCCTCTCTACTAAAAATACAAAAATTAGCCAGGCATGGTGGTGCACGCCTGTAGGCCCAGCTACTCAGGAGGCTGAGGCAGGAGAATCACTTGAACCCAGGAGGTGGAGGTTGAAGTGAGCCGAGATCTCGCCATTGCACTCCAGCCTGGGCAACAAGAACAAAACTCCCTCTCAAAACAAAACAAAACAAAACAAAAACTAGCTGGGTGTGGTATCAAGCACCTGTAATCCCAGCTACCCAGGAGGCTGAAGCAGGAGAATCACTTGCACCTGGGAGGCAGAGGTTGCAGAGAGCCAAGATTGTGCCACTGAACTCCAACCTGGGTGACAGAGCGAGACTCCATCTCAAAAATAAATAAATAAACATAAAAATAAAATAAAA","GCTGAGTGTGGCGGCTGGTGCCTGTAATCCCAGCTACTTTGGAGGCTGAGGTAGGAGAATCACTTGAACCCAGGAGGCAGAGGTTGCAGTGAGCCAAGATTGTGCCATAGCATTCCAGCCTGGGCAACAAGAGTGACACTCTATCTCAAAAAAAAACAAAAAACAAAAATTTGCTGGGTGTTGTGGCGGGCGCCTTGTAATCCCAGCTACTCAGGAGGCTGAGGCAGGAGAATCACTCAAACTTGGGAGGCAGAGGTTGCAGTGAGTCAAGATGGCACCATTGCACTCCAGCCTGGGTGACAAGAGCAAAACTCCGTCCCAAAATAAATAAATAAATAAATAAATA"
"chr1","227111344","227111659","JH378271","2122362","2122678","60","224988982","GGCTGGGGACGGTGGCTCACGCCTGGAATCTCAGTGAGGCCAAGGTGGGTGGATCACCTGAGGTCAGGAGTTCCAGACCAGCCTGGCCAACATGGTGAAACCCCATCTCTCCTAAAAAAAAAAAAAAAAAAAAAAAAAAAAAAAAATTAGCTGGCCGTGGTCCGTGGTGGCAGGTGCCTGTAATCCCAGGTACTCAGGAGGCTGAGGCAGGAGAATCACTTAAACCCGCAAAGTGGAGGTTGCACTGAGCCGAGACGACACGATTGCACTGCAGCATGGGCAAAAAGAGTCAAACTCCCTCTCAAAAAAAAAAAAA","GGCCGGGCACGGTGGCTCACACCTGTAATCCCAGCACTTTGGGAGGCTGAGGTGGGTGAATCACCTGAGGTCAGGAGTTTGAGACCAGCCTGACCAACATGATGAAACCCGGTCTCTGCTAAAAATACAAAAAAAAAAAAAAAAAAAAAAAAAAAAAGCTGGGCATGATGGTGGGCACCTGTAATCCCAGCTACTCGGGAGGCTGAGGCAGGAGAATCGCTTGAACACCAGGAGGTGGAGGTTGCTATGAGCCGAGATCGCACCATTGCACTCTAGCTTGGGCAACAAGAGAGAAACTCCATCAAAAAAAAAAAAAA"
"chr1","227185965","227186583","JH378118","18053084","18053501","266","209132881","GGCCAGGCACGGTGGCTCACGTCTGTAATACCAGCACTTTGGGAGGCCGAGGCGGGTGGATCACCTGAGGCCAGGAGTTCGAGACAAGCCTAGCCAATATGGCAAAACCCCGTCTCTACTAAAAACACAAAAATTAGGCTGGGCGCGGTGGCTCACGCCTGTAATCCCAGCACTTTGGGAGGCCGAGGCAGGCAGATCACCAGGTCAGGAGATCCAGATCATCCTGGCTAACACGGTGAAACCCTGTCTCTACTAAAAAATATAAAAATTAGCTGGGCTTGGTGTCGGGCGCCTGTAGTACCAGCTACTCCGGAGGCTAAGGCAGGAGAATGGCGTGAACCTGGGAGGCGGAGCTTGCAGTGAGCCAAGATCGCGCCACTGCACTCCAGCTTGGGCGACAGAGCAAGGCTCCATCTCAAAAAAAAAAAACCATACAAAAATTAGCTGGGCGTGGTGGTGGGCACCTATAACCTCAGCTACTTGGGAGGCTGAGGCAGGAGGATCGCTTGAACCCAGGAGGCGGAGATTGCAGTGAGCCGAAATCACACCATTGCACTCCAGCCTGGACAACAAGAGCGAGACTCCATCTTAAAAACACACAAAAAAACAACAAAAAAAA","GGCTGGGCGCAGTGGCTCACACCTGTAATCCCAGCACTTAGGGAAGCTGAGGCGAGTAGATCACCTGAGGTCAGGAGTTAGAGACCAGCCTGGCCATCATGGTGAAACCCCGTCTCTACTAAAGATACCAAAAATTAGCTGAGTGTGGTGCTGGGTGCCTGTAATCCCAGAAACTCAGGGTGCCTGTAATCCCAGCAACTCAGGGTGCCTTTAATCCCAGCAACTGAGGGTACCAGTAATCCCAGCAACTCAGGGTGTCTTTAATCCTAGCAACTGAGGGCACCTGTAATCCCAGCAACTCAGGAAGCTGAGACAGGAGAAGTACTTGAACCCAGAAGGCAGAGGTTGCAGTGAGCCGATATTGCACCATTGCACTCCAGTCTGGGCAACAAGAGTGAAACTCTGTCTCAAAAAAAAA"
"chr3","3583213","3584011","JH378118","18053084","18053501","437","14469871","CTGGGGGCGGTGGCTCATGCCTGTAATCCCAGCAATTTGGAAATCTGAGGCAGATGAATCACTTAAAGGGAGGAGACCACCCCTCATATTGTCCTAGGCCCAATTTCTGCCTCAAAGAAAAGGTAGGAGTTAAAGAAAAGACAGAAGTGAAATCAGCCGTCAGACAGCCCGGCGCTGCCTTCCATGCCTGATAGTTAAAGATCGACCCTTGACCTAACAGGTTATGTTATCTATAGATTCCACACATTGTATGGAAAAGCATTGTGAAAATCCCTGTCCTGCTCTGTTCTGTTCCGATTACCGGTGCATGAAGCCCCCAGTCACATACCCCCTGCTTGCTCAATCGATCACAACCCTCTCACGCGGACCCCCTTAGAATTGTAAGCTCTTAAAAGGGACAGGAATTGCTCACTTGGGAAGCTCGGTTTTTGAGACGTGAGTCTTGTTGACGCACCCGGCCGAATAAAGCCCTTCCTTCTTTAACTCAGTGTCTGAGGGGTTTTGTCTGCGGCTCATCCTGCTACAACTTGAGATCAGGAGTTTGAGACCAGCCTGGCCAACATGGTAAAACCTTGTCTCTACTTGAAAAAATACAAAATTTAGGGTAAAACCCTGTCTCTACTTGAAAAAATACAAAATTTAGCTGGGCGTGGTGGCAGGCACCTGTAATCCCAGCTACTTGGGAGGCTGAGGCAGAAGAATCGCTTGAACGCGAGAGAGGGAGTTTGCAGTGAGCCGAGATTATGCCACTGCACTCCAGCCTGGGAGACAAGAGCTAGACACTGTCAACAAAACAAAA","GGCTGGGCGCAGTGGCTCACACCTGTAATCCCAGCACTTAGGGAAGCTGAGGCGAGTAGATCACCTGAGGTCAGGAGTTAGAGACCAGCCTGGCCATCATGGTGAAACCCCGTCTCTACTAAAGATACCAAAAATTAGCTGAGTGTGGTGCTGGGTGCCTGTAATCCCAGAAACTCAGGGTGCCTGTAATCCCAGCAACTCAGGGTGCCTTTAATCCCAGCAACTGAGGGTACCAGTAATCCCAGCAACTCAGGGTGTCTTTAATCCTAGCAACTGAGGGCACCTGTAATCCCAGCAACTCAGGAAGCTGAGACAGGAGAAGTACTTGAACCCAGAAGGCAGAGGTTGCAGTGAGCCGATATTGCACCATTGCACTCCAGTCTGGGCAACAAGAGTGAAACTCTGTCTCAAAAAAAAA"
"chr3","9091524","9091695","JH378206","4391323","4391494","42","4700201","CTGTAATCCTAGCTACTCGGGAGGCTGAGGCAGCAGAATCATTTGAACCCGGGAGGCAGAGGTTGCAGTGAGCCATTGCACTCCAGCCTGGGCAACAAGAGCGAAACTCCGTCTCAAAATAATAATAATAATAATAATAATAATAATAAATAAATAAAATATAAATTAAAAA","AATCCCAGCTACTCTGGAGACTGAGGCAGGAGAATCGCTTGAACCCAGGAGGCGGAGGTTGCAGTGAGCCGAGATCGTGCCATTGCCTTCCAGCCTGGGCAACAAGAGTGAAACTACATCTTAAAAATAAATAAATAAATAAATAAATAAATAAATAAATAAATAAATAAAT"
"chr3","14132561","14132872","JH378122","8011060","8011359","57","6121501","GGCCGGGTGCGGTGGCTCATGCTTGTAATCCCAGCACTTTTGGAGGCCGAAGCAGGTGGATCACCTGAGGTCAGGAGTTCGAGACGAGGCTGATCAACATGGTGAAACCCTGTCTCTACTAAAAACACACACACACACACACACACACACACACAAAATTAGCTGGGCGTGGTGGCGGGCACCTGTAATCCCAGATACTTGGGAGGCTGATGCAGGAGAATCGCTTGAACCTCAGAGGCAGAGGTTGCAGTGAGCTGAGATCATGCCATCATATTCCAGCCTGGGCAATAAGAGTAAAACACTTTCTCAAAA","GGCCAGGTGCAGTGGTTCATGCTGGTAATCCCAGCACTTTGGGAGGCCAAGACAGGTGGATCACTTGAGGTCAGGAGTTCGAGACCAGCCTGACCAACATGGTAAAACCTCGTCTCTACTAAAAATACAAAAAAAAAAAAAAAAAAAAATTCAGCTGGGTCTGGTAGTGGGTGCCTGTAATACCAGCTACTTGGGAGGCTGAGGCAGGAGAATCACTTGAACCCGGGAAGCAGAGATTGCAGTGAGCTGAGATCCTGCCATTGCATTCCAGCCTGGGCAACAAGAGCAAAACTCCATCTC"
"chr3","15422754","15423344","JH378206","6546474","6546861","252","8876280","TAATCCCAGCACTTGGGGAGGCTGAGGTGGGTGGATCACCTGAGGTCAGGAGTTCAAGACCAGCCTGACCAACATGGTGAAACCCCATCTCTATTAATACAAAAATTTAATCCCAGCACTTGGGGAGACTGAGGCGGGCAGATCACAAGGTCAGGAGTTCAAGATCACCAGCCTGGCCAACATGGGGAAACCCTATCTCTACTAAAAATACAAAAATTAGCTGGACATGTTGGCGCATGTCTGTAATTCCAGCTACTCAGGAGGCTGAGGCAGGAGAATTGCTTGAACCAGGACCCGGGAGGTGGAGGTTGCAGTGAGCCAAGATCACGTCGCTGCACTCCAGCCTCAGCTACAGAGCAAGGCTTCGTCTCAAAAAAAAAACAAAAAACAAAAAACAAAAAACAAAAACAAAAATTAGCCAGGCGTGATGGAAGGCACTTGTAATCCCAGCTACTCTGGAGCTGAGGCAGGAGGATCACTTGAATCCAGGAGGCGGAGATTGCAATGAGCCAAGACTGTGCCATTGCTCTCCAGCCTGGGCAACAAGAGCAAAACCTCGTCTCAAAAAAAAAAAAAAAAAGAACTAAAAAA","GGCCACACATGGTGGCTAACGCCTGTAATCCCAGCACTTTGGGAGGCCAAGTCGGGTGGATCATGAGGTCAGGAGACCAAGACCATCCTGGCCAAATGGTGAAACCCCGTCTCTACTAAAAATACAAAAATTAGCTGGGCATGGTGGCGTGTGCCTGTAATCCCAGCTACTCAGGAGGCTGAGGCAGGACAATTGCCTGAACCCAGGAGAATTAGCTGGGCATGGTGGCGTGTGCCTGTAATCCCAGCTACTCAGGAGGCTGAGGCAGGACAATTGCCTGAACCCAGGAGGCGAAGGTTGCGGTGAGCCGAGATTGTGCCATTGCACTCCAGCCTGGGTAACAAGAGCGACACTCTGTCTCAAAAAAAAAAAAAAAAAAAAAAAAAAA"
"chr3","27366722","27367331","JH378118","18053084","18053501","255","9313638","GGCTGGGCGCGGTGGCTCATGCCTGTAATCCCAGCACTTTGGGAGGCTGAGATGGTGAGATCACGAGGTCACGAGTTCGAGACCAGCCTGGCCAACATGGTGAAACCCCATCTCTACTAAAAATACAAAAATTAGGCTGGGCACATTGGCTCATGCCTATAATCCCAGCACTTTGGGAGGCCGAGGTGGGCGTATCACGAAGTCAGGAGATCGAGACCATCCTGGCTAACACAGTGAAACCCTGTCTCTACTAAAAATACAAAAAAATTAGCCAGGCCTGGTGGCTGGCGCCTGTAGTCCCAGCTACTCGGGAGGCTGAGGCAGGAGAATGGCGTAAACCCAGGAGGCGGAGTTTGCAGTGAGCCGAGATCACGCTACTGCACTCCAGGCTGGGCCATAGAGTGAGACTCCGTCTCAAAAAAAAAAAAAAAAATTAGCCAGGTGTGGTGGCGGGCACCTGTAATCCCAGCTACTCCGGCGGCTGAGGAAGGAGAATCGCTTGAACCCGGAAGGCGGATGTTTCAGTGAGCCGAGATCGTGCCATTGCACTGCAGCCTGGGCGACAAGAGTGAAAGTCCATCTCAAAAAAACATATAAAAATAAAAATAAA","GGCTGGGCGCAGTGGCTCACACCTGTAATCCCAGCACTTAGGGAAGCTGAGGCGAGTAGATCACCTGAGGTCAGGAGTTAGAGACCAGCCTGGCCATCATGGTGAAACCCCGTCTCTACTAAAGATACCAAAAATTAGCTGAGTGTGGTGCTGGGTGCCTGTAATCCCAGAAACTCAGGGTGCCTGTAATCCCAGCAACTCAGGGTGCCTTTAATCCCAGCAACTGAGGGTACCAGTAATCCCAGCAACTCAGGGTGTCTTTAATCCTAGCAACTGAGGGCACCTGTAATCCCAGCAACTCAGGAAGCTGAGACAGGAGAAGTACTTGAACCCAGAAGGCAGAGGTTGCAGTGAGCCGATATTGCACCATTGCACTCCAGTCTGGGCAACAAGAGTGAAACTCTGTCTCAAAAAAAAA"
"chr3","29239852","29240165","JH378154","4181526","4181824","58","25058326","GGTCAGGCGCGGTGGCTCATGCCTGTAATCCCAGCACTTTGGGAGGCTAAAGTGGGTGGATCAACTGAGGTCAAGAGTTCAAGACCAGCCTGGCCAACATGGTGAAACCCTGTCTCTACTAAAAATACCAAAAAAAAAAAAAAAAAAAAAAAAATCAGCCAGCCATGGTGGCAGTCACCTGTAATCCCAGTTACTCGGGAGGCAGAGTCAGGGGAATCGCTTGAACTGAGCCGAGATGGTGCCATTGCACTCCAGCCTTGGCAACAAGAGTGAAAACCCATCTCAAAAAAAAAAAAAGAAGAAGAAAAAAGAAA","GGCAGGGTGCAGTGGCTCATGCCTATAGTTCCAGCACTTTGGGAGGCTGAGGCGGGTGGATCACCTGAGGTCAGGAGTTTAAGACCAGCCTGGCCAACATGGTGAAAACCCATCTCTACTAAAAATACAAAAAAAAAAAAAAAAAAAAAAAAAAAAAGCTGGGTCTGGTGGTAGGCACCTGTAATCCCAGCTACTCGGAAGGTTGAGACAGGAGAGTCACTTGAGATTGTGCCATTGCACTCCAGCCTGGGCCACAAAAGCAAAACTCCATCTCAAAAAAGAGAAAAAAAAAAAAAAAA"
"chr3","34807674","34808295","JH378118","18053084","18053501","276","16754590","GGCCGGGCGTGGTGGTTCACTCCTGTAACTCCAGTACTTTGGGAGGCTGAGGCAGGCGGATCACCTGAGGTCAGGAGTAAGACAAGCCTGGCTAACATGATGAAACCCTGTCTCTACTAAAAATACAAAAATTAAGGCCGAGCGTGGTGTCATGTGCCTGTAATCCCAGCACTTTGGGAGGCCGAGGCAGGTGGATTGCCTGAAGTCAGAAGTTGGAGACCAGCCTGGGCAACACGGTGAAACCCCGTCTCTACTAAAATACAAAAAATTAGCCGGGCGTGGTGGTGGGTGCCTGTAGTCTCAGCTACGGGGGAGGCTGCTTCAAGACAACTGCTTGAACCCGGGAGGCAGAGCTTGCAGTGAGCCGAGATCGCGCCACCGCACTCTAGCCTGGGCGACAGAGAGAGACTCCGTCTCAAAAAAAAGAAAAAAAAAGAAAAAAAATTAGCTGGATGTGGTGATGGGCGCCTGTAATCCCAGCTACTCCAGAGGCTGAGGCGGGAGAATCGTTTGAACCAGGGAAGCGGAGGTTGCAGTGACCCGAGATTGTGTCATTGCTCCCCAGCCTGGGCGACAAGAGCTAAACTCCGTCTCAAAAACTAAAAATAAATAAATAAACAAA","GGCTGGGCGCAGTGGCTCACACCTGTAATCCCAGCACTTAGGGAAGCTGAGGCGAGTAGATCACCTGAGGTCAGGAGTTAGAGACCAGCCTGGCCATCATGGTGAAACCCCGTCTCTACTAAAGATACCAAAAATTAGCTGAGTGTGGTGCTGGGTGCCTGTAATCCCAGAAACTCAGGGTGCCTGTAATCCCAGCAACTCAGGGTGCCTTTAATCCCAGCAACTGAGGGTACCAGTAATCCCAGCAACTCAGGGTGTCTTTAATCCTAGCAACTGAGGGCACCTGTAATCCCAGCAACTCAGGAAGCTGAGACAGGAGAAGTACTTGAACCCAGAAGGCAGAGGTTGCAGTGAGCCGATATTGCACCATTGCACTCCAGTCTGGGCAACAAGAGTGAAACTCTGTCTCAAAAAAAAA"
"chr3","35726688","35727012","JH378254","873499","873817","50","34853189","GGCCAGGCGTGGTGGCTCATGCCTGTAATCTCAGCACTTTGGGAGGCCGAGGAGGGCAGATCACCTGAGGTTAGGAGTTAGAGACTAGCCTGGCCAACATGGTGAAACCCCATCTGTACTAAAAATACAAAAAAAAAAAAAAAAAAAAAAAAAAAGAAAATCAGCCAAGTGTGGTGGCACACGCCTGTAATCCCAGCTACTCAGGAGGCTGAAGCAGGAGAATTGTTTGAACCCGGGAGGCAGATCTTGCAGTGAGCCAAGATTATGCCATTGCACTCCAGCCTGGATGACAAGAGTGAAACTCTGTCTCAAAAAAAAAAAAAAA","GGCCGGGCGAGGTGGCTCAAGCCTGTAATCCCAGCACTTTGGGAGGCCGAGGCGGGTGGTTCATGAGGTCAAGAGATCGAGACCATCCTGGTCAACATGGTGAAACCCCGTCTCTACTAAAAATACAAAAAAAAAAAAAAAAAAAAAAAAAGTTAGCTGGGCATGGTGGCGCTTGCCTGTAATCCCAGCTACTCAGGAGGCTGAGGCAGGAGAATTGCCTGAACCCAGGAGGCGGAGGTTGCGGTGAGCCGAGATTGCGCCATTGCACTCCAGCCTGGGTAACAAGAGTGAAACTCCGTCTCAAAAAAAAAAAAGAAAA"
"chr3","47465542","47465871","JH378172","1346140","1346461","55","46119402","GGCTGGGCGCCGTGGCTCATGCCTGTAATCCCAGCACTTTGGGAGGCCAAGGCAGATGGATCACCTGAGGTCAAGAGTTCAGGACCAGCCTGACCAACATGGTGAAACCCCGTCTTTAATAAAAATACAAAAAAAAAAAAAAAAAAAGAAAAAGAAAAAAAAAGGATTAGCTGGGCATGGTGGCAGATGCCTGTAGTCTCAGCTATTTGGGAGCCTGAGGCAGGATAATCACTTGAATCAGGGAGGCAGAGGTTGCAGTAAGCCGAGATCACTCCATTGCACTCCAGCCTAGGCAACAAGAGTGAAATTCCATCTCAAAAAAAAAAAAAA","GGCCAGGTGTGTTGGCTCTCTCCTGTAATCCCAGCACTTTGGGAGGCTAAGGTGGGTGGATCACCTGAGGTCAGGAGTTTGAGACCAGCCTGACCAACATGGTGAAACCCCGTCTCTGCTAAATACAAAAAAAAAAAAAAAGAAGAAGAAGAAAAAAATCAGCTGAGCATGGTGGCACATACCTATAATCCCTGATACTTGGGCAGCTGAGGCAGGAGAATCACTTGAACCTGGGAGGCGGAGGTTACAGTAAGCTGAGATTGCACCATTGCACTCCAGCCTAGGCAACAAGAGTGAAACTCTGTCTCAAAAAAAAGAAAAA"
"chr3","51333507","51334135","JH378118","18053084","18053501","278","33280423","GGCCAGTTGTGGTGGCTCGCGGCTGTAATCCCAGCACTTTGGGAGGCCGAAGTGGGCGGATCACCTGAGGTCAGGAGTTTGAGACCAGCCTGGCCAACATGGTGTTACCCTGTCTCTACTAAAAACACAAAAATTGGCCGGGTGCGGTCACTCACGCCTGTAATCCCAGCACTTTGGGAGGCCTAGGCGGGCGGATCACAAAGTTAGGAGATCAAGACCATCCTGGCTAACACGGTGAAACCCCATCTCTGCTAAAAATACAAAAAAATTTAGCTGGGCGCGGTGGCGGGCGCCTGTAGTCCCAGCTACTTGGGAGGCTGAGGCAGGAGAACGGCGTGAACCCGGGAGGCGGAGCTTGCAGTGAGCTGAGATCGCGCCACTGCACTCCAGCCTGGGTGGCAGCGCGAGACTCCGTCTCAAAAAAAAAAACAAAACAAAAAAAACAAACCCACAAAAGTTAGCCGGGCGTGGTGGTGGGTGCCTTTAATCTCAGCTACTCAGGAGGATGAGGCAAGAGAATCACTTGAACCCGGGAGGCAGAGGTTGCAGTGAGCTGCGATCGCGCCATTGCACTCCAGCCTGGGCAACAGGCGTGAGACTCTGTTTCAAAAAAAAAAAAATCAAAAAAA","GGCTGGGCGCAGTGGCTCACACCTGTAATCCCAGCACTTAGGGAAGCTGAGGCGAGTAGATCACCTGAGGTCAGGAGTTAGAGACCAGCCTGGCCATCATGGTGAAACCCCGTCTCTACTAAAGATACCAAAAATTAGCTGAGTGTGGTGCTGGGTGCCTGTAATCCCAGAAACTCAGGGTGCCTGTAATCCCAGCAACTCAGGGTGCCTTTAATCCCAGCAACTGAGGGTACCAGTAATCCCAGCAACTCAGGGTGTCTTTAATCCTAGCAACTGAGGGCACCTGTAATCCCAGCAACTCAGGAAGCTGAGACAGGAGAAGTACTTGAACCCAGAAGGCAGAGGTTGCAGTGAGCCGATATTGCACCATTGCACTCCAGTCTGGGCAACAAGAGTGAAACTCTGTCTCAAAAAAAAA"
"chr3","55881240","55881843","JH378118","18053084","18053501","246","37828156","GGCCGAGCACAGTGGCTCATGCCTGTAATCCCAGCATTTTGGGAGGCCGAGGCGGATGGATCACCTGAGGTCAGGAGTTCAAGACCAGCCTGGCTAACATGGTGAAACCTCATCTCCACTTAAAATACAAAAATTGCCGGCTGTGGTGGCTCACGCCTGTAATCTCAGCACTTTGGGAGGCCTAGGCAGGTGGATCACGAGGTCAGGAAATCGAGACCATCCGGGCTAACACGGGTGAAACCCCGTCTCTATTTAAAAATAGAAAAAGTTAGGCGGGCATGGTGGTGAGTGCCTGTAGTCCCAGCTACTCAAGAGCCTGAGGCGGGAGAATGGCATGAACACAGAAGGCGGAGCTTGCAGTGAGCTGAGATGGTGCCACTGCACTCTAACCTGGGCAACAGAGCGAGACACCTTCTCAAAAAAAATCAAAAAACAAAAATTATCCAGGCGTGGAGGTGGGCACCTGTAATCCCAGCTACTCGGGAGGCTGAGGCAGGCAAATCTCTTGAGCCCGGGAGGCGGAGGTTGCAGTGAGCCAAGATCACACCATTGCACGCCAGTCTGGGCAACAAGAGTGAAATTCCATCTCAAAAAAAACAAAAAA","GGCTGGGCGCAGTGGCTCACACCTGTAATCCCAGCACTTAGGGAAGCTGAGGCGAGTAGATCACCTGAGGTCAGGAGTTAGAGACCAGCCTGGCCATCATGGTGAAACCCCGTCTCTACTAAAGATACCAAAAATTAGCTGAGTGTGGTGCTGGGTGCCTGTAATCCCAGAAACTCAGGGTGCCTGTAATCCCAGCAACTCAGGGTGCCTTTAATCCCAGCAACTGAGGGTACCAGTAATCCCAGCAACTCAGGGTGTCTTTAATCCTAGCAACTGAGGGCACCTGTAATCCCAGCAACTCAGGAAGCTGAGACAGGAGAAGTACTTGAACCCAGAAGGCAGAGGTTGCAGTGAGCCGATATTGCACCATTGCACTCCAGTCTGGGCAACAAGAGTGAAACTCTGTCTCAAAAAAAAA"
"chr3","58626636","58627252","JH378118","18053084","18053501","258","40573552","GGCCAGACACAGTGGCTCATGCCTGTAATCCCAGCACTTTGGGAAGCCAAGGCAGGTGGATCACCTGAGGTCAGGAGTTCGAGACCAGCCTGGCCAACATGGTGAAACTTCATCTCTACTAAAAATACAAAAATTAGTCGGGCGTGGCTGGGCGCGGTGGCTCCTGCCTGTAATCCCAGCACTTTAGGAGGCCAAGGTGGGCAGATCACAAGGTCAGGAGATCGAGACCATCCTGGCTAACATGGCAAAACCCCATCTTTACTAAAAATACAAAAAAAAAAAATAGATGGTTGTGGTGGTGGGCACCTGCAGTCCCAGCTACTCCAGAGGCTGAGGGAAGAGAATGGCATGAACCCAGGAGGCAGAGCTTGCAGTGAGCCAAGATCGTGCCACTGCACTCCAGCCTGGGGGACAGAGTGAGAGTCTGTCTCAAAAAAAAAAAAAAAAAATTAGCCGGACATGGTGGCAGGGGCCCGTAATCTTAGCTACTCGGGAGGCTGAGGCAGGAGAATTTCTTGGAGCTGGGAGGCTGAGGTTGCAGCGAGCCGAGATCGTGCCATTGCACTCCAGCCTGGGTGACAAGAGTGAAACTCTGTCTCAAAAAACAAAACAAAAAA","GGCTGGGCGCAGTGGCTCACACCTGTAATCCCAGCACTTAGGGAAGCTGAGGCGAGTAGATCACCTGAGGTCAGGAGTTAGAGACCAGCCTGGCCATCATGGTGAAACCCCGTCTCTACTAAAGATACCAAAAATTAGCTGAGTGTGGTGCTGGGTGCCTGTAATCCCAGAAACTCAGGGTGCCTGTAATCCCAGCAACTCAGGGTGCCTTTAATCCCAGCAACTGAGGGTACCAGTAATCCCAGCAACTCAGGGTGTCTTTAATCCTAGCAACTGAGGGCACCTGTAATCCCAGCAACTCAGGAAGCTGAGACAGGAGAAGTACTTGAACCCAGAAGGCAGAGGTTGCAGTGAGCCGATATTGCACCATTGCACTCCAGTCTGGGCAACAAGAGTGAAACTCTGTCTCAAAAAAAAA"
"chr3","68575478","68576071","JH378119","32351107","32351490","251","36224371","GGCCGGGCGTGGTGGCTCATGCCTGTAATCCCAGCACTTTGGGAGGCCAAGGCAGGCGATCACCTGAGGTCAGGAGTTTGAGACTAGCCTGGCTAACACGGCAAAACCCCGCCTCTACTAAAAATACAAAAATTAGGCCAGGCGCGGTGGCTCATGCCTATAATCCCAGCACTTTGGGAGGCCGAGGCGGGCGGATCATGAGGTCAGGAGATCGAGATCATCCTGGCTAACACAGTGAAAGCCCGTCTTTACTTAAAATATAAAAAAATTAGCCAGGCATGGTGGCATGTGCCTGTAATCCCAGCTACTCAGGAGGCTGAGGCAGGAGAATTGCTTGAACCTGGAAGGTGGAGGTTGCAGTGAGCCGAGATCGCGCCACTGCACTCCAGCCTGGGCGACCGAGCGAGACGCGGTCTCAAAAAAAAAAAAAAAATTAGCTGGGCATGGTGGTTGGCACCTGTAATCCTCGCTACTTAGGAGGCCGAGGCGGGAGTATCGCTTGAACCAGGGAGGCAGAGGTTGCAGTGAGCCGAGATCGTGCTATTGCACTCCAGCTTGAGTGACAAGAACAAAATTCCGTCTCAAAAAAAAAAA","GGCCAGGTATGGTGGCTCACACCTGTAATCCCAGCACTTTGGGAGGCCAAGGCAGGCAGACCACCTGAGGTCAGGAGTTCGAGATCAGCCTAGCCAACATGGTGAAACCCCATCTCTAGTAAAAATAAAATTAGCCAGGCATGGTGGTGCATGCCTGTAACGCAGGTCAGGAGTTCGAGATCAGCTTAGCCAACATGGTGAAACCCCATCTCTAGTAAAAATAAAATTAGCCAGGCAGGTGGTGCCGCCTGTACTCGGGAGGCTGAGGCAGGAGAATCACTTGAACCCAAGAGGCAGAGGTTGCAGTCAGCCAAGATCATGCCATTGCACTCCAGCCTAAGCAAAAAGAGTAAAACTCAGTCTCAAAACAAAAAAACAAAAAAA"
"chr3","72656258","72656860","JH378118","18053084","18053501","248","54603174","GCTGGGCACGGTGGCTCACCCTTGTAATCCCAGCACTTTGGGAGGCCAAGGTGGGTGGATCACCTGAGGTCAGGAGTTTGCGACCAGCCTGGCCAACATGGTGAAACCTCGTCTCTACTAAAAATACAAAAATTAAGGCTGGGCCCGGTGGCTCATGCCTGTAATCCCAGCACTTTTGGAGGCTGAGGCAGGCGGATCACCTGAGGTCAGAAGTTTGAGACCAGCTTGGCCAACATGGTGAAACCCTGTCTCTACTAAAAATACAAAAATTAGCTGGGCATGGTGGCGGGCGCCTGTAATCCCAGCTACTCAGGAGGCTGAGGCAGGAGAATTGCTTGAACTGGGGAGGCAGAGGTTGCAGTGAGCCAAGCCTGGGTGATAGAGTGAGACTCCATCTAAAAAAAAAAAAAAAAAAAAAAAAAATTAGTCCAGCATGGTTGTACGCACCTGTAATCCCAGCTACTTGGGAGGCTGAGGCAGGAGAATTGCTTGAACCCGGGAGGTGGATGTTGCAGTAAGTGGAGACCACACCATTGCACTCAAGCCTGGGCAACAAGAGTGAAACTCTGTTACAAAAAACAAACAACAAAACAAAACCAAAAA","GGCTGGGCGCAGTGGCTCACACCTGTAATCCCAGCACTTAGGGAAGCTGAGGCGAGTAGATCACCTGAGGTCAGGAGTTAGAGACCAGCCTGGCCATCATGGTGAAACCCCGTCTCTACTAAAGATACCAAAAATTAGCTGAGTGTGGTGCTGGGTGCCTGTAATCCCAGAAACTCAGGGTGCCTGTAATCCCAGCAACTCAGGGTGCCTTTAATCCCAGCAACTGAGGGTACCAGTAATCCCAGCAACTCAGGGTGTCTTTAATCCTAGCAACTGAGGGCACCTGTAATCCCAGCAACTCAGGAAGCTGAGACAGGAGAAGTACTTGAACCCAGAAGGCAGAGGTTGCAGTGAGCCGATATTGCACCATTGCACTCCAGTCTGGGCAACAAGAGTGAAACTCTGTCTCAAAAAAAAA"
"chr3","73783781","73784109","JH378140","18737287","18737613","56","55046494","GGCTGGGCGCAGTGGCTCATGCCTGTAATCCCACCACTTTGGGAGGCCAAGGTGGGTGGATCACCTAAGGTCAGGAGTTTGAGACCAGCCTGGCCAATGAGGTGAAATCCCATCTCTACTAAAAATACACACACACAGACACACACACACACACACACAAATTAGCCGGGTGTGGTGGCAGGTGCCTGTAATCCCAGCTTCTCTGGAGGCTGAGGCAGGAGAATCACTTGAACCTGGGAGGCAGAGGTTGCAGTGAGCTGAGGTTGCACCATTGCACTCTAGCCTGGGCAACAAGAGTGAAACTCTGTCTCAGAAAACAACAAAAAAAA","GGTTGGGCACAGTGGCTCATACCTGTACTTTCAGCATTTTGGGAGGCCAAGGCGGGTGGATCACCTGAGGTCAGGAGTTTGAGACTAGCCTGGCCAACATGATGAAACCCCATCTCTACTAAAAATACAAAAAAAATAAAATAAATAAAACAAATTAGCTGGGTGCGGTGATGAGCACCTGTAATCCAAGCTACTTGGGAAGCTGAGGCAGGAGAATAGCTTGAACCTTGGGAGGCAGAGGTTGCAGTGAGCTGAGATCACACCATTGCACTCTAGCCTGGGCAATAAGAGTGAAACTCTATCTCAAAAACAACAACAAAAACAAAA"
"chr3","85058694","85059285","JH378118","18053084","18053501","236","67005610","GGCCAGGCGCAGTGGCTCACACTTGTAATCCCAGCACTTTGGAAGGCAGAGGTGGGTGGATCACTTGAGCTCAGGAGTTCAAGACCAGCCTGGGCAACATGGTGAAACCCGTCTCTACCAAAAATACAAAAATTGGCCAGGCGCAGTGGCTCACGCTTGTAATCCCAGCACTTTGGGAGGCTAAGACAGGGGGATCACAAGGTCAAGAGATCAAGACTACCCTGGCCAACATGGTGAAACCCTGCTCTACTAAAAATACAGAAAATTAGCTGGGCGTGGTGCCTGTAGTCCCAGCTACTCAGGAGGCTGAGGTAGGAGAATCACTTGAACCCAGGAGGCAGAGGTTGCAGTGAGCTGAGATCGCGCCACTGCACTCCAGCCTAGCGACAGAGTGAGACTCCGTCTCAAAACAAACAAACAAAAAATACAAAAATTAGCTGGGCATTGTGGCAGACACCTGTAATCCCAGCTACTTGGGAGGCTGAGGCAGAAGAATCGCTTGAACCTGGGAGGCAGAGGTTGCAGTGAGCCGAGATTGTGCCATCTCACTCCAGCCTGGGCAACAAGAGGGAAACTCCATATCAAAAAAAAA","GGCTGGGCGCAGTGGCTCACACCTGTAATCCCAGCACTTAGGGAAGCTGAGGCGAGTAGATCACCTGAGGTCAGGAGTTAGAGACCAGCCTGGCCATCATGGTGAAACCCCGTCTCTACTAAAGATACCAAAAATTAGCTGAGTGTGGTGCTGGGTGCCTGTAATCCCAGAAACTCAGGGTGCCTGTAATCCCAGCAACTCAGGGTGCCTTTAATCCCAGCAACTGAGGGTACCAGTAATCCCAGCAACTCAGGGTGTCTTTAATCCTAGCAACTGAGGGCACCTGTAATCCCAGCAACTCAGGAAGCTGAGACAGGAGAAGTACTTGAACCCAGAAGGCAGAGGTTGCAGTGAGCCGATATTGCACCATTGCACTCCAGTCTGGGCAACAAGAGTGAAACTCTGTCTCAAAAAAAAA"
"chr3","89186268","89186874","JH378118","18053084","18053501","247","71133184","GACCAGGCACGGTGGCTCATGCCTGTAATCCCAACACTTTGGGAGGCCAAGGTGGGCGGATCACCTGAGGTCGGGAGTTTGAGACCAGCCTGGCTAACATGGTGAAACCCTGTCTCTACTAAAAATACAAAAATTAGCCGGGCATGACCGAGCTCGATGGCTCAAGTCTGTAATCCCAGCACTTTGGGAGGCCGAGGCGGGCGGATCACCTGAGGTCGGGAGTTCGAGACTAGCCTGACCAACATGGAGAAACCCTGTCTACTAAAAATACAAAATTAGCCAAGCGTGGTGGTGCATGCCTTGTAATCCTAGCTACTCGAGAGGCTGAGGCAGAAGAATTGCTTGAACCCAGGAGGCAAAGGTTGCGGTGAGCAGAGATTGCGCCGTTGTACTCCAGCCTGGGCAACAAGAGTGAAACTCCATCTCAAAAAAAAAAAAAAAAAAGCCGGGCATCGTAGCAGGCGCCTGTAATCCCAGCTACTCGGGAGGCTGAGGCAGGAGAATCGCTTGAACCCGGGAGGCAGAGGTTGCAGTGAGCTGAGATCGTGCCATTGCACTCAAGCCTGGGCAACAAGAGCGGAACTCCATCTCAAAAAAAAAAAAAAAA","GGCTGGGCGCAGTGGCTCACACCTGTAATCCCAGCACTTAGGGAAGCTGAGGCGAGTAGATCACCTGAGGTCAGGAGTTAGAGACCAGCCTGGCCATCATGGTGAAACCCCGTCTCTACTAAAGATACCAAAAATTAGCTGAGTGTGGTGCTGGGTGCCTGTAATCCCAGAAACTCAGGGTGCCTGTAATCCCAGCAACTCAGGGTGCCTTTAATCCCAGCAACTGAGGGTACCAGTAATCCCAGCAACTCAGGGTGTCTTTAATCCTAGCAACTGAGGGCACCTGTAATCCCAGCAACTCAGGAAGCTGAGACAGGAGAAGTACTTGAACCCAGAAGGCAGAGGTTGCAGTGAGCCGATATTGCACCATTGCACTCCAGTCTGGGCAACAAGAGTGAAACTCTGTCTCAAAAAAAAA"
"chr3","89640055","89640421","JH378119","28476684","28477024","72","61163371","GGCCAGGCGTTGTGGCTTATGTCTGTAATACCAGCACTTCGGGAGGCTGAAGCAGATGGATTACCTGAAGTTAGGAGTTCAAGACCAGCCTGACCAACATGGTGAAACCTCATCTCTACTAAAAATACACAATTAGCCGGGTGTGGTGGTGGGTGCCTATAATCCCAGCTACTTAGGAGGCTGATACAGGAGAATCGCTTGAACCTGGGAGGCAGAGGTTGCAGTGAGCTGAGATCACACCAATGCACTCCAGCCTGGGCAACAAGAGTAAAACTCTGTCTCAAATAATAATAATAATAATAATAATAATAATAATAATAATAGTAAATAAAATAAATTTAAAAATAAAAAGAAAAAAAGAAAAAGA","GGCTGGGGGTGGTGGCTGACACCTGTAATCCCAACACTTTGGGAGGCCAAAGTGAGTGGATCATCTGAGGTTGGGAATTCAAGACCAGCCTGGCCAACATGGTGAAACCTCATCTCTACTAAAAATACAAAAATTTGCTGGGCATGGTGGCATGCGCCTGTAATTCCAGCTACTTGGACGCTGAGACAGGAGAATCACTTGAACCTGGGAGGCAGAGGTTGCACTGAGCTGAGATCATGCCATTGCACTCCAGCCTGGGTGACAAGAGTGGAACTCTGTCTCAAAAAAAAAAAAAAAAAAAAAAAAAAAAAAAAAAAAAAAAAAAAAAAAAAAAAAAAAAA"
"chr3","90351314","90351922","JH378118","18053084","18053501","252","72298230","GACCAGGCGCAGTGGCTCACGCCTGTAATCCCAGCACCTTGGGAGGCTGAGGCGGGTGAATCGCCTGAGGTCAGGAGTTCGAGATCAGCCTGGCTAACATGGTGAAACCCCATCTCTACTAAAAATTTTAAAAATGGCCGGGCGCGGAGGCACGCGCCTGTAATCCCAGCACTTTGGGAGGCCGAGGCAGGCGGATCACAAGGTCAGGAGATGGAGACCATCCTGGCTAACACAGTGAAACCCCGTCTCTACTAAAAATACAAAAAATTAGTCAGGCGTGGTGGCAGGCGCCTGTAGTCCCAGCTACTCGGGAGGCTGAGGCAGGAGAATGGTGTGAACCCGGGAAACAGAGCTTGCAGTGAGCCGAGATCACGCCACTGCACTCCAGCCTGGGCGACAGAGCGAGACTCAGTCTCAATAAATAAATAAATAAAATAAAAATAAAAAAATTAGCTGGGCATGGTAGCAGGCGTCTGTAATCCCAGCTACTCGGGAGGCTGAGGCAGGAGAATTGCTTGAACCTGGAGGCAGAGGTTGCAGTAAGCCAAGATCGCGCCATTGCACTCCAGCCTGAGTGACAAGAATGAAACTTCATCTCAAAAAAAAAAA","GGCTGGGCGCAGTGGCTCACACCTGTAATCCCAGCACTTAGGGAAGCTGAGGCGAGTAGATCACCTGAGGTCAGGAGTTAGAGACCAGCCTGGCCATCATGGTGAAACCCCGTCTCTACTAAAGATACCAAAAATTAGCTGAGTGTGGTGCTGGGTGCCTGTAATCCCAGAAACTCAGGGTGCCTGTAATCCCAGCAACTCAGGGTGCCTTTAATCCCAGCAACTGAGGGTACCAGTAATCCCAGCAACTCAGGGTGTCTTTAATCCTAGCAACTGAGGGCACCTGTAATCCCAGCAACTCAGGAAGCTGAGACAGGAGAAGTACTTGAACCCAGAAGGCAGAGGTTGCAGTGAGCCGATATTGCACCATTGCACTCCAGTCTGGGCAACAAGAGTGAAACTCTGTCTCAAAAAAAAA"
"chr3","92382781","92383368","JH378118","18053084","18053501","237","74329697","GGCCTGGTACAGTGGCTCATTCCTGTAATCCCAGCACGTTGGGAGGCCGAGGCAGGCAGATCACCTGAGGTCAAGAGTTTGATACCAGCCTGGCCAACATGGTGAAACTCCGTCTCTACTAAAAATACAAAATGTGGGCTGGGCAAGGTGGCTCACCCCTGTAATCCCAGCACTTTGGGAGGCCGAGGTGGGTGGATCACGAGGTCAGGAGTTCAAGACCAGTCTGGCCAATATGATGAAACCCTAGCCGGGCGTGGTGGCGCATGCCTGTAGTCCCAGCTATTCAGGAGGCTGAGGCAGAAGAATAGCTTGAACCCAGGAGGTGGAGGTTGCACTGAGCTGAGATCACGCCACTGCATTCCAGCCTGGGCGAAAGAGCAAGATTCCATCTCAAAAAGAGTGTGTGTGTGTGTGTGTGTGCGCGCCAGGAGTGGTGGCACAAGCCTATAGTCTCAGCTACTCAGGAGGCTGAGGCAGGAGAGTCGCTTGAACCCGGGAGGTGGAGGTTGCAGTAGGCCAAGATCACACCATTGCACTCCATCCTGGGCAACAAGAGCGAAACTCCATCCCCCCAAAAAAACACAAAAA","GGCTGGGCGCAGTGGCTCACACCTGTAATCCCAGCACTTAGGGAAGCTGAGGCGAGTAGATCACCTGAGGTCAGGAGTTAGAGACCAGCCTGGCCATCATGGTGAAACCCCGTCTCTACTAAAGATACCAAAAATTAGCTGAGTGTGGTGCTGGGTGCCTGTAATCCCAGAAACTCAGGGTGCCTGTAATCCCAGCAACTCAGGGTGCCTTTAATCCCAGCAACTGAGGGTACCAGTAATCCCAGCAACTCAGGGTGTCTTTAATCCTAGCAACTGAGGGCACCTGTAATCCCAGCAACTCAGGAAGCTGAGACAGGAGAAGTACTTGAACCCAGAAGGCAGAGGTTGCAGTGAGCCGATATTGCACCATTGCACTCCAGTCTGGGCAACAAGAGTGAAACTCTGTCTCAAAAAAAAA"
"chr3","92389161","92389799","JH378118","18053084","18053501","283","74336077","GGGCGGACGCAGTGGCTCACACTTGTAATCCCAGCACTTTGGGAGGCTAAGACAGGCGGTTCACTTGAAGTCAGGAGTTCAAGACCAGCCTGGCCAGCATGGTGAAATCTTGTCTCTACTAAAAATACATGCCAGGCATGATGGCTCACGCCTGTAACCCTAGCACTTTGGGAGGCCAAGGCTGGTGGATCACCTGAGGTCAGGAGTTTGAGACCAGCCTGGCCAACATGGTGAAATCCCGTCTCTACTACAAATACAAAAATTAGCCGGGCGTGGTGGTGCGTGCCTGAAGTCGCAGCTACTTAGGAGGCTGAGACAGGAGAATCCCTTGAACCTGGTAGGCAGACGTTGCAGTGAGCGGAGACTGCACCACTGCACTCCAGCCTGGGTGACAGAGAAAGACCCTGTCTCAAAAACAATACATACATACATACACACAAAGAAACACAAATACAAAAATTAGCCGGGTGTGGTGGCAGGCACCTGTAATCCCAGCTACTCGGGAGGCTGAAGCAGGAGGATTGCTCGAACCCAGGAGGCAGAGGTTGAAGTGAGCCGAGAATGCGCCATTGAATTCCAGCTTGGGCAACAAGAGCAAAACTCCATCTCATTATTTAAAAAAAAAAAAAGAAAAAAAAA","GGCTGGGCGCAGTGGCTCACACCTGTAATCCCAGCACTTAGGGAAGCTGAGGCGAGTAGATCACCTGAGGTCAGGAGTTAGAGACCAGCCTGGCCATCATGGTGAAACCCCGTCTCTACTAAAGATACCAAAAATTAGCTGAGTGTGGTGCTGGGTGCCTGTAATCCCAGAAACTCAGGGTGCCTGTAATCCCAGCAACTCAGGGTGCCTTTAATCCCAGCAACTGAGGGTACCAGTAATCCCAGCAACTCAGGGTGTCTTTAATCCTAGCAACTGAGGGCACCTGTAATCCCAGCAACTCAGGAAGCTGAGACAGGAGAAGTACTTGAACCCAGAAGGCAGAGGTTGCAGTGAGCCGATATTGCACCATTGCACTCCAGTCTGGGCAACAAGAGTGAAACTCTGTCTCAAAAAAAAA"
"chr3","92444638","92445263","JH378118","18053084","18053501","262","74391554","GCCGGGCATGGTGGCTCGTGCCTGTAACCCCAACACTTTGGGAGGCTGAGGCGGGTGGATCACCTGATGTCAGGAGTTCGAGACCAGCCTGGCCAACATGGTGAAGCCCCATATCTACTAAAAATACAAAAAATTGGCCAGGTGCGGTGGCTCATGCCTGTAATCCCAGCACTTTGGGAGACCAAGGCTGGGGGATCACCTGAGGTTGGGAGTTTGAGACCAGCGTGACCAACATGGAGAAACCTTGTCTCTACTGAAAAATACAAAATTAGCCAGGCGTGGTGGCACATGTCTGTAATCCCAGCTACTCTGGAGGCTGAGGCAGAAGAATCGCTTGAACCCGGGAGGCAGAGGTTGCGGTGAGCCGAGATCTCGCCATTTGCACTCCAGCCTGGGCAACAAGAGCGAAACTTTGTCTCAAAAAAAAATTAATTAATTAAAAATACAAAAAATTAGCTGGGCACGGTGGCATGTGCCTGTAATCCCAGCTACTCCGTAGGCTGAGGGAGAAGAATTGCTTGACCCCGGGGGGCGGAGGTTGCAGTGAGCCGAGATTGCACCATTGCACTCCAGGCTAGGCAACAAGAGTGAAACTCTGTCTCAAAAAAAAAAAAAAAGAAGAAAAA","GGCTGGGCGCAGTGGCTCACACCTGTAATCCCAGCACTTAGGGAAGCTGAGGCGAGTAGATCACCTGAGGTCAGGAGTTAGAGACCAGCCTGGCCATCATGGTGAAACCCCGTCTCTACTAAAGATACCAAAAATTAGCTGAGTGTGGTGCTGGGTGCCTGTAATCCCAGAAACTCAGGGTGCCTGTAATCCCAGCAACTCAGGGTGCCTTTAATCCCAGCAACTGAGGGTACCAGTAATCCCAGCAACTCAGGGTGTCTTTAATCCTAGCAACTGAGGGCACCTGTAATCCCAGCAACTCAGGAAGCTGAGACAGGAGAAGTACTTGAACCCAGAAGGCAGAGGTTGCAGTGAGCCGATATTGCACCATTGCACTCCAGTCTGGGCAACAAGAGTGAAACTCTGTCTCAAAAAAAAA"
"chr3","92757548","92757887","JH378112","22601665","22602004","61","70155883","GGCCGGGTGCAGGTGGCTCAAGCCCGTAATCCCAGGACTTTGGGAGGCCGAGGCGTGCAGATCACCTGAGGTCAGGAGTTCAAGACCAGCCTGGCCAATGTGGTGAAACCCCGTCGCTACTAAAAATACAAAAATAAAACAAAATAAAATAAAATAAAATAAAACAAAACTAGCCAGACGAGGTGGCCGGCACCTGTGATCCCAGCTACTGAGGAGGCTGAGGCAAGAGAATCACTTGAACCTGGGAGGCAGAGGTTGCAGTGAGTCAACATTGCACCACTGTACTCCAATCTGGGTGACAAGAGCAAAACTCCATCTCAAAAAATAAAATAAAATAAAA","GGCCAGGTGCAGTGGCTCATGCCTATAATCCCAGCACTTTGGGAGGCCAAGGCAGGCAGATCATCTAAGGTCAGGAGTTCAAGATCAACCTAGCCAACATGTGAAACCTAGTCTCTACTAAAAATACAAAAAAAAAAAAAAAAAAAAAAAAAAAAAAAAAAAAAATTAGCCAAGTGTGGTGGCAGACATCTGTAATCCCAGCTACTCAGGAGGCTAAAGCAAGAGAATCACTTAAACCCAGGAGGCGGAGGTTGCGGTGAGCCAAGATTGCACCACTGCACTCCAGCCTGGACGACAAGAGTGAAACACCATCTCAAAAACAAAAACAAAAACAAAAAAA"
"chr3","92813589","92814204","JH378118","18053084","18053501","261","74760505","GGGCAGGCGCGGTGGCTCACGCCTGTAATCTCAGCACTTTGGGAGGCCAAGGTGGGCAGACCACGAGGTCAGGAGTTCAAGACCAGCCTGACCAACATAGTGAAACTCCGTCTCTACTACAAATACAAAAAATTAGCCGGGCGTCAGCCGGGTGCAGTGGCTCACGCCTGTAATCCCAGCACTGTGGGAGGCTGAGGCGGGAGGATCACGAGGTCAGGACATCGAGACCATGCTGGCTAACACGGTGAAACCCCGTCTCTACTAAAACTACAAAAAATTAGCTGGGCATGGTGGCAGGCACCTGTAGTCCCAGTTACTCGGGAGGCTGAGGCAGGAGAACAGCGTGAACCTGGAAAGCGGAGCTTGCAGTGAGTCGAGATCGTACCACCGCACTCCAGCCTGGGCAGCAGAGCGAGACTACGTCTCAAAAAAAAAAAAATTAGCCCAGCGTGGTGGCAGGCGCCTGTAATTCTAGCTACTCCAGAGGCTGAGGCAGGAGAATTGCTTGAACCCCGAAGGTGGAGGTTGCAGTGAGCCAAAATCGCGCCATTACACTCCAGCCTGGGCGACAAGAGTGAAACTCCATCTCAAAAAAAAAAAAAAAAAAAAAAAAAAA","GGCTGGGCGCAGTGGCTCACACCTGTAATCCCAGCACTTAGGGAAGCTGAGGCGAGTAGATCACCTGAGGTCAGGAGTTAGAGACCAGCCTGGCCATCATGGTGAAACCCCGTCTCTACTAAAGATACCAAAAATTAGCTGAGTGTGGTGCTGGGTGCCTGTAATCCCAGAAACTCAGGGTGCCTGTAATCCCAGCAACTCAGGGTGCCTTTAATCCCAGCAACTGAGGGTACCAGTAATCCCAGCAACTCAGGGTGTCTTTAATCCTAGCAACTGAGGGCACCTGTAATCCCAGCAACTCAGGAAGCTGAGACAGGAGAAGTACTTGAACCCAGAAGGCAGAGGTTGCAGTGAGCCGATATTGCACCATTGCACTCCAGTCTGGGCAACAAGAGTGAAACTCTGTCTCAAAAAAAAA"
"chr3","92843764","92844668","JH378118","18053084","18053501","518","74790680","GGCTGGGTATGGTGGCTCACACCTGTAATCCCAGCACTTTGGGAGGCCGAGGCCGGTGGATCACCTGAGGTCAGGAGTTTCGGACCAGCCTGGCCAACATGGTGAAACCCCGTCTCTACTAAAAATACAAAAATTAGGGCTGGGCGTGGTGGCTCGCGCCTGTAATCCCAGCACTTTGGGAGGCCAAGGCAGGCAGATCACGAGGTCAGGAGATCGAGACCATCCTGGCTAACACGGTGAAACCCTGTCTCTACTAACAACACAAAAAATTAGCCAGTTGTGGTGGCGGGCGCCTGTGGTCCCAGCTACCTGGGAGGCTGAGGCAGGAGAATGGCATGAACCTGGGAGGCGGAGCTTGCAGTGAGCCGAGATCACACCACTGCACTCCAGCCTGGGCGACAGAGCAAGACTTGGTCTCAAAAACATATATATGTATATATAAATTAGGTCTGAGCGTGGTGGCTCACGCCTGTAATCCCAGCACTTTGGGAGGCTGAGGTGGGCGGATCATGAGGTCAGGAGATCAAGACCATCCTGGCTAACACGGCGGAACTCTGTCTCTACTAAAAATACAAAAAATCAGCCGGGCGTGGTGGCACGCACCTGTAGTCCCAGCTACTCGGGAGGCTGAGGCAGGAGAATCGCTTGAACTGGGGAAGTGGTGGTTGCAGTGAGCCGAGATCGCACCACTGCACTCTAGCCTGGGTGACAGAGCGAAACTCCGTCTCAAAAAAAAAAAAAATTAGCTGGGTGTGGTGGCGGGCACATGTGATCCCTGCTACTTGGGAGGCTAAGGCAGGAGAATAGCTTGAACCTGGGATGCAGAGGTTACGGTGAGCCGTGACTACCATATCACTCCAGCCTGGGGAACGAGCGAAACTGCATCTCAAAAAAAAAATAAATAA","GGCTGGGCGCAGTGGCTCACACCTGTAATCCCAGCACTTAGGGAAGCTGAGGCGAGTAGATCACCTGAGGTCAGGAGTTAGAGACCAGCCTGGCCATCATGGTGAAACCCCGTCTCTACTAAAGATACCAAAAATTAGCTGAGTGTGGTGCTGGGTGCCTGTAATCCCAGAAACTCAGGGTGCCTGTAATCCCAGCAACTCAGGGTGCCTTTAATCCCAGCAACTGAGGGTACCAGTAATCCCAGCAACTCAGGGTGTCTTTAATCCTAGCAACTGAGGGCACCTGTAATCCCAGCAACTCAGGAAGCTGAGACAGGAGAAGTACTTGAACCCAGAAGGCAGAGGTTGCAGTGAGCCGATATTGCACCATTGCACTCCAGTCTGGGCAACAAGAGTGAAACTCTGTCTCAAAAAAAAA"
"chr3","94704573","94705174","JH378118","18053084","18053501","251","76651489","GCTGGGCGCGTTGGCTCACGCCTATAATCCCAGCACTTTGGGAGGCCAAGGCAGGTGGATCACCTGAGGTCAGGAGTTCGAGACTAGCCTGGCCAACATGGTGAAAACCCGTGTCTACTAATAATATAAAAAAAATTGCTGGGCAATTTTACAGTGCCTGTAATCCCAGCACTTTGGGAGGCCGAGGCGGGCGAATCACAAGGTCAGGAGATCGACACCATCCTGGCTAATACGGTGAAACCCCATCTCTACTAAAAATACAAAAAAATTAGCCGGGCGTGGTGGCGGGCGTCTGTAGTCCCAGCTATTCGGGAGGCTGAGGCAGGAGATAGCGTGAACCGGGGAGGCGGAGCTTGCAGTGAGCCGAGATCGCGCCACTGCACTCCAGCCTAGGCACACAGAAAGACTCCGTCTTAAAAAAAAAAAAAATTAGCTGGGCATGGTGGTGCATGCCTGTAATCTCAACTACTTGGGAGGCTGAGGGAGGAGAATCACTTGAACCCGGGAGGCGGAGGCTGCAGTGAGCCGAGATAGTGCCATTGCACTCCAGCCTGAGTGACAAGAGCGAAACTCCGTCTCAAAAAAAAAAAAAAAAAAAAAAA","GGCTGGGCGCAGTGGCTCACACCTGTAATCCCAGCACTTAGGGAAGCTGAGGCGAGTAGATCACCTGAGGTCAGGAGTTAGAGACCAGCCTGGCCATCATGGTGAAACCCCGTCTCTACTAAAGATACCAAAAATTAGCTGAGTGTGGTGCTGGGTGCCTGTAATCCCAGAAACTCAGGGTGCCTGTAATCCCAGCAACTCAGGGTGCCTTTAATCCCAGCAACTGAGGGTACCAGTAATCCCAGCAACTCAGGGTGTCTTTAATCCTAGCAACTGAGGGCACCTGTAATCCCAGCAACTCAGGAAGCTGAGACAGGAGAAGTACTTGAACCCAGAAGGCAGAGGTTGCAGTGAGCCGATATTGCACCATTGCACTCCAGTCTGGGCAACAAGAGTGAAACTCTGTCTCAAAAAAAAA"
"chr3","103008323","103008912","JH378119","32351107","32351490","263","70657216","GGCCGGGTACAGTCGCTCATGCCAGTGATTCTAGCACTTTGGGAGGCCAAGGAGGGGAGATAACTTGAGGCCAGGAGTTTGAGACCAGCCTGGCCAATATGGTAAAGCCTCGTCTCTACAAAAATACAAAAGTTAAGGCCAGGTGCGGTGGCTCACTCCTGTAATCCCAACACTTTGGAAGGCTGAGGCAGGTGGATCACCTGAGGTCAGAAGTTTGGTACCAGCCTGATCAACATGGAGAAACCCCATCTCTACTAAAAATACAAAAGTAATCAGGTGTGGTGGTGCATACCTGTAATCCCAGCTACTTAGGAGGCTGAGGCGGAAGAATCACTTGAACCCGGGAGAGGGAGGTTGCGGTGAGCCTGGATCGCCCCATTGCACTCCAGCCTGGGCAACAAAAGCAAAACTCCATCTCAGAGAAAAAAAAAATTAGTCAGGTGTGGTGGTGGGTACCTTTAATCCCAGCTACTCGAGAGGCTGAGGCAGGAGAATTGCTGCAACCTGGAAGGCAGAGTCTGCAGGCTGCAGTGAGCCAAGATTATGCCATTGCACTCCAGCCTAAGGTCTAAAAAAAAAAAAAAGAAGAA","GGCCAGGTATGGTGGCTCACACCTGTAATCCCAGCACTTTGGGAGGCCAAGGCAGGCAGACCACCTGAGGTCAGGAGTTCGAGATCAGCCTAGCCAACATGGTGAAACCCCATCTCTAGTAAAAATAAAATTAGCCAGGCATGGTGGTGCATGCCTGTAACGCAGGTCAGGAGTTCGAGATCAGCTTAGCCAACATGGTGAAACCCCATCTCTAGTAAAAATAAAATTAGCCAGGCAGGTGGTGCCGCCTGTACTCGGGAGGCTGAGGCAGGAGAATCACTTGAACCCAAGAGGCAGAGGTTGCAGTCAGCCAAGATCATGCCATTGCACTCCAGCCTAAGCAAAAAGAGTAAAACTCAGTCTCAAAACAAAAAAACAAAAAAA"
"chr3","112736871","112737495","JH378118","18053084","18053501","273","94683787","GGCCGGGTGTGGTGGTTCACGCCTGTAATCCCAGCACTTTGGGAGACTGAGGCGGGTGGATCACCTGAGGTCAGGAGTTCAAGACCAGCCTGACCAACATGGTGAAACTTCGTCTCTACTAAAAAATACAAAAAAATGGCCAGGCACAGTGGCTCACGCCTGTAATCCCAGCACTTTGGGAGGCCGAGGTGGGCAGATCACGAGGTCAGGAGATGGAGACCATCCTGGCTAATATGGTGAAACCCCATCTCTACTAAAAATACAAAAAATTAGCTGGCGTGGTGGCGGGCGCCTGTAGTCCCAGCTACTCAGGAGGCTGAGGCAGGAGAATTGTTGAATCCGGGAGGCGGAGGTTGCAGTGTGCCGAGATCGCGCCACTGCACTCCAGCCTGGTGACAGAGCGAGACTATGTCTCAAACAACAACAACAACAACAAAATACAAAAAAATTAGCCAGACGTGGTGGCAGATGCCTGTAATCCCAGCTACTCAAGAGGCTGAGGCAGGAAAATCACTTGAGTCTGGGAGGCGGAGGATGCGGTGAGCTGAGATCATGCCATTGCACTCTAGCCTGGGTGACAAGAGCAAAACTCTGTCTCAGAAAAAAAAAAAAAAAAAAAAGAAAA","GGCTGGGCGCAGTGGCTCACACCTGTAATCCCAGCACTTAGGGAAGCTGAGGCGAGTAGATCACCTGAGGTCAGGAGTTAGAGACCAGCCTGGCCATCATGGTGAAACCCCGTCTCTACTAAAGATACCAAAAATTAGCTGAGTGTGGTGCTGGGTGCCTGTAATCCCAGAAACTCAGGGTGCCTGTAATCCCAGCAACTCAGGGTGCCTTTAATCCCAGCAACTGAGGGTACCAGTAATCCCAGCAACTCAGGGTGTCTTTAATCCTAGCAACTGAGGGCACCTGTAATCCCAGCAACTCAGGAAGCTGAGACAGGAGAAGTACTTGAACCCAGAAGGCAGAGGTTGCAGTGAGCCGATATTGCACCATTGCACTCCAGTCTGGGCAACAAGAGTGAAACTCTGTCTCAAAAAAAAA"
"chr3","114573455","114573788","JH378117","16180246","16180577","59","98393209","GGCGGGGCATGGTGGCTCATGCCCCTAATCCCAGCATTTTGGGAGGCCGAGGCGGGAGGATCACCTGAGGTCAGGACTTTGAAACCAGCCTGGGCAACATGGTGAAACCCCCTTCTCTACTAAAATACAAAAAAAAAAAAAAAAAAAAAAAAAAAAATTAGCTGAGTGTGATGGCAAGCACCTGTAATCCCAGCTACTTGAGAGGCTGAGGCAGGAGAATCACTTGAACCTGGGAGAGGGAGGTTGCGGTGAGCTCAGATCGCACCATTATACTACAGCCTGGGTGACAAAAGCAAGACTCTGTACCAAAAAAAAAAAACAAAATAACAAAAAA","GGCCGGGCGCGGTAGCTCAAGCCTGTAATCCCAGCACTTTGGGAGGCTGAGGCGGGTGGATCATGAGGTCAAGAGATCGAGACCATCCTGGTCAACATGGTGAAACCCCGTCTCTACTAAAAATACAAAAAAAAAAAAAAAAAAAAAAAAAAAAAATTAGCTGGGCATGGTGGCGCTTGCCTTTAATCCCAGCTACTCAGGAGGCTGAGGCAGGAGAATCACCTGAACCCAGAAGGCGGAGGTTGCGGTGAGCTGAGATCACGCCATTGCACTCCAGCCTGGGTAACAAGAGCGAAACTCCGTCTCAAAAAAAAAAAAAAAAAAAAAAAGAA"
"chr3","115529266","115529601","JH378224","2846632","2846964","49","112682634","GGCTGGGTGCAGTGGCTCACATCTGTAATCCCAGCACTTTGGGAGGCCAAGGCAGGTGGACCACCTGAGGTCAGGAGTTCAAGACCAGCCTGGCCAACATGGTGAAACCCTGTGTCTACTAAAAATACAAAAAAAAAAAAAAAAAAAAAAAAAAATTAGCTGAGTGTGGTGGCGGGCGCCTGTAATCCCAGCTACTCGGGAGGCTGAGGCAGGAGAATTACTTGAACCCGGGAGATGGAGGTTGCAGTGAGCCGAAATTGCGCCATTGTACTCCAGCCTGTCAACAAGAGTGAAACTCTGTCTCAAAGAAAAAAAAAAACCAAACAAACAAACAAA","GGCCAGGCAGGGTGGCTTACATCTGTAATCCCAGCACTTTGGGAGGTCAAGGCGAGTGGATCACCTGAGGTCATGAGTTCAAGACCAGCCTGGCCAACTTGGTGAAACCCTGTCTCTACTAAAAATACAAAAAAAAAAAAAAAAAAAAAAAAAAAAATTAACTGGGTGTGGTGGTGCACACCTGTAATCCCAGCTACTCAGGAGGCTGAGGCAGGAGAATCCCTTGAACACGGGAGGTGGAGGTTGCAGTGAGCCGAGATCATGCCATTGCACTCCAGCCTTGGTGAAAAGAGCAAAACTCTGTCTTAAACAAAACAAAACAAAACCAGAAAA"
"chr3","130503164","130503521","JH378293","1845184","1845523","69","128657980","GGTCAGGCACAGTGGCTCATGCTTGTAATCCCAGCACTTTGGGAGGCTGAAGTGGGCAGATCACCTGAGGTCAGGAGTTCGAGACCAGCCTGACCAACATAGTGAAACCCCATCTCTACTTAAAAAAAAAAAAAAAAAAAAAAAAAATATATATATATATATATATATATATATATATATATATATATATAAATTAGCTGGGCATGGTGGCAGGCACCTGTAATCCCAGCTTCTCAGGAGGCTGAGGCAGGAGAATTGCTTGAACCCGGGAGGTGGAGGTTGCAGTGAGCTGAGATCGCGCCATTGCACTCCAACCTGGAAACAAGAGCAAGACTCTGTCAAAAAAGAAAGAAAGAAA","GGCCGGGTGCGGTGGCTCACGCCTGTAATCCCAGCACTTTGGGAGGCCAAGGCGGGTGGATCACCTGAGGTCAGAAGTTCGAGACCAGCCTGGCCAACATGGTGAAACCCCGTCTCTGCTAAAAAGAAAAAAATAAGAAAAAAACAAAATAAGAAAATAATTTTAAAAAATACAAAATTAGCTGGGCGTGGTGGCAGGCACCTGTAATTCCAGCTATTCAGGAGGCTGAGGCAGGGGAATCACTTGAACCCAGGAGGCAGAGGTTGCAGTGAGCCAAGATGACGCCATTGCACACCAGCCTGGGCAACAAGAGTGAAACTCCGTCTCAAAAAAAAAACAA"
"chr3","135918594","135919055","JH378110","30295293","30295690","188","105623301","TTAGCCAGGCATAGTGGCAGGCACCTGTAATCCCAGCTACTCAGGAAGCTGAAGTAGGAGAATCTTTTTTTTTTTTTTTTGAGATGGAATCTTGATCTGTTGTCCAGGCTGGCGTGCAGTGGCGCAACCTCTGCCTCCTGGGTTCAAGCAATTCTCCTGCCTCAGCCTCCCGAGTAGCTGGGATTAAAGGTGCCCGCCACCACGCCCGGCTAATTTTTTTGTATTTTTAGTAGAGACGGGGTTTCACCATGTTGGTCAGGCTGGTTTTGAACTCCTGACCTCAAGTGATCCACCTGCCTTGGCCTCCCAAAGTGTTAGGATTACAGGCGTGAGCCACCGTGCCAGGCCGAGAATCACTTGAACCTGAGAGGTAGAGGTTGTAGTAAGCCGAGATGGTGCCATTGCGCTCCAGCCTGAGCAACAAGAGTGAAACTCCATCTCAAAAATAAATAAATAAATAAA","GGCTAGGCATGGTAGCTTACGCCTGTAATCCCAGCACTTTGGGAGGCCGACGCAGGCAGATCACTTGAGATCAGGAATTGAGACCAGGAGTTTGAGACCAGCCTGGCCAACATGGTGAAACCCTGACTCTACTAAAAATACTCTACTAAAAAAGTAGAAAAAGGGGCCAGGCACAGTGGCTTATGCCTGTAATCCAAGCACTTTGGGAGGCCGCAGCGGGCAGAGTTCGAGACCGGGCGTGGTGGTACATGCCGGTAATCCTACCTACTCAGGATGCTAAGGCAGGAGAATCGCTTGAACCCGGGAGGCAGAGGTTTCAGTGAGCTGAGATTGCACAATTTCACTCCATCCTGGAGAACAAGAGCGAATCTCAGTCTCAAAAAAAAAAAAAAAAAAGA"
"chr3","135938507","135939077","JH378118","18053084","18053501","247","117885423","GTGATGGCTCACGCCTGTAATCCTAGCAAAGGGGGTGGTGGATCACCTGATGTCAGGAGTTCGAGACCAGCATGGTGAAACCCCATCCATACTAAAAATACAAAAATTAGGCCGGGCATGGTGGCTCACGCCTGTAATCCCAACACTTTGGGAGGCTGAGGCGGGTGGATCACCCGAGGTTGGGAGCTCAAGACCAGCCTGACTAACATGGAGAAACCCCATCTCTACTAAAAATACAAAATTAGCTGGATGTGGTGGCGCAGGCCTGTAATCCCAGCTACTTGGGAGGATGAGGCAGGAGAATCCCTTGAACCCGGGAGGCAGATGTTGCGGTGAGCCGAGATCAAGCCATTGCACTCCAGCCTGGGCAATGAGAGTGAAACTCCGTCTCACAAAAAAAAAAAAAAAAAAAAAATTAGATGGGCATGGTGGTGGGCACCTGTAATCCCAGCTACTTGGGAGGATGAGGCAGGAGAATCACTTGAACCCGGGAGATGGAGGTTTCAATGAGCCGAGATTGAGCCATTGCACTCCAGCCTGGGCAACAAGAGTGAAACTCCATCTCAAAAAA","GGCTGGGCGCAGTGGCTCACACCTGTAATCCCAGCACTTAGGGAAGCTGAGGCGAGTAGATCACCTGAGGTCAGGAGTTAGAGACCAGCCTGGCCATCATGGTGAAACCCCGTCTCTACTAAAGATACCAAAAATTAGCTGAGTGTGGTGCTGGGTGCCTGTAATCCCAGAAACTCAGGGTGCCTGTAATCCCAGCAACTCAGGGTGCCTTTAATCCCAGCAACTGAGGGTACCAGTAATCCCAGCAACTCAGGGTGTCTTTAATCCTAGCAACTGAGGGCACCTGTAATCCCAGCAACTCAGGAAGCTGAGACAGGAGAAGTACTTGAACCCAGAAGGCAGAGGTTGCAGTGAGCCGATATTGCACCATTGCACTCCAGTCTGGGCAACAAGAGTGAAACTCTGTCTCAAAAAAAAA"
"chr3","135953479","135954073","JH378118","18053084","18053501","239","117900395","GGCTGGGCATAGTGGCTTACACCTGCAATCCCAGCCCTTTGGGAGGCCAAAGCAGGCATATCACCTGAAGTCAGGAATTCACGACCAGCCTGGCCAACATGGTGAAACCCCATCTCTACTAAAAACACAAAAATTAGGGCCAGGCATGGTGGCTCACACCTATAATCCCAGCACTTTGGGAGGCTGAGGCAGGTGGATCACCCAAGGTCAGGAGTTGAGACCACCCTGGCCAACATGGTGAAACCCCCGTCTCTACTAAAAATGCAGAAATTAGCCAGGCATGACGGCACGTGCCTGTAATCCCAGCTACTCAGGAGGCTGAGGCAGGAGAATCACTTGAACCTGGAAGGCGGAGGTTGCAGTGAGCTGAGATCTCGCCATTGCACTCCAGCCTGGGTGTCACAGCAAGACTCTGTCTAACAAAAAAAAAAAAGAAAAAGTAGGCATGTGTAGTGGCAGGCCCCTGTAATCCCAGCTATTTGGGAAGCTGAGGCAGGAGAATCACTTGAATCTGGAAGGCAGAGGTTGCAGTGAGCCGAGACTGCACCATTGCACTCCAGCCTGGGCAACAAGAGCGAAACTTTGTCTCAAAAAA","GGCTGGGCGCAGTGGCTCACACCTGTAATCCCAGCACTTAGGGAAGCTGAGGCGAGTAGATCACCTGAGGTCAGGAGTTAGAGACCAGCCTGGCCATCATGGTGAAACCCCGTCTCTACTAAAGATACCAAAAATTAGCTGAGTGTGGTGCTGGGTGCCTGTAATCCCAGAAACTCAGGGTGCCTGTAATCCCAGCAACTCAGGGTGCCTTTAATCCCAGCAACTGAGGGTACCAGTAATCCCAGCAACTCAGGGTGTCTTTAATCCTAGCAACTGAGGGCACCTGTAATCCCAGCAACTCAGGAAGCTGAGACAGGAGAAGTACTTGAACCCAGAAGGCAGAGGTTGCAGTGAGCCGATATTGCACCATTGCACTCCAGTCTGGGCAACAAGAGTGAAACTCTGTCTCAAAAAAAAA"
"chr3","135987256","135987865","JH378118","18053084","18053501","251","117934172","GCCAGGTGCAGTGGCTCACACCTGTAATCCCAGCACTTTGGGAGGCTGAGGCGGGTGGATCACCTGAGGTCAGGAGTTCAAGACCAGCCTGGCCAACATGACAAAACCCTGTCTCCACTAAAAATACAAAAATTAAGGTCGGGCGCGGTGGCTCATGCCTGTAATCCCAGCACTTTGGGAGGCGCAGGCGGGCGGATCACAAGCTCAGGAGATCGAGACCATCTTGGCTCACACAGTGAAACCCCGCCTCTACTAAAAATACAAAAAATTAGCCAGGCGTGGTGGCGGGCGCCTATAGTCCCAGCTACTCGGGAGGCTGAGGCAGAAGAATGGCGTAAGAAAACCCAGGAGGCGGAGGTTGTAGTGAGCCTAGATCGTGCCACTGCACTCCAGCCTAGGCAACAGAGTGAGACTCCATCTCAAAAATAAAAATAAAAATAAATTAACAGGGCATGGTGGCGGGAGCCTGTAATCCCAGCTACTGGGGAGCCTGAGGCAGGAGAATCACTTGAACCTGGGTGGTGGAGGTTGCAGTGAGCTGAGATCGCGCCATTGCACTCCAGCCTGGGCAACAAGAGCGAAACTCCATCTCCAAAAAAAAAAAAAAAAA","GGCTGGGCGCAGTGGCTCACACCTGTAATCCCAGCACTTAGGGAAGCTGAGGCGAGTAGATCACCTGAGGTCAGGAGTTAGAGACCAGCCTGGCCATCATGGTGAAACCCCGTCTCTACTAAAGATACCAAAAATTAGCTGAGTGTGGTGCTGGGTGCCTGTAATCCCAGAAACTCAGGGTGCCTGTAATCCCAGCAACTCAGGGTGCCTTTAATCCCAGCAACTGAGGGTACCAGTAATCCCAGCAACTCAGGGTGTCTTTAATCCTAGCAACTGAGGGCACCTGTAATCCCAGCAACTCAGGAAGCTGAGACAGGAGAAGTACTTGAACCCAGAAGGCAGAGGTTGCAGTGAGCCGATATTGCACCATTGCACTCCAGTCTGGGCAACAAGAGTGAAACTCTGTCTCAAAAAAAAA"
"chr3","138993232","138993762","JH378113","5810610","5810991","232","133182622","GTTCATGCCTGTAATTCCAGCACTTTGGGAGGCCGAGGCGGGAGGATCACCTGAGGTCAGAAGTTCAAGACCAGCCTGGCCAACATAGTGAAACTCTGTCTCTATTAAAAACACAAAAATTAGGCCGGGCGCGGTGGCTCACGCCTGTAATCCCAGCGCTTTGGGAGGCCGAGGCAGGTGAATCACCTGAGATCAGGAGCTCAAGACCAGCTTGGCCAACATGGTGAAACCCTGTCTCTACTAAAAGTACAAAAATCAGCCGGCTGTGGAGGCAGGCACCTGTTATCCCAGCTACTCAGGAGGCTGAGGCAGGAGAATCACTCGAACCCGGGAGGTGGGGGTTGCAGTGAGTGGAGGTCATGCCACTATACTCCAGCCTGGGCAACAGAGCAAAACTCGGTTTAAAAAAAAAAAAAAATTAGCCAGGCATGGTGGTGGGTGCTGGTAATCCCAGCTACTTGGGAGGCTGAGGTAGGAGAATTGCTCAAACCCGGGAGGCGGAGGTTGAGTTGAGCACCATTGCACTTCAGC","GTTCAGGCCTGTAATCCCAGCACTTTGGGAGACCAAGGCAGGCGAATCACCTGAGGTCAGGAGTTCAAGACCAGTCTGGCTAATATGGTGAAACCCCATCTCTGCTAAAAATACAAAAAAAAAAAAAAAAAAAAAAAAAAGATTAGCCAGTGCCAGGCTAATTAGCATGGTGGTAGGTGCCTGTAATCCCAGCTAAAAAAAATTAGCGTGGTGGCAGGCACCTGTAATACCAGCTACTCGGGAGGCTGAGGCAGGAGAAGCGTTTTTACCTGGGAGGCCGAGGTCGCAGTGGGTGGAGGTTGCAGTGAGCCGAGATTACTCCAGCCTGGGCAAGAAGAGCAAAACTCCATCTCAAGAAAAAAGAAAAAGAAAGAAAAGAAAA"
"chr3","153299780","153300382","JH378118","18053084","18053501","251","135246696","GGCCGAACACAGTGGCTCACGCCTGTAATCCCAGCACTTTGGGAGGCTGAGTGGGGCGGATCACTTGAGGCCAGGAGTTCGAGACCAGCCTGGCCAACATGATGAAACCCCATCTCTACTAAATATACAAAATCAGTGGCCAGGCGTGGTGGCTCACGCCTGTAATCCCAGCACTTTGAGAGGCAAGGCAGGCGGATCACAAGGTCAGGAGTTTGAGACCAGCCTGACCAACATGGTGAAATCCCATCTCTATAAAAATACAAAAACTAGCCGGGCATGGTGGCACACGCCTGTAATCCCAGCTACTCACAAAGTTGAGGCAGGAGAATCGCTTGAACCCTGGAGGCAAAGTTTGCAGTGAGCCAAGATTGCACCACTGCACTCCAGCCTGGACGGCAGAGTGAGACTCCTTCTCAAAAAAAAAAAAAAAACTAGCTGGGCATGGTGGTGCATGCCTGTAATCCCAGCTACTCGGGAGGCTGAAGCAGGAGAATCGCTTGAACCCAGCAGGCGAAAGTTGCAGTGAGCCGAGATCTCTCCATTGTACTCCAGCCTGGGTGACAAGAACAAAACTCCACCTCCAAAAAAAAAAAAAAAAACAAA","GGCTGGGCGCAGTGGCTCACACCTGTAATCCCAGCACTTAGGGAAGCTGAGGCGAGTAGATCACCTGAGGTCAGGAGTTAGAGACCAGCCTGGCCATCATGGTGAAACCCCGTCTCTACTAAAGATACCAAAAATTAGCTGAGTGTGGTGCTGGGTGCCTGTAATCCCAGAAACTCAGGGTGCCTGTAATCCCAGCAACTCAGGGTGCCTTTAATCCCAGCAACTGAGGGTACCAGTAATCCCAGCAACTCAGGGTGTCTTTAATCCTAGCAACTGAGGGCACCTGTAATCCCAGCAACTCAGGAAGCTGAGACAGGAGAAGTACTTGAACCCAGAAGGCAGAGGTTGCAGTGAGCCGATATTGCACCATTGCACTCCAGTCTGGGCAACAAGAGTGAAACTCTGTCTCAAAAAAAAA"
"chr3","155000926","155001240","JH378106","62104717","62105046","64","92896209","GACTCATGCCTGTAATCCCAGCACTTTAAGAGGCCAAGCTCGGCAGATGGATCACCTGAGGTCAGGAGTTCGAGACCAGCCTGGCCAACACGGCGAAACCCTGTCTCTACTAAAAATACAAAAATTAGCTGGCCATGGTGGCAGGCGCTTGTAATCCCAGCTACTTGAGAGGCTGAGGCAGGAGAATCTCTTGAACCTAGAAAGTGGAGGTTGCATTGAGATCGTGCGATTGCACTCCAGGCTGGGTGACAAGAGCGAAACTCCATCTCAAAACAAACAAACAAACAAACAAACAAACAAAAAATTAAAAAAAAA","GAGTGCTGTGGCTCAGGCCCGTAATCTCAGCACTTTGGGAGACCAAGGTGAGTGGATCACCTGAGGTCAGGAGTTTGAGACCAGCCTGGCCAACATGGTGAAACCCCGTCTCTACTAAAAATACAAAATTATCTGGGTGTGGTGGCAGGCACCTGTAATCCCAGCTACTTGGGAGGCTGAGGCAGGAGAATCACTTGAACCCAGGAGGTGGAAGTTGCTATAAGCTGAGATCGTGCCATTGCACTCCAGCCTGGTGACAAGAGTGAAATTCCATCTCAAAAAAAAAAAAAAAAAAAGAGAGAGAGAGAAAGAAAGAAAAAAGAAAAGAAA"
"chr3","174995270","174995887","JH378118","18053084","18053501","269","156942186","GGCCGGGAGCAGTGGCTCACGCCTGTAATCCCAGCGCTGTGGGAGGCCACGGCGGGCAGATCACCTGAGGTCAGGAGTTTGAGATGATCCTGGCCAACATGGTGAAACCCTATCTCTACTAAAAATACAAAAATTAGCCAGGCAGGCAGGGCACAGTGGGTCACGCCAGTAATCCCAGCACTTTGGGAGGCCAAGGCAGGTGGATCACCAGAGGTCAGGAGTTTGAGACCAGCCTGGCCAACACGGAGAAACCCCGTCTCTACTAAAAATACAAAAATTAGCCAGGTGTGGTGGCGGGCACCTGTAGTCCCAGCGACTCAGAAGGCTGAGGCAAGAGAATCGCTTGACCCCAGGAGGCAGAGGTTGCAGTGAGCTGAGATCGCACCACAGCACTCCAGCCTGGGCAAAAGAATGAGACTCCATCAAAAAAATTAAAAAAAAAAAAAAAAAAAATTAGCCAGGCATGGTGGTGGACGCCTATAATCTCAGCTATCCAGGAGGCTGAGGCAGGAGAATCACTTGAACACAGCAGGTGGAGGTTGCAATGAGCCAAGATCGCCCCATTTCACTCCAGCCTGGGCGAAAGAGAGAAACTCCGTAACCAAAAAAAAAAAAAAA","GGCTGGGCGCAGTGGCTCACACCTGTAATCCCAGCACTTAGGGAAGCTGAGGCGAGTAGATCACCTGAGGTCAGGAGTTAGAGACCAGCCTGGCCATCATGGTGAAACCCCGTCTCTACTAAAGATACCAAAAATTAGCTGAGTGTGGTGCTGGGTGCCTGTAATCCCAGAAACTCAGGGTGCCTGTAATCCCAGCAACTCAGGGTGCCTTTAATCCCAGCAACTGAGGGTACCAGTAATCCCAGCAACTCAGGGTGTCTTTAATCCTAGCAACTGAGGGCACCTGTAATCCCAGCAACTCAGGAAGCTGAGACAGGAGAAGTACTTGAACCCAGAAGGCAGAGGTTGCAGTGAGCCGATATTGCACCATTGCACTCCAGTCTGGGCAACAAGAGTGAAACTCTGTCTCAAAAAAAAA"
"chr3","175221690","175222150","JH378108","4185732","4186071","167","171035958","GCCAGGTATGGTGGCTCATGCCTGTAATCCCAGCACATTGGGAGCCCAAGGCAGGTGGATCACCTGAGGTCAGGGGTTTGAGACCACCAGCCTGGCCAACATAGTGAAACCCCGTCTCTACTAAAAATATCTAAATTAGCTGAGTGTGGTGGTGTGCATCTCTGGTCCCAGCTACTCAGGAGGCTGAGGCAGGAGAATCGCTTGAACCCAGGAGGTGGAGGTTGCAGTAAGCCGAGATCGCACCATTGCACTCCAAACTGGGTGAGAAGAGTGAAACTCTGTCTCATAAAAATGAAAGAAAGAAAGAAAGAAAGAAAGAAAGAAAGAAAGAAAGAAAGAAAGAAAGAAAGAAAGAAGAAAGAAAGAAAGGAAGGAAGGAAGGAAGGAAGGAAGGAAGGAAGGAAGGAAGGAAGAAAGAAAGAAGGAAAGAAAGAAAGAAAGAAAGAAAAAGAAAAAGAAAA","GGCTGGGTGCGGTGGCTCACGCCTGTAATCCCAGTACTTTGGGAGGCCGAGGCGGGTGGATCATGAGGTCAGAAGATAGAGACCATCCTGGTCAACATGGTGAAACCCCGTCTCTATTAAAAATACAAAAAATAGCTGGGCCTGGTGGCGTATGCCTGTAATCCCAGCTACTCAGGAGGCTGAGGCAGGAGAATTGCCTGAACCCAGGAGGTGGAGGTCGCAGTGAGCCGAGATCGCGCCATTGCACTCCAGCCTGGGTAACAAGAGTGAAACTCCATCTCAAAAAAAAAAAAAAAAGAAAGAAAAAAAGAAAAGAAAAGAAAAAAAGAAAAAAAAGAAA"
"chr3","179489730","179490296","JH378118","18053084","18053501","229","161436646","CAGCACTTTGGGAGGCTAAGGTGGATCACCTGAGGTCAGGAGTTCGAGACCAGCCTAGTTAATGTGATGAAACCCCATCTCTACTAAAAATATAAAAAGCCTGGTGTGGTGGCTCATGCCTGTAATCTCAGCACTTTGGGAGGCCGAGGCGGGTGGATCACCTGAGGTCAGGAGTTTGAGACCAGCCTGGCCAATATGGTGAAACCCCGTCTTTACTAAAAATACAAAAAATTAGCCAGGCGTCATGGCGGGCACTTGTAATCCCAGCTAATCGGGAAGCTGAAGCAGGAGAATCACTTGAACCTGGGAGGCAGAGGTTGCAATGAGCCAGGATCACGCCATTGCACTCCAGCCTGGGCGACAAGAGTGAGACTCCGTCTCAAAAAAAAAAAAAAAAAAAAATTAGCTGGGTGTGGTGGTGGGCATCTGTAATCCCAGCTACTTGGGAGGCTGCGGCAAGAGAATTGCTTGAACCCGGGAGGCAGAGGTTGCAGTGAGCCAAGACTGCACCATTGCACTCCAGCCTGGGCAACAAGAGCAAAACTCTGTCTCAAAAAAAAGAAAAAA","GGCTGGGCGCAGTGGCTCACACCTGTAATCCCAGCACTTAGGGAAGCTGAGGCGAGTAGATCACCTGAGGTCAGGAGTTAGAGACCAGCCTGGCCATCATGGTGAAACCCCGTCTCTACTAAAGATACCAAAAATTAGCTGAGTGTGGTGCTGGGTGCCTGTAATCCCAGAAACTCAGGGTGCCTGTAATCCCAGCAACTCAGGGTGCCTTTAATCCCAGCAACTGAGGGTACCAGTAATCCCAGCAACTCAGGGTGTCTTTAATCCTAGCAACTGAGGGCACCTGTAATCCCAGCAACTCAGGAAGCTGAGACAGGAGAAGTACTTGAACCCAGAAGGCAGAGGTTGCAGTGAGCCGATATTGCACCATTGCACTCCAGTCTGGGCAACAAGAGTGAAACTCTGTCTCAAAAAAAAA"
"chr3","180414084","180414406","JH378271","2122362","2122678","44","178291722","GGCCGGGCACGGTGGCTCACGCTTGTAATCTCAGCACTTTGGGAGGCCTAGGTGGGTGGATCACTTGAGGACAGGAGTTCAAGACCAGCCTGGCCAACATGGTGAAAGCCGTCTCTACTAAAAATACAAAAAAAAAAAAAAAAAAAAAAAAAAAAAAAAATTAGCTGGGCATGGTGATGGGCACCTGTAATCCCAGCTACTCAGGAGGCTGAGGCAGGAGAATCTCTTGAACCCAGAAGGCGGAGGTCGCAGTGAGCCGAGATCACACCATTGCAATCCAGCCTGGACAACAATAGTGAAACTCTGTCTCAAAAAAAAAAGAA","GGCCGGGCACGGTGGCTCACACCTGTAATCCCAGCACTTTGGGAGGCTGAGGTGGGTGAATCACCTGAGGTCAGGAGTTTGAGACCAGCCTGACCAACATGATGAAACCCGGTCTCTGCTAAAAATACAAAAAAAAAAAAAAAAAAAAAAAAAAAAAGCTGGGCATGATGGTGGGCACCTGTAATCCCAGCTACTCGGGAGGCTGAGGCAGGAGAATCGCTTGAACACCAGGAGGTGGAGGTTGCTATGAGCCGAGATCGCACCATTGCACTCTAGCTTGGGCAACAAGAGAGAAACTCCATCAAAAAAAAAAAAAA"
"chr3","180972366","180973031","JH378118","18053084","18053501","298","162919282","GGCCGGGTGCGGCGGCTCACGCCTGTAATCCCAGCACTTTGGGAGGCCGTGGCGGGTGGATTATCTGAGGTCAGGAATTCAAGACCAGCCTGGCCAACATAGTGAAACCCCCGTTTCTACTAAAAATATAAAAATTAGGCTGGGCACGGTGGCTCACACCTGTAATCCTGGCACTTTGGGAGCCTGAGGTGGGCAGATCACGAGGTCAGGAGATCGAGACCATCCTAGCTAACACGGTGAAACCCCATCTATACTAAAAATATAGTAGTAGTCCCAACTACTGTAGTCCTGTAGTCCCAGCTACTCGGGAGGCTGAGGAGTTCACTCAGGAGAATGGCATGAACCCGGGAGGCAGAGCTTGCAGTGAGCAGAGATGGCGCCACTGCACTCCATCCTGGGTGACAGAGCGAGACTCCGACTCAAAAAAAAAAATATATATATATATATATACACACACACACACACACATATATATATAGATATATATATAAATAAATTAGCTGGGCATGGTGGTGGGTGCCTGTAATCCCAGCTACTCAGGAGGCTGAGGCAGGAGAATTGCTTGAACCTGGGAGGCAGAGGTTGCAGTGAGCAGAGATTACGCCATTGCGCTCCAGCCTGGGCCACAAGAGCAAAACTCTGTCTCAACAACAAGAACAACAAGAA","GGCTGGGCGCAGTGGCTCACACCTGTAATCCCAGCACTTAGGGAAGCTGAGGCGAGTAGATCACCTGAGGTCAGGAGTTAGAGACCAGCCTGGCCATCATGGTGAAACCCCGTCTCTACTAAAGATACCAAAAATTAGCTGAGTGTGGTGCTGGGTGCCTGTAATCCCAGAAACTCAGGGTGCCTGTAATCCCAGCAACTCAGGGTGCCTTTAATCCCAGCAACTGAGGGTACCAGTAATCCCAGCAACTCAGGGTGTCTTTAATCCTAGCAACTGAGGGCACCTGTAATCCCAGCAACTCAGGAAGCTGAGACAGGAGAAGTACTTGAACCCAGAAGGCAGAGGTTGCAGTGAGCCGATATTGCACCATTGCACTCCAGTCTGGGCAACAAGAGTGAAACTCTGTCTCAAAAAAAAA"
"chr3","181830908","181831502","JH378118","18053084","18053501","239","163777824","GGCTGGGCTCAGTGGCTCACACCTGTAATCCCAGCACTTCGGGAGGCCGAGGCAGGTGAATCACCTGAGGTCAGGAGTTCAAGACCACCCTGGCCAACATAGTGGACCCCCGTCTCTATTAAAAATACAAAAAAGCCAGGCGTGGTGGCTCACGCCTGTAATCCCAGCACTTTGGGAGGCCAAGGTGGGTGGGTCCCCTGAGGTCAGGAGTTCGAGACCAGCCTGGCCAACTTGATGAAACCCCATCTCTACTAAAAATACAAAAATTAGCTGGGCCTGGTGGCAGGTGCCTGTAATCCCAGCTACTCAGGAGGCTGAGGCAGGAGAATCGCTTGAACCTGGGAGGCAGAGGTTGCGGTGAGCCGAGATCGCGCCATTGCACTCCAGCCTGGGAGACAAGAGTGAGACTTCATCTCAAAAAAAAAAAAAATACAAAAATTTAGCCGGGCATGGTGGTGGGCACCTGTAATCCCAGCTACTCAGGAGGCTGAGTCAGGAGAATTGCGTGAACCCAGGAGGCGGAGGTTGCAGTGAGCCGAGATCACGCCCTTGCACTCCAACCTGGGTGACAAGAGCGAAACTCTTTCTCAAAAAA","GGCTGGGCGCAGTGGCTCACACCTGTAATCCCAGCACTTAGGGAAGCTGAGGCGAGTAGATCACCTGAGGTCAGGAGTTAGAGACCAGCCTGGCCATCATGGTGAAACCCCGTCTCTACTAAAGATACCAAAAATTAGCTGAGTGTGGTGCTGGGTGCCTGTAATCCCAGAAACTCAGGGTGCCTGTAATCCCAGCAACTCAGGGTGCCTTTAATCCCAGCAACTGAGGGTACCAGTAATCCCAGCAACTCAGGGTGTCTTTAATCCTAGCAACTGAGGGCACCTGTAATCCCAGCAACTCAGGAAGCTGAGACAGGAGAAGTACTTGAACCCAGAAGGCAGAGGTTGCAGTGAGCCGATATTGCACCATTGCACTCCAGTCTGGGCAACAAGAGTGAAACTCTGTCTCAAAAAAAAA"
"chr3","183034927","183035263","JH378228","5665092","5665424","48","177369835","GCCGGGTGCGGTGGCTCGTGCCTGTAATCCCCGCACTTTGGGAGGTTGAGGCGGGTGGATCACCTGAGGACAGGAGTTCGAGACCAGCCTGGCCAACATGGTGAAACCCTGTCTCTACTAAAAATACAAAATTAGCCGGGTGTGTGCGGTGGTGCATACCTGTAATCCCAGCTACTTAGGAGGCTGAGGCAGGAGAATTGCTTGAACCTGGGAGGCGGAGGTTGCAGTGAGCCGAGATTGTGTCATTGCATTCCATCCTGGGCAACAAAAGCAAAACTCCGTCTCAAAAAATAAATAAATAAATAAATAAATAAAAGAAAAGAAAAAGAAAGATAAA","GGCCGGGCGCGGTGGCTCAAGCCTGTAATCCCAGCACTTTGGGAGGCTGAGGCGGGTGGATCACGAGGTCAAGAGATCGAGACCATCCTGGTCAACATGGTGAAACCCTGTCTCTACTAAAAATACTAAAAATTAGCTGGGCATGGTGGCGTGTGCCTGTAATCCCAGCTACTCAGGAGGCTGAGGCAGGAGAATTGCCTGAACCCAGGAGGCGGAGGTTGCGGTGAGCCGAGATCGCGCCATTGCACTCCAGCCTGGGCAACAAGAGCGAAACTCTGTCTCAAAAAAAAAAAATAAATAAATAAAATAAAATAAAATAAAATAAAATAAAAT"
"chr3","183168560","183168905","JH378106","31557967","31558303","56","151610593","GGCTGGGCACAGTGGTTCATCCTGTAATCCCAGCACTTTGGGAGGCCGAGGCAGGCGGATCGCCTGAGGTCAGGAGTTTGAGACAAGCCTGGCCAACATGGTGAAACCCTGTCTCTACTAAAAATACAAAATTAGCCAGGTGTGGTTGCGGGTGCCTGTAATCCCAGCTACTCGGGAGGCTGAGGCAGGAGAATCGCTTGAACCTGGGAGGTGGAGATTGCAGTGAACCGAGATTGTGCCATTGCACTCTAGCCTGGGCAAAAAGAGCAAAACTCTGTCAAAAAAACAAACAAAACAAAACAAAACAAAACAAACCAACAGACCAAAAAAAAAAAAAAAAAAAGAA","GGCCGGGCGCGGTGGCTCAAGCCTGTAATCCCAGCACTTTGGGAGGCCGAGGCGGGTGGATCACAAGGTCAAGAGATCGAGACCAACCTGGTCAACATGGTGAAAGCCCGTCTCTACTAAAAATACAAAAATTAGCTGGGCATGGTGGCGCGTGCCTATAATCCCAGCTACTCAGGAGGCTGAGGCAGGAGAATTGCCTGAACCCAGGAGGTGGAGGTTGCAGTGAGCGAGATTGCGCCATTGCACTCCAGCCTGGGTAACAAGAGCGAAACTCCGTCTCACAAAACAAAACAAAACAAAACAAAACAAAACAAAACAAAAAACAAACAAAAAAAAA"
"chr3","183199214","183199807","JH378118","18053084","18053501","226","165146130","GGCCGGGCACGGTGGCTCACACCTGTAATCCCAGCACTTTGTGAGGCCGAGGTGGGTGGATCACCTGAGGTCAGGAGTTTGAGACCAGCCTGGCCAACATGGTGAAACCCTGTTTCTACTAAAAATACAAAAAATTGGCTGGGCGTGGTGGCTCACGCCTGTAATCCCAGCACTTTGGGAGGCTGAGGTGGGAGGATCATGAGGTCAGGAGATTGAGACCATCCTGGCTAACACGGTGAAGCCCCGTCTCTCCTAAAAATACAAAAAATTAGCCAGGCATGGTGGTGGGCGCCTGTAGTCCCAGCTACTCGGGAGGCTGAGGCAGGAGAATCACTTGAACCCAGGAGGCAGAGGTTGCAGTGAGTCAAGATCGTGCCACTGCACTCCAGCCTGGACGACAGAGCGACACTCTGTCTCCAAAAAAAAAAAAAAAAAAATTAGCCGGGCGTGGTGGCACATGCCTGTAATCCCAGCTACTCAGGAGGCTGAGGCGGGAGAATTGCTTGAACCCAGGAGGCAGAGGTTGCAGTGAGCTGAGATTGCGCCATTGCACTCCAGCCTGGGCAACAAGAGTAAAACTCTGTCTCAAAAAAA","GGCTGGGCGCAGTGGCTCACACCTGTAATCCCAGCACTTAGGGAAGCTGAGGCGAGTAGATCACCTGAGGTCAGGAGTTAGAGACCAGCCTGGCCATCATGGTGAAACCCCGTCTCTACTAAAGATACCAAAAATTAGCTGAGTGTGGTGCTGGGTGCCTGTAATCCCAGAAACTCAGGGTGCCTGTAATCCCAGCAACTCAGGGTGCCTTTAATCCCAGCAACTGAGGGTACCAGTAATCCCAGCAACTCAGGGTGTCTTTAATCCTAGCAACTGAGGGCACCTGTAATCCCAGCAACTCAGGAAGCTGAGACAGGAGAAGTACTTGAACCCAGAAGGCAGAGGTTGCAGTGAGCCGATATTGCACCATTGCACTCCAGTCTGGGCAACAAGAGTGAAACTCTGTCTCAAAAAAAAA"
"chr3","184496219","184496830","JH378118","18053084","18053501","264","166443135","GGCCGGGAGCAGTGGCTTATGCTTGTAATTCCAGCACTTTGGGAGGCTGAGGTGGGCAGATCACCTGAGGTCAGGAGTTTGAGACCACCCTGGCCAACATGGTGAAACCCTGTCTCTACTAAAAATACAAAAATTGCCGGGTGCGGTGGCTCACGCCTGTAATCCCAGCACTTTGGGAGGCCGAGGCGGGCGGATCACAAGGTCAGGAGATCGAGACGGTCCTGGCTAACAGGTGAAACCCCGTCTCTACTAAAAATACAAAAAATTATCCGGGCGTGGTTGCAGGCAACTGTAGTCCCAGCTACTCGGGAGGCTGAGGCAGGAGAATGTCCAGAACCCGAGAAGCGGAACTTGCAGTGAGCCGAGATCGCGCCACTGCACTCCAGCCTGGGCGACAGAACGAGACTCCACCTCAAAAAAAAAAAAAAAAAAAATTAGCCGGGCGTGGTGGTGTGTGCCTATAATTCCAGCTACTCAGGAGGCTGAGGCATGAGGATCACTAGAACCTGGGAGGCGGAGGATGTAGTGAGCCGAGATCATGCCATTGCACTCCAGCCTGGGCGACAAGAGAAAAACTCCATCTCAAAAAAAAAAAAAAAAAAAAAAAAAAAA","GGCTGGGCGCAGTGGCTCACACCTGTAATCCCAGCACTTAGGGAAGCTGAGGCGAGTAGATCACCTGAGGTCAGGAGTTAGAGACCAGCCTGGCCATCATGGTGAAACCCCGTCTCTACTAAAGATACCAAAAATTAGCTGAGTGTGGTGCTGGGTGCCTGTAATCCCAGAAACTCAGGGTGCCTGTAATCCCAGCAACTCAGGGTGCCTTTAATCCCAGCAACTGAGGGTACCAGTAATCCCAGCAACTCAGGGTGTCTTTAATCCTAGCAACTGAGGGCACCTGTAATCCCAGCAACTCAGGAAGCTGAGACAGGAGAAGTACTTGAACCCAGAAGGCAGAGGTTGCAGTGAGCCGATATTGCACCATTGCACTCCAGTCTGGGCAACAAGAGTGAAACTCTGTCTCAAAAAAAAA"
"chr3","187874783","187875388","JH378118","18053084","18053501","258","169821699","GGCTGGGCACAGTGGCTCACACCTGTAATCCCAGCACTTTGGGAGGCCAAGGTGGGCGGATCACTTGAGGTCAGGAGTTTGAGACCGCCTGGCCAAAATGGCGAAACCCTGTCTCAACTAAAAATGTAAAAGATTAGCCGGGCGTGGTGGCTCACACCTGTAATCCCAGCACTTTGGGAGGCCAAGGCGGGTGGATCACAAGGTCAGGAGATCGAGACTATCCTGGCTAACACGGTGAAACCTCGTCTCTACTAAAAATACAAAAAATTAGCCGGGCGTGGTGACGGGCGCCTGTAGTCCCAGCTACTCGGGAGGCTGAGGCAGGAGAATGGTGTGAACCCGGGAGGCGGAGCTTGCAGTGAGCCAAGATTGCGCCACTGCACTCCAGCCTGGGCGACAGAGCGAGACTTTGTCTCAAAAAAAAAAAAAAAAAATGTAAAAGATTAGCTGGGCGTGGTGGCAGGCGCCTGTAATCCCAGCTACTAGGGAGGCTGAGGCAGAAGGACTGCTTGAGCCTAGGAGGTGGAGGTTGCAGTGAGCCAAGATCGCTCCACTGCCCTCCAGCCTGGGTGACAAGAGTGAGACTTTGTCACAAAAAGAAAAGAA","GGCTGGGCGCAGTGGCTCACACCTGTAATCCCAGCACTTAGGGAAGCTGAGGCGAGTAGATCACCTGAGGTCAGGAGTTAGAGACCAGCCTGGCCATCATGGTGAAACCCCGTCTCTACTAAAGATACCAAAAATTAGCTGAGTGTGGTGCTGGGTGCCTGTAATCCCAGAAACTCAGGGTGCCTGTAATCCCAGCAACTCAGGGTGCCTTTAATCCCAGCAACTGAGGGTACCAGTAATCCCAGCAACTCAGGGTGTCTTTAATCCTAGCAACTGAGGGCACCTGTAATCCCAGCAACTCAGGAAGCTGAGACAGGAGAAGTACTTGAACCCAGAAGGCAGAGGTTGCAGTGAGCCGATATTGCACCATTGCACTCCAGTCTGGGCAACAAGAGTGAAACTCTGTCTCAAAAAAAAA"
"chr3","189102251","189102868","JH378118","18053084","18053501","259","171049167","GGCCAGGAGCAGTGGCTTATGCCTGTAATCACTGCACTTTGGGAGGCAGAGGCCAGCAGATCACTTGAGGTCAGGAGTTCGAGACCAGCCTGGCCAAAATGGTGAAACCCCGTCTCTACTAAAAATATAAAAAATTGCCGAGCACGGTGGCTCACGCCTGTAATCCCAGCACTTTGGGAGGCCAAGGCGGGTGGATCACGAGGTCAGGAGATCGAGACCATCCTGGCTAACACGGTGAAACCCCATCTCTACTAAAAATACAAAAAATTAGCTGGGCGTAGTGGCAGGCACCTGTAGTCCCAGCTACTCGGGAGGCTGAGGCAAGAGAATGTCGAGAACCCAGGAGGCGGAGCTTACAGTGAGCTGAGATCACGCCACTGCACTCCAGCCTGGGCAACAGAGCGAGACTCCATCTCAAAAAAAAAAAAAAAAAAAAAAAATTTAGCTGGGAGTGGTGGTGCATGCTTGTAATCCCAGCTACTTGGGAGGCTGAGGCAGAAGAATCACTTGAACCCAGGAGGCAGAGGTTGCAGTGAGCTGAGATCGCACCATTGCACTCCAGCCTGGGTGACAAGAGTCAAGCTCCGTCTCAAAAATAATAATAACAATAAATAAAAA","GGCTGGGCGCAGTGGCTCACACCTGTAATCCCAGCACTTAGGGAAGCTGAGGCGAGTAGATCACCTGAGGTCAGGAGTTAGAGACCAGCCTGGCCATCATGGTGAAACCCCGTCTCTACTAAAGATACCAAAAATTAGCTGAGTGTGGTGCTGGGTGCCTGTAATCCCAGAAACTCAGGGTGCCTGTAATCCCAGCAACTCAGGGTGCCTTTAATCCCAGCAACTGAGGGTACCAGTAATCCCAGCAACTCAGGGTGTCTTTAATCCTAGCAACTGAGGGCACCTGTAATCCCAGCAACTCAGGAAGCTGAGACAGGAGAAGTACTTGAACCCAGAAGGCAGAGGTTGCAGTGAGCCGATATTGCACCATTGCACTCCAGTCTGGGCAACAAGAGTGAAACTCTGTCTCAAAAAAAAA"
"chr3","193231547","193232167","JH378118","18053084","18053501","278","175178463","GGCAGGGCATGGTAGCCCATGCCTGTAATCCCAACACTTTGGGAGGCTGAGGTGGGTGGATCACCTGAGGTTAGGAGTTCGAGACCAGCCTGGCCAACATGGTGAAACCCCATCTCTACTAAAAATACAAAAATTAGGTCAGGCGCGGTGGCTCACGCCTGTAATCCCAGCACTTTGGGAGGCTGAGGCGGGTGGAGCATGAGGTCAAGAGATCGAGACCATCCTGGCCAACATGGTGAAACTCCATCCCTACTAAAAAAAATGCAAAAATTAGCTGGGTGTGATGGTGCACACCTGTAGTCTCAGCTACTCTGGAGGCTGAGGCAGAAGAATCGCTTGAACCTGGGAGGTGGAGTTTGCAGTGAGCCGAGATCACGCCACTGCACTCCAGCCTGGCAAGAGAGTGAGACTCCATCTCATAAACAAACAAACAAACAAAAACCAACAACAAAAACAAAAATTAGCCTGGCCTGGTGGTGGGTGCCTGTAATCCCAGCTACTCCAGAGGCTGAGGTAGCGAGAATTTCTTGAACCTGGCGGTGGAGGTTGCAGTGAGCCAAGATCACACCTCAGTACTCCAGCCTGGGTGACAAGAGCAAAACTAAACACCATCTCAAAAAA","GGCTGGGCGCAGTGGCTCACACCTGTAATCCCAGCACTTAGGGAAGCTGAGGCGAGTAGATCACCTGAGGTCAGGAGTTAGAGACCAGCCTGGCCATCATGGTGAAACCCCGTCTCTACTAAAGATACCAAAAATTAGCTGAGTGTGGTGCTGGGTGCCTGTAATCCCAGAAACTCAGGGTGCCTGTAATCCCAGCAACTCAGGGTGCCTTTAATCCCAGCAACTGAGGGTACCAGTAATCCCAGCAACTCAGGGTGTCTTTAATCCTAGCAACTGAGGGCACCTGTAATCCCAGCAACTCAGGAAGCTGAGACAGGAGAAGTACTTGAACCCAGAAGGCAGAGGTTGCAGTGAGCCGATATTGCACCATTGCACTCCAGTCTGGGCAACAAGAGTGAAACTCTGTCTCAAAAAAAAA"
"chr3","193647770","193648089","JH378192","5372003","5372306","57","188275767","GACTGGGTGCAGTGGCTCACTCCTGTAATCCCAGCACTTTGGAAGACTGAGGCAGACAGATCACCTGAGGTCAGGAGTTTTGAGACCAGCCTGGCCAACGTGGTGAAACCCCTTCTTAACTAAAATTACACACACACACACATACACACACACACACAAACAAATTAGCTGGGTGTGGTGGTGGGCACCTGTAATCCCAGCTACTTAGGAGGCTGAGGCAGGAGAATTGCTTGAACCCGGGAGGTGGAGGTTGCAGTGAGCCAAGATCATTCCATGGCACTCCAGCCTAGGCAACAAGAGGGAGATTCCATCTCGAAAAA","GCCGGGCATGGTGGCTCACACCTGTAATCCCAGCACTTTGGGAAGCTGAGGCAGGTGGATCACCTGAGGTCAGGAGTTCAAGACCAACCTGGCCAACATAGTGAAACCCGGTCTCTACTAAAAATACAAAAAAAAAAAAAAAAAAAAAATTAGCTGGGTGTGGTGGCAGGCGCCTGTAATCCCAGCTACTAGGAGGCTGAGGCAGGAGAATTGCTAGAACCCAGGAGGTGGAGGTTGTAGTGAGCCAAGATTGCACCATTGCACTCCAGCCTGGGCAACAAGAGTGACACTCTGTCTCAAAAAA"
"chr4","7561600","7562220","JH378118","18053084","18053501","270","10491484","GGCCAGGTGTGGTGGCTCACGCCTGCAGTCCCAGCACTTTGGGAGGCCGAGGCAGATGGATCACCTGATGTCAGGAGTTCAAGACCAGCCTGGCCAACGTGGTAAAACCTCGTCTCTACTAAAAATGCAAAAATTAGCCAGGCATGGTGGCTCATGCCTGTAATCCCAGCACTTAGGGAGGCCGAGGCTGGTGGATCACGAGGTCAGGAGATCGAGACCATCCTGGCTAACACAGTGAAATGCCATCTCTACTAAAAATACAAAAAAAATAGCCGGGTGTGGTGGCGGCCTCCTGTAGTCTCAGCTACTCGGGAGGCTGAGGCAGGAGAATGGCGTGAACCCGGGAGGTGGAGTTTGCAGTGAGCAGAGATCACGCCACTGCATTCCAGCCTGGGCAACAGAGCAAGACTCCGTCTCAAAACAAAAACAAAAACAAAATACAAAAATTAGCCAGGCGTGGTGGCATGTGCCTGTAATCCCAGCTACTTGGGAGGCTGAGGCAGGAGAATCGCCTGAACCTGGGAGGCGGAGGTTGCAGTGAGCCAAGATCATGCCATTATACTCTAGCTTGGGTGACAAGAGTGAAACTCTGTCTCAAAAAAACAAAACAAAACAAAAAAA","GGCTGGGCGCAGTGGCTCACACCTGTAATCCCAGCACTTAGGGAAGCTGAGGCGAGTAGATCACCTGAGGTCAGGAGTTAGAGACCAGCCTGGCCATCATGGTGAAACCCCGTCTCTACTAAAGATACCAAAAATTAGCTGAGTGTGGTGCTGGGTGCCTGTAATCCCAGAAACTCAGGGTGCCTGTAATCCCAGCAACTCAGGGTGCCTTTAATCCCAGCAACTGAGGGTACCAGTAATCCCAGCAACTCAGGGTGTCTTTAATCCTAGCAACTGAGGGCACCTGTAATCCCAGCAACTCAGGAAGCTGAGACAGGAGAAGTACTTGAACCCAGAAGGCAGAGGTTGCAGTGAGCCGATATTGCACCATTGCACTCCAGTCTGGGCAACAAGAGTGAAACTCTGTCTCAAAAAAAAA"
"chr4","8143343","8143684","JH378154","14497882","14498175","164","6354539","GAATCGGTTGAACCTGGGAGGCGCAGGTTGGAGTGAACTGAGATCGCGCCATTGCACTCCAGCCTGGGCGACAAGAGCAAAACTCCGTCTCAAAGAAGAGGAGGAGGAGGAGGAGGAGGAGGAGGAGGAGGAAGGAGGAGGAGGAGGGGGGAGGAAGAAGAAGAAGGAGGAGGAGGAGGAGGGGAGGAAGAAGAAGAAGAAGAAGAAGGAGGAGGAGGAGAAGGAGGAGGAGGGGGAGGAAGAAGAAGGAGGAGGAGGAGGAGGAGGAGGAAGAGGAGGAGGAGGGGAGGAAGAGAGGAGGAGGATGAGGAGGAGGAGAAAAAGAGGAAGAAAAGAGGAAGA","GCACTTTGGGAGGCTGGAGCAGGCAAATCACCTGAGGTCAGGAGTTCCAGACCAGCCTGGCCAACATGGTGAAACCCTGTCTCTACTAAAAATACAAGAAAAAAAAAAATGAAGAAGAAGAAATAGCTGGGAATGGTGGCAGGGGCCTGTAATCCCAGCTACTCAGGAGGCTGAGGCAGGAGAATCGCTTGAACCCAGGAGACGAAGGTTGCAGTGAGCCAAGATGGTGCCAGTGCACTCCAGCCTGGGAGACAAGAGCAAGACTCCGTCTCAAAAACAAACAAACAAAAAGAA"
"chr4","12134292","12134639","JH378114","18206329","18206669","63","6072037","GGCCAGGTGTGGTGGCTCATGCCTGTAATCCCAGTACTTTGAGAGGCTGCGGTGGGCAGATCGCCTGAGGTTAGGAGTTCAAGACCAGCCTGGCCAACATGATGAAACCCTGTCTCTACGAAAAATACAAAAATTAGCCAGGCGTGGTGGCAGGCACCTGTAATCCCAGCTACTCGGTGGGCTAAGGCAGGAGAATTGCTTGAACCCGGGAGGTGGAGGTTGCAGTGCGCCAAGACTGTGCCATTGCACTCCAGCCTGGGCAACAAGAGAGAAACTCCATCTCTCACACACACACACACACACACACACACACACACACACACACACACACAAAAGGAAAAAAGAAAA","GGCTGGGCGTGGTGGCTCATGCCTGTAACCCCAGCACTTTAGGAGGCTGAGGTGGGTGGATCACCTGAAGTTAGGAGTTTGAGACCAGCCTGGCCAACATGGTGAAACCCTGTCTCCACTAAAAATAGAAAAATTAGCCAGGCGTGGTAGCAGACATCTGTAATCCCAGCTACTCAGGAGACTTAGGCAGGAGAATTGCTTGAACTGGGAGGCAGAGGTTGCAGTGAACTGAGATCATGCCATTGCACTCCAGCCTGGGCAACAAGAGAAAGACTTCATCTCAAAAAGAAAACAAAAACAAAAACAAAAACAAAAACAAAAAAAAAAAAAGAAAAACAAAA"
"chr4","13366198","13366514","JH378115","32490156","32490457","64","19123958","GGCCAGGTGCAGTGGCTCACGCCTGTAATCCCAGCACTTTGAGAGATTGAGGCAGGTGGATCACCTGAGGTTAGGAGTTCAAGACCAGCCTGGCCAATATGGTGAAACCCCACCTCTACTAATAATACACACACACACACACACACACACACACACAAATTCAGCCAGGCATGGCAGTGGGCAGCTATAGTCCCAGCAACTCATGAGGCTGAAAGAGGAGAATCACTTGAACCCAGGAGGTGGAGGTTGCAGTGAGCTGAGATCGCGCCATTGGACTCCATCCTGGGCAAAAAGAACGAAACTCCATTAAAAAAAAA","GGCCAGGTGCGGTGGCTCACGCCTGTAATTCCAGCACTTTGGGAGGCCGAGGCAGGTGGATCACCTGAGTTCAGGAGTTCAAGACCAGCCTGGACAACATGTTGAAATCCCATCTCTACTTAAAATAGAAAAAAAAAAATTAGCCGGGCGTGGTAGTGGGCACCTGTAATCCCAGCTATTCAGGAGGCTAAGGCAGGAGAATCGTTTGAACCCAGGAGATGGAGGTTGCAGTGAGCTGAAATCGTGCCATTGCACTCCAGCCTGGGCAACAAGAGCGAGACTCCATCTTTAAAAAAACAAAA"
"chr4","17478430","17478780","JH378144","13229286","13229620","56","4249144","GGCCAGGCGTGGTGTCTTATGCCTGTAATCCCAGCACATTGGGAGGCCGAGGTGGGTGGATCACCTGAGGTCAGGAGTTCGAGACGAGCTTGGCCAATAAAGTGAAACCCTGTCTCTACTAAAAAAATACAAAAATTAGCTGAGCATGCTGTTGGGCACCTGAAATCCCAGCTACTCAGGTGGCTGAGGCAGGAGAATTGCTTGAAGCTGGGAGGCAGAGGTTGCGGTGAGCTAAGATCGCACCATTGCACTCCAGCCTGGGCAACAAGAGCAAAACTCCATCTCAAAAATAAATAAATAAATAAATAAATAAATAATAAATAAAATTAAAAAAGAAAGGAAAACAAAAAA","GGCCGGGCGCGGTGGCTCAAGCCTGTAATCCCAGCACTTTGGGAGGCCGAGGCGGGTGGATCACCTGTGGTCAGGAGTTCAAGACAGCTTGGTCAACATGGTGAAACCCCGTCTCTACCAAAAATACAAAAAATTAGCTGGGCATGGTAGCGCATGCCTGTAATCCCAGCTACTCAGGAGGCTGAGGCAGGAGAATTGCCTGAACCCAGGAGGCAGAGGTTGCGGTGAGCCGAGATCGCGCCATTGCACTCCAGCCTGGGTAACAAGAGCGAAACTCCCTCTCATAAAAAATAAATAAATAAATAAATAAATAAATAAATAAATAAATAAATAAA"
"chr4","39082584","39083196","JH378118","18053084","18053501","254","21029500","GGCTGGGCGCAGTGGCTCACACCTGTAATCCCAGCACTTTGGAAGGCTGAGGCGGGCGGATCACCTAAGGTCAGGAGTTCGAGACTAGCCTGGCCAAAATGATGAAACCCCATCTCTATTAAAAATAAAAAAAATCGGCTGGGTGCGGTGGCTCACGCCTGTAATCCTAGCACTTTGGGAGGCCGAAGCGGGTGGACTGCCTGAGCTCAGGAGTTCAAGACCAGTCTGGGCAACATGGCAAAATCTTGTCTCTAAAACTACAAAAAAATTAGTCGGGTGTGGTAGTGTGTGCCTGTAATTCCAGCTACTCAGGAGGCTGAGGCATGAAAATCGTTTGAACCTGGGAGGTGGAGGTTGCAGTGAGCCGAGATTGCACCACTGCACTCTAGCCTGGGTGACAGAGCGAGACTCTGTGTCAAGAAAAAAAAAAAAAATTATATATATATATATATTTTAGCCGGATGTAGTGGCACCCACCTGTAGTCCCAGCTACTCAGGAGGGTGAGGCAGGAGAATCACCTGAACCCAGGAGGCAGAGATTATAGTGAGCCGAGATCGTGCCACTACACTCCAGCTCGGGCGACAAGAGCAAAACTCCGTCTTTAAAAAAAAA","GGCTGGGCGCAGTGGCTCACACCTGTAATCCCAGCACTTAGGGAAGCTGAGGCGAGTAGATCACCTGAGGTCAGGAGTTAGAGACCAGCCTGGCCATCATGGTGAAACCCCGTCTCTACTAAAGATACCAAAAATTAGCTGAGTGTGGTGCTGGGTGCCTGTAATCCCAGAAACTCAGGGTGCCTGTAATCCCAGCAACTCAGGGTGCCTTTAATCCCAGCAACTGAGGGTACCAGTAATCCCAGCAACTCAGGGTGTCTTTAATCCTAGCAACTGAGGGCACCTGTAATCCCAGCAACTCAGGAAGCTGAGACAGGAGAAGTACTTGAACCCAGAAGGCAGAGGTTGCAGTGAGCCGATATTGCACCATTGCACTCCAGTCTGGGCAACAAGAGTGAAACTCTGTCTCAAAAAAAAA"
"chr4","39644125","39644662","JH378118","18053084","18053501","202","21591041","GCCTGGCCAACATGGCGAAACTCCATCTCTGCTAAAAATATAAAAATTGCCAGGCATGGTGGCTCATGCCTGCAATCCCAGCACTTTGGGAGGCTGAGGAGGGCAGATCACCTGAGGTCTAGAGTTCAAGACCAGCCTGGTCAATGTGGTGAAACCTTGTCTCTACTAAAAATACAAAAATTAGCTCGGCGTGGTGGTGGGCTCCTGTAGTCCCAGCTACTCAGGAGGCTGAGGCAGGAGAATCGCTTGAACTCGGGAGGCGGAAGTTGCAGTGAGCAGAGATTGTGCCACTGCACTCCAGCCTGGGAGATACAGCCAGACTCTGTCTCAAACAAAACAAAACAAAACAAAACAAAACAAAACAAAACATCACAAAAATTAGCAGGGTGTGGAGGCACGTGCCTGTAATCCCAGCTACTTGGGAGGCTGAGGCATTAGAATCACTTGAACCAGCGAGTTAGAGGTTACAGTGAGCCAGGATTGCACCATTGCACTCCAGCCTGGGCAAGAAGAGTAAAACTCCATCTCAGAAAAAAAA","GGCTGGGCGCAGTGGCTCACACCTGTAATCCCAGCACTTAGGGAAGCTGAGGCGAGTAGATCACCTGAGGTCAGGAGTTAGAGACCAGCCTGGCCATCATGGTGAAACCCCGTCTCTACTAAAGATACCAAAAATTAGCTGAGTGTGGTGCTGGGTGCCTGTAATCCCAGAAACTCAGGGTGCCTGTAATCCCAGCAACTCAGGGTGCCTTTAATCCCAGCAACTGAGGGTACCAGTAATCCCAGCAACTCAGGGTGTCTTTAATCCTAGCAACTGAGGGCACCTGTAATCCCAGCAACTCAGGAAGCTGAGACAGGAGAAGTACTTGAACCCAGAAGGCAGAGGTTGCAGTGAGCCGATATTGCACCATTGCACTCCAGTCTGGGCAACAAGAGTGAAACTCTGTCTCAAAAAAAAA"
"chr4","39650758","39651317","JH378118","18053084","18053501","216","21597674","GGCTGGGCATGGTGGCAAATGGCTGTAATCCCAGCACTTTGGGAGGCTGAGGTGGGTGGATCACCTGAGGTCAGGAGTTGAAGACCAGCCTGGCCAACATGGTGAAACCCTGCCTTCATTAAAAGTACGGAAATGTGGGAGGCTGAGGTGGGCGGATCACAAGGTCAGGAGATCGAGACCATCCTGGCTAACATGGTGAAACCTCGTTTCTACTAAAAATACAAAAAATTAGCCGGGCGTGGTGGTGGGCGCCTGTAGTCCCAGCTACTCGGGAGGCTGAGGCAGGAGAATGGTGTGAACCCGGGAGGTGGAGCTTGCAGTGAGCCGAGATCACGCCACTGCACTCCATCCTGGGCGACAGAGCGAGACTCTGTCTCAAAAAAAAAAAAAAAGGTACAAAAATGAGTTAGGCGTGGTGGCATGGGCCTGTAATCCCAGATACTTGGGAGGCTGAGGCAGGAGAATCACTTGAACCCAGGAGATGGAGGTTGCAGTGAGCCAAGATTGTGCCATTGCACTCCAGCCTGGGCAACAAGAGCAAAATTCTGTTGGAAAAAAAA","GGCTGGGCGCAGTGGCTCACACCTGTAATCCCAGCACTTAGGGAAGCTGAGGCGAGTAGATCACCTGAGGTCAGGAGTTAGAGACCAGCCTGGCCATCATGGTGAAACCCCGTCTCTACTAAAGATACCAAAAATTAGCTGAGTGTGGTGCTGGGTGCCTGTAATCCCAGAAACTCAGGGTGCCTGTAATCCCAGCAACTCAGGGTGCCTTTAATCCCAGCAACTGAGGGTACCAGTAATCCCAGCAACTCAGGGTGTCTTTAATCCTAGCAACTGAGGGCACCTGTAATCCCAGCAACTCAGGAAGCTGAGACAGGAGAAGTACTTGAACCCAGAAGGCAGAGGTTGCAGTGAGCCGATATTGCACCATTGCACTCCAGTCTGGGCAACAAGAGTGAAACTCTGTCTCAAAAAAAAA"
"chr4","39871705","39872304","JH378206","6546474","6546861","260","33325231","GGCTGGGTGTGGTGGCTCATGCTTGTAATCCCAGCACTTTGGGAGGCCGAGTGGGGTGGATCACCTGAGGCTAGTAGTTCAAGACCAGCCTGGATAACATGATGAAACCCCATCTCTATTAAAAATACAAAAATTGGGCCGGGCACGGTGGCTCACACCTGTAATCCCAGCACTTTGGGAGGCCGAGGCGGGTGGATCATGAGATCAAGAGATGGAGGCCATCCTGGCCAACATGGTGAAACCTTGTCTCTACAAAAATACAAAAATTAGCCGGGCGTGGTGGCAGGTGCCTGTAGTCCTGGCTACTCGGGAGGCTGAGGCAGGAGAATCACTTGAACCCAGGAGGCAGAGGTTGCAGTGAGCCGAGATTGCGCCACGGCACTCCAGCCTGACGACAGAGCGAGACTCTGTCTCAAAAAAAAAAAAAAAAAAGCCAGCCATGGTGGTGGGTGCCTGTAATCCCAACTACTTGGGAGGCTGGAGAATCACTTGAACCTGGGAGGCAGAGGTTGCAGTGGGCCGAGATCGTGCCATTGCACTCCAGCCTGGGTGACAAGAGCGAAAACTGTCTCAAAAAAAAAAAAAAAAAAAAAAAAAAAA","GGCCACACATGGTGGCTAACGCCTGTAATCCCAGCACTTTGGGAGGCCAAGTCGGGTGGATCATGAGGTCAGGAGACCAAGACCATCCTGGCCAAATGGTGAAACCCCGTCTCTACTAAAAATACAAAAATTAGCTGGGCATGGTGGCGTGTGCCTGTAATCCCAGCTACTCAGGAGGCTGAGGCAGGACAATTGCCTGAACCCAGGAGAATTAGCTGGGCATGGTGGCGTGTGCCTGTAATCCCAGCTACTCAGGAGGCTGAGGCAGGACAATTGCCTGAACCCAGGAGGCGAAGGTTGCGGTGAGCCGAGATTGTGCCATTGCACTCCAGCCTGGGTAACAAGAGCGACACTCTGTCTCAAAAAAAAAAAAAAAAAAAAAAAAAAA"
"chr4","63551708","63552352","JH378118","18053084","18053501","290","45498624","GCTGGGCGCAGTGGCTCACGCCTGTAATCTCAGCACTTTGGGAGGCCGAGGCAGGCAGATCACCAGAGGTCAGGAGCTCGAGATCAGCCTGGCCAAAATGGTGAAACCCCGTCTCTACCAAAAATATAAAAATTAGCCGGGCACGGTGGCTCATGCCTGAATCTCAGCACTTTGGGAGGCCGAAGCGGGCAGATCACTTGAGGTCAGGAGTTCAAGACCAGCCTGGCAAACATGGTGAAACCCCGTCTCTACTGAAAATACAAAAATTAGCTAGGCATGGGGTCAGGAGCCTGTAATTCCAGCTACTCCGGAGGCTGAGGCAGGAGAATCACTTGAACCGGGGAGGCGTAGGTTGTGATGAGCTGAGACCACACCATTGCACTCCAACCTGGGTAATAAAAGTGAAACTCTGTCTCAAAAAAAAAAAAAAAAAAAAAAAAATTAGCTGGGTGTGGCTGCAGGCACCTGTAATCCCAGCTACTCAGGAGGCTGAGGCAGGAGAATTGCTTGAACCTGGGAGGAGGAGGTTGCTGTGAGTAGAGATCGTGCCATTGCACTCCAGCCTGGATGACAAGAGTAAAACTCCGTCTCAATAATAATAATAATAATAATAATAATAATAATAATAATAGAACAGAATAAAAA","GGCTGGGCGCAGTGGCTCACACCTGTAATCCCAGCACTTAGGGAAGCTGAGGCGAGTAGATCACCTGAGGTCAGGAGTTAGAGACCAGCCTGGCCATCATGGTGAAACCCCGTCTCTACTAAAGATACCAAAAATTAGCTGAGTGTGGTGCTGGGTGCCTGTAATCCCAGAAACTCAGGGTGCCTGTAATCCCAGCAACTCAGGGTGCCTTTAATCCCAGCAACTGAGGGTACCAGTAATCCCAGCAACTCAGGGTGTCTTTAATCCTAGCAACTGAGGGCACCTGTAATCCCAGCAACTCAGGAAGCTGAGACAGGAGAAGTACTTGAACCCAGAAGGCAGAGGTTGCAGTGAGCCGATATTGCACCATTGCACTCCAGTCTGGGCAACAAGAGTGAAACTCTGTCTCAAAAAAAAA"
"chr4","69138890","69139492","JH378118","18053084","18053501","250","51085806","GGCCGGGCGCAGTGGCTCATGCCTGTAATTCTAGCATTGTGGGAGGCTGAGGTGGGTGGATCACTTAAGGTCAGGAGTTTCAGACCAGCCTGGCCAACATGGTGAAACCCCTCGTCTCTACTAAAAACACAAAAATAGGCCAGGTGCAGTGGCTCATGCCTGTAATCTCAGCACTTTGGGAGGCCGAGGTGGGCGGATCACCTGAGGTCAGGAGTTCGAGACCAGCCTGACCAACATGGAGAAACCCCTTCTCTACTAAAAATACAAAATCAGCCGGGCATAGTGGCACATGCCTGTAATCCCAGCTACTAGGGAGGCCGAGGCAGGAGAATCGCTTGAACCTGGGAGGCGGAGGTTGTGGTGAGCCGAGATCGCGCCCAGCCGAGATCGCGCCATCGCACTCCAGCCTGGGCAACAAGAGCGAAACTCCGTCTCAAAAAAAAAAGCTAGGCATGGAGGCGTGCACTTGTAATCCCACCTACTCGGGAGGCTGAGGCAGAACTGGTTGAACCTGGGAGGCAGAGGTTGCGGTGAGCTGAGATCGCTCCATCGCACTCCAGCCTGGGCAACAAGAGAGAAACTCCGTCTCAAAAAAAAAAAAAA","GGCTGGGCGCAGTGGCTCACACCTGTAATCCCAGCACTTAGGGAAGCTGAGGCGAGTAGATCACCTGAGGTCAGGAGTTAGAGACCAGCCTGGCCATCATGGTGAAACCCCGTCTCTACTAAAGATACCAAAAATTAGCTGAGTGTGGTGCTGGGTGCCTGTAATCCCAGAAACTCAGGGTGCCTGTAATCCCAGCAACTCAGGGTGCCTTTAATCCCAGCAACTGAGGGTACCAGTAATCCCAGCAACTCAGGGTGTCTTTAATCCTAGCAACTGAGGGCACCTGTAATCCCAGCAACTCAGGAAGCTGAGACAGGAGAAGTACTTGAACCCAGAAGGCAGAGGTTGCAGTGAGCCGATATTGCACCATTGCACTCCAGTCTGGGCAACAAGAGTGAAACTCTGTCTCAAAAAAAAA"
"chr4","84106299","84106637","JH378156","11322774","11323105","56","72783525","GCTGGACCTGGTGGCTCATGCCTATAATCCCAGCACTTTGGGAAGCCAAGGCAGGTGGATCACCTGAGGTCAGGAGTTCGAGACTAGCCTGGCCAACATGGTGAAACCCCGTCTCTACTGAAAATACAAAAATTGGCCGGGTGTGCTGGTAGGTGCCTGTAATCCCAGCTACTCAGGAGGCTGAGGCAGTGGAATTGCTTGAACCCGGCAGGCAGAGGTTGCAGTGAGCCGAGATCGCGCCATTACAATCCCACCTGGGTGACAGGAGCAAAACTCCATCTCAGAAAACAAACAAACAAACAAACAAACAAAAAAAAAAAAAAAAGAAAAAGAAAAGAA","GCTGGGCGCAGTGGCTCAAGCCTGTAATCCCAGCACTTTGGGAGGCCGAGGCGGGTGGATCATGAGGTCAAGAGATCGAGACCATCCTGGTCAACATGGTGAAACCCCGTCTCTACTAAAAAAACAAAAATTAGCTGGGCATGGTGGCACATGCCTGTAATCCCAGCTACTCAGGAGGCTGAGGCAGGAGAATTGCCTGAACTCAGGAGGCGGAGGTTGCGGTGAGCCGAGATCGCACCATTGCACTCCAGCCTGGGTAACAAGAGGGAAACTCGTCTCAAAAAACAAAACAAACAAAAAACAAAAACAAAAACAAAAACAAAAACAAAAAC"
"chr4","89040744","89041080","JH378153","10517405","10517727","59","78523339","GGCCGGGCGTGGTGGCTCACACCTGTAATTCCAGCAATTTGGGAGGCTGAGGCGAGTGGATCACCTGAGGTCAGGAGTTCGAGATCAGCCTGATCAACATGGTAAAACTCTATCTCTACAAAAAAAAAAAAAAAAAAAAAAAAAGAAAAGAAAAGAAAAAGAAAATTAGCCCAGCATGGTGGGGGGTGCCTGTAAACCCAGCTACTCAGGAGGCTGAGGCAGGAGAATTGCTTGAACCTGGAAGGATAGGTTGCAGTGAGTCAAGATCACGCTATTGCACTTCAGCCTGGGCAACAAGAGCAAAACTTGGTCTCAAAGAAACAACAAAAAAAAAGAA","GGCCGGGCGTGGTGGCTCACGCCTGTAATCCCAGCACTTTGGGAGGCCGAGGTGGGTGGATCATGAGGTCAAGAGATCGAGACCATCCTGGTCAACATGGTGAAACCCTGTCTCTACTAAAAAAAAAAAAAAAAAAAAAAAATACAAAAAAATTAGCTGGGCATGGTGGCGCATGCCTGTAATCCCAGCTACTCCGGAGGTTGAGGTAGGAGAATTGCCTGAACCCAGGAGGCGGAGGTTGCGGTGAGCCGAGATCGCGCCATTGCACTCCAGCCTGGGTAACAAGAGCAAAACTCCGTCTCAAAAAAAAAAAAAAAAAAGAA"
"chr4","91580279","91580611","JH378195","2882588","2882917","67","88697691","GACCTGGTGCTGTGGTTCACACCTGTAATCACGTAATTTTGAGAGGTCCAGGCGGGCAGTTCACTTGAGGTCAGGAGTTCGAGACAAGCCTGGCCAACATGGTGAAACTCCATCTCTACTGAAAAAAAAAAAAAAAAAAGAAAAAAGAAAAAAAAACTAGCTGGGTGGGGTGTCAGGCACCTGTAATCCCAGCTACTCAGGAGGCTGAGGCTGGAGAACTTGAACTTGGGAGATGGAGGGTGCAGTGAGCTGAGATCACACCATTGCAATCCAGCCTGGGGGACAAGAGTGAAACTCTGTCTCAAAAAAAAAAAAAAATAAAAATAAATAAAA","GGACAGGCGCAGTGGTTCACACCTGTAATTCCAAAACTTTGGGAAGCCAAAGCAGGTGGATCACCTGAGGTCAGGAGTTTGAAACCAGCCTGGCCAACATGGTGAAATCCTATCTCTACTATTAATACAAAAAAAAAAAAAAAAAAAAAAAAAAACCTGGGCGTGGTGGCCAGCACCTGTAATCCCAGCTACTTGGGAGGTGGAGGCAGGAGAATTGCTTGAACCCGGGAGGTGGAGGTTGCAGTGAACCAAGATTGCGCCATTGCACTTCAGCATGGGTGACAAGAGTGAAACTCTGTCTCAAAAAAACAAAAAAATAAAACAAACAAA"
"chr4","103796863","103797211","JH378109","21598627","21598960","58","82198236","GCTAGGCATGGTGGCTAATGCCTGTAATCCCAGCACTTTGGGGGGCCGAGGCAGGTGGATCACCTGAGGTCCAGAGTTTGAGACCAGCCTGGCCAGCATGGTGAAAACCCGTCTCTACTAAAAATACAAAAAATTTGCTGGGCGTGGTGGCGCATGCCTGTAATCCCAGCTACTTGGGAGGCTGAAGCAGAAGAACTGTTTGAACGTGGGAGGCAGAGGTTGCAGTGAGCTGAGATCATGCCATTGCACTCCAGCCTGGGCAACAAGAGCAAAACTCCATCTCAAAATAATAATAATAATAATAATAATAATAATAATAATAATAATAATAAAATAAAAAATAAAAAAA","GGCTGGGCACAGTGGCTCATGTCTGTAATCCCAGCACTTTGGGAGGCTGAGGCAGGCAGATTACCTGAGGTCTGGAGTTCGAGACCAGCCTGGCCAACATGGTGAAACCCCATCTCTACTAAAAATACAAAAAATTAGCCAGGGATGGTGGTGGGCATCTGTAATCCTAGCTACTTGGGAGGCTGAAGCAGGAGAATTGCTTGAAGCTGGGAGGCAGAGGTTGCAGTGATTTGAGATCCTGCCATTGCACTCCAGCCTGGGCAACAAGAATGAAACTCTGGCTCAAAATTATAATAATGATAATAAAAATAAAAAATAAAAATAAAAATAAAAA"
"chr4","115452492","115452823","JH378153","13131650","13131982","49","102320842","GGCTGGGCGCGGTGGCTCACGCTTGTAATCCCAGCATTTTGGGAGGCCAAGGCAGGTGGATCTCCTGAAGTCAGGAGTTTGAGATCAGCCTGGTCAACATGGTGAAACACCATCTCCACTGAAAATGCAAAAATTAGCTGTGCGTGGTGTCGGGCGCCTGTAATCCCAGCTACTCAGGAGACTGAGGCAGGAGAATCGTTGAACCTGGGAGGCAGAGGTTGCAGTGAGCCGAGATCGCGTCATTGCACTCCAGCCTGGGCAACAAGAGCAAGACTGTCTTAAATAAAATAAAATAAAATAAAATAAAATAAAATAAAACAAATAAACAAAAA","GGCTGGGCGCGGTGGCTCACGCCTGTAATCCCAGCACTTTGGGAGGCCGAGGCGGGTGGATCATGAAGTCAAGAGATCAAGACCATCCTGGTCAATATGGTGAAACCCGTGTCTACTAAAAATACAAAAATTAGCTGGGCATGGTGGCGCGTGCCTGTAATCCCAGCTACTCAGGAGGCTGAGGCAGGAGAATTGCCTGAACCCAGGAGGCGGAGGTTGTGGTGAGCCGAGATCGCGCCATTGCACTCCAGCCTGGGTAACAAGAGCGAAACTCTGTCTCAAAAAATAAATAAATAAAATAAAATAAAATAAAATAAAATAAAATAAAATAAA"
"chr4","115696430","115696766","JH378148","10302642","10302970","58","105393788","GGCCGGGCACAGTGGCTCACGCCTGTAATCCCAGTACTTTGGGAGGCCGAGACGGATGGATCACCTGAGGTCAAGATTTTGAGACCAGTCTGGCCAAAATGGTGGAACCCCATCTCTACTAAAAGCACAAATTTAGCCGGGCGTGGTGGTGGGCGCCTGTAATCCCAGCTACTCAGGAGGCTGAGGCAGGAGAACTCTTGAACCCGGGAGGCAGAGGTTGCAGTGAGCAGCGATAGCGCTGTTGCTCCCCAGCCCGGGCAACAAGAGCTAAACTCCCTCTCAAAAAATTTAAATTAAATTAAATTAAAATTAAAATTAAAAAAAAAAGAAATAGAAA","GGCCGGGCGCGGTGGCTCAAGCCTGTAATCCCAGCACTTTGGGAGGCCGAGGCGGGTGGATCACGAGGTCAAGAGATCGAGACCATCCTGGTCAACATGGTGAAACCCCGTCTCTACTAAAAATACAAAAAATTAGCTGGGCATGGTGGTGGGTGCCTGTAATCCCAGCTACTCAGGAGGCTGAGGCAGGAGAATTGCCTGAACCCAGGAGGCGGAGGTTGCGGTGAGCCGAGATCGCGCCATTGCACTCCAGCCTGGGTAACAAGAGTGAAACTCTGCCTCAAAAAAAAAAAATAAAATAAAATAAAATAAAATAAAATAAAATAAAA"
"chr4","126648700","126649621","JH378118","18053084","18053501","550","108595616","GCCGGGTGTGGTGGCTCACGTCTGCAATCCCAGCACTTTGGGAGGCCAAGGTGGGTCAATCATCTGGGGTCCAGAATTCAAGATCAGCCTGGCCAACATGGTGAAACCCCATCTCTACTAAATATACAAAAATTATTGGCCGGGCGCGGTGGCTCATGCCTATAATCCCAGCACTTTGGGAGGCCGAGGCGGGTGGATCACGAGGTCAGGAGATCGAGACCACCCTGGTTAACGTGGTGAAACCCCGTCTCTGCTAAAAATACAAAAAAAAATTAGCCAGGCGTGGTGGCAGGTGCCTGTAGTTCCAGCTACTCGGGAGGCTGAGGCAGGAGAATGGCGTGAACCCGGGAGGCGGAGCTTACAGTGAGCTGAGATTGCGCCACTGCAGTCCAGCCTGGGCAACAGAGCGAGACTCGCTCTCAAAAAAAAAAAAAAGGCCGGGCACGGTGGCTCATGCCTGTAATCCCAGCACTTTGGGAGGCCGAGGCGGGTGGATCATGAGGTCAGAAGATGGAGATCATCCTGGCTACCACGGTGAAACCCTGTCTCCACTAAAAATAAAAAAATTAGCTGGGCATGGTGGCGGGTGCCTGTATTCCCAGCTACTCGGGAGGCTAAGGCAGGAGAATGGTGTGAACCAGGGAGGCAGAGCTTGCAGTGAGCCGAGATTGTGCCACTGCAGTCCAGCCTGGGCAGCAAAGCGAGACTCTGTCTCAAAAAAAAAAAAAAAAAAAACTAAAACAAACATTATGCAGGCATGGTGGCGAGCGCCTGTAATCCCAGCTACTCAGAAGGCTGCAGCAGAAGAAGAGCTTGAACACAGGAGATGGAGGTTGTAATGAGATTGCTCCATTGCACTCCGGCTTGAGCAACGAGAGCGAGGCTCCATCTCAAAAAAAGAAAAAAAAAGAAAAAAAAAAAA","GGCTGGGCGCAGTGGCTCACACCTGTAATCCCAGCACTTAGGGAAGCTGAGGCGAGTAGATCACCTGAGGTCAGGAGTTAGAGACCAGCCTGGCCATCATGGTGAAACCCCGTCTCTACTAAAGATACCAAAAATTAGCTGAGTGTGGTGCTGGGTGCCTGTAATCCCAGAAACTCAGGGTGCCTGTAATCCCAGCAACTCAGGGTGCCTTTAATCCCAGCAACTGAGGGTACCAGTAATCCCAGCAACTCAGGGTGTCTTTAATCCTAGCAACTGAGGGCACCTGTAATCCCAGCAACTCAGGAAGCTGAGACAGGAGAAGTACTTGAACCCAGAAGGCAGAGGTTGCAGTGAGCCGATATTGCACCATTGCACTCCAGTCTGGGCAACAAGAGTGAAACTCTGTCTCAAAAAAAAA"
"chr4","126697360","126697985","JH378118","18053084","18053501","267","108644276","GGCCAGGTGCGGTGGTTCACACCTGTAATCCCAACACTTTGGGAGGCCGAGGCCAGCGGTTCACCTGAGGTCAGGAGTTCAAGAACAGCCTGGCCAACATAGTGAAACCACGTCTCTACTAAAAATACAAAAATTAGGCCAGGTGTGGTGGACCACACCTGTAATCCCAGCACTTTGGGAGGCTGAGGCGGGTGGATCACCTGAGGTCAGGAGTTCGAGAACAGCCTGGCCAACATGGCAAAACCCTGTCTCTACTTAAAACATAAAAATTAGCTGGGTGTGGTGGCGTGTGCCTTTAATCCCATCTACTCTGGAGGCTGAGGCAGGAGAATCGCTTGAACCCGGGAGGGGGAGGTTGTAGAGAGCCGCGATCACGCCACTGCACTCTAGCTTGGGCAACAGAGTGAGATTCTGTCTGAAAAAAATAAATAGATAAATGCAAAAATTAGCCGGGTGTGGTAGCAGGTGCCTGTAATCCCAGCTACTCACGAGTCTGAGGCAGGAGAATCTCTTGAACCCAGGAGGTGAAGGTTGCAGTGAGCCAAGATCACACCATTGCACTCCACTCCAGCCTGGGCAACAAGAGCAAGACTCTGTCTCAAAAAAAAAAAAAAAAAAAAAAAAAA","GGCTGGGCGCAGTGGCTCACACCTGTAATCCCAGCACTTAGGGAAGCTGAGGCGAGTAGATCACCTGAGGTCAGGAGTTAGAGACCAGCCTGGCCATCATGGTGAAACCCCGTCTCTACTAAAGATACCAAAAATTAGCTGAGTGTGGTGCTGGGTGCCTGTAATCCCAGAAACTCAGGGTGCCTGTAATCCCAGCAACTCAGGGTGCCTTTAATCCCAGCAACTGAGGGTACCAGTAATCCCAGCAACTCAGGGTGTCTTTAATCCTAGCAACTGAGGGCACCTGTAATCCCAGCAACTCAGGAAGCTGAGACAGGAGAAGTACTTGAACCCAGAAGGCAGAGGTTGCAGTGAGCCGATATTGCACCATTGCACTCCAGTCTGGGCAACAAGAGTGAAACTCTGTCTCAAAAAAAAA"
"chr4","139386397","139386721","JH378250","1133852","1134171","46","138252545","GGCTGGACACGGTGGCTCATGCCTGTAATCCCAGCACTTTGGGAGGCTGAGGTGGGTGGATCACCTGAGGTCAGGAGTTCAAGACCAGCCTGGCCAACATAGTGAAACCCCATCTCTACTAAAAAAAATACAAACATTAGCTGGGCGTGGTGGCGCGTGCCGGTAATTCCAGCTACTTGGGAGGCCAAGGTCGGAGAATTGCTTGAATCTAGGAGGCAGAGGTTGCAGTGGGCCAAGATCGCACCATTGCACTCCAGCCTGGGCAACAAGAGCAGAACTCCATATCAAAAAAAAAAAAAAAAAAAAAAAAACGCAAAAAATAAAA","GGCCGGGTGCGGTGGCTCAAGCCTGTAATCCCAGCACTTTGGGAGGCTGAGGCGGGTGGATCACCTGAGGTCAGGAGTTCAAGACCAGCCTGGTCAACATGGTGAAACCCCGTCTCTACTAAAAATACAAAAAATTAGCTGGGCGTGGTGGCGCGTGCCTGTAATCCCAGCTACTCAGGAGGCTGAGGCAGGAGAATTGCCTGAACCCAGGAGGCGGAGGTTGCGGTGAGCCGAGATCACGCCATTGCACTCCAGCCTGGGTAACAAGAGCGAAACTCCGACTCAAAAAAATAAATAAATAAATAAAATAAAAAATAAAT"
"chr4","140873696","140874012","JH378235","1186107","1186418","47","139687589","GGTTGGGCGCAGTGGCTCACGCCTGTAATCCTAGCACTTTGGGAGGCCGAGGCGGGCGGATCACCTGAGGTCTGGAGTTCAAGACCAGACTGGCCAAAATGGTGAAACCCTGTCTCTACTAAAAATACAAAAAAAAAAAAAAAAAAAAAAAAATTAGCCGGGCTTAGTGGCCCTGTAGTCCCAGCTACTTAGGAGATTGAAGCAGGAGAATTGCCTGAATCCAGGAGGCGGAGGTTGCAGTGAGCCAAGATCATGCCATTGCACTCCAGCCTGGAAGACAAGTCCAGTGAAACTCCATCTCAAAAAAAAAAAAAGAA","GGCTGGGCGCAGTGGCTCAAGCCTGTAATCCCAGCACTTTGGGAGGCCGAGGGGGGTGGATCACGAGGTCAAGAGATCAAGACCATCCTGGTCAACATGGTGAAACCCCGTCTCTACTAAAAAAAAAAAAAAAAAAAAAAAAAAAAAAAAAAAATTAGCTGGGCATGGTGGCGTGTAATCCCAGCTACTCAGGAGGCTGAGGCAGGAGAATTGCCTGAACCCAGGAGGCGGAGTTTGCGGTGAGCCAAGATCGCGCCATTGCACTCCAGCCTGGGTAACAAGAGCAAAACTCTGTCTCAAAAAAAAAAAAAA"
"chr4","142020435","142020694","JH378109","6502662","6502896","64","135517773","GGCCAGCCTGGCCACCATGGTAACACCCCATCTGTACTAAAAATAAAAAAATTAGCCGGGCATGGTGGCGGGCACCTGGTAATCCCAGCTACCTGGGAGGATGAGGCAGGAGAATTGCTTGAACTTGGGAGGCGGAGGTTGCAATGAGCAGAGACCATGCCATTGCATTCCAGCCTGGGCAGCAAGGATGAAACTCTGTCGTAAAACAAACAAACATAAAACACACACACACACACACACACACACAGAGAAAAGAAAAA","AGACCATCCTGGCCAACATGGTGAAACCTTGTCTCTACTAAAAATACAAAAGTTATCCGGGCATGGTGGAGCACACCTGTAATCCCAGCTACTCTGGAGGCTGAGGCAAGAGAATTGCTTGAACCTGGGATGCAGAGGTTGCAGTGAGCCGAAACCACACGATTGCACTCCAGCCTGGGCAATAAGAGTGAAACTCCATCTAAAACAAAAACGAACAAAACAATACCAAAAAAAA"
"chr4","142337013","142337612","JH378119","32351107","32351490","257","109985906","GGCCAGCTGTGGTTGTTCACACCTGTAATCCCAGCACTTTGGGAGGCTAAGGCAGGCAGACCACTTGAGGTCAGGAGTTTGAGACCAACCTGGCCAACACGGTGAAACCTCATCTCTACTAAAAATACAAAAAAATGGCCGGGTACGGTGGCTCACAACTGTAATCCCAGCACTCTAGGAGGCCAAGGTGGGTGGATCACCTGAGGTCAGGAGTTTGAGACCACCCTGGCCAACATGGCAAAACCCCAACTCTACTAAAAAATAAAACAATTACCTGAGCATGGTGGTGCGCACCTGTAATCCCAGCTACTCGGGGAGCTGAGGCTGGAGAATCGCTTGAACCCAGAAAGTGGAGATTGCAATGAGCCGAGATCACACCACTGCACTCCAGCCCGGGCAACAGAGCAAGACTCCATCTCAAAAAGTAAATACACAAACAAAAAAATTAGCCGGGTATGGTGGTGGGCACCTGTAACCTCAACTACTCGGGAGGCTAAGGCAAGAGAATCGCTTGAACCTGGGAGATGGAGGTTATAGTAAGCCAAGATGGCGCCATTGCGCTCCAGCCTCTGTCTCAAAAAAAAAAAAAAAAAAAAAAAA","GGCCAGGTATGGTGGCTCACACCTGTAATCCCAGCACTTTGGGAGGCCAAGGCAGGCAGACCACCTGAGGTCAGGAGTTCGAGATCAGCCTAGCCAACATGGTGAAACCCCATCTCTAGTAAAAATAAAATTAGCCAGGCATGGTGGTGCATGCCTGTAACGCAGGTCAGGAGTTCGAGATCAGCTTAGCCAACATGGTGAAACCCCATCTCTAGTAAAAATAAAATTAGCCAGGCAGGTGGTGCCGCCTGTACTCGGGAGGCTGAGGCAGGAGAATCACTTGAACCCAAGAGGCAGAGGTTGCAGTCAGCCAAGATCATGCCATTGCACTCCAGCCTAAGCAAAAAGAGTAAAACTCAGTCTCAAAACAAAAAAACAAAAAAA"
"chr4","143499593","143500000","JH378149","8949716","8950050","131","134549877","CAGGAGATGTAGGTTGCAGTGAGCCTAGGTCACGCCATTGCACTCTAGCCTGGGCAACAAGAGCGAAACTCTGACTGGGTGCATTGGCTGATGCCTGTAATCCCAGAACTTTGGGAGGCCAAGGCGGGCAGGTCATGAGGTCAAGAGATCGAGACCATCATGGCCAACATAGTGAAACCCCATCTCTATTAAAAATACAAAAATTAGCTGGGTGTGGTGGTGCGTGTCTGTACTCCCAGCTACTTGGGAGGCTGAGGCAGGAGAATCGCTTGAACTGGGAGGCAGAGGTTGCAGTGAGCTGAGATAGTGCCACTGCACTCCCGCCTGGCAACAGAGCAAGACTTGGTCAAAAAAAAAAAAAAAAAAAAAAGAAAGAGCAAAACTCTGTCTCAAAAAAAAAAAAAAAAA","GGCCGGGCGCAGTGGTTCAAGCCTGTAATCCCAGCACTTTGGGAGGCCGAGGTGGGTGGATCATGAGGTCAAGAGATCGAGACCATCCTGGTCAACATGGTGAAACCCTGTCTCTACTAAAAACACAAAAAATTAGCTGGGCATGGTGGCGTGTGCCTGTAATCCCAGCTACTCAGGAGGCTGAGGCAGGAGAATTGCCGGAACCCAGGAGGCAGAGGTTGCGGTGAGCCGAGATCGCGCCATTGCACTCCAGCCTGGGTAACAAGAGTGAAACTCCATCTCAAAAAAAAAAAAAAAAAAAAAAAAAAATGAAAAGAAAAGAAAAGAAAAAAAAA"
"chr4","144394054","144394626","JH378119","32351107","32351490","245","112042947","AGGCTGAGGCAGGCAGGATCACTTGATGTCAGGAGTTCAAGACCAGCCTGGCCAAGATAGTGAAACCTTGTCTGTACTAATAATACGAAACTTACGGCCTGGTGCGGTGGCTCACACCTGTAATCCCAGCACTTTGGGAGGCCGAGGTGGGCAGATCACGAGGTCAGGAGATCGAGACCACAGTGAAACCCCATTTCTACTAAAAATACAAAAAATTAGCCAGGCACGGTGGTGGGCACCTGTAGTCCCACCTACTCAGGAGGCTGAGGCAGAAGAATGGCATGAACCTGGGAGGTGGAGCTTGCAGTGAGCTGAGATTGCACCACTGCACTCCAGCCTGGGCAACAGAGCCAGATTCCATCTCAAAACAAAAAACAAAAAAAAACACAAAAAAACAAACTTAGCCAGGCGTGGTGGCACATGCCTGTAATCCCAGCTACTTGGGAGACTGAGGCAGGAGAATCGCTTGAACCTGGGAGGCGGAGGTTGCAGTGAGCCAAGATTGCGCCATTGTACTCCAGCCTGAGTGACAAGAGTGAAACTCCATCTCAAAAAAAAAAAAAAAAAAAAGAA","GGCCAGGTATGGTGGCTCACACCTGTAATCCCAGCACTTTGGGAGGCCAAGGCAGGCAGACCACCTGAGGTCAGGAGTTCGAGATCAGCCTAGCCAACATGGTGAAACCCCATCTCTAGTAAAAATAAAATTAGCCAGGCATGGTGGTGCATGCCTGTAACGCAGGTCAGGAGTTCGAGATCAGCTTAGCCAACATGGTGAAACCCCATCTCTAGTAAAAATAAAATTAGCCAGGCAGGTGGTGCCGCCTGTACTCGGGAGGCTGAGGCAGGAGAATCACTTGAACCCAAGAGGCAGAGGTTGCAGTCAGCCAAGATCATGCCATTGCACTCCAGCCTAAGCAAAAAGAGTAAAACTCAGTCTCAAAACAAAAAAACAAAAAAA"
"chr4","149920258","149920873","JH378118","18053084","18053501","271","131867174","GGCCGGGTGCGCTGCCTCACGCCTGTAAGCCCAGCACTTTAGGGGGCCGAGGGGGGTGGATCACCTGAGGTCAGGAGTTTGAGACAAGCCTGGCCAATGTGGTGAAACCCCATCTCTATTAAAAATACAAAAATTGGGCCAGGGCGGTGGCTCACGCCTATAATCCCAACACTTTGGGAGGCCGAGGCAGGTGGATCCCCTGAGGTTAGGAGTTTGAGACCAGCCTGGCCAACATGGTGAAATCCCGTCTCTACTGAAAAAACAAAAATTAGCCGGGTGTGGTGGCATGTGCCTGTAATCCCTGATACTTGGGAGGCTGAGACAGGAGAATTGCTTGAACCCAGGAGATGGAGGTTGCGGTGAGCCAAGATCTTGCCATTGCACTCCAGCCTGGGCAACAAGAGCAAAACTCCGTCTCAAAAAAAAAAAAAAAAAAAAATTACAAAAATTAGCCGGGTGTGATGGTGGTTGCCTGTAATCCCAGCTACTTGGGAGACTGAGGCAGAAGAATCACTTGAACCTGGGAGGCGGAGGTTGCAGTGAGCTGAGATCCGCCATTCACTGCACTCCGGCCTAGACAACAAGAGCAAAACTCCATCTGAAAAAAAAAAAAAAA","GGCTGGGCGCAGTGGCTCACACCTGTAATCCCAGCACTTAGGGAAGCTGAGGCGAGTAGATCACCTGAGGTCAGGAGTTAGAGACCAGCCTGGCCATCATGGTGAAACCCCGTCTCTACTAAAGATACCAAAAATTAGCTGAGTGTGGTGCTGGGTGCCTGTAATCCCAGAAACTCAGGGTGCCTGTAATCCCAGCAACTCAGGGTGCCTTTAATCCCAGCAACTGAGGGTACCAGTAATCCCAGCAACTCAGGGTGTCTTTAATCCTAGCAACTGAGGGCACCTGTAATCCCAGCAACTCAGGAAGCTGAGACAGGAGAAGTACTTGAACCCAGAAGGCAGAGGTTGCAGTGAGCCGATATTGCACCATTGCACTCCAGTCTGGGCAACAAGAGTGAAACTCTGTCTCAAAAAAAAA"
"chr4","149956663","149957277","JH378118","18053084","18053501","256","131903579","GGCTGGGTGCGGTGGCTCACACCTGTAATCCCAGCACTTTGGGAGGGTGAGGCGGGTGGATCACCTGAGGCCAGGAGTTCAAGACCAGCCTGGCCAACATGGCGAAACTCCATCTCTACTAAAAATACAAAAAATTGGCTGGGCACGGTGGCTCATGCCTATAATCCCAGCACTTTGGGAGGCCAAGGCGGGTGGATCACCTGAGGTCATGAGTTTGAGACCAGCCTGACCAACATGGTGAAATCCTGTCTTTATTAAAAATATAAAAATTAGCTGGGCATGGTGGTGGGCACCTGTAATCCCAGCTACTTGGGAGGCTGAGGCAGGAGAATTGCTTGAACCCAGGAGGCAGAGGTTGCAGTGAGCCAAAATCACACCATTGCACTCCAGCCTGGGTTGACGAGCGAAACTCCATCTCAAAAATAAAAATACAGATACAAAAAACTAGCCAAGCGTGATGGTGGGCACCTCTAGTCCTAGCTACTTCAGAGGCTGAGGCACAAGAATTGCTGGAACCTGGGGGCAGAGCTTGCAGTGAGCCAAGATCGCACCATTGGACTCCAGCCTGGGCAGCAAGGGCGAAACTACGTCTCAGAAAAAAAAAAAAAAAAAGAA","GGCTGGGCGCAGTGGCTCACACCTGTAATCCCAGCACTTAGGGAAGCTGAGGCGAGTAGATCACCTGAGGTCAGGAGTTAGAGACCAGCCTGGCCATCATGGTGAAACCCCGTCTCTACTAAAGATACCAAAAATTAGCTGAGTGTGGTGCTGGGTGCCTGTAATCCCAGAAACTCAGGGTGCCTGTAATCCCAGCAACTCAGGGTGCCTTTAATCCCAGCAACTGAGGGTACCAGTAATCCCAGCAACTCAGGGTGTCTTTAATCCTAGCAACTGAGGGCACCTGTAATCCCAGCAACTCAGGAAGCTGAGACAGGAGAAGTACTTGAACCCAGAAGGCAGAGGTTGCAGTGAGCCGATATTGCACCATTGCACTCCAGTCTGGGCAACAAGAGTGAAACTCTGTCTCAAAAAAAAA"
"chr4","152426621","152427224","JH378118","18053084","18053501","246","134373537","GGCTGGGCACAGTGGCTCATGCCTGTAATCCCAGCACTTTGGGAGGCCGAGGTGGGTGGATCATCTGAGGTCAGCAGTTCGAGACTAGCCTGGCCAAAATGGTGAAACCCCGTCTCTACGAAAAATACAAAAAAAAAAATGGCGAGGCGTTGTGGCTCACGCCTGTAATCCCAGCACTTTGGGAGGCCGAGGCAGATGGATCACAGGGTCAGGAGATCAAGACCATCCTGGATAACATGGTGAAACCCCGTCTCTACTAAAAATACAAAAAATTAGCCGGGCATGGAAGCGGGCACCTGTAGTCTCAGCTACTCGAGAGGCTGAGGCAGGAGAATGGTGCGAACCTGAGAGGCAGAGCTTGCAGTGAGCTGAGATCGCACCACTGCACTCCAGCCTGGGCAACAGAGCGAGACTCCGTCAAAAAAAAATAAAATAAAAACTAGCTGGGCATAGTGATGCACACCTGTAGTCTCAGCTACATGGGAGGCTAAGGCAGGAGAATCACTTGAACCCAGGAGGTGGAGGTTTCAGTGAGCTGAGATCATGCCATTGCACTCCAGCCTGGGTGACAAGAGTGAAACTCCGTCTCAAAAAAAAAATAAAA","GGCTGGGCGCAGTGGCTCACACCTGTAATCCCAGCACTTAGGGAAGCTGAGGCGAGTAGATCACCTGAGGTCAGGAGTTAGAGACCAGCCTGGCCATCATGGTGAAACCCCGTCTCTACTAAAGATACCAAAAATTAGCTGAGTGTGGTGCTGGGTGCCTGTAATCCCAGAAACTCAGGGTGCCTGTAATCCCAGCAACTCAGGGTGCCTTTAATCCCAGCAACTGAGGGTACCAGTAATCCCAGCAACTCAGGGTGTCTTTAATCCTAGCAACTGAGGGCACCTGTAATCCCAGCAACTCAGGAAGCTGAGACAGGAGAAGTACTTGAACCCAGAAGGCAGAGGTTGCAGTGAGCCGATATTGCACCATTGCACTCCAGTCTGGGCAACAAGAGTGAAACTCTGTCTCAAAAAAAAA"
"chr4","163855118","163855738","JH378118","18053084","18053501","267","145802034","GGCCGGGTGCAGTGACTCACACCTGTAATCCCAGCATTTCAGGAGGCCGAGGTGGGCTGATCACCTGAGGTCAAGAGTTCAAGACTGGCTGGGCACGGTGACTCAAGCCTGTAATCCCAGCACTTTGGGAGGCCGAGGCAGGTGGATCACCTGAGGTCAGGAGTTCAAGATCAGCCTGGTCAACATGGTGAAACCCCGTCACTACTAAAAATACAAAAAAATTAGCTGGGTGTGGTGGTGCACACTTGTAACCCCAGCTACTTGGGAGGCTGAAGCAGGAGAATCGCTTGCACCTGAGGGGCAGAGGTTGCAGTGAGCCGAGATCTGCCACTGCACTCCAGCCTGGGTGACAGAGGGAGACTCTGTCTCAAACAAAAAAAAAAAGAAAAAGAAAAAGAAAGAGTTAAAGACCAGCTTGACCAACTTGGTGAAACCCCGTCTATACTGAAAATACAAAATTATTGGGAATAGAGGCAGGCGCCTGTAATCCCAGCTACTCCAGGAGGCTGAGGCAGGACAGTCGCTTCAACCAGGGAGGTGGAGGTTGCAGTGAGCTGAGATCGTGGCATTGCACTCCAGCCTGGGCAACAAGAGTGAAACTCCACCTCAGAAATAAATAAA","GGCTGGGCGCAGTGGCTCACACCTGTAATCCCAGCACTTAGGGAAGCTGAGGCGAGTAGATCACCTGAGGTCAGGAGTTAGAGACCAGCCTGGCCATCATGGTGAAACCCCGTCTCTACTAAAGATACCAAAAATTAGCTGAGTGTGGTGCTGGGTGCCTGTAATCCCAGAAACTCAGGGTGCCTGTAATCCCAGCAACTCAGGGTGCCTTTAATCCCAGCAACTGAGGGTACCAGTAATCCCAGCAACTCAGGGTGTCTTTAATCCTAGCAACTGAGGGCACCTGTAATCCCAGCAACTCAGGAAGCTGAGACAGGAGAAGTACTTGAACCCAGAAGGCAGAGGTTGCAGTGAGCCGATATTGCACCATTGCACTCCAGTCTGGGCAACAAGAGTGAAACTCTGTCTCAAAAAAAAA"
"chr4","163910296","163910862","JH378118","18053084","18053501","220","145857212","GGTCAGGTGCGTTGGCTCAAGCCTGTAATCCTAGCACTTTGGGAGGCCGAGGTGGGCAGATCAACTGAGGCCAGGAGTTCGAGACCAGACCGGCCAAAATGGTGAAACCCTGTCTCTACTAAAAATACGAAAAAATTGTTAGGAGGCCAAGGCAGGCAGATCACGAGGTCAGGAGATCGAGACCATCCTGGCTAACAGTGAAACTCCGTCTCTACTAAAGATACAAAAAAAATTAGCCGGGTGTGGTGGCGGGCACCTGTAGTCCCAGCTACTTGGGAGGCTGAGGCAGGAGAATGGCATGAACCCGGGAGGCGGAGTTTGCAGTGAACCGAGATTGCGCCACTGCACTCCAGCCTGGGCAACAGAGCGAGACTCTGTCTCAAACAAAAAAAAAAGGCGCACATAGTGATGCATGCCTATAATCCCAGCTACTCAGGAGGCTGAGGCAGGAGAATCTCTTGAACCCGAGAGGCTGAGGTTGCAGTGAGCCGAGACTGGGCCATTGCACTCCAGCCTGGGTGACAAGAGTGAAACTCCATCTCAAAAACAAAAAGAAAGGAAAGAAAA","GGCTGGGCGCAGTGGCTCACACCTGTAATCCCAGCACTTAGGGAAGCTGAGGCGAGTAGATCACCTGAGGTCAGGAGTTAGAGACCAGCCTGGCCATCATGGTGAAACCCCGTCTCTACTAAAGATACCAAAAATTAGCTGAGTGTGGTGCTGGGTGCCTGTAATCCCAGAAACTCAGGGTGCCTGTAATCCCAGCAACTCAGGGTGCCTTTAATCCCAGCAACTGAGGGTACCAGTAATCCCAGCAACTCAGGGTGTCTTTAATCCTAGCAACTGAGGGCACCTGTAATCCCAGCAACTCAGGAAGCTGAGACAGGAGAAGTACTTGAACCCAGAAGGCAGAGGTTGCAGTGAGCCGATATTGCACCATTGCACTCCAGTCTGGGCAACAAGAGTGAAACTCTGTCTCAAAAAAAAA"
"chr4","163985921","163986529","JH378118","18053084","18053501","263","145932837","GGCCGGGTGCAGTTGCTTAGGGCTGTAATCCCAGCACTTTGGAAGGGCGAAGCGGGTGTATCACCTGAGGTCAGGAGTTTAACATCAGCCTGGCCAACATGGCGAAACCCCGGCTCTACTACAAATACAAAAATTGTCCGAGCATGGTGGCTCATGCCTGTAATCTCGGCAATTTGGGAGGCCGAGAAGGGCGGATCACCTGAGGTCAGGAGTTCGAAACTAGCCTGACCAATATGGAGAAACCTTGTCTTTACTAAAAATACAAAATTAGCCGGGTGTGGTAGCACATGCCTGTAATCCCAGCTACTCAGGAGGCTGAGGCAGGAGAATCGTTGGAACCCGGGAGGCGGAAGTTGAGGTGAGCTGAGATCGTGCCATTGTGCTCCAGCCTAGGCAACAAGAGAGAAACTCCGTCTCAAAAGAAAAAAAAAATTAGCCGGGCATGGTGGCAAGCACCTGTAATTCCAACTATTCGGGTGGCTGAGGTAGGAGAATCTCTTGAACCCAGGGGTCAGAGGTTGCAGTAAGCCAAGATTGCACCATTGCACTCCAGCCTGGGCGACAAGAGCAAATTCCATTTCAAAAACAAAAAAGCAAACAAAAAAAGAA","GGCTGGGCGCAGTGGCTCACACCTGTAATCCCAGCACTTAGGGAAGCTGAGGCGAGTAGATCACCTGAGGTCAGGAGTTAGAGACCAGCCTGGCCATCATGGTGAAACCCCGTCTCTACTAAAGATACCAAAAATTAGCTGAGTGTGGTGCTGGGTGCCTGTAATCCCAGAAACTCAGGGTGCCTGTAATCCCAGCAACTCAGGGTGCCTTTAATCCCAGCAACTGAGGGTACCAGTAATCCCAGCAACTCAGGGTGTCTTTAATCCTAGCAACTGAGGGCACCTGTAATCCCAGCAACTCAGGAAGCTGAGACAGGAGAAGTACTTGAACCCAGAAGGCAGAGGTTGCAGTGAGCCGATATTGCACCATTGCACTCCAGTCTGGGCAACAAGAGTGAAACTCTGTCTCAAAAAAAAA"
"chr4","167436842","167437184","JH378106","31557967","31558303","52","135878875","GGCCAGGCACGGTGGCTCACACCTGTAATCCCAGCATTTTGGGAGGCCAAGGCAGGTGAATCACCTGAGGTCAGGAGTTCAAGACCAACCTGGCCAACATGGTGAAACCCCGTCTCCACTAAAAATGCAAAAATTAGCTGGGCATGGTGGTGGATGCCTGTAATCCCAGCTACTTGGGAGGCTGAGGCAGGAGAATTGCTTGAACCCCAGAGGCAGAGGTTGCAGTGAGTCAAGATCACACCATTGCCCTCCAGCCTGGGCGACAAGAGTGAAACTCCCATCTCAAAACAACAACAACAACAACCACCAACAACAACAACAAAAAAAAAAAAACAACAAAAAA","GGCCGGGCGCGGTGGCTCAAGCCTGTAATCCCAGCACTTTGGGAGGCCGAGGCGGGTGGATCACAAGGTCAAGAGATCGAGACCAACCTGGTCAACATGGTGAAAGCCCGTCTCTACTAAAAATACAAAAATTAGCTGGGCATGGTGGCGCGTGCCTATAATCCCAGCTACTCAGGAGGCTGAGGCAGGAGAATTGCCTGAACCCAGGAGGTGGAGGTTGCAGTGAGCGAGATTGCGCCATTGCACTCCAGCCTGGGTAACAAGAGCGAAACTCCGTCTCACAAAACAAAACAAAACAAAACAAAACAAAACAAAACAAAAAACAAACAAAAAAAAA"
"chr4","172715187","172715506","JH378141","8679762","8680071","44","164035425","GGCTGGGCCCGGTGGCTCACGCCTGTAATCCCAGCACTTTGGGAGGCTGAGTTGGGCAGATCACCTGAGGTCAGGAGTTCGAGACCAGCCTGGCTAACATGGTGAAACCCCGTTCTATGCAAAATACAAAATACAAAAAAAAATACAAAATTAGCTGGGCATGGTGGCACGTGCCTGCAATCCCAGCTACTCAGGAAGCTGAGGCAGGAGAATTGCTTGAACCTGAGAGGCTGAGGTTGCAGTGAGCCAAGATCGCACCATTGCACTCCAGCCTGGGCGACAAGAGTGAAACTCCATCTCAAAAAAAACAAAAAAAAGAA","GGTCGGGCGCGGTGGCTCAAGCCTGTAATCCCAGCACTTTGGGAGGCCAAGGCGGGTGGATCACGAGGTCAGGAGATCGAGACCATCCTGGTCAACATGGTGAAACCCCGTCTCTACTAAAAATAAAAATAAAAATAAAAAAATTAGCTGGGCATGGTGGCGTGTGTCTGTAATCCCAGCTACTCAGGAGGCTGAGGCAGGAGAATTGCCTGAACCCGGGAGGCGGAGGTTGCGGTGAGCCGAGATCGCGCCATTGCACTCCAGCCTGGGTGACAAGAGTGAAACTCCGTCTCAAAAAAAAAAAAAAAAA"
"chr4","172775055","172775412","JH378106","31557967","31558303","71","141217088","GGCCGGGCGCAGTGGCTCACGCCTGTAATCCCAGCCCTTTGGGAGGCCGAGGCAGGTGAATCCCCTGAGGTCAGGAGTTTGAGACCAGCCCGGCCAACATGGTGAAATCTCATCTCTACTAAAAATACAAAAATTAGCCAGGCGTGGTGGCGGGCACTTGTAATCCCAGCTACTTCAGAGGCTGAGACAGTAGAATCTCTTGAAACTGGAAAGCAGAGTTTGCAGTGAGTCGAGATCGTACCATTGCACTCCAGCCTGGGTGATGAGAGTGAAACTCCATCTCAAACACACACACACACACACACACACACACACACACACACACACACACAAAACAAAAAAAACAAAAAAAAAAAAA","GGCCGGGCGCGGTGGCTCAAGCCTGTAATCCCAGCACTTTGGGAGGCCGAGGCGGGTGGATCACAAGGTCAAGAGATCGAGACCAACCTGGTCAACATGGTGAAAGCCCGTCTCTACTAAAAATACAAAAATTAGCTGGGCATGGTGGCGCGTGCCTATAATCCCAGCTACTCAGGAGGCTGAGGCAGGAGAATTGCCTGAACCCAGGAGGTGGAGGTTGCAGTGAGCGAGATTGCGCCATTGCACTCCAGCCTGGGTAACAAGAGCGAAACTCCGTCTCACAAAACAAAACAAAACAAAACAAAACAAAACAAAACAAAAAACAAACAAAAAAAAA"
"chr4","178395863","178396182","JH378192","5372003","5372306","60","173023860","GACTGGGTGCAGTGGCTCACTCCTGTAATCCCAGCACTTTGGAAGACTGAGGCAGACGGATCACCTGAGTTCAGGAGTTTTGAGACCAGCCTGGCCAACATGGTGAAACCCCTTCTTAACTAAAATTACACACACACACACATACACACACACACACACAAACAAATTAGCTGGCGTGGTGGTGGGCACCTGTAATCCCAGCTACTTAGGAGGCTGAGGCAGGAGAATTGCTTGAACCCGGGAGTGGAGGTTGCAGTGAGCCAAGATCATGCCATGGCACTCCAGCCTAGGCAACAAGAGGGAGATTCCATCTCGAAAAA","GCCGGGCATGGTGGCTCACACCTGTAATCCCAGCACTTTGGGAAGCTGAGGCAGGTGGATCACCTGAGGTCAGGAGTTCAAGACCAACCTGGCCAACATAGTGAAACCCGGTCTCTACTAAAAATACAAAAAAAAAAAAAAAAAAAAAATTAGCTGGGTGTGGTGGCAGGCGCCTGTAATCCCAGCTACTAGGAGGCTGAGGCAGGAGAATTGCTAGAACCCAGGAGGTGGAGGTTGTAGTGAGCCAAGATTGCACCATTGCACTCCAGCCTGGGCAACAAGAGTGACACTCTGTCTCAAAAAA"
"chr4","183497715","183498161","JH378108","45564157","45564495","152","137933558","GGCCAGGCACGGTGGCTGACGCCTGTAATCCCAGCACTTTGTGAGGCTAAGGCGGGTGGATCACCTGAGGTCAGGGGTTCAAGAGCAGCCTGGCCAACATGGCAAAACCCCGTCTTTACTAAAAATACAAAAATTAGCTGGGTGTGGCAGTGGGTGCCTGTAGTTCCAGCTACTTGGGAGGCTGAGGCAGGAGAATTGCTTGAACCCAGGAGTCGGAGGTTGCAGTGAGCCAAGATCTTGCCATTGCCCTCCAGCTTGGGTGACAAGAGCAAAACTCCGTCAAAAAGAAAGAAAGAGAGAGAGAGAGAGAGGAAAGAAAGAAAGAGAGAGGAAAGAAAGAAAGAGAGAGGAAAGAAAGAAAGAAAGAAAGAAAGAAAGAAAGAAAGAAAGAAAGAAAGAAAGAAAGAAAGAAAGAAAGAAAGAGAAAGAGAGAGAGATAAAAAGAAA","GCTAGGCAAGGTGGCTCATGCCTGTAATCCCAACATTTTGGGAGGCCGAGGCAGATGGATCACCTGAGGTTAGGAGTTCAAGACCAGCCTGGCCAACATGGTGAAACTCCATCTCTACTAAAAATACAAAAAATTAGCTTGGCACGGTGGTGGGTGCCTCTAATCCCAGCTGCTTGGGAGGCTGAGGCAGGAGAATCGCTTGAACTCAGGAGGTGGAGGTTGCAGTGAGCCAAGATCATGGCATTGCACTCCAGCCTGGGCGACAAGAGCGAGACTCCCTCTAAGAAAGAAAAGAAAGAAAAGAAAAGAAAAAAGGAAAGGAAAGGAAAGAAAGAGAAA"
"chr5","3141852","3142196","JH378138","5283086","5283413","50","2141234","GGCCTGTCATGGTGGCTCACTCCTGTAATCACAGCACTTTGAGAGGCTGAGGCAGTTTGGATCACCTCAGGTCAGGAGTTTGAGACCAGCCTGGCCAACATGGTGAAACCCTGTCTCTACTAAAAATACAAAAAATTAGCTGGGCATGGTGGCAGGCGCCTGTAATCCCAGCTACTCGGGAGGCTGAGGCAGGAGAATCCTTGATACCTGGGAGGCAGAGGTTGCAGTGAGCCAAGATCACGCCATTGCATTCCAACCTGGGCCACAAGAGCAAAACTCCATCTCAAAAATGATAAATAAATAAATAAATAAATAAATAAATAAATAAAACAAAATAAAATAAAA","GGTAGCTCACACCTGTAATCCCAGCACTTTGGGAGGGTGAAGAGAGTGGATCACCTGAGATCAGGAGTTTGAGACCAGCCTGGCCAACGTGGTAAAACCCTGTCTCTACTAAAAATACAAAAAAATTAGCTGGGCATGGTGGCAGGCACCTGTAATCCCAGCTACTCAGGAGGCTGAGGGAGGAGAATTGCTTGAACCTGGGAGGCAGAGGTTGCAGTGAGCTGAGATTGTGCCACTGCATTCCAGCCTGGGCGACAAGAGTGAAACTCCACCTCAAATAAATAAATAAATAAATAAATAAATAAATAAATAATAAATAAATAAATAA"
"chr5","17616490","17616823","JH378140","12909800","12910119","55","4706690","GCTGGGTGCGGCGGCTCACGCCTGTAATCCTAACACTTTGAGAGGCCAAGGCAGGTGGACCACTTGAGGTCAGGAGTTCGAAACCAACCTGACCAATATGGCAAAACCCCATCTCTACTAAACACACACACACACACACACACACACACACACAAAATTAGCCGGGCATGGTGGCAGGCGCCTATAATCCCAGCTACTCAGGAGGCTGAGGCAGGAAAATGGCTTGAACCCAAGAGGTGGAGGTTGCAGTGAGCCGAGATCGCACCATTGCACTCCAGCCTGGGCAACAAGAGTGAAACTCCATCTAAAAAAAAGAAAAGAAAAGAAAAGAAAA","GGCCGGGTGCGGTGGCTCACGCCTGTAATCCCAGCACTTTGGTAGGCCGAGGCGGGTGGATCACGAGGTCAAGAGATCGAGACCAACGTGGTCAACATGGTGAAACCCCGTCTCTACTAAAAATACAAAAAAAAAAAAAAATTAGCTGGGCATGGTGGCGCGTGCCTGTAATCCCAGCTACTCAGGAGGCTGAGACAGGAGAATTGCCTGAACCCAGGAGGTGGAGGTTGCAGTGAGCCGAGATCGCACCATTGCACTCCAGCCTGGGTAACAAGAGTGAAACTCTGTCTCAAAAAAAAAAAAAAAAAAAGAAAAGAAAA"
"chr5","29275482","29275824","JH378144","13229286","13229620","59","16046196","GGCTGGGCGCAGTGGCTCACGCCTGTAATTCCAGCATTTTGGGAGGCCGAGGCAGGTGGATCTCCTGAGGTCAGGAGTTCGAGACTAGTCTGGTTAACATGGTGAAACCCTGTCTTTACTAAAAATATAAAAAATTAGCCTGGGGTGGTGGTGCACGCCTGTAATCCTGGCTATTCGGGAGGCTAAGGCAGGAGAATCGCTTCAACCTGGGAGATGGAGGTTGCAGTGAGCTGAGATTGAGCCATTGTACTGCATCCTGGGTGACAAGAGTGAAATTCCATCTCAAAAACAAATGAATGAATGAATGAATGAATGAATAAATAAATAAATAAATAAATAAAAA","GGCCGGGCGCGGTGGCTCAAGCCTGTAATCCCAGCACTTTGGGAGGCCGAGGCGGGTGGATCACCTGTGGTCAGGAGTTCAAGACAGCTTGGTCAACATGGTGAAACCCCGTCTCTACCAAAAATACAAAAAATTAGCTGGGCATGGTAGCGCATGCCTGTAATCCCAGCTACTCAGGAGGCTGAGGCAGGAGAATTGCCTGAACCCAGGAGGCAGAGGTTGCGGTGAGCCGAGATCGCGCCATTGCACTCCAGCCTGGGTAACAAGAGCGAAACTCCCTCTCATAAAAAATAAATAAATAAATAAATAAATAAATAAATAAATAAATAAATAAA"
"chr5","32275343","32275719","JH378169","5922203","5922541","91","26353140","GGCTGGGTGTGGTGGCTCACACCTGTAATCTCAGCACTTTGGAGGCCAAGGCGGGCAGATCTCCTGAGGTCAGGAGTTTGAGACCAGCCTGGCCAATGTGGTGAAACCCCGTCTCTACTTAAAAAAAAAAATATATATATATACACACACACACACACACACACACACACACACACACACACACACACAAATTAGCCAGGCATGCTGGCAAGTGCCTGTAATCCCAGCTACTCAGGACGCTGAGGCAGGAGAACTGCCTGAACCCGGGGGGTAGAGGTTGCATCGAGTCAAGATCACTCCACTGCACTCCAGCCTGAGTGACAAGAGCGACACTCTATCTAAATAAAACCCCCCCCAAAAACCAAAAAAACAAAAAA","GGCCAAGGGTGGTGGCTCACACCTGTAATCCCAACACTCTGGGAGGCCAAGGTGGGTGGATCACCTAAGGTCAGGAGTTCAAGACCAGCATGGCCAATATAGTGAAACTCTGTCTCTACTAAAAATACACACACACAAAAAAAAACAAAACACAAAAAAAACCACAAAATTAGCCGGGCATGGTGGCATGTGCCTGTAATCCCAGCTACTCAGGAGGCTGAGGCAGGAGAATCACTTAAACCCAGGAAGCGGAGGTTGCAGTGAGCCAAGATTGCGCCACTGCACTCCAGCCTAGGTGACAAGAGCAAAACTCTGTCTCAAAAAAAAAAAAAAAAAAAA"
"chr5","32477124","32477455","JH378208","3909771","3910091","47","28567353","GGCCGAGCACGGTGGCTCACGTCTGTAACCCCAGCAGTTTGGGAGGCCGAGGTGAGTGGATCACCTGTGGTCAGGAGTTCAAGACCAGCCTAGCCAACATGGTGAAACCTTGTCTCTACTAAAAATACAAAAAAAAAAAAAAAAAAAAAAAAAAAAAGCTGGGTGTGGTGGCACATGCCTGTAATCCCAGCTACTCGGGAAGGTGAGGCAGGAGAATTGCTTGAACCCGAGAGGCGGAGGTTGCAATGAGCCAAGATTGCACCATTGCACTCCAGCCTGGGCTACAAGAGCGAAACTCCATCTCAAAATAAATAAATGAATAAATAAATAAA","GCCGGGTGCGGTGGCTCAAGCCTGTAATCCCAGCACTTTGGGAGGCCGAGGCGGGTGGATCACGAGGTCGTGAGATCAAGACCAGCCGAGCCAACATGGTGAAACCCCGTCTCTACTAAAAATACAAAAAAAAAAAAAAAAAAAAAAAAATTAGCTGGGCATGGTGGCGTGTGCCTGTAATCCGAGCTACTCAGGAAGCTGAGGCAGGAGAATTGCCTGAACCCAGGAGGCGGAGGTTGCAGTGAGCCGAGATCGCGCCATTGCACTCCAGCCTGGGTAACAAGAGCGAAACTCCGTCTCAAAAAAAAAAAAAAAAAAAAA"
"chr5","32899646","32900270","JH378118","18053084","18053501","278","14846562","GGTTGGGCGCGGTGGCTCACGCCTGTAATCCCAGCACTTCGGGAGGCCGAAGCGGGTGGATCATCTGAAGTCAGTGAGACCAGCCTGGCCAACATGGTGAAACCCCCGTCTCTATTAAAAATACAAAAATTAGCGGCATGGCGCGGTGGCTGAGGCTGAGGCGGGCTGATCACGAGGTTAGGGGTTTGAGACTATCCTGGCCAACATGGTGAAACTCCGTCCCTACTAAAAATACAAAAATTAGCCGGGTGTGATGGCAGGCGCCTATAATCCCAGCTACTCGGGAGGCTGAGGCAGGAGAATCGCTTGAACCTGGGAGGCGGAGGTTGCAGTGAGCCTATACTACGCCACTGCACTCAAGCCTGGGCGACGGAACGACACACACACACACACACACACACACACACACACACACACACACACACACACACACACACACACACTTAGCTGGATGTAGTGGCGGGCGCCTGTAATCCCAGCTACTCAGGAGGCTGAGGCAAGAGAATCGCTTGAACCTGGGAGACGGAGGTTGCAATGAGCAGAGATCGCGCCATTGCACTCCAGCCTGCGCGACAAGAGCAAAACTCCGTCTCAAAAGTAACTAATAATAAAATAAAATAAAAAA","GGCTGGGCGCAGTGGCTCACACCTGTAATCCCAGCACTTAGGGAAGCTGAGGCGAGTAGATCACCTGAGGTCAGGAGTTAGAGACCAGCCTGGCCATCATGGTGAAACCCCGTCTCTACTAAAGATACCAAAAATTAGCTGAGTGTGGTGCTGGGTGCCTGTAATCCCAGAAACTCAGGGTGCCTGTAATCCCAGCAACTCAGGGTGCCTTTAATCCCAGCAACTGAGGGTACCAGTAATCCCAGCAACTCAGGGTGTCTTTAATCCTAGCAACTGAGGGCACCTGTAATCCCAGCAACTCAGGAAGCTGAGACAGGAGAAGTACTTGAACCCAGAAGGCAGAGGTTGCAGTGAGCCGATATTGCACCATTGCACTCCAGTCTGGGCAACAAGAGTGAAACTCTGTCTCAAAAAAAAA"
"chr5","37567190","37567807","JH378118","18053084","18053501","268","19514106","GGTCAGGTGCAGTGGCTCACAACTGTAATCCCAGCACTTTGGGAGGCTGAGGTGGGCAGATCACCTGAGGTCAGGACTTCGAGACAAGCCTGGCCAACATGATGAAACCCCATCTCTGTTAAAAATGTGAAAATTGGCTGGGCACGGTGGCTCACGCCTGTAATCCCAGCACTTTGGGAGGCCTAGGCAGGCGGATCACGAGGTCAAGAGATAGAGACCATCCTGGCCAATATGGTGAAACCCCGTCTGTACTAAAAATACAAAAAAAAAAATTAGCCGGGTGTGGTGGCAGGCGCCTGTAGTCCCAGTTACTTGGGAGGCTGAGGCAGGAGAATGGCGTGAACCCAGGAGGTGGAGCTTGCAGCGAGCCGAGATAGCGCCACTGCACTCTGGCCTGGGCGATAGAGCGAGACTCTGCCTCAAAAAAAAAAATGAAAATGAAAATTAGCCAGGTGTGGTGGCTAGTGCCTGTAATCCCAGCTACTTGGGAGGCTGAGATAGGAGAATCCCTTAAACCTAGGAGGCAGAGGTTGCAGTGAGCAGAGATCGTGCCATTGCACTCCAGCATGGGTGACGAGAGTGAAACTCCATCTAAAAAAATAATAAAATAAAATAAAA","GGCTGGGCGCAGTGGCTCACACCTGTAATCCCAGCACTTAGGGAAGCTGAGGCGAGTAGATCACCTGAGGTCAGGAGTTAGAGACCAGCCTGGCCATCATGGTGAAACCCCGTCTCTACTAAAGATACCAAAAATTAGCTGAGTGTGGTGCTGGGTGCCTGTAATCCCAGAAACTCAGGGTGCCTGTAATCCCAGCAACTCAGGGTGCCTTTAATCCCAGCAACTGAGGGTACCAGTAATCCCAGCAACTCAGGGTGTCTTTAATCCTAGCAACTGAGGGCACCTGTAATCCCAGCAACTCAGGAAGCTGAGACAGGAGAAGTACTTGAACCCAGAAGGCAGAGGTTGCAGTGAGCCGATATTGCACCATTGCACTCCAGTCTGGGCAACAAGAGTGAAACTCTGTCTCAAAAAAAAA"
"chr5","37688191","37688793","JH378118","18053084","18053501","255","19635107","GGTCAGGCACGGTGGCTTACACCGGTAATCCCAGCACTTTGGAAGCCGAGGTGGGAGGATCACCTGAGGCCAGGAGTTCGAGACCAACCTGGCCAACATGGTGAAACCCCGTCTCTACTAAAAATACAGAAAATTAGCCAGGCGTAGCTGGACGCGGTAGCTCACGTCTGTAATCCCAGCGCTTTGGGAGGCCAAGGCGGGTGGATCACTTCAGGTCAGGAGTTCAAGACCAGCCTGACCAACATAGTAAAACCCCCGTCTCTACTAAAAATACAAAAAAATTAGCTGGGCATGATGGCATGTGCCTGTAATCCCAGCTACTCGGAAGGCTGAGGCAGAATTGCTTGAACCTGAGAGGTGGAGGTTGCAGTGAACAGAGATCATGACACTGGCACTCCAGCCTGGGCAACAAAAGCAAAACTCCATCTCAAAAAAAAAATAAAGAAAAGAAAATTAAGAAAATTAGCCTGTAATTCCAGCTACTTGGGAGGCTGAAGCAGGAGAATTGCTTGAACCTGGGAGGCAGAGGTTGCAATGAGCTGAGATCGCATGATTGCACCCCAGCCTAGGTGACAAGAGCAAAACTCTGTTAAAAAAAAAAAA","GGCTGGGCGCAGTGGCTCACACCTGTAATCCCAGCACTTAGGGAAGCTGAGGCGAGTAGATCACCTGAGGTCAGGAGTTAGAGACCAGCCTGGCCATCATGGTGAAACCCCGTCTCTACTAAAGATACCAAAAATTAGCTGAGTGTGGTGCTGGGTGCCTGTAATCCCAGAAACTCAGGGTGCCTGTAATCCCAGCAACTCAGGGTGCCTTTAATCCCAGCAACTGAGGGTACCAGTAATCCCAGCAACTCAGGGTGTCTTTAATCCTAGCAACTGAGGGCACCTGTAATCCCAGCAACTCAGGAAGCTGAGACAGGAGAAGTACTTGAACCCAGAAGGCAGAGGTTGCAGTGAGCCGATATTGCACCATTGCACTCCAGTCTGGGCAACAAGAGTGAAACTCTGTCTCAAAAAAAAA"
"chr5","39552560","39553195","JH378118","18053084","18053501","275","21499476","GGCTGGGTTTGGTGTCTCACACCCGTAATCCCAGCACCTTGGGAGGCCGAGGTGGGCGTATCACCTGAGGTCAGGGGTTCAAGACCAGCCTGGCCAACATGGTGAAACCCCGTCTCTACTAAAAATACAAAAAATTAGCTGGGCGTGGCCGGGTGTGGTGGCTCATGCCTGTAATCCCAGCATTCTGGGAGGCCGAGGCAGGTGGATCATGAGGTCAGGAGATCGAGAGCATCCTGGCTAACATGGTGAAACCCCATCTCTACTAAAATATACAAAAAAAAAAATTAGCTGGGTGTGATGGCGGGAGCTTATAGTCCCAGCTACTCAGGAGGCTGAGGCAGGAGAATGGCGTGAACCTGGGAGGCGGAGTTTACAGTGAGCTGAGTCCACGCCACTGCACTCCAGCCTGGGCGACAGAGCGAGACTGTCTCAAAAAAAAAAAAAAAAGAAAAAAAATTAGCTGGGGATGGTGGTGGGCACCTGTAATCCCAGCTACTCAGGAGGCTGAGGCAGGAGTATCACTTGAACCTGGGAGGCGGAGGCTGCAGTGAACCAAGATTACGCTGTTGCACTCCAGCCTGGGCTACAAGAGCAAAACTCTGTCTCAAAAATAAATAAATAAATGAATAAAAGAAA","GGCTGGGCGCAGTGGCTCACACCTGTAATCCCAGCACTTAGGGAAGCTGAGGCGAGTAGATCACCTGAGGTCAGGAGTTAGAGACCAGCCTGGCCATCATGGTGAAACCCCGTCTCTACTAAAGATACCAAAAATTAGCTGAGTGTGGTGCTGGGTGCCTGTAATCCCAGAAACTCAGGGTGCCTGTAATCCCAGCAACTCAGGGTGCCTTTAATCCCAGCAACTGAGGGTACCAGTAATCCCAGCAACTCAGGGTGTCTTTAATCCTAGCAACTGAGGGCACCTGTAATCCCAGCAACTCAGGAAGCTGAGACAGGAGAAGTACTTGAACCCAGAAGGCAGAGGTTGCAGTGAGCCGATATTGCACCATTGCACTCCAGTCTGGGCAACAAGAGTGAAACTCTGTCTCAAAAAAAAA"
"chr5","58531934","58532516","JH378118","18053084","18053501","238","40478850","GGTTGGGCGCAGTGGCTCACGCCTGTTATCCCAGCACTTTGGGAGGCCGAGGCAGGCAGATCACCTGAGGTCAGGAATTCGAGACCATCCTGGCCAACATGATGAAATCCCATCTTTATTAAAAATACAAAAATTAAGGCTGGGCATGGTAGCTCACACCTGTAATCCCAGCACTTTGGGAGGCTGAGGCAGGTGGATCATGATGTCAGGAGTCCAAGACCAGCCTGGCCAATATGGTGAAACCCTGTCTCTACTCAAACTACAAAAATTAGCCAGGCACAGTGGCAGCTGCCTGTAATCCCAGCTACTCGGGAGGCTGAGGCAGGAGAATCGCTTGAACCCGGGCAGCAGAGGTTGCGCCACTGCACTCCAGCCTGGGTGACACAGTGAGACTTTGTCTCAAAAAAAAAAAAAAAAAAAAAATACAATAATTAGCTGGCCATAGTGGCAGGCACCTGCAATCCCAGCTACTCGGGAGGCTGAGGCAGGAGAATTGCTTGAATCTGGGAAGCAGAGGTTGCAGTGAGCCGAGATCACTCTATTGCACTCCAGGCTGGGGAATAAGAGCAAGACTTTGTCTCAA","GGCTGGGCGCAGTGGCTCACACCTGTAATCCCAGCACTTAGGGAAGCTGAGGCGAGTAGATCACCTGAGGTCAGGAGTTAGAGACCAGCCTGGCCATCATGGTGAAACCCCGTCTCTACTAAAGATACCAAAAATTAGCTGAGTGTGGTGCTGGGTGCCTGTAATCCCAGAAACTCAGGGTGCCTGTAATCCCAGCAACTCAGGGTGCCTTTAATCCCAGCAACTGAGGGTACCAGTAATCCCAGCAACTCAGGGTGTCTTTAATCCTAGCAACTGAGGGCACCTGTAATCCCAGCAACTCAGGAAGCTGAGACAGGAGAAGTACTTGAACCCAGAAGGCAGAGGTTGCAGTGAGCCGATATTGCACCATTGCACTCCAGTCTGGGCAACAAGAGTGAAACTCTGTCTCAAAAAAAAA"
"chr5","58862574","58863186","JH378118","18053084","18053501","250","40809490","GGCCGGGAGTGGTGGCTCATGCCTGTAATCCCAGCACTTTGGGAGGCCGAAGTGGGCAGATCATCTGAGGTCAGGAGTTTGAGACCAGCCTGGCTAACATGGTGAAACCCCGTTTCTACTGAAAATATAAAAAATTAGGCCAGGTGTAGTGGCTCATGCCTGTAATCCCAGCACTTTGGGAGGCCAAGGCGGGCGGATCATGAGGTCAAGAGATCAAAATCATCCTGGCCAACATGGTGAAACCCCGTCTCTACTAAAAATACAAAAATTAGCTGGGCATGGTGGCATGCGCCTGTAGTCCCAGCTACTCGGGAGGCTGAGGCAGGAGAATCACTTGAACCCGGGAGGCAGAGGTTGCAGTGAGCCAAGATCACGCCACTGCACTCCAGCCTGGTGACAGAGTGAGACTCCATCTCAGAAAAAAACAAAAAATTCAAAAAGTTAGCCAGGCGTGGTGGCACAGGCCTGTAATCCGAGCTACTCAGGAGGCTGAGGCAGGAGAATCGCTTGAACCCAGGAGGCAGAGGTTGCAGTGAGCTGAGATTGCGCCATTGCACTCTGGCTTGGGCAACAAGAGCGAAACTCCATCTCAAAAAAAAAAAAAGAAAAGAAA","GGCTGGGCGCAGTGGCTCACACCTGTAATCCCAGCACTTAGGGAAGCTGAGGCGAGTAGATCACCTGAGGTCAGGAGTTAGAGACCAGCCTGGCCATCATGGTGAAACCCCGTCTCTACTAAAGATACCAAAAATTAGCTGAGTGTGGTGCTGGGTGCCTGTAATCCCAGAAACTCAGGGTGCCTGTAATCCCAGCAACTCAGGGTGCCTTTAATCCCAGCAACTGAGGGTACCAGTAATCCCAGCAACTCAGGGTGTCTTTAATCCTAGCAACTGAGGGCACCTGTAATCCCAGCAACTCAGGAAGCTGAGACAGGAGAAGTACTTGAACCCAGAAGGCAGAGGTTGCAGTGAGCCGATATTGCACCATTGCACTCCAGTCTGGGCAACAAGAGTGAAACTCTGTCTCAAAAAAAAA"
"chr5","63752748","63753198","JH378118","9548216","9548555","214","54204532","TGAACCCGGAAGGCAGAGGTTGCAGTGAGCCGAGATTGCACCATTGCACTCCAGCCTGGGCAACAAGAGTGAAACTCATCTCAAAAATAAAAATAAAAAGAACAAGATCATGTCCTTTGTAGGGACATGGATGGAGCTGGAGGCCGTTACCCTTAGCAAACTAACACAGGAATCAAAAACCAGATACCGCCATGTTCTCACTTACAAGTGGGAGCTAAATGATGCGAACACATGGACATGTAGAGGAGAACAGCACACACTGGGGCCTTTTGGAGAAGGTGAAGGATGGGAGGAAGGAGAGGATCGGGAAAAATAACTAATTGGTACTAGCTTTAATACCTGGATAATGAAATAATCTGTACGGCAAACCCGTGTGACACAAGTTTACCTATGTAACAAACCTGTACTCGTACCCCGAACTTAAAAGTTAAAAAAAAAAGAAACAGAAAAA","GGCCAGGCGCGGTGACTCATGCCTGGAATCTCAGAACTTTAGGAGGCCAACGCAGGTGGATCACCTCAAGTCAGGAGACTGAGGCAGATGGATCACCTAAGATCAGGAGTTCAAGACCAGCCTGACCAATATAGTGAAACACCATCTCTACTAAAAATACAAAATTAGCCGGGCATGGTGGCAGGTATCTGTAATCTCAGCTACTTGGGAGGCTGAGGTGGGAGAATCACTTGAACCCAGGAAGCAGAGGTTGCAGTGAGCCGAAATCACACCACTACACACCAGCCTAGGCGACAAGAGCAAGATTCTGTCTAAAAAAAAAAAAAAAAAAAAAAAAAAA"
"chr5","71124788","71125683","JH378118","18053084","18053501","515","53071704","GGCCAGACGCCGTGCCTCACTCCTGTAATCCCAGCACTTTGGGAGGCTGAGGCAGGCATATCACCTGAGGTCGGGAGTTCAAGACCAGCCTGGTTAACATGGTGAAAGCCATCTCCACTAAAAATAAATAAAATTGGCCTGGTGCGGTGGCTCATGCCTGTAATCCTAGCACTTTGGGAGGCTGAAGCGGGTGGATCACCTTAGGTCAGGAGTTTGAGTGCAGCATGGCCAACACGGCGAAACCCTGTCTCTACCAAAAATACAAAAATTAGCCGAGCGTGGTGGTGGGCGCTTATAATCCCAGCTAGTCAGGAGGTTTAGCAGGAGAATCGCTTGAACCCGGTGTGGCAGGGCAGAGGTTGCAGTGAGCGGAGATCGCACCACTGCACTCCAGCCTGGGCGACAGATTGAGATTCCATCTCAAAAAAAAATTAGCTGAGCGTGGTGGCAGGCGCCTATAATCTCAGCTACTCAGGAGGCTAAGTCAGGAGAATCACTTGAACCCCGGAGGCAGAGGTTGCAGTAAGCCAAGACCGTGCCATTGGCCGGGCGCGGTGGCTCACACCTGTAATCCCAGCATTTTGGGAGGCCGAGGCGGGCAGATCACGAGGTCAGGAGATCAAGACCATCCTGGCTAACATGGTGAAACCCTGTCTCTACTAAAAATACAAAAAATTAGCCGGGCATGGTGGCGGGCGCCTGTAGTCCCAGCTACTCCGGAGGCTGAGGCAGGAGAATGGTGTGAACCCGGGAGGCGGAGGTTGCAGTGAGCCGAGATGGTGCCGCTGCACTCCAGCCTGGGCGACAGAGCGAGACTCCGTCTCAAAGCAAAAAAAAGATCGCGCCATTGTACTCCAGCATGGGCAATAAGAGTGAGACTCTGTTTCAGAAAAAAA","GGCTGGGCGCAGTGGCTCACACCTGTAATCCCAGCACTTAGGGAAGCTGAGGCGAGTAGATCACCTGAGGTCAGGAGTTAGAGACCAGCCTGGCCATCATGGTGAAACCCCGTCTCTACTAAAGATACCAAAAATTAGCTGAGTGTGGTGCTGGGTGCCTGTAATCCCAGAAACTCAGGGTGCCTGTAATCCCAGCAACTCAGGGTGCCTTTAATCCCAGCAACTGAGGGTACCAGTAATCCCAGCAACTCAGGGTGTCTTTAATCCTAGCAACTGAGGGCACCTGTAATCCCAGCAACTCAGGAAGCTGAGACAGGAGAAGTACTTGAACCCAGAAGGCAGAGGTTGCAGTGAGCCGATATTGCACCATTGCACTCCAGTCTGGGCAACAAGAGTGAAACTCTGTCTCAAAAAAAAA"
"chr5","71125721","71126321","JH378206","6546474","6546861","256","64579247","CCGGGCGTGGTGGCTCACGCCTATAATCCCAGCTCTTTGGGAAGCCGAGGCATCACCTAAGGTCATGAGTTTGAGACCAGACTGGCCAACATGGTGAAATCCTGTCTCTACTAAAAATACAAAATTAGGGCTGAGTGCGGGGGCTCACGCCTGTAATCCCAGCACTTTGAGAGGTCGAGGCGGGAGGATCACAAGGTCAAGAGTTCGAGACCAGCCTGGCCAACATGGTGAAACCTCATCTCTACTAAAAATACAAAAATTAGCTGAGCATGGTGGCGGGCGTCTGTAGTCCCAGCTACTCAGGAGGCTGAGGCAGGAGAATTGCTTGAACCCGGAGGCAGAGGTTGCAGTGAGCTGAGATCTCAACACTGCACTCCAGCCTGGGGGACAGAGCAAGACTTCATCTTGGGGGAAAAAAAAAATTAGCCGGGCATGGTGGCACACGCCTGTAACCCCAGCTACTCGGGGGGCTGAGGCAGGAGAATTGCTTCAACCTGAGAGGTGGAGGTTAGAGTGAGCCGAGAGCGCGCCATTGCATTCCAGCCAGGGCAACAAGAGTGAAACTCCGTCTCAAAAAAAAAAAAAAAAAAAAAGAAAGAAA","GGCCACACATGGTGGCTAACGCCTGTAATCCCAGCACTTTGGGAGGCCAAGTCGGGTGGATCATGAGGTCAGGAGACCAAGACCATCCTGGCCAAATGGTGAAACCCCGTCTCTACTAAAAATACAAAAATTAGCTGGGCATGGTGGCGTGTGCCTGTAATCCCAGCTACTCAGGAGGCTGAGGCAGGACAATTGCCTGAACCCAGGAGAATTAGCTGGGCATGGTGGCGTGTGCCTGTAATCCCAGCTACTCAGGAGGCTGAGGCAGGACAATTGCCTGAACCCAGGAGGCGAAGGTTGCGGTGAGCCGAGATTGTGCCATTGCACTCCAGCCTGGGTAACAAGAGCGACACTCTGTCTCAAAAAAAAAAAAAAAAAAAAAAAAAAA"
"chr5","75729860","75730175","JH378254","873499","873817","43","74856361","GGCCGGGCACGATGGCTCACGCCTGTAATCCCAGCACTTTGGAAGGCCAAGGCGGGTGGATCACCTGAGGTCAGGAGTTAGCGACCAGCCTGGCCAACATGGTGAAACCCTATCTCTACTAAAAATACAAAAAAAAAAAAAAAAAAAAAAAAAAGCTGGGCATGGTGGCAGGTGCCTGTAATCCTAGCTACTTGGGAGGCTGAGGCAGGAGAATCGCTTGAACCTGGAAGGCGGAGGTTGCATGAGCTGAGATTGTGCCATTGCACTCCAGCCTGGCCAACAAGAGCAAAACTCCATCTCAAAGAAAGAAAGAAAA","GGCCGGGCGAGGTGGCTCAAGCCTGTAATCCCAGCACTTTGGGAGGCCGAGGCGGGTGGTTCATGAGGTCAAGAGATCGAGACCATCCTGGTCAACATGGTGAAACCCCGTCTCTACTAAAAATACAAAAAAAAAAAAAAAAAAAAAAAAAGTTAGCTGGGCATGGTGGCGCTTGCCTGTAATCCCAGCTACTCAGGAGGCTGAGGCAGGAGAATTGCCTGAACCCAGGAGGCGGAGGTTGCGGTGAGCCGAGATTGCGCCATTGCACTCCAGCCTGGGTAACAAGAGTGAAACTCCGTCTCAAAAAAAAAAAAGAAAA"
"chr5","86998053","86998417","JH378298","1088088","1088359","148","85909965","GTTCAAGACCAGGCTGGTCGACATGGTGAAATCCTGTCTCTACTAAATATACAAAAATTAGCCAGGCGTGGGGTGGGCACCTCTAATCCCAGCTACTCGGGAGGCTGAGGCAGGAGGATCGCTTGAACACGGGAGGCAGAGGTTGCAGTGAGCCAAGATCGTGCCATTGTGCTCCAGTCTGGGCAACAAGAGTGAAACTTCATCTCAAAAATAAAAGACTACACATTGGGTACAGTGTATGCTGCTCGGTAATGGGAGCACCAAAATCTCAGAAATCACCACTAAAGAACTTATTCATGTAACCAAACACCCACTTGTTCCTCCAAAAACCAATTGAAATAAAAAAAGTTTTTAAAAAAAGAAAA","TTCGAGACCAGTCTGACCAATACGATGAAACGCCATCTCTACCAAAAACACAAAAATTAGCAGGGCATGGTGGCATGTGCCTGTAATCCCAGCTACTCGGGAGGCTGAGACAGGAAAATCACTTGAACTCAGGAGGCAGAGGTTGCAGTGAGCCGAGAGGTTGCAATGGCAGGGAATAGCGGCAGAGCGCCGTCGCACTCCTGGGCAACAAGAATGAAACTCTGTCTCAAAAAAAAAGAAGGTTCTTAATTATTTAAAGAAAAAAAAAAAAA"
"chr5","89764398","89765043","JH378118","18053084","18053501","290","71711314","GGCCAGGCACGGTGGCTCACACCTGTAATCCCAGCACTTTGGGAGGCCCAGGCGGATGGAGTGCCTCGGGTCAGGAGTTCAAGACCAGCCCAACCAACATGATGAAACCCCATCTCAACTAAAAATAGAAAAAAAAAAAAAAAAAAAAAACGCCTGGCATGGTGGCTCACTCCTGTAATCCCAGCACTTTGGGAGACTGAGGCCAGCAGATCACAAGGTCAGGAGATCAAGACCATCCTGGCTAACATGGTGAAACCCCACCTCTACTAAAAAAAAAATATATATATACAGATAATTAGCCAGGTGTGGTGGCGGGCGCCTGTAGTCCCAGCTACTCGGGAGGCTGAGGCAGGAGAATGGTGCAAACCCTGGAGGCAGAGCTTACAGTGAGCTGAGATCGTGCCAATGCACTCCAGCCTGGGCGACAGAGCCAGACTCCGTCTCAAAAAAAAACAACAACAACAACAAAAATTAGCTGGGTGTGGTGGCGGGAGCCTGTAATCCAGCTACTCGGGAGGCTGAGGCAGGAGAATAGCTTGAACCCAGAAGGCGGAGGTTGCAGTGAGCCGAGATCGTGCCATTGCACTCCAGCCTGGGCAACAAGAACGAAACTCCGTCTCAGGAAAAAAAAAAAAAAAAAAAAGAA","GGCTGGGCGCAGTGGCTCACACCTGTAATCCCAGCACTTAGGGAAGCTGAGGCGAGTAGATCACCTGAGGTCAGGAGTTAGAGACCAGCCTGGCCATCATGGTGAAACCCCGTCTCTACTAAAGATACCAAAAATTAGCTGAGTGTGGTGCTGGGTGCCTGTAATCCCAGAAACTCAGGGTGCCTGTAATCCCAGCAACTCAGGGTGCCTTTAATCCCAGCAACTGAGGGTACCAGTAATCCCAGCAACTCAGGGTGTCTTTAATCCTAGCAACTGAGGGCACCTGTAATCCCAGCAACTCAGGAAGCTGAGACAGGAGAAGTACTTGAACCCAGAAGGCAGAGGTTGCAGTGAGCCGATATTGCACCATTGCACTCCAGTCTGGGCAACAAGAGTGAAACTCTGTCTCAAAAAAAAA"
"chr5","90959360","90959713","JH378169","5922203","5922541","68","85037157","GGCCAGGCATGGTGGCTCACACCTGTAATCCCAACACTTTAGCAGGCCAAGGTGGGCAGATCACCTGAGGTTGGGAGTTCAAGACCAGTCTGGCCAACATGGTGAAACCCTGTCTCTACTAAAAATACACACACACACACACACACACATACACACACATACACACACACACAAATTAGCTGAGTGTGGTGGTGGGTGCCTGTAATCCCAGCTACTTGGGAGGCTGAGGCAGAATTGCTTGAACCCAGGAGGCAGAAGTTACAGTGAGCCAAGATCGCACCATTGCATTCCAGCCTGGGCAACAAGAGCAAGACTCTGTCTCAAAACTAAGTAAATAAATAAAATAAAATAAAA","GGCCAAGGGTGGTGGCTCACACCTGTAATCCCAACACTCTGGGAGGCCAAGGTGGGTGGATCACCTAAGGTCAGGAGTTCAAGACCAGCATGGCCAATATAGTGAAACTCTGTCTCTACTAAAAATACACACACACAAAAAAAAACAAAACACAAAAAAAACCACAAAATTAGCCGGGCATGGTGGCATGTGCCTGTAATCCCAGCTACTCAGGAGGCTGAGGCAGGAGAATCACTTAAACCCAGGAAGCGGAGGTTGCAGTGAGCCAAGATTGCGCCACTGCACTCCAGCCTAGGTGACAAGAGCAAAACTCTGTCTCAAAAAAAAAAAAAAAAAAAA"
"chr5","104374444","104374789","JH378262","266823","267148","53","104107621","GGCCGGGCGCAGTGGCTCACGCCTGTAATCCCAGCACTTTGGGAGGCCGAGGCGGGCTTATCACCTGAGGTCAGAAGTTCGAGACCAGCCTGGCCAACATGGTGAAACCCTGTCTCTACTAAAAATACAAAATTAGCCAGGCGTGGTGGCACATGCCTGTTATCCCAGCTACTAGAGAGGCTGAGGCAGGAGAATCACTTGAACCTGGGAGGCGGAGGTTGCAGTGAGCCGAGATCGTGCCATTGCACTCCAGCCTGGGCAACAAGAGCAAAACTCTCCGTCTCACACACACAACACACACACACACACACACACAAAAAAAAAAAAAAAAAAGGAAAAAAGAAAA","GGCCGGGCGCGGTGGCTCAAGCCTGTAATCCCAGCACTTTGGGAGGCCGAGGCGGGTAGATCATGAGGTCAGGAGTTTGAGACCAGCCTGGCCAACATGGTGAAACCCCGTCTCTACTAAAAATACAAAAATTAGCCGGGCATGGTGGCCTGTGCCTGTAATCCTAGCTACCCAGGAAGCTGAGGCAGGAGAATTGCCTGAACCCAGGAGGCGGAGGTTGCGGTGAGCCGAGATCGTGCCATTGCACTCCAGCCTGGGTAACAAGAGCGAAACTCCGTCTCAAAAACAAACAAACAAACAAACAAAAACAAAAAACAAAAAACAAA"
"chr5","111480855","111481634","JH378118","18053084","18053501","411","93427771","GGCCGGGCTCAGTGGCTCACGCCTGTAATCCCAGCACTTTGGGAGGCCGAGCTGGGAATCACCTGAGGTCAGGAGTTCGAGACCCGCTGAGTCTGTCCGGCAGACTCTGGCTGAGCAACAGATGAAAGAAGTATGCAGACACAGGTATTTTACCTGACAGCATGGCTAGGAAACTGCACCACTTAGCACCAACAACAAGAGTGCAGCCCCAATAAGCCGGAGACACTCATATTTATTTTGGTACTGATTTAATGGCAAAGGCTCAGAGCAAACACAATTTGTGGGTAATTAACACTGTCAACACCCCCCCCCCCCCCCCCCCGGTGGAGAGCAGTCCTGCACGCAAATGATTGAAGGAAGGTTTCTGGAGACTTAAGTAAACAAATTTATCTACATAAGTTCCTTTACATTCCCTTGTTATGTACTGTTTGCTCTGAAGATAATTTAGCTGAAGGCAGCTAAATTAGCTGGTGGCAGCTAAATTAGCTGGTCCTTCCAAGAAGGTTTGCATCTTTCCCTATAATTTTTCCCACCATCTTGACCAATCTCCTACAGAGACCAGCCTGGCCAACCTGGTGAAATCCCATCTCTACTAAAAATACAAAAAATTAGCCAGGACAGGGGGAAGATACCTGTAATCCCAGCTACTCGGGAGGCTGAGGCAGGAGAACTGTTTGATCCCGGGAAGTGGAGTGGGCTGAGATCGCACCATTGTACTCCAGCCTGGCAACAAGAGTGAAACTCCATCTCAAAAAAAAGAAGAAAAGAAAAGAAAAGAAA","GGCTGGGCGCAGTGGCTCACACCTGTAATCCCAGCACTTAGGGAAGCTGAGGCGAGTAGATCACCTGAGGTCAGGAGTTAGAGACCAGCCTGGCCATCATGGTGAAACCCCGTCTCTACTAAAGATACCAAAAATTAGCTGAGTGTGGTGCTGGGTGCCTGTAATCCCAGAAACTCAGGGTGCCTGTAATCCCAGCAACTCAGGGTGCCTTTAATCCCAGCAACTGAGGGTACCAGTAATCCCAGCAACTCAGGGTGTCTTTAATCCTAGCAACTGAGGGCACCTGTAATCCCAGCAACTCAGGAAGCTGAGACAGGAGAAGTACTTGAACCCAGAAGGCAGAGGTTGCAGTGAGCCGATATTGCACCATTGCACTCCAGTCTGGGCAACAAGAGTGAAACTCTGTCTCAAAAAAAAA"
"chr5","113874299","113874719","JH378166","6401112","6401453","133","107473187","CCAGGTGCAGTGGCTCATGCCTGTAATCCCAACACATTGGGAGGCCAAGGTGGGTGGATCACCTGAGTTCAGAGGAGTTTGACACTAGCTTGGCGAACATGGTGAAACCCCATCTCTACTAAAAACAGAAAAAATTAGCCAGGCGTAGTGGTGCAGGCCTATAATCCCAGCTACTCAGGAGGTGGAGGCAGGAGAATCACTTGAACCTGGAAGGCAGAGGTTGCAGTGAGCCGAGATCATGCCATCACACTCCAGCCTGGGCGACAAGAGCAAAACTCTGTCACAAAAGGAAAGGGAAGGGAAGGGGAAGGGGAAGGGGAAGGAGAAAGGGAAGCCGAAGGGGAAGGGGAAGGGAAAGGGGAAGGGGAAGGGGAAGGGGAAGGGGAAGGGGAAGGGGAAGGGGAGAGAAAAGAAAAGAAAA","GGCCAGGTGCAGTGGCTCACCCCTGTAATCCCAGCACTTTGGGAGGTCGAGGTGGGTGGATCACCTGAGGTCAGGAGTTCAAGACCAGCCTGACCAAAATGGTGAAACCCCATCTCTACTAAAAATACAAAACATTAGCCAGACATCGTGGCGGGCACCTGTAATCCCAGCTACTTGGGAGGCTGAGGCAGGAGAATTGCTTGAGCCTAGGAGGCGGAGGTTACAGTGAGCCATGATCGTGCCATTGGACTCCAGCCTGGGCTACAAGAGCGAGACTCCATCTCAAAAAAAAAAAAAAAAAAAAAAAAGAAAGAAAGAAAGAAAGAAAGAAAAGAAAGAAAG"
"chr5","125769686","125770246","JH378118","18053084","18053501","237","107716602","GGCCAGGCGCAGTGGCTCATATCTGTAATCCCAGCACTTTGGGAGGCTGAGGCAGGTGGATCTCCTGAGGTCAGGAGTTCAAGACTAGCCTGGTCAACATGGTGAAACCCCATCTCTACCAAAAAAGTAGGCCGGACACGGTGGCTCAATCCTGTAATCCCAACACTTTGGGAGGCCAAGGCAGGGGGATCACCTGAGGTCGGGAGTTTGGGACGAACCTGACCAATAGAGAAACTCCATCTCTACTAAAAATACAAAATTAGCTGGGTGTGGTGGTGCCTGCCTGTAATCCTAGCTTCTCGTGGGGCTGAGGCAAGAGAATTGCTTGAACCTGGGAAGCGGAGGTTGCGGTGAGCCGAGATCACACCACTGCACTCCAGCCTGGGCAACAAGAGTTAAACTCTGTCTCAAAAAAAAAAAAAAAAATTATCTGGGCTTGTCCCAGCTACTCAGGAGGCTGAGGCAGAAGAATCGCTTGCATCCGGGAGGTGGAGGTTATAGTGAGCCAAGATGGTACCGTTGCACTTCCAGCCTGGGCAACAAGAGCAAAACTCTGTCTCA","GGCTGGGCGCAGTGGCTCACACCTGTAATCCCAGCACTTAGGGAAGCTGAGGCGAGTAGATCACCTGAGGTCAGGAGTTAGAGACCAGCCTGGCCATCATGGTGAAACCCCGTCTCTACTAAAGATACCAAAAATTAGCTGAGTGTGGTGCTGGGTGCCTGTAATCCCAGAAACTCAGGGTGCCTGTAATCCCAGCAACTCAGGGTGCCTTTAATCCCAGCAACTGAGGGTACCAGTAATCCCAGCAACTCAGGGTGTCTTTAATCCTAGCAACTGAGGGCACCTGTAATCCCAGCAACTCAGGAAGCTGAGACAGGAGAAGTACTTGAACCCAGAAGGCAGAGGTTGCAGTGAGCCGATATTGCACCATTGCACTCCAGTCTGGGCAACAAGAGTGAAACTCTGTCTCAAAAAAAAA"
"chr5","129450857","129451391","JH378118","18053084","18053501","198","111397773","GACCAGGCACGGTGGCTCATGCCTGTAATCCCAGCACTTTGGAAGGCTGAGGCAGACGGATCACCTGAGGTCAGGAGTTCGAGACCAGCATGACTGACATGGTGAAACCCCACCTCTACAACAATACAAAAATTAGCTGAGCATGGCCAGGCGCGGTGGCTCACACCTGTAATCCCAGCACTTTGGGAGGCCGAGGTGGGTGGATCACGAGTTCAGGAGATTGAGACCATCCTGGCTAACATGGTAAAACCCCGTCTGTACTAAAAATACAAAAAATTAGCCAGGTGTGATGGCGCATGCCTGTAGTCCCAGCTGCTCGGGAGGCTGAGGCAGGAGAATGGCGTGAACCTGGGAGGCAGAGCTTGCAGTGAGCCACGCATGATGGCGGGTGTCTGTAATCCCAGCTACTAGGGAGGCTGAGGTGGGAGAATCACCTGAACTCAGGAGGCAGAGGTTGCAGTAAGCCAAGATCGTGTCATTGCACTTCAGCCTGGGTGACAAGAGCAAGACTGTGTCTCAAAAAACACACACAAAA","GGCTGGGCGCAGTGGCTCACACCTGTAATCCCAGCACTTAGGGAAGCTGAGGCGAGTAGATCACCTGAGGTCAGGAGTTAGAGACCAGCCTGGCCATCATGGTGAAACCCCGTCTCTACTAAAGATACCAAAAATTAGCTGAGTGTGGTGCTGGGTGCCTGTAATCCCAGAAACTCAGGGTGCCTGTAATCCCAGCAACTCAGGGTGCCTTTAATCCCAGCAACTGAGGGTACCAGTAATCCCAGCAACTCAGGGTGTCTTTAATCCTAGCAACTGAGGGCACCTGTAATCCCAGCAACTCAGGAAGCTGAGACAGGAGAAGTACTTGAACCCAGAAGGCAGAGGTTGCAGTGAGCCGATATTGCACCATTGCACTCCAGTCTGGGCAACAAGAGTGAAACTCTGTCTCAAAAAAAAA"
"chr5","131390707","131391326","JH378118","18053084","18053501","260","113337623","GGCCGGGTGCAGTGGCTCACACATGTAATCCTAGCACTTTGGGAGGCCGAGGCAGGCAGATCACCTGAGGTCAGGAGTTTGAGACCAGCTTGGCTAACATAGTGAAACCCTGTTTCTACTAAAAATATAAAAAAATTGGCCAGGCATGGTGGCTCACGCCTGTAATCCCAGCACTTTGGGAGGCAGAGGCAGACGTATCACGAGGTCAGGAGTTCGAGACCAGCCTGACCAACATGGTGAAAACCCGTCTCTACTAAAAATACAAAAAACTAGCCGGGTGTGCTGGCGCATGCCTGTAGTCCCAGCTGCTCAGGAGGCTGAGGCAGAAGAATCGCTTGAACTCAGGAGGCGGAAGTTGCAGTGAGCCGAGATTGTGCCACTGCACTCCAGCCTGGGTAACAGAGTGAGACTCCGTCTCAAAAAAAAAAAAAAAAAAAAATTAGCTGGGTGTGGTGGCGCATGCCTGTAATCCCAGCTACTTGGGAGGCTGAGGCAGGGGAATTGCTTGAACCCAGGAGGCAGAGATTGCAGTGAGCCCGAGATTGCGCCATTGCACTCTAGCCTGGGTAACAAGAGTGAAACTCCATCTCAAAAAAATAAAAATAAAAATAAAAAATAAA","GGCTGGGCGCAGTGGCTCACACCTGTAATCCCAGCACTTAGGGAAGCTGAGGCGAGTAGATCACCTGAGGTCAGGAGTTAGAGACCAGCCTGGCCATCATGGTGAAACCCCGTCTCTACTAAAGATACCAAAAATTAGCTGAGTGTGGTGCTGGGTGCCTGTAATCCCAGAAACTCAGGGTGCCTGTAATCCCAGCAACTCAGGGTGCCTTTAATCCCAGCAACTGAGGGTACCAGTAATCCCAGCAACTCAGGGTGTCTTTAATCCTAGCAACTGAGGGCACCTGTAATCCCAGCAACTCAGGAAGCTGAGACAGGAGAAGTACTTGAACCCAGAAGGCAGAGGTTGCAGTGAGCCGATATTGCACCATTGCACTCCAGTCTGGGCAACAAGAGTGAAACTCTGTCTCAAAAAAAAA"
"chr5","135552720","135553284","JH378118","18053084","18053501","222","117499636","GGCTGGGCGCTGTGGCTCATGCCTATAATCCCAACACTTTGGGAGCCTGAGGAGGGTGGATCACCTGAGGTCAAGAGTTTGAGGGGAGCCTGGCCAATGTGGTGAAACCCTGTCTCTACTAAAAATACAAACAGACTAGGCGCAATGGCTCACACCTGTAATCCCAGCACTTTGGGAGGCCAAGGTGGGCGGATCACGAGGTCAGGAGATCGAGACCATCCTGGCCAACATGGTGAAACCCTGTCTTTACTAAAAATACCCAGCTACTCAGGAGGCTGAGGCAGGAGAATTGCTTGAACCCAGGAAGTGGAGGTTGCAGTGAGCCAAGATTGGGCCACTGTACTCCAGCCTGGTGACAGAGACTCTGTCTCAAAAACAAAAACAAAAACAAACAAAAAACAGCCAGGAGTGGTGGCAGGCACTTGTAATTCCAGCTACCAGGAGGCTGAGGCAGGAGAATCACTTGAACCTGGGAGGTGGAGGTTGCAGTGAGCTAAGATCACACCATTGCACTCCAGCCTGGGTGACAACAGCGAGACTGTATCAAAAACAAACAAACAAAAAA","GGCTGGGCGCAGTGGCTCACACCTGTAATCCCAGCACTTAGGGAAGCTGAGGCGAGTAGATCACCTGAGGTCAGGAGTTAGAGACCAGCCTGGCCATCATGGTGAAACCCCGTCTCTACTAAAGATACCAAAAATTAGCTGAGTGTGGTGCTGGGTGCCTGTAATCCCAGAAACTCAGGGTGCCTGTAATCCCAGCAACTCAGGGTGCCTTTAATCCCAGCAACTGAGGGTACCAGTAATCCCAGCAACTCAGGGTGTCTTTAATCCTAGCAACTGAGGGCACCTGTAATCCCAGCAACTCAGGAAGCTGAGACAGGAGAAGTACTTGAACCCAGAAGGCAGAGGTTGCAGTGAGCCGATATTGCACCATTGCACTCCAGTCTGGGCAACAAGAGTGAAACTCTGTCTCAAAAAAAAA"
"chr5","135892178","135892754","JH378118","18053084","18053501","252","117839094","CAGGAGCAGTGGCTCAGGTCTGTAATCCCAGCACTTTGGGAGGCTGAGGCAGGTGGATCACCTGAGGTCAGGAGCTCGAGACCAGCCTAGCAACATGCTGAAACTGCTGGGTTTGGTGGCTCACACCTGTAATCCCAGCACTTTGGGAGGCCGAGGCGGGTGGATCATGAGGTCAGGAGTTCAAGACCAGCCTGGTCAAGATGGTGAAACCCCGTCTGTACTAAAAATACAAAAATTAGCCAGGCATGGTGGCAGGTGTCTGTAATCCCAGCTACTTGGGAGGCTGAGGCAGAGAATTGCTTGGACCCGGGAGGAGGAGCTTGCAGTGAGCCGAGATTGTACCACTGCACTCCAGCCTGGGCGACAGAGTGAGACTCCATCTCAAAAAATAAATAAACAAATAAATAAAAAAATAAAAATAAAAAATTAGCCAGACATGGTGGCACGTACCTGTAATCCCAGTTACTCAGAAGGCAAGGCTGGAGAATCGCTTGAACCCGGGAGGAGGAGGTTGCAGTGAGCAGAGATCTCACCATTGCACTCCAGCCTGGGCGACAAGAGGGAAACTCCGTCTCAA","GGCTGGGCGCAGTGGCTCACACCTGTAATCCCAGCACTTAGGGAAGCTGAGGCGAGTAGATCACCTGAGGTCAGGAGTTAGAGACCAGCCTGGCCATCATGGTGAAACCCCGTCTCTACTAAAGATACCAAAAATTAGCTGAGTGTGGTGCTGGGTGCCTGTAATCCCAGAAACTCAGGGTGCCTGTAATCCCAGCAACTCAGGGTGCCTTTAATCCCAGCAACTGAGGGTACCAGTAATCCCAGCAACTCAGGGTGTCTTTAATCCTAGCAACTGAGGGCACCTGTAATCCCAGCAACTCAGGAAGCTGAGACAGGAGAAGTACTTGAACCCAGAAGGCAGAGGTTGCAGTGAGCCGATATTGCACCATTGCACTCCAGTCTGGGCAACAAGAGTGAAACTCTGTCTCAAAAAAAAA"
"chr5","136013175","136013485","JH378140","6001243","6001554","61","130011932","GGCCGGGTGCGGTGGCCTATGCCTGTATCCCAGCACTTTGGGAGGCCGAGGCAGGCGGATCACCTGAGGTCAAGAGTTCGAGACCAGCCTTGCCAGCATGGTAAAACTCCGTCTCTACTGAAAATACAAAAATTAGCCGGGGGTGGTGGTGTGCACCTGTAATCCCAGCTACTCGGGAAGCTGAGGCAGGAGAATCGTTTGAATCCAGGAGGTAGAGGTTGCAGTCTGAGTGACAAAAGCGAAACTCCGTCTCACACACACACACACACACACACACACACACAAAAAAAAAGAAAAGAAAAAAGAAAAAA","GGCCGGGTGTGGTGGCTCATGCCTGTAATCCCAGCACTTTGGGAGGTTGAGGCAGGTGGATCATCTGAGGTCAGGAGTTTGAGACCAGCCTGACCAACATAGTGAAACCCCGTCTCTACTGAAAATACAAAAAATTAGCTGGACGTGGTGGTGGACACCTGTAATCCCAGCTACTCGGGAGGCTGAGGCAGGAGAATGGTTTGAACCTGGGAGGTGGAGGTTGCAATGAGCTGAGATTGCACCATTGCACTCCAGCCTGGGCATCAAGAACAAGACTCTGTCTCAAAAAAAAAAAAAAAGAAAAAGAAAAAA"
"chr5","136799451","136800035","JH378118","18053084","18053501","236","118746367","CTGGGCGCGGTGTCTCACAACTGTAATCTCAGCACTTTGGGAGGCTGAGGCTGGCGCATCACCTAAGGTCAGGAGTTCGAGACCAGCCTGGCCAACATGGTGAAACCCCATCTCTACTAAAAATACAAAAATTAGGCCGGGCACGGTCACTCACGCCTGTAATCCCAGCACTTTGGGAGGCCAAGGCAGGCAGATCACGAGGTCAGGAATTCGAGACCAGCCTGGCCAACACAGTGAAACCCCTTCTGTACTAAATATACAAAAATTACCCGGGCATGGTGGCAGACACCTGTAGTCCCAGCTACTCGGGAGGCTGAGGCACGAGAATCGCTTGAATCCGGGAGGCGGAGGTTGCCGTGAGCCGAGATCACGCCAGTTCACTCCAGCTTAGGCAACAGCAAGAATGCGTCTCAAAAAAAAAAAATTAGCCGAGAGTGGTGGCGGGTTCCTGTAAACCCAGCTGCTGGGGAGGCTGAGGCAGGAGAATCGCTGGAACCCAGGAGGCAGAGGTTGCAGTGAGCCGAGAGCGCGCCATTGCACTCCAGCCTGGGCGACGAGCAAAACTCCATCTCCAAAAAAAAAAAA","GGCTGGGCGCAGTGGCTCACACCTGTAATCCCAGCACTTAGGGAAGCTGAGGCGAGTAGATCACCTGAGGTCAGGAGTTAGAGACCAGCCTGGCCATCATGGTGAAACCCCGTCTCTACTAAAGATACCAAAAATTAGCTGAGTGTGGTGCTGGGTGCCTGTAATCCCAGAAACTCAGGGTGCCTGTAATCCCAGCAACTCAGGGTGCCTTTAATCCCAGCAACTGAGGGTACCAGTAATCCCAGCAACTCAGGGTGTCTTTAATCCTAGCAACTGAGGGCACCTGTAATCCCAGCAACTCAGGAAGCTGAGACAGGAGAAGTACTTGAACCCAGAAGGCAGAGGTTGCAGTGAGCCGATATTGCACCATTGCACTCCAGTCTGGGCAACAAGAGTGAAACTCTGTCTCAAAAAAAAA"
"chr5","138563486","138564083","JH378118","18053084","18053501","239","120510402","GCTGGGTGCAGTGGCTCATGCCTGTAATCCCAGCACTTTGGGAGGCCCAGGCGGATGGATCACCTGAGGTCAGGAGTTCGAGACCAGCCTGGCCAACATGGTGAAACCCCATCTCTACTAAAAATACAAAAAAAAGGCCAGGCACAGTGGCTCACGCCTGTAATCCCAGCACTTTGGGAGGCGGAGGTGGGTGGATCACGAGGTCAGGAGATTGAGACCATTCTGGCTAACACGGTGAAACCCCGTCTCTACTAAAAATACAAAAAATTAGCCAAGCGCAATGGCAGGCACCTGTAGTCCCAGCTGCTCGGGAAGCTGAGGCAGGAGAATGGCGTGAACCCGGGAGGCAGAGTTTGCAGTGAGCCGAGATCACGCCACTGCACTCCAGCCTGGGCAATAGAGCGGGACTCATTCTCAAAAACAAAAAAAAATTAGCCAGGCTTGGCAGCGGGCACCTGTAATCCCAGCTACTCGGGAGACTGAGGGAGGAGAATTACTTGAACCCGGGAAGTGAAGATTGCAGTGAGCCAAGATTGCACCATTGCATTCCAGCCTGGGCAACACTGGAGCAAAATTCCATCTCAAAAAAAAAAAAAAA","GGCTGGGCGCAGTGGCTCACACCTGTAATCCCAGCACTTAGGGAAGCTGAGGCGAGTAGATCACCTGAGGTCAGGAGTTAGAGACCAGCCTGGCCATCATGGTGAAACCCCGTCTCTACTAAAGATACCAAAAATTAGCTGAGTGTGGTGCTGGGTGCCTGTAATCCCAGAAACTCAGGGTGCCTGTAATCCCAGCAACTCAGGGTGCCTTTAATCCCAGCAACTGAGGGTACCAGTAATCCCAGCAACTCAGGGTGTCTTTAATCCTAGCAACTGAGGGCACCTGTAATCCCAGCAACTCAGGAAGCTGAGACAGGAGAAGTACTTGAACCCAGAAGGCAGAGGTTGCAGTGAGCCGATATTGCACCATTGCACTCCAGTCTGGGCAACAAGAGTGAAACTCTGTCTCAAAAAAAAA"
"chr5","138721372","138721943","JH378118","18053084","18053501","229","120668288","GGCTGGGCTCAGTGGCTCACGCCTGTAATCCCAGTGCTTAGGGAGGCCGAGGCCAGCGGATCACCTGAGGCCAGGAGTTCAAGACCGGCCTGGCCAACATGGTGAAACCCTATCTCTACTAATAATACAAAAATCAGGCCGGGCCTGGTGGCTCACGCCTGTAATCCCGCACTTTGGGAGGCGGAGGCGGGCTGATCACGAGGTCAGGAGTTCAAGACCAGCCTGGCCAACATGGTGAAACCCCGTCTCTACTAAAAATACAAAAATTCGCCGGGCATGGTGGCTGAGGCAGGAGAATCACTTGACAGTGGAGGTTGCAGTGAGCCGAGATCACGCCACTGCACTCCAGCCTGGGTGAAAGAGCGAAACTCCATCTCAAAAAAAAAAAAAAAAAAAATCAACCAGGTGTGGTGGCAGGTGCCTGTAATCCCAGCTACTTGGGAGGTTGAAGCAGGAGAATCGCTTTAACTCAGGAAGCAGAGGTTGCAGTGAGCCAAGATCATGCTGTTGCATTCCAGCCTAGGCAACAAGAGTAAAACTCACTCCATCTCAAAAAAAAAAAAAAAAAAAAA","GGCTGGGCGCAGTGGCTCACACCTGTAATCCCAGCACTTAGGGAAGCTGAGGCGAGTAGATCACCTGAGGTCAGGAGTTAGAGACCAGCCTGGCCATCATGGTGAAACCCCGTCTCTACTAAAGATACCAAAAATTAGCTGAGTGTGGTGCTGGGTGCCTGTAATCCCAGAAACTCAGGGTGCCTGTAATCCCAGCAACTCAGGGTGCCTTTAATCCCAGCAACTGAGGGTACCAGTAATCCCAGCAACTCAGGGTGTCTTTAATCCTAGCAACTGAGGGCACCTGTAATCCCAGCAACTCAGGAAGCTGAGACAGGAGAAGTACTTGAACCCAGAAGGCAGAGGTTGCAGTGAGCCGATATTGCACCATTGCACTCCAGTCTGGGCAACAAGAGTGAAACTCTGTCTCAAAAAAAAA"
"chr5","139131911","139132284","JH378119","28476684","28477024","84","110655227","GCCAGGCGTGGTGGCTCACGCTTGTAATCCCAGCACTTTGGGAGGCTGAGGCGGGCGGATCGCGAGGTCAGGAGTTCAAGACCAGCCTGGCCAACATAGTGAAACCATGTCTCTACTAAAAACACAAAAAACTAGCTGGGCTTGGTGGCAGGCACCTGTAATTCCAGCTACTTGGGAGGCTGAGGCAGGAGAGTCCCTTGAACCCAGGAGGCAGAGTTTGCAGTGAGCTGAGATAGTGCCATTGCACTCCAGCCCAGGCAGCAAGAGTGAAACTCTGTCAAAAAAAAAAAAAAAGAAAGACAGAAAGAAAGAAAGACAGAAAGAAAAAGAAAGAAAGAAAGATAAAGAAAGAAAGAAAGAAAAAGAGGAAAGAA","GGCTGGGGGTGGTGGCTGACACCTGTAATCCCAACACTTTGGGAGGCCAAAGTGAGTGGATCATCTGAGGTTGGGAATTCAAGACCAGCCTGGCCAACATGGTGAAACCTCATCTCTACTAAAAATACAAAAATTTGCTGGGCATGGTGGCATGCGCCTGTAATTCCAGCTACTTGGACGCTGAGACAGGAGAATCACTTGAACCTGGGAGGCAGAGGTTGCACTGAGCTGAGATCATGCCATTGCACTCCAGCCTGGGTGACAAGAGTGGAACTCTGTCTCAAAAAAAAAAAAAAAAAAAAAAAAAAAAAAAAAAAAAAAAAAAAAAAAAAAAAAAAAAA"
"chr5","157768817","157769401","JH378115","26183910","26184297","245","131584907","GCCGCGTGCAGTGGCTCATGCCTGTAATTCCAGCACTTTGGGAGGCCAAGGCGGGCGGATCACTTGAGGTTAGGAGTTTGAGACCAGCCCGGCCAACACGGTGAAATCCCATCTCCACTAAAAATACAAAAATTGGCCAGGCGCAGTGGCTCACATCTGTAATCCCAGCACTTTGGGAGGCCAAGGTGGGTGGATTGTTTGAGATCAGGAGTTTGAGACCAGCCTGACCAACACAGTGAAACCCCGTCTCTAATAAAAATATAAAATTAGCCAGGTATGGTGGCACACACACCTGTAATCCAACTACCCGGGAGGCTGAGGCAATAGAATCGCCTGAACCCAGGAGGCAGAGGTTGCACTGAGCTGAGAACGCACCACTGCACTTCTGCCTGGGTAACGGGGCAAGACTGTCTAAAAAAATTAGCCAGGAATGGTGGTGGGTACCTATAATCCCAGCTACTCTGCAGGAGAATCTCTTCAACCTGGGAGGCAGAGGTTGCAGTGAGCCAAGATCATGCCATTCATTGCACTCCAGCCTGGGCAACAAGAGCAAAACTCCATCTCAAAAACAAACAAACAAAAAAA","GGCCAGGTGCAGTGGCTCATATGTATAACCCCAACACTTTGGGAGGCCAACGCAGGTGGATCACCTGAGTTAGGAGTTTGAGACCAGCCTGACCAACATGGTGAAACCCTGTCTCTACTAAAAATACAGAAATGGCCGGGCATAGTGACACATACCTGTAATCCCAGATACTTGGGATGCTGAGTTTGCTTAAACCCAGAGGAGAACTGCTTAAACCCGGGAGGTAGAGGTCACAGTGAGCCAAGATTGGGATGCTGAGATTTGCTTAAACCCAGAGGAGAACTGCTTAAACCCAGGAGGCAGAGGTTGCAGTGAGTTGAGATTGCACCATTGCACTCCAGCCTGGACAACAAGAGTGAAACTCTGTCTCAAAAAAAAAAAAAAAAAA"
"chr5","157826285","157827231","JH378118","18053084","18053501","557","139773201","GCTGGGCGTAGTGGCTCACACCTGTAATCCTAGCACTTTGGGAGGCCAAGGCAGGCAGATCACTTGAGGTCAGCAGTTCAAAACCAGCCTGGCCAACATGCTGAAACCCTGTCTCTACTAAAAATATTTTTTAAATTAGCCAGTTGTGGCCGGGTGCGGTGGCTCACGCCTGTAATCCCAACACTTTGGGAGGCCGAGGTGGGTGAATCACGAGGTGGGTGAATCACAAAGTGAGGAGATCGAGATCAGCCTGGCTAACATGGTGAAACCCTGTCTCTACTAAAAATACAAAAAAATTAGCTGGGCGTGGTGGCGGGTGCCTGTAGTCCCAGCTACTCAGGAGGCTGAGGCAGGAGAATGGCGTGAACCCGGGAAGCGGAGCTTGCACTGAGCCGAGATCATGCCACTGCACTCCAGCCTGGGCGACAGAGTGAGACTCCGTCTCCAAAAAATAAAAACAAAAATTAGCCAGTTGTGGGGCCAGACACAGTGGCTCATGCCTGAAATCCCAGCACTTTGGGAGGCCGAGGTGGGCAGGTCATGAGGTCAGGAGATGGAGACCAACCTGGCTAACGTGGTAAAACCCCGTCTCTAGTAAAAATACAAAAAAATTAGCTGGGCATGGCGGCAGATGCCTGTAGTCCCAGCTACTTGGGAGGCTGAGGCAGGAGAATCGCTTGAACCCAGGAGCCAGAGGTTGCGGTGAGCCAAAATTGTGCCACTGCACTCCAGCCTGGGCAACAGAGCGAGACTCCATCTCAAAAAAGAAAAAGAAATTAGCCAGTTGTGGCGGCAGGCGCCTGTAATTCCAGCTACTCGAGAAGCTGAGGCAGGAGAATAGCTTGAACCCAGGAGGCGGAGGTTACAGTGAGCTGAGATCACACCATTGCACTACAGCCTGGGCGACAAGAGGGAGACTCCATCTGAAAAAAAAAAAAAAAAAAGAA","GGCTGGGCGCAGTGGCTCACACCTGTAATCCCAGCACTTAGGGAAGCTGAGGCGAGTAGATCACCTGAGGTCAGGAGTTAGAGACCAGCCTGGCCATCATGGTGAAACCCCGTCTCTACTAAAGATACCAAAAATTAGCTGAGTGTGGTGCTGGGTGCCTGTAATCCCAGAAACTCAGGGTGCCTGTAATCCCAGCAACTCAGGGTGCCTTTAATCCCAGCAACTGAGGGTACCAGTAATCCCAGCAACTCAGGGTGTCTTTAATCCTAGCAACTGAGGGCACCTGTAATCCCAGCAACTCAGGAAGCTGAGACAGGAGAAGTACTTGAACCCAGAAGGCAGAGGTTGCAGTGAGCCGATATTGCACCATTGCACTCCAGTCTGGGCAACAAGAGTGAAACTCTGTCTCAAAAAAAAA"
"chr5","157891641","157892194","JH378118","18053084","18053501","196","139838557","GGCTGGGCGCGGTGGCTCACACCTATAATCCCAACACCTTGGGAGGCAGAGGCAGGTGGATCACCTGAGGTCAGGAGTTCGAGATCAGCCCAGCCAACATGATGAAACCTTGTCTCTCCTAAAAATACAAAAAAATTAGCCAGGCCAGTCAGATAATCTGAGGTCAGAAGTTTGAGACCAGCCTGACCAACATGGAGAAACCCCATCTCTATAAAAACACAAAATTAGCTGGGCATGGTGGCGCATGCCTGTAATCCCAGCTACTCAGGAAGCTGAGGCGGGAGAATCGCTTGAACCCGGGAGGCAGAGGTTGTGGTGAGCCGAGATCATGCCATTGCATTCCAGCCTGGGCAACAAGAATGAAACCCCATCTCAGAAAAAAAAACAATTAGCCAGGCGTGATGGGCGCCTGTAATCCCAGCTACTCAGGAGGCTGAGGCAGGAGAATTGCTTGAACCCGGGAGGGGGAGGTTGCAGTGAGCCAAGATGGCACCATTGCACTCCAGGCAGGCTGGGCAACAGGAGCAAAACTCTATCTCAAAAAAAAAAAAAAA","GGCTGGGCGCAGTGGCTCACACCTGTAATCCCAGCACTTAGGGAAGCTGAGGCGAGTAGATCACCTGAGGTCAGGAGTTAGAGACCAGCCTGGCCATCATGGTGAAACCCCGTCTCTACTAAAGATACCAAAAATTAGCTGAGTGTGGTGCTGGGTGCCTGTAATCCCAGAAACTCAGGGTGCCTGTAATCCCAGCAACTCAGGGTGCCTTTAATCCCAGCAACTGAGGGTACCAGTAATCCCAGCAACTCAGGGTGTCTTTAATCCTAGCAACTGAGGGCACCTGTAATCCCAGCAACTCAGGAAGCTGAGACAGGAGAAGTACTTGAACCCAGAAGGCAGAGGTTGCAGTGAGCCGATATTGCACCATTGCACTCCAGTCTGGGCAACAAGAGTGAAACTCTGTCTCAAAAAAAAA"
"chr5","172465373","172466027","JH378118","18053084","18053501","291","154412289","GGCAGGGTGCAGTGGCTCATGCCTGTAATCCCAGCACTTTGGCACTTTGGGAGGCCGAGGTGGATGGATCACCTGAGGCCAGGAGTTTGAGACCAGCCTGGCTAACATGGTGAAACCCTGTCTCTACTAAAAATACAAAAATTAGCCAGGTGCAGTGTCTCATGCCTGTAATCCCAGCACTTTGGGAGGCCGAAGCAGGCGCATCATGAGGTCAGAAGTTCGAGATCAGCCTGGCCAACATGGTGAAACCCCTACTAAACCCCTACTACTTTGTCTCTACTAAAGATACAAAAAAAAAAATTAGTTGGGCATGGTGGCACACTGTAATCCCAGCTACTTGGGAGGCTGAGGCAGGAGAATCGCTTGAACCTGGCGGATGTTTCAGTGAGCCGAAGCTTTCAGTGAGCCGAGGTTGTGCCATTGCACTCCAGCCTGGGCGACGGAGCGAGACTCTGTCTCAAAAAAACAAAAACAAAAACAAAAACAAAAATTAGCTGGGCATGGTTGCCAGTACCTGTAATTCCAGCTACTCGGGAGCCTAAGGCAGGAGAATCGCTTGAACCCTGGAGGCAGAGGTTGCAGTGAGCCGATATCGCGCCACTGCACTCCAGCCTGGGTGACTAAAGTGAAACTGTCTCAAAAGGAAAGAAAGAAA","GGCTGGGCGCAGTGGCTCACACCTGTAATCCCAGCACTTAGGGAAGCTGAGGCGAGTAGATCACCTGAGGTCAGGAGTTAGAGACCAGCCTGGCCATCATGGTGAAACCCCGTCTCTACTAAAGATACCAAAAATTAGCTGAGTGTGGTGCTGGGTGCCTGTAATCCCAGAAACTCAGGGTGCCTGTAATCCCAGCAACTCAGGGTGCCTTTAATCCCAGCAACTGAGGGTACCAGTAATCCCAGCAACTCAGGGTGTCTTTAATCCTAGCAACTGAGGGCACCTGTAATCCCAGCAACTCAGGAAGCTGAGACAGGAGAAGTACTTGAACCCAGAAGGCAGAGGTTGCAGTGAGCCGATATTGCACCATTGCACTCCAGTCTGGGCAACAAGAGTGAAACTCTGTCTCAAAAAAAAA"
"chr5","172905582","172906189","JH378118","18053084","18053501","263","154852498","GGCCAGGCAAGGTGGCTGATGCCTGTAATCCCAGTCCTTTGGGAGGCTGAGGTTGGCGGGTCACTTGAGGTCAGGAGTTCGAGACCAGCCTGGTCAACATGGCAAAACCGTGTCTCTATTTAAAAATTAGCTGGGAGTGAGGCCGGGCGTGGTGGCTCATGCCTGTAATCCCAGCACTTCAGGAAGCTGAAGCAGGCGGATCACCTGAGGTCAGGAGTTCGAGACCAGCCTGACCAACATGGTAAAACTCCGTCTCTACTAAAAATACAAAAATTAGCTGGGCATGGTGGTGCATGCCTGTAATTCCAGCTACTTGGGAGGCTGAGGCAGGAGACTCACTTGAACCTGGGAGGCAGAGGTTGCAGTGAGCCGAGATGGTGCCTCTGCACTCCAGCCTAGGCAACAGAGTGAGACTCTGTCAAAAAAAAAAAAAAAAAAAAAAAGAAAGAAAAAGCCGGGAGTGGTGGTAGGTGCCTGTAATTCCAGCTACTGGGAGGCAGAGGCAGGAGAATCACTTGAACCCAGGAAGCGGAGGTTGCAGTGAGCCAAGATCGCGTCATTGCACTCTAGCCTGGGCTACAAGAGTGAAACTCCATCTCAAAAAAAAA","GGCTGGGCGCAGTGGCTCACACCTGTAATCCCAGCACTTAGGGAAGCTGAGGCGAGTAGATCACCTGAGGTCAGGAGTTAGAGACCAGCCTGGCCATCATGGTGAAACCCCGTCTCTACTAAAGATACCAAAAATTAGCTGAGTGTGGTGCTGGGTGCCTGTAATCCCAGAAACTCAGGGTGCCTGTAATCCCAGCAACTCAGGGTGCCTTTAATCCCAGCAACTGAGGGTACCAGTAATCCCAGCAACTCAGGGTGTCTTTAATCCTAGCAACTGAGGGCACCTGTAATCCCAGCAACTCAGGAAGCTGAGACAGGAGAAGTACTTGAACCCAGAAGGCAGAGGTTGCAGTGAGCCGATATTGCACCATTGCACTCCAGTCTGGGCAACAAGAGTGAAACTCTGTCTCAAAAAAAAA"
"chr5","173061632","173061959","JH378107","917944","918262","44","172143688","GGCCAGGCGCAGTGGCTCACGCCTGTAATCCCAGCACTTTGGGAGACCGAGGCGGGTGGATCACCTGAGGTTAGGAGTTCGAGACCAGCCTGGCCAACATGGTAAAACCCCGTCTCTACTAAAAGTACAAAAATTAGCTGGGCATGTTGGCAGGCGCCTGTAACCTCAGCTACATGGGAGGCTGAGGCCGGAGAATTGCTGGAACCCAGGAGGCGGAGGTTGCAGTGAGCCGAGATCGCGCCATTGCACTCTAGCCTGGGCGACAACAGTGAGACTCCGTCTCAAAACCAACCAACCAACCAACCAACCAAACAAACACACAAAAAAA","GGCCAGGCGCGGTGGCTCACGCCTGTAATCCCAGCACTTTGGGAGGCCGAGGCGGGTGGATCATGAGGTCAAGAGATCGAGACCATCCTGGTCAACATGGTGAAACCCCGTCTCTACTAAAAATACAAAACATTAGCTGGGCATGGTGGCGCGTGCCTGTAATCCCAGCTACTCAGGAGGCTGAGGCAGGAGAATTTCCCGAACCCAGGAGGCGGAGGTTGCGGTGAGCCGAGATCGCGCCATTGCACTCCAGCCTGGGTAACAAGAGCGAAACTCCGTCTCAAAAACAAACAAACAAACAAACAAACAAACAAACAAA"
"chr5","173701802","173702122","JH378118","29358893","29359212","58","144342909","GGCCAGGCAAAGGTGGCTCACGCCTGTAATCACTTTGGGAGGCCAAGGCGGGTGGATCACGTGAGGTCAGGAGTTCGAGACCAGCCTGCCCAACATGGCAAAACCCCGTCTCCACTAAAAATACAAAAATTAGCCAGGAGTGGTGGCGGGAGCCTGTAATCCCAGCTACATGGGAGGCTGAGGCAAGAGAATAGCTTGAACCCAGGTGGCAGAGGTTGCAGTGAGCCAAGATCTCACCATTACCCTACAGCCTGGGTGACAAAGTGAAACTCCATCTCAAAAAATACATACATACATACATACATACATTTTTAAAAAAAA","GGCTGGGCGTGGTGGCTCACTCCTGTAATCCCAGCACTTTGGGAGGCCGAGGTGGGTGGATCAGCTGAGGTCAGGAGTCGGAGACCAGCGTGGCCAACATGGCAAAACCCCATCTCTACTAAAAATACAAAAAATTAGCCAGGTGTGATGGCTGGCTCCTGTAATCCCAGCTACTTGGGAGGCTGAGGCAGGAGAATTGCTTGAACCTGGGAGGTGGAGGTTGCGGTGAGCCGAGATCATCCCATTGCACTTCAGCCTGGGTGAAAAGAGTGAAACTCCATCTCAAAAATAAATAAATAAATAAATAAATAAATAAATAA"
"chr5","177053495","177054113","JH378118","18053084","18053501","260","159000411","GCCAGGCGTGGTGGCTCATGCCTGTAATCCCGACACTTTGGAAGGCCGAGGCGGGTGGATCACCTGAGGTCAGGAGTTTGAAACCAGCCTGGCCAACACAGTAAAACCCTGTCTCTACTAAAAAATACAAAAATTAGCCAGGTGTGGCAGGGTGTGGTGGCTCACGCCTGTAATCCCAGCACTTTGGGAGGCTGAGGCGGGCGGATCACAAGGTCAGGAGATCGAGACCATTCTGGCTAACATGGTGAAACCCTGTCTCTACTAAAAATACAAAAAATTAGCCAGGTGTGGTGGCGGGCACCTGTAGTCCCAGCTACTCGGGAAGCTGAAGCAGGAGAAAGGCATGAACCCGGGAGGTGGAGCTTGCAGTGAGCCAAGATTGTACCACTGCACTCCAGCCTGGGCGACAGAGAGAGACTCTGTCTCAAAAAAAAAAAAAAAAAAAAAAAAAAAAATTAACCAGGCCTGGTGGCAGGCGCCTGTAATCCCAGCTATTCAGGAGGCTGAGGCAGAAGAATTGCTCGAACCCCGGAAGCAGAGGTTGCAGTGAGCTGAGATTGCACCATTGCACTCCAGCCTGGGCAACAGGAGCAAAACTCTGTCTCAAAAAAAACACAAA","GGCTGGGCGCAGTGGCTCACACCTGTAATCCCAGCACTTAGGGAAGCTGAGGCGAGTAGATCACCTGAGGTCAGGAGTTAGAGACCAGCCTGGCCATCATGGTGAAACCCCGTCTCTACTAAAGATACCAAAAATTAGCTGAGTGTGGTGCTGGGTGCCTGTAATCCCAGAAACTCAGGGTGCCTGTAATCCCAGCAACTCAGGGTGCCTTTAATCCCAGCAACTGAGGGTACCAGTAATCCCAGCAACTCAGGGTGTCTTTAATCCTAGCAACTGAGGGCACCTGTAATCCCAGCAACTCAGGAAGCTGAGACAGGAGAAGTACTTGAACCCAGAAGGCAGAGGTTGCAGTGAGCCGATATTGCACCATTGCACTCCAGTCTGGGCAACAAGAGTGAAACTCTGTCTCAAAAAAAAA"
"chr5","177386430","177386973","JH378118","18053084","18053501","217","159333346","GGCCGGGCACGGTGTCTCACGCCTATAATCCCAGCACCCTGGGAGGCCAAGGTGGGTGGATCACCTGAGCTCAGAAGTTCGAGACCAGCGTGGCCAACATGGCAAAACTCTGTCTCTACAAAAAAAATACAAAAAAATTAGCCAAGTGAGGGCCGGGCGTGGTGGCTCACACCTGTAATCCCAGCACTTTGGGAGGCTGAGGCGGGCGGATCACGAGGTCAGGAGATCAAGACCACCCTGGCTAACATGGTGAAACCCCGTCTCTACTAAAAATACAAAAAATTAGCTGGGCGTGGTTGCAGGCGCCTGTAGTCCCAGCTATTTGGGAGGCTGAGGCAGGAGAATGGCCTGAACCCTGGAGGCAGAGCTTGCAGTGAGCAGAGATCGCGCCACTGCACTCCAGGCTGGGTGACAGAGTGAGACTCCGTCTCAAAAAAAAAAAAAAATTAGCCAGGTGAGGCGGAGGTTGCAGTGTGTTGAGATGGAGCCACTGCACTCCAACCTGGGTGACAAGAGTGAGGTCCCGTCCCCACCACAAAAAAAA","GGCTGGGCGCAGTGGCTCACACCTGTAATCCCAGCACTTAGGGAAGCTGAGGCGAGTAGATCACCTGAGGTCAGGAGTTAGAGACCAGCCTGGCCATCATGGTGAAACCCCGTCTCTACTAAAGATACCAAAAATTAGCTGAGTGTGGTGCTGGGTGCCTGTAATCCCAGAAACTCAGGGTGCCTGTAATCCCAGCAACTCAGGGTGCCTTTAATCCCAGCAACTGAGGGTACCAGTAATCCCAGCAACTCAGGGTGTCTTTAATCCTAGCAACTGAGGGCACCTGTAATCCCAGCAACTCAGGAAGCTGAGACAGGAGAAGTACTTGAACCCAGAAGGCAGAGGTTGCAGTGAGCCGATATTGCACCATTGCACTCCAGTCTGGGCAACAAGAGTGAAACTCTGTCTCAAAAAAAAA"
"chr6","2657143","2657777","JH378118","18053084","18053501","284","15395941","GGCTGGGTGTGGTGGGTCATGCCTGTAATCCAGCACTTTGGGAGGCCCAGGCAGGCAGATAACCTGAGGCCAGGAATTCAAGACCAGCCTGGCCAACATGGTGAAACCCCGTCTCTACAAAAATACAAAAAATTGGCCAGGTGCAGTGGCTCACGCCTATAATCCCAACACTTTGGGAGGCCGAGGTGGGCAGATGCCCTGAGGTCAGGAGTTTGAGACCAGGCTGGCCAATATATAGTGAAACCCCAACTCTACTAAAAAAATACAAAAATTAACTGGGAGTGGTGGCAAACGTCTGTGGTCCCAGCTACTTGGGAAGCTGAGGCAGGGGAATCGTTCAAACCCAGGAGGTGGAGGTTGCAGTGAGCCGAGATAGCGCCACTCCACTCCAGCCTGGGTGACAGAGCAAGACTCCATCTCTCAAAAAAACAAGAACAAAAACAAAAAACAACAACTTAGCCGGACGTGGTGGTGGGTGCCTGTAATCTCAGCTACTCAGGAGGCTGAGGCACAAGAATCCCTTGAACCTGGGAGGTGGAGGTTGCAGTGAGCAGAGATCTCACCATTGCACTGCAGCCTGGGCAACAAGAGCAAAACTCCATCTCAAAAAATAATAATAATAAATAAATAATAAA","GGCTGGGCGCAGTGGCTCACACCTGTAATCCCAGCACTTAGGGAAGCTGAGGCGAGTAGATCACCTGAGGTCAGGAGTTAGAGACCAGCCTGGCCATCATGGTGAAACCCCGTCTCTACTAAAGATACCAAAAATTAGCTGAGTGTGGTGCTGGGTGCCTGTAATCCCAGAAACTCAGGGTGCCTGTAATCCCAGCAACTCAGGGTGCCTTTAATCCCAGCAACTGAGGGTACCAGTAATCCCAGCAACTCAGGGTGTCTTTAATCCTAGCAACTGAGGGCACCTGTAATCCCAGCAACTCAGGAAGCTGAGACAGGAGAAGTACTTGAACCCAGAAGGCAGAGGTTGCAGTGAGCCGATATTGCACCATTGCACTCCAGTCTGGGCAACAAGAGTGAAACTCTGTCTCAAAAAAAAA"
"chr6","7250694","7251312","JH378118","18053084","18053501","276","10802390","CCAGGCACGGTGGCTCACGCCTCTAATCCCAGCACTTTGGGAGGTGAGGCCGGCGGATCACCTGAGATCAGGAGTTTGTGACCAGGCTGGGCAATATGGTGAAACCCCGTCTCTACTAAAAATACAAAAATTAGGCCGGGTGCGATGGCTCACACCTGTAATCCCAGCACTTTGGGAGGCTGAAGCGGGTGGATCATGAGGTCAGGAGTTCGAGCCCAGCCTGGCCAACATGGTGAAACCCCATCTCTACTAAAAATACAAAAATTAGCCAGGCATGCTGACACGCACCTGAAATCTCAGTTACTCGGGAGGCTGAGGCACGAGAATCGCTTGAACCTGGGAGGCAGAGGTTGTGGTGAGCCAAGATTGTGCCACTGCACTCCAGCGTGGGTGACAGAGCGAGACTCCATCTCAAAAAAAAAAAAAAAAAAAAAACCACACAAGCACACAAAATTAGCAGGGAATGGTGGTGGGCTCCTGTAATCCCAGCTACTGGGGAGGCTGAGGCAGAAGAACTGCTTTAACTCGGGAGGCGGAGACTGCAGTGAGCCAAAATTGCACACTGCACTCCAGCCTGGGTGACAAGAGCAAAACTCCGTCAAAAAAAAAAAAAAAAAAA","GGCTGGGCGCAGTGGCTCACACCTGTAATCCCAGCACTTAGGGAAGCTGAGGCGAGTAGATCACCTGAGGTCAGGAGTTAGAGACCAGCCTGGCCATCATGGTGAAACCCCGTCTCTACTAAAGATACCAAAAATTAGCTGAGTGTGGTGCTGGGTGCCTGTAATCCCAGAAACTCAGGGTGCCTGTAATCCCAGCAACTCAGGGTGCCTTTAATCCCAGCAACTGAGGGTACCAGTAATCCCAGCAACTCAGGGTGTCTTTAATCCTAGCAACTGAGGGCACCTGTAATCCCAGCAACTCAGGAAGCTGAGACAGGAGAAGTACTTGAACCCAGAAGGCAGAGGTTGCAGTGAGCCGATATTGCACCATTGCACTCCAGTCTGGGCAACAAGAGTGAAACTCTGTCTCAAAAAAAAA"
"chr6","12909830","12910160","JH378151","16928339","16928664","55","4018509","GGCTTGGTGCGGTCGCTCACGCCTATAATCCCAGCACTTTGGGAGGCCAAGGCAGGTGGATCACCTGAGGTCAGGAGTTCAAGACCAGCCTGGCCAACATGCTGAAACCCTGTCTCTACTTAAAATACAAAAATAAGCTGGGTGTGGTGGCATGTGCCTGTAATCCCAGCTACTGAGGCTGAGGCAGGAGAATCGCTTGAACCCAGGAGGCAGAGATTGCAGTGAGCCAAGATTGCACCATTACACTCCAGCCTAGGTGACAAAAGTGAATGAAACTCCATCACACACACACACACACACACACACACAAAAAAAAAAAAAAAAAAAAAAA","GGCCATATGTGGTGGCTCACGCCTGCAATCCCAGCACTTTGGGAGGCCGAGGTGGGTGAATCACCTGCGGTCAGGAGTTCAAGACCAGCCTGGCCAACATGGTGAAACCCCATCACTACTAAAAATACAAAAAATTAGCTGGGTGTGGTGGCAGGCGCCTGTAATCCCAGCTACTCGAGAGGCTGAGGCAGGAGAATCGCTTGAACCCAGCAGGCGGAGGCTGTAGTGAGCCGAGGTCGTGCCATTGCACTCCAGCCTGGGCAACAGGAATGAAACTCCATCTCCAAAAAACAAAACAAACAAACAAACAAACAAAAAAAAAAACA"
"chr6","14703171","14703410","JH378127","11755432","11755665","47","2947739","GAGACCAGCCAGGCCAACATGATGAAACCGCATCTCTACTAAAAAAAAAAAAAAAAAAAAAAAAAAAAAATTAGCTGGACGTGGTGGTGGGTGCCTGTAGTCCCAGCTACTCGGGAGGCTGAGGCAGGAGAATCACTTGAACTTGGGAAGTGGAGGTGCAGTAAGCCAAGATCACGCCATTGCACTCCAGCCTGAGCAACAAGAGCAAAACCCCTCCTCAAAAAAACAAAAACAAAAAAA","GAGACTAGCCTGGCCAACATGGTGAAACCCTATCTCTACTTAAAAAAAAAAAAAAAAAAAAAAAGCCGGGTACAGTGTGGCAGGTGCTTGTAGTCCCAGCTACTCAGGAGGCTGAGGCAGGAGAATTGCTTGAACTTGGGAGGAGGAGGTTGCAATAAGTCGAGATTGCACCATTGTCTCACAGCCTGGGCAACAAGAGTGAAACCCCATTTCAAACAAAGAACAACAGAAAAA"
"chr6","17087910","17088250","JH378166","6401112","6401453","56","10686798","GGCTGGGCGTGGTGGCTCACGTCTGTAATCCCAGCATTGTGGGAGGCCGAGGCGGGTGGATCATCTGAGGTCAGGAGTTCCAGACCAGCCTGGCCAACATGGTGAAACCCTGTCTCTCCTAAAAATACAAAAAGTTATCCAGATGTGGTGGCAGGTGCCTGTAATCCCAGCTACTTGGGAGGATGAGGCAGGACAATCGCTTGAACCCAGGAGACGGAGGTTGCAGTGAGTGGAGATCGTGCCACTGCACTCCAGCCTGGGCGACAAGAGCAAAACTCCATTAAAACAAACAAACAAACAAACAAAAAACAAGAAAGCAAGCAAGAAAGAAAAGAAAAAAA","GGCCAGGTGCAGTGGCTCACCCCTGTAATCCCAGCACTTTGGGAGGTCGAGGTGGGTGGATCACCTGAGGTCAGGAGTTCAAGACCAGCCTGACCAAAATGGTGAAACCCCATCTCTACTAAAAATACAAAACATTAGCCAGACATCGTGGCGGGCACCTGTAATCCCAGCTACTTGGGAGGCTGAGGCAGGAGAATTGCTTGAGCCTAGGAGGCGGAGGTTACAGTGAGCCATGATCGTGCCATTGGACTCCAGCCTGGGCTACAAGAGCGAGACTCCATCTCAAAAAAAAAAAAAAAAAAAAAAAAGAAAGAAAGAAAGAAAGAAAGAAAAGAAAGAAAG"
"chr6","17392076","17392403","JH378314","538162","538484","53","16853914","GCTGGGTGCAGTGGCTCACGCCTGTAATCCCAGCACTTTGAGAAGCCGAGGTCACCTGAGGTCAGGAGTTCTAGACCAGCCTGGCCAACGTGGTGAAACCCTGTCTCTACTAAAAAAAAAAAAAAAAAAAAAAAAAAAAAAAAAAACAAAATTAGCCAGGTGTGGTGGCGTGCACCTGTAATCCCAGCTACTTAGGCAGGAGGCTGAGGCAGGAGAATTACTTGAAATCAGGAGGCAGAGGTTGCAGTGAGCCGAGATTGTACCATTGCACTCCAGTCTGGGTAAAAAGAGCAAACGCTGTCTCAAAAAAAAAAAAAAACCCAAAAAA","GGCTGGGTGCGGTGCCTCACACCTGTAATCCCAGCACTTTGGGAGGCCGAGGTGGGTGGATCACGAGGTCAAGAGATCAAGACCATCCTGGTCAACATGGTGAAACCCTGTCTCTACTAAAAAAAAAAAAAAAAAAAAAAAAAAAAAAAAAAAAATTAGCTGGGCATGGTGGCGTGTGCCTGTAATCCCAGCTACTCAGGAGGCTGAGGCAGGAGAATTGCCTGAACCCAGGAGGCGGAGGTTGCGGTGAGCCGAGACTGTACCATTGCACTCCAGCCTGGGTAACAAGAGCGAAACTCCATCTCAAAAAAAAAAAAAAAAAA"
"chr6","21590859","21591452","JH378118","18053084","18053501","253","3537775","GGCCGGCGCGGTGGCTCACGCCTGTAATCCCAACACTCTGGGAGGCCGAGGTGGGCAGATCACTTGAGGTCAGTTTGAGGCCAGCCTGGTCAACATGGTGAAACCCTGTCTCTACTAAAAATACAAAAGTTAGGCCGGGCGCGGTGGCTCACGCCTGTAGTCCCAGCACTTTGGGAGGCCGAGGTGGGAGGATCACGAGGTCAGGAGATCGAGACCACTCTGGCTAACATGGCGAAACTCCGTCTCTACTAAAAATATTTTTAAAAAAAATTAGCCGGGTGTGGTGATGGGCGCCTGTAGTCCCAGCTACTCGGGAGGCTGAGGCAGGAGAATGGTGTGAACCTGGGAGGTGGAGCTGGCACTTCAGCCTGAGCGACAGAGCAAGACTCCGTCTCAAAAAAAAAAAAAAAAATTACAAAAGTTAGCCAAGCACTCACAGGTGGTGAGTGCCTATAATCCCAGCTACTTGGGAGGCTGAGGCAGAAGAATTGTTGGAACCCAGGAGGCGGAGATTGCAGCGAGACAAGGTCGTGCCATTGTGCTCCAGTCTGGGCAACAAGAGTGTGACTCAGTCTCAAAAAACAAACAAACAAA","GGCTGGGCGCAGTGGCTCACACCTGTAATCCCAGCACTTAGGGAAGCTGAGGCGAGTAGATCACCTGAGGTCAGGAGTTAGAGACCAGCCTGGCCATCATGGTGAAACCCCGTCTCTACTAAAGATACCAAAAATTAGCTGAGTGTGGTGCTGGGTGCCTGTAATCCCAGAAACTCAGGGTGCCTGTAATCCCAGCAACTCAGGGTGCCTTTAATCCCAGCAACTGAGGGTACCAGTAATCCCAGCAACTCAGGGTGTCTTTAATCCTAGCAACTGAGGGCACCTGTAATCCCAGCAACTCAGGAAGCTGAGACAGGAGAAGTACTTGAACCCAGAAGGCAGAGGTTGCAGTGAGCCGATATTGCACCATTGCACTCCAGTCTGGGCAACAAGAGTGAAACTCTGTCTCAAAAAAAAA"
"chr6","21776365","21776682","JH378105","46221579","46221896","51","24445214","GGCCAGGCACGGTGGCTCATGCCTGTAATCCCAGCACTTTGGGAGGCCCAGGTGGGCGGATCACCTGAGGTCAGGAGTTCAAGACCATCCTGGCCGAGGTGAAACCCCGTCTCTACGAAAATAAAATAAAATAAGATAAAATAAAATAAAATAATTAGCCAGGCATGGTGGCTGACACCTGTAATCCCAGCTACTTGGGAGGCTGAGGCAGGAGAATTTCTTAAACCTGGGAGGCCAAGGTTGCAGTGAGCCGAGATCGTGCCATTGCACTTTAGCCTGGGAGACAAGAGCAAAACTCGGTCTTAAAAAAAAAAAAAA","GACTGGGTGTGATGGCTCATGCCTGTAATCCCAGCACTTTGGGAGGCCAAGGCGGGTGGATCACCTGAGGTCAGGAGTTCAAGACCAGCCTGACCAACATGGTGAAACCCCGTCTCTACTAAAAAAAAAAAAAAAAAAAAAAAACTACAAAATTAGCTGGGCCTGGTGGTACACACCTATAATCCCAGCTACTTGGGAGGCTGAGGCAGGAGAGTTACTTGAACCCAGGAGGCAGAGGTTGCAGTGAGCTGAGATCATGCCATTGCACTCCATCCTGGGCAACAAGAGCGAAACTCTGTCTTAAAAAAAAAAAAAAAA"
"chr6","24822609","24822780","JH378105","21927543","21927691","49","2895066","CCAGCTGGGCGAGGGGCCTGAGGCGGATGAGAACTCCTGTGAACTCAAAACAGGGGGGGGGGGGGGGGGGGGGGGGGGGGGGTGGAGGTTGCAGTGAGCTGAGATTGCACCATTGCACTCCAGCCTGGGCAGCAAGAGCAAAACTCTGTCTCAAAAAAAAAAAAAAAAAAAA","GCAACCCGGGAGGCTAAGGCAAGAGAATCACTTGAACTGGGGCTGGGGGGCAGGGGGTGGTGTGGAGGTTGCAGTGAGCCGAGATTGAACCGTTGCACTCCAGCCTGGGTAACAAGAGTGAAGCTCCGTCTTAAAAATAAAAATAAAAA"
"chr6","27054092","27054582","JH378206","6546474","6546861","172","20507618","GGGGCGGTGGCTCACGCTTGTAATCCCAGCACTTTGGGAGGCCGAGGCGGGCGGATCGCCTGAGGCCAGAAATTCGAAACCAGCCTGGCCAATATGGTGAAACCCCGTTTCTACTAAAAATACAAAAATTAGCCGGGCGTGGTGGCTCACGCCTGTAATACCAGCGCTTTGAGAGGCTGAGGTGGGCGGATCACCTGAGATCGGGAGTTCGAATCCAGCCTGACCAACATGGAGAAACCCTGTCTCTACTAAAAATACAAAATTAGACGGGCGTGGGTGGCGCATGCCTGTAATCCCAGCTACTCGGAAGGCTGAGTCAGGAGAATCGTTTGACCGCGGGAGACAAATCTCAGCTCCTCGAGAGGCTGAGGCAGGAGAATCGCTTGAACCGGGGAGACAAAGGTGCGGTAAGCCGAGATTGCCCCATTGAACTCCAGCCTGGTCATCAAGAGCGAAACTCCATTTCAAAAAGAAAAACGAAAAAAGGAAAA","GGCCACACATGGTGGCTAACGCCTGTAATCCCAGCACTTTGGGAGGCCAAGTCGGGTGGATCATGAGGTCAGGAGACCAAGACCATCCTGGCCAAATGGTGAAACCCCGTCTCTACTAAAAATACAAAAATTAGCTGGGCATGGTGGCGTGTGCCTGTAATCCCAGCTACTCAGGAGGCTGAGGCAGGACAATTGCCTGAACCCAGGAGAATTAGCTGGGCATGGTGGCGTGTGCCTGTAATCCCAGCTACTCAGGAGGCTGAGGCAGGACAATTGCCTGAACCCAGGAGGCGAAGGTTGCGGTGAGCCGAGATTGTGCCATTGCACTCCAGCCTGGGTAACAAGAGCGACACTCTGTCTCAAAAAAAAAAAAAAAAAAAAAAAAAAA"
"chr6","27461381","27461983","JH378118","18053084","18053501","256","9408297","GCAGTGGCTCACGCTTGTAACCCCAACACTTTGGGAGGCCAAGGCGGGAGGATCACCTGAGGTCAGGAGTTCGAGACCAGCCTGGCTAACATGGTGAAACCCTGTCTCCACTGAAAATACAAAAAATGGCCGGGTGGTGGCTCATGCCTGTAATCCTAGCACTTTGGGAGGCCGAGGCGAGCAGATCACGAGGTCAAGAGATGGAGACCATCCTGGCCAACATGGTGAAACCTCGTCTCTACTAAAATACAAAAATTAGCTGGGCATGGTGGTTCGTGCCTGCAATCCCAGCTACTCGGGAGACTGAGGCAGGAGAATCGCTTGAACCCGGGAGGCGGAGGTTGCAGTGAGCTGAGATCAGGCCACTGCACTCCAGCCTGGCAACAGAGCGAGACTCCGTCTCAAAACGAAAAAGAAAATACAAAAAATTAGCCAGACGCGGTGGCGTGCGCCTGTAATCCCAGCTACTCAGCAGGCTGAGACAGGAGAACTGCTTGAACCTGGGAGACAGAGGTTGCAGTGAGCTGAGATTACACCATTGCACTCCAGCCTGGGTGACAAGAGTGAAACTCCATCTCAAAAAAAAAAAAAAAAAAAAAAAAA","GGCTGGGCGCAGTGGCTCACACCTGTAATCCCAGCACTTAGGGAAGCTGAGGCGAGTAGATCACCTGAGGTCAGGAGTTAGAGACCAGCCTGGCCATCATGGTGAAACCCCGTCTCTACTAAAGATACCAAAAATTAGCTGAGTGTGGTGCTGGGTGCCTGTAATCCCAGAAACTCAGGGTGCCTGTAATCCCAGCAACTCAGGGTGCCTTTAATCCCAGCAACTGAGGGTACCAGTAATCCCAGCAACTCAGGGTGTCTTTAATCCTAGCAACTGAGGGCACCTGTAATCCCAGCAACTCAGGAAGCTGAGACAGGAGAAGTACTTGAACCCAGAAGGCAGAGGTTGCAGTGAGCCGATATTGCACCATTGCACTCCAGTCTGGGCAACAAGAGTGAAACTCTGTCTCAAAAAAAAA"
"chr6","28682375","28682711","JH378224","2846632","2846964","57","25835743","GGCTGGGCATGGTGGCTCACACCTGTAATCTCAGCACTTTGGGAGGCCGAGTCGGGTAGATCACCTGAGATCAGAAGTTTAAGACCAGCCTGGCCAACATGGTGATACCCTGTCACTACTAAAAATACAAAATAATAATAATAATAATAATAATAATAAATTAGCCGGGCGTGGTGGTGGATGCCTGTAATCCCAGTTACTCGAGAGGCTGAGGCAGGAGAATCCCTTGAACCTGGGAAGTGGAGGTTGCAGTGAGCCGAGATTGCACCATTGCACTCCACTCTAGGCAACAAGAGCAAGACTCTGTCTTAAAAAAAGAAAAAAAAAAAAAAGGAAA","GGCCAGGCAGGGTGGCTTACATCTGTAATCCCAGCACTTTGGGAGGTCAAGGCGAGTGGATCACCTGAGGTCATGAGTTCAAGACCAGCCTGGCCAACTTGGTGAAACCCTGTCTCTACTAAAAATACAAAAAAAAAAAAAAAAAAAAAAAAAAAAATTAACTGGGTGTGGTGGTGCACACCTGTAATCCCAGCTACTCAGGAGGCTGAGGCAGGAGAATCCCTTGAACACGGGAGGTGGAGGTTGCAGTGAGCCGAGATCATGCCATTGCACTCCAGCCTTGGTGAAAAGAGCAAAACTCTGTCTTAAACAAAACAAAACAAAACCAGAAAA"
"chr6","29541063","29541569","JH378206","6546474","6546861","190","22994589","CTATAGTCCCAACTACTCAGGAGGCTGAGCAGGAAGAATTGGTTGAGGCCAGGAGTTCAAGAGCAGCCTGGGCAATAGAGTGAGACCTGTCTTTTAAAAAAGTAAAAATAGGCCAGGCTCAGTGGCTCACACCTGTAATCCCAGCACTTTGGGAGGCCGAGGTGGGCGGATCATCTGAGGTCAGGAGCTCAAGACCAGCCTGAGCAACATGACAAAACCCCATCTCTATTAAAAATACAAAAAATTAGCCGTGTGTGGTGGTGCACGCCTGCATTCCCAGCTACTCAGAAGGCTGAGGCAGGAGAGTCACTTGAACCCAGGAGGTGGAAGTTGCAGTGAGCCGAGATCGCACCTGCATTCCCAGATACTTAGAAGGCTGAGGCAGGAGAATCACTTGAACCCAGGAGGTGGAAGTTGCAGTGAGCTGAGATCGCACCATTGTACTCCAGCCTGGGCAACAAGAGTGAAACTCCACCACAAAAAAAAAAAAAAAAAGTAAGAATAAAA","GGCCACACATGGTGGCTAACGCCTGTAATCCCAGCACTTTGGGAGGCCAAGTCGGGTGGATCATGAGGTCAGGAGACCAAGACCATCCTGGCCAAATGGTGAAACCCCGTCTCTACTAAAAATACAAAAATTAGCTGGGCATGGTGGCGTGTGCCTGTAATCCCAGCTACTCAGGAGGCTGAGGCAGGACAATTGCCTGAACCCAGGAGAATTAGCTGGGCATGGTGGCGTGTGCCTGTAATCCCAGCTACTCAGGAGGCTGAGGCAGGACAATTGCCTGAACCCAGGAGGCGAAGGTTGCGGTGAGCCGAGATTGTGCCATTGCACTCCAGCCTGGGTAACAAGAGCGACACTCTGTCTCAAAAAAAAAAAAAAAAAAAAAAAAAAA"
"chr6","30303986","30304272","JH378262","1472551","1472814","62","28831435","CACTTTGGGCAGCCAAGGTGAGTGGATCACAGGAGGTCGGGAATTGGAGACCAGCCTGGCCAACATTATGAAACCCTGTCTCTACTAAAAATACACACACACACACACACACACACAAAAATAGCCAGGCATGGTGGCAGGTGCCTGTAACCCCAAGCTACTTGAGAGGCTGAGACAGGAGAATCACTTGAACCCGGGAGGCAGAGGTTGCAGTGAGCCGAGATCGTGTCATTTGCACTCCAGCCTGGGCGACAAGAGCAAGACTTCATCTCCCAAAAAAAAAAAAA","CACTTTGGGAGGCCAAGGTAGGTGGGTCACGAGGTCAGGAGTTTCAGACCATCCTGGCTAACATGGTGAAACCCCGTCTCTACTAAAAATACAAAAAAAAATAGCTGGGCGTGGTGGTGCGTGCCTGTAATCCCAGCTACTCAGGAGGCTGAGGCAGGAGAATTGCCTGAACCCAGGAGGCAGAGGTTGCGGTGAGCCGAGATCGCGCCATTGCACTCCAGCCTGGGTAACAAGAGCGAAACTCCGTCTCAAAAAAAAAAAAAA"
"chr6","32692357","32692676","JH378141","8679762","8680071","51","24012595","GGTCGGGCACAGTGTCTCACTCCTGTAATCCCAGCACTTTGGGAGGCCAAGGTGGGTGGATCACTTGAGGTCAGGAATTTGAGAACAACCTGGCCAACATGGTGAAACCCTACTAAAAATACAAAATACAAAAATACTAAAAATACAAAAAAATTAACTGGGCGTGGTGGCGGGCACCTGTAATCCCAGCTACACAAGAGGCTGAGGCAGGAGAATCGCGTGAACCTGGGAGGTGGAAGTTGCAGTGAGCCGCAATCATGACATTGCACTCCAGCCTGGGCAACAAGAGTGAAACTCGGTCTCAAAAAAAAAAAAAAAAA","GGTCGGGCGCGGTGGCTCAAGCCTGTAATCCCAGCACTTTGGGAGGCCAAGGCGGGTGGATCACGAGGTCAGGAGATCGAGACCATCCTGGTCAACATGGTGAAACCCCGTCTCTACTAAAAATAAAAATAAAAATAAAAAAATTAGCTGGGCATGGTGGCGTGTGTCTGTAATCCCAGCTACTCAGGAGGCTGAGGCAGGAGAATTGCCTGAACCCGGGAGGCGGAGGTTGCGGTGAGCCGAGATCGCGCCATTGCACTCCAGCCTGGGTGACAAGAGTGAAACTCCGTCTCAAAAAAAAAAAAAAAAA"
"chr6","35063777","35064388","JH378118","18053084","18053501","282","17010693","CTGGGCACTGTGGCTCATGCCTGTAATCCCAGCACTTTGGGAGGCAGAGGCAGGTGGATAGCTTGAGCCCAGGAGTTTGAGACTAGCCTGGGCAACATAGCAAGACACTGTCCCTATGGAAAAAAAAAAAATTTCTTAGACACAAAAATTAAGGCTGGGAGCAGTGGCTCATGCTTGTACTATAATCCCAACACTTTTGGAGGCCGAGGCGGGTGAATCACTTGAGGTCAGGAGTTCGAGGCCAGCCTGGCCAACATGGTGAAACCCCGTCTCTACTAAAAATACAAAAATTGGCTGGGCATGGTGGCGGGCGCCTGTAATCTTAGCTACTCAAGAGGCTGAGGTGGGAGAATCGCTTGAACCTGGGGGGCAGAGGTTGCAGTGAGCCAAGATATCATGCCACTGCACTCCAGTCTGGGCAACAAAGTAAGACTCCGTGTCAAAAAAAAGTCAAAAAAAAAATACAAAAATTACTCAGGTGTGGCGGCAGGCGCTTATAACCCCAGCTACTAGGGATGCTAAGGTGGGAGAATCGCTTGAACCAGGGGACAGAGTTTGCACTCCAGCCTGGGCGACAAGAGTGAGACTCCATCTCAAAAATAAATAAATAAA","GGCTGGGCGCAGTGGCTCACACCTGTAATCCCAGCACTTAGGGAAGCTGAGGCGAGTAGATCACCTGAGGTCAGGAGTTAGAGACCAGCCTGGCCATCATGGTGAAACCCCGTCTCTACTAAAGATACCAAAAATTAGCTGAGTGTGGTGCTGGGTGCCTGTAATCCCAGAAACTCAGGGTGCCTGTAATCCCAGCAACTCAGGGTGCCTTTAATCCCAGCAACTGAGGGTACCAGTAATCCCAGCAACTCAGGGTGTCTTTAATCCTAGCAACTGAGGGCACCTGTAATCCCAGCAACTCAGGAAGCTGAGACAGGAGAAGTACTTGAACCCAGAAGGCAGAGGTTGCAGTGAGCCGATATTGCACCATTGCACTCCAGTCTGGGCAACAAGAGTGAAACTCTGTCTCAAAAAAAAA"
"chr6","35134619","35135101","JH378119","32351107","32351490","158","2783512","CTACTAAAAATGCAGACAGGATGGGCAGGGTGGCTCACACCTGTAATCCCAGTACTTTGGGAGGCCAAGGCGGGCGGATCAACTGAGGTCAGGAGTTCAAGACCAGTCTGGCCAACATGGTGAAACCCCATCTCTACAAAAATAAGCTGAGCGTGGTGGTGGGTGCCTGTAATCCCAGCTACTTGGGAGGCTGAGGCGGGAGAATCACTTGAACCCGGGAGGCGGAGGTTGCAGTGAGCCGAGATCGCACCATTGCACTCCAGCCTGGGCGACAGGGCGAGACTCCGTCTCAAAAAAAAAAAAACAATTAGCCGGGCTTGGTGGTGGGCACCTGTAATCCCAGCTACTCAGGAGGCTGAGGCAGGAGAATTACTTGAACCCTGGGAGGCGGAGGTTGCAGTGAGCTGAGATCACACCATCGCACTCCAGCCATGGCAACAAGAGCAAAACTCCATCTCAAAAATAAACAAACAAATAAATAAA","GGCCAGGTATGGTGGCTCACACCTGTAATCCCAGCACTTTGGGAGGCCAAGGCAGGCAGACCACCTGAGGTCAGGAGTTCGAGATCAGCCTAGCCAACATGGTGAAACCCCATCTCTAGTAAAAATAAAATTAGCCAGGCATGGTGGTGCATGCCTGTAACGCAGGTCAGGAGTTCGAGATCAGCTTAGCCAACATGGTGAAACCCCATCTCTAGTAAAAATAAAATTAGCCAGGCAGGTGGTGCCGCCTGTACTCGGGAGGCTGAGGCAGGAGAATCACTTGAACCCAAGAGGCAGAGGTTGCAGTCAGCCAAGATCATGCCATTGCACTCCAGCCTAAGCAAAAAGAGTAAAACTCAGTCTCAAAACAAAAAAACAAAAAAA"
"chr6","35848765","35849383","JH378206","6546474","6546861","275","29302291","GCCAGGTGCGGTGGTTTACGCCTGTAATCCCAGCACTTTGGGAGGCTGAGACTGGCGGATCATTTGAGGTCAGGAGTTCGAGGCCAGCCTGGCCGGCACAGTGAAACCCAGTCTCTACTAAAAATTCAAAAATTAGCCAGGTGCGGTGGCTCACCCCTGTAATCCCAGCACTTTTGGGAGGCCAAGGCAGACAGATCACAAGGTCAGGAGATCGAGACTATCCTGGCTAACACGGTGAAACCTCGTCTCTACTAAAAATGCAAAAATTAGCCGGGCGTGGCAGCAGGCGCCTGTAGTCCCAGCTACTCAGGAGGCTGAGGCAGGAGAATGGAGTGTACCCGGGAGGCGGAGCTTGCAGTGAGCGGAGATCACGCCACTGCACCCCTGCCTGGGCAACAGAGCGAGACTCCGTCTCAAAAACAAAAAAAATATTAAAAAATTAGCTGGGCATCGTGGTGGGCACCTGTAGTCCCAGCTACTAGGGAGGCTGAGGCAGGAGAATCGCTTGAACCTGGGAGGCGGAGGTTGCAGTGAGCCGAGATCTTGCCAGTGCACTCCAGCCTGGCCAAAAACAGCAAGACTACGTCTTAGAAAAAAAAAAAAAAAAAAAAAAAAAAAA","GGCCACACATGGTGGCTAACGCCTGTAATCCCAGCACTTTGGGAGGCCAAGTCGGGTGGATCATGAGGTCAGGAGACCAAGACCATCCTGGCCAAATGGTGAAACCCCGTCTCTACTAAAAATACAAAAATTAGCTGGGCATGGTGGCGTGTGCCTGTAATCCCAGCTACTCAGGAGGCTGAGGCAGGACAATTGCCTGAACCCAGGAGAATTAGCTGGGCATGGTGGCGTGTGCCTGTAATCCCAGCTACTCAGGAGGCTGAGGCAGGACAATTGCCTGAACCCAGGAGGCGAAGGTTGCGGTGAGCCGAGATTGTGCCATTGCACTCCAGCCTGGGTAACAAGAGCGACACTCTGTCTCAAAAAAAAAAAAAAAAAAAAAAAAAAA"
"chr6","37381205","37381693","JH378119","32351107","32351490","160","5030098","AAAAATATGTAAATAGGCCGGGCATGGTGGCTCACACCTGTAATCACAGCATTTTGGGAGGTCGAGGTGGGCGGACCACCTGAGGTCAGGAGTTTGAGACCAGCCTGGCCAACATGGCGAAACCCCGTCTCTACTAAAAATATAAAAATTAGCTCGGTGTGGTGGTGCGCTCCTGTAATCCCAGCTACTGGGGAGGCTGAGGCAGTAGAATGGCTTGAACCCAAGAAGGGGAGGTTGCAGTGAGCCGAGATTACGCCACTGCACTCCAGGCTGGGTGACAGAGCAAGACTCCATCTAAAAAAAAAAAAAAAAAAAAAAAATTAGCCAGGTGTGGTGGCAGGCACCTGTAATCACAGCTACTCAAGAGGCCGAGGTAGGAGAATCACTCGAACCTGGGAGGCAGAGGTGGCAGTGAGCCGAGATCATGCCATTGCACTCCAGCCTGGGTGACAATAGCGAGACTCTGTCTCAAAAAAAAAAAAAAAAAAA","GGCCAGGTATGGTGGCTCACACCTGTAATCCCAGCACTTTGGGAGGCCAAGGCAGGCAGACCACCTGAGGTCAGGAGTTCGAGATCAGCCTAGCCAACATGGTGAAACCCCATCTCTAGTAAAAATAAAATTAGCCAGGCATGGTGGTGCATGCCTGTAACGCAGGTCAGGAGTTCGAGATCAGCTTAGCCAACATGGTGAAACCCCATCTCTAGTAAAAATAAAATTAGCCAGGCAGGTGGTGCCGCCTGTACTCGGGAGGCTGAGGCAGGAGAATCACTTGAACCCAAGAGGCAGAGGTTGCAGTCAGCCAAGATCATGCCATTGCACTCCAGCCTAAGCAAAAAGAGTAAAACTCAGTCTCAAAACAAAAAAACAAAAAAA"
"chr6","37454921","37455537","JH378118","18053084","18053501","254","19401837","GGCTAGGTGCAGTGGCTCACGCCTGTAATCCCAGCACTTTGGGAGGCCGAAGTGGGTGGATCACTTGACGTCAGGAGTTCGAGACTAGCCTGGCCAATCCCTTTAGTAGAGATGGGTGAAACCCCATCTCTACTAAAAACACAAAAAATTAGCCAGGCATGGCTGGGCACGGTGGCTCATGCCTGTAATCCCAGCACTTTGGGAGGCTAAGGCAGGCGAATCATGAGGTCAGGAGTTCAAGACCACCCTGGCCAACATGGTGAAACCCCATCTTTACTAAAAAATACAAAAAGTTAGCCAGGCATGGTGGCAGGCACCTGTAATCCCAGCTCAGGAGAACTGCTTGAACCTGGGAAGCGGAGGTTACAGTGAGCTGAGATTGCACCACTGCACTGCAGCCTGGGCAACAGTGCAAGACTCCGTCTCAAAAAAAAAAAAAAAAAAAATTAGCCAGACATGGTGGCAGGTGCCTGTAATCCCAGCTACTTGGGAGGCTAAGGCAGGAGAATCACTTGAACCCAGGAGGCAAAGGTTGCAGTGAGCCGAGGTCGCATCATTGCACTCCAGCCGAGACAACAAGAGCGAAACTCCGTCTCAAAAACAAACAAAACAAATAA","GGCTGGGCGCAGTGGCTCACACCTGTAATCCCAGCACTTAGGGAAGCTGAGGCGAGTAGATCACCTGAGGTCAGGAGTTAGAGACCAGCCTGGCCATCATGGTGAAACCCCGTCTCTACTAAAGATACCAAAAATTAGCTGAGTGTGGTGCTGGGTGCCTGTAATCCCAGAAACTCAGGGTGCCTGTAATCCCAGCAACTCAGGGTGCCTTTAATCCCAGCAACTGAGGGTACCAGTAATCCCAGCAACTCAGGGTGTCTTTAATCCTAGCAACTGAGGGCACCTGTAATCCCAGCAACTCAGGAAGCTGAGACAGGAGAAGTACTTGAACCCAGAAGGCAGAGGTTGCAGTGAGCCGATATTGCACCATTGCACTCCAGTCTGGGCAACAAGAGTGAAACTCTGTCTCAAAAAAAAA"
"chr6","38142220","38142533","JH378190","5694705","5695021","48","32447515","GGCCAGGCACAGTGGCTCATGCCCGTAATCCCAGCACTTTGGGAGGCCGAGGCGGGTGGATCACCTGAGGTTAGGAGTTCGAGACCAGCCTGGCCAACATGGTGAAACCCCATCTCTACTAAAAATACAAAAAAAAAAAAAAAAAAAAAAAAATAGCCATACGTGGTGGCAGATGCCTGTAATTCCAGCTACTTGGGAGGCTGAAACAGAAGAATCACTTAAACCTGGGAGGTGGAGGTTGCAGTGAGCTGAGATCACACCATTGCGCTCCAGCCTGGGCGACAACAGTGAAACTCCATCTCAAAAAAAAAAAA","GGCCCGGCATAGTGGCACACGCCTGTAATCCCAACACTTTGGGAGGCCGAGGCGGTTGAATCACCTAAGGTCAGGAGTTCAAGACCAGCCTGGACAATGTGGTGAAACCCCATCTCTACTAAAAATACAAAAAAAAAAAAAAAAAAAAAAAAAAAATAGCCAGATGTGGTGGCGTGCACCTGTAATCCCAGTTACTTGGGAGGCTGAGGCGGGAGAATCGCTTATCTGGGAAGCGGAGGTTGCAGTGAGACAAGATTGCACCATTGCACACCAGCCTGGGTGACAAGATTAAAACTCCATCTCAAAAAACAGAAAAA"
"chr6","42401686","42402278","JH378114","15957391","15957789","245","26444295","GCCAGGTGCGGTGGGTCATGCCTGTAATCCTAGCACTTTGGGAGGCTGAGGTGGGCAGATCACTTAAGGTCAGGAGTTGGAGACCCACCTGGCCAACATGGTGAAACCCCATCTCTACTAAACCTACAAAAAATTAGGCCAGGTGTGGTGGCTCATGCCTGTAATCCCAGCACTTTGGGAGGCCGAGGTGGGCGGATCATGAGGTCAGGAGATCGAGACCATCCTGGCTAACGCGGTGAAACTCTGTCTCTACTGAAAAATACAAAAAATTAGCCGGGCGTGGTGGCAGGCACCTGTAGTCTCAGCTACTTGGGAGGCTGAGGCAGGAGAATGGCGTGAACCCGGGAGGCGGAGCTTGCAGTGAGCCGAGATTGCACCACTGCAATCTTGACAATCCACTGCAATCCAGCCTGGGCGACAGAGCGAGACTCTGTCTCCAAAAAAAAAAAATTAGCCAGGTGTGGTGGTAGATACCTATAATCCCAGCTACTCAGGAAGCTGAGGCAGGAGAATCATTTGAACCCGGGAGGTGGAGGTTGCAGTGAGCCAAGATTGCACTCCAGCCTGGGCAACAAGAGCAAAACTCCGTCACA","GCAAGGAACGGTGGCTCATGCCTGTCATCCCAGCACTTTGGGAGGCTAAGGAGGGTGGATTACCGAAGGTCATGAGTTTGAGACCAGCCTGACCAACATGGTGAAAACCCCATCTCTACTAAAAATACAAAAAATTAGCCAGATACAGCTATGCGGCAGACTGGGGCAGGAGAATCGCTTGGACCCAAACCCCATCTCTACTAAAAATACAAAAAATTAGCCGGATACAGCTATGCGGGAGACTGGGGCAGGAGAATCGCTTGGACCCGGGAGGCAGAGATTGCAGTGAGATGAGACCATGCCATTGCTCTCTAGCTTGTGCGATGAGAACAAGACTCTGTCTCAAAAAAAAAAAAAAAAAAAAAAAAAAAAAAAAAAAAAAAAGAGAGAGAGAGAAAA"
"chr6","42597294","42597848","JH378129","11955248","11955630","234","30642046","GCAGGGTGCGATGGCATGCACCTGTACCCCCACCTATCAGGAGACTGAGGTGAGGATTACTTGAGCGAAGGAGTTCAAGACTAGCCTGGGCAACACAGCAAGACCTCATCTCTTTTCTTTTTTTTTTTTTTTGAGATGGACTCTTGCTCTGTTGCCCAGGCTGGAGGGCAATGGTGCGATCTTGGCTCACTGCAACCTCCGCCTCCTGGGTTCAAGTGATTCTCCTACCTCAGCCTCCCGAGTAGCTGGGACTACAGGTGCCCGCCACCATGCCCAGCTAATTTTGTATTTTTAGTAGAGACGGGGTTTCACCGTGTTAGCCAGGATGGTCTCGATCTCCTGACCTCATGATCTGCCCGTCTCTACCAAAAATACAAAAATTAGCTGGGCATGGTGGCAGGCGCTTGCAATCCCAGCTACTTGGGAAGCTGAGGCAGGAGATTCACTTGAACCCGGGAGGCAGAGGTTGCAGTGAGCCGAGATTGTGCCACTGCACTCCAGGCTCGGTGACAAGAGCAAAACTCCATCTACAAAAAAAAAAAAAAAAAAAAAAAA","GGCTGGGTACGGTGGCTCATGCCTGTAATCCCAGCACTTTGGGAGGTGGGTCACTTGAGGTCAGGAGTTCGAGACCAGCCTGTGCAGTGCCTCCATCCTCAACTGCTGCCTCATCAGCCTGGACCACTACCTGCTCATCCTCTCACCACTGCCACAAGCTGCGCATGAAGCTCCTGCGCGCGCCGGTGCCCGTCTCTACTAAAAATACAAAAATTAGCTGGGTGTGGTGGCAGGTGCCTGTAATCCCAGCTACTCAGGAGGCTGAGGCAGGAGAATCACTTGAACCCAGGAGGCAGAGGTTGCAGTGAGCCGATATCGCATCATTGCACTCCAGCCTGAGCAACAAGAGTGAAATTTTGTCTCAAAAAAAAAAAAAAAAGAAA"
"chr6","43312389","43313006","JH378118","18053084","18053501","252","25259305","GGCCGGGTGCGGTGGCTCACACCTGTAATCCCAGCACTTTGGGAGGCTGAGGCAGGTAGATCACCTGAGGTCAGGAGTTCGAGAGCAGCGTGGCCAACATGGTGAAACACTGTCTCTACTAAAAATACAAAAATTGGGCTGGGCATGGTGGCTCACACCTGTAATCCCAGCACTTTGGGAGGCCGAGGCGGGTGGATCACCTGAGGTCAGGAGTTCAAGACCAGCTTGACCAACATAGTGAAACCCTGTCTCTACTAAAAATACAAAAATTAGCCAGGCATGGTGGCACATGCCTGTAATCCCAGCTACTCAGGAGGCTGAGGCAGGAGAATCTCTTGAACCCAGGAGCCGGAGGATGCAGTGAGCCGATATCGCACCATTGCACTCCAGACTGGGCAACAAGAGTGAAACTGCATCTCAAAAAAAAAAAAATACAAAAATTAGCCAGGTGTGGTGGTGGCACACCTGTAATCCCAGCTACTGGGGAGGCTGAGGCTGGAGAATTGCTTGAACCCAGGAGGCAGAGGTTGCAGTGAGAGGAGATCGTGCCATTGCACTCCAGCCTCGGCGACAAGAGGGAAACTCCGTCTCAAAAAACAAAAAAACAGAAAAAAAAAA","GGCTGGGCGCAGTGGCTCACACCTGTAATCCCAGCACTTAGGGAAGCTGAGGCGAGTAGATCACCTGAGGTCAGGAGTTAGAGACCAGCCTGGCCATCATGGTGAAACCCCGTCTCTACTAAAGATACCAAAAATTAGCTGAGTGTGGTGCTGGGTGCCTGTAATCCCAGAAACTCAGGGTGCCTGTAATCCCAGCAACTCAGGGTGCCTTTAATCCCAGCAACTGAGGGTACCAGTAATCCCAGCAACTCAGGGTGTCTTTAATCCTAGCAACTGAGGGCACCTGTAATCCCAGCAACTCAGGAAGCTGAGACAGGAGAAGTACTTGAACCCAGAAGGCAGAGGTTGCAGTGAGCCGATATTGCACCATTGCACTCCAGTCTGGGCAACAAGAGTGAAACTCTGTCTCAAAAAAAAA"
"chr6","43869307","43869787","JH378118","18053084","18053501","167","25816223","TTCAAGACCAGGCTGGCAAACATGGTGAAACCCTGTCTCTACTGAAGATACAAAATTAGCCAGGCTGGGCGGATCACGAGGTCAGGAGATCGAGACCATCCTGGCTAACATGGTGAAACCCCATCTCTACTAAAATTACAAAAAATTAGCTGGGCGAGGTGGCGGGCGCCTGTAGTCCCAGCTACTTGGGAGGCTGAGGCAGGAGAATGGTGTGAACCCGGGAGGCGGAGCTTGCAGTGAGCCGAGATGGCGCCACTGCACTCCAGCCTGGGCGACAGAGCGCGACTCCATCTCAAAATAAATAAATAAAATTAGCCAGGCATGGTGGCACACGCCTGTAATCCCAGCTACTCAGGAGGCTGAGACAGGAGAAGCGCTTGAACCTGGGAGGTAGAGGTTGAAGTGAGCTGAGATCATACCTTTGCATGCCAGCCTGGGCAACAAGAGTGACACTCTGTTTCAAAAAAAATAAATTAAAAAA","GGCTGGGCGCAGTGGCTCACACCTGTAATCCCAGCACTTAGGGAAGCTGAGGCGAGTAGATCACCTGAGGTCAGGAGTTAGAGACCAGCCTGGCCATCATGGTGAAACCCCGTCTCTACTAAAGATACCAAAAATTAGCTGAGTGTGGTGCTGGGTGCCTGTAATCCCAGAAACTCAGGGTGCCTGTAATCCCAGCAACTCAGGGTGCCTTTAATCCCAGCAACTGAGGGTACCAGTAATCCCAGCAACTCAGGGTGTCTTTAATCCTAGCAACTGAGGGCACCTGTAATCCCAGCAACTCAGGAAGCTGAGACAGGAGAAGTACTTGAACCCAGAAGGCAGAGGTTGCAGTGAGCCGATATTGCACCATTGCACTCCAGTCTGGGCAACAAGAGTGAAACTCTGTCTCAAAAAAAAA"
"chr6","45951346","45951779","JH378166","6401112","6401453","157","39550234","GACTCACACCTGTAATCCCAGCACTTTGGGAGGCCAAGATGGGCTGATTACCTGAGGTCAGGAGTTCCAGCCAAGCCTGACCAATATGGTGAAACCCCGACTCTACTAAAAATGCAAAAAAATTAGCTGGGCATGGTGGCGGGCAGATGTAATCCCAGCTACTTGGGAGGCTGAGGCAGGAGAATTGCTTGAACCCGGGAGGCAGAGGTTGCAGTGAGCCGAGATCATGGCATTGCACTGCAGCCTGGGCAAAAGAGCAACACTCTGTCTCAAGGAAGGAAGGAAGGGAGGGAGGAGGGAGGGAGGGAGGAGGAAGGAAGGAGGAAGGAAGAAGGAAGAAGGAAGGAAGGAAGGAAGGAAGGAAGGAAGGAAGGAAGGAAGGAAGGAAGGAAGGAAGGAAGGAAAGAAAGAGGAAAAAAAGAAAGAAAGAGAAA","GGCCAGGTGCAGTGGCTCACCCCTGTAATCCCAGCACTTTGGGAGGTCGAGGTGGGTGGATCACCTGAGGTCAGGAGTTCAAGACCAGCCTGACCAAAATGGTGAAACCCCATCTCTACTAAAAATACAAAACATTAGCCAGACATCGTGGCGGGCACCTGTAATCCCAGCTACTTGGGAGGCTGAGGCAGGAGAATTGCTTGAGCCTAGGAGGCGGAGGTTACAGTGAGCCATGATCGTGCCATTGGACTCCAGCCTGGGCTACAAGAGCGAGACTCCATCTCAAAAAAAAAAAAAAAAAAAAAAAAGAAAGAAAGAAAGAAAGAAAGAAAAGAAAGAAAG"
"chr6","54161224","54161563","JH378314","538162","538484","64","53623062","GGCTGGGCGCAGTGGCTCAAGCCTGTAATCCCAGCACTTTGGGAGGCTGAAGTGGGCGGATTACCTGAGGCCAGAAGTTCAAGAACAGCCTGGCCAACATGGTAAAACTCCATCTCTACCAAAAAAAAAAAAAAAAAAATATATATATATATATATATATATATATATATTAGCTGGGTGTGATGGCATGTGTCTGTAGTCCCAGCTACTCGGGAGGCTGAGGCAGGAGAATCACTTGAACCTGGGAGGCAGAAGTTGCAGTGAGCTGAGATCGCACCATTGCACTCCTGTCTGGGCAACAAAAAGCGAAACTCCATCTCAAAAAAAAAGAAAAAAAAAA","GGCTGGGTGCGGTGCCTCACACCTGTAATCCCAGCACTTTGGGAGGCCGAGGTGGGTGGATCACGAGGTCAAGAGATCAAGACCATCCTGGTCAACATGGTGAAACCCTGTCTCTACTAAAAAAAAAAAAAAAAAAAAAAAAAAAAAAAAAAAAATTAGCTGGGCATGGTGGCGTGTGCCTGTAATCCCAGCTACTCAGGAGGCTGAGGCAGGAGAATTGCCTGAACCCAGGAGGCGGAGGTTGCGGTGAGCCGAGACTGTACCATTGCACTCCAGCCTGGGTAACAAGAGCGAAACTCCATCTCAAAAAAAAAAAAAAAAAA"
"chr6","69701903","69702225","JH378247","2315434","2315746","92","67386469","GGAAGCTGAAGCGGGCAGATCACTTGAGGTCAGGAGTTAAGAGACCAGTGTGGCCAATATGGTGAAACCCCGTCTCTACTAAAAAACACACAACACACACACACCACACCACAACACACACACACCACACACACACACCACACACACACAAATTAGGTGGGCATGGTGGCAGGTGCTTGTAATCCCAGCTACTTGGGAGGCTGAGAGAGGAGATTTGCTTGAACACAGGAGGCAGAGGTTGCAGTGAGCCAAGATCACACCATAGCACTCCAGCCTAGACAACAAGAGTGAGACTCTGTCTCAAAAAAGAAAAGAAAAGAAAA","GCACTTTGGGAGGCCAAGACAGATGGATCATTTGAGGTCAGGAGTTCAAGACCACCCTGGCCAGCATAGTGAAACTCCATCTCTACTAAAAATACCAAAAAAAAAAAAAAAAAAAAAAACAAACAAACAAACAAAAAAATTATCCAGGCATGGTAGCACATGCCTGTAATCCCAGCTACTCAGGAGGCTGAAGCAGGAGAATTGCTTCAACCTGGGAGGTGGAAGTTTCAGTGAGCCAAGATCACACCATTGCACTCCAGCCTGGGTGACAAGAGCGAAATTCCATCTCTAAATAAGTAAAATAAAATAAAGA"
"chr6","70808423","70809044","JH378118","18053084","18053501","270","52755339","GGCCAGGCACGGTGGCTCACGCTTGTAATCCCAGCACTTTGGGAGGTCTAGGCGGGTGGATCACTTGGGGTTAGGAGTTCGAGACCAGCCTGGCCAACACGACTAAACCCTATCTCTACTAAAAATAATAATAGGCTGGGCGCGGTGGCTCACGCTTATAATCCCAGCACGTTGGGAGGCCGAGGTGGGCGGATCACGAGGTCAGGAGATGGAGACCACGGTGAAACCCCATCTCTACTAAAAATATAAAAAATTAGCCGGGCGTGGTGGCGGGCGCCTGTAATCCCAGCTACTCGGAGAGGCTGAGGCAGGAGAATGGCGTGAACCCGGGAGGCGGAGCTTGCAGTGAGCTGAGATCACGCCACTACACTCCAGTACTCCAGCCTGGGTGACAGAGCGAGACTCCGTCTCAAAAAAAAAAAAAAAAAATAATAATAATAATTATAAAATTTAGCTAGGCGTGGTGGCGGGCGCCTGTAATCCCAGCTCCTTCGGAGGCTGAGGCAGGAGAATTGCTTGAACCCGGGAGGTGGAGGTTGCAGTGGGCCAAGATTGCACCATTGCACTCCAGCCTGGACAACAAGAGTGAAACTCCATTTCAAAAAGAAGAAAAAATCAAAAA","GGCTGGGCGCAGTGGCTCACACCTGTAATCCCAGCACTTAGGGAAGCTGAGGCGAGTAGATCACCTGAGGTCAGGAGTTAGAGACCAGCCTGGCCATCATGGTGAAACCCCGTCTCTACTAAAGATACCAAAAATTAGCTGAGTGTGGTGCTGGGTGCCTGTAATCCCAGAAACTCAGGGTGCCTGTAATCCCAGCAACTCAGGGTGCCTTTAATCCCAGCAACTGAGGGTACCAGTAATCCCAGCAACTCAGGGTGTCTTTAATCCTAGCAACTGAGGGCACCTGTAATCCCAGCAACTCAGGAAGCTGAGACAGGAGAAGTACTTGAACCCAGAAGGCAGAGGTTGCAGTGAGCCGATATTGCACCATTGCACTCCAGTCTGGGCAACAAGAGTGAAACTCTGTCTCAAAAAAAAA"
"chr6","70904514","70905138","JH378118","18053084","18053501","281","52851430","GGCCCGGCATGGTGGCTCACGCCTATAATCCCAGCATTTTGGGAGGCTGAAGGTGGATCACCTGAGGTCAAGAGTTTGAGACCAGTTGGGTGCGGTGGCTCAGTTGGGTGTGGTGGCTCACACTTTGGGAGGCCGAGGCGGGAGGATCACCTGAGGTTGGGAGTTCGTGACTAGCCTGACCAACATTGAGAAACCCCATTTACTAAAAATACAAAATTAGCTGGGTGTGGTGGCACATGCCTGTAATCCCAGCTACTCAAGAGGCTGAGGCGGGAGAATTGCTTGAACCCGGGAGGTGGACGTTGCAGTGAGCTGAGATCGCGCTGTTGTACTCCAGCCTGGGCAACAAGAGTGAAATGCCATCTCAAAAAAAAAAAAAAAAGAGAGTTCAAGACCAGCCTGATCAACATGGTGAAACCCTGTCTCTACTAAAAATACAAAAACAAATTAGCTGGGCATGGCGGTGGGCACCTGTAATCCCAACTACTAGGGAGGCCGAGGCAGGAGAATTGCTTGAACCCAGGGGGCGGAGGCTGCAGTGAGCTGAGATCGTGCCATTGCACCACGGGCTGGGCAACAAGACTGAATCTCCATCTCAAAAAGCAAAACAAAACAAAACAAAAAA","GGCTGGGCGCAGTGGCTCACACCTGTAATCCCAGCACTTAGGGAAGCTGAGGCGAGTAGATCACCTGAGGTCAGGAGTTAGAGACCAGCCTGGCCATCATGGTGAAACCCCGTCTCTACTAAAGATACCAAAAATTAGCTGAGTGTGGTGCTGGGTGCCTGTAATCCCAGAAACTCAGGGTGCCTGTAATCCCAGCAACTCAGGGTGCCTTTAATCCCAGCAACTGAGGGTACCAGTAATCCCAGCAACTCAGGGTGTCTTTAATCCTAGCAACTGAGGGCACCTGTAATCCCAGCAACTCAGGAAGCTGAGACAGGAGAAGTACTTGAACCCAGAAGGCAGAGGTTGCAGTGAGCCGATATTGCACCATTGCACTCCAGTCTGGGCAACAAGAGTGAAACTCTGTCTCAAAAAAAAA"
"chr6","71755278","71755641","JH378140","2655674","2656004","78","69099604","GGCCAGGAGCAGTGACTCACACCTGTAATCCCAGGACTTTGGGAGGCCGAGGCAGGTGGATCACCTGAGGTCCGGAGTTGGAGACCAGCCTGGCCAACATGATGATGAAACCCCATCTCCATTAAAAAAAAAAATATATATATATATATATACATATATATATATATATATGTATATATATAAACCAGGTGTGGTGGTGGGTGCCTGTAATGCCAGCTATTTGGGAGGCTAAGGCAGGAGAATAGTTTGAACCTGGGAGGCAGAGGTTGCAGTGAGCTGAAATTGCACCACTGACTGCACTCCAGCCTGGGTAACAAGAGTGAAACTCCATCTTAAAAAAAAAAAAAAAAAAAGAAAAAAGAAA","GGCCAGGAGCAGTGGCTCACTCCTGTAATCCTAGAACTTTGGGAAGCCAATGCAGGTGGATCGCCTGAGGTCAGGAGTTCAAGACCAGCCTGGCCAACATAGTGAAACCCTGTCTCTACTAAAAATACAAAAAAAAAAAAAAAAAAGAAAGAAAATTAGCCGGGCCTGGTGGTGGGTGCTTGTAATCTCAGCTACCTCAGAGGCTGAGGCAGGAGAATCACTTGAACCTGGGAGGCAGAGGTTGCAGTGAGTCGAGATCATGCCATTGCACTCCATCCCGGGCAACAAGAGTGAAACTCCATCTAAAAAAAAAAAAAAGAAAAAAAAGAAA"
"chr6","75711170","75711809","JH378118","18053084","18053501","280","57658086","GCCAGGCGCGGTAGCTCATACCTGTAATCCCAGAACTTTGGGAAGCTGAGGTGGGTGGATCTACCTGAGGTCAGCAGTTCGAGACCAGCCTGGCCAACATGGTGAAACTCCATCCCTACTAAATATACAAAAAATTAAGGCCGGGTGCAGTGGCTCACACTTGTAATCCCAGCACTTTGGGAGGCCGATGTGGGTGGATCACAAGGTTAGGAGATCGAGAACATCCTGGCAAACACGGTGAAACCCCGTCTCTACTAAAAATACCAAAAAAAAAGTTAGCTGGGTGTGGTGGTGTGTGCCTGTAGTCCCAGCTACTCGGGAGTCTGAGGCAGGAGAATGGCATGAACCTGGGAGTTGGAGCTTGCAGTGAGCCGAGAGACAGCACCGCACTCCAGCCTGGGCGACAGAGCGAGACTCTGTCTCAAAAAAAAAAAAAAAAAAAAAAAAAAAAAAAAAAAAATTAGGCAGGCATTGTGGCAGGTGCCTGTAATCCCAGCTACTGAGGAGGCTGAGGCAGGAGAATTGCTTGAACCCAGGAGGTGGAGGTTGCAGTGAGCCTAGATTGTGCCATTGTCCTCCAGCCTGGGCAACAAGAATGAAACTCCATCTCAAAATTAAAAGACAAAACAAAACAAACAAA","GGCTGGGCGCAGTGGCTCACACCTGTAATCCCAGCACTTAGGGAAGCTGAGGCGAGTAGATCACCTGAGGTCAGGAGTTAGAGACCAGCCTGGCCATCATGGTGAAACCCCGTCTCTACTAAAGATACCAAAAATTAGCTGAGTGTGGTGCTGGGTGCCTGTAATCCCAGAAACTCAGGGTGCCTGTAATCCCAGCAACTCAGGGTGCCTTTAATCCCAGCAACTGAGGGTACCAGTAATCCCAGCAACTCAGGGTGTCTTTAATCCTAGCAACTGAGGGCACCTGTAATCCCAGCAACTCAGGAAGCTGAGACAGGAGAAGTACTTGAACCCAGAAGGCAGAGGTTGCAGTGAGCCGATATTGCACCATTGCACTCCAGTCTGGGCAACAAGAGTGAAACTCTGTCTCAAAAAAAAA"
"chr6","90473109","90473437","JH378105","48662676","48662994","48","41810433","GGCCAGCACAATGGCTCACACCTGAAATCCCAGCACTTTGGGAGGCTGAGGCGGATGGATCATCTGAAGTCAGGAGTACAAGAACAGCCTGGCCAACATGGTGAAACCCCATCTCTACAAAAATACAAAACTTAGCTGGACACGGTGGCGGGTGCCTGTAATCCCAGCTACTTGGGAGGCTGAGGCAGGAGAATTGCTTGAAACCGGGGGGTGGAGGTTTCAGTGAGCCTAGATGGTGCCATTGCACTCCCGCCTGGGTGACAAGAGTAAAACTCCATCTCAATAAATAATAAATAAATAAATAAATAAATAAATATTAAAAAAAAAAA","GGCCCAGCACGGTGGCTCACACCTGTAATCCAAGCACTTTGGGAGGCTGAGGCGGGTGGATCATGAAGTCAGGAGTTCAAGACCAACTTGGCCAACATGGTGAAACCTCATCTCTACTAAAAATACAAAAATTCAGCTGGGCATGGTGGCACGTGCCTGTAATCCCAGCTACTCAGGAGGCTGAGGCAGGAGAATTGCCTGAACCCAGGAGGTGGAGGTTGCGGTGAGCCGAGATCGCGCCATTGCACTCCAGCCTGGGTAACAAGAGTGAAACTCCGTCTCAAATAAATAAATAAATAAATAAATAAATAAATAAATA"
"chr6","92286266","92286522","JH378112","8038111","8038336","83","84248155","CACCTGAGGTCAGGAGTTTGAGACCAGCCCGGACAATATGATAAAACCCCGTCTCTACTAAAAAACAAAACAAAACAAAACAAAACAAAACAAACAAACAAACAAATAAAAATTAGCCGGGCATGGTGGTGAGTGCCTGCCATCCCAGCTTCTCCTGAGGCTGAGGCTGGGGAATCACTTGAACCCCGGAGGCAAAGGTTGCAGTGATCATGCCATTGCACTCCAGCCTGGGCAACAAGAGTGAAACTCTGTCTCAA","TGAGATCAGAAGTTTGAGATCAGCCTGGCAAACACGGTGAAATCTCATCTCTGCTAAAAATACCATTTTAAAAAATTAAGCAGACATGGTGGTGGGTGCCTGTAATCCCAGATACTCTGGAGGTTGAGGCTGGAGAATCACTTGAACCCAGGAAGCAGAGGTTGCAGTGAGACAAGATTGCACTATTGCACTCCAGCCTGGGAAACAAGAATGAAACTCTGTCTTA"
"chr6","95989274","95989614","JH378115","22661982","22662308","69","73327292","GGGCACAGTGGCTCACACCTGTAATTCCAGTACTTTCAGAGGCCGAGACGGGCTGATCACCTGAGGTCAGGAGATCGAGACCAGCAGGGCCACCATGGCGAAATCCCATCTCTACTAAAAATGCAAAAAATCAGCTGGGCATGGTGGCAGGTATCTGTAATCCTAGCGACTCAGGGGACTGAGGCAGGAGAATCATTTGAACCTGGGTTGCAGAGGCTGCAGTGAGCTGAGATTGCACCATTGCACTCCAGCCTGGGCAACAAGAGTGAAACTCTGTCTCACACACACACACACACACACACACACACACAAAAAAAAAAAAAAAAAAAAAAAAAAAAAAA","TGTCTCATGACTGTAATTCCAGCACTCTGGGAGGCCGAGGAGGGTGGATCACCTGAGTTCAGGAGTTCCAAACCAGCCTGGCCAACATGGTGAAACTCCATCTTTACTAAAAATACAAAAAATTAGCTGGGCATGGTGGCACGTGTCTGTAATCCCCGCTACTCAGGAGGCTGAGGCAGGAGAATCACCTGAACCTGGGAGGTGGAGGTTGCAGTGAGCTGAGATCTCGCCATTGCACTCCAGCCTGGGCAACAAGAGCGAGACTCTGTCTCAAAACAAAACAAAACAAAACAAAACAAAACAAAAAAAGCAACAACAACAACAAAA"
"chr6","102721692","102721988","JH378378","75116","75408","44","102646576","GGCCGGGCGCAGTGGCTCACGCCTTTAATCCCAGCACTTTGGGAGGCCGAGGCAGGCGGATCACCTGAGAGCAGGAGTTCTAGATGAGCCTGGCTAACATGGTGAAACCTCATTTCCACTAAAAAAAAAAAAAAAAAAAAAAAAAAATTAGCTGGGCGTGGTGGCACGCGCTTGTAATCCCAGCTACTTGGGAGGCTGAGGCTGGAGAATCGTTTGAACCCGGGAGGCAGAGGTTGCAGTGAGCCGAGATCTTGCCATTGCACTCCATCTTGGGCAACAAGAGCGAAACTCCGTCTC","GGCCGGGTGCAGTGGCTCACGCCTGTAATCCCAGCACTTTGGGAGGCCAAGGCGGGTGGATCATGAGGTCAAGAGATCGAGACCATCCTGGTCAACATGGTGAAACTCTGTCTCTACTAAAAATAAAAAAAAAAAAAAAAAAGATTAGCTGGGCATGGTGGCGCGTGCCTGTAATCCCAGCTACTCAGGAGGCTGAGGCAGGAGAATTGCCTGAACCCAGGAGGCGGAGGTTGCGGTGAGCCGAGATCGCGCCATTGCACTCCAGCCTGGGTAACAAGAGCGAAACTCCGTCT"
"chr6","113206114","113206442","JH378153","10517405","10517727","56","102688709","GGCCGGGCGTGGTGGTTCATGCCTGTAATCACAGCACTTTGGGAGGCCGAGGTGGGCGGATCACCTGAGGTCAGGAGTTAGAGACAAGCCTGGCCAACGTGGCAAAACCCTGTCTCTAAAATAAATAAATAAATAAATAAATAAATAAATAAAAAATTAGTCAGGCGTGTTGGTGGGCACCTGTAATCCCAACTACTCCGGAGGCTGAGACAAAAGAATCTCTTGAATCCAGGAGGCGGAAGTTGCAGTGAGCCGAGATCGCGCCATTGCACTTCAGTCTGGGGAACAAGAGTGAAACTCCCTCAAAAAAAAAAAAAAAAAAAAAAGAA","GGCCGGGCGTGGTGGCTCACGCCTGTAATCCCAGCACTTTGGGAGGCCGAGGTGGGTGGATCATGAGGTCAAGAGATCGAGACCATCCTGGTCAACATGGTGAAACCCTGTCTCTACTAAAAAAAAAAAAAAAAAAAAAAAATACAAAAAAATTAGCTGGGCATGGTGGCGCATGCCTGTAATCCCAGCTACTCCGGAGGTTGAGGTAGGAGAATTGCCTGAACCCAGGAGGCGGAGGTTGCGGTGAGCCGAGATCGCGCCATTGCACTCCAGCCTGGGTAACAAGAGCAAAACTCCGTCTCAAAAAAAAAAAAAAAAAAGAA"
"chr6","122782236","122782562","JH378105","22605583","22605892","68","100176653","GGCCAGGTGCAGTGGCTCATGCCAGTAATCCCAGGCCTTTGGGAGGCTGAGGCAGGTGAATCATATGAGGTCAGGAGTTTAAGACCAGCCTGACCAAAATAGTGAAATCTCTACTAAAAACACACACACACACACACACACACACACACACAAATTAGCCAGGAGTGGTGGTGGGCACCCGTGATCCCAGCTACTCCAGAGGCTGAGGCAGGAGAATTGCTTGAACCCAACAGGCAGAGGTTGCAGTGAGCAGAGATCCCACCATTGCACTCCAGCCTGGGTAACAAGAGTGAAACTCTTATCTCAAAACATAAAAAAAGAGAAAAA","GGCTAGGTGTGGCGGCTCACGCCTGTAATCTCAGCACTTTGGGTGGCGATGCGGGTGAATCACCTGAGGTCAGGAGTTTGAGACCAGCCTGGCCAACGTGGTGAAACGCTGTCTCTACCAAAAACACACACACAAAAAAAAAAATTAGGCAGGCGTGGTGGCGGGCATTGTAATCCCAGCTACTTGGGAGGCTGAGTCAGGAGAATTGCTTGAACCCAGGAGGCAGAGGTTGCAGTGAACCAAGATTGCAACATTGCACTCCAGCCTGTGCAACAAGAGTGAAACACCACCTCAAAAAAAAAAAAAAAAA"
"chr6","131270742","131271346","JH378118","18053084","18053501","250","113217658","GGCTGGTCGTGGTGGCTCACGCCTGTTATCCCAGCACTTTGGGAGGCCAAGGTGAGCAGATCACCTGAGGTTAGGAGATCGAGGCCAGCCTGCCCAACATAGCAAAAACCTGTCTCTACTAAAAATACAAAAATTCAGCTAGGCGCGGTGACTCACGCCTGTAATCCCAGCACTTCCGGAGGCGGAGGCAGGCAGATCATGAGGTCAGGAGATGGAGATCATCCTGGCTAACACGGTGAAACCCCGTCTCTACTAAAACAATACAAAAAAAAAAATTAACTGGGCGTGGTGGCGGGCACCTGTAGTCCCAGCTACTTGGGAGGCTGAGGCAGGAGAATGGCGTGAACTCAGGAGGCGGAGCTTGTAGTGAGCCGAGATCGCGCCACTGCACTCCAGCCTGGGCGAGAGTGTGAGACTCCATCTCAAAAAAAAAAAAAAATTACCCGGACGTGGTGGTAGGCACCTGTAATCCCAGCTACTCGGGAGGCTGAGGCAGGACAATCAATTGAACCCGGGAGGCAGAGGTTGCAGTGAGCCAAGATCACAACATTGCACTCCAGCCTGGGCAACAAGAGCGAAACCCTATCTCAAAAGAAAAAAAAAAA","GGCTGGGCGCAGTGGCTCACACCTGTAATCCCAGCACTTAGGGAAGCTGAGGCGAGTAGATCACCTGAGGTCAGGAGTTAGAGACCAGCCTGGCCATCATGGTGAAACCCCGTCTCTACTAAAGATACCAAAAATTAGCTGAGTGTGGTGCTGGGTGCCTGTAATCCCAGAAACTCAGGGTGCCTGTAATCCCAGCAACTCAGGGTGCCTTTAATCCCAGCAACTGAGGGTACCAGTAATCCCAGCAACTCAGGGTGTCTTTAATCCTAGCAACTGAGGGCACCTGTAATCCCAGCAACTCAGGAAGCTGAGACAGGAGAAGTACTTGAACCCAGAAGGCAGAGGTTGCAGTGAGCCGATATTGCACCATTGCACTCCAGTCTGGGCAACAAGAGTGAAACTCTGTCTCAAAAAAAAA"
"chr6","138220267","138220608","JH378137","944902","945240","62","137275365","GGCTGGGCATGGTGGCTCATGCCTGTAATCCCAGCACTTTGGGAGGCCAAGGCAAGTGGGTCACTTGAGGTCAGGAGTTCGAAGCCAGCCTGGCCAACATGGTGAAACCCCATCTTCACTAAAAAAAAAAAAAAAAAAAAAAAAAAAAAAAAAAAAAAAAAAAAAATTAGCTGGGCATGGTGGCAGGTGCCTATAATCCCAGCCACTAGGGAGGCTGAGGAGGGAGAATCTCTTGAACCCAGGAGTGGAAATCACACCATTTGAGCCAAGATCACACCATTGCACTCCAAACTGGGCAACAAGAGCGAAAATCTGTCTCAAAAAATAAATAAATAAATAAAA","GCTGGGCACAGTGGCTCATGCCATAATCCCAGCACTTTGGGAGGCCAAGGCAGGTTGATCGCCTGGGGTCAGGATTCGAGACCGGCCTGGCCAACATGGAGAAACCCCGTCTCTAGTTAAAAAAAAAAAAAAAAAAAAAAAAAAAAAAAAAAAAAAAACGAAAATTAGCCGGGCATGGTGGCAGATGCCTGTAATCCCAGCTACTCAGAAGGCTGAGACAGGAGAATCGCTTGAACCCAGGAGGCAGAGGTTGCAGTGAGCTAAGATTGCACCATTGCACTCCAGCCTGGGCAACAAGAGCAAAACTCCATCTAAAAATTATTAAATAAAAATGAAAAA"
"chr6","143136854","143137196","JH378109","21565230","21565567","48","121571624","GGCCAAGCGTGGTGACTCATGCCTGTAATCCCAGCACTTTGGGAGGCTGAGGCAGGTGGATCACCTGAGGTCAGGAGTTCGAGACCAGCCTGGCCAACATGGTGAAACCCGGTCTCTACTAAAAAATACAAAAATTAGCCGGACATGGTGGCAGGCGCCTGTAATCCCAGCTACTGGGGAGGCTGAGGCAGGAGAATCACTTGAACGCGGGAGGCAGAGGTTGCAGTGAGCCGAGATTGCACCATTGCACTCCAGCCTGGGTGACAAGAGTGAAACTCGGTCTCAAAATAAATAAATAAATAAATAAATAAATAAATACATGAAAAATAAAAGACAAAAAAAA","GGCCGGGCGCGGTGGCTCAAGCCTGTAATACCAGCACTTTGGGAGGCCGAGGCGGGTGGATCACGAGGTCAAGAGATCGAGACCATCCTGGTCAACATGGTGAAACCCCGTCTCTACTAAAAATACAAACAATTAGCTGGGCATGGTGGCGGGTGCCTGTAATCCCAGCTACTCCAGAGGCTGAGGCAGGAGAATTGCCTGAACCCAGGAGACGGAGGTTGCGGTGAGCCAAGATCGCGCCATTGCACTCCAGCCTGGGTGACAAGAGCGAAACTCCGTCTCAATAAATAAATAAATAAATAAATAAATAAAAATAAAATAAATAAATAAATAAATAA"
"chr6","148087141","148087756","JH378118","18053084","18053501","265","130034057","GGCCGGGCGCGGTGGCTCATGCCTGTAATCCCAGCACTTTGGGAGGCCAAGGCGGAAGGATCGCCCAAGGTTGGGAGTTCCAGACCAGCCTGGCCAGCATGGTGAAACCCTGTCTCTACTACTAATACAAAAATTAGCCGGGCATTGACTGGGCGTGGTGGCTCATGCCTGTAATCCCAGCACTTTGCGAGGCCAAGGCAGGCAGATTGCCTGAGCTCAGGAGTTCGAAACCAGCCTGGGCAACATAGTGAAACCCTGTTTCTACTAAAATTACAAAAAATTAGCTGGATGCGATGGCGGGTGCCTGTAATCCCAGCTACTTGGGAGCCTGAGGCAGGAGAATCGCTTGAACCCAGGAGGCGGAGGTTGCAGTGAGCCGAGATCGTGCCACTGCACTCCAGCCTGGATAACAGAGCGAGATTCTCTCTCAAAAAAAAAAAAAAAAAAATTAGCCAGGCATGGGTGGCAGGCACCTATAATCCCAGCTACTTGGGAAGCTGAGGCAGGCGAATCGCTTGAACCCGGGAGGTGGAGGTTGCAGTGAGCCCGAGATCATGCCATTGCACTCCAGCCTGGGCAACAGAAACTCCATCTCAAAAAAAAAAAAAAGGGAAAA","GGCTGGGCGCAGTGGCTCACACCTGTAATCCCAGCACTTAGGGAAGCTGAGGCGAGTAGATCACCTGAGGTCAGGAGTTAGAGACCAGCCTGGCCATCATGGTGAAACCCCGTCTCTACTAAAGATACCAAAAATTAGCTGAGTGTGGTGCTGGGTGCCTGTAATCCCAGAAACTCAGGGTGCCTGTAATCCCAGCAACTCAGGGTGCCTTTAATCCCAGCAACTGAGGGTACCAGTAATCCCAGCAACTCAGGGTGTCTTTAATCCTAGCAACTGAGGGCACCTGTAATCCCAGCAACTCAGGAAGCTGAGACAGGAGAAGTACTTGAACCCAGAAGGCAGAGGTTGCAGTGAGCCGATATTGCACCATTGCACTCCAGTCTGGGCAACAAGAGTGAAACTCTGTCTCAAAAAAAAA"
"chr6","148347354","148347964","JH378118","18053084","18053501","256","130294270","GGCCAGGCGCAGTGGCTCACGCCTATAATCCCAGCATTTTGGGAGGCAAAGGCGAGTGGATCACCTGAGGTCAGGAGTTCAAAACCAGCCTGGCCAACAATGTGAAACCCTGTCTCTACTAAAAATACAAAAAGTTAAGGCCAGGCGGGGTGGCTCACGCCTGTAATCCCAGCACTTTGGGAGGCCGAGGTGGGCGGATCACAAGGTCAGGAGATCGAGACCATCCTGGCTAACATGGTGAAACCCCGTCTCTACTAAAAAATACAAAAAACTAGCCGGGCATGGTGGCGGGCACCTGTAGTCCCAGCTACTCGGGAGGCTGAGGCAGGAGAATGGCGTGAACCTGGGAGGCGGAGCTTGCAGTGAGCCGAGATGGCGCCACTGCACTCCAGCCTGAGCCACAGGCGAGAGTCCGTCTCAAAAAAAAAAAAAAAAAAAAAAGTTAGCCAGGCGTGGTGGCGGGTGCCTGTAATCCCAGCTACTAGGGAGGCTGAGGCAAGAGAACTGCTTGAACCTAGGAGGTGGAGGTTGCAGTGAGCAGAGATGACAACATTGCACTCCAGCCTGGGCACAAGAGCGAAACTCCGTCTCAAAAAAAAAAAAAAAAAAAA","GGCTGGGCGCAGTGGCTCACACCTGTAATCCCAGCACTTAGGGAAGCTGAGGCGAGTAGATCACCTGAGGTCAGGAGTTAGAGACCAGCCTGGCCATCATGGTGAAACCCCGTCTCTACTAAAGATACCAAAAATTAGCTGAGTGTGGTGCTGGGTGCCTGTAATCCCAGAAACTCAGGGTGCCTGTAATCCCAGCAACTCAGGGTGCCTTTAATCCCAGCAACTGAGGGTACCAGTAATCCCAGCAACTCAGGGTGTCTTTAATCCTAGCAACTGAGGGCACCTGTAATCCCAGCAACTCAGGAAGCTGAGACAGGAGAAGTACTTGAACCCAGAAGGCAGAGGTTGCAGTGAGCCGATATTGCACCATTGCACTCCAGTCTGGGCAACAAGAGTGAAACTCTGTCTCAAAAAAAAA"
"chr6","149601697","149601954","JH378172","12296021","12296264","64","137305676","GCCGGGCGCGGTGGCTCATGCCTGTAATCCCAGGACTTTGGGAGGCTGAGGCAGGTAGATCAGCTGAGGAGTTCAAGACCAGTGGTGGTGGACGCCTGTAATCCCCACCACTCGGGAGGCTGAGGCAAGAGAATCGCTTGAACTTGGGAGGCAGAGGTTGCAGTGATCTGAGATTGCACCATTGCACTCCAGCCTGGGTGATAAGAACGAAACTCCGTCTCAACAACAACAACAACAACAACAACAAAAAAAAAAAAA","GGCCAGGTGCTGTGGCTCACGCCTGTATTCCCAGCACTTTGGGAAGCTGAGGCGGGTGGATCACCTGAGGTCAGGAGTTCAAGACCAGCCTGGCGCATGGCTGTAATCCCAGCTACTCGGGAGGCTGAGGCAGGAAAATTGCTTGCACCTGTGAGGCAGAAGTTGCAGTGAGCCAAGATCACACCATTGCCTGGGTGACAAGGGCAAAACTCTGTCTCAAAAAAAAAAAAAAAAAAAAGGAAAA"
"chr6","156143780","156144103","JH378114","21211700","21212024","61","134932080","GGCCGGGCGTGGTGGCTCATGCTTGTAATCCCAGCCCCTTTGGAAGGCCAAGGTGGGTGGATCACCTGATGTCGGGAGTTCGAGAGCAGCCTGGCCAACATGGTGAAACTCCATCTCTACTAAAAATACAATAATAATAATAATAAATAAATAAATAAATAAATAAAATTAGCCAGATGTGGTGGCATGCGCCTATAGTTCCAGCTACTTGGGAGGCTGAGGCAGGAGAATCGCTTGTACTTGGGAGGTGGAGATTGCAGTGAGCCGAGATCGCACCATTGCACTCCAGCCTGGGTGACAAGAGTGAAACTCCATCTAAAAAAA","GGCTGGGTGCGGTGGCTCAGGCCTGTAATCCCAGCACTTTGGGAGGCCGAGGTGGGTACATCACCTAAGGTCAGGAGTTCAAGACCAGCCTGACCAACATGGTAAAACCCTGTCTCTACTAAAATTACAAAAGAAAATTAGAAAAAAAAAAAAGAAAGAAAGAAAATTAGATGGCATGGTGGTGGCGGGCACCTGTAATTTCAACTACTCGGGAGGCTAAGGCAGGAGAATCACTTGAACCCAGGAGGTGGAGGTTGCAGTGAGCCGAGATCACACCATTGCACTGCAGCCTGGGCAATAAGAGCAAAACTCCATCTCAAAAAAA"
"chr6","159698084","159698393","JH378112","14248985","14249277","61","145449099","GGCTTGGCAAGGTGGATAACGCCTGTAATCCTAGCACTTTGGGAGGCCGAAACAGGTGGATCACCTGAGGTCAGGAGTTTGAGACCAGCCTGACTGACGTGGTGAAACCCCATCTCTACTAAAAATAAAATAATAATAATAATAATAATAATTAGCCATGGTGATGTGCATCTGTAATTCAAGCTACTTGGGAGGCTGAGGCAGAAGAATCACTTGAACTAGGGAGGGGGAGGTTGCAGTGAGCCAAGTGCACCTTTGCACTCCAGCCTGGGTGACAAGAGGGAAAATCCATCACACACACGAAAGAAAA","GGCCGGGCACAGTGGCTCATGCCCATAATCCCAGCACTTTGGGAGACCGAGGCAGGTGGATCACCTGAGGTCAGGAGTTTGAGACCAGACTGACAAACATGGTGAAGCCCCATCTCTACTAAAAATACAAAAAAAATTAGCTAGACATGGTTGCATGTGCCTGTAATCTCAGCTACTTGGGAGGCTGAGGCATGAGAATCACTTGAACTTGGGAGGCGGAGGTTGCAGTGAGCAGAGAGTACACCATTGCACTCCAGCCTGGTGACAAGAGCGAATATTCATCTTAAAAAAAA"
"chr6","160000284","160000577","JH378116","24318103","24318369","53","135682181","GTCTATCACCCCAGCACTTTGGGAGGCCGAGGCGGGTGGATCACCTGAGGTCAGGAATTTGAGACCAGCCTGGCCAACATGATGAAACCTTGTCTCTACTAAAAATACAAAAAAAAAAAAAAAAAAAAAAAAAAAAATTAGCTGGGTGTGGTGGCAGGCGCCTGTAATCCCAGCTACTCGGGAGGCTGAGGCAGGAGAATCGCTTGAACCCGGGAGGCAGAGGTTGCAGTGAGCTGAGATTGTGCCATTGTACTCCAGCCTGGGCAACAAGAGTGAAACTTCGTCTCAAAAAAA","CTGTAATCCCAGTACTTTGGGAGGCCAAGGCAGGTGGATCACTTGAGGTCAGGAGTTCAAGACCAGCCTGGCCAACATGGTGAAACCTTGTCTCTACTAAAAATACAAAAATTAGCCGGGGGTGGTGGCAGGCGCCTGTAATCCCAGCTACTAGGGAGGCTGAGGCAGGAGAATCACTTGAACCAGGGAGGCAGAGATTGCAGTGAGCTGAGATCACACCATTGCACTCCGGCCTGGGCAACAACAGTGAAACTCCATCTCAAAAAA"
"chr6","161873870","161874460","JH378119","32351107","32351490","253","129522763","GGCCGGGCACAGTGGCTCATGCTTGTAAACTCAGCACTTTGGGAGGCTGTGGCAGGCGGATCACCTAAGGTTAGGCGTTCCAGACCAGCCTGGCCAACATGGCGGAACCCTGTCTCTACTAAAAATACAAAAATTAGGCCGGGCATGGTGGCTCATGCCTATAATCTCAGCACGTTGGGAGGCCAAGGCAGGCAGATCACGAGATCAGGAGATTGAGACCAGCCTGGCCAACATGGTGAAACTCTGTCTCTACTAAAAATACAAAAATTAGCCAGGCGTGGTGGCAGGCACCTGTAATCCAGCTACTTGGGAGGCTGAGGCAGGAGAATCACTTGAACTTGAGAGGCGGAAGTTGCAGTGAGCCAAGATCGTGCCACTGCACTCCAGCCTGGGTGACAGAGTGAGACTCCATGTCAAAAAATAATAATAATACAAAAATGAGCCAGGCATGGTGGTGTGTGCCTGTAATCCTACCTACTTGGGAGGCTAAGGCAGGAGAATCACTTAAACCCGGGAGGTGGAGGTGAGTCGAGATCATGCCATTGCACTCCAGCCTGGGTGACAAGAGCAAGACTCCGTTTAAAAAAAAAA","GGCCAGGTATGGTGGCTCACACCTGTAATCCCAGCACTTTGGGAGGCCAAGGCAGGCAGACCACCTGAGGTCAGGAGTTCGAGATCAGCCTAGCCAACATGGTGAAACCCCATCTCTAGTAAAAATAAAATTAGCCAGGCATGGTGGTGCATGCCTGTAACGCAGGTCAGGAGTTCGAGATCAGCTTAGCCAACATGGTGAAACCCCATCTCTAGTAAAAATAAAATTAGCCAGGCAGGTGGTGCCGCCTGTACTCGGGAGGCTGAGGCAGGAGAATCACTTGAACCCAAGAGGCAGAGGTTGCAGTCAGCCAAGATCATGCCATTGCACTCCAGCCTAAGCAAAAAGAGTAAAACTCAGTCTCAAAACAAAAAAACAAAAAAA"
"chr6","165900346","165900849","JH378206","6546474","6546861","190","159353872","GGTCAGAAGTTCGAGACCAGCCTGGCCAACATGGTGGAACTCCATCTCTACTAAAATACAAAAGATTGGCCAGGTGCGGTGGCTCAAACCTGTAATCCAACTTTGGGAGGCTGAGGCGGGCGGATCATTTGAGACCAGCCTGGCCAACATAGTGAAACCCTGTCTCTACTAAAAATACAAAAATTAGCTGGGCATGGTGGTGTGCACCTGTAGTCCCAGCTACTCGGGAGGGCGAGGCAGGAGAATTGCTTGAACCCGGGAGGCGGAGGTTGTGGTGAGCCGAGATTGTGCCTCTGCACTCCACAGAGCGAGACTCTGTCTCAAAAAAAAAAAAAAAAAAAAAAAAATACAAGTAATTAGCTGGGCGTGGTACTCGGGAGGCTGAGGCAAGAGAATCGCTTGAACCCGGCAGTCGGAGGTTGCAGTAAGCCAAGATCTGGCCATTGCACTCTAACCTGGACAACAAGAATGAAACTCTGTCTCAAAAAAAAAAAAAAAAAAAAA","GGCCACACATGGTGGCTAACGCCTGTAATCCCAGCACTTTGGGAGGCCAAGTCGGGTGGATCATGAGGTCAGGAGACCAAGACCATCCTGGCCAAATGGTGAAACCCCGTCTCTACTAAAAATACAAAAATTAGCTGGGCATGGTGGCGTGTGCCTGTAATCCCAGCTACTCAGGAGGCTGAGGCAGGACAATTGCCTGAACCCAGGAGAATTAGCTGGGCATGGTGGCGTGTGCCTGTAATCCCAGCTACTCAGGAGGCTGAGGCAGGACAATTGCCTGAACCCAGGAGGCGAAGGTTGCGGTGAGCCGAGATTGTGCCATTGCACTCCAGCCTGGGTAACAAGAGCGACACTCTGTCTCAAAAAAAAAAAAAAAAAAAAAAAAAAA"
"chr6","166268223","166268555","JH378119","27762770","27763095","56","138505453","GGCCAGGTGCGGTGGCTCATTCCTGTAGTCCCAGCACTTTGGGAGGCTAAGGCAGGTGGATCACCTGAGGTCAGGGGTTTGAGACCAGCCTGACCGACATGGTGAAACCCTGTCTCTACTAAAAATACAAAACAAATTATCCAGGCATGGTGGTGCCCACCTGTAATCCCAGCTACTTGAGAGGCTGAGGCAGGAGAATCGCTTGAACCAGGGAGGCAGAGGTTGCAGTGAGCCAAGTGTGCCATTGCACTCCAGGCTGGGGGACAAGAGCGAAAATCCATCTCACAACAACAACAACAACAACAACAACAAAAAAAGAAAGAAAGAAAACAA","GACCAGGAGTGGTGGCTCACGCATGTAATCCCAGCACTTTGGGAGGCTGAGGCAGGTGGATCACCTGAGGTCAGGAGTTTGAGACCAGCCTGGCCAACGTGGTGAAACCCGGCCTCTACTAAAAATACAAAAATTAGCTGGGAGTGGTGGTATACACCTGTAGTCCCAGCTACTTGGGAGGCTGAGGCAGGACAATCGCTTGAACCAGGGAGGCAGAGGTTGCAATGAGCCAAGATTGCACCATTGCACTCCAGTCTGGGTGACAAGAGCAAAACTCTGTCTCGAAAACATAATAAACAAACAAACAAACAAACAAACAAACAAAC"
"chr7","39690","40033","JH378228","5665092","5665424","51","5625402","GGCCAGGAGCGGTAGCTCACGCCTGTAATCCCAGCACTTTGGGAGGCTGATGCGGGTCAATCACCTGAGGTCAGGAGTTCGAGACCAGCCTGGCCAACATGGTGAAAACTCCGTCTCTACTAAAAATACAACAATTAGCCGGGCATGGTGGCAGGTGCCTATAATCTCAGCTACTCGGGAGCCTGAGGCCGGAGAATTGTTTGAATCCAGGAAGCGGAAGTTGCAGTGAGCTGAGATTGCACCATTGCACTCCAGCCTGGGCAAAAAGAACAAAACTCTGTCCCAATAAATAAATAAATAAATAAATAAATAAATAAAATATATAAATTAAAAGTAAAATAAAA","GGCCGGGCGCGGTGGCTCAAGCCTGTAATCCCAGCACTTTGGGAGGCTGAGGCGGGTGGATCACGAGGTCAAGAGATCGAGACCATCCTGGTCAACATGGTGAAACCCTGTCTCTACTAAAAATACTAAAAATTAGCTGGGCATGGTGGCGTGTGCCTGTAATCCCAGCTACTCAGGAGGCTGAGGCAGGAGAATTGCCTGAACCCAGGAGGCGGAGGTTGCGGTGAGCCGAGATCGCGCCATTGCACTCCAGCCTGGGCAACAAGAGCGAAACTCTGTCTCAAAAAAAAAAAATAAATAAATAAAATAAAATAAAATAAAATAAAATAAAAT"
"chr7","230186","230773","JH378118","18053084","18053501","245","17822898","GGCCGGGTGCAGTAGCTCACGCCTGCAATCCCAGCACTTTGGGAGACCAAGGCGGGCAGATCATTGTAGGTCAGGAGTTCGAGACCAGCCTGGCCAACATGGTGAAACTCCGTCTGTACTAAAAATGCAATTTTTTTTGCTGTTATTGCCCAGGCTAGAGTGCAGTGGTGCAATCTCAGCTCACTGCAACCTCCGCCTTCCGGTTTCAAGCGATTCTCCTGCCTCAGCCAACCAAGTTGCTGGGATTACAGGTGCCCGCCACCACACCCAGCTAATTTTTTTGTACTTTTAATAGAGACGGGATTTTACCATGTTGGTCAGCCTGATCTCGAACTGCTGACCTCGTGATCCACCCGCCTCAGCCTCCCAAAGTGGGCGTGAGCCACCACGCCTGGCCCTTAAAAATACAAAAATTAGCCAAGCATGGTGGCACACGCCTATAATCCCAACTACTTGGGAGACTGAGGCAGGAGGATTGCTTGAACCTGGGAGGCGGAAGTTGCAGTGAGCCGAGATCTTGCCATTGCACTCCAGCCTGGGTGACAAAAGCAAAACTCTGTCTCAAAAAAAAATAAAAAATAAAAAAAA","GGCTGGGCGCAGTGGCTCACACCTGTAATCCCAGCACTTAGGGAAGCTGAGGCGAGTAGATCACCTGAGGTCAGGAGTTAGAGACCAGCCTGGCCATCATGGTGAAACCCCGTCTCTACTAAAGATACCAAAAATTAGCTGAGTGTGGTGCTGGGTGCCTGTAATCCCAGAAACTCAGGGTGCCTGTAATCCCAGCAACTCAGGGTGCCTTTAATCCCAGCAACTGAGGGTACCAGTAATCCCAGCAACTCAGGGTGTCTTTAATCCTAGCAACTGAGGGCACCTGTAATCCCAGCAACTCAGGAAGCTGAGACAGGAGAAGTACTTGAACCCAGAAGGCAGAGGTTGCAGTGAGCCGATATTGCACCATTGCACTCCAGTCTGGGCAACAAGAGTGAAACTCTGTCTCAAAAAAAAA"
"chr7","574686","575253","JH378206","6546474","6546861","227","5971788","GAGGTCAGGAGTTCCAGATCAGCCTGGCCAACATGCCATCTCTACTAAATGCCGTCTCTACTAAAAATAGAAAATTAGCCAGGTGTGGCCAGGCGTGGTGGCTCTCGTTTGTAATCCAGCACTTTGGGAGGCCGAGGCGGGCAGATCATGAGGTCAGAAGATCGAGACCACCCTGGCTAACATGGTGAAACCCCATCTCTACTAAAAATACAAAAAATTAGCCAGGCGTGGTGGTGGGCACCTGTAGTCCCAGCTACTCGGGAGGCTGAGGCAGGAGAATGGCGTGAACCTGGGAGGCGGAGCTTGCAGTGAGCCGAGATTGTGCTACTGCACTCCAGCCTGGGTGACAGAGCAAGACTCCGTCTCAAAAAATGAAAATTAGCCAGGCATGGTGGCGGGCACCTGTAATCCCAACTACTCAGGAGGCTGAGCCAGTAGCACTGCTTGAGCCTGGGAGATGGAGGCTGCAGTGAGCTGAGATCATGCCATTGCACTCCAGCCTGGGCAGCAAGGGTGAAACTCTGTCTCAAAAAGAGAAAAATAAAATGGTTCAGGGAAAAAAAAAAAA","GGCCACACATGGTGGCTAACGCCTGTAATCCCAGCACTTTGGGAGGCCAAGTCGGGTGGATCATGAGGTCAGGAGACCAAGACCATCCTGGCCAAATGGTGAAACCCCGTCTCTACTAAAAATACAAAAATTAGCTGGGCATGGTGGCGTGTGCCTGTAATCCCAGCTACTCAGGAGGCTGAGGCAGGACAATTGCCTGAACCCAGGAGAATTAGCTGGGCATGGTGGCGTGTGCCTGTAATCCCAGCTACTCAGGAGGCTGAGGCAGGACAATTGCCTGAACCCAGGAGGCGAAGGTTGCGGTGAGCCGAGATTGTGCCATTGCACTCCAGCCTGGGTAACAAGAGCGACACTCTGTCTCAAAAAAAAAAAAAAAAAAAAAAAAAAA"
"chr7","588143","588838","JH378118","18053084","18053501","348","17464941","GCTGGGTGCGGTGGCTAACACCTGTAATACCAGCACTTTGGGAGGATGAGGTGGGTGGATCACCTGAGGTCAGGAGACCAGCCTGGCCAACATGGTTAAACTTTGTCTCTACTAGACCAGGTGCAGTGGCTCACGCCTGTAATCCTAGCACTTTGGGAGGCTGAGGTGGGTGGATCACGAGGTCAAGAGATCGAGACCATCCTGGCTAACACAGTGAAACCCCATCTCTTCTAAAAATACAAAAAAAAAAAAAAAAAAAAAAAAAGCCAGGCACGGTGGCGGCACCTGTAGTCCCAGCTACTTGGGAGGCTGAGGCAGGAGAATGGTGTGAACCCGGGAGGCGGAGCTTGCAGTGAGCTGAGATAGAGATAGCGCCACTGCAGTCTGGCCTGGGTGAAAGAGCGAGACTCCATCCCCCCAATAAATAAATAAATAAATAAATAACCAAACTTTGTCTCTACTAAAAATACAAAAAAAAAAAAAAAAAAGGGAAACTTTGTCTCTATTAAAAATACAAAAAAATTAGCTGGGTGTGGTGGCACGTGCCTGTAATCTCAGCTAGTTGGGAGGCTGAGGCAGAATTGTTTGAACCTGGGAGGCAGAGGTTGGTTGCAGTGAGCTGAGATTACACCATTGCAGTCCAGCCCTGGGCAACAAGGGCAAAACTCTGTCTCGAAAGAAAAAAGTAAAATAAAA","GGCTGGGCGCAGTGGCTCACACCTGTAATCCCAGCACTTAGGGAAGCTGAGGCGAGTAGATCACCTGAGGTCAGGAGTTAGAGACCAGCCTGGCCATCATGGTGAAACCCCGTCTCTACTAAAGATACCAAAAATTAGCTGAGTGTGGTGCTGGGTGCCTGTAATCCCAGAAACTCAGGGTGCCTGTAATCCCAGCAACTCAGGGTGCCTTTAATCCCAGCAACTGAGGGTACCAGTAATCCCAGCAACTCAGGGTGTCTTTAATCCTAGCAACTGAGGGCACCTGTAATCCCAGCAACTCAGGAAGCTGAGACAGGAGAAGTACTTGAACCCAGAAGGCAGAGGTTGCAGTGAGCCGATATTGCACCATTGCACTCCAGTCTGGGCAACAAGAGTGAAACTCTGTCTCAAAAAAAAA"
"chr7","1328883","1329465","JH378118","18053084","18053501","265","16724201","GCAGGGTGTGGTGGCTCAAGCCTATAATCTCAGCACTTTGGGAGGTTTGCTTGAAGCTAGGAGTTTAAGACCAGCGTAGGCAACAGAGTGAGACCCCTATCCTTTAATTTTTTTTTCTTTCGAGAGTCTCACTCTGTCACCCAGGCTTGAGTGCAGTGGTTCAATCATGGCTCACTGCAGTCTCTGCCTCCTGGGCTCAAATAATCCTCCCACCTTAGCCTCCCAAGTAGCTGTGACTATAGGCACACGCCGCCACACCCAGCTATTTTATTTTATTTTTTGTAGAGATGAGGGGGGGGGTCTCACTATGTTGCCCAGGCTGGTCTCGAATGCCTGGGCTCAAGCCATCCTCCCGCTTTGACCTCCCAAGCTGCTGGGATTACAGGTGTGAGCCACTGCTCCCGGCTTTCTGGGCATTTTAATTTGTGGATCACCATGCCTGTTATCCCAGCTACTGGGGAGGAGGCTGAGGCGGGAAAATCGCTTGAACCCAGAAGGTGGAGGTTGCGGTGAGCTGAGATCATGCCATTGCACTCCAGCCTGGGCAACAAGAGCAAAACTCAGTCTAAAAAAAAAAAAAAGA","GGCTGGGCGCAGTGGCTCACACCTGTAATCCCAGCACTTAGGGAAGCTGAGGCGAGTAGATCACCTGAGGTCAGGAGTTAGAGACCAGCCTGGCCATCATGGTGAAACCCCGTCTCTACTAAAGATACCAAAAATTAGCTGAGTGTGGTGCTGGGTGCCTGTAATCCCAGAAACTCAGGGTGCCTGTAATCCCAGCAACTCAGGGTGCCTTTAATCCCAGCAACTGAGGGTACCAGTAATCCCAGCAACTCAGGGTGTCTTTAATCCTAGCAACTGAGGGCACCTGTAATCCCAGCAACTCAGGAAGCTGAGACAGGAGAAGTACTTGAACCCAGAAGGCAGAGGTTGCAGTGAGCCGATATTGCACCATTGCACTCCAGTCTGGGCAACAAGAGTGAAACTCTGTCTCAAAAAAAAA"
"chr7","1808322","1808640","JH378186","9203996","9204293","51","7395674","GGCTGGGCATGGTGGCCCACGCCTGCAATCCCAGCACTCTGGGAGGCTGAGATGGGCGGATCACCTGAGGTCAGGAGTTCCAGACCAGCCTGGCCAACATGGTGAAACCCTGTCTCTACTAAAAATACAAAAAAATTAGCCGAGCGTGGTGGGGGGTGGGGGGTGGGGGGTGGGGGCGCCTGTAATCCCAGCTACTTGGGAGGCTGAGGCAGGAGAATCTCTTGAACCCGGGAGGTGGAGGTTGCAATGAGCTGAGATCTCACCATTGCACTCCAGCCTGGGCAACAAGAACAAAACTCCATCTCAAAAAAAAAAAAAA","GCTGGGCACAGTGGCTCATGCCTGTAATCCCAGCACTTTGGGAGGCTGAGGTGGGCAGATCACCTGAGGTCAGGAGTTGGAGACCAGCCTGGCCAACATGGTGAAACCCTGTCTCTACTAAAAATACAAAAATTAGCCCGGCATGTTGGCGTGTGCCTGTAATCCCAGCTACTTGGGAGGCTGAGGCAGGAGAATCACTTGAACCTGGGAGGTGGAGGTTGCAGTGAGCGGAGACCATGCCATTGCATTCCAGCCTGGGAAACAAGAGCAAAACTCTATCTCAAAAAAAAAAAAAAAA"
"chr7","3396677","3397012","JH378144","13229286","13229620","56","9832609","GGCCGGGTGTGGTGGCTCACGCCTGTAATCCCAGCACTTTGGGAGGCCAAGGTAGGTGGATCACCCGAGGTCAGGCAAGACCAGCCTGGCCAACATGGTGAGACCTCGTCTCTGCTAAGAATACAAAAATTAGCCAGGCATGGTGGTGCATGCCTGTAATCCCAGCTACTTGGGAGGCTGAGGCAGGGGAATTGCTTGAACCCTGGAGGTGGAGGTTGCAGTAGGTGAGAGGGCGCCATTGCACTCTAGCCTGGGCGACAAGAGCAAAACTCCATCTCAAAATAACTAACTAACTAACTAACTAACTAACTAAATAAATAAATACAATAAAAAGAA","GGCCGGGCGCGGTGGCTCAAGCCTGTAATCCCAGCACTTTGGGAGGCCGAGGCGGGTGGATCACCTGTGGTCAGGAGTTCAAGACAGCTTGGTCAACATGGTGAAACCCCGTCTCTACCAAAAATACAAAAAATTAGCTGGGCATGGTAGCGCATGCCTGTAATCCCAGCTACTCAGGAGGCTGAGGCAGGAGAATTGCCTGAACCCAGGAGGCAGAGGTTGCGGTGAGCCGAGATCGCGCCATTGCACTCCAGCCTGGGTAACAAGAGCGAAACTCCCTCTCATAAAAAATAAATAAATAAATAAATAAATAAATAAATAAATAAATAAATAAA"
"chr7","3812203","3812830","JH378118","18053084","18053501","274","14240881","GTCAGGTGTGCTGGTTCACACATGTAATCCCAGCACTTTGGCAGGCTGAGGCAGGTGGATCACCTGAGGTCAGGAGTTCCAGACCAGCCTGGCCAACATGGTGAAACCCCGTCTTTACTAAAAGTATAAAAATTAGGCCGGGCGCGGTGGCTCACGCCTGTAATCCCAGCACTTTGGGAGGCCGAGGCGGGCGGATCACGACGTCAGGAGATCGAGACCATCCTGGCTAACATGGCGAAACTCTGTCTCTACTAAAAATACAAAAAATTAGCCCGGTGCAGTGGCGGGCGCCTGTAGTCTCAGCTACTCGAGAGGCTGAGGCAGGAGAATGGCGTGAACCCGGGAGGCGGAGCTTGCAGTGAGCCGAGATGGCGCCACTGCAGTCCAGCCTGGGCAAAAGAGCGAGACTCTGTCTCAAAAAAAAAAAAAAAAAAAAAAAAAGTATAAAAATTAGCTTGCCATGGTGGCGCGCACCTGTGATCCCAGCTACTCAGGAGGCTGAGGCAGGAGAATTGCTTGAACCCAGGAAGGAGAGGTTGCAGTGAGCTGAGATTGCGCCGCTGCACTCCAGCCTGTGTGACAAGAGCGAAACCATCTCAAACAAACAAACAAAAAACAAACTAAAAAA","GGCTGGGCGCAGTGGCTCACACCTGTAATCCCAGCACTTAGGGAAGCTGAGGCGAGTAGATCACCTGAGGTCAGGAGTTAGAGACCAGCCTGGCCATCATGGTGAAACCCCGTCTCTACTAAAGATACCAAAAATTAGCTGAGTGTGGTGCTGGGTGCCTGTAATCCCAGAAACTCAGGGTGCCTGTAATCCCAGCAACTCAGGGTGCCTTTAATCCCAGCAACTGAGGGTACCAGTAATCCCAGCAACTCAGGGTGTCTTTAATCCTAGCAACTGAGGGCACCTGTAATCCCAGCAACTCAGGAAGCTGAGACAGGAGAAGTACTTGAACCCAGAAGGCAGAGGTTGCAGTGAGCCGATATTGCACCATTGCACTCCAGTCTGGGCAACAAGAGTGAAACTCTGTCTCAAAAAAAAA"
"chr7","4716434","4717311","JH378118","18053084","18053501","498","13336650","GGCTGGGCTCAGTGGCTCACACCTGTAATCATAGCACTTTGGGAGGCCAAGGCAGGAGGATCACTTGAACCCAGGGGTTCAAGACCAGGCTGGGCGACATAGCAAGATCCAGTCCCTATTTTTATTTTTATTTATTTATTCTGAGACAGAGTCTCACTCTGTCGCCCAGGCTGGAGTGCATTGGCGCAATCTCGGCTCACTGCAACCTCCACTTCCCAGGCTCAAGTGATTCTCCCACCTCCATCTTCCAAGTAGCTGGAACTACAGGGATTCGTTCCTATGCCTGGCTAATTTTTGCATTTTTTTGTAGAGACAGGGTTTTGCCACGTTGCCTAGGCTGGTCTCAAACTTGTGAGCTCAAGCAGTCCTCCCACCTCCCAAAGTGCTACGATTACAGGCATGAGCCGCCTAGCCCATCTCTATTTTTTTTTTTTTGCTTTTCTGAGACAGAGTTTCTCTTTTGTTGCCCAGGCTGGAGTGCAATGGCACAATCTCGGCTCACTGCAACCTCCGCCTCCCAGGTTCAAGCGATTCTCCTGCCTCAGCCTCCCGAGTAGCTGAGATTACAGGCACATGCCACCACACCTGGCTAATTTTGTATTTTTAGTAGAGACAAGGTTTCTCTGCGTTGGTCAGGCTGGTCTCAAACTCTTGACCTCAGGTGATCCGCCCACCTTGGCCTCCCAAAGTGTTGAGATTACAGGCATGAGACACCACCCCCCGCCAAATCCCAGCTACTCGGGAGGCTGAGGCAGGAGAATTGCTTGAACCAGGGAGGTGGAGGTTGCAGTGAGCCGAGATTTCACCATTGCACTCTATCTAGCCTGGGCAACAAGAGTGAAAACTCCATCTCAAAAAATAAAAATAAAAATAAAAAA","GGCTGGGCGCAGTGGCTCACACCTGTAATCCCAGCACTTAGGGAAGCTGAGGCGAGTAGATCACCTGAGGTCAGGAGTTAGAGACCAGCCTGGCCATCATGGTGAAACCCCGTCTCTACTAAAGATACCAAAAATTAGCTGAGTGTGGTGCTGGGTGCCTGTAATCCCAGAAACTCAGGGTGCCTGTAATCCCAGCAACTCAGGGTGCCTTTAATCCCAGCAACTGAGGGTACCAGTAATCCCAGCAACTCAGGGTGTCTTTAATCCTAGCAACTGAGGGCACCTGTAATCCCAGCAACTCAGGAAGCTGAGACAGGAGAAGTACTTGAACCCAGAAGGCAGAGGTTGCAGTGAGCCGATATTGCACCATTGCACTCCAGTCTGGGCAACAAGAGTGAAACTCTGTCTCAAAAAAAAA"
"chr7","5662584","5662900","JH378126","21651594","21651905","42","15989010","GGGCGTGGTGGCTCACGCCTGTAATCCCAGCACTTTGGGAGGCTGAGGTGGGCGGATCACCTGAGGTCAGGAGTTTGAGACCAGCCTGGCCAACATGGTGAAAACTCGTCTCTACTAAAAATACAAAAAAAAAAAAAAAAAAAAAAAAATCAGCCGGGCATGGTGGCGGGCGCCTGTAATCCCAGCTATTTGGGAGGCTGAGGCAGGAGAATGGCTTGAACCTGGGAGGCGGAGGTTACAGTGAGCTGAGATGGCACCATTGTACTCCAGCCTGGGCAACAAGAGCGAAACTCCATCTCAAAAAAAAAAAAAAAAGA","GGGTGCGGTGTCTCACACCTGTAATCCCAGTATTTTGGGAGGCTGAGGTGGGCGGATCACCTGAGGTCAGGAGTTCAAGACCAGCCTGACCAACATGGTGAAACACTGTCTCTACTAAAAAAAAAAAAAAAAAAAAAAAAACAAAATTAGCAGGGTGTGGTGGTACATGCCTGTAATCCCAGCTACTTGGGAGGCTGAGGCAGGAGAATTGGGAGAACCAGGGAGGTGGAGGTTGCAGTGAGCTGAGATCGTGCCATTGCTCTCTAGCCTGGGCAACAAGAGCGAAAATCCGTCTCAAAAAAAAAAAAAAAA"
"chr7","5793830","5794436","JH378118","18053084","18053501","247","12259254","GGCCAGGCGCAGTGACTCACGCCTGTAATCCCAGCACTTTGGGAGGCCAAGATGGGTGGATCACCTGAGGTCAGTATTTTAAGATCAGCCTGACCAACATGGTGAAACCCCATCTCTACTAAAAATACCAAAATTAGCCGGGCGTGGTGGCGGGCGCCTGTAATCCCAGCACTTTGGGAGGCCAAGGCGGGCAGATCACTTGAGGTCAGGAGTTCGAGACCATCCTGGCCAACATGGTGAAACCCCGTCTCTACTAAAAAAATACAAAAAATTAGCCGGGCGTGGTGGCGGGCACCTGTAGTCCCAGCTACTCGGGAGGCTGAGGCAAGAGAATGGCGTGAACCTGGGAGGCGGAACTTGCAGTGAGCCAAGATCACGCCACTGCACTGCAGCCTGGGCGACAGAGCGAGACTCCATCTCAAAAAAAAAAAAAAAATACAAAAATTAGCCGGGTGTGATGGCGGGCACCTGTAGTCCCAGCTACTCAGGAGGCTGAGGCAAGAGAATCACTTGAACCCAGGAGGCAGAGGTTGCAGTGAGCTGAGATCACGCCATTGCACTATAGCCTGGGCAACAAGGGCGAAACTCTGTCTAAAAAAAAAAAAAA","GGCTGGGCGCAGTGGCTCACACCTGTAATCCCAGCACTTAGGGAAGCTGAGGCGAGTAGATCACCTGAGGTCAGGAGTTAGAGACCAGCCTGGCCATCATGGTGAAACCCCGTCTCTACTAAAGATACCAAAAATTAGCTGAGTGTGGTGCTGGGTGCCTGTAATCCCAGAAACTCAGGGTGCCTGTAATCCCAGCAACTCAGGGTGCCTTTAATCCCAGCAACTGAGGGTACCAGTAATCCCAGCAACTCAGGGTGTCTTTAATCCTAGCAACTGAGGGCACCTGTAATCCCAGCAACTCAGGAAGCTGAGACAGGAGAAGTACTTGAACCCAGAAGGCAGAGGTTGCAGTGAGCCGATATTGCACCATTGCACTCCAGTCTGGGCAACAAGAGTGAAACTCTGTCTCAAAAAAAAA"
"chr7","5981497","5982111","JH378118","18053084","18053501","258","12071587","GGCCGGATGCAGTGGCCCTCACCTGTAATCCCAGCACTTTGGAAGGCTGCAGTGGGCAGATTACCTGAGGTCAGGAGTTTGAGATCAGCCTGGCTGACATGGTGAAACTCTGTCTCTACTAAAAATACAAAAATTAGCCCGGATGCGGTGGCTCACGTCTGTAATCCCAGTACTTTGGGAGACTGAGGCGGGCAGATCATGAGGTCAGGAGTTCAAGACCAGCCTGGCCAACGTGGTGAATCCCTGTCTCTACTAAAATACAAAAATTAGCTGGGCATGGTGGCATGTGCCTGTAATCCCAGTTACTCGGGAGGCTGAGGAAGAAGCATTGCTTGAACCTGGGAGGCGAAGTTTGCAGTGAGCCGAGATTGTGCCATTTCACTCCAGCCTGGGCGACAGAGCAAGACTCCATCTCAAAAAAATATATATATACAAAAATTAGCTGAGTGTGGTGGCACATGCCTGTAATCCCAGCTACTTGGGAGATGAGGCAGGAGAATCACTTGAACCTGGGAGGCAGAGGTTGCAGTGAGCCGAGATTGTGCCATTTCACTCCAGCCTGGACAACAAGAGCAAAACTCCGTCTCACAAAAAAAAAAAAAAGGAAAATAAAAA","GGCTGGGCGCAGTGGCTCACACCTGTAATCCCAGCACTTAGGGAAGCTGAGGCGAGTAGATCACCTGAGGTCAGGAGTTAGAGACCAGCCTGGCCATCATGGTGAAACCCCGTCTCTACTAAAGATACCAAAAATTAGCTGAGTGTGGTGCTGGGTGCCTGTAATCCCAGAAACTCAGGGTGCCTGTAATCCCAGCAACTCAGGGTGCCTTTAATCCCAGCAACTGAGGGTACCAGTAATCCCAGCAACTCAGGGTGTCTTTAATCCTAGCAACTGAGGGCACCTGTAATCCCAGCAACTCAGGAAGCTGAGACAGGAGAAGTACTTGAACCCAGAAGGCAGAGGTTGCAGTGAGCCGATATTGCACCATTGCACTCCAGTCTGGGCAACAAGAGTGAAACTCTGTCTCAAAAAAAAA"
"chr7","6167448","6168046","JH378118","18053084","18053501","241","11885636","GGCTGGGCACAGTGGCTCACACCTGTAATCCTAGCACTTTGGGAGGCCGAGGGGGGTGGATCACCTGAGGTCAGGAAGTCAAGACCAGCCTGACCAACATGGTGAAACCCCAGCTCTACTAAAAATACAAAAATTCGGTCGGCCATGGTGCCTCACACCTGTAATCCCAGCACTTCGCGAGGCTGAGGCGGGCAGATCACCTGAGGTCAGGAGTTCGAGACCAGCCTGGCCAACATGGCGAACCCCTGTCTCTACTAAAAATGCAAAAAAATTAGCCAGGCATAGTGGTGCATGCCTGTAATCTCAGCTACTTGGGAAGCTGAGGCAGGAGAATCACTTGAACCTGGGAGGCAGAGGTTGCAGTGAGCGGAGATCATACCATTGCACTCCAGCCTAGGTGACAGAGTGAGACTCCGTCTCAGAAAAAAAAAAAGAAAAAATTAGCCAGGCGTGGTGGGCACCTGTAATCCCAGCTACTTGGGAGGCTGAGGCAGGAGGATCGCTTGAACCCAGGAGGCAGAGGTTGCAATGAGCTGAGATTGTGCCATTGCACTCCAGCCTGGATGACAAGAGCAAGACTCTGTCTCAAAAAAAAAAAA","GGCTGGGCGCAGTGGCTCACACCTGTAATCCCAGCACTTAGGGAAGCTGAGGCGAGTAGATCACCTGAGGTCAGGAGTTAGAGACCAGCCTGGCCATCATGGTGAAACCCCGTCTCTACTAAAGATACCAAAAATTAGCTGAGTGTGGTGCTGGGTGCCTGTAATCCCAGAAACTCAGGGTGCCTGTAATCCCAGCAACTCAGGGTGCCTTTAATCCCAGCAACTGAGGGTACCAGTAATCCCAGCAACTCAGGGTGTCTTTAATCCTAGCAACTGAGGGCACCTGTAATCCCAGCAACTCAGGAAGCTGAGACAGGAGAAGTACTTGAACCCAGAAGGCAGAGGTTGCAGTGAGCCGATATTGCACCATTGCACTCCAGTCTGGGCAACAAGAGTGAAACTCTGTCTCAAAAAAAAA"
"chr7","6221443","6222091","JH378118","18053084","18053501","286","11831641","GGGCAGGCACGGTGGCTCATGCCTGTAATCCCAACACTTTGGGAGGTCGAGGCTGGGAGATCACCTGAGGTCAGGAGTTCAAGACCAGCCTGGCCACCATGGTGAAACCCCATTTCTACTAAAAAGACAAAAAATTAGCCAGGTGTGGGCTGGGCGTGGTGGCTCACACCTGTAATCCCAGCACTTTGGGAGGCCAAGGTGGGCGGATCACGAGGTCAGGAGATTGAGACCATCCTGGCTAACACGGTGAAACCCCATTTCTACTAAAAATACAAAAAATACAAAAAAAAAAAAATTAGCCGGGCATGGTGGTGGGCGCCTGTAGTCCCAGCTACTCGGGAGGCTGAGGCAGGAGAATGGCGTGAACTTGGGAGGCAGAGCTTGCAGTGAGCCAAGATCGCACCACTGCACTCCAGCCTGGGTGACAGAGTGAGATTCCATCTCAAAAAAAAAAAAAAAAAAAAAAAAAAAATTAGCCAGGTGTGGTGGCACATGCCTGTTATTCCAGCTACTCAGGAGGCCGAGACAGGAGAATCATTTGAACCCAGGAGGCAGAGGTTGCAATGAGCTGAGATCATGCCATTGCACTCCAGCCTGGGCGACAAGAGTGAAACTCTGTCTCAGAAAAAAAAAAAAAAAAAAAAAAAAA","GGCTGGGCGCAGTGGCTCACACCTGTAATCCCAGCACTTAGGGAAGCTGAGGCGAGTAGATCACCTGAGGTCAGGAGTTAGAGACCAGCCTGGCCATCATGGTGAAACCCCGTCTCTACTAAAGATACCAAAAATTAGCTGAGTGTGGTGCTGGGTGCCTGTAATCCCAGAAACTCAGGGTGCCTGTAATCCCAGCAACTCAGGGTGCCTTTAATCCCAGCAACTGAGGGTACCAGTAATCCCAGCAACTCAGGGTGTCTTTAATCCTAGCAACTGAGGGCACCTGTAATCCCAGCAACTCAGGAAGCTGAGACAGGAGAAGTACTTGAACCCAGAAGGCAGAGGTTGCAGTGAGCCGATATTGCACCATTGCACTCCAGTCTGGGCAACAAGAGTGAAACTCTGTCTCAAAAAAAAA"
"chr7","6286801","6287413","JH378118","18053084","18053501","265","11766283","GGCTAAGTGTGGTGGCTCATGCCTGTAATCCCAGCACTTTGGGAGGCTGAGGTGGGTGATCACTTGAGGTCCAGAGTCTGAGACTAGCCTAGTCAACATGGTGAAACCCTGTCTCTACTAAAAATACAAAAAAATTAGCTTGGCCGGGCGCGGTGGCTCATGCTTGTAATCCCAGCACTTTGGGAGGCCGAGGTGGGTGGATCACAAGGTCAGGAGATCGAGACCATCCTGGCTAACACGGTGAAACCCCGTCTCTACTAAAAAATACAAAAAATTAGCTGGGCGTGGTGGCAGGCGCCTGTAGTCCCAGCTACTCGGGAGGCTGAGGCAGGAGAATGGGGTGAACCCAGGAGGCGGAGCTTGCTGTGAGCCGAGATCGCACCACTGCACTCCAGCCTGGCTGACAGAGCGAGACTCCGTCTTAAAAAAAAAAAATTAGCTCGACTTGGTGGCTCATGCTTGTAATCCCAGCTACTAGGGAGGCTGAGGCAGGAGAATCGCTTCAACCCGTGAGGCAGAGGTTGCAGTGAGCAGAGATCGCACCATTGCACTCTAGCCTGGGTGACAAGAACGAAGTTCCATCTCAATTAAAAAAAAAAAAAAAAGGAAAGAA","GGCTGGGCGCAGTGGCTCACACCTGTAATCCCAGCACTTAGGGAAGCTGAGGCGAGTAGATCACCTGAGGTCAGGAGTTAGAGACCAGCCTGGCCATCATGGTGAAACCCCGTCTCTACTAAAGATACCAAAAATTAGCTGAGTGTGGTGCTGGGTGCCTGTAATCCCAGAAACTCAGGGTGCCTGTAATCCCAGCAACTCAGGGTGCCTTTAATCCCAGCAACTGAGGGTACCAGTAATCCCAGCAACTCAGGGTGTCTTTAATCCTAGCAACTGAGGGCACCTGTAATCCCAGCAACTCAGGAAGCTGAGACAGGAGAAGTACTTGAACCCAGAAGGCAGAGGTTGCAGTGAGCCGATATTGCACCATTGCACTCCAGTCTGGGCAACAAGAGTGAAACTCTGTCTCAAAAAAAAA"
"chr7","7752900","7753491","JH378118","18053084","18053501","239","10300184","GGCTGGGTGCGGTGGCTCATGCATGTAATCCCAACACTTTGAGATGGCAATGCAGGTGGATCACCTGAGGTCAGGAGTTCGAGACCAGCCTGGCCAACATGGTGAAAGCCCGTCTCTACTAAAAATACAAAAAATTGGCTGGGCACGGTGGCTCACGCTTGTAATTCCAGCACTTTGGGAGGCGGAGGCAGGCAGATCACGAGGTCAGGAGATCAAGACCATCCTGGCTAACACAGTGAAACCCCGTCTCTACTAAAAATACAAAAAGTTAGCCAGGTGTGGTGGCAGGTGCCTGTAGTCTCAGCTACTCGGGAGGTTGAGGCAGGAGAATGGCGTGAACCCGGGAGGCGGAGCTTGCAGTGAGCCGAGATCGCACCACTGTACTCCAGCCCGGGCGACAGAGCAAGACTCCATCTCAAAAAAAAAAAAAAATTAGCCGGGTGTGGTGGCTGGCACCTATAATCTCAGCTACTCCAGAGGCTGAGGCAAGAGAATCGCTTGAACCCAGGAGGCAGAGGTTGCAGTGAGTCAAGATTGAACCACTGCACTCAAGCCTGGGCGACAAGAGAGAAACTCTGGCTCAAAAAAAAAA","GGCTGGGCGCAGTGGCTCACACCTGTAATCCCAGCACTTAGGGAAGCTGAGGCGAGTAGATCACCTGAGGTCAGGAGTTAGAGACCAGCCTGGCCATCATGGTGAAACCCCGTCTCTACTAAAGATACCAAAAATTAGCTGAGTGTGGTGCTGGGTGCCTGTAATCCCAGAAACTCAGGGTGCCTGTAATCCCAGCAACTCAGGGTGCCTTTAATCCCAGCAACTGAGGGTACCAGTAATCCCAGCAACTCAGGGTGTCTTTAATCCTAGCAACTGAGGGCACCTGTAATCCCAGCAACTCAGGAAGCTGAGACAGGAGAAGTACTTGAACCCAGAAGGCAGAGGTTGCAGTGAGCCGATATTGCACCATTGCACTCCAGTCTGGGCAACAAGAGTGAAACTCTGTCTCAAAAAAAAA"
"chr7","8358779","8359393","JH378118","18053084","18053501","281","9694305","GGCCGTGCACGATGCTCATTCCTGTAATCCCAGCACTTTGGGAGGCTCAGGAGGGAGGATTGCTTGAGGCTAGGGGTTCGAGACCAGCCTATGAAACATAGTGAGGCCTCATTTCTATGAAACATACAAAAATTTGGCCGGGGCTGGGCGTGGTGGCTCATGCCTATAATCCCAGCAATTTGGGAGGCCGAGGCAGGTAGATCACCTGAGGTCAGGAGTTTGAGACCAGCCTAGCCAACCTGGTGAACCCCCGTCTCTACTAAAAATACAAAAAAATTAGCTGAGCATGGTAGCGTGCACCTGTAGTCCCAGCTACTCAGGAGGCTGACGCAGGAGAGTCACTTGAACCCGGGAGGTAGAGGTTGCAGTAAGTCGAGATTGTGCCATGGCACTCCAGCCTGGCAGCGGAGTGAGACTGTCAAAAAAAACAAACAAACAAACAAACAATTAGCCGGGCATGGTGGTGGGCACCTGTAATCTCAGCTACTCGGGAGGCTGAGGCAGGAGAACTGCTGCAACCCGGGAGGCGGAGGTTGCAGTGAGCTGAGAACATGCCATTGCACTCCTGGGCTGACAACAGCAAGACTCCGTCTCAGAAAAAAAAAAAAAAAAAAA","GGCTGGGCGCAGTGGCTCACACCTGTAATCCCAGCACTTAGGGAAGCTGAGGCGAGTAGATCACCTGAGGTCAGGAGTTAGAGACCAGCCTGGCCATCATGGTGAAACCCCGTCTCTACTAAAGATACCAAAAATTAGCTGAGTGTGGTGCTGGGTGCCTGTAATCCCAGAAACTCAGGGTGCCTGTAATCCCAGCAACTCAGGGTGCCTTTAATCCCAGCAACTGAGGGTACCAGTAATCCCAGCAACTCAGGGTGTCTTTAATCCTAGCAACTGAGGGCACCTGTAATCCCAGCAACTCAGGAAGCTGAGACAGGAGAAGTACTTGAACCCAGAAGGCAGAGGTTGCAGTGAGCCGATATTGCACCATTGCACTCCAGTCTGGGCAACAAGAGTGAAACTCTGTCTCAAAAAAAAA"
"chr7","8572120","8572455","JH378144","13229286","13229620","48","4657166","GGCCAGGCACGGTGGCTCACACCTGTAATCCCAGCACTTTGGGAGGCTAACATGGGTGGATTACCTGAGGTCAGGAGTTCGAGACCAGCCTGGCCAACATGGTGAAACCCCGTCTCTACTAAAAATACAAAAATTAGCCGGGCGTGGTGGTGCATGCCTGTAGTCCCAGCTACTAGGGAGGCTGAGGCAGGAGAATCACTTGAACCTGGGAGGTGGAGGTTGCAGTGAGCCGAGATCGTGCCATTGCACTCCAGCCTGGGCAACAAGAGCGAAACTCCATCTCAAAATAAATAAATAAATAAATAAATAAAATGTTTTTAAAAAGGAAAGAAAAAA","GGCCGGGCGCGGTGGCTCAAGCCTGTAATCCCAGCACTTTGGGAGGCCGAGGCGGGTGGATCACCTGTGGTCAGGAGTTCAAGACAGCTTGGTCAACATGGTGAAACCCCGTCTCTACCAAAAATACAAAAAATTAGCTGGGCATGGTAGCGCATGCCTGTAATCCCAGCTACTCAGGAGGCTGAGGCAGGAGAATTGCCTGAACCCAGGAGGCAGAGGTTGCGGTGAGCCGAGATCGCGCCATTGCACTCCAGCCTGGGTAACAAGAGCGAAACTCCCTCTCATAAAAAATAAATAAATAAATAAATAAATAAATAAATAAATAAATAAATAAA"
"chr7","12888389","12888682","JH378378","75116","75408","40","12813273","GGCTGGGCACGGTGGCTCACTCCTGTAATCCCAGCACTTTGGGAGGCCGAGGTGGGTGGATCACTTGAGGTCAGGAGTTTGAGACCATCCTGGACAACATGGTGAAACCCCATCTCTACTAAAAAAAAAAAAAAAAAAAAAAAAATTAGTCAGGCATGGTGGTGGGTGCCTGTAGTCCCAGCTACTCTGGAGGCTGAGGCAGGAGAATCACTTAAACCCAGGAGGTGGAGGTTGCAGTCAAAGGAGATCGCACATTGCACTCCAGCCTGGGCAACAAGAGCGAAACTCCGCCTC","GGCCGGGTGCAGTGGCTCACGCCTGTAATCCCAGCACTTTGGGAGGCCAAGGCGGGTGGATCATGAGGTCAAGAGATCGAGACCATCCTGGTCAACATGGTGAAACTCTGTCTCTACTAAAAATAAAAAAAAAAAAAAAAAAGATTAGCTGGGCATGGTGGCGCGTGCCTGTAATCCCAGCTACTCAGGAGGCTGAGGCAGGAGAATTGCCTGAACCCAGGAGGCGGAGGTTGCGGTGAGCCGAGATCGCGCCATTGCACTCCAGCCTGGGTAACAAGAGCGAAACTCCGTCT"
"chr7","14638257","14638829","JH378118","18053084","18053501","227","3414827","GGCCAGGCACAGTGGCTCACGCCTGTAATCCCAGCACTTTGGGAGGCCCAGGTAGGCAGATCACCTGAGGTCAGGAGTTCAAGACCAGCCTGGCCAAAATGACAAAACCTAGTCTCTATTAAAAATACAAAAATTAGCTGGGCGTGGTGGCTCACGCCTGTAATACCAAGACTTTGGGAGGCCAAGGCAGGCAGATCACCAGGTCAAGAGATCGAGACCATCCTGGCCAACATGCTGAAACTGTGTCTCTACTAAAAATACAAAAATTAGCTGGGCATGGTGGCGCATGCCTGTAGTCCCAGCTACTCGGGAGGCTGAGGCAGGAGAATCACTTGAACCCAGGAGGCGGAGGTTGCAGTGAGCCACTGCACTCCAGCCTGGGCGACAGAGCGAGACGCCGACTCAAAAAAAAAAAAGCCTGGCGTGGTGGCGGCTGCCTGTAATCCCAGCTGCTCAAGAGGCTGAGGCTGGAGAATCTCTTGAACCCAGGAGGCAGAGGTTGCAGTGAGCCTAGATTCTGCCACTACACTCCAGCCTGGGTGACAAGAGCAAAACTCCATCTCAAAAAAAAAA","GGCTGGGCGCAGTGGCTCACACCTGTAATCCCAGCACTTAGGGAAGCTGAGGCGAGTAGATCACCTGAGGTCAGGAGTTAGAGACCAGCCTGGCCATCATGGTGAAACCCCGTCTCTACTAAAGATACCAAAAATTAGCTGAGTGTGGTGCTGGGTGCCTGTAATCCCAGAAACTCAGGGTGCCTGTAATCCCAGCAACTCAGGGTGCCTTTAATCCCAGCAACTGAGGGTACCAGTAATCCCAGCAACTCAGGGTGTCTTTAATCCTAGCAACTGAGGGCACCTGTAATCCCAGCAACTCAGGAAGCTGAGACAGGAGAAGTACTTGAACCCAGAAGGCAGAGGTTGCAGTGAGCCGATATTGCACCATTGCACTCCAGTCTGGGCAACAAGAGTGAAACTCTGTCTCAAAAAAAAA"
"chr7","15094386","15095019","JH378118","18053084","18053501","265","2958698","GGTCGGGCACAGTGGCTCACACTTATAATCCCAGCATTTTGGGAGGCTGAGCCGGGTGGATCACCTGAGGTCAGGAGTTAGAGACCAGCCTGGCCAAGATGGCGAAACCCCATCTCTACTAAAAATACAAAAAAATGGCCGGGCGCATTGGCTCACGCCTGTAATCCCAGCACTTTGGGAGGCCGAGGCGGGTGGATCACGAGGTCAGGAGATTGAGACCATCCTGGCTAACACGGTGAAACCCCGTCTCCACTAAAAATACAAAAAATTCTCCGGGCGTGGTGGCGGGCGCCTGTAGTCCCAGCTACTCCAGAGGCTTAGGCAGGAGAATGACATGAGCCCGGGAGGCGGAGCTTGCAGTGAGCGGAGGTCGCGCCACTGCACTCCAGCCTGGGCGACAGAGCGACACTCCGTATCAAAAAAATAATAATAATAAAAATAAAATTACCTGGGCGTGGTGGTGGGTGCCTGTAATCCCATCTACTCAGGAGGCTGAGGCAGGGAGAATCACTTGAACCCAGGAGGCAGAGGTTGCAGTGAGCCGAGATCGCACCATTGCACTCCAGTCTGGGCAACAAGAGTGAAACTCCATCTCAAAAATAAAATAAAATTAAATTAAAAAGTAAAAAAAAAA","GGCTGGGCGCAGTGGCTCACACCTGTAATCCCAGCACTTAGGGAAGCTGAGGCGAGTAGATCACCTGAGGTCAGGAGTTAGAGACCAGCCTGGCCATCATGGTGAAACCCCGTCTCTACTAAAGATACCAAAAATTAGCTGAGTGTGGTGCTGGGTGCCTGTAATCCCAGAAACTCAGGGTGCCTGTAATCCCAGCAACTCAGGGTGCCTTTAATCCCAGCAACTGAGGGTACCAGTAATCCCAGCAACTCAGGGTGTCTTTAATCCTAGCAACTGAGGGCACCTGTAATCCCAGCAACTCAGGAAGCTGAGACAGGAGAAGTACTTGAACCCAGAAGGCAGAGGTTGCAGTGAGCCGATATTGCACCATTGCACTCCAGTCTGGGCAACAAGAGTGAAACTCTGTCTCAAAAAAAAA"
"chr7","15661435","15661754","JH378109","3329188","3329514","50","12332247","GCGCGGTGGCTCACGTCTGTAATCCCAGCACTTTGGGAGGCCAAGGCGGGTGGATTCTCTGAGGTCAGGAGTTCAGGACTAGCCTGGCCAACATGGTGAAACTCCGTCTCTACTAAAAAAAAAAAAAAAAAAAAAAAAAAAAAAAAAAAAAAAAAAGAGCCGGGCATGATGGCAGGTGCATGTAATCCCAGCTACTCAGGAGGCTGAGACAGGAGAATCACTTGAACTGCGGAGGCGGAGGTTTCAGTGAGCCAAGATCACGCCATTGCACTCCAGCCTGGGCAACAAGAGCGAAACTCCATCTCGAAAAAAAGAAAAAA","GGCCAGGCATGGTGGCTCACGCCTGTAATCCCAGCACTTTGGGAGCCCAAGCCGGGTGGATTACCTAAGGTCAGGAATTCCAGAACAGCCTGGACAATATGGTGAAACCTTGTCTCTACTAAAAATACAAAAAAAAAAAAAAAAAAAAAAAAAAAAAAAATTTAGCCGGGTGTGGTGGTAGGTACCTGTAATCCCAGCTACTAGGGAGGCTGAGGCAGGAGAATCGCTTGAACTTGGGAGGCGGAGGTTGCAGTGAACAGAGATCACACCACTGCACTCCAGCCTGGGCGACAAGAGCAAAACTCCATCTCAAAGAAAAAAAAAGAA"
"chr7","15890825","15891430","JH378118","18053084","18053501","251","2162259","GGCTGGGTGTGGTGGCTCACATCTGTAATTCCAGCACTTTGGGAGGCCAAGGCAGGTGGATCACCTGAGGTGAGGAGTTCGAGACCAGCCTGGCCAACATGGTGAAATGCCGTCTCTACTAAAAAGACAATAATTAGGGGCTGGGCGCGGTGGCTCACGCCTGTAATCCCAGCACTTTGGGAGGCCAAGGCGGGCAGATCACGAGGTCAGGAGATAGAGACCATCCTGGCTAACACGGTGAAACCCCGTCTTTACTAAAAATACAAAAAAATTAGCCGGGCGTGGTGGCGGGAGCCTGTCGTCCCAGTTACTCGGGAGGCTGAGGCAGAAGAATGGCGTGAATCTGGGAGGTGGAGCTTGCAGTAAGCCGAGATCGCACCACTGCACTCCAGCCTGGGCAACAGAGCAAGACTCTGTCTCAGAAAAAAAAAAAAAAAGAAAAAATTAGCCGGGTGTGGTGGTGTGCATCTGTAGTCCCAGCTACTTGGGAGGCTGAGGCAGGAGAATCGCTTGAACCCAGGAAGCAGAGGTTGCAGTGAGCTGAGATCATGCCATTGCACTCCAGCCTGGGTGACAAGAGTGAAACTCAGTCTCCAAAAACAAAAA","GGCTGGGCGCAGTGGCTCACACCTGTAATCCCAGCACTTAGGGAAGCTGAGGCGAGTAGATCACCTGAGGTCAGGAGTTAGAGACCAGCCTGGCCATCATGGTGAAACCCCGTCTCTACTAAAGATACCAAAAATTAGCTGAGTGTGGTGCTGGGTGCCTGTAATCCCAGAAACTCAGGGTGCCTGTAATCCCAGCAACTCAGGGTGCCTTTAATCCCAGCAACTGAGGGTACCAGTAATCCCAGCAACTCAGGGTGTCTTTAATCCTAGCAACTGAGGGCACCTGTAATCCCAGCAACTCAGGAAGCTGAGACAGGAGAAGTACTTGAACCCAGAAGGCAGAGGTTGCAGTGAGCCGATATTGCACCATTGCACTCCAGTCTGGGCAACAAGAGTGAAACTCTGTCTCAAAAAAAAA"
"chr7","15928804","15929335","JH378118","18053084","18053501","198","2124280","CCGGGTGCAGTGTTTCATGCCTATAATCCCAGCACTTGGGGAGGCACTTGTTTCATGCCTATAATCCCAGCACTTGAGGCAGGCAGATCATTTGAGGTCAGGAGTTTGACACCAGCCTGGCCAACATGGTGAAATCCCATATCTACTAAAATACAAAAATTAGTTGGGTGTGGCAGCAGGTGCCTGTAATCCCAGCTACTTGGGAGGCTGACAAAGGGAGAATCACTTGAACCCGGGAGGTGGAGGTTGCAGTGAACCAAGATTGCGCCATTGCTCTCCAGCCTGGGCGATGAGTAAAACTCTGTCTCAAAAAAAAATTAAAATAAAAATAAGTCAGTAAAATAAATAAATAAAAATACAAAAATTAGCTGGGCGTGGTGGTAGGCACCTGTAATCCCAGCTACTTGGAAGTCTGAGGCAGGAGAATCACTTGAACTAGGGAAATGAGAGGTTGCAGTGAGCCAAGATCGCTCCATTGCACTCCAGCCTGGGCAACAAGAGTGAAACTCTATCTCAAAAAAAAAAAAAAAAA","GGCTGGGCGCAGTGGCTCACACCTGTAATCCCAGCACTTAGGGAAGCTGAGGCGAGTAGATCACCTGAGGTCAGGAGTTAGAGACCAGCCTGGCCATCATGGTGAAACCCCGTCTCTACTAAAGATACCAAAAATTAGCTGAGTGTGGTGCTGGGTGCCTGTAATCCCAGAAACTCAGGGTGCCTGTAATCCCAGCAACTCAGGGTGCCTTTAATCCCAGCAACTGAGGGTACCAGTAATCCCAGCAACTCAGGGTGTCTTTAATCCTAGCAACTGAGGGCACCTGTAATCCCAGCAACTCAGGAAGCTGAGACAGGAGAAGTACTTGAACCCAGAAGGCAGAGGTTGCAGTGAGCCGATATTGCACCATTGCACTCCAGTCTGGGCAACAAGAGTGAAACTCTGTCTCAAAAAAAAA"
"chr7","17471558","17471750","JH378124","10865404","10865566","50","6606154","GTGGTGGCAGGCACCTGTAATCCCAGCTACTCGGGAGGCTGAGGCAGGAGAATCGCTTGAACCCAGGATGCAGAGGTTGCAATGAGCTTTGATCACACCATTGTACTCCAGCCTGGGGAACACACACACACACACACACACACACACACACACACACACACAAAGAAAAGAAAAAGAAAAAAGAAAAAAAAAA","GTGGTTGCAGGCGCCTGTAATTCCAGCTACTCAGGAGGCTGAGGCAGGAGAATCGCTTGAACCCAGGAGGCAGAGGTTGCAGTGAGCCGAGATCACACCATTGCACTCCAGTCTGAGCAATACAGGCAAAACTCCATCTCAATTAAAAAAAAAAAAGAAAAAA"
"chr7","18517403","18517702","JH378181","5676350","5676662","59","12841053","GGCTGGGCATGGTGGCTCACGCCTATAATCCCAAAACTTTGGGAGGCTGAGGCAGGCGAATCATGAGGCCAGGAGTTTGAGACCAGGCTGACCAACACGGTGAAACTAAAAATACAAAAATACAAAAAATACAAAAATACAAAAAAAACTAGCTGGGCGTGGTGGCAGGTGCCTGTAATCCCAGCTTCTCAGGAGGCTGAGGCAGGAGAATTGCTTGAACCCGGGAGGCAGAGGTTGCAGTGAGCCGAGATCGCGCCATTGCACTCCAGCCCGCGCGACAGTGAAAAAAAAAAACAAAAA","GGCTGGGTGCAGTGGCTCATGCCTATAATCCCAGCACTTTAGGAGGCTGAGGCAGGTGGATCACTTGAGGTCAGGAGCTTGAGACCAGCCTGGCCAACATAGTGAAATCTCATCTCTACTAAAAATGCAAAAAAAAAAAAAAAAAAAAAATTTGCTGGGAGTGGTGGCATGTGCCTGTAATCCCAGCTACTCAGGAGGCTGAGGCAGGAGAATCACTTGAACCCAGGAGGTAGATGTTGCAGTGAGCTGAGATCGTGCCATTGCACTCCAGTCTGGGTGACAAGAGCAAAACTCCATCTCAAAAAAAACAAAA"
"chr7","19213914","19214869","JH378118","18053084","18053501","573","1160830","GGCTGGGCACACTGGCTTACACCTGTAATACCAGCACTTTGGGAGGCCAAGGCGGGTGAATCACTTGAGGTTAGGAGTTCGAGACCAGCCTGGCCAACATGAAATAAACATTTCAGAAAAGAGCTTGGGGATGGTGGCTCATGCTTGTAATCCCTGCACTTTGCGAGGCCAAAGCTGGAAGATTGCTTAAGTTTAGGAGTTTGAGACCGGCCTGGGTAACACAGTGAGACCTCATCTCTACCAAAAACAGAAACAAAAACATTAGCTGGACTTGGTGGTGTACTTTTTTTTTTTTTTTTTTTTTTTTGAGACAGAGTCTTGCTCTGTTGCCCTGGCTGGAGTGCAGTGGCATGATCTCGGCTCACTGCAACCTCCGCCTCCCGGGTTCACGCCATTATCCTGCCTCAGCCTCCTGAGTAGCTGGGACTACAGGTGCCCGCCACCACATCTGGCTCATTTTTTGTGTGTGTTTTTAGTAGAAACGGGGTTTCACCATATTAGCCAGGATGGTCTCGATCTCCTGACCTCGTGATCCGCCCGCCTCGGCCTCCGAAAGTGCTGGGATTACAGGCGTGAGCCACCGCACCCAGCCTGGTGGTGTACTCTTGTAGTCTCAACTACTGAGGCAGGAGGATCGCTTTAGCCTAGGAGGCCAGGGCTGCAGTGAAACATGATCGTGTCACCGCACTCCAGTCTGGATGACAGAGCCAGACCCTGTCTCCCTGTCTCAAAAAAAAAAAAAAAAAAAAAAAAAGTTGGGAGGTGAAACCCAGTCACTACCAAAAATACAAAAAATTAGCCGGGTGTGGTGGCGGGCACCTGTAATCCTAGCTACTCAGGAGGCTGAGGCAGGAGAATCGCTTAAATCCAGGAGGCAGAGGTTGCAGTGAGCCAAGGTTTTGCCATTGCATTCCAGCCTAGGTGACAAGAGTGAAAGTCTGTCTCAAAAAAAAAAA","GGCTGGGCGCAGTGGCTCACACCTGTAATCCCAGCACTTAGGGAAGCTGAGGCGAGTAGATCACCTGAGGTCAGGAGTTAGAGACCAGCCTGGCCATCATGGTGAAACCCCGTCTCTACTAAAGATACCAAAAATTAGCTGAGTGTGGTGCTGGGTGCCTGTAATCCCAGAAACTCAGGGTGCCTGTAATCCCAGCAACTCAGGGTGCCTTTAATCCCAGCAACTGAGGGTACCAGTAATCCCAGCAACTCAGGGTGTCTTTAATCCTAGCAACTGAGGGCACCTGTAATCCCAGCAACTCAGGAAGCTGAGACAGGAGAAGTACTTGAACCCAGAAGGCAGAGGTTGCAGTGAGCCGATATTGCACCATTGCACTCCAGTCTGGGCAACAAGAGTGAAACTCTGTCTCAAAAAAAAA"
"chr7","19470315","19470919","JH378206","6546474","6546861","259","12923841","CACTTTGGGGGGCTGAGGCGGGTGGATCACCTGAGGTGAGGAGTTCGAGACCAGCCTGGCCAACATGGTGAAACCCTGTCTCTACTAAAAATACAAAAAATTGGTCGGGCATGGTGGCTCACACCTGTAATCCTAGCACTTTGGGAGGCCAAGACGGGCGGGTCAGTTGAGGTCAGGAGTTTGAGACAAGCCTAGCCAACATAGTGAAACCTTGTCTCTACTAAAAATACAAAAAAAATTAGCTGGGCATGGTGGCGGGTGCCAGTAATCCCAGCTACTTGGGAGGCTGAGGCAGGAGAATCGCTTGAACCTGGGAGGCAGAGGTTGCAGTGAGCTGAGATTGCCCCACTACACTCCAGCCTGGGTGACAGAGTGAGATTCTGTCTTAAAAACAAAAACAAAAACAAAAAAACAAAAAAACAAAATTAGCCGGGTGTGGGGATGCATGCCTGTAATGCCAGCTACTTGGGAGGCTGAGGCAGGAGAATTGCTTGAACTTGGGAGGCGGAGGTTGCAGTGAGCCAAGATTGCGCCATTGCACTTCAGACTGGGCAACAAGTACGAAACACTGTCTCAAAAAGTAGAAAAAAATAAAAATGAAAAAA","GGCCACACATGGTGGCTAACGCCTGTAATCCCAGCACTTTGGGAGGCCAAGTCGGGTGGATCATGAGGTCAGGAGACCAAGACCATCCTGGCCAAATGGTGAAACCCCGTCTCTACTAAAAATACAAAAATTAGCTGGGCATGGTGGCGTGTGCCTGTAATCCCAGCTACTCAGGAGGCTGAGGCAGGACAATTGCCTGAACCCAGGAGAATTAGCTGGGCATGGTGGCGTGTGCCTGTAATCCCAGCTACTCAGGAGGCTGAGGCAGGACAATTGCCTGAACCCAGGAGGCGAAGGTTGCGGTGAGCCGAGATTGTGCCATTGCACTCCAGCCTGGGTAACAAGAGCGACACTCTGTCTCAAAAAAAAAAAAAAAAAAAAAAAAAAA"
"chr7","19780583","19780921","JH378208","3909771","3910091","56","15870812","GCCAGGTGCGGTGGCTCACACCTGTAATCCCAGCACTTTGGGAGGCTGAAAAGGGCAGACTACCTGAGGTCAGAAGTTCGAGACCAGCCTGGCCATGGTGATGAAACCCCATCTCTACAAAAAACAAACAAACAAACAAACAAAAAAACCCACAAAAATTAGCTGGGCGTGGTGGCGTGTGCCTGTAATCCCAGCTACTCAGGAAGCTGAGGCAGGAGAATCGCTTGAACCCAGGAGGTGGAGGTTGCAGTGAGCTGAGATCATGCCATTGCACTCTAGCCTTGGGCAACAAGAGTGAAACTCCGTCTCAAAAGAAACGAACAAAGAAACAAACAAAAA","GCCGGGTGCGGTGGCTCAAGCCTGTAATCCCAGCACTTTGGGAGGCCGAGGCGGGTGGATCACGAGGTCGTGAGATCAAGACCAGCCGAGCCAACATGGTGAAACCCCGTCTCTACTAAAAATACAAAAAAAAAAAAAAAAAAAAAAAAATTAGCTGGGCATGGTGGCGTGTGCCTGTAATCCGAGCTACTCAGGAAGCTGAGGCAGGAGAATTGCCTGAACCCAGGAGGCGGAGGTTGCAGTGAGCCGAGATCGCGCCATTGCACTCCAGCCTGGGTAACAAGAGCGAAACTCCGTCTCAAAAAAAAAAAAAAAAAAAAA"
"chr7","26502876","26503226","JH378228","5665092","5665424","56","20837784","GGCCAGGTGCCATGGCTCACGCCTTGCAATCCCAGGACTTTGGGAGGTTGAGGCAGGTGGATCACCTGAGGTCAGGAGGTTGAGACCAGCCTGGCCAACATGGTGAAACCCTGTCTCTACTAAAAATATCAAAATTAGCTAGGCGTGGTGGCAGATGCCTGTAATCTCAGCTACTCTGGAGGCCAAGGCAGGAGAACTGCTTGAACCCAGGAGGGGAGGTTGCAGTGAGCCAAGATCGTGCCATTGCCCTCCAACCTGGGCAACAAGAGCGAAACTCCATCTCCAAAATAAATAAATAAAATAAAATAAAATAAAATAAAATAAATTAAAATAAAAAATAAAAATAGAAAA","GGCCGGGCGCGGTGGCTCAAGCCTGTAATCCCAGCACTTTGGGAGGCTGAGGCGGGTGGATCACGAGGTCAAGAGATCGAGACCATCCTGGTCAACATGGTGAAACCCTGTCTCTACTAAAAATACTAAAAATTAGCTGGGCATGGTGGCGTGTGCCTGTAATCCCAGCTACTCAGGAGGCTGAGGCAGGAGAATTGCCTGAACCCAGGAGGCGGAGGTTGCGGTGAGCCGAGATCGCGCCATTGCACTCCAGCCTGGGCAACAAGAGCGAAACTCTGTCTCAAAAAAAAAAAATAAATAAATAAAATAAAATAAAATAAAATAAAATAAAAT"
"chr7","34362141","34362721","JH378118","18053084","18053501","237","16309057","GGCAGGGCGCTGTGGCTCACGCCTGTAATCCTAACACTTTGGGAGGCCGAAGCGGGTGGATCACCTGAGGTCAGGAGTTCAAGACCAGCCTGACCAACCTGATGAAACCCCGTCTGTACTAAAAATACATGAGGCCGAGGTGGGCAGATCACGAGGTCGGCAGATCGAGACCTTCCTGGCTAACACGGTGAAACCCCCTCTCTACTAAAAATACAAAAAATTGGCCGGGCATAGTGGCGGGTGCCTGTGGTCCTGGCTACTCCGGAGGCTGAGGCAGGAGAATGGCGTGAACCCAGGAGGTGGAGCTTGCAGTGAGCCGAGATCACGCCATTGCACTCCAGCCTGGGTGATAGAGCAAGACTCCGTCTCAAAAAAAAAAAAAAAAAAGAAAAAGAAACAAACAAAAAATTAGCTAGGCGTGGTGGTGTGCTCCTGTAATCCTAGCTACTCGGGAGGCTGAGGCAGGAGAATCACTTGAACCTGGGAGGCGGATGTTGCAGTGAGCCGAGATCGCGCCATTGCACTCCAGCTTGGGCGACAGGAGCGAATCTCCATCTCAAAAAACAAACAAACAAACAAAA","GGCTGGGCGCAGTGGCTCACACCTGTAATCCCAGCACTTAGGGAAGCTGAGGCGAGTAGATCACCTGAGGTCAGGAGTTAGAGACCAGCCTGGCCATCATGGTGAAACCCCGTCTCTACTAAAGATACCAAAAATTAGCTGAGTGTGGTGCTGGGTGCCTGTAATCCCAGAAACTCAGGGTGCCTGTAATCCCAGCAACTCAGGGTGCCTTTAATCCCAGCAACTGAGGGTACCAGTAATCCCAGCAACTCAGGGTGTCTTTAATCCTAGCAACTGAGGGCACCTGTAATCCCAGCAACTCAGGAAGCTGAGACAGGAGAAGTACTTGAACCCAGAAGGCAGAGGTTGCAGTGAGCCGATATTGCACCATTGCACTCCAGTCTGGGCAACAAGAGTGAAACTCTGTCTCAAAAAAAAA"
"chr7","50012600","50012925","JH378118","23749903","23750223","51","26262697","GGCCCGGTGTGGTGGCTCACGCCTGTAATTCCAGCACTTTGGGAGGTTAAGGCGGGTGGATCACCTGAGATCAGGAGTTCAAGAGCACCCTGGACAACATGGTGAAACCCTTTCTCTATTAAAAATACAAAAAAAAAAAAAAAAAAAAAAAAAAAAGCCAGGTGTGGTGGTGGGCGCCTGTAATCCCAGCTACTCAGGAGGCTGAGGCAGGAGAACTGGATGAACCTGGGAGGTGGAGGTTGCAGTGAACTGAGATAGTGCCATTGCACTCCAGCCTGAGTGACAAGAGTAAAAAACTCCATCTCAAAAAAAAAAAAAACAAAAAA","GGCCGGGCGCGGTGGCTCAAGCCTGTAATCCCAGCACTTTGGGAGGCCGAGGCAGGTGGATCATGAGGTCGAGAGATCGAGACCATCCTGGTCAACATGGTGAAACCCTGTCTCTACTAAAAATACAAAAAAAAAAAAAAAAAAAAAAATTAGCTGGGCATGGTGGCGCATGCCTGTAATCCCAGCTACTCAGGAGGCTGAGGCAGGAGAATTGCCTGAACCCAGGAGGCGGAGGTTGCAGTGAGCTGAGATCGCGCCATTGCACTCCAGCCTGGGTAACAAGAGTGAAATTCCGTCTCAAAAAAAAAAAAAAGAAAGAAA"
"chr7","60436662","60436983","JH378131","1076795","1077100","68","59359867","TGTAATCCCAGCACTTTGGGAGGCTAAGGCAGGCGGATCACCTGAGGTCAGGAGTTCAAGACCAGCCTGGCCAACATGGGGAAATCCCATCTGTACTAAAAATACCAAAAAAAACAAAACAAAACAAAACAAAACAAAAACATTCGCTGGGCATGGTGGCAGGCACCTGTAATCCCAGCTACTTGGGAAACAGAGGCCAGAGAATCGCTTGAATCTGGGAGGCAGAGGTTGCAGTGAGCCGCGATTGCGCCATTGCACTACAGCCTGGGCGACAATAGCAAGACTCCATCTCAAAACAAACAAACAAACAAAAAACACAAAA","TGTAATCCCAGCACTTTGGGAAGCCAAGACGGGCGGATCACCTGAGATCAGGAGTTCAAGACCAGCCCGGCCAACCTGGTAAAACCCCGTCTCTACTAAAAATACAAAAAATACAAAAAATACAAAAAAATACAAAAAAATTAGCCAGGTGTGGTGGCAAGTGCCTGTAATCCCAGTTACTCAGGAGGCTGAGGCAGGAGAATTGCTTGAACCAGGGAGGTGGAGGCTGCAGTGAGCTGAGATCGCGCCACTGTACTCAAGCCTGAGTGACAAAAGCAAGACTCCATTTCAAAAAAAAGAAAAGAA"
"chr7","80786928","80787240","JH378118","1197626","1197930","67","79589302","GTCTGTGATCCCAGCACTTTGGGAGGCCAAGGCAGGCAGATCATCTGAGGTCAGGAGTTCGAGACCAGCCTGGACAACATGGTGAAACACTGTCTCTACTAAAAAAAAAAAAAAAAAAAAAAAAAAATACAAAATTAGCCAGGCATGGTGATACATGCCCATAACCCCAGCTACTCAGGAGGCTGAGGCAAGAGAATCACTTAAACCTGGGAGGTGGAGGTTACAGTGAGCAGAGATCACGCCATTGCACTGCAGCCTGCGTGACAAGAGAGAAACTCTGGCAGGAAAAAAAAAAAAAAAAAAGGGAAAGAAA","GCTTACACCTGTAATCCCAGCACTTTGGGAGGCCGACGCAGGTGGATTACCTGAGGTCAGAAGTTCTTGATTAACCATGGTGAAAATCCATCTCTACTAAAAAACAAAAAACAAAAAACAAAAAAACTAAAATTAGCTGGGCATGGTGGCACATGCCTATAATCCCAGCTACTGGGGAGGCTGAGGCAGGAGAATTGCTTGAACCTGGGAGGTGGAGGTTGCAGTGAGCCAAGATCATGCCATTGCTCTCCAGCCTGGGCAACAAGAGCAAAACTGTCTCAAAAAAAAAAAAAAAAAAAAAAAAA"
"chr7","85052641","85053001","JH378134","16553897","16554225","129","68498744","CAAAAATTACCTGGGTGTGGTGGCACGCACCTGTAATCCCAGCTACTTGAGAGGCAGAGGCAGGAGAATCGCTTGAACCCAGGAGGTAGAGGTTGCAGTGAGCCGAGATCGCGTCATTGCACTCCAGCCTGAGTGACAAGAATGAAACTCCATCTCAAAAAAAAAAAAAAAAGCTAGAAGAGATAATTCTAAATGTTTGCAACACAGAGAAATGATAAATGTTTGAGGTGACGGATATGCTAATTACCCTGATTTGATCAGTACTCATTGTATATATGTATGGAAATATTACTCTGTATCCCATAAATATGTACAATTATTATATGTCAACTAAAAATAAAATGAAAAAAAAGAAAAAAAA","GCTGGGTGTAGTGGTGCATACCTGTAATCCCAGCTACTCAGGAGGCTGAGGCACAAGAATCATTTGAACCTGGGAGGCAGAGGTTGCAGTGAGCTGAGATTGCACCATTGCACTCCAGCCTGGGTAACAAGAGCGAAACTCCATCTCAAAAAAAAAAAAAAAATTAGCTGGGTGTAGTGGTGCATACCTGTAATCCCAGCTACTCAGGAGGCTGAGGCAGGAGAATTGCCTGCACCCAGAAGGCAGAGGTTGCAGTGAGCTGAGATTGCACCATTGCACTCCAGCCTGGGTAACAAGAGCGAAACTCCATCTCAAAAAAAAAAAAAAAA"
"chr7","90713639","90713950","JH378116","25229810","25230116","40","65483829","GCTGGGCATGGTGGCTCACGCCTATAATCCCAGCACTTTGGGAGGCAGAAGCAGGTGGATCACTGGAGGTCAGGAGTTTGAGACCAGCCTGGCCAACATGGTGAAACCTCATCTCTACTAAAAAAAAAAAAAAAAAAAAAAAAAATTAGCCAGGCATGGTGGCAGGTGCCTGTAATCCCAGCTACTCAAGAGGCTGAGGCAGGATAATCCCTTGAACCCAGGAGACAGAGGTTGCAGTGAGCCAAGATCTCACCATTGCACTCCAGCCTGGGCAGCAAGAGTGAAACTCTGTCTCAGAAAAAAAAAAAAAAA","GCCGGGCGCGGTGGCTCAAGCCTGTAATCCCAGCACTTTGGGAGGCCGAGGCGGGTGGATCACGAGGTCAGGAGATCGAGATCATCCTGGTCAACATGGTGAAACCCCATCTCTACTAAAAATACAAAAAAAAAAAAAAAAATTAGCTGGGCATGGTGGCGCGTGCCTGTAATCCCAGCTACTCAGGAGGCTGAGGCAGGAGAATTGCCTGAACCCAGGAGGTGGAGGTTGCGGTGAGCCGAGATCGCGCCATTGCACTCCAGCCTGGGTAACAAGAGTGAAACTCCGTCTCAAAAAAAAAAAAAAA"
"chr7","90741183","90742566","JH378118","18053084","18053501","980","72688099","GGCCAGGCACGGTGGCTCACGCCTGTAATCCCAGCACTTTGGGAGGCCGAGGTGGGTGGGATCACCTGAGGACAGGTATCAGGGGAACCCGCCCCCAATAATTCAATGTTATTTCACGTAGGTTCTTTTCTGTTTCCCTAAGTGTCAGCCAGTCTGAGAAATAAAGGGAAAGAGTACAGCAGAGAGAAATTTTAAAGCTGGATATCCGGGGGAGACATCACATGTCGGCAGGTTCCGTGATGCCCCCCAAGCCGCAAAACCAGAAAGTTTTTATTAGTGATTTTCAAAGGGGAGGGAGTGTACGAATAGGGTGTGGGTCACAGAGATCACATGCTTCACAAGGTGATAAAATATCACAAGGCAAATGGAGGCAGGGCAAGATCACAGGACCACAGGACCGGGGTGAAATTAAAATTGCTAATGAAGTTTCAGTCATGCATTGCCATTGATAACATCTTATCAGGAGATAGGGTTTGAGAGCAGACAACCAGTCTGACTAAAAATTTACTAGGTGGGAATTTCCTCGTCCTGATAGGCCTGGGAGCGCTACAGGAGACCAGGGCTTATTTCATCCCTTATCTGCAACCGTAAAAGACATTCCATTTTAGAGAGACAGGCCATTTTAGAGACCAACCCCTGGGAATGCATTCTCTTTCTCAGGTCTGTTCCTTGCTGAGAAAAGGAATTCAGCGATATTTCTATTTGCTTTTGAAAGAAAAGAAATATGGCTCTGTTCTGCCTGGCTCTCAGGCAGCCAGACCTAATGGTTATCTCCCTTGTTCCCTGAACATCGCTGTTATCCTGTTCTTTTTTCAAGGTGCCCAGATTTCATATTGTTTAAACATACATGCTTACGAACAATTTGTGCAGTTAACACAATCATCACAGGATCCTGAGGCGACATACATCCTCAGCTTACAAAGACAACAGGATTGAGAGATTAAAGTAAACACAGTCATGGGAAATCACAAGAGTATTGATTGGGAAAGTGATAAATGTCCATGAAATCTTCACAGTTTATGTTCAGAGATTGCAGTAAAGACAGGCGTAAAAAATTATAAAGGTATTAATTTGAGGAACTAATAAATGTCTATGAAATCTTCACAATTTATGTTCTGCCATGGCTTCAGCCAGTCTCTCTGTTTGGGGTCCCTGACTTCCTGCAACAGACAGGAGTTCCAGACTAGCCTGGCCAAGACGGTGAAACCCCATCTCTACTAAAAAAATACAAAAAATATTAGGGTGTAGTGGTGCATGCCTGTAATCCCAGCTACTTGGGAGGCTGAGGCAGGAGAATCTCTTGAACTCGGGAGGTGGAGGTTGCAGTGAGCCGAGGTCACGCCATTGTACTCCAGCCTGGGCGACAAGAGCGAAAATCCGTCTC","GGCTGGGCGCAGTGGCTCACACCTGTAATCCCAGCACTTAGGGAAGCTGAGGCGAGTAGATCACCTGAGGTCAGGAGTTAGAGACCAGCCTGGCCATCATGGTGAAACCCCGTCTCTACTAAAGATACCAAAAATTAGCTGAGTGTGGTGCTGGGTGCCTGTAATCCCAGAAACTCAGGGTGCCTGTAATCCCAGCAACTCAGGGTGCCTTTAATCCCAGCAACTGAGGGTACCAGTAATCCCAGCAACTCAGGGTGTCTTTAATCCTAGCAACTGAGGGCACCTGTAATCCCAGCAACTCAGGAAGCTGAGACAGGAGAAGTACTTGAACCCAGAAGGCAGAGGTTGCAGTGAGCCGATATTGCACCATTGCACTCCAGTCTGGGCAACAAGAGTGAAACTCTGTCTCAAAAAAAAA"
"chr7","95682818","95683127","JH378153","13252150","13252460","53","82430668","GGCTCGGTGTGGTGGCTTACGCCTGTAATCACAACACTTTGGGAGGCCGAGGCAGGTGGATCACCTGTGGTCTGGACTTTGAGACCAGCCTGGCCAACGCGGTGAAACCCTGGCTCTACTAAAAAAAAAAAAAAAAAAAAAAAAAAACAAAGATTAGCCTGGCATGGTGGTGGAATGCCTGTAATCCCAGCTACTCAGGAGGCTGAGGCAAATGAATTGCTTGAACCTGGGAGGTGGAGGTTGCAGTGACCCAAAATAGTGCCATTGCACTCCAGCCTGGGCAACGAGTGAAACTCCATCTCAAAAAAAA","GGCTGGGTGCAGTGGCTCACACCTGTAATCCCAGCACTTTGGGAGGCCAAGGTGGGTGGATTACCTAAGGTCAGGAGTTCAAGACCAGCATGGCCAATGTGGTGAAACCCTGTCTCTACTTAAAAAAAAAAAAAAAAAAAAAAAAAAAAAAATTAGCCGTGCATGGTGGCGCGTGCCTGTAATCCCAGCTCCTCAGGAGGCTGAGGCAAGAGAATTGCTTGAACCCAGGAGGCAGAGGTTGCAGTAAGCCGAGATGGCACCATGGCACTCCAGCCTGTACGACAAGAGGGAAACTCCGTCTCAAAAAAAAA"
"chr7","114310732","114311060","JH378262","266823","267148","45","114043909","GGCTGGGCATGATGGCTCACGCCTGTAATCCCAGCACTTTGGGAGGTCAAGGTGGGTGGATCACCTGAGGTTGGGAGTTCGAGATCAGCCTGGCCAGCATGGTGAAACCTTGTCTTTACTAAAAATACAAAAATTAGCCAGGCATGGTGGCGGGTGCCTGTAATTCTAGCTACTCAGGAGGCTGAGGCAGCAGAATCGCTTGAACCCAGAAGGTGGAGGTTGCAGTGAGCCAAGATCACTCCATTGCACTCCAGCCTGGGCAACAAGGGCAAAACTCCATCTCAAAAACAAACAAACAAACAAACAAACAAAAACCCCAAAAAACAAAA","GGCCGGGCGCGGTGGCTCAAGCCTGTAATCCCAGCACTTTGGGAGGCCGAGGCGGGTAGATCATGAGGTCAGGAGTTTGAGACCAGCCTGGCCAACATGGTGAAACCCCGTCTCTACTAAAAATACAAAAATTAGCCGGGCATGGTGGCCTGTGCCTGTAATCCTAGCTACCCAGGAAGCTGAGGCAGGAGAATTGCCTGAACCCAGGAGGCGGAGGTTGCGGTGAGCCGAGATCGTGCCATTGCACTCCAGCCTGGGTAACAAGAGCGAAACTCCGTCTCAAAAACAAACAAACAAACAAACAAAAACAAAAAACAAAAAACAAA"
"chr7","116062407","116062984","JH378118","18053084","18053501","238","98009323","GGCCCGACGCGGTGGCTCTCGCCTGTAATCCCACTACTTTGGGATGCCGAGGTGGGCAGATCACCTGAGGTCAGGAGTTCGAGACCAGCCTGGCCAACATGGTGAAACCCCGTCTCTACTAAAAATACAAAAATTAGGCTGGGCGCGGTGGCTCACGCTTGTAATCCCAGCACTTTGGGAGGCCGAGGCGGGCGGATCACAAGGTCAGGAGATCGAGACCACGGTGAAACCCCGTCTCTACTAAAAATATTTTTAAAAATTAGCCTGTAGTCCCAGCTACTCGGAGAAGCCGAGGCAGGAGAATGGCTGAACCCAGGAGGGGGAGCTTGCAGTGAGCTGAGATCGCACCACTACACTCCAGCCTGGGCGACAGAGCGAGACTCTGTCTTAAAAAAAAAATACAAAAATTAGCCCAGTGTGGTGGCATGCGCCTATAATCCCAGCTAGTAGGGAGGCTGAGAGAGGAGAATCACTTCAACCCAGAGGTTGCAGTGAGCCAAGATCATGCCATTGCACTCCAGCCTGGGTGACAAGAGTGAAACTGTCTCAACAAAAAAAAAAAAAGAAAAGAAGAAGAA","GGCTGGGCGCAGTGGCTCACACCTGTAATCCCAGCACTTAGGGAAGCTGAGGCGAGTAGATCACCTGAGGTCAGGAGTTAGAGACCAGCCTGGCCATCATGGTGAAACCCCGTCTCTACTAAAGATACCAAAAATTAGCTGAGTGTGGTGCTGGGTGCCTGTAATCCCAGAAACTCAGGGTGCCTGTAATCCCAGCAACTCAGGGTGCCTTTAATCCCAGCAACTGAGGGTACCAGTAATCCCAGCAACTCAGGGTGTCTTTAATCCTAGCAACTGAGGGCACCTGTAATCCCAGCAACTCAGGAAGCTGAGACAGGAGAAGTACTTGAACCCAGAAGGCAGAGGTTGCAGTGAGCCGATATTGCACCATTGCACTCCAGTCTGGGCAACAAGAGTGAAACTCTGTCTCAAAAAAAAA"
"chr7","117219013","117219615","JH378118","18053084","18053501","249","99165929","GGCTAGGCACCATGGCTCACGCCTGTAGTCCCAGCACTTTGGGAGGCTGAGGCGGGTGGATCGCTTGAGGTCAAGAGTTTGAGACCAGTCTGGCCAACACGGTGAAACCTGTCTTTACTAAAAATACAAAAAGGCTGGGTGTGGTGGCTCACACCTGAAATCCTAGTACTTTGGGAGGCCGAGGCAGGTGGATCACCTGAGGTCAGGAGTTTGAGACCAGCTTGGCCAACATGGTGAAACCCCATCTCTACTAAAAATACAAAAATTAGCAGGGCATGGTGGTGGGCGCTGGTAATCCTAGCTACTCAGGAGGCTGAGGCAGGAGAATAGCTTGAACCCGGGAGGCAGAGGTTGCCATAAGCCGAGATTGCGCCACTGCACTTCAGCCTGGGCAACAGAGTGAGACTTTGTCTCAAAAAAACAAACAAAACAAAAAATAGCTGAGCATGGTGGTGGGCGCCTGTAATCCCAGCTACTTGGGAGGCCGAGGCAGGAGAATCGCTTGAACCCAGGAGGCGGAGGTTGCAATGAGCCAAGATTGTGCCATTGCACTCCAGCCTGGGCAACAAGAGCAAAACTCCAACTCAAAAAAAAAAAAAAAAA","GGCTGGGCGCAGTGGCTCACACCTGTAATCCCAGCACTTAGGGAAGCTGAGGCGAGTAGATCACCTGAGGTCAGGAGTTAGAGACCAGCCTGGCCATCATGGTGAAACCCCGTCTCTACTAAAGATACCAAAAATTAGCTGAGTGTGGTGCTGGGTGCCTGTAATCCCAGAAACTCAGGGTGCCTGTAATCCCAGCAACTCAGGGTGCCTTTAATCCCAGCAACTGAGGGTACCAGTAATCCCAGCAACTCAGGGTGTCTTTAATCCTAGCAACTGAGGGCACCTGTAATCCCAGCAACTCAGGAAGCTGAGACAGGAGAAGTACTTGAACCCAGAAGGCAGAGGTTGCAGTGAGCCGATATTGCACCATTGCACTCCAGTCTGGGCAACAAGAGTGAAACTCTGTCTCAAAAAAAAA"
"chr7","119683468","119683798","JH378106","47883136","47883458","51","71800332","GGCCAGACGCAGTGGTTCACGCCTGTAATCCCAGCACTTTGGATGGCCGAGGTGGGTGGATAACCTGAGGTCTGGAGTTCGATACCAGTCTGGCCAACATGGTGAAACTCTGTCTCTACTAAAAATACAAAAATTAGCTGGATGTGGTGGTGGGGGCTTGTAGTCCCAGCTACTCGGGAGGCTGAGGCAGGAGAATCACTTGAACCCAGGAGGCGGAGGTTTCAGTGAGCTGAAATCGCACCATTGCACTCCAGCCTGGGTGATAAGAGGGAAACTCCATCTCAAAACAAACAAACAAAAACAAACAAACAAACAAACAAGAAAAAGGAAA","GGCCGGGTGCGGTGGTTCACCCCTGTAATCCCCGCACTTTGGGAGGCCGAGGTGAGTGGATCACGAGGTCAAGAGATCGAGACCATCCTGGTCAACAAGGTGAAACCCTGTCTCTACTAAAAATACAAAAATTAGCTGGGCATGGTGGCGTGTGCCTGTAATCCCAGCTACTCGGGAGGCTGAGGCAGGAGAATTGCCTGAACCCAGGAGGCGGAGGTTGCGGTGAGTTGAGATGGCACCATTGCACTCCAGCCTGGGTAACAAGAGCGAAATTCCGTCTCAAACAAACAAAAACAAACAAACAAACAAACAAACAAAAAAAC"
"chr7","119805843","119806141","JH378122","8011060","8011359","50","111794783","GGCCAGGCGCGGTGGCTCACGCCTGTAATCCCAGCACTTTGAGAGGCTGAGGCGGGTAGATCACCTGAGGTCAGGAGTTTGAGGCCAGCCTGGCCAACATGGTGAAACCGTGGCTCTACTAAAAATACAAAAAAAAAAAAAAAAAAAAAAAAATTTAGCCGGGCGTGGTGGTGGGTGCCTGTAATCCCAGCTACTCAGGAGGCTGAGGCAGGAGAATTGCTTGAACCTGGAAGGAGATGGTTGCACTGAGCCGAGATCATGCCATTGCACTTCAGCCTGGGCTACAAGAGCAAAACTCC","GGCCAGGTGCAGTGGTTCATGCTGGTAATCCCAGCACTTTGGGAGGCCAAGACAGGTGGATCACTTGAGGTCAGGAGTTCGAGACCAGCCTGACCAACATGGTAAAACCTCGTCTCTACTAAAAATACAAAAAAAAAAAAAAAAAAAAATTCAGCTGGGTCTGGTAGTGGGTGCCTGTAATACCAGCTACTTGGGAGGCTGAGGCAGGAGAATCACTTGAACCCGGGAAGCAGAGATTGCAGTGAGCTGAGATCCTGCCATTGCATTCCAGCCTGGGCAACAAGAGCAAAACTCCATCTC"
"chr7","125021897","125022507","JH378118","18053084","18053501","263","106968813","GGCCAGGCACGGTGGCTCACACCTGTAATCCCAACACTTTGGGAGGCCAAGGCAGGTGGATACCTGAGGTCAGGAGTTCAAGACCAGCCTGGCCCACATGGTGAAACCCCATCTCTACTAAAAACACAAACATTGGCCAGGCGCAGTGGCTCACGCCTGTAATCCCAGCACTTTGGGAGGCTGAGGTGGGAGGATCACGAGGTCAGGAGATCGAGACCATCCTGGCTAACACAGTGAAACCCCATCTCTACTTAAAATACAAAAAATTAGCCAGGCGTGGTGGCAGGCACCTGTAGTCACAGCTACTTGGGAGGCTGAGGCAGAGGAATGGCGTGAACCCGAGAGGCGGAGCTTGCAGTGAGCAGAGATTGTGCCACTGCACTTCAGCCTGGGCGACAGAGTGAGACTCCGTCTCAAAAAAAAAAAAAACACACACACACACAAAAATTAGTTGGGCGTGGTGGTGGGCACCTATAATCCCAGCTAGTCAGGAGGCTAGGGCACAAGAATTGCTTGAACCTGAGAAGTGGAGGTTGCAGTGAGCCAAGATCATACGATTGCACTCCAGCCTGGGCAACAAGAGCGAGACTCCATCTCAAAAAAAAAAAAAA","GGCTGGGCGCAGTGGCTCACACCTGTAATCCCAGCACTTAGGGAAGCTGAGGCGAGTAGATCACCTGAGGTCAGGAGTTAGAGACCAGCCTGGCCATCATGGTGAAACCCCGTCTCTACTAAAGATACCAAAAATTAGCTGAGTGTGGTGCTGGGTGCCTGTAATCCCAGAAACTCAGGGTGCCTGTAATCCCAGCAACTCAGGGTGCCTTTAATCCCAGCAACTGAGGGTACCAGTAATCCCAGCAACTCAGGGTGTCTTTAATCCTAGCAACTGAGGGCACCTGTAATCCCAGCAACTCAGGAAGCTGAGACAGGAGAAGTACTTGAACCCAGAAGGCAGAGGTTGCAGTGAGCCGATATTGCACCATTGCACTCCAGTCTGGGCAACAAGAGTGAAACTCTGTCTCAAAAAAAAA"
"chr7","125491537","125491901","JH378110","18893949","18894277","93","106597588","CTTGCCCTAGAGATGGAGGTTGCAGTAAGCCGAGATCACGCCATTGCACTCCAACCTGGGCAACAAGAGGGAAACTCCATCTCAAAAAAAAAAAGGAACATGAGGTCAGGAGTTCGAGACCAGCCTGACGGACATGGTGAAACCCTGTCTCTACTAAAAACACAAAAATTAGCCAGGCTTGGTGGCACGCACCTGTAATCTCAGCTACTCGGGAGGCTGGGGCAGGAGAATCACTTGAACCTGGGAGGCGGAGGTTGCAGTGAGCTGAGATTGTGCCATTGCACTTCAGCCTGGGCAACAAGAGAGAAACTCCGTCTCAAAAACAAAAAAAAAAACCCAAAAAACAAAACAAACAAACAAAAAAA","GCCGGGCGTGGGGGCTCATTCCTGTAATCCTAGCAGTTAGGGATGCTTCAGGCAGGCGGATGACCTGAGGTCAGCAGTATGAGACCAGCTTGGCTAACATGGTGAAATCCCGTTTCTACTTAAAACACAAAAATTAGCCGGGCATGGTGGCTTGTGCCTGTAATCCCAGCTACTCGGGAGGCTGAGGCAGGAGAATTGCTTGAACCTGGGAGGCAGAGGTTGCAGTGAGCCAAGACAGTGCCATTGCACTCCAGCTTGGGCAACAAGAGTGAAACTCCGTCTCAAAAACAAACAAACAAACAAACAAACAAACAAACAAACAAACAAAC"
"chr7","126222920","126223525","JH378118","18053084","18053501","259","108169836","GGCCAGGCGCGGTGGCTCACGCCTGCAATCCCAGCAATTTGGGAGGCCACGATGTAGGGATCACCTGAGGTCAGGAGTTCGAGACCAGCCTGGCCAACACAGCGAAACCCTGTATCTACTAAAAAATACAAAAAAAAAAAAAAAAAAAAGCCGGGCACGATGGCTCACACCTGTAATCCCAGCACTTTGGGAGGCTGAAGCGGGTGGATCACGAGGTCAGGAGTTTGAGACCAGCCTGACCAACATGGTGAAATCCCGTCTCTACTAAATATAAAACTTAGCCGGGCATGGTGGCATGCACCTGTAATCCCAGCTACTCAGGAGGCTGAGACAGGAGAATCGCTTGAACCCAGGAGGCGGAGGTTGCAGTGAGCCAAGATCACGCCATTGCACTCCAGCCTGTGTGACAGAGCGAGACTCCGTCTCAAAATAAAATTAAAAAAAAATTAGCTGGGTGTGGCAGCGGGAGCCTGTAATCCCAGCTATTTGGGAGGCTGAAGTAGGAGAATCGCTTGAACCTGGGAGGCCGAGGTTGCAGGGAGCCTAGATTGTGCCACTACACTCCAGCTTGGGCGGTAAGACTGAAAACTCTGTCTCAACAAAAAA","GGCTGGGCGCAGTGGCTCACACCTGTAATCCCAGCACTTAGGGAAGCTGAGGCGAGTAGATCACCTGAGGTCAGGAGTTAGAGACCAGCCTGGCCATCATGGTGAAACCCCGTCTCTACTAAAGATACCAAAAATTAGCTGAGTGTGGTGCTGGGTGCCTGTAATCCCAGAAACTCAGGGTGCCTGTAATCCCAGCAACTCAGGGTGCCTTTAATCCCAGCAACTGAGGGTACCAGTAATCCCAGCAACTCAGGGTGTCTTTAATCCTAGCAACTGAGGGCACCTGTAATCCCAGCAACTCAGGAAGCTGAGACAGGAGAAGTACTTGAACCCAGAAGGCAGAGGTTGCAGTGAGCCGATATTGCACCATTGCACTCCAGTCTGGGCAACAAGAGTGAAACTCTGTCTCAAAAAAAAA"
"chr7","126542436","126543000","JH378118","18053084","18053501","224","108489352","GGCCAGGCATGGTGGCTCATGCCTGTAATCCCAACACTTTGGGAGGCCAAGGTGTGGATCATCTAAGGTCATTAGTTCAAGACCAGCCTGACCAACATGGTGAAACCCCATCTCTACTAAAAATACAAAAATTAGCTAAAGCCGGATGAAGTGGCTCACGCCTGTAATCCCAGCACTTTGGGAGACTGAGGCGGGCAGATCACCTGATGTCAGGAGTTCAAGACCAGCCTGGCAAACATGGTGAAACCCCGTTTCTACTAAAAATACAAAAATTAGCCAGGGGCTGAGGCGGGAGAATTGCTTGAACCTGGGAAGCAGAGGTTGCAGTGAGCCAAGATTGCACCACTGCACTCCAGCCTGGGCAACAACAGCGAAACTCAGGCTCAAAAAAAGAAAAAAATTAAGTGAGTGTGGTGGTGGGCGTCTGTAATCCCAGCTACTCGGGAGACTGAGGCAGGAGAATTGTTTGGACCTGACAGGCGGACGTTGCAGTGAGCCGAGATCACGCCATTGCACTCCAGCCTGGGCAACAAGAGCGAAACTCCGTCTCAAAAGAAAAAAGAAA","GGCTGGGCGCAGTGGCTCACACCTGTAATCCCAGCACTTAGGGAAGCTGAGGCGAGTAGATCACCTGAGGTCAGGAGTTAGAGACCAGCCTGGCCATCATGGTGAAACCCCGTCTCTACTAAAGATACCAAAAATTAGCTGAGTGTGGTGCTGGGTGCCTGTAATCCCAGAAACTCAGGGTGCCTGTAATCCCAGCAACTCAGGGTGCCTTTAATCCCAGCAACTGAGGGTACCAGTAATCCCAGCAACTCAGGGTGTCTTTAATCCTAGCAACTGAGGGCACCTGTAATCCCAGCAACTCAGGAAGCTGAGACAGGAGAAGTACTTGAACCCAGAAGGCAGAGGTTGCAGTGAGCCGATATTGCACCATTGCACTCCAGTCTGGGCAACAAGAGTGAAACTCTGTCTCAAAAAAAAA"
"chr7","126582939","126583496","JH378206","6546474","6546861","227","120036465","CGGATCACCTGAGGTCAGGAGTTCAAGACCAGCTTGCCCAACATGGCAAAACCCCGTCTCTACTAAAAACGAAAAATTAGCTGGGCGTGGTGGCTGTCACCTGTAATCCCAGCACTTTGGGAGGCTGAGGTGGGCAGATCACGACGTCAGAAGATCGAGACCATCCTGGCTAACACGGTGAAACCCGGTCTCTACTAAAAATAAAATTTAAAAAAATAGCTGGGCATAGTGGCAGGCGCCTGTAGTCCCAGCTACTCGAGAGCCTGAGGCAGGAGAATGGTGTGAACCAAGGAGGTGGAGCTTTCAGTGAGCCAGGATCGTGCCACTGCACTCCAGTCTGGGTGACAGAGCGAGACTCCGTCTCAAAAAAAAAAAAAAATTAGCCAGTCGTGGTGGCAGGCGCCTGTAATCTCAGCTACTCAGGAGGCTGAGACAGGAGAATTGCTTGAACCCAGGGGGCAGAGGCTGCAGTGAGCCGAGATTGCACCTGGGTGACAAGAGCCTGGGCGTCAAGAGTGAAACTCCGTCAAAAAAAAAAAAAAAAAAAACAGAAGAAAA","GGCCACACATGGTGGCTAACGCCTGTAATCCCAGCACTTTGGGAGGCCAAGTCGGGTGGATCATGAGGTCAGGAGACCAAGACCATCCTGGCCAAATGGTGAAACCCCGTCTCTACTAAAAATACAAAAATTAGCTGGGCATGGTGGCGTGTGCCTGTAATCCCAGCTACTCAGGAGGCTGAGGCAGGACAATTGCCTGAACCCAGGAGAATTAGCTGGGCATGGTGGCGTGTGCCTGTAATCCCAGCTACTCAGGAGGCTGAGGCAGGACAATTGCCTGAACCCAGGAGGCGAAGGTTGCGGTGAGCCGAGATTGTGCCATTGCACTCCAGCCTGGGTAACAAGAGCGACACTCTGTCTCAAAAAAAAAAAAAAAAAAAAAAAAAAA"
"chr7","127016366","127016692","JH378192","5296515","5296837","54","121719851","GCCAAGTGTGATGGCTCACGTCTGTAATCCCAGCACTTTGGGAGGCCTGGGTGGGTGGATTACCTGAGTTCAGGAGTTTGAGACCAGCCTGGCTAACATAGTGAAACCCCATCTCTACTAAAAACACAAAAAATTAGCCAGGTGTGGTGACACATGCCCGTAATCCTAGCTACTTGGGAGGTTGAGGCAGGAGAATTGCTTGAACCTGGGAGGCAGAGGTTGCAGTGAGCTGAGATCGCACAATAGCACTCCAGCCTGGGCGACAAGAGTGAAATTCCCTCTCAAAACAAACAAACAAACAAACAAACAAAACAACAACCAAAAAAA","GGCTAGGTGCAGTGGCTCACACCTGTGATCCCAGCACTTTGGGAGGCCAAGGCGGGTGGATCACATAAGGTCAGGAGTTTGAGATCAGCCTGGCTAACATGGTGAAACCCCATTTCTACTAAAAATACAAAAAATTAGCTGGATATGGTGGCGTGTGCCTGTAATCCCAGCTACTTGGGAGGCTGAGACAGGAGAATCACTTGAACCCAGGAGGCAGAGGTTGCAGTGAGCTGAGATTGTGCCATTGCACTCCAGCTTGGACAACAAGAGCAAAACTCCGTCTCAAAAAACAAACAAACAAACAAACAAACAAAAAAAAAAAC"
"chr7","135138313","135139231","JH378118","18053084","18053501","534","117085229","GGCCGGGCACTGTGGCTCACGCCAGTAATCCCAGCATTTTGGGAGGCTGAGGCAGGCGAGTCACTTGAGGTCAGGAGTTCGAGAACAGCCTGACCAACATGGTGAAACCCCACCTCTACTAAAAATACAAAAATTAGGCCAGGAGCGGTGGCTCACGCCTGTAATCCCAGTACTTTGGGAGGCCAAGGCGGGGCACATTGTCTGAGCTCAGGAGTTCACGACCAGCCTGGGCATCATGGTGAAACCCCATCTCTAGTAAAAACACAAAAAATTAGCCAGGCGTGGCGGCGTGCGCCTGTAGTACCAGCTACTTGGGAGGCTGAAGCAGGAGAATTGCTTGAACCTGGGAGGTGGAGGTTGCAGTGAGCCTAGATCACGCCACTGCACTCCAGCCTGGGCGACAGAGCAAGACTCCATCTTAAAAAACTAAAAAAAAATAAAAAATACAGGCCAGGCGCAATAGCTCACGCCTGTAATCCCAGCACTTTGGGAGGCTGAGCTGGGCGGATCACCTGAGGTCAGGGGTTCGAAAACAGCCTGACCAACATGGAGAAACCCCGTCTCTACTAAAAAAATACAAAATTAGCGGGGTGTAGTGGCACATGCCTATAATCCCAGCTACTTGGGAGACTGAGGCAGGAGAATCGCTTGAACCCGGCAGGCAGAGGTTGCGGTGAGCCAAGATTGCGCCATTGCACTCCAGCCTGGGCAACAAGAGCGAAATTCCGTCTCAAAAAAAAAAAAAAAAAAAAAAAATTAGCCGGGCATGGTAGCAGGCACCTGTAATCCCAGCTACTCCGGAGGCTGAGGCATAAGAATCACTTGAATCTGGGAAGGCCAGAGCTGCAGTGAGCCAAGACCGCCGCATTGCACTCCAGCCTGGGCAACAAGAGCGAAACTCTGTTAAAAAAAAAAAAAA","GGCTGGGCGCAGTGGCTCACACCTGTAATCCCAGCACTTAGGGAAGCTGAGGCGAGTAGATCACCTGAGGTCAGGAGTTAGAGACCAGCCTGGCCATCATGGTGAAACCCCGTCTCTACTAAAGATACCAAAAATTAGCTGAGTGTGGTGCTGGGTGCCTGTAATCCCAGAAACTCAGGGTGCCTGTAATCCCAGCAACTCAGGGTGCCTTTAATCCCAGCAACTGAGGGTACCAGTAATCCCAGCAACTCAGGGTGTCTTTAATCCTAGCAACTGAGGGCACCTGTAATCCCAGCAACTCAGGAAGCTGAGACAGGAGAAGTACTTGAACCCAGAAGGCAGAGGTTGCAGTGAGCCGATATTGCACCATTGCACTCCAGTCTGGGCAACAAGAGTGAAACTCTGTCTCAAAAAAAAA"
"chr7","135219978","135220573","JH378118","18053084","18053501","240","117166894","GGCCGGGCGCAGTGGCTCATGCCTGTAATCCCAGCACTTTGAGAGGCCGAGGTGGGTGGATCACCTGAGGTCAGGAGTTCAAGACCAGCCTGGCCAACATGGTGAAACCCCATATCTACAAAAATACAAAAATTAGGCTGGGCACGGTGGCTCACGCCTGTAATCCCAGCACTTTGGGAGGCCGAGGCAGGTGGATCACGAGGTCAGGAGATCCAGACCATCCTGGCTAACACGGTGAAAGCCCGTCTCTACTAAAAATACAAAAAATTAGCTGGGCATGGTGGTGGGCACCTGTAGTCCCAGCTACTCAGGAGGCTGAGGCAGGAGAATGGCGTGAACTCGGGAGGCGGAGCTTGCAGTGAGCCAAGTTCGTGCCACTGCACTCCAGCCTGGGCTACAGAGTGAGACTCCGTCTCAAAAAAAAAAAAAAATTTAGCCTCACATAATGGCAATGCCTGTAATCCTAGCTACTCGGGAGGCTGAGATGGAAGAATCGCTTGAATCCAGGAGGCAGAGGTTGCAGTGAGCCAAGATTGTGCCATTGCATTCCAGCCTGGGCCACAAGAGCGACACTGTCTCAAAAAAAAAAAAAAAAA","GGCTGGGCGCAGTGGCTCACACCTGTAATCCCAGCACTTAGGGAAGCTGAGGCGAGTAGATCACCTGAGGTCAGGAGTTAGAGACCAGCCTGGCCATCATGGTGAAACCCCGTCTCTACTAAAGATACCAAAAATTAGCTGAGTGTGGTGCTGGGTGCCTGTAATCCCAGAAACTCAGGGTGCCTGTAATCCCAGCAACTCAGGGTGCCTTTAATCCCAGCAACTGAGGGTACCAGTAATCCCAGCAACTCAGGGTGTCTTTAATCCTAGCAACTGAGGGCACCTGTAATCCCAGCAACTCAGGAAGCTGAGACAGGAGAAGTACTTGAACCCAGAAGGCAGAGGTTGCAGTGAGCCGATATTGCACCATTGCACTCCAGTCTGGGCAACAAGAGTGAAACTCTGTCTCAAAAAAAAA"
"chr7","138483123","138483709","JH378118","18053084","18053501","245","120430039","GGCCGGGTGCAGTGGCTCACGCTTGTATTCCCAGCACTTTGGGAGGGCGAGGCACGTGGATCATCTGAGATCAGGAATTTGAGACCAGCCTGGCCAACATGGTGAAACCCCGTCTCTACTAAAAATACAAAAATTAGCTGGGTGAAGGCTGGGTACGGTGGCTCACGCCTGTAATCCCAGCACTTTGGGAGGCTGAAGTGGGCAGATCACGAAGTCAGGAGATCAAGACCATCCCGGCTAACACACTGAAACCCCATCTCTACTAAAAAAATACAAAAAGTTAGCCAGGCATGGTGGCGGGCACCTGTAGTCCCAGCTACTCGGGAGGCTGAGGTAGGAGAATGGCATGAACCCGGGAGGCGGAGCTTGAAGTGAGCCAAGATCGCACCACTGCACTCCAGCCTGGGCGACAGAAGGAGACTCCATCTCAAAAAAAAAAAAAAAAAAATTAGCTGGGCGTGGTGGCAGGTGTCTGTAATCCCAGCTACTCAGGAGAATTGCTTGAACCCGGGAGGTAGAGGTTGCAGTGAGCCAAGATTGCACCATTGTACTCCAGCCTGGGTGACAAGAGCAAAACTCCATCTCAA","GGCTGGGCGCAGTGGCTCACACCTGTAATCCCAGCACTTAGGGAAGCTGAGGCGAGTAGATCACCTGAGGTCAGGAGTTAGAGACCAGCCTGGCCATCATGGTGAAACCCCGTCTCTACTAAAGATACCAAAAATTAGCTGAGTGTGGTGCTGGGTGCCTGTAATCCCAGAAACTCAGGGTGCCTGTAATCCCAGCAACTCAGGGTGCCTTTAATCCCAGCAACTGAGGGTACCAGTAATCCCAGCAACTCAGGGTGTCTTTAATCCTAGCAACTGAGGGCACCTGTAATCCCAGCAACTCAGGAAGCTGAGACAGGAGAAGTACTTGAACCCAGAAGGCAGAGGTTGCAGTGAGCCGATATTGCACCATTGCACTCCAGTCTGGGCAACAAGAGTGAAACTCTGTCTCAAAAAAAAA"
"chr7","138499129","138499721","JH378118","18053084","18053501","243","120446045","GACCAGGCTCAGTGGCTCACGCCTGTAATCCCAGCACTTTGGGAGGCTGAGGTCAGTGGATCACCTGAGGTCAGGAGTTTGAGACGAGCCTGGCTAACATGGTGAAACTCCATCTCTACTAATAATACAAAAATTAGCCGGACTTCGCTGGGCGTGGTGGCTCACACCTGTAATCCCAGCACTTTGGGAGGCCGAGGCGGGCGGATCACGAGTTCAGGAAATCGAGACCATCCTGGCTAACATGGTGAAACCCCGTCTCTACTAAAAATACAAAAAATTAGCAGGGCGTGGTGGCTGGCACCTGTAGTCCCAGCTACTCGGGAGGCTGAGGCAGGAGAATGGCGTGAACCTGGGAGGCAGAGCTTGCAGTGAGCTGAGATGGCACCACTGCATTCCAGGCTGGGCGACAGAGTGCATCTCTGCCTCAAAAAAAAAAAAAAAAATTAGCCGGACATGGTGGTGCACGCCTGTAATCCCAACTACTCAGGAGGTTGAGGCAGGAGAATCGCTTGAACCCAGGAGGGAGAGGTTGCAGTGGGCCGAGATTACACCATTGCACTCCAGCCTGGGTGACAAGAGTGAAACTCTGTCTC","GGCTGGGCGCAGTGGCTCACACCTGTAATCCCAGCACTTAGGGAAGCTGAGGCGAGTAGATCACCTGAGGTCAGGAGTTAGAGACCAGCCTGGCCATCATGGTGAAACCCCGTCTCTACTAAAGATACCAAAAATTAGCTGAGTGTGGTGCTGGGTGCCTGTAATCCCAGAAACTCAGGGTGCCTGTAATCCCAGCAACTCAGGGTGCCTTTAATCCCAGCAACTGAGGGTACCAGTAATCCCAGCAACTCAGGGTGTCTTTAATCCTAGCAACTGAGGGCACCTGTAATCCCAGCAACTCAGGAAGCTGAGACAGGAGAAGTACTTGAACCCAGAAGGCAGAGGTTGCAGTGAGCCGATATTGCACCATTGCACTCCAGTCTGGGCAACAAGAGTGAAACTCTGTCTCAAAAAAAAA"
"chr7","138664363","138664612","JH378149","16315215","16315453","63","122349148","CCAGCCTGGGCAACAAAGTGAAATTCTGTCTCAAAAAAAACAAAACAAAACAAAACAAAACCCAGTCTCTACTAAAATACAAAAATTAGCCAGGTATGGTGGTGTGTCCCTGTAGTTCCAGCTACTGGGGAGGCTGAGGCAGGAGAATCACTTGAACCAGGGAGGCGGAAGTTGCAGTGAGCTGAGATCGTGCCATTGGACGCCAGCCTAGGCAACAAGACTGAAACTCGGTCTCAAAAACAATAAAGAA","GATCACCTGAGGTCAGGAGTTCAAGACCAGCCTGACCAACATGGTAAAACCCTGTCTCTACTAAAAATACAAAAATAGCTGGGCATGGTGGAGGATGCCTATAATTCCAGCTACTTGGCAAGCTGAGGCACTAGAATCACTTGAACCCAGGAGGTGGAGGTTGCAGTGAGCTGAGATCGCGCCATTGCACCCCAGCCTGGGCAACAAGAGCGAAACTCCATCTCAAAAAAAAAAAAAAA"
"chr7","138698145","138698740","JH378118","18053084","18053501","252","120645061","GGCTGGGCGTGCTGTCTCACGCCTGCAATCCAGCACTTTGGGAGGCCGAGGTGGGCGTATCATCTGAGGTCAGGAGTTCGAGACCAGCCTGGCCAACGTGTTGAAACCCCATCTCTACCAAAAACACAAAAATTAGGCCAGGTGCGGTGGCTCATACCTGTAATCCCAGCACTTTGGGAGGCCGAGGGGGTTGGATCACCTGAGGTTGGGAGTTCGAGACCATCCTGACCAACGTGGAGAAACCCCGTCTCTACTAAAAATACAAAATTAGCTGGGCGTGGTGGCACATGCCTATAATCCCAGCTACTCAGGAGGCTGAGGCAGGAAAATGGCTTGAACCCAGGAGGCAGAGGTTGCGGTGAGCCAAGATCGTGCCATTGCACTCTAGCCTGGGCAACAAGAGTGAAACTCTGTCTCAAAAAAAAAAAAAAAAAATTAGCTGGTCATGGTGGCAGGTGCCTGTAATTCCAGCTACTTGGGAGGCTGAGGCAGGAGAATCGCTTGAGCCTGGGAGGTGGAGGTTTCGGTGAGCCAAGATCATGTCATTGAACTCCAGCCTGGGCAACAAGAGTAAAACTCAGTCTCCAAAAAGAAAA","GGCTGGGCGCAGTGGCTCACACCTGTAATCCCAGCACTTAGGGAAGCTGAGGCGAGTAGATCACCTGAGGTCAGGAGTTAGAGACCAGCCTGGCCATCATGGTGAAACCCCGTCTCTACTAAAGATACCAAAAATTAGCTGAGTGTGGTGCTGGGTGCCTGTAATCCCAGAAACTCAGGGTGCCTGTAATCCCAGCAACTCAGGGTGCCTTTAATCCCAGCAACTGAGGGTACCAGTAATCCCAGCAACTCAGGGTGTCTTTAATCCTAGCAACTGAGGGCACCTGTAATCCCAGCAACTCAGGAAGCTGAGACAGGAGAAGTACTTGAACCCAGAAGGCAGAGGTTGCAGTGAGCCGATATTGCACCATTGCACTCCAGTCTGGGCAACAAGAGTGAAACTCTGTCTCAAAAAAAAA"
"chr8","10524672","10525442","JH378118","18053084","18053501","396","7528412","GGCCTGGCGCGGTGGCTCACTCCTGTAATCCCAGCACTTTGGGAGGCCGAGGTGGGCGGATCACCTGAGGTCAGGAGTTTGAGATCAGCCTGACCAAGATGATGAAACCCTGTCTCTACTAAAAATACAAAAAATTAGCTGGGCGTGGTGGCTTTCACTCATGTCCGTGTGAAGAGACCACCAAACAGGCTTTGTGTGAGCAACAAGGCTGTTTATTTCACCTGGGTGCAGGCGGGCTGAGTCCGAAAAGAGAGTCAGCGAAGGGAGATAGGGGTGGGGCCATTTTATAGGATTTGGGTAGGTAAAGGAAAATTACAGTCAAAGGGGGATTGTTCTCTGGTTGGCAGGGGTGGGGGTCACAAGGTGCTCAGTGGGGAGCCTTTGAGCCAGGATGAGCCAGGAGAAGGAATTTCACAAGGTAATGTCATCAGTTAAGGCAGGGACCAGCCATTTTCACTTCTTTTGTGGTGGAATGTCATCAATTAAGGCAGGAACAGGCCATTTTCACTTCTTTTGTGATTCTTCAGTTACTTCGGGCCATCTGGATGTATACGTGCAGATCACAGGGGATATGATGGCTTAGCTTGGGCTCAGAGGCCTGACAGTGGCAGGCGCCTGTAATCCCAGCTACTGGGGAGGCTGAAGCAGGAGAAGTGCTTGAACCTGGGAGGCATAGGTTGCAGTGAGCCGAGATCGTGCCATTGCACTCCAGCCTGGGCAACAAGAGTAAAACTCTGTCTCAAAACAAACAAAAACACAAAACAAAACAAA","GGCTGGGCGCAGTGGCTCACACCTGTAATCCCAGCACTTAGGGAAGCTGAGGCGAGTAGATCACCTGAGGTCAGGAGTTAGAGACCAGCCTGGCCATCATGGTGAAACCCCGTCTCTACTAAAGATACCAAAAATTAGCTGAGTGTGGTGCTGGGTGCCTGTAATCCCAGAAACTCAGGGTGCCTGTAATCCCAGCAACTCAGGGTGCCTTTAATCCCAGCAACTGAGGGTACCAGTAATCCCAGCAACTCAGGGTGTCTTTAATCCTAGCAACTGAGGGCACCTGTAATCCCAGCAACTCAGGAAGCTGAGACAGGAGAAGTACTTGAACCCAGAAGGCAGAGGTTGCAGTGAGCCGATATTGCACCATTGCACTCCAGTCTGGGCAACAAGAGTGAAACTCTGTCTCAAAAAAAAA"
"chr8","11096450","11096845","JH378107","47223300","47223634","96","36126850","GGCTGGGCATGGTGGCTCACGCCTGTAATCCCAGCACTTTGGGGGTCTAAGGCGGGTGGATCACCTGAGTTCAGGAGTTCGAGACCAGCCATAGCTAACGTGGTAAAACCCGGTTTCTACTAAAAATACAAAAAATTAGTCGGGCATGGTGGTGCATGCCTGTAATCCCAGCTACTTGGGAGGCTGAGGCAGGAGAATCTCTTGAACCCAGGAGACGGATGTTGCAGTGAGCTGAGCTCGTGCCATTGCACTGCAGCTTGGGCAACAAGAGCAAAATTCTGTCTCAAAAGGAAGGAAGGAAGGAAGGAAAGAAAGGAAGAAAGGAAGAAAGGAAGAAAGGAAGAAAGGAGGAAGGAAGGAAGGAAGGAAGGAAAGAAAGAAAGAAAAGAAAAGAAA","GCTGGGCGCAGTGGCTCATGCCTGTAAGCCCAGAACTTTGGGAGGTCAAGGCGGTGGATCACCTCAGGTCAGGAGTTCAAGATCATCCTGGCTAACGTGGTGAAACTCCATTTCTACTAAAAATACAAAAAATTAGCCAGGCATGGTGGTGCATGCCTGTAGTCCCAGCTACTTGGGAGGCTGAGGCAGAAGAATTGATTGAACCCAAGGCAGAGGTTGCAGTGAACTGAGATTGTGCCATTGAACTACAGCTTGGGCAATAAGAGCAAAACTCTGTCAAGAAAGAAAGAAAGAAAGAAAAAGAAAGAAGGAAAAGAAAAGAAAAGAAAAAAGAA"
"chr8","16034245","16034584","JH378129","14372468","14372787","56","1661777","GGCCAGGTGTGGTAGCTCACACCTGTAATCCCAACACTTTGGGAGGCCGAGGCAGGCAGATCACGAGGTCAGGAGTTCGAGACCATCCTAACCAACACGGTGAAACCCTGTCTCTACTAAAAATACAAAAAATTAGCTGGGCCTGGTGGCGGGCGCCTATAATTCCAGCTACTCGGGAGGCTGAGGCAGGAGACTCACTTGAACTCAGGAGGCAGAGGTTGCAGTGAGCCAAGATCGCGCCATTGCACTCCAGCCTGGGCAACAAGAGTGAAACTCCGTCTCACACACACACACACGTACGCACACACACACACACACACAATAAATAAATAAATAAAAA","GCCGGGCGCGGTGGCTCAAGCCTGTAATCCCAGCACTTTGGGAGGCCGAGGCGGGTGGATCACGAGGTCAAGAGATCGAGACCATCCTGGTCAACATGGTGAAACCCCGTCTCTACTAAAAATACAAAAAATTAGCTGGGCATGGTGGCGGGTGCCTGTAATCCCAGCTACTCAGGAGGCTGAGGCAGGAGAATTGCCTGAACCCAGGAGGCAGAGGTTGCGGTGAGCCGAGATGGCGCCATTGCACTCCAGCCTGGGTAACAAGAGCGAAACTCCGTCTCAAAACAAAACAAAACAAAACAAAACAAAACAAAAAAAAC"
"chr8","18216700","18217020","JH378137","18493129","18493435","43","276429","GGCCGAGTGGGGTGGCTCATGCCTGTAATCCCAGCACTTTGGGAGGCCAAGGTGGGCAGATCACCTGAGGTCAGGAGTTCATAACCAGCCTGGCCAACAGGGTAAAACCCCATCTCTACTAAAAATACAAAAATTAGCTGGCCGTGTTGGCAGGCTCCTGTAATGCCAGCTACTTGGGAGGCTGAGGCAGGAGAATCGCTTGAACCCAGGATGTGGAGGTTGCAGTGAGCCGAGATCAGGCCATTGCACTCCAGCCTGGGGAAGAAGAGCGAAACTCCATCTCAAAATCAATCAATCAATCAATCAATCATAAAAAGAGAA","GGCCGGGCGTGGTGGCTCATGCCTGTAATCCCAGCACTTTGGGAGGCCAAGGTGGGCGGATCACCTGAGGTCAGGAGTTCGAGACCAGCCTGACCAACATGGTGAAACTCCATCTCTACTAACAATACAAAAATTAGCTGGGCAGGGTGGCAGACGCCTGTAATTCCAGCTACTTGGGGGGCTGAGGCAAGAGAATCACTTGAACCCAGGAAGCAGAGGTTGCAGTAAGCCGAGATCACGCCATTGCACTCCAGCCTGGGCAACAAGAGCGAAACTCCATCTCAAAACAACAACAACAATAAAAGAA"
"chr8","20765089","20765693","JH378118","18053084","18053501","266","2712005","GGTGGCTCATGCATGTAATCCCAGCACTTTGGGAGGCTGAGGTGGGTGGATCACCCGAGGTCAGGGCTTTGAGACCAGCCTGGCCAACATGGTGAATCCCCGTCTCTACTAAAAATACAAAAATTAGGCCGGGCGCGGTGGCTCACGCCTGTAATGCCAGCACTTTGGGAGGCTGAGGGGGGGCGGATCACGAGGTCAGGAGATCAAGACCATCTTGGCTAACACGGTGAAACCCCTTCTCTACTAAAAAATAAAAAAAAATTAGCCAGGCATGGTGGTGGGCGCCTGTAGTCCCAGCTACTTGGGAGGCTGAGGCAGGAGAATGACGTGAACTTGGGAGGCAGAGCTTGCAGTGAGCCGAGATCGTGCCACTGCACTCCAGCCTGGGCAACAGAGCAAGGCTCTGTCTAAAAAACAAACAAACAAACAAAAAAATTGTCTGGGCGTGGTTGTGGGCGCCTGTAATTCCAGCTACTCGAGAAGCTGAGGCATGAGAGTCGCTTGAACTTGAGAGGCAGAGGTTGCAGTGAGCCTAGATCGTCCCATTGCACTCCAGCCTGGGCGACAAGAGAGAAACTCCATCTCAAAACAAAACAAAACAAAAA","GGCTGGGCGCAGTGGCTCACACCTGTAATCCCAGCACTTAGGGAAGCTGAGGCGAGTAGATCACCTGAGGTCAGGAGTTAGAGACCAGCCTGGCCATCATGGTGAAACCCCGTCTCTACTAAAGATACCAAAAATTAGCTGAGTGTGGTGCTGGGTGCCTGTAATCCCAGAAACTCAGGGTGCCTGTAATCCCAGCAACTCAGGGTGCCTTTAATCCCAGCAACTGAGGGTACCAGTAATCCCAGCAACTCAGGGTGTCTTTAATCCTAGCAACTGAGGGCACCTGTAATCCCAGCAACTCAGGAAGCTGAGACAGGAGAAGTACTTGAACCCAGAAGGCAGAGGTTGCAGTGAGCCGATATTGCACCATTGCACTCCAGTCTGGGCAACAAGAGTGAAACTCTGTCTCAAAAAAAAA"
"chr8","21632406","21633023","JH378153","2355361","2355755","270","19277045","GGCCAGGCACGGTGGCTCACGCCTGTAATCCCAATACTTTGGGAGCCCAAGGGAGGCGGATCACCTGAGGTCAGGAGTTTGAGACCAGCCTGGCCAACATGGTGAAACCTCATCTCTACTAAAAATACAAAAAAAATGGCCAGGCTCGGTGGCTCACACCTGTAATCCCAGCACTTCAGGAGGCCAAAGTTGGCGGATCATGAGATCAGGAGTTCGAGACCAGCCTGGCCAATATGGTGACACCCTGTCTCTACTAAAAATACTAAAATTAGTCGGGCATGGTGGCGCACAACTGTAGTCCCAGCTACTCAGGAGGCTGAGGCAGGAGAATTGCTTGAACCCGGGAGGCGGAGGTTGCAGTGAGCCAAGATCACACCACTGCACTCCAGCCTGGGTGACAGAGCGAGACTCTGTCTAAAAAAAAAAAAAAAAAAACCCTGGGTGTGGTGGTGGACACCTGTAATCCCAGGTACTTGGGAGGCTGAGGCAGGAGAATCACTTGAACCCAGAAGGCAAAAGTTGCAGTGAGCTGAGATCGTGCCATCACACTCCAGCCTGGAGGACAAGAGCGAGACTTCATCTAAAAAAAAAAAAAAAAAAAAAAAAAAGGAAAAAAAA","GGCGGGGCATGGTGGCTCACACCTGTCATCCCAACACTTTGGGAGGCTGAGGCAGGCAGATCACCTGAGGTCAGGAGTTTGAGACCAGCCTGGCCAACATGGTGAAACCCCATCTCTACTAAAAATACAAAAATACAAAAAACCCCATCTCTACTAAAAATACAAAAAGCTTGTCTCTATTAAAAATACAAAAAACAAAAAACAAACAAAAAAAAAACCACCATGGTGGTGGGTGCCTATAATCCCAGCTACTCGGGAGGCTGAGGCAGGAGAATCGCTTGAACCCAGGAGGCAGAGGTTGCAGTGAGCCAAGATCCCACCATTGCACTCCAGCCTGGGCAACAGAGAGAGAGACTCTGCCTCAGAAAAAAGAAAGAAAGAAAGAAAGAAAGAAA"
"chr8","22907309","22907634","JH378314","538162","538484","51","22369147","GGCCCGGTGCGGTGGCTCATGCCTGTAATCCCAGCATTTTGGGAGGCCAAAGCAAGTGGACATCTGAGGTCAGGAGTTTGAGACCAGCCTGGCCAACATGGTGAAACTGTGTCTCTACTAAAAAAAAAAAAAAAAAAAAAAAAAAAATTACAAAAATTAGCTGGGCGTGGTGGCAAGAGCTGTGATCCCAGCTCCTCGGGAGGCTGACGCAGGAGAATCGCTTGAACCCGGGAGGCGGAGGTTGCAGTGAGCCGAGATCATGCCATTGCACTTCAGCCTGGGTGACAAGAGTAAGACTTCATCTCAAAAAAAAATAGAAAAAAAAA","GGCTGGGTGCGGTGCCTCACACCTGTAATCCCAGCACTTTGGGAGGCCGAGGTGGGTGGATCACGAGGTCAAGAGATCAAGACCATCCTGGTCAACATGGTGAAACCCTGTCTCTACTAAAAAAAAAAAAAAAAAAAAAAAAAAAAAAAAAAAAATTAGCTGGGCATGGTGGCGTGTGCCTGTAATCCCAGCTACTCAGGAGGCTGAGGCAGGAGAATTGCCTGAACCCAGGAGGCGGAGGTTGCGGTGAGCCGAGACTGTACCATTGCACTCCAGCCTGGGTAACAAGAGCGAAACTCCATCTCAAAAAAAAAAAAAAAAAA"
"chr8","37023666","37024012","JH378120","14651551","14651882","64","22372115","GGCTGGGCGTAGTGGCTCACGCCTGTAATCCCAGCACTTTAGGAGGCCCAGGCGGGTGGATCACCTGAGGTTAGGATTTCGAAACCAGTCTGGTCGGCATGGTGAAACCCTGTCTCTACTAAAAACACAAAAAATTAGCTGGACATGGTGGCGGGTGCCTGGGTGCCTGTAATCCCAGTTACTCGGGAGACTGAGGTAGGAGAAATGCTTGAACCCAGGAGGTGGAGGTTGCAGTGAGCTGAGATCGTGCCACTGCACTCCAGCCTAGGCGACAAGAACGAAACTCCATCTCAAAATATGTATATATATATATATGTATTTATGTATATATAAATCAAAATGAAAAA","GGCCGGGCGCAGTGGCTCAAGCCTGTAATCCCAGCACTTTGGGAGGCCGAGGCGGGTGGATCACGAGGTCAAGAGATCGAGACCATCCTGGTCAACATGGTGAAACCCCGTCTCTACTAAAAATACAAAAAAATTAGCTGGGCATGGTGGCCTGTGCCTGTAATCTGAGCTACTCAGGAGGCTGAGGCAGGAGAATTGCCTGAACCCAGGAGGCGGAGGTTGCGGTGAGCCGAGATCGCGCCATTGCACTCCAGCCTGGGTAACAAGAGCGAAACTCCGTCTCAAAATAAATAAATAAATAAATAAATAAATAAATAAATAAATAAATAAAT"
"chr8","40568875","40569198","JH378116","10174930","10175258","68","30393945","GACGGGGTGGCTCATGCCTGTAATCCCATCACTTTGGGAGGCCAAGGCAGGCTGATCACCTGAGGTCAGGAGTTCAAGACTAGCCTGGCCAACATGGTGAAACTCCATCTCTACTAAAAAAATAAAAAATAAATAAATAAATAAATAAATAGAAAATACAAAAATTAACCAGGAATGGTGGCAGGCACCTGTAATCCCAGCTACTCGGGAGGCAGGAGAATTGCTCAAGCCCGGAAGGGGGGGATTGTGGTGAGCCAAGATCACACCACTGCACTCCAGCCTGGGTGACAAGAGCAGAACTGTCTCAAAAAAAAAAAAAAAAAA","GCCAGGTGTGGTGGCTCATGCCTGTAATCCCAGCACTTTGGGAGGCCCAGGCAGGTAGATCACCTGAGGTCAGGAGTTCAAGACCAGCTTGGCCAACATGATGAAACTGCATCTCTACTAAAAAGAAAAAAAGAAAAAAAAAGAAAAAAAAAGAAAAAGAAAAAAATAGCTGGGTGTGGTGGAGGGCACCTGTAATCCCAGCTGCTCAGGAAGCTGAAGGAGAATCGCTTGAAGACCAGGAGGTAGAGGTTGCAGTGAGCTGAGATCATGCCATTGCACTTTAGCCTGGGCAACAAGAGCAAAACTCTGTCTCAACAACAACAAAGAAA"
"chr8","41818006","41818616","JH378118","18053084","18053501","265","23764922","GCCTGGCATGGTAGCCAACACCTGTAATCCCAGCATTTTTGGGAGGCTGAAGCAGGAGGATCACCTGAGGTCAGGAGTTCGAGACCAGCCTGGCCAACATGGTGAAACCCCATCTCATCTCTATTAAAAATACAAAAATGAGTCCAGGCGAGGTGGCTCACGCCTGTAATCCCAGGACCTTGGGAGGTCGAGGCGGATGCATCACGAGGTCAGGAGATCAAAACCATCCTGGCGAACATGATGAAACCTCATCTCTACTAAAAACACAAAAAATTAGCCGGGCATGGTGGCACACGCCTGTAGTCCCAGTTACTCGGAAGGCTGAGGCAGGAGAATCTCTTGAACCTGGGAGGCGGAGATTGCAGTGAGCCGAGATCACGCCACTGCACTCCAGCCTGGGCGACAGGGCGAGACTCTGTCTCAAAAAAAAAACAAAAAAACAAAAACTAGCCAGGCGTGGTGACGAGCACCTGTAATCCCAACTACGCTGGAGGCTTAGGCAAGAGAATCGCTTGAACCCGGGAGACGGAGGTTGCAGTGAGTTACGATCGTGCCACTGGGCTCCAGCCTGGACGACAAGAGCAAAACTCCGTCTCAAAAGAAAAAAAAAA","GGCTGGGCGCAGTGGCTCACACCTGTAATCCCAGCACTTAGGGAAGCTGAGGCGAGTAGATCACCTGAGGTCAGGAGTTAGAGACCAGCCTGGCCATCATGGTGAAACCCCGTCTCTACTAAAGATACCAAAAATTAGCTGAGTGTGGTGCTGGGTGCCTGTAATCCCAGAAACTCAGGGTGCCTGTAATCCCAGCAACTCAGGGTGCCTTTAATCCCAGCAACTGAGGGTACCAGTAATCCCAGCAACTCAGGGTGTCTTTAATCCTAGCAACTGAGGGCACCTGTAATCCCAGCAACTCAGGAAGCTGAGACAGGAGAAGTACTTGAACCCAGAAGGCAGAGGTTGCAGTGAGCCGATATTGCACCATTGCACTCCAGTCTGGGCAACAAGAGTGAAACTCTGTCTCAAAAAAAAA"
"chr8","42211296","42211892","JH378118","18053084","18053501","242","24158212","GGCTGGGCGCGGTAGCACATGCCTGTAATCCCAGCACTTTGGGAGGCCATGGCAGGCAGATCACCTGAGGCCAGGAGTTCAAGATCAGCCTGGCCAACATGATGAAACCCCTTCTCTATCAAAAATACAAAAAGTGACTGGGTGTGGTGGCTCATAGCTGTAATCCCAGCACTTTGGGAGGCCAAGGCGGGTGGATCACCTGAGGTCAGGAGTTTGAAACCAGCCTGGCCAACATGGTGAAACCCCGTCTCTACTAAAAATACAAAAATTAGCCAGGTGTGGTGGCAGGCACCTGTAATCCCAGGTACTCAGGAGGCTAAGGCAGGAGAATCGCTTGAAACTGAGAGGCGGAGGTTACACTGAGCTTAGATAGTGCCACCACACTCCAGCCTAGGGAACAAGAGTGAGACTTCATCTAAAAAAAAAAAAAAAAATTAGCAGGGCGTGGTGGTAGGCACCTGTAATCCCAGCTACTCAGGACGCTGAGGCAAGAGAATCACTTGAACCCGGTAGGCAGAGGTTGCAGCGAGGCCGAGATCACGCCATTGCACTCCAGCCTGGGTGACAAGAGCAAGACTCCGTCTCAAAAAAAGAAAA","GGCTGGGCGCAGTGGCTCACACCTGTAATCCCAGCACTTAGGGAAGCTGAGGCGAGTAGATCACCTGAGGTCAGGAGTTAGAGACCAGCCTGGCCATCATGGTGAAACCCCGTCTCTACTAAAGATACCAAAAATTAGCTGAGTGTGGTGCTGGGTGCCTGTAATCCCAGAAACTCAGGGTGCCTGTAATCCCAGCAACTCAGGGTGCCTTTAATCCCAGCAACTGAGGGTACCAGTAATCCCAGCAACTCAGGGTGTCTTTAATCCTAGCAACTGAGGGCACCTGTAATCCCAGCAACTCAGGAAGCTGAGACAGGAGAAGTACTTGAACCCAGAAGGCAGAGGTTGCAGTGAGCCGATATTGCACCATTGCACTCCAGTCTGGGCAACAAGAGTGAAACTCTGTCTCAAAAAAAAA"
"chr8","45176710","45177309","JH378118","18053084","18053501","244","27123626","GCCAGGCGCATTGGCTCATACCTGTAATCCCAGCACTTTGGGAAGATGAGGTGGGTGGATCACCTGAGGTCAAGAGTTCAAGACCAGCCGGGCACAGTGGCTCACGCTTGTAATCCCAGCACTTTGGGAGGCCAAGGCGGGCGGATCACGAGGTCAGGAGATTGAGACCATCCTCACTAAATCGGTGAAACCCTGTCTCTACTAAAAATACAAAAAATTAGCCGGGCGTGGTGGTGGGCACTTGTAGTCCCAGCTACTCAGGAGGCTGAAGCAGGAGAATGGCGTGAACCTGGGAGGCAGAGCTTGCAGTGAGCCGAGATCGCACCACTGCACTCCAGCGTGGGCGACAGAGCAAGACTCCGTCTCAAAAAAAAAAAAAAGAGTTCAAGACCAGCCTGGCCAACATAGTGAAACCCTGTCTCTACTAAAAATACAAAAAATTAGCTGGGCATGGTGGCAGCTGCCTGTAAGCCCAACTACTAGGGAGGCTGAGACAGGAGAATCGCTTGAACCCAGGAGGCAGAGGTTGCAGTGAGCCGAGATCACGCCATTGCACTCCAGCCTGGGCAACAAGAGTGAAAATCCATCTTAAAAAAAAAA","GGCTGGGCGCAGTGGCTCACACCTGTAATCCCAGCACTTAGGGAAGCTGAGGCGAGTAGATCACCTGAGGTCAGGAGTTAGAGACCAGCCTGGCCATCATGGTGAAACCCCGTCTCTACTAAAGATACCAAAAATTAGCTGAGTGTGGTGCTGGGTGCCTGTAATCCCAGAAACTCAGGGTGCCTGTAATCCCAGCAACTCAGGGTGCCTTTAATCCCAGCAACTGAGGGTACCAGTAATCCCAGCAACTCAGGGTGTCTTTAATCCTAGCAACTGAGGGCACCTGTAATCCCAGCAACTCAGGAAGCTGAGACAGGAGAAGTACTTGAACCCAGAAGGCAGAGGTTGCAGTGAGCCGATATTGCACCATTGCACTCCAGTCTGGGCAACAAGAGTGAAACTCTGTCTCAAAAAAAAA"
"chr8","48193079","48193406","JH378293","1845184","1845523","77","46347895","GGCCAGGCACTGTGGCTCACACCTGTAATCCCAGCACTTTGGAAGGCTGAGGTGGGCAGATCACCTGAGGTCAGGAATTTGAGACCAGCCTGGCCACCATGGTGAAACCCTGTCTCTACTTAAAAAAAAAAAAAAAAAAAAAAAAAAAAAATATATAATAATAATATTATATATATACACATATAAGCCAGGTGTGGTGGCGGCATCTGGAATCCCAGCTACTCGAGAGACTGACCCAGGAAGTGGAGGTTGCAGTGAGCTGAGATTGTGCCATTGCACACCAGCCTGGGTGACAAGAATGAGACTTCATCTCAAAAAAAAAAAAAAA","GGCCGGGTGCGGTGGCTCACGCCTGTAATCCCAGCACTTTGGGAGGCCAAGGCGGGTGGATCACCTGAGGTCAGAAGTTCGAGACCAGCCTGGCCAACATGGTGAAACCCCGTCTCTGCTAAAAAGAAAAAAATAAGAAAAAAACAAAATAAGAAAATAATTTTAAAAAATACAAAATTAGCTGGGCGTGGTGGCAGGCACCTGTAATTCCAGCTATTCAGGAGGCTGAGGCAGGGGAATCACTTGAACCCAGGAGGCAGAGGTTGCAGTGAGCCAAGATGACGCCATTGCACACCAGCCTGGGCAACAAGAGTGAAACTCCGTCTCAAAAAAAAAACAA"
"chr8","60245390","60245712","JH378114","44053474","44053787","53","16191916","GGCCAGGCTTGGTGGCTCACACCTGTAATCCTACCACTTTGGGAGACCGAGGAGGGTGGATCACCTGAGGTCAGGAGTTCAAGAACAGCCTGGCCAAATGGTGAAATCCGTCTTTACCAAAAATACAAAAAATTAGCTGGACGTGGCGGTATGTGCCTGTAGTCCCAGCTACTCGGGAGGCTGAGGCAGGAGAATCACTTGAACCTGGGAAGCGGAGGTTGCAGTCAGCCGAGATCCTGCCATTGCACTCCAGCCTGGGCAACAAGAGCAAAACTCCGTCACACACACACACACACACACACACACACAAAGAAAAGAAAAAA","GGCTGGACACGGTGGCTCACACCTGTAATCCTAGCACTTTGGGAAGCTGAGGTGGGTGGATCAACTGAGGTCAGGAGTTTGAAACCAGCCTGGCCAACATGGTGAAACCCCGCCTCTACTAAAAACACAAAAATTAGCTGGACGTGGTGGTGCGTGCCTGTAATCCCAGCTACTCGGGAGGCTGAGGCAGGAGAATTGCTTGAACCCGAAAGGCGGAGGTTGCAGTGAGCTGAGATCACGCCATTGCACTCCAGCCTGGGGACAAGAGCAAAACTCCGTCTCATAAAAACCGCAACAAAACAAAAACAAAAAAA"
"chr8","65086259","65086594","JH378236","1338559","1338895","61","63747700","GTGCCGTGGCTGGGCACGCCTGTAATCCCAGCACTTTGGGAGGCTGAAGTGGGCAGATCACCTAAGGTCAGGAGTTCGAGACCAGCCTGGCCAACATGGCGAAATCCTGTCTCTACCAAAAATACTAAAAAATACCAGTGGGTGTGGTGGCAGGGGCCTGTAATCCCAGCTACTCGGGAGGCTGAGGCAGGAGAATTGCTTGAACCTGGGAGGTGGAAGTTGCAGTGAGCTGAGATCACGTCATTGCACCTGGGTGACAAGAGCAAGACTCTGTCTCAAAAATAAAATAAAATAAAATAAAATAATAATAAGAAGAAGAAGAAAAAGAAAAAGAAA","GGCCAGATATGGTGGCTCACGCCTGTAATCCCAGCACTTTGGGAGGCTGAGGTGGGCAGATCACCTGAGGTCAGGAGTTCAAGACAAGCCTGGCCTACATGGCGAAATTCTCTCTCTATTAAAAAATACAAAAATTAGCTGCACATGGTGGCAGGTGCCTGTAATCCCAGTTACTCAGGAGGCTGAGGCAGAAGAATTGCTTGAACCTGGGAGGTGGAGGTTGCAGTGAGCAGAGGTCATGCCATTGCACTCTAGCCTGGGAGATAAGAGCGAAACTCTGCCTCAAAAAAATAAAAATAAAAATAAAAATAAAAATAAAAATAAAAATAAAAATAAA"
"chr8","67590218","67590699","JH378206","6546474","6546861","155","61043744","TAAAAATGGAAAAAATAGGCCGAGCATGGTGGCTCACGCCTGTAATCCCAGCATTTTGGGAGGCCAAGGCAGGTGGATCACGAGGTCAGGAGTGCAAGACCAGCCTGACCAACATGGTGAAACCCCCGTCTCTACTAAAAATACAAAAATTAGCCGGGCATGGTGGCGGGAGCCTGTAATCTCAGCTACTCAGGAGGCTGAGGCAGGAGAATCACTTGAACCCGGAAGGCGGAGTTTGCAGTGACCCGAGATCAGGCCACTGCTCTCCAGCCTGGGCAACAGAGTGAGACTGCGTCTCAAAAAAAAAAAAAAAAAAATTAGCCGAACATGGTGGCAGGTGCCTGGCTACTTGGGAGGCTGAGGCAGGAGAATCACTCGAACCCGAGAGGTGGAGATTGCAGTGAGCTAAGATCACACTGTTGCACTCTAGCCTGGGTGACAAGAGCAAGACTCCATCTCAAAAAAAAAGAAAAAAGGAAAAA","GGCCACACATGGTGGCTAACGCCTGTAATCCCAGCACTTTGGGAGGCCAAGTCGGGTGGATCATGAGGTCAGGAGACCAAGACCATCCTGGCCAAATGGTGAAACCCCGTCTCTACTAAAAATACAAAAATTAGCTGGGCATGGTGGCGTGTGCCTGTAATCCCAGCTACTCAGGAGGCTGAGGCAGGACAATTGCCTGAACCCAGGAGAATTAGCTGGGCATGGTGGCGTGTGCCTGTAATCCCAGCTACTCAGGAGGCTGAGGCAGGACAATTGCCTGAACCCAGGAGGCGAAGGTTGCGGTGAGCCGAGATTGTGCCATTGCACTCCAGCCTGGGTAACAAGAGCGACACTCTGTCTCAAAAAAAAAAAAAAAAAAAAAAAAAAA"
"chr8","121899410","121900031","JH378118","18053084","18053501","272","103846326","GGTCAGGCGCAGTGGCTCACGCCTGTAACCCCAGCACTTTGGGAGGCTGAGGTGGGCGGATCACCTGAGGTCAGGAGTTCGAGACCAGCCTGGCCAACAGTGTGAAACCCTGTCTTTACTAAAAATAAAAAATTAGGCTGGGCGCAGTGACTCATGCCTGTAATCCCAGCACTCTGGGAGGCCGAGGTGGACGGATCACGAGGTCAGGAGATTGAGACCATCCTGGCTAACATGGTGAAACCCCATCTCTACTAAAAATACAAAAACAAAATTAGCTGGGCACGGTGGCTGGCGCCTGTAGTCCCAGCTACTTGGGAGGCTGAGACAGGAGAATGGCATGAACCCGGGAGGTGGAGCTTGCAGTGAGCTGAGGTTATGCCACTGCACTCCAGTCTGGGCGATAGAGCGAGACTCTGTCTCAAAAATAAATAAATAAATAAATAAATAAATAATAGATAAAACAAAAAATTAGGTGTGGTGGTGGGCACCTGTATTCCCAGCTACTGGGGAGGCTGAGGCAGGATAATCACTTGAACCCGGAGGCGGAGGTTGCAGTGAGCCGAGATCGTGCCCTCCAGCCTGGGTGACAAGAGCAAAACTCTGTCTCAAAAAAAAAAAAGAA","GGCTGGGCGCAGTGGCTCACACCTGTAATCCCAGCACTTAGGGAAGCTGAGGCGAGTAGATCACCTGAGGTCAGGAGTTAGAGACCAGCCTGGCCATCATGGTGAAACCCCGTCTCTACTAAAGATACCAAAAATTAGCTGAGTGTGGTGCTGGGTGCCTGTAATCCCAGAAACTCAGGGTGCCTGTAATCCCAGCAACTCAGGGTGCCTTTAATCCCAGCAACTGAGGGTACCAGTAATCCCAGCAACTCAGGGTGTCTTTAATCCTAGCAACTGAGGGCACCTGTAATCCCAGCAACTCAGGAAGCTGAGACAGGAGAAGTACTTGAACCCAGAAGGCAGAGGTTGCAGTGAGCCGATATTGCACCATTGCACTCCAGTCTGGGCAACAAGAGTGAAACTCTGTCTCAAAAAAAAA"
"chr8","126314118","126314703","JH378118","18053084","18053501","244","108261034","GGCTGGGCACGGTGGCTCACGCCTCTAATCCCAGCACTTTGGGAGGCCAAGGGTCACCTGAGGTCAGGAGTTCGAGACCAGCCTGGCCATGGTGAAACCCCGTCTCTACTAAAAATACAAAAAATTCGCTAGGCATGGCGGGGCGCAGTGGCTCACACTTGTAATCCCAGCACTTTGGGAGGCCGAGGCAGGTGGATCATGAGGTCAGGAGTTCAAGACCAGCCTGGCAAACATGGTGAAACCCTGTCTCTACTAAAAAATACAAAAATTAGCCTGGCACAGTAGTGGGCGCCTGTAATCCCAGCCACTCAGGAGGCTGAGGCAGGAGAATCGCTTGAACTCAGGAGGCAGAGGTTGCAGTGAGCCAAGATCATGCCACTGCATTCTAGCCTGGGCAACAGAGCAAGACTCCTTCTCAAAAAAAAAAAAAAAATTAGCTAGGTATGGTAGCAGGCATCTGTAATCCCAGCTACTTGGGAGGCTGAGGCAGGAGAATCACTTGAACCCAGGAGGCAGAGGTTGCAGTGAGCCGAGATTGTGCCATTGCACTCCAGCCTGGGCAACAAGAGGAAAATTCCATCTCAAA","GGCTGGGCGCAGTGGCTCACACCTGTAATCCCAGCACTTAGGGAAGCTGAGGCGAGTAGATCACCTGAGGTCAGGAGTTAGAGACCAGCCTGGCCATCATGGTGAAACCCCGTCTCTACTAAAGATACCAAAAATTAGCTGAGTGTGGTGCTGGGTGCCTGTAATCCCAGAAACTCAGGGTGCCTGTAATCCCAGCAACTCAGGGTGCCTTTAATCCCAGCAACTGAGGGTACCAGTAATCCCAGCAACTCAGGGTGTCTTTAATCCTAGCAACTGAGGGCACCTGTAATCCCAGCAACTCAGGAAGCTGAGACAGGAGAAGTACTTGAACCCAGAAGGCAGAGGTTGCAGTGAGCCGATATTGCACCATTGCACTCCAGTCTGGGCAACAAGAGTGAAACTCTGTCTCAAAAAAAAA"
"chr8","127904572","127904887","JH378181","5676350","5676662","46","122228222","GGCTGGGCGTAGTGGCTCATGCCCATAATCCCAGCACTTTGGGAGGCTGAGGCGGGTGGATCACCTGAGGTCAGGTGTTTGAGACCAGCCTGGCCAACATGGTGAAACCCCGTCTCTACTAAAAATAAAAAAAAAAAAAAAAAAAAAAAAAGAATTAGCCAGGCATGGTGGCAGGCAGTTGTAATTCTAGCTATTTCGGAGGCTGAGGCAGGAGAATCGCTTGAACCCTGGAGGTGGAGGTTGCAGTGAGCTGAGATTGTGCCACTGCACTCCAGCCTGGGCGACAAGAGCAAGACTCAGTCTCAAAAAAATAAAA","GGCTGGGTGCAGTGGCTCATGCCTATAATCCCAGCACTTTAGGAGGCTGAGGCAGGTGGATCACTTGAGGTCAGGAGCTTGAGACCAGCCTGGCCAACATAGTGAAATCTCATCTCTACTAAAAATGCAAAAAAAAAAAAAAAAAAAAAATTTGCTGGGAGTGGTGGCATGTGCCTGTAATCCCAGCTACTCAGGAGGCTGAGGCAGGAGAATCACTTGAACCCAGGAGGTAGATGTTGCAGTGAGCTGAGATCGTGCCATTGCACTCCAGTCTGGGTGACAAGAGCAAAACTCCATCTCAAAAAAAACAAAA"
"chr8","128970173","128970659","JH378118","18053084","18053501","162","110917089","AAAAAAAAAAAAGGCCTGGTGCAGTGGCTCACGCCTGTAATCCCAACACTTTGGGAGGCCGAGGTGGGTGGATCATGAGGTCAGGAGTAACAGACCAGCCTGGCCAACATGGAGAAACCCCGTCTCTACTAAAAATACAAAAATTAGCTGGGCATGATGGCACGTGCCTGTGGTCCCAGCTACTCAGGAGGCTGAGGCAGGAGAATCGCTTGAACCCGGGAGTCAGAGGTTGCAGTGAGCCAAGATCGCGACACAGCACTCCAGCCTGGCAACAGAGCAAGACTCTGTCTCAAAATAAATAAATAAATAAATAAATAAAATTAGCTGGGTGTGGTGGCAGGCGCTTGTAATCCCACATACTTGGGAGGCTGAGGCAGAAGAATCGTCTGAACCCGGGAGGCAGAGGTTGCGGTGAGATGAGATCGCGCCATTGCACTCCAGCCTTGGCAACAAGAGCAAAACTCCATCTCAAAAAAAAAAAAAAAAA","GGCTGGGCGCAGTGGCTCACACCTGTAATCCCAGCACTTAGGGAAGCTGAGGCGAGTAGATCACCTGAGGTCAGGAGTTAGAGACCAGCCTGGCCATCATGGTGAAACCCCGTCTCTACTAAAGATACCAAAAATTAGCTGAGTGTGGTGCTGGGTGCCTGTAATCCCAGAAACTCAGGGTGCCTGTAATCCCAGCAACTCAGGGTGCCTTTAATCCCAGCAACTGAGGGTACCAGTAATCCCAGCAACTCAGGGTGTCTTTAATCCTAGCAACTGAGGGCACCTGTAATCCCAGCAACTCAGGAAGCTGAGACAGGAGAAGTACTTGAACCCAGAAGGCAGAGGTTGCAGTGAGCCGATATTGCACCATTGCACTCCAGTCTGGGCAACAAGAGTGAAACTCTGTCTCAAAAAAAAA"
"chr8","129601388","129601724","JH378114","30407801","30408124","64","99193587","GGCTGGGCAAGGTGGCTCACACCTGCATCCCAGCACTTTGGATGGCCAAGGCAGGTGCATCACCTGAGGTCAGGAGTTCAAGACCACCCTCGTCAACATGGCAAAACCCCATCTCTACTAAAAATAAAAAAATTAGCCAGGCATGGTGGTGGATGCCTGTAATCCCAGCTACTTGGGAGGCGGAGGCAGGAGAATTGCTTGAACCCAGGAGGTAGAGGTTGCAGTGAGCTAGTGAGCTGAGATTGTGCCATTGCACTCCAGCCTGGGCAACAAGAGTGAAACACCATCACACACACACACACACACACACACACACACATTAAGGAAGAAGTAAAAA","GGCTGGGCATGGTGGCTCAAGCCTGTAATCTCAGCACTTTAGGAGGCCGAGGTGGGTGGATCACCTGAGGTTAGGAGTTCAAGACCAGCTTGGCCAATATGGTGAAACCCCATCTCTATTAAAAATACAAAAAATTAGCAAGGCATGATGGTGGATGCCTGTAATCCCAGCTACTCAGGAGGCTGAGGCAGGAGAATCGCTTGAACCCAGGAGGCAGAGGTTGCATTGTACTGAGATTGCATCATTGTACTCCAGCCTGGGCAACAAGAGTGAAACTCCATCTCAAATAAATAAATAAATAAATAAATAAATAAATAAATAAAT"
"chr8","141858311","141858654","JH378105","46221579","46221896","62","95636732","GGCTGGGCGTGGTGGCTCACACCTGTAATCCCAGCACTTTGAGAGGCCAAGGCAGGTGGATCACTTGAGGTCAGGAGTTCGAGACCAGCCTGGCCAATATGGTGAAACCCTATCTCTAAAAAAAAAAATATATGTATATATATATACACACACACACACACACACACACAAAATTAGCTGGGCATGGGGGTGCACGCCTATAATCCCAGCTACTTGGGGGGCTGAGGCAGGAGAATCGCTTGAACCCGGGAGGCGGAGTTTGCAGTGAGCCAAGATTGCGCCATTGCACTCCATCCTGGGCAACAAGAGCGAAACTCCATCTCAGTAAATAAATAAATAAATAA","GACTGGGTGTGATGGCTCATGCCTGTAATCCCAGCACTTTGGGAGGCCAAGGCGGGTGGATCACCTGAGGTCAGGAGTTCAAGACCAGCCTGACCAACATGGTGAAACCCCGTCTCTACTAAAAAAAAAAAAAAAAAAAAAAAACTACAAAATTAGCTGGGCCTGGTGGTACACACCTATAATCCCAGCTACTTGGGAGGCTGAGGCAGGAGAGTTACTTGAACCCAGGAGGCAGAGGTTGCAGTGAGCTGAGATCATGCCATTGCACTCCATCCTGGGCAACAAGAGCGAAACTCTGTCTTAAAAAAAAAAAAAAAA"
"chr8","142452082","142452679","JH378118","18053084","18053501","256","124398998","GGCCGGGCACGGTGGCTCATGCCTGTACTACCAGCACTTTGGGAGGTTGAGGCAGGTGAATCACCTGAGGTCAGGAGTTCGACACCAGCCTGGCCAACATGGTGAAACCATCTCTACTAAAACTACAAAAATTAGCCAGGCGTTGGGCCGGGTGCAGTGGCTCATGCTTGTAATCCCAGCACTTTGGGAGGCTGAGGTGGGCAGATCACGAGGTCAGGGGATCGAGACCATCCTGGCTGACACGGTGAAACCCCGTCTCTACTAAAAATACAAAAATTAGCCGGGTGTGGTGGCGGGCGCCTATAGTCCCAGCTACTCGGGAGGCTGAGTCAGGAGAATGGCTTGAACCCAGGAGGCGGAGCTTGCAGTGAGCTGAGATTGCGTCACTGCACTCCAGCCTGGGCGACAGAGCGAGACTCCGTCTCAAAAAAAAAAAAAAATTAGCCAGGCATGGTGGCAGGTGCCTGTAGTCCCAGCTACTCAAGAGGCTGAGGTACAAGAATCGCTTGAACCCGGAGGCAGAGGTTGAGTGAGCTGAGATCACGCCATTGCGCTCCAGTCTGGGTGATGAGAGCAAAACATCTCAAAAAAAAAAGAA","GGCTGGGCGCAGTGGCTCACACCTGTAATCCCAGCACTTAGGGAAGCTGAGGCGAGTAGATCACCTGAGGTCAGGAGTTAGAGACCAGCCTGGCCATCATGGTGAAACCCCGTCTCTACTAAAGATACCAAAAATTAGCTGAGTGTGGTGCTGGGTGCCTGTAATCCCAGAAACTCAGGGTGCCTGTAATCCCAGCAACTCAGGGTGCCTTTAATCCCAGCAACTGAGGGTACCAGTAATCCCAGCAACTCAGGGTGTCTTTAATCCTAGCAACTGAGGGCACCTGTAATCCCAGCAACTCAGGAAGCTGAGACAGGAGAAGTACTTGAACCCAGAAGGCAGAGGTTGCAGTGAGCCGATATTGCACCATTGCACTCCAGTCTGGGCAACAAGAGTGAAACTCTGTCTCAAAAAAAAA"
"chr8","143274363","143274985","JH378118","18053084","18053501","270","125221279","GGCTGGGTGCAGTGGCTCATGCCTGTAATCCCAGCACTTTGGCAGGCTGAGGCAGGTGGATCACTTGCGGTCGGAAGTTCGAAACCAGCCTGATCAACATGGTGAAACTCTGTCTCTACTAAAAATACAAAAATTGCCAGGTGTGGTGTCTCATGCCTGTAATCGCAGCACTTTGGGAGGCCAAGGCGGGCGGATCACGAGGTCAGGAGATCAAGACCATCCTGGCTAACACGGTGAAACCCCATCTCTACTAAAAATACGAAAAAAAAATTAGGTGGGCGTGTTGGCACGTGCCTGTAGTCCCAGCTACTCGTGTGGCTGAGGCAGGAGAATCACTTGAACCCAGAAGGTAGAGGTTGCAGTGAGCCAAGATCGCACCACTGCGCCAGCCTGAGTGACAGAGCAAGACTCCGTCTCAAAAAAACAAAACAAAACAAACCAAAAAATAGCTGGGGGTGGTGGCAGACGCCTGTAATTTCAGCTACTCGGGAGGCTGAGGCAGGAGAATCGCTTGAACCCAGGAGGCGGAGGTTGCAGTGAGCTGAGATCACACCATTGGACTCCAGCCTGGGCGACAAAAGTGAAACAGTCTCAAAAAAAAAAAAAAAAAAGAAAAGAAAAGA","GGCTGGGCGCAGTGGCTCACACCTGTAATCCCAGCACTTAGGGAAGCTGAGGCGAGTAGATCACCTGAGGTCAGGAGTTAGAGACCAGCCTGGCCATCATGGTGAAACCCCGTCTCTACTAAAGATACCAAAAATTAGCTGAGTGTGGTGCTGGGTGCCTGTAATCCCAGAAACTCAGGGTGCCTGTAATCCCAGCAACTCAGGGTGCCTTTAATCCCAGCAACTGAGGGTACCAGTAATCCCAGCAACTCAGGGTGTCTTTAATCCTAGCAACTGAGGGCACCTGTAATCCCAGCAACTCAGGAAGCTGAGACAGGAGAAGTACTTGAACCCAGAAGGCAGAGGTTGCAGTGAGCCGATATTGCACCATTGCACTCCAGTCTGGGCAACAAGAGTGAAACTCTGTCTCAAAAAAAAA"
"chr9","2529454","2530075","JH378118","18053084","18053501","265","15523630","GGCCAGGGCAGTGGCTCACACCTGTAATCCTAGCACTTTGGGAGGTCGAAGTAGGCAGATCAGTTGAGGTCAGGAGTTCAAAACCCGCTTGGCCAACATGTTGAAACCCTGTCTCTACTAAAAATGTAAAAAAAAAAATTAGCTGGGGCCGGGTGTGGTGGCTCACGCCTGTAATCCCAGCACTTTGGGAGGCCGAGGCAGGCAGATCATTTGATGCCAGGAGTTTGAGACCAGCCTGGCCAAAATGGTGAAACCGTGTCTCTACTGAAAATACAAAAACTAGCCAGGCGTGATGGTGGGCGCCTGTAATCCCAGCTACTCCGGAGGCTGAGGCAGGAGAATGACTTGAGCCCGGAAGGTGGAGTTGCAGTGAGCCGAGATCGCGCCACTGCACTCCAGCCTGGGAGACAGAGTGAGACTCCGTCCAAAAAAAAAAAAAAAAAAAAAATTACCTGGGCATGGTGGCTGGCACCTGTAATCCCAGCTACTTAGGAGGCTCAAGCAGGAGAATCGCTTGAACCCGGGAGGCGGAGGTTGCAGTGAGCTGAGAATCACGCCATTGCACTCCAGCCCGGGCAACAAGAGTGAAACTCAGTCTCAAAACAACAACAACAACAAAAAA","GGCTGGGCGCAGTGGCTCACACCTGTAATCCCAGCACTTAGGGAAGCTGAGGCGAGTAGATCACCTGAGGTCAGGAGTTAGAGACCAGCCTGGCCATCATGGTGAAACCCCGTCTCTACTAAAGATACCAAAAATTAGCTGAGTGTGGTGCTGGGTGCCTGTAATCCCAGAAACTCAGGGTGCCTGTAATCCCAGCAACTCAGGGTGCCTTTAATCCCAGCAACTGAGGGTACCAGTAATCCCAGCAACTCAGGGTGTCTTTAATCCTAGCAACTGAGGGCACCTGTAATCCCAGCAACTCAGGAAGCTGAGACAGGAGAAGTACTTGAACCCAGAAGGCAGAGGTTGCAGTGAGCCGATATTGCACCATTGCACTCCAGTCTGGGCAACAAGAGTGAAACTCTGTCTCAAAAAAAAA"
"chr9","2600136","2600710","JH378118","18053084","18053501","233","15452948","GGCTGGGCACGGTAGCTCACGTCTGTAATTGCAGCACTTTGGGAGGCCGAGGCAGGTGGATCACCTGAGGTCAGGAGTTTGAGACCAGCCTGGCCAACATGGCAAAACCCCGTCTCTACTAAAAATACAAAAAAATTAGCCGGGCCTGCCAGGCGCGGTAGGTCACAAGGTCAGGAGATCGAGACCATCCTGGCTAACATGGTGAAACCCCATCTCTACTAAAAATACAAAACCTTAGCTGGGCATGGTGGCAGGAGCCTGTAGTCCCAGCTACATGGGAGGCTGAGGCACAAGAATGGCGTGAACCCGGGAGGCGGAGCTTGCAGTGAGCCAAGATTGCGCCACTGCACTCCAGCCCCGGCAACAGAGTGAGACTCTCTCAAAAAAAAAAAAAAAAAAAAAAAATTAGTCGGGTGTGGTGGCGGGCGCCTGTAATCCCAGCTGCTCAGAAGGCTAAGGCAGAAGAATCGCTTGAACCCAGGAAGCAGAGGTTGCAGTGAGCTGAGATTGTGCCACTGTACTCCAGCCTAGGTGACAAAAGCAAGACTCCATCTCAAAAAAACAAAAACAAAAAA","GGCTGGGCGCAGTGGCTCACACCTGTAATCCCAGCACTTAGGGAAGCTGAGGCGAGTAGATCACCTGAGGTCAGGAGTTAGAGACCAGCCTGGCCATCATGGTGAAACCCCGTCTCTACTAAAGATACCAAAAATTAGCTGAGTGTGGTGCTGGGTGCCTGTAATCCCAGAAACTCAGGGTGCCTGTAATCCCAGCAACTCAGGGTGCCTTTAATCCCAGCAACTGAGGGTACCAGTAATCCCAGCAACTCAGGGTGTCTTTAATCCTAGCAACTGAGGGCACCTGTAATCCCAGCAACTCAGGAAGCTGAGACAGGAGAAGTACTTGAACCCAGAAGGCAGAGGTTGCAGTGAGCCGATATTGCACCATTGCACTCCAGTCTGGGCAACAAGAGTGAAACTCTGTCTCAAAAAAAAA"
"chr9","3815870","3816375","JH378118","18053084","18053501","192","14237214","GGCCGGGCACTGTGGCTCACGCCTGTAATCCTGAACTGAGGCAGGAGCATCGCTTGAGGTTAGGAGTTCAAGGCCAGCCTGGCCTACATGGTGAAACCTCGTCTCTACTAAAAATACAAAAGTTAGCTAGGTGTCCAGGTGCGGTGGCTCACTCCTGTAATCCCAGCACTTTGGGAGGCCGAGGTGGGCGGGACACCTGAGGTCGGGAGTTCGAGACCAGCCTGACCAAGAGGGAGAAACCCTGTCTCTACTAAAAATACAAAATTAGTCGGCGTGGTGGCGTGTGCCTGTAATCCCAGTTGTTCAGGCTGAGGTGGGAGGAATACCTGAGGTTGGGAATTCGAGACCAGCCTGACAAACATGGAGAAACCCCATCTCTGTGGCTGAGGCAGGAGAATCACTTGAACCTGGGAGAAGGAAGTTGCAGTGAACCGAGACTGCGCCATTGCACCCCGGCCTAGGCAACAAGAGCGAAAGTCTGTCTCAAAAAAAAAAAAAAAAAAAAA","GGCTGGGCGCAGTGGCTCACACCTGTAATCCCAGCACTTAGGGAAGCTGAGGCGAGTAGATCACCTGAGGTCAGGAGTTAGAGACCAGCCTGGCCATCATGGTGAAACCCCGTCTCTACTAAAGATACCAAAAATTAGCTGAGTGTGGTGCTGGGTGCCTGTAATCCCAGAAACTCAGGGTGCCTGTAATCCCAGCAACTCAGGGTGCCTTTAATCCCAGCAACTGAGGGTACCAGTAATCCCAGCAACTCAGGGTGTCTTTAATCCTAGCAACTGAGGGCACCTGTAATCCCAGCAACTCAGGAAGCTGAGACAGGAGAAGTACTTGAACCCAGAAGGCAGAGGTTGCAGTGAGCCGATATTGCACCATTGCACTCCAGTCTGGGCAACAAGAGTGAAACTCTGTCTCAAAAAAAAA"
"chr9","5925662","5926287","JH378118","18053084","18053501","286","12127422","GGGCGCGGGGGCTCACCCCTGTAATCCCAGCACTTTGGGAGGCCTAGGCCTGTGGATCACCTGAGGTCAGGAGTCCGAGACCAGCCCGACCAATATGGTGAAACTCCGCCTCTACTAAAAATACAAAAATTGGCTGGGTGCGGTGGCCCACACCTGTAATCCCAGCACTTTGGGAGGCCAAGGCGGGCAGATCACGAGGTCAGGAGACCAAGACCATCATGGCTAACACGGTGAAACCCTGTCTCTACCAAAAATACAAAAAAATTAGCTGGGCGTGGTGGCAGGCGCCTATAGTCCCAGCTACTTGGGAGGCTGAGGCAGGAGAATGACGTGAACCCAGGAGGCGGAGCTTGCAGCGAGCCAAGATCACACCACTGCACTCCAGCCTGGATGACAGAGCAAGACTCCGTTTCAAAAAAAAAATAAAACTAAACTAAACTAAAATAAAATAAATTAGCCAGGCATGGTGGCGTGTGCCTGTAATCCCAGCTACTTGGGAGGCTGAGACAGGTCCCTTGAATCGGGGAGGTGGAGGTTGCAGTGAGTCGAGATTGCGCCACTGCACTCCACCCTGGGTGACAAGAGCGAAACGCCGTCTCAAAAATAAAAAATACAAAAGTAAAAAA","GGCTGGGCGCAGTGGCTCACACCTGTAATCCCAGCACTTAGGGAAGCTGAGGCGAGTAGATCACCTGAGGTCAGGAGTTAGAGACCAGCCTGGCCATCATGGTGAAACCCCGTCTCTACTAAAGATACCAAAAATTAGCTGAGTGTGGTGCTGGGTGCCTGTAATCCCAGAAACTCAGGGTGCCTGTAATCCCAGCAACTCAGGGTGCCTTTAATCCCAGCAACTGAGGGTACCAGTAATCCCAGCAACTCAGGGTGTCTTTAATCCTAGCAACTGAGGGCACCTGTAATCCCAGCAACTCAGGAAGCTGAGACAGGAGAAGTACTTGAACCCAGAAGGCAGAGGTTGCAGTGAGCCGATATTGCACCATTGCACTCCAGTCTGGGCAACAAGAGTGAAACTCTGTCTCAAAAAAAAA"
"chr9","13569233","13569850","JH378118","18053084","18053501","275","4483851","GGCCGAGTGCGGCAGCTCACGCCTGTAATCCCAGCACTTTGAAAGGCATAGGCAGGTGCATTACCTGAGGTCAGGAGTTCAAGACTAGCCTGGCCAAAATGGTGAAACCCCCATCTCTACTAAAAATATAAAAATTAGGCCAGGCGCAGTGGCTCACCTGTAATCCCAGCACTCTAGGAGGCCAAGGTGGGCAGATCACCTGAGGTTGGGAGTTCGAGACCAGCCTGACCAACATGGAGAAACCCCGTCTGAACTAAAAATACAAAATTAGCTGGGTATGGTGGCGCACACCTGTAATCCCAGCTACTTGGGAGGCTGAGGCAGGAGAATCACTTGAACCCGGGAGGCGGAGGTTGCAGTGCCAGAGATCAGGCCATTGCACTCCAACCTGGGCAACAAGAACAAAACTCTGTCTCAAAAAATAATAATAATAATACAAAAATTAGCCAAGTGTGGTGGCAGGCACCTGTAATCCCAGCTACTCGCAGATTACAGGCACGAGGCTGAGGCAAGAGAATCACTTGAATCCGGGGGGCAGAAGTTGCAGTGACAAGAGATCCCATCATTGCACTCCAGCTTGGGTGACAAGCAAAACTCCATCCCAAAAAAAAAAAAAAA","GGCTGGGCGCAGTGGCTCACACCTGTAATCCCAGCACTTAGGGAAGCTGAGGCGAGTAGATCACCTGAGGTCAGGAGTTAGAGACCAGCCTGGCCATCATGGTGAAACCCCGTCTCTACTAAAGATACCAAAAATTAGCTGAGTGTGGTGCTGGGTGCCTGTAATCCCAGAAACTCAGGGTGCCTGTAATCCCAGCAACTCAGGGTGCCTTTAATCCCAGCAACTGAGGGTACCAGTAATCCCAGCAACTCAGGGTGTCTTTAATCCTAGCAACTGAGGGCACCTGTAATCCCAGCAACTCAGGAAGCTGAGACAGGAGAAGTACTTGAACCCAGAAGGCAGAGGTTGCAGTGAGCCGATATTGCACCATTGCACTCCAGTCTGGGCAACAAGAGTGAAACTCTGTCTCAAAAAAAAA"
"chr9","21512211","21512659","JH378181","3341107","3341454","147","18171104","CAGGAGGCTGAGGCAGGAGAATCACTTAAACATGGGAGGCAGAGGTTGCAATGAGCTGAGATTGCACCATTGCATTCCAACCTGGGCAACAAAAGCGAAACTCTGTCTCAAAAAATAAATAAATAGGCCAGGCATGGTGGCTCACGCCTGTAATCCCAGCACTTTGGGAGGCCAAGGCGGGTGGATCACCTGAGGTCAGGAGTTCAAGACCAGCCTGGCCAACATGGTTAAACCCCGTCTCTACTAAAAATACAAAAAATTAGCCCGGCTGGTGGCAGGTAACTGTAATCCCAGCTACTCAGGAGGCTGAGGCAGGAGAATCGCTTGAACCAGGGAGGCGGAGGTTGTAGTGAACTGAGATCGTGCCATTGCACTCCAGCCTGGGCAACAAGAGCAAAACTCCATCTCAACAAATAAATAAATAAAAATAAAAATAAAAAATAAAAGAA","CAGGTATGGTGGCTCATGCCTATAATCCCAGCACTTTGGGAGGCAGAGGGGGGCGGATCACTTGAGAACAGGAGTTAAAGACCAGCCTGGGGCGGATCGCCTGAGGTCAGGGGTTCAATACCAGCCTGGCCAACATGGTGAAACCCCGTCTCTACTAAAAATACAAAAAATTAGCTGGGCATGGTGGTGCGTGCCTGTAATCCCAGCTACTCAGGAGGCTGAGGCAGGAGAATTGCCTGAACCCAGGAGGCGGAGGTTGCGGTGAGCCGAGATCGCGCCATTGCACTCCAGCCTGGGTAACAAGAGCGAAACTCCGTCTCAAAAAAAAAAAAAAAAAAAAAAAAAAAA"
"chr9","39120516","39120835","JH378152","15932639","15932952","64","23187877","GGCTGGGCGCGGTGGCTCACCCCTGTAATTTGGGAGGCCGAGGCAGGAAGATCACCTGAGGTCAGGAGTTCGAGACCAGCCTGGCGAACATGGTGAAACCCCATTTAAAACTACAAAATTACAAAACTACAAAATTACAATACTACAAAAATTAGCTGGGTGTCGTGGCAGGCACCTGTAATCCTAGCTATTCAGGAGGCTTAGGAAAGAGAATTGCTTGAACTCGGGAGGTGGAGGTTGCAGTGAGCCGAGATCGCGCCATTGTACTCCAGCCTGAGTGACAACAGCGAAACTCGGTCTCAAAAAAAAAAAAAAAAAAA","GGCCGGGCATGGTGGCTCAAGCCTGTAATCCCAGCACTTTGGGAGGCCGAGGCGGGTGGATCACGAGGTCAAGAGATTGAGACCATCCTGGTCAACATGGTGAAACCCCGTCTCTACTAAAAATACAAAAAAAAAAAAAAAAAAAATAGCTGGGTGTGGTGGCGTGTGCCTGTAATCCCAGCTACTCAGGAGGCTGAGGCAGGAGAATTGCCTGAACCCGGGAGGCGGAGGTTGCGGTGAGCCGAGATCGCGCCATTGCACTCCAGCCTGGGTAACAAGAGCGAAACTCCGTCTCAAAAACAAAAAAAACAAAA"
"chr9","40494311","40494921","JH378118","18053084","18053501","257","22441227","GGCCAGATGCAGTGGCTCATGCCTATAATCCCAGCACTTTGGGAGGCTGAGGTGGGTGGATCACCTGAGGTCAGGAGTTTGAGACCAGCCTGGCCAACATGGTGAAACCCCATCTCTACTAAAAGTACAAAACTATTGGCTGGGGTGTGGTGGCACATGCCTGTAATTCCAGCACTTTGGGAGGCTGAGGCGGGCGGCTCACCTGAAGTCAGGAGTTCGAGACCAGCCTGGTCAACATGGTGAAACTCTGTCTCTACTAAAAATATAAAAATTAGCTGGGCGTGGTGGCATGCACCTGTAATCCTAGCTACTCAGAAGGCTGAGGCAGGAGCATGGCTTGAACCTGGGAGGTGGAGGTTGCAGTGAGCTGAGATTGTGCCACTGCACTCCAGCTGGGGCGACAGAGCAAGATTTGGTCTCAAAAAAAAAAAAAAAAAAAAAAAAAGCTAGCTGAGTGTGGTGGCCAGTGCCTATAATCCCAGCTACTCGGGAGGCTGACGCACGAGAATCGCTTGAACCTGGGAGGCGGAGGTTGCAGTGAGCCAAAATTGTACCACTGCACTCCAACCTGGGTGACAAGAGCAAGACTCCGTCTCAAAAAATAAATAAAA","GGCTGGGCGCAGTGGCTCACACCTGTAATCCCAGCACTTAGGGAAGCTGAGGCGAGTAGATCACCTGAGGTCAGGAGTTAGAGACCAGCCTGGCCATCATGGTGAAACCCCGTCTCTACTAAAGATACCAAAAATTAGCTGAGTGTGGTGCTGGGTGCCTGTAATCCCAGAAACTCAGGGTGCCTGTAATCCCAGCAACTCAGGGTGCCTTTAATCCCAGCAACTGAGGGTACCAGTAATCCCAGCAACTCAGGGTGTCTTTAATCCTAGCAACTGAGGGCACCTGTAATCCCAGCAACTCAGGAAGCTGAGACAGGAGAAGTACTTGAACCCAGAAGGCAGAGGTTGCAGTGAGCCGATATTGCACCATTGCACTCCAGTCTGGGCAACAAGAGTGAAACTCTGTCTCAAAAAAAAA"
"chr9","40763583","40764096","JH378118","18053084","18053501","213","22710499","AGGTCAGGAGTTGGAGACCAGCCTGACCAACATGGTGAAACCCTGTCTCTACTAAAAATACAAAAACTGGCATGGTGGCTCACGCCTGTAATCCTGACACTTTGGGAGGCCGAGGTGGGTACATCACGATGTCAAGAGATTGAGACCATCCTGGCCAACATACTGAAACCCTGTCTCTACTAAAAATACAAAAATTAGCTGGGCGTGGTGACACGGTGCCTGTAGTCCCAGCTACTCGGGAGGCTGAGGCACGAGAATCGCTTGAACCCGGGAGGTGGAGGTTGCAGTGAGCTGAGATCGCGCCACTGCACTCCAGCCTGGCAACAGATCGAGACTCCATCTCAAAAAAAAAAAAAAAAAAAAAAATTAGCCGGGCATGGTGGCAGGTGCCTGTAATCCCAGCTACTTGGGAGGCTGAGGCAGGAGAATCGCTTAAACCTGGGAGGCGGAGGTTGCAGTGAGCTGATACCGTGCCATTGCACTGTAGCCTGGGTGACAAGAGCAAAACTCCGTC","GGCTGGGCGCAGTGGCTCACACCTGTAATCCCAGCACTTAGGGAAGCTGAGGCGAGTAGATCACCTGAGGTCAGGAGTTAGAGACCAGCCTGGCCATCATGGTGAAACCCCGTCTCTACTAAAGATACCAAAAATTAGCTGAGTGTGGTGCTGGGTGCCTGTAATCCCAGAAACTCAGGGTGCCTGTAATCCCAGCAACTCAGGGTGCCTTTAATCCCAGCAACTGAGGGTACCAGTAATCCCAGCAACTCAGGGTGTCTTTAATCCTAGCAACTGAGGGCACCTGTAATCCCAGCAACTCAGGAAGCTGAGACAGGAGAAGTACTTGAACCCAGAAGGCAGAGGTTGCAGTGAGCCGATATTGCACCATTGCACTCCAGTCTGGGCAACAAGAGTGAAACTCTGTCTCAAAAAAAAA"
"chr9","43566127","43566458","JH378132","23184680","23184996","64","20381447","CGGGCATGGTGGCTCACGCCTGTAATCCCAGCACTTTGGGAGGCCGAGGCACATGGATCACAACGTCAAGAGTTTGAGACCAGCCTGGCCAACATAGCGAAATCCCATCTCTACTGAAAGTACAAAATAAATAAATAAATAAATAAATAAATAAATAAATAAATAAATTAGCCGGGCATGGTGGTGGGCGCCTGTAATTCCAGCTACTCGGGAGGCTGAGGCAAGAGAATCACTTGAACCTGGGAGATGGAGGTTGCAGTGAGCCAAGATCATGCCATTGCACTCCAACCTGGGAGACCAGAGTAAAACTCCATCTCAAAAAAAGAAAAAAA","GGCCGGGCATGGTGGCTCAAGCCTGTAATCCCAGTACTTTGGGAGGCCGAGGTGGGTGGATCACAAGGTCAAGAGTTCGAGACCATCCCGGTCAACATGGTGAAACCCCGTCTCTACTAAAAATACAAAAAAAAAAAAAAAAAAAAAAAAATTAGCTGAGCATGGTGGCGCGTGCCTATAATCCCAGCTACTCAGGAGGCTGAGGCAGGAGAATTGCCTGAACCCAGGAGGTGGAGGTTGCGGTGAGCCGAGATCGTGCCATTGCACTCCAGCCTGGGTAACAAGAGTGAAACTCCGTCTCAAAAAAAAAAAAAAAA"
"chr9","46029986","46030307","JH378250","1133852","1134171","39","44896134","GGCCAGGTGCTGTGGCTCACGCCTGTAATCCCAGCGCTTTGGGAGGCTGAGGCGGGCAGATCACCTGAGGTCAGGAGTTCAAGACCAGCTTGGCCAACATGGTGAAGCCCATCTCTACTAAAAATACAAAAAATTAGCTGGGTGTGGTGGCGGGTGCCTGTAATCCTAGCTGCTCAGGAGGCTGAGGCAGGAGAATCGTTTGAACCTGGGAGGCAGAGGTTGCAGTGAGCTGAGATCACTCCATTACACTCCAGCCTGGGCAACAAGAGCAAAACTCCATCTCAAAATAATAATAATAATAATAATAATAAAGAAAACAAAA","GGCCGGGTGCGGTGGCTCAAGCCTGTAATCCCAGCACTTTGGGAGGCTGAGGCGGGTGGATCACCTGAGGTCAGGAGTTCAAGACCAGCCTGGTCAACATGGTGAAACCCCGTCTCTACTAAAAATACAAAAAATTAGCTGGGCGTGGTGGCGCGTGCCTGTAATCCCAGCTACTCAGGAGGCTGAGGCAGGAGAATTGCCTGAACCCAGGAGGCGGAGGTTGCGGTGAGCCGAGATCACGCCATTGCACTCCAGCCTGGGTAACAAGAGCGAAACTCCGACTCAAAAAAATAAATAAATAAATAAAATAAAAAATAAAT"
"chr9","50062696","50063006","JH378141","14073221","14073505","58","35989475","GGCCGGGTGCAGTGGCTCATGCCTGTAATCCTGTAATTCCAGCACTTTGGGATGCCAAGGCAGGAGGATCACCTGAGGTCAGGAGTTCGAGACCGGCCTGGCCAACGTGGTGAAACCCCGTCTCTGCTAAAAATACAAAAAAAAAAAAAAAAAAAAAAAAATTAAAGCTACTCAGGAGGCTGAGGCAGGAGAATCACTTGAGCCTGGGAAGTGGAGGTTGCAGTGAGCTGAGATCATGCCATTGCACTCCAGCCTGGGCTACAAGAGTGAGAGTCCATCTCAAAAAAACAAAAGAAAAGAAAAGAAAAAAA","GGCCGGGCGCAGTGGCTCAAGCCTGTAATCCCAGCACTTTGGGAGGCCGAGGCGGGTGGATCACGAGGTCGAGAGATCGAGACCATCCTGGTCAACATGGTGAAACCCCGTCTCTACTAAAAATACAAAAAAAAAAAAAACAAAAAAAAACTAGGAGGCTGAGGCAGGAGAATTGCCTGAGCCCAGGAGGCGGAGGTTGCAGTGAGCCGATATCGCGCCATTGCACTCCAGCCTGGGTAACAAGAGCGAAACTCCGTCTCAAAAAAAAAAAAAAAAAAAAAAAAA"
"chr9","57580755","57581084","JH378235","1186107","1186418","67","56394648","GGCCGGGCACAGTGGCTCACGCCTGTAATCCCAGCACTTTGGAAGGCTGAGGCAGGAGGATCACCTGAGGCCAGGAATTCAAGACCAACCTGGCCAACGTGGTAAAACCTCGTCTCTACTAAACACACACACACACACACACACACACACACACACACACACACAATTAGCCAGGTGTGTTGGTGGGTGCCTGTAATCCCAGCTACTTGGGAGGCTGAGGCAGGAAATTCACTCGAACCCGGAGGTGGAGTTTGCAGTGAGCCGAGATCGCGCCATTGGACACCAGTCTGGGCTACAAGAGCAAAACTCTTGTCTCAAAAAAATAAAAAA","GGCTGGGCGCAGTGGCTCAAGCCTGTAATCCCAGCACTTTGGGAGGCCGAGGGGGGTGGATCACGAGGTCAAGAGATCAAGACCATCCTGGTCAACATGGTGAAACCCCGTCTCTACTAAAAAAAAAAAAAAAAAAAAAAAAAAAAAAAAAAAATTAGCTGGGCATGGTGGCGTGTAATCCCAGCTACTCAGGAGGCTGAGGCAGGAGAATTGCCTGAACCCAGGAGGCGGAGTTTGCGGTGAGCCAAGATCGCGCCATTGCACTCCAGCCTGGGTAACAAGAGCAAAACTCTGTCTCAAAAAAAAAAAAAA"
"chr9","71686707","71687611","JH378118","18053084","18053501","515","53633623","GGCTGGGCATGGTGGCTTATGCCTGTAATCCCAGCACTTCAGGAGGCCGAGGTGGGTAGATCACCTGAGGTCAGGAGTTGGAGATCAGCCTGGCCAACATGGTGAAACCCCATCTGTACTTAAAATACAAAATTAGGCTGGGTGCGGTGTCTCATGCCTGTATTCCCAGCACTGTGGGATGCCAAGGTGGGCGGATCACCTGAGGTTAGGAGTTCAGGACCAGCCTGACCAACATTGTGAAACCCCGTCTCTACTAAAAATACAAAAATTAGCCAGGCATGGTGGCGGGCACCTGTAATCCCAGCTACTCGGGAGGCTGAGGCAGGAGAATCTCTTGAACCCGGGAGGCAGAGATTGCAGTGAGCTGAGATAGCACCATTGCACTCCAGCCTGGGCAACAAGAGCAAAACTCCATCTCAAAAAACAAACACACAGGCCGGGCACAGTGGCTCACGCCTGTAATCCCAGCACTTTGGGAGGCCGAGTGGGCAGATCACGAGATCAGGAGATAGAGACCATCCTGGCTAACACGGTGAAACCCCGTCTCTACTAAAAATACAAAAATTAGCTGGGCGTGGTGGCGGGCACCTGTAGTCCCAGCTACTCAGGAGGCTGAGGCAGGAGAATGGCGTGAACCCGGGAGGCAGAGCTTACAGTGAGCCAAGATTGCACCTCTGCACTCCAGCCTGGATGACAGAGTAAGACTCTGTCTCAAAAACAAACAAACAGACAAACAAAATTAGCTGGGCATGATGGCAGGTGCCTATAATCCCAGCTACTTGGGAGGCTGAGGCAGGAGAATTGCTTGAACCCAGGAGGCGGAGGTTGCAGTGAGCCGAGATTGCGTCATTGCACTCCAGCCTGGGCAACAAAAGCAAAACTCTGTCTCAAAAACAAACAAAAAA","GGCTGGGCGCAGTGGCTCACACCTGTAATCCCAGCACTTAGGGAAGCTGAGGCGAGTAGATCACCTGAGGTCAGGAGTTAGAGACCAGCCTGGCCATCATGGTGAAACCCCGTCTCTACTAAAGATACCAAAAATTAGCTGAGTGTGGTGCTGGGTGCCTGTAATCCCAGAAACTCAGGGTGCCTGTAATCCCAGCAACTCAGGGTGCCTTTAATCCCAGCAACTGAGGGTACCAGTAATCCCAGCAACTCAGGGTGTCTTTAATCCTAGCAACTGAGGGCACCTGTAATCCCAGCAACTCAGGAAGCTGAGACAGGAGAAGTACTTGAACCCAGAAGGCAGAGGTTGCAGTGAGCCGATATTGCACCATTGCACTCCAGTCTGGGCAACAAGAGTGAAACTCTGTCTCAAAAAAAAA"
"chr9","78131943","78132265","JH378105","46221579","46221896","48","31910364","GGCTGGGCACGGTGGCTCATGCCTGTAATCCCAGCACTTTGTGGGGCTGAGGCAAGCAGATCACCTGAGGTCAGGAGTTCAAGACCAGCCTAGCCAGCATGGTGAAACCTCCTCTCTACTAAAAATACAAAAAAAAAAAAAAAAAAAAAAAAAAGCCAGGCGTGGTGGCTGGCACCTGTAATCCCAGCTTCTCGGGAGGCTGAGGCAGGAGAATTGCTTGAACCCAGGAGGCAGAGGTTGCAGTGAGCCAAGATCACGCCATTGCCATTGCACTCCAGCCTGGGCAACAAGAGCGAGACTCTGTCTCAAAAAAAAAAAAAAAA","GACTGGGTGTGATGGCTCATGCCTGTAATCCCAGCACTTTGGGAGGCCAAGGCGGGTGGATCACCTGAGGTCAGGAGTTCAAGACCAGCCTGACCAACATGGTGAAACCCCGTCTCTACTAAAAAAAAAAAAAAAAAAAAAAAACTACAAAATTAGCTGGGCCTGGTGGTACACACCTATAATCCCAGCTACTTGGGAGGCTGAGGCAGGAGAGTTACTTGAACCCAGGAGGCAGAGGTTGCAGTGAGCTGAGATCATGCCATTGCACTCCATCCTGGGCAACAAGAGCGAAACTCTGTCTTAAAAAAAAAAAAAAAA"
"chr9","78725021","78725729","JH378118","18053084","18053501","347","60671937","GCCGGGCGCAGTGGCTCATGCCTGTAATCCCAGCGCTTTGGGAGGCCAAGGCGGGTGGATCACCTGAGGTCAGGAGTTTGAGAACAGCCTGGCCAATATGGTGAAACCCCATCTTTACTAAAAATATAAAAATTAGGGCTGGGCGCAGTGGCTCAGGCCTGTAATCCCAGCACTTTGGGAGGCCGAGGCAGGCGGATCACAATGTCAGGGGTTCGAGACCAGCCTGGCCAATGTCGTGAAACCCCGTCTCTACTAAAAATACAAAAAATTAGCCAGGTGTGGTGGCACGCGCCTGTAGTCCCAGCTACTCAAGAGGCTGAGGCAGGAGAATCACTTGAACCCGGGAGGCGGAGGTTGCAGTGAGCTGAGATCACACCAGCCTGGGCAACAGAGTGAGACTCCATCTCAAAAAAAAAAAACAACATATATATATGTGTGTGTATATATATATGTGTGTGTATATATATGTATATATGTGTATATATGTATATATATGTGTGTATATATGTGTATATGTGTGTGTGTGTATATATATAGCTGGGCATGGTAGTGGGCACCTGTAATCCTAGCTACTTGGGAGGCTGAGGCAGGAGAATCGCTTGAACCCAGGAGGTGGAGGTGGCAGTGAGCCGAGATTGTGCCATTGCACTCCTGCCTGGGCGACAAGAGTGAGACTCAGTCCCCCTACCACAAAAAATAAATAAATAAA","GGCTGGGCGCAGTGGCTCACACCTGTAATCCCAGCACTTAGGGAAGCTGAGGCGAGTAGATCACCTGAGGTCAGGAGTTAGAGACCAGCCTGGCCATCATGGTGAAACCCCGTCTCTACTAAAGATACCAAAAATTAGCTGAGTGTGGTGCTGGGTGCCTGTAATCCCAGAAACTCAGGGTGCCTGTAATCCCAGCAACTCAGGGTGCCTTTAATCCCAGCAACTGAGGGTACCAGTAATCCCAGCAACTCAGGGTGTCTTTAATCCTAGCAACTGAGGGCACCTGTAATCCCAGCAACTCAGGAAGCTGAGACAGGAGAAGTACTTGAACCCAGAAGGCAGAGGTTGCAGTGAGCCGATATTGCACCATTGCACTCCAGTCTGGGCAACAAGAGTGAAACTCTGTCTCAAAAAAAAA"
"chr9","78779465","78780075","JH378118","18053084","18053501","256","60726381","GGCCAGGCATGATGGCTCATGCCTGTAATCCCAGCACTTTGGGAGGCCAAGGTGGGCAGATCACCTGAGGTCAGGCGTTCAAGACCAGCCTGGCTAACATGATAAAACCCTGTCTCTACTAAAAATACAAAAATTAGGGCTGGGCACGGTGGCTCACACTTGTAATCCCAGCACTTCAGGAGACCAAGGCGGGCACATCACGAGGTCAGGAGTTCGAGACCAGCATGGCCAACACAGTGAAACCCTGTCTCTACTAAAAATACAAAAATTAGCTGGGCATGGTGACGGGCACCTGTAATCCCAGCTACTTGGGAGGCTGAGGCAGGAGAATCGCTTGAACCTGGGAGGCGGAGGTTGCAGTGAGCCGAGATCGTGCCACTGCACTCCAGCCTGGGTAACAGAGCTAGACTCTGTCTCAAAAAAAAAAAGAAAAAAAAAATACGAAAATTAGCAGGACATGGTGGGAGGTGCCTGTAATCCCAGCTACTTGGGAGGCTGAGGCAGGAGAATTGCTTGAACCTGGGAGACAGTGGTTTCAGTGAGCCGAGACCGCACCATTGCACTCCAGCCTAGGCAACAAAAGCAAAACTCTGTCTCAAAGAAAAAAAAAA","GGCTGGGCGCAGTGGCTCACACCTGTAATCCCAGCACTTAGGGAAGCTGAGGCGAGTAGATCACCTGAGGTCAGGAGTTAGAGACCAGCCTGGCCATCATGGTGAAACCCCGTCTCTACTAAAGATACCAAAAATTAGCTGAGTGTGGTGCTGGGTGCCTGTAATCCCAGAAACTCAGGGTGCCTGTAATCCCAGCAACTCAGGGTGCCTTTAATCCCAGCAACTGAGGGTACCAGTAATCCCAGCAACTCAGGGTGTCTTTAATCCTAGCAACTGAGGGCACCTGTAATCCCAGCAACTCAGGAAGCTGAGACAGGAGAAGTACTTGAACCCAGAAGGCAGAGGTTGCAGTGAGCCGATATTGCACCATTGCACTCCAGTCTGGGCAACAAGAGTGAAACTCTGTCTCAAAAAAAAA"
"chr9","82864668","82864991","JH378208","3909771","3910091","46","78954897","GGCTGGGTGCGGTGGCTCATGCCTGTAATCTCAGCACTTTGGGAGGTCGAGGCGGGTGGATCACCTGAGGTTAGGAGTTCAAGACCAGCCTGGCCAACATGGTGAAACCCCGTCTCTACCAAAAATACAAAAAAAAAAAAAAAAAAAAAAAAAAATAGCTGGGTGTGGTGGTGGGCACCTGTAATCCCAACTATTTGGGAGGCTGAGGCAGAAGAATCGCTTGAACCCGGGAGGCAGAGGTTGGAGTTAGCCGAGATTGCACCACTGCAATCCGTTCTGGGTGACAAGAGCGAAACTCAGTCTCAAAAAAAAAAAACAAAAAAA","GCCGGGTGCGGTGGCTCAAGCCTGTAATCCCAGCACTTTGGGAGGCCGAGGCGGGTGGATCACGAGGTCGTGAGATCAAGACCAGCCGAGCCAACATGGTGAAACCCCGTCTCTACTAAAAATACAAAAAAAAAAAAAAAAAAAAAAAAATTAGCTGGGCATGGTGGCGTGTGCCTGTAATCCGAGCTACTCAGGAAGCTGAGGCAGGAGAATTGCCTGAACCCAGGAGGCGGAGGTTGCAGTGAGCCGAGATCGCGCCATTGCACTCCAGCCTGGGTAACAAGAGCGAAACTCCGTCTCAAAAAAAAAAAAAAAAAAAAA"
"chr9","83606654","83606993","JH378122","29716059","29716383","57","53890595","GGCTGGGCACGGTGGCTCACACCTGTAATCCCAGCACTTTGGGAGGCCAAGATGGGTGGATCATCTGGGGTCAGGAGTTCGAGACCAGCCTGGCCAACATAGTGAAACTCCGTCTCTACTAAAAACAACAACAACAACAACAACAACAACAACACAACAAAATTAGCCAGGCATGGTGGTGTGCACCTGTAATCCCAGCTATTCAGGAGGCTGAGGCAGGAGAATCGCTTGAACCTGGGAGGCAAAGGTTGCAGTGAACCAAGATTGTGCCATTGCACTCCAGCCTGGGCAACAAGAGTGAAACTCTGTCTCAAAAAAACAAAAAGCAAAAACAAATAAA","GCTGGGTGTGGTGGTTCACACCTGTAATCCCAGCACTTTGGGAGGCCAAGGTGGGTGGATCACCTGAGGTCAGGAGTTTGAAACCAGCCTGGCCAATATGGTGAACCCTTGTCTCTAGTAAAAATACAAAAAAAAAAAAGAAAAAAAAATAGCCAGGTGTGGTAGCGGGCACCTGTAATCCCAGCTACTCAAGAGGCTGAGGCAGGAGAATCGCTTGAACCCGGGAGGCAGAGGTTGCAGTGAGTGCAGACCGTGCCATTGCACTCCACCCTGGGCAACAAGAGTGAAACTCCATCTCAAATAAATAAATAAACAAATAAATAAA"
"chr9","83774169","83774494","JH378279","1076331","1076650","61","82697838","GGTGGCTCACACCTGTAATCCCAACACTGGGAGGCCAAGGCGGGTGGATCACCTGAGGTCAGGAGTTCAAGACCAGCCTGGGCAACATGGTGAAATCCCCATCTCTACTAAAAATACAAAAATTAGTCAGATGTGGTGGCGGGCACCTGTAATCCCATAATCCCAGCTACTTGGGAGGCTGAGGCAGGAGAATTGCTGAGGCAGGAGGCGGAGGTTGCAGTGAGCCGAGATCATGCCATTGCACCCCAGCCTAGGCAACAAGAGTGCAACTTGGTCTCAATAAATAAATAAATAAATAAATAAATAAATAAAAATAAAAAGAAGAA","GGCATGGTGGCTCACACCTGTAATCCCAACACTTCGGGAGGCCGAGGTGGGTGGATCACCTGAGGTCAGGAGTTCAAGACCAGCCTGGCCAACATGGTGAAACCCCATCTCCACTAAAAATACAAAAAATTAGCCAGGCATGGTGGCAGGTGCTTGCAATCCAAGCTATTCAGGAGGCTGAGGCAGAAGAATTGTTTGAACGCTGGAGGCAGAGGTTGCAGTGAGCCAAGATTGCACCATTGCGCTCCAGCCTGGGCAACAAGAGTGAAACTCCATCTCAATAAATAAATAAATAAATAAGTAAATAAATAAATAAATAA"
"chr9","87411323","87411692","JH378109","21565230","21565567","78","65846093","GGCCGGGTGTGGTGGCCCACGGCTGTAATCCCAGCACTTTGGGGGCCGAGGCGAGTCGATCACCTGAGGCCAGGAGTTCGAAATGAGTCTGGCCAACATGGTGAAACCCGTCTCTACTAAAAATACAAAAAAAATTAGTTCGGCATAGTGGTGGGCGCCTGTAATCCCATCTACTTGAGAGGCTGGGGCAGGAGAATCGCTTGAACCGGGGAGGCAGAGGTTGCAGTGAGCCAAGATTGCACCATTGCACTCCAGCCTGGGCAACAAGAGTGAAAACCCTGCCGATAAGATAAGATAAGATAAGATAAGATAAGATAAGATAAGATAAGATAAGATAAATAAAATTAAAAGAAAATAAAGTAAAATAAAA","GGCCGGGCGCGGTGGCTCAAGCCTGTAATACCAGCACTTTGGGAGGCCGAGGCGGGTGGATCACGAGGTCAAGAGATCGAGACCATCCTGGTCAACATGGTGAAACCCCGTCTCTACTAAAAATACAAACAATTAGCTGGGCATGGTGGCGGGTGCCTGTAATCCCAGCTACTCCAGAGGCTGAGGCAGGAGAATTGCCTGAACCCAGGAGACGGAGGTTGCGGTGAGCCAAGATCGCGCCATTGCACTCCAGCCTGGGTGACAAGAGCGAAACTCCGTCTCAATAAATAAATAAATAAATAAATAAATAAAAATAAAATAAATAAATAAATAAATAA"
"chr9","96800689","96801286","JH378118","18053084","18053501","240","78747605","CAGGTGAAGTGGCTAACACCTGTAATCCCAGCACTTTGGGAGGCCGAGGCAGACAGATTACCTGAGGTCAGGAGTTCAAGACCAGCCTGGCCAACATGGTGAAACTCCATCTCTACTAAAAATAGAAAAATTAGGCCTGGCGCAGTGGCTCATGCCTGTAATCCCACCACTTTGGGAGGCCGAAGCAGGTGGATCACCCAGGCCAGTAGTTCGAGACCAGCCTGACCAACATGAAGAAACCCCGTCTCTACTAAAAATACAAAATTAGCCAGGCTTGGTGGCGCCTGCCTGTAATCCCAGCTACTGGGGAGGCTGAGGCAGGAGAATCGCTTGAATCCGGGAGGCGGAGGTTGTGGCAAGCCCATTGCACTTCAGCCTGGGTGACAACAGCGAAACTCTGTCTCCAAAAAAAAAAAAAAAAAAATACAAAAATTAGCTGGGCATGGTGGCAGGCACCTGTAATCCCAGCTACTCAGGAGGCTGAGGCAGGAGAATCGCTTGAACCCAGGAGGCAGAGGTTGCAGCAAGCTGAGATCACGCCATTGCACTCCAGCCTGGGCAACAAGAGTGAAACTCCATCTCAAAAAAAGAAAAAAAA","GGCTGGGCGCAGTGGCTCACACCTGTAATCCCAGCACTTAGGGAAGCTGAGGCGAGTAGATCACCTGAGGTCAGGAGTTAGAGACCAGCCTGGCCATCATGGTGAAACCCCGTCTCTACTAAAGATACCAAAAATTAGCTGAGTGTGGTGCTGGGTGCCTGTAATCCCAGAAACTCAGGGTGCCTGTAATCCCAGCAACTCAGGGTGCCTTTAATCCCAGCAACTGAGGGTACCAGTAATCCCAGCAACTCAGGGTGTCTTTAATCCTAGCAACTGAGGGCACCTGTAATCCCAGCAACTCAGGAAGCTGAGACAGGAGAAGTACTTGAACCCAGAAGGCAGAGGTTGCAGTGAGCCGATATTGCACCATTGCACTCCAGTCTGGGCAACAAGAGTGAAACTCTGTCTCAAAAAAAAA"
"chr9","98754629","98755240","JH378118","18053084","18053501","266","80701545","GCCAGGCGTGGTGGTGTACAGCTGAAGTCCCAGCTACTCGGGAGGTTGACGTGGGAGAATTGCTTGAGCCCAGGAGTTCAAAGACTGAATTCAGCCCGGGCAACATAGTAAGATACTGTCTCTTAAAGAAAAAAAAGGCCGGGTGTGGTGGCTCATGCCTGTAATCCCAGCACTTTGGGAGGCCAAGGTGGGTGGACCACCTGAGGTCAGGAGTTCGAGACCAGCCTGGCCAACAGGGTGAAACCCTGTCTCTACTAAAAATACAAAAATTAGCCAGGCGTGGTGGCAGGCACCAGTAATCCCAGCTACTCAGGAGGCTGAGGCAGGAGAATCGCTTGAACCCAGAAGGCAGAGGTTACAGTGAGCCGAGATTATGTCACTGCAATCCAGCCTAGGCAACAGAGCAAGACTCTGTCTCAAAAAAATAAATAAATAAAATTAGCTGGGTGTGGTGGCGCACAACTGTAATCCCAGCTACTCGGGAGGCTGAGGCAGGAGAATTGTTTGAACCCAGGAGGCGGAGGTTGCAGTGAGCCGAGATTGCACCATTGCACTCCAACCTGGGCAACAAGAGTGAAACTCCATCTTAGAAGAAGAAGAAGAAAACAAAAA","GGCTGGGCGCAGTGGCTCACACCTGTAATCCCAGCACTTAGGGAAGCTGAGGCGAGTAGATCACCTGAGGTCAGGAGTTAGAGACCAGCCTGGCCATCATGGTGAAACCCCGTCTCTACTAAAGATACCAAAAATTAGCTGAGTGTGGTGCTGGGTGCCTGTAATCCCAGAAACTCAGGGTGCCTGTAATCCCAGCAACTCAGGGTGCCTTTAATCCCAGCAACTGAGGGTACCAGTAATCCCAGCAACTCAGGGTGTCTTTAATCCTAGCAACTGAGGGCACCTGTAATCCCAGCAACTCAGGAAGCTGAGACAGGAGAAGTACTTGAACCCAGAAGGCAGAGGTTGCAGTGAGCCGATATTGCACCATTGCACTCCAGTCTGGGCAACAAGAGTGAAACTCTGTCTCAAAAAAAAA"
"chr9","98780694","98781281","JH378118","18053084","18053501","240","80727610","GGCCAGGCGTGGTGGCTCACGCCTGTAATCCCAGCACTTTAGGTAGCCGAGGCGGGCAGATCACCTGAGGTCAGGAGTTCAAGACCAGCCTGGCCAACATGGCAAAACCCCACCTCTATTAAAAATACAAAAATTAGGCCAGGCGCGGTGGCTTATGCCTATAATCCCAGCACTTTGGGAGGCCGAGGCGGGCGGATCACGAGGTCAGGAGATCGAGACCATCCTGGCCAACATGGTGAAAGCCCGTCTCTACTAAAAATACAAAAATTAGCTGGGCGTGGTGGCACATGCCTGTAGTCCCAAGCGACTCGGGAGGCTGAGGCAGGAGAATTGCTTGAACCTGGGAGGTTGCTGTGAGCTGAGATCATGCCATTGCACTACTGCCTGGTGACAGAGTGAGAGACTCCGTCTCAAAAAAAAAAAAAATTAGCTGGGCATGGTGGCGGGTGCCTGTAATTCCAGCTACTCAGGAGGCTGAAGCAAGAGAATCACTTGAACCCAGGAGGTGGAGGTTGCAGTGAGCCAAGATCGCACCACTACTTTCCAGCCTGAGCGACAAGAGCAAAATTCCATCTCAAAAATAATAAA","GGCTGGGCGCAGTGGCTCACACCTGTAATCCCAGCACTTAGGGAAGCTGAGGCGAGTAGATCACCTGAGGTCAGGAGTTAGAGACCAGCCTGGCCATCATGGTGAAACCCCGTCTCTACTAAAGATACCAAAAATTAGCTGAGTGTGGTGCTGGGTGCCTGTAATCCCAGAAACTCAGGGTGCCTGTAATCCCAGCAACTCAGGGTGCCTTTAATCCCAGCAACTGAGGGTACCAGTAATCCCAGCAACTCAGGGTGTCTTTAATCCTAGCAACTGAGGGCACCTGTAATCCCAGCAACTCAGGAAGCTGAGACAGGAGAAGTACTTGAACCCAGAAGGCAGAGGTTGCAGTGAGCCGATATTGCACCATTGCACTCCAGTCTGGGCAACAAGAGTGAAACTCTGTCTCAAAAAAAAA"
"chr9","99156600","99157382","JH378114","15957391","15957789","444","83199209","GGCCGGGCGCGGTGGCTCATGCCTGTAATCCCAGCACTTTGGGAGGCGGAGGCGGGTGGATCACTTGAGATCAGGAGGTCGAGACCAGCCTGACCAACACTGTGAAACCCCGTCTCTACTAAAAATATAAAAATTGGCCAGGTGCAGTGGCTCACACCTGTAATCCCAGCACTTTCGGAGGCCGAGGTGGGCGGATCACGAGGTCAAGAGATCAGGATCACCAACACGGTGAAACCCCATCTCCACTGAAAACACAAAAATTAGCTGGGCATGGTGGTGCACGCCTGTAGTCCCAGCTACTAGGGAGGCTAGGGCAGAAGAATCGCTTGAACCCAGGAGGCGGAGGTTGCAGTGAGCCGAGACTGCACCAATGCACTCTAGACTGGCAACAGAGTGAGACACTGTCTCAAAAAAAAAAACAAAACAAAACTGTGTATATATATATATATACAATTATATATATTATTATATATAATATATTTTATATATATTATATTTATAATATATATTATTATATATTTTATATATATTATATATTATAATATATATATTATTATATTAGTATATATAATATATATTATTATATATTATAATATATAATATATATAATATTATTTTATATATTATAATATATATATTATATATATATAATTAGCTGGGCATGGTGGCAGCTGCCTGTCATCCCAGCTACTCGGGAGGCTGAGGCAGAAGAATCACTTGAACCCGGGTGGCAGAGGTTAGAGTGAACTGAGATCACACCATTGCACTCCAGCCTGGGCGACA","GCAAGGAACGGTGGCTCATGCCTGTCATCCCAGCACTTTGGGAGGCTAAGGAGGGTGGATTACCGAAGGTCATGAGTTTGAGACCAGCCTGACCAACATGGTGAAAACCCCATCTCTACTAAAAATACAAAAAATTAGCCAGATACAGCTATGCGGCAGACTGGGGCAGGAGAATCGCTTGGACCCAAACCCCATCTCTACTAAAAATACAAAAAATTAGCCGGATACAGCTATGCGGGAGACTGGGGCAGGAGAATCGCTTGGACCCGGGAGGCAGAGATTGCAGTGAGATGAGACCATGCCATTGCTCTCTAGCTTGTGCGATGAGAACAAGACTCTGTCTCAAAAAAAAAAAAAAAAAAAAAAAAAAAAAAAAAAAAAAAAGAGAGAGAGAGAAAA"
"chr9","101214819","101215426","JH378118","18053084","18053501","256","83161735","GGCCAGACATGGTGGCTCATGCCTGTAATCCCAGCACTTTGGGAGGCCGACGCAGGTGGATCACCTGAGGTCAGGAGTTCAATACCAGCCCGGCCAATATGGTGAAACCCCACCTCTACTAAAAATACAAAAAAATTGGCTGGGCGCAGTGGCTCACACCTGTAATCCCAGCACTTTGAGAGGCCGAGGTGGCAGATCACAAGGTCAGGAGATAGAGACCATCCTGGCTATGGTGAAACCGGTCCCTACTAAAAATACAAAAATTAGCCAGGTGTGGTGGCTGGCGCCTGTAGTCCCAGCTACTTGGGAGGCTGAGGCAGGAGAATGGCATGAACCCAGGAGGCGGAGCTTGCAGTGAGCTGAGATCACGCCACTGCACTCCAGCCTGGGTGACAGAGCGAGACTCCATCTCAAAAAACAAAACAAAACAAAACAAAAACAAAAAAATTAGCTGGGCGTCTGTAATCCCAGTTACTCAGGAAGCTGAGGTGGGAGAATCGCTTGAACCTGGGAGGCAGAGGTTGCAGTGAGCCAAGATCGCACCATTGCACTCCAACCTGGGTGACAAAAGCGAAACTCTGTCTCAAAAAAAAAAATAAATAAATAAA","GGCTGGGCGCAGTGGCTCACACCTGTAATCCCAGCACTTAGGGAAGCTGAGGCGAGTAGATCACCTGAGGTCAGGAGTTAGAGACCAGCCTGGCCATCATGGTGAAACCCCGTCTCTACTAAAGATACCAAAAATTAGCTGAGTGTGGTGCTGGGTGCCTGTAATCCCAGAAACTCAGGGTGCCTGTAATCCCAGCAACTCAGGGTGCCTTTAATCCCAGCAACTGAGGGTACCAGTAATCCCAGCAACTCAGGGTGTCTTTAATCCTAGCAACTGAGGGCACCTGTAATCCCAGCAACTCAGGAAGCTGAGACAGGAGAAGTACTTGAACCCAGAAGGCAGAGGTTGCAGTGAGCCGATATTGCACCATTGCACTCCAGTCTGGGCAACAAGAGTGAAACTCTGTCTCAAAAAAAAA"
"chr9","101904328","101904957","JH378118","18053084","18053501","284","83851244","GGCCATGTGAGGTGGCTCGCACCTGTAATCCCAGTGCTTTAAGAGGCCGAAGCAGGAGGATCGCTTGAGCCCAGGAGTTAGAGGTTGCAGTCAGCCACTGCACTCCAACCTGGGCAACAAAGTGAGACCCCATCTCTTAAAAAAAAAAAAAGGAGGCTGGGCACGGTGGCTCATGCCCATAATCCCAGCACTTTGGGAGGCCGAGGCGGGTGGATCACCTGTGGTCAGGAGTTCGAGACCAGCCTGGCCAACATGGCGTAACCCCGTCCCTACTAAAAATACAAAAAGTAGCTGGGAGTGGTGGCAGGTGCCTGTAATCCTAGCTACTCGGGAGGCTGAGGCAAGAGAATTGCTTGAACCTGTGAGCCAGAGGTTGCACTGAGCCGAGATTGCACCCCTGCACTCCAGCCTGGGTGACAGAGTGAGACTCCATATCAAAAAAAAAAAAAAAAAATTAGCCGGGTGTGGTGGTGGACACCTGTAATCCCAGCTACTTGGGAGGGAGGTTGAGGCAGGAGAATCACTTGAACCTGGGAGGCAGAGGTTGCAGTGAGCCGAGATCACATCATTGCACTCCAGCCTAGGCAACAAGAGTGAAACTCCATCTCAAAAAAAAAAAAAAAAAAAGAA","GGCTGGGCGCAGTGGCTCACACCTGTAATCCCAGCACTTAGGGAAGCTGAGGCGAGTAGATCACCTGAGGTCAGGAGTTAGAGACCAGCCTGGCCATCATGGTGAAACCCCGTCTCTACTAAAGATACCAAAAATTAGCTGAGTGTGGTGCTGGGTGCCTGTAATCCCAGAAACTCAGGGTGCCTGTAATCCCAGCAACTCAGGGTGCCTTTAATCCCAGCAACTGAGGGTACCAGTAATCCCAGCAACTCAGGGTGTCTTTAATCCTAGCAACTGAGGGCACCTGTAATCCCAGCAACTCAGGAAGCTGAGACAGGAGAAGTACTTGAACCCAGAAGGCAGAGGTTGCAGTGAGCCGATATTGCACCATTGCACTCCAGTCTGGGCAACAAGAGTGAAACTCTGTCTCAAAAAAAAA"
"chr9","101912702","101913283","JH378118","18053084","18053501","232","83859618","GGGTGCGGTGGCTCACACCTGTAATCCCAGCACTTTGGGAGGCCAAGGCAGGTGGATTACCTGAGGTCAGGCATTCAAGACCAGCCTGGCCAACATGGTGAAACTCCGTCTCTACTAAAAATACAAAACTTGGGCCAGGCATGGTGGCTCATGCCGGTAATCCCAGCACTTTGGGAAGCTGAGGCAGGCGGATTGCCTGAGCTCAGGAGTTCGTGATCAGCCTGGGCAACACGGTGAAATGCCATCTCTACTAAAATACAAAAAATTAGCCAGGCATGGCAGTGTGTGCCTGTAGTCCAGGCTACTTGGGGAGGCTGAGGCAGGAGAATTGCTTGAACCCGGGAGGCGGAGGTTGCAGTGAGCTGAGATCATGTCACTGCACTCCAGCCTGGTGACAGAGAGAGACTCCATCTAAAAAAAAAGCCAGGTGTGGTGGTGGGCGCCTGTAATCCCAGCTACTCAGGAGGCTGAGGCAGGAGAATTGCTTGAACCCAGGAGGCGGAGTTTGCAGTAAGCTGAGATCATGCCATTGCAACTCTAGCCTGGGCAACAAGAGCGAAACTCCATCTCAAAATAAATAAA","GGCTGGGCGCAGTGGCTCACACCTGTAATCCCAGCACTTAGGGAAGCTGAGGCGAGTAGATCACCTGAGGTCAGGAGTTAGAGACCAGCCTGGCCATCATGGTGAAACCCCGTCTCTACTAAAGATACCAAAAATTAGCTGAGTGTGGTGCTGGGTGCCTGTAATCCCAGAAACTCAGGGTGCCTGTAATCCCAGCAACTCAGGGTGCCTTTAATCCCAGCAACTGAGGGTACCAGTAATCCCAGCAACTCAGGGTGTCTTTAATCCTAGCAACTGAGGGCACCTGTAATCCCAGCAACTCAGGAAGCTGAGACAGGAGAAGTACTTGAACCCAGAAGGCAGAGGTTGCAGTGAGCCGATATTGCACCATTGCACTCCAGTCTGGGCAACAAGAGTGAAACTCTGTCTCAAAAAAAAA"
"chr9","101950580","101951222","JH378118","18053084","18053501","289","83897496","GGCCAGGCGTGGTGGCTCACACCTGTAATCTCGGCACTTTGGGAGGCTGAGGCAGGCAGATCACTTAAGGTCAGGAGTTCAAGACCAGCCTGGTCAACCTGGTGAAACCCCATCTCTACTAAAAATACAAAATTAGCTGTGTGTGCTGGTGGGGCAGGGAAGAGCGGGGGGCGGGCAGCTATTTGGTTTCTTTCTCTTTTTTTTTTTCCTTGAGACGGAGTCTCGCTCTGTTGCCCAGGCTGGAGTACAATGGCGCCATCTCAGCTCACTGCAAGCTCTGCCTCCTGGGTTCACGCCGTTCTCCTGCCTCAGCCTCCTGAGTAGCTGGGACTACAGGTGCCCACCACCACGCCCGACTAATTTTTTATATTTTTAGTAGAGATGAGGTTTCACCGTGTTAGCCAGGATGGTCTGGATCTCCTGATCTCATGATCCACCCGGCTCGGCCTCCCAAAGTGCTGGGATTACAGGTGTGAGCACTGCACCCAGCCAATCCCAGCTACTTGGGAGGCTGAGGCAGGAGAATGGCTTGAACCCAGGAGGCAGAGGTTGCCGTGAGCCAAGATCATGCCATTGCACTGCAGCCTGGGCAACAAGAGCAAAACTCTGTCTCAAAAAAACAAAACAAAAACAAAAAAACAAA","GGCTGGGCGCAGTGGCTCACACCTGTAATCCCAGCACTTAGGGAAGCTGAGGCGAGTAGATCACCTGAGGTCAGGAGTTAGAGACCAGCCTGGCCATCATGGTGAAACCCCGTCTCTACTAAAGATACCAAAAATTAGCTGAGTGTGGTGCTGGGTGCCTGTAATCCCAGAAACTCAGGGTGCCTGTAATCCCAGCAACTCAGGGTGCCTTTAATCCCAGCAACTGAGGGTACCAGTAATCCCAGCAACTCAGGGTGTCTTTAATCCTAGCAACTGAGGGCACCTGTAATCCCAGCAACTCAGGAAGCTGAGACAGGAGAAGTACTTGAACCCAGAAGGCAGAGGTTGCAGTGAGCCGATATTGCACCATTGCACTCCAGTCTGGGCAACAAGAGTGAAACTCTGTCTCAAAAAAAAA"
"chr9","102742426","102743061","JH378118","18053084","18053501","284","84689342","GGCTGGGCCCGGTGGCTCACGACTCTATTCTCCAGCACTTTGGAAGGCCGAGGTGGGCAGATCCCTTGAGGTCAGGAGTTTGAGACCAGCCTGGACAACATGGTGAAACCCCATCTCTAAAAATATAAAAATTAGGGCCAGGCGCAGCAGCTCATGTCTGTAATCCCAGTACTTTGGGAGGCTGAGGCAGGTGGATCACGAGGTCAGGAGTTCGAGACCAGCCTGGCAAACATGGTGAAATCCCATCTCTACTAAAAATACAAAAAAAAAAAAAAAAAAAATTAGCTGGGCATGGTGGTGCACGCCCATAATCCCAGCTACTTGGGAGGCTGAGACAGGAGATTGCTTGAACCTGTGAGGGGGAGGTTGCAGTGAGCCGAGATCATGCCACTGCACTCCAGCCTGGGTGACAGAGTGAGATTCTGTCTTGGGGGGAAGAATAAAAGAAAAAAAATTTGCTGGGCATTGTGTTGCACGCCTGTAATTCCAGTTACTTGGAGGCTGAAGCAGGAGAATCATTTGAACCCAGGAGGCAGAGGTTGCAGTGAGCCGAGACCGTGCCATTGCACTCCAGCCTGGGCAACAAGAGCAAAACTCCATCTCAAAAATAAAATGAAAATAAAACAAGTCAAAAAA","GGCTGGGCGCAGTGGCTCACACCTGTAATCCCAGCACTTAGGGAAGCTGAGGCGAGTAGATCACCTGAGGTCAGGAGTTAGAGACCAGCCTGGCCATCATGGTGAAACCCCGTCTCTACTAAAGATACCAAAAATTAGCTGAGTGTGGTGCTGGGTGCCTGTAATCCCAGAAACTCAGGGTGCCTGTAATCCCAGCAACTCAGGGTGCCTTTAATCCCAGCAACTGAGGGTACCAGTAATCCCAGCAACTCAGGGTGTCTTTAATCCTAGCAACTGAGGGCACCTGTAATCCCAGCAACTCAGGAAGCTGAGACAGGAGAAGTACTTGAACCCAGAAGGCAGAGGTTGCAGTGAGCCGATATTGCACCATTGCACTCCAGTCTGGGCAACAAGAGTGAAACTCTGTCTCAAAAAAAAA"
"chr9","104009364","104009980","JH378118","18053084","18053501","256","85956280","GGCTGAGCATGGTGGCTCACACCTGTAATCTCAGCACTTTGGGAGGCTGAGGCGGGTGGATCACGATCACCTGACATCAGGAGTTCAACACCAGCCTGGCCAACATGGTGAAACCCCGTCTCTACTAAAAATACAAAAAAAATTAGGGCCAGGTGCAGTGGCTCACGCCTGTAATCCCAGCACTTTGGGAGTCCAAGGCAGGCTGATCACAAGGTTAGGAGTTCAAGACCAGCCTGGCCAACATGGTGAAACCCTGTCTCTATGAAAAATACAAAAATTAGCCGGGTGTGGTGGCGCACCCTTGTAATCCCAGCTACTTGGGAGGCTGAGGAAGGACAATCGCTTGAACGCAGGAGGCAGAGGTTGCAGTGAGCCAAGATTGCACCACTGCACTCTAACCTGGGTGACAGAGCAAGACTCCGTCTGGAAAAAAAAAAAAAAAAAAAAAATTAGCCAGGCATTGTGACAGGCGCCTGTAATCCCAGCTACTCAGGAGGCTGAGGAAGGAGAATCACTTGAACCCAGGAGACGGAGGTTGTGGTGAGGCAAGATCATGCCATTGCAGTCCAGCCTGGGCAACAAGAATGAAACTCCATCTCAAAAAAAAAAAAAAAAAA","GGCTGGGCGCAGTGGCTCACACCTGTAATCCCAGCACTTAGGGAAGCTGAGGCGAGTAGATCACCTGAGGTCAGGAGTTAGAGACCAGCCTGGCCATCATGGTGAAACCCCGTCTCTACTAAAGATACCAAAAATTAGCTGAGTGTGGTGCTGGGTGCCTGTAATCCCAGAAACTCAGGGTGCCTGTAATCCCAGCAACTCAGGGTGCCTTTAATCCCAGCAACTGAGGGTACCAGTAATCCCAGCAACTCAGGGTGTCTTTAATCCTAGCAACTGAGGGCACCTGTAATCCCAGCAACTCAGGAAGCTGAGACAGGAGAAGTACTTGAACCCAGAAGGCAGAGGTTGCAGTGAGCCGATATTGCACCATTGCACTCCAGTCTGGGCAACAAGAGTGAAACTCTGTCTCAAAAAAAAA"
"chr9","106235027","106235631","JH378118","18053084","18053501","263","88181943","GCTAGGCTTGGTGGCTCACGTCTGTAATCCCAGCACTTTGGGAGGCCAAGGTGGGTGGATCACCTCAGGTCAGGAGTTTTGAGACCAGCTGGCCAACATGGTGAAACCCTGTCTCTACTAAAATACAAAATGTGGGCCGGGCACGGTGGCTAATGCCTGTAATCCCAGCACTTTGGGAGGCCAAGGCAGGTGGATCACCTGAGGTCAGGAGTTCGATACCAGCCTGACCAACGTGGAGAAACCCTGTCTCTACTAAAAATACAAAATTAGCCAGGCGTGGTGGTGGGCGCCTGTAATCCCAGCTACTTGGGAGACTGAGGCAGAAGAATCACTTGAACCTGGGAGGTGGAGGTTGTGGTGAGCCAAGATCGCGCCATTGCACTCTCGCCTGGGCAACAAGACCGAAACTCTGTCTCCAAAAAAAATAAATAAAAAGTGAGCCAGGCATGGTGGCACATGCCTGTATTCCCAGCTAATGGGAGGCGGAGGCGGGAGAATCACTTGAACCCGCGAGGCGGAGGTTGCAGTGAGCGGAAATGATGCCATTGCACTCCAGCCAGAGCAACAGGACTGAAACTCCATCTCAAAAAAAAAAAAAAAAAAAA","GGCTGGGCGCAGTGGCTCACACCTGTAATCCCAGCACTTAGGGAAGCTGAGGCGAGTAGATCACCTGAGGTCAGGAGTTAGAGACCAGCCTGGCCATCATGGTGAAACCCCGTCTCTACTAAAGATACCAAAAATTAGCTGAGTGTGGTGCTGGGTGCCTGTAATCCCAGAAACTCAGGGTGCCTGTAATCCCAGCAACTCAGGGTGCCTTTAATCCCAGCAACTGAGGGTACCAGTAATCCCAGCAACTCAGGGTGTCTTTAATCCTAGCAACTGAGGGCACCTGTAATCCCAGCAACTCAGGAAGCTGAGACAGGAGAAGTACTTGAACCCAGAAGGCAGAGGTTGCAGTGAGCCGATATTGCACCATTGCACTCCAGTCTGGGCAACAAGAGTGAAACTCTGTCTCAAAAAAAAA"
"chr9","107169252","107170551","JH378118","18053084","18053501","895","89116168","GGCCAGGTGCGGTGGCTCACTTTGGGAGGCCCAGCACTTTGGGAGGCCGAGGCAGGCGGATCACCTGAGGTCAGGAGTTTGAGACCTGAAGGGGGCCAGCCCCTCCACACCTGCAAGTGTTTCTCATCAAGTAGGACGAGAGACTGAGAAAACAAGACACAGAGACAAAGTATAGAGAAAGAACAGTGGGCCCAGGGGACCGGCGCTCAGCATATGGAGGACCCGCGCCAGCACTGGTCTCTGAGTTCCCTCAGTATTTATTGATCACTAGCTCTACTATCTCAGTGAGGAGGATGTGGCAGGACTATAGGATAATGGTGGGGAGAGGGTCAGCAGGAAAACATGTGAGCAAAGATCTCTGTGTCATAAATAGGTTTAAGGAAAGGTGCTGTGCCTTGATGTGCACGTAGGCCAGATTTATGTTTGACTTTATACAAACCTCTCAGTGCAGTAAAAAGCAGTATTGCTGCCAGCATGTCTCACCTCCAGCCATAAGGCGGTTTTCTCCTATCTCAGTAAATAGAGCGTACGATCGGGTTTTACACTGAGACATTCCATTCCCAGGGATGAGCAGGAGACAGATGCCTTCCTCTTATCTCAGTGAGGCCTTCCTCTTTTACTAATCCTCCTCAGCACAGACCCTTTACGGGTGTTGGGCTGGGGGACGGTCAGGTCTTTCCCTTCCCACGAGGCCATATCTCAGGCTGTCTCAATGGGGAGAAACCTTGGACAATACCCAGGCTTTCTTGGGCAGAGATTCCTGTGGCCTTCAGCAGTGCATTGTGTTCCTGGTTAATCGAGAATAGAGAATGGCGATGACTTTTACCAAGCATACTGCCTACAAACACTTTTTTAACAAAGCACATCCTGCACAGCCCTAAATCCCTCAAACCTTGAGTCAACACAGCACATGTTTCTGCGAGCACAGGGTTGGGGCTAGGGTTACAGATTAACAGCATCTCAAGGCAGAAGAATTTTTCTTAGTACGGAACAAAATGGAGTTTCTTATGTCTTCTTCTTTATACATAGACACAATAACAGTCTGATCTTTCTTTCTTTCCCCCACAGAGACCAGCCTGGCCAACATGGCAAAACCCCGTCTCTACTAAACATACAAAATTTAGCCAGGCCTGGTGGTGGATGCCTGTAATCCCAGCTACTCGGGAGGCTGAAGCAGGAGAATCGTTTGAACTCGGGAGGTGGAGCTTGCAGTGAGCCAAGTTCGTGCCACTGCACTCCAGCCTGGGCGACAAGAGCGAAACTCTGTCTAAAAAAAAAAACCAAAAACCGAAAACAAAAA","GGCTGGGCGCAGTGGCTCACACCTGTAATCCCAGCACTTAGGGAAGCTGAGGCGAGTAGATCACCTGAGGTCAGGAGTTAGAGACCAGCCTGGCCATCATGGTGAAACCCCGTCTCTACTAAAGATACCAAAAATTAGCTGAGTGTGGTGCTGGGTGCCTGTAATCCCAGAAACTCAGGGTGCCTGTAATCCCAGCAACTCAGGGTGCCTTTAATCCCAGCAACTGAGGGTACCAGTAATCCCAGCAACTCAGGGTGTCTTTAATCCTAGCAACTGAGGGCACCTGTAATCCCAGCAACTCAGGAAGCTGAGACAGGAGAAGTACTTGAACCCAGAAGGCAGAGGTTGCAGTGAGCCGATATTGCACCATTGCACTCCAGTCTGGGCAACAAGAGTGAAACTCTGTCTCAAAAAAAAA"
"chr9","111672786","111673351","JH378118","18053084","18053501","228","93619702","CCCAGCACTTTGGGAGGCCGAGGTGGGTGGATCATGAGGTCAGGAGTTTGAGACCAGCCTGACCAACATGGTGAAACCCTGTCTCTATTAAAAATACAAAAATTAGGCTGGGCGCAGTGGCTCACGTCTGTAATCCCAGCAATTTGGGAGGCTGAGGCGAGTGGATCACCTGAGGTCAGGAGTTCGAGACCAGCCTGGCCAACATGGTGAAACCCCATCTCTACTAAAAATACAAAAATTAAATGGACATGGTGGCAGGCACCTGTATTCCCAGCTACTTGACAGGCTCAGGCAGGAGAATCACTTGAACCCAGGAGGCAGAGGTTGCAGTGAGCTGAGGCCGCACCATTGCACTCCAGCCTGGGTGACAAAAGCAAAACTCCGTCTCAAAAAAAAAAAAAATTAACCAGGCATGGTGGCGCGCGCCTGTAATCCCAGCTACTCAGGAGGCTGAGGCAGGAGAATTGCTTGAACCCAGGAGGTGGAGGTTGCAGTGAGCTGAGATCACACCATTGCACTGCAGCCTGGGCGACAAGAGCAAAACTCCATCTCAAAAAAAAAAAAAA","GGCTGGGCGCAGTGGCTCACACCTGTAATCCCAGCACTTAGGGAAGCTGAGGCGAGTAGATCACCTGAGGTCAGGAGTTAGAGACCAGCCTGGCCATCATGGTGAAACCCCGTCTCTACTAAAGATACCAAAAATTAGCTGAGTGTGGTGCTGGGTGCCTGTAATCCCAGAAACTCAGGGTGCCTGTAATCCCAGCAACTCAGGGTGCCTTTAATCCCAGCAACTGAGGGTACCAGTAATCCCAGCAACTCAGGGTGTCTTTAATCCTAGCAACTGAGGGCACCTGTAATCCCAGCAACTCAGGAAGCTGAGACAGGAGAAGTACTTGAACCCAGAAGGCAGAGGTTGCAGTGAGCCGATATTGCACCATTGCACTCCAGTCTGGGCAACAAGAGTGAAACTCTGTCTCAAAAAAAAA"
"chr9","111743856","111744202","JH378316","567988","568320","57","111175868","GGCTGAGTGTGGTTGGCTCATGCCTGTAATCTCAGCACTTTGAGAGGCTGAGGCGGGTGGATCACCTGAGCTCAGGAGTTCAAGACCGCCTGGCCAACATGGGGAAACCCCGTCTCTACTAAAAATACAAAAAATTAGCCGGGCGTGGTGGCAGGCACCTGTAATCCCAGCTACTCAGGAGGCTGAGGCAAGAGAATTGCTTGAACCTGGGAGGCAGAGATTGCAGTGAGCCGAAATCCCACCATTGCACTCCAACCTGGGCAACAAGAGTGAAACTCTGTCTCAAAAAAACAAAAAAACAAAAAAACAAAAAAACACACACACAGAAAGTGAAGAAAAAAGGAGAA","GGCCGGGCGTGGTGGCTCACGCCTGTAATCCCAGCACCTTGGGAGGCTGAGGCGGGTGGATCACGAGGTCAAGAGATTGAGACCAGCCTGGTCAACATGGTGAAACCCTGTCTACTAAAAAAATACAAAAATTAGCTGGGCATGGTGGCACGTGCCTGTAATCCCAGCTACTCAGGAGGCTGAGGCAGGAGAATTGCCTGAACCCAGGAGGCGGAGGTTGCGGTGAGCCGAGATCGCGCCATTGCACTCCAGCCTGGGTAACAAGAGCGAAACTCCGTCTCAAAAAACAAAAAACAAAAAAACAAAAAACAAACAAACAAACAAAAAAACAAA"
"chrX","3322109","3323007","JH378118","18053084","18053501","528","14730975","GGCTGGGCGTGGTGGCTCATGCCCGTAATCCCAGCACTTTGGGAGGCCAAGGTGGGTGGTCAGGAGTTCGAGACTAGCTTGACCAACATGGTTGTTTGAAATGCTTGTTACCTGGTGCCATAAGGAAATAGCACTTGAACATAAATTTAATTTACTCAGCAAGGCCATTTTTACTTCCTGCAGAAAGGGTACATGCTCCAGCAGTTTTGTCAGAGTATACCGAACAAAGGAGATACGGTAATTTATAACCTTACGCGTCCACCCTACTGCTGTGTCCAGTTTACATTGGCTGGAATGGGACCTCACATTCTGTATTTGTTCCAACTGGCTAGCAACTTAGAACTTTTTAAAAGAGGCAAAGGTAGAGGAGAACAAAGGAAGGAGGAAGTAACTTGTGGAATGCTGAGAAAGGTAAAAACACCTTCAAAGAAGGAAGAGGAGCAGGCTATGACCTAATGCTTGCTTGGACCAGTATAAGTATGCCAGGGCAAATATTTAGGCTAAATTGTGGGAGCTAAGAACATAAAGTACACTGATTTCCTTATCATGGCTAGCCAGTATTTAAGAATGTTAGCACAGGCCTTTGAATAAATTTTGCTTCTAAGAGAAGTTACTATTTATTCCTAATTAAATGGGGAGGAAAGTCTTTGAAGAGGAACCTCTACTTTACTTTTTACAATGGTGAAACTCAGTCTCTACTAAAAATACAAAAAATTAGCCAGGCATGGTGGTGGCCGCCTGTAATCCCAGCTACTCTGGAGGCTGAGGCAGAAAAATCGCTTGAACCTGGGAGGCGGAGGTTGCAGTGAGCTGAGATCACGCCATTGCACTCCAGCCAACATTGCACTCTTGGGCAACAGGAGTGAAACGCCATCTCAAAAAAAAAAAAAGAGAGAAAA","GGCTGGGCGCAGTGGCTCACACCTGTAATCCCAGCACTTAGGGAAGCTGAGGCGAGTAGATCACCTGAGGTCAGGAGTTAGAGACCAGCCTGGCCATCATGGTGAAACCCCGTCTCTACTAAAGATACCAAAAATTAGCTGAGTGTGGTGCTGGGTGCCTGTAATCCCAGAAACTCAGGGTGCCTGTAATCCCAGCAACTCAGGGTGCCTTTAATCCCAGCAACTGAGGGTACCAGTAATCCCAGCAACTCAGGGTGTCTTTAATCCTAGCAACTGAGGGCACCTGTAATCCCAGCAACTCAGGAAGCTGAGACAGGAGAAGTACTTGAACCCAGAAGGCAGAGGTTGCAGTGAGCCGATATTGCACCATTGCACTCCAGTCTGGGCAACAAGAGTGAAACTCTGTCTCAAAAAAAAA"
"chrX","7212244","7213595","JH378118","18053084","18053501","946","10840840","GGCCAGGTGTGGTGGCTCACACCTGTAATCCCAGCACTTTGGGAGGACAAGGTGGGCAGATCACCTGAGGTCAGGAGTTTGAGACCTGCTGTGGGAAGTCAGGGACCCCGAATGGAGGGACAAGCTAGAGCTGAGGCAGAAGAACATAAATTGTGAAGATTTCATGGACACTTACCAGTTCCCAAAATTAATACTTTTATCATTTCTTATGCCTGTCTTTACTGCAGAACATAAATTGTGAAGATTTCATGGACATTTATCCTTTCCCCAATCAATAGTCTTATAATTTCTTATGCCTGTCTTTACTTTAATCTCTTAATTCTGTTATCTTTGTAAGCTGAGAATGTATGTCACTTCAAGACCATATTTTACAATATGTGTGATTAAACAATATGAAATCAGTACACCCTGAAAAAGAACAGAATAACAGCGATTTTCAGGGAACAAGGAAAGATAACCATAAGGTCTGGCTGCCTGCAGGGTCAGGCAGAATACAGCATATTTTTCTTCACGCAGAAAGCCTATAGATGGATGTGTGAGGAGGAGAAATATCGCTGAATTCTTTTCCCAGCAAGGAATATTAATAATTGATACCCTGGGGAAGGAATGCATTCCTGGGGGGAGGTCTATGAATGGCCGCTCTGGGAGTGTCTGTCTTATGCTGTTGAGATAAGGACTGAAATACACCCTGGTCTCCTGCAGTACCCTCAGGCTTGCTAGGATTGGGAAATTCCATCCTGGTGAATTCTAGTCAGACTGGTTGTCTGCCCTCGAACCCTGTTTCCTGTTAAGATGTTTATCAAGACAATGTATGCACAGTGGGACATGGACCCTCATCAGTAATTCTAATTTTGTCCTTGCATTGTGATCTTTTATTGCCCTTTGAAGCATGTGATCTTTGTGACTTACTCCCTGTTCATACACCCCTTCCCCTTTCAAAATCCCTAATAAAAACTTGCTGGTTTTGCGGCTAGAGGTTGCCATCACGGTCCTACCGATATGTGATGGCACCCCTGGAGGCCCAGCTGTAAAATTCTTCTCTTTGTACTCTTTCTCTTTATTTCTCAGACCAGCCAACACTTAGGGAAAATAGAAAAGAATATACATTGAAATACTGGGGGCTGGTTCTCCTGATAGAGACCAGCCTGGCCAACATGGTGAAACCCCATCTCTACTAAAAATACAAAAAAAATTAGCTGGGTGTGGTGGCGTGTGCCTATAATCCCAGCTACTTGGGAGACTGAGGCATGAGAATTGCTTGAACCTGGGAGGTGGAGGCTGCAGAGAGCTGAGACCATGCCATTGAACTCCAGCCCAGGCAACAAGAATGAAACTCCGTCTCAAAAAAAAAA","GGCTGGGCGCAGTGGCTCACACCTGTAATCCCAGCACTTAGGGAAGCTGAGGCGAGTAGATCACCTGAGGTCAGGAGTTAGAGACCAGCCTGGCCATCATGGTGAAACCCCGTCTCTACTAAAGATACCAAAAATTAGCTGAGTGTGGTGCTGGGTGCCTGTAATCCCAGAAACTCAGGGTGCCTGTAATCCCAGCAACTCAGGGTGCCTTTAATCCCAGCAACTGAGGGTACCAGTAATCCCAGCAACTCAGGGTGTCTTTAATCCTAGCAACTGAGGGCACCTGTAATCCCAGCAACTCAGGAAGCTGAGACAGGAGAAGTACTTGAACCCAGAAGGCAGAGGTTGCAGTGAGCCGATATTGCACCATTGCACTCCAGTCTGGGCAACAAGAGTGAAACTCTGTCTCAAAAAAAAA"
"chrX","12018871","12019221","JH378114","18206329","18206669","56","6187458","GGCTGGGTGTGGTGGCTCACACCTGTAATCCCAGCACTTTGGGAGGCCAAGGTGGGCGGATCGCCTGAGGTCAGGAGTTCAAGACCAGCCTGGCCAACATGGTGAAACCCTGTCTCCACTAAAACTACAAAAATATTAGCCAGGCGTGGTGGCAGGGGCCTGTAATCCCAGCTACTGGGGAGGCTGAAGCAGGAGAATCACTTCAACTCGAGAGGCGGAGGTTGCAGTGAGCCGAGATCACACCATTGCACTCCAGCCTGGGCAACAAGAGTGAGACTTCATCTCAAAAAATAAATAAATAAATAAATAAATAAATAAATAAATAAAACAAAAACAAAAACAAAAACAAAA","GGCTGGGCGTGGTGGCTCATGCCTGTAACCCCAGCACTTTAGGAGGCTGAGGTGGGTGGATCACCTGAAGTTAGGAGTTTGAGACCAGCCTGGCCAACATGGTGAAACCCTGTCTCCACTAAAAATAGAAAAATTAGCCAGGCGTGGTAGCAGACATCTGTAATCCCAGCTACTCAGGAGACTTAGGCAGGAGAATTGCTTGAACTGGGAGGCAGAGGTTGCAGTGAACTGAGATCATGCCATTGCACTCCAGCCTGGGCAACAAGAGAAAGACTTCATCTCAAAAAGAAAACAAAAACAAAAACAAAAACAAAAACAAAAAAAAAAAAAGAAAAACAAAA"
"chrX","13335049","13335566","JH378106","3836420","3836780","257","9498629","TGGCCAACATAGTGAAACCCCGTCTCTACTAAAAATACAAAAATTAGCCGGGCATGGTGGTGGTGGTGGGCTTTTCTTTTTTCTTTGTTTTTTTTTTTTTTTTCCCCAAGACGGAGTCTTGCTGTCACCCAAAGCTGGAGTGCAGTGGCACGATCTCAGCTCACTGCAACCTGCGCCTCCCAGGTTCAAGCAATTCTCCTGCCTTAGCCTCCCGAGTAGCTGGGATTGCAGGCACGTGCCACCACGCTGGGCTAATTTTTGTATTTTTAGTAGAGACAGGGGTTTCACCATGTTGGCCAGGCTGGTCTTGAACTTCTGACCTCCTGATCTGCCCTCCTCGGCCTCCCAAAGTGCTGGGATTACAGGTGTGAGCAACCGCCCGCAGCCGGTTGTGGGCTTCTGTAATTCCAGCTATTTGGGATCTGAGATAGGAGAATCGCTTGAACCCAGGCAGCAGAGGTTGCAGTGAGCCAAGATCATGCCATTGAACTCCAGCCTGGGTGAGGAGAAACTCCATC","GGCCGGGTGTGGTGACTCATGCCTGTGATCCCAGCACTTTGGGAGGCATAGGTGGGAGGATCATCTGATGTCAGGGGTTCAAGACCAGCCTGGCCAAAATGATGAAACCCATCTCTACTAAAAATACAAAAAATTAGCCAAGCATGCTGATAGGCACCTGTAATCAACCTGTAATCCCAGCTATAATCTCATCTACTCGAGAGGCTGTACTCTGGCACCTCTAACCCCAGCTATTTGGGCACCTGTTATCCCAGCTACAAGAGAGGCTGAGGCAGGAGAATCACTTGAACCTGGAAGGCTGAGGTTGCAATGAGGCAACATTGCACCATTTCACTCCAGCCTGGGCAGCAAGAGTGCAACT"
"chrX","18599953","18600263","JH378129","14156160","14156469","75","4443793","GGCCGGACATGGAGGCTCACACCTGTAATCCCATCACTTTGGGAGGCTGAGGCGGGTGGATCACCTGTGGGCAGGAGTTCGAGATCAGCCTGACCAATGTAGTGAAACCCCATCTCTACTAAAAATACAAAATTAGCCAGTTACTTGGGAGACTGAGTCAGGAGAACCACTTGAACCTGGGAGATGGAGGTTGCAGTGAGCTGAGATGACGCCATTGTACTCCCGCCTGGGCAACAAGAGTGAAACTCCATCTCAACACACACACACACACACCACACACACACACACACACAAACCAAAAAAAAAAAAAA","GCCTGGCTTGGTGACTCATGCCTATAATTCTAGCACTTTGGGAGGCTGAGGTGGGTGGATCACCTGAGGTCAGGAGTTCAAGAGCAACATGGCCAACATAGTGAAAATCTATTTCTACTAAAAAAAAAAAAAAAGAAAGAAAATTATCTAGGGAAGCTGAGGTAGGAGAAACTCTGCCCCTGGGAGGTGGAGGTTGCAGTGAGCCCAGATTGCACCATTGCACTCCAGCCTGGGCAACAAGAGCAAAACTCCATCTCAAAACAAACCAACAAACAACAAAAACAAAGCAAAAACAATAATACAAACAAAA"
"chrX","34431333","34431764","JH378108","4185732","4186071","134","30245601","GGCTGGGCGCAGTGGCTCACACCTGTAATCCCAGCACTTTGGGAGGCCAAGGTGGGTGGATCACCTGAGGTCAGGAGTTCGAGACCAGCCTGGCCAACATGGCGAAACCCCGTCTCTACTAAAAATACAAAAATTCACTGGGCGTGGTAGCAGGAGCCTGTAATCCCAGCTACTTGGGAGGCTGAGGCAAGAGAATTGTTTGAACCCGGGAGGCAGCAGTTTCAGTGTGCCGAGATCGCGCCATTGCACTCCATCCTGGGTGGCAAGATCAAAACTCTGTCTCGAAAAAAAAAAAGAAACAAAAAAGAAAGAAAGGAAGGAAGAAAGAAAGAAAAAGAAAGAAAAAAAGAAAGAAAGAAAGAAAGAAAGAAAGAAAGAAAGAAAGAAAGAAAGAAAGAAAGAAAGAAAGAAAAAGAAAAAGAAAAAGGAAAA","GGCTGGGTGCGGTGGCTCACGCCTGTAATCCCAGTACTTTGGGAGGCCGAGGCGGGTGGATCATGAGGTCAGAAGATAGAGACCATCCTGGTCAACATGGTGAAACCCCGTCTCTATTAAAAATACAAAAAATAGCTGGGCCTGGTGGCGTATGCCTGTAATCCCAGCTACTCAGGAGGCTGAGGCAGGAGAATTGCCTGAACCCAGGAGGTGGAGGTCGCAGTGAGCCGAGATCGCGCCATTGCACTCCAGCCTGGGTAACAAGAGTGAAACTCCATCTCAAAAAAAAAAAAAAAAGAAAGAAAAAAAGAAAAGAAAAGAAAAAAAGAAAAAAAAGAAA"
"chrX","40832242","40832574","JH378105","46221579","46221896","51","5389337","GGCTGGGCGTGGTGGCTCATGCCTGTAATCCCAGCACTTTGGGAGGCCGAGGCTGGCGGATCACCTGAGGTCAGGAGTTCAAGAGCAGCCTGGCCAACATGGTGAAACACCATCTCTACTAAAAAAAAAAAAAAAAAAAAAAAAATACAAAAATTAGCCAGGGATGATGGCGGGCATCTATAATCTCAGCTACTAGGGAGGCTGAGGCTGGAGAATCGCTTGAACCCAGGAGGCAGAAGTGGCAGTGAGCGGAGATCGTGCCATTGCACTCCAGCTTGGGCTACAAGAGCGAAACTCGGTCTCAAAAAAAAAAAAAGAAAGAAAGAAAGAAAA","GACTGGGTGTGATGGCTCATGCCTGTAATCCCAGCACTTTGGGAGGCCAAGGCGGGTGGATCACCTGAGGTCAGGAGTTCAAGACCAGCCTGACCAACATGGTGAAACCCCGTCTCTACTAAAAAAAAAAAAAAAAAAAAAAAACTACAAAATTAGCTGGGCCTGGTGGTACACACCTATAATCCCAGCTACTTGGGAGGCTGAGGCAGGAGAGTTACTTGAACCCAGGAGGCAGAGGTTGCAGTGAGCTGAGATCATGCCATTGCACTCCATCCTGGGCAACAAGAGCGAAACTCTGTCTTAAAAAAAAAAAAAAAA"
"chrX","41351931","41352276","JH378114","26407278","26407597","62","14944653","GGCTGGGTGCGGTGGCTCACACTTGTAATCCCAGCACTTTGGGAGGCTGAGGCAGGCTGAGGAGGCTGAGGAGGCTGAGGATCACTTGAGGCCAGGAGTTTGAGACCAGCCTGGCCAACATAGTGAAAACCCGTCTCTACTAAAAATACAAAAAAAAAAAAAAAAAAATTAGCCAGGTGTGGTGGTGGGTGCCTGTAATCTCAGCTACTCGGGAGGCTGAGGCAGGAGAATCACTTGAACCTGGGAGGTGGAGGTTGCAGTGAGGGGAGATCACGCCATTGCACTCCAGCCTGGGTGAGAAGAGCGAAAATCTGTCTCAAAAAAAAAAAAAAAGAGAAAAAGAAAA","GGCCGGGCGCAGTGGCTCAAGCTTGTAATCCCAGCACTTTGGGAGGCCGAGGCGGGTGGATCACGAGGTCAAGAGATCGAGACCATCCTGGTCAACATGGTGAAACCCCGTCTCTACTAAAAATACAAAAAAAAAAAAAAAAAATTAGTTGGGCATGGTGGTGTGTGCCTGTAATCCCAGCTACTCAGGAGGCTGAGGCAGGAGAATTGCCTGAACCCAGGAGGCGGAGGTTGCGGTGAGCCGAGATCGCGCCATTGCACTCCAGCCTGGGTAACAAGAGCGAAACTCCGTCTCAAAAAAAAAAAAAAAAAAAAAAAAAA"
"chrX","41422637","41422984","JH378163","5010000","5010330","64","36412637","GGCCGGGCGCAGTGGCTCATGCCTGTAATCCCGGCACTTTGGGAGGCTGAGGTGGGCAGATCACCTGAGGTCAGGAGTTCGAGACCAGCCTGGCCAACATCTGTACTAAAAATACAACCCCATCTCTACTAAAAATACAAAAATTAGCCGGGTGTGGTGGTGGGTGCCTGAAATCTCAGCTACTCGGGAGGCTGAGGTAGGAGAATTGCTTGAACCTGGGAGTTGGAGGTTGCAGTGAGCCGAGACCACGCCATTGCACTCCAGCCTGGGCAAGAAGAGCAAAACTCCATCAAACAAAACAAAACAAAACAAAACAAAACACCCTGTCTCTACAAAAAAATACAAAAA","GGCTGGGTGTGGTGGCTCATGCCTGTAATCCCAGCACTTAAGGAGGCTGAGGCGGGTGGATCACCTGAGGCCAGGAGTTCGAGACCAGCCTGGCCAACATGGCGAAACCCCTGCCTCTACTAAAAATATAAAAATTAGCTGGACGTGGCAGTGGGTGCTTGTCATCCCAGCTATTTGGGAGGCTGAGGTAGGAGAATTGCTTGAACCTGGGAGGTGGAGGTTGCAGTGAGCCAACATCACATCATTGCACTCCAGCCTGGGCAACAAGAGTAAAACTCTTTCTCAAAACAAAACAAAACAAAACAAAACAAAACAAAACAAAACAAAACAA"
"chrX","43326631","43326970","JH378165","7366638","7366957","61","35959993","GCCGGACGTGGTGACTCATGCCTATAATCCCAGCACTTTGGGATGCCGAGGCGGATGTATCACCTGAGGTCAGGGGTTCAGGACCAGCCTGGCCAACATGGTGAAACCCCGTCTCTACTAAAAATACAAAAATTAGCCAGGCATGATGGCAGGCGCCTGTAATCCCAGCTACTCAGGAGGCTGAGGCAGGAAAACCACTTGAACCTGGGACACAGAGGTTGTAGTGAGCCGAGATTGTGCCATTGCACTCTAGCCTGGGCTAAAAGAGCAAAACTCTGTCTCACACACACAAACACACACACCACACACACACACACACACACACACAAAAGAAAAAAAA","GCCGGGCGTGGTGGCTCAAGCCTGTAATCCCAGCACTTTGGGAGGCCGAGGCGGGTGGGTCCCGAGGTCAAGAGATCGAGACCATCCTGGTCAACATGGTGAAACCCCGTCTCTACTAAAAATACAAAAATTAGCTGGGCATGGTGGCGCGTGCCTGTAATCCCAGCTACTCAGGAGGCTGAGGCAGGAGAATTGCCTGAACCCAGGAGGCGGAGGTTGTGGTGAGCCAAGATCGTGCCATTGCACTCCAGCCTGGGTAACAAGAGCGAAACTCTGTCTCCAAAACAAAACAAAACAAAACAAAACAAAACAAAACAAAA"
"chrX","45974881","45975214","JH378114","18206329","18206669","59","27768552","CGGGCATGGTGGCTCATGCCTGTAATCCCAGCACTTTGGGAGGCCGAGGCGGGCGGATCGCCTGAGGTCAGGAGTTCAAGACCAGCCTGACCAATGTGGTAAAACCCTGTCTCTACTAAAAATACAAAAATTAGTCGGGCATGGTGGCAGGCGCCTGTAATCCCAGCTACTTGGGAGGCTGAGGCAGGAGAATTGCTTGAACCTGGGGGGCAGAGGTTGCAGTGAGCGCCAATGCACTCCAGCCTGGGCAACAAGAGTGAAACTCCATCTCAAACAACAACAACAACAACAACAACAACAAACAGAAAGAAAAAAGAAAATAAGAAGAAAAAAA","GGCTGGGCGTGGTGGCTCATGCCTGTAACCCCAGCACTTTAGGAGGCTGAGGTGGGTGGATCACCTGAAGTTAGGAGTTTGAGACCAGCCTGGCCAACATGGTGAAACCCTGTCTCCACTAAAAATAGAAAAATTAGCCAGGCGTGGTAGCAGACATCTGTAATCCCAGCTACTCAGGAGACTTAGGCAGGAGAATTGCTTGAACTGGGAGGCAGAGGTTGCAGTGAACTGAGATCATGCCATTGCACTCCAGCCTGGGCAACAAGAGAAAGACTTCATCTCAAAAAGAAAACAAAAACAAAAACAAAAACAAAAACAAAAAAAAAAAAAGAAAAACAAAA"
"chrX","45980426","45980753","JH378137","13677298","13677634","53","32303128","GGCTGGATGCAGTGGCTCATGCCTGTAATCCCAGCACTTGGGAGACCGAGGCAGGTGGATCACCTGAGGTCGGGAGTTCAAGACCAGCCCGGCCAACGTGACAAAACCTCATCTCTACTAAAAAAAAAAAAAAAAAAAAAAAAAAAAATTTAAAAATTAGCCAGGCTTGGTGGCAGGCACCTGTAATCCCAACTACTAGGGAGGCTGAGGCAGGAGAATCACTTGAACCCGGGAGGTGGAGGTTGCAGTGAGCCGAGATCATGCTGTTGCACTCCATCCTGGACGACAAGAGCAAAACTCCATCTCAAAAAAAAAAAAAAAAAAAAAA","GGCTGGGCATTGTGGCTCATGCCTGTAATCCCAGCACTTTGGGAGGCCGAGGTGGGCGGATCACCTGAGGTCGGGAGTTCAAGACCAGCCTGGCCACAATGGTGAAACTCTGTCTCTGCTAAAAAAAAAAAAAAAAAAAAAAAAAAAAAAAAAAAAAAAATTAGCCAGGCGTGGTGGCACACGCCTGTAATCCCAGCTATTTGGGAGGCTGAGGCAGGAGAATCGCTTGAACCTGAGAGGTGGAGGTTGCAGTGAGCCAAGATCATACCATTGCACTCCAGCTTGGGAACAAAGAGCAAAACGCCATCTCAAAAACAAAACAAACAAACTGAAAAAA"
"chrX","46099079","46099432","JH378148","10302642","10302970","62","35796437","GGCCGGGAACAGTGGCTCATGCCTGTAATCCCAGCACTTTGGGAGGCCGAGGCAGGCGGATCACCTGAGGTCAGGAGTTCGAGACCTGCCTGGCCAATATGGTGAAACCCCATCTCTATTTTTTGTAAAAATACAAAAAAAATTAGCTGGGCTTGGTGGTGGGCACCTGTAATCCCAGCTACTCGGGAGGCTGAGGCAGGAGAATCGCTTGAACCTGGGAGGCGGAGGTTGCAGTGAGCCGAGATCATGCCATTGCACTCCAGCCTGGGTGACAAGAGTGAAACTCCGTCACACACACACACACACACACACATATACACACACACGAAAAGAAAAAAAAGAAAGAAATATAAA","GGCCGGGCGCGGTGGCTCAAGCCTGTAATCCCAGCACTTTGGGAGGCCGAGGCGGGTGGATCACGAGGTCAAGAGATCGAGACCATCCTGGTCAACATGGTGAAACCCCGTCTCTACTAAAAATACAAAAAATTAGCTGGGCATGGTGGTGGGTGCCTGTAATCCCAGCTACTCAGGAGGCTGAGGCAGGAGAATTGCCTGAACCCAGGAGGCGGAGGTTGCGGTGAGCCGAGATCGCGCCATTGCACTCCAGCCTGGGTAACAAGAGTGAAACTCTGCCTCAAAAAAAAAAAATAAAATAAAATAAAATAAAATAAAATAAAATAAAA"
"chrX","48488002","48488651","JH378118","18053084","18053501","291","30434918","GGCCAGGCGCGGTGGCTCACGCTTGTAATCCCAGCACTTTGGGAGGCCCAGGCAGGCAGATCACTTGAGGCCAAGAGTTCGAGACCAGCCTGGCCAACATGGTGAAACCCCACCTCTATTAAAAATACAAAAATTGCTGGGCGCGGTGGCTCACGCCTGTAATCCCAGCACTTTGGAAGGCCGAGGCGGGCGGATCACAAGGTCAGGAGATCGAGACCATCCTGGCTAACACAGTGAAACCCCATCTCTACTAAAAATACAAAAAATTAGCCAGACGTGGTGGCGGGTGCCTGTAATCCCAGCTACTGGGGAGGCTGAGGCAGGAGAATGGCATGAACCCGGGAGGCGGAGCTTGCAGTGAGCCGAGATTGCCCCACTGCACTCCAGCCTGGGCGAGTGCCGAGAGTGCGAGACTCCGTCTAAAAATAAATAAATAAATAAATAAATAAAATAAAATAAAAAAATAAAAATACAAAAATTAGCCGGGCATGGTAGCAGGCATCTGTAATCCCAGCTACTCGGGAGGGCGAGGCAGGAGAAATCACTTGAACCCGGGAGGAGGAGGTTGCAGTGAGCAGAGATCGCACCATTGCATTCCAGCCTGGGCTACAAGAGTCAAACTCCATCTCAAAAAAAAAAAAAAGACAAAA","GGCTGGGCGCAGTGGCTCACACCTGTAATCCCAGCACTTAGGGAAGCTGAGGCGAGTAGATCACCTGAGGTCAGGAGTTAGAGACCAGCCTGGCCATCATGGTGAAACCCCGTCTCTACTAAAGATACCAAAAATTAGCTGAGTGTGGTGCTGGGTGCCTGTAATCCCAGAAACTCAGGGTGCCTGTAATCCCAGCAACTCAGGGTGCCTTTAATCCCAGCAACTGAGGGTACCAGTAATCCCAGCAACTCAGGGTGTCTTTAATCCTAGCAACTGAGGGCACCTGTAATCCCAGCAACTCAGGAAGCTGAGACAGGAGAAGTACTTGAACCCAGAAGGCAGAGGTTGCAGTGAGCCGATATTGCACCATTGCACTCCAGTCTGGGCAACAAGAGTGAAACTCTGTCTCAAAAAAAAA"
"chrX","50491115","50491734","JH378118","18053084","18053501","264","32438031","GGCCGGGTGCGGTGGCTCACGTCTGTAATCCCAGCACTTTGGAAGGCCGTGGCAGGTGGATCACTTGAAGTCAGGAGTCCGAGACCAGCCTGGCCAACATGGTGAAACCCCATCTCTACTAAAAAATACAAAAATTAGCTGGGCGTGGCCGGGCACGGTGGCTCATACCTGTGATACCAGCACTTTGGGAGGTCGAGGTGGGTGGATCACAAGGTCAGGAGATCGAAACCATCCTGGCTAACAAGGTGAAACCCCGTCTCTACTAAAAATACAAAAAATTAGCCGGATGTGGTGGCGGGCGCCTGTAGTCCCAGCTACTCAGGAGGCTGAGACAGGAGAATGGCATGAACCCGGGAGATAGAGCTTGCAGTGAGCCAAGATCGTGCCACTGCACTCCAGCCTGGGCGACAGAGCCAGACTCCGTCTCAAAAAAAAAAAAAAAAACTTAGCTGGGCGTGGTGGCGATAATCCCAGCTACTCGGGAGGCTGAGGCAGGAGAATCTCTTGAACCCAGGAGGCACAGGTTGCAGTTAGCCAAGATTGTGCCATTGCACTCCAGCTGGGCAACAGGAGTGAAACGCCATCTCAAAACACAAAACAAAACAAAAGAAACAAGAAAA","GGCTGGGCGCAGTGGCTCACACCTGTAATCCCAGCACTTAGGGAAGCTGAGGCGAGTAGATCACCTGAGGTCAGGAGTTAGAGACCAGCCTGGCCATCATGGTGAAACCCCGTCTCTACTAAAGATACCAAAAATTAGCTGAGTGTGGTGCTGGGTGCCTGTAATCCCAGAAACTCAGGGTGCCTGTAATCCCAGCAACTCAGGGTGCCTTTAATCCCAGCAACTGAGGGTACCAGTAATCCCAGCAACTCAGGGTGTCTTTAATCCTAGCAACTGAGGGCACCTGTAATCCCAGCAACTCAGGAAGCTGAGACAGGAGAAGTACTTGAACCCAGAAGGCAGAGGTTGCAGTGAGCCGATATTGCACCATTGCACTCCAGTCTGGGCAACAAGAGTGAAACTCTGTCTCAAAAAAAAA"
"chrX","50899287","50899964","JH378118","18053084","18053501","314","32846203","GGCTGGGCGCAGTGGCTCACGCCTGTAATCCCAGCACTTTGGGAGACCAAGGCGGGCAGATCATCTGAGGTCAGGAGTTCAAGACCAGCCTGGCCAACATGGTGAAACTCTGTCTCTACTAAAAATACAAAAAAATTAGCCAGGCGTGCAGCCATAAAAAAGAATGAGTTCATATCCTTTGCAGGGACGTGGATGAAACTGGAAGCTATTATTCTCAGCAAACTAACACAGGAACAGAAAACCAAACACTGCATGTTCTCACTCATAAGTGGGAGCTGAACAGTGAGAACACATGGACACAGGGAGGGGAACATCACACACGGCCTGTTGAGGGGTCCGGGGAAAGGGGAGGGAGAGCATTAGGACAAATACCTAATGCATGCGGAGCTTAAAACCTAGATGACGGGTTGATAGGTGCAGCAAAGCACCATGGCACATGTATACCTATGTAACAAACCTGCATGTTCAGCACATGTATCCCAGAACTTAAAATTAAAAAAAAAAAAAATTAGCCAGGTGTAGTGGCAGGCGCCTGTAATCCCAGCTACTTGGGAGTGTGAGGCAGGAGAATCGCTTGAACCCGGTGGTGGAAGTTGCAGTGAACCAAGACCACGCCATTGCACTCCAGCCTGGGCAACAAGAAAGAAACTCTGTCTCGAAAAAAAAAAAAAAAAAAAA","GGCTGGGCGCAGTGGCTCACACCTGTAATCCCAGCACTTAGGGAAGCTGAGGCGAGTAGATCACCTGAGGTCAGGAGTTAGAGACCAGCCTGGCCATCATGGTGAAACCCCGTCTCTACTAAAGATACCAAAAATTAGCTGAGTGTGGTGCTGGGTGCCTGTAATCCCAGAAACTCAGGGTGCCTGTAATCCCAGCAACTCAGGGTGCCTTTAATCCCAGCAACTGAGGGTACCAGTAATCCCAGCAACTCAGGGTGTCTTTAATCCTAGCAACTGAGGGCACCTGTAATCCCAGCAACTCAGGAAGCTGAGACAGGAGAAGTACTTGAACCCAGAAGGCAGAGGTTGCAGTGAGCCGATATTGCACCATTGCACTCCAGTCTGGGCAACAAGAGTGAAACTCTGTCTCAAAAAAAAA"
"chrX","58881321","58881673","JH378232","255792","256130","56","58625529","GGCTGGGTATGGTAGCTCATGCCTGTAATCCCAGCACTTTGGGAGGCCAAGGTGGATGGATCATCTGAGGTCAGGAGTTCAGCAGCTCAAGACCAGCCAGGGCAACATGGTGAAATCCTGTCTCTATGGGAAAATACAAAAAATTAGCTGGGCATGGTGGTGGGCACCTGTAATCCTAGCTACTCAGGAGGCTGAGGCAGGAGAATTGCTTGAACCCAGGAGGCGGAAGCTGTAGTGAGCCGAGATCTCGCCATTGCACTCCGGGCTGGGCAACAAGAGCAAAACTCCATCTCAAAAACAAAACAAAACAAAACAAACAAACAAAAAAACAGAAAGAAAGAAAGAAAAGAAAA","GGCCGGGTGCGGTGGCTCACGCCTGTAATCCCAGCACTTTGGGAGGCCAAGGCGGGTGGATCATGAGGTCAAGAGATCGAGACCATCCCGGTCAACATGGTGAAACCTTGTCTCTACTAAAAATACAAAAAATTAGCTGGGCATGGTGGTGTGTGCCTATAATCCCAGCTACTCAGGAGGCTGAGGCAGGAGAATTGCCTGAACCCAGCAGGAGGCGGAGGTTGTGGTGAGCCGAGATCGCGCCATTGCACTCCAGCCTGGGTAACAAGAGCAAAACTCCGTCTCAAAAACAAAACAAAACAAAACAAAACAAAACAAAACAAAACAACAAAAAACAAA"
"chrX","58997284","58997606","JH378113","28425684","28425994","46","30571600","GGCTGGGCCTGGTGGCTCACACCTGTAATCCCAGCACTTTGGGAGGCTGAGATGGGTGGATCACTTGAGGTCAGGAGTTCGAGACCAGCCTGGCCAACATGGTGAAACCTCATCTGTACTAAAAATACAAAAATTAGCTGGGCGTGGTGGCAGGTTCCTGTAATCCCAGCTACTCAGGAGACTGAGACAGGAGAATCGCTTGAACCTGGGAGGCGGTGGTTGCAGTGAGCCAAGATTGCACCATTGCACTCCAGCCTGGGTGACAAGAGTAAAACTATGTCAAACAACAACAACAACAACAACAACAACAGAAAAAAAACAAA","GGCTGGGTGCAGTGGCTCACACCTGTAATTCCAGCACTTTGGGAGGCTGAAGTGGGTGGATCACTTGAGGTCAGGAGTTCCAGACCAGCCTGGCCAACCTGGTGAAAGCCCATCTTTACTAAAAATACAAAAATTAGCTAGGTATGGTGGCAGGTGCCTGTAATCCCAGCTACTCGAGAGGCTGAGGCAGGAGAATCGCTTGAACCTGGAAGGAAGAGGTTGCAGTGAGCTGAGATCGCGCCATTACACTCCAGCCTGGGTGACAAGAGTGAAACTCTGTCTCAAAAAAAAAAAAAAAAAAAAGAAAGAAA"
"chrX","60975885","60976216","JH378152","15932639","15932952","60","45043246","GGCCAGGCACATTGATTCACGCCTGTAATCTCAACACTTTGGGAGGCCGAGGCAGGCGGATCACCTGCAGTCAGGAGTTTGAGACCAGCTTGGCCAACATAGTGAAATCCCCGTTTCCACTAAAATAAATAAATAAATAAATAAATAAATAAATAAAATTACCCAGGAGTGGTGATGTGCACCTGTAATCCCAGCTACTCCAGAGGCTAAGGCAGGAGAATTGCTTGAACCCGGGAGGCAGAGGTTGCAGTGAGCCAAGATTGCGCCATTGCACTCCAGCCTGGGTGACAAGAGTGAAGACTCCATCTCAAAAAAAAAAAAAACAAAAAAAA","GGCCGGGCATGGTGGCTCAAGCCTGTAATCCCAGCACTTTGGGAGGCCGAGGCGGGTGGATCACGAGGTCAAGAGATTGAGACCATCCTGGTCAACATGGTGAAACCCCGTCTCTACTAAAAATACAAAAAAAAAAAAAAAAAAAATAGCTGGGTGTGGTGGCGTGTGCCTGTAATCCCAGCTACTCAGGAGGCTGAGGCAGGAGAATTGCCTGAACCCGGGAGGCGGAGGTTGCGGTGAGCCGAGATCGCGCCATTGCACTCCAGCCTGGGTAACAAGAGCGAAACTCCGTCTCAAAAACAAAAAAAACAAAA"
"chrX","65141810","65142148","JH378197","364249","364588","54","64777561","GGCCAGGTATGGTGGCTTACGCCTGTAATCCTAGCGCTCTGGGAGGCTGAGGCAGGTGGATCACCTGGGGTCAGGAGTTCGAGACCAGCCTGGCCAACATGGTGAAACCCCGTCTCTACTAAAAATACAAAAATTAGCCGGGCATGGTGGCGAGCGCCTGTAATTCCAGCTATTGGGAGGCTGAGACAGGAGAATTACTTGAACCCCGGAGGTGGAGGCTGCAGTGAGCTGAGACTGTGCCACTGCACTCCAGCCTGGGAGACAAGAGTGAAGCTCCATCTCAACAAACAAACAAACAAACAAAAAAAAAACAAAAAAAAAGAAAAGAAAAGAAAAAAA","GGCTGGGTGCAGTGGCTTACGCCTGTAATCCCAGCACTTTGGGAGGCCGAGGCGGGTGGATCATGAGGTCAAGAGATCGAGACCATCCTGGTCAACATGGTGAAACCCCGTCTCTACTAAAAATACAAAACATTAGCTGGGCATGGTGGTGCGTGCCTGTAATTCCAGCTACTCAGTAGGCTGAGGCAGGAGAATTGCCTGAACCCAGGAGGTGGAGGTTGCGGTGAGCCAAGATCGCGCCATTGTACTCCAGCCTGGGTAACAAGAGCGAAACTCCATCTCAAAAACAAACAAACAAACAAACAAACAAACAAACAAACAAACAAACAAACAAAAAAAC"
"chrX","66279350","66279936","JH378206","6546474","6546861","248","59732876","GGCCCGGCCGGTGGCTCACGCCTGTAATCCCATCACCTTGGGAGGCCAAGGCAGGTGGATCAGCCTGGCCAACATGTGAAACCCCGTCTCTATTAAAAAATACAAAAAATGGCCGGGCGCGGTGGCTCACGCCTGTAATCCTAGCACTTTGGGAGGCCGAGGCGGGCGGATCACGAGTCAGGAGATCGAGACCATCCTGGCTAACACGGTGAAACCCGTCTCTACCAAAAATACAAAAATATTAGCCGGGCGTGATGGCCGGCGCCTGTAGTCCCAGCTACGCGGGAGGCTGAGGCAGGAGAATGGCGTGAACCCGGGAGGCGGAGCTTGCAGTGAGCCGAGATTGTGCCACTGCACTCCCGCCTGGGCGACAGAGCGAGACTCCGTCTAAAAAAAAAAAAATACAAAAAATTAGCCAGGCGTGGTGGCAGGCAACTGTAATCCCAGCTACTCGGGAGGATGAGGCGGGAGAATCACTTGAACCGGGAGGCAGAGGTTGCAGTGAGCCGAGATCACACCATTGCACTCCAGCCTGGGTAACGAGAGTGAAACTCCGTCTCAAAAAAAAAAAAAAAAAAAAAAAAGAA","GGCCACACATGGTGGCTAACGCCTGTAATCCCAGCACTTTGGGAGGCCAAGTCGGGTGGATCATGAGGTCAGGAGACCAAGACCATCCTGGCCAAATGGTGAAACCCCGTCTCTACTAAAAATACAAAAATTAGCTGGGCATGGTGGCGTGTGCCTGTAATCCCAGCTACTCAGGAGGCTGAGGCAGGACAATTGCCTGAACCCAGGAGAATTAGCTGGGCATGGTGGCGTGTGCCTGTAATCCCAGCTACTCAGGAGGCTGAGGCAGGACAATTGCCTGAACCCAGGAGGCGAAGGTTGCGGTGAGCCGAGATTGTGCCATTGCACTCCAGCCTGGGTAACAAGAGCGACACTCTGTCTCAAAAAAAAAAAAAAAAAAAAAAAAAAA"
"chrX","95466990","95467595","JH378118","18053084","18053501","260","77413906","CCAAGCATGGTGGCTCATGCCTGTAATCCCAACACTTTGGGAGGCCAGGGCAGGCAGATCACAAGGTCAGGAGTTCCAGACCAGCCTGGCCAACATGGTGAAACCCCGTCTCTACTAAAAATACAAAAATTAGGACCGGGAGCAGTGGCTCATGCCTGTAATCCCAACACTTTGGGAGGCCAAGGCAGGTGGATCACGAGGTCAGGAGTTCGAGACCAGCCTGGCCAATATGGTGAAACCCCGTCTCTACCAAAAATACAAAAATTAGCTGGGCGTGGTGGCATGCACCTGTAGGCCCAGCTACTCGGTAGGCTGAGTTAGGAGAATTGCTTGAACCCAGGAGGCGGAGGTTGCAGTGAGCCGAGATCACGCCACTGCACTCCAGCCTGGGCGATAGAGTGAGACTCAATCTCAAAAAAAAAAAAACCCTACAAAAATACAAAAATTAGCCAGGCATGTTGGCAAGTGCCTGTAACCCCAGCTACTTGGGAGGCTGAGGCAGGAGAATTGCTTGAACCTGGGAGGTGGAGGTTGCAATGAGCCAAGACTGTGCCATTGCACTCCAGCCTGGGCAACAAGAGCAAAACTCTGTCTCAAAAAAAAAAA","GGCTGGGCGCAGTGGCTCACACCTGTAATCCCAGCACTTAGGGAAGCTGAGGCGAGTAGATCACCTGAGGTCAGGAGTTAGAGACCAGCCTGGCCATCATGGTGAAACCCCGTCTCTACTAAAGATACCAAAAATTAGCTGAGTGTGGTGCTGGGTGCCTGTAATCCCAGAAACTCAGGGTGCCTGTAATCCCAGCAACTCAGGGTGCCTTTAATCCCAGCAACTGAGGGTACCAGTAATCCCAGCAACTCAGGGTGTCTTTAATCCTAGCAACTGAGGGCACCTGTAATCCCAGCAACTCAGGAAGCTGAGACAGGAGAAGTACTTGAACCCAGAAGGCAGAGGTTGCAGTGAGCCGATATTGCACCATTGCACTCCAGTCTGGGCAACAAGAGTGAAACTCTGTCTCAAAAAAAAA"
"chrX","105455725","105456048","JH378192","5372003","5372306","55","100083722","GGTCAGGCGCCGGGGCTCACTCCTGTAATCCCAGCACTTTGGGAGGCTGAGGCAGGCGGATCACCTGAGGTCAGGAGTTCGAGACCAGCCTGGCCAACACGGTGAAACCCCATCTCTACTAAACACAAACACACACACACACACACACACACACAAACACACACACACAAAGCTGGGCGTGGTGGCAGGCGCCTGTAATCCCAGCTACTCAGGAGGCTGAGGCAGGAGAATTGCGTGAACCCTGGAGGCAGAAGTTGCAGTGAGCAGAGATCGCGCCATTGCACTCCAGCCTGGGCAACAAGAGCGAAACTCCGTCTCAAAAAA","GCCGGGCATGGTGGCTCACACCTGTAATCCCAGCACTTTGGGAAGCTGAGGCAGGTGGATCACCTGAGGTCAGGAGTTCAAGACCAACCTGGCCAACATAGTGAAACCCGGTCTCTACTAAAAATACAAAAAAAAAAAAAAAAAAAAAATTAGCTGGGTGTGGTGGCAGGCGCCTGTAATCCCAGCTACTAGGAGGCTGAGGCAGGAGAATTGCTAGAACCCAGGAGGTGGAGGTTGTAGTGAGCCAAGATTGCACCATTGCACTCCAGCCTGGGCAACAAGAGTGACACTCTGTCTCAAAAAA"
"chrX","113990824","113991428","JH378118","18053084","18053501","245","95937740","GGCCGGGCACGGTGGCTCATGCCTGTAATCCCGGCACTTTGGGAAGCCAAGACAGGTGGATCACCTGAGGTCAGGAGTTCGAGACCAGCCTGGCCAACATGGTGAAACCCCGTCTCTACTGAAAATACAAAAATTAGCCAGGTGCGGTTGCTCACGTCTGTAATCCCAGCACTTTGGGAGGCCGAGGCTGGCAGATCACCTGAGGTCGGGAGTTCGAGACCAGCCTGACCAACATGGAGAAACCCTGTCTCCACTAAAAAAATACAAAATTAGCTGGGCATGGTGGTGCACGCCTGTAATCCCAGCTACTTGGGAGGCTGAGGCAGGAGAATCGCTTGAACCCGGGAGACGGAGGTTGCAGTGAGCCGAGATGGTGCCATTGCACTCCAGCCTGGGCAACAAGAGCGAAACTCCGTCTCAAGAAAAAAAAAAAAAAAAAATCAGCCGGACATGGTGGCAGGCGTCTGTAATCCCAGCTACTCGGGAGGCTGACGCAGGAGAATCACTTGAACCTGGGAGGCAGAGGTTGCAGTGAGGTGAGATCGCACCATTGCACTCCAGCCTGGGCTACAAGAGCTAGACACTGTTTCAAAAAAAAAAAAAAA","GGCTGGGCGCAGTGGCTCACACCTGTAATCCCAGCACTTAGGGAAGCTGAGGCGAGTAGATCACCTGAGGTCAGGAGTTAGAGACCAGCCTGGCCATCATGGTGAAACCCCGTCTCTACTAAAGATACCAAAAATTAGCTGAGTGTGGTGCTGGGTGCCTGTAATCCCAGAAACTCAGGGTGCCTGTAATCCCAGCAACTCAGGGTGCCTTTAATCCCAGCAACTGAGGGTACCAGTAATCCCAGCAACTCAGGGTGTCTTTAATCCTAGCAACTGAGGGCACCTGTAATCCCAGCAACTCAGGAAGCTGAGACAGGAGAAGTACTTGAACCCAGAAGGCAGAGGTTGCAGTGAGCCGATATTGCACCATTGCACTCCAGTCTGGGCAACAAGAGTGAAACTCTGTCTCAAAAAAAAA"
"chrX","115297540","115297885","JH378208","3925639","3925977","50","111371901","GCTGGGCACAGTGGCTCATGCCTGTAATCCCATCACTTTGGGAGGCTGAGGCAGGTGGATCATCTGAGGTCAGGAGTTCAAGGCCAGCCTGGCCAACATAGTGAAACCCCGTCTCTACTAAAAAGAATACAAAAAATTAGCTGGGCGTGGCGGTGGGTGCCTGTAATCCCAGCTACTAGGGAGGCTGAGGCAGGAGAATCACTTGAACCTGGGAGGCAGAGGTTGCAGTGAGCTGAGATTACGCCATTGCACTCCAGCCTGGGCAACAAGAGTGAAACTTTGTCTCAGAAAAGAAATAAATGAATAAATAAATAAATAAATAAAAAGTAAAAAATTAAAAAAAAAA","GGCCGGGCGCGGTGGCTCAAGCCTGTAATCCCAGCACTTTGGGAGGCCGAGGCGGGTGGATCACGAGGTCAAGAGATCGAGACCATCCTGGTCAACATGGTGAAACCCCGTCTCTACTAAAAAAAATACTAAAAAATTAGCTGGGCATGGTGGCGTGTGCCTGTAATCCCAGCTACTCAGGAGGCTGAGGCAGGAGAATTGCCTGAACCCAGGAGGCGGAGGTTGTGGTGAGCCGAGATCGCGCCATTGCACTCCAGCCTGGGCAACAAGAGCGAAACGCCATCTCAAAAAAAATAAATAAATAAATAATAAATAAATAAATAAAAAATAAAAAATAAA"
"chrX","124063597","124063908","JH378114","2159383","2159672","59","121904214","CCTGTAATCCCAGCACTTTGAGAGGCTGAGGTGGGCTGGTGGATCACCTGAGGTCAGGAGTTCAAGACCAGCCTGGCCAACATGGTGAAACCCCATCTCAACTAAAAATATGAAAATTAGCTGGGTGTGGTGGTGGACACCTGTAATCCCAGCTACTCGGGAGGCTGAGATAGGAGAATCACTTGAACCCGGGAGGCAGAGTTTGCAGTGAGCCGAGATTGTGCCATTGCACTCCAGCCTGGGCGATACAAGCAAAACTCCATCTCAATAAATAAATAAATAAATAAATAAATGAAAGAAAGAAATGAAAAA","CCGTAATCCCAGCACTTTGGGAGGCTGAGGCGGTGGATTGCCTGAGGTCAGGAGTTCGAGACTAGCCTGGCCAACATAGTGAAACCTCGTCCATACTAAAAATACAAAAAATTAGCTGGGTGTGGTGGTACATGCCTGTAATCCCAGCTACCAGGAAGGCTGAGGCAGAAGGATCACTTGAACCCAGGAGGCGGAGGTTGCAGTGAGCCGAGATCATGCCATTGCACTCCAGGCTGGGCAACAAGAGCGAAACTCCATCTCCAAAAAAAAAAAAAAAAAAAAAAAAGAAA"
"chrX","126319904","126320233","JH378117","16180246","16180577","52","110139658","GGCTGGGTGCAGTGGCTCACACCTGTAATTCCAGCACTTTGGGAGGCCAAGGTGGGTGGATCACCTGGGGTTGGGAGTTGGAGACCAGCCTGGCCAACATGGTGAAACCCCATCTCTACTAAAAATACAAAAAAAAAAAAAAAAAAAAAAAAAAAATTGCCAGGTGTGGTGGCAGGTACCTGTAATCCCAGCTACTCGGGAGGCTGAAGCAAGAGAATCACTGAAACCCAGGAGGCAGAGGTTGCAGTGAGCCGAAATCGCGCCATTGCACTCCAGCCTGGGCATCAAGAGCAGGGCTCCATCTCAAAAAAAAAAAAAAAAAAAAAAAAA","GGCCGGGCGCGGTAGCTCAAGCCTGTAATCCCAGCACTTTGGGAGGCTGAGGCGGGTGGATCATGAGGTCAAGAGATCGAGACCATCCTGGTCAACATGGTGAAACCCCGTCTCTACTAAAAATACAAAAAAAAAAAAAAAAAAAAAAAAAAAAAATTAGCTGGGCATGGTGGCGCTTGCCTTTAATCCCAGCTACTCAGGAGGCTGAGGCAGGAGAATCACCTGAACCCAGAAGGCGGAGGTTGCGGTGAGCTGAGATCACGCCATTGCACTCCAGCCTGGGTAACAAGAGCGAAACTCCGTCTCAAAAAAAAAAAAAAAAAAAAAAAGAA"
"chrX","131576430","131576745","JH378123","253789","254096","57","131322641","GCCAGATGCAGTGGCTCACGCCTATAATCTCAGCACATTGGGAGGCCGAGGCGGGCAGATCACCTGAGGTTAGGGGTTCAAGACCAGCCTGGCCAACAGTGAAACCCTGTCTCTACTAAAAATACAAATAATAATAATAATAATAATAATAACTGGCATAGTGGCAGGCATCTGTAATCCCAGCTACTTGGAAAGCTGAGGCAGGAAAATCGCTTGAACCTGGGAAGCAGAGGTTGCAGTGAGCTGAGATCACACCATTGCACTCTAGCCTGGGCAACAAGTGCAAAACTGTCTCAGAACAGAGAAGAAAAAAAAA","GCCGGATACAATGGCCCTTGCCTGTAATCCTAACACTTTGGGAGGCCAAGGCGGGCCAATCACTTGAGGTCAGGAGTTCAAAACCAGTCTGGCCAACATAGTGAAACCCTGTCTCTACAAAAATACAAAAAATAAAATAAAAAATTAGCCAGGCATAGTGGCAGGCACCTGTAATCCCAGCTACTGAGGAGGGTGAGGCAGGAAAATCGCTTGAACCCGGGAGGCAGAAGTTGCAGTGAGCAAAGATTGCACCATTGCACTCCAGCCTAGGCAACAAGAGCCAAAACTCCAAAAAAAAAAGAAAAAAA"
"chrX","132318073","132318442","JH378131","1489062","1489397","79","130829011","GCCAGGCGCAGTGGCTCACGCCTGTAATCCCAGCACTTTGGGAGGCCAAGGCAGGCAGATCATCTGAGGTCAGGAGTTTGAGACCAGCCTGGCAAACGTGGTGAAACCCTGTCTCTACTAAAAATACAAAAAAAAAAAAAAAAAAAATAGCCGGGTGTGGTGGTGGACGCCTGTAATCCCAGCTACTCCGGAGGCTAAGGCAGGAGAATTGCTTGAACCTGGGAGGCGGAGGTTGCAGTGAGTTGAGACAGCACCATTGCACTCCAGCCTGGGTGACAAGAGCAAAACTTCACCCTTAACACACACACACACACACACACACACACACACACAAACATACAACAAAACAAACAAACAAAATAAAAACAAA","GGCTGGGTATGGTGGCTCACACCTGTAATCCCAACACTTTGGGAGGCTGAGGCAGGGAGATCACTTGAGCTCAGGAGTTCAAGACCAGCCTGACCCACATGGTGAAACCCATCTCTACTAAAAATACAAAAAAAAAAAAAAAATTAGTCAGGTGTGGTGGCACATGCCTGTAATCCCAGCTACTTGGGAGGCAGAGGCAGGAGAATCACTTGAACCTGGGAGGTGGAGGTTTGCAGTGAGCTGAGATCACACAATTGCACTCCAGCCTGGGCAACAAGAGCAAAACTCCAAAACAAAAGCAACAAAACAAAACAAACAAACAAACAAACAAACAAA"
"chrX","140813592","140813946","JH378106","31557967","31558303","68","109255625","GGCTGGGCACGGTGGCTCACACTTCTAATCCCAGCACTTTGGGAGGCCGAGGCAGGCAGATCACCTGAGGTCAGGTCAGGAGTTCGAGACCAGCCTGACCAATATGATGAAACCCCATCTCTACTAAAAATACAAAAATTAGCTGGGTGTGGTGGCAGGCACCTGTAACACCAGCTACTCGAGGGGCTGAGACAGGAGAATCACTTGAACCCGGGAGGCGGAGGTTGCCGTGAGCCGAGATTGCGCCATTGCACTCCAGCTTGGGCAACAAGAGCAAAACTCCATCACACACACACACACACACACACACACACACACACACAAAAGAAAGAAAAAGAAAGGAAAGAAAAGAAAA","GGCCGGGCGCGGTGGCTCAAGCCTGTAATCCCAGCACTTTGGGAGGCCGAGGCGGGTGGATCACAAGGTCAAGAGATCGAGACCAACCTGGTCAACATGGTGAAAGCCCGTCTCTACTAAAAATACAAAAATTAGCTGGGCATGGTGGCGCGTGCCTATAATCCCAGCTACTCAGGAGGCTGAGGCAGGAGAATTGCCTGAACCCAGGAGGTGGAGGTTGCAGTGAGCGAGATTGCGCCATTGCACTCCAGCCTGGGTAACAAGAGCGAAACTCCGTCTCACAAAACAAAACAAAACAAAACAAAACAAAACAAAACAAAAAACAAACAAAAAAAAA"
"chrX","146149674","146150247","JH378118","18053084","18053501","234","128096590","CGGGCGCCGTGGCTCACGTCTGTAATCCCAACCTTTTAGGAGGCCGAGGTGGGTGGATTACCTGAGGTCAGGAGTTTGAGACCAGCCTGGCCAACATGGCGAAACCCCATCTCTACTAAAAATACAAAAATTAGGCCGGGCGCGGTGGCTCACGCCTGTAATCCCAGCACTTTGAGAGGCCAAGGCAGGCAGATCACAAGGCCAGGAGTTCAAGACCAGCCTGGCCAACATGGTGAAACCCCGTCTCTACTAAAAATACAAAAATTAGCTAGGCGCGGTGGCTACTCGGGAGGCTGAGGCAGGAGAATAGCTTGAACTCAGGAGGCGGAAGTTGCAATGAGCCGAGATCGCACCACTGCACTCCAGCCTGGGCGACAGAGCAAGATTCTGTCTCAAAAAAAAAAAAAAAAAAATTAGCAGGGCGTGGTGGTGGGCCCCTGTAATCCCATCTACTCGGGAGGCTGAGGCTGGAGAATCGCTTGAACCCAGGAGGCAGAGGCTGCAGTGAGCCAAGATAGCGCCATTGAACTCCAGCTTAGACGACAGAAGCGAAACTCCGTCTCAAAGAAAGAAA","GGCTGGGCGCAGTGGCTCACACCTGTAATCCCAGCACTTAGGGAAGCTGAGGCGAGTAGATCACCTGAGGTCAGGAGTTAGAGACCAGCCTGGCCATCATGGTGAAACCCCGTCTCTACTAAAGATACCAAAAATTAGCTGAGTGTGGTGCTGGGTGCCTGTAATCCCAGAAACTCAGGGTGCCTGTAATCCCAGCAACTCAGGGTGCCTTTAATCCCAGCAACTGAGGGTACCAGTAATCCCAGCAACTCAGGGTGTCTTTAATCCTAGCAACTGAGGGCACCTGTAATCCCAGCAACTCAGGAAGCTGAGACAGGAGAAGTACTTGAACCCAGAAGGCAGAGGTTGCAGTGAGCCGATATTGCACCATTGCACTCCAGTCTGGGCAACAAGAGTGAAACTCTGTCTCAAAAAAAAA"
"chrX","147406838","147407188","JH378149","8949716","8950050","70","138457122","GGCCGGGTTCTGTGGCTCACATCTGTAATCCCAGCACTTTGGGAGGCTGAGGTGGGCGGATCATATGAAGTCAGGAGTTGGAGACCAGCCTGGCCAACATGTTGAAACCCTGTCTGTACTAAAAATCCAAAAAAAAAAAAAAAAATAGCCAGGCTTGGTGGCAGGCGCCTGTAATCCCAGCTACTCGGGAGGCTGAGGCAGGAGAATCGCTTGAACCTGAGAGGCGGGGGGTTGCAGTGAGCCGAGAACTCTCTATTGCACTCCAGCCTGGGTAACAAGAGTGAAACTCCATCTCAAAAAAAGAAAGGAAGGAAGGAAGGAAGGAAGGAAGGAAGGAAAAATGAAAAAGAA","GGCCGGGCGCAGTGGTTCAAGCCTGTAATCCCAGCACTTTGGGAGGCCGAGGTGGGTGGATCATGAGGTCAAGAGATCGAGACCATCCTGGTCAACATGGTGAAACCCTGTCTCTACTAAAAACACAAAAAATTAGCTGGGCATGGTGGCGTGTGCCTGTAATCCCAGCTACTCAGGAGGCTGAGGCAGGAGAATTGCCGGAACCCAGGAGGCAGAGGTTGCGGTGAGCCGAGATCGCGCCATTGCACTCCAGCCTGGGTAACAAGAGTGAAACTCCATCTCAAAAAAAAAAAAAAAAAAAAAAAAAAATGAAAAGAAAAGAAAAGAAAAAAAAA"
"chrX","149149643","149150264","JH378118","18053084","18053501","268","131096559","GGCCAGGGACAGTGGCTCATGCCTGTAATCCCAGAACTTTGGGAGGCCAAGGTGGGTGGATCACCTGAAGTCAGGAGTTCAAAACCAGCCAGGCCAACATGGTGAAACCCTGTCTCTAGTAAAAATAGAAAATTAGGGCTGGGCATGGTGGTTCATGCCTGTAATCCCAGCACTTTGGGAAGCTGAGGCAGGCGGATCATGAGGTCAGCAGTTTGAGACCAGCCTGGCCAACATGGTGAAATCCTGTCTCTACTAAAAATACAAAAAAAAAAAAAATAGCCAGGCATGGTGGCTAATGCCTGTAATCCCAGCTACTCAGGAGGCTGAGGCAGGAGAATCACTTGAACTCAGGAGGCGGAGGTTGCGGTGAGCAGAGATGGCACCATTGCACTCCAGCCTGGGCAACAGAGCAAGACTCTGTCTCAAAAAAAAAAAAAAAAAAAGTTAGCCCGGTGTGGTGGTGCATTCCTGTAATCCCAGCTACTTAGGAGGCTGAGGCAGGAGAATCTCTTGAACCCAGGAGGTGGAATTTGCAGTGAGCCAAGATCGCACCATTGCACTCCAGCCTGGGCAACAAGAGAGAAACTCCACCTCAAAAAAAAAAAAAAAAAGAAAGAAAGAA","GGCTGGGCGCAGTGGCTCACACCTGTAATCCCAGCACTTAGGGAAGCTGAGGCGAGTAGATCACCTGAGGTCAGGAGTTAGAGACCAGCCTGGCCATCATGGTGAAACCCCGTCTCTACTAAAGATACCAAAAATTAGCTGAGTGTGGTGCTGGGTGCCTGTAATCCCAGAAACTCAGGGTGCCTGTAATCCCAGCAACTCAGGGTGCCTTTAATCCCAGCAACTGAGGGTACCAGTAATCCCAGCAACTCAGGGTGTCTTTAATCCTAGCAACTGAGGGCACCTGTAATCCCAGCAACTCAGGAAGCTGAGACAGGAGAAGTACTTGAACCCAGAAGGCAGAGGTTGCAGTGAGCCGATATTGCACCATTGCACTCCAGTCTGGGCAACAAGAGTGAAACTCTGTCTCAAAAAAAAA"
"chrX","149191535","149192167","JH378118","18053084","18053501","286","131138451","GGCCGGGAGTGGTGGCTCATGCCTGTAATCCGAGCACTTTGGGAGGCTGAGGCAAGCAGATCACCTGAAGTCAGCAGTTCGAGACAAGCCTGGCCAACATGGTGAAACCCTGTCCTACTGAAAAATAAAAATAAAAGGGTTGGGCATGGTGGCCCACGCCTGTAATCCCAGCACTTTGGGAGGCCGAGGCGGGCGGATCACCTGAGGTCAGGAGTTCAAGACCAGACTGGACAATATGGCGAAACCCTGTCTGTACTAAAAATACAAAAATCAGCCAGGCGTGGTGGTGCACACCTGTAGTCCCAGCTACTCGGGAGGCTGAGGCAGGAGAATTGCTTGAACCTGGGAGGCGGAGGTTGCAGTGAGCCGAGATTGCGCCACTGCACTCTAGCCTGGGCAACAGAGAAAGACTCTGTCTCAAAAATAAATAAATAAATAAAATAAATTAAATTTAAAAAATTAAAAAATTAGCCAGGTGTGGTGGCAAGTGCCTATAATTCCAGCTACTTGGGAGGCTGAGGCAGGAGAATCACTTGAACCCAGGAGGCGAAGTTTGCAGTGGGTCAAGATCATGCCACTGCACTGCAGCCTGGGCGACAAGGGGGAAACTTCATCTCAAAAAAAAAAAAAAGA","GGCTGGGCGCAGTGGCTCACACCTGTAATCCCAGCACTTAGGGAAGCTGAGGCGAGTAGATCACCTGAGGTCAGGAGTTAGAGACCAGCCTGGCCATCATGGTGAAACCCCGTCTCTACTAAAGATACCAAAAATTAGCTGAGTGTGGTGCTGGGTGCCTGTAATCCCAGAAACTCAGGGTGCCTGTAATCCCAGCAACTCAGGGTGCCTTTAATCCCAGCAACTGAGGGTACCAGTAATCCCAGCAACTCAGGGTGTCTTTAATCCTAGCAACTGAGGGCACCTGTAATCCCAGCAACTCAGGAAGCTGAGACAGGAGAAGTACTTGAACCCAGAAGGCAGAGGTTGCAGTGAGCCGATATTGCACCATTGCACTCCAGTCTGGGCAACAAGAGTGAAACTCTGTCTCAAAAAAAAA"
"chrX","149212136","149212744","JH378118","18053084","18053501","262","131159052","GGCTGGGCATGGTGGCTCATGCCTGTAACCTCAGCACTTTGGGAGACTGAGGCGGGTGGATCACCTGAGGTCAGGAGTTCTGGACCAGCCTGGCCAACATGGCGAAACCCCGTCTCTACTAAAAATACAAAAATTGGGCCGGGCGCGGTGGCTCACGCCTGTCATTCCAGCACTTTGAAAGGCCGAGGCAGGCGGATCACTTGAGGTCAGGAGTTCGAGAACAGCCTGGCTGACATGGTGAAACCCCATCTCTATTAAAAATACAAAAAGTTAGCCGGGTGTGGTGGCGGGTGCCTGTAATCCCAACTACTGGGGAGACTGAGGCAGGAGAATCACTTGAACCCGGGAAGCACTCCAGCCTGGGCAACAGGAGCAAAACTCCATAAAAAAATAAAATAAAATAATAAATAAAATAAATAAATAAGTAAATAAATTAGCCGGGCTTGGTGGCGGGTGCCTGTAATCCCAGCTACTCAGGAGGCTGAAGCAGGAGAATCAGTGGAACCTGGGAGGTGAAGCTTGCAGTGAGCTGGGATCACGCCACTGCACTCCGTCCAGTCTGGGTGACAAGAGCGAAACTCCGTCTTAAAAAACCAAAAAACCAAAAAA","GGCTGGGCGCAGTGGCTCACACCTGTAATCCCAGCACTTAGGGAAGCTGAGGCGAGTAGATCACCTGAGGTCAGGAGTTAGAGACCAGCCTGGCCATCATGGTGAAACCCCGTCTCTACTAAAGATACCAAAAATTAGCTGAGTGTGGTGCTGGGTGCCTGTAATCCCAGAAACTCAGGGTGCCTGTAATCCCAGCAACTCAGGGTGCCTTTAATCCCAGCAACTGAGGGTACCAGTAATCCCAGCAACTCAGGGTGTCTTTAATCCTAGCAACTGAGGGCACCTGTAATCCCAGCAACTCAGGAAGCTGAGACAGGAGAAGTACTTGAACCCAGAAGGCAGAGGTTGCAGTGAGCCGATATTGCACCATTGCACTCCAGTCTGGGCAACAAGAGTGAAACTCTGTCTCAAAAAAAAA"
"chrX","149688849","149689456","JH378118","18053084","18053501","254","131635765","GCTGGGCGCAGTGGCTCACGTCTGTAATCTCAACACTTTGGGAGGCCAAGGCGGGTGGATCACCTGAGGTCAAGAGTTCGAGACCAGTCTGGCCAAGATGGTGAAACCCCGTCTCTACTAAAAAGACAAAAATTAGCCAGGCATGGCCGGCTGCGGTGGCTCACACCTGTAATCCCAGCACTTTGGGAGGCCGAGGCAGGCGGATCACGAGGTCAGGAGATCAAGACCATCCTGGCTAACATGGTGAAACCCCGTCTCTACTAAAAATACAAAAAAATTAGCCGGGCGTGGTGGCGGGCGCCTGTAGTCCCAGCTACTAGGGAGGCTGAGGCAGGAGAATGGCGTGTACCCGGGAGGTGGAGCTTGCAGTGAGCTGAGATCGCGCCACTGCACTCCAGTCTGAGCGACAGAGCAAGACTCTGTCTCAAAAAAAAAAATTAGCCAGGCACAGTGGTGCGCGCCTGTAATCCCAGCTACTCGGGAGGCTGAGGCAGGAGAATCGCTTGAACCCAGGAGGTGGATGTTGCAGTGAGCTGAGATCACGCCATTGCACTCCAGCCTGGGGGGCAAGAGCAAGAGTCCGTCTCAAAAATAAAAAAATAAAAAGA","GGCTGGGCGCAGTGGCTCACACCTGTAATCCCAGCACTTAGGGAAGCTGAGGCGAGTAGATCACCTGAGGTCAGGAGTTAGAGACCAGCCTGGCCATCATGGTGAAACCCCGTCTCTACTAAAGATACCAAAAATTAGCTGAGTGTGGTGCTGGGTGCCTGTAATCCCAGAAACTCAGGGTGCCTGTAATCCCAGCAACTCAGGGTGCCTTTAATCCCAGCAACTGAGGGTACCAGTAATCCCAGCAACTCAGGGTGTCTTTAATCCTAGCAACTGAGGGCACCTGTAATCCCAGCAACTCAGGAAGCTGAGACAGGAGAAGTACTTGAACCCAGAAGGCAGAGGTTGCAGTGAGCCGATATTGCACCATTGCACTCCAGTCTGGGCAACAAGAGTGAAACTCTGTCTCAAAAAAAAA"
"chr10","673658","674249","JH378118","18053084","18053501","241","17379426","GGCCGGGTGCAGTGGCTCACACCTGTAATCCCAGTACTTTTGGAGGCTGAGGCGGGTGGATCACCTGAGGTCAGGAGTTCGAGACTAGCCTGGCCAATATGGTGAAACCACATCTACTTAAAAAAATTAAAAATAGCCGGTCACAGTGGCTCACGCCTGTAATCCCAGCACTTTGGGAGGCCGAGGCGGGTGGATCACCTGAGGTTGGGAGTTTGAGACCAGCCTAACCAACATGGAGAAATCCTGTCTCTACTAAAAATACAAAATTAGTCAGGCATGGTGGTGCATGCCTGTAATCCTAGCTCAGGAGGCTGAGGCAGGAAAATTGCTTGAACCTGGGAAGCAGAGGTTGTGGTGAGCTGAGATCGTGCCATTGCACTCCAGCCTGAGTGACAAGATCGAAACTCCATCTCAATAAATAAATAAGCAAACAATAAAATAGCTGGGCATGGTCATGGGTGCCTATAATCCCAGCTACTCGGGAGGCTGAGGCAGGAGAATCACTTGAACCCAGGAGGCGGAGGTTGCAGTGAGCCGAGATCTCGCCATTGCATTCCAGCCTGGACAACAAGAGCAAAACTCTGTCATAAAA","GGCTGGGCGCAGTGGCTCACACCTGTAATCCCAGCACTTAGGGAAGCTGAGGCGAGTAGATCACCTGAGGTCAGGAGTTAGAGACCAGCCTGGCCATCATGGTGAAACCCCGTCTCTACTAAAGATACCAAAAATTAGCTGAGTGTGGTGCTGGGTGCCTGTAATCCCAGAAACTCAGGGTGCCTGTAATCCCAGCAACTCAGGGTGCCTTTAATCCCAGCAACTGAGGGTACCAGTAATCCCAGCAACTCAGGGTGTCTTTAATCCTAGCAACTGAGGGCACCTGTAATCCCAGCAACTCAGGAAGCTGAGACAGGAGAAGTACTTGAACCCAGAAGGCAGAGGTTGCAGTGAGCCGATATTGCACCATTGCACTCCAGTCTGGGCAACAAGAGTGAAACTCTGTCTCAAAAAAAAA"
"chr10","1429163","1429504","JH378228","5665092","5665424","52","4235929","GGCTGGGCATGGTGGCTCACGCTTGTAATCCCAGCACTTTGGGAGGCTGAGGCGGCTGGATCACCTAGGGTCAGGAGTTCGAGACCAACCTGGCCAACATGGTGAAACCCATCTTTACTAAAAATATAAAAAATTGGCCGGGCATGGTGGCAGGTGCCTGTAATCCCAGCTACTTTGGGAGGCTGAGGCTGGAGAATCACTTGAACCCAAGAGGCGGAGGTTGCAGTAAGCCAAGATTGCACCCTTGCACTCCAGCCTGGGCAACAAGAGTGAAACTCTGTCTCAAATAAATAAATAAATAAATAAATACATAATTTTTTAAAAAAGGAAAATAAAAGAAAA","GGCCGGGCGCGGTGGCTCAAGCCTGTAATCCCAGCACTTTGGGAGGCTGAGGCGGGTGGATCACGAGGTCAAGAGATCGAGACCATCCTGGTCAACATGGTGAAACCCTGTCTCTACTAAAAATACTAAAAATTAGCTGGGCATGGTGGCGTGTGCCTGTAATCCCAGCTACTCAGGAGGCTGAGGCAGGAGAATTGCCTGAACCCAGGAGGCGGAGGTTGCGGTGAGCCGAGATCGCGCCATTGCACTCCAGCCTGGGCAACAAGAGCGAAACTCTGTCTCAAAAAAAAAAAATAAATAAATAAAATAAAATAAAATAAAATAAAATAAAAT"
"chr10","16865029","16865349","JH378160","11464081","11464388","51","5400948","GACCTGGTGTGGTAGCTGACTCCTGTAATCCCAGCACTTTGGGAGGCCGAGGCAGGTGCATCACCTGAGGTCAGGAGTTTGAGACCAGCCTGGCCGACGTGGTGAAACCCCATCTCTACAATAAATAAATAAATAAATAAATAAATAATTAGCTGGGCATGGTGGCGCATGCCTGTAGTCCCAGCTACTTGGGAAGCTGAGGCAGGAGAATCGCTTGAACCTGGGAGGCAGAGGTTGCAGTGAGCCGAGATCAAGCCATTACAATCCAGCCTGGGTGACAAGAGTGAAACTCTATGTCAAAAAAGAAAAAAGAAAAGAAAA","GCCAGGCGCGGTGGCTCAAGCCTGTAATCCCAGCACTTTGGGAGGCCAAGGCAGGTGGATCACGTAAGGTCAGGAGTTCTAGACCATCCTGGTCAACATGGTGAAACCCCGTCTCTACTAAAAATACAAAAAAAAAAAATTAGCTGGGCATGGTGGCGCGTGCCTGTAATCCCAGCTACTCAGGAGGCTGAGGCAGGAGAATTGCCTGAACCCAGGAGGCAGAGGTTGCGGTGAGCCGAGATCGCACCATTGCACTCCAGCCTGGGTAACAAGAGTGAAACTCCGTCTCAAAAAAAAAAAAAAAAAAA"
"chr10","17934636","17934967","JH378120","14651551","14651882","49","3283085","CTGGGCACAGTGGCTCACCCTTGTATTCCCAGCACTTTGGGAGGCCGAGGTGGGTGGATCACCTGAGGTCAGGAGTTTGAGACCCGCTTGGCCAACATGGTGAAATCCCATCTCTACTAAAAATACAAAAAATTAGCTGGGCACGGTGGCAGGCTCCTGTAATCCCAGCTACTCGGGAGGCTGAGGCAGGAGAATGGCTTGAACCTGGGAGGTGGAGGTTGCAGTGAGCCGAGATCACACCATTGCACTCCAGCCTGGGCAACAAGAGTGAAACTCGTCTCAAAAATAAATAAATAAATAAATAAATAAATTTAAAAAAAAAGGAAAGAAAA","GGCCGGGCGCAGTGGCTCAAGCCTGTAATCCCAGCACTTTGGGAGGCCGAGGCGGGTGGATCACGAGGTCAAGAGATCGAGACCATCCTGGTCAACATGGTGAAACCCCGTCTCTACTAAAAATACAAAAAAATTAGCTGGGCATGGTGGCCTGTGCCTGTAATCTGAGCTACTCAGGAGGCTGAGGCAGGAGAATTGCCTGAACCCAGGAGGCGGAGGTTGCGGTGAGCCGAGATCGCGCCATTGCACTCCAGCCTGGGTAACAAGAGCGAAACTCCGTCTCAAAATAAATAAATAAATAAATAAATAAATAAATAAATAAATAAATAAAT"
"chr10","27900042","27900356","JH378123","552156","552469","54","27347886","GGCAGGGTGCAGTGGCTCATGCCTGTAATCCCAGCACTTTGGGAGGCCAAGGCAGGCTGATCACCTAAGATTAGGAGTTTGAGACCAGCCTGGCCAACATGGTGAAACCCCATCTTTACTAAAAATACAAAATTTAGCTGAGCATGGTGGTGGGTGCCTTTAATCCCAGCAATTTGGGAGGCTGAGGCAGGAGAATCGCTTGAACCCAGGAGGCGGAGTTTGCAGTGACCATTGCACTCCAGCCTGGGCAATAAGAGTGAAACTCCATCTCAAAAAATAAAATAAAATAAAATAAAATAAAAATTAAAAAAAGAA","GGCCAGGTGCAGTGGCTCATGCCTGTAATCCCATCACTTTGGGAGGCCAAGGCAGATTGATCACCTGAGGTCAGGAGTTGGAGACCATCCTGGCCAACATGGTGAAACCCTGTCTCTACTAAAAATACAAAAAAATTGGCTGGGCATGGTGGTGGGCGCCTGTAATTCCAGCTACTTGAAGGCTGAGGCAGGAGAATCTCTTGAACCTGGGAGGCAGAGGTTAGAGTGAGCTGAGATCGCACAGCCTGGGTGACAAGAGCAAAACTCCATCTCAAAAATAAATAAATAAATAAATAAATAAATAAATAAAAAAA"
"chr10","29575862","29576185","JH378109","3329188","3329514","52","26246674","GGCCAGGCATGGTGGCTCATGCCCATAATCCCACCACTTTGGGAGACCAAGGCAGGTGGATCACCTGAGGTCAGGAGTTCGAGACCAGCCTGGCCAACATGGTGAAACCCCGTCTCTACTACTTAAAAAAAAAAAAAAAAAAAAAAAAAAAAAAAAAAATTAGCTGGGAGTAGTGGTGGGTGCCTGTAATTCCAGTTACTGGGGAGGCTGAGACAGGAGAATCGTTTGAACCCGGGAGGCAGAGGTTGCAGTTAGCCAAGATCGCACCACTGCACTCCAGCTTGGGTAACAAGAGTGAAACTCTGTTTCAAAAACAAACAAAAA","GGCCAGGCATGGTGGCTCACGCCTGTAATCCCAGCACTTTGGGAGCCCAAGCCGGGTGGATTACCTAAGGTCAGGAATTCCAGAACAGCCTGGACAATATGGTGAAACCTTGTCTCTACTAAAAATACAAAAAAAAAAAAAAAAAAAAAAAAAAAAAAAATTTAGCCGGGTGTGGTGGTAGGTACCTGTAATCCCAGCTACTAGGGAGGCTGAGGCAGGAGAATCGCTTGAACTTGGGAGGCGGAGGTTGCAGTGAACAGAGATCACACCACTGCACTCCAGCCTGGGCGACAAGAGCAAAACTCCATCTCAAAGAAAAAAAAAGAA"
"chr10","30347336","30347955","JH378118","18053084","18053501","262","12294252","GGCTGGGCACGGTGGCTCACGCCTCTAGTCCCAGCACTTTGGGAGGTGGACACGGGCGGATCACCTGAGGTCAGGAGTTCGAGACCAGCCTGGCCAACATGGCAAAACCCTGTCTCTACTAAAAATACAAAAATTAGGCCAGGTGAAGTGGCTCACCCCTGTAATCCCAGCACTTTGGGAGGTGGACACGGGTGGATCACCTGAGGTCAGCAGTTCAAGACCAGCCTGACAACAAGGAGAAACCCTGTCTCTACTAAAAAAAAAAAAATACAAAAAAAAATTTACCCGGGTGTGGTGGCGCATGCCTGTAATCCCAGCTACTCAGGAGGCTGAGGCAGGAGAATCACTCGAACCCAGGAGGCAGAGGTTGCGGTGAGCTGAGATCGAGCCATTGCACTCCAGTCTGGGCAACAAGAGTGAAACTCCATCTTGGAAAAAAAAAAAAAAAGGCAGGTGTGGTGGCGGGCGCCTGTAATCCCTGCTACTTGGGAGGCTGAGGCAGGAGAATTGTTTGAACCTGGGAGGTGGAGGTTGCAGTGAGCTGAGATCACACCATTGCACTCCAGCCTGGGCAACAAGAGCAAAACTCTGTCTCAAAAAATAAATAAATAATAAATAAA","GGCTGGGCGCAGTGGCTCACACCTGTAATCCCAGCACTTAGGGAAGCTGAGGCGAGTAGATCACCTGAGGTCAGGAGTTAGAGACCAGCCTGGCCATCATGGTGAAACCCCGTCTCTACTAAAGATACCAAAAATTAGCTGAGTGTGGTGCTGGGTGCCTGTAATCCCAGAAACTCAGGGTGCCTGTAATCCCAGCAACTCAGGGTGCCTTTAATCCCAGCAACTGAGGGTACCAGTAATCCCAGCAACTCAGGGTGTCTTTAATCCTAGCAACTGAGGGCACCTGTAATCCCAGCAACTCAGGAAGCTGAGACAGGAGAAGTACTTGAACCCAGAAGGCAGAGGTTGCAGTGAGCCGATATTGCACCATTGCACTCCAGTCTGGGCAACAAGAGTGAAACTCTGTCTCAAAAAAAAA"
"chr10","31340636","31340948","JH378192","5372003","5372306","62","25968633","GGTCGGGCATGATGGCTCACGTGTGTAATCCCAGCACTTTGAAAGCCGAGGCAGGCAGATCACTTGAAGTCAGGAGCTTGAGATCAGCCTGGCCAACATGGTGAAAACCCGTCACTACTAAAAACAAAACAAAACAAAACAAACAAACAAAAAAAAATTAGCCGGGCATGATGGAGGGGTGGGCACCTGTAATCCCAGCTATTCAGGAGGCTAAGGCAGAAGAATCGCTTGAACCCAGGAGGCGGAGGTTGTAGTGGGCCAAGATCGTGCCATTGCACTCCAGCCTGGGCCACAAGAGCAGGACTCTGTCTCA","GCCGGGCATGGTGGCTCACACCTGTAATCCCAGCACTTTGGGAAGCTGAGGCAGGTGGATCACCTGAGGTCAGGAGTTCAAGACCAACCTGGCCAACATAGTGAAACCCGGTCTCTACTAAAAATACAAAAAAAAAAAAAAAAAAAAAATTAGCTGGGTGTGGTGGCAGGCGCCTGTAATCCCAGCTACTAGGAGGCTGAGGCAGGAGAATTGCTAGAACCCAGGAGGTGGAGGTTGTAGTGAGCCAAGATTGCACCATTGCACTCCAGCCTGGGCAACAAGAGTGACACTCTGTCTCAAAAAA"
"chr10","33535461","33535835","JH378144","13229286","13229620","80","20306175","GGCCAGGTGCGGTGGCTCACGCCTGTAATCCCAGCACTTTGGGAAGCTGAGGTAGGCAGATCACCTGAGGGCAGGAGCTTAAGACCAGCCTGGCCAACGTGGTGAAACCCCATCTCTACTAAAAATACAAAAAATTAGCTGGCTGGGCATGTGACAGGCCCCTGTAATCCCAGCTGCTTAGGAGGCTGAGGCAGGAGAATCGCTTGAACTCAGGAGGCCGAGTTTGCAGTGAGCAGAGATTGCGCCATTGCACTCCAGACTGGGCAACAAGGACAACAAGAGAGAAACTCTGTCTCAAAAAATAGAATAGAATAGAATAGAATAGAATAGAATAGAATAAAATAAAATAAAATAAAATAATAAAATAAATAAAAA","GGCCGGGCGCGGTGGCTCAAGCCTGTAATCCCAGCACTTTGGGAGGCCGAGGCGGGTGGATCACCTGTGGTCAGGAGTTCAAGACAGCTTGGTCAACATGGTGAAACCCCGTCTCTACCAAAAATACAAAAAATTAGCTGGGCATGGTAGCGCATGCCTGTAATCCCAGCTACTCAGGAGGCTGAGGCAGGAGAATTGCCTGAACCCAGGAGGCAGAGGTTGCGGTGAGCCGAGATCGCGCCATTGCACTCCAGCCTGGGTAACAAGAGCGAAACTCCCTCTCATAAAAAATAAATAAATAAATAAATAAATAAATAAATAAATAAATAAATAAA"
"chr10","35264147","35264761","JH378118","18053084","18053501","277","17211063","GCCAGGCACGATGGCTGATGCCTGTAACCCCAGCACTTTGGGAGGTGGGTAAATCACCTAAGTTAAGGAGTTCGAGACCAGCCTGGTCAACATGGTGAAACTATGTCTCTACTAAAAACACAAAAAATTAGCCAGGCGCAGTGGCTCATGCCTGTAATCCCAGCACTTTGGAACGCCAAAGCGGGTGGATCATCTGAGGTCAGCATTTCGAGACCAGCCTGGCCAACACGGTGAAACCCCATCTCTACTAAAAATACAAAAATTAGCCAGGCATGGTGGCACACACCCATAATCCCAGCTACTCGAGAGGCTGAGGCAGGAGAATCGCTTGAGCCCAGGAGGCAGAGGTTGCACTGAGCCAAGATCGTGCCACTGTACTCCAGCCTGGGTGACAGAGTGAGACCCTGTCTCAAAACACACACACACACACACACACACACACACACACACAAAATTAGCCGGGCGTGGTGGCAAGCACCTGTAGTCCCAGCTACTCGGGAGGCTGACGCTGAGGAGAATCACTTGAACCTAGGAGGTGGAGGCTACAGTGAGCCGAGAATGCGCCACTGCACTCCAGCCTGGGTGGCAAGAGTGAACTCCATCTCCAAAAAAAAA","GGCTGGGCGCAGTGGCTCACACCTGTAATCCCAGCACTTAGGGAAGCTGAGGCGAGTAGATCACCTGAGGTCAGGAGTTAGAGACCAGCCTGGCCATCATGGTGAAACCCCGTCTCTACTAAAGATACCAAAAATTAGCTGAGTGTGGTGCTGGGTGCCTGTAATCCCAGAAACTCAGGGTGCCTGTAATCCCAGCAACTCAGGGTGCCTTTAATCCCAGCAACTGAGGGTACCAGTAATCCCAGCAACTCAGGGTGTCTTTAATCCTAGCAACTGAGGGCACCTGTAATCCCAGCAACTCAGGAAGCTGAGACAGGAGAAGTACTTGAACCCAGAAGGCAGAGGTTGCAGTGAGCCGATATTGCACCATTGCACTCCAGTCTGGGCAACAAGAGTGAAACTCTGTCTCAAAAAAAAA"
"chr10","37689597","37690219","JH378118","18053084","18053501","265","19636513","GGCTGAGCACGGTGGCTCAGGCCTGTAATCTCAGCACTTTGGGAGGCTGAGACAGGTGGATCGCTTTAGGTCAGGAGTTCAAGACCAGCCTGGCCAACATGGTGAAACCCCATCTCTACTAAAAGTAGAAAAATTAGGTGGCCGGGCATGGTGGCTCACATCTGTAATCCCAACACTTTGGGAGGCCAAGGTAGGTGAATCACGAGGTCAGGATTTCAAGATCTACCTGGCCAACACAGTGAAACCCTGTCTCTATTTAAAAATACAAAAAATTAGCCAGGCGTGGTGGCAGGTGCCTGTAATCCCAGCTACTCTGGAGGCTGAGGCAGGAGAATTGCTTGAACCTGGGAGGCGGAGGTTGCAGTGAGCCGAGGTCGCATCATTGAACTCCAGCCCAGGTGACAGTGCCAGACTCTGTCTCAAAAAAAAAAAAAAAAAAAAAATTAGCTGGGAGTGGTGGTGGATGCCTGTAATCCCAGCTACTCAGGAGGCTGAGTCAGGAGAATTGCTTGAACCCAGGAGGTGGAGGTTGCAGTGAGCCAAGATTGCACCATCGCACTCCAGCCTGGGGGACAAGAGCAAAACTCCATCTCAAAAAATAAATAAATAAAATAAAAAATAAA","GGCTGGGCGCAGTGGCTCACACCTGTAATCCCAGCACTTAGGGAAGCTGAGGCGAGTAGATCACCTGAGGTCAGGAGTTAGAGACCAGCCTGGCCATCATGGTGAAACCCCGTCTCTACTAAAGATACCAAAAATTAGCTGAGTGTGGTGCTGGGTGCCTGTAATCCCAGAAACTCAGGGTGCCTGTAATCCCAGCAACTCAGGGTGCCTTTAATCCCAGCAACTGAGGGTACCAGTAATCCCAGCAACTCAGGGTGTCTTTAATCCTAGCAACTGAGGGCACCTGTAATCCCAGCAACTCAGGAAGCTGAGACAGGAGAAGTACTTGAACCCAGAAGGCAGAGGTTGCAGTGAGCCGATATTGCACCATTGCACTCCAGTCTGGGCAACAAGAGTGAAACTCTGTCTCAAAAAAAAA"
"chr10","47884196","47884804","JH378114","15957391","15957789","274","31926805","GGCCAGGTGTAGTGGCTTATACCTGTAATCCCAGAACTTTGGGAGGCCCAGGTAGGAGGATTGCTTGAGGCCAGAAATTTGAGAGCAGCCTGGGCAACATGGTGAGAACTCCATCTCTACAAAATAAAAAAATTAGCCACTACTAAAAATACAAAATTAGGCAAGGCGCGGTGGCTCACACCTGTAATCCCAGCACGCTGGGAGGCCGAGGCGGGTGGATCACAAGGTCAGGAGATCAAGATCATCCTGGCTAACATGGTGAAACCCTGTCTCTACTAAAAATACAAAAAAAGTTAGTCAGGTGTGGTCGTGGGCGCCTGTAGTCCCAGCTATTCGGGAGGCTGAAGTAGGAGAATGGTGTGAACCCGGGAGGCAGAGCTTGCAGTAAGCCGAGATCACGCCACTGCACTCCAGCCTGGGTGACGGAGCAAGACTTTGTCTCAAAAAAAAAAAAAAAAAATCAGCCAGGTCTGGTGGTGCATACCTGTAATCCCAGCTACTTGGGAGGCAGGAGCACCACCTGAACCTGGGAGGTGGAGGTTGCAATGAGCTGAGATCATGCCATTGCACTCCAGCCTGGGCAACAAGAGCAAAACTCCATTTCAAAAA","GCAAGGAACGGTGGCTCATGCCTGTCATCCCAGCACTTTGGGAGGCTAAGGAGGGTGGATTACCGAAGGTCATGAGTTTGAGACCAGCCTGACCAACATGGTGAAAACCCCATCTCTACTAAAAATACAAAAAATTAGCCAGATACAGCTATGCGGCAGACTGGGGCAGGAGAATCGCTTGGACCCAAACCCCATCTCTACTAAAAATACAAAAAATTAGCCGGATACAGCTATGCGGGAGACTGGGGCAGGAGAATCGCTTGGACCCGGGAGGCAGAGATTGCAGTGAGATGAGACCATGCCATTGCTCTCTAGCTTGTGCGATGAGAACAAGACTCTGTCTCAAAAAAAAAAAAAAAAAAAAAAAAAAAAAAAAAAAAAAAAGAGAGAGAGAGAAAA"
"chr10","57394099","57394723","JH378118","18053084","18053501","274","39341015","GCCGGGAGTGGTGGCTTACGCCTGTAATCCCAGCACTTTGGGAGGCCAAGGTGGGTGGATCACCTGACATCAGGAGTTCAAGACCAGCCTGGCCAACATGGTGAAACCCTGTCTCTACTAAAAACACAAAAATTACGGCCGGACGCGGTGGCTCATGCCTGTAATCCCAGCACTTTGGGAGGCCGAGGCAAGCAGATCTCGAGGTCAGGAGTTCCAGACCAGCCTGGCCAACATGGCGAAACCCCATCTCTACTAAAAATATAAAAATTAGCCAGTGTGGTGGCATGCACCTGTAATCCCAGCTACTCGGGAGGCCAAGGCAGGAGAATTGCTTAAACCTGGGAGACGGAGGTTGCAGTGAGCCGAGTTTGCACCACTGTACTCCAGCCTGGGCAACATAGCAAGACTCCATCTCAAAAAATTAAAAATAAATTTAAAAAATACAAAAATTAGCTGGGCGTGGTGGCAGCCGCCTGTAATCTCAGCTACTTGGGAGGCTGAGGCAGGAGAATTGCTTGAACCTGGGTTGGGGTGGGGTGGGGCGGAGGCTGCAGTGAGCTGAGATCTCGCCATTGCACTCCAGCCTGGGTGACAAGAGCAAAACTCTGTCTCAAAAAAAAAAAAA","GGCTGGGCGCAGTGGCTCACACCTGTAATCCCAGCACTTAGGGAAGCTGAGGCGAGTAGATCACCTGAGGTCAGGAGTTAGAGACCAGCCTGGCCATCATGGTGAAACCCCGTCTCTACTAAAGATACCAAAAATTAGCTGAGTGTGGTGCTGGGTGCCTGTAATCCCAGAAACTCAGGGTGCCTGTAATCCCAGCAACTCAGGGTGCCTTTAATCCCAGCAACTGAGGGTACCAGTAATCCCAGCAACTCAGGGTGTCTTTAATCCTAGCAACTGAGGGCACCTGTAATCCCAGCAACTCAGGAAGCTGAGACAGGAGAAGTACTTGAACCCAGAAGGCAGAGGTTGCAGTGAGCCGATATTGCACCATTGCACTCCAGTCTGGGCAACAAGAGTGAAACTCTGTCTCAAAAAAAAA"
"chr10","60145554","60146164","JH378118","18053084","18053501","248","42092470","GGCCAGGCGTGGTGGCTCATGCCTGTAATCCCAGAACTTCGGGAGTCCGAGGCGGGCGGATCACCTGAGGTCAGGAGTTTGAGACCAGCCTGACCAATATGATGAAATCCCGTCTCTACTAAAAATACAAAAATTAAGCCAGGCATGGTGGCTGACACCTATAATCCCAGCACTTTGGGAGGCCGAGGCAGGTGGATCACCTGAGGTCAGGAGTTCAAGACCGGCCTGGCCAATGTGGTGAAACCCGGTCTCTGTTAAAAATACAAAAATTAGCTGGGCGTGGTGGCAGGCACCTGTAATCCCAGCTACTCGGGAGGCTGAGATAGAATTGTTTGAACCCAGGAGACGGAGGTTGCAGTGAGCCGAGATCATGCCACTGCACTCCAGCCTGGGCAACAGAGCGAGACTCTGTTTCAAAAAATATATACAAAAATACAAAAATTAGCTGGGCGTGGTGGCATGCGCCTGTAATCCCAGCTACTCGGGAGGCTGAGACAGGATAATCGCTTGAACCCGGGAGGCGGAGGTCGCAGTGAGCGGAGATCGCACCATTGCACTCCAGCCTGGGCGACAAGAGTGAAACTCTGTCTCAAAACAAACAAACAAGAAAA","GGCTGGGCGCAGTGGCTCACACCTGTAATCCCAGCACTTAGGGAAGCTGAGGCGAGTAGATCACCTGAGGTCAGGAGTTAGAGACCAGCCTGGCCATCATGGTGAAACCCCGTCTCTACTAAAGATACCAAAAATTAGCTGAGTGTGGTGCTGGGTGCCTGTAATCCCAGAAACTCAGGGTGCCTGTAATCCCAGCAACTCAGGGTGCCTTTAATCCCAGCAACTGAGGGTACCAGTAATCCCAGCAACTCAGGGTGTCTTTAATCCTAGCAACTGAGGGCACCTGTAATCCCAGCAACTCAGGAAGCTGAGACAGGAGAAGTACTTGAACCCAGAAGGCAGAGGTTGCAGTGAGCCGATATTGCACCATTGCACTCCAGTCTGGGCAACAAGAGTGAAACTCTGTCTCAAAAAAAAA"
"chr10","60525667","60526289","JH378118","18053084","18053501","262","42472583","GGCCGAGCATGGTGGCTCACGCCTGTAATCCCTGCACTTTGGGAGGCTGAAGTGGGTGGATCACCTGAGGTCAAGAGTTCGACAGCAGCCTGGCCAACATCATGAAACCTCGTCTCTACTAAAAATACAAAAAAATTGGGCAGGCACAGTGGCTCACGCCTGTAATCCCAGCACTTTGGGAGGCCAAGGTGGGTGGATCACGAGGTCAGGAGTTCGAGACCAGCCTGGCCAACATAGTGAAACCCTGTCTCTACTTAAAATACAAAAATTAGCCAAGCATGGTGGCATGACCCTGTAGTCCTAGCTACTCGGGAGGTTGAGGCAGCAGAATCGCATCGCTTGAACCTGGGAGGCAGAGGTTGTGGTGAGCCAAAATTGCGTCACTGCACTCCAGTCTGGGCAACAGAGCGAGAGACTTTGTCTCAAAAAAAAAAAAAAAGGAAACATCCAAAAAATTAGCTGGGCGTAGTGGCACGCACCTGCTGTAATCCCAGCTACTCAGGAGGCTGAGGCAGGAGAATCACTTGAACCCAGGAGGTGGAGGTTGCAGTGAGCCGAGATTGTGTGCGCCACTGCACTCCACCCTGGGTAACAAGAGCAAAACTCGGTCTCAAAAAAAAAAA","GGCTGGGCGCAGTGGCTCACACCTGTAATCCCAGCACTTAGGGAAGCTGAGGCGAGTAGATCACCTGAGGTCAGGAGTTAGAGACCAGCCTGGCCATCATGGTGAAACCCCGTCTCTACTAAAGATACCAAAAATTAGCTGAGTGTGGTGCTGGGTGCCTGTAATCCCAGAAACTCAGGGTGCCTGTAATCCCAGCAACTCAGGGTGCCTTTAATCCCAGCAACTGAGGGTACCAGTAATCCCAGCAACTCAGGGTGTCTTTAATCCTAGCAACTGAGGGCACCTGTAATCCCAGCAACTCAGGAAGCTGAGACAGGAGAAGTACTTGAACCCAGAAGGCAGAGGTTGCAGTGAGCCGATATTGCACCATTGCACTCCAGTCTGGGCAACAAGAGTGAAACTCTGTCTCAAAAAAAAA"
"chr10","60530619","60531226","JH378118","18053084","18053501","244","42477535","GGCTGGGTGCAGTGGTTCACGCCTGTAATCCCAACACTTTGGGAGGCCGAGGTGGGCGGATCACCTGAGATCAGGAATTTGAGACCAGCCTAGCCAACATGGTGAAACCCTGTCTCTACTAAAAAATACAAAAATTGGCCAGGCGCGGTGGCTCATGCCTGTAATCCCAGCACTTTGGGAGGCCGAGGCGGGAGGATCACGGGGTCAGGAGTTCAAGACCAGCCTGGCCAACATGGTGAAACCCCGTCTCTACTAAAAATACAAAAATTAGCCAGGTGTGGTGGCACGCGCCTGTAATCCCAGCTACTCAGGAGGCTGAAGTAGGAGAATAGCTTGAACCTAGGAGGCAGAGGTTGCAGTGAGCCGAGATCCTGCCACTGCACTCCAGCCTGGGACAACGCGAGACTCTGTTGCAAAAGAAAAAAACCCAAAAACTACCCGAGCGTGGTGGCGGGTACCTGTAATCCCAACTACTCAGGAGGCTGAGGCAGGAGAATCGCTTGAACCCAGGAGGTAGAGGTTGCAGTGAGCCGAGATCGCGCCATTGCACTCCAGCCTGGGCAACAAGAGTGAAATTCCATTTCGAAAAAAAAGTGAAAAATAAAAAA","GGCTGGGCGCAGTGGCTCACACCTGTAATCCCAGCACTTAGGGAAGCTGAGGCGAGTAGATCACCTGAGGTCAGGAGTTAGAGACCAGCCTGGCCATCATGGTGAAACCCCGTCTCTACTAAAGATACCAAAAATTAGCTGAGTGTGGTGCTGGGTGCCTGTAATCCCAGAAACTCAGGGTGCCTGTAATCCCAGCAACTCAGGGTGCCTTTAATCCCAGCAACTGAGGGTACCAGTAATCCCAGCAACTCAGGGTGTCTTTAATCCTAGCAACTGAGGGCACCTGTAATCCCAGCAACTCAGGAAGCTGAGACAGGAGAAGTACTTGAACCCAGAAGGCAGAGGTTGCAGTGAGCCGATATTGCACCATTGCACTCCAGTCTGGGCAACAAGAGTGAAACTCTGTCTCAAAAAAAAA"
"chr10","61242643","61242805","JH378108","5444588","5444745","31","55798055","CTGTTTGGGAGGCTGAGGCAGGAGAATCGCTTGAACCTGGGAGGCGGAAGTTGCAGTGAGCTGAGATTGTGCCATTGCACTCCATCCTGGGCAACGAGAGCGAAACTCCATCTCAAAAAATAAAATAAAATAAAATAAAATAAACAAAAAAACAAAAACAAAA","CCAACTACTTGGGAGGCTGAGACAGGAGAATTGCTTGAACCCAGGAGGCAGAGGTTGCAGTGAGCCGAGAATGCGCCATTGCACTCCAGCCTGGGCAACAAGAGCGAAACTCCGTCTCAAAATAAATAAATAAATAAATAAATAAATAAATAAATAAA"
"chr10","62939207","62939822","JH378114","15957391","15957789","281","46981816","GGTGTGGTGGCTCACGCCTGTAACCCCACCATTTTGGGAGGCCAAGAAGGGAGGACTACTTTAGTCAGGAGTTTGAGGCCAGCCTAGAAAACATAGTGAGACCTCTCTCTAAAAAAATAAAAACAAATTAAAAAAAATGTAATTAAGAGAACAAAATTCTAAACAGGATTCTTACACTTTGTATAAAAAGAAGCTTGAGGCTGGGTGCGGTGGCTCATGCCTGTAATCCCAGCACTTTGGGAGGCTGAGCAGGTGGATCACCTGAGGTCAGGAGTTCAAGACCAGCCTGGTCAACAGGGTGAAACCCTGTCTCTACTAAAAATACCAAAAAAAATTAGCTGGGTGTGGTGGTGGGCGCCTGTAATCCCAGTTACTCGGGAGGCTGAAGCAGGAGAATTGCTTGAACCCAGGAGGCGGAGGTTGCAGTGAGCCGAGATCATGCCATTGCACTCCAGCCTGGGCAACAAGAGCTTGACCTCAGGAGGCAGAGGGTGCAGTGAACCAAGATCGTGCTGTTGCTGTTGCACTCCAGCCTGGGCAACAAGAGTGAGCCTCAAAAAAACAAAACAAAACAAAACAAAACAAAACAAAAACAAAAACAAAATAGAAAAAGAAA","GCAAGGAACGGTGGCTCATGCCTGTCATCCCAGCACTTTGGGAGGCTAAGGAGGGTGGATTACCGAAGGTCATGAGTTTGAGACCAGCCTGACCAACATGGTGAAAACCCCATCTCTACTAAAAATACAAAAAATTAGCCAGATACAGCTATGCGGCAGACTGGGGCAGGAGAATCGCTTGGACCCAAACCCCATCTCTACTAAAAATACAAAAAATTAGCCGGATACAGCTATGCGGGAGACTGGGGCAGGAGAATCGCTTGGACCCGGGAGGCAGAGATTGCAGTGAGATGAGACCATGCCATTGCTCTCTAGCTTGTGCGATGAGAACAAGACTCTGTCTCAAAAAAAAAAAAAAAAAAAAAAAAAAAAAAAAAAAAAAAAGAGAGAGAGAGAAAA"
"chr10","66289888","66290482","JH378118","18053084","18053501","255","48236804","GGCCGGGCACAGTGGCTCATGCTTGTAATCCCAACACTTTGAGAGGCCAAGGTGGGTGGATCACCTGAGGTCAGGAGTTCGAGACCAGCCTGGCCAAGATGATGAAACCCTGTCTCTACTAATAATACAAAAAATTAGGCCAGGTGTGGTGGCTCACGCCTGTAATCCCAGCATTTTGGGAGGTCAAGGCAGGCGGATCACTAGGTCAGGAGATCGAGACCATCCTGGCTAATAAGGTGAAACCCCGTCTCTACTAAAAATACAAAAAAATTAGCCGGGCGTGGTGGCGGGTGCCTGTAGTCCCAGCTACTCGGGAGGCTGAGGCGGGAGAATGGCGTGAACCCAGGAATTGGAGCTTGCAGTGAGCCGAGATTGCGCCACTGCACTCCAGCCTGAGCGACAGAGTGAGACTCCGTCTCAAAAAAAAAAAAAAAAAAAAAAAAAATTAGCTGGGCATGGTGGCAGGCGCCTGAAATCCCAGCTGCTCCAGAGGCTGAAGCAGGAGAATCGCTTGAACCCAGGAGGCAGAGGTTGCAGTGAGCTAAGATTGCGCCATTGCACTCCAGCCTGGGCAAGAAAAGTGAAACTCTGTCTC","GGCTGGGCGCAGTGGCTCACACCTGTAATCCCAGCACTTAGGGAAGCTGAGGCGAGTAGATCACCTGAGGTCAGGAGTTAGAGACCAGCCTGGCCATCATGGTGAAACCCCGTCTCTACTAAAGATACCAAAAATTAGCTGAGTGTGGTGCTGGGTGCCTGTAATCCCAGAAACTCAGGGTGCCTGTAATCCCAGCAACTCAGGGTGCCTTTAATCCCAGCAACTGAGGGTACCAGTAATCCCAGCAACTCAGGGTGTCTTTAATCCTAGCAACTGAGGGCACCTGTAATCCCAGCAACTCAGGAAGCTGAGACAGGAGAAGTACTTGAACCCAGAAGGCAGAGGTTGCAGTGAGCCGATATTGCACCATTGCACTCCAGTCTGGGCAACAAGAGTGAAACTCTGTCTCAAAAAAAAA"
"chr10","67714906","67715413","JH378118","18053084","18053501","170","49661822","GGCCAGGTGAAGTGGCTTACGCCTGTAATCCCAGAACTTTAGGAGGCCAAAGTGGGTGGATCACCTGAGGTCAGGAGTTTGAGACCAGCCTGGCCAACATGATGAAACCCCATCTCTACTAAAAATTCAAAAAATTGGCTAGGCACAATGGCTCATGCCTGTAATACCAGCACTTTGGCACGCAAAGGTGGGTGAATCACAAGGTCAGGAGTTCGAGACCAGCCTGGCCAATATGGTGAAACCCCATCTCTACTAAAAATACAAAATTAGCCAGGCGTGGTGGCGGGCACCTGTAATCCCAGCTACTCAGGAGGCTGAGGCAGAACTGTTTGAACCCGGGAAGCAGAGGCTGCAGTGAGCCGAGATCCCATAATCAAGGCTACTCAAGAAGCTGAGGCAGGAGATCACTTGAACCTGGGAGACGGAGGTTGCAAGTGAGCTGAAATCACACCATCGCACTCCAGCCTGAGCAACAAGAGTGAAACTTCATCTCCAAAAAAAAACAAAA","GGCTGGGCGCAGTGGCTCACACCTGTAATCCCAGCACTTAGGGAAGCTGAGGCGAGTAGATCACCTGAGGTCAGGAGTTAGAGACCAGCCTGGCCATCATGGTGAAACCCCGTCTCTACTAAAGATACCAAAAATTAGCTGAGTGTGGTGCTGGGTGCCTGTAATCCCAGAAACTCAGGGTGCCTGTAATCCCAGCAACTCAGGGTGCCTTTAATCCCAGCAACTGAGGGTACCAGTAATCCCAGCAACTCAGGGTGTCTTTAATCCTAGCAACTGAGGGCACCTGTAATCCCAGCAACTCAGGAAGCTGAGACAGGAGAAGTACTTGAACCCAGAAGGCAGAGGTTGCAGTGAGCCGATATTGCACCATTGCACTCCAGTCTGGGCAACAAGAGTGAAACTCTGTCTCAAAAAAAAA"
"chr10","72467676","72468308","JH378118","18053084","18053501","286","54414592","GGCCAGGCGCAGTGGCTCACGGCTGTAATCCCAGCACTTTGGGAGGCTGAGGAAGGCGGATCATCTGAGGTCAGGAGTTCAAGACCAGCCTGGCCAACATGGTGAAACCCCATCTCTACTAGAAATACAAAAATTAGCTGGGCGCAGTGGCTCACGCCTGTAATCCCAGGACTTTGGGAGGCCGAGGCGGGCAGATCATGAGGTCAGGAGAGCGAGACCACCCTGGCTAACAGGATGAAACCCCGTCTCAACTAAAAATATGAAAAAAAAAAAAAAAATTAGCCAGACAGACATGGTGGCGGGCACCTGTAGTCCCAGCTACTCGGGAGGCTGAGGCAGGACAATGGCATGAACCTGGCAGGGGGAGCTTGCAGTGAGCCGAGATCGCTCCATTGCACTCCAGTCTGGGCGACACAGCAAGACCCCATCTCAAAAAAAACAAACAACAACAATAACAACAACAACAAAAAATTAGCCGGGCGTGATGGCGGGCGCCTGTAATCCCAGCTACTCAGGAGGCTGAGGCAGAACTGCTTGAACCCGGGAGGCAGAGGTTGCAACAAGGCAAGATCATGCCATTGCTCTCCAGCCTGGGTGAAAACGGCGAAACTCCATCTCAAAAAAAAAAAAAAA","GGCTGGGCGCAGTGGCTCACACCTGTAATCCCAGCACTTAGGGAAGCTGAGGCGAGTAGATCACCTGAGGTCAGGAGTTAGAGACCAGCCTGGCCATCATGGTGAAACCCCGTCTCTACTAAAGATACCAAAAATTAGCTGAGTGTGGTGCTGGGTGCCTGTAATCCCAGAAACTCAGGGTGCCTGTAATCCCAGCAACTCAGGGTGCCTTTAATCCCAGCAACTGAGGGTACCAGTAATCCCAGCAACTCAGGGTGTCTTTAATCCTAGCAACTGAGGGCACCTGTAATCCCAGCAACTCAGGAAGCTGAGACAGGAGAAGTACTTGAACCCAGAAGGCAGAGGTTGCAGTGAGCCGATATTGCACCATTGCACTCCAGTCTGGGCAACAAGAGTGAAACTCTGTCTCAAAAAAAAA"
"chr10","75665887","75666501","JH378118","18053084","18053501","266","57612803","GGCCAGGCGTGGTGACTCACACCTGTAATCCCAGCACTTTTGGAGGCCAAGGTAGGTGGATCACCTGAGGTCAGGAGTTCGAGATCAGCCTGGCCAACATGGTGAAACCCTGTCTCTACTAAAAATACAAAACTTGGCTGGGCATGGTGGCTCATGCCTGTAATCCCAGCACTTTGGGAGGCTGAGGCGGGCAGATCACCTGAGGTCAGGAGTTCAAGACCAGCCTGGCCAACATGGCAAAACCCTGTCTCTACTAAAAAATACAAAAAAAAAAAAAACATTAGCCAGGCGTAGCGGCAGGCACCTGTAATCCCAGCTGCTTGGGAGGCTGAGGTGGGAGAATTGCTTGAACTCAGGAAGCGGAGGTTGTAGTGAGCCAAGATCATGCCACTGCACTCCAGCCTGAGCGACAGAGTGAGACTCTGTTAAAAAAAAAAAAAAGAAAAAAAAAAGTTAGCCAGCTGTGGTGGCATCCACCTGTAATCTCAGCTACTTGAGAGGCTGAGGCTGGAGAATCGCTTGAACTGGAAGTGGAGGTTGCAGTGAGTCAAGATCGTGCCATTGCACTCCAGCCTGTGCAACAAGAGTGAAATTCCATCAAAAAAAAAAAAAAAA","GGCTGGGCGCAGTGGCTCACACCTGTAATCCCAGCACTTAGGGAAGCTGAGGCGAGTAGATCACCTGAGGTCAGGAGTTAGAGACCAGCCTGGCCATCATGGTGAAACCCCGTCTCTACTAAAGATACCAAAAATTAGCTGAGTGTGGTGCTGGGTGCCTGTAATCCCAGAAACTCAGGGTGCCTGTAATCCCAGCAACTCAGGGTGCCTTTAATCCCAGCAACTGAGGGTACCAGTAATCCCAGCAACTCAGGGTGTCTTTAATCCTAGCAACTGAGGGCACCTGTAATCCCAGCAACTCAGGAAGCTGAGACAGGAGAAGTACTTGAACCCAGAAGGCAGAGGTTGCAGTGAGCCGATATTGCACCATTGCACTCCAGTCTGGGCAACAAGAGTGAAACTCTGTCTCAAAAAAAAA"
"chr10","92296652","92296908","JH378118","27195548","27195776","70","65101104","TGGTGAAACCCCGTCTCTACTAAAAATACAAAAATTAGCCAGGCGTGGTGGCTGACGCCTGTAGTCCCATCTACGCGGGAGGCTGAGGCAGGAGAATTGCTTGAACCTGGGCAGCAGAGGTTGTGGTGAGCCAAGATCACACCATTGCACTCCAGCCTCGGCAACAAGAGCTAAACTCCATCTCAAAATAAATAAATAAATAAATAAATAAGATATATTTTCCATGCTAAAGTAAAAAAAAAAAAAAAAAAAAAAAA","AACATGGTGAAACCCCGTCTCTACTAAAAATACAAAAAATTAGCTGGGCGTGGTGGCGCGTGCCTGTAATCCCAGCTACTCGGGAGGCTGAGACAGGAGAATTGCCTGAGCCCAGGAGGCGGAGGTTGCAGTGAGCCGAGATCGCGCCATTGCGCTCCAGCCTGGGTAACAAGAGCGAACCTCCGTCTCAAAATAAAAAAACAAAACAAAACAAAACAAAAAAAACAAA"
"chr10","93544143","93544445","JH378232","4048076","4048387","54","89496067","GGCCAGGTGCGGCGGCTCACGCCTGTAATCCCAGCACTTTGGAAGGCCGAGGCAGGCGGATCACCTGAGGTCTGGAGTTCGAGATCAGCCTGGCCAACATGGTGAAACCCTGTCTCTACTTAAAAAAAAAAAAAAAAAAAAAAAAAAGCCGGGCGTGGTGGCGGGCCCCTGTAATCCCAGCTGAGGCGAGGGAATCGCTTGAACCCAGGAGGCGGAGGTTACAGTGAGCCGATAGTGCGCCATTACACTCCAGCCTGGGCGACAAAAGCGAGACTCAGTCTCAAAAAACAAAAACAAAAAAAA","GCCAGGCGCAGTGGCTCACGCCTGTAATCCCAGCACTTCGGGAGGCTGAGGCAGGTGGATCACCTGAGGTCAGGAGTTCAAGACCAGCCTGGCCAACATGGTGAAACTCCATCTTAAAAAAAAAAAAAAAAAAAAAAAAATTAGCCTGGTGTGGTGACAGGCACCTGTAATCCCAGCTACTCAGGAGGCTGAGGCAGGAAAATCGCTTGAACCCAGGAGGCGGAGGTTGTAGTGAGCCAAGATCGCGCCATTGCACTCCAGTCTGGGCAACAAAAGCAGAACTTCGCCTCAAAAAAACAAAACCAAAAACAA"
"chr10","94343273","94343598","JH378115","16887097","16887400","58","77456176","GGTCCGGCACGGTGGCTCACACCTGTAATCCCAGCACTTTGGGAGGCCGAGGCGGGTGGATCACCTGAGGTCAGGAGTTCGAGGCAAGCCTGGCCAACATGGCGAAACCCTGTCTCTACTAAAAATACACACACACACACACACACACACACACACACACAAAATTAGCCGGGCCTGGTGGCAGGCAGTTGTAATCCCAGCTACTCAGGAGGCTGAGGCAGGAGAATCGCTTGAACCCGGGAGGTGGAGGTTGCAGTGAGTCGAGATCATGCCACTGCACTCCAGCCTTGGTAACAAGAGCAGAACTCCATCTCAAAATAAATAAA","GCCGGGCACGGTGGCTCAAGCCTGTAATCCCAGCACTTTGGGAGGCCGAGGCGGGTGGATCACAAGGTCAAGAGATCGAGACCAACCTGGTCAACATGGTGAAACCCCATCTCTACTAAAAAATACAAAAAAAAAAAAAAAATTAGCTGGGCATGGTGGCGCGTGCCTATAATCCCAGCTACTCAGGAGGCTGAGGCAGGAGAATTGCCTGAACCTAGGAGGTGGAGGTTGCAGTGAGCCAAGATCATGCCATTGCACTCCAGCCTGGGTAACAAGAGCGAAACTCCATCTCAAAAAAAAAAAA"
"chr10","95856294","95856923","JH378118","18053084","18053501","284","77803210","CTGGGTGTGGCGGCTTATGCATGTAATCCCGGCACTTTGGGAGGCAGAGGTGGGGTGGATCACCTGAGGTCAGGAGTTCAACACCAGCCTGGCCAACATTGTAAAGCCCTATCTCTACTAAAAATACAAAAATTAGGGCCAGGTGCAGTGGCTCATGCCTGTAATCCCAGCACTTTGGGAGGCCGAGGCGGGCCGATCACGAGGTCAGGAGTTCGAAACCAGCCTGGCCAACATGGCAAAACCCCGTCTCTACTGAAAATACAAAAATTAGCCAGGCGTGGTGGTGGGCACCTGTAATCCCAGCTACTTGGGAGACTGAAGCAGAAGAATTGCTTGAACCCGGGAGGTGGAGGTTGCAGTGAGCCAAGATCATACCATTGCACTCCAGCCTGGGTAACAAGAGCAAGACTCCATCTCAAAAAAAAAAAAAAAGAAAAAGAAAATAAAATAAAAAATTAGCCGGGCGTGGTGGCAGGCACCTGTAATCCCAGGTACTCGGGAGGCTGAGGCAGGAGAATCGCTTGAACCCAGGAGGCGGAGGTTGCAGCAAGCCGAGATCGCACCATTGCACTCTAGCCTGGGTGACAAAAGCGAACTCCATCTCAAAAATAAATAAATAAATAAAATAAA","GGCTGGGCGCAGTGGCTCACACCTGTAATCCCAGCACTTAGGGAAGCTGAGGCGAGTAGATCACCTGAGGTCAGGAGTTAGAGACCAGCCTGGCCATCATGGTGAAACCCCGTCTCTACTAAAGATACCAAAAATTAGCTGAGTGTGGTGCTGGGTGCCTGTAATCCCAGAAACTCAGGGTGCCTGTAATCCCAGCAACTCAGGGTGCCTTTAATCCCAGCAACTGAGGGTACCAGTAATCCCAGCAACTCAGGGTGTCTTTAATCCTAGCAACTGAGGGCACCTGTAATCCCAGCAACTCAGGAAGCTGAGACAGGAGAAGTACTTGAACCCAGAAGGCAGAGGTTGCAGTGAGCCGATATTGCACCATTGCACTCCAGTCTGGGCAACAAGAGTGAAACTCTGTCTCAAAAAAAAA"
"chr10","96096961","96097092","JH378155","6169149","6169252","35","89927812","GTGGCAGTGAGCTGAGATCACTCCATTGCACTCCAGCCTGGGTGACAAGAGTGAAACTCCGTCTCAAAACACACACACACACACACACACACACACACACACACACACACGAAAGAATTCAAGAAAGAACAA","TGCAGTGAGCCGAGATCGTGCCATTGCACTCCAGCCTGGGTAACAAGAGCAAAACTCCGTCTCAAAAAACAAACAAACAAACAAACAAAAAAAAAACAAAAAAA"
"chr10","98348289","98348890","JH378118","18053084","18053501","247","80295205","GGCCGGGCATGGTGGCTCACACCTGTAATCCCAGCACTTTGGGAGGCCGAGGCAGGTGGATCACCTGAGGTCAGGAGTTTGAGACCAACCTGCCCAACATAGCGAAACCCTGTCTCTATTAAAAAAAAAATACAGGCCAGGCTCATGCCTGTAATCCCAGCACTTTGGAAGGCCGAGGCGGGTGGAATACGAGGTCAGGAAATCGAGACCATCCTGGCTAACATGGTGAAACCCTGTCTTTACTAAAAATACAAAAAATTAGCCGGGCATGGTGGCGGGCACCTGTAGTCCCAGCTACTCGGGAGGCTGGGGCAGGAGAATGGTGTGAACCCAGGAGGCAGAGCTTGCAGTGAGCTGAGATCATGCCACTGCACTCCTACCTGGGCGACAGAGCGAGACTCCGTCTCAAAAAAAAAAAAAAAAAAAAAAAATTACCTGGGCGTGGTGGCAAGCACCTGTAATCCCAGCTACTCAGGAGGCTGAGGCAGGAGAATCGCTTGAACCCGGGAGGTAGAGGTTGCAGTGAGCTGAGATTGCACCACTGCACTCCAGCCTGGGTGACAAGAGCGAAACTCTATCTCAAAAAAAAAAAAAAAAAAAAA","GGCTGGGCGCAGTGGCTCACACCTGTAATCCCAGCACTTAGGGAAGCTGAGGCGAGTAGATCACCTGAGGTCAGGAGTTAGAGACCAGCCTGGCCATCATGGTGAAACCCCGTCTCTACTAAAGATACCAAAAATTAGCTGAGTGTGGTGCTGGGTGCCTGTAATCCCAGAAACTCAGGGTGCCTGTAATCCCAGCAACTCAGGGTGCCTTTAATCCCAGCAACTGAGGGTACCAGTAATCCCAGCAACTCAGGGTGTCTTTAATCCTAGCAACTGAGGGCACCTGTAATCCCAGCAACTCAGGAAGCTGAGACAGGAGAAGTACTTGAACCCAGAAGGCAGAGGTTGCAGTGAGCCGATATTGCACCATTGCACTCCAGTCTGGGCAACAAGAGTGAAACTCTGTCTCAAAAAAAAA"
"chr10","98740948","98741577","JH378118","18053084","18053501","270","80687864","GGCCGGGTGCAGTGGCTCATGCTTGTAATCCCAGCACTTTGGGAGGCCAAGGTGGGCAGATCACTTGAGGTCAGGAGTTTGAGACCAGGTTGGCCAACATGGTAAAACCCCATCTCTACTAAAAAAAAAAAAAAAAAAAAAAAAAAAATTGGCCAGGCGCGGTGGCTCATGCCTGTAATCCCAGCACTTTGGGAGGCCTCAGGAGATCGAGACCATCCTGGCAAACACGGTGAAACCCTGTCTCTACTAAAAATACAAAAAAAAAAAATTAGCCAGGCGTGGTGGCAGGTGCCTGTAGTCCCAGCTACTCGGGAGGCTGAGGCTGAGGCAGGAGAATGGCGCGAACCCGGGAGGCGGAGCTTGCAGTGAACCGAGATTGTGCCGCTGCACTCTAGCCTGGGCAACAGAGCAAAACTCCGTCTCAAAAAAAAAAAAGAAAAAAAAAATATATATTTCTATAAATTAGCCAGGCATAGTGGTGGACGCCTGTAATCCCAGCTACTCTGGAGGCTGAGGCAGGAGAATCACTTGAACCTGGGGGGCAGAGGTTGCAGTGAGCCGAGATCGCGCCTTTGCACTCCAGCCTGGGGCAACAAGAGCGAAACTCTGTCTCAAAAAATAAAATAAAAA","GGCTGGGCGCAGTGGCTCACACCTGTAATCCCAGCACTTAGGGAAGCTGAGGCGAGTAGATCACCTGAGGTCAGGAGTTAGAGACCAGCCTGGCCATCATGGTGAAACCCCGTCTCTACTAAAGATACCAAAAATTAGCTGAGTGTGGTGCTGGGTGCCTGTAATCCCAGAAACTCAGGGTGCCTGTAATCCCAGCAACTCAGGGTGCCTTTAATCCCAGCAACTGAGGGTACCAGTAATCCCAGCAACTCAGGGTGTCTTTAATCCTAGCAACTGAGGGCACCTGTAATCCCAGCAACTCAGGAAGCTGAGACAGGAGAAGTACTTGAACCCAGAAGGCAGAGGTTGCAGTGAGCCGATATTGCACCATTGCACTCCAGTCTGGGCAACAAGAGTGAAACTCTGTCTCAAAAAAAAA"
"chr10","100193161","100193487","JH378240","2812907","2813216","58","97380254","GGCCGGGCGCTGTGACTCACGCCTGTAATCCTAGCACTTTGAGAGACTGAGGCGGGTGGAGCACCTGAGGTCAGGAGTTCGAGACCAGCCTAGCCAATATCATGAAACCCCGTCTCTACTAAAAGTACACACACACACACACACACACACACAAATTAGCCAAGCATGGTGGCAGGTGCCTGTAATCCCAGCTATTCAGGAGGCTGAGGCAGGAGGATCGCTTGAACTTGTGAGGTGGAGGCTGCAGTGAGCTAAGATCGCACCATTGCACTCCAGCCTGGGTGACAAGAGCAAGACTGTCTCAAAAAAAGAAAAAAAAAAAAGAAA","GGCCGGGCGCAGTGGCTCAAGCCTGTAATCCCAGCACTTTGGGAGGCCGAGGCGGGTGGATCACGAGGTCAAGAGATCGAGACCATCCTGGTCAACATCGTGAAACCCTGTCTCTACTAAAAAAATACAAAAAAAAAATTAGCTGGGCATGGTGGCAGGTGCCTGTAATCCCAGCTACTCAGGAGGCTGAGGCAGGAGAATTGCCTGAACCCAGGAGGCGGAGGTTGCGGTGAGCCGAGATCGCGCCATTGCACTCCAGCCTGGGTAACAAGAGCGAAACTCCGTCTCAAAAAAAAAAAAAAAAAAAAAA"
"chr10","101097489","101098090","JH378118","18053084","18053501","258","83044405","CGGGCAACGGTGGCTCACGCCTGTAATCCCAATACTTTGGGAGGCTGAAGTGGGCAGATAACCTGAGGTCAGGATTTCAAGACCAACCATGGCCAACATGGTGAAACCCCGTCTCTACTAAAAATACAAAATGAGGCCAGGCGCAGTGGCTCACGCCTGTAATGCCAGCACTTTGGGAGGCTGAGGCGGGCGGATCACAAGGTGAGGAGATTGAGACCATCCTGGCCAACATGGTGAAATCCCGTCTCTACTAAAAATACAAAAATTAGCTGTGCTAATTTGTTGGGATTTGTGGCACGTGCCTGTAATCCCAACTACTTGTGAGGCTGAGGCAGGAGAATCGTTCAGGGAGTCGGAGGTTGCAGTGAGCCGAGACTGCGCCACTGCACTCCAGCCTGGCGATGGAGTGAGACTCCATCTCGAAAAAAAAAAAAAAAATACAAAATGAGCTGGGCATGGTGGCAGGCACCTGTAATCCCAGCTACTCTGAAGGCTGAGGCAGGAGAATCACTTGAGCCGGGAGGCAGAGGCTGTGGTGAGCCAAGATCATGCCACTGCACTCTAGCCTGGATAACAAGAGTGAAACTCCATCTCAAAAAAAA","GGCTGGGCGCAGTGGCTCACACCTGTAATCCCAGCACTTAGGGAAGCTGAGGCGAGTAGATCACCTGAGGTCAGGAGTTAGAGACCAGCCTGGCCATCATGGTGAAACCCCGTCTCTACTAAAGATACCAAAAATTAGCTGAGTGTGGTGCTGGGTGCCTGTAATCCCAGAAACTCAGGGTGCCTGTAATCCCAGCAACTCAGGGTGCCTTTAATCCCAGCAACTGAGGGTACCAGTAATCCCAGCAACTCAGGGTGTCTTTAATCCTAGCAACTGAGGGCACCTGTAATCCCAGCAACTCAGGAAGCTGAGACAGGAGAAGTACTTGAACCCAGAAGGCAGAGGTTGCAGTGAGCCGATATTGCACCATTGCACTCCAGTCTGGGCAACAAGAGTGAAACTCTGTCTCAAAAAAAAA"
"chr10","101583490","101584085","JH378118","18053084","18053501","241","83530406","GGCCTGGCATGGTGGCTCACGCCTGCAATCCCAGCACTTTGGGAAGCCGAGGTGGGTGGATCACCTGAGGTCAAGAGTTCAAGACCAGCCTGGCCAATATGGTGAAACTCCATCACTACTAAAAATACAAAAAATTAGCCAGACGGGCCAGGCATGGTGGCTCATGCCTGTAATCCCAGCACTTTGGGAGGCCAAGGGGGGTGGATCACGATGTCAGGAGATCGAGACCATCCTGACCAACATGGTGAAACCCGGTCTCTACTAAAAATACAAAAATTAGCTGGGTGTGGTGGTGCGTGCTTGTAATCCCAGCTACTTGGGAGGCTGAAGCAGGAGAATCGTTTGAACCCAGGAGGTGGAGGTTACAGTGAGCCGAGATCGCGCCACTGCACTCCAGCCTGGCGACAGAGCAAGACTCTGTCTCAAAAAAAAAAAAAAATTAGCCAGATGTGGTGGTGGATGCCTGTAATCCCAGCTATTCAGAAGGCTGAGGCAGGAGAATCATTTGAACCCAGAAGACAGAGGTTGCAGTGAGCTGAGACTGTGCCATCACACTCCAGGCTGGGCAACAAGAGCGAAACTCCACCTCAAAAAAA","GGCTGGGCGCAGTGGCTCACACCTGTAATCCCAGCACTTAGGGAAGCTGAGGCGAGTAGATCACCTGAGGTCAGGAGTTAGAGACCAGCCTGGCCATCATGGTGAAACCCCGTCTCTACTAAAGATACCAAAAATTAGCTGAGTGTGGTGCTGGGTGCCTGTAATCCCAGAAACTCAGGGTGCCTGTAATCCCAGCAACTCAGGGTGCCTTTAATCCCAGCAACTGAGGGTACCAGTAATCCCAGCAACTCAGGGTGTCTTTAATCCTAGCAACTGAGGGCACCTGTAATCCCAGCAACTCAGGAAGCTGAGACAGGAGAAGTACTTGAACCCAGAAGGCAGAGGTTGCAGTGAGCCGATATTGCACCATTGCACTCCAGTCTGGGCAACAAGAGTGAAACTCTGTCTCAAAAAAAAA"
"chr10","101734620","101735218","JH378129","11955248","11955630","268","89779372","GGCTGGGCACGGTGGCTCGTACTCTTTTTTTTGAGATGGAGTCTCGCTCTGTCACCCACGCTGGAGTGCAGTGGCGTGATCTCGGTTCACTGCATCCTCCGCCTCCCGGGTTCACGCCATTCTCCTGCCTCAGCCTCCTGAGTAGCTGGGACTATAGGCGCCCACTACCACGCCTGGCTAATTTTTTGTGTTTTTAGTAGAGACGGGGTTTCACTGTGTTAGCCAGGATGGCCTCAATCTCCCGACCTTGTGATCCACCTGTTTCGGCCTCCCAAAGTGCTGGGATTACAGGCGGGAGCCACCGCACCCGGCGGCTCTTACTTGTAATCCCAGCACTTTGGGAGGCAGGTGGATCACCTGTGGTCAGAGTTTGAGACTAGCCTGGCCAACATAGTGAAACCCCATCTCTACTAAAAATACAAAAATTAGCTGGGCATAGTGGTGCATGCCTGTAATCCCAGCTACTCAGGAGGCTGAGGCAGGAGAATCACTTGAACTCGAGATGGGGAGGTTGCAGTGAGCCGAGATGGTGCCATTGCACTACAGCCTGGGCGACAAGAGTGAAACTCCATCTCAAAAGGAAAAGAAAAAAAAAAAAA","GGCTGGGTACGGTGGCTCATGCCTGTAATCCCAGCACTTTGGGAGGTGGGTCACTTGAGGTCAGGAGTTCGAGACCAGCCTGTGCAGTGCCTCCATCCTCAACTGCTGCCTCATCAGCCTGGACCACTACCTGCTCATCCTCTCACCACTGCCACAAGCTGCGCATGAAGCTCCTGCGCGCGCCGGTGCCCGTCTCTACTAAAAATACAAAAATTAGCTGGGTGTGGTGGCAGGTGCCTGTAATCCCAGCTACTCAGGAGGCTGAGGCAGGAGAATCACTTGAACCCAGGAGGCAGAGGTTGCAGTGAGCCGATATCGCATCATTGCACTCCAGCCTGAGCAACAAGAGTGAAATTTTGTCTCAAAAAAAAAAAAAAAAGAAA"
"chr10","105299779","105300111","JH378137","13677298","13677634","51","91622481","CGGGCACGGTGACTCACGCCTGTATTCCCAGCAATTTGGGAGGCTGAGGTGGGTGGATCACCTGAGGTCAGGAGTTCGAGACCAGCCTTGCCAACATGGTGAAACCCTGTCTCTACTGAAAAAAAAAAAAAAAAAAAAAAAAAAAAAAAAAAAAAAAACTAGCTGGGCGTGGTGGCGGGCACATGTAATCCCAGCTACTCGGGAGGCTGAGGCAGGAGAATTGCTTGAACCTGGGAGATGGAGGTGGCAGTGACCTGAGATCATGCCATTGCACTCCAGTCTGGGCAAAAAAAGCACAACTCCATCTCAAAAAAAAAAAAAAAAAAAAAGAAA","GGCTGGGCATTGTGGCTCATGCCTGTAATCCCAGCACTTTGGGAGGCCGAGGTGGGCGGATCACCTGAGGTCGGGAGTTCAAGACCAGCCTGGCCACAATGGTGAAACTCTGTCTCTGCTAAAAAAAAAAAAAAAAAAAAAAAAAAAAAAAAAAAAAAAATTAGCCAGGCGTGGTGGCACACGCCTGTAATCCCAGCTATTTGGGAGGCTGAGGCAGGAGAATCGCTTGAACCTGAGAGGTGGAGGTTGCAGTGAGCCAAGATCATACCATTGCACTCCAGCTTGGGAACAAAGAGCAAAACGCCATCTCAAAAACAAAACAAACAAACTGAAAAAA"
"chr10","117266792","117267403","JH378118","18053084","18053501","259","99213708","GGCCGGGCACAGTGGCTCATGCCTGTAATCCCAGCACTTTGGGATGCCAAGGCAGGTGGATCACCTGAGGTCAGGAGTTCGAGACCAGCCCGGCCAACATGGCAGAACCCCGTCTCCACTAAAAATACAAAAAATTGCCAGGCATGGTGGCTCACACCTGTAATCCTAGCACTTTGGGAGGCTGAGGAGGGCAGATCACCTGAGGTCGGGAGTGCGAGACCAGCCTGACCAACATGGAGAAACCCCGTCTCTTCTAAAAATGCAAAATTAGCCAAGCATGGTGGCACATGCCTGTATTCCCAGCTACTCAGGAGGCTAATGTAGGAGAATCGCCTGAACCTGGGAGGCGGAGGTTGTGGTAAGCCGAGACTGCGCTGTTGCACTCCAGCCTGGGCAACAAGAGTGAAACTCTGCCTCAAAAGAAAAAAAAAATACAACAAATTAGCCAGGCATGGTGGCGGGCACCTGTAATCCCAGCCACTTGGGAGGCTGAGGCAGGAGAATCGCCTGAACGTAGGAGGTGGAGGTTGCAGTGAACCGAGATCGTGCCGTTGCACTCCAGCCTGGACGACAAGAGTGAAACTCCACCTCAAAAAGAAACAACAAAAAAAA","GGCTGGGCGCAGTGGCTCACACCTGTAATCCCAGCACTTAGGGAAGCTGAGGCGAGTAGATCACCTGAGGTCAGGAGTTAGAGACCAGCCTGGCCATCATGGTGAAACCCCGTCTCTACTAAAGATACCAAAAATTAGCTGAGTGTGGTGCTGGGTGCCTGTAATCCCAGAAACTCAGGGTGCCTGTAATCCCAGCAACTCAGGGTGCCTTTAATCCCAGCAACTGAGGGTACCAGTAATCCCAGCAACTCAGGGTGTCTTTAATCCTAGCAACTGAGGGCACCTGTAATCCCAGCAACTCAGGAAGCTGAGACAGGAGAAGTACTTGAACCCAGAAGGCAGAGGTTGCAGTGAGCCGATATTGCACCATTGCACTCCAGTCTGGGCAACAAGAGTGAAACTCTGTCTCAAAAAAAAA"
"chr10","118157628","118158326","JH378118","18053084","18053501","341","100104544","GGCCAGGCGCGGTGGCTCACACCTGTCATCTCAGCACTTTGGGAGGCCGAGGCGGGTGGATCACCTGAGGTCAGGAGTTCGAGACCAGCCTGGCCAACGTGGTGAAACCCTATCTTCACTAAAAAAAATACAAAAATTAGGCTGGGCGCGGTGGCTCATGCCTGTAATCCCAGCACTTTGGCAGGCCGAGGTGGGTGGATCACAAGATCAGGAGATGGAGACCATCCTGGCTAACACGGCGAAACCCCATCTCTACTAAAAATACAAACAAAAAAATTAGCCGGGCGTGGTGGCCGGCGCCTGTAGTCCCAGCTACTCGGGAGGCTGAGGCAGAAGAATGGCGTGAACCTGGGAGGTGGAGCTTGCAGTGAGCCGAGATCGCGCCACTGCACTCCAGCCTGGGTGACAGAGCGAGACTCCATCTCAAAAAAAAAAAAAAAAAAAAAAAAAAAAAATATATATATATATATATATATATATATATATGACACACACACACACACACACACACACACACACAAAAATTAGCTGTGTGTGGTGGCGGGTGCCTGTAATCCCAGTTACTCGGGAGGCTGAGGCAGAAGAATCGCTTGAACCTGGAGGTGGAGGTTGCAGTGAGCTGAGATCACACCATTGCACTCTAGCCTGGGCTACAAGAGTGAAACTCCGCCAAAAAAAACCACACACACACAAAAAAAA","GGCTGGGCGCAGTGGCTCACACCTGTAATCCCAGCACTTAGGGAAGCTGAGGCGAGTAGATCACCTGAGGTCAGGAGTTAGAGACCAGCCTGGCCATCATGGTGAAACCCCGTCTCTACTAAAGATACCAAAAATTAGCTGAGTGTGGTGCTGGGTGCCTGTAATCCCAGAAACTCAGGGTGCCTGTAATCCCAGCAACTCAGGGTGCCTTTAATCCCAGCAACTGAGGGTACCAGTAATCCCAGCAACTCAGGGTGTCTTTAATCCTAGCAACTGAGGGCACCTGTAATCCCAGCAACTCAGGAAGCTGAGACAGGAGAAGTACTTGAACCCAGAAGGCAGAGGTTGCAGTGAGCCGATATTGCACCATTGCACTCCAGTCTGGGCAACAAGAGTGAAACTCTGTCTCAAAAAAAAA"
"chr10","118353555","118354149","JH378118","18053084","18053501","262","100300471","GGCCGGGCGCGGTGGCTCACGCCTATAATCCCAGCACTTCGAGAGGCCAAGGCAGGCAAATCACCTGTTCGAGACCAGCCTTGCTAACATGGCGAAATCCTGTCTCTACTAAAAATACAAAAATTAGCGGCTGGGCGCGGTGGCTCACACCTATAATCCCAGCACTTTGGGAGGCCAAGGTGGGCGGATCACTAGATCAGGAGTTCAAGACCAGCCTGGCCAAGATGGTGAAACCCTGTCTTTACTAAAAATACAAAAATTAGCTGGGCATGGTGGCATGCACCTGTAATCCCAGCTACTCGGAGGGCTGAGGCAGGAGAATCGCTTGAACCCAGGAGGCAGAGGCTGCAGTGAGCCAAGACTGTAACACTGTGCCCTAGCCTGGGTGACAGAGCAAGACTCAGTCTCAAAAAAAAAAAAAAAAAAAATTAGCTTGGCATGGTGGCAGGCACTTGTAATCCCAGCTACTCCGGAGGCTGAGGCAGAACTGCTTGAACCTGGGAGGCGGAGGTTGCAGTGAGCTGAGAGATCACACTGTTGCACTCCAGCCTGGGTGACAAGAACGAAACTCTATCCCAAAAACAAAACAAAAAAA","GGCTGGGCGCAGTGGCTCACACCTGTAATCCCAGCACTTAGGGAAGCTGAGGCGAGTAGATCACCTGAGGTCAGGAGTTAGAGACCAGCCTGGCCATCATGGTGAAACCCCGTCTCTACTAAAGATACCAAAAATTAGCTGAGTGTGGTGCTGGGTGCCTGTAATCCCAGAAACTCAGGGTGCCTGTAATCCCAGCAACTCAGGGTGCCTTTAATCCCAGCAACTGAGGGTACCAGTAATCCCAGCAACTCAGGGTGTCTTTAATCCTAGCAACTGAGGGCACCTGTAATCCCAGCAACTCAGGAAGCTGAGACAGGAGAAGTACTTGAACCCAGAAGGCAGAGGTTGCAGTGAGCCGATATTGCACCATTGCACTCCAGTCTGGGCAACAAGAGTGAAACTCTGTCTCAAAAAAAAA"
"chr10","122118156","122118494","JH378105","65222258","65222568","66","56895898","GGCCAGGTGTGGTGGCGGCTCATTCTCATAATCCCAGCACTTCGGGAGGCTGAAGCAGGTGGATCACCTGAGGTCAGGAGTTCGAGACCAGCCTGGCCAACATGATGAAACCTCGTCTCTACTAAAACTACAAAAATTAGCTGGGCGTGGTGGCAGGCACCTGTAATCCCAGCTACTCAGGAGACTGAGGCAGGAGAATCACTTGAACCCGGGAGGCAGAGGTTGCAGTGAGCCGAGATTGTACAAATGCACTCCAGCCTCAGCAATAAGAGTGAGATTCTGCCAGAAGGAAGGAAGGAAGGAAGGAAGGGGAGAAAGAAAGAAAGAAAGAGAAAAAAA","GGCCAGGTGAAGTGGCTCACACCTGTAATCCCAACACTTTGGGAGGCTGAGGCAGGTGGATCACCTGAGGTCAGGAGTTCAAGACCAACCTGACTAACATGTTGAAATCCTGTCTCTACTAAAAATACAAAAATAGCTGGGCGTCGTGGCAGGCACCTGTAGTCCCAGCTACTCAGGAGGCTGAGGCAGAAGAATTGCTTGAACCCAGGAGGTGGAGGTTGCAATGAGCCGAGATTGTGCCATTGCACTCCAGCCTGGGCAACAAGAGTGAAATTCCATCTCAGGAAAAAAGAAAAAAAGAAAGAAAGAAA"
"chr10","124162347","124162960","JH378118","18053084","18053501","249","106109263","GGCCGGGCACGGTGGCTCACACCTGTAATCCCAGCACTTTGGGAGGCTGAGGCAGGCAGATCACCTGAGGTCAGGAGTTCAAGACCAACCTGGCCAACGTGGTGAAAACCCGTCTCTACTAAAAATATGAAAGTTGCCAGGTGCAGTGGCTAACGCCGGTAATCCCAACACTTTGGGAGGCTGAGGCAGGCGGATCACGAGGTCAAGAGATCGAGACCATCTTGGCCAACATGGTGAAACCCTGTCTCTAATAAAAATACAAAAATTAGCTGGGTGTGGTGGCGTGTGCCTGTAGTCCCAGCTACTCAGGAGGCTGAGGCAGGAGAATTGCTTGAACCCAGGAGGCGGAGGTTGCAGTGAGCAGAGATCACACCACTGCACTCCAGCCTGGAAACAGAGTGAGACTCCATCTCAAAATAAATAAATAAATAAATAAAATACAAAACTTAGCTGGGCATCATGGCCAGCACCTGTAATCCCAGCTACTCGGAAGGCTGAGGCAGGAGAATCACTTGAACCTGGGAGGTGGAGGTTGCAGTGAGCCAAGATCATGCCATTGCACTCCAGCCTAGGCAACAAGAGTGAAACTCTGTCTCAAAAAAAAAAAAAAAAAA","GGCTGGGCGCAGTGGCTCACACCTGTAATCCCAGCACTTAGGGAAGCTGAGGCGAGTAGATCACCTGAGGTCAGGAGTTAGAGACCAGCCTGGCCATCATGGTGAAACCCCGTCTCTACTAAAGATACCAAAAATTAGCTGAGTGTGGTGCTGGGTGCCTGTAATCCCAGAAACTCAGGGTGCCTGTAATCCCAGCAACTCAGGGTGCCTTTAATCCCAGCAACTGAGGGTACCAGTAATCCCAGCAACTCAGGGTGTCTTTAATCCTAGCAACTGAGGGCACCTGTAATCCCAGCAACTCAGGAAGCTGAGACAGGAGAAGTACTTGAACCCAGAAGGCAGAGGTTGCAGTGAGCCGATATTGCACCATTGCACTCCAGTCTGGGCAACAAGAGTGAAACTCTGTCTCAAAAAAAAA"
"chr10","130655623","130656106","JH378118","18053084","18053501","156","112602539","GTCTTTTTAAAAACACAAGAGGCTGGGTGAGGTGGCTCACACCTGTAATCCCAGCACTATGGGAGGCCAAGACGGGCGGATCACTTGAGGCCAGGAGTTTGAGACCAGCCTGGCTAACACAGTGAAACCCCGTCTCTACTAAAAACACAAAAATTAGCCAGGTGTGGTGGCACATGCCTGTAGTCTCAGCTACTCAGGAGGCTGAGGCGGGAGAATCTCTTGAACCCGGGAGGTGGAGGTTGCAGTGAGCCGAGACCATGCCATTGCACTCCAGCCTGGGTGACAGAGTGAGACTCCATCTCAAAAAAAAAAAAAAAATTAGCTGGGCATGGTAGCGGGCACCTGTAATCCTAGCTACTCTGGAGGCTGAGGCAGGAGAATCACTTGAACCCAGGAGGTGGAGGTTGCAGTGAGCTGAGATCGTGCCATTGCACTCCAGCCAGGGCAACAAGAGTGAAACTCCGTCTCAAAAAACACAAGAAAA","GGCTGGGCGCAGTGGCTCACACCTGTAATCCCAGCACTTAGGGAAGCTGAGGCGAGTAGATCACCTGAGGTCAGGAGTTAGAGACCAGCCTGGCCATCATGGTGAAACCCCGTCTCTACTAAAGATACCAAAAATTAGCTGAGTGTGGTGCTGGGTGCCTGTAATCCCAGAAACTCAGGGTGCCTGTAATCCCAGCAACTCAGGGTGCCTTTAATCCCAGCAACTGAGGGTACCAGTAATCCCAGCAACTCAGGGTGTCTTTAATCCTAGCAACTGAGGGCACCTGTAATCCCAGCAACTCAGGAAGCTGAGACAGGAGAAGTACTTGAACCCAGAAGGCAGAGGTTGCAGTGAGCCGATATTGCACCATTGCACTCCAGTCTGGGCAACAAGAGTGAAACTCTGTCTCAAAAAAAAA"
"chr11","305245","305835","JH378118","18053084","18053501","261","17747839","GCAGGGTGCGGTGGCCCACTCCTGTATTCCTAGCACTTTGGGAGGCCAAAGCAGGTGGATCGGCTAAGGTCAGGGGTTCGAGACCAGCATGGCCAAGCCACGTCTCTATTAAAAATACAAAAATTAGGGCTGGGCGCAGTGGCTCACACCTGTAATCCCGGCACTTTGGGAGGCCAAGGTGGGTGGATCACAAGGTCAGGAGATCAAGACCATCCGGGCTAACACAGTGAAACCTTGTCTCTACTAAAAATACTAAAAAATTAGCCGGGCGTCGTGGCAAGCACTTGTAGACCCAGCTACTCGGGAGGCTGAGGCAGGAGAATGGCGTGAACCCGGGAGGTGGAGCTTGTAGTGAGCTGAGATCCCACCACTGCATCCAGCCTGGGTGACAGAGCAAGACTCCATCTCAAAAAAAAAAAAAAAAAAATTAGTGGAGCGTGGTGGTGGGCTCCTGTAATTCCAGCTGCTCAGGAGGCTGAGGCAGGAGAATCATTTGAACCCAGGAGGTGGAGGTTTCAGTGAGCCGAGGTTGCACCACTGCACTCCAGCCTGGGTAACAAAAGCAAAACTCTTATCTTAAAAAAAAAAAAA","GGCTGGGCGCAGTGGCTCACACCTGTAATCCCAGCACTTAGGGAAGCTGAGGCGAGTAGATCACCTGAGGTCAGGAGTTAGAGACCAGCCTGGCCATCATGGTGAAACCCCGTCTCTACTAAAGATACCAAAAATTAGCTGAGTGTGGTGCTGGGTGCCTGTAATCCCAGAAACTCAGGGTGCCTGTAATCCCAGCAACTCAGGGTGCCTTTAATCCCAGCAACTGAGGGTACCAGTAATCCCAGCAACTCAGGGTGTCTTTAATCCTAGCAACTGAGGGCACCTGTAATCCCAGCAACTCAGGAAGCTGAGACAGGAGAAGTACTTGAACCCAGAAGGCAGAGGTTGCAGTGAGCCGATATTGCACCATTGCACTCCAGTCTGGGCAACAAGAGTGAAACTCTGTCTCAAAAAAAAA"
"chr11","7042705","7043279","JH378119","32351107","32351490","229","25308402","GGCCGGGCACAGTGGCTCACACCTGTAATCCTAGCACTTTGAGAGGCCAAGGTGGGCGGATCACCTGAGGTCAGGAGTTCGAGACCAGCCTGGCCAACATGGTGAAACCCCATCTCTACTAAAAATACAAAAAAAGGCTCGGTGCGATGGCTCATGCCTGTAATCCCAGCACTTTGGGAGGCCGAGGCAGGTAGATCATGAGGTCAGGAGTTCAAGATCAGCCTGGCCAAGATGGTAAAACCCCGTCTCTACTAAAAACACAAAAATTAGCCAGGTGTGGTGGCAGGTGCCTGTAATCCCAGCTACTTGGGAGGCTGAGGCAGGAGAGTCGCTTGAACCCAGTTGGGGAGGAGGTTGTAGTGAGCCGACAGAGTGAGACTCCATCTCAAAAAAAAAAAAAAAAAATTAGCTGGGCATGGTGGCGGGCACGTGTAATCCCAGCTACTGGGGAGGCTGAGGCAGAATCTCTTCAATTCGGGAGGTGAAGGTTGCAGTGAGCTGAGATCACATCGTTGCACTCCAGCCTGGGCAACAAGAGCAAAACTCAGTCTCAAAAAAAAAAAAAAAAAAAAAAA","GGCCAGGTATGGTGGCTCACACCTGTAATCCCAGCACTTTGGGAGGCCAAGGCAGGCAGACCACCTGAGGTCAGGAGTTCGAGATCAGCCTAGCCAACATGGTGAAACCCCATCTCTAGTAAAAATAAAATTAGCCAGGCATGGTGGTGCATGCCTGTAACGCAGGTCAGGAGTTCGAGATCAGCTTAGCCAACATGGTGAAACCCCATCTCTAGTAAAAATAAAATTAGCCAGGCAGGTGGTGCCGCCTGTACTCGGGAGGCTGAGGCAGGAGAATCACTTGAACCCAAGAGGCAGAGGTTGCAGTCAGCCAAGATCATGCCATTGCACTCCAGCCTAAGCAAAAAGAGTAAAACTCAGTCTCAAAACAAAAAAACAAAAAAA"
"chr11","8629955","8630558","JH378118","18053084","18053501","248","9423129","GGCCGGGCGTGGTGGCTCACGCCTGTAATAGCACTTTGGGAGACCGAGATGGGCAGATAACCTGAGGTCAGGAGTTAGAGACCACCCTGGCCAACATGGTGAAACCATGTCTCTACTAAAAGTACAAAATTAGTCGGATGCAGTGGCTCACGCCTGTAATCCCAACATTTTCAGAGGCTGAGGTGGGTGGATCACCTAAGGTCAGGAGTTTGAGACCAGCCTGGCCAACATGGTGAAACCCCGTCTCTACTAAAAATACAAAAAGCCGGGTGTGGTGGCAGGCACCTGTAATCCCAGCTACTCAGGAGGCTGAGGCAGGAGAATCACTTGAACTCGGGAGGCAGAGGTTGCTGTGAGCCGAGATTGTGCCATTGCACACCTGCCTGGGCAACAAGAGCGAAACTCTGTCTCAAAAGAAAAAAAAAAAACACAAAATTAGCCGGGCATGGTGACGCATACCTGTAATCCCAGCTACTCAGGAGGCTGAGGCAGGAGAACCACTTGAACCTGGGAGGCAGAGGTTGCAGTGAGCCGAGATGGTGCTATTGCACTCCAGCCTGGGCCACAAGAGAGAAACTCCATCTCAAAAAAATAAAAATAAAAA","GGCTGGGCGCAGTGGCTCACACCTGTAATCCCAGCACTTAGGGAAGCTGAGGCGAGTAGATCACCTGAGGTCAGGAGTTAGAGACCAGCCTGGCCATCATGGTGAAACCCCGTCTCTACTAAAGATACCAAAAATTAGCTGAGTGTGGTGCTGGGTGCCTGTAATCCCAGAAACTCAGGGTGCCTGTAATCCCAGCAACTCAGGGTGCCTTTAATCCCAGCAACTGAGGGTACCAGTAATCCCAGCAACTCAGGGTGTCTTTAATCCTAGCAACTGAGGGCACCTGTAATCCCAGCAACTCAGGAAGCTGAGACAGGAGAAGTACTTGAACCCAGAAGGCAGAGGTTGCAGTGAGCCGATATTGCACCATTGCACTCCAGTCTGGGCAACAAGAGTGAAACTCTGTCTCAAAAAAAAA"
"chr11","8830784","8831258","JH378118","18053084","18053501","153","9222300","TAAAATTACAGAAATGAGCCAGGCGTGGTGGCTCACGCCTGTAATCCCAGCACTTTAGGAGGCCAAGGTGGGCGGATCACCTGAGGTCAGGAGTTCAAGACCAGCCTGGCCAATATAGTGAAACCCCGTCTCTACTAAAAATACAAAAATCAGCCGGGCATGGTGGTTGGCGCCTGTAATCCCAGCTACTTGGGAGACTGAAGCAGGAGAATCACTTGAACCCAGGAGGCGGAGGTTGCAATGAGCCGAGATCGTGCCATTGCACTCCAGCCTGGGGGACAAGAATGAGACTTCATCTCAAAAAAAAAAAAAATTAGCTGGGCATGGTGGTGGGCACCTGTAATCTCAGCTACTTGGGAGGCCGAGGCAGGAGAATCGCTTGAATCCAGGAGGCAGAAATTGCACTGAGCTGAGATCATGCCATTGCACTCCAGCCTAGGCAACAAGAGTGAAACTCCATCTGAAAAAAAAAAAA","GGCTGGGCGCAGTGGCTCACACCTGTAATCCCAGCACTTAGGGAAGCTGAGGCGAGTAGATCACCTGAGGTCAGGAGTTAGAGACCAGCCTGGCCATCATGGTGAAACCCCGTCTCTACTAAAGATACCAAAAATTAGCTGAGTGTGGTGCTGGGTGCCTGTAATCCCAGAAACTCAGGGTGCCTGTAATCCCAGCAACTCAGGGTGCCTTTAATCCCAGCAACTGAGGGTACCAGTAATCCCAGCAACTCAGGGTGTCTTTAATCCTAGCAACTGAGGGCACCTGTAATCCCAGCAACTCAGGAAGCTGAGACAGGAGAAGTACTTGAACCCAGAAGGCAGAGGTTGCAGTGAGCCGATATTGCACCATTGCACTCCAGTCTGGGCAACAAGAGTGAAACTCTGTCTCAAAAAAAAA"
"chr11","9334776","9335409","JH378118","18053084","18053501","266","8718308","GGCAGGGCATGGTGGCTCACACCCGTAATCCCAGCACTTTGGGAGGACAAGGCGGGCAGATCATTTGAGGTCAGGAGTTCGAGACCAGCCTGGCCAACATGGTGGAACCCCATCTCTACTAAAAATACAAAAATTAGCCGGGTGTGAGGCTGGGCGTGGTGGCTCATGCCTGTAATCCCAGCACTTTGGGAGGCCGAGGTGGGCGGATCATGACGTCAGGAGATCGAGACCATCCTGCCTAACACGGTGAAACCCTGTCTCTACTAAAAATACAAAAAAAAAAAAAAAAAATAGCCGGGCATGGTGGCAGGTGCCTGTAGTCCCAGCTACTCGGGAGGCTGAGGCAGGAGAATGGCATGAACCTGGGAGGCGGAGCTTGCAGTGAGCCGAGATTGCGCCACTGCACTCCAGCCTGGGTGACAGAGCGAGACTCTGTCTCAAAAAAAAGAAAAAATTAGCTGAGCGTGGTGGTGGGCACCTGTAATCCCAGCTACTTGATAGGCTGAGGCGGGAGAATCACTTGAACCCAGGAGGCGGAGGTTGTAGTGAGCCGAGATTGCACCATTGCACTCCAGCCTGGGTGACAAGAGTGAAACTCCATCTCAAAAAAAAAAAAAAAAAAAACATAAAAAAA","GGCTGGGCGCAGTGGCTCACACCTGTAATCCCAGCACTTAGGGAAGCTGAGGCGAGTAGATCACCTGAGGTCAGGAGTTAGAGACCAGCCTGGCCATCATGGTGAAACCCCGTCTCTACTAAAGATACCAAAAATTAGCTGAGTGTGGTGCTGGGTGCCTGTAATCCCAGAAACTCAGGGTGCCTGTAATCCCAGCAACTCAGGGTGCCTTTAATCCCAGCAACTGAGGGTACCAGTAATCCCAGCAACTCAGGGTGTCTTTAATCCTAGCAACTGAGGGCACCTGTAATCCCAGCAACTCAGGAAGCTGAGACAGGAGAAGTACTTGAACCCAGAAGGCAGAGGTTGCAGTGAGCCGATATTGCACCATTGCACTCCAGTCTGGGCAACAAGAGTGAAACTCTGTCTCAAAAAAAAA"
"chr11","9349189","9349812","JH378118","18053084","18053501","274","8703895","GGCCGGGCGCGGTGGCTCATGCCTGTAATTCCAGCACTTTGGGAGGCCAAGGTGGGTGGATAACCTGAGGTCAGGAGTTTGAGACCAACCTGGCCAATATGGTGAAACCCCATCTCTATTTTGCAAAAATACAAGCTTAGTCAGGCGCGGTGGCTCACTCCTGTAATCCCAGCACTTTGGGAGGCCGAGGCGGGCAGATCACGAGGTCAGGAGATCCAGACCATCCTGGCTAACACGGTGAAACCCCGTCTCTACTAAAAATAACAAAAAATACAAAAAATTAGCCGTGGTGGCGGGCGCCTGTAGTCCCAGCTACTCAGGAGGCTGAGGCAGGAGAATGGCGTGAACTCGGTAGGCGGAGCTTGCAGTGAGCCGAGTTTGCGAGATTGCGCCACTGGACTCTAGCCTGGGCGACAGAGCAAGACTCCGTCTCAAACAAAACAAAGCAAAAACAAAATTAGCCAGGCATGGTGGGGCACACCTGTAATCCATGCTGCTCAGAAGGCTGAAGCACAAGAATCTCTTGAACCCTGGAGGCAGACGTTGCAGGGAGCTGAGATCACGCCATTGCTCTCCAGCCTGGACAACAAGAGCAAAACTCCGACTCAAAAAAGAAAAAAAAAA","GGCTGGGCGCAGTGGCTCACACCTGTAATCCCAGCACTTAGGGAAGCTGAGGCGAGTAGATCACCTGAGGTCAGGAGTTAGAGACCAGCCTGGCCATCATGGTGAAACCCCGTCTCTACTAAAGATACCAAAAATTAGCTGAGTGTGGTGCTGGGTGCCTGTAATCCCAGAAACTCAGGGTGCCTGTAATCCCAGCAACTCAGGGTGCCTTTAATCCCAGCAACTGAGGGTACCAGTAATCCCAGCAACTCAGGGTGTCTTTAATCCTAGCAACTGAGGGCACCTGTAATCCCAGCAACTCAGGAAGCTGAGACAGGAGAAGTACTTGAACCCAGAAGGCAGAGGTTGCAGTGAGCCGATATTGCACCATTGCACTCCAGTCTGGGCAACAAGAGTGAAACTCTGTCTCAAAAAAAAA"
"chr11","9365756","9366382","JH378118","18053084","18053501","272","8687328","GGCTGGGCACAGTGGCTCACGCCTGTTAATCCCAGTGCTTTGGGAGGCCAAGGCAGGTGGATCACCTGAGGTCAGGAGTTCGAGACCAGCCTGGCCAACGTGGTAAAACCCTGTCTCTACTAAAAATACAAAAAAGGCCCAGTGCGGTGGCTTATGCCTGTAATCCCAGCACTTTGGGAGGCCGAGGCGGGTGGATCACCTGAGGTCAGGAGTTTGAAACCAGTCTGATCAACATGGAGAAACCCCATTTCTACTAAAAATAAAAAATTAGCCAGGCATGGTGGTGCATGCCTGTAATCCTAGCTACTTGGGAGGCTGAGCCAGGAGAATTGCTTGAACGAGGAGGCAGAGGTTTTGGTGAGCTGAGATTGCGCCATTGCACTCCAGCCTGGGCAACAAGAGTGAAACTCCATCTCAAAAAAATAAATAAATAAAAATAAATAAAAATACAAAAAATTAGCTGGGCGTGGTGGCGGGTGCCTGTAATTCCAGCTACTTGGGAGGTTGCGGTAGGAGAATCACTTGAACCCAGGAGGTGGAGGTTGCAGTGAGCCAAAATCGCACCATTGCACTCCAGCCTGGGTGACAAGAGTGAAACGCGGTCCCAAAACAAAACAAAAACAAAAA","GGCTGGGCGCAGTGGCTCACACCTGTAATCCCAGCACTTAGGGAAGCTGAGGCGAGTAGATCACCTGAGGTCAGGAGTTAGAGACCAGCCTGGCCATCATGGTGAAACCCCGTCTCTACTAAAGATACCAAAAATTAGCTGAGTGTGGTGCTGGGTGCCTGTAATCCCAGAAACTCAGGGTGCCTGTAATCCCAGCAACTCAGGGTGCCTTTAATCCCAGCAACTGAGGGTACCAGTAATCCCAGCAACTCAGGGTGTCTTTAATCCTAGCAACTGAGGGCACCTGTAATCCCAGCAACTCAGGAAGCTGAGACAGGAGAAGTACTTGAACCCAGAAGGCAGAGGTTGCAGTGAGCCGATATTGCACCATTGCACTCCAGTCTGGGCAACAAGAGTGAAACTCTGTCTCAAAAAAAAA"
"chr11","9523970","9524493","JH378118","18053084","18053501","201","8529114","TTCGAGACCAGCTTTGCCAACATGGTGAAACCCCATCTCTACTTAAAATACAAGAATTAGGCTGGCTGCGGTGGCTTACGCCTGTAATCCCAGCACTTTGGGAGGCCGAGGCAGGCGGATCCCAAGGTCAGGAGTTTGAGACCAGCCTGGCCAACATGGTGAAAGCCCGTCTCTAGTAAAAATACAAAAAATTATCCGGTGTGGTGGCAGGTGCCTGTAATCCCAGCTACTCAGGAGGCTAAGGCAGGAGAATCTCTTGAACCCGGGAGGCGGAGGTTGCAGTGAGCTGAGACTGCACCACTGCACTCCAGCCTGGGCAACAGAGCGAGACTCCATCTCAAATAAATAAACAAACAAACATAAGTTAGCTGGGCATGGTGGCCCACGCCTGTAATCCCAGCTACTTGGGAGGCTGAGGCAGGAGAATCTGGGAGGCAGAGGTTGCAGTGAGCCGAGATCTTGCCATTGCACTCCAGCCTGAGTGACAAGAGTGAAACTCTGTCTTAAAAAAAAAAAAAAAAAAA","GGCTGGGCGCAGTGGCTCACACCTGTAATCCCAGCACTTAGGGAAGCTGAGGCGAGTAGATCACCTGAGGTCAGGAGTTAGAGACCAGCCTGGCCATCATGGTGAAACCCCGTCTCTACTAAAGATACCAAAAATTAGCTGAGTGTGGTGCTGGGTGCCTGTAATCCCAGAAACTCAGGGTGCCTGTAATCCCAGCAACTCAGGGTGCCTTTAATCCCAGCAACTGAGGGTACCAGTAATCCCAGCAACTCAGGGTGTCTTTAATCCTAGCAACTGAGGGCACCTGTAATCCCAGCAACTCAGGAAGCTGAGACAGGAGAAGTACTTGAACCCAGAAGGCAGAGGTTGCAGTGAGCCGATATTGCACCATTGCACTCCAGTCTGGGCAACAAGAGTGAAACTCTGTCTCAAAAAAAAA"
"chr11","11622000","11622572","JH378118","18053084","18053501","239","6431084","CCAGGTGCGGTGGCTCATGCCTGTAATACCAACACTGTGGGAGGCCGAGGGGACCAGCCTGCCCAACATGGTGAAACCCCATCTCTACTAAAAACACACAAAAAAATTGTCTAGCTACGGTGGTTCACACCTGTAATTACAGCACTTTGGGAGGCCGATGCGGGCGGATCACTTGAGGTCAGGAGTTCAAGACCAGACTGGCCAACATGGTGAAACCCTATCTCTACTAAAACTACAAAAATTAGCCAGGAGTGGTGGTGGGTGCCTGTAATCCCAGCTACCTGGGAGGCTGAGGCAGAATCATTTGAACCCAGGAGGTAGAGGTTGCAGTGAGCTGAGATCACGCCACTACACTTCAGCCTGGGCGACAAGACTGAAACTCCACCTCAAAAAAAAAAAAGAAAAATTATCCAGGCTTGGTGGTGGGTGCCTGTAATCCCAGCTACTCAGGAGGTTGAGGCAGGAGAATTGCTTGAACCCGGGAGGCGGAGGCTGCAGTGAGACGAGATCGCGTCATTGCATTCCAGCCTGGGCAACAAGAGTGAGACTGTCTCAAAAAAAAAAAAAAAAAAA","GGCTGGGCGCAGTGGCTCACACCTGTAATCCCAGCACTTAGGGAAGCTGAGGCGAGTAGATCACCTGAGGTCAGGAGTTAGAGACCAGCCTGGCCATCATGGTGAAACCCCGTCTCTACTAAAGATACCAAAAATTAGCTGAGTGTGGTGCTGGGTGCCTGTAATCCCAGAAACTCAGGGTGCCTGTAATCCCAGCAACTCAGGGTGCCTTTAATCCCAGCAACTGAGGGTACCAGTAATCCCAGCAACTCAGGGTGTCTTTAATCCTAGCAACTGAGGGCACCTGTAATCCCAGCAACTCAGGAAGCTGAGACAGGAGAAGTACTTGAACCCAGAAGGCAGAGGTTGCAGTGAGCCGATATTGCACCATTGCACTCCAGTCTGGGCAACAAGAGTGAAACTCTGTCTCAAAAAAAAA"
"chr11","12627398","12627727","JH378131","6270391","6270710","41","6357007","GGCCAGGCATGGTGGCTCACGCCTGTAATCCCAGCACTTTGGGAGGCCGAGGCGGGTGGCTCACCTGAGGTCAGAAGTTCAAGACCAGCCTGGTCAACATGGTGAAACCCCGTCTCTACTAAATATACAAAAATTAGCTGGGCGTGATGGCGGGTGCCTGTAATCCCAGCTACTCAGGAGGCTAAGGCAGGAGAATCGCTTGAACCCAGGAGGCAGACAGAGGTTACAGTGAGCCGAGATTGCGCCATGGCGCTCCAGCCTGGGCAACAAGAGTGAAACTTCGTTCCAATAAATAAATAAATAAATAAATAAATAAGAAAAATGTAAAAA","GGCCGGGCATGGTGGCTCAAGCCTGTAATCCCAGCACTTTGGGAGGCCGAGGTGGGTGGATCATGAGGTCAAGAGATCAAGACCATACTGGTCAACATGGTGAAACCCCGTCTCTACTAAAAATACAAAAATTAGCTGGGCATGGTGGCGCATGCCTGTAATCCCAGCTACTCAGGAGGCTGAGGCAGGAGAATTGCCTGAACCCAGGAGGCGGACGTTGCGGTGAGCCGAGATCGCGCCATTGCACTCCAGCCTGGGTAACAAGAGCGAAACTCCTCCTCAAAAATAAATAAATAAATAAATAAATAAATAAATAAATA"
"chr11","17546249","17546884","JH378118","18053084","18053501","268","506835","GGCTGGGCATGGTGGCTCATGCCTGTAATCCCAGCACTTTGGGAGGCCGAGGTGGGTGGATCACCTGAGGTCAGGAGTTTGAGACCAGCCTGGCCAACATCGTGAAACCCCGTCTCTACTAAAAATACAAAAAAAAAAAAAAACAGCTGGGCATGGTGGCTTACGCCTGTAATACCAGCACTTTGGGAGGCCGAGGCAGGTGGATCACTTGAGGTCAGGAGTTCTAGACCAGCCTGGCCAACATGGTTCTCTTTAGTAGAGAACCTTGTCTCTACTAAAAATACAAACATTAGCCAAGTGTGGTGGCATATGCCTGTAATCCCAGCTACTCGGGAGGCTGAGGCAGAAGAATCTCTTGAACCCGGGAGATGGAGGTTGCAGTTAGCCCAGATTGCACCACTGCACTCCAGCTTGGGTCAAAGAGCGAAATTCCGTTTCAAAAAAAATTGCAAAAAAACTAGCCGTGCGTGGTGGCAGGTGCCTGTAATCCCAACTACTTGGGAGGCTGAGGCAGGAGAATCACTTGAACCCAGGAGACAGAGCTTGCCGTGAGCCAAGATCATGCCATTGCACTCCAGCCTAGGCAACAAGAGTGAAACTCCATTTCAAAAAAATAAAAAATAAATAAAATAAAAA","GGCTGGGCGCAGTGGCTCACACCTGTAATCCCAGCACTTAGGGAAGCTGAGGCGAGTAGATCACCTGAGGTCAGGAGTTAGAGACCAGCCTGGCCATCATGGTGAAACCCCGTCTCTACTAAAGATACCAAAAATTAGCTGAGTGTGGTGCTGGGTGCCTGTAATCCCAGAAACTCAGGGTGCCTGTAATCCCAGCAACTCAGGGTGCCTTTAATCCCAGCAACTGAGGGTACCAGTAATCCCAGCAACTCAGGGTGTCTTTAATCCTAGCAACTGAGGGCACCTGTAATCCCAGCAACTCAGGAAGCTGAGACAGGAGAAGTACTTGAACCCAGAAGGCAGAGGTTGCAGTGAGCCGATATTGCACCATTGCACTCCAGTCTGGGCAACAAGAGTGAAACTCTGTCTCAAAAAAAAA"
"chr11","18649430","18649768","JH378228","5665092","5665424","55","12984338","GCTGGGCATGGTGGTTTACGCCTGTAATCTCAGCACTTTGGGAGGCGGAGATGGGTGGATCACCTGAGGTCAGGAGTTTGAGACCAGCCTGGCCAACATGGTGAAACCCTGTCTCTACTAAAAATACAAAAATTAGCCGGGCGTGTTGGCATGTGCCTGTAATCCCAGCTATTGGAGAGGCTGAGGCAGGAGAATCGCTTGAACCCAGGAGGTGGAGGTTGCAGTGAGCCAAGATCACGCCATTGCACTCCAGCCTGGGCAGCAAGAGTAAGACTCCGTCCCCCCCAAAAAAATCAATCAATCAATCAATCAATCAATAAAATAAAATAAATAAAAAAA","GGCCGGGCGCGGTGGCTCAAGCCTGTAATCCCAGCACTTTGGGAGGCTGAGGCGGGTGGATCACGAGGTCAAGAGATCGAGACCATCCTGGTCAACATGGTGAAACCCTGTCTCTACTAAAAATACTAAAAATTAGCTGGGCATGGTGGCGTGTGCCTGTAATCCCAGCTACTCAGGAGGCTGAGGCAGGAGAATTGCCTGAACCCAGGAGGCGGAGGTTGCGGTGAGCCGAGATCGCGCCATTGCACTCCAGCCTGGGCAACAAGAGCGAAACTCTGTCTCAAAAAAAAAAAATAAATAAATAAAATAAAATAAAATAAAATAAAATAAAAT"
"chr11","18825092","18825718","JH378118","18053084","18053501","269","772008","GGTCGGGCGTGGTGGCTCACGCCTGTAATCCCAGCACTTTGGGAGGCCAAGGCGTGAGGATCACTTGAGGTCAGGAGTTCGAGACCAGCCTGGCCAACATGGTGAAACCCGGTCTGTACCAAAAATAGAAAAATTAGCCGGGCGCGGTGGCTCACGCCTGTAATCCCAGCACTCTGGGAGGCAGAGGTGGGTGGATCACGAGGTAAGGAGTTTGAGACCAACCTGGCCAACATGGTGAAACCCTATCTCTACTAAAGATACAAAAAATTAGCTGGGCATGGTGGTGCACGCCTGTAATCCCAGCTACTCGGGAGGCTGAGGCAGGAGAATCGCTTGAATCTGGGAGGCAGAGGTTGCAGCGAGCTAAGATCGCGCCACTGCACTCCAGCCTGGGTGACAGAGCGAGACTGTCTCAAAAAAAAAAAAAAAAAAAAGAAAAAAGAAAAATTAGCTGGGCATGATGGTGCGCTCATGTAATCCCGGCTACTCGGGAAGCTGAGGCAGGAGAATCGCTTGAACCCGGGAGGTGGAGGTTACAGTGAGCCGAGATCTCGCCGTTGCACTCCAGCCTGGGCAACAAAAGCGAAACTCCGTCTCAAAAAAAAAAAAAAAAAGAAAAGAAAGAAA","GGCTGGGCGCAGTGGCTCACACCTGTAATCCCAGCACTTAGGGAAGCTGAGGCGAGTAGATCACCTGAGGTCAGGAGTTAGAGACCAGCCTGGCCATCATGGTGAAACCCCGTCTCTACTAAAGATACCAAAAATTAGCTGAGTGTGGTGCTGGGTGCCTGTAATCCCAGAAACTCAGGGTGCCTGTAATCCCAGCAACTCAGGGTGCCTTTAATCCCAGCAACTGAGGGTACCAGTAATCCCAGCAACTCAGGGTGTCTTTAATCCTAGCAACTGAGGGCACCTGTAATCCCAGCAACTCAGGAAGCTGAGACAGGAGAAGTACTTGAACCCAGAAGGCAGAGGTTGCAGTGAGCCGATATTGCACCATTGCACTCCAGTCTGGGCAACAAGAGTGAAACTCTGTCTCAAAAAAAAA"
"chr11","19020087","19020410","JH378110","12773123","12773444","44","6246964","GGCCAGGTGCAGTGGCTCATGCCCATAATCCCAGCACTTTGGGAGGCTGAAGCAGGTGGAGTTCTGAGGTCAGGAGTTCAAGACCAGCCTGGCCAACGTGATGAAACCCTGTCTCTACTAAATATACAAAAAAAAAAAAAAAAAAAAAAAAAGCCGGGTGTGGTGGTGGGCACCTGTAATCCCAGCTACTTGGGAGGCTGAGGCAGGAGAATCACTGGAACCCAGGAGGTGGAGGTTGCAGTGAGCTGAGATTGTGCCATTCCACTCCAGCCTGGGCAACAAGAGCGAAACTCCGTCTCAAAAAAAAAAAAAAAAGAAAAGAAA","GGCTGGGCGTGGTGGCTCATGCCTATAATCCCAGCACTTGGAGAGGCCAAAGCAGGCAGATTATTTGAGGTCAGGAGTTCCAAACCAGCCTGGCCAACATGGTGAAACCCTGTATCTACTAAAAATGCAAAAAAAAAAAAAAAAAAAAAAATTAGCTGGGCGTGGTGGCAGGTGACTGTATCCCAGTACTTGGTAGGCTGAGGCAGGAGAATTGCTTGAACCTGGGAGGTGGAGGTTGCAGTGAGCTGAGATTGTGCCATTGCACTCCAGCCTGGGCAACAAGAGCAAAACTCTGTCTCAAAAAAAAAAAAAAAAAAAAAAA"
"chr11","20392907","20393494","JH378119","32351107","32351490","254","11958200","GGCTGGGTGTGGTGGCTCAGGCTTGTAATCCCTGCACATTGGGAGGCCGAGGCAGGTGGATCACCTGAGGTCAGGAGTTCGAGACCAGCCTGGCCAACACATGGTGAAAACCCGTCTCTACTAAAAAAAAAAAAATACAGGGCCGGGCGCGGTGGCTCGCACCTGTAATCCCAGCACTCTGGGAGGCCGAGGCGGGCGGATCACTAGGTCAGGAGATCGAGACCATCCTGGCTAACACAATGAAACCCCGTCTCTACTAAAAATATAAAAAATTAGCTGGGCGTGGTGGTGGGCACCTGTAGTCCCAGCTACTTGGGAAGCTGAGGCAGGAGAATGGCGTGAACCCGGGAGGCGGAGCTTGCAGTGAGCCAAGATTCTGCCACTGCACTCCAGCCTGGGCGACAGAGCGAGACTCCGTCTCAAAAAAAAAAAAAAAGTACAAAAACTAGCTGGGCGCGGTGGTGGGTGCCTGTAATCCCAGCTACTCGGCAGGCTAAGGCAAGAGAATCGCTTGAACCCGGGAGGCGGAGGTTGCCGTGAGCCATTGCACTCCAGCCTGGGTGACAAGAAAAAAAAAAAATACAGAAA","GGCCAGGTATGGTGGCTCACACCTGTAATCCCAGCACTTTGGGAGGCCAAGGCAGGCAGACCACCTGAGGTCAGGAGTTCGAGATCAGCCTAGCCAACATGGTGAAACCCCATCTCTAGTAAAAATAAAATTAGCCAGGCATGGTGGTGCATGCCTGTAACGCAGGTCAGGAGTTCGAGATCAGCTTAGCCAACATGGTGAAACCCCATCTCTAGTAAAAATAAAATTAGCCAGGCAGGTGGTGCCGCCTGTACTCGGGAGGCTGAGGCAGGAGAATCACTTGAACCCAAGAGGCAGAGGTTGCAGTCAGCCAAGATCATGCCATTGCACTCCAGCCTAAGCAAAAAGAGTAAAACTCAGTCTCAAAACAAAAAAACAAAAAAA"
"chr11","23389112","23389708","JH378118","18053084","18053501","245","5336028","GCCAGGAGTGGTGGGTCACACCTGTAATCCCAGCACTTTGGGAGGCTGAGGTGGGTGGATCACCTGAGGTCAGGAGTTCAAGACCAGCCTGGCCAATATGGTGAAACCTCGTCTCTACTAAAAATACAAAAATTACAGGCCGGGCGCAGTGGCTCACACCTGTAATCTCAGCACTTAGGGAGGCAGAAGCAGGCAGATCATGAGGTCAGGAGATGGAGACCATCCTGGCTAACACGGTGAAACCCCATCTCTACTAAAAATACAAAAAATTAGCTGGGCGTGGCAGCACACGCCTGTAATCCCAGCTACTTGGGAGGCTGAGGCAGGAGAATCGTTTGAACCCAGGAGGCAGAGTTTGCAGTGAGCCGAGATCACACCACTGCACTCCAGCCTGGGTGACAGAGTGAGACTCCGTCTCAAAAAAACAAAACAAAACAAAAAATTAGCTGGGGCATGGTAGCAGTCACCTGTAATCCCAGCTACTCTGGAGGCTGAGGCAGGAGAATGGCTTGAACCCAGGAGGCAGAGGTTGCAGTGAGCTGAGATCACGCCATTGCACTCCAGCCTGGGTGACAAGAGTGAAACTCCATCTAAAAA","GGCTGGGCGCAGTGGCTCACACCTGTAATCCCAGCACTTAGGGAAGCTGAGGCGAGTAGATCACCTGAGGTCAGGAGTTAGAGACCAGCCTGGCCATCATGGTGAAACCCCGTCTCTACTAAAGATACCAAAAATTAGCTGAGTGTGGTGCTGGGTGCCTGTAATCCCAGAAACTCAGGGTGCCTGTAATCCCAGCAACTCAGGGTGCCTTTAATCCCAGCAACTGAGGGTACCAGTAATCCCAGCAACTCAGGGTGTCTTTAATCCTAGCAACTGAGGGCACCTGTAATCCCAGCAACTCAGGAAGCTGAGACAGGAGAAGTACTTGAACCCAGAAGGCAGAGGTTGCAGTGAGCCGATATTGCACCATTGCACTCCAGTCTGGGCAACAAGAGTGAAACTCTGTCTCAAAAAAAAA"
"chr11","38739012","38739370","JH378108","45564157","45564495","72","6825145","GCCAGGCATGGTGGCTCATGCTTGTAATTGCAGCACTTTGGGAGGCCAAGGCAGGTGGATCACCTGAGGTCAGGAGTTGGAGACCAGCCTGACCAATATGGTAAAACTCCATCTCTACTAAAAATACTAAAAATTAGCCAGACATGGTGGCAGATGCCTGTAATCCCACTACTCGGGAGGCTGTAGCAGGAGAATTGCTTGAACCCAGGAGGTAGAGGTTGCTGTGAGCTGAGATCGCACCATTGCACTTCAGCACGGGCAACAAGAGCAAAACTCCACATATTAAGAAAGAGAGAGAGAGAGGAGAGAGAGAGAGAGAGAGGAGAGAGAGAGAGAAAGAAAGAAAGAAAGAAAAGAAA","GCTAGGCAAGGTGGCTCATGCCTGTAATCCCAACATTTTGGGAGGCCGAGGCAGATGGATCACCTGAGGTTAGGAGTTCAAGACCAGCCTGGCCAACATGGTGAAACTCCATCTCTACTAAAAATACAAAAAATTAGCTTGGCACGGTGGTGGGTGCCTCTAATCCCAGCTGCTTGGGAGGCTGAGGCAGGAGAATCGCTTGAACTCAGGAGGTGGAGGTTGCAGTGAGCCAAGATCATGGCATTGCACTCCAGCCTGGGCGACAAGAGCGAGACTCCCTCTAAGAAAGAAAAGAAAGAAAAGAAAAGAAAAAAGGAAAGGAAAGGAAAGAAAGAGAAA"
"chr11","48382895","48383246","JH378293","1845184","1845523","57","46537711","GGCTGGGCGCGGTGGCTCATGCCTGTAATCTCAGCACTTTGGGAGGCCAAGGTGGGTGGATTACCTGAGGTCAGGAGTTCGAGACCAGCCTGGACAACATGGTGAAACCCCATCTCTACCAAAACTACAATGAATAAATAAATAAATAAATAAATAAATAAATAAATAAACAAATAAATAAATAAATGAAATAGCCAGGTGTGGTGGCGGGCACCTGTAATCCCAGCTACTTGGGAGGCTGAGGTAGGAGAATCACTTGAACCTGGGAGGCAGAGGTTGCAGTGAGCCGAGATTGTGCCATTGCATCCCAGCCTGGGCAACAAGAGGGAAACTCCACCTCAAAAAAAAAAAA","GGCCGGGTGCGGTGGCTCACGCCTGTAATCCCAGCACTTTGGGAGGCCAAGGCGGGTGGATCACCTGAGGTCAGAAGTTCGAGACCAGCCTGGCCAACATGGTGAAACCCCGTCTCTGCTAAAAAGAAAAAAATAAGAAAAAAACAAAATAAGAAAATAATTTTAAAAAATACAAAATTAGCTGGGCGTGGTGGCAGGCACCTGTAATTCCAGCTATTCAGGAGGCTGAGGCAGGGGAATCACTTGAACCCAGGAGGCAGAGGTTGCAGTGAGCCAAGATGACGCCATTGCACACCAGCCTGGGCAACAAGAGTGAAACTCCGTCTCAAAAAAAAAACAA"
"chr11","55503997","55504328","JH378199","2310278","2310612","50","53193719","GGCCGGGCATGGTAGCTCATGCCTGTAATCACAGCACTTTGGGAGGCCGAGGCGGGCAGATCACCTGAGGTCAGGAGTTTGAGACCAGCCTGGCCAACATGGTTAAACACCATCTCTACTAAAAATACAAAAAAAAAAAAAAAAAAAAAAAAAAAAAAAAAGCCAGGTGTGGTGGCAGGCATCTGTAATCCCAGCTACTCAGGAGGCTGAGGCAGGAGCATCACTTGAACCCGGCAGGCAGAGGGTGCAGTGAGCCGAGATTGTGCCAAAGCACTCCAGCCTGGGCAACAAGAGTGAAACCCCATCTCAAAATAAATAAATAAATAAATAAA","GCCGAGCGCGGTGCTCATGCCTGTAATCCCAGCACTTTGAAAGGCCGAGGTGGGCAGATCATCTGAGGCCAGGAGTTTGAGAGCAGCCTGGCCAACATGGTGAAACCCCGTCTCTACTAAAAATACAAAAAAAAAAAAAAAAAAAAAAAAAAAAAAAATAGCCAGATGTGGTGGCCTGTGCCTGTAATCCCAGCTACTTGGGAGGCTGAGGCAGGAGAATCGCTTGAACCCTGGGAGGCAGAGGCTGCAGTGAGCCAAGATTGCATCATTGCACTCCAGCCTGAGCAACAAGGGCAAAACTCCATTTCAAACAAAACAAAACAAAACAAAACAAA"
"chr11","57615144","57615732","JH378119","32351107","32351490","251","25264037","GCCGGGCGTGGTGGCTCAGACCTGTAATCTCAGCACTTTGGGAGTTCGAGACCAGCCTGACAAACACAGTGAAACCCCGTCTCTACTGAAAATACAAAATTAGGGCTGGGTGCAGTGGCTCATGACTGTAATCCCAGCACTCTGGGAGGCCAAGGTGGGCGGATCCACCTGAGGTCGGGAGCTCGAGACCAGCCTGGCCAACACAGCGAAACCCTGTCTCTACTAAAAATTATAAAAATTAGCCAGGCATTGTGGCATGTGCTTGTAATTCCAGCTACTAGGGAGGCTGCGGCAGGAGAATCGCTTGAATCCGGGAGGCGGAAGAAGCAGTGAGCCAAGATCACGCCACTGCACTCCAGCCTGGGAAACAGAGCGAGACTCCGTCTCAAAAAAAAAAAAAAAAAAAAAAAAAAAAATTAGCCAGGTGTGGTGGCGAATGCCTGTAATCCCAGCTACTTGGGAGGCTGAGGCAGGAGAATCACTTGAACTCAGGAGGCAGAGGTTGCAGTGAGTCAAGATCGTGCCATTGCACTCCAGCCTGGGCAATAAGAGCAAAACTCCATTTTAAACAAACAAACAAATAAATAAA","GGCCAGGTATGGTGGCTCACACCTGTAATCCCAGCACTTTGGGAGGCCAAGGCAGGCAGACCACCTGAGGTCAGGAGTTCGAGATCAGCCTAGCCAACATGGTGAAACCCCATCTCTAGTAAAAATAAAATTAGCCAGGCATGGTGGTGCATGCCTGTAACGCAGGTCAGGAGTTCGAGATCAGCTTAGCCAACATGGTGAAACCCCATCTCTAGTAAAAATAAAATTAGCCAGGCAGGTGGTGCCGCCTGTACTCGGGAGGCTGAGGCAGGAGAATCACTTGAACCCAAGAGGCAGAGGTTGCAGTCAGCCAAGATCATGCCATTGCACTCCAGCCTAAGCAAAAAGAGTAAAACTCAGTCTCAAAACAAAAAAACAAAAAAA"
"chr11","57798441","57799028","JH378118","18053084","18053501","249","39745357","GGCAGGGCACAGTGGCTAACCCCTGTAATCCCAGCACTTTGGGAGGGCGAGGTGGTTGGATCACCTGAGGTGAGGAGTTCAAGACCAGTTTGAAACCCCGTCTCTACTAAAAGTACAAAAAATTAGCTGGGTGTGGCCGGGTGCGGTGGCTCATGCCTGTAATCCCAGCACTTTGGGAGGCCGAGGCGGGCAGATGACGAGGTCGGGAGATCAAGACCATCGTGGCTAACACGGTGAAACCCCGTCTCTACTAAAAATACAAAAAATTAGCCGGGCGTGGTGGCGGGTGCCTGTAGTCCCAGCTATTCAGGAGGCTGAGGCAGGAGAATGGTGTGAACCCGGGAGGCGGAGCTTGCATTGAGCCGAGATCTCGACACTGCACTCCAGCCTGGGCGACAGAGCAAGACTCCGTCTCAAAAAAAAAAAAAAAATAGCTGGGCGTGGTGGGGGGCGCCTGTAATCCCAGCTACCCAGGAGGCTGAGGCAGGAGAATCGCTTGAACCAAGGAGGCAGAGGTTCCAGTGAGCTGAGATCCTGCCATTGCACTCCAGCCAGGGCAACAAGTGTGAAACTCCGTCTCAAAAAAAA","GGCTGGGCGCAGTGGCTCACACCTGTAATCCCAGCACTTAGGGAAGCTGAGGCGAGTAGATCACCTGAGGTCAGGAGTTAGAGACCAGCCTGGCCATCATGGTGAAACCCCGTCTCTACTAAAGATACCAAAAATTAGCTGAGTGTGGTGCTGGGTGCCTGTAATCCCAGAAACTCAGGGTGCCTGTAATCCCAGCAACTCAGGGTGCCTTTAATCCCAGCAACTGAGGGTACCAGTAATCCCAGCAACTCAGGGTGTCTTTAATCCTAGCAACTGAGGGCACCTGTAATCCCAGCAACTCAGGAAGCTGAGACAGGAGAAGTACTTGAACCCAGAAGGCAGAGGTTGCAGTGAGCCGATATTGCACCATTGCACTCCAGTCTGGGCAACAAGAGTGAAACTCTGTCTCAAAAAAAAA"
"chr11","57837769","57838681","JH378118","18053084","18053501","527","39784685","GACCAGGAGCAGTGGCTCACACCTGTAATTCCAGCACTTTGGGAGGTCAAGGCAAGCACATTGCTAGAGGCCCAAAGTTACAGACCAGCCTGACCAACATAGCGAAACCCCGTCTCCACTAAAAATTTAAAAATTAGGCCAGGCGTGGTGGCTCATGCCTGTAATCCTAGCACTTCCGGAGGCCAAGGTGGGTGGATCACCTGAGGTCAGGAGTTTGAGACCAGCCTGGCCAACATGGCAAAACCCGTGTCTACTAAAAATACAAAAATTAGCTGGGTGTGGTGGCATGCACATGTAATCCCAGCTACTCGGGAGGCCGAGGCAGGAGAATTGCTCAAACCCCGGAAGCAAAGGTTGTAGTTAGCGAAGATCCCGCCACTGCACTCCAGCCTGGGTGACAGAGCGAGATTCCCTCTCAAAAAAAAAAAAAAAAAAAAAAAAAAAAGGCCCAGCATGGTGGCTCACTCCTGTAATCCCAGCACTTTGGGAGGCCTAGGTGGACGGATAACAAGGTCAGGAGTTCGAGACCAGCCTGACCAACATGGTGAAACCCCCGTCTCTACTAAAAATACAAAAATTAGCCGGTTGTGGTGGCGAGCACCTGTAATCCCAGTTATTCAGGAGGCTGAGGCAGGGGAATCGCTTGAACCCAGGAGATGGGGGTTACAGTGAACCGAGATCATGCTACTGCACTCCAGCCTGGGTGACAGAGCGAGACTCCATCTCAAAAAAAAAAAAAAAAAAATTAGCTGGGCGTGGTGGCGGGCGCCTGTAATCCCAGCTACCCAGTAGGCTGAGGCACGAGAGTTACTTGAACCTGGGAGGCGGAGGTTGCAGTGAGCTGAGATCGTACCATTGCACTCCAGCCTGGGCGACAAGAGCGAAACTCTGTCTAAATAAATAAATAAATAAA","GGCTGGGCGCAGTGGCTCACACCTGTAATCCCAGCACTTAGGGAAGCTGAGGCGAGTAGATCACCTGAGGTCAGGAGTTAGAGACCAGCCTGGCCATCATGGTGAAACCCCGTCTCTACTAAAGATACCAAAAATTAGCTGAGTGTGGTGCTGGGTGCCTGTAATCCCAGAAACTCAGGGTGCCTGTAATCCCAGCAACTCAGGGTGCCTTTAATCCCAGCAACTGAGGGTACCAGTAATCCCAGCAACTCAGGGTGTCTTTAATCCTAGCAACTGAGGGCACCTGTAATCCCAGCAACTCAGGAAGCTGAGACAGGAGAAGTACTTGAACCCAGAAGGCAGAGGTTGCAGTGAGCCGATATTGCACCATTGCACTCCAGTCTGGGCAACAAGAGTGAAACTCTGTCTCAAAAAAAAA"
"chr11","57857685","57858268","JH378118","18053084","18053501","238","39804601","GCCAGGTGTGGTGGCTCTTACCTGTAATTCCAGCACTTTGGGAGGCCGAGGCAGGTGAATCACCTGAGGTCAGGAGTTCAAGACCAGCCTGGCCAACATCGTAAAACCCCGTTTCTACTAAAAATACAAAAATTGGCCGGCACAGTGGCTCATGCCTGTAATCCCAGCACTTTGGAAGGCCGAGGCAAGTGGATCACGAGGTCAGGAGTTCAAGACCAGCCTAATATGGTGAAACTCTGTCTCTAGTACAAAATACAAAAATTAGCTGGGCCTAGTGGCGTGCACCTGTAGTCCCAGCTACTTGGGAGGCCAAGGCAGGATAATTGCTTGAACCCGGGAGGCAGAGGTTGCAGTGAGCCAAGACTGCGCCACTGCACTCCAGCCTAGGCGACAGAGTGAGACTCCGTCTCAAAAAAACAAATTATCCAGGCATGGTGACGGGTATCTGTAATCCCAGCTACTCAAGAGGCTGAGGAAGGAGAATGGCCTGAACCCGGGAGGCAGTGGTTGCAGTAAGCCGAGATCGTGCCATTGCACTCCAGCATAAGCAACATGGCGAAACTCCATCTCAAAAAAAAAAAAAA","GGCTGGGCGCAGTGGCTCACACCTGTAATCCCAGCACTTAGGGAAGCTGAGGCGAGTAGATCACCTGAGGTCAGGAGTTAGAGACCAGCCTGGCCATCATGGTGAAACCCCGTCTCTACTAAAGATACCAAAAATTAGCTGAGTGTGGTGCTGGGTGCCTGTAATCCCAGAAACTCAGGGTGCCTGTAATCCCAGCAACTCAGGGTGCCTTTAATCCCAGCAACTGAGGGTACCAGTAATCCCAGCAACTCAGGGTGTCTTTAATCCTAGCAACTGAGGGCACCTGTAATCCCAGCAACTCAGGAAGCTGAGACAGGAGAAGTACTTGAACCCAGAAGGCAGAGGTTGCAGTGAGCCGATATTGCACCATTGCACTCCAGTCTGGGCAACAAGAGTGAAACTCTGTCTCAAAAAAAAA"
"chr11","65232192","65232563","JH378208","3925639","3925977","73","61306553","GGCCGGGCGCGGTGGCTCACGCCTGTAATCCCAGCACTTTGGGAGGCCGAGGCAGGCAGATCACCTGAGGCCAGGAGTTCAAGAACAGCCTGGCCAACATGGCGAAACCCCGTCTCTACTGAAAACACACACAAAAAATTAGCCAGGCATGGTGGCCGGTGCCTGTAATCCCAGCTACTGGGGAGGCTGAGGCTGGAGAATCACTTGAAACCAGAAGGTGGAGGCTGCAGTGAGCTGAGACTGCGCCATTGCACTCTAGCTTGGGCAACAAGAGCGAAACTCCATTTCAAAATAGAATAGAATAGAATAGAATAGAATAGAATAGAATAGAATAGAATAGAATAGAATAGAATAAAATAAAATTTTAAAAAA","GGCCGGGCGCGGTGGCTCAAGCCTGTAATCCCAGCACTTTGGGAGGCCGAGGCGGGTGGATCACGAGGTCAAGAGATCGAGACCATCCTGGTCAACATGGTGAAACCCCGTCTCTACTAAAAAAAATACTAAAAAATTAGCTGGGCATGGTGGCGTGTGCCTGTAATCCCAGCTACTCAGGAGGCTGAGGCAGGAGAATTGCCTGAACCCAGGAGGCGGAGGTTGTGGTGAGCCGAGATCGCGCCATTGCACTCCAGCCTGGGCAACAAGAGCGAAACGCCATCTCAAAAAAAATAAATAAATAAATAATAAATAAATAAATAAAAAATAAAAAATAAA"
"chr11","65619638","65620241","JH378118","18053084","18053501","242","47566554","GGCTGGGCGCGGTGGTTCACAGTTGTAATCCCAGCACTTTGGGAGGCTGACATGGGTGGATCACCTGAGGTCAGGAGTTCAAGACCAGCCTGGCCAACATGGTGAAACCCCGTCTCTACTTAAAATACAAAAATTAGGGCTGGGCATGGTGGCTCACGCCTGTAATCCCAGCACTTTGGGAGGCTGAGGCAGGTGGATCACAAGGCCAGGAGATCGAGACCATCCTGGCTAACACGGTGAAACCCTGTCTCTACTAAAAATACAAAAATTTAGCTGGGCGTGGTGGCATGTGTCTGTAGTCCCAACTACTCGGGAGGCCGAGGCAGGAGAATTGCTTGAACCCAGGAGGTGGAGGTTGCAGTGAGCCAAGATTGTGCCATTGCACTCCAGCCTGGGTGACAGAGTGAGACTCCGTCTAAAAAAAAAAATTAGCTGGGAGTGGTGGCAGGCACCTGTAACCCCAGCTACTTGGGAGGCTGAGGCAGGAGAATTGAGAATTGCTTGCACCTGGGAGGTGGAGGTTGCAGTGAGCCAAGATCGTGCCATTGCACTCCAGCCTGGGCAACAAGAGTGAAACTCTGTCTCAAAAAAAAAAAGCAAAAAA","GGCTGGGCGCAGTGGCTCACACCTGTAATCCCAGCACTTAGGGAAGCTGAGGCGAGTAGATCACCTGAGGTCAGGAGTTAGAGACCAGCCTGGCCATCATGGTGAAACCCCGTCTCTACTAAAGATACCAAAAATTAGCTGAGTGTGGTGCTGGGTGCCTGTAATCCCAGAAACTCAGGGTGCCTGTAATCCCAGCAACTCAGGGTGCCTTTAATCCCAGCAACTGAGGGTACCAGTAATCCCAGCAACTCAGGGTGTCTTTAATCCTAGCAACTGAGGGCACCTGTAATCCCAGCAACTCAGGAAGCTGAGACAGGAGAAGTACTTGAACCCAGAAGGCAGAGGTTGCAGTGAGCCGATATTGCACCATTGCACTCCAGTCTGGGCAACAAGAGTGAAACTCTGTCTCAAAAAAAAA"
"chr11","68213932","68214556","JH378118","18053084","18053501","258","50160848","CTGGGCGCAGTGGCTCATGCCTGTAATCCCAGCACTTTGGGAGGCTGAGCCGGGTGGATCATGTGAGGTCGGGAGTTCGAGACCAGCCTGGCCAACATGGCGAAACCCCGTCTCTACTAAAAATACAAAAAATTGGGCCAGGTGCAGTGGCTTACGCCTGTAATCCCAGCACTTTGGGAGGCCGAGGCGGCAGATCATGTGAGGTCAGGGGTTTGAGATGAGCCTGGCCAACATGGGGAAACCCAGTCTCTACTAAAAATACAAAAAAAATTAGCCCGGCGTGGTGACAGGCGCCTGTAATCCCAGCTACTCGGGAGGCTGAGGTAGGAGAATCGCTCAAATCCAGGAGCTGGATGTTGCAGTGAGCCGAGATCGCGCCATTGCACTCAACCCAGCCTGGGCGACAGAGCGAGACTCTGTCTCAAAACAAAAACAAAAACAAACCCAAAAAAATTTAGCCAGGCATTGTGGCAGGCACCTATAATCCCAGCTACTCAGGAGGCTGAGGCAGGAGAATCACTTTAACCCAGGAGGCAGAAGTTGCAGTGAGCCGAGATTGTGCCATTGCACTGCAGCCTGGGCAACAAGAGTGAAACTCCATCTCAAAAAAAAAAAAAAAGATAAA","GGCTGGGCGCAGTGGCTCACACCTGTAATCCCAGCACTTAGGGAAGCTGAGGCGAGTAGATCACCTGAGGTCAGGAGTTAGAGACCAGCCTGGCCATCATGGTGAAACCCCGTCTCTACTAAAGATACCAAAAATTAGCTGAGTGTGGTGCTGGGTGCCTGTAATCCCAGAAACTCAGGGTGCCTGTAATCCCAGCAACTCAGGGTGCCTTTAATCCCAGCAACTGAGGGTACCAGTAATCCCAGCAACTCAGGGTGTCTTTAATCCTAGCAACTGAGGGCACCTGTAATCCCAGCAACTCAGGAAGCTGAGACAGGAGAAGTACTTGAACCCAGAAGGCAGAGGTTGCAGTGAGCCGATATTGCACCATTGCACTCCAGTCTGGGCAACAAGAGTGAAACTCTGTCTCAAAAAAAAA"
"chr11","69780748","69781383","JH378118","18053084","18053501","278","51727664","GGCCAGGTGCTGCAGTGGCTCACGCCTATAATCCCAGTACTTTGGAAGGCAGAGGCAGGCAGATCACCTGAGGTCAGGAGTTCAAGACCAGCCTGGCCAACACGGTGAAACCCTGCTTCTTTGTTTCTTTTTTTTCTTTTTTTTTTTGAGACGGACTCTTGCACTGTCACCCCAGGCTGGTGTGCAACGGCATGATCTCAGCTTGCTGCAACCTCTGCTTCCCGGGTTCCAGTGATTTTCCTGCCTCAGCCTCCCGAGTAGCTAGGATTACAGGCGCCCGCCACCATGCCAGGATAATTTTTTGTATTTTTAGTAGAGATGAGGTTTCACTATGTTGGCCAGGCTGGTCTCGAATCCTGACCTCATGATCTGCCCAACTCAGCCTCCCAAAGTGCTGGGATTACAGGCGTGAGCCACTGTGCCCGGCCATGAAACCCTGTTTCTACTAAAAATACAAAAAACCTAGCTGGGCATGGTGGTGGGCACCTGTAATCCCAGCTACTCAGGAGGGTGAGACAGGAGAATCTCTTGAACCCAGGAGGCGGAGGTTGCAGTGAGCCGAGATTGCACCTTTGCACTCCAGCCTGGGTGACAACAGCGAGACTCCATCTCAAAATAAACAAACAAGCAAACAAA","GGCTGGGCGCAGTGGCTCACACCTGTAATCCCAGCACTTAGGGAAGCTGAGGCGAGTAGATCACCTGAGGTCAGGAGTTAGAGACCAGCCTGGCCATCATGGTGAAACCCCGTCTCTACTAAAGATACCAAAAATTAGCTGAGTGTGGTGCTGGGTGCCTGTAATCCCAGAAACTCAGGGTGCCTGTAATCCCAGCAACTCAGGGTGCCTTTAATCCCAGCAACTGAGGGTACCAGTAATCCCAGCAACTCAGGGTGTCTTTAATCCTAGCAACTGAGGGCACCTGTAATCCCAGCAACTCAGGAAGCTGAGACAGGAGAAGTACTTGAACCCAGAAGGCAGAGGTTGCAGTGAGCCGATATTGCACCATTGCACTCCAGTCTGGGCAACAAGAGTGAAACTCTGTCTCAAAAAAAAA"
"chr11","75178486","75179106","JH378118","18053084","18053501","261","57125402","GCCGGGCATGGTGGCTCATGCTTGTAATCCCAGCACTTTGGGAGGCAGAGGCAGGTGGATCACCTGAGGTCAGGAGTTTGAGACCAGCCTGGCCAACATGGTGAAACCCTGTCTCTACTAAAAATACAAAAGTTGCCAGGTGTGGTGGCTCACGCCTATAATCCCAGCACTTTGGGAGGCTGAGGCGGGTGGATCATTTGAGGTCAGGAGTTTGACAGACCAGCCTGGCCAACATGGTGAGACCCTATCTCTACTAAATATACAAAAATTAGCTGGGAGTGGTGGGTGCCTGTAATCCCAACTACTTGGAAGGGTGAGGCAGGAGAACTGCTTGAACCTGGAGACGGAGGCTGCAGTGAGCTGCGATCATGCCACTGCACTTCAGCCTGGGCGACAGAGTGAGACTCTGTCTCAAAAAAAAAAAAAAAAAAAAAAAAAAAGTTAGCTGAGCATGGTGGCGGGCACCTGTAATCCCAGACATTAGGGAGGCTGAGGCAGGAGAATTGCTTGACCCTGGGAGGCAGAGGTTGCAATGAGCCGAGATTGCGCCATTGCACTCCAGCCAGGGCAACAAGAGCAAAACTCTGTCTCAAAAAAAACAAAAACAAAAACAAAAACAAA","GGCTGGGCGCAGTGGCTCACACCTGTAATCCCAGCACTTAGGGAAGCTGAGGCGAGTAGATCACCTGAGGTCAGGAGTTAGAGACCAGCCTGGCCATCATGGTGAAACCCCGTCTCTACTAAAGATACCAAAAATTAGCTGAGTGTGGTGCTGGGTGCCTGTAATCCCAGAAACTCAGGGTGCCTGTAATCCCAGCAACTCAGGGTGCCTTTAATCCCAGCAACTGAGGGTACCAGTAATCCCAGCAACTCAGGGTGTCTTTAATCCTAGCAACTGAGGGCACCTGTAATCCCAGCAACTCAGGAAGCTGAGACAGGAGAAGTACTTGAACCCAGAAGGCAGAGGTTGCAGTGAGCCGATATTGCACCATTGCACTCCAGTCTGGGCAACAAGAGTGAAACTCTGTCTCAAAAAAAAA"
"chr11","77801464","77802082","JH378118","18053084","18053501","268","59748380","GGCCAGGCACGCTGGTTCACGCCTGTAATCCCTGCACTTTGGGAGACCGAGGCGAGTGGATCACCTGAGGTCAGGAGTTCGAGACCAGCCTGGCCAACGTGGTGAAATCCTGTCTTTACTAAAAAATAAGCCGAGGCTCGGCATGGTGGCTCACGCCTGTAATCCCAGCACTTTGGGAGGCCAAGGCGGGTGGATCACGAGGGCAGGAGATAGAGACCATCCCGGCTAACACGGTGAAACCCCGTCTCTACTAAAAATACAAAAAAATTAGCCAGGCGTGGTGGCAGAAGCCTGTAGTCCCAGCTACTTGGGAGGCTGAGGCAGGAGAATGCTGTGAACCCAGGAGGCGGAGCTTGCAGTGAGCCGAAATCGCACCACTGCACTCCAGCCTGGGTGACAGAACGAGACTCAGTCTCAAAAAAAAAAAAAAAAAATCAGCTGATCAGCTGGGCGTGGTGGCACACGCCTGTAATCCCAGCTACTCTGGAGGCTGAAGCAGGAAAATCGCTTGAACCTGGAAGGCAGAAGTTGCAATGAGCTGAGATCAGGCCATTGCACTCCAGCCTGGCCGACGAGAGCAAAACTCTGTCTAAAAAATAAAAAATAAAAATAAAAAAAA","GGCTGGGCGCAGTGGCTCACACCTGTAATCCCAGCACTTAGGGAAGCTGAGGCGAGTAGATCACCTGAGGTCAGGAGTTAGAGACCAGCCTGGCCATCATGGTGAAACCCCGTCTCTACTAAAGATACCAAAAATTAGCTGAGTGTGGTGCTGGGTGCCTGTAATCCCAGAAACTCAGGGTGCCTGTAATCCCAGCAACTCAGGGTGCCTTTAATCCCAGCAACTGAGGGTACCAGTAATCCCAGCAACTCAGGGTGTCTTTAATCCTAGCAACTGAGGGCACCTGTAATCCCAGCAACTCAGGAAGCTGAGACAGGAGAAGTACTTGAACCCAGAAGGCAGAGGTTGCAGTGAGCCGATATTGCACCATTGCACTCCAGTCTGGGCAACAAGAGTGAAACTCTGTCTCAAAAAAAAA"
"chr11","100672864","100673497","JH378206","6546474","6546861","290","94126390","GGGCACAGTGTCTTATGCCTGTAATGCCAGCACTTTGGGAGGCTGAGGTGGGTAGATCACCTGAGGTTGGGAATTTGCGACTAGCCTGGCCAACATGGTGAAACCCTGTCTTTAGCCAGGCGCGGTGGCTCACGCCTGTAATCCCAGCACTTTGGGAGGCTGAGGTGGGTGGATCACGAGGTCAGGAGTTCGAGACCAGCCTGGCCAATGTGGTGAAACCCCATCTCTACTATAAATACAAAAATTAGCCGGGCGTGGTGGCACGTGCCTGTAGTCCCAGCTACTCAGGAGGCTGAAGCAGGAGAATCGCTTGAACCCGGGAGGTGGTGGAAGTTGCAGTGAGCCGAGACCATGCCACTGTACTCTAGCCGGGGCAACAAAGTGAGATGCTGTCTCAAAAAAAAAAAAAAAAAAAGAAAGAAACCCTGTCTTTACTAAAAATACAAAAATTAGCCAGGCATGGTGGCAGGCGCCTGTAATCCCAGCTACTTGGGAGGCTGAGGCTAAAGAATGGCTTGAACCCAGGAGACGGAGGTTGCAGTGACTGGAGATCGCGCCATTCCACTCCAGCCTGGGTGACGAGAGAAACTCTGTCTCAAAAAAAATAAAAATAAAAATAAATTTAAAAAAAAAA","GGCCACACATGGTGGCTAACGCCTGTAATCCCAGCACTTTGGGAGGCCAAGTCGGGTGGATCATGAGGTCAGGAGACCAAGACCATCCTGGCCAAATGGTGAAACCCCGTCTCTACTAAAAATACAAAAATTAGCTGGGCATGGTGGCGTGTGCCTGTAATCCCAGCTACTCAGGAGGCTGAGGCAGGACAATTGCCTGAACCCAGGAGAATTAGCTGGGCATGGTGGCGTGTGCCTGTAATCCCAGCTACTCAGGAGGCTGAGGCAGGACAATTGCCTGAACCCAGGAGGCGAAGGTTGCGGTGAGCCGAGATTGTGCCATTGCACTCCAGCCTGGGTAACAAGAGCGACACTCTGTCTCAAAAAAAAAAAAAAAAAAAAAAAAAAA"
"chr11","100742577","100743182","JH378118","18053084","18053501","252","82689493","GGCCGGGCGCAGTGGCTCACGCCTGTAATCCCAGCACTTTGGGAGGACGAGGGGGGCAGATTGCCTGAGGTCAGGAGTTCGAGACCAGCCTGGCCAACATGGTGAAACTTCGTCTTTATTAAAACTACAAAAATGGCTGGGTGCAGTGGTTCATGCCTGTAATCCCAGCGCTTTGGGAGGCCGAGGTGTGTGGATCACGAGGTCAGGAGTTCAAGACCAGCCTGGCCAAGATGGTGAAACCTCCTCTCTACTAAAAATACAAAAATTAGCCAGGCGCAGTGGCAGGCGCCTGTAATCCCAGCTACTCAGGAGGCTGAGGCAGGAGAATCACTTGAACCTGGGGGGCAGAGGTTGCAGTGAGCCGAGATGGTGCCACTGCACTCCAGCCTAGATGACAAAGCAAGACTCTTCGTCTCAAAAAAAAAAAAGTTACAAAAATTAGCCAAGCATGGTGGCACATGCCTGTAACCCCAGGCACTTGGGAGGCTGAGGCAGTATAATCGCTTGAACCCGGGAAGTGGAGGCTGCAGTGAGCCGAGATTGTGCCATTGCACTCCAGCCTGGGCAACAAGAGCGAAAGTCCATCTCAAAAAAAAAAAAAAAAAA","GGCTGGGCGCAGTGGCTCACACCTGTAATCCCAGCACTTAGGGAAGCTGAGGCGAGTAGATCACCTGAGGTCAGGAGTTAGAGACCAGCCTGGCCATCATGGTGAAACCCCGTCTCTACTAAAGATACCAAAAATTAGCTGAGTGTGGTGCTGGGTGCCTGTAATCCCAGAAACTCAGGGTGCCTGTAATCCCAGCAACTCAGGGTGCCTTTAATCCCAGCAACTGAGGGTACCAGTAATCCCAGCAACTCAGGGTGTCTTTAATCCTAGCAACTGAGGGCACCTGTAATCCCAGCAACTCAGGAAGCTGAGACAGGAGAAGTACTTGAACCCAGAAGGCAGAGGTTGCAGTGAGCCGATATTGCACCATTGCACTCCAGTCTGGGCAACAAGAGTGAAACTCTGTCTCAAAAAAAAA"
"chr11","103566607","103566914","JH378145","9157431","9157737","44","94409176","GGCCGGGTGCAGTCGCTCACACCTGTAATCCCAGCACTTTGGGAGGCCGAGGCAGGCAGATCACTTGAGGTCAGGAGTTCAAGATCAGCCTGGTCAACATGGTGAAACCCTGTCTCTACTAAAAAAAAAAAAAAAAAAAAAAAAATTAGCTGGGCATGGTGGCAGGCGCCTGTTATCCCAGCTACTTGGGAGGCTAAGGCAGGAGAATCACCTGAACCTGGGAGGCAGAGGTTGCAATGAGCCAAGACTGTGCCATTGCACTCCAGCCTAGGCATAAAAAGTGAAACTCTGTCTCAAAGAAAAAAAAA","GGCTGGGTGCGGTGTTTCATACTTGTAATCCCAGCACTTTGGGAGGCTGAGGTGGGTGGATCACTGAGGTCAGGAGTTCGAGACAAGCCTGGCCAACATGGTGAAACCCTGTCTCTACTAAACGTACAAAAAAAAAAAAAAAACCTAGCTGGGCATGGTGGTGGGCACCTGTAATCCCAGCTACTTGGGAGGCTGAGGCAGGAGAATTGCATGAACCCAGGAGGCAGAAGTTGCAGTGAGCCAAGATTGTGCCATTGCACTCCAGCCTGGGCAACAAGAGTGAAACTCTGCCTCAAAAAAAGAAGAA"
"chr11","111847549","111848173","JH378118","18053084","18053501","275","93794465","GACCAGGCATGGTGGCTCACGTCTGTAATCCCAGCACTTTGGGAGGCCAAGGTGGGCGAATCACCTCAAGTCAGGAGTTAGTGACCAACCTGGCCAACAAGGTGAAACCCCATCTCTACTAAAAATACAAAAATTGGCCAGGCGTGGTGGCTCACGCCTGTAATCCCAGCACTTTGGGAGGCCGAGGCGGGCGGATCAGGAGGTCAGGAGATCGAGACCATCCTGGCTAACACGGTGAAACCCCGTCTCTACTAAAAATACAAAAAATTAGCCGGGCGTGGTGGCAGGCGCCTGTAGTCCCAGCTACTCAGGAGTCTGAGGCAGGAGAATGGCGTGAACCCGGGAGGCAGAGCTTGCAGTAAGCAGAGGTCGCGCCACTGCACTCCAGCCTGGGCAACAGAGCGAGACTCCGTCTCAAAAAAAAAAAAAAGAAAAAAACATAAAAATACAAAAATTAGCCAGGTGTGGTGGTGTGCACCTGTAATCCCAGCTACTTGGGAGGCTGAGGCAGGAGAATCATTTGAATCCAGGAGGCCGAAGTTGCAGTGGGCTGAGATTGTGCCATTGCACTCCAGCCTGGGCGAAAAGAGCAAAACTCTGTCTCAAAAGAAAAGATAAAATAAAA","GGCTGGGCGCAGTGGCTCACACCTGTAATCCCAGCACTTAGGGAAGCTGAGGCGAGTAGATCACCTGAGGTCAGGAGTTAGAGACCAGCCTGGCCATCATGGTGAAACCCCGTCTCTACTAAAGATACCAAAAATTAGCTGAGTGTGGTGCTGGGTGCCTGTAATCCCAGAAACTCAGGGTGCCTGTAATCCCAGCAACTCAGGGTGCCTTTAATCCCAGCAACTGAGGGTACCAGTAATCCCAGCAACTCAGGGTGTCTTTAATCCTAGCAACTGAGGGCACCTGTAATCCCAGCAACTCAGGAAGCTGAGACAGGAGAAGTACTTGAACCCAGAAGGCAGAGGTTGCAGTGAGCCGATATTGCACCATTGCACTCCAGTCTGGGCAACAAGAGTGAAACTCTGTCTCAAAAAAAAA"
"chr11","112053775","112054398","JH378118","18053084","18053501","269","94000691","GCCCAGCACAGTGGCTCACACCTGTAATCCCAGCACTTTGTGAGGCCGAGGGAGGCGGATCACCTCAGGTCAGGAGTTGGAGACCAGCTTGGCCAACATGGTGAAATCTTGTCTTTACTAAAAATAAAAAAATTAGGTCGGGCGCAGTGGCTCACGCCTGTAGTCCCAGCACTTTGGGAGGCCGAGGCGAGTGGGACACGAGGTCAGGAGATCGAGACCATCCTTGGCCAACATGGTGAGACCCCATCTCTGCTAAAAATAGAAAAAAAAATAGCTGGGTGTGGTGGTGCGCGCTTGTAATCCCAGCTACTCAGGAGGCTGAGGCAGGAGAATCGCTTGAACCCGGGAGGCAGAGGTTGCAGTGAGGTGAGATTGTGCCACTGCACTCCAGCCTGGGGACAGTGAGACTCTGTCTCAAAATAAAATAAAATAAAATAAAATAAATACAAAAATTAGCTGGGCATAGTGGCAGGCACCTGTAATCCCAGCTCCTCGGGAGAGTGAGGCTGGAGAATCGTTTGAACCCGGGAGCCAGAGGTTGCAGTGAGCCGAGATTGTGCCACTGCACTCCAGGCTGGCGACAAGAGTGAAACTCTGTCTCAAAAACATAAATAAATAAATAAA","GGCTGGGCGCAGTGGCTCACACCTGTAATCCCAGCACTTAGGGAAGCTGAGGCGAGTAGATCACCTGAGGTCAGGAGTTAGAGACCAGCCTGGCCATCATGGTGAAACCCCGTCTCTACTAAAGATACCAAAAATTAGCTGAGTGTGGTGCTGGGTGCCTGTAATCCCAGAAACTCAGGGTGCCTGTAATCCCAGCAACTCAGGGTGCCTTTAATCCCAGCAACTGAGGGTACCAGTAATCCCAGCAACTCAGGGTGTCTTTAATCCTAGCAACTGAGGGCACCTGTAATCCCAGCAACTCAGGAAGCTGAGACAGGAGAAGTACTTGAACCCAGAAGGCAGAGGTTGCAGTGAGCCGATATTGCACCATTGCACTCCAGTCTGGGCAACAAGAGTGAAACTCTGTCTCAAAAAAAAA"
"chr11","120180768","120181103","JH378105","46221579","46221896","60","73959189","GACTGGGCGTGGTGGCTCATGCCTGTAATCCCAACACTTTGGGAGGCCGAGGTGGGCAGATCACCTGAGGTCAGGAGTTCAAGACCAGCCTGGTGAAGTTCAAGACCAGCCTGGTGAAACCCCATCTCTACTAAAAAAAAAAAAAAAAAAAAAAAAAAAAAAAAGCCAGGCGTGGTGGCAGGTGCCTGTAATCCCAGCTACTTGGGAGGCTGAAGCAGGAGAATCGCTTGAGCCCAGGAGGCAGAGGTTGCAGTGAGCCAAGATTGTAGCATTGCACTCCATCCTAGGCAACAAGAGTGAAACTCCATCTCAAAATAAATAAATAAATAAGTAAAA","GACTGGGTGTGATGGCTCATGCCTGTAATCCCAGCACTTTGGGAGGCCAAGGCGGGTGGATCACCTGAGGTCAGGAGTTCAAGACCAGCCTGACCAACATGGTGAAACCCCGTCTCTACTAAAAAAAAAAAAAAAAAAAAAAAACTACAAAATTAGCTGGGCCTGGTGGTACACACCTATAATCCCAGCTACTTGGGAGGCTGAGGCAGGAGAGTTACTTGAACCCAGGAGGCAGAGGTTGCAGTGAGCTGAGATCATGCCATTGCACTCCATCCTGGGCAACAAGAGCGAAACTCTGTCTTAAAAAAAAAAAAAAAA"
"chr12","1198238","1198768","JH378206","6546474","6546861","210","5348236","TCACGTCTGTAATCCCAGCACTTTGGGAGGCCGAGGCGGGTGGATCATCTGAGGTCAGGAGTTCAAGACCAGCCTGGCCAACATGGTGAAACCCTGACGGGTGGATCACGAGGTCAGGAGTTCCAGACCAGCCTGAGCAACATGGCGAAACCCTGTCTCTACTAAAAATACAAAAATTGGCCAGGCGTGGTGGCGCACCCCTGTAATCCCAGGTACTCAGGAGGCTGAGAGAGGGGAATAGCTTGAACCTGGGAGGTAGAGGTTGCACTGAGCTGAGATCACGTCACTGCACTCTAGCCTGGGAGATAGGGCAAGACTCCATCTCAAAAAAAAAAAAAAAAAAAAAAAAATTAGCTGGGCGTGGTGGCAAGTGCCTGTAATCCCAGCTACTCAGGAGGCTAAGGCAGGCAGGAGAATCACTTGAACCCGAGAGGCGGAGGTTGCTTGAAACCAGTGAGCTGAGATTGCGCCACTGCACTCCAGCCTGGGTAACAAGAGAAAGACTGTCTCAAAACAGAACAAAACAAAAAA","GGCCACACATGGTGGCTAACGCCTGTAATCCCAGCACTTTGGGAGGCCAAGTCGGGTGGATCATGAGGTCAGGAGACCAAGACCATCCTGGCCAAATGGTGAAACCCCGTCTCTACTAAAAATACAAAAATTAGCTGGGCATGGTGGCGTGTGCCTGTAATCCCAGCTACTCAGGAGGCTGAGGCAGGACAATTGCCTGAACCCAGGAGAATTAGCTGGGCATGGTGGCGTGTGCCTGTAATCCCAGCTACTCAGGAGGCTGAGGCAGGACAATTGCCTGAACCCAGGAGGCGAAGGTTGCGGTGAGCCGAGATTGTGCCATTGCACTCCAGCCTGGGTAACAAGAGCGACACTCTGTCTCAAAAAAAAAAAAAAAAAAAAAAAAAAA"
"chr12","6157282","6159142","JH378118","18053084","18053501","1443","11895802","GGTCGGGCATGATGGCTCACACCTGGTAATCCCAGCACTTTGGGAGGCTGAAGTGGCAGGATCACCTCAGGTCAGGAGTTCGAGACCAGCCTGACCAACATGGTGAAACACCTACTAAAAATACAAAAATTAACCAAGCGTGGTGGCGCACCTGTAGTCCTGAGAGGTGACAGCCTGTCGGCAGCCCTCGCAGCCCTCGCTCGCTCTGGGCGCCTCCTCGGCCTTGGCGCCCACTCTGGCCGCACTTGAGGAGCCCTTCAGCCTGCCGCCGCTGCACTGTGGGAGCCCCTTTCTGGGCTGGCCAAGGCCGGAGCCGGCTCCCTCAGCTTGCAGGGAGGTGTGGAGGAAGAGGCGCGGGCGGGAACTGGGGCTGCGCGCGGCGCTGCTGGCCAGCGCGAGTTCCGGGTGCGTGTGGGCTCAGCGGGCCCCCCACTCCGAGCGGCAGGCCGGCCCCGCCGGCCGCGGGCAGTGAGGAGCTTAGCACCTGGGCCAGCAAGTGCTGTGCTCGATTTCTCGCCAGGCCTTAGCTGCCTCCCGGGAGCGCCGCCCCCTGCTCCAGGGCGCCCGGTCCCATCGACCGCCCAAGGGCTGAGGAGTGCCGGTGCACTGCGCATGGGACTGGCAGTCAGCTCCACCTTCCGCACCTGTGCGGGACCCACTAGGTGAAGCCAGCTGGGCCTCTGAGTGCGGTGGGGACTTGAACCTTTATGTCTAGCTAAGGGATTGGGAATACACCAATCAGCACTCTGTGTCTAGCTCAAGGTTTGTGAATGCACCAATCAGTGCTCTGTGTCTAGCTGATCTGGTGGGGACTTGGAGTACCTTTATGTCTAGCTAAGTGATTGTAAATACACCAATCAGCACTCTGTATCTAGCTCTAAGTTTGTAAACACACCAATAAGCACTGTGTGTCTAGCTCAGGGTTTGTGAATGCACCAATCGGCACTCAGTATCTAGTTAATCTGGTGGGGACTTGGAGAATCTTTATGTCTAGCTAAGGGATTATGAATGCACCAATCGGCACTCTGTATCTAGCTCAAGGTTTGTAAAAGCACCAATCAGCACTCTGTGTCTAGCTCAGGGTTTGTAAATACACCAATCCACACTCTGTATCTAGCTAATTTAGTGGGGACATGGAGAACTTTTGTGTCTAGCTCAGGGATTGTAAATGCACCAATCAGCGCCCTGTCAAAACTGACCAATCAGCTCTCTGTAAAGCAGACCAATTGGCTCTCTGTAAAATGGACCAATCAGCAGGATGTGGGTGGGGCCAGATAAGAGAATAAAAGCAGGCTGCCCAGCCAGCAGCGAGAATCCATTCGGGTCCCTTTCCACCGAGTGGAAGGGGTGTTCTTTTGTTTGCAATAATCTTGCTGGTGGTCATTGTTGGGGCCTACATTGCGATTATGAACTGTAACACTCACTGTAAAAGTCTGCAGCTTCAGTCCTGAAGCTATGGAGACCACAAACTCACCAGGAGGAATGAACAACTCCAGATGTTCTGTTTTAAGAGCTACAATACTCAACCGAGAAAGTCTGTAGCTTCACTGCTGAGCCAGCAAGACTGCAAACCCACCAGAAGGAAGAGACTCCCCATACATCCGAACATCAGAAGGAACAAACTCCCGATACGCCACCTTTAAGAACTGTAACAATCACTGCGAGGGTCCGAAGCTTTATTTTTGAAGTCAGTGAAACTGAGAACCCACCAATTCCGGACACAGTCTCAGCTACTCGGGAGGCTGAGGCAGGAGAATCACTTAAACCCGCGAGGCAGAGGTTGCAGCGAGTCAACATCACCCCATTGCATTCCAGCCGGAGAACAAGAGCAAAACTCCATCTTAAAAAAAAAAAACCAAAA","GGCTGGGCGCAGTGGCTCACACCTGTAATCCCAGCACTTAGGGAAGCTGAGGCGAGTAGATCACCTGAGGTCAGGAGTTAGAGACCAGCCTGGCCATCATGGTGAAACCCCGTCTCTACTAAAGATACCAAAAATTAGCTGAGTGTGGTGCTGGGTGCCTGTAATCCCAGAAACTCAGGGTGCCTGTAATCCCAGCAACTCAGGGTGCCTTTAATCCCAGCAACTGAGGGTACCAGTAATCCCAGCAACTCAGGGTGTCTTTAATCCTAGCAACTGAGGGCACCTGTAATCCCAGCAACTCAGGAAGCTGAGACAGGAGAAGTACTTGAACCCAGAAGGCAGAGGTTGCAGTGAGCCGATATTGCACCATTGCACTCCAGTCTGGGCAACAAGAGTGAAACTCTGTCTCAAAAAAAAA"
"chr12","7871712","7872313","JH378118","18053084","18053501","248","10181372","GGACAGGCGCAGTGACTCACGCCTGTAATCTCACCACTTTAGGAGGCCGAGGTGGGAGGATCATTTGAGGTTGGGAGTTAGAGACCAGCCTGGCCAACATGGTGAAACCCCGTCTCCACCAAAAATATAAAAATTAGCCAAGTGGCCAGGCGCAGTGGCTCACGCCTGTAATCCCAGCGCTTTGGGAGGCCGAGGCTGGTGGATCACTTGAGGTCAGGAGTTTGACCAACATGGTGAAACCCCGTCTCTACTAAAAATACAAAAATTACCTGGGCGTGGTGGCGGGCACCTATAATCCGAGCTACCTGGGAGGCTGAGGCAGGAGAATTGCTTGAACCCAGGAGGCAGAGGTTGCAGTAAGCCAAGATCACGCCATTGCAATCCAGCCTGGACGACAGAGCAAGACTCTGTCTCAAAAAAACAATTAGCCAAGGGTGGTGGCAGGCGCCTGTAATCCCAGTTACTCAAGAGGCTGAGGCAGGAAAATCACTTGAACTTGGAAGACAGAGGTTGCAGTGAGCCGAGATTGTGCCATTGCACTCCAGCCTGGGTGACAAGAGTGCAACTCCATCTCAAAAAATAAATAAATAAATAAATAAAAA","GGCTGGGCGCAGTGGCTCACACCTGTAATCCCAGCACTTAGGGAAGCTGAGGCGAGTAGATCACCTGAGGTCAGGAGTTAGAGACCAGCCTGGCCATCATGGTGAAACCCCGTCTCTACTAAAGATACCAAAAATTAGCTGAGTGTGGTGCTGGGTGCCTGTAATCCCAGAAACTCAGGGTGCCTGTAATCCCAGCAACTCAGGGTGCCTTTAATCCCAGCAACTGAGGGTACCAGTAATCCCAGCAACTCAGGGTGTCTTTAATCCTAGCAACTGAGGGCACCTGTAATCCCAGCAACTCAGGAAGCTGAGACAGGAGAAGTACTTGAACCCAGAAGGCAGAGGTTGCAGTGAGCCGATATTGCACCATTGCACTCCAGTCTGGGCAACAAGAGTGAAACTCTGTCTCAAAAAAAAA"
"chr12","7915084","7915642","JH378118","18053084","18053501","232","10138000","TTGGGAGTCCAAGGTGGGTGGATCATCTGAGGTCAGGAGTTGGAGACCAGCCTGGACATCATGGTAAAACCCTGTCTCTACTAAAAATACAAAAAAATTGGCTGGGCACGGTGGCTTACGCCTATAATCTCAACAATTTGGGAGGCTGAGGTGCTCAGATCAGCTGAGGTCAGGAGTTCGAGACCAGCCTGGCCAACATGGTGAAAACTCCATCTCTACTAATAATACAAAAATTAGTCGGGCGTGGTGGTGTGCACCTGTAATCCCAGTTACTCTGGAGGCTGAGACAGGAGAATTGCTTGAACCCAGGAGGCGGAGGTAGCAGTGAGCTGAGTTCAGGCAACTGCACTCCAGCCTGGGCAACAGAGTGAGACTCTGTCTCCAAAAAAAAAATACAAAAAAGTTACTCGAGCGTGGTGGTGGGCGCCTGTAATCCCAGCTACTGTGGAGGCTGAGGCAGGAGAATCGCTTGAACTTGGGAGGTGGAGGTTGCAGTGAGCCGAAATCACACCATTGTACTCCAGCCTGGGCAACACGAGCAAAATTCCGTCTCAAAAAA","GGCTGGGCGCAGTGGCTCACACCTGTAATCCCAGCACTTAGGGAAGCTGAGGCGAGTAGATCACCTGAGGTCAGGAGTTAGAGACCAGCCTGGCCATCATGGTGAAACCCCGTCTCTACTAAAGATACCAAAAATTAGCTGAGTGTGGTGCTGGGTGCCTGTAATCCCAGAAACTCAGGGTGCCTGTAATCCCAGCAACTCAGGGTGCCTTTAATCCCAGCAACTGAGGGTACCAGTAATCCCAGCAACTCAGGGTGTCTTTAATCCTAGCAACTGAGGGCACCTGTAATCCCAGCAACTCAGGAAGCTGAGACAGGAGAAGTACTTGAACCCAGAAGGCAGAGGTTGCAGTGAGCCGATATTGCACCATTGCACTCCAGTCTGGGCAACAAGAGTGAAACTCTGTCTCAAAAAAAAA"
"chr12","8192382","8192925","JH378118","18053084","18053501","224","9860702","GGCCAGGCCGTGTTTCCTGCCTGTAATCCCAGCACTTTGGAGGCCTAAAACGGGAGAATAGTTTAAACGCAGGAATTAAAGACCAGCCTGGGCAGCATACTGAGACCCCGTCTCTATTTAAAAAAAAGAAAAAGAAAGAAAGGAAAGAAAGTAGGGTAGTTTGATAAAAGTTTAAAAAGCCAGAGTATGGGCCGGGCGCGGTGGCTCACGCCTGTAATCCCAGCACTTTGGGAGGCCGAGGAAGGCGGATCACGACGTCAGGAGTTCGAGACCAGCCTGGCCAACATGGTGAAACCCCATCTCTACTAAAAATACAAAAATTAGCCCGGCGCGGTGGCGGACGCCTGTAGTGCCGACTAAGGCAGGAGAATCGCTTGAACCCCGGCGTGGTGGCGCGCGCCTGTAATCCCAGCTACTCGGGAAGCTGAGGCAGAAGAATCGCTTGAACCCGGGAGGTGTAGGTTGCAGTGGGCCGAGATCGCGCCAGTGCACTCCAGCCTGGGCAATAAGAGTGAAACTCCGCCTCAAAAAAAGAAAAAAAAAA","GGCTGGGCGCAGTGGCTCACACCTGTAATCCCAGCACTTAGGGAAGCTGAGGCGAGTAGATCACCTGAGGTCAGGAGTTAGAGACCAGCCTGGCCATCATGGTGAAACCCCGTCTCTACTAAAGATACCAAAAATTAGCTGAGTGTGGTGCTGGGTGCCTGTAATCCCAGAAACTCAGGGTGCCTGTAATCCCAGCAACTCAGGGTGCCTTTAATCCCAGCAACTGAGGGTACCAGTAATCCCAGCAACTCAGGGTGTCTTTAATCCTAGCAACTGAGGGCACCTGTAATCCCAGCAACTCAGGAAGCTGAGACAGGAGAAGTACTTGAACCCAGAAGGCAGAGGTTGCAGTGAGCCGATATTGCACCATTGCACTCCAGTCTGGGCAACAAGAGTGAAACTCTGTCTCAAAAAAAAA"
"chr12","11208037","11208614","JH378118","18053084","18053501","247","6845047","TTGGGAGGCTGAGGAAGGCGGATTACCTGAGGTCACGAGTTTGAGACCAGCCTGGCCAATATGGTGTAACTCCATCTCTACTAAAAATACAAAAAATTGGCCAGGCACGGTGGCTCACACCTGTAATCTCAGCACTTTGGGATGCCAAGACAGGCAGATCACCTGAGGTTGGGAGTTCAAGATTAACCTGAACAACATGGAGAAACCCCGTCTCTACTAAAAATACAAAATTAGACAGATGTGGTGGTACATGCCTGTAATCCCAGCTACTCGGGAGGCTGAGGCAGGGGAATCACTTGAACCCAGGAGGCGGAGGTCACGGTGAGCCAAGATCACATCATTGCACTCCAGCTTCAGCAACAGGAGTGAAACTCCGTCTAAAAAACAAACAAACAAACAAAACCAAAAAGGAAACATTAGCTGGGCTTGGTGGCAGATGCCTGTAATCCCAGCTACTCGGGAGGGAAGCTGAGGCAGGAGAATCACTTGAACCTGGGAAGGGGAGGTTGCAGTGAGCCAAGATCATGCCATTGCACTTCAGCCGGGGCAACAAGAGCAAAACTCTGCCAAAAAAAAAA","GGCTGGGCGCAGTGGCTCACACCTGTAATCCCAGCACTTAGGGAAGCTGAGGCGAGTAGATCACCTGAGGTCAGGAGTTAGAGACCAGCCTGGCCATCATGGTGAAACCCCGTCTCTACTAAAGATACCAAAAATTAGCTGAGTGTGGTGCTGGGTGCCTGTAATCCCAGAAACTCAGGGTGCCTGTAATCCCAGCAACTCAGGGTGCCTTTAATCCCAGCAACTGAGGGTACCAGTAATCCCAGCAACTCAGGGTGTCTTTAATCCTAGCAACTGAGGGCACCTGTAATCCCAGCAACTCAGGAAGCTGAGACAGGAGAAGTACTTGAACCCAGAAGGCAGAGGTTGCAGTGAGCCGATATTGCACCATTGCACTCCAGTCTGGGCAACAAGAGTGAAACTCTGTCTCAAAAAAAAA"
"chr12","14818577","14819183","JH378118","18053084","18053501","243","3234507","GGCCAGTCGCGGTGGCTCACGCCTGTAATCCCAGCAGTTTGGGAAGCTGAGGTGGGAGGATCACCAGAGGTCAGGAGTTTGAGACCAGTCTGCCCAACATGGTGAAATCCTGTCTCTACTAAAAATAAAAAAAATTAGGCCTGGTGCAGTGGCTTATGCCTGTAATCTCAGCAGTTTGGGAGGCTGAGGAGGGCGGATCATGAGGTCAAGAGATCAAGACCATCCTGGCCAACATGGTGAAACCCTGTCTCTACTAAAAATACAAAAATTAGCTGGGCCTGGTGGCAGGTGCCTGTAGTCCCAGCTACCTGGGAGGCTGAGGCAGGAGAATTGCTTGAACCTGGGAAGTAGAGGTTGCAGTGAGCCGAGATCGCGCTACTGTATACTAGCCTGGCGACAGAGTGAGACTCTATCTCAAAAACAAACTAACAAACAAATTAGCTGGATGTGGTGGCGGGTGCCTGTAATCCCAGCTACTCAGGAGGCTAAGGCAGGAGAATCACTTGAACCCAGGAGGCGGAGGTTGCAGTGAGACGAGATCGCCCCACTGCACTCCAGCCTGGGCGACAATAGTGAAACTCAGTCTCAAAAAAAAAAAAAAAGAAAA","GGCTGGGCGCAGTGGCTCACACCTGTAATCCCAGCACTTAGGGAAGCTGAGGCGAGTAGATCACCTGAGGTCAGGAGTTAGAGACCAGCCTGGCCATCATGGTGAAACCCCGTCTCTACTAAAGATACCAAAAATTAGCTGAGTGTGGTGCTGGGTGCCTGTAATCCCAGAAACTCAGGGTGCCTGTAATCCCAGCAACTCAGGGTGCCTTTAATCCCAGCAACTGAGGGTACCAGTAATCCCAGCAACTCAGGGTGTCTTTAATCCTAGCAACTGAGGGCACCTGTAATCCCAGCAACTCAGGAAGCTGAGACAGGAGAAGTACTTGAACCCAGAAGGCAGAGGTTGCAGTGAGCCGATATTGCACCATTGCACTCCAGTCTGGGCAACAAGAGTGAAACTCTGTCTCAAAAAAAAA"
"chr12","19873753","19874366","JH378118","18053084","18053501","264","1820669","GGCCAGACGCAGTGGCTCAAGCCTGTAATCCCAACACTTTGGGATAATCCCAACACTTTGGGAGGCCAAGGTGGGCGGATCATTTGAGGTCAGGAGTTCCAGACCAGCCTGGCCAACATGGTGAAACCCCATCTCTACTAAAAATACAAAAATTGCCGGGCGTGGTGGCTCACGCCTGTAATCCCGGCACTTTGGGAGGCCGAGGTGGGCAGATCACCTGAGGTCGGGAGTTTGAGACCAGCCTGACCAACATGGAGAAACCCCGTCTCTACTAAAAATACAAAATTAGCCAGGTGTGGTGGCGCATGCCTGTAATCTCAGCTACTCAGGAGGCTGAGGCAGGACAATCACTTGAACCCGGGAGGTGGAGGTTGCAGTAAGCCGAGATGGCACCATTGCACTCCAGCCTGGGCAACAAGAGCGAAACTCCATCTCAAAAAAAAAAAAAAAAAAATTACCTGGGCGTGGTGTTGCGCACCTGTAGTCTCAGCTACTCGGGAGGCTGAGGCAGGAGAATCTCTTAAACCTGGGAGGTGGAGGTTGCAATGAGCTGAGATCTCGCCATTGCACTCCAGCCTGGGTGACAACACTGAAATTCTGTCTCAAAAAAAAAA","GGCTGGGCGCAGTGGCTCACACCTGTAATCCCAGCACTTAGGGAAGCTGAGGCGAGTAGATCACCTGAGGTCAGGAGTTAGAGACCAGCCTGGCCATCATGGTGAAACCCCGTCTCTACTAAAGATACCAAAAATTAGCTGAGTGTGGTGCTGGGTGCCTGTAATCCCAGAAACTCAGGGTGCCTGTAATCCCAGCAACTCAGGGTGCCTTTAATCCCAGCAACTGAGGGTACCAGTAATCCCAGCAACTCAGGGTGTCTTTAATCCTAGCAACTGAGGGCACCTGTAATCCCAGCAACTCAGGAAGCTGAGACAGGAGAAGTACTTGAACCCAGAAGGCAGAGGTTGCAGTGAGCCGATATTGCACCATTGCACTCCAGTCTGGGCAACAAGAGTGAAACTCTGTCTCAAAAAAAAA"
"chr12","22056519","22056847","JH378148","10302642","10302970","48","11753877","GCCGGGTGTGGTGGCTCACACCTGTAATCCCAGCACTGTGGGAGACCCAGGCGGGCAGATCACTTGAGGTCAGGAGTTCGAGACCAGCCTGGCCAACATGGTGAAACCTCGACTCTACTAAAAATACAAAAAGTTAGCCAGGCGTGGTGGTGGGCACCTGTAATCCCAGCTACTTGGGAGGCCAAAGCAGGAGAATTGCTTGAACCCGGGAGGCGGAGGTTGCAGTGAGCCGAGATCGTGCCATTGCACTCCAGCCTGGGCAACAATAGCGAAACTCCACCTCAAAAAAATAAAATAAAATAAAATAAAATCAGGGGGAGAAAAAAAAA","GGCCGGGCGCGGTGGCTCAAGCCTGTAATCCCAGCACTTTGGGAGGCCGAGGCGGGTGGATCACGAGGTCAAGAGATCGAGACCATCCTGGTCAACATGGTGAAACCCCGTCTCTACTAAAAATACAAAAAATTAGCTGGGCATGGTGGTGGGTGCCTGTAATCCCAGCTACTCAGGAGGCTGAGGCAGGAGAATTGCCTGAACCCAGGAGGCGGAGGTTGCGGTGAGCCGAGATCGCGCCATTGCACTCCAGCCTGGGTAACAAGAGTGAAACTCTGCCTCAAAAAAAAAAAATAAAATAAAATAAAATAAAATAAAATAAAATAAAA"
"chr12","34236846","34237177","JH378111","8583129","8583438","58","25653717","GGCTGGACACAGGTGGCTCATGCCTGTAATCCCAGCACTTTGGGAGGCCAAGGCGGGCAGATCACCTGAGGTCAGGAGTTCAAGACCAGCCTGGCTAACATGGTGAAACCCCATTTCTACTAAAAGTACAAAAACTAGTTGGGTGTGGTGGCGGGCACCTGTAATCTCAGCTACTTGGGAGGCTGAGGTGGGATAATCGCTTGAATTTGGGAGGCAGAGGTTGCGATGAGCTGAGATTGCACCATTACACTCCAGCCTGGGTGACAAGAGTGAAACTCCATTTCAATACATACATACATACATACATACATACACAGAAAAGAAAAGAAAAA","GGCTGGGCGCTGTGGCTTATGCCTGTAATCCCAGCACTTTGGGAGGCCAAATCGGGTGGATCACCTGAGGTCAGGACTTCAAGACCAGCCTGGCCAACATGGTGAAACCCGTCTCTCCTAAAAACACAAAAATTAGCTGGGTGTGGTGGCGGGCATCTGTAATCCCAGCTACTCAGGAGGCTGAGGCAGGAGAATTTCTTGAACCTGGGTAGCAGAGGTTGCAGTGAGCCGAGATTGCACCATTGCACTCCAGCCTGTGTGACAAGAGTGAAACTCCCATCTCAAAACATTTAAAAAAAAAAAAAAAAAA"
"chr12","44890099","44890424","JH378130","3770433","3770754","54","41119666","GGCTGGACACAGTGGCTCACGCCTGTAATCCCAGCACTTTGGAAGGCCAAGGTGGGCAGATCTCCTGAGGTCAGGAGTTTGAGACCAGCCCGGCCAACATGGTGAATCCCCATCTCCACCAAAAATACAAAAATTAGCTGGGCGTGTTGGCATGCATCTGTAGTCCCAGCTACTCAGGAGGCTGAGGCAGGAAAATTGCTTAAAGCTGGGAGGCAGAAGTTGCAGTGAGCCAGGATTGTGCCATTGCACTCCAGCCTGGAGGACAAGAGCGAGACTCCATTTCAAAATAATAATAATAATAATAATAATAAAATTTAAAAAAGAAA","GGCCGGACAGGATGGCTCACGCCTGTAATCCCAGCACTTAGGGAGGCGAAGGCAGTTGGATCACCTGAGGTCAGGAGTTTGAGACCAGCATGGCCAACATGGTGAAACCCCATCTCTACTAAAAATACAAAAATTAGCTGGACATGGTGGCATGCCTGTAATCCTAGCTACTCAGGAGGCTGAGGCTGGAGAATTGCTTGAACCCAGGAGGCAGAAGTTGCAGTGAGCTGAGATGGTGCCATTGCACTCCAGCCTGGGCAACAAGAGAAACACTCTGTCTCAAAAATAATAAAATAAAATAAAATAAGATAAAATAAAATAA"
"chr12","45051205","45051529","JH378109","3329188","3329514","49","41722017","GGCCAGGCACATTGGCTCATGTCTGTCATCCCAGCACTTTGGGAGGCTGAAGAGGGTGGATTGCCTGAGGTCAGGAGTTCGAGACCAGCCTGGCCAACATAGTGAAACCTCGTCTCTACTAAAAATACAAAAAAAAAAAAAAAGAAAAAAAAAAGAAAAAAATAGCTGCTGTGGTGGCAGGCACCTGTAATTCCAGCTACTCGGGAGGCTGAGGCAGGAGAATTGCTTGAACCTGGGAGGCAGGGGTTGCAGTGAGCTGAGTTCGTGCCATTGCACTCCAGGCTGGGCAACAAGAGCGAAACTCCATCTCAAATAAATAAATAAA","GGCCAGGCATGGTGGCTCACGCCTGTAATCCCAGCACTTTGGGAGCCCAAGCCGGGTGGATTACCTAAGGTCAGGAATTCCAGAACAGCCTGGACAATATGGTGAAACCTTGTCTCTACTAAAAATACAAAAAAAAAAAAAAAAAAAAAAAAAAAAAAAATTTAGCCGGGTGTGGTGGTAGGTACCTGTAATCCCAGCTACTAGGGAGGCTGAGGCAGGAGAATCGCTTGAACTTGGGAGGCGGAGGTTGCAGTGAACAGAGATCACACCACTGCACTCCAGCCTGGGCGACAAGAGCAAAACTCCATCTCAAAGAAAAAAAAAGAA"
"chr12","46682602","46683404","JH378118","18053084","18053501","432","28629518","GGCCGGGCGCAGTGTCTCACGCCTGTAATCCCAGCACTTTGGGAGGCCGAGACGGGTGGATTACCTGAAGTCAGGTGCCGAGACCAGCTCGGTCGGAGAGACCCTAACCCAGTGGCGCTAGAGGAATTAAAGACACACTCACAGAAATATAGAGGTGTGAAGTGGGAAATCAGGGGTCTCACAGCCTTCAGAGCTAAGAGCCCGGAACAGAGATTTACCCAACAGCAAGCCAGTCATTAGCATTGTTTCTATAGATATTAGTTTAACTGAAAATATCCCTTATGGGAAACAAAGGGATGGGCAGAGATAAAGGGATGGGTTGGGCTAGTTATCTGCAGCAGGAGCATGTCCTTGAGGCACAGATCGCTCATGCTATTGTTTGTGGTTTAAGAACGTCTTTAAGCGGTTTTCCGCCCTGGGTGGGCCAGGTGTTCCTTGCCCTCATTCCAGTAAACCCACAACCTTCCAGCGTGGGCATTATGGCCATCGTGAACATGTCACAGTGCTGCAGAGATTTTGTTTATGGCCAGTTCTGGGGCCAGTTTATGGCCAGATTTTGGGAGGGCTTGTTCCCAACAGTCAGGAGTTCAGGACCACCCTGGCCAACATGGTGAAACCCTGTCTCTACTAAAAAATACAAAAATTAGCTGGGCATGGTGGTGGGTACTGTAATCCCAGCTACTTGGGAGGCTGAGGCAGGAGAATCACTTGAACCTGGGAGTTGGAGGTTGTGGTGAGCTGAGATCACACCATTGCACTACAGCTTGGGCAACAAGAGCGAAACTCCGTCTCTAAAAAAAAAA","GGCTGGGCGCAGTGGCTCACACCTGTAATCCCAGCACTTAGGGAAGCTGAGGCGAGTAGATCACCTGAGGTCAGGAGTTAGAGACCAGCCTGGCCATCATGGTGAAACCCCGTCTCTACTAAAGATACCAAAAATTAGCTGAGTGTGGTGCTGGGTGCCTGTAATCCCAGAAACTCAGGGTGCCTGTAATCCCAGCAACTCAGGGTGCCTTTAATCCCAGCAACTGAGGGTACCAGTAATCCCAGCAACTCAGGGTGTCTTTAATCCTAGCAACTGAGGGCACCTGTAATCCCAGCAACTCAGGAAGCTGAGACAGGAGAAGTACTTGAACCCAGAAGGCAGAGGTTGCAGTGAGCCGATATTGCACCATTGCACTCCAGTCTGGGCAACAAGAGTGAAACTCTGTCTCAAAAAAAAA"
"chr12","46737294","46737909","JH378118","18053084","18053501","256","28684210","GGCTGGGCGTGGTGGCTCACGCCTGTAATCCCAGCACTTTGGGAGGCCAAGGCGGGCAGATCACTTGAGGTCAGGAGCTCGAGACCAGTCTGGACAATATGGTGAAACCTCATCACTACTAAAAATACAAAAATAGGCTGGGTGCAGTGGCTCACACCTGTATTGCCAGCACTTTGGGAGGCTGAGGTGGGCAGATCACAAGGTCAGGAATTCAAGACAAGCCTGGTCAACATAGTGAAACCCTGTCTCTACTAAAAATACAAAAATTAGCTGGGCATGGTGGTGCGTGCCTGTAGTCCCAGCTACTCAGGAGGCTGAGGCAGGAAAATCGCTTGAACCCAGGAGGTATAGGTTGCAGTGAGCCGAGATTGTGCCACTGCACTCCAGCTTGGGCAACAGAGTGAGACTTCGTCTCAAAAAAAAAAACTAAAAATATATACAAAAATAAGCCAGGCATGGTGGCATGCGCCTGTAATTCCAGTTACTCAGGAGGCTGAGGCAGGAGAATCGCTTGAACCCGGGAGGCAGAGGTTGCAGTGAGCTGGAGATCACGCCATTGTACTCCAACCTGGGCATCAAGAGCGAAACTCCAGTCTCAAAAAAAAAAAAAAAAAAA","GGCTGGGCGCAGTGGCTCACACCTGTAATCCCAGCACTTAGGGAAGCTGAGGCGAGTAGATCACCTGAGGTCAGGAGTTAGAGACCAGCCTGGCCATCATGGTGAAACCCCGTCTCTACTAAAGATACCAAAAATTAGCTGAGTGTGGTGCTGGGTGCCTGTAATCCCAGAAACTCAGGGTGCCTGTAATCCCAGCAACTCAGGGTGCCTTTAATCCCAGCAACTGAGGGTACCAGTAATCCCAGCAACTCAGGGTGTCTTTAATCCTAGCAACTGAGGGCACCTGTAATCCCAGCAACTCAGGAAGCTGAGACAGGAGAAGTACTTGAACCCAGAAGGCAGAGGTTGCAGTGAGCCGATATTGCACCATTGCACTCCAGTCTGGGCAACAAGAGTGAAACTCTGTCTCAAAAAAAAA"
"chr12","50958599","50959204","JH378118","18053084","18053501","254","32905515","GGCTAGGCATAGTGGCTCATGCCTGTAACCCCAGCACTTTGGGAGGCTGAGGTGGGCAGATTGCCTGAGGTCAGGAGTTCGAGACCAGCCTGGCTAACATGGTAAAACCCCATCTCTACTAAAAATACAAAAATTGGCCGGATGCGGTGGCTCACACCCGTAATCCCAGCATTTTGGGAGGCTGAGGCGGGGCGGATCACGAGGTCAAGAAATCGAGACCATCCTGGCCAACATGATAAAACCCCTTCTCTACTAAAAATACAAAAATTAGCTCGGTGTGGTGGCATGCACCTGTAGTCCCAGCTACTTGGGAGGCTGAGGCAGGAGAATCTCTTGAACCAGGGAGGCAGAGGATGCAGTGAGCCGAGATTGCGCCACTGCACTCCAGCCTGGGCAACAGAGCAAGACTTTGTCTCCGAAAAAAAAATAAGAAGAAATACAAAATTAGCTGGGCGTGGTGGTGCATGCCTGTAATTGCAGCTACTTGGGAGACTGAGGCAGGAGAATCTCTGGAACCAGGGAGGCAGAGGGTGCAGTGAGCTGCGATTGTGCCATTGCACTCCAGCCTGGGTAACAAGAGTGAAACTCCATCTCAAAAAAAAAGAA","GGCTGGGCGCAGTGGCTCACACCTGTAATCCCAGCACTTAGGGAAGCTGAGGCGAGTAGATCACCTGAGGTCAGGAGTTAGAGACCAGCCTGGCCATCATGGTGAAACCCCGTCTCTACTAAAGATACCAAAAATTAGCTGAGTGTGGTGCTGGGTGCCTGTAATCCCAGAAACTCAGGGTGCCTGTAATCCCAGCAACTCAGGGTGCCTTTAATCCCAGCAACTGAGGGTACCAGTAATCCCAGCAACTCAGGGTGTCTTTAATCCTAGCAACTGAGGGCACCTGTAATCCCAGCAACTCAGGAAGCTGAGACAGGAGAAGTACTTGAACCCAGAAGGCAGAGGTTGCAGTGAGCCGATATTGCACCATTGCACTCCAGTCTGGGCAACAAGAGTGAAACTCTGTCTCAAAAAAAAA"
"chr12","53027910","53028202","JH378165","1307477","1307734","79","51720433","GAGACCATTCTGGCCAGCATGGTGAAACACCATCTCTACTGAAACTGCAAAAATTAGCTGGTCATGGTGGCGATGGCAGGCACCTGCAGTCCCAGCTACTTGTCAGGCTGAGGCAGGAGAATCGCTTGAACCCAGGAGGTGGAGGTTGCAGTGAGCCGAGATTATGCCATTGCACTCCAGCCTGGGTTACAAGAGTGAAACTCCATCTCAAAAAAAAAAAAAAAAAAATCTCATGTACTCCATAATTATATATCCCTACTATGTACCCACAAAAATTAAAAATTAAAAAAGAA","GACCATCCTGGTCAACAAGGTGAAACCCCGTCTCTACTAAAAATTCAAAAATTAGCTGGGCATGGTGGCGTGCACCTGTAGTCCCAGTAGCCTGTAGCTAATCGGGAGGCTGAGGCAGGAGAATTGCTTGAACCCAGGAGGCGGAGGTTGCGGTGAGCCGAGATCCTGCCATTGCACTCCAGCCTGGGTTACAAGAGCGAAACTCCGTCTCAAAAAAAAAATAAATAAATAAATAAATAAATAAATAAATAAATAAAT"
"chr12","53467144","53467768","JH378118","18053084","18053501","275","35414060","GGCTGGGCTTGGTGGCTCATGCCTATAATCCCAGCACTTTCGGAGGCCGAGGCAGGTGGATCACCTGAGGTCAGGAGTTCGAGACCAGCCTGACCAACACGGCAAAACCCTGTCTCTACTAAAAATACAAAAAATTAGCCAGGCGTGGCCAGGCGCGGTGGCTCACGCTTGTAATCCCAGCACTTTGGGAGGCTGAGGCGGGCGGATCACGAGGTCGGGAGATCGAGACCACGGTGAAACCCCGTCTCTACTAAAAACACAAAAAATTAGCCGGGCGTGGTGGCGGCGCCTGTAGTTCCAGCTACTCGGAGAGGCTGAGGCAGGAGAATGGTGTGAACCCGGGAGGCGGAGCTTGCAGTGAGCCGAGATCGCGCCATTGCACTCCAGCCTGGGTGACAGAGCGAGACTCCGTATCAAAAAAAAAAAAAAAAAAAAAAAAAAAAAAATTAGCCGGGCGTGGTGGCAGGCGCCTGTAATCCCAGGTACTCGGGAGGCTGAGGCAGGAGAATCACTTGAATCTGGGAGGAGGAGGTTGCAGTGAGCTGAGATCGCACCATTGTACTCTAGCCTGGGAGACAAGAGCAAAATTCCATCTCAAAACAAAACAAACAAACAAACAAAAAAA","GGCTGGGCGCAGTGGCTCACACCTGTAATCCCAGCACTTAGGGAAGCTGAGGCGAGTAGATCACCTGAGGTCAGGAGTTAGAGACCAGCCTGGCCATCATGGTGAAACCCCGTCTCTACTAAAGATACCAAAAATTAGCTGAGTGTGGTGCTGGGTGCCTGTAATCCCAGAAACTCAGGGTGCCTGTAATCCCAGCAACTCAGGGTGCCTTTAATCCCAGCAACTGAGGGTACCAGTAATCCCAGCAACTCAGGGTGTCTTTAATCCTAGCAACTGAGGGCACCTGTAATCCCAGCAACTCAGGAAGCTGAGACAGGAGAAGTACTTGAACCCAGAAGGCAGAGGTTGCAGTGAGCCGATATTGCACCATTGCACTCCAGTCTGGGCAACAAGAGTGAAACTCTGTCTCAAAAAAAAA"
"chr12","53569692","53570317","JH378118","18053084","18053501","273","35516608","GGCCAGGGACAGTGGCTCACGCCTGTTATCCCAGCACTTTGGGAGGCCAAGGCGGGCAGATCATCTGAGGTCAGGAGTTCAACAGCAGCCTAGCTAACATGGTGAAACCCCGTCTCTACTAAAAATACAAAACTAGGCCGGGTGCGGTGGCTCACGCCTGTAATCCCAGCACTTTGGGGGGCCTAGGCGGGCAGATCAACTGACGTCAGGAGTTCAAGACCAGCCTGGCCAACATGGTGAAACCCTGTCTCTACTAAAAATACAAATAGTAGCCGAGCATGGTGGCGGGCGCTTATATTTACCCAGCTATTCAGGAGGCTGAGACAAAAGAATTGCTTAAACCTAGGAGGCAGAGGTTGCAGTGAGCCGAAATCGTGCCATTGCACTCCAGCGGGTGAAAGAGTGAGACTGTCTCAAAAAAATAAATAAAAATAAAAATAAAAATATAAAATACAAAACTAGCCAGGCGTGGTGGCACATGCCTGTAATCCCAGCTATTCAGGAGGCTGAGGCAGGAGAACGGCTTGAACCTGGGATGCAGAGGTTGCAGTGAGCCGAGATCACGCCATTGCGCTCCAGCCTGGATGCCAAGAACAAAATTCTGTCTCAAAAAAAAAAAAAAAAAA","GGCTGGGCGCAGTGGCTCACACCTGTAATCCCAGCACTTAGGGAAGCTGAGGCGAGTAGATCACCTGAGGTCAGGAGTTAGAGACCAGCCTGGCCATCATGGTGAAACCCCGTCTCTACTAAAGATACCAAAAATTAGCTGAGTGTGGTGCTGGGTGCCTGTAATCCCAGAAACTCAGGGTGCCTGTAATCCCAGCAACTCAGGGTGCCTTTAATCCCAGCAACTGAGGGTACCAGTAATCCCAGCAACTCAGGGTGTCTTTAATCCTAGCAACTGAGGGCACCTGTAATCCCAGCAACTCAGGAAGCTGAGACAGGAGAAGTACTTGAACCCAGAAGGCAGAGGTTGCAGTGAGCCGATATTGCACCATTGCACTCCAGTCTGGGCAACAAGAGTGAAACTCTGTCTCAAAAAAAAA"
"chr12","60987460","60987773","JH378271","2122362","2122678","52","58865098","GGCCGAGTTCAGTGGCTCATGCCTGTAATCCCAGCACTTTGAGGGGCCAAGATGGGCAGATCACCTGAGGTCAGGAGTTCGAGAACAGCCTGGCCAACATGCTGAAACCCTGTCTCTACTAAAAATACAAAAAAAAAAAAAAAAAAAAAAAAAATAGCTGGGTGTGGTGGTAGATGCCTGTAATCCCAGCTACTTGGGAGGCTGAGGCAGGAGAAGAGCTTAAACCCTGGAGACGGAGGTTGCAGTGAGCCAATTTCATGCCATTGCACTCCAGCCTGGGCAATAAGAGTGAAATTCCATCACAAAAAAAAAAA","GGCCGGGCACGGTGGCTCACACCTGTAATCCCAGCACTTTGGGAGGCTGAGGTGGGTGAATCACCTGAGGTCAGGAGTTTGAGACCAGCCTGACCAACATGATGAAACCCGGTCTCTGCTAAAAATACAAAAAAAAAAAAAAAAAAAAAAAAAAAAAGCTGGGCATGATGGTGGGCACCTGTAATCCCAGCTACTCGGGAGGCTGAGGCAGGAGAATCGCTTGAACACCAGGAGGTGGAGGTTGCTATGAGCCGAGATCGCACCATTGCACTCTAGCTTGGGCAACAAGAGAGAAACTCCATCAAAAAAAAAAAAAA"
"chr12","67505865","67506198","JH378262","266823","267148","55","67239042","GGCTGGGCATGGGGGCTCATGCCTGTAATCCCGCTTTTTGGGAGACCGAGGTGGGGGATCACCCGAGGTCAGGAGTTCGAGACCAGCCTGGCCAACATGGTGAAACCCCCTCTCTACTAAAAATACAAAAATTAGCCGGGCGTGGTGGCAGGCACCTGTAGTCCCAGCTACTTGGGAAGCTGAGGCAGGAGAATTGCTTGAACCCAGGAGACAGAGGTTGCAGTGAGCCAAGATCGTACCACTGCACTCCAGCCTGGGTGACAAGAGCAAGACTTCATCTCACACACACACACACACACACACACACACACACACACAAAGAAAAGAAAAAAAA","GGCCGGGCGCGGTGGCTCAAGCCTGTAATCCCAGCACTTTGGGAGGCCGAGGCGGGTAGATCATGAGGTCAGGAGTTTGAGACCAGCCTGGCCAACATGGTGAAACCCCGTCTCTACTAAAAATACAAAAATTAGCCGGGCATGGTGGCCTGTGCCTGTAATCCTAGCTACCCAGGAAGCTGAGGCAGGAGAATTGCCTGAACCCAGGAGGCGGAGGTTGCGGTGAGCCGAGATCGTGCCATTGCACTCCAGCCTGGGTAACAAGAGCGAAACTCCGTCTCAAAAACAAACAAACAAACAAACAAAAACAAAAAACAAAAAACAAA"
"chr12","82383141","82383450","JH378138","4229795","4230103","67","78153346","AGGCCAAGGTGGGTTGATCACCTGAGGTCAGGAGTTCAAGACCAGCCTGACCAACATAGTGAAACCCCTGGTCTACTAAATATACAAAAAATTAGCCTGGCATGGTGGTGGGCACCTGTAATCCCAGCTACTTGGGAGGCTGGGGTAGGAGAATCGCTTGAACCTGGGAGGCAGAGGTTGGAGTGAGCAGAGATCTCACCATTGATTGTACTCCAGCCTGGGCAACAAGAGCAAGACTCTGTCTTAAAAAATAAATAAATAAATAAATAAAATAAAATAAAATAAAATAAAAAGAAAGAAAAGAAAAGAA","CACTTTGGGAGGTGAAGGCGGGCAGATCACCTGAGGTCAGGAGTTCGAGACCAGCCTGGCCAACATGGTGAAACCCCGCCTCTACTAAAAATACAAAAATTAGCCAGGTGTGACACTAGGCATCTGTAATCCCAGCTACTTGGGAGGCTGAGACAGGAGAATCACTTGAACCCAGGAGGCGGAAGTTGCAGTGAGCCAAGATCATGCCATTGCACTCCAGCCTGGGTGACAGGAGCAAAACTCTGTCTCAAAAAAAAAAAAAAAAAAAAAAAAAAAAAAAAAAAAAAAAGAAAAGAAAAGAAAAGTAAA"
"chr12","83007532","83008009","JH378163","10668746","10669125","153","72338786","GGCCAGGCGTGGTGGCTCATGCCTGTAATCCCAGCACTTTGGGAAGCCGAGGTGGGTGGATCACCTGAGGTCAGGAGTTCAAGACCAGCCTGGCCAACATGGTGAAATCCCGTCTCTACTAAAAATATGAAAATTATTTTTATTTATTTATTTATTTTATTATACCTTAAGTTCTACGGTACATGTGCATAACGTGCAGGTTTGTTACATATGTATACATGTGCCATGTTGGTGTGCTACACCTATTAATTCATCATTTACATTAGGTATTTCTCTTAATGCTATCCCTCACCCTGCCCCCACCCCACGACTGGCACGGTGGCGGGCGCCTGTAGTCCGCTACTCGGGAGGCTGAGGCAGGAGAATTGCTTGAACCCTGGAGGCGGAGGTTGCAGTGAGCCAAGATTGCACCATTGCACTCCAGCCCGGGCAACAAGAGTGAAACTCCATCTCAAAAAACAAAACAAAACAAAAGAAA","GGCTGGGCGTGGTGGCTCACATCTGTAATACCAGCACTTTGGGAGGCTGAGGTGGGTGGCTCACCTGAGGTCAGGAGTTCAAGACCAGCCTGGCCAACATGGCAAAACCCCGTATCTACTAAAAATATGTGTATATATATATACACATATATATATACACACATATATATATAGTGTGTGTGTGTATATATATATATTTATATTTATATTTATATACAAAAATTAGCCAGACACCTGTAATCCCATCTACTTGTGAGTCTGAGTCAGGAGAATCACTTGAACCTGGGAGGTGAAGGTTGCAGTGAGCCAAGATTACGCCATTGCACTCCAGCTTGGGCAACAAAAACAAAACTCCATCTCAAAAATAAATAAATAAAAGA"
"chr12","96753274","96753864","JH378118","18053084","18053501","252","78700190","GGCTGGGCACAGTGGCTCATGCCTGTAATCCCAGCACTTTTTTTTTTTTTTTTTTGAGACAGAGTTTCGCTCTTGTTGCCCAGGCTGGAGTGTAATGGCATGATCTCGGCTCACCGCAACCTCCGCCTCCTGGGTTCAAGCGATTCTCCTGCCTCAGCCTCCCTAGTAGTGGGGATTACAGGCATGTGCCACCACACCCAGCTAATTTTTGTATTTTTAGTAGAGACGGGGTTTCTCCATGTTGATCAGGCTGGTGTCCAACTCCCGACCTCAGGTGATCTACCTGCCTCGGCCTCCCAAAGTACTGGGATTATAGGCATGAGCAATCCCAGCACTTCGGCAGGCCGAGGCAGGTGGATCGCTTGAGGTCAGGAGTGAGAGACCAGCCTGGCCAACACGGTGAAACCCCGTCTCTAGTAAATTTACAAAAATTAGCTGGGCATGGTGGCACATGCCTGTAATCCCAGCTACTCAGGAGGCAGAGGCAGGAGAATGGCTTGAACCCAGGAGGCGGAGGTTGCAGTGAGCTGAGATCGTGCCATTGCACTCCAGCCTGGGCAACAAGAGCGAAACTCCATCTCAAAAAATAAA","GGCTGGGCGCAGTGGCTCACACCTGTAATCCCAGCACTTAGGGAAGCTGAGGCGAGTAGATCACCTGAGGTCAGGAGTTAGAGACCAGCCTGGCCATCATGGTGAAACCCCGTCTCTACTAAAGATACCAAAAATTAGCTGAGTGTGGTGCTGGGTGCCTGTAATCCCAGAAACTCAGGGTGCCTGTAATCCCAGCAACTCAGGGTGCCTTTAATCCCAGCAACTGAGGGTACCAGTAATCCCAGCAACTCAGGGTGTCTTTAATCCTAGCAACTGAGGGCACCTGTAATCCCAGCAACTCAGGAAGCTGAGACAGGAGAAGTACTTGAACCCAGAAGGCAGAGGTTGCAGTGAGCCGATATTGCACCATTGCACTCCAGTCTGGGCAACAAGAGTGAAACTCTGTCTCAAAAAAAAA"
"chr12","99938852","99939366","JH378206","6546474","6546861","195","93392378","TGATAAAAACCCATCTCTATTAAAAATATAAAAATTAGGCTAGGTGCGGTGGCTCATGCCTGTAATCTCAGCATTCTGGGAGGCCGAGGTGGGCAGATCATGAGGTCAGGAGTTCGAGGCCAGCTTGTCCGCATAGTGAAACCTTGTCTCTACTAAAAATAAAAATAAAAAATTAGCCAGGCATGGTGGTGCATGCCTGTAGTTCCAGTTACTTGGGAGGCTGAGGCAGGAGAATTGCTTGAACCTGGGAGGAGGAGGTTGTGGTGAGCCAAGATCATGCCACTGTACTCCAGCCTGGGCAACAGAGCAAGACTCCATCTCAAAAAAAAAAAAAATTAACTAGGCGTGATGGTGGGTGCCTGTAATCCCAGTTACTCAGGAGGCTGAGATAGAAGAATCACTTGAACCCAGGAGCTGGAGGTTGCAGTGAGCCAATATGGCACCATTGCACTTCCGCCTGGGCAACGATAGAGAAATTCCATCTCGAAAAAAAGAAAGAAAAAAAGAAAGAAGAA","GGCCACACATGGTGGCTAACGCCTGTAATCCCAGCACTTTGGGAGGCCAAGTCGGGTGGATCATGAGGTCAGGAGACCAAGACCATCCTGGCCAAATGGTGAAACCCCGTCTCTACTAAAAATACAAAAATTAGCTGGGCATGGTGGCGTGTGCCTGTAATCCCAGCTACTCAGGAGGCTGAGGCAGGACAATTGCCTGAACCCAGGAGAATTAGCTGGGCATGGTGGCGTGTGCCTGTAATCCCAGCTACTCAGGAGGCTGAGGCAGGACAATTGCCTGAACCCAGGAGGCGAAGGTTGCGGTGAGCCGAGATTGTGCCATTGCACTCCAGCCTGGGTAACAAGAGCGACACTCTGTCTCAAAAAAAAAAAAAAAAAAAAAAAAAAA"
"chr12","102771258","102771774","JH378114","15957391","15957789","218","86813867","GGCCGGGTCCAGTGCCTCACGTCTATAATCCCAGCTCTTTGGGAGGCCAAGGTAGGTAGGTGGATTACCTGAGGTCAGGAGTTTGAGACCAGCCTGGACAACATGATGAAACCCCGTCTCTACTAAAAATATAAAAAATTAGCCTGGCATGGTGGCAGGTGCCTGTAATCCCAGCTACTCAGGAAGCTGAGGCAGGAGAATTGCTTGAACCCAGGAGACGGAGAGTGAAGTGAGCCCAGATTACGCCATTGCACTTCAGCCGGGGCAACAAGAGCAAAACTTGGTCTCAAAAAAAAAAGAGAGAGAGAGGAAGGAAGGAGGGAAGGAGGGAGGGGGAAGGAAGGGAAGGAAGGAAGGAGGGAAGGAAGGAAGGAAGGAAGGAGGGAAGGAAGGAAGGAAGGAGGGAAGGAAGGAAGGAAAGGAAGGAAGGAAGGAAGGAAAGGAAGGAAAGGGAAGGGAGGAAGGAAGGAAGAAGGAAGGAAGGAAGAAAGAAAGAAGAAAGGAAAGAAAGAAAGAA","GCAAGGAACGGTGGCTCATGCCTGTCATCCCAGCACTTTGGGAGGCTAAGGAGGGTGGATTACCGAAGGTCATGAGTTTGAGACCAGCCTGACCAACATGGTGAAAACCCCATCTCTACTAAAAATACAAAAAATTAGCCAGATACAGCTATGCGGCAGACTGGGGCAGGAGAATCGCTTGGACCCAAACCCCATCTCTACTAAAAATACAAAAAATTAGCCGGATACAGCTATGCGGGAGACTGGGGCAGGAGAATCGCTTGGACCCGGGAGGCAGAGATTGCAGTGAGATGAGACCATGCCATTGCTCTCTAGCTTGTGCGATGAGAACAAGACTCTGTCTCAAAAAAAAAAAAAAAAAAAAAAAAAAAAAAAAAAAAAAAAGAGAGAGAGAGAAAA"
"chr12","102775582","102776600","JH378118","18053084","18053501","638","84722498","CCAGCGGCCAACATGGTGAATCCCTGTCTCTACTAAAAATACAAAAATTAGCAGGGCATGGTGGTGAGTGCCTGTAATCCCAGCTACTCCGAAAGCTGATGTTATAAGTAAAGTTTCGGTGCCGCAAAAGAAATAGCACTGGAATATAAAGTTTTCTTTTTAATTCTCAGCAAGGCAAGTTACTTCTATAGAAGGGTGTGCCCTTACAGATGGAGCAATGGTGAGCACACATTTCCATAAGGGAGGGGAAGGGGTTCTTATCCCTGACACAGGTGGCTCCTGCTGCTGTGTTGTTCCCCTATTGGCTAGGGTTAGACCACACAGGCTAAACATTCCAATTCACTAATTTAAGGAGAGTGACAGGGTGAGTGATTTGGCGGGAAAAATTGTTATGACAGAGCAGGTAATCGGAATGAATCAGGGTGGGGTAGGTAATCAGAAAGACTTAAGGGTGGAGCAGGTAATCGGAATGAGTCAGAGTGGAGTAGGTAATCGAAAAGGTTGCTTTACGAGGAAGTTAAGTTTAAAAGTAGAAGGTAAAAGTCCCGGCGCTGTGGCTCACGCCTGTAATCCCAGTACTTTTGGGAGGCCGAGATGGGCAGATCACGAGGTCAGGAGATCAAGACCATCCCAGCTACGGTGAAACCCAGTCTCTACTAAAAATACAAAAAAATTAGCCGGGCATGGTGGCGGGCGCCTGTAGTCGGGAGGCTGAGGGAGGAGAATGGCATGAACCTGGGAGGCGGAGCTTGCAGTGAGCCCAGATCACACCACTGCACTCAAGCCTGGGCGACAGAGCGAGACTCCGCCTGAAAAGAAAAAGAAAAAGAAAAAAAAAGTAGAAGGCAAAGAATTGAACATACTGACATATTGATTCTTTGAAAAGAAATTTAGAACTCATATCTAACACTAAGGCAGGAGAATTGCTTGAACCTGGGAGGCAGAGGTTGCAGTGAGCCGAGATCACGTCATTGCACTCCAGCCTGGGCGACAAGAGTGAGACTCTATCTCAAAAAAAA","GGCTGGGCGCAGTGGCTCACACCTGTAATCCCAGCACTTAGGGAAGCTGAGGCGAGTAGATCACCTGAGGTCAGGAGTTAGAGACCAGCCTGGCCATCATGGTGAAACCCCGTCTCTACTAAAGATACCAAAAATTAGCTGAGTGTGGTGCTGGGTGCCTGTAATCCCAGAAACTCAGGGTGCCTGTAATCCCAGCAACTCAGGGTGCCTTTAATCCCAGCAACTGAGGGTACCAGTAATCCCAGCAACTCAGGGTGTCTTTAATCCTAGCAACTGAGGGCACCTGTAATCCCAGCAACTCAGGAAGCTGAGACAGGAGAAGTACTTGAACCCAGAAGGCAGAGGTTGCAGTGAGCCGATATTGCACCATTGCACTCCAGTCTGGGCAACAAGAGTGAAACTCTGTCTCAAAAAAAAA"
"chr12","109105055","109105633","JH378118","18053084","18053501","225","91051971","GGCGAGGTGCAGTGGCTCATGCCTATACATCCCAGCACTTTGGGAGGCTGAGGTGGGCAGATCACTTGAGTCCAGGAGTTTGGGACCAGCCTGGCCTACATGGTGAAACCCTTAGGCTGGGCGCGGTGGCTCATGCCTTTAATCCCAGCATTTTGGGAGGCCAAGGCGGGCGGATCACGAGGTCAGGAGATTGAGACCATCCTGGCTAACATGGTGACACCCTGTCTCTAGAAATATATAAAAAAATTAGCCAGGCATGGTGGCGGGCACCTGTAGTCCCAGCTACTCAGGAGGCTGAGGCAGGAGAATGGCGTGAACCCGGGAGGTGGAGCTTGCAGTGAGCCAAGATCGTGCCACTGCACTCCGGACTGGGCAACAGAGTGAGACTCTGTCTCAAAAAAAAAAAAAAAAATTAGCCAGGCGTGGTGGGAGGGCACCTGTAATCCCAGCTACTCAGGAGGCTGAGGCAGGAGAATCGCTTGAACTCAGGAGGCAGCGGTTGCAGTGAGCCGAGATCGCGCCATTGCGCTCCAGCCTGGGCAACAAAAGTGAAACTCCTTCTCAAAAAAAAAAAAAAAA","GGCTGGGCGCAGTGGCTCACACCTGTAATCCCAGCACTTAGGGAAGCTGAGGCGAGTAGATCACCTGAGGTCAGGAGTTAGAGACCAGCCTGGCCATCATGGTGAAACCCCGTCTCTACTAAAGATACCAAAAATTAGCTGAGTGTGGTGCTGGGTGCCTGTAATCCCAGAAACTCAGGGTGCCTGTAATCCCAGCAACTCAGGGTGCCTTTAATCCCAGCAACTGAGGGTACCAGTAATCCCAGCAACTCAGGGTGTCTTTAATCCTAGCAACTGAGGGCACCTGTAATCCCAGCAACTCAGGAAGCTGAGACAGGAGAAGTACTTGAACCCAGAAGGCAGAGGTTGCAGTGAGCCGATATTGCACCATTGCACTCCAGTCTGGGCAACAAGAGTGAAACTCTGTCTCAAAAAAAAA"
"chr12","109523639","109523970","JH378108","45564157","45564495","57","63959482","GGCTGGGCGTGGTGGCTCACACCTGTAATCCCAGCACTTTGGGAAGCCAAGGCAGGTGGATCACCTGAGGTCAGGAGTTTGAGACCAGCCTGGCCAACGTGGTGAAACCCCATCTCTATTAAACATACAAAAATTAGCCGGGCATGGTGGTGGGCGCCTATAATCCCAGCTACTTAGGAAGCTGAGACAGGAGAATAACTTGAACCCAGGAGGCAGAGGTTGCAGTGAGCCAAGATCATGCCACTGCACTCCAGCCTGGGTGATGAGAGCGAAATTCCATCAAAGGAAGGAAGGAAGGAAGGAAGGAAGGAAGGAAGGAGAAAGAAAGAAAA","GCTAGGCAAGGTGGCTCATGCCTGTAATCCCAACATTTTGGGAGGCCGAGGCAGATGGATCACCTGAGGTTAGGAGTTCAAGACCAGCCTGGCCAACATGGTGAAACTCCATCTCTACTAAAAATACAAAAAATTAGCTTGGCACGGTGGTGGGTGCCTCTAATCCCAGCTGCTTGGGAGGCTGAGGCAGGAGAATCGCTTGAACTCAGGAGGTGGAGGTTGCAGTGAGCCAAGATCATGGCATTGCACTCCAGCCTGGGCGACAAGAGCGAGACTCCCTCTAAGAAAGAAAAGAAAGAAAAGAAAAGAAAAAAGGAAAGGAAAGGAAAGAAAGAGAAA"
"chr12","113239537","113240166","JH378118","18053084","18053501","265","95186453","GGCTGGGCGGGGTGGCTCACAACTGTAATCCCAGCACTTCGGGAGGCTGAGGTGGGTGGATCACCTGAGGTCAGGAGTTCGAGACCAGCCTGGCCAATGCAGCGAAACCCCATCTCTACTAAAAAATAACAAAAATTAGGCCAGGCTTGGTGGGTCACACCTGTAATCCCAGCACTTTGGGAGGCCAAGGTGGGCAGATCACGAGGTCAGGAGTTTGACACCAGCCTGACCAACACGATGAAACCCTGTCTCTACTACAAACACAAAAGTTAGCTGGGCGTGGTGGCCAGTGCCTGTAATCCCAGCTACTCAGGAGGCTGAGGCAGGAGAATCGCTTGAACCCGGGAGGCGGAGGTTGCATTGAGCTGAGATCAGGTCACTCTTCTCCAGCCTGGGTGACAGAGACAGACTGTGTCTCTAAATAAATAAATAAATAAATAAGTAACAAAAATTAGCTAGGTGTGGTGGCGAGTGCCTGTAATCCCAGCGACTTGGGAGGCTGAGGCAGGAGAATCACTTGAACCCAGGAGGTGGAGGTTGCAATGAGCCAAGATCACGCATTGCACTCCAGCCTGGGCAACAAGAGCGAAACTCTGTCTCAAAAAAAGAAAAAAAGAAAGGAAAAAAAAA","GGCTGGGCGCAGTGGCTCACACCTGTAATCCCAGCACTTAGGGAAGCTGAGGCGAGTAGATCACCTGAGGTCAGGAGTTAGAGACCAGCCTGGCCATCATGGTGAAACCCCGTCTCTACTAAAGATACCAAAAATTAGCTGAGTGTGGTGCTGGGTGCCTGTAATCCCAGAAACTCAGGGTGCCTGTAATCCCAGCAACTCAGGGTGCCTTTAATCCCAGCAACTGAGGGTACCAGTAATCCCAGCAACTCAGGGTGTCTTTAATCCTAGCAACTGAGGGCACCTGTAATCCCAGCAACTCAGGAAGCTGAGACAGGAGAAGTACTTGAACCCAGAAGGCAGAGGTTGCAGTGAGCCGATATTGCACCATTGCACTCCAGTCTGGGCAACAAGAGTGAAACTCTGTCTCAAAAAAAAA"
"chr12","120325823","120326490","JH378153","2355361","2355755","319","117970462","GGCTGTGCACAGTGGTTCACGCCTATTATCCCCGCACTTTGGGAGCCAGAGAGGGAGGATTGCTTGAGATCAGGAGTTCCAGACTAGCCTCGGCAACATAGTGAGACCCTGTCTCTACAAAATTAAAAAAAAAAAAACAAAAAAACTTGGGCCAGGCGTGGTGGCTCACGCGTGTAGTCCCAGCACTTTGGGAGGCTGAGGCAGGTGGATCACCTGAGGTCAGTAGTTCGAGACCAGCCTGTCCAACATGGTGAAATGGTGTCTCTACTGAAAATACAAAAATTAGCTGGGCGTGGTGGCGGGCACCTGTAATCCCAGCTACTCAGTAGGCTGAGGCAGGAGAATTGCTTGAACCCAGGAGGCAGAGGTTGCAGTGAGCCAAAGATTGCACCATTGCACTCCAGCAGCCTAGGTGACAGAGCCAGACTCTCACACACACACACACACACACACACACACACACACAAAACCCACAAAACCCAAAATTAGCCAGGTGTGGTGGTAGGCGCCTGTAATCCCAGCTACTTGGGAGGCTGAGACAGGAGAATCGCTTGAACCCCGGAGGCAGAGGTTGCAGTGAACCAAGATCATGCCATTACACTCTAGCCTCGGGGGCAAAAGCAAAACTCTGTTTCAAAAACAAACAAACAAACAAACAAACAAACAAA","GGCGGGGCATGGTGGCTCACACCTGTCATCCCAACACTTTGGGAGGCTGAGGCAGGCAGATCACCTGAGGTCAGGAGTTTGAGACCAGCCTGGCCAACATGGTGAAACCCCATCTCTACTAAAAATACAAAAATACAAAAAACCCCATCTCTACTAAAAATACAAAAAGCTTGTCTCTATTAAAAATACAAAAAACAAAAAACAAACAAAAAAAAAACCACCATGGTGGTGGGTGCCTATAATCCCAGCTACTCGGGAGGCTGAGGCAGGAGAATCGCTTGAACCCAGGAGGCAGAGGTTGCAGTGAGCCAAGATCCCACCATTGCACTCCAGCCTGGGCAACAGAGAGAGAGACTCTGCCTCAGAAAAAAGAAAGAAAGAAAGAAAGAAAGAAA"
"chr12","121860613","121860996","JH378109","23464169","23464522","95","98396444","GGCCGGGTGTGGTGGCTCATGCCTGTAATCCCAGCACTTTGAGGGGCTGAGGCAGGCGGATCACTTGAGTTCAGGAGTTGGAGACCAGCCTGGCGAATATGGTGAAACACCATCTACACACACACACACCCACACACACACACACACACACACACACACACACACACGGTGAAACACCATCTACACACACACACACACACACACACACCACCGCGTGGTAGCAGATGCCTGTAATCCCAGCTACCCGGGAGGCTGAGGCAGGATAATCGCTTGAACCCGCGAGGCAGAGGTTGCAGTGAGCTGAGATCATGCCATTGCACTCCAGCCTGGGCAACAAGGGCAAAACTCCATCTAAAAAAATAAATAAATAAAATAAAATAAAAA","GGCTGGGCATAGTGGCTCATGCCTATAATCCCAGCACTTTGGAAGGCTGAAGCGGGCAGATCACCTGAGGTCAGGAGTTCGAGATCAGCCTGGCCAACATGGTGAAAACCCATCTCTACTAAAACAAAAACAAAAACAAAAACAAAAACAACAAAAACAAAACAAAACAAAACAAAAAAACTACAAAAATTAGCGCCATGGTGGGTGTCTATAATCCCAGCTACTCGGGAGGCTGAGGCAGGACAATGTCTTGAACCCAGGAGGCAGAGGTTGCAGTGAGCTGAGATCTCGCTATTACACTCCAGCCTGGGCAACAAGAGTAAGACTACATCTCAAAAAAAAAAAAAAAGAAAA"
"chr12","122018318","122019202","JH378118","18053084","18053501","509","103965234","GGCCAGGCCCTGTGGCTCATGTCTGTAATCCCAGCACTTTCGGAGGCCAAGGCGGGTGGATCACTTGAGGTCAGGAGTTCGAGACCAGCCTGGCCAAAATGGTGCAACCACATCTGTACTAAAAAAAAATACAAAAATTAGGCCAGGGTCAGTTGCTCACGCCTATAATCCCAGAACTTTGGGAGGCCAAGGCAGGTGGGTCACCTGAGGTCAGGAGTTCGAGACCAGCCTGACCAACATAGTGAAACCCCATCTGTACTAAAAATACAAAAAATTAGACGGGCGTGGTGGCATGCATCTGTAGTCCCAGCTACTTGGGAGGCGGAGGTTGCCGTGAGCCGAGATCATGCCACTGCACTCCAGCCTGGGCAACAGGGCAAGACTCTGTCTCAAAAAATTATACAAAAATTAGTTGGGCGTGGCTGGGCACAGTAGCTGACGCCTGTAATCCAGCACTTTGGGAGACTGAGGTGTGTGGATCACGAGATCAAGAGATCGAGACCATCCTGGCCAACATGGTGAAACCCTGTCTCTACTAAAAATAGAAAAATTAGCTGGGCGTGGTAGTGTGCGCCTGTAGTCCTAGCTACTTGGGAGGCTGAGGCAGGAAAATCACTTCAACCTGGGATGCAGAGGTTGCAATGAGCCGAGTTTACACCACTGCACTCCAGCTTGTTGATAGAGCAAGACTCTGTCTCAAAGAAAAAAAAAAAATTAGTTGGGCATGGTGGCAGGCACCTATAATCCCAGCTACTTGGGAGGCTGAGGCAGGAGAACCGCTTGAACCCGGGAGGCAGAGGTTTCAGTGAGTAGAGATCGGTCCATTACACTCTAGCCTGGGCGATGAGCGAAACTCTGTCTCCAAAAAAAGAAAAAATAAAGAAA","GGCTGGGCGCAGTGGCTCACACCTGTAATCCCAGCACTTAGGGAAGCTGAGGCGAGTAGATCACCTGAGGTCAGGAGTTAGAGACCAGCCTGGCCATCATGGTGAAACCCCGTCTCTACTAAAGATACCAAAAATTAGCTGAGTGTGGTGCTGGGTGCCTGTAATCCCAGAAACTCAGGGTGCCTGTAATCCCAGCAACTCAGGGTGCCTTTAATCCCAGCAACTGAGGGTACCAGTAATCCCAGCAACTCAGGGTGTCTTTAATCCTAGCAACTGAGGGCACCTGTAATCCCAGCAACTCAGGAAGCTGAGACAGGAGAAGTACTTGAACCCAGAAGGCAGAGGTTGCAGTGAGCCGATATTGCACCATTGCACTCCAGTCTGGGCAACAAGAGTGAAACTCTGTCTCAAAAAAAAA"
"chr12","122956332","122956672","JH378262","266823","267148","60","122689509","GGCCAGGTGCGGTGGTTCATGCCCGTAATCCCAGCACTTTGGGAGGTGGAGGTGGGCAGATCACTTGAGGTCAGGCATTCAAGACCAGCCTGGCCAACATGGGGAAACCCTGTCTCTACTAAAAATAAAAAAAAATTAGCCGGGCGTGGTGGCAAGCGCCTGTATTCCCAGCTACTCGGGAGGCTGAGGCAGGAGAATCACTTGAACCCGAGGGTGGAGGTTGCAGTCAGCCGAGATCGCACCATTGCACTCCAGCCTGTGCGACAAGAGCAAGACTGTGTCTCAAAAACAAACAAACAAACAAACAAACAAACAAAAAAACCCAAAAGAGAGAGAGAGAA","GGCCGGGCGCGGTGGCTCAAGCCTGTAATCCCAGCACTTTGGGAGGCCGAGGCGGGTAGATCATGAGGTCAGGAGTTTGAGACCAGCCTGGCCAACATGGTGAAACCCCGTCTCTACTAAAAATACAAAAATTAGCCGGGCATGGTGGCCTGTGCCTGTAATCCTAGCTACCCAGGAAGCTGAGGCAGGAGAATTGCCTGAACCCAGGAGGCGGAGGTTGCGGTGAGCCGAGATCGTGCCATTGCACTCCAGCCTGGGTAACAAGAGCGAAACTCCGTCTCAAAAACAAACAAACAAACAAACAAAAACAAAAAACAAAAAACAAA"
"chr12","123747188","123747752","JH378206","6546474","6546861","228","117200714","AGATCACCTGGCCAACATAGTGAAACCCTGTCTCTACTAAAAATAATAATAATAATAATAAATAAAAATAAATAAAAAAATTAGGCCAGGTGCGGTGGCTCATGCCTGTAATCCCAGCATTTTGGGAGGCCAAGGCAAGGGATCAGAAGGTCAGGAGTTTGAGACCAGTCTGACCAACATGGTGAAACCCCCGTCTCTACTAAAAATACAAAAATTAGCCAGGTGTAGTGGTGTGTGTCTGTAATCCCAGCTACCCAGGAGGCTGAGGCAGGAGAATCGCTTGAACCCAGGAGGCGGAGGTTGCAGTGAGCCAAGATAGTGCCAGTGCACTCCAGTCTGGGCGAAAGAGCAAGACTCCGTCTCAAAAAAAAAAAAAAAAAAAAAAAAATAGCCGGGTGTGGTGGCACATGCCTGTAATCCCAGCTACTCGGGAGGCTGAGGCAGGAGAACTGCTTGAACCTGGGAGGCGGAGGTTGCAGTAAGCAGAGATCATGCCATTGCACTCCAGCCTGGGCGACAAGAGAAAAACTCCATCTTAAAAAAAACAAAAAAAAACAAAACAAAA","GGCCACACATGGTGGCTAACGCCTGTAATCCCAGCACTTTGGGAGGCCAAGTCGGGTGGATCATGAGGTCAGGAGACCAAGACCATCCTGGCCAAATGGTGAAACCCCGTCTCTACTAAAAATACAAAAATTAGCTGGGCATGGTGGCGTGTGCCTGTAATCCCAGCTACTCAGGAGGCTGAGGCAGGACAATTGCCTGAACCCAGGAGAATTAGCTGGGCATGGTGGCGTGTGCCTGTAATCCCAGCTACTCAGGAGGCTGAGGCAGGACAATTGCCTGAACCCAGGAGGCGAAGGTTGCGGTGAGCCGAGATTGTGCCATTGCACTCCAGCCTGGGTAACAAGAGCGACACTCTGTCTCAAAAAAAAAAAAAAAAAAAAAAAAAAA"
"chr12","126422618","126423253","JH378118","18053084","18053501","285","108369534","GGCCAGGTGCAGCGGCTCATGCCTGTAATCCCCGCACTTCAGGAGACTGAGGCAGGAGGATCACCTCAGGTCAAGAGCTCAAGACTAGCCCAGGCAACATAGTGAAACCCCGTCTATACTAAAAATACAAAAATTGGCTGGGTGCAGTGGCTCACGCCTGTAATCCCAGCACTTTGGGCGGCCAAGGCGGGCGGATCACGAGGTCAGGACATTGAGACCATCCTGGCTAAGACGATGAAACCCCGTCTCTACTAAAAATACAAAAAATTAACCAGGCGTGGTAGCAGGCACCTGTAGTCCCAGTTACTAGGGAGGCTGAGGCAGGAGAATGACGTGAACCCGGGAGATGGAGCTTGCAGTGAGCTGTGATCGCGCCACTGTACTCCAGCCTGGGCAACAGAGCGAGGCTCCGTCTAAAATAAATAAATAAAAAATAAAAATAAAAAATAAAAATAAAAAACAAATTAGCTGGGTGTGGTGGCAGGAACCTGTGATTCCAGCTACTCAGGAGGCTGAGGCAGGAGAATTGCTTGAGCCCAGGAGGTGGAGGTTGTAGTGAGCCGAGATCACACCATTGCACTCCAGCCTGGGTGACAAGAGTGAAATTCCGCCTCAAAAAAAAAAAAAAAAAAAAAA","GGCTGGGCGCAGTGGCTCACACCTGTAATCCCAGCACTTAGGGAAGCTGAGGCGAGTAGATCACCTGAGGTCAGGAGTTAGAGACCAGCCTGGCCATCATGGTGAAACCCCGTCTCTACTAAAGATACCAAAAATTAGCTGAGTGTGGTGCTGGGTGCCTGTAATCCCAGAAACTCAGGGTGCCTGTAATCCCAGCAACTCAGGGTGCCTTTAATCCCAGCAACTGAGGGTACCAGTAATCCCAGCAACTCAGGGTGTCTTTAATCCTAGCAACTGAGGGCACCTGTAATCCCAGCAACTCAGGAAGCTGAGACAGGAGAAGTACTTGAACCCAGAAGGCAGAGGTTGCAGTGAGCCGATATTGCACCATTGCACTCCAGTCTGGGCAACAAGAGTGAAACTCTGTCTCAAAAAAAAA"
"chr12","131579435","131580029","JH378118","18053084","18053501","255","113526351","GGCCAGCCGCAGTGGCTCACGCCTGTAATCCCCAAAATTTGGGAGGCCAAGGCGGGTGGATCACCAGAGGTCAGGAGTTCGAGACCAGCCTGGCCAGCATGGTGAAACCCCATCTCTACTAAAAATACAAAAAATTAAATCCCAGCACCATGGGAGGCCAAGGCAGGCGGATCACGGGGTCAGGAGATCAAGACCATCCTGCTAATACGGTGAAACCCCATCTTTACTAAAAATACAAAAATTTAGCCAGGCGTGGTGGTGGGCGCCTATAGTCCCAGCTACTCAGGAGGCTGAGGCAGGAGAATGGCATGAACCCGGGAGGCAGAGCCTGCAGTGAGCCGAGAACGCGCCATCACACTCCAGCCTAGGCAACAGAGCAAGACTCCGGCAAAAATAAATAAAAAAAATAATAATAATAATAAAATAAATAAATAAATAAATAAATTAGCTGGGTATTGTGGGGTGGGCCTATAATCCCAGCTACTCAGGAGGCTGAGGCAGGAGAATCACTTGAACCCTAGAGGTGGAGGTTGCAGTGAGCCAAGATTGCGCCACTGCACTCCAGCCTGGGTGACAAGAGTGAAACTTCGTCTCA","GGCTGGGCGCAGTGGCTCACACCTGTAATCCCAGCACTTAGGGAAGCTGAGGCGAGTAGATCACCTGAGGTCAGGAGTTAGAGACCAGCCTGGCCATCATGGTGAAACCCCGTCTCTACTAAAGATACCAAAAATTAGCTGAGTGTGGTGCTGGGTGCCTGTAATCCCAGAAACTCAGGGTGCCTGTAATCCCAGCAACTCAGGGTGCCTTTAATCCCAGCAACTGAGGGTACCAGTAATCCCAGCAACTCAGGGTGTCTTTAATCCTAGCAACTGAGGGCACCTGTAATCCCAGCAACTCAGGAAGCTGAGACAGGAGAAGTACTTGAACCCAGAAGGCAGAGGTTGCAGTGAGCCGATATTGCACCATTGCACTCCAGTCTGGGCAACAAGAGTGAAACTCTGTCTCAAAAAAAAA"
"chr12","131843868","131844452","JH378118","18053084","18053501","244","113790784","GGCTGGGTACGGTGGCTCAGGTCTGTAATCCCAACACTTTGGGAGTCCGAGACGCATGGATCACCTGAGGTCAGGAGTTTGAGACCAGCCTTGCCAACATGGTGAAACCCATCTCTACTAAAAATACAAAAAGTAGCTGGGAGTGGCTGGGCGCAGAGGCTCACGCCTGTAATCCCAGCACTTTGGGAGGCCGAGGCGGGTGGATCACGAGGTTAAGAGATTGAGATCAGCCTGGCCAACATGGTGAAACCCCGTCTCTTCCAAAAATACAAAAATTAGCTGGGCGTGGTGGCGCACGCCTGTAATCCCAGCTACTCGGGAGGCTGAGGCAGGAGAATCACTTGAACTCAGGAGGCAGAGGTTGCAGTGAGCCGATATTGTGCCACTGCACTCTAGCATGGGCGACCGGGCGAGACTCCGTCTCAAAAAAAAAAATTAGCTGGGAGTGATGGTGGGCACCTGTAATCCCAGTGACTCAGGAGGCTGAGGCAGGAGAATCGCTTGAACCCGGGAGGTGGAGGTTGCAGTGAGCTGAGATCCCACCACTGCACTCCAGCCTGGGCGACAAGAGCAAAACTCCATCTC","GGCTGGGCGCAGTGGCTCACACCTGTAATCCCAGCACTTAGGGAAGCTGAGGCGAGTAGATCACCTGAGGTCAGGAGTTAGAGACCAGCCTGGCCATCATGGTGAAACCCCGTCTCTACTAAAGATACCAAAAATTAGCTGAGTGTGGTGCTGGGTGCCTGTAATCCCAGAAACTCAGGGTGCCTGTAATCCCAGCAACTCAGGGTGCCTTTAATCCCAGCAACTGAGGGTACCAGTAATCCCAGCAACTCAGGGTGTCTTTAATCCTAGCAACTGAGGGCACCTGTAATCCCAGCAACTCAGGAAGCTGAGACAGGAGAAGTACTTGAACCCAGAAGGCAGAGGTTGCAGTGAGCCGATATTGCACCATTGCACTCCAGTCTGGGCAACAAGAGTGAAACTCTGTCTCAAAAAAAAA"
"chr13","82130","82738","JH378118","18053084","18053501","257","17970954","GGTGGGGTGCAGTGGCTCACACCAGTAATCCCAACACTTTGGGAGGCTGAGGCAGGCAGATCCCCTGAGGTCAGGAGTTCAAGACCAGCCTGGCAAACATGGTGAAACCTGTATCTAGGTTTGGCGCGGTGGCTCACGCCTGTAATCCCAGCACTTTGGGAGGCCGAGATGGGTGGATCACGAGGTCAGGAGATCAAGACCATGATCTCCTAACATGGTGAAACCCCGTTTCTACTAAAAATACAAAAAAATTAGTCAGGTGTGGTGGCGGGCGCCTGTAATCCCAACTATTCGGGAGGCTGAGGCAGGAGAATTGCGGGAACCCAGGAGGCAGAGGTTGCAGTGAGCCGAGATCGCACCACTGCACTCCAGCCTGGGCAAGAAAGAGAGACTCCGTCTCATAAAAAAAAAGAAAGAAACCCCATCTCTACTAATAATACAAAAAAATTAGCTGGGCAGTAGTGGCACATGCCTGTAATCCTACCTCCTCAGGAGGCTGCGGCAGGAGAATCGCTTGAACCCAGGGGGCGGGGGTTGCAATGAACTGAGATTGCACTATTGCACTCCAGCCTGGGCAACAAGAGCAAAATTCTGTCTCAAAAAATAAAA","GGCTGGGCGCAGTGGCTCACACCTGTAATCCCAGCACTTAGGGAAGCTGAGGCGAGTAGATCACCTGAGGTCAGGAGTTAGAGACCAGCCTGGCCATCATGGTGAAACCCCGTCTCTACTAAAGATACCAAAAATTAGCTGAGTGTGGTGCTGGGTGCCTGTAATCCCAGAAACTCAGGGTGCCTGTAATCCCAGCAACTCAGGGTGCCTTTAATCCCAGCAACTGAGGGTACCAGTAATCCCAGCAACTCAGGGTGTCTTTAATCCTAGCAACTGAGGGCACCTGTAATCCCAGCAACTCAGGAAGCTGAGACAGGAGAAGTACTTGAACCCAGAAGGCAGAGGTTGCAGTGAGCCGATATTGCACCATTGCACTCCAGTCTGGGCAACAAGAGTGAAACTCTGTCTCAAAAAAAAA"
"chr13","856081","856721","JH378118","18053084","18053501","273","17197003","GACTGGGCGCAGTGGCTCACCCATGTAGTCCCAGCACTTTGGGAGGCCAAGGTAGGAGGATCACCTGAGGTCAGGAGTTCAAGACCAGCCTGGCCAACATGGTGAAACCCCGTCTCTATTAAATATATAATTATTAGCTCTCTATTAAAAATACAAAAATTAGGCCGGGCGTGGTGGCTCACGCCTGTAATCCCAGCACTTTGGGAGGCCGAGGCAGGTGGATCACGAGGTCAGGAGTTCAAGACCAGCCTGGCCAAGATGCTGAAACCCCGTCTCTACTAAAAATACAAAAAAAAACTAGCCAGGCGTGGTGGCGGGCGCCTGTAATCCCAGCCACTCGGAAGGCTGAGGCAGAGAACTGCTTGAACCCGGGAGGCAGAGCTTGCAGTGAGCCGAGATGGCACCACTGCACTCCAGCCTGGGGGACAGAGCGAGACTCATCTAAAAAAAAAACACAAAAATAAAAATACAAAAATTAGCTGGGCGTGGTGGCGGGTGCCTGTAATCCCAGCTACTTGGGAGGCTGAGGCAGGAGAATCACCTGAACCCAGGAGGCAGAGGTTGCAGTGAGCCAAGATTGTGCCATTGCACTCCAGCCTGGGCAACAAGACTAAAACTCCGTCTCAAAAAAAAAAAAAGAA","GGCTGGGCGCAGTGGCTCACACCTGTAATCCCAGCACTTAGGGAAGCTGAGGCGAGTAGATCACCTGAGGTCAGGAGTTAGAGACCAGCCTGGCCATCATGGTGAAACCCCGTCTCTACTAAAGATACCAAAAATTAGCTGAGTGTGGTGCTGGGTGCCTGTAATCCCAGAAACTCAGGGTGCCTGTAATCCCAGCAACTCAGGGTGCCTTTAATCCCAGCAACTGAGGGTACCAGTAATCCCAGCAACTCAGGGTGTCTTTAATCCTAGCAACTGAGGGCACCTGTAATCCCAGCAACTCAGGAAGCTGAGACAGGAGAAGTACTTGAACCCAGAAGGCAGAGGTTGCAGTGAGCCGATATTGCACCATTGCACTCCAGTCTGGGCAACAAGAGTGAAACTCTGTCTCAAAAAAAAA"
"chr13","1002205","1002813","JH378118","18053084","18053501","256","17050879","GGCGGGGTGCAGTGGCTCACACCAGTAATCCCAACACTTTGGGAGGCTGAGGCAGGCAGATCACCTGAGGTCAGGAGTTCAAGACCAGCCTGGCAAACATGGTGAAACCTGTATCTAGGTTGGGCGCGGTGGCTCACGCCTGTAATCCCAGCACTTTGGGAGGCCGAGATGGGCGGATCACGAGGTCAGGAGATCAAGAACATGATCTCCTAACATGGTGAAACCCCGTTTCTACTAAAAATACAAAAAAATTAGTCAGGTGTGGTGGCGGGCGCCTGTAGTCCCAACTATTCGGGAGGCTGAGGCAGGAGAATTGCGGGAACCCAGGAGGCAGAGGTTGCAGTGAGCCGAGATCGCACCACTGCACTCCAGCCTGGGCAAGAAAGAGAGACTCCGTCTCATAAAAAAAAAAAAAAGAAACCTCATCTCTACTAATAATACAAAAAATTAGCTGGGCAGTAGTGGCACATGCCTGTAATCCTACCTCCTCAGGAGGCTGCGGCAGGAGAATCGCTTGAACCCAGGGGGCGGGGGTTGCAATGAACCGAGATTGCACTATTGCACTCCAGCCTGGGCAACAAGAGCAAAATTCTGTCTCAAAAAATAAAA","GGCTGGGCGCAGTGGCTCACACCTGTAATCCCAGCACTTAGGGAAGCTGAGGCGAGTAGATCACCTGAGGTCAGGAGTTAGAGACCAGCCTGGCCATCATGGTGAAACCCCGTCTCTACTAAAGATACCAAAAATTAGCTGAGTGTGGTGCTGGGTGCCTGTAATCCCAGAAACTCAGGGTGCCTGTAATCCCAGCAACTCAGGGTGCCTTTAATCCCAGCAACTGAGGGTACCAGTAATCCCAGCAACTCAGGGTGTCTTTAATCCTAGCAACTGAGGGCACCTGTAATCCCAGCAACTCAGGAAGCTGAGACAGGAGAAGTACTTGAACCCAGAAGGCAGAGGTTGCAGTGAGCCGATATTGCACCATTGCACTCCAGTCTGGGCAACAAGAGTGAAACTCTGTCTCAAAAAAAAA"
"chr13","1091634","1092284","JH378118","18053084","18053501","291","16961450","GGCCAGACATGGTGGCTCACGCTTGTAATCCCAGCACTTTGGGAGGCCAAGGCAGGCAGATCACCTGAGGTCAAGAGTTCAAGACCAGCCTGGCCAAAATGGTGAAACCCCATCTCTACTAAAAATACAAAAAAAAAAAAAAAAAAGCCAGGCGCAGTGGCTCACGCCTGTAATCCTAGCACTTTGGGAGGCCGCACGTCTGTAATCCTAGCACTTTGGGAGGCCGAGGCGGGTGGATCACCTGAGGTAAGGAGTTTGAGACCAATCTGGCCAACATGGCGAAACCCCGTCTCTACTAAAAATACAAAAATTAGCCGGGCGTGGTGGCAGGCCCCTATAATCCCAGCTACTCAGGAGGCTGAAGCAGGAGAATTGCTTGAACCCAGGGGGCAGAGGTTGCCATGAACCAAGATCGTGCCACTTCGCTCCAGCCTGAGCAAAAGAGCGAAACTCTGTCTCAAAAAACAAAAACAAAAAAATCAGCCAGATGTGGTGGCAGGTAGCTGTAATCCCAGCTAGTTGGGAGGCTGAGGCAAGAGAATTGCTTGAACCCAGGAGGCGGAGGTTGCAGTGAGCTGGGATTGCACCATTGCACTCCAGCCTGGGCACCAAGAGTGAAACTCCATCTCAAACCGAAAAAAAAAAGAAAAA","GGCTGGGCGCAGTGGCTCACACCTGTAATCCCAGCACTTAGGGAAGCTGAGGCGAGTAGATCACCTGAGGTCAGGAGTTAGAGACCAGCCTGGCCATCATGGTGAAACCCCGTCTCTACTAAAGATACCAAAAATTAGCTGAGTGTGGTGCTGGGTGCCTGTAATCCCAGAAACTCAGGGTGCCTGTAATCCCAGCAACTCAGGGTGCCTTTAATCCCAGCAACTGAGGGTACCAGTAATCCCAGCAACTCAGGGTGTCTTTAATCCTAGCAACTGAGGGCACCTGTAATCCCAGCAACTCAGGAAGCTGAGACAGGAGAAGTACTTGAACCCAGAAGGCAGAGGTTGCAGTGAGCCGATATTGCACCATTGCACTCCAGTCTGGGCAACAAGAGTGAAACTCTGTCTCAAAAAAAAA"
"chr13","1108894","1109525","JH378118","18053084","18053501","281","16944190","GCCGGGTGCAGTGACTCACGCCTGTAATCCCAGGACTTTGGGAGGCCAAGGCGGGTGGATTGCTTGAGGTCAGGAGTTCAAGACCAGCCTGACCAGCCGGGCGCGGTGGCTCACACCTGTAATCCCAGCACTTTGGGAGGCTGAGATGGGCGGATCACAAGGTCAGGAGATCGAGACCATCCTGGCTAACACGGTGAAACCCCATCTCTACTAAAATTACAAAAAATTGGCCGGGCGTGGTTGCGGGCGCCTGTAGTCCCAGCTACTCAGGAGGCTGAGGCAGGAGAATGGTGTGAACCTGGGAGGCAGAGCTTGCAGTGAGTGAGCTGAGATCGGGCCACTGCACTCCAGCCTGGGCGACAAAGGGAGACTCTGTCTCAAAAAAAAAAAAAAAAAAAAGACCATCCTGACCAACATGGTGAAACCCCATCTCTACTAAAAATACAAAAATTAGCCAGGCGTGGTGGTGGGCAGCCTATAATCCCAGCTACTCGGGAGGCTGAGGCAGGAGAATTGCTTGAACCTGGGAGGTGGAGGTTGCAGTGAGCCGAGATCACACCTTGCACTCCAGCCTGGGTGACAGACAGAATGAGACTCTGTCTCAAAAAAAAAAAAAAAAAAAAAAAAAAAAA","GGCTGGGCGCAGTGGCTCACACCTGTAATCCCAGCACTTAGGGAAGCTGAGGCGAGTAGATCACCTGAGGTCAGGAGTTAGAGACCAGCCTGGCCATCATGGTGAAACCCCGTCTCTACTAAAGATACCAAAAATTAGCTGAGTGTGGTGCTGGGTGCCTGTAATCCCAGAAACTCAGGGTGCCTGTAATCCCAGCAACTCAGGGTGCCTTTAATCCCAGCAACTGAGGGTACCAGTAATCCCAGCAACTCAGGGTGTCTTTAATCCTAGCAACTGAGGGCACCTGTAATCCCAGCAACTCAGGAAGCTGAGACAGGAGAAGTACTTGAACCCAGAAGGCAGAGGTTGCAGTGAGCCGATATTGCACCATTGCACTCCAGTCTGGGCAACAAGAGTGAAACTCTGTCTCAAAAAAAAA"
"chr13","2122775","2123360","JH378110","30295293","30295690","270","28172518","GTAATCCCAGCACTTCGGGAGGCTGAGGTGGGCAGATCCCCTGAGGCCAGGAGTTCGAGACCAGCCCGGCCAACATGGCAAAACCCCATCTCTACTAAAAATACAAAAAATTAGCCAGGCCTGGGCTGGGCATGGTGGCTCACTCCTGTAATCCCAGCACTCTGGGAGGCTGAGACAGGTAGATCACGAGGTCAGGAGTTTAAGACCAGCCTGGCCAACATAGTGAAACACAGTATCTACTAAAAAAAAAAAAAAAAAAAAAAAAAAATATTAGCCAGGCGTGGTGGCAGGCGCCTATAGTCCCGGGTACTTGGGAGGCTGAGGGAGGAGAATCACTTGAACCGAGGAGGCAGAGTTTGCAGTGAGCCGAGATCGCGCCATCGCAGTCCAGCCTGGGTGACAGAGCGAGACGCTGTCTCAAAAACAAACAAACAAACAAAAAAATTAGCCAGGCCTGGTGGCAGGTTCCTATAATCCCAGCTACTCGTAAGGCTGAGGCGGAGGCTGCTGTGAGCCAAGATCGCGCCATTGCACTCCAGCCTGGGCAACAAAAGTGAAACTCTGTCTCAAAAAAAAAAAAAAAAAA","GGCTAGGCATGGTAGCTTACGCCTGTAATCCCAGCACTTTGGGAGGCCGACGCAGGCAGATCACTTGAGATCAGGAATTGAGACCAGGAGTTTGAGACCAGCCTGGCCAACATGGTGAAACCCTGACTCTACTAAAAATACTCTACTAAAAAAGTAGAAAAAGGGGCCAGGCACAGTGGCTTATGCCTGTAATCCAAGCACTTTGGGAGGCCGCAGCGGGCAGAGTTCGAGACCGGGCGTGGTGGTACATGCCGGTAATCCTACCTACTCAGGATGCTAAGGCAGGAGAATCGCTTGAACCCGGGAGGCAGAGGTTTCAGTGAGCTGAGATTGCACAATTTCACTCCATCCTGGAGAACAAGAGCGAATCTCAGTCTCAAAAAAAAAAAAAAAAAAGA"
"chr13","12885812","12886412","JH378118","18053084","18053501","246","5167272","GCCGGGCGCAGTGGCTCACGCCTGGATTCCCAGCACTTTGGGAGGCTGAGGTGGGTGGATCACCTGAGGTCAGGAGTTCAAGACCAGCCTGGCCAATGTGGTGAAACCCTGTCTCTACTAAAAATACAGAAATTGGCCAGGCGCGGTGGCTCACACCTGTAATCCCAGCACTTTGGGAGGCTGAGACAGGTGGATCACGAGGTCAGGAGATCGAGACCATCCTGGCTAACACAGTGAAACCCTGTCTCTACTAAAAAATACAAAAAATTAGCCGGGCGTGGTGGCGGGCGCCTGTATTCCCAGCTACTCAGGAGGCTGAGGCAGGAGAATGGTGTGAACCTGGGAGGCGGAGGTTGCAGTGAGCCGAGATCGTGCCACTGCACTCCAGCCTGGGCGACAGAGCGAGACTCCATCTCAAAAAAAAAAACAAAAAAACAAAAATTAGCCCGGTGTGGTGGCAGACACCTGTAATCCCAGCTACTTGGAAGGCTGAGGCAGGAGAATTGCTTGAACCTGGGAGGTGGAGGCTGCAGTGAGCCAAGATTGCGCCATTGAACTCCAACCTAGGCGACAAGAGTGAAATTCTGTCTCAAAAAAAAAA","GGCTGGGCGCAGTGGCTCACACCTGTAATCCCAGCACTTAGGGAAGCTGAGGCGAGTAGATCACCTGAGGTCAGGAGTTAGAGACCAGCCTGGCCATCATGGTGAAACCCCGTCTCTACTAAAGATACCAAAAATTAGCTGAGTGTGGTGCTGGGTGCCTGTAATCCCAGAAACTCAGGGTGCCTGTAATCCCAGCAACTCAGGGTGCCTTTAATCCCAGCAACTGAGGGTACCAGTAATCCCAGCAACTCAGGGTGTCTTTAATCCTAGCAACTGAGGGCACCTGTAATCCCAGCAACTCAGGAAGCTGAGACAGGAGAAGTACTTGAACCCAGAAGGCAGAGGTTGCAGTGAGCCGATATTGCACCATTGCACTCCAGTCTGGGCAACAAGAGTGAAACTCTGTCTCAAAAAAAAA"
"chr13","17397308","17397692","JH378108","45564157","45564495","89","28166849","GCCGGGCGCAGTGGCTCATGCCTGTAATCCCGGCACTTTGGGAGGCCAATGCGGATGGATCACCTGAGGTCAGGAGTTCGAGACCAGCCTGGCCAACATAGTGAAACCCTATCTCTACTAAAAATACAAAACATTAGCCGGGCATAGTGGTGGGTGCCTGTAATCCCAGCAACTTGTGAGGCTAAGGCAGGAGAATCACTTGAACCCAGGAGGCAGAGGTTGCAGTGAGTTGAGATCCAGCCATTGCACTCCAGCCTGGGCAACAGGAGCAAAACCCTGTCTCAGAAGAAAAGAAAGGAAGAAAGGAAGGAAGGAAGGAAGGAAGGAAGGAAGGAAGGAAGGAAGGAAGGAAGGAAGGAAGGAAGGGAAGGAAAAAGGAAAAAAA","GCTAGGCAAGGTGGCTCATGCCTGTAATCCCAACATTTTGGGAGGCCGAGGCAGATGGATCACCTGAGGTTAGGAGTTCAAGACCAGCCTGGCCAACATGGTGAAACTCCATCTCTACTAAAAATACAAAAAATTAGCTTGGCACGGTGGTGGGTGCCTCTAATCCCAGCTGCTTGGGAGGCTGAGGCAGGAGAATCGCTTGAACTCAGGAGGTGGAGGTTGCAGTGAGCCAAGATCATGGCATTGCACTCCAGCCTGGGCGACAAGAGCGAGACTCCCTCTAAGAAAGAAAAGAAAGAAAAGAAAAGAAAAAAGGAAAGGAAAGGAAAGAAAGAGAAA"
"chr13","22900952","22901303","JH378198","5062782","5063109","63","17838170","GGCCGGGCACAGTGGCTCACGCCTGTAATCCCAGCACTTTGGGAGGCCAAGGCAGGCGGGTTACCTGAGGTCAGGAGTTCGAGACCAGCCTGGCCAACATGGCAAAATCCTGTCTCTACTAAAAATACAAAATTAGCCGAATGTGGTGGCAGGTGCCTATAATCCCACCTACTCGGGAGGCTGAGGCAGGAGAATCACTTGAACCCGGGAGGTGGAGGTTGCAGTGAGCTGAGATCAAGCCATTGCACTCCAGCCTGGGCAAAAAGAGCGAAACTCCATCCCAAAATAAATACATACATACATACATACATACATACATACATACATACATACATACATAAAAAAGCAAAAA","GCCAGGCATGGTGGCTCACGCCTATAATCTCAGCACTTTGGGAGGCTGAGGCAGGCAGATCACTTGAGGTCAGGAGTTCAAGACCAGCCTGGCCAACATGGTGAAACCCTGGCTCTACTAAAAATACAAAAATTAGCCGGGTGTGGTGGCACGTGCCTATAATCCCAGCTACTCAGGAGGCTGAGGCAGAAGAATCGCTTGAATCCAGGAGGTGGAGGTTGCAGCGAGCCGAGATCACACCATTGGACTCCAGCCTGGGTGACAAGAGCGAAACTCCATCTCAAAATAAATAAATAAATACATAAAATTAAAAATAAATAAATAAATA"
"chr13","23490309","23490940","JH378118","18053084","18053501","275","5437225","GGCCAGGCTTGGTGGCTCGTGCCTATAATCCCAGCACTTTGGGAGGCCAAGGTGTGTGGCTCACTTGAGGTCAGGAGTTTGAGACCAGCATGGCCAACATGGTGAAACCTCGTCTCTACTAAAAATACAAAAAAATAGCTGGGCGCGGTGCCTCACGCCCTGTAATCCCAGCACTTTCGGAGGCCAAGGCGGGTGGATCATGAGGTCAGGAGATCGAGACCATCCTAGCTAACATGGTGAAACCCCGTCTCTACTAAAAAAATACAAAAAATTAGCCGGGCGTGGTGGCGGGAGCCTGTAGTCCCAGCTACTCAGGAGGCTGAGGCAGGAGAATGGCGTGAACCCAGGAGGCAGAGCTTGCAGTGAGCCAAGATCGTGCCACTGTACCCCAGCCTCGGCGACAGAGCAAGACTCTGTCTCAAAAAAAAAAACCAAACAATAATAATAATAACAATTAGCTGGGCGTGGAGGCGGGCGCCTGTAATCCCAGCTATTCAGGAGGCTGAGGCAGGAGAATCGCTTGAACCCAGGAGGCAGAGGTTGCAGTGAGTGGAGATCACGCCATTGCACTCTGGCCTTGGCAACAAGAGTGAAACTCAGTCTCAAAAAAATAAATAAATAAAAATAAAAAA","GGCTGGGCGCAGTGGCTCACACCTGTAATCCCAGCACTTAGGGAAGCTGAGGCGAGTAGATCACCTGAGGTCAGGAGTTAGAGACCAGCCTGGCCATCATGGTGAAACCCCGTCTCTACTAAAGATACCAAAAATTAGCTGAGTGTGGTGCTGGGTGCCTGTAATCCCAGAAACTCAGGGTGCCTGTAATCCCAGCAACTCAGGGTGCCTTTAATCCCAGCAACTGAGGGTACCAGTAATCCCAGCAACTCAGGGTGTCTTTAATCCTAGCAACTGAGGGCACCTGTAATCCCAGCAACTCAGGAAGCTGAGACAGGAGAAGTACTTGAACCCAGAAGGCAGAGGTTGCAGTGAGCCGATATTGCACCATTGCACTCCAGTCTGGGCAACAAGAGTGAAACTCTGTCTCAAAAAAAAA"
"chr13","25802576","25803171","JH378118","18053084","18053501","256","7749492","CCAGGCACGGTGGCTCACGCCTGTAGTCTCAGCACTTTGGGAGGCTGAGGCAGGCAGATCATGTGAGGTCAGGGGTTCGAGACCAGCCTGGCCAACATGACGAAACCCCATCTCTACTAAAAATACAAAAATTACTGGCCGGGCACAGTGGCTCACACCTGTAATTCCAGCACTTTGGGAGGCCAAGATGGGTGGATCATGAGGTCAGGAGTTCAAGACCAGCCTGGCCAAGATGGTAAAACCCCGTCTCTACTAAAAATACAAAAAATTAGCCGGACATGGTGGCGGGCGCCTATAATCCCAGATACTTGGGAGGCTGAGGCAGAGAATTGCTTGAACCCGGGAGGTGGAGAGGTTGCAGTGAGCCGAGATCGTACCACTGTACTCCAGCCTGGGCGACAGAGCAAGACTCCGTCTCAAAAAAAAAAAAAAAAATTTGCGGGCGTGGTGGTGGGTGCCTGTAATCCCAGGCTCTCGGGAAGCTGAGTCAAGAGAATTGCTTGAAACTGGGAGGCAGAGGTTACAGGGGGCCAAGATCACGCTATTGCACAACAGCCTGGGTGACAAGAGTGAAATTCCGTCTCAAAAAAAAAAAA","GGCTGGGCGCAGTGGCTCACACCTGTAATCCCAGCACTTAGGGAAGCTGAGGCGAGTAGATCACCTGAGGTCAGGAGTTAGAGACCAGCCTGGCCATCATGGTGAAACCCCGTCTCTACTAAAGATACCAAAAATTAGCTGAGTGTGGTGCTGGGTGCCTGTAATCCCAGAAACTCAGGGTGCCTGTAATCCCAGCAACTCAGGGTGCCTTTAATCCCAGCAACTGAGGGTACCAGTAATCCCAGCAACTCAGGGTGTCTTTAATCCTAGCAACTGAGGGCACCTGTAATCCCAGCAACTCAGGAAGCTGAGACAGGAGAAGTACTTGAACCCAGAAGGCAGAGGTTGCAGTGAGCCGATATTGCACCATTGCACTCCAGTCTGGGCAACAAGAGTGAAACTCTGTCTCAAAAAAAAA"
"chr13","32719602","32720198","JH378118","18053084","18053501","266","14666518","TAGCTCACACCTGTAATCCCAGCCCTTTGGGAGGCCAAGTTGTGTGGATCAATTGAGGTCAGGAGTTCGAGACCAGCCGGGCCAACATGGTGAAACCCTGTCTCTACTAAAAATACAAAATGTGGGCTGGGCGCATTGGCCCACGCCTGTAATTCCAGTGCTTTGGGAGGCCGAGGGGAGTGGATCTCGAGGCCAGGAGTTCAAGACCAGCCTGACCAACATGGTGAAACCCCGTCTCTACTAAAAATACAAAAATTAGCTGGGTGTGGTGGCACATGCCTGTAATCCCAGCTACTCAAGAGGCTGAGGCAAAAGCATCTCTTGAACCCGGGAGGCGGAGGTTGCAGCAAGCCAAGCTCATGCCACTGCACTCTAGCCTGAGTGACAGAGCCAGATTCTGTCTCAAAAAAAAGAAAACCATACAAAAATACAAAAAGTTAGCCAGGCATTGTGGTGGGCACCTGTAATCCCAGCTACTTGTGAGTGTGAGGCTGGAGAATCGCTTGAATCTGGGGGTGGAGTTTGCGGTGAGCTGAGATCACGCCATTGCACTCCAGCCTGGGCAATAAGAGCGAAAGTCCATCTCAAAAAAAAAAA","GGCTGGGCGCAGTGGCTCACACCTGTAATCCCAGCACTTAGGGAAGCTGAGGCGAGTAGATCACCTGAGGTCAGGAGTTAGAGACCAGCCTGGCCATCATGGTGAAACCCCGTCTCTACTAAAGATACCAAAAATTAGCTGAGTGTGGTGCTGGGTGCCTGTAATCCCAGAAACTCAGGGTGCCTGTAATCCCAGCAACTCAGGGTGCCTTTAATCCCAGCAACTGAGGGTACCAGTAATCCCAGCAACTCAGGGTGTCTTTAATCCTAGCAACTGAGGGCACCTGTAATCCCAGCAACTCAGGAAGCTGAGACAGGAGAAGTACTTGAACCCAGAAGGCAGAGGTTGCAGTGAGCCGATATTGCACCATTGCACTCCAGTCTGGGCAACAAGAGTGAAACTCTGTCTCAAAAAAAAA"
"chr13","51723360","51723682","JH378281","556601","556921","50","51166759","GCCAGGCGTGGTAGCTCACATGTCTATAATCTCAGCACTTTGGGAGGCCGAGGCGGGCGGATCACCTGAGGTCAGGAGTTCGAGACCAGCCTGGCCAACATGGTGAAATCCCATCTGTACTAAAAAAAAAAAAAAAAGTAAAAAAAAAAAAAAAATGGCCGGGTGTTGTGGTGGGAACCTGTAATCCCAATTACTCAGGAGGCTGAGGCAGGAGAATCGCTTGAACCCAGGAAGTGGAGGTTGCAGTGAGCTGAGATCATGCCATTGTACTCCAGCCTGGGTGACAAGAGCAAGACTCTTTTCATGAAAACAAACAAAAAAAA","GGCCGGGCGTGGCAGCTCAAGCCTGTCATCCCAGCACTTTGGGAGGCTGAGGCAGGCGGATCACCTGAGGCCAGGAGTTTGAGACCAGCCTGGCCAACATGGTGAAACCCCGTCCCTACAAAAAAAAAAAAAAAAAAAAAAAAAAAAAAAAAGGCTGGGCATGGTGGTGGGAGCCTGTACTCCCAGCTACTCGGGAGGCTGAGGCTGGAGAATGGTTTGAACCAGGAATGTGGAGGTTGCAGTGAGCTGAGATTGTGCCATTGCACTCCAGCCTGGGCAAAAAGAGCGAAACTCTCTCTCAGAAAAAAAAAAAAAAAAAAA"
"chr13","54359592","54359946","JH378153","13131650","13131982","61","41227942","GGCTGGGTGCGGTGGCTCACACCTGTAATCCCAGCACTTCGGGAGGCTGAGGCGGGTGGATCACCTGAGGTCAGGAGTTCAAGACCAGCCTGGATAGCATGGCGAAACCTCATCTCTACTAAAAATACAAAAGTTAGCTGGGCGTGGTGGTGGGCGCCTGTAATCCCAGCTACTCAGGAGGCTGAGGCAAGAGAATTGCTTGAACCCGGGAGACGGAGGTTGCAGTGAGTGGAGATAGTGCCATTGCACTCCACCCTGGGCAACAAGAGCGAAACCCTTGTTGTCCCAAAATAAAATAAAATAAAACAAAATAAAATAAAATAATAAAGAAAGAAAGAAAAAAGAAAAGAAAAAA","GGCTGGGCGCGGTGGCTCACGCCTGTAATCCCAGCACTTTGGGAGGCCGAGGCGGGTGGATCATGAAGTCAAGAGATCAAGACCATCCTGGTCAATATGGTGAAACCCGTGTCTACTAAAAATACAAAAATTAGCTGGGCATGGTGGCGCGTGCCTGTAATCCCAGCTACTCAGGAGGCTGAGGCAGGAGAATTGCCTGAACCCAGGAGGCGGAGGTTGTGGTGAGCCGAGATCGCGCCATTGCACTCCAGCCTGGGTAACAAGAGCGAAACTCTGTCTCAAAAAATAAATAAATAAAATAAAATAAAATAAAATAAAATAAAATAAAATAAA"
"chr13","56689453","56689798","JH378203","7854047","7854373","65","48835406","GCCAGTTGTGGTGGCTCATGCCTGTAATCCCAGCACTTCAGGAGGCTGAGGCAGGTGGATCACTTGAGGTCAGGAGTCTGAGACTGGCCTGGCCAACATGGTGAAACCCCGTCTCTACTAAAAATATAAAAATTAGCCAGGCATGGTGGCAGGCGCCTGTAATTCCAGCTACTTGGGAGGCTGAGGCAGGAGAATCACTTGAACCTGGGAGGTGGAAGTTGCAGTGAGCCAGAGGTTGCAGTGAGCTGAGATTGCACCATTGCACTCCAACCTAGGTGACAAGAGTGAAACTCTGTCTCAAAAAAAAAATAAAAAATAAAAAATAAAATGAAAATAAAAAGACAAA","GGGCACCGTGGCTCACGCCTGTAATCCCAGCACTCCAGGAGGCAGAGGCAGGTGGATCACCTGAGGTCAGGAGTTTGAGACCAGCCTGGCCAACGCAGTGAAACCCTGTCTCTACTAAAAATGCTAAAAAATTAGCTTGACGTGGTGGCGGGCACCTGTCATCCCAGCTACTTGGGAGGCTGAGGAAGGAGAATCACTTGAACCAGGGAGATGGAGGTTGCAGTGAGCTGAGATTGCACCATTGCACTCCAGCCTGGACAAGAGTAAAACTCCGTCTCAAGAATAAATAAATAAATAAATAAATAAATAAATAAATAAATAAATAAA"
"chr13","63900303","63900919","JH378118","18053084","18053501","253","45847219","CTGGGTACGGTGGCTCACACCTGTAATCCCAGCACTTTGGGAGGTCAAGGCAGATGGATCACCTGAGGTCAGGAGTTCATGACCAGCCTGATCAACATGGTGAAACCCCGTCTCTACTAAAAATACAAAAATTAGGCTGGGTGCAGCTGCCTATGCCTGTTATCCCAGCACTTTGGGAGGCTGAGGAGGGTGGATCACCTGAGGTTGGGAGTTCGAGACCAGCCTGACCAACAGGGAGAAAACTCATCTCTACTAAAAATACAAAATTAGCTGGATGTGGTGGCACATGCCTGTAATCCCAGCAACTCGAGAGGCTGAGGCAGGAGAATCACTTAAACCCCGGAGGCAGAGGTTGCAGTGAGCCAAGATCGTGCCATTGCACTCCAGCCTGGGCAATAATAGCGAAACTCCATCTCAAAAATAATGATAATAATAAGACAAATACAAAAATTAGCTGGACGTGGTGGTGGCTGCCTGTAATCCCAGCTATTTGGGAGGCTGAGGCAGGAGAATCGCTTGAACCCGGGAGGCAGAGGTTGCAGTGAGCCGAGATTGCACCATTGCACTCCAGCCTGGGCAGCAAAAAGTGAAACTCGGTCTCAAAATAAATAAATAAA","GGCTGGGCGCAGTGGCTCACACCTGTAATCCCAGCACTTAGGGAAGCTGAGGCGAGTAGATCACCTGAGGTCAGGAGTTAGAGACCAGCCTGGCCATCATGGTGAAACCCCGTCTCTACTAAAGATACCAAAAATTAGCTGAGTGTGGTGCTGGGTGCCTGTAATCCCAGAAACTCAGGGTGCCTGTAATCCCAGCAACTCAGGGTGCCTTTAATCCCAGCAACTGAGGGTACCAGTAATCCCAGCAACTCAGGGTGTCTTTAATCCTAGCAACTGAGGGCACCTGTAATCCCAGCAACTCAGGAAGCTGAGACAGGAGAAGTACTTGAACCCAGAAGGCAGAGGTTGCAGTGAGCCGATATTGCACCATTGCACTCCAGTCTGGGCAACAAGAGTGAAACTCTGTCTCAAAAAAAAA"
"chr13","64091159","64091580","JH378153","2794876","2795255","115","61296283","GCTGGGCACAGTGACTCACGCCTGTAATACCAGAACTTTGGGAGGCCGAGGTGGGCAGATCACCTGAGATCAGGAGTTCGAGACCAGCCTGGCCAACATGGTGAAACCCTGTCTCTATTAAAAATACAAAAATTAACATGGCACATGTATACATATGTAACAAACCTGCACATTGTGCACATGTACCCTAAAACTTAAAGTATGATAATAAAAAATAATAATCTGTAGTGATAGTAAAAAAAAAAAAAATACAAAAATTAGCCAGGCATGGTAGCAGGTGCCAGCTACTCAGGAGGCTGAGGCAGGAGAATCACTTGAACCCAGGAGGTGGAGGTTTCAGTGAGCTGAGATCATGCCATTGCACTTCAGCCTGGGGGACAAGAGCAAGACTTCGTCACAAAAAAAAAAAAAAAAAAAAAAAA","GGCCGGCACGGTGTCTCACGCCTGTAATCCCAGCACTTTGGGAGGCCGAGGAGGGTGGATCACCTGAGGTCAGGAGTTCGAGACCAGTCTGGCAACATGATGAAATACTGTCTCTACTAAAAATACAAAATTATAAACTGGCTATTCTAGTTTAGACAAAAAGAAAATGAAAAAAAAAAATATATAATAAAAATAAAAATACAAAATTAGCCAGGTGTAGTGGCGCACGCCTATAATCCCAGCTACTTGGGAGGCTGAGGCAGGAGAATCACTCGAACTTGGGAGGCGGAGGTTGCAGTGAGCTGAGATGGCACCATTGCACTCCAGCCTGAGCAACAACAGTGAAACTCTCTCAAAAATAAATAAATTAAAAAAAAAAA"
"chr13","73525402","73525683","JH378281","1825301","1825574","63","71700101","GACCAGGCGTGGTGGCTCATGCCTGTAATCCTAGCACTTTGGGAGGCCAAGGAAGGCAGATCACTTGAGGTCAGGAGTTTGAAACCAGCTTGGTCAACATGGTGAAAACCTGTGTCAACCAAAAAAAAAAAAAAAAAAAAAGAAAAAAAAAACAACTAGCCAGACATGGTATTGGGTACCTACAAATCCCAGCTACTTTGGAGGCTGAGGCAAGAAAATTCCTTGAACCCAGGAGGCAGAGGTTGCAGTGAGCCACAATCCCACCATTGCACTCCAGCCTGG","GGCTGGGCGTGGTGGCTCACGCCTGTAATCCCTACACTTTGGGAGGCTGAGGCAGGTGGATCACCTGAGGTCAGAAGTTTGAGACCAGCTTGGCCACCATGGTGAAAAGACAAAAAAAAAAAAAAAAAAAAAAAAAAAAAAAATACAAAAATTAGCCAGGCGTGGTGGCAGGTGCATGGAACCCCAGCTACTCGGGAAGCTGAGGCAGGAGAATCGCTTGAACCCGGGAGTCAGAGGTTGCAGTGAAATGAGATCAAGCCAGTGCACTCCAGCC"
"chr13","83299431","83300714","JH378118","18053084","18053501","879","65246347","GGCTGGGCGCCGAGGCTCCAACCTGTAATCCCAGCACTTTGGGAGCCTGAAGCAGGCAGATCACCTGAAGTCAGGAGTTCGAGACCCACCTGGCCAAGATGGTGAAACCCCCTCTCTATTAAAAATACAAAAATTAGCCAGGTTATTGGGGGAACCAGCCCCCAATATTTCAACGTAGGTTCTTTCTATTTTCCCTAAGTGTTGGCTGGTCTGAGAAATAAAGAGAAAGAGTACAAAGGGAGAAATTTTACAGCTGGGCCTCCGTGGGTGTCATCACGTATTGGTAGGACCGTGATGGCAACCCCGAGCTGCAAAACCAGCAAGTTTTTATAAGGGATTTTAAAAGGGGAGGGGTGTACGAACAGGGAGTAGGTCACAAGGATCACATGTTTCAAAAGGCCATAAAGATGACAAGGCGAAGGCAAAATTAGAATTACTGATGAGGTTCTGTGTCCCACTGTGCATGCATTGTCTTGATAAACATCTTAACAGGAAACAGGGTTCAAGAACAGACAACTGGTCTAACTAGAATTCACCAGGCTAGAATTTCCCAATCCTAGTAAGCCTGAGGGCACTGCAGGAGACCAGTATTTCAGTCCTTAGCTCAACCGCATAAGACAGACACTCCCAGAGCAGCCGTTCATAGACCTACCCCCAGGAATGCAGTCCTTCCCCAGGGTCTCAATGATTAATATTCCTTGCTAGGAAAAGAATTCAGTGATATCTCTCCTACTTGCACATCCGTCTATAGGTTTTCTGCAAGAAGAAAAATATGGCTCTATTCTGCCCGACCCCGCAGGCAGTCAGACCTTATGGTTATCTTTCCTTGTTCCCTGAAAATCGCTGTTATTCTGTTCTTTTTCAGGGTGCACTGATTTCATATTGTTCAAACACACGTTTCACAAACAATTTGTACAGTTAATGCAATCATCACAGGGTCCTGAGGTGACATACATCCTCAGCTTACAAAGATGATGGGAATAAGAGATTAAAGTAAGACAGTCATAAGAAATTATAAAAGTATTAATTTGGGGAACTAATAAATGTCCATGAAATATTCACAATTTATGTTCTTCTGCTGTGGCTTCAGCCAGTCCCTCCATTCAGGGTCCCCGACTTCCCACAACACAGGTGTGCTGGCACCTGCCTGTAATCCCAACTACTTGGGAAGCTAAGGCAGGAGAATCTCTTGAACCTGGGGGACAGAGGTTGCAGTGAGCCAAGATCACACCATTATACTCCAGCCTGGGCAACAAGAGTGAAACTCTGTCTCAAAAAAAAAAA","GGCTGGGCGCAGTGGCTCACACCTGTAATCCCAGCACTTAGGGAAGCTGAGGCGAGTAGATCACCTGAGGTCAGGAGTTAGAGACCAGCCTGGCCATCATGGTGAAACCCCGTCTCTACTAAAGATACCAAAAATTAGCTGAGTGTGGTGCTGGGTGCCTGTAATCCCAGAAACTCAGGGTGCCTGTAATCCCAGCAACTCAGGGTGCCTTTAATCCCAGCAACTGAGGGTACCAGTAATCCCAGCAACTCAGGGTGTCTTTAATCCTAGCAACTGAGGGCACCTGTAATCCCAGCAACTCAGGAAGCTGAGACAGGAGAAGTACTTGAACCCAGAAGGCAGAGGTTGCAGTGAGCCGATATTGCACCATTGCACTCCAGTCTGGGCAACAAGAGTGAAACTCTGTCTCAAAAAAAAA"
"chr13","92420977","92421589","JH378118","18053084","18053501","261","74367893","GGCTAGGCCGGTGGCTAATGCCTGTAATTCCAGCACTTTAAGAGGCGGAGGTGAGCGGATCACTTGAGGTCAGGAGTTTGACACCAGCCTGGTCAACATGGTGAACCCCCGTCTCTACTGAAAAATACAAAAATTAGGCCGGGCGCGGTGGCTCACGCCTGTAATCCCAGCACTTTGGGAGGCCGAGGTGGGCGGATCACCAGAGGTGGGGAGTTTGAGACCAGCCTGGCCAACATGGTGAAACCCGGTCTCTACTAAAGAAAAATACAAAATTAGCCGGGCGTGGTGGCGCATGCCTGTAATCCCAGCTACTCGGGAGGCTGAGGCAGGAGAATCGCTTGAACCTGGGAGGCGGGAGGTTGCGGTGAGCCGAGATCTTGCCATTGCACTCCAGCCTGGGAAACAAGAGCGAAACTCTGTCTCAAAACAACAACAAAACAAAAACAAAAAGTAGCGGGGCGTGGTGGCGGGCACCTGTAATCCCAGCTACTTCAGAGGCTGAGGCGAGAGAATCGCTTGAACCAGGGAGGCGGAGGTTGCAGTGAGCCGAGATCACGCCATTGCACTCCAGCCTGGGCGACAAGAGCGAGGCTCCGTCTCAAAAGGAAAAAAA","GGCTGGGCGCAGTGGCTCACACCTGTAATCCCAGCACTTAGGGAAGCTGAGGCGAGTAGATCACCTGAGGTCAGGAGTTAGAGACCAGCCTGGCCATCATGGTGAAACCCCGTCTCTACTAAAGATACCAAAAATTAGCTGAGTGTGGTGCTGGGTGCCTGTAATCCCAGAAACTCAGGGTGCCTGTAATCCCAGCAACTCAGGGTGCCTTTAATCCCAGCAACTGAGGGTACCAGTAATCCCAGCAACTCAGGGTGTCTTTAATCCTAGCAACTGAGGGCACCTGTAATCCCAGCAACTCAGGAAGCTGAGACAGGAGAAGTACTTGAACCCAGAAGGCAGAGGTTGCAGTGAGCCGATATTGCACCATTGCACTCCAGTCTGGGCAACAAGAGTGAAACTCTGTCTCAAAAAAAAA"
"chr14","584088","584429","JH378109","21565230","21565567","54","20981142","GGCCGGGTACGGTGGCTCACGCCTGTAGTCCTGGCACTTTGGGAGGCCGAGGCAGGTGGATCCCCGAGGTCACGAGTTTGAGACCAGCCTGGCCAGCATGGTGAAATCCCATCTCTACTAAAAATACAAAACTTAGCCGGGCATGGTGACGTGTGCCTGTAATCCCAGCTACTTGGGAGGCTGAGGCAGGAGAATTGCTTGAACCAGGGAGGCAGAGGTTGCAGTGAGCTGAGATCATGAAACTGCAGTCCAGTCTAGGCGACAAGAGCAAAACTCCGTCTCAAAAAAATAAATAAATAAATAAATAAATAAAAAATAAAACAAACAACAAAAAAAACAAAA","GGCCGGGCGCGGTGGCTCAAGCCTGTAATACCAGCACTTTGGGAGGCCGAGGCGGGTGGATCACGAGGTCAAGAGATCGAGACCATCCTGGTCAACATGGTGAAACCCCGTCTCTACTAAAAATACAAACAATTAGCTGGGCATGGTGGCGGGTGCCTGTAATCCCAGCTACTCCAGAGGCTGAGGCAGGAGAATTGCCTGAACCCAGGAGACGGAGGTTGCGGTGAGCCAAGATCGCGCCATTGCACTCCAGCCTGGGTGACAAGAGCGAAACTCCGTCTCAATAAATAAATAAATAAATAAATAAATAAAAATAAAATAAATAAATAAATAAATAA"
"chr14","620575","620915","JH378109","21565230","21565567","56","20944655","GGCCGGGTACGGTGGCTCACGCCTGTAGTCCTGGCACTTTGGGAGGCCGAGGCAGGTGGATCCCCGAGGTCACGAGTTTGAGACCAGCCTGGCCAGCATGGTGAAATCCCATCTCTACTAAAAATACAAAACTTAGCCGGGCATGGTGACGTGTGCCTGTAATCCAGCTAACTTGGGAGGCTGAGGCAGGAGAATTGCTTGAACCAGGGAGGCAGAGGTTGCAGTGAGCTGAGATCATGAAACTGCAGTCCAGTCTAGGCGACAAGAGCAAAACTCCGTCTCAAAAAATAAATAAATAAATAAATAAATAAAAAATAAAACAAACAACAAACAAAACAAAA","GGCCGGGCGCGGTGGCTCAAGCCTGTAATACCAGCACTTTGGGAGGCCGAGGCGGGTGGATCACGAGGTCAAGAGATCGAGACCATCCTGGTCAACATGGTGAAACCCCGTCTCTACTAAAAATACAAACAATTAGCTGGGCATGGTGGCGGGTGCCTGTAATCCCAGCTACTCCAGAGGCTGAGGCAGGAGAATTGCCTGAACCCAGGAGACGGAGGTTGCGGTGAGCCAAGATCGCGCCATTGCACTCCAGCCTGGGTGACAAGAGCGAAACTCCGTCTCAATAAATAAATAAATAAATAAATAAATAAAAATAAAATAAATAAATAAATAAATAA"
"chr14","1107083","1107723","JH378118","18053084","18053501","303","16946001","GGCGTGGTGGCTCACACCTGTAATCCCAGCACTTCAGGAGGCCAAGGCAGGTAGATTGCTTGATCACAGGAGTTCAAACCAGCCATGGGCAATGTCAGGCCTCTGAGCCCAAGCTTGCACGTATCCAGATGGCCTGAAGCAACTGAAGAATCACAAAAGAAGTGAAAACAGCCAGTTCCTTCCTTAACTGATGACATTACCTTGTGAAATTCCTTCTCCTGGCTCAGAAGCTCCCCTACTGAGCACCTTGTGACCCCTGCCCCTGCCAGCCAGAGAACAATCCCCTTTGACTGTAATTTTCCACTACCTACCCAAATCCTATAAAACAGCCCCACCCCATCTCCCTTTGCTGACTCCTTTTTCGGACTAGGTCCGCCTGCACCCAGGTGATTAAAAAGCTTTATTGCTCACACAAAGCCTGTTGGTGGTCTCTTCACACGGACGCACGTGACAGGCAACATGGTGAAACCCTATCTCTATAAAAAAATAAAAATAAAAATTAGTTGGGCGTGGAGACTGAGGTGAGAGAATCCAGAGGATCCAAGAGGATCGAGTCAAGGAGGTGGAGGCCGCAGTGAGCCGAGATCGCACCGCTGCACTCCAGCCTGGGCGACAAGAGTGAAACTCTGTCTTAAAAAAAA","GGCTGGGCGCAGTGGCTCACACCTGTAATCCCAGCACTTAGGGAAGCTGAGGCGAGTAGATCACCTGAGGTCAGGAGTTAGAGACCAGCCTGGCCATCATGGTGAAACCCCGTCTCTACTAAAGATACCAAAAATTAGCTGAGTGTGGTGCTGGGTGCCTGTAATCCCAGAAACTCAGGGTGCCTGTAATCCCAGCAACTCAGGGTGCCTTTAATCCCAGCAACTGAGGGTACCAGTAATCCCAGCAACTCAGGGTGTCTTTAATCCTAGCAACTGAGGGCACCTGTAATCCCAGCAACTCAGGAAGCTGAGACAGGAGAAGTACTTGAACCCAGAAGGCAGAGGTTGCAGTGAGCCGATATTGCACCATTGCACTCCAGTCTGGGCAACAAGAGTGAAACTCTGTCTCAAAAAAAAA"
"chr14","1362660","1363231","JH378118","18053084","18053501","229","16690424","GGCTGGGCACAGTGGCTTATACCCATAATCTCAGCAGTTTGGGAGGCCAAGGCAGGTGTATCACCTGAGGTCAGGAGTTCGAGAAACACCATGGCCAACATGGTGAAACCCCATCTCTACTAAAAATACAAAAAGTAGGCTGGGCGTGGTGGCTCACGCCTGTAATCCCAGTACTTTGGGAGGCCGAGGCGGGCGGATCACAAGGTCAGGAAACCGAGACCATCCTGACTAACATGGTGAAACCCCGTCTCTACTAAAAATACAAAAAAAGCTAGCCGGGCATGGTGGCGGGTGCCTGTAGTCCCAGCTACTCGGGAGGCTGAGGCAGGAGAATGGCGTGACCCCAGGAGGCAGAGCTTCCAGCTTGGGTGACTCCGTCTCAAAAAAAAAAAAACAAAAACAAAAAGTAGCTGGACGTGGTGGCTGTAGACCTAGCTACTCGAGAGGCTGAGGCAGGAGAATCGCTTGAACCTAGGAGGCGGAGGTTGCGGTGAGCCGAGATCACGCTTCTGCACTCCAGCCTGGGTGACAAGAGCAAAACTCCATCTCCAAAAAAAAAAAACAAAAAAAAA","GGCTGGGCGCAGTGGCTCACACCTGTAATCCCAGCACTTAGGGAAGCTGAGGCGAGTAGATCACCTGAGGTCAGGAGTTAGAGACCAGCCTGGCCATCATGGTGAAACCCCGTCTCTACTAAAGATACCAAAAATTAGCTGAGTGTGGTGCTGGGTGCCTGTAATCCCAGAAACTCAGGGTGCCTGTAATCCCAGCAACTCAGGGTGCCTTTAATCCCAGCAACTGAGGGTACCAGTAATCCCAGCAACTCAGGGTGTCTTTAATCCTAGCAACTGAGGGCACCTGTAATCCCAGCAACTCAGGAAGCTGAGACAGGAGAAGTACTTGAACCCAGAAGGCAGAGGTTGCAGTGAGCCGATATTGCACCATTGCACTCCAGTCTGGGCAACAAGAGTGAAACTCTGTCTCAAAAAAAAA"
"chr14","2088506","2089110","JH378118","18053084","18053501","257","15964578","GGCTGGGCACTGCGGCTCACACCTGTAATCCCAGCATTTTGAGAGGCCTAGGTGGGTGGATCACCTGAGATCAGTTCAAGACCAGCCTGACCAACATGGCAAAACCCCATCTCTATTAAAAACACAAAAAACGCCCAGGAGCGGTGGCTCACACCTGTAATCCCGGCACTTTGGGAGGCTGAGGCAGGCGGATCACGAGGTCAGGAGATCGAGACCATGCTGGCTAACACGGTGAAACCCCGTCTCTACTAAAAATACAAAAAATTAGCCAGGCGTGGTGTCGGGCGCCTGTAGTCCCAGCTATTCGGGAGGCTGAGACAGGAGAATGGCATGAACCCGGGAGGCAGAGCTTGCAGTGAGCTGAGATCGCGCCACTGCACTCCAGCCTGGGCGACAGAGTAAGACTCTGTCTCAAAAAAAAAAATACAAAAAATACAAAAAACATTAGCCACATGTGGTGGTGGGTGCCTGTAATCCCAGCTACTCAGGAGGCTGAGGCTGGAGAATTGCTTGAACCCAGGAGGTGGAGGTTGTGGTGAGCCAAGATCACGCCATTGCATTCCAGCCTGGGTGACAAGAGTGAACCTCTGTCTCAAAAAAAAGAA","GGCTGGGCGCAGTGGCTCACACCTGTAATCCCAGCACTTAGGGAAGCTGAGGCGAGTAGATCACCTGAGGTCAGGAGTTAGAGACCAGCCTGGCCATCATGGTGAAACCCCGTCTCTACTAAAGATACCAAAAATTAGCTGAGTGTGGTGCTGGGTGCCTGTAATCCCAGAAACTCAGGGTGCCTGTAATCCCAGCAACTCAGGGTGCCTTTAATCCCAGCAACTGAGGGTACCAGTAATCCCAGCAACTCAGGGTGTCTTTAATCCTAGCAACTGAGGGCACCTGTAATCCCAGCAACTCAGGAAGCTGAGACAGGAGAAGTACTTGAACCCAGAAGGCAGAGGTTGCAGTGAGCCGATATTGCACCATTGCACTCCAGTCTGGGCAACAAGAGTGAAACTCTGTCTCAAAAAAAAA"
"chr14","2164771","2165383","JH378118","18053084","18053501","243","15888313","GGCTGGGCGCAGTGGCTCACACCTGTAATCCCAGCACTCTGGGAGGCCAAGGCAGGTGGATCACCTGAGGTCAGGAGTTCGAGACCAGCCTGGCCAACATGGTGAAACCCCATCTTTACTAAAAATACAAAAATTAGCTAGGCGTGAGGCCGGGCGTGGCGGCTCATGCCTGTAATCCCAGCACTATGGGAGGCTGAGGCAGGCTGATCATGAGGTCAGGAGATTGAGACCTGGCTAACACAGTGAAACCCCGTCTCTACTAAAAATACAAAAAAAAAATAGCCAGGCATGATGGCAGGCTCCTGTAGTCCCAGCTTCTTGGGAGGCTGAGGCAGGAGAATGGTGTGAACCCGGGAGGCAGAGCTTGCAGTGAGCCGAGATCATGCCACTGCACTCCAGCCTGGGTGACAGAGCAAGACTCTGTCTCAAAAAAAAAAAAAAAAAATTAGCTAGGCGTGGTGAGGGGCACCTGGAATCCCAGCTACTCAGGAGGCTGAGGCAGGAGCATCGTTTAAACCCAGGAGGCAGAGGTTGCAGTGAGCCGAAATCACACCATTGCACTCCAGCCTGGGCAACAAGAGCAAGTCTCCATCTTAAAAAAAAAAAAAAAAAA","GGCTGGGCGCAGTGGCTCACACCTGTAATCCCAGCACTTAGGGAAGCTGAGGCGAGTAGATCACCTGAGGTCAGGAGTTAGAGACCAGCCTGGCCATCATGGTGAAACCCCGTCTCTACTAAAGATACCAAAAATTAGCTGAGTGTGGTGCTGGGTGCCTGTAATCCCAGAAACTCAGGGTGCCTGTAATCCCAGCAACTCAGGGTGCCTTTAATCCCAGCAACTGAGGGTACCAGTAATCCCAGCAACTCAGGGTGTCTTTAATCCTAGCAACTGAGGGCACCTGTAATCCCAGCAACTCAGGAAGCTGAGACAGGAGAAGTACTTGAACCCAGAAGGCAGAGGTTGCAGTGAGCCGATATTGCACCATTGCACTCCAGTCTGGGCAACAAGAGTGAAACTCTGTCTCAAAAAAAAA"
"chr14","3757666","3758004","JH378113","23438980","23439304","67","19681314","CTGGGCATGGTGGCTCATGCCTGTAATCCCAGCACTTTGGGAGACAGAGGAGGGCAGATCATCTGAGGTCAGGAGTTTGAGACCAGCCTGGCCACCATGGTGAAACCCCCGTCTCTACTGAAAATACAAAAAAATTCAGCTGGGTGTGGTAGTGGATGTCTGTAATCCTAGCTGCTTGGGAGGCTGAGACAGGAGAATCGCTTGAACCCGGGAGGTGGAGGTTGCAGTGAGCCGCCATTGCGCTCCAGCCTGGGCAACAAGAGCGAAACTCCATCTCAAAAATTAATTAATTAATTAATTAATTAAAAGTGGACTAAAGCAAAGACAAGAGAAAAAAGA","GGCAGGGTGTGGTAGCTCATGCTTGTAATCCCAGCACTTTGGGAAGTGGAGGCGGGCAGATCATCTGAGGTCAGGAGTTTGAGGCCAGCCTGGCCAACATGGTGAAACCCTGTCTCTACTAAAAATACAAAAAATTAACTGGGCGTGGTGGTGGACACCTGTAATCCCAGCTGCTTGGGAGGCTGAGGCAGGAGAATCGCTTGAACCCAGGAGATGGAGGTTGCAGTGAGCCAAGATGGCACCATTGCACTCTAGCCTGGGCAAAAAGAGTGAAACTCCGTCTCAAAAAAAAAAAAGAAAAGAAAAGAAAAGAAAAGAAAAGAAA"
"chr14","10702105","10702681","JH378118","18053084","18053501","246","7350979","GGCCAGGCGCAATGGCTCACACCTGTAATCCAAGCACTTTGGGAGGCCAGTTCAAGACCAGCCTGGCCAACATGGTGAAAACCTGTCTCTGCTAAAAATGCCAAATTTCCCAGCACTTTGGGAGGCTGAGGCGGGTGGATCACGAGGTCAGGAGATTGAGACCATCCCGGCTAACACGGTGAAACCCCATCTCTACTAAAAATAGAAAAAAATTAGCCGGGCGTGGTGGCAGACGCCTGTAGTCCCAGCTACTCTGGAGGCTGAGGGAAGAGAATGGCATAAACCCGGGAGGCGGAGCTTGCAGCGAGCTGAGATTGCGCCACTGCACTCCAGCCTGGGCGACAGAGCAAGACTCCGTCTCAAAATAAATAAATAAATAAAATTAAAATTAAAAATAAAATACAAAATTTAGCCGAGCATGGTGGTGAGCACCTATAATCCCAGCTACTTGGGAGGCTGAGGCAGAAGAATCTCTTGAACCAGGGAAGTGGAGGTTGCAGTGGGCTGAGATCCAGCCACTGTACTCCAGCCTGGGCGACAAAAGCGAAACACTGTCTAAAAAAATAAAAAATAAAAA","GGCTGGGCGCAGTGGCTCACACCTGTAATCCCAGCACTTAGGGAAGCTGAGGCGAGTAGATCACCTGAGGTCAGGAGTTAGAGACCAGCCTGGCCATCATGGTGAAACCCCGTCTCTACTAAAGATACCAAAAATTAGCTGAGTGTGGTGCTGGGTGCCTGTAATCCCAGAAACTCAGGGTGCCTGTAATCCCAGCAACTCAGGGTGCCTTTAATCCCAGCAACTGAGGGTACCAGTAATCCCAGCAACTCAGGGTGTCTTTAATCCTAGCAACTGAGGGCACCTGTAATCCCAGCAACTCAGGAAGCTGAGACAGGAGAAGTACTTGAACCCAGAAGGCAGAGGTTGCAGTGAGCCGATATTGCACCATTGCACTCCAGTCTGGGCAACAAGAGTGAAACTCTGTCTCAAAAAAAAA"
"chr14","11790883","11791455","JH378118","18053084","18053501","226","6262201","GGCTGGGTGGCCATGGCTCATGCCTGTAATCCTAGAACTTTGGGAGGCTGCGGCAGGCAAATCACCTGAAGTCAGGAGTTCAAGACCAGCCTGGCCAACATACTGAAACCCCGTCTCTCCAGGCCTGGTGGCTCATGCCTGTAATCCCAGCACTTTGGAAAGCCGAGGTGGGCGGATCACCTGAGGTCAGGAGTTCAAGACCAGTCTGACCAACATGGGGAAACCCCATCTCTACTAAAAATACAAAATTAGCTGGATGTGGTGGCACATGCCTGTATTCCCAGCTACTTGGGAGGCTGAGGCAGGAGAATCGCTTGATCCCGAGAGGTGGAGCTTGCCGTGAGCTGAGATTGTGCGCCATTGCACTCCAGCCTGGGCAACAAGAGTGAAACTCCGTCTCTACTAAAAATACAAAAATTAGCCGGGTGTGGTGGCGGGTGCCTGTAATCCAAGCTACTCGGGAGGCTAAGGCAGGAGAATTGCTTGAACCCACGAGGCCGAGGTTGCAGTGAGCCGAGATTGCACTATTGCACTCCAGCCTGGGCGACAAGAGTGAGACTGTGTCTCAAAAAA","GGCTGGGCGCAGTGGCTCACACCTGTAATCCCAGCACTTAGGGAAGCTGAGGCGAGTAGATCACCTGAGGTCAGGAGTTAGAGACCAGCCTGGCCATCATGGTGAAACCCCGTCTCTACTAAAGATACCAAAAATTAGCTGAGTGTGGTGCTGGGTGCCTGTAATCCCAGAAACTCAGGGTGCCTGTAATCCCAGCAACTCAGGGTGCCTTTAATCCCAGCAACTGAGGGTACCAGTAATCCCAGCAACTCAGGGTGTCTTTAATCCTAGCAACTGAGGGCACCTGTAATCCCAGCAACTCAGGAAGCTGAGACAGGAGAAGTACTTGAACCCAGAAGGCAGAGGTTGCAGTGAGCCGATATTGCACCATTGCACTCCAGTCTGGGCAACAAGAGTGAAACTCTGTCTCAAAAAAAAA"
"chr14","12236526","12237360","JH378118","18053084","18053501","465","5816558","GGCTGGGTGGGGTGGCTCACGCGTGTAATCCCAACACTTTTGAGGCTGAGGTGGGTGGATCACTTGAGGTCCGGAGTTTGAGACCAGCCTGGTCAACATGGTGAAACCCCATGTCTCAGGATGGGGAACATCACATACCGGGGCCTGTCGTGGGGTGTGGGGAGGGGAAGGGATAGCATTAGGAGATATACCTAATGTAAATGACAAGTTAATGGGTGCAGCACACCAACATGGCACATGTATACATATGTAACAAACCTGCATGTTGTGCACATGTACCCTAGAACTTAAAGTATAGCAATAAAAAAAAAAAAAGAAACCCCGTGTCTACAAAAAAAATACAAAATTAGGCCAGGCGCAGTGGCACATACCTGTAATCCCAGCACTTTGGGAGGCCAAGGTGGGCAGATCACGAGGTCAGGAGTTTGAGACCAGCCTGTCCAAAATGGTGAAACCCCATCTCTACTAAAAAAATACAAAAATTAGCCAGGCATGGTGGCCCGTGCCTGCAATCCCAGCTACTCAGGAGGCTAAGGCAGGAGAATCACTTGAACGTGGGAGGCGGAGGTTGCAGTGAGCCGAGATCACACCATTGCACTCCAGCCTAGGCAACAGAGCGAGACTCTGTCTCAAAAAAACAAAAAGCAAAAAAACCCAAATTAGCCAGGCATGGTGGTAGTCACCTGTAATCCCAGCTACTTGGGAGGCTTAGGCAGGAGAATCGCTTGAACCCCAGAGGCAGAGGTTGCAGTAAGCCAAGATCGCACCAAGATCACTCCAGCCTGGGCGACAGTGAAACTGTGTCTCAAAAGAAAAAGAAAAAAAAGAAAGAAAA","GGCTGGGCGCAGTGGCTCACACCTGTAATCCCAGCACTTAGGGAAGCTGAGGCGAGTAGATCACCTGAGGTCAGGAGTTAGAGACCAGCCTGGCCATCATGGTGAAACCCCGTCTCTACTAAAGATACCAAAAATTAGCTGAGTGTGGTGCTGGGTGCCTGTAATCCCAGAAACTCAGGGTGCCTGTAATCCCAGCAACTCAGGGTGCCTTTAATCCCAGCAACTGAGGGTACCAGTAATCCCAGCAACTCAGGGTGTCTTTAATCCTAGCAACTGAGGGCACCTGTAATCCCAGCAACTCAGGAAGCTGAGACAGGAGAAGTACTTGAACCCAGAAGGCAGAGGTTGCAGTGAGCCGATATTGCACCATTGCACTCCAGTCTGGGCAACAAGAGTGAAACTCTGTCTCAAAAAAAAA"
"chr14","12551961","12552292","JH378124","27069096","27069413","54","14517135","GGCCAGGCGCGGTGGCTCACGCCTGTAATCCCAGCACTCTGGGAGGCCAAGGCGGACGGATCATCCGAGGTCAGGAGTTTGAGACCAGCCTGGCCAACATGGTGAAACCCCATCTCTACTAAAAATATATATATATATGTATATATATATATATATTAGCCAGGTGTAGTGGTGGGCATCTGTAATCCCAGCTACTCGGGAGGCTGAGGCAGGAGAATTGCTTGAACCCAGGAGGCGGAGGTTGCAGTGAGCTGAGATTGCACCACTGCACTCCAGCCTGGGTGATAAGAATGAGACTCCATCTCAAAACAAACAAACAAACAAATAAAAAA","GGCCGGGCACGGTGGCTCATGCCTGTAATCCCAGCACTTTGGGAGGCCGAGGCGGGTGGATCATGAGGTCAAGAGATCGAGACCATCCTAGTCAACATGGTGAAACTCCATCTCTACTAAAAATACAAAAAAAAAAAAAAATTAGCTGAGCATGGTGGTGCATGCTTGTAATTCCAGCTACTCAGGAGGCTGAGGCAGGAGAATTGCCTGAACCCAGGAGGCGGAGGTTGCAGTGAGCCGAGATTGCGCCATTGCACTCCAGCCTGGGTAATAAGAGTGAAACTCCGTCTCAAAAAAAAAAAACAAAAAAACAAAAAA"
"chr14","15131045","15131391","JH378121","20921542","20921875","62","5790497","GGCTGGGCCCGGTGACTCATGCCTGTAATCCCAGCACTTCGGGAGGACAAGGCGGGTGGATCACCTGAGGTCAGGAGTTCGAGACCAGCCTGGCCAACATGGCGAAACCCCGTCTCTACTGAAAATACAAAAATTAGCCAGGCATGGTGGTGGGCGCCTGTAATCCCAGCTACTCAGAGGCTGAGACAGGAGAATCACTTGAACCTGGGGTGGGGGCGGGGGCGGGGGCGGGGGCGGGGTGGGAGTGGAGGTTGCAGACAGTGAGTGGTGATGGCGCCAGTTCACTCCAGCCTGGGCGAAAGAGTGAAACTCCATCTCAGAAAAAAAAAAAAAAAAAAAAAGTAAAA","GGCTGGGTACGGTGGCTCATGCTGTAATCCCAGCACTTTGGGAGGTCAAAGCAGGCGGATCACCTGAGGTCAGGAGTTTGAGACCAGCCTTGCTAACATGGTGAAACCCCGTTTCTACTAAAAATAAAAAAATTAGCCAGGCGTGGTGGTGTGCACCTGTAATCCCAGCTACTTGGGAGGCTGAAGCAGGAGAGTTGCTTGAACCGGGGTGGTGGGGGGGCAGGGGCAGGGGTGGGTGGCAGGCAGAGGTTGCAGTGAGCCGAGATGGTGCCATTGCACTCCAGCCTGGGCAACAAGAGCAAAACTCCGTCTCAAAAAGAAAAAAAAAAAAGAA"
"chr14","15292066","15292693","JH378118","18053084","18053501","267","2761018","GGCCGGAGACGGTGGCTCACACCTGTAATCCCAGCACTTTGGGAGGCTGAGGCAGGCAGATCACCTGAAGTCAGGAGTTTGAGACCAGCCTGGCCAACATGGTATAAACCCCATCTCTACTAAAAATACAAAAATTAGGCTGGGCGCGGTGGCTCACGCCTGTAATCCCAACACTTTGGGAGGCCGAGGTGGGTGGATCACCTGAGGTCGGGAGTTTGAGACCAGCCTGACCAACATGAAGAAACCCTGTCTCTACTAAAAAAAAAAAAAAATACAAAATTAGCCGGGCATCATGGCACAAGCCTGTAATCCCAGCTACTCAGGAGTCTGAGGCAGGAGAATCGCTTGAACCTGGGAGGCGAAGGTTGCAGTGAGCTGAGATCGTGCCATTGCACTCCAGCCTGGGCAACAAGAGCGAAACTCCTTCTCTAAATAAATAAATAAAAATACAAAAATTTAGCCGGGCATGGTGGCGGGCACCTGTAATCCTAGCTACTTGAGAGGCTGAGGCAGGAGAATCGCTTGAACCCGGGAGGCGGAGGTTGCAGTAAGCAGAGATTGTGCCATTGCACTCCATCCTGGGCAACAAGAGTGAAACTCCATCTCAAAAAAAAAAAAAAAAAAAAAA","GGCTGGGCGCAGTGGCTCACACCTGTAATCCCAGCACTTAGGGAAGCTGAGGCGAGTAGATCACCTGAGGTCAGGAGTTAGAGACCAGCCTGGCCATCATGGTGAAACCCCGTCTCTACTAAAGATACCAAAAATTAGCTGAGTGTGGTGCTGGGTGCCTGTAATCCCAGAAACTCAGGGTGCCTGTAATCCCAGCAACTCAGGGTGCCTTTAATCCCAGCAACTGAGGGTACCAGTAATCCCAGCAACTCAGGGTGTCTTTAATCCTAGCAACTGAGGGCACCTGTAATCCCAGCAACTCAGGAAGCTGAGACAGGAGAAGTACTTGAACCCAGAAGGCAGAGGTTGCAGTGAGCCGATATTGCACCATTGCACTCCAGTCTGGGCAACAAGAGTGAAACTCTGTCTCAAAAAAAAA"
"chr14","15354689","15355313","JH378118","18053084","18053501","269","2698395","GGACGGGCGCAGTAGCTCACACCTGTAATCCTAGCAGTTTGGGAGGCCAAGGTGGGTGGATCACCTGACGTCAGGAGATCGAGACCAGCCTGGACAACATGGCGAAACCCTGTCTCTACTAAAAATACAAAATTAGGGCCAGGTGCGGTGGCTCACGCCTGTAATCCCAGCACTTTGGGAGACTGAGGCGGGCAGATCACCTGAGGTCAGGAGTTCGAGACCAGCCTGGCCAACATGGTGAAACCGCCTCTCTACTAAAAATATAAAAATTGGCTGGGCATTGTAGCAGCCACCTGTAATCCCAGCTACTTGGGGGCCCGAGGCAGAAAAACTGCTTGAACCCAGGAGGCAGAGGTTGTAGTGAGCCGAAATCATGCCACTGCACTCCAGCCTGGGTGACGAGAGTGAGACTCCGTTTCAAAGAAAAAGAAAAAAAATAAAATAAAACACAAAATTAGCCAGTCATGGTGGCAGGCACCTATAATCCCAGCTACCTGGGAGGCTAAGGCAGGAGAATCACTTGAACCCAGGAGGTAGAGGGTGTGGTGAGCCGAGATCACGCCATTGCACTCTAGCCTGGGCAACAAGAGCAAAACTCTGTCTCAAAACAAAAAGTTAAAAAAAA","GGCTGGGCGCAGTGGCTCACACCTGTAATCCCAGCACTTAGGGAAGCTGAGGCGAGTAGATCACCTGAGGTCAGGAGTTAGAGACCAGCCTGGCCATCATGGTGAAACCCCGTCTCTACTAAAGATACCAAAAATTAGCTGAGTGTGGTGCTGGGTGCCTGTAATCCCAGAAACTCAGGGTGCCTGTAATCCCAGCAACTCAGGGTGCCTTTAATCCCAGCAACTGAGGGTACCAGTAATCCCAGCAACTCAGGGTGTCTTTAATCCTAGCAACTGAGGGCACCTGTAATCCCAGCAACTCAGGAAGCTGAGACAGGAGAAGTACTTGAACCCAGAAGGCAGAGGTTGCAGTGAGCCGATATTGCACCATTGCACTCCAGTCTGGGCAACAAGAGTGAAACTCTGTCTCAAAAAAAAA"
"chr14","15366797","15367405","JH378129","11955248","11955630","263","3411549","GGTTGGGTGCGGTGGCTTACCCCTGTAATCCCAGCACTTTGGGGGTACAAAGTGGGAAGATTGCTTGAGCCCAGGAGTTCAAGACCAGCCTGGGCAACTAAGCGAGATCCTATCTCTCAAAAAAATTTTGAAACAACTTTTTGGCCGGGCGCAGTGGCTCACGCCTGTGATCCCAGCACTTTGGGAGGCCAGGGCGGGCGGATCACGAGGTCAGGAGATCAAGACCATCCTGGCTAACACGGTGAAACCCCGTCTCTACTAAAAATACAAAAAATTAGCCGGGTGCGGTGGCGGGCACCTGTAGTCCCAGCTACTCGGGAGGCTGAGGCAGGAGGATGGCGTGAACCCGGGAGGTGGAGCTTGCAGTGAGCTGAGATCGGGCCACTGCACTCCAACCTGGACGACAGATCGAGACTCCGGCTCAAAAAAAAAAAATTAGCTGGGCGTGGTGGCGGGTGCGTGTAATCCCAGCTACTCGGGAGGCTGAGGCAGGAGAATCACTTGAACCTGGGAGGCAGAGGCTGCAGTGAGCCAAGATCGCGCCATTGCACTCCAGCCTGGGCAACAAGAGCGAAACTCTGTCTCTAAATAATAAAATAAAATAAAAAA","GGCTGGGTACGGTGGCTCATGCCTGTAATCCCAGCACTTTGGGAGGTGGGTCACTTGAGGTCAGGAGTTCGAGACCAGCCTGTGCAGTGCCTCCATCCTCAACTGCTGCCTCATCAGCCTGGACCACTACCTGCTCATCCTCTCACCACTGCCACAAGCTGCGCATGAAGCTCCTGCGCGCGCCGGTGCCCGTCTCTACTAAAAATACAAAAATTAGCTGGGTGTGGTGGCAGGTGCCTGTAATCCCAGCTACTCAGGAGGCTGAGGCAGGAGAATCACTTGAACCCAGGAGGCAGAGGTTGCAGTGAGCCGATATCGCATCATTGCACTCCAGCCTGAGCAACAAGAGTGAAATTTTGTCTCAAAAAAAAAAAAAAAAGAAA"
"chr14","15379094","15379705","JH378129","11955248","11955630","265","3423846","GGTTGGGTGCGGTGGCTTACCCCTGTAATCCCAGCACTTTGGGGGTACAAAGTGGGAAGATTGCTTGAGCCCAGGAGTTCAAGACCAGCCTGGGCAACTAAGCGAGATCCTATCTCTCAAAAAAATTTTGAAACAACTTTTTGGCCGGGCGCAGTGGCTCACGCCTGTGATCCCAGCACTTTGGGAGGCCAGGGCGGGCGGATCACGAGGTCAGGAGATCAAGACCATCCTGGCTAACACGGTGAAACCCCGTCTCTACTAAAAATACAAAAAATTAGCCGGGTGCGGTGGCGGGCACCTGTAGTCCCAGCTACTCGGGAGGCTGAGGCAGGAGGATGGCGTGAACCCGGGAGGTGGAGCTTGCAGTGAGCTGAGATCGGGCCACTGCACTCCAACCTGGACGACAGATCGAGACTCCGGCTCAAAAAAAAAAAAAATTAGCTGGGCGTGGTGGCGGGTGCGTGTAATCCCAGCTACTCGGGAGGCTGAGGCAGGAGAATCACTTGAACCTGGGAGGCAGAGGCTGCAGTGAGCCAAGATCGCGCCATTGCACTCCAGCCTGGGCAACAAGAGCGAAACTCTGTCTCTAAATAAATAAAATAAAATAAAAAA","GGCTGGGTACGGTGGCTCATGCCTGTAATCCCAGCACTTTGGGAGGTGGGTCACTTGAGGTCAGGAGTTCGAGACCAGCCTGTGCAGTGCCTCCATCCTCAACTGCTGCCTCATCAGCCTGGACCACTACCTGCTCATCCTCTCACCACTGCCACAAGCTGCGCATGAAGCTCCTGCGCGCGCCGGTGCCCGTCTCTACTAAAAATACAAAAATTAGCTGGGTGTGGTGGCAGGTGCCTGTAATCCCAGCTACTCAGGAGGCTGAGGCAGGAGAATCACTTGAACCCAGGAGGCAGAGGTTGCAGTGAGCCGATATCGCATCATTGCACTCCAGCCTGAGCAACAAGAGTGAAATTTTGTCTCAAAAAAAAAAAAAAAAGAAA"
"chr14","15386894","15387394","JH378114","15957391","15957789","201","570497","GCTGAGTGCAGTGGCTCACGCCTGTAATCCACTTTAGCAGGCCAAAATAGGGGGATCACTTTGAGGCCACGAGTTTGAGACCTGCCTGGGCAACATAGTGAGGCCCCGTCTCTACAAAAATCTTTAAATATTAGAATAACTTTGGGAGGCCGAGGCGGGTGGATCACGAGGTCAAGAGATTGAGACCATCCTGGCCAACATGGTGAAATCCCATCCCTACTAAAGCTACAAAAATTAGCCAGGCGTGGTGGTGTGCGCCTGTAGTCCCAGCTACTCGGGAGACTGAGGCAGGAGAATTGCTTGAATCCGCGTGGCGGAGGTTGCAGTGAGCTGAGATCGCGCCACTGCACTCCAGCCTGGTGACAGAGCGAGACTCCGTCTTAAAAAAAAAAAAAAAAAAAAAAAAAAAAACTTCGGAGGTTGCGGTGAGCCAAGATCACGCCATTGTACTCCAGCCTGGGCCACAAGAGCAAAACTCCGCTTCAAAAAAAAAAAAAAAAA","GCAAGGAACGGTGGCTCATGCCTGTCATCCCAGCACTTTGGGAGGCTAAGGAGGGTGGATTACCGAAGGTCATGAGTTTGAGACCAGCCTGACCAACATGGTGAAAACCCCATCTCTACTAAAAATACAAAAAATTAGCCAGATACAGCTATGCGGCAGACTGGGGCAGGAGAATCGCTTGGACCCAAACCCCATCTCTACTAAAAATACAAAAAATTAGCCGGATACAGCTATGCGGGAGACTGGGGCAGGAGAATCGCTTGGACCCGGGAGGCAGAGATTGCAGTGAGATGAGACCATGCCATTGCTCTCTAGCTTGTGCGATGAGAACAAGACTCTGTCTCAAAAAAAAAAAAAAAAAAAAAAAAAAAAAAAAAAAAAAAAGAGAGAGAGAGAAAA"
"chr14","20140478","20141066","JH378118","18053084","18053501","250","2087394","GCCAGGCGAGGTGGCTCATGCCTGTAATCCCAGCACTTTGGGAGGCTGAGGTGGGTGGAACACTTGAGGTCAGGAGTTCAAGACCAGCCTGGCCAACATGATGAAACCCCCATCTCTACTAAAAACACAAAAATTAGCCAGGAGTGGGCAGGGTGCGGTGGCTCACGCCTGTAATCCCAGCACTTTGGGAGGCTGGGATGGGTGGATCATGAGGTCGGGAGTTCAAGACCAGCCTGGCCAAGATGGTGAAACCCTGTCTCTATTAAAACTTCAAAAATTAGCCAGGCACGGTGGCAGGTGCTTGTAATCCCAGCTACTTGGGAGGCTGAGGCAGGAGAATCACTTGAAACTGGGCGGCAGAGGTTGCAGTGAGCCAAGATCGCGCCACTGGACTCCAGACTGGGCGACACAGTGAGATACCGTCTCAAAAAAAAAAAAAAAAAAAATTAGCCAGGAGTGGTGGCGGAAATCCCAGCTACTTGAGAGGCTGAGGCAGGAGAATCGTTTGAACCCAGGAGGCAGAGGTTGCAGTGAGCCAAGATCTTGCCATTGCACTCCAGCTTGGGAGACAAGAGCAAAACTCTGTCTC","GGCTGGGCGCAGTGGCTCACACCTGTAATCCCAGCACTTAGGGAAGCTGAGGCGAGTAGATCACCTGAGGTCAGGAGTTAGAGACCAGCCTGGCCATCATGGTGAAACCCCGTCTCTACTAAAGATACCAAAAATTAGCTGAGTGTGGTGCTGGGTGCCTGTAATCCCAGAAACTCAGGGTGCCTGTAATCCCAGCAACTCAGGGTGCCTTTAATCCCAGCAACTGAGGGTACCAGTAATCCCAGCAACTCAGGGTGTCTTTAATCCTAGCAACTGAGGGCACCTGTAATCCCAGCAACTCAGGAAGCTGAGACAGGAGAAGTACTTGAACCCAGAAGGCAGAGGTTGCAGTGAGCCGATATTGCACCATTGCACTCCAGTCTGGGCAACAAGAGTGAAACTCTGTCTCAAAAAAAAA"
"chr14","32019134","32019479","JH378197","6655183","6655524","67","25363951","GGCTGGGGCAGTGGCTCACTGTAATTCCAGCACTTGGCCAAGGCAGGTGGATCACCTGAGGTCAGGAGTTCAAGACCAGCAGGGCCAACATGGTGAAACCCTATCTCTAAAAATAAATAAATAAATAAATAAATAAAATAAAATAAAATAAAATAAAAAATAAAAAAAATTAGCTGGGCGTTGTGGTGGGCGCCTGTAATCCCAGCTACTTGGGAGGCTGAGGCAGGAGGATCGCTTGAACCTGGAAGGCAGAGGTTGCAGTGAGCCGAAATCACATAATTGCACTCCAGCCTGGGCGACAAGAGCAAAACTCCATCTCAAAAAAAAAAAAAAAAAAAAAAAAAAA","GGCCGGGCGCAGTGGCTCATGCCTGTAATCCCAGCACTTTGGGAGGCAGAGGCGGGCAGATCACCCAAGGTCAGGAGTTCAAGACCAGCCTGGCTAACATGGTGAAACCCCATTTCTACTAAAAATACAAAAAAAAAAAAAAAAAAAAAAAAAAAAAAAAAAAAAAATTAGCTGAGCGAGGTGGTGGGCACATGTAATCCCAGCTACTTCGGAGACTAAGGCAGGACAATTGCTTAAGCCTGGGAGGCAGAGGTTGTAGTAAGCTGAGATCACACCATTGCACTCCAGCTTGAGCAACAAGAGCGAAACTCCGTCTCAAAAAAAAACCCAAAAAACAAAAAA"
"chr14","39734996","39735596","JH378118","18053084","18053501","237","21681912","GGCTGGGCGCGGTGGCTCATGCCTGTAATCCCAGCATTTTGGGAGGCCGAGGCGGGTGGATCACCTGAGGTCAGGAGTTTGAGACCAGCCTGGCCAACATGGTGAAACCCTGTCTCTACTAAAAATGCAAAAATTAGGCTGGTGCAGTGGCTCACGCCTGTAATCACAGCACTTTGGGAGGCCGAGGTGGGCGGATCACGAGGTCAGGAGATCGAGACCATCCTGGCTAATACAATGAAACCCCGTCTCTATGAAAAATACAAAAAATTAGCCGGGCGTAGTGGCAGGCGTCTGTAGTCCCAGCTACTCAGGAGGCTGAGGCAGGAGAATGGCATGAACCTGGGAGGCGGAGCTTGCAGTGAGCCGAGATTGCGCCACTGCACTCCAGCCTGGGCGACAGCGAGACTCTGTCTCAAAAAAAAAAAAAAAAATTAGCTAGGCATGGTGGCGCATGCCTGTAATCCCAGCTACTTGGGAGGCTGAGGCAGGAGAATCGCTTGAACCTGGGAGGCAGAGGCTGCAGTGAGACAAGATCACGCCATTGCACTCCAGCCTGGGCAACAAGAGTGAAACTCCATCTTCCCCCTACCAAAAAAAAAAA","GGCTGGGCGCAGTGGCTCACACCTGTAATCCCAGCACTTAGGGAAGCTGAGGCGAGTAGATCACCTGAGGTCAGGAGTTAGAGACCAGCCTGGCCATCATGGTGAAACCCCGTCTCTACTAAAGATACCAAAAATTAGCTGAGTGTGGTGCTGGGTGCCTGTAATCCCAGAAACTCAGGGTGCCTGTAATCCCAGCAACTCAGGGTGCCTTTAATCCCAGCAACTGAGGGTACCAGTAATCCCAGCAACTCAGGGTGTCTTTAATCCTAGCAACTGAGGGCACCTGTAATCCCAGCAACTCAGGAAGCTGAGACAGGAGAAGTACTTGAACCCAGAAGGCAGAGGTTGCAGTGAGCCGATATTGCACCATTGCACTCCAGTCTGGGCAACAAGAGTGAAACTCTGTCTCAAAAAAAAA"
"chr14","49081899","49082239","JH378114","14264965","14265292","65","34816934","GGCCAGGTACAGTGGCTCATGCCTGTAATCTCAGCATTTTGGGAGGCTGAGGCAGGCAGATCACCTGAGGTCAGGAGTTCGTGACCAGCCTGACCAGTGAAACCCTGTCTCTACTGAAAAAAATAAAATAAAATAAAATAAAAATAAAAATTAGCTGGGTGTGGTGGTGGGCGCCTGTAATCCCAGCTACTCGGCAGGCTGAGGCAGGAGAATTGCTTGTACCCGGGAGGCGGAGGTTGCAGTGAGCCAAGATCATGCCATTGCACTACAGCCTAGGTGACAAGAGCAAAACTCTGTCTCAAAACAAAACAACAACAACAACAACAACTAAAAAAAAAAAA","GGCCAGGCGCGGTGGCTCAAGCCTGTAATCCCAGCACTTTGGGAGGCCGAGGCGGGTGGATCATGAGGTCAAGAGATCGAGACCATCCTGGTCAACATGGTGAAACCCCGTCTCTACTAAAAACAGAAAAAAAATAAAAATAAAAATAATTAGCTGGGCATGGTGGAGCATGCCTGTAATCCCAGCTACTCAGGAGGCTGAGGCAGGAGAATTGCCTGAACCGAGGAGGCGGAGGTTGCGGGGAGCCAAGATCGCGCCATTGCACTCCAGCCTGGGCAACAAGAGCGAAACTCCGTCTCAAAAAAAAAAAAAAAAAAAAAAAAAAAAA"
"chr14","54833704","54834332","JH378118","18053084","18053501","272","36780620","GGCCAGGTGCAGTGGCTCACTCCTGTAATTCCAGCACTTTGGGAGGCTGCCGGTGGATCACCTGAGGTCAGGAGTTCGAGATCAGCCTGGCCAACATGGTGAAACCCCGTCTCTACTAATAATACAAAAATTAGCCAGGCAAGGCCGGGCGCAGTGGCTCACACCTGTAATCCCAGCACTTTGGGAGGCCGAGGCGGGCGGATCACCTGAGGTCGGGAGTTCAAGACCAGCCTGACCAACATGGAGAAACCCCATCTCTACTAAAAATACAAAATTAGCTGGGCATGGTGGCACATGCCTGTAATCCCAGCTACTAGGGAGGCTGAGGCAGGCGAATCGCTTGAACCTGGGAGGTGGAGGTTGCGGTGGGCCGAGATGGTGCCATTGCACTCTAGCCCGGGCAACAAGAGCGAAACTCTGTCTCAAAAAAAAAAAAAAAAAAAAAAAAATTAGCCAGGCATGGTAGCACACCCTTGTAATCCCAGCTACTCGGGAGGCTGAGGCAGGAGAGTTGCTTGAACCCGAGAGACGGAGGTTGCAGTGAGCTGAGATCGTGCCATTGCACTCCAACCTGGGTGACAAGAGTGAAACTCCATCTCCAAAAAAAAAAATAAATAAAATAAATAAAA","GGCTGGGCGCAGTGGCTCACACCTGTAATCCCAGCACTTAGGGAAGCTGAGGCGAGTAGATCACCTGAGGTCAGGAGTTAGAGACCAGCCTGGCCATCATGGTGAAACCCCGTCTCTACTAAAGATACCAAAAATTAGCTGAGTGTGGTGCTGGGTGCCTGTAATCCCAGAAACTCAGGGTGCCTGTAATCCCAGCAACTCAGGGTGCCTTTAATCCCAGCAACTGAGGGTACCAGTAATCCCAGCAACTCAGGGTGTCTTTAATCCTAGCAACTGAGGGCACCTGTAATCCCAGCAACTCAGGAAGCTGAGACAGGAGAAGTACTTGAACCCAGAAGGCAGAGGTTGCAGTGAGCCGATATTGCACCATTGCACTCCAGTCTGGGCAACAAGAGTGAAACTCTGTCTCAAAAAAAAA"
"chr14","55277737","55278067","JH378148","10302642","10302970","61","44975095","GGCCGGGTGCAGTGGCCCACCTCTGTAATCCTAACACTTTGGGAGGCCAAGGCAGGCAGGTCACTTGAGGTCAGGAGTTCAAGACTAACCTGGCCAACATGGTGAAACCCCGTCTCTACTAAAAATACGAAAATTAGCCGGGCTTCATGATGCATGCCTGTAATCCCAGCTACTAAGGAGGCTGAGGCAGAAGAATCTCTTGAACCCATGAGGTTGCAGTGAGCTGAGATCTCGCCATTGCACTCCAGCCTGGAGGACAAGAGCGAAACTCTGTCTCAAAAAAATAAAATAAAATAAATAAGAATAAAATAATAATAAAAGGCAAAAAGAA","GGCCGGGCGCGGTGGCTCAAGCCTGTAATCCCAGCACTTTGGGAGGCCGAGGCGGGTGGATCACGAGGTCAAGAGATCGAGACCATCCTGGTCAACATGGTGAAACCCCGTCTCTACTAAAAATACAAAAAATTAGCTGGGCATGGTGGTGGGTGCCTGTAATCCCAGCTACTCAGGAGGCTGAGGCAGGAGAATTGCCTGAACCCAGGAGGCGGAGGTTGCGGTGAGCCGAGATCGCGCCATTGCACTCCAGCCTGGGTAACAAGAGTGAAACTCTGCCTCAAAAAAAAAAAATAAAATAAAATAAAATAAAATAAAATAAAATAAAA"
"chr14","55822103","55822700","JH378118","18053084","18053501","240","37769019","GGCCAGGCGCAGTGGCTCACGCCTGTAATCCCAGCACTTTAGGAGGCCGAGGCAGGTGGATCGCCTGAGTTCAGGAGTTCAAACCCACCCTGGCCAACATGGTGAAACCCTGCCTCTACTAAAAAACAAAAAAATGGCCAAGCGTGGTGGCTCACGCCTGTAATTCCAGCACTTTGGGAGGCTGAGGCAGGCGAATCACGAGGTCAGGAGATCGAGACCATCCTGGCTAACATGGTGAAACCCCATCTCTATTAAAAATACAGAAAATTAGCCAGGCGTGGTGGTGGACGCCTGTAGTCCCAGCTTCTTGGGAGGCTGAGGCAGGAGAATGGCATGAACCCGGGAGGCAGAGCTTGCAGTGAGCTGAGATTGCGCCAGTGCACTACAGCCTGTGGGACAGAGCAACTCCGTCTCAAAAAAAAAAAAAATTAGCTGGGCATGGTGGCATATGCCTGTAATCCCAGCTACTAAGGAGGCTGAGGCGGGAGAATCGCTTGAACCCGGGAGGCAGAGGTTGCAGTGAGCCGAGATTGCGCCATTGCACTCCAGTCTGGACAACAAGAGTGAACTGTGTCTCAAAAAAAAAAAAAAAAAAAGA","GGCTGGGCGCAGTGGCTCACACCTGTAATCCCAGCACTTAGGGAAGCTGAGGCGAGTAGATCACCTGAGGTCAGGAGTTAGAGACCAGCCTGGCCATCATGGTGAAACCCCGTCTCTACTAAAGATACCAAAAATTAGCTGAGTGTGGTGCTGGGTGCCTGTAATCCCAGAAACTCAGGGTGCCTGTAATCCCAGCAACTCAGGGTGCCTTTAATCCCAGCAACTGAGGGTACCAGTAATCCCAGCAACTCAGGGTGTCTTTAATCCTAGCAACTGAGGGCACCTGTAATCCCAGCAACTCAGGAAGCTGAGACAGGAGAAGTACTTGAACCCAGAAGGCAGAGGTTGCAGTGAGCCGATATTGCACCATTGCACTCCAGTCTGGGCAACAAGAGTGAAACTCTGTCTCAAAAAAAAA"
"chr14","55860214","55860812","JH378118","18053084","18053501","246","37807130","GGCCGGATGCAGTGGCTCACGCCTGTAATCCCAGCACTTTGGGAGGCCAAGGCAAGCGGATCACCTGAGGTCAGGAGTTCAAGACCAGCCTGGCCAGCATGGTGAAACCCCTTCTCTACTAAAAATACAAAAATTAGCCGGGGCCTTGCGTGGTGGCTCACACCTGTAAATCCCAGCGCTTTGGGAGGCCGAGGCAGGCGGATCACCTGAGGTCGGGAGTTCAAGAACAGCCTGACCAACATGGAGAAACCCCGTCTCCACTAAAAATAGAAAAATAGCCGGGCATGGTGGCGCATGCTTGTAATCTCAGCTACTCGGGAGGCTGAGGCAGGAGATCACTTGAACCCAAGAGGCAGAGGTTGCGGTGAGCCGAGATCGCGCCATTGCACTCCAGCCTGGGCAACAAAGAGCGAAACTCCGTCTCCAAAAAAAAAAAAAAAAAATTAGCCGGGCGTGGTGGCACATACCTGTAATCCCAGCTATTCAGGAGGCTGAGGCAGGAGAATCCCTTGAACCCGGGAGGCAGAGATGGCAGTGAGCTGAGATCACGCCATTGCACTCCAGCCTGGGTGAGAGGAGTGAAACTCCGTCTAAAAAAA","GGCTGGGCGCAGTGGCTCACACCTGTAATCCCAGCACTTAGGGAAGCTGAGGCGAGTAGATCACCTGAGGTCAGGAGTTAGAGACCAGCCTGGCCATCATGGTGAAACCCCGTCTCTACTAAAGATACCAAAAATTAGCTGAGTGTGGTGCTGGGTGCCTGTAATCCCAGAAACTCAGGGTGCCTGTAATCCCAGCAACTCAGGGTGCCTTTAATCCCAGCAACTGAGGGTACCAGTAATCCCAGCAACTCAGGGTGTCTTTAATCCTAGCAACTGAGGGCACCTGTAATCCCAGCAACTCAGGAAGCTGAGACAGGAGAAGTACTTGAACCCAGAAGGCAGAGGTTGCAGTGAGCCGATATTGCACCATTGCACTCCAGTCTGGGCAACAAGAGTGAAACTCTGTCTCAAAAAAAAA"
"chr14","56736257","56736880","JH378206","6546474","6546861","276","50189783","GGCCAGGCACAGTGGCTCATGCCTGTAATCCCTGCACTTTGGGAGGCCAAGGCGGGTGGATCACCTGAGGTCAGGAGTTCGAGACTAGCCTGGCCAACATGGTTGGCCATCTCTTCTAAAAATACAAAAAATTAAGTTGGGCATGGTGGCTCATGCCTGTAATCCCAGCATTTTGGGAGGCCAAGGCAGGTGGATCATAAGGTCAAGAGATTGAGACCATCCTGGCCAACATGGTGAAACCCCATCTCTACTAAAAATACAAAAATTAGCTGGGCGTGGTGGTAGCACACACCTGCAGTCCCAGCTGCTCAGGAGGCTGAGGCAGGAGAATCACTTGAACCCGGGAAGCAGAGGTTGCAGTGAGCCGAAATTGCACCACTGCACTCCAGCCTGGCGACAAAGCAAGACTCCGTCAAAAAAAAAAAAAAAAAAAAAAAAATTAGCCAGGAGTGGTGGCACGTGCCTATAGTTCCAGCTACTCGGGAGGCTGAGGCAAGAGATTTGCTTGAACCTGGGAAGCAGAGGTTGCATATATTGCAGTGAGCCAAGATTATGCCATTGCACTCCAGCCTGGGCAACAAGAGTGAAAATCTGTCTAAAAAGAAAAAAAAAAGAAAAGAAAAA","GGCCACACATGGTGGCTAACGCCTGTAATCCCAGCACTTTGGGAGGCCAAGTCGGGTGGATCATGAGGTCAGGAGACCAAGACCATCCTGGCCAAATGGTGAAACCCCGTCTCTACTAAAAATACAAAAATTAGCTGGGCATGGTGGCGTGTGCCTGTAATCCCAGCTACTCAGGAGGCTGAGGCAGGACAATTGCCTGAACCCAGGAGAATTAGCTGGGCATGGTGGCGTGTGCCTGTAATCCCAGCTACTCAGGAGGCTGAGGCAGGACAATTGCCTGAACCCAGGAGGCGAAGGTTGCGGTGAGCCGAGATTGTGCCATTGCACTCCAGCCTGGGTAACAAGAGCGACACTCTGTCTCAAAAAAAAAAAAAAAAAAAAAAAAAAA"
"chr14","56744047","56744674","JH378118","18053084","18053501","281","38690963","GGCCGGGTGCGGTGACTCACATCTATAATCCCAGCACTTTGGGAGGCCAAGGCAGGTGGATCACCTGAGGTCAGGAGTTCAAGACCAGCCTGGCCAACTTGGTGAAACCCCATCTCTACTAAAAAATATAAAAATTTGCCAGGTGCGGTGGCTCATACCTGTAATCCCAGCACTTTGAGAGGCAGAGGTGGGTGGATCACGAGGTCAGGAGTTCGAGACCAGCCTGGCCAATGTGGTGAAACCCCATCTCTACTAAAAATACAAAAATTAGCCGGGTGTGGTGATGCGTGCCTGTAGTCCCAGCTATTCGGGAGGTTGAGGCAGGAGAATGGCGTGAACCAGGAAGGCGGAGCTTTCACTGAGCGGAGATCGCACCACTGCACTCCAGCCTGGGCGACGGAGCGAGACTCTGTCTCAAAAACAAAACAAAACAAAAAAACAAACAAACAAAAAAACATTATCCGGGTGTGGTGGTGGGCGCCTGTAATCCCAGCTACTTGGGAGGCTGAAGCAGGAGGATTGCTTGAACCTGGGAGGTGGAGGTTGCAGTGAGCTGAGATCACGCCTCTGCACTGCAGGCTGGACGACAAGAACAAAACTCTGAATCAACAACAACAACAACAAAAAA","GGCTGGGCGCAGTGGCTCACACCTGTAATCCCAGCACTTAGGGAAGCTGAGGCGAGTAGATCACCTGAGGTCAGGAGTTAGAGACCAGCCTGGCCATCATGGTGAAACCCCGTCTCTACTAAAGATACCAAAAATTAGCTGAGTGTGGTGCTGGGTGCCTGTAATCCCAGAAACTCAGGGTGCCTGTAATCCCAGCAACTCAGGGTGCCTTTAATCCCAGCAACTGAGGGTACCAGTAATCCCAGCAACTCAGGGTGTCTTTAATCCTAGCAACTGAGGGCACCTGTAATCCCAGCAACTCAGGAAGCTGAGACAGGAGAAGTACTTGAACCCAGAAGGCAGAGGTTGCAGTGAGCCGATATTGCACCATTGCACTCCAGTCTGGGCAACAAGAGTGAAACTCTGTCTCAAAAAAAAA"
"chr14","58283278","58283584","JH378115","34663603","34663898","52","23619675","CCGGGTGCGGTGGCTCACGCCTGTAATCCCAGCACTTTGGGAAGCTGAGGTGGGTGGATCATTTGAGGTCAAGAGTTCTAGACCAGCCTGGCCAACATGGTGAAACCCTACTTCTAATAAACACACACACACACACACACACACACACACACACACAAATTAGCCAGCAGGCACCTGTAATCCCAGCTACTCGGAAGGCTGAGGCAGGACAATCGCTTGAACCTGGGAGGCCAGAAGTTGCAGTGAGCCAAGATCATGCCACTGCACTCCAGTCTGGGTGACAAGAGCAAGACTCCATTTCAAAAAA","GGCCTGGTGAAGTGGCTCACGCCTGTAATCCCAACACTTTGGGAGGCTGAGATGGATGGCTCATTTGAGGTCAGGAGTTCTAGACCAGCCTGGCCAACATGGTAAAAGCCCACCTCTACCAAAAATACAAAAACAAAAACAAAAAAATTTTAGCCAACAGGCACCTTTAATCCCAGCTACTCAGGAGGCTGAGGCAGGAGAATTGCTTGAATCTGGGAGGCCAGAAGTTGCAGTGAGCCAGGATCACACCACTGCACTCCATCCTAGGCGACAAGAGCAAGACTCCAAAAAAAAAA"
"chr14","59226808","59227410","JH378118","18053084","18053501","257","41173724","GGCTGGGCGCTGTGGCTCATGCCTGTAATCCCAGCACTTTAGGAAGCCAAGGGAGGTGGATCACCTGAGGTCAGAGTTCAAGTCCGGCCTGACCAACATGGCGAAACCCAGTCTCTACTAAAAATACAAAATTGGCCAGGCGTGGGGTGGCTCACACCTGTAATCCCAGCACTTTGGGAGGCCGAAGTGGGTGGATCACTTGAGGTCAGGAGTTTGAGACCAGCCTGGTTAACATGGTGAAACCCCATCTCTACTAAAAATACAAAAATTAGCCAGGCATGGTGGCAGGCGCCTGCAATCCCAGTTACTCAGGAGGCTGGTGCAGGAGAATCGCTTAAACCTAGGAGGCAGAGGTTGCAGTGAACTGAGATCGTGCCATTGCACTCCAGCCTGGGTAACAACAGCAAGACTTCATCTCAAAAAAAAAAATACATAATTATAATTAGCTGGGCGTGTTGGCGAGCGCCTGTAGTCCCTGCTACTTGGGAGGCTGAGGCAGGGGAATCACTTGAACCTGAGAGGCGGAGGTTGCAGTGAGCCAAGTCACGCCATTGCATTCCAGCCTCGGCAACAAGAGCAAAACTCCATCTCAAAAAAAAAAAA","GGCTGGGCGCAGTGGCTCACACCTGTAATCCCAGCACTTAGGGAAGCTGAGGCGAGTAGATCACCTGAGGTCAGGAGTTAGAGACCAGCCTGGCCATCATGGTGAAACCCCGTCTCTACTAAAGATACCAAAAATTAGCTGAGTGTGGTGCTGGGTGCCTGTAATCCCAGAAACTCAGGGTGCCTGTAATCCCAGCAACTCAGGGTGCCTTTAATCCCAGCAACTGAGGGTACCAGTAATCCCAGCAACTCAGGGTGTCTTTAATCCTAGCAACTGAGGGCACCTGTAATCCCAGCAACTCAGGAAGCTGAGACAGGAGAAGTACTTGAACCCAGAAGGCAGAGGTTGCAGTGAGCCGATATTGCACCATTGCACTCCAGTCTGGGCAACAAGAGTGAAACTCTGTCTCAAAAAAAAA"
"chr14","62992080","62992681","JH378118","18053084","18053501","256","44938996","GGCCGGATGCAGTGGCCCACACCTGTAATCCTAGCACTTTGAGAGGCTGAAGCAGGCAGATCACTTGCGGTCAGGAGTTTGAGACCAGCCTGGCCAACATAGTAAAACCTCATCTCTACTAAAAATAGAAAAATTTTCTGACCAGGCACGGTGGCTCGCGCCTGTAATCCCAGCACTTTGGGAGGCCAAGGTGGGCACATTACCTGAGATCAAGAGTTCAAGACCAGCCTGACCAACATGGCAAAACTCTGTCTCTACTAAAAATACAAAATTAGCCGGGCATAGTGGCGCATTCCTGTAATCCCAGCTACTAAGGAGGCTGAGGCAGGAGAATTGCTTGAACCCGGGAGCCGGAGGTTGCAGTAAGCCAAGATTGCGCACTGCACTCTAGGCTGGGCAACAACAGCGAAACTCTGTCTCGAAAAAAAAAAAAAAAAAAATTAGCTGGGCGTGGTGGTGAGTACCTGTAATCCCAGCTACTTGGGAGACTGAGGCAGGAGAATCTCTTGAACCTGGGAGGTAGAGGTTGCAGCGAGCTTAGATCACACCACTGCACTAAAGCCTGGGGGACAAGAGCAAAACTCTATCTCAAAAAAATAAAA","GGCTGGGCGCAGTGGCTCACACCTGTAATCCCAGCACTTAGGGAAGCTGAGGCGAGTAGATCACCTGAGGTCAGGAGTTAGAGACCAGCCTGGCCATCATGGTGAAACCCCGTCTCTACTAAAGATACCAAAAATTAGCTGAGTGTGGTGCTGGGTGCCTGTAATCCCAGAAACTCAGGGTGCCTGTAATCCCAGCAACTCAGGGTGCCTTTAATCCCAGCAACTGAGGGTACCAGTAATCCCAGCAACTCAGGGTGTCTTTAATCCTAGCAACTGAGGGCACCTGTAATCCCAGCAACTCAGGAAGCTGAGACAGGAGAAGTACTTGAACCCAGAAGGCAGAGGTTGCAGTGAGCCGATATTGCACCATTGCACTCCAGTCTGGGCAACAAGAGTGAAACTCTGTCTCAAAAAAAAA"
"chr14","75046278","75046878","JH378118","18053084","18053501","246","56993194","GGCCGGGCACAGTGGCTCACACCTATAATCTCAGTACTTTGGGAGGCCAAGGCGGGCAGATCACTTGAGGTCAGGAGTTCGAGACCACCCTGGCCAACATGGTGAAACCTCATCTCTACTAAAAATACAAAAAACTGGCTGGGTGAAGTGGCTCACGCCTGTAATCCCAGCAGTTTGGGAGGCCAAGGCGGGCCAATCACGAGGTCAGGAGTTCGAGACCAGCCTGGCCAATATGGTGAAACCCCGTCTCTATTAAAAATTCAAAAATTAGCTGGATGTGGTGGCAGGCACCTACAATCCCAGCTACTTGGAAGGCTGAGGCAGGAGAGTCTGCTTGAAACCAGAAGGCGGAGGTTGCAGTGAGTGAGCTGAGAACGTGCCACTGCACTCCAGCCTGGGCGAAAGAGCAAAACGCTGTCTCAGGGGGAAAAAAAAAACTAGCCGGGCATGGTGGCAGGTGCCTGTAATCCCAGCTACTCAGGAGGCTGAGGCAGGAGAATTGCTTGAACCCAGGAGGAGGAGGTTGCAGTGAGTCGAGATCACGTCATTGCACTCCCAGCCTGGCTGATAAGAGCGAAACTCCGTCAAAAAAAAAAAAAAA","GGCTGGGCGCAGTGGCTCACACCTGTAATCCCAGCACTTAGGGAAGCTGAGGCGAGTAGATCACCTGAGGTCAGGAGTTAGAGACCAGCCTGGCCATCATGGTGAAACCCCGTCTCTACTAAAGATACCAAAAATTAGCTGAGTGTGGTGCTGGGTGCCTGTAATCCCAGAAACTCAGGGTGCCTGTAATCCCAGCAACTCAGGGTGCCTTTAATCCCAGCAACTGAGGGTACCAGTAATCCCAGCAACTCAGGGTGTCTTTAATCCTAGCAACTGAGGGCACCTGTAATCCCAGCAACTCAGGAAGCTGAGACAGGAGAAGTACTTGAACCCAGAAGGCAGAGGTTGCAGTGAGCCGATATTGCACCATTGCACTCCAGTCTGGGCAACAAGAGTGAAACTCTGTCTCAAAAAAAAA"
"chr14","83813857","83814442","JH378118","18053084","18053501","240","65760773","GGCCAGGCGCGGTGGCTCACGCCTGTAATCCCAGCACTTTGGGAGGCCGAGGCGGGCGGATCACCTGAGGTCAGGGGTTCAAGACCAGCCTGACCATCCCAGAACTTTGGGAGGCCGAGACGGGTGGATCATGAGGTCAGGAGATCGAGACCATCCTGGCTAACACAGTGAAACCCCATCTCTATTAAAAATACAAAAAATTAGCCGGGCGTGGTGGCAGCTCCTGTAGTCCCAGCTACTCGGGAGGCTGAGGCAGGAGAATGGCGTGAACCCGGGAGGCGGAGCTTGCCGTGAGCCGAGATCGCACCACTGCACTCCAGCCTGCAAGATAGCGAGGCTATGTCTCAGGAAAAAAAAAAAAAAAAAAAAAAAGACCAACCTGACCAACATGGTAAAACCCCATCTCTACTAAAAATACAAAATTAGCCGGGCATGGTGGCAGACGCCTGTAATCCCAGCTACTCAGGAGGCTGAGGCAGGAAAATCACTTGAACCCAGGAGGTGGAGGTTGCGGTGAGCCGAGATCGTGCCATTGCACTCCGGCCTGGGTGACAACAGCGAAACTCCATCTCAAAAAAAAGAAAAA","GGCTGGGCGCAGTGGCTCACACCTGTAATCCCAGCACTTAGGGAAGCTGAGGCGAGTAGATCACCTGAGGTCAGGAGTTAGAGACCAGCCTGGCCATCATGGTGAAACCCCGTCTCTACTAAAGATACCAAAAATTAGCTGAGTGTGGTGCTGGGTGCCTGTAATCCCAGAAACTCAGGGTGCCTGTAATCCCAGCAACTCAGGGTGCCTTTAATCCCAGCAACTGAGGGTACCAGTAATCCCAGCAACTCAGGGTGTCTTTAATCCTAGCAACTGAGGGCACCTGTAATCCCAGCAACTCAGGAAGCTGAGACAGGAGAAGTACTTGAACCCAGAAGGCAGAGGTTGCAGTGAGCCGATATTGCACCATTGCACTCCAGTCTGGGCAACAAGAGTGAAACTCTGTCTCAAAAAAAAA"
"chr14","84224287","84224910","JH378118","18053084","18053501","265","66171203","GGCAGGGTGCAGTGGCTCATACCTGTAATCCCAGCACTCTGGGAGGCCGAGGTGGGCAGATCACTTGAGCTCAGGAGTTTGAGACCAGCCTGGCCAACATAGTGAAACCCCATCTCTACTAAAAATACAAAATTAGGCTGGGCACAGTGACTCACGTCTGTAATCCCAGCACTTTGGGAGGCCGAGGCTGGTGGATCACAAGGTCAGGAGATCAAGACCATCCTGTCCAACATAGTGAAACCCCATCTCTACTAAAAATACAAAAATTAGCTGGACGTGGAGGTGCACATCTGTAGTCCCAGCTACTTGTGAGGCTGAGGCAGGAGAACTGCTTGAACCCAGGAGGCGGAGGCTGCAGTGAGCTGAGATTGTGCCACTGCACTCCAGCCTGGGCGACAGAGCGAGACTCTGTCTCAAAAAAAAAAAAAAACAGAAAAAACAAAATTAGCCGGGCATGGTGGTGCACGCCTGTAACCCCAGCTACTTGGGGGGCTGAGGCAGGAGAATTGCTTGAACCTGAGAGGTGGAGGTTTCAGTGAGCCGAGATTGTGCCATTGCCCTCCAGTCTGGGCAACAAGAGCAAAACTCCGTCTCAAAAAAAAAAAAAAGAAAAAAAAAGAAGAA","GGCTGGGCGCAGTGGCTCACACCTGTAATCCCAGCACTTAGGGAAGCTGAGGCGAGTAGATCACCTGAGGTCAGGAGTTAGAGACCAGCCTGGCCATCATGGTGAAACCCCGTCTCTACTAAAGATACCAAAAATTAGCTGAGTGTGGTGCTGGGTGCCTGTAATCCCAGAAACTCAGGGTGCCTGTAATCCCAGCAACTCAGGGTGCCTTTAATCCCAGCAACTGAGGGTACCAGTAATCCCAGCAACTCAGGGTGTCTTTAATCCTAGCAACTGAGGGCACCTGTAATCCCAGCAACTCAGGAAGCTGAGACAGGAGAAGTACTTGAACCCAGAAGGCAGAGGTTGCAGTGAGCCGATATTGCACCATTGCACTCCAGTCTGGGCAACAAGAGTGAAACTCTGTCTCAAAAAAAAA"
"chr14","85020958","85021268","JH378108","34510794","34511096","52","50510164","GCCAGGTGCAGTGGCTCATGCCTGTAATTCCAGTACTTTGAGAGGTCGAGACAGGGAGATCACCTGAGGCCAGGAGTTCAAGACTAGCTTGGCCAACATGGCAAAACCCTGTCTCTACTAAAAATGCAAAAAAAAAAAAAAAAAAAAAAAAAAAATTAGCCTGGCATGGTGGTAGACACCTGTAATCCCAGCTACTTGGGAGGCTGAGACAGGAGAACCTCTTGAATCTGGGAGGAGGAGGTTGCTGTGAGCTGAGATCGTGCCACTGCACTCCAGCCTGGGTAACAAGAGAGAAACTCTGTCTCAAAAAA","GGGTGCCGTGTCTCATGCCTGTAATTCCAGCACTTTGGGAGGTCAAGGCAGTCCGATCACCTGAGGTCAGGAGTTTGAGACTAGCCTGGCCAAAATGGTGAAACCCTGTCTCTAGAAAAAATACAAAAAAAAAAAAAAAAAAAAAAAAAAATTAGCTGGATGTAGTGGTGCATACCTGTAGTCCCAGCTACTCTGGAGGCTGAGGCAGGAGAATTGTTTGAACCCAGGAGGCGGAGGTTGCGGTGAGCCGAGATCATGCCATTGCACTCCAGCCTGGGAAACAAGAGTGAAACTCTGTCTCAA"
"chr14","86696589","86696920","JH378203","2698403","2698735","56","83998186","GGCCAGGCACGGTGGCTCATGCCTATAACCAGCACTTTGGAGGCCGAGGCAGGTGGATCACCTGAGGTCAGGAGTTTGAGACTGGCCTGGCCAGCATGGTGAAACTCTGTCTCTACTAAAAAAAAAAAAAAAAAAAAAAAAAAAAAAGTACAAAATTAGCTGGATGTGGTGGTAGGCACCTGTAATCCCAGCTACTTGGGAGGCTGAGGCAGGAGAATCGCTTGAACCCAGGAGGCAGAGATTGCAGTGAGCCAAGATTGCGCCATTGTACTCCACTCTGGGCAATGAGCGAAACTCCGTCTCAAAAAAAAAATAAAATAAAAATAAAATAA","GCCGGGTGCAGTGGCTCATACCTCTAATCCCAGCACTTTGGGAGGCCAAGGCAGGTGATCACCTGTGGTCAGGAGTTCGAGACCAGCCTGGCCAACATGGTGAAACCCTGTCTTTACTAAAAATACAAAAAAAAAAAAAAAAAAAAAAAAAAAAAACTTAGCCCACCATGGTGGTGGGCTCTTGTAGTCCCAGCTACATGGGAGGCTGAGGCAGAAGAATCGCTTGAAGACAGGAGGTGGAGGTTGCAGTGAGCCAAGACTGCGCCATTGCACTCAGCCTGGGTGACGAGCCAAACTCCATCTCAAAAAAAAAAAAAAAAAAAAAAAAAAAAA"
"chr14","86944567","86945185","JH378118","18053084","18053501","274","68891483","GAGCACGGTGGCTCACGCCTGCAATCCCAGCACTTTGGGAGGCCGAGGTGGGTGGATCACCTGAGGTTAGGAGTTTGAGACCAGCCTGGCCAACATGGTGAAACCGTCTCTACTAAAAATGCAAAAAAGTAGGGGCCGGGCACGGTGGCTCACGCCTGTAATCCCAGCACTTTGGGAGTCTGAGGCAGACGGATCACAAGGTCAGGAGATCAAGACCATGGTGAAACTCCGTCTCTACTAAAAATACAAAAAATTAGCTGGGCGTGGTGGTGGGCACCTGTAGTCCCAGCTGCTTGGGAGGCTGAGGCAGGAGAATGGTGTGAACCCGGGAGGCGGAGCTTGCAGTGAGCCGAGATCGCAACACTGCACTCCAGCCTGGGCGACAGAGCGAGACCCTGTCTCAAAAAAAACAAAAATAAACAAAAATAAATAAATACAAAAAAGTAGCCAGGCATGGTGGTGGGTGCCTGTAATCCCAGCTACTTGGGAGGCTGAGGCAGGAGAATCACCTGAACCCGGGAGGTGGAGGTTGCAGTGAGCCAAGACCGTGTCATTACACTCTAGCCTGGGCAACAAGAGCGAAATTCCATCTGAAAAAATAAATAAATAAAAATAAAAA","GGCTGGGCGCAGTGGCTCACACCTGTAATCCCAGCACTTAGGGAAGCTGAGGCGAGTAGATCACCTGAGGTCAGGAGTTAGAGACCAGCCTGGCCATCATGGTGAAACCCCGTCTCTACTAAAGATACCAAAAATTAGCTGAGTGTGGTGCTGGGTGCCTGTAATCCCAGAAACTCAGGGTGCCTGTAATCCCAGCAACTCAGGGTGCCTTTAATCCCAGCAACTGAGGGTACCAGTAATCCCAGCAACTCAGGGTGTCTTTAATCCTAGCAACTGAGGGCACCTGTAATCCCAGCAACTCAGGAAGCTGAGACAGGAGAAGTACTTGAACCCAGAAGGCAGAGGTTGCAGTGAGCCGATATTGCACCATTGCACTCCAGTCTGGGCAACAAGAGTGAAACTCTGTCTCAAAAAAAAA"
"chr14","87180871","87181803","JH378118","18053084","18053501","547","69127787","GGCCATGTGCGGTGGCTCACACCTGTAATCCCAGCACTGTGGGAGGCCAAGGTGGGCGGATCATTTGAGGTCAGGAGTTCTAAACCAGCCTGGCCAATATGGTGAAACACTGTCTCTGCTAAAAATACAAAAAAAGAAAAAGAAAAAAAAAAAAAGGCTGGGCACGGTGGCTCACGCCTGTAATCTCAGCACTTTGGGAGGCTGAGGTGGGTGGATTACCTGAGGTCAGGAGTTCGAGACCAGCCTGGCCAACATGGTGAAACCTTGTCTCTACTAAAAGTATAAAAATTAGCCAGGTGTGGTGGAGGTCGCCTGTAATCCCAGCTACTCAGTAGGCAGAGGCAGAAGAATCCGTTGAACCTGGGAGGCGGAGGTTGCAGTGAGCTGAGATTGCACCAGTGCATTCCAGCCCGGGTGACAAGAGTGAGACTCTGTCTCAAAATAAACAAACAAAAAAATTAGTGGGCCGGGTTCAATGACTCACGCCGGTAATCCCAGCACTTTGGGAGGCCAAGGAAGGCAGGTCACCTGAGGTCGGGAGCTCGAGACCAGCCTGACCAACATGGAGAAACCCCGTCTCTACTAAAAATACAAAATTAGCTGGGCGTGGTGGCACATGCCTGTAATTCCAGCTACTCAGGACGCTGAGGCAGGAGAATTGCTTGAACCCAGGAGGCGGAAGTTGCAGTGAGCCAAGATCATGACATTGCACTCCCGCCTGGGCGCCAAGAGTGAGATTTCGTCTCAAACAAACAAACAAAAAAACGAATTAGTGGAGCGTGGTGGCAGGCACCTAAAGTCCCAGCTATTCAGGAGGCTGAGGCAGGAGAATTGCTTGAACCTGGGAAGTGGAGGTTATAGTGAGCTGAGATCGCGCCATTGCACTCCAGCCTGGGCAACAAGAGTGAGAATCTGTCTAAAAAAAAAAAAGAA","GGCTGGGCGCAGTGGCTCACACCTGTAATCCCAGCACTTAGGGAAGCTGAGGCGAGTAGATCACCTGAGGTCAGGAGTTAGAGACCAGCCTGGCCATCATGGTGAAACCCCGTCTCTACTAAAGATACCAAAAATTAGCTGAGTGTGGTGCTGGGTGCCTGTAATCCCAGAAACTCAGGGTGCCTGTAATCCCAGCAACTCAGGGTGCCTTTAATCCCAGCAACTGAGGGTACCAGTAATCCCAGCAACTCAGGGTGTCTTTAATCCTAGCAACTGAGGGCACCTGTAATCCCAGCAACTCAGGAAGCTGAGACAGGAGAAGTACTTGAACCCAGAAGGCAGAGGTTGCAGTGAGCCGATATTGCACCATTGCACTCCAGTCTGGGCAACAAGAGTGAAACTCTGTCTCAAAAAAAAA"
"chr15","7203590","7204226","JH378118","18053084","18053501","285","10849494","GGCCAGGTGCAGTGGCTCATGCCTCTAATCCCAGCACTTTGGGAGGCCGAGATGGGCAGATCACCGGAGGTCAGGAGTTTGAGACCAGCTTGGCCAAAATGGTGAAACCCTGTCTCTACAAAAAAATACAAAAATGGCTAGGCACGGTGGCTCACACCTGTAATCCCAGCACTTTGGGATACAGGTGGATCATGAGGTCAAGAGATCAAGATCATCTTGGCCAACATGGCAAAACCCTGTCTCTACTAAAAAATACAAAAAATTAGCTGGGCGTGGTGGTGCACGCCTGTAGTCCCAGCTACTCAGGAAACTGAGGCAAGAGAATCGCTTGAACCTGGGAGGTAGAGGTTGCAGTGAGCCGAGATGCACTCCAGCCTGGCAACAGAACAAGACTCCATCTCAAAGAACAAAAACAAAACAAAACAAAACAAAAGACAAGCAAACAAAAAAATACAAAAATTAGCTAGGTGTGGTGGCAGGCGCCTGTAATCCCAGCTACTCAGGAGGCTGAGGCAGGAGAATCGCTTGAACCTGGGAGGCGGAGGTTGCAGTGAGCCAAGATTGTGCCATTGCACTCCAGCCTAGGTGACAAGAGTGAAAAGACGTCTCAAAAACAAAACCAAAAAAAAAAATAAAA","GGCTGGGCGCAGTGGCTCACACCTGTAATCCCAGCACTTAGGGAAGCTGAGGCGAGTAGATCACCTGAGGTCAGGAGTTAGAGACCAGCCTGGCCATCATGGTGAAACCCCGTCTCTACTAAAGATACCAAAAATTAGCTGAGTGTGGTGCTGGGTGCCTGTAATCCCAGAAACTCAGGGTGCCTGTAATCCCAGCAACTCAGGGTGCCTTTAATCCCAGCAACTGAGGGTACCAGTAATCCCAGCAACTCAGGGTGTCTTTAATCCTAGCAACTGAGGGCACCTGTAATCCCAGCAACTCAGGAAGCTGAGACAGGAGAAGTACTTGAACCCAGAAGGCAGAGGTTGCAGTGAGCCGATATTGCACCATTGCACTCCAGTCTGGGCAACAAGAGTGAAACTCTGTCTCAAAAAAAAA"
"chr15","13675429","13675731","JH378235","1186107","1186418","53","12489322","GGCTTGGCACAGTGGCTCATGCCTGTAATCCCAGCACTTTGAGAGACCGAGGCAAGTGGATCCCAGGAGTTCAAGACCAGCCTGGCCAAGATGGTGAAACCCCCCATCTCTACTAAAAATACAAAAAAAAAAAAAAAAAAAAAAAAAGGGCTTAGTGGCTGGCAGCTGTAGTCCCAGCTACTCGGGAGGCTGAGGCAGGAGAATCGCTTGAACCTGGGAAGCGGAGGTTGCAGTGAGCCAAGATCACACCATTGCACTCTAGCCTGGGCAACAAGGGCAAAACTCCATCTCAAAAAAAAAGAA","GGCTGGGCGCAGTGGCTCAAGCCTGTAATCCCAGCACTTTGGGAGGCCGAGGGGGGTGGATCACGAGGTCAAGAGATCAAGACCATCCTGGTCAACATGGTGAAACCCCGTCTCTACTAAAAAAAAAAAAAAAAAAAAAAAAAAAAAAAAAAAATTAGCTGGGCATGGTGGCGTGTAATCCCAGCTACTCAGGAGGCTGAGGCAGGAGAATTGCCTGAACCCAGGAGGCGGAGTTTGCGGTGAGCCAAGATCGCGCCATTGCACTCCAGCCTGGGTAACAAGAGCAAAACTCTGTCTCAAAAAAAAAAAAAA"
"chr15","14837014","14837358","JH378137","13677298","13677634","59","1159716","GCCGGGTATGGTGGCTCATGCCTGTAATTCCAGCACTTTGGGAGGCCGAGGCAGGCGGATCACCTGAGGTCAGGAGTTTGAGACCAGCCTGGCTAACATGGTGAAACTACGTTTCTACTAAAAATACAAAAAAAAAAAAAAAAAAAAAAAAAAAAAAAAAAAAAAAAAAAATTAGCCAGGCGTGGAGGCGCGTGCCTATAATCCCAGTTACTCGGGAGGCCGAGGCAGGAGAATCGCTTGAACCCAGGAGCCGGAGGGTGTAGTGAGCCGAGATCATGCCATTGCGCTCCAGGTTGGGCAACAAGAGCAGAACTCCGTCTCAAAAAAAAAAAAAAAAAAAAAAAA","GGCTGGGCATTGTGGCTCATGCCTGTAATCCCAGCACTTTGGGAGGCCGAGGTGGGCGGATCACCTGAGGTCGGGAGTTCAAGACCAGCCTGGCCACAATGGTGAAACTCTGTCTCTGCTAAAAAAAAAAAAAAAAAAAAAAAAAAAAAAAAAAAAAAAATTAGCCAGGCGTGGTGGCACACGCCTGTAATCCCAGCTATTTGGGAGGCTGAGGCAGGAGAATCGCTTGAACCTGAGAGGTGGAGGTTGCAGTGAGCCAAGATCATACCATTGCACTCCAGCTTGGGAACAAAGAGCAAAACGCCATCTCAAAAACAAAACAAACAAACTGAAAAAA"
"chr15","20684723","20685060","JH378262","266823","267148","57","20417900","GGCTGGGCGTGTTGGCTTACACCTGAAATCCCAGCACTCTGGGAGGCCGAGGCGGGCAGATCACCTGAGGTCAGGGGTTCGAGACCAGCTTGGCCAACATGGTGAAACCCCGTCGCTACTAAAAATACAAAAATTAGCTGGGCATGGTGGTGGGAGCCTGTAATCCCAGCTACTCAGGAGACTGAGGCAGGACAATCGCTTGAACCCAGGAGGCAGAGGTTGCAGCGAGCCGAGATCGTGCCACTGCACTCCAGCCTGGGAGGGAAGAGTGAAAGTCCATAACAACAACAAAACAACAAAACAACAACAACAACAACAACAACATCTCTGAAAGGAAA","GGCCGGGCGCGGTGGCTCAAGCCTGTAATCCCAGCACTTTGGGAGGCCGAGGCGGGTAGATCATGAGGTCAGGAGTTTGAGACCAGCCTGGCCAACATGGTGAAACCCCGTCTCTACTAAAAATACAAAAATTAGCCGGGCATGGTGGCCTGTGCCTGTAATCCTAGCTACCCAGGAAGCTGAGGCAGGAGAATTGCCTGAACCCAGGAGGCGGAGGTTGCGGTGAGCCGAGATCGTGCCATTGCACTCCAGCCTGGGTAACAAGAGCGAAACTCCGTCTCAAAAACAAACAAACAAACAAACAAAAACAAAAAACAAAAAACAAA"
"chr15","20894395","20894976","JH378119","32351107","32351490","257","11456712","GGTGGCTCACACCTGTAATCCCAGCACTTTGGGAAGCCGAGGTAGGTGGATCACCTGAGGTCAGGAGTTAGAGATCAGCCTGGACAACATGGTGAAACCCCATCTCTACTAAAAATACAAAAACTAACCAGGCTTGGTGGCTCACACCTGTAATCCCATCACTTTGGGAGGCCAAGGCGGGTGGACTACTTGAGGTCAGGAGTTTGAGACCAGCCTGGCTAACATGGTGAAACCCCATCTCTACTAAAAATACAAAAATTAGCTGGGCATGGCAGTGCGCGCCTGCAATCCCAGCTACCTGGGAGGCTAAGGCAGGGGAATTGTTTGAACCTGGGAGGCAGAGGTTGCAGTGAGCCGACACTGCACCACTGCACTCCAGCCTGGGTGACAGAGTGAGCCTCCGTCTCAAAAAAAAAAAAAAAAAAAAAAAAAAATTAGCCAGGTGTGGTGGCAGGCACCTGTGATCCCAGCTACTCAGGAGGCTGAGGCAGGAGAATTGCTTGAACCCAGGAGGCGGAGAGTGCAGTGAGCTGAGATCATGCCATTGCACTCCAGCCTGGGTGACAAGAGAGAAACTCTGTC","GGCCAGGTATGGTGGCTCACACCTGTAATCCCAGCACTTTGGGAGGCCAAGGCAGGCAGACCACCTGAGGTCAGGAGTTCGAGATCAGCCTAGCCAACATGGTGAAACCCCATCTCTAGTAAAAATAAAATTAGCCAGGCATGGTGGTGCATGCCTGTAACGCAGGTCAGGAGTTCGAGATCAGCTTAGCCAACATGGTGAAACCCCATCTCTAGTAAAAATAAAATTAGCCAGGCAGGTGGTGCCGCCTGTACTCGGGAGGCTGAGGCAGGAGAATCACTTGAACCCAAGAGGCAGAGGTTGCAGTCAGCCAAGATCATGCCATTGCACTCCAGCCTAAGCAAAAAGAGTAAAACTCAGTCTCAAAACAAAAAAACAAAAAAA"
"chr15","21092189","21092737","JH378206","6546474","6546861","200","14545715","GCCGGGCGTGGTGGCTCACGCCTGGCCTGTAATCCCAGCACTTTGGGAAGCCAAGGCGGGTGGTTCACCTGAGGTCAGGAGTTCAAGACCAGCCTGGCCAACATGGTGAAACCCTGTCTCTACTAATAATACAAAAATTAGCTGGGCATGGTGGTGCATGCCTGTAATCCCAGCTACTTGGGAGGCCGAGGCGAGCAGATCACCTGAGGTCAAGAGTTCGATACCAGCCTGACCAACATAGAGAAACCCCGTCTCTACTAAAAATGCAAAATTAGCCGGGCATGGTGGTGCATGCCTGTAATCCCCAGCTACTCGGGAGGCTGAGGCAGGAGAATCGCTTGAACCTGGGAGGCAGAGGTTGTGGTGAGCTGAGATCACGCCATTGCACTCCAGCCTGGGCTCGAAACTCCATCTTAAAAAAAAAAAAAAAAAAAAGAATCACTTGAACCCAGGAGGTGGAGGTTGCAGTGAGCTGAGAGTGCACCATTGTACTCCAGCCTGGGCGACAACAGCAAAACTCCATCACCTTAAAAAAAAAAAAAAAAAAGA","GGCCACACATGGTGGCTAACGCCTGTAATCCCAGCACTTTGGGAGGCCAAGTCGGGTGGATCATGAGGTCAGGAGACCAAGACCATCCTGGCCAAATGGTGAAACCCCGTCTCTACTAAAAATACAAAAATTAGCTGGGCATGGTGGCGTGTGCCTGTAATCCCAGCTACTCAGGAGGCTGAGGCAGGACAATTGCCTGAACCCAGGAGAATTAGCTGGGCATGGTGGCGTGTGCCTGTAATCCCAGCTACTCAGGAGGCTGAGGCAGGACAATTGCCTGAACCCAGGAGGCGAAGGTTGCGGTGAGCCGAGATTGTGCCATTGCACTCCAGCCTGGGTAACAAGAGCGACACTCTGTCTCAAAAAAAAAAAAAAAAAAAAAAAAAAA"
"chr15","21150084","21150391","JH378158","10397018","10397312","55","10753066","GGCCGGGCATGGTGGCTTATGCCTGTAATCCCAGCACTTTGGGAGGCTGAGGTGGGTGGATCACCTGAGGTCAGGAGTTCAAGACCACCCTGGTCAACATGGCAAAATCCTGTCTCTACTAAAAATACAAAATTAGCTGGGCGTGGTGGTGGGCGTCTGCCTGGGTGAGGCAGGAGAATCGCTTGAACCCAAGAGGCAGAGGTTGGAGTGAGCCAAGATCGTGCCATTGCACTCCAGCCTGGGCAACGAGAGTGAAACCCCATCTCAGAAAAAAAAAAGAAAAAGAAAAAGAAAAAAGTAAAAAAAAA","GGCTGAGCACAGTGGCTCACACCTGTAATCCCAGCACTTTGGGAGGCCGAGGCGGGTGGATCACCTGAGATCAGGAGTTCAAGAACAGCCTGACCAACATGGTGAAACCTATCTCTACTAAAAATACAAAATTAGCCTGGCATGGTGGCGCGTGCCTGTAATCTGGCTGAGGCAGAAGAATCGCTTAAACCCAGAGGCAGAGATTGCAGTGAGCCAAGATTGTGTCATTGCACTCCAGCCTGGGCAACAAGAGCAAAACTCCATCTCAGAAAAAAAAAAAAAAAGAAGAAAAAAA"
"chr15","21563578","21564184","JH378118","18053084","18053501","255","3510494","GGCCAGGCATGGTGGCTCACACCTGTAATCGCAGCACTTTGGGAGACTGAGGCAAGCAGATCACCTGAGGTTAGAAGTTCAAGACCAGCCTGGCCAACACAGTGAAACCCCATCTCTACTAAAAATACAAAAAAATGGCCGGGTGCAGTGGCTCATGCCTGTAATCCCAGCACTTTGGGAGGCTAAGGCAGGGGGAATCACAAGGTCAAGAGATCAAGACCATCCTGGTAAAACCCCGTCGGTACTAAAAATACAAAAATTAGCTGGGTGAGGTGGCATGCACCTGTAGCCCCAGCTACTCGGGAGGCTGAGACAGGAGAATCACTTGAACCTGGGAGGCAGAGGTTGCAGTGAGCTGAGATCGCACCACTGCACTCCAGCCTGGCAACAGAGGAAGACTCTGTCTAAAACTAATAATAATAATAATAATAATAATAAAATTAGCTGGGAGTAGTGGCGGGCACCTGTAATCCCAGCTACTTGGGGGGGCTGAGGCAGGAGAAAAGCTTGAACCCGGGAGGTGAAGGTTGCAGTAAGCCAAGATCACGCCATTGCACTCCAGCCCGGGCAACAAGAGCGAAACTTCGTTTCAAAAAAAAAAAAAAAA","GGCTGGGCGCAGTGGCTCACACCTGTAATCCCAGCACTTAGGGAAGCTGAGGCGAGTAGATCACCTGAGGTCAGGAGTTAGAGACCAGCCTGGCCATCATGGTGAAACCCCGTCTCTACTAAAGATACCAAAAATTAGCTGAGTGTGGTGCTGGGTGCCTGTAATCCCAGAAACTCAGGGTGCCTGTAATCCCAGCAACTCAGGGTGCCTTTAATCCCAGCAACTGAGGGTACCAGTAATCCCAGCAACTCAGGGTGTCTTTAATCCTAGCAACTGAGGGCACCTGTAATCCCAGCAACTCAGGAAGCTGAGACAGGAGAAGTACTTGAACCCAGAAGGCAGAGGTTGCAGTGAGCCGATATTGCACCATTGCACTCCAGTCTGGGCAACAAGAGTGAAACTCTGTCTCAAAAAAAAA"
"chr15","22132229","22132799","JH378118","18053084","18053501","233","4079145","GGAGGCCAAGGTGGGCGAATCACCGGTGGTCAGGAGTTTGAGACTAGCCTGGCCAACATGGTGAAACCCCGTCTCTACTAAAAAATACAAAAATTAGGCCGAGTGTGGTGGCTCATGCCTGTAATCCCAGCAGTTTGGAAGGCCAAGGCGGGCAGATCACCTGAGGTCAGGAGTTCAAGACCAGCCTGGCCAACACAGTGGAACCCTGTCTCTACTAAAAATACAAAAAAAATTTGCCAGGCATGGTGGTGTGTGTGCCTATAATCCCAGCTACTCAGGAGACTGAGGCAAGAGAACTGCATGAACCCCAGAGGGAGAGGCTGCAGTGAGCTGAGATCGTACCACTGCACTCCAGCCTGGGTGACAGGGCAGGACTCCGTCTCAAAAAAAAAAAAAAAAAAAAAAAATTAGCCAGGTGTGGTGGCGAGCACCTGTAATCCTAGGTACTTGGGAGGCTGAGAAAGGAGAACCACTTGAACCCCGGAGGCAGAGGTTGCAGTGAGTGGAGATTGTGCGCCATTGCACTCCAGCCTGGGTGACAAGTGTGAAATTCTGCCTCAAAAAAAAAAAA","GGCTGGGCGCAGTGGCTCACACCTGTAATCCCAGCACTTAGGGAAGCTGAGGCGAGTAGATCACCTGAGGTCAGGAGTTAGAGACCAGCCTGGCCATCATGGTGAAACCCCGTCTCTACTAAAGATACCAAAAATTAGCTGAGTGTGGTGCTGGGTGCCTGTAATCCCAGAAACTCAGGGTGCCTGTAATCCCAGCAACTCAGGGTGCCTTTAATCCCAGCAACTGAGGGTACCAGTAATCCCAGCAACTCAGGGTGTCTTTAATCCTAGCAACTGAGGGCACCTGTAATCCCAGCAACTCAGGAAGCTGAGACAGGAGAAGTACTTGAACCCAGAAGGCAGAGGTTGCAGTGAGCCGATATTGCACCATTGCACTCCAGTCTGGGCAACAAGAGTGAAACTCTGTCTCAAAAAAAAA"
"chr15","23508255","23508883","JH378118","18053084","18053501","275","5455171","GGTCGGGTGTGGTGGCTCATGCATGTAATCCTGGCACTTTGGGAGGCCGAGGCGGGTAGATCACCTGAGGTCACGAGTTTGAGACCAGCCTGACCAACATGGTAAAACTTTGTTTCTACTACAAATACAAAAAATTGGCCAGGCTCGGTGGCTTCCGCCTGTAATCCCAGCACTTTGGGAGGCCGGGGTGCATGGATCACCTGAGGTCAGGACTTCGAGACCAGCCTGGCCAACATGGTGAAACCCCATCTCTACTAAAAATACAAAAAAAAAAAAAAAAATGAGCCAGGCATATTGGTGGGCGCCTGTAATCCCAGCTACTTGGAAGGCTGAGACAGGAGAATCACTTGAACCTGGGAGGCGGAGATTGCAGTGAGCCGAGATCATGCCACTGTACTCCATCCTGGGTGACAAGAGTGAGACTGCATCTCAAAAAAAAAAAAACCAAAAAACCAAAAAAAAACAAAAAATTAGTCAACCGTAGTGGTGGGCCCCTATAATCTCAGCTGCTCAGGAGGCTGAGGCAGTAGAATCACTTGATCCCAGGAGGTGGAGGTTTCAGTGAGCTGAGATCATGCCATTGTACTCCAGCCTGGGCAACAAGAGCGAAACTCTATCTCAAAAAATAA","GGCTGGGCGCAGTGGCTCACACCTGTAATCCCAGCACTTAGGGAAGCTGAGGCGAGTAGATCACCTGAGGTCAGGAGTTAGAGACCAGCCTGGCCATCATGGTGAAACCCCGTCTCTACTAAAGATACCAAAAATTAGCTGAGTGTGGTGCTGGGTGCCTGTAATCCCAGAAACTCAGGGTGCCTGTAATCCCAGCAACTCAGGGTGCCTTTAATCCCAGCAACTGAGGGTACCAGTAATCCCAGCAACTCAGGGTGTCTTTAATCCTAGCAACTGAGGGCACCTGTAATCCCAGCAACTCAGGAAGCTGAGACAGGAGAAGTACTTGAACCCAGAAGGCAGAGGTTGCAGTGAGCCGATATTGCACCATTGCACTCCAGTCTGGGCAACAAGAGTGAAACTCTGTCTCAAAAAAAAA"
"chr15","23602365","23603005","JH378118","18053084","18053501","286","5549281","GGTCGGGTGTGGTGGCTCATGCATGTAATCCTGGCACTTTGGGAGGCCGAGGCGGGTAGATCACCTGAGGTCACGAGTTTGAGACCAGCCTGACCAACATGGTAAAACCTTGTTTCTACTACAAATACAAAAAATTGGCCAGGCTCGGTGGCTTCCGCCTGTAATCCCAGCACTTTGGGAGGCCGGGGTGCATGGATCACCTGAGGTCAGGACTTCGAGACCAGCCTGGCCAACATGGTGAAACCCCATCTCTACTAAAAATACAAAAAAAAAAAAATGAGCCAGGCATATTGGTGGGCGCCTGTAATCCCAGCTACTTGGAAGGCTGAGACAGGAGAATCACTTGAACCTGGGAGGCGGAGATTGCAGTGAGCCGAGATCATGCCACTGTACTCCATCCTGGGTGACAAGAGTGAGACTGCATCTCAAAAAAAAAAAAAACCAAAAAACCAAAAAAAACCAAAAAATTAGTCAACCGTAGTGGTGGGCCCCTATAATCTCAGCTGCTCAGGAGGCTGAGGCAGTAGAATCACTTGATCCCAGGAGGTGGAGGTTTCAGTGAGCTGAGATCATGCCATTGTACTCCAGCCTGGGCAACAAGAGCAAAACTCTATCTCAAAAAAAAAAAAAAAAAAGAAAAA","GGCTGGGCGCAGTGGCTCACACCTGTAATCCCAGCACTTAGGGAAGCTGAGGCGAGTAGATCACCTGAGGTCAGGAGTTAGAGACCAGCCTGGCCATCATGGTGAAACCCCGTCTCTACTAAAGATACCAAAAATTAGCTGAGTGTGGTGCTGGGTGCCTGTAATCCCAGAAACTCAGGGTGCCTGTAATCCCAGCAACTCAGGGTGCCTTTAATCCCAGCAACTGAGGGTACCAGTAATCCCAGCAACTCAGGGTGTCTTTAATCCTAGCAACTGAGGGCACCTGTAATCCCAGCAACTCAGGAAGCTGAGACAGGAGAAGTACTTGAACCCAGAAGGCAGAGGTTGCAGTGAGCCGATATTGCACCATTGCACTCCAGTCTGGGCAACAAGAGTGAAACTCTGTCTCAAAAAAAAA"
"chr15","23603280","23603615","JH378109","21565230","21565567","55","2038050","GGCCAGGCGCGGTGGCTCATGCCTATAAACTCAGCACTTTGAGAGGCTGAGGCGGGTGGGTCACCTGAGGTCAGGAGTTAGAGACCAGCCTGGCCAACATGGTGAAACCGTGTTTCTACTAAAGATACAACATTAGCCAGGCATGGTGGCGCATGCCTGTAATCCCAGCTACTAGGGAGGCTGCGGCAGGAGAATCGCTTGAACGCAGGAGGTGAAGGTTGCAGTGAGCTGAGATCGTGCCATTGCACTCCAGCCTGGGTGACAAGAGCGAAACTCCATCCCAATCAATCAATCAATCAATCAATCAATTAAATTAAAAAAATAAAAAGAAAGAAA","GGCCGGGCGCGGTGGCTCAAGCCTGTAATACCAGCACTTTGGGAGGCCGAGGCGGGTGGATCACGAGGTCAAGAGATCGAGACCATCCTGGTCAACATGGTGAAACCCCGTCTCTACTAAAAATACAAACAATTAGCTGGGCATGGTGGCGGGTGCCTGTAATCCCAGCTACTCCAGAGGCTGAGGCAGGAGAATTGCCTGAACCCAGGAGACGGAGGTTGCGGTGAGCCAAGATCGCGCCATTGCACTCCAGCCTGGGTGACAAGAGCGAAACTCCGTCTCAATAAATAAATAAATAAATAAATAAATAAAAATAAAATAAATAAATAAATAAATAA"
"chr15","38315253","38315599","JH378169","5922203","5922541","56","32393050","GCCAGACACGGTGGCTCACGCCTGTAATCCCAGCACTTTGGGAGGCCGAGGCGGGTGGATCACCTGAGGTCAGGAGTTCGAGACCAGCCTGGCCAACATGGCGAAATCCTGTCTCTACTAAAAATACACACACACACACACACACACACACACACACACACACACATACACACACAAAATTAGCTGGGCATGGTGGCAGGTGCCTGTAATCCCAGCTACTTGGGAGGCTGAGGCAGGAGAATCACTTGAACCTGGGAGGCGGAGATTGCAGTGAGCCAAGATCATGCCATTGCACTTCAGCCTGGGCAACGAGAGTGAAACTCTGTCTCAAAAAAAAAAAAAAAAAA","GGCCAAGGGTGGTGGCTCACACCTGTAATCCCAACACTCTGGGAGGCCAAGGTGGGTGGATCACCTAAGGTCAGGAGTTCAAGACCAGCATGGCCAATATAGTGAAACTCTGTCTCTACTAAAAATACACACACACAAAAAAAAACAAAACACAAAAAAAACCACAAAATTAGCCGGGCATGGTGGCATGTGCCTGTAATCCCAGCTACTCAGGAGGCTGAGGCAGGAGAATCACTTAAACCCAGGAAGCGGAGGTTGCAGTGAGCCAAGATTGCGCCACTGCACTCCAGCCTAGGTGACAAGAGCAAAACTCTGTCTCAAAAAAAAAAAAAAAAAAAA"
"chr15","39410478","39411079","JH378118","18053084","18053501","249","21357394","GGCCGGGCACGGTGGCTCACGCCTGTAATCCCAGCACTTTGGGAGTCTGAGGTGGGCAGATCCACCTGAGGTCAGGGGTTCAAGACCAGCATGGCCAACATGGTGAAACCTCATCTCTACTAAAAATACAAAAATTAGGCTGGGTGCGGTGGCTCACGCCTGTAATCCCAGCACTTTGGGAGGCCAAGGCAGGTGGATCACCTGAGGTCAGGAGTTCGAGACCAGCATGGCCAACATAGCGAAAATCCGTCTCTACTAAAAACACAAAAATTAGCCAGGTGTGTTGGCTTACACCTGTAATCCCAGCTACACAGGAGGCTGAGGCAGAAGAATCACTTGAATCCAGGAGGTGGAGGTTGCAGTGAGCCGAGATCGCGCCACTGCCCTCCAGCCTGGGTGACAGAGCAAGACACCATCTCAAAAAAAAAAAAAAAAAAATTAGCTGGGCATGGTCACAGGTGCCCCTAATCCCAGCTACTCAGGAGGCTGAGGCAGGAGAATTGCTTGAACCCAGGAGACGGAGGTCACAGTGAGCGGTAATTGTGCCATTGCACTTCAACCTGGGTGACAAGAGCAAAAGTCCATCTCAAAAAAAAAAAAAA","GGCTGGGCGCAGTGGCTCACACCTGTAATCCCAGCACTTAGGGAAGCTGAGGCGAGTAGATCACCTGAGGTCAGGAGTTAGAGACCAGCCTGGCCATCATGGTGAAACCCCGTCTCTACTAAAGATACCAAAAATTAGCTGAGTGTGGTGCTGGGTGCCTGTAATCCCAGAAACTCAGGGTGCCTGTAATCCCAGCAACTCAGGGTGCCTTTAATCCCAGCAACTGAGGGTACCAGTAATCCCAGCAACTCAGGGTGTCTTTAATCCTAGCAACTGAGGGCACCTGTAATCCCAGCAACTCAGGAAGCTGAGACAGGAGAAGTACTTGAACCCAGAAGGCAGAGGTTGCAGTGAGCCGATATTGCACCATTGCACTCCAGTCTGGGCAACAAGAGTGAAACTCTGTCTCAAAAAAAAA"
"chr15","45225530","45226131","JH378133","19690365","19690767","253","25535165","GGCCGGGCACAGTGGCTCATGCCTGCAGTTCCAGCACTTTTGGAGGCCGAGGCAGGCCGATCACTTGAGGTCAGGAGTTCGAGACCACCCCGGCTAACGTGGTGCAACTCCATCTCTACTAAAAATACAAAATTGGCCGGGTGCGGTGGCTCATGCCTGTAATCCCAGCACTTTGGGAGGCCGAGGCGGATGGATCACCTCAGGTCAGGAGTTCGAGACCAGCCTGGCCAATGTGGTGAAACCCCGTCTCTACTAATAATACAAAAATTAACTGGGTGTGGTGGTGGGCACCTATAATCCCAGCTACTCGGGAAGCTGAGGCAGGAGAATCACTTGAACCTGGGAGGTGGAGATTGCAGTGAGCTGAGATGGTGCCATTACACTCCAGCCTGGGCAACGAGAGTGAAACTCTGTCTCTAAATAAATAAATACAAAATTAGCCGGGCATGGTGGCGGATGCCTATAATCACAGCTACTTGGGAGGCTGAGGCAAGAGAATCACTTGAACCTGGGAGGTGGAGGTTGCAGTGAGCTGAGATCAAGCCATTGCACTCCAGCCTGGGCAAAAAGAGTGAAACTCTGTCTCAAAAAAAAGAAAGAAA","GGCCAGGCACAGTGGTTCATGTCTGTAATCAGCATTTTGGGAGGCTGAGGCGGGAGAATCACCTGAGGCCAGGAGTTCTAGATGAGCCTGGGCAAATAGTGACAACCTGTCCCTACAAAAAAATTTAAAATTAGCCAGGATTGAGACCATCCTGGCTCACGTGGTGAAACCCCATCTTTACTTAAAATACTTAAAATGCAAAAAACATTTTTTTTTGTATTTTATTTAAAATACAAAAAAACTAGGCAGGCATGTTGGCACGTGCCTGTAGTCCCAGATACTTGGGAGGCTGAGGCAAGAGAATCACTTGAACCCAGGAGGTGGAGGTTGCAGTGAGCCGAGATCATACCACTGCACTCCAGCCTGGGTGACAAGAGTGAAACTCTGTCTCAAAAAAAAACAA"
"chr15","46581057","46581661","JH378118","18053084","18053501","254","28527973","GGCCGGGCGCGGTGGCTCACGCCTGTAGTCCCAGACTTTGGGAGGCCGAGGTGGGCGGATTGCCTGAGGTCAGGAGTTCAAGACCAACCTGGCCAACATGGTGAAATGCCGTCTCTACTAAAAATACAAAAATTAGGCCGGGCACGGTGGCTCATGTCTATAATCCCAGCACTTTGGGAGGCCGAGGTGGGCGGATCACGAGGTCAGGAGATCGAGACCATCCTGGCTAACACGGTGAAACCCCGTCTCTACTAAAAACACAAAAAATTAGCCGGGCGTGGTGGCAGGCACCTGTAGTCTCAGCTACTCAGGAGGCTGAGGCAGGAGAATGGCGTGAACTTGGGAGGCGGAGCTTGCAGTGAGCCAAGATTGTGCCACTGCACTCCAGCCTGGGCAACAGAGCGAGACTCTGTCTCAAAAAAAAAAAAAAAAATTAGCCAGGTGTGGTGGCAGGTGCCTGTAATCCCAGCTAATTGGGAGGCTAAGGCAGGAGAATCTCTTGAACCCAGGAGGCAGAGGTTGCAGTGAGCCAAGATTTCGCCATTACACTCCAGCCTGGGCAACAAGAGCTAGACTCCATCTCAAAAATAAATAAATAAAATAAA","GGCTGGGCGCAGTGGCTCACACCTGTAATCCCAGCACTTAGGGAAGCTGAGGCGAGTAGATCACCTGAGGTCAGGAGTTAGAGACCAGCCTGGCCATCATGGTGAAACCCCGTCTCTACTAAAGATACCAAAAATTAGCTGAGTGTGGTGCTGGGTGCCTGTAATCCCAGAAACTCAGGGTGCCTGTAATCCCAGCAACTCAGGGTGCCTTTAATCCCAGCAACTGAGGGTACCAGTAATCCCAGCAACTCAGGGTGTCTTTAATCCTAGCAACTGAGGGCACCTGTAATCCCAGCAACTCAGGAAGCTGAGACAGGAGAAGTACTTGAACCCAGAAGGCAGAGGTTGCAGTGAGCCGATATTGCACCATTGCACTCCAGTCTGGGCAACAAGAGTGAAACTCTGTCTCAAAAAAAAA"
"chr15","46659994","46660594","JH378118","18053084","18053501","247","28606910","GCTGGGCATGGTGGCTTACGCCTGTAATCCCAGCACCTTGGGAGGCTGAAGTGAGCAAATCACCTGAGTTCAGGAGTTCAAGACCAGCCTGGCCAACATGGTGAAAACCCATCTCTATTAAAAATTACAAAAATGGCCAGACACGGTAGCTCACGCCTGTAATCCCAGCACTTTGGGAGGCTGAGGCGGGCAGATCACCTGAGGTTGGGAGTTGGAGACCAGCTTGACCAACATGGAGAAACCCCCTCTCTACTAAAAATACAAAATTAGCCAGGCGTGGTGGCACATGCCTGTAATCCCAGCTACTTGGGAGGCTGAGGCAGGAGAATCACTTCAACCCGGAAGGTGGAGGTTGTGGTGAGCTGAGATTGTGTCATTGCACTCTAGCCTGGATAACAAAGGCAAAACTCAGTCTCAAAAAAAAAAAAAATTACAAAAATTAGCTGGCGTGGTGGCAGGTGCCTATAATCCCAGCTACTCAGGAAGCTGAGGCAGGAGAATCACTTGAAACCAGGAGGCAGAGGTTGCAGTGAGCTGAGACCACGCCATTGCCCTCCTGCCTGGGTGACAAGAGTGAAACTCCATCTCAAAAAAAAAAAAA","GGCTGGGCGCAGTGGCTCACACCTGTAATCCCAGCACTTAGGGAAGCTGAGGCGAGTAGATCACCTGAGGTCAGGAGTTAGAGACCAGCCTGGCCATCATGGTGAAACCCCGTCTCTACTAAAGATACCAAAAATTAGCTGAGTGTGGTGCTGGGTGCCTGTAATCCCAGAAACTCAGGGTGCCTGTAATCCCAGCAACTCAGGGTGCCTTTAATCCCAGCAACTGAGGGTACCAGTAATCCCAGCAACTCAGGGTGTCTTTAATCCTAGCAACTGAGGGCACCTGTAATCCCAGCAACTCAGGAAGCTGAGACAGGAGAAGTACTTGAACCCAGAAGGCAGAGGTTGCAGTGAGCCGATATTGCACCATTGCACTCCAGTCTGGGCAACAAGAGTGAAACTCTGTCTCAAAAAAAAA"
"chr15","46772064","46772669","JH378118","18053084","18053501","251","28718980","GGCTGGGTGCAATGGCTCATGCCTGTAATTCCAGTGTTTTGGGAGGCCGAGGCAGGTGGATCACTTGAGATCAGGAGTTCGCGACCAACCTGGCTAACATGGTGAAACCCCGTCTCTACTAAAAATACAAAAAATTGGCCAGGAGCGGTGGCTCAAACCTGTAATTCCAGCACTTTGGGAGGCCGAGGGGGGCAGATCACGATGTTTAGGAGTTTGAGATCAGACTGACCAACATGGTGAAACCCCATCTCTACTAAAAATACAAAAATTAGCCAGGCGTGGTGGTGCATGTCTGTAATCCCAGCTACTTGGGAGGCTGAGGCAGGAGAGTTGCTTGAAGCCGGGAGGTGGAGGTTGCAGTGAGCTGAGATCACACCACTGCACTCCAGCCTGGGCGACAGAGCAAGACTGTCTCAAAAAAAAAAAAAAAAAAAAAAATTAGCCAGCTTGGTGGCGGGCATCTGTAATCCCAGCTACTCGGGAGGCTGAGGCAGGAGAATCACTTGAACCCAGGAGGCAGAGGTCGCAGTGAGCCAAGATCACGCCATTGTACTCCAGCCTGGGCAACAAGAGCAAAACTCCATCTCAAAAAACAAAAAATAAAAA","GGCTGGGCGCAGTGGCTCACACCTGTAATCCCAGCACTTAGGGAAGCTGAGGCGAGTAGATCACCTGAGGTCAGGAGTTAGAGACCAGCCTGGCCATCATGGTGAAACCCCGTCTCTACTAAAGATACCAAAAATTAGCTGAGTGTGGTGCTGGGTGCCTGTAATCCCAGAAACTCAGGGTGCCTGTAATCCCAGCAACTCAGGGTGCCTTTAATCCCAGCAACTGAGGGTACCAGTAATCCCAGCAACTCAGGGTGTCTTTAATCCTAGCAACTGAGGGCACCTGTAATCCCAGCAACTCAGGAAGCTGAGACAGGAGAAGTACTTGAACCCAGAAGGCAGAGGTTGCAGTGAGCCGATATTGCACCATTGCACTCCAGTCTGGGCAACAAGAGTGAAACTCTGTCTCAAAAAAAAA"
"chr15","48446925","48447526","JH378118","18053084","18053501","252","30393841","GGCCAAGTGCAGTGGCTCACGTTTGTAATCCCAGCACTTTGGGAGGCCGAGGCGGGTGGATCACCTGATGTCAGGGGTTTGAAACCAGCCTGGCCAACATGGTGAAACCCCATCTCTAATAAAAATACAAAACTGGCCAGGTGCAGTGGCTCATGCCTGTAATCCCAGCACTTTGAGAGACCAAGGGAGGCAGATCACCTGAGGTCAGGAGTTCCAGACCAGCCTAGCCAACATGGTGAAACCCTATCTCTACTAAGAGTACAAAAATTAGCCTGGCGTGGTGGCAGGCGCCTGTAATCCCAGCTACTCAGAAGGCTGAGGCAGGAGAATCACTTGAACCCAGGAGGCGGAGGTTGCAGTGAGCCGAGATTGAGCCACTACACTCCAGCCTGGGTGACAAGAACAAGACTCTGTCTCAAAAAAAAAAAAAAAAAAAGCCGGTCATGGTGGCACATGCCTATAATCCCAGCTTCTTGGGAGGCTGAGGCAGGAGAACCACTTGAACCTGGGAGGTGGAGGCTGCAGTGAGCCGAAATTGTGCCATTGCACTCTAGCCTGGGCAACAAGAGCAAAACTCTCTCAAAAAAAAAAAAAAAAAAAAA","GGCTGGGCGCAGTGGCTCACACCTGTAATCCCAGCACTTAGGGAAGCTGAGGCGAGTAGATCACCTGAGGTCAGGAGTTAGAGACCAGCCTGGCCATCATGGTGAAACCCCGTCTCTACTAAAGATACCAAAAATTAGCTGAGTGTGGTGCTGGGTGCCTGTAATCCCAGAAACTCAGGGTGCCTGTAATCCCAGCAACTCAGGGTGCCTTTAATCCCAGCAACTGAGGGTACCAGTAATCCCAGCAACTCAGGGTGTCTTTAATCCTAGCAACTGAGGGCACCTGTAATCCCAGCAACTCAGGAAGCTGAGACAGGAGAAGTACTTGAACCCAGAAGGCAGAGGTTGCAGTGAGCCGATATTGCACCATTGCACTCCAGTCTGGGCAACAAGAGTGAAACTCTGTCTCAAAAAAAAA"
"chr15","59372839","59373447","JH378118","18053084","18053501","260","41319755","GGCCAGGATCAGTGTCTCACACCTGTAATCCTAGCACTTTGGGAGGCTAAGGTGGGCGGATTACTTGAGGTCAGGAGTTTGAGACCAGCCTGGGCAACATGGTGAAACCCCGTCTCTACTAAAAATACAAAAATTAGCTGGGCATAGGCCAGGAGTGGTGGCTTACGCCTGTAATTCCAGGACTTTGGGAGGCTGAGGCGGGCAGATCATGAGGTCAGGAGATTGAGACCATCCTGGCTAACATGGTGAAACCTCATCTCTACTAAAAATACAAAAATTAGCCAGTCGTGGTGGTAGGCGCCTGTAGTCCCAGCTACTTGAGAGGCTGAGGCAGGAGAATCACTTGAATCCGGGAGGTGGAGGTTGCAGTGAGCCGAGATTATGCCACTTCACTCCAACCTGGTGACAGAGCAAGACTCCGTCTAAAAAAAAAAAAAAAAATTAGCTGGGTGTGGCGGGCACTTGCAATCCCAGCTACTTAGGAGGCTGAGGCAGGAGAACCGCTTGAACCTGGGAGGTAGAGGTTCCAGATCACGCCATTGCACTCCTGCTTGGGCAACAAGAGTGACACTCCATCTCAAAAAAACAAAAAAAAAAAAGAAAAAGAAA","GGCTGGGCGCAGTGGCTCACACCTGTAATCCCAGCACTTAGGGAAGCTGAGGCGAGTAGATCACCTGAGGTCAGGAGTTAGAGACCAGCCTGGCCATCATGGTGAAACCCCGTCTCTACTAAAGATACCAAAAATTAGCTGAGTGTGGTGCTGGGTGCCTGTAATCCCAGAAACTCAGGGTGCCTGTAATCCCAGCAACTCAGGGTGCCTTTAATCCCAGCAACTGAGGGTACCAGTAATCCCAGCAACTCAGGGTGTCTTTAATCCTAGCAACTGAGGGCACCTGTAATCCCAGCAACTCAGGAAGCTGAGACAGGAGAAGTACTTGAACCCAGAAGGCAGAGGTTGCAGTGAGCCGATATTGCACCATTGCACTCCAGTCTGGGCAACAAGAGTGAAACTCTGTCTCAAAAAAAAA"
"chr15","64220715","64221335","JH378118","18053084","18053501","268","46167631","CCAGGCACAGTGGCTCATACCTGTAATCCCAGCACTTTGGGAGCCCAAGGCGGGCAGATCACCTGAGGTCAGGAGTTCGAGACCAGCCTGGACAACATGGAGAAACTCCATCTCTACTAAAAATACAAAATGAGGCCGGGCACAGTGGCTCACACCTATAATCCCAGCACTTTTGGAGGCCGAGACAGGCAGCTCACGAGGTCAGGAGTTCAAGACCAGCCTGGCCAGCATGGTGTAACCCCGTTTCTACTAAAAATACAAAAATTAGCCAGGCATGGTGGTGCGTGCCTGTAGTCCTCAGGAGGCTGAGGCAGGAGAATCGCTTGAATCTGGGAGGCGGAGCTTGCAGTCAGCTGAGATCAGGCTACTGCACTGCAGCTTGGGCAACAGAGTGAGACTCCGTCTCAAAAACAAACAAACAAACAAACAAAACACAACAAAATTAGCTGGGCATGGTGGCAGGTGCCTGTAATCCCAGCTACTCAGCTACTCAGGAGGCTGAGGCAGGAGAGTCACGTGAACCTGGGAGGCAGAGGTTGCAGTGAGCCAAGATCACGCCATTGCACTCCAGCCTGGGCAACAAGAGGGAAATTACATCTCAAAAAAAAAAAAAAAAAAAAA","GGCTGGGCGCAGTGGCTCACACCTGTAATCCCAGCACTTAGGGAAGCTGAGGCGAGTAGATCACCTGAGGTCAGGAGTTAGAGACCAGCCTGGCCATCATGGTGAAACCCCGTCTCTACTAAAGATACCAAAAATTAGCTGAGTGTGGTGCTGGGTGCCTGTAATCCCAGAAACTCAGGGTGCCTGTAATCCCAGCAACTCAGGGTGCCTTTAATCCCAGCAACTGAGGGTACCAGTAATCCCAGCAACTCAGGGTGTCTTTAATCCTAGCAACTGAGGGCACCTGTAATCCCAGCAACTCAGGAAGCTGAGACAGGAGAAGTACTTGAACCCAGAAGGCAGAGGTTGCAGTGAGCCGATATTGCACCATTGCACTCCAGTCTGGGCAACAAGAGTGAAACTCTGTCTCAAAAAAAAA"
"chr15","65873443","65873774","JH378165","3784440","3784761","45","62089003","GGCCAGGCACGGTGGCTCACACGTGTAATCCCAGCACCTTGGGAGACCGAAGCAGGTGGATCACCTGAGGTCAGGAGTTTGAGGCCAGCCTGGCCGATATGGTGAAACCCTATCTCTATTAAAAATACCAAAAAAAAAAAAAAAAAAAAAAAAACCTGCTGGGCGTGGTGGCGCACGCCTGTAATCCCAACTACTCAGGAGGCTGAGGCAGGAGAATCACTTGAATCCAGGAGGCAGAGGTTGCAGTGAGCCGAGATCGCGCCATTGCACTCCAGCCTGGGCAACAAGAGCGAAACTCGGTCTCAAAAAAAAAAAAAAAAAAAGAAAAGAAA","GGCCGGGCGCGGTGGCTCAAGCCTGTAATCCCAGCACTTTGGGAGGCCGAGGCAGGTGGATCATGAGGTCAAGAGATCAAGACCATCCTGGTCAACATGGTGAAACCCCGTCTCTACTAAAAATACAAAAAAAAAAAAAAAAAAACTAGCTGGGCGTGGTGGCGCATGCCTGTAATCCCAGCTACTCAGGAGGCTGAGGCAGGAGAATTGCTTGAACCCAGGAGGCGGAGGTTGCGGTGAGCCCAGATCGCGCCATTGCACTCCAGCCTGGGTAACAAGAGCAAAACTCCATCTCAAAAAAAAAAAAAAAAAAAAAAAAAAA"
"chr15","70453292","70453944","JH378118","18053084","18053501","292","52400208","GGCCAGGCACGGTGGCTCATGCCTGTAATCCCAACACTTTGGGAGGCTGAGGTAGGTAGATCACCTGAGGTTGAGGTCAGGAGTTTGAGACCAGCCTGGCCAACATGGTGAAACTCTGTCTCTACTAAAAATACAAAAATTTGGCCCGGCGCAGTGGCTCACCTGTAATCCCAGCACTTTGGGAGGCCGAGGCAGGCAGATCACGAGGTCTGGAGATCAAGACCATCCTGGCTAACTCGGTGAAATCCCATCTCTACTAAAAATACGAAAAATTAGCCAGGTGTGGTGGCGGGCACCTGTAGTCCCAGCTACTTGGGAGGCTGAGGCAGGAGAATGGCGTGAACCTGGGAGGTGGAGCTTGCAGTGGGCCAAGATCACGCCACTGCACTCCAGCCTGGGCAACAGAGTGAGACTCTGTCTCAAAATAAAATAACATAAAATAAAATAAAGTAATATAAAATAAAAATACAAAAATTAGCTGGGCATGGTAGCGGGTACCTATAATTCCAGCTACTTGAGAGGCTGAGGCTGGAGAATCACTTGAATCTGGGAGGTGGAGGTTGCAGTGAGCCAAGATTGCACCATTGCACTCCAGCCTGGGCAACAAGAGCCAAACTCCGTATCAAAAAAAAAAAAAAAAAGAAAAAGAAAAA","GGCTGGGCGCAGTGGCTCACACCTGTAATCCCAGCACTTAGGGAAGCTGAGGCGAGTAGATCACCTGAGGTCAGGAGTTAGAGACCAGCCTGGCCATCATGGTGAAACCCCGTCTCTACTAAAGATACCAAAAATTAGCTGAGTGTGGTGCTGGGTGCCTGTAATCCCAGAAACTCAGGGTGCCTGTAATCCCAGCAACTCAGGGTGCCTTTAATCCCAGCAACTGAGGGTACCAGTAATCCCAGCAACTCAGGGTGTCTTTAATCCTAGCAACTGAGGGCACCTGTAATCCCAGCAACTCAGGAAGCTGAGACAGGAGAAGTACTTGAACCCAGAAGGCAGAGGTTGCAGTGAGCCGATATTGCACCATTGCACTCCAGTCTGGGCAACAAGAGTGAAACTCTGTCTCAAAAAAAAA"
"chr16","217191","217526","JH378138","4229795","4230103","77","4012604","ATTTTGGGAGGCTGAGATGAGTGATGAGCGGATCACCTGAGGTCAGGAGCTCGAGACCAGTCTGGCCAACACGGTGAAACCCTGTCTCTACTAAAAGTACCAAAAAAATTAGCCAGGCATGGCAGTGGGCGCCTGTAATCCCAACTACTCGGGAGGCTGAGGCAGGAGAATCACTTGAACCTGGGAGGTGGATGTAGCAGTGAGCCGGGATCGTGCCACTGAACTCCAGCCTGGGCGATAAGATCAAAACTCTGTCTCTCTCTCACACACACACACACACACACACACACACACACACACACCCCCAAAAAAAAAAACAAAAAAAAGAAAAAGAAA","CACTTTGGGAGGTGAAGGCGGGCAGATCACCTGAGGTCAGGAGTTCGAGACCAGCCTGGCCAACATGGTGAAACCCCGCCTCTACTAAAAATACAAAAATTAGCCAGGTGTGACACTAGGCATCTGTAATCCCAGCTACTTGGGAGGCTGAGACAGGAGAATCACTTGAACCCAGGAGGCGGAAGTTGCAGTGAGCCAAGATCATGCCATTGCACTCCAGCCTGGGTGACAGGAGCAAAACTCTGTCTCAAAAAAAAAAAAAAAAAAAAAAAAAAAAAAAAAAAAAAAAGAAAAGAAAAGAAAAGTAAA"
"chr16","384893","385508","JH378118","18053084","18053501","265","17668191","GGCCGGGCGTGGTGGCTAACACGGGTAGTCCTAGCACTTTGGGAAGCCAAGGCAGGCAGATCACTTGAGGTCAGGAGTTTGAGATCAGTCTGGCCAACATGGTGAAACCACGCCTCTACTAAAAATACAAAAGTTATGGCCGAGCGTGGTGGCACGCGCCTGTAATCCCAGCACTTTGGGATGCTGAGGCAGGCGCATCACCTAAGGTCGGGAATTCAAGACCAGCCTGACCAACATGGAGAAACCACGTTTCTACTAAAAATACAAAATTAGCCGGGTGTGGTGGCACATGCCTGTAGTTTCAGCTACTCAGGAGGCTGAGGCAGGAGAATCACTTGAATCCGGGAGGCGGAGATTGTGGTGAGCCGAGATCGGGCCATTGCACTCCAGCCTGGGCAACAAGAGAGAAACTCTGTCTCAAAAAAAAAAAAAAAAAATTAGCCAGGCATGGTAGCCTGTGCCTGTAATCCCAGCTACTTGGGAGGCTGAGGCAGGAGAATCGCTTGAACCTGGGAGGCAGAGGTTGCAGTGAGCCGCGATTGCGCCATTGCACTCTCCAGCCTGGGGGAGAAGAGCAAAACTCCATCTCAAAAATAAATAAATAAATAAAAATAAA","GGCTGGGCGCAGTGGCTCACACCTGTAATCCCAGCACTTAGGGAAGCTGAGGCGAGTAGATCACCTGAGGTCAGGAGTTAGAGACCAGCCTGGCCATCATGGTGAAACCCCGTCTCTACTAAAGATACCAAAAATTAGCTGAGTGTGGTGCTGGGTGCCTGTAATCCCAGAAACTCAGGGTGCCTGTAATCCCAGCAACTCAGGGTGCCTTTAATCCCAGCAACTGAGGGTACCAGTAATCCCAGCAACTCAGGGTGTCTTTAATCCTAGCAACTGAGGGCACCTGTAATCCCAGCAACTCAGGAAGCTGAGACAGGAGAAGTACTTGAACCCAGAAGGCAGAGGTTGCAGTGAGCCGATATTGCACCATTGCACTCCAGTCTGGGCAACAAGAGTGAAACTCTGTCTCAAAAAAAAA"
"chr16","1668152","1668787","JH378118","18053084","18053501","287","16384932","GGCCGGGCACGGTGCCTCGTTCCTGTAATCCCAGCACTTTGGGAGGCCAAGGTGGGTGGATCACCTGAGGTCAGGAGTTCGAGACATGCCTGGCCAACATGGCAAAATCCTGTCTTTACTAAAAATACAAAAATTAAGCCGGGCGCTGTGACTCATGCCTGTAATCCCAGCACTTTGGGAGGCCAAGGCGGGCGGATCACAAGGTCAGGAGATTGAGACCATCCTGGCTAACACGGTGAAAACCCGTCTCTACTAAAAATACAAAAAATTAGCCAGGTGTGGTGGCGGGTGCCTGTAGTCCCAGCTACTCGGGAGGCTGAGGCAGGAGAATGGCGTGAACCCGGGAGGCGGAGCTTGCAGTGAGCCGAGATCGTGCCACTGCACTCCAGTCTGGGCAACAGAGCAAGACTCTCTCTCAAAAAGAAACAAACAAAAAAAAAAATGAAAAAAGAAAAATTAGCCAGGCGTGGTGGCGGGTGCCTATAATCTCAGCTACTCGGGAGGCTGAGGCAGAAGTATCATTTGAACCCAGGAGGCGGAGGTTGTAGTGATCCAAGATAGCGCCATTGCACTGCAGCCTGGGTGACAACAGTGAAACTCCGTCTCAAAAAAAAAAAAAAAAAAGAAAGAAAGAAA","GGCTGGGCGCAGTGGCTCACACCTGTAATCCCAGCACTTAGGGAAGCTGAGGCGAGTAGATCACCTGAGGTCAGGAGTTAGAGACCAGCCTGGCCATCATGGTGAAACCCCGTCTCTACTAAAGATACCAAAAATTAGCTGAGTGTGGTGCTGGGTGCCTGTAATCCCAGAAACTCAGGGTGCCTGTAATCCCAGCAACTCAGGGTGCCTTTAATCCCAGCAACTGAGGGTACCAGTAATCCCAGCAACTCAGGGTGTCTTTAATCCTAGCAACTGAGGGCACCTGTAATCCCAGCAACTCAGGAAGCTGAGACAGGAGAAGTACTTGAACCCAGAAGGCAGAGGTTGCAGTGAGCCGATATTGCACCATTGCACTCCAGTCTGGGCAACAAGAGTGAAACTCTGTCTCAAAAAAAAA"
"chr16","2310740","2311369","JH378118","18053084","18053501","271","15742344","GGCCGGGCACAGTGGCTCACGCCTATAATATCAGCACTTTGGGAGACCAAGGCGGGTGGATCACCTAAGGTCAGGAGTTCAAGACCAGCCTGACCAACATGGTGAAACCCCATCTCTACCAAAAATAGAAAACATTAGTCTTGGCCGGGCACGGTGACTCATACCTGTAATTCCAGCACTTTGGGAGGCCGATCACCTGGCGGATCACCTGAGGTCGGGAGTTTGAGACCAGCCTGACCAACATGGAGAAACCCCGTCTCTACTAAAAATACAAAATTAGCTGTGCGTAGTGGCCCATGCGTGTAATCCCAGCTACTCAGGAGACTGAGGCAGGAGAATGGCTTGAACCTGGGAGGCGGAGGTTGTGCTGAGCCAAGATCGCACCATTGCACTCCAGCCTGGGCAATAAGAGTGAAACTCCGTTTCATAAAACAAAAAACAAAAAACAAAAAAAAAACCATTAGCCAGGCATTGTGGCAGGCACCTGTAATCCCAGCTACTCAGGAGGCTGAGGCAGAATGGCTTGAACCGGGGAGGCAGAGGTTGCAGTGAGCCGAGATCGCGCCATTGCACTCCAGCCTGGGCAACAAAAGTAAAACTCTGTCTCAAATAAAAAAAAGAGAGAAAAAA","GGCTGGGCGCAGTGGCTCACACCTGTAATCCCAGCACTTAGGGAAGCTGAGGCGAGTAGATCACCTGAGGTCAGGAGTTAGAGACCAGCCTGGCCATCATGGTGAAACCCCGTCTCTACTAAAGATACCAAAAATTAGCTGAGTGTGGTGCTGGGTGCCTGTAATCCCAGAAACTCAGGGTGCCTGTAATCCCAGCAACTCAGGGTGCCTTTAATCCCAGCAACTGAGGGTACCAGTAATCCCAGCAACTCAGGGTGTCTTTAATCCTAGCAACTGAGGGCACCTGTAATCCCAGCAACTCAGGAAGCTGAGACAGGAGAAGTACTTGAACCCAGAAGGCAGAGGTTGCAGTGAGCCGATATTGCACCATTGCACTCCAGTCTGGGCAACAAGAGTGAAACTCTGTCTCAAAAAAAAA"
"chr16","3075498","3075819","JH378114","26407278","26407597","46","23331780","GGCCAGGCGCGGTGGCTCACACCTGTAATCCCAGCACTTTGGGAGGCCAAGGCGGGCAGATCACGAGGTCAAGAGATCGAGACCATCCTGGCCAACCTGGTGAAACTCTGTCTCTACTAAAAATACCAAAAAAAAAAAAAAAAAAAAAAAAAAAAAGCATGGTGGCAGGTGCCTGTAATCCCAGCTACTTGGGAGGCTGAGGCAGAATTGCTTGAACCCGGGAGGCAGAGGTTGCAGTGAGTTGAGATCATGCCATTGCACTCCAGCCTGGGCAAAAAGAGCGAAACTCTGTCTCAAAAAACAAAACAAAAACAAAAACAAA","GGCCGGGCGCAGTGGCTCAAGCTTGTAATCCCAGCACTTTGGGAGGCCGAGGCGGGTGGATCACGAGGTCAAGAGATCGAGACCATCCTGGTCAACATGGTGAAACCCCGTCTCTACTAAAAATACAAAAAAAAAAAAAAAAAATTAGTTGGGCATGGTGGTGTGTGCCTGTAATCCCAGCTACTCAGGAGGCTGAGGCAGGAGAATTGCCTGAACCCAGGAGGCGGAGGTTGCGGTGAGCCGAGATCGCGCCATTGCACTCCAGCCTGGGTAACAAGAGCGAAACTCCGTCTCAAAAAAAAAAAAAAAAAAAAAAAAAA"
"chr16","3161549","3162150","JH378118","18053084","18053501","252","14891535","CTGGGCACCGTGGCTCACGCCTGTAATCCCAACACTTTGGGAGGCCAAGGCGGGTGGAACACCTGAAGTCAGGAGTTCGAGACCAGTCTGGACAACATGATGAAACCCCGTCTCTACTAAAAATACAAAAAGTAGCCAGGTATGGCCGGGCGCGGTGGCTCACGCCTGTAATCCCGGCACTTTGAGAGGCCGAGGCAGGTGGATCACAAGGTCAGGAGTTCAAGAGCAGCCTGGCCAAGATAGTGAAACCCCGTCTCTACTAAAAGCAAAATTACAGTGCGCCTGTAATCCCAGCTGCTCGGGAGGCTGAGGCAGGAGAATCGCTTGAACCTGGAGGGCGGAGGTTGCAGTGAGCCAAGATCGCTCTACTGCACCCTAGCCTGGGTGACAGAGCAAGACTCTGTATCAAAAAAAAAATAAATAAATAATTAGCCAGGTATGGTGGTGCAGGCTTGTAATCCTAGCTGCTCAGGAGGCTGAGGCAGGAGAATCGATTGAACCCAGGAGACGGAGGTTGCAGTGAGCAGAGATCACACCATTGTACTCCAGCCTGAGTGACAAAAACGAAACTCCGTCTCAAAAAAAAACCAAAAAAACAAAAA","GGCTGGGCGCAGTGGCTCACACCTGTAATCCCAGCACTTAGGGAAGCTGAGGCGAGTAGATCACCTGAGGTCAGGAGTTAGAGACCAGCCTGGCCATCATGGTGAAACCCCGTCTCTACTAAAGATACCAAAAATTAGCTGAGTGTGGTGCTGGGTGCCTGTAATCCCAGAAACTCAGGGTGCCTGTAATCCCAGCAACTCAGGGTGCCTTTAATCCCAGCAACTGAGGGTACCAGTAATCCCAGCAACTCAGGGTGTCTTTAATCCTAGCAACTGAGGGCACCTGTAATCCCAGCAACTCAGGAAGCTGAGACAGGAGAAGTACTTGAACCCAGAAGGCAGAGGTTGCAGTGAGCCGATATTGCACCATTGCACTCCAGTCTGGGCAACAAGAGTGAAACTCTGTCTCAAAAAAAAA"
"chr16","3211652","3212251","JH378118","18053084","18053501","260","14841432","GTCAGACGCAGTAGTTTATGCCTGTAATCCTTGCACTTTGGGAGGCAGGTGGATCACCTGAGGCCAGGAGTTGGAGACCAGCCAGGCCAATATGGCAAAACCCCGTCTCTACTAAAAATACAAAAACTAGCCGGGCGCAGTGGCTCACACCTGTAATCCCAGCACTTTGGGAGGCTGAGGTGGGTGGATCACTAGGTCAGGAGTTCAAGACCAGCCTGGCCAACATGGTGAAACCGCGTCTCTACTAAAAACACCAAAAAATTAGCTGGGCGTGGTGGCAGTCGCCTGTAATCCCTGCTACTCGGAAGGCTGAGGCAGGAGAATCACTTGAACGCAGGAGGCAGAGGTTGCGGTGAGCCGAGATCACGCCACTGCACTCCAGCCTGGGTGACAGAGCAAGACTCTGTCTCAAAAAACAACAACAACAACTAGCTGGGCGTGGTGGCACATGCCTGTAACCCCAGCTACTCAGGAGGCTGAGGCTGAGGGAGAAAAATCGCTTGTACCTGGGAGGTGGAAGTTGCAGTGAGCGGAGATCCCACCATTGCACTCCAGCCTGGGTGACAAGAGCGAAACTCCATCTCAAAAAAAAAAAAAAAA","GGCTGGGCGCAGTGGCTCACACCTGTAATCCCAGCACTTAGGGAAGCTGAGGCGAGTAGATCACCTGAGGTCAGGAGTTAGAGACCAGCCTGGCCATCATGGTGAAACCCCGTCTCTACTAAAGATACCAAAAATTAGCTGAGTGTGGTGCTGGGTGCCTGTAATCCCAGAAACTCAGGGTGCCTGTAATCCCAGCAACTCAGGGTGCCTTTAATCCCAGCAACTGAGGGTACCAGTAATCCCAGCAACTCAGGGTGTCTTTAATCCTAGCAACTGAGGGCACCTGTAATCCCAGCAACTCAGGAAGCTGAGACAGGAGAAGTACTTGAACCCAGAAGGCAGAGGTTGCAGTGAGCCGATATTGCACCATTGCACTCCAGTCTGGGCAACAAGAGTGAAACTCTGTCTCAAAAAAAAA"
"chr16","3990675","3991277","JH378118","18053084","18053501","250","14062409","GGCTGGGCGTGGTGGCTCACGCCTTTAATCCCAGTACTTTGGGAGGCCGAGAAGGGCACATCACCTGAGGTCAGGAGTTTGAGACCAGCCTGGCCAATATGGTAAAACCCTGTCTCTACTTAAAAAATAGAAAAATCAGGCTGGACGCAGTGGCTCACGCCTGTAATCCCAGCACTTTGGGAGGCCGAGGCGGGTGGATCATGAGGTCAGGAGTTACCAGCCTGCCAACATGGTGAAACCCCATCTCTACTAAAAAAACAAAAAAAATTAGCCAGTCGTAGTGGCAGGCACCTGTAATCCCAGCCACTCGGGAGGCTGAGGCAGAGAATTGCTTGAACCTGGGAGGTGGAGATTGCTGTGCACCAAAATCACACCACTGCACTTGAGCCTGGGCGACAGAGGGAGACTCATCTGAAAAAAAAAAAAAAAAAAAAATTAGCCGGTTATGGTGGCAGGTGCCTGTGATCCCAGCTACTTGGGAGGCTGAGGCAGGAGAATTGCTTGAACCCGGGAGGCAGAGGTTGCAGTGAGCTGAGATCGCACCACTGCACTCCAGCCTGGAGGACAAGAGTGAGACTTGTCTGATTGGAAAAAAAAAAAAAA","GGCTGGGCGCAGTGGCTCACACCTGTAATCCCAGCACTTAGGGAAGCTGAGGCGAGTAGATCACCTGAGGTCAGGAGTTAGAGACCAGCCTGGCCATCATGGTGAAACCCCGTCTCTACTAAAGATACCAAAAATTAGCTGAGTGTGGTGCTGGGTGCCTGTAATCCCAGAAACTCAGGGTGCCTGTAATCCCAGCAACTCAGGGTGCCTTTAATCCCAGCAACTGAGGGTACCAGTAATCCCAGCAACTCAGGGTGTCTTTAATCCTAGCAACTGAGGGCACCTGTAATCCCAGCAACTCAGGAAGCTGAGACAGGAGAAGTACTTGAACCCAGAAGGCAGAGGTTGCAGTGAGCCGATATTGCACCATTGCACTCCAGTCTGGGCAACAAGAGTGAAACTCTGTCTCAAAAAAAAA"
"chr16","4259838","4260446","JH378118","18053084","18053501","263","13793246","GGCCGGGTGCAGTGGCTCACGCCTGTAATCGCAGGACTTTGGGAGGCCAAGGCAGGTGCATCACCTGAGGTCAGGATTTCAAGACCATCCAGCCTGATCAACATGGTGAAACCCTGTCTCTACTAAAAATATAAAAATTGGCCGGGCACAGTGACTCACGCCTGTAATCCCAGCACTTTGGGAGGCTGAGGCAGGTGGATCACAAGGTCAGGAGATCGAGACCATCCTGGCTAACACAGTGAAACCCCGTCTCTACTAAAAATATAAAAAATTAGCCGGGCGTGGTGGTAGGCACCTGTAGTCCCAGCTACTCGGGAGACTGAGGCAGGAGAATGGCGTGAACCTGGGAGGTGGAGCTTGCAGTGAGCAGAGATCGCGCCACTGTACTCCAGCCTGGGTGACAGAGCGAGACTCCGTCTCAAAAAAAAAAAAAAAAAAAAAAATTAGCTGGGCGTGGTGGCGGGCACCTGTAATCCCAGCTACTTGGGAGGCTGAGGCAGGAGAATTGCTTGAACCTGGGAAGTGGAGGTTGCAGTGAGCTGAGATTGTGCCCTTGTACTCCAGCCTGGGCAATAAAAGCAAAACTCCGTCTTAAAAAAAAAAAAAAAA","GGCTGGGCGCAGTGGCTCACACCTGTAATCCCAGCACTTAGGGAAGCTGAGGCGAGTAGATCACCTGAGGTCAGGAGTTAGAGACCAGCCTGGCCATCATGGTGAAACCCCGTCTCTACTAAAGATACCAAAAATTAGCTGAGTGTGGTGCTGGGTGCCTGTAATCCCAGAAACTCAGGGTGCCTGTAATCCCAGCAACTCAGGGTGCCTTTAATCCCAGCAACTGAGGGTACCAGTAATCCCAGCAACTCAGGGTGTCTTTAATCCTAGCAACTGAGGGCACCTGTAATCCCAGCAACTCAGGAAGCTGAGACAGGAGAAGTACTTGAACCCAGAAGGCAGAGGTTGCAGTGAGCCGATATTGCACCATTGCACTCCAGTCTGGGCAACAAGAGTGAAACTCTGTCTCAAAAAAAAA"
"chr16","4899850","4900511","JH378118","18053084","18053501","313","13153234","GGCCAGGCACGGTGGCATGCACCTGTAATCTCAGCTCTTTGGGAGGCTGAGGCAAGAGGATCACTTGAGCCCAGGAGTTGGTGATTGCAGTGAGCTCTGATCACTCCACTGCACTCCAGCCTGGGTGACAGAGTGAGATCCTGTCTCTACGAAAAAAAGACAAGACACAAATACGTTAAAAGTAAAATGATATAAAAAGATATTCCAGTGGGGCACAGTGGCTCACCCCTATAATCCCAACACTTTGGGAGGCTGAGGTGGGTGGATCACCTGAGGTCAGGAATTCAAGACCAGCCTGACCAACATGGAGAAACCCGTCTCTACTAAAAATACAAAATTAGCCGGGTGTGGTGGCACATGCCTGTAATCCCAGCTACTCAGGAGGCTGAGAATGGCTTGAACCTGGGAGGTGGAGGTTGTGGTGAGCCGAGATTGCACCACTGCACTCCAGCCTGGGCAACAAGAGCTGAAACTCCGTCGAAAAAAAAAATTAGCCTGGCGTGGTGGCGGGAGCCTGTAATCCCAGCTACTGGGGAGGCTGAGGCAGGAGAATCACTTGAACCTGGGAGGCAGAATTTGCAGTGAGCCGAGATCGCGCCACCACACTCCAGCCTGGGTGACAAAAACGAAACCCCATCTCAAAAAAATTAAAAAATAACAAA","GGCTGGGCGCAGTGGCTCACACCTGTAATCCCAGCACTTAGGGAAGCTGAGGCGAGTAGATCACCTGAGGTCAGGAGTTAGAGACCAGCCTGGCCATCATGGTGAAACCCCGTCTCTACTAAAGATACCAAAAATTAGCTGAGTGTGGTGCTGGGTGCCTGTAATCCCAGAAACTCAGGGTGCCTGTAATCCCAGCAACTCAGGGTGCCTTTAATCCCAGCAACTGAGGGTACCAGTAATCCCAGCAACTCAGGGTGTCTTTAATCCTAGCAACTGAGGGCACCTGTAATCCCAGCAACTCAGGAAGCTGAGACAGGAGAAGTACTTGAACCCAGAAGGCAGAGGTTGCAGTGAGCCGATATTGCACCATTGCACTCCAGTCTGGGCAACAAGAGTGAAACTCTGTCTCAAAAAAAAA"
"chr16","4919663","4920295","JH378118","18053084","18053501","281","13133421","CTGGGCGCAGTGGCTCACACCTATAATCCCAGCACTTTGGGAGGCCGAGGTGGGGTGGATCACTTGAGGTCAGGAGTTTGAGACCAGCCTGGCCAACATGGTGAAACCCCATCTCTTCTAGAAAAATACAAAATTAGGCTGGGCGCGGTGGCTCACGCTTGTAATCCCAGCACTTTGGGAGGCTGAGGCAGGCGGATCATCTGAGGTTGGGAGTTCGAGACCAGCCTGACCAACATAGAGAAACCCTGTCTCTACTAAAAATACAAAATTAGCCGGGCGTGGTGGCGCATGCCTGTAATCCCAGCTAGTCAGGAGGCTGAGGCAGGAGAATCCCTTGAACTGGGGAGGCAGAGGTTGTGGTGAGCCCAGATCGTGCCATTGCACTCCAGCTTGGGTAAGAAGAGCAAAACTCTGTCTAAAAAATATATATATTTATACATATATATATATTTATATATATAATTAGCCACGCATAGTGGCACACACCTGTAACCCCAGCTACCTGGGAGGATGAGGCAGGAGAATAGCTTGAACTTGGGAGGTGGAGGTTGCACTGAGCTGAGACTGCGCCATTGCATTCCAGCCTGGGCAACAAGAGCGAAACTGTCTCAAAAAAAAAAAAAAAAAAAAAAA","GGCTGGGCGCAGTGGCTCACACCTGTAATCCCAGCACTTAGGGAAGCTGAGGCGAGTAGATCACCTGAGGTCAGGAGTTAGAGACCAGCCTGGCCATCATGGTGAAACCCCGTCTCTACTAAAGATACCAAAAATTAGCTGAGTGTGGTGCTGGGTGCCTGTAATCCCAGAAACTCAGGGTGCCTGTAATCCCAGCAACTCAGGGTGCCTTTAATCCCAGCAACTGAGGGTACCAGTAATCCCAGCAACTCAGGGTGTCTTTAATCCTAGCAACTGAGGGCACCTGTAATCCCAGCAACTCAGGAAGCTGAGACAGGAGAAGTACTTGAACCCAGAAGGCAGAGGTTGCAGTGAGCCGATATTGCACCATTGCACTCCAGTCTGGGCAACAAGAGTGAAACTCTGTCTCAAAAAAAAA"
"chr16","5124255","5124811","JH378118","18053084","18053501","213","12928829","GGCCAGGTGCGGTGGCTCATGCGTGTAATCCCAGCGCTTTGGGAGGCTGAGGCAAGTGGATCACCTGAGGTCAGGAGTTTGAGACCAGCCTGGCCAACATGGGGAAATCCCTGTCTCTACTAAAAATACAAAAATTGGGCCGGGTGTGGTGGCTCACACCTGTAATCCCAGCACTTTGGGAGACTGAGGTGGGCGGATCACCCAAGGTCAGGAGTTTGAGACCATCCTGGCCAACATGGTGAAACCCCGTCTCTACTAAATAAATACAAAAAAGTAGCCGAGCGTGTTGGCGGATGCCTGTAATCCCAGCTACTTGGGAGGCTGAGGCAGGAGAATTGCTTGAACCCTGAGAGGTGGAGGTTGCAGTGAGCAGAGATTGTGCCACTGCACTCTGGCCTGGGCGACAAGAGGGAGTCTCTGTCTTAAAAAAAAAAAAAAAAAAAATTAGCTGGAAATCGCTTGAACCCAGGAGGCGGAGGTTGCAGTGAGCCGAGATTGTGCCACTGCACTCTGGCCTGGGCGACAAGAGCGAGATTCTGTCTCAAAAAAAAAAAAGA","GGCTGGGCGCAGTGGCTCACACCTGTAATCCCAGCACTTAGGGAAGCTGAGGCGAGTAGATCACCTGAGGTCAGGAGTTAGAGACCAGCCTGGCCATCATGGTGAAACCCCGTCTCTACTAAAGATACCAAAAATTAGCTGAGTGTGGTGCTGGGTGCCTGTAATCCCAGAAACTCAGGGTGCCTGTAATCCCAGCAACTCAGGGTGCCTTTAATCCCAGCAACTGAGGGTACCAGTAATCCCAGCAACTCAGGGTGTCTTTAATCCTAGCAACTGAGGGCACCTGTAATCCCAGCAACTCAGGAAGCTGAGACAGGAGAAGTACTTGAACCCAGAAGGCAGAGGTTGCAGTGAGCCGATATTGCACCATTGCACTCCAGTCTGGGCAACAAGAGTGAAACTCTGTCTCAAAAAAAAA"
"chr16","8088191","8088522","JH378114","21211700","21212024","70","13123509","GGCTGGGCGCGGTGGCTTTTGACCATAATCCCAGCACTTTGGGAGGCCGAGGTGGTCAGGTCACCTGAGGTCAGGAGTTCAAGAGCAGCCTGGCCAACGTGGTGAAACTCTGTCTCTACCAAAAATACCAAATAATAATAATAATAATAATAATAATAATAAAATAATATAATTGCAGGGTGTGGCAGCCCATGCATGTAATGCCAGCTACTTGGGAGACTGAGGCAGGATAATCACTTCAACCCAAGAGGCGGAGGTTGCAGTGAGCTGAGATCATGCCATTGCATTCCAGCGTAGGCAACAAGAGCGAAACTCTGTTTCAAATAAATAAA","GGCTGGGTGCGGTGGCTCAGGCCTGTAATCCCAGCACTTTGGGAGGCCGAGGTGGGTACATCACCTAAGGTCAGGAGTTCAAGACCAGCCTGACCAACATGGTAAAACCCTGTCTCTACTAAAATTACAAAAGAAAATTAGAAAAAAAAAAAAGAAAGAAAGAAAATTAGATGGCATGGTGGTGGCGGGCACCTGTAATTTCAACTACTCGGGAGGCTAAGGCAGGAGAATCACTTGAACCCAGGAGGTGGAGGTTGCAGTGAGCCGAGATCACACCATTGCACTGCAGCCTGGGCAATAAGAGCAAAACTCCATCTCAAAAAAA"
"chr16","9762791","9763467","JH378118","18053084","18053501","323","8290293","CAGGCATGGTAGCTCACGCCTGTAATCTCAGCACTTTGGGAGGCCGAGGTGCGCAGATCACTTGAGGTCAGGTGTTGGTGACCAGCCTGGCCAACATGGTGAAACCCTATCTCTACTAAAAATACAAAAATTATGGCCGGGCGCAGTGGCTCACGCCTGTAATCCCAGCACTTTGGGAGGCCGAGGTGGGCAGATCACTTGAGGTCAGGAGTTCAAGACCAGCCTAGGCAACATAGTGAAACCCCGTTGCTACTAAAAATACAAAAATTAGCTGGGCGTGATGGCACATACCTGTAGTCCCACCTACTTGGGAGGCTGAGGCAGGAAAATCGCTTGAACCTGGAGGCAGAGGTTGCAGCGAGCCAAGACTGTGCCAATGCACCACAGCCTGGATAACAGAGTGAGACTCAATCTCAAAAAAAAAAAAAAAAAAAAAAGGCGGGCTGGTGGCTCATGCCCATGCAAACCCCGTCTCTACTAAAAGGACAAAAATTAGCTGGGCATGGTGGCGGGGGCCTGTAATCTCAGGATTACAGGAGATACTACTACTCGGGAGGCTGAGGCAGTAGAATTGCTTGAACCAGGGAGGCGGAGGTTGCAGTGAGCTGAGATCGCGCCATTGCACTCCAGGCTGGGTGACAACAATGACTCCGTCTCAAAAACAACAACAACAACAA","GGCTGGGCGCAGTGGCTCACACCTGTAATCCCAGCACTTAGGGAAGCTGAGGCGAGTAGATCACCTGAGGTCAGGAGTTAGAGACCAGCCTGGCCATCATGGTGAAACCCCGTCTCTACTAAAGATACCAAAAATTAGCTGAGTGTGGTGCTGGGTGCCTGTAATCCCAGAAACTCAGGGTGCCTGTAATCCCAGCAACTCAGGGTGCCTTTAATCCCAGCAACTGAGGGTACCAGTAATCCCAGCAACTCAGGGTGTCTTTAATCCTAGCAACTGAGGGCACCTGTAATCCCAGCAACTCAGGAAGCTGAGACAGGAGAAGTACTTGAACCCAGAAGGCAGAGGTTGCAGTGAGCCGATATTGCACCATTGCACTCCAGTCTGGGCAACAAGAGTGAAACTCTGTCTCAAAAAAAAA"
"chr16","9769317","9769634","JH378153","10517405","10517727","57","748088","GGTTGGGCATGGTGGCTCACACCTGTAATGCCAGCACTTTGGGAGGCGGGCAGATCACCTGAGGTCAGGAGTTCAAGACCAGCCTGGCCAACATGGTGAAATCCTGTCATTACAAAAATACAAAAAAAAAAAAAAAAAAAAAAAAAAAAAGCCAGTAATGATAGTGGGTGCGTATAATCCCAGCTACTTTGGAGGCTAAGGCAGGAGACTCACTTGAACCCAGGAGGCGGAGGTTATGGTGAGCCGAGATCACACCATTGCACTCCAGCCTGGGCGACAAGAGCAAAACTCCATCTCAAAAAAAAAAAAAAAAAAAAA","GGCCGGGCGTGGTGGCTCACGCCTGTAATCCCAGCACTTTGGGAGGCCGAGGTGGGTGGATCATGAGGTCAAGAGATCGAGACCATCCTGGTCAACATGGTGAAACCCTGTCTCTACTAAAAAAAAAAAAAAAAAAAAAAAATACAAAAAAATTAGCTGGGCATGGTGGCGCATGCCTGTAATCCCAGCTACTCCGGAGGTTGAGGTAGGAGAATTGCCTGAACCCAGGAGGCGGAGGTTGCGGTGAGCCGAGATCGCGCCATTGCACTCCAGCCTGGGTAACAAGAGCAAAACTCCGTCTCAAAAAAAAAAAAAAAAAAGAA"
"chr16","13753079","13753710","JH378118","18053084","18053501","278","4300005","GGCTGATTGTGATGGCTCACACTTGTAATCCCCTCACTTTGGGAGGCCAAAGCGGGAGCATCACCTGAGGTCAGGAGTTCAAGACCAGCCTGGCCAACATGGTGAAACCCCATCTCTACTAAAAATAAAAAATTAGCTGGGCACAGTGACTCATGCCTGTAATCCCAGCACTTTGGGAGGCCGAGGCAGGCAGATCACAATCACGAGGTCAGGAGTTCGAGACCAGCCTGACCAACATGGTGAAACCCCGTCTCTACTAAAAATAGAAAAATTAGCCAGGCGTGGTGGCACACGCCTGTAATCCCAGCTCCTCAGGAGACTGAGGCAGGAGAATCACTTGAACCCAGGAGGTGGAGGTTGCAGTGAGCAGAGATCGCACCACTGCACTCCAGCCTGGGTAACAGAGTGAGACTCCGTCTCAAAAAAAAAAAAAAAAAAAAAAAAAAAACGAAATTAACCAGGTGTGGTGGCACATGCCTGTAATCCCAGCTACTTGGGAGGCTGAGGCAGGAGAATCGCTTGAACCCGGGAGACAGAGGTTCCAGAGAACTGAGATCATGCCATTGCACTCCAGCCTGGGCAACAAGAGTGAAACTCCATCTAAAAAATAAATAAATACATAAACAAACAAA","GGCTGGGCGCAGTGGCTCACACCTGTAATCCCAGCACTTAGGGAAGCTGAGGCGAGTAGATCACCTGAGGTCAGGAGTTAGAGACCAGCCTGGCCATCATGGTGAAACCCCGTCTCTACTAAAGATACCAAAAATTAGCTGAGTGTGGTGCTGGGTGCCTGTAATCCCAGAAACTCAGGGTGCCTGTAATCCCAGCAACTCAGGGTGCCTTTAATCCCAGCAACTGAGGGTACCAGTAATCCCAGCAACTCAGGGTGTCTTTAATCCTAGCAACTGAGGGCACCTGTAATCCCAGCAACTCAGGAAGCTGAGACAGGAGAAGTACTTGAACCCAGAAGGCAGAGGTTGCAGTGAGCCGATATTGCACCATTGCACTCCAGTCTGGGCAACAAGAGTGAAACTCTGTCTCAAAAAAAAA"
"chr16","13951847","13952482","JH378118","18053084","18053501","292","4101237","GGCCAGGTGCGGTGGCTCATGCCTGTAATCCCAGCACTTTGGGAGGCTATGGCAGCGGATAACCTGAGGTCACAAGTTTGAGACCAGCCTGGCAAACATGGTGAAACCGTCTCTACTAAAAATACAAAAATTACACCAGGCGCGGTGGCTCATGCCTGTAATCCCAGCACTTTGGAAGGCCGAGGCAGGTGGATCATGAGGTCAGGAGATCAAGACCATCCTGGCTAACGCAGTGAAACCCCGTCTCTACTAAAAATATAAAAAATTGGCCAGGCGTGGTGGCGGACGCCTGTAGTCCCAGCTACTCGGGAGGCTGAGCCAGGAGAATGGCGTGAACCCGGGAGGCGGAGCTTGTGGTGAGCCGAGATAGCGCCACTGCACTGCCGCCTGGGTGACAGAGTGAGACTCTGTCTCAAAAAACAAAACAAAACAAAAACCAAAAACAAAAACAAAAAAACAAAAATTAGCCAGGTGTGGTGGTGCACGCCTGTCATCCCAGCTACTTGGGGGGCTGAGACGTGATAATCACTTGAACCCGGGAGGGAGAGGTTGCAGTGAGTGGAGATCACGCCATTGTATTCCAGCCTGGGGGCAAGAGCAAAACTCTGTCTCAAAAACAACAACAACAACAACAAA","GGCTGGGCGCAGTGGCTCACACCTGTAATCCCAGCACTTAGGGAAGCTGAGGCGAGTAGATCACCTGAGGTCAGGAGTTAGAGACCAGCCTGGCCATCATGGTGAAACCCCGTCTCTACTAAAGATACCAAAAATTAGCTGAGTGTGGTGCTGGGTGCCTGTAATCCCAGAAACTCAGGGTGCCTGTAATCCCAGCAACTCAGGGTGCCTTTAATCCCAGCAACTGAGGGTACCAGTAATCCCAGCAACTCAGGGTGTCTTTAATCCTAGCAACTGAGGGCACCTGTAATCCCAGCAACTCAGGAAGCTGAGACAGGAGAAGTACTTGAACCCAGAAGGCAGAGGTTGCAGTGAGCCGATATTGCACCATTGCACTCCAGTCTGGGCAACAAGAGTGAAACTCTGTCTCAAAAAAAAA"
"chr16","19006984","19007584","JH378118","18053084","18053501","263","953900","GGTGGCTGATGCCTGTAAACCCAGCATTTTGGGAGGCCGAGGCTGGTGGATCACCTGAGGTCAGGTGTTCGAGACCAGTCTGGCCAACATGGTGAAACCTCGTCTCTACCAAAAATACAAAAATTAGTTGGGTGTGGCCGGGTGTGGTGGCTTACGCTTGTAATCTCAGCACTTTGGGAGGCCGAGGTGGGTGGATCACGAGGTCAGGAGTTCAAGACCAGCCTGGCCAAGATGGTGAAACCCTGTCTCTACTAAAAATACAAAAAATTAGCCAGGCATGGTGGCGGGTGCCTGTAATCCCAGCTACTCGGGAGGCTGAGGCAGAGAATTGCTTGAACCTGGGAGGTGGAGGTTGCAGTGAGCCGAGATTGTGCCACGACACTCCAGCCTGGGTGACAGAGCGAGACTCTGTCTAAAAAAAAAAAAAAAAATTAGTTGGATGTGGTGGTGGGTGTCTGTAATCTCAGCTACTCAGGAGACTGAATCAGGAGAATCACTTGAACCCAGGGGGCTGGAGGTTGCAGTGAGCCGAGATCTTGCCATTGCACTCCAGCCCGGGCGACAAGAGCAAAACTCTCTTTCAAAAAAAAAAAAAAAAAGA","GGCTGGGCGCAGTGGCTCACACCTGTAATCCCAGCACTTAGGGAAGCTGAGGCGAGTAGATCACCTGAGGTCAGGAGTTAGAGACCAGCCTGGCCATCATGGTGAAACCCCGTCTCTACTAAAGATACCAAAAATTAGCTGAGTGTGGTGCTGGGTGCCTGTAATCCCAGAAACTCAGGGTGCCTGTAATCCCAGCAACTCAGGGTGCCTTTAATCCCAGCAACTGAGGGTACCAGTAATCCCAGCAACTCAGGGTGTCTTTAATCCTAGCAACTGAGGGCACCTGTAATCCCAGCAACTCAGGAAGCTGAGACAGGAGAAGTACTTGAACCCAGAAGGCAGAGGTTGCAGTGAGCCGATATTGCACCATTGCACTCCAGTCTGGGCAACAAGAGTGAAACTCTGTCTCAAAAAAAAA"
"chr16","19554918","19555551","JH378118","18053084","18053501","281","1501834","GGCCGGGCGCAGTGGCTCACACCTGTAATCCCAGCACTTTGGGAGGCCGAGGCGGGTGGATCACTTGAGGTCAGGAGTTCAAGACCAGCCTGGCTGACATGGTGAAACCCTGTCTCTACTGAAAACACAAAAATTAGGCCGGGCATAGTGGCTCATGCCTGTAATACCAGCACTTTGGGAGGCCGAGGTGGGTGGATCACCTGAGGTCAGGAGTTTGAGACCAGCTTGACCAACATGGTGAAACCCCGTCTCTACTAAAAATATAAAAATTAGTCTGGCATGGTGGCAGATGCCTGTAATCCCAGCTACTCAGGAGGCTGAGGCAGGAGAATTGCTTGAACCTGGAAGGTGGAGGTTGTAATGAGCCAAGATCACACCACTGCACTCCAGCCACTGTACTCCAGCCTGGGTGACAGAGTGAGACTCTGTCTCAAAAAACATACATACACACACATACACACACACACACACACACACACAAATTAGCTGGACGTGATAGCACACCCCTGTAGTCCCAGCTGCTTGAGAGACCGAGGCACAAGAATCACACGAACCCGGGAGGCGGAGGTTCCTGTGAGCCAAGATCGCACCATTGTACTCCATTCTGGGTGACAAGAGTGAAGCTCTGTCTCAA","GGCTGGGCGCAGTGGCTCACACCTGTAATCCCAGCACTTAGGGAAGCTGAGGCGAGTAGATCACCTGAGGTCAGGAGTTAGAGACCAGCCTGGCCATCATGGTGAAACCCCGTCTCTACTAAAGATACCAAAAATTAGCTGAGTGTGGTGCTGGGTGCCTGTAATCCCAGAAACTCAGGGTGCCTGTAATCCCAGCAACTCAGGGTGCCTTTAATCCCAGCAACTGAGGGTACCAGTAATCCCAGCAACTCAGGGTGTCTTTAATCCTAGCAACTGAGGGCACCTGTAATCCCAGCAACTCAGGAAGCTGAGACAGGAGAAGTACTTGAACCCAGAAGGCAGAGGTTGCAGTGAGCCGATATTGCACCATTGCACTCCAGTCTGGGCAACAAGAGTGAAACTCTGTCTCAAAAAAAAA"
"chr16","19576859","19577465","JH378118","18053084","18053501","251","1523775","GGCCAGGCATGGTGGCTCACACCTGTAATCCCAGCCCTTTGGGAGGCCGAGGCAGGTGGATCACCTGAGGTCAGGAGTTCGAGACCAGCCTGGCCAACATGGTGACACCCCACTCTACCAAAAATACAAAAATTAGGTTGGGTGCAGCGGTTCACACCTGTAATCCCAGCACTTTGGGAGGCCAAGGTGGATGGATCACCTGAGGTCAGGAGTTTGTGACCAGCCTGGCCAACATGGCGAAACCCTGCCTCTACTAAAAATAAAAAATTAGCCAGGTGTGGTGGCATGCGCCTGTAATCCTAGCTACTGAGGCAGGAGAATCGCTTGGACCAGGGAAGCAGAGTTTGCAGTGAGCCAAGATCACGCCACTGCACTCTAGCCTGGGTGACAGAGTAAGACTCCATCTCAAAAAAAAAAAAAAATACAAATATTAGCTGGGCATGGTGGCGCACACCTGTAGTTCTGGCTACTCAGGAGGCTGAGGCAGGAGAATTGCTTGAACCCAGAAGGCAGAGGTTGCAGTGAGCTGAGATTGTGCCATTGCACTCAGCCTGGGCAACAAAAGTGAAACTCCATCTCAAAATAAATAGATAAATAAATAAATAAA","GGCTGGGCGCAGTGGCTCACACCTGTAATCCCAGCACTTAGGGAAGCTGAGGCGAGTAGATCACCTGAGGTCAGGAGTTAGAGACCAGCCTGGCCATCATGGTGAAACCCCGTCTCTACTAAAGATACCAAAAATTAGCTGAGTGTGGTGCTGGGTGCCTGTAATCCCAGAAACTCAGGGTGCCTGTAATCCCAGCAACTCAGGGTGCCTTTAATCCCAGCAACTGAGGGTACCAGTAATCCCAGCAACTCAGGGTGTCTTTAATCCTAGCAACTGAGGGCACCTGTAATCCCAGCAACTCAGGAAGCTGAGACAGGAGAAGTACTTGAACCCAGAAGGCAGAGGTTGCAGTGAGCCGATATTGCACCATTGCACTCCAGTCTGGGCAACAAGAGTGAAACTCTGTCTCAAAAAAAAA"
"chr16","19983557","19984148","JH378118","18053084","18053501","244","1930473","GGCCGAGTGCGGTGGCTCATGCCTGTAATCCCAGCACTTTGGGAGGCCGAGACAGGTGAATCACCTGAGGTCTGGAGTTTGAGACCAGCTGACCAACATGGTGAAACCCTGTCTCTACTAAAAATACAAAAAATTGGCTGAGCGCAGTGGCCACGCCTGTTATCCCAGTACTTTGGGAGGCCGAGGCGGGTGGATCACGAGGTCAGGAATTCGAGACCAGCCTGACCAACATGGTGAAGCCCCGTCTCTACTAAAAATAAAAAAATTAGCCAGGTGTGGTGGTGCGCCCCTGTAAACCCAGCTACTCAGGAGGCTGAGGCAGGAGAATCACTTGAATCTGGGAGGCGGAGGTTGCAGTGAGCCAAGATCGAGCCACTGTACTCCAGCCTGGGAGACGGAGTGAGACTCCATCTAAAAAAAAAAAAAAATTAGCCAGGCGTGGTGGCACAAGCCTGTAATCCCAGCTACCTGGGAGGCTGAGATAGGAGAATTCCTTGAATCTGGGAGGCGGAGGTTGCAGTGAGCTGAGATTGTGCCATTGCACACCAGCCTGGGTGACAAGAGCAAAATTCCATCTCAAAAAAAAAAAAAA","GGCTGGGCGCAGTGGCTCACACCTGTAATCCCAGCACTTAGGGAAGCTGAGGCGAGTAGATCACCTGAGGTCAGGAGTTAGAGACCAGCCTGGCCATCATGGTGAAACCCCGTCTCTACTAAAGATACCAAAAATTAGCTGAGTGTGGTGCTGGGTGCCTGTAATCCCAGAAACTCAGGGTGCCTGTAATCCCAGCAACTCAGGGTGCCTTTAATCCCAGCAACTGAGGGTACCAGTAATCCCAGCAACTCAGGGTGTCTTTAATCCTAGCAACTGAGGGCACCTGTAATCCCAGCAACTCAGGAAGCTGAGACAGGAGAAGTACTTGAACCCAGAAGGCAGAGGTTGCAGTGAGCCGATATTGCACCATTGCACTCCAGTCTGGGCAACAAGAGTGAAACTCTGTCTCAAAAAAAAA"
"chr16","20117717","20118289","JH378118","18053084","18053501","224","2064633","GGCTGGGTGCGGTGGCTCACGCCTGTAATCCCAGCACTTTGGGAGGCCAAGGCGGGTAGATCATCTGAGGTCAGGAGTTCAAGACCAGCCTGGCCAACATGGTGAAACCCCGTCTCTACTAAAAATATTTTTAAAAGGCCAGGCGTGGTGGCTCACGCCTGTAATCCCAGCACTTTGGGAGGCCGAGGCGGGCAGATCATGAGGTCAGGAGTTCGAGACCATCCTGGCTAACACGGTGAAACCCCCGTCTCTACCAAAAAATACAAAAAATTAGCCGGGCATGGTGGCAGGTGCCTGTAGTCCCAGCTACTCGGGAGGCTGAGGCAGGAGGATGGCGTGAACCCAGGAGACAGAGCTTCCAGTGAGCTGAGATCGTGTCACTGCACTCCAGCCTGGGCGACAGAGGAGATTCTGTCTCAAAAAAAAAAAAAAAAAATTAGCTTGGTGTGGTGGCAGGTGCCTGTAATCCCAGTTACTCGGGAGGCTGAGGCAGAGGTTTCAGTGAACCGAGATCGCGCCATTGCACTCCAGCCTGGGCAACAAGAGTGAAACTCCGTCTCAAAGGAAAAAAAA","GGCTGGGCGCAGTGGCTCACACCTGTAATCCCAGCACTTAGGGAAGCTGAGGCGAGTAGATCACCTGAGGTCAGGAGTTAGAGACCAGCCTGGCCATCATGGTGAAACCCCGTCTCTACTAAAGATACCAAAAATTAGCTGAGTGTGGTGCTGGGTGCCTGTAATCCCAGAAACTCAGGGTGCCTGTAATCCCAGCAACTCAGGGTGCCTTTAATCCCAGCAACTGAGGGTACCAGTAATCCCAGCAACTCAGGGTGTCTTTAATCCTAGCAACTGAGGGCACCTGTAATCCCAGCAACTCAGGAAGCTGAGACAGGAGAAGTACTTGAACCCAGAAGGCAGAGGTTGCAGTGAGCCGATATTGCACCATTGCACTCCAGTCTGGGCAACAAGAGTGAAACTCTGTCTCAAAAAAAAA"
"chr16","20574957","20575888","JH378118","18053084","18053501","543","2521873","GGCCAGGCGTGGTGGCTCATGCCTGTAATCCCAGCACTGTGAGAGGCCGAGGCGGGCGGATCACCTGAGCTGAGGAGTTCGAGACCAGCCTGGCCAACATGGCGAAACCCCATCTCTACTAAAAACACAAAAATTAGGCCAGGTGTGGTGGCTCACACCTGTAATCCCAGCACTTTGGGAGGCCAAGGCGGGCGGATCACCTGAGGTCAGGAGTTCCAGACCTGCCTGGCCAACATGGTGGAATCCCATCTCTACTAAAAATACAAAAATCTGCCAGGTGTGGTGGCACACTTCTGTAATCCCAGATACTCAGGAGGCTGAGGCAGGAGAATCACTTGAACCCTGGAGATGGAGGTTGCAGTGAGCCAAGATCAAGAGATTGCACTCTAGCCAGGGTGACTAGAGTGAGACTCGGTCTCAAAAAAAATGTAATTAATTAATTAATTAATACAAAAATTAGCTGGGCGTGGGCTAGGTGTGGTGGCTCACGCCTGTAATCCCAGCACTTTGGGAGGCCGAGACAGGCGGATCACCTGAGGTCAGGAGTTCAAGACCAGTTTAACCAACATGGAGAAACCCCATCTCTACTAAAAATACAAAATTAGCTGGGCGTGGTGGTGCATGCCTGTAATCCCAGCTACTCGGGAGGCTGAGGCAGAAGAATCGCTTGAGCCTGGTAGGCGGAGATCGTGGTGAGCCGAGATCGCGCCATTGCACTCCAGCCTGGACAACAAGAGCGAAACTCCGTCTAAAAAAAAAAAAAAAATTAGCTGGGCATGGTAACAGGCGCCTGTAAACCCAGTTTCCTCGGGAGGCTGAAGCAGAATTGCTTGATCCCAGAGGCAGAGGTTGCAGTGAGCCAAGATAGTGCCATTGCAGTCCAGCCTGGGCAACAAGAGTGAAACTCCGTCTCAAAAAAAAAAAAAAAAAAA","GGCTGGGCGCAGTGGCTCACACCTGTAATCCCAGCACTTAGGGAAGCTGAGGCGAGTAGATCACCTGAGGTCAGGAGTTAGAGACCAGCCTGGCCATCATGGTGAAACCCCGTCTCTACTAAAGATACCAAAAATTAGCTGAGTGTGGTGCTGGGTGCCTGTAATCCCAGAAACTCAGGGTGCCTGTAATCCCAGCAACTCAGGGTGCCTTTAATCCCAGCAACTGAGGGTACCAGTAATCCCAGCAACTCAGGGTGTCTTTAATCCTAGCAACTGAGGGCACCTGTAATCCCAGCAACTCAGGAAGCTGAGACAGGAGAAGTACTTGAACCCAGAAGGCAGAGGTTGCAGTGAGCCGATATTGCACCATTGCACTCCAGTCTGGGCAACAAGAGTGAAACTCTGTCTCAAAAAAAAA"
"chr16","20816618","20817242","JH378118","18053084","18053501","267","2763534","GGCCCGGCGTGGTGGCTCATGCCTGTAATCCCAGCACTTTGGGAGGCCGAGGCCGGCGGATCACCTGAGGTCAGGAGTTTGAGACCACCCTGGCCAACACGGTGAAAACCTGTCTCTACTAAAAATACAAAAATTAGCCAGGCGCAGTGGCTCACGTCTGTAATTCCAGCACTTTGGAGGGCCGAGGGGGGCAGATCACAAGGTCAGGAGTCCAAGACCAGCCAGGCCAACATAGTGAAACCCGGTCTCTACTAAAAATACAAAAAATTAGCCGGGCGTGGTGGCGGACCCCTGTAGTCCCAGCTACTCAGGAGGCTGAGACAGGAGAATCTCTTGAACCCAGGAGGCAGAGGTTGCAGTGAGCCAAGATCATGCCATTCCACTCCAGCCTGGGCGACAGTGCAAGACTCTGTCTCAAAAACAAAAACAAAAAACCCCCAAACCAAAAATTAGCCAGGCGTGGTGGCATGCACCTGTAGTCCCAGCTACTTGGGAGGCTAAGGCAAGAGAATAGCTTGAACCCAGGAGGCAGAGGTTGCAGTGAGCCGAGATAGTGCCATTGCACTCCAACGTGGGTGACAAGAGCAAAACTCTGTCTCAAAAAAAAAAAAAAAAAAGGAAGGAA","GGCTGGGCGCAGTGGCTCACACCTGTAATCCCAGCACTTAGGGAAGCTGAGGCGAGTAGATCACCTGAGGTCAGGAGTTAGAGACCAGCCTGGCCATCATGGTGAAACCCCGTCTCTACTAAAGATACCAAAAATTAGCTGAGTGTGGTGCTGGGTGCCTGTAATCCCAGAAACTCAGGGTGCCTGTAATCCCAGCAACTCAGGGTGCCTTTAATCCCAGCAACTGAGGGTACCAGTAATCCCAGCAACTCAGGGTGTCTTTAATCCTAGCAACTGAGGGCACCTGTAATCCCAGCAACTCAGGAAGCTGAGACAGGAGAAGTACTTGAACCCAGAAGGCAGAGGTTGCAGTGAGCCGATATTGCACCATTGCACTCCAGTCTGGGCAACAAGAGTGAAACTCTGTCTCAAAAAAAAA"
"chr16","21054922","21055508","JH378118","18053084","18053501","243","3001838","GGCCGGGTGCGGTGGCTCACACCTATAATCCCAGCACTTTGAGAGTCTGAGGCAGGCGGATCACCTGAGGTCAGGAGTTCCAGACCAGCCTGGCCAACATGGTGAAACCCAGTCTCTACTAAAAATACAAAAAAAGACCGGGCACAGTGGCTCACGCCTGTAATTCCAGCACTTTGGGAGGCCGAGGCAGGTGGATCACCTGAGGTTGGGAGTTCGCGACCAGCCTGACCGACATGGAGAAATCCCATCTCTACTAAAAATACAAAATTAGCCGGGCGTGGTGGCACATGCCTGTAATTCCAGCTACTCAGGAGGCTGAGGGAGGAGAATCACTTGAACCTGGGAGGCGGAAGTTGTGGCGAGCCAAGATCACGCCATTGCACTCCAGCCTGGGCAACAAGAGTGAAACCCCATTTCAAAAAAAAAAAAAATTAGCCAGGGGTGGTGGTGCATTCTTGTAATACCAGCTACTCGGGAGGCTGAGGTAGGAGAATCACTTGAGCGCAGGAGGCAGATGTTGTAGTGAGCCGAGTGCCATTGCACTACAGCCTGGGCGACAAGAAAGTAACTCCACCTCAAAAAAAAAA","GGCTGGGCGCAGTGGCTCACACCTGTAATCCCAGCACTTAGGGAAGCTGAGGCGAGTAGATCACCTGAGGTCAGGAGTTAGAGACCAGCCTGGCCATCATGGTGAAACCCCGTCTCTACTAAAGATACCAAAAATTAGCTGAGTGTGGTGCTGGGTGCCTGTAATCCCAGAAACTCAGGGTGCCTGTAATCCCAGCAACTCAGGGTGCCTTTAATCCCAGCAACTGAGGGTACCAGTAATCCCAGCAACTCAGGGTGTCTTTAATCCTAGCAACTGAGGGCACCTGTAATCCCAGCAACTCAGGAAGCTGAGACAGGAGAAGTACTTGAACCCAGAAGGCAGAGGTTGCAGTGAGCCGATATTGCACCATTGCACTCCAGTCTGGGCAACAAGAGTGAAACTCTGTCTCAAAAAAAAA"
"chr16","27896431","27896766","JH378166","6401112","6401453","56","21495319","GGCCAGGCGCGGTGGCTCACGCCTGTAATCCCAGGACTTTGGTAGTCCAAGGCGGGTGGATCACCTGAGGTCAGGAGTTCAAGATCAGCCTGACCAACATGGCAAAACCTCGTCTCTACTAAAAAATACAAAAATTAGCCGGTGTGGTGGCAGGTGCCTGTAATTCCAGCTACTCGGGACGCTGAGTCATGAGAATTGCTTGAACCTAGGAGGCAGATGTTGCAATGAGCCGAGATCGCACCATTGTACTCCAGCCTGGGCGACAAGAGGGAAACTGTCTCCAAAAAAAAAAAAGAAAGAAAGAAAGAAAGAAAGAAAAAAGAAAAACAAAACAAA","GGCCAGGTGCAGTGGCTCACCCCTGTAATCCCAGCACTTTGGGAGGTCGAGGTGGGTGGATCACCTGAGGTCAGGAGTTCAAGACCAGCCTGACCAAAATGGTGAAACCCCATCTCTACTAAAAATACAAAACATTAGCCAGACATCGTGGCGGGCACCTGTAATCCCAGCTACTTGGGAGGCTGAGGCAGGAGAATTGCTTGAGCCTAGGAGGCGGAGGTTACAGTGAGCCATGATCGTGCCATTGGACTCCAGCCTGGGCTACAAGAGCGAGACTCCATCTCAAAAAAAAAAAAAAAAAAAAAAAAGAAAGAAAGAAAGAAAGAAAGAAAAGAAAGAAAG"
"chr16","36524888","36525430","JH378206","6546474","6546861","201","29978414","TTTGAGACCAGCCTGGCCATTGTGGTGAAACCCCGTCTCTACTAAAAAAAATTCAAAAAATGGCTGGGTATGGTGGCTCACGCCTGTAATCCCAGGACTTTGGGAGGCCAAGGTGGGCGGATCACCTGAGGTCAGGAGTTTGAGACCAGCCTAGCCAACATGGTGAAACCCCGTCTCTACCAAAAATACAAAAATTAGCCGGGCTTGGTGGCGCGCACCTGTAATCCCAGGTACACTGGAGGTTGAGGCACAAGAATCGTTTGATCCTGGGAGGTTGCAGTGAGCCAAGATCACGCCACTGCACTCCAGACTGGGTGACAGAGCGAGATTCCATCTCAAAACAACAACAACAAACCCAAAAAATTAGCTGGGTGTGGTGGTGGGTGCCTGTAATCCCAGCTACTTAGGAGGCTGAGGCAGAAGAATCGCTTGAACCCAGGAGGTGGAGGTTGTTGCAGTGAGCAGAGATCGCACCATTGCACTCCAGCCTGGGCAACGAGTGAAACTCCATCTCAAAAAAAAAAAAAAAAAAAGAAAAAAAAA","GGCCACACATGGTGGCTAACGCCTGTAATCCCAGCACTTTGGGAGGCCAAGTCGGGTGGATCATGAGGTCAGGAGACCAAGACCATCCTGGCCAAATGGTGAAACCCCGTCTCTACTAAAAATACAAAAATTAGCTGGGCATGGTGGCGTGTGCCTGTAATCCCAGCTACTCAGGAGGCTGAGGCAGGACAATTGCCTGAACCCAGGAGAATTAGCTGGGCATGGTGGCGTGTGCCTGTAATCCCAGCTACTCAGGAGGCTGAGGCAGGACAATTGCCTGAACCCAGGAGGCGAAGGTTGCGGTGAGCCGAGATTGTGCCATTGCACTCCAGCCTGGGTAACAAGAGCGACACTCTGTCTCAAAAAAAAAAAAAAAAAAAAAAAAAAA"
"chr16","36528224","36528842","JH378119","32351107","32351490","270","4177117","GGCCAGGCGTGGTGGCTCACGCCTGTAATCCCAGCACTTTGGGAGGCTGAGGCAGGCAGATCACCTGAGGTCAGGAGTTCAAGACCAGCCTGGCCAACATGGTGAAACTCCATCTCTACTAAAAATACAAAATTAAGCCGGGCACGGTGGCTCACATCTGAAATCCCAGCACCTTGGGAGGCTAAGGCAGGCGGATCACGAGGTCAGGAGTTCAAGACTAGCTGACCAATATGGTGAAACCCCGTGTCTACTAAAAATACAAAAAAAATTAGCTGGGCGTGGTGGCGCATGCCTGTAGTTCCAGGTACTCAGGAGGCTGAGGAAGGAGAATCACTTGAACCTGGGAGGCGGAGGTTGCAGTGAGCCAAGATCATGCCACTGCATTCCAGCCTGGGCAACAGAGCAAGACTCTGTCTCAAAAATAAAAATAAAAATAAAAGTAAAAATACAAAATTAGCCAGGCGTGGTGGTGTGTGCCTGTAATCACAGCTACTCAGGAGGCAGGAAAATCACTTGAACCTAGGAGGAGGAGGTTGGTGAGCCAAGATCACACCATTGCACTCCAGCCTGGGCAAAAAGAGCAAAACTCCGAACTCTGTCTCAAAAAAAAAAAAAAAAA","GGCCAGGTATGGTGGCTCACACCTGTAATCCCAGCACTTTGGGAGGCCAAGGCAGGCAGACCACCTGAGGTCAGGAGTTCGAGATCAGCCTAGCCAACATGGTGAAACCCCATCTCTAGTAAAAATAAAATTAGCCAGGCATGGTGGTGCATGCCTGTAACGCAGGTCAGGAGTTCGAGATCAGCTTAGCCAACATGGTGAAACCCCATCTCTAGTAAAAATAAAATTAGCCAGGCAGGTGGTGCCGCCTGTACTCGGGAGGCTGAGGCAGGAGAATCACTTGAACCCAAGAGGCAGAGGTTGCAGTCAGCCAAGATCATGCCATTGCACTCCAGCCTAAGCAAAAAGAGTAAAACTCAGTCTCAAAACAAAAAAACAAAAAAA"
"chr16","44800308","44800913","JH378118","18053084","18053501","244","26747224","GGCCTGGTGCAGTGGCTCACACCTGTAATCCCAGCACTTTGGGAGCCCAAGGCGGGTGGATCACCTGAGGTCAGGAGTTCGAGACCAGCCTGGCCAACATGGTGAAATCCTCTCTACTAAAAATGCAAAAAATTAGCTGGGCGGCCAGGCGCAGTGGCTCACGCCTGTAATCCCAGCACTTTGGGAGGCCGAGGTGGGCGGATCACAAGGTCAGGAGATCGAGACCATGCTGGCTAACACGGTGAAACTCCGTCTCTACTGAAAATACAAAAAATTAGCCAGGCACGGTGGCGGGCGCCTGTAGTCCCAGCTACTGGGGAGGCTGAGGCAGGAGAATGGCGTGAACCTGGGAGGTGGAGGTAGCAGTGAGCCAAGATTGCGCCACCGCAGTCCGGCCTGGGTGAAAGAGCGAGACGCTGTCTCAAAAAAAAAAAAAAAAAATTAGCTGGGCATGGTGGCGGGCGCCTGTAATCCCAGTTACTCGGGAGGCTGAGGCAGGAGAATCAGTTGAACCCAGGAGGTGGAGGTTGCAGTAAGCCAAGATTGTGCCATTGTACTCCAGTCTGGGCAACAAGAGCGAAACTCTGTCTTAAAAAACAAAAAAAA","GGCTGGGCGCAGTGGCTCACACCTGTAATCCCAGCACTTAGGGAAGCTGAGGCGAGTAGATCACCTGAGGTCAGGAGTTAGAGACCAGCCTGGCCATCATGGTGAAACCCCGTCTCTACTAAAGATACCAAAAATTAGCTGAGTGTGGTGCTGGGTGCCTGTAATCCCAGAAACTCAGGGTGCCTGTAATCCCAGCAACTCAGGGTGCCTTTAATCCCAGCAACTGAGGGTACCAGTAATCCCAGCAACTCAGGGTGTCTTTAATCCTAGCAACTGAGGGCACCTGTAATCCCAGCAACTCAGGAAGCTGAGACAGGAGAAGTACTTGAACCCAGAAGGCAGAGGTTGCAGTGAGCCGATATTGCACCATTGCACTCCAGTCTGGGCAACAAGAGTGAAACTCTGTCTCAAAAAAAAA"
"chr16","45828895","45829498","JH378118","18053084","18053501","256","27775811","GGCCAGGAGAGGTGGCTCATGCTTGTAATTCCAGTATTTTGGGAGCCCAAGGCGGGTGGATCACTTGAGGTCAGGAGTTTGAAACCAGCCTGACCAACATGGTGAAACCCCGTCTCTACTAAAAATTCAAAATTAGGCAAGGCCTGGTGGCTCATGCCTGTAATCCCAGCACTTTGGGAGGCCAAGGAGGGAGGATCACCTGAGGTCGGGAGTTTGAGACCAGCCTGACCAACATGGAGAAACCCCGTCTCTACTAAAACTACAAAATTAGCCGGGTGTGGTGGCCCATGCCTCTAATCCCAGCTACTCTGGAGGCTGAGGCAGGAGAATCACTTGGACCTGGGATGTGAAGGTTGCAGTGAGCCAAGATCGAGCCATTGCACTCCAGCCTGGGCCACAAGAGTGAAACTCCGTCCCAGAAAAAAAAAAAAAAATTAACCTGGCATGGTGGTGTATGCCTGTAATCCCAGCTACTCGGGAGACTGAGGCAGGAGAATCTCTTGAACCCGGGAGGCGGAGGTTGCAGTAAACCGAGATTGCGCCATTGCACTCCGGCCTGGGTGACAAGAGCGAAACTCCGCCTAAAAAAAAAAAGAAAAGAAAA","GGCTGGGCGCAGTGGCTCACACCTGTAATCCCAGCACTTAGGGAAGCTGAGGCGAGTAGATCACCTGAGGTCAGGAGTTAGAGACCAGCCTGGCCATCATGGTGAAACCCCGTCTCTACTAAAGATACCAAAAATTAGCTGAGTGTGGTGCTGGGTGCCTGTAATCCCAGAAACTCAGGGTGCCTGTAATCCCAGCAACTCAGGGTGCCTTTAATCCCAGCAACTGAGGGTACCAGTAATCCCAGCAACTCAGGGTGTCTTTAATCCTAGCAACTGAGGGCACCTGTAATCCCAGCAACTCAGGAAGCTGAGACAGGAGAAGTACTTGAACCCAGAAGGCAGAGGTTGCAGTGAGCCGATATTGCACCATTGCACTCCAGTCTGGGCAACAAGAGTGAAACTCTGTCTCAAAAAAAAA"
"chr16","47110839","47111458","JH378118","18053084","18053501","268","29057755","GGCCAGGCGTGGTGGCTCACGCCTTTAATCCCAGCACTTTGGGAGGCCGAGGCAGGCAGATCACCTAAGGTCAGGAGTTCGAGACCAGCCTGGCCAACATGGTGAAACCCCCTCTCTACTAAAAATGCAAAAATTTCTGGGCATGGTGGCTCACGCCTGTAGTCCCAGCACTTTGGGAGGCCAAGGCAGGCGGATCACTTGAGGTCAGGAGTTTGAGACCAGCCTGGCCAACATGGTGAGACCCCTGTCTCTACTAAAAATATAAAAAAGTAGCCAGGCGTGGTGGTGTATGCCTCCCAGATAATTGGGAGGCTGAGGTGGGATAATTGCTTGAACCCGGGAGGCAGAGGTTGTAGTGAGCCAAGATAGCGCCAATGCACTCCAGCCTGGGCAACAGAGCGAGACTCTGTCTCAAAAAAAAAAAAAAAAAGAAAAAAGAAAAGAAATTAGCTGGGCGTGGTGATGGGTGCCTGTAATCCCAGCTGCTTAGGAAGCTGAGGAAGGAGAATCACTTAGACCCAGGAGACAGAGGTTGCAGTGAGCCGAGATCGCACCATTGTATTCCAGCCTGGGTGACAAGAGAAAAACTATGTCTCAAAAAAAAAAAAAAGAGTAGAAAA","GGCTGGGCGCAGTGGCTCACACCTGTAATCCCAGCACTTAGGGAAGCTGAGGCGAGTAGATCACCTGAGGTCAGGAGTTAGAGACCAGCCTGGCCATCATGGTGAAACCCCGTCTCTACTAAAGATACCAAAAATTAGCTGAGTGTGGTGCTGGGTGCCTGTAATCCCAGAAACTCAGGGTGCCTGTAATCCCAGCAACTCAGGGTGCCTTTAATCCCAGCAACTGAGGGTACCAGTAATCCCAGCAACTCAGGGTGTCTTTAATCCTAGCAACTGAGGGCACCTGTAATCCCAGCAACTCAGGAAGCTGAGACAGGAGAAGTACTTGAACCCAGAAGGCAGAGGTTGCAGTGAGCCGATATTGCACCATTGCACTCCAGTCTGGGCAACAAGAGTGAAACTCTGTCTCAAAAAAAAA"
"chr16","48159907","48160229","JH378222","6231244","6231546","61","41928663","GGCTGGGCACAGTGGCTCATGCCTGTAATCCCAGCACTTTGGGAGGCCGAGGCAGGCGGATCACCTGAGGTCAGGAGTTCGAGACTAGCCTGGCCAATATAGCGAAACCCCGTCTCTACTAAAAATTAGTTGGGCATGGTGGCAGGCGCCTTAATCCCAGCTACTTGGGATGCTGAGGCAGAAGAATCGCTTGAACCCAGAGGGTGGAGGTTTCAGTGAGATGAGATCGTGCCATTGCACTCCAGACTGGGCAACAAGAGCGAGACTCTGTAAAAAAAATTAATTAATTAATTAACTAATTAATTAAAATAAAATGAGAAAAA","GGCTGGGCATGGTGGCTCACGCCTGTAATCCCAGCACTTTGGGACGCTTAGGCAGGTGGATTGCCTGAGGTCAGGAGTTCAAGACTACCCTGACCAACATAGTGAAACCCCGTCTCTACTAAAAATTAGCTGGGCATGGTGGCAGAGGCCTGTAATCCCAGCTACTCGGGAGGCTGAGGCAGGAGAATCACTTAAACCTGGGAGTTGGAGGTTGCAGTGAGCCAAGATCAAGCCATTGCACTCCAGTCTGGGCAACAAGAGCAAGACTCTGTCTCAAAAAAAAAAAAAAAAAGAAAAGAAAAA"
"chr16","49252302","49252639","JH378314","538162","538484","57","48714140","GGCCAGGCGCAGTGGTGCATGTCTGTAATCTTAGCACTTTGGGAGGCCGAGGTGGACGGATTACATGAGGTCAGGAGTTCAAGACCAGCCTGGCCAACATGGTGAAATTCCATCTCTACTACTAAAAAAAAAAAAAAAAAAAAAAAAAAAAAAAAAAAAAAATACAAAAATTAGCTGGGCTTGGTGGCGGGTGCCTGTAATCCCAGCTACTTGGGAGGCTGAGGCAGGAATCACTTAAACCCAGGAGGTGGAGGTTGCAGTGAGCCAAGACCATGCCATTGCACTCCAGCCTGGGCAACAAGAGCAAAACTCCGTCTCAAAAAAACAAAACAAAAAAA","GGCTGGGTGCGGTGCCTCACACCTGTAATCCCAGCACTTTGGGAGGCCGAGGTGGGTGGATCACGAGGTCAAGAGATCAAGACCATCCTGGTCAACATGGTGAAACCCTGTCTCTACTAAAAAAAAAAAAAAAAAAAAAAAAAAAAAAAAAAAAATTAGCTGGGCATGGTGGCGTGTGCCTGTAATCCCAGCTACTCAGGAGGCTGAGGCAGGAGAATTGCCTGAACCCAGGAGGCGGAGGTTGCGGTGAGCCGAGACTGTACCATTGCACTCCAGCCTGGGTAACAAGAGCGAAACTCCATCTCAAAAAAAAAAAAAAAAAA"
"chr16","49464616","49465219","JH378118","18053084","18053501","254","31411532","GGCCAGGCGTGGTGGCTCACACCTGTAATCCTAGCACTTTGGGAGACTGAGGCAGGTGGATCACATGAGGTGAGGAGTTCAAAACCACCCTGGCCGACATGGTGAAACCCCGTCTCTACTAAAAATATTTTTAAAAAGGCCAGGCGTGGTGGCTCACACCTGTAATTCCAGCACTTCGGGAGGCTGGGGCAGGCAGATCACAAGGTCAGGAGATCGAGACCATTCTGGCCAACGTGGTGAAACCCCGTCTCTACTAAAAATACAAAAATTAGCTGGGCGTGGTGGCGCGTGCCTGTAATCCCAGCTACTTGGGAGGCTGATACAGGAGAATTGCTTGAACCAGTGAGTCAGAGGTTGCAGTGAGCTGAGATTGCGCCATTGCACTCCAGCCTGGCAACAGAATGAGACTCCGTCTCAAAAAAAAAAAAAAAATTAGCTGGGCATGGTGGCAGGCACCTGTGATCCCAGCTACTTGGGAGGCTGAGGCAGGAGAATCGCTTGAACCTGGGAGGTGGAGGTTGCAGTGAGCTGAGATTGCGCCATTGCACTCCAACCTGGGCGTCAAGAGCAAAACTCCATCTCAAAAATAAATAAATAAATAAAA","GGCTGGGCGCAGTGGCTCACACCTGTAATCCCAGCACTTAGGGAAGCTGAGGCGAGTAGATCACCTGAGGTCAGGAGTTAGAGACCAGCCTGGCCATCATGGTGAAACCCCGTCTCTACTAAAGATACCAAAAATTAGCTGAGTGTGGTGCTGGGTGCCTGTAATCCCAGAAACTCAGGGTGCCTGTAATCCCAGCAACTCAGGGTGCCTTTAATCCCAGCAACTGAGGGTACCAGTAATCCCAGCAACTCAGGGTGTCTTTAATCCTAGCAACTGAGGGCACCTGTAATCCCAGCAACTCAGGAAGCTGAGACAGGAGAAGTACTTGAACCCAGAAGGCAGAGGTTGCAGTGAGCCGATATTGCACCATTGCACTCCAGTCTGGGCAACAAGAGTGAAACTCTGTCTCAAAAAAAAA"
"chr16","49983504","49983843","JH378316","567988","568320","50","49415516","GGCCAGGCATGGTGGCTTACGCCTGTAATCTCAGCACTTTGGGAGGCCAAGGCAGGCGGATCACCTGAGGTCAGGAGTTCAAGACCAGCCTGGTCAACATGGCGAAACCCTGTCTCTACTAAAAAAATACAAAAATTAGCCAGGCGTGGTGGTGGGCGCCTGTAATCTCTCCTACTTGGGAGACTGAGGCAGGAGAATTGCTTGAACTCAGAAGGCAGAGGTTGCAGTGAGCTGAGATCACGCCATTGCACTCCAGCCTGGATGACAAGAGCAAAACTCCATCTCAAACAAACAAAAAACAAACAAACAAAAAAAAACAAAAAAACCTCCAAAAAACAAA","GGCCGGGCGTGGTGGCTCACGCCTGTAATCCCAGCACCTTGGGAGGCTGAGGCGGGTGGATCACGAGGTCAAGAGATTGAGACCAGCCTGGTCAACATGGTGAAACCCTGTCTACTAAAAAAATACAAAAATTAGCTGGGCATGGTGGCACGTGCCTGTAATCCCAGCTACTCAGGAGGCTGAGGCAGGAGAATTGCCTGAACCCAGGAGGCGGAGGTTGCGGTGAGCCGAGATCGCGCCATTGCACTCCAGCCTGGGTAACAAGAGCGAAACTCCGTCTCAAAAAACAAAAAACAAAAAAACAAAAAACAAACAAACAAACAAAAAAACAAA"
"chr16","50470493","50471105","JH378118","18053084","18053501","251","32417409","GGCTGGGAGCGGTGGCTCATACCTGTAATCCCAGCACTCTGGGAGGCCGAGGCGCGTGGATCACCTGAGGTCAGGAGTTTGAGACCAGCCTGGCCAGCATGGTGAAACCCTGTCTCTACTAAAAATAGAAAAAGTTAGCTGGGTGAACAGCCGGGCGCGGTGGCTCACACCTGTAATCCCAGCACTTTGGGAGGCCGAGGCAGGTGGATCACAAGGTCAGGAGATCGAGACCATCCTGGCTAACACGGTGAAACCCTGTCTCTACTAAAAATATAAAAAATTAGCCGGGCATGGTGGTGGGTGCCTGTAGTCCCAGCTGCTCAGGAGGCTGAGGCAGGAGAATGGCGTGAAGCCAGGAGGCAGAGGTTGCAGTGAGCCGAGATCGTACCACTGCACTCTAGCCTGGGTGACAGAACGAGACTGTGTCTCAAAGAAAAAAAAAATTAGCTGGGTGTGGTGGCAGACACCTGTAATCCTAGCTACTTGGGAGGTTGAGGCAGGAGAATCGCTTGGACCTGGGAGGCGGAGGTTGCAGTAGGCTGAAATCGCACCATTGCACTCCAGCCTGGGCAACAAGAGGGAAACTCAGTCTCAAAAAAAAAAAAAAAAAAAA","GGCTGGGCGCAGTGGCTCACACCTGTAATCCCAGCACTTAGGGAAGCTGAGGCGAGTAGATCACCTGAGGTCAGGAGTTAGAGACCAGCCTGGCCATCATGGTGAAACCCCGTCTCTACTAAAGATACCAAAAATTAGCTGAGTGTGGTGCTGGGTGCCTGTAATCCCAGAAACTCAGGGTGCCTGTAATCCCAGCAACTCAGGGTGCCTTTAATCCCAGCAACTGAGGGTACCAGTAATCCCAGCAACTCAGGGTGTCTTTAATCCTAGCAACTGAGGGCACCTGTAATCCCAGCAACTCAGGAAGCTGAGACAGGAGAAGTACTTGAACCCAGAAGGCAGAGGTTGCAGTGAGCCGATATTGCACCATTGCACTCCAGTCTGGGCAACAAGAGTGAAACTCTGTCTCAAAAAAAAA"
"chr16","50478366","50478929","JH378114","15957391","15957789","242","34520975","GGCTGGGCACGGTGGCTCATGCCTGTAATCCTAGTACCCTGGGAGGCTGAAGCTGGCAGATCACTTGAGGTCAGGAGTTCGAAACCAGCCTGGCCAACATGGTGAAACCTCATCACTACTAAAAATACAAAAAGTCAGCCGAGCGCGGTGGCTCACGCCTTTAATCCCAGCACTTTAGGAGTCTGAGGCGGGTGGATCACAAGGTCAGGGGTTTGAGACTAGCCTGACCAACACGGTGAAACATCTTTACTAAAAATAGCCAGGCATGGTGGTGCAGGCCTGTAGCAGGTACTCAGGAGGCTGAGGCAGCAGAATCGCTTGAACCCGGGAGGCGGAGGTTGCAGTGAGCCGAGATTGAGCCACTGCACTCCACCCTGGGCAACTGAGCGAGACTCCGTCTCAAAAAAAAAAAAAAAAATTAGCTGGACGTGGTGGTGGATGCCTGTAATCCCGGCTACTTGGTACTTGGAAGGCTGAGACAGGAGAATCGCTTGAACCCGGGAGGTGGAGGTTGCAGTGAGCTGAGATAGCGCCATTGCACTCCAGCCTGGGCAACAAGAGTGA","GCAAGGAACGGTGGCTCATGCCTGTCATCCCAGCACTTTGGGAGGCTAAGGAGGGTGGATTACCGAAGGTCATGAGTTTGAGACCAGCCTGACCAACATGGTGAAAACCCCATCTCTACTAAAAATACAAAAAATTAGCCAGATACAGCTATGCGGCAGACTGGGGCAGGAGAATCGCTTGGACCCAAACCCCATCTCTACTAAAAATACAAAAAATTAGCCGGATACAGCTATGCGGGAGACTGGGGCAGGAGAATCGCTTGGACCCGGGAGGCAGAGATTGCAGTGAGATGAGACCATGCCATTGCTCTCTAGCTTGTGCGATGAGAACAAGACTCTGTCTCAAAAAAAAAAAAAAAAAAAAAAAAAAAAAAAAAAAAAAAAGAGAGAGAGAGAAAA"
"chr16","51388263","51388584","JH378271","2122362","2122678","46","49265901","GGCTGGGTACGGTGGCCCACACCTGTAATCCCAGCACCTTGGGAGGCTGAGGTGGGCGGATTACCTGAGGTCAAAAGTTCAAGACCAGCCTGGCCAACATGGTGAAATCCCATCTCTGCTAAAAATACAAAAAAAAAAAAAAAAAAAAAAAAAAAATTGCCAGGCATGGTGGCAGGCACCTGTAATCCCAGCTACTTGGGAGGCTGAGGCAGGGGAATCGCTTGAACCTGGGAGGCAGAGGTTGCAGTGAGCCCAGATAGCGCCATTGCACTCCAGCCTGGGCGACAAGAGCGAAACTCTGTCCAAAAAAAAAAAAAAAAAA","GGCCGGGCACGGTGGCTCACACCTGTAATCCCAGCACTTTGGGAGGCTGAGGTGGGTGAATCACCTGAGGTCAGGAGTTTGAGACCAGCCTGACCAACATGATGAAACCCGGTCTCTGCTAAAAATACAAAAAAAAAAAAAAAAAAAAAAAAAAAAAGCTGGGCATGATGGTGGGCACCTGTAATCCCAGCTACTCGGGAGGCTGAGGCAGGAGAATCGCTTGAACACCAGGAGGTGGAGGTTGCTATGAGCCGAGATCGCACCATTGCACTCTAGCTTGGGCAACAAGAGAGAAACTCCATCAAAAAAAAAAAAAA"
"chr16","51876298","51876882","JH378118","18053084","18053501","253","33823214","GTAATCCCAGCACTTTGGGAGGCCCAAGTGGGTGGATCACCTGAGGTCAGGAGTTCATGACCAGCCTGGCCACATGGTGAAACCCCATCTCTACTAAAAATACAAAATTAGGCTGGGCGCGGTGGCTTACGTCTGTAATTCCAGCACTTTGGGAGGCCGAGGCAGGCGGATCATGAGGTCAGGAGATTGAAACCATCCTGGCTAACACGGTGAAACCCTGTCTCTACTAAAAATACAAAAAATTAGCCGGGTGTGGTGGGGGGGCGCCTGTAGTCCCAGCTGCTCAGGAGGCTGAGGCAGGAGAATGGCATGAACCCGGGGGGGCGGAGCTTGCAGTGAGCTGAGATCATGCCACTGCACTCCAGCCTGGGCAACAAAGTGAGACTCCGTCTCAAAAAAAAAAACCAAAAAACAAAATGAGCTGGGTGTGGTGGTGGGGGCGTATAATCCCAGCTATACAGGAGGCTGAGGTAGGAGAATCACTTGAACCCGGGAGGTGGAGGTTGCAGTGAGCCGAGATTGTGCCATTTCACACCAACCTGGGTAACAAGAGTAAAATGCTGTCTCAAAAAAAAAAAAGAAAAA","GGCTGGGCGCAGTGGCTCACACCTGTAATCCCAGCACTTAGGGAAGCTGAGGCGAGTAGATCACCTGAGGTCAGGAGTTAGAGACCAGCCTGGCCATCATGGTGAAACCCCGTCTCTACTAAAGATACCAAAAATTAGCTGAGTGTGGTGCTGGGTGCCTGTAATCCCAGAAACTCAGGGTGCCTGTAATCCCAGCAACTCAGGGTGCCTTTAATCCCAGCAACTGAGGGTACCAGTAATCCCAGCAACTCAGGGTGTCTTTAATCCTAGCAACTGAGGGCACCTGTAATCCCAGCAACTCAGGAAGCTGAGACAGGAGAAGTACTTGAACCCAGAAGGCAGAGGTTGCAGTGAGCCGATATTGCACCATTGCACTCCAGTCTGGGCAACAAGAGTGAAACTCTGTCTCAAAAAAAAA"
"chr16","59738190","59738518","JH378138","4229795","4230103","67","55508395","TCACAGCATTTTGGGAGGCCAAGGCAGGCGGATCACCTGTGGTCAGGAGTTTGAGACCAGCCTGGCCAACATGGTGAAACCCCATCTCTACTAAAAATACAAAACAATTAGCCAGGTTTGGTGGCAGGCGCCTATAATCCCAGCTACTTGGGAGGCTGAGGCAGGAGAATCGCTTGAACCCAGGAGGCGGAGGTTGCAGTGAGCCGAGAACACACCATTGTACTCCAGCCTGCGACAAGAACGAAACTGTATCTCAATTAAAAAAAAAAAAAGAAAGGGAGGAAGGAAGGAAGGAAGGAAGGAAGGAAGGAAGGAAGAAAGAAAGAAAA","CACTTTGGGAGGTGAAGGCGGGCAGATCACCTGAGGTCAGGAGTTCGAGACCAGCCTGGCCAACATGGTGAAACCCCGCCTCTACTAAAAATACAAAAATTAGCCAGGTGTGACACTAGGCATCTGTAATCCCAGCTACTTGGGAGGCTGAGACAGGAGAATCACTTGAACCCAGGAGGCGGAAGTTGCAGTGAGCCAAGATCATGCCATTGCACTCCAGCCTGGGTGACAGGAGCAAAACTCTGTCTCAAAAAAAAAAAAAAAAAAAAAAAAAAAAAAAAAAAAAAAAGAAAAGAAAAGAAAAGTAAA"
"chr16","64682336","64682940","JH378118","18053084","18053501","253","46629252","GGCCGGGCACGGTGGCTCACTCCTGTAATCCCAGCACTTTGGGAGGGTGAGGCAGGTAGATCAAAAGGTCAGGAGTGGCCAGGCGTGGTGGCTCACACTTGTAATCCCAGCACTTTGGGAGGCCGAGATGGGCAGATCACGAGGTCAAGAGATTGAGACCATCCTGGCTAACATGGTGAAACCCCGTCTCTACTAAAAATACAAAAAATTAGCCGGGTGTGGTGGCAGGCGTCTGTAATCCCAGCCACTTGGGAGGCTGAGGCAGGAGAATCGCTTGAACCTGGGCGGCAGAGGTTGCATTGAGCCAGGATCGCGCCACTGCACTCCAGCCTGAGCAAAAAGAGCGAAACTCTGTCTCAGAAAAAAAAAAAAGTCAGGAGTTTGAGACCAGCCTGGCCAATATGGTGAAACCCCGTCTCTACTAAAAATACAAAAATTAGCCGAGCGTGGTGGTGGGTGCCTATACTCCCAGCTACTCAGGAGGCTGAGGCAGGAGAATCACTTGAACCCCAGGGGCAGAGGTTGCAGTGAGCCGAGATCGTGCCATTGCACTTCACCCTGGGTGAAAGAGCAAAACTCCGTCTCAAAAAAACAAAACAAAAAAA","GGCTGGGCGCAGTGGCTCACACCTGTAATCCCAGCACTTAGGGAAGCTGAGGCGAGTAGATCACCTGAGGTCAGGAGTTAGAGACCAGCCTGGCCATCATGGTGAAACCCCGTCTCTACTAAAGATACCAAAAATTAGCTGAGTGTGGTGCTGGGTGCCTGTAATCCCAGAAACTCAGGGTGCCTGTAATCCCAGCAACTCAGGGTGCCTTTAATCCCAGCAACTGAGGGTACCAGTAATCCCAGCAACTCAGGGTGTCTTTAATCCTAGCAACTGAGGGCACCTGTAATCCCAGCAACTCAGGAAGCTGAGACAGGAGAAGTACTTGAACCCAGAAGGCAGAGGTTGCAGTGAGCCGATATTGCACCATTGCACTCCAGTCTGGGCAACAAGAGTGAAACTCTGTCTCAAAAAAAAA"
"chr16","67872770","67873371","JH378118","18053084","18053501","260","49819686","GGCTGGGCATGGTGGCTCATGCCTGTAATCCCAGCACTTTGGGAGGCCAAGACGGGCAAATCACCTCAGGTCAGGAGATCGAGACCAGCCTGGCCAACACAGCAAAACCCACCTCTCTACTAAAAATAGAAAAATTACCCAGGCGTCACAGCTCACGCTTATAATCCCAGCACTTTGGGAGGCCGAAGCAGGTGGATCACAAGGTCAGGAGATCGAGACCAGCCTCACTAACATGGTGAAACCCCGTCTCTACTGAATATACGAAAAATTAGTCGGGTGTGGTGGCAGGCACCTGTAGTCCCAGCTACTTGGGAGGCTGAGGCAGGAGAATGGCTTTAACTCAGGAAGAGGAGCTTACGGTGAGCTGAGATTGTGCCACTGCACCCCAGCCTGGGCGACAGAGCAAGACTCCGTCAAAAAAAAAAAAAACCCCAAAACCCCAGCGTGGCAGCAGGTACCTGTAGTCCCAGCTACTCGGGAGGCTGAGACAGGAGAATGGCTTGAACCCGGGAGGCGGAGCTTGCGGTGAGCCAAGACGGCGCCACTTCATTCCAGCTATGGTGATAAGAGGGAGACCGTCTCAATCAATAAATTTAAAAAAA","GGCTGGGCGCAGTGGCTCACACCTGTAATCCCAGCACTTAGGGAAGCTGAGGCGAGTAGATCACCTGAGGTCAGGAGTTAGAGACCAGCCTGGCCATCATGGTGAAACCCCGTCTCTACTAAAGATACCAAAAATTAGCTGAGTGTGGTGCTGGGTGCCTGTAATCCCAGAAACTCAGGGTGCCTGTAATCCCAGCAACTCAGGGTGCCTTTAATCCCAGCAACTGAGGGTACCAGTAATCCCAGCAACTCAGGGTGTCTTTAATCCTAGCAACTGAGGGCACCTGTAATCCCAGCAACTCAGGAAGCTGAGACAGGAGAAGTACTTGAACCCAGAAGGCAGAGGTTGCAGTGAGCCGATATTGCACCATTGCACTCCAGTCTGGGCAACAAGAGTGAAACTCTGTCTCAAAAAAAAA"
"chr16","67970409","67971018","JH378118","18053084","18053501","252","49917325","GGGCGGGTGCGGTGGCTCACCCTGTAATCCCAGCACTTTCGGAGGCTTAAGCAGGCGGATCACCTGAGGTCAGGAGTTCGAGACCAGCCTGGCCAACATGGTGAAACCCCATCTCTACTAAAAATACAAAAAAATGGCCGGGTGCGGCGGCTCATGCCTGTCATCCCAGCACTTTCGGAGGCTGAGGCAGGCGGATCACCGGAGGTCAGGAGTTCGAGACCAGCTTGGCCAACATGGTGAAACCCCGTCTCTACTAAAAATACAAAAGTTAGCTGGGCATGGTGGCACATGCCTGTAATCCCAGCTACTCCGGAGGCTGAGGCAGGAGAATCACTTGAACCTGGGGAGGCGGAGGTTGCAGTGAGCTGAAATCACGGCATTGCACTCCAGCCTAGGCAACAGAGCGAAAGTCCGTCTCAGAAAAAAAAAAAAAAAAATTAGATGGGTTTGGTGGCGGGCGCGCTGTAATCCCAGCTACTTGGGAGGCTGGAGGCAGGAGAATCGCTTGAACTCAGGAGGCTGAGGTTACAGTGAGCCGAGATCATGCCATTGCACTCCAGCCTGGGCAATAAGAGTGAAACTCTGTCTCAAAAAACAACAACAACAAAAA","GGCTGGGCGCAGTGGCTCACACCTGTAATCCCAGCACTTAGGGAAGCTGAGGCGAGTAGATCACCTGAGGTCAGGAGTTAGAGACCAGCCTGGCCATCATGGTGAAACCCCGTCTCTACTAAAGATACCAAAAATTAGCTGAGTGTGGTGCTGGGTGCCTGTAATCCCAGAAACTCAGGGTGCCTGTAATCCCAGCAACTCAGGGTGCCTTTAATCCCAGCAACTGAGGGTACCAGTAATCCCAGCAACTCAGGGTGTCTTTAATCCTAGCAACTGAGGGCACCTGTAATCCCAGCAACTCAGGAAGCTGAGACAGGAGAAGTACTTGAACCCAGAAGGCAGAGGTTGCAGTGAGCCGATATTGCACCATTGCACTCCAGTCTGGGCAACAAGAGTGAAACTCTGTCTCAAAAAAAAA"
"chr16","68229729","68230314","JH378206","6546474","6546861","256","61683255","TGGTTTCCGCCTGTACTCCCAGCACTTTCGGAGGCTCAAGTGAGCAGATCGCTTGAGGCCAGGAGTTTAAGACCTACCTAGTCAACACCGGGGAAACCCACATCTCCACTAAACAATGGCCAGGAGCAGTGGCTCATACCTGTAATCACAACACTTTGGGATCCCAGCCAGACGGATCACAAAGTCAGGAGTTTGCGACCAGCCTATTAGAATGGTGAAACCCTGTCTCTACTAAAAATACAAAAAATTAGCCAGGCATGGTGGCGCATGCCTGTCATCCCAGCTACTCGGGAGGCTGAGGCAAGAGAATCACTTAAACCCAGGAGGCAGATGGAGGTTGCAGTGAGCCAAGATCACACCACTGCACTACAGCATGGGCGACAGAGCAAGACTCGGTCTCAAAAAAAAAAAAATTGGCCAGGCACGGTGGCTGACACCTGTAATCCCAGCACTTTGGGAGGCTGAGGCGGGAGAATCGCTTGAACCTGGGAGACGAAGGTTGCAGTGAGCCGAGACTAAGCCATTGCACCCCAACCTGGGCGGCAAGAGTGAAACTCTGTCTCAAAAAAAATTAAAAAATAAAAAA","GGCCACACATGGTGGCTAACGCCTGTAATCCCAGCACTTTGGGAGGCCAAGTCGGGTGGATCATGAGGTCAGGAGACCAAGACCATCCTGGCCAAATGGTGAAACCCCGTCTCTACTAAAAATACAAAAATTAGCTGGGCATGGTGGCGTGTGCCTGTAATCCCAGCTACTCAGGAGGCTGAGGCAGGACAATTGCCTGAACCCAGGAGAATTAGCTGGGCATGGTGGCGTGTGCCTGTAATCCCAGCTACTCAGGAGGCTGAGGCAGGACAATTGCCTGAACCCAGGAGGCGAAGGTTGCGGTGAGCCGAGATTGTGCCATTGCACTCCAGCCTGGGTAACAAGAGCGACACTCTGTCTCAAAAAAAAAAAAAAAAAAAAAAAAAAA"
"chr17","3506470","3507049","JH378118","18053084","18053501","238","14546614","CCTGTCATCCCAGCACTTTGGGAGGCCGAGGCGGGTAGATCACCTGAGGTCAGGAGTTTGAGACCAGCCTGGCCAACATGGCGAAACCCCGTCTCTACTAAAAATACAAAAACTGGCTGGGCGCGGTGGCTCACGCCTGTAATCCCAGCACTTTGGGAGGCTGAGGCGGGTGGATCATAAGGTCAGGAGTTCAAGACCAGCCTGGCCAACATGGTGAAACCCCATCTCTACTAAAAATACAAAAATTAGCCAGGTATGGTGGCAGGTGCCTGTAATCCCAGCTACTCAGGAGGCTGAGGCAGAGAATTGCTTGAACCCGGGAGGGGGAGGTTGCAGAGGGCCAAGATCGTACCACTATACTCCAGCCTGGGTGACAGGATGAGACTCCATCTTAAAAAAAAAAAAAAAAAAAAAAATTAGCCAGGCGTGGTGCGGGCACTTGTAATCCCAGCTATTCAGGAGGCTGAGGCAGGAGAATTGCTTGAACCCGGGAGGCAGAGGTTGCGGTGAGCTGAGATCGCACCATTGCACTCCAGCCTGGGCAACAAGAGTGAAACTCTGTCTCAAAAAAAAAACAAAA","GGCTGGGCGCAGTGGCTCACACCTGTAATCCCAGCACTTAGGGAAGCTGAGGCGAGTAGATCACCTGAGGTCAGGAGTTAGAGACCAGCCTGGCCATCATGGTGAAACCCCGTCTCTACTAAAGATACCAAAAATTAGCTGAGTGTGGTGCTGGGTGCCTGTAATCCCAGAAACTCAGGGTGCCTGTAATCCCAGCAACTCAGGGTGCCTTTAATCCCAGCAACTGAGGGTACCAGTAATCCCAGCAACTCAGGGTGTCTTTAATCCTAGCAACTGAGGGCACCTGTAATCCCAGCAACTCAGGAAGCTGAGACAGGAGAAGTACTTGAACCCAGAAGGCAGAGGTTGCAGTGAGCCGATATTGCACCATTGCACTCCAGTCTGGGCAACAAGAGTGAAACTCTGTCTCAAAAAAAAA"
"chr17","3641899","3642243","JH378198","5062782","5063109","59","1420883","GGCCAGGCACAGTGGCTCACACCTGTAATCCCAGCACTTCAGGAGGCCGAGGTGGGTAGATCACCTGAGGTCAGGGGTTTGAGACCAGCCTGACCGACGTGGCGAAACCCTGTCTCTACTACAAATACAAAAATTAGCCTTATGTGGTGGCGGGCACGTGTAATCCCAGCTACTTGGGAGGCTGAGGCAGGAGAATCGCTTGAATCTGGGAGGTGGAGGTTGCAGTGAGCCGAGATCACGCCATTGCACTCCAGCCTGGGTGACAAGAGCGAAACTCCATCTCAAAATAAATAAATACATACATACATGTATACATACATACATACATAAAAATAAAAAGTAAAA","GCCAGGCATGGTGGCTCACGCCTATAATCTCAGCACTTTGGGAGGCTGAGGCAGGCAGATCACTTGAGGTCAGGAGTTCAAGACCAGCCTGGCCAACATGGTGAAACCCTGGCTCTACTAAAAATACAAAAATTAGCCGGGTGTGGTGGCACGTGCCTATAATCCCAGCTACTCAGGAGGCTGAGGCAGAAGAATCGCTTGAATCCAGGAGGTGGAGGTTGCAGCGAGCCGAGATCACACCATTGGACTCCAGCCTGGGTGACAAGAGCGAAACTCCATCTCAAAATAAATAAATAAATACATAAAATTAAAAATAAATAAATAAATA"
"chr17","4508039","4508546","JH378206","6546474","6546861","194","2038435","GAGTTGGAGACCAGCCTGGCCAACACGGTGAAACCTCGTCCCCACTAAAAATATAAAAATTAGGCCAGGCGCGGTGGCTCACTCCTGTAATCCCAGCACTTTGGGAGGCTGAGGCGGGTAGATCATCTGAGGTCAGGAGTTCGAGACCAGCCTGGCCAACATGGTGAAACTCCGTCTCTACTAAAAATACAAAAATTAGCTGGGCTGGTAGCGGGCACCTGTAATCCCAGCTACTTGGAAGGGTGAGGCAGGAGAATCACTTGAACCCAGGAGGTGGAGGTTGCAGTGAGCCAAGATTGCAGCACTGTACTCCAGCCTGGGTGACAAAGCAAGACTCTGTCTCAAAAAAAAAAAAAAAAAAAAAGCCGGGCTTGGTGGTGAGTACCGGTAATCCCAGCTACTTGGAAGGCTGAGGCGGCGGACGTTGTACTTAGCCGAGATCATGCCATTGCACTCCAGCCTGGGTAACAGGCAAAAACTCTGTCTCAAAAAATAATAAATAATAAAA","GGCCACACATGGTGGCTAACGCCTGTAATCCCAGCACTTTGGGAGGCCAAGTCGGGTGGATCATGAGGTCAGGAGACCAAGACCATCCTGGCCAAATGGTGAAACCCCGTCTCTACTAAAAATACAAAAATTAGCTGGGCATGGTGGCGTGTGCCTGTAATCCCAGCTACTCAGGAGGCTGAGGCAGGACAATTGCCTGAACCCAGGAGAATTAGCTGGGCATGGTGGCGTGTGCCTGTAATCCCAGCTACTCAGGAGGCTGAGGCAGGACAATTGCCTGAACCCAGGAGGCGAAGGTTGCGGTGAGCCGAGATTGTGCCATTGCACTCCAGCCTGGGTAACAAGAGCGACACTCTGTCTCAAAAAAAAAAAAAAAAAAAAAAAAAAA"
"chr17","4560867","4561450","JH378118","18053084","18053501","257","13492217","GGCTGGGGGTGGTGTCTCTTGCCTGTAATCCCAACACTTTAGCAGGCTGAGGTGTGAGTATGGCTTGAGCCAGGAGTTCTAGACCAGCCTAGGAAACATGGCGAGATCCCTATCTCTACTAATACAAAAATTAGCCGGGCGTGGTGGCAAGCACCTGCAATCTCAGCTACTCGGGAGGCTGAGGTGGGAGGGCCGCTTGAGCCCAGGAGGTCCAGGCTGCAGTAAGCACTTATTTAAAAAAAAAAGAAGAGAAAAGATACAGAAATTAGCCAGGCGTGGTGGTGGGCACCTGTAATCCCAGCTACTCAGGAGGCTGAGGCAGGAAAATCACTTGAACCCGGGAGGCAGAGGTTGCAGTGGGCCGAGATCACACCATTGTACTCCAGCCTGGGCAACAAGAGCGAAACTCTGTCTCAAAAAAAAGAAAAGTAAAGTAAAGAAAAGATACAGAAATTAGCCAGGTGTGGTGGCGGGTGCCTGTAATCCCGCTACTTGGGAGGCTGAGGCAGGAGATTGCAGTGAGCCAAGATTGTGCCATTGCATTCCAGCCTGGGCAACAAGAGCAAAACTCCGCCTCAAAAAAA","GGCTGGGCGCAGTGGCTCACACCTGTAATCCCAGCACTTAGGGAAGCTGAGGCGAGTAGATCACCTGAGGTCAGGAGTTAGAGACCAGCCTGGCCATCATGGTGAAACCCCGTCTCTACTAAAGATACCAAAAATTAGCTGAGTGTGGTGCTGGGTGCCTGTAATCCCAGAAACTCAGGGTGCCTGTAATCCCAGCAACTCAGGGTGCCTTTAATCCCAGCAACTGAGGGTACCAGTAATCCCAGCAACTCAGGGTGTCTTTAATCCTAGCAACTGAGGGCACCTGTAATCCCAGCAACTCAGGAAGCTGAGACAGGAGAAGTACTTGAACCCAGAAGGCAGAGGTTGCAGTGAGCCGATATTGCACCATTGCACTCCAGTCTGGGCAACAAGAGTGAAACTCTGTCTCAAAAAAAAA"
"chr17","4846296","4846953","JH378118","18053084","18053501","290","13206788","GGCCAGGTGCAGTGGCTCACGCCTGTAATCCCAGCACTTTGGGAAGCCCAGGTGGGCGGATCACCCAAGGTCAGGGGTTCGAGACCAGCCTGGCCAACATGGTGAAACTCCATCTCTACTAAAAATAGAAAAAAATGGCCTGGTACGGTGGCTAACGCCTGTAATCCCAGCACTTTGGTAGGCCGAGGCAGGCAGATCACGAGGTCAGAAGATCGAGACCATCCTGGCTAACATGGTGAAACCCCGTCTCTACTAAAAATACAAAAAAGTAGCCAGGTGTGGTGGTGGGTGCCTGTAGTCCTAGCTACTCGGGAGGCTGAGGCAGGAGAATGCCGTGAACCCGGGAGGTGGAGCTTGCAGTGAGCTGAGATCACGCCACTGCACTCCAGCCTGGGTGACAGTGCGAGACTGTCTCCAAAAAAAAAAAAAAAAAAAAATTATATATATAATACACACACACACACACACACACACACACACACACAAATCAGCCAGGCGTGGTGGTGCGCACCTGTAATCCCAGCTACTCGGGAGGCTGAGGCAGGAGAGCTCCTCGAACCCAGGAGGCGAAGGTTGCAGTGAGCCGAGATCACACCATTGCACTCCAGCCTGGGCAACAAGAGCGAAACTCTGTCTCAAGGAAAAAAAAAAAAAAAAA","GGCTGGGCGCAGTGGCTCACACCTGTAATCCCAGCACTTAGGGAAGCTGAGGCGAGTAGATCACCTGAGGTCAGGAGTTAGAGACCAGCCTGGCCATCATGGTGAAACCCCGTCTCTACTAAAGATACCAAAAATTAGCTGAGTGTGGTGCTGGGTGCCTGTAATCCCAGAAACTCAGGGTGCCTGTAATCCCAGCAACTCAGGGTGCCTTTAATCCCAGCAACTGAGGGTACCAGTAATCCCAGCAACTCAGGGTGTCTTTAATCCTAGCAACTGAGGGCACCTGTAATCCCAGCAACTCAGGAAGCTGAGACAGGAGAAGTACTTGAACCCAGAAGGCAGAGGTTGCAGTGAGCCGATATTGCACCATTGCACTCCAGTCTGGGCAACAAGAGTGAAACTCTGTCTCAAAAAAAAA"
"chr17","6289040","6289368","JH378152","15932639","15932952","57","9643599","GGCTGGGCGTGGTGGCTCACGCCTGTAATCCCAGCACTTTGGGAGGCCAAGGTGGGTAGATCACCTGAGGTCAGGAGTTTGAGACCAGCCTGGCCAATGTGATGAAACCCTGTATCCACTAAAAAAAAAAAAAAAAAAAAAAAAAAAAATAGCTGGGTGAAGTGGCAAGCACCTGTAATCCCAGCTACTTGGGAGGCTGAGGCAGGAGAATCCCAGGAGGTGGAGATTGATCCCAGGAGGTGGAGGTTGCAGTGAGTCAAGATCATGCCATTGCACTCCAGCCTGGGTGACAAGAGCAAAATTCCATCTCAAAAAAAAAAAAAAGAAAA","GGCCGGGCATGGTGGCTCAAGCCTGTAATCCCAGCACTTTGGGAGGCCGAGGCGGGTGGATCACGAGGTCAAGAGATTGAGACCATCCTGGTCAACATGGTGAAACCCCGTCTCTACTAAAAATACAAAAAAAAAAAAAAAAAAAATAGCTGGGTGTGGTGGCGTGTGCCTGTAATCCCAGCTACTCAGGAGGCTGAGGCAGGAGAATTGCCTGAACCCGGGAGGCGGAGGTTGCGGTGAGCCGAGATCGCGCCATTGCACTCCAGCCTGGGTAACAAGAGCGAAACTCCGTCTCAAAAACAAAAAAAACAAAA"
"chr17","7490664","7491294","JH378118","18053084","18053501","283","10562420","GGCCGGGAGCGGTGGTTCACTCCTGTAATCCCAGCACTTTGGCAGACCGAGGAGGGTGGATCAACTGAGGTCAGAACTTCAAGACCAGCCTGCCGGGCACAGTGGCTCACACCTGTAATCCCAGCACTTTGGGAGGCTGAGGCAGGTGGATCACCCGAGGTCGGGAGTTCAAGACCAGCCTGACCAACGTGGAGAAACCCCGTCTCTACTAAAAATACAAAATTAGCTGGGGTGGTGGCACGTACCTGTAATCCCAGCTACTCGGGAGGCTGAGGCAAGAGAATCGCTTGAACCCGGGAGGCGGAGGTTGCGGTGCGCCGAGATCGCGCCATTACACTCCAGCCTGGGCAAAAAGAGCGAAACTCTGTCTCAAAAAATAAAAAAAGAAAAAGAAAAAGAAAAAGAAGTTCAAGACCAGCCTGGTCAACGTGGTGAAACCCCGTCTCTACTAAAAACACAAAAAAAATTAGGCGGGTGTTGTGGTGGGTGCCTGTAATCCCAGCTACTCAGGAGGCCAAGGCAGGAGAATCACCTGAACCCTGGAGGTGGAGGTTGCAGTGAGTCGAGATCGCACCATTGCACTCCAGCGTGGGTGACAGAGAGCGAGACTCCGTCTCAAAAAAAAAGAAAA","GGCTGGGCGCAGTGGCTCACACCTGTAATCCCAGCACTTAGGGAAGCTGAGGCGAGTAGATCACCTGAGGTCAGGAGTTAGAGACCAGCCTGGCCATCATGGTGAAACCCCGTCTCTACTAAAGATACCAAAAATTAGCTGAGTGTGGTGCTGGGTGCCTGTAATCCCAGAAACTCAGGGTGCCTGTAATCCCAGCAACTCAGGGTGCCTTTAATCCCAGCAACTGAGGGTACCAGTAATCCCAGCAACTCAGGGTGTCTTTAATCCTAGCAACTGAGGGCACCTGTAATCCCAGCAACTCAGGAAGCTGAGACAGGAGAAGTACTTGAACCCAGAAGGCAGAGGTTGCAGTGAGCCGATATTGCACCATTGCACTCCAGTCTGGGCAACAAGAGTGAAACTCTGTCTCAAAAAAAAA"
"chr17","9634166","9634493","JH378110","12773123","12773444","45","3138957","GGCTGGGTGCGGTGGCTCACGCCTGTAATCCCAGCACTGTGGGAGGCCGAGGCAGGTGGATCACCTGAGGTCAGGAGTTTGAGACCAGCTTGGCCAACATGGTGAAACCCTGTCTGCACTAAAAATACAAAAAAAAAAAAAAAAAAAAAAAAATTAGCTGGGTGTGGTGGCGGACGCCTATAATCCCAGCTACTGGGGAGGCTAAGGCAGGAGAATCGCTTGAACCTGGGAGGTGGAGATTGCAGTGAGCCAAGATGGTGCCATTGCACTCCAGCCTGGACAACAAGAGCGAAACTCGGTTTCAAAAAAAAAAAAAAAAAAAAAAAAA","GGCTGGGCGTGGTGGCTCATGCCTATAATCCCAGCACTTGGAGAGGCCAAAGCAGGCAGATTATTTGAGGTCAGGAGTTCCAAACCAGCCTGGCCAACATGGTGAAACCCTGTATCTACTAAAAATGCAAAAAAAAAAAAAAAAAAAAAAATTAGCTGGGCGTGGTGGCAGGTGACTGTATCCCAGTACTTGGTAGGCTGAGGCAGGAGAATTGCTTGAACCTGGGAGGTGGAGGTTGCAGTGAGCTGAGATTGTGCCATTGCACTCCAGCCTGGGCAACAAGAGCAAAACTCTGTCTCAAAAAAAAAAAAAAAAAAAAAAA"
"chr17","9636859","9637187","JH378193","2430153","2430476","55","7206706","GACACGGTAGCTCACGCCTGTAATCCCAGCACTTTGGGAGGTCGAGGCGGGTGGATCACCTGAGGTCAGGAGTTTAAGACCAGCCTGGCCAACATGGTGAAACCCCGTCTCTGCTAAAAATACAAGAATTAGCCAGGCGTGGTGGTGGGCGCCTGTAATCCCAGCTACTGGGGAGGCTGAGGCAGGAGAATCACTTGAACCCAGAAGGTGGAGGTTGCAGTGAGCCAAGACCACACCACTGGACTGCAGCCTGGCGGACAAGAGCGAGACTCTGTCTCAAAAACAACAACAACAACAACAACAACAACAAAAGAAAGAAAAGAAAAGAA","GGCCGGGCACAGTGGCTCAAGCCTGTAATCCCAGCACTTTGGGAGGCCGAGGTGGGTGGATCACGAGGTCAAGAGATCGAGACCAACCTGGTCAACATGGTGAAACCCCGTCTCTACTAAAAATACAAAAATTAGCTGGGCATGGTGGTGTGTGCCTGTAATCCCAGCTACTCAGGAGGCTGAAGCAGGAGAATTGCCTGAACCCAGGAGGAGGAGGTTGCGGTGAACCAAGATCACGCCATTGCACTCCAGCCTGGGTAACAAGAGCGAAACTCTGTCTCAAAACAAAACAAAACAAAACAAAACAAAACAAACAAAAAAAAA"
"chr17","9725612","9725938","JH378224","2846632","2846964","49","6878980","GGGCGTGGTGGCTCACACCTGTAATCCCAGCACTTTGGGAGGCCGAGGTGGGCGGATTGCCTGAGGTCAGGAGTTCGAGACCAGCCTGGCCAACCCGGTGAAACCCTGTCTCTACTAAAATACAAAAAAAAAAAAAAAAAAAAAAAAAAATTTAGCTGTGTGTGGTGGTGTGCACCTGTAATCCCAGCTACTCAGAAGGCTGAGGCAGGAGAATCGCTAGAACCCGGGAGGCGGAGGTTGCAGTGAGCCGAGATCGCACCATTACGCTCCAGCTTGGGCAACAAGAGTGAAACTCCATCTCAAAAACAAAACAAAACAAAACAAAAA","GGCCAGGCAGGGTGGCTTACATCTGTAATCCCAGCACTTTGGGAGGTCAAGGCGAGTGGATCACCTGAGGTCATGAGTTCAAGACCAGCCTGGCCAACTTGGTGAAACCCTGTCTCTACTAAAAATACAAAAAAAAAAAAAAAAAAAAAAAAAAAAATTAACTGGGTGTGGTGGTGCACACCTGTAATCCCAGCTACTCAGGAGGCTGAGGCAGGAGAATCCCTTGAACACGGGAGGTGGAGGTTGCAGTGAGCCGAGATCATGCCATTGCACTCCAGCCTTGGTGAAAAGAGCAAAACTCTGTCTTAAACAAAACAAAACAAAACCAGAAAA"
"chr17","11904179","11904388","JH378115","24252957","24253162","48","12348778","CCTGTCTTTACAAAAAATGCAAAAACAAAACAAAACAAAACAAAACAAAAACCGGGCATGGTGGTGAGCACCTGTAATCCCAGCTACTTGGGAGTTTGAGGCAGGAGAATCACTTGAACCTGGGAAGCGGAGGTTGCAGTGAGCCGAGACCGCGCCATTGCACTCCAGCCTGGGCAACAAGAATGAAACTCTGTCTCAAAAAAAAAAAAA","TGGTGAAACCCTGTCTTTACTAAAAATACAAAAAAAAAAAAAATTAGCTGGGCATGGTGGCACATGCCTGTAGTCCCAGCTGCTCGGGAGGCTGAGGCAGGAGAATTGCTTGAACCCAGGAGGCGGAGGTTGCAGTGAGCCGAGATCGAGCCATTGCACTCCAGCCTGGGCAACAAGAGCAAAACTCCGTCTCAAAACAAAATAAA"
"chr17","15884346","15884946","JH378118","18053084","18053501","249","2168738","GCCAGGCAGGTGGCTCAGGACTGTAATCCCAGCCTTTTGGGAGGCTGAGGCGAGTGGATCACCTGAGGTCAGGAGTTCGACACCAGCCTGGTCAACATGGTGAAACCCCGTCTCTACTAAAAAATACAAAAAATTGGCCAGGCGCAGTGTCTCACGCCTGTAATCCCAGCACTTTAGGAGGCTGAGGCAGGTGGATCACTTGGTCAGGAGATCGAGACCATCCTGGCCAACATGGTGAAACCCTGTCTCTATCAAAAATACAAAAATTAGCTGGGCGTGGTGGCATATGCCTATAATCCCAGCTACTTGGGACGCTGAGGCAGGAGAATCACTTGAACCAGGGAGTCAGAAGTTGCAGTGAGCCGAGATTGCGCCACTGCACCCCAGCCTGGTGACAGAGTGAGACTGTCTTAAAAAACAAAAAACAAAAAATTAGCCAGGTATGGTACCAGGTGCCTGTAACCCCAGCTACTTGGGAGGCTGAGGCAGGAGTATCGCTTGAACCCTGGAGGTGGAGGATGCAGTGAGCTGAGAGCACGCCATTGTACTCCAGCCTGGGCAACAAGAGTGAAACTCCATCTAAAATAAATAAAAATAAAAA","GGCTGGGCGCAGTGGCTCACACCTGTAATCCCAGCACTTAGGGAAGCTGAGGCGAGTAGATCACCTGAGGTCAGGAGTTAGAGACCAGCCTGGCCATCATGGTGAAACCCCGTCTCTACTAAAGATACCAAAAATTAGCTGAGTGTGGTGCTGGGTGCCTGTAATCCCAGAAACTCAGGGTGCCTGTAATCCCAGCAACTCAGGGTGCCTTTAATCCCAGCAACTGAGGGTACCAGTAATCCCAGCAACTCAGGGTGTCTTTAATCCTAGCAACTGAGGGCACCTGTAATCCCAGCAACTCAGGAAGCTGAGACAGGAGAAGTACTTGAACCCAGAAGGCAGAGGTTGCAGTGAGCCGATATTGCACCATTGCACTCCAGTCTGGGCAACAAGAGTGAAACTCTGTCTCAAAAAAAAA"
"chr17","16331846","16332458","JH378118","18053084","18053501","252","1721238","GGCCATGTGTGGTGGTTCACACCTGTAATCTCAGAACTTTGGGAGGCCGAGGTGGGTGGATCACCTGAGGTCAGGAGTTCGAGACCAGCCTGGCCAACATGGTGAAACCTCATCTCTACTAAAAATACAAAAAATTAAGGCCATACCCAGAGACTCATGCCTGTAATCCCAGCACTTTGGGAGGCTGAGGCGGATGGATCACTTGAGGTCAGGAGTTCAAAACCAGCCTGGCCAACATGGTGAAACCCCATCTCTACTAAAAATATAAAAATTAGCCGGGTGTGATGGCAGGCACCTGTAATCCCAGCTACTTGGGAGGCTGAGGCAGGAGAATTGCTTGAACCCAGGAAGCAGAGGTTGTGGTGAGCCGAGGTCGCGCCATTGCACTCCAGCCTGGGCAACAGAATGAGACTGTCTCAAAAAAAAAAAAAAAAAAAAATCAGCCAGGAGTGGTGGCGGGGGCACCTGTAATCCCAGCTACTCGGGAGGCTGAGGCAGGAGAATCGCTTGAACTCAGGAGGCAGAGGTTGCAGTGAGCTGATATCTCGCCATTGCACTCCAGCCTGGGCAACAAGAGTGAAACTGTCTCAAAAAAAAAAAAAAAAAAAAAGAA","GGCTGGGCGCAGTGGCTCACACCTGTAATCCCAGCACTTAGGGAAGCTGAGGCGAGTAGATCACCTGAGGTCAGGAGTTAGAGACCAGCCTGGCCATCATGGTGAAACCCCGTCTCTACTAAAGATACCAAAAATTAGCTGAGTGTGGTGCTGGGTGCCTGTAATCCCAGAAACTCAGGGTGCCTGTAATCCCAGCAACTCAGGGTGCCTTTAATCCCAGCAACTGAGGGTACCAGTAATCCCAGCAACTCAGGGTGTCTTTAATCCTAGCAACTGAGGGCACCTGTAATCCCAGCAACTCAGGAAGCTGAGACAGGAGAAGTACTTGAACCCAGAAGGCAGAGGTTGCAGTGAGCCGATATTGCACCATTGCACTCCAGTCTGGGCAACAAGAGTGAAACTCTGTCTCAAAAAAAAA"
"chr17","16464101","16464461","JH378293","1845184","1845523","61","14618917","GGCCGGGCGCCGTGGCTCACGCCTATAATCCCAGCACTTTGGGAGGCCGAGGCGGGTGGATCACCTGAGGTCAGGAGTTCGAGACCAGCCTGACCAACATGGTGAAACCCCCGTCTCTGCTAAAAAAAAAAAAATATATATATATATATATATAATATATAATATATATATATATATATATATAAAATAGCTGGGCATGGTGGCAGGCACCTGTAATCCCAGCTACTCAGGAGGCTGAGGCAGGAGAATCGCTTGAACCTGGGAGGTGGAGGTTGCAGTGGGCTAAGATCACACCATCGCACTCCAGCCTGGGCGACAGGAATGAAACGCTGTCTCAAAAAAAAAAAAAAAAAAAAAAAAA","GGCCGGGTGCGGTGGCTCACGCCTGTAATCCCAGCACTTTGGGAGGCCAAGGCGGGTGGATCACCTGAGGTCAGAAGTTCGAGACCAGCCTGGCCAACATGGTGAAACCCCGTCTCTGCTAAAAAGAAAAAAATAAGAAAAAAACAAAATAAGAAAATAATTTTAAAAAATACAAAATTAGCTGGGCGTGGTGGCAGGCACCTGTAATTCCAGCTATTCAGGAGGCTGAGGCAGGGGAATCACTTGAACCCAGGAGGCAGAGGTTGCAGTGAGCCAAGATGACGCCATTGCACACCAGCCTGGGCAACAAGAGTGAAACTCCGTCTCAAAAAAAAAACAA"
"chr17","16469420","16470033","JH378118","18053084","18053501","254","1583664","GCCAGGGGTGGTGGCTCATGCCTGTAATCCCAGCACTTTGGGAGGCTGAGGCGGGCAGATTGCCTGAGGTCAGGAATTCAAGACCAGCCTGGCCAACATAGTGAAACCCTGTCTCTACTAAAAATGCAAAGAATTAGCTGGGTGTTGGCCGGGCACGGTGGCTGACACCTGTAATCCCAGCACTTTGGGAGGCCTAGGCAGGCGGATCACCTGAGGTTGGGAGTTCGAGACCAGCCTGACCAACATGGAGAAACCCCGTCTCTACTGAAAATAAAAAACTAGCCAGGCATGGTGGCCCATGCCTGTAATCCCAGCTAATTGGGAGGCTGAGGCAGGAGAATCGCTTGAACCCAGGAGGCAGAGGTTGCGGTGAACCAAGATCGCATCAATGCACTCCAGCCTAGGCGACAAGAGCAAAACTCCGTCTCAAAAAAAAGAATTAGCTGGGTGTGGTGGGTGGGAACCTGTAATCCCAGTTACTAGGGAGGCTGAGGCAGGAGAATTGCTTGAACCCAGGAGGCGGAGGTTGTGGTGAGCCGAGATCGCGCCATTGCACTCCAGCCTGGACAACAAGAGCGAATCTCCGTCTCAAAAAAAAAAAAAAAAAAAAAAAA","GGCTGGGCGCAGTGGCTCACACCTGTAATCCCAGCACTTAGGGAAGCTGAGGCGAGTAGATCACCTGAGGTCAGGAGTTAGAGACCAGCCTGGCCATCATGGTGAAACCCCGTCTCTACTAAAGATACCAAAAATTAGCTGAGTGTGGTGCTGGGTGCCTGTAATCCCAGAAACTCAGGGTGCCTGTAATCCCAGCAACTCAGGGTGCCTTTAATCCCAGCAACTGAGGGTACCAGTAATCCCAGCAACTCAGGGTGTCTTTAATCCTAGCAACTGAGGGCACCTGTAATCCCAGCAACTCAGGAAGCTGAGACAGGAGAAGTACTTGAACCCAGAAGGCAGAGGTTGCAGTGAGCCGATATTGCACCATTGCACTCCAGTCTGGGCAACAAGAGTGAAACTCTGTCTCAAAAAAAAA"
"chr17","17534259","17534875","JH378118","18053084","18053501","268","518825","GGCTGGGGCGGTGGCTCACCTGTAATCCCAGCACTTTGGGAGGCAGAGGTGGGCGGATCGCCTGAGGTCAGAAGTTGGAGACCAGCCTGGCAACATGGTGAAACCCTGTCTCTACTAAAAAAAAAAAAAAAAAAAAAAAATGGCCGGGCATGGTGGCTCAAGCCTGTAATCCTAGCACTTTGGAAGGCTGAGGCGGGTGGATCACAAGGTCAGGAAATCGAGACCATCCTGGCTAACATGGTGAAACTCCGTCTCTACTAAAAATACAAAAAAAATTAGCCGGGCGTGGTGGTGGGTGCCTGTAGTCCCAGCTACTCGGGAGGCTGAGGCAGGCAAATGGAGTGAACCCGGGAGGCAAACTTGCAGTGAGCCAAGATGGCGCCATTGCACTCCAGCCTGGGCAACAAGAGCAAGACTCCTTCTCAAAAAAAAAAAAAATATATATATATATATATAGTCGGGCATGGTGGCAGGCACCTGTAATCCCAGCTACTCAGAGGCTGAGGCAGGAGAATCGCTTGAACCCTGGAGGTGGAGGTTGCAGTGAGCCAAGGTCATGCCATTGCACTCCAGCCTGGGCAACAAGAGCAAGACTCCGTCTCAAAAAAAAAAAAAAA","GGCTGGGCGCAGTGGCTCACACCTGTAATCCCAGCACTTAGGGAAGCTGAGGCGAGTAGATCACCTGAGGTCAGGAGTTAGAGACCAGCCTGGCCATCATGGTGAAACCCCGTCTCTACTAAAGATACCAAAAATTAGCTGAGTGTGGTGCTGGGTGCCTGTAATCCCAGAAACTCAGGGTGCCTGTAATCCCAGCAACTCAGGGTGCCTTTAATCCCAGCAACTGAGGGTACCAGTAATCCCAGCAACTCAGGGTGTCTTTAATCCTAGCAACTGAGGGCACCTGTAATCCCAGCAACTCAGGAAGCTGAGACAGGAGAAGTACTTGAACCCAGAAGGCAGAGGTTGCAGTGAGCCGATATTGCACCATTGCACTCCAGTCTGGGCAACAAGAGTGAAACTCTGTCTCAAAAAAAAA"
"chr17","17916069","17916669","JH378118","18053084","18053501","243","137015","GCCGGGTACAGTGGCTCACACCTGTAATCCTAGCACTTTGGGAGGCCGAGGCGGGTGGATCACCTGAGGTCAGGAGTTCGAGACCAGCCTGGCCAACATGATGAAACCCTACCTCAGCCAGGTACGGTGGTTCACGCCTGTAATCCTAGCACTTTGGGAGGCTGAGGCAGGTGGATTGCCTGAACTCAGGAGTTTGAGACCAGCCTGGGCAGCATGGTGAAACCCCATCTGTACTAAAATACAAAAACTTTGCTGGGCGTGGCGGCATGCACATGTAGTCCCAGTTACTTGGGAGGCTGAGGCAGGATAATTGTTTGAACCTGGGAGGCGGAGGTTGTACAGTGAGCCAAGATCGCGCCACTACACTCTAGCGTAGGTGACAGAGCGAGATTCCGCCTCCAAAAAAAAAAGAAACCCTGTCTCTACTAAAAATACAAACAATTAGCTGGGCGTGGTGGTGGGCGCCTGTAATCCCAGCTACTTAGGAGGCTGAAGCAGGAGAATCGCTTGAGCCCAGGAAGTGGAGGTTGCAGTGAGCTGAGATTGCTCCATTGCACTCTAGCCTGGGCAACAAGAGTGAAACTCTGTCTCAAAAAAAGAA","GGCTGGGCGCAGTGGCTCACACCTGTAATCCCAGCACTTAGGGAAGCTGAGGCGAGTAGATCACCTGAGGTCAGGAGTTAGAGACCAGCCTGGCCATCATGGTGAAACCCCGTCTCTACTAAAGATACCAAAAATTAGCTGAGTGTGGTGCTGGGTGCCTGTAATCCCAGAAACTCAGGGTGCCTGTAATCCCAGCAACTCAGGGTGCCTTTAATCCCAGCAACTGAGGGTACCAGTAATCCCAGCAACTCAGGGTGTCTTTAATCCTAGCAACTGAGGGCACCTGTAATCCCAGCAACTCAGGAAGCTGAGACAGGAGAAGTACTTGAACCCAGAAGGCAGAGGTTGCAGTGAGCCGATATTGCACCATTGCACTCCAGTCTGGGCAACAAGAGTGAAACTCTGTCTCAAAAAAAAA"
"chr17","18237318","18237912","JH378118","18053084","18053501","239","184234","GGCCATGCGTGGTGGCTCACGCCTGTAATCCCAGTACTTTGGGAGGCTGAGGTGGGAGGATCACCTGAGGTCAGGAGTTCGAGACCAGCCTGGCCAACATGATGAAACCCTGTCTCTACTAAAAATGCAAAAAATTGGCCGGGCACGGTGGCTCACGCCTGTAATCCCAGCACTTTGGGAGGCCAAGGCGGGTGGATCACAAGGTCAGGAGCTTGAGACCAGCCTGGCCAATATGGTGAAACCCCATCTCTACTAAAAATACAAAAATTAGCCAGGCGTGGTGGTACACACCTGTAGTCCCAGCTACTCGGGAGGCTGAGGCAGGAGAATTGCTTGAACTCAGGAGGCAGAGGTTGCAGTGAGCTGAGATGGTGCCACTGCACTGCAGCCTGGGCAACAGAGTGAGACTTCATCTCAAAAAAAAAAAAAAAATTAACCGGGTGTGGTGGCACGTGCCTATGGTCCCAGCCACTGGGGAGGCTGAGGCAGGAGAATCGCTTGAACACAGGAGGCAGAAGTTGCAGTGAGCTGAGATTGCACCACTGCACTCCAGCCTGGGTGACAAGAGTGGAACTCCATCTCAAAAAAAAAAGAA","GGCTGGGCGCAGTGGCTCACACCTGTAATCCCAGCACTTAGGGAAGCTGAGGCGAGTAGATCACCTGAGGTCAGGAGTTAGAGACCAGCCTGGCCATCATGGTGAAACCCCGTCTCTACTAAAGATACCAAAAATTAGCTGAGTGTGGTGCTGGGTGCCTGTAATCCCAGAAACTCAGGGTGCCTGTAATCCCAGCAACTCAGGGTGCCTTTAATCCCAGCAACTGAGGGTACCAGTAATCCCAGCAACTCAGGGTGTCTTTAATCCTAGCAACTGAGGGCACCTGTAATCCCAGCAACTCAGGAAGCTGAGACAGGAGAAGTACTTGAACCCAGAAGGCAGAGGTTGCAGTGAGCCGATATTGCACCATTGCACTCCAGTCTGGGCAACAAGAGTGAAACTCTGTCTCAAAAAAAAA"
"chr17","18951167","18952093","JH378118","18053084","18053501","537","898083","GGCCAGGGGCAGTGGCTCATGCCTGTAATCCCAGCATTTTGGGATGCCAAGGCTGGTGGATCAACTGAGGTCAGGAGTTTCAGACCACCCTGGCCAACATGGCGAAATCCCATCTCTACTAAAAATACAAAAATTAGGCCAGGCACAGTGGCTCATGCCTGTAATCCCAGCACTTTGAGAGGCCAAGGCGGGCGATCACGAGGTCAGGAGATTGAGACCATCCTGGCTAACACGGTGAAATCCTGTCTCTACTAAAAAAAAAAAATACAAAAAATTAGCCGGGACGTGGTGGCTGGCACCTGTAGTCCCAGCTACTCGGGAGGCTAAGGCAGGAGAATGGCATGAACCCGGGAGATGGAGCTTGCAGTGACCCGAGATCGCGTCACTGCACTCCAGCCTGAACAACAGAGCAAGACTATATCTCAAAAAAAAAAAAAAAAAAAAGGCCGGGTGCAGTGGCTCACGTCTGTAATCCCAGCACTTTGGGAGGCCGAGGTGGGTGGATCACGAGGTCAGGAGATCGAGACCATCCTGGCTAACATGATGAAACCCCATCTCTACTAAAAAATACAAAAAATTAGCCGGGTGTGGTGGCAGGCACCTGTAGTCCCAGCTACTCGGGAGGCTGAGGCAGGAGAATGGCATGAACCTGGGTAGTGGAACTTGCAGTGAGCCGAGATCACGCCACTGCACTCCAGCCTGGGCGACAGAGCGAGACTCTGTCTCAAAAAAAAAAAAAAAAAAAAAATTAGCCGGGCATGGTGGTGGGTGCCTGCAATCCCAGCTAGTCAGGAGGCTGAGGCTGGAGAATCCCTTGAACCCAGGAGGTAGAGGTTGCAGTGAGCCAAGATCACGCCATTGCATTCCAGCCTGGGCAACAAGAGTGAAATTCTGTCTCAAAAAAATAAACAAACAAGTAAAATAAAA","GGCTGGGCGCAGTGGCTCACACCTGTAATCCCAGCACTTAGGGAAGCTGAGGCGAGTAGATCACCTGAGGTCAGGAGTTAGAGACCAGCCTGGCCATCATGGTGAAACCCCGTCTCTACTAAAGATACCAAAAATTAGCTGAGTGTGGTGCTGGGTGCCTGTAATCCCAGAAACTCAGGGTGCCTGTAATCCCAGCAACTCAGGGTGCCTTTAATCCCAGCAACTGAGGGTACCAGTAATCCCAGCAACTCAGGGTGTCTTTAATCCTAGCAACTGAGGGCACCTGTAATCCCAGCAACTCAGGAAGCTGAGACAGGAGAAGTACTTGAACCCAGAAGGCAGAGGTTGCAGTGAGCCGATATTGCACCATTGCACTCCAGTCTGGGCAACAAGAGTGAAACTCTGTCTCAAAAAAAAA"
"chr17","20996420","20997041","JH378118","18053084","18053501","266","2943336","GGCTAGGCGCGGTGGTTCACACCTGTAATCCCAGCACTTTGGGAGGCCAAGGTGGGTGGATCACCTGTGGTCAGGAGTTCGAGACCAGCCTGGCCAACATTGTGAAACCCCGTCTCTACTAAAAATGCAAAAAATTAGCTGGGCGACCAGTCATGGTAGCTCACGCCTGTAATCCTAGCACTTTGGGAGGCCAAGGCGGGTGGATTGCCTGAGCTCAGGAGTTAGAGGCCAGCCTGGGCAACATGGTAAAACCCTGTCTCTACTAAAATACAAAAAAAAAAAAAAAAATTAGCTGGGTGTGACAGCGTGCATCTGTAATCCCGGTTACTTGGGAGGTTGAGGCAGGAGAATTCCTTGAACCTAGGAGGCGGAGGTTACAGTTAGCCGAGATCACGCCATTGCACTCCAGCCTGGGCAACAGAGCGAGACTCCATCTCAAAAAAAAAAAAAAAAATTCAGCTGGGCGTGGTGGCGGGCACCTGTGATCCTAGCTACTCAGGAGGCTGAGGCAGGAGAATCATTTGAACTCCGGAGGCGGAGGTTGCAGTGACCCTAGATCGCACCATTGTGTTCCAGCCTGAGCAACAAGAGCGAGACGCCATCTGAAAAAAAAAAAAAGAAA","GGCTGGGCGCAGTGGCTCACACCTGTAATCCCAGCACTTAGGGAAGCTGAGGCGAGTAGATCACCTGAGGTCAGGAGTTAGAGACCAGCCTGGCCATCATGGTGAAACCCCGTCTCTACTAAAGATACCAAAAATTAGCTGAGTGTGGTGCTGGGTGCCTGTAATCCCAGAAACTCAGGGTGCCTGTAATCCCAGCAACTCAGGGTGCCTTTAATCCCAGCAACTGAGGGTACCAGTAATCCCAGCAACTCAGGGTGTCTTTAATCCTAGCAACTGAGGGCACCTGTAATCCCAGCAACTCAGGAAGCTGAGACAGGAGAAGTACTTGAACCCAGAAGGCAGAGGTTGCAGTGAGCCGATATTGCACCATTGCACTCCAGTCTGGGCAACAAGAGTGAAACTCTGTCTCAAAAAAAAA"
"chr17","21298865","21299429","JH378206","6546474","6546861","222","14752391","GGCCGAGGCAGGTGGATCACCTGAGGTCAGGAGTTCAAGACTAGTCTGGCCAACATGGTGAAACCCTGTCTCTACTAAAAATACAAAAAATTGGCCGGGCGCGGTGGCTCATGCCTGTAATCCCAGCACTTTGGGAGGCTGAGGCGGGTGGATCACGAGGTCGGGAGATCGAGACCATCCTGGCTAACACAGTTAAACCCTTTCTCTACTAAAAAATACAAAAAATTAGCCGGGCGTAGTGGGGGGCGCCTGTAGTCCCAGCTACTCAGGAGGCTGAGGCAGGAGACTGGCGTGAACCCGGGAGGCAGAGCTTGCAGTGAGCTGAGATCACGTCACTGCATGCCAGCCTGGGCGACAGAGCGAGACTCTGTCTCAAAAAAAAAAAATTAGCCAGGCATGGTGGTGTACACCTGTAATCCTAGCTACTCGGGAAGCTGAGCAGGAGAACAGCTTGAACCCAGGAGGCAGAGGTTGCAGTGAGCTGAGATCACGCCATTGCACTCCAGCCTGGGCAACAAGAGTGAAACTCCGTCTCAAAAAAAAAAAAAGAAAAGAAAAAAGAAAA","GGCCACACATGGTGGCTAACGCCTGTAATCCCAGCACTTTGGGAGGCCAAGTCGGGTGGATCATGAGGTCAGGAGACCAAGACCATCCTGGCCAAATGGTGAAACCCCGTCTCTACTAAAAATACAAAAATTAGCTGGGCATGGTGGCGTGTGCCTGTAATCCCAGCTACTCAGGAGGCTGAGGCAGGACAATTGCCTGAACCCAGGAGAATTAGCTGGGCATGGTGGCGTGTGCCTGTAATCCCAGCTACTCAGGAGGCTGAGGCAGGACAATTGCCTGAACCCAGGAGGCGAAGGTTGCGGTGAGCCGAGATTGTGCCATTGCACTCCAGCCTGGGTAACAAGAGCGACACTCTGTCTCAAAAAAAAAAAAAAAAAAAAAAAAAAA"
"chr17","21663027","21663921","JH378118","18053084","18053501","517","3609943","TTGGGAGGCCAAGGTGGGCCTCCCAGACACGTGAGGTCAGGAGTTTGAGACCAGCCTGGACAATATGGCGAAACCCCATCTCTACTAAAAAAACACAAAAATTGGTTGGGCCGGGCACGGTGGCTCACGCCTGTAATCCCAGCACTTTGGGAGGCCGAAGTGGGCAGATCACGAGGTCAGGAGATCGAGATCATCTTGGCTAACATGGTGAAACTCCGTCTTTACTTAAAATACAAAAAATTAGCTGGGCATGATGGCAGGCAGTTGGAGTCCCAGCTACTTGGGAGGCTGAGGCAGGAGAATCGCTTGAACCCGGGAGGCAGAGGTTGCAGTGAGCTGAGATCGTGCCATTGCACTCCAGCCTGGGTGACAGAATGAGACTCCGTCTGAAAAAAAAACAAAAAACAAAAAACAAAAATTGGCCAGGTGCGGTGGCTCACGCCTGTAATCCCAGAACTTTGGGAGGCCGAGGCAGGTGGATCATGAGGTCAGGAGTTCAAGACCAGCCTGGCCAAGATGGTGAAACCCCATCTCTACTAAAAATACAAAAATTAGGCGGGCACGGTGGCAGGTGCCTGTAATCTCAGCTACTCAGGAGGCTGAGGCAGGAGAATTGCCTGAAGCCGGGTGGCAGAGGTTGCAGAGAGCTAAGATCACGCCACTGCACTCCAGCCTGGGTGATAGAGTAAGACTCTATCTCAAAAAAAGAAAAAAAAAAATAGCCGGGCATTGTGCTGGGCGCCTGTAATCCCAGCTACTTGGGAGGCTGAGACAAGAGAATCACTTGAACCTGGGAGGCGGAGGTTGCAGTGAGCCGAGATCGTGCCATTGCACTCCAGCCTGGGTGAGAAGAGCAAAACTCTGTCTCAAAAAAACAAAAAAAGAAGAAAACAAA","GGCTGGGCGCAGTGGCTCACACCTGTAATCCCAGCACTTAGGGAAGCTGAGGCGAGTAGATCACCTGAGGTCAGGAGTTAGAGACCAGCCTGGCCATCATGGTGAAACCCCGTCTCTACTAAAGATACCAAAAATTAGCTGAGTGTGGTGCTGGGTGCCTGTAATCCCAGAAACTCAGGGTGCCTGTAATCCCAGCAACTCAGGGTGCCTTTAATCCCAGCAACTGAGGGTACCAGTAATCCCAGCAACTCAGGGTGTCTTTAATCCTAGCAACTGAGGGCACCTGTAATCCCAGCAACTCAGGAAGCTGAGACAGGAGAAGTACTTGAACCCAGAAGGCAGAGGTTGCAGTGAGCCGATATTGCACCATTGCACTCCAGTCTGGGCAACAAGAGTGAAACTCTGTCTCAAAAAAAAA"
"chr17","21688652","21689276","JH378118","18053084","18053501","258","3635568","GGCCGGGTGCCATGGCTCACGCCTATAATCCCAGCACTTTGGGAGGCCAAGGTGGGCGGATCACCTGAGGTCAGGAGTTTGAGACCAGCCTGGCCAACATAGTGAAACCCCGTCTCTACTAAAAATACGAAAAGTTAGCTGGGGGTGCAGTGGCTCACACCTGTAATTCCAGCACTTTGGGAGGCCGAGGCAGGTGAATCACGAGGGGAGGAGTTTGAGACCAGCCTAACCAATATGTTGAAACCCCGTTTCTACTAAAAATACAAAAATTAGCTGGGCGTGGTGGCACGTGCCTATAATCCCAGCTACTCAGGAGGCTGAGGCAGGAGAATCGCCTGAACCTGGGAGGCGGAGGTGGCAGTGAGCCAAGATCACACCACTGCACTTTAGCCTGGGTGACAGAGGGAGACTCTGTCTCAAAAAACAAAACAAAACAAAACAAAAAATTAGGCAGGCTTGGTGGCACATGCCTGTAATCCCAGCTACTCAGGAGGCTGAGGCAGGAGAATTGCTTGAACCCAGGAGGCAGAAGTTGCAGTGAGCTGAGATCGCGCCATTGCACTCCAGCCTGGGTAACAAGAGTGAAACTCCATCTCAAAAAAAAAAAAAAAAAAAAAAAAAAAAA","GGCTGGGCGCAGTGGCTCACACCTGTAATCCCAGCACTTAGGGAAGCTGAGGCGAGTAGATCACCTGAGGTCAGGAGTTAGAGACCAGCCTGGCCATCATGGTGAAACCCCGTCTCTACTAAAGATACCAAAAATTAGCTGAGTGTGGTGCTGGGTGCCTGTAATCCCAGAAACTCAGGGTGCCTGTAATCCCAGCAACTCAGGGTGCCTTTAATCCCAGCAACTGAGGGTACCAGTAATCCCAGCAACTCAGGGTGTCTTTAATCCTAGCAACTGAGGGCACCTGTAATCCCAGCAACTCAGGAAGCTGAGACAGGAGAAGTACTTGAACCCAGAAGGCAGAGGTTGCAGTGAGCCGATATTGCACCATTGCACTCCAGTCTGGGCAACAAGAGTGAAACTCTGTCTCAAAAAAAAA"
"chr17","22129020","22129352","JH378128","1602813","1603145","53","20526207","GCCAGGCACGGTGGCTCACACCTGAATTCCAGTACTTTGGGAGGCCGAGGCGGGCGGATCTCTTGAGGTCAGGAGTTTGAGACCAGCCTGGCCAACATGGTGAAACCCCATCTCTACTAAAAATACAAAAATTAGCCGGGCGTGGTGGCAGGTGCCTGTAATCCCAGCTACTTGGGAGGCTGAGGCAGGAGAACCTCTTGAACCCAGGAGGTGGAGGCTGCAGTGAGCTGAGATTGTGCCACTTCACTCCAGCCTGGAAGACAAGAGCAAGACTTCATCTCAAAAAAAAATAAAAAAAAAATAAATAAATAAATAAATAAAAATTTAAAAAAA","GGCCAGGTGCAGTGGCTCACGCCTGTAATACCAGCATTTTGGGAGGCCGAGGCAGGTGGATCACGAGGTTAGGAGTTTGAGACCAGCATGGCCAACATGGAGAAACCCCGTCTCTACTAAAAATACAAAAATTAACCAGGCATGGTGGCAGGTGCCTGTAATTCCATCTACTCGGGAGGCTGAGGCAGGAGAATCCCTTGAACCTGGGAGGCGGAGGTTGCAGTGAGCCGAGATTGTGCCATTGCACTCAGTCTGGGTGACAAAAACAAGACTCCATCTCAAAAAAAAAAAAAAGAAAAGAAAAAGAAAAAAAGAAAGAAAGAAAGAAAGAAA"
"chr17","22130129","22130738","JH378118","18053084","18053501","262","4077045","GGCTGGGCACAGTGGCTCACGCCTGTAATCTCAGCACTTCGGGAAGCCGAGGCGGGCAGATCAGCTGAGGTCAGGAGTTCAAGACCAGCCTGGCCATGGCAAAACCCTGTCTCTACTAAAAAATGCAAAAAATAGGGGCCAGGCACGGTGGCTCACGCCTGTAATCCCAGCATTTTGGGAGGCCAAGGCAGGCGGATCACAAGGTCAGGAGGTTGAGACCATCCTGGCCAACATGGTGAAACCCCATCTCTACTAAAAATACAAAAATTAGCTGGGTGTGGTGGCCTGTGCCTGTAATCCCAGCTACTTGGGAGGCTGAGGCAGGGGAATCACTTGAATCCAGGAGACAGAGGTTGTAGTGAGCTGAAATGGAGCCACTGCACTCCAGCCTGGCGGCAGAGCGAGACTCTGTCTCAAAAAAAAAAAAAATACAAAAAATAGCTAGGTGTGATGGTGGGCACCTGTAATCCCAGCTACTTGGGTAGCCGAAGCAGGAGAATCGCTAGAACCTGGGAGGTGGAGGTTTAGTAAGCTGAGATCACACCATTGCACTCCAGCCTGGGTATCAACAGCGAAACTCCATCTCAAAAAAAAAAAAAAAAAAAGAAAA","GGCTGGGCGCAGTGGCTCACACCTGTAATCCCAGCACTTAGGGAAGCTGAGGCGAGTAGATCACCTGAGGTCAGGAGTTAGAGACCAGCCTGGCCATCATGGTGAAACCCCGTCTCTACTAAAGATACCAAAAATTAGCTGAGTGTGGTGCTGGGTGCCTGTAATCCCAGAAACTCAGGGTGCCTGTAATCCCAGCAACTCAGGGTGCCTTTAATCCCAGCAACTGAGGGTACCAGTAATCCCAGCAACTCAGGGTGTCTTTAATCCTAGCAACTGAGGGCACCTGTAATCCCAGCAACTCAGGAAGCTGAGACAGGAGAAGTACTTGAACCCAGAAGGCAGAGGTTGCAGTGAGCCGATATTGCACCATTGCACTCCAGTCTGGGCAACAAGAGTGAAACTCTGTCTCAAAAAAAAA"
"chr17","23633062","23633662","JH378118","18053084","18053501","247","5579978","GGCCAGGCGTGGTGGCTTACGCCTGTAATCCCAGCATTTTGGGAAGCTGAGGCAGGTGGATCACCTGAGGTCAAGAGTTCAAGACCAGCCTGGCCAACATGGTGAAACCCCGTCTCTACTGCAAATACAAAAAATTAGTAGCCGGGCATGGTGGCTCACGCCTGTAATCCCAACACTTTGGTAGGCCAAGGCGGGTGGATCACCTGAGGTCGGGAGTTCGAGACCAGCCTGACCAACATGGAGAAACCCCGTCTCTACTAAAAGTACAAAATTAGCCAGGGATGGTGGCATGTGCCTGTAATCCCAGCTATTTGGGAAGCTAAGGCACAAGAATCGCTTTGAACCTGGGAGACAGAGGTTGCAGTGAGCTGAGATCGCACCATTGCACTCCCGCCTGGGCAACAAGAGCGAAACTCCATCTAAAAAAAAAAAAAAAAAAAAAAAAGCCAGGCATGGTGACAGGCACCTTGTAATCCCAGCTACTCGGAAGGCTGAGGCAGGAGAATCGCTTGAACACTGCAGAGGTTGCAGTGAGCTGAGATCACGCCATTGCACTGCAGCCTAGGCAACAAGAGTGAGACTCTATCTCAAAAAAAAGAAA","GGCTGGGCGCAGTGGCTCACACCTGTAATCCCAGCACTTAGGGAAGCTGAGGCGAGTAGATCACCTGAGGTCAGGAGTTAGAGACCAGCCTGGCCATCATGGTGAAACCCCGTCTCTACTAAAGATACCAAAAATTAGCTGAGTGTGGTGCTGGGTGCCTGTAATCCCAGAAACTCAGGGTGCCTGTAATCCCAGCAACTCAGGGTGCCTTTAATCCCAGCAACTGAGGGTACCAGTAATCCCAGCAACTCAGGGTGTCTTTAATCCTAGCAACTGAGGGCACCTGTAATCCCAGCAACTCAGGAAGCTGAGACAGGAGAAGTACTTGAACCCAGAAGGCAGAGGTTGCAGTGAGCCGATATTGCACCATTGCACTCCAGTCTGGGCAACAAGAGTGAAACTCTGTCTCAAAAAAAAA"
"chr17","34071612","34072215","JH378118","18053084","18053501","250","16018528","GGCCAGGTGTGGTGCCTTACATCTGTAATTCCAGCACTTTGGGAGGCTGAGGTGGGTGGATCACCTGAGGTCAGGAGTTCAGGACCAACCTGGCCAACATAGTGAAACCCCGTCTCACTAAAAATACAAAAATTAAAAAGAAAGAAAGAAAAAAGCCAGGTGCGGTGGCTCACACCTGTAACCCCAGCACTTTGGGAGGCCAAGATGGGCGGATCACCTGAGGTCGGGAGTTTGAGACCAGCCTGACCAACATGGAGAAACCCCGTCTCTACTAAAAATACAAAATTAACCAGGCGTGGTGGTGCATGCCTGTAATCCCAGCTACTTGGGAGGATGAGGCAGGAGAATCGCTTGAACCCTGGAGGCGGAGGTTGTGGTGAGCTGAGATCATGCCATTGCACTCCAGCCTAGGCAACAAGAGCGAGACTCCATCTCAAAAAAAAAAAAAAAATTGGGCATGGTGGTGCATGCCTGTAATCCCAGCTACTCAGGAGTCTAAGGCAGGAGAATCACTTGAACCCAGGAGGCAGAGGTTGCAGTGAGCTGAGATCACGCCATTGCACTCCAGCCTGAGCGACAAGAGTGAAACTACGTCTCAAAAAAA","GGCTGGGCGCAGTGGCTCACACCTGTAATCCCAGCACTTAGGGAAGCTGAGGCGAGTAGATCACCTGAGGTCAGGAGTTAGAGACCAGCCTGGCCATCATGGTGAAACCCCGTCTCTACTAAAGATACCAAAAATTAGCTGAGTGTGGTGCTGGGTGCCTGTAATCCCAGAAACTCAGGGTGCCTGTAATCCCAGCAACTCAGGGTGCCTTTAATCCCAGCAACTGAGGGTACCAGTAATCCCAGCAACTCAGGGTGTCTTTAATCCTAGCAACTGAGGGCACCTGTAATCCCAGCAACTCAGGAAGCTGAGACAGGAGAAGTACTTGAACCCAGAAGGCAGAGGTTGCAGTGAGCCGATATTGCACCATTGCACTCCAGTCTGGGCAACAAGAGTGAAACTCTGTCTCAAAAAAAAA"
"chr17","34329459","34330029","JH378119","32351107","32351490","237","1978352","GGCCAGGTGCCGTGGCTCACACATGTAGTCCCAGCACGTTGGGAGGCTGAGGTTAATGGATCACCTGAAGTCACAAGTTCGAGACCAGCCTGACCAACATGGTGAAACCCTGTCTCTACTAAAATATAAAAAGTAGTCGGCCGGGCGCAGTTGCTCATGCCTGTGATCGCCTGAGGTCAGGATTTCAAGCCCAGCCTGGCCAAAATGGTGAAACCCCATCTCTACTAAAAATATAAAAATTAGCCAGGCATGGTGGCAGGTGCCTGTAATCCCAGCTACTCAGGAGGTTGAGGCAGGAGAATCACTTGGACCCAGGGGGCAGAGGTTGCAGTGAGCCAAGATCACAGCATCGCACTCCAGCTTAGGCAACAAGAGAGAAACTCCATCTCAAAAAAAACCCAAAAAAAACAAAAAAACAAAAAAACCCAGGCATGGTGGCAGGCGTCTGTAATCTCAGCTACTCGGGAGGCTGAGGCAAGAGAATCGCTTGAACCTGGGAGGCAGAGGTTGCAGTGAGCCAAGATCATGCCATTGCACTCCAGACTGAGCAATAAGAGCGAAACTCCATCTC","GGCCAGGTATGGTGGCTCACACCTGTAATCCCAGCACTTTGGGAGGCCAAGGCAGGCAGACCACCTGAGGTCAGGAGTTCGAGATCAGCCTAGCCAACATGGTGAAACCCCATCTCTAGTAAAAATAAAATTAGCCAGGCATGGTGGTGCATGCCTGTAACGCAGGTCAGGAGTTCGAGATCAGCTTAGCCAACATGGTGAAACCCCATCTCTAGTAAAAATAAAATTAGCCAGGCAGGTGGTGCCGCCTGTACTCGGGAGGCTGAGGCAGGAGAATCACTTGAACCCAAGAGGCAGAGGTTGCAGTCAGCCAAGATCATGCCATTGCACTCCAGCCTAAGCAAAAAGAGTAAAACTCAGTCTCAAAACAAAAAAACAAAAAAA"
"chr17","35196292","35196625","JH378228","5665092","5665424","47","29531200","GGCTGGGCATGGTGTCTTACGCCTGGAATCCCAGCACTTTGGGAGGCCAAGGCGGGTGGATCACCTGAGGTCAGGAGTTTGAGACCAGCCTGGCCAACATGTTGAAACTCTGTCTCTACTAAAAATACAAAAATTAGCCGGGCATGGTGGCGGATGCCTGTAATCCCAACTACGTGGGAGGCTGAGGCAGGAGAATCGCTTGAACCCAGGAGATGGAGGTTGTGGTGAGCCGAGATCATGCCATTGCACTCCAGCCTGGGCAACAAGAACAAAACTCTGTCTCAAAATAAATAAAAAAATAAATAAATAAATAAAAACAACAACAACAACAAAA","GGCCGGGCGCGGTGGCTCAAGCCTGTAATCCCAGCACTTTGGGAGGCTGAGGCGGGTGGATCACGAGGTCAAGAGATCGAGACCATCCTGGTCAACATGGTGAAACCCTGTCTCTACTAAAAATACTAAAAATTAGCTGGGCATGGTGGCGTGTGCCTGTAATCCCAGCTACTCAGGAGGCTGAGGCAGGAGAATTGCCTGAACCCAGGAGGCGGAGGTTGCGGTGAGCCGAGATCGCGCCATTGCACTCCAGCCTGGGCAACAAGAGCGAAACTCTGTCTCAAAAAAAAAAAATAAATAAATAAAATAAAATAAAATAAAATAAAATAAAAT"
"chr17","40291413","40291755","JH378144","13229286","13229620","52","27062127","GGCCAGGCACAGTGGCTCATGCCTGTAATCCCAGCACTTTGCGAGGCTGAGCCAGGTGGATCACCTGAGGTCAGGAGTTCAAGAGCAGCCTGGCCAACATGGTGAAACCCCGTCTCTACTAAAAATACAAAAATTATCTGGAGTGGTGGTAGGTGCCTATAATTGCAGATACACAGAAGGCTGAGACAGGAGAATTGCTTGAACCCAGGAGGCGGAGGTTGCTGTGAGCCGAGATCGCGCCATTGCACCCCAGCCTGGGAGACAAGAGCGAAACTCCATCTCAATAAATAAATACATACATACATACATACATACATGCATACATACATAAAATAAAATAAAA","GGCCGGGCGCGGTGGCTCAAGCCTGTAATCCCAGCACTTTGGGAGGCCGAGGCGGGTGGATCACCTGTGGTCAGGAGTTCAAGACAGCTTGGTCAACATGGTGAAACCCCGTCTCTACCAAAAATACAAAAAATTAGCTGGGCATGGTAGCGCATGCCTGTAATCCCAGCTACTCAGGAGGCTGAGGCAGGAGAATTGCCTGAACCCAGGAGGCAGAGGTTGCGGTGAGCCGAGATCGCGCCATTGCACTCCAGCCTGGGTAACAAGAGCGAAACTCCCTCTCATAAAAAATAAATAAATAAATAAATAAATAAATAAATAAATAAATAAATAAA"
"chr17","45148344","45148987","JH378206","6546474","6546861","299","38601870","GGCTTGGTGCCATGGTTCATGCCTGTAATCCTGGCACTTTGGGAGGCCGAGGTGGGCAGATCACTTGAGCTCAGGAGTTCAAGACCACCTTGGGCGACATGGTGAAACCTCATCTCTCCTTAAAAAAAAAAAAAACAGCCGGGCGCGGTGGCTCACACCTGTAATCCCAGCACTTTGGGAGGCCAAGGCGGGTGGGGTTCATGAGGTCAGAAGATCGAGACCATCCTGGCTAACACGGTGAAACCCCGTCTCACTAAAAATAGAAAAAACTAGCCGGGCGTGGTGGCGGGCACCTGTAGTCCCAGCTACTCGGGAGGCTGAGGCAGGAGAATGGCGTGAACCCGGGAGGCGGAGCTTGCAGTGAGCTGAGATCTTGCCATTGCACTCCAGCCTGGGCAACAAGAGTGAAACTCTGTCTCAAAAAAAAAAAATTAAAAAAACAAATAAAAATAAAAATACATAATTAGCAGGACATGGTGGCACATGCCTGTAATCCCCAGCTACTCGGGAGGCTGAGGCATGGGAATTGTTTAAACCTGTGAGGCGGTGGTTGCAGTGAGCCAAGATCAAGCCATTGCACTCCAGCCTGGGCAACAAGAGTGAAACTCCATCTCAAAAAAAAAAAAAAAAAAGAGAAAAGAAAA","GGCCACACATGGTGGCTAACGCCTGTAATCCCAGCACTTTGGGAGGCCAAGTCGGGTGGATCATGAGGTCAGGAGACCAAGACCATCCTGGCCAAATGGTGAAACCCCGTCTCTACTAAAAATACAAAAATTAGCTGGGCATGGTGGCGTGTGCCTGTAATCCCAGCTACTCAGGAGGCTGAGGCAGGACAATTGCCTGAACCCAGGAGAATTAGCTGGGCATGGTGGCGTGTGCCTGTAATCCCAGCTACTCAGGAGGCTGAGGCAGGACAATTGCCTGAACCCAGGAGGCGAAGGTTGCGGTGAGCCGAGATTGTGCCATTGCACTCCAGCCTGGGTAACAAGAGCGACACTCTGTCTCAAAAAAAAAAAAAAAAAAAAAAAAAAA"
"chr17","47866693","47867898","JH378118","18053084","18053501","809","29813609","GGCTGGGCTTGGTGGCTCATGCCTATAATTCTAGGACTTTGGGAGGCCAAGGCGGATGGATCACCTGAGGTCAAGAGTTGGAGACCAACCTGTCCAACATGGTGAAACCCCCTCTGTACTAAAAATACAAAAATTGGCCGAGCGTAGTGGCTCATGCCTGTGATCACAGCACTTTGAGAGGCTGAGGCGGGCGGATCACAAGGTCAGGAGATCAAAACCATCCTGGCTAACAAGGTGAAACCCCATCTCTGCTAAAAAATAACAGGGCGTGGTGGCACACGGCTGTAGTCCCAGCTACTTGGGAAGCTGAGGCAGGAGAATCGCTTGAACCTGAGAGGCAGAGGTTGCAGTGAGCTGAGATCAGGCCACTGCTCTCCAGCCTGGGCAACAGAGTGAAACTCCATCTCAAAAAAAAAAAGAAAAAGGCCAGGCATGGTGGCTCACGCCTGTAATGCCAGCACTTTGGAAGACTAAGTTGGGCAGATCACAACATCAGAAGATGGAGACCATCCTGGCTAACACGGTGAAACCCCGTCTCTACTAAAAATACAAAAAAAAAAAAAAAAAAAATTAGCCGGGCGTGGTGACATGCGCCTGTAATCCTAGCTACTCCGGAGGCTGAGGCAGGAGAATGGCGTGAACCCGGGAGGCGGAGCTTGCAGTGAGCCGAGATGGTGCCACTGCACTCCAACCTGGGCGACAGAGCGAGACTCTGTCTCAAAAAAAAAAAAAAAAAAGAAAAAAGGTCGGGCGCAGTGGCTCACACCAGTAATCACAGCACTTTGGGAGGCCGAGGCGGGTGGATCACCTGAGCTCGGGAGTTCAAGACCAGCCTGACCAACATGGTGAAACTCCGTCTCTACTAAAAATACAAAATATTAGCCGGGCGTGGTGGCGCGTGCCTGTAATCCCAGTTACACGGGAGGCTGAGGCAGGAGAATCACTTGAACTTGGGAAGTGGAGGTTGTGGGAGCCGAAATCGTGCCATCGCATTCCACAAGAGTGAAACTCCATTTCAAAAAAAAAAAATACAAAAATTAGCTGGGCGTGGTGGCGGGCGCCTTTAATCCCAGGGGCTCGGGAGGCTGAGGCAGGAGAATCGCTTGAACCTAGGAGGCAGAGGTTGCAGTGTGCCAAGATGACACCATTGCACTCCAGGCTGGGCAAGAGAGCAGTAACTCCCGTCTCAAAAAAAAAGAAGGAAAA","GGCTGGGCGCAGTGGCTCACACCTGTAATCCCAGCACTTAGGGAAGCTGAGGCGAGTAGATCACCTGAGGTCAGGAGTTAGAGACCAGCCTGGCCATCATGGTGAAACCCCGTCTCTACTAAAGATACCAAAAATTAGCTGAGTGTGGTGCTGGGTGCCTGTAATCCCAGAAACTCAGGGTGCCTGTAATCCCAGCAACTCAGGGTGCCTTTAATCCCAGCAACTGAGGGTACCAGTAATCCCAGCAACTCAGGGTGTCTTTAATCCTAGCAACTGAGGGCACCTGTAATCCCAGCAACTCAGGAAGCTGAGACAGGAGAAGTACTTGAACCCAGAAGGCAGAGGTTGCAGTGAGCCGATATTGCACCATTGCACTCCAGTCTGGGCAACAAGAGTGAAACTCTGTCTCAAAAAAAAA"
"chr17","48059944","48060302","JH378108","45564157","45564495","64","2495787","GGCCGGGCGCAGTGGTTCATGCCTGTAATCCCAACACTTTAGGGGGCTGAGGCAGGTGGATCACCTGAGGTCAGGAGTTCAAGACCAGCCTGGCCAACATGGTGAAAGCCCATCTCTACTAAAAATACAAAAAATTAGCTGGGCATGGTGGTGCGTGCCTGTAATCCCAGCTACTTGGGATGCTGAGGCAGGAGAATCGCTTGAACCCGGGAGGTGGAGGCTGCAGTGAGCTGAGATTGTGCCATTGCACTCCAGCCTGGGCAACAAGAGTGAAACTCCATCTAAAAAAAAAAAAGAAGAGGAGGAGGAGGAGGAGGGGGAGGGGGAGGAGGAGGAGGAGGAGAAGAAGAAAAAAGAAA","GCTAGGCAAGGTGGCTCATGCCTGTAATCCCAACATTTTGGGAGGCCGAGGCAGATGGATCACCTGAGGTTAGGAGTTCAAGACCAGCCTGGCCAACATGGTGAAACTCCATCTCTACTAAAAATACAAAAAATTAGCTTGGCACGGTGGTGGGTGCCTCTAATCCCAGCTGCTTGGGAGGCTGAGGCAGGAGAATCGCTTGAACTCAGGAGGTGGAGGTTGCAGTGAGCCAAGATCATGGCATTGCACTCCAGCCTGGGCGACAAGAGCGAGACTCCCTCTAAGAAAGAAAAGAAAGAAAAGAAAAGAAAAAAGGAAAGGAAAGGAAAGAAAGAGAAA"
"chr17","50365982","50366602","JH378118","18053084","18053501","274","32312898","GGCAAGGCGTGGTGGCTGATGTCTGTAATCCCAGCAATTTGGGGGGCTGAGGTGGATGGATCACCTGAGATCAGAAGTTCGAGACTAGGCTAGCCAACATAGTGAAACCCCATCTCTACTAAAAATATAAAAAGTTAGCCAGGCGCGGTGGTTCATGCCTGTAATCCCAGCACTTTGGGAGGCCGAGGTAGGTGGATCACAAGGTCAGGAGTTCAAGACCAACCTGGCCAAGATAGTGAAACCTCATCTCTACTAAAAATACAAAAATTAGCTGGGCGTGGTGGCAACCACCTATGATCCCAGCTACTTGGGAGGCTGAGGCAGAGAACTGCTTGAACCCAGGAAGTGGAGGTTGTAGTGAGCCAAGATTGCATCACTGTACTCCAGCCTGGGCAACAGAGCAAGACTCCATCTCAAAAAAAAAAAAAAAAAAAATACAAAAAATTAGCCAGGCGTGGTGGCAGGCACCTGTAATCCCAGCTACTCGGAAGGCTGAGGCAGGAGAATTGCTTGAACCTGGGAGGTAGAGGTTGCAGTGAGCTGAGATTGTGCCATTGCACTCTAGCCTATGTGACAAGAGCGAAACTCCATCTCAAAAAAAAAAAAAAAAAAGAAAGAAAA","GGCTGGGCGCAGTGGCTCACACCTGTAATCCCAGCACTTAGGGAAGCTGAGGCGAGTAGATCACCTGAGGTCAGGAGTTAGAGACCAGCCTGGCCATCATGGTGAAACCCCGTCTCTACTAAAGATACCAAAAATTAGCTGAGTGTGGTGCTGGGTGCCTGTAATCCCAGAAACTCAGGGTGCCTGTAATCCCAGCAACTCAGGGTGCCTTTAATCCCAGCAACTGAGGGTACCAGTAATCCCAGCAACTCAGGGTGTCTTTAATCCTAGCAACTGAGGGCACCTGTAATCCCAGCAACTCAGGAAGCTGAGACAGGAGAAGTACTTGAACCCAGAAGGCAGAGGTTGCAGTGAGCCGATATTGCACCATTGCACTCCAGTCTGGGCAACAAGAGTGAAACTCTGTCTCAAAAAAAAA"
"chr17","50542261","50542886","JH378206","6546474","6546861","277","43995787","GCCGGGCGCTGTGGCTCAAGCCTGTAATCCCAGCATTTTGGGAGACTAAGGGAAGCAGATCCTGTGAGCTCAGGATTTCGAGACCAGCCTGGCCAACATGGTGAAACCCTGTCTCTACAAAAATTAGCCATGCCGGGCACGGTGGCTCACGCCTGTAATCCCAGCACTTTGGGAGGCTGAGGCGGGCGGATCACAAGGTCAGGAGTTTGAGACCATCCTGCCTAACACGGTGCAACCCCGTCTCTACCAAAAATACAAAAAATTAGCTGGGCGTGGTGGCGGGTGCCTGTAGTCCCAGCTACTCGGGGGGCTGAGGCAAGAGAATGGCATGAACCTGTGGGGCGGAGCTTGCTGTGAGCCGATATCCTGCCACTGCACTCCAGCCTGGGCGACAGAGCGAGACTCCATCTCAAAAAAAAAAAAAAAAAAAAAAAAAAAAAAAAATGAGCCAGCTGTGGTGGCGTGTGTGCCTGTAATCCCAGCTACTCGGGAGGCTGAGGCAAGAGAATCACTTGAATCTGGGAGGCAGAGGTTGCAGTGAGCCAAGATCATGCTATTGCACTTCAGCCTGGGCAACAAGAGTGAAACTCTGTCTCAAAAAAAAAAAAAAAAAAAAAGAAAAAGAA","GGCCACACATGGTGGCTAACGCCTGTAATCCCAGCACTTTGGGAGGCCAAGTCGGGTGGATCATGAGGTCAGGAGACCAAGACCATCCTGGCCAAATGGTGAAACCCCGTCTCTACTAAAAATACAAAAATTAGCTGGGCATGGTGGCGTGTGCCTGTAATCCCAGCTACTCAGGAGGCTGAGGCAGGACAATTGCCTGAACCCAGGAGAATTAGCTGGGCATGGTGGCGTGTGCCTGTAATCCCAGCTACTCAGGAGGCTGAGGCAGGACAATTGCCTGAACCCAGGAGGCGAAGGTTGCGGTGAGCCGAGATTGTGCCATTGCACTCCAGCCTGGGTAACAAGAGCGACACTCTGTCTCAAAAAAAAAAAAAAAAAAAAAAAAAAA"
"chr17","51121894","51122508","JH378118","18053084","18053501","260","33068810","GGCTGGGTGCAGTGGCTCATGCCTGTATTCCCAACACTTTGAGAGGCCAAGGCGGGCAGATCACCTGAGGTCAGGAATTCGAGACCAGCCTGGCTAACATGGCGAAACCCTGTCTCTATTAAAAACACAAAAATTAGGCCAGGCACGGTGGCTCACACCTGTAATCCCAGCACTTTGGGAGGCTGAGGCGGGCAGATCACGAAGTCAGGAGATCGAGACCATCCTGGCTAACATGGTGAAACCCTGTCTCTGCTAAAAATACAAAAAAAATAGCGGGGCGTGGTGGCAGGCGCCTGTAGTCCCAGCTACTCAGGAGGCTGAGGCAGGAGAATGGCGTGAACCTGGGAGGCGGAGGTTGCAGTGAGCCGAGATCGCGCCACTGCACTACAGCTTGGGTGACAGAGCGAGACTCTGTCTCAAAAAAAAAAAAAAAAGTTAGTCGGGCATGGTGGTGGGCTCCTGTATTCCCAGCTACTCAGGAGGCTGAGGTGGGAGAATCACTTGAACCTGGAAGGCAGAGGTTGCTGTGAGCCAAGATTGCACCATTGCATTCCAGCCTGGGTGACAAGAGCAAAACTCTGTCTCAAAAAATATATATAAAATAATAAAAATAAA","GGCTGGGCGCAGTGGCTCACACCTGTAATCCCAGCACTTAGGGAAGCTGAGGCGAGTAGATCACCTGAGGTCAGGAGTTAGAGACCAGCCTGGCCATCATGGTGAAACCCCGTCTCTACTAAAGATACCAAAAATTAGCTGAGTGTGGTGCTGGGTGCCTGTAATCCCAGAAACTCAGGGTGCCTGTAATCCCAGCAACTCAGGGTGCCTTTAATCCCAGCAACTGAGGGTACCAGTAATCCCAGCAACTCAGGGTGTCTTTAATCCTAGCAACTGAGGGCACCTGTAATCCCAGCAACTCAGGAAGCTGAGACAGGAGAAGTACTTGAACCCAGAAGGCAGAGGTTGCAGTGAGCCGATATTGCACCATTGCACTCCAGTCTGGGCAACAAGAGTGAAACTCTGTCTCAAAAAAAAA"
"chr17","51573403","51574012","JH378118","18053084","18053501","260","33520319","GGCCGGGTGTGGTGGCTCACGCCTATTATCCCAGCAGTTTGGGAGGCCAAGTGGGGGTTGGATCACCTGAGGTCAGGGGTTCGAGACCAGCATGGCCAACATGGTGAAAACCCATCTATACTAAAGATACAAAAAATTAGGCTGGGCACAGTGGCTCATGCCTGTAATCCCAGCACTTTGGGAGGCCAAGGATCACGAGGTCAGGAGATCGAGACCATCCTGGCTAACACAGTGAAACCCCGTCTCTACTAAAAATACAAAAAAATTAGCCGGGAGTGGTGGCAAGTGCCTGTAGTCCCAGCTACTCAGGAGGCTGAGGCAGGTGAATAGTGTGAACGCAGGAGGCAGAGCTTGCAGTGAGCCGAGATCGTGCCACTACACTCCAGCCTGGGCGACAAGGTGAGACAACGTCTCAAAAAAAAAAAAAAAAAAAAGCCGGGCATGGTGGGAGGCACCTGTAATTCCACCTACTTGGGAGGGTGAGGCAGGAGAATTGCTTGAATCTGGGAGATGGAGGTTGGAGTAAGCCAAGTTCGCACCATTGCACTCCAGCCTGGGTGACAAGAGCGAAACTCTTGTCTCAAAAAAAAAAAAAAAAAAAAAAAAAAAA","GGCTGGGCGCAGTGGCTCACACCTGTAATCCCAGCACTTAGGGAAGCTGAGGCGAGTAGATCACCTGAGGTCAGGAGTTAGAGACCAGCCTGGCCATCATGGTGAAACCCCGTCTCTACTAAAGATACCAAAAATTAGCTGAGTGTGGTGCTGGGTGCCTGTAATCCCAGAAACTCAGGGTGCCTGTAATCCCAGCAACTCAGGGTGCCTTTAATCCCAGCAACTGAGGGTACCAGTAATCCCAGCAACTCAGGGTGTCTTTAATCCTAGCAACTGAGGGCACCTGTAATCCCAGCAACTCAGGAAGCTGAGACAGGAGAAGTACTTGAACCCAGAAGGCAGAGGTTGCAGTGAGCCGATATTGCACCATTGCACTCCAGTCTGGGCAACAAGAGTGAAACTCTGTCTCAAAAAAAAA"
"chr17","51598763","51599361","JH378118","18053084","18053501","241","33545679","GCCGGGCGTGGTGACTCACGCCTGTAATACCAGCACTTTAGGAGGCTGAGGTGGGTGGATCACCTGAGGTCAGGAGTTCGAGACCGGCCTGGCCAACATGGTGAAATCCTGTCTCTACTAAAAATACAAAAAAATGGCCAGGCGTGGTGGCTCACGCCTGTAATCCTAGCACTTTGGGCGGCCCAGGTGAGTGGATCACGAGGTCAGGAGATCGAGACCATCCTGGCTAACATGGTGAAACCCCATCTCTACTAAAAAACTACAAAAAAATTAGCTGGGCGTGGTGGCAGGCGCCTGTAGTCCCAGCTACTCGGGAGGCTGAGGCAGGAGAATGACGTGAACCCGGGAGGCGGAGCTTGCAGTGAGCAGAGCTTGAGCCACTGCACTCCAGCTTGGGCGACAGAGTGAGACTCCGTCTCAAAAAAAAAAAAAAAAAAATTAGCTGGGGATGGTGGCGGGCACCTGTAATCCCAGCTACTCTGGAGGCTGAGACAGGAGAATCGCTTGAACCCAGGAGGCGGAGGTTGCAGTGAGCTGAGATCGTGCCATTGTACTCCAGCCTGGGCAACAAGAGTGAAACTCAATCCGAAGAAAAAAAA","GGCTGGGCGCAGTGGCTCACACCTGTAATCCCAGCACTTAGGGAAGCTGAGGCGAGTAGATCACCTGAGGTCAGGAGTTAGAGACCAGCCTGGCCATCATGGTGAAACCCCGTCTCTACTAAAGATACCAAAAATTAGCTGAGTGTGGTGCTGGGTGCCTGTAATCCCAGAAACTCAGGGTGCCTGTAATCCCAGCAACTCAGGGTGCCTTTAATCCCAGCAACTGAGGGTACCAGTAATCCCAGCAACTCAGGGTGTCTTTAATCCTAGCAACTGAGGGCACCTGTAATCCCAGCAACTCAGGAAGCTGAGACAGGAGAAGTACTTGAACCCAGAAGGCAGAGGTTGCAGTGAGCCGATATTGCACCATTGCACTCCAGTCTGGGCAACAAGAGTGAAACTCTGTCTCAAAAAAAAA"
"chr17","51738482","51739094","JH378118","18053084","18053501","257","33685398","GCCGGGTGCGGTGGCTCACACCTGTAATCCCAGCACTTTGGGAGACTGAGGCGGGAGGATCACCTGAGGTCAGGAGTTCGAGACCAACCTGACCAACATGGTAAAACCCTGTCTGTACTAAAACTACAAAAAATTAGGCCAGGCGCAGTGGTCCATGCCTGTAATCCCAGCACTTTGGGAGGCCAAGGTGGGCGGATCATGAGGTCAGGAGTTTGAGACCAGCCTGGCCAACATAGTGAAACCCTGTCTCTACTAAAAACACAAAAATTAGTCGGGCATGGTGGCGGATGCCTGTAATCTCAGCTACTCAGGAGGTTGAGGCAGGAGAATCACTTGAACCCGGGAGGTGGAGGTTGCAGTGAGCCAAGATCACGCCACTGTACTCCAGCCTGGGCAACAGAGCGGGACTCCATCTTAAAAAAAAAAAAAAAAAAATTAGCCAGGCGTGGTGGCGCATGCCTGTAGTCCCAGCTACTTAGGAGGCTGAGGCAGGAGAATTGCTTGAACCCGGGAGGCAGAGGCTGCAGTGAGCCAAGACCACGCTATTGCATTCCAGCCTGGGTGACAAGAGCAAAACTCTGTCTCAAAAAACAAAACAAAACAAACAAAAAAA","GGCTGGGCGCAGTGGCTCACACCTGTAATCCCAGCACTTAGGGAAGCTGAGGCGAGTAGATCACCTGAGGTCAGGAGTTAGAGACCAGCCTGGCCATCATGGTGAAACCCCGTCTCTACTAAAGATACCAAAAATTAGCTGAGTGTGGTGCTGGGTGCCTGTAATCCCAGAAACTCAGGGTGCCTGTAATCCCAGCAACTCAGGGTGCCTTTAATCCCAGCAACTGAGGGTACCAGTAATCCCAGCAACTCAGGGTGTCTTTAATCCTAGCAACTGAGGGCACCTGTAATCCCAGCAACTCAGGAAGCTGAGACAGGAGAAGTACTTGAACCCAGAAGGCAGAGGTTGCAGTGAGCCGATATTGCACCATTGCACTCCAGTCTGGGCAACAAGAGTGAAACTCTGTCTCAAAAAAAAA"
"chr17","52245950","52246538","JH378118","18053084","18053501","254","34192866","TGTAATCCCAGCACTTTGGGAAGCCAACGCGGGTAGATCAGCTGAGGTCAGGAGCTCGAGACCAGCCTGGCCAACTGGTGAAACCCCATCTCTACTAAAAAAAATACAAAAAAATGGCCCAGCGCGGTGGCTCACACCTGTAATCCCAGCACTTTGGGAGGCCGAGGCGGGCAGATCACGAGGTCAGGAGATCGAGACCATCCTGGATAATACGGTGAAACCCCGTCTCTACTAAAAATACAAAAAAAAATTAACCGGGTGTGGTGGCGGGCGCCTGTAGTCCCAGCTACTAGGGAGGCTGAAGCAGGAGAATGGCGCGAAACCGGGAGGCGGAGCTTGCAGTGAGCCAAGACAGGCCACTGCACTCCAGCCTGGGCGACAGAGCGAGACTCCATCTCAAAAAAACAAAAAACAAAAAAATTAGCCAGCTGTGGTGGTGGGCGCATGTAATCCCAGTTACTTGGGAGGCTGAGGCAGGAGAATTGCTTGAAACCAGGAGGCAGAGGTTGCAGTGAGCCAAGATTACGCCATTGTACTCCAGCCTGGGCAACAAGGGCAAAACTCTGTCTCAACAAAAAAAAAGAAAAAA","GGCTGGGCGCAGTGGCTCACACCTGTAATCCCAGCACTTAGGGAAGCTGAGGCGAGTAGATCACCTGAGGTCAGGAGTTAGAGACCAGCCTGGCCATCATGGTGAAACCCCGTCTCTACTAAAGATACCAAAAATTAGCTGAGTGTGGTGCTGGGTGCCTGTAATCCCAGAAACTCAGGGTGCCTGTAATCCCAGCAACTCAGGGTGCCTTTAATCCCAGCAACTGAGGGTACCAGTAATCCCAGCAACTCAGGGTGTCTTTAATCCTAGCAACTGAGGGCACCTGTAATCCCAGCAACTCAGGAAGCTGAGACAGGAGAAGTACTTGAACCCAGAAGGCAGAGGTTGCAGTGAGCCGATATTGCACCATTGCACTCCAGTCTGGGCAACAAGAGTGAAACTCTGTCTCAAAAAAAAA"
"chr17","52264620","52265210","JH378118","18053084","18053501","242","34211536","GGCCACATGTGGTGGCTCACACCTGTAATCCCAGCACTTTGGGAGGCCAAGGCAGGCAGATCACCTGAGATCAGAAGTTCAAGACCAGCCTGGCCAATGTGGTGAAACCCTGTCTCTACTAAAAATAGAAAAAACACAGCCAGGCGCGGTAGCTCACACCTGCAATCCCAGCACTTTGGGAGGCCGAGGCAGGCAGATCACGAGGTCAGGAGATTGAGACCACGGTGAAACCCCATCTCTACTAAAAATACAAAAAATTAGCTGGGCATGGTGGCGGGCACCTGTAGTCCCAGCCACTTGGGAGGCTGAGGCAGGAGAATGGCGTGAACTCGGGAGGTGGAGCTTGCAGTGAGCAAAATTGCGCCACTGCACTCCAGCCTGGGCAACAGAGCAAGACTCCGTCTCAAAAAAAAAAAAAAAAAAAAATTAGCCGGCGTAGTGGCAAGCTCCTGTAATCCCAGCTACTTGGGAGGCTGAAGCAGGAGAATCGCTTGAACCCAGGAGGTGGAGGTTGCAGTGAGCCGAGACTGCGCCATTGCACTCCAGCCTGGGCAACAAGAATGAAACTCCGTCTCAGAAAAGAAAAAAAAA","GGCTGGGCGCAGTGGCTCACACCTGTAATCCCAGCACTTAGGGAAGCTGAGGCGAGTAGATCACCTGAGGTCAGGAGTTAGAGACCAGCCTGGCCATCATGGTGAAACCCCGTCTCTACTAAAGATACCAAAAATTAGCTGAGTGTGGTGCTGGGTGCCTGTAATCCCAGAAACTCAGGGTGCCTGTAATCCCAGCAACTCAGGGTGCCTTTAATCCCAGCAACTGAGGGTACCAGTAATCCCAGCAACTCAGGGTGTCTTTAATCCTAGCAACTGAGGGCACCTGTAATCCCAGCAACTCAGGAAGCTGAGACAGGAGAAGTACTTGAACCCAGAAGGCAGAGGTTGCAGTGAGCCGATATTGCACCATTGCACTCCAGTCTGGGCAACAAGAGTGAAACTCTGTCTCAAAAAAAAA"
"chr17","52281488","52282107","JH378118","18053084","18053501","287","34228404","GGCCAGGCGCGGTGGCTCACGCCTGTAATCCCAGCACTTTGGGAGGTCAAGGCGGGTGGATCACCTGAGGTCAGGAGTTCAAGACCAGCCTGGCCAACATGATGAAACTTCATCTTGGCCGGGCGCGGTGGCTCATGCTTGTAATCCCAGCACTTTGGGAGGCCAAGGCAGGCGGCGGATCATGAGGTCAGGAGATTGAGACCATCCTGGCTAAAACGGTGAAACCCCGTCTCTACTAAAAATACAAAAAAAAAAAAATTAGCCGGGCGTGGTGGCAGGCGCCTGTAGTCCCAGCTACTCGGGAGGCTGAGGCAGGAGAATGGCGTGAACCCGGGAGGCGGAGCTTGCAGTGAGCCGAGATAGCACCACTGCAGTCCGGCCTGGGTGAAAGAGTGAGACTCCGTCTCAAAAAAAAAAAAAAAGAAGAAAGAACTTCGTCTTTACTAAAAGTACAAAAAAAAAAAAAAAAAATTAGCCGGGCATGGTGGCAGGCGCCTGTAAACCCAACTACTCTGGAGGCTGAGGAAGGAGAACTGCTTGCACCTGGGAGTCGGAGGTTGCAGTAAGCCAAGATCGCACCATTGCACTCCAGCCTGGGCATCAAGAGTGAGACTTTGTCT","GGCTGGGCGCAGTGGCTCACACCTGTAATCCCAGCACTTAGGGAAGCTGAGGCGAGTAGATCACCTGAGGTCAGGAGTTAGAGACCAGCCTGGCCATCATGGTGAAACCCCGTCTCTACTAAAGATACCAAAAATTAGCTGAGTGTGGTGCTGGGTGCCTGTAATCCCAGAAACTCAGGGTGCCTGTAATCCCAGCAACTCAGGGTGCCTTTAATCCCAGCAACTGAGGGTACCAGTAATCCCAGCAACTCAGGGTGTCTTTAATCCTAGCAACTGAGGGCACCTGTAATCCCAGCAACTCAGGAAGCTGAGACAGGAGAAGTACTTGAACCCAGAAGGCAGAGGTTGCAGTGAGCCGATATTGCACCATTGCACTCCAGTCTGGGCAACAAGAGTGAAACTCTGTCTCAAAAAAAAA"
"chr17","52731467","52732093","JH378129","11955248","11955630","276","40776219","GGCCGGGTGCGGTGGCTCACGCCTGTAATCCTGGCACTTTGGGAGGCTGAGATGGACGGATCACCTGAGGTCAGGAGTTTTTTGTTTTTTTCTTTTTTTTTGAGACAGAGTCTGGCTCTGTTGCCCAGGCTGGAGTGCAGTGGCTCGATCTCGGCTCACTGCAAGCTCCGCCTCCCGGGTTCATGCCATTCTCCTGCCTCAGCCTCCCGGTAGCTGGGACTACAGGTGCCCGCCAGCACATCCGGTTATTTTTTTGTATTTTTAGTAGAGACAGTGTTTCACAGTGTTAGCCAGGATGGTCTCGATCTCCTGACCTCGTGATCCGCCCACCTCGGCCTCCCAAAAGTGCTGGGATTACAGGCATGAGCCACCGCGCCCGGCCAGGAGTTTTTGAGACCAGCCTGGCCAACAGGGTGAAACTCTGTCTCTACTAAAAATACAAAAATTAGTTGGGCATGGTGGCAGGCACCTGTAATCCCAGCTACATGGGAGGCTGAGGCAGGAGAATTGCTTGAACCTGGGAGGCGGAGGTTGCAGTGAGCTGAGATTGCGCCATTGCACTCCAGCCTGGGCAACAAGAGTGAAATTGCGTCTCAAAAACCAAAACAAACAAAAAAAGAATGAAAA","GGCTGGGTACGGTGGCTCATGCCTGTAATCCCAGCACTTTGGGAGGTGGGTCACTTGAGGTCAGGAGTTCGAGACCAGCCTGTGCAGTGCCTCCATCCTCAACTGCTGCCTCATCAGCCTGGACCACTACCTGCTCATCCTCTCACCACTGCCACAAGCTGCGCATGAAGCTCCTGCGCGCGCCGGTGCCCGTCTCTACTAAAAATACAAAAATTAGCTGGGTGTGGTGGCAGGTGCCTGTAATCCCAGCTACTCAGGAGGCTGAGGCAGGAGAATCACTTGAACCCAGGAGGCAGAGGTTGCAGTGAGCCGATATCGCATCATTGCACTCCAGCCTGAGCAACAAGAGTGAAATTTTGTCTCAAAAAAAAAAAAAAAAGAAA"
"chr17","54416242","54416805","JH378115","26183910","26184297","228","28232332","ACTTTGGGAGGCCATGGCAGGCGGATCACCTGAGATCAGGAGTTGGAAACCAGCCTGGCCAACATGGTAAAACCCCGTCTCTACTAAAAATACTTGGCTGGGCACGGTGGCTCACACTTGTAATTCCAACACTTTGGAAGGCCAAGGCGGGCAGATCACCTGAGGTTGGGAGTTCGAGACCAGCCTGACCAACATGGAGAAACCCTGTCTCTACTAAAAATACAAAATTAGCTGGGCATGGTGGTCTATGCCTGTAATCCCAGCTACTTGGGAGGCTGAGGCAGGAGAATTGCTTGAACCCGGGAGGCAGAGGTTGCGGTAAGCCAAGATCATGCCATTGCACTCCAGCCTGGGCAACAAGAGCAAAACCCCGTCTCAAAAAAAAAAAAAAAATTAGCCCAGTGTGGTGGCGTGCACCTGTAATCCCAGCTACTTACTTAGGAGCCTGAGGCAGGAGAATTGCTTGAACCCGGGAGGCAGAGTTTGCAGTGAGCCAAGATTGCACCATTGCACTCCAGCCTGGGTGACAAGAGTGAGACTGTCTCAAAAAAAAAAAAAAAAAAA","GGCCAGGTGCAGTGGCTCATATGTATAACCCCAACACTTTGGGAGGCCAACGCAGGTGGATCACCTGAGTTAGGAGTTTGAGACCAGCCTGACCAACATGGTGAAACCCTGTCTCTACTAAAAATACAGAAATGGCCGGGCATAGTGACACATACCTGTAATCCCAGATACTTGGGATGCTGAGTTTGCTTAAACCCAGAGGAGAACTGCTTAAACCCGGGAGGTAGAGGTCACAGTGAGCCAAGATTGGGATGCTGAGATTTGCTTAAACCCAGAGGAGAACTGCTTAAACCCAGGAGGCAGAGGTTGCAGTGAGTTGAGATTGCACCATTGCACTCCAGCCTGGACAACAAGAGTGAAACTCTGTCTCAAAAAAAAAAAAAAAAAA"
"chr17","55179146","55179483","JH378144","13229286","13229620","44","41949860","GGCCGGGTGCGGTGGCTCACGCCTGTAATCCCAGCACTTTGGGAGGCCGACGCAGGTGGATCACTTGAGGTCTGGTGTTCAAGACCAGCCTGGCCAACATTGTGAAACCCCGTCTCTACTAAAAATACAAAAAGTTAGCTGGGCATGGTAGCAGGTGCCTGTAATCCCAGCTACTTGGGAGGCTGAGGCAGGAGAATTGCTTGAACCTGGGAGGCAGAGGTTGCAGTGAGCTGAGATCGCACCATTGCACTCCAGCCCAGGCAACAAGAGCGAAACTTCGTCTCAAATAATAATAATAATAATAATAATAAATAAATAAATTTTTAAAAAAGAAAAAA","GGCCGGGCGCGGTGGCTCAAGCCTGTAATCCCAGCACTTTGGGAGGCCGAGGCGGGTGGATCACCTGTGGTCAGGAGTTCAAGACAGCTTGGTCAACATGGTGAAACCCCGTCTCTACCAAAAATACAAAAAATTAGCTGGGCATGGTAGCGCATGCCTGTAATCCCAGCTACTCAGGAGGCTGAGGCAGGAGAATTGCCTGAACCCAGGAGGCAGAGGTTGCGGTGAGCCGAGATCGCGCCATTGCACTCCAGCCTGGGTAACAAGAGCGAAACTCCCTCTCATAAAAAATAAATAAATAAATAAATAAATAAATAAATAAATAAATAAATAAA"
"chr17","59543657","59543981","JH378109","3329188","3329514","46","56214469","GGTTGGGCACAGTGGCTCACGCCTGTAATCCCAACACTTTGGGAGGCCAAGGCGGGTGGATCACCTGAGGTCGGGAGTTCAAGACCAGCCTGGCCAACATGCTGAAACCCTATCTCTACTAAAAATACAAAAAAAAAAAAAAAAAAAAAAAAAAAAAATAGCCCAGTGTGGTGTCAGGCGCCTATAATCTCAGCTACTTGGGTGGCTGAGGCAGGAGAGTCGCTTGAACCTGGGAGGCGGAGGTTGCAGTGAGCGGAGATCGCACCATTGCACTCCAGCGTGGGCAACAAGAGTGAAACTCCATCTCAAAAAAAAAGAAAAGAAA","GGCCAGGCATGGTGGCTCACGCCTGTAATCCCAGCACTTTGGGAGCCCAAGCCGGGTGGATTACCTAAGGTCAGGAATTCCAGAACAGCCTGGACAATATGGTGAAACCTTGTCTCTACTAAAAATACAAAAAAAAAAAAAAAAAAAAAAAAAAAAAAAATTTAGCCGGGTGTGGTGGTAGGTACCTGTAATCCCAGCTACTAGGGAGGCTGAGGCAGGAGAATCGCTTGAACTTGGGAGGCGGAGGTTGCAGTGAACAGAGATCACACCACTGCACTCCAGCCTGGGCGACAAGAGCAAAACTCCATCTCAAAGAAAAAAAAAGAA"
"chr17","60766805","60768705","JH378118","18053084","18053501","1483","42713721","GGCCAGGTACCGTGGCTCATGCCTCTTATCCCACCACTTTTGGAAGCTGAGGTGTGAGGATCACCCGAAGTCAGGAGTTTGGAACCATCCTGGCCAATGTTGTAAAACCCCGTCTCTAATAAAAATACAAAAGTTACCCAAGCATGGTGGTGGGCACACCTGTAATCCCAGCTACTTGGAAGGCTAAGACAGGAAAATGCCTGAACCCAGTGTGGCTGGAATTGGTGGGTTCTTGATCTCACTGACCTCAAGAATGAAGCCACGGACCCTCACGGTGAGTGTCACACTTCAAGGTGGCACGTCCAGTTTGTTCCTTCTGATGTTCGGATGTGCTCAGAGTTTCTTTCTTCTGGTGGGTTCATGGTCTCGCTGGCTCAGGAGTGAAGCTACAGACGTTCACCGGGAGTGTTACAGCTCTTAAGGCCTTGCGCCTGGAGTTGTTAGTTCCTCCCAGTGGCTTCGTGGTCTCACTGGCTTCAGGAATCAAGCAGCACGGTGAGCGTTACAGCTCACAAAGGCAGTGTGCACCCACAGTGAGCAACAGCAAAATCTATTGCAAAGAGGACAGAACAAAACCCCCACACTGGGGAAAAGGACCGGAACAGCTTGCCACTGCTGGCTCAGGCAGCCTGCTTTTATTCTCTTATCTGGCCCCACCCACATCCTCCTGATTGGTCCATTTTACAGAGAGCTGATTAGTTTGCTTTACAGTGAACTGATTGGTCCATTTTGACAGATTGGTGCTGATTGGTGCGTTTACAATCCCTGAGCTAGACACAAAAGTTTTCCACGTCCCCATTAGAATAGCTAGATACAGAGTGTCCATAGGTGTATTTACAAACCCTGAGCTAGACACGGAGTGATGATTGGTGCATTTACAAACATGGAGCTAGATACAGAGTGCCGATTGGTGCATTCACAATCCCTTAGCTAGACATAAAGGTTCTCAAGTTCCCACCAGATCAGCTAGACATAGAGCGCTGATTGGTGCATTTACAAAACTTGAGCTCGACACAGGGTGCTGATTGGTGCATTCACAAACCTTGAGCTAGACACAGGGTGCTGATTGGTGTGTTTACAAACCTTGAGCTAGATGCAGAGCGCTGATTGGTGTATTTACAATTCCTTAGCTAGACATAAAGGTTCTCCAAGTCCCCACTAGACTCAGGAGCCCAGCTGGCCTCACCCAGTGGATGTCACACTGGGGCCATAGGTGGAGCTGCCTGCCAGTTCCGTGTCCTGCGCCCACACTCCTCAGCCCTTGGGCGGTGGATGGGATTGGGCACCGTGCAGCAGGGGGTCGCGCTCCTGGGGGAGGCTCGGGCGGTGCAGGAGCCCACGGTGGCGGGGCGGGGCAGACTCAGGCATGGCGGGCTCCGGGTCCCAAGCCCTGCCGGGTGGGGAGGCACCTAAGGCCAGGCGAGAAATGGAGCGCAGCGCTGGTGGGCCAGCACTGCTGGGGGACCAGGCGCATCCTCCGCAGCTGTTGGCCTGGGTGCTAAGCCCCTCACTGCCCAGGGCTGGCAGGGCCCGCCGGCCGCTCCGAGTGCCGGGCCCGCCAAGCCCACGCCCACTTGGAACTCTAGCTGGCCCGCAAGCGCGGCGCGCAGCCCTGGTTCCCCCCCGTGCCTCTCCCTCCACACCTCCCCGCGGGCTGAGGGAGCCGGCTCCGGCCTCGGCCATCCCAGGAAGGGGCTCCCACACTGCAGCGGCGTGCTGAAGGGCTCCTCAAGCACGGCCAGAGTGGGCGAGGAGGCTGAGGAGGCGCCAAGAGTGAGCCAGGGCTGCCAGCATGCTGTCACCTCTCACCAGGAGGCGGAGATTGCAGTGAACCAAGACTGTGCCATTGCACTCCAGCCTGGGCAACAAGAGTGAAACTCCATCTCAAAAAAAATAATAAA","GGCTGGGCGCAGTGGCTCACACCTGTAATCCCAGCACTTAGGGAAGCTGAGGCGAGTAGATCACCTGAGGTCAGGAGTTAGAGACCAGCCTGGCCATCATGGTGAAACCCCGTCTCTACTAAAGATACCAAAAATTAGCTGAGTGTGGTGCTGGGTGCCTGTAATCCCAGAAACTCAGGGTGCCTGTAATCCCAGCAACTCAGGGTGCCTTTAATCCCAGCAACTGAGGGTACCAGTAATCCCAGCAACTCAGGGTGTCTTTAATCCTAGCAACTGAGGGCACCTGTAATCCCAGCAACTCAGGAAGCTGAGACAGGAGAAGTACTTGAACCCAGAAGGCAGAGGTTGCAGTGAGCCGATATTGCACCATTGCACTCCAGTCTGGGCAACAAGAGTGAAACTCTGTCTCAAAAAAAAA"
"chr17","64473614","64473953","JH378109","21565230","21565567","55","42908384","GGCCGGGTGTGGTGGCTCATGCCTGTAATCCCAGTACTTTGGGAGGCCGAGGCAGGCAGATCTCCTGAGGTCAGGAGTTTGAGACCAGCCTGGCCAACATGATGAAATGCTGTCTCTCCTAAAAATACAAAAATTAGCCAGACATAGTGGCAGGTGCCTGTAATCCCAGCTACTTGGGAGGCTGAGGGAGGAGAATTGCTTGAACCTGGGAGGCAGAGGTTGCAGTGAGTCAAGATCACGCCATTGCGCTCCAACCTGGGTGACAAAAGTGAGACTTCATCTCAAAATAAATAAATAAATAAATAAATAAATAAATAAATAAATAATAATTAAAAAAAAA","GGCCGGGCGCGGTGGCTCAAGCCTGTAATACCAGCACTTTGGGAGGCCGAGGCGGGTGGATCACGAGGTCAAGAGATCGAGACCATCCTGGTCAACATGGTGAAACCCCGTCTCTACTAAAAATACAAACAATTAGCTGGGCATGGTGGCGGGTGCCTGTAATCCCAGCTACTCCAGAGGCTGAGGCAGGAGAATTGCCTGAACCCAGGAGACGGAGGTTGCGGTGAGCCAAGATCGCGCCATTGCACTCCAGCCTGGGTGACAAGAGCGAAACTCCGTCTCAATAAATAAATAAATAAATAAATAAATAAAAATAAAATAAATAAATAAATAAATAA"
"chr17","67747489","67748097","JH378118","18053084","18053501","256","49694405","GCTGGGTGTGGTGGCTCACGCCTATAATCCCAGCACTTTGGGAGGCCAAGGCAGGTGGATCACCTGAGGTCAGGAGTTTGAGACCAGCCTGGCCAACATGATGAAACCCCGTCTCTACTAAAAATACAAAGAATTAGGCTGGGCGCGGTGGCTCACGCCTGTAATCCCAGCACTTTGGGAGGCCGAGGCGGGTGGATCACGAGGTCAGGAGATCGAGACCATCCTGGCTAACACGGTGAAACCCCGTCTCTAATAAAAATAAAAAAAAATTAGCTGGGCGTGGTGGTTGGCGCCTGTAGTCCCAGCTACTCGGGAGGCTGAGGCAGGGGAATGGCGTGAACCCGGGAGGTGGAGCTTGTAGTGAGCCGAGATCACGCCACTGCACTCCAGCCTGGGCGACAGAGCAAGACTCCGTCTCAAAAAAAAAAAAAAAAAAAATTAGCCAGGCGTGGTGGCGGGTGCCTGTAATCCCAGCTACTCTGGAGGCTGAGGCAGGAAAATCACTTTAACTCAGGAAACAGAGGTTGCAGTAAGCCGAGATCACGCCATTGTGCTCCATCCTGGGCAACAAGAGCGAAACTCCGACTCGGAAAAAAAGAAAAAAAAAAA","GGCTGGGCGCAGTGGCTCACACCTGTAATCCCAGCACTTAGGGAAGCTGAGGCGAGTAGATCACCTGAGGTCAGGAGTTAGAGACCAGCCTGGCCATCATGGTGAAACCCCGTCTCTACTAAAGATACCAAAAATTAGCTGAGTGTGGTGCTGGGTGCCTGTAATCCCAGAAACTCAGGGTGCCTGTAATCCCAGCAACTCAGGGTGCCTTTAATCCCAGCAACTGAGGGTACCAGTAATCCCAGCAACTCAGGGTGTCTTTAATCCTAGCAACTGAGGGCACCTGTAATCCCAGCAACTCAGGAAGCTGAGACAGGAGAAGTACTTGAACCCAGAAGGCAGAGGTTGCAGTGAGCCGATATTGCACCATTGCACTCCAGTCTGGGCAACAAGAGTGAAACTCTGTCTCAAAAAAAAA"
"chr17","71197353","71197681","JH378262","266823","267148","47","70930530","GACCGGACACAGTGGCTCACGTCTGTAATCCCAGCACTTTGGGAGGCTGAGGCGGGTGGATCACCTGAGGTCAGGAGTTCAAAACCAGCCTGGCCAATATGGTGAAAACCCGTCTATACTAAAAATAAAAAATTAGCCAGGCTTGGTGGCAGGCACCTGTAATCCTAGGTACTCTGGAGGCTTAGACAGGAGAATCACTTGAACCCGAGAAGTGGAGGTTGCAGTGAGCCAAGATCGTGCCATTGCACTCCAGCCTGGGCGACAAGAGTGAGACTCCATCTCAAAAACAAACAAACAAACAAACAAAAAACAAATGAACAAAAAAAAAA","GGCCGGGCGCGGTGGCTCAAGCCTGTAATCCCAGCACTTTGGGAGGCCGAGGCGGGTAGATCATGAGGTCAGGAGTTTGAGACCAGCCTGGCCAACATGGTGAAACCCCGTCTCTACTAAAAATACAAAAATTAGCCGGGCATGGTGGCCTGTGCCTGTAATCCTAGCTACCCAGGAAGCTGAGGCAGGAGAATTGCCTGAACCCAGGAGGCGGAGGTTGCGGTGAGCCGAGATCGTGCCATTGCACTCCAGCCTGGGTAACAAGAGCGAAACTCCGTCTCAAAAACAAACAAACAAACAAACAAAAACAAAAAACAAAAAACAAA"
"chr17","72892082","72892699","JH378118","18053084","18053501","266","54838998","GGCCAGGTGCAGTGGTTCACACCTATAATCCCAGCACTCTAGGAGGCCAAAGTGGGCAGATCACCTGAGGTCAGAAGTTCGAGACCAGCCTGGCCAACATGGTGAAACCATCTCTACTAAAAACACAAAAATTAGGCTGGGCACGGTGGCTCACACCTGTAATCCCAGCACTTTGGGAGGCCGAGGTGGGTGGATCACGAAGTCAGGAGATCAAGACCATCCTGGCTAACACGGTGAAACCCCGTCTCTACTAAAAATACAAAAAATTAGCCAGGCGTGGTGGCGGGCGCCTATAGTCCCAGCTACTTGGGAGGCTGAGGCAGGAGAATGGCGTGAACCCAGGAGGCGGAGCTTGCAGTGAGCCAAGATTGCGCCACTGCACTCCAGCCTGGGTGAGAGAGCTAGACTCTGTCTCAAAAAAAAAAAAAAAAAAAACACAAAAATTAGCCGGGCTTGGTGGCAGGTGCCCGTAATCCCAGCTACTCAGGACGCTGGGACAGGAGAATCTCATGAACCCTGGAGGTGGAGGTTGTAGTGAGCCAAGATCTCACCATCGCACTCCAGCCAGGGTGACAAGAGTGAAACTCTGTCTTAAAAAGATAAATAAATAAAATAAAA","GGCTGGGCGCAGTGGCTCACACCTGTAATCCCAGCACTTAGGGAAGCTGAGGCGAGTAGATCACCTGAGGTCAGGAGTTAGAGACCAGCCTGGCCATCATGGTGAAACCCCGTCTCTACTAAAGATACCAAAAATTAGCTGAGTGTGGTGCTGGGTGCCTGTAATCCCAGAAACTCAGGGTGCCTGTAATCCCAGCAACTCAGGGTGCCTTTAATCCCAGCAACTGAGGGTACCAGTAATCCCAGCAACTCAGGGTGTCTTTAATCCTAGCAACTGAGGGCACCTGTAATCCCAGCAACTCAGGAAGCTGAGACAGGAGAAGTACTTGAACCCAGAAGGCAGAGGTTGCAGTGAGCCGATATTGCACCATTGCACTCCAGTCTGGGCAACAAGAGTGAAACTCTGTCTCAAAAAAAAA"
"chr17","74365360","74365846","JH378118","18053084","18053501","163","56312276","TATAAAAAATCAGCTAGGCTTGGTGGCTTGTGCCTGTAATCCCAGCACTTTGGGAGGCTGAGGCAGGTGGATCACCTGACGTAGGTGTTTAAGACCAGATTGACTAACATGTTGAAACCCCGTCTCTACTAAAAATACAAAAATTATCTGGGCTTGGTGGTGCATGCCTGTAATCCCAGCTGCTCAGGAGGCTGAGACAGGAGAATCGCCTGAACCTGGGAAACGGAAGTTGCAGTGAGTGGAGGTTGCAGTGAGCCGAGATTGCACCACTGCACTCCAGTCTGGGCAACGGAAAAAGACTGTCTCAAAAAAAAAAAAAAAATTAGCTGGGTGTGGTGGTTGGCGCCTGTAATTCCAGCTACTCAGGAGGCTGAGGCAGGAGAATCACTTGAACTCAAGAGGCAGAGGTTGCAATGAGCCAAGATTGCGCCATTGTACTCCAGCCTGGGCCACAAGATTGAAACTTCATCTTGGGGAAAGAAAACAA","GGCTGGGCGCAGTGGCTCACACCTGTAATCCCAGCACTTAGGGAAGCTGAGGCGAGTAGATCACCTGAGGTCAGGAGTTAGAGACCAGCCTGGCCATCATGGTGAAACCCCGTCTCTACTAAAGATACCAAAAATTAGCTGAGTGTGGTGCTGGGTGCCTGTAATCCCAGAAACTCAGGGTGCCTGTAATCCCAGCAACTCAGGGTGCCTTTAATCCCAGCAACTGAGGGTACCAGTAATCCCAGCAACTCAGGGTGTCTTTAATCCTAGCAACTGAGGGCACCTGTAATCCCAGCAACTCAGGAAGCTGAGACAGGAGAAGTACTTGAACCCAGAAGGCAGAGGTTGCAGTGAGCCGATATTGCACCATTGCACTCCAGTCTGGGCAACAAGAGTGAAACTCTGTCTCAAAAAAAAA"
"chr17","74566963","74567566","JH378119","32351107","32351490","260","42215856","GCCGGGCATGGTGTATCACGCCTGTAATCCCAGCACTTTGGGAGGCAGAGGTAGGCAGATCACCTGAGGTCAGGAGTTCAAAACCAGCCTAGCCAACATGGTGAAACCCCGTCTCTACTAAAAATACAAAAAATTAGTGGCCAGGCACGGCAGCTCACGCCTGTAATTCCAGCACTTTGGGAGGCCGAGGCGGGCAGATCACGAGGTCAGAAGATTGAGACCATCCTGGCTAACACGGTGGAACCCCATCTCTACTAAAAATACAAAAAATTAGCTGGGCATGGTGGCTGGTGCCTGTAGTCCCAGCTACTCGGGAGGCTGAGGCAGGAGACTGGCATGAACCCGGGAGGCGGAGCTTGCAGCAAGCCAAGATCGTGCCACTGCACTCCACTCCATCCTGGGCGACAGAGCAAGACTCCGCTTCAAAAAAAAAAAAATTAACCGGGCAAGGTGGCAGGTGCCTGTAATCCCAGCTACTTGGGAGGCTGAGGCAGGAGAATTGCTTGCAGAGGTTGAAGTGAGCCGAGATTACGCCATTGCACTCCAGCCCAAGTGACAAGAGTGAAACTCCATCTCAAAAAAAAAAAAAAAAAAAAGAAAAAAA","GGCCAGGTATGGTGGCTCACACCTGTAATCCCAGCACTTTGGGAGGCCAAGGCAGGCAGACCACCTGAGGTCAGGAGTTCGAGATCAGCCTAGCCAACATGGTGAAACCCCATCTCTAGTAAAAATAAAATTAGCCAGGCATGGTGGTGCATGCCTGTAACGCAGGTCAGGAGTTCGAGATCAGCTTAGCCAACATGGTGAAACCCCATCTCTAGTAAAAATAAAATTAGCCAGGCAGGTGGTGCCGCCTGTACTCGGGAGGCTGAGGCAGGAGAATCACTTGAACCCAAGAGGCAGAGGTTGCAGTCAGCCAAGATCATGCCATTGCACTCCAGCCTAAGCAAAAAGAGTAAAACTCAGTCTCAAAACAAAAAAACAAAAAAA"
"chr17","75365782","75366409","JH378153","2355361","2355755","282","73010421","CCAGGCGTGGTGGCTCATGCCGGTAATCCCAGCACTTTGGGAGGCCAAGGCAGGTGGATCATCTGAGGTCAGGAGTTCGAGACCAGCCTGACCAACATGGTGAAACCTCACCTCTACTAAAAATACAAAAACTAGACAGGCGTGGTGGCGGGTGCCTGTAGTCCCAGCTACTTGGGAGGCTGAGGCAGAAAAATCGCTTGAACCCAGTAGGCAGAGGTTGCAGTGAGCCGAGATCACACCATTGCACTCCAGCCTGGGCAAAAAAGAGCGAAACTCCATCTCAGAAGAAAAGACCGGGTGCAGTGGCTCATGCTTGTAACCCCAGCACTTTGGGAGGCCAAGGCGGGTGGATCACGAGGTCAGAAGATCGAGACCATCCTGGCTAACACGGTGAAACCCCGTCTCTACTAAAAATACAAAAAAAAAAAAATAATTAGCCGAGTGTGGTGGCGGATGCCTGTAGTCCCAGCTACTCGGGAGGCTGAGGCAGGAGAATGGCGTGAACCCAGGAGGCGTAGCTTGCAGTGAGCCGAGATCACGCCACTGCACTCCAGCCTGGGCGACAGAGCAAGACTCGTCTTAAAAAAAAAAAAAAAAAGAAAAAGTAAAAGAAAAGAAAAAGCAACAA","GGCGGGGCATGGTGGCTCACACCTGTCATCCCAACACTTTGGGAGGCTGAGGCAGGCAGATCACCTGAGGTCAGGAGTTTGAGACCAGCCTGGCCAACATGGTGAAACCCCATCTCTACTAAAAATACAAAAATACAAAAAACCCCATCTCTACTAAAAATACAAAAAGCTTGTCTCTATTAAAAATACAAAAAACAAAAAACAAACAAAAAAAAAACCACCATGGTGGTGGGTGCCTATAATCCCAGCTACTCGGGAGGCTGAGGCAGGAGAATCGCTTGAACCCAGGAGGCAGAGGTTGCAGTGAGCCAAGATCCCACCATTGCACTCCAGCCTGGGCAACAGAGAGAGAGACTCTGCCTCAGAAAAAAGAAAGAAAGAAAGAAAGAAAGAAA"
"chr18","19875","20142","JH378153","8929988","8930242","54","8910113","TTGGGAGGCTGAGGTGGGTGGATCATCTGAGGTCAGGAGTTAAGACCAGCCTGGCCAACATGGTGAAACCCCATCTCTACTAAAAATACAAAAACAAAACAAAACAAAACAAAAAAAACCAGCATGGTGGCAGACACCTGTAATCCCAGCTACTCGGGAGACTGAGGCAGGAGAATCACTTGAACCTGGGAGGCGGAGGTTACAGTGAGCCAAGATCTTGTCATGTCACTCCAGCCCAGGCAACAAGAGCAAAACTGTCTTAAAAAAA","TTTGAGAGGCTGAGGTGGGTGGATCACCTAGGTCAGGAGTTTGAGACCAGCCTGACCAACATGGTGAAACCTCATCTCTACTAAAAATAAAAATAAAAAACTAGCCAGGTGCAATGGTGCATGCCTGTAATCCCAGCTACTTGGGAGGCTGAGATGGGAGACTCACTTGAACCTGGGAGGTGGAGGTTGCAGTGAGCCAAGATCATACCATTGCACTCCAGCCTGGGCAACAAGAGTGAAACCTCTTCTCAAAAA"
"chr18","4520498","4521101","JH378118","18053084","18053501","246","13532586","GGCTGGGCGCAGTGGCCCACCCCTGTAATCCCAGCACTTTGGGAGGCCGAGGCGGGTAGATCACCTGACGTCAGGAGTTCAAGACCAGCCTGGCCAACATGGTGAAACCCTGTCTCTACTAAAATACAAAAATTAGGCTGGGCGCAGTGGCTCAAGCCTGTAATCCAGCACTTTGGGAGGCCAAGGCGGGCAGATCACCTGAGGTCAGGAGTTCGAGACTAGCCTGGCCAACCTGGCAAAACCCCATCTCTACTAAAAGTACGAAAATTAGCCAGGGTGATGGTGTGCACCTGTAATCCTAGGTACTCAGGAGGCTGAGGGCAAGAGAATCGCTTGAACCTGGGAGGCAGAGGTTGTAGTGGGCCAAGATCGCGCCATTGCACTGCAGCCTCGGTGACAGAGAAAGACTCCGTCTCAAAAAAAAAAAAAAACAAAAATTAGCTGGGCGTGGTGGTGGGCGTCTGTAGTCCCATCTACACGGGAGGCTGAGGCAGAAGAATCACTTAAACCCAGGATGTGGAGGTTGCAGTGAGCTGAGATCACGCCATTGCACTCCAGACTGGGTAACAAGAGCAAAACTCCATCTCAAATAAATAAAATAAAA","GGCTGGGCGCAGTGGCTCACACCTGTAATCCCAGCACTTAGGGAAGCTGAGGCGAGTAGATCACCTGAGGTCAGGAGTTAGAGACCAGCCTGGCCATCATGGTGAAACCCCGTCTCTACTAAAGATACCAAAAATTAGCTGAGTGTGGTGCTGGGTGCCTGTAATCCCAGAAACTCAGGGTGCCTGTAATCCCAGCAACTCAGGGTGCCTTTAATCCCAGCAACTGAGGGTACCAGTAATCCCAGCAACTCAGGGTGTCTTTAATCCTAGCAACTGAGGGCACCTGTAATCCCAGCAACTCAGGAAGCTGAGACAGGAGAAGTACTTGAACCCAGAAGGCAGAGGTTGCAGTGAGCCGATATTGCACCATTGCACTCCAGTCTGGGCAACAAGAGTGAAACTCTGTCTCAAAAAAAAA"
"chr18","8281535","8282152","JH378118","18053084","18053501","271","9771549","GGCCAGGTGCGATAGCTCACACTGGTAATCCCAACACTTTGGGAGGCCGAGGTGGGCGGATCACCTGAGGCCAGGAGTTTGAGACCAGCCTGGCCAACACAGTGAAACCCCATCTCTACTAAAAATACAAAATTAGGCAGGGTGCAGTGGCTCACGCCTGTAATACCAGCACTTTGGGAGGCCGAGACAGGCGGATTACGAGGTCAGGAGATCGAGACCATCCTAGCTAACACAGTGAAACCCCGTCTCTACTAAAAAAAAAAAAAAAAAAAAAAGTACAAAAAAATTAGCCAGGCGTGGCGGCAGGTGCCTGTAGTCCCAGCTACTCAGGAGACTGAGGCAGGAGAATGGCGTGAACCCGGGAGGCGGAGCTTGCAGTGAACTGAGATCACACCACTGCACTCCAGCCTGGGCAACAGAGTGAGACTCCGTCTCAAAAACAAAACAAAATTAGCCGGGCATGGTGGTGGATGCCCGTAATCCCAGCTACTCGGGAGGCTGAGGCCGCCAAGGCAGGAGAATCTCTTGAATGTGGGAGGCAAAGGCTGCAGTGAGCTGAGATCATGCCATTGCACTGTAGCCTGGGCGACAAAAGTGAGACTCCGTCTCAAAAAAAAA","GGCTGGGCGCAGTGGCTCACACCTGTAATCCCAGCACTTAGGGAAGCTGAGGCGAGTAGATCACCTGAGGTCAGGAGTTAGAGACCAGCCTGGCCATCATGGTGAAACCCCGTCTCTACTAAAGATACCAAAAATTAGCTGAGTGTGGTGCTGGGTGCCTGTAATCCCAGAAACTCAGGGTGCCTGTAATCCCAGCAACTCAGGGTGCCTTTAATCCCAGCAACTGAGGGTACCAGTAATCCCAGCAACTCAGGGTGTCTTTAATCCTAGCAACTGAGGGCACCTGTAATCCCAGCAACTCAGGAAGCTGAGACAGGAGAAGTACTTGAACCCAGAAGGCAGAGGTTGCAGTGAGCCGATATTGCACCATTGCACTCCAGTCTGGGCAACAAGAGTGAAACTCTGTCTCAAAAAAAAA"
"chr18","14964693","14965321","JH378118","18053084","18053501","273","3088391","GGCTGGGTGCGGTGGCTCACACCTGTAATCCCAGCACTTTGGGAGGCTGAGGCAGGCGGATCACCTGAGGTCAGGAGTTCAGGACCAGCCTGATCAACATAGCGAAACCCTGTCTCTATTAAAAATATAAAAATTGCTGGGTGCGGTGGCTCACGCCTGTAATCCCAGCACTTTGGGAAGCCGAGGCGGGCGGATCATGAGCTCAGGAGATCGAGACCATCTTGGCTAACATGGTGAAACCCTGTCTCTACTAAAAATACAAAAAAATTAGCCAGGTGTGGTGGCGGGCGCCTGTAGTCCCAGCTACTCTGGAGGCTGAGGCAGGAGAATCACTTGAACCTGGGAGGCGGAGGTTGCGGTGAGCCAAGATGGTGCCATTGCACTCCAGCCTGGGCAACAAGAGTGAAACTCCATCTCAAAAAAAAAGAAAAAAAAAAAAAAAAACAACCCACAAAAATTAGCCAGGTGTGATGGCGGGTGTCTGTAATCCCAGCTACTTGGGAGACTGAGGCAGGAGAATGGCTTGAACCCGGGAGGTGGAGGTTGCAGTAAGCCGAGATTGCGCCACTGCACTCCAGCCTGGGTGACCAGAGTGAAACTTCATCTCAAAAAAAAAAAAAAAAAAAAAA","GGCTGGGCGCAGTGGCTCACACCTGTAATCCCAGCACTTAGGGAAGCTGAGGCGAGTAGATCACCTGAGGTCAGGAGTTAGAGACCAGCCTGGCCATCATGGTGAAACCCCGTCTCTACTAAAGATACCAAAAATTAGCTGAGTGTGGTGCTGGGTGCCTGTAATCCCAGAAACTCAGGGTGCCTGTAATCCCAGCAACTCAGGGTGCCTTTAATCCCAGCAACTGAGGGTACCAGTAATCCCAGCAACTCAGGGTGTCTTTAATCCTAGCAACTGAGGGCACCTGTAATCCCAGCAACTCAGGAAGCTGAGACAGGAGAAGTACTTGAACCCAGAAGGCAGAGGTTGCAGTGAGCCGATATTGCACCATTGCACTCCAGTCTGGGCAACAAGAGTGAAACTCTGTCTCAAAAAAAAA"
"chr18","15291276","15291680","JH378105","31074364","31074738","116","15783088","CTCGTGCCTGTAATCCTAGCACTTTGGGAGGCCAAGGTGGGCAGATCATCTGAGGTCAGGAGTTCGAGACCAGCCTGGCCAACATAGAGAAATCCCATCTCTACTAAAAATACAAAAATTGACGAGTTAATGGGTGCAGCACACGAACATGGCACATGTATACATATGTAACAAACCTGCACGTTGTGCACATGTACCCTAAAACTTAAAGTATATTTAAAAAAAATACAAAAATTAGCCGGGCATGGTAGCAGGCACCTGTAATCCCAGCTACTCGGGAGGCTGAGGCAGGAGAATCACTTGAACCTGGGAGGCAGAGGTTGCAGTGAGCTAAGATCATTCCATTGTACTCCAACCTGGGCAACAAGAGTGAAATTCCGTCTAATAAAAAATGAAATAAATAAA","GGCCGGGCACAGTGGCTCACACCTGTAAACCCAGCACTTTGGGAGAATGAGGTGGGCAGATGACTTCAGGTCAGGAGTTCGAGACCAGCCTGGCCAACACTGTGAAATCCCATCTCTACTAAAAATACAAAAATTAGCCATGGTGGTCAGAAGATCAAGACTATCCTGGCCAACATGGTGAAACCTTGTCTCTACTGAAAATAGAAAAATTAGCTGGGTATGGTGGCATGCGCCTGTAGTCCCAGATACTCAGGAGGCTGGGGCAGGAGAATCACTTGAACCCAGGAGGCAGAGGTTGCAGTGAGCTGAGATCATGCCATTGCACTCTAGATTAGGCAACAAGAGTGAAACTGTCTCAAAAAGAGAGAGAGAAAA"
"chr18","15802064","15802689","JH378153","2355361","2355755","270","13446703","GACCGGGCATGGTGGCTCACACCTGTAATCCCAGCACTTTGGGAGGCGTAGGCGAGTGGCCCCTGAGGTCAGGAGATCGAGACAACCCTGGCCAACATGGTGAAACTCTACTAAAAATACAAAATTAGGCCGGGTGCCGTGGTTCACGCCTATAATCCCAGCACTTTGGGAGGTCAAGGTGGGCAGATCACCTGAGGTCAGGAGTTTGAGACCAGCCTGGCCAACATGGTGAAACCCAGTCTCTACTAAAAATACAAAAATTAGCTGGGCATGGTGGTGGACACTTGTAATCCCAGCTACTTGGGGGGCTGAGGCAGGAGAATCACTTGAACCCAGGAGGCAGAGGTTGCAGTGAGCCTAAATCACCCCATTGCACTCCAGCCTGGGCAACAAGAGTGAAATTCTGTCTCGAAAAAAAAAAAAAAAGAAAAGAAAAGAAAAAAAAATTAGCCAGGTGTGGTGCTGCATGCCTGTAATCCCAGCTACTCAGGAGGCTGAGGCAGGAGAATCGCTTGAACCCGGGAGGCAGAGGTTGCAGTGAGCTGAGACCACACCATTGCACTCCAGCCTGGGCGACAAGAGAGTAACTCCATTTCAAAAAAAAAAAAAAAAAAAAGAAAAAAGAA","GGCGGGGCATGGTGGCTCACACCTGTCATCCCAACACTTTGGGAGGCTGAGGCAGGCAGATCACCTGAGGTCAGGAGTTTGAGACCAGCCTGGCCAACATGGTGAAACCCCATCTCTACTAAAAATACAAAAATACAAAAAACCCCATCTCTACTAAAAATACAAAAAGCTTGTCTCTATTAAAAATACAAAAAACAAAAAACAAACAAAAAAAAAACCACCATGGTGGTGGGTGCCTATAATCCCAGCTACTCGGGAGGCTGAGGCAGGAGAATCGCTTGAACCCAGGAGGCAGAGGTTGCAGTGAGCCAAGATCCCACCATTGCACTCCAGCCTGGGCAACAGAGAGAGAGACTCTGCCTCAGAAAAAAGAAAGAAAGAAAGAAAGAAAGAAA"
"chr18","15849226","15849860","JH378118","18053084","18053501","290","2203858","GGCCAGGCACAGTAGCTTACGCCTATAATCTCAGCACCCTAGGAGGCCGAGGCTGGCAGACCACCTGAGGTCACGAGTTCAAGACTAGCCTGGTCAACATAGCAAAACCCCATCTCTACTAAAAATACAAAAATTAGGCTGGGCACAGTGGCTCATGCTTGTAATCCCAGCACTTTGGGAGGCCAAGTCGGGAGAATCACCTGAGGTTGGGAGTTCGAGATCAGCCTGACCAACATAGAGAAACTCCATCTCTACTAAAAATGCAAAATTAGCTAGGCATGGTGGTGCATGCCTGTAATCCCAGCTACTCGTAAGGCTGAGGCAGGAGTATCGCTTGAATCTGGGAGGTGGAGGTTGCGGTGAGCCAAGATCACGCCATCGTACTCCAGCCTGGGCAACAAGAGCGAAACTCCATCTCAAAACAAAAAAAATGAGCCAGGAGTGGTGGCGGGCGCCTATAATTCCAGCTACTCCAGAGGCTGAGGCAGGAGAATCACTTAAACCCGGGAAGCAGAGGTTGCAGTGAGCTGAGATTGTGCCATTGCACCCCAGCCTAGGTGAAAAGAGCAAAACTCCATCTCAAAAAAAAAAAAAAAAAAAAAAAAAAAGAAAGAAAGAAAGAAAAAGAAAAAAAA","GGCTGGGCGCAGTGGCTCACACCTGTAATCCCAGCACTTAGGGAAGCTGAGGCGAGTAGATCACCTGAGGTCAGGAGTTAGAGACCAGCCTGGCCATCATGGTGAAACCCCGTCTCTACTAAAGATACCAAAAATTAGCTGAGTGTGGTGCTGGGTGCCTGTAATCCCAGAAACTCAGGGTGCCTGTAATCCCAGCAACTCAGGGTGCCTTTAATCCCAGCAACTGAGGGTACCAGTAATCCCAGCAACTCAGGGTGTCTTTAATCCTAGCAACTGAGGGCACCTGTAATCCCAGCAACTCAGGAAGCTGAGACAGGAGAAGTACTTGAACCCAGAAGGCAGAGGTTGCAGTGAGCCGATATTGCACCATTGCACTCCAGTCTGGGCAACAAGAGTGAAACTCTGTCTCAAAAAAAAA"
"chr18","16042035","16042617","JH378118","18053084","18053501","243","2011049","GGCTATGCACGGTGGCTCACGCCTGTAATCCCAGCACTTTGGGAGGCCGAGTCAGGTGGATCACTTGAGGTCAGGAGTTCGAGACCAGCCTGGCCAACATGGTGAAGCCCCATCTCCACTAGAAATACAAAAATTAGTCTGGGAGCAGTGGCTTACACCTGTAATTGCAGCACTTTGGGAGGCCAAGGTGGGTGGATCACCTGAGGTCAGGAGTTTGAGACCAGCATGACCAACATGGTGAAACTCCATCTATACAAAAAAATTAGCCGGGTGTGGTGGCGCATGCCTGTAATCCCAGCTACTCAGGAGACTGAGGCAGGAGAATTGCTTGAACCCGGGAGGCAGAGGTTGCAGTGAGCCAAGTCTGTGCCATTGCACTCCAACCTGGGCAACAAAAGCGAAACTCTGTCTCAAAAATAAACAACAAAAAAAATTAGCCAGGTGTGGTGGCACATGCCTATAATCCCAGCTACTCGGGAGGCTGAGGCAGAAGAATTGCTTGAACCTGGGAGGTGGAGGTTGCAGTGAGCCGAGATCATGCCATTCTACTCCAGCCTGGGCCACAAGAGCGAAACTCTGTCTC","GGCTGGGCGCAGTGGCTCACACCTGTAATCCCAGCACTTAGGGAAGCTGAGGCGAGTAGATCACCTGAGGTCAGGAGTTAGAGACCAGCCTGGCCATCATGGTGAAACCCCGTCTCTACTAAAGATACCAAAAATTAGCTGAGTGTGGTGCTGGGTGCCTGTAATCCCAGAAACTCAGGGTGCCTGTAATCCCAGCAACTCAGGGTGCCTTTAATCCCAGCAACTGAGGGTACCAGTAATCCCAGCAACTCAGGGTGTCTTTAATCCTAGCAACTGAGGGCACCTGTAATCCCAGCAACTCAGGAAGCTGAGACAGGAGAAGTACTTGAACCCAGAAGGCAGAGGTTGCAGTGAGCCGATATTGCACCATTGCACTCCAGTCTGGGCAACAAGAGTGAAACTCTGTCTCAAAAAAAAA"
"chr18","25849088","25849351","JH378114","20445944","20446195","60","5403144","GGGAAGATGAGGCGGGTGGATCACTTGAGGTCAGGAGTTCGAGACCAGCCTGGCCAACATGGTGACACCCTGTCTCCAAAAAATACACACACACACACACACACACACACACACACAAATTAGCTGGGCATGGTGGCGGGCACCTGTAATCCTAGCTACTCGAGAGGCTGCGGCAGGAGAATTGCTTTAACTTGGGAGGTAGAGGTTGCAGAGAGCCGAGATTGCACCATTGTACTCCAGCCTGGGTGACAAGAGCGAAACTCC","TTGGGAGGCCAAGGCGGGTGGATCACCTGAGGTCAGGAGTTCGAGACCAGCCTGGCCAACATGATAAAACCCCCGTATCTAATAAAAATAGGAAAAAAAAATAAATAAATAGCTGGGCGTTGTGGCAGGTGCCTGTAATCCCAGCTACTCGGGAGGCTCAGGCAGGAGAATCGCTTGAACCCAGGAGGCAGAGGTTGCAGTGAGCCAAAATTGTGCCATTGCACTCCCGCCTGGGAAACAAGAGCAAAACTC"
"chr18","38083500","38083832","JH378152","15993594","15993909","55","22089906","GGCTGGGTGCGGTGGCTCACGCCTGTAATCCCAGCACTTTGGGAAGCCAAGTCAGGTGACCTCACCTGAGGTCAGGAGTCCAAGACCAGCCTGACCAACATGGTGAAACCTCGTCTCTACTAAAAAGACAAAAAATTAGCCAGGCATGGTGGTGGGCACCTGTAATCTCAGCTACTCTGGAGGCTGAGGCAGGAGAATCACTTGAACCCTGGAGGGGGAGGTTGCAGTGAACCAAGATTGCACCATTGCAGTCCAGCCTGGGCGACAAGAGCAAAACTCCATCTCACAAACACACACACACACACACACACACACACACACAGAAAAAAAAAA","GGCTGGGTGTGGTGGCTCATGCCGGTAATCCCAGCACTTTGGGAAGCGGAGGCAGGCAGATCACCTGAGGTCAGGAGTTCAAGACCAACCTGGCCAACATGGAGAAACCATGTCTCTACTAAAAATACAAAAAATTAGCCAGGCATGGTGGGTGCCTGTAATCCCCACTACTCGGGAGGCTGAGGCAGGAGAATTTCTTGAACCCAGGAGGTGGAGGTTTCAGTGAAGCGGAGATCACCCCATTGCACTCCAGCCTGGGTGACAAGAGCAAAACTCCATCTCACAAAATCAACAACAACAACTTAAAAAAAAAAAA"
"chr18","44076326","44076933","JH378118","18053084","18053501","257","26023242","GCTGGGCGCGGTGGCTTGCGCCTGTAATCCCAGCCATTTGGGAGGCCGAGGCAGGTGGATCACCTGAGGTTAGGAGTTCAAAACCAGCCTGGCCAACATGGTGAAACCCCGTCTCTACTAAAAATACAAAAATTAGGCCAGGCACAGTGGCTCACGCCTGTCATCCCAGCACTTTGGGAGGCCAAGGCGGGCGGATCATGAGGTCAGGAGATTGAGACCATCCTGGCTAACACAGTGAAACCCTGTCTCTACTAAAAAAATATATAAAAAATTAGCCGGGCTTGGTGGCGGGTGCCCGTAATCCCAGCTACTCGGGAGGCTGAGGCAGGAGAATGGCGTGAACCTGGAAGGCGGAGCTTGCAGTGAGCCGAGATTGCACCACTGCACTCCAGCCTGGGTGACAGAGTGAGACTCTGTCTCAAAAAAAAAAAAAAAACAAAAAACAAAAATTAGTTGGGTGTGGTGGTGGACGCCTGTAATCCCGGCTACTCGGGAGGCTGAGGCAGGAAAATCACTTCAACCCGGGAGGCAGAGGTTGCCGTGAGCCAAGATCGTGCCATTGCACTCCAGCCTGGGTGACAAGAGCAAAACTCTGTCTCAAAAAAAAA","GGCTGGGCGCAGTGGCTCACACCTGTAATCCCAGCACTTAGGGAAGCTGAGGCGAGTAGATCACCTGAGGTCAGGAGTTAGAGACCAGCCTGGCCATCATGGTGAAACCCCGTCTCTACTAAAGATACCAAAAATTAGCTGAGTGTGGTGCTGGGTGCCTGTAATCCCAGAAACTCAGGGTGCCTGTAATCCCAGCAACTCAGGGTGCCTTTAATCCCAGCAACTGAGGGTACCAGTAATCCCAGCAACTCAGGGTGTCTTTAATCCTAGCAACTGAGGGCACCTGTAATCCCAGCAACTCAGGAAGCTGAGACAGGAGAAGTACTTGAACCCAGAAGGCAGAGGTTGCAGTGAGCCGATATTGCACCATTGCACTCCAGTCTGGGCAACAAGAGTGAAACTCTGTCTCAAAAAAAAA"
"chr18","44546829","44547449","JH378118","18053084","18053501","262","26493745","GGCCAGGCACGGTCGCTCACACCTGTAATTCCAGCACTTTGGGAGGCCAAGGCGGATGGGTCACCTGAGGTCAGGAGTTTGAGACCAGCCTGACCAATATGATGAAACCCCATCTCTATTAAAAATACAAAAATTAGGCTGGGCGCAGTGGTTCATGCCTGTAATTCCAACACTTTGGGAGGCCGAGACGGGCGGACCATGAGGTCAGGAGATCGAGACCATCCTGGCCAACGTGGTGAAACCCCGTGTCTACTAAAATACAAAAAAAATTAGCCAGGTGTGGTGGCACGTGCCTGTAGTCCCAGCTATTAGGGAGGCTGAGGCAGGGGAATCACTTGAACCTGGGAGGTGGAGGTTGCAGTGAGCTGAGATCTTGCCACTACACTCCATTCTGGGCAACAGAGCAAGACTCCGTCTGAAAAAAAACAAAAAAATACAAAAATTAGCTGGGCATGGTGGCGGGTACCTGTAATCCCAGCTACTTGGGAGGCTGAGACAGGAGAATCACTTGAACTCGGGAGGCAGAGGTTGCAGTGAGCCAAGATCGCACCATTGCATTCCAGCCTGGGCAACAAGAGCGAAACTCCATCTCAAAAAAACAAAAAAAAAAAAAAAGAAAAA","GGCTGGGCGCAGTGGCTCACACCTGTAATCCCAGCACTTAGGGAAGCTGAGGCGAGTAGATCACCTGAGGTCAGGAGTTAGAGACCAGCCTGGCCATCATGGTGAAACCCCGTCTCTACTAAAGATACCAAAAATTAGCTGAGTGTGGTGCTGGGTGCCTGTAATCCCAGAAACTCAGGGTGCCTGTAATCCCAGCAACTCAGGGTGCCTTTAATCCCAGCAACTGAGGGTACCAGTAATCCCAGCAACTCAGGGTGTCTTTAATCCTAGCAACTGAGGGCACCTGTAATCCCAGCAACTCAGGAAGCTGAGACAGGAGAAGTACTTGAACCCAGAAGGCAGAGGTTGCAGTGAGCCGATATTGCACCATTGCACTCCAGTCTGGGCAACAAGAGTGAAACTCTGTCTCAAAAAAAAA"
"chr18","45772849","45773450","JH378118","18053084","18053501","269","27719765","CACGCCTATAATCCCAGCACTTTAGGAGGCTGAGGCAGGTGGATCACCTGAGATCAGGAGTTCAAAACCAGCCTGGCCAACATGGTGAAACCCTGTGTCTACTACAAATACAAAAAAATGGGCAGGGTGTGGTGGCTCACACCTGTAATCCCAGCACTTAGGGAGGCCGAGGCGGGTGGATCATGAGGTCAAGAGATCAAGACCATCCTGGCCAACATGGTAAAACCCCGCCTCTACTAAAAATATAAAAATTAGCTGGGCAAGGTGGTGCGCGCCTGTAGTCCCAGCTATTTGGGAGGCTGAGGCAGGAGAATTGCTTGAACCTGGGAGGTGGAGGTTGCAGTGAGCCAAAATCGCGCCACTGCACTCCAGCCTGGCAACAGAGTGAGACTCTGTCTCAAAAAAAAACAAAAACAAAACAAAACAGAAACCAAAATTAGCTGGGCGTGGTGGCGGGCGCCTGTAGTCCCAGCTACTTGGGAGGCTGAGGCAGGAGAATCGCATGAACCCAGGAGGCGGAGGTTGCAGTGAGCCAAGACTGCACTATTGCACTCCAGTCTGGGCTACAAGAGCGAACTCCGTCTCAAAAAAAAAAAAAAAAA","GGCTGGGCGCAGTGGCTCACACCTGTAATCCCAGCACTTAGGGAAGCTGAGGCGAGTAGATCACCTGAGGTCAGGAGTTAGAGACCAGCCTGGCCATCATGGTGAAACCCCGTCTCTACTAAAGATACCAAAAATTAGCTGAGTGTGGTGCTGGGTGCCTGTAATCCCAGAAACTCAGGGTGCCTGTAATCCCAGCAACTCAGGGTGCCTTTAATCCCAGCAACTGAGGGTACCAGTAATCCCAGCAACTCAGGGTGTCTTTAATCCTAGCAACTGAGGGCACCTGTAATCCCAGCAACTCAGGAAGCTGAGACAGGAGAAGTACTTGAACCCAGAAGGCAGAGGTTGCAGTGAGCCGATATTGCACCATTGCACTCCAGTCTGGGCAACAAGAGTGAAACTCTGTCTCAAAAAAAAA"
"chr18","50079974","50080314","JH378127","6796468","6796795","54","43283506","GGTCTGGCGCCAGTGGCTCATGCCTGTAATCCCAGCACTTTGGGAGGCTGAGGCGGGTGTATCACCTGAGGTCAGGAGTTCGAGACCAGCCTGGCCAACATGGCAAAACCCCGTCTCTACGAAAAATACAAAAAAATTAGCCGGGCGTGGTAGCAGTCGCCTGTAATCCCAGCAACTTGGGAAGCTGAGGCAGAAGAATCGCTTAAACCTAGGAGGCGGAGGTTGCAGTGAGCCAAGATTGCGCCATTGCACTCCAGCCTGGTCAACAAGAGCAAAACTCTGTCTCAAAACAACAACAACAACAACAACAACAACAAACAAAAACCAAAAAAACCAAAAAA","GGCCGGGCGCGGTGGCTCAAGCCTGTAATCCCAGCATTTTGGGAGGCCGAGGCGGGTGGATCACGAGGTCAGGAAATCGAGACCATCCTGGTCAACATGGCGAAACCCCATGTCTACTAAAAATACAAAAATTAGCTGGGCATGGTGGCACGTGCCTGTAATCCCAGCTACTCAGGAGGCTGAGGCAGGAGAATTGCCTGAACCCAGGAGGCGGAGCTTGCAGTGAGCCGAGATCGCGCCATTGCACTCCAGCCTGGGTAACAAGAGCGAAACTCCGTCTCAAAAAAACAAACAAAAACAAAACAAAACAAAACAAAACAAAAAAAAC"
"chr18","53653883","53654201","AGCE01149660","956","1264","46","53652927","GGCCAGGCATGGTGGCTCACGTTTGTAATCCTAGCACTTTGGGAGGCTGTAGCGGGCGGATCACCTGAGGTCAGGAGTTTGAGACCAGCCTGGCCAACATGGTGAAACCCTGTCTCTACTAAAAAAAAAAAAAAAAAAAAAAAAAAAATTAGCCAGGTGTGGTGGTGGTGGATGCCTATAATCCCAGCTACTCGGGAGGCTGAGGCAGGAGAATCACTTGAACCTGGGAAGCAGAGGTTGCAATGAGCTGAGATTGAGCCATTGCACTCCAGCCTGGACAACAAGAATGAGACTCTGTCTCAATAAATAAGTAAATAAA","GGCCAGGCACGGTGGCTCATGCCTATAATCCCAGCACTTTGGGAGGCTGCGATGGGTGGTTCACTTGAGGTCTGGAGTTTGAGACCAGCCTGGCCAACATGGAGAAACCCTTTCTCTACTAAAAATACAAAAAAAAAAAAAAAAAAAATTAGCCAGGCATGGTGGCGGGTGCCTGTAATCCCAGCTACTCAGCAGGCTGAGGGAAGAGAATCACTTGAACCGGGGAGGCAGAGGTTGCAGTGAGCTGAGATGATGCCATTGCACTCCAGCCTGGGCAACAAGAGCAAAACTGTCTCAAAAAAAAAAAAA"
"chr18","53971096","53971710","JH378118","18053084","18053501","262","35918012","GGTCGGGTGTGGTGGCTCATGCCTATAATCCCAGCACTTTGGGAGGCTGAGGCAGGCAGATTACCTGAGGTCAGGAGTTCGAGACCAGCCTGGCCAACATGATGAAACCTTGTCTCTACTAAAAATACAAAAATTAGGCCGGGCACGGTGGCTCATGCCTGTAATCCCAGCACTTTGGGAGGCCGAGGCGGGTAGATCACAAGGTCAGAAGTTCAAGACCAGCCTGGCCAACATGGTGAAACTCTGTCTTTACTAAAAATACAAAAATTAGCTAGGCATGGTGGCGCACACCTATAATCCCAGCTACTGGGGAGGCTGAGGCAGGAGAATTGCTTGAACCAGGACCCGGGAGGTGGAGGTTGCTGTGAGCCGAGATTGCGCCACTGCACTCCAGCCTGGGAGACAGAGTGAGACTCCGTCTAAAAAAAAAAAAAAAAAATTAGCCAGGTGTGGTGGCGCATGCCTGTAATCCCAGCTACTCGGGAGGCTGACGCAGAAGAATCATTTGAACGTGGGAGGCAGAGGTTACAATGAGCTGAGATCACACCATTGTACTCCAGCCTGGGCAACAAGAGCAAACTCAATCTCAAAAAAATAAAAATAAAAAAAAAGAAA","GGCTGGGCGCAGTGGCTCACACCTGTAATCCCAGCACTTAGGGAAGCTGAGGCGAGTAGATCACCTGAGGTCAGGAGTTAGAGACCAGCCTGGCCATCATGGTGAAACCCCGTCTCTACTAAAGATACCAAAAATTAGCTGAGTGTGGTGCTGGGTGCCTGTAATCCCAGAAACTCAGGGTGCCTGTAATCCCAGCAACTCAGGGTGCCTTTAATCCCAGCAACTGAGGGTACCAGTAATCCCAGCAACTCAGGGTGTCTTTAATCCTAGCAACTGAGGGCACCTGTAATCCCAGCAACTCAGGAAGCTGAGACAGGAGAAGTACTTGAACCCAGAAGGCAGAGGTTGCAGTGAGCCGATATTGCACCATTGCACTCCAGTCTGGGCAACAAGAGTGAAACTCTGTCTCAAAAAAAAA"
"chr18","57837437","57837748","JH378115","16887097","16887400","43","40950340","GCTGGGCATGGTGGCTCACACCTGTAATCCCAGCACCTTGGGAGGCCGAGGTGGGTAGATCACCTGAGGTCAGGAATTCGAGACCAACCTGGCCAACATGGTGAAACCCCGTCTCTACTAAAAATACAAAAAAAAAAAAAAAAAAAAAAAAAGCTGGGCATGGTGGTGGGTACCTGTAATCCCAGCTACTCAGGAGTCCGAGGCAGGAGAATCGCTTGAACCTGGCAGGTGGAGGTTGCAGTGTGCCAGGATTGTGCCATTGCACTCCAGCCTGGGTGACAAGAGCAAAACTCCAACTCAAAACAAAAACAA","GCCGGGCACGGTGGCTCAAGCCTGTAATCCCAGCACTTTGGGAGGCCGAGGCGGGTGGATCACAAGGTCAAGAGATCGAGACCAACCTGGTCAACATGGTGAAACCCCATCTCTACTAAAAAATACAAAAAAAAAAAAAAAATTAGCTGGGCATGGTGGCGCGTGCCTATAATCCCAGCTACTCAGGAGGCTGAGGCAGGAGAATTGCCTGAACCTAGGAGGTGGAGGTTGCAGTGAGCCAAGATCATGCCATTGCACTCCAGCCTGGGTAACAAGAGCGAAACTCCATCTCAAAAAAAAAAAA"
"chr18","58257354","58257943","JH378118","18053084","18053501","263","40204270","GCCTGTAATCACAGCACTTAGGGGGGCCGAGGCAGGAGGATCACCTGAGGTCAGGAGTTCGAGACCAGCCTGGCCAACATGGTGAAACCCCGTCCCTACTAAAAATACAAAAATTGGCCGGACACATTGGCTCATGCCTGTAATCCCAGCACTTTGGGAGGCCGAGGCGGGTGGATCACCTGAGGTCAGGAGTTCAAGACCAGCCTGACCAACCTGGAGAAACCCTGTTTCTACTAAAAATACAAAATTAGCCAGGCATAGTGGCGCATGCCTGTAATCCCAGCTACTCGAGAGGCTGAGGCAGGAGAATCGCTTGAACCCGGAAGGTGGAGGTTGCGGTGAACCGAGATTGTGCCATTGCACTCCAGCCTGGGCAACAAGAGCAAAACTCCGTCTCAAAAACAAAACAAAACAAAACAAAAATTAACCCGGCGTGGAGGTGGATGCCTGTAATCCCAGCCACTTTGGGAGACTGAGGCAAGAGAATTGCTTGAACCCGGGATGTGGAGGCTGCAGTGACCCGAGATCACGCCATTGCATTCCAGCCTGGCAACAAGAGTAAGACTCCATCTCAAAAACAAGCAAACAAA","GGCTGGGCGCAGTGGCTCACACCTGTAATCCCAGCACTTAGGGAAGCTGAGGCGAGTAGATCACCTGAGGTCAGGAGTTAGAGACCAGCCTGGCCATCATGGTGAAACCCCGTCTCTACTAAAGATACCAAAAATTAGCTGAGTGTGGTGCTGGGTGCCTGTAATCCCAGAAACTCAGGGTGCCTGTAATCCCAGCAACTCAGGGTGCCTTTAATCCCAGCAACTGAGGGTACCAGTAATCCCAGCAACTCAGGGTGTCTTTAATCCTAGCAACTGAGGGCACCTGTAATCCCAGCAACTCAGGAAGCTGAGACAGGAGAAGTACTTGAACCCAGAAGGCAGAGGTTGCAGTGAGCCGATATTGCACCATTGCACTCCAGTCTGGGCAACAAGAGTGAAACTCTGTCTCAAAAAAAAA"
"chr18","59255477","59255805","JH378228","5665092","5665424","52","53590385","GGTTGGGCGCAGTGGCTCACGCCTGTAACCCCAGCACTTTCGGAAGCTGAGGCAGGCGGATCACCTGAGGTCAGGGGTTCGAGACCAGCCCGGACAACGTGATTAAACCCTGCCTCTACTAAAAATACAAAAATTAGCGACTGTGGTGTTGGGCGCCTGTAATCGCAGCTACTTGGGAGGCTGAGGCATGAGAATTGCTTGAACCCAGGAGGCAGAGGTTGCAGTGAGCAGAGATTGCTCCATTGCACTCCAGCCTGGGCAACAAGAGCAGAACTCTGTCTCAAAATAAATAAATAAATAAATAAATAAATAAATAACAGAAAAGAAAA","GGCCGGGCGCGGTGGCTCAAGCCTGTAATCCCAGCACTTTGGGAGGCTGAGGCGGGTGGATCACGAGGTCAAGAGATCGAGACCATCCTGGTCAACATGGTGAAACCCTGTCTCTACTAAAAATACTAAAAATTAGCTGGGCATGGTGGCGTGTGCCTGTAATCCCAGCTACTCAGGAGGCTGAGGCAGGAGAATTGCCTGAACCCAGGAGGCGGAGGTTGCGGTGAGCCGAGATCGCGCCATTGCACTCCAGCCTGGGCAACAAGAGCGAAACTCTGTCTCAAAAAAAAAAAATAAATAAATAAAATAAAATAAAATAAAATAAAATAAAAT"
"chr18","59405673","59406877","JH378118","18053084","18053501","805","41352589","GGCTAGATGCGGTGGCTCATGCCTGTAATCCCAGCACTTTGGGAGGCCAAGGCAGGTGGATCACCTGAGGTCAGGAGTTTGACACCAGCCTGGCCAACATGTTGAAACCCTGTCTCCACTAAAAATACAAAAAAAGATTATCTGGGTTATTGTGGGATCTGGCCAGCAGCCCGCAATGCAATGGGGCTCTCTCTTTGTTCCCAGGCAGATTGGCAGGTTGAGAAATAATAGACACACACAAGATAGTGAAAGTTGGGTCCAGGGGGGTCACCGCCTTCTGGTCCCATGGTGCCAACAATGCACTGGATATACCAGCATTTATTATTAAGTTTAGTGAGGGCGGGGGTAGGTTAGTGAGGGATTTAGGGTCATTTGATTATGAGGTGAGATGGTCACATGGAAATGAAGTAATTCTTTAACGTAACATTTGTATGTAGAAGTACAGTACATTTGTATGTAGAAGTACAGTATACAGAGATAAGAATTTACAATATAGTGTGTGCATCAGTAATTTCTAACAGAGCCTTAAAACAGAAAGACAATCTTTCCATAATCTATGATTAGCAAGATATTAATCAGCAGTAACAATTGCAATGAAAGCTGGTTACAAACAGTCCATGGAAACAGGAGGTGAAGCTAGACAATCGGTTAGACCAGAAATTCTCAGAAGGGAATATGCCTTAACCCTAAAGAGGCCTAGAAGAGCCGTGGCAAGATGAGGGTGTTTATAGCCCTATCTTATCCATATGGACAGGCACCTCCCCATGCGTCCGTTTATAGGCTCTCCATGAGGGTCGCATTCCATTCCCAGAGCTATGAACATCTGCTTTTCTGGGATAGGAATCTTGGTGATGTGAAACCTCCCTGACTACACGTCCATTCATAGGATCTCTGCAGGGGGAAGCACATCACACACTGTTGGCTCGTTCTGGCAGTCCAACCTGGCATTGTGTCTTTACACAATCCTGCATGCAATTTTGTATTTACAATAATCAGGAGCATTTCATCTTTTATTCTGTAGCAATAGTTTCAGGGGGTCTCCCTACACTGGGTGTGGTGACGGGTACCTGTAATCCCAGCTACTCAGGAGGCTGAGGCAGGAGAATCACTTGAGCCTTAGAGGCAGAGGTTGCAGTGAGCTGAGATCAGACCATTGCACTCCAGCCTGGGCAACAAGAGCAAACCTCCGTCTCAAAAAAAAAAAA","GGCTGGGCGCAGTGGCTCACACCTGTAATCCCAGCACTTAGGGAAGCTGAGGCGAGTAGATCACCTGAGGTCAGGAGTTAGAGACCAGCCTGGCCATCATGGTGAAACCCCGTCTCTACTAAAGATACCAAAAATTAGCTGAGTGTGGTGCTGGGTGCCTGTAATCCCAGAAACTCAGGGTGCCTGTAATCCCAGCAACTCAGGGTGCCTTTAATCCCAGCAACTGAGGGTACCAGTAATCCCAGCAACTCAGGGTGTCTTTAATCCTAGCAACTGAGGGCACCTGTAATCCCAGCAACTCAGGAAGCTGAGACAGGAGAAGTACTTGAACCCAGAAGGCAGAGGTTGCAGTGAGCCGATATTGCACCATTGCACTCCAGTCTGGGCAACAAGAGTGAAACTCTGTCTCAAAAAAAAA"
"chr18","71500430","71500770","JH378228","5665092","5665424","54","65835338","GCTGGGTGCGGTGGCTCACGCCTGTAATCACAGCACTTTGGTAAGCCCGAGGCAGGTGGATCACCTGAGGTCAGGAGTTCGAGACCAGCCTGACCAACATGGTGAAACCCTTTCTCTACTAAAAATGCAAAAATTAGCTGGGCGTCATGGCGGGCGTCTGTGATCCCAGCTACTAGGGAGGCTAAGGCAGGAGAATTGCTTGAACCTGGGAGGCGGAGGTTGCAGTGAGCAGAGATTGCACCATTACACTCCAGCCTGGGCAACAAGAGCAAAACTCCATCTCAAAATAAATAAATAACTAAATAAATAAATAAAATGAAATTAAAAAGAAAGAAAGAAAA","GGCCGGGCGCGGTGGCTCAAGCCTGTAATCCCAGCACTTTGGGAGGCTGAGGCGGGTGGATCACGAGGTCAAGAGATCGAGACCATCCTGGTCAACATGGTGAAACCCTGTCTCTACTAAAAATACTAAAAATTAGCTGGGCATGGTGGCGTGTGCCTGTAATCCCAGCTACTCAGGAGGCTGAGGCAGGAGAATTGCCTGAACCCAGGAGGCGGAGGTTGCGGTGAGCCGAGATCGCGCCATTGCACTCCAGCCTGGGCAACAAGAGCGAAACTCTGTCTCAAAAAAAAAAAATAAATAAATAAAATAAAATAAAATAAAATAAAATAAAAT"
"chr19","1465612","1466244","JH378118","18053084","18053501","284","16587472","GGCTGGGGACGGTGGCTCAGGCCTGTAACCCCAGCACTTTGAGAGGACCAGGAGGGAGGATTGCTTGAGCCCAGGAGTCCGAGACCAGCCTGGGCAGCAAAGCAAGGCCCTGTCTCTACAAAAATACTTTAAAATTAGCCAAGTGTTGGCTGGGTGCGGTTGCTCATGCCTATAATCCCAGCACTTTGGGAGGCCGAGGTGGGTGGATCACCTGAGGTCAGGAGTTTGAGACCAGCCTGGCCAACATGGCAAAACCCCGTCTCTACTAAAAATACGAAAATTAGCCAGACGTGGTGGCTCATTCCTGTAATCCCAGCTACTCGGGAGGCTGAGGCAGGAGAATCGCTTGAACTCGCAAGGCGGAGGTTGCAGTGAGCCAAGATCATGCCATTGCATTCCAGCCTGGGTGACAGAGCAAAACTCCGTCTCAAAAAAAAAAAAAAAAAAAAAAAATTAGCCAGGCGTGGTGGTGGGCACCTGTAGTCCCAGCTACCCGGGAGGCTGAGGCAGGAGAATCGCTTGAGCCCGGGAGGCAGAGGTTACAGTGAGCCGAGATCGTGCCATTGCACTCCAGCCTGGGCAACAAGAGTGAAAATCCGTCTCAAAAAAATAAATAAATACAAAATAAAAAAA","GGCTGGGCGCAGTGGCTCACACCTGTAATCCCAGCACTTAGGGAAGCTGAGGCGAGTAGATCACCTGAGGTCAGGAGTTAGAGACCAGCCTGGCCATCATGGTGAAACCCCGTCTCTACTAAAGATACCAAAAATTAGCTGAGTGTGGTGCTGGGTGCCTGTAATCCCAGAAACTCAGGGTGCCTGTAATCCCAGCAACTCAGGGTGCCTTTAATCCCAGCAACTGAGGGTACCAGTAATCCCAGCAACTCAGGGTGTCTTTAATCCTAGCAACTGAGGGCACCTGTAATCCCAGCAACTCAGGAAGCTGAGACAGGAGAAGTACTTGAACCCAGAAGGCAGAGGTTGCAGTGAGCCGATATTGCACCATTGCACTCCAGTCTGGGCAACAAGAGTGAAACTCTGTCTCAAAAAAAAA"
"chr19","1761610","1762212","JH378118","18053084","18053501","248","16291474","GGCCGGGTGCGGTGGTTTACACCTGTAATCCTGGCATTTTGGGAGGCCGAGGCAGGAGTATCACCTCAGGTCAGGAGTTCAAGACCAGCCTGGCCAACATGGTGATACTCCGTCTCTACTAAAAATACAAAAATTGGCCGAGTGCAGTGGCTCACACCTGTAATCCCAGCACTTTGGGAGGCCGAGGCAGGTGGATCATGAGGTCAGGAGTTCGAGACCAGCCTGGCCAAGATGGTGAAACCCCGTCTCTACTAAAAATACAAAAATCAGCTGGGTGTGGTGGCGGGTGCCTGTAATCCCAGCTACTCGGGAGGCTGAGGCAGGAGAATTGCTTGGACCTGGGCAGCAGAGGTTGCAGCGAGCTGAGATGGCGCCACTGCACTCCAGCCTGGGCGACAGAGCGAGACTCTTGTCTCAGAAAAATAAAAAATAAAAAAATTAGCTGGGTGTGGTGGTGCGCACCTGTAATCCCAGCTACTCGGGAGGCTGAGGCAGGAGAATCGCTTGAATCTGGGAGGAGGAGGAGGTTGCAGTGAGCTGAGATAGTGCCAGTGCAGGCCAGCCTGGTCAACAAGAGTGAAACTCCGTCTCAGAAAAAAAAAA","GGCTGGGCGCAGTGGCTCACACCTGTAATCCCAGCACTTAGGGAAGCTGAGGCGAGTAGATCACCTGAGGTCAGGAGTTAGAGACCAGCCTGGCCATCATGGTGAAACCCCGTCTCTACTAAAGATACCAAAAATTAGCTGAGTGTGGTGCTGGGTGCCTGTAATCCCAGAAACTCAGGGTGCCTGTAATCCCAGCAACTCAGGGTGCCTTTAATCCCAGCAACTGAGGGTACCAGTAATCCCAGCAACTCAGGGTGTCTTTAATCCTAGCAACTGAGGGCACCTGTAATCCCAGCAACTCAGGAAGCTGAGACAGGAGAAGTACTTGAACCCAGAAGGCAGAGGTTGCAGTGAGCCGATATTGCACCATTGCACTCCAGTCTGGGCAACAAGAGTGAAACTCTGTCTCAAAAAAAAA"
"chr19","2871458","2872098","JH378118","18053084","18053501","282","15181626","GGCCGGGCGCGGTGGCTCACGCTTGTAATCCCAGCACTTTGGGAGGCCTAGGTAGTGGATCACCTGAGGTCAGGAGTTTGAGACCAGCCTGGCCAACATGGGGAAACCCAGTCTCTACTAAAAATACAAAAATGAGGCCGGGTGCAGTGGCTCATGCCTGTAGTCTCAACACTTTGGGAGACCAAGGCAGGCGGATCACCTGAGGTCAGGAGTTCAAGCCCAACCTGGCCAACATGGTGAAACCCTGCCTCTTCTAAAAATACAAAAATTAGCCAGGTGTGGTGGCATGTACCTGCAATCCCAGCTGCTTAGGAGTTCGAGATAGAAGGATTGCCTGAACCTGGGAGGCGGAGGTTGCAGTGAGCTGAGATCATGCCATTGCACTCCAGCCTGGGTGACAGAGACCCTGTCTCACACACACACACACAAATTATATATATATATATATATATACACACACACACACACGCACACACAAATTGGCCAGGCGTGGTGGCGGGTGCCTATAATTCCAGCTACTTGGGAGGCTGAGGCAGGAGAATGTCTTGAACCCGGGAGGTGGAGGTTGCAGTGAGCCGAGATTGCGCCACTGCACTTTAGCCTGGACGACAAGAACAAAACTCCATCTCAAAAAAACGAAA","GGCTGGGCGCAGTGGCTCACACCTGTAATCCCAGCACTTAGGGAAGCTGAGGCGAGTAGATCACCTGAGGTCAGGAGTTAGAGACCAGCCTGGCCATCATGGTGAAACCCCGTCTCTACTAAAGATACCAAAAATTAGCTGAGTGTGGTGCTGGGTGCCTGTAATCCCAGAAACTCAGGGTGCCTGTAATCCCAGCAACTCAGGGTGCCTTTAATCCCAGCAACTGAGGGTACCAGTAATCCCAGCAACTCAGGGTGTCTTTAATCCTAGCAACTGAGGGCACCTGTAATCCCAGCAACTCAGGAAGCTGAGACAGGAGAAGTACTTGAACCCAGAAGGCAGAGGTTGCAGTGAGCCGATATTGCACCATTGCACTCCAGTCTGGGCAACAAGAGTGAAACTCTGTCTCAAAAAAAAA"
"chr19","2912949","2913566","JH378118","18053084","18053501","268","15140135","GGCTGGGCGTGGTGGCTCACACCTGTAATCCCAGCACTTTGGGAGGCCAAGGTGGAGGGACTGCCTGAAGCCAGGGGTTCGAGACCAGCCTGGCCAACATGGTGAAACCCTGTCTCTACTAAAAATAGAAAAATTAAGGCCGGGCGCGGTGGCTCATGCCTGTAATCCCAGCACTTTGGAAGGCCGAGGCGGGCGGATCACTTGAGGTCGGGAGTTCAAGACCAGCCTGACCAACATGGAGAAACCCTGTCTCTACTAAAAATACAAAATTAGCCAGGGTGGTGGCGCATGCCTGTAATCCCAGCTACTTGGGAGGCTGAGGCAGGAGAATCGCTTGAACCCGGGAGGTGGAGGTTGCAGTGAGCTGAGATCGCACCATTGCACTCCAGCCTGGGCAACAAGAGCAAAACCACGTCTCAAAAAAAATAAAAATAAAAATAAAAAAATTAGCTGGGTGTGGTGGCAGGCGCCTGTAGCTGCTTGGGAGGCTGAGACAGGAGAATTGCTTGAACCTGGGAGGCGGAGGTTGCAGTGAGCTGAGACCGTGCCATTGCACTCCAGGCTGGGCAAGAAGAGCAAAACTCTATCCTTCCCCCACTCCAAAAAAAAAAAAAAAAA","GGCTGGGCGCAGTGGCTCACACCTGTAATCCCAGCACTTAGGGAAGCTGAGGCGAGTAGATCACCTGAGGTCAGGAGTTAGAGACCAGCCTGGCCATCATGGTGAAACCCCGTCTCTACTAAAGATACCAAAAATTAGCTGAGTGTGGTGCTGGGTGCCTGTAATCCCAGAAACTCAGGGTGCCTGTAATCCCAGCAACTCAGGGTGCCTTTAATCCCAGCAACTGAGGGTACCAGTAATCCCAGCAACTCAGGGTGTCTTTAATCCTAGCAACTGAGGGCACCTGTAATCCCAGCAACTCAGGAAGCTGAGACAGGAGAAGTACTTGAACCCAGAAGGCAGAGGTTGCAGTGAGCCGATATTGCACCATTGCACTCCAGTCTGGGCAACAAGAGTGAAACTCTGTCTCAAAAAAAAA"
"chr19","3601333","3601668","JH378148","10302642","10302970","47","6701309","GCTGGGCGTGGTGGCTCACACCTGTAATCCCAGCACTTTGGGAGGCTGAGGTGGGCGGATCACGTGAGGTCAGGAGTTCCAGACTAGCCTGGCCAACATGGGGAAACCCCATCTCTGCTAAAAATAAAAAATTTAGCCGAGTGTGGTGGTGGGTGCCTGTAATCCCAGCTACTCAGGAGGCCGAGGCAGGAGAATTGCTTGAACCCAGGAGGCAGAGGTTGCAGTGAGCCGAGATCACGCCATTGCACTCCAGCCTGGATGACAACAGTGAGACTCCAACTCAAAAAATAATAATAATAATAATAATAATAATAAAATAAAACAATAAAAAAAAAA","GGCCGGGCGCGGTGGCTCAAGCCTGTAATCCCAGCACTTTGGGAGGCCGAGGCGGGTGGATCACGAGGTCAAGAGATCGAGACCATCCTGGTCAACATGGTGAAACCCCGTCTCTACTAAAAATACAAAAAATTAGCTGGGCATGGTGGTGGGTGCCTGTAATCCCAGCTACTCAGGAGGCTGAGGCAGGAGAATTGCCTGAACCCAGGAGGCGGAGGTTGCGGTGAGCCGAGATCGCGCCATTGCACTCCAGCCTGGGTAACAAGAGTGAAACTCTGCCTCAAAAAAAAAAAATAAAATAAAATAAAATAAAATAAAATAAAATAAAA"
"chr19","4440800","4441421","JH378118","18053084","18053501","276","13612284","GGCTGGGTGCGGTGGCTCATGCCTGTAATCCCAGCACTTTGGGAGGCCAAGCGGGCAGATCAACTGAGGTCAGGAGTTCGAGACCAGCCTGGCCAACATAGTAAAACCCTGTTTCTACTAAAAAAAAAAAAAAAAAAAAAAAAAAAATTGGCTGGGCGCAGTGGCTCACGCATGTAATCCCTGCACTTTGGGAGGCCAAGGCAGGTGGATCACCTGAGGTCAGTAGTTTGAGACCAGCCTGACCAACGTGGAGAAACCCCATCTCTACTAAAAATACAAACAAAAAAAACAAAAAACAAAAAAAACCGGGTATGGTGGTACATCCCTGTAATCCCAGCTCCTCGGGAGGCTGAGGCAGGAGAATCACTTGAACCCGGGAGGCGGAGGTTGCACTGAGCCGAGATTGCGCCACTGCACTCCAGCCTGGGCGATAGAGCGAGACTCCCTCTTAAATAATGATTATAATTGCCAGGTGTGGTGGCGGGTGCCTGTAATCCCAGCTACTTGGGAGGCTGAGGCAGGAGAATCGTTTGAATCCAGGAGGAGGAGGTTGCAGTGAGCCGAGATGGTGCCACAGCACTCCAGCCTGGGTGACAAGAGTGAAACCCCATTACAAACAAAA","GGCTGGGCGCAGTGGCTCACACCTGTAATCCCAGCACTTAGGGAAGCTGAGGCGAGTAGATCACCTGAGGTCAGGAGTTAGAGACCAGCCTGGCCATCATGGTGAAACCCCGTCTCTACTAAAGATACCAAAAATTAGCTGAGTGTGGTGCTGGGTGCCTGTAATCCCAGAAACTCAGGGTGCCTGTAATCCCAGCAACTCAGGGTGCCTTTAATCCCAGCAACTGAGGGTACCAGTAATCCCAGCAACTCAGGGTGTCTTTAATCCTAGCAACTGAGGGCACCTGTAATCCCAGCAACTCAGGAAGCTGAGACAGGAGAAGTACTTGAACCCAGAAGGCAGAGGTTGCAGTGAGCCGATATTGCACCATTGCACTCCAGTCTGGGCAACAAGAGTGAAACTCTGTCTCAAAAAAAAA"
"chr19","5462237","5462567","JH378255","1377129","1377437","56","4085108","GACCAGGTGCGGTGGCTCACGCCTGTCATTCCAGCACTTTGGGAGGCCGAGGGGGGCGTGGATCACTTGAGGTCAGGAGTTCAAGACCAGCCTGACCAACATGGTGAAACTCCGTCTCTACTAAAAATACAAAAATTAGCCAGGTGTGGTGGCACATGCCTGTAATCCCAGCTACTTGGGAGGCTGAGGCAGGAGAATCACTTGAACCTGGGAGATGGAGGTTTCATTCAGTGAGCTGAGATTGCACCATTGCACTCCAGCCTGGGTGACAAGAACGAAACTCTGTCTCAGAACACACACACACACACACACACACACACCCCAGAAAAAA","GGCCTGGCGTGGTGGCTCACGCCTGTAATCTCAGCACTTTGGGAGGCCAAGGTGGGTGGATCACCTGAGGTCAGGAGTTCAAGACCAGCCTGGCCAACATGGTGAAACCCCGTCTCTACTAAAAATACAAAAATTAGCTGGGTGTGGTGGCAGACACCTGTAATTCCAGCTACTTGGGAGGCTGAGGCAGGAGAATAGCTTGAACCTGGGAGGTGAGGGTTGCAGTGAGCCGAGATCGCACCATTTTACTCCAACCTGGGCAACAAGAGCGAAACTCCGTCTCAAAATCCAAACAAACCAAAACAAAAA"
"chr19","8011731","8012413","JH378118","18053084","18053501","321","10041353","GGCCGGGTACAGTGGCTCACTCCTGTAATCCCAGAACTTTGGGAGACCGAGGTGGGGGGATCACTTGAGGTCAGGAGTTCGAGACCACCCTGGCCAATATAGTGCTAAACCCCATCTCTACTCAAAATACAAAAAAAAAAAAAAAAAAAAAAAAAAAGCAAAACCCAGGCTGGGCACAGTAGCTCATACCTGTAATCCCAGCACTTTGGGAGGCTGAGGTGGGTAGATCATGAGGTCAGGAGTTCGAGACCAGCCTGACCAACATGGTGAAACCCCGTCTCTACTAAAAATACAAAAATTAGCCGGGCATGGTGGTGCGTGCCTGTAATCCCAGCTACTCAGGAGGCTGAGGCAGGAGAATCGCTTGAAGCTGGGAGGCAGAGGTTGCAGTGAGCCGAGATCGTGCTACTGTACTCCAGCCTGGGCAACAGGGCGACAGAGCAAGACTCTGTCTCAAAAAAAAAAAAAAAAAAAAAAAAAAGCAAAACCCCATCTCTACTAAAAATACAAAAAATTAGCCAGGCATGGTGGCATGTGCCTGTAATCCCAGCTACTCGAGAGGCTGAGGCAGAAGAATCACTTGAACCCAGGAGGCAGAGGTTGCAGCGAGCCAAGATTGTGCCATTGCACTCCAATCTGGGTGACAAGAGTAAAATCCTGTCTCAAAAAAATAAAAAATAAAA","GGCTGGGCGCAGTGGCTCACACCTGTAATCCCAGCACTTAGGGAAGCTGAGGCGAGTAGATCACCTGAGGTCAGGAGTTAGAGACCAGCCTGGCCATCATGGTGAAACCCCGTCTCTACTAAAGATACCAAAAATTAGCTGAGTGTGGTGCTGGGTGCCTGTAATCCCAGAAACTCAGGGTGCCTGTAATCCCAGCAACTCAGGGTGCCTTTAATCCCAGCAACTGAGGGTACCAGTAATCCCAGCAACTCAGGGTGTCTTTAATCCTAGCAACTGAGGGCACCTGTAATCCCAGCAACTCAGGAAGCTGAGACAGGAGAAGTACTTGAACCCAGAAGGCAGAGGTTGCAGTGAGCCGATATTGCACCATTGCACTCCAGTCTGGGCAACAAGAGTGAAACTCTGTCTCAAAAAAAAA"
"chr19","8026835","8027736","JH378118","18053084","18053501","522","10026249","GCGCGGTGGCTCATGCCTGTAAACCCAGCACTTTGGGAGGCTGAGGTGGGTGGATCACCTGAGGTCAGGAGTTTGAGACCAGCCTGGCCAATATGGTGAAACCCGTCTCTACTAAAACATACAAAAATTAGGCTGGGCGCGGTGGCTCATGCCTTTAATCCCAACACTTTGGGAGGCCGAGGCGGGCGGATCACGAGGTCAGGAGTTTGAGACCATCCTGGCTAACATGGTGAAAGCCCGTCTCTACTAAAAATATAAAAATTAGCTGGGCGTGGTGGTGGGCACCTGGAGTCCCAGCTACTTGGGAGGCTGAGGCAGGAGAATGGCGTGAACCCGGGAGGCGGAGCTTGCAGTGAGCCAGGATCACGCCACTGCACTCCAGCCTGGGCGACAGAGCGAGACACCGTCTCAAAAAAAAAACAACAAAAATTAGCCAGGCATGGTGGTGGGCGCCTTTTTTTTTTTTTTTTTCAGAGTCTCACTCTGTCACCCAGGCTGGAGTGCAGTGGCTCAATCTCGGTTCACTGCAACCTCCGCCTCCCAGGTTCAAGCGATTCTCCTGCCTCAGCCTCCCGAATAACTGGGATTACAGGCACCCGCCACTACAACCAGCTAATTTTTGTATTTTTAGTAGAGATGGGGTTTCGCCATGTTGGCCAGGATGGTCTTGATCTCTTGACCTCGTGATCCACCCTCCTTGGCCTCTCAAAGTGCTGGGATTACAGGTGTGAGCCACTGTTCCCAGCTGATAGTGGGCACTTTTAATCCCAGCTACTCCGGAGGCTGAGGCAGGAGAATTGCTTGAACCCAGGAGGTGGAGGTTGCAGTGAGCCAAGATCGCGCCATTGCACTCCAGCCTGGGTGACAATAGCAAAACTCTGTCTCAATGAAACAAAACAAAA","GGCTGGGCGCAGTGGCTCACACCTGTAATCCCAGCACTTAGGGAAGCTGAGGCGAGTAGATCACCTGAGGTCAGGAGTTAGAGACCAGCCTGGCCATCATGGTGAAACCCCGTCTCTACTAAAGATACCAAAAATTAGCTGAGTGTGGTGCTGGGTGCCTGTAATCCCAGAAACTCAGGGTGCCTGTAATCCCAGCAACTCAGGGTGCCTTTAATCCCAGCAACTGAGGGTACCAGTAATCCCAGCAACTCAGGGTGTCTTTAATCCTAGCAACTGAGGGCACCTGTAATCCCAGCAACTCAGGAAGCTGAGACAGGAGAAGTACTTGAACCCAGAAGGCAGAGGTTGCAGTGAGCCGATATTGCACCATTGCACTCCAGTCTGGGCAACAAGAGTGAAACTCTGTCTCAAAAAAAAA"
"chr19","9069244","9069863","JH378118","18053084","18053501","266","8983840","GGCCGGGCACGGTGGCTCATTCCTGTAGTCTCTGTACTTTAGGAGGCTGAGGTGGGTGGATCACTTGAGGTCAGGAGTTCCAGACCAGTCTGGCCAAAATGGTGAAACCCCGTCTGTACTAAAAATACAAAAAAAAAGGCCGGGCGCGGTGGCTCACGCCTGTAATCCCAGCACTTTGGGAGGCTGAGGTGGGTGGATCACAAGGTCAGGAGATTGAGACCATCCTGGCTAACATGGTGAAACCCCGTCTCTACTAAAAATACAAAAAATTAGCTGAGTGTGGTAGCAGGCACCTGTAATCCCAGCTACTCAGGAGGCTGAGGTGGGAGAATGGCATGAACCCAGGAAGCAGAGCTTGCAGTGAGCTGAGATCATGCCACTGCACTCCAGCCTGGGTGACAGAGCGAGACTCCATCTCAAAAAAAAAAAATACAAAAAAATTAGCCAGGCGTAGTGGTGCATGCTTGTAGTCTCGGCTACTCAGGAGACTGACGCAGGAGAATCACTTGAACCCAGGAGGCGGAGGTTGCAGTGAGCCGAAATTATGCCATTGCACTCCAGCCTGGGAGACAAGAACAAAACTCTATCTCAAAAACCAACCAACCAAACAAACAAAAAAA","GGCTGGGCGCAGTGGCTCACACCTGTAATCCCAGCACTTAGGGAAGCTGAGGCGAGTAGATCACCTGAGGTCAGGAGTTAGAGACCAGCCTGGCCATCATGGTGAAACCCCGTCTCTACTAAAGATACCAAAAATTAGCTGAGTGTGGTGCTGGGTGCCTGTAATCCCAGAAACTCAGGGTGCCTGTAATCCCAGCAACTCAGGGTGCCTTTAATCCCAGCAACTGAGGGTACCAGTAATCCCAGCAACTCAGGGTGTCTTTAATCCTAGCAACTGAGGGCACCTGTAATCCCAGCAACTCAGGAAGCTGAGACAGGAGAAGTACTTGAACCCAGAAGGCAGAGGTTGCAGTGAGCCGATATTGCACCATTGCACTCCAGTCTGGGCAACAAGAGTGAAACTCTGTCTCAAAAAAAAA"
"chr19","9785992","9786608","JH378118","18053084","18053501","261","8267092","GGCCGGGAACGGTGGCTCACACCTATAATCCCAGCACTTTGGGAGGCCGAGGCAGGTGGATCACCTGAGGTCAGGAGTTCAAGACCAGCGTGGCCAACATAATGAAACCCCATCTTGGCCGGGTGCGGTGACTCACGCCTGTAATCCCAGCACTTTGGGAGGCCAAGGCGGGTGGATCACGAGGTCAGGGGATCGAGACCATCCTGGCTAACACAGTGAAACCCTGTCTCTACTAAAAATACAAAAAAATTAGCTGGGCATGGTGGCGGACGCCTGTAGTCCCAGCTACTCGGGAGGCTGAGGCAGGAGAATGGTGTGAACCTGGGAGGCAGAGCTTGCAGTGAGCCGAGATTGCGCCACTGCACTCCAGCTTGGGTGACAAAGTGAGACTCCATCTCAAAAAAAAAAAAAGAAACCCCATCTCTACTAAAAATACAAAAAATTTGCTGGGTGTGGTTGTGGGCACCTGTAATCCCAGCTACTTGGGAGGCTGAGGCAGGAGAATCACCTGAACCCAGGAGGCAGAGGTTGCAGTGAGCCGAAACAGTGCCATTGCACTCCAGCCTGGGCAACAAGAGTGAAACTCAATCTCAAAAAAAAAAAAAAAAGTACAAAAA","GGCTGGGCGCAGTGGCTCACACCTGTAATCCCAGCACTTAGGGAAGCTGAGGCGAGTAGATCACCTGAGGTCAGGAGTTAGAGACCAGCCTGGCCATCATGGTGAAACCCCGTCTCTACTAAAGATACCAAAAATTAGCTGAGTGTGGTGCTGGGTGCCTGTAATCCCAGAAACTCAGGGTGCCTGTAATCCCAGCAACTCAGGGTGCCTTTAATCCCAGCAACTGAGGGTACCAGTAATCCCAGCAACTCAGGGTGTCTTTAATCCTAGCAACTGAGGGCACCTGTAATCCCAGCAACTCAGGAAGCTGAGACAGGAGAAGTACTTGAACCCAGAAGGCAGAGGTTGCAGTGAGCCGATATTGCACCATTGCACTCCAGTCTGGGCAACAAGAGTGAAACTCTGTCTCAAAAAAAAA"
"chr19","9897689","9898264","JH378206","6546474","6546861","233","3351215","GCCAGGCACGGTGGCTCACACCTGTAATCCCAGCACTTTGGGAGGCCAAGGTGGGTGGATCACCTGAGGTCAGGAGTTCAAGACCAGCCTGACCAACATGGTGAAACCCAGGGCTCACACCTGTAATCCCAGCGCTTTGGGAGGCTGACGCGGGCAGATCACGAGGTCAGGAGATCGAGACCATCCTGGCTAACATGGTGAAACCCCGTCTCTACTAAAAATACAATAATTAGCTGGGCATGGTGGTGGGTGCCTGCAGTCCCAGCTACTTGGGAAGCTGAGGCAGGAGAATGGCGTGAACCCAGGAGGTGGAGCTCTCAGTGAGCTGAGATTGCATCACTGCACTTCCAGCCTGGGTGACAGAGCAAGACTCTGTCTCAAAAAAAAAAAAAAAAAAAAAAAAAATTAGCCAGGTGTGATGGCAGGCACCTGTAATCCCAGCTACTTAGGAGGCTGAGGCAGGAGAACCCAGGAGGCAGAGGTTGCAGTGAGCCAAGATCGCGCCATTGCACTCCAGCCTGGGTGACAAGAGCAAAATTCCATCTCAAAAAAAAAAAAAAAGAAGAAAAAGAAGAA","GGCCACACATGGTGGCTAACGCCTGTAATCCCAGCACTTTGGGAGGCCAAGTCGGGTGGATCATGAGGTCAGGAGACCAAGACCATCCTGGCCAAATGGTGAAACCCCGTCTCTACTAAAAATACAAAAATTAGCTGGGCATGGTGGCGTGTGCCTGTAATCCCAGCTACTCAGGAGGCTGAGGCAGGACAATTGCCTGAACCCAGGAGAATTAGCTGGGCATGGTGGCGTGTGCCTGTAATCCCAGCTACTCAGGAGGCTGAGGCAGGACAATTGCCTGAACCCAGGAGGCGAAGGTTGCGGTGAGCCGAGATTGTGCCATTGCACTCCAGCCTGGGTAACAAGAGCGACACTCTGTCTCAAAAAAAAAAAAAAAAAAAAAAAAAAA"
"chr19","10210761","10211695","JH378118","18053084","18053501","553","7842323","GGCCGGGTGTGGTGGCTCATGCCTGTAATCCCAGGCATGATTTGGGAGGCCGAGGGAGGCAGATCACCTGAGGTCAGGAGTTTTTTTGTTTTGTTTTGTTTTGTTTTTGAGACAGAGTCTTGTTCTGTTGCCCAGGCTGGAGTGCAATGATGTGATCTCGACTCACTACAACCTCCACCTCCTGAGTTCAAGCGATTCTGCTGCCTCAGCCTCCCGAGTAGCTGGCATTACAGGCATGTGCCACCAAGCCTGGCTAATTTTTGTATTTATAGTAGAGACGGGGGTTTCACCATGTTGATCAGGCTGGTGTCGAACTCCTGGCCTCAAGTGATCCGCTCGCCTTGGCCTCCCAAAATGCTGGGATTACAGATGTGAGCCACTGTGCCCAGCCAAGGTCAAGAGTTTGAAACCAGCCTGGCCAGCATGGTGAAACCCTATCTCTACTAAAAATACAAAATCAGTCCATGTGCCTAATTTTGGGATCACACCTGGGATCATGCCTGCAATCCCAGCACTTTGGGAGGCCAAGGCGGGTGGGTCATGAAGTCAGGAGTTCAAGACCAGCCTGGCCAACATGGTGAAACCCTGTCTCTACTAAAAATACAAAAGTTAGCTGGGCGTGGTGGCACGCACCTGTAGTCCCAGCTACTAGGAAGGCTGAGGCAGGAGAATTCTTGAACCCGGGTGATGGAGGTTGCAGTGAGCCGAGATTGCGCCACTGCACTCCAGCCTGGGCAACAGAGTGAGACTCTGTCTAAAAAAAAAATTAGTCAGGCGTGGTGGTGAGCACCTGTAATCACAGCTACTGGGGAGGCTGAGGCTGGAGAATTGCTTGAACCCGGGAGGCGGAGGTTGCAGTGAGCCAAGATCGCGCCTTTGCACTCCAGCCTGGGCAACAGGAGTGAAACTGCATCTCAAAAAAAAAAAAAAAAAAA","GGCTGGGCGCAGTGGCTCACACCTGTAATCCCAGCACTTAGGGAAGCTGAGGCGAGTAGATCACCTGAGGTCAGGAGTTAGAGACCAGCCTGGCCATCATGGTGAAACCCCGTCTCTACTAAAGATACCAAAAATTAGCTGAGTGTGGTGCTGGGTGCCTGTAATCCCAGAAACTCAGGGTGCCTGTAATCCCAGCAACTCAGGGTGCCTTTAATCCCAGCAACTGAGGGTACCAGTAATCCCAGCAACTCAGGGTGTCTTTAATCCTAGCAACTGAGGGCACCTGTAATCCCAGCAACTCAGGAAGCTGAGACAGGAGAAGTACTTGAACCCAGAAGGCAGAGGTTGCAGTGAGCCGATATTGCACCATTGCACTCCAGTCTGGGCAACAAGAGTGAAACTCTGTCTCAAAAAAAAA"
"chr19","10485431","10486007","JH378118","18053084","18053501","237","7567653","GGCCGGGCGCAGTGGCTCATGCCTAATCCCAAGACTTTCAGAGGCTGAGGCAGGTGGATCACCTGAGGTCAGGAGCTCAAGACCAGCCTGGCTAACATTGTGAAACCGCGTCTCTACTAAAAATCAAAATTGGCCGGGCACGGTGGCTCACACCTGTAATCCCATCCCTCTGGGAGACCGAGGCGGGCAGATCACCTAAGGTCAGGAGTTCGAGACCAGCCTGACCAACATGGAGAAAACCCTTCTCTGCTAAAAATACAAAATTAGCCGGGCGTGGTGGCGCATGCCTGTAACCTCAGCTACTCGGGAGGCTGAGGGAAAATCGCTTGAACCTGCCAGGTGGAGGTTGCAGTGAGCCGAGATCGAGCCATTGCACTCCAGCATGGGCAACGAAAGCGAAACTCCATCTCAAAAAAAAAAAAAATTAGCTAGGCGTGGTGGCGCGTGCCTGTATTCCCAGCTACTCAGGAGGCTGAGACAGGAGAATCACTTGAACCTGGGAGGCAGAGGTTGCAGTGAGCCAAGATTGCACCATTGCACTCCAGCCTGGGCAACACGAGCAAAACTCTGTCTCAAA","GGCTGGGCGCAGTGGCTCACACCTGTAATCCCAGCACTTAGGGAAGCTGAGGCGAGTAGATCACCTGAGGTCAGGAGTTAGAGACCAGCCTGGCCATCATGGTGAAACCCCGTCTCTACTAAAGATACCAAAAATTAGCTGAGTGTGGTGCTGGGTGCCTGTAATCCCAGAAACTCAGGGTGCCTGTAATCCCAGCAACTCAGGGTGCCTTTAATCCCAGCAACTGAGGGTACCAGTAATCCCAGCAACTCAGGGTGTCTTTAATCCTAGCAACTGAGGGCACCTGTAATCCCAGCAACTCAGGAAGCTGAGACAGGAGAAGTACTTGAACCCAGAAGGCAGAGGTTGCAGTGAGCCGATATTGCACCATTGCACTCCAGTCTGGGCAACAAGAGTGAAACTCTGTCTCAAAAAAAAA"
"chr19","10538873","10539199","JH378118","15020968","15021286","46","4482095","GCTGGGCGCGGTGGCTCACGCCTGTAATCCCAGCACTTTGGGAGGCTGAGGCAGGCAGATCACCTGAGGTCAGGAGTTCAAGACCAGCCTGGTTAACACAGTGAAACCCCCGTCTCTACTAAAAATACAAAAACAAAAATTAGCCGGGTGTGGTGGCGGGCGCCTGTAATCCCAGTTACTCGGGAGGCTGAGGCAGGAGAATCGCTTGAACCCGGGAGGCGGAGGTTGTGGTGAGCCGAGATTGCCATTGCACTCCAGCCTGGGCAAAAAGAGCGAAACTCCATCTAAAACAAACAAACAAACAAACAAACAAAAAATAGAAAAGAA","GCCGGGCGCGGTGGCTCAAGCCTGTAATCCCAGCACTTTGGGAGGCTGAGGCGGGTGGATCCCGAGGTCAAGAGATCGAGACCATCCTGGTCAACATGGTGAAACCCCGTCTCTACTAAAAATACAAAACATTAGCTGGGTATGGTGGCGCGTGCCTGTAATCCCAGCTACTCAGGAGGCTGAGGCAGGAGAATTGCCTGAACCCAGGAGGCGGAGGTTGCGGTGAGCTGAGATCGCGCCATTGCACTCCAGCCTGGGTAACAAGAGCGAAACTTCCATCTCAAAAACAAACAAACAAACAAACAAACAAAAAACAAAC"
"chr19","10973032","10973651","JH378118","18053084","18053501","265","7080052","GGCTGGACGTGGTGGCTCACGCCTGTAATCCCAACACTTTGGGAGACCAAGGCAGGTGGATCGCCTGAGGTTAGGGGTTCGAGACCAGCCTGACCAACATGGTGAAACCCCATCTCTACTAATAATAAAAAAATTAGGACCAGGCTTGGTGGCTCATGCCTGTAATTCCAACACTTTGGGAGGCCAAGGCGAGTGGATAACTTGAGGTCAGGAGTTTGAGACCAGCCTGGCCAACATGGTGAAACCTCATCTCTACTAAAAATACAAAAATTAGCCGGCATGGTGGCGGGCACCCGTAATCCCAGCTACTCGGTGTGGGGGCTGGGACAGGAGAATCGCTTGAACCCAGGAGGTGGAGGTTGCCGTGAGCTAAGATTGCGCCACTGCACTCTAGTTGGGGCAACAGAGCGGACTCCGTCTCAAAAAAAAAAAAAAAATTAGCCGAGCGTGGTGGTGGACACCTGTAATCCCAGCTACTCAGGAGGCTGAGGCAGGAAAATTGAAATCGCTTAAACCTGGGAGGAGGAGGTTGCAGTGAGCCAAGATCGCACCATTGCACTCCAGCCTGGGCGACAAGAACAAAACTCCGTCTCCCCACTCCAAAAAAAAAAAAAAAAAAA","GGCTGGGCGCAGTGGCTCACACCTGTAATCCCAGCACTTAGGGAAGCTGAGGCGAGTAGATCACCTGAGGTCAGGAGTTAGAGACCAGCCTGGCCATCATGGTGAAACCCCGTCTCTACTAAAGATACCAAAAATTAGCTGAGTGTGGTGCTGGGTGCCTGTAATCCCAGAAACTCAGGGTGCCTGTAATCCCAGCAACTCAGGGTGCCTTTAATCCCAGCAACTGAGGGTACCAGTAATCCCAGCAACTCAGGGTGTCTTTAATCCTAGCAACTGAGGGCACCTGTAATCCCAGCAACTCAGGAAGCTGAGACAGGAGAAGTACTTGAACCCAGAAGGCAGAGGTTGCAGTGAGCCGATATTGCACCATTGCACTCCAGTCTGGGCAACAAGAGTGAAACTCTGTCTCAAAAAAAAA"
"chr19","11513769","11514351","JH378206","6546474","6546861","242","4967295","TCCCAGCACTTTGGGAGGCCGCGATGGGTGGATCACCTTAGGTCAGGAATTCGAGACCATCCTGGCCAACATGGTGAAACCCCGTCTCTACTAAAAACACAAAAATTAGGCCGGGCACGGTGGCTCACATCTGTAATCCCAGCACTTTGGGAGGCTGAGGTGGGCGGATCACAAGGTCAGGAGTTCAAGACCAGCCTGGCCAACATGGTGAAACCCTGTCTCTACTAAAAATACAAAAATTAACTGGGCATGGTGGCATGTGCCTGTAATCCCAGCTACTTGGGAGGCTGAGGCAGAAGAATTGCTTGAACCAGGGAGTCAGAGGTTATAGTGAGCTGAGATCGTGCGACTGCACTCCAGCCTGGTGACAGAGCGAGACTCCGTTTCAGGAAAAACAAACAAAACACAAAAATTAGCTGGGCATGGTGGCAGGCGCCTGTAATCCTAGCTACTTGGGAGGCTGAGGCAGGAGAATCGCTTGAACCCAGAAGGCAAAGGTTGCAGTGAGCTGAGATGATGCCATTGCACTCCAGCCTGGGCAACAAGTGAAACTCTGTCTCAAGAAAAAAAGTAAAAGAAAGAA","GGCCACACATGGTGGCTAACGCCTGTAATCCCAGCACTTTGGGAGGCCAAGTCGGGTGGATCATGAGGTCAGGAGACCAAGACCATCCTGGCCAAATGGTGAAACCCCGTCTCTACTAAAAATACAAAAATTAGCTGGGCATGGTGGCGTGTGCCTGTAATCCCAGCTACTCAGGAGGCTGAGGCAGGACAATTGCCTGAACCCAGGAGAATTAGCTGGGCATGGTGGCGTGTGCCTGTAATCCCAGCTACTCAGGAGGCTGAGGCAGGACAATTGCCTGAACCCAGGAGGCGAAGGTTGCGGTGAGCCGAGATTGTGCCATTGCACTCCAGCCTGGGTAACAAGAGCGACACTCTGTCTCAAAAAAAAAAAAAAAAAAAAAAAAAAA"
"chr19","11535200","11535780","JH378206","6546474","6546861","242","4988726","TCCCAGCACTTTGGGAGGCCGCGATGGGTGGATCACCTTAGGTCAGGAATTCGAGACCATCCTGGCCAACATGGTGAAACCCCGTCTCTACTAAAAACACAAAAATTAGGCCGGGCACGGTGGCTCACATTGTAATCCCAGCACTTTGGGAGGCTGAGGTGGGCGGATCACAAGGTCAGGAGTTCAAGACCAGCCTGGCCAACATGGTGAAACCCTGTCTCTACTAAAAATACAAAAATTAACTGGGCATGGTGGCATGTGCCTGTAATCCCAGCTACTTGGGAGGCTGAGGCAGAAGAATTGCTTGAACCAGGGAGTCAGAGGTTATAGTGAGCTGAGATCGTGCGACTGCACTCCAGCCTGGTGACAGAGCGAGACTCCGTTTCAGGAAAAACAAACAAAACACAAAAATTAGCTGGCATGGTGGCAGGCGCCTGTAATCCTAGCTACTTGGAGGCTGAGGCAGGAGAATCGCTTGAAACCCAGAAGGCAAAGGTTGCAGTGAGCTGAGATGATGCCATTGCACTCCAGCCTGGGCAACAAGTGAAACTCTGTCTCAAGAAAAAAAGTAAAAGAAAGAA","GGCCACACATGGTGGCTAACGCCTGTAATCCCAGCACTTTGGGAGGCCAAGTCGGGTGGATCATGAGGTCAGGAGACCAAGACCATCCTGGCCAAATGGTGAAACCCCGTCTCTACTAAAAATACAAAAATTAGCTGGGCATGGTGGCGTGTGCCTGTAATCCCAGCTACTCAGGAGGCTGAGGCAGGACAATTGCCTGAACCCAGGAGAATTAGCTGGGCATGGTGGCGTGTGCCTGTAATCCCAGCTACTCAGGAGGCTGAGGCAGGACAATTGCCTGAACCCAGGAGGCGAAGGTTGCGGTGAGCCGAGATTGTGCCATTGCACTCCAGCCTGGGTAACAAGAGCGACACTCTGTCTCAAAAAAAAAAAAAAAAAAAAAAAAAAA"
"chr19","12911527","12912140","JH378118","18053084","18053501","266","5141557","GGCCAGGCATGGTGGCTCATGCCTGTAATCCAGCACTTTGGTAGGCCAAGGTGGGTGGATGGATTACTTGAGGCCAGGAGTTCAAGACCAACCTGGCCAACATGGTGAAAACCCATCTCTATTAAAAATATAAAAGCTAGGCCAGGTGCGGTGGCTCACGCCTGTAATCCCAGCACTTTGGGAGGCTGAGGCGGGCGGATCACGAGGTCAGGAGATCGAGACCACTGTGAAACCCTGTCTCTACTAAAAATACAAAAAAAATTAGCTGGGTGGGGTGGCGGGTGCCTGTAGTCCCAGCTACTTGGGAGGCTGAGGCAGGAGAATGGCGTGAACCCGGGAGGCGGAGCTTGCAGTGAGCCGAGATCGCGCCACTGCACTCCAGCCTGGGCTACAGAGCAAGACTCCGTCTCAAAAAAAAAATAAATAAATAAATAAAAATAAAAACTAACTGGGCATGGTGGTGTGCACCTGTAATCCCAGCTACTCGGGAGGCTGAGACAGGAGAATTGCTTGAACCTGGGAGGTGGAGGTTGCAGTGAACCAAGATGATGCCATTGCACTCCAACCTGGGCAACAAGAGCAAAACTCCGTCTCAAAAAAAAAAAAAAAAAAAA","GGCTGGGCGCAGTGGCTCACACCTGTAATCCCAGCACTTAGGGAAGCTGAGGCGAGTAGATCACCTGAGGTCAGGAGTTAGAGACCAGCCTGGCCATCATGGTGAAACCCCGTCTCTACTAAAGATACCAAAAATTAGCTGAGTGTGGTGCTGGGTGCCTGTAATCCCAGAAACTCAGGGTGCCTGTAATCCCAGCAACTCAGGGTGCCTTTAATCCCAGCAACTGAGGGTACCAGTAATCCCAGCAACTCAGGGTGTCTTTAATCCTAGCAACTGAGGGCACCTGTAATCCCAGCAACTCAGGAAGCTGAGACAGGAGAAGTACTTGAACCCAGAAGGCAGAGGTTGCAGTGAGCCGATATTGCACCATTGCACTCCAGTCTGGGCAACAAGAGTGAAACTCTGTCTCAAAAAAAAA"
"chr19","13205284","13205895","JH378118","18053084","18053501","258","4847800","GCCAGGCGCAGTGGATTACGCCTGTAATCCCAGCGCTTTGGTATACCGAGGCGGGCAGATCGTCTGAGGTCAGGAGTTCAAGACCAGCCTGGAGAACATGGTGAAACCCCGTCTCTATTAAAAATACAGGCTGGGCGCGGTGGCTTACGCCTGTAATCTCAGCACTTTGGGAGGCCAAGGCGGGTGGATCACGAGGTCAGGAGATCGAGACCATCCTGGCTAACATGGTGAAACCCTGTCTCTACTGAAAATACAAAAAAATTAGTTGTGGTGGGTGCCTGTAATCCCAGCTACTCGGGAGGCTGAGGCAGGAGAATGGCGTGAACCCGGGAAGCAGAGATTGCAGTAAGCCAAGATCGCTCCACTGCACTCCAGCCTGGGCTACAGAGCAAGACTCCATCTCAAAAAAAAATAAATAAATAAAATAAAAAATTAGCCTGGCGTGGTGGCGCATGCCTGTAATCCCAGCTACTTGGGAGGCTGAGGCAGGAGAATTGCTTGAACCCAAGAGGTGGAGGTTGCAGTGAGTCGAGATTGAGCCATTGCCATCCAGCCTGGGCAACAAGAGTGAAACTCTGTCTCAAAAAAAAAGAGAGAGAAAAGAAAGTAAAA","GGCTGGGCGCAGTGGCTCACACCTGTAATCCCAGCACTTAGGGAAGCTGAGGCGAGTAGATCACCTGAGGTCAGGAGTTAGAGACCAGCCTGGCCATCATGGTGAAACCCCGTCTCTACTAAAGATACCAAAAATTAGCTGAGTGTGGTGCTGGGTGCCTGTAATCCCAGAAACTCAGGGTGCCTGTAATCCCAGCAACTCAGGGTGCCTTTAATCCCAGCAACTGAGGGTACCAGTAATCCCAGCAACTCAGGGTGTCTTTAATCCTAGCAACTGAGGGCACCTGTAATCCCAGCAACTCAGGAAGCTGAGACAGGAGAAGTACTTGAACCCAGAAGGCAGAGGTTGCAGTGAGCCGATATTGCACCATTGCACTCCAGTCTGGGCAACAAGAGTGAAACTCTGTCTCAAAAAAAAA"
"chr19","14119695","14120238","JH378206","6546474","6546861","206","7573221","ACCAGCCTGGCCAAAATGGTGAAACCCTGTCTCTACTAAAAATATTTAAAAATTGGCCAGGTGCGGTGGCTCACGCCTGTAATCCCAGCACTTTGGGAGGCCGAGGCGGGCGGATTACAAGGTCAGGAGATCGAGACCATCCTGACTAACATGGTGAAACCCCGTCTCTACTAAAAATACAAAAAATTGGCCGGGCGTGGTAGCGGGCGCCTGTAGTTCCAGCTACTCGGGAGGCTGAGGCAGGAGAATGGCGTGAACCCGGAAGGCAGAGCTTGCAGTGAGCCAAGATCGTGCCACTGCACTCCAGCCTGAGCGACAGAGCAAGACTCCATCTCAAAAAAAAAAAAAAAAAAAAAAAAAATTAAAAAATTAGCTGGGCGTGGTAGCCGGCACCTGTAATTCCAGCTACTCAGGAGGCTGGAGCACAAGAATCGCTTGAAACCAGGAGGCAGAGTTGTAGTGAGCCGAGATCGTGCCATTGCACTCCAGCCTGGGCATCAAGAGCGAAACTCCATCTCAAAAACAAAACAAAACAAAACAAAAA","GGCCACACATGGTGGCTAACGCCTGTAATCCCAGCACTTTGGGAGGCCAAGTCGGGTGGATCATGAGGTCAGGAGACCAAGACCATCCTGGCCAAATGGTGAAACCCCGTCTCTACTAAAAATACAAAAATTAGCTGGGCATGGTGGCGTGTGCCTGTAATCCCAGCTACTCAGGAGGCTGAGGCAGGACAATTGCCTGAACCCAGGAGAATTAGCTGGGCATGGTGGCGTGTGCCTGTAATCCCAGCTACTCAGGAGGCTGAGGCAGGACAATTGCCTGAACCCAGGAGGCGAAGGTTGCGGTGAGCCGAGATTGTGCCATTGCACTCCAGCCTGGGTAACAAGAGCGACACTCTGTCTCAAAAAAAAAAAAAAAAAAAAAAAAAAA"
"chr14","584088","584429","JH378109","21565230","21565567","54","20981142","GGCCGGGTACGGTGGCTCACGCCTGTAGTCCTGGCACTTTGGGAGGCCGAGGCAGGTGGATCCCCGAGGTCACGAGTTTGAGACCAGCCTGGCCAGCATGGTGAAATCCCATCTCTACTAAAAATACAAAACTTAGCCGGGCATGGTGACGTGTGCCTGTAATCCCAGCTACTTGGGAGGCTGAGGCAGGAGAATTGCTTGAACCAGGGAGGCAGAGGTTGCAGTGAGCTGAGATCATGAAACTGCAGTCCAGTCTAGGCGACAAGAGCAAAACTCCGTCTCAAAAAAATAAATAAATAAATAAATAAATAAAAAATAAAACAAACAACAAAAAAAACAAAA","GGCCGGGCGCGGTGGCTCAAGCCTGTAATACCAGCACTTTGGGAGGCCGAGGCGGGTGGATCACGAGGTCAAGAGATCGAGACCATCCTGGTCAACATGGTGAAACCCCGTCTCTACTAAAAATACAAACAATTAGCTGGGCATGGTGGCGGGTGCCTGTAATCCCAGCTACTCCAGAGGCTGAGGCAGGAGAATTGCCTGAACCCAGGAGACGGAGGTTGCGGTGAGCCAAGATCGCGCCATTGCACTCCAGCCTGGGTGACAAGAGCGAAACTCCGTCTCAATAAATAAATAAATAAATAAATAAATAAAAATAAAATAAATAAATAAATAAATAA"
"chr14","620575","620915","JH378109","21565230","21565567","56","20944655","GGCCGGGTACGGTGGCTCACGCCTGTAGTCCTGGCACTTTGGGAGGCCGAGGCAGGTGGATCCCCGAGGTCACGAGTTTGAGACCAGCCTGGCCAGCATGGTGAAATCCCATCTCTACTAAAAATACAAAACTTAGCCGGGCATGGTGACGTGTGCCTGTAATCCAGCTAACTTGGGAGGCTGAGGCAGGAGAATTGCTTGAACCAGGGAGGCAGAGGTTGCAGTGAGCTGAGATCATGAAACTGCAGTCCAGTCTAGGCGACAAGAGCAAAACTCCGTCTCAAAAAATAAATAAATAAATAAATAAATAAAAAATAAAACAAACAACAAACAAAACAAAA","GGCCGGGCGCGGTGGCTCAAGCCTGTAATACCAGCACTTTGGGAGGCCGAGGCGGGTGGATCACGAGGTCAAGAGATCGAGACCATCCTGGTCAACATGGTGAAACCCCGTCTCTACTAAAAATACAAACAATTAGCTGGGCATGGTGGCGGGTGCCTGTAATCCCAGCTACTCCAGAGGCTGAGGCAGGAGAATTGCCTGAACCCAGGAGACGGAGGTTGCGGTGAGCCAAGATCGCGCCATTGCACTCCAGCCTGGGTGACAAGAGCGAAACTCCGTCTCAATAAATAAATAAATAAATAAATAAATAAAAATAAAATAAATAAATAAATAAATAA"
"chr14","1107083","1107723","JH378118","18053084","18053501","303","16946001","GGCGTGGTGGCTCACACCTGTAATCCCAGCACTTCAGGAGGCCAAGGCAGGTAGATTGCTTGATCACAGGAGTTCAAACCAGCCATGGGCAATGTCAGGCCTCTGAGCCCAAGCTTGCACGTATCCAGATGGCCTGAAGCAACTGAAGAATCACAAAAGAAGTGAAAACAGCCAGTTCCTTCCTTAACTGATGACATTACCTTGTGAAATTCCTTCTCCTGGCTCAGAAGCTCCCCTACTGAGCACCTTGTGACCCCTGCCCCTGCCAGCCAGAGAACAATCCCCTTTGACTGTAATTTTCCACTACCTACCCAAATCCTATAAAACAGCCCCACCCCATCTCCCTTTGCTGACTCCTTTTTCGGACTAGGTCCGCCTGCACCCAGGTGATTAAAAAGCTTTATTGCTCACACAAAGCCTGTTGGTGGTCTCTTCACACGGACGCACGTGACAGGCAACATGGTGAAACCCTATCTCTATAAAAAAATAAAAATAAAAATTAGTTGGGCGTGGAGACTGAGGTGAGAGAATCCAGAGGATCCAAGAGGATCGAGTCAAGGAGGTGGAGGCCGCAGTGAGCCGAGATCGCACCGCTGCACTCCAGCCTGGGCGACAAGAGTGAAACTCTGTCTTAAAAAAAA","GGCTGGGCGCAGTGGCTCACACCTGTAATCCCAGCACTTAGGGAAGCTGAGGCGAGTAGATCACCTGAGGTCAGGAGTTAGAGACCAGCCTGGCCATCATGGTGAAACCCCGTCTCTACTAAAGATACCAAAAATTAGCTGAGTGTGGTGCTGGGTGCCTGTAATCCCAGAAACTCAGGGTGCCTGTAATCCCAGCAACTCAGGGTGCCTTTAATCCCAGCAACTGAGGGTACCAGTAATCCCAGCAACTCAGGGTGTCTTTAATCCTAGCAACTGAGGGCACCTGTAATCCCAGCAACTCAGGAAGCTGAGACAGGAGAAGTACTTGAACCCAGAAGGCAGAGGTTGCAGTGAGCCGATATTGCACCATTGCACTCCAGTCTGGGCAACAAGAGTGAAACTCTGTCTCAAAAAAAAA"
"chr14","1362660","1363231","JH378118","18053084","18053501","229","16690424","GGCTGGGCACAGTGGCTTATACCCATAATCTCAGCAGTTTGGGAGGCCAAGGCAGGTGTATCACCTGAGGTCAGGAGTTCGAGAAACACCATGGCCAACATGGTGAAACCCCATCTCTACTAAAAATACAAAAAGTAGGCTGGGCGTGGTGGCTCACGCCTGTAATCCCAGTACTTTGGGAGGCCGAGGCGGGCGGATCACAAGGTCAGGAAACCGAGACCATCCTGACTAACATGGTGAAACCCCGTCTCTACTAAAAATACAAAAAAAGCTAGCCGGGCATGGTGGCGGGTGCCTGTAGTCCCAGCTACTCGGGAGGCTGAGGCAGGAGAATGGCGTGACCCCAGGAGGCAGAGCTTCCAGCTTGGGTGACTCCGTCTCAAAAAAAAAAAAACAAAAACAAAAAGTAGCTGGACGTGGTGGCTGTAGACCTAGCTACTCGAGAGGCTGAGGCAGGAGAATCGCTTGAACCTAGGAGGCGGAGGTTGCGGTGAGCCGAGATCACGCTTCTGCACTCCAGCCTGGGTGACAAGAGCAAAACTCCATCTCCAAAAAAAAAAAACAAAAAAAAA","GGCTGGGCGCAGTGGCTCACACCTGTAATCCCAGCACTTAGGGAAGCTGAGGCGAGTAGATCACCTGAGGTCAGGAGTTAGAGACCAGCCTGGCCATCATGGTGAAACCCCGTCTCTACTAAAGATACCAAAAATTAGCTGAGTGTGGTGCTGGGTGCCTGTAATCCCAGAAACTCAGGGTGCCTGTAATCCCAGCAACTCAGGGTGCCTTTAATCCCAGCAACTGAGGGTACCAGTAATCCCAGCAACTCAGGGTGTCTTTAATCCTAGCAACTGAGGGCACCTGTAATCCCAGCAACTCAGGAAGCTGAGACAGGAGAAGTACTTGAACCCAGAAGGCAGAGGTTGCAGTGAGCCGATATTGCACCATTGCACTCCAGTCTGGGCAACAAGAGTGAAACTCTGTCTCAAAAAAAAA"
"chr14","2088506","2089110","JH378118","18053084","18053501","257","15964578","GGCTGGGCACTGCGGCTCACACCTGTAATCCCAGCATTTTGAGAGGCCTAGGTGGGTGGATCACCTGAGATCAGTTCAAGACCAGCCTGACCAACATGGCAAAACCCCATCTCTATTAAAAACACAAAAAACGCCCAGGAGCGGTGGCTCACACCTGTAATCCCGGCACTTTGGGAGGCTGAGGCAGGCGGATCACGAGGTCAGGAGATCGAGACCATGCTGGCTAACACGGTGAAACCCCGTCTCTACTAAAAATACAAAAAATTAGCCAGGCGTGGTGTCGGGCGCCTGTAGTCCCAGCTATTCGGGAGGCTGAGACAGGAGAATGGCATGAACCCGGGAGGCAGAGCTTGCAGTGAGCTGAGATCGCGCCACTGCACTCCAGCCTGGGCGACAGAGTAAGACTCTGTCTCAAAAAAAAAAATACAAAAAATACAAAAAACATTAGCCACATGTGGTGGTGGGTGCCTGTAATCCCAGCTACTCAGGAGGCTGAGGCTGGAGAATTGCTTGAACCCAGGAGGTGGAGGTTGTGGTGAGCCAAGATCACGCCATTGCATTCCAGCCTGGGTGACAAGAGTGAACCTCTGTCTCAAAAAAAAGAA","GGCTGGGCGCAGTGGCTCACACCTGTAATCCCAGCACTTAGGGAAGCTGAGGCGAGTAGATCACCTGAGGTCAGGAGTTAGAGACCAGCCTGGCCATCATGGTGAAACCCCGTCTCTACTAAAGATACCAAAAATTAGCTGAGTGTGGTGCTGGGTGCCTGTAATCCCAGAAACTCAGGGTGCCTGTAATCCCAGCAACTCAGGGTGCCTTTAATCCCAGCAACTGAGGGTACCAGTAATCCCAGCAACTCAGGGTGTCTTTAATCCTAGCAACTGAGGGCACCTGTAATCCCAGCAACTCAGGAAGCTGAGACAGGAGAAGTACTTGAACCCAGAAGGCAGAGGTTGCAGTGAGCCGATATTGCACCATTGCACTCCAGTCTGGGCAACAAGAGTGAAACTCTGTCTCAAAAAAAAA"
"chr14","2164771","2165383","JH378118","18053084","18053501","243","15888313","GGCTGGGCGCAGTGGCTCACACCTGTAATCCCAGCACTCTGGGAGGCCAAGGCAGGTGGATCACCTGAGGTCAGGAGTTCGAGACCAGCCTGGCCAACATGGTGAAACCCCATCTTTACTAAAAATACAAAAATTAGCTAGGCGTGAGGCCGGGCGTGGCGGCTCATGCCTGTAATCCCAGCACTATGGGAGGCTGAGGCAGGCTGATCATGAGGTCAGGAGATTGAGACCTGGCTAACACAGTGAAACCCCGTCTCTACTAAAAATACAAAAAAAAAATAGCCAGGCATGATGGCAGGCTCCTGTAGTCCCAGCTTCTTGGGAGGCTGAGGCAGGAGAATGGTGTGAACCCGGGAGGCAGAGCTTGCAGTGAGCCGAGATCATGCCACTGCACTCCAGCCTGGGTGACAGAGCAAGACTCTGTCTCAAAAAAAAAAAAAAAAAATTAGCTAGGCGTGGTGAGGGGCACCTGGAATCCCAGCTACTCAGGAGGCTGAGGCAGGAGCATCGTTTAAACCCAGGAGGCAGAGGTTGCAGTGAGCCGAAATCACACCATTGCACTCCAGCCTGGGCAACAAGAGCAAGTCTCCATCTTAAAAAAAAAAAAAAAAAA","GGCTGGGCGCAGTGGCTCACACCTGTAATCCCAGCACTTAGGGAAGCTGAGGCGAGTAGATCACCTGAGGTCAGGAGTTAGAGACCAGCCTGGCCATCATGGTGAAACCCCGTCTCTACTAAAGATACCAAAAATTAGCTGAGTGTGGTGCTGGGTGCCTGTAATCCCAGAAACTCAGGGTGCCTGTAATCCCAGCAACTCAGGGTGCCTTTAATCCCAGCAACTGAGGGTACCAGTAATCCCAGCAACTCAGGGTGTCTTTAATCCTAGCAACTGAGGGCACCTGTAATCCCAGCAACTCAGGAAGCTGAGACAGGAGAAGTACTTGAACCCAGAAGGCAGAGGTTGCAGTGAGCCGATATTGCACCATTGCACTCCAGTCTGGGCAACAAGAGTGAAACTCTGTCTCAAAAAAAAA"
"chr14","3757666","3758004","JH378113","23438980","23439304","67","19681314","CTGGGCATGGTGGCTCATGCCTGTAATCCCAGCACTTTGGGAGACAGAGGAGGGCAGATCATCTGAGGTCAGGAGTTTGAGACCAGCCTGGCCACCATGGTGAAACCCCCGTCTCTACTGAAAATACAAAAAAATTCAGCTGGGTGTGGTAGTGGATGTCTGTAATCCTAGCTGCTTGGGAGGCTGAGACAGGAGAATCGCTTGAACCCGGGAGGTGGAGGTTGCAGTGAGCCGCCATTGCGCTCCAGCCTGGGCAACAAGAGCGAAACTCCATCTCAAAAATTAATTAATTAATTAATTAATTAAAAGTGGACTAAAGCAAAGACAAGAGAAAAAAGA","GGCAGGGTGTGGTAGCTCATGCTTGTAATCCCAGCACTTTGGGAAGTGGAGGCGGGCAGATCATCTGAGGTCAGGAGTTTGAGGCCAGCCTGGCCAACATGGTGAAACCCTGTCTCTACTAAAAATACAAAAAATTAACTGGGCGTGGTGGTGGACACCTGTAATCCCAGCTGCTTGGGAGGCTGAGGCAGGAGAATCGCTTGAACCCAGGAGATGGAGGTTGCAGTGAGCCAAGATGGCACCATTGCACTCTAGCCTGGGCAAAAAGAGTGAAACTCCGTCTCAAAAAAAAAAAAGAAAAGAAAAGAAAAGAAAAGAAAAGAAA"
"chr14","10702105","10702681","JH378118","18053084","18053501","246","7350979","GGCCAGGCGCAATGGCTCACACCTGTAATCCAAGCACTTTGGGAGGCCAGTTCAAGACCAGCCTGGCCAACATGGTGAAAACCTGTCTCTGCTAAAAATGCCAAATTTCCCAGCACTTTGGGAGGCTGAGGCGGGTGGATCACGAGGTCAGGAGATTGAGACCATCCCGGCTAACACGGTGAAACCCCATCTCTACTAAAAATAGAAAAAAATTAGCCGGGCGTGGTGGCAGACGCCTGTAGTCCCAGCTACTCTGGAGGCTGAGGGAAGAGAATGGCATAAACCCGGGAGGCGGAGCTTGCAGCGAGCTGAGATTGCGCCACTGCACTCCAGCCTGGGCGACAGAGCAAGACTCCGTCTCAAAATAAATAAATAAATAAAATTAAAATTAAAAATAAAATACAAAATTTAGCCGAGCATGGTGGTGAGCACCTATAATCCCAGCTACTTGGGAGGCTGAGGCAGAAGAATCTCTTGAACCAGGGAAGTGGAGGTTGCAGTGGGCTGAGATCCAGCCACTGTACTCCAGCCTGGGCGACAAAAGCGAAACACTGTCTAAAAAAATAAAAAATAAAAA","GGCTGGGCGCAGTGGCTCACACCTGTAATCCCAGCACTTAGGGAAGCTGAGGCGAGTAGATCACCTGAGGTCAGGAGTTAGAGACCAGCCTGGCCATCATGGTGAAACCCCGTCTCTACTAAAGATACCAAAAATTAGCTGAGTGTGGTGCTGGGTGCCTGTAATCCCAGAAACTCAGGGTGCCTGTAATCCCAGCAACTCAGGGTGCCTTTAATCCCAGCAACTGAGGGTACCAGTAATCCCAGCAACTCAGGGTGTCTTTAATCCTAGCAACTGAGGGCACCTGTAATCCCAGCAACTCAGGAAGCTGAGACAGGAGAAGTACTTGAACCCAGAAGGCAGAGGTTGCAGTGAGCCGATATTGCACCATTGCACTCCAGTCTGGGCAACAAGAGTGAAACTCTGTCTCAAAAAAAAA"
"chr14","11790883","11791455","JH378118","18053084","18053501","226","6262201","GGCTGGGTGGCCATGGCTCATGCCTGTAATCCTAGAACTTTGGGAGGCTGCGGCAGGCAAATCACCTGAAGTCAGGAGTTCAAGACCAGCCTGGCCAACATACTGAAACCCCGTCTCTCCAGGCCTGGTGGCTCATGCCTGTAATCCCAGCACTTTGGAAAGCCGAGGTGGGCGGATCACCTGAGGTCAGGAGTTCAAGACCAGTCTGACCAACATGGGGAAACCCCATCTCTACTAAAAATACAAAATTAGCTGGATGTGGTGGCACATGCCTGTATTCCCAGCTACTTGGGAGGCTGAGGCAGGAGAATCGCTTGATCCCGAGAGGTGGAGCTTGCCGTGAGCTGAGATTGTGCGCCATTGCACTCCAGCCTGGGCAACAAGAGTGAAACTCCGTCTCTACTAAAAATACAAAAATTAGCCGGGTGTGGTGGCGGGTGCCTGTAATCCAAGCTACTCGGGAGGCTAAGGCAGGAGAATTGCTTGAACCCACGAGGCCGAGGTTGCAGTGAGCCGAGATTGCACTATTGCACTCCAGCCTGGGCGACAAGAGTGAGACTGTGTCTCAAAAAA","GGCTGGGCGCAGTGGCTCACACCTGTAATCCCAGCACTTAGGGAAGCTGAGGCGAGTAGATCACCTGAGGTCAGGAGTTAGAGACCAGCCTGGCCATCATGGTGAAACCCCGTCTCTACTAAAGATACCAAAAATTAGCTGAGTGTGGTGCTGGGTGCCTGTAATCCCAGAAACTCAGGGTGCCTGTAATCCCAGCAACTCAGGGTGCCTTTAATCCCAGCAACTGAGGGTACCAGTAATCCCAGCAACTCAGGGTGTCTTTAATCCTAGCAACTGAGGGCACCTGTAATCCCAGCAACTCAGGAAGCTGAGACAGGAGAAGTACTTGAACCCAGAAGGCAGAGGTTGCAGTGAGCCGATATTGCACCATTGCACTCCAGTCTGGGCAACAAGAGTGAAACTCTGTCTCAAAAAAAAA"
"chr14","12236526","12237360","JH378118","18053084","18053501","465","5816558","GGCTGGGTGGGGTGGCTCACGCGTGTAATCCCAACACTTTTGAGGCTGAGGTGGGTGGATCACTTGAGGTCCGGAGTTTGAGACCAGCCTGGTCAACATGGTGAAACCCCATGTCTCAGGATGGGGAACATCACATACCGGGGCCTGTCGTGGGGTGTGGGGAGGGGAAGGGATAGCATTAGGAGATATACCTAATGTAAATGACAAGTTAATGGGTGCAGCACACCAACATGGCACATGTATACATATGTAACAAACCTGCATGTTGTGCACATGTACCCTAGAACTTAAAGTATAGCAATAAAAAAAAAAAAAGAAACCCCGTGTCTACAAAAAAAATACAAAATTAGGCCAGGCGCAGTGGCACATACCTGTAATCCCAGCACTTTGGGAGGCCAAGGTGGGCAGATCACGAGGTCAGGAGTTTGAGACCAGCCTGTCCAAAATGGTGAAACCCCATCTCTACTAAAAAAATACAAAAATTAGCCAGGCATGGTGGCCCGTGCCTGCAATCCCAGCTACTCAGGAGGCTAAGGCAGGAGAATCACTTGAACGTGGGAGGCGGAGGTTGCAGTGAGCCGAGATCACACCATTGCACTCCAGCCTAGGCAACAGAGCGAGACTCTGTCTCAAAAAAACAAAAAGCAAAAAAACCCAAATTAGCCAGGCATGGTGGTAGTCACCTGTAATCCCAGCTACTTGGGAGGCTTAGGCAGGAGAATCGCTTGAACCCCAGAGGCAGAGGTTGCAGTAAGCCAAGATCGCACCAAGATCACTCCAGCCTGGGCGACAGTGAAACTGTGTCTCAAAAGAAAAAGAAAAAAAAGAAAGAAAA","GGCTGGGCGCAGTGGCTCACACCTGTAATCCCAGCACTTAGGGAAGCTGAGGCGAGTAGATCACCTGAGGTCAGGAGTTAGAGACCAGCCTGGCCATCATGGTGAAACCCCGTCTCTACTAAAGATACCAAAAATTAGCTGAGTGTGGTGCTGGGTGCCTGTAATCCCAGAAACTCAGGGTGCCTGTAATCCCAGCAACTCAGGGTGCCTTTAATCCCAGCAACTGAGGGTACCAGTAATCCCAGCAACTCAGGGTGTCTTTAATCCTAGCAACTGAGGGCACCTGTAATCCCAGCAACTCAGGAAGCTGAGACAGGAGAAGTACTTGAACCCAGAAGGCAGAGGTTGCAGTGAGCCGATATTGCACCATTGCACTCCAGTCTGGGCAACAAGAGTGAAACTCTGTCTCAAAAAAAAA"
"chr14","12551961","12552292","JH378124","27069096","27069413","54","14517135","GGCCAGGCGCGGTGGCTCACGCCTGTAATCCCAGCACTCTGGGAGGCCAAGGCGGACGGATCATCCGAGGTCAGGAGTTTGAGACCAGCCTGGCCAACATGGTGAAACCCCATCTCTACTAAAAATATATATATATATGTATATATATATATATATTAGCCAGGTGTAGTGGTGGGCATCTGTAATCCCAGCTACTCGGGAGGCTGAGGCAGGAGAATTGCTTGAACCCAGGAGGCGGAGGTTGCAGTGAGCTGAGATTGCACCACTGCACTCCAGCCTGGGTGATAAGAATGAGACTCCATCTCAAAACAAACAAACAAACAAATAAAAAA","GGCCGGGCACGGTGGCTCATGCCTGTAATCCCAGCACTTTGGGAGGCCGAGGCGGGTGGATCATGAGGTCAAGAGATCGAGACCATCCTAGTCAACATGGTGAAACTCCATCTCTACTAAAAATACAAAAAAAAAAAAAAATTAGCTGAGCATGGTGGTGCATGCTTGTAATTCCAGCTACTCAGGAGGCTGAGGCAGGAGAATTGCCTGAACCCAGGAGGCGGAGGTTGCAGTGAGCCGAGATTGCGCCATTGCACTCCAGCCTGGGTAATAAGAGTGAAACTCCGTCTCAAAAAAAAAAAACAAAAAAACAAAAAA"
"chr14","15131045","15131391","JH378121","20921542","20921875","62","5790497","GGCTGGGCCCGGTGACTCATGCCTGTAATCCCAGCACTTCGGGAGGACAAGGCGGGTGGATCACCTGAGGTCAGGAGTTCGAGACCAGCCTGGCCAACATGGCGAAACCCCGTCTCTACTGAAAATACAAAAATTAGCCAGGCATGGTGGTGGGCGCCTGTAATCCCAGCTACTCAGAGGCTGAGACAGGAGAATCACTTGAACCTGGGGTGGGGGCGGGGGCGGGGGCGGGGGCGGGGTGGGAGTGGAGGTTGCAGACAGTGAGTGGTGATGGCGCCAGTTCACTCCAGCCTGGGCGAAAGAGTGAAACTCCATCTCAGAAAAAAAAAAAAAAAAAAAAAGTAAAA","GGCTGGGTACGGTGGCTCATGCTGTAATCCCAGCACTTTGGGAGGTCAAAGCAGGCGGATCACCTGAGGTCAGGAGTTTGAGACCAGCCTTGCTAACATGGTGAAACCCCGTTTCTACTAAAAATAAAAAAATTAGCCAGGCGTGGTGGTGTGCACCTGTAATCCCAGCTACTTGGGAGGCTGAAGCAGGAGAGTTGCTTGAACCGGGGTGGTGGGGGGGCAGGGGCAGGGGTGGGTGGCAGGCAGAGGTTGCAGTGAGCCGAGATGGTGCCATTGCACTCCAGCCTGGGCAACAAGAGCAAAACTCCGTCTCAAAAAGAAAAAAAAAAAAGAA"
"chr14","15292066","15292693","JH378118","18053084","18053501","267","2761018","GGCCGGAGACGGTGGCTCACACCTGTAATCCCAGCACTTTGGGAGGCTGAGGCAGGCAGATCACCTGAAGTCAGGAGTTTGAGACCAGCCTGGCCAACATGGTATAAACCCCATCTCTACTAAAAATACAAAAATTAGGCTGGGCGCGGTGGCTCACGCCTGTAATCCCAACACTTTGGGAGGCCGAGGTGGGTGGATCACCTGAGGTCGGGAGTTTGAGACCAGCCTGACCAACATGAAGAAACCCTGTCTCTACTAAAAAAAAAAAAAAATACAAAATTAGCCGGGCATCATGGCACAAGCCTGTAATCCCAGCTACTCAGGAGTCTGAGGCAGGAGAATCGCTTGAACCTGGGAGGCGAAGGTTGCAGTGAGCTGAGATCGTGCCATTGCACTCCAGCCTGGGCAACAAGAGCGAAACTCCTTCTCTAAATAAATAAATAAAAATACAAAAATTTAGCCGGGCATGGTGGCGGGCACCTGTAATCCTAGCTACTTGAGAGGCTGAGGCAGGAGAATCGCTTGAACCCGGGAGGCGGAGGTTGCAGTAAGCAGAGATTGTGCCATTGCACTCCATCCTGGGCAACAAGAGTGAAACTCCATCTCAAAAAAAAAAAAAAAAAAAAAA","GGCTGGGCGCAGTGGCTCACACCTGTAATCCCAGCACTTAGGGAAGCTGAGGCGAGTAGATCACCTGAGGTCAGGAGTTAGAGACCAGCCTGGCCATCATGGTGAAACCCCGTCTCTACTAAAGATACCAAAAATTAGCTGAGTGTGGTGCTGGGTGCCTGTAATCCCAGAAACTCAGGGTGCCTGTAATCCCAGCAACTCAGGGTGCCTTTAATCCCAGCAACTGAGGGTACCAGTAATCCCAGCAACTCAGGGTGTCTTTAATCCTAGCAACTGAGGGCACCTGTAATCCCAGCAACTCAGGAAGCTGAGACAGGAGAAGTACTTGAACCCAGAAGGCAGAGGTTGCAGTGAGCCGATATTGCACCATTGCACTCCAGTCTGGGCAACAAGAGTGAAACTCTGTCTCAAAAAAAAA"
"chr14","15354689","15355313","JH378118","18053084","18053501","269","2698395","GGACGGGCGCAGTAGCTCACACCTGTAATCCTAGCAGTTTGGGAGGCCAAGGTGGGTGGATCACCTGACGTCAGGAGATCGAGACCAGCCTGGACAACATGGCGAAACCCTGTCTCTACTAAAAATACAAAATTAGGGCCAGGTGCGGTGGCTCACGCCTGTAATCCCAGCACTTTGGGAGACTGAGGCGGGCAGATCACCTGAGGTCAGGAGTTCGAGACCAGCCTGGCCAACATGGTGAAACCGCCTCTCTACTAAAAATATAAAAATTGGCTGGGCATTGTAGCAGCCACCTGTAATCCCAGCTACTTGGGGGCCCGAGGCAGAAAAACTGCTTGAACCCAGGAGGCAGAGGTTGTAGTGAGCCGAAATCATGCCACTGCACTCCAGCCTGGGTGACGAGAGTGAGACTCCGTTTCAAAGAAAAAGAAAAAAAATAAAATAAAACACAAAATTAGCCAGTCATGGTGGCAGGCACCTATAATCCCAGCTACCTGGGAGGCTAAGGCAGGAGAATCACTTGAACCCAGGAGGTAGAGGGTGTGGTGAGCCGAGATCACGCCATTGCACTCTAGCCTGGGCAACAAGAGCAAAACTCTGTCTCAAAACAAAAAGTTAAAAAAAA","GGCTGGGCGCAGTGGCTCACACCTGTAATCCCAGCACTTAGGGAAGCTGAGGCGAGTAGATCACCTGAGGTCAGGAGTTAGAGACCAGCCTGGCCATCATGGTGAAACCCCGTCTCTACTAAAGATACCAAAAATTAGCTGAGTGTGGTGCTGGGTGCCTGTAATCCCAGAAACTCAGGGTGCCTGTAATCCCAGCAACTCAGGGTGCCTTTAATCCCAGCAACTGAGGGTACCAGTAATCCCAGCAACTCAGGGTGTCTTTAATCCTAGCAACTGAGGGCACCTGTAATCCCAGCAACTCAGGAAGCTGAGACAGGAGAAGTACTTGAACCCAGAAGGCAGAGGTTGCAGTGAGCCGATATTGCACCATTGCACTCCAGTCTGGGCAACAAGAGTGAAACTCTGTCTCAAAAAAAAA"
"chr14","15366797","15367405","JH378129","11955248","11955630","263","3411549","GGTTGGGTGCGGTGGCTTACCCCTGTAATCCCAGCACTTTGGGGGTACAAAGTGGGAAGATTGCTTGAGCCCAGGAGTTCAAGACCAGCCTGGGCAACTAAGCGAGATCCTATCTCTCAAAAAAATTTTGAAACAACTTTTTGGCCGGGCGCAGTGGCTCACGCCTGTGATCCCAGCACTTTGGGAGGCCAGGGCGGGCGGATCACGAGGTCAGGAGATCAAGACCATCCTGGCTAACACGGTGAAACCCCGTCTCTACTAAAAATACAAAAAATTAGCCGGGTGCGGTGGCGGGCACCTGTAGTCCCAGCTACTCGGGAGGCTGAGGCAGGAGGATGGCGTGAACCCGGGAGGTGGAGCTTGCAGTGAGCTGAGATCGGGCCACTGCACTCCAACCTGGACGACAGATCGAGACTCCGGCTCAAAAAAAAAAAATTAGCTGGGCGTGGTGGCGGGTGCGTGTAATCCCAGCTACTCGGGAGGCTGAGGCAGGAGAATCACTTGAACCTGGGAGGCAGAGGCTGCAGTGAGCCAAGATCGCGCCATTGCACTCCAGCCTGGGCAACAAGAGCGAAACTCTGTCTCTAAATAATAAAATAAAATAAAAAA","GGCTGGGTACGGTGGCTCATGCCTGTAATCCCAGCACTTTGGGAGGTGGGTCACTTGAGGTCAGGAGTTCGAGACCAGCCTGTGCAGTGCCTCCATCCTCAACTGCTGCCTCATCAGCCTGGACCACTACCTGCTCATCCTCTCACCACTGCCACAAGCTGCGCATGAAGCTCCTGCGCGCGCCGGTGCCCGTCTCTACTAAAAATACAAAAATTAGCTGGGTGTGGTGGCAGGTGCCTGTAATCCCAGCTACTCAGGAGGCTGAGGCAGGAGAATCACTTGAACCCAGGAGGCAGAGGTTGCAGTGAGCCGATATCGCATCATTGCACTCCAGCCTGAGCAACAAGAGTGAAATTTTGTCTCAAAAAAAAAAAAAAAAGAAA"
"chr14","15379094","15379705","JH378129","11955248","11955630","265","3423846","GGTTGGGTGCGGTGGCTTACCCCTGTAATCCCAGCACTTTGGGGGTACAAAGTGGGAAGATTGCTTGAGCCCAGGAGTTCAAGACCAGCCTGGGCAACTAAGCGAGATCCTATCTCTCAAAAAAATTTTGAAACAACTTTTTGGCCGGGCGCAGTGGCTCACGCCTGTGATCCCAGCACTTTGGGAGGCCAGGGCGGGCGGATCACGAGGTCAGGAGATCAAGACCATCCTGGCTAACACGGTGAAACCCCGTCTCTACTAAAAATACAAAAAATTAGCCGGGTGCGGTGGCGGGCACCTGTAGTCCCAGCTACTCGGGAGGCTGAGGCAGGAGGATGGCGTGAACCCGGGAGGTGGAGCTTGCAGTGAGCTGAGATCGGGCCACTGCACTCCAACCTGGACGACAGATCGAGACTCCGGCTCAAAAAAAAAAAAAATTAGCTGGGCGTGGTGGCGGGTGCGTGTAATCCCAGCTACTCGGGAGGCTGAGGCAGGAGAATCACTTGAACCTGGGAGGCAGAGGCTGCAGTGAGCCAAGATCGCGCCATTGCACTCCAGCCTGGGCAACAAGAGCGAAACTCTGTCTCTAAATAAATAAAATAAAATAAAAAA","GGCTGGGTACGGTGGCTCATGCCTGTAATCCCAGCACTTTGGGAGGTGGGTCACTTGAGGTCAGGAGTTCGAGACCAGCCTGTGCAGTGCCTCCATCCTCAACTGCTGCCTCATCAGCCTGGACCACTACCTGCTCATCCTCTCACCACTGCCACAAGCTGCGCATGAAGCTCCTGCGCGCGCCGGTGCCCGTCTCTACTAAAAATACAAAAATTAGCTGGGTGTGGTGGCAGGTGCCTGTAATCCCAGCTACTCAGGAGGCTGAGGCAGGAGAATCACTTGAACCCAGGAGGCAGAGGTTGCAGTGAGCCGATATCGCATCATTGCACTCCAGCCTGAGCAACAAGAGTGAAATTTTGTCTCAAAAAAAAAAAAAAAAGAAA"
"chr14","15386894","15387394","JH378114","15957391","15957789","201","570497","GCTGAGTGCAGTGGCTCACGCCTGTAATCCACTTTAGCAGGCCAAAATAGGGGGATCACTTTGAGGCCACGAGTTTGAGACCTGCCTGGGCAACATAGTGAGGCCCCGTCTCTACAAAAATCTTTAAATATTAGAATAACTTTGGGAGGCCGAGGCGGGTGGATCACGAGGTCAAGAGATTGAGACCATCCTGGCCAACATGGTGAAATCCCATCCCTACTAAAGCTACAAAAATTAGCCAGGCGTGGTGGTGTGCGCCTGTAGTCCCAGCTACTCGGGAGACTGAGGCAGGAGAATTGCTTGAATCCGCGTGGCGGAGGTTGCAGTGAGCTGAGATCGCGCCACTGCACTCCAGCCTGGTGACAGAGCGAGACTCCGTCTTAAAAAAAAAAAAAAAAAAAAAAAAAAAAACTTCGGAGGTTGCGGTGAGCCAAGATCACGCCATTGTACTCCAGCCTGGGCCACAAGAGCAAAACTCCGCTTCAAAAAAAAAAAAAAAAA","GCAAGGAACGGTGGCTCATGCCTGTCATCCCAGCACTTTGGGAGGCTAAGGAGGGTGGATTACCGAAGGTCATGAGTTTGAGACCAGCCTGACCAACATGGTGAAAACCCCATCTCTACTAAAAATACAAAAAATTAGCCAGATACAGCTATGCGGCAGACTGGGGCAGGAGAATCGCTTGGACCCAAACCCCATCTCTACTAAAAATACAAAAAATTAGCCGGATACAGCTATGCGGGAGACTGGGGCAGGAGAATCGCTTGGACCCGGGAGGCAGAGATTGCAGTGAGATGAGACCATGCCATTGCTCTCTAGCTTGTGCGATGAGAACAAGACTCTGTCTCAAAAAAAAAAAAAAAAAAAAAAAAAAAAAAAAAAAAAAAAGAGAGAGAGAGAAAA"
"chr14","20140478","20141066","JH378118","18053084","18053501","250","2087394","GCCAGGCGAGGTGGCTCATGCCTGTAATCCCAGCACTTTGGGAGGCTGAGGTGGGTGGAACACTTGAGGTCAGGAGTTCAAGACCAGCCTGGCCAACATGATGAAACCCCCATCTCTACTAAAAACACAAAAATTAGCCAGGAGTGGGCAGGGTGCGGTGGCTCACGCCTGTAATCCCAGCACTTTGGGAGGCTGGGATGGGTGGATCATGAGGTCGGGAGTTCAAGACCAGCCTGGCCAAGATGGTGAAACCCTGTCTCTATTAAAACTTCAAAAATTAGCCAGGCACGGTGGCAGGTGCTTGTAATCCCAGCTACTTGGGAGGCTGAGGCAGGAGAATCACTTGAAACTGGGCGGCAGAGGTTGCAGTGAGCCAAGATCGCGCCACTGGACTCCAGACTGGGCGACACAGTGAGATACCGTCTCAAAAAAAAAAAAAAAAAAAATTAGCCAGGAGTGGTGGCGGAAATCCCAGCTACTTGAGAGGCTGAGGCAGGAGAATCGTTTGAACCCAGGAGGCAGAGGTTGCAGTGAGCCAAGATCTTGCCATTGCACTCCAGCTTGGGAGACAAGAGCAAAACTCTGTCTC","GGCTGGGCGCAGTGGCTCACACCTGTAATCCCAGCACTTAGGGAAGCTGAGGCGAGTAGATCACCTGAGGTCAGGAGTTAGAGACCAGCCTGGCCATCATGGTGAAACCCCGTCTCTACTAAAGATACCAAAAATTAGCTGAGTGTGGTGCTGGGTGCCTGTAATCCCAGAAACTCAGGGTGCCTGTAATCCCAGCAACTCAGGGTGCCTTTAATCCCAGCAACTGAGGGTACCAGTAATCCCAGCAACTCAGGGTGTCTTTAATCCTAGCAACTGAGGGCACCTGTAATCCCAGCAACTCAGGAAGCTGAGACAGGAGAAGTACTTGAACCCAGAAGGCAGAGGTTGCAGTGAGCCGATATTGCACCATTGCACTCCAGTCTGGGCAACAAGAGTGAAACTCTGTCTCAAAAAAAAA"
"chr14","32019134","32019479","JH378197","6655183","6655524","67","25363951","GGCTGGGGCAGTGGCTCACTGTAATTCCAGCACTTGGCCAAGGCAGGTGGATCACCTGAGGTCAGGAGTTCAAGACCAGCAGGGCCAACATGGTGAAACCCTATCTCTAAAAATAAATAAATAAATAAATAAATAAAATAAAATAAAATAAAATAAAAAATAAAAAAAATTAGCTGGGCGTTGTGGTGGGCGCCTGTAATCCCAGCTACTTGGGAGGCTGAGGCAGGAGGATCGCTTGAACCTGGAAGGCAGAGGTTGCAGTGAGCCGAAATCACATAATTGCACTCCAGCCTGGGCGACAAGAGCAAAACTCCATCTCAAAAAAAAAAAAAAAAAAAAAAAAAAA","GGCCGGGCGCAGTGGCTCATGCCTGTAATCCCAGCACTTTGGGAGGCAGAGGCGGGCAGATCACCCAAGGTCAGGAGTTCAAGACCAGCCTGGCTAACATGGTGAAACCCCATTTCTACTAAAAATACAAAAAAAAAAAAAAAAAAAAAAAAAAAAAAAAAAAAAAATTAGCTGAGCGAGGTGGTGGGCACATGTAATCCCAGCTACTTCGGAGACTAAGGCAGGACAATTGCTTAAGCCTGGGAGGCAGAGGTTGTAGTAAGCTGAGATCACACCATTGCACTCCAGCTTGAGCAACAAGAGCGAAACTCCGTCTCAAAAAAAAACCCAAAAAACAAAAAA"
"chr14","39734996","39735596","JH378118","18053084","18053501","237","21681912","GGCTGGGCGCGGTGGCTCATGCCTGTAATCCCAGCATTTTGGGAGGCCGAGGCGGGTGGATCACCTGAGGTCAGGAGTTTGAGACCAGCCTGGCCAACATGGTGAAACCCTGTCTCTACTAAAAATGCAAAAATTAGGCTGGTGCAGTGGCTCACGCCTGTAATCACAGCACTTTGGGAGGCCGAGGTGGGCGGATCACGAGGTCAGGAGATCGAGACCATCCTGGCTAATACAATGAAACCCCGTCTCTATGAAAAATACAAAAAATTAGCCGGGCGTAGTGGCAGGCGTCTGTAGTCCCAGCTACTCAGGAGGCTGAGGCAGGAGAATGGCATGAACCTGGGAGGCGGAGCTTGCAGTGAGCCGAGATTGCGCCACTGCACTCCAGCCTGGGCGACAGCGAGACTCTGTCTCAAAAAAAAAAAAAAAAATTAGCTAGGCATGGTGGCGCATGCCTGTAATCCCAGCTACTTGGGAGGCTGAGGCAGGAGAATCGCTTGAACCTGGGAGGCAGAGGCTGCAGTGAGACAAGATCACGCCATTGCACTCCAGCCTGGGCAACAAGAGTGAAACTCCATCTTCCCCCTACCAAAAAAAAAAA","GGCTGGGCGCAGTGGCTCACACCTGTAATCCCAGCACTTAGGGAAGCTGAGGCGAGTAGATCACCTGAGGTCAGGAGTTAGAGACCAGCCTGGCCATCATGGTGAAACCCCGTCTCTACTAAAGATACCAAAAATTAGCTGAGTGTGGTGCTGGGTGCCTGTAATCCCAGAAACTCAGGGTGCCTGTAATCCCAGCAACTCAGGGTGCCTTTAATCCCAGCAACTGAGGGTACCAGTAATCCCAGCAACTCAGGGTGTCTTTAATCCTAGCAACTGAGGGCACCTGTAATCCCAGCAACTCAGGAAGCTGAGACAGGAGAAGTACTTGAACCCAGAAGGCAGAGGTTGCAGTGAGCCGATATTGCACCATTGCACTCCAGTCTGGGCAACAAGAGTGAAACTCTGTCTCAAAAAAAAA"
"chr14","49081899","49082239","JH378114","14264965","14265292","65","34816934","GGCCAGGTACAGTGGCTCATGCCTGTAATCTCAGCATTTTGGGAGGCTGAGGCAGGCAGATCACCTGAGGTCAGGAGTTCGTGACCAGCCTGACCAGTGAAACCCTGTCTCTACTGAAAAAAATAAAATAAAATAAAATAAAAATAAAAATTAGCTGGGTGTGGTGGTGGGCGCCTGTAATCCCAGCTACTCGGCAGGCTGAGGCAGGAGAATTGCTTGTACCCGGGAGGCGGAGGTTGCAGTGAGCCAAGATCATGCCATTGCACTACAGCCTAGGTGACAAGAGCAAAACTCTGTCTCAAAACAAAACAACAACAACAACAACAACTAAAAAAAAAAAA","GGCCAGGCGCGGTGGCTCAAGCCTGTAATCCCAGCACTTTGGGAGGCCGAGGCGGGTGGATCATGAGGTCAAGAGATCGAGACCATCCTGGTCAACATGGTGAAACCCCGTCTCTACTAAAAACAGAAAAAAAATAAAAATAAAAATAATTAGCTGGGCATGGTGGAGCATGCCTGTAATCCCAGCTACTCAGGAGGCTGAGGCAGGAGAATTGCCTGAACCGAGGAGGCGGAGGTTGCGGGGAGCCAAGATCGCGCCATTGCACTCCAGCCTGGGCAACAAGAGCGAAACTCCGTCTCAAAAAAAAAAAAAAAAAAAAAAAAAAAAA"
"chr14","54833704","54834332","JH378118","18053084","18053501","272","36780620","GGCCAGGTGCAGTGGCTCACTCCTGTAATTCCAGCACTTTGGGAGGCTGCCGGTGGATCACCTGAGGTCAGGAGTTCGAGATCAGCCTGGCCAACATGGTGAAACCCCGTCTCTACTAATAATACAAAAATTAGCCAGGCAAGGCCGGGCGCAGTGGCTCACACCTGTAATCCCAGCACTTTGGGAGGCCGAGGCGGGCGGATCACCTGAGGTCGGGAGTTCAAGACCAGCCTGACCAACATGGAGAAACCCCATCTCTACTAAAAATACAAAATTAGCTGGGCATGGTGGCACATGCCTGTAATCCCAGCTACTAGGGAGGCTGAGGCAGGCGAATCGCTTGAACCTGGGAGGTGGAGGTTGCGGTGGGCCGAGATGGTGCCATTGCACTCTAGCCCGGGCAACAAGAGCGAAACTCTGTCTCAAAAAAAAAAAAAAAAAAAAAAAAATTAGCCAGGCATGGTAGCACACCCTTGTAATCCCAGCTACTCGGGAGGCTGAGGCAGGAGAGTTGCTTGAACCCGAGAGACGGAGGTTGCAGTGAGCTGAGATCGTGCCATTGCACTCCAACCTGGGTGACAAGAGTGAAACTCCATCTCCAAAAAAAAAAATAAATAAAATAAATAAAA","GGCTGGGCGCAGTGGCTCACACCTGTAATCCCAGCACTTAGGGAAGCTGAGGCGAGTAGATCACCTGAGGTCAGGAGTTAGAGACCAGCCTGGCCATCATGGTGAAACCCCGTCTCTACTAAAGATACCAAAAATTAGCTGAGTGTGGTGCTGGGTGCCTGTAATCCCAGAAACTCAGGGTGCCTGTAATCCCAGCAACTCAGGGTGCCTTTAATCCCAGCAACTGAGGGTACCAGTAATCCCAGCAACTCAGGGTGTCTTTAATCCTAGCAACTGAGGGCACCTGTAATCCCAGCAACTCAGGAAGCTGAGACAGGAGAAGTACTTGAACCCAGAAGGCAGAGGTTGCAGTGAGCCGATATTGCACCATTGCACTCCAGTCTGGGCAACAAGAGTGAAACTCTGTCTCAAAAAAAAA"
"chr14","55277737","55278067","JH378148","10302642","10302970","61","44975095","GGCCGGGTGCAGTGGCCCACCTCTGTAATCCTAACACTTTGGGAGGCCAAGGCAGGCAGGTCACTTGAGGTCAGGAGTTCAAGACTAACCTGGCCAACATGGTGAAACCCCGTCTCTACTAAAAATACGAAAATTAGCCGGGCTTCATGATGCATGCCTGTAATCCCAGCTACTAAGGAGGCTGAGGCAGAAGAATCTCTTGAACCCATGAGGTTGCAGTGAGCTGAGATCTCGCCATTGCACTCCAGCCTGGAGGACAAGAGCGAAACTCTGTCTCAAAAAAATAAAATAAAATAAATAAGAATAAAATAATAATAAAAGGCAAAAAGAA","GGCCGGGCGCGGTGGCTCAAGCCTGTAATCCCAGCACTTTGGGAGGCCGAGGCGGGTGGATCACGAGGTCAAGAGATCGAGACCATCCTGGTCAACATGGTGAAACCCCGTCTCTACTAAAAATACAAAAAATTAGCTGGGCATGGTGGTGGGTGCCTGTAATCCCAGCTACTCAGGAGGCTGAGGCAGGAGAATTGCCTGAACCCAGGAGGCGGAGGTTGCGGTGAGCCGAGATCGCGCCATTGCACTCCAGCCTGGGTAACAAGAGTGAAACTCTGCCTCAAAAAAAAAAAATAAAATAAAATAAAATAAAATAAAATAAAATAAAA"
"chr14","55822103","55822700","JH378118","18053084","18053501","240","37769019","GGCCAGGCGCAGTGGCTCACGCCTGTAATCCCAGCACTTTAGGAGGCCGAGGCAGGTGGATCGCCTGAGTTCAGGAGTTCAAACCCACCCTGGCCAACATGGTGAAACCCTGCCTCTACTAAAAAACAAAAAAATGGCCAAGCGTGGTGGCTCACGCCTGTAATTCCAGCACTTTGGGAGGCTGAGGCAGGCGAATCACGAGGTCAGGAGATCGAGACCATCCTGGCTAACATGGTGAAACCCCATCTCTATTAAAAATACAGAAAATTAGCCAGGCGTGGTGGTGGACGCCTGTAGTCCCAGCTTCTTGGGAGGCTGAGGCAGGAGAATGGCATGAACCCGGGAGGCAGAGCTTGCAGTGAGCTGAGATTGCGCCAGTGCACTACAGCCTGTGGGACAGAGCAACTCCGTCTCAAAAAAAAAAAAAATTAGCTGGGCATGGTGGCATATGCCTGTAATCCCAGCTACTAAGGAGGCTGAGGCGGGAGAATCGCTTGAACCCGGGAGGCAGAGGTTGCAGTGAGCCGAGATTGCGCCATTGCACTCCAGTCTGGACAACAAGAGTGAACTGTGTCTCAAAAAAAAAAAAAAAAAAAGA","GGCTGGGCGCAGTGGCTCACACCTGTAATCCCAGCACTTAGGGAAGCTGAGGCGAGTAGATCACCTGAGGTCAGGAGTTAGAGACCAGCCTGGCCATCATGGTGAAACCCCGTCTCTACTAAAGATACCAAAAATTAGCTGAGTGTGGTGCTGGGTGCCTGTAATCCCAGAAACTCAGGGTGCCTGTAATCCCAGCAACTCAGGGTGCCTTTAATCCCAGCAACTGAGGGTACCAGTAATCCCAGCAACTCAGGGTGTCTTTAATCCTAGCAACTGAGGGCACCTGTAATCCCAGCAACTCAGGAAGCTGAGACAGGAGAAGTACTTGAACCCAGAAGGCAGAGGTTGCAGTGAGCCGATATTGCACCATTGCACTCCAGTCTGGGCAACAAGAGTGAAACTCTGTCTCAAAAAAAAA"
"chr14","55860214","55860812","JH378118","18053084","18053501","246","37807130","GGCCGGATGCAGTGGCTCACGCCTGTAATCCCAGCACTTTGGGAGGCCAAGGCAAGCGGATCACCTGAGGTCAGGAGTTCAAGACCAGCCTGGCCAGCATGGTGAAACCCCTTCTCTACTAAAAATACAAAAATTAGCCGGGGCCTTGCGTGGTGGCTCACACCTGTAAATCCCAGCGCTTTGGGAGGCCGAGGCAGGCGGATCACCTGAGGTCGGGAGTTCAAGAACAGCCTGACCAACATGGAGAAACCCCGTCTCCACTAAAAATAGAAAAATAGCCGGGCATGGTGGCGCATGCTTGTAATCTCAGCTACTCGGGAGGCTGAGGCAGGAGATCACTTGAACCCAAGAGGCAGAGGTTGCGGTGAGCCGAGATCGCGCCATTGCACTCCAGCCTGGGCAACAAAGAGCGAAACTCCGTCTCCAAAAAAAAAAAAAAAAAATTAGCCGGGCGTGGTGGCACATACCTGTAATCCCAGCTATTCAGGAGGCTGAGGCAGGAGAATCCCTTGAACCCGGGAGGCAGAGATGGCAGTGAGCTGAGATCACGCCATTGCACTCCAGCCTGGGTGAGAGGAGTGAAACTCCGTCTAAAAAAA","GGCTGGGCGCAGTGGCTCACACCTGTAATCCCAGCACTTAGGGAAGCTGAGGCGAGTAGATCACCTGAGGTCAGGAGTTAGAGACCAGCCTGGCCATCATGGTGAAACCCCGTCTCTACTAAAGATACCAAAAATTAGCTGAGTGTGGTGCTGGGTGCCTGTAATCCCAGAAACTCAGGGTGCCTGTAATCCCAGCAACTCAGGGTGCCTTTAATCCCAGCAACTGAGGGTACCAGTAATCCCAGCAACTCAGGGTGTCTTTAATCCTAGCAACTGAGGGCACCTGTAATCCCAGCAACTCAGGAAGCTGAGACAGGAGAAGTACTTGAACCCAGAAGGCAGAGGTTGCAGTGAGCCGATATTGCACCATTGCACTCCAGTCTGGGCAACAAGAGTGAAACTCTGTCTCAAAAAAAAA"
"chr14","56736257","56736880","JH378206","6546474","6546861","276","50189783","GGCCAGGCACAGTGGCTCATGCCTGTAATCCCTGCACTTTGGGAGGCCAAGGCGGGTGGATCACCTGAGGTCAGGAGTTCGAGACTAGCCTGGCCAACATGGTTGGCCATCTCTTCTAAAAATACAAAAAATTAAGTTGGGCATGGTGGCTCATGCCTGTAATCCCAGCATTTTGGGAGGCCAAGGCAGGTGGATCATAAGGTCAAGAGATTGAGACCATCCTGGCCAACATGGTGAAACCCCATCTCTACTAAAAATACAAAAATTAGCTGGGCGTGGTGGTAGCACACACCTGCAGTCCCAGCTGCTCAGGAGGCTGAGGCAGGAGAATCACTTGAACCCGGGAAGCAGAGGTTGCAGTGAGCCGAAATTGCACCACTGCACTCCAGCCTGGCGACAAAGCAAGACTCCGTCAAAAAAAAAAAAAAAAAAAAAAAAATTAGCCAGGAGTGGTGGCACGTGCCTATAGTTCCAGCTACTCGGGAGGCTGAGGCAAGAGATTTGCTTGAACCTGGGAAGCAGAGGTTGCATATATTGCAGTGAGCCAAGATTATGCCATTGCACTCCAGCCTGGGCAACAAGAGTGAAAATCTGTCTAAAAAGAAAAAAAAAAGAAAAGAAAAA","GGCCACACATGGTGGCTAACGCCTGTAATCCCAGCACTTTGGGAGGCCAAGTCGGGTGGATCATGAGGTCAGGAGACCAAGACCATCCTGGCCAAATGGTGAAACCCCGTCTCTACTAAAAATACAAAAATTAGCTGGGCATGGTGGCGTGTGCCTGTAATCCCAGCTACTCAGGAGGCTGAGGCAGGACAATTGCCTGAACCCAGGAGAATTAGCTGGGCATGGTGGCGTGTGCCTGTAATCCCAGCTACTCAGGAGGCTGAGGCAGGACAATTGCCTGAACCCAGGAGGCGAAGGTTGCGGTGAGCCGAGATTGTGCCATTGCACTCCAGCCTGGGTAACAAGAGCGACACTCTGTCTCAAAAAAAAAAAAAAAAAAAAAAAAAAA"
"chr14","56744047","56744674","JH378118","18053084","18053501","281","38690963","GGCCGGGTGCGGTGACTCACATCTATAATCCCAGCACTTTGGGAGGCCAAGGCAGGTGGATCACCTGAGGTCAGGAGTTCAAGACCAGCCTGGCCAACTTGGTGAAACCCCATCTCTACTAAAAAATATAAAAATTTGCCAGGTGCGGTGGCTCATACCTGTAATCCCAGCACTTTGAGAGGCAGAGGTGGGTGGATCACGAGGTCAGGAGTTCGAGACCAGCCTGGCCAATGTGGTGAAACCCCATCTCTACTAAAAATACAAAAATTAGCCGGGTGTGGTGATGCGTGCCTGTAGTCCCAGCTATTCGGGAGGTTGAGGCAGGAGAATGGCGTGAACCAGGAAGGCGGAGCTTTCACTGAGCGGAGATCGCACCACTGCACTCCAGCCTGGGCGACGGAGCGAGACTCTGTCTCAAAAACAAAACAAAACAAAAAAACAAACAAACAAAAAAACATTATCCGGGTGTGGTGGTGGGCGCCTGTAATCCCAGCTACTTGGGAGGCTGAAGCAGGAGGATTGCTTGAACCTGGGAGGTGGAGGTTGCAGTGAGCTGAGATCACGCCTCTGCACTGCAGGCTGGACGACAAGAACAAAACTCTGAATCAACAACAACAACAACAAAAAA","GGCTGGGCGCAGTGGCTCACACCTGTAATCCCAGCACTTAGGGAAGCTGAGGCGAGTAGATCACCTGAGGTCAGGAGTTAGAGACCAGCCTGGCCATCATGGTGAAACCCCGTCTCTACTAAAGATACCAAAAATTAGCTGAGTGTGGTGCTGGGTGCCTGTAATCCCAGAAACTCAGGGTGCCTGTAATCCCAGCAACTCAGGGTGCCTTTAATCCCAGCAACTGAGGGTACCAGTAATCCCAGCAACTCAGGGTGTCTTTAATCCTAGCAACTGAGGGCACCTGTAATCCCAGCAACTCAGGAAGCTGAGACAGGAGAAGTACTTGAACCCAGAAGGCAGAGGTTGCAGTGAGCCGATATTGCACCATTGCACTCCAGTCTGGGCAACAAGAGTGAAACTCTGTCTCAAAAAAAAA"
"chr14","58283278","58283584","JH378115","34663603","34663898","52","23619675","CCGGGTGCGGTGGCTCACGCCTGTAATCCCAGCACTTTGGGAAGCTGAGGTGGGTGGATCATTTGAGGTCAAGAGTTCTAGACCAGCCTGGCCAACATGGTGAAACCCTACTTCTAATAAACACACACACACACACACACACACACACACACACACAAATTAGCCAGCAGGCACCTGTAATCCCAGCTACTCGGAAGGCTGAGGCAGGACAATCGCTTGAACCTGGGAGGCCAGAAGTTGCAGTGAGCCAAGATCATGCCACTGCACTCCAGTCTGGGTGACAAGAGCAAGACTCCATTTCAAAAAA","GGCCTGGTGAAGTGGCTCACGCCTGTAATCCCAACACTTTGGGAGGCTGAGATGGATGGCTCATTTGAGGTCAGGAGTTCTAGACCAGCCTGGCCAACATGGTAAAAGCCCACCTCTACCAAAAATACAAAAACAAAAACAAAAAAATTTTAGCCAACAGGCACCTTTAATCCCAGCTACTCAGGAGGCTGAGGCAGGAGAATTGCTTGAATCTGGGAGGCCAGAAGTTGCAGTGAGCCAGGATCACACCACTGCACTCCATCCTAGGCGACAAGAGCAAGACTCCAAAAAAAAAA"
"chr14","59226808","59227410","JH378118","18053084","18053501","257","41173724","GGCTGGGCGCTGTGGCTCATGCCTGTAATCCCAGCACTTTAGGAAGCCAAGGGAGGTGGATCACCTGAGGTCAGAGTTCAAGTCCGGCCTGACCAACATGGCGAAACCCAGTCTCTACTAAAAATACAAAATTGGCCAGGCGTGGGGTGGCTCACACCTGTAATCCCAGCACTTTGGGAGGCCGAAGTGGGTGGATCACTTGAGGTCAGGAGTTTGAGACCAGCCTGGTTAACATGGTGAAACCCCATCTCTACTAAAAATACAAAAATTAGCCAGGCATGGTGGCAGGCGCCTGCAATCCCAGTTACTCAGGAGGCTGGTGCAGGAGAATCGCTTAAACCTAGGAGGCAGAGGTTGCAGTGAACTGAGATCGTGCCATTGCACTCCAGCCTGGGTAACAACAGCAAGACTTCATCTCAAAAAAAAAAATACATAATTATAATTAGCTGGGCGTGTTGGCGAGCGCCTGTAGTCCCTGCTACTTGGGAGGCTGAGGCAGGGGAATCACTTGAACCTGAGAGGCGGAGGTTGCAGTGAGCCAAGTCACGCCATTGCATTCCAGCCTCGGCAACAAGAGCAAAACTCCATCTCAAAAAAAAAAAA","GGCTGGGCGCAGTGGCTCACACCTGTAATCCCAGCACTTAGGGAAGCTGAGGCGAGTAGATCACCTGAGGTCAGGAGTTAGAGACCAGCCTGGCCATCATGGTGAAACCCCGTCTCTACTAAAGATACCAAAAATTAGCTGAGTGTGGTGCTGGGTGCCTGTAATCCCAGAAACTCAGGGTGCCTGTAATCCCAGCAACTCAGGGTGCCTTTAATCCCAGCAACTGAGGGTACCAGTAATCCCAGCAACTCAGGGTGTCTTTAATCCTAGCAACTGAGGGCACCTGTAATCCCAGCAACTCAGGAAGCTGAGACAGGAGAAGTACTTGAACCCAGAAGGCAGAGGTTGCAGTGAGCCGATATTGCACCATTGCACTCCAGTCTGGGCAACAAGAGTGAAACTCTGTCTCAAAAAAAAA"
"chr14","62992080","62992681","JH378118","18053084","18053501","256","44938996","GGCCGGATGCAGTGGCCCACACCTGTAATCCTAGCACTTTGAGAGGCTGAAGCAGGCAGATCACTTGCGGTCAGGAGTTTGAGACCAGCCTGGCCAACATAGTAAAACCTCATCTCTACTAAAAATAGAAAAATTTTCTGACCAGGCACGGTGGCTCGCGCCTGTAATCCCAGCACTTTGGGAGGCCAAGGTGGGCACATTACCTGAGATCAAGAGTTCAAGACCAGCCTGACCAACATGGCAAAACTCTGTCTCTACTAAAAATACAAAATTAGCCGGGCATAGTGGCGCATTCCTGTAATCCCAGCTACTAAGGAGGCTGAGGCAGGAGAATTGCTTGAACCCGGGAGCCGGAGGTTGCAGTAAGCCAAGATTGCGCACTGCACTCTAGGCTGGGCAACAACAGCGAAACTCTGTCTCGAAAAAAAAAAAAAAAAAAATTAGCTGGGCGTGGTGGTGAGTACCTGTAATCCCAGCTACTTGGGAGACTGAGGCAGGAGAATCTCTTGAACCTGGGAGGTAGAGGTTGCAGCGAGCTTAGATCACACCACTGCACTAAAGCCTGGGGGACAAGAGCAAAACTCTATCTCAAAAAAATAAAA","GGCTGGGCGCAGTGGCTCACACCTGTAATCCCAGCACTTAGGGAAGCTGAGGCGAGTAGATCACCTGAGGTCAGGAGTTAGAGACCAGCCTGGCCATCATGGTGAAACCCCGTCTCTACTAAAGATACCAAAAATTAGCTGAGTGTGGTGCTGGGTGCCTGTAATCCCAGAAACTCAGGGTGCCTGTAATCCCAGCAACTCAGGGTGCCTTTAATCCCAGCAACTGAGGGTACCAGTAATCCCAGCAACTCAGGGTGTCTTTAATCCTAGCAACTGAGGGCACCTGTAATCCCAGCAACTCAGGAAGCTGAGACAGGAGAAGTACTTGAACCCAGAAGGCAGAGGTTGCAGTGAGCCGATATTGCACCATTGCACTCCAGTCTGGGCAACAAGAGTGAAACTCTGTCTCAAAAAAAAA"
"chr14","75046278","75046878","JH378118","18053084","18053501","246","56993194","GGCCGGGCACAGTGGCTCACACCTATAATCTCAGTACTTTGGGAGGCCAAGGCGGGCAGATCACTTGAGGTCAGGAGTTCGAGACCACCCTGGCCAACATGGTGAAACCTCATCTCTACTAAAAATACAAAAAACTGGCTGGGTGAAGTGGCTCACGCCTGTAATCCCAGCAGTTTGGGAGGCCAAGGCGGGCCAATCACGAGGTCAGGAGTTCGAGACCAGCCTGGCCAATATGGTGAAACCCCGTCTCTATTAAAAATTCAAAAATTAGCTGGATGTGGTGGCAGGCACCTACAATCCCAGCTACTTGGAAGGCTGAGGCAGGAGAGTCTGCTTGAAACCAGAAGGCGGAGGTTGCAGTGAGTGAGCTGAGAACGTGCCACTGCACTCCAGCCTGGGCGAAAGAGCAAAACGCTGTCTCAGGGGGAAAAAAAAAACTAGCCGGGCATGGTGGCAGGTGCCTGTAATCCCAGCTACTCAGGAGGCTGAGGCAGGAGAATTGCTTGAACCCAGGAGGAGGAGGTTGCAGTGAGTCGAGATCACGTCATTGCACTCCCAGCCTGGCTGATAAGAGCGAAACTCCGTCAAAAAAAAAAAAAAA","GGCTGGGCGCAGTGGCTCACACCTGTAATCCCAGCACTTAGGGAAGCTGAGGCGAGTAGATCACCTGAGGTCAGGAGTTAGAGACCAGCCTGGCCATCATGGTGAAACCCCGTCTCTACTAAAGATACCAAAAATTAGCTGAGTGTGGTGCTGGGTGCCTGTAATCCCAGAAACTCAGGGTGCCTGTAATCCCAGCAACTCAGGGTGCCTTTAATCCCAGCAACTGAGGGTACCAGTAATCCCAGCAACTCAGGGTGTCTTTAATCCTAGCAACTGAGGGCACCTGTAATCCCAGCAACTCAGGAAGCTGAGACAGGAGAAGTACTTGAACCCAGAAGGCAGAGGTTGCAGTGAGCCGATATTGCACCATTGCACTCCAGTCTGGGCAACAAGAGTGAAACTCTGTCTCAAAAAAAAA"
"chr14","83813857","83814442","JH378118","18053084","18053501","240","65760773","GGCCAGGCGCGGTGGCTCACGCCTGTAATCCCAGCACTTTGGGAGGCCGAGGCGGGCGGATCACCTGAGGTCAGGGGTTCAAGACCAGCCTGACCATCCCAGAACTTTGGGAGGCCGAGACGGGTGGATCATGAGGTCAGGAGATCGAGACCATCCTGGCTAACACAGTGAAACCCCATCTCTATTAAAAATACAAAAAATTAGCCGGGCGTGGTGGCAGCTCCTGTAGTCCCAGCTACTCGGGAGGCTGAGGCAGGAGAATGGCGTGAACCCGGGAGGCGGAGCTTGCCGTGAGCCGAGATCGCACCACTGCACTCCAGCCTGCAAGATAGCGAGGCTATGTCTCAGGAAAAAAAAAAAAAAAAAAAAAAAGACCAACCTGACCAACATGGTAAAACCCCATCTCTACTAAAAATACAAAATTAGCCGGGCATGGTGGCAGACGCCTGTAATCCCAGCTACTCAGGAGGCTGAGGCAGGAAAATCACTTGAACCCAGGAGGTGGAGGTTGCGGTGAGCCGAGATCGTGCCATTGCACTCCGGCCTGGGTGACAACAGCGAAACTCCATCTCAAAAAAAAGAAAAA","GGCTGGGCGCAGTGGCTCACACCTGTAATCCCAGCACTTAGGGAAGCTGAGGCGAGTAGATCACCTGAGGTCAGGAGTTAGAGACCAGCCTGGCCATCATGGTGAAACCCCGTCTCTACTAAAGATACCAAAAATTAGCTGAGTGTGGTGCTGGGTGCCTGTAATCCCAGAAACTCAGGGTGCCTGTAATCCCAGCAACTCAGGGTGCCTTTAATCCCAGCAACTGAGGGTACCAGTAATCCCAGCAACTCAGGGTGTCTTTAATCCTAGCAACTGAGGGCACCTGTAATCCCAGCAACTCAGGAAGCTGAGACAGGAGAAGTACTTGAACCCAGAAGGCAGAGGTTGCAGTGAGCCGATATTGCACCATTGCACTCCAGTCTGGGCAACAAGAGTGAAACTCTGTCTCAAAAAAAAA"
"chr14","84224287","84224910","JH378118","18053084","18053501","265","66171203","GGCAGGGTGCAGTGGCTCATACCTGTAATCCCAGCACTCTGGGAGGCCGAGGTGGGCAGATCACTTGAGCTCAGGAGTTTGAGACCAGCCTGGCCAACATAGTGAAACCCCATCTCTACTAAAAATACAAAATTAGGCTGGGCACAGTGACTCACGTCTGTAATCCCAGCACTTTGGGAGGCCGAGGCTGGTGGATCACAAGGTCAGGAGATCAAGACCATCCTGTCCAACATAGTGAAACCCCATCTCTACTAAAAATACAAAAATTAGCTGGACGTGGAGGTGCACATCTGTAGTCCCAGCTACTTGTGAGGCTGAGGCAGGAGAACTGCTTGAACCCAGGAGGCGGAGGCTGCAGTGAGCTGAGATTGTGCCACTGCACTCCAGCCTGGGCGACAGAGCGAGACTCTGTCTCAAAAAAAAAAAAAAACAGAAAAAACAAAATTAGCCGGGCATGGTGGTGCACGCCTGTAACCCCAGCTACTTGGGGGGCTGAGGCAGGAGAATTGCTTGAACCTGAGAGGTGGAGGTTTCAGTGAGCCGAGATTGTGCCATTGCCCTCCAGTCTGGGCAACAAGAGCAAAACTCCGTCTCAAAAAAAAAAAAAAGAAAAAAAAAGAAGAA","GGCTGGGCGCAGTGGCTCACACCTGTAATCCCAGCACTTAGGGAAGCTGAGGCGAGTAGATCACCTGAGGTCAGGAGTTAGAGACCAGCCTGGCCATCATGGTGAAACCCCGTCTCTACTAAAGATACCAAAAATTAGCTGAGTGTGGTGCTGGGTGCCTGTAATCCCAGAAACTCAGGGTGCCTGTAATCCCAGCAACTCAGGGTGCCTTTAATCCCAGCAACTGAGGGTACCAGTAATCCCAGCAACTCAGGGTGTCTTTAATCCTAGCAACTGAGGGCACCTGTAATCCCAGCAACTCAGGAAGCTGAGACAGGAGAAGTACTTGAACCCAGAAGGCAGAGGTTGCAGTGAGCCGATATTGCACCATTGCACTCCAGTCTGGGCAACAAGAGTGAAACTCTGTCTCAAAAAAAAA"
"chr14","85020958","85021268","JH378108","34510794","34511096","52","50510164","GCCAGGTGCAGTGGCTCATGCCTGTAATTCCAGTACTTTGAGAGGTCGAGACAGGGAGATCACCTGAGGCCAGGAGTTCAAGACTAGCTTGGCCAACATGGCAAAACCCTGTCTCTACTAAAAATGCAAAAAAAAAAAAAAAAAAAAAAAAAAAATTAGCCTGGCATGGTGGTAGACACCTGTAATCCCAGCTACTTGGGAGGCTGAGACAGGAGAACCTCTTGAATCTGGGAGGAGGAGGTTGCTGTGAGCTGAGATCGTGCCACTGCACTCCAGCCTGGGTAACAAGAGAGAAACTCTGTCTCAAAAAA","GGGTGCCGTGTCTCATGCCTGTAATTCCAGCACTTTGGGAGGTCAAGGCAGTCCGATCACCTGAGGTCAGGAGTTTGAGACTAGCCTGGCCAAAATGGTGAAACCCTGTCTCTAGAAAAAATACAAAAAAAAAAAAAAAAAAAAAAAAAAATTAGCTGGATGTAGTGGTGCATACCTGTAGTCCCAGCTACTCTGGAGGCTGAGGCAGGAGAATTGTTTGAACCCAGGAGGCGGAGGTTGCGGTGAGCCGAGATCATGCCATTGCACTCCAGCCTGGGAAACAAGAGTGAAACTCTGTCTCAA"
"chr14","86696589","86696920","JH378203","2698403","2698735","56","83998186","GGCCAGGCACGGTGGCTCATGCCTATAACCAGCACTTTGGAGGCCGAGGCAGGTGGATCACCTGAGGTCAGGAGTTTGAGACTGGCCTGGCCAGCATGGTGAAACTCTGTCTCTACTAAAAAAAAAAAAAAAAAAAAAAAAAAAAAAGTACAAAATTAGCTGGATGTGGTGGTAGGCACCTGTAATCCCAGCTACTTGGGAGGCTGAGGCAGGAGAATCGCTTGAACCCAGGAGGCAGAGATTGCAGTGAGCCAAGATTGCGCCATTGTACTCCACTCTGGGCAATGAGCGAAACTCCGTCTCAAAAAAAAAATAAAATAAAAATAAAATAA","GCCGGGTGCAGTGGCTCATACCTCTAATCCCAGCACTTTGGGAGGCCAAGGCAGGTGATCACCTGTGGTCAGGAGTTCGAGACCAGCCTGGCCAACATGGTGAAACCCTGTCTTTACTAAAAATACAAAAAAAAAAAAAAAAAAAAAAAAAAAAAACTTAGCCCACCATGGTGGTGGGCTCTTGTAGTCCCAGCTACATGGGAGGCTGAGGCAGAAGAATCGCTTGAAGACAGGAGGTGGAGGTTGCAGTGAGCCAAGACTGCGCCATTGCACTCAGCCTGGGTGACGAGCCAAACTCCATCTCAAAAAAAAAAAAAAAAAAAAAAAAAAAAA"
"chr14","86944567","86945185","JH378118","18053084","18053501","274","68891483","GAGCACGGTGGCTCACGCCTGCAATCCCAGCACTTTGGGAGGCCGAGGTGGGTGGATCACCTGAGGTTAGGAGTTTGAGACCAGCCTGGCCAACATGGTGAAACCGTCTCTACTAAAAATGCAAAAAAGTAGGGGCCGGGCACGGTGGCTCACGCCTGTAATCCCAGCACTTTGGGAGTCTGAGGCAGACGGATCACAAGGTCAGGAGATCAAGACCATGGTGAAACTCCGTCTCTACTAAAAATACAAAAAATTAGCTGGGCGTGGTGGTGGGCACCTGTAGTCCCAGCTGCTTGGGAGGCTGAGGCAGGAGAATGGTGTGAACCCGGGAGGCGGAGCTTGCAGTGAGCCGAGATCGCAACACTGCACTCCAGCCTGGGCGACAGAGCGAGACCCTGTCTCAAAAAAAACAAAAATAAACAAAAATAAATAAATACAAAAAAGTAGCCAGGCATGGTGGTGGGTGCCTGTAATCCCAGCTACTTGGGAGGCTGAGGCAGGAGAATCACCTGAACCCGGGAGGTGGAGGTTGCAGTGAGCCAAGACCGTGTCATTACACTCTAGCCTGGGCAACAAGAGCGAAATTCCATCTGAAAAAATAAATAAATAAAAATAAAAA","GGCTGGGCGCAGTGGCTCACACCTGTAATCCCAGCACTTAGGGAAGCTGAGGCGAGTAGATCACCTGAGGTCAGGAGTTAGAGACCAGCCTGGCCATCATGGTGAAACCCCGTCTCTACTAAAGATACCAAAAATTAGCTGAGTGTGGTGCTGGGTGCCTGTAATCCCAGAAACTCAGGGTGCCTGTAATCCCAGCAACTCAGGGTGCCTTTAATCCCAGCAACTGAGGGTACCAGTAATCCCAGCAACTCAGGGTGTCTTTAATCCTAGCAACTGAGGGCACCTGTAATCCCAGCAACTCAGGAAGCTGAGACAGGAGAAGTACTTGAACCCAGAAGGCAGAGGTTGCAGTGAGCCGATATTGCACCATTGCACTCCAGTCTGGGCAACAAGAGTGAAACTCTGTCTCAAAAAAAAA"
"chr14","87180871","87181803","JH378118","18053084","18053501","547","69127787","GGCCATGTGCGGTGGCTCACACCTGTAATCCCAGCACTGTGGGAGGCCAAGGTGGGCGGATCATTTGAGGTCAGGAGTTCTAAACCAGCCTGGCCAATATGGTGAAACACTGTCTCTGCTAAAAATACAAAAAAAGAAAAAGAAAAAAAAAAAAAGGCTGGGCACGGTGGCTCACGCCTGTAATCTCAGCACTTTGGGAGGCTGAGGTGGGTGGATTACCTGAGGTCAGGAGTTCGAGACCAGCCTGGCCAACATGGTGAAACCTTGTCTCTACTAAAAGTATAAAAATTAGCCAGGTGTGGTGGAGGTCGCCTGTAATCCCAGCTACTCAGTAGGCAGAGGCAGAAGAATCCGTTGAACCTGGGAGGCGGAGGTTGCAGTGAGCTGAGATTGCACCAGTGCATTCCAGCCCGGGTGACAAGAGTGAGACTCTGTCTCAAAATAAACAAACAAAAAAATTAGTGGGCCGGGTTCAATGACTCACGCCGGTAATCCCAGCACTTTGGGAGGCCAAGGAAGGCAGGTCACCTGAGGTCGGGAGCTCGAGACCAGCCTGACCAACATGGAGAAACCCCGTCTCTACTAAAAATACAAAATTAGCTGGGCGTGGTGGCACATGCCTGTAATTCCAGCTACTCAGGACGCTGAGGCAGGAGAATTGCTTGAACCCAGGAGGCGGAAGTTGCAGTGAGCCAAGATCATGACATTGCACTCCCGCCTGGGCGCCAAGAGTGAGATTTCGTCTCAAACAAACAAACAAAAAAACGAATTAGTGGAGCGTGGTGGCAGGCACCTAAAGTCCCAGCTATTCAGGAGGCTGAGGCAGGAGAATTGCTTGAACCTGGGAAGTGGAGGTTATAGTGAGCTGAGATCGCGCCATTGCACTCCAGCCTGGGCAACAAGAGTGAGAATCTGTCTAAAAAAAAAAAAGAA","GGCTGGGCGCAGTGGCTCACACCTGTAATCCCAGCACTTAGGGAAGCTGAGGCGAGTAGATCACCTGAGGTCAGGAGTTAGAGACCAGCCTGGCCATCATGGTGAAACCCCGTCTCTACTAAAGATACCAAAAATTAGCTGAGTGTGGTGCTGGGTGCCTGTAATCCCAGAAACTCAGGGTGCCTGTAATCCCAGCAACTCAGGGTGCCTTTAATCCCAGCAACTGAGGGTACCAGTAATCCCAGCAACTCAGGGTGTCTTTAATCCTAGCAACTGAGGGCACCTGTAATCCCAGCAACTCAGGAAGCTGAGACAGGAGAAGTACTTGAACCCAGAAGGCAGAGGTTGCAGTGAGCCGATATTGCACCATTGCACTCCAGTCTGGGCAACAAGAGTGAAACTCTGTCTCAAAAAAAAA"
"chr15","7203590","7204226","JH378118","18053084","18053501","285","10849494","GGCCAGGTGCAGTGGCTCATGCCTCTAATCCCAGCACTTTGGGAGGCCGAGATGGGCAGATCACCGGAGGTCAGGAGTTTGAGACCAGCTTGGCCAAAATGGTGAAACCCTGTCTCTACAAAAAAATACAAAAATGGCTAGGCACGGTGGCTCACACCTGTAATCCCAGCACTTTGGGATACAGGTGGATCATGAGGTCAAGAGATCAAGATCATCTTGGCCAACATGGCAAAACCCTGTCTCTACTAAAAAATACAAAAAATTAGCTGGGCGTGGTGGTGCACGCCTGTAGTCCCAGCTACTCAGGAAACTGAGGCAAGAGAATCGCTTGAACCTGGGAGGTAGAGGTTGCAGTGAGCCGAGATGCACTCCAGCCTGGCAACAGAACAAGACTCCATCTCAAAGAACAAAAACAAAACAAAACAAAACAAAAGACAAGCAAACAAAAAAATACAAAAATTAGCTAGGTGTGGTGGCAGGCGCCTGTAATCCCAGCTACTCAGGAGGCTGAGGCAGGAGAATCGCTTGAACCTGGGAGGCGGAGGTTGCAGTGAGCCAAGATTGTGCCATTGCACTCCAGCCTAGGTGACAAGAGTGAAAAGACGTCTCAAAAACAAAACCAAAAAAAAAAATAAAA","GGCTGGGCGCAGTGGCTCACACCTGTAATCCCAGCACTTAGGGAAGCTGAGGCGAGTAGATCACCTGAGGTCAGGAGTTAGAGACCAGCCTGGCCATCATGGTGAAACCCCGTCTCTACTAAAGATACCAAAAATTAGCTGAGTGTGGTGCTGGGTGCCTGTAATCCCAGAAACTCAGGGTGCCTGTAATCCCAGCAACTCAGGGTGCCTTTAATCCCAGCAACTGAGGGTACCAGTAATCCCAGCAACTCAGGGTGTCTTTAATCCTAGCAACTGAGGGCACCTGTAATCCCAGCAACTCAGGAAGCTGAGACAGGAGAAGTACTTGAACCCAGAAGGCAGAGGTTGCAGTGAGCCGATATTGCACCATTGCACTCCAGTCTGGGCAACAAGAGTGAAACTCTGTCTCAAAAAAAAA"
"chr15","13675429","13675731","JH378235","1186107","1186418","53","12489322","GGCTTGGCACAGTGGCTCATGCCTGTAATCCCAGCACTTTGAGAGACCGAGGCAAGTGGATCCCAGGAGTTCAAGACCAGCCTGGCCAAGATGGTGAAACCCCCCATCTCTACTAAAAATACAAAAAAAAAAAAAAAAAAAAAAAAAGGGCTTAGTGGCTGGCAGCTGTAGTCCCAGCTACTCGGGAGGCTGAGGCAGGAGAATCGCTTGAACCTGGGAAGCGGAGGTTGCAGTGAGCCAAGATCACACCATTGCACTCTAGCCTGGGCAACAAGGGCAAAACTCCATCTCAAAAAAAAAGAA","GGCTGGGCGCAGTGGCTCAAGCCTGTAATCCCAGCACTTTGGGAGGCCGAGGGGGGTGGATCACGAGGTCAAGAGATCAAGACCATCCTGGTCAACATGGTGAAACCCCGTCTCTACTAAAAAAAAAAAAAAAAAAAAAAAAAAAAAAAAAAAATTAGCTGGGCATGGTGGCGTGTAATCCCAGCTACTCAGGAGGCTGAGGCAGGAGAATTGCCTGAACCCAGGAGGCGGAGTTTGCGGTGAGCCAAGATCGCGCCATTGCACTCCAGCCTGGGTAACAAGAGCAAAACTCTGTCTCAAAAAAAAAAAAAA"
"chr15","14837014","14837358","JH378137","13677298","13677634","59","1159716","GCCGGGTATGGTGGCTCATGCCTGTAATTCCAGCACTTTGGGAGGCCGAGGCAGGCGGATCACCTGAGGTCAGGAGTTTGAGACCAGCCTGGCTAACATGGTGAAACTACGTTTCTACTAAAAATACAAAAAAAAAAAAAAAAAAAAAAAAAAAAAAAAAAAAAAAAAAAATTAGCCAGGCGTGGAGGCGCGTGCCTATAATCCCAGTTACTCGGGAGGCCGAGGCAGGAGAATCGCTTGAACCCAGGAGCCGGAGGGTGTAGTGAGCCGAGATCATGCCATTGCGCTCCAGGTTGGGCAACAAGAGCAGAACTCCGTCTCAAAAAAAAAAAAAAAAAAAAAAAA","GGCTGGGCATTGTGGCTCATGCCTGTAATCCCAGCACTTTGGGAGGCCGAGGTGGGCGGATCACCTGAGGTCGGGAGTTCAAGACCAGCCTGGCCACAATGGTGAAACTCTGTCTCTGCTAAAAAAAAAAAAAAAAAAAAAAAAAAAAAAAAAAAAAAAATTAGCCAGGCGTGGTGGCACACGCCTGTAATCCCAGCTATTTGGGAGGCTGAGGCAGGAGAATCGCTTGAACCTGAGAGGTGGAGGTTGCAGTGAGCCAAGATCATACCATTGCACTCCAGCTTGGGAACAAAGAGCAAAACGCCATCTCAAAAACAAAACAAACAAACTGAAAAAA"
"chr15","20684723","20685060","JH378262","266823","267148","57","20417900","GGCTGGGCGTGTTGGCTTACACCTGAAATCCCAGCACTCTGGGAGGCCGAGGCGGGCAGATCACCTGAGGTCAGGGGTTCGAGACCAGCTTGGCCAACATGGTGAAACCCCGTCGCTACTAAAAATACAAAAATTAGCTGGGCATGGTGGTGGGAGCCTGTAATCCCAGCTACTCAGGAGACTGAGGCAGGACAATCGCTTGAACCCAGGAGGCAGAGGTTGCAGCGAGCCGAGATCGTGCCACTGCACTCCAGCCTGGGAGGGAAGAGTGAAAGTCCATAACAACAACAAAACAACAAAACAACAACAACAACAACAACAACATCTCTGAAAGGAAA","GGCCGGGCGCGGTGGCTCAAGCCTGTAATCCCAGCACTTTGGGAGGCCGAGGCGGGTAGATCATGAGGTCAGGAGTTTGAGACCAGCCTGGCCAACATGGTGAAACCCCGTCTCTACTAAAAATACAAAAATTAGCCGGGCATGGTGGCCTGTGCCTGTAATCCTAGCTACCCAGGAAGCTGAGGCAGGAGAATTGCCTGAACCCAGGAGGCGGAGGTTGCGGTGAGCCGAGATCGTGCCATTGCACTCCAGCCTGGGTAACAAGAGCGAAACTCCGTCTCAAAAACAAACAAACAAACAAACAAAAACAAAAAACAAAAAACAAA"
"chr15","20894395","20894976","JH378119","32351107","32351490","257","11456712","GGTGGCTCACACCTGTAATCCCAGCACTTTGGGAAGCCGAGGTAGGTGGATCACCTGAGGTCAGGAGTTAGAGATCAGCCTGGACAACATGGTGAAACCCCATCTCTACTAAAAATACAAAAACTAACCAGGCTTGGTGGCTCACACCTGTAATCCCATCACTTTGGGAGGCCAAGGCGGGTGGACTACTTGAGGTCAGGAGTTTGAGACCAGCCTGGCTAACATGGTGAAACCCCATCTCTACTAAAAATACAAAAATTAGCTGGGCATGGCAGTGCGCGCCTGCAATCCCAGCTACCTGGGAGGCTAAGGCAGGGGAATTGTTTGAACCTGGGAGGCAGAGGTTGCAGTGAGCCGACACTGCACCACTGCACTCCAGCCTGGGTGACAGAGTGAGCCTCCGTCTCAAAAAAAAAAAAAAAAAAAAAAAAAAATTAGCCAGGTGTGGTGGCAGGCACCTGTGATCCCAGCTACTCAGGAGGCTGAGGCAGGAGAATTGCTTGAACCCAGGAGGCGGAGAGTGCAGTGAGCTGAGATCATGCCATTGCACTCCAGCCTGGGTGACAAGAGAGAAACTCTGTC","GGCCAGGTATGGTGGCTCACACCTGTAATCCCAGCACTTTGGGAGGCCAAGGCAGGCAGACCACCTGAGGTCAGGAGTTCGAGATCAGCCTAGCCAACATGGTGAAACCCCATCTCTAGTAAAAATAAAATTAGCCAGGCATGGTGGTGCATGCCTGTAACGCAGGTCAGGAGTTCGAGATCAGCTTAGCCAACATGGTGAAACCCCATCTCTAGTAAAAATAAAATTAGCCAGGCAGGTGGTGCCGCCTGTACTCGGGAGGCTGAGGCAGGAGAATCACTTGAACCCAAGAGGCAGAGGTTGCAGTCAGCCAAGATCATGCCATTGCACTCCAGCCTAAGCAAAAAGAGTAAAACTCAGTCTCAAAACAAAAAAACAAAAAAA"
"chr15","21092189","21092737","JH378206","6546474","6546861","200","14545715","GCCGGGCGTGGTGGCTCACGCCTGGCCTGTAATCCCAGCACTTTGGGAAGCCAAGGCGGGTGGTTCACCTGAGGTCAGGAGTTCAAGACCAGCCTGGCCAACATGGTGAAACCCTGTCTCTACTAATAATACAAAAATTAGCTGGGCATGGTGGTGCATGCCTGTAATCCCAGCTACTTGGGAGGCCGAGGCGAGCAGATCACCTGAGGTCAAGAGTTCGATACCAGCCTGACCAACATAGAGAAACCCCGTCTCTACTAAAAATGCAAAATTAGCCGGGCATGGTGGTGCATGCCTGTAATCCCCAGCTACTCGGGAGGCTGAGGCAGGAGAATCGCTTGAACCTGGGAGGCAGAGGTTGTGGTGAGCTGAGATCACGCCATTGCACTCCAGCCTGGGCTCGAAACTCCATCTTAAAAAAAAAAAAAAAAAAAAGAATCACTTGAACCCAGGAGGTGGAGGTTGCAGTGAGCTGAGAGTGCACCATTGTACTCCAGCCTGGGCGACAACAGCAAAACTCCATCACCTTAAAAAAAAAAAAAAAAAAGA","GGCCACACATGGTGGCTAACGCCTGTAATCCCAGCACTTTGGGAGGCCAAGTCGGGTGGATCATGAGGTCAGGAGACCAAGACCATCCTGGCCAAATGGTGAAACCCCGTCTCTACTAAAAATACAAAAATTAGCTGGGCATGGTGGCGTGTGCCTGTAATCCCAGCTACTCAGGAGGCTGAGGCAGGACAATTGCCTGAACCCAGGAGAATTAGCTGGGCATGGTGGCGTGTGCCTGTAATCCCAGCTACTCAGGAGGCTGAGGCAGGACAATTGCCTGAACCCAGGAGGCGAAGGTTGCGGTGAGCCGAGATTGTGCCATTGCACTCCAGCCTGGGTAACAAGAGCGACACTCTGTCTCAAAAAAAAAAAAAAAAAAAAAAAAAAA"
"chr15","21150084","21150391","JH378158","10397018","10397312","55","10753066","GGCCGGGCATGGTGGCTTATGCCTGTAATCCCAGCACTTTGGGAGGCTGAGGTGGGTGGATCACCTGAGGTCAGGAGTTCAAGACCACCCTGGTCAACATGGCAAAATCCTGTCTCTACTAAAAATACAAAATTAGCTGGGCGTGGTGGTGGGCGTCTGCCTGGGTGAGGCAGGAGAATCGCTTGAACCCAAGAGGCAGAGGTTGGAGTGAGCCAAGATCGTGCCATTGCACTCCAGCCTGGGCAACGAGAGTGAAACCCCATCTCAGAAAAAAAAAAGAAAAAGAAAAAGAAAAAAGTAAAAAAAAA","GGCTGAGCACAGTGGCTCACACCTGTAATCCCAGCACTTTGGGAGGCCGAGGCGGGTGGATCACCTGAGATCAGGAGTTCAAGAACAGCCTGACCAACATGGTGAAACCTATCTCTACTAAAAATACAAAATTAGCCTGGCATGGTGGCGCGTGCCTGTAATCTGGCTGAGGCAGAAGAATCGCTTAAACCCAGAGGCAGAGATTGCAGTGAGCCAAGATTGTGTCATTGCACTCCAGCCTGGGCAACAAGAGCAAAACTCCATCTCAGAAAAAAAAAAAAAAAGAAGAAAAAAA"
"chr15","21563578","21564184","JH378118","18053084","18053501","255","3510494","GGCCAGGCATGGTGGCTCACACCTGTAATCGCAGCACTTTGGGAGACTGAGGCAAGCAGATCACCTGAGGTTAGAAGTTCAAGACCAGCCTGGCCAACACAGTGAAACCCCATCTCTACTAAAAATACAAAAAAATGGCCGGGTGCAGTGGCTCATGCCTGTAATCCCAGCACTTTGGGAGGCTAAGGCAGGGGGAATCACAAGGTCAAGAGATCAAGACCATCCTGGTAAAACCCCGTCGGTACTAAAAATACAAAAATTAGCTGGGTGAGGTGGCATGCACCTGTAGCCCCAGCTACTCGGGAGGCTGAGACAGGAGAATCACTTGAACCTGGGAGGCAGAGGTTGCAGTGAGCTGAGATCGCACCACTGCACTCCAGCCTGGCAACAGAGGAAGACTCTGTCTAAAACTAATAATAATAATAATAATAATAATAAAATTAGCTGGGAGTAGTGGCGGGCACCTGTAATCCCAGCTACTTGGGGGGGCTGAGGCAGGAGAAAAGCTTGAACCCGGGAGGTGAAGGTTGCAGTAAGCCAAGATCACGCCATTGCACTCCAGCCCGGGCAACAAGAGCGAAACTTCGTTTCAAAAAAAAAAAAAAAA","GGCTGGGCGCAGTGGCTCACACCTGTAATCCCAGCACTTAGGGAAGCTGAGGCGAGTAGATCACCTGAGGTCAGGAGTTAGAGACCAGCCTGGCCATCATGGTGAAACCCCGTCTCTACTAAAGATACCAAAAATTAGCTGAGTGTGGTGCTGGGTGCCTGTAATCCCAGAAACTCAGGGTGCCTGTAATCCCAGCAACTCAGGGTGCCTTTAATCCCAGCAACTGAGGGTACCAGTAATCCCAGCAACTCAGGGTGTCTTTAATCCTAGCAACTGAGGGCACCTGTAATCCCAGCAACTCAGGAAGCTGAGACAGGAGAAGTACTTGAACCCAGAAGGCAGAGGTTGCAGTGAGCCGATATTGCACCATTGCACTCCAGTCTGGGCAACAAGAGTGAAACTCTGTCTCAAAAAAAAA"
"chr15","22132229","22132799","JH378118","18053084","18053501","233","4079145","GGAGGCCAAGGTGGGCGAATCACCGGTGGTCAGGAGTTTGAGACTAGCCTGGCCAACATGGTGAAACCCCGTCTCTACTAAAAAATACAAAAATTAGGCCGAGTGTGGTGGCTCATGCCTGTAATCCCAGCAGTTTGGAAGGCCAAGGCGGGCAGATCACCTGAGGTCAGGAGTTCAAGACCAGCCTGGCCAACACAGTGGAACCCTGTCTCTACTAAAAATACAAAAAAAATTTGCCAGGCATGGTGGTGTGTGTGCCTATAATCCCAGCTACTCAGGAGACTGAGGCAAGAGAACTGCATGAACCCCAGAGGGAGAGGCTGCAGTGAGCTGAGATCGTACCACTGCACTCCAGCCTGGGTGACAGGGCAGGACTCCGTCTCAAAAAAAAAAAAAAAAAAAAAAAATTAGCCAGGTGTGGTGGCGAGCACCTGTAATCCTAGGTACTTGGGAGGCTGAGAAAGGAGAACCACTTGAACCCCGGAGGCAGAGGTTGCAGTGAGTGGAGATTGTGCGCCATTGCACTCCAGCCTGGGTGACAAGTGTGAAATTCTGCCTCAAAAAAAAAAAA","GGCTGGGCGCAGTGGCTCACACCTGTAATCCCAGCACTTAGGGAAGCTGAGGCGAGTAGATCACCTGAGGTCAGGAGTTAGAGACCAGCCTGGCCATCATGGTGAAACCCCGTCTCTACTAAAGATACCAAAAATTAGCTGAGTGTGGTGCTGGGTGCCTGTAATCCCAGAAACTCAGGGTGCCTGTAATCCCAGCAACTCAGGGTGCCTTTAATCCCAGCAACTGAGGGTACCAGTAATCCCAGCAACTCAGGGTGTCTTTAATCCTAGCAACTGAGGGCACCTGTAATCCCAGCAACTCAGGAAGCTGAGACAGGAGAAGTACTTGAACCCAGAAGGCAGAGGTTGCAGTGAGCCGATATTGCACCATTGCACTCCAGTCTGGGCAACAAGAGTGAAACTCTGTCTCAAAAAAAAA"
"chr15","23508255","23508883","JH378118","18053084","18053501","275","5455171","GGTCGGGTGTGGTGGCTCATGCATGTAATCCTGGCACTTTGGGAGGCCGAGGCGGGTAGATCACCTGAGGTCACGAGTTTGAGACCAGCCTGACCAACATGGTAAAACTTTGTTTCTACTACAAATACAAAAAATTGGCCAGGCTCGGTGGCTTCCGCCTGTAATCCCAGCACTTTGGGAGGCCGGGGTGCATGGATCACCTGAGGTCAGGACTTCGAGACCAGCCTGGCCAACATGGTGAAACCCCATCTCTACTAAAAATACAAAAAAAAAAAAAAAAATGAGCCAGGCATATTGGTGGGCGCCTGTAATCCCAGCTACTTGGAAGGCTGAGACAGGAGAATCACTTGAACCTGGGAGGCGGAGATTGCAGTGAGCCGAGATCATGCCACTGTACTCCATCCTGGGTGACAAGAGTGAGACTGCATCTCAAAAAAAAAAAAACCAAAAAACCAAAAAAAAACAAAAAATTAGTCAACCGTAGTGGTGGGCCCCTATAATCTCAGCTGCTCAGGAGGCTGAGGCAGTAGAATCACTTGATCCCAGGAGGTGGAGGTTTCAGTGAGCTGAGATCATGCCATTGTACTCCAGCCTGGGCAACAAGAGCGAAACTCTATCTCAAAAAATAA","GGCTGGGCGCAGTGGCTCACACCTGTAATCCCAGCACTTAGGGAAGCTGAGGCGAGTAGATCACCTGAGGTCAGGAGTTAGAGACCAGCCTGGCCATCATGGTGAAACCCCGTCTCTACTAAAGATACCAAAAATTAGCTGAGTGTGGTGCTGGGTGCCTGTAATCCCAGAAACTCAGGGTGCCTGTAATCCCAGCAACTCAGGGTGCCTTTAATCCCAGCAACTGAGGGTACCAGTAATCCCAGCAACTCAGGGTGTCTTTAATCCTAGCAACTGAGGGCACCTGTAATCCCAGCAACTCAGGAAGCTGAGACAGGAGAAGTACTTGAACCCAGAAGGCAGAGGTTGCAGTGAGCCGATATTGCACCATTGCACTCCAGTCTGGGCAACAAGAGTGAAACTCTGTCTCAAAAAAAAA"
"chr15","23602365","23603005","JH378118","18053084","18053501","286","5549281","GGTCGGGTGTGGTGGCTCATGCATGTAATCCTGGCACTTTGGGAGGCCGAGGCGGGTAGATCACCTGAGGTCACGAGTTTGAGACCAGCCTGACCAACATGGTAAAACCTTGTTTCTACTACAAATACAAAAAATTGGCCAGGCTCGGTGGCTTCCGCCTGTAATCCCAGCACTTTGGGAGGCCGGGGTGCATGGATCACCTGAGGTCAGGACTTCGAGACCAGCCTGGCCAACATGGTGAAACCCCATCTCTACTAAAAATACAAAAAAAAAAAAATGAGCCAGGCATATTGGTGGGCGCCTGTAATCCCAGCTACTTGGAAGGCTGAGACAGGAGAATCACTTGAACCTGGGAGGCGGAGATTGCAGTGAGCCGAGATCATGCCACTGTACTCCATCCTGGGTGACAAGAGTGAGACTGCATCTCAAAAAAAAAAAAAACCAAAAAACCAAAAAAAACCAAAAAATTAGTCAACCGTAGTGGTGGGCCCCTATAATCTCAGCTGCTCAGGAGGCTGAGGCAGTAGAATCACTTGATCCCAGGAGGTGGAGGTTTCAGTGAGCTGAGATCATGCCATTGTACTCCAGCCTGGGCAACAAGAGCAAAACTCTATCTCAAAAAAAAAAAAAAAAAAGAAAAA","GGCTGGGCGCAGTGGCTCACACCTGTAATCCCAGCACTTAGGGAAGCTGAGGCGAGTAGATCACCTGAGGTCAGGAGTTAGAGACCAGCCTGGCCATCATGGTGAAACCCCGTCTCTACTAAAGATACCAAAAATTAGCTGAGTGTGGTGCTGGGTGCCTGTAATCCCAGAAACTCAGGGTGCCTGTAATCCCAGCAACTCAGGGTGCCTTTAATCCCAGCAACTGAGGGTACCAGTAATCCCAGCAACTCAGGGTGTCTTTAATCCTAGCAACTGAGGGCACCTGTAATCCCAGCAACTCAGGAAGCTGAGACAGGAGAAGTACTTGAACCCAGAAGGCAGAGGTTGCAGTGAGCCGATATTGCACCATTGCACTCCAGTCTGGGCAACAAGAGTGAAACTCTGTCTCAAAAAAAAA"
"chr15","23603280","23603615","JH378109","21565230","21565567","55","2038050","GGCCAGGCGCGGTGGCTCATGCCTATAAACTCAGCACTTTGAGAGGCTGAGGCGGGTGGGTCACCTGAGGTCAGGAGTTAGAGACCAGCCTGGCCAACATGGTGAAACCGTGTTTCTACTAAAGATACAACATTAGCCAGGCATGGTGGCGCATGCCTGTAATCCCAGCTACTAGGGAGGCTGCGGCAGGAGAATCGCTTGAACGCAGGAGGTGAAGGTTGCAGTGAGCTGAGATCGTGCCATTGCACTCCAGCCTGGGTGACAAGAGCGAAACTCCATCCCAATCAATCAATCAATCAATCAATCAATTAAATTAAAAAAATAAAAAGAAAGAAA","GGCCGGGCGCGGTGGCTCAAGCCTGTAATACCAGCACTTTGGGAGGCCGAGGCGGGTGGATCACGAGGTCAAGAGATCGAGACCATCCTGGTCAACATGGTGAAACCCCGTCTCTACTAAAAATACAAACAATTAGCTGGGCATGGTGGCGGGTGCCTGTAATCCCAGCTACTCCAGAGGCTGAGGCAGGAGAATTGCCTGAACCCAGGAGACGGAGGTTGCGGTGAGCCAAGATCGCGCCATTGCACTCCAGCCTGGGTGACAAGAGCGAAACTCCGTCTCAATAAATAAATAAATAAATAAATAAATAAAAATAAAATAAATAAATAAATAAATAA"
"chr15","38315253","38315599","JH378169","5922203","5922541","56","32393050","GCCAGACACGGTGGCTCACGCCTGTAATCCCAGCACTTTGGGAGGCCGAGGCGGGTGGATCACCTGAGGTCAGGAGTTCGAGACCAGCCTGGCCAACATGGCGAAATCCTGTCTCTACTAAAAATACACACACACACACACACACACACACACACACACACACACATACACACACAAAATTAGCTGGGCATGGTGGCAGGTGCCTGTAATCCCAGCTACTTGGGAGGCTGAGGCAGGAGAATCACTTGAACCTGGGAGGCGGAGATTGCAGTGAGCCAAGATCATGCCATTGCACTTCAGCCTGGGCAACGAGAGTGAAACTCTGTCTCAAAAAAAAAAAAAAAAAA","GGCCAAGGGTGGTGGCTCACACCTGTAATCCCAACACTCTGGGAGGCCAAGGTGGGTGGATCACCTAAGGTCAGGAGTTCAAGACCAGCATGGCCAATATAGTGAAACTCTGTCTCTACTAAAAATACACACACACAAAAAAAAACAAAACACAAAAAAAACCACAAAATTAGCCGGGCATGGTGGCATGTGCCTGTAATCCCAGCTACTCAGGAGGCTGAGGCAGGAGAATCACTTAAACCCAGGAAGCGGAGGTTGCAGTGAGCCAAGATTGCGCCACTGCACTCCAGCCTAGGTGACAAGAGCAAAACTCTGTCTCAAAAAAAAAAAAAAAAAAAA"
"chr15","39410478","39411079","JH378118","18053084","18053501","249","21357394","GGCCGGGCACGGTGGCTCACGCCTGTAATCCCAGCACTTTGGGAGTCTGAGGTGGGCAGATCCACCTGAGGTCAGGGGTTCAAGACCAGCATGGCCAACATGGTGAAACCTCATCTCTACTAAAAATACAAAAATTAGGCTGGGTGCGGTGGCTCACGCCTGTAATCCCAGCACTTTGGGAGGCCAAGGCAGGTGGATCACCTGAGGTCAGGAGTTCGAGACCAGCATGGCCAACATAGCGAAAATCCGTCTCTACTAAAAACACAAAAATTAGCCAGGTGTGTTGGCTTACACCTGTAATCCCAGCTACACAGGAGGCTGAGGCAGAAGAATCACTTGAATCCAGGAGGTGGAGGTTGCAGTGAGCCGAGATCGCGCCACTGCCCTCCAGCCTGGGTGACAGAGCAAGACACCATCTCAAAAAAAAAAAAAAAAAAATTAGCTGGGCATGGTCACAGGTGCCCCTAATCCCAGCTACTCAGGAGGCTGAGGCAGGAGAATTGCTTGAACCCAGGAGACGGAGGTCACAGTGAGCGGTAATTGTGCCATTGCACTTCAACCTGGGTGACAAGAGCAAAAGTCCATCTCAAAAAAAAAAAAAA","GGCTGGGCGCAGTGGCTCACACCTGTAATCCCAGCACTTAGGGAAGCTGAGGCGAGTAGATCACCTGAGGTCAGGAGTTAGAGACCAGCCTGGCCATCATGGTGAAACCCCGTCTCTACTAAAGATACCAAAAATTAGCTGAGTGTGGTGCTGGGTGCCTGTAATCCCAGAAACTCAGGGTGCCTGTAATCCCAGCAACTCAGGGTGCCTTTAATCCCAGCAACTGAGGGTACCAGTAATCCCAGCAACTCAGGGTGTCTTTAATCCTAGCAACTGAGGGCACCTGTAATCCCAGCAACTCAGGAAGCTGAGACAGGAGAAGTACTTGAACCCAGAAGGCAGAGGTTGCAGTGAGCCGATATTGCACCATTGCACTCCAGTCTGGGCAACAAGAGTGAAACTCTGTCTCAAAAAAAAA"
"chr15","45225530","45226131","JH378133","19690365","19690767","253","25535165","GGCCGGGCACAGTGGCTCATGCCTGCAGTTCCAGCACTTTTGGAGGCCGAGGCAGGCCGATCACTTGAGGTCAGGAGTTCGAGACCACCCCGGCTAACGTGGTGCAACTCCATCTCTACTAAAAATACAAAATTGGCCGGGTGCGGTGGCTCATGCCTGTAATCCCAGCACTTTGGGAGGCCGAGGCGGATGGATCACCTCAGGTCAGGAGTTCGAGACCAGCCTGGCCAATGTGGTGAAACCCCGTCTCTACTAATAATACAAAAATTAACTGGGTGTGGTGGTGGGCACCTATAATCCCAGCTACTCGGGAAGCTGAGGCAGGAGAATCACTTGAACCTGGGAGGTGGAGATTGCAGTGAGCTGAGATGGTGCCATTACACTCCAGCCTGGGCAACGAGAGTGAAACTCTGTCTCTAAATAAATAAATACAAAATTAGCCGGGCATGGTGGCGGATGCCTATAATCACAGCTACTTGGGAGGCTGAGGCAAGAGAATCACTTGAACCTGGGAGGTGGAGGTTGCAGTGAGCTGAGATCAAGCCATTGCACTCCAGCCTGGGCAAAAAGAGTGAAACTCTGTCTCAAAAAAAAGAAAGAAA","GGCCAGGCACAGTGGTTCATGTCTGTAATCAGCATTTTGGGAGGCTGAGGCGGGAGAATCACCTGAGGCCAGGAGTTCTAGATGAGCCTGGGCAAATAGTGACAACCTGTCCCTACAAAAAAATTTAAAATTAGCCAGGATTGAGACCATCCTGGCTCACGTGGTGAAACCCCATCTTTACTTAAAATACTTAAAATGCAAAAAACATTTTTTTTTGTATTTTATTTAAAATACAAAAAAACTAGGCAGGCATGTTGGCACGTGCCTGTAGTCCCAGATACTTGGGAGGCTGAGGCAAGAGAATCACTTGAACCCAGGAGGTGGAGGTTGCAGTGAGCCGAGATCATACCACTGCACTCCAGCCTGGGTGACAAGAGTGAAACTCTGTCTCAAAAAAAAACAA"
"chr15","46581057","46581661","JH378118","18053084","18053501","254","28527973","GGCCGGGCGCGGTGGCTCACGCCTGTAGTCCCAGACTTTGGGAGGCCGAGGTGGGCGGATTGCCTGAGGTCAGGAGTTCAAGACCAACCTGGCCAACATGGTGAAATGCCGTCTCTACTAAAAATACAAAAATTAGGCCGGGCACGGTGGCTCATGTCTATAATCCCAGCACTTTGGGAGGCCGAGGTGGGCGGATCACGAGGTCAGGAGATCGAGACCATCCTGGCTAACACGGTGAAACCCCGTCTCTACTAAAAACACAAAAAATTAGCCGGGCGTGGTGGCAGGCACCTGTAGTCTCAGCTACTCAGGAGGCTGAGGCAGGAGAATGGCGTGAACTTGGGAGGCGGAGCTTGCAGTGAGCCAAGATTGTGCCACTGCACTCCAGCCTGGGCAACAGAGCGAGACTCTGTCTCAAAAAAAAAAAAAAAAATTAGCCAGGTGTGGTGGCAGGTGCCTGTAATCCCAGCTAATTGGGAGGCTAAGGCAGGAGAATCTCTTGAACCCAGGAGGCAGAGGTTGCAGTGAGCCAAGATTTCGCCATTACACTCCAGCCTGGGCAACAAGAGCTAGACTCCATCTCAAAAATAAATAAATAAAATAAA","GGCTGGGCGCAGTGGCTCACACCTGTAATCCCAGCACTTAGGGAAGCTGAGGCGAGTAGATCACCTGAGGTCAGGAGTTAGAGACCAGCCTGGCCATCATGGTGAAACCCCGTCTCTACTAAAGATACCAAAAATTAGCTGAGTGTGGTGCTGGGTGCCTGTAATCCCAGAAACTCAGGGTGCCTGTAATCCCAGCAACTCAGGGTGCCTTTAATCCCAGCAACTGAGGGTACCAGTAATCCCAGCAACTCAGGGTGTCTTTAATCCTAGCAACTGAGGGCACCTGTAATCCCAGCAACTCAGGAAGCTGAGACAGGAGAAGTACTTGAACCCAGAAGGCAGAGGTTGCAGTGAGCCGATATTGCACCATTGCACTCCAGTCTGGGCAACAAGAGTGAAACTCTGTCTCAAAAAAAAA"
"chr15","46659994","46660594","JH378118","18053084","18053501","247","28606910","GCTGGGCATGGTGGCTTACGCCTGTAATCCCAGCACCTTGGGAGGCTGAAGTGAGCAAATCACCTGAGTTCAGGAGTTCAAGACCAGCCTGGCCAACATGGTGAAAACCCATCTCTATTAAAAATTACAAAAATGGCCAGACACGGTAGCTCACGCCTGTAATCCCAGCACTTTGGGAGGCTGAGGCGGGCAGATCACCTGAGGTTGGGAGTTGGAGACCAGCTTGACCAACATGGAGAAACCCCCTCTCTACTAAAAATACAAAATTAGCCAGGCGTGGTGGCACATGCCTGTAATCCCAGCTACTTGGGAGGCTGAGGCAGGAGAATCACTTCAACCCGGAAGGTGGAGGTTGTGGTGAGCTGAGATTGTGTCATTGCACTCTAGCCTGGATAACAAAGGCAAAACTCAGTCTCAAAAAAAAAAAAAATTACAAAAATTAGCTGGCGTGGTGGCAGGTGCCTATAATCCCAGCTACTCAGGAAGCTGAGGCAGGAGAATCACTTGAAACCAGGAGGCAGAGGTTGCAGTGAGCTGAGACCACGCCATTGCCCTCCTGCCTGGGTGACAAGAGTGAAACTCCATCTCAAAAAAAAAAAAA","GGCTGGGCGCAGTGGCTCACACCTGTAATCCCAGCACTTAGGGAAGCTGAGGCGAGTAGATCACCTGAGGTCAGGAGTTAGAGACCAGCCTGGCCATCATGGTGAAACCCCGTCTCTACTAAAGATACCAAAAATTAGCTGAGTGTGGTGCTGGGTGCCTGTAATCCCAGAAACTCAGGGTGCCTGTAATCCCAGCAACTCAGGGTGCCTTTAATCCCAGCAACTGAGGGTACCAGTAATCCCAGCAACTCAGGGTGTCTTTAATCCTAGCAACTGAGGGCACCTGTAATCCCAGCAACTCAGGAAGCTGAGACAGGAGAAGTACTTGAACCCAGAAGGCAGAGGTTGCAGTGAGCCGATATTGCACCATTGCACTCCAGTCTGGGCAACAAGAGTGAAACTCTGTCTCAAAAAAAAA"
"chr15","46772064","46772669","JH378118","18053084","18053501","251","28718980","GGCTGGGTGCAATGGCTCATGCCTGTAATTCCAGTGTTTTGGGAGGCCGAGGCAGGTGGATCACTTGAGATCAGGAGTTCGCGACCAACCTGGCTAACATGGTGAAACCCCGTCTCTACTAAAAATACAAAAAATTGGCCAGGAGCGGTGGCTCAAACCTGTAATTCCAGCACTTTGGGAGGCCGAGGGGGGCAGATCACGATGTTTAGGAGTTTGAGATCAGACTGACCAACATGGTGAAACCCCATCTCTACTAAAAATACAAAAATTAGCCAGGCGTGGTGGTGCATGTCTGTAATCCCAGCTACTTGGGAGGCTGAGGCAGGAGAGTTGCTTGAAGCCGGGAGGTGGAGGTTGCAGTGAGCTGAGATCACACCACTGCACTCCAGCCTGGGCGACAGAGCAAGACTGTCTCAAAAAAAAAAAAAAAAAAAAAAATTAGCCAGCTTGGTGGCGGGCATCTGTAATCCCAGCTACTCGGGAGGCTGAGGCAGGAGAATCACTTGAACCCAGGAGGCAGAGGTCGCAGTGAGCCAAGATCACGCCATTGTACTCCAGCCTGGGCAACAAGAGCAAAACTCCATCTCAAAAAACAAAAAATAAAAA","GGCTGGGCGCAGTGGCTCACACCTGTAATCCCAGCACTTAGGGAAGCTGAGGCGAGTAGATCACCTGAGGTCAGGAGTTAGAGACCAGCCTGGCCATCATGGTGAAACCCCGTCTCTACTAAAGATACCAAAAATTAGCTGAGTGTGGTGCTGGGTGCCTGTAATCCCAGAAACTCAGGGTGCCTGTAATCCCAGCAACTCAGGGTGCCTTTAATCCCAGCAACTGAGGGTACCAGTAATCCCAGCAACTCAGGGTGTCTTTAATCCTAGCAACTGAGGGCACCTGTAATCCCAGCAACTCAGGAAGCTGAGACAGGAGAAGTACTTGAACCCAGAAGGCAGAGGTTGCAGTGAGCCGATATTGCACCATTGCACTCCAGTCTGGGCAACAAGAGTGAAACTCTGTCTCAAAAAAAAA"
"chr15","48446925","48447526","JH378118","18053084","18053501","252","30393841","GGCCAAGTGCAGTGGCTCACGTTTGTAATCCCAGCACTTTGGGAGGCCGAGGCGGGTGGATCACCTGATGTCAGGGGTTTGAAACCAGCCTGGCCAACATGGTGAAACCCCATCTCTAATAAAAATACAAAACTGGCCAGGTGCAGTGGCTCATGCCTGTAATCCCAGCACTTTGAGAGACCAAGGGAGGCAGATCACCTGAGGTCAGGAGTTCCAGACCAGCCTAGCCAACATGGTGAAACCCTATCTCTACTAAGAGTACAAAAATTAGCCTGGCGTGGTGGCAGGCGCCTGTAATCCCAGCTACTCAGAAGGCTGAGGCAGGAGAATCACTTGAACCCAGGAGGCGGAGGTTGCAGTGAGCCGAGATTGAGCCACTACACTCCAGCCTGGGTGACAAGAACAAGACTCTGTCTCAAAAAAAAAAAAAAAAAAAGCCGGTCATGGTGGCACATGCCTATAATCCCAGCTTCTTGGGAGGCTGAGGCAGGAGAACCACTTGAACCTGGGAGGTGGAGGCTGCAGTGAGCCGAAATTGTGCCATTGCACTCTAGCCTGGGCAACAAGAGCAAAACTCTCTCAAAAAAAAAAAAAAAAAAAAA","GGCTGGGCGCAGTGGCTCACACCTGTAATCCCAGCACTTAGGGAAGCTGAGGCGAGTAGATCACCTGAGGTCAGGAGTTAGAGACCAGCCTGGCCATCATGGTGAAACCCCGTCTCTACTAAAGATACCAAAAATTAGCTGAGTGTGGTGCTGGGTGCCTGTAATCCCAGAAACTCAGGGTGCCTGTAATCCCAGCAACTCAGGGTGCCTTTAATCCCAGCAACTGAGGGTACCAGTAATCCCAGCAACTCAGGGTGTCTTTAATCCTAGCAACTGAGGGCACCTGTAATCCCAGCAACTCAGGAAGCTGAGACAGGAGAAGTACTTGAACCCAGAAGGCAGAGGTTGCAGTGAGCCGATATTGCACCATTGCACTCCAGTCTGGGCAACAAGAGTGAAACTCTGTCTCAAAAAAAAA"
"chr15","59372839","59373447","JH378118","18053084","18053501","260","41319755","GGCCAGGATCAGTGTCTCACACCTGTAATCCTAGCACTTTGGGAGGCTAAGGTGGGCGGATTACTTGAGGTCAGGAGTTTGAGACCAGCCTGGGCAACATGGTGAAACCCCGTCTCTACTAAAAATACAAAAATTAGCTGGGCATAGGCCAGGAGTGGTGGCTTACGCCTGTAATTCCAGGACTTTGGGAGGCTGAGGCGGGCAGATCATGAGGTCAGGAGATTGAGACCATCCTGGCTAACATGGTGAAACCTCATCTCTACTAAAAATACAAAAATTAGCCAGTCGTGGTGGTAGGCGCCTGTAGTCCCAGCTACTTGAGAGGCTGAGGCAGGAGAATCACTTGAATCCGGGAGGTGGAGGTTGCAGTGAGCCGAGATTATGCCACTTCACTCCAACCTGGTGACAGAGCAAGACTCCGTCTAAAAAAAAAAAAAAAAATTAGCTGGGTGTGGCGGGCACTTGCAATCCCAGCTACTTAGGAGGCTGAGGCAGGAGAACCGCTTGAACCTGGGAGGTAGAGGTTCCAGATCACGCCATTGCACTCCTGCTTGGGCAACAAGAGTGACACTCCATCTCAAAAAAACAAAAAAAAAAAAGAAAAAGAAA","GGCTGGGCGCAGTGGCTCACACCTGTAATCCCAGCACTTAGGGAAGCTGAGGCGAGTAGATCACCTGAGGTCAGGAGTTAGAGACCAGCCTGGCCATCATGGTGAAACCCCGTCTCTACTAAAGATACCAAAAATTAGCTGAGTGTGGTGCTGGGTGCCTGTAATCCCAGAAACTCAGGGTGCCTGTAATCCCAGCAACTCAGGGTGCCTTTAATCCCAGCAACTGAGGGTACCAGTAATCCCAGCAACTCAGGGTGTCTTTAATCCTAGCAACTGAGGGCACCTGTAATCCCAGCAACTCAGGAAGCTGAGACAGGAGAAGTACTTGAACCCAGAAGGCAGAGGTTGCAGTGAGCCGATATTGCACCATTGCACTCCAGTCTGGGCAACAAGAGTGAAACTCTGTCTCAAAAAAAAA"
"chr15","64220715","64221335","JH378118","18053084","18053501","268","46167631","CCAGGCACAGTGGCTCATACCTGTAATCCCAGCACTTTGGGAGCCCAAGGCGGGCAGATCACCTGAGGTCAGGAGTTCGAGACCAGCCTGGACAACATGGAGAAACTCCATCTCTACTAAAAATACAAAATGAGGCCGGGCACAGTGGCTCACACCTATAATCCCAGCACTTTTGGAGGCCGAGACAGGCAGCTCACGAGGTCAGGAGTTCAAGACCAGCCTGGCCAGCATGGTGTAACCCCGTTTCTACTAAAAATACAAAAATTAGCCAGGCATGGTGGTGCGTGCCTGTAGTCCTCAGGAGGCTGAGGCAGGAGAATCGCTTGAATCTGGGAGGCGGAGCTTGCAGTCAGCTGAGATCAGGCTACTGCACTGCAGCTTGGGCAACAGAGTGAGACTCCGTCTCAAAAACAAACAAACAAACAAACAAAACACAACAAAATTAGCTGGGCATGGTGGCAGGTGCCTGTAATCCCAGCTACTCAGCTACTCAGGAGGCTGAGGCAGGAGAGTCACGTGAACCTGGGAGGCAGAGGTTGCAGTGAGCCAAGATCACGCCATTGCACTCCAGCCTGGGCAACAAGAGGGAAATTACATCTCAAAAAAAAAAAAAAAAAAAAA","GGCTGGGCGCAGTGGCTCACACCTGTAATCCCAGCACTTAGGGAAGCTGAGGCGAGTAGATCACCTGAGGTCAGGAGTTAGAGACCAGCCTGGCCATCATGGTGAAACCCCGTCTCTACTAAAGATACCAAAAATTAGCTGAGTGTGGTGCTGGGTGCCTGTAATCCCAGAAACTCAGGGTGCCTGTAATCCCAGCAACTCAGGGTGCCTTTAATCCCAGCAACTGAGGGTACCAGTAATCCCAGCAACTCAGGGTGTCTTTAATCCTAGCAACTGAGGGCACCTGTAATCCCAGCAACTCAGGAAGCTGAGACAGGAGAAGTACTTGAACCCAGAAGGCAGAGGTTGCAGTGAGCCGATATTGCACCATTGCACTCCAGTCTGGGCAACAAGAGTGAAACTCTGTCTCAAAAAAAAA"
"chr15","65873443","65873774","JH378165","3784440","3784761","45","62089003","GGCCAGGCACGGTGGCTCACACGTGTAATCCCAGCACCTTGGGAGACCGAAGCAGGTGGATCACCTGAGGTCAGGAGTTTGAGGCCAGCCTGGCCGATATGGTGAAACCCTATCTCTATTAAAAATACCAAAAAAAAAAAAAAAAAAAAAAAAACCTGCTGGGCGTGGTGGCGCACGCCTGTAATCCCAACTACTCAGGAGGCTGAGGCAGGAGAATCACTTGAATCCAGGAGGCAGAGGTTGCAGTGAGCCGAGATCGCGCCATTGCACTCCAGCCTGGGCAACAAGAGCGAAACTCGGTCTCAAAAAAAAAAAAAAAAAAAGAAAAGAAA","GGCCGGGCGCGGTGGCTCAAGCCTGTAATCCCAGCACTTTGGGAGGCCGAGGCAGGTGGATCATGAGGTCAAGAGATCAAGACCATCCTGGTCAACATGGTGAAACCCCGTCTCTACTAAAAATACAAAAAAAAAAAAAAAAAAACTAGCTGGGCGTGGTGGCGCATGCCTGTAATCCCAGCTACTCAGGAGGCTGAGGCAGGAGAATTGCTTGAACCCAGGAGGCGGAGGTTGCGGTGAGCCCAGATCGCGCCATTGCACTCCAGCCTGGGTAACAAGAGCAAAACTCCATCTCAAAAAAAAAAAAAAAAAAAAAAAAAAA"
"chr15","70453292","70453944","JH378118","18053084","18053501","292","52400208","GGCCAGGCACGGTGGCTCATGCCTGTAATCCCAACACTTTGGGAGGCTGAGGTAGGTAGATCACCTGAGGTTGAGGTCAGGAGTTTGAGACCAGCCTGGCCAACATGGTGAAACTCTGTCTCTACTAAAAATACAAAAATTTGGCCCGGCGCAGTGGCTCACCTGTAATCCCAGCACTTTGGGAGGCCGAGGCAGGCAGATCACGAGGTCTGGAGATCAAGACCATCCTGGCTAACTCGGTGAAATCCCATCTCTACTAAAAATACGAAAAATTAGCCAGGTGTGGTGGCGGGCACCTGTAGTCCCAGCTACTTGGGAGGCTGAGGCAGGAGAATGGCGTGAACCTGGGAGGTGGAGCTTGCAGTGGGCCAAGATCACGCCACTGCACTCCAGCCTGGGCAACAGAGTGAGACTCTGTCTCAAAATAAAATAACATAAAATAAAATAAAGTAATATAAAATAAAAATACAAAAATTAGCTGGGCATGGTAGCGGGTACCTATAATTCCAGCTACTTGAGAGGCTGAGGCTGGAGAATCACTTGAATCTGGGAGGTGGAGGTTGCAGTGAGCCAAGATTGCACCATTGCACTCCAGCCTGGGCAACAAGAGCCAAACTCCGTATCAAAAAAAAAAAAAAAAAGAAAAAGAAAAA","GGCTGGGCGCAGTGGCTCACACCTGTAATCCCAGCACTTAGGGAAGCTGAGGCGAGTAGATCACCTGAGGTCAGGAGTTAGAGACCAGCCTGGCCATCATGGTGAAACCCCGTCTCTACTAAAGATACCAAAAATTAGCTGAGTGTGGTGCTGGGTGCCTGTAATCCCAGAAACTCAGGGTGCCTGTAATCCCAGCAACTCAGGGTGCCTTTAATCCCAGCAACTGAGGGTACCAGTAATCCCAGCAACTCAGGGTGTCTTTAATCCTAGCAACTGAGGGCACCTGTAATCCCAGCAACTCAGGAAGCTGAGACAGGAGAAGTACTTGAACCCAGAAGGCAGAGGTTGCAGTGAGCCGATATTGCACCATTGCACTCCAGTCTGGGCAACAAGAGTGAAACTCTGTCTCAAAAAAAAA"
"chr16","217191","217526","JH378138","4229795","4230103","77","4012604","ATTTTGGGAGGCTGAGATGAGTGATGAGCGGATCACCTGAGGTCAGGAGCTCGAGACCAGTCTGGCCAACACGGTGAAACCCTGTCTCTACTAAAAGTACCAAAAAAATTAGCCAGGCATGGCAGTGGGCGCCTGTAATCCCAACTACTCGGGAGGCTGAGGCAGGAGAATCACTTGAACCTGGGAGGTGGATGTAGCAGTGAGCCGGGATCGTGCCACTGAACTCCAGCCTGGGCGATAAGATCAAAACTCTGTCTCTCTCTCACACACACACACACACACACACACACACACACACACACCCCCAAAAAAAAAAACAAAAAAAAGAAAAAGAAA","CACTTTGGGAGGTGAAGGCGGGCAGATCACCTGAGGTCAGGAGTTCGAGACCAGCCTGGCCAACATGGTGAAACCCCGCCTCTACTAAAAATACAAAAATTAGCCAGGTGTGACACTAGGCATCTGTAATCCCAGCTACTTGGGAGGCTGAGACAGGAGAATCACTTGAACCCAGGAGGCGGAAGTTGCAGTGAGCCAAGATCATGCCATTGCACTCCAGCCTGGGTGACAGGAGCAAAACTCTGTCTCAAAAAAAAAAAAAAAAAAAAAAAAAAAAAAAAAAAAAAAAGAAAAGAAAAGAAAAGTAAA"
"chr16","384893","385508","JH378118","18053084","18053501","265","17668191","GGCCGGGCGTGGTGGCTAACACGGGTAGTCCTAGCACTTTGGGAAGCCAAGGCAGGCAGATCACTTGAGGTCAGGAGTTTGAGATCAGTCTGGCCAACATGGTGAAACCACGCCTCTACTAAAAATACAAAAGTTATGGCCGAGCGTGGTGGCACGCGCCTGTAATCCCAGCACTTTGGGATGCTGAGGCAGGCGCATCACCTAAGGTCGGGAATTCAAGACCAGCCTGACCAACATGGAGAAACCACGTTTCTACTAAAAATACAAAATTAGCCGGGTGTGGTGGCACATGCCTGTAGTTTCAGCTACTCAGGAGGCTGAGGCAGGAGAATCACTTGAATCCGGGAGGCGGAGATTGTGGTGAGCCGAGATCGGGCCATTGCACTCCAGCCTGGGCAACAAGAGAGAAACTCTGTCTCAAAAAAAAAAAAAAAAAATTAGCCAGGCATGGTAGCCTGTGCCTGTAATCCCAGCTACTTGGGAGGCTGAGGCAGGAGAATCGCTTGAACCTGGGAGGCAGAGGTTGCAGTGAGCCGCGATTGCGCCATTGCACTCTCCAGCCTGGGGGAGAAGAGCAAAACTCCATCTCAAAAATAAATAAATAAATAAAAATAAA","GGCTGGGCGCAGTGGCTCACACCTGTAATCCCAGCACTTAGGGAAGCTGAGGCGAGTAGATCACCTGAGGTCAGGAGTTAGAGACCAGCCTGGCCATCATGGTGAAACCCCGTCTCTACTAAAGATACCAAAAATTAGCTGAGTGTGGTGCTGGGTGCCTGTAATCCCAGAAACTCAGGGTGCCTGTAATCCCAGCAACTCAGGGTGCCTTTAATCCCAGCAACTGAGGGTACCAGTAATCCCAGCAACTCAGGGTGTCTTTAATCCTAGCAACTGAGGGCACCTGTAATCCCAGCAACTCAGGAAGCTGAGACAGGAGAAGTACTTGAACCCAGAAGGCAGAGGTTGCAGTGAGCCGATATTGCACCATTGCACTCCAGTCTGGGCAACAAGAGTGAAACTCTGTCTCAAAAAAAAA"
"chr16","1668152","1668787","JH378118","18053084","18053501","287","16384932","GGCCGGGCACGGTGCCTCGTTCCTGTAATCCCAGCACTTTGGGAGGCCAAGGTGGGTGGATCACCTGAGGTCAGGAGTTCGAGACATGCCTGGCCAACATGGCAAAATCCTGTCTTTACTAAAAATACAAAAATTAAGCCGGGCGCTGTGACTCATGCCTGTAATCCCAGCACTTTGGGAGGCCAAGGCGGGCGGATCACAAGGTCAGGAGATTGAGACCATCCTGGCTAACACGGTGAAAACCCGTCTCTACTAAAAATACAAAAAATTAGCCAGGTGTGGTGGCGGGTGCCTGTAGTCCCAGCTACTCGGGAGGCTGAGGCAGGAGAATGGCGTGAACCCGGGAGGCGGAGCTTGCAGTGAGCCGAGATCGTGCCACTGCACTCCAGTCTGGGCAACAGAGCAAGACTCTCTCTCAAAAAGAAACAAACAAAAAAAAAAATGAAAAAAGAAAAATTAGCCAGGCGTGGTGGCGGGTGCCTATAATCTCAGCTACTCGGGAGGCTGAGGCAGAAGTATCATTTGAACCCAGGAGGCGGAGGTTGTAGTGATCCAAGATAGCGCCATTGCACTGCAGCCTGGGTGACAACAGTGAAACTCCGTCTCAAAAAAAAAAAAAAAAAAGAAAGAAAGAAA","GGCTGGGCGCAGTGGCTCACACCTGTAATCCCAGCACTTAGGGAAGCTGAGGCGAGTAGATCACCTGAGGTCAGGAGTTAGAGACCAGCCTGGCCATCATGGTGAAACCCCGTCTCTACTAAAGATACCAAAAATTAGCTGAGTGTGGTGCTGGGTGCCTGTAATCCCAGAAACTCAGGGTGCCTGTAATCCCAGCAACTCAGGGTGCCTTTAATCCCAGCAACTGAGGGTACCAGTAATCCCAGCAACTCAGGGTGTCTTTAATCCTAGCAACTGAGGGCACCTGTAATCCCAGCAACTCAGGAAGCTGAGACAGGAGAAGTACTTGAACCCAGAAGGCAGAGGTTGCAGTGAGCCGATATTGCACCATTGCACTCCAGTCTGGGCAACAAGAGTGAAACTCTGTCTCAAAAAAAAA"
"chr16","2310740","2311369","JH378118","18053084","18053501","271","15742344","GGCCGGGCACAGTGGCTCACGCCTATAATATCAGCACTTTGGGAGACCAAGGCGGGTGGATCACCTAAGGTCAGGAGTTCAAGACCAGCCTGACCAACATGGTGAAACCCCATCTCTACCAAAAATAGAAAACATTAGTCTTGGCCGGGCACGGTGACTCATACCTGTAATTCCAGCACTTTGGGAGGCCGATCACCTGGCGGATCACCTGAGGTCGGGAGTTTGAGACCAGCCTGACCAACATGGAGAAACCCCGTCTCTACTAAAAATACAAAATTAGCTGTGCGTAGTGGCCCATGCGTGTAATCCCAGCTACTCAGGAGACTGAGGCAGGAGAATGGCTTGAACCTGGGAGGCGGAGGTTGTGCTGAGCCAAGATCGCACCATTGCACTCCAGCCTGGGCAATAAGAGTGAAACTCCGTTTCATAAAACAAAAAACAAAAAACAAAAAAAAAACCATTAGCCAGGCATTGTGGCAGGCACCTGTAATCCCAGCTACTCAGGAGGCTGAGGCAGAATGGCTTGAACCGGGGAGGCAGAGGTTGCAGTGAGCCGAGATCGCGCCATTGCACTCCAGCCTGGGCAACAAAAGTAAAACTCTGTCTCAAATAAAAAAAAGAGAGAAAAAA","GGCTGGGCGCAGTGGCTCACACCTGTAATCCCAGCACTTAGGGAAGCTGAGGCGAGTAGATCACCTGAGGTCAGGAGTTAGAGACCAGCCTGGCCATCATGGTGAAACCCCGTCTCTACTAAAGATACCAAAAATTAGCTGAGTGTGGTGCTGGGTGCCTGTAATCCCAGAAACTCAGGGTGCCTGTAATCCCAGCAACTCAGGGTGCCTTTAATCCCAGCAACTGAGGGTACCAGTAATCCCAGCAACTCAGGGTGTCTTTAATCCTAGCAACTGAGGGCACCTGTAATCCCAGCAACTCAGGAAGCTGAGACAGGAGAAGTACTTGAACCCAGAAGGCAGAGGTTGCAGTGAGCCGATATTGCACCATTGCACTCCAGTCTGGGCAACAAGAGTGAAACTCTGTCTCAAAAAAAAA"
"chr16","3075498","3075819","JH378114","26407278","26407597","46","23331780","GGCCAGGCGCGGTGGCTCACACCTGTAATCCCAGCACTTTGGGAGGCCAAGGCGGGCAGATCACGAGGTCAAGAGATCGAGACCATCCTGGCCAACCTGGTGAAACTCTGTCTCTACTAAAAATACCAAAAAAAAAAAAAAAAAAAAAAAAAAAAAGCATGGTGGCAGGTGCCTGTAATCCCAGCTACTTGGGAGGCTGAGGCAGAATTGCTTGAACCCGGGAGGCAGAGGTTGCAGTGAGTTGAGATCATGCCATTGCACTCCAGCCTGGGCAAAAAGAGCGAAACTCTGTCTCAAAAAACAAAACAAAAACAAAAACAAA","GGCCGGGCGCAGTGGCTCAAGCTTGTAATCCCAGCACTTTGGGAGGCCGAGGCGGGTGGATCACGAGGTCAAGAGATCGAGACCATCCTGGTCAACATGGTGAAACCCCGTCTCTACTAAAAATACAAAAAAAAAAAAAAAAAATTAGTTGGGCATGGTGGTGTGTGCCTGTAATCCCAGCTACTCAGGAGGCTGAGGCAGGAGAATTGCCTGAACCCAGGAGGCGGAGGTTGCGGTGAGCCGAGATCGCGCCATTGCACTCCAGCCTGGGTAACAAGAGCGAAACTCCGTCTCAAAAAAAAAAAAAAAAAAAAAAAAAA"
"chr16","3161549","3162150","JH378118","18053084","18053501","252","14891535","CTGGGCACCGTGGCTCACGCCTGTAATCCCAACACTTTGGGAGGCCAAGGCGGGTGGAACACCTGAAGTCAGGAGTTCGAGACCAGTCTGGACAACATGATGAAACCCCGTCTCTACTAAAAATACAAAAAGTAGCCAGGTATGGCCGGGCGCGGTGGCTCACGCCTGTAATCCCGGCACTTTGAGAGGCCGAGGCAGGTGGATCACAAGGTCAGGAGTTCAAGAGCAGCCTGGCCAAGATAGTGAAACCCCGTCTCTACTAAAAGCAAAATTACAGTGCGCCTGTAATCCCAGCTGCTCGGGAGGCTGAGGCAGGAGAATCGCTTGAACCTGGAGGGCGGAGGTTGCAGTGAGCCAAGATCGCTCTACTGCACCCTAGCCTGGGTGACAGAGCAAGACTCTGTATCAAAAAAAAAATAAATAAATAATTAGCCAGGTATGGTGGTGCAGGCTTGTAATCCTAGCTGCTCAGGAGGCTGAGGCAGGAGAATCGATTGAACCCAGGAGACGGAGGTTGCAGTGAGCAGAGATCACACCATTGTACTCCAGCCTGAGTGACAAAAACGAAACTCCGTCTCAAAAAAAAACCAAAAAAACAAAAA","GGCTGGGCGCAGTGGCTCACACCTGTAATCCCAGCACTTAGGGAAGCTGAGGCGAGTAGATCACCTGAGGTCAGGAGTTAGAGACCAGCCTGGCCATCATGGTGAAACCCCGTCTCTACTAAAGATACCAAAAATTAGCTGAGTGTGGTGCTGGGTGCCTGTAATCCCAGAAACTCAGGGTGCCTGTAATCCCAGCAACTCAGGGTGCCTTTAATCCCAGCAACTGAGGGTACCAGTAATCCCAGCAACTCAGGGTGTCTTTAATCCTAGCAACTGAGGGCACCTGTAATCCCAGCAACTCAGGAAGCTGAGACAGGAGAAGTACTTGAACCCAGAAGGCAGAGGTTGCAGTGAGCCGATATTGCACCATTGCACTCCAGTCTGGGCAACAAGAGTGAAACTCTGTCTCAAAAAAAAA"
"chr16","3211652","3212251","JH378118","18053084","18053501","260","14841432","GTCAGACGCAGTAGTTTATGCCTGTAATCCTTGCACTTTGGGAGGCAGGTGGATCACCTGAGGCCAGGAGTTGGAGACCAGCCAGGCCAATATGGCAAAACCCCGTCTCTACTAAAAATACAAAAACTAGCCGGGCGCAGTGGCTCACACCTGTAATCCCAGCACTTTGGGAGGCTGAGGTGGGTGGATCACTAGGTCAGGAGTTCAAGACCAGCCTGGCCAACATGGTGAAACCGCGTCTCTACTAAAAACACCAAAAAATTAGCTGGGCGTGGTGGCAGTCGCCTGTAATCCCTGCTACTCGGAAGGCTGAGGCAGGAGAATCACTTGAACGCAGGAGGCAGAGGTTGCGGTGAGCCGAGATCACGCCACTGCACTCCAGCCTGGGTGACAGAGCAAGACTCTGTCTCAAAAAACAACAACAACAACTAGCTGGGCGTGGTGGCACATGCCTGTAACCCCAGCTACTCAGGAGGCTGAGGCTGAGGGAGAAAAATCGCTTGTACCTGGGAGGTGGAAGTTGCAGTGAGCGGAGATCCCACCATTGCACTCCAGCCTGGGTGACAAGAGCGAAACTCCATCTCAAAAAAAAAAAAAAAA","GGCTGGGCGCAGTGGCTCACACCTGTAATCCCAGCACTTAGGGAAGCTGAGGCGAGTAGATCACCTGAGGTCAGGAGTTAGAGACCAGCCTGGCCATCATGGTGAAACCCCGTCTCTACTAAAGATACCAAAAATTAGCTGAGTGTGGTGCTGGGTGCCTGTAATCCCAGAAACTCAGGGTGCCTGTAATCCCAGCAACTCAGGGTGCCTTTAATCCCAGCAACTGAGGGTACCAGTAATCCCAGCAACTCAGGGTGTCTTTAATCCTAGCAACTGAGGGCACCTGTAATCCCAGCAACTCAGGAAGCTGAGACAGGAGAAGTACTTGAACCCAGAAGGCAGAGGTTGCAGTGAGCCGATATTGCACCATTGCACTCCAGTCTGGGCAACAAGAGTGAAACTCTGTCTCAAAAAAAAA"
"chr16","3990675","3991277","JH378118","18053084","18053501","250","14062409","GGCTGGGCGTGGTGGCTCACGCCTTTAATCCCAGTACTTTGGGAGGCCGAGAAGGGCACATCACCTGAGGTCAGGAGTTTGAGACCAGCCTGGCCAATATGGTAAAACCCTGTCTCTACTTAAAAAATAGAAAAATCAGGCTGGACGCAGTGGCTCACGCCTGTAATCCCAGCACTTTGGGAGGCCGAGGCGGGTGGATCATGAGGTCAGGAGTTACCAGCCTGCCAACATGGTGAAACCCCATCTCTACTAAAAAAACAAAAAAAATTAGCCAGTCGTAGTGGCAGGCACCTGTAATCCCAGCCACTCGGGAGGCTGAGGCAGAGAATTGCTTGAACCTGGGAGGTGGAGATTGCTGTGCACCAAAATCACACCACTGCACTTGAGCCTGGGCGACAGAGGGAGACTCATCTGAAAAAAAAAAAAAAAAAAAAATTAGCCGGTTATGGTGGCAGGTGCCTGTGATCCCAGCTACTTGGGAGGCTGAGGCAGGAGAATTGCTTGAACCCGGGAGGCAGAGGTTGCAGTGAGCTGAGATCGCACCACTGCACTCCAGCCTGGAGGACAAGAGTGAGACTTGTCTGATTGGAAAAAAAAAAAAAA","GGCTGGGCGCAGTGGCTCACACCTGTAATCCCAGCACTTAGGGAAGCTGAGGCGAGTAGATCACCTGAGGTCAGGAGTTAGAGACCAGCCTGGCCATCATGGTGAAACCCCGTCTCTACTAAAGATACCAAAAATTAGCTGAGTGTGGTGCTGGGTGCCTGTAATCCCAGAAACTCAGGGTGCCTGTAATCCCAGCAACTCAGGGTGCCTTTAATCCCAGCAACTGAGGGTACCAGTAATCCCAGCAACTCAGGGTGTCTTTAATCCTAGCAACTGAGGGCACCTGTAATCCCAGCAACTCAGGAAGCTGAGACAGGAGAAGTACTTGAACCCAGAAGGCAGAGGTTGCAGTGAGCCGATATTGCACCATTGCACTCCAGTCTGGGCAACAAGAGTGAAACTCTGTCTCAAAAAAAAA"
"chr16","4259838","4260446","JH378118","18053084","18053501","263","13793246","GGCCGGGTGCAGTGGCTCACGCCTGTAATCGCAGGACTTTGGGAGGCCAAGGCAGGTGCATCACCTGAGGTCAGGATTTCAAGACCATCCAGCCTGATCAACATGGTGAAACCCTGTCTCTACTAAAAATATAAAAATTGGCCGGGCACAGTGACTCACGCCTGTAATCCCAGCACTTTGGGAGGCTGAGGCAGGTGGATCACAAGGTCAGGAGATCGAGACCATCCTGGCTAACACAGTGAAACCCCGTCTCTACTAAAAATATAAAAAATTAGCCGGGCGTGGTGGTAGGCACCTGTAGTCCCAGCTACTCGGGAGACTGAGGCAGGAGAATGGCGTGAACCTGGGAGGTGGAGCTTGCAGTGAGCAGAGATCGCGCCACTGTACTCCAGCCTGGGTGACAGAGCGAGACTCCGTCTCAAAAAAAAAAAAAAAAAAAAAAATTAGCTGGGCGTGGTGGCGGGCACCTGTAATCCCAGCTACTTGGGAGGCTGAGGCAGGAGAATTGCTTGAACCTGGGAAGTGGAGGTTGCAGTGAGCTGAGATTGTGCCCTTGTACTCCAGCCTGGGCAATAAAAGCAAAACTCCGTCTTAAAAAAAAAAAAAAAA","GGCTGGGCGCAGTGGCTCACACCTGTAATCCCAGCACTTAGGGAAGCTGAGGCGAGTAGATCACCTGAGGTCAGGAGTTAGAGACCAGCCTGGCCATCATGGTGAAACCCCGTCTCTACTAAAGATACCAAAAATTAGCTGAGTGTGGTGCTGGGTGCCTGTAATCCCAGAAACTCAGGGTGCCTGTAATCCCAGCAACTCAGGGTGCCTTTAATCCCAGCAACTGAGGGTACCAGTAATCCCAGCAACTCAGGGTGTCTTTAATCCTAGCAACTGAGGGCACCTGTAATCCCAGCAACTCAGGAAGCTGAGACAGGAGAAGTACTTGAACCCAGAAGGCAGAGGTTGCAGTGAGCCGATATTGCACCATTGCACTCCAGTCTGGGCAACAAGAGTGAAACTCTGTCTCAAAAAAAAA"
"chr16","4899850","4900511","JH378118","18053084","18053501","313","13153234","GGCCAGGCACGGTGGCATGCACCTGTAATCTCAGCTCTTTGGGAGGCTGAGGCAAGAGGATCACTTGAGCCCAGGAGTTGGTGATTGCAGTGAGCTCTGATCACTCCACTGCACTCCAGCCTGGGTGACAGAGTGAGATCCTGTCTCTACGAAAAAAAGACAAGACACAAATACGTTAAAAGTAAAATGATATAAAAAGATATTCCAGTGGGGCACAGTGGCTCACCCCTATAATCCCAACACTTTGGGAGGCTGAGGTGGGTGGATCACCTGAGGTCAGGAATTCAAGACCAGCCTGACCAACATGGAGAAACCCGTCTCTACTAAAAATACAAAATTAGCCGGGTGTGGTGGCACATGCCTGTAATCCCAGCTACTCAGGAGGCTGAGAATGGCTTGAACCTGGGAGGTGGAGGTTGTGGTGAGCCGAGATTGCACCACTGCACTCCAGCCTGGGCAACAAGAGCTGAAACTCCGTCGAAAAAAAAAATTAGCCTGGCGTGGTGGCGGGAGCCTGTAATCCCAGCTACTGGGGAGGCTGAGGCAGGAGAATCACTTGAACCTGGGAGGCAGAATTTGCAGTGAGCCGAGATCGCGCCACCACACTCCAGCCTGGGTGACAAAAACGAAACCCCATCTCAAAAAAATTAAAAAATAACAAA","GGCTGGGCGCAGTGGCTCACACCTGTAATCCCAGCACTTAGGGAAGCTGAGGCGAGTAGATCACCTGAGGTCAGGAGTTAGAGACCAGCCTGGCCATCATGGTGAAACCCCGTCTCTACTAAAGATACCAAAAATTAGCTGAGTGTGGTGCTGGGTGCCTGTAATCCCAGAAACTCAGGGTGCCTGTAATCCCAGCAACTCAGGGTGCCTTTAATCCCAGCAACTGAGGGTACCAGTAATCCCAGCAACTCAGGGTGTCTTTAATCCTAGCAACTGAGGGCACCTGTAATCCCAGCAACTCAGGAAGCTGAGACAGGAGAAGTACTTGAACCCAGAAGGCAGAGGTTGCAGTGAGCCGATATTGCACCATTGCACTCCAGTCTGGGCAACAAGAGTGAAACTCTGTCTCAAAAAAAAA"
"chr16","4919663","4920295","JH378118","18053084","18053501","281","13133421","CTGGGCGCAGTGGCTCACACCTATAATCCCAGCACTTTGGGAGGCCGAGGTGGGGTGGATCACTTGAGGTCAGGAGTTTGAGACCAGCCTGGCCAACATGGTGAAACCCCATCTCTTCTAGAAAAATACAAAATTAGGCTGGGCGCGGTGGCTCACGCTTGTAATCCCAGCACTTTGGGAGGCTGAGGCAGGCGGATCATCTGAGGTTGGGAGTTCGAGACCAGCCTGACCAACATAGAGAAACCCTGTCTCTACTAAAAATACAAAATTAGCCGGGCGTGGTGGCGCATGCCTGTAATCCCAGCTAGTCAGGAGGCTGAGGCAGGAGAATCCCTTGAACTGGGGAGGCAGAGGTTGTGGTGAGCCCAGATCGTGCCATTGCACTCCAGCTTGGGTAAGAAGAGCAAAACTCTGTCTAAAAAATATATATATTTATACATATATATATATTTATATATATAATTAGCCACGCATAGTGGCACACACCTGTAACCCCAGCTACCTGGGAGGATGAGGCAGGAGAATAGCTTGAACTTGGGAGGTGGAGGTTGCACTGAGCTGAGACTGCGCCATTGCATTCCAGCCTGGGCAACAAGAGCGAAACTGTCTCAAAAAAAAAAAAAAAAAAAAAAA","GGCTGGGCGCAGTGGCTCACACCTGTAATCCCAGCACTTAGGGAAGCTGAGGCGAGTAGATCACCTGAGGTCAGGAGTTAGAGACCAGCCTGGCCATCATGGTGAAACCCCGTCTCTACTAAAGATACCAAAAATTAGCTGAGTGTGGTGCTGGGTGCCTGTAATCCCAGAAACTCAGGGTGCCTGTAATCCCAGCAACTCAGGGTGCCTTTAATCCCAGCAACTGAGGGTACCAGTAATCCCAGCAACTCAGGGTGTCTTTAATCCTAGCAACTGAGGGCACCTGTAATCCCAGCAACTCAGGAAGCTGAGACAGGAGAAGTACTTGAACCCAGAAGGCAGAGGTTGCAGTGAGCCGATATTGCACCATTGCACTCCAGTCTGGGCAACAAGAGTGAAACTCTGTCTCAAAAAAAAA"
"chr16","5124255","5124811","JH378118","18053084","18053501","213","12928829","GGCCAGGTGCGGTGGCTCATGCGTGTAATCCCAGCGCTTTGGGAGGCTGAGGCAAGTGGATCACCTGAGGTCAGGAGTTTGAGACCAGCCTGGCCAACATGGGGAAATCCCTGTCTCTACTAAAAATACAAAAATTGGGCCGGGTGTGGTGGCTCACACCTGTAATCCCAGCACTTTGGGAGACTGAGGTGGGCGGATCACCCAAGGTCAGGAGTTTGAGACCATCCTGGCCAACATGGTGAAACCCCGTCTCTACTAAATAAATACAAAAAAGTAGCCGAGCGTGTTGGCGGATGCCTGTAATCCCAGCTACTTGGGAGGCTGAGGCAGGAGAATTGCTTGAACCCTGAGAGGTGGAGGTTGCAGTGAGCAGAGATTGTGCCACTGCACTCTGGCCTGGGCGACAAGAGGGAGTCTCTGTCTTAAAAAAAAAAAAAAAAAAAATTAGCTGGAAATCGCTTGAACCCAGGAGGCGGAGGTTGCAGTGAGCCGAGATTGTGCCACTGCACTCTGGCCTGGGCGACAAGAGCGAGATTCTGTCTCAAAAAAAAAAAAGA","GGCTGGGCGCAGTGGCTCACACCTGTAATCCCAGCACTTAGGGAAGCTGAGGCGAGTAGATCACCTGAGGTCAGGAGTTAGAGACCAGCCTGGCCATCATGGTGAAACCCCGTCTCTACTAAAGATACCAAAAATTAGCTGAGTGTGGTGCTGGGTGCCTGTAATCCCAGAAACTCAGGGTGCCTGTAATCCCAGCAACTCAGGGTGCCTTTAATCCCAGCAACTGAGGGTACCAGTAATCCCAGCAACTCAGGGTGTCTTTAATCCTAGCAACTGAGGGCACCTGTAATCCCAGCAACTCAGGAAGCTGAGACAGGAGAAGTACTTGAACCCAGAAGGCAGAGGTTGCAGTGAGCCGATATTGCACCATTGCACTCCAGTCTGGGCAACAAGAGTGAAACTCTGTCTCAAAAAAAAA"
"chr16","8088191","8088522","JH378114","21211700","21212024","70","13123509","GGCTGGGCGCGGTGGCTTTTGACCATAATCCCAGCACTTTGGGAGGCCGAGGTGGTCAGGTCACCTGAGGTCAGGAGTTCAAGAGCAGCCTGGCCAACGTGGTGAAACTCTGTCTCTACCAAAAATACCAAATAATAATAATAATAATAATAATAATAATAAAATAATATAATTGCAGGGTGTGGCAGCCCATGCATGTAATGCCAGCTACTTGGGAGACTGAGGCAGGATAATCACTTCAACCCAAGAGGCGGAGGTTGCAGTGAGCTGAGATCATGCCATTGCATTCCAGCGTAGGCAACAAGAGCGAAACTCTGTTTCAAATAAATAAA","GGCTGGGTGCGGTGGCTCAGGCCTGTAATCCCAGCACTTTGGGAGGCCGAGGTGGGTACATCACCTAAGGTCAGGAGTTCAAGACCAGCCTGACCAACATGGTAAAACCCTGTCTCTACTAAAATTACAAAAGAAAATTAGAAAAAAAAAAAAGAAAGAAAGAAAATTAGATGGCATGGTGGTGGCGGGCACCTGTAATTTCAACTACTCGGGAGGCTAAGGCAGGAGAATCACTTGAACCCAGGAGGTGGAGGTTGCAGTGAGCCGAGATCACACCATTGCACTGCAGCCTGGGCAATAAGAGCAAAACTCCATCTCAAAAAAA"
"chr16","9762791","9763467","JH378118","18053084","18053501","323","8290293","CAGGCATGGTAGCTCACGCCTGTAATCTCAGCACTTTGGGAGGCCGAGGTGCGCAGATCACTTGAGGTCAGGTGTTGGTGACCAGCCTGGCCAACATGGTGAAACCCTATCTCTACTAAAAATACAAAAATTATGGCCGGGCGCAGTGGCTCACGCCTGTAATCCCAGCACTTTGGGAGGCCGAGGTGGGCAGATCACTTGAGGTCAGGAGTTCAAGACCAGCCTAGGCAACATAGTGAAACCCCGTTGCTACTAAAAATACAAAAATTAGCTGGGCGTGATGGCACATACCTGTAGTCCCACCTACTTGGGAGGCTGAGGCAGGAAAATCGCTTGAACCTGGAGGCAGAGGTTGCAGCGAGCCAAGACTGTGCCAATGCACCACAGCCTGGATAACAGAGTGAGACTCAATCTCAAAAAAAAAAAAAAAAAAAAAAGGCGGGCTGGTGGCTCATGCCCATGCAAACCCCGTCTCTACTAAAAGGACAAAAATTAGCTGGGCATGGTGGCGGGGGCCTGTAATCTCAGGATTACAGGAGATACTACTACTCGGGAGGCTGAGGCAGTAGAATTGCTTGAACCAGGGAGGCGGAGGTTGCAGTGAGCTGAGATCGCGCCATTGCACTCCAGGCTGGGTGACAACAATGACTCCGTCTCAAAAACAACAACAACAACAA","GGCTGGGCGCAGTGGCTCACACCTGTAATCCCAGCACTTAGGGAAGCTGAGGCGAGTAGATCACCTGAGGTCAGGAGTTAGAGACCAGCCTGGCCATCATGGTGAAACCCCGTCTCTACTAAAGATACCAAAAATTAGCTGAGTGTGGTGCTGGGTGCCTGTAATCCCAGAAACTCAGGGTGCCTGTAATCCCAGCAACTCAGGGTGCCTTTAATCCCAGCAACTGAGGGTACCAGTAATCCCAGCAACTCAGGGTGTCTTTAATCCTAGCAACTGAGGGCACCTGTAATCCCAGCAACTCAGGAAGCTGAGACAGGAGAAGTACTTGAACCCAGAAGGCAGAGGTTGCAGTGAGCCGATATTGCACCATTGCACTCCAGTCTGGGCAACAAGAGTGAAACTCTGTCTCAAAAAAAAA"
"chr16","9769317","9769634","JH378153","10517405","10517727","57","748088","GGTTGGGCATGGTGGCTCACACCTGTAATGCCAGCACTTTGGGAGGCGGGCAGATCACCTGAGGTCAGGAGTTCAAGACCAGCCTGGCCAACATGGTGAAATCCTGTCATTACAAAAATACAAAAAAAAAAAAAAAAAAAAAAAAAAAAAGCCAGTAATGATAGTGGGTGCGTATAATCCCAGCTACTTTGGAGGCTAAGGCAGGAGACTCACTTGAACCCAGGAGGCGGAGGTTATGGTGAGCCGAGATCACACCATTGCACTCCAGCCTGGGCGACAAGAGCAAAACTCCATCTCAAAAAAAAAAAAAAAAAAAAA","GGCCGGGCGTGGTGGCTCACGCCTGTAATCCCAGCACTTTGGGAGGCCGAGGTGGGTGGATCATGAGGTCAAGAGATCGAGACCATCCTGGTCAACATGGTGAAACCCTGTCTCTACTAAAAAAAAAAAAAAAAAAAAAAAATACAAAAAAATTAGCTGGGCATGGTGGCGCATGCCTGTAATCCCAGCTACTCCGGAGGTTGAGGTAGGAGAATTGCCTGAACCCAGGAGGCGGAGGTTGCGGTGAGCCGAGATCGCGCCATTGCACTCCAGCCTGGGTAACAAGAGCAAAACTCCGTCTCAAAAAAAAAAAAAAAAAAGAA"
"chr16","13753079","13753710","JH378118","18053084","18053501","278","4300005","GGCTGATTGTGATGGCTCACACTTGTAATCCCCTCACTTTGGGAGGCCAAAGCGGGAGCATCACCTGAGGTCAGGAGTTCAAGACCAGCCTGGCCAACATGGTGAAACCCCATCTCTACTAAAAATAAAAAATTAGCTGGGCACAGTGACTCATGCCTGTAATCCCAGCACTTTGGGAGGCCGAGGCAGGCAGATCACAATCACGAGGTCAGGAGTTCGAGACCAGCCTGACCAACATGGTGAAACCCCGTCTCTACTAAAAATAGAAAAATTAGCCAGGCGTGGTGGCACACGCCTGTAATCCCAGCTCCTCAGGAGACTGAGGCAGGAGAATCACTTGAACCCAGGAGGTGGAGGTTGCAGTGAGCAGAGATCGCACCACTGCACTCCAGCCTGGGTAACAGAGTGAGACTCCGTCTCAAAAAAAAAAAAAAAAAAAAAAAAAAAACGAAATTAACCAGGTGTGGTGGCACATGCCTGTAATCCCAGCTACTTGGGAGGCTGAGGCAGGAGAATCGCTTGAACCCGGGAGACAGAGGTTCCAGAGAACTGAGATCATGCCATTGCACTCCAGCCTGGGCAACAAGAGTGAAACTCCATCTAAAAAATAAATAAATACATAAACAAACAAA","GGCTGGGCGCAGTGGCTCACACCTGTAATCCCAGCACTTAGGGAAGCTGAGGCGAGTAGATCACCTGAGGTCAGGAGTTAGAGACCAGCCTGGCCATCATGGTGAAACCCCGTCTCTACTAAAGATACCAAAAATTAGCTGAGTGTGGTGCTGGGTGCCTGTAATCCCAGAAACTCAGGGTGCCTGTAATCCCAGCAACTCAGGGTGCCTTTAATCCCAGCAACTGAGGGTACCAGTAATCCCAGCAACTCAGGGTGTCTTTAATCCTAGCAACTGAGGGCACCTGTAATCCCAGCAACTCAGGAAGCTGAGACAGGAGAAGTACTTGAACCCAGAAGGCAGAGGTTGCAGTGAGCCGATATTGCACCATTGCACTCCAGTCTGGGCAACAAGAGTGAAACTCTGTCTCAAAAAAAAA"
"chr16","13951847","13952482","JH378118","18053084","18053501","292","4101237","GGCCAGGTGCGGTGGCTCATGCCTGTAATCCCAGCACTTTGGGAGGCTATGGCAGCGGATAACCTGAGGTCACAAGTTTGAGACCAGCCTGGCAAACATGGTGAAACCGTCTCTACTAAAAATACAAAAATTACACCAGGCGCGGTGGCTCATGCCTGTAATCCCAGCACTTTGGAAGGCCGAGGCAGGTGGATCATGAGGTCAGGAGATCAAGACCATCCTGGCTAACGCAGTGAAACCCCGTCTCTACTAAAAATATAAAAAATTGGCCAGGCGTGGTGGCGGACGCCTGTAGTCCCAGCTACTCGGGAGGCTGAGCCAGGAGAATGGCGTGAACCCGGGAGGCGGAGCTTGTGGTGAGCCGAGATAGCGCCACTGCACTGCCGCCTGGGTGACAGAGTGAGACTCTGTCTCAAAAAACAAAACAAAACAAAAACCAAAAACAAAAACAAAAAAACAAAAATTAGCCAGGTGTGGTGGTGCACGCCTGTCATCCCAGCTACTTGGGGGGCTGAGACGTGATAATCACTTGAACCCGGGAGGGAGAGGTTGCAGTGAGTGGAGATCACGCCATTGTATTCCAGCCTGGGGGCAAGAGCAAAACTCTGTCTCAAAAACAACAACAACAACAACAAA","GGCTGGGCGCAGTGGCTCACACCTGTAATCCCAGCACTTAGGGAAGCTGAGGCGAGTAGATCACCTGAGGTCAGGAGTTAGAGACCAGCCTGGCCATCATGGTGAAACCCCGTCTCTACTAAAGATACCAAAAATTAGCTGAGTGTGGTGCTGGGTGCCTGTAATCCCAGAAACTCAGGGTGCCTGTAATCCCAGCAACTCAGGGTGCCTTTAATCCCAGCAACTGAGGGTACCAGTAATCCCAGCAACTCAGGGTGTCTTTAATCCTAGCAACTGAGGGCACCTGTAATCCCAGCAACTCAGGAAGCTGAGACAGGAGAAGTACTTGAACCCAGAAGGCAGAGGTTGCAGTGAGCCGATATTGCACCATTGCACTCCAGTCTGGGCAACAAGAGTGAAACTCTGTCTCAAAAAAAAA"
"chr16","19006984","19007584","JH378118","18053084","18053501","263","953900","GGTGGCTGATGCCTGTAAACCCAGCATTTTGGGAGGCCGAGGCTGGTGGATCACCTGAGGTCAGGTGTTCGAGACCAGTCTGGCCAACATGGTGAAACCTCGTCTCTACCAAAAATACAAAAATTAGTTGGGTGTGGCCGGGTGTGGTGGCTTACGCTTGTAATCTCAGCACTTTGGGAGGCCGAGGTGGGTGGATCACGAGGTCAGGAGTTCAAGACCAGCCTGGCCAAGATGGTGAAACCCTGTCTCTACTAAAAATACAAAAAATTAGCCAGGCATGGTGGCGGGTGCCTGTAATCCCAGCTACTCGGGAGGCTGAGGCAGAGAATTGCTTGAACCTGGGAGGTGGAGGTTGCAGTGAGCCGAGATTGTGCCACGACACTCCAGCCTGGGTGACAGAGCGAGACTCTGTCTAAAAAAAAAAAAAAAAATTAGTTGGATGTGGTGGTGGGTGTCTGTAATCTCAGCTACTCAGGAGACTGAATCAGGAGAATCACTTGAACCCAGGGGGCTGGAGGTTGCAGTGAGCCGAGATCTTGCCATTGCACTCCAGCCCGGGCGACAAGAGCAAAACTCTCTTTCAAAAAAAAAAAAAAAAAGA","GGCTGGGCGCAGTGGCTCACACCTGTAATCCCAGCACTTAGGGAAGCTGAGGCGAGTAGATCACCTGAGGTCAGGAGTTAGAGACCAGCCTGGCCATCATGGTGAAACCCCGTCTCTACTAAAGATACCAAAAATTAGCTGAGTGTGGTGCTGGGTGCCTGTAATCCCAGAAACTCAGGGTGCCTGTAATCCCAGCAACTCAGGGTGCCTTTAATCCCAGCAACTGAGGGTACCAGTAATCCCAGCAACTCAGGGTGTCTTTAATCCTAGCAACTGAGGGCACCTGTAATCCCAGCAACTCAGGAAGCTGAGACAGGAGAAGTACTTGAACCCAGAAGGCAGAGGTTGCAGTGAGCCGATATTGCACCATTGCACTCCAGTCTGGGCAACAAGAGTGAAACTCTGTCTCAAAAAAAAA"
"chr16","19554918","19555551","JH378118","18053084","18053501","281","1501834","GGCCGGGCGCAGTGGCTCACACCTGTAATCCCAGCACTTTGGGAGGCCGAGGCGGGTGGATCACTTGAGGTCAGGAGTTCAAGACCAGCCTGGCTGACATGGTGAAACCCTGTCTCTACTGAAAACACAAAAATTAGGCCGGGCATAGTGGCTCATGCCTGTAATACCAGCACTTTGGGAGGCCGAGGTGGGTGGATCACCTGAGGTCAGGAGTTTGAGACCAGCTTGACCAACATGGTGAAACCCCGTCTCTACTAAAAATATAAAAATTAGTCTGGCATGGTGGCAGATGCCTGTAATCCCAGCTACTCAGGAGGCTGAGGCAGGAGAATTGCTTGAACCTGGAAGGTGGAGGTTGTAATGAGCCAAGATCACACCACTGCACTCCAGCCACTGTACTCCAGCCTGGGTGACAGAGTGAGACTCTGTCTCAAAAAACATACATACACACACATACACACACACACACACACACACACAAATTAGCTGGACGTGATAGCACACCCCTGTAGTCCCAGCTGCTTGAGAGACCGAGGCACAAGAATCACACGAACCCGGGAGGCGGAGGTTCCTGTGAGCCAAGATCGCACCATTGTACTCCATTCTGGGTGACAAGAGTGAAGCTCTGTCTCAA","GGCTGGGCGCAGTGGCTCACACCTGTAATCCCAGCACTTAGGGAAGCTGAGGCGAGTAGATCACCTGAGGTCAGGAGTTAGAGACCAGCCTGGCCATCATGGTGAAACCCCGTCTCTACTAAAGATACCAAAAATTAGCTGAGTGTGGTGCTGGGTGCCTGTAATCCCAGAAACTCAGGGTGCCTGTAATCCCAGCAACTCAGGGTGCCTTTAATCCCAGCAACTGAGGGTACCAGTAATCCCAGCAACTCAGGGTGTCTTTAATCCTAGCAACTGAGGGCACCTGTAATCCCAGCAACTCAGGAAGCTGAGACAGGAGAAGTACTTGAACCCAGAAGGCAGAGGTTGCAGTGAGCCGATATTGCACCATTGCACTCCAGTCTGGGCAACAAGAGTGAAACTCTGTCTCAAAAAAAAA"
"chr16","19576859","19577465","JH378118","18053084","18053501","251","1523775","GGCCAGGCATGGTGGCTCACACCTGTAATCCCAGCCCTTTGGGAGGCCGAGGCAGGTGGATCACCTGAGGTCAGGAGTTCGAGACCAGCCTGGCCAACATGGTGACACCCCACTCTACCAAAAATACAAAAATTAGGTTGGGTGCAGCGGTTCACACCTGTAATCCCAGCACTTTGGGAGGCCAAGGTGGATGGATCACCTGAGGTCAGGAGTTTGTGACCAGCCTGGCCAACATGGCGAAACCCTGCCTCTACTAAAAATAAAAAATTAGCCAGGTGTGGTGGCATGCGCCTGTAATCCTAGCTACTGAGGCAGGAGAATCGCTTGGACCAGGGAAGCAGAGTTTGCAGTGAGCCAAGATCACGCCACTGCACTCTAGCCTGGGTGACAGAGTAAGACTCCATCTCAAAAAAAAAAAAAAATACAAATATTAGCTGGGCATGGTGGCGCACACCTGTAGTTCTGGCTACTCAGGAGGCTGAGGCAGGAGAATTGCTTGAACCCAGAAGGCAGAGGTTGCAGTGAGCTGAGATTGTGCCATTGCACTCAGCCTGGGCAACAAAAGTGAAACTCCATCTCAAAATAAATAGATAAATAAATAAATAAA","GGCTGGGCGCAGTGGCTCACACCTGTAATCCCAGCACTTAGGGAAGCTGAGGCGAGTAGATCACCTGAGGTCAGGAGTTAGAGACCAGCCTGGCCATCATGGTGAAACCCCGTCTCTACTAAAGATACCAAAAATTAGCTGAGTGTGGTGCTGGGTGCCTGTAATCCCAGAAACTCAGGGTGCCTGTAATCCCAGCAACTCAGGGTGCCTTTAATCCCAGCAACTGAGGGTACCAGTAATCCCAGCAACTCAGGGTGTCTTTAATCCTAGCAACTGAGGGCACCTGTAATCCCAGCAACTCAGGAAGCTGAGACAGGAGAAGTACTTGAACCCAGAAGGCAGAGGTTGCAGTGAGCCGATATTGCACCATTGCACTCCAGTCTGGGCAACAAGAGTGAAACTCTGTCTCAAAAAAAAA"
"chr16","19983557","19984148","JH378118","18053084","18053501","244","1930473","GGCCGAGTGCGGTGGCTCATGCCTGTAATCCCAGCACTTTGGGAGGCCGAGACAGGTGAATCACCTGAGGTCTGGAGTTTGAGACCAGCTGACCAACATGGTGAAACCCTGTCTCTACTAAAAATACAAAAAATTGGCTGAGCGCAGTGGCCACGCCTGTTATCCCAGTACTTTGGGAGGCCGAGGCGGGTGGATCACGAGGTCAGGAATTCGAGACCAGCCTGACCAACATGGTGAAGCCCCGTCTCTACTAAAAATAAAAAAATTAGCCAGGTGTGGTGGTGCGCCCCTGTAAACCCAGCTACTCAGGAGGCTGAGGCAGGAGAATCACTTGAATCTGGGAGGCGGAGGTTGCAGTGAGCCAAGATCGAGCCACTGTACTCCAGCCTGGGAGACGGAGTGAGACTCCATCTAAAAAAAAAAAAAAATTAGCCAGGCGTGGTGGCACAAGCCTGTAATCCCAGCTACCTGGGAGGCTGAGATAGGAGAATTCCTTGAATCTGGGAGGCGGAGGTTGCAGTGAGCTGAGATTGTGCCATTGCACACCAGCCTGGGTGACAAGAGCAAAATTCCATCTCAAAAAAAAAAAAAA","GGCTGGGCGCAGTGGCTCACACCTGTAATCCCAGCACTTAGGGAAGCTGAGGCGAGTAGATCACCTGAGGTCAGGAGTTAGAGACCAGCCTGGCCATCATGGTGAAACCCCGTCTCTACTAAAGATACCAAAAATTAGCTGAGTGTGGTGCTGGGTGCCTGTAATCCCAGAAACTCAGGGTGCCTGTAATCCCAGCAACTCAGGGTGCCTTTAATCCCAGCAACTGAGGGTACCAGTAATCCCAGCAACTCAGGGTGTCTTTAATCCTAGCAACTGAGGGCACCTGTAATCCCAGCAACTCAGGAAGCTGAGACAGGAGAAGTACTTGAACCCAGAAGGCAGAGGTTGCAGTGAGCCGATATTGCACCATTGCACTCCAGTCTGGGCAACAAGAGTGAAACTCTGTCTCAAAAAAAAA"
"chr16","20117717","20118289","JH378118","18053084","18053501","224","2064633","GGCTGGGTGCGGTGGCTCACGCCTGTAATCCCAGCACTTTGGGAGGCCAAGGCGGGTAGATCATCTGAGGTCAGGAGTTCAAGACCAGCCTGGCCAACATGGTGAAACCCCGTCTCTACTAAAAATATTTTTAAAAGGCCAGGCGTGGTGGCTCACGCCTGTAATCCCAGCACTTTGGGAGGCCGAGGCGGGCAGATCATGAGGTCAGGAGTTCGAGACCATCCTGGCTAACACGGTGAAACCCCCGTCTCTACCAAAAAATACAAAAAATTAGCCGGGCATGGTGGCAGGTGCCTGTAGTCCCAGCTACTCGGGAGGCTGAGGCAGGAGGATGGCGTGAACCCAGGAGACAGAGCTTCCAGTGAGCTGAGATCGTGTCACTGCACTCCAGCCTGGGCGACAGAGGAGATTCTGTCTCAAAAAAAAAAAAAAAAAATTAGCTTGGTGTGGTGGCAGGTGCCTGTAATCCCAGTTACTCGGGAGGCTGAGGCAGAGGTTTCAGTGAACCGAGATCGCGCCATTGCACTCCAGCCTGGGCAACAAGAGTGAAACTCCGTCTCAAAGGAAAAAAAA","GGCTGGGCGCAGTGGCTCACACCTGTAATCCCAGCACTTAGGGAAGCTGAGGCGAGTAGATCACCTGAGGTCAGGAGTTAGAGACCAGCCTGGCCATCATGGTGAAACCCCGTCTCTACTAAAGATACCAAAAATTAGCTGAGTGTGGTGCTGGGTGCCTGTAATCCCAGAAACTCAGGGTGCCTGTAATCCCAGCAACTCAGGGTGCCTTTAATCCCAGCAACTGAGGGTACCAGTAATCCCAGCAACTCAGGGTGTCTTTAATCCTAGCAACTGAGGGCACCTGTAATCCCAGCAACTCAGGAAGCTGAGACAGGAGAAGTACTTGAACCCAGAAGGCAGAGGTTGCAGTGAGCCGATATTGCACCATTGCACTCCAGTCTGGGCAACAAGAGTGAAACTCTGTCTCAAAAAAAAA"
"chr16","20574957","20575888","JH378118","18053084","18053501","543","2521873","GGCCAGGCGTGGTGGCTCATGCCTGTAATCCCAGCACTGTGAGAGGCCGAGGCGGGCGGATCACCTGAGCTGAGGAGTTCGAGACCAGCCTGGCCAACATGGCGAAACCCCATCTCTACTAAAAACACAAAAATTAGGCCAGGTGTGGTGGCTCACACCTGTAATCCCAGCACTTTGGGAGGCCAAGGCGGGCGGATCACCTGAGGTCAGGAGTTCCAGACCTGCCTGGCCAACATGGTGGAATCCCATCTCTACTAAAAATACAAAAATCTGCCAGGTGTGGTGGCACACTTCTGTAATCCCAGATACTCAGGAGGCTGAGGCAGGAGAATCACTTGAACCCTGGAGATGGAGGTTGCAGTGAGCCAAGATCAAGAGATTGCACTCTAGCCAGGGTGACTAGAGTGAGACTCGGTCTCAAAAAAAATGTAATTAATTAATTAATTAATACAAAAATTAGCTGGGCGTGGGCTAGGTGTGGTGGCTCACGCCTGTAATCCCAGCACTTTGGGAGGCCGAGACAGGCGGATCACCTGAGGTCAGGAGTTCAAGACCAGTTTAACCAACATGGAGAAACCCCATCTCTACTAAAAATACAAAATTAGCTGGGCGTGGTGGTGCATGCCTGTAATCCCAGCTACTCGGGAGGCTGAGGCAGAAGAATCGCTTGAGCCTGGTAGGCGGAGATCGTGGTGAGCCGAGATCGCGCCATTGCACTCCAGCCTGGACAACAAGAGCGAAACTCCGTCTAAAAAAAAAAAAAAAATTAGCTGGGCATGGTAACAGGCGCCTGTAAACCCAGTTTCCTCGGGAGGCTGAAGCAGAATTGCTTGATCCCAGAGGCAGAGGTTGCAGTGAGCCAAGATAGTGCCATTGCAGTCCAGCCTGGGCAACAAGAGTGAAACTCCGTCTCAAAAAAAAAAAAAAAAAAA","GGCTGGGCGCAGTGGCTCACACCTGTAATCCCAGCACTTAGGGAAGCTGAGGCGAGTAGATCACCTGAGGTCAGGAGTTAGAGACCAGCCTGGCCATCATGGTGAAACCCCGTCTCTACTAAAGATACCAAAAATTAGCTGAGTGTGGTGCTGGGTGCCTGTAATCCCAGAAACTCAGGGTGCCTGTAATCCCAGCAACTCAGGGTGCCTTTAATCCCAGCAACTGAGGGTACCAGTAATCCCAGCAACTCAGGGTGTCTTTAATCCTAGCAACTGAGGGCACCTGTAATCCCAGCAACTCAGGAAGCTGAGACAGGAGAAGTACTTGAACCCAGAAGGCAGAGGTTGCAGTGAGCCGATATTGCACCATTGCACTCCAGTCTGGGCAACAAGAGTGAAACTCTGTCTCAAAAAAAAA"
"chr16","20816618","20817242","JH378118","18053084","18053501","267","2763534","GGCCCGGCGTGGTGGCTCATGCCTGTAATCCCAGCACTTTGGGAGGCCGAGGCCGGCGGATCACCTGAGGTCAGGAGTTTGAGACCACCCTGGCCAACACGGTGAAAACCTGTCTCTACTAAAAATACAAAAATTAGCCAGGCGCAGTGGCTCACGTCTGTAATTCCAGCACTTTGGAGGGCCGAGGGGGGCAGATCACAAGGTCAGGAGTCCAAGACCAGCCAGGCCAACATAGTGAAACCCGGTCTCTACTAAAAATACAAAAAATTAGCCGGGCGTGGTGGCGGACCCCTGTAGTCCCAGCTACTCAGGAGGCTGAGACAGGAGAATCTCTTGAACCCAGGAGGCAGAGGTTGCAGTGAGCCAAGATCATGCCATTCCACTCCAGCCTGGGCGACAGTGCAAGACTCTGTCTCAAAAACAAAAACAAAAAACCCCCAAACCAAAAATTAGCCAGGCGTGGTGGCATGCACCTGTAGTCCCAGCTACTTGGGAGGCTAAGGCAAGAGAATAGCTTGAACCCAGGAGGCAGAGGTTGCAGTGAGCCGAGATAGTGCCATTGCACTCCAACGTGGGTGACAAGAGCAAAACTCTGTCTCAAAAAAAAAAAAAAAAAAGGAAGGAA","GGCTGGGCGCAGTGGCTCACACCTGTAATCCCAGCACTTAGGGAAGCTGAGGCGAGTAGATCACCTGAGGTCAGGAGTTAGAGACCAGCCTGGCCATCATGGTGAAACCCCGTCTCTACTAAAGATACCAAAAATTAGCTGAGTGTGGTGCTGGGTGCCTGTAATCCCAGAAACTCAGGGTGCCTGTAATCCCAGCAACTCAGGGTGCCTTTAATCCCAGCAACTGAGGGTACCAGTAATCCCAGCAACTCAGGGTGTCTTTAATCCTAGCAACTGAGGGCACCTGTAATCCCAGCAACTCAGGAAGCTGAGACAGGAGAAGTACTTGAACCCAGAAGGCAGAGGTTGCAGTGAGCCGATATTGCACCATTGCACTCCAGTCTGGGCAACAAGAGTGAAACTCTGTCTCAAAAAAAAA"
"chr16","21054922","21055508","JH378118","18053084","18053501","243","3001838","GGCCGGGTGCGGTGGCTCACACCTATAATCCCAGCACTTTGAGAGTCTGAGGCAGGCGGATCACCTGAGGTCAGGAGTTCCAGACCAGCCTGGCCAACATGGTGAAACCCAGTCTCTACTAAAAATACAAAAAAAGACCGGGCACAGTGGCTCACGCCTGTAATTCCAGCACTTTGGGAGGCCGAGGCAGGTGGATCACCTGAGGTTGGGAGTTCGCGACCAGCCTGACCGACATGGAGAAATCCCATCTCTACTAAAAATACAAAATTAGCCGGGCGTGGTGGCACATGCCTGTAATTCCAGCTACTCAGGAGGCTGAGGGAGGAGAATCACTTGAACCTGGGAGGCGGAAGTTGTGGCGAGCCAAGATCACGCCATTGCACTCCAGCCTGGGCAACAAGAGTGAAACCCCATTTCAAAAAAAAAAAAAATTAGCCAGGGGTGGTGGTGCATTCTTGTAATACCAGCTACTCGGGAGGCTGAGGTAGGAGAATCACTTGAGCGCAGGAGGCAGATGTTGTAGTGAGCCGAGTGCCATTGCACTACAGCCTGGGCGACAAGAAAGTAACTCCACCTCAAAAAAAAAA","GGCTGGGCGCAGTGGCTCACACCTGTAATCCCAGCACTTAGGGAAGCTGAGGCGAGTAGATCACCTGAGGTCAGGAGTTAGAGACCAGCCTGGCCATCATGGTGAAACCCCGTCTCTACTAAAGATACCAAAAATTAGCTGAGTGTGGTGCTGGGTGCCTGTAATCCCAGAAACTCAGGGTGCCTGTAATCCCAGCAACTCAGGGTGCCTTTAATCCCAGCAACTGAGGGTACCAGTAATCCCAGCAACTCAGGGTGTCTTTAATCCTAGCAACTGAGGGCACCTGTAATCCCAGCAACTCAGGAAGCTGAGACAGGAGAAGTACTTGAACCCAGAAGGCAGAGGTTGCAGTGAGCCGATATTGCACCATTGCACTCCAGTCTGGGCAACAAGAGTGAAACTCTGTCTCAAAAAAAAA"
"chr16","27896431","27896766","JH378166","6401112","6401453","56","21495319","GGCCAGGCGCGGTGGCTCACGCCTGTAATCCCAGGACTTTGGTAGTCCAAGGCGGGTGGATCACCTGAGGTCAGGAGTTCAAGATCAGCCTGACCAACATGGCAAAACCTCGTCTCTACTAAAAAATACAAAAATTAGCCGGTGTGGTGGCAGGTGCCTGTAATTCCAGCTACTCGGGACGCTGAGTCATGAGAATTGCTTGAACCTAGGAGGCAGATGTTGCAATGAGCCGAGATCGCACCATTGTACTCCAGCCTGGGCGACAAGAGGGAAACTGTCTCCAAAAAAAAAAAAGAAAGAAAGAAAGAAAGAAAGAAAAAAGAAAAACAAAACAAA","GGCCAGGTGCAGTGGCTCACCCCTGTAATCCCAGCACTTTGGGAGGTCGAGGTGGGTGGATCACCTGAGGTCAGGAGTTCAAGACCAGCCTGACCAAAATGGTGAAACCCCATCTCTACTAAAAATACAAAACATTAGCCAGACATCGTGGCGGGCACCTGTAATCCCAGCTACTTGGGAGGCTGAGGCAGGAGAATTGCTTGAGCCTAGGAGGCGGAGGTTACAGTGAGCCATGATCGTGCCATTGGACTCCAGCCTGGGCTACAAGAGCGAGACTCCATCTCAAAAAAAAAAAAAAAAAAAAAAAAGAAAGAAAGAAAGAAAGAAAGAAAAGAAAGAAAG"
"chr16","36524888","36525430","JH378206","6546474","6546861","201","29978414","TTTGAGACCAGCCTGGCCATTGTGGTGAAACCCCGTCTCTACTAAAAAAAATTCAAAAAATGGCTGGGTATGGTGGCTCACGCCTGTAATCCCAGGACTTTGGGAGGCCAAGGTGGGCGGATCACCTGAGGTCAGGAGTTTGAGACCAGCCTAGCCAACATGGTGAAACCCCGTCTCTACCAAAAATACAAAAATTAGCCGGGCTTGGTGGCGCGCACCTGTAATCCCAGGTACACTGGAGGTTGAGGCACAAGAATCGTTTGATCCTGGGAGGTTGCAGTGAGCCAAGATCACGCCACTGCACTCCAGACTGGGTGACAGAGCGAGATTCCATCTCAAAACAACAACAACAAACCCAAAAAATTAGCTGGGTGTGGTGGTGGGTGCCTGTAATCCCAGCTACTTAGGAGGCTGAGGCAGAAGAATCGCTTGAACCCAGGAGGTGGAGGTTGTTGCAGTGAGCAGAGATCGCACCATTGCACTCCAGCCTGGGCAACGAGTGAAACTCCATCTCAAAAAAAAAAAAAAAAAAAGAAAAAAAAA","GGCCACACATGGTGGCTAACGCCTGTAATCCCAGCACTTTGGGAGGCCAAGTCGGGTGGATCATGAGGTCAGGAGACCAAGACCATCCTGGCCAAATGGTGAAACCCCGTCTCTACTAAAAATACAAAAATTAGCTGGGCATGGTGGCGTGTGCCTGTAATCCCAGCTACTCAGGAGGCTGAGGCAGGACAATTGCCTGAACCCAGGAGAATTAGCTGGGCATGGTGGCGTGTGCCTGTAATCCCAGCTACTCAGGAGGCTGAGGCAGGACAATTGCCTGAACCCAGGAGGCGAAGGTTGCGGTGAGCCGAGATTGTGCCATTGCACTCCAGCCTGGGTAACAAGAGCGACACTCTGTCTCAAAAAAAAAAAAAAAAAAAAAAAAAAA"
"chr16","36528224","36528842","JH378119","32351107","32351490","270","4177117","GGCCAGGCGTGGTGGCTCACGCCTGTAATCCCAGCACTTTGGGAGGCTGAGGCAGGCAGATCACCTGAGGTCAGGAGTTCAAGACCAGCCTGGCCAACATGGTGAAACTCCATCTCTACTAAAAATACAAAATTAAGCCGGGCACGGTGGCTCACATCTGAAATCCCAGCACCTTGGGAGGCTAAGGCAGGCGGATCACGAGGTCAGGAGTTCAAGACTAGCTGACCAATATGGTGAAACCCCGTGTCTACTAAAAATACAAAAAAAATTAGCTGGGCGTGGTGGCGCATGCCTGTAGTTCCAGGTACTCAGGAGGCTGAGGAAGGAGAATCACTTGAACCTGGGAGGCGGAGGTTGCAGTGAGCCAAGATCATGCCACTGCATTCCAGCCTGGGCAACAGAGCAAGACTCTGTCTCAAAAATAAAAATAAAAATAAAAGTAAAAATACAAAATTAGCCAGGCGTGGTGGTGTGTGCCTGTAATCACAGCTACTCAGGAGGCAGGAAAATCACTTGAACCTAGGAGGAGGAGGTTGGTGAGCCAAGATCACACCATTGCACTCCAGCCTGGGCAAAAAGAGCAAAACTCCGAACTCTGTCTCAAAAAAAAAAAAAAAAA","GGCCAGGTATGGTGGCTCACACCTGTAATCCCAGCACTTTGGGAGGCCAAGGCAGGCAGACCACCTGAGGTCAGGAGTTCGAGATCAGCCTAGCCAACATGGTGAAACCCCATCTCTAGTAAAAATAAAATTAGCCAGGCATGGTGGTGCATGCCTGTAACGCAGGTCAGGAGTTCGAGATCAGCTTAGCCAACATGGTGAAACCCCATCTCTAGTAAAAATAAAATTAGCCAGGCAGGTGGTGCCGCCTGTACTCGGGAGGCTGAGGCAGGAGAATCACTTGAACCCAAGAGGCAGAGGTTGCAGTCAGCCAAGATCATGCCATTGCACTCCAGCCTAAGCAAAAAGAGTAAAACTCAGTCTCAAAACAAAAAAACAAAAAAA"
"chr16","44800308","44800913","JH378118","18053084","18053501","244","26747224","GGCCTGGTGCAGTGGCTCACACCTGTAATCCCAGCACTTTGGGAGCCCAAGGCGGGTGGATCACCTGAGGTCAGGAGTTCGAGACCAGCCTGGCCAACATGGTGAAATCCTCTCTACTAAAAATGCAAAAAATTAGCTGGGCGGCCAGGCGCAGTGGCTCACGCCTGTAATCCCAGCACTTTGGGAGGCCGAGGTGGGCGGATCACAAGGTCAGGAGATCGAGACCATGCTGGCTAACACGGTGAAACTCCGTCTCTACTGAAAATACAAAAAATTAGCCAGGCACGGTGGCGGGCGCCTGTAGTCCCAGCTACTGGGGAGGCTGAGGCAGGAGAATGGCGTGAACCTGGGAGGTGGAGGTAGCAGTGAGCCAAGATTGCGCCACCGCAGTCCGGCCTGGGTGAAAGAGCGAGACGCTGTCTCAAAAAAAAAAAAAAAAAATTAGCTGGGCATGGTGGCGGGCGCCTGTAATCCCAGTTACTCGGGAGGCTGAGGCAGGAGAATCAGTTGAACCCAGGAGGTGGAGGTTGCAGTAAGCCAAGATTGTGCCATTGTACTCCAGTCTGGGCAACAAGAGCGAAACTCTGTCTTAAAAAACAAAAAAAA","GGCTGGGCGCAGTGGCTCACACCTGTAATCCCAGCACTTAGGGAAGCTGAGGCGAGTAGATCACCTGAGGTCAGGAGTTAGAGACCAGCCTGGCCATCATGGTGAAACCCCGTCTCTACTAAAGATACCAAAAATTAGCTGAGTGTGGTGCTGGGTGCCTGTAATCCCAGAAACTCAGGGTGCCTGTAATCCCAGCAACTCAGGGTGCCTTTAATCCCAGCAACTGAGGGTACCAGTAATCCCAGCAACTCAGGGTGTCTTTAATCCTAGCAACTGAGGGCACCTGTAATCCCAGCAACTCAGGAAGCTGAGACAGGAGAAGTACTTGAACCCAGAAGGCAGAGGTTGCAGTGAGCCGATATTGCACCATTGCACTCCAGTCTGGGCAACAAGAGTGAAACTCTGTCTCAAAAAAAAA"
"chr16","45828895","45829498","JH378118","18053084","18053501","256","27775811","GGCCAGGAGAGGTGGCTCATGCTTGTAATTCCAGTATTTTGGGAGCCCAAGGCGGGTGGATCACTTGAGGTCAGGAGTTTGAAACCAGCCTGACCAACATGGTGAAACCCCGTCTCTACTAAAAATTCAAAATTAGGCAAGGCCTGGTGGCTCATGCCTGTAATCCCAGCACTTTGGGAGGCCAAGGAGGGAGGATCACCTGAGGTCGGGAGTTTGAGACCAGCCTGACCAACATGGAGAAACCCCGTCTCTACTAAAACTACAAAATTAGCCGGGTGTGGTGGCCCATGCCTCTAATCCCAGCTACTCTGGAGGCTGAGGCAGGAGAATCACTTGGACCTGGGATGTGAAGGTTGCAGTGAGCCAAGATCGAGCCATTGCACTCCAGCCTGGGCCACAAGAGTGAAACTCCGTCCCAGAAAAAAAAAAAAAAATTAACCTGGCATGGTGGTGTATGCCTGTAATCCCAGCTACTCGGGAGACTGAGGCAGGAGAATCTCTTGAACCCGGGAGGCGGAGGTTGCAGTAAACCGAGATTGCGCCATTGCACTCCGGCCTGGGTGACAAGAGCGAAACTCCGCCTAAAAAAAAAAAGAAAAGAAAA","GGCTGGGCGCAGTGGCTCACACCTGTAATCCCAGCACTTAGGGAAGCTGAGGCGAGTAGATCACCTGAGGTCAGGAGTTAGAGACCAGCCTGGCCATCATGGTGAAACCCCGTCTCTACTAAAGATACCAAAAATTAGCTGAGTGTGGTGCTGGGTGCCTGTAATCCCAGAAACTCAGGGTGCCTGTAATCCCAGCAACTCAGGGTGCCTTTAATCCCAGCAACTGAGGGTACCAGTAATCCCAGCAACTCAGGGTGTCTTTAATCCTAGCAACTGAGGGCACCTGTAATCCCAGCAACTCAGGAAGCTGAGACAGGAGAAGTACTTGAACCCAGAAGGCAGAGGTTGCAGTGAGCCGATATTGCACCATTGCACTCCAGTCTGGGCAACAAGAGTGAAACTCTGTCTCAAAAAAAAA"
"chr16","47110839","47111458","JH378118","18053084","18053501","268","29057755","GGCCAGGCGTGGTGGCTCACGCCTTTAATCCCAGCACTTTGGGAGGCCGAGGCAGGCAGATCACCTAAGGTCAGGAGTTCGAGACCAGCCTGGCCAACATGGTGAAACCCCCTCTCTACTAAAAATGCAAAAATTTCTGGGCATGGTGGCTCACGCCTGTAGTCCCAGCACTTTGGGAGGCCAAGGCAGGCGGATCACTTGAGGTCAGGAGTTTGAGACCAGCCTGGCCAACATGGTGAGACCCCTGTCTCTACTAAAAATATAAAAAAGTAGCCAGGCGTGGTGGTGTATGCCTCCCAGATAATTGGGAGGCTGAGGTGGGATAATTGCTTGAACCCGGGAGGCAGAGGTTGTAGTGAGCCAAGATAGCGCCAATGCACTCCAGCCTGGGCAACAGAGCGAGACTCTGTCTCAAAAAAAAAAAAAAAAAGAAAAAAGAAAAGAAATTAGCTGGGCGTGGTGATGGGTGCCTGTAATCCCAGCTGCTTAGGAAGCTGAGGAAGGAGAATCACTTAGACCCAGGAGACAGAGGTTGCAGTGAGCCGAGATCGCACCATTGTATTCCAGCCTGGGTGACAAGAGAAAAACTATGTCTCAAAAAAAAAAAAAAGAGTAGAAAA","GGCTGGGCGCAGTGGCTCACACCTGTAATCCCAGCACTTAGGGAAGCTGAGGCGAGTAGATCACCTGAGGTCAGGAGTTAGAGACCAGCCTGGCCATCATGGTGAAACCCCGTCTCTACTAAAGATACCAAAAATTAGCTGAGTGTGGTGCTGGGTGCCTGTAATCCCAGAAACTCAGGGTGCCTGTAATCCCAGCAACTCAGGGTGCCTTTAATCCCAGCAACTGAGGGTACCAGTAATCCCAGCAACTCAGGGTGTCTTTAATCCTAGCAACTGAGGGCACCTGTAATCCCAGCAACTCAGGAAGCTGAGACAGGAGAAGTACTTGAACCCAGAAGGCAGAGGTTGCAGTGAGCCGATATTGCACCATTGCACTCCAGTCTGGGCAACAAGAGTGAAACTCTGTCTCAAAAAAAAA"
"chr16","48159907","48160229","JH378222","6231244","6231546","61","41928663","GGCTGGGCACAGTGGCTCATGCCTGTAATCCCAGCACTTTGGGAGGCCGAGGCAGGCGGATCACCTGAGGTCAGGAGTTCGAGACTAGCCTGGCCAATATAGCGAAACCCCGTCTCTACTAAAAATTAGTTGGGCATGGTGGCAGGCGCCTTAATCCCAGCTACTTGGGATGCTGAGGCAGAAGAATCGCTTGAACCCAGAGGGTGGAGGTTTCAGTGAGATGAGATCGTGCCATTGCACTCCAGACTGGGCAACAAGAGCGAGACTCTGTAAAAAAAATTAATTAATTAATTAACTAATTAATTAAAATAAAATGAGAAAAA","GGCTGGGCATGGTGGCTCACGCCTGTAATCCCAGCACTTTGGGACGCTTAGGCAGGTGGATTGCCTGAGGTCAGGAGTTCAAGACTACCCTGACCAACATAGTGAAACCCCGTCTCTACTAAAAATTAGCTGGGCATGGTGGCAGAGGCCTGTAATCCCAGCTACTCGGGAGGCTGAGGCAGGAGAATCACTTAAACCTGGGAGTTGGAGGTTGCAGTGAGCCAAGATCAAGCCATTGCACTCCAGTCTGGGCAACAAGAGCAAGACTCTGTCTCAAAAAAAAAAAAAAAAAGAAAAGAAAAA"
"chr16","49252302","49252639","JH378314","538162","538484","57","48714140","GGCCAGGCGCAGTGGTGCATGTCTGTAATCTTAGCACTTTGGGAGGCCGAGGTGGACGGATTACATGAGGTCAGGAGTTCAAGACCAGCCTGGCCAACATGGTGAAATTCCATCTCTACTACTAAAAAAAAAAAAAAAAAAAAAAAAAAAAAAAAAAAAAAATACAAAAATTAGCTGGGCTTGGTGGCGGGTGCCTGTAATCCCAGCTACTTGGGAGGCTGAGGCAGGAATCACTTAAACCCAGGAGGTGGAGGTTGCAGTGAGCCAAGACCATGCCATTGCACTCCAGCCTGGGCAACAAGAGCAAAACTCCGTCTCAAAAAAACAAAACAAAAAAA","GGCTGGGTGCGGTGCCTCACACCTGTAATCCCAGCACTTTGGGAGGCCGAGGTGGGTGGATCACGAGGTCAAGAGATCAAGACCATCCTGGTCAACATGGTGAAACCCTGTCTCTACTAAAAAAAAAAAAAAAAAAAAAAAAAAAAAAAAAAAAATTAGCTGGGCATGGTGGCGTGTGCCTGTAATCCCAGCTACTCAGGAGGCTGAGGCAGGAGAATTGCCTGAACCCAGGAGGCGGAGGTTGCGGTGAGCCGAGACTGTACCATTGCACTCCAGCCTGGGTAACAAGAGCGAAACTCCATCTCAAAAAAAAAAAAAAAAAA"
"chr16","49464616","49465219","JH378118","18053084","18053501","254","31411532","GGCCAGGCGTGGTGGCTCACACCTGTAATCCTAGCACTTTGGGAGACTGAGGCAGGTGGATCACATGAGGTGAGGAGTTCAAAACCACCCTGGCCGACATGGTGAAACCCCGTCTCTACTAAAAATATTTTTAAAAAGGCCAGGCGTGGTGGCTCACACCTGTAATTCCAGCACTTCGGGAGGCTGGGGCAGGCAGATCACAAGGTCAGGAGATCGAGACCATTCTGGCCAACGTGGTGAAACCCCGTCTCTACTAAAAATACAAAAATTAGCTGGGCGTGGTGGCGCGTGCCTGTAATCCCAGCTACTTGGGAGGCTGATACAGGAGAATTGCTTGAACCAGTGAGTCAGAGGTTGCAGTGAGCTGAGATTGCGCCATTGCACTCCAGCCTGGCAACAGAATGAGACTCCGTCTCAAAAAAAAAAAAAAAATTAGCTGGGCATGGTGGCAGGCACCTGTGATCCCAGCTACTTGGGAGGCTGAGGCAGGAGAATCGCTTGAACCTGGGAGGTGGAGGTTGCAGTGAGCTGAGATTGCGCCATTGCACTCCAACCTGGGCGTCAAGAGCAAAACTCCATCTCAAAAATAAATAAATAAATAAAA","GGCTGGGCGCAGTGGCTCACACCTGTAATCCCAGCACTTAGGGAAGCTGAGGCGAGTAGATCACCTGAGGTCAGGAGTTAGAGACCAGCCTGGCCATCATGGTGAAACCCCGTCTCTACTAAAGATACCAAAAATTAGCTGAGTGTGGTGCTGGGTGCCTGTAATCCCAGAAACTCAGGGTGCCTGTAATCCCAGCAACTCAGGGTGCCTTTAATCCCAGCAACTGAGGGTACCAGTAATCCCAGCAACTCAGGGTGTCTTTAATCCTAGCAACTGAGGGCACCTGTAATCCCAGCAACTCAGGAAGCTGAGACAGGAGAAGTACTTGAACCCAGAAGGCAGAGGTTGCAGTGAGCCGATATTGCACCATTGCACTCCAGTCTGGGCAACAAGAGTGAAACTCTGTCTCAAAAAAAAA"
"chr16","49983504","49983843","JH378316","567988","568320","50","49415516","GGCCAGGCATGGTGGCTTACGCCTGTAATCTCAGCACTTTGGGAGGCCAAGGCAGGCGGATCACCTGAGGTCAGGAGTTCAAGACCAGCCTGGTCAACATGGCGAAACCCTGTCTCTACTAAAAAAATACAAAAATTAGCCAGGCGTGGTGGTGGGCGCCTGTAATCTCTCCTACTTGGGAGACTGAGGCAGGAGAATTGCTTGAACTCAGAAGGCAGAGGTTGCAGTGAGCTGAGATCACGCCATTGCACTCCAGCCTGGATGACAAGAGCAAAACTCCATCTCAAACAAACAAAAAACAAACAAACAAAAAAAAACAAAAAAACCTCCAAAAAACAAA","GGCCGGGCGTGGTGGCTCACGCCTGTAATCCCAGCACCTTGGGAGGCTGAGGCGGGTGGATCACGAGGTCAAGAGATTGAGACCAGCCTGGTCAACATGGTGAAACCCTGTCTACTAAAAAAATACAAAAATTAGCTGGGCATGGTGGCACGTGCCTGTAATCCCAGCTACTCAGGAGGCTGAGGCAGGAGAATTGCCTGAACCCAGGAGGCGGAGGTTGCGGTGAGCCGAGATCGCGCCATTGCACTCCAGCCTGGGTAACAAGAGCGAAACTCCGTCTCAAAAAACAAAAAACAAAAAAACAAAAAACAAACAAACAAACAAAAAAACAAA"
"chr16","50470493","50471105","JH378118","18053084","18053501","251","32417409","GGCTGGGAGCGGTGGCTCATACCTGTAATCCCAGCACTCTGGGAGGCCGAGGCGCGTGGATCACCTGAGGTCAGGAGTTTGAGACCAGCCTGGCCAGCATGGTGAAACCCTGTCTCTACTAAAAATAGAAAAAGTTAGCTGGGTGAACAGCCGGGCGCGGTGGCTCACACCTGTAATCCCAGCACTTTGGGAGGCCGAGGCAGGTGGATCACAAGGTCAGGAGATCGAGACCATCCTGGCTAACACGGTGAAACCCTGTCTCTACTAAAAATATAAAAAATTAGCCGGGCATGGTGGTGGGTGCCTGTAGTCCCAGCTGCTCAGGAGGCTGAGGCAGGAGAATGGCGTGAAGCCAGGAGGCAGAGGTTGCAGTGAGCCGAGATCGTACCACTGCACTCTAGCCTGGGTGACAGAACGAGACTGTGTCTCAAAGAAAAAAAAAATTAGCTGGGTGTGGTGGCAGACACCTGTAATCCTAGCTACTTGGGAGGTTGAGGCAGGAGAATCGCTTGGACCTGGGAGGCGGAGGTTGCAGTAGGCTGAAATCGCACCATTGCACTCCAGCCTGGGCAACAAGAGGGAAACTCAGTCTCAAAAAAAAAAAAAAAAAAAA","GGCTGGGCGCAGTGGCTCACACCTGTAATCCCAGCACTTAGGGAAGCTGAGGCGAGTAGATCACCTGAGGTCAGGAGTTAGAGACCAGCCTGGCCATCATGGTGAAACCCCGTCTCTACTAAAGATACCAAAAATTAGCTGAGTGTGGTGCTGGGTGCCTGTAATCCCAGAAACTCAGGGTGCCTGTAATCCCAGCAACTCAGGGTGCCTTTAATCCCAGCAACTGAGGGTACCAGTAATCCCAGCAACTCAGGGTGTCTTTAATCCTAGCAACTGAGGGCACCTGTAATCCCAGCAACTCAGGAAGCTGAGACAGGAGAAGTACTTGAACCCAGAAGGCAGAGGTTGCAGTGAGCCGATATTGCACCATTGCACTCCAGTCTGGGCAACAAGAGTGAAACTCTGTCTCAAAAAAAAA"
"chr16","50478366","50478929","JH378114","15957391","15957789","242","34520975","GGCTGGGCACGGTGGCTCATGCCTGTAATCCTAGTACCCTGGGAGGCTGAAGCTGGCAGATCACTTGAGGTCAGGAGTTCGAAACCAGCCTGGCCAACATGGTGAAACCTCATCACTACTAAAAATACAAAAAGTCAGCCGAGCGCGGTGGCTCACGCCTTTAATCCCAGCACTTTAGGAGTCTGAGGCGGGTGGATCACAAGGTCAGGGGTTTGAGACTAGCCTGACCAACACGGTGAAACATCTTTACTAAAAATAGCCAGGCATGGTGGTGCAGGCCTGTAGCAGGTACTCAGGAGGCTGAGGCAGCAGAATCGCTTGAACCCGGGAGGCGGAGGTTGCAGTGAGCCGAGATTGAGCCACTGCACTCCACCCTGGGCAACTGAGCGAGACTCCGTCTCAAAAAAAAAAAAAAAAATTAGCTGGACGTGGTGGTGGATGCCTGTAATCCCGGCTACTTGGTACTTGGAAGGCTGAGACAGGAGAATCGCTTGAACCCGGGAGGTGGAGGTTGCAGTGAGCTGAGATAGCGCCATTGCACTCCAGCCTGGGCAACAAGAGTGA","GCAAGGAACGGTGGCTCATGCCTGTCATCCCAGCACTTTGGGAGGCTAAGGAGGGTGGATTACCGAAGGTCATGAGTTTGAGACCAGCCTGACCAACATGGTGAAAACCCCATCTCTACTAAAAATACAAAAAATTAGCCAGATACAGCTATGCGGCAGACTGGGGCAGGAGAATCGCTTGGACCCAAACCCCATCTCTACTAAAAATACAAAAAATTAGCCGGATACAGCTATGCGGGAGACTGGGGCAGGAGAATCGCTTGGACCCGGGAGGCAGAGATTGCAGTGAGATGAGACCATGCCATTGCTCTCTAGCTTGTGCGATGAGAACAAGACTCTGTCTCAAAAAAAAAAAAAAAAAAAAAAAAAAAAAAAAAAAAAAAAGAGAGAGAGAGAAAA"
"chr16","51388263","51388584","JH378271","2122362","2122678","46","49265901","GGCTGGGTACGGTGGCCCACACCTGTAATCCCAGCACCTTGGGAGGCTGAGGTGGGCGGATTACCTGAGGTCAAAAGTTCAAGACCAGCCTGGCCAACATGGTGAAATCCCATCTCTGCTAAAAATACAAAAAAAAAAAAAAAAAAAAAAAAAAAATTGCCAGGCATGGTGGCAGGCACCTGTAATCCCAGCTACTTGGGAGGCTGAGGCAGGGGAATCGCTTGAACCTGGGAGGCAGAGGTTGCAGTGAGCCCAGATAGCGCCATTGCACTCCAGCCTGGGCGACAAGAGCGAAACTCTGTCCAAAAAAAAAAAAAAAAAA","GGCCGGGCACGGTGGCTCACACCTGTAATCCCAGCACTTTGGGAGGCTGAGGTGGGTGAATCACCTGAGGTCAGGAGTTTGAGACCAGCCTGACCAACATGATGAAACCCGGTCTCTGCTAAAAATACAAAAAAAAAAAAAAAAAAAAAAAAAAAAAGCTGGGCATGATGGTGGGCACCTGTAATCCCAGCTACTCGGGAGGCTGAGGCAGGAGAATCGCTTGAACACCAGGAGGTGGAGGTTGCTATGAGCCGAGATCGCACCATTGCACTCTAGCTTGGGCAACAAGAGAGAAACTCCATCAAAAAAAAAAAAAA"
"chr16","51876298","51876882","JH378118","18053084","18053501","253","33823214","GTAATCCCAGCACTTTGGGAGGCCCAAGTGGGTGGATCACCTGAGGTCAGGAGTTCATGACCAGCCTGGCCACATGGTGAAACCCCATCTCTACTAAAAATACAAAATTAGGCTGGGCGCGGTGGCTTACGTCTGTAATTCCAGCACTTTGGGAGGCCGAGGCAGGCGGATCATGAGGTCAGGAGATTGAAACCATCCTGGCTAACACGGTGAAACCCTGTCTCTACTAAAAATACAAAAAATTAGCCGGGTGTGGTGGGGGGGCGCCTGTAGTCCCAGCTGCTCAGGAGGCTGAGGCAGGAGAATGGCATGAACCCGGGGGGGCGGAGCTTGCAGTGAGCTGAGATCATGCCACTGCACTCCAGCCTGGGCAACAAAGTGAGACTCCGTCTCAAAAAAAAAAACCAAAAAACAAAATGAGCTGGGTGTGGTGGTGGGGGCGTATAATCCCAGCTATACAGGAGGCTGAGGTAGGAGAATCACTTGAACCCGGGAGGTGGAGGTTGCAGTGAGCCGAGATTGTGCCATTTCACACCAACCTGGGTAACAAGAGTAAAATGCTGTCTCAAAAAAAAAAAAGAAAAA","GGCTGGGCGCAGTGGCTCACACCTGTAATCCCAGCACTTAGGGAAGCTGAGGCGAGTAGATCACCTGAGGTCAGGAGTTAGAGACCAGCCTGGCCATCATGGTGAAACCCCGTCTCTACTAAAGATACCAAAAATTAGCTGAGTGTGGTGCTGGGTGCCTGTAATCCCAGAAACTCAGGGTGCCTGTAATCCCAGCAACTCAGGGTGCCTTTAATCCCAGCAACTGAGGGTACCAGTAATCCCAGCAACTCAGGGTGTCTTTAATCCTAGCAACTGAGGGCACCTGTAATCCCAGCAACTCAGGAAGCTGAGACAGGAGAAGTACTTGAACCCAGAAGGCAGAGGTTGCAGTGAGCCGATATTGCACCATTGCACTCCAGTCTGGGCAACAAGAGTGAAACTCTGTCTCAAAAAAAAA"
"chr16","59738190","59738518","JH378138","4229795","4230103","67","55508395","TCACAGCATTTTGGGAGGCCAAGGCAGGCGGATCACCTGTGGTCAGGAGTTTGAGACCAGCCTGGCCAACATGGTGAAACCCCATCTCTACTAAAAATACAAAACAATTAGCCAGGTTTGGTGGCAGGCGCCTATAATCCCAGCTACTTGGGAGGCTGAGGCAGGAGAATCGCTTGAACCCAGGAGGCGGAGGTTGCAGTGAGCCGAGAACACACCATTGTACTCCAGCCTGCGACAAGAACGAAACTGTATCTCAATTAAAAAAAAAAAAAGAAAGGGAGGAAGGAAGGAAGGAAGGAAGGAAGGAAGGAAGGAAGAAAGAAAGAAAA","CACTTTGGGAGGTGAAGGCGGGCAGATCACCTGAGGTCAGGAGTTCGAGACCAGCCTGGCCAACATGGTGAAACCCCGCCTCTACTAAAAATACAAAAATTAGCCAGGTGTGACACTAGGCATCTGTAATCCCAGCTACTTGGGAGGCTGAGACAGGAGAATCACTTGAACCCAGGAGGCGGAAGTTGCAGTGAGCCAAGATCATGCCATTGCACTCCAGCCTGGGTGACAGGAGCAAAACTCTGTCTCAAAAAAAAAAAAAAAAAAAAAAAAAAAAAAAAAAAAAAAAGAAAAGAAAAGAAAAGTAAA"
"chr16","64682336","64682940","JH378118","18053084","18053501","253","46629252","GGCCGGGCACGGTGGCTCACTCCTGTAATCCCAGCACTTTGGGAGGGTGAGGCAGGTAGATCAAAAGGTCAGGAGTGGCCAGGCGTGGTGGCTCACACTTGTAATCCCAGCACTTTGGGAGGCCGAGATGGGCAGATCACGAGGTCAAGAGATTGAGACCATCCTGGCTAACATGGTGAAACCCCGTCTCTACTAAAAATACAAAAAATTAGCCGGGTGTGGTGGCAGGCGTCTGTAATCCCAGCCACTTGGGAGGCTGAGGCAGGAGAATCGCTTGAACCTGGGCGGCAGAGGTTGCATTGAGCCAGGATCGCGCCACTGCACTCCAGCCTGAGCAAAAAGAGCGAAACTCTGTCTCAGAAAAAAAAAAAAGTCAGGAGTTTGAGACCAGCCTGGCCAATATGGTGAAACCCCGTCTCTACTAAAAATACAAAAATTAGCCGAGCGTGGTGGTGGGTGCCTATACTCCCAGCTACTCAGGAGGCTGAGGCAGGAGAATCACTTGAACCCCAGGGGCAGAGGTTGCAGTGAGCCGAGATCGTGCCATTGCACTTCACCCTGGGTGAAAGAGCAAAACTCCGTCTCAAAAAAACAAAACAAAAAAA","GGCTGGGCGCAGTGGCTCACACCTGTAATCCCAGCACTTAGGGAAGCTGAGGCGAGTAGATCACCTGAGGTCAGGAGTTAGAGACCAGCCTGGCCATCATGGTGAAACCCCGTCTCTACTAAAGATACCAAAAATTAGCTGAGTGTGGTGCTGGGTGCCTGTAATCCCAGAAACTCAGGGTGCCTGTAATCCCAGCAACTCAGGGTGCCTTTAATCCCAGCAACTGAGGGTACCAGTAATCCCAGCAACTCAGGGTGTCTTTAATCCTAGCAACTGAGGGCACCTGTAATCCCAGCAACTCAGGAAGCTGAGACAGGAGAAGTACTTGAACCCAGAAGGCAGAGGTTGCAGTGAGCCGATATTGCACCATTGCACTCCAGTCTGGGCAACAAGAGTGAAACTCTGTCTCAAAAAAAAA"
"chr16","67872770","67873371","JH378118","18053084","18053501","260","49819686","GGCTGGGCATGGTGGCTCATGCCTGTAATCCCAGCACTTTGGGAGGCCAAGACGGGCAAATCACCTCAGGTCAGGAGATCGAGACCAGCCTGGCCAACACAGCAAAACCCACCTCTCTACTAAAAATAGAAAAATTACCCAGGCGTCACAGCTCACGCTTATAATCCCAGCACTTTGGGAGGCCGAAGCAGGTGGATCACAAGGTCAGGAGATCGAGACCAGCCTCACTAACATGGTGAAACCCCGTCTCTACTGAATATACGAAAAATTAGTCGGGTGTGGTGGCAGGCACCTGTAGTCCCAGCTACTTGGGAGGCTGAGGCAGGAGAATGGCTTTAACTCAGGAAGAGGAGCTTACGGTGAGCTGAGATTGTGCCACTGCACCCCAGCCTGGGCGACAGAGCAAGACTCCGTCAAAAAAAAAAAAAACCCCAAAACCCCAGCGTGGCAGCAGGTACCTGTAGTCCCAGCTACTCGGGAGGCTGAGACAGGAGAATGGCTTGAACCCGGGAGGCGGAGCTTGCGGTGAGCCAAGACGGCGCCACTTCATTCCAGCTATGGTGATAAGAGGGAGACCGTCTCAATCAATAAATTTAAAAAAA","GGCTGGGCGCAGTGGCTCACACCTGTAATCCCAGCACTTAGGGAAGCTGAGGCGAGTAGATCACCTGAGGTCAGGAGTTAGAGACCAGCCTGGCCATCATGGTGAAACCCCGTCTCTACTAAAGATACCAAAAATTAGCTGAGTGTGGTGCTGGGTGCCTGTAATCCCAGAAACTCAGGGTGCCTGTAATCCCAGCAACTCAGGGTGCCTTTAATCCCAGCAACTGAGGGTACCAGTAATCCCAGCAACTCAGGGTGTCTTTAATCCTAGCAACTGAGGGCACCTGTAATCCCAGCAACTCAGGAAGCTGAGACAGGAGAAGTACTTGAACCCAGAAGGCAGAGGTTGCAGTGAGCCGATATTGCACCATTGCACTCCAGTCTGGGCAACAAGAGTGAAACTCTGTCTCAAAAAAAAA"
"chr16","67970409","67971018","JH378118","18053084","18053501","252","49917325","GGGCGGGTGCGGTGGCTCACCCTGTAATCCCAGCACTTTCGGAGGCTTAAGCAGGCGGATCACCTGAGGTCAGGAGTTCGAGACCAGCCTGGCCAACATGGTGAAACCCCATCTCTACTAAAAATACAAAAAAATGGCCGGGTGCGGCGGCTCATGCCTGTCATCCCAGCACTTTCGGAGGCTGAGGCAGGCGGATCACCGGAGGTCAGGAGTTCGAGACCAGCTTGGCCAACATGGTGAAACCCCGTCTCTACTAAAAATACAAAAGTTAGCTGGGCATGGTGGCACATGCCTGTAATCCCAGCTACTCCGGAGGCTGAGGCAGGAGAATCACTTGAACCTGGGGAGGCGGAGGTTGCAGTGAGCTGAAATCACGGCATTGCACTCCAGCCTAGGCAACAGAGCGAAAGTCCGTCTCAGAAAAAAAAAAAAAAAAATTAGATGGGTTTGGTGGCGGGCGCGCTGTAATCCCAGCTACTTGGGAGGCTGGAGGCAGGAGAATCGCTTGAACTCAGGAGGCTGAGGTTACAGTGAGCCGAGATCATGCCATTGCACTCCAGCCTGGGCAATAAGAGTGAAACTCTGTCTCAAAAAACAACAACAACAAAAA","GGCTGGGCGCAGTGGCTCACACCTGTAATCCCAGCACTTAGGGAAGCTGAGGCGAGTAGATCACCTGAGGTCAGGAGTTAGAGACCAGCCTGGCCATCATGGTGAAACCCCGTCTCTACTAAAGATACCAAAAATTAGCTGAGTGTGGTGCTGGGTGCCTGTAATCCCAGAAACTCAGGGTGCCTGTAATCCCAGCAACTCAGGGTGCCTTTAATCCCAGCAACTGAGGGTACCAGTAATCCCAGCAACTCAGGGTGTCTTTAATCCTAGCAACTGAGGGCACCTGTAATCCCAGCAACTCAGGAAGCTGAGACAGGAGAAGTACTTGAACCCAGAAGGCAGAGGTTGCAGTGAGCCGATATTGCACCATTGCACTCCAGTCTGGGCAACAAGAGTGAAACTCTGTCTCAAAAAAAAA"
"chr16","68229729","68230314","JH378206","6546474","6546861","256","61683255","TGGTTTCCGCCTGTACTCCCAGCACTTTCGGAGGCTCAAGTGAGCAGATCGCTTGAGGCCAGGAGTTTAAGACCTACCTAGTCAACACCGGGGAAACCCACATCTCCACTAAACAATGGCCAGGAGCAGTGGCTCATACCTGTAATCACAACACTTTGGGATCCCAGCCAGACGGATCACAAAGTCAGGAGTTTGCGACCAGCCTATTAGAATGGTGAAACCCTGTCTCTACTAAAAATACAAAAAATTAGCCAGGCATGGTGGCGCATGCCTGTCATCCCAGCTACTCGGGAGGCTGAGGCAAGAGAATCACTTAAACCCAGGAGGCAGATGGAGGTTGCAGTGAGCCAAGATCACACCACTGCACTACAGCATGGGCGACAGAGCAAGACTCGGTCTCAAAAAAAAAAAAATTGGCCAGGCACGGTGGCTGACACCTGTAATCCCAGCACTTTGGGAGGCTGAGGCGGGAGAATCGCTTGAACCTGGGAGACGAAGGTTGCAGTGAGCCGAGACTAAGCCATTGCACCCCAACCTGGGCGGCAAGAGTGAAACTCTGTCTCAAAAAAAATTAAAAAATAAAAAA","GGCCACACATGGTGGCTAACGCCTGTAATCCCAGCACTTTGGGAGGCCAAGTCGGGTGGATCATGAGGTCAGGAGACCAAGACCATCCTGGCCAAATGGTGAAACCCCGTCTCTACTAAAAATACAAAAATTAGCTGGGCATGGTGGCGTGTGCCTGTAATCCCAGCTACTCAGGAGGCTGAGGCAGGACAATTGCCTGAACCCAGGAGAATTAGCTGGGCATGGTGGCGTGTGCCTGTAATCCCAGCTACTCAGGAGGCTGAGGCAGGACAATTGCCTGAACCCAGGAGGCGAAGGTTGCGGTGAGCCGAGATTGTGCCATTGCACTCCAGCCTGGGTAACAAGAGCGACACTCTGTCTCAAAAAAAAAAAAAAAAAAAAAAAAAAA"
"chr17","3506470","3507049","JH378118","18053084","18053501","238","14546614","CCTGTCATCCCAGCACTTTGGGAGGCCGAGGCGGGTAGATCACCTGAGGTCAGGAGTTTGAGACCAGCCTGGCCAACATGGCGAAACCCCGTCTCTACTAAAAATACAAAAACTGGCTGGGCGCGGTGGCTCACGCCTGTAATCCCAGCACTTTGGGAGGCTGAGGCGGGTGGATCATAAGGTCAGGAGTTCAAGACCAGCCTGGCCAACATGGTGAAACCCCATCTCTACTAAAAATACAAAAATTAGCCAGGTATGGTGGCAGGTGCCTGTAATCCCAGCTACTCAGGAGGCTGAGGCAGAGAATTGCTTGAACCCGGGAGGGGGAGGTTGCAGAGGGCCAAGATCGTACCACTATACTCCAGCCTGGGTGACAGGATGAGACTCCATCTTAAAAAAAAAAAAAAAAAAAAAAATTAGCCAGGCGTGGTGCGGGCACTTGTAATCCCAGCTATTCAGGAGGCTGAGGCAGGAGAATTGCTTGAACCCGGGAGGCAGAGGTTGCGGTGAGCTGAGATCGCACCATTGCACTCCAGCCTGGGCAACAAGAGTGAAACTCTGTCTCAAAAAAAAAACAAAA","GGCTGGGCGCAGTGGCTCACACCTGTAATCCCAGCACTTAGGGAAGCTGAGGCGAGTAGATCACCTGAGGTCAGGAGTTAGAGACCAGCCTGGCCATCATGGTGAAACCCCGTCTCTACTAAAGATACCAAAAATTAGCTGAGTGTGGTGCTGGGTGCCTGTAATCCCAGAAACTCAGGGTGCCTGTAATCCCAGCAACTCAGGGTGCCTTTAATCCCAGCAACTGAGGGTACCAGTAATCCCAGCAACTCAGGGTGTCTTTAATCCTAGCAACTGAGGGCACCTGTAATCCCAGCAACTCAGGAAGCTGAGACAGGAGAAGTACTTGAACCCAGAAGGCAGAGGTTGCAGTGAGCCGATATTGCACCATTGCACTCCAGTCTGGGCAACAAGAGTGAAACTCTGTCTCAAAAAAAAA"
"chr17","3641899","3642243","JH378198","5062782","5063109","59","1420883","GGCCAGGCACAGTGGCTCACACCTGTAATCCCAGCACTTCAGGAGGCCGAGGTGGGTAGATCACCTGAGGTCAGGGGTTTGAGACCAGCCTGACCGACGTGGCGAAACCCTGTCTCTACTACAAATACAAAAATTAGCCTTATGTGGTGGCGGGCACGTGTAATCCCAGCTACTTGGGAGGCTGAGGCAGGAGAATCGCTTGAATCTGGGAGGTGGAGGTTGCAGTGAGCCGAGATCACGCCATTGCACTCCAGCCTGGGTGACAAGAGCGAAACTCCATCTCAAAATAAATAAATACATACATACATGTATACATACATACATACATAAAAATAAAAAGTAAAA","GCCAGGCATGGTGGCTCACGCCTATAATCTCAGCACTTTGGGAGGCTGAGGCAGGCAGATCACTTGAGGTCAGGAGTTCAAGACCAGCCTGGCCAACATGGTGAAACCCTGGCTCTACTAAAAATACAAAAATTAGCCGGGTGTGGTGGCACGTGCCTATAATCCCAGCTACTCAGGAGGCTGAGGCAGAAGAATCGCTTGAATCCAGGAGGTGGAGGTTGCAGCGAGCCGAGATCACACCATTGGACTCCAGCCTGGGTGACAAGAGCGAAACTCCATCTCAAAATAAATAAATAAATACATAAAATTAAAAATAAATAAATAAATA"
"chr17","4508039","4508546","JH378206","6546474","6546861","194","2038435","GAGTTGGAGACCAGCCTGGCCAACACGGTGAAACCTCGTCCCCACTAAAAATATAAAAATTAGGCCAGGCGCGGTGGCTCACTCCTGTAATCCCAGCACTTTGGGAGGCTGAGGCGGGTAGATCATCTGAGGTCAGGAGTTCGAGACCAGCCTGGCCAACATGGTGAAACTCCGTCTCTACTAAAAATACAAAAATTAGCTGGGCTGGTAGCGGGCACCTGTAATCCCAGCTACTTGGAAGGGTGAGGCAGGAGAATCACTTGAACCCAGGAGGTGGAGGTTGCAGTGAGCCAAGATTGCAGCACTGTACTCCAGCCTGGGTGACAAAGCAAGACTCTGTCTCAAAAAAAAAAAAAAAAAAAAAGCCGGGCTTGGTGGTGAGTACCGGTAATCCCAGCTACTTGGAAGGCTGAGGCGGCGGACGTTGTACTTAGCCGAGATCATGCCATTGCACTCCAGCCTGGGTAACAGGCAAAAACTCTGTCTCAAAAAATAATAAATAATAAAA","GGCCACACATGGTGGCTAACGCCTGTAATCCCAGCACTTTGGGAGGCCAAGTCGGGTGGATCATGAGGTCAGGAGACCAAGACCATCCTGGCCAAATGGTGAAACCCCGTCTCTACTAAAAATACAAAAATTAGCTGGGCATGGTGGCGTGTGCCTGTAATCCCAGCTACTCAGGAGGCTGAGGCAGGACAATTGCCTGAACCCAGGAGAATTAGCTGGGCATGGTGGCGTGTGCCTGTAATCCCAGCTACTCAGGAGGCTGAGGCAGGACAATTGCCTGAACCCAGGAGGCGAAGGTTGCGGTGAGCCGAGATTGTGCCATTGCACTCCAGCCTGGGTAACAAGAGCGACACTCTGTCTCAAAAAAAAAAAAAAAAAAAAAAAAAAA"
"chr17","4560867","4561450","JH378118","18053084","18053501","257","13492217","GGCTGGGGGTGGTGTCTCTTGCCTGTAATCCCAACACTTTAGCAGGCTGAGGTGTGAGTATGGCTTGAGCCAGGAGTTCTAGACCAGCCTAGGAAACATGGCGAGATCCCTATCTCTACTAATACAAAAATTAGCCGGGCGTGGTGGCAAGCACCTGCAATCTCAGCTACTCGGGAGGCTGAGGTGGGAGGGCCGCTTGAGCCCAGGAGGTCCAGGCTGCAGTAAGCACTTATTTAAAAAAAAAAGAAGAGAAAAGATACAGAAATTAGCCAGGCGTGGTGGTGGGCACCTGTAATCCCAGCTACTCAGGAGGCTGAGGCAGGAAAATCACTTGAACCCGGGAGGCAGAGGTTGCAGTGGGCCGAGATCACACCATTGTACTCCAGCCTGGGCAACAAGAGCGAAACTCTGTCTCAAAAAAAAGAAAAGTAAAGTAAAGAAAAGATACAGAAATTAGCCAGGTGTGGTGGCGGGTGCCTGTAATCCCGCTACTTGGGAGGCTGAGGCAGGAGATTGCAGTGAGCCAAGATTGTGCCATTGCATTCCAGCCTGGGCAACAAGAGCAAAACTCCGCCTCAAAAAAA","GGCTGGGCGCAGTGGCTCACACCTGTAATCCCAGCACTTAGGGAAGCTGAGGCGAGTAGATCACCTGAGGTCAGGAGTTAGAGACCAGCCTGGCCATCATGGTGAAACCCCGTCTCTACTAAAGATACCAAAAATTAGCTGAGTGTGGTGCTGGGTGCCTGTAATCCCAGAAACTCAGGGTGCCTGTAATCCCAGCAACTCAGGGTGCCTTTAATCCCAGCAACTGAGGGTACCAGTAATCCCAGCAACTCAGGGTGTCTTTAATCCTAGCAACTGAGGGCACCTGTAATCCCAGCAACTCAGGAAGCTGAGACAGGAGAAGTACTTGAACCCAGAAGGCAGAGGTTGCAGTGAGCCGATATTGCACCATTGCACTCCAGTCTGGGCAACAAGAGTGAAACTCTGTCTCAAAAAAAAA"
"chr17","4846296","4846953","JH378118","18053084","18053501","290","13206788","GGCCAGGTGCAGTGGCTCACGCCTGTAATCCCAGCACTTTGGGAAGCCCAGGTGGGCGGATCACCCAAGGTCAGGGGTTCGAGACCAGCCTGGCCAACATGGTGAAACTCCATCTCTACTAAAAATAGAAAAAAATGGCCTGGTACGGTGGCTAACGCCTGTAATCCCAGCACTTTGGTAGGCCGAGGCAGGCAGATCACGAGGTCAGAAGATCGAGACCATCCTGGCTAACATGGTGAAACCCCGTCTCTACTAAAAATACAAAAAAGTAGCCAGGTGTGGTGGTGGGTGCCTGTAGTCCTAGCTACTCGGGAGGCTGAGGCAGGAGAATGCCGTGAACCCGGGAGGTGGAGCTTGCAGTGAGCTGAGATCACGCCACTGCACTCCAGCCTGGGTGACAGTGCGAGACTGTCTCCAAAAAAAAAAAAAAAAAAAAATTATATATATAATACACACACACACACACACACACACACACACACACAAATCAGCCAGGCGTGGTGGTGCGCACCTGTAATCCCAGCTACTCGGGAGGCTGAGGCAGGAGAGCTCCTCGAACCCAGGAGGCGAAGGTTGCAGTGAGCCGAGATCACACCATTGCACTCCAGCCTGGGCAACAAGAGCGAAACTCTGTCTCAAGGAAAAAAAAAAAAAAAAA","GGCTGGGCGCAGTGGCTCACACCTGTAATCCCAGCACTTAGGGAAGCTGAGGCGAGTAGATCACCTGAGGTCAGGAGTTAGAGACCAGCCTGGCCATCATGGTGAAACCCCGTCTCTACTAAAGATACCAAAAATTAGCTGAGTGTGGTGCTGGGTGCCTGTAATCCCAGAAACTCAGGGTGCCTGTAATCCCAGCAACTCAGGGTGCCTTTAATCCCAGCAACTGAGGGTACCAGTAATCCCAGCAACTCAGGGTGTCTTTAATCCTAGCAACTGAGGGCACCTGTAATCCCAGCAACTCAGGAAGCTGAGACAGGAGAAGTACTTGAACCCAGAAGGCAGAGGTTGCAGTGAGCCGATATTGCACCATTGCACTCCAGTCTGGGCAACAAGAGTGAAACTCTGTCTCAAAAAAAAA"
"chr17","6289040","6289368","JH378152","15932639","15932952","57","9643599","GGCTGGGCGTGGTGGCTCACGCCTGTAATCCCAGCACTTTGGGAGGCCAAGGTGGGTAGATCACCTGAGGTCAGGAGTTTGAGACCAGCCTGGCCAATGTGATGAAACCCTGTATCCACTAAAAAAAAAAAAAAAAAAAAAAAAAAAAATAGCTGGGTGAAGTGGCAAGCACCTGTAATCCCAGCTACTTGGGAGGCTGAGGCAGGAGAATCCCAGGAGGTGGAGATTGATCCCAGGAGGTGGAGGTTGCAGTGAGTCAAGATCATGCCATTGCACTCCAGCCTGGGTGACAAGAGCAAAATTCCATCTCAAAAAAAAAAAAAAGAAAA","GGCCGGGCATGGTGGCTCAAGCCTGTAATCCCAGCACTTTGGGAGGCCGAGGCGGGTGGATCACGAGGTCAAGAGATTGAGACCATCCTGGTCAACATGGTGAAACCCCGTCTCTACTAAAAATACAAAAAAAAAAAAAAAAAAAATAGCTGGGTGTGGTGGCGTGTGCCTGTAATCCCAGCTACTCAGGAGGCTGAGGCAGGAGAATTGCCTGAACCCGGGAGGCGGAGGTTGCGGTGAGCCGAGATCGCGCCATTGCACTCCAGCCTGGGTAACAAGAGCGAAACTCCGTCTCAAAAACAAAAAAAACAAAA"
"chr17","7490664","7491294","JH378118","18053084","18053501","283","10562420","GGCCGGGAGCGGTGGTTCACTCCTGTAATCCCAGCACTTTGGCAGACCGAGGAGGGTGGATCAACTGAGGTCAGAACTTCAAGACCAGCCTGCCGGGCACAGTGGCTCACACCTGTAATCCCAGCACTTTGGGAGGCTGAGGCAGGTGGATCACCCGAGGTCGGGAGTTCAAGACCAGCCTGACCAACGTGGAGAAACCCCGTCTCTACTAAAAATACAAAATTAGCTGGGGTGGTGGCACGTACCTGTAATCCCAGCTACTCGGGAGGCTGAGGCAAGAGAATCGCTTGAACCCGGGAGGCGGAGGTTGCGGTGCGCCGAGATCGCGCCATTACACTCCAGCCTGGGCAAAAAGAGCGAAACTCTGTCTCAAAAAATAAAAAAAGAAAAAGAAAAAGAAAAAGAAGTTCAAGACCAGCCTGGTCAACGTGGTGAAACCCCGTCTCTACTAAAAACACAAAAAAAATTAGGCGGGTGTTGTGGTGGGTGCCTGTAATCCCAGCTACTCAGGAGGCCAAGGCAGGAGAATCACCTGAACCCTGGAGGTGGAGGTTGCAGTGAGTCGAGATCGCACCATTGCACTCCAGCGTGGGTGACAGAGAGCGAGACTCCGTCTCAAAAAAAAAGAAAA","GGCTGGGCGCAGTGGCTCACACCTGTAATCCCAGCACTTAGGGAAGCTGAGGCGAGTAGATCACCTGAGGTCAGGAGTTAGAGACCAGCCTGGCCATCATGGTGAAACCCCGTCTCTACTAAAGATACCAAAAATTAGCTGAGTGTGGTGCTGGGTGCCTGTAATCCCAGAAACTCAGGGTGCCTGTAATCCCAGCAACTCAGGGTGCCTTTAATCCCAGCAACTGAGGGTACCAGTAATCCCAGCAACTCAGGGTGTCTTTAATCCTAGCAACTGAGGGCACCTGTAATCCCAGCAACTCAGGAAGCTGAGACAGGAGAAGTACTTGAACCCAGAAGGCAGAGGTTGCAGTGAGCCGATATTGCACCATTGCACTCCAGTCTGGGCAACAAGAGTGAAACTCTGTCTCAAAAAAAAA"
"chr17","9634166","9634493","JH378110","12773123","12773444","45","3138957","GGCTGGGTGCGGTGGCTCACGCCTGTAATCCCAGCACTGTGGGAGGCCGAGGCAGGTGGATCACCTGAGGTCAGGAGTTTGAGACCAGCTTGGCCAACATGGTGAAACCCTGTCTGCACTAAAAATACAAAAAAAAAAAAAAAAAAAAAAAAATTAGCTGGGTGTGGTGGCGGACGCCTATAATCCCAGCTACTGGGGAGGCTAAGGCAGGAGAATCGCTTGAACCTGGGAGGTGGAGATTGCAGTGAGCCAAGATGGTGCCATTGCACTCCAGCCTGGACAACAAGAGCGAAACTCGGTTTCAAAAAAAAAAAAAAAAAAAAAAAAA","GGCTGGGCGTGGTGGCTCATGCCTATAATCCCAGCACTTGGAGAGGCCAAAGCAGGCAGATTATTTGAGGTCAGGAGTTCCAAACCAGCCTGGCCAACATGGTGAAACCCTGTATCTACTAAAAATGCAAAAAAAAAAAAAAAAAAAAAAATTAGCTGGGCGTGGTGGCAGGTGACTGTATCCCAGTACTTGGTAGGCTGAGGCAGGAGAATTGCTTGAACCTGGGAGGTGGAGGTTGCAGTGAGCTGAGATTGTGCCATTGCACTCCAGCCTGGGCAACAAGAGCAAAACTCTGTCTCAAAAAAAAAAAAAAAAAAAAAAA"
"chr17","9636859","9637187","JH378193","2430153","2430476","55","7206706","GACACGGTAGCTCACGCCTGTAATCCCAGCACTTTGGGAGGTCGAGGCGGGTGGATCACCTGAGGTCAGGAGTTTAAGACCAGCCTGGCCAACATGGTGAAACCCCGTCTCTGCTAAAAATACAAGAATTAGCCAGGCGTGGTGGTGGGCGCCTGTAATCCCAGCTACTGGGGAGGCTGAGGCAGGAGAATCACTTGAACCCAGAAGGTGGAGGTTGCAGTGAGCCAAGACCACACCACTGGACTGCAGCCTGGCGGACAAGAGCGAGACTCTGTCTCAAAAACAACAACAACAACAACAACAACAACAAAAGAAAGAAAAGAAAAGAA","GGCCGGGCACAGTGGCTCAAGCCTGTAATCCCAGCACTTTGGGAGGCCGAGGTGGGTGGATCACGAGGTCAAGAGATCGAGACCAACCTGGTCAACATGGTGAAACCCCGTCTCTACTAAAAATACAAAAATTAGCTGGGCATGGTGGTGTGTGCCTGTAATCCCAGCTACTCAGGAGGCTGAAGCAGGAGAATTGCCTGAACCCAGGAGGAGGAGGTTGCGGTGAACCAAGATCACGCCATTGCACTCCAGCCTGGGTAACAAGAGCGAAACTCTGTCTCAAAACAAAACAAAACAAAACAAAACAAAACAAACAAAAAAAAA"
"chr17","9725612","9725938","JH378224","2846632","2846964","49","6878980","GGGCGTGGTGGCTCACACCTGTAATCCCAGCACTTTGGGAGGCCGAGGTGGGCGGATTGCCTGAGGTCAGGAGTTCGAGACCAGCCTGGCCAACCCGGTGAAACCCTGTCTCTACTAAAATACAAAAAAAAAAAAAAAAAAAAAAAAAAATTTAGCTGTGTGTGGTGGTGTGCACCTGTAATCCCAGCTACTCAGAAGGCTGAGGCAGGAGAATCGCTAGAACCCGGGAGGCGGAGGTTGCAGTGAGCCGAGATCGCACCATTACGCTCCAGCTTGGGCAACAAGAGTGAAACTCCATCTCAAAAACAAAACAAAACAAAACAAAAA","GGCCAGGCAGGGTGGCTTACATCTGTAATCCCAGCACTTTGGGAGGTCAAGGCGAGTGGATCACCTGAGGTCATGAGTTCAAGACCAGCCTGGCCAACTTGGTGAAACCCTGTCTCTACTAAAAATACAAAAAAAAAAAAAAAAAAAAAAAAAAAAATTAACTGGGTGTGGTGGTGCACACCTGTAATCCCAGCTACTCAGGAGGCTGAGGCAGGAGAATCCCTTGAACACGGGAGGTGGAGGTTGCAGTGAGCCGAGATCATGCCATTGCACTCCAGCCTTGGTGAAAAGAGCAAAACTCTGTCTTAAACAAAACAAAACAAAACCAGAAAA"
"chr17","11904179","11904388","JH378115","24252957","24253162","48","12348778","CCTGTCTTTACAAAAAATGCAAAAACAAAACAAAACAAAACAAAACAAAAACCGGGCATGGTGGTGAGCACCTGTAATCCCAGCTACTTGGGAGTTTGAGGCAGGAGAATCACTTGAACCTGGGAAGCGGAGGTTGCAGTGAGCCGAGACCGCGCCATTGCACTCCAGCCTGGGCAACAAGAATGAAACTCTGTCTCAAAAAAAAAAAAA","TGGTGAAACCCTGTCTTTACTAAAAATACAAAAAAAAAAAAAATTAGCTGGGCATGGTGGCACATGCCTGTAGTCCCAGCTGCTCGGGAGGCTGAGGCAGGAGAATTGCTTGAACCCAGGAGGCGGAGGTTGCAGTGAGCCGAGATCGAGCCATTGCACTCCAGCCTGGGCAACAAGAGCAAAACTCCGTCTCAAAACAAAATAAA"
"chr17","15884346","15884946","JH378118","18053084","18053501","249","2168738","GCCAGGCAGGTGGCTCAGGACTGTAATCCCAGCCTTTTGGGAGGCTGAGGCGAGTGGATCACCTGAGGTCAGGAGTTCGACACCAGCCTGGTCAACATGGTGAAACCCCGTCTCTACTAAAAAATACAAAAAATTGGCCAGGCGCAGTGTCTCACGCCTGTAATCCCAGCACTTTAGGAGGCTGAGGCAGGTGGATCACTTGGTCAGGAGATCGAGACCATCCTGGCCAACATGGTGAAACCCTGTCTCTATCAAAAATACAAAAATTAGCTGGGCGTGGTGGCATATGCCTATAATCCCAGCTACTTGGGACGCTGAGGCAGGAGAATCACTTGAACCAGGGAGTCAGAAGTTGCAGTGAGCCGAGATTGCGCCACTGCACCCCAGCCTGGTGACAGAGTGAGACTGTCTTAAAAAACAAAAAACAAAAAATTAGCCAGGTATGGTACCAGGTGCCTGTAACCCCAGCTACTTGGGAGGCTGAGGCAGGAGTATCGCTTGAACCCTGGAGGTGGAGGATGCAGTGAGCTGAGAGCACGCCATTGTACTCCAGCCTGGGCAACAAGAGTGAAACTCCATCTAAAATAAATAAAAATAAAAA","GGCTGGGCGCAGTGGCTCACACCTGTAATCCCAGCACTTAGGGAAGCTGAGGCGAGTAGATCACCTGAGGTCAGGAGTTAGAGACCAGCCTGGCCATCATGGTGAAACCCCGTCTCTACTAAAGATACCAAAAATTAGCTGAGTGTGGTGCTGGGTGCCTGTAATCCCAGAAACTCAGGGTGCCTGTAATCCCAGCAACTCAGGGTGCCTTTAATCCCAGCAACTGAGGGTACCAGTAATCCCAGCAACTCAGGGTGTCTTTAATCCTAGCAACTGAGGGCACCTGTAATCCCAGCAACTCAGGAAGCTGAGACAGGAGAAGTACTTGAACCCAGAAGGCAGAGGTTGCAGTGAGCCGATATTGCACCATTGCACTCCAGTCTGGGCAACAAGAGTGAAACTCTGTCTCAAAAAAAAA"
"chr17","16331846","16332458","JH378118","18053084","18053501","252","1721238","GGCCATGTGTGGTGGTTCACACCTGTAATCTCAGAACTTTGGGAGGCCGAGGTGGGTGGATCACCTGAGGTCAGGAGTTCGAGACCAGCCTGGCCAACATGGTGAAACCTCATCTCTACTAAAAATACAAAAAATTAAGGCCATACCCAGAGACTCATGCCTGTAATCCCAGCACTTTGGGAGGCTGAGGCGGATGGATCACTTGAGGTCAGGAGTTCAAAACCAGCCTGGCCAACATGGTGAAACCCCATCTCTACTAAAAATATAAAAATTAGCCGGGTGTGATGGCAGGCACCTGTAATCCCAGCTACTTGGGAGGCTGAGGCAGGAGAATTGCTTGAACCCAGGAAGCAGAGGTTGTGGTGAGCCGAGGTCGCGCCATTGCACTCCAGCCTGGGCAACAGAATGAGACTGTCTCAAAAAAAAAAAAAAAAAAAAATCAGCCAGGAGTGGTGGCGGGGGCACCTGTAATCCCAGCTACTCGGGAGGCTGAGGCAGGAGAATCGCTTGAACTCAGGAGGCAGAGGTTGCAGTGAGCTGATATCTCGCCATTGCACTCCAGCCTGGGCAACAAGAGTGAAACTGTCTCAAAAAAAAAAAAAAAAAAAAAGAA","GGCTGGGCGCAGTGGCTCACACCTGTAATCCCAGCACTTAGGGAAGCTGAGGCGAGTAGATCACCTGAGGTCAGGAGTTAGAGACCAGCCTGGCCATCATGGTGAAACCCCGTCTCTACTAAAGATACCAAAAATTAGCTGAGTGTGGTGCTGGGTGCCTGTAATCCCAGAAACTCAGGGTGCCTGTAATCCCAGCAACTCAGGGTGCCTTTAATCCCAGCAACTGAGGGTACCAGTAATCCCAGCAACTCAGGGTGTCTTTAATCCTAGCAACTGAGGGCACCTGTAATCCCAGCAACTCAGGAAGCTGAGACAGGAGAAGTACTTGAACCCAGAAGGCAGAGGTTGCAGTGAGCCGATATTGCACCATTGCACTCCAGTCTGGGCAACAAGAGTGAAACTCTGTCTCAAAAAAAAA"
"chr17","16464101","16464461","JH378293","1845184","1845523","61","14618917","GGCCGGGCGCCGTGGCTCACGCCTATAATCCCAGCACTTTGGGAGGCCGAGGCGGGTGGATCACCTGAGGTCAGGAGTTCGAGACCAGCCTGACCAACATGGTGAAACCCCCGTCTCTGCTAAAAAAAAAAAAATATATATATATATATATATAATATATAATATATATATATATATATATATAAAATAGCTGGGCATGGTGGCAGGCACCTGTAATCCCAGCTACTCAGGAGGCTGAGGCAGGAGAATCGCTTGAACCTGGGAGGTGGAGGTTGCAGTGGGCTAAGATCACACCATCGCACTCCAGCCTGGGCGACAGGAATGAAACGCTGTCTCAAAAAAAAAAAAAAAAAAAAAAAAA","GGCCGGGTGCGGTGGCTCACGCCTGTAATCCCAGCACTTTGGGAGGCCAAGGCGGGTGGATCACCTGAGGTCAGAAGTTCGAGACCAGCCTGGCCAACATGGTGAAACCCCGTCTCTGCTAAAAAGAAAAAAATAAGAAAAAAACAAAATAAGAAAATAATTTTAAAAAATACAAAATTAGCTGGGCGTGGTGGCAGGCACCTGTAATTCCAGCTATTCAGGAGGCTGAGGCAGGGGAATCACTTGAACCCAGGAGGCAGAGGTTGCAGTGAGCCAAGATGACGCCATTGCACACCAGCCTGGGCAACAAGAGTGAAACTCCGTCTCAAAAAAAAAACAA"
"chr17","16469420","16470033","JH378118","18053084","18053501","254","1583664","GCCAGGGGTGGTGGCTCATGCCTGTAATCCCAGCACTTTGGGAGGCTGAGGCGGGCAGATTGCCTGAGGTCAGGAATTCAAGACCAGCCTGGCCAACATAGTGAAACCCTGTCTCTACTAAAAATGCAAAGAATTAGCTGGGTGTTGGCCGGGCACGGTGGCTGACACCTGTAATCCCAGCACTTTGGGAGGCCTAGGCAGGCGGATCACCTGAGGTTGGGAGTTCGAGACCAGCCTGACCAACATGGAGAAACCCCGTCTCTACTGAAAATAAAAAACTAGCCAGGCATGGTGGCCCATGCCTGTAATCCCAGCTAATTGGGAGGCTGAGGCAGGAGAATCGCTTGAACCCAGGAGGCAGAGGTTGCGGTGAACCAAGATCGCATCAATGCACTCCAGCCTAGGCGACAAGAGCAAAACTCCGTCTCAAAAAAAAGAATTAGCTGGGTGTGGTGGGTGGGAACCTGTAATCCCAGTTACTAGGGAGGCTGAGGCAGGAGAATTGCTTGAACCCAGGAGGCGGAGGTTGTGGTGAGCCGAGATCGCGCCATTGCACTCCAGCCTGGACAACAAGAGCGAATCTCCGTCTCAAAAAAAAAAAAAAAAAAAAAAAA","GGCTGGGCGCAGTGGCTCACACCTGTAATCCCAGCACTTAGGGAAGCTGAGGCGAGTAGATCACCTGAGGTCAGGAGTTAGAGACCAGCCTGGCCATCATGGTGAAACCCCGTCTCTACTAAAGATACCAAAAATTAGCTGAGTGTGGTGCTGGGTGCCTGTAATCCCAGAAACTCAGGGTGCCTGTAATCCCAGCAACTCAGGGTGCCTTTAATCCCAGCAACTGAGGGTACCAGTAATCCCAGCAACTCAGGGTGTCTTTAATCCTAGCAACTGAGGGCACCTGTAATCCCAGCAACTCAGGAAGCTGAGACAGGAGAAGTACTTGAACCCAGAAGGCAGAGGTTGCAGTGAGCCGATATTGCACCATTGCACTCCAGTCTGGGCAACAAGAGTGAAACTCTGTCTCAAAAAAAAA"
"chr17","17534259","17534875","JH378118","18053084","18053501","268","518825","GGCTGGGGCGGTGGCTCACCTGTAATCCCAGCACTTTGGGAGGCAGAGGTGGGCGGATCGCCTGAGGTCAGAAGTTGGAGACCAGCCTGGCAACATGGTGAAACCCTGTCTCTACTAAAAAAAAAAAAAAAAAAAAAAAATGGCCGGGCATGGTGGCTCAAGCCTGTAATCCTAGCACTTTGGAAGGCTGAGGCGGGTGGATCACAAGGTCAGGAAATCGAGACCATCCTGGCTAACATGGTGAAACTCCGTCTCTACTAAAAATACAAAAAAAATTAGCCGGGCGTGGTGGTGGGTGCCTGTAGTCCCAGCTACTCGGGAGGCTGAGGCAGGCAAATGGAGTGAACCCGGGAGGCAAACTTGCAGTGAGCCAAGATGGCGCCATTGCACTCCAGCCTGGGCAACAAGAGCAAGACTCCTTCTCAAAAAAAAAAAAAATATATATATATATATATAGTCGGGCATGGTGGCAGGCACCTGTAATCCCAGCTACTCAGAGGCTGAGGCAGGAGAATCGCTTGAACCCTGGAGGTGGAGGTTGCAGTGAGCCAAGGTCATGCCATTGCACTCCAGCCTGGGCAACAAGAGCAAGACTCCGTCTCAAAAAAAAAAAAAAA","GGCTGGGCGCAGTGGCTCACACCTGTAATCCCAGCACTTAGGGAAGCTGAGGCGAGTAGATCACCTGAGGTCAGGAGTTAGAGACCAGCCTGGCCATCATGGTGAAACCCCGTCTCTACTAAAGATACCAAAAATTAGCTGAGTGTGGTGCTGGGTGCCTGTAATCCCAGAAACTCAGGGTGCCTGTAATCCCAGCAACTCAGGGTGCCTTTAATCCCAGCAACTGAGGGTACCAGTAATCCCAGCAACTCAGGGTGTCTTTAATCCTAGCAACTGAGGGCACCTGTAATCCCAGCAACTCAGGAAGCTGAGACAGGAGAAGTACTTGAACCCAGAAGGCAGAGGTTGCAGTGAGCCGATATTGCACCATTGCACTCCAGTCTGGGCAACAAGAGTGAAACTCTGTCTCAAAAAAAAA"
"chr17","17916069","17916669","JH378118","18053084","18053501","243","137015","GCCGGGTACAGTGGCTCACACCTGTAATCCTAGCACTTTGGGAGGCCGAGGCGGGTGGATCACCTGAGGTCAGGAGTTCGAGACCAGCCTGGCCAACATGATGAAACCCTACCTCAGCCAGGTACGGTGGTTCACGCCTGTAATCCTAGCACTTTGGGAGGCTGAGGCAGGTGGATTGCCTGAACTCAGGAGTTTGAGACCAGCCTGGGCAGCATGGTGAAACCCCATCTGTACTAAAATACAAAAACTTTGCTGGGCGTGGCGGCATGCACATGTAGTCCCAGTTACTTGGGAGGCTGAGGCAGGATAATTGTTTGAACCTGGGAGGCGGAGGTTGTACAGTGAGCCAAGATCGCGCCACTACACTCTAGCGTAGGTGACAGAGCGAGATTCCGCCTCCAAAAAAAAAAGAAACCCTGTCTCTACTAAAAATACAAACAATTAGCTGGGCGTGGTGGTGGGCGCCTGTAATCCCAGCTACTTAGGAGGCTGAAGCAGGAGAATCGCTTGAGCCCAGGAAGTGGAGGTTGCAGTGAGCTGAGATTGCTCCATTGCACTCTAGCCTGGGCAACAAGAGTGAAACTCTGTCTCAAAAAAAGAA","GGCTGGGCGCAGTGGCTCACACCTGTAATCCCAGCACTTAGGGAAGCTGAGGCGAGTAGATCACCTGAGGTCAGGAGTTAGAGACCAGCCTGGCCATCATGGTGAAACCCCGTCTCTACTAAAGATACCAAAAATTAGCTGAGTGTGGTGCTGGGTGCCTGTAATCCCAGAAACTCAGGGTGCCTGTAATCCCAGCAACTCAGGGTGCCTTTAATCCCAGCAACTGAGGGTACCAGTAATCCCAGCAACTCAGGGTGTCTTTAATCCTAGCAACTGAGGGCACCTGTAATCCCAGCAACTCAGGAAGCTGAGACAGGAGAAGTACTTGAACCCAGAAGGCAGAGGTTGCAGTGAGCCGATATTGCACCATTGCACTCCAGTCTGGGCAACAAGAGTGAAACTCTGTCTCAAAAAAAAA"
"chr17","18237318","18237912","JH378118","18053084","18053501","239","184234","GGCCATGCGTGGTGGCTCACGCCTGTAATCCCAGTACTTTGGGAGGCTGAGGTGGGAGGATCACCTGAGGTCAGGAGTTCGAGACCAGCCTGGCCAACATGATGAAACCCTGTCTCTACTAAAAATGCAAAAAATTGGCCGGGCACGGTGGCTCACGCCTGTAATCCCAGCACTTTGGGAGGCCAAGGCGGGTGGATCACAAGGTCAGGAGCTTGAGACCAGCCTGGCCAATATGGTGAAACCCCATCTCTACTAAAAATACAAAAATTAGCCAGGCGTGGTGGTACACACCTGTAGTCCCAGCTACTCGGGAGGCTGAGGCAGGAGAATTGCTTGAACTCAGGAGGCAGAGGTTGCAGTGAGCTGAGATGGTGCCACTGCACTGCAGCCTGGGCAACAGAGTGAGACTTCATCTCAAAAAAAAAAAAAAAATTAACCGGGTGTGGTGGCACGTGCCTATGGTCCCAGCCACTGGGGAGGCTGAGGCAGGAGAATCGCTTGAACACAGGAGGCAGAAGTTGCAGTGAGCTGAGATTGCACCACTGCACTCCAGCCTGGGTGACAAGAGTGGAACTCCATCTCAAAAAAAAAAGAA","GGCTGGGCGCAGTGGCTCACACCTGTAATCCCAGCACTTAGGGAAGCTGAGGCGAGTAGATCACCTGAGGTCAGGAGTTAGAGACCAGCCTGGCCATCATGGTGAAACCCCGTCTCTACTAAAGATACCAAAAATTAGCTGAGTGTGGTGCTGGGTGCCTGTAATCCCAGAAACTCAGGGTGCCTGTAATCCCAGCAACTCAGGGTGCCTTTAATCCCAGCAACTGAGGGTACCAGTAATCCCAGCAACTCAGGGTGTCTTTAATCCTAGCAACTGAGGGCACCTGTAATCCCAGCAACTCAGGAAGCTGAGACAGGAGAAGTACTTGAACCCAGAAGGCAGAGGTTGCAGTGAGCCGATATTGCACCATTGCACTCCAGTCTGGGCAACAAGAGTGAAACTCTGTCTCAAAAAAAAA"
"chr17","18951167","18952093","JH378118","18053084","18053501","537","898083","GGCCAGGGGCAGTGGCTCATGCCTGTAATCCCAGCATTTTGGGATGCCAAGGCTGGTGGATCAACTGAGGTCAGGAGTTTCAGACCACCCTGGCCAACATGGCGAAATCCCATCTCTACTAAAAATACAAAAATTAGGCCAGGCACAGTGGCTCATGCCTGTAATCCCAGCACTTTGAGAGGCCAAGGCGGGCGATCACGAGGTCAGGAGATTGAGACCATCCTGGCTAACACGGTGAAATCCTGTCTCTACTAAAAAAAAAAAATACAAAAAATTAGCCGGGACGTGGTGGCTGGCACCTGTAGTCCCAGCTACTCGGGAGGCTAAGGCAGGAGAATGGCATGAACCCGGGAGATGGAGCTTGCAGTGACCCGAGATCGCGTCACTGCACTCCAGCCTGAACAACAGAGCAAGACTATATCTCAAAAAAAAAAAAAAAAAAAAGGCCGGGTGCAGTGGCTCACGTCTGTAATCCCAGCACTTTGGGAGGCCGAGGTGGGTGGATCACGAGGTCAGGAGATCGAGACCATCCTGGCTAACATGATGAAACCCCATCTCTACTAAAAAATACAAAAAATTAGCCGGGTGTGGTGGCAGGCACCTGTAGTCCCAGCTACTCGGGAGGCTGAGGCAGGAGAATGGCATGAACCTGGGTAGTGGAACTTGCAGTGAGCCGAGATCACGCCACTGCACTCCAGCCTGGGCGACAGAGCGAGACTCTGTCTCAAAAAAAAAAAAAAAAAAAAAATTAGCCGGGCATGGTGGTGGGTGCCTGCAATCCCAGCTAGTCAGGAGGCTGAGGCTGGAGAATCCCTTGAACCCAGGAGGTAGAGGTTGCAGTGAGCCAAGATCACGCCATTGCATTCCAGCCTGGGCAACAAGAGTGAAATTCTGTCTCAAAAAAATAAACAAACAAGTAAAATAAAA","GGCTGGGCGCAGTGGCTCACACCTGTAATCCCAGCACTTAGGGAAGCTGAGGCGAGTAGATCACCTGAGGTCAGGAGTTAGAGACCAGCCTGGCCATCATGGTGAAACCCCGTCTCTACTAAAGATACCAAAAATTAGCTGAGTGTGGTGCTGGGTGCCTGTAATCCCAGAAACTCAGGGTGCCTGTAATCCCAGCAACTCAGGGTGCCTTTAATCCCAGCAACTGAGGGTACCAGTAATCCCAGCAACTCAGGGTGTCTTTAATCCTAGCAACTGAGGGCACCTGTAATCCCAGCAACTCAGGAAGCTGAGACAGGAGAAGTACTTGAACCCAGAAGGCAGAGGTTGCAGTGAGCCGATATTGCACCATTGCACTCCAGTCTGGGCAACAAGAGTGAAACTCTGTCTCAAAAAAAAA"
"chr17","20996420","20997041","JH378118","18053084","18053501","266","2943336","GGCTAGGCGCGGTGGTTCACACCTGTAATCCCAGCACTTTGGGAGGCCAAGGTGGGTGGATCACCTGTGGTCAGGAGTTCGAGACCAGCCTGGCCAACATTGTGAAACCCCGTCTCTACTAAAAATGCAAAAAATTAGCTGGGCGACCAGTCATGGTAGCTCACGCCTGTAATCCTAGCACTTTGGGAGGCCAAGGCGGGTGGATTGCCTGAGCTCAGGAGTTAGAGGCCAGCCTGGGCAACATGGTAAAACCCTGTCTCTACTAAAATACAAAAAAAAAAAAAAAAATTAGCTGGGTGTGACAGCGTGCATCTGTAATCCCGGTTACTTGGGAGGTTGAGGCAGGAGAATTCCTTGAACCTAGGAGGCGGAGGTTACAGTTAGCCGAGATCACGCCATTGCACTCCAGCCTGGGCAACAGAGCGAGACTCCATCTCAAAAAAAAAAAAAAAAATTCAGCTGGGCGTGGTGGCGGGCACCTGTGATCCTAGCTACTCAGGAGGCTGAGGCAGGAGAATCATTTGAACTCCGGAGGCGGAGGTTGCAGTGACCCTAGATCGCACCATTGTGTTCCAGCCTGAGCAACAAGAGCGAGACGCCATCTGAAAAAAAAAAAAAGAAA","GGCTGGGCGCAGTGGCTCACACCTGTAATCCCAGCACTTAGGGAAGCTGAGGCGAGTAGATCACCTGAGGTCAGGAGTTAGAGACCAGCCTGGCCATCATGGTGAAACCCCGTCTCTACTAAAGATACCAAAAATTAGCTGAGTGTGGTGCTGGGTGCCTGTAATCCCAGAAACTCAGGGTGCCTGTAATCCCAGCAACTCAGGGTGCCTTTAATCCCAGCAACTGAGGGTACCAGTAATCCCAGCAACTCAGGGTGTCTTTAATCCTAGCAACTGAGGGCACCTGTAATCCCAGCAACTCAGGAAGCTGAGACAGGAGAAGTACTTGAACCCAGAAGGCAGAGGTTGCAGTGAGCCGATATTGCACCATTGCACTCCAGTCTGGGCAACAAGAGTGAAACTCTGTCTCAAAAAAAAA"
"chr17","21298865","21299429","JH378206","6546474","6546861","222","14752391","GGCCGAGGCAGGTGGATCACCTGAGGTCAGGAGTTCAAGACTAGTCTGGCCAACATGGTGAAACCCTGTCTCTACTAAAAATACAAAAAATTGGCCGGGCGCGGTGGCTCATGCCTGTAATCCCAGCACTTTGGGAGGCTGAGGCGGGTGGATCACGAGGTCGGGAGATCGAGACCATCCTGGCTAACACAGTTAAACCCTTTCTCTACTAAAAAATACAAAAAATTAGCCGGGCGTAGTGGGGGGCGCCTGTAGTCCCAGCTACTCAGGAGGCTGAGGCAGGAGACTGGCGTGAACCCGGGAGGCAGAGCTTGCAGTGAGCTGAGATCACGTCACTGCATGCCAGCCTGGGCGACAGAGCGAGACTCTGTCTCAAAAAAAAAAAATTAGCCAGGCATGGTGGTGTACACCTGTAATCCTAGCTACTCGGGAAGCTGAGCAGGAGAACAGCTTGAACCCAGGAGGCAGAGGTTGCAGTGAGCTGAGATCACGCCATTGCACTCCAGCCTGGGCAACAAGAGTGAAACTCCGTCTCAAAAAAAAAAAAAGAAAAGAAAAAAGAAAA","GGCCACACATGGTGGCTAACGCCTGTAATCCCAGCACTTTGGGAGGCCAAGTCGGGTGGATCATGAGGTCAGGAGACCAAGACCATCCTGGCCAAATGGTGAAACCCCGTCTCTACTAAAAATACAAAAATTAGCTGGGCATGGTGGCGTGTGCCTGTAATCCCAGCTACTCAGGAGGCTGAGGCAGGACAATTGCCTGAACCCAGGAGAATTAGCTGGGCATGGTGGCGTGTGCCTGTAATCCCAGCTACTCAGGAGGCTGAGGCAGGACAATTGCCTGAACCCAGGAGGCGAAGGTTGCGGTGAGCCGAGATTGTGCCATTGCACTCCAGCCTGGGTAACAAGAGCGACACTCTGTCTCAAAAAAAAAAAAAAAAAAAAAAAAAAA"
"chr17","21663027","21663921","JH378118","18053084","18053501","517","3609943","TTGGGAGGCCAAGGTGGGCCTCCCAGACACGTGAGGTCAGGAGTTTGAGACCAGCCTGGACAATATGGCGAAACCCCATCTCTACTAAAAAAACACAAAAATTGGTTGGGCCGGGCACGGTGGCTCACGCCTGTAATCCCAGCACTTTGGGAGGCCGAAGTGGGCAGATCACGAGGTCAGGAGATCGAGATCATCTTGGCTAACATGGTGAAACTCCGTCTTTACTTAAAATACAAAAAATTAGCTGGGCATGATGGCAGGCAGTTGGAGTCCCAGCTACTTGGGAGGCTGAGGCAGGAGAATCGCTTGAACCCGGGAGGCAGAGGTTGCAGTGAGCTGAGATCGTGCCATTGCACTCCAGCCTGGGTGACAGAATGAGACTCCGTCTGAAAAAAAAACAAAAAACAAAAAACAAAAATTGGCCAGGTGCGGTGGCTCACGCCTGTAATCCCAGAACTTTGGGAGGCCGAGGCAGGTGGATCATGAGGTCAGGAGTTCAAGACCAGCCTGGCCAAGATGGTGAAACCCCATCTCTACTAAAAATACAAAAATTAGGCGGGCACGGTGGCAGGTGCCTGTAATCTCAGCTACTCAGGAGGCTGAGGCAGGAGAATTGCCTGAAGCCGGGTGGCAGAGGTTGCAGAGAGCTAAGATCACGCCACTGCACTCCAGCCTGGGTGATAGAGTAAGACTCTATCTCAAAAAAAGAAAAAAAAAAATAGCCGGGCATTGTGCTGGGCGCCTGTAATCCCAGCTACTTGGGAGGCTGAGACAAGAGAATCACTTGAACCTGGGAGGCGGAGGTTGCAGTGAGCCGAGATCGTGCCATTGCACTCCAGCCTGGGTGAGAAGAGCAAAACTCTGTCTCAAAAAAACAAAAAAAGAAGAAAACAAA","GGCTGGGCGCAGTGGCTCACACCTGTAATCCCAGCACTTAGGGAAGCTGAGGCGAGTAGATCACCTGAGGTCAGGAGTTAGAGACCAGCCTGGCCATCATGGTGAAACCCCGTCTCTACTAAAGATACCAAAAATTAGCTGAGTGTGGTGCTGGGTGCCTGTAATCCCAGAAACTCAGGGTGCCTGTAATCCCAGCAACTCAGGGTGCCTTTAATCCCAGCAACTGAGGGTACCAGTAATCCCAGCAACTCAGGGTGTCTTTAATCCTAGCAACTGAGGGCACCTGTAATCCCAGCAACTCAGGAAGCTGAGACAGGAGAAGTACTTGAACCCAGAAGGCAGAGGTTGCAGTGAGCCGATATTGCACCATTGCACTCCAGTCTGGGCAACAAGAGTGAAACTCTGTCTCAAAAAAAAA"
"chr17","21688652","21689276","JH378118","18053084","18053501","258","3635568","GGCCGGGTGCCATGGCTCACGCCTATAATCCCAGCACTTTGGGAGGCCAAGGTGGGCGGATCACCTGAGGTCAGGAGTTTGAGACCAGCCTGGCCAACATAGTGAAACCCCGTCTCTACTAAAAATACGAAAAGTTAGCTGGGGGTGCAGTGGCTCACACCTGTAATTCCAGCACTTTGGGAGGCCGAGGCAGGTGAATCACGAGGGGAGGAGTTTGAGACCAGCCTAACCAATATGTTGAAACCCCGTTTCTACTAAAAATACAAAAATTAGCTGGGCGTGGTGGCACGTGCCTATAATCCCAGCTACTCAGGAGGCTGAGGCAGGAGAATCGCCTGAACCTGGGAGGCGGAGGTGGCAGTGAGCCAAGATCACACCACTGCACTTTAGCCTGGGTGACAGAGGGAGACTCTGTCTCAAAAAACAAAACAAAACAAAACAAAAAATTAGGCAGGCTTGGTGGCACATGCCTGTAATCCCAGCTACTCAGGAGGCTGAGGCAGGAGAATTGCTTGAACCCAGGAGGCAGAAGTTGCAGTGAGCTGAGATCGCGCCATTGCACTCCAGCCTGGGTAACAAGAGTGAAACTCCATCTCAAAAAAAAAAAAAAAAAAAAAAAAAAAAA","GGCTGGGCGCAGTGGCTCACACCTGTAATCCCAGCACTTAGGGAAGCTGAGGCGAGTAGATCACCTGAGGTCAGGAGTTAGAGACCAGCCTGGCCATCATGGTGAAACCCCGTCTCTACTAAAGATACCAAAAATTAGCTGAGTGTGGTGCTGGGTGCCTGTAATCCCAGAAACTCAGGGTGCCTGTAATCCCAGCAACTCAGGGTGCCTTTAATCCCAGCAACTGAGGGTACCAGTAATCCCAGCAACTCAGGGTGTCTTTAATCCTAGCAACTGAGGGCACCTGTAATCCCAGCAACTCAGGAAGCTGAGACAGGAGAAGTACTTGAACCCAGAAGGCAGAGGTTGCAGTGAGCCGATATTGCACCATTGCACTCCAGTCTGGGCAACAAGAGTGAAACTCTGTCTCAAAAAAAAA"
"chr17","22129020","22129352","JH378128","1602813","1603145","53","20526207","GCCAGGCACGGTGGCTCACACCTGAATTCCAGTACTTTGGGAGGCCGAGGCGGGCGGATCTCTTGAGGTCAGGAGTTTGAGACCAGCCTGGCCAACATGGTGAAACCCCATCTCTACTAAAAATACAAAAATTAGCCGGGCGTGGTGGCAGGTGCCTGTAATCCCAGCTACTTGGGAGGCTGAGGCAGGAGAACCTCTTGAACCCAGGAGGTGGAGGCTGCAGTGAGCTGAGATTGTGCCACTTCACTCCAGCCTGGAAGACAAGAGCAAGACTTCATCTCAAAAAAAAATAAAAAAAAAATAAATAAATAAATAAATAAAAATTTAAAAAAA","GGCCAGGTGCAGTGGCTCACGCCTGTAATACCAGCATTTTGGGAGGCCGAGGCAGGTGGATCACGAGGTTAGGAGTTTGAGACCAGCATGGCCAACATGGAGAAACCCCGTCTCTACTAAAAATACAAAAATTAACCAGGCATGGTGGCAGGTGCCTGTAATTCCATCTACTCGGGAGGCTGAGGCAGGAGAATCCCTTGAACCTGGGAGGCGGAGGTTGCAGTGAGCCGAGATTGTGCCATTGCACTCAGTCTGGGTGACAAAAACAAGACTCCATCTCAAAAAAAAAAAAAAGAAAAGAAAAAGAAAAAAAGAAAGAAAGAAAGAAAGAAA"
"chr17","22130129","22130738","JH378118","18053084","18053501","262","4077045","GGCTGGGCACAGTGGCTCACGCCTGTAATCTCAGCACTTCGGGAAGCCGAGGCGGGCAGATCAGCTGAGGTCAGGAGTTCAAGACCAGCCTGGCCATGGCAAAACCCTGTCTCTACTAAAAAATGCAAAAAATAGGGGCCAGGCACGGTGGCTCACGCCTGTAATCCCAGCATTTTGGGAGGCCAAGGCAGGCGGATCACAAGGTCAGGAGGTTGAGACCATCCTGGCCAACATGGTGAAACCCCATCTCTACTAAAAATACAAAAATTAGCTGGGTGTGGTGGCCTGTGCCTGTAATCCCAGCTACTTGGGAGGCTGAGGCAGGGGAATCACTTGAATCCAGGAGACAGAGGTTGTAGTGAGCTGAAATGGAGCCACTGCACTCCAGCCTGGCGGCAGAGCGAGACTCTGTCTCAAAAAAAAAAAAAATACAAAAAATAGCTAGGTGTGATGGTGGGCACCTGTAATCCCAGCTACTTGGGTAGCCGAAGCAGGAGAATCGCTAGAACCTGGGAGGTGGAGGTTTAGTAAGCTGAGATCACACCATTGCACTCCAGCCTGGGTATCAACAGCGAAACTCCATCTCAAAAAAAAAAAAAAAAAAAGAAAA","GGCTGGGCGCAGTGGCTCACACCTGTAATCCCAGCACTTAGGGAAGCTGAGGCGAGTAGATCACCTGAGGTCAGGAGTTAGAGACCAGCCTGGCCATCATGGTGAAACCCCGTCTCTACTAAAGATACCAAAAATTAGCTGAGTGTGGTGCTGGGTGCCTGTAATCCCAGAAACTCAGGGTGCCTGTAATCCCAGCAACTCAGGGTGCCTTTAATCCCAGCAACTGAGGGTACCAGTAATCCCAGCAACTCAGGGTGTCTTTAATCCTAGCAACTGAGGGCACCTGTAATCCCAGCAACTCAGGAAGCTGAGACAGGAGAAGTACTTGAACCCAGAAGGCAGAGGTTGCAGTGAGCCGATATTGCACCATTGCACTCCAGTCTGGGCAACAAGAGTGAAACTCTGTCTCAAAAAAAAA"
"chr17","23633062","23633662","JH378118","18053084","18053501","247","5579978","GGCCAGGCGTGGTGGCTTACGCCTGTAATCCCAGCATTTTGGGAAGCTGAGGCAGGTGGATCACCTGAGGTCAAGAGTTCAAGACCAGCCTGGCCAACATGGTGAAACCCCGTCTCTACTGCAAATACAAAAAATTAGTAGCCGGGCATGGTGGCTCACGCCTGTAATCCCAACACTTTGGTAGGCCAAGGCGGGTGGATCACCTGAGGTCGGGAGTTCGAGACCAGCCTGACCAACATGGAGAAACCCCGTCTCTACTAAAAGTACAAAATTAGCCAGGGATGGTGGCATGTGCCTGTAATCCCAGCTATTTGGGAAGCTAAGGCACAAGAATCGCTTTGAACCTGGGAGACAGAGGTTGCAGTGAGCTGAGATCGCACCATTGCACTCCCGCCTGGGCAACAAGAGCGAAACTCCATCTAAAAAAAAAAAAAAAAAAAAAAAAGCCAGGCATGGTGACAGGCACCTTGTAATCCCAGCTACTCGGAAGGCTGAGGCAGGAGAATCGCTTGAACACTGCAGAGGTTGCAGTGAGCTGAGATCACGCCATTGCACTGCAGCCTAGGCAACAAGAGTGAGACTCTATCTCAAAAAAAAGAAA","GGCTGGGCGCAGTGGCTCACACCTGTAATCCCAGCACTTAGGGAAGCTGAGGCGAGTAGATCACCTGAGGTCAGGAGTTAGAGACCAGCCTGGCCATCATGGTGAAACCCCGTCTCTACTAAAGATACCAAAAATTAGCTGAGTGTGGTGCTGGGTGCCTGTAATCCCAGAAACTCAGGGTGCCTGTAATCCCAGCAACTCAGGGTGCCTTTAATCCCAGCAACTGAGGGTACCAGTAATCCCAGCAACTCAGGGTGTCTTTAATCCTAGCAACTGAGGGCACCTGTAATCCCAGCAACTCAGGAAGCTGAGACAGGAGAAGTACTTGAACCCAGAAGGCAGAGGTTGCAGTGAGCCGATATTGCACCATTGCACTCCAGTCTGGGCAACAAGAGTGAAACTCTGTCTCAAAAAAAAA"
"chr17","34071612","34072215","JH378118","18053084","18053501","250","16018528","GGCCAGGTGTGGTGCCTTACATCTGTAATTCCAGCACTTTGGGAGGCTGAGGTGGGTGGATCACCTGAGGTCAGGAGTTCAGGACCAACCTGGCCAACATAGTGAAACCCCGTCTCACTAAAAATACAAAAATTAAAAAGAAAGAAAGAAAAAAGCCAGGTGCGGTGGCTCACACCTGTAACCCCAGCACTTTGGGAGGCCAAGATGGGCGGATCACCTGAGGTCGGGAGTTTGAGACCAGCCTGACCAACATGGAGAAACCCCGTCTCTACTAAAAATACAAAATTAACCAGGCGTGGTGGTGCATGCCTGTAATCCCAGCTACTTGGGAGGATGAGGCAGGAGAATCGCTTGAACCCTGGAGGCGGAGGTTGTGGTGAGCTGAGATCATGCCATTGCACTCCAGCCTAGGCAACAAGAGCGAGACTCCATCTCAAAAAAAAAAAAAAAATTGGGCATGGTGGTGCATGCCTGTAATCCCAGCTACTCAGGAGTCTAAGGCAGGAGAATCACTTGAACCCAGGAGGCAGAGGTTGCAGTGAGCTGAGATCACGCCATTGCACTCCAGCCTGAGCGACAAGAGTGAAACTACGTCTCAAAAAAA","GGCTGGGCGCAGTGGCTCACACCTGTAATCCCAGCACTTAGGGAAGCTGAGGCGAGTAGATCACCTGAGGTCAGGAGTTAGAGACCAGCCTGGCCATCATGGTGAAACCCCGTCTCTACTAAAGATACCAAAAATTAGCTGAGTGTGGTGCTGGGTGCCTGTAATCCCAGAAACTCAGGGTGCCTGTAATCCCAGCAACTCAGGGTGCCTTTAATCCCAGCAACTGAGGGTACCAGTAATCCCAGCAACTCAGGGTGTCTTTAATCCTAGCAACTGAGGGCACCTGTAATCCCAGCAACTCAGGAAGCTGAGACAGGAGAAGTACTTGAACCCAGAAGGCAGAGGTTGCAGTGAGCCGATATTGCACCATTGCACTCCAGTCTGGGCAACAAGAGTGAAACTCTGTCTCAAAAAAAAA"
"chr17","34329459","34330029","JH378119","32351107","32351490","237","1978352","GGCCAGGTGCCGTGGCTCACACATGTAGTCCCAGCACGTTGGGAGGCTGAGGTTAATGGATCACCTGAAGTCACAAGTTCGAGACCAGCCTGACCAACATGGTGAAACCCTGTCTCTACTAAAATATAAAAAGTAGTCGGCCGGGCGCAGTTGCTCATGCCTGTGATCGCCTGAGGTCAGGATTTCAAGCCCAGCCTGGCCAAAATGGTGAAACCCCATCTCTACTAAAAATATAAAAATTAGCCAGGCATGGTGGCAGGTGCCTGTAATCCCAGCTACTCAGGAGGTTGAGGCAGGAGAATCACTTGGACCCAGGGGGCAGAGGTTGCAGTGAGCCAAGATCACAGCATCGCACTCCAGCTTAGGCAACAAGAGAGAAACTCCATCTCAAAAAAAACCCAAAAAAAACAAAAAAACAAAAAAACCCAGGCATGGTGGCAGGCGTCTGTAATCTCAGCTACTCGGGAGGCTGAGGCAAGAGAATCGCTTGAACCTGGGAGGCAGAGGTTGCAGTGAGCCAAGATCATGCCATTGCACTCCAGACTGAGCAATAAGAGCGAAACTCCATCTC","GGCCAGGTATGGTGGCTCACACCTGTAATCCCAGCACTTTGGGAGGCCAAGGCAGGCAGACCACCTGAGGTCAGGAGTTCGAGATCAGCCTAGCCAACATGGTGAAACCCCATCTCTAGTAAAAATAAAATTAGCCAGGCATGGTGGTGCATGCCTGTAACGCAGGTCAGGAGTTCGAGATCAGCTTAGCCAACATGGTGAAACCCCATCTCTAGTAAAAATAAAATTAGCCAGGCAGGTGGTGCCGCCTGTACTCGGGAGGCTGAGGCAGGAGAATCACTTGAACCCAAGAGGCAGAGGTTGCAGTCAGCCAAGATCATGCCATTGCACTCCAGCCTAAGCAAAAAGAGTAAAACTCAGTCTCAAAACAAAAAAACAAAAAAA"
"chr17","35196292","35196625","JH378228","5665092","5665424","47","29531200","GGCTGGGCATGGTGTCTTACGCCTGGAATCCCAGCACTTTGGGAGGCCAAGGCGGGTGGATCACCTGAGGTCAGGAGTTTGAGACCAGCCTGGCCAACATGTTGAAACTCTGTCTCTACTAAAAATACAAAAATTAGCCGGGCATGGTGGCGGATGCCTGTAATCCCAACTACGTGGGAGGCTGAGGCAGGAGAATCGCTTGAACCCAGGAGATGGAGGTTGTGGTGAGCCGAGATCATGCCATTGCACTCCAGCCTGGGCAACAAGAACAAAACTCTGTCTCAAAATAAATAAAAAAATAAATAAATAAATAAAAACAACAACAACAACAAAA","GGCCGGGCGCGGTGGCTCAAGCCTGTAATCCCAGCACTTTGGGAGGCTGAGGCGGGTGGATCACGAGGTCAAGAGATCGAGACCATCCTGGTCAACATGGTGAAACCCTGTCTCTACTAAAAATACTAAAAATTAGCTGGGCATGGTGGCGTGTGCCTGTAATCCCAGCTACTCAGGAGGCTGAGGCAGGAGAATTGCCTGAACCCAGGAGGCGGAGGTTGCGGTGAGCCGAGATCGCGCCATTGCACTCCAGCCTGGGCAACAAGAGCGAAACTCTGTCTCAAAAAAAAAAAATAAATAAATAAAATAAAATAAAATAAAATAAAATAAAAT"
"chr17","40291413","40291755","JH378144","13229286","13229620","52","27062127","GGCCAGGCACAGTGGCTCATGCCTGTAATCCCAGCACTTTGCGAGGCTGAGCCAGGTGGATCACCTGAGGTCAGGAGTTCAAGAGCAGCCTGGCCAACATGGTGAAACCCCGTCTCTACTAAAAATACAAAAATTATCTGGAGTGGTGGTAGGTGCCTATAATTGCAGATACACAGAAGGCTGAGACAGGAGAATTGCTTGAACCCAGGAGGCGGAGGTTGCTGTGAGCCGAGATCGCGCCATTGCACCCCAGCCTGGGAGACAAGAGCGAAACTCCATCTCAATAAATAAATACATACATACATACATACATACATGCATACATACATAAAATAAAATAAAA","GGCCGGGCGCGGTGGCTCAAGCCTGTAATCCCAGCACTTTGGGAGGCCGAGGCGGGTGGATCACCTGTGGTCAGGAGTTCAAGACAGCTTGGTCAACATGGTGAAACCCCGTCTCTACCAAAAATACAAAAAATTAGCTGGGCATGGTAGCGCATGCCTGTAATCCCAGCTACTCAGGAGGCTGAGGCAGGAGAATTGCCTGAACCCAGGAGGCAGAGGTTGCGGTGAGCCGAGATCGCGCCATTGCACTCCAGCCTGGGTAACAAGAGCGAAACTCCCTCTCATAAAAAATAAATAAATAAATAAATAAATAAATAAATAAATAAATAAATAAA"
"chr17","45148344","45148987","JH378206","6546474","6546861","299","38601870","GGCTTGGTGCCATGGTTCATGCCTGTAATCCTGGCACTTTGGGAGGCCGAGGTGGGCAGATCACTTGAGCTCAGGAGTTCAAGACCACCTTGGGCGACATGGTGAAACCTCATCTCTCCTTAAAAAAAAAAAAAACAGCCGGGCGCGGTGGCTCACACCTGTAATCCCAGCACTTTGGGAGGCCAAGGCGGGTGGGGTTCATGAGGTCAGAAGATCGAGACCATCCTGGCTAACACGGTGAAACCCCGTCTCACTAAAAATAGAAAAAACTAGCCGGGCGTGGTGGCGGGCACCTGTAGTCCCAGCTACTCGGGAGGCTGAGGCAGGAGAATGGCGTGAACCCGGGAGGCGGAGCTTGCAGTGAGCTGAGATCTTGCCATTGCACTCCAGCCTGGGCAACAAGAGTGAAACTCTGTCTCAAAAAAAAAAAATTAAAAAAACAAATAAAAATAAAAATACATAATTAGCAGGACATGGTGGCACATGCCTGTAATCCCCAGCTACTCGGGAGGCTGAGGCATGGGAATTGTTTAAACCTGTGAGGCGGTGGTTGCAGTGAGCCAAGATCAAGCCATTGCACTCCAGCCTGGGCAACAAGAGTGAAACTCCATCTCAAAAAAAAAAAAAAAAAAGAGAAAAGAAAA","GGCCACACATGGTGGCTAACGCCTGTAATCCCAGCACTTTGGGAGGCCAAGTCGGGTGGATCATGAGGTCAGGAGACCAAGACCATCCTGGCCAAATGGTGAAACCCCGTCTCTACTAAAAATACAAAAATTAGCTGGGCATGGTGGCGTGTGCCTGTAATCCCAGCTACTCAGGAGGCTGAGGCAGGACAATTGCCTGAACCCAGGAGAATTAGCTGGGCATGGTGGCGTGTGCCTGTAATCCCAGCTACTCAGGAGGCTGAGGCAGGACAATTGCCTGAACCCAGGAGGCGAAGGTTGCGGTGAGCCGAGATTGTGCCATTGCACTCCAGCCTGGGTAACAAGAGCGACACTCTGTCTCAAAAAAAAAAAAAAAAAAAAAAAAAAA"
"chr17","47866693","47867898","JH378118","18053084","18053501","809","29813609","GGCTGGGCTTGGTGGCTCATGCCTATAATTCTAGGACTTTGGGAGGCCAAGGCGGATGGATCACCTGAGGTCAAGAGTTGGAGACCAACCTGTCCAACATGGTGAAACCCCCTCTGTACTAAAAATACAAAAATTGGCCGAGCGTAGTGGCTCATGCCTGTGATCACAGCACTTTGAGAGGCTGAGGCGGGCGGATCACAAGGTCAGGAGATCAAAACCATCCTGGCTAACAAGGTGAAACCCCATCTCTGCTAAAAAATAACAGGGCGTGGTGGCACACGGCTGTAGTCCCAGCTACTTGGGAAGCTGAGGCAGGAGAATCGCTTGAACCTGAGAGGCAGAGGTTGCAGTGAGCTGAGATCAGGCCACTGCTCTCCAGCCTGGGCAACAGAGTGAAACTCCATCTCAAAAAAAAAAAGAAAAAGGCCAGGCATGGTGGCTCACGCCTGTAATGCCAGCACTTTGGAAGACTAAGTTGGGCAGATCACAACATCAGAAGATGGAGACCATCCTGGCTAACACGGTGAAACCCCGTCTCTACTAAAAATACAAAAAAAAAAAAAAAAAAAATTAGCCGGGCGTGGTGACATGCGCCTGTAATCCTAGCTACTCCGGAGGCTGAGGCAGGAGAATGGCGTGAACCCGGGAGGCGGAGCTTGCAGTGAGCCGAGATGGTGCCACTGCACTCCAACCTGGGCGACAGAGCGAGACTCTGTCTCAAAAAAAAAAAAAAAAAAGAAAAAAGGTCGGGCGCAGTGGCTCACACCAGTAATCACAGCACTTTGGGAGGCCGAGGCGGGTGGATCACCTGAGCTCGGGAGTTCAAGACCAGCCTGACCAACATGGTGAAACTCCGTCTCTACTAAAAATACAAAATATTAGCCGGGCGTGGTGGCGCGTGCCTGTAATCCCAGTTACACGGGAGGCTGAGGCAGGAGAATCACTTGAACTTGGGAAGTGGAGGTTGTGGGAGCCGAAATCGTGCCATCGCATTCCACAAGAGTGAAACTCCATTTCAAAAAAAAAAAATACAAAAATTAGCTGGGCGTGGTGGCGGGCGCCTTTAATCCCAGGGGCTCGGGAGGCTGAGGCAGGAGAATCGCTTGAACCTAGGAGGCAGAGGTTGCAGTGTGCCAAGATGACACCATTGCACTCCAGGCTGGGCAAGAGAGCAGTAACTCCCGTCTCAAAAAAAAAGAAGGAAAA","GGCTGGGCGCAGTGGCTCACACCTGTAATCCCAGCACTTAGGGAAGCTGAGGCGAGTAGATCACCTGAGGTCAGGAGTTAGAGACCAGCCTGGCCATCATGGTGAAACCCCGTCTCTACTAAAGATACCAAAAATTAGCTGAGTGTGGTGCTGGGTGCCTGTAATCCCAGAAACTCAGGGTGCCTGTAATCCCAGCAACTCAGGGTGCCTTTAATCCCAGCAACTGAGGGTACCAGTAATCCCAGCAACTCAGGGTGTCTTTAATCCTAGCAACTGAGGGCACCTGTAATCCCAGCAACTCAGGAAGCTGAGACAGGAGAAGTACTTGAACCCAGAAGGCAGAGGTTGCAGTGAGCCGATATTGCACCATTGCACTCCAGTCTGGGCAACAAGAGTGAAACTCTGTCTCAAAAAAAAA"
"chr17","48059944","48060302","JH378108","45564157","45564495","64","2495787","GGCCGGGCGCAGTGGTTCATGCCTGTAATCCCAACACTTTAGGGGGCTGAGGCAGGTGGATCACCTGAGGTCAGGAGTTCAAGACCAGCCTGGCCAACATGGTGAAAGCCCATCTCTACTAAAAATACAAAAAATTAGCTGGGCATGGTGGTGCGTGCCTGTAATCCCAGCTACTTGGGATGCTGAGGCAGGAGAATCGCTTGAACCCGGGAGGTGGAGGCTGCAGTGAGCTGAGATTGTGCCATTGCACTCCAGCCTGGGCAACAAGAGTGAAACTCCATCTAAAAAAAAAAAAGAAGAGGAGGAGGAGGAGGAGGGGGAGGGGGAGGAGGAGGAGGAGGAGAAGAAGAAAAAAGAAA","GCTAGGCAAGGTGGCTCATGCCTGTAATCCCAACATTTTGGGAGGCCGAGGCAGATGGATCACCTGAGGTTAGGAGTTCAAGACCAGCCTGGCCAACATGGTGAAACTCCATCTCTACTAAAAATACAAAAAATTAGCTTGGCACGGTGGTGGGTGCCTCTAATCCCAGCTGCTTGGGAGGCTGAGGCAGGAGAATCGCTTGAACTCAGGAGGTGGAGGTTGCAGTGAGCCAAGATCATGGCATTGCACTCCAGCCTGGGCGACAAGAGCGAGACTCCCTCTAAGAAAGAAAAGAAAGAAAAGAAAAGAAAAAAGGAAAGGAAAGGAAAGAAAGAGAAA"
"chr17","50365982","50366602","JH378118","18053084","18053501","274","32312898","GGCAAGGCGTGGTGGCTGATGTCTGTAATCCCAGCAATTTGGGGGGCTGAGGTGGATGGATCACCTGAGATCAGAAGTTCGAGACTAGGCTAGCCAACATAGTGAAACCCCATCTCTACTAAAAATATAAAAAGTTAGCCAGGCGCGGTGGTTCATGCCTGTAATCCCAGCACTTTGGGAGGCCGAGGTAGGTGGATCACAAGGTCAGGAGTTCAAGACCAACCTGGCCAAGATAGTGAAACCTCATCTCTACTAAAAATACAAAAATTAGCTGGGCGTGGTGGCAACCACCTATGATCCCAGCTACTTGGGAGGCTGAGGCAGAGAACTGCTTGAACCCAGGAAGTGGAGGTTGTAGTGAGCCAAGATTGCATCACTGTACTCCAGCCTGGGCAACAGAGCAAGACTCCATCTCAAAAAAAAAAAAAAAAAAAATACAAAAAATTAGCCAGGCGTGGTGGCAGGCACCTGTAATCCCAGCTACTCGGAAGGCTGAGGCAGGAGAATTGCTTGAACCTGGGAGGTAGAGGTTGCAGTGAGCTGAGATTGTGCCATTGCACTCTAGCCTATGTGACAAGAGCGAAACTCCATCTCAAAAAAAAAAAAAAAAAAGAAAGAAAA","GGCTGGGCGCAGTGGCTCACACCTGTAATCCCAGCACTTAGGGAAGCTGAGGCGAGTAGATCACCTGAGGTCAGGAGTTAGAGACCAGCCTGGCCATCATGGTGAAACCCCGTCTCTACTAAAGATACCAAAAATTAGCTGAGTGTGGTGCTGGGTGCCTGTAATCCCAGAAACTCAGGGTGCCTGTAATCCCAGCAACTCAGGGTGCCTTTAATCCCAGCAACTGAGGGTACCAGTAATCCCAGCAACTCAGGGTGTCTTTAATCCTAGCAACTGAGGGCACCTGTAATCCCAGCAACTCAGGAAGCTGAGACAGGAGAAGTACTTGAACCCAGAAGGCAGAGGTTGCAGTGAGCCGATATTGCACCATTGCACTCCAGTCTGGGCAACAAGAGTGAAACTCTGTCTCAAAAAAAAA"
"chr17","50542261","50542886","JH378206","6546474","6546861","277","43995787","GCCGGGCGCTGTGGCTCAAGCCTGTAATCCCAGCATTTTGGGAGACTAAGGGAAGCAGATCCTGTGAGCTCAGGATTTCGAGACCAGCCTGGCCAACATGGTGAAACCCTGTCTCTACAAAAATTAGCCATGCCGGGCACGGTGGCTCACGCCTGTAATCCCAGCACTTTGGGAGGCTGAGGCGGGCGGATCACAAGGTCAGGAGTTTGAGACCATCCTGCCTAACACGGTGCAACCCCGTCTCTACCAAAAATACAAAAAATTAGCTGGGCGTGGTGGCGGGTGCCTGTAGTCCCAGCTACTCGGGGGGCTGAGGCAAGAGAATGGCATGAACCTGTGGGGCGGAGCTTGCTGTGAGCCGATATCCTGCCACTGCACTCCAGCCTGGGCGACAGAGCGAGACTCCATCTCAAAAAAAAAAAAAAAAAAAAAAAAAAAAAAAAATGAGCCAGCTGTGGTGGCGTGTGTGCCTGTAATCCCAGCTACTCGGGAGGCTGAGGCAAGAGAATCACTTGAATCTGGGAGGCAGAGGTTGCAGTGAGCCAAGATCATGCTATTGCACTTCAGCCTGGGCAACAAGAGTGAAACTCTGTCTCAAAAAAAAAAAAAAAAAAAAAGAAAAAGAA","GGCCACACATGGTGGCTAACGCCTGTAATCCCAGCACTTTGGGAGGCCAAGTCGGGTGGATCATGAGGTCAGGAGACCAAGACCATCCTGGCCAAATGGTGAAACCCCGTCTCTACTAAAAATACAAAAATTAGCTGGGCATGGTGGCGTGTGCCTGTAATCCCAGCTACTCAGGAGGCTGAGGCAGGACAATTGCCTGAACCCAGGAGAATTAGCTGGGCATGGTGGCGTGTGCCTGTAATCCCAGCTACTCAGGAGGCTGAGGCAGGACAATTGCCTGAACCCAGGAGGCGAAGGTTGCGGTGAGCCGAGATTGTGCCATTGCACTCCAGCCTGGGTAACAAGAGCGACACTCTGTCTCAAAAAAAAAAAAAAAAAAAAAAAAAAA"
"chr17","51121894","51122508","JH378118","18053084","18053501","260","33068810","GGCTGGGTGCAGTGGCTCATGCCTGTATTCCCAACACTTTGAGAGGCCAAGGCGGGCAGATCACCTGAGGTCAGGAATTCGAGACCAGCCTGGCTAACATGGCGAAACCCTGTCTCTATTAAAAACACAAAAATTAGGCCAGGCACGGTGGCTCACACCTGTAATCCCAGCACTTTGGGAGGCTGAGGCGGGCAGATCACGAAGTCAGGAGATCGAGACCATCCTGGCTAACATGGTGAAACCCTGTCTCTGCTAAAAATACAAAAAAAATAGCGGGGCGTGGTGGCAGGCGCCTGTAGTCCCAGCTACTCAGGAGGCTGAGGCAGGAGAATGGCGTGAACCTGGGAGGCGGAGGTTGCAGTGAGCCGAGATCGCGCCACTGCACTACAGCTTGGGTGACAGAGCGAGACTCTGTCTCAAAAAAAAAAAAAAAAGTTAGTCGGGCATGGTGGTGGGCTCCTGTATTCCCAGCTACTCAGGAGGCTGAGGTGGGAGAATCACTTGAACCTGGAAGGCAGAGGTTGCTGTGAGCCAAGATTGCACCATTGCATTCCAGCCTGGGTGACAAGAGCAAAACTCTGTCTCAAAAAATATATATAAAATAATAAAAATAAA","GGCTGGGCGCAGTGGCTCACACCTGTAATCCCAGCACTTAGGGAAGCTGAGGCGAGTAGATCACCTGAGGTCAGGAGTTAGAGACCAGCCTGGCCATCATGGTGAAACCCCGTCTCTACTAAAGATACCAAAAATTAGCTGAGTGTGGTGCTGGGTGCCTGTAATCCCAGAAACTCAGGGTGCCTGTAATCCCAGCAACTCAGGGTGCCTTTAATCCCAGCAACTGAGGGTACCAGTAATCCCAGCAACTCAGGGTGTCTTTAATCCTAGCAACTGAGGGCACCTGTAATCCCAGCAACTCAGGAAGCTGAGACAGGAGAAGTACTTGAACCCAGAAGGCAGAGGTTGCAGTGAGCCGATATTGCACCATTGCACTCCAGTCTGGGCAACAAGAGTGAAACTCTGTCTCAAAAAAAAA"
"chr17","51573403","51574012","JH378118","18053084","18053501","260","33520319","GGCCGGGTGTGGTGGCTCACGCCTATTATCCCAGCAGTTTGGGAGGCCAAGTGGGGGTTGGATCACCTGAGGTCAGGGGTTCGAGACCAGCATGGCCAACATGGTGAAAACCCATCTATACTAAAGATACAAAAAATTAGGCTGGGCACAGTGGCTCATGCCTGTAATCCCAGCACTTTGGGAGGCCAAGGATCACGAGGTCAGGAGATCGAGACCATCCTGGCTAACACAGTGAAACCCCGTCTCTACTAAAAATACAAAAAAATTAGCCGGGAGTGGTGGCAAGTGCCTGTAGTCCCAGCTACTCAGGAGGCTGAGGCAGGTGAATAGTGTGAACGCAGGAGGCAGAGCTTGCAGTGAGCCGAGATCGTGCCACTACACTCCAGCCTGGGCGACAAGGTGAGACAACGTCTCAAAAAAAAAAAAAAAAAAAAGCCGGGCATGGTGGGAGGCACCTGTAATTCCACCTACTTGGGAGGGTGAGGCAGGAGAATTGCTTGAATCTGGGAGATGGAGGTTGGAGTAAGCCAAGTTCGCACCATTGCACTCCAGCCTGGGTGACAAGAGCGAAACTCTTGTCTCAAAAAAAAAAAAAAAAAAAAAAAAAAAA","GGCTGGGCGCAGTGGCTCACACCTGTAATCCCAGCACTTAGGGAAGCTGAGGCGAGTAGATCACCTGAGGTCAGGAGTTAGAGACCAGCCTGGCCATCATGGTGAAACCCCGTCTCTACTAAAGATACCAAAAATTAGCTGAGTGTGGTGCTGGGTGCCTGTAATCCCAGAAACTCAGGGTGCCTGTAATCCCAGCAACTCAGGGTGCCTTTAATCCCAGCAACTGAGGGTACCAGTAATCCCAGCAACTCAGGGTGTCTTTAATCCTAGCAACTGAGGGCACCTGTAATCCCAGCAACTCAGGAAGCTGAGACAGGAGAAGTACTTGAACCCAGAAGGCAGAGGTTGCAGTGAGCCGATATTGCACCATTGCACTCCAGTCTGGGCAACAAGAGTGAAACTCTGTCTCAAAAAAAAA"
"chr17","51598763","51599361","JH378118","18053084","18053501","241","33545679","GCCGGGCGTGGTGACTCACGCCTGTAATACCAGCACTTTAGGAGGCTGAGGTGGGTGGATCACCTGAGGTCAGGAGTTCGAGACCGGCCTGGCCAACATGGTGAAATCCTGTCTCTACTAAAAATACAAAAAAATGGCCAGGCGTGGTGGCTCACGCCTGTAATCCTAGCACTTTGGGCGGCCCAGGTGAGTGGATCACGAGGTCAGGAGATCGAGACCATCCTGGCTAACATGGTGAAACCCCATCTCTACTAAAAAACTACAAAAAAATTAGCTGGGCGTGGTGGCAGGCGCCTGTAGTCCCAGCTACTCGGGAGGCTGAGGCAGGAGAATGACGTGAACCCGGGAGGCGGAGCTTGCAGTGAGCAGAGCTTGAGCCACTGCACTCCAGCTTGGGCGACAGAGTGAGACTCCGTCTCAAAAAAAAAAAAAAAAAAATTAGCTGGGGATGGTGGCGGGCACCTGTAATCCCAGCTACTCTGGAGGCTGAGACAGGAGAATCGCTTGAACCCAGGAGGCGGAGGTTGCAGTGAGCTGAGATCGTGCCATTGTACTCCAGCCTGGGCAACAAGAGTGAAACTCAATCCGAAGAAAAAAAA","GGCTGGGCGCAGTGGCTCACACCTGTAATCCCAGCACTTAGGGAAGCTGAGGCGAGTAGATCACCTGAGGTCAGGAGTTAGAGACCAGCCTGGCCATCATGGTGAAACCCCGTCTCTACTAAAGATACCAAAAATTAGCTGAGTGTGGTGCTGGGTGCCTGTAATCCCAGAAACTCAGGGTGCCTGTAATCCCAGCAACTCAGGGTGCCTTTAATCCCAGCAACTGAGGGTACCAGTAATCCCAGCAACTCAGGGTGTCTTTAATCCTAGCAACTGAGGGCACCTGTAATCCCAGCAACTCAGGAAGCTGAGACAGGAGAAGTACTTGAACCCAGAAGGCAGAGGTTGCAGTGAGCCGATATTGCACCATTGCACTCCAGTCTGGGCAACAAGAGTGAAACTCTGTCTCAAAAAAAAA"
"chr17","51738482","51739094","JH378118","18053084","18053501","257","33685398","GCCGGGTGCGGTGGCTCACACCTGTAATCCCAGCACTTTGGGAGACTGAGGCGGGAGGATCACCTGAGGTCAGGAGTTCGAGACCAACCTGACCAACATGGTAAAACCCTGTCTGTACTAAAACTACAAAAAATTAGGCCAGGCGCAGTGGTCCATGCCTGTAATCCCAGCACTTTGGGAGGCCAAGGTGGGCGGATCATGAGGTCAGGAGTTTGAGACCAGCCTGGCCAACATAGTGAAACCCTGTCTCTACTAAAAACACAAAAATTAGTCGGGCATGGTGGCGGATGCCTGTAATCTCAGCTACTCAGGAGGTTGAGGCAGGAGAATCACTTGAACCCGGGAGGTGGAGGTTGCAGTGAGCCAAGATCACGCCACTGTACTCCAGCCTGGGCAACAGAGCGGGACTCCATCTTAAAAAAAAAAAAAAAAAAATTAGCCAGGCGTGGTGGCGCATGCCTGTAGTCCCAGCTACTTAGGAGGCTGAGGCAGGAGAATTGCTTGAACCCGGGAGGCAGAGGCTGCAGTGAGCCAAGACCACGCTATTGCATTCCAGCCTGGGTGACAAGAGCAAAACTCTGTCTCAAAAAACAAAACAAAACAAACAAAAAAA","GGCTGGGCGCAGTGGCTCACACCTGTAATCCCAGCACTTAGGGAAGCTGAGGCGAGTAGATCACCTGAGGTCAGGAGTTAGAGACCAGCCTGGCCATCATGGTGAAACCCCGTCTCTACTAAAGATACCAAAAATTAGCTGAGTGTGGTGCTGGGTGCCTGTAATCCCAGAAACTCAGGGTGCCTGTAATCCCAGCAACTCAGGGTGCCTTTAATCCCAGCAACTGAGGGTACCAGTAATCCCAGCAACTCAGGGTGTCTTTAATCCTAGCAACTGAGGGCACCTGTAATCCCAGCAACTCAGGAAGCTGAGACAGGAGAAGTACTTGAACCCAGAAGGCAGAGGTTGCAGTGAGCCGATATTGCACCATTGCACTCCAGTCTGGGCAACAAGAGTGAAACTCTGTCTCAAAAAAAAA"
"chr17","52245950","52246538","JH378118","18053084","18053501","254","34192866","TGTAATCCCAGCACTTTGGGAAGCCAACGCGGGTAGATCAGCTGAGGTCAGGAGCTCGAGACCAGCCTGGCCAACTGGTGAAACCCCATCTCTACTAAAAAAAATACAAAAAAATGGCCCAGCGCGGTGGCTCACACCTGTAATCCCAGCACTTTGGGAGGCCGAGGCGGGCAGATCACGAGGTCAGGAGATCGAGACCATCCTGGATAATACGGTGAAACCCCGTCTCTACTAAAAATACAAAAAAAAATTAACCGGGTGTGGTGGCGGGCGCCTGTAGTCCCAGCTACTAGGGAGGCTGAAGCAGGAGAATGGCGCGAAACCGGGAGGCGGAGCTTGCAGTGAGCCAAGACAGGCCACTGCACTCCAGCCTGGGCGACAGAGCGAGACTCCATCTCAAAAAAACAAAAAACAAAAAAATTAGCCAGCTGTGGTGGTGGGCGCATGTAATCCCAGTTACTTGGGAGGCTGAGGCAGGAGAATTGCTTGAAACCAGGAGGCAGAGGTTGCAGTGAGCCAAGATTACGCCATTGTACTCCAGCCTGGGCAACAAGGGCAAAACTCTGTCTCAACAAAAAAAAAGAAAAAA","GGCTGGGCGCAGTGGCTCACACCTGTAATCCCAGCACTTAGGGAAGCTGAGGCGAGTAGATCACCTGAGGTCAGGAGTTAGAGACCAGCCTGGCCATCATGGTGAAACCCCGTCTCTACTAAAGATACCAAAAATTAGCTGAGTGTGGTGCTGGGTGCCTGTAATCCCAGAAACTCAGGGTGCCTGTAATCCCAGCAACTCAGGGTGCCTTTAATCCCAGCAACTGAGGGTACCAGTAATCCCAGCAACTCAGGGTGTCTTTAATCCTAGCAACTGAGGGCACCTGTAATCCCAGCAACTCAGGAAGCTGAGACAGGAGAAGTACTTGAACCCAGAAGGCAGAGGTTGCAGTGAGCCGATATTGCACCATTGCACTCCAGTCTGGGCAACAAGAGTGAAACTCTGTCTCAAAAAAAAA"
"chr17","52264620","52265210","JH378118","18053084","18053501","242","34211536","GGCCACATGTGGTGGCTCACACCTGTAATCCCAGCACTTTGGGAGGCCAAGGCAGGCAGATCACCTGAGATCAGAAGTTCAAGACCAGCCTGGCCAATGTGGTGAAACCCTGTCTCTACTAAAAATAGAAAAAACACAGCCAGGCGCGGTAGCTCACACCTGCAATCCCAGCACTTTGGGAGGCCGAGGCAGGCAGATCACGAGGTCAGGAGATTGAGACCACGGTGAAACCCCATCTCTACTAAAAATACAAAAAATTAGCTGGGCATGGTGGCGGGCACCTGTAGTCCCAGCCACTTGGGAGGCTGAGGCAGGAGAATGGCGTGAACTCGGGAGGTGGAGCTTGCAGTGAGCAAAATTGCGCCACTGCACTCCAGCCTGGGCAACAGAGCAAGACTCCGTCTCAAAAAAAAAAAAAAAAAAAAATTAGCCGGCGTAGTGGCAAGCTCCTGTAATCCCAGCTACTTGGGAGGCTGAAGCAGGAGAATCGCTTGAACCCAGGAGGTGGAGGTTGCAGTGAGCCGAGACTGCGCCATTGCACTCCAGCCTGGGCAACAAGAATGAAACTCCGTCTCAGAAAAGAAAAAAAAA","GGCTGGGCGCAGTGGCTCACACCTGTAATCCCAGCACTTAGGGAAGCTGAGGCGAGTAGATCACCTGAGGTCAGGAGTTAGAGACCAGCCTGGCCATCATGGTGAAACCCCGTCTCTACTAAAGATACCAAAAATTAGCTGAGTGTGGTGCTGGGTGCCTGTAATCCCAGAAACTCAGGGTGCCTGTAATCCCAGCAACTCAGGGTGCCTTTAATCCCAGCAACTGAGGGTACCAGTAATCCCAGCAACTCAGGGTGTCTTTAATCCTAGCAACTGAGGGCACCTGTAATCCCAGCAACTCAGGAAGCTGAGACAGGAGAAGTACTTGAACCCAGAAGGCAGAGGTTGCAGTGAGCCGATATTGCACCATTGCACTCCAGTCTGGGCAACAAGAGTGAAACTCTGTCTCAAAAAAAAA"
"chr17","52281488","52282107","JH378118","18053084","18053501","287","34228404","GGCCAGGCGCGGTGGCTCACGCCTGTAATCCCAGCACTTTGGGAGGTCAAGGCGGGTGGATCACCTGAGGTCAGGAGTTCAAGACCAGCCTGGCCAACATGATGAAACTTCATCTTGGCCGGGCGCGGTGGCTCATGCTTGTAATCCCAGCACTTTGGGAGGCCAAGGCAGGCGGCGGATCATGAGGTCAGGAGATTGAGACCATCCTGGCTAAAACGGTGAAACCCCGTCTCTACTAAAAATACAAAAAAAAAAAAATTAGCCGGGCGTGGTGGCAGGCGCCTGTAGTCCCAGCTACTCGGGAGGCTGAGGCAGGAGAATGGCGTGAACCCGGGAGGCGGAGCTTGCAGTGAGCCGAGATAGCACCACTGCAGTCCGGCCTGGGTGAAAGAGTGAGACTCCGTCTCAAAAAAAAAAAAAAAGAAGAAAGAACTTCGTCTTTACTAAAAGTACAAAAAAAAAAAAAAAAAATTAGCCGGGCATGGTGGCAGGCGCCTGTAAACCCAACTACTCTGGAGGCTGAGGAAGGAGAACTGCTTGCACCTGGGAGTCGGAGGTTGCAGTAAGCCAAGATCGCACCATTGCACTCCAGCCTGGGCATCAAGAGTGAGACTTTGTCT","GGCTGGGCGCAGTGGCTCACACCTGTAATCCCAGCACTTAGGGAAGCTGAGGCGAGTAGATCACCTGAGGTCAGGAGTTAGAGACCAGCCTGGCCATCATGGTGAAACCCCGTCTCTACTAAAGATACCAAAAATTAGCTGAGTGTGGTGCTGGGTGCCTGTAATCCCAGAAACTCAGGGTGCCTGTAATCCCAGCAACTCAGGGTGCCTTTAATCCCAGCAACTGAGGGTACCAGTAATCCCAGCAACTCAGGGTGTCTTTAATCCTAGCAACTGAGGGCACCTGTAATCCCAGCAACTCAGGAAGCTGAGACAGGAGAAGTACTTGAACCCAGAAGGCAGAGGTTGCAGTGAGCCGATATTGCACCATTGCACTCCAGTCTGGGCAACAAGAGTGAAACTCTGTCTCAAAAAAAAA"
"chr17","52731467","52732093","JH378129","11955248","11955630","276","40776219","GGCCGGGTGCGGTGGCTCACGCCTGTAATCCTGGCACTTTGGGAGGCTGAGATGGACGGATCACCTGAGGTCAGGAGTTTTTTGTTTTTTTCTTTTTTTTTGAGACAGAGTCTGGCTCTGTTGCCCAGGCTGGAGTGCAGTGGCTCGATCTCGGCTCACTGCAAGCTCCGCCTCCCGGGTTCATGCCATTCTCCTGCCTCAGCCTCCCGGTAGCTGGGACTACAGGTGCCCGCCAGCACATCCGGTTATTTTTTTGTATTTTTAGTAGAGACAGTGTTTCACAGTGTTAGCCAGGATGGTCTCGATCTCCTGACCTCGTGATCCGCCCACCTCGGCCTCCCAAAAGTGCTGGGATTACAGGCATGAGCCACCGCGCCCGGCCAGGAGTTTTTGAGACCAGCCTGGCCAACAGGGTGAAACTCTGTCTCTACTAAAAATACAAAAATTAGTTGGGCATGGTGGCAGGCACCTGTAATCCCAGCTACATGGGAGGCTGAGGCAGGAGAATTGCTTGAACCTGGGAGGCGGAGGTTGCAGTGAGCTGAGATTGCGCCATTGCACTCCAGCCTGGGCAACAAGAGTGAAATTGCGTCTCAAAAACCAAAACAAACAAAAAAAGAATGAAAA","GGCTGGGTACGGTGGCTCATGCCTGTAATCCCAGCACTTTGGGAGGTGGGTCACTTGAGGTCAGGAGTTCGAGACCAGCCTGTGCAGTGCCTCCATCCTCAACTGCTGCCTCATCAGCCTGGACCACTACCTGCTCATCCTCTCACCACTGCCACAAGCTGCGCATGAAGCTCCTGCGCGCGCCGGTGCCCGTCTCTACTAAAAATACAAAAATTAGCTGGGTGTGGTGGCAGGTGCCTGTAATCCCAGCTACTCAGGAGGCTGAGGCAGGAGAATCACTTGAACCCAGGAGGCAGAGGTTGCAGTGAGCCGATATCGCATCATTGCACTCCAGCCTGAGCAACAAGAGTGAAATTTTGTCTCAAAAAAAAAAAAAAAAGAAA"
"chr17","54416242","54416805","JH378115","26183910","26184297","228","28232332","ACTTTGGGAGGCCATGGCAGGCGGATCACCTGAGATCAGGAGTTGGAAACCAGCCTGGCCAACATGGTAAAACCCCGTCTCTACTAAAAATACTTGGCTGGGCACGGTGGCTCACACTTGTAATTCCAACACTTTGGAAGGCCAAGGCGGGCAGATCACCTGAGGTTGGGAGTTCGAGACCAGCCTGACCAACATGGAGAAACCCTGTCTCTACTAAAAATACAAAATTAGCTGGGCATGGTGGTCTATGCCTGTAATCCCAGCTACTTGGGAGGCTGAGGCAGGAGAATTGCTTGAACCCGGGAGGCAGAGGTTGCGGTAAGCCAAGATCATGCCATTGCACTCCAGCCTGGGCAACAAGAGCAAAACCCCGTCTCAAAAAAAAAAAAAAAATTAGCCCAGTGTGGTGGCGTGCACCTGTAATCCCAGCTACTTACTTAGGAGCCTGAGGCAGGAGAATTGCTTGAACCCGGGAGGCAGAGTTTGCAGTGAGCCAAGATTGCACCATTGCACTCCAGCCTGGGTGACAAGAGTGAGACTGTCTCAAAAAAAAAAAAAAAAAAA","GGCCAGGTGCAGTGGCTCATATGTATAACCCCAACACTTTGGGAGGCCAACGCAGGTGGATCACCTGAGTTAGGAGTTTGAGACCAGCCTGACCAACATGGTGAAACCCTGTCTCTACTAAAAATACAGAAATGGCCGGGCATAGTGACACATACCTGTAATCCCAGATACTTGGGATGCTGAGTTTGCTTAAACCCAGAGGAGAACTGCTTAAACCCGGGAGGTAGAGGTCACAGTGAGCCAAGATTGGGATGCTGAGATTTGCTTAAACCCAGAGGAGAACTGCTTAAACCCAGGAGGCAGAGGTTGCAGTGAGTTGAGATTGCACCATTGCACTCCAGCCTGGACAACAAGAGTGAAACTCTGTCTCAAAAAAAAAAAAAAAAAA"
"chr17","55179146","55179483","JH378144","13229286","13229620","44","41949860","GGCCGGGTGCGGTGGCTCACGCCTGTAATCCCAGCACTTTGGGAGGCCGACGCAGGTGGATCACTTGAGGTCTGGTGTTCAAGACCAGCCTGGCCAACATTGTGAAACCCCGTCTCTACTAAAAATACAAAAAGTTAGCTGGGCATGGTAGCAGGTGCCTGTAATCCCAGCTACTTGGGAGGCTGAGGCAGGAGAATTGCTTGAACCTGGGAGGCAGAGGTTGCAGTGAGCTGAGATCGCACCATTGCACTCCAGCCCAGGCAACAAGAGCGAAACTTCGTCTCAAATAATAATAATAATAATAATAATAAATAAATAAATTTTTAAAAAAGAAAAAA","GGCCGGGCGCGGTGGCTCAAGCCTGTAATCCCAGCACTTTGGGAGGCCGAGGCGGGTGGATCACCTGTGGTCAGGAGTTCAAGACAGCTTGGTCAACATGGTGAAACCCCGTCTCTACCAAAAATACAAAAAATTAGCTGGGCATGGTAGCGCATGCCTGTAATCCCAGCTACTCAGGAGGCTGAGGCAGGAGAATTGCCTGAACCCAGGAGGCAGAGGTTGCGGTGAGCCGAGATCGCGCCATTGCACTCCAGCCTGGGTAACAAGAGCGAAACTCCCTCTCATAAAAAATAAATAAATAAATAAATAAATAAATAAATAAATAAATAAATAAA"
"chr17","59543657","59543981","JH378109","3329188","3329514","46","56214469","GGTTGGGCACAGTGGCTCACGCCTGTAATCCCAACACTTTGGGAGGCCAAGGCGGGTGGATCACCTGAGGTCGGGAGTTCAAGACCAGCCTGGCCAACATGCTGAAACCCTATCTCTACTAAAAATACAAAAAAAAAAAAAAAAAAAAAAAAAAAAAATAGCCCAGTGTGGTGTCAGGCGCCTATAATCTCAGCTACTTGGGTGGCTGAGGCAGGAGAGTCGCTTGAACCTGGGAGGCGGAGGTTGCAGTGAGCGGAGATCGCACCATTGCACTCCAGCGTGGGCAACAAGAGTGAAACTCCATCTCAAAAAAAAAGAAAAGAAA","GGCCAGGCATGGTGGCTCACGCCTGTAATCCCAGCACTTTGGGAGCCCAAGCCGGGTGGATTACCTAAGGTCAGGAATTCCAGAACAGCCTGGACAATATGGTGAAACCTTGTCTCTACTAAAAATACAAAAAAAAAAAAAAAAAAAAAAAAAAAAAAAATTTAGCCGGGTGTGGTGGTAGGTACCTGTAATCCCAGCTACTAGGGAGGCTGAGGCAGGAGAATCGCTTGAACTTGGGAGGCGGAGGTTGCAGTGAACAGAGATCACACCACTGCACTCCAGCCTGGGCGACAAGAGCAAAACTCCATCTCAAAGAAAAAAAAAGAA"
"chr17","60766805","60768705","JH378118","18053084","18053501","1483","42713721","GGCCAGGTACCGTGGCTCATGCCTCTTATCCCACCACTTTTGGAAGCTGAGGTGTGAGGATCACCCGAAGTCAGGAGTTTGGAACCATCCTGGCCAATGTTGTAAAACCCCGTCTCTAATAAAAATACAAAAGTTACCCAAGCATGGTGGTGGGCACACCTGTAATCCCAGCTACTTGGAAGGCTAAGACAGGAAAATGCCTGAACCCAGTGTGGCTGGAATTGGTGGGTTCTTGATCTCACTGACCTCAAGAATGAAGCCACGGACCCTCACGGTGAGTGTCACACTTCAAGGTGGCACGTCCAGTTTGTTCCTTCTGATGTTCGGATGTGCTCAGAGTTTCTTTCTTCTGGTGGGTTCATGGTCTCGCTGGCTCAGGAGTGAAGCTACAGACGTTCACCGGGAGTGTTACAGCTCTTAAGGCCTTGCGCCTGGAGTTGTTAGTTCCTCCCAGTGGCTTCGTGGTCTCACTGGCTTCAGGAATCAAGCAGCACGGTGAGCGTTACAGCTCACAAAGGCAGTGTGCACCCACAGTGAGCAACAGCAAAATCTATTGCAAAGAGGACAGAACAAAACCCCCACACTGGGGAAAAGGACCGGAACAGCTTGCCACTGCTGGCTCAGGCAGCCTGCTTTTATTCTCTTATCTGGCCCCACCCACATCCTCCTGATTGGTCCATTTTACAGAGAGCTGATTAGTTTGCTTTACAGTGAACTGATTGGTCCATTTTGACAGATTGGTGCTGATTGGTGCGTTTACAATCCCTGAGCTAGACACAAAAGTTTTCCACGTCCCCATTAGAATAGCTAGATACAGAGTGTCCATAGGTGTATTTACAAACCCTGAGCTAGACACGGAGTGATGATTGGTGCATTTACAAACATGGAGCTAGATACAGAGTGCCGATTGGTGCATTCACAATCCCTTAGCTAGACATAAAGGTTCTCAAGTTCCCACCAGATCAGCTAGACATAGAGCGCTGATTGGTGCATTTACAAAACTTGAGCTCGACACAGGGTGCTGATTGGTGCATTCACAAACCTTGAGCTAGACACAGGGTGCTGATTGGTGTGTTTACAAACCTTGAGCTAGATGCAGAGCGCTGATTGGTGTATTTACAATTCCTTAGCTAGACATAAAGGTTCTCCAAGTCCCCACTAGACTCAGGAGCCCAGCTGGCCTCACCCAGTGGATGTCACACTGGGGCCATAGGTGGAGCTGCCTGCCAGTTCCGTGTCCTGCGCCCACACTCCTCAGCCCTTGGGCGGTGGATGGGATTGGGCACCGTGCAGCAGGGGGTCGCGCTCCTGGGGGAGGCTCGGGCGGTGCAGGAGCCCACGGTGGCGGGGCGGGGCAGACTCAGGCATGGCGGGCTCCGGGTCCCAAGCCCTGCCGGGTGGGGAGGCACCTAAGGCCAGGCGAGAAATGGAGCGCAGCGCTGGTGGGCCAGCACTGCTGGGGGACCAGGCGCATCCTCCGCAGCTGTTGGCCTGGGTGCTAAGCCCCTCACTGCCCAGGGCTGGCAGGGCCCGCCGGCCGCTCCGAGTGCCGGGCCCGCCAAGCCCACGCCCACTTGGAACTCTAGCTGGCCCGCAAGCGCGGCGCGCAGCCCTGGTTCCCCCCCGTGCCTCTCCCTCCACACCTCCCCGCGGGCTGAGGGAGCCGGCTCCGGCCTCGGCCATCCCAGGAAGGGGCTCCCACACTGCAGCGGCGTGCTGAAGGGCTCCTCAAGCACGGCCAGAGTGGGCGAGGAGGCTGAGGAGGCGCCAAGAGTGAGCCAGGGCTGCCAGCATGCTGTCACCTCTCACCAGGAGGCGGAGATTGCAGTGAACCAAGACTGTGCCATTGCACTCCAGCCTGGGCAACAAGAGTGAAACTCCATCTCAAAAAAAATAATAAA","GGCTGGGCGCAGTGGCTCACACCTGTAATCCCAGCACTTAGGGAAGCTGAGGCGAGTAGATCACCTGAGGTCAGGAGTTAGAGACCAGCCTGGCCATCATGGTGAAACCCCGTCTCTACTAAAGATACCAAAAATTAGCTGAGTGTGGTGCTGGGTGCCTGTAATCCCAGAAACTCAGGGTGCCTGTAATCCCAGCAACTCAGGGTGCCTTTAATCCCAGCAACTGAGGGTACCAGTAATCCCAGCAACTCAGGGTGTCTTTAATCCTAGCAACTGAGGGCACCTGTAATCCCAGCAACTCAGGAAGCTGAGACAGGAGAAGTACTTGAACCCAGAAGGCAGAGGTTGCAGTGAGCCGATATTGCACCATTGCACTCCAGTCTGGGCAACAAGAGTGAAACTCTGTCTCAAAAAAAAA"
"chr17","64473614","64473953","JH378109","21565230","21565567","55","42908384","GGCCGGGTGTGGTGGCTCATGCCTGTAATCCCAGTACTTTGGGAGGCCGAGGCAGGCAGATCTCCTGAGGTCAGGAGTTTGAGACCAGCCTGGCCAACATGATGAAATGCTGTCTCTCCTAAAAATACAAAAATTAGCCAGACATAGTGGCAGGTGCCTGTAATCCCAGCTACTTGGGAGGCTGAGGGAGGAGAATTGCTTGAACCTGGGAGGCAGAGGTTGCAGTGAGTCAAGATCACGCCATTGCGCTCCAACCTGGGTGACAAAAGTGAGACTTCATCTCAAAATAAATAAATAAATAAATAAATAAATAAATAAATAAATAATAATTAAAAAAAAA","GGCCGGGCGCGGTGGCTCAAGCCTGTAATACCAGCACTTTGGGAGGCCGAGGCGGGTGGATCACGAGGTCAAGAGATCGAGACCATCCTGGTCAACATGGTGAAACCCCGTCTCTACTAAAAATACAAACAATTAGCTGGGCATGGTGGCGGGTGCCTGTAATCCCAGCTACTCCAGAGGCTGAGGCAGGAGAATTGCCTGAACCCAGGAGACGGAGGTTGCGGTGAGCCAAGATCGCGCCATTGCACTCCAGCCTGGGTGACAAGAGCGAAACTCCGTCTCAATAAATAAATAAATAAATAAATAAATAAAAATAAAATAAATAAATAAATAAATAA"
"chr17","67747489","67748097","JH378118","18053084","18053501","256","49694405","GCTGGGTGTGGTGGCTCACGCCTATAATCCCAGCACTTTGGGAGGCCAAGGCAGGTGGATCACCTGAGGTCAGGAGTTTGAGACCAGCCTGGCCAACATGATGAAACCCCGTCTCTACTAAAAATACAAAGAATTAGGCTGGGCGCGGTGGCTCACGCCTGTAATCCCAGCACTTTGGGAGGCCGAGGCGGGTGGATCACGAGGTCAGGAGATCGAGACCATCCTGGCTAACACGGTGAAACCCCGTCTCTAATAAAAATAAAAAAAAATTAGCTGGGCGTGGTGGTTGGCGCCTGTAGTCCCAGCTACTCGGGAGGCTGAGGCAGGGGAATGGCGTGAACCCGGGAGGTGGAGCTTGTAGTGAGCCGAGATCACGCCACTGCACTCCAGCCTGGGCGACAGAGCAAGACTCCGTCTCAAAAAAAAAAAAAAAAAAAATTAGCCAGGCGTGGTGGCGGGTGCCTGTAATCCCAGCTACTCTGGAGGCTGAGGCAGGAAAATCACTTTAACTCAGGAAACAGAGGTTGCAGTAAGCCGAGATCACGCCATTGTGCTCCATCCTGGGCAACAAGAGCGAAACTCCGACTCGGAAAAAAAGAAAAAAAAAAA","GGCTGGGCGCAGTGGCTCACACCTGTAATCCCAGCACTTAGGGAAGCTGAGGCGAGTAGATCACCTGAGGTCAGGAGTTAGAGACCAGCCTGGCCATCATGGTGAAACCCCGTCTCTACTAAAGATACCAAAAATTAGCTGAGTGTGGTGCTGGGTGCCTGTAATCCCAGAAACTCAGGGTGCCTGTAATCCCAGCAACTCAGGGTGCCTTTAATCCCAGCAACTGAGGGTACCAGTAATCCCAGCAACTCAGGGTGTCTTTAATCCTAGCAACTGAGGGCACCTGTAATCCCAGCAACTCAGGAAGCTGAGACAGGAGAAGTACTTGAACCCAGAAGGCAGAGGTTGCAGTGAGCCGATATTGCACCATTGCACTCCAGTCTGGGCAACAAGAGTGAAACTCTGTCTCAAAAAAAAA"
"chr17","71197353","71197681","JH378262","266823","267148","47","70930530","GACCGGACACAGTGGCTCACGTCTGTAATCCCAGCACTTTGGGAGGCTGAGGCGGGTGGATCACCTGAGGTCAGGAGTTCAAAACCAGCCTGGCCAATATGGTGAAAACCCGTCTATACTAAAAATAAAAAATTAGCCAGGCTTGGTGGCAGGCACCTGTAATCCTAGGTACTCTGGAGGCTTAGACAGGAGAATCACTTGAACCCGAGAAGTGGAGGTTGCAGTGAGCCAAGATCGTGCCATTGCACTCCAGCCTGGGCGACAAGAGTGAGACTCCATCTCAAAAACAAACAAACAAACAAACAAAAAACAAATGAACAAAAAAAAAA","GGCCGGGCGCGGTGGCTCAAGCCTGTAATCCCAGCACTTTGGGAGGCCGAGGCGGGTAGATCATGAGGTCAGGAGTTTGAGACCAGCCTGGCCAACATGGTGAAACCCCGTCTCTACTAAAAATACAAAAATTAGCCGGGCATGGTGGCCTGTGCCTGTAATCCTAGCTACCCAGGAAGCTGAGGCAGGAGAATTGCCTGAACCCAGGAGGCGGAGGTTGCGGTGAGCCGAGATCGTGCCATTGCACTCCAGCCTGGGTAACAAGAGCGAAACTCCGTCTCAAAAACAAACAAACAAACAAACAAAAACAAAAAACAAAAAACAAA"
"chr17","72892082","72892699","JH378118","18053084","18053501","266","54838998","GGCCAGGTGCAGTGGTTCACACCTATAATCCCAGCACTCTAGGAGGCCAAAGTGGGCAGATCACCTGAGGTCAGAAGTTCGAGACCAGCCTGGCCAACATGGTGAAACCATCTCTACTAAAAACACAAAAATTAGGCTGGGCACGGTGGCTCACACCTGTAATCCCAGCACTTTGGGAGGCCGAGGTGGGTGGATCACGAAGTCAGGAGATCAAGACCATCCTGGCTAACACGGTGAAACCCCGTCTCTACTAAAAATACAAAAAATTAGCCAGGCGTGGTGGCGGGCGCCTATAGTCCCAGCTACTTGGGAGGCTGAGGCAGGAGAATGGCGTGAACCCAGGAGGCGGAGCTTGCAGTGAGCCAAGATTGCGCCACTGCACTCCAGCCTGGGTGAGAGAGCTAGACTCTGTCTCAAAAAAAAAAAAAAAAAAAACACAAAAATTAGCCGGGCTTGGTGGCAGGTGCCCGTAATCCCAGCTACTCAGGACGCTGGGACAGGAGAATCTCATGAACCCTGGAGGTGGAGGTTGTAGTGAGCCAAGATCTCACCATCGCACTCCAGCCAGGGTGACAAGAGTGAAACTCTGTCTTAAAAAGATAAATAAATAAAATAAAA","GGCTGGGCGCAGTGGCTCACACCTGTAATCCCAGCACTTAGGGAAGCTGAGGCGAGTAGATCACCTGAGGTCAGGAGTTAGAGACCAGCCTGGCCATCATGGTGAAACCCCGTCTCTACTAAAGATACCAAAAATTAGCTGAGTGTGGTGCTGGGTGCCTGTAATCCCAGAAACTCAGGGTGCCTGTAATCCCAGCAACTCAGGGTGCCTTTAATCCCAGCAACTGAGGGTACCAGTAATCCCAGCAACTCAGGGTGTCTTTAATCCTAGCAACTGAGGGCACCTGTAATCCCAGCAACTCAGGAAGCTGAGACAGGAGAAGTACTTGAACCCAGAAGGCAGAGGTTGCAGTGAGCCGATATTGCACCATTGCACTCCAGTCTGGGCAACAAGAGTGAAACTCTGTCTCAAAAAAAAA"
"chr17","74365360","74365846","JH378118","18053084","18053501","163","56312276","TATAAAAAATCAGCTAGGCTTGGTGGCTTGTGCCTGTAATCCCAGCACTTTGGGAGGCTGAGGCAGGTGGATCACCTGACGTAGGTGTTTAAGACCAGATTGACTAACATGTTGAAACCCCGTCTCTACTAAAAATACAAAAATTATCTGGGCTTGGTGGTGCATGCCTGTAATCCCAGCTGCTCAGGAGGCTGAGACAGGAGAATCGCCTGAACCTGGGAAACGGAAGTTGCAGTGAGTGGAGGTTGCAGTGAGCCGAGATTGCACCACTGCACTCCAGTCTGGGCAACGGAAAAAGACTGTCTCAAAAAAAAAAAAAAAATTAGCTGGGTGTGGTGGTTGGCGCCTGTAATTCCAGCTACTCAGGAGGCTGAGGCAGGAGAATCACTTGAACTCAAGAGGCAGAGGTTGCAATGAGCCAAGATTGCGCCATTGTACTCCAGCCTGGGCCACAAGATTGAAACTTCATCTTGGGGAAAGAAAACAA","GGCTGGGCGCAGTGGCTCACACCTGTAATCCCAGCACTTAGGGAAGCTGAGGCGAGTAGATCACCTGAGGTCAGGAGTTAGAGACCAGCCTGGCCATCATGGTGAAACCCCGTCTCTACTAAAGATACCAAAAATTAGCTGAGTGTGGTGCTGGGTGCCTGTAATCCCAGAAACTCAGGGTGCCTGTAATCCCAGCAACTCAGGGTGCCTTTAATCCCAGCAACTGAGGGTACCAGTAATCCCAGCAACTCAGGGTGTCTTTAATCCTAGCAACTGAGGGCACCTGTAATCCCAGCAACTCAGGAAGCTGAGACAGGAGAAGTACTTGAACCCAGAAGGCAGAGGTTGCAGTGAGCCGATATTGCACCATTGCACTCCAGTCTGGGCAACAAGAGTGAAACTCTGTCTCAAAAAAAAA"
"chr17","74566963","74567566","JH378119","32351107","32351490","260","42215856","GCCGGGCATGGTGTATCACGCCTGTAATCCCAGCACTTTGGGAGGCAGAGGTAGGCAGATCACCTGAGGTCAGGAGTTCAAAACCAGCCTAGCCAACATGGTGAAACCCCGTCTCTACTAAAAATACAAAAAATTAGTGGCCAGGCACGGCAGCTCACGCCTGTAATTCCAGCACTTTGGGAGGCCGAGGCGGGCAGATCACGAGGTCAGAAGATTGAGACCATCCTGGCTAACACGGTGGAACCCCATCTCTACTAAAAATACAAAAAATTAGCTGGGCATGGTGGCTGGTGCCTGTAGTCCCAGCTACTCGGGAGGCTGAGGCAGGAGACTGGCATGAACCCGGGAGGCGGAGCTTGCAGCAAGCCAAGATCGTGCCACTGCACTCCACTCCATCCTGGGCGACAGAGCAAGACTCCGCTTCAAAAAAAAAAAAATTAACCGGGCAAGGTGGCAGGTGCCTGTAATCCCAGCTACTTGGGAGGCTGAGGCAGGAGAATTGCTTGCAGAGGTTGAAGTGAGCCGAGATTACGCCATTGCACTCCAGCCCAAGTGACAAGAGTGAAACTCCATCTCAAAAAAAAAAAAAAAAAAAAGAAAAAAA","GGCCAGGTATGGTGGCTCACACCTGTAATCCCAGCACTTTGGGAGGCCAAGGCAGGCAGACCACCTGAGGTCAGGAGTTCGAGATCAGCCTAGCCAACATGGTGAAACCCCATCTCTAGTAAAAATAAAATTAGCCAGGCATGGTGGTGCATGCCTGTAACGCAGGTCAGGAGTTCGAGATCAGCTTAGCCAACATGGTGAAACCCCATCTCTAGTAAAAATAAAATTAGCCAGGCAGGTGGTGCCGCCTGTACTCGGGAGGCTGAGGCAGGAGAATCACTTGAACCCAAGAGGCAGAGGTTGCAGTCAGCCAAGATCATGCCATTGCACTCCAGCCTAAGCAAAAAGAGTAAAACTCAGTCTCAAAACAAAAAAACAAAAAAA"
"chr17","75365782","75366409","JH378153","2355361","2355755","282","73010421","CCAGGCGTGGTGGCTCATGCCGGTAATCCCAGCACTTTGGGAGGCCAAGGCAGGTGGATCATCTGAGGTCAGGAGTTCGAGACCAGCCTGACCAACATGGTGAAACCTCACCTCTACTAAAAATACAAAAACTAGACAGGCGTGGTGGCGGGTGCCTGTAGTCCCAGCTACTTGGGAGGCTGAGGCAGAAAAATCGCTTGAACCCAGTAGGCAGAGGTTGCAGTGAGCCGAGATCACACCATTGCACTCCAGCCTGGGCAAAAAAGAGCGAAACTCCATCTCAGAAGAAAAGACCGGGTGCAGTGGCTCATGCTTGTAACCCCAGCACTTTGGGAGGCCAAGGCGGGTGGATCACGAGGTCAGAAGATCGAGACCATCCTGGCTAACACGGTGAAACCCCGTCTCTACTAAAAATACAAAAAAAAAAAAATAATTAGCCGAGTGTGGTGGCGGATGCCTGTAGTCCCAGCTACTCGGGAGGCTGAGGCAGGAGAATGGCGTGAACCCAGGAGGCGTAGCTTGCAGTGAGCCGAGATCACGCCACTGCACTCCAGCCTGGGCGACAGAGCAAGACTCGTCTTAAAAAAAAAAAAAAAAAGAAAAAGTAAAAGAAAAGAAAAAGCAACAA","GGCGGGGCATGGTGGCTCACACCTGTCATCCCAACACTTTGGGAGGCTGAGGCAGGCAGATCACCTGAGGTCAGGAGTTTGAGACCAGCCTGGCCAACATGGTGAAACCCCATCTCTACTAAAAATACAAAAATACAAAAAACCCCATCTCTACTAAAAATACAAAAAGCTTGTCTCTATTAAAAATACAAAAAACAAAAAACAAACAAAAAAAAAACCACCATGGTGGTGGGTGCCTATAATCCCAGCTACTCGGGAGGCTGAGGCAGGAGAATCGCTTGAACCCAGGAGGCAGAGGTTGCAGTGAGCCAAGATCCCACCATTGCACTCCAGCCTGGGCAACAGAGAGAGAGACTCTGCCTCAGAAAAAAGAAAGAAAGAAAGAAAGAAAGAAA"
"chr18","19875","20142","JH378153","8929988","8930242","54","8910113","TTGGGAGGCTGAGGTGGGTGGATCATCTGAGGTCAGGAGTTAAGACCAGCCTGGCCAACATGGTGAAACCCCATCTCTACTAAAAATACAAAAACAAAACAAAACAAAACAAAAAAAACCAGCATGGTGGCAGACACCTGTAATCCCAGCTACTCGGGAGACTGAGGCAGGAGAATCACTTGAACCTGGGAGGCGGAGGTTACAGTGAGCCAAGATCTTGTCATGTCACTCCAGCCCAGGCAACAAGAGCAAAACTGTCTTAAAAAAA","TTTGAGAGGCTGAGGTGGGTGGATCACCTAGGTCAGGAGTTTGAGACCAGCCTGACCAACATGGTGAAACCTCATCTCTACTAAAAATAAAAATAAAAAACTAGCCAGGTGCAATGGTGCATGCCTGTAATCCCAGCTACTTGGGAGGCTGAGATGGGAGACTCACTTGAACCTGGGAGGTGGAGGTTGCAGTGAGCCAAGATCATACCATTGCACTCCAGCCTGGGCAACAAGAGTGAAACCTCTTCTCAAAAA"
"chr18","4520498","4521101","JH378118","18053084","18053501","246","13532586","GGCTGGGCGCAGTGGCCCACCCCTGTAATCCCAGCACTTTGGGAGGCCGAGGCGGGTAGATCACCTGACGTCAGGAGTTCAAGACCAGCCTGGCCAACATGGTGAAACCCTGTCTCTACTAAAATACAAAAATTAGGCTGGGCGCAGTGGCTCAAGCCTGTAATCCAGCACTTTGGGAGGCCAAGGCGGGCAGATCACCTGAGGTCAGGAGTTCGAGACTAGCCTGGCCAACCTGGCAAAACCCCATCTCTACTAAAAGTACGAAAATTAGCCAGGGTGATGGTGTGCACCTGTAATCCTAGGTACTCAGGAGGCTGAGGGCAAGAGAATCGCTTGAACCTGGGAGGCAGAGGTTGTAGTGGGCCAAGATCGCGCCATTGCACTGCAGCCTCGGTGACAGAGAAAGACTCCGTCTCAAAAAAAAAAAAAAACAAAAATTAGCTGGGCGTGGTGGTGGGCGTCTGTAGTCCCATCTACACGGGAGGCTGAGGCAGAAGAATCACTTAAACCCAGGATGTGGAGGTTGCAGTGAGCTGAGATCACGCCATTGCACTCCAGACTGGGTAACAAGAGCAAAACTCCATCTCAAATAAATAAAATAAAA","GGCTGGGCGCAGTGGCTCACACCTGTAATCCCAGCACTTAGGGAAGCTGAGGCGAGTAGATCACCTGAGGTCAGGAGTTAGAGACCAGCCTGGCCATCATGGTGAAACCCCGTCTCTACTAAAGATACCAAAAATTAGCTGAGTGTGGTGCTGGGTGCCTGTAATCCCAGAAACTCAGGGTGCCTGTAATCCCAGCAACTCAGGGTGCCTTTAATCCCAGCAACTGAGGGTACCAGTAATCCCAGCAACTCAGGGTGTCTTTAATCCTAGCAACTGAGGGCACCTGTAATCCCAGCAACTCAGGAAGCTGAGACAGGAGAAGTACTTGAACCCAGAAGGCAGAGGTTGCAGTGAGCCGATATTGCACCATTGCACTCCAGTCTGGGCAACAAGAGTGAAACTCTGTCTCAAAAAAAAA"
"chr18","8281535","8282152","JH378118","18053084","18053501","271","9771549","GGCCAGGTGCGATAGCTCACACTGGTAATCCCAACACTTTGGGAGGCCGAGGTGGGCGGATCACCTGAGGCCAGGAGTTTGAGACCAGCCTGGCCAACACAGTGAAACCCCATCTCTACTAAAAATACAAAATTAGGCAGGGTGCAGTGGCTCACGCCTGTAATACCAGCACTTTGGGAGGCCGAGACAGGCGGATTACGAGGTCAGGAGATCGAGACCATCCTAGCTAACACAGTGAAACCCCGTCTCTACTAAAAAAAAAAAAAAAAAAAAAAGTACAAAAAAATTAGCCAGGCGTGGCGGCAGGTGCCTGTAGTCCCAGCTACTCAGGAGACTGAGGCAGGAGAATGGCGTGAACCCGGGAGGCGGAGCTTGCAGTGAACTGAGATCACACCACTGCACTCCAGCCTGGGCAACAGAGTGAGACTCCGTCTCAAAAACAAAACAAAATTAGCCGGGCATGGTGGTGGATGCCCGTAATCCCAGCTACTCGGGAGGCTGAGGCCGCCAAGGCAGGAGAATCTCTTGAATGTGGGAGGCAAAGGCTGCAGTGAGCTGAGATCATGCCATTGCACTGTAGCCTGGGCGACAAAAGTGAGACTCCGTCTCAAAAAAAAA","GGCTGGGCGCAGTGGCTCACACCTGTAATCCCAGCACTTAGGGAAGCTGAGGCGAGTAGATCACCTGAGGTCAGGAGTTAGAGACCAGCCTGGCCATCATGGTGAAACCCCGTCTCTACTAAAGATACCAAAAATTAGCTGAGTGTGGTGCTGGGTGCCTGTAATCCCAGAAACTCAGGGTGCCTGTAATCCCAGCAACTCAGGGTGCCTTTAATCCCAGCAACTGAGGGTACCAGTAATCCCAGCAACTCAGGGTGTCTTTAATCCTAGCAACTGAGGGCACCTGTAATCCCAGCAACTCAGGAAGCTGAGACAGGAGAAGTACTTGAACCCAGAAGGCAGAGGTTGCAGTGAGCCGATATTGCACCATTGCACTCCAGTCTGGGCAACAAGAGTGAAACTCTGTCTCAAAAAAAAA"
"chr18","14964693","14965321","JH378118","18053084","18053501","273","3088391","GGCTGGGTGCGGTGGCTCACACCTGTAATCCCAGCACTTTGGGAGGCTGAGGCAGGCGGATCACCTGAGGTCAGGAGTTCAGGACCAGCCTGATCAACATAGCGAAACCCTGTCTCTATTAAAAATATAAAAATTGCTGGGTGCGGTGGCTCACGCCTGTAATCCCAGCACTTTGGGAAGCCGAGGCGGGCGGATCATGAGCTCAGGAGATCGAGACCATCTTGGCTAACATGGTGAAACCCTGTCTCTACTAAAAATACAAAAAAATTAGCCAGGTGTGGTGGCGGGCGCCTGTAGTCCCAGCTACTCTGGAGGCTGAGGCAGGAGAATCACTTGAACCTGGGAGGCGGAGGTTGCGGTGAGCCAAGATGGTGCCATTGCACTCCAGCCTGGGCAACAAGAGTGAAACTCCATCTCAAAAAAAAAGAAAAAAAAAAAAAAAAACAACCCACAAAAATTAGCCAGGTGTGATGGCGGGTGTCTGTAATCCCAGCTACTTGGGAGACTGAGGCAGGAGAATGGCTTGAACCCGGGAGGTGGAGGTTGCAGTAAGCCGAGATTGCGCCACTGCACTCCAGCCTGGGTGACCAGAGTGAAACTTCATCTCAAAAAAAAAAAAAAAAAAAAAA","GGCTGGGCGCAGTGGCTCACACCTGTAATCCCAGCACTTAGGGAAGCTGAGGCGAGTAGATCACCTGAGGTCAGGAGTTAGAGACCAGCCTGGCCATCATGGTGAAACCCCGTCTCTACTAAAGATACCAAAAATTAGCTGAGTGTGGTGCTGGGTGCCTGTAATCCCAGAAACTCAGGGTGCCTGTAATCCCAGCAACTCAGGGTGCCTTTAATCCCAGCAACTGAGGGTACCAGTAATCCCAGCAACTCAGGGTGTCTTTAATCCTAGCAACTGAGGGCACCTGTAATCCCAGCAACTCAGGAAGCTGAGACAGGAGAAGTACTTGAACCCAGAAGGCAGAGGTTGCAGTGAGCCGATATTGCACCATTGCACTCCAGTCTGGGCAACAAGAGTGAAACTCTGTCTCAAAAAAAAA"
"chr18","15291276","15291680","JH378105","31074364","31074738","116","15783088","CTCGTGCCTGTAATCCTAGCACTTTGGGAGGCCAAGGTGGGCAGATCATCTGAGGTCAGGAGTTCGAGACCAGCCTGGCCAACATAGAGAAATCCCATCTCTACTAAAAATACAAAAATTGACGAGTTAATGGGTGCAGCACACGAACATGGCACATGTATACATATGTAACAAACCTGCACGTTGTGCACATGTACCCTAAAACTTAAAGTATATTTAAAAAAAATACAAAAATTAGCCGGGCATGGTAGCAGGCACCTGTAATCCCAGCTACTCGGGAGGCTGAGGCAGGAGAATCACTTGAACCTGGGAGGCAGAGGTTGCAGTGAGCTAAGATCATTCCATTGTACTCCAACCTGGGCAACAAGAGTGAAATTCCGTCTAATAAAAAATGAAATAAATAAA","GGCCGGGCACAGTGGCTCACACCTGTAAACCCAGCACTTTGGGAGAATGAGGTGGGCAGATGACTTCAGGTCAGGAGTTCGAGACCAGCCTGGCCAACACTGTGAAATCCCATCTCTACTAAAAATACAAAAATTAGCCATGGTGGTCAGAAGATCAAGACTATCCTGGCCAACATGGTGAAACCTTGTCTCTACTGAAAATAGAAAAATTAGCTGGGTATGGTGGCATGCGCCTGTAGTCCCAGATACTCAGGAGGCTGGGGCAGGAGAATCACTTGAACCCAGGAGGCAGAGGTTGCAGTGAGCTGAGATCATGCCATTGCACTCTAGATTAGGCAACAAGAGTGAAACTGTCTCAAAAAGAGAGAGAGAAAA"
"chr18","15802064","15802689","JH378153","2355361","2355755","270","13446703","GACCGGGCATGGTGGCTCACACCTGTAATCCCAGCACTTTGGGAGGCGTAGGCGAGTGGCCCCTGAGGTCAGGAGATCGAGACAACCCTGGCCAACATGGTGAAACTCTACTAAAAATACAAAATTAGGCCGGGTGCCGTGGTTCACGCCTATAATCCCAGCACTTTGGGAGGTCAAGGTGGGCAGATCACCTGAGGTCAGGAGTTTGAGACCAGCCTGGCCAACATGGTGAAACCCAGTCTCTACTAAAAATACAAAAATTAGCTGGGCATGGTGGTGGACACTTGTAATCCCAGCTACTTGGGGGGCTGAGGCAGGAGAATCACTTGAACCCAGGAGGCAGAGGTTGCAGTGAGCCTAAATCACCCCATTGCACTCCAGCCTGGGCAACAAGAGTGAAATTCTGTCTCGAAAAAAAAAAAAAAAGAAAAGAAAAGAAAAAAAAATTAGCCAGGTGTGGTGCTGCATGCCTGTAATCCCAGCTACTCAGGAGGCTGAGGCAGGAGAATCGCTTGAACCCGGGAGGCAGAGGTTGCAGTGAGCTGAGACCACACCATTGCACTCCAGCCTGGGCGACAAGAGAGTAACTCCATTTCAAAAAAAAAAAAAAAAAAAAGAAAAAAGAA","GGCGGGGCATGGTGGCTCACACCTGTCATCCCAACACTTTGGGAGGCTGAGGCAGGCAGATCACCTGAGGTCAGGAGTTTGAGACCAGCCTGGCCAACATGGTGAAACCCCATCTCTACTAAAAATACAAAAATACAAAAAACCCCATCTCTACTAAAAATACAAAAAGCTTGTCTCTATTAAAAATACAAAAAACAAAAAACAAACAAAAAAAAAACCACCATGGTGGTGGGTGCCTATAATCCCAGCTACTCGGGAGGCTGAGGCAGGAGAATCGCTTGAACCCAGGAGGCAGAGGTTGCAGTGAGCCAAGATCCCACCATTGCACTCCAGCCTGGGCAACAGAGAGAGAGACTCTGCCTCAGAAAAAAGAAAGAAAGAAAGAAAGAAAGAAA"
"chr18","15849226","15849860","JH378118","18053084","18053501","290","2203858","GGCCAGGCACAGTAGCTTACGCCTATAATCTCAGCACCCTAGGAGGCCGAGGCTGGCAGACCACCTGAGGTCACGAGTTCAAGACTAGCCTGGTCAACATAGCAAAACCCCATCTCTACTAAAAATACAAAAATTAGGCTGGGCACAGTGGCTCATGCTTGTAATCCCAGCACTTTGGGAGGCCAAGTCGGGAGAATCACCTGAGGTTGGGAGTTCGAGATCAGCCTGACCAACATAGAGAAACTCCATCTCTACTAAAAATGCAAAATTAGCTAGGCATGGTGGTGCATGCCTGTAATCCCAGCTACTCGTAAGGCTGAGGCAGGAGTATCGCTTGAATCTGGGAGGTGGAGGTTGCGGTGAGCCAAGATCACGCCATCGTACTCCAGCCTGGGCAACAAGAGCGAAACTCCATCTCAAAACAAAAAAAATGAGCCAGGAGTGGTGGCGGGCGCCTATAATTCCAGCTACTCCAGAGGCTGAGGCAGGAGAATCACTTAAACCCGGGAAGCAGAGGTTGCAGTGAGCTGAGATTGTGCCATTGCACCCCAGCCTAGGTGAAAAGAGCAAAACTCCATCTCAAAAAAAAAAAAAAAAAAAAAAAAAAAGAAAGAAAGAAAGAAAAAGAAAAAAAA","GGCTGGGCGCAGTGGCTCACACCTGTAATCCCAGCACTTAGGGAAGCTGAGGCGAGTAGATCACCTGAGGTCAGGAGTTAGAGACCAGCCTGGCCATCATGGTGAAACCCCGTCTCTACTAAAGATACCAAAAATTAGCTGAGTGTGGTGCTGGGTGCCTGTAATCCCAGAAACTCAGGGTGCCTGTAATCCCAGCAACTCAGGGTGCCTTTAATCCCAGCAACTGAGGGTACCAGTAATCCCAGCAACTCAGGGTGTCTTTAATCCTAGCAACTGAGGGCACCTGTAATCCCAGCAACTCAGGAAGCTGAGACAGGAGAAGTACTTGAACCCAGAAGGCAGAGGTTGCAGTGAGCCGATATTGCACCATTGCACTCCAGTCTGGGCAACAAGAGTGAAACTCTGTCTCAAAAAAAAA"
"chr18","16042035","16042617","JH378118","18053084","18053501","243","2011049","GGCTATGCACGGTGGCTCACGCCTGTAATCCCAGCACTTTGGGAGGCCGAGTCAGGTGGATCACTTGAGGTCAGGAGTTCGAGACCAGCCTGGCCAACATGGTGAAGCCCCATCTCCACTAGAAATACAAAAATTAGTCTGGGAGCAGTGGCTTACACCTGTAATTGCAGCACTTTGGGAGGCCAAGGTGGGTGGATCACCTGAGGTCAGGAGTTTGAGACCAGCATGACCAACATGGTGAAACTCCATCTATACAAAAAAATTAGCCGGGTGTGGTGGCGCATGCCTGTAATCCCAGCTACTCAGGAGACTGAGGCAGGAGAATTGCTTGAACCCGGGAGGCAGAGGTTGCAGTGAGCCAAGTCTGTGCCATTGCACTCCAACCTGGGCAACAAAAGCGAAACTCTGTCTCAAAAATAAACAACAAAAAAAATTAGCCAGGTGTGGTGGCACATGCCTATAATCCCAGCTACTCGGGAGGCTGAGGCAGAAGAATTGCTTGAACCTGGGAGGTGGAGGTTGCAGTGAGCCGAGATCATGCCATTCTACTCCAGCCTGGGCCACAAGAGCGAAACTCTGTCTC","GGCTGGGCGCAGTGGCTCACACCTGTAATCCCAGCACTTAGGGAAGCTGAGGCGAGTAGATCACCTGAGGTCAGGAGTTAGAGACCAGCCTGGCCATCATGGTGAAACCCCGTCTCTACTAAAGATACCAAAAATTAGCTGAGTGTGGTGCTGGGTGCCTGTAATCCCAGAAACTCAGGGTGCCTGTAATCCCAGCAACTCAGGGTGCCTTTAATCCCAGCAACTGAGGGTACCAGTAATCCCAGCAACTCAGGGTGTCTTTAATCCTAGCAACTGAGGGCACCTGTAATCCCAGCAACTCAGGAAGCTGAGACAGGAGAAGTACTTGAACCCAGAAGGCAGAGGTTGCAGTGAGCCGATATTGCACCATTGCACTCCAGTCTGGGCAACAAGAGTGAAACTCTGTCTCAAAAAAAAA"
"chr18","25849088","25849351","JH378114","20445944","20446195","60","5403144","GGGAAGATGAGGCGGGTGGATCACTTGAGGTCAGGAGTTCGAGACCAGCCTGGCCAACATGGTGACACCCTGTCTCCAAAAAATACACACACACACACACACACACACACACACACAAATTAGCTGGGCATGGTGGCGGGCACCTGTAATCCTAGCTACTCGAGAGGCTGCGGCAGGAGAATTGCTTTAACTTGGGAGGTAGAGGTTGCAGAGAGCCGAGATTGCACCATTGTACTCCAGCCTGGGTGACAAGAGCGAAACTCC","TTGGGAGGCCAAGGCGGGTGGATCACCTGAGGTCAGGAGTTCGAGACCAGCCTGGCCAACATGATAAAACCCCCGTATCTAATAAAAATAGGAAAAAAAAATAAATAAATAGCTGGGCGTTGTGGCAGGTGCCTGTAATCCCAGCTACTCGGGAGGCTCAGGCAGGAGAATCGCTTGAACCCAGGAGGCAGAGGTTGCAGTGAGCCAAAATTGTGCCATTGCACTCCCGCCTGGGAAACAAGAGCAAAACTC"
"chr18","38083500","38083832","JH378152","15993594","15993909","55","22089906","GGCTGGGTGCGGTGGCTCACGCCTGTAATCCCAGCACTTTGGGAAGCCAAGTCAGGTGACCTCACCTGAGGTCAGGAGTCCAAGACCAGCCTGACCAACATGGTGAAACCTCGTCTCTACTAAAAAGACAAAAAATTAGCCAGGCATGGTGGTGGGCACCTGTAATCTCAGCTACTCTGGAGGCTGAGGCAGGAGAATCACTTGAACCCTGGAGGGGGAGGTTGCAGTGAACCAAGATTGCACCATTGCAGTCCAGCCTGGGCGACAAGAGCAAAACTCCATCTCACAAACACACACACACACACACACACACACACACACAGAAAAAAAAAA","GGCTGGGTGTGGTGGCTCATGCCGGTAATCCCAGCACTTTGGGAAGCGGAGGCAGGCAGATCACCTGAGGTCAGGAGTTCAAGACCAACCTGGCCAACATGGAGAAACCATGTCTCTACTAAAAATACAAAAAATTAGCCAGGCATGGTGGGTGCCTGTAATCCCCACTACTCGGGAGGCTGAGGCAGGAGAATTTCTTGAACCCAGGAGGTGGAGGTTTCAGTGAAGCGGAGATCACCCCATTGCACTCCAGCCTGGGTGACAAGAGCAAAACTCCATCTCACAAAATCAACAACAACAACTTAAAAAAAAAAAA"
"chr18","44076326","44076933","JH378118","18053084","18053501","257","26023242","GCTGGGCGCGGTGGCTTGCGCCTGTAATCCCAGCCATTTGGGAGGCCGAGGCAGGTGGATCACCTGAGGTTAGGAGTTCAAAACCAGCCTGGCCAACATGGTGAAACCCCGTCTCTACTAAAAATACAAAAATTAGGCCAGGCACAGTGGCTCACGCCTGTCATCCCAGCACTTTGGGAGGCCAAGGCGGGCGGATCATGAGGTCAGGAGATTGAGACCATCCTGGCTAACACAGTGAAACCCTGTCTCTACTAAAAAAATATATAAAAAATTAGCCGGGCTTGGTGGCGGGTGCCCGTAATCCCAGCTACTCGGGAGGCTGAGGCAGGAGAATGGCGTGAACCTGGAAGGCGGAGCTTGCAGTGAGCCGAGATTGCACCACTGCACTCCAGCCTGGGTGACAGAGTGAGACTCTGTCTCAAAAAAAAAAAAAAAACAAAAAACAAAAATTAGTTGGGTGTGGTGGTGGACGCCTGTAATCCCGGCTACTCGGGAGGCTGAGGCAGGAAAATCACTTCAACCCGGGAGGCAGAGGTTGCCGTGAGCCAAGATCGTGCCATTGCACTCCAGCCTGGGTGACAAGAGCAAAACTCTGTCTCAAAAAAAAA","GGCTGGGCGCAGTGGCTCACACCTGTAATCCCAGCACTTAGGGAAGCTGAGGCGAGTAGATCACCTGAGGTCAGGAGTTAGAGACCAGCCTGGCCATCATGGTGAAACCCCGTCTCTACTAAAGATACCAAAAATTAGCTGAGTGTGGTGCTGGGTGCCTGTAATCCCAGAAACTCAGGGTGCCTGTAATCCCAGCAACTCAGGGTGCCTTTAATCCCAGCAACTGAGGGTACCAGTAATCCCAGCAACTCAGGGTGTCTTTAATCCTAGCAACTGAGGGCACCTGTAATCCCAGCAACTCAGGAAGCTGAGACAGGAGAAGTACTTGAACCCAGAAGGCAGAGGTTGCAGTGAGCCGATATTGCACCATTGCACTCCAGTCTGGGCAACAAGAGTGAAACTCTGTCTCAAAAAAAAA"
"chr18","44546829","44547449","JH378118","18053084","18053501","262","26493745","GGCCAGGCACGGTCGCTCACACCTGTAATTCCAGCACTTTGGGAGGCCAAGGCGGATGGGTCACCTGAGGTCAGGAGTTTGAGACCAGCCTGACCAATATGATGAAACCCCATCTCTATTAAAAATACAAAAATTAGGCTGGGCGCAGTGGTTCATGCCTGTAATTCCAACACTTTGGGAGGCCGAGACGGGCGGACCATGAGGTCAGGAGATCGAGACCATCCTGGCCAACGTGGTGAAACCCCGTGTCTACTAAAATACAAAAAAAATTAGCCAGGTGTGGTGGCACGTGCCTGTAGTCCCAGCTATTAGGGAGGCTGAGGCAGGGGAATCACTTGAACCTGGGAGGTGGAGGTTGCAGTGAGCTGAGATCTTGCCACTACACTCCATTCTGGGCAACAGAGCAAGACTCCGTCTGAAAAAAAACAAAAAAATACAAAAATTAGCTGGGCATGGTGGCGGGTACCTGTAATCCCAGCTACTTGGGAGGCTGAGACAGGAGAATCACTTGAACTCGGGAGGCAGAGGTTGCAGTGAGCCAAGATCGCACCATTGCATTCCAGCCTGGGCAACAAGAGCGAAACTCCATCTCAAAAAAACAAAAAAAAAAAAAAAGAAAAA","GGCTGGGCGCAGTGGCTCACACCTGTAATCCCAGCACTTAGGGAAGCTGAGGCGAGTAGATCACCTGAGGTCAGGAGTTAGAGACCAGCCTGGCCATCATGGTGAAACCCCGTCTCTACTAAAGATACCAAAAATTAGCTGAGTGTGGTGCTGGGTGCCTGTAATCCCAGAAACTCAGGGTGCCTGTAATCCCAGCAACTCAGGGTGCCTTTAATCCCAGCAACTGAGGGTACCAGTAATCCCAGCAACTCAGGGTGTCTTTAATCCTAGCAACTGAGGGCACCTGTAATCCCAGCAACTCAGGAAGCTGAGACAGGAGAAGTACTTGAACCCAGAAGGCAGAGGTTGCAGTGAGCCGATATTGCACCATTGCACTCCAGTCTGGGCAACAAGAGTGAAACTCTGTCTCAAAAAAAAA"
"chr18","45772849","45773450","JH378118","18053084","18053501","269","27719765","CACGCCTATAATCCCAGCACTTTAGGAGGCTGAGGCAGGTGGATCACCTGAGATCAGGAGTTCAAAACCAGCCTGGCCAACATGGTGAAACCCTGTGTCTACTACAAATACAAAAAAATGGGCAGGGTGTGGTGGCTCACACCTGTAATCCCAGCACTTAGGGAGGCCGAGGCGGGTGGATCATGAGGTCAAGAGATCAAGACCATCCTGGCCAACATGGTAAAACCCCGCCTCTACTAAAAATATAAAAATTAGCTGGGCAAGGTGGTGCGCGCCTGTAGTCCCAGCTATTTGGGAGGCTGAGGCAGGAGAATTGCTTGAACCTGGGAGGTGGAGGTTGCAGTGAGCCAAAATCGCGCCACTGCACTCCAGCCTGGCAACAGAGTGAGACTCTGTCTCAAAAAAAAACAAAAACAAAACAAAACAGAAACCAAAATTAGCTGGGCGTGGTGGCGGGCGCCTGTAGTCCCAGCTACTTGGGAGGCTGAGGCAGGAGAATCGCATGAACCCAGGAGGCGGAGGTTGCAGTGAGCCAAGACTGCACTATTGCACTCCAGTCTGGGCTACAAGAGCGAACTCCGTCTCAAAAAAAAAAAAAAAAA","GGCTGGGCGCAGTGGCTCACACCTGTAATCCCAGCACTTAGGGAAGCTGAGGCGAGTAGATCACCTGAGGTCAGGAGTTAGAGACCAGCCTGGCCATCATGGTGAAACCCCGTCTCTACTAAAGATACCAAAAATTAGCTGAGTGTGGTGCTGGGTGCCTGTAATCCCAGAAACTCAGGGTGCCTGTAATCCCAGCAACTCAGGGTGCCTTTAATCCCAGCAACTGAGGGTACCAGTAATCCCAGCAACTCAGGGTGTCTTTAATCCTAGCAACTGAGGGCACCTGTAATCCCAGCAACTCAGGAAGCTGAGACAGGAGAAGTACTTGAACCCAGAAGGCAGAGGTTGCAGTGAGCCGATATTGCACCATTGCACTCCAGTCTGGGCAACAAGAGTGAAACTCTGTCTCAAAAAAAAA"
"chr18","50079974","50080314","JH378127","6796468","6796795","54","43283506","GGTCTGGCGCCAGTGGCTCATGCCTGTAATCCCAGCACTTTGGGAGGCTGAGGCGGGTGTATCACCTGAGGTCAGGAGTTCGAGACCAGCCTGGCCAACATGGCAAAACCCCGTCTCTACGAAAAATACAAAAAAATTAGCCGGGCGTGGTAGCAGTCGCCTGTAATCCCAGCAACTTGGGAAGCTGAGGCAGAAGAATCGCTTAAACCTAGGAGGCGGAGGTTGCAGTGAGCCAAGATTGCGCCATTGCACTCCAGCCTGGTCAACAAGAGCAAAACTCTGTCTCAAAACAACAACAACAACAACAACAACAACAAACAAAAACCAAAAAAACCAAAAAA","GGCCGGGCGCGGTGGCTCAAGCCTGTAATCCCAGCATTTTGGGAGGCCGAGGCGGGTGGATCACGAGGTCAGGAAATCGAGACCATCCTGGTCAACATGGCGAAACCCCATGTCTACTAAAAATACAAAAATTAGCTGGGCATGGTGGCACGTGCCTGTAATCCCAGCTACTCAGGAGGCTGAGGCAGGAGAATTGCCTGAACCCAGGAGGCGGAGCTTGCAGTGAGCCGAGATCGCGCCATTGCACTCCAGCCTGGGTAACAAGAGCGAAACTCCGTCTCAAAAAAACAAACAAAAACAAAACAAAACAAAACAAAACAAAAAAAAC"
"chr18","53653883","53654201","AGCE01149660","956","1264","46","53652927","GGCCAGGCATGGTGGCTCACGTTTGTAATCCTAGCACTTTGGGAGGCTGTAGCGGGCGGATCACCTGAGGTCAGGAGTTTGAGACCAGCCTGGCCAACATGGTGAAACCCTGTCTCTACTAAAAAAAAAAAAAAAAAAAAAAAAAAAATTAGCCAGGTGTGGTGGTGGTGGATGCCTATAATCCCAGCTACTCGGGAGGCTGAGGCAGGAGAATCACTTGAACCTGGGAAGCAGAGGTTGCAATGAGCTGAGATTGAGCCATTGCACTCCAGCCTGGACAACAAGAATGAGACTCTGTCTCAATAAATAAGTAAATAAA","GGCCAGGCACGGTGGCTCATGCCTATAATCCCAGCACTTTGGGAGGCTGCGATGGGTGGTTCACTTGAGGTCTGGAGTTTGAGACCAGCCTGGCCAACATGGAGAAACCCTTTCTCTACTAAAAATACAAAAAAAAAAAAAAAAAAAATTAGCCAGGCATGGTGGCGGGTGCCTGTAATCCCAGCTACTCAGCAGGCTGAGGGAAGAGAATCACTTGAACCGGGGAGGCAGAGGTTGCAGTGAGCTGAGATGATGCCATTGCACTCCAGCCTGGGCAACAAGAGCAAAACTGTCTCAAAAAAAAAAAAA"
"chr18","53971096","53971710","JH378118","18053084","18053501","262","35918012","GGTCGGGTGTGGTGGCTCATGCCTATAATCCCAGCACTTTGGGAGGCTGAGGCAGGCAGATTACCTGAGGTCAGGAGTTCGAGACCAGCCTGGCCAACATGATGAAACCTTGTCTCTACTAAAAATACAAAAATTAGGCCGGGCACGGTGGCTCATGCCTGTAATCCCAGCACTTTGGGAGGCCGAGGCGGGTAGATCACAAGGTCAGAAGTTCAAGACCAGCCTGGCCAACATGGTGAAACTCTGTCTTTACTAAAAATACAAAAATTAGCTAGGCATGGTGGCGCACACCTATAATCCCAGCTACTGGGGAGGCTGAGGCAGGAGAATTGCTTGAACCAGGACCCGGGAGGTGGAGGTTGCTGTGAGCCGAGATTGCGCCACTGCACTCCAGCCTGGGAGACAGAGTGAGACTCCGTCTAAAAAAAAAAAAAAAAAATTAGCCAGGTGTGGTGGCGCATGCCTGTAATCCCAGCTACTCGGGAGGCTGACGCAGAAGAATCATTTGAACGTGGGAGGCAGAGGTTACAATGAGCTGAGATCACACCATTGTACTCCAGCCTGGGCAACAAGAGCAAACTCAATCTCAAAAAAATAAAAATAAAAAAAAAGAAA","GGCTGGGCGCAGTGGCTCACACCTGTAATCCCAGCACTTAGGGAAGCTGAGGCGAGTAGATCACCTGAGGTCAGGAGTTAGAGACCAGCCTGGCCATCATGGTGAAACCCCGTCTCTACTAAAGATACCAAAAATTAGCTGAGTGTGGTGCTGGGTGCCTGTAATCCCAGAAACTCAGGGTGCCTGTAATCCCAGCAACTCAGGGTGCCTTTAATCCCAGCAACTGAGGGTACCAGTAATCCCAGCAACTCAGGGTGTCTTTAATCCTAGCAACTGAGGGCACCTGTAATCCCAGCAACTCAGGAAGCTGAGACAGGAGAAGTACTTGAACCCAGAAGGCAGAGGTTGCAGTGAGCCGATATTGCACCATTGCACTCCAGTCTGGGCAACAAGAGTGAAACTCTGTCTCAAAAAAAAA"
"chr18","57837437","57837748","JH378115","16887097","16887400","43","40950340","GCTGGGCATGGTGGCTCACACCTGTAATCCCAGCACCTTGGGAGGCCGAGGTGGGTAGATCACCTGAGGTCAGGAATTCGAGACCAACCTGGCCAACATGGTGAAACCCCGTCTCTACTAAAAATACAAAAAAAAAAAAAAAAAAAAAAAAAGCTGGGCATGGTGGTGGGTACCTGTAATCCCAGCTACTCAGGAGTCCGAGGCAGGAGAATCGCTTGAACCTGGCAGGTGGAGGTTGCAGTGTGCCAGGATTGTGCCATTGCACTCCAGCCTGGGTGACAAGAGCAAAACTCCAACTCAAAACAAAAACAA","GCCGGGCACGGTGGCTCAAGCCTGTAATCCCAGCACTTTGGGAGGCCGAGGCGGGTGGATCACAAGGTCAAGAGATCGAGACCAACCTGGTCAACATGGTGAAACCCCATCTCTACTAAAAAATACAAAAAAAAAAAAAAAATTAGCTGGGCATGGTGGCGCGTGCCTATAATCCCAGCTACTCAGGAGGCTGAGGCAGGAGAATTGCCTGAACCTAGGAGGTGGAGGTTGCAGTGAGCCAAGATCATGCCATTGCACTCCAGCCTGGGTAACAAGAGCGAAACTCCATCTCAAAAAAAAAAAA"
"chr18","58257354","58257943","JH378118","18053084","18053501","263","40204270","GCCTGTAATCACAGCACTTAGGGGGGCCGAGGCAGGAGGATCACCTGAGGTCAGGAGTTCGAGACCAGCCTGGCCAACATGGTGAAACCCCGTCCCTACTAAAAATACAAAAATTGGCCGGACACATTGGCTCATGCCTGTAATCCCAGCACTTTGGGAGGCCGAGGCGGGTGGATCACCTGAGGTCAGGAGTTCAAGACCAGCCTGACCAACCTGGAGAAACCCTGTTTCTACTAAAAATACAAAATTAGCCAGGCATAGTGGCGCATGCCTGTAATCCCAGCTACTCGAGAGGCTGAGGCAGGAGAATCGCTTGAACCCGGAAGGTGGAGGTTGCGGTGAACCGAGATTGTGCCATTGCACTCCAGCCTGGGCAACAAGAGCAAAACTCCGTCTCAAAAACAAAACAAAACAAAACAAAAATTAACCCGGCGTGGAGGTGGATGCCTGTAATCCCAGCCACTTTGGGAGACTGAGGCAAGAGAATTGCTTGAACCCGGGATGTGGAGGCTGCAGTGACCCGAGATCACGCCATTGCATTCCAGCCTGGCAACAAGAGTAAGACTCCATCTCAAAAACAAGCAAACAAA","GGCTGGGCGCAGTGGCTCACACCTGTAATCCCAGCACTTAGGGAAGCTGAGGCGAGTAGATCACCTGAGGTCAGGAGTTAGAGACCAGCCTGGCCATCATGGTGAAACCCCGTCTCTACTAAAGATACCAAAAATTAGCTGAGTGTGGTGCTGGGTGCCTGTAATCCCAGAAACTCAGGGTGCCTGTAATCCCAGCAACTCAGGGTGCCTTTAATCCCAGCAACTGAGGGTACCAGTAATCCCAGCAACTCAGGGTGTCTTTAATCCTAGCAACTGAGGGCACCTGTAATCCCAGCAACTCAGGAAGCTGAGACAGGAGAAGTACTTGAACCCAGAAGGCAGAGGTTGCAGTGAGCCGATATTGCACCATTGCACTCCAGTCTGGGCAACAAGAGTGAAACTCTGTCTCAAAAAAAAA"
"chr18","59255477","59255805","JH378228","5665092","5665424","52","53590385","GGTTGGGCGCAGTGGCTCACGCCTGTAACCCCAGCACTTTCGGAAGCTGAGGCAGGCGGATCACCTGAGGTCAGGGGTTCGAGACCAGCCCGGACAACGTGATTAAACCCTGCCTCTACTAAAAATACAAAAATTAGCGACTGTGGTGTTGGGCGCCTGTAATCGCAGCTACTTGGGAGGCTGAGGCATGAGAATTGCTTGAACCCAGGAGGCAGAGGTTGCAGTGAGCAGAGATTGCTCCATTGCACTCCAGCCTGGGCAACAAGAGCAGAACTCTGTCTCAAAATAAATAAATAAATAAATAAATAAATAAATAACAGAAAAGAAAA","GGCCGGGCGCGGTGGCTCAAGCCTGTAATCCCAGCACTTTGGGAGGCTGAGGCGGGTGGATCACGAGGTCAAGAGATCGAGACCATCCTGGTCAACATGGTGAAACCCTGTCTCTACTAAAAATACTAAAAATTAGCTGGGCATGGTGGCGTGTGCCTGTAATCCCAGCTACTCAGGAGGCTGAGGCAGGAGAATTGCCTGAACCCAGGAGGCGGAGGTTGCGGTGAGCCGAGATCGCGCCATTGCACTCCAGCCTGGGCAACAAGAGCGAAACTCTGTCTCAAAAAAAAAAAATAAATAAATAAAATAAAATAAAATAAAATAAAATAAAAT"
"chr18","59405673","59406877","JH378118","18053084","18053501","805","41352589","GGCTAGATGCGGTGGCTCATGCCTGTAATCCCAGCACTTTGGGAGGCCAAGGCAGGTGGATCACCTGAGGTCAGGAGTTTGACACCAGCCTGGCCAACATGTTGAAACCCTGTCTCCACTAAAAATACAAAAAAAGATTATCTGGGTTATTGTGGGATCTGGCCAGCAGCCCGCAATGCAATGGGGCTCTCTCTTTGTTCCCAGGCAGATTGGCAGGTTGAGAAATAATAGACACACACAAGATAGTGAAAGTTGGGTCCAGGGGGGTCACCGCCTTCTGGTCCCATGGTGCCAACAATGCACTGGATATACCAGCATTTATTATTAAGTTTAGTGAGGGCGGGGGTAGGTTAGTGAGGGATTTAGGGTCATTTGATTATGAGGTGAGATGGTCACATGGAAATGAAGTAATTCTTTAACGTAACATTTGTATGTAGAAGTACAGTACATTTGTATGTAGAAGTACAGTATACAGAGATAAGAATTTACAATATAGTGTGTGCATCAGTAATTTCTAACAGAGCCTTAAAACAGAAAGACAATCTTTCCATAATCTATGATTAGCAAGATATTAATCAGCAGTAACAATTGCAATGAAAGCTGGTTACAAACAGTCCATGGAAACAGGAGGTGAAGCTAGACAATCGGTTAGACCAGAAATTCTCAGAAGGGAATATGCCTTAACCCTAAAGAGGCCTAGAAGAGCCGTGGCAAGATGAGGGTGTTTATAGCCCTATCTTATCCATATGGACAGGCACCTCCCCATGCGTCCGTTTATAGGCTCTCCATGAGGGTCGCATTCCATTCCCAGAGCTATGAACATCTGCTTTTCTGGGATAGGAATCTTGGTGATGTGAAACCTCCCTGACTACACGTCCATTCATAGGATCTCTGCAGGGGGAAGCACATCACACACTGTTGGCTCGTTCTGGCAGTCCAACCTGGCATTGTGTCTTTACACAATCCTGCATGCAATTTTGTATTTACAATAATCAGGAGCATTTCATCTTTTATTCTGTAGCAATAGTTTCAGGGGGTCTCCCTACACTGGGTGTGGTGACGGGTACCTGTAATCCCAGCTACTCAGGAGGCTGAGGCAGGAGAATCACTTGAGCCTTAGAGGCAGAGGTTGCAGTGAGCTGAGATCAGACCATTGCACTCCAGCCTGGGCAACAAGAGCAAACCTCCGTCTCAAAAAAAAAAAA","GGCTGGGCGCAGTGGCTCACACCTGTAATCCCAGCACTTAGGGAAGCTGAGGCGAGTAGATCACCTGAGGTCAGGAGTTAGAGACCAGCCTGGCCATCATGGTGAAACCCCGTCTCTACTAAAGATACCAAAAATTAGCTGAGTGTGGTGCTGGGTGCCTGTAATCCCAGAAACTCAGGGTGCCTGTAATCCCAGCAACTCAGGGTGCCTTTAATCCCAGCAACTGAGGGTACCAGTAATCCCAGCAACTCAGGGTGTCTTTAATCCTAGCAACTGAGGGCACCTGTAATCCCAGCAACTCAGGAAGCTGAGACAGGAGAAGTACTTGAACCCAGAAGGCAGAGGTTGCAGTGAGCCGATATTGCACCATTGCACTCCAGTCTGGGCAACAAGAGTGAAACTCTGTCTCAAAAAAAAA"
"chr18","71500430","71500770","JH378228","5665092","5665424","54","65835338","GCTGGGTGCGGTGGCTCACGCCTGTAATCACAGCACTTTGGTAAGCCCGAGGCAGGTGGATCACCTGAGGTCAGGAGTTCGAGACCAGCCTGACCAACATGGTGAAACCCTTTCTCTACTAAAAATGCAAAAATTAGCTGGGCGTCATGGCGGGCGTCTGTGATCCCAGCTACTAGGGAGGCTAAGGCAGGAGAATTGCTTGAACCTGGGAGGCGGAGGTTGCAGTGAGCAGAGATTGCACCATTACACTCCAGCCTGGGCAACAAGAGCAAAACTCCATCTCAAAATAAATAAATAACTAAATAAATAAATAAAATGAAATTAAAAAGAAAGAAAGAAAA","GGCCGGGCGCGGTGGCTCAAGCCTGTAATCCCAGCACTTTGGGAGGCTGAGGCGGGTGGATCACGAGGTCAAGAGATCGAGACCATCCTGGTCAACATGGTGAAACCCTGTCTCTACTAAAAATACTAAAAATTAGCTGGGCATGGTGGCGTGTGCCTGTAATCCCAGCTACTCAGGAGGCTGAGGCAGGAGAATTGCCTGAACCCAGGAGGCGGAGGTTGCGGTGAGCCGAGATCGCGCCATTGCACTCCAGCCTGGGCAACAAGAGCGAAACTCTGTCTCAAAAAAAAAAAATAAATAAATAAAATAAAATAAAATAAAATAAAATAAAAT"
"chr19","1465612","1466244","JH378118","18053084","18053501","284","16587472","GGCTGGGGACGGTGGCTCAGGCCTGTAACCCCAGCACTTTGAGAGGACCAGGAGGGAGGATTGCTTGAGCCCAGGAGTCCGAGACCAGCCTGGGCAGCAAAGCAAGGCCCTGTCTCTACAAAAATACTTTAAAATTAGCCAAGTGTTGGCTGGGTGCGGTTGCTCATGCCTATAATCCCAGCACTTTGGGAGGCCGAGGTGGGTGGATCACCTGAGGTCAGGAGTTTGAGACCAGCCTGGCCAACATGGCAAAACCCCGTCTCTACTAAAAATACGAAAATTAGCCAGACGTGGTGGCTCATTCCTGTAATCCCAGCTACTCGGGAGGCTGAGGCAGGAGAATCGCTTGAACTCGCAAGGCGGAGGTTGCAGTGAGCCAAGATCATGCCATTGCATTCCAGCCTGGGTGACAGAGCAAAACTCCGTCTCAAAAAAAAAAAAAAAAAAAAAAAATTAGCCAGGCGTGGTGGTGGGCACCTGTAGTCCCAGCTACCCGGGAGGCTGAGGCAGGAGAATCGCTTGAGCCCGGGAGGCAGAGGTTACAGTGAGCCGAGATCGTGCCATTGCACTCCAGCCTGGGCAACAAGAGTGAAAATCCGTCTCAAAAAAATAAATAAATACAAAATAAAAAAA","GGCTGGGCGCAGTGGCTCACACCTGTAATCCCAGCACTTAGGGAAGCTGAGGCGAGTAGATCACCTGAGGTCAGGAGTTAGAGACCAGCCTGGCCATCATGGTGAAACCCCGTCTCTACTAAAGATACCAAAAATTAGCTGAGTGTGGTGCTGGGTGCCTGTAATCCCAGAAACTCAGGGTGCCTGTAATCCCAGCAACTCAGGGTGCCTTTAATCCCAGCAACTGAGGGTACCAGTAATCCCAGCAACTCAGGGTGTCTTTAATCCTAGCAACTGAGGGCACCTGTAATCCCAGCAACTCAGGAAGCTGAGACAGGAGAAGTACTTGAACCCAGAAGGCAGAGGTTGCAGTGAGCCGATATTGCACCATTGCACTCCAGTCTGGGCAACAAGAGTGAAACTCTGTCTCAAAAAAAAA"
"chr19","1761610","1762212","JH378118","18053084","18053501","248","16291474","GGCCGGGTGCGGTGGTTTACACCTGTAATCCTGGCATTTTGGGAGGCCGAGGCAGGAGTATCACCTCAGGTCAGGAGTTCAAGACCAGCCTGGCCAACATGGTGATACTCCGTCTCTACTAAAAATACAAAAATTGGCCGAGTGCAGTGGCTCACACCTGTAATCCCAGCACTTTGGGAGGCCGAGGCAGGTGGATCATGAGGTCAGGAGTTCGAGACCAGCCTGGCCAAGATGGTGAAACCCCGTCTCTACTAAAAATACAAAAATCAGCTGGGTGTGGTGGCGGGTGCCTGTAATCCCAGCTACTCGGGAGGCTGAGGCAGGAGAATTGCTTGGACCTGGGCAGCAGAGGTTGCAGCGAGCTGAGATGGCGCCACTGCACTCCAGCCTGGGCGACAGAGCGAGACTCTTGTCTCAGAAAAATAAAAAATAAAAAAATTAGCTGGGTGTGGTGGTGCGCACCTGTAATCCCAGCTACTCGGGAGGCTGAGGCAGGAGAATCGCTTGAATCTGGGAGGAGGAGGAGGTTGCAGTGAGCTGAGATAGTGCCAGTGCAGGCCAGCCTGGTCAACAAGAGTGAAACTCCGTCTCAGAAAAAAAAAA","GGCTGGGCGCAGTGGCTCACACCTGTAATCCCAGCACTTAGGGAAGCTGAGGCGAGTAGATCACCTGAGGTCAGGAGTTAGAGACCAGCCTGGCCATCATGGTGAAACCCCGTCTCTACTAAAGATACCAAAAATTAGCTGAGTGTGGTGCTGGGTGCCTGTAATCCCAGAAACTCAGGGTGCCTGTAATCCCAGCAACTCAGGGTGCCTTTAATCCCAGCAACTGAGGGTACCAGTAATCCCAGCAACTCAGGGTGTCTTTAATCCTAGCAACTGAGGGCACCTGTAATCCCAGCAACTCAGGAAGCTGAGACAGGAGAAGTACTTGAACCCAGAAGGCAGAGGTTGCAGTGAGCCGATATTGCACCATTGCACTCCAGTCTGGGCAACAAGAGTGAAACTCTGTCTCAAAAAAAAA"
"chr19","2871458","2872098","JH378118","18053084","18053501","282","15181626","GGCCGGGCGCGGTGGCTCACGCTTGTAATCCCAGCACTTTGGGAGGCCTAGGTAGTGGATCACCTGAGGTCAGGAGTTTGAGACCAGCCTGGCCAACATGGGGAAACCCAGTCTCTACTAAAAATACAAAAATGAGGCCGGGTGCAGTGGCTCATGCCTGTAGTCTCAACACTTTGGGAGACCAAGGCAGGCGGATCACCTGAGGTCAGGAGTTCAAGCCCAACCTGGCCAACATGGTGAAACCCTGCCTCTTCTAAAAATACAAAAATTAGCCAGGTGTGGTGGCATGTACCTGCAATCCCAGCTGCTTAGGAGTTCGAGATAGAAGGATTGCCTGAACCTGGGAGGCGGAGGTTGCAGTGAGCTGAGATCATGCCATTGCACTCCAGCCTGGGTGACAGAGACCCTGTCTCACACACACACACACAAATTATATATATATATATATATATACACACACACACACACGCACACACAAATTGGCCAGGCGTGGTGGCGGGTGCCTATAATTCCAGCTACTTGGGAGGCTGAGGCAGGAGAATGTCTTGAACCCGGGAGGTGGAGGTTGCAGTGAGCCGAGATTGCGCCACTGCACTTTAGCCTGGACGACAAGAACAAAACTCCATCTCAAAAAAACGAAA","GGCTGGGCGCAGTGGCTCACACCTGTAATCCCAGCACTTAGGGAAGCTGAGGCGAGTAGATCACCTGAGGTCAGGAGTTAGAGACCAGCCTGGCCATCATGGTGAAACCCCGTCTCTACTAAAGATACCAAAAATTAGCTGAGTGTGGTGCTGGGTGCCTGTAATCCCAGAAACTCAGGGTGCCTGTAATCCCAGCAACTCAGGGTGCCTTTAATCCCAGCAACTGAGGGTACCAGTAATCCCAGCAACTCAGGGTGTCTTTAATCCTAGCAACTGAGGGCACCTGTAATCCCAGCAACTCAGGAAGCTGAGACAGGAGAAGTACTTGAACCCAGAAGGCAGAGGTTGCAGTGAGCCGATATTGCACCATTGCACTCCAGTCTGGGCAACAAGAGTGAAACTCTGTCTCAAAAAAAAA"
"chr19","2912949","2913566","JH378118","18053084","18053501","268","15140135","GGCTGGGCGTGGTGGCTCACACCTGTAATCCCAGCACTTTGGGAGGCCAAGGTGGAGGGACTGCCTGAAGCCAGGGGTTCGAGACCAGCCTGGCCAACATGGTGAAACCCTGTCTCTACTAAAAATAGAAAAATTAAGGCCGGGCGCGGTGGCTCATGCCTGTAATCCCAGCACTTTGGAAGGCCGAGGCGGGCGGATCACTTGAGGTCGGGAGTTCAAGACCAGCCTGACCAACATGGAGAAACCCTGTCTCTACTAAAAATACAAAATTAGCCAGGGTGGTGGCGCATGCCTGTAATCCCAGCTACTTGGGAGGCTGAGGCAGGAGAATCGCTTGAACCCGGGAGGTGGAGGTTGCAGTGAGCTGAGATCGCACCATTGCACTCCAGCCTGGGCAACAAGAGCAAAACCACGTCTCAAAAAAAATAAAAATAAAAATAAAAAAATTAGCTGGGTGTGGTGGCAGGCGCCTGTAGCTGCTTGGGAGGCTGAGACAGGAGAATTGCTTGAACCTGGGAGGCGGAGGTTGCAGTGAGCTGAGACCGTGCCATTGCACTCCAGGCTGGGCAAGAAGAGCAAAACTCTATCCTTCCCCCACTCCAAAAAAAAAAAAAAAAA","GGCTGGGCGCAGTGGCTCACACCTGTAATCCCAGCACTTAGGGAAGCTGAGGCGAGTAGATCACCTGAGGTCAGGAGTTAGAGACCAGCCTGGCCATCATGGTGAAACCCCGTCTCTACTAAAGATACCAAAAATTAGCTGAGTGTGGTGCTGGGTGCCTGTAATCCCAGAAACTCAGGGTGCCTGTAATCCCAGCAACTCAGGGTGCCTTTAATCCCAGCAACTGAGGGTACCAGTAATCCCAGCAACTCAGGGTGTCTTTAATCCTAGCAACTGAGGGCACCTGTAATCCCAGCAACTCAGGAAGCTGAGACAGGAGAAGTACTTGAACCCAGAAGGCAGAGGTTGCAGTGAGCCGATATTGCACCATTGCACTCCAGTCTGGGCAACAAGAGTGAAACTCTGTCTCAAAAAAAAA"
"chr19","3601333","3601668","JH378148","10302642","10302970","47","6701309","GCTGGGCGTGGTGGCTCACACCTGTAATCCCAGCACTTTGGGAGGCTGAGGTGGGCGGATCACGTGAGGTCAGGAGTTCCAGACTAGCCTGGCCAACATGGGGAAACCCCATCTCTGCTAAAAATAAAAAATTTAGCCGAGTGTGGTGGTGGGTGCCTGTAATCCCAGCTACTCAGGAGGCCGAGGCAGGAGAATTGCTTGAACCCAGGAGGCAGAGGTTGCAGTGAGCCGAGATCACGCCATTGCACTCCAGCCTGGATGACAACAGTGAGACTCCAACTCAAAAAATAATAATAATAATAATAATAATAATAAAATAAAACAATAAAAAAAAAA","GGCCGGGCGCGGTGGCTCAAGCCTGTAATCCCAGCACTTTGGGAGGCCGAGGCGGGTGGATCACGAGGTCAAGAGATCGAGACCATCCTGGTCAACATGGTGAAACCCCGTCTCTACTAAAAATACAAAAAATTAGCTGGGCATGGTGGTGGGTGCCTGTAATCCCAGCTACTCAGGAGGCTGAGGCAGGAGAATTGCCTGAACCCAGGAGGCGGAGGTTGCGGTGAGCCGAGATCGCGCCATTGCACTCCAGCCTGGGTAACAAGAGTGAAACTCTGCCTCAAAAAAAAAAAATAAAATAAAATAAAATAAAATAAAATAAAATAAAA"
"chr19","4440800","4441421","JH378118","18053084","18053501","276","13612284","GGCTGGGTGCGGTGGCTCATGCCTGTAATCCCAGCACTTTGGGAGGCCAAGCGGGCAGATCAACTGAGGTCAGGAGTTCGAGACCAGCCTGGCCAACATAGTAAAACCCTGTTTCTACTAAAAAAAAAAAAAAAAAAAAAAAAAAAATTGGCTGGGCGCAGTGGCTCACGCATGTAATCCCTGCACTTTGGGAGGCCAAGGCAGGTGGATCACCTGAGGTCAGTAGTTTGAGACCAGCCTGACCAACGTGGAGAAACCCCATCTCTACTAAAAATACAAACAAAAAAAACAAAAAACAAAAAAAACCGGGTATGGTGGTACATCCCTGTAATCCCAGCTCCTCGGGAGGCTGAGGCAGGAGAATCACTTGAACCCGGGAGGCGGAGGTTGCACTGAGCCGAGATTGCGCCACTGCACTCCAGCCTGGGCGATAGAGCGAGACTCCCTCTTAAATAATGATTATAATTGCCAGGTGTGGTGGCGGGTGCCTGTAATCCCAGCTACTTGGGAGGCTGAGGCAGGAGAATCGTTTGAATCCAGGAGGAGGAGGTTGCAGTGAGCCGAGATGGTGCCACAGCACTCCAGCCTGGGTGACAAGAGTGAAACCCCATTACAAACAAAA","GGCTGGGCGCAGTGGCTCACACCTGTAATCCCAGCACTTAGGGAAGCTGAGGCGAGTAGATCACCTGAGGTCAGGAGTTAGAGACCAGCCTGGCCATCATGGTGAAACCCCGTCTCTACTAAAGATACCAAAAATTAGCTGAGTGTGGTGCTGGGTGCCTGTAATCCCAGAAACTCAGGGTGCCTGTAATCCCAGCAACTCAGGGTGCCTTTAATCCCAGCAACTGAGGGTACCAGTAATCCCAGCAACTCAGGGTGTCTTTAATCCTAGCAACTGAGGGCACCTGTAATCCCAGCAACTCAGGAAGCTGAGACAGGAGAAGTACTTGAACCCAGAAGGCAGAGGTTGCAGTGAGCCGATATTGCACCATTGCACTCCAGTCTGGGCAACAAGAGTGAAACTCTGTCTCAAAAAAAAA"
"chr19","5462237","5462567","JH378255","1377129","1377437","56","4085108","GACCAGGTGCGGTGGCTCACGCCTGTCATTCCAGCACTTTGGGAGGCCGAGGGGGGCGTGGATCACTTGAGGTCAGGAGTTCAAGACCAGCCTGACCAACATGGTGAAACTCCGTCTCTACTAAAAATACAAAAATTAGCCAGGTGTGGTGGCACATGCCTGTAATCCCAGCTACTTGGGAGGCTGAGGCAGGAGAATCACTTGAACCTGGGAGATGGAGGTTTCATTCAGTGAGCTGAGATTGCACCATTGCACTCCAGCCTGGGTGACAAGAACGAAACTCTGTCTCAGAACACACACACACACACACACACACACACCCCAGAAAAAA","GGCCTGGCGTGGTGGCTCACGCCTGTAATCTCAGCACTTTGGGAGGCCAAGGTGGGTGGATCACCTGAGGTCAGGAGTTCAAGACCAGCCTGGCCAACATGGTGAAACCCCGTCTCTACTAAAAATACAAAAATTAGCTGGGTGTGGTGGCAGACACCTGTAATTCCAGCTACTTGGGAGGCTGAGGCAGGAGAATAGCTTGAACCTGGGAGGTGAGGGTTGCAGTGAGCCGAGATCGCACCATTTTACTCCAACCTGGGCAACAAGAGCGAAACTCCGTCTCAAAATCCAAACAAACCAAAACAAAAA"
"chr19","8011731","8012413","JH378118","18053084","18053501","321","10041353","GGCCGGGTACAGTGGCTCACTCCTGTAATCCCAGAACTTTGGGAGACCGAGGTGGGGGGATCACTTGAGGTCAGGAGTTCGAGACCACCCTGGCCAATATAGTGCTAAACCCCATCTCTACTCAAAATACAAAAAAAAAAAAAAAAAAAAAAAAAAAGCAAAACCCAGGCTGGGCACAGTAGCTCATACCTGTAATCCCAGCACTTTGGGAGGCTGAGGTGGGTAGATCATGAGGTCAGGAGTTCGAGACCAGCCTGACCAACATGGTGAAACCCCGTCTCTACTAAAAATACAAAAATTAGCCGGGCATGGTGGTGCGTGCCTGTAATCCCAGCTACTCAGGAGGCTGAGGCAGGAGAATCGCTTGAAGCTGGGAGGCAGAGGTTGCAGTGAGCCGAGATCGTGCTACTGTACTCCAGCCTGGGCAACAGGGCGACAGAGCAAGACTCTGTCTCAAAAAAAAAAAAAAAAAAAAAAAAAAGCAAAACCCCATCTCTACTAAAAATACAAAAAATTAGCCAGGCATGGTGGCATGTGCCTGTAATCCCAGCTACTCGAGAGGCTGAGGCAGAAGAATCACTTGAACCCAGGAGGCAGAGGTTGCAGCGAGCCAAGATTGTGCCATTGCACTCCAATCTGGGTGACAAGAGTAAAATCCTGTCTCAAAAAAATAAAAAATAAAA","GGCTGGGCGCAGTGGCTCACACCTGTAATCCCAGCACTTAGGGAAGCTGAGGCGAGTAGATCACCTGAGGTCAGGAGTTAGAGACCAGCCTGGCCATCATGGTGAAACCCCGTCTCTACTAAAGATACCAAAAATTAGCTGAGTGTGGTGCTGGGTGCCTGTAATCCCAGAAACTCAGGGTGCCTGTAATCCCAGCAACTCAGGGTGCCTTTAATCCCAGCAACTGAGGGTACCAGTAATCCCAGCAACTCAGGGTGTCTTTAATCCTAGCAACTGAGGGCACCTGTAATCCCAGCAACTCAGGAAGCTGAGACAGGAGAAGTACTTGAACCCAGAAGGCAGAGGTTGCAGTGAGCCGATATTGCACCATTGCACTCCAGTCTGGGCAACAAGAGTGAAACTCTGTCTCAAAAAAAAA"
"chr19","8026835","8027736","JH378118","18053084","18053501","522","10026249","GCGCGGTGGCTCATGCCTGTAAACCCAGCACTTTGGGAGGCTGAGGTGGGTGGATCACCTGAGGTCAGGAGTTTGAGACCAGCCTGGCCAATATGGTGAAACCCGTCTCTACTAAAACATACAAAAATTAGGCTGGGCGCGGTGGCTCATGCCTTTAATCCCAACACTTTGGGAGGCCGAGGCGGGCGGATCACGAGGTCAGGAGTTTGAGACCATCCTGGCTAACATGGTGAAAGCCCGTCTCTACTAAAAATATAAAAATTAGCTGGGCGTGGTGGTGGGCACCTGGAGTCCCAGCTACTTGGGAGGCTGAGGCAGGAGAATGGCGTGAACCCGGGAGGCGGAGCTTGCAGTGAGCCAGGATCACGCCACTGCACTCCAGCCTGGGCGACAGAGCGAGACACCGTCTCAAAAAAAAAACAACAAAAATTAGCCAGGCATGGTGGTGGGCGCCTTTTTTTTTTTTTTTTTCAGAGTCTCACTCTGTCACCCAGGCTGGAGTGCAGTGGCTCAATCTCGGTTCACTGCAACCTCCGCCTCCCAGGTTCAAGCGATTCTCCTGCCTCAGCCTCCCGAATAACTGGGATTACAGGCACCCGCCACTACAACCAGCTAATTTTTGTATTTTTAGTAGAGATGGGGTTTCGCCATGTTGGCCAGGATGGTCTTGATCTCTTGACCTCGTGATCCACCCTCCTTGGCCTCTCAAAGTGCTGGGATTACAGGTGTGAGCCACTGTTCCCAGCTGATAGTGGGCACTTTTAATCCCAGCTACTCCGGAGGCTGAGGCAGGAGAATTGCTTGAACCCAGGAGGTGGAGGTTGCAGTGAGCCAAGATCGCGCCATTGCACTCCAGCCTGGGTGACAATAGCAAAACTCTGTCTCAATGAAACAAAACAAAA","GGCTGGGCGCAGTGGCTCACACCTGTAATCCCAGCACTTAGGGAAGCTGAGGCGAGTAGATCACCTGAGGTCAGGAGTTAGAGACCAGCCTGGCCATCATGGTGAAACCCCGTCTCTACTAAAGATACCAAAAATTAGCTGAGTGTGGTGCTGGGTGCCTGTAATCCCAGAAACTCAGGGTGCCTGTAATCCCAGCAACTCAGGGTGCCTTTAATCCCAGCAACTGAGGGTACCAGTAATCCCAGCAACTCAGGGTGTCTTTAATCCTAGCAACTGAGGGCACCTGTAATCCCAGCAACTCAGGAAGCTGAGACAGGAGAAGTACTTGAACCCAGAAGGCAGAGGTTGCAGTGAGCCGATATTGCACCATTGCACTCCAGTCTGGGCAACAAGAGTGAAACTCTGTCTCAAAAAAAAA"
"chr19","9069244","9069863","JH378118","18053084","18053501","266","8983840","GGCCGGGCACGGTGGCTCATTCCTGTAGTCTCTGTACTTTAGGAGGCTGAGGTGGGTGGATCACTTGAGGTCAGGAGTTCCAGACCAGTCTGGCCAAAATGGTGAAACCCCGTCTGTACTAAAAATACAAAAAAAAAGGCCGGGCGCGGTGGCTCACGCCTGTAATCCCAGCACTTTGGGAGGCTGAGGTGGGTGGATCACAAGGTCAGGAGATTGAGACCATCCTGGCTAACATGGTGAAACCCCGTCTCTACTAAAAATACAAAAAATTAGCTGAGTGTGGTAGCAGGCACCTGTAATCCCAGCTACTCAGGAGGCTGAGGTGGGAGAATGGCATGAACCCAGGAAGCAGAGCTTGCAGTGAGCTGAGATCATGCCACTGCACTCCAGCCTGGGTGACAGAGCGAGACTCCATCTCAAAAAAAAAAAATACAAAAAAATTAGCCAGGCGTAGTGGTGCATGCTTGTAGTCTCGGCTACTCAGGAGACTGACGCAGGAGAATCACTTGAACCCAGGAGGCGGAGGTTGCAGTGAGCCGAAATTATGCCATTGCACTCCAGCCTGGGAGACAAGAACAAAACTCTATCTCAAAAACCAACCAACCAAACAAACAAAAAAA","GGCTGGGCGCAGTGGCTCACACCTGTAATCCCAGCACTTAGGGAAGCTGAGGCGAGTAGATCACCTGAGGTCAGGAGTTAGAGACCAGCCTGGCCATCATGGTGAAACCCCGTCTCTACTAAAGATACCAAAAATTAGCTGAGTGTGGTGCTGGGTGCCTGTAATCCCAGAAACTCAGGGTGCCTGTAATCCCAGCAACTCAGGGTGCCTTTAATCCCAGCAACTGAGGGTACCAGTAATCCCAGCAACTCAGGGTGTCTTTAATCCTAGCAACTGAGGGCACCTGTAATCCCAGCAACTCAGGAAGCTGAGACAGGAGAAGTACTTGAACCCAGAAGGCAGAGGTTGCAGTGAGCCGATATTGCACCATTGCACTCCAGTCTGGGCAACAAGAGTGAAACTCTGTCTCAAAAAAAAA"
"chr19","9785992","9786608","JH378118","18053084","18053501","261","8267092","GGCCGGGAACGGTGGCTCACACCTATAATCCCAGCACTTTGGGAGGCCGAGGCAGGTGGATCACCTGAGGTCAGGAGTTCAAGACCAGCGTGGCCAACATAATGAAACCCCATCTTGGCCGGGTGCGGTGACTCACGCCTGTAATCCCAGCACTTTGGGAGGCCAAGGCGGGTGGATCACGAGGTCAGGGGATCGAGACCATCCTGGCTAACACAGTGAAACCCTGTCTCTACTAAAAATACAAAAAAATTAGCTGGGCATGGTGGCGGACGCCTGTAGTCCCAGCTACTCGGGAGGCTGAGGCAGGAGAATGGTGTGAACCTGGGAGGCAGAGCTTGCAGTGAGCCGAGATTGCGCCACTGCACTCCAGCTTGGGTGACAAAGTGAGACTCCATCTCAAAAAAAAAAAAAGAAACCCCATCTCTACTAAAAATACAAAAAATTTGCTGGGTGTGGTTGTGGGCACCTGTAATCCCAGCTACTTGGGAGGCTGAGGCAGGAGAATCACCTGAACCCAGGAGGCAGAGGTTGCAGTGAGCCGAAACAGTGCCATTGCACTCCAGCCTGGGCAACAAGAGTGAAACTCAATCTCAAAAAAAAAAAAAAAAGTACAAAAA","GGCTGGGCGCAGTGGCTCACACCTGTAATCCCAGCACTTAGGGAAGCTGAGGCGAGTAGATCACCTGAGGTCAGGAGTTAGAGACCAGCCTGGCCATCATGGTGAAACCCCGTCTCTACTAAAGATACCAAAAATTAGCTGAGTGTGGTGCTGGGTGCCTGTAATCCCAGAAACTCAGGGTGCCTGTAATCCCAGCAACTCAGGGTGCCTTTAATCCCAGCAACTGAGGGTACCAGTAATCCCAGCAACTCAGGGTGTCTTTAATCCTAGCAACTGAGGGCACCTGTAATCCCAGCAACTCAGGAAGCTGAGACAGGAGAAGTACTTGAACCCAGAAGGCAGAGGTTGCAGTGAGCCGATATTGCACCATTGCACTCCAGTCTGGGCAACAAGAGTGAAACTCTGTCTCAAAAAAAAA"
"chr19","9897689","9898264","JH378206","6546474","6546861","233","3351215","GCCAGGCACGGTGGCTCACACCTGTAATCCCAGCACTTTGGGAGGCCAAGGTGGGTGGATCACCTGAGGTCAGGAGTTCAAGACCAGCCTGACCAACATGGTGAAACCCAGGGCTCACACCTGTAATCCCAGCGCTTTGGGAGGCTGACGCGGGCAGATCACGAGGTCAGGAGATCGAGACCATCCTGGCTAACATGGTGAAACCCCGTCTCTACTAAAAATACAATAATTAGCTGGGCATGGTGGTGGGTGCCTGCAGTCCCAGCTACTTGGGAAGCTGAGGCAGGAGAATGGCGTGAACCCAGGAGGTGGAGCTCTCAGTGAGCTGAGATTGCATCACTGCACTTCCAGCCTGGGTGACAGAGCAAGACTCTGTCTCAAAAAAAAAAAAAAAAAAAAAAAAAATTAGCCAGGTGTGATGGCAGGCACCTGTAATCCCAGCTACTTAGGAGGCTGAGGCAGGAGAACCCAGGAGGCAGAGGTTGCAGTGAGCCAAGATCGCGCCATTGCACTCCAGCCTGGGTGACAAGAGCAAAATTCCATCTCAAAAAAAAAAAAAAAGAAGAAAAAGAAGAA","GGCCACACATGGTGGCTAACGCCTGTAATCCCAGCACTTTGGGAGGCCAAGTCGGGTGGATCATGAGGTCAGGAGACCAAGACCATCCTGGCCAAATGGTGAAACCCCGTCTCTACTAAAAATACAAAAATTAGCTGGGCATGGTGGCGTGTGCCTGTAATCCCAGCTACTCAGGAGGCTGAGGCAGGACAATTGCCTGAACCCAGGAGAATTAGCTGGGCATGGTGGCGTGTGCCTGTAATCCCAGCTACTCAGGAGGCTGAGGCAGGACAATTGCCTGAACCCAGGAGGCGAAGGTTGCGGTGAGCCGAGATTGTGCCATTGCACTCCAGCCTGGGTAACAAGAGCGACACTCTGTCTCAAAAAAAAAAAAAAAAAAAAAAAAAAA"
"chr19","10210761","10211695","JH378118","18053084","18053501","553","7842323","GGCCGGGTGTGGTGGCTCATGCCTGTAATCCCAGGCATGATTTGGGAGGCCGAGGGAGGCAGATCACCTGAGGTCAGGAGTTTTTTTGTTTTGTTTTGTTTTGTTTTTGAGACAGAGTCTTGTTCTGTTGCCCAGGCTGGAGTGCAATGATGTGATCTCGACTCACTACAACCTCCACCTCCTGAGTTCAAGCGATTCTGCTGCCTCAGCCTCCCGAGTAGCTGGCATTACAGGCATGTGCCACCAAGCCTGGCTAATTTTTGTATTTATAGTAGAGACGGGGGTTTCACCATGTTGATCAGGCTGGTGTCGAACTCCTGGCCTCAAGTGATCCGCTCGCCTTGGCCTCCCAAAATGCTGGGATTACAGATGTGAGCCACTGTGCCCAGCCAAGGTCAAGAGTTTGAAACCAGCCTGGCCAGCATGGTGAAACCCTATCTCTACTAAAAATACAAAATCAGTCCATGTGCCTAATTTTGGGATCACACCTGGGATCATGCCTGCAATCCCAGCACTTTGGGAGGCCAAGGCGGGTGGGTCATGAAGTCAGGAGTTCAAGACCAGCCTGGCCAACATGGTGAAACCCTGTCTCTACTAAAAATACAAAAGTTAGCTGGGCGTGGTGGCACGCACCTGTAGTCCCAGCTACTAGGAAGGCTGAGGCAGGAGAATTCTTGAACCCGGGTGATGGAGGTTGCAGTGAGCCGAGATTGCGCCACTGCACTCCAGCCTGGGCAACAGAGTGAGACTCTGTCTAAAAAAAAAATTAGTCAGGCGTGGTGGTGAGCACCTGTAATCACAGCTACTGGGGAGGCTGAGGCTGGAGAATTGCTTGAACCCGGGAGGCGGAGGTTGCAGTGAGCCAAGATCGCGCCTTTGCACTCCAGCCTGGGCAACAGGAGTGAAACTGCATCTCAAAAAAAAAAAAAAAAAAA","GGCTGGGCGCAGTGGCTCACACCTGTAATCCCAGCACTTAGGGAAGCTGAGGCGAGTAGATCACCTGAGGTCAGGAGTTAGAGACCAGCCTGGCCATCATGGTGAAACCCCGTCTCTACTAAAGATACCAAAAATTAGCTGAGTGTGGTGCTGGGTGCCTGTAATCCCAGAAACTCAGGGTGCCTGTAATCCCAGCAACTCAGGGTGCCTTTAATCCCAGCAACTGAGGGTACCAGTAATCCCAGCAACTCAGGGTGTCTTTAATCCTAGCAACTGAGGGCACCTGTAATCCCAGCAACTCAGGAAGCTGAGACAGGAGAAGTACTTGAACCCAGAAGGCAGAGGTTGCAGTGAGCCGATATTGCACCATTGCACTCCAGTCTGGGCAACAAGAGTGAAACTCTGTCTCAAAAAAAAA"
"chr19","10485431","10486007","JH378118","18053084","18053501","237","7567653","GGCCGGGCGCAGTGGCTCATGCCTAATCCCAAGACTTTCAGAGGCTGAGGCAGGTGGATCACCTGAGGTCAGGAGCTCAAGACCAGCCTGGCTAACATTGTGAAACCGCGTCTCTACTAAAAATCAAAATTGGCCGGGCACGGTGGCTCACACCTGTAATCCCATCCCTCTGGGAGACCGAGGCGGGCAGATCACCTAAGGTCAGGAGTTCGAGACCAGCCTGACCAACATGGAGAAAACCCTTCTCTGCTAAAAATACAAAATTAGCCGGGCGTGGTGGCGCATGCCTGTAACCTCAGCTACTCGGGAGGCTGAGGGAAAATCGCTTGAACCTGCCAGGTGGAGGTTGCAGTGAGCCGAGATCGAGCCATTGCACTCCAGCATGGGCAACGAAAGCGAAACTCCATCTCAAAAAAAAAAAAAATTAGCTAGGCGTGGTGGCGCGTGCCTGTATTCCCAGCTACTCAGGAGGCTGAGACAGGAGAATCACTTGAACCTGGGAGGCAGAGGTTGCAGTGAGCCAAGATTGCACCATTGCACTCCAGCCTGGGCAACACGAGCAAAACTCTGTCTCAAA","GGCTGGGCGCAGTGGCTCACACCTGTAATCCCAGCACTTAGGGAAGCTGAGGCGAGTAGATCACCTGAGGTCAGGAGTTAGAGACCAGCCTGGCCATCATGGTGAAACCCCGTCTCTACTAAAGATACCAAAAATTAGCTGAGTGTGGTGCTGGGTGCCTGTAATCCCAGAAACTCAGGGTGCCTGTAATCCCAGCAACTCAGGGTGCCTTTAATCCCAGCAACTGAGGGTACCAGTAATCCCAGCAACTCAGGGTGTCTTTAATCCTAGCAACTGAGGGCACCTGTAATCCCAGCAACTCAGGAAGCTGAGACAGGAGAAGTACTTGAACCCAGAAGGCAGAGGTTGCAGTGAGCCGATATTGCACCATTGCACTCCAGTCTGGGCAACAAGAGTGAAACTCTGTCTCAAAAAAAAA"
"chr19","10538873","10539199","JH378118","15020968","15021286","46","4482095","GCTGGGCGCGGTGGCTCACGCCTGTAATCCCAGCACTTTGGGAGGCTGAGGCAGGCAGATCACCTGAGGTCAGGAGTTCAAGACCAGCCTGGTTAACACAGTGAAACCCCCGTCTCTACTAAAAATACAAAAACAAAAATTAGCCGGGTGTGGTGGCGGGCGCCTGTAATCCCAGTTACTCGGGAGGCTGAGGCAGGAGAATCGCTTGAACCCGGGAGGCGGAGGTTGTGGTGAGCCGAGATTGCCATTGCACTCCAGCCTGGGCAAAAAGAGCGAAACTCCATCTAAAACAAACAAACAAACAAACAAACAAAAAATAGAAAAGAA","GCCGGGCGCGGTGGCTCAAGCCTGTAATCCCAGCACTTTGGGAGGCTGAGGCGGGTGGATCCCGAGGTCAAGAGATCGAGACCATCCTGGTCAACATGGTGAAACCCCGTCTCTACTAAAAATACAAAACATTAGCTGGGTATGGTGGCGCGTGCCTGTAATCCCAGCTACTCAGGAGGCTGAGGCAGGAGAATTGCCTGAACCCAGGAGGCGGAGGTTGCGGTGAGCTGAGATCGCGCCATTGCACTCCAGCCTGGGTAACAAGAGCGAAACTTCCATCTCAAAAACAAACAAACAAACAAACAAACAAAAAACAAAC"
"chr19","10973032","10973651","JH378118","18053084","18053501","265","7080052","GGCTGGACGTGGTGGCTCACGCCTGTAATCCCAACACTTTGGGAGACCAAGGCAGGTGGATCGCCTGAGGTTAGGGGTTCGAGACCAGCCTGACCAACATGGTGAAACCCCATCTCTACTAATAATAAAAAAATTAGGACCAGGCTTGGTGGCTCATGCCTGTAATTCCAACACTTTGGGAGGCCAAGGCGAGTGGATAACTTGAGGTCAGGAGTTTGAGACCAGCCTGGCCAACATGGTGAAACCTCATCTCTACTAAAAATACAAAAATTAGCCGGCATGGTGGCGGGCACCCGTAATCCCAGCTACTCGGTGTGGGGGCTGGGACAGGAGAATCGCTTGAACCCAGGAGGTGGAGGTTGCCGTGAGCTAAGATTGCGCCACTGCACTCTAGTTGGGGCAACAGAGCGGACTCCGTCTCAAAAAAAAAAAAAAAATTAGCCGAGCGTGGTGGTGGACACCTGTAATCCCAGCTACTCAGGAGGCTGAGGCAGGAAAATTGAAATCGCTTAAACCTGGGAGGAGGAGGTTGCAGTGAGCCAAGATCGCACCATTGCACTCCAGCCTGGGCGACAAGAACAAAACTCCGTCTCCCCACTCCAAAAAAAAAAAAAAAAAAA","GGCTGGGCGCAGTGGCTCACACCTGTAATCCCAGCACTTAGGGAAGCTGAGGCGAGTAGATCACCTGAGGTCAGGAGTTAGAGACCAGCCTGGCCATCATGGTGAAACCCCGTCTCTACTAAAGATACCAAAAATTAGCTGAGTGTGGTGCTGGGTGCCTGTAATCCCAGAAACTCAGGGTGCCTGTAATCCCAGCAACTCAGGGTGCCTTTAATCCCAGCAACTGAGGGTACCAGTAATCCCAGCAACTCAGGGTGTCTTTAATCCTAGCAACTGAGGGCACCTGTAATCCCAGCAACTCAGGAAGCTGAGACAGGAGAAGTACTTGAACCCAGAAGGCAGAGGTTGCAGTGAGCCGATATTGCACCATTGCACTCCAGTCTGGGCAACAAGAGTGAAACTCTGTCTCAAAAAAAAA"
"chr19","11513769","11514351","JH378206","6546474","6546861","242","4967295","TCCCAGCACTTTGGGAGGCCGCGATGGGTGGATCACCTTAGGTCAGGAATTCGAGACCATCCTGGCCAACATGGTGAAACCCCGTCTCTACTAAAAACACAAAAATTAGGCCGGGCACGGTGGCTCACATCTGTAATCCCAGCACTTTGGGAGGCTGAGGTGGGCGGATCACAAGGTCAGGAGTTCAAGACCAGCCTGGCCAACATGGTGAAACCCTGTCTCTACTAAAAATACAAAAATTAACTGGGCATGGTGGCATGTGCCTGTAATCCCAGCTACTTGGGAGGCTGAGGCAGAAGAATTGCTTGAACCAGGGAGTCAGAGGTTATAGTGAGCTGAGATCGTGCGACTGCACTCCAGCCTGGTGACAGAGCGAGACTCCGTTTCAGGAAAAACAAACAAAACACAAAAATTAGCTGGGCATGGTGGCAGGCGCCTGTAATCCTAGCTACTTGGGAGGCTGAGGCAGGAGAATCGCTTGAACCCAGAAGGCAAAGGTTGCAGTGAGCTGAGATGATGCCATTGCACTCCAGCCTGGGCAACAAGTGAAACTCTGTCTCAAGAAAAAAAGTAAAAGAAAGAA","GGCCACACATGGTGGCTAACGCCTGTAATCCCAGCACTTTGGGAGGCCAAGTCGGGTGGATCATGAGGTCAGGAGACCAAGACCATCCTGGCCAAATGGTGAAACCCCGTCTCTACTAAAAATACAAAAATTAGCTGGGCATGGTGGCGTGTGCCTGTAATCCCAGCTACTCAGGAGGCTGAGGCAGGACAATTGCCTGAACCCAGGAGAATTAGCTGGGCATGGTGGCGTGTGCCTGTAATCCCAGCTACTCAGGAGGCTGAGGCAGGACAATTGCCTGAACCCAGGAGGCGAAGGTTGCGGTGAGCCGAGATTGTGCCATTGCACTCCAGCCTGGGTAACAAGAGCGACACTCTGTCTCAAAAAAAAAAAAAAAAAAAAAAAAAAA"
"chr19","11535200","11535780","JH378206","6546474","6546861","242","4988726","TCCCAGCACTTTGGGAGGCCGCGATGGGTGGATCACCTTAGGTCAGGAATTCGAGACCATCCTGGCCAACATGGTGAAACCCCGTCTCTACTAAAAACACAAAAATTAGGCCGGGCACGGTGGCTCACATTGTAATCCCAGCACTTTGGGAGGCTGAGGTGGGCGGATCACAAGGTCAGGAGTTCAAGACCAGCCTGGCCAACATGGTGAAACCCTGTCTCTACTAAAAATACAAAAATTAACTGGGCATGGTGGCATGTGCCTGTAATCCCAGCTACTTGGGAGGCTGAGGCAGAAGAATTGCTTGAACCAGGGAGTCAGAGGTTATAGTGAGCTGAGATCGTGCGACTGCACTCCAGCCTGGTGACAGAGCGAGACTCCGTTTCAGGAAAAACAAACAAAACACAAAAATTAGCTGGCATGGTGGCAGGCGCCTGTAATCCTAGCTACTTGGAGGCTGAGGCAGGAGAATCGCTTGAAACCCAGAAGGCAAAGGTTGCAGTGAGCTGAGATGATGCCATTGCACTCCAGCCTGGGCAACAAGTGAAACTCTGTCTCAAGAAAAAAAGTAAAAGAAAGAA","GGCCACACATGGTGGCTAACGCCTGTAATCCCAGCACTTTGGGAGGCCAAGTCGGGTGGATCATGAGGTCAGGAGACCAAGACCATCCTGGCCAAATGGTGAAACCCCGTCTCTACTAAAAATACAAAAATTAGCTGGGCATGGTGGCGTGTGCCTGTAATCCCAGCTACTCAGGAGGCTGAGGCAGGACAATTGCCTGAACCCAGGAGAATTAGCTGGGCATGGTGGCGTGTGCCTGTAATCCCAGCTACTCAGGAGGCTGAGGCAGGACAATTGCCTGAACCCAGGAGGCGAAGGTTGCGGTGAGCCGAGATTGTGCCATTGCACTCCAGCCTGGGTAACAAGAGCGACACTCTGTCTCAAAAAAAAAAAAAAAAAAAAAAAAAAA"
"chr19","12911527","12912140","JH378118","18053084","18053501","266","5141557","GGCCAGGCATGGTGGCTCATGCCTGTAATCCAGCACTTTGGTAGGCCAAGGTGGGTGGATGGATTACTTGAGGCCAGGAGTTCAAGACCAACCTGGCCAACATGGTGAAAACCCATCTCTATTAAAAATATAAAAGCTAGGCCAGGTGCGGTGGCTCACGCCTGTAATCCCAGCACTTTGGGAGGCTGAGGCGGGCGGATCACGAGGTCAGGAGATCGAGACCACTGTGAAACCCTGTCTCTACTAAAAATACAAAAAAAATTAGCTGGGTGGGGTGGCGGGTGCCTGTAGTCCCAGCTACTTGGGAGGCTGAGGCAGGAGAATGGCGTGAACCCGGGAGGCGGAGCTTGCAGTGAGCCGAGATCGCGCCACTGCACTCCAGCCTGGGCTACAGAGCAAGACTCCGTCTCAAAAAAAAAATAAATAAATAAATAAAAATAAAAACTAACTGGGCATGGTGGTGTGCACCTGTAATCCCAGCTACTCGGGAGGCTGAGACAGGAGAATTGCTTGAACCTGGGAGGTGGAGGTTGCAGTGAACCAAGATGATGCCATTGCACTCCAACCTGGGCAACAAGAGCAAAACTCCGTCTCAAAAAAAAAAAAAAAAAAAA","GGCTGGGCGCAGTGGCTCACACCTGTAATCCCAGCACTTAGGGAAGCTGAGGCGAGTAGATCACCTGAGGTCAGGAGTTAGAGACCAGCCTGGCCATCATGGTGAAACCCCGTCTCTACTAAAGATACCAAAAATTAGCTGAGTGTGGTGCTGGGTGCCTGTAATCCCAGAAACTCAGGGTGCCTGTAATCCCAGCAACTCAGGGTGCCTTTAATCCCAGCAACTGAGGGTACCAGTAATCCCAGCAACTCAGGGTGTCTTTAATCCTAGCAACTGAGGGCACCTGTAATCCCAGCAACTCAGGAAGCTGAGACAGGAGAAGTACTTGAACCCAGAAGGCAGAGGTTGCAGTGAGCCGATATTGCACCATTGCACTCCAGTCTGGGCAACAAGAGTGAAACTCTGTCTCAAAAAAAAA"
"chr19","13205284","13205895","JH378118","18053084","18053501","258","4847800","GCCAGGCGCAGTGGATTACGCCTGTAATCCCAGCGCTTTGGTATACCGAGGCGGGCAGATCGTCTGAGGTCAGGAGTTCAAGACCAGCCTGGAGAACATGGTGAAACCCCGTCTCTATTAAAAATACAGGCTGGGCGCGGTGGCTTACGCCTGTAATCTCAGCACTTTGGGAGGCCAAGGCGGGTGGATCACGAGGTCAGGAGATCGAGACCATCCTGGCTAACATGGTGAAACCCTGTCTCTACTGAAAATACAAAAAAATTAGTTGTGGTGGGTGCCTGTAATCCCAGCTACTCGGGAGGCTGAGGCAGGAGAATGGCGTGAACCCGGGAAGCAGAGATTGCAGTAAGCCAAGATCGCTCCACTGCACTCCAGCCTGGGCTACAGAGCAAGACTCCATCTCAAAAAAAAATAAATAAATAAAATAAAAAATTAGCCTGGCGTGGTGGCGCATGCCTGTAATCCCAGCTACTTGGGAGGCTGAGGCAGGAGAATTGCTTGAACCCAAGAGGTGGAGGTTGCAGTGAGTCGAGATTGAGCCATTGCCATCCAGCCTGGGCAACAAGAGTGAAACTCTGTCTCAAAAAAAAAGAGAGAGAAAAGAAAGTAAAA","GGCTGGGCGCAGTGGCTCACACCTGTAATCCCAGCACTTAGGGAAGCTGAGGCGAGTAGATCACCTGAGGTCAGGAGTTAGAGACCAGCCTGGCCATCATGGTGAAACCCCGTCTCTACTAAAGATACCAAAAATTAGCTGAGTGTGGTGCTGGGTGCCTGTAATCCCAGAAACTCAGGGTGCCTGTAATCCCAGCAACTCAGGGTGCCTTTAATCCCAGCAACTGAGGGTACCAGTAATCCCAGCAACTCAGGGTGTCTTTAATCCTAGCAACTGAGGGCACCTGTAATCCCAGCAACTCAGGAAGCTGAGACAGGAGAAGTACTTGAACCCAGAAGGCAGAGGTTGCAGTGAGCCGATATTGCACCATTGCACTCCAGTCTGGGCAACAAGAGTGAAACTCTGTCTCAAAAAAAAA"
"chr19","14119695","14120238","JH378206","6546474","6546861","206","7573221","ACCAGCCTGGCCAAAATGGTGAAACCCTGTCTCTACTAAAAATATTTAAAAATTGGCCAGGTGCGGTGGCTCACGCCTGTAATCCCAGCACTTTGGGAGGCCGAGGCGGGCGGATTACAAGGTCAGGAGATCGAGACCATCCTGACTAACATGGTGAAACCCCGTCTCTACTAAAAATACAAAAAATTGGCCGGGCGTGGTAGCGGGCGCCTGTAGTTCCAGCTACTCGGGAGGCTGAGGCAGGAGAATGGCGTGAACCCGGAAGGCAGAGCTTGCAGTGAGCCAAGATCGTGCCACTGCACTCCAGCCTGAGCGACAGAGCAAGACTCCATCTCAAAAAAAAAAAAAAAAAAAAAAAAAATTAAAAAATTAGCTGGGCGTGGTAGCCGGCACCTGTAATTCCAGCTACTCAGGAGGCTGGAGCACAAGAATCGCTTGAAACCAGGAGGCAGAGTTGTAGTGAGCCGAGATCGTGCCATTGCACTCCAGCCTGGGCATCAAGAGCGAAACTCCATCTCAAAAACAAAACAAAACAAAACAAAAA","GGCCACACATGGTGGCTAACGCCTGTAATCCCAGCACTTTGGGAGGCCAAGTCGGGTGGATCATGAGGTCAGGAGACCAAGACCATCCTGGCCAAATGGTGAAACCCCGTCTCTACTAAAAATACAAAAATTAGCTGGGCATGGTGGCGTGTGCCTGTAATCCCAGCTACTCAGGAGGCTGAGGCAGGACAATTGCCTGAACCCAGGAGAATTAGCTGGGCATGGTGGCGTGTGCCTGTAATCCCAGCTACTCAGGAGGCTGAGGCAGGACAATTGCCTGAACCCAGGAGGCGAAGGTTGCGGTGAGCCGAGATTGTGCCATTGCACTCCAGCCTGGGTAACAAGAGCGACACTCTGTCTCAAAAAAAAAAAAAAAAAAAAAAAAAAA"
"chr14","584088","584429","JH378109","21565230","21565567","54","20981142","GGCCGGGTACGGTGGCTCACGCCTGTAGTCCTGGCACTTTGGGAGGCCGAGGCAGGTGGATCCCCGAGGTCACGAGTTTGAGACCAGCCTGGCCAGCATGGTGAAATCCCATCTCTACTAAAAATACAAAACTTAGCCGGGCATGGTGACGTGTGCCTGTAATCCCAGCTACTTGGGAGGCTGAGGCAGGAGAATTGCTTGAACCAGGGAGGCAGAGGTTGCAGTGAGCTGAGATCATGAAACTGCAGTCCAGTCTAGGCGACAAGAGCAAAACTCCGTCTCAAAAAAATAAATAAATAAATAAATAAATAAAAAATAAAACAAACAACAAAAAAAACAAAA","GGCCGGGCGCGGTGGCTCAAGCCTGTAATACCAGCACTTTGGGAGGCCGAGGCGGGTGGATCACGAGGTCAAGAGATCGAGACCATCCTGGTCAACATGGTGAAACCCCGTCTCTACTAAAAATACAAACAATTAGCTGGGCATGGTGGCGGGTGCCTGTAATCCCAGCTACTCCAGAGGCTGAGGCAGGAGAATTGCCTGAACCCAGGAGACGGAGGTTGCGGTGAGCCAAGATCGCGCCATTGCACTCCAGCCTGGGTGACAAGAGCGAAACTCCGTCTCAATAAATAAATAAATAAATAAATAAATAAAAATAAAATAAATAAATAAATAAATAA"
"chr14","620575","620915","JH378109","21565230","21565567","56","20944655","GGCCGGGTACGGTGGCTCACGCCTGTAGTCCTGGCACTTTGGGAGGCCGAGGCAGGTGGATCCCCGAGGTCACGAGTTTGAGACCAGCCTGGCCAGCATGGTGAAATCCCATCTCTACTAAAAATACAAAACTTAGCCGGGCATGGTGACGTGTGCCTGTAATCCAGCTAACTTGGGAGGCTGAGGCAGGAGAATTGCTTGAACCAGGGAGGCAGAGGTTGCAGTGAGCTGAGATCATGAAACTGCAGTCCAGTCTAGGCGACAAGAGCAAAACTCCGTCTCAAAAAATAAATAAATAAATAAATAAATAAAAAATAAAACAAACAACAAACAAAACAAAA","GGCCGGGCGCGGTGGCTCAAGCCTGTAATACCAGCACTTTGGGAGGCCGAGGCGGGTGGATCACGAGGTCAAGAGATCGAGACCATCCTGGTCAACATGGTGAAACCCCGTCTCTACTAAAAATACAAACAATTAGCTGGGCATGGTGGCGGGTGCCTGTAATCCCAGCTACTCCAGAGGCTGAGGCAGGAGAATTGCCTGAACCCAGGAGACGGAGGTTGCGGTGAGCCAAGATCGCGCCATTGCACTCCAGCCTGGGTGACAAGAGCGAAACTCCGTCTCAATAAATAAATAAATAAATAAATAAATAAAAATAAAATAAATAAATAAATAAATAA"
"chr14","1107083","1107723","JH378118","18053084","18053501","303","16946001","GGCGTGGTGGCTCACACCTGTAATCCCAGCACTTCAGGAGGCCAAGGCAGGTAGATTGCTTGATCACAGGAGTTCAAACCAGCCATGGGCAATGTCAGGCCTCTGAGCCCAAGCTTGCACGTATCCAGATGGCCTGAAGCAACTGAAGAATCACAAAAGAAGTGAAAACAGCCAGTTCCTTCCTTAACTGATGACATTACCTTGTGAAATTCCTTCTCCTGGCTCAGAAGCTCCCCTACTGAGCACCTTGTGACCCCTGCCCCTGCCAGCCAGAGAACAATCCCCTTTGACTGTAATTTTCCACTACCTACCCAAATCCTATAAAACAGCCCCACCCCATCTCCCTTTGCTGACTCCTTTTTCGGACTAGGTCCGCCTGCACCCAGGTGATTAAAAAGCTTTATTGCTCACACAAAGCCTGTTGGTGGTCTCTTCACACGGACGCACGTGACAGGCAACATGGTGAAACCCTATCTCTATAAAAAAATAAAAATAAAAATTAGTTGGGCGTGGAGACTGAGGTGAGAGAATCCAGAGGATCCAAGAGGATCGAGTCAAGGAGGTGGAGGCCGCAGTGAGCCGAGATCGCACCGCTGCACTCCAGCCTGGGCGACAAGAGTGAAACTCTGTCTTAAAAAAAA","GGCTGGGCGCAGTGGCTCACACCTGTAATCCCAGCACTTAGGGAAGCTGAGGCGAGTAGATCACCTGAGGTCAGGAGTTAGAGACCAGCCTGGCCATCATGGTGAAACCCCGTCTCTACTAAAGATACCAAAAATTAGCTGAGTGTGGTGCTGGGTGCCTGTAATCCCAGAAACTCAGGGTGCCTGTAATCCCAGCAACTCAGGGTGCCTTTAATCCCAGCAACTGAGGGTACCAGTAATCCCAGCAACTCAGGGTGTCTTTAATCCTAGCAACTGAGGGCACCTGTAATCCCAGCAACTCAGGAAGCTGAGACAGGAGAAGTACTTGAACCCAGAAGGCAGAGGTTGCAGTGAGCCGATATTGCACCATTGCACTCCAGTCTGGGCAACAAGAGTGAAACTCTGTCTCAAAAAAAAA"
"chr14","1362660","1363231","JH378118","18053084","18053501","229","16690424","GGCTGGGCACAGTGGCTTATACCCATAATCTCAGCAGTTTGGGAGGCCAAGGCAGGTGTATCACCTGAGGTCAGGAGTTCGAGAAACACCATGGCCAACATGGTGAAACCCCATCTCTACTAAAAATACAAAAAGTAGGCTGGGCGTGGTGGCTCACGCCTGTAATCCCAGTACTTTGGGAGGCCGAGGCGGGCGGATCACAAGGTCAGGAAACCGAGACCATCCTGACTAACATGGTGAAACCCCGTCTCTACTAAAAATACAAAAAAAGCTAGCCGGGCATGGTGGCGGGTGCCTGTAGTCCCAGCTACTCGGGAGGCTGAGGCAGGAGAATGGCGTGACCCCAGGAGGCAGAGCTTCCAGCTTGGGTGACTCCGTCTCAAAAAAAAAAAAACAAAAACAAAAAGTAGCTGGACGTGGTGGCTGTAGACCTAGCTACTCGAGAGGCTGAGGCAGGAGAATCGCTTGAACCTAGGAGGCGGAGGTTGCGGTGAGCCGAGATCACGCTTCTGCACTCCAGCCTGGGTGACAAGAGCAAAACTCCATCTCCAAAAAAAAAAAACAAAAAAAAA","GGCTGGGCGCAGTGGCTCACACCTGTAATCCCAGCACTTAGGGAAGCTGAGGCGAGTAGATCACCTGAGGTCAGGAGTTAGAGACCAGCCTGGCCATCATGGTGAAACCCCGTCTCTACTAAAGATACCAAAAATTAGCTGAGTGTGGTGCTGGGTGCCTGTAATCCCAGAAACTCAGGGTGCCTGTAATCCCAGCAACTCAGGGTGCCTTTAATCCCAGCAACTGAGGGTACCAGTAATCCCAGCAACTCAGGGTGTCTTTAATCCTAGCAACTGAGGGCACCTGTAATCCCAGCAACTCAGGAAGCTGAGACAGGAGAAGTACTTGAACCCAGAAGGCAGAGGTTGCAGTGAGCCGATATTGCACCATTGCACTCCAGTCTGGGCAACAAGAGTGAAACTCTGTCTCAAAAAAAAA"
"chr14","2088506","2089110","JH378118","18053084","18053501","257","15964578","GGCTGGGCACTGCGGCTCACACCTGTAATCCCAGCATTTTGAGAGGCCTAGGTGGGTGGATCACCTGAGATCAGTTCAAGACCAGCCTGACCAACATGGCAAAACCCCATCTCTATTAAAAACACAAAAAACGCCCAGGAGCGGTGGCTCACACCTGTAATCCCGGCACTTTGGGAGGCTGAGGCAGGCGGATCACGAGGTCAGGAGATCGAGACCATGCTGGCTAACACGGTGAAACCCCGTCTCTACTAAAAATACAAAAAATTAGCCAGGCGTGGTGTCGGGCGCCTGTAGTCCCAGCTATTCGGGAGGCTGAGACAGGAGAATGGCATGAACCCGGGAGGCAGAGCTTGCAGTGAGCTGAGATCGCGCCACTGCACTCCAGCCTGGGCGACAGAGTAAGACTCTGTCTCAAAAAAAAAAATACAAAAAATACAAAAAACATTAGCCACATGTGGTGGTGGGTGCCTGTAATCCCAGCTACTCAGGAGGCTGAGGCTGGAGAATTGCTTGAACCCAGGAGGTGGAGGTTGTGGTGAGCCAAGATCACGCCATTGCATTCCAGCCTGGGTGACAAGAGTGAACCTCTGTCTCAAAAAAAAGAA","GGCTGGGCGCAGTGGCTCACACCTGTAATCCCAGCACTTAGGGAAGCTGAGGCGAGTAGATCACCTGAGGTCAGGAGTTAGAGACCAGCCTGGCCATCATGGTGAAACCCCGTCTCTACTAAAGATACCAAAAATTAGCTGAGTGTGGTGCTGGGTGCCTGTAATCCCAGAAACTCAGGGTGCCTGTAATCCCAGCAACTCAGGGTGCCTTTAATCCCAGCAACTGAGGGTACCAGTAATCCCAGCAACTCAGGGTGTCTTTAATCCTAGCAACTGAGGGCACCTGTAATCCCAGCAACTCAGGAAGCTGAGACAGGAGAAGTACTTGAACCCAGAAGGCAGAGGTTGCAGTGAGCCGATATTGCACCATTGCACTCCAGTCTGGGCAACAAGAGTGAAACTCTGTCTCAAAAAAAAA"
"chr14","2164771","2165383","JH378118","18053084","18053501","243","15888313","GGCTGGGCGCAGTGGCTCACACCTGTAATCCCAGCACTCTGGGAGGCCAAGGCAGGTGGATCACCTGAGGTCAGGAGTTCGAGACCAGCCTGGCCAACATGGTGAAACCCCATCTTTACTAAAAATACAAAAATTAGCTAGGCGTGAGGCCGGGCGTGGCGGCTCATGCCTGTAATCCCAGCACTATGGGAGGCTGAGGCAGGCTGATCATGAGGTCAGGAGATTGAGACCTGGCTAACACAGTGAAACCCCGTCTCTACTAAAAATACAAAAAAAAAATAGCCAGGCATGATGGCAGGCTCCTGTAGTCCCAGCTTCTTGGGAGGCTGAGGCAGGAGAATGGTGTGAACCCGGGAGGCAGAGCTTGCAGTGAGCCGAGATCATGCCACTGCACTCCAGCCTGGGTGACAGAGCAAGACTCTGTCTCAAAAAAAAAAAAAAAAAATTAGCTAGGCGTGGTGAGGGGCACCTGGAATCCCAGCTACTCAGGAGGCTGAGGCAGGAGCATCGTTTAAACCCAGGAGGCAGAGGTTGCAGTGAGCCGAAATCACACCATTGCACTCCAGCCTGGGCAACAAGAGCAAGTCTCCATCTTAAAAAAAAAAAAAAAAAA","GGCTGGGCGCAGTGGCTCACACCTGTAATCCCAGCACTTAGGGAAGCTGAGGCGAGTAGATCACCTGAGGTCAGGAGTTAGAGACCAGCCTGGCCATCATGGTGAAACCCCGTCTCTACTAAAGATACCAAAAATTAGCTGAGTGTGGTGCTGGGTGCCTGTAATCCCAGAAACTCAGGGTGCCTGTAATCCCAGCAACTCAGGGTGCCTTTAATCCCAGCAACTGAGGGTACCAGTAATCCCAGCAACTCAGGGTGTCTTTAATCCTAGCAACTGAGGGCACCTGTAATCCCAGCAACTCAGGAAGCTGAGACAGGAGAAGTACTTGAACCCAGAAGGCAGAGGTTGCAGTGAGCCGATATTGCACCATTGCACTCCAGTCTGGGCAACAAGAGTGAAACTCTGTCTCAAAAAAAAA"
"chr14","3757666","3758004","JH378113","23438980","23439304","67","19681314","CTGGGCATGGTGGCTCATGCCTGTAATCCCAGCACTTTGGGAGACAGAGGAGGGCAGATCATCTGAGGTCAGGAGTTTGAGACCAGCCTGGCCACCATGGTGAAACCCCCGTCTCTACTGAAAATACAAAAAAATTCAGCTGGGTGTGGTAGTGGATGTCTGTAATCCTAGCTGCTTGGGAGGCTGAGACAGGAGAATCGCTTGAACCCGGGAGGTGGAGGTTGCAGTGAGCCGCCATTGCGCTCCAGCCTGGGCAACAAGAGCGAAACTCCATCTCAAAAATTAATTAATTAATTAATTAATTAAAAGTGGACTAAAGCAAAGACAAGAGAAAAAAGA","GGCAGGGTGTGGTAGCTCATGCTTGTAATCCCAGCACTTTGGGAAGTGGAGGCGGGCAGATCATCTGAGGTCAGGAGTTTGAGGCCAGCCTGGCCAACATGGTGAAACCCTGTCTCTACTAAAAATACAAAAAATTAACTGGGCGTGGTGGTGGACACCTGTAATCCCAGCTGCTTGGGAGGCTGAGGCAGGAGAATCGCTTGAACCCAGGAGATGGAGGTTGCAGTGAGCCAAGATGGCACCATTGCACTCTAGCCTGGGCAAAAAGAGTGAAACTCCGTCTCAAAAAAAAAAAAGAAAAGAAAAGAAAAGAAAAGAAAAGAAA"
"chr14","10702105","10702681","JH378118","18053084","18053501","246","7350979","GGCCAGGCGCAATGGCTCACACCTGTAATCCAAGCACTTTGGGAGGCCAGTTCAAGACCAGCCTGGCCAACATGGTGAAAACCTGTCTCTGCTAAAAATGCCAAATTTCCCAGCACTTTGGGAGGCTGAGGCGGGTGGATCACGAGGTCAGGAGATTGAGACCATCCCGGCTAACACGGTGAAACCCCATCTCTACTAAAAATAGAAAAAAATTAGCCGGGCGTGGTGGCAGACGCCTGTAGTCCCAGCTACTCTGGAGGCTGAGGGAAGAGAATGGCATAAACCCGGGAGGCGGAGCTTGCAGCGAGCTGAGATTGCGCCACTGCACTCCAGCCTGGGCGACAGAGCAAGACTCCGTCTCAAAATAAATAAATAAATAAAATTAAAATTAAAAATAAAATACAAAATTTAGCCGAGCATGGTGGTGAGCACCTATAATCCCAGCTACTTGGGAGGCTGAGGCAGAAGAATCTCTTGAACCAGGGAAGTGGAGGTTGCAGTGGGCTGAGATCCAGCCACTGTACTCCAGCCTGGGCGACAAAAGCGAAACACTGTCTAAAAAAATAAAAAATAAAAA","GGCTGGGCGCAGTGGCTCACACCTGTAATCCCAGCACTTAGGGAAGCTGAGGCGAGTAGATCACCTGAGGTCAGGAGTTAGAGACCAGCCTGGCCATCATGGTGAAACCCCGTCTCTACTAAAGATACCAAAAATTAGCTGAGTGTGGTGCTGGGTGCCTGTAATCCCAGAAACTCAGGGTGCCTGTAATCCCAGCAACTCAGGGTGCCTTTAATCCCAGCAACTGAGGGTACCAGTAATCCCAGCAACTCAGGGTGTCTTTAATCCTAGCAACTGAGGGCACCTGTAATCCCAGCAACTCAGGAAGCTGAGACAGGAGAAGTACTTGAACCCAGAAGGCAGAGGTTGCAGTGAGCCGATATTGCACCATTGCACTCCAGTCTGGGCAACAAGAGTGAAACTCTGTCTCAAAAAAAAA"
"chr14","11790883","11791455","JH378118","18053084","18053501","226","6262201","GGCTGGGTGGCCATGGCTCATGCCTGTAATCCTAGAACTTTGGGAGGCTGCGGCAGGCAAATCACCTGAAGTCAGGAGTTCAAGACCAGCCTGGCCAACATACTGAAACCCCGTCTCTCCAGGCCTGGTGGCTCATGCCTGTAATCCCAGCACTTTGGAAAGCCGAGGTGGGCGGATCACCTGAGGTCAGGAGTTCAAGACCAGTCTGACCAACATGGGGAAACCCCATCTCTACTAAAAATACAAAATTAGCTGGATGTGGTGGCACATGCCTGTATTCCCAGCTACTTGGGAGGCTGAGGCAGGAGAATCGCTTGATCCCGAGAGGTGGAGCTTGCCGTGAGCTGAGATTGTGCGCCATTGCACTCCAGCCTGGGCAACAAGAGTGAAACTCCGTCTCTACTAAAAATACAAAAATTAGCCGGGTGTGGTGGCGGGTGCCTGTAATCCAAGCTACTCGGGAGGCTAAGGCAGGAGAATTGCTTGAACCCACGAGGCCGAGGTTGCAGTGAGCCGAGATTGCACTATTGCACTCCAGCCTGGGCGACAAGAGTGAGACTGTGTCTCAAAAAA","GGCTGGGCGCAGTGGCTCACACCTGTAATCCCAGCACTTAGGGAAGCTGAGGCGAGTAGATCACCTGAGGTCAGGAGTTAGAGACCAGCCTGGCCATCATGGTGAAACCCCGTCTCTACTAAAGATACCAAAAATTAGCTGAGTGTGGTGCTGGGTGCCTGTAATCCCAGAAACTCAGGGTGCCTGTAATCCCAGCAACTCAGGGTGCCTTTAATCCCAGCAACTGAGGGTACCAGTAATCCCAGCAACTCAGGGTGTCTTTAATCCTAGCAACTGAGGGCACCTGTAATCCCAGCAACTCAGGAAGCTGAGACAGGAGAAGTACTTGAACCCAGAAGGCAGAGGTTGCAGTGAGCCGATATTGCACCATTGCACTCCAGTCTGGGCAACAAGAGTGAAACTCTGTCTCAAAAAAAAA"
"chr14","12236526","12237360","JH378118","18053084","18053501","465","5816558","GGCTGGGTGGGGTGGCTCACGCGTGTAATCCCAACACTTTTGAGGCTGAGGTGGGTGGATCACTTGAGGTCCGGAGTTTGAGACCAGCCTGGTCAACATGGTGAAACCCCATGTCTCAGGATGGGGAACATCACATACCGGGGCCTGTCGTGGGGTGTGGGGAGGGGAAGGGATAGCATTAGGAGATATACCTAATGTAAATGACAAGTTAATGGGTGCAGCACACCAACATGGCACATGTATACATATGTAACAAACCTGCATGTTGTGCACATGTACCCTAGAACTTAAAGTATAGCAATAAAAAAAAAAAAAGAAACCCCGTGTCTACAAAAAAAATACAAAATTAGGCCAGGCGCAGTGGCACATACCTGTAATCCCAGCACTTTGGGAGGCCAAGGTGGGCAGATCACGAGGTCAGGAGTTTGAGACCAGCCTGTCCAAAATGGTGAAACCCCATCTCTACTAAAAAAATACAAAAATTAGCCAGGCATGGTGGCCCGTGCCTGCAATCCCAGCTACTCAGGAGGCTAAGGCAGGAGAATCACTTGAACGTGGGAGGCGGAGGTTGCAGTGAGCCGAGATCACACCATTGCACTCCAGCCTAGGCAACAGAGCGAGACTCTGTCTCAAAAAAACAAAAAGCAAAAAAACCCAAATTAGCCAGGCATGGTGGTAGTCACCTGTAATCCCAGCTACTTGGGAGGCTTAGGCAGGAGAATCGCTTGAACCCCAGAGGCAGAGGTTGCAGTAAGCCAAGATCGCACCAAGATCACTCCAGCCTGGGCGACAGTGAAACTGTGTCTCAAAAGAAAAAGAAAAAAAAGAAAGAAAA","GGCTGGGCGCAGTGGCTCACACCTGTAATCCCAGCACTTAGGGAAGCTGAGGCGAGTAGATCACCTGAGGTCAGGAGTTAGAGACCAGCCTGGCCATCATGGTGAAACCCCGTCTCTACTAAAGATACCAAAAATTAGCTGAGTGTGGTGCTGGGTGCCTGTAATCCCAGAAACTCAGGGTGCCTGTAATCCCAGCAACTCAGGGTGCCTTTAATCCCAGCAACTGAGGGTACCAGTAATCCCAGCAACTCAGGGTGTCTTTAATCCTAGCAACTGAGGGCACCTGTAATCCCAGCAACTCAGGAAGCTGAGACAGGAGAAGTACTTGAACCCAGAAGGCAGAGGTTGCAGTGAGCCGATATTGCACCATTGCACTCCAGTCTGGGCAACAAGAGTGAAACTCTGTCTCAAAAAAAAA"
"chr14","12551961","12552292","JH378124","27069096","27069413","54","14517135","GGCCAGGCGCGGTGGCTCACGCCTGTAATCCCAGCACTCTGGGAGGCCAAGGCGGACGGATCATCCGAGGTCAGGAGTTTGAGACCAGCCTGGCCAACATGGTGAAACCCCATCTCTACTAAAAATATATATATATATGTATATATATATATATATTAGCCAGGTGTAGTGGTGGGCATCTGTAATCCCAGCTACTCGGGAGGCTGAGGCAGGAGAATTGCTTGAACCCAGGAGGCGGAGGTTGCAGTGAGCTGAGATTGCACCACTGCACTCCAGCCTGGGTGATAAGAATGAGACTCCATCTCAAAACAAACAAACAAACAAATAAAAAA","GGCCGGGCACGGTGGCTCATGCCTGTAATCCCAGCACTTTGGGAGGCCGAGGCGGGTGGATCATGAGGTCAAGAGATCGAGACCATCCTAGTCAACATGGTGAAACTCCATCTCTACTAAAAATACAAAAAAAAAAAAAAATTAGCTGAGCATGGTGGTGCATGCTTGTAATTCCAGCTACTCAGGAGGCTGAGGCAGGAGAATTGCCTGAACCCAGGAGGCGGAGGTTGCAGTGAGCCGAGATTGCGCCATTGCACTCCAGCCTGGGTAATAAGAGTGAAACTCCGTCTCAAAAAAAAAAAACAAAAAAACAAAAAA"
"chr14","15131045","15131391","JH378121","20921542","20921875","62","5790497","GGCTGGGCCCGGTGACTCATGCCTGTAATCCCAGCACTTCGGGAGGACAAGGCGGGTGGATCACCTGAGGTCAGGAGTTCGAGACCAGCCTGGCCAACATGGCGAAACCCCGTCTCTACTGAAAATACAAAAATTAGCCAGGCATGGTGGTGGGCGCCTGTAATCCCAGCTACTCAGAGGCTGAGACAGGAGAATCACTTGAACCTGGGGTGGGGGCGGGGGCGGGGGCGGGGGCGGGGTGGGAGTGGAGGTTGCAGACAGTGAGTGGTGATGGCGCCAGTTCACTCCAGCCTGGGCGAAAGAGTGAAACTCCATCTCAGAAAAAAAAAAAAAAAAAAAAAGTAAAA","GGCTGGGTACGGTGGCTCATGCTGTAATCCCAGCACTTTGGGAGGTCAAAGCAGGCGGATCACCTGAGGTCAGGAGTTTGAGACCAGCCTTGCTAACATGGTGAAACCCCGTTTCTACTAAAAATAAAAAAATTAGCCAGGCGTGGTGGTGTGCACCTGTAATCCCAGCTACTTGGGAGGCTGAAGCAGGAGAGTTGCTTGAACCGGGGTGGTGGGGGGGCAGGGGCAGGGGTGGGTGGCAGGCAGAGGTTGCAGTGAGCCGAGATGGTGCCATTGCACTCCAGCCTGGGCAACAAGAGCAAAACTCCGTCTCAAAAAGAAAAAAAAAAAAGAA"
"chr14","15292066","15292693","JH378118","18053084","18053501","267","2761018","GGCCGGAGACGGTGGCTCACACCTGTAATCCCAGCACTTTGGGAGGCTGAGGCAGGCAGATCACCTGAAGTCAGGAGTTTGAGACCAGCCTGGCCAACATGGTATAAACCCCATCTCTACTAAAAATACAAAAATTAGGCTGGGCGCGGTGGCTCACGCCTGTAATCCCAACACTTTGGGAGGCCGAGGTGGGTGGATCACCTGAGGTCGGGAGTTTGAGACCAGCCTGACCAACATGAAGAAACCCTGTCTCTACTAAAAAAAAAAAAAAATACAAAATTAGCCGGGCATCATGGCACAAGCCTGTAATCCCAGCTACTCAGGAGTCTGAGGCAGGAGAATCGCTTGAACCTGGGAGGCGAAGGTTGCAGTGAGCTGAGATCGTGCCATTGCACTCCAGCCTGGGCAACAAGAGCGAAACTCCTTCTCTAAATAAATAAATAAAAATACAAAAATTTAGCCGGGCATGGTGGCGGGCACCTGTAATCCTAGCTACTTGAGAGGCTGAGGCAGGAGAATCGCTTGAACCCGGGAGGCGGAGGTTGCAGTAAGCAGAGATTGTGCCATTGCACTCCATCCTGGGCAACAAGAGTGAAACTCCATCTCAAAAAAAAAAAAAAAAAAAAAA","GGCTGGGCGCAGTGGCTCACACCTGTAATCCCAGCACTTAGGGAAGCTGAGGCGAGTAGATCACCTGAGGTCAGGAGTTAGAGACCAGCCTGGCCATCATGGTGAAACCCCGTCTCTACTAAAGATACCAAAAATTAGCTGAGTGTGGTGCTGGGTGCCTGTAATCCCAGAAACTCAGGGTGCCTGTAATCCCAGCAACTCAGGGTGCCTTTAATCCCAGCAACTGAGGGTACCAGTAATCCCAGCAACTCAGGGTGTCTTTAATCCTAGCAACTGAGGGCACCTGTAATCCCAGCAACTCAGGAAGCTGAGACAGGAGAAGTACTTGAACCCAGAAGGCAGAGGTTGCAGTGAGCCGATATTGCACCATTGCACTCCAGTCTGGGCAACAAGAGTGAAACTCTGTCTCAAAAAAAAA"
"chr14","15354689","15355313","JH378118","18053084","18053501","269","2698395","GGACGGGCGCAGTAGCTCACACCTGTAATCCTAGCAGTTTGGGAGGCCAAGGTGGGTGGATCACCTGACGTCAGGAGATCGAGACCAGCCTGGACAACATGGCGAAACCCTGTCTCTACTAAAAATACAAAATTAGGGCCAGGTGCGGTGGCTCACGCCTGTAATCCCAGCACTTTGGGAGACTGAGGCGGGCAGATCACCTGAGGTCAGGAGTTCGAGACCAGCCTGGCCAACATGGTGAAACCGCCTCTCTACTAAAAATATAAAAATTGGCTGGGCATTGTAGCAGCCACCTGTAATCCCAGCTACTTGGGGGCCCGAGGCAGAAAAACTGCTTGAACCCAGGAGGCAGAGGTTGTAGTGAGCCGAAATCATGCCACTGCACTCCAGCCTGGGTGACGAGAGTGAGACTCCGTTTCAAAGAAAAAGAAAAAAAATAAAATAAAACACAAAATTAGCCAGTCATGGTGGCAGGCACCTATAATCCCAGCTACCTGGGAGGCTAAGGCAGGAGAATCACTTGAACCCAGGAGGTAGAGGGTGTGGTGAGCCGAGATCACGCCATTGCACTCTAGCCTGGGCAACAAGAGCAAAACTCTGTCTCAAAACAAAAAGTTAAAAAAAA","GGCTGGGCGCAGTGGCTCACACCTGTAATCCCAGCACTTAGGGAAGCTGAGGCGAGTAGATCACCTGAGGTCAGGAGTTAGAGACCAGCCTGGCCATCATGGTGAAACCCCGTCTCTACTAAAGATACCAAAAATTAGCTGAGTGTGGTGCTGGGTGCCTGTAATCCCAGAAACTCAGGGTGCCTGTAATCCCAGCAACTCAGGGTGCCTTTAATCCCAGCAACTGAGGGTACCAGTAATCCCAGCAACTCAGGGTGTCTTTAATCCTAGCAACTGAGGGCACCTGTAATCCCAGCAACTCAGGAAGCTGAGACAGGAGAAGTACTTGAACCCAGAAGGCAGAGGTTGCAGTGAGCCGATATTGCACCATTGCACTCCAGTCTGGGCAACAAGAGTGAAACTCTGTCTCAAAAAAAAA"
"chr14","15366797","15367405","JH378129","11955248","11955630","263","3411549","GGTTGGGTGCGGTGGCTTACCCCTGTAATCCCAGCACTTTGGGGGTACAAAGTGGGAAGATTGCTTGAGCCCAGGAGTTCAAGACCAGCCTGGGCAACTAAGCGAGATCCTATCTCTCAAAAAAATTTTGAAACAACTTTTTGGCCGGGCGCAGTGGCTCACGCCTGTGATCCCAGCACTTTGGGAGGCCAGGGCGGGCGGATCACGAGGTCAGGAGATCAAGACCATCCTGGCTAACACGGTGAAACCCCGTCTCTACTAAAAATACAAAAAATTAGCCGGGTGCGGTGGCGGGCACCTGTAGTCCCAGCTACTCGGGAGGCTGAGGCAGGAGGATGGCGTGAACCCGGGAGGTGGAGCTTGCAGTGAGCTGAGATCGGGCCACTGCACTCCAACCTGGACGACAGATCGAGACTCCGGCTCAAAAAAAAAAAATTAGCTGGGCGTGGTGGCGGGTGCGTGTAATCCCAGCTACTCGGGAGGCTGAGGCAGGAGAATCACTTGAACCTGGGAGGCAGAGGCTGCAGTGAGCCAAGATCGCGCCATTGCACTCCAGCCTGGGCAACAAGAGCGAAACTCTGTCTCTAAATAATAAAATAAAATAAAAAA","GGCTGGGTACGGTGGCTCATGCCTGTAATCCCAGCACTTTGGGAGGTGGGTCACTTGAGGTCAGGAGTTCGAGACCAGCCTGTGCAGTGCCTCCATCCTCAACTGCTGCCTCATCAGCCTGGACCACTACCTGCTCATCCTCTCACCACTGCCACAAGCTGCGCATGAAGCTCCTGCGCGCGCCGGTGCCCGTCTCTACTAAAAATACAAAAATTAGCTGGGTGTGGTGGCAGGTGCCTGTAATCCCAGCTACTCAGGAGGCTGAGGCAGGAGAATCACTTGAACCCAGGAGGCAGAGGTTGCAGTGAGCCGATATCGCATCATTGCACTCCAGCCTGAGCAACAAGAGTGAAATTTTGTCTCAAAAAAAAAAAAAAAAGAAA"
"chr14","15379094","15379705","JH378129","11955248","11955630","265","3423846","GGTTGGGTGCGGTGGCTTACCCCTGTAATCCCAGCACTTTGGGGGTACAAAGTGGGAAGATTGCTTGAGCCCAGGAGTTCAAGACCAGCCTGGGCAACTAAGCGAGATCCTATCTCTCAAAAAAATTTTGAAACAACTTTTTGGCCGGGCGCAGTGGCTCACGCCTGTGATCCCAGCACTTTGGGAGGCCAGGGCGGGCGGATCACGAGGTCAGGAGATCAAGACCATCCTGGCTAACACGGTGAAACCCCGTCTCTACTAAAAATACAAAAAATTAGCCGGGTGCGGTGGCGGGCACCTGTAGTCCCAGCTACTCGGGAGGCTGAGGCAGGAGGATGGCGTGAACCCGGGAGGTGGAGCTTGCAGTGAGCTGAGATCGGGCCACTGCACTCCAACCTGGACGACAGATCGAGACTCCGGCTCAAAAAAAAAAAAAATTAGCTGGGCGTGGTGGCGGGTGCGTGTAATCCCAGCTACTCGGGAGGCTGAGGCAGGAGAATCACTTGAACCTGGGAGGCAGAGGCTGCAGTGAGCCAAGATCGCGCCATTGCACTCCAGCCTGGGCAACAAGAGCGAAACTCTGTCTCTAAATAAATAAAATAAAATAAAAAA","GGCTGGGTACGGTGGCTCATGCCTGTAATCCCAGCACTTTGGGAGGTGGGTCACTTGAGGTCAGGAGTTCGAGACCAGCCTGTGCAGTGCCTCCATCCTCAACTGCTGCCTCATCAGCCTGGACCACTACCTGCTCATCCTCTCACCACTGCCACAAGCTGCGCATGAAGCTCCTGCGCGCGCCGGTGCCCGTCTCTACTAAAAATACAAAAATTAGCTGGGTGTGGTGGCAGGTGCCTGTAATCCCAGCTACTCAGGAGGCTGAGGCAGGAGAATCACTTGAACCCAGGAGGCAGAGGTTGCAGTGAGCCGATATCGCATCATTGCACTCCAGCCTGAGCAACAAGAGTGAAATTTTGTCTCAAAAAAAAAAAAAAAAGAAA"
"chr14","15386894","15387394","JH378114","15957391","15957789","201","570497","GCTGAGTGCAGTGGCTCACGCCTGTAATCCACTTTAGCAGGCCAAAATAGGGGGATCACTTTGAGGCCACGAGTTTGAGACCTGCCTGGGCAACATAGTGAGGCCCCGTCTCTACAAAAATCTTTAAATATTAGAATAACTTTGGGAGGCCGAGGCGGGTGGATCACGAGGTCAAGAGATTGAGACCATCCTGGCCAACATGGTGAAATCCCATCCCTACTAAAGCTACAAAAATTAGCCAGGCGTGGTGGTGTGCGCCTGTAGTCCCAGCTACTCGGGAGACTGAGGCAGGAGAATTGCTTGAATCCGCGTGGCGGAGGTTGCAGTGAGCTGAGATCGCGCCACTGCACTCCAGCCTGGTGACAGAGCGAGACTCCGTCTTAAAAAAAAAAAAAAAAAAAAAAAAAAAAACTTCGGAGGTTGCGGTGAGCCAAGATCACGCCATTGTACTCCAGCCTGGGCCACAAGAGCAAAACTCCGCTTCAAAAAAAAAAAAAAAAA","GCAAGGAACGGTGGCTCATGCCTGTCATCCCAGCACTTTGGGAGGCTAAGGAGGGTGGATTACCGAAGGTCATGAGTTTGAGACCAGCCTGACCAACATGGTGAAAACCCCATCTCTACTAAAAATACAAAAAATTAGCCAGATACAGCTATGCGGCAGACTGGGGCAGGAGAATCGCTTGGACCCAAACCCCATCTCTACTAAAAATACAAAAAATTAGCCGGATACAGCTATGCGGGAGACTGGGGCAGGAGAATCGCTTGGACCCGGGAGGCAGAGATTGCAGTGAGATGAGACCATGCCATTGCTCTCTAGCTTGTGCGATGAGAACAAGACTCTGTCTCAAAAAAAAAAAAAAAAAAAAAAAAAAAAAAAAAAAAAAAAGAGAGAGAGAGAAAA"
"chr14","20140478","20141066","JH378118","18053084","18053501","250","2087394","GCCAGGCGAGGTGGCTCATGCCTGTAATCCCAGCACTTTGGGAGGCTGAGGTGGGTGGAACACTTGAGGTCAGGAGTTCAAGACCAGCCTGGCCAACATGATGAAACCCCCATCTCTACTAAAAACACAAAAATTAGCCAGGAGTGGGCAGGGTGCGGTGGCTCACGCCTGTAATCCCAGCACTTTGGGAGGCTGGGATGGGTGGATCATGAGGTCGGGAGTTCAAGACCAGCCTGGCCAAGATGGTGAAACCCTGTCTCTATTAAAACTTCAAAAATTAGCCAGGCACGGTGGCAGGTGCTTGTAATCCCAGCTACTTGGGAGGCTGAGGCAGGAGAATCACTTGAAACTGGGCGGCAGAGGTTGCAGTGAGCCAAGATCGCGCCACTGGACTCCAGACTGGGCGACACAGTGAGATACCGTCTCAAAAAAAAAAAAAAAAAAAATTAGCCAGGAGTGGTGGCGGAAATCCCAGCTACTTGAGAGGCTGAGGCAGGAGAATCGTTTGAACCCAGGAGGCAGAGGTTGCAGTGAGCCAAGATCTTGCCATTGCACTCCAGCTTGGGAGACAAGAGCAAAACTCTGTCTC","GGCTGGGCGCAGTGGCTCACACCTGTAATCCCAGCACTTAGGGAAGCTGAGGCGAGTAGATCACCTGAGGTCAGGAGTTAGAGACCAGCCTGGCCATCATGGTGAAACCCCGTCTCTACTAAAGATACCAAAAATTAGCTGAGTGTGGTGCTGGGTGCCTGTAATCCCAGAAACTCAGGGTGCCTGTAATCCCAGCAACTCAGGGTGCCTTTAATCCCAGCAACTGAGGGTACCAGTAATCCCAGCAACTCAGGGTGTCTTTAATCCTAGCAACTGAGGGCACCTGTAATCCCAGCAACTCAGGAAGCTGAGACAGGAGAAGTACTTGAACCCAGAAGGCAGAGGTTGCAGTGAGCCGATATTGCACCATTGCACTCCAGTCTGGGCAACAAGAGTGAAACTCTGTCTCAAAAAAAAA"
"chr14","32019134","32019479","JH378197","6655183","6655524","67","25363951","GGCTGGGGCAGTGGCTCACTGTAATTCCAGCACTTGGCCAAGGCAGGTGGATCACCTGAGGTCAGGAGTTCAAGACCAGCAGGGCCAACATGGTGAAACCCTATCTCTAAAAATAAATAAATAAATAAATAAATAAAATAAAATAAAATAAAATAAAAAATAAAAAAAATTAGCTGGGCGTTGTGGTGGGCGCCTGTAATCCCAGCTACTTGGGAGGCTGAGGCAGGAGGATCGCTTGAACCTGGAAGGCAGAGGTTGCAGTGAGCCGAAATCACATAATTGCACTCCAGCCTGGGCGACAAGAGCAAAACTCCATCTCAAAAAAAAAAAAAAAAAAAAAAAAAAA","GGCCGGGCGCAGTGGCTCATGCCTGTAATCCCAGCACTTTGGGAGGCAGAGGCGGGCAGATCACCCAAGGTCAGGAGTTCAAGACCAGCCTGGCTAACATGGTGAAACCCCATTTCTACTAAAAATACAAAAAAAAAAAAAAAAAAAAAAAAAAAAAAAAAAAAAAATTAGCTGAGCGAGGTGGTGGGCACATGTAATCCCAGCTACTTCGGAGACTAAGGCAGGACAATTGCTTAAGCCTGGGAGGCAGAGGTTGTAGTAAGCTGAGATCACACCATTGCACTCCAGCTTGAGCAACAAGAGCGAAACTCCGTCTCAAAAAAAAACCCAAAAAACAAAAAA"
"chr14","39734996","39735596","JH378118","18053084","18053501","237","21681912","GGCTGGGCGCGGTGGCTCATGCCTGTAATCCCAGCATTTTGGGAGGCCGAGGCGGGTGGATCACCTGAGGTCAGGAGTTTGAGACCAGCCTGGCCAACATGGTGAAACCCTGTCTCTACTAAAAATGCAAAAATTAGGCTGGTGCAGTGGCTCACGCCTGTAATCACAGCACTTTGGGAGGCCGAGGTGGGCGGATCACGAGGTCAGGAGATCGAGACCATCCTGGCTAATACAATGAAACCCCGTCTCTATGAAAAATACAAAAAATTAGCCGGGCGTAGTGGCAGGCGTCTGTAGTCCCAGCTACTCAGGAGGCTGAGGCAGGAGAATGGCATGAACCTGGGAGGCGGAGCTTGCAGTGAGCCGAGATTGCGCCACTGCACTCCAGCCTGGGCGACAGCGAGACTCTGTCTCAAAAAAAAAAAAAAAAATTAGCTAGGCATGGTGGCGCATGCCTGTAATCCCAGCTACTTGGGAGGCTGAGGCAGGAGAATCGCTTGAACCTGGGAGGCAGAGGCTGCAGTGAGACAAGATCACGCCATTGCACTCCAGCCTGGGCAACAAGAGTGAAACTCCATCTTCCCCCTACCAAAAAAAAAAA","GGCTGGGCGCAGTGGCTCACACCTGTAATCCCAGCACTTAGGGAAGCTGAGGCGAGTAGATCACCTGAGGTCAGGAGTTAGAGACCAGCCTGGCCATCATGGTGAAACCCCGTCTCTACTAAAGATACCAAAAATTAGCTGAGTGTGGTGCTGGGTGCCTGTAATCCCAGAAACTCAGGGTGCCTGTAATCCCAGCAACTCAGGGTGCCTTTAATCCCAGCAACTGAGGGTACCAGTAATCCCAGCAACTCAGGGTGTCTTTAATCCTAGCAACTGAGGGCACCTGTAATCCCAGCAACTCAGGAAGCTGAGACAGGAGAAGTACTTGAACCCAGAAGGCAGAGGTTGCAGTGAGCCGATATTGCACCATTGCACTCCAGTCTGGGCAACAAGAGTGAAACTCTGTCTCAAAAAAAAA"
"chr14","49081899","49082239","JH378114","14264965","14265292","65","34816934","GGCCAGGTACAGTGGCTCATGCCTGTAATCTCAGCATTTTGGGAGGCTGAGGCAGGCAGATCACCTGAGGTCAGGAGTTCGTGACCAGCCTGACCAGTGAAACCCTGTCTCTACTGAAAAAAATAAAATAAAATAAAATAAAAATAAAAATTAGCTGGGTGTGGTGGTGGGCGCCTGTAATCCCAGCTACTCGGCAGGCTGAGGCAGGAGAATTGCTTGTACCCGGGAGGCGGAGGTTGCAGTGAGCCAAGATCATGCCATTGCACTACAGCCTAGGTGACAAGAGCAAAACTCTGTCTCAAAACAAAACAACAACAACAACAACAACTAAAAAAAAAAAA","GGCCAGGCGCGGTGGCTCAAGCCTGTAATCCCAGCACTTTGGGAGGCCGAGGCGGGTGGATCATGAGGTCAAGAGATCGAGACCATCCTGGTCAACATGGTGAAACCCCGTCTCTACTAAAAACAGAAAAAAAATAAAAATAAAAATAATTAGCTGGGCATGGTGGAGCATGCCTGTAATCCCAGCTACTCAGGAGGCTGAGGCAGGAGAATTGCCTGAACCGAGGAGGCGGAGGTTGCGGGGAGCCAAGATCGCGCCATTGCACTCCAGCCTGGGCAACAAGAGCGAAACTCCGTCTCAAAAAAAAAAAAAAAAAAAAAAAAAAAAA"
"chr14","54833704","54834332","JH378118","18053084","18053501","272","36780620","GGCCAGGTGCAGTGGCTCACTCCTGTAATTCCAGCACTTTGGGAGGCTGCCGGTGGATCACCTGAGGTCAGGAGTTCGAGATCAGCCTGGCCAACATGGTGAAACCCCGTCTCTACTAATAATACAAAAATTAGCCAGGCAAGGCCGGGCGCAGTGGCTCACACCTGTAATCCCAGCACTTTGGGAGGCCGAGGCGGGCGGATCACCTGAGGTCGGGAGTTCAAGACCAGCCTGACCAACATGGAGAAACCCCATCTCTACTAAAAATACAAAATTAGCTGGGCATGGTGGCACATGCCTGTAATCCCAGCTACTAGGGAGGCTGAGGCAGGCGAATCGCTTGAACCTGGGAGGTGGAGGTTGCGGTGGGCCGAGATGGTGCCATTGCACTCTAGCCCGGGCAACAAGAGCGAAACTCTGTCTCAAAAAAAAAAAAAAAAAAAAAAAAATTAGCCAGGCATGGTAGCACACCCTTGTAATCCCAGCTACTCGGGAGGCTGAGGCAGGAGAGTTGCTTGAACCCGAGAGACGGAGGTTGCAGTGAGCTGAGATCGTGCCATTGCACTCCAACCTGGGTGACAAGAGTGAAACTCCATCTCCAAAAAAAAAAATAAATAAAATAAATAAAA","GGCTGGGCGCAGTGGCTCACACCTGTAATCCCAGCACTTAGGGAAGCTGAGGCGAGTAGATCACCTGAGGTCAGGAGTTAGAGACCAGCCTGGCCATCATGGTGAAACCCCGTCTCTACTAAAGATACCAAAAATTAGCTGAGTGTGGTGCTGGGTGCCTGTAATCCCAGAAACTCAGGGTGCCTGTAATCCCAGCAACTCAGGGTGCCTTTAATCCCAGCAACTGAGGGTACCAGTAATCCCAGCAACTCAGGGTGTCTTTAATCCTAGCAACTGAGGGCACCTGTAATCCCAGCAACTCAGGAAGCTGAGACAGGAGAAGTACTTGAACCCAGAAGGCAGAGGTTGCAGTGAGCCGATATTGCACCATTGCACTCCAGTCTGGGCAACAAGAGTGAAACTCTGTCTCAAAAAAAAA"
"chr14","55277737","55278067","JH378148","10302642","10302970","61","44975095","GGCCGGGTGCAGTGGCCCACCTCTGTAATCCTAACACTTTGGGAGGCCAAGGCAGGCAGGTCACTTGAGGTCAGGAGTTCAAGACTAACCTGGCCAACATGGTGAAACCCCGTCTCTACTAAAAATACGAAAATTAGCCGGGCTTCATGATGCATGCCTGTAATCCCAGCTACTAAGGAGGCTGAGGCAGAAGAATCTCTTGAACCCATGAGGTTGCAGTGAGCTGAGATCTCGCCATTGCACTCCAGCCTGGAGGACAAGAGCGAAACTCTGTCTCAAAAAAATAAAATAAAATAAATAAGAATAAAATAATAATAAAAGGCAAAAAGAA","GGCCGGGCGCGGTGGCTCAAGCCTGTAATCCCAGCACTTTGGGAGGCCGAGGCGGGTGGATCACGAGGTCAAGAGATCGAGACCATCCTGGTCAACATGGTGAAACCCCGTCTCTACTAAAAATACAAAAAATTAGCTGGGCATGGTGGTGGGTGCCTGTAATCCCAGCTACTCAGGAGGCTGAGGCAGGAGAATTGCCTGAACCCAGGAGGCGGAGGTTGCGGTGAGCCGAGATCGCGCCATTGCACTCCAGCCTGGGTAACAAGAGTGAAACTCTGCCTCAAAAAAAAAAAATAAAATAAAATAAAATAAAATAAAATAAAATAAAA"
"chr14","55822103","55822700","JH378118","18053084","18053501","240","37769019","GGCCAGGCGCAGTGGCTCACGCCTGTAATCCCAGCACTTTAGGAGGCCGAGGCAGGTGGATCGCCTGAGTTCAGGAGTTCAAACCCACCCTGGCCAACATGGTGAAACCCTGCCTCTACTAAAAAACAAAAAAATGGCCAAGCGTGGTGGCTCACGCCTGTAATTCCAGCACTTTGGGAGGCTGAGGCAGGCGAATCACGAGGTCAGGAGATCGAGACCATCCTGGCTAACATGGTGAAACCCCATCTCTATTAAAAATACAGAAAATTAGCCAGGCGTGGTGGTGGACGCCTGTAGTCCCAGCTTCTTGGGAGGCTGAGGCAGGAGAATGGCATGAACCCGGGAGGCAGAGCTTGCAGTGAGCTGAGATTGCGCCAGTGCACTACAGCCTGTGGGACAGAGCAACTCCGTCTCAAAAAAAAAAAAAATTAGCTGGGCATGGTGGCATATGCCTGTAATCCCAGCTACTAAGGAGGCTGAGGCGGGAGAATCGCTTGAACCCGGGAGGCAGAGGTTGCAGTGAGCCGAGATTGCGCCATTGCACTCCAGTCTGGACAACAAGAGTGAACTGTGTCTCAAAAAAAAAAAAAAAAAAAGA","GGCTGGGCGCAGTGGCTCACACCTGTAATCCCAGCACTTAGGGAAGCTGAGGCGAGTAGATCACCTGAGGTCAGGAGTTAGAGACCAGCCTGGCCATCATGGTGAAACCCCGTCTCTACTAAAGATACCAAAAATTAGCTGAGTGTGGTGCTGGGTGCCTGTAATCCCAGAAACTCAGGGTGCCTGTAATCCCAGCAACTCAGGGTGCCTTTAATCCCAGCAACTGAGGGTACCAGTAATCCCAGCAACTCAGGGTGTCTTTAATCCTAGCAACTGAGGGCACCTGTAATCCCAGCAACTCAGGAAGCTGAGACAGGAGAAGTACTTGAACCCAGAAGGCAGAGGTTGCAGTGAGCCGATATTGCACCATTGCACTCCAGTCTGGGCAACAAGAGTGAAACTCTGTCTCAAAAAAAAA"
"chr14","55860214","55860812","JH378118","18053084","18053501","246","37807130","GGCCGGATGCAGTGGCTCACGCCTGTAATCCCAGCACTTTGGGAGGCCAAGGCAAGCGGATCACCTGAGGTCAGGAGTTCAAGACCAGCCTGGCCAGCATGGTGAAACCCCTTCTCTACTAAAAATACAAAAATTAGCCGGGGCCTTGCGTGGTGGCTCACACCTGTAAATCCCAGCGCTTTGGGAGGCCGAGGCAGGCGGATCACCTGAGGTCGGGAGTTCAAGAACAGCCTGACCAACATGGAGAAACCCCGTCTCCACTAAAAATAGAAAAATAGCCGGGCATGGTGGCGCATGCTTGTAATCTCAGCTACTCGGGAGGCTGAGGCAGGAGATCACTTGAACCCAAGAGGCAGAGGTTGCGGTGAGCCGAGATCGCGCCATTGCACTCCAGCCTGGGCAACAAAGAGCGAAACTCCGTCTCCAAAAAAAAAAAAAAAAAATTAGCCGGGCGTGGTGGCACATACCTGTAATCCCAGCTATTCAGGAGGCTGAGGCAGGAGAATCCCTTGAACCCGGGAGGCAGAGATGGCAGTGAGCTGAGATCACGCCATTGCACTCCAGCCTGGGTGAGAGGAGTGAAACTCCGTCTAAAAAAA","GGCTGGGCGCAGTGGCTCACACCTGTAATCCCAGCACTTAGGGAAGCTGAGGCGAGTAGATCACCTGAGGTCAGGAGTTAGAGACCAGCCTGGCCATCATGGTGAAACCCCGTCTCTACTAAAGATACCAAAAATTAGCTGAGTGTGGTGCTGGGTGCCTGTAATCCCAGAAACTCAGGGTGCCTGTAATCCCAGCAACTCAGGGTGCCTTTAATCCCAGCAACTGAGGGTACCAGTAATCCCAGCAACTCAGGGTGTCTTTAATCCTAGCAACTGAGGGCACCTGTAATCCCAGCAACTCAGGAAGCTGAGACAGGAGAAGTACTTGAACCCAGAAGGCAGAGGTTGCAGTGAGCCGATATTGCACCATTGCACTCCAGTCTGGGCAACAAGAGTGAAACTCTGTCTCAAAAAAAAA"
"chr14","56736257","56736880","JH378206","6546474","6546861","276","50189783","GGCCAGGCACAGTGGCTCATGCCTGTAATCCCTGCACTTTGGGAGGCCAAGGCGGGTGGATCACCTGAGGTCAGGAGTTCGAGACTAGCCTGGCCAACATGGTTGGCCATCTCTTCTAAAAATACAAAAAATTAAGTTGGGCATGGTGGCTCATGCCTGTAATCCCAGCATTTTGGGAGGCCAAGGCAGGTGGATCATAAGGTCAAGAGATTGAGACCATCCTGGCCAACATGGTGAAACCCCATCTCTACTAAAAATACAAAAATTAGCTGGGCGTGGTGGTAGCACACACCTGCAGTCCCAGCTGCTCAGGAGGCTGAGGCAGGAGAATCACTTGAACCCGGGAAGCAGAGGTTGCAGTGAGCCGAAATTGCACCACTGCACTCCAGCCTGGCGACAAAGCAAGACTCCGTCAAAAAAAAAAAAAAAAAAAAAAAAATTAGCCAGGAGTGGTGGCACGTGCCTATAGTTCCAGCTACTCGGGAGGCTGAGGCAAGAGATTTGCTTGAACCTGGGAAGCAGAGGTTGCATATATTGCAGTGAGCCAAGATTATGCCATTGCACTCCAGCCTGGGCAACAAGAGTGAAAATCTGTCTAAAAAGAAAAAAAAAAGAAAAGAAAAA","GGCCACACATGGTGGCTAACGCCTGTAATCCCAGCACTTTGGGAGGCCAAGTCGGGTGGATCATGAGGTCAGGAGACCAAGACCATCCTGGCCAAATGGTGAAACCCCGTCTCTACTAAAAATACAAAAATTAGCTGGGCATGGTGGCGTGTGCCTGTAATCCCAGCTACTCAGGAGGCTGAGGCAGGACAATTGCCTGAACCCAGGAGAATTAGCTGGGCATGGTGGCGTGTGCCTGTAATCCCAGCTACTCAGGAGGCTGAGGCAGGACAATTGCCTGAACCCAGGAGGCGAAGGTTGCGGTGAGCCGAGATTGTGCCATTGCACTCCAGCCTGGGTAACAAGAGCGACACTCTGTCTCAAAAAAAAAAAAAAAAAAAAAAAAAAA"
"chr14","56744047","56744674","JH378118","18053084","18053501","281","38690963","GGCCGGGTGCGGTGACTCACATCTATAATCCCAGCACTTTGGGAGGCCAAGGCAGGTGGATCACCTGAGGTCAGGAGTTCAAGACCAGCCTGGCCAACTTGGTGAAACCCCATCTCTACTAAAAAATATAAAAATTTGCCAGGTGCGGTGGCTCATACCTGTAATCCCAGCACTTTGAGAGGCAGAGGTGGGTGGATCACGAGGTCAGGAGTTCGAGACCAGCCTGGCCAATGTGGTGAAACCCCATCTCTACTAAAAATACAAAAATTAGCCGGGTGTGGTGATGCGTGCCTGTAGTCCCAGCTATTCGGGAGGTTGAGGCAGGAGAATGGCGTGAACCAGGAAGGCGGAGCTTTCACTGAGCGGAGATCGCACCACTGCACTCCAGCCTGGGCGACGGAGCGAGACTCTGTCTCAAAAACAAAACAAAACAAAAAAACAAACAAACAAAAAAACATTATCCGGGTGTGGTGGTGGGCGCCTGTAATCCCAGCTACTTGGGAGGCTGAAGCAGGAGGATTGCTTGAACCTGGGAGGTGGAGGTTGCAGTGAGCTGAGATCACGCCTCTGCACTGCAGGCTGGACGACAAGAACAAAACTCTGAATCAACAACAACAACAACAAAAAA","GGCTGGGCGCAGTGGCTCACACCTGTAATCCCAGCACTTAGGGAAGCTGAGGCGAGTAGATCACCTGAGGTCAGGAGTTAGAGACCAGCCTGGCCATCATGGTGAAACCCCGTCTCTACTAAAGATACCAAAAATTAGCTGAGTGTGGTGCTGGGTGCCTGTAATCCCAGAAACTCAGGGTGCCTGTAATCCCAGCAACTCAGGGTGCCTTTAATCCCAGCAACTGAGGGTACCAGTAATCCCAGCAACTCAGGGTGTCTTTAATCCTAGCAACTGAGGGCACCTGTAATCCCAGCAACTCAGGAAGCTGAGACAGGAGAAGTACTTGAACCCAGAAGGCAGAGGTTGCAGTGAGCCGATATTGCACCATTGCACTCCAGTCTGGGCAACAAGAGTGAAACTCTGTCTCAAAAAAAAA"
"chr14","58283278","58283584","JH378115","34663603","34663898","52","23619675","CCGGGTGCGGTGGCTCACGCCTGTAATCCCAGCACTTTGGGAAGCTGAGGTGGGTGGATCATTTGAGGTCAAGAGTTCTAGACCAGCCTGGCCAACATGGTGAAACCCTACTTCTAATAAACACACACACACACACACACACACACACACACACACAAATTAGCCAGCAGGCACCTGTAATCCCAGCTACTCGGAAGGCTGAGGCAGGACAATCGCTTGAACCTGGGAGGCCAGAAGTTGCAGTGAGCCAAGATCATGCCACTGCACTCCAGTCTGGGTGACAAGAGCAAGACTCCATTTCAAAAAA","GGCCTGGTGAAGTGGCTCACGCCTGTAATCCCAACACTTTGGGAGGCTGAGATGGATGGCTCATTTGAGGTCAGGAGTTCTAGACCAGCCTGGCCAACATGGTAAAAGCCCACCTCTACCAAAAATACAAAAACAAAAACAAAAAAATTTTAGCCAACAGGCACCTTTAATCCCAGCTACTCAGGAGGCTGAGGCAGGAGAATTGCTTGAATCTGGGAGGCCAGAAGTTGCAGTGAGCCAGGATCACACCACTGCACTCCATCCTAGGCGACAAGAGCAAGACTCCAAAAAAAAAA"
"chr14","59226808","59227410","JH378118","18053084","18053501","257","41173724","GGCTGGGCGCTGTGGCTCATGCCTGTAATCCCAGCACTTTAGGAAGCCAAGGGAGGTGGATCACCTGAGGTCAGAGTTCAAGTCCGGCCTGACCAACATGGCGAAACCCAGTCTCTACTAAAAATACAAAATTGGCCAGGCGTGGGGTGGCTCACACCTGTAATCCCAGCACTTTGGGAGGCCGAAGTGGGTGGATCACTTGAGGTCAGGAGTTTGAGACCAGCCTGGTTAACATGGTGAAACCCCATCTCTACTAAAAATACAAAAATTAGCCAGGCATGGTGGCAGGCGCCTGCAATCCCAGTTACTCAGGAGGCTGGTGCAGGAGAATCGCTTAAACCTAGGAGGCAGAGGTTGCAGTGAACTGAGATCGTGCCATTGCACTCCAGCCTGGGTAACAACAGCAAGACTTCATCTCAAAAAAAAAAATACATAATTATAATTAGCTGGGCGTGTTGGCGAGCGCCTGTAGTCCCTGCTACTTGGGAGGCTGAGGCAGGGGAATCACTTGAACCTGAGAGGCGGAGGTTGCAGTGAGCCAAGTCACGCCATTGCATTCCAGCCTCGGCAACAAGAGCAAAACTCCATCTCAAAAAAAAAAAA","GGCTGGGCGCAGTGGCTCACACCTGTAATCCCAGCACTTAGGGAAGCTGAGGCGAGTAGATCACCTGAGGTCAGGAGTTAGAGACCAGCCTGGCCATCATGGTGAAACCCCGTCTCTACTAAAGATACCAAAAATTAGCTGAGTGTGGTGCTGGGTGCCTGTAATCCCAGAAACTCAGGGTGCCTGTAATCCCAGCAACTCAGGGTGCCTTTAATCCCAGCAACTGAGGGTACCAGTAATCCCAGCAACTCAGGGTGTCTTTAATCCTAGCAACTGAGGGCACCTGTAATCCCAGCAACTCAGGAAGCTGAGACAGGAGAAGTACTTGAACCCAGAAGGCAGAGGTTGCAGTGAGCCGATATTGCACCATTGCACTCCAGTCTGGGCAACAAGAGTGAAACTCTGTCTCAAAAAAAAA"
"chr14","62992080","62992681","JH378118","18053084","18053501","256","44938996","GGCCGGATGCAGTGGCCCACACCTGTAATCCTAGCACTTTGAGAGGCTGAAGCAGGCAGATCACTTGCGGTCAGGAGTTTGAGACCAGCCTGGCCAACATAGTAAAACCTCATCTCTACTAAAAATAGAAAAATTTTCTGACCAGGCACGGTGGCTCGCGCCTGTAATCCCAGCACTTTGGGAGGCCAAGGTGGGCACATTACCTGAGATCAAGAGTTCAAGACCAGCCTGACCAACATGGCAAAACTCTGTCTCTACTAAAAATACAAAATTAGCCGGGCATAGTGGCGCATTCCTGTAATCCCAGCTACTAAGGAGGCTGAGGCAGGAGAATTGCTTGAACCCGGGAGCCGGAGGTTGCAGTAAGCCAAGATTGCGCACTGCACTCTAGGCTGGGCAACAACAGCGAAACTCTGTCTCGAAAAAAAAAAAAAAAAAAATTAGCTGGGCGTGGTGGTGAGTACCTGTAATCCCAGCTACTTGGGAGACTGAGGCAGGAGAATCTCTTGAACCTGGGAGGTAGAGGTTGCAGCGAGCTTAGATCACACCACTGCACTAAAGCCTGGGGGACAAGAGCAAAACTCTATCTCAAAAAAATAAAA","GGCTGGGCGCAGTGGCTCACACCTGTAATCCCAGCACTTAGGGAAGCTGAGGCGAGTAGATCACCTGAGGTCAGGAGTTAGAGACCAGCCTGGCCATCATGGTGAAACCCCGTCTCTACTAAAGATACCAAAAATTAGCTGAGTGTGGTGCTGGGTGCCTGTAATCCCAGAAACTCAGGGTGCCTGTAATCCCAGCAACTCAGGGTGCCTTTAATCCCAGCAACTGAGGGTACCAGTAATCCCAGCAACTCAGGGTGTCTTTAATCCTAGCAACTGAGGGCACCTGTAATCCCAGCAACTCAGGAAGCTGAGACAGGAGAAGTACTTGAACCCAGAAGGCAGAGGTTGCAGTGAGCCGATATTGCACCATTGCACTCCAGTCTGGGCAACAAGAGTGAAACTCTGTCTCAAAAAAAAA"
"chr14","75046278","75046878","JH378118","18053084","18053501","246","56993194","GGCCGGGCACAGTGGCTCACACCTATAATCTCAGTACTTTGGGAGGCCAAGGCGGGCAGATCACTTGAGGTCAGGAGTTCGAGACCACCCTGGCCAACATGGTGAAACCTCATCTCTACTAAAAATACAAAAAACTGGCTGGGTGAAGTGGCTCACGCCTGTAATCCCAGCAGTTTGGGAGGCCAAGGCGGGCCAATCACGAGGTCAGGAGTTCGAGACCAGCCTGGCCAATATGGTGAAACCCCGTCTCTATTAAAAATTCAAAAATTAGCTGGATGTGGTGGCAGGCACCTACAATCCCAGCTACTTGGAAGGCTGAGGCAGGAGAGTCTGCTTGAAACCAGAAGGCGGAGGTTGCAGTGAGTGAGCTGAGAACGTGCCACTGCACTCCAGCCTGGGCGAAAGAGCAAAACGCTGTCTCAGGGGGAAAAAAAAAACTAGCCGGGCATGGTGGCAGGTGCCTGTAATCCCAGCTACTCAGGAGGCTGAGGCAGGAGAATTGCTTGAACCCAGGAGGAGGAGGTTGCAGTGAGTCGAGATCACGTCATTGCACTCCCAGCCTGGCTGATAAGAGCGAAACTCCGTCAAAAAAAAAAAAAAA","GGCTGGGCGCAGTGGCTCACACCTGTAATCCCAGCACTTAGGGAAGCTGAGGCGAGTAGATCACCTGAGGTCAGGAGTTAGAGACCAGCCTGGCCATCATGGTGAAACCCCGTCTCTACTAAAGATACCAAAAATTAGCTGAGTGTGGTGCTGGGTGCCTGTAATCCCAGAAACTCAGGGTGCCTGTAATCCCAGCAACTCAGGGTGCCTTTAATCCCAGCAACTGAGGGTACCAGTAATCCCAGCAACTCAGGGTGTCTTTAATCCTAGCAACTGAGGGCACCTGTAATCCCAGCAACTCAGGAAGCTGAGACAGGAGAAGTACTTGAACCCAGAAGGCAGAGGTTGCAGTGAGCCGATATTGCACCATTGCACTCCAGTCTGGGCAACAAGAGTGAAACTCTGTCTCAAAAAAAAA"
"chr14","83813857","83814442","JH378118","18053084","18053501","240","65760773","GGCCAGGCGCGGTGGCTCACGCCTGTAATCCCAGCACTTTGGGAGGCCGAGGCGGGCGGATCACCTGAGGTCAGGGGTTCAAGACCAGCCTGACCATCCCAGAACTTTGGGAGGCCGAGACGGGTGGATCATGAGGTCAGGAGATCGAGACCATCCTGGCTAACACAGTGAAACCCCATCTCTATTAAAAATACAAAAAATTAGCCGGGCGTGGTGGCAGCTCCTGTAGTCCCAGCTACTCGGGAGGCTGAGGCAGGAGAATGGCGTGAACCCGGGAGGCGGAGCTTGCCGTGAGCCGAGATCGCACCACTGCACTCCAGCCTGCAAGATAGCGAGGCTATGTCTCAGGAAAAAAAAAAAAAAAAAAAAAAAGACCAACCTGACCAACATGGTAAAACCCCATCTCTACTAAAAATACAAAATTAGCCGGGCATGGTGGCAGACGCCTGTAATCCCAGCTACTCAGGAGGCTGAGGCAGGAAAATCACTTGAACCCAGGAGGTGGAGGTTGCGGTGAGCCGAGATCGTGCCATTGCACTCCGGCCTGGGTGACAACAGCGAAACTCCATCTCAAAAAAAAGAAAAA","GGCTGGGCGCAGTGGCTCACACCTGTAATCCCAGCACTTAGGGAAGCTGAGGCGAGTAGATCACCTGAGGTCAGGAGTTAGAGACCAGCCTGGCCATCATGGTGAAACCCCGTCTCTACTAAAGATACCAAAAATTAGCTGAGTGTGGTGCTGGGTGCCTGTAATCCCAGAAACTCAGGGTGCCTGTAATCCCAGCAACTCAGGGTGCCTTTAATCCCAGCAACTGAGGGTACCAGTAATCCCAGCAACTCAGGGTGTCTTTAATCCTAGCAACTGAGGGCACCTGTAATCCCAGCAACTCAGGAAGCTGAGACAGGAGAAGTACTTGAACCCAGAAGGCAGAGGTTGCAGTGAGCCGATATTGCACCATTGCACTCCAGTCTGGGCAACAAGAGTGAAACTCTGTCTCAAAAAAAAA"
"chr14","84224287","84224910","JH378118","18053084","18053501","265","66171203","GGCAGGGTGCAGTGGCTCATACCTGTAATCCCAGCACTCTGGGAGGCCGAGGTGGGCAGATCACTTGAGCTCAGGAGTTTGAGACCAGCCTGGCCAACATAGTGAAACCCCATCTCTACTAAAAATACAAAATTAGGCTGGGCACAGTGACTCACGTCTGTAATCCCAGCACTTTGGGAGGCCGAGGCTGGTGGATCACAAGGTCAGGAGATCAAGACCATCCTGTCCAACATAGTGAAACCCCATCTCTACTAAAAATACAAAAATTAGCTGGACGTGGAGGTGCACATCTGTAGTCCCAGCTACTTGTGAGGCTGAGGCAGGAGAACTGCTTGAACCCAGGAGGCGGAGGCTGCAGTGAGCTGAGATTGTGCCACTGCACTCCAGCCTGGGCGACAGAGCGAGACTCTGTCTCAAAAAAAAAAAAAAACAGAAAAAACAAAATTAGCCGGGCATGGTGGTGCACGCCTGTAACCCCAGCTACTTGGGGGGCTGAGGCAGGAGAATTGCTTGAACCTGAGAGGTGGAGGTTTCAGTGAGCCGAGATTGTGCCATTGCCCTCCAGTCTGGGCAACAAGAGCAAAACTCCGTCTCAAAAAAAAAAAAAAGAAAAAAAAAGAAGAA","GGCTGGGCGCAGTGGCTCACACCTGTAATCCCAGCACTTAGGGAAGCTGAGGCGAGTAGATCACCTGAGGTCAGGAGTTAGAGACCAGCCTGGCCATCATGGTGAAACCCCGTCTCTACTAAAGATACCAAAAATTAGCTGAGTGTGGTGCTGGGTGCCTGTAATCCCAGAAACTCAGGGTGCCTGTAATCCCAGCAACTCAGGGTGCCTTTAATCCCAGCAACTGAGGGTACCAGTAATCCCAGCAACTCAGGGTGTCTTTAATCCTAGCAACTGAGGGCACCTGTAATCCCAGCAACTCAGGAAGCTGAGACAGGAGAAGTACTTGAACCCAGAAGGCAGAGGTTGCAGTGAGCCGATATTGCACCATTGCACTCCAGTCTGGGCAACAAGAGTGAAACTCTGTCTCAAAAAAAAA"
"chr14","85020958","85021268","JH378108","34510794","34511096","52","50510164","GCCAGGTGCAGTGGCTCATGCCTGTAATTCCAGTACTTTGAGAGGTCGAGACAGGGAGATCACCTGAGGCCAGGAGTTCAAGACTAGCTTGGCCAACATGGCAAAACCCTGTCTCTACTAAAAATGCAAAAAAAAAAAAAAAAAAAAAAAAAAAATTAGCCTGGCATGGTGGTAGACACCTGTAATCCCAGCTACTTGGGAGGCTGAGACAGGAGAACCTCTTGAATCTGGGAGGAGGAGGTTGCTGTGAGCTGAGATCGTGCCACTGCACTCCAGCCTGGGTAACAAGAGAGAAACTCTGTCTCAAAAAA","GGGTGCCGTGTCTCATGCCTGTAATTCCAGCACTTTGGGAGGTCAAGGCAGTCCGATCACCTGAGGTCAGGAGTTTGAGACTAGCCTGGCCAAAATGGTGAAACCCTGTCTCTAGAAAAAATACAAAAAAAAAAAAAAAAAAAAAAAAAAATTAGCTGGATGTAGTGGTGCATACCTGTAGTCCCAGCTACTCTGGAGGCTGAGGCAGGAGAATTGTTTGAACCCAGGAGGCGGAGGTTGCGGTGAGCCGAGATCATGCCATTGCACTCCAGCCTGGGAAACAAGAGTGAAACTCTGTCTCAA"
"chr14","86696589","86696920","JH378203","2698403","2698735","56","83998186","GGCCAGGCACGGTGGCTCATGCCTATAACCAGCACTTTGGAGGCCGAGGCAGGTGGATCACCTGAGGTCAGGAGTTTGAGACTGGCCTGGCCAGCATGGTGAAACTCTGTCTCTACTAAAAAAAAAAAAAAAAAAAAAAAAAAAAAAGTACAAAATTAGCTGGATGTGGTGGTAGGCACCTGTAATCCCAGCTACTTGGGAGGCTGAGGCAGGAGAATCGCTTGAACCCAGGAGGCAGAGATTGCAGTGAGCCAAGATTGCGCCATTGTACTCCACTCTGGGCAATGAGCGAAACTCCGTCTCAAAAAAAAAATAAAATAAAAATAAAATAA","GCCGGGTGCAGTGGCTCATACCTCTAATCCCAGCACTTTGGGAGGCCAAGGCAGGTGATCACCTGTGGTCAGGAGTTCGAGACCAGCCTGGCCAACATGGTGAAACCCTGTCTTTACTAAAAATACAAAAAAAAAAAAAAAAAAAAAAAAAAAAAACTTAGCCCACCATGGTGGTGGGCTCTTGTAGTCCCAGCTACATGGGAGGCTGAGGCAGAAGAATCGCTTGAAGACAGGAGGTGGAGGTTGCAGTGAGCCAAGACTGCGCCATTGCACTCAGCCTGGGTGACGAGCCAAACTCCATCTCAAAAAAAAAAAAAAAAAAAAAAAAAAAAA"
"chr14","86944567","86945185","JH378118","18053084","18053501","274","68891483","GAGCACGGTGGCTCACGCCTGCAATCCCAGCACTTTGGGAGGCCGAGGTGGGTGGATCACCTGAGGTTAGGAGTTTGAGACCAGCCTGGCCAACATGGTGAAACCGTCTCTACTAAAAATGCAAAAAAGTAGGGGCCGGGCACGGTGGCTCACGCCTGTAATCCCAGCACTTTGGGAGTCTGAGGCAGACGGATCACAAGGTCAGGAGATCAAGACCATGGTGAAACTCCGTCTCTACTAAAAATACAAAAAATTAGCTGGGCGTGGTGGTGGGCACCTGTAGTCCCAGCTGCTTGGGAGGCTGAGGCAGGAGAATGGTGTGAACCCGGGAGGCGGAGCTTGCAGTGAGCCGAGATCGCAACACTGCACTCCAGCCTGGGCGACAGAGCGAGACCCTGTCTCAAAAAAAACAAAAATAAACAAAAATAAATAAATACAAAAAAGTAGCCAGGCATGGTGGTGGGTGCCTGTAATCCCAGCTACTTGGGAGGCTGAGGCAGGAGAATCACCTGAACCCGGGAGGTGGAGGTTGCAGTGAGCCAAGACCGTGTCATTACACTCTAGCCTGGGCAACAAGAGCGAAATTCCATCTGAAAAAATAAATAAATAAAAATAAAAA","GGCTGGGCGCAGTGGCTCACACCTGTAATCCCAGCACTTAGGGAAGCTGAGGCGAGTAGATCACCTGAGGTCAGGAGTTAGAGACCAGCCTGGCCATCATGGTGAAACCCCGTCTCTACTAAAGATACCAAAAATTAGCTGAGTGTGGTGCTGGGTGCCTGTAATCCCAGAAACTCAGGGTGCCTGTAATCCCAGCAACTCAGGGTGCCTTTAATCCCAGCAACTGAGGGTACCAGTAATCCCAGCAACTCAGGGTGTCTTTAATCCTAGCAACTGAGGGCACCTGTAATCCCAGCAACTCAGGAAGCTGAGACAGGAGAAGTACTTGAACCCAGAAGGCAGAGGTTGCAGTGAGCCGATATTGCACCATTGCACTCCAGTCTGGGCAACAAGAGTGAAACTCTGTCTCAAAAAAAAA"
"chr14","87180871","87181803","JH378118","18053084","18053501","547","69127787","GGCCATGTGCGGTGGCTCACACCTGTAATCCCAGCACTGTGGGAGGCCAAGGTGGGCGGATCATTTGAGGTCAGGAGTTCTAAACCAGCCTGGCCAATATGGTGAAACACTGTCTCTGCTAAAAATACAAAAAAAGAAAAAGAAAAAAAAAAAAAGGCTGGGCACGGTGGCTCACGCCTGTAATCTCAGCACTTTGGGAGGCTGAGGTGGGTGGATTACCTGAGGTCAGGAGTTCGAGACCAGCCTGGCCAACATGGTGAAACCTTGTCTCTACTAAAAGTATAAAAATTAGCCAGGTGTGGTGGAGGTCGCCTGTAATCCCAGCTACTCAGTAGGCAGAGGCAGAAGAATCCGTTGAACCTGGGAGGCGGAGGTTGCAGTGAGCTGAGATTGCACCAGTGCATTCCAGCCCGGGTGACAAGAGTGAGACTCTGTCTCAAAATAAACAAACAAAAAAATTAGTGGGCCGGGTTCAATGACTCACGCCGGTAATCCCAGCACTTTGGGAGGCCAAGGAAGGCAGGTCACCTGAGGTCGGGAGCTCGAGACCAGCCTGACCAACATGGAGAAACCCCGTCTCTACTAAAAATACAAAATTAGCTGGGCGTGGTGGCACATGCCTGTAATTCCAGCTACTCAGGACGCTGAGGCAGGAGAATTGCTTGAACCCAGGAGGCGGAAGTTGCAGTGAGCCAAGATCATGACATTGCACTCCCGCCTGGGCGCCAAGAGTGAGATTTCGTCTCAAACAAACAAACAAAAAAACGAATTAGTGGAGCGTGGTGGCAGGCACCTAAAGTCCCAGCTATTCAGGAGGCTGAGGCAGGAGAATTGCTTGAACCTGGGAAGTGGAGGTTATAGTGAGCTGAGATCGCGCCATTGCACTCCAGCCTGGGCAACAAGAGTGAGAATCTGTCTAAAAAAAAAAAAGAA","GGCTGGGCGCAGTGGCTCACACCTGTAATCCCAGCACTTAGGGAAGCTGAGGCGAGTAGATCACCTGAGGTCAGGAGTTAGAGACCAGCCTGGCCATCATGGTGAAACCCCGTCTCTACTAAAGATACCAAAAATTAGCTGAGTGTGGTGCTGGGTGCCTGTAATCCCAGAAACTCAGGGTGCCTGTAATCCCAGCAACTCAGGGTGCCTTTAATCCCAGCAACTGAGGGTACCAGTAATCCCAGCAACTCAGGGTGTCTTTAATCCTAGCAACTGAGGGCACCTGTAATCCCAGCAACTCAGGAAGCTGAGACAGGAGAAGTACTTGAACCCAGAAGGCAGAGGTTGCAGTGAGCCGATATTGCACCATTGCACTCCAGTCTGGGCAACAAGAGTGAAACTCTGTCTCAAAAAAAAA"
"chr15","7203590","7204226","JH378118","18053084","18053501","285","10849494","GGCCAGGTGCAGTGGCTCATGCCTCTAATCCCAGCACTTTGGGAGGCCGAGATGGGCAGATCACCGGAGGTCAGGAGTTTGAGACCAGCTTGGCCAAAATGGTGAAACCCTGTCTCTACAAAAAAATACAAAAATGGCTAGGCACGGTGGCTCACACCTGTAATCCCAGCACTTTGGGATACAGGTGGATCATGAGGTCAAGAGATCAAGATCATCTTGGCCAACATGGCAAAACCCTGTCTCTACTAAAAAATACAAAAAATTAGCTGGGCGTGGTGGTGCACGCCTGTAGTCCCAGCTACTCAGGAAACTGAGGCAAGAGAATCGCTTGAACCTGGGAGGTAGAGGTTGCAGTGAGCCGAGATGCACTCCAGCCTGGCAACAGAACAAGACTCCATCTCAAAGAACAAAAACAAAACAAAACAAAACAAAAGACAAGCAAACAAAAAAATACAAAAATTAGCTAGGTGTGGTGGCAGGCGCCTGTAATCCCAGCTACTCAGGAGGCTGAGGCAGGAGAATCGCTTGAACCTGGGAGGCGGAGGTTGCAGTGAGCCAAGATTGTGCCATTGCACTCCAGCCTAGGTGACAAGAGTGAAAAGACGTCTCAAAAACAAAACCAAAAAAAAAAATAAAA","GGCTGGGCGCAGTGGCTCACACCTGTAATCCCAGCACTTAGGGAAGCTGAGGCGAGTAGATCACCTGAGGTCAGGAGTTAGAGACCAGCCTGGCCATCATGGTGAAACCCCGTCTCTACTAAAGATACCAAAAATTAGCTGAGTGTGGTGCTGGGTGCCTGTAATCCCAGAAACTCAGGGTGCCTGTAATCCCAGCAACTCAGGGTGCCTTTAATCCCAGCAACTGAGGGTACCAGTAATCCCAGCAACTCAGGGTGTCTTTAATCCTAGCAACTGAGGGCACCTGTAATCCCAGCAACTCAGGAAGCTGAGACAGGAGAAGTACTTGAACCCAGAAGGCAGAGGTTGCAGTGAGCCGATATTGCACCATTGCACTCCAGTCTGGGCAACAAGAGTGAAACTCTGTCTCAAAAAAAAA"
"chr15","13675429","13675731","JH378235","1186107","1186418","53","12489322","GGCTTGGCACAGTGGCTCATGCCTGTAATCCCAGCACTTTGAGAGACCGAGGCAAGTGGATCCCAGGAGTTCAAGACCAGCCTGGCCAAGATGGTGAAACCCCCCATCTCTACTAAAAATACAAAAAAAAAAAAAAAAAAAAAAAAAGGGCTTAGTGGCTGGCAGCTGTAGTCCCAGCTACTCGGGAGGCTGAGGCAGGAGAATCGCTTGAACCTGGGAAGCGGAGGTTGCAGTGAGCCAAGATCACACCATTGCACTCTAGCCTGGGCAACAAGGGCAAAACTCCATCTCAAAAAAAAAGAA","GGCTGGGCGCAGTGGCTCAAGCCTGTAATCCCAGCACTTTGGGAGGCCGAGGGGGGTGGATCACGAGGTCAAGAGATCAAGACCATCCTGGTCAACATGGTGAAACCCCGTCTCTACTAAAAAAAAAAAAAAAAAAAAAAAAAAAAAAAAAAAATTAGCTGGGCATGGTGGCGTGTAATCCCAGCTACTCAGGAGGCTGAGGCAGGAGAATTGCCTGAACCCAGGAGGCGGAGTTTGCGGTGAGCCAAGATCGCGCCATTGCACTCCAGCCTGGGTAACAAGAGCAAAACTCTGTCTCAAAAAAAAAAAAAA"
"chr15","14837014","14837358","JH378137","13677298","13677634","59","1159716","GCCGGGTATGGTGGCTCATGCCTGTAATTCCAGCACTTTGGGAGGCCGAGGCAGGCGGATCACCTGAGGTCAGGAGTTTGAGACCAGCCTGGCTAACATGGTGAAACTACGTTTCTACTAAAAATACAAAAAAAAAAAAAAAAAAAAAAAAAAAAAAAAAAAAAAAAAAAATTAGCCAGGCGTGGAGGCGCGTGCCTATAATCCCAGTTACTCGGGAGGCCGAGGCAGGAGAATCGCTTGAACCCAGGAGCCGGAGGGTGTAGTGAGCCGAGATCATGCCATTGCGCTCCAGGTTGGGCAACAAGAGCAGAACTCCGTCTCAAAAAAAAAAAAAAAAAAAAAAAA","GGCTGGGCATTGTGGCTCATGCCTGTAATCCCAGCACTTTGGGAGGCCGAGGTGGGCGGATCACCTGAGGTCGGGAGTTCAAGACCAGCCTGGCCACAATGGTGAAACTCTGTCTCTGCTAAAAAAAAAAAAAAAAAAAAAAAAAAAAAAAAAAAAAAAATTAGCCAGGCGTGGTGGCACACGCCTGTAATCCCAGCTATTTGGGAGGCTGAGGCAGGAGAATCGCTTGAACCTGAGAGGTGGAGGTTGCAGTGAGCCAAGATCATACCATTGCACTCCAGCTTGGGAACAAAGAGCAAAACGCCATCTCAAAAACAAAACAAACAAACTGAAAAAA"
"chr15","20684723","20685060","JH378262","266823","267148","57","20417900","GGCTGGGCGTGTTGGCTTACACCTGAAATCCCAGCACTCTGGGAGGCCGAGGCGGGCAGATCACCTGAGGTCAGGGGTTCGAGACCAGCTTGGCCAACATGGTGAAACCCCGTCGCTACTAAAAATACAAAAATTAGCTGGGCATGGTGGTGGGAGCCTGTAATCCCAGCTACTCAGGAGACTGAGGCAGGACAATCGCTTGAACCCAGGAGGCAGAGGTTGCAGCGAGCCGAGATCGTGCCACTGCACTCCAGCCTGGGAGGGAAGAGTGAAAGTCCATAACAACAACAAAACAACAAAACAACAACAACAACAACAACAACATCTCTGAAAGGAAA","GGCCGGGCGCGGTGGCTCAAGCCTGTAATCCCAGCACTTTGGGAGGCCGAGGCGGGTAGATCATGAGGTCAGGAGTTTGAGACCAGCCTGGCCAACATGGTGAAACCCCGTCTCTACTAAAAATACAAAAATTAGCCGGGCATGGTGGCCTGTGCCTGTAATCCTAGCTACCCAGGAAGCTGAGGCAGGAGAATTGCCTGAACCCAGGAGGCGGAGGTTGCGGTGAGCCGAGATCGTGCCATTGCACTCCAGCCTGGGTAACAAGAGCGAAACTCCGTCTCAAAAACAAACAAACAAACAAACAAAAACAAAAAACAAAAAACAAA"
"chr15","20894395","20894976","JH378119","32351107","32351490","257","11456712","GGTGGCTCACACCTGTAATCCCAGCACTTTGGGAAGCCGAGGTAGGTGGATCACCTGAGGTCAGGAGTTAGAGATCAGCCTGGACAACATGGTGAAACCCCATCTCTACTAAAAATACAAAAACTAACCAGGCTTGGTGGCTCACACCTGTAATCCCATCACTTTGGGAGGCCAAGGCGGGTGGACTACTTGAGGTCAGGAGTTTGAGACCAGCCTGGCTAACATGGTGAAACCCCATCTCTACTAAAAATACAAAAATTAGCTGGGCATGGCAGTGCGCGCCTGCAATCCCAGCTACCTGGGAGGCTAAGGCAGGGGAATTGTTTGAACCTGGGAGGCAGAGGTTGCAGTGAGCCGACACTGCACCACTGCACTCCAGCCTGGGTGACAGAGTGAGCCTCCGTCTCAAAAAAAAAAAAAAAAAAAAAAAAAAATTAGCCAGGTGTGGTGGCAGGCACCTGTGATCCCAGCTACTCAGGAGGCTGAGGCAGGAGAATTGCTTGAACCCAGGAGGCGGAGAGTGCAGTGAGCTGAGATCATGCCATTGCACTCCAGCCTGGGTGACAAGAGAGAAACTCTGTC","GGCCAGGTATGGTGGCTCACACCTGTAATCCCAGCACTTTGGGAGGCCAAGGCAGGCAGACCACCTGAGGTCAGGAGTTCGAGATCAGCCTAGCCAACATGGTGAAACCCCATCTCTAGTAAAAATAAAATTAGCCAGGCATGGTGGTGCATGCCTGTAACGCAGGTCAGGAGTTCGAGATCAGCTTAGCCAACATGGTGAAACCCCATCTCTAGTAAAAATAAAATTAGCCAGGCAGGTGGTGCCGCCTGTACTCGGGAGGCTGAGGCAGGAGAATCACTTGAACCCAAGAGGCAGAGGTTGCAGTCAGCCAAGATCATGCCATTGCACTCCAGCCTAAGCAAAAAGAGTAAAACTCAGTCTCAAAACAAAAAAACAAAAAAA"
"chr15","21092189","21092737","JH378206","6546474","6546861","200","14545715","GCCGGGCGTGGTGGCTCACGCCTGGCCTGTAATCCCAGCACTTTGGGAAGCCAAGGCGGGTGGTTCACCTGAGGTCAGGAGTTCAAGACCAGCCTGGCCAACATGGTGAAACCCTGTCTCTACTAATAATACAAAAATTAGCTGGGCATGGTGGTGCATGCCTGTAATCCCAGCTACTTGGGAGGCCGAGGCGAGCAGATCACCTGAGGTCAAGAGTTCGATACCAGCCTGACCAACATAGAGAAACCCCGTCTCTACTAAAAATGCAAAATTAGCCGGGCATGGTGGTGCATGCCTGTAATCCCCAGCTACTCGGGAGGCTGAGGCAGGAGAATCGCTTGAACCTGGGAGGCAGAGGTTGTGGTGAGCTGAGATCACGCCATTGCACTCCAGCCTGGGCTCGAAACTCCATCTTAAAAAAAAAAAAAAAAAAAAGAATCACTTGAACCCAGGAGGTGGAGGTTGCAGTGAGCTGAGAGTGCACCATTGTACTCCAGCCTGGGCGACAACAGCAAAACTCCATCACCTTAAAAAAAAAAAAAAAAAAGA","GGCCACACATGGTGGCTAACGCCTGTAATCCCAGCACTTTGGGAGGCCAAGTCGGGTGGATCATGAGGTCAGGAGACCAAGACCATCCTGGCCAAATGGTGAAACCCCGTCTCTACTAAAAATACAAAAATTAGCTGGGCATGGTGGCGTGTGCCTGTAATCCCAGCTACTCAGGAGGCTGAGGCAGGACAATTGCCTGAACCCAGGAGAATTAGCTGGGCATGGTGGCGTGTGCCTGTAATCCCAGCTACTCAGGAGGCTGAGGCAGGACAATTGCCTGAACCCAGGAGGCGAAGGTTGCGGTGAGCCGAGATTGTGCCATTGCACTCCAGCCTGGGTAACAAGAGCGACACTCTGTCTCAAAAAAAAAAAAAAAAAAAAAAAAAAA"
"chr15","21150084","21150391","JH378158","10397018","10397312","55","10753066","GGCCGGGCATGGTGGCTTATGCCTGTAATCCCAGCACTTTGGGAGGCTGAGGTGGGTGGATCACCTGAGGTCAGGAGTTCAAGACCACCCTGGTCAACATGGCAAAATCCTGTCTCTACTAAAAATACAAAATTAGCTGGGCGTGGTGGTGGGCGTCTGCCTGGGTGAGGCAGGAGAATCGCTTGAACCCAAGAGGCAGAGGTTGGAGTGAGCCAAGATCGTGCCATTGCACTCCAGCCTGGGCAACGAGAGTGAAACCCCATCTCAGAAAAAAAAAAGAAAAAGAAAAAGAAAAAAGTAAAAAAAAA","GGCTGAGCACAGTGGCTCACACCTGTAATCCCAGCACTTTGGGAGGCCGAGGCGGGTGGATCACCTGAGATCAGGAGTTCAAGAACAGCCTGACCAACATGGTGAAACCTATCTCTACTAAAAATACAAAATTAGCCTGGCATGGTGGCGCGTGCCTGTAATCTGGCTGAGGCAGAAGAATCGCTTAAACCCAGAGGCAGAGATTGCAGTGAGCCAAGATTGTGTCATTGCACTCCAGCCTGGGCAACAAGAGCAAAACTCCATCTCAGAAAAAAAAAAAAAAAGAAGAAAAAAA"
"chr15","21563578","21564184","JH378118","18053084","18053501","255","3510494","GGCCAGGCATGGTGGCTCACACCTGTAATCGCAGCACTTTGGGAGACTGAGGCAAGCAGATCACCTGAGGTTAGAAGTTCAAGACCAGCCTGGCCAACACAGTGAAACCCCATCTCTACTAAAAATACAAAAAAATGGCCGGGTGCAGTGGCTCATGCCTGTAATCCCAGCACTTTGGGAGGCTAAGGCAGGGGGAATCACAAGGTCAAGAGATCAAGACCATCCTGGTAAAACCCCGTCGGTACTAAAAATACAAAAATTAGCTGGGTGAGGTGGCATGCACCTGTAGCCCCAGCTACTCGGGAGGCTGAGACAGGAGAATCACTTGAACCTGGGAGGCAGAGGTTGCAGTGAGCTGAGATCGCACCACTGCACTCCAGCCTGGCAACAGAGGAAGACTCTGTCTAAAACTAATAATAATAATAATAATAATAATAAAATTAGCTGGGAGTAGTGGCGGGCACCTGTAATCCCAGCTACTTGGGGGGGCTGAGGCAGGAGAAAAGCTTGAACCCGGGAGGTGAAGGTTGCAGTAAGCCAAGATCACGCCATTGCACTCCAGCCCGGGCAACAAGAGCGAAACTTCGTTTCAAAAAAAAAAAAAAAA","GGCTGGGCGCAGTGGCTCACACCTGTAATCCCAGCACTTAGGGAAGCTGAGGCGAGTAGATCACCTGAGGTCAGGAGTTAGAGACCAGCCTGGCCATCATGGTGAAACCCCGTCTCTACTAAAGATACCAAAAATTAGCTGAGTGTGGTGCTGGGTGCCTGTAATCCCAGAAACTCAGGGTGCCTGTAATCCCAGCAACTCAGGGTGCCTTTAATCCCAGCAACTGAGGGTACCAGTAATCCCAGCAACTCAGGGTGTCTTTAATCCTAGCAACTGAGGGCACCTGTAATCCCAGCAACTCAGGAAGCTGAGACAGGAGAAGTACTTGAACCCAGAAGGCAGAGGTTGCAGTGAGCCGATATTGCACCATTGCACTCCAGTCTGGGCAACAAGAGTGAAACTCTGTCTCAAAAAAAAA"
"chr15","22132229","22132799","JH378118","18053084","18053501","233","4079145","GGAGGCCAAGGTGGGCGAATCACCGGTGGTCAGGAGTTTGAGACTAGCCTGGCCAACATGGTGAAACCCCGTCTCTACTAAAAAATACAAAAATTAGGCCGAGTGTGGTGGCTCATGCCTGTAATCCCAGCAGTTTGGAAGGCCAAGGCGGGCAGATCACCTGAGGTCAGGAGTTCAAGACCAGCCTGGCCAACACAGTGGAACCCTGTCTCTACTAAAAATACAAAAAAAATTTGCCAGGCATGGTGGTGTGTGTGCCTATAATCCCAGCTACTCAGGAGACTGAGGCAAGAGAACTGCATGAACCCCAGAGGGAGAGGCTGCAGTGAGCTGAGATCGTACCACTGCACTCCAGCCTGGGTGACAGGGCAGGACTCCGTCTCAAAAAAAAAAAAAAAAAAAAAAAATTAGCCAGGTGTGGTGGCGAGCACCTGTAATCCTAGGTACTTGGGAGGCTGAGAAAGGAGAACCACTTGAACCCCGGAGGCAGAGGTTGCAGTGAGTGGAGATTGTGCGCCATTGCACTCCAGCCTGGGTGACAAGTGTGAAATTCTGCCTCAAAAAAAAAAAA","GGCTGGGCGCAGTGGCTCACACCTGTAATCCCAGCACTTAGGGAAGCTGAGGCGAGTAGATCACCTGAGGTCAGGAGTTAGAGACCAGCCTGGCCATCATGGTGAAACCCCGTCTCTACTAAAGATACCAAAAATTAGCTGAGTGTGGTGCTGGGTGCCTGTAATCCCAGAAACTCAGGGTGCCTGTAATCCCAGCAACTCAGGGTGCCTTTAATCCCAGCAACTGAGGGTACCAGTAATCCCAGCAACTCAGGGTGTCTTTAATCCTAGCAACTGAGGGCACCTGTAATCCCAGCAACTCAGGAAGCTGAGACAGGAGAAGTACTTGAACCCAGAAGGCAGAGGTTGCAGTGAGCCGATATTGCACCATTGCACTCCAGTCTGGGCAACAAGAGTGAAACTCTGTCTCAAAAAAAAA"
"chr15","23508255","23508883","JH378118","18053084","18053501","275","5455171","GGTCGGGTGTGGTGGCTCATGCATGTAATCCTGGCACTTTGGGAGGCCGAGGCGGGTAGATCACCTGAGGTCACGAGTTTGAGACCAGCCTGACCAACATGGTAAAACTTTGTTTCTACTACAAATACAAAAAATTGGCCAGGCTCGGTGGCTTCCGCCTGTAATCCCAGCACTTTGGGAGGCCGGGGTGCATGGATCACCTGAGGTCAGGACTTCGAGACCAGCCTGGCCAACATGGTGAAACCCCATCTCTACTAAAAATACAAAAAAAAAAAAAAAAATGAGCCAGGCATATTGGTGGGCGCCTGTAATCCCAGCTACTTGGAAGGCTGAGACAGGAGAATCACTTGAACCTGGGAGGCGGAGATTGCAGTGAGCCGAGATCATGCCACTGTACTCCATCCTGGGTGACAAGAGTGAGACTGCATCTCAAAAAAAAAAAAACCAAAAAACCAAAAAAAAACAAAAAATTAGTCAACCGTAGTGGTGGGCCCCTATAATCTCAGCTGCTCAGGAGGCTGAGGCAGTAGAATCACTTGATCCCAGGAGGTGGAGGTTTCAGTGAGCTGAGATCATGCCATTGTACTCCAGCCTGGGCAACAAGAGCGAAACTCTATCTCAAAAAATAA","GGCTGGGCGCAGTGGCTCACACCTGTAATCCCAGCACTTAGGGAAGCTGAGGCGAGTAGATCACCTGAGGTCAGGAGTTAGAGACCAGCCTGGCCATCATGGTGAAACCCCGTCTCTACTAAAGATACCAAAAATTAGCTGAGTGTGGTGCTGGGTGCCTGTAATCCCAGAAACTCAGGGTGCCTGTAATCCCAGCAACTCAGGGTGCCTTTAATCCCAGCAACTGAGGGTACCAGTAATCCCAGCAACTCAGGGTGTCTTTAATCCTAGCAACTGAGGGCACCTGTAATCCCAGCAACTCAGGAAGCTGAGACAGGAGAAGTACTTGAACCCAGAAGGCAGAGGTTGCAGTGAGCCGATATTGCACCATTGCACTCCAGTCTGGGCAACAAGAGTGAAACTCTGTCTCAAAAAAAAA"
"chr15","23602365","23603005","JH378118","18053084","18053501","286","5549281","GGTCGGGTGTGGTGGCTCATGCATGTAATCCTGGCACTTTGGGAGGCCGAGGCGGGTAGATCACCTGAGGTCACGAGTTTGAGACCAGCCTGACCAACATGGTAAAACCTTGTTTCTACTACAAATACAAAAAATTGGCCAGGCTCGGTGGCTTCCGCCTGTAATCCCAGCACTTTGGGAGGCCGGGGTGCATGGATCACCTGAGGTCAGGACTTCGAGACCAGCCTGGCCAACATGGTGAAACCCCATCTCTACTAAAAATACAAAAAAAAAAAAATGAGCCAGGCATATTGGTGGGCGCCTGTAATCCCAGCTACTTGGAAGGCTGAGACAGGAGAATCACTTGAACCTGGGAGGCGGAGATTGCAGTGAGCCGAGATCATGCCACTGTACTCCATCCTGGGTGACAAGAGTGAGACTGCATCTCAAAAAAAAAAAAAACCAAAAAACCAAAAAAAACCAAAAAATTAGTCAACCGTAGTGGTGGGCCCCTATAATCTCAGCTGCTCAGGAGGCTGAGGCAGTAGAATCACTTGATCCCAGGAGGTGGAGGTTTCAGTGAGCTGAGATCATGCCATTGTACTCCAGCCTGGGCAACAAGAGCAAAACTCTATCTCAAAAAAAAAAAAAAAAAAGAAAAA","GGCTGGGCGCAGTGGCTCACACCTGTAATCCCAGCACTTAGGGAAGCTGAGGCGAGTAGATCACCTGAGGTCAGGAGTTAGAGACCAGCCTGGCCATCATGGTGAAACCCCGTCTCTACTAAAGATACCAAAAATTAGCTGAGTGTGGTGCTGGGTGCCTGTAATCCCAGAAACTCAGGGTGCCTGTAATCCCAGCAACTCAGGGTGCCTTTAATCCCAGCAACTGAGGGTACCAGTAATCCCAGCAACTCAGGGTGTCTTTAATCCTAGCAACTGAGGGCACCTGTAATCCCAGCAACTCAGGAAGCTGAGACAGGAGAAGTACTTGAACCCAGAAGGCAGAGGTTGCAGTGAGCCGATATTGCACCATTGCACTCCAGTCTGGGCAACAAGAGTGAAACTCTGTCTCAAAAAAAAA"
"chr15","23603280","23603615","JH378109","21565230","21565567","55","2038050","GGCCAGGCGCGGTGGCTCATGCCTATAAACTCAGCACTTTGAGAGGCTGAGGCGGGTGGGTCACCTGAGGTCAGGAGTTAGAGACCAGCCTGGCCAACATGGTGAAACCGTGTTTCTACTAAAGATACAACATTAGCCAGGCATGGTGGCGCATGCCTGTAATCCCAGCTACTAGGGAGGCTGCGGCAGGAGAATCGCTTGAACGCAGGAGGTGAAGGTTGCAGTGAGCTGAGATCGTGCCATTGCACTCCAGCCTGGGTGACAAGAGCGAAACTCCATCCCAATCAATCAATCAATCAATCAATCAATTAAATTAAAAAAATAAAAAGAAAGAAA","GGCCGGGCGCGGTGGCTCAAGCCTGTAATACCAGCACTTTGGGAGGCCGAGGCGGGTGGATCACGAGGTCAAGAGATCGAGACCATCCTGGTCAACATGGTGAAACCCCGTCTCTACTAAAAATACAAACAATTAGCTGGGCATGGTGGCGGGTGCCTGTAATCCCAGCTACTCCAGAGGCTGAGGCAGGAGAATTGCCTGAACCCAGGAGACGGAGGTTGCGGTGAGCCAAGATCGCGCCATTGCACTCCAGCCTGGGTGACAAGAGCGAAACTCCGTCTCAATAAATAAATAAATAAATAAATAAATAAAAATAAAATAAATAAATAAATAAATAA"
"chr15","38315253","38315599","JH378169","5922203","5922541","56","32393050","GCCAGACACGGTGGCTCACGCCTGTAATCCCAGCACTTTGGGAGGCCGAGGCGGGTGGATCACCTGAGGTCAGGAGTTCGAGACCAGCCTGGCCAACATGGCGAAATCCTGTCTCTACTAAAAATACACACACACACACACACACACACACACACACACACACACATACACACACAAAATTAGCTGGGCATGGTGGCAGGTGCCTGTAATCCCAGCTACTTGGGAGGCTGAGGCAGGAGAATCACTTGAACCTGGGAGGCGGAGATTGCAGTGAGCCAAGATCATGCCATTGCACTTCAGCCTGGGCAACGAGAGTGAAACTCTGTCTCAAAAAAAAAAAAAAAAAA","GGCCAAGGGTGGTGGCTCACACCTGTAATCCCAACACTCTGGGAGGCCAAGGTGGGTGGATCACCTAAGGTCAGGAGTTCAAGACCAGCATGGCCAATATAGTGAAACTCTGTCTCTACTAAAAATACACACACACAAAAAAAAACAAAACACAAAAAAAACCACAAAATTAGCCGGGCATGGTGGCATGTGCCTGTAATCCCAGCTACTCAGGAGGCTGAGGCAGGAGAATCACTTAAACCCAGGAAGCGGAGGTTGCAGTGAGCCAAGATTGCGCCACTGCACTCCAGCCTAGGTGACAAGAGCAAAACTCTGTCTCAAAAAAAAAAAAAAAAAAAA"
"chr15","39410478","39411079","JH378118","18053084","18053501","249","21357394","GGCCGGGCACGGTGGCTCACGCCTGTAATCCCAGCACTTTGGGAGTCTGAGGTGGGCAGATCCACCTGAGGTCAGGGGTTCAAGACCAGCATGGCCAACATGGTGAAACCTCATCTCTACTAAAAATACAAAAATTAGGCTGGGTGCGGTGGCTCACGCCTGTAATCCCAGCACTTTGGGAGGCCAAGGCAGGTGGATCACCTGAGGTCAGGAGTTCGAGACCAGCATGGCCAACATAGCGAAAATCCGTCTCTACTAAAAACACAAAAATTAGCCAGGTGTGTTGGCTTACACCTGTAATCCCAGCTACACAGGAGGCTGAGGCAGAAGAATCACTTGAATCCAGGAGGTGGAGGTTGCAGTGAGCCGAGATCGCGCCACTGCCCTCCAGCCTGGGTGACAGAGCAAGACACCATCTCAAAAAAAAAAAAAAAAAAATTAGCTGGGCATGGTCACAGGTGCCCCTAATCCCAGCTACTCAGGAGGCTGAGGCAGGAGAATTGCTTGAACCCAGGAGACGGAGGTCACAGTGAGCGGTAATTGTGCCATTGCACTTCAACCTGGGTGACAAGAGCAAAAGTCCATCTCAAAAAAAAAAAAAA","GGCTGGGCGCAGTGGCTCACACCTGTAATCCCAGCACTTAGGGAAGCTGAGGCGAGTAGATCACCTGAGGTCAGGAGTTAGAGACCAGCCTGGCCATCATGGTGAAACCCCGTCTCTACTAAAGATACCAAAAATTAGCTGAGTGTGGTGCTGGGTGCCTGTAATCCCAGAAACTCAGGGTGCCTGTAATCCCAGCAACTCAGGGTGCCTTTAATCCCAGCAACTGAGGGTACCAGTAATCCCAGCAACTCAGGGTGTCTTTAATCCTAGCAACTGAGGGCACCTGTAATCCCAGCAACTCAGGAAGCTGAGACAGGAGAAGTACTTGAACCCAGAAGGCAGAGGTTGCAGTGAGCCGATATTGCACCATTGCACTCCAGTCTGGGCAACAAGAGTGAAACTCTGTCTCAAAAAAAAA"
"chr15","45225530","45226131","JH378133","19690365","19690767","253","25535165","GGCCGGGCACAGTGGCTCATGCCTGCAGTTCCAGCACTTTTGGAGGCCGAGGCAGGCCGATCACTTGAGGTCAGGAGTTCGAGACCACCCCGGCTAACGTGGTGCAACTCCATCTCTACTAAAAATACAAAATTGGCCGGGTGCGGTGGCTCATGCCTGTAATCCCAGCACTTTGGGAGGCCGAGGCGGATGGATCACCTCAGGTCAGGAGTTCGAGACCAGCCTGGCCAATGTGGTGAAACCCCGTCTCTACTAATAATACAAAAATTAACTGGGTGTGGTGGTGGGCACCTATAATCCCAGCTACTCGGGAAGCTGAGGCAGGAGAATCACTTGAACCTGGGAGGTGGAGATTGCAGTGAGCTGAGATGGTGCCATTACACTCCAGCCTGGGCAACGAGAGTGAAACTCTGTCTCTAAATAAATAAATACAAAATTAGCCGGGCATGGTGGCGGATGCCTATAATCACAGCTACTTGGGAGGCTGAGGCAAGAGAATCACTTGAACCTGGGAGGTGGAGGTTGCAGTGAGCTGAGATCAAGCCATTGCACTCCAGCCTGGGCAAAAAGAGTGAAACTCTGTCTCAAAAAAAAGAAAGAAA","GGCCAGGCACAGTGGTTCATGTCTGTAATCAGCATTTTGGGAGGCTGAGGCGGGAGAATCACCTGAGGCCAGGAGTTCTAGATGAGCCTGGGCAAATAGTGACAACCTGTCCCTACAAAAAAATTTAAAATTAGCCAGGATTGAGACCATCCTGGCTCACGTGGTGAAACCCCATCTTTACTTAAAATACTTAAAATGCAAAAAACATTTTTTTTTGTATTTTATTTAAAATACAAAAAAACTAGGCAGGCATGTTGGCACGTGCCTGTAGTCCCAGATACTTGGGAGGCTGAGGCAAGAGAATCACTTGAACCCAGGAGGTGGAGGTTGCAGTGAGCCGAGATCATACCACTGCACTCCAGCCTGGGTGACAAGAGTGAAACTCTGTCTCAAAAAAAAACAA"
"chr15","46581057","46581661","JH378118","18053084","18053501","254","28527973","GGCCGGGCGCGGTGGCTCACGCCTGTAGTCCCAGACTTTGGGAGGCCGAGGTGGGCGGATTGCCTGAGGTCAGGAGTTCAAGACCAACCTGGCCAACATGGTGAAATGCCGTCTCTACTAAAAATACAAAAATTAGGCCGGGCACGGTGGCTCATGTCTATAATCCCAGCACTTTGGGAGGCCGAGGTGGGCGGATCACGAGGTCAGGAGATCGAGACCATCCTGGCTAACACGGTGAAACCCCGTCTCTACTAAAAACACAAAAAATTAGCCGGGCGTGGTGGCAGGCACCTGTAGTCTCAGCTACTCAGGAGGCTGAGGCAGGAGAATGGCGTGAACTTGGGAGGCGGAGCTTGCAGTGAGCCAAGATTGTGCCACTGCACTCCAGCCTGGGCAACAGAGCGAGACTCTGTCTCAAAAAAAAAAAAAAAAATTAGCCAGGTGTGGTGGCAGGTGCCTGTAATCCCAGCTAATTGGGAGGCTAAGGCAGGAGAATCTCTTGAACCCAGGAGGCAGAGGTTGCAGTGAGCCAAGATTTCGCCATTACACTCCAGCCTGGGCAACAAGAGCTAGACTCCATCTCAAAAATAAATAAATAAAATAAA","GGCTGGGCGCAGTGGCTCACACCTGTAATCCCAGCACTTAGGGAAGCTGAGGCGAGTAGATCACCTGAGGTCAGGAGTTAGAGACCAGCCTGGCCATCATGGTGAAACCCCGTCTCTACTAAAGATACCAAAAATTAGCTGAGTGTGGTGCTGGGTGCCTGTAATCCCAGAAACTCAGGGTGCCTGTAATCCCAGCAACTCAGGGTGCCTTTAATCCCAGCAACTGAGGGTACCAGTAATCCCAGCAACTCAGGGTGTCTTTAATCCTAGCAACTGAGGGCACCTGTAATCCCAGCAACTCAGGAAGCTGAGACAGGAGAAGTACTTGAACCCAGAAGGCAGAGGTTGCAGTGAGCCGATATTGCACCATTGCACTCCAGTCTGGGCAACAAGAGTGAAACTCTGTCTCAAAAAAAAA"
"chr15","46659994","46660594","JH378118","18053084","18053501","247","28606910","GCTGGGCATGGTGGCTTACGCCTGTAATCCCAGCACCTTGGGAGGCTGAAGTGAGCAAATCACCTGAGTTCAGGAGTTCAAGACCAGCCTGGCCAACATGGTGAAAACCCATCTCTATTAAAAATTACAAAAATGGCCAGACACGGTAGCTCACGCCTGTAATCCCAGCACTTTGGGAGGCTGAGGCGGGCAGATCACCTGAGGTTGGGAGTTGGAGACCAGCTTGACCAACATGGAGAAACCCCCTCTCTACTAAAAATACAAAATTAGCCAGGCGTGGTGGCACATGCCTGTAATCCCAGCTACTTGGGAGGCTGAGGCAGGAGAATCACTTCAACCCGGAAGGTGGAGGTTGTGGTGAGCTGAGATTGTGTCATTGCACTCTAGCCTGGATAACAAAGGCAAAACTCAGTCTCAAAAAAAAAAAAAATTACAAAAATTAGCTGGCGTGGTGGCAGGTGCCTATAATCCCAGCTACTCAGGAAGCTGAGGCAGGAGAATCACTTGAAACCAGGAGGCAGAGGTTGCAGTGAGCTGAGACCACGCCATTGCCCTCCTGCCTGGGTGACAAGAGTGAAACTCCATCTCAAAAAAAAAAAAA","GGCTGGGCGCAGTGGCTCACACCTGTAATCCCAGCACTTAGGGAAGCTGAGGCGAGTAGATCACCTGAGGTCAGGAGTTAGAGACCAGCCTGGCCATCATGGTGAAACCCCGTCTCTACTAAAGATACCAAAAATTAGCTGAGTGTGGTGCTGGGTGCCTGTAATCCCAGAAACTCAGGGTGCCTGTAATCCCAGCAACTCAGGGTGCCTTTAATCCCAGCAACTGAGGGTACCAGTAATCCCAGCAACTCAGGGTGTCTTTAATCCTAGCAACTGAGGGCACCTGTAATCCCAGCAACTCAGGAAGCTGAGACAGGAGAAGTACTTGAACCCAGAAGGCAGAGGTTGCAGTGAGCCGATATTGCACCATTGCACTCCAGTCTGGGCAACAAGAGTGAAACTCTGTCTCAAAAAAAAA"
"chr15","46772064","46772669","JH378118","18053084","18053501","251","28718980","GGCTGGGTGCAATGGCTCATGCCTGTAATTCCAGTGTTTTGGGAGGCCGAGGCAGGTGGATCACTTGAGATCAGGAGTTCGCGACCAACCTGGCTAACATGGTGAAACCCCGTCTCTACTAAAAATACAAAAAATTGGCCAGGAGCGGTGGCTCAAACCTGTAATTCCAGCACTTTGGGAGGCCGAGGGGGGCAGATCACGATGTTTAGGAGTTTGAGATCAGACTGACCAACATGGTGAAACCCCATCTCTACTAAAAATACAAAAATTAGCCAGGCGTGGTGGTGCATGTCTGTAATCCCAGCTACTTGGGAGGCTGAGGCAGGAGAGTTGCTTGAAGCCGGGAGGTGGAGGTTGCAGTGAGCTGAGATCACACCACTGCACTCCAGCCTGGGCGACAGAGCAAGACTGTCTCAAAAAAAAAAAAAAAAAAAAAAATTAGCCAGCTTGGTGGCGGGCATCTGTAATCCCAGCTACTCGGGAGGCTGAGGCAGGAGAATCACTTGAACCCAGGAGGCAGAGGTCGCAGTGAGCCAAGATCACGCCATTGTACTCCAGCCTGGGCAACAAGAGCAAAACTCCATCTCAAAAAACAAAAAATAAAAA","GGCTGGGCGCAGTGGCTCACACCTGTAATCCCAGCACTTAGGGAAGCTGAGGCGAGTAGATCACCTGAGGTCAGGAGTTAGAGACCAGCCTGGCCATCATGGTGAAACCCCGTCTCTACTAAAGATACCAAAAATTAGCTGAGTGTGGTGCTGGGTGCCTGTAATCCCAGAAACTCAGGGTGCCTGTAATCCCAGCAACTCAGGGTGCCTTTAATCCCAGCAACTGAGGGTACCAGTAATCCCAGCAACTCAGGGTGTCTTTAATCCTAGCAACTGAGGGCACCTGTAATCCCAGCAACTCAGGAAGCTGAGACAGGAGAAGTACTTGAACCCAGAAGGCAGAGGTTGCAGTGAGCCGATATTGCACCATTGCACTCCAGTCTGGGCAACAAGAGTGAAACTCTGTCTCAAAAAAAAA"
"chr15","48446925","48447526","JH378118","18053084","18053501","252","30393841","GGCCAAGTGCAGTGGCTCACGTTTGTAATCCCAGCACTTTGGGAGGCCGAGGCGGGTGGATCACCTGATGTCAGGGGTTTGAAACCAGCCTGGCCAACATGGTGAAACCCCATCTCTAATAAAAATACAAAACTGGCCAGGTGCAGTGGCTCATGCCTGTAATCCCAGCACTTTGAGAGACCAAGGGAGGCAGATCACCTGAGGTCAGGAGTTCCAGACCAGCCTAGCCAACATGGTGAAACCCTATCTCTACTAAGAGTACAAAAATTAGCCTGGCGTGGTGGCAGGCGCCTGTAATCCCAGCTACTCAGAAGGCTGAGGCAGGAGAATCACTTGAACCCAGGAGGCGGAGGTTGCAGTGAGCCGAGATTGAGCCACTACACTCCAGCCTGGGTGACAAGAACAAGACTCTGTCTCAAAAAAAAAAAAAAAAAAAGCCGGTCATGGTGGCACATGCCTATAATCCCAGCTTCTTGGGAGGCTGAGGCAGGAGAACCACTTGAACCTGGGAGGTGGAGGCTGCAGTGAGCCGAAATTGTGCCATTGCACTCTAGCCTGGGCAACAAGAGCAAAACTCTCTCAAAAAAAAAAAAAAAAAAAAA","GGCTGGGCGCAGTGGCTCACACCTGTAATCCCAGCACTTAGGGAAGCTGAGGCGAGTAGATCACCTGAGGTCAGGAGTTAGAGACCAGCCTGGCCATCATGGTGAAACCCCGTCTCTACTAAAGATACCAAAAATTAGCTGAGTGTGGTGCTGGGTGCCTGTAATCCCAGAAACTCAGGGTGCCTGTAATCCCAGCAACTCAGGGTGCCTTTAATCCCAGCAACTGAGGGTACCAGTAATCCCAGCAACTCAGGGTGTCTTTAATCCTAGCAACTGAGGGCACCTGTAATCCCAGCAACTCAGGAAGCTGAGACAGGAGAAGTACTTGAACCCAGAAGGCAGAGGTTGCAGTGAGCCGATATTGCACCATTGCACTCCAGTCTGGGCAACAAGAGTGAAACTCTGTCTCAAAAAAAAA"
"chr15","59372839","59373447","JH378118","18053084","18053501","260","41319755","GGCCAGGATCAGTGTCTCACACCTGTAATCCTAGCACTTTGGGAGGCTAAGGTGGGCGGATTACTTGAGGTCAGGAGTTTGAGACCAGCCTGGGCAACATGGTGAAACCCCGTCTCTACTAAAAATACAAAAATTAGCTGGGCATAGGCCAGGAGTGGTGGCTTACGCCTGTAATTCCAGGACTTTGGGAGGCTGAGGCGGGCAGATCATGAGGTCAGGAGATTGAGACCATCCTGGCTAACATGGTGAAACCTCATCTCTACTAAAAATACAAAAATTAGCCAGTCGTGGTGGTAGGCGCCTGTAGTCCCAGCTACTTGAGAGGCTGAGGCAGGAGAATCACTTGAATCCGGGAGGTGGAGGTTGCAGTGAGCCGAGATTATGCCACTTCACTCCAACCTGGTGACAGAGCAAGACTCCGTCTAAAAAAAAAAAAAAAAATTAGCTGGGTGTGGCGGGCACTTGCAATCCCAGCTACTTAGGAGGCTGAGGCAGGAGAACCGCTTGAACCTGGGAGGTAGAGGTTCCAGATCACGCCATTGCACTCCTGCTTGGGCAACAAGAGTGACACTCCATCTCAAAAAAACAAAAAAAAAAAAGAAAAAGAAA","GGCTGGGCGCAGTGGCTCACACCTGTAATCCCAGCACTTAGGGAAGCTGAGGCGAGTAGATCACCTGAGGTCAGGAGTTAGAGACCAGCCTGGCCATCATGGTGAAACCCCGTCTCTACTAAAGATACCAAAAATTAGCTGAGTGTGGTGCTGGGTGCCTGTAATCCCAGAAACTCAGGGTGCCTGTAATCCCAGCAACTCAGGGTGCCTTTAATCCCAGCAACTGAGGGTACCAGTAATCCCAGCAACTCAGGGTGTCTTTAATCCTAGCAACTGAGGGCACCTGTAATCCCAGCAACTCAGGAAGCTGAGACAGGAGAAGTACTTGAACCCAGAAGGCAGAGGTTGCAGTGAGCCGATATTGCACCATTGCACTCCAGTCTGGGCAACAAGAGTGAAACTCTGTCTCAAAAAAAAA"
"chr15","64220715","64221335","JH378118","18053084","18053501","268","46167631","CCAGGCACAGTGGCTCATACCTGTAATCCCAGCACTTTGGGAGCCCAAGGCGGGCAGATCACCTGAGGTCAGGAGTTCGAGACCAGCCTGGACAACATGGAGAAACTCCATCTCTACTAAAAATACAAAATGAGGCCGGGCACAGTGGCTCACACCTATAATCCCAGCACTTTTGGAGGCCGAGACAGGCAGCTCACGAGGTCAGGAGTTCAAGACCAGCCTGGCCAGCATGGTGTAACCCCGTTTCTACTAAAAATACAAAAATTAGCCAGGCATGGTGGTGCGTGCCTGTAGTCCTCAGGAGGCTGAGGCAGGAGAATCGCTTGAATCTGGGAGGCGGAGCTTGCAGTCAGCTGAGATCAGGCTACTGCACTGCAGCTTGGGCAACAGAGTGAGACTCCGTCTCAAAAACAAACAAACAAACAAACAAAACACAACAAAATTAGCTGGGCATGGTGGCAGGTGCCTGTAATCCCAGCTACTCAGCTACTCAGGAGGCTGAGGCAGGAGAGTCACGTGAACCTGGGAGGCAGAGGTTGCAGTGAGCCAAGATCACGCCATTGCACTCCAGCCTGGGCAACAAGAGGGAAATTACATCTCAAAAAAAAAAAAAAAAAAAAA","GGCTGGGCGCAGTGGCTCACACCTGTAATCCCAGCACTTAGGGAAGCTGAGGCGAGTAGATCACCTGAGGTCAGGAGTTAGAGACCAGCCTGGCCATCATGGTGAAACCCCGTCTCTACTAAAGATACCAAAAATTAGCTGAGTGTGGTGCTGGGTGCCTGTAATCCCAGAAACTCAGGGTGCCTGTAATCCCAGCAACTCAGGGTGCCTTTAATCCCAGCAACTGAGGGTACCAGTAATCCCAGCAACTCAGGGTGTCTTTAATCCTAGCAACTGAGGGCACCTGTAATCCCAGCAACTCAGGAAGCTGAGACAGGAGAAGTACTTGAACCCAGAAGGCAGAGGTTGCAGTGAGCCGATATTGCACCATTGCACTCCAGTCTGGGCAACAAGAGTGAAACTCTGTCTCAAAAAAAAA"
"chr15","65873443","65873774","JH378165","3784440","3784761","45","62089003","GGCCAGGCACGGTGGCTCACACGTGTAATCCCAGCACCTTGGGAGACCGAAGCAGGTGGATCACCTGAGGTCAGGAGTTTGAGGCCAGCCTGGCCGATATGGTGAAACCCTATCTCTATTAAAAATACCAAAAAAAAAAAAAAAAAAAAAAAAACCTGCTGGGCGTGGTGGCGCACGCCTGTAATCCCAACTACTCAGGAGGCTGAGGCAGGAGAATCACTTGAATCCAGGAGGCAGAGGTTGCAGTGAGCCGAGATCGCGCCATTGCACTCCAGCCTGGGCAACAAGAGCGAAACTCGGTCTCAAAAAAAAAAAAAAAAAAAGAAAAGAAA","GGCCGGGCGCGGTGGCTCAAGCCTGTAATCCCAGCACTTTGGGAGGCCGAGGCAGGTGGATCATGAGGTCAAGAGATCAAGACCATCCTGGTCAACATGGTGAAACCCCGTCTCTACTAAAAATACAAAAAAAAAAAAAAAAAAACTAGCTGGGCGTGGTGGCGCATGCCTGTAATCCCAGCTACTCAGGAGGCTGAGGCAGGAGAATTGCTTGAACCCAGGAGGCGGAGGTTGCGGTGAGCCCAGATCGCGCCATTGCACTCCAGCCTGGGTAACAAGAGCAAAACTCCATCTCAAAAAAAAAAAAAAAAAAAAAAAAAAA"
"chr15","70453292","70453944","JH378118","18053084","18053501","292","52400208","GGCCAGGCACGGTGGCTCATGCCTGTAATCCCAACACTTTGGGAGGCTGAGGTAGGTAGATCACCTGAGGTTGAGGTCAGGAGTTTGAGACCAGCCTGGCCAACATGGTGAAACTCTGTCTCTACTAAAAATACAAAAATTTGGCCCGGCGCAGTGGCTCACCTGTAATCCCAGCACTTTGGGAGGCCGAGGCAGGCAGATCACGAGGTCTGGAGATCAAGACCATCCTGGCTAACTCGGTGAAATCCCATCTCTACTAAAAATACGAAAAATTAGCCAGGTGTGGTGGCGGGCACCTGTAGTCCCAGCTACTTGGGAGGCTGAGGCAGGAGAATGGCGTGAACCTGGGAGGTGGAGCTTGCAGTGGGCCAAGATCACGCCACTGCACTCCAGCCTGGGCAACAGAGTGAGACTCTGTCTCAAAATAAAATAACATAAAATAAAATAAAGTAATATAAAATAAAAATACAAAAATTAGCTGGGCATGGTAGCGGGTACCTATAATTCCAGCTACTTGAGAGGCTGAGGCTGGAGAATCACTTGAATCTGGGAGGTGGAGGTTGCAGTGAGCCAAGATTGCACCATTGCACTCCAGCCTGGGCAACAAGAGCCAAACTCCGTATCAAAAAAAAAAAAAAAAAGAAAAAGAAAAA","GGCTGGGCGCAGTGGCTCACACCTGTAATCCCAGCACTTAGGGAAGCTGAGGCGAGTAGATCACCTGAGGTCAGGAGTTAGAGACCAGCCTGGCCATCATGGTGAAACCCCGTCTCTACTAAAGATACCAAAAATTAGCTGAGTGTGGTGCTGGGTGCCTGTAATCCCAGAAACTCAGGGTGCCTGTAATCCCAGCAACTCAGGGTGCCTTTAATCCCAGCAACTGAGGGTACCAGTAATCCCAGCAACTCAGGGTGTCTTTAATCCTAGCAACTGAGGGCACCTGTAATCCCAGCAACTCAGGAAGCTGAGACAGGAGAAGTACTTGAACCCAGAAGGCAGAGGTTGCAGTGAGCCGATATTGCACCATTGCACTCCAGTCTGGGCAACAAGAGTGAAACTCTGTCTCAAAAAAAAA"
"chr16","217191","217526","JH378138","4229795","4230103","77","4012604","ATTTTGGGAGGCTGAGATGAGTGATGAGCGGATCACCTGAGGTCAGGAGCTCGAGACCAGTCTGGCCAACACGGTGAAACCCTGTCTCTACTAAAAGTACCAAAAAAATTAGCCAGGCATGGCAGTGGGCGCCTGTAATCCCAACTACTCGGGAGGCTGAGGCAGGAGAATCACTTGAACCTGGGAGGTGGATGTAGCAGTGAGCCGGGATCGTGCCACTGAACTCCAGCCTGGGCGATAAGATCAAAACTCTGTCTCTCTCTCACACACACACACACACACACACACACACACACACACACCCCCAAAAAAAAAAACAAAAAAAAGAAAAAGAAA","CACTTTGGGAGGTGAAGGCGGGCAGATCACCTGAGGTCAGGAGTTCGAGACCAGCCTGGCCAACATGGTGAAACCCCGCCTCTACTAAAAATACAAAAATTAGCCAGGTGTGACACTAGGCATCTGTAATCCCAGCTACTTGGGAGGCTGAGACAGGAGAATCACTTGAACCCAGGAGGCGGAAGTTGCAGTGAGCCAAGATCATGCCATTGCACTCCAGCCTGGGTGACAGGAGCAAAACTCTGTCTCAAAAAAAAAAAAAAAAAAAAAAAAAAAAAAAAAAAAAAAAGAAAAGAAAAGAAAAGTAAA"
"chr16","384893","385508","JH378118","18053084","18053501","265","17668191","GGCCGGGCGTGGTGGCTAACACGGGTAGTCCTAGCACTTTGGGAAGCCAAGGCAGGCAGATCACTTGAGGTCAGGAGTTTGAGATCAGTCTGGCCAACATGGTGAAACCACGCCTCTACTAAAAATACAAAAGTTATGGCCGAGCGTGGTGGCACGCGCCTGTAATCCCAGCACTTTGGGATGCTGAGGCAGGCGCATCACCTAAGGTCGGGAATTCAAGACCAGCCTGACCAACATGGAGAAACCACGTTTCTACTAAAAATACAAAATTAGCCGGGTGTGGTGGCACATGCCTGTAGTTTCAGCTACTCAGGAGGCTGAGGCAGGAGAATCACTTGAATCCGGGAGGCGGAGATTGTGGTGAGCCGAGATCGGGCCATTGCACTCCAGCCTGGGCAACAAGAGAGAAACTCTGTCTCAAAAAAAAAAAAAAAAAATTAGCCAGGCATGGTAGCCTGTGCCTGTAATCCCAGCTACTTGGGAGGCTGAGGCAGGAGAATCGCTTGAACCTGGGAGGCAGAGGTTGCAGTGAGCCGCGATTGCGCCATTGCACTCTCCAGCCTGGGGGAGAAGAGCAAAACTCCATCTCAAAAATAAATAAATAAATAAAAATAAA","GGCTGGGCGCAGTGGCTCACACCTGTAATCCCAGCACTTAGGGAAGCTGAGGCGAGTAGATCACCTGAGGTCAGGAGTTAGAGACCAGCCTGGCCATCATGGTGAAACCCCGTCTCTACTAAAGATACCAAAAATTAGCTGAGTGTGGTGCTGGGTGCCTGTAATCCCAGAAACTCAGGGTGCCTGTAATCCCAGCAACTCAGGGTGCCTTTAATCCCAGCAACTGAGGGTACCAGTAATCCCAGCAACTCAGGGTGTCTTTAATCCTAGCAACTGAGGGCACCTGTAATCCCAGCAACTCAGGAAGCTGAGACAGGAGAAGTACTTGAACCCAGAAGGCAGAGGTTGCAGTGAGCCGATATTGCACCATTGCACTCCAGTCTGGGCAACAAGAGTGAAACTCTGTCTCAAAAAAAAA"
"chr16","1668152","1668787","JH378118","18053084","18053501","287","16384932","GGCCGGGCACGGTGCCTCGTTCCTGTAATCCCAGCACTTTGGGAGGCCAAGGTGGGTGGATCACCTGAGGTCAGGAGTTCGAGACATGCCTGGCCAACATGGCAAAATCCTGTCTTTACTAAAAATACAAAAATTAAGCCGGGCGCTGTGACTCATGCCTGTAATCCCAGCACTTTGGGAGGCCAAGGCGGGCGGATCACAAGGTCAGGAGATTGAGACCATCCTGGCTAACACGGTGAAAACCCGTCTCTACTAAAAATACAAAAAATTAGCCAGGTGTGGTGGCGGGTGCCTGTAGTCCCAGCTACTCGGGAGGCTGAGGCAGGAGAATGGCGTGAACCCGGGAGGCGGAGCTTGCAGTGAGCCGAGATCGTGCCACTGCACTCCAGTCTGGGCAACAGAGCAAGACTCTCTCTCAAAAAGAAACAAACAAAAAAAAAAATGAAAAAAGAAAAATTAGCCAGGCGTGGTGGCGGGTGCCTATAATCTCAGCTACTCGGGAGGCTGAGGCAGAAGTATCATTTGAACCCAGGAGGCGGAGGTTGTAGTGATCCAAGATAGCGCCATTGCACTGCAGCCTGGGTGACAACAGTGAAACTCCGTCTCAAAAAAAAAAAAAAAAAAGAAAGAAAGAAA","GGCTGGGCGCAGTGGCTCACACCTGTAATCCCAGCACTTAGGGAAGCTGAGGCGAGTAGATCACCTGAGGTCAGGAGTTAGAGACCAGCCTGGCCATCATGGTGAAACCCCGTCTCTACTAAAGATACCAAAAATTAGCTGAGTGTGGTGCTGGGTGCCTGTAATCCCAGAAACTCAGGGTGCCTGTAATCCCAGCAACTCAGGGTGCCTTTAATCCCAGCAACTGAGGGTACCAGTAATCCCAGCAACTCAGGGTGTCTTTAATCCTAGCAACTGAGGGCACCTGTAATCCCAGCAACTCAGGAAGCTGAGACAGGAGAAGTACTTGAACCCAGAAGGCAGAGGTTGCAGTGAGCCGATATTGCACCATTGCACTCCAGTCTGGGCAACAAGAGTGAAACTCTGTCTCAAAAAAAAA"
"chr16","2310740","2311369","JH378118","18053084","18053501","271","15742344","GGCCGGGCACAGTGGCTCACGCCTATAATATCAGCACTTTGGGAGACCAAGGCGGGTGGATCACCTAAGGTCAGGAGTTCAAGACCAGCCTGACCAACATGGTGAAACCCCATCTCTACCAAAAATAGAAAACATTAGTCTTGGCCGGGCACGGTGACTCATACCTGTAATTCCAGCACTTTGGGAGGCCGATCACCTGGCGGATCACCTGAGGTCGGGAGTTTGAGACCAGCCTGACCAACATGGAGAAACCCCGTCTCTACTAAAAATACAAAATTAGCTGTGCGTAGTGGCCCATGCGTGTAATCCCAGCTACTCAGGAGACTGAGGCAGGAGAATGGCTTGAACCTGGGAGGCGGAGGTTGTGCTGAGCCAAGATCGCACCATTGCACTCCAGCCTGGGCAATAAGAGTGAAACTCCGTTTCATAAAACAAAAAACAAAAAACAAAAAAAAAACCATTAGCCAGGCATTGTGGCAGGCACCTGTAATCCCAGCTACTCAGGAGGCTGAGGCAGAATGGCTTGAACCGGGGAGGCAGAGGTTGCAGTGAGCCGAGATCGCGCCATTGCACTCCAGCCTGGGCAACAAAAGTAAAACTCTGTCTCAAATAAAAAAAAGAGAGAAAAAA","GGCTGGGCGCAGTGGCTCACACCTGTAATCCCAGCACTTAGGGAAGCTGAGGCGAGTAGATCACCTGAGGTCAGGAGTTAGAGACCAGCCTGGCCATCATGGTGAAACCCCGTCTCTACTAAAGATACCAAAAATTAGCTGAGTGTGGTGCTGGGTGCCTGTAATCCCAGAAACTCAGGGTGCCTGTAATCCCAGCAACTCAGGGTGCCTTTAATCCCAGCAACTGAGGGTACCAGTAATCCCAGCAACTCAGGGTGTCTTTAATCCTAGCAACTGAGGGCACCTGTAATCCCAGCAACTCAGGAAGCTGAGACAGGAGAAGTACTTGAACCCAGAAGGCAGAGGTTGCAGTGAGCCGATATTGCACCATTGCACTCCAGTCTGGGCAACAAGAGTGAAACTCTGTCTCAAAAAAAAA"
"chr16","3075498","3075819","JH378114","26407278","26407597","46","23331780","GGCCAGGCGCGGTGGCTCACACCTGTAATCCCAGCACTTTGGGAGGCCAAGGCGGGCAGATCACGAGGTCAAGAGATCGAGACCATCCTGGCCAACCTGGTGAAACTCTGTCTCTACTAAAAATACCAAAAAAAAAAAAAAAAAAAAAAAAAAAAAGCATGGTGGCAGGTGCCTGTAATCCCAGCTACTTGGGAGGCTGAGGCAGAATTGCTTGAACCCGGGAGGCAGAGGTTGCAGTGAGTTGAGATCATGCCATTGCACTCCAGCCTGGGCAAAAAGAGCGAAACTCTGTCTCAAAAAACAAAACAAAAACAAAAACAAA","GGCCGGGCGCAGTGGCTCAAGCTTGTAATCCCAGCACTTTGGGAGGCCGAGGCGGGTGGATCACGAGGTCAAGAGATCGAGACCATCCTGGTCAACATGGTGAAACCCCGTCTCTACTAAAAATACAAAAAAAAAAAAAAAAAATTAGTTGGGCATGGTGGTGTGTGCCTGTAATCCCAGCTACTCAGGAGGCTGAGGCAGGAGAATTGCCTGAACCCAGGAGGCGGAGGTTGCGGTGAGCCGAGATCGCGCCATTGCACTCCAGCCTGGGTAACAAGAGCGAAACTCCGTCTCAAAAAAAAAAAAAAAAAAAAAAAAAA"
"chr16","3161549","3162150","JH378118","18053084","18053501","252","14891535","CTGGGCACCGTGGCTCACGCCTGTAATCCCAACACTTTGGGAGGCCAAGGCGGGTGGAACACCTGAAGTCAGGAGTTCGAGACCAGTCTGGACAACATGATGAAACCCCGTCTCTACTAAAAATACAAAAAGTAGCCAGGTATGGCCGGGCGCGGTGGCTCACGCCTGTAATCCCGGCACTTTGAGAGGCCGAGGCAGGTGGATCACAAGGTCAGGAGTTCAAGAGCAGCCTGGCCAAGATAGTGAAACCCCGTCTCTACTAAAAGCAAAATTACAGTGCGCCTGTAATCCCAGCTGCTCGGGAGGCTGAGGCAGGAGAATCGCTTGAACCTGGAGGGCGGAGGTTGCAGTGAGCCAAGATCGCTCTACTGCACCCTAGCCTGGGTGACAGAGCAAGACTCTGTATCAAAAAAAAAATAAATAAATAATTAGCCAGGTATGGTGGTGCAGGCTTGTAATCCTAGCTGCTCAGGAGGCTGAGGCAGGAGAATCGATTGAACCCAGGAGACGGAGGTTGCAGTGAGCAGAGATCACACCATTGTACTCCAGCCTGAGTGACAAAAACGAAACTCCGTCTCAAAAAAAAACCAAAAAAACAAAAA","GGCTGGGCGCAGTGGCTCACACCTGTAATCCCAGCACTTAGGGAAGCTGAGGCGAGTAGATCACCTGAGGTCAGGAGTTAGAGACCAGCCTGGCCATCATGGTGAAACCCCGTCTCTACTAAAGATACCAAAAATTAGCTGAGTGTGGTGCTGGGTGCCTGTAATCCCAGAAACTCAGGGTGCCTGTAATCCCAGCAACTCAGGGTGCCTTTAATCCCAGCAACTGAGGGTACCAGTAATCCCAGCAACTCAGGGTGTCTTTAATCCTAGCAACTGAGGGCACCTGTAATCCCAGCAACTCAGGAAGCTGAGACAGGAGAAGTACTTGAACCCAGAAGGCAGAGGTTGCAGTGAGCCGATATTGCACCATTGCACTCCAGTCTGGGCAACAAGAGTGAAACTCTGTCTCAAAAAAAAA"
"chr16","3211652","3212251","JH378118","18053084","18053501","260","14841432","GTCAGACGCAGTAGTTTATGCCTGTAATCCTTGCACTTTGGGAGGCAGGTGGATCACCTGAGGCCAGGAGTTGGAGACCAGCCAGGCCAATATGGCAAAACCCCGTCTCTACTAAAAATACAAAAACTAGCCGGGCGCAGTGGCTCACACCTGTAATCCCAGCACTTTGGGAGGCTGAGGTGGGTGGATCACTAGGTCAGGAGTTCAAGACCAGCCTGGCCAACATGGTGAAACCGCGTCTCTACTAAAAACACCAAAAAATTAGCTGGGCGTGGTGGCAGTCGCCTGTAATCCCTGCTACTCGGAAGGCTGAGGCAGGAGAATCACTTGAACGCAGGAGGCAGAGGTTGCGGTGAGCCGAGATCACGCCACTGCACTCCAGCCTGGGTGACAGAGCAAGACTCTGTCTCAAAAAACAACAACAACAACTAGCTGGGCGTGGTGGCACATGCCTGTAACCCCAGCTACTCAGGAGGCTGAGGCTGAGGGAGAAAAATCGCTTGTACCTGGGAGGTGGAAGTTGCAGTGAGCGGAGATCCCACCATTGCACTCCAGCCTGGGTGACAAGAGCGAAACTCCATCTCAAAAAAAAAAAAAAAA","GGCTGGGCGCAGTGGCTCACACCTGTAATCCCAGCACTTAGGGAAGCTGAGGCGAGTAGATCACCTGAGGTCAGGAGTTAGAGACCAGCCTGGCCATCATGGTGAAACCCCGTCTCTACTAAAGATACCAAAAATTAGCTGAGTGTGGTGCTGGGTGCCTGTAATCCCAGAAACTCAGGGTGCCTGTAATCCCAGCAACTCAGGGTGCCTTTAATCCCAGCAACTGAGGGTACCAGTAATCCCAGCAACTCAGGGTGTCTTTAATCCTAGCAACTGAGGGCACCTGTAATCCCAGCAACTCAGGAAGCTGAGACAGGAGAAGTACTTGAACCCAGAAGGCAGAGGTTGCAGTGAGCCGATATTGCACCATTGCACTCCAGTCTGGGCAACAAGAGTGAAACTCTGTCTCAAAAAAAAA"
"chr16","3990675","3991277","JH378118","18053084","18053501","250","14062409","GGCTGGGCGTGGTGGCTCACGCCTTTAATCCCAGTACTTTGGGAGGCCGAGAAGGGCACATCACCTGAGGTCAGGAGTTTGAGACCAGCCTGGCCAATATGGTAAAACCCTGTCTCTACTTAAAAAATAGAAAAATCAGGCTGGACGCAGTGGCTCACGCCTGTAATCCCAGCACTTTGGGAGGCCGAGGCGGGTGGATCATGAGGTCAGGAGTTACCAGCCTGCCAACATGGTGAAACCCCATCTCTACTAAAAAAACAAAAAAAATTAGCCAGTCGTAGTGGCAGGCACCTGTAATCCCAGCCACTCGGGAGGCTGAGGCAGAGAATTGCTTGAACCTGGGAGGTGGAGATTGCTGTGCACCAAAATCACACCACTGCACTTGAGCCTGGGCGACAGAGGGAGACTCATCTGAAAAAAAAAAAAAAAAAAAAATTAGCCGGTTATGGTGGCAGGTGCCTGTGATCCCAGCTACTTGGGAGGCTGAGGCAGGAGAATTGCTTGAACCCGGGAGGCAGAGGTTGCAGTGAGCTGAGATCGCACCACTGCACTCCAGCCTGGAGGACAAGAGTGAGACTTGTCTGATTGGAAAAAAAAAAAAAA","GGCTGGGCGCAGTGGCTCACACCTGTAATCCCAGCACTTAGGGAAGCTGAGGCGAGTAGATCACCTGAGGTCAGGAGTTAGAGACCAGCCTGGCCATCATGGTGAAACCCCGTCTCTACTAAAGATACCAAAAATTAGCTGAGTGTGGTGCTGGGTGCCTGTAATCCCAGAAACTCAGGGTGCCTGTAATCCCAGCAACTCAGGGTGCCTTTAATCCCAGCAACTGAGGGTACCAGTAATCCCAGCAACTCAGGGTGTCTTTAATCCTAGCAACTGAGGGCACCTGTAATCCCAGCAACTCAGGAAGCTGAGACAGGAGAAGTACTTGAACCCAGAAGGCAGAGGTTGCAGTGAGCCGATATTGCACCATTGCACTCCAGTCTGGGCAACAAGAGTGAAACTCTGTCTCAAAAAAAAA"
"chr16","4259838","4260446","JH378118","18053084","18053501","263","13793246","GGCCGGGTGCAGTGGCTCACGCCTGTAATCGCAGGACTTTGGGAGGCCAAGGCAGGTGCATCACCTGAGGTCAGGATTTCAAGACCATCCAGCCTGATCAACATGGTGAAACCCTGTCTCTACTAAAAATATAAAAATTGGCCGGGCACAGTGACTCACGCCTGTAATCCCAGCACTTTGGGAGGCTGAGGCAGGTGGATCACAAGGTCAGGAGATCGAGACCATCCTGGCTAACACAGTGAAACCCCGTCTCTACTAAAAATATAAAAAATTAGCCGGGCGTGGTGGTAGGCACCTGTAGTCCCAGCTACTCGGGAGACTGAGGCAGGAGAATGGCGTGAACCTGGGAGGTGGAGCTTGCAGTGAGCAGAGATCGCGCCACTGTACTCCAGCCTGGGTGACAGAGCGAGACTCCGTCTCAAAAAAAAAAAAAAAAAAAAAAATTAGCTGGGCGTGGTGGCGGGCACCTGTAATCCCAGCTACTTGGGAGGCTGAGGCAGGAGAATTGCTTGAACCTGGGAAGTGGAGGTTGCAGTGAGCTGAGATTGTGCCCTTGTACTCCAGCCTGGGCAATAAAAGCAAAACTCCGTCTTAAAAAAAAAAAAAAAA","GGCTGGGCGCAGTGGCTCACACCTGTAATCCCAGCACTTAGGGAAGCTGAGGCGAGTAGATCACCTGAGGTCAGGAGTTAGAGACCAGCCTGGCCATCATGGTGAAACCCCGTCTCTACTAAAGATACCAAAAATTAGCTGAGTGTGGTGCTGGGTGCCTGTAATCCCAGAAACTCAGGGTGCCTGTAATCCCAGCAACTCAGGGTGCCTTTAATCCCAGCAACTGAGGGTACCAGTAATCCCAGCAACTCAGGGTGTCTTTAATCCTAGCAACTGAGGGCACCTGTAATCCCAGCAACTCAGGAAGCTGAGACAGGAGAAGTACTTGAACCCAGAAGGCAGAGGTTGCAGTGAGCCGATATTGCACCATTGCACTCCAGTCTGGGCAACAAGAGTGAAACTCTGTCTCAAAAAAAAA"
"chr16","4899850","4900511","JH378118","18053084","18053501","313","13153234","GGCCAGGCACGGTGGCATGCACCTGTAATCTCAGCTCTTTGGGAGGCTGAGGCAAGAGGATCACTTGAGCCCAGGAGTTGGTGATTGCAGTGAGCTCTGATCACTCCACTGCACTCCAGCCTGGGTGACAGAGTGAGATCCTGTCTCTACGAAAAAAAGACAAGACACAAATACGTTAAAAGTAAAATGATATAAAAAGATATTCCAGTGGGGCACAGTGGCTCACCCCTATAATCCCAACACTTTGGGAGGCTGAGGTGGGTGGATCACCTGAGGTCAGGAATTCAAGACCAGCCTGACCAACATGGAGAAACCCGTCTCTACTAAAAATACAAAATTAGCCGGGTGTGGTGGCACATGCCTGTAATCCCAGCTACTCAGGAGGCTGAGAATGGCTTGAACCTGGGAGGTGGAGGTTGTGGTGAGCCGAGATTGCACCACTGCACTCCAGCCTGGGCAACAAGAGCTGAAACTCCGTCGAAAAAAAAAATTAGCCTGGCGTGGTGGCGGGAGCCTGTAATCCCAGCTACTGGGGAGGCTGAGGCAGGAGAATCACTTGAACCTGGGAGGCAGAATTTGCAGTGAGCCGAGATCGCGCCACCACACTCCAGCCTGGGTGACAAAAACGAAACCCCATCTCAAAAAAATTAAAAAATAACAAA","GGCTGGGCGCAGTGGCTCACACCTGTAATCCCAGCACTTAGGGAAGCTGAGGCGAGTAGATCACCTGAGGTCAGGAGTTAGAGACCAGCCTGGCCATCATGGTGAAACCCCGTCTCTACTAAAGATACCAAAAATTAGCTGAGTGTGGTGCTGGGTGCCTGTAATCCCAGAAACTCAGGGTGCCTGTAATCCCAGCAACTCAGGGTGCCTTTAATCCCAGCAACTGAGGGTACCAGTAATCCCAGCAACTCAGGGTGTCTTTAATCCTAGCAACTGAGGGCACCTGTAATCCCAGCAACTCAGGAAGCTGAGACAGGAGAAGTACTTGAACCCAGAAGGCAGAGGTTGCAGTGAGCCGATATTGCACCATTGCACTCCAGTCTGGGCAACAAGAGTGAAACTCTGTCTCAAAAAAAAA"
"chr16","4919663","4920295","JH378118","18053084","18053501","281","13133421","CTGGGCGCAGTGGCTCACACCTATAATCCCAGCACTTTGGGAGGCCGAGGTGGGGTGGATCACTTGAGGTCAGGAGTTTGAGACCAGCCTGGCCAACATGGTGAAACCCCATCTCTTCTAGAAAAATACAAAATTAGGCTGGGCGCGGTGGCTCACGCTTGTAATCCCAGCACTTTGGGAGGCTGAGGCAGGCGGATCATCTGAGGTTGGGAGTTCGAGACCAGCCTGACCAACATAGAGAAACCCTGTCTCTACTAAAAATACAAAATTAGCCGGGCGTGGTGGCGCATGCCTGTAATCCCAGCTAGTCAGGAGGCTGAGGCAGGAGAATCCCTTGAACTGGGGAGGCAGAGGTTGTGGTGAGCCCAGATCGTGCCATTGCACTCCAGCTTGGGTAAGAAGAGCAAAACTCTGTCTAAAAAATATATATATTTATACATATATATATATTTATATATATAATTAGCCACGCATAGTGGCACACACCTGTAACCCCAGCTACCTGGGAGGATGAGGCAGGAGAATAGCTTGAACTTGGGAGGTGGAGGTTGCACTGAGCTGAGACTGCGCCATTGCATTCCAGCCTGGGCAACAAGAGCGAAACTGTCTCAAAAAAAAAAAAAAAAAAAAAAA","GGCTGGGCGCAGTGGCTCACACCTGTAATCCCAGCACTTAGGGAAGCTGAGGCGAGTAGATCACCTGAGGTCAGGAGTTAGAGACCAGCCTGGCCATCATGGTGAAACCCCGTCTCTACTAAAGATACCAAAAATTAGCTGAGTGTGGTGCTGGGTGCCTGTAATCCCAGAAACTCAGGGTGCCTGTAATCCCAGCAACTCAGGGTGCCTTTAATCCCAGCAACTGAGGGTACCAGTAATCCCAGCAACTCAGGGTGTCTTTAATCCTAGCAACTGAGGGCACCTGTAATCCCAGCAACTCAGGAAGCTGAGACAGGAGAAGTACTTGAACCCAGAAGGCAGAGGTTGCAGTGAGCCGATATTGCACCATTGCACTCCAGTCTGGGCAACAAGAGTGAAACTCTGTCTCAAAAAAAAA"
"chr16","5124255","5124811","JH378118","18053084","18053501","213","12928829","GGCCAGGTGCGGTGGCTCATGCGTGTAATCCCAGCGCTTTGGGAGGCTGAGGCAAGTGGATCACCTGAGGTCAGGAGTTTGAGACCAGCCTGGCCAACATGGGGAAATCCCTGTCTCTACTAAAAATACAAAAATTGGGCCGGGTGTGGTGGCTCACACCTGTAATCCCAGCACTTTGGGAGACTGAGGTGGGCGGATCACCCAAGGTCAGGAGTTTGAGACCATCCTGGCCAACATGGTGAAACCCCGTCTCTACTAAATAAATACAAAAAAGTAGCCGAGCGTGTTGGCGGATGCCTGTAATCCCAGCTACTTGGGAGGCTGAGGCAGGAGAATTGCTTGAACCCTGAGAGGTGGAGGTTGCAGTGAGCAGAGATTGTGCCACTGCACTCTGGCCTGGGCGACAAGAGGGAGTCTCTGTCTTAAAAAAAAAAAAAAAAAAAATTAGCTGGAAATCGCTTGAACCCAGGAGGCGGAGGTTGCAGTGAGCCGAGATTGTGCCACTGCACTCTGGCCTGGGCGACAAGAGCGAGATTCTGTCTCAAAAAAAAAAAAGA","GGCTGGGCGCAGTGGCTCACACCTGTAATCCCAGCACTTAGGGAAGCTGAGGCGAGTAGATCACCTGAGGTCAGGAGTTAGAGACCAGCCTGGCCATCATGGTGAAACCCCGTCTCTACTAAAGATACCAAAAATTAGCTGAGTGTGGTGCTGGGTGCCTGTAATCCCAGAAACTCAGGGTGCCTGTAATCCCAGCAACTCAGGGTGCCTTTAATCCCAGCAACTGAGGGTACCAGTAATCCCAGCAACTCAGGGTGTCTTTAATCCTAGCAACTGAGGGCACCTGTAATCCCAGCAACTCAGGAAGCTGAGACAGGAGAAGTACTTGAACCCAGAAGGCAGAGGTTGCAGTGAGCCGATATTGCACCATTGCACTCCAGTCTGGGCAACAAGAGTGAAACTCTGTCTCAAAAAAAAA"
"chr16","8088191","8088522","JH378114","21211700","21212024","70","13123509","GGCTGGGCGCGGTGGCTTTTGACCATAATCCCAGCACTTTGGGAGGCCGAGGTGGTCAGGTCACCTGAGGTCAGGAGTTCAAGAGCAGCCTGGCCAACGTGGTGAAACTCTGTCTCTACCAAAAATACCAAATAATAATAATAATAATAATAATAATAATAAAATAATATAATTGCAGGGTGTGGCAGCCCATGCATGTAATGCCAGCTACTTGGGAGACTGAGGCAGGATAATCACTTCAACCCAAGAGGCGGAGGTTGCAGTGAGCTGAGATCATGCCATTGCATTCCAGCGTAGGCAACAAGAGCGAAACTCTGTTTCAAATAAATAAA","GGCTGGGTGCGGTGGCTCAGGCCTGTAATCCCAGCACTTTGGGAGGCCGAGGTGGGTACATCACCTAAGGTCAGGAGTTCAAGACCAGCCTGACCAACATGGTAAAACCCTGTCTCTACTAAAATTACAAAAGAAAATTAGAAAAAAAAAAAAGAAAGAAAGAAAATTAGATGGCATGGTGGTGGCGGGCACCTGTAATTTCAACTACTCGGGAGGCTAAGGCAGGAGAATCACTTGAACCCAGGAGGTGGAGGTTGCAGTGAGCCGAGATCACACCATTGCACTGCAGCCTGGGCAATAAGAGCAAAACTCCATCTCAAAAAAA"
"chr16","9762791","9763467","JH378118","18053084","18053501","323","8290293","CAGGCATGGTAGCTCACGCCTGTAATCTCAGCACTTTGGGAGGCCGAGGTGCGCAGATCACTTGAGGTCAGGTGTTGGTGACCAGCCTGGCCAACATGGTGAAACCCTATCTCTACTAAAAATACAAAAATTATGGCCGGGCGCAGTGGCTCACGCCTGTAATCCCAGCACTTTGGGAGGCCGAGGTGGGCAGATCACTTGAGGTCAGGAGTTCAAGACCAGCCTAGGCAACATAGTGAAACCCCGTTGCTACTAAAAATACAAAAATTAGCTGGGCGTGATGGCACATACCTGTAGTCCCACCTACTTGGGAGGCTGAGGCAGGAAAATCGCTTGAACCTGGAGGCAGAGGTTGCAGCGAGCCAAGACTGTGCCAATGCACCACAGCCTGGATAACAGAGTGAGACTCAATCTCAAAAAAAAAAAAAAAAAAAAAAGGCGGGCTGGTGGCTCATGCCCATGCAAACCCCGTCTCTACTAAAAGGACAAAAATTAGCTGGGCATGGTGGCGGGGGCCTGTAATCTCAGGATTACAGGAGATACTACTACTCGGGAGGCTGAGGCAGTAGAATTGCTTGAACCAGGGAGGCGGAGGTTGCAGTGAGCTGAGATCGCGCCATTGCACTCCAGGCTGGGTGACAACAATGACTCCGTCTCAAAAACAACAACAACAACAA","GGCTGGGCGCAGTGGCTCACACCTGTAATCCCAGCACTTAGGGAAGCTGAGGCGAGTAGATCACCTGAGGTCAGGAGTTAGAGACCAGCCTGGCCATCATGGTGAAACCCCGTCTCTACTAAAGATACCAAAAATTAGCTGAGTGTGGTGCTGGGTGCCTGTAATCCCAGAAACTCAGGGTGCCTGTAATCCCAGCAACTCAGGGTGCCTTTAATCCCAGCAACTGAGGGTACCAGTAATCCCAGCAACTCAGGGTGTCTTTAATCCTAGCAACTGAGGGCACCTGTAATCCCAGCAACTCAGGAAGCTGAGACAGGAGAAGTACTTGAACCCAGAAGGCAGAGGTTGCAGTGAGCCGATATTGCACCATTGCACTCCAGTCTGGGCAACAAGAGTGAAACTCTGTCTCAAAAAAAAA"
"chr16","9769317","9769634","JH378153","10517405","10517727","57","748088","GGTTGGGCATGGTGGCTCACACCTGTAATGCCAGCACTTTGGGAGGCGGGCAGATCACCTGAGGTCAGGAGTTCAAGACCAGCCTGGCCAACATGGTGAAATCCTGTCATTACAAAAATACAAAAAAAAAAAAAAAAAAAAAAAAAAAAAGCCAGTAATGATAGTGGGTGCGTATAATCCCAGCTACTTTGGAGGCTAAGGCAGGAGACTCACTTGAACCCAGGAGGCGGAGGTTATGGTGAGCCGAGATCACACCATTGCACTCCAGCCTGGGCGACAAGAGCAAAACTCCATCTCAAAAAAAAAAAAAAAAAAAAA","GGCCGGGCGTGGTGGCTCACGCCTGTAATCCCAGCACTTTGGGAGGCCGAGGTGGGTGGATCATGAGGTCAAGAGATCGAGACCATCCTGGTCAACATGGTGAAACCCTGTCTCTACTAAAAAAAAAAAAAAAAAAAAAAAATACAAAAAAATTAGCTGGGCATGGTGGCGCATGCCTGTAATCCCAGCTACTCCGGAGGTTGAGGTAGGAGAATTGCCTGAACCCAGGAGGCGGAGGTTGCGGTGAGCCGAGATCGCGCCATTGCACTCCAGCCTGGGTAACAAGAGCAAAACTCCGTCTCAAAAAAAAAAAAAAAAAAGAA"
"chr16","13753079","13753710","JH378118","18053084","18053501","278","4300005","GGCTGATTGTGATGGCTCACACTTGTAATCCCCTCACTTTGGGAGGCCAAAGCGGGAGCATCACCTGAGGTCAGGAGTTCAAGACCAGCCTGGCCAACATGGTGAAACCCCATCTCTACTAAAAATAAAAAATTAGCTGGGCACAGTGACTCATGCCTGTAATCCCAGCACTTTGGGAGGCCGAGGCAGGCAGATCACAATCACGAGGTCAGGAGTTCGAGACCAGCCTGACCAACATGGTGAAACCCCGTCTCTACTAAAAATAGAAAAATTAGCCAGGCGTGGTGGCACACGCCTGTAATCCCAGCTCCTCAGGAGACTGAGGCAGGAGAATCACTTGAACCCAGGAGGTGGAGGTTGCAGTGAGCAGAGATCGCACCACTGCACTCCAGCCTGGGTAACAGAGTGAGACTCCGTCTCAAAAAAAAAAAAAAAAAAAAAAAAAAAACGAAATTAACCAGGTGTGGTGGCACATGCCTGTAATCCCAGCTACTTGGGAGGCTGAGGCAGGAGAATCGCTTGAACCCGGGAGACAGAGGTTCCAGAGAACTGAGATCATGCCATTGCACTCCAGCCTGGGCAACAAGAGTGAAACTCCATCTAAAAAATAAATAAATACATAAACAAACAAA","GGCTGGGCGCAGTGGCTCACACCTGTAATCCCAGCACTTAGGGAAGCTGAGGCGAGTAGATCACCTGAGGTCAGGAGTTAGAGACCAGCCTGGCCATCATGGTGAAACCCCGTCTCTACTAAAGATACCAAAAATTAGCTGAGTGTGGTGCTGGGTGCCTGTAATCCCAGAAACTCAGGGTGCCTGTAATCCCAGCAACTCAGGGTGCCTTTAATCCCAGCAACTGAGGGTACCAGTAATCCCAGCAACTCAGGGTGTCTTTAATCCTAGCAACTGAGGGCACCTGTAATCCCAGCAACTCAGGAAGCTGAGACAGGAGAAGTACTTGAACCCAGAAGGCAGAGGTTGCAGTGAGCCGATATTGCACCATTGCACTCCAGTCTGGGCAACAAGAGTGAAACTCTGTCTCAAAAAAAAA"
"chr16","13951847","13952482","JH378118","18053084","18053501","292","4101237","GGCCAGGTGCGGTGGCTCATGCCTGTAATCCCAGCACTTTGGGAGGCTATGGCAGCGGATAACCTGAGGTCACAAGTTTGAGACCAGCCTGGCAAACATGGTGAAACCGTCTCTACTAAAAATACAAAAATTACACCAGGCGCGGTGGCTCATGCCTGTAATCCCAGCACTTTGGAAGGCCGAGGCAGGTGGATCATGAGGTCAGGAGATCAAGACCATCCTGGCTAACGCAGTGAAACCCCGTCTCTACTAAAAATATAAAAAATTGGCCAGGCGTGGTGGCGGACGCCTGTAGTCCCAGCTACTCGGGAGGCTGAGCCAGGAGAATGGCGTGAACCCGGGAGGCGGAGCTTGTGGTGAGCCGAGATAGCGCCACTGCACTGCCGCCTGGGTGACAGAGTGAGACTCTGTCTCAAAAAACAAAACAAAACAAAAACCAAAAACAAAAACAAAAAAACAAAAATTAGCCAGGTGTGGTGGTGCACGCCTGTCATCCCAGCTACTTGGGGGGCTGAGACGTGATAATCACTTGAACCCGGGAGGGAGAGGTTGCAGTGAGTGGAGATCACGCCATTGTATTCCAGCCTGGGGGCAAGAGCAAAACTCTGTCTCAAAAACAACAACAACAACAACAAA","GGCTGGGCGCAGTGGCTCACACCTGTAATCCCAGCACTTAGGGAAGCTGAGGCGAGTAGATCACCTGAGGTCAGGAGTTAGAGACCAGCCTGGCCATCATGGTGAAACCCCGTCTCTACTAAAGATACCAAAAATTAGCTGAGTGTGGTGCTGGGTGCCTGTAATCCCAGAAACTCAGGGTGCCTGTAATCCCAGCAACTCAGGGTGCCTTTAATCCCAGCAACTGAGGGTACCAGTAATCCCAGCAACTCAGGGTGTCTTTAATCCTAGCAACTGAGGGCACCTGTAATCCCAGCAACTCAGGAAGCTGAGACAGGAGAAGTACTTGAACCCAGAAGGCAGAGGTTGCAGTGAGCCGATATTGCACCATTGCACTCCAGTCTGGGCAACAAGAGTGAAACTCTGTCTCAAAAAAAAA"
"chr16","19006984","19007584","JH378118","18053084","18053501","263","953900","GGTGGCTGATGCCTGTAAACCCAGCATTTTGGGAGGCCGAGGCTGGTGGATCACCTGAGGTCAGGTGTTCGAGACCAGTCTGGCCAACATGGTGAAACCTCGTCTCTACCAAAAATACAAAAATTAGTTGGGTGTGGCCGGGTGTGGTGGCTTACGCTTGTAATCTCAGCACTTTGGGAGGCCGAGGTGGGTGGATCACGAGGTCAGGAGTTCAAGACCAGCCTGGCCAAGATGGTGAAACCCTGTCTCTACTAAAAATACAAAAAATTAGCCAGGCATGGTGGCGGGTGCCTGTAATCCCAGCTACTCGGGAGGCTGAGGCAGAGAATTGCTTGAACCTGGGAGGTGGAGGTTGCAGTGAGCCGAGATTGTGCCACGACACTCCAGCCTGGGTGACAGAGCGAGACTCTGTCTAAAAAAAAAAAAAAAAATTAGTTGGATGTGGTGGTGGGTGTCTGTAATCTCAGCTACTCAGGAGACTGAATCAGGAGAATCACTTGAACCCAGGGGGCTGGAGGTTGCAGTGAGCCGAGATCTTGCCATTGCACTCCAGCCCGGGCGACAAGAGCAAAACTCTCTTTCAAAAAAAAAAAAAAAAAGA","GGCTGGGCGCAGTGGCTCACACCTGTAATCCCAGCACTTAGGGAAGCTGAGGCGAGTAGATCACCTGAGGTCAGGAGTTAGAGACCAGCCTGGCCATCATGGTGAAACCCCGTCTCTACTAAAGATACCAAAAATTAGCTGAGTGTGGTGCTGGGTGCCTGTAATCCCAGAAACTCAGGGTGCCTGTAATCCCAGCAACTCAGGGTGCCTTTAATCCCAGCAACTGAGGGTACCAGTAATCCCAGCAACTCAGGGTGTCTTTAATCCTAGCAACTGAGGGCACCTGTAATCCCAGCAACTCAGGAAGCTGAGACAGGAGAAGTACTTGAACCCAGAAGGCAGAGGTTGCAGTGAGCCGATATTGCACCATTGCACTCCAGTCTGGGCAACAAGAGTGAAACTCTGTCTCAAAAAAAAA"
"chr16","19554918","19555551","JH378118","18053084","18053501","281","1501834","GGCCGGGCGCAGTGGCTCACACCTGTAATCCCAGCACTTTGGGAGGCCGAGGCGGGTGGATCACTTGAGGTCAGGAGTTCAAGACCAGCCTGGCTGACATGGTGAAACCCTGTCTCTACTGAAAACACAAAAATTAGGCCGGGCATAGTGGCTCATGCCTGTAATACCAGCACTTTGGGAGGCCGAGGTGGGTGGATCACCTGAGGTCAGGAGTTTGAGACCAGCTTGACCAACATGGTGAAACCCCGTCTCTACTAAAAATATAAAAATTAGTCTGGCATGGTGGCAGATGCCTGTAATCCCAGCTACTCAGGAGGCTGAGGCAGGAGAATTGCTTGAACCTGGAAGGTGGAGGTTGTAATGAGCCAAGATCACACCACTGCACTCCAGCCACTGTACTCCAGCCTGGGTGACAGAGTGAGACTCTGTCTCAAAAAACATACATACACACACATACACACACACACACACACACACACAAATTAGCTGGACGTGATAGCACACCCCTGTAGTCCCAGCTGCTTGAGAGACCGAGGCACAAGAATCACACGAACCCGGGAGGCGGAGGTTCCTGTGAGCCAAGATCGCACCATTGTACTCCATTCTGGGTGACAAGAGTGAAGCTCTGTCTCAA","GGCTGGGCGCAGTGGCTCACACCTGTAATCCCAGCACTTAGGGAAGCTGAGGCGAGTAGATCACCTGAGGTCAGGAGTTAGAGACCAGCCTGGCCATCATGGTGAAACCCCGTCTCTACTAAAGATACCAAAAATTAGCTGAGTGTGGTGCTGGGTGCCTGTAATCCCAGAAACTCAGGGTGCCTGTAATCCCAGCAACTCAGGGTGCCTTTAATCCCAGCAACTGAGGGTACCAGTAATCCCAGCAACTCAGGGTGTCTTTAATCCTAGCAACTGAGGGCACCTGTAATCCCAGCAACTCAGGAAGCTGAGACAGGAGAAGTACTTGAACCCAGAAGGCAGAGGTTGCAGTGAGCCGATATTGCACCATTGCACTCCAGTCTGGGCAACAAGAGTGAAACTCTGTCTCAAAAAAAAA"
"chr16","19576859","19577465","JH378118","18053084","18053501","251","1523775","GGCCAGGCATGGTGGCTCACACCTGTAATCCCAGCCCTTTGGGAGGCCGAGGCAGGTGGATCACCTGAGGTCAGGAGTTCGAGACCAGCCTGGCCAACATGGTGACACCCCACTCTACCAAAAATACAAAAATTAGGTTGGGTGCAGCGGTTCACACCTGTAATCCCAGCACTTTGGGAGGCCAAGGTGGATGGATCACCTGAGGTCAGGAGTTTGTGACCAGCCTGGCCAACATGGCGAAACCCTGCCTCTACTAAAAATAAAAAATTAGCCAGGTGTGGTGGCATGCGCCTGTAATCCTAGCTACTGAGGCAGGAGAATCGCTTGGACCAGGGAAGCAGAGTTTGCAGTGAGCCAAGATCACGCCACTGCACTCTAGCCTGGGTGACAGAGTAAGACTCCATCTCAAAAAAAAAAAAAAATACAAATATTAGCTGGGCATGGTGGCGCACACCTGTAGTTCTGGCTACTCAGGAGGCTGAGGCAGGAGAATTGCTTGAACCCAGAAGGCAGAGGTTGCAGTGAGCTGAGATTGTGCCATTGCACTCAGCCTGGGCAACAAAAGTGAAACTCCATCTCAAAATAAATAGATAAATAAATAAATAAA","GGCTGGGCGCAGTGGCTCACACCTGTAATCCCAGCACTTAGGGAAGCTGAGGCGAGTAGATCACCTGAGGTCAGGAGTTAGAGACCAGCCTGGCCATCATGGTGAAACCCCGTCTCTACTAAAGATACCAAAAATTAGCTGAGTGTGGTGCTGGGTGCCTGTAATCCCAGAAACTCAGGGTGCCTGTAATCCCAGCAACTCAGGGTGCCTTTAATCCCAGCAACTGAGGGTACCAGTAATCCCAGCAACTCAGGGTGTCTTTAATCCTAGCAACTGAGGGCACCTGTAATCCCAGCAACTCAGGAAGCTGAGACAGGAGAAGTACTTGAACCCAGAAGGCAGAGGTTGCAGTGAGCCGATATTGCACCATTGCACTCCAGTCTGGGCAACAAGAGTGAAACTCTGTCTCAAAAAAAAA"
"chr16","19983557","19984148","JH378118","18053084","18053501","244","1930473","GGCCGAGTGCGGTGGCTCATGCCTGTAATCCCAGCACTTTGGGAGGCCGAGACAGGTGAATCACCTGAGGTCTGGAGTTTGAGACCAGCTGACCAACATGGTGAAACCCTGTCTCTACTAAAAATACAAAAAATTGGCTGAGCGCAGTGGCCACGCCTGTTATCCCAGTACTTTGGGAGGCCGAGGCGGGTGGATCACGAGGTCAGGAATTCGAGACCAGCCTGACCAACATGGTGAAGCCCCGTCTCTACTAAAAATAAAAAAATTAGCCAGGTGTGGTGGTGCGCCCCTGTAAACCCAGCTACTCAGGAGGCTGAGGCAGGAGAATCACTTGAATCTGGGAGGCGGAGGTTGCAGTGAGCCAAGATCGAGCCACTGTACTCCAGCCTGGGAGACGGAGTGAGACTCCATCTAAAAAAAAAAAAAAATTAGCCAGGCGTGGTGGCACAAGCCTGTAATCCCAGCTACCTGGGAGGCTGAGATAGGAGAATTCCTTGAATCTGGGAGGCGGAGGTTGCAGTGAGCTGAGATTGTGCCATTGCACACCAGCCTGGGTGACAAGAGCAAAATTCCATCTCAAAAAAAAAAAAAA","GGCTGGGCGCAGTGGCTCACACCTGTAATCCCAGCACTTAGGGAAGCTGAGGCGAGTAGATCACCTGAGGTCAGGAGTTAGAGACCAGCCTGGCCATCATGGTGAAACCCCGTCTCTACTAAAGATACCAAAAATTAGCTGAGTGTGGTGCTGGGTGCCTGTAATCCCAGAAACTCAGGGTGCCTGTAATCCCAGCAACTCAGGGTGCCTTTAATCCCAGCAACTGAGGGTACCAGTAATCCCAGCAACTCAGGGTGTCTTTAATCCTAGCAACTGAGGGCACCTGTAATCCCAGCAACTCAGGAAGCTGAGACAGGAGAAGTACTTGAACCCAGAAGGCAGAGGTTGCAGTGAGCCGATATTGCACCATTGCACTCCAGTCTGGGCAACAAGAGTGAAACTCTGTCTCAAAAAAAAA"
"chr16","20117717","20118289","JH378118","18053084","18053501","224","2064633","GGCTGGGTGCGGTGGCTCACGCCTGTAATCCCAGCACTTTGGGAGGCCAAGGCGGGTAGATCATCTGAGGTCAGGAGTTCAAGACCAGCCTGGCCAACATGGTGAAACCCCGTCTCTACTAAAAATATTTTTAAAAGGCCAGGCGTGGTGGCTCACGCCTGTAATCCCAGCACTTTGGGAGGCCGAGGCGGGCAGATCATGAGGTCAGGAGTTCGAGACCATCCTGGCTAACACGGTGAAACCCCCGTCTCTACCAAAAAATACAAAAAATTAGCCGGGCATGGTGGCAGGTGCCTGTAGTCCCAGCTACTCGGGAGGCTGAGGCAGGAGGATGGCGTGAACCCAGGAGACAGAGCTTCCAGTGAGCTGAGATCGTGTCACTGCACTCCAGCCTGGGCGACAGAGGAGATTCTGTCTCAAAAAAAAAAAAAAAAAATTAGCTTGGTGTGGTGGCAGGTGCCTGTAATCCCAGTTACTCGGGAGGCTGAGGCAGAGGTTTCAGTGAACCGAGATCGCGCCATTGCACTCCAGCCTGGGCAACAAGAGTGAAACTCCGTCTCAAAGGAAAAAAAA","GGCTGGGCGCAGTGGCTCACACCTGTAATCCCAGCACTTAGGGAAGCTGAGGCGAGTAGATCACCTGAGGTCAGGAGTTAGAGACCAGCCTGGCCATCATGGTGAAACCCCGTCTCTACTAAAGATACCAAAAATTAGCTGAGTGTGGTGCTGGGTGCCTGTAATCCCAGAAACTCAGGGTGCCTGTAATCCCAGCAACTCAGGGTGCCTTTAATCCCAGCAACTGAGGGTACCAGTAATCCCAGCAACTCAGGGTGTCTTTAATCCTAGCAACTGAGGGCACCTGTAATCCCAGCAACTCAGGAAGCTGAGACAGGAGAAGTACTTGAACCCAGAAGGCAGAGGTTGCAGTGAGCCGATATTGCACCATTGCACTCCAGTCTGGGCAACAAGAGTGAAACTCTGTCTCAAAAAAAAA"
"chr16","20574957","20575888","JH378118","18053084","18053501","543","2521873","GGCCAGGCGTGGTGGCTCATGCCTGTAATCCCAGCACTGTGAGAGGCCGAGGCGGGCGGATCACCTGAGCTGAGGAGTTCGAGACCAGCCTGGCCAACATGGCGAAACCCCATCTCTACTAAAAACACAAAAATTAGGCCAGGTGTGGTGGCTCACACCTGTAATCCCAGCACTTTGGGAGGCCAAGGCGGGCGGATCACCTGAGGTCAGGAGTTCCAGACCTGCCTGGCCAACATGGTGGAATCCCATCTCTACTAAAAATACAAAAATCTGCCAGGTGTGGTGGCACACTTCTGTAATCCCAGATACTCAGGAGGCTGAGGCAGGAGAATCACTTGAACCCTGGAGATGGAGGTTGCAGTGAGCCAAGATCAAGAGATTGCACTCTAGCCAGGGTGACTAGAGTGAGACTCGGTCTCAAAAAAAATGTAATTAATTAATTAATTAATACAAAAATTAGCTGGGCGTGGGCTAGGTGTGGTGGCTCACGCCTGTAATCCCAGCACTTTGGGAGGCCGAGACAGGCGGATCACCTGAGGTCAGGAGTTCAAGACCAGTTTAACCAACATGGAGAAACCCCATCTCTACTAAAAATACAAAATTAGCTGGGCGTGGTGGTGCATGCCTGTAATCCCAGCTACTCGGGAGGCTGAGGCAGAAGAATCGCTTGAGCCTGGTAGGCGGAGATCGTGGTGAGCCGAGATCGCGCCATTGCACTCCAGCCTGGACAACAAGAGCGAAACTCCGTCTAAAAAAAAAAAAAAAATTAGCTGGGCATGGTAACAGGCGCCTGTAAACCCAGTTTCCTCGGGAGGCTGAAGCAGAATTGCTTGATCCCAGAGGCAGAGGTTGCAGTGAGCCAAGATAGTGCCATTGCAGTCCAGCCTGGGCAACAAGAGTGAAACTCCGTCTCAAAAAAAAAAAAAAAAAAA","GGCTGGGCGCAGTGGCTCACACCTGTAATCCCAGCACTTAGGGAAGCTGAGGCGAGTAGATCACCTGAGGTCAGGAGTTAGAGACCAGCCTGGCCATCATGGTGAAACCCCGTCTCTACTAAAGATACCAAAAATTAGCTGAGTGTGGTGCTGGGTGCCTGTAATCCCAGAAACTCAGGGTGCCTGTAATCCCAGCAACTCAGGGTGCCTTTAATCCCAGCAACTGAGGGTACCAGTAATCCCAGCAACTCAGGGTGTCTTTAATCCTAGCAACTGAGGGCACCTGTAATCCCAGCAACTCAGGAAGCTGAGACAGGAGAAGTACTTGAACCCAGAAGGCAGAGGTTGCAGTGAGCCGATATTGCACCATTGCACTCCAGTCTGGGCAACAAGAGTGAAACTCTGTCTCAAAAAAAAA"
"chr16","20816618","20817242","JH378118","18053084","18053501","267","2763534","GGCCCGGCGTGGTGGCTCATGCCTGTAATCCCAGCACTTTGGGAGGCCGAGGCCGGCGGATCACCTGAGGTCAGGAGTTTGAGACCACCCTGGCCAACACGGTGAAAACCTGTCTCTACTAAAAATACAAAAATTAGCCAGGCGCAGTGGCTCACGTCTGTAATTCCAGCACTTTGGAGGGCCGAGGGGGGCAGATCACAAGGTCAGGAGTCCAAGACCAGCCAGGCCAACATAGTGAAACCCGGTCTCTACTAAAAATACAAAAAATTAGCCGGGCGTGGTGGCGGACCCCTGTAGTCCCAGCTACTCAGGAGGCTGAGACAGGAGAATCTCTTGAACCCAGGAGGCAGAGGTTGCAGTGAGCCAAGATCATGCCATTCCACTCCAGCCTGGGCGACAGTGCAAGACTCTGTCTCAAAAACAAAAACAAAAAACCCCCAAACCAAAAATTAGCCAGGCGTGGTGGCATGCACCTGTAGTCCCAGCTACTTGGGAGGCTAAGGCAAGAGAATAGCTTGAACCCAGGAGGCAGAGGTTGCAGTGAGCCGAGATAGTGCCATTGCACTCCAACGTGGGTGACAAGAGCAAAACTCTGTCTCAAAAAAAAAAAAAAAAAAGGAAGGAA","GGCTGGGCGCAGTGGCTCACACCTGTAATCCCAGCACTTAGGGAAGCTGAGGCGAGTAGATCACCTGAGGTCAGGAGTTAGAGACCAGCCTGGCCATCATGGTGAAACCCCGTCTCTACTAAAGATACCAAAAATTAGCTGAGTGTGGTGCTGGGTGCCTGTAATCCCAGAAACTCAGGGTGCCTGTAATCCCAGCAACTCAGGGTGCCTTTAATCCCAGCAACTGAGGGTACCAGTAATCCCAGCAACTCAGGGTGTCTTTAATCCTAGCAACTGAGGGCACCTGTAATCCCAGCAACTCAGGAAGCTGAGACAGGAGAAGTACTTGAACCCAGAAGGCAGAGGTTGCAGTGAGCCGATATTGCACCATTGCACTCCAGTCTGGGCAACAAGAGTGAAACTCTGTCTCAAAAAAAAA"
"chr16","21054922","21055508","JH378118","18053084","18053501","243","3001838","GGCCGGGTGCGGTGGCTCACACCTATAATCCCAGCACTTTGAGAGTCTGAGGCAGGCGGATCACCTGAGGTCAGGAGTTCCAGACCAGCCTGGCCAACATGGTGAAACCCAGTCTCTACTAAAAATACAAAAAAAGACCGGGCACAGTGGCTCACGCCTGTAATTCCAGCACTTTGGGAGGCCGAGGCAGGTGGATCACCTGAGGTTGGGAGTTCGCGACCAGCCTGACCGACATGGAGAAATCCCATCTCTACTAAAAATACAAAATTAGCCGGGCGTGGTGGCACATGCCTGTAATTCCAGCTACTCAGGAGGCTGAGGGAGGAGAATCACTTGAACCTGGGAGGCGGAAGTTGTGGCGAGCCAAGATCACGCCATTGCACTCCAGCCTGGGCAACAAGAGTGAAACCCCATTTCAAAAAAAAAAAAAATTAGCCAGGGGTGGTGGTGCATTCTTGTAATACCAGCTACTCGGGAGGCTGAGGTAGGAGAATCACTTGAGCGCAGGAGGCAGATGTTGTAGTGAGCCGAGTGCCATTGCACTACAGCCTGGGCGACAAGAAAGTAACTCCACCTCAAAAAAAAAA","GGCTGGGCGCAGTGGCTCACACCTGTAATCCCAGCACTTAGGGAAGCTGAGGCGAGTAGATCACCTGAGGTCAGGAGTTAGAGACCAGCCTGGCCATCATGGTGAAACCCCGTCTCTACTAAAGATACCAAAAATTAGCTGAGTGTGGTGCTGGGTGCCTGTAATCCCAGAAACTCAGGGTGCCTGTAATCCCAGCAACTCAGGGTGCCTTTAATCCCAGCAACTGAGGGTACCAGTAATCCCAGCAACTCAGGGTGTCTTTAATCCTAGCAACTGAGGGCACCTGTAATCCCAGCAACTCAGGAAGCTGAGACAGGAGAAGTACTTGAACCCAGAAGGCAGAGGTTGCAGTGAGCCGATATTGCACCATTGCACTCCAGTCTGGGCAACAAGAGTGAAACTCTGTCTCAAAAAAAAA"
"chr16","27896431","27896766","JH378166","6401112","6401453","56","21495319","GGCCAGGCGCGGTGGCTCACGCCTGTAATCCCAGGACTTTGGTAGTCCAAGGCGGGTGGATCACCTGAGGTCAGGAGTTCAAGATCAGCCTGACCAACATGGCAAAACCTCGTCTCTACTAAAAAATACAAAAATTAGCCGGTGTGGTGGCAGGTGCCTGTAATTCCAGCTACTCGGGACGCTGAGTCATGAGAATTGCTTGAACCTAGGAGGCAGATGTTGCAATGAGCCGAGATCGCACCATTGTACTCCAGCCTGGGCGACAAGAGGGAAACTGTCTCCAAAAAAAAAAAAGAAAGAAAGAAAGAAAGAAAGAAAAAAGAAAAACAAAACAAA","GGCCAGGTGCAGTGGCTCACCCCTGTAATCCCAGCACTTTGGGAGGTCGAGGTGGGTGGATCACCTGAGGTCAGGAGTTCAAGACCAGCCTGACCAAAATGGTGAAACCCCATCTCTACTAAAAATACAAAACATTAGCCAGACATCGTGGCGGGCACCTGTAATCCCAGCTACTTGGGAGGCTGAGGCAGGAGAATTGCTTGAGCCTAGGAGGCGGAGGTTACAGTGAGCCATGATCGTGCCATTGGACTCCAGCCTGGGCTACAAGAGCGAGACTCCATCTCAAAAAAAAAAAAAAAAAAAAAAAAGAAAGAAAGAAAGAAAGAAAGAAAAGAAAGAAAG"
"chr16","36524888","36525430","JH378206","6546474","6546861","201","29978414","TTTGAGACCAGCCTGGCCATTGTGGTGAAACCCCGTCTCTACTAAAAAAAATTCAAAAAATGGCTGGGTATGGTGGCTCACGCCTGTAATCCCAGGACTTTGGGAGGCCAAGGTGGGCGGATCACCTGAGGTCAGGAGTTTGAGACCAGCCTAGCCAACATGGTGAAACCCCGTCTCTACCAAAAATACAAAAATTAGCCGGGCTTGGTGGCGCGCACCTGTAATCCCAGGTACACTGGAGGTTGAGGCACAAGAATCGTTTGATCCTGGGAGGTTGCAGTGAGCCAAGATCACGCCACTGCACTCCAGACTGGGTGACAGAGCGAGATTCCATCTCAAAACAACAACAACAAACCCAAAAAATTAGCTGGGTGTGGTGGTGGGTGCCTGTAATCCCAGCTACTTAGGAGGCTGAGGCAGAAGAATCGCTTGAACCCAGGAGGTGGAGGTTGTTGCAGTGAGCAGAGATCGCACCATTGCACTCCAGCCTGGGCAACGAGTGAAACTCCATCTCAAAAAAAAAAAAAAAAAAAGAAAAAAAAA","GGCCACACATGGTGGCTAACGCCTGTAATCCCAGCACTTTGGGAGGCCAAGTCGGGTGGATCATGAGGTCAGGAGACCAAGACCATCCTGGCCAAATGGTGAAACCCCGTCTCTACTAAAAATACAAAAATTAGCTGGGCATGGTGGCGTGTGCCTGTAATCCCAGCTACTCAGGAGGCTGAGGCAGGACAATTGCCTGAACCCAGGAGAATTAGCTGGGCATGGTGGCGTGTGCCTGTAATCCCAGCTACTCAGGAGGCTGAGGCAGGACAATTGCCTGAACCCAGGAGGCGAAGGTTGCGGTGAGCCGAGATTGTGCCATTGCACTCCAGCCTGGGTAACAAGAGCGACACTCTGTCTCAAAAAAAAAAAAAAAAAAAAAAAAAAA"
"chr16","36528224","36528842","JH378119","32351107","32351490","270","4177117","GGCCAGGCGTGGTGGCTCACGCCTGTAATCCCAGCACTTTGGGAGGCTGAGGCAGGCAGATCACCTGAGGTCAGGAGTTCAAGACCAGCCTGGCCAACATGGTGAAACTCCATCTCTACTAAAAATACAAAATTAAGCCGGGCACGGTGGCTCACATCTGAAATCCCAGCACCTTGGGAGGCTAAGGCAGGCGGATCACGAGGTCAGGAGTTCAAGACTAGCTGACCAATATGGTGAAACCCCGTGTCTACTAAAAATACAAAAAAAATTAGCTGGGCGTGGTGGCGCATGCCTGTAGTTCCAGGTACTCAGGAGGCTGAGGAAGGAGAATCACTTGAACCTGGGAGGCGGAGGTTGCAGTGAGCCAAGATCATGCCACTGCATTCCAGCCTGGGCAACAGAGCAAGACTCTGTCTCAAAAATAAAAATAAAAATAAAAGTAAAAATACAAAATTAGCCAGGCGTGGTGGTGTGTGCCTGTAATCACAGCTACTCAGGAGGCAGGAAAATCACTTGAACCTAGGAGGAGGAGGTTGGTGAGCCAAGATCACACCATTGCACTCCAGCCTGGGCAAAAAGAGCAAAACTCCGAACTCTGTCTCAAAAAAAAAAAAAAAAA","GGCCAGGTATGGTGGCTCACACCTGTAATCCCAGCACTTTGGGAGGCCAAGGCAGGCAGACCACCTGAGGTCAGGAGTTCGAGATCAGCCTAGCCAACATGGTGAAACCCCATCTCTAGTAAAAATAAAATTAGCCAGGCATGGTGGTGCATGCCTGTAACGCAGGTCAGGAGTTCGAGATCAGCTTAGCCAACATGGTGAAACCCCATCTCTAGTAAAAATAAAATTAGCCAGGCAGGTGGTGCCGCCTGTACTCGGGAGGCTGAGGCAGGAGAATCACTTGAACCCAAGAGGCAGAGGTTGCAGTCAGCCAAGATCATGCCATTGCACTCCAGCCTAAGCAAAAAGAGTAAAACTCAGTCTCAAAACAAAAAAACAAAAAAA"
"chr16","44800308","44800913","JH378118","18053084","18053501","244","26747224","GGCCTGGTGCAGTGGCTCACACCTGTAATCCCAGCACTTTGGGAGCCCAAGGCGGGTGGATCACCTGAGGTCAGGAGTTCGAGACCAGCCTGGCCAACATGGTGAAATCCTCTCTACTAAAAATGCAAAAAATTAGCTGGGCGGCCAGGCGCAGTGGCTCACGCCTGTAATCCCAGCACTTTGGGAGGCCGAGGTGGGCGGATCACAAGGTCAGGAGATCGAGACCATGCTGGCTAACACGGTGAAACTCCGTCTCTACTGAAAATACAAAAAATTAGCCAGGCACGGTGGCGGGCGCCTGTAGTCCCAGCTACTGGGGAGGCTGAGGCAGGAGAATGGCGTGAACCTGGGAGGTGGAGGTAGCAGTGAGCCAAGATTGCGCCACCGCAGTCCGGCCTGGGTGAAAGAGCGAGACGCTGTCTCAAAAAAAAAAAAAAAAAATTAGCTGGGCATGGTGGCGGGCGCCTGTAATCCCAGTTACTCGGGAGGCTGAGGCAGGAGAATCAGTTGAACCCAGGAGGTGGAGGTTGCAGTAAGCCAAGATTGTGCCATTGTACTCCAGTCTGGGCAACAAGAGCGAAACTCTGTCTTAAAAAACAAAAAAAA","GGCTGGGCGCAGTGGCTCACACCTGTAATCCCAGCACTTAGGGAAGCTGAGGCGAGTAGATCACCTGAGGTCAGGAGTTAGAGACCAGCCTGGCCATCATGGTGAAACCCCGTCTCTACTAAAGATACCAAAAATTAGCTGAGTGTGGTGCTGGGTGCCTGTAATCCCAGAAACTCAGGGTGCCTGTAATCCCAGCAACTCAGGGTGCCTTTAATCCCAGCAACTGAGGGTACCAGTAATCCCAGCAACTCAGGGTGTCTTTAATCCTAGCAACTGAGGGCACCTGTAATCCCAGCAACTCAGGAAGCTGAGACAGGAGAAGTACTTGAACCCAGAAGGCAGAGGTTGCAGTGAGCCGATATTGCACCATTGCACTCCAGTCTGGGCAACAAGAGTGAAACTCTGTCTCAAAAAAAAA"
"chr16","45828895","45829498","JH378118","18053084","18053501","256","27775811","GGCCAGGAGAGGTGGCTCATGCTTGTAATTCCAGTATTTTGGGAGCCCAAGGCGGGTGGATCACTTGAGGTCAGGAGTTTGAAACCAGCCTGACCAACATGGTGAAACCCCGTCTCTACTAAAAATTCAAAATTAGGCAAGGCCTGGTGGCTCATGCCTGTAATCCCAGCACTTTGGGAGGCCAAGGAGGGAGGATCACCTGAGGTCGGGAGTTTGAGACCAGCCTGACCAACATGGAGAAACCCCGTCTCTACTAAAACTACAAAATTAGCCGGGTGTGGTGGCCCATGCCTCTAATCCCAGCTACTCTGGAGGCTGAGGCAGGAGAATCACTTGGACCTGGGATGTGAAGGTTGCAGTGAGCCAAGATCGAGCCATTGCACTCCAGCCTGGGCCACAAGAGTGAAACTCCGTCCCAGAAAAAAAAAAAAAAATTAACCTGGCATGGTGGTGTATGCCTGTAATCCCAGCTACTCGGGAGACTGAGGCAGGAGAATCTCTTGAACCCGGGAGGCGGAGGTTGCAGTAAACCGAGATTGCGCCATTGCACTCCGGCCTGGGTGACAAGAGCGAAACTCCGCCTAAAAAAAAAAAGAAAAGAAAA","GGCTGGGCGCAGTGGCTCACACCTGTAATCCCAGCACTTAGGGAAGCTGAGGCGAGTAGATCACCTGAGGTCAGGAGTTAGAGACCAGCCTGGCCATCATGGTGAAACCCCGTCTCTACTAAAGATACCAAAAATTAGCTGAGTGTGGTGCTGGGTGCCTGTAATCCCAGAAACTCAGGGTGCCTGTAATCCCAGCAACTCAGGGTGCCTTTAATCCCAGCAACTGAGGGTACCAGTAATCCCAGCAACTCAGGGTGTCTTTAATCCTAGCAACTGAGGGCACCTGTAATCCCAGCAACTCAGGAAGCTGAGACAGGAGAAGTACTTGAACCCAGAAGGCAGAGGTTGCAGTGAGCCGATATTGCACCATTGCACTCCAGTCTGGGCAACAAGAGTGAAACTCTGTCTCAAAAAAAAA"
"chr16","47110839","47111458","JH378118","18053084","18053501","268","29057755","GGCCAGGCGTGGTGGCTCACGCCTTTAATCCCAGCACTTTGGGAGGCCGAGGCAGGCAGATCACCTAAGGTCAGGAGTTCGAGACCAGCCTGGCCAACATGGTGAAACCCCCTCTCTACTAAAAATGCAAAAATTTCTGGGCATGGTGGCTCACGCCTGTAGTCCCAGCACTTTGGGAGGCCAAGGCAGGCGGATCACTTGAGGTCAGGAGTTTGAGACCAGCCTGGCCAACATGGTGAGACCCCTGTCTCTACTAAAAATATAAAAAAGTAGCCAGGCGTGGTGGTGTATGCCTCCCAGATAATTGGGAGGCTGAGGTGGGATAATTGCTTGAACCCGGGAGGCAGAGGTTGTAGTGAGCCAAGATAGCGCCAATGCACTCCAGCCTGGGCAACAGAGCGAGACTCTGTCTCAAAAAAAAAAAAAAAAAGAAAAAAGAAAAGAAATTAGCTGGGCGTGGTGATGGGTGCCTGTAATCCCAGCTGCTTAGGAAGCTGAGGAAGGAGAATCACTTAGACCCAGGAGACAGAGGTTGCAGTGAGCCGAGATCGCACCATTGTATTCCAGCCTGGGTGACAAGAGAAAAACTATGTCTCAAAAAAAAAAAAAAGAGTAGAAAA","GGCTGGGCGCAGTGGCTCACACCTGTAATCCCAGCACTTAGGGAAGCTGAGGCGAGTAGATCACCTGAGGTCAGGAGTTAGAGACCAGCCTGGCCATCATGGTGAAACCCCGTCTCTACTAAAGATACCAAAAATTAGCTGAGTGTGGTGCTGGGTGCCTGTAATCCCAGAAACTCAGGGTGCCTGTAATCCCAGCAACTCAGGGTGCCTTTAATCCCAGCAACTGAGGGTACCAGTAATCCCAGCAACTCAGGGTGTCTTTAATCCTAGCAACTGAGGGCACCTGTAATCCCAGCAACTCAGGAAGCTGAGACAGGAGAAGTACTTGAACCCAGAAGGCAGAGGTTGCAGTGAGCCGATATTGCACCATTGCACTCCAGTCTGGGCAACAAGAGTGAAACTCTGTCTCAAAAAAAAA"
"chr16","48159907","48160229","JH378222","6231244","6231546","61","41928663","GGCTGGGCACAGTGGCTCATGCCTGTAATCCCAGCACTTTGGGAGGCCGAGGCAGGCGGATCACCTGAGGTCAGGAGTTCGAGACTAGCCTGGCCAATATAGCGAAACCCCGTCTCTACTAAAAATTAGTTGGGCATGGTGGCAGGCGCCTTAATCCCAGCTACTTGGGATGCTGAGGCAGAAGAATCGCTTGAACCCAGAGGGTGGAGGTTTCAGTGAGATGAGATCGTGCCATTGCACTCCAGACTGGGCAACAAGAGCGAGACTCTGTAAAAAAAATTAATTAATTAATTAACTAATTAATTAAAATAAAATGAGAAAAA","GGCTGGGCATGGTGGCTCACGCCTGTAATCCCAGCACTTTGGGACGCTTAGGCAGGTGGATTGCCTGAGGTCAGGAGTTCAAGACTACCCTGACCAACATAGTGAAACCCCGTCTCTACTAAAAATTAGCTGGGCATGGTGGCAGAGGCCTGTAATCCCAGCTACTCGGGAGGCTGAGGCAGGAGAATCACTTAAACCTGGGAGTTGGAGGTTGCAGTGAGCCAAGATCAAGCCATTGCACTCCAGTCTGGGCAACAAGAGCAAGACTCTGTCTCAAAAAAAAAAAAAAAAAGAAAAGAAAAA"
"chr16","49252302","49252639","JH378314","538162","538484","57","48714140","GGCCAGGCGCAGTGGTGCATGTCTGTAATCTTAGCACTTTGGGAGGCCGAGGTGGACGGATTACATGAGGTCAGGAGTTCAAGACCAGCCTGGCCAACATGGTGAAATTCCATCTCTACTACTAAAAAAAAAAAAAAAAAAAAAAAAAAAAAAAAAAAAAAATACAAAAATTAGCTGGGCTTGGTGGCGGGTGCCTGTAATCCCAGCTACTTGGGAGGCTGAGGCAGGAATCACTTAAACCCAGGAGGTGGAGGTTGCAGTGAGCCAAGACCATGCCATTGCACTCCAGCCTGGGCAACAAGAGCAAAACTCCGTCTCAAAAAAACAAAACAAAAAAA","GGCTGGGTGCGGTGCCTCACACCTGTAATCCCAGCACTTTGGGAGGCCGAGGTGGGTGGATCACGAGGTCAAGAGATCAAGACCATCCTGGTCAACATGGTGAAACCCTGTCTCTACTAAAAAAAAAAAAAAAAAAAAAAAAAAAAAAAAAAAAATTAGCTGGGCATGGTGGCGTGTGCCTGTAATCCCAGCTACTCAGGAGGCTGAGGCAGGAGAATTGCCTGAACCCAGGAGGCGGAGGTTGCGGTGAGCCGAGACTGTACCATTGCACTCCAGCCTGGGTAACAAGAGCGAAACTCCATCTCAAAAAAAAAAAAAAAAAA"
"chr16","49464616","49465219","JH378118","18053084","18053501","254","31411532","GGCCAGGCGTGGTGGCTCACACCTGTAATCCTAGCACTTTGGGAGACTGAGGCAGGTGGATCACATGAGGTGAGGAGTTCAAAACCACCCTGGCCGACATGGTGAAACCCCGTCTCTACTAAAAATATTTTTAAAAAGGCCAGGCGTGGTGGCTCACACCTGTAATTCCAGCACTTCGGGAGGCTGGGGCAGGCAGATCACAAGGTCAGGAGATCGAGACCATTCTGGCCAACGTGGTGAAACCCCGTCTCTACTAAAAATACAAAAATTAGCTGGGCGTGGTGGCGCGTGCCTGTAATCCCAGCTACTTGGGAGGCTGATACAGGAGAATTGCTTGAACCAGTGAGTCAGAGGTTGCAGTGAGCTGAGATTGCGCCATTGCACTCCAGCCTGGCAACAGAATGAGACTCCGTCTCAAAAAAAAAAAAAAAATTAGCTGGGCATGGTGGCAGGCACCTGTGATCCCAGCTACTTGGGAGGCTGAGGCAGGAGAATCGCTTGAACCTGGGAGGTGGAGGTTGCAGTGAGCTGAGATTGCGCCATTGCACTCCAACCTGGGCGTCAAGAGCAAAACTCCATCTCAAAAATAAATAAATAAATAAAA","GGCTGGGCGCAGTGGCTCACACCTGTAATCCCAGCACTTAGGGAAGCTGAGGCGAGTAGATCACCTGAGGTCAGGAGTTAGAGACCAGCCTGGCCATCATGGTGAAACCCCGTCTCTACTAAAGATACCAAAAATTAGCTGAGTGTGGTGCTGGGTGCCTGTAATCCCAGAAACTCAGGGTGCCTGTAATCCCAGCAACTCAGGGTGCCTTTAATCCCAGCAACTGAGGGTACCAGTAATCCCAGCAACTCAGGGTGTCTTTAATCCTAGCAACTGAGGGCACCTGTAATCCCAGCAACTCAGGAAGCTGAGACAGGAGAAGTACTTGAACCCAGAAGGCAGAGGTTGCAGTGAGCCGATATTGCACCATTGCACTCCAGTCTGGGCAACAAGAGTGAAACTCTGTCTCAAAAAAAAA"
"chr16","49983504","49983843","JH378316","567988","568320","50","49415516","GGCCAGGCATGGTGGCTTACGCCTGTAATCTCAGCACTTTGGGAGGCCAAGGCAGGCGGATCACCTGAGGTCAGGAGTTCAAGACCAGCCTGGTCAACATGGCGAAACCCTGTCTCTACTAAAAAAATACAAAAATTAGCCAGGCGTGGTGGTGGGCGCCTGTAATCTCTCCTACTTGGGAGACTGAGGCAGGAGAATTGCTTGAACTCAGAAGGCAGAGGTTGCAGTGAGCTGAGATCACGCCATTGCACTCCAGCCTGGATGACAAGAGCAAAACTCCATCTCAAACAAACAAAAAACAAACAAACAAAAAAAAACAAAAAAACCTCCAAAAAACAAA","GGCCGGGCGTGGTGGCTCACGCCTGTAATCCCAGCACCTTGGGAGGCTGAGGCGGGTGGATCACGAGGTCAAGAGATTGAGACCAGCCTGGTCAACATGGTGAAACCCTGTCTACTAAAAAAATACAAAAATTAGCTGGGCATGGTGGCACGTGCCTGTAATCCCAGCTACTCAGGAGGCTGAGGCAGGAGAATTGCCTGAACCCAGGAGGCGGAGGTTGCGGTGAGCCGAGATCGCGCCATTGCACTCCAGCCTGGGTAACAAGAGCGAAACTCCGTCTCAAAAAACAAAAAACAAAAAAACAAAAAACAAACAAACAAACAAAAAAACAAA"
"chr16","50470493","50471105","JH378118","18053084","18053501","251","32417409","GGCTGGGAGCGGTGGCTCATACCTGTAATCCCAGCACTCTGGGAGGCCGAGGCGCGTGGATCACCTGAGGTCAGGAGTTTGAGACCAGCCTGGCCAGCATGGTGAAACCCTGTCTCTACTAAAAATAGAAAAAGTTAGCTGGGTGAACAGCCGGGCGCGGTGGCTCACACCTGTAATCCCAGCACTTTGGGAGGCCGAGGCAGGTGGATCACAAGGTCAGGAGATCGAGACCATCCTGGCTAACACGGTGAAACCCTGTCTCTACTAAAAATATAAAAAATTAGCCGGGCATGGTGGTGGGTGCCTGTAGTCCCAGCTGCTCAGGAGGCTGAGGCAGGAGAATGGCGTGAAGCCAGGAGGCAGAGGTTGCAGTGAGCCGAGATCGTACCACTGCACTCTAGCCTGGGTGACAGAACGAGACTGTGTCTCAAAGAAAAAAAAAATTAGCTGGGTGTGGTGGCAGACACCTGTAATCCTAGCTACTTGGGAGGTTGAGGCAGGAGAATCGCTTGGACCTGGGAGGCGGAGGTTGCAGTAGGCTGAAATCGCACCATTGCACTCCAGCCTGGGCAACAAGAGGGAAACTCAGTCTCAAAAAAAAAAAAAAAAAAAA","GGCTGGGCGCAGTGGCTCACACCTGTAATCCCAGCACTTAGGGAAGCTGAGGCGAGTAGATCACCTGAGGTCAGGAGTTAGAGACCAGCCTGGCCATCATGGTGAAACCCCGTCTCTACTAAAGATACCAAAAATTAGCTGAGTGTGGTGCTGGGTGCCTGTAATCCCAGAAACTCAGGGTGCCTGTAATCCCAGCAACTCAGGGTGCCTTTAATCCCAGCAACTGAGGGTACCAGTAATCCCAGCAACTCAGGGTGTCTTTAATCCTAGCAACTGAGGGCACCTGTAATCCCAGCAACTCAGGAAGCTGAGACAGGAGAAGTACTTGAACCCAGAAGGCAGAGGTTGCAGTGAGCCGATATTGCACCATTGCACTCCAGTCTGGGCAACAAGAGTGAAACTCTGTCTCAAAAAAAAA"
"chr16","50478366","50478929","JH378114","15957391","15957789","242","34520975","GGCTGGGCACGGTGGCTCATGCCTGTAATCCTAGTACCCTGGGAGGCTGAAGCTGGCAGATCACTTGAGGTCAGGAGTTCGAAACCAGCCTGGCCAACATGGTGAAACCTCATCACTACTAAAAATACAAAAAGTCAGCCGAGCGCGGTGGCTCACGCCTTTAATCCCAGCACTTTAGGAGTCTGAGGCGGGTGGATCACAAGGTCAGGGGTTTGAGACTAGCCTGACCAACACGGTGAAACATCTTTACTAAAAATAGCCAGGCATGGTGGTGCAGGCCTGTAGCAGGTACTCAGGAGGCTGAGGCAGCAGAATCGCTTGAACCCGGGAGGCGGAGGTTGCAGTGAGCCGAGATTGAGCCACTGCACTCCACCCTGGGCAACTGAGCGAGACTCCGTCTCAAAAAAAAAAAAAAAAATTAGCTGGACGTGGTGGTGGATGCCTGTAATCCCGGCTACTTGGTACTTGGAAGGCTGAGACAGGAGAATCGCTTGAACCCGGGAGGTGGAGGTTGCAGTGAGCTGAGATAGCGCCATTGCACTCCAGCCTGGGCAACAAGAGTGA","GCAAGGAACGGTGGCTCATGCCTGTCATCCCAGCACTTTGGGAGGCTAAGGAGGGTGGATTACCGAAGGTCATGAGTTTGAGACCAGCCTGACCAACATGGTGAAAACCCCATCTCTACTAAAAATACAAAAAATTAGCCAGATACAGCTATGCGGCAGACTGGGGCAGGAGAATCGCTTGGACCCAAACCCCATCTCTACTAAAAATACAAAAAATTAGCCGGATACAGCTATGCGGGAGACTGGGGCAGGAGAATCGCTTGGACCCGGGAGGCAGAGATTGCAGTGAGATGAGACCATGCCATTGCTCTCTAGCTTGTGCGATGAGAACAAGACTCTGTCTCAAAAAAAAAAAAAAAAAAAAAAAAAAAAAAAAAAAAAAAAGAGAGAGAGAGAAAA"
"chr16","51388263","51388584","JH378271","2122362","2122678","46","49265901","GGCTGGGTACGGTGGCCCACACCTGTAATCCCAGCACCTTGGGAGGCTGAGGTGGGCGGATTACCTGAGGTCAAAAGTTCAAGACCAGCCTGGCCAACATGGTGAAATCCCATCTCTGCTAAAAATACAAAAAAAAAAAAAAAAAAAAAAAAAAAATTGCCAGGCATGGTGGCAGGCACCTGTAATCCCAGCTACTTGGGAGGCTGAGGCAGGGGAATCGCTTGAACCTGGGAGGCAGAGGTTGCAGTGAGCCCAGATAGCGCCATTGCACTCCAGCCTGGGCGACAAGAGCGAAACTCTGTCCAAAAAAAAAAAAAAAAAA","GGCCGGGCACGGTGGCTCACACCTGTAATCCCAGCACTTTGGGAGGCTGAGGTGGGTGAATCACCTGAGGTCAGGAGTTTGAGACCAGCCTGACCAACATGATGAAACCCGGTCTCTGCTAAAAATACAAAAAAAAAAAAAAAAAAAAAAAAAAAAAGCTGGGCATGATGGTGGGCACCTGTAATCCCAGCTACTCGGGAGGCTGAGGCAGGAGAATCGCTTGAACACCAGGAGGTGGAGGTTGCTATGAGCCGAGATCGCACCATTGCACTCTAGCTTGGGCAACAAGAGAGAAACTCCATCAAAAAAAAAAAAAA"
"chr16","51876298","51876882","JH378118","18053084","18053501","253","33823214","GTAATCCCAGCACTTTGGGAGGCCCAAGTGGGTGGATCACCTGAGGTCAGGAGTTCATGACCAGCCTGGCCACATGGTGAAACCCCATCTCTACTAAAAATACAAAATTAGGCTGGGCGCGGTGGCTTACGTCTGTAATTCCAGCACTTTGGGAGGCCGAGGCAGGCGGATCATGAGGTCAGGAGATTGAAACCATCCTGGCTAACACGGTGAAACCCTGTCTCTACTAAAAATACAAAAAATTAGCCGGGTGTGGTGGGGGGGCGCCTGTAGTCCCAGCTGCTCAGGAGGCTGAGGCAGGAGAATGGCATGAACCCGGGGGGGCGGAGCTTGCAGTGAGCTGAGATCATGCCACTGCACTCCAGCCTGGGCAACAAAGTGAGACTCCGTCTCAAAAAAAAAAACCAAAAAACAAAATGAGCTGGGTGTGGTGGTGGGGGCGTATAATCCCAGCTATACAGGAGGCTGAGGTAGGAGAATCACTTGAACCCGGGAGGTGGAGGTTGCAGTGAGCCGAGATTGTGCCATTTCACACCAACCTGGGTAACAAGAGTAAAATGCTGTCTCAAAAAAAAAAAAGAAAAA","GGCTGGGCGCAGTGGCTCACACCTGTAATCCCAGCACTTAGGGAAGCTGAGGCGAGTAGATCACCTGAGGTCAGGAGTTAGAGACCAGCCTGGCCATCATGGTGAAACCCCGTCTCTACTAAAGATACCAAAAATTAGCTGAGTGTGGTGCTGGGTGCCTGTAATCCCAGAAACTCAGGGTGCCTGTAATCCCAGCAACTCAGGGTGCCTTTAATCCCAGCAACTGAGGGTACCAGTAATCCCAGCAACTCAGGGTGTCTTTAATCCTAGCAACTGAGGGCACCTGTAATCCCAGCAACTCAGGAAGCTGAGACAGGAGAAGTACTTGAACCCAGAAGGCAGAGGTTGCAGTGAGCCGATATTGCACCATTGCACTCCAGTCTGGGCAACAAGAGTGAAACTCTGTCTCAAAAAAAAA"
"chr16","59738190","59738518","JH378138","4229795","4230103","67","55508395","TCACAGCATTTTGGGAGGCCAAGGCAGGCGGATCACCTGTGGTCAGGAGTTTGAGACCAGCCTGGCCAACATGGTGAAACCCCATCTCTACTAAAAATACAAAACAATTAGCCAGGTTTGGTGGCAGGCGCCTATAATCCCAGCTACTTGGGAGGCTGAGGCAGGAGAATCGCTTGAACCCAGGAGGCGGAGGTTGCAGTGAGCCGAGAACACACCATTGTACTCCAGCCTGCGACAAGAACGAAACTGTATCTCAATTAAAAAAAAAAAAAGAAAGGGAGGAAGGAAGGAAGGAAGGAAGGAAGGAAGGAAGGAAGAAAGAAAGAAAA","CACTTTGGGAGGTGAAGGCGGGCAGATCACCTGAGGTCAGGAGTTCGAGACCAGCCTGGCCAACATGGTGAAACCCCGCCTCTACTAAAAATACAAAAATTAGCCAGGTGTGACACTAGGCATCTGTAATCCCAGCTACTTGGGAGGCTGAGACAGGAGAATCACTTGAACCCAGGAGGCGGAAGTTGCAGTGAGCCAAGATCATGCCATTGCACTCCAGCCTGGGTGACAGGAGCAAAACTCTGTCTCAAAAAAAAAAAAAAAAAAAAAAAAAAAAAAAAAAAAAAAAGAAAAGAAAAGAAAAGTAAA"
"chr16","64682336","64682940","JH378118","18053084","18053501","253","46629252","GGCCGGGCACGGTGGCTCACTCCTGTAATCCCAGCACTTTGGGAGGGTGAGGCAGGTAGATCAAAAGGTCAGGAGTGGCCAGGCGTGGTGGCTCACACTTGTAATCCCAGCACTTTGGGAGGCCGAGATGGGCAGATCACGAGGTCAAGAGATTGAGACCATCCTGGCTAACATGGTGAAACCCCGTCTCTACTAAAAATACAAAAAATTAGCCGGGTGTGGTGGCAGGCGTCTGTAATCCCAGCCACTTGGGAGGCTGAGGCAGGAGAATCGCTTGAACCTGGGCGGCAGAGGTTGCATTGAGCCAGGATCGCGCCACTGCACTCCAGCCTGAGCAAAAAGAGCGAAACTCTGTCTCAGAAAAAAAAAAAAGTCAGGAGTTTGAGACCAGCCTGGCCAATATGGTGAAACCCCGTCTCTACTAAAAATACAAAAATTAGCCGAGCGTGGTGGTGGGTGCCTATACTCCCAGCTACTCAGGAGGCTGAGGCAGGAGAATCACTTGAACCCCAGGGGCAGAGGTTGCAGTGAGCCGAGATCGTGCCATTGCACTTCACCCTGGGTGAAAGAGCAAAACTCCGTCTCAAAAAAACAAAACAAAAAAA","GGCTGGGCGCAGTGGCTCACACCTGTAATCCCAGCACTTAGGGAAGCTGAGGCGAGTAGATCACCTGAGGTCAGGAGTTAGAGACCAGCCTGGCCATCATGGTGAAACCCCGTCTCTACTAAAGATACCAAAAATTAGCTGAGTGTGGTGCTGGGTGCCTGTAATCCCAGAAACTCAGGGTGCCTGTAATCCCAGCAACTCAGGGTGCCTTTAATCCCAGCAACTGAGGGTACCAGTAATCCCAGCAACTCAGGGTGTCTTTAATCCTAGCAACTGAGGGCACCTGTAATCCCAGCAACTCAGGAAGCTGAGACAGGAGAAGTACTTGAACCCAGAAGGCAGAGGTTGCAGTGAGCCGATATTGCACCATTGCACTCCAGTCTGGGCAACAAGAGTGAAACTCTGTCTCAAAAAAAAA"
"chr16","67872770","67873371","JH378118","18053084","18053501","260","49819686","GGCTGGGCATGGTGGCTCATGCCTGTAATCCCAGCACTTTGGGAGGCCAAGACGGGCAAATCACCTCAGGTCAGGAGATCGAGACCAGCCTGGCCAACACAGCAAAACCCACCTCTCTACTAAAAATAGAAAAATTACCCAGGCGTCACAGCTCACGCTTATAATCCCAGCACTTTGGGAGGCCGAAGCAGGTGGATCACAAGGTCAGGAGATCGAGACCAGCCTCACTAACATGGTGAAACCCCGTCTCTACTGAATATACGAAAAATTAGTCGGGTGTGGTGGCAGGCACCTGTAGTCCCAGCTACTTGGGAGGCTGAGGCAGGAGAATGGCTTTAACTCAGGAAGAGGAGCTTACGGTGAGCTGAGATTGTGCCACTGCACCCCAGCCTGGGCGACAGAGCAAGACTCCGTCAAAAAAAAAAAAAACCCCAAAACCCCAGCGTGGCAGCAGGTACCTGTAGTCCCAGCTACTCGGGAGGCTGAGACAGGAGAATGGCTTGAACCCGGGAGGCGGAGCTTGCGGTGAGCCAAGACGGCGCCACTTCATTCCAGCTATGGTGATAAGAGGGAGACCGTCTCAATCAATAAATTTAAAAAAA","GGCTGGGCGCAGTGGCTCACACCTGTAATCCCAGCACTTAGGGAAGCTGAGGCGAGTAGATCACCTGAGGTCAGGAGTTAGAGACCAGCCTGGCCATCATGGTGAAACCCCGTCTCTACTAAAGATACCAAAAATTAGCTGAGTGTGGTGCTGGGTGCCTGTAATCCCAGAAACTCAGGGTGCCTGTAATCCCAGCAACTCAGGGTGCCTTTAATCCCAGCAACTGAGGGTACCAGTAATCCCAGCAACTCAGGGTGTCTTTAATCCTAGCAACTGAGGGCACCTGTAATCCCAGCAACTCAGGAAGCTGAGACAGGAGAAGTACTTGAACCCAGAAGGCAGAGGTTGCAGTGAGCCGATATTGCACCATTGCACTCCAGTCTGGGCAACAAGAGTGAAACTCTGTCTCAAAAAAAAA"
"chr16","67970409","67971018","JH378118","18053084","18053501","252","49917325","GGGCGGGTGCGGTGGCTCACCCTGTAATCCCAGCACTTTCGGAGGCTTAAGCAGGCGGATCACCTGAGGTCAGGAGTTCGAGACCAGCCTGGCCAACATGGTGAAACCCCATCTCTACTAAAAATACAAAAAAATGGCCGGGTGCGGCGGCTCATGCCTGTCATCCCAGCACTTTCGGAGGCTGAGGCAGGCGGATCACCGGAGGTCAGGAGTTCGAGACCAGCTTGGCCAACATGGTGAAACCCCGTCTCTACTAAAAATACAAAAGTTAGCTGGGCATGGTGGCACATGCCTGTAATCCCAGCTACTCCGGAGGCTGAGGCAGGAGAATCACTTGAACCTGGGGAGGCGGAGGTTGCAGTGAGCTGAAATCACGGCATTGCACTCCAGCCTAGGCAACAGAGCGAAAGTCCGTCTCAGAAAAAAAAAAAAAAAAATTAGATGGGTTTGGTGGCGGGCGCGCTGTAATCCCAGCTACTTGGGAGGCTGGAGGCAGGAGAATCGCTTGAACTCAGGAGGCTGAGGTTACAGTGAGCCGAGATCATGCCATTGCACTCCAGCCTGGGCAATAAGAGTGAAACTCTGTCTCAAAAAACAACAACAACAAAAA","GGCTGGGCGCAGTGGCTCACACCTGTAATCCCAGCACTTAGGGAAGCTGAGGCGAGTAGATCACCTGAGGTCAGGAGTTAGAGACCAGCCTGGCCATCATGGTGAAACCCCGTCTCTACTAAAGATACCAAAAATTAGCTGAGTGTGGTGCTGGGTGCCTGTAATCCCAGAAACTCAGGGTGCCTGTAATCCCAGCAACTCAGGGTGCCTTTAATCCCAGCAACTGAGGGTACCAGTAATCCCAGCAACTCAGGGTGTCTTTAATCCTAGCAACTGAGGGCACCTGTAATCCCAGCAACTCAGGAAGCTGAGACAGGAGAAGTACTTGAACCCAGAAGGCAGAGGTTGCAGTGAGCCGATATTGCACCATTGCACTCCAGTCTGGGCAACAAGAGTGAAACTCTGTCTCAAAAAAAAA"
"chr16","68229729","68230314","JH378206","6546474","6546861","256","61683255","TGGTTTCCGCCTGTACTCCCAGCACTTTCGGAGGCTCAAGTGAGCAGATCGCTTGAGGCCAGGAGTTTAAGACCTACCTAGTCAACACCGGGGAAACCCACATCTCCACTAAACAATGGCCAGGAGCAGTGGCTCATACCTGTAATCACAACACTTTGGGATCCCAGCCAGACGGATCACAAAGTCAGGAGTTTGCGACCAGCCTATTAGAATGGTGAAACCCTGTCTCTACTAAAAATACAAAAAATTAGCCAGGCATGGTGGCGCATGCCTGTCATCCCAGCTACTCGGGAGGCTGAGGCAAGAGAATCACTTAAACCCAGGAGGCAGATGGAGGTTGCAGTGAGCCAAGATCACACCACTGCACTACAGCATGGGCGACAGAGCAAGACTCGGTCTCAAAAAAAAAAAAATTGGCCAGGCACGGTGGCTGACACCTGTAATCCCAGCACTTTGGGAGGCTGAGGCGGGAGAATCGCTTGAACCTGGGAGACGAAGGTTGCAGTGAGCCGAGACTAAGCCATTGCACCCCAACCTGGGCGGCAAGAGTGAAACTCTGTCTCAAAAAAAATTAAAAAATAAAAAA","GGCCACACATGGTGGCTAACGCCTGTAATCCCAGCACTTTGGGAGGCCAAGTCGGGTGGATCATGAGGTCAGGAGACCAAGACCATCCTGGCCAAATGGTGAAACCCCGTCTCTACTAAAAATACAAAAATTAGCTGGGCATGGTGGCGTGTGCCTGTAATCCCAGCTACTCAGGAGGCTGAGGCAGGACAATTGCCTGAACCCAGGAGAATTAGCTGGGCATGGTGGCGTGTGCCTGTAATCCCAGCTACTCAGGAGGCTGAGGCAGGACAATTGCCTGAACCCAGGAGGCGAAGGTTGCGGTGAGCCGAGATTGTGCCATTGCACTCCAGCCTGGGTAACAAGAGCGACACTCTGTCTCAAAAAAAAAAAAAAAAAAAAAAAAAAA"
"chr17","3506470","3507049","JH378118","18053084","18053501","238","14546614","CCTGTCATCCCAGCACTTTGGGAGGCCGAGGCGGGTAGATCACCTGAGGTCAGGAGTTTGAGACCAGCCTGGCCAACATGGCGAAACCCCGTCTCTACTAAAAATACAAAAACTGGCTGGGCGCGGTGGCTCACGCCTGTAATCCCAGCACTTTGGGAGGCTGAGGCGGGTGGATCATAAGGTCAGGAGTTCAAGACCAGCCTGGCCAACATGGTGAAACCCCATCTCTACTAAAAATACAAAAATTAGCCAGGTATGGTGGCAGGTGCCTGTAATCCCAGCTACTCAGGAGGCTGAGGCAGAGAATTGCTTGAACCCGGGAGGGGGAGGTTGCAGAGGGCCAAGATCGTACCACTATACTCCAGCCTGGGTGACAGGATGAGACTCCATCTTAAAAAAAAAAAAAAAAAAAAAAATTAGCCAGGCGTGGTGCGGGCACTTGTAATCCCAGCTATTCAGGAGGCTGAGGCAGGAGAATTGCTTGAACCCGGGAGGCAGAGGTTGCGGTGAGCTGAGATCGCACCATTGCACTCCAGCCTGGGCAACAAGAGTGAAACTCTGTCTCAAAAAAAAAACAAAA","GGCTGGGCGCAGTGGCTCACACCTGTAATCCCAGCACTTAGGGAAGCTGAGGCGAGTAGATCACCTGAGGTCAGGAGTTAGAGACCAGCCTGGCCATCATGGTGAAACCCCGTCTCTACTAAAGATACCAAAAATTAGCTGAGTGTGGTGCTGGGTGCCTGTAATCCCAGAAACTCAGGGTGCCTGTAATCCCAGCAACTCAGGGTGCCTTTAATCCCAGCAACTGAGGGTACCAGTAATCCCAGCAACTCAGGGTGTCTTTAATCCTAGCAACTGAGGGCACCTGTAATCCCAGCAACTCAGGAAGCTGAGACAGGAGAAGTACTTGAACCCAGAAGGCAGAGGTTGCAGTGAGCCGATATTGCACCATTGCACTCCAGTCTGGGCAACAAGAGTGAAACTCTGTCTCAAAAAAAAA"
"chr17","3641899","3642243","JH378198","5062782","5063109","59","1420883","GGCCAGGCACAGTGGCTCACACCTGTAATCCCAGCACTTCAGGAGGCCGAGGTGGGTAGATCACCTGAGGTCAGGGGTTTGAGACCAGCCTGACCGACGTGGCGAAACCCTGTCTCTACTACAAATACAAAAATTAGCCTTATGTGGTGGCGGGCACGTGTAATCCCAGCTACTTGGGAGGCTGAGGCAGGAGAATCGCTTGAATCTGGGAGGTGGAGGTTGCAGTGAGCCGAGATCACGCCATTGCACTCCAGCCTGGGTGACAAGAGCGAAACTCCATCTCAAAATAAATAAATACATACATACATGTATACATACATACATACATAAAAATAAAAAGTAAAA","GCCAGGCATGGTGGCTCACGCCTATAATCTCAGCACTTTGGGAGGCTGAGGCAGGCAGATCACTTGAGGTCAGGAGTTCAAGACCAGCCTGGCCAACATGGTGAAACCCTGGCTCTACTAAAAATACAAAAATTAGCCGGGTGTGGTGGCACGTGCCTATAATCCCAGCTACTCAGGAGGCTGAGGCAGAAGAATCGCTTGAATCCAGGAGGTGGAGGTTGCAGCGAGCCGAGATCACACCATTGGACTCCAGCCTGGGTGACAAGAGCGAAACTCCATCTCAAAATAAATAAATAAATACATAAAATTAAAAATAAATAAATAAATA"
"chr17","4508039","4508546","JH378206","6546474","6546861","194","2038435","GAGTTGGAGACCAGCCTGGCCAACACGGTGAAACCTCGTCCCCACTAAAAATATAAAAATTAGGCCAGGCGCGGTGGCTCACTCCTGTAATCCCAGCACTTTGGGAGGCTGAGGCGGGTAGATCATCTGAGGTCAGGAGTTCGAGACCAGCCTGGCCAACATGGTGAAACTCCGTCTCTACTAAAAATACAAAAATTAGCTGGGCTGGTAGCGGGCACCTGTAATCCCAGCTACTTGGAAGGGTGAGGCAGGAGAATCACTTGAACCCAGGAGGTGGAGGTTGCAGTGAGCCAAGATTGCAGCACTGTACTCCAGCCTGGGTGACAAAGCAAGACTCTGTCTCAAAAAAAAAAAAAAAAAAAAAGCCGGGCTTGGTGGTGAGTACCGGTAATCCCAGCTACTTGGAAGGCTGAGGCGGCGGACGTTGTACTTAGCCGAGATCATGCCATTGCACTCCAGCCTGGGTAACAGGCAAAAACTCTGTCTCAAAAAATAATAAATAATAAAA","GGCCACACATGGTGGCTAACGCCTGTAATCCCAGCACTTTGGGAGGCCAAGTCGGGTGGATCATGAGGTCAGGAGACCAAGACCATCCTGGCCAAATGGTGAAACCCCGTCTCTACTAAAAATACAAAAATTAGCTGGGCATGGTGGCGTGTGCCTGTAATCCCAGCTACTCAGGAGGCTGAGGCAGGACAATTGCCTGAACCCAGGAGAATTAGCTGGGCATGGTGGCGTGTGCCTGTAATCCCAGCTACTCAGGAGGCTGAGGCAGGACAATTGCCTGAACCCAGGAGGCGAAGGTTGCGGTGAGCCGAGATTGTGCCATTGCACTCCAGCCTGGGTAACAAGAGCGACACTCTGTCTCAAAAAAAAAAAAAAAAAAAAAAAAAAA"
"chr17","4560867","4561450","JH378118","18053084","18053501","257","13492217","GGCTGGGGGTGGTGTCTCTTGCCTGTAATCCCAACACTTTAGCAGGCTGAGGTGTGAGTATGGCTTGAGCCAGGAGTTCTAGACCAGCCTAGGAAACATGGCGAGATCCCTATCTCTACTAATACAAAAATTAGCCGGGCGTGGTGGCAAGCACCTGCAATCTCAGCTACTCGGGAGGCTGAGGTGGGAGGGCCGCTTGAGCCCAGGAGGTCCAGGCTGCAGTAAGCACTTATTTAAAAAAAAAAGAAGAGAAAAGATACAGAAATTAGCCAGGCGTGGTGGTGGGCACCTGTAATCCCAGCTACTCAGGAGGCTGAGGCAGGAAAATCACTTGAACCCGGGAGGCAGAGGTTGCAGTGGGCCGAGATCACACCATTGTACTCCAGCCTGGGCAACAAGAGCGAAACTCTGTCTCAAAAAAAAGAAAAGTAAAGTAAAGAAAAGATACAGAAATTAGCCAGGTGTGGTGGCGGGTGCCTGTAATCCCGCTACTTGGGAGGCTGAGGCAGGAGATTGCAGTGAGCCAAGATTGTGCCATTGCATTCCAGCCTGGGCAACAAGAGCAAAACTCCGCCTCAAAAAAA","GGCTGGGCGCAGTGGCTCACACCTGTAATCCCAGCACTTAGGGAAGCTGAGGCGAGTAGATCACCTGAGGTCAGGAGTTAGAGACCAGCCTGGCCATCATGGTGAAACCCCGTCTCTACTAAAGATACCAAAAATTAGCTGAGTGTGGTGCTGGGTGCCTGTAATCCCAGAAACTCAGGGTGCCTGTAATCCCAGCAACTCAGGGTGCCTTTAATCCCAGCAACTGAGGGTACCAGTAATCCCAGCAACTCAGGGTGTCTTTAATCCTAGCAACTGAGGGCACCTGTAATCCCAGCAACTCAGGAAGCTGAGACAGGAGAAGTACTTGAACCCAGAAGGCAGAGGTTGCAGTGAGCCGATATTGCACCATTGCACTCCAGTCTGGGCAACAAGAGTGAAACTCTGTCTCAAAAAAAAA"
"chr17","4846296","4846953","JH378118","18053084","18053501","290","13206788","GGCCAGGTGCAGTGGCTCACGCCTGTAATCCCAGCACTTTGGGAAGCCCAGGTGGGCGGATCACCCAAGGTCAGGGGTTCGAGACCAGCCTGGCCAACATGGTGAAACTCCATCTCTACTAAAAATAGAAAAAAATGGCCTGGTACGGTGGCTAACGCCTGTAATCCCAGCACTTTGGTAGGCCGAGGCAGGCAGATCACGAGGTCAGAAGATCGAGACCATCCTGGCTAACATGGTGAAACCCCGTCTCTACTAAAAATACAAAAAAGTAGCCAGGTGTGGTGGTGGGTGCCTGTAGTCCTAGCTACTCGGGAGGCTGAGGCAGGAGAATGCCGTGAACCCGGGAGGTGGAGCTTGCAGTGAGCTGAGATCACGCCACTGCACTCCAGCCTGGGTGACAGTGCGAGACTGTCTCCAAAAAAAAAAAAAAAAAAAAATTATATATATAATACACACACACACACACACACACACACACACACACAAATCAGCCAGGCGTGGTGGTGCGCACCTGTAATCCCAGCTACTCGGGAGGCTGAGGCAGGAGAGCTCCTCGAACCCAGGAGGCGAAGGTTGCAGTGAGCCGAGATCACACCATTGCACTCCAGCCTGGGCAACAAGAGCGAAACTCTGTCTCAAGGAAAAAAAAAAAAAAAAA","GGCTGGGCGCAGTGGCTCACACCTGTAATCCCAGCACTTAGGGAAGCTGAGGCGAGTAGATCACCTGAGGTCAGGAGTTAGAGACCAGCCTGGCCATCATGGTGAAACCCCGTCTCTACTAAAGATACCAAAAATTAGCTGAGTGTGGTGCTGGGTGCCTGTAATCCCAGAAACTCAGGGTGCCTGTAATCCCAGCAACTCAGGGTGCCTTTAATCCCAGCAACTGAGGGTACCAGTAATCCCAGCAACTCAGGGTGTCTTTAATCCTAGCAACTGAGGGCACCTGTAATCCCAGCAACTCAGGAAGCTGAGACAGGAGAAGTACTTGAACCCAGAAGGCAGAGGTTGCAGTGAGCCGATATTGCACCATTGCACTCCAGTCTGGGCAACAAGAGTGAAACTCTGTCTCAAAAAAAAA"
"chr17","6289040","6289368","JH378152","15932639","15932952","57","9643599","GGCTGGGCGTGGTGGCTCACGCCTGTAATCCCAGCACTTTGGGAGGCCAAGGTGGGTAGATCACCTGAGGTCAGGAGTTTGAGACCAGCCTGGCCAATGTGATGAAACCCTGTATCCACTAAAAAAAAAAAAAAAAAAAAAAAAAAAAATAGCTGGGTGAAGTGGCAAGCACCTGTAATCCCAGCTACTTGGGAGGCTGAGGCAGGAGAATCCCAGGAGGTGGAGATTGATCCCAGGAGGTGGAGGTTGCAGTGAGTCAAGATCATGCCATTGCACTCCAGCCTGGGTGACAAGAGCAAAATTCCATCTCAAAAAAAAAAAAAAGAAAA","GGCCGGGCATGGTGGCTCAAGCCTGTAATCCCAGCACTTTGGGAGGCCGAGGCGGGTGGATCACGAGGTCAAGAGATTGAGACCATCCTGGTCAACATGGTGAAACCCCGTCTCTACTAAAAATACAAAAAAAAAAAAAAAAAAAATAGCTGGGTGTGGTGGCGTGTGCCTGTAATCCCAGCTACTCAGGAGGCTGAGGCAGGAGAATTGCCTGAACCCGGGAGGCGGAGGTTGCGGTGAGCCGAGATCGCGCCATTGCACTCCAGCCTGGGTAACAAGAGCGAAACTCCGTCTCAAAAACAAAAAAAACAAAA"
"chr17","7490664","7491294","JH378118","18053084","18053501","283","10562420","GGCCGGGAGCGGTGGTTCACTCCTGTAATCCCAGCACTTTGGCAGACCGAGGAGGGTGGATCAACTGAGGTCAGAACTTCAAGACCAGCCTGCCGGGCACAGTGGCTCACACCTGTAATCCCAGCACTTTGGGAGGCTGAGGCAGGTGGATCACCCGAGGTCGGGAGTTCAAGACCAGCCTGACCAACGTGGAGAAACCCCGTCTCTACTAAAAATACAAAATTAGCTGGGGTGGTGGCACGTACCTGTAATCCCAGCTACTCGGGAGGCTGAGGCAAGAGAATCGCTTGAACCCGGGAGGCGGAGGTTGCGGTGCGCCGAGATCGCGCCATTACACTCCAGCCTGGGCAAAAAGAGCGAAACTCTGTCTCAAAAAATAAAAAAAGAAAAAGAAAAAGAAAAAGAAGTTCAAGACCAGCCTGGTCAACGTGGTGAAACCCCGTCTCTACTAAAAACACAAAAAAAATTAGGCGGGTGTTGTGGTGGGTGCCTGTAATCCCAGCTACTCAGGAGGCCAAGGCAGGAGAATCACCTGAACCCTGGAGGTGGAGGTTGCAGTGAGTCGAGATCGCACCATTGCACTCCAGCGTGGGTGACAGAGAGCGAGACTCCGTCTCAAAAAAAAAGAAAA","GGCTGGGCGCAGTGGCTCACACCTGTAATCCCAGCACTTAGGGAAGCTGAGGCGAGTAGATCACCTGAGGTCAGGAGTTAGAGACCAGCCTGGCCATCATGGTGAAACCCCGTCTCTACTAAAGATACCAAAAATTAGCTGAGTGTGGTGCTGGGTGCCTGTAATCCCAGAAACTCAGGGTGCCTGTAATCCCAGCAACTCAGGGTGCCTTTAATCCCAGCAACTGAGGGTACCAGTAATCCCAGCAACTCAGGGTGTCTTTAATCCTAGCAACTGAGGGCACCTGTAATCCCAGCAACTCAGGAAGCTGAGACAGGAGAAGTACTTGAACCCAGAAGGCAGAGGTTGCAGTGAGCCGATATTGCACCATTGCACTCCAGTCTGGGCAACAAGAGTGAAACTCTGTCTCAAAAAAAAA"
"chr17","9634166","9634493","JH378110","12773123","12773444","45","3138957","GGCTGGGTGCGGTGGCTCACGCCTGTAATCCCAGCACTGTGGGAGGCCGAGGCAGGTGGATCACCTGAGGTCAGGAGTTTGAGACCAGCTTGGCCAACATGGTGAAACCCTGTCTGCACTAAAAATACAAAAAAAAAAAAAAAAAAAAAAAAATTAGCTGGGTGTGGTGGCGGACGCCTATAATCCCAGCTACTGGGGAGGCTAAGGCAGGAGAATCGCTTGAACCTGGGAGGTGGAGATTGCAGTGAGCCAAGATGGTGCCATTGCACTCCAGCCTGGACAACAAGAGCGAAACTCGGTTTCAAAAAAAAAAAAAAAAAAAAAAAAA","GGCTGGGCGTGGTGGCTCATGCCTATAATCCCAGCACTTGGAGAGGCCAAAGCAGGCAGATTATTTGAGGTCAGGAGTTCCAAACCAGCCTGGCCAACATGGTGAAACCCTGTATCTACTAAAAATGCAAAAAAAAAAAAAAAAAAAAAAATTAGCTGGGCGTGGTGGCAGGTGACTGTATCCCAGTACTTGGTAGGCTGAGGCAGGAGAATTGCTTGAACCTGGGAGGTGGAGGTTGCAGTGAGCTGAGATTGTGCCATTGCACTCCAGCCTGGGCAACAAGAGCAAAACTCTGTCTCAAAAAAAAAAAAAAAAAAAAAAA"
"chr17","9636859","9637187","JH378193","2430153","2430476","55","7206706","GACACGGTAGCTCACGCCTGTAATCCCAGCACTTTGGGAGGTCGAGGCGGGTGGATCACCTGAGGTCAGGAGTTTAAGACCAGCCTGGCCAACATGGTGAAACCCCGTCTCTGCTAAAAATACAAGAATTAGCCAGGCGTGGTGGTGGGCGCCTGTAATCCCAGCTACTGGGGAGGCTGAGGCAGGAGAATCACTTGAACCCAGAAGGTGGAGGTTGCAGTGAGCCAAGACCACACCACTGGACTGCAGCCTGGCGGACAAGAGCGAGACTCTGTCTCAAAAACAACAACAACAACAACAACAACAACAAAAGAAAGAAAAGAAAAGAA","GGCCGGGCACAGTGGCTCAAGCCTGTAATCCCAGCACTTTGGGAGGCCGAGGTGGGTGGATCACGAGGTCAAGAGATCGAGACCAACCTGGTCAACATGGTGAAACCCCGTCTCTACTAAAAATACAAAAATTAGCTGGGCATGGTGGTGTGTGCCTGTAATCCCAGCTACTCAGGAGGCTGAAGCAGGAGAATTGCCTGAACCCAGGAGGAGGAGGTTGCGGTGAACCAAGATCACGCCATTGCACTCCAGCCTGGGTAACAAGAGCGAAACTCTGTCTCAAAACAAAACAAAACAAAACAAAACAAAACAAACAAAAAAAAA"
"chr17","9725612","9725938","JH378224","2846632","2846964","49","6878980","GGGCGTGGTGGCTCACACCTGTAATCCCAGCACTTTGGGAGGCCGAGGTGGGCGGATTGCCTGAGGTCAGGAGTTCGAGACCAGCCTGGCCAACCCGGTGAAACCCTGTCTCTACTAAAATACAAAAAAAAAAAAAAAAAAAAAAAAAAATTTAGCTGTGTGTGGTGGTGTGCACCTGTAATCCCAGCTACTCAGAAGGCTGAGGCAGGAGAATCGCTAGAACCCGGGAGGCGGAGGTTGCAGTGAGCCGAGATCGCACCATTACGCTCCAGCTTGGGCAACAAGAGTGAAACTCCATCTCAAAAACAAAACAAAACAAAACAAAAA","GGCCAGGCAGGGTGGCTTACATCTGTAATCCCAGCACTTTGGGAGGTCAAGGCGAGTGGATCACCTGAGGTCATGAGTTCAAGACCAGCCTGGCCAACTTGGTGAAACCCTGTCTCTACTAAAAATACAAAAAAAAAAAAAAAAAAAAAAAAAAAAATTAACTGGGTGTGGTGGTGCACACCTGTAATCCCAGCTACTCAGGAGGCTGAGGCAGGAGAATCCCTTGAACACGGGAGGTGGAGGTTGCAGTGAGCCGAGATCATGCCATTGCACTCCAGCCTTGGTGAAAAGAGCAAAACTCTGTCTTAAACAAAACAAAACAAAACCAGAAAA"
"chr17","11904179","11904388","JH378115","24252957","24253162","48","12348778","CCTGTCTTTACAAAAAATGCAAAAACAAAACAAAACAAAACAAAACAAAAACCGGGCATGGTGGTGAGCACCTGTAATCCCAGCTACTTGGGAGTTTGAGGCAGGAGAATCACTTGAACCTGGGAAGCGGAGGTTGCAGTGAGCCGAGACCGCGCCATTGCACTCCAGCCTGGGCAACAAGAATGAAACTCTGTCTCAAAAAAAAAAAAA","TGGTGAAACCCTGTCTTTACTAAAAATACAAAAAAAAAAAAAATTAGCTGGGCATGGTGGCACATGCCTGTAGTCCCAGCTGCTCGGGAGGCTGAGGCAGGAGAATTGCTTGAACCCAGGAGGCGGAGGTTGCAGTGAGCCGAGATCGAGCCATTGCACTCCAGCCTGGGCAACAAGAGCAAAACTCCGTCTCAAAACAAAATAAA"
"chr17","15884346","15884946","JH378118","18053084","18053501","249","2168738","GCCAGGCAGGTGGCTCAGGACTGTAATCCCAGCCTTTTGGGAGGCTGAGGCGAGTGGATCACCTGAGGTCAGGAGTTCGACACCAGCCTGGTCAACATGGTGAAACCCCGTCTCTACTAAAAAATACAAAAAATTGGCCAGGCGCAGTGTCTCACGCCTGTAATCCCAGCACTTTAGGAGGCTGAGGCAGGTGGATCACTTGGTCAGGAGATCGAGACCATCCTGGCCAACATGGTGAAACCCTGTCTCTATCAAAAATACAAAAATTAGCTGGGCGTGGTGGCATATGCCTATAATCCCAGCTACTTGGGACGCTGAGGCAGGAGAATCACTTGAACCAGGGAGTCAGAAGTTGCAGTGAGCCGAGATTGCGCCACTGCACCCCAGCCTGGTGACAGAGTGAGACTGTCTTAAAAAACAAAAAACAAAAAATTAGCCAGGTATGGTACCAGGTGCCTGTAACCCCAGCTACTTGGGAGGCTGAGGCAGGAGTATCGCTTGAACCCTGGAGGTGGAGGATGCAGTGAGCTGAGAGCACGCCATTGTACTCCAGCCTGGGCAACAAGAGTGAAACTCCATCTAAAATAAATAAAAATAAAAA","GGCTGGGCGCAGTGGCTCACACCTGTAATCCCAGCACTTAGGGAAGCTGAGGCGAGTAGATCACCTGAGGTCAGGAGTTAGAGACCAGCCTGGCCATCATGGTGAAACCCCGTCTCTACTAAAGATACCAAAAATTAGCTGAGTGTGGTGCTGGGTGCCTGTAATCCCAGAAACTCAGGGTGCCTGTAATCCCAGCAACTCAGGGTGCCTTTAATCCCAGCAACTGAGGGTACCAGTAATCCCAGCAACTCAGGGTGTCTTTAATCCTAGCAACTGAGGGCACCTGTAATCCCAGCAACTCAGGAAGCTGAGACAGGAGAAGTACTTGAACCCAGAAGGCAGAGGTTGCAGTGAGCCGATATTGCACCATTGCACTCCAGTCTGGGCAACAAGAGTGAAACTCTGTCTCAAAAAAAAA"
"chr17","16331846","16332458","JH378118","18053084","18053501","252","1721238","GGCCATGTGTGGTGGTTCACACCTGTAATCTCAGAACTTTGGGAGGCCGAGGTGGGTGGATCACCTGAGGTCAGGAGTTCGAGACCAGCCTGGCCAACATGGTGAAACCTCATCTCTACTAAAAATACAAAAAATTAAGGCCATACCCAGAGACTCATGCCTGTAATCCCAGCACTTTGGGAGGCTGAGGCGGATGGATCACTTGAGGTCAGGAGTTCAAAACCAGCCTGGCCAACATGGTGAAACCCCATCTCTACTAAAAATATAAAAATTAGCCGGGTGTGATGGCAGGCACCTGTAATCCCAGCTACTTGGGAGGCTGAGGCAGGAGAATTGCTTGAACCCAGGAAGCAGAGGTTGTGGTGAGCCGAGGTCGCGCCATTGCACTCCAGCCTGGGCAACAGAATGAGACTGTCTCAAAAAAAAAAAAAAAAAAAAATCAGCCAGGAGTGGTGGCGGGGGCACCTGTAATCCCAGCTACTCGGGAGGCTGAGGCAGGAGAATCGCTTGAACTCAGGAGGCAGAGGTTGCAGTGAGCTGATATCTCGCCATTGCACTCCAGCCTGGGCAACAAGAGTGAAACTGTCTCAAAAAAAAAAAAAAAAAAAAAGAA","GGCTGGGCGCAGTGGCTCACACCTGTAATCCCAGCACTTAGGGAAGCTGAGGCGAGTAGATCACCTGAGGTCAGGAGTTAGAGACCAGCCTGGCCATCATGGTGAAACCCCGTCTCTACTAAAGATACCAAAAATTAGCTGAGTGTGGTGCTGGGTGCCTGTAATCCCAGAAACTCAGGGTGCCTGTAATCCCAGCAACTCAGGGTGCCTTTAATCCCAGCAACTGAGGGTACCAGTAATCCCAGCAACTCAGGGTGTCTTTAATCCTAGCAACTGAGGGCACCTGTAATCCCAGCAACTCAGGAAGCTGAGACAGGAGAAGTACTTGAACCCAGAAGGCAGAGGTTGCAGTGAGCCGATATTGCACCATTGCACTCCAGTCTGGGCAACAAGAGTGAAACTCTGTCTCAAAAAAAAA"
"chr17","16464101","16464461","JH378293","1845184","1845523","61","14618917","GGCCGGGCGCCGTGGCTCACGCCTATAATCCCAGCACTTTGGGAGGCCGAGGCGGGTGGATCACCTGAGGTCAGGAGTTCGAGACCAGCCTGACCAACATGGTGAAACCCCCGTCTCTGCTAAAAAAAAAAAAATATATATATATATATATATAATATATAATATATATATATATATATATATAAAATAGCTGGGCATGGTGGCAGGCACCTGTAATCCCAGCTACTCAGGAGGCTGAGGCAGGAGAATCGCTTGAACCTGGGAGGTGGAGGTTGCAGTGGGCTAAGATCACACCATCGCACTCCAGCCTGGGCGACAGGAATGAAACGCTGTCTCAAAAAAAAAAAAAAAAAAAAAAAAA","GGCCGGGTGCGGTGGCTCACGCCTGTAATCCCAGCACTTTGGGAGGCCAAGGCGGGTGGATCACCTGAGGTCAGAAGTTCGAGACCAGCCTGGCCAACATGGTGAAACCCCGTCTCTGCTAAAAAGAAAAAAATAAGAAAAAAACAAAATAAGAAAATAATTTTAAAAAATACAAAATTAGCTGGGCGTGGTGGCAGGCACCTGTAATTCCAGCTATTCAGGAGGCTGAGGCAGGGGAATCACTTGAACCCAGGAGGCAGAGGTTGCAGTGAGCCAAGATGACGCCATTGCACACCAGCCTGGGCAACAAGAGTGAAACTCCGTCTCAAAAAAAAAACAA"
"chr17","16469420","16470033","JH378118","18053084","18053501","254","1583664","GCCAGGGGTGGTGGCTCATGCCTGTAATCCCAGCACTTTGGGAGGCTGAGGCGGGCAGATTGCCTGAGGTCAGGAATTCAAGACCAGCCTGGCCAACATAGTGAAACCCTGTCTCTACTAAAAATGCAAAGAATTAGCTGGGTGTTGGCCGGGCACGGTGGCTGACACCTGTAATCCCAGCACTTTGGGAGGCCTAGGCAGGCGGATCACCTGAGGTTGGGAGTTCGAGACCAGCCTGACCAACATGGAGAAACCCCGTCTCTACTGAAAATAAAAAACTAGCCAGGCATGGTGGCCCATGCCTGTAATCCCAGCTAATTGGGAGGCTGAGGCAGGAGAATCGCTTGAACCCAGGAGGCAGAGGTTGCGGTGAACCAAGATCGCATCAATGCACTCCAGCCTAGGCGACAAGAGCAAAACTCCGTCTCAAAAAAAAGAATTAGCTGGGTGTGGTGGGTGGGAACCTGTAATCCCAGTTACTAGGGAGGCTGAGGCAGGAGAATTGCTTGAACCCAGGAGGCGGAGGTTGTGGTGAGCCGAGATCGCGCCATTGCACTCCAGCCTGGACAACAAGAGCGAATCTCCGTCTCAAAAAAAAAAAAAAAAAAAAAAAA","GGCTGGGCGCAGTGGCTCACACCTGTAATCCCAGCACTTAGGGAAGCTGAGGCGAGTAGATCACCTGAGGTCAGGAGTTAGAGACCAGCCTGGCCATCATGGTGAAACCCCGTCTCTACTAAAGATACCAAAAATTAGCTGAGTGTGGTGCTGGGTGCCTGTAATCCCAGAAACTCAGGGTGCCTGTAATCCCAGCAACTCAGGGTGCCTTTAATCCCAGCAACTGAGGGTACCAGTAATCCCAGCAACTCAGGGTGTCTTTAATCCTAGCAACTGAGGGCACCTGTAATCCCAGCAACTCAGGAAGCTGAGACAGGAGAAGTACTTGAACCCAGAAGGCAGAGGTTGCAGTGAGCCGATATTGCACCATTGCACTCCAGTCTGGGCAACAAGAGTGAAACTCTGTCTCAAAAAAAAA"
"chr17","17534259","17534875","JH378118","18053084","18053501","268","518825","GGCTGGGGCGGTGGCTCACCTGTAATCCCAGCACTTTGGGAGGCAGAGGTGGGCGGATCGCCTGAGGTCAGAAGTTGGAGACCAGCCTGGCAACATGGTGAAACCCTGTCTCTACTAAAAAAAAAAAAAAAAAAAAAAAATGGCCGGGCATGGTGGCTCAAGCCTGTAATCCTAGCACTTTGGAAGGCTGAGGCGGGTGGATCACAAGGTCAGGAAATCGAGACCATCCTGGCTAACATGGTGAAACTCCGTCTCTACTAAAAATACAAAAAAAATTAGCCGGGCGTGGTGGTGGGTGCCTGTAGTCCCAGCTACTCGGGAGGCTGAGGCAGGCAAATGGAGTGAACCCGGGAGGCAAACTTGCAGTGAGCCAAGATGGCGCCATTGCACTCCAGCCTGGGCAACAAGAGCAAGACTCCTTCTCAAAAAAAAAAAAAATATATATATATATATATAGTCGGGCATGGTGGCAGGCACCTGTAATCCCAGCTACTCAGAGGCTGAGGCAGGAGAATCGCTTGAACCCTGGAGGTGGAGGTTGCAGTGAGCCAAGGTCATGCCATTGCACTCCAGCCTGGGCAACAAGAGCAAGACTCCGTCTCAAAAAAAAAAAAAAA","GGCTGGGCGCAGTGGCTCACACCTGTAATCCCAGCACTTAGGGAAGCTGAGGCGAGTAGATCACCTGAGGTCAGGAGTTAGAGACCAGCCTGGCCATCATGGTGAAACCCCGTCTCTACTAAAGATACCAAAAATTAGCTGAGTGTGGTGCTGGGTGCCTGTAATCCCAGAAACTCAGGGTGCCTGTAATCCCAGCAACTCAGGGTGCCTTTAATCCCAGCAACTGAGGGTACCAGTAATCCCAGCAACTCAGGGTGTCTTTAATCCTAGCAACTGAGGGCACCTGTAATCCCAGCAACTCAGGAAGCTGAGACAGGAGAAGTACTTGAACCCAGAAGGCAGAGGTTGCAGTGAGCCGATATTGCACCATTGCACTCCAGTCTGGGCAACAAGAGTGAAACTCTGTCTCAAAAAAAAA"
"chr17","17916069","17916669","JH378118","18053084","18053501","243","137015","GCCGGGTACAGTGGCTCACACCTGTAATCCTAGCACTTTGGGAGGCCGAGGCGGGTGGATCACCTGAGGTCAGGAGTTCGAGACCAGCCTGGCCAACATGATGAAACCCTACCTCAGCCAGGTACGGTGGTTCACGCCTGTAATCCTAGCACTTTGGGAGGCTGAGGCAGGTGGATTGCCTGAACTCAGGAGTTTGAGACCAGCCTGGGCAGCATGGTGAAACCCCATCTGTACTAAAATACAAAAACTTTGCTGGGCGTGGCGGCATGCACATGTAGTCCCAGTTACTTGGGAGGCTGAGGCAGGATAATTGTTTGAACCTGGGAGGCGGAGGTTGTACAGTGAGCCAAGATCGCGCCACTACACTCTAGCGTAGGTGACAGAGCGAGATTCCGCCTCCAAAAAAAAAAGAAACCCTGTCTCTACTAAAAATACAAACAATTAGCTGGGCGTGGTGGTGGGCGCCTGTAATCCCAGCTACTTAGGAGGCTGAAGCAGGAGAATCGCTTGAGCCCAGGAAGTGGAGGTTGCAGTGAGCTGAGATTGCTCCATTGCACTCTAGCCTGGGCAACAAGAGTGAAACTCTGTCTCAAAAAAAGAA","GGCTGGGCGCAGTGGCTCACACCTGTAATCCCAGCACTTAGGGAAGCTGAGGCGAGTAGATCACCTGAGGTCAGGAGTTAGAGACCAGCCTGGCCATCATGGTGAAACCCCGTCTCTACTAAAGATACCAAAAATTAGCTGAGTGTGGTGCTGGGTGCCTGTAATCCCAGAAACTCAGGGTGCCTGTAATCCCAGCAACTCAGGGTGCCTTTAATCCCAGCAACTGAGGGTACCAGTAATCCCAGCAACTCAGGGTGTCTTTAATCCTAGCAACTGAGGGCACCTGTAATCCCAGCAACTCAGGAAGCTGAGACAGGAGAAGTACTTGAACCCAGAAGGCAGAGGTTGCAGTGAGCCGATATTGCACCATTGCACTCCAGTCTGGGCAACAAGAGTGAAACTCTGTCTCAAAAAAAAA"
"chr17","18237318","18237912","JH378118","18053084","18053501","239","184234","GGCCATGCGTGGTGGCTCACGCCTGTAATCCCAGTACTTTGGGAGGCTGAGGTGGGAGGATCACCTGAGGTCAGGAGTTCGAGACCAGCCTGGCCAACATGATGAAACCCTGTCTCTACTAAAAATGCAAAAAATTGGCCGGGCACGGTGGCTCACGCCTGTAATCCCAGCACTTTGGGAGGCCAAGGCGGGTGGATCACAAGGTCAGGAGCTTGAGACCAGCCTGGCCAATATGGTGAAACCCCATCTCTACTAAAAATACAAAAATTAGCCAGGCGTGGTGGTACACACCTGTAGTCCCAGCTACTCGGGAGGCTGAGGCAGGAGAATTGCTTGAACTCAGGAGGCAGAGGTTGCAGTGAGCTGAGATGGTGCCACTGCACTGCAGCCTGGGCAACAGAGTGAGACTTCATCTCAAAAAAAAAAAAAAAATTAACCGGGTGTGGTGGCACGTGCCTATGGTCCCAGCCACTGGGGAGGCTGAGGCAGGAGAATCGCTTGAACACAGGAGGCAGAAGTTGCAGTGAGCTGAGATTGCACCACTGCACTCCAGCCTGGGTGACAAGAGTGGAACTCCATCTCAAAAAAAAAAGAA","GGCTGGGCGCAGTGGCTCACACCTGTAATCCCAGCACTTAGGGAAGCTGAGGCGAGTAGATCACCTGAGGTCAGGAGTTAGAGACCAGCCTGGCCATCATGGTGAAACCCCGTCTCTACTAAAGATACCAAAAATTAGCTGAGTGTGGTGCTGGGTGCCTGTAATCCCAGAAACTCAGGGTGCCTGTAATCCCAGCAACTCAGGGTGCCTTTAATCCCAGCAACTGAGGGTACCAGTAATCCCAGCAACTCAGGGTGTCTTTAATCCTAGCAACTGAGGGCACCTGTAATCCCAGCAACTCAGGAAGCTGAGACAGGAGAAGTACTTGAACCCAGAAGGCAGAGGTTGCAGTGAGCCGATATTGCACCATTGCACTCCAGTCTGGGCAACAAGAGTGAAACTCTGTCTCAAAAAAAAA"
"chr17","18951167","18952093","JH378118","18053084","18053501","537","898083","GGCCAGGGGCAGTGGCTCATGCCTGTAATCCCAGCATTTTGGGATGCCAAGGCTGGTGGATCAACTGAGGTCAGGAGTTTCAGACCACCCTGGCCAACATGGCGAAATCCCATCTCTACTAAAAATACAAAAATTAGGCCAGGCACAGTGGCTCATGCCTGTAATCCCAGCACTTTGAGAGGCCAAGGCGGGCGATCACGAGGTCAGGAGATTGAGACCATCCTGGCTAACACGGTGAAATCCTGTCTCTACTAAAAAAAAAAAATACAAAAAATTAGCCGGGACGTGGTGGCTGGCACCTGTAGTCCCAGCTACTCGGGAGGCTAAGGCAGGAGAATGGCATGAACCCGGGAGATGGAGCTTGCAGTGACCCGAGATCGCGTCACTGCACTCCAGCCTGAACAACAGAGCAAGACTATATCTCAAAAAAAAAAAAAAAAAAAAGGCCGGGTGCAGTGGCTCACGTCTGTAATCCCAGCACTTTGGGAGGCCGAGGTGGGTGGATCACGAGGTCAGGAGATCGAGACCATCCTGGCTAACATGATGAAACCCCATCTCTACTAAAAAATACAAAAAATTAGCCGGGTGTGGTGGCAGGCACCTGTAGTCCCAGCTACTCGGGAGGCTGAGGCAGGAGAATGGCATGAACCTGGGTAGTGGAACTTGCAGTGAGCCGAGATCACGCCACTGCACTCCAGCCTGGGCGACAGAGCGAGACTCTGTCTCAAAAAAAAAAAAAAAAAAAAAATTAGCCGGGCATGGTGGTGGGTGCCTGCAATCCCAGCTAGTCAGGAGGCTGAGGCTGGAGAATCCCTTGAACCCAGGAGGTAGAGGTTGCAGTGAGCCAAGATCACGCCATTGCATTCCAGCCTGGGCAACAAGAGTGAAATTCTGTCTCAAAAAAATAAACAAACAAGTAAAATAAAA","GGCTGGGCGCAGTGGCTCACACCTGTAATCCCAGCACTTAGGGAAGCTGAGGCGAGTAGATCACCTGAGGTCAGGAGTTAGAGACCAGCCTGGCCATCATGGTGAAACCCCGTCTCTACTAAAGATACCAAAAATTAGCTGAGTGTGGTGCTGGGTGCCTGTAATCCCAGAAACTCAGGGTGCCTGTAATCCCAGCAACTCAGGGTGCCTTTAATCCCAGCAACTGAGGGTACCAGTAATCCCAGCAACTCAGGGTGTCTTTAATCCTAGCAACTGAGGGCACCTGTAATCCCAGCAACTCAGGAAGCTGAGACAGGAGAAGTACTTGAACCCAGAAGGCAGAGGTTGCAGTGAGCCGATATTGCACCATTGCACTCCAGTCTGGGCAACAAGAGTGAAACTCTGTCTCAAAAAAAAA"
"chr17","20996420","20997041","JH378118","18053084","18053501","266","2943336","GGCTAGGCGCGGTGGTTCACACCTGTAATCCCAGCACTTTGGGAGGCCAAGGTGGGTGGATCACCTGTGGTCAGGAGTTCGAGACCAGCCTGGCCAACATTGTGAAACCCCGTCTCTACTAAAAATGCAAAAAATTAGCTGGGCGACCAGTCATGGTAGCTCACGCCTGTAATCCTAGCACTTTGGGAGGCCAAGGCGGGTGGATTGCCTGAGCTCAGGAGTTAGAGGCCAGCCTGGGCAACATGGTAAAACCCTGTCTCTACTAAAATACAAAAAAAAAAAAAAAAATTAGCTGGGTGTGACAGCGTGCATCTGTAATCCCGGTTACTTGGGAGGTTGAGGCAGGAGAATTCCTTGAACCTAGGAGGCGGAGGTTACAGTTAGCCGAGATCACGCCATTGCACTCCAGCCTGGGCAACAGAGCGAGACTCCATCTCAAAAAAAAAAAAAAAAATTCAGCTGGGCGTGGTGGCGGGCACCTGTGATCCTAGCTACTCAGGAGGCTGAGGCAGGAGAATCATTTGAACTCCGGAGGCGGAGGTTGCAGTGACCCTAGATCGCACCATTGTGTTCCAGCCTGAGCAACAAGAGCGAGACGCCATCTGAAAAAAAAAAAAAGAAA","GGCTGGGCGCAGTGGCTCACACCTGTAATCCCAGCACTTAGGGAAGCTGAGGCGAGTAGATCACCTGAGGTCAGGAGTTAGAGACCAGCCTGGCCATCATGGTGAAACCCCGTCTCTACTAAAGATACCAAAAATTAGCTGAGTGTGGTGCTGGGTGCCTGTAATCCCAGAAACTCAGGGTGCCTGTAATCCCAGCAACTCAGGGTGCCTTTAATCCCAGCAACTGAGGGTACCAGTAATCCCAGCAACTCAGGGTGTCTTTAATCCTAGCAACTGAGGGCACCTGTAATCCCAGCAACTCAGGAAGCTGAGACAGGAGAAGTACTTGAACCCAGAAGGCAGAGGTTGCAGTGAGCCGATATTGCACCATTGCACTCCAGTCTGGGCAACAAGAGTGAAACTCTGTCTCAAAAAAAAA"
"chr17","21298865","21299429","JH378206","6546474","6546861","222","14752391","GGCCGAGGCAGGTGGATCACCTGAGGTCAGGAGTTCAAGACTAGTCTGGCCAACATGGTGAAACCCTGTCTCTACTAAAAATACAAAAAATTGGCCGGGCGCGGTGGCTCATGCCTGTAATCCCAGCACTTTGGGAGGCTGAGGCGGGTGGATCACGAGGTCGGGAGATCGAGACCATCCTGGCTAACACAGTTAAACCCTTTCTCTACTAAAAAATACAAAAAATTAGCCGGGCGTAGTGGGGGGCGCCTGTAGTCCCAGCTACTCAGGAGGCTGAGGCAGGAGACTGGCGTGAACCCGGGAGGCAGAGCTTGCAGTGAGCTGAGATCACGTCACTGCATGCCAGCCTGGGCGACAGAGCGAGACTCTGTCTCAAAAAAAAAAAATTAGCCAGGCATGGTGGTGTACACCTGTAATCCTAGCTACTCGGGAAGCTGAGCAGGAGAACAGCTTGAACCCAGGAGGCAGAGGTTGCAGTGAGCTGAGATCACGCCATTGCACTCCAGCCTGGGCAACAAGAGTGAAACTCCGTCTCAAAAAAAAAAAAAGAAAAGAAAAAAGAAAA","GGCCACACATGGTGGCTAACGCCTGTAATCCCAGCACTTTGGGAGGCCAAGTCGGGTGGATCATGAGGTCAGGAGACCAAGACCATCCTGGCCAAATGGTGAAACCCCGTCTCTACTAAAAATACAAAAATTAGCTGGGCATGGTGGCGTGTGCCTGTAATCCCAGCTACTCAGGAGGCTGAGGCAGGACAATTGCCTGAACCCAGGAGAATTAGCTGGGCATGGTGGCGTGTGCCTGTAATCCCAGCTACTCAGGAGGCTGAGGCAGGACAATTGCCTGAACCCAGGAGGCGAAGGTTGCGGTGAGCCGAGATTGTGCCATTGCACTCCAGCCTGGGTAACAAGAGCGACACTCTGTCTCAAAAAAAAAAAAAAAAAAAAAAAAAAA"
"chr17","21663027","21663921","JH378118","18053084","18053501","517","3609943","TTGGGAGGCCAAGGTGGGCCTCCCAGACACGTGAGGTCAGGAGTTTGAGACCAGCCTGGACAATATGGCGAAACCCCATCTCTACTAAAAAAACACAAAAATTGGTTGGGCCGGGCACGGTGGCTCACGCCTGTAATCCCAGCACTTTGGGAGGCCGAAGTGGGCAGATCACGAGGTCAGGAGATCGAGATCATCTTGGCTAACATGGTGAAACTCCGTCTTTACTTAAAATACAAAAAATTAGCTGGGCATGATGGCAGGCAGTTGGAGTCCCAGCTACTTGGGAGGCTGAGGCAGGAGAATCGCTTGAACCCGGGAGGCAGAGGTTGCAGTGAGCTGAGATCGTGCCATTGCACTCCAGCCTGGGTGACAGAATGAGACTCCGTCTGAAAAAAAAACAAAAAACAAAAAACAAAAATTGGCCAGGTGCGGTGGCTCACGCCTGTAATCCCAGAACTTTGGGAGGCCGAGGCAGGTGGATCATGAGGTCAGGAGTTCAAGACCAGCCTGGCCAAGATGGTGAAACCCCATCTCTACTAAAAATACAAAAATTAGGCGGGCACGGTGGCAGGTGCCTGTAATCTCAGCTACTCAGGAGGCTGAGGCAGGAGAATTGCCTGAAGCCGGGTGGCAGAGGTTGCAGAGAGCTAAGATCACGCCACTGCACTCCAGCCTGGGTGATAGAGTAAGACTCTATCTCAAAAAAAGAAAAAAAAAAATAGCCGGGCATTGTGCTGGGCGCCTGTAATCCCAGCTACTTGGGAGGCTGAGACAAGAGAATCACTTGAACCTGGGAGGCGGAGGTTGCAGTGAGCCGAGATCGTGCCATTGCACTCCAGCCTGGGTGAGAAGAGCAAAACTCTGTCTCAAAAAAACAAAAAAAGAAGAAAACAAA","GGCTGGGCGCAGTGGCTCACACCTGTAATCCCAGCACTTAGGGAAGCTGAGGCGAGTAGATCACCTGAGGTCAGGAGTTAGAGACCAGCCTGGCCATCATGGTGAAACCCCGTCTCTACTAAAGATACCAAAAATTAGCTGAGTGTGGTGCTGGGTGCCTGTAATCCCAGAAACTCAGGGTGCCTGTAATCCCAGCAACTCAGGGTGCCTTTAATCCCAGCAACTGAGGGTACCAGTAATCCCAGCAACTCAGGGTGTCTTTAATCCTAGCAACTGAGGGCACCTGTAATCCCAGCAACTCAGGAAGCTGAGACAGGAGAAGTACTTGAACCCAGAAGGCAGAGGTTGCAGTGAGCCGATATTGCACCATTGCACTCCAGTCTGGGCAACAAGAGTGAAACTCTGTCTCAAAAAAAAA"
"chr17","21688652","21689276","JH378118","18053084","18053501","258","3635568","GGCCGGGTGCCATGGCTCACGCCTATAATCCCAGCACTTTGGGAGGCCAAGGTGGGCGGATCACCTGAGGTCAGGAGTTTGAGACCAGCCTGGCCAACATAGTGAAACCCCGTCTCTACTAAAAATACGAAAAGTTAGCTGGGGGTGCAGTGGCTCACACCTGTAATTCCAGCACTTTGGGAGGCCGAGGCAGGTGAATCACGAGGGGAGGAGTTTGAGACCAGCCTAACCAATATGTTGAAACCCCGTTTCTACTAAAAATACAAAAATTAGCTGGGCGTGGTGGCACGTGCCTATAATCCCAGCTACTCAGGAGGCTGAGGCAGGAGAATCGCCTGAACCTGGGAGGCGGAGGTGGCAGTGAGCCAAGATCACACCACTGCACTTTAGCCTGGGTGACAGAGGGAGACTCTGTCTCAAAAAACAAAACAAAACAAAACAAAAAATTAGGCAGGCTTGGTGGCACATGCCTGTAATCCCAGCTACTCAGGAGGCTGAGGCAGGAGAATTGCTTGAACCCAGGAGGCAGAAGTTGCAGTGAGCTGAGATCGCGCCATTGCACTCCAGCCTGGGTAACAAGAGTGAAACTCCATCTCAAAAAAAAAAAAAAAAAAAAAAAAAAAAA","GGCTGGGCGCAGTGGCTCACACCTGTAATCCCAGCACTTAGGGAAGCTGAGGCGAGTAGATCACCTGAGGTCAGGAGTTAGAGACCAGCCTGGCCATCATGGTGAAACCCCGTCTCTACTAAAGATACCAAAAATTAGCTGAGTGTGGTGCTGGGTGCCTGTAATCCCAGAAACTCAGGGTGCCTGTAATCCCAGCAACTCAGGGTGCCTTTAATCCCAGCAACTGAGGGTACCAGTAATCCCAGCAACTCAGGGTGTCTTTAATCCTAGCAACTGAGGGCACCTGTAATCCCAGCAACTCAGGAAGCTGAGACAGGAGAAGTACTTGAACCCAGAAGGCAGAGGTTGCAGTGAGCCGATATTGCACCATTGCACTCCAGTCTGGGCAACAAGAGTGAAACTCTGTCTCAAAAAAAAA"
"chr17","22129020","22129352","JH378128","1602813","1603145","53","20526207","GCCAGGCACGGTGGCTCACACCTGAATTCCAGTACTTTGGGAGGCCGAGGCGGGCGGATCTCTTGAGGTCAGGAGTTTGAGACCAGCCTGGCCAACATGGTGAAACCCCATCTCTACTAAAAATACAAAAATTAGCCGGGCGTGGTGGCAGGTGCCTGTAATCCCAGCTACTTGGGAGGCTGAGGCAGGAGAACCTCTTGAACCCAGGAGGTGGAGGCTGCAGTGAGCTGAGATTGTGCCACTTCACTCCAGCCTGGAAGACAAGAGCAAGACTTCATCTCAAAAAAAAATAAAAAAAAAATAAATAAATAAATAAATAAAAATTTAAAAAAA","GGCCAGGTGCAGTGGCTCACGCCTGTAATACCAGCATTTTGGGAGGCCGAGGCAGGTGGATCACGAGGTTAGGAGTTTGAGACCAGCATGGCCAACATGGAGAAACCCCGTCTCTACTAAAAATACAAAAATTAACCAGGCATGGTGGCAGGTGCCTGTAATTCCATCTACTCGGGAGGCTGAGGCAGGAGAATCCCTTGAACCTGGGAGGCGGAGGTTGCAGTGAGCCGAGATTGTGCCATTGCACTCAGTCTGGGTGACAAAAACAAGACTCCATCTCAAAAAAAAAAAAAAGAAAAGAAAAAGAAAAAAAGAAAGAAAGAAAGAAAGAAA"
"chr17","22130129","22130738","JH378118","18053084","18053501","262","4077045","GGCTGGGCACAGTGGCTCACGCCTGTAATCTCAGCACTTCGGGAAGCCGAGGCGGGCAGATCAGCTGAGGTCAGGAGTTCAAGACCAGCCTGGCCATGGCAAAACCCTGTCTCTACTAAAAAATGCAAAAAATAGGGGCCAGGCACGGTGGCTCACGCCTGTAATCCCAGCATTTTGGGAGGCCAAGGCAGGCGGATCACAAGGTCAGGAGGTTGAGACCATCCTGGCCAACATGGTGAAACCCCATCTCTACTAAAAATACAAAAATTAGCTGGGTGTGGTGGCCTGTGCCTGTAATCCCAGCTACTTGGGAGGCTGAGGCAGGGGAATCACTTGAATCCAGGAGACAGAGGTTGTAGTGAGCTGAAATGGAGCCACTGCACTCCAGCCTGGCGGCAGAGCGAGACTCTGTCTCAAAAAAAAAAAAAATACAAAAAATAGCTAGGTGTGATGGTGGGCACCTGTAATCCCAGCTACTTGGGTAGCCGAAGCAGGAGAATCGCTAGAACCTGGGAGGTGGAGGTTTAGTAAGCTGAGATCACACCATTGCACTCCAGCCTGGGTATCAACAGCGAAACTCCATCTCAAAAAAAAAAAAAAAAAAAGAAAA","GGCTGGGCGCAGTGGCTCACACCTGTAATCCCAGCACTTAGGGAAGCTGAGGCGAGTAGATCACCTGAGGTCAGGAGTTAGAGACCAGCCTGGCCATCATGGTGAAACCCCGTCTCTACTAAAGATACCAAAAATTAGCTGAGTGTGGTGCTGGGTGCCTGTAATCCCAGAAACTCAGGGTGCCTGTAATCCCAGCAACTCAGGGTGCCTTTAATCCCAGCAACTGAGGGTACCAGTAATCCCAGCAACTCAGGGTGTCTTTAATCCTAGCAACTGAGGGCACCTGTAATCCCAGCAACTCAGGAAGCTGAGACAGGAGAAGTACTTGAACCCAGAAGGCAGAGGTTGCAGTGAGCCGATATTGCACCATTGCACTCCAGTCTGGGCAACAAGAGTGAAACTCTGTCTCAAAAAAAAA"
"chr17","23633062","23633662","JH378118","18053084","18053501","247","5579978","GGCCAGGCGTGGTGGCTTACGCCTGTAATCCCAGCATTTTGGGAAGCTGAGGCAGGTGGATCACCTGAGGTCAAGAGTTCAAGACCAGCCTGGCCAACATGGTGAAACCCCGTCTCTACTGCAAATACAAAAAATTAGTAGCCGGGCATGGTGGCTCACGCCTGTAATCCCAACACTTTGGTAGGCCAAGGCGGGTGGATCACCTGAGGTCGGGAGTTCGAGACCAGCCTGACCAACATGGAGAAACCCCGTCTCTACTAAAAGTACAAAATTAGCCAGGGATGGTGGCATGTGCCTGTAATCCCAGCTATTTGGGAAGCTAAGGCACAAGAATCGCTTTGAACCTGGGAGACAGAGGTTGCAGTGAGCTGAGATCGCACCATTGCACTCCCGCCTGGGCAACAAGAGCGAAACTCCATCTAAAAAAAAAAAAAAAAAAAAAAAAGCCAGGCATGGTGACAGGCACCTTGTAATCCCAGCTACTCGGAAGGCTGAGGCAGGAGAATCGCTTGAACACTGCAGAGGTTGCAGTGAGCTGAGATCACGCCATTGCACTGCAGCCTAGGCAACAAGAGTGAGACTCTATCTCAAAAAAAAGAAA","GGCTGGGCGCAGTGGCTCACACCTGTAATCCCAGCACTTAGGGAAGCTGAGGCGAGTAGATCACCTGAGGTCAGGAGTTAGAGACCAGCCTGGCCATCATGGTGAAACCCCGTCTCTACTAAAGATACCAAAAATTAGCTGAGTGTGGTGCTGGGTGCCTGTAATCCCAGAAACTCAGGGTGCCTGTAATCCCAGCAACTCAGGGTGCCTTTAATCCCAGCAACTGAGGGTACCAGTAATCCCAGCAACTCAGGGTGTCTTTAATCCTAGCAACTGAGGGCACCTGTAATCCCAGCAACTCAGGAAGCTGAGACAGGAGAAGTACTTGAACCCAGAAGGCAGAGGTTGCAGTGAGCCGATATTGCACCATTGCACTCCAGTCTGGGCAACAAGAGTGAAACTCTGTCTCAAAAAAAAA"
"chr17","34071612","34072215","JH378118","18053084","18053501","250","16018528","GGCCAGGTGTGGTGCCTTACATCTGTAATTCCAGCACTTTGGGAGGCTGAGGTGGGTGGATCACCTGAGGTCAGGAGTTCAGGACCAACCTGGCCAACATAGTGAAACCCCGTCTCACTAAAAATACAAAAATTAAAAAGAAAGAAAGAAAAAAGCCAGGTGCGGTGGCTCACACCTGTAACCCCAGCACTTTGGGAGGCCAAGATGGGCGGATCACCTGAGGTCGGGAGTTTGAGACCAGCCTGACCAACATGGAGAAACCCCGTCTCTACTAAAAATACAAAATTAACCAGGCGTGGTGGTGCATGCCTGTAATCCCAGCTACTTGGGAGGATGAGGCAGGAGAATCGCTTGAACCCTGGAGGCGGAGGTTGTGGTGAGCTGAGATCATGCCATTGCACTCCAGCCTAGGCAACAAGAGCGAGACTCCATCTCAAAAAAAAAAAAAAAATTGGGCATGGTGGTGCATGCCTGTAATCCCAGCTACTCAGGAGTCTAAGGCAGGAGAATCACTTGAACCCAGGAGGCAGAGGTTGCAGTGAGCTGAGATCACGCCATTGCACTCCAGCCTGAGCGACAAGAGTGAAACTACGTCTCAAAAAAA","GGCTGGGCGCAGTGGCTCACACCTGTAATCCCAGCACTTAGGGAAGCTGAGGCGAGTAGATCACCTGAGGTCAGGAGTTAGAGACCAGCCTGGCCATCATGGTGAAACCCCGTCTCTACTAAAGATACCAAAAATTAGCTGAGTGTGGTGCTGGGTGCCTGTAATCCCAGAAACTCAGGGTGCCTGTAATCCCAGCAACTCAGGGTGCCTTTAATCCCAGCAACTGAGGGTACCAGTAATCCCAGCAACTCAGGGTGTCTTTAATCCTAGCAACTGAGGGCACCTGTAATCCCAGCAACTCAGGAAGCTGAGACAGGAGAAGTACTTGAACCCAGAAGGCAGAGGTTGCAGTGAGCCGATATTGCACCATTGCACTCCAGTCTGGGCAACAAGAGTGAAACTCTGTCTCAAAAAAAAA"
"chr17","34329459","34330029","JH378119","32351107","32351490","237","1978352","GGCCAGGTGCCGTGGCTCACACATGTAGTCCCAGCACGTTGGGAGGCTGAGGTTAATGGATCACCTGAAGTCACAAGTTCGAGACCAGCCTGACCAACATGGTGAAACCCTGTCTCTACTAAAATATAAAAAGTAGTCGGCCGGGCGCAGTTGCTCATGCCTGTGATCGCCTGAGGTCAGGATTTCAAGCCCAGCCTGGCCAAAATGGTGAAACCCCATCTCTACTAAAAATATAAAAATTAGCCAGGCATGGTGGCAGGTGCCTGTAATCCCAGCTACTCAGGAGGTTGAGGCAGGAGAATCACTTGGACCCAGGGGGCAGAGGTTGCAGTGAGCCAAGATCACAGCATCGCACTCCAGCTTAGGCAACAAGAGAGAAACTCCATCTCAAAAAAAACCCAAAAAAAACAAAAAAACAAAAAAACCCAGGCATGGTGGCAGGCGTCTGTAATCTCAGCTACTCGGGAGGCTGAGGCAAGAGAATCGCTTGAACCTGGGAGGCAGAGGTTGCAGTGAGCCAAGATCATGCCATTGCACTCCAGACTGAGCAATAAGAGCGAAACTCCATCTC","GGCCAGGTATGGTGGCTCACACCTGTAATCCCAGCACTTTGGGAGGCCAAGGCAGGCAGACCACCTGAGGTCAGGAGTTCGAGATCAGCCTAGCCAACATGGTGAAACCCCATCTCTAGTAAAAATAAAATTAGCCAGGCATGGTGGTGCATGCCTGTAACGCAGGTCAGGAGTTCGAGATCAGCTTAGCCAACATGGTGAAACCCCATCTCTAGTAAAAATAAAATTAGCCAGGCAGGTGGTGCCGCCTGTACTCGGGAGGCTGAGGCAGGAGAATCACTTGAACCCAAGAGGCAGAGGTTGCAGTCAGCCAAGATCATGCCATTGCACTCCAGCCTAAGCAAAAAGAGTAAAACTCAGTCTCAAAACAAAAAAACAAAAAAA"
"chr17","35196292","35196625","JH378228","5665092","5665424","47","29531200","GGCTGGGCATGGTGTCTTACGCCTGGAATCCCAGCACTTTGGGAGGCCAAGGCGGGTGGATCACCTGAGGTCAGGAGTTTGAGACCAGCCTGGCCAACATGTTGAAACTCTGTCTCTACTAAAAATACAAAAATTAGCCGGGCATGGTGGCGGATGCCTGTAATCCCAACTACGTGGGAGGCTGAGGCAGGAGAATCGCTTGAACCCAGGAGATGGAGGTTGTGGTGAGCCGAGATCATGCCATTGCACTCCAGCCTGGGCAACAAGAACAAAACTCTGTCTCAAAATAAATAAAAAAATAAATAAATAAATAAAAACAACAACAACAACAAAA","GGCCGGGCGCGGTGGCTCAAGCCTGTAATCCCAGCACTTTGGGAGGCTGAGGCGGGTGGATCACGAGGTCAAGAGATCGAGACCATCCTGGTCAACATGGTGAAACCCTGTCTCTACTAAAAATACTAAAAATTAGCTGGGCATGGTGGCGTGTGCCTGTAATCCCAGCTACTCAGGAGGCTGAGGCAGGAGAATTGCCTGAACCCAGGAGGCGGAGGTTGCGGTGAGCCGAGATCGCGCCATTGCACTCCAGCCTGGGCAACAAGAGCGAAACTCTGTCTCAAAAAAAAAAAATAAATAAATAAAATAAAATAAAATAAAATAAAATAAAAT"
"chr17","40291413","40291755","JH378144","13229286","13229620","52","27062127","GGCCAGGCACAGTGGCTCATGCCTGTAATCCCAGCACTTTGCGAGGCTGAGCCAGGTGGATCACCTGAGGTCAGGAGTTCAAGAGCAGCCTGGCCAACATGGTGAAACCCCGTCTCTACTAAAAATACAAAAATTATCTGGAGTGGTGGTAGGTGCCTATAATTGCAGATACACAGAAGGCTGAGACAGGAGAATTGCTTGAACCCAGGAGGCGGAGGTTGCTGTGAGCCGAGATCGCGCCATTGCACCCCAGCCTGGGAGACAAGAGCGAAACTCCATCTCAATAAATAAATACATACATACATACATACATACATGCATACATACATAAAATAAAATAAAA","GGCCGGGCGCGGTGGCTCAAGCCTGTAATCCCAGCACTTTGGGAGGCCGAGGCGGGTGGATCACCTGTGGTCAGGAGTTCAAGACAGCTTGGTCAACATGGTGAAACCCCGTCTCTACCAAAAATACAAAAAATTAGCTGGGCATGGTAGCGCATGCCTGTAATCCCAGCTACTCAGGAGGCTGAGGCAGGAGAATTGCCTGAACCCAGGAGGCAGAGGTTGCGGTGAGCCGAGATCGCGCCATTGCACTCCAGCCTGGGTAACAAGAGCGAAACTCCCTCTCATAAAAAATAAATAAATAAATAAATAAATAAATAAATAAATAAATAAATAAA"
"chr17","45148344","45148987","JH378206","6546474","6546861","299","38601870","GGCTTGGTGCCATGGTTCATGCCTGTAATCCTGGCACTTTGGGAGGCCGAGGTGGGCAGATCACTTGAGCTCAGGAGTTCAAGACCACCTTGGGCGACATGGTGAAACCTCATCTCTCCTTAAAAAAAAAAAAAACAGCCGGGCGCGGTGGCTCACACCTGTAATCCCAGCACTTTGGGAGGCCAAGGCGGGTGGGGTTCATGAGGTCAGAAGATCGAGACCATCCTGGCTAACACGGTGAAACCCCGTCTCACTAAAAATAGAAAAAACTAGCCGGGCGTGGTGGCGGGCACCTGTAGTCCCAGCTACTCGGGAGGCTGAGGCAGGAGAATGGCGTGAACCCGGGAGGCGGAGCTTGCAGTGAGCTGAGATCTTGCCATTGCACTCCAGCCTGGGCAACAAGAGTGAAACTCTGTCTCAAAAAAAAAAAATTAAAAAAACAAATAAAAATAAAAATACATAATTAGCAGGACATGGTGGCACATGCCTGTAATCCCCAGCTACTCGGGAGGCTGAGGCATGGGAATTGTTTAAACCTGTGAGGCGGTGGTTGCAGTGAGCCAAGATCAAGCCATTGCACTCCAGCCTGGGCAACAAGAGTGAAACTCCATCTCAAAAAAAAAAAAAAAAAAGAGAAAAGAAAA","GGCCACACATGGTGGCTAACGCCTGTAATCCCAGCACTTTGGGAGGCCAAGTCGGGTGGATCATGAGGTCAGGAGACCAAGACCATCCTGGCCAAATGGTGAAACCCCGTCTCTACTAAAAATACAAAAATTAGCTGGGCATGGTGGCGTGTGCCTGTAATCCCAGCTACTCAGGAGGCTGAGGCAGGACAATTGCCTGAACCCAGGAGAATTAGCTGGGCATGGTGGCGTGTGCCTGTAATCCCAGCTACTCAGGAGGCTGAGGCAGGACAATTGCCTGAACCCAGGAGGCGAAGGTTGCGGTGAGCCGAGATTGTGCCATTGCACTCCAGCCTGGGTAACAAGAGCGACACTCTGTCTCAAAAAAAAAAAAAAAAAAAAAAAAAAA"
"chr17","47866693","47867898","JH378118","18053084","18053501","809","29813609","GGCTGGGCTTGGTGGCTCATGCCTATAATTCTAGGACTTTGGGAGGCCAAGGCGGATGGATCACCTGAGGTCAAGAGTTGGAGACCAACCTGTCCAACATGGTGAAACCCCCTCTGTACTAAAAATACAAAAATTGGCCGAGCGTAGTGGCTCATGCCTGTGATCACAGCACTTTGAGAGGCTGAGGCGGGCGGATCACAAGGTCAGGAGATCAAAACCATCCTGGCTAACAAGGTGAAACCCCATCTCTGCTAAAAAATAACAGGGCGTGGTGGCACACGGCTGTAGTCCCAGCTACTTGGGAAGCTGAGGCAGGAGAATCGCTTGAACCTGAGAGGCAGAGGTTGCAGTGAGCTGAGATCAGGCCACTGCTCTCCAGCCTGGGCAACAGAGTGAAACTCCATCTCAAAAAAAAAAAGAAAAAGGCCAGGCATGGTGGCTCACGCCTGTAATGCCAGCACTTTGGAAGACTAAGTTGGGCAGATCACAACATCAGAAGATGGAGACCATCCTGGCTAACACGGTGAAACCCCGTCTCTACTAAAAATACAAAAAAAAAAAAAAAAAAAATTAGCCGGGCGTGGTGACATGCGCCTGTAATCCTAGCTACTCCGGAGGCTGAGGCAGGAGAATGGCGTGAACCCGGGAGGCGGAGCTTGCAGTGAGCCGAGATGGTGCCACTGCACTCCAACCTGGGCGACAGAGCGAGACTCTGTCTCAAAAAAAAAAAAAAAAAAGAAAAAAGGTCGGGCGCAGTGGCTCACACCAGTAATCACAGCACTTTGGGAGGCCGAGGCGGGTGGATCACCTGAGCTCGGGAGTTCAAGACCAGCCTGACCAACATGGTGAAACTCCGTCTCTACTAAAAATACAAAATATTAGCCGGGCGTGGTGGCGCGTGCCTGTAATCCCAGTTACACGGGAGGCTGAGGCAGGAGAATCACTTGAACTTGGGAAGTGGAGGTTGTGGGAGCCGAAATCGTGCCATCGCATTCCACAAGAGTGAAACTCCATTTCAAAAAAAAAAAATACAAAAATTAGCTGGGCGTGGTGGCGGGCGCCTTTAATCCCAGGGGCTCGGGAGGCTGAGGCAGGAGAATCGCTTGAACCTAGGAGGCAGAGGTTGCAGTGTGCCAAGATGACACCATTGCACTCCAGGCTGGGCAAGAGAGCAGTAACTCCCGTCTCAAAAAAAAAGAAGGAAAA","GGCTGGGCGCAGTGGCTCACACCTGTAATCCCAGCACTTAGGGAAGCTGAGGCGAGTAGATCACCTGAGGTCAGGAGTTAGAGACCAGCCTGGCCATCATGGTGAAACCCCGTCTCTACTAAAGATACCAAAAATTAGCTGAGTGTGGTGCTGGGTGCCTGTAATCCCAGAAACTCAGGGTGCCTGTAATCCCAGCAACTCAGGGTGCCTTTAATCCCAGCAACTGAGGGTACCAGTAATCCCAGCAACTCAGGGTGTCTTTAATCCTAGCAACTGAGGGCACCTGTAATCCCAGCAACTCAGGAAGCTGAGACAGGAGAAGTACTTGAACCCAGAAGGCAGAGGTTGCAGTGAGCCGATATTGCACCATTGCACTCCAGTCTGGGCAACAAGAGTGAAACTCTGTCTCAAAAAAAAA"
"chr17","48059944","48060302","JH378108","45564157","45564495","64","2495787","GGCCGGGCGCAGTGGTTCATGCCTGTAATCCCAACACTTTAGGGGGCTGAGGCAGGTGGATCACCTGAGGTCAGGAGTTCAAGACCAGCCTGGCCAACATGGTGAAAGCCCATCTCTACTAAAAATACAAAAAATTAGCTGGGCATGGTGGTGCGTGCCTGTAATCCCAGCTACTTGGGATGCTGAGGCAGGAGAATCGCTTGAACCCGGGAGGTGGAGGCTGCAGTGAGCTGAGATTGTGCCATTGCACTCCAGCCTGGGCAACAAGAGTGAAACTCCATCTAAAAAAAAAAAAGAAGAGGAGGAGGAGGAGGAGGGGGAGGGGGAGGAGGAGGAGGAGGAGAAGAAGAAAAAAGAAA","GCTAGGCAAGGTGGCTCATGCCTGTAATCCCAACATTTTGGGAGGCCGAGGCAGATGGATCACCTGAGGTTAGGAGTTCAAGACCAGCCTGGCCAACATGGTGAAACTCCATCTCTACTAAAAATACAAAAAATTAGCTTGGCACGGTGGTGGGTGCCTCTAATCCCAGCTGCTTGGGAGGCTGAGGCAGGAGAATCGCTTGAACTCAGGAGGTGGAGGTTGCAGTGAGCCAAGATCATGGCATTGCACTCCAGCCTGGGCGACAAGAGCGAGACTCCCTCTAAGAAAGAAAAGAAAGAAAAGAAAAGAAAAAAGGAAAGGAAAGGAAAGAAAGAGAAA"
"chr17","50365982","50366602","JH378118","18053084","18053501","274","32312898","GGCAAGGCGTGGTGGCTGATGTCTGTAATCCCAGCAATTTGGGGGGCTGAGGTGGATGGATCACCTGAGATCAGAAGTTCGAGACTAGGCTAGCCAACATAGTGAAACCCCATCTCTACTAAAAATATAAAAAGTTAGCCAGGCGCGGTGGTTCATGCCTGTAATCCCAGCACTTTGGGAGGCCGAGGTAGGTGGATCACAAGGTCAGGAGTTCAAGACCAACCTGGCCAAGATAGTGAAACCTCATCTCTACTAAAAATACAAAAATTAGCTGGGCGTGGTGGCAACCACCTATGATCCCAGCTACTTGGGAGGCTGAGGCAGAGAACTGCTTGAACCCAGGAAGTGGAGGTTGTAGTGAGCCAAGATTGCATCACTGTACTCCAGCCTGGGCAACAGAGCAAGACTCCATCTCAAAAAAAAAAAAAAAAAAAATACAAAAAATTAGCCAGGCGTGGTGGCAGGCACCTGTAATCCCAGCTACTCGGAAGGCTGAGGCAGGAGAATTGCTTGAACCTGGGAGGTAGAGGTTGCAGTGAGCTGAGATTGTGCCATTGCACTCTAGCCTATGTGACAAGAGCGAAACTCCATCTCAAAAAAAAAAAAAAAAAAGAAAGAAAA","GGCTGGGCGCAGTGGCTCACACCTGTAATCCCAGCACTTAGGGAAGCTGAGGCGAGTAGATCACCTGAGGTCAGGAGTTAGAGACCAGCCTGGCCATCATGGTGAAACCCCGTCTCTACTAAAGATACCAAAAATTAGCTGAGTGTGGTGCTGGGTGCCTGTAATCCCAGAAACTCAGGGTGCCTGTAATCCCAGCAACTCAGGGTGCCTTTAATCCCAGCAACTGAGGGTACCAGTAATCCCAGCAACTCAGGGTGTCTTTAATCCTAGCAACTGAGGGCACCTGTAATCCCAGCAACTCAGGAAGCTGAGACAGGAGAAGTACTTGAACCCAGAAGGCAGAGGTTGCAGTGAGCCGATATTGCACCATTGCACTCCAGTCTGGGCAACAAGAGTGAAACTCTGTCTCAAAAAAAAA"
"chr17","50542261","50542886","JH378206","6546474","6546861","277","43995787","GCCGGGCGCTGTGGCTCAAGCCTGTAATCCCAGCATTTTGGGAGACTAAGGGAAGCAGATCCTGTGAGCTCAGGATTTCGAGACCAGCCTGGCCAACATGGTGAAACCCTGTCTCTACAAAAATTAGCCATGCCGGGCACGGTGGCTCACGCCTGTAATCCCAGCACTTTGGGAGGCTGAGGCGGGCGGATCACAAGGTCAGGAGTTTGAGACCATCCTGCCTAACACGGTGCAACCCCGTCTCTACCAAAAATACAAAAAATTAGCTGGGCGTGGTGGCGGGTGCCTGTAGTCCCAGCTACTCGGGGGGCTGAGGCAAGAGAATGGCATGAACCTGTGGGGCGGAGCTTGCTGTGAGCCGATATCCTGCCACTGCACTCCAGCCTGGGCGACAGAGCGAGACTCCATCTCAAAAAAAAAAAAAAAAAAAAAAAAAAAAAAAAATGAGCCAGCTGTGGTGGCGTGTGTGCCTGTAATCCCAGCTACTCGGGAGGCTGAGGCAAGAGAATCACTTGAATCTGGGAGGCAGAGGTTGCAGTGAGCCAAGATCATGCTATTGCACTTCAGCCTGGGCAACAAGAGTGAAACTCTGTCTCAAAAAAAAAAAAAAAAAAAAAGAAAAAGAA","GGCCACACATGGTGGCTAACGCCTGTAATCCCAGCACTTTGGGAGGCCAAGTCGGGTGGATCATGAGGTCAGGAGACCAAGACCATCCTGGCCAAATGGTGAAACCCCGTCTCTACTAAAAATACAAAAATTAGCTGGGCATGGTGGCGTGTGCCTGTAATCCCAGCTACTCAGGAGGCTGAGGCAGGACAATTGCCTGAACCCAGGAGAATTAGCTGGGCATGGTGGCGTGTGCCTGTAATCCCAGCTACTCAGGAGGCTGAGGCAGGACAATTGCCTGAACCCAGGAGGCGAAGGTTGCGGTGAGCCGAGATTGTGCCATTGCACTCCAGCCTGGGTAACAAGAGCGACACTCTGTCTCAAAAAAAAAAAAAAAAAAAAAAAAAAA"
"chr17","51121894","51122508","JH378118","18053084","18053501","260","33068810","GGCTGGGTGCAGTGGCTCATGCCTGTATTCCCAACACTTTGAGAGGCCAAGGCGGGCAGATCACCTGAGGTCAGGAATTCGAGACCAGCCTGGCTAACATGGCGAAACCCTGTCTCTATTAAAAACACAAAAATTAGGCCAGGCACGGTGGCTCACACCTGTAATCCCAGCACTTTGGGAGGCTGAGGCGGGCAGATCACGAAGTCAGGAGATCGAGACCATCCTGGCTAACATGGTGAAACCCTGTCTCTGCTAAAAATACAAAAAAAATAGCGGGGCGTGGTGGCAGGCGCCTGTAGTCCCAGCTACTCAGGAGGCTGAGGCAGGAGAATGGCGTGAACCTGGGAGGCGGAGGTTGCAGTGAGCCGAGATCGCGCCACTGCACTACAGCTTGGGTGACAGAGCGAGACTCTGTCTCAAAAAAAAAAAAAAAAGTTAGTCGGGCATGGTGGTGGGCTCCTGTATTCCCAGCTACTCAGGAGGCTGAGGTGGGAGAATCACTTGAACCTGGAAGGCAGAGGTTGCTGTGAGCCAAGATTGCACCATTGCATTCCAGCCTGGGTGACAAGAGCAAAACTCTGTCTCAAAAAATATATATAAAATAATAAAAATAAA","GGCTGGGCGCAGTGGCTCACACCTGTAATCCCAGCACTTAGGGAAGCTGAGGCGAGTAGATCACCTGAGGTCAGGAGTTAGAGACCAGCCTGGCCATCATGGTGAAACCCCGTCTCTACTAAAGATACCAAAAATTAGCTGAGTGTGGTGCTGGGTGCCTGTAATCCCAGAAACTCAGGGTGCCTGTAATCCCAGCAACTCAGGGTGCCTTTAATCCCAGCAACTGAGGGTACCAGTAATCCCAGCAACTCAGGGTGTCTTTAATCCTAGCAACTGAGGGCACCTGTAATCCCAGCAACTCAGGAAGCTGAGACAGGAGAAGTACTTGAACCCAGAAGGCAGAGGTTGCAGTGAGCCGATATTGCACCATTGCACTCCAGTCTGGGCAACAAGAGTGAAACTCTGTCTCAAAAAAAAA"
"chr17","51573403","51574012","JH378118","18053084","18053501","260","33520319","GGCCGGGTGTGGTGGCTCACGCCTATTATCCCAGCAGTTTGGGAGGCCAAGTGGGGGTTGGATCACCTGAGGTCAGGGGTTCGAGACCAGCATGGCCAACATGGTGAAAACCCATCTATACTAAAGATACAAAAAATTAGGCTGGGCACAGTGGCTCATGCCTGTAATCCCAGCACTTTGGGAGGCCAAGGATCACGAGGTCAGGAGATCGAGACCATCCTGGCTAACACAGTGAAACCCCGTCTCTACTAAAAATACAAAAAAATTAGCCGGGAGTGGTGGCAAGTGCCTGTAGTCCCAGCTACTCAGGAGGCTGAGGCAGGTGAATAGTGTGAACGCAGGAGGCAGAGCTTGCAGTGAGCCGAGATCGTGCCACTACACTCCAGCCTGGGCGACAAGGTGAGACAACGTCTCAAAAAAAAAAAAAAAAAAAAGCCGGGCATGGTGGGAGGCACCTGTAATTCCACCTACTTGGGAGGGTGAGGCAGGAGAATTGCTTGAATCTGGGAGATGGAGGTTGGAGTAAGCCAAGTTCGCACCATTGCACTCCAGCCTGGGTGACAAGAGCGAAACTCTTGTCTCAAAAAAAAAAAAAAAAAAAAAAAAAAAA","GGCTGGGCGCAGTGGCTCACACCTGTAATCCCAGCACTTAGGGAAGCTGAGGCGAGTAGATCACCTGAGGTCAGGAGTTAGAGACCAGCCTGGCCATCATGGTGAAACCCCGTCTCTACTAAAGATACCAAAAATTAGCTGAGTGTGGTGCTGGGTGCCTGTAATCCCAGAAACTCAGGGTGCCTGTAATCCCAGCAACTCAGGGTGCCTTTAATCCCAGCAACTGAGGGTACCAGTAATCCCAGCAACTCAGGGTGTCTTTAATCCTAGCAACTGAGGGCACCTGTAATCCCAGCAACTCAGGAAGCTGAGACAGGAGAAGTACTTGAACCCAGAAGGCAGAGGTTGCAGTGAGCCGATATTGCACCATTGCACTCCAGTCTGGGCAACAAGAGTGAAACTCTGTCTCAAAAAAAAA"
"chr17","51598763","51599361","JH378118","18053084","18053501","241","33545679","GCCGGGCGTGGTGACTCACGCCTGTAATACCAGCACTTTAGGAGGCTGAGGTGGGTGGATCACCTGAGGTCAGGAGTTCGAGACCGGCCTGGCCAACATGGTGAAATCCTGTCTCTACTAAAAATACAAAAAAATGGCCAGGCGTGGTGGCTCACGCCTGTAATCCTAGCACTTTGGGCGGCCCAGGTGAGTGGATCACGAGGTCAGGAGATCGAGACCATCCTGGCTAACATGGTGAAACCCCATCTCTACTAAAAAACTACAAAAAAATTAGCTGGGCGTGGTGGCAGGCGCCTGTAGTCCCAGCTACTCGGGAGGCTGAGGCAGGAGAATGACGTGAACCCGGGAGGCGGAGCTTGCAGTGAGCAGAGCTTGAGCCACTGCACTCCAGCTTGGGCGACAGAGTGAGACTCCGTCTCAAAAAAAAAAAAAAAAAAATTAGCTGGGGATGGTGGCGGGCACCTGTAATCCCAGCTACTCTGGAGGCTGAGACAGGAGAATCGCTTGAACCCAGGAGGCGGAGGTTGCAGTGAGCTGAGATCGTGCCATTGTACTCCAGCCTGGGCAACAAGAGTGAAACTCAATCCGAAGAAAAAAAA","GGCTGGGCGCAGTGGCTCACACCTGTAATCCCAGCACTTAGGGAAGCTGAGGCGAGTAGATCACCTGAGGTCAGGAGTTAGAGACCAGCCTGGCCATCATGGTGAAACCCCGTCTCTACTAAAGATACCAAAAATTAGCTGAGTGTGGTGCTGGGTGCCTGTAATCCCAGAAACTCAGGGTGCCTGTAATCCCAGCAACTCAGGGTGCCTTTAATCCCAGCAACTGAGGGTACCAGTAATCCCAGCAACTCAGGGTGTCTTTAATCCTAGCAACTGAGGGCACCTGTAATCCCAGCAACTCAGGAAGCTGAGACAGGAGAAGTACTTGAACCCAGAAGGCAGAGGTTGCAGTGAGCCGATATTGCACCATTGCACTCCAGTCTGGGCAACAAGAGTGAAACTCTGTCTCAAAAAAAAA"
"chr17","51738482","51739094","JH378118","18053084","18053501","257","33685398","GCCGGGTGCGGTGGCTCACACCTGTAATCCCAGCACTTTGGGAGACTGAGGCGGGAGGATCACCTGAGGTCAGGAGTTCGAGACCAACCTGACCAACATGGTAAAACCCTGTCTGTACTAAAACTACAAAAAATTAGGCCAGGCGCAGTGGTCCATGCCTGTAATCCCAGCACTTTGGGAGGCCAAGGTGGGCGGATCATGAGGTCAGGAGTTTGAGACCAGCCTGGCCAACATAGTGAAACCCTGTCTCTACTAAAAACACAAAAATTAGTCGGGCATGGTGGCGGATGCCTGTAATCTCAGCTACTCAGGAGGTTGAGGCAGGAGAATCACTTGAACCCGGGAGGTGGAGGTTGCAGTGAGCCAAGATCACGCCACTGTACTCCAGCCTGGGCAACAGAGCGGGACTCCATCTTAAAAAAAAAAAAAAAAAAATTAGCCAGGCGTGGTGGCGCATGCCTGTAGTCCCAGCTACTTAGGAGGCTGAGGCAGGAGAATTGCTTGAACCCGGGAGGCAGAGGCTGCAGTGAGCCAAGACCACGCTATTGCATTCCAGCCTGGGTGACAAGAGCAAAACTCTGTCTCAAAAAACAAAACAAAACAAACAAAAAAA","GGCTGGGCGCAGTGGCTCACACCTGTAATCCCAGCACTTAGGGAAGCTGAGGCGAGTAGATCACCTGAGGTCAGGAGTTAGAGACCAGCCTGGCCATCATGGTGAAACCCCGTCTCTACTAAAGATACCAAAAATTAGCTGAGTGTGGTGCTGGGTGCCTGTAATCCCAGAAACTCAGGGTGCCTGTAATCCCAGCAACTCAGGGTGCCTTTAATCCCAGCAACTGAGGGTACCAGTAATCCCAGCAACTCAGGGTGTCTTTAATCCTAGCAACTGAGGGCACCTGTAATCCCAGCAACTCAGGAAGCTGAGACAGGAGAAGTACTTGAACCCAGAAGGCAGAGGTTGCAGTGAGCCGATATTGCACCATTGCACTCCAGTCTGGGCAACAAGAGTGAAACTCTGTCTCAAAAAAAAA"
"chr17","52245950","52246538","JH378118","18053084","18053501","254","34192866","TGTAATCCCAGCACTTTGGGAAGCCAACGCGGGTAGATCAGCTGAGGTCAGGAGCTCGAGACCAGCCTGGCCAACTGGTGAAACCCCATCTCTACTAAAAAAAATACAAAAAAATGGCCCAGCGCGGTGGCTCACACCTGTAATCCCAGCACTTTGGGAGGCCGAGGCGGGCAGATCACGAGGTCAGGAGATCGAGACCATCCTGGATAATACGGTGAAACCCCGTCTCTACTAAAAATACAAAAAAAAATTAACCGGGTGTGGTGGCGGGCGCCTGTAGTCCCAGCTACTAGGGAGGCTGAAGCAGGAGAATGGCGCGAAACCGGGAGGCGGAGCTTGCAGTGAGCCAAGACAGGCCACTGCACTCCAGCCTGGGCGACAGAGCGAGACTCCATCTCAAAAAAACAAAAAACAAAAAAATTAGCCAGCTGTGGTGGTGGGCGCATGTAATCCCAGTTACTTGGGAGGCTGAGGCAGGAGAATTGCTTGAAACCAGGAGGCAGAGGTTGCAGTGAGCCAAGATTACGCCATTGTACTCCAGCCTGGGCAACAAGGGCAAAACTCTGTCTCAACAAAAAAAAAGAAAAAA","GGCTGGGCGCAGTGGCTCACACCTGTAATCCCAGCACTTAGGGAAGCTGAGGCGAGTAGATCACCTGAGGTCAGGAGTTAGAGACCAGCCTGGCCATCATGGTGAAACCCCGTCTCTACTAAAGATACCAAAAATTAGCTGAGTGTGGTGCTGGGTGCCTGTAATCCCAGAAACTCAGGGTGCCTGTAATCCCAGCAACTCAGGGTGCCTTTAATCCCAGCAACTGAGGGTACCAGTAATCCCAGCAACTCAGGGTGTCTTTAATCCTAGCAACTGAGGGCACCTGTAATCCCAGCAACTCAGGAAGCTGAGACAGGAGAAGTACTTGAACCCAGAAGGCAGAGGTTGCAGTGAGCCGATATTGCACCATTGCACTCCAGTCTGGGCAACAAGAGTGAAACTCTGTCTCAAAAAAAAA"
"chr17","52264620","52265210","JH378118","18053084","18053501","242","34211536","GGCCACATGTGGTGGCTCACACCTGTAATCCCAGCACTTTGGGAGGCCAAGGCAGGCAGATCACCTGAGATCAGAAGTTCAAGACCAGCCTGGCCAATGTGGTGAAACCCTGTCTCTACTAAAAATAGAAAAAACACAGCCAGGCGCGGTAGCTCACACCTGCAATCCCAGCACTTTGGGAGGCCGAGGCAGGCAGATCACGAGGTCAGGAGATTGAGACCACGGTGAAACCCCATCTCTACTAAAAATACAAAAAATTAGCTGGGCATGGTGGCGGGCACCTGTAGTCCCAGCCACTTGGGAGGCTGAGGCAGGAGAATGGCGTGAACTCGGGAGGTGGAGCTTGCAGTGAGCAAAATTGCGCCACTGCACTCCAGCCTGGGCAACAGAGCAAGACTCCGTCTCAAAAAAAAAAAAAAAAAAAAATTAGCCGGCGTAGTGGCAAGCTCCTGTAATCCCAGCTACTTGGGAGGCTGAAGCAGGAGAATCGCTTGAACCCAGGAGGTGGAGGTTGCAGTGAGCCGAGACTGCGCCATTGCACTCCAGCCTGGGCAACAAGAATGAAACTCCGTCTCAGAAAAGAAAAAAAAA","GGCTGGGCGCAGTGGCTCACACCTGTAATCCCAGCACTTAGGGAAGCTGAGGCGAGTAGATCACCTGAGGTCAGGAGTTAGAGACCAGCCTGGCCATCATGGTGAAACCCCGTCTCTACTAAAGATACCAAAAATTAGCTGAGTGTGGTGCTGGGTGCCTGTAATCCCAGAAACTCAGGGTGCCTGTAATCCCAGCAACTCAGGGTGCCTTTAATCCCAGCAACTGAGGGTACCAGTAATCCCAGCAACTCAGGGTGTCTTTAATCCTAGCAACTGAGGGCACCTGTAATCCCAGCAACTCAGGAAGCTGAGACAGGAGAAGTACTTGAACCCAGAAGGCAGAGGTTGCAGTGAGCCGATATTGCACCATTGCACTCCAGTCTGGGCAACAAGAGTGAAACTCTGTCTCAAAAAAAAA"
"chr17","52281488","52282107","JH378118","18053084","18053501","287","34228404","GGCCAGGCGCGGTGGCTCACGCCTGTAATCCCAGCACTTTGGGAGGTCAAGGCGGGTGGATCACCTGAGGTCAGGAGTTCAAGACCAGCCTGGCCAACATGATGAAACTTCATCTTGGCCGGGCGCGGTGGCTCATGCTTGTAATCCCAGCACTTTGGGAGGCCAAGGCAGGCGGCGGATCATGAGGTCAGGAGATTGAGACCATCCTGGCTAAAACGGTGAAACCCCGTCTCTACTAAAAATACAAAAAAAAAAAAATTAGCCGGGCGTGGTGGCAGGCGCCTGTAGTCCCAGCTACTCGGGAGGCTGAGGCAGGAGAATGGCGTGAACCCGGGAGGCGGAGCTTGCAGTGAGCCGAGATAGCACCACTGCAGTCCGGCCTGGGTGAAAGAGTGAGACTCCGTCTCAAAAAAAAAAAAAAAGAAGAAAGAACTTCGTCTTTACTAAAAGTACAAAAAAAAAAAAAAAAAATTAGCCGGGCATGGTGGCAGGCGCCTGTAAACCCAACTACTCTGGAGGCTGAGGAAGGAGAACTGCTTGCACCTGGGAGTCGGAGGTTGCAGTAAGCCAAGATCGCACCATTGCACTCCAGCCTGGGCATCAAGAGTGAGACTTTGTCT","GGCTGGGCGCAGTGGCTCACACCTGTAATCCCAGCACTTAGGGAAGCTGAGGCGAGTAGATCACCTGAGGTCAGGAGTTAGAGACCAGCCTGGCCATCATGGTGAAACCCCGTCTCTACTAAAGATACCAAAAATTAGCTGAGTGTGGTGCTGGGTGCCTGTAATCCCAGAAACTCAGGGTGCCTGTAATCCCAGCAACTCAGGGTGCCTTTAATCCCAGCAACTGAGGGTACCAGTAATCCCAGCAACTCAGGGTGTCTTTAATCCTAGCAACTGAGGGCACCTGTAATCCCAGCAACTCAGGAAGCTGAGACAGGAGAAGTACTTGAACCCAGAAGGCAGAGGTTGCAGTGAGCCGATATTGCACCATTGCACTCCAGTCTGGGCAACAAGAGTGAAACTCTGTCTCAAAAAAAAA"
"chr17","52731467","52732093","JH378129","11955248","11955630","276","40776219","GGCCGGGTGCGGTGGCTCACGCCTGTAATCCTGGCACTTTGGGAGGCTGAGATGGACGGATCACCTGAGGTCAGGAGTTTTTTGTTTTTTTCTTTTTTTTTGAGACAGAGTCTGGCTCTGTTGCCCAGGCTGGAGTGCAGTGGCTCGATCTCGGCTCACTGCAAGCTCCGCCTCCCGGGTTCATGCCATTCTCCTGCCTCAGCCTCCCGGTAGCTGGGACTACAGGTGCCCGCCAGCACATCCGGTTATTTTTTTGTATTTTTAGTAGAGACAGTGTTTCACAGTGTTAGCCAGGATGGTCTCGATCTCCTGACCTCGTGATCCGCCCACCTCGGCCTCCCAAAAGTGCTGGGATTACAGGCATGAGCCACCGCGCCCGGCCAGGAGTTTTTGAGACCAGCCTGGCCAACAGGGTGAAACTCTGTCTCTACTAAAAATACAAAAATTAGTTGGGCATGGTGGCAGGCACCTGTAATCCCAGCTACATGGGAGGCTGAGGCAGGAGAATTGCTTGAACCTGGGAGGCGGAGGTTGCAGTGAGCTGAGATTGCGCCATTGCACTCCAGCCTGGGCAACAAGAGTGAAATTGCGTCTCAAAAACCAAAACAAACAAAAAAAGAATGAAAA","GGCTGGGTACGGTGGCTCATGCCTGTAATCCCAGCACTTTGGGAGGTGGGTCACTTGAGGTCAGGAGTTCGAGACCAGCCTGTGCAGTGCCTCCATCCTCAACTGCTGCCTCATCAGCCTGGACCACTACCTGCTCATCCTCTCACCACTGCCACAAGCTGCGCATGAAGCTCCTGCGCGCGCCGGTGCCCGTCTCTACTAAAAATACAAAAATTAGCTGGGTGTGGTGGCAGGTGCCTGTAATCCCAGCTACTCAGGAGGCTGAGGCAGGAGAATCACTTGAACCCAGGAGGCAGAGGTTGCAGTGAGCCGATATCGCATCATTGCACTCCAGCCTGAGCAACAAGAGTGAAATTTTGTCTCAAAAAAAAAAAAAAAAGAAA"
"chr17","54416242","54416805","JH378115","26183910","26184297","228","28232332","ACTTTGGGAGGCCATGGCAGGCGGATCACCTGAGATCAGGAGTTGGAAACCAGCCTGGCCAACATGGTAAAACCCCGTCTCTACTAAAAATACTTGGCTGGGCACGGTGGCTCACACTTGTAATTCCAACACTTTGGAAGGCCAAGGCGGGCAGATCACCTGAGGTTGGGAGTTCGAGACCAGCCTGACCAACATGGAGAAACCCTGTCTCTACTAAAAATACAAAATTAGCTGGGCATGGTGGTCTATGCCTGTAATCCCAGCTACTTGGGAGGCTGAGGCAGGAGAATTGCTTGAACCCGGGAGGCAGAGGTTGCGGTAAGCCAAGATCATGCCATTGCACTCCAGCCTGGGCAACAAGAGCAAAACCCCGTCTCAAAAAAAAAAAAAAAATTAGCCCAGTGTGGTGGCGTGCACCTGTAATCCCAGCTACTTACTTAGGAGCCTGAGGCAGGAGAATTGCTTGAACCCGGGAGGCAGAGTTTGCAGTGAGCCAAGATTGCACCATTGCACTCCAGCCTGGGTGACAAGAGTGAGACTGTCTCAAAAAAAAAAAAAAAAAAA","GGCCAGGTGCAGTGGCTCATATGTATAACCCCAACACTTTGGGAGGCCAACGCAGGTGGATCACCTGAGTTAGGAGTTTGAGACCAGCCTGACCAACATGGTGAAACCCTGTCTCTACTAAAAATACAGAAATGGCCGGGCATAGTGACACATACCTGTAATCCCAGATACTTGGGATGCTGAGTTTGCTTAAACCCAGAGGAGAACTGCTTAAACCCGGGAGGTAGAGGTCACAGTGAGCCAAGATTGGGATGCTGAGATTTGCTTAAACCCAGAGGAGAACTGCTTAAACCCAGGAGGCAGAGGTTGCAGTGAGTTGAGATTGCACCATTGCACTCCAGCCTGGACAACAAGAGTGAAACTCTGTCTCAAAAAAAAAAAAAAAAAA"
"chr17","55179146","55179483","JH378144","13229286","13229620","44","41949860","GGCCGGGTGCGGTGGCTCACGCCTGTAATCCCAGCACTTTGGGAGGCCGACGCAGGTGGATCACTTGAGGTCTGGTGTTCAAGACCAGCCTGGCCAACATTGTGAAACCCCGTCTCTACTAAAAATACAAAAAGTTAGCTGGGCATGGTAGCAGGTGCCTGTAATCCCAGCTACTTGGGAGGCTGAGGCAGGAGAATTGCTTGAACCTGGGAGGCAGAGGTTGCAGTGAGCTGAGATCGCACCATTGCACTCCAGCCCAGGCAACAAGAGCGAAACTTCGTCTCAAATAATAATAATAATAATAATAATAAATAAATAAATTTTTAAAAAAGAAAAAA","GGCCGGGCGCGGTGGCTCAAGCCTGTAATCCCAGCACTTTGGGAGGCCGAGGCGGGTGGATCACCTGTGGTCAGGAGTTCAAGACAGCTTGGTCAACATGGTGAAACCCCGTCTCTACCAAAAATACAAAAAATTAGCTGGGCATGGTAGCGCATGCCTGTAATCCCAGCTACTCAGGAGGCTGAGGCAGGAGAATTGCCTGAACCCAGGAGGCAGAGGTTGCGGTGAGCCGAGATCGCGCCATTGCACTCCAGCCTGGGTAACAAGAGCGAAACTCCCTCTCATAAAAAATAAATAAATAAATAAATAAATAAATAAATAAATAAATAAATAAA"
"chr17","59543657","59543981","JH378109","3329188","3329514","46","56214469","GGTTGGGCACAGTGGCTCACGCCTGTAATCCCAACACTTTGGGAGGCCAAGGCGGGTGGATCACCTGAGGTCGGGAGTTCAAGACCAGCCTGGCCAACATGCTGAAACCCTATCTCTACTAAAAATACAAAAAAAAAAAAAAAAAAAAAAAAAAAAAATAGCCCAGTGTGGTGTCAGGCGCCTATAATCTCAGCTACTTGGGTGGCTGAGGCAGGAGAGTCGCTTGAACCTGGGAGGCGGAGGTTGCAGTGAGCGGAGATCGCACCATTGCACTCCAGCGTGGGCAACAAGAGTGAAACTCCATCTCAAAAAAAAAGAAAAGAAA","GGCCAGGCATGGTGGCTCACGCCTGTAATCCCAGCACTTTGGGAGCCCAAGCCGGGTGGATTACCTAAGGTCAGGAATTCCAGAACAGCCTGGACAATATGGTGAAACCTTGTCTCTACTAAAAATACAAAAAAAAAAAAAAAAAAAAAAAAAAAAAAAATTTAGCCGGGTGTGGTGGTAGGTACCTGTAATCCCAGCTACTAGGGAGGCTGAGGCAGGAGAATCGCTTGAACTTGGGAGGCGGAGGTTGCAGTGAACAGAGATCACACCACTGCACTCCAGCCTGGGCGACAAGAGCAAAACTCCATCTCAAAGAAAAAAAAAGAA"
"chr17","60766805","60768705","JH378118","18053084","18053501","1483","42713721","GGCCAGGTACCGTGGCTCATGCCTCTTATCCCACCACTTTTGGAAGCTGAGGTGTGAGGATCACCCGAAGTCAGGAGTTTGGAACCATCCTGGCCAATGTTGTAAAACCCCGTCTCTAATAAAAATACAAAAGTTACCCAAGCATGGTGGTGGGCACACCTGTAATCCCAGCTACTTGGAAGGCTAAGACAGGAAAATGCCTGAACCCAGTGTGGCTGGAATTGGTGGGTTCTTGATCTCACTGACCTCAAGAATGAAGCCACGGACCCTCACGGTGAGTGTCACACTTCAAGGTGGCACGTCCAGTTTGTTCCTTCTGATGTTCGGATGTGCTCAGAGTTTCTTTCTTCTGGTGGGTTCATGGTCTCGCTGGCTCAGGAGTGAAGCTACAGACGTTCACCGGGAGTGTTACAGCTCTTAAGGCCTTGCGCCTGGAGTTGTTAGTTCCTCCCAGTGGCTTCGTGGTCTCACTGGCTTCAGGAATCAAGCAGCACGGTGAGCGTTACAGCTCACAAAGGCAGTGTGCACCCACAGTGAGCAACAGCAAAATCTATTGCAAAGAGGACAGAACAAAACCCCCACACTGGGGAAAAGGACCGGAACAGCTTGCCACTGCTGGCTCAGGCAGCCTGCTTTTATTCTCTTATCTGGCCCCACCCACATCCTCCTGATTGGTCCATTTTACAGAGAGCTGATTAGTTTGCTTTACAGTGAACTGATTGGTCCATTTTGACAGATTGGTGCTGATTGGTGCGTTTACAATCCCTGAGCTAGACACAAAAGTTTTCCACGTCCCCATTAGAATAGCTAGATACAGAGTGTCCATAGGTGTATTTACAAACCCTGAGCTAGACACGGAGTGATGATTGGTGCATTTACAAACATGGAGCTAGATACAGAGTGCCGATTGGTGCATTCACAATCCCTTAGCTAGACATAAAGGTTCTCAAGTTCCCACCAGATCAGCTAGACATAGAGCGCTGATTGGTGCATTTACAAAACTTGAGCTCGACACAGGGTGCTGATTGGTGCATTCACAAACCTTGAGCTAGACACAGGGTGCTGATTGGTGTGTTTACAAACCTTGAGCTAGATGCAGAGCGCTGATTGGTGTATTTACAATTCCTTAGCTAGACATAAAGGTTCTCCAAGTCCCCACTAGACTCAGGAGCCCAGCTGGCCTCACCCAGTGGATGTCACACTGGGGCCATAGGTGGAGCTGCCTGCCAGTTCCGTGTCCTGCGCCCACACTCCTCAGCCCTTGGGCGGTGGATGGGATTGGGCACCGTGCAGCAGGGGGTCGCGCTCCTGGGGGAGGCTCGGGCGGTGCAGGAGCCCACGGTGGCGGGGCGGGGCAGACTCAGGCATGGCGGGCTCCGGGTCCCAAGCCCTGCCGGGTGGGGAGGCACCTAAGGCCAGGCGAGAAATGGAGCGCAGCGCTGGTGGGCCAGCACTGCTGGGGGACCAGGCGCATCCTCCGCAGCTGTTGGCCTGGGTGCTAAGCCCCTCACTGCCCAGGGCTGGCAGGGCCCGCCGGCCGCTCCGAGTGCCGGGCCCGCCAAGCCCACGCCCACTTGGAACTCTAGCTGGCCCGCAAGCGCGGCGCGCAGCCCTGGTTCCCCCCCGTGCCTCTCCCTCCACACCTCCCCGCGGGCTGAGGGAGCCGGCTCCGGCCTCGGCCATCCCAGGAAGGGGCTCCCACACTGCAGCGGCGTGCTGAAGGGCTCCTCAAGCACGGCCAGAGTGGGCGAGGAGGCTGAGGAGGCGCCAAGAGTGAGCCAGGGCTGCCAGCATGCTGTCACCTCTCACCAGGAGGCGGAGATTGCAGTGAACCAAGACTGTGCCATTGCACTCCAGCCTGGGCAACAAGAGTGAAACTCCATCTCAAAAAAAATAATAAA","GGCTGGGCGCAGTGGCTCACACCTGTAATCCCAGCACTTAGGGAAGCTGAGGCGAGTAGATCACCTGAGGTCAGGAGTTAGAGACCAGCCTGGCCATCATGGTGAAACCCCGTCTCTACTAAAGATACCAAAAATTAGCTGAGTGTGGTGCTGGGTGCCTGTAATCCCAGAAACTCAGGGTGCCTGTAATCCCAGCAACTCAGGGTGCCTTTAATCCCAGCAACTGAGGGTACCAGTAATCCCAGCAACTCAGGGTGTCTTTAATCCTAGCAACTGAGGGCACCTGTAATCCCAGCAACTCAGGAAGCTGAGACAGGAGAAGTACTTGAACCCAGAAGGCAGAGGTTGCAGTGAGCCGATATTGCACCATTGCACTCCAGTCTGGGCAACAAGAGTGAAACTCTGTCTCAAAAAAAAA"
"chr17","64473614","64473953","JH378109","21565230","21565567","55","42908384","GGCCGGGTGTGGTGGCTCATGCCTGTAATCCCAGTACTTTGGGAGGCCGAGGCAGGCAGATCTCCTGAGGTCAGGAGTTTGAGACCAGCCTGGCCAACATGATGAAATGCTGTCTCTCCTAAAAATACAAAAATTAGCCAGACATAGTGGCAGGTGCCTGTAATCCCAGCTACTTGGGAGGCTGAGGGAGGAGAATTGCTTGAACCTGGGAGGCAGAGGTTGCAGTGAGTCAAGATCACGCCATTGCGCTCCAACCTGGGTGACAAAAGTGAGACTTCATCTCAAAATAAATAAATAAATAAATAAATAAATAAATAAATAAATAATAATTAAAAAAAAA","GGCCGGGCGCGGTGGCTCAAGCCTGTAATACCAGCACTTTGGGAGGCCGAGGCGGGTGGATCACGAGGTCAAGAGATCGAGACCATCCTGGTCAACATGGTGAAACCCCGTCTCTACTAAAAATACAAACAATTAGCTGGGCATGGTGGCGGGTGCCTGTAATCCCAGCTACTCCAGAGGCTGAGGCAGGAGAATTGCCTGAACCCAGGAGACGGAGGTTGCGGTGAGCCAAGATCGCGCCATTGCACTCCAGCCTGGGTGACAAGAGCGAAACTCCGTCTCAATAAATAAATAAATAAATAAATAAATAAAAATAAAATAAATAAATAAATAAATAA"
"chr17","67747489","67748097","JH378118","18053084","18053501","256","49694405","GCTGGGTGTGGTGGCTCACGCCTATAATCCCAGCACTTTGGGAGGCCAAGGCAGGTGGATCACCTGAGGTCAGGAGTTTGAGACCAGCCTGGCCAACATGATGAAACCCCGTCTCTACTAAAAATACAAAGAATTAGGCTGGGCGCGGTGGCTCACGCCTGTAATCCCAGCACTTTGGGAGGCCGAGGCGGGTGGATCACGAGGTCAGGAGATCGAGACCATCCTGGCTAACACGGTGAAACCCCGTCTCTAATAAAAATAAAAAAAAATTAGCTGGGCGTGGTGGTTGGCGCCTGTAGTCCCAGCTACTCGGGAGGCTGAGGCAGGGGAATGGCGTGAACCCGGGAGGTGGAGCTTGTAGTGAGCCGAGATCACGCCACTGCACTCCAGCCTGGGCGACAGAGCAAGACTCCGTCTCAAAAAAAAAAAAAAAAAAAATTAGCCAGGCGTGGTGGCGGGTGCCTGTAATCCCAGCTACTCTGGAGGCTGAGGCAGGAAAATCACTTTAACTCAGGAAACAGAGGTTGCAGTAAGCCGAGATCACGCCATTGTGCTCCATCCTGGGCAACAAGAGCGAAACTCCGACTCGGAAAAAAAGAAAAAAAAAAA","GGCTGGGCGCAGTGGCTCACACCTGTAATCCCAGCACTTAGGGAAGCTGAGGCGAGTAGATCACCTGAGGTCAGGAGTTAGAGACCAGCCTGGCCATCATGGTGAAACCCCGTCTCTACTAAAGATACCAAAAATTAGCTGAGTGTGGTGCTGGGTGCCTGTAATCCCAGAAACTCAGGGTGCCTGTAATCCCAGCAACTCAGGGTGCCTTTAATCCCAGCAACTGAGGGTACCAGTAATCCCAGCAACTCAGGGTGTCTTTAATCCTAGCAACTGAGGGCACCTGTAATCCCAGCAACTCAGGAAGCTGAGACAGGAGAAGTACTTGAACCCAGAAGGCAGAGGTTGCAGTGAGCCGATATTGCACCATTGCACTCCAGTCTGGGCAACAAGAGTGAAACTCTGTCTCAAAAAAAAA"
"chr17","71197353","71197681","JH378262","266823","267148","47","70930530","GACCGGACACAGTGGCTCACGTCTGTAATCCCAGCACTTTGGGAGGCTGAGGCGGGTGGATCACCTGAGGTCAGGAGTTCAAAACCAGCCTGGCCAATATGGTGAAAACCCGTCTATACTAAAAATAAAAAATTAGCCAGGCTTGGTGGCAGGCACCTGTAATCCTAGGTACTCTGGAGGCTTAGACAGGAGAATCACTTGAACCCGAGAAGTGGAGGTTGCAGTGAGCCAAGATCGTGCCATTGCACTCCAGCCTGGGCGACAAGAGTGAGACTCCATCTCAAAAACAAACAAACAAACAAACAAAAAACAAATGAACAAAAAAAAAA","GGCCGGGCGCGGTGGCTCAAGCCTGTAATCCCAGCACTTTGGGAGGCCGAGGCGGGTAGATCATGAGGTCAGGAGTTTGAGACCAGCCTGGCCAACATGGTGAAACCCCGTCTCTACTAAAAATACAAAAATTAGCCGGGCATGGTGGCCTGTGCCTGTAATCCTAGCTACCCAGGAAGCTGAGGCAGGAGAATTGCCTGAACCCAGGAGGCGGAGGTTGCGGTGAGCCGAGATCGTGCCATTGCACTCCAGCCTGGGTAACAAGAGCGAAACTCCGTCTCAAAAACAAACAAACAAACAAACAAAAACAAAAAACAAAAAACAAA"
"chr17","72892082","72892699","JH378118","18053084","18053501","266","54838998","GGCCAGGTGCAGTGGTTCACACCTATAATCCCAGCACTCTAGGAGGCCAAAGTGGGCAGATCACCTGAGGTCAGAAGTTCGAGACCAGCCTGGCCAACATGGTGAAACCATCTCTACTAAAAACACAAAAATTAGGCTGGGCACGGTGGCTCACACCTGTAATCCCAGCACTTTGGGAGGCCGAGGTGGGTGGATCACGAAGTCAGGAGATCAAGACCATCCTGGCTAACACGGTGAAACCCCGTCTCTACTAAAAATACAAAAAATTAGCCAGGCGTGGTGGCGGGCGCCTATAGTCCCAGCTACTTGGGAGGCTGAGGCAGGAGAATGGCGTGAACCCAGGAGGCGGAGCTTGCAGTGAGCCAAGATTGCGCCACTGCACTCCAGCCTGGGTGAGAGAGCTAGACTCTGTCTCAAAAAAAAAAAAAAAAAAAACACAAAAATTAGCCGGGCTTGGTGGCAGGTGCCCGTAATCCCAGCTACTCAGGACGCTGGGACAGGAGAATCTCATGAACCCTGGAGGTGGAGGTTGTAGTGAGCCAAGATCTCACCATCGCACTCCAGCCAGGGTGACAAGAGTGAAACTCTGTCTTAAAAAGATAAATAAATAAAATAAAA","GGCTGGGCGCAGTGGCTCACACCTGTAATCCCAGCACTTAGGGAAGCTGAGGCGAGTAGATCACCTGAGGTCAGGAGTTAGAGACCAGCCTGGCCATCATGGTGAAACCCCGTCTCTACTAAAGATACCAAAAATTAGCTGAGTGTGGTGCTGGGTGCCTGTAATCCCAGAAACTCAGGGTGCCTGTAATCCCAGCAACTCAGGGTGCCTTTAATCCCAGCAACTGAGGGTACCAGTAATCCCAGCAACTCAGGGTGTCTTTAATCCTAGCAACTGAGGGCACCTGTAATCCCAGCAACTCAGGAAGCTGAGACAGGAGAAGTACTTGAACCCAGAAGGCAGAGGTTGCAGTGAGCCGATATTGCACCATTGCACTCCAGTCTGGGCAACAAGAGTGAAACTCTGTCTCAAAAAAAAA"
"chr17","74365360","74365846","JH378118","18053084","18053501","163","56312276","TATAAAAAATCAGCTAGGCTTGGTGGCTTGTGCCTGTAATCCCAGCACTTTGGGAGGCTGAGGCAGGTGGATCACCTGACGTAGGTGTTTAAGACCAGATTGACTAACATGTTGAAACCCCGTCTCTACTAAAAATACAAAAATTATCTGGGCTTGGTGGTGCATGCCTGTAATCCCAGCTGCTCAGGAGGCTGAGACAGGAGAATCGCCTGAACCTGGGAAACGGAAGTTGCAGTGAGTGGAGGTTGCAGTGAGCCGAGATTGCACCACTGCACTCCAGTCTGGGCAACGGAAAAAGACTGTCTCAAAAAAAAAAAAAAAATTAGCTGGGTGTGGTGGTTGGCGCCTGTAATTCCAGCTACTCAGGAGGCTGAGGCAGGAGAATCACTTGAACTCAAGAGGCAGAGGTTGCAATGAGCCAAGATTGCGCCATTGTACTCCAGCCTGGGCCACAAGATTGAAACTTCATCTTGGGGAAAGAAAACAA","GGCTGGGCGCAGTGGCTCACACCTGTAATCCCAGCACTTAGGGAAGCTGAGGCGAGTAGATCACCTGAGGTCAGGAGTTAGAGACCAGCCTGGCCATCATGGTGAAACCCCGTCTCTACTAAAGATACCAAAAATTAGCTGAGTGTGGTGCTGGGTGCCTGTAATCCCAGAAACTCAGGGTGCCTGTAATCCCAGCAACTCAGGGTGCCTTTAATCCCAGCAACTGAGGGTACCAGTAATCCCAGCAACTCAGGGTGTCTTTAATCCTAGCAACTGAGGGCACCTGTAATCCCAGCAACTCAGGAAGCTGAGACAGGAGAAGTACTTGAACCCAGAAGGCAGAGGTTGCAGTGAGCCGATATTGCACCATTGCACTCCAGTCTGGGCAACAAGAGTGAAACTCTGTCTCAAAAAAAAA"
"chr17","74566963","74567566","JH378119","32351107","32351490","260","42215856","GCCGGGCATGGTGTATCACGCCTGTAATCCCAGCACTTTGGGAGGCAGAGGTAGGCAGATCACCTGAGGTCAGGAGTTCAAAACCAGCCTAGCCAACATGGTGAAACCCCGTCTCTACTAAAAATACAAAAAATTAGTGGCCAGGCACGGCAGCTCACGCCTGTAATTCCAGCACTTTGGGAGGCCGAGGCGGGCAGATCACGAGGTCAGAAGATTGAGACCATCCTGGCTAACACGGTGGAACCCCATCTCTACTAAAAATACAAAAAATTAGCTGGGCATGGTGGCTGGTGCCTGTAGTCCCAGCTACTCGGGAGGCTGAGGCAGGAGACTGGCATGAACCCGGGAGGCGGAGCTTGCAGCAAGCCAAGATCGTGCCACTGCACTCCACTCCATCCTGGGCGACAGAGCAAGACTCCGCTTCAAAAAAAAAAAAATTAACCGGGCAAGGTGGCAGGTGCCTGTAATCCCAGCTACTTGGGAGGCTGAGGCAGGAGAATTGCTTGCAGAGGTTGAAGTGAGCCGAGATTACGCCATTGCACTCCAGCCCAAGTGACAAGAGTGAAACTCCATCTCAAAAAAAAAAAAAAAAAAAAGAAAAAAA","GGCCAGGTATGGTGGCTCACACCTGTAATCCCAGCACTTTGGGAGGCCAAGGCAGGCAGACCACCTGAGGTCAGGAGTTCGAGATCAGCCTAGCCAACATGGTGAAACCCCATCTCTAGTAAAAATAAAATTAGCCAGGCATGGTGGTGCATGCCTGTAACGCAGGTCAGGAGTTCGAGATCAGCTTAGCCAACATGGTGAAACCCCATCTCTAGTAAAAATAAAATTAGCCAGGCAGGTGGTGCCGCCTGTACTCGGGAGGCTGAGGCAGGAGAATCACTTGAACCCAAGAGGCAGAGGTTGCAGTCAGCCAAGATCATGCCATTGCACTCCAGCCTAAGCAAAAAGAGTAAAACTCAGTCTCAAAACAAAAAAACAAAAAAA"
"chr17","75365782","75366409","JH378153","2355361","2355755","282","73010421","CCAGGCGTGGTGGCTCATGCCGGTAATCCCAGCACTTTGGGAGGCCAAGGCAGGTGGATCATCTGAGGTCAGGAGTTCGAGACCAGCCTGACCAACATGGTGAAACCTCACCTCTACTAAAAATACAAAAACTAGACAGGCGTGGTGGCGGGTGCCTGTAGTCCCAGCTACTTGGGAGGCTGAGGCAGAAAAATCGCTTGAACCCAGTAGGCAGAGGTTGCAGTGAGCCGAGATCACACCATTGCACTCCAGCCTGGGCAAAAAAGAGCGAAACTCCATCTCAGAAGAAAAGACCGGGTGCAGTGGCTCATGCTTGTAACCCCAGCACTTTGGGAGGCCAAGGCGGGTGGATCACGAGGTCAGAAGATCGAGACCATCCTGGCTAACACGGTGAAACCCCGTCTCTACTAAAAATACAAAAAAAAAAAAATAATTAGCCGAGTGTGGTGGCGGATGCCTGTAGTCCCAGCTACTCGGGAGGCTGAGGCAGGAGAATGGCGTGAACCCAGGAGGCGTAGCTTGCAGTGAGCCGAGATCACGCCACTGCACTCCAGCCTGGGCGACAGAGCAAGACTCGTCTTAAAAAAAAAAAAAAAAAGAAAAAGTAAAAGAAAAGAAAAAGCAACAA","GGCGGGGCATGGTGGCTCACACCTGTCATCCCAACACTTTGGGAGGCTGAGGCAGGCAGATCACCTGAGGTCAGGAGTTTGAGACCAGCCTGGCCAACATGGTGAAACCCCATCTCTACTAAAAATACAAAAATACAAAAAACCCCATCTCTACTAAAAATACAAAAAGCTTGTCTCTATTAAAAATACAAAAAACAAAAAACAAACAAAAAAAAAACCACCATGGTGGTGGGTGCCTATAATCCCAGCTACTCGGGAGGCTGAGGCAGGAGAATCGCTTGAACCCAGGAGGCAGAGGTTGCAGTGAGCCAAGATCCCACCATTGCACTCCAGCCTGGGCAACAGAGAGAGAGACTCTGCCTCAGAAAAAAGAAAGAAAGAAAGAAAGAAAGAAA"
"chr18","19875","20142","JH378153","8929988","8930242","54","8910113","TTGGGAGGCTGAGGTGGGTGGATCATCTGAGGTCAGGAGTTAAGACCAGCCTGGCCAACATGGTGAAACCCCATCTCTACTAAAAATACAAAAACAAAACAAAACAAAACAAAAAAAACCAGCATGGTGGCAGACACCTGTAATCCCAGCTACTCGGGAGACTGAGGCAGGAGAATCACTTGAACCTGGGAGGCGGAGGTTACAGTGAGCCAAGATCTTGTCATGTCACTCCAGCCCAGGCAACAAGAGCAAAACTGTCTTAAAAAAA","TTTGAGAGGCTGAGGTGGGTGGATCACCTAGGTCAGGAGTTTGAGACCAGCCTGACCAACATGGTGAAACCTCATCTCTACTAAAAATAAAAATAAAAAACTAGCCAGGTGCAATGGTGCATGCCTGTAATCCCAGCTACTTGGGAGGCTGAGATGGGAGACTCACTTGAACCTGGGAGGTGGAGGTTGCAGTGAGCCAAGATCATACCATTGCACTCCAGCCTGGGCAACAAGAGTGAAACCTCTTCTCAAAAA"
"chr18","4520498","4521101","JH378118","18053084","18053501","246","13532586","GGCTGGGCGCAGTGGCCCACCCCTGTAATCCCAGCACTTTGGGAGGCCGAGGCGGGTAGATCACCTGACGTCAGGAGTTCAAGACCAGCCTGGCCAACATGGTGAAACCCTGTCTCTACTAAAATACAAAAATTAGGCTGGGCGCAGTGGCTCAAGCCTGTAATCCAGCACTTTGGGAGGCCAAGGCGGGCAGATCACCTGAGGTCAGGAGTTCGAGACTAGCCTGGCCAACCTGGCAAAACCCCATCTCTACTAAAAGTACGAAAATTAGCCAGGGTGATGGTGTGCACCTGTAATCCTAGGTACTCAGGAGGCTGAGGGCAAGAGAATCGCTTGAACCTGGGAGGCAGAGGTTGTAGTGGGCCAAGATCGCGCCATTGCACTGCAGCCTCGGTGACAGAGAAAGACTCCGTCTCAAAAAAAAAAAAAAACAAAAATTAGCTGGGCGTGGTGGTGGGCGTCTGTAGTCCCATCTACACGGGAGGCTGAGGCAGAAGAATCACTTAAACCCAGGATGTGGAGGTTGCAGTGAGCTGAGATCACGCCATTGCACTCCAGACTGGGTAACAAGAGCAAAACTCCATCTCAAATAAATAAAATAAAA","GGCTGGGCGCAGTGGCTCACACCTGTAATCCCAGCACTTAGGGAAGCTGAGGCGAGTAGATCACCTGAGGTCAGGAGTTAGAGACCAGCCTGGCCATCATGGTGAAACCCCGTCTCTACTAAAGATACCAAAAATTAGCTGAGTGTGGTGCTGGGTGCCTGTAATCCCAGAAACTCAGGGTGCCTGTAATCCCAGCAACTCAGGGTGCCTTTAATCCCAGCAACTGAGGGTACCAGTAATCCCAGCAACTCAGGGTGTCTTTAATCCTAGCAACTGAGGGCACCTGTAATCCCAGCAACTCAGGAAGCTGAGACAGGAGAAGTACTTGAACCCAGAAGGCAGAGGTTGCAGTGAGCCGATATTGCACCATTGCACTCCAGTCTGGGCAACAAGAGTGAAACTCTGTCTCAAAAAAAAA"
"chr18","8281535","8282152","JH378118","18053084","18053501","271","9771549","GGCCAGGTGCGATAGCTCACACTGGTAATCCCAACACTTTGGGAGGCCGAGGTGGGCGGATCACCTGAGGCCAGGAGTTTGAGACCAGCCTGGCCAACACAGTGAAACCCCATCTCTACTAAAAATACAAAATTAGGCAGGGTGCAGTGGCTCACGCCTGTAATACCAGCACTTTGGGAGGCCGAGACAGGCGGATTACGAGGTCAGGAGATCGAGACCATCCTAGCTAACACAGTGAAACCCCGTCTCTACTAAAAAAAAAAAAAAAAAAAAAAGTACAAAAAAATTAGCCAGGCGTGGCGGCAGGTGCCTGTAGTCCCAGCTACTCAGGAGACTGAGGCAGGAGAATGGCGTGAACCCGGGAGGCGGAGCTTGCAGTGAACTGAGATCACACCACTGCACTCCAGCCTGGGCAACAGAGTGAGACTCCGTCTCAAAAACAAAACAAAATTAGCCGGGCATGGTGGTGGATGCCCGTAATCCCAGCTACTCGGGAGGCTGAGGCCGCCAAGGCAGGAGAATCTCTTGAATGTGGGAGGCAAAGGCTGCAGTGAGCTGAGATCATGCCATTGCACTGTAGCCTGGGCGACAAAAGTGAGACTCCGTCTCAAAAAAAAA","GGCTGGGCGCAGTGGCTCACACCTGTAATCCCAGCACTTAGGGAAGCTGAGGCGAGTAGATCACCTGAGGTCAGGAGTTAGAGACCAGCCTGGCCATCATGGTGAAACCCCGTCTCTACTAAAGATACCAAAAATTAGCTGAGTGTGGTGCTGGGTGCCTGTAATCCCAGAAACTCAGGGTGCCTGTAATCCCAGCAACTCAGGGTGCCTTTAATCCCAGCAACTGAGGGTACCAGTAATCCCAGCAACTCAGGGTGTCTTTAATCCTAGCAACTGAGGGCACCTGTAATCCCAGCAACTCAGGAAGCTGAGACAGGAGAAGTACTTGAACCCAGAAGGCAGAGGTTGCAGTGAGCCGATATTGCACCATTGCACTCCAGTCTGGGCAACAAGAGTGAAACTCTGTCTCAAAAAAAAA"
"chr18","14964693","14965321","JH378118","18053084","18053501","273","3088391","GGCTGGGTGCGGTGGCTCACACCTGTAATCCCAGCACTTTGGGAGGCTGAGGCAGGCGGATCACCTGAGGTCAGGAGTTCAGGACCAGCCTGATCAACATAGCGAAACCCTGTCTCTATTAAAAATATAAAAATTGCTGGGTGCGGTGGCTCACGCCTGTAATCCCAGCACTTTGGGAAGCCGAGGCGGGCGGATCATGAGCTCAGGAGATCGAGACCATCTTGGCTAACATGGTGAAACCCTGTCTCTACTAAAAATACAAAAAAATTAGCCAGGTGTGGTGGCGGGCGCCTGTAGTCCCAGCTACTCTGGAGGCTGAGGCAGGAGAATCACTTGAACCTGGGAGGCGGAGGTTGCGGTGAGCCAAGATGGTGCCATTGCACTCCAGCCTGGGCAACAAGAGTGAAACTCCATCTCAAAAAAAAAGAAAAAAAAAAAAAAAAACAACCCACAAAAATTAGCCAGGTGTGATGGCGGGTGTCTGTAATCCCAGCTACTTGGGAGACTGAGGCAGGAGAATGGCTTGAACCCGGGAGGTGGAGGTTGCAGTAAGCCGAGATTGCGCCACTGCACTCCAGCCTGGGTGACCAGAGTGAAACTTCATCTCAAAAAAAAAAAAAAAAAAAAAA","GGCTGGGCGCAGTGGCTCACACCTGTAATCCCAGCACTTAGGGAAGCTGAGGCGAGTAGATCACCTGAGGTCAGGAGTTAGAGACCAGCCTGGCCATCATGGTGAAACCCCGTCTCTACTAAAGATACCAAAAATTAGCTGAGTGTGGTGCTGGGTGCCTGTAATCCCAGAAACTCAGGGTGCCTGTAATCCCAGCAACTCAGGGTGCCTTTAATCCCAGCAACTGAGGGTACCAGTAATCCCAGCAACTCAGGGTGTCTTTAATCCTAGCAACTGAGGGCACCTGTAATCCCAGCAACTCAGGAAGCTGAGACAGGAGAAGTACTTGAACCCAGAAGGCAGAGGTTGCAGTGAGCCGATATTGCACCATTGCACTCCAGTCTGGGCAACAAGAGTGAAACTCTGTCTCAAAAAAAAA"
"chr18","15291276","15291680","JH378105","31074364","31074738","116","15783088","CTCGTGCCTGTAATCCTAGCACTTTGGGAGGCCAAGGTGGGCAGATCATCTGAGGTCAGGAGTTCGAGACCAGCCTGGCCAACATAGAGAAATCCCATCTCTACTAAAAATACAAAAATTGACGAGTTAATGGGTGCAGCACACGAACATGGCACATGTATACATATGTAACAAACCTGCACGTTGTGCACATGTACCCTAAAACTTAAAGTATATTTAAAAAAAATACAAAAATTAGCCGGGCATGGTAGCAGGCACCTGTAATCCCAGCTACTCGGGAGGCTGAGGCAGGAGAATCACTTGAACCTGGGAGGCAGAGGTTGCAGTGAGCTAAGATCATTCCATTGTACTCCAACCTGGGCAACAAGAGTGAAATTCCGTCTAATAAAAAATGAAATAAATAAA","GGCCGGGCACAGTGGCTCACACCTGTAAACCCAGCACTTTGGGAGAATGAGGTGGGCAGATGACTTCAGGTCAGGAGTTCGAGACCAGCCTGGCCAACACTGTGAAATCCCATCTCTACTAAAAATACAAAAATTAGCCATGGTGGTCAGAAGATCAAGACTATCCTGGCCAACATGGTGAAACCTTGTCTCTACTGAAAATAGAAAAATTAGCTGGGTATGGTGGCATGCGCCTGTAGTCCCAGATACTCAGGAGGCTGGGGCAGGAGAATCACTTGAACCCAGGAGGCAGAGGTTGCAGTGAGCTGAGATCATGCCATTGCACTCTAGATTAGGCAACAAGAGTGAAACTGTCTCAAAAAGAGAGAGAGAAAA"
"chr18","15802064","15802689","JH378153","2355361","2355755","270","13446703","GACCGGGCATGGTGGCTCACACCTGTAATCCCAGCACTTTGGGAGGCGTAGGCGAGTGGCCCCTGAGGTCAGGAGATCGAGACAACCCTGGCCAACATGGTGAAACTCTACTAAAAATACAAAATTAGGCCGGGTGCCGTGGTTCACGCCTATAATCCCAGCACTTTGGGAGGTCAAGGTGGGCAGATCACCTGAGGTCAGGAGTTTGAGACCAGCCTGGCCAACATGGTGAAACCCAGTCTCTACTAAAAATACAAAAATTAGCTGGGCATGGTGGTGGACACTTGTAATCCCAGCTACTTGGGGGGCTGAGGCAGGAGAATCACTTGAACCCAGGAGGCAGAGGTTGCAGTGAGCCTAAATCACCCCATTGCACTCCAGCCTGGGCAACAAGAGTGAAATTCTGTCTCGAAAAAAAAAAAAAAAGAAAAGAAAAGAAAAAAAAATTAGCCAGGTGTGGTGCTGCATGCCTGTAATCCCAGCTACTCAGGAGGCTGAGGCAGGAGAATCGCTTGAACCCGGGAGGCAGAGGTTGCAGTGAGCTGAGACCACACCATTGCACTCCAGCCTGGGCGACAAGAGAGTAACTCCATTTCAAAAAAAAAAAAAAAAAAAAGAAAAAAGAA","GGCGGGGCATGGTGGCTCACACCTGTCATCCCAACACTTTGGGAGGCTGAGGCAGGCAGATCACCTGAGGTCAGGAGTTTGAGACCAGCCTGGCCAACATGGTGAAACCCCATCTCTACTAAAAATACAAAAATACAAAAAACCCCATCTCTACTAAAAATACAAAAAGCTTGTCTCTATTAAAAATACAAAAAACAAAAAACAAACAAAAAAAAAACCACCATGGTGGTGGGTGCCTATAATCCCAGCTACTCGGGAGGCTGAGGCAGGAGAATCGCTTGAACCCAGGAGGCAGAGGTTGCAGTGAGCCAAGATCCCACCATTGCACTCCAGCCTGGGCAACAGAGAGAGAGACTCTGCCTCAGAAAAAAGAAAGAAAGAAAGAAAGAAAGAAA"
"chr18","15849226","15849860","JH378118","18053084","18053501","290","2203858","GGCCAGGCACAGTAGCTTACGCCTATAATCTCAGCACCCTAGGAGGCCGAGGCTGGCAGACCACCTGAGGTCACGAGTTCAAGACTAGCCTGGTCAACATAGCAAAACCCCATCTCTACTAAAAATACAAAAATTAGGCTGGGCACAGTGGCTCATGCTTGTAATCCCAGCACTTTGGGAGGCCAAGTCGGGAGAATCACCTGAGGTTGGGAGTTCGAGATCAGCCTGACCAACATAGAGAAACTCCATCTCTACTAAAAATGCAAAATTAGCTAGGCATGGTGGTGCATGCCTGTAATCCCAGCTACTCGTAAGGCTGAGGCAGGAGTATCGCTTGAATCTGGGAGGTGGAGGTTGCGGTGAGCCAAGATCACGCCATCGTACTCCAGCCTGGGCAACAAGAGCGAAACTCCATCTCAAAACAAAAAAAATGAGCCAGGAGTGGTGGCGGGCGCCTATAATTCCAGCTACTCCAGAGGCTGAGGCAGGAGAATCACTTAAACCCGGGAAGCAGAGGTTGCAGTGAGCTGAGATTGTGCCATTGCACCCCAGCCTAGGTGAAAAGAGCAAAACTCCATCTCAAAAAAAAAAAAAAAAAAAAAAAAAAAGAAAGAAAGAAAGAAAAAGAAAAAAAA","GGCTGGGCGCAGTGGCTCACACCTGTAATCCCAGCACTTAGGGAAGCTGAGGCGAGTAGATCACCTGAGGTCAGGAGTTAGAGACCAGCCTGGCCATCATGGTGAAACCCCGTCTCTACTAAAGATACCAAAAATTAGCTGAGTGTGGTGCTGGGTGCCTGTAATCCCAGAAACTCAGGGTGCCTGTAATCCCAGCAACTCAGGGTGCCTTTAATCCCAGCAACTGAGGGTACCAGTAATCCCAGCAACTCAGGGTGTCTTTAATCCTAGCAACTGAGGGCACCTGTAATCCCAGCAACTCAGGAAGCTGAGACAGGAGAAGTACTTGAACCCAGAAGGCAGAGGTTGCAGTGAGCCGATATTGCACCATTGCACTCCAGTCTGGGCAACAAGAGTGAAACTCTGTCTCAAAAAAAAA"
"chr18","16042035","16042617","JH378118","18053084","18053501","243","2011049","GGCTATGCACGGTGGCTCACGCCTGTAATCCCAGCACTTTGGGAGGCCGAGTCAGGTGGATCACTTGAGGTCAGGAGTTCGAGACCAGCCTGGCCAACATGGTGAAGCCCCATCTCCACTAGAAATACAAAAATTAGTCTGGGAGCAGTGGCTTACACCTGTAATTGCAGCACTTTGGGAGGCCAAGGTGGGTGGATCACCTGAGGTCAGGAGTTTGAGACCAGCATGACCAACATGGTGAAACTCCATCTATACAAAAAAATTAGCCGGGTGTGGTGGCGCATGCCTGTAATCCCAGCTACTCAGGAGACTGAGGCAGGAGAATTGCTTGAACCCGGGAGGCAGAGGTTGCAGTGAGCCAAGTCTGTGCCATTGCACTCCAACCTGGGCAACAAAAGCGAAACTCTGTCTCAAAAATAAACAACAAAAAAAATTAGCCAGGTGTGGTGGCACATGCCTATAATCCCAGCTACTCGGGAGGCTGAGGCAGAAGAATTGCTTGAACCTGGGAGGTGGAGGTTGCAGTGAGCCGAGATCATGCCATTCTACTCCAGCCTGGGCCACAAGAGCGAAACTCTGTCTC","GGCTGGGCGCAGTGGCTCACACCTGTAATCCCAGCACTTAGGGAAGCTGAGGCGAGTAGATCACCTGAGGTCAGGAGTTAGAGACCAGCCTGGCCATCATGGTGAAACCCCGTCTCTACTAAAGATACCAAAAATTAGCTGAGTGTGGTGCTGGGTGCCTGTAATCCCAGAAACTCAGGGTGCCTGTAATCCCAGCAACTCAGGGTGCCTTTAATCCCAGCAACTGAGGGTACCAGTAATCCCAGCAACTCAGGGTGTCTTTAATCCTAGCAACTGAGGGCACCTGTAATCCCAGCAACTCAGGAAGCTGAGACAGGAGAAGTACTTGAACCCAGAAGGCAGAGGTTGCAGTGAGCCGATATTGCACCATTGCACTCCAGTCTGGGCAACAAGAGTGAAACTCTGTCTCAAAAAAAAA"
"chr18","25849088","25849351","JH378114","20445944","20446195","60","5403144","GGGAAGATGAGGCGGGTGGATCACTTGAGGTCAGGAGTTCGAGACCAGCCTGGCCAACATGGTGACACCCTGTCTCCAAAAAATACACACACACACACACACACACACACACACACAAATTAGCTGGGCATGGTGGCGGGCACCTGTAATCCTAGCTACTCGAGAGGCTGCGGCAGGAGAATTGCTTTAACTTGGGAGGTAGAGGTTGCAGAGAGCCGAGATTGCACCATTGTACTCCAGCCTGGGTGACAAGAGCGAAACTCC","TTGGGAGGCCAAGGCGGGTGGATCACCTGAGGTCAGGAGTTCGAGACCAGCCTGGCCAACATGATAAAACCCCCGTATCTAATAAAAATAGGAAAAAAAAATAAATAAATAGCTGGGCGTTGTGGCAGGTGCCTGTAATCCCAGCTACTCGGGAGGCTCAGGCAGGAGAATCGCTTGAACCCAGGAGGCAGAGGTTGCAGTGAGCCAAAATTGTGCCATTGCACTCCCGCCTGGGAAACAAGAGCAAAACTC"
"chr18","38083500","38083832","JH378152","15993594","15993909","55","22089906","GGCTGGGTGCGGTGGCTCACGCCTGTAATCCCAGCACTTTGGGAAGCCAAGTCAGGTGACCTCACCTGAGGTCAGGAGTCCAAGACCAGCCTGACCAACATGGTGAAACCTCGTCTCTACTAAAAAGACAAAAAATTAGCCAGGCATGGTGGTGGGCACCTGTAATCTCAGCTACTCTGGAGGCTGAGGCAGGAGAATCACTTGAACCCTGGAGGGGGAGGTTGCAGTGAACCAAGATTGCACCATTGCAGTCCAGCCTGGGCGACAAGAGCAAAACTCCATCTCACAAACACACACACACACACACACACACACACACACAGAAAAAAAAAA","GGCTGGGTGTGGTGGCTCATGCCGGTAATCCCAGCACTTTGGGAAGCGGAGGCAGGCAGATCACCTGAGGTCAGGAGTTCAAGACCAACCTGGCCAACATGGAGAAACCATGTCTCTACTAAAAATACAAAAAATTAGCCAGGCATGGTGGGTGCCTGTAATCCCCACTACTCGGGAGGCTGAGGCAGGAGAATTTCTTGAACCCAGGAGGTGGAGGTTTCAGTGAAGCGGAGATCACCCCATTGCACTCCAGCCTGGGTGACAAGAGCAAAACTCCATCTCACAAAATCAACAACAACAACTTAAAAAAAAAAAA"
"chr18","44076326","44076933","JH378118","18053084","18053501","257","26023242","GCTGGGCGCGGTGGCTTGCGCCTGTAATCCCAGCCATTTGGGAGGCCGAGGCAGGTGGATCACCTGAGGTTAGGAGTTCAAAACCAGCCTGGCCAACATGGTGAAACCCCGTCTCTACTAAAAATACAAAAATTAGGCCAGGCACAGTGGCTCACGCCTGTCATCCCAGCACTTTGGGAGGCCAAGGCGGGCGGATCATGAGGTCAGGAGATTGAGACCATCCTGGCTAACACAGTGAAACCCTGTCTCTACTAAAAAAATATATAAAAAATTAGCCGGGCTTGGTGGCGGGTGCCCGTAATCCCAGCTACTCGGGAGGCTGAGGCAGGAGAATGGCGTGAACCTGGAAGGCGGAGCTTGCAGTGAGCCGAGATTGCACCACTGCACTCCAGCCTGGGTGACAGAGTGAGACTCTGTCTCAAAAAAAAAAAAAAAACAAAAAACAAAAATTAGTTGGGTGTGGTGGTGGACGCCTGTAATCCCGGCTACTCGGGAGGCTGAGGCAGGAAAATCACTTCAACCCGGGAGGCAGAGGTTGCCGTGAGCCAAGATCGTGCCATTGCACTCCAGCCTGGGTGACAAGAGCAAAACTCTGTCTCAAAAAAAAA","GGCTGGGCGCAGTGGCTCACACCTGTAATCCCAGCACTTAGGGAAGCTGAGGCGAGTAGATCACCTGAGGTCAGGAGTTAGAGACCAGCCTGGCCATCATGGTGAAACCCCGTCTCTACTAAAGATACCAAAAATTAGCTGAGTGTGGTGCTGGGTGCCTGTAATCCCAGAAACTCAGGGTGCCTGTAATCCCAGCAACTCAGGGTGCCTTTAATCCCAGCAACTGAGGGTACCAGTAATCCCAGCAACTCAGGGTGTCTTTAATCCTAGCAACTGAGGGCACCTGTAATCCCAGCAACTCAGGAAGCTGAGACAGGAGAAGTACTTGAACCCAGAAGGCAGAGGTTGCAGTGAGCCGATATTGCACCATTGCACTCCAGTCTGGGCAACAAGAGTGAAACTCTGTCTCAAAAAAAAA"
"chr18","44546829","44547449","JH378118","18053084","18053501","262","26493745","GGCCAGGCACGGTCGCTCACACCTGTAATTCCAGCACTTTGGGAGGCCAAGGCGGATGGGTCACCTGAGGTCAGGAGTTTGAGACCAGCCTGACCAATATGATGAAACCCCATCTCTATTAAAAATACAAAAATTAGGCTGGGCGCAGTGGTTCATGCCTGTAATTCCAACACTTTGGGAGGCCGAGACGGGCGGACCATGAGGTCAGGAGATCGAGACCATCCTGGCCAACGTGGTGAAACCCCGTGTCTACTAAAATACAAAAAAAATTAGCCAGGTGTGGTGGCACGTGCCTGTAGTCCCAGCTATTAGGGAGGCTGAGGCAGGGGAATCACTTGAACCTGGGAGGTGGAGGTTGCAGTGAGCTGAGATCTTGCCACTACACTCCATTCTGGGCAACAGAGCAAGACTCCGTCTGAAAAAAAACAAAAAAATACAAAAATTAGCTGGGCATGGTGGCGGGTACCTGTAATCCCAGCTACTTGGGAGGCTGAGACAGGAGAATCACTTGAACTCGGGAGGCAGAGGTTGCAGTGAGCCAAGATCGCACCATTGCATTCCAGCCTGGGCAACAAGAGCGAAACTCCATCTCAAAAAAACAAAAAAAAAAAAAAAGAAAAA","GGCTGGGCGCAGTGGCTCACACCTGTAATCCCAGCACTTAGGGAAGCTGAGGCGAGTAGATCACCTGAGGTCAGGAGTTAGAGACCAGCCTGGCCATCATGGTGAAACCCCGTCTCTACTAAAGATACCAAAAATTAGCTGAGTGTGGTGCTGGGTGCCTGTAATCCCAGAAACTCAGGGTGCCTGTAATCCCAGCAACTCAGGGTGCCTTTAATCCCAGCAACTGAGGGTACCAGTAATCCCAGCAACTCAGGGTGTCTTTAATCCTAGCAACTGAGGGCACCTGTAATCCCAGCAACTCAGGAAGCTGAGACAGGAGAAGTACTTGAACCCAGAAGGCAGAGGTTGCAGTGAGCCGATATTGCACCATTGCACTCCAGTCTGGGCAACAAGAGTGAAACTCTGTCTCAAAAAAAAA"
"chr18","45772849","45773450","JH378118","18053084","18053501","269","27719765","CACGCCTATAATCCCAGCACTTTAGGAGGCTGAGGCAGGTGGATCACCTGAGATCAGGAGTTCAAAACCAGCCTGGCCAACATGGTGAAACCCTGTGTCTACTACAAATACAAAAAAATGGGCAGGGTGTGGTGGCTCACACCTGTAATCCCAGCACTTAGGGAGGCCGAGGCGGGTGGATCATGAGGTCAAGAGATCAAGACCATCCTGGCCAACATGGTAAAACCCCGCCTCTACTAAAAATATAAAAATTAGCTGGGCAAGGTGGTGCGCGCCTGTAGTCCCAGCTATTTGGGAGGCTGAGGCAGGAGAATTGCTTGAACCTGGGAGGTGGAGGTTGCAGTGAGCCAAAATCGCGCCACTGCACTCCAGCCTGGCAACAGAGTGAGACTCTGTCTCAAAAAAAAACAAAAACAAAACAAAACAGAAACCAAAATTAGCTGGGCGTGGTGGCGGGCGCCTGTAGTCCCAGCTACTTGGGAGGCTGAGGCAGGAGAATCGCATGAACCCAGGAGGCGGAGGTTGCAGTGAGCCAAGACTGCACTATTGCACTCCAGTCTGGGCTACAAGAGCGAACTCCGTCTCAAAAAAAAAAAAAAAAA","GGCTGGGCGCAGTGGCTCACACCTGTAATCCCAGCACTTAGGGAAGCTGAGGCGAGTAGATCACCTGAGGTCAGGAGTTAGAGACCAGCCTGGCCATCATGGTGAAACCCCGTCTCTACTAAAGATACCAAAAATTAGCTGAGTGTGGTGCTGGGTGCCTGTAATCCCAGAAACTCAGGGTGCCTGTAATCCCAGCAACTCAGGGTGCCTTTAATCCCAGCAACTGAGGGTACCAGTAATCCCAGCAACTCAGGGTGTCTTTAATCCTAGCAACTGAGGGCACCTGTAATCCCAGCAACTCAGGAAGCTGAGACAGGAGAAGTACTTGAACCCAGAAGGCAGAGGTTGCAGTGAGCCGATATTGCACCATTGCACTCCAGTCTGGGCAACAAGAGTGAAACTCTGTCTCAAAAAAAAA"
"chr18","50079974","50080314","JH378127","6796468","6796795","54","43283506","GGTCTGGCGCCAGTGGCTCATGCCTGTAATCCCAGCACTTTGGGAGGCTGAGGCGGGTGTATCACCTGAGGTCAGGAGTTCGAGACCAGCCTGGCCAACATGGCAAAACCCCGTCTCTACGAAAAATACAAAAAAATTAGCCGGGCGTGGTAGCAGTCGCCTGTAATCCCAGCAACTTGGGAAGCTGAGGCAGAAGAATCGCTTAAACCTAGGAGGCGGAGGTTGCAGTGAGCCAAGATTGCGCCATTGCACTCCAGCCTGGTCAACAAGAGCAAAACTCTGTCTCAAAACAACAACAACAACAACAACAACAACAAACAAAAACCAAAAAAACCAAAAAA","GGCCGGGCGCGGTGGCTCAAGCCTGTAATCCCAGCATTTTGGGAGGCCGAGGCGGGTGGATCACGAGGTCAGGAAATCGAGACCATCCTGGTCAACATGGCGAAACCCCATGTCTACTAAAAATACAAAAATTAGCTGGGCATGGTGGCACGTGCCTGTAATCCCAGCTACTCAGGAGGCTGAGGCAGGAGAATTGCCTGAACCCAGGAGGCGGAGCTTGCAGTGAGCCGAGATCGCGCCATTGCACTCCAGCCTGGGTAACAAGAGCGAAACTCCGTCTCAAAAAAACAAACAAAAACAAAACAAAACAAAACAAAACAAAAAAAAC"
"chr18","53653883","53654201","AGCE01149660","956","1264","46","53652927","GGCCAGGCATGGTGGCTCACGTTTGTAATCCTAGCACTTTGGGAGGCTGTAGCGGGCGGATCACCTGAGGTCAGGAGTTTGAGACCAGCCTGGCCAACATGGTGAAACCCTGTCTCTACTAAAAAAAAAAAAAAAAAAAAAAAAAAAATTAGCCAGGTGTGGTGGTGGTGGATGCCTATAATCCCAGCTACTCGGGAGGCTGAGGCAGGAGAATCACTTGAACCTGGGAAGCAGAGGTTGCAATGAGCTGAGATTGAGCCATTGCACTCCAGCCTGGACAACAAGAATGAGACTCTGTCTCAATAAATAAGTAAATAAA","GGCCAGGCACGGTGGCTCATGCCTATAATCCCAGCACTTTGGGAGGCTGCGATGGGTGGTTCACTTGAGGTCTGGAGTTTGAGACCAGCCTGGCCAACATGGAGAAACCCTTTCTCTACTAAAAATACAAAAAAAAAAAAAAAAAAAATTAGCCAGGCATGGTGGCGGGTGCCTGTAATCCCAGCTACTCAGCAGGCTGAGGGAAGAGAATCACTTGAACCGGGGAGGCAGAGGTTGCAGTGAGCTGAGATGATGCCATTGCACTCCAGCCTGGGCAACAAGAGCAAAACTGTCTCAAAAAAAAAAAAA"
"chr18","53971096","53971710","JH378118","18053084","18053501","262","35918012","GGTCGGGTGTGGTGGCTCATGCCTATAATCCCAGCACTTTGGGAGGCTGAGGCAGGCAGATTACCTGAGGTCAGGAGTTCGAGACCAGCCTGGCCAACATGATGAAACCTTGTCTCTACTAAAAATACAAAAATTAGGCCGGGCACGGTGGCTCATGCCTGTAATCCCAGCACTTTGGGAGGCCGAGGCGGGTAGATCACAAGGTCAGAAGTTCAAGACCAGCCTGGCCAACATGGTGAAACTCTGTCTTTACTAAAAATACAAAAATTAGCTAGGCATGGTGGCGCACACCTATAATCCCAGCTACTGGGGAGGCTGAGGCAGGAGAATTGCTTGAACCAGGACCCGGGAGGTGGAGGTTGCTGTGAGCCGAGATTGCGCCACTGCACTCCAGCCTGGGAGACAGAGTGAGACTCCGTCTAAAAAAAAAAAAAAAAAATTAGCCAGGTGTGGTGGCGCATGCCTGTAATCCCAGCTACTCGGGAGGCTGACGCAGAAGAATCATTTGAACGTGGGAGGCAGAGGTTACAATGAGCTGAGATCACACCATTGTACTCCAGCCTGGGCAACAAGAGCAAACTCAATCTCAAAAAAATAAAAATAAAAAAAAAGAAA","GGCTGGGCGCAGTGGCTCACACCTGTAATCCCAGCACTTAGGGAAGCTGAGGCGAGTAGATCACCTGAGGTCAGGAGTTAGAGACCAGCCTGGCCATCATGGTGAAACCCCGTCTCTACTAAAGATACCAAAAATTAGCTGAGTGTGGTGCTGGGTGCCTGTAATCCCAGAAACTCAGGGTGCCTGTAATCCCAGCAACTCAGGGTGCCTTTAATCCCAGCAACTGAGGGTACCAGTAATCCCAGCAACTCAGGGTGTCTTTAATCCTAGCAACTGAGGGCACCTGTAATCCCAGCAACTCAGGAAGCTGAGACAGGAGAAGTACTTGAACCCAGAAGGCAGAGGTTGCAGTGAGCCGATATTGCACCATTGCACTCCAGTCTGGGCAACAAGAGTGAAACTCTGTCTCAAAAAAAAA"
"chr18","57837437","57837748","JH378115","16887097","16887400","43","40950340","GCTGGGCATGGTGGCTCACACCTGTAATCCCAGCACCTTGGGAGGCCGAGGTGGGTAGATCACCTGAGGTCAGGAATTCGAGACCAACCTGGCCAACATGGTGAAACCCCGTCTCTACTAAAAATACAAAAAAAAAAAAAAAAAAAAAAAAAGCTGGGCATGGTGGTGGGTACCTGTAATCCCAGCTACTCAGGAGTCCGAGGCAGGAGAATCGCTTGAACCTGGCAGGTGGAGGTTGCAGTGTGCCAGGATTGTGCCATTGCACTCCAGCCTGGGTGACAAGAGCAAAACTCCAACTCAAAACAAAAACAA","GCCGGGCACGGTGGCTCAAGCCTGTAATCCCAGCACTTTGGGAGGCCGAGGCGGGTGGATCACAAGGTCAAGAGATCGAGACCAACCTGGTCAACATGGTGAAACCCCATCTCTACTAAAAAATACAAAAAAAAAAAAAAAATTAGCTGGGCATGGTGGCGCGTGCCTATAATCCCAGCTACTCAGGAGGCTGAGGCAGGAGAATTGCCTGAACCTAGGAGGTGGAGGTTGCAGTGAGCCAAGATCATGCCATTGCACTCCAGCCTGGGTAACAAGAGCGAAACTCCATCTCAAAAAAAAAAAA"
"chr18","58257354","58257943","JH378118","18053084","18053501","263","40204270","GCCTGTAATCACAGCACTTAGGGGGGCCGAGGCAGGAGGATCACCTGAGGTCAGGAGTTCGAGACCAGCCTGGCCAACATGGTGAAACCCCGTCCCTACTAAAAATACAAAAATTGGCCGGACACATTGGCTCATGCCTGTAATCCCAGCACTTTGGGAGGCCGAGGCGGGTGGATCACCTGAGGTCAGGAGTTCAAGACCAGCCTGACCAACCTGGAGAAACCCTGTTTCTACTAAAAATACAAAATTAGCCAGGCATAGTGGCGCATGCCTGTAATCCCAGCTACTCGAGAGGCTGAGGCAGGAGAATCGCTTGAACCCGGAAGGTGGAGGTTGCGGTGAACCGAGATTGTGCCATTGCACTCCAGCCTGGGCAACAAGAGCAAAACTCCGTCTCAAAAACAAAACAAAACAAAACAAAAATTAACCCGGCGTGGAGGTGGATGCCTGTAATCCCAGCCACTTTGGGAGACTGAGGCAAGAGAATTGCTTGAACCCGGGATGTGGAGGCTGCAGTGACCCGAGATCACGCCATTGCATTCCAGCCTGGCAACAAGAGTAAGACTCCATCTCAAAAACAAGCAAACAAA","GGCTGGGCGCAGTGGCTCACACCTGTAATCCCAGCACTTAGGGAAGCTGAGGCGAGTAGATCACCTGAGGTCAGGAGTTAGAGACCAGCCTGGCCATCATGGTGAAACCCCGTCTCTACTAAAGATACCAAAAATTAGCTGAGTGTGGTGCTGGGTGCCTGTAATCCCAGAAACTCAGGGTGCCTGTAATCCCAGCAACTCAGGGTGCCTTTAATCCCAGCAACTGAGGGTACCAGTAATCCCAGCAACTCAGGGTGTCTTTAATCCTAGCAACTGAGGGCACCTGTAATCCCAGCAACTCAGGAAGCTGAGACAGGAGAAGTACTTGAACCCAGAAGGCAGAGGTTGCAGTGAGCCGATATTGCACCATTGCACTCCAGTCTGGGCAACAAGAGTGAAACTCTGTCTCAAAAAAAAA"
"chr18","59255477","59255805","JH378228","5665092","5665424","52","53590385","GGTTGGGCGCAGTGGCTCACGCCTGTAACCCCAGCACTTTCGGAAGCTGAGGCAGGCGGATCACCTGAGGTCAGGGGTTCGAGACCAGCCCGGACAACGTGATTAAACCCTGCCTCTACTAAAAATACAAAAATTAGCGACTGTGGTGTTGGGCGCCTGTAATCGCAGCTACTTGGGAGGCTGAGGCATGAGAATTGCTTGAACCCAGGAGGCAGAGGTTGCAGTGAGCAGAGATTGCTCCATTGCACTCCAGCCTGGGCAACAAGAGCAGAACTCTGTCTCAAAATAAATAAATAAATAAATAAATAAATAAATAACAGAAAAGAAAA","GGCCGGGCGCGGTGGCTCAAGCCTGTAATCCCAGCACTTTGGGAGGCTGAGGCGGGTGGATCACGAGGTCAAGAGATCGAGACCATCCTGGTCAACATGGTGAAACCCTGTCTCTACTAAAAATACTAAAAATTAGCTGGGCATGGTGGCGTGTGCCTGTAATCCCAGCTACTCAGGAGGCTGAGGCAGGAGAATTGCCTGAACCCAGGAGGCGGAGGTTGCGGTGAGCCGAGATCGCGCCATTGCACTCCAGCCTGGGCAACAAGAGCGAAACTCTGTCTCAAAAAAAAAAAATAAATAAATAAAATAAAATAAAATAAAATAAAATAAAAT"
"chr18","59405673","59406877","JH378118","18053084","18053501","805","41352589","GGCTAGATGCGGTGGCTCATGCCTGTAATCCCAGCACTTTGGGAGGCCAAGGCAGGTGGATCACCTGAGGTCAGGAGTTTGACACCAGCCTGGCCAACATGTTGAAACCCTGTCTCCACTAAAAATACAAAAAAAGATTATCTGGGTTATTGTGGGATCTGGCCAGCAGCCCGCAATGCAATGGGGCTCTCTCTTTGTTCCCAGGCAGATTGGCAGGTTGAGAAATAATAGACACACACAAGATAGTGAAAGTTGGGTCCAGGGGGGTCACCGCCTTCTGGTCCCATGGTGCCAACAATGCACTGGATATACCAGCATTTATTATTAAGTTTAGTGAGGGCGGGGGTAGGTTAGTGAGGGATTTAGGGTCATTTGATTATGAGGTGAGATGGTCACATGGAAATGAAGTAATTCTTTAACGTAACATTTGTATGTAGAAGTACAGTACATTTGTATGTAGAAGTACAGTATACAGAGATAAGAATTTACAATATAGTGTGTGCATCAGTAATTTCTAACAGAGCCTTAAAACAGAAAGACAATCTTTCCATAATCTATGATTAGCAAGATATTAATCAGCAGTAACAATTGCAATGAAAGCTGGTTACAAACAGTCCATGGAAACAGGAGGTGAAGCTAGACAATCGGTTAGACCAGAAATTCTCAGAAGGGAATATGCCTTAACCCTAAAGAGGCCTAGAAGAGCCGTGGCAAGATGAGGGTGTTTATAGCCCTATCTTATCCATATGGACAGGCACCTCCCCATGCGTCCGTTTATAGGCTCTCCATGAGGGTCGCATTCCATTCCCAGAGCTATGAACATCTGCTTTTCTGGGATAGGAATCTTGGTGATGTGAAACCTCCCTGACTACACGTCCATTCATAGGATCTCTGCAGGGGGAAGCACATCACACACTGTTGGCTCGTTCTGGCAGTCCAACCTGGCATTGTGTCTTTACACAATCCTGCATGCAATTTTGTATTTACAATAATCAGGAGCATTTCATCTTTTATTCTGTAGCAATAGTTTCAGGGGGTCTCCCTACACTGGGTGTGGTGACGGGTACCTGTAATCCCAGCTACTCAGGAGGCTGAGGCAGGAGAATCACTTGAGCCTTAGAGGCAGAGGTTGCAGTGAGCTGAGATCAGACCATTGCACTCCAGCCTGGGCAACAAGAGCAAACCTCCGTCTCAAAAAAAAAAAA","GGCTGGGCGCAGTGGCTCACACCTGTAATCCCAGCACTTAGGGAAGCTGAGGCGAGTAGATCACCTGAGGTCAGGAGTTAGAGACCAGCCTGGCCATCATGGTGAAACCCCGTCTCTACTAAAGATACCAAAAATTAGCTGAGTGTGGTGCTGGGTGCCTGTAATCCCAGAAACTCAGGGTGCCTGTAATCCCAGCAACTCAGGGTGCCTTTAATCCCAGCAACTGAGGGTACCAGTAATCCCAGCAACTCAGGGTGTCTTTAATCCTAGCAACTGAGGGCACCTGTAATCCCAGCAACTCAGGAAGCTGAGACAGGAGAAGTACTTGAACCCAGAAGGCAGAGGTTGCAGTGAGCCGATATTGCACCATTGCACTCCAGTCTGGGCAACAAGAGTGAAACTCTGTCTCAAAAAAAAA"
"chr18","71500430","71500770","JH378228","5665092","5665424","54","65835338","GCTGGGTGCGGTGGCTCACGCCTGTAATCACAGCACTTTGGTAAGCCCGAGGCAGGTGGATCACCTGAGGTCAGGAGTTCGAGACCAGCCTGACCAACATGGTGAAACCCTTTCTCTACTAAAAATGCAAAAATTAGCTGGGCGTCATGGCGGGCGTCTGTGATCCCAGCTACTAGGGAGGCTAAGGCAGGAGAATTGCTTGAACCTGGGAGGCGGAGGTTGCAGTGAGCAGAGATTGCACCATTACACTCCAGCCTGGGCAACAAGAGCAAAACTCCATCTCAAAATAAATAAATAACTAAATAAATAAATAAAATGAAATTAAAAAGAAAGAAAGAAAA","GGCCGGGCGCGGTGGCTCAAGCCTGTAATCCCAGCACTTTGGGAGGCTGAGGCGGGTGGATCACGAGGTCAAGAGATCGAGACCATCCTGGTCAACATGGTGAAACCCTGTCTCTACTAAAAATACTAAAAATTAGCTGGGCATGGTGGCGTGTGCCTGTAATCCCAGCTACTCAGGAGGCTGAGGCAGGAGAATTGCCTGAACCCAGGAGGCGGAGGTTGCGGTGAGCCGAGATCGCGCCATTGCACTCCAGCCTGGGCAACAAGAGCGAAACTCTGTCTCAAAAAAAAAAAATAAATAAATAAAATAAAATAAAATAAAATAAAATAAAAT"
"chr19","1465612","1466244","JH378118","18053084","18053501","284","16587472","GGCTGGGGACGGTGGCTCAGGCCTGTAACCCCAGCACTTTGAGAGGACCAGGAGGGAGGATTGCTTGAGCCCAGGAGTCCGAGACCAGCCTGGGCAGCAAAGCAAGGCCCTGTCTCTACAAAAATACTTTAAAATTAGCCAAGTGTTGGCTGGGTGCGGTTGCTCATGCCTATAATCCCAGCACTTTGGGAGGCCGAGGTGGGTGGATCACCTGAGGTCAGGAGTTTGAGACCAGCCTGGCCAACATGGCAAAACCCCGTCTCTACTAAAAATACGAAAATTAGCCAGACGTGGTGGCTCATTCCTGTAATCCCAGCTACTCGGGAGGCTGAGGCAGGAGAATCGCTTGAACTCGCAAGGCGGAGGTTGCAGTGAGCCAAGATCATGCCATTGCATTCCAGCCTGGGTGACAGAGCAAAACTCCGTCTCAAAAAAAAAAAAAAAAAAAAAAAATTAGCCAGGCGTGGTGGTGGGCACCTGTAGTCCCAGCTACCCGGGAGGCTGAGGCAGGAGAATCGCTTGAGCCCGGGAGGCAGAGGTTACAGTGAGCCGAGATCGTGCCATTGCACTCCAGCCTGGGCAACAAGAGTGAAAATCCGTCTCAAAAAAATAAATAAATACAAAATAAAAAAA","GGCTGGGCGCAGTGGCTCACACCTGTAATCCCAGCACTTAGGGAAGCTGAGGCGAGTAGATCACCTGAGGTCAGGAGTTAGAGACCAGCCTGGCCATCATGGTGAAACCCCGTCTCTACTAAAGATACCAAAAATTAGCTGAGTGTGGTGCTGGGTGCCTGTAATCCCAGAAACTCAGGGTGCCTGTAATCCCAGCAACTCAGGGTGCCTTTAATCCCAGCAACTGAGGGTACCAGTAATCCCAGCAACTCAGGGTGTCTTTAATCCTAGCAACTGAGGGCACCTGTAATCCCAGCAACTCAGGAAGCTGAGACAGGAGAAGTACTTGAACCCAGAAGGCAGAGGTTGCAGTGAGCCGATATTGCACCATTGCACTCCAGTCTGGGCAACAAGAGTGAAACTCTGTCTCAAAAAAAAA"
"chr19","1761610","1762212","JH378118","18053084","18053501","248","16291474","GGCCGGGTGCGGTGGTTTACACCTGTAATCCTGGCATTTTGGGAGGCCGAGGCAGGAGTATCACCTCAGGTCAGGAGTTCAAGACCAGCCTGGCCAACATGGTGATACTCCGTCTCTACTAAAAATACAAAAATTGGCCGAGTGCAGTGGCTCACACCTGTAATCCCAGCACTTTGGGAGGCCGAGGCAGGTGGATCATGAGGTCAGGAGTTCGAGACCAGCCTGGCCAAGATGGTGAAACCCCGTCTCTACTAAAAATACAAAAATCAGCTGGGTGTGGTGGCGGGTGCCTGTAATCCCAGCTACTCGGGAGGCTGAGGCAGGAGAATTGCTTGGACCTGGGCAGCAGAGGTTGCAGCGAGCTGAGATGGCGCCACTGCACTCCAGCCTGGGCGACAGAGCGAGACTCTTGTCTCAGAAAAATAAAAAATAAAAAAATTAGCTGGGTGTGGTGGTGCGCACCTGTAATCCCAGCTACTCGGGAGGCTGAGGCAGGAGAATCGCTTGAATCTGGGAGGAGGAGGAGGTTGCAGTGAGCTGAGATAGTGCCAGTGCAGGCCAGCCTGGTCAACAAGAGTGAAACTCCGTCTCAGAAAAAAAAAA","GGCTGGGCGCAGTGGCTCACACCTGTAATCCCAGCACTTAGGGAAGCTGAGGCGAGTAGATCACCTGAGGTCAGGAGTTAGAGACCAGCCTGGCCATCATGGTGAAACCCCGTCTCTACTAAAGATACCAAAAATTAGCTGAGTGTGGTGCTGGGTGCCTGTAATCCCAGAAACTCAGGGTGCCTGTAATCCCAGCAACTCAGGGTGCCTTTAATCCCAGCAACTGAGGGTACCAGTAATCCCAGCAACTCAGGGTGTCTTTAATCCTAGCAACTGAGGGCACCTGTAATCCCAGCAACTCAGGAAGCTGAGACAGGAGAAGTACTTGAACCCAGAAGGCAGAGGTTGCAGTGAGCCGATATTGCACCATTGCACTCCAGTCTGGGCAACAAGAGTGAAACTCTGTCTCAAAAAAAAA"
"chr19","2871458","2872098","JH378118","18053084","18053501","282","15181626","GGCCGGGCGCGGTGGCTCACGCTTGTAATCCCAGCACTTTGGGAGGCCTAGGTAGTGGATCACCTGAGGTCAGGAGTTTGAGACCAGCCTGGCCAACATGGGGAAACCCAGTCTCTACTAAAAATACAAAAATGAGGCCGGGTGCAGTGGCTCATGCCTGTAGTCTCAACACTTTGGGAGACCAAGGCAGGCGGATCACCTGAGGTCAGGAGTTCAAGCCCAACCTGGCCAACATGGTGAAACCCTGCCTCTTCTAAAAATACAAAAATTAGCCAGGTGTGGTGGCATGTACCTGCAATCCCAGCTGCTTAGGAGTTCGAGATAGAAGGATTGCCTGAACCTGGGAGGCGGAGGTTGCAGTGAGCTGAGATCATGCCATTGCACTCCAGCCTGGGTGACAGAGACCCTGTCTCACACACACACACACAAATTATATATATATATATATATATACACACACACACACACGCACACACAAATTGGCCAGGCGTGGTGGCGGGTGCCTATAATTCCAGCTACTTGGGAGGCTGAGGCAGGAGAATGTCTTGAACCCGGGAGGTGGAGGTTGCAGTGAGCCGAGATTGCGCCACTGCACTTTAGCCTGGACGACAAGAACAAAACTCCATCTCAAAAAAACGAAA","GGCTGGGCGCAGTGGCTCACACCTGTAATCCCAGCACTTAGGGAAGCTGAGGCGAGTAGATCACCTGAGGTCAGGAGTTAGAGACCAGCCTGGCCATCATGGTGAAACCCCGTCTCTACTAAAGATACCAAAAATTAGCTGAGTGTGGTGCTGGGTGCCTGTAATCCCAGAAACTCAGGGTGCCTGTAATCCCAGCAACTCAGGGTGCCTTTAATCCCAGCAACTGAGGGTACCAGTAATCCCAGCAACTCAGGGTGTCTTTAATCCTAGCAACTGAGGGCACCTGTAATCCCAGCAACTCAGGAAGCTGAGACAGGAGAAGTACTTGAACCCAGAAGGCAGAGGTTGCAGTGAGCCGATATTGCACCATTGCACTCCAGTCTGGGCAACAAGAGTGAAACTCTGTCTCAAAAAAAAA"
"chr19","2912949","2913566","JH378118","18053084","18053501","268","15140135","GGCTGGGCGTGGTGGCTCACACCTGTAATCCCAGCACTTTGGGAGGCCAAGGTGGAGGGACTGCCTGAAGCCAGGGGTTCGAGACCAGCCTGGCCAACATGGTGAAACCCTGTCTCTACTAAAAATAGAAAAATTAAGGCCGGGCGCGGTGGCTCATGCCTGTAATCCCAGCACTTTGGAAGGCCGAGGCGGGCGGATCACTTGAGGTCGGGAGTTCAAGACCAGCCTGACCAACATGGAGAAACCCTGTCTCTACTAAAAATACAAAATTAGCCAGGGTGGTGGCGCATGCCTGTAATCCCAGCTACTTGGGAGGCTGAGGCAGGAGAATCGCTTGAACCCGGGAGGTGGAGGTTGCAGTGAGCTGAGATCGCACCATTGCACTCCAGCCTGGGCAACAAGAGCAAAACCACGTCTCAAAAAAAATAAAAATAAAAATAAAAAAATTAGCTGGGTGTGGTGGCAGGCGCCTGTAGCTGCTTGGGAGGCTGAGACAGGAGAATTGCTTGAACCTGGGAGGCGGAGGTTGCAGTGAGCTGAGACCGTGCCATTGCACTCCAGGCTGGGCAAGAAGAGCAAAACTCTATCCTTCCCCCACTCCAAAAAAAAAAAAAAAAA","GGCTGGGCGCAGTGGCTCACACCTGTAATCCCAGCACTTAGGGAAGCTGAGGCGAGTAGATCACCTGAGGTCAGGAGTTAGAGACCAGCCTGGCCATCATGGTGAAACCCCGTCTCTACTAAAGATACCAAAAATTAGCTGAGTGTGGTGCTGGGTGCCTGTAATCCCAGAAACTCAGGGTGCCTGTAATCCCAGCAACTCAGGGTGCCTTTAATCCCAGCAACTGAGGGTACCAGTAATCCCAGCAACTCAGGGTGTCTTTAATCCTAGCAACTGAGGGCACCTGTAATCCCAGCAACTCAGGAAGCTGAGACAGGAGAAGTACTTGAACCCAGAAGGCAGAGGTTGCAGTGAGCCGATATTGCACCATTGCACTCCAGTCTGGGCAACAAGAGTGAAACTCTGTCTCAAAAAAAAA"
"chr19","3601333","3601668","JH378148","10302642","10302970","47","6701309","GCTGGGCGTGGTGGCTCACACCTGTAATCCCAGCACTTTGGGAGGCTGAGGTGGGCGGATCACGTGAGGTCAGGAGTTCCAGACTAGCCTGGCCAACATGGGGAAACCCCATCTCTGCTAAAAATAAAAAATTTAGCCGAGTGTGGTGGTGGGTGCCTGTAATCCCAGCTACTCAGGAGGCCGAGGCAGGAGAATTGCTTGAACCCAGGAGGCAGAGGTTGCAGTGAGCCGAGATCACGCCATTGCACTCCAGCCTGGATGACAACAGTGAGACTCCAACTCAAAAAATAATAATAATAATAATAATAATAATAAAATAAAACAATAAAAAAAAAA","GGCCGGGCGCGGTGGCTCAAGCCTGTAATCCCAGCACTTTGGGAGGCCGAGGCGGGTGGATCACGAGGTCAAGAGATCGAGACCATCCTGGTCAACATGGTGAAACCCCGTCTCTACTAAAAATACAAAAAATTAGCTGGGCATGGTGGTGGGTGCCTGTAATCCCAGCTACTCAGGAGGCTGAGGCAGGAGAATTGCCTGAACCCAGGAGGCGGAGGTTGCGGTGAGCCGAGATCGCGCCATTGCACTCCAGCCTGGGTAACAAGAGTGAAACTCTGCCTCAAAAAAAAAAAATAAAATAAAATAAAATAAAATAAAATAAAATAAAA"
"chr19","4440800","4441421","JH378118","18053084","18053501","276","13612284","GGCTGGGTGCGGTGGCTCATGCCTGTAATCCCAGCACTTTGGGAGGCCAAGCGGGCAGATCAACTGAGGTCAGGAGTTCGAGACCAGCCTGGCCAACATAGTAAAACCCTGTTTCTACTAAAAAAAAAAAAAAAAAAAAAAAAAAAATTGGCTGGGCGCAGTGGCTCACGCATGTAATCCCTGCACTTTGGGAGGCCAAGGCAGGTGGATCACCTGAGGTCAGTAGTTTGAGACCAGCCTGACCAACGTGGAGAAACCCCATCTCTACTAAAAATACAAACAAAAAAAACAAAAAACAAAAAAAACCGGGTATGGTGGTACATCCCTGTAATCCCAGCTCCTCGGGAGGCTGAGGCAGGAGAATCACTTGAACCCGGGAGGCGGAGGTTGCACTGAGCCGAGATTGCGCCACTGCACTCCAGCCTGGGCGATAGAGCGAGACTCCCTCTTAAATAATGATTATAATTGCCAGGTGTGGTGGCGGGTGCCTGTAATCCCAGCTACTTGGGAGGCTGAGGCAGGAGAATCGTTTGAATCCAGGAGGAGGAGGTTGCAGTGAGCCGAGATGGTGCCACAGCACTCCAGCCTGGGTGACAAGAGTGAAACCCCATTACAAACAAAA","GGCTGGGCGCAGTGGCTCACACCTGTAATCCCAGCACTTAGGGAAGCTGAGGCGAGTAGATCACCTGAGGTCAGGAGTTAGAGACCAGCCTGGCCATCATGGTGAAACCCCGTCTCTACTAAAGATACCAAAAATTAGCTGAGTGTGGTGCTGGGTGCCTGTAATCCCAGAAACTCAGGGTGCCTGTAATCCCAGCAACTCAGGGTGCCTTTAATCCCAGCAACTGAGGGTACCAGTAATCCCAGCAACTCAGGGTGTCTTTAATCCTAGCAACTGAGGGCACCTGTAATCCCAGCAACTCAGGAAGCTGAGACAGGAGAAGTACTTGAACCCAGAAGGCAGAGGTTGCAGTGAGCCGATATTGCACCATTGCACTCCAGTCTGGGCAACAAGAGTGAAACTCTGTCTCAAAAAAAAA"
"chr19","5462237","5462567","JH378255","1377129","1377437","56","4085108","GACCAGGTGCGGTGGCTCACGCCTGTCATTCCAGCACTTTGGGAGGCCGAGGGGGGCGTGGATCACTTGAGGTCAGGAGTTCAAGACCAGCCTGACCAACATGGTGAAACTCCGTCTCTACTAAAAATACAAAAATTAGCCAGGTGTGGTGGCACATGCCTGTAATCCCAGCTACTTGGGAGGCTGAGGCAGGAGAATCACTTGAACCTGGGAGATGGAGGTTTCATTCAGTGAGCTGAGATTGCACCATTGCACTCCAGCCTGGGTGACAAGAACGAAACTCTGTCTCAGAACACACACACACACACACACACACACACCCCAGAAAAAA","GGCCTGGCGTGGTGGCTCACGCCTGTAATCTCAGCACTTTGGGAGGCCAAGGTGGGTGGATCACCTGAGGTCAGGAGTTCAAGACCAGCCTGGCCAACATGGTGAAACCCCGTCTCTACTAAAAATACAAAAATTAGCTGGGTGTGGTGGCAGACACCTGTAATTCCAGCTACTTGGGAGGCTGAGGCAGGAGAATAGCTTGAACCTGGGAGGTGAGGGTTGCAGTGAGCCGAGATCGCACCATTTTACTCCAACCTGGGCAACAAGAGCGAAACTCCGTCTCAAAATCCAAACAAACCAAAACAAAAA"
"chr19","8011731","8012413","JH378118","18053084","18053501","321","10041353","GGCCGGGTACAGTGGCTCACTCCTGTAATCCCAGAACTTTGGGAGACCGAGGTGGGGGGATCACTTGAGGTCAGGAGTTCGAGACCACCCTGGCCAATATAGTGCTAAACCCCATCTCTACTCAAAATACAAAAAAAAAAAAAAAAAAAAAAAAAAAGCAAAACCCAGGCTGGGCACAGTAGCTCATACCTGTAATCCCAGCACTTTGGGAGGCTGAGGTGGGTAGATCATGAGGTCAGGAGTTCGAGACCAGCCTGACCAACATGGTGAAACCCCGTCTCTACTAAAAATACAAAAATTAGCCGGGCATGGTGGTGCGTGCCTGTAATCCCAGCTACTCAGGAGGCTGAGGCAGGAGAATCGCTTGAAGCTGGGAGGCAGAGGTTGCAGTGAGCCGAGATCGTGCTACTGTACTCCAGCCTGGGCAACAGGGCGACAGAGCAAGACTCTGTCTCAAAAAAAAAAAAAAAAAAAAAAAAAAGCAAAACCCCATCTCTACTAAAAATACAAAAAATTAGCCAGGCATGGTGGCATGTGCCTGTAATCCCAGCTACTCGAGAGGCTGAGGCAGAAGAATCACTTGAACCCAGGAGGCAGAGGTTGCAGCGAGCCAAGATTGTGCCATTGCACTCCAATCTGGGTGACAAGAGTAAAATCCTGTCTCAAAAAAATAAAAAATAAAA","GGCTGGGCGCAGTGGCTCACACCTGTAATCCCAGCACTTAGGGAAGCTGAGGCGAGTAGATCACCTGAGGTCAGGAGTTAGAGACCAGCCTGGCCATCATGGTGAAACCCCGTCTCTACTAAAGATACCAAAAATTAGCTGAGTGTGGTGCTGGGTGCCTGTAATCCCAGAAACTCAGGGTGCCTGTAATCCCAGCAACTCAGGGTGCCTTTAATCCCAGCAACTGAGGGTACCAGTAATCCCAGCAACTCAGGGTGTCTTTAATCCTAGCAACTGAGGGCACCTGTAATCCCAGCAACTCAGGAAGCTGAGACAGGAGAAGTACTTGAACCCAGAAGGCAGAGGTTGCAGTGAGCCGATATTGCACCATTGCACTCCAGTCTGGGCAACAAGAGTGAAACTCTGTCTCAAAAAAAAA"
"chr19","8026835","8027736","JH378118","18053084","18053501","522","10026249","GCGCGGTGGCTCATGCCTGTAAACCCAGCACTTTGGGAGGCTGAGGTGGGTGGATCACCTGAGGTCAGGAGTTTGAGACCAGCCTGGCCAATATGGTGAAACCCGTCTCTACTAAAACATACAAAAATTAGGCTGGGCGCGGTGGCTCATGCCTTTAATCCCAACACTTTGGGAGGCCGAGGCGGGCGGATCACGAGGTCAGGAGTTTGAGACCATCCTGGCTAACATGGTGAAAGCCCGTCTCTACTAAAAATATAAAAATTAGCTGGGCGTGGTGGTGGGCACCTGGAGTCCCAGCTACTTGGGAGGCTGAGGCAGGAGAATGGCGTGAACCCGGGAGGCGGAGCTTGCAGTGAGCCAGGATCACGCCACTGCACTCCAGCCTGGGCGACAGAGCGAGACACCGTCTCAAAAAAAAAACAACAAAAATTAGCCAGGCATGGTGGTGGGCGCCTTTTTTTTTTTTTTTTTCAGAGTCTCACTCTGTCACCCAGGCTGGAGTGCAGTGGCTCAATCTCGGTTCACTGCAACCTCCGCCTCCCAGGTTCAAGCGATTCTCCTGCCTCAGCCTCCCGAATAACTGGGATTACAGGCACCCGCCACTACAACCAGCTAATTTTTGTATTTTTAGTAGAGATGGGGTTTCGCCATGTTGGCCAGGATGGTCTTGATCTCTTGACCTCGTGATCCACCCTCCTTGGCCTCTCAAAGTGCTGGGATTACAGGTGTGAGCCACTGTTCCCAGCTGATAGTGGGCACTTTTAATCCCAGCTACTCCGGAGGCTGAGGCAGGAGAATTGCTTGAACCCAGGAGGTGGAGGTTGCAGTGAGCCAAGATCGCGCCATTGCACTCCAGCCTGGGTGACAATAGCAAAACTCTGTCTCAATGAAACAAAACAAAA","GGCTGGGCGCAGTGGCTCACACCTGTAATCCCAGCACTTAGGGAAGCTGAGGCGAGTAGATCACCTGAGGTCAGGAGTTAGAGACCAGCCTGGCCATCATGGTGAAACCCCGTCTCTACTAAAGATACCAAAAATTAGCTGAGTGTGGTGCTGGGTGCCTGTAATCCCAGAAACTCAGGGTGCCTGTAATCCCAGCAACTCAGGGTGCCTTTAATCCCAGCAACTGAGGGTACCAGTAATCCCAGCAACTCAGGGTGTCTTTAATCCTAGCAACTGAGGGCACCTGTAATCCCAGCAACTCAGGAAGCTGAGACAGGAGAAGTACTTGAACCCAGAAGGCAGAGGTTGCAGTGAGCCGATATTGCACCATTGCACTCCAGTCTGGGCAACAAGAGTGAAACTCTGTCTCAAAAAAAAA"
"chr19","9069244","9069863","JH378118","18053084","18053501","266","8983840","GGCCGGGCACGGTGGCTCATTCCTGTAGTCTCTGTACTTTAGGAGGCTGAGGTGGGTGGATCACTTGAGGTCAGGAGTTCCAGACCAGTCTGGCCAAAATGGTGAAACCCCGTCTGTACTAAAAATACAAAAAAAAAGGCCGGGCGCGGTGGCTCACGCCTGTAATCCCAGCACTTTGGGAGGCTGAGGTGGGTGGATCACAAGGTCAGGAGATTGAGACCATCCTGGCTAACATGGTGAAACCCCGTCTCTACTAAAAATACAAAAAATTAGCTGAGTGTGGTAGCAGGCACCTGTAATCCCAGCTACTCAGGAGGCTGAGGTGGGAGAATGGCATGAACCCAGGAAGCAGAGCTTGCAGTGAGCTGAGATCATGCCACTGCACTCCAGCCTGGGTGACAGAGCGAGACTCCATCTCAAAAAAAAAAAATACAAAAAAATTAGCCAGGCGTAGTGGTGCATGCTTGTAGTCTCGGCTACTCAGGAGACTGACGCAGGAGAATCACTTGAACCCAGGAGGCGGAGGTTGCAGTGAGCCGAAATTATGCCATTGCACTCCAGCCTGGGAGACAAGAACAAAACTCTATCTCAAAAACCAACCAACCAAACAAACAAAAAAA","GGCTGGGCGCAGTGGCTCACACCTGTAATCCCAGCACTTAGGGAAGCTGAGGCGAGTAGATCACCTGAGGTCAGGAGTTAGAGACCAGCCTGGCCATCATGGTGAAACCCCGTCTCTACTAAAGATACCAAAAATTAGCTGAGTGTGGTGCTGGGTGCCTGTAATCCCAGAAACTCAGGGTGCCTGTAATCCCAGCAACTCAGGGTGCCTTTAATCCCAGCAACTGAGGGTACCAGTAATCCCAGCAACTCAGGGTGTCTTTAATCCTAGCAACTGAGGGCACCTGTAATCCCAGCAACTCAGGAAGCTGAGACAGGAGAAGTACTTGAACCCAGAAGGCAGAGGTTGCAGTGAGCCGATATTGCACCATTGCACTCCAGTCTGGGCAACAAGAGTGAAACTCTGTCTCAAAAAAAAA"
"chr19","9785992","9786608","JH378118","18053084","18053501","261","8267092","GGCCGGGAACGGTGGCTCACACCTATAATCCCAGCACTTTGGGAGGCCGAGGCAGGTGGATCACCTGAGGTCAGGAGTTCAAGACCAGCGTGGCCAACATAATGAAACCCCATCTTGGCCGGGTGCGGTGACTCACGCCTGTAATCCCAGCACTTTGGGAGGCCAAGGCGGGTGGATCACGAGGTCAGGGGATCGAGACCATCCTGGCTAACACAGTGAAACCCTGTCTCTACTAAAAATACAAAAAAATTAGCTGGGCATGGTGGCGGACGCCTGTAGTCCCAGCTACTCGGGAGGCTGAGGCAGGAGAATGGTGTGAACCTGGGAGGCAGAGCTTGCAGTGAGCCGAGATTGCGCCACTGCACTCCAGCTTGGGTGACAAAGTGAGACTCCATCTCAAAAAAAAAAAAAGAAACCCCATCTCTACTAAAAATACAAAAAATTTGCTGGGTGTGGTTGTGGGCACCTGTAATCCCAGCTACTTGGGAGGCTGAGGCAGGAGAATCACCTGAACCCAGGAGGCAGAGGTTGCAGTGAGCCGAAACAGTGCCATTGCACTCCAGCCTGGGCAACAAGAGTGAAACTCAATCTCAAAAAAAAAAAAAAAAGTACAAAAA","GGCTGGGCGCAGTGGCTCACACCTGTAATCCCAGCACTTAGGGAAGCTGAGGCGAGTAGATCACCTGAGGTCAGGAGTTAGAGACCAGCCTGGCCATCATGGTGAAACCCCGTCTCTACTAAAGATACCAAAAATTAGCTGAGTGTGGTGCTGGGTGCCTGTAATCCCAGAAACTCAGGGTGCCTGTAATCCCAGCAACTCAGGGTGCCTTTAATCCCAGCAACTGAGGGTACCAGTAATCCCAGCAACTCAGGGTGTCTTTAATCCTAGCAACTGAGGGCACCTGTAATCCCAGCAACTCAGGAAGCTGAGACAGGAGAAGTACTTGAACCCAGAAGGCAGAGGTTGCAGTGAGCCGATATTGCACCATTGCACTCCAGTCTGGGCAACAAGAGTGAAACTCTGTCTCAAAAAAAAA"
"chr19","9897689","9898264","JH378206","6546474","6546861","233","3351215","GCCAGGCACGGTGGCTCACACCTGTAATCCCAGCACTTTGGGAGGCCAAGGTGGGTGGATCACCTGAGGTCAGGAGTTCAAGACCAGCCTGACCAACATGGTGAAACCCAGGGCTCACACCTGTAATCCCAGCGCTTTGGGAGGCTGACGCGGGCAGATCACGAGGTCAGGAGATCGAGACCATCCTGGCTAACATGGTGAAACCCCGTCTCTACTAAAAATACAATAATTAGCTGGGCATGGTGGTGGGTGCCTGCAGTCCCAGCTACTTGGGAAGCTGAGGCAGGAGAATGGCGTGAACCCAGGAGGTGGAGCTCTCAGTGAGCTGAGATTGCATCACTGCACTTCCAGCCTGGGTGACAGAGCAAGACTCTGTCTCAAAAAAAAAAAAAAAAAAAAAAAAAATTAGCCAGGTGTGATGGCAGGCACCTGTAATCCCAGCTACTTAGGAGGCTGAGGCAGGAGAACCCAGGAGGCAGAGGTTGCAGTGAGCCAAGATCGCGCCATTGCACTCCAGCCTGGGTGACAAGAGCAAAATTCCATCTCAAAAAAAAAAAAAAAGAAGAAAAAGAAGAA","GGCCACACATGGTGGCTAACGCCTGTAATCCCAGCACTTTGGGAGGCCAAGTCGGGTGGATCATGAGGTCAGGAGACCAAGACCATCCTGGCCAAATGGTGAAACCCCGTCTCTACTAAAAATACAAAAATTAGCTGGGCATGGTGGCGTGTGCCTGTAATCCCAGCTACTCAGGAGGCTGAGGCAGGACAATTGCCTGAACCCAGGAGAATTAGCTGGGCATGGTGGCGTGTGCCTGTAATCCCAGCTACTCAGGAGGCTGAGGCAGGACAATTGCCTGAACCCAGGAGGCGAAGGTTGCGGTGAGCCGAGATTGTGCCATTGCACTCCAGCCTGGGTAACAAGAGCGACACTCTGTCTCAAAAAAAAAAAAAAAAAAAAAAAAAAA"
"chr19","10210761","10211695","JH378118","18053084","18053501","553","7842323","GGCCGGGTGTGGTGGCTCATGCCTGTAATCCCAGGCATGATTTGGGAGGCCGAGGGAGGCAGATCACCTGAGGTCAGGAGTTTTTTTGTTTTGTTTTGTTTTGTTTTTGAGACAGAGTCTTGTTCTGTTGCCCAGGCTGGAGTGCAATGATGTGATCTCGACTCACTACAACCTCCACCTCCTGAGTTCAAGCGATTCTGCTGCCTCAGCCTCCCGAGTAGCTGGCATTACAGGCATGTGCCACCAAGCCTGGCTAATTTTTGTATTTATAGTAGAGACGGGGGTTTCACCATGTTGATCAGGCTGGTGTCGAACTCCTGGCCTCAAGTGATCCGCTCGCCTTGGCCTCCCAAAATGCTGGGATTACAGATGTGAGCCACTGTGCCCAGCCAAGGTCAAGAGTTTGAAACCAGCCTGGCCAGCATGGTGAAACCCTATCTCTACTAAAAATACAAAATCAGTCCATGTGCCTAATTTTGGGATCACACCTGGGATCATGCCTGCAATCCCAGCACTTTGGGAGGCCAAGGCGGGTGGGTCATGAAGTCAGGAGTTCAAGACCAGCCTGGCCAACATGGTGAAACCCTGTCTCTACTAAAAATACAAAAGTTAGCTGGGCGTGGTGGCACGCACCTGTAGTCCCAGCTACTAGGAAGGCTGAGGCAGGAGAATTCTTGAACCCGGGTGATGGAGGTTGCAGTGAGCCGAGATTGCGCCACTGCACTCCAGCCTGGGCAACAGAGTGAGACTCTGTCTAAAAAAAAAATTAGTCAGGCGTGGTGGTGAGCACCTGTAATCACAGCTACTGGGGAGGCTGAGGCTGGAGAATTGCTTGAACCCGGGAGGCGGAGGTTGCAGTGAGCCAAGATCGCGCCTTTGCACTCCAGCCTGGGCAACAGGAGTGAAACTGCATCTCAAAAAAAAAAAAAAAAAAA","GGCTGGGCGCAGTGGCTCACACCTGTAATCCCAGCACTTAGGGAAGCTGAGGCGAGTAGATCACCTGAGGTCAGGAGTTAGAGACCAGCCTGGCCATCATGGTGAAACCCCGTCTCTACTAAAGATACCAAAAATTAGCTGAGTGTGGTGCTGGGTGCCTGTAATCCCAGAAACTCAGGGTGCCTGTAATCCCAGCAACTCAGGGTGCCTTTAATCCCAGCAACTGAGGGTACCAGTAATCCCAGCAACTCAGGGTGTCTTTAATCCTAGCAACTGAGGGCACCTGTAATCCCAGCAACTCAGGAAGCTGAGACAGGAGAAGTACTTGAACCCAGAAGGCAGAGGTTGCAGTGAGCCGATATTGCACCATTGCACTCCAGTCTGGGCAACAAGAGTGAAACTCTGTCTCAAAAAAAAA"
"chr19","10485431","10486007","JH378118","18053084","18053501","237","7567653","GGCCGGGCGCAGTGGCTCATGCCTAATCCCAAGACTTTCAGAGGCTGAGGCAGGTGGATCACCTGAGGTCAGGAGCTCAAGACCAGCCTGGCTAACATTGTGAAACCGCGTCTCTACTAAAAATCAAAATTGGCCGGGCACGGTGGCTCACACCTGTAATCCCATCCCTCTGGGAGACCGAGGCGGGCAGATCACCTAAGGTCAGGAGTTCGAGACCAGCCTGACCAACATGGAGAAAACCCTTCTCTGCTAAAAATACAAAATTAGCCGGGCGTGGTGGCGCATGCCTGTAACCTCAGCTACTCGGGAGGCTGAGGGAAAATCGCTTGAACCTGCCAGGTGGAGGTTGCAGTGAGCCGAGATCGAGCCATTGCACTCCAGCATGGGCAACGAAAGCGAAACTCCATCTCAAAAAAAAAAAAAATTAGCTAGGCGTGGTGGCGCGTGCCTGTATTCCCAGCTACTCAGGAGGCTGAGACAGGAGAATCACTTGAACCTGGGAGGCAGAGGTTGCAGTGAGCCAAGATTGCACCATTGCACTCCAGCCTGGGCAACACGAGCAAAACTCTGTCTCAAA","GGCTGGGCGCAGTGGCTCACACCTGTAATCCCAGCACTTAGGGAAGCTGAGGCGAGTAGATCACCTGAGGTCAGGAGTTAGAGACCAGCCTGGCCATCATGGTGAAACCCCGTCTCTACTAAAGATACCAAAAATTAGCTGAGTGTGGTGCTGGGTGCCTGTAATCCCAGAAACTCAGGGTGCCTGTAATCCCAGCAACTCAGGGTGCCTTTAATCCCAGCAACTGAGGGTACCAGTAATCCCAGCAACTCAGGGTGTCTTTAATCCTAGCAACTGAGGGCACCTGTAATCCCAGCAACTCAGGAAGCTGAGACAGGAGAAGTACTTGAACCCAGAAGGCAGAGGTTGCAGTGAGCCGATATTGCACCATTGCACTCCAGTCTGGGCAACAAGAGTGAAACTCTGTCTCAAAAAAAAA"
"chr19","10538873","10539199","JH378118","15020968","15021286","46","4482095","GCTGGGCGCGGTGGCTCACGCCTGTAATCCCAGCACTTTGGGAGGCTGAGGCAGGCAGATCACCTGAGGTCAGGAGTTCAAGACCAGCCTGGTTAACACAGTGAAACCCCCGTCTCTACTAAAAATACAAAAACAAAAATTAGCCGGGTGTGGTGGCGGGCGCCTGTAATCCCAGTTACTCGGGAGGCTGAGGCAGGAGAATCGCTTGAACCCGGGAGGCGGAGGTTGTGGTGAGCCGAGATTGCCATTGCACTCCAGCCTGGGCAAAAAGAGCGAAACTCCATCTAAAACAAACAAACAAACAAACAAACAAAAAATAGAAAAGAA","GCCGGGCGCGGTGGCTCAAGCCTGTAATCCCAGCACTTTGGGAGGCTGAGGCGGGTGGATCCCGAGGTCAAGAGATCGAGACCATCCTGGTCAACATGGTGAAACCCCGTCTCTACTAAAAATACAAAACATTAGCTGGGTATGGTGGCGCGTGCCTGTAATCCCAGCTACTCAGGAGGCTGAGGCAGGAGAATTGCCTGAACCCAGGAGGCGGAGGTTGCGGTGAGCTGAGATCGCGCCATTGCACTCCAGCCTGGGTAACAAGAGCGAAACTTCCATCTCAAAAACAAACAAACAAACAAACAAACAAAAAACAAAC"
"chr19","10973032","10973651","JH378118","18053084","18053501","265","7080052","GGCTGGACGTGGTGGCTCACGCCTGTAATCCCAACACTTTGGGAGACCAAGGCAGGTGGATCGCCTGAGGTTAGGGGTTCGAGACCAGCCTGACCAACATGGTGAAACCCCATCTCTACTAATAATAAAAAAATTAGGACCAGGCTTGGTGGCTCATGCCTGTAATTCCAACACTTTGGGAGGCCAAGGCGAGTGGATAACTTGAGGTCAGGAGTTTGAGACCAGCCTGGCCAACATGGTGAAACCTCATCTCTACTAAAAATACAAAAATTAGCCGGCATGGTGGCGGGCACCCGTAATCCCAGCTACTCGGTGTGGGGGCTGGGACAGGAGAATCGCTTGAACCCAGGAGGTGGAGGTTGCCGTGAGCTAAGATTGCGCCACTGCACTCTAGTTGGGGCAACAGAGCGGACTCCGTCTCAAAAAAAAAAAAAAAATTAGCCGAGCGTGGTGGTGGACACCTGTAATCCCAGCTACTCAGGAGGCTGAGGCAGGAAAATTGAAATCGCTTAAACCTGGGAGGAGGAGGTTGCAGTGAGCCAAGATCGCACCATTGCACTCCAGCCTGGGCGACAAGAACAAAACTCCGTCTCCCCACTCCAAAAAAAAAAAAAAAAAAA","GGCTGGGCGCAGTGGCTCACACCTGTAATCCCAGCACTTAGGGAAGCTGAGGCGAGTAGATCACCTGAGGTCAGGAGTTAGAGACCAGCCTGGCCATCATGGTGAAACCCCGTCTCTACTAAAGATACCAAAAATTAGCTGAGTGTGGTGCTGGGTGCCTGTAATCCCAGAAACTCAGGGTGCCTGTAATCCCAGCAACTCAGGGTGCCTTTAATCCCAGCAACTGAGGGTACCAGTAATCCCAGCAACTCAGGGTGTCTTTAATCCTAGCAACTGAGGGCACCTGTAATCCCAGCAACTCAGGAAGCTGAGACAGGAGAAGTACTTGAACCCAGAAGGCAGAGGTTGCAGTGAGCCGATATTGCACCATTGCACTCCAGTCTGGGCAACAAGAGTGAAACTCTGTCTCAAAAAAAAA"
"chr19","11513769","11514351","JH378206","6546474","6546861","242","4967295","TCCCAGCACTTTGGGAGGCCGCGATGGGTGGATCACCTTAGGTCAGGAATTCGAGACCATCCTGGCCAACATGGTGAAACCCCGTCTCTACTAAAAACACAAAAATTAGGCCGGGCACGGTGGCTCACATCTGTAATCCCAGCACTTTGGGAGGCTGAGGTGGGCGGATCACAAGGTCAGGAGTTCAAGACCAGCCTGGCCAACATGGTGAAACCCTGTCTCTACTAAAAATACAAAAATTAACTGGGCATGGTGGCATGTGCCTGTAATCCCAGCTACTTGGGAGGCTGAGGCAGAAGAATTGCTTGAACCAGGGAGTCAGAGGTTATAGTGAGCTGAGATCGTGCGACTGCACTCCAGCCTGGTGACAGAGCGAGACTCCGTTTCAGGAAAAACAAACAAAACACAAAAATTAGCTGGGCATGGTGGCAGGCGCCTGTAATCCTAGCTACTTGGGAGGCTGAGGCAGGAGAATCGCTTGAACCCAGAAGGCAAAGGTTGCAGTGAGCTGAGATGATGCCATTGCACTCCAGCCTGGGCAACAAGTGAAACTCTGTCTCAAGAAAAAAAGTAAAAGAAAGAA","GGCCACACATGGTGGCTAACGCCTGTAATCCCAGCACTTTGGGAGGCCAAGTCGGGTGGATCATGAGGTCAGGAGACCAAGACCATCCTGGCCAAATGGTGAAACCCCGTCTCTACTAAAAATACAAAAATTAGCTGGGCATGGTGGCGTGTGCCTGTAATCCCAGCTACTCAGGAGGCTGAGGCAGGACAATTGCCTGAACCCAGGAGAATTAGCTGGGCATGGTGGCGTGTGCCTGTAATCCCAGCTACTCAGGAGGCTGAGGCAGGACAATTGCCTGAACCCAGGAGGCGAAGGTTGCGGTGAGCCGAGATTGTGCCATTGCACTCCAGCCTGGGTAACAAGAGCGACACTCTGTCTCAAAAAAAAAAAAAAAAAAAAAAAAAAA"
"chr19","11535200","11535780","JH378206","6546474","6546861","242","4988726","TCCCAGCACTTTGGGAGGCCGCGATGGGTGGATCACCTTAGGTCAGGAATTCGAGACCATCCTGGCCAACATGGTGAAACCCCGTCTCTACTAAAAACACAAAAATTAGGCCGGGCACGGTGGCTCACATTGTAATCCCAGCACTTTGGGAGGCTGAGGTGGGCGGATCACAAGGTCAGGAGTTCAAGACCAGCCTGGCCAACATGGTGAAACCCTGTCTCTACTAAAAATACAAAAATTAACTGGGCATGGTGGCATGTGCCTGTAATCCCAGCTACTTGGGAGGCTGAGGCAGAAGAATTGCTTGAACCAGGGAGTCAGAGGTTATAGTGAGCTGAGATCGTGCGACTGCACTCCAGCCTGGTGACAGAGCGAGACTCCGTTTCAGGAAAAACAAACAAAACACAAAAATTAGCTGGCATGGTGGCAGGCGCCTGTAATCCTAGCTACTTGGAGGCTGAGGCAGGAGAATCGCTTGAAACCCAGAAGGCAAAGGTTGCAGTGAGCTGAGATGATGCCATTGCACTCCAGCCTGGGCAACAAGTGAAACTCTGTCTCAAGAAAAAAAGTAAAAGAAAGAA","GGCCACACATGGTGGCTAACGCCTGTAATCCCAGCACTTTGGGAGGCCAAGTCGGGTGGATCATGAGGTCAGGAGACCAAGACCATCCTGGCCAAATGGTGAAACCCCGTCTCTACTAAAAATACAAAAATTAGCTGGGCATGGTGGCGTGTGCCTGTAATCCCAGCTACTCAGGAGGCTGAGGCAGGACAATTGCCTGAACCCAGGAGAATTAGCTGGGCATGGTGGCGTGTGCCTGTAATCCCAGCTACTCAGGAGGCTGAGGCAGGACAATTGCCTGAACCCAGGAGGCGAAGGTTGCGGTGAGCCGAGATTGTGCCATTGCACTCCAGCCTGGGTAACAAGAGCGACACTCTGTCTCAAAAAAAAAAAAAAAAAAAAAAAAAAA"
"chr19","12911527","12912140","JH378118","18053084","18053501","266","5141557","GGCCAGGCATGGTGGCTCATGCCTGTAATCCAGCACTTTGGTAGGCCAAGGTGGGTGGATGGATTACTTGAGGCCAGGAGTTCAAGACCAACCTGGCCAACATGGTGAAAACCCATCTCTATTAAAAATATAAAAGCTAGGCCAGGTGCGGTGGCTCACGCCTGTAATCCCAGCACTTTGGGAGGCTGAGGCGGGCGGATCACGAGGTCAGGAGATCGAGACCACTGTGAAACCCTGTCTCTACTAAAAATACAAAAAAAATTAGCTGGGTGGGGTGGCGGGTGCCTGTAGTCCCAGCTACTTGGGAGGCTGAGGCAGGAGAATGGCGTGAACCCGGGAGGCGGAGCTTGCAGTGAGCCGAGATCGCGCCACTGCACTCCAGCCTGGGCTACAGAGCAAGACTCCGTCTCAAAAAAAAAATAAATAAATAAATAAAAATAAAAACTAACTGGGCATGGTGGTGTGCACCTGTAATCCCAGCTACTCGGGAGGCTGAGACAGGAGAATTGCTTGAACCTGGGAGGTGGAGGTTGCAGTGAACCAAGATGATGCCATTGCACTCCAACCTGGGCAACAAGAGCAAAACTCCGTCTCAAAAAAAAAAAAAAAAAAAA","GGCTGGGCGCAGTGGCTCACACCTGTAATCCCAGCACTTAGGGAAGCTGAGGCGAGTAGATCACCTGAGGTCAGGAGTTAGAGACCAGCCTGGCCATCATGGTGAAACCCCGTCTCTACTAAAGATACCAAAAATTAGCTGAGTGTGGTGCTGGGTGCCTGTAATCCCAGAAACTCAGGGTGCCTGTAATCCCAGCAACTCAGGGTGCCTTTAATCCCAGCAACTGAGGGTACCAGTAATCCCAGCAACTCAGGGTGTCTTTAATCCTAGCAACTGAGGGCACCTGTAATCCCAGCAACTCAGGAAGCTGAGACAGGAGAAGTACTTGAACCCAGAAGGCAGAGGTTGCAGTGAGCCGATATTGCACCATTGCACTCCAGTCTGGGCAACAAGAGTGAAACTCTGTCTCAAAAAAAAA"
"chr19","13205284","13205895","JH378118","18053084","18053501","258","4847800","GCCAGGCGCAGTGGATTACGCCTGTAATCCCAGCGCTTTGGTATACCGAGGCGGGCAGATCGTCTGAGGTCAGGAGTTCAAGACCAGCCTGGAGAACATGGTGAAACCCCGTCTCTATTAAAAATACAGGCTGGGCGCGGTGGCTTACGCCTGTAATCTCAGCACTTTGGGAGGCCAAGGCGGGTGGATCACGAGGTCAGGAGATCGAGACCATCCTGGCTAACATGGTGAAACCCTGTCTCTACTGAAAATACAAAAAAATTAGTTGTGGTGGGTGCCTGTAATCCCAGCTACTCGGGAGGCTGAGGCAGGAGAATGGCGTGAACCCGGGAAGCAGAGATTGCAGTAAGCCAAGATCGCTCCACTGCACTCCAGCCTGGGCTACAGAGCAAGACTCCATCTCAAAAAAAAATAAATAAATAAAATAAAAAATTAGCCTGGCGTGGTGGCGCATGCCTGTAATCCCAGCTACTTGGGAGGCTGAGGCAGGAGAATTGCTTGAACCCAAGAGGTGGAGGTTGCAGTGAGTCGAGATTGAGCCATTGCCATCCAGCCTGGGCAACAAGAGTGAAACTCTGTCTCAAAAAAAAAGAGAGAGAAAAGAAAGTAAAA","GGCTGGGCGCAGTGGCTCACACCTGTAATCCCAGCACTTAGGGAAGCTGAGGCGAGTAGATCACCTGAGGTCAGGAGTTAGAGACCAGCCTGGCCATCATGGTGAAACCCCGTCTCTACTAAAGATACCAAAAATTAGCTGAGTGTGGTGCTGGGTGCCTGTAATCCCAGAAACTCAGGGTGCCTGTAATCCCAGCAACTCAGGGTGCCTTTAATCCCAGCAACTGAGGGTACCAGTAATCCCAGCAACTCAGGGTGTCTTTAATCCTAGCAACTGAGGGCACCTGTAATCCCAGCAACTCAGGAAGCTGAGACAGGAGAAGTACTTGAACCCAGAAGGCAGAGGTTGCAGTGAGCCGATATTGCACCATTGCACTCCAGTCTGGGCAACAAGAGTGAAACTCTGTCTCAAAAAAAAA"
"chr19","14119695","14120238","JH378206","6546474","6546861","206","7573221","ACCAGCCTGGCCAAAATGGTGAAACCCTGTCTCTACTAAAAATATTTAAAAATTGGCCAGGTGCGGTGGCTCACGCCTGTAATCCCAGCACTTTGGGAGGCCGAGGCGGGCGGATTACAAGGTCAGGAGATCGAGACCATCCTGACTAACATGGTGAAACCCCGTCTCTACTAAAAATACAAAAAATTGGCCGGGCGTGGTAGCGGGCGCCTGTAGTTCCAGCTACTCGGGAGGCTGAGGCAGGAGAATGGCGTGAACCCGGAAGGCAGAGCTTGCAGTGAGCCAAGATCGTGCCACTGCACTCCAGCCTGAGCGACAGAGCAAGACTCCATCTCAAAAAAAAAAAAAAAAAAAAAAAAAATTAAAAAATTAGCTGGGCGTGGTAGCCGGCACCTGTAATTCCAGCTACTCAGGAGGCTGGAGCACAAGAATCGCTTGAAACCAGGAGGCAGAGTTGTAGTGAGCCGAGATCGTGCCATTGCACTCCAGCCTGGGCATCAAGAGCGAAACTCCATCTCAAAAACAAAACAAAACAAAACAAAAA","GGCCACACATGGTGGCTAACGCCTGTAATCCCAGCACTTTGGGAGGCCAAGTCGGGTGGATCATGAGGTCAGGAGACCAAGACCATCCTGGCCAAATGGTGAAACCCCGTCTCTACTAAAAATACAAAAATTAGCTGGGCATGGTGGCGTGTGCCTGTAATCCCAGCTACTCAGGAGGCTGAGGCAGGACAATTGCCTGAACCCAGGAGAATTAGCTGGGCATGGTGGCGTGTGCCTGTAATCCCAGCTACTCAGGAGGCTGAGGCAGGACAATTGCCTGAACCCAGGAGGCGAAGGTTGCGGTGAGCCGAGATTGTGCCATTGCACTCCAGCCTGGGTAACAAGAGCGACACTCTGTCTCAAAAAAAAAAAAAAAAAAAAAAAAAAA"
"chr14","584088","584429","JH378109","21565230","21565567","54","20981142","GGCCGGGTACGGTGGCTCACGCCTGTAGTCCTGGCACTTTGGGAGGCCGAGGCAGGTGGATCCCCGAGGTCACGAGTTTGAGACCAGCCTGGCCAGCATGGTGAAATCCCATCTCTACTAAAAATACAAAACTTAGCCGGGCATGGTGACGTGTGCCTGTAATCCCAGCTACTTGGGAGGCTGAGGCAGGAGAATTGCTTGAACCAGGGAGGCAGAGGTTGCAGTGAGCTGAGATCATGAAACTGCAGTCCAGTCTAGGCGACAAGAGCAAAACTCCGTCTCAAAAAAATAAATAAATAAATAAATAAATAAAAAATAAAACAAACAACAAAAAAAACAAAA","GGCCGGGCGCGGTGGCTCAAGCCTGTAATACCAGCACTTTGGGAGGCCGAGGCGGGTGGATCACGAGGTCAAGAGATCGAGACCATCCTGGTCAACATGGTGAAACCCCGTCTCTACTAAAAATACAAACAATTAGCTGGGCATGGTGGCGGGTGCCTGTAATCCCAGCTACTCCAGAGGCTGAGGCAGGAGAATTGCCTGAACCCAGGAGACGGAGGTTGCGGTGAGCCAAGATCGCGCCATTGCACTCCAGCCTGGGTGACAAGAGCGAAACTCCGTCTCAATAAATAAATAAATAAATAAATAAATAAAAATAAAATAAATAAATAAATAAATAA"
"chr14","620575","620915","JH378109","21565230","21565567","56","20944655","GGCCGGGTACGGTGGCTCACGCCTGTAGTCCTGGCACTTTGGGAGGCCGAGGCAGGTGGATCCCCGAGGTCACGAGTTTGAGACCAGCCTGGCCAGCATGGTGAAATCCCATCTCTACTAAAAATACAAAACTTAGCCGGGCATGGTGACGTGTGCCTGTAATCCAGCTAACTTGGGAGGCTGAGGCAGGAGAATTGCTTGAACCAGGGAGGCAGAGGTTGCAGTGAGCTGAGATCATGAAACTGCAGTCCAGTCTAGGCGACAAGAGCAAAACTCCGTCTCAAAAAATAAATAAATAAATAAATAAATAAAAAATAAAACAAACAACAAACAAAACAAAA","GGCCGGGCGCGGTGGCTCAAGCCTGTAATACCAGCACTTTGGGAGGCCGAGGCGGGTGGATCACGAGGTCAAGAGATCGAGACCATCCTGGTCAACATGGTGAAACCCCGTCTCTACTAAAAATACAAACAATTAGCTGGGCATGGTGGCGGGTGCCTGTAATCCCAGCTACTCCAGAGGCTGAGGCAGGAGAATTGCCTGAACCCAGGAGACGGAGGTTGCGGTGAGCCAAGATCGCGCCATTGCACTCCAGCCTGGGTGACAAGAGCGAAACTCCGTCTCAATAAATAAATAAATAAATAAATAAATAAAAATAAAATAAATAAATAAATAAATAA"
"chr14","1107083","1107723","JH378118","18053084","18053501","303","16946001","GGCGTGGTGGCTCACACCTGTAATCCCAGCACTTCAGGAGGCCAAGGCAGGTAGATTGCTTGATCACAGGAGTTCAAACCAGCCATGGGCAATGTCAGGCCTCTGAGCCCAAGCTTGCACGTATCCAGATGGCCTGAAGCAACTGAAGAATCACAAAAGAAGTGAAAACAGCCAGTTCCTTCCTTAACTGATGACATTACCTTGTGAAATTCCTTCTCCTGGCTCAGAAGCTCCCCTACTGAGCACCTTGTGACCCCTGCCCCTGCCAGCCAGAGAACAATCCCCTTTGACTGTAATTTTCCACTACCTACCCAAATCCTATAAAACAGCCCCACCCCATCTCCCTTTGCTGACTCCTTTTTCGGACTAGGTCCGCCTGCACCCAGGTGATTAAAAAGCTTTATTGCTCACACAAAGCCTGTTGGTGGTCTCTTCACACGGACGCACGTGACAGGCAACATGGTGAAACCCTATCTCTATAAAAAAATAAAAATAAAAATTAGTTGGGCGTGGAGACTGAGGTGAGAGAATCCAGAGGATCCAAGAGGATCGAGTCAAGGAGGTGGAGGCCGCAGTGAGCCGAGATCGCACCGCTGCACTCCAGCCTGGGCGACAAGAGTGAAACTCTGTCTTAAAAAAAA","GGCTGGGCGCAGTGGCTCACACCTGTAATCCCAGCACTTAGGGAAGCTGAGGCGAGTAGATCACCTGAGGTCAGGAGTTAGAGACCAGCCTGGCCATCATGGTGAAACCCCGTCTCTACTAAAGATACCAAAAATTAGCTGAGTGTGGTGCTGGGTGCCTGTAATCCCAGAAACTCAGGGTGCCTGTAATCCCAGCAACTCAGGGTGCCTTTAATCCCAGCAACTGAGGGTACCAGTAATCCCAGCAACTCAGGGTGTCTTTAATCCTAGCAACTGAGGGCACCTGTAATCCCAGCAACTCAGGAAGCTGAGACAGGAGAAGTACTTGAACCCAGAAGGCAGAGGTTGCAGTGAGCCGATATTGCACCATTGCACTCCAGTCTGGGCAACAAGAGTGAAACTCTGTCTCAAAAAAAAA"
"chr14","1362660","1363231","JH378118","18053084","18053501","229","16690424","GGCTGGGCACAGTGGCTTATACCCATAATCTCAGCAGTTTGGGAGGCCAAGGCAGGTGTATCACCTGAGGTCAGGAGTTCGAGAAACACCATGGCCAACATGGTGAAACCCCATCTCTACTAAAAATACAAAAAGTAGGCTGGGCGTGGTGGCTCACGCCTGTAATCCCAGTACTTTGGGAGGCCGAGGCGGGCGGATCACAAGGTCAGGAAACCGAGACCATCCTGACTAACATGGTGAAACCCCGTCTCTACTAAAAATACAAAAAAAGCTAGCCGGGCATGGTGGCGGGTGCCTGTAGTCCCAGCTACTCGGGAGGCTGAGGCAGGAGAATGGCGTGACCCCAGGAGGCAGAGCTTCCAGCTTGGGTGACTCCGTCTCAAAAAAAAAAAAACAAAAACAAAAAGTAGCTGGACGTGGTGGCTGTAGACCTAGCTACTCGAGAGGCTGAGGCAGGAGAATCGCTTGAACCTAGGAGGCGGAGGTTGCGGTGAGCCGAGATCACGCTTCTGCACTCCAGCCTGGGTGACAAGAGCAAAACTCCATCTCCAAAAAAAAAAAACAAAAAAAAA","GGCTGGGCGCAGTGGCTCACACCTGTAATCCCAGCACTTAGGGAAGCTGAGGCGAGTAGATCACCTGAGGTCAGGAGTTAGAGACCAGCCTGGCCATCATGGTGAAACCCCGTCTCTACTAAAGATACCAAAAATTAGCTGAGTGTGGTGCTGGGTGCCTGTAATCCCAGAAACTCAGGGTGCCTGTAATCCCAGCAACTCAGGGTGCCTTTAATCCCAGCAACTGAGGGTACCAGTAATCCCAGCAACTCAGGGTGTCTTTAATCCTAGCAACTGAGGGCACCTGTAATCCCAGCAACTCAGGAAGCTGAGACAGGAGAAGTACTTGAACCCAGAAGGCAGAGGTTGCAGTGAGCCGATATTGCACCATTGCACTCCAGTCTGGGCAACAAGAGTGAAACTCTGTCTCAAAAAAAAA"
"chr14","2088506","2089110","JH378118","18053084","18053501","257","15964578","GGCTGGGCACTGCGGCTCACACCTGTAATCCCAGCATTTTGAGAGGCCTAGGTGGGTGGATCACCTGAGATCAGTTCAAGACCAGCCTGACCAACATGGCAAAACCCCATCTCTATTAAAAACACAAAAAACGCCCAGGAGCGGTGGCTCACACCTGTAATCCCGGCACTTTGGGAGGCTGAGGCAGGCGGATCACGAGGTCAGGAGATCGAGACCATGCTGGCTAACACGGTGAAACCCCGTCTCTACTAAAAATACAAAAAATTAGCCAGGCGTGGTGTCGGGCGCCTGTAGTCCCAGCTATTCGGGAGGCTGAGACAGGAGAATGGCATGAACCCGGGAGGCAGAGCTTGCAGTGAGCTGAGATCGCGCCACTGCACTCCAGCCTGGGCGACAGAGTAAGACTCTGTCTCAAAAAAAAAAATACAAAAAATACAAAAAACATTAGCCACATGTGGTGGTGGGTGCCTGTAATCCCAGCTACTCAGGAGGCTGAGGCTGGAGAATTGCTTGAACCCAGGAGGTGGAGGTTGTGGTGAGCCAAGATCACGCCATTGCATTCCAGCCTGGGTGACAAGAGTGAACCTCTGTCTCAAAAAAAAGAA","GGCTGGGCGCAGTGGCTCACACCTGTAATCCCAGCACTTAGGGAAGCTGAGGCGAGTAGATCACCTGAGGTCAGGAGTTAGAGACCAGCCTGGCCATCATGGTGAAACCCCGTCTCTACTAAAGATACCAAAAATTAGCTGAGTGTGGTGCTGGGTGCCTGTAATCCCAGAAACTCAGGGTGCCTGTAATCCCAGCAACTCAGGGTGCCTTTAATCCCAGCAACTGAGGGTACCAGTAATCCCAGCAACTCAGGGTGTCTTTAATCCTAGCAACTGAGGGCACCTGTAATCCCAGCAACTCAGGAAGCTGAGACAGGAGAAGTACTTGAACCCAGAAGGCAGAGGTTGCAGTGAGCCGATATTGCACCATTGCACTCCAGTCTGGGCAACAAGAGTGAAACTCTGTCTCAAAAAAAAA"
"chr14","2164771","2165383","JH378118","18053084","18053501","243","15888313","GGCTGGGCGCAGTGGCTCACACCTGTAATCCCAGCACTCTGGGAGGCCAAGGCAGGTGGATCACCTGAGGTCAGGAGTTCGAGACCAGCCTGGCCAACATGGTGAAACCCCATCTTTACTAAAAATACAAAAATTAGCTAGGCGTGAGGCCGGGCGTGGCGGCTCATGCCTGTAATCCCAGCACTATGGGAGGCTGAGGCAGGCTGATCATGAGGTCAGGAGATTGAGACCTGGCTAACACAGTGAAACCCCGTCTCTACTAAAAATACAAAAAAAAAATAGCCAGGCATGATGGCAGGCTCCTGTAGTCCCAGCTTCTTGGGAGGCTGAGGCAGGAGAATGGTGTGAACCCGGGAGGCAGAGCTTGCAGTGAGCCGAGATCATGCCACTGCACTCCAGCCTGGGTGACAGAGCAAGACTCTGTCTCAAAAAAAAAAAAAAAAAATTAGCTAGGCGTGGTGAGGGGCACCTGGAATCCCAGCTACTCAGGAGGCTGAGGCAGGAGCATCGTTTAAACCCAGGAGGCAGAGGTTGCAGTGAGCCGAAATCACACCATTGCACTCCAGCCTGGGCAACAAGAGCAAGTCTCCATCTTAAAAAAAAAAAAAAAAAA","GGCTGGGCGCAGTGGCTCACACCTGTAATCCCAGCACTTAGGGAAGCTGAGGCGAGTAGATCACCTGAGGTCAGGAGTTAGAGACCAGCCTGGCCATCATGGTGAAACCCCGTCTCTACTAAAGATACCAAAAATTAGCTGAGTGTGGTGCTGGGTGCCTGTAATCCCAGAAACTCAGGGTGCCTGTAATCCCAGCAACTCAGGGTGCCTTTAATCCCAGCAACTGAGGGTACCAGTAATCCCAGCAACTCAGGGTGTCTTTAATCCTAGCAACTGAGGGCACCTGTAATCCCAGCAACTCAGGAAGCTGAGACAGGAGAAGTACTTGAACCCAGAAGGCAGAGGTTGCAGTGAGCCGATATTGCACCATTGCACTCCAGTCTGGGCAACAAGAGTGAAACTCTGTCTCAAAAAAAAA"
"chr14","3757666","3758004","JH378113","23438980","23439304","67","19681314","CTGGGCATGGTGGCTCATGCCTGTAATCCCAGCACTTTGGGAGACAGAGGAGGGCAGATCATCTGAGGTCAGGAGTTTGAGACCAGCCTGGCCACCATGGTGAAACCCCCGTCTCTACTGAAAATACAAAAAAATTCAGCTGGGTGTGGTAGTGGATGTCTGTAATCCTAGCTGCTTGGGAGGCTGAGACAGGAGAATCGCTTGAACCCGGGAGGTGGAGGTTGCAGTGAGCCGCCATTGCGCTCCAGCCTGGGCAACAAGAGCGAAACTCCATCTCAAAAATTAATTAATTAATTAATTAATTAAAAGTGGACTAAAGCAAAGACAAGAGAAAAAAGA","GGCAGGGTGTGGTAGCTCATGCTTGTAATCCCAGCACTTTGGGAAGTGGAGGCGGGCAGATCATCTGAGGTCAGGAGTTTGAGGCCAGCCTGGCCAACATGGTGAAACCCTGTCTCTACTAAAAATACAAAAAATTAACTGGGCGTGGTGGTGGACACCTGTAATCCCAGCTGCTTGGGAGGCTGAGGCAGGAGAATCGCTTGAACCCAGGAGATGGAGGTTGCAGTGAGCCAAGATGGCACCATTGCACTCTAGCCTGGGCAAAAAGAGTGAAACTCCGTCTCAAAAAAAAAAAAGAAAAGAAAAGAAAAGAAAAGAAAAGAAA"
"chr14","10702105","10702681","JH378118","18053084","18053501","246","7350979","GGCCAGGCGCAATGGCTCACACCTGTAATCCAAGCACTTTGGGAGGCCAGTTCAAGACCAGCCTGGCCAACATGGTGAAAACCTGTCTCTGCTAAAAATGCCAAATTTCCCAGCACTTTGGGAGGCTGAGGCGGGTGGATCACGAGGTCAGGAGATTGAGACCATCCCGGCTAACACGGTGAAACCCCATCTCTACTAAAAATAGAAAAAAATTAGCCGGGCGTGGTGGCAGACGCCTGTAGTCCCAGCTACTCTGGAGGCTGAGGGAAGAGAATGGCATAAACCCGGGAGGCGGAGCTTGCAGCGAGCTGAGATTGCGCCACTGCACTCCAGCCTGGGCGACAGAGCAAGACTCCGTCTCAAAATAAATAAATAAATAAAATTAAAATTAAAAATAAAATACAAAATTTAGCCGAGCATGGTGGTGAGCACCTATAATCCCAGCTACTTGGGAGGCTGAGGCAGAAGAATCTCTTGAACCAGGGAAGTGGAGGTTGCAGTGGGCTGAGATCCAGCCACTGTACTCCAGCCTGGGCGACAAAAGCGAAACACTGTCTAAAAAAATAAAAAATAAAAA","GGCTGGGCGCAGTGGCTCACACCTGTAATCCCAGCACTTAGGGAAGCTGAGGCGAGTAGATCACCTGAGGTCAGGAGTTAGAGACCAGCCTGGCCATCATGGTGAAACCCCGTCTCTACTAAAGATACCAAAAATTAGCTGAGTGTGGTGCTGGGTGCCTGTAATCCCAGAAACTCAGGGTGCCTGTAATCCCAGCAACTCAGGGTGCCTTTAATCCCAGCAACTGAGGGTACCAGTAATCCCAGCAACTCAGGGTGTCTTTAATCCTAGCAACTGAGGGCACCTGTAATCCCAGCAACTCAGGAAGCTGAGACAGGAGAAGTACTTGAACCCAGAAGGCAGAGGTTGCAGTGAGCCGATATTGCACCATTGCACTCCAGTCTGGGCAACAAGAGTGAAACTCTGTCTCAAAAAAAAA"
"chr14","11790883","11791455","JH378118","18053084","18053501","226","6262201","GGCTGGGTGGCCATGGCTCATGCCTGTAATCCTAGAACTTTGGGAGGCTGCGGCAGGCAAATCACCTGAAGTCAGGAGTTCAAGACCAGCCTGGCCAACATACTGAAACCCCGTCTCTCCAGGCCTGGTGGCTCATGCCTGTAATCCCAGCACTTTGGAAAGCCGAGGTGGGCGGATCACCTGAGGTCAGGAGTTCAAGACCAGTCTGACCAACATGGGGAAACCCCATCTCTACTAAAAATACAAAATTAGCTGGATGTGGTGGCACATGCCTGTATTCCCAGCTACTTGGGAGGCTGAGGCAGGAGAATCGCTTGATCCCGAGAGGTGGAGCTTGCCGTGAGCTGAGATTGTGCGCCATTGCACTCCAGCCTGGGCAACAAGAGTGAAACTCCGTCTCTACTAAAAATACAAAAATTAGCCGGGTGTGGTGGCGGGTGCCTGTAATCCAAGCTACTCGGGAGGCTAAGGCAGGAGAATTGCTTGAACCCACGAGGCCGAGGTTGCAGTGAGCCGAGATTGCACTATTGCACTCCAGCCTGGGCGACAAGAGTGAGACTGTGTCTCAAAAAA","GGCTGGGCGCAGTGGCTCACACCTGTAATCCCAGCACTTAGGGAAGCTGAGGCGAGTAGATCACCTGAGGTCAGGAGTTAGAGACCAGCCTGGCCATCATGGTGAAACCCCGTCTCTACTAAAGATACCAAAAATTAGCTGAGTGTGGTGCTGGGTGCCTGTAATCCCAGAAACTCAGGGTGCCTGTAATCCCAGCAACTCAGGGTGCCTTTAATCCCAGCAACTGAGGGTACCAGTAATCCCAGCAACTCAGGGTGTCTTTAATCCTAGCAACTGAGGGCACCTGTAATCCCAGCAACTCAGGAAGCTGAGACAGGAGAAGTACTTGAACCCAGAAGGCAGAGGTTGCAGTGAGCCGATATTGCACCATTGCACTCCAGTCTGGGCAACAAGAGTGAAACTCTGTCTCAAAAAAAAA"
"chr14","12236526","12237360","JH378118","18053084","18053501","465","5816558","GGCTGGGTGGGGTGGCTCACGCGTGTAATCCCAACACTTTTGAGGCTGAGGTGGGTGGATCACTTGAGGTCCGGAGTTTGAGACCAGCCTGGTCAACATGGTGAAACCCCATGTCTCAGGATGGGGAACATCACATACCGGGGCCTGTCGTGGGGTGTGGGGAGGGGAAGGGATAGCATTAGGAGATATACCTAATGTAAATGACAAGTTAATGGGTGCAGCACACCAACATGGCACATGTATACATATGTAACAAACCTGCATGTTGTGCACATGTACCCTAGAACTTAAAGTATAGCAATAAAAAAAAAAAAAGAAACCCCGTGTCTACAAAAAAAATACAAAATTAGGCCAGGCGCAGTGGCACATACCTGTAATCCCAGCACTTTGGGAGGCCAAGGTGGGCAGATCACGAGGTCAGGAGTTTGAGACCAGCCTGTCCAAAATGGTGAAACCCCATCTCTACTAAAAAAATACAAAAATTAGCCAGGCATGGTGGCCCGTGCCTGCAATCCCAGCTACTCAGGAGGCTAAGGCAGGAGAATCACTTGAACGTGGGAGGCGGAGGTTGCAGTGAGCCGAGATCACACCATTGCACTCCAGCCTAGGCAACAGAGCGAGACTCTGTCTCAAAAAAACAAAAAGCAAAAAAACCCAAATTAGCCAGGCATGGTGGTAGTCACCTGTAATCCCAGCTACTTGGGAGGCTTAGGCAGGAGAATCGCTTGAACCCCAGAGGCAGAGGTTGCAGTAAGCCAAGATCGCACCAAGATCACTCCAGCCTGGGCGACAGTGAAACTGTGTCTCAAAAGAAAAAGAAAAAAAAGAAAGAAAA","GGCTGGGCGCAGTGGCTCACACCTGTAATCCCAGCACTTAGGGAAGCTGAGGCGAGTAGATCACCTGAGGTCAGGAGTTAGAGACCAGCCTGGCCATCATGGTGAAACCCCGTCTCTACTAAAGATACCAAAAATTAGCTGAGTGTGGTGCTGGGTGCCTGTAATCCCAGAAACTCAGGGTGCCTGTAATCCCAGCAACTCAGGGTGCCTTTAATCCCAGCAACTGAGGGTACCAGTAATCCCAGCAACTCAGGGTGTCTTTAATCCTAGCAACTGAGGGCACCTGTAATCCCAGCAACTCAGGAAGCTGAGACAGGAGAAGTACTTGAACCCAGAAGGCAGAGGTTGCAGTGAGCCGATATTGCACCATTGCACTCCAGTCTGGGCAACAAGAGTGAAACTCTGTCTCAAAAAAAAA"
"chr14","12551961","12552292","JH378124","27069096","27069413","54","14517135","GGCCAGGCGCGGTGGCTCACGCCTGTAATCCCAGCACTCTGGGAGGCCAAGGCGGACGGATCATCCGAGGTCAGGAGTTTGAGACCAGCCTGGCCAACATGGTGAAACCCCATCTCTACTAAAAATATATATATATATGTATATATATATATATATTAGCCAGGTGTAGTGGTGGGCATCTGTAATCCCAGCTACTCGGGAGGCTGAGGCAGGAGAATTGCTTGAACCCAGGAGGCGGAGGTTGCAGTGAGCTGAGATTGCACCACTGCACTCCAGCCTGGGTGATAAGAATGAGACTCCATCTCAAAACAAACAAACAAACAAATAAAAAA","GGCCGGGCACGGTGGCTCATGCCTGTAATCCCAGCACTTTGGGAGGCCGAGGCGGGTGGATCATGAGGTCAAGAGATCGAGACCATCCTAGTCAACATGGTGAAACTCCATCTCTACTAAAAATACAAAAAAAAAAAAAAATTAGCTGAGCATGGTGGTGCATGCTTGTAATTCCAGCTACTCAGGAGGCTGAGGCAGGAGAATTGCCTGAACCCAGGAGGCGGAGGTTGCAGTGAGCCGAGATTGCGCCATTGCACTCCAGCCTGGGTAATAAGAGTGAAACTCCGTCTCAAAAAAAAAAAACAAAAAAACAAAAAA"
"chr14","15131045","15131391","JH378121","20921542","20921875","62","5790497","GGCTGGGCCCGGTGACTCATGCCTGTAATCCCAGCACTTCGGGAGGACAAGGCGGGTGGATCACCTGAGGTCAGGAGTTCGAGACCAGCCTGGCCAACATGGCGAAACCCCGTCTCTACTGAAAATACAAAAATTAGCCAGGCATGGTGGTGGGCGCCTGTAATCCCAGCTACTCAGAGGCTGAGACAGGAGAATCACTTGAACCTGGGGTGGGGGCGGGGGCGGGGGCGGGGGCGGGGTGGGAGTGGAGGTTGCAGACAGTGAGTGGTGATGGCGCCAGTTCACTCCAGCCTGGGCGAAAGAGTGAAACTCCATCTCAGAAAAAAAAAAAAAAAAAAAAAGTAAAA","GGCTGGGTACGGTGGCTCATGCTGTAATCCCAGCACTTTGGGAGGTCAAAGCAGGCGGATCACCTGAGGTCAGGAGTTTGAGACCAGCCTTGCTAACATGGTGAAACCCCGTTTCTACTAAAAATAAAAAAATTAGCCAGGCGTGGTGGTGTGCACCTGTAATCCCAGCTACTTGGGAGGCTGAAGCAGGAGAGTTGCTTGAACCGGGGTGGTGGGGGGGCAGGGGCAGGGGTGGGTGGCAGGCAGAGGTTGCAGTGAGCCGAGATGGTGCCATTGCACTCCAGCCTGGGCAACAAGAGCAAAACTCCGTCTCAAAAAGAAAAAAAAAAAAGAA"
"chr14","15292066","15292693","JH378118","18053084","18053501","267","2761018","GGCCGGAGACGGTGGCTCACACCTGTAATCCCAGCACTTTGGGAGGCTGAGGCAGGCAGATCACCTGAAGTCAGGAGTTTGAGACCAGCCTGGCCAACATGGTATAAACCCCATCTCTACTAAAAATACAAAAATTAGGCTGGGCGCGGTGGCTCACGCCTGTAATCCCAACACTTTGGGAGGCCGAGGTGGGTGGATCACCTGAGGTCGGGAGTTTGAGACCAGCCTGACCAACATGAAGAAACCCTGTCTCTACTAAAAAAAAAAAAAAATACAAAATTAGCCGGGCATCATGGCACAAGCCTGTAATCCCAGCTACTCAGGAGTCTGAGGCAGGAGAATCGCTTGAACCTGGGAGGCGAAGGTTGCAGTGAGCTGAGATCGTGCCATTGCACTCCAGCCTGGGCAACAAGAGCGAAACTCCTTCTCTAAATAAATAAATAAAAATACAAAAATTTAGCCGGGCATGGTGGCGGGCACCTGTAATCCTAGCTACTTGAGAGGCTGAGGCAGGAGAATCGCTTGAACCCGGGAGGCGGAGGTTGCAGTAAGCAGAGATTGTGCCATTGCACTCCATCCTGGGCAACAAGAGTGAAACTCCATCTCAAAAAAAAAAAAAAAAAAAAAA","GGCTGGGCGCAGTGGCTCACACCTGTAATCCCAGCACTTAGGGAAGCTGAGGCGAGTAGATCACCTGAGGTCAGGAGTTAGAGACCAGCCTGGCCATCATGGTGAAACCCCGTCTCTACTAAAGATACCAAAAATTAGCTGAGTGTGGTGCTGGGTGCCTGTAATCCCAGAAACTCAGGGTGCCTGTAATCCCAGCAACTCAGGGTGCCTTTAATCCCAGCAACTGAGGGTACCAGTAATCCCAGCAACTCAGGGTGTCTTTAATCCTAGCAACTGAGGGCACCTGTAATCCCAGCAACTCAGGAAGCTGAGACAGGAGAAGTACTTGAACCCAGAAGGCAGAGGTTGCAGTGAGCCGATATTGCACCATTGCACTCCAGTCTGGGCAACAAGAGTGAAACTCTGTCTCAAAAAAAAA"
"chr14","15354689","15355313","JH378118","18053084","18053501","269","2698395","GGACGGGCGCAGTAGCTCACACCTGTAATCCTAGCAGTTTGGGAGGCCAAGGTGGGTGGATCACCTGACGTCAGGAGATCGAGACCAGCCTGGACAACATGGCGAAACCCTGTCTCTACTAAAAATACAAAATTAGGGCCAGGTGCGGTGGCTCACGCCTGTAATCCCAGCACTTTGGGAGACTGAGGCGGGCAGATCACCTGAGGTCAGGAGTTCGAGACCAGCCTGGCCAACATGGTGAAACCGCCTCTCTACTAAAAATATAAAAATTGGCTGGGCATTGTAGCAGCCACCTGTAATCCCAGCTACTTGGGGGCCCGAGGCAGAAAAACTGCTTGAACCCAGGAGGCAGAGGTTGTAGTGAGCCGAAATCATGCCACTGCACTCCAGCCTGGGTGACGAGAGTGAGACTCCGTTTCAAAGAAAAAGAAAAAAAATAAAATAAAACACAAAATTAGCCAGTCATGGTGGCAGGCACCTATAATCCCAGCTACCTGGGAGGCTAAGGCAGGAGAATCACTTGAACCCAGGAGGTAGAGGGTGTGGTGAGCCGAGATCACGCCATTGCACTCTAGCCTGGGCAACAAGAGCAAAACTCTGTCTCAAAACAAAAAGTTAAAAAAAA","GGCTGGGCGCAGTGGCTCACACCTGTAATCCCAGCACTTAGGGAAGCTGAGGCGAGTAGATCACCTGAGGTCAGGAGTTAGAGACCAGCCTGGCCATCATGGTGAAACCCCGTCTCTACTAAAGATACCAAAAATTAGCTGAGTGTGGTGCTGGGTGCCTGTAATCCCAGAAACTCAGGGTGCCTGTAATCCCAGCAACTCAGGGTGCCTTTAATCCCAGCAACTGAGGGTACCAGTAATCCCAGCAACTCAGGGTGTCTTTAATCCTAGCAACTGAGGGCACCTGTAATCCCAGCAACTCAGGAAGCTGAGACAGGAGAAGTACTTGAACCCAGAAGGCAGAGGTTGCAGTGAGCCGATATTGCACCATTGCACTCCAGTCTGGGCAACAAGAGTGAAACTCTGTCTCAAAAAAAAA"
"chr14","15366797","15367405","JH378129","11955248","11955630","263","3411549","GGTTGGGTGCGGTGGCTTACCCCTGTAATCCCAGCACTTTGGGGGTACAAAGTGGGAAGATTGCTTGAGCCCAGGAGTTCAAGACCAGCCTGGGCAACTAAGCGAGATCCTATCTCTCAAAAAAATTTTGAAACAACTTTTTGGCCGGGCGCAGTGGCTCACGCCTGTGATCCCAGCACTTTGGGAGGCCAGGGCGGGCGGATCACGAGGTCAGGAGATCAAGACCATCCTGGCTAACACGGTGAAACCCCGTCTCTACTAAAAATACAAAAAATTAGCCGGGTGCGGTGGCGGGCACCTGTAGTCCCAGCTACTCGGGAGGCTGAGGCAGGAGGATGGCGTGAACCCGGGAGGTGGAGCTTGCAGTGAGCTGAGATCGGGCCACTGCACTCCAACCTGGACGACAGATCGAGACTCCGGCTCAAAAAAAAAAAATTAGCTGGGCGTGGTGGCGGGTGCGTGTAATCCCAGCTACTCGGGAGGCTGAGGCAGGAGAATCACTTGAACCTGGGAGGCAGAGGCTGCAGTGAGCCAAGATCGCGCCATTGCACTCCAGCCTGGGCAACAAGAGCGAAACTCTGTCTCTAAATAATAAAATAAAATAAAAAA","GGCTGGGTACGGTGGCTCATGCCTGTAATCCCAGCACTTTGGGAGGTGGGTCACTTGAGGTCAGGAGTTCGAGACCAGCCTGTGCAGTGCCTCCATCCTCAACTGCTGCCTCATCAGCCTGGACCACTACCTGCTCATCCTCTCACCACTGCCACAAGCTGCGCATGAAGCTCCTGCGCGCGCCGGTGCCCGTCTCTACTAAAAATACAAAAATTAGCTGGGTGTGGTGGCAGGTGCCTGTAATCCCAGCTACTCAGGAGGCTGAGGCAGGAGAATCACTTGAACCCAGGAGGCAGAGGTTGCAGTGAGCCGATATCGCATCATTGCACTCCAGCCTGAGCAACAAGAGTGAAATTTTGTCTCAAAAAAAAAAAAAAAAGAAA"
"chr14","15379094","15379705","JH378129","11955248","11955630","265","3423846","GGTTGGGTGCGGTGGCTTACCCCTGTAATCCCAGCACTTTGGGGGTACAAAGTGGGAAGATTGCTTGAGCCCAGGAGTTCAAGACCAGCCTGGGCAACTAAGCGAGATCCTATCTCTCAAAAAAATTTTGAAACAACTTTTTGGCCGGGCGCAGTGGCTCACGCCTGTGATCCCAGCACTTTGGGAGGCCAGGGCGGGCGGATCACGAGGTCAGGAGATCAAGACCATCCTGGCTAACACGGTGAAACCCCGTCTCTACTAAAAATACAAAAAATTAGCCGGGTGCGGTGGCGGGCACCTGTAGTCCCAGCTACTCGGGAGGCTGAGGCAGGAGGATGGCGTGAACCCGGGAGGTGGAGCTTGCAGTGAGCTGAGATCGGGCCACTGCACTCCAACCTGGACGACAGATCGAGACTCCGGCTCAAAAAAAAAAAAAATTAGCTGGGCGTGGTGGCGGGTGCGTGTAATCCCAGCTACTCGGGAGGCTGAGGCAGGAGAATCACTTGAACCTGGGAGGCAGAGGCTGCAGTGAGCCAAGATCGCGCCATTGCACTCCAGCCTGGGCAACAAGAGCGAAACTCTGTCTCTAAATAAATAAAATAAAATAAAAAA","GGCTGGGTACGGTGGCTCATGCCTGTAATCCCAGCACTTTGGGAGGTGGGTCACTTGAGGTCAGGAGTTCGAGACCAGCCTGTGCAGTGCCTCCATCCTCAACTGCTGCCTCATCAGCCTGGACCACTACCTGCTCATCCTCTCACCACTGCCACAAGCTGCGCATGAAGCTCCTGCGCGCGCCGGTGCCCGTCTCTACTAAAAATACAAAAATTAGCTGGGTGTGGTGGCAGGTGCCTGTAATCCCAGCTACTCAGGAGGCTGAGGCAGGAGAATCACTTGAACCCAGGAGGCAGAGGTTGCAGTGAGCCGATATCGCATCATTGCACTCCAGCCTGAGCAACAAGAGTGAAATTTTGTCTCAAAAAAAAAAAAAAAAGAAA"
"chr14","15386894","15387394","JH378114","15957391","15957789","201","570497","GCTGAGTGCAGTGGCTCACGCCTGTAATCCACTTTAGCAGGCCAAAATAGGGGGATCACTTTGAGGCCACGAGTTTGAGACCTGCCTGGGCAACATAGTGAGGCCCCGTCTCTACAAAAATCTTTAAATATTAGAATAACTTTGGGAGGCCGAGGCGGGTGGATCACGAGGTCAAGAGATTGAGACCATCCTGGCCAACATGGTGAAATCCCATCCCTACTAAAGCTACAAAAATTAGCCAGGCGTGGTGGTGTGCGCCTGTAGTCCCAGCTACTCGGGAGACTGAGGCAGGAGAATTGCTTGAATCCGCGTGGCGGAGGTTGCAGTGAGCTGAGATCGCGCCACTGCACTCCAGCCTGGTGACAGAGCGAGACTCCGTCTTAAAAAAAAAAAAAAAAAAAAAAAAAAAAACTTCGGAGGTTGCGGTGAGCCAAGATCACGCCATTGTACTCCAGCCTGGGCCACAAGAGCAAAACTCCGCTTCAAAAAAAAAAAAAAAAA","GCAAGGAACGGTGGCTCATGCCTGTCATCCCAGCACTTTGGGAGGCTAAGGAGGGTGGATTACCGAAGGTCATGAGTTTGAGACCAGCCTGACCAACATGGTGAAAACCCCATCTCTACTAAAAATACAAAAAATTAGCCAGATACAGCTATGCGGCAGACTGGGGCAGGAGAATCGCTTGGACCCAAACCCCATCTCTACTAAAAATACAAAAAATTAGCCGGATACAGCTATGCGGGAGACTGGGGCAGGAGAATCGCTTGGACCCGGGAGGCAGAGATTGCAGTGAGATGAGACCATGCCATTGCTCTCTAGCTTGTGCGATGAGAACAAGACTCTGTCTCAAAAAAAAAAAAAAAAAAAAAAAAAAAAAAAAAAAAAAAAGAGAGAGAGAGAAAA"
"chr14","20140478","20141066","JH378118","18053084","18053501","250","2087394","GCCAGGCGAGGTGGCTCATGCCTGTAATCCCAGCACTTTGGGAGGCTGAGGTGGGTGGAACACTTGAGGTCAGGAGTTCAAGACCAGCCTGGCCAACATGATGAAACCCCCATCTCTACTAAAAACACAAAAATTAGCCAGGAGTGGGCAGGGTGCGGTGGCTCACGCCTGTAATCCCAGCACTTTGGGAGGCTGGGATGGGTGGATCATGAGGTCGGGAGTTCAAGACCAGCCTGGCCAAGATGGTGAAACCCTGTCTCTATTAAAACTTCAAAAATTAGCCAGGCACGGTGGCAGGTGCTTGTAATCCCAGCTACTTGGGAGGCTGAGGCAGGAGAATCACTTGAAACTGGGCGGCAGAGGTTGCAGTGAGCCAAGATCGCGCCACTGGACTCCAGACTGGGCGACACAGTGAGATACCGTCTCAAAAAAAAAAAAAAAAAAAATTAGCCAGGAGTGGTGGCGGAAATCCCAGCTACTTGAGAGGCTGAGGCAGGAGAATCGTTTGAACCCAGGAGGCAGAGGTTGCAGTGAGCCAAGATCTTGCCATTGCACTCCAGCTTGGGAGACAAGAGCAAAACTCTGTCTC","GGCTGGGCGCAGTGGCTCACACCTGTAATCCCAGCACTTAGGGAAGCTGAGGCGAGTAGATCACCTGAGGTCAGGAGTTAGAGACCAGCCTGGCCATCATGGTGAAACCCCGTCTCTACTAAAGATACCAAAAATTAGCTGAGTGTGGTGCTGGGTGCCTGTAATCCCAGAAACTCAGGGTGCCTGTAATCCCAGCAACTCAGGGTGCCTTTAATCCCAGCAACTGAGGGTACCAGTAATCCCAGCAACTCAGGGTGTCTTTAATCCTAGCAACTGAGGGCACCTGTAATCCCAGCAACTCAGGAAGCTGAGACAGGAGAAGTACTTGAACCCAGAAGGCAGAGGTTGCAGTGAGCCGATATTGCACCATTGCACTCCAGTCTGGGCAACAAGAGTGAAACTCTGTCTCAAAAAAAAA"
"chr14","32019134","32019479","JH378197","6655183","6655524","67","25363951","GGCTGGGGCAGTGGCTCACTGTAATTCCAGCACTTGGCCAAGGCAGGTGGATCACCTGAGGTCAGGAGTTCAAGACCAGCAGGGCCAACATGGTGAAACCCTATCTCTAAAAATAAATAAATAAATAAATAAATAAAATAAAATAAAATAAAATAAAAAATAAAAAAAATTAGCTGGGCGTTGTGGTGGGCGCCTGTAATCCCAGCTACTTGGGAGGCTGAGGCAGGAGGATCGCTTGAACCTGGAAGGCAGAGGTTGCAGTGAGCCGAAATCACATAATTGCACTCCAGCCTGGGCGACAAGAGCAAAACTCCATCTCAAAAAAAAAAAAAAAAAAAAAAAAAAA","GGCCGGGCGCAGTGGCTCATGCCTGTAATCCCAGCACTTTGGGAGGCAGAGGCGGGCAGATCACCCAAGGTCAGGAGTTCAAGACCAGCCTGGCTAACATGGTGAAACCCCATTTCTACTAAAAATACAAAAAAAAAAAAAAAAAAAAAAAAAAAAAAAAAAAAAAATTAGCTGAGCGAGGTGGTGGGCACATGTAATCCCAGCTACTTCGGAGACTAAGGCAGGACAATTGCTTAAGCCTGGGAGGCAGAGGTTGTAGTAAGCTGAGATCACACCATTGCACTCCAGCTTGAGCAACAAGAGCGAAACTCCGTCTCAAAAAAAAACCCAAAAAACAAAAAA"
"chr14","39734996","39735596","JH378118","18053084","18053501","237","21681912","GGCTGGGCGCGGTGGCTCATGCCTGTAATCCCAGCATTTTGGGAGGCCGAGGCGGGTGGATCACCTGAGGTCAGGAGTTTGAGACCAGCCTGGCCAACATGGTGAAACCCTGTCTCTACTAAAAATGCAAAAATTAGGCTGGTGCAGTGGCTCACGCCTGTAATCACAGCACTTTGGGAGGCCGAGGTGGGCGGATCACGAGGTCAGGAGATCGAGACCATCCTGGCTAATACAATGAAACCCCGTCTCTATGAAAAATACAAAAAATTAGCCGGGCGTAGTGGCAGGCGTCTGTAGTCCCAGCTACTCAGGAGGCTGAGGCAGGAGAATGGCATGAACCTGGGAGGCGGAGCTTGCAGTGAGCCGAGATTGCGCCACTGCACTCCAGCCTGGGCGACAGCGAGACTCTGTCTCAAAAAAAAAAAAAAAAATTAGCTAGGCATGGTGGCGCATGCCTGTAATCCCAGCTACTTGGGAGGCTGAGGCAGGAGAATCGCTTGAACCTGGGAGGCAGAGGCTGCAGTGAGACAAGATCACGCCATTGCACTCCAGCCTGGGCAACAAGAGTGAAACTCCATCTTCCCCCTACCAAAAAAAAAAA","GGCTGGGCGCAGTGGCTCACACCTGTAATCCCAGCACTTAGGGAAGCTGAGGCGAGTAGATCACCTGAGGTCAGGAGTTAGAGACCAGCCTGGCCATCATGGTGAAACCCCGTCTCTACTAAAGATACCAAAAATTAGCTGAGTGTGGTGCTGGGTGCCTGTAATCCCAGAAACTCAGGGTGCCTGTAATCCCAGCAACTCAGGGTGCCTTTAATCCCAGCAACTGAGGGTACCAGTAATCCCAGCAACTCAGGGTGTCTTTAATCCTAGCAACTGAGGGCACCTGTAATCCCAGCAACTCAGGAAGCTGAGACAGGAGAAGTACTTGAACCCAGAAGGCAGAGGTTGCAGTGAGCCGATATTGCACCATTGCACTCCAGTCTGGGCAACAAGAGTGAAACTCTGTCTCAAAAAAAAA"
"chr14","49081899","49082239","JH378114","14264965","14265292","65","34816934","GGCCAGGTACAGTGGCTCATGCCTGTAATCTCAGCATTTTGGGAGGCTGAGGCAGGCAGATCACCTGAGGTCAGGAGTTCGTGACCAGCCTGACCAGTGAAACCCTGTCTCTACTGAAAAAAATAAAATAAAATAAAATAAAAATAAAAATTAGCTGGGTGTGGTGGTGGGCGCCTGTAATCCCAGCTACTCGGCAGGCTGAGGCAGGAGAATTGCTTGTACCCGGGAGGCGGAGGTTGCAGTGAGCCAAGATCATGCCATTGCACTACAGCCTAGGTGACAAGAGCAAAACTCTGTCTCAAAACAAAACAACAACAACAACAACAACTAAAAAAAAAAAA","GGCCAGGCGCGGTGGCTCAAGCCTGTAATCCCAGCACTTTGGGAGGCCGAGGCGGGTGGATCATGAGGTCAAGAGATCGAGACCATCCTGGTCAACATGGTGAAACCCCGTCTCTACTAAAAACAGAAAAAAAATAAAAATAAAAATAATTAGCTGGGCATGGTGGAGCATGCCTGTAATCCCAGCTACTCAGGAGGCTGAGGCAGGAGAATTGCCTGAACCGAGGAGGCGGAGGTTGCGGGGAGCCAAGATCGCGCCATTGCACTCCAGCCTGGGCAACAAGAGCGAAACTCCGTCTCAAAAAAAAAAAAAAAAAAAAAAAAAAAAA"
"chr14","54833704","54834332","JH378118","18053084","18053501","272","36780620","GGCCAGGTGCAGTGGCTCACTCCTGTAATTCCAGCACTTTGGGAGGCTGCCGGTGGATCACCTGAGGTCAGGAGTTCGAGATCAGCCTGGCCAACATGGTGAAACCCCGTCTCTACTAATAATACAAAAATTAGCCAGGCAAGGCCGGGCGCAGTGGCTCACACCTGTAATCCCAGCACTTTGGGAGGCCGAGGCGGGCGGATCACCTGAGGTCGGGAGTTCAAGACCAGCCTGACCAACATGGAGAAACCCCATCTCTACTAAAAATACAAAATTAGCTGGGCATGGTGGCACATGCCTGTAATCCCAGCTACTAGGGAGGCTGAGGCAGGCGAATCGCTTGAACCTGGGAGGTGGAGGTTGCGGTGGGCCGAGATGGTGCCATTGCACTCTAGCCCGGGCAACAAGAGCGAAACTCTGTCTCAAAAAAAAAAAAAAAAAAAAAAAAATTAGCCAGGCATGGTAGCACACCCTTGTAATCCCAGCTACTCGGGAGGCTGAGGCAGGAGAGTTGCTTGAACCCGAGAGACGGAGGTTGCAGTGAGCTGAGATCGTGCCATTGCACTCCAACCTGGGTGACAAGAGTGAAACTCCATCTCCAAAAAAAAAAATAAATAAAATAAATAAAA","GGCTGGGCGCAGTGGCTCACACCTGTAATCCCAGCACTTAGGGAAGCTGAGGCGAGTAGATCACCTGAGGTCAGGAGTTAGAGACCAGCCTGGCCATCATGGTGAAACCCCGTCTCTACTAAAGATACCAAAAATTAGCTGAGTGTGGTGCTGGGTGCCTGTAATCCCAGAAACTCAGGGTGCCTGTAATCCCAGCAACTCAGGGTGCCTTTAATCCCAGCAACTGAGGGTACCAGTAATCCCAGCAACTCAGGGTGTCTTTAATCCTAGCAACTGAGGGCACCTGTAATCCCAGCAACTCAGGAAGCTGAGACAGGAGAAGTACTTGAACCCAGAAGGCAGAGGTTGCAGTGAGCCGATATTGCACCATTGCACTCCAGTCTGGGCAACAAGAGTGAAACTCTGTCTCAAAAAAAAA"
"chr14","55277737","55278067","JH378148","10302642","10302970","61","44975095","GGCCGGGTGCAGTGGCCCACCTCTGTAATCCTAACACTTTGGGAGGCCAAGGCAGGCAGGTCACTTGAGGTCAGGAGTTCAAGACTAACCTGGCCAACATGGTGAAACCCCGTCTCTACTAAAAATACGAAAATTAGCCGGGCTTCATGATGCATGCCTGTAATCCCAGCTACTAAGGAGGCTGAGGCAGAAGAATCTCTTGAACCCATGAGGTTGCAGTGAGCTGAGATCTCGCCATTGCACTCCAGCCTGGAGGACAAGAGCGAAACTCTGTCTCAAAAAAATAAAATAAAATAAATAAGAATAAAATAATAATAAAAGGCAAAAAGAA","GGCCGGGCGCGGTGGCTCAAGCCTGTAATCCCAGCACTTTGGGAGGCCGAGGCGGGTGGATCACGAGGTCAAGAGATCGAGACCATCCTGGTCAACATGGTGAAACCCCGTCTCTACTAAAAATACAAAAAATTAGCTGGGCATGGTGGTGGGTGCCTGTAATCCCAGCTACTCAGGAGGCTGAGGCAGGAGAATTGCCTGAACCCAGGAGGCGGAGGTTGCGGTGAGCCGAGATCGCGCCATTGCACTCCAGCCTGGGTAACAAGAGTGAAACTCTGCCTCAAAAAAAAAAAATAAAATAAAATAAAATAAAATAAAATAAAATAAAA"
"chr14","55822103","55822700","JH378118","18053084","18053501","240","37769019","GGCCAGGCGCAGTGGCTCACGCCTGTAATCCCAGCACTTTAGGAGGCCGAGGCAGGTGGATCGCCTGAGTTCAGGAGTTCAAACCCACCCTGGCCAACATGGTGAAACCCTGCCTCTACTAAAAAACAAAAAAATGGCCAAGCGTGGTGGCTCACGCCTGTAATTCCAGCACTTTGGGAGGCTGAGGCAGGCGAATCACGAGGTCAGGAGATCGAGACCATCCTGGCTAACATGGTGAAACCCCATCTCTATTAAAAATACAGAAAATTAGCCAGGCGTGGTGGTGGACGCCTGTAGTCCCAGCTTCTTGGGAGGCTGAGGCAGGAGAATGGCATGAACCCGGGAGGCAGAGCTTGCAGTGAGCTGAGATTGCGCCAGTGCACTACAGCCTGTGGGACAGAGCAACTCCGTCTCAAAAAAAAAAAAAATTAGCTGGGCATGGTGGCATATGCCTGTAATCCCAGCTACTAAGGAGGCTGAGGCGGGAGAATCGCTTGAACCCGGGAGGCAGAGGTTGCAGTGAGCCGAGATTGCGCCATTGCACTCCAGTCTGGACAACAAGAGTGAACTGTGTCTCAAAAAAAAAAAAAAAAAAAGA","GGCTGGGCGCAGTGGCTCACACCTGTAATCCCAGCACTTAGGGAAGCTGAGGCGAGTAGATCACCTGAGGTCAGGAGTTAGAGACCAGCCTGGCCATCATGGTGAAACCCCGTCTCTACTAAAGATACCAAAAATTAGCTGAGTGTGGTGCTGGGTGCCTGTAATCCCAGAAACTCAGGGTGCCTGTAATCCCAGCAACTCAGGGTGCCTTTAATCCCAGCAACTGAGGGTACCAGTAATCCCAGCAACTCAGGGTGTCTTTAATCCTAGCAACTGAGGGCACCTGTAATCCCAGCAACTCAGGAAGCTGAGACAGGAGAAGTACTTGAACCCAGAAGGCAGAGGTTGCAGTGAGCCGATATTGCACCATTGCACTCCAGTCTGGGCAACAAGAGTGAAACTCTGTCTCAAAAAAAAA"
"chr14","55860214","55860812","JH378118","18053084","18053501","246","37807130","GGCCGGATGCAGTGGCTCACGCCTGTAATCCCAGCACTTTGGGAGGCCAAGGCAAGCGGATCACCTGAGGTCAGGAGTTCAAGACCAGCCTGGCCAGCATGGTGAAACCCCTTCTCTACTAAAAATACAAAAATTAGCCGGGGCCTTGCGTGGTGGCTCACACCTGTAAATCCCAGCGCTTTGGGAGGCCGAGGCAGGCGGATCACCTGAGGTCGGGAGTTCAAGAACAGCCTGACCAACATGGAGAAACCCCGTCTCCACTAAAAATAGAAAAATAGCCGGGCATGGTGGCGCATGCTTGTAATCTCAGCTACTCGGGAGGCTGAGGCAGGAGATCACTTGAACCCAAGAGGCAGAGGTTGCGGTGAGCCGAGATCGCGCCATTGCACTCCAGCCTGGGCAACAAAGAGCGAAACTCCGTCTCCAAAAAAAAAAAAAAAAAATTAGCCGGGCGTGGTGGCACATACCTGTAATCCCAGCTATTCAGGAGGCTGAGGCAGGAGAATCCCTTGAACCCGGGAGGCAGAGATGGCAGTGAGCTGAGATCACGCCATTGCACTCCAGCCTGGGTGAGAGGAGTGAAACTCCGTCTAAAAAAA","GGCTGGGCGCAGTGGCTCACACCTGTAATCCCAGCACTTAGGGAAGCTGAGGCGAGTAGATCACCTGAGGTCAGGAGTTAGAGACCAGCCTGGCCATCATGGTGAAACCCCGTCTCTACTAAAGATACCAAAAATTAGCTGAGTGTGGTGCTGGGTGCCTGTAATCCCAGAAACTCAGGGTGCCTGTAATCCCAGCAACTCAGGGTGCCTTTAATCCCAGCAACTGAGGGTACCAGTAATCCCAGCAACTCAGGGTGTCTTTAATCCTAGCAACTGAGGGCACCTGTAATCCCAGCAACTCAGGAAGCTGAGACAGGAGAAGTACTTGAACCCAGAAGGCAGAGGTTGCAGTGAGCCGATATTGCACCATTGCACTCCAGTCTGGGCAACAAGAGTGAAACTCTGTCTCAAAAAAAAA"
"chr14","56736257","56736880","JH378206","6546474","6546861","276","50189783","GGCCAGGCACAGTGGCTCATGCCTGTAATCCCTGCACTTTGGGAGGCCAAGGCGGGTGGATCACCTGAGGTCAGGAGTTCGAGACTAGCCTGGCCAACATGGTTGGCCATCTCTTCTAAAAATACAAAAAATTAAGTTGGGCATGGTGGCTCATGCCTGTAATCCCAGCATTTTGGGAGGCCAAGGCAGGTGGATCATAAGGTCAAGAGATTGAGACCATCCTGGCCAACATGGTGAAACCCCATCTCTACTAAAAATACAAAAATTAGCTGGGCGTGGTGGTAGCACACACCTGCAGTCCCAGCTGCTCAGGAGGCTGAGGCAGGAGAATCACTTGAACCCGGGAAGCAGAGGTTGCAGTGAGCCGAAATTGCACCACTGCACTCCAGCCTGGCGACAAAGCAAGACTCCGTCAAAAAAAAAAAAAAAAAAAAAAAAATTAGCCAGGAGTGGTGGCACGTGCCTATAGTTCCAGCTACTCGGGAGGCTGAGGCAAGAGATTTGCTTGAACCTGGGAAGCAGAGGTTGCATATATTGCAGTGAGCCAAGATTATGCCATTGCACTCCAGCCTGGGCAACAAGAGTGAAAATCTGTCTAAAAAGAAAAAAAAAAGAAAAGAAAAA","GGCCACACATGGTGGCTAACGCCTGTAATCCCAGCACTTTGGGAGGCCAAGTCGGGTGGATCATGAGGTCAGGAGACCAAGACCATCCTGGCCAAATGGTGAAACCCCGTCTCTACTAAAAATACAAAAATTAGCTGGGCATGGTGGCGTGTGCCTGTAATCCCAGCTACTCAGGAGGCTGAGGCAGGACAATTGCCTGAACCCAGGAGAATTAGCTGGGCATGGTGGCGTGTGCCTGTAATCCCAGCTACTCAGGAGGCTGAGGCAGGACAATTGCCTGAACCCAGGAGGCGAAGGTTGCGGTGAGCCGAGATTGTGCCATTGCACTCCAGCCTGGGTAACAAGAGCGACACTCTGTCTCAAAAAAAAAAAAAAAAAAAAAAAAAAA"
"chr14","56744047","56744674","JH378118","18053084","18053501","281","38690963","GGCCGGGTGCGGTGACTCACATCTATAATCCCAGCACTTTGGGAGGCCAAGGCAGGTGGATCACCTGAGGTCAGGAGTTCAAGACCAGCCTGGCCAACTTGGTGAAACCCCATCTCTACTAAAAAATATAAAAATTTGCCAGGTGCGGTGGCTCATACCTGTAATCCCAGCACTTTGAGAGGCAGAGGTGGGTGGATCACGAGGTCAGGAGTTCGAGACCAGCCTGGCCAATGTGGTGAAACCCCATCTCTACTAAAAATACAAAAATTAGCCGGGTGTGGTGATGCGTGCCTGTAGTCCCAGCTATTCGGGAGGTTGAGGCAGGAGAATGGCGTGAACCAGGAAGGCGGAGCTTTCACTGAGCGGAGATCGCACCACTGCACTCCAGCCTGGGCGACGGAGCGAGACTCTGTCTCAAAAACAAAACAAAACAAAAAAACAAACAAACAAAAAAACATTATCCGGGTGTGGTGGTGGGCGCCTGTAATCCCAGCTACTTGGGAGGCTGAAGCAGGAGGATTGCTTGAACCTGGGAGGTGGAGGTTGCAGTGAGCTGAGATCACGCCTCTGCACTGCAGGCTGGACGACAAGAACAAAACTCTGAATCAACAACAACAACAACAAAAAA","GGCTGGGCGCAGTGGCTCACACCTGTAATCCCAGCACTTAGGGAAGCTGAGGCGAGTAGATCACCTGAGGTCAGGAGTTAGAGACCAGCCTGGCCATCATGGTGAAACCCCGTCTCTACTAAAGATACCAAAAATTAGCTGAGTGTGGTGCTGGGTGCCTGTAATCCCAGAAACTCAGGGTGCCTGTAATCCCAGCAACTCAGGGTGCCTTTAATCCCAGCAACTGAGGGTACCAGTAATCCCAGCAACTCAGGGTGTCTTTAATCCTAGCAACTGAGGGCACCTGTAATCCCAGCAACTCAGGAAGCTGAGACAGGAGAAGTACTTGAACCCAGAAGGCAGAGGTTGCAGTGAGCCGATATTGCACCATTGCACTCCAGTCTGGGCAACAAGAGTGAAACTCTGTCTCAAAAAAAAA"
"chr14","58283278","58283584","JH378115","34663603","34663898","52","23619675","CCGGGTGCGGTGGCTCACGCCTGTAATCCCAGCACTTTGGGAAGCTGAGGTGGGTGGATCATTTGAGGTCAAGAGTTCTAGACCAGCCTGGCCAACATGGTGAAACCCTACTTCTAATAAACACACACACACACACACACACACACACACACACACAAATTAGCCAGCAGGCACCTGTAATCCCAGCTACTCGGAAGGCTGAGGCAGGACAATCGCTTGAACCTGGGAGGCCAGAAGTTGCAGTGAGCCAAGATCATGCCACTGCACTCCAGTCTGGGTGACAAGAGCAAGACTCCATTTCAAAAAA","GGCCTGGTGAAGTGGCTCACGCCTGTAATCCCAACACTTTGGGAGGCTGAGATGGATGGCTCATTTGAGGTCAGGAGTTCTAGACCAGCCTGGCCAACATGGTAAAAGCCCACCTCTACCAAAAATACAAAAACAAAAACAAAAAAATTTTAGCCAACAGGCACCTTTAATCCCAGCTACTCAGGAGGCTGAGGCAGGAGAATTGCTTGAATCTGGGAGGCCAGAAGTTGCAGTGAGCCAGGATCACACCACTGCACTCCATCCTAGGCGACAAGAGCAAGACTCCAAAAAAAAAA"
"chr14","59226808","59227410","JH378118","18053084","18053501","257","41173724","GGCTGGGCGCTGTGGCTCATGCCTGTAATCCCAGCACTTTAGGAAGCCAAGGGAGGTGGATCACCTGAGGTCAGAGTTCAAGTCCGGCCTGACCAACATGGCGAAACCCAGTCTCTACTAAAAATACAAAATTGGCCAGGCGTGGGGTGGCTCACACCTGTAATCCCAGCACTTTGGGAGGCCGAAGTGGGTGGATCACTTGAGGTCAGGAGTTTGAGACCAGCCTGGTTAACATGGTGAAACCCCATCTCTACTAAAAATACAAAAATTAGCCAGGCATGGTGGCAGGCGCCTGCAATCCCAGTTACTCAGGAGGCTGGTGCAGGAGAATCGCTTAAACCTAGGAGGCAGAGGTTGCAGTGAACTGAGATCGTGCCATTGCACTCCAGCCTGGGTAACAACAGCAAGACTTCATCTCAAAAAAAAAAATACATAATTATAATTAGCTGGGCGTGTTGGCGAGCGCCTGTAGTCCCTGCTACTTGGGAGGCTGAGGCAGGGGAATCACTTGAACCTGAGAGGCGGAGGTTGCAGTGAGCCAAGTCACGCCATTGCATTCCAGCCTCGGCAACAAGAGCAAAACTCCATCTCAAAAAAAAAAAA","GGCTGGGCGCAGTGGCTCACACCTGTAATCCCAGCACTTAGGGAAGCTGAGGCGAGTAGATCACCTGAGGTCAGGAGTTAGAGACCAGCCTGGCCATCATGGTGAAACCCCGTCTCTACTAAAGATACCAAAAATTAGCTGAGTGTGGTGCTGGGTGCCTGTAATCCCAGAAACTCAGGGTGCCTGTAATCCCAGCAACTCAGGGTGCCTTTAATCCCAGCAACTGAGGGTACCAGTAATCCCAGCAACTCAGGGTGTCTTTAATCCTAGCAACTGAGGGCACCTGTAATCCCAGCAACTCAGGAAGCTGAGACAGGAGAAGTACTTGAACCCAGAAGGCAGAGGTTGCAGTGAGCCGATATTGCACCATTGCACTCCAGTCTGGGCAACAAGAGTGAAACTCTGTCTCAAAAAAAAA"
"chr14","62992080","62992681","JH378118","18053084","18053501","256","44938996","GGCCGGATGCAGTGGCCCACACCTGTAATCCTAGCACTTTGAGAGGCTGAAGCAGGCAGATCACTTGCGGTCAGGAGTTTGAGACCAGCCTGGCCAACATAGTAAAACCTCATCTCTACTAAAAATAGAAAAATTTTCTGACCAGGCACGGTGGCTCGCGCCTGTAATCCCAGCACTTTGGGAGGCCAAGGTGGGCACATTACCTGAGATCAAGAGTTCAAGACCAGCCTGACCAACATGGCAAAACTCTGTCTCTACTAAAAATACAAAATTAGCCGGGCATAGTGGCGCATTCCTGTAATCCCAGCTACTAAGGAGGCTGAGGCAGGAGAATTGCTTGAACCCGGGAGCCGGAGGTTGCAGTAAGCCAAGATTGCGCACTGCACTCTAGGCTGGGCAACAACAGCGAAACTCTGTCTCGAAAAAAAAAAAAAAAAAAATTAGCTGGGCGTGGTGGTGAGTACCTGTAATCCCAGCTACTTGGGAGACTGAGGCAGGAGAATCTCTTGAACCTGGGAGGTAGAGGTTGCAGCGAGCTTAGATCACACCACTGCACTAAAGCCTGGGGGACAAGAGCAAAACTCTATCTCAAAAAAATAAAA","GGCTGGGCGCAGTGGCTCACACCTGTAATCCCAGCACTTAGGGAAGCTGAGGCGAGTAGATCACCTGAGGTCAGGAGTTAGAGACCAGCCTGGCCATCATGGTGAAACCCCGTCTCTACTAAAGATACCAAAAATTAGCTGAGTGTGGTGCTGGGTGCCTGTAATCCCAGAAACTCAGGGTGCCTGTAATCCCAGCAACTCAGGGTGCCTTTAATCCCAGCAACTGAGGGTACCAGTAATCCCAGCAACTCAGGGTGTCTTTAATCCTAGCAACTGAGGGCACCTGTAATCCCAGCAACTCAGGAAGCTGAGACAGGAGAAGTACTTGAACCCAGAAGGCAGAGGTTGCAGTGAGCCGATATTGCACCATTGCACTCCAGTCTGGGCAACAAGAGTGAAACTCTGTCTCAAAAAAAAA"
"chr14","75046278","75046878","JH378118","18053084","18053501","246","56993194","GGCCGGGCACAGTGGCTCACACCTATAATCTCAGTACTTTGGGAGGCCAAGGCGGGCAGATCACTTGAGGTCAGGAGTTCGAGACCACCCTGGCCAACATGGTGAAACCTCATCTCTACTAAAAATACAAAAAACTGGCTGGGTGAAGTGGCTCACGCCTGTAATCCCAGCAGTTTGGGAGGCCAAGGCGGGCCAATCACGAGGTCAGGAGTTCGAGACCAGCCTGGCCAATATGGTGAAACCCCGTCTCTATTAAAAATTCAAAAATTAGCTGGATGTGGTGGCAGGCACCTACAATCCCAGCTACTTGGAAGGCTGAGGCAGGAGAGTCTGCTTGAAACCAGAAGGCGGAGGTTGCAGTGAGTGAGCTGAGAACGTGCCACTGCACTCCAGCCTGGGCGAAAGAGCAAAACGCTGTCTCAGGGGGAAAAAAAAAACTAGCCGGGCATGGTGGCAGGTGCCTGTAATCCCAGCTACTCAGGAGGCTGAGGCAGGAGAATTGCTTGAACCCAGGAGGAGGAGGTTGCAGTGAGTCGAGATCACGTCATTGCACTCCCAGCCTGGCTGATAAGAGCGAAACTCCGTCAAAAAAAAAAAAAAA","GGCTGGGCGCAGTGGCTCACACCTGTAATCCCAGCACTTAGGGAAGCTGAGGCGAGTAGATCACCTGAGGTCAGGAGTTAGAGACCAGCCTGGCCATCATGGTGAAACCCCGTCTCTACTAAAGATACCAAAAATTAGCTGAGTGTGGTGCTGGGTGCCTGTAATCCCAGAAACTCAGGGTGCCTGTAATCCCAGCAACTCAGGGTGCCTTTAATCCCAGCAACTGAGGGTACCAGTAATCCCAGCAACTCAGGGTGTCTTTAATCCTAGCAACTGAGGGCACCTGTAATCCCAGCAACTCAGGAAGCTGAGACAGGAGAAGTACTTGAACCCAGAAGGCAGAGGTTGCAGTGAGCCGATATTGCACCATTGCACTCCAGTCTGGGCAACAAGAGTGAAACTCTGTCTCAAAAAAAAA"
"chr14","83813857","83814442","JH378118","18053084","18053501","240","65760773","GGCCAGGCGCGGTGGCTCACGCCTGTAATCCCAGCACTTTGGGAGGCCGAGGCGGGCGGATCACCTGAGGTCAGGGGTTCAAGACCAGCCTGACCATCCCAGAACTTTGGGAGGCCGAGACGGGTGGATCATGAGGTCAGGAGATCGAGACCATCCTGGCTAACACAGTGAAACCCCATCTCTATTAAAAATACAAAAAATTAGCCGGGCGTGGTGGCAGCTCCTGTAGTCCCAGCTACTCGGGAGGCTGAGGCAGGAGAATGGCGTGAACCCGGGAGGCGGAGCTTGCCGTGAGCCGAGATCGCACCACTGCACTCCAGCCTGCAAGATAGCGAGGCTATGTCTCAGGAAAAAAAAAAAAAAAAAAAAAAAGACCAACCTGACCAACATGGTAAAACCCCATCTCTACTAAAAATACAAAATTAGCCGGGCATGGTGGCAGACGCCTGTAATCCCAGCTACTCAGGAGGCTGAGGCAGGAAAATCACTTGAACCCAGGAGGTGGAGGTTGCGGTGAGCCGAGATCGTGCCATTGCACTCCGGCCTGGGTGACAACAGCGAAACTCCATCTCAAAAAAAAGAAAAA","GGCTGGGCGCAGTGGCTCACACCTGTAATCCCAGCACTTAGGGAAGCTGAGGCGAGTAGATCACCTGAGGTCAGGAGTTAGAGACCAGCCTGGCCATCATGGTGAAACCCCGTCTCTACTAAAGATACCAAAAATTAGCTGAGTGTGGTGCTGGGTGCCTGTAATCCCAGAAACTCAGGGTGCCTGTAATCCCAGCAACTCAGGGTGCCTTTAATCCCAGCAACTGAGGGTACCAGTAATCCCAGCAACTCAGGGTGTCTTTAATCCTAGCAACTGAGGGCACCTGTAATCCCAGCAACTCAGGAAGCTGAGACAGGAGAAGTACTTGAACCCAGAAGGCAGAGGTTGCAGTGAGCCGATATTGCACCATTGCACTCCAGTCTGGGCAACAAGAGTGAAACTCTGTCTCAAAAAAAAA"
"chr14","84224287","84224910","JH378118","18053084","18053501","265","66171203","GGCAGGGTGCAGTGGCTCATACCTGTAATCCCAGCACTCTGGGAGGCCGAGGTGGGCAGATCACTTGAGCTCAGGAGTTTGAGACCAGCCTGGCCAACATAGTGAAACCCCATCTCTACTAAAAATACAAAATTAGGCTGGGCACAGTGACTCACGTCTGTAATCCCAGCACTTTGGGAGGCCGAGGCTGGTGGATCACAAGGTCAGGAGATCAAGACCATCCTGTCCAACATAGTGAAACCCCATCTCTACTAAAAATACAAAAATTAGCTGGACGTGGAGGTGCACATCTGTAGTCCCAGCTACTTGTGAGGCTGAGGCAGGAGAACTGCTTGAACCCAGGAGGCGGAGGCTGCAGTGAGCTGAGATTGTGCCACTGCACTCCAGCCTGGGCGACAGAGCGAGACTCTGTCTCAAAAAAAAAAAAAAACAGAAAAAACAAAATTAGCCGGGCATGGTGGTGCACGCCTGTAACCCCAGCTACTTGGGGGGCTGAGGCAGGAGAATTGCTTGAACCTGAGAGGTGGAGGTTTCAGTGAGCCGAGATTGTGCCATTGCCCTCCAGTCTGGGCAACAAGAGCAAAACTCCGTCTCAAAAAAAAAAAAAAGAAAAAAAAAGAAGAA","GGCTGGGCGCAGTGGCTCACACCTGTAATCCCAGCACTTAGGGAAGCTGAGGCGAGTAGATCACCTGAGGTCAGGAGTTAGAGACCAGCCTGGCCATCATGGTGAAACCCCGTCTCTACTAAAGATACCAAAAATTAGCTGAGTGTGGTGCTGGGTGCCTGTAATCCCAGAAACTCAGGGTGCCTGTAATCCCAGCAACTCAGGGTGCCTTTAATCCCAGCAACTGAGGGTACCAGTAATCCCAGCAACTCAGGGTGTCTTTAATCCTAGCAACTGAGGGCACCTGTAATCCCAGCAACTCAGGAAGCTGAGACAGGAGAAGTACTTGAACCCAGAAGGCAGAGGTTGCAGTGAGCCGATATTGCACCATTGCACTCCAGTCTGGGCAACAAGAGTGAAACTCTGTCTCAAAAAAAAA"
"chr14","85020958","85021268","JH378108","34510794","34511096","52","50510164","GCCAGGTGCAGTGGCTCATGCCTGTAATTCCAGTACTTTGAGAGGTCGAGACAGGGAGATCACCTGAGGCCAGGAGTTCAAGACTAGCTTGGCCAACATGGCAAAACCCTGTCTCTACTAAAAATGCAAAAAAAAAAAAAAAAAAAAAAAAAAAATTAGCCTGGCATGGTGGTAGACACCTGTAATCCCAGCTACTTGGGAGGCTGAGACAGGAGAACCTCTTGAATCTGGGAGGAGGAGGTTGCTGTGAGCTGAGATCGTGCCACTGCACTCCAGCCTGGGTAACAAGAGAGAAACTCTGTCTCAAAAAA","GGGTGCCGTGTCTCATGCCTGTAATTCCAGCACTTTGGGAGGTCAAGGCAGTCCGATCACCTGAGGTCAGGAGTTTGAGACTAGCCTGGCCAAAATGGTGAAACCCTGTCTCTAGAAAAAATACAAAAAAAAAAAAAAAAAAAAAAAAAAATTAGCTGGATGTAGTGGTGCATACCTGTAGTCCCAGCTACTCTGGAGGCTGAGGCAGGAGAATTGTTTGAACCCAGGAGGCGGAGGTTGCGGTGAGCCGAGATCATGCCATTGCACTCCAGCCTGGGAAACAAGAGTGAAACTCTGTCTCAA"
"chr14","86696589","86696920","JH378203","2698403","2698735","56","83998186","GGCCAGGCACGGTGGCTCATGCCTATAACCAGCACTTTGGAGGCCGAGGCAGGTGGATCACCTGAGGTCAGGAGTTTGAGACTGGCCTGGCCAGCATGGTGAAACTCTGTCTCTACTAAAAAAAAAAAAAAAAAAAAAAAAAAAAAAGTACAAAATTAGCTGGATGTGGTGGTAGGCACCTGTAATCCCAGCTACTTGGGAGGCTGAGGCAGGAGAATCGCTTGAACCCAGGAGGCAGAGATTGCAGTGAGCCAAGATTGCGCCATTGTACTCCACTCTGGGCAATGAGCGAAACTCCGTCTCAAAAAAAAAATAAAATAAAAATAAAATAA","GCCGGGTGCAGTGGCTCATACCTCTAATCCCAGCACTTTGGGAGGCCAAGGCAGGTGATCACCTGTGGTCAGGAGTTCGAGACCAGCCTGGCCAACATGGTGAAACCCTGTCTTTACTAAAAATACAAAAAAAAAAAAAAAAAAAAAAAAAAAAAACTTAGCCCACCATGGTGGTGGGCTCTTGTAGTCCCAGCTACATGGGAGGCTGAGGCAGAAGAATCGCTTGAAGACAGGAGGTGGAGGTTGCAGTGAGCCAAGACTGCGCCATTGCACTCAGCCTGGGTGACGAGCCAAACTCCATCTCAAAAAAAAAAAAAAAAAAAAAAAAAAAAA"
"chr14","86944567","86945185","JH378118","18053084","18053501","274","68891483","GAGCACGGTGGCTCACGCCTGCAATCCCAGCACTTTGGGAGGCCGAGGTGGGTGGATCACCTGAGGTTAGGAGTTTGAGACCAGCCTGGCCAACATGGTGAAACCGTCTCTACTAAAAATGCAAAAAAGTAGGGGCCGGGCACGGTGGCTCACGCCTGTAATCCCAGCACTTTGGGAGTCTGAGGCAGACGGATCACAAGGTCAGGAGATCAAGACCATGGTGAAACTCCGTCTCTACTAAAAATACAAAAAATTAGCTGGGCGTGGTGGTGGGCACCTGTAGTCCCAGCTGCTTGGGAGGCTGAGGCAGGAGAATGGTGTGAACCCGGGAGGCGGAGCTTGCAGTGAGCCGAGATCGCAACACTGCACTCCAGCCTGGGCGACAGAGCGAGACCCTGTCTCAAAAAAAACAAAAATAAACAAAAATAAATAAATACAAAAAAGTAGCCAGGCATGGTGGTGGGTGCCTGTAATCCCAGCTACTTGGGAGGCTGAGGCAGGAGAATCACCTGAACCCGGGAGGTGGAGGTTGCAGTGAGCCAAGACCGTGTCATTACACTCTAGCCTGGGCAACAAGAGCGAAATTCCATCTGAAAAAATAAATAAATAAAAATAAAAA","GGCTGGGCGCAGTGGCTCACACCTGTAATCCCAGCACTTAGGGAAGCTGAGGCGAGTAGATCACCTGAGGTCAGGAGTTAGAGACCAGCCTGGCCATCATGGTGAAACCCCGTCTCTACTAAAGATACCAAAAATTAGCTGAGTGTGGTGCTGGGTGCCTGTAATCCCAGAAACTCAGGGTGCCTGTAATCCCAGCAACTCAGGGTGCCTTTAATCCCAGCAACTGAGGGTACCAGTAATCCCAGCAACTCAGGGTGTCTTTAATCCTAGCAACTGAGGGCACCTGTAATCCCAGCAACTCAGGAAGCTGAGACAGGAGAAGTACTTGAACCCAGAAGGCAGAGGTTGCAGTGAGCCGATATTGCACCATTGCACTCCAGTCTGGGCAACAAGAGTGAAACTCTGTCTCAAAAAAAAA"
"chr14","87180871","87181803","JH378118","18053084","18053501","547","69127787","GGCCATGTGCGGTGGCTCACACCTGTAATCCCAGCACTGTGGGAGGCCAAGGTGGGCGGATCATTTGAGGTCAGGAGTTCTAAACCAGCCTGGCCAATATGGTGAAACACTGTCTCTGCTAAAAATACAAAAAAAGAAAAAGAAAAAAAAAAAAAGGCTGGGCACGGTGGCTCACGCCTGTAATCTCAGCACTTTGGGAGGCTGAGGTGGGTGGATTACCTGAGGTCAGGAGTTCGAGACCAGCCTGGCCAACATGGTGAAACCTTGTCTCTACTAAAAGTATAAAAATTAGCCAGGTGTGGTGGAGGTCGCCTGTAATCCCAGCTACTCAGTAGGCAGAGGCAGAAGAATCCGTTGAACCTGGGAGGCGGAGGTTGCAGTGAGCTGAGATTGCACCAGTGCATTCCAGCCCGGGTGACAAGAGTGAGACTCTGTCTCAAAATAAACAAACAAAAAAATTAGTGGGCCGGGTTCAATGACTCACGCCGGTAATCCCAGCACTTTGGGAGGCCAAGGAAGGCAGGTCACCTGAGGTCGGGAGCTCGAGACCAGCCTGACCAACATGGAGAAACCCCGTCTCTACTAAAAATACAAAATTAGCTGGGCGTGGTGGCACATGCCTGTAATTCCAGCTACTCAGGACGCTGAGGCAGGAGAATTGCTTGAACCCAGGAGGCGGAAGTTGCAGTGAGCCAAGATCATGACATTGCACTCCCGCCTGGGCGCCAAGAGTGAGATTTCGTCTCAAACAAACAAACAAAAAAACGAATTAGTGGAGCGTGGTGGCAGGCACCTAAAGTCCCAGCTATTCAGGAGGCTGAGGCAGGAGAATTGCTTGAACCTGGGAAGTGGAGGTTATAGTGAGCTGAGATCGCGCCATTGCACTCCAGCCTGGGCAACAAGAGTGAGAATCTGTCTAAAAAAAAAAAAGAA","GGCTGGGCGCAGTGGCTCACACCTGTAATCCCAGCACTTAGGGAAGCTGAGGCGAGTAGATCACCTGAGGTCAGGAGTTAGAGACCAGCCTGGCCATCATGGTGAAACCCCGTCTCTACTAAAGATACCAAAAATTAGCTGAGTGTGGTGCTGGGTGCCTGTAATCCCAGAAACTCAGGGTGCCTGTAATCCCAGCAACTCAGGGTGCCTTTAATCCCAGCAACTGAGGGTACCAGTAATCCCAGCAACTCAGGGTGTCTTTAATCCTAGCAACTGAGGGCACCTGTAATCCCAGCAACTCAGGAAGCTGAGACAGGAGAAGTACTTGAACCCAGAAGGCAGAGGTTGCAGTGAGCCGATATTGCACCATTGCACTCCAGTCTGGGCAACAAGAGTGAAACTCTGTCTCAAAAAAAAA"
"chr15","7203590","7204226","JH378118","18053084","18053501","285","10849494","GGCCAGGTGCAGTGGCTCATGCCTCTAATCCCAGCACTTTGGGAGGCCGAGATGGGCAGATCACCGGAGGTCAGGAGTTTGAGACCAGCTTGGCCAAAATGGTGAAACCCTGTCTCTACAAAAAAATACAAAAATGGCTAGGCACGGTGGCTCACACCTGTAATCCCAGCACTTTGGGATACAGGTGGATCATGAGGTCAAGAGATCAAGATCATCTTGGCCAACATGGCAAAACCCTGTCTCTACTAAAAAATACAAAAAATTAGCTGGGCGTGGTGGTGCACGCCTGTAGTCCCAGCTACTCAGGAAACTGAGGCAAGAGAATCGCTTGAACCTGGGAGGTAGAGGTTGCAGTGAGCCGAGATGCACTCCAGCCTGGCAACAGAACAAGACTCCATCTCAAAGAACAAAAACAAAACAAAACAAAACAAAAGACAAGCAAACAAAAAAATACAAAAATTAGCTAGGTGTGGTGGCAGGCGCCTGTAATCCCAGCTACTCAGGAGGCTGAGGCAGGAGAATCGCTTGAACCTGGGAGGCGGAGGTTGCAGTGAGCCAAGATTGTGCCATTGCACTCCAGCCTAGGTGACAAGAGTGAAAAGACGTCTCAAAAACAAAACCAAAAAAAAAAATAAAA","GGCTGGGCGCAGTGGCTCACACCTGTAATCCCAGCACTTAGGGAAGCTGAGGCGAGTAGATCACCTGAGGTCAGGAGTTAGAGACCAGCCTGGCCATCATGGTGAAACCCCGTCTCTACTAAAGATACCAAAAATTAGCTGAGTGTGGTGCTGGGTGCCTGTAATCCCAGAAACTCAGGGTGCCTGTAATCCCAGCAACTCAGGGTGCCTTTAATCCCAGCAACTGAGGGTACCAGTAATCCCAGCAACTCAGGGTGTCTTTAATCCTAGCAACTGAGGGCACCTGTAATCCCAGCAACTCAGGAAGCTGAGACAGGAGAAGTACTTGAACCCAGAAGGCAGAGGTTGCAGTGAGCCGATATTGCACCATTGCACTCCAGTCTGGGCAACAAGAGTGAAACTCTGTCTCAAAAAAAAA"
"chr15","13675429","13675731","JH378235","1186107","1186418","53","12489322","GGCTTGGCACAGTGGCTCATGCCTGTAATCCCAGCACTTTGAGAGACCGAGGCAAGTGGATCCCAGGAGTTCAAGACCAGCCTGGCCAAGATGGTGAAACCCCCCATCTCTACTAAAAATACAAAAAAAAAAAAAAAAAAAAAAAAAGGGCTTAGTGGCTGGCAGCTGTAGTCCCAGCTACTCGGGAGGCTGAGGCAGGAGAATCGCTTGAACCTGGGAAGCGGAGGTTGCAGTGAGCCAAGATCACACCATTGCACTCTAGCCTGGGCAACAAGGGCAAAACTCCATCTCAAAAAAAAAGAA","GGCTGGGCGCAGTGGCTCAAGCCTGTAATCCCAGCACTTTGGGAGGCCGAGGGGGGTGGATCACGAGGTCAAGAGATCAAGACCATCCTGGTCAACATGGTGAAACCCCGTCTCTACTAAAAAAAAAAAAAAAAAAAAAAAAAAAAAAAAAAAATTAGCTGGGCATGGTGGCGTGTAATCCCAGCTACTCAGGAGGCTGAGGCAGGAGAATTGCCTGAACCCAGGAGGCGGAGTTTGCGGTGAGCCAAGATCGCGCCATTGCACTCCAGCCTGGGTAACAAGAGCAAAACTCTGTCTCAAAAAAAAAAAAAA"
"chr15","14837014","14837358","JH378137","13677298","13677634","59","1159716","GCCGGGTATGGTGGCTCATGCCTGTAATTCCAGCACTTTGGGAGGCCGAGGCAGGCGGATCACCTGAGGTCAGGAGTTTGAGACCAGCCTGGCTAACATGGTGAAACTACGTTTCTACTAAAAATACAAAAAAAAAAAAAAAAAAAAAAAAAAAAAAAAAAAAAAAAAAAATTAGCCAGGCGTGGAGGCGCGTGCCTATAATCCCAGTTACTCGGGAGGCCGAGGCAGGAGAATCGCTTGAACCCAGGAGCCGGAGGGTGTAGTGAGCCGAGATCATGCCATTGCGCTCCAGGTTGGGCAACAAGAGCAGAACTCCGTCTCAAAAAAAAAAAAAAAAAAAAAAAA","GGCTGGGCATTGTGGCTCATGCCTGTAATCCCAGCACTTTGGGAGGCCGAGGTGGGCGGATCACCTGAGGTCGGGAGTTCAAGACCAGCCTGGCCACAATGGTGAAACTCTGTCTCTGCTAAAAAAAAAAAAAAAAAAAAAAAAAAAAAAAAAAAAAAAATTAGCCAGGCGTGGTGGCACACGCCTGTAATCCCAGCTATTTGGGAGGCTGAGGCAGGAGAATCGCTTGAACCTGAGAGGTGGAGGTTGCAGTGAGCCAAGATCATACCATTGCACTCCAGCTTGGGAACAAAGAGCAAAACGCCATCTCAAAAACAAAACAAACAAACTGAAAAAA"
"chr15","20684723","20685060","JH378262","266823","267148","57","20417900","GGCTGGGCGTGTTGGCTTACACCTGAAATCCCAGCACTCTGGGAGGCCGAGGCGGGCAGATCACCTGAGGTCAGGGGTTCGAGACCAGCTTGGCCAACATGGTGAAACCCCGTCGCTACTAAAAATACAAAAATTAGCTGGGCATGGTGGTGGGAGCCTGTAATCCCAGCTACTCAGGAGACTGAGGCAGGACAATCGCTTGAACCCAGGAGGCAGAGGTTGCAGCGAGCCGAGATCGTGCCACTGCACTCCAGCCTGGGAGGGAAGAGTGAAAGTCCATAACAACAACAAAACAACAAAACAACAACAACAACAACAACAACATCTCTGAAAGGAAA","GGCCGGGCGCGGTGGCTCAAGCCTGTAATCCCAGCACTTTGGGAGGCCGAGGCGGGTAGATCATGAGGTCAGGAGTTTGAGACCAGCCTGGCCAACATGGTGAAACCCCGTCTCTACTAAAAATACAAAAATTAGCCGGGCATGGTGGCCTGTGCCTGTAATCCTAGCTACCCAGGAAGCTGAGGCAGGAGAATTGCCTGAACCCAGGAGGCGGAGGTTGCGGTGAGCCGAGATCGTGCCATTGCACTCCAGCCTGGGTAACAAGAGCGAAACTCCGTCTCAAAAACAAACAAACAAACAAACAAAAACAAAAAACAAAAAACAAA"
"chr15","20894395","20894976","JH378119","32351107","32351490","257","11456712","GGTGGCTCACACCTGTAATCCCAGCACTTTGGGAAGCCGAGGTAGGTGGATCACCTGAGGTCAGGAGTTAGAGATCAGCCTGGACAACATGGTGAAACCCCATCTCTACTAAAAATACAAAAACTAACCAGGCTTGGTGGCTCACACCTGTAATCCCATCACTTTGGGAGGCCAAGGCGGGTGGACTACTTGAGGTCAGGAGTTTGAGACCAGCCTGGCTAACATGGTGAAACCCCATCTCTACTAAAAATACAAAAATTAGCTGGGCATGGCAGTGCGCGCCTGCAATCCCAGCTACCTGGGAGGCTAAGGCAGGGGAATTGTTTGAACCTGGGAGGCAGAGGTTGCAGTGAGCCGACACTGCACCACTGCACTCCAGCCTGGGTGACAGAGTGAGCCTCCGTCTCAAAAAAAAAAAAAAAAAAAAAAAAAAATTAGCCAGGTGTGGTGGCAGGCACCTGTGATCCCAGCTACTCAGGAGGCTGAGGCAGGAGAATTGCTTGAACCCAGGAGGCGGAGAGTGCAGTGAGCTGAGATCATGCCATTGCACTCCAGCCTGGGTGACAAGAGAGAAACTCTGTC","GGCCAGGTATGGTGGCTCACACCTGTAATCCCAGCACTTTGGGAGGCCAAGGCAGGCAGACCACCTGAGGTCAGGAGTTCGAGATCAGCCTAGCCAACATGGTGAAACCCCATCTCTAGTAAAAATAAAATTAGCCAGGCATGGTGGTGCATGCCTGTAACGCAGGTCAGGAGTTCGAGATCAGCTTAGCCAACATGGTGAAACCCCATCTCTAGTAAAAATAAAATTAGCCAGGCAGGTGGTGCCGCCTGTACTCGGGAGGCTGAGGCAGGAGAATCACTTGAACCCAAGAGGCAGAGGTTGCAGTCAGCCAAGATCATGCCATTGCACTCCAGCCTAAGCAAAAAGAGTAAAACTCAGTCTCAAAACAAAAAAACAAAAAAA"
"chr15","21092189","21092737","JH378206","6546474","6546861","200","14545715","GCCGGGCGTGGTGGCTCACGCCTGGCCTGTAATCCCAGCACTTTGGGAAGCCAAGGCGGGTGGTTCACCTGAGGTCAGGAGTTCAAGACCAGCCTGGCCAACATGGTGAAACCCTGTCTCTACTAATAATACAAAAATTAGCTGGGCATGGTGGTGCATGCCTGTAATCCCAGCTACTTGGGAGGCCGAGGCGAGCAGATCACCTGAGGTCAAGAGTTCGATACCAGCCTGACCAACATAGAGAAACCCCGTCTCTACTAAAAATGCAAAATTAGCCGGGCATGGTGGTGCATGCCTGTAATCCCCAGCTACTCGGGAGGCTGAGGCAGGAGAATCGCTTGAACCTGGGAGGCAGAGGTTGTGGTGAGCTGAGATCACGCCATTGCACTCCAGCCTGGGCTCGAAACTCCATCTTAAAAAAAAAAAAAAAAAAAAGAATCACTTGAACCCAGGAGGTGGAGGTTGCAGTGAGCTGAGAGTGCACCATTGTACTCCAGCCTGGGCGACAACAGCAAAACTCCATCACCTTAAAAAAAAAAAAAAAAAAGA","GGCCACACATGGTGGCTAACGCCTGTAATCCCAGCACTTTGGGAGGCCAAGTCGGGTGGATCATGAGGTCAGGAGACCAAGACCATCCTGGCCAAATGGTGAAACCCCGTCTCTACTAAAAATACAAAAATTAGCTGGGCATGGTGGCGTGTGCCTGTAATCCCAGCTACTCAGGAGGCTGAGGCAGGACAATTGCCTGAACCCAGGAGAATTAGCTGGGCATGGTGGCGTGTGCCTGTAATCCCAGCTACTCAGGAGGCTGAGGCAGGACAATTGCCTGAACCCAGGAGGCGAAGGTTGCGGTGAGCCGAGATTGTGCCATTGCACTCCAGCCTGGGTAACAAGAGCGACACTCTGTCTCAAAAAAAAAAAAAAAAAAAAAAAAAAA"
"chr15","21150084","21150391","JH378158","10397018","10397312","55","10753066","GGCCGGGCATGGTGGCTTATGCCTGTAATCCCAGCACTTTGGGAGGCTGAGGTGGGTGGATCACCTGAGGTCAGGAGTTCAAGACCACCCTGGTCAACATGGCAAAATCCTGTCTCTACTAAAAATACAAAATTAGCTGGGCGTGGTGGTGGGCGTCTGCCTGGGTGAGGCAGGAGAATCGCTTGAACCCAAGAGGCAGAGGTTGGAGTGAGCCAAGATCGTGCCATTGCACTCCAGCCTGGGCAACGAGAGTGAAACCCCATCTCAGAAAAAAAAAAGAAAAAGAAAAAGAAAAAAGTAAAAAAAAA","GGCTGAGCACAGTGGCTCACACCTGTAATCCCAGCACTTTGGGAGGCCGAGGCGGGTGGATCACCTGAGATCAGGAGTTCAAGAACAGCCTGACCAACATGGTGAAACCTATCTCTACTAAAAATACAAAATTAGCCTGGCATGGTGGCGCGTGCCTGTAATCTGGCTGAGGCAGAAGAATCGCTTAAACCCAGAGGCAGAGATTGCAGTGAGCCAAGATTGTGTCATTGCACTCCAGCCTGGGCAACAAGAGCAAAACTCCATCTCAGAAAAAAAAAAAAAAAGAAGAAAAAAA"
"chr15","21563578","21564184","JH378118","18053084","18053501","255","3510494","GGCCAGGCATGGTGGCTCACACCTGTAATCGCAGCACTTTGGGAGACTGAGGCAAGCAGATCACCTGAGGTTAGAAGTTCAAGACCAGCCTGGCCAACACAGTGAAACCCCATCTCTACTAAAAATACAAAAAAATGGCCGGGTGCAGTGGCTCATGCCTGTAATCCCAGCACTTTGGGAGGCTAAGGCAGGGGGAATCACAAGGTCAAGAGATCAAGACCATCCTGGTAAAACCCCGTCGGTACTAAAAATACAAAAATTAGCTGGGTGAGGTGGCATGCACCTGTAGCCCCAGCTACTCGGGAGGCTGAGACAGGAGAATCACTTGAACCTGGGAGGCAGAGGTTGCAGTGAGCTGAGATCGCACCACTGCACTCCAGCCTGGCAACAGAGGAAGACTCTGTCTAAAACTAATAATAATAATAATAATAATAATAAAATTAGCTGGGAGTAGTGGCGGGCACCTGTAATCCCAGCTACTTGGGGGGGCTGAGGCAGGAGAAAAGCTTGAACCCGGGAGGTGAAGGTTGCAGTAAGCCAAGATCACGCCATTGCACTCCAGCCCGGGCAACAAGAGCGAAACTTCGTTTCAAAAAAAAAAAAAAAA","GGCTGGGCGCAGTGGCTCACACCTGTAATCCCAGCACTTAGGGAAGCTGAGGCGAGTAGATCACCTGAGGTCAGGAGTTAGAGACCAGCCTGGCCATCATGGTGAAACCCCGTCTCTACTAAAGATACCAAAAATTAGCTGAGTGTGGTGCTGGGTGCCTGTAATCCCAGAAACTCAGGGTGCCTGTAATCCCAGCAACTCAGGGTGCCTTTAATCCCAGCAACTGAGGGTACCAGTAATCCCAGCAACTCAGGGTGTCTTTAATCCTAGCAACTGAGGGCACCTGTAATCCCAGCAACTCAGGAAGCTGAGACAGGAGAAGTACTTGAACCCAGAAGGCAGAGGTTGCAGTGAGCCGATATTGCACCATTGCACTCCAGTCTGGGCAACAAGAGTGAAACTCTGTCTCAAAAAAAAA"
"chr15","22132229","22132799","JH378118","18053084","18053501","233","4079145","GGAGGCCAAGGTGGGCGAATCACCGGTGGTCAGGAGTTTGAGACTAGCCTGGCCAACATGGTGAAACCCCGTCTCTACTAAAAAATACAAAAATTAGGCCGAGTGTGGTGGCTCATGCCTGTAATCCCAGCAGTTTGGAAGGCCAAGGCGGGCAGATCACCTGAGGTCAGGAGTTCAAGACCAGCCTGGCCAACACAGTGGAACCCTGTCTCTACTAAAAATACAAAAAAAATTTGCCAGGCATGGTGGTGTGTGTGCCTATAATCCCAGCTACTCAGGAGACTGAGGCAAGAGAACTGCATGAACCCCAGAGGGAGAGGCTGCAGTGAGCTGAGATCGTACCACTGCACTCCAGCCTGGGTGACAGGGCAGGACTCCGTCTCAAAAAAAAAAAAAAAAAAAAAAAATTAGCCAGGTGTGGTGGCGAGCACCTGTAATCCTAGGTACTTGGGAGGCTGAGAAAGGAGAACCACTTGAACCCCGGAGGCAGAGGTTGCAGTGAGTGGAGATTGTGCGCCATTGCACTCCAGCCTGGGTGACAAGTGTGAAATTCTGCCTCAAAAAAAAAAAA","GGCTGGGCGCAGTGGCTCACACCTGTAATCCCAGCACTTAGGGAAGCTGAGGCGAGTAGATCACCTGAGGTCAGGAGTTAGAGACCAGCCTGGCCATCATGGTGAAACCCCGTCTCTACTAAAGATACCAAAAATTAGCTGAGTGTGGTGCTGGGTGCCTGTAATCCCAGAAACTCAGGGTGCCTGTAATCCCAGCAACTCAGGGTGCCTTTAATCCCAGCAACTGAGGGTACCAGTAATCCCAGCAACTCAGGGTGTCTTTAATCCTAGCAACTGAGGGCACCTGTAATCCCAGCAACTCAGGAAGCTGAGACAGGAGAAGTACTTGAACCCAGAAGGCAGAGGTTGCAGTGAGCCGATATTGCACCATTGCACTCCAGTCTGGGCAACAAGAGTGAAACTCTGTCTCAAAAAAAAA"
"chr15","23508255","23508883","JH378118","18053084","18053501","275","5455171","GGTCGGGTGTGGTGGCTCATGCATGTAATCCTGGCACTTTGGGAGGCCGAGGCGGGTAGATCACCTGAGGTCACGAGTTTGAGACCAGCCTGACCAACATGGTAAAACTTTGTTTCTACTACAAATACAAAAAATTGGCCAGGCTCGGTGGCTTCCGCCTGTAATCCCAGCACTTTGGGAGGCCGGGGTGCATGGATCACCTGAGGTCAGGACTTCGAGACCAGCCTGGCCAACATGGTGAAACCCCATCTCTACTAAAAATACAAAAAAAAAAAAAAAAATGAGCCAGGCATATTGGTGGGCGCCTGTAATCCCAGCTACTTGGAAGGCTGAGACAGGAGAATCACTTGAACCTGGGAGGCGGAGATTGCAGTGAGCCGAGATCATGCCACTGTACTCCATCCTGGGTGACAAGAGTGAGACTGCATCTCAAAAAAAAAAAAACCAAAAAACCAAAAAAAAACAAAAAATTAGTCAACCGTAGTGGTGGGCCCCTATAATCTCAGCTGCTCAGGAGGCTGAGGCAGTAGAATCACTTGATCCCAGGAGGTGGAGGTTTCAGTGAGCTGAGATCATGCCATTGTACTCCAGCCTGGGCAACAAGAGCGAAACTCTATCTCAAAAAATAA","GGCTGGGCGCAGTGGCTCACACCTGTAATCCCAGCACTTAGGGAAGCTGAGGCGAGTAGATCACCTGAGGTCAGGAGTTAGAGACCAGCCTGGCCATCATGGTGAAACCCCGTCTCTACTAAAGATACCAAAAATTAGCTGAGTGTGGTGCTGGGTGCCTGTAATCCCAGAAACTCAGGGTGCCTGTAATCCCAGCAACTCAGGGTGCCTTTAATCCCAGCAACTGAGGGTACCAGTAATCCCAGCAACTCAGGGTGTCTTTAATCCTAGCAACTGAGGGCACCTGTAATCCCAGCAACTCAGGAAGCTGAGACAGGAGAAGTACTTGAACCCAGAAGGCAGAGGTTGCAGTGAGCCGATATTGCACCATTGCACTCCAGTCTGGGCAACAAGAGTGAAACTCTGTCTCAAAAAAAAA"
"chr15","23602365","23603005","JH378118","18053084","18053501","286","5549281","GGTCGGGTGTGGTGGCTCATGCATGTAATCCTGGCACTTTGGGAGGCCGAGGCGGGTAGATCACCTGAGGTCACGAGTTTGAGACCAGCCTGACCAACATGGTAAAACCTTGTTTCTACTACAAATACAAAAAATTGGCCAGGCTCGGTGGCTTCCGCCTGTAATCCCAGCACTTTGGGAGGCCGGGGTGCATGGATCACCTGAGGTCAGGACTTCGAGACCAGCCTGGCCAACATGGTGAAACCCCATCTCTACTAAAAATACAAAAAAAAAAAAATGAGCCAGGCATATTGGTGGGCGCCTGTAATCCCAGCTACTTGGAAGGCTGAGACAGGAGAATCACTTGAACCTGGGAGGCGGAGATTGCAGTGAGCCGAGATCATGCCACTGTACTCCATCCTGGGTGACAAGAGTGAGACTGCATCTCAAAAAAAAAAAAAACCAAAAAACCAAAAAAAACCAAAAAATTAGTCAACCGTAGTGGTGGGCCCCTATAATCTCAGCTGCTCAGGAGGCTGAGGCAGTAGAATCACTTGATCCCAGGAGGTGGAGGTTTCAGTGAGCTGAGATCATGCCATTGTACTCCAGCCTGGGCAACAAGAGCAAAACTCTATCTCAAAAAAAAAAAAAAAAAAGAAAAA","GGCTGGGCGCAGTGGCTCACACCTGTAATCCCAGCACTTAGGGAAGCTGAGGCGAGTAGATCACCTGAGGTCAGGAGTTAGAGACCAGCCTGGCCATCATGGTGAAACCCCGTCTCTACTAAAGATACCAAAAATTAGCTGAGTGTGGTGCTGGGTGCCTGTAATCCCAGAAACTCAGGGTGCCTGTAATCCCAGCAACTCAGGGTGCCTTTAATCCCAGCAACTGAGGGTACCAGTAATCCCAGCAACTCAGGGTGTCTTTAATCCTAGCAACTGAGGGCACCTGTAATCCCAGCAACTCAGGAAGCTGAGACAGGAGAAGTACTTGAACCCAGAAGGCAGAGGTTGCAGTGAGCCGATATTGCACCATTGCACTCCAGTCTGGGCAACAAGAGTGAAACTCTGTCTCAAAAAAAAA"
"chr15","23603280","23603615","JH378109","21565230","21565567","55","2038050","GGCCAGGCGCGGTGGCTCATGCCTATAAACTCAGCACTTTGAGAGGCTGAGGCGGGTGGGTCACCTGAGGTCAGGAGTTAGAGACCAGCCTGGCCAACATGGTGAAACCGTGTTTCTACTAAAGATACAACATTAGCCAGGCATGGTGGCGCATGCCTGTAATCCCAGCTACTAGGGAGGCTGCGGCAGGAGAATCGCTTGAACGCAGGAGGTGAAGGTTGCAGTGAGCTGAGATCGTGCCATTGCACTCCAGCCTGGGTGACAAGAGCGAAACTCCATCCCAATCAATCAATCAATCAATCAATCAATTAAATTAAAAAAATAAAAAGAAAGAAA","GGCCGGGCGCGGTGGCTCAAGCCTGTAATACCAGCACTTTGGGAGGCCGAGGCGGGTGGATCACGAGGTCAAGAGATCGAGACCATCCTGGTCAACATGGTGAAACCCCGTCTCTACTAAAAATACAAACAATTAGCTGGGCATGGTGGCGGGTGCCTGTAATCCCAGCTACTCCAGAGGCTGAGGCAGGAGAATTGCCTGAACCCAGGAGACGGAGGTTGCGGTGAGCCAAGATCGCGCCATTGCACTCCAGCCTGGGTGACAAGAGCGAAACTCCGTCTCAATAAATAAATAAATAAATAAATAAATAAAAATAAAATAAATAAATAAATAAATAA"
"chr15","38315253","38315599","JH378169","5922203","5922541","56","32393050","GCCAGACACGGTGGCTCACGCCTGTAATCCCAGCACTTTGGGAGGCCGAGGCGGGTGGATCACCTGAGGTCAGGAGTTCGAGACCAGCCTGGCCAACATGGCGAAATCCTGTCTCTACTAAAAATACACACACACACACACACACACACACACACACACACACACATACACACACAAAATTAGCTGGGCATGGTGGCAGGTGCCTGTAATCCCAGCTACTTGGGAGGCTGAGGCAGGAGAATCACTTGAACCTGGGAGGCGGAGATTGCAGTGAGCCAAGATCATGCCATTGCACTTCAGCCTGGGCAACGAGAGTGAAACTCTGTCTCAAAAAAAAAAAAAAAAAA","GGCCAAGGGTGGTGGCTCACACCTGTAATCCCAACACTCTGGGAGGCCAAGGTGGGTGGATCACCTAAGGTCAGGAGTTCAAGACCAGCATGGCCAATATAGTGAAACTCTGTCTCTACTAAAAATACACACACACAAAAAAAAACAAAACACAAAAAAAACCACAAAATTAGCCGGGCATGGTGGCATGTGCCTGTAATCCCAGCTACTCAGGAGGCTGAGGCAGGAGAATCACTTAAACCCAGGAAGCGGAGGTTGCAGTGAGCCAAGATTGCGCCACTGCACTCCAGCCTAGGTGACAAGAGCAAAACTCTGTCTCAAAAAAAAAAAAAAAAAAAA"
"chr15","39410478","39411079","JH378118","18053084","18053501","249","21357394","GGCCGGGCACGGTGGCTCACGCCTGTAATCCCAGCACTTTGGGAGTCTGAGGTGGGCAGATCCACCTGAGGTCAGGGGTTCAAGACCAGCATGGCCAACATGGTGAAACCTCATCTCTACTAAAAATACAAAAATTAGGCTGGGTGCGGTGGCTCACGCCTGTAATCCCAGCACTTTGGGAGGCCAAGGCAGGTGGATCACCTGAGGTCAGGAGTTCGAGACCAGCATGGCCAACATAGCGAAAATCCGTCTCTACTAAAAACACAAAAATTAGCCAGGTGTGTTGGCTTACACCTGTAATCCCAGCTACACAGGAGGCTGAGGCAGAAGAATCACTTGAATCCAGGAGGTGGAGGTTGCAGTGAGCCGAGATCGCGCCACTGCCCTCCAGCCTGGGTGACAGAGCAAGACACCATCTCAAAAAAAAAAAAAAAAAAATTAGCTGGGCATGGTCACAGGTGCCCCTAATCCCAGCTACTCAGGAGGCTGAGGCAGGAGAATTGCTTGAACCCAGGAGACGGAGGTCACAGTGAGCGGTAATTGTGCCATTGCACTTCAACCTGGGTGACAAGAGCAAAAGTCCATCTCAAAAAAAAAAAAAA","GGCTGGGCGCAGTGGCTCACACCTGTAATCCCAGCACTTAGGGAAGCTGAGGCGAGTAGATCACCTGAGGTCAGGAGTTAGAGACCAGCCTGGCCATCATGGTGAAACCCCGTCTCTACTAAAGATACCAAAAATTAGCTGAGTGTGGTGCTGGGTGCCTGTAATCCCAGAAACTCAGGGTGCCTGTAATCCCAGCAACTCAGGGTGCCTTTAATCCCAGCAACTGAGGGTACCAGTAATCCCAGCAACTCAGGGTGTCTTTAATCCTAGCAACTGAGGGCACCTGTAATCCCAGCAACTCAGGAAGCTGAGACAGGAGAAGTACTTGAACCCAGAAGGCAGAGGTTGCAGTGAGCCGATATTGCACCATTGCACTCCAGTCTGGGCAACAAGAGTGAAACTCTGTCTCAAAAAAAAA"
"chr15","45225530","45226131","JH378133","19690365","19690767","253","25535165","GGCCGGGCACAGTGGCTCATGCCTGCAGTTCCAGCACTTTTGGAGGCCGAGGCAGGCCGATCACTTGAGGTCAGGAGTTCGAGACCACCCCGGCTAACGTGGTGCAACTCCATCTCTACTAAAAATACAAAATTGGCCGGGTGCGGTGGCTCATGCCTGTAATCCCAGCACTTTGGGAGGCCGAGGCGGATGGATCACCTCAGGTCAGGAGTTCGAGACCAGCCTGGCCAATGTGGTGAAACCCCGTCTCTACTAATAATACAAAAATTAACTGGGTGTGGTGGTGGGCACCTATAATCCCAGCTACTCGGGAAGCTGAGGCAGGAGAATCACTTGAACCTGGGAGGTGGAGATTGCAGTGAGCTGAGATGGTGCCATTACACTCCAGCCTGGGCAACGAGAGTGAAACTCTGTCTCTAAATAAATAAATACAAAATTAGCCGGGCATGGTGGCGGATGCCTATAATCACAGCTACTTGGGAGGCTGAGGCAAGAGAATCACTTGAACCTGGGAGGTGGAGGTTGCAGTGAGCTGAGATCAAGCCATTGCACTCCAGCCTGGGCAAAAAGAGTGAAACTCTGTCTCAAAAAAAAGAAAGAAA","GGCCAGGCACAGTGGTTCATGTCTGTAATCAGCATTTTGGGAGGCTGAGGCGGGAGAATCACCTGAGGCCAGGAGTTCTAGATGAGCCTGGGCAAATAGTGACAACCTGTCCCTACAAAAAAATTTAAAATTAGCCAGGATTGAGACCATCCTGGCTCACGTGGTGAAACCCCATCTTTACTTAAAATACTTAAAATGCAAAAAACATTTTTTTTTGTATTTTATTTAAAATACAAAAAAACTAGGCAGGCATGTTGGCACGTGCCTGTAGTCCCAGATACTTGGGAGGCTGAGGCAAGAGAATCACTTGAACCCAGGAGGTGGAGGTTGCAGTGAGCCGAGATCATACCACTGCACTCCAGCCTGGGTGACAAGAGTGAAACTCTGTCTCAAAAAAAAACAA"
"chr15","46581057","46581661","JH378118","18053084","18053501","254","28527973","GGCCGGGCGCGGTGGCTCACGCCTGTAGTCCCAGACTTTGGGAGGCCGAGGTGGGCGGATTGCCTGAGGTCAGGAGTTCAAGACCAACCTGGCCAACATGGTGAAATGCCGTCTCTACTAAAAATACAAAAATTAGGCCGGGCACGGTGGCTCATGTCTATAATCCCAGCACTTTGGGAGGCCGAGGTGGGCGGATCACGAGGTCAGGAGATCGAGACCATCCTGGCTAACACGGTGAAACCCCGTCTCTACTAAAAACACAAAAAATTAGCCGGGCGTGGTGGCAGGCACCTGTAGTCTCAGCTACTCAGGAGGCTGAGGCAGGAGAATGGCGTGAACTTGGGAGGCGGAGCTTGCAGTGAGCCAAGATTGTGCCACTGCACTCCAGCCTGGGCAACAGAGCGAGACTCTGTCTCAAAAAAAAAAAAAAAAATTAGCCAGGTGTGGTGGCAGGTGCCTGTAATCCCAGCTAATTGGGAGGCTAAGGCAGGAGAATCTCTTGAACCCAGGAGGCAGAGGTTGCAGTGAGCCAAGATTTCGCCATTACACTCCAGCCTGGGCAACAAGAGCTAGACTCCATCTCAAAAATAAATAAATAAAATAAA","GGCTGGGCGCAGTGGCTCACACCTGTAATCCCAGCACTTAGGGAAGCTGAGGCGAGTAGATCACCTGAGGTCAGGAGTTAGAGACCAGCCTGGCCATCATGGTGAAACCCCGTCTCTACTAAAGATACCAAAAATTAGCTGAGTGTGGTGCTGGGTGCCTGTAATCCCAGAAACTCAGGGTGCCTGTAATCCCAGCAACTCAGGGTGCCTTTAATCCCAGCAACTGAGGGTACCAGTAATCCCAGCAACTCAGGGTGTCTTTAATCCTAGCAACTGAGGGCACCTGTAATCCCAGCAACTCAGGAAGCTGAGACAGGAGAAGTACTTGAACCCAGAAGGCAGAGGTTGCAGTGAGCCGATATTGCACCATTGCACTCCAGTCTGGGCAACAAGAGTGAAACTCTGTCTCAAAAAAAAA"
"chr15","46659994","46660594","JH378118","18053084","18053501","247","28606910","GCTGGGCATGGTGGCTTACGCCTGTAATCCCAGCACCTTGGGAGGCTGAAGTGAGCAAATCACCTGAGTTCAGGAGTTCAAGACCAGCCTGGCCAACATGGTGAAAACCCATCTCTATTAAAAATTACAAAAATGGCCAGACACGGTAGCTCACGCCTGTAATCCCAGCACTTTGGGAGGCTGAGGCGGGCAGATCACCTGAGGTTGGGAGTTGGAGACCAGCTTGACCAACATGGAGAAACCCCCTCTCTACTAAAAATACAAAATTAGCCAGGCGTGGTGGCACATGCCTGTAATCCCAGCTACTTGGGAGGCTGAGGCAGGAGAATCACTTCAACCCGGAAGGTGGAGGTTGTGGTGAGCTGAGATTGTGTCATTGCACTCTAGCCTGGATAACAAAGGCAAAACTCAGTCTCAAAAAAAAAAAAAATTACAAAAATTAGCTGGCGTGGTGGCAGGTGCCTATAATCCCAGCTACTCAGGAAGCTGAGGCAGGAGAATCACTTGAAACCAGGAGGCAGAGGTTGCAGTGAGCTGAGACCACGCCATTGCCCTCCTGCCTGGGTGACAAGAGTGAAACTCCATCTCAAAAAAAAAAAAA","GGCTGGGCGCAGTGGCTCACACCTGTAATCCCAGCACTTAGGGAAGCTGAGGCGAGTAGATCACCTGAGGTCAGGAGTTAGAGACCAGCCTGGCCATCATGGTGAAACCCCGTCTCTACTAAAGATACCAAAAATTAGCTGAGTGTGGTGCTGGGTGCCTGTAATCCCAGAAACTCAGGGTGCCTGTAATCCCAGCAACTCAGGGTGCCTTTAATCCCAGCAACTGAGGGTACCAGTAATCCCAGCAACTCAGGGTGTCTTTAATCCTAGCAACTGAGGGCACCTGTAATCCCAGCAACTCAGGAAGCTGAGACAGGAGAAGTACTTGAACCCAGAAGGCAGAGGTTGCAGTGAGCCGATATTGCACCATTGCACTCCAGTCTGGGCAACAAGAGTGAAACTCTGTCTCAAAAAAAAA"
"chr15","46772064","46772669","JH378118","18053084","18053501","251","28718980","GGCTGGGTGCAATGGCTCATGCCTGTAATTCCAGTGTTTTGGGAGGCCGAGGCAGGTGGATCACTTGAGATCAGGAGTTCGCGACCAACCTGGCTAACATGGTGAAACCCCGTCTCTACTAAAAATACAAAAAATTGGCCAGGAGCGGTGGCTCAAACCTGTAATTCCAGCACTTTGGGAGGCCGAGGGGGGCAGATCACGATGTTTAGGAGTTTGAGATCAGACTGACCAACATGGTGAAACCCCATCTCTACTAAAAATACAAAAATTAGCCAGGCGTGGTGGTGCATGTCTGTAATCCCAGCTACTTGGGAGGCTGAGGCAGGAGAGTTGCTTGAAGCCGGGAGGTGGAGGTTGCAGTGAGCTGAGATCACACCACTGCACTCCAGCCTGGGCGACAGAGCAAGACTGTCTCAAAAAAAAAAAAAAAAAAAAAAATTAGCCAGCTTGGTGGCGGGCATCTGTAATCCCAGCTACTCGGGAGGCTGAGGCAGGAGAATCACTTGAACCCAGGAGGCAGAGGTCGCAGTGAGCCAAGATCACGCCATTGTACTCCAGCCTGGGCAACAAGAGCAAAACTCCATCTCAAAAAACAAAAAATAAAAA","GGCTGGGCGCAGTGGCTCACACCTGTAATCCCAGCACTTAGGGAAGCTGAGGCGAGTAGATCACCTGAGGTCAGGAGTTAGAGACCAGCCTGGCCATCATGGTGAAACCCCGTCTCTACTAAAGATACCAAAAATTAGCTGAGTGTGGTGCTGGGTGCCTGTAATCCCAGAAACTCAGGGTGCCTGTAATCCCAGCAACTCAGGGTGCCTTTAATCCCAGCAACTGAGGGTACCAGTAATCCCAGCAACTCAGGGTGTCTTTAATCCTAGCAACTGAGGGCACCTGTAATCCCAGCAACTCAGGAAGCTGAGACAGGAGAAGTACTTGAACCCAGAAGGCAGAGGTTGCAGTGAGCCGATATTGCACCATTGCACTCCAGTCTGGGCAACAAGAGTGAAACTCTGTCTCAAAAAAAAA"
"chr15","48446925","48447526","JH378118","18053084","18053501","252","30393841","GGCCAAGTGCAGTGGCTCACGTTTGTAATCCCAGCACTTTGGGAGGCCGAGGCGGGTGGATCACCTGATGTCAGGGGTTTGAAACCAGCCTGGCCAACATGGTGAAACCCCATCTCTAATAAAAATACAAAACTGGCCAGGTGCAGTGGCTCATGCCTGTAATCCCAGCACTTTGAGAGACCAAGGGAGGCAGATCACCTGAGGTCAGGAGTTCCAGACCAGCCTAGCCAACATGGTGAAACCCTATCTCTACTAAGAGTACAAAAATTAGCCTGGCGTGGTGGCAGGCGCCTGTAATCCCAGCTACTCAGAAGGCTGAGGCAGGAGAATCACTTGAACCCAGGAGGCGGAGGTTGCAGTGAGCCGAGATTGAGCCACTACACTCCAGCCTGGGTGACAAGAACAAGACTCTGTCTCAAAAAAAAAAAAAAAAAAAGCCGGTCATGGTGGCACATGCCTATAATCCCAGCTTCTTGGGAGGCTGAGGCAGGAGAACCACTTGAACCTGGGAGGTGGAGGCTGCAGTGAGCCGAAATTGTGCCATTGCACTCTAGCCTGGGCAACAAGAGCAAAACTCTCTCAAAAAAAAAAAAAAAAAAAAA","GGCTGGGCGCAGTGGCTCACACCTGTAATCCCAGCACTTAGGGAAGCTGAGGCGAGTAGATCACCTGAGGTCAGGAGTTAGAGACCAGCCTGGCCATCATGGTGAAACCCCGTCTCTACTAAAGATACCAAAAATTAGCTGAGTGTGGTGCTGGGTGCCTGTAATCCCAGAAACTCAGGGTGCCTGTAATCCCAGCAACTCAGGGTGCCTTTAATCCCAGCAACTGAGGGTACCAGTAATCCCAGCAACTCAGGGTGTCTTTAATCCTAGCAACTGAGGGCACCTGTAATCCCAGCAACTCAGGAAGCTGAGACAGGAGAAGTACTTGAACCCAGAAGGCAGAGGTTGCAGTGAGCCGATATTGCACCATTGCACTCCAGTCTGGGCAACAAGAGTGAAACTCTGTCTCAAAAAAAAA"
"chr15","59372839","59373447","JH378118","18053084","18053501","260","41319755","GGCCAGGATCAGTGTCTCACACCTGTAATCCTAGCACTTTGGGAGGCTAAGGTGGGCGGATTACTTGAGGTCAGGAGTTTGAGACCAGCCTGGGCAACATGGTGAAACCCCGTCTCTACTAAAAATACAAAAATTAGCTGGGCATAGGCCAGGAGTGGTGGCTTACGCCTGTAATTCCAGGACTTTGGGAGGCTGAGGCGGGCAGATCATGAGGTCAGGAGATTGAGACCATCCTGGCTAACATGGTGAAACCTCATCTCTACTAAAAATACAAAAATTAGCCAGTCGTGGTGGTAGGCGCCTGTAGTCCCAGCTACTTGAGAGGCTGAGGCAGGAGAATCACTTGAATCCGGGAGGTGGAGGTTGCAGTGAGCCGAGATTATGCCACTTCACTCCAACCTGGTGACAGAGCAAGACTCCGTCTAAAAAAAAAAAAAAAAATTAGCTGGGTGTGGCGGGCACTTGCAATCCCAGCTACTTAGGAGGCTGAGGCAGGAGAACCGCTTGAACCTGGGAGGTAGAGGTTCCAGATCACGCCATTGCACTCCTGCTTGGGCAACAAGAGTGACACTCCATCTCAAAAAAACAAAAAAAAAAAAGAAAAAGAAA","GGCTGGGCGCAGTGGCTCACACCTGTAATCCCAGCACTTAGGGAAGCTGAGGCGAGTAGATCACCTGAGGTCAGGAGTTAGAGACCAGCCTGGCCATCATGGTGAAACCCCGTCTCTACTAAAGATACCAAAAATTAGCTGAGTGTGGTGCTGGGTGCCTGTAATCCCAGAAACTCAGGGTGCCTGTAATCCCAGCAACTCAGGGTGCCTTTAATCCCAGCAACTGAGGGTACCAGTAATCCCAGCAACTCAGGGTGTCTTTAATCCTAGCAACTGAGGGCACCTGTAATCCCAGCAACTCAGGAAGCTGAGACAGGAGAAGTACTTGAACCCAGAAGGCAGAGGTTGCAGTGAGCCGATATTGCACCATTGCACTCCAGTCTGGGCAACAAGAGTGAAACTCTGTCTCAAAAAAAAA"
"chr15","64220715","64221335","JH378118","18053084","18053501","268","46167631","CCAGGCACAGTGGCTCATACCTGTAATCCCAGCACTTTGGGAGCCCAAGGCGGGCAGATCACCTGAGGTCAGGAGTTCGAGACCAGCCTGGACAACATGGAGAAACTCCATCTCTACTAAAAATACAAAATGAGGCCGGGCACAGTGGCTCACACCTATAATCCCAGCACTTTTGGAGGCCGAGACAGGCAGCTCACGAGGTCAGGAGTTCAAGACCAGCCTGGCCAGCATGGTGTAACCCCGTTTCTACTAAAAATACAAAAATTAGCCAGGCATGGTGGTGCGTGCCTGTAGTCCTCAGGAGGCTGAGGCAGGAGAATCGCTTGAATCTGGGAGGCGGAGCTTGCAGTCAGCTGAGATCAGGCTACTGCACTGCAGCTTGGGCAACAGAGTGAGACTCCGTCTCAAAAACAAACAAACAAACAAACAAAACACAACAAAATTAGCTGGGCATGGTGGCAGGTGCCTGTAATCCCAGCTACTCAGCTACTCAGGAGGCTGAGGCAGGAGAGTCACGTGAACCTGGGAGGCAGAGGTTGCAGTGAGCCAAGATCACGCCATTGCACTCCAGCCTGGGCAACAAGAGGGAAATTACATCTCAAAAAAAAAAAAAAAAAAAAA","GGCTGGGCGCAGTGGCTCACACCTGTAATCCCAGCACTTAGGGAAGCTGAGGCGAGTAGATCACCTGAGGTCAGGAGTTAGAGACCAGCCTGGCCATCATGGTGAAACCCCGTCTCTACTAAAGATACCAAAAATTAGCTGAGTGTGGTGCTGGGTGCCTGTAATCCCAGAAACTCAGGGTGCCTGTAATCCCAGCAACTCAGGGTGCCTTTAATCCCAGCAACTGAGGGTACCAGTAATCCCAGCAACTCAGGGTGTCTTTAATCCTAGCAACTGAGGGCACCTGTAATCCCAGCAACTCAGGAAGCTGAGACAGGAGAAGTACTTGAACCCAGAAGGCAGAGGTTGCAGTGAGCCGATATTGCACCATTGCACTCCAGTCTGGGCAACAAGAGTGAAACTCTGTCTCAAAAAAAAA"
"chr15","65873443","65873774","JH378165","3784440","3784761","45","62089003","GGCCAGGCACGGTGGCTCACACGTGTAATCCCAGCACCTTGGGAGACCGAAGCAGGTGGATCACCTGAGGTCAGGAGTTTGAGGCCAGCCTGGCCGATATGGTGAAACCCTATCTCTATTAAAAATACCAAAAAAAAAAAAAAAAAAAAAAAAACCTGCTGGGCGTGGTGGCGCACGCCTGTAATCCCAACTACTCAGGAGGCTGAGGCAGGAGAATCACTTGAATCCAGGAGGCAGAGGTTGCAGTGAGCCGAGATCGCGCCATTGCACTCCAGCCTGGGCAACAAGAGCGAAACTCGGTCTCAAAAAAAAAAAAAAAAAAAGAAAAGAAA","GGCCGGGCGCGGTGGCTCAAGCCTGTAATCCCAGCACTTTGGGAGGCCGAGGCAGGTGGATCATGAGGTCAAGAGATCAAGACCATCCTGGTCAACATGGTGAAACCCCGTCTCTACTAAAAATACAAAAAAAAAAAAAAAAAAACTAGCTGGGCGTGGTGGCGCATGCCTGTAATCCCAGCTACTCAGGAGGCTGAGGCAGGAGAATTGCTTGAACCCAGGAGGCGGAGGTTGCGGTGAGCCCAGATCGCGCCATTGCACTCCAGCCTGGGTAACAAGAGCAAAACTCCATCTCAAAAAAAAAAAAAAAAAAAAAAAAAAA"
"chr15","70453292","70453944","JH378118","18053084","18053501","292","52400208","GGCCAGGCACGGTGGCTCATGCCTGTAATCCCAACACTTTGGGAGGCTGAGGTAGGTAGATCACCTGAGGTTGAGGTCAGGAGTTTGAGACCAGCCTGGCCAACATGGTGAAACTCTGTCTCTACTAAAAATACAAAAATTTGGCCCGGCGCAGTGGCTCACCTGTAATCCCAGCACTTTGGGAGGCCGAGGCAGGCAGATCACGAGGTCTGGAGATCAAGACCATCCTGGCTAACTCGGTGAAATCCCATCTCTACTAAAAATACGAAAAATTAGCCAGGTGTGGTGGCGGGCACCTGTAGTCCCAGCTACTTGGGAGGCTGAGGCAGGAGAATGGCGTGAACCTGGGAGGTGGAGCTTGCAGTGGGCCAAGATCACGCCACTGCACTCCAGCCTGGGCAACAGAGTGAGACTCTGTCTCAAAATAAAATAACATAAAATAAAATAAAGTAATATAAAATAAAAATACAAAAATTAGCTGGGCATGGTAGCGGGTACCTATAATTCCAGCTACTTGAGAGGCTGAGGCTGGAGAATCACTTGAATCTGGGAGGTGGAGGTTGCAGTGAGCCAAGATTGCACCATTGCACTCCAGCCTGGGCAACAAGAGCCAAACTCCGTATCAAAAAAAAAAAAAAAAAGAAAAAGAAAAA","GGCTGGGCGCAGTGGCTCACACCTGTAATCCCAGCACTTAGGGAAGCTGAGGCGAGTAGATCACCTGAGGTCAGGAGTTAGAGACCAGCCTGGCCATCATGGTGAAACCCCGTCTCTACTAAAGATACCAAAAATTAGCTGAGTGTGGTGCTGGGTGCCTGTAATCCCAGAAACTCAGGGTGCCTGTAATCCCAGCAACTCAGGGTGCCTTTAATCCCAGCAACTGAGGGTACCAGTAATCCCAGCAACTCAGGGTGTCTTTAATCCTAGCAACTGAGGGCACCTGTAATCCCAGCAACTCAGGAAGCTGAGACAGGAGAAGTACTTGAACCCAGAAGGCAGAGGTTGCAGTGAGCCGATATTGCACCATTGCACTCCAGTCTGGGCAACAAGAGTGAAACTCTGTCTCAAAAAAAAA"
"chr16","217191","217526","JH378138","4229795","4230103","77","4012604","ATTTTGGGAGGCTGAGATGAGTGATGAGCGGATCACCTGAGGTCAGGAGCTCGAGACCAGTCTGGCCAACACGGTGAAACCCTGTCTCTACTAAAAGTACCAAAAAAATTAGCCAGGCATGGCAGTGGGCGCCTGTAATCCCAACTACTCGGGAGGCTGAGGCAGGAGAATCACTTGAACCTGGGAGGTGGATGTAGCAGTGAGCCGGGATCGTGCCACTGAACTCCAGCCTGGGCGATAAGATCAAAACTCTGTCTCTCTCTCACACACACACACACACACACACACACACACACACACACCCCCAAAAAAAAAAACAAAAAAAAGAAAAAGAAA","CACTTTGGGAGGTGAAGGCGGGCAGATCACCTGAGGTCAGGAGTTCGAGACCAGCCTGGCCAACATGGTGAAACCCCGCCTCTACTAAAAATACAAAAATTAGCCAGGTGTGACACTAGGCATCTGTAATCCCAGCTACTTGGGAGGCTGAGACAGGAGAATCACTTGAACCCAGGAGGCGGAAGTTGCAGTGAGCCAAGATCATGCCATTGCACTCCAGCCTGGGTGACAGGAGCAAAACTCTGTCTCAAAAAAAAAAAAAAAAAAAAAAAAAAAAAAAAAAAAAAAAGAAAAGAAAAGAAAAGTAAA"
"chr16","384893","385508","JH378118","18053084","18053501","265","17668191","GGCCGGGCGTGGTGGCTAACACGGGTAGTCCTAGCACTTTGGGAAGCCAAGGCAGGCAGATCACTTGAGGTCAGGAGTTTGAGATCAGTCTGGCCAACATGGTGAAACCACGCCTCTACTAAAAATACAAAAGTTATGGCCGAGCGTGGTGGCACGCGCCTGTAATCCCAGCACTTTGGGATGCTGAGGCAGGCGCATCACCTAAGGTCGGGAATTCAAGACCAGCCTGACCAACATGGAGAAACCACGTTTCTACTAAAAATACAAAATTAGCCGGGTGTGGTGGCACATGCCTGTAGTTTCAGCTACTCAGGAGGCTGAGGCAGGAGAATCACTTGAATCCGGGAGGCGGAGATTGTGGTGAGCCGAGATCGGGCCATTGCACTCCAGCCTGGGCAACAAGAGAGAAACTCTGTCTCAAAAAAAAAAAAAAAAAATTAGCCAGGCATGGTAGCCTGTGCCTGTAATCCCAGCTACTTGGGAGGCTGAGGCAGGAGAATCGCTTGAACCTGGGAGGCAGAGGTTGCAGTGAGCCGCGATTGCGCCATTGCACTCTCCAGCCTGGGGGAGAAGAGCAAAACTCCATCTCAAAAATAAATAAATAAATAAAAATAAA","GGCTGGGCGCAGTGGCTCACACCTGTAATCCCAGCACTTAGGGAAGCTGAGGCGAGTAGATCACCTGAGGTCAGGAGTTAGAGACCAGCCTGGCCATCATGGTGAAACCCCGTCTCTACTAAAGATACCAAAAATTAGCTGAGTGTGGTGCTGGGTGCCTGTAATCCCAGAAACTCAGGGTGCCTGTAATCCCAGCAACTCAGGGTGCCTTTAATCCCAGCAACTGAGGGTACCAGTAATCCCAGCAACTCAGGGTGTCTTTAATCCTAGCAACTGAGGGCACCTGTAATCCCAGCAACTCAGGAAGCTGAGACAGGAGAAGTACTTGAACCCAGAAGGCAGAGGTTGCAGTGAGCCGATATTGCACCATTGCACTCCAGTCTGGGCAACAAGAGTGAAACTCTGTCTCAAAAAAAAA"
"chr16","1668152","1668787","JH378118","18053084","18053501","287","16384932","GGCCGGGCACGGTGCCTCGTTCCTGTAATCCCAGCACTTTGGGAGGCCAAGGTGGGTGGATCACCTGAGGTCAGGAGTTCGAGACATGCCTGGCCAACATGGCAAAATCCTGTCTTTACTAAAAATACAAAAATTAAGCCGGGCGCTGTGACTCATGCCTGTAATCCCAGCACTTTGGGAGGCCAAGGCGGGCGGATCACAAGGTCAGGAGATTGAGACCATCCTGGCTAACACGGTGAAAACCCGTCTCTACTAAAAATACAAAAAATTAGCCAGGTGTGGTGGCGGGTGCCTGTAGTCCCAGCTACTCGGGAGGCTGAGGCAGGAGAATGGCGTGAACCCGGGAGGCGGAGCTTGCAGTGAGCCGAGATCGTGCCACTGCACTCCAGTCTGGGCAACAGAGCAAGACTCTCTCTCAAAAAGAAACAAACAAAAAAAAAAATGAAAAAAGAAAAATTAGCCAGGCGTGGTGGCGGGTGCCTATAATCTCAGCTACTCGGGAGGCTGAGGCAGAAGTATCATTTGAACCCAGGAGGCGGAGGTTGTAGTGATCCAAGATAGCGCCATTGCACTGCAGCCTGGGTGACAACAGTGAAACTCCGTCTCAAAAAAAAAAAAAAAAAAGAAAGAAAGAAA","GGCTGGGCGCAGTGGCTCACACCTGTAATCCCAGCACTTAGGGAAGCTGAGGCGAGTAGATCACCTGAGGTCAGGAGTTAGAGACCAGCCTGGCCATCATGGTGAAACCCCGTCTCTACTAAAGATACCAAAAATTAGCTGAGTGTGGTGCTGGGTGCCTGTAATCCCAGAAACTCAGGGTGCCTGTAATCCCAGCAACTCAGGGTGCCTTTAATCCCAGCAACTGAGGGTACCAGTAATCCCAGCAACTCAGGGTGTCTTTAATCCTAGCAACTGAGGGCACCTGTAATCCCAGCAACTCAGGAAGCTGAGACAGGAGAAGTACTTGAACCCAGAAGGCAGAGGTTGCAGTGAGCCGATATTGCACCATTGCACTCCAGTCTGGGCAACAAGAGTGAAACTCTGTCTCAAAAAAAAA"
"chr16","2310740","2311369","JH378118","18053084","18053501","271","15742344","GGCCGGGCACAGTGGCTCACGCCTATAATATCAGCACTTTGGGAGACCAAGGCGGGTGGATCACCTAAGGTCAGGAGTTCAAGACCAGCCTGACCAACATGGTGAAACCCCATCTCTACCAAAAATAGAAAACATTAGTCTTGGCCGGGCACGGTGACTCATACCTGTAATTCCAGCACTTTGGGAGGCCGATCACCTGGCGGATCACCTGAGGTCGGGAGTTTGAGACCAGCCTGACCAACATGGAGAAACCCCGTCTCTACTAAAAATACAAAATTAGCTGTGCGTAGTGGCCCATGCGTGTAATCCCAGCTACTCAGGAGACTGAGGCAGGAGAATGGCTTGAACCTGGGAGGCGGAGGTTGTGCTGAGCCAAGATCGCACCATTGCACTCCAGCCTGGGCAATAAGAGTGAAACTCCGTTTCATAAAACAAAAAACAAAAAACAAAAAAAAAACCATTAGCCAGGCATTGTGGCAGGCACCTGTAATCCCAGCTACTCAGGAGGCTGAGGCAGAATGGCTTGAACCGGGGAGGCAGAGGTTGCAGTGAGCCGAGATCGCGCCATTGCACTCCAGCCTGGGCAACAAAAGTAAAACTCTGTCTCAAATAAAAAAAAGAGAGAAAAAA","GGCTGGGCGCAGTGGCTCACACCTGTAATCCCAGCACTTAGGGAAGCTGAGGCGAGTAGATCACCTGAGGTCAGGAGTTAGAGACCAGCCTGGCCATCATGGTGAAACCCCGTCTCTACTAAAGATACCAAAAATTAGCTGAGTGTGGTGCTGGGTGCCTGTAATCCCAGAAACTCAGGGTGCCTGTAATCCCAGCAACTCAGGGTGCCTTTAATCCCAGCAACTGAGGGTACCAGTAATCCCAGCAACTCAGGGTGTCTTTAATCCTAGCAACTGAGGGCACCTGTAATCCCAGCAACTCAGGAAGCTGAGACAGGAGAAGTACTTGAACCCAGAAGGCAGAGGTTGCAGTGAGCCGATATTGCACCATTGCACTCCAGTCTGGGCAACAAGAGTGAAACTCTGTCTCAAAAAAAAA"
"chr16","3075498","3075819","JH378114","26407278","26407597","46","23331780","GGCCAGGCGCGGTGGCTCACACCTGTAATCCCAGCACTTTGGGAGGCCAAGGCGGGCAGATCACGAGGTCAAGAGATCGAGACCATCCTGGCCAACCTGGTGAAACTCTGTCTCTACTAAAAATACCAAAAAAAAAAAAAAAAAAAAAAAAAAAAAGCATGGTGGCAGGTGCCTGTAATCCCAGCTACTTGGGAGGCTGAGGCAGAATTGCTTGAACCCGGGAGGCAGAGGTTGCAGTGAGTTGAGATCATGCCATTGCACTCCAGCCTGGGCAAAAAGAGCGAAACTCTGTCTCAAAAAACAAAACAAAAACAAAAACAAA","GGCCGGGCGCAGTGGCTCAAGCTTGTAATCCCAGCACTTTGGGAGGCCGAGGCGGGTGGATCACGAGGTCAAGAGATCGAGACCATCCTGGTCAACATGGTGAAACCCCGTCTCTACTAAAAATACAAAAAAAAAAAAAAAAAATTAGTTGGGCATGGTGGTGTGTGCCTGTAATCCCAGCTACTCAGGAGGCTGAGGCAGGAGAATTGCCTGAACCCAGGAGGCGGAGGTTGCGGTGAGCCGAGATCGCGCCATTGCACTCCAGCCTGGGTAACAAGAGCGAAACTCCGTCTCAAAAAAAAAAAAAAAAAAAAAAAAAA"
"chr16","3161549","3162150","JH378118","18053084","18053501","252","14891535","CTGGGCACCGTGGCTCACGCCTGTAATCCCAACACTTTGGGAGGCCAAGGCGGGTGGAACACCTGAAGTCAGGAGTTCGAGACCAGTCTGGACAACATGATGAAACCCCGTCTCTACTAAAAATACAAAAAGTAGCCAGGTATGGCCGGGCGCGGTGGCTCACGCCTGTAATCCCGGCACTTTGAGAGGCCGAGGCAGGTGGATCACAAGGTCAGGAGTTCAAGAGCAGCCTGGCCAAGATAGTGAAACCCCGTCTCTACTAAAAGCAAAATTACAGTGCGCCTGTAATCCCAGCTGCTCGGGAGGCTGAGGCAGGAGAATCGCTTGAACCTGGAGGGCGGAGGTTGCAGTGAGCCAAGATCGCTCTACTGCACCCTAGCCTGGGTGACAGAGCAAGACTCTGTATCAAAAAAAAAATAAATAAATAATTAGCCAGGTATGGTGGTGCAGGCTTGTAATCCTAGCTGCTCAGGAGGCTGAGGCAGGAGAATCGATTGAACCCAGGAGACGGAGGTTGCAGTGAGCAGAGATCACACCATTGTACTCCAGCCTGAGTGACAAAAACGAAACTCCGTCTCAAAAAAAAACCAAAAAAACAAAAA","GGCTGGGCGCAGTGGCTCACACCTGTAATCCCAGCACTTAGGGAAGCTGAGGCGAGTAGATCACCTGAGGTCAGGAGTTAGAGACCAGCCTGGCCATCATGGTGAAACCCCGTCTCTACTAAAGATACCAAAAATTAGCTGAGTGTGGTGCTGGGTGCCTGTAATCCCAGAAACTCAGGGTGCCTGTAATCCCAGCAACTCAGGGTGCCTTTAATCCCAGCAACTGAGGGTACCAGTAATCCCAGCAACTCAGGGTGTCTTTAATCCTAGCAACTGAGGGCACCTGTAATCCCAGCAACTCAGGAAGCTGAGACAGGAGAAGTACTTGAACCCAGAAGGCAGAGGTTGCAGTGAGCCGATATTGCACCATTGCACTCCAGTCTGGGCAACAAGAGTGAAACTCTGTCTCAAAAAAAAA"
"chr16","3211652","3212251","JH378118","18053084","18053501","260","14841432","GTCAGACGCAGTAGTTTATGCCTGTAATCCTTGCACTTTGGGAGGCAGGTGGATCACCTGAGGCCAGGAGTTGGAGACCAGCCAGGCCAATATGGCAAAACCCCGTCTCTACTAAAAATACAAAAACTAGCCGGGCGCAGTGGCTCACACCTGTAATCCCAGCACTTTGGGAGGCTGAGGTGGGTGGATCACTAGGTCAGGAGTTCAAGACCAGCCTGGCCAACATGGTGAAACCGCGTCTCTACTAAAAACACCAAAAAATTAGCTGGGCGTGGTGGCAGTCGCCTGTAATCCCTGCTACTCGGAAGGCTGAGGCAGGAGAATCACTTGAACGCAGGAGGCAGAGGTTGCGGTGAGCCGAGATCACGCCACTGCACTCCAGCCTGGGTGACAGAGCAAGACTCTGTCTCAAAAAACAACAACAACAACTAGCTGGGCGTGGTGGCACATGCCTGTAACCCCAGCTACTCAGGAGGCTGAGGCTGAGGGAGAAAAATCGCTTGTACCTGGGAGGTGGAAGTTGCAGTGAGCGGAGATCCCACCATTGCACTCCAGCCTGGGTGACAAGAGCGAAACTCCATCTCAAAAAAAAAAAAAAAA","GGCTGGGCGCAGTGGCTCACACCTGTAATCCCAGCACTTAGGGAAGCTGAGGCGAGTAGATCACCTGAGGTCAGGAGTTAGAGACCAGCCTGGCCATCATGGTGAAACCCCGTCTCTACTAAAGATACCAAAAATTAGCTGAGTGTGGTGCTGGGTGCCTGTAATCCCAGAAACTCAGGGTGCCTGTAATCCCAGCAACTCAGGGTGCCTTTAATCCCAGCAACTGAGGGTACCAGTAATCCCAGCAACTCAGGGTGTCTTTAATCCTAGCAACTGAGGGCACCTGTAATCCCAGCAACTCAGGAAGCTGAGACAGGAGAAGTACTTGAACCCAGAAGGCAGAGGTTGCAGTGAGCCGATATTGCACCATTGCACTCCAGTCTGGGCAACAAGAGTGAAACTCTGTCTCAAAAAAAAA"
"chr16","3990675","3991277","JH378118","18053084","18053501","250","14062409","GGCTGGGCGTGGTGGCTCACGCCTTTAATCCCAGTACTTTGGGAGGCCGAGAAGGGCACATCACCTGAGGTCAGGAGTTTGAGACCAGCCTGGCCAATATGGTAAAACCCTGTCTCTACTTAAAAAATAGAAAAATCAGGCTGGACGCAGTGGCTCACGCCTGTAATCCCAGCACTTTGGGAGGCCGAGGCGGGTGGATCATGAGGTCAGGAGTTACCAGCCTGCCAACATGGTGAAACCCCATCTCTACTAAAAAAACAAAAAAAATTAGCCAGTCGTAGTGGCAGGCACCTGTAATCCCAGCCACTCGGGAGGCTGAGGCAGAGAATTGCTTGAACCTGGGAGGTGGAGATTGCTGTGCACCAAAATCACACCACTGCACTTGAGCCTGGGCGACAGAGGGAGACTCATCTGAAAAAAAAAAAAAAAAAAAAATTAGCCGGTTATGGTGGCAGGTGCCTGTGATCCCAGCTACTTGGGAGGCTGAGGCAGGAGAATTGCTTGAACCCGGGAGGCAGAGGTTGCAGTGAGCTGAGATCGCACCACTGCACTCCAGCCTGGAGGACAAGAGTGAGACTTGTCTGATTGGAAAAAAAAAAAAAA","GGCTGGGCGCAGTGGCTCACACCTGTAATCCCAGCACTTAGGGAAGCTGAGGCGAGTAGATCACCTGAGGTCAGGAGTTAGAGACCAGCCTGGCCATCATGGTGAAACCCCGTCTCTACTAAAGATACCAAAAATTAGCTGAGTGTGGTGCTGGGTGCCTGTAATCCCAGAAACTCAGGGTGCCTGTAATCCCAGCAACTCAGGGTGCCTTTAATCCCAGCAACTGAGGGTACCAGTAATCCCAGCAACTCAGGGTGTCTTTAATCCTAGCAACTGAGGGCACCTGTAATCCCAGCAACTCAGGAAGCTGAGACAGGAGAAGTACTTGAACCCAGAAGGCAGAGGTTGCAGTGAGCCGATATTGCACCATTGCACTCCAGTCTGGGCAACAAGAGTGAAACTCTGTCTCAAAAAAAAA"
"chr16","4259838","4260446","JH378118","18053084","18053501","263","13793246","GGCCGGGTGCAGTGGCTCACGCCTGTAATCGCAGGACTTTGGGAGGCCAAGGCAGGTGCATCACCTGAGGTCAGGATTTCAAGACCATCCAGCCTGATCAACATGGTGAAACCCTGTCTCTACTAAAAATATAAAAATTGGCCGGGCACAGTGACTCACGCCTGTAATCCCAGCACTTTGGGAGGCTGAGGCAGGTGGATCACAAGGTCAGGAGATCGAGACCATCCTGGCTAACACAGTGAAACCCCGTCTCTACTAAAAATATAAAAAATTAGCCGGGCGTGGTGGTAGGCACCTGTAGTCCCAGCTACTCGGGAGACTGAGGCAGGAGAATGGCGTGAACCTGGGAGGTGGAGCTTGCAGTGAGCAGAGATCGCGCCACTGTACTCCAGCCTGGGTGACAGAGCGAGACTCCGTCTCAAAAAAAAAAAAAAAAAAAAAAATTAGCTGGGCGTGGTGGCGGGCACCTGTAATCCCAGCTACTTGGGAGGCTGAGGCAGGAGAATTGCTTGAACCTGGGAAGTGGAGGTTGCAGTGAGCTGAGATTGTGCCCTTGTACTCCAGCCTGGGCAATAAAAGCAAAACTCCGTCTTAAAAAAAAAAAAAAAA","GGCTGGGCGCAGTGGCTCACACCTGTAATCCCAGCACTTAGGGAAGCTGAGGCGAGTAGATCACCTGAGGTCAGGAGTTAGAGACCAGCCTGGCCATCATGGTGAAACCCCGTCTCTACTAAAGATACCAAAAATTAGCTGAGTGTGGTGCTGGGTGCCTGTAATCCCAGAAACTCAGGGTGCCTGTAATCCCAGCAACTCAGGGTGCCTTTAATCCCAGCAACTGAGGGTACCAGTAATCCCAGCAACTCAGGGTGTCTTTAATCCTAGCAACTGAGGGCACCTGTAATCCCAGCAACTCAGGAAGCTGAGACAGGAGAAGTACTTGAACCCAGAAGGCAGAGGTTGCAGTGAGCCGATATTGCACCATTGCACTCCAGTCTGGGCAACAAGAGTGAAACTCTGTCTCAAAAAAAAA"
"chr16","4899850","4900511","JH378118","18053084","18053501","313","13153234","GGCCAGGCACGGTGGCATGCACCTGTAATCTCAGCTCTTTGGGAGGCTGAGGCAAGAGGATCACTTGAGCCCAGGAGTTGGTGATTGCAGTGAGCTCTGATCACTCCACTGCACTCCAGCCTGGGTGACAGAGTGAGATCCTGTCTCTACGAAAAAAAGACAAGACACAAATACGTTAAAAGTAAAATGATATAAAAAGATATTCCAGTGGGGCACAGTGGCTCACCCCTATAATCCCAACACTTTGGGAGGCTGAGGTGGGTGGATCACCTGAGGTCAGGAATTCAAGACCAGCCTGACCAACATGGAGAAACCCGTCTCTACTAAAAATACAAAATTAGCCGGGTGTGGTGGCACATGCCTGTAATCCCAGCTACTCAGGAGGCTGAGAATGGCTTGAACCTGGGAGGTGGAGGTTGTGGTGAGCCGAGATTGCACCACTGCACTCCAGCCTGGGCAACAAGAGCTGAAACTCCGTCGAAAAAAAAAATTAGCCTGGCGTGGTGGCGGGAGCCTGTAATCCCAGCTACTGGGGAGGCTGAGGCAGGAGAATCACTTGAACCTGGGAGGCAGAATTTGCAGTGAGCCGAGATCGCGCCACCACACTCCAGCCTGGGTGACAAAAACGAAACCCCATCTCAAAAAAATTAAAAAATAACAAA","GGCTGGGCGCAGTGGCTCACACCTGTAATCCCAGCACTTAGGGAAGCTGAGGCGAGTAGATCACCTGAGGTCAGGAGTTAGAGACCAGCCTGGCCATCATGGTGAAACCCCGTCTCTACTAAAGATACCAAAAATTAGCTGAGTGTGGTGCTGGGTGCCTGTAATCCCAGAAACTCAGGGTGCCTGTAATCCCAGCAACTCAGGGTGCCTTTAATCCCAGCAACTGAGGGTACCAGTAATCCCAGCAACTCAGGGTGTCTTTAATCCTAGCAACTGAGGGCACCTGTAATCCCAGCAACTCAGGAAGCTGAGACAGGAGAAGTACTTGAACCCAGAAGGCAGAGGTTGCAGTGAGCCGATATTGCACCATTGCACTCCAGTCTGGGCAACAAGAGTGAAACTCTGTCTCAAAAAAAAA"
"chr16","4919663","4920295","JH378118","18053084","18053501","281","13133421","CTGGGCGCAGTGGCTCACACCTATAATCCCAGCACTTTGGGAGGCCGAGGTGGGGTGGATCACTTGAGGTCAGGAGTTTGAGACCAGCCTGGCCAACATGGTGAAACCCCATCTCTTCTAGAAAAATACAAAATTAGGCTGGGCGCGGTGGCTCACGCTTGTAATCCCAGCACTTTGGGAGGCTGAGGCAGGCGGATCATCTGAGGTTGGGAGTTCGAGACCAGCCTGACCAACATAGAGAAACCCTGTCTCTACTAAAAATACAAAATTAGCCGGGCGTGGTGGCGCATGCCTGTAATCCCAGCTAGTCAGGAGGCTGAGGCAGGAGAATCCCTTGAACTGGGGAGGCAGAGGTTGTGGTGAGCCCAGATCGTGCCATTGCACTCCAGCTTGGGTAAGAAGAGCAAAACTCTGTCTAAAAAATATATATATTTATACATATATATATATTTATATATATAATTAGCCACGCATAGTGGCACACACCTGTAACCCCAGCTACCTGGGAGGATGAGGCAGGAGAATAGCTTGAACTTGGGAGGTGGAGGTTGCACTGAGCTGAGACTGCGCCATTGCATTCCAGCCTGGGCAACAAGAGCGAAACTGTCTCAAAAAAAAAAAAAAAAAAAAAAA","GGCTGGGCGCAGTGGCTCACACCTGTAATCCCAGCACTTAGGGAAGCTGAGGCGAGTAGATCACCTGAGGTCAGGAGTTAGAGACCAGCCTGGCCATCATGGTGAAACCCCGTCTCTACTAAAGATACCAAAAATTAGCTGAGTGTGGTGCTGGGTGCCTGTAATCCCAGAAACTCAGGGTGCCTGTAATCCCAGCAACTCAGGGTGCCTTTAATCCCAGCAACTGAGGGTACCAGTAATCCCAGCAACTCAGGGTGTCTTTAATCCTAGCAACTGAGGGCACCTGTAATCCCAGCAACTCAGGAAGCTGAGACAGGAGAAGTACTTGAACCCAGAAGGCAGAGGTTGCAGTGAGCCGATATTGCACCATTGCACTCCAGTCTGGGCAACAAGAGTGAAACTCTGTCTCAAAAAAAAA"
"chr16","5124255","5124811","JH378118","18053084","18053501","213","12928829","GGCCAGGTGCGGTGGCTCATGCGTGTAATCCCAGCGCTTTGGGAGGCTGAGGCAAGTGGATCACCTGAGGTCAGGAGTTTGAGACCAGCCTGGCCAACATGGGGAAATCCCTGTCTCTACTAAAAATACAAAAATTGGGCCGGGTGTGGTGGCTCACACCTGTAATCCCAGCACTTTGGGAGACTGAGGTGGGCGGATCACCCAAGGTCAGGAGTTTGAGACCATCCTGGCCAACATGGTGAAACCCCGTCTCTACTAAATAAATACAAAAAAGTAGCCGAGCGTGTTGGCGGATGCCTGTAATCCCAGCTACTTGGGAGGCTGAGGCAGGAGAATTGCTTGAACCCTGAGAGGTGGAGGTTGCAGTGAGCAGAGATTGTGCCACTGCACTCTGGCCTGGGCGACAAGAGGGAGTCTCTGTCTTAAAAAAAAAAAAAAAAAAAATTAGCTGGAAATCGCTTGAACCCAGGAGGCGGAGGTTGCAGTGAGCCGAGATTGTGCCACTGCACTCTGGCCTGGGCGACAAGAGCGAGATTCTGTCTCAAAAAAAAAAAAGA","GGCTGGGCGCAGTGGCTCACACCTGTAATCCCAGCACTTAGGGAAGCTGAGGCGAGTAGATCACCTGAGGTCAGGAGTTAGAGACCAGCCTGGCCATCATGGTGAAACCCCGTCTCTACTAAAGATACCAAAAATTAGCTGAGTGTGGTGCTGGGTGCCTGTAATCCCAGAAACTCAGGGTGCCTGTAATCCCAGCAACTCAGGGTGCCTTTAATCCCAGCAACTGAGGGTACCAGTAATCCCAGCAACTCAGGGTGTCTTTAATCCTAGCAACTGAGGGCACCTGTAATCCCAGCAACTCAGGAAGCTGAGACAGGAGAAGTACTTGAACCCAGAAGGCAGAGGTTGCAGTGAGCCGATATTGCACCATTGCACTCCAGTCTGGGCAACAAGAGTGAAACTCTGTCTCAAAAAAAAA"
"chr16","8088191","8088522","JH378114","21211700","21212024","70","13123509","GGCTGGGCGCGGTGGCTTTTGACCATAATCCCAGCACTTTGGGAGGCCGAGGTGGTCAGGTCACCTGAGGTCAGGAGTTCAAGAGCAGCCTGGCCAACGTGGTGAAACTCTGTCTCTACCAAAAATACCAAATAATAATAATAATAATAATAATAATAATAAAATAATATAATTGCAGGGTGTGGCAGCCCATGCATGTAATGCCAGCTACTTGGGAGACTGAGGCAGGATAATCACTTCAACCCAAGAGGCGGAGGTTGCAGTGAGCTGAGATCATGCCATTGCATTCCAGCGTAGGCAACAAGAGCGAAACTCTGTTTCAAATAAATAAA","GGCTGGGTGCGGTGGCTCAGGCCTGTAATCCCAGCACTTTGGGAGGCCGAGGTGGGTACATCACCTAAGGTCAGGAGTTCAAGACCAGCCTGACCAACATGGTAAAACCCTGTCTCTACTAAAATTACAAAAGAAAATTAGAAAAAAAAAAAAGAAAGAAAGAAAATTAGATGGCATGGTGGTGGCGGGCACCTGTAATTTCAACTACTCGGGAGGCTAAGGCAGGAGAATCACTTGAACCCAGGAGGTGGAGGTTGCAGTGAGCCGAGATCACACCATTGCACTGCAGCCTGGGCAATAAGAGCAAAACTCCATCTCAAAAAAA"
"chr16","9762791","9763467","JH378118","18053084","18053501","323","8290293","CAGGCATGGTAGCTCACGCCTGTAATCTCAGCACTTTGGGAGGCCGAGGTGCGCAGATCACTTGAGGTCAGGTGTTGGTGACCAGCCTGGCCAACATGGTGAAACCCTATCTCTACTAAAAATACAAAAATTATGGCCGGGCGCAGTGGCTCACGCCTGTAATCCCAGCACTTTGGGAGGCCGAGGTGGGCAGATCACTTGAGGTCAGGAGTTCAAGACCAGCCTAGGCAACATAGTGAAACCCCGTTGCTACTAAAAATACAAAAATTAGCTGGGCGTGATGGCACATACCTGTAGTCCCACCTACTTGGGAGGCTGAGGCAGGAAAATCGCTTGAACCTGGAGGCAGAGGTTGCAGCGAGCCAAGACTGTGCCAATGCACCACAGCCTGGATAACAGAGTGAGACTCAATCTCAAAAAAAAAAAAAAAAAAAAAAGGCGGGCTGGTGGCTCATGCCCATGCAAACCCCGTCTCTACTAAAAGGACAAAAATTAGCTGGGCATGGTGGCGGGGGCCTGTAATCTCAGGATTACAGGAGATACTACTACTCGGGAGGCTGAGGCAGTAGAATTGCTTGAACCAGGGAGGCGGAGGTTGCAGTGAGCTGAGATCGCGCCATTGCACTCCAGGCTGGGTGACAACAATGACTCCGTCTCAAAAACAACAACAACAACAA","GGCTGGGCGCAGTGGCTCACACCTGTAATCCCAGCACTTAGGGAAGCTGAGGCGAGTAGATCACCTGAGGTCAGGAGTTAGAGACCAGCCTGGCCATCATGGTGAAACCCCGTCTCTACTAAAGATACCAAAAATTAGCTGAGTGTGGTGCTGGGTGCCTGTAATCCCAGAAACTCAGGGTGCCTGTAATCCCAGCAACTCAGGGTGCCTTTAATCCCAGCAACTGAGGGTACCAGTAATCCCAGCAACTCAGGGTGTCTTTAATCCTAGCAACTGAGGGCACCTGTAATCCCAGCAACTCAGGAAGCTGAGACAGGAGAAGTACTTGAACCCAGAAGGCAGAGGTTGCAGTGAGCCGATATTGCACCATTGCACTCCAGTCTGGGCAACAAGAGTGAAACTCTGTCTCAAAAAAAAA"
"chr16","9769317","9769634","JH378153","10517405","10517727","57","748088","GGTTGGGCATGGTGGCTCACACCTGTAATGCCAGCACTTTGGGAGGCGGGCAGATCACCTGAGGTCAGGAGTTCAAGACCAGCCTGGCCAACATGGTGAAATCCTGTCATTACAAAAATACAAAAAAAAAAAAAAAAAAAAAAAAAAAAAGCCAGTAATGATAGTGGGTGCGTATAATCCCAGCTACTTTGGAGGCTAAGGCAGGAGACTCACTTGAACCCAGGAGGCGGAGGTTATGGTGAGCCGAGATCACACCATTGCACTCCAGCCTGGGCGACAAGAGCAAAACTCCATCTCAAAAAAAAAAAAAAAAAAAAA","GGCCGGGCGTGGTGGCTCACGCCTGTAATCCCAGCACTTTGGGAGGCCGAGGTGGGTGGATCATGAGGTCAAGAGATCGAGACCATCCTGGTCAACATGGTGAAACCCTGTCTCTACTAAAAAAAAAAAAAAAAAAAAAAAATACAAAAAAATTAGCTGGGCATGGTGGCGCATGCCTGTAATCCCAGCTACTCCGGAGGTTGAGGTAGGAGAATTGCCTGAACCCAGGAGGCGGAGGTTGCGGTGAGCCGAGATCGCGCCATTGCACTCCAGCCTGGGTAACAAGAGCAAAACTCCGTCTCAAAAAAAAAAAAAAAAAAGAA"
"chr16","13753079","13753710","JH378118","18053084","18053501","278","4300005","GGCTGATTGTGATGGCTCACACTTGTAATCCCCTCACTTTGGGAGGCCAAAGCGGGAGCATCACCTGAGGTCAGGAGTTCAAGACCAGCCTGGCCAACATGGTGAAACCCCATCTCTACTAAAAATAAAAAATTAGCTGGGCACAGTGACTCATGCCTGTAATCCCAGCACTTTGGGAGGCCGAGGCAGGCAGATCACAATCACGAGGTCAGGAGTTCGAGACCAGCCTGACCAACATGGTGAAACCCCGTCTCTACTAAAAATAGAAAAATTAGCCAGGCGTGGTGGCACACGCCTGTAATCCCAGCTCCTCAGGAGACTGAGGCAGGAGAATCACTTGAACCCAGGAGGTGGAGGTTGCAGTGAGCAGAGATCGCACCACTGCACTCCAGCCTGGGTAACAGAGTGAGACTCCGTCTCAAAAAAAAAAAAAAAAAAAAAAAAAAAACGAAATTAACCAGGTGTGGTGGCACATGCCTGTAATCCCAGCTACTTGGGAGGCTGAGGCAGGAGAATCGCTTGAACCCGGGAGACAGAGGTTCCAGAGAACTGAGATCATGCCATTGCACTCCAGCCTGGGCAACAAGAGTGAAACTCCATCTAAAAAATAAATAAATACATAAACAAACAAA","GGCTGGGCGCAGTGGCTCACACCTGTAATCCCAGCACTTAGGGAAGCTGAGGCGAGTAGATCACCTGAGGTCAGGAGTTAGAGACCAGCCTGGCCATCATGGTGAAACCCCGTCTCTACTAAAGATACCAAAAATTAGCTGAGTGTGGTGCTGGGTGCCTGTAATCCCAGAAACTCAGGGTGCCTGTAATCCCAGCAACTCAGGGTGCCTTTAATCCCAGCAACTGAGGGTACCAGTAATCCCAGCAACTCAGGGTGTCTTTAATCCTAGCAACTGAGGGCACCTGTAATCCCAGCAACTCAGGAAGCTGAGACAGGAGAAGTACTTGAACCCAGAAGGCAGAGGTTGCAGTGAGCCGATATTGCACCATTGCACTCCAGTCTGGGCAACAAGAGTGAAACTCTGTCTCAAAAAAAAA"
"chr16","13951847","13952482","JH378118","18053084","18053501","292","4101237","GGCCAGGTGCGGTGGCTCATGCCTGTAATCCCAGCACTTTGGGAGGCTATGGCAGCGGATAACCTGAGGTCACAAGTTTGAGACCAGCCTGGCAAACATGGTGAAACCGTCTCTACTAAAAATACAAAAATTACACCAGGCGCGGTGGCTCATGCCTGTAATCCCAGCACTTTGGAAGGCCGAGGCAGGTGGATCATGAGGTCAGGAGATCAAGACCATCCTGGCTAACGCAGTGAAACCCCGTCTCTACTAAAAATATAAAAAATTGGCCAGGCGTGGTGGCGGACGCCTGTAGTCCCAGCTACTCGGGAGGCTGAGCCAGGAGAATGGCGTGAACCCGGGAGGCGGAGCTTGTGGTGAGCCGAGATAGCGCCACTGCACTGCCGCCTGGGTGACAGAGTGAGACTCTGTCTCAAAAAACAAAACAAAACAAAAACCAAAAACAAAAACAAAAAAACAAAAATTAGCCAGGTGTGGTGGTGCACGCCTGTCATCCCAGCTACTTGGGGGGCTGAGACGTGATAATCACTTGAACCCGGGAGGGAGAGGTTGCAGTGAGTGGAGATCACGCCATTGTATTCCAGCCTGGGGGCAAGAGCAAAACTCTGTCTCAAAAACAACAACAACAACAACAAA","GGCTGGGCGCAGTGGCTCACACCTGTAATCCCAGCACTTAGGGAAGCTGAGGCGAGTAGATCACCTGAGGTCAGGAGTTAGAGACCAGCCTGGCCATCATGGTGAAACCCCGTCTCTACTAAAGATACCAAAAATTAGCTGAGTGTGGTGCTGGGTGCCTGTAATCCCAGAAACTCAGGGTGCCTGTAATCCCAGCAACTCAGGGTGCCTTTAATCCCAGCAACTGAGGGTACCAGTAATCCCAGCAACTCAGGGTGTCTTTAATCCTAGCAACTGAGGGCACCTGTAATCCCAGCAACTCAGGAAGCTGAGACAGGAGAAGTACTTGAACCCAGAAGGCAGAGGTTGCAGTGAGCCGATATTGCACCATTGCACTCCAGTCTGGGCAACAAGAGTGAAACTCTGTCTCAAAAAAAAA"
"chr16","19006984","19007584","JH378118","18053084","18053501","263","953900","GGTGGCTGATGCCTGTAAACCCAGCATTTTGGGAGGCCGAGGCTGGTGGATCACCTGAGGTCAGGTGTTCGAGACCAGTCTGGCCAACATGGTGAAACCTCGTCTCTACCAAAAATACAAAAATTAGTTGGGTGTGGCCGGGTGTGGTGGCTTACGCTTGTAATCTCAGCACTTTGGGAGGCCGAGGTGGGTGGATCACGAGGTCAGGAGTTCAAGACCAGCCTGGCCAAGATGGTGAAACCCTGTCTCTACTAAAAATACAAAAAATTAGCCAGGCATGGTGGCGGGTGCCTGTAATCCCAGCTACTCGGGAGGCTGAGGCAGAGAATTGCTTGAACCTGGGAGGTGGAGGTTGCAGTGAGCCGAGATTGTGCCACGACACTCCAGCCTGGGTGACAGAGCGAGACTCTGTCTAAAAAAAAAAAAAAAAATTAGTTGGATGTGGTGGTGGGTGTCTGTAATCTCAGCTACTCAGGAGACTGAATCAGGAGAATCACTTGAACCCAGGGGGCTGGAGGTTGCAGTGAGCCGAGATCTTGCCATTGCACTCCAGCCCGGGCGACAAGAGCAAAACTCTCTTTCAAAAAAAAAAAAAAAAAGA","GGCTGGGCGCAGTGGCTCACACCTGTAATCCCAGCACTTAGGGAAGCTGAGGCGAGTAGATCACCTGAGGTCAGGAGTTAGAGACCAGCCTGGCCATCATGGTGAAACCCCGTCTCTACTAAAGATACCAAAAATTAGCTGAGTGTGGTGCTGGGTGCCTGTAATCCCAGAAACTCAGGGTGCCTGTAATCCCAGCAACTCAGGGTGCCTTTAATCCCAGCAACTGAGGGTACCAGTAATCCCAGCAACTCAGGGTGTCTTTAATCCTAGCAACTGAGGGCACCTGTAATCCCAGCAACTCAGGAAGCTGAGACAGGAGAAGTACTTGAACCCAGAAGGCAGAGGTTGCAGTGAGCCGATATTGCACCATTGCACTCCAGTCTGGGCAACAAGAGTGAAACTCTGTCTCAAAAAAAAA"
"chr16","19554918","19555551","JH378118","18053084","18053501","281","1501834","GGCCGGGCGCAGTGGCTCACACCTGTAATCCCAGCACTTTGGGAGGCCGAGGCGGGTGGATCACTTGAGGTCAGGAGTTCAAGACCAGCCTGGCTGACATGGTGAAACCCTGTCTCTACTGAAAACACAAAAATTAGGCCGGGCATAGTGGCTCATGCCTGTAATACCAGCACTTTGGGAGGCCGAGGTGGGTGGATCACCTGAGGTCAGGAGTTTGAGACCAGCTTGACCAACATGGTGAAACCCCGTCTCTACTAAAAATATAAAAATTAGTCTGGCATGGTGGCAGATGCCTGTAATCCCAGCTACTCAGGAGGCTGAGGCAGGAGAATTGCTTGAACCTGGAAGGTGGAGGTTGTAATGAGCCAAGATCACACCACTGCACTCCAGCCACTGTACTCCAGCCTGGGTGACAGAGTGAGACTCTGTCTCAAAAAACATACATACACACACATACACACACACACACACACACACACAAATTAGCTGGACGTGATAGCACACCCCTGTAGTCCCAGCTGCTTGAGAGACCGAGGCACAAGAATCACACGAACCCGGGAGGCGGAGGTTCCTGTGAGCCAAGATCGCACCATTGTACTCCATTCTGGGTGACAAGAGTGAAGCTCTGTCTCAA","GGCTGGGCGCAGTGGCTCACACCTGTAATCCCAGCACTTAGGGAAGCTGAGGCGAGTAGATCACCTGAGGTCAGGAGTTAGAGACCAGCCTGGCCATCATGGTGAAACCCCGTCTCTACTAAAGATACCAAAAATTAGCTGAGTGTGGTGCTGGGTGCCTGTAATCCCAGAAACTCAGGGTGCCTGTAATCCCAGCAACTCAGGGTGCCTTTAATCCCAGCAACTGAGGGTACCAGTAATCCCAGCAACTCAGGGTGTCTTTAATCCTAGCAACTGAGGGCACCTGTAATCCCAGCAACTCAGGAAGCTGAGACAGGAGAAGTACTTGAACCCAGAAGGCAGAGGTTGCAGTGAGCCGATATTGCACCATTGCACTCCAGTCTGGGCAACAAGAGTGAAACTCTGTCTCAAAAAAAAA"
"chr16","19576859","19577465","JH378118","18053084","18053501","251","1523775","GGCCAGGCATGGTGGCTCACACCTGTAATCCCAGCCCTTTGGGAGGCCGAGGCAGGTGGATCACCTGAGGTCAGGAGTTCGAGACCAGCCTGGCCAACATGGTGACACCCCACTCTACCAAAAATACAAAAATTAGGTTGGGTGCAGCGGTTCACACCTGTAATCCCAGCACTTTGGGAGGCCAAGGTGGATGGATCACCTGAGGTCAGGAGTTTGTGACCAGCCTGGCCAACATGGCGAAACCCTGCCTCTACTAAAAATAAAAAATTAGCCAGGTGTGGTGGCATGCGCCTGTAATCCTAGCTACTGAGGCAGGAGAATCGCTTGGACCAGGGAAGCAGAGTTTGCAGTGAGCCAAGATCACGCCACTGCACTCTAGCCTGGGTGACAGAGTAAGACTCCATCTCAAAAAAAAAAAAAAATACAAATATTAGCTGGGCATGGTGGCGCACACCTGTAGTTCTGGCTACTCAGGAGGCTGAGGCAGGAGAATTGCTTGAACCCAGAAGGCAGAGGTTGCAGTGAGCTGAGATTGTGCCATTGCACTCAGCCTGGGCAACAAAAGTGAAACTCCATCTCAAAATAAATAGATAAATAAATAAATAAA","GGCTGGGCGCAGTGGCTCACACCTGTAATCCCAGCACTTAGGGAAGCTGAGGCGAGTAGATCACCTGAGGTCAGGAGTTAGAGACCAGCCTGGCCATCATGGTGAAACCCCGTCTCTACTAAAGATACCAAAAATTAGCTGAGTGTGGTGCTGGGTGCCTGTAATCCCAGAAACTCAGGGTGCCTGTAATCCCAGCAACTCAGGGTGCCTTTAATCCCAGCAACTGAGGGTACCAGTAATCCCAGCAACTCAGGGTGTCTTTAATCCTAGCAACTGAGGGCACCTGTAATCCCAGCAACTCAGGAAGCTGAGACAGGAGAAGTACTTGAACCCAGAAGGCAGAGGTTGCAGTGAGCCGATATTGCACCATTGCACTCCAGTCTGGGCAACAAGAGTGAAACTCTGTCTCAAAAAAAAA"
"chr16","19983557","19984148","JH378118","18053084","18053501","244","1930473","GGCCGAGTGCGGTGGCTCATGCCTGTAATCCCAGCACTTTGGGAGGCCGAGACAGGTGAATCACCTGAGGTCTGGAGTTTGAGACCAGCTGACCAACATGGTGAAACCCTGTCTCTACTAAAAATACAAAAAATTGGCTGAGCGCAGTGGCCACGCCTGTTATCCCAGTACTTTGGGAGGCCGAGGCGGGTGGATCACGAGGTCAGGAATTCGAGACCAGCCTGACCAACATGGTGAAGCCCCGTCTCTACTAAAAATAAAAAAATTAGCCAGGTGTGGTGGTGCGCCCCTGTAAACCCAGCTACTCAGGAGGCTGAGGCAGGAGAATCACTTGAATCTGGGAGGCGGAGGTTGCAGTGAGCCAAGATCGAGCCACTGTACTCCAGCCTGGGAGACGGAGTGAGACTCCATCTAAAAAAAAAAAAAAATTAGCCAGGCGTGGTGGCACAAGCCTGTAATCCCAGCTACCTGGGAGGCTGAGATAGGAGAATTCCTTGAATCTGGGAGGCGGAGGTTGCAGTGAGCTGAGATTGTGCCATTGCACACCAGCCTGGGTGACAAGAGCAAAATTCCATCTCAAAAAAAAAAAAAA","GGCTGGGCGCAGTGGCTCACACCTGTAATCCCAGCACTTAGGGAAGCTGAGGCGAGTAGATCACCTGAGGTCAGGAGTTAGAGACCAGCCTGGCCATCATGGTGAAACCCCGTCTCTACTAAAGATACCAAAAATTAGCTGAGTGTGGTGCTGGGTGCCTGTAATCCCAGAAACTCAGGGTGCCTGTAATCCCAGCAACTCAGGGTGCCTTTAATCCCAGCAACTGAGGGTACCAGTAATCCCAGCAACTCAGGGTGTCTTTAATCCTAGCAACTGAGGGCACCTGTAATCCCAGCAACTCAGGAAGCTGAGACAGGAGAAGTACTTGAACCCAGAAGGCAGAGGTTGCAGTGAGCCGATATTGCACCATTGCACTCCAGTCTGGGCAACAAGAGTGAAACTCTGTCTCAAAAAAAAA"
"chr16","20117717","20118289","JH378118","18053084","18053501","224","2064633","GGCTGGGTGCGGTGGCTCACGCCTGTAATCCCAGCACTTTGGGAGGCCAAGGCGGGTAGATCATCTGAGGTCAGGAGTTCAAGACCAGCCTGGCCAACATGGTGAAACCCCGTCTCTACTAAAAATATTTTTAAAAGGCCAGGCGTGGTGGCTCACGCCTGTAATCCCAGCACTTTGGGAGGCCGAGGCGGGCAGATCATGAGGTCAGGAGTTCGAGACCATCCTGGCTAACACGGTGAAACCCCCGTCTCTACCAAAAAATACAAAAAATTAGCCGGGCATGGTGGCAGGTGCCTGTAGTCCCAGCTACTCGGGAGGCTGAGGCAGGAGGATGGCGTGAACCCAGGAGACAGAGCTTCCAGTGAGCTGAGATCGTGTCACTGCACTCCAGCCTGGGCGACAGAGGAGATTCTGTCTCAAAAAAAAAAAAAAAAAATTAGCTTGGTGTGGTGGCAGGTGCCTGTAATCCCAGTTACTCGGGAGGCTGAGGCAGAGGTTTCAGTGAACCGAGATCGCGCCATTGCACTCCAGCCTGGGCAACAAGAGTGAAACTCCGTCTCAAAGGAAAAAAAA","GGCTGGGCGCAGTGGCTCACACCTGTAATCCCAGCACTTAGGGAAGCTGAGGCGAGTAGATCACCTGAGGTCAGGAGTTAGAGACCAGCCTGGCCATCATGGTGAAACCCCGTCTCTACTAAAGATACCAAAAATTAGCTGAGTGTGGTGCTGGGTGCCTGTAATCCCAGAAACTCAGGGTGCCTGTAATCCCAGCAACTCAGGGTGCCTTTAATCCCAGCAACTGAGGGTACCAGTAATCCCAGCAACTCAGGGTGTCTTTAATCCTAGCAACTGAGGGCACCTGTAATCCCAGCAACTCAGGAAGCTGAGACAGGAGAAGTACTTGAACCCAGAAGGCAGAGGTTGCAGTGAGCCGATATTGCACCATTGCACTCCAGTCTGGGCAACAAGAGTGAAACTCTGTCTCAAAAAAAAA"
"chr16","20574957","20575888","JH378118","18053084","18053501","543","2521873","GGCCAGGCGTGGTGGCTCATGCCTGTAATCCCAGCACTGTGAGAGGCCGAGGCGGGCGGATCACCTGAGCTGAGGAGTTCGAGACCAGCCTGGCCAACATGGCGAAACCCCATCTCTACTAAAAACACAAAAATTAGGCCAGGTGTGGTGGCTCACACCTGTAATCCCAGCACTTTGGGAGGCCAAGGCGGGCGGATCACCTGAGGTCAGGAGTTCCAGACCTGCCTGGCCAACATGGTGGAATCCCATCTCTACTAAAAATACAAAAATCTGCCAGGTGTGGTGGCACACTTCTGTAATCCCAGATACTCAGGAGGCTGAGGCAGGAGAATCACTTGAACCCTGGAGATGGAGGTTGCAGTGAGCCAAGATCAAGAGATTGCACTCTAGCCAGGGTGACTAGAGTGAGACTCGGTCTCAAAAAAAATGTAATTAATTAATTAATTAATACAAAAATTAGCTGGGCGTGGGCTAGGTGTGGTGGCTCACGCCTGTAATCCCAGCACTTTGGGAGGCCGAGACAGGCGGATCACCTGAGGTCAGGAGTTCAAGACCAGTTTAACCAACATGGAGAAACCCCATCTCTACTAAAAATACAAAATTAGCTGGGCGTGGTGGTGCATGCCTGTAATCCCAGCTACTCGGGAGGCTGAGGCAGAAGAATCGCTTGAGCCTGGTAGGCGGAGATCGTGGTGAGCCGAGATCGCGCCATTGCACTCCAGCCTGGACAACAAGAGCGAAACTCCGTCTAAAAAAAAAAAAAAAATTAGCTGGGCATGGTAACAGGCGCCTGTAAACCCAGTTTCCTCGGGAGGCTGAAGCAGAATTGCTTGATCCCAGAGGCAGAGGTTGCAGTGAGCCAAGATAGTGCCATTGCAGTCCAGCCTGGGCAACAAGAGTGAAACTCCGTCTCAAAAAAAAAAAAAAAAAAA","GGCTGGGCGCAGTGGCTCACACCTGTAATCCCAGCACTTAGGGAAGCTGAGGCGAGTAGATCACCTGAGGTCAGGAGTTAGAGACCAGCCTGGCCATCATGGTGAAACCCCGTCTCTACTAAAGATACCAAAAATTAGCTGAGTGTGGTGCTGGGTGCCTGTAATCCCAGAAACTCAGGGTGCCTGTAATCCCAGCAACTCAGGGTGCCTTTAATCCCAGCAACTGAGGGTACCAGTAATCCCAGCAACTCAGGGTGTCTTTAATCCTAGCAACTGAGGGCACCTGTAATCCCAGCAACTCAGGAAGCTGAGACAGGAGAAGTACTTGAACCCAGAAGGCAGAGGTTGCAGTGAGCCGATATTGCACCATTGCACTCCAGTCTGGGCAACAAGAGTGAAACTCTGTCTCAAAAAAAAA"
"chr16","20816618","20817242","JH378118","18053084","18053501","267","2763534","GGCCCGGCGTGGTGGCTCATGCCTGTAATCCCAGCACTTTGGGAGGCCGAGGCCGGCGGATCACCTGAGGTCAGGAGTTTGAGACCACCCTGGCCAACACGGTGAAAACCTGTCTCTACTAAAAATACAAAAATTAGCCAGGCGCAGTGGCTCACGTCTGTAATTCCAGCACTTTGGAGGGCCGAGGGGGGCAGATCACAAGGTCAGGAGTCCAAGACCAGCCAGGCCAACATAGTGAAACCCGGTCTCTACTAAAAATACAAAAAATTAGCCGGGCGTGGTGGCGGACCCCTGTAGTCCCAGCTACTCAGGAGGCTGAGACAGGAGAATCTCTTGAACCCAGGAGGCAGAGGTTGCAGTGAGCCAAGATCATGCCATTCCACTCCAGCCTGGGCGACAGTGCAAGACTCTGTCTCAAAAACAAAAACAAAAAACCCCCAAACCAAAAATTAGCCAGGCGTGGTGGCATGCACCTGTAGTCCCAGCTACTTGGGAGGCTAAGGCAAGAGAATAGCTTGAACCCAGGAGGCAGAGGTTGCAGTGAGCCGAGATAGTGCCATTGCACTCCAACGTGGGTGACAAGAGCAAAACTCTGTCTCAAAAAAAAAAAAAAAAAAGGAAGGAA","GGCTGGGCGCAGTGGCTCACACCTGTAATCCCAGCACTTAGGGAAGCTGAGGCGAGTAGATCACCTGAGGTCAGGAGTTAGAGACCAGCCTGGCCATCATGGTGAAACCCCGTCTCTACTAAAGATACCAAAAATTAGCTGAGTGTGGTGCTGGGTGCCTGTAATCCCAGAAACTCAGGGTGCCTGTAATCCCAGCAACTCAGGGTGCCTTTAATCCCAGCAACTGAGGGTACCAGTAATCCCAGCAACTCAGGGTGTCTTTAATCCTAGCAACTGAGGGCACCTGTAATCCCAGCAACTCAGGAAGCTGAGACAGGAGAAGTACTTGAACCCAGAAGGCAGAGGTTGCAGTGAGCCGATATTGCACCATTGCACTCCAGTCTGGGCAACAAGAGTGAAACTCTGTCTCAAAAAAAAA"
"chr16","21054922","21055508","JH378118","18053084","18053501","243","3001838","GGCCGGGTGCGGTGGCTCACACCTATAATCCCAGCACTTTGAGAGTCTGAGGCAGGCGGATCACCTGAGGTCAGGAGTTCCAGACCAGCCTGGCCAACATGGTGAAACCCAGTCTCTACTAAAAATACAAAAAAAGACCGGGCACAGTGGCTCACGCCTGTAATTCCAGCACTTTGGGAGGCCGAGGCAGGTGGATCACCTGAGGTTGGGAGTTCGCGACCAGCCTGACCGACATGGAGAAATCCCATCTCTACTAAAAATACAAAATTAGCCGGGCGTGGTGGCACATGCCTGTAATTCCAGCTACTCAGGAGGCTGAGGGAGGAGAATCACTTGAACCTGGGAGGCGGAAGTTGTGGCGAGCCAAGATCACGCCATTGCACTCCAGCCTGGGCAACAAGAGTGAAACCCCATTTCAAAAAAAAAAAAAATTAGCCAGGGGTGGTGGTGCATTCTTGTAATACCAGCTACTCGGGAGGCTGAGGTAGGAGAATCACTTGAGCGCAGGAGGCAGATGTTGTAGTGAGCCGAGTGCCATTGCACTACAGCCTGGGCGACAAGAAAGTAACTCCACCTCAAAAAAAAAA","GGCTGGGCGCAGTGGCTCACACCTGTAATCCCAGCACTTAGGGAAGCTGAGGCGAGTAGATCACCTGAGGTCAGGAGTTAGAGACCAGCCTGGCCATCATGGTGAAACCCCGTCTCTACTAAAGATACCAAAAATTAGCTGAGTGTGGTGCTGGGTGCCTGTAATCCCAGAAACTCAGGGTGCCTGTAATCCCAGCAACTCAGGGTGCCTTTAATCCCAGCAACTGAGGGTACCAGTAATCCCAGCAACTCAGGGTGTCTTTAATCCTAGCAACTGAGGGCACCTGTAATCCCAGCAACTCAGGAAGCTGAGACAGGAGAAGTACTTGAACCCAGAAGGCAGAGGTTGCAGTGAGCCGATATTGCACCATTGCACTCCAGTCTGGGCAACAAGAGTGAAACTCTGTCTCAAAAAAAAA"
"chr16","27896431","27896766","JH378166","6401112","6401453","56","21495319","GGCCAGGCGCGGTGGCTCACGCCTGTAATCCCAGGACTTTGGTAGTCCAAGGCGGGTGGATCACCTGAGGTCAGGAGTTCAAGATCAGCCTGACCAACATGGCAAAACCTCGTCTCTACTAAAAAATACAAAAATTAGCCGGTGTGGTGGCAGGTGCCTGTAATTCCAGCTACTCGGGACGCTGAGTCATGAGAATTGCTTGAACCTAGGAGGCAGATGTTGCAATGAGCCGAGATCGCACCATTGTACTCCAGCCTGGGCGACAAGAGGGAAACTGTCTCCAAAAAAAAAAAAGAAAGAAAGAAAGAAAGAAAGAAAAAAGAAAAACAAAACAAA","GGCCAGGTGCAGTGGCTCACCCCTGTAATCCCAGCACTTTGGGAGGTCGAGGTGGGTGGATCACCTGAGGTCAGGAGTTCAAGACCAGCCTGACCAAAATGGTGAAACCCCATCTCTACTAAAAATACAAAACATTAGCCAGACATCGTGGCGGGCACCTGTAATCCCAGCTACTTGGGAGGCTGAGGCAGGAGAATTGCTTGAGCCTAGGAGGCGGAGGTTACAGTGAGCCATGATCGTGCCATTGGACTCCAGCCTGGGCTACAAGAGCGAGACTCCATCTCAAAAAAAAAAAAAAAAAAAAAAAAGAAAGAAAGAAAGAAAGAAAGAAAAGAAAGAAAG"
"chr16","36524888","36525430","JH378206","6546474","6546861","201","29978414","TTTGAGACCAGCCTGGCCATTGTGGTGAAACCCCGTCTCTACTAAAAAAAATTCAAAAAATGGCTGGGTATGGTGGCTCACGCCTGTAATCCCAGGACTTTGGGAGGCCAAGGTGGGCGGATCACCTGAGGTCAGGAGTTTGAGACCAGCCTAGCCAACATGGTGAAACCCCGTCTCTACCAAAAATACAAAAATTAGCCGGGCTTGGTGGCGCGCACCTGTAATCCCAGGTACACTGGAGGTTGAGGCACAAGAATCGTTTGATCCTGGGAGGTTGCAGTGAGCCAAGATCACGCCACTGCACTCCAGACTGGGTGACAGAGCGAGATTCCATCTCAAAACAACAACAACAAACCCAAAAAATTAGCTGGGTGTGGTGGTGGGTGCCTGTAATCCCAGCTACTTAGGAGGCTGAGGCAGAAGAATCGCTTGAACCCAGGAGGTGGAGGTTGTTGCAGTGAGCAGAGATCGCACCATTGCACTCCAGCCTGGGCAACGAGTGAAACTCCATCTCAAAAAAAAAAAAAAAAAAAGAAAAAAAAA","GGCCACACATGGTGGCTAACGCCTGTAATCCCAGCACTTTGGGAGGCCAAGTCGGGTGGATCATGAGGTCAGGAGACCAAGACCATCCTGGCCAAATGGTGAAACCCCGTCTCTACTAAAAATACAAAAATTAGCTGGGCATGGTGGCGTGTGCCTGTAATCCCAGCTACTCAGGAGGCTGAGGCAGGACAATTGCCTGAACCCAGGAGAATTAGCTGGGCATGGTGGCGTGTGCCTGTAATCCCAGCTACTCAGGAGGCTGAGGCAGGACAATTGCCTGAACCCAGGAGGCGAAGGTTGCGGTGAGCCGAGATTGTGCCATTGCACTCCAGCCTGGGTAACAAGAGCGACACTCTGTCTCAAAAAAAAAAAAAAAAAAAAAAAAAAA"
"chr16","36528224","36528842","JH378119","32351107","32351490","270","4177117","GGCCAGGCGTGGTGGCTCACGCCTGTAATCCCAGCACTTTGGGAGGCTGAGGCAGGCAGATCACCTGAGGTCAGGAGTTCAAGACCAGCCTGGCCAACATGGTGAAACTCCATCTCTACTAAAAATACAAAATTAAGCCGGGCACGGTGGCTCACATCTGAAATCCCAGCACCTTGGGAGGCTAAGGCAGGCGGATCACGAGGTCAGGAGTTCAAGACTAGCTGACCAATATGGTGAAACCCCGTGTCTACTAAAAATACAAAAAAAATTAGCTGGGCGTGGTGGCGCATGCCTGTAGTTCCAGGTACTCAGGAGGCTGAGGAAGGAGAATCACTTGAACCTGGGAGGCGGAGGTTGCAGTGAGCCAAGATCATGCCACTGCATTCCAGCCTGGGCAACAGAGCAAGACTCTGTCTCAAAAATAAAAATAAAAATAAAAGTAAAAATACAAAATTAGCCAGGCGTGGTGGTGTGTGCCTGTAATCACAGCTACTCAGGAGGCAGGAAAATCACTTGAACCTAGGAGGAGGAGGTTGGTGAGCCAAGATCACACCATTGCACTCCAGCCTGGGCAAAAAGAGCAAAACTCCGAACTCTGTCTCAAAAAAAAAAAAAAAAA","GGCCAGGTATGGTGGCTCACACCTGTAATCCCAGCACTTTGGGAGGCCAAGGCAGGCAGACCACCTGAGGTCAGGAGTTCGAGATCAGCCTAGCCAACATGGTGAAACCCCATCTCTAGTAAAAATAAAATTAGCCAGGCATGGTGGTGCATGCCTGTAACGCAGGTCAGGAGTTCGAGATCAGCTTAGCCAACATGGTGAAACCCCATCTCTAGTAAAAATAAAATTAGCCAGGCAGGTGGTGCCGCCTGTACTCGGGAGGCTGAGGCAGGAGAATCACTTGAACCCAAGAGGCAGAGGTTGCAGTCAGCCAAGATCATGCCATTGCACTCCAGCCTAAGCAAAAAGAGTAAAACTCAGTCTCAAAACAAAAAAACAAAAAAA"
"chr16","44800308","44800913","JH378118","18053084","18053501","244","26747224","GGCCTGGTGCAGTGGCTCACACCTGTAATCCCAGCACTTTGGGAGCCCAAGGCGGGTGGATCACCTGAGGTCAGGAGTTCGAGACCAGCCTGGCCAACATGGTGAAATCCTCTCTACTAAAAATGCAAAAAATTAGCTGGGCGGCCAGGCGCAGTGGCTCACGCCTGTAATCCCAGCACTTTGGGAGGCCGAGGTGGGCGGATCACAAGGTCAGGAGATCGAGACCATGCTGGCTAACACGGTGAAACTCCGTCTCTACTGAAAATACAAAAAATTAGCCAGGCACGGTGGCGGGCGCCTGTAGTCCCAGCTACTGGGGAGGCTGAGGCAGGAGAATGGCGTGAACCTGGGAGGTGGAGGTAGCAGTGAGCCAAGATTGCGCCACCGCAGTCCGGCCTGGGTGAAAGAGCGAGACGCTGTCTCAAAAAAAAAAAAAAAAAATTAGCTGGGCATGGTGGCGGGCGCCTGTAATCCCAGTTACTCGGGAGGCTGAGGCAGGAGAATCAGTTGAACCCAGGAGGTGGAGGTTGCAGTAAGCCAAGATTGTGCCATTGTACTCCAGTCTGGGCAACAAGAGCGAAACTCTGTCTTAAAAAACAAAAAAAA","GGCTGGGCGCAGTGGCTCACACCTGTAATCCCAGCACTTAGGGAAGCTGAGGCGAGTAGATCACCTGAGGTCAGGAGTTAGAGACCAGCCTGGCCATCATGGTGAAACCCCGTCTCTACTAAAGATACCAAAAATTAGCTGAGTGTGGTGCTGGGTGCCTGTAATCCCAGAAACTCAGGGTGCCTGTAATCCCAGCAACTCAGGGTGCCTTTAATCCCAGCAACTGAGGGTACCAGTAATCCCAGCAACTCAGGGTGTCTTTAATCCTAGCAACTGAGGGCACCTGTAATCCCAGCAACTCAGGAAGCTGAGACAGGAGAAGTACTTGAACCCAGAAGGCAGAGGTTGCAGTGAGCCGATATTGCACCATTGCACTCCAGTCTGGGCAACAAGAGTGAAACTCTGTCTCAAAAAAAAA"
"chr16","45828895","45829498","JH378118","18053084","18053501","256","27775811","GGCCAGGAGAGGTGGCTCATGCTTGTAATTCCAGTATTTTGGGAGCCCAAGGCGGGTGGATCACTTGAGGTCAGGAGTTTGAAACCAGCCTGACCAACATGGTGAAACCCCGTCTCTACTAAAAATTCAAAATTAGGCAAGGCCTGGTGGCTCATGCCTGTAATCCCAGCACTTTGGGAGGCCAAGGAGGGAGGATCACCTGAGGTCGGGAGTTTGAGACCAGCCTGACCAACATGGAGAAACCCCGTCTCTACTAAAACTACAAAATTAGCCGGGTGTGGTGGCCCATGCCTCTAATCCCAGCTACTCTGGAGGCTGAGGCAGGAGAATCACTTGGACCTGGGATGTGAAGGTTGCAGTGAGCCAAGATCGAGCCATTGCACTCCAGCCTGGGCCACAAGAGTGAAACTCCGTCCCAGAAAAAAAAAAAAAAATTAACCTGGCATGGTGGTGTATGCCTGTAATCCCAGCTACTCGGGAGACTGAGGCAGGAGAATCTCTTGAACCCGGGAGGCGGAGGTTGCAGTAAACCGAGATTGCGCCATTGCACTCCGGCCTGGGTGACAAGAGCGAAACTCCGCCTAAAAAAAAAAAGAAAAGAAAA","GGCTGGGCGCAGTGGCTCACACCTGTAATCCCAGCACTTAGGGAAGCTGAGGCGAGTAGATCACCTGAGGTCAGGAGTTAGAGACCAGCCTGGCCATCATGGTGAAACCCCGTCTCTACTAAAGATACCAAAAATTAGCTGAGTGTGGTGCTGGGTGCCTGTAATCCCAGAAACTCAGGGTGCCTGTAATCCCAGCAACTCAGGGTGCCTTTAATCCCAGCAACTGAGGGTACCAGTAATCCCAGCAACTCAGGGTGTCTTTAATCCTAGCAACTGAGGGCACCTGTAATCCCAGCAACTCAGGAAGCTGAGACAGGAGAAGTACTTGAACCCAGAAGGCAGAGGTTGCAGTGAGCCGATATTGCACCATTGCACTCCAGTCTGGGCAACAAGAGTGAAACTCTGTCTCAAAAAAAAA"
"chr16","47110839","47111458","JH378118","18053084","18053501","268","29057755","GGCCAGGCGTGGTGGCTCACGCCTTTAATCCCAGCACTTTGGGAGGCCGAGGCAGGCAGATCACCTAAGGTCAGGAGTTCGAGACCAGCCTGGCCAACATGGTGAAACCCCCTCTCTACTAAAAATGCAAAAATTTCTGGGCATGGTGGCTCACGCCTGTAGTCCCAGCACTTTGGGAGGCCAAGGCAGGCGGATCACTTGAGGTCAGGAGTTTGAGACCAGCCTGGCCAACATGGTGAGACCCCTGTCTCTACTAAAAATATAAAAAAGTAGCCAGGCGTGGTGGTGTATGCCTCCCAGATAATTGGGAGGCTGAGGTGGGATAATTGCTTGAACCCGGGAGGCAGAGGTTGTAGTGAGCCAAGATAGCGCCAATGCACTCCAGCCTGGGCAACAGAGCGAGACTCTGTCTCAAAAAAAAAAAAAAAAAGAAAAAAGAAAAGAAATTAGCTGGGCGTGGTGATGGGTGCCTGTAATCCCAGCTGCTTAGGAAGCTGAGGAAGGAGAATCACTTAGACCCAGGAGACAGAGGTTGCAGTGAGCCGAGATCGCACCATTGTATTCCAGCCTGGGTGACAAGAGAAAAACTATGTCTCAAAAAAAAAAAAAAGAGTAGAAAA","GGCTGGGCGCAGTGGCTCACACCTGTAATCCCAGCACTTAGGGAAGCTGAGGCGAGTAGATCACCTGAGGTCAGGAGTTAGAGACCAGCCTGGCCATCATGGTGAAACCCCGTCTCTACTAAAGATACCAAAAATTAGCTGAGTGTGGTGCTGGGTGCCTGTAATCCCAGAAACTCAGGGTGCCTGTAATCCCAGCAACTCAGGGTGCCTTTAATCCCAGCAACTGAGGGTACCAGTAATCCCAGCAACTCAGGGTGTCTTTAATCCTAGCAACTGAGGGCACCTGTAATCCCAGCAACTCAGGAAGCTGAGACAGGAGAAGTACTTGAACCCAGAAGGCAGAGGTTGCAGTGAGCCGATATTGCACCATTGCACTCCAGTCTGGGCAACAAGAGTGAAACTCTGTCTCAAAAAAAAA"
"chr16","48159907","48160229","JH378222","6231244","6231546","61","41928663","GGCTGGGCACAGTGGCTCATGCCTGTAATCCCAGCACTTTGGGAGGCCGAGGCAGGCGGATCACCTGAGGTCAGGAGTTCGAGACTAGCCTGGCCAATATAGCGAAACCCCGTCTCTACTAAAAATTAGTTGGGCATGGTGGCAGGCGCCTTAATCCCAGCTACTTGGGATGCTGAGGCAGAAGAATCGCTTGAACCCAGAGGGTGGAGGTTTCAGTGAGATGAGATCGTGCCATTGCACTCCAGACTGGGCAACAAGAGCGAGACTCTGTAAAAAAAATTAATTAATTAATTAACTAATTAATTAAAATAAAATGAGAAAAA","GGCTGGGCATGGTGGCTCACGCCTGTAATCCCAGCACTTTGGGACGCTTAGGCAGGTGGATTGCCTGAGGTCAGGAGTTCAAGACTACCCTGACCAACATAGTGAAACCCCGTCTCTACTAAAAATTAGCTGGGCATGGTGGCAGAGGCCTGTAATCCCAGCTACTCGGGAGGCTGAGGCAGGAGAATCACTTAAACCTGGGAGTTGGAGGTTGCAGTGAGCCAAGATCAAGCCATTGCACTCCAGTCTGGGCAACAAGAGCAAGACTCTGTCTCAAAAAAAAAAAAAAAAAGAAAAGAAAAA"
"chr16","49252302","49252639","JH378314","538162","538484","57","48714140","GGCCAGGCGCAGTGGTGCATGTCTGTAATCTTAGCACTTTGGGAGGCCGAGGTGGACGGATTACATGAGGTCAGGAGTTCAAGACCAGCCTGGCCAACATGGTGAAATTCCATCTCTACTACTAAAAAAAAAAAAAAAAAAAAAAAAAAAAAAAAAAAAAAATACAAAAATTAGCTGGGCTTGGTGGCGGGTGCCTGTAATCCCAGCTACTTGGGAGGCTGAGGCAGGAATCACTTAAACCCAGGAGGTGGAGGTTGCAGTGAGCCAAGACCATGCCATTGCACTCCAGCCTGGGCAACAAGAGCAAAACTCCGTCTCAAAAAAACAAAACAAAAAAA","GGCTGGGTGCGGTGCCTCACACCTGTAATCCCAGCACTTTGGGAGGCCGAGGTGGGTGGATCACGAGGTCAAGAGATCAAGACCATCCTGGTCAACATGGTGAAACCCTGTCTCTACTAAAAAAAAAAAAAAAAAAAAAAAAAAAAAAAAAAAAATTAGCTGGGCATGGTGGCGTGTGCCTGTAATCCCAGCTACTCAGGAGGCTGAGGCAGGAGAATTGCCTGAACCCAGGAGGCGGAGGTTGCGGTGAGCCGAGACTGTACCATTGCACTCCAGCCTGGGTAACAAGAGCGAAACTCCATCTCAAAAAAAAAAAAAAAAAA"
"chr16","49464616","49465219","JH378118","18053084","18053501","254","31411532","GGCCAGGCGTGGTGGCTCACACCTGTAATCCTAGCACTTTGGGAGACTGAGGCAGGTGGATCACATGAGGTGAGGAGTTCAAAACCACCCTGGCCGACATGGTGAAACCCCGTCTCTACTAAAAATATTTTTAAAAAGGCCAGGCGTGGTGGCTCACACCTGTAATTCCAGCACTTCGGGAGGCTGGGGCAGGCAGATCACAAGGTCAGGAGATCGAGACCATTCTGGCCAACGTGGTGAAACCCCGTCTCTACTAAAAATACAAAAATTAGCTGGGCGTGGTGGCGCGTGCCTGTAATCCCAGCTACTTGGGAGGCTGATACAGGAGAATTGCTTGAACCAGTGAGTCAGAGGTTGCAGTGAGCTGAGATTGCGCCATTGCACTCCAGCCTGGCAACAGAATGAGACTCCGTCTCAAAAAAAAAAAAAAAATTAGCTGGGCATGGTGGCAGGCACCTGTGATCCCAGCTACTTGGGAGGCTGAGGCAGGAGAATCGCTTGAACCTGGGAGGTGGAGGTTGCAGTGAGCTGAGATTGCGCCATTGCACTCCAACCTGGGCGTCAAGAGCAAAACTCCATCTCAAAAATAAATAAATAAATAAAA","GGCTGGGCGCAGTGGCTCACACCTGTAATCCCAGCACTTAGGGAAGCTGAGGCGAGTAGATCACCTGAGGTCAGGAGTTAGAGACCAGCCTGGCCATCATGGTGAAACCCCGTCTCTACTAAAGATACCAAAAATTAGCTGAGTGTGGTGCTGGGTGCCTGTAATCCCAGAAACTCAGGGTGCCTGTAATCCCAGCAACTCAGGGTGCCTTTAATCCCAGCAACTGAGGGTACCAGTAATCCCAGCAACTCAGGGTGTCTTTAATCCTAGCAACTGAGGGCACCTGTAATCCCAGCAACTCAGGAAGCTGAGACAGGAGAAGTACTTGAACCCAGAAGGCAGAGGTTGCAGTGAGCCGATATTGCACCATTGCACTCCAGTCTGGGCAACAAGAGTGAAACTCTGTCTCAAAAAAAAA"
"chr16","49983504","49983843","JH378316","567988","568320","50","49415516","GGCCAGGCATGGTGGCTTACGCCTGTAATCTCAGCACTTTGGGAGGCCAAGGCAGGCGGATCACCTGAGGTCAGGAGTTCAAGACCAGCCTGGTCAACATGGCGAAACCCTGTCTCTACTAAAAAAATACAAAAATTAGCCAGGCGTGGTGGTGGGCGCCTGTAATCTCTCCTACTTGGGAGACTGAGGCAGGAGAATTGCTTGAACTCAGAAGGCAGAGGTTGCAGTGAGCTGAGATCACGCCATTGCACTCCAGCCTGGATGACAAGAGCAAAACTCCATCTCAAACAAACAAAAAACAAACAAACAAAAAAAAACAAAAAAACCTCCAAAAAACAAA","GGCCGGGCGTGGTGGCTCACGCCTGTAATCCCAGCACCTTGGGAGGCTGAGGCGGGTGGATCACGAGGTCAAGAGATTGAGACCAGCCTGGTCAACATGGTGAAACCCTGTCTACTAAAAAAATACAAAAATTAGCTGGGCATGGTGGCACGTGCCTGTAATCCCAGCTACTCAGGAGGCTGAGGCAGGAGAATTGCCTGAACCCAGGAGGCGGAGGTTGCGGTGAGCCGAGATCGCGCCATTGCACTCCAGCCTGGGTAACAAGAGCGAAACTCCGTCTCAAAAAACAAAAAACAAAAAAACAAAAAACAAACAAACAAACAAAAAAACAAA"
"chr16","50470493","50471105","JH378118","18053084","18053501","251","32417409","GGCTGGGAGCGGTGGCTCATACCTGTAATCCCAGCACTCTGGGAGGCCGAGGCGCGTGGATCACCTGAGGTCAGGAGTTTGAGACCAGCCTGGCCAGCATGGTGAAACCCTGTCTCTACTAAAAATAGAAAAAGTTAGCTGGGTGAACAGCCGGGCGCGGTGGCTCACACCTGTAATCCCAGCACTTTGGGAGGCCGAGGCAGGTGGATCACAAGGTCAGGAGATCGAGACCATCCTGGCTAACACGGTGAAACCCTGTCTCTACTAAAAATATAAAAAATTAGCCGGGCATGGTGGTGGGTGCCTGTAGTCCCAGCTGCTCAGGAGGCTGAGGCAGGAGAATGGCGTGAAGCCAGGAGGCAGAGGTTGCAGTGAGCCGAGATCGTACCACTGCACTCTAGCCTGGGTGACAGAACGAGACTGTGTCTCAAAGAAAAAAAAAATTAGCTGGGTGTGGTGGCAGACACCTGTAATCCTAGCTACTTGGGAGGTTGAGGCAGGAGAATCGCTTGGACCTGGGAGGCGGAGGTTGCAGTAGGCTGAAATCGCACCATTGCACTCCAGCCTGGGCAACAAGAGGGAAACTCAGTCTCAAAAAAAAAAAAAAAAAAAA","GGCTGGGCGCAGTGGCTCACACCTGTAATCCCAGCACTTAGGGAAGCTGAGGCGAGTAGATCACCTGAGGTCAGGAGTTAGAGACCAGCCTGGCCATCATGGTGAAACCCCGTCTCTACTAAAGATACCAAAAATTAGCTGAGTGTGGTGCTGGGTGCCTGTAATCCCAGAAACTCAGGGTGCCTGTAATCCCAGCAACTCAGGGTGCCTTTAATCCCAGCAACTGAGGGTACCAGTAATCCCAGCAACTCAGGGTGTCTTTAATCCTAGCAACTGAGGGCACCTGTAATCCCAGCAACTCAGGAAGCTGAGACAGGAGAAGTACTTGAACCCAGAAGGCAGAGGTTGCAGTGAGCCGATATTGCACCATTGCACTCCAGTCTGGGCAACAAGAGTGAAACTCTGTCTCAAAAAAAAA"
"chr16","50478366","50478929","JH378114","15957391","15957789","242","34520975","GGCTGGGCACGGTGGCTCATGCCTGTAATCCTAGTACCCTGGGAGGCTGAAGCTGGCAGATCACTTGAGGTCAGGAGTTCGAAACCAGCCTGGCCAACATGGTGAAACCTCATCACTACTAAAAATACAAAAAGTCAGCCGAGCGCGGTGGCTCACGCCTTTAATCCCAGCACTTTAGGAGTCTGAGGCGGGTGGATCACAAGGTCAGGGGTTTGAGACTAGCCTGACCAACACGGTGAAACATCTTTACTAAAAATAGCCAGGCATGGTGGTGCAGGCCTGTAGCAGGTACTCAGGAGGCTGAGGCAGCAGAATCGCTTGAACCCGGGAGGCGGAGGTTGCAGTGAGCCGAGATTGAGCCACTGCACTCCACCCTGGGCAACTGAGCGAGACTCCGTCTCAAAAAAAAAAAAAAAAATTAGCTGGACGTGGTGGTGGATGCCTGTAATCCCGGCTACTTGGTACTTGGAAGGCTGAGACAGGAGAATCGCTTGAACCCGGGAGGTGGAGGTTGCAGTGAGCTGAGATAGCGCCATTGCACTCCAGCCTGGGCAACAAGAGTGA","GCAAGGAACGGTGGCTCATGCCTGTCATCCCAGCACTTTGGGAGGCTAAGGAGGGTGGATTACCGAAGGTCATGAGTTTGAGACCAGCCTGACCAACATGGTGAAAACCCCATCTCTACTAAAAATACAAAAAATTAGCCAGATACAGCTATGCGGCAGACTGGGGCAGGAGAATCGCTTGGACCCAAACCCCATCTCTACTAAAAATACAAAAAATTAGCCGGATACAGCTATGCGGGAGACTGGGGCAGGAGAATCGCTTGGACCCGGGAGGCAGAGATTGCAGTGAGATGAGACCATGCCATTGCTCTCTAGCTTGTGCGATGAGAACAAGACTCTGTCTCAAAAAAAAAAAAAAAAAAAAAAAAAAAAAAAAAAAAAAAAGAGAGAGAGAGAAAA"
"chr16","51388263","51388584","JH378271","2122362","2122678","46","49265901","GGCTGGGTACGGTGGCCCACACCTGTAATCCCAGCACCTTGGGAGGCTGAGGTGGGCGGATTACCTGAGGTCAAAAGTTCAAGACCAGCCTGGCCAACATGGTGAAATCCCATCTCTGCTAAAAATACAAAAAAAAAAAAAAAAAAAAAAAAAAAATTGCCAGGCATGGTGGCAGGCACCTGTAATCCCAGCTACTTGGGAGGCTGAGGCAGGGGAATCGCTTGAACCTGGGAGGCAGAGGTTGCAGTGAGCCCAGATAGCGCCATTGCACTCCAGCCTGGGCGACAAGAGCGAAACTCTGTCCAAAAAAAAAAAAAAAAAA","GGCCGGGCACGGTGGCTCACACCTGTAATCCCAGCACTTTGGGAGGCTGAGGTGGGTGAATCACCTGAGGTCAGGAGTTTGAGACCAGCCTGACCAACATGATGAAACCCGGTCTCTGCTAAAAATACAAAAAAAAAAAAAAAAAAAAAAAAAAAAAGCTGGGCATGATGGTGGGCACCTGTAATCCCAGCTACTCGGGAGGCTGAGGCAGGAGAATCGCTTGAACACCAGGAGGTGGAGGTTGCTATGAGCCGAGATCGCACCATTGCACTCTAGCTTGGGCAACAAGAGAGAAACTCCATCAAAAAAAAAAAAAA"
"chr16","51876298","51876882","JH378118","18053084","18053501","253","33823214","GTAATCCCAGCACTTTGGGAGGCCCAAGTGGGTGGATCACCTGAGGTCAGGAGTTCATGACCAGCCTGGCCACATGGTGAAACCCCATCTCTACTAAAAATACAAAATTAGGCTGGGCGCGGTGGCTTACGTCTGTAATTCCAGCACTTTGGGAGGCCGAGGCAGGCGGATCATGAGGTCAGGAGATTGAAACCATCCTGGCTAACACGGTGAAACCCTGTCTCTACTAAAAATACAAAAAATTAGCCGGGTGTGGTGGGGGGGCGCCTGTAGTCCCAGCTGCTCAGGAGGCTGAGGCAGGAGAATGGCATGAACCCGGGGGGGCGGAGCTTGCAGTGAGCTGAGATCATGCCACTGCACTCCAGCCTGGGCAACAAAGTGAGACTCCGTCTCAAAAAAAAAAACCAAAAAACAAAATGAGCTGGGTGTGGTGGTGGGGGCGTATAATCCCAGCTATACAGGAGGCTGAGGTAGGAGAATCACTTGAACCCGGGAGGTGGAGGTTGCAGTGAGCCGAGATTGTGCCATTTCACACCAACCTGGGTAACAAGAGTAAAATGCTGTCTCAAAAAAAAAAAAGAAAAA","GGCTGGGCGCAGTGGCTCACACCTGTAATCCCAGCACTTAGGGAAGCTGAGGCGAGTAGATCACCTGAGGTCAGGAGTTAGAGACCAGCCTGGCCATCATGGTGAAACCCCGTCTCTACTAAAGATACCAAAAATTAGCTGAGTGTGGTGCTGGGTGCCTGTAATCCCAGAAACTCAGGGTGCCTGTAATCCCAGCAACTCAGGGTGCCTTTAATCCCAGCAACTGAGGGTACCAGTAATCCCAGCAACTCAGGGTGTCTTTAATCCTAGCAACTGAGGGCACCTGTAATCCCAGCAACTCAGGAAGCTGAGACAGGAGAAGTACTTGAACCCAGAAGGCAGAGGTTGCAGTGAGCCGATATTGCACCATTGCACTCCAGTCTGGGCAACAAGAGTGAAACTCTGTCTCAAAAAAAAA"
"chr16","59738190","59738518","JH378138","4229795","4230103","67","55508395","TCACAGCATTTTGGGAGGCCAAGGCAGGCGGATCACCTGTGGTCAGGAGTTTGAGACCAGCCTGGCCAACATGGTGAAACCCCATCTCTACTAAAAATACAAAACAATTAGCCAGGTTTGGTGGCAGGCGCCTATAATCCCAGCTACTTGGGAGGCTGAGGCAGGAGAATCGCTTGAACCCAGGAGGCGGAGGTTGCAGTGAGCCGAGAACACACCATTGTACTCCAGCCTGCGACAAGAACGAAACTGTATCTCAATTAAAAAAAAAAAAAGAAAGGGAGGAAGGAAGGAAGGAAGGAAGGAAGGAAGGAAGGAAGAAAGAAAGAAAA","CACTTTGGGAGGTGAAGGCGGGCAGATCACCTGAGGTCAGGAGTTCGAGACCAGCCTGGCCAACATGGTGAAACCCCGCCTCTACTAAAAATACAAAAATTAGCCAGGTGTGACACTAGGCATCTGTAATCCCAGCTACTTGGGAGGCTGAGACAGGAGAATCACTTGAACCCAGGAGGCGGAAGTTGCAGTGAGCCAAGATCATGCCATTGCACTCCAGCCTGGGTGACAGGAGCAAAACTCTGTCTCAAAAAAAAAAAAAAAAAAAAAAAAAAAAAAAAAAAAAAAAGAAAAGAAAAGAAAAGTAAA"
"chr16","64682336","64682940","JH378118","18053084","18053501","253","46629252","GGCCGGGCACGGTGGCTCACTCCTGTAATCCCAGCACTTTGGGAGGGTGAGGCAGGTAGATCAAAAGGTCAGGAGTGGCCAGGCGTGGTGGCTCACACTTGTAATCCCAGCACTTTGGGAGGCCGAGATGGGCAGATCACGAGGTCAAGAGATTGAGACCATCCTGGCTAACATGGTGAAACCCCGTCTCTACTAAAAATACAAAAAATTAGCCGGGTGTGGTGGCAGGCGTCTGTAATCCCAGCCACTTGGGAGGCTGAGGCAGGAGAATCGCTTGAACCTGGGCGGCAGAGGTTGCATTGAGCCAGGATCGCGCCACTGCACTCCAGCCTGAGCAAAAAGAGCGAAACTCTGTCTCAGAAAAAAAAAAAAGTCAGGAGTTTGAGACCAGCCTGGCCAATATGGTGAAACCCCGTCTCTACTAAAAATACAAAAATTAGCCGAGCGTGGTGGTGGGTGCCTATACTCCCAGCTACTCAGGAGGCTGAGGCAGGAGAATCACTTGAACCCCAGGGGCAGAGGTTGCAGTGAGCCGAGATCGTGCCATTGCACTTCACCCTGGGTGAAAGAGCAAAACTCCGTCTCAAAAAAACAAAACAAAAAAA","GGCTGGGCGCAGTGGCTCACACCTGTAATCCCAGCACTTAGGGAAGCTGAGGCGAGTAGATCACCTGAGGTCAGGAGTTAGAGACCAGCCTGGCCATCATGGTGAAACCCCGTCTCTACTAAAGATACCAAAAATTAGCTGAGTGTGGTGCTGGGTGCCTGTAATCCCAGAAACTCAGGGTGCCTGTAATCCCAGCAACTCAGGGTGCCTTTAATCCCAGCAACTGAGGGTACCAGTAATCCCAGCAACTCAGGGTGTCTTTAATCCTAGCAACTGAGGGCACCTGTAATCCCAGCAACTCAGGAAGCTGAGACAGGAGAAGTACTTGAACCCAGAAGGCAGAGGTTGCAGTGAGCCGATATTGCACCATTGCACTCCAGTCTGGGCAACAAGAGTGAAACTCTGTCTCAAAAAAAAA"
"chr16","67872770","67873371","JH378118","18053084","18053501","260","49819686","GGCTGGGCATGGTGGCTCATGCCTGTAATCCCAGCACTTTGGGAGGCCAAGACGGGCAAATCACCTCAGGTCAGGAGATCGAGACCAGCCTGGCCAACACAGCAAAACCCACCTCTCTACTAAAAATAGAAAAATTACCCAGGCGTCACAGCTCACGCTTATAATCCCAGCACTTTGGGAGGCCGAAGCAGGTGGATCACAAGGTCAGGAGATCGAGACCAGCCTCACTAACATGGTGAAACCCCGTCTCTACTGAATATACGAAAAATTAGTCGGGTGTGGTGGCAGGCACCTGTAGTCCCAGCTACTTGGGAGGCTGAGGCAGGAGAATGGCTTTAACTCAGGAAGAGGAGCTTACGGTGAGCTGAGATTGTGCCACTGCACCCCAGCCTGGGCGACAGAGCAAGACTCCGTCAAAAAAAAAAAAAACCCCAAAACCCCAGCGTGGCAGCAGGTACCTGTAGTCCCAGCTACTCGGGAGGCTGAGACAGGAGAATGGCTTGAACCCGGGAGGCGGAGCTTGCGGTGAGCCAAGACGGCGCCACTTCATTCCAGCTATGGTGATAAGAGGGAGACCGTCTCAATCAATAAATTTAAAAAAA","GGCTGGGCGCAGTGGCTCACACCTGTAATCCCAGCACTTAGGGAAGCTGAGGCGAGTAGATCACCTGAGGTCAGGAGTTAGAGACCAGCCTGGCCATCATGGTGAAACCCCGTCTCTACTAAAGATACCAAAAATTAGCTGAGTGTGGTGCTGGGTGCCTGTAATCCCAGAAACTCAGGGTGCCTGTAATCCCAGCAACTCAGGGTGCCTTTAATCCCAGCAACTGAGGGTACCAGTAATCCCAGCAACTCAGGGTGTCTTTAATCCTAGCAACTGAGGGCACCTGTAATCCCAGCAACTCAGGAAGCTGAGACAGGAGAAGTACTTGAACCCAGAAGGCAGAGGTTGCAGTGAGCCGATATTGCACCATTGCACTCCAGTCTGGGCAACAAGAGTGAAACTCTGTCTCAAAAAAAAA"
"chr16","67970409","67971018","JH378118","18053084","18053501","252","49917325","GGGCGGGTGCGGTGGCTCACCCTGTAATCCCAGCACTTTCGGAGGCTTAAGCAGGCGGATCACCTGAGGTCAGGAGTTCGAGACCAGCCTGGCCAACATGGTGAAACCCCATCTCTACTAAAAATACAAAAAAATGGCCGGGTGCGGCGGCTCATGCCTGTCATCCCAGCACTTTCGGAGGCTGAGGCAGGCGGATCACCGGAGGTCAGGAGTTCGAGACCAGCTTGGCCAACATGGTGAAACCCCGTCTCTACTAAAAATACAAAAGTTAGCTGGGCATGGTGGCACATGCCTGTAATCCCAGCTACTCCGGAGGCTGAGGCAGGAGAATCACTTGAACCTGGGGAGGCGGAGGTTGCAGTGAGCTGAAATCACGGCATTGCACTCCAGCCTAGGCAACAGAGCGAAAGTCCGTCTCAGAAAAAAAAAAAAAAAAATTAGATGGGTTTGGTGGCGGGCGCGCTGTAATCCCAGCTACTTGGGAGGCTGGAGGCAGGAGAATCGCTTGAACTCAGGAGGCTGAGGTTACAGTGAGCCGAGATCATGCCATTGCACTCCAGCCTGGGCAATAAGAGTGAAACTCTGTCTCAAAAAACAACAACAACAAAAA","GGCTGGGCGCAGTGGCTCACACCTGTAATCCCAGCACTTAGGGAAGCTGAGGCGAGTAGATCACCTGAGGTCAGGAGTTAGAGACCAGCCTGGCCATCATGGTGAAACCCCGTCTCTACTAAAGATACCAAAAATTAGCTGAGTGTGGTGCTGGGTGCCTGTAATCCCAGAAACTCAGGGTGCCTGTAATCCCAGCAACTCAGGGTGCCTTTAATCCCAGCAACTGAGGGTACCAGTAATCCCAGCAACTCAGGGTGTCTTTAATCCTAGCAACTGAGGGCACCTGTAATCCCAGCAACTCAGGAAGCTGAGACAGGAGAAGTACTTGAACCCAGAAGGCAGAGGTTGCAGTGAGCCGATATTGCACCATTGCACTCCAGTCTGGGCAACAAGAGTGAAACTCTGTCTCAAAAAAAAA"
"chr16","68229729","68230314","JH378206","6546474","6546861","256","61683255","TGGTTTCCGCCTGTACTCCCAGCACTTTCGGAGGCTCAAGTGAGCAGATCGCTTGAGGCCAGGAGTTTAAGACCTACCTAGTCAACACCGGGGAAACCCACATCTCCACTAAACAATGGCCAGGAGCAGTGGCTCATACCTGTAATCACAACACTTTGGGATCCCAGCCAGACGGATCACAAAGTCAGGAGTTTGCGACCAGCCTATTAGAATGGTGAAACCCTGTCTCTACTAAAAATACAAAAAATTAGCCAGGCATGGTGGCGCATGCCTGTCATCCCAGCTACTCGGGAGGCTGAGGCAAGAGAATCACTTAAACCCAGGAGGCAGATGGAGGTTGCAGTGAGCCAAGATCACACCACTGCACTACAGCATGGGCGACAGAGCAAGACTCGGTCTCAAAAAAAAAAAAATTGGCCAGGCACGGTGGCTGACACCTGTAATCCCAGCACTTTGGGAGGCTGAGGCGGGAGAATCGCTTGAACCTGGGAGACGAAGGTTGCAGTGAGCCGAGACTAAGCCATTGCACCCCAACCTGGGCGGCAAGAGTGAAACTCTGTCTCAAAAAAAATTAAAAAATAAAAAA","GGCCACACATGGTGGCTAACGCCTGTAATCCCAGCACTTTGGGAGGCCAAGTCGGGTGGATCATGAGGTCAGGAGACCAAGACCATCCTGGCCAAATGGTGAAACCCCGTCTCTACTAAAAATACAAAAATTAGCTGGGCATGGTGGCGTGTGCCTGTAATCCCAGCTACTCAGGAGGCTGAGGCAGGACAATTGCCTGAACCCAGGAGAATTAGCTGGGCATGGTGGCGTGTGCCTGTAATCCCAGCTACTCAGGAGGCTGAGGCAGGACAATTGCCTGAACCCAGGAGGCGAAGGTTGCGGTGAGCCGAGATTGTGCCATTGCACTCCAGCCTGGGTAACAAGAGCGACACTCTGTCTCAAAAAAAAAAAAAAAAAAAAAAAAAAA"
"chr17","3506470","3507049","JH378118","18053084","18053501","238","14546614","CCTGTCATCCCAGCACTTTGGGAGGCCGAGGCGGGTAGATCACCTGAGGTCAGGAGTTTGAGACCAGCCTGGCCAACATGGCGAAACCCCGTCTCTACTAAAAATACAAAAACTGGCTGGGCGCGGTGGCTCACGCCTGTAATCCCAGCACTTTGGGAGGCTGAGGCGGGTGGATCATAAGGTCAGGAGTTCAAGACCAGCCTGGCCAACATGGTGAAACCCCATCTCTACTAAAAATACAAAAATTAGCCAGGTATGGTGGCAGGTGCCTGTAATCCCAGCTACTCAGGAGGCTGAGGCAGAGAATTGCTTGAACCCGGGAGGGGGAGGTTGCAGAGGGCCAAGATCGTACCACTATACTCCAGCCTGGGTGACAGGATGAGACTCCATCTTAAAAAAAAAAAAAAAAAAAAAAATTAGCCAGGCGTGGTGCGGGCACTTGTAATCCCAGCTATTCAGGAGGCTGAGGCAGGAGAATTGCTTGAACCCGGGAGGCAGAGGTTGCGGTGAGCTGAGATCGCACCATTGCACTCCAGCCTGGGCAACAAGAGTGAAACTCTGTCTCAAAAAAAAAACAAAA","GGCTGGGCGCAGTGGCTCACACCTGTAATCCCAGCACTTAGGGAAGCTGAGGCGAGTAGATCACCTGAGGTCAGGAGTTAGAGACCAGCCTGGCCATCATGGTGAAACCCCGTCTCTACTAAAGATACCAAAAATTAGCTGAGTGTGGTGCTGGGTGCCTGTAATCCCAGAAACTCAGGGTGCCTGTAATCCCAGCAACTCAGGGTGCCTTTAATCCCAGCAACTGAGGGTACCAGTAATCCCAGCAACTCAGGGTGTCTTTAATCCTAGCAACTGAGGGCACCTGTAATCCCAGCAACTCAGGAAGCTGAGACAGGAGAAGTACTTGAACCCAGAAGGCAGAGGTTGCAGTGAGCCGATATTGCACCATTGCACTCCAGTCTGGGCAACAAGAGTGAAACTCTGTCTCAAAAAAAAA"
"chr17","3641899","3642243","JH378198","5062782","5063109","59","1420883","GGCCAGGCACAGTGGCTCACACCTGTAATCCCAGCACTTCAGGAGGCCGAGGTGGGTAGATCACCTGAGGTCAGGGGTTTGAGACCAGCCTGACCGACGTGGCGAAACCCTGTCTCTACTACAAATACAAAAATTAGCCTTATGTGGTGGCGGGCACGTGTAATCCCAGCTACTTGGGAGGCTGAGGCAGGAGAATCGCTTGAATCTGGGAGGTGGAGGTTGCAGTGAGCCGAGATCACGCCATTGCACTCCAGCCTGGGTGACAAGAGCGAAACTCCATCTCAAAATAAATAAATACATACATACATGTATACATACATACATACATAAAAATAAAAAGTAAAA","GCCAGGCATGGTGGCTCACGCCTATAATCTCAGCACTTTGGGAGGCTGAGGCAGGCAGATCACTTGAGGTCAGGAGTTCAAGACCAGCCTGGCCAACATGGTGAAACCCTGGCTCTACTAAAAATACAAAAATTAGCCGGGTGTGGTGGCACGTGCCTATAATCCCAGCTACTCAGGAGGCTGAGGCAGAAGAATCGCTTGAATCCAGGAGGTGGAGGTTGCAGCGAGCCGAGATCACACCATTGGACTCCAGCCTGGGTGACAAGAGCGAAACTCCATCTCAAAATAAATAAATAAATACATAAAATTAAAAATAAATAAATAAATA"
"chr17","4508039","4508546","JH378206","6546474","6546861","194","2038435","GAGTTGGAGACCAGCCTGGCCAACACGGTGAAACCTCGTCCCCACTAAAAATATAAAAATTAGGCCAGGCGCGGTGGCTCACTCCTGTAATCCCAGCACTTTGGGAGGCTGAGGCGGGTAGATCATCTGAGGTCAGGAGTTCGAGACCAGCCTGGCCAACATGGTGAAACTCCGTCTCTACTAAAAATACAAAAATTAGCTGGGCTGGTAGCGGGCACCTGTAATCCCAGCTACTTGGAAGGGTGAGGCAGGAGAATCACTTGAACCCAGGAGGTGGAGGTTGCAGTGAGCCAAGATTGCAGCACTGTACTCCAGCCTGGGTGACAAAGCAAGACTCTGTCTCAAAAAAAAAAAAAAAAAAAAAGCCGGGCTTGGTGGTGAGTACCGGTAATCCCAGCTACTTGGAAGGCTGAGGCGGCGGACGTTGTACTTAGCCGAGATCATGCCATTGCACTCCAGCCTGGGTAACAGGCAAAAACTCTGTCTCAAAAAATAATAAATAATAAAA","GGCCACACATGGTGGCTAACGCCTGTAATCCCAGCACTTTGGGAGGCCAAGTCGGGTGGATCATGAGGTCAGGAGACCAAGACCATCCTGGCCAAATGGTGAAACCCCGTCTCTACTAAAAATACAAAAATTAGCTGGGCATGGTGGCGTGTGCCTGTAATCCCAGCTACTCAGGAGGCTGAGGCAGGACAATTGCCTGAACCCAGGAGAATTAGCTGGGCATGGTGGCGTGTGCCTGTAATCCCAGCTACTCAGGAGGCTGAGGCAGGACAATTGCCTGAACCCAGGAGGCGAAGGTTGCGGTGAGCCGAGATTGTGCCATTGCACTCCAGCCTGGGTAACAAGAGCGACACTCTGTCTCAAAAAAAAAAAAAAAAAAAAAAAAAAA"
"chr17","4560867","4561450","JH378118","18053084","18053501","257","13492217","GGCTGGGGGTGGTGTCTCTTGCCTGTAATCCCAACACTTTAGCAGGCTGAGGTGTGAGTATGGCTTGAGCCAGGAGTTCTAGACCAGCCTAGGAAACATGGCGAGATCCCTATCTCTACTAATACAAAAATTAGCCGGGCGTGGTGGCAAGCACCTGCAATCTCAGCTACTCGGGAGGCTGAGGTGGGAGGGCCGCTTGAGCCCAGGAGGTCCAGGCTGCAGTAAGCACTTATTTAAAAAAAAAAGAAGAGAAAAGATACAGAAATTAGCCAGGCGTGGTGGTGGGCACCTGTAATCCCAGCTACTCAGGAGGCTGAGGCAGGAAAATCACTTGAACCCGGGAGGCAGAGGTTGCAGTGGGCCGAGATCACACCATTGTACTCCAGCCTGGGCAACAAGAGCGAAACTCTGTCTCAAAAAAAAGAAAAGTAAAGTAAAGAAAAGATACAGAAATTAGCCAGGTGTGGTGGCGGGTGCCTGTAATCCCGCTACTTGGGAGGCTGAGGCAGGAGATTGCAGTGAGCCAAGATTGTGCCATTGCATTCCAGCCTGGGCAACAAGAGCAAAACTCCGCCTCAAAAAAA","GGCTGGGCGCAGTGGCTCACACCTGTAATCCCAGCACTTAGGGAAGCTGAGGCGAGTAGATCACCTGAGGTCAGGAGTTAGAGACCAGCCTGGCCATCATGGTGAAACCCCGTCTCTACTAAAGATACCAAAAATTAGCTGAGTGTGGTGCTGGGTGCCTGTAATCCCAGAAACTCAGGGTGCCTGTAATCCCAGCAACTCAGGGTGCCTTTAATCCCAGCAACTGAGGGTACCAGTAATCCCAGCAACTCAGGGTGTCTTTAATCCTAGCAACTGAGGGCACCTGTAATCCCAGCAACTCAGGAAGCTGAGACAGGAGAAGTACTTGAACCCAGAAGGCAGAGGTTGCAGTGAGCCGATATTGCACCATTGCACTCCAGTCTGGGCAACAAGAGTGAAACTCTGTCTCAAAAAAAAA"
"chr17","4846296","4846953","JH378118","18053084","18053501","290","13206788","GGCCAGGTGCAGTGGCTCACGCCTGTAATCCCAGCACTTTGGGAAGCCCAGGTGGGCGGATCACCCAAGGTCAGGGGTTCGAGACCAGCCTGGCCAACATGGTGAAACTCCATCTCTACTAAAAATAGAAAAAAATGGCCTGGTACGGTGGCTAACGCCTGTAATCCCAGCACTTTGGTAGGCCGAGGCAGGCAGATCACGAGGTCAGAAGATCGAGACCATCCTGGCTAACATGGTGAAACCCCGTCTCTACTAAAAATACAAAAAAGTAGCCAGGTGTGGTGGTGGGTGCCTGTAGTCCTAGCTACTCGGGAGGCTGAGGCAGGAGAATGCCGTGAACCCGGGAGGTGGAGCTTGCAGTGAGCTGAGATCACGCCACTGCACTCCAGCCTGGGTGACAGTGCGAGACTGTCTCCAAAAAAAAAAAAAAAAAAAAATTATATATATAATACACACACACACACACACACACACACACACACACAAATCAGCCAGGCGTGGTGGTGCGCACCTGTAATCCCAGCTACTCGGGAGGCTGAGGCAGGAGAGCTCCTCGAACCCAGGAGGCGAAGGTTGCAGTGAGCCGAGATCACACCATTGCACTCCAGCCTGGGCAACAAGAGCGAAACTCTGTCTCAAGGAAAAAAAAAAAAAAAAA","GGCTGGGCGCAGTGGCTCACACCTGTAATCCCAGCACTTAGGGAAGCTGAGGCGAGTAGATCACCTGAGGTCAGGAGTTAGAGACCAGCCTGGCCATCATGGTGAAACCCCGTCTCTACTAAAGATACCAAAAATTAGCTGAGTGTGGTGCTGGGTGCCTGTAATCCCAGAAACTCAGGGTGCCTGTAATCCCAGCAACTCAGGGTGCCTTTAATCCCAGCAACTGAGGGTACCAGTAATCCCAGCAACTCAGGGTGTCTTTAATCCTAGCAACTGAGGGCACCTGTAATCCCAGCAACTCAGGAAGCTGAGACAGGAGAAGTACTTGAACCCAGAAGGCAGAGGTTGCAGTGAGCCGATATTGCACCATTGCACTCCAGTCTGGGCAACAAGAGTGAAACTCTGTCTCAAAAAAAAA"
"chr17","6289040","6289368","JH378152","15932639","15932952","57","9643599","GGCTGGGCGTGGTGGCTCACGCCTGTAATCCCAGCACTTTGGGAGGCCAAGGTGGGTAGATCACCTGAGGTCAGGAGTTTGAGACCAGCCTGGCCAATGTGATGAAACCCTGTATCCACTAAAAAAAAAAAAAAAAAAAAAAAAAAAAATAGCTGGGTGAAGTGGCAAGCACCTGTAATCCCAGCTACTTGGGAGGCTGAGGCAGGAGAATCCCAGGAGGTGGAGATTGATCCCAGGAGGTGGAGGTTGCAGTGAGTCAAGATCATGCCATTGCACTCCAGCCTGGGTGACAAGAGCAAAATTCCATCTCAAAAAAAAAAAAAAGAAAA","GGCCGGGCATGGTGGCTCAAGCCTGTAATCCCAGCACTTTGGGAGGCCGAGGCGGGTGGATCACGAGGTCAAGAGATTGAGACCATCCTGGTCAACATGGTGAAACCCCGTCTCTACTAAAAATACAAAAAAAAAAAAAAAAAAAATAGCTGGGTGTGGTGGCGTGTGCCTGTAATCCCAGCTACTCAGGAGGCTGAGGCAGGAGAATTGCCTGAACCCGGGAGGCGGAGGTTGCGGTGAGCCGAGATCGCGCCATTGCACTCCAGCCTGGGTAACAAGAGCGAAACTCCGTCTCAAAAACAAAAAAAACAAAA"
"chr17","7490664","7491294","JH378118","18053084","18053501","283","10562420","GGCCGGGAGCGGTGGTTCACTCCTGTAATCCCAGCACTTTGGCAGACCGAGGAGGGTGGATCAACTGAGGTCAGAACTTCAAGACCAGCCTGCCGGGCACAGTGGCTCACACCTGTAATCCCAGCACTTTGGGAGGCTGAGGCAGGTGGATCACCCGAGGTCGGGAGTTCAAGACCAGCCTGACCAACGTGGAGAAACCCCGTCTCTACTAAAAATACAAAATTAGCTGGGGTGGTGGCACGTACCTGTAATCCCAGCTACTCGGGAGGCTGAGGCAAGAGAATCGCTTGAACCCGGGAGGCGGAGGTTGCGGTGCGCCGAGATCGCGCCATTACACTCCAGCCTGGGCAAAAAGAGCGAAACTCTGTCTCAAAAAATAAAAAAAGAAAAAGAAAAAGAAAAAGAAGTTCAAGACCAGCCTGGTCAACGTGGTGAAACCCCGTCTCTACTAAAAACACAAAAAAAATTAGGCGGGTGTTGTGGTGGGTGCCTGTAATCCCAGCTACTCAGGAGGCCAAGGCAGGAGAATCACCTGAACCCTGGAGGTGGAGGTTGCAGTGAGTCGAGATCGCACCATTGCACTCCAGCGTGGGTGACAGAGAGCGAGACTCCGTCTCAAAAAAAAAGAAAA","GGCTGGGCGCAGTGGCTCACACCTGTAATCCCAGCACTTAGGGAAGCTGAGGCGAGTAGATCACCTGAGGTCAGGAGTTAGAGACCAGCCTGGCCATCATGGTGAAACCCCGTCTCTACTAAAGATACCAAAAATTAGCTGAGTGTGGTGCTGGGTGCCTGTAATCCCAGAAACTCAGGGTGCCTGTAATCCCAGCAACTCAGGGTGCCTTTAATCCCAGCAACTGAGGGTACCAGTAATCCCAGCAACTCAGGGTGTCTTTAATCCTAGCAACTGAGGGCACCTGTAATCCCAGCAACTCAGGAAGCTGAGACAGGAGAAGTACTTGAACCCAGAAGGCAGAGGTTGCAGTGAGCCGATATTGCACCATTGCACTCCAGTCTGGGCAACAAGAGTGAAACTCTGTCTCAAAAAAAAA"
"chr17","9634166","9634493","JH378110","12773123","12773444","45","3138957","GGCTGGGTGCGGTGGCTCACGCCTGTAATCCCAGCACTGTGGGAGGCCGAGGCAGGTGGATCACCTGAGGTCAGGAGTTTGAGACCAGCTTGGCCAACATGGTGAAACCCTGTCTGCACTAAAAATACAAAAAAAAAAAAAAAAAAAAAAAAATTAGCTGGGTGTGGTGGCGGACGCCTATAATCCCAGCTACTGGGGAGGCTAAGGCAGGAGAATCGCTTGAACCTGGGAGGTGGAGATTGCAGTGAGCCAAGATGGTGCCATTGCACTCCAGCCTGGACAACAAGAGCGAAACTCGGTTTCAAAAAAAAAAAAAAAAAAAAAAAAA","GGCTGGGCGTGGTGGCTCATGCCTATAATCCCAGCACTTGGAGAGGCCAAAGCAGGCAGATTATTTGAGGTCAGGAGTTCCAAACCAGCCTGGCCAACATGGTGAAACCCTGTATCTACTAAAAATGCAAAAAAAAAAAAAAAAAAAAAAATTAGCTGGGCGTGGTGGCAGGTGACTGTATCCCAGTACTTGGTAGGCTGAGGCAGGAGAATTGCTTGAACCTGGGAGGTGGAGGTTGCAGTGAGCTGAGATTGTGCCATTGCACTCCAGCCTGGGCAACAAGAGCAAAACTCTGTCTCAAAAAAAAAAAAAAAAAAAAAAA"
"chr17","9636859","9637187","JH378193","2430153","2430476","55","7206706","GACACGGTAGCTCACGCCTGTAATCCCAGCACTTTGGGAGGTCGAGGCGGGTGGATCACCTGAGGTCAGGAGTTTAAGACCAGCCTGGCCAACATGGTGAAACCCCGTCTCTGCTAAAAATACAAGAATTAGCCAGGCGTGGTGGTGGGCGCCTGTAATCCCAGCTACTGGGGAGGCTGAGGCAGGAGAATCACTTGAACCCAGAAGGTGGAGGTTGCAGTGAGCCAAGACCACACCACTGGACTGCAGCCTGGCGGACAAGAGCGAGACTCTGTCTCAAAAACAACAACAACAACAACAACAACAACAAAAGAAAGAAAAGAAAAGAA","GGCCGGGCACAGTGGCTCAAGCCTGTAATCCCAGCACTTTGGGAGGCCGAGGTGGGTGGATCACGAGGTCAAGAGATCGAGACCAACCTGGTCAACATGGTGAAACCCCGTCTCTACTAAAAATACAAAAATTAGCTGGGCATGGTGGTGTGTGCCTGTAATCCCAGCTACTCAGGAGGCTGAAGCAGGAGAATTGCCTGAACCCAGGAGGAGGAGGTTGCGGTGAACCAAGATCACGCCATTGCACTCCAGCCTGGGTAACAAGAGCGAAACTCTGTCTCAAAACAAAACAAAACAAAACAAAACAAAACAAACAAAAAAAAA"
"chr17","9725612","9725938","JH378224","2846632","2846964","49","6878980","GGGCGTGGTGGCTCACACCTGTAATCCCAGCACTTTGGGAGGCCGAGGTGGGCGGATTGCCTGAGGTCAGGAGTTCGAGACCAGCCTGGCCAACCCGGTGAAACCCTGTCTCTACTAAAATACAAAAAAAAAAAAAAAAAAAAAAAAAAATTTAGCTGTGTGTGGTGGTGTGCACCTGTAATCCCAGCTACTCAGAAGGCTGAGGCAGGAGAATCGCTAGAACCCGGGAGGCGGAGGTTGCAGTGAGCCGAGATCGCACCATTACGCTCCAGCTTGGGCAACAAGAGTGAAACTCCATCTCAAAAACAAAACAAAACAAAACAAAAA","GGCCAGGCAGGGTGGCTTACATCTGTAATCCCAGCACTTTGGGAGGTCAAGGCGAGTGGATCACCTGAGGTCATGAGTTCAAGACCAGCCTGGCCAACTTGGTGAAACCCTGTCTCTACTAAAAATACAAAAAAAAAAAAAAAAAAAAAAAAAAAAATTAACTGGGTGTGGTGGTGCACACCTGTAATCCCAGCTACTCAGGAGGCTGAGGCAGGAGAATCCCTTGAACACGGGAGGTGGAGGTTGCAGTGAGCCGAGATCATGCCATTGCACTCCAGCCTTGGTGAAAAGAGCAAAACTCTGTCTTAAACAAAACAAAACAAAACCAGAAAA"
"chr17","11904179","11904388","JH378115","24252957","24253162","48","12348778","CCTGTCTTTACAAAAAATGCAAAAACAAAACAAAACAAAACAAAACAAAAACCGGGCATGGTGGTGAGCACCTGTAATCCCAGCTACTTGGGAGTTTGAGGCAGGAGAATCACTTGAACCTGGGAAGCGGAGGTTGCAGTGAGCCGAGACCGCGCCATTGCACTCCAGCCTGGGCAACAAGAATGAAACTCTGTCTCAAAAAAAAAAAAA","TGGTGAAACCCTGTCTTTACTAAAAATACAAAAAAAAAAAAAATTAGCTGGGCATGGTGGCACATGCCTGTAGTCCCAGCTGCTCGGGAGGCTGAGGCAGGAGAATTGCTTGAACCCAGGAGGCGGAGGTTGCAGTGAGCCGAGATCGAGCCATTGCACTCCAGCCTGGGCAACAAGAGCAAAACTCCGTCTCAAAACAAAATAAA"
"chr17","15884346","15884946","JH378118","18053084","18053501","249","2168738","GCCAGGCAGGTGGCTCAGGACTGTAATCCCAGCCTTTTGGGAGGCTGAGGCGAGTGGATCACCTGAGGTCAGGAGTTCGACACCAGCCTGGTCAACATGGTGAAACCCCGTCTCTACTAAAAAATACAAAAAATTGGCCAGGCGCAGTGTCTCACGCCTGTAATCCCAGCACTTTAGGAGGCTGAGGCAGGTGGATCACTTGGTCAGGAGATCGAGACCATCCTGGCCAACATGGTGAAACCCTGTCTCTATCAAAAATACAAAAATTAGCTGGGCGTGGTGGCATATGCCTATAATCCCAGCTACTTGGGACGCTGAGGCAGGAGAATCACTTGAACCAGGGAGTCAGAAGTTGCAGTGAGCCGAGATTGCGCCACTGCACCCCAGCCTGGTGACAGAGTGAGACTGTCTTAAAAAACAAAAAACAAAAAATTAGCCAGGTATGGTACCAGGTGCCTGTAACCCCAGCTACTTGGGAGGCTGAGGCAGGAGTATCGCTTGAACCCTGGAGGTGGAGGATGCAGTGAGCTGAGAGCACGCCATTGTACTCCAGCCTGGGCAACAAGAGTGAAACTCCATCTAAAATAAATAAAAATAAAAA","GGCTGGGCGCAGTGGCTCACACCTGTAATCCCAGCACTTAGGGAAGCTGAGGCGAGTAGATCACCTGAGGTCAGGAGTTAGAGACCAGCCTGGCCATCATGGTGAAACCCCGTCTCTACTAAAGATACCAAAAATTAGCTGAGTGTGGTGCTGGGTGCCTGTAATCCCAGAAACTCAGGGTGCCTGTAATCCCAGCAACTCAGGGTGCCTTTAATCCCAGCAACTGAGGGTACCAGTAATCCCAGCAACTCAGGGTGTCTTTAATCCTAGCAACTGAGGGCACCTGTAATCCCAGCAACTCAGGAAGCTGAGACAGGAGAAGTACTTGAACCCAGAAGGCAGAGGTTGCAGTGAGCCGATATTGCACCATTGCACTCCAGTCTGGGCAACAAGAGTGAAACTCTGTCTCAAAAAAAAA"
"chr17","16331846","16332458","JH378118","18053084","18053501","252","1721238","GGCCATGTGTGGTGGTTCACACCTGTAATCTCAGAACTTTGGGAGGCCGAGGTGGGTGGATCACCTGAGGTCAGGAGTTCGAGACCAGCCTGGCCAACATGGTGAAACCTCATCTCTACTAAAAATACAAAAAATTAAGGCCATACCCAGAGACTCATGCCTGTAATCCCAGCACTTTGGGAGGCTGAGGCGGATGGATCACTTGAGGTCAGGAGTTCAAAACCAGCCTGGCCAACATGGTGAAACCCCATCTCTACTAAAAATATAAAAATTAGCCGGGTGTGATGGCAGGCACCTGTAATCCCAGCTACTTGGGAGGCTGAGGCAGGAGAATTGCTTGAACCCAGGAAGCAGAGGTTGTGGTGAGCCGAGGTCGCGCCATTGCACTCCAGCCTGGGCAACAGAATGAGACTGTCTCAAAAAAAAAAAAAAAAAAAAATCAGCCAGGAGTGGTGGCGGGGGCACCTGTAATCCCAGCTACTCGGGAGGCTGAGGCAGGAGAATCGCTTGAACTCAGGAGGCAGAGGTTGCAGTGAGCTGATATCTCGCCATTGCACTCCAGCCTGGGCAACAAGAGTGAAACTGTCTCAAAAAAAAAAAAAAAAAAAAAGAA","GGCTGGGCGCAGTGGCTCACACCTGTAATCCCAGCACTTAGGGAAGCTGAGGCGAGTAGATCACCTGAGGTCAGGAGTTAGAGACCAGCCTGGCCATCATGGTGAAACCCCGTCTCTACTAAAGATACCAAAAATTAGCTGAGTGTGGTGCTGGGTGCCTGTAATCCCAGAAACTCAGGGTGCCTGTAATCCCAGCAACTCAGGGTGCCTTTAATCCCAGCAACTGAGGGTACCAGTAATCCCAGCAACTCAGGGTGTCTTTAATCCTAGCAACTGAGGGCACCTGTAATCCCAGCAACTCAGGAAGCTGAGACAGGAGAAGTACTTGAACCCAGAAGGCAGAGGTTGCAGTGAGCCGATATTGCACCATTGCACTCCAGTCTGGGCAACAAGAGTGAAACTCTGTCTCAAAAAAAAA"
"chr17","16464101","16464461","JH378293","1845184","1845523","61","14618917","GGCCGGGCGCCGTGGCTCACGCCTATAATCCCAGCACTTTGGGAGGCCGAGGCGGGTGGATCACCTGAGGTCAGGAGTTCGAGACCAGCCTGACCAACATGGTGAAACCCCCGTCTCTGCTAAAAAAAAAAAAATATATATATATATATATATAATATATAATATATATATATATATATATATAAAATAGCTGGGCATGGTGGCAGGCACCTGTAATCCCAGCTACTCAGGAGGCTGAGGCAGGAGAATCGCTTGAACCTGGGAGGTGGAGGTTGCAGTGGGCTAAGATCACACCATCGCACTCCAGCCTGGGCGACAGGAATGAAACGCTGTCTCAAAAAAAAAAAAAAAAAAAAAAAAA","GGCCGGGTGCGGTGGCTCACGCCTGTAATCCCAGCACTTTGGGAGGCCAAGGCGGGTGGATCACCTGAGGTCAGAAGTTCGAGACCAGCCTGGCCAACATGGTGAAACCCCGTCTCTGCTAAAAAGAAAAAAATAAGAAAAAAACAAAATAAGAAAATAATTTTAAAAAATACAAAATTAGCTGGGCGTGGTGGCAGGCACCTGTAATTCCAGCTATTCAGGAGGCTGAGGCAGGGGAATCACTTGAACCCAGGAGGCAGAGGTTGCAGTGAGCCAAGATGACGCCATTGCACACCAGCCTGGGCAACAAGAGTGAAACTCCGTCTCAAAAAAAAAACAA"
"chr17","16469420","16470033","JH378118","18053084","18053501","254","1583664","GCCAGGGGTGGTGGCTCATGCCTGTAATCCCAGCACTTTGGGAGGCTGAGGCGGGCAGATTGCCTGAGGTCAGGAATTCAAGACCAGCCTGGCCAACATAGTGAAACCCTGTCTCTACTAAAAATGCAAAGAATTAGCTGGGTGTTGGCCGGGCACGGTGGCTGACACCTGTAATCCCAGCACTTTGGGAGGCCTAGGCAGGCGGATCACCTGAGGTTGGGAGTTCGAGACCAGCCTGACCAACATGGAGAAACCCCGTCTCTACTGAAAATAAAAAACTAGCCAGGCATGGTGGCCCATGCCTGTAATCCCAGCTAATTGGGAGGCTGAGGCAGGAGAATCGCTTGAACCCAGGAGGCAGAGGTTGCGGTGAACCAAGATCGCATCAATGCACTCCAGCCTAGGCGACAAGAGCAAAACTCCGTCTCAAAAAAAAGAATTAGCTGGGTGTGGTGGGTGGGAACCTGTAATCCCAGTTACTAGGGAGGCTGAGGCAGGAGAATTGCTTGAACCCAGGAGGCGGAGGTTGTGGTGAGCCGAGATCGCGCCATTGCACTCCAGCCTGGACAACAAGAGCGAATCTCCGTCTCAAAAAAAAAAAAAAAAAAAAAAAA","GGCTGGGCGCAGTGGCTCACACCTGTAATCCCAGCACTTAGGGAAGCTGAGGCGAGTAGATCACCTGAGGTCAGGAGTTAGAGACCAGCCTGGCCATCATGGTGAAACCCCGTCTCTACTAAAGATACCAAAAATTAGCTGAGTGTGGTGCTGGGTGCCTGTAATCCCAGAAACTCAGGGTGCCTGTAATCCCAGCAACTCAGGGTGCCTTTAATCCCAGCAACTGAGGGTACCAGTAATCCCAGCAACTCAGGGTGTCTTTAATCCTAGCAACTGAGGGCACCTGTAATCCCAGCAACTCAGGAAGCTGAGACAGGAGAAGTACTTGAACCCAGAAGGCAGAGGTTGCAGTGAGCCGATATTGCACCATTGCACTCCAGTCTGGGCAACAAGAGTGAAACTCTGTCTCAAAAAAAAA"
"chr17","17534259","17534875","JH378118","18053084","18053501","268","518825","GGCTGGGGCGGTGGCTCACCTGTAATCCCAGCACTTTGGGAGGCAGAGGTGGGCGGATCGCCTGAGGTCAGAAGTTGGAGACCAGCCTGGCAACATGGTGAAACCCTGTCTCTACTAAAAAAAAAAAAAAAAAAAAAAAATGGCCGGGCATGGTGGCTCAAGCCTGTAATCCTAGCACTTTGGAAGGCTGAGGCGGGTGGATCACAAGGTCAGGAAATCGAGACCATCCTGGCTAACATGGTGAAACTCCGTCTCTACTAAAAATACAAAAAAAATTAGCCGGGCGTGGTGGTGGGTGCCTGTAGTCCCAGCTACTCGGGAGGCTGAGGCAGGCAAATGGAGTGAACCCGGGAGGCAAACTTGCAGTGAGCCAAGATGGCGCCATTGCACTCCAGCCTGGGCAACAAGAGCAAGACTCCTTCTCAAAAAAAAAAAAAATATATATATATATATATAGTCGGGCATGGTGGCAGGCACCTGTAATCCCAGCTACTCAGAGGCTGAGGCAGGAGAATCGCTTGAACCCTGGAGGTGGAGGTTGCAGTGAGCCAAGGTCATGCCATTGCACTCCAGCCTGGGCAACAAGAGCAAGACTCCGTCTCAAAAAAAAAAAAAAA","GGCTGGGCGCAGTGGCTCACACCTGTAATCCCAGCACTTAGGGAAGCTGAGGCGAGTAGATCACCTGAGGTCAGGAGTTAGAGACCAGCCTGGCCATCATGGTGAAACCCCGTCTCTACTAAAGATACCAAAAATTAGCTGAGTGTGGTGCTGGGTGCCTGTAATCCCAGAAACTCAGGGTGCCTGTAATCCCAGCAACTCAGGGTGCCTTTAATCCCAGCAACTGAGGGTACCAGTAATCCCAGCAACTCAGGGTGTCTTTAATCCTAGCAACTGAGGGCACCTGTAATCCCAGCAACTCAGGAAGCTGAGACAGGAGAAGTACTTGAACCCAGAAGGCAGAGGTTGCAGTGAGCCGATATTGCACCATTGCACTCCAGTCTGGGCAACAAGAGTGAAACTCTGTCTCAAAAAAAAA"
"chr17","17916069","17916669","JH378118","18053084","18053501","243","137015","GCCGGGTACAGTGGCTCACACCTGTAATCCTAGCACTTTGGGAGGCCGAGGCGGGTGGATCACCTGAGGTCAGGAGTTCGAGACCAGCCTGGCCAACATGATGAAACCCTACCTCAGCCAGGTACGGTGGTTCACGCCTGTAATCCTAGCACTTTGGGAGGCTGAGGCAGGTGGATTGCCTGAACTCAGGAGTTTGAGACCAGCCTGGGCAGCATGGTGAAACCCCATCTGTACTAAAATACAAAAACTTTGCTGGGCGTGGCGGCATGCACATGTAGTCCCAGTTACTTGGGAGGCTGAGGCAGGATAATTGTTTGAACCTGGGAGGCGGAGGTTGTACAGTGAGCCAAGATCGCGCCACTACACTCTAGCGTAGGTGACAGAGCGAGATTCCGCCTCCAAAAAAAAAAGAAACCCTGTCTCTACTAAAAATACAAACAATTAGCTGGGCGTGGTGGTGGGCGCCTGTAATCCCAGCTACTTAGGAGGCTGAAGCAGGAGAATCGCTTGAGCCCAGGAAGTGGAGGTTGCAGTGAGCTGAGATTGCTCCATTGCACTCTAGCCTGGGCAACAAGAGTGAAACTCTGTCTCAAAAAAAGAA","GGCTGGGCGCAGTGGCTCACACCTGTAATCCCAGCACTTAGGGAAGCTGAGGCGAGTAGATCACCTGAGGTCAGGAGTTAGAGACCAGCCTGGCCATCATGGTGAAACCCCGTCTCTACTAAAGATACCAAAAATTAGCTGAGTGTGGTGCTGGGTGCCTGTAATCCCAGAAACTCAGGGTGCCTGTAATCCCAGCAACTCAGGGTGCCTTTAATCCCAGCAACTGAGGGTACCAGTAATCCCAGCAACTCAGGGTGTCTTTAATCCTAGCAACTGAGGGCACCTGTAATCCCAGCAACTCAGGAAGCTGAGACAGGAGAAGTACTTGAACCCAGAAGGCAGAGGTTGCAGTGAGCCGATATTGCACCATTGCACTCCAGTCTGGGCAACAAGAGTGAAACTCTGTCTCAAAAAAAAA"
"chr17","18237318","18237912","JH378118","18053084","18053501","239","184234","GGCCATGCGTGGTGGCTCACGCCTGTAATCCCAGTACTTTGGGAGGCTGAGGTGGGAGGATCACCTGAGGTCAGGAGTTCGAGACCAGCCTGGCCAACATGATGAAACCCTGTCTCTACTAAAAATGCAAAAAATTGGCCGGGCACGGTGGCTCACGCCTGTAATCCCAGCACTTTGGGAGGCCAAGGCGGGTGGATCACAAGGTCAGGAGCTTGAGACCAGCCTGGCCAATATGGTGAAACCCCATCTCTACTAAAAATACAAAAATTAGCCAGGCGTGGTGGTACACACCTGTAGTCCCAGCTACTCGGGAGGCTGAGGCAGGAGAATTGCTTGAACTCAGGAGGCAGAGGTTGCAGTGAGCTGAGATGGTGCCACTGCACTGCAGCCTGGGCAACAGAGTGAGACTTCATCTCAAAAAAAAAAAAAAAATTAACCGGGTGTGGTGGCACGTGCCTATGGTCCCAGCCACTGGGGAGGCTGAGGCAGGAGAATCGCTTGAACACAGGAGGCAGAAGTTGCAGTGAGCTGAGATTGCACCACTGCACTCCAGCCTGGGTGACAAGAGTGGAACTCCATCTCAAAAAAAAAAGAA","GGCTGGGCGCAGTGGCTCACACCTGTAATCCCAGCACTTAGGGAAGCTGAGGCGAGTAGATCACCTGAGGTCAGGAGTTAGAGACCAGCCTGGCCATCATGGTGAAACCCCGTCTCTACTAAAGATACCAAAAATTAGCTGAGTGTGGTGCTGGGTGCCTGTAATCCCAGAAACTCAGGGTGCCTGTAATCCCAGCAACTCAGGGTGCCTTTAATCCCAGCAACTGAGGGTACCAGTAATCCCAGCAACTCAGGGTGTCTTTAATCCTAGCAACTGAGGGCACCTGTAATCCCAGCAACTCAGGAAGCTGAGACAGGAGAAGTACTTGAACCCAGAAGGCAGAGGTTGCAGTGAGCCGATATTGCACCATTGCACTCCAGTCTGGGCAACAAGAGTGAAACTCTGTCTCAAAAAAAAA"
"chr17","18951167","18952093","JH378118","18053084","18053501","537","898083","GGCCAGGGGCAGTGGCTCATGCCTGTAATCCCAGCATTTTGGGATGCCAAGGCTGGTGGATCAACTGAGGTCAGGAGTTTCAGACCACCCTGGCCAACATGGCGAAATCCCATCTCTACTAAAAATACAAAAATTAGGCCAGGCACAGTGGCTCATGCCTGTAATCCCAGCACTTTGAGAGGCCAAGGCGGGCGATCACGAGGTCAGGAGATTGAGACCATCCTGGCTAACACGGTGAAATCCTGTCTCTACTAAAAAAAAAAAATACAAAAAATTAGCCGGGACGTGGTGGCTGGCACCTGTAGTCCCAGCTACTCGGGAGGCTAAGGCAGGAGAATGGCATGAACCCGGGAGATGGAGCTTGCAGTGACCCGAGATCGCGTCACTGCACTCCAGCCTGAACAACAGAGCAAGACTATATCTCAAAAAAAAAAAAAAAAAAAAGGCCGGGTGCAGTGGCTCACGTCTGTAATCCCAGCACTTTGGGAGGCCGAGGTGGGTGGATCACGAGGTCAGGAGATCGAGACCATCCTGGCTAACATGATGAAACCCCATCTCTACTAAAAAATACAAAAAATTAGCCGGGTGTGGTGGCAGGCACCTGTAGTCCCAGCTACTCGGGAGGCTGAGGCAGGAGAATGGCATGAACCTGGGTAGTGGAACTTGCAGTGAGCCGAGATCACGCCACTGCACTCCAGCCTGGGCGACAGAGCGAGACTCTGTCTCAAAAAAAAAAAAAAAAAAAAAATTAGCCGGGCATGGTGGTGGGTGCCTGCAATCCCAGCTAGTCAGGAGGCTGAGGCTGGAGAATCCCTTGAACCCAGGAGGTAGAGGTTGCAGTGAGCCAAGATCACGCCATTGCATTCCAGCCTGGGCAACAAGAGTGAAATTCTGTCTCAAAAAAATAAACAAACAAGTAAAATAAAA","GGCTGGGCGCAGTGGCTCACACCTGTAATCCCAGCACTTAGGGAAGCTGAGGCGAGTAGATCACCTGAGGTCAGGAGTTAGAGACCAGCCTGGCCATCATGGTGAAACCCCGTCTCTACTAAAGATACCAAAAATTAGCTGAGTGTGGTGCTGGGTGCCTGTAATCCCAGAAACTCAGGGTGCCTGTAATCCCAGCAACTCAGGGTGCCTTTAATCCCAGCAACTGAGGGTACCAGTAATCCCAGCAACTCAGGGTGTCTTTAATCCTAGCAACTGAGGGCACCTGTAATCCCAGCAACTCAGGAAGCTGAGACAGGAGAAGTACTTGAACCCAGAAGGCAGAGGTTGCAGTGAGCCGATATTGCACCATTGCACTCCAGTCTGGGCAACAAGAGTGAAACTCTGTCTCAAAAAAAAA"
"chr17","20996420","20997041","JH378118","18053084","18053501","266","2943336","GGCTAGGCGCGGTGGTTCACACCTGTAATCCCAGCACTTTGGGAGGCCAAGGTGGGTGGATCACCTGTGGTCAGGAGTTCGAGACCAGCCTGGCCAACATTGTGAAACCCCGTCTCTACTAAAAATGCAAAAAATTAGCTGGGCGACCAGTCATGGTAGCTCACGCCTGTAATCCTAGCACTTTGGGAGGCCAAGGCGGGTGGATTGCCTGAGCTCAGGAGTTAGAGGCCAGCCTGGGCAACATGGTAAAACCCTGTCTCTACTAAAATACAAAAAAAAAAAAAAAAATTAGCTGGGTGTGACAGCGTGCATCTGTAATCCCGGTTACTTGGGAGGTTGAGGCAGGAGAATTCCTTGAACCTAGGAGGCGGAGGTTACAGTTAGCCGAGATCACGCCATTGCACTCCAGCCTGGGCAACAGAGCGAGACTCCATCTCAAAAAAAAAAAAAAAAATTCAGCTGGGCGTGGTGGCGGGCACCTGTGATCCTAGCTACTCAGGAGGCTGAGGCAGGAGAATCATTTGAACTCCGGAGGCGGAGGTTGCAGTGACCCTAGATCGCACCATTGTGTTCCAGCCTGAGCAACAAGAGCGAGACGCCATCTGAAAAAAAAAAAAAGAAA","GGCTGGGCGCAGTGGCTCACACCTGTAATCCCAGCACTTAGGGAAGCTGAGGCGAGTAGATCACCTGAGGTCAGGAGTTAGAGACCAGCCTGGCCATCATGGTGAAACCCCGTCTCTACTAAAGATACCAAAAATTAGCTGAGTGTGGTGCTGGGTGCCTGTAATCCCAGAAACTCAGGGTGCCTGTAATCCCAGCAACTCAGGGTGCCTTTAATCCCAGCAACTGAGGGTACCAGTAATCCCAGCAACTCAGGGTGTCTTTAATCCTAGCAACTGAGGGCACCTGTAATCCCAGCAACTCAGGAAGCTGAGACAGGAGAAGTACTTGAACCCAGAAGGCAGAGGTTGCAGTGAGCCGATATTGCACCATTGCACTCCAGTCTGGGCAACAAGAGTGAAACTCTGTCTCAAAAAAAAA"
"chr17","21298865","21299429","JH378206","6546474","6546861","222","14752391","GGCCGAGGCAGGTGGATCACCTGAGGTCAGGAGTTCAAGACTAGTCTGGCCAACATGGTGAAACCCTGTCTCTACTAAAAATACAAAAAATTGGCCGGGCGCGGTGGCTCATGCCTGTAATCCCAGCACTTTGGGAGGCTGAGGCGGGTGGATCACGAGGTCGGGAGATCGAGACCATCCTGGCTAACACAGTTAAACCCTTTCTCTACTAAAAAATACAAAAAATTAGCCGGGCGTAGTGGGGGGCGCCTGTAGTCCCAGCTACTCAGGAGGCTGAGGCAGGAGACTGGCGTGAACCCGGGAGGCAGAGCTTGCAGTGAGCTGAGATCACGTCACTGCATGCCAGCCTGGGCGACAGAGCGAGACTCTGTCTCAAAAAAAAAAAATTAGCCAGGCATGGTGGTGTACACCTGTAATCCTAGCTACTCGGGAAGCTGAGCAGGAGAACAGCTTGAACCCAGGAGGCAGAGGTTGCAGTGAGCTGAGATCACGCCATTGCACTCCAGCCTGGGCAACAAGAGTGAAACTCCGTCTCAAAAAAAAAAAAAGAAAAGAAAAAAGAAAA","GGCCACACATGGTGGCTAACGCCTGTAATCCCAGCACTTTGGGAGGCCAAGTCGGGTGGATCATGAGGTCAGGAGACCAAGACCATCCTGGCCAAATGGTGAAACCCCGTCTCTACTAAAAATACAAAAATTAGCTGGGCATGGTGGCGTGTGCCTGTAATCCCAGCTACTCAGGAGGCTGAGGCAGGACAATTGCCTGAACCCAGGAGAATTAGCTGGGCATGGTGGCGTGTGCCTGTAATCCCAGCTACTCAGGAGGCTGAGGCAGGACAATTGCCTGAACCCAGGAGGCGAAGGTTGCGGTGAGCCGAGATTGTGCCATTGCACTCCAGCCTGGGTAACAAGAGCGACACTCTGTCTCAAAAAAAAAAAAAAAAAAAAAAAAAAA"
"chr17","21663027","21663921","JH378118","18053084","18053501","517","3609943","TTGGGAGGCCAAGGTGGGCCTCCCAGACACGTGAGGTCAGGAGTTTGAGACCAGCCTGGACAATATGGCGAAACCCCATCTCTACTAAAAAAACACAAAAATTGGTTGGGCCGGGCACGGTGGCTCACGCCTGTAATCCCAGCACTTTGGGAGGCCGAAGTGGGCAGATCACGAGGTCAGGAGATCGAGATCATCTTGGCTAACATGGTGAAACTCCGTCTTTACTTAAAATACAAAAAATTAGCTGGGCATGATGGCAGGCAGTTGGAGTCCCAGCTACTTGGGAGGCTGAGGCAGGAGAATCGCTTGAACCCGGGAGGCAGAGGTTGCAGTGAGCTGAGATCGTGCCATTGCACTCCAGCCTGGGTGACAGAATGAGACTCCGTCTGAAAAAAAAACAAAAAACAAAAAACAAAAATTGGCCAGGTGCGGTGGCTCACGCCTGTAATCCCAGAACTTTGGGAGGCCGAGGCAGGTGGATCATGAGGTCAGGAGTTCAAGACCAGCCTGGCCAAGATGGTGAAACCCCATCTCTACTAAAAATACAAAAATTAGGCGGGCACGGTGGCAGGTGCCTGTAATCTCAGCTACTCAGGAGGCTGAGGCAGGAGAATTGCCTGAAGCCGGGTGGCAGAGGTTGCAGAGAGCTAAGATCACGCCACTGCACTCCAGCCTGGGTGATAGAGTAAGACTCTATCTCAAAAAAAGAAAAAAAAAAATAGCCGGGCATTGTGCTGGGCGCCTGTAATCCCAGCTACTTGGGAGGCTGAGACAAGAGAATCACTTGAACCTGGGAGGCGGAGGTTGCAGTGAGCCGAGATCGTGCCATTGCACTCCAGCCTGGGTGAGAAGAGCAAAACTCTGTCTCAAAAAAACAAAAAAAGAAGAAAACAAA","GGCTGGGCGCAGTGGCTCACACCTGTAATCCCAGCACTTAGGGAAGCTGAGGCGAGTAGATCACCTGAGGTCAGGAGTTAGAGACCAGCCTGGCCATCATGGTGAAACCCCGTCTCTACTAAAGATACCAAAAATTAGCTGAGTGTGGTGCTGGGTGCCTGTAATCCCAGAAACTCAGGGTGCCTGTAATCCCAGCAACTCAGGGTGCCTTTAATCCCAGCAACTGAGGGTACCAGTAATCCCAGCAACTCAGGGTGTCTTTAATCCTAGCAACTGAGGGCACCTGTAATCCCAGCAACTCAGGAAGCTGAGACAGGAGAAGTACTTGAACCCAGAAGGCAGAGGTTGCAGTGAGCCGATATTGCACCATTGCACTCCAGTCTGGGCAACAAGAGTGAAACTCTGTCTCAAAAAAAAA"
"chr17","21688652","21689276","JH378118","18053084","18053501","258","3635568","GGCCGGGTGCCATGGCTCACGCCTATAATCCCAGCACTTTGGGAGGCCAAGGTGGGCGGATCACCTGAGGTCAGGAGTTTGAGACCAGCCTGGCCAACATAGTGAAACCCCGTCTCTACTAAAAATACGAAAAGTTAGCTGGGGGTGCAGTGGCTCACACCTGTAATTCCAGCACTTTGGGAGGCCGAGGCAGGTGAATCACGAGGGGAGGAGTTTGAGACCAGCCTAACCAATATGTTGAAACCCCGTTTCTACTAAAAATACAAAAATTAGCTGGGCGTGGTGGCACGTGCCTATAATCCCAGCTACTCAGGAGGCTGAGGCAGGAGAATCGCCTGAACCTGGGAGGCGGAGGTGGCAGTGAGCCAAGATCACACCACTGCACTTTAGCCTGGGTGACAGAGGGAGACTCTGTCTCAAAAAACAAAACAAAACAAAACAAAAAATTAGGCAGGCTTGGTGGCACATGCCTGTAATCCCAGCTACTCAGGAGGCTGAGGCAGGAGAATTGCTTGAACCCAGGAGGCAGAAGTTGCAGTGAGCTGAGATCGCGCCATTGCACTCCAGCCTGGGTAACAAGAGTGAAACTCCATCTCAAAAAAAAAAAAAAAAAAAAAAAAAAAAA","GGCTGGGCGCAGTGGCTCACACCTGTAATCCCAGCACTTAGGGAAGCTGAGGCGAGTAGATCACCTGAGGTCAGGAGTTAGAGACCAGCCTGGCCATCATGGTGAAACCCCGTCTCTACTAAAGATACCAAAAATTAGCTGAGTGTGGTGCTGGGTGCCTGTAATCCCAGAAACTCAGGGTGCCTGTAATCCCAGCAACTCAGGGTGCCTTTAATCCCAGCAACTGAGGGTACCAGTAATCCCAGCAACTCAGGGTGTCTTTAATCCTAGCAACTGAGGGCACCTGTAATCCCAGCAACTCAGGAAGCTGAGACAGGAGAAGTACTTGAACCCAGAAGGCAGAGGTTGCAGTGAGCCGATATTGCACCATTGCACTCCAGTCTGGGCAACAAGAGTGAAACTCTGTCTCAAAAAAAAA"
"chr17","22129020","22129352","JH378128","1602813","1603145","53","20526207","GCCAGGCACGGTGGCTCACACCTGAATTCCAGTACTTTGGGAGGCCGAGGCGGGCGGATCTCTTGAGGTCAGGAGTTTGAGACCAGCCTGGCCAACATGGTGAAACCCCATCTCTACTAAAAATACAAAAATTAGCCGGGCGTGGTGGCAGGTGCCTGTAATCCCAGCTACTTGGGAGGCTGAGGCAGGAGAACCTCTTGAACCCAGGAGGTGGAGGCTGCAGTGAGCTGAGATTGTGCCACTTCACTCCAGCCTGGAAGACAAGAGCAAGACTTCATCTCAAAAAAAAATAAAAAAAAAATAAATAAATAAATAAATAAAAATTTAAAAAAA","GGCCAGGTGCAGTGGCTCACGCCTGTAATACCAGCATTTTGGGAGGCCGAGGCAGGTGGATCACGAGGTTAGGAGTTTGAGACCAGCATGGCCAACATGGAGAAACCCCGTCTCTACTAAAAATACAAAAATTAACCAGGCATGGTGGCAGGTGCCTGTAATTCCATCTACTCGGGAGGCTGAGGCAGGAGAATCCCTTGAACCTGGGAGGCGGAGGTTGCAGTGAGCCGAGATTGTGCCATTGCACTCAGTCTGGGTGACAAAAACAAGACTCCATCTCAAAAAAAAAAAAAAGAAAAGAAAAAGAAAAAAAGAAAGAAAGAAAGAAAGAAA"
"chr17","22130129","22130738","JH378118","18053084","18053501","262","4077045","GGCTGGGCACAGTGGCTCACGCCTGTAATCTCAGCACTTCGGGAAGCCGAGGCGGGCAGATCAGCTGAGGTCAGGAGTTCAAGACCAGCCTGGCCATGGCAAAACCCTGTCTCTACTAAAAAATGCAAAAAATAGGGGCCAGGCACGGTGGCTCACGCCTGTAATCCCAGCATTTTGGGAGGCCAAGGCAGGCGGATCACAAGGTCAGGAGGTTGAGACCATCCTGGCCAACATGGTGAAACCCCATCTCTACTAAAAATACAAAAATTAGCTGGGTGTGGTGGCCTGTGCCTGTAATCCCAGCTACTTGGGAGGCTGAGGCAGGGGAATCACTTGAATCCAGGAGACAGAGGTTGTAGTGAGCTGAAATGGAGCCACTGCACTCCAGCCTGGCGGCAGAGCGAGACTCTGTCTCAAAAAAAAAAAAAATACAAAAAATAGCTAGGTGTGATGGTGGGCACCTGTAATCCCAGCTACTTGGGTAGCCGAAGCAGGAGAATCGCTAGAACCTGGGAGGTGGAGGTTTAGTAAGCTGAGATCACACCATTGCACTCCAGCCTGGGTATCAACAGCGAAACTCCATCTCAAAAAAAAAAAAAAAAAAAGAAAA","GGCTGGGCGCAGTGGCTCACACCTGTAATCCCAGCACTTAGGGAAGCTGAGGCGAGTAGATCACCTGAGGTCAGGAGTTAGAGACCAGCCTGGCCATCATGGTGAAACCCCGTCTCTACTAAAGATACCAAAAATTAGCTGAGTGTGGTGCTGGGTGCCTGTAATCCCAGAAACTCAGGGTGCCTGTAATCCCAGCAACTCAGGGTGCCTTTAATCCCAGCAACTGAGGGTACCAGTAATCCCAGCAACTCAGGGTGTCTTTAATCCTAGCAACTGAGGGCACCTGTAATCCCAGCAACTCAGGAAGCTGAGACAGGAGAAGTACTTGAACCCAGAAGGCAGAGGTTGCAGTGAGCCGATATTGCACCATTGCACTCCAGTCTGGGCAACAAGAGTGAAACTCTGTCTCAAAAAAAAA"
"chr17","23633062","23633662","JH378118","18053084","18053501","247","5579978","GGCCAGGCGTGGTGGCTTACGCCTGTAATCCCAGCATTTTGGGAAGCTGAGGCAGGTGGATCACCTGAGGTCAAGAGTTCAAGACCAGCCTGGCCAACATGGTGAAACCCCGTCTCTACTGCAAATACAAAAAATTAGTAGCCGGGCATGGTGGCTCACGCCTGTAATCCCAACACTTTGGTAGGCCAAGGCGGGTGGATCACCTGAGGTCGGGAGTTCGAGACCAGCCTGACCAACATGGAGAAACCCCGTCTCTACTAAAAGTACAAAATTAGCCAGGGATGGTGGCATGTGCCTGTAATCCCAGCTATTTGGGAAGCTAAGGCACAAGAATCGCTTTGAACCTGGGAGACAGAGGTTGCAGTGAGCTGAGATCGCACCATTGCACTCCCGCCTGGGCAACAAGAGCGAAACTCCATCTAAAAAAAAAAAAAAAAAAAAAAAAGCCAGGCATGGTGACAGGCACCTTGTAATCCCAGCTACTCGGAAGGCTGAGGCAGGAGAATCGCTTGAACACTGCAGAGGTTGCAGTGAGCTGAGATCACGCCATTGCACTGCAGCCTAGGCAACAAGAGTGAGACTCTATCTCAAAAAAAAGAAA","GGCTGGGCGCAGTGGCTCACACCTGTAATCCCAGCACTTAGGGAAGCTGAGGCGAGTAGATCACCTGAGGTCAGGAGTTAGAGACCAGCCTGGCCATCATGGTGAAACCCCGTCTCTACTAAAGATACCAAAAATTAGCTGAGTGTGGTGCTGGGTGCCTGTAATCCCAGAAACTCAGGGTGCCTGTAATCCCAGCAACTCAGGGTGCCTTTAATCCCAGCAACTGAGGGTACCAGTAATCCCAGCAACTCAGGGTGTCTTTAATCCTAGCAACTGAGGGCACCTGTAATCCCAGCAACTCAGGAAGCTGAGACAGGAGAAGTACTTGAACCCAGAAGGCAGAGGTTGCAGTGAGCCGATATTGCACCATTGCACTCCAGTCTGGGCAACAAGAGTGAAACTCTGTCTCAAAAAAAAA"
"chr17","34071612","34072215","JH378118","18053084","18053501","250","16018528","GGCCAGGTGTGGTGCCTTACATCTGTAATTCCAGCACTTTGGGAGGCTGAGGTGGGTGGATCACCTGAGGTCAGGAGTTCAGGACCAACCTGGCCAACATAGTGAAACCCCGTCTCACTAAAAATACAAAAATTAAAAAGAAAGAAAGAAAAAAGCCAGGTGCGGTGGCTCACACCTGTAACCCCAGCACTTTGGGAGGCCAAGATGGGCGGATCACCTGAGGTCGGGAGTTTGAGACCAGCCTGACCAACATGGAGAAACCCCGTCTCTACTAAAAATACAAAATTAACCAGGCGTGGTGGTGCATGCCTGTAATCCCAGCTACTTGGGAGGATGAGGCAGGAGAATCGCTTGAACCCTGGAGGCGGAGGTTGTGGTGAGCTGAGATCATGCCATTGCACTCCAGCCTAGGCAACAAGAGCGAGACTCCATCTCAAAAAAAAAAAAAAAATTGGGCATGGTGGTGCATGCCTGTAATCCCAGCTACTCAGGAGTCTAAGGCAGGAGAATCACTTGAACCCAGGAGGCAGAGGTTGCAGTGAGCTGAGATCACGCCATTGCACTCCAGCCTGAGCGACAAGAGTGAAACTACGTCTCAAAAAAA","GGCTGGGCGCAGTGGCTCACACCTGTAATCCCAGCACTTAGGGAAGCTGAGGCGAGTAGATCACCTGAGGTCAGGAGTTAGAGACCAGCCTGGCCATCATGGTGAAACCCCGTCTCTACTAAAGATACCAAAAATTAGCTGAGTGTGGTGCTGGGTGCCTGTAATCCCAGAAACTCAGGGTGCCTGTAATCCCAGCAACTCAGGGTGCCTTTAATCCCAGCAACTGAGGGTACCAGTAATCCCAGCAACTCAGGGTGTCTTTAATCCTAGCAACTGAGGGCACCTGTAATCCCAGCAACTCAGGAAGCTGAGACAGGAGAAGTACTTGAACCCAGAAGGCAGAGGTTGCAGTGAGCCGATATTGCACCATTGCACTCCAGTCTGGGCAACAAGAGTGAAACTCTGTCTCAAAAAAAAA"
"chr17","34329459","34330029","JH378119","32351107","32351490","237","1978352","GGCCAGGTGCCGTGGCTCACACATGTAGTCCCAGCACGTTGGGAGGCTGAGGTTAATGGATCACCTGAAGTCACAAGTTCGAGACCAGCCTGACCAACATGGTGAAACCCTGTCTCTACTAAAATATAAAAAGTAGTCGGCCGGGCGCAGTTGCTCATGCCTGTGATCGCCTGAGGTCAGGATTTCAAGCCCAGCCTGGCCAAAATGGTGAAACCCCATCTCTACTAAAAATATAAAAATTAGCCAGGCATGGTGGCAGGTGCCTGTAATCCCAGCTACTCAGGAGGTTGAGGCAGGAGAATCACTTGGACCCAGGGGGCAGAGGTTGCAGTGAGCCAAGATCACAGCATCGCACTCCAGCTTAGGCAACAAGAGAGAAACTCCATCTCAAAAAAAACCCAAAAAAAACAAAAAAACAAAAAAACCCAGGCATGGTGGCAGGCGTCTGTAATCTCAGCTACTCGGGAGGCTGAGGCAAGAGAATCGCTTGAACCTGGGAGGCAGAGGTTGCAGTGAGCCAAGATCATGCCATTGCACTCCAGACTGAGCAATAAGAGCGAAACTCCATCTC","GGCCAGGTATGGTGGCTCACACCTGTAATCCCAGCACTTTGGGAGGCCAAGGCAGGCAGACCACCTGAGGTCAGGAGTTCGAGATCAGCCTAGCCAACATGGTGAAACCCCATCTCTAGTAAAAATAAAATTAGCCAGGCATGGTGGTGCATGCCTGTAACGCAGGTCAGGAGTTCGAGATCAGCTTAGCCAACATGGTGAAACCCCATCTCTAGTAAAAATAAAATTAGCCAGGCAGGTGGTGCCGCCTGTACTCGGGAGGCTGAGGCAGGAGAATCACTTGAACCCAAGAGGCAGAGGTTGCAGTCAGCCAAGATCATGCCATTGCACTCCAGCCTAAGCAAAAAGAGTAAAACTCAGTCTCAAAACAAAAAAACAAAAAAA"
"chr17","35196292","35196625","JH378228","5665092","5665424","47","29531200","GGCTGGGCATGGTGTCTTACGCCTGGAATCCCAGCACTTTGGGAGGCCAAGGCGGGTGGATCACCTGAGGTCAGGAGTTTGAGACCAGCCTGGCCAACATGTTGAAACTCTGTCTCTACTAAAAATACAAAAATTAGCCGGGCATGGTGGCGGATGCCTGTAATCCCAACTACGTGGGAGGCTGAGGCAGGAGAATCGCTTGAACCCAGGAGATGGAGGTTGTGGTGAGCCGAGATCATGCCATTGCACTCCAGCCTGGGCAACAAGAACAAAACTCTGTCTCAAAATAAATAAAAAAATAAATAAATAAATAAAAACAACAACAACAACAAAA","GGCCGGGCGCGGTGGCTCAAGCCTGTAATCCCAGCACTTTGGGAGGCTGAGGCGGGTGGATCACGAGGTCAAGAGATCGAGACCATCCTGGTCAACATGGTGAAACCCTGTCTCTACTAAAAATACTAAAAATTAGCTGGGCATGGTGGCGTGTGCCTGTAATCCCAGCTACTCAGGAGGCTGAGGCAGGAGAATTGCCTGAACCCAGGAGGCGGAGGTTGCGGTGAGCCGAGATCGCGCCATTGCACTCCAGCCTGGGCAACAAGAGCGAAACTCTGTCTCAAAAAAAAAAAATAAATAAATAAAATAAAATAAAATAAAATAAAATAAAAT"
"chr17","40291413","40291755","JH378144","13229286","13229620","52","27062127","GGCCAGGCACAGTGGCTCATGCCTGTAATCCCAGCACTTTGCGAGGCTGAGCCAGGTGGATCACCTGAGGTCAGGAGTTCAAGAGCAGCCTGGCCAACATGGTGAAACCCCGTCTCTACTAAAAATACAAAAATTATCTGGAGTGGTGGTAGGTGCCTATAATTGCAGATACACAGAAGGCTGAGACAGGAGAATTGCTTGAACCCAGGAGGCGGAGGTTGCTGTGAGCCGAGATCGCGCCATTGCACCCCAGCCTGGGAGACAAGAGCGAAACTCCATCTCAATAAATAAATACATACATACATACATACATACATGCATACATACATAAAATAAAATAAAA","GGCCGGGCGCGGTGGCTCAAGCCTGTAATCCCAGCACTTTGGGAGGCCGAGGCGGGTGGATCACCTGTGGTCAGGAGTTCAAGACAGCTTGGTCAACATGGTGAAACCCCGTCTCTACCAAAAATACAAAAAATTAGCTGGGCATGGTAGCGCATGCCTGTAATCCCAGCTACTCAGGAGGCTGAGGCAGGAGAATTGCCTGAACCCAGGAGGCAGAGGTTGCGGTGAGCCGAGATCGCGCCATTGCACTCCAGCCTGGGTAACAAGAGCGAAACTCCCTCTCATAAAAAATAAATAAATAAATAAATAAATAAATAAATAAATAAATAAATAAA"
"chr17","45148344","45148987","JH378206","6546474","6546861","299","38601870","GGCTTGGTGCCATGGTTCATGCCTGTAATCCTGGCACTTTGGGAGGCCGAGGTGGGCAGATCACTTGAGCTCAGGAGTTCAAGACCACCTTGGGCGACATGGTGAAACCTCATCTCTCCTTAAAAAAAAAAAAAACAGCCGGGCGCGGTGGCTCACACCTGTAATCCCAGCACTTTGGGAGGCCAAGGCGGGTGGGGTTCATGAGGTCAGAAGATCGAGACCATCCTGGCTAACACGGTGAAACCCCGTCTCACTAAAAATAGAAAAAACTAGCCGGGCGTGGTGGCGGGCACCTGTAGTCCCAGCTACTCGGGAGGCTGAGGCAGGAGAATGGCGTGAACCCGGGAGGCGGAGCTTGCAGTGAGCTGAGATCTTGCCATTGCACTCCAGCCTGGGCAACAAGAGTGAAACTCTGTCTCAAAAAAAAAAAATTAAAAAAACAAATAAAAATAAAAATACATAATTAGCAGGACATGGTGGCACATGCCTGTAATCCCCAGCTACTCGGGAGGCTGAGGCATGGGAATTGTTTAAACCTGTGAGGCGGTGGTTGCAGTGAGCCAAGATCAAGCCATTGCACTCCAGCCTGGGCAACAAGAGTGAAACTCCATCTCAAAAAAAAAAAAAAAAAAGAGAAAAGAAAA","GGCCACACATGGTGGCTAACGCCTGTAATCCCAGCACTTTGGGAGGCCAAGTCGGGTGGATCATGAGGTCAGGAGACCAAGACCATCCTGGCCAAATGGTGAAACCCCGTCTCTACTAAAAATACAAAAATTAGCTGGGCATGGTGGCGTGTGCCTGTAATCCCAGCTACTCAGGAGGCTGAGGCAGGACAATTGCCTGAACCCAGGAGAATTAGCTGGGCATGGTGGCGTGTGCCTGTAATCCCAGCTACTCAGGAGGCTGAGGCAGGACAATTGCCTGAACCCAGGAGGCGAAGGTTGCGGTGAGCCGAGATTGTGCCATTGCACTCCAGCCTGGGTAACAAGAGCGACACTCTGTCTCAAAAAAAAAAAAAAAAAAAAAAAAAAA"
"chr17","47866693","47867898","JH378118","18053084","18053501","809","29813609","GGCTGGGCTTGGTGGCTCATGCCTATAATTCTAGGACTTTGGGAGGCCAAGGCGGATGGATCACCTGAGGTCAAGAGTTGGAGACCAACCTGTCCAACATGGTGAAACCCCCTCTGTACTAAAAATACAAAAATTGGCCGAGCGTAGTGGCTCATGCCTGTGATCACAGCACTTTGAGAGGCTGAGGCGGGCGGATCACAAGGTCAGGAGATCAAAACCATCCTGGCTAACAAGGTGAAACCCCATCTCTGCTAAAAAATAACAGGGCGTGGTGGCACACGGCTGTAGTCCCAGCTACTTGGGAAGCTGAGGCAGGAGAATCGCTTGAACCTGAGAGGCAGAGGTTGCAGTGAGCTGAGATCAGGCCACTGCTCTCCAGCCTGGGCAACAGAGTGAAACTCCATCTCAAAAAAAAAAAGAAAAAGGCCAGGCATGGTGGCTCACGCCTGTAATGCCAGCACTTTGGAAGACTAAGTTGGGCAGATCACAACATCAGAAGATGGAGACCATCCTGGCTAACACGGTGAAACCCCGTCTCTACTAAAAATACAAAAAAAAAAAAAAAAAAAATTAGCCGGGCGTGGTGACATGCGCCTGTAATCCTAGCTACTCCGGAGGCTGAGGCAGGAGAATGGCGTGAACCCGGGAGGCGGAGCTTGCAGTGAGCCGAGATGGTGCCACTGCACTCCAACCTGGGCGACAGAGCGAGACTCTGTCTCAAAAAAAAAAAAAAAAAAGAAAAAAGGTCGGGCGCAGTGGCTCACACCAGTAATCACAGCACTTTGGGAGGCCGAGGCGGGTGGATCACCTGAGCTCGGGAGTTCAAGACCAGCCTGACCAACATGGTGAAACTCCGTCTCTACTAAAAATACAAAATATTAGCCGGGCGTGGTGGCGCGTGCCTGTAATCCCAGTTACACGGGAGGCTGAGGCAGGAGAATCACTTGAACTTGGGAAGTGGAGGTTGTGGGAGCCGAAATCGTGCCATCGCATTCCACAAGAGTGAAACTCCATTTCAAAAAAAAAAAATACAAAAATTAGCTGGGCGTGGTGGCGGGCGCCTTTAATCCCAGGGGCTCGGGAGGCTGAGGCAGGAGAATCGCTTGAACCTAGGAGGCAGAGGTTGCAGTGTGCCAAGATGACACCATTGCACTCCAGGCTGGGCAAGAGAGCAGTAACTCCCGTCTCAAAAAAAAAGAAGGAAAA","GGCTGGGCGCAGTGGCTCACACCTGTAATCCCAGCACTTAGGGAAGCTGAGGCGAGTAGATCACCTGAGGTCAGGAGTTAGAGACCAGCCTGGCCATCATGGTGAAACCCCGTCTCTACTAAAGATACCAAAAATTAGCTGAGTGTGGTGCTGGGTGCCTGTAATCCCAGAAACTCAGGGTGCCTGTAATCCCAGCAACTCAGGGTGCCTTTAATCCCAGCAACTGAGGGTACCAGTAATCCCAGCAACTCAGGGTGTCTTTAATCCTAGCAACTGAGGGCACCTGTAATCCCAGCAACTCAGGAAGCTGAGACAGGAGAAGTACTTGAACCCAGAAGGCAGAGGTTGCAGTGAGCCGATATTGCACCATTGCACTCCAGTCTGGGCAACAAGAGTGAAACTCTGTCTCAAAAAAAAA"
"chr17","48059944","48060302","JH378108","45564157","45564495","64","2495787","GGCCGGGCGCAGTGGTTCATGCCTGTAATCCCAACACTTTAGGGGGCTGAGGCAGGTGGATCACCTGAGGTCAGGAGTTCAAGACCAGCCTGGCCAACATGGTGAAAGCCCATCTCTACTAAAAATACAAAAAATTAGCTGGGCATGGTGGTGCGTGCCTGTAATCCCAGCTACTTGGGATGCTGAGGCAGGAGAATCGCTTGAACCCGGGAGGTGGAGGCTGCAGTGAGCTGAGATTGTGCCATTGCACTCCAGCCTGGGCAACAAGAGTGAAACTCCATCTAAAAAAAAAAAAGAAGAGGAGGAGGAGGAGGAGGGGGAGGGGGAGGAGGAGGAGGAGGAGAAGAAGAAAAAAGAAA","GCTAGGCAAGGTGGCTCATGCCTGTAATCCCAACATTTTGGGAGGCCGAGGCAGATGGATCACCTGAGGTTAGGAGTTCAAGACCAGCCTGGCCAACATGGTGAAACTCCATCTCTACTAAAAATACAAAAAATTAGCTTGGCACGGTGGTGGGTGCCTCTAATCCCAGCTGCTTGGGAGGCTGAGGCAGGAGAATCGCTTGAACTCAGGAGGTGGAGGTTGCAGTGAGCCAAGATCATGGCATTGCACTCCAGCCTGGGCGACAAGAGCGAGACTCCCTCTAAGAAAGAAAAGAAAGAAAAGAAAAGAAAAAAGGAAAGGAAAGGAAAGAAAGAGAAA"
"chr17","50365982","50366602","JH378118","18053084","18053501","274","32312898","GGCAAGGCGTGGTGGCTGATGTCTGTAATCCCAGCAATTTGGGGGGCTGAGGTGGATGGATCACCTGAGATCAGAAGTTCGAGACTAGGCTAGCCAACATAGTGAAACCCCATCTCTACTAAAAATATAAAAAGTTAGCCAGGCGCGGTGGTTCATGCCTGTAATCCCAGCACTTTGGGAGGCCGAGGTAGGTGGATCACAAGGTCAGGAGTTCAAGACCAACCTGGCCAAGATAGTGAAACCTCATCTCTACTAAAAATACAAAAATTAGCTGGGCGTGGTGGCAACCACCTATGATCCCAGCTACTTGGGAGGCTGAGGCAGAGAACTGCTTGAACCCAGGAAGTGGAGGTTGTAGTGAGCCAAGATTGCATCACTGTACTCCAGCCTGGGCAACAGAGCAAGACTCCATCTCAAAAAAAAAAAAAAAAAAAATACAAAAAATTAGCCAGGCGTGGTGGCAGGCACCTGTAATCCCAGCTACTCGGAAGGCTGAGGCAGGAGAATTGCTTGAACCTGGGAGGTAGAGGTTGCAGTGAGCTGAGATTGTGCCATTGCACTCTAGCCTATGTGACAAGAGCGAAACTCCATCTCAAAAAAAAAAAAAAAAAAGAAAGAAAA","GGCTGGGCGCAGTGGCTCACACCTGTAATCCCAGCACTTAGGGAAGCTGAGGCGAGTAGATCACCTGAGGTCAGGAGTTAGAGACCAGCCTGGCCATCATGGTGAAACCCCGTCTCTACTAAAGATACCAAAAATTAGCTGAGTGTGGTGCTGGGTGCCTGTAATCCCAGAAACTCAGGGTGCCTGTAATCCCAGCAACTCAGGGTGCCTTTAATCCCAGCAACTGAGGGTACCAGTAATCCCAGCAACTCAGGGTGTCTTTAATCCTAGCAACTGAGGGCACCTGTAATCCCAGCAACTCAGGAAGCTGAGACAGGAGAAGTACTTGAACCCAGAAGGCAGAGGTTGCAGTGAGCCGATATTGCACCATTGCACTCCAGTCTGGGCAACAAGAGTGAAACTCTGTCTCAAAAAAAAA"
"chr17","50542261","50542886","JH378206","6546474","6546861","277","43995787","GCCGGGCGCTGTGGCTCAAGCCTGTAATCCCAGCATTTTGGGAGACTAAGGGAAGCAGATCCTGTGAGCTCAGGATTTCGAGACCAGCCTGGCCAACATGGTGAAACCCTGTCTCTACAAAAATTAGCCATGCCGGGCACGGTGGCTCACGCCTGTAATCCCAGCACTTTGGGAGGCTGAGGCGGGCGGATCACAAGGTCAGGAGTTTGAGACCATCCTGCCTAACACGGTGCAACCCCGTCTCTACCAAAAATACAAAAAATTAGCTGGGCGTGGTGGCGGGTGCCTGTAGTCCCAGCTACTCGGGGGGCTGAGGCAAGAGAATGGCATGAACCTGTGGGGCGGAGCTTGCTGTGAGCCGATATCCTGCCACTGCACTCCAGCCTGGGCGACAGAGCGAGACTCCATCTCAAAAAAAAAAAAAAAAAAAAAAAAAAAAAAAAATGAGCCAGCTGTGGTGGCGTGTGTGCCTGTAATCCCAGCTACTCGGGAGGCTGAGGCAAGAGAATCACTTGAATCTGGGAGGCAGAGGTTGCAGTGAGCCAAGATCATGCTATTGCACTTCAGCCTGGGCAACAAGAGTGAAACTCTGTCTCAAAAAAAAAAAAAAAAAAAAAGAAAAAGAA","GGCCACACATGGTGGCTAACGCCTGTAATCCCAGCACTTTGGGAGGCCAAGTCGGGTGGATCATGAGGTCAGGAGACCAAGACCATCCTGGCCAAATGGTGAAACCCCGTCTCTACTAAAAATACAAAAATTAGCTGGGCATGGTGGCGTGTGCCTGTAATCCCAGCTACTCAGGAGGCTGAGGCAGGACAATTGCCTGAACCCAGGAGAATTAGCTGGGCATGGTGGCGTGTGCCTGTAATCCCAGCTACTCAGGAGGCTGAGGCAGGACAATTGCCTGAACCCAGGAGGCGAAGGTTGCGGTGAGCCGAGATTGTGCCATTGCACTCCAGCCTGGGTAACAAGAGCGACACTCTGTCTCAAAAAAAAAAAAAAAAAAAAAAAAAAA"
"chr17","51121894","51122508","JH378118","18053084","18053501","260","33068810","GGCTGGGTGCAGTGGCTCATGCCTGTATTCCCAACACTTTGAGAGGCCAAGGCGGGCAGATCACCTGAGGTCAGGAATTCGAGACCAGCCTGGCTAACATGGCGAAACCCTGTCTCTATTAAAAACACAAAAATTAGGCCAGGCACGGTGGCTCACACCTGTAATCCCAGCACTTTGGGAGGCTGAGGCGGGCAGATCACGAAGTCAGGAGATCGAGACCATCCTGGCTAACATGGTGAAACCCTGTCTCTGCTAAAAATACAAAAAAAATAGCGGGGCGTGGTGGCAGGCGCCTGTAGTCCCAGCTACTCAGGAGGCTGAGGCAGGAGAATGGCGTGAACCTGGGAGGCGGAGGTTGCAGTGAGCCGAGATCGCGCCACTGCACTACAGCTTGGGTGACAGAGCGAGACTCTGTCTCAAAAAAAAAAAAAAAAGTTAGTCGGGCATGGTGGTGGGCTCCTGTATTCCCAGCTACTCAGGAGGCTGAGGTGGGAGAATCACTTGAACCTGGAAGGCAGAGGTTGCTGTGAGCCAAGATTGCACCATTGCATTCCAGCCTGGGTGACAAGAGCAAAACTCTGTCTCAAAAAATATATATAAAATAATAAAAATAAA","GGCTGGGCGCAGTGGCTCACACCTGTAATCCCAGCACTTAGGGAAGCTGAGGCGAGTAGATCACCTGAGGTCAGGAGTTAGAGACCAGCCTGGCCATCATGGTGAAACCCCGTCTCTACTAAAGATACCAAAAATTAGCTGAGTGTGGTGCTGGGTGCCTGTAATCCCAGAAACTCAGGGTGCCTGTAATCCCAGCAACTCAGGGTGCCTTTAATCCCAGCAACTGAGGGTACCAGTAATCCCAGCAACTCAGGGTGTCTTTAATCCTAGCAACTGAGGGCACCTGTAATCCCAGCAACTCAGGAAGCTGAGACAGGAGAAGTACTTGAACCCAGAAGGCAGAGGTTGCAGTGAGCCGATATTGCACCATTGCACTCCAGTCTGGGCAACAAGAGTGAAACTCTGTCTCAAAAAAAAA"
"chr17","51573403","51574012","JH378118","18053084","18053501","260","33520319","GGCCGGGTGTGGTGGCTCACGCCTATTATCCCAGCAGTTTGGGAGGCCAAGTGGGGGTTGGATCACCTGAGGTCAGGGGTTCGAGACCAGCATGGCCAACATGGTGAAAACCCATCTATACTAAAGATACAAAAAATTAGGCTGGGCACAGTGGCTCATGCCTGTAATCCCAGCACTTTGGGAGGCCAAGGATCACGAGGTCAGGAGATCGAGACCATCCTGGCTAACACAGTGAAACCCCGTCTCTACTAAAAATACAAAAAAATTAGCCGGGAGTGGTGGCAAGTGCCTGTAGTCCCAGCTACTCAGGAGGCTGAGGCAGGTGAATAGTGTGAACGCAGGAGGCAGAGCTTGCAGTGAGCCGAGATCGTGCCACTACACTCCAGCCTGGGCGACAAGGTGAGACAACGTCTCAAAAAAAAAAAAAAAAAAAAGCCGGGCATGGTGGGAGGCACCTGTAATTCCACCTACTTGGGAGGGTGAGGCAGGAGAATTGCTTGAATCTGGGAGATGGAGGTTGGAGTAAGCCAAGTTCGCACCATTGCACTCCAGCCTGGGTGACAAGAGCGAAACTCTTGTCTCAAAAAAAAAAAAAAAAAAAAAAAAAAAA","GGCTGGGCGCAGTGGCTCACACCTGTAATCCCAGCACTTAGGGAAGCTGAGGCGAGTAGATCACCTGAGGTCAGGAGTTAGAGACCAGCCTGGCCATCATGGTGAAACCCCGTCTCTACTAAAGATACCAAAAATTAGCTGAGTGTGGTGCTGGGTGCCTGTAATCCCAGAAACTCAGGGTGCCTGTAATCCCAGCAACTCAGGGTGCCTTTAATCCCAGCAACTGAGGGTACCAGTAATCCCAGCAACTCAGGGTGTCTTTAATCCTAGCAACTGAGGGCACCTGTAATCCCAGCAACTCAGGAAGCTGAGACAGGAGAAGTACTTGAACCCAGAAGGCAGAGGTTGCAGTGAGCCGATATTGCACCATTGCACTCCAGTCTGGGCAACAAGAGTGAAACTCTGTCTCAAAAAAAAA"
"chr17","51598763","51599361","JH378118","18053084","18053501","241","33545679","GCCGGGCGTGGTGACTCACGCCTGTAATACCAGCACTTTAGGAGGCTGAGGTGGGTGGATCACCTGAGGTCAGGAGTTCGAGACCGGCCTGGCCAACATGGTGAAATCCTGTCTCTACTAAAAATACAAAAAAATGGCCAGGCGTGGTGGCTCACGCCTGTAATCCTAGCACTTTGGGCGGCCCAGGTGAGTGGATCACGAGGTCAGGAGATCGAGACCATCCTGGCTAACATGGTGAAACCCCATCTCTACTAAAAAACTACAAAAAAATTAGCTGGGCGTGGTGGCAGGCGCCTGTAGTCCCAGCTACTCGGGAGGCTGAGGCAGGAGAATGACGTGAACCCGGGAGGCGGAGCTTGCAGTGAGCAGAGCTTGAGCCACTGCACTCCAGCTTGGGCGACAGAGTGAGACTCCGTCTCAAAAAAAAAAAAAAAAAAATTAGCTGGGGATGGTGGCGGGCACCTGTAATCCCAGCTACTCTGGAGGCTGAGACAGGAGAATCGCTTGAACCCAGGAGGCGGAGGTTGCAGTGAGCTGAGATCGTGCCATTGTACTCCAGCCTGGGCAACAAGAGTGAAACTCAATCCGAAGAAAAAAAA","GGCTGGGCGCAGTGGCTCACACCTGTAATCCCAGCACTTAGGGAAGCTGAGGCGAGTAGATCACCTGAGGTCAGGAGTTAGAGACCAGCCTGGCCATCATGGTGAAACCCCGTCTCTACTAAAGATACCAAAAATTAGCTGAGTGTGGTGCTGGGTGCCTGTAATCCCAGAAACTCAGGGTGCCTGTAATCCCAGCAACTCAGGGTGCCTTTAATCCCAGCAACTGAGGGTACCAGTAATCCCAGCAACTCAGGGTGTCTTTAATCCTAGCAACTGAGGGCACCTGTAATCCCAGCAACTCAGGAAGCTGAGACAGGAGAAGTACTTGAACCCAGAAGGCAGAGGTTGCAGTGAGCCGATATTGCACCATTGCACTCCAGTCTGGGCAACAAGAGTGAAACTCTGTCTCAAAAAAAAA"
"chr17","51738482","51739094","JH378118","18053084","18053501","257","33685398","GCCGGGTGCGGTGGCTCACACCTGTAATCCCAGCACTTTGGGAGACTGAGGCGGGAGGATCACCTGAGGTCAGGAGTTCGAGACCAACCTGACCAACATGGTAAAACCCTGTCTGTACTAAAACTACAAAAAATTAGGCCAGGCGCAGTGGTCCATGCCTGTAATCCCAGCACTTTGGGAGGCCAAGGTGGGCGGATCATGAGGTCAGGAGTTTGAGACCAGCCTGGCCAACATAGTGAAACCCTGTCTCTACTAAAAACACAAAAATTAGTCGGGCATGGTGGCGGATGCCTGTAATCTCAGCTACTCAGGAGGTTGAGGCAGGAGAATCACTTGAACCCGGGAGGTGGAGGTTGCAGTGAGCCAAGATCACGCCACTGTACTCCAGCCTGGGCAACAGAGCGGGACTCCATCTTAAAAAAAAAAAAAAAAAAATTAGCCAGGCGTGGTGGCGCATGCCTGTAGTCCCAGCTACTTAGGAGGCTGAGGCAGGAGAATTGCTTGAACCCGGGAGGCAGAGGCTGCAGTGAGCCAAGACCACGCTATTGCATTCCAGCCTGGGTGACAAGAGCAAAACTCTGTCTCAAAAAACAAAACAAAACAAACAAAAAAA","GGCTGGGCGCAGTGGCTCACACCTGTAATCCCAGCACTTAGGGAAGCTGAGGCGAGTAGATCACCTGAGGTCAGGAGTTAGAGACCAGCCTGGCCATCATGGTGAAACCCCGTCTCTACTAAAGATACCAAAAATTAGCTGAGTGTGGTGCTGGGTGCCTGTAATCCCAGAAACTCAGGGTGCCTGTAATCCCAGCAACTCAGGGTGCCTTTAATCCCAGCAACTGAGGGTACCAGTAATCCCAGCAACTCAGGGTGTCTTTAATCCTAGCAACTGAGGGCACCTGTAATCCCAGCAACTCAGGAAGCTGAGACAGGAGAAGTACTTGAACCCAGAAGGCAGAGGTTGCAGTGAGCCGATATTGCACCATTGCACTCCAGTCTGGGCAACAAGAGTGAAACTCTGTCTCAAAAAAAAA"
"chr17","52245950","52246538","JH378118","18053084","18053501","254","34192866","TGTAATCCCAGCACTTTGGGAAGCCAACGCGGGTAGATCAGCTGAGGTCAGGAGCTCGAGACCAGCCTGGCCAACTGGTGAAACCCCATCTCTACTAAAAAAAATACAAAAAAATGGCCCAGCGCGGTGGCTCACACCTGTAATCCCAGCACTTTGGGAGGCCGAGGCGGGCAGATCACGAGGTCAGGAGATCGAGACCATCCTGGATAATACGGTGAAACCCCGTCTCTACTAAAAATACAAAAAAAAATTAACCGGGTGTGGTGGCGGGCGCCTGTAGTCCCAGCTACTAGGGAGGCTGAAGCAGGAGAATGGCGCGAAACCGGGAGGCGGAGCTTGCAGTGAGCCAAGACAGGCCACTGCACTCCAGCCTGGGCGACAGAGCGAGACTCCATCTCAAAAAAACAAAAAACAAAAAAATTAGCCAGCTGTGGTGGTGGGCGCATGTAATCCCAGTTACTTGGGAGGCTGAGGCAGGAGAATTGCTTGAAACCAGGAGGCAGAGGTTGCAGTGAGCCAAGATTACGCCATTGTACTCCAGCCTGGGCAACAAGGGCAAAACTCTGTCTCAACAAAAAAAAAGAAAAAA","GGCTGGGCGCAGTGGCTCACACCTGTAATCCCAGCACTTAGGGAAGCTGAGGCGAGTAGATCACCTGAGGTCAGGAGTTAGAGACCAGCCTGGCCATCATGGTGAAACCCCGTCTCTACTAAAGATACCAAAAATTAGCTGAGTGTGGTGCTGGGTGCCTGTAATCCCAGAAACTCAGGGTGCCTGTAATCCCAGCAACTCAGGGTGCCTTTAATCCCAGCAACTGAGGGTACCAGTAATCCCAGCAACTCAGGGTGTCTTTAATCCTAGCAACTGAGGGCACCTGTAATCCCAGCAACTCAGGAAGCTGAGACAGGAGAAGTACTTGAACCCAGAAGGCAGAGGTTGCAGTGAGCCGATATTGCACCATTGCACTCCAGTCTGGGCAACAAGAGTGAAACTCTGTCTCAAAAAAAAA"
"chr17","52264620","52265210","JH378118","18053084","18053501","242","34211536","GGCCACATGTGGTGGCTCACACCTGTAATCCCAGCACTTTGGGAGGCCAAGGCAGGCAGATCACCTGAGATCAGAAGTTCAAGACCAGCCTGGCCAATGTGGTGAAACCCTGTCTCTACTAAAAATAGAAAAAACACAGCCAGGCGCGGTAGCTCACACCTGCAATCCCAGCACTTTGGGAGGCCGAGGCAGGCAGATCACGAGGTCAGGAGATTGAGACCACGGTGAAACCCCATCTCTACTAAAAATACAAAAAATTAGCTGGGCATGGTGGCGGGCACCTGTAGTCCCAGCCACTTGGGAGGCTGAGGCAGGAGAATGGCGTGAACTCGGGAGGTGGAGCTTGCAGTGAGCAAAATTGCGCCACTGCACTCCAGCCTGGGCAACAGAGCAAGACTCCGTCTCAAAAAAAAAAAAAAAAAAAAATTAGCCGGCGTAGTGGCAAGCTCCTGTAATCCCAGCTACTTGGGAGGCTGAAGCAGGAGAATCGCTTGAACCCAGGAGGTGGAGGTTGCAGTGAGCCGAGACTGCGCCATTGCACTCCAGCCTGGGCAACAAGAATGAAACTCCGTCTCAGAAAAGAAAAAAAAA","GGCTGGGCGCAGTGGCTCACACCTGTAATCCCAGCACTTAGGGAAGCTGAGGCGAGTAGATCACCTGAGGTCAGGAGTTAGAGACCAGCCTGGCCATCATGGTGAAACCCCGTCTCTACTAAAGATACCAAAAATTAGCTGAGTGTGGTGCTGGGTGCCTGTAATCCCAGAAACTCAGGGTGCCTGTAATCCCAGCAACTCAGGGTGCCTTTAATCCCAGCAACTGAGGGTACCAGTAATCCCAGCAACTCAGGGTGTCTTTAATCCTAGCAACTGAGGGCACCTGTAATCCCAGCAACTCAGGAAGCTGAGACAGGAGAAGTACTTGAACCCAGAAGGCAGAGGTTGCAGTGAGCCGATATTGCACCATTGCACTCCAGTCTGGGCAACAAGAGTGAAACTCTGTCTCAAAAAAAAA"
"chr17","52281488","52282107","JH378118","18053084","18053501","287","34228404","GGCCAGGCGCGGTGGCTCACGCCTGTAATCCCAGCACTTTGGGAGGTCAAGGCGGGTGGATCACCTGAGGTCAGGAGTTCAAGACCAGCCTGGCCAACATGATGAAACTTCATCTTGGCCGGGCGCGGTGGCTCATGCTTGTAATCCCAGCACTTTGGGAGGCCAAGGCAGGCGGCGGATCATGAGGTCAGGAGATTGAGACCATCCTGGCTAAAACGGTGAAACCCCGTCTCTACTAAAAATACAAAAAAAAAAAAATTAGCCGGGCGTGGTGGCAGGCGCCTGTAGTCCCAGCTACTCGGGAGGCTGAGGCAGGAGAATGGCGTGAACCCGGGAGGCGGAGCTTGCAGTGAGCCGAGATAGCACCACTGCAGTCCGGCCTGGGTGAAAGAGTGAGACTCCGTCTCAAAAAAAAAAAAAAAGAAGAAAGAACTTCGTCTTTACTAAAAGTACAAAAAAAAAAAAAAAAAATTAGCCGGGCATGGTGGCAGGCGCCTGTAAACCCAACTACTCTGGAGGCTGAGGAAGGAGAACTGCTTGCACCTGGGAGTCGGAGGTTGCAGTAAGCCAAGATCGCACCATTGCACTCCAGCCTGGGCATCAAGAGTGAGACTTTGTCT","GGCTGGGCGCAGTGGCTCACACCTGTAATCCCAGCACTTAGGGAAGCTGAGGCGAGTAGATCACCTGAGGTCAGGAGTTAGAGACCAGCCTGGCCATCATGGTGAAACCCCGTCTCTACTAAAGATACCAAAAATTAGCTGAGTGTGGTGCTGGGTGCCTGTAATCCCAGAAACTCAGGGTGCCTGTAATCCCAGCAACTCAGGGTGCCTTTAATCCCAGCAACTGAGGGTACCAGTAATCCCAGCAACTCAGGGTGTCTTTAATCCTAGCAACTGAGGGCACCTGTAATCCCAGCAACTCAGGAAGCTGAGACAGGAGAAGTACTTGAACCCAGAAGGCAGAGGTTGCAGTGAGCCGATATTGCACCATTGCACTCCAGTCTGGGCAACAAGAGTGAAACTCTGTCTCAAAAAAAAA"
"chr17","52731467","52732093","JH378129","11955248","11955630","276","40776219","GGCCGGGTGCGGTGGCTCACGCCTGTAATCCTGGCACTTTGGGAGGCTGAGATGGACGGATCACCTGAGGTCAGGAGTTTTTTGTTTTTTTCTTTTTTTTTGAGACAGAGTCTGGCTCTGTTGCCCAGGCTGGAGTGCAGTGGCTCGATCTCGGCTCACTGCAAGCTCCGCCTCCCGGGTTCATGCCATTCTCCTGCCTCAGCCTCCCGGTAGCTGGGACTACAGGTGCCCGCCAGCACATCCGGTTATTTTTTTGTATTTTTAGTAGAGACAGTGTTTCACAGTGTTAGCCAGGATGGTCTCGATCTCCTGACCTCGTGATCCGCCCACCTCGGCCTCCCAAAAGTGCTGGGATTACAGGCATGAGCCACCGCGCCCGGCCAGGAGTTTTTGAGACCAGCCTGGCCAACAGGGTGAAACTCTGTCTCTACTAAAAATACAAAAATTAGTTGGGCATGGTGGCAGGCACCTGTAATCCCAGCTACATGGGAGGCTGAGGCAGGAGAATTGCTTGAACCTGGGAGGCGGAGGTTGCAGTGAGCTGAGATTGCGCCATTGCACTCCAGCCTGGGCAACAAGAGTGAAATTGCGTCTCAAAAACCAAAACAAACAAAAAAAGAATGAAAA","GGCTGGGTACGGTGGCTCATGCCTGTAATCCCAGCACTTTGGGAGGTGGGTCACTTGAGGTCAGGAGTTCGAGACCAGCCTGTGCAGTGCCTCCATCCTCAACTGCTGCCTCATCAGCCTGGACCACTACCTGCTCATCCTCTCACCACTGCCACAAGCTGCGCATGAAGCTCCTGCGCGCGCCGGTGCCCGTCTCTACTAAAAATACAAAAATTAGCTGGGTGTGGTGGCAGGTGCCTGTAATCCCAGCTACTCAGGAGGCTGAGGCAGGAGAATCACTTGAACCCAGGAGGCAGAGGTTGCAGTGAGCCGATATCGCATCATTGCACTCCAGCCTGAGCAACAAGAGTGAAATTTTGTCTCAAAAAAAAAAAAAAAAGAAA"
"chr17","54416242","54416805","JH378115","26183910","26184297","228","28232332","ACTTTGGGAGGCCATGGCAGGCGGATCACCTGAGATCAGGAGTTGGAAACCAGCCTGGCCAACATGGTAAAACCCCGTCTCTACTAAAAATACTTGGCTGGGCACGGTGGCTCACACTTGTAATTCCAACACTTTGGAAGGCCAAGGCGGGCAGATCACCTGAGGTTGGGAGTTCGAGACCAGCCTGACCAACATGGAGAAACCCTGTCTCTACTAAAAATACAAAATTAGCTGGGCATGGTGGTCTATGCCTGTAATCCCAGCTACTTGGGAGGCTGAGGCAGGAGAATTGCTTGAACCCGGGAGGCAGAGGTTGCGGTAAGCCAAGATCATGCCATTGCACTCCAGCCTGGGCAACAAGAGCAAAACCCCGTCTCAAAAAAAAAAAAAAAATTAGCCCAGTGTGGTGGCGTGCACCTGTAATCCCAGCTACTTACTTAGGAGCCTGAGGCAGGAGAATTGCTTGAACCCGGGAGGCAGAGTTTGCAGTGAGCCAAGATTGCACCATTGCACTCCAGCCTGGGTGACAAGAGTGAGACTGTCTCAAAAAAAAAAAAAAAAAAA","GGCCAGGTGCAGTGGCTCATATGTATAACCCCAACACTTTGGGAGGCCAACGCAGGTGGATCACCTGAGTTAGGAGTTTGAGACCAGCCTGACCAACATGGTGAAACCCTGTCTCTACTAAAAATACAGAAATGGCCGGGCATAGTGACACATACCTGTAATCCCAGATACTTGGGATGCTGAGTTTGCTTAAACCCAGAGGAGAACTGCTTAAACCCGGGAGGTAGAGGTCACAGTGAGCCAAGATTGGGATGCTGAGATTTGCTTAAACCCAGAGGAGAACTGCTTAAACCCAGGAGGCAGAGGTTGCAGTGAGTTGAGATTGCACCATTGCACTCCAGCCTGGACAACAAGAGTGAAACTCTGTCTCAAAAAAAAAAAAAAAAAA"
"chr17","55179146","55179483","JH378144","13229286","13229620","44","41949860","GGCCGGGTGCGGTGGCTCACGCCTGTAATCCCAGCACTTTGGGAGGCCGACGCAGGTGGATCACTTGAGGTCTGGTGTTCAAGACCAGCCTGGCCAACATTGTGAAACCCCGTCTCTACTAAAAATACAAAAAGTTAGCTGGGCATGGTAGCAGGTGCCTGTAATCCCAGCTACTTGGGAGGCTGAGGCAGGAGAATTGCTTGAACCTGGGAGGCAGAGGTTGCAGTGAGCTGAGATCGCACCATTGCACTCCAGCCCAGGCAACAAGAGCGAAACTTCGTCTCAAATAATAATAATAATAATAATAATAAATAAATAAATTTTTAAAAAAGAAAAAA","GGCCGGGCGCGGTGGCTCAAGCCTGTAATCCCAGCACTTTGGGAGGCCGAGGCGGGTGGATCACCTGTGGTCAGGAGTTCAAGACAGCTTGGTCAACATGGTGAAACCCCGTCTCTACCAAAAATACAAAAAATTAGCTGGGCATGGTAGCGCATGCCTGTAATCCCAGCTACTCAGGAGGCTGAGGCAGGAGAATTGCCTGAACCCAGGAGGCAGAGGTTGCGGTGAGCCGAGATCGCGCCATTGCACTCCAGCCTGGGTAACAAGAGCGAAACTCCCTCTCATAAAAAATAAATAAATAAATAAATAAATAAATAAATAAATAAATAAATAAA"
"chr17","59543657","59543981","JH378109","3329188","3329514","46","56214469","GGTTGGGCACAGTGGCTCACGCCTGTAATCCCAACACTTTGGGAGGCCAAGGCGGGTGGATCACCTGAGGTCGGGAGTTCAAGACCAGCCTGGCCAACATGCTGAAACCCTATCTCTACTAAAAATACAAAAAAAAAAAAAAAAAAAAAAAAAAAAAATAGCCCAGTGTGGTGTCAGGCGCCTATAATCTCAGCTACTTGGGTGGCTGAGGCAGGAGAGTCGCTTGAACCTGGGAGGCGGAGGTTGCAGTGAGCGGAGATCGCACCATTGCACTCCAGCGTGGGCAACAAGAGTGAAACTCCATCTCAAAAAAAAAGAAAAGAAA","GGCCAGGCATGGTGGCTCACGCCTGTAATCCCAGCACTTTGGGAGCCCAAGCCGGGTGGATTACCTAAGGTCAGGAATTCCAGAACAGCCTGGACAATATGGTGAAACCTTGTCTCTACTAAAAATACAAAAAAAAAAAAAAAAAAAAAAAAAAAAAAAATTTAGCCGGGTGTGGTGGTAGGTACCTGTAATCCCAGCTACTAGGGAGGCTGAGGCAGGAGAATCGCTTGAACTTGGGAGGCGGAGGTTGCAGTGAACAGAGATCACACCACTGCACTCCAGCCTGGGCGACAAGAGCAAAACTCCATCTCAAAGAAAAAAAAAGAA"
"chr17","60766805","60768705","JH378118","18053084","18053501","1483","42713721","GGCCAGGTACCGTGGCTCATGCCTCTTATCCCACCACTTTTGGAAGCTGAGGTGTGAGGATCACCCGAAGTCAGGAGTTTGGAACCATCCTGGCCAATGTTGTAAAACCCCGTCTCTAATAAAAATACAAAAGTTACCCAAGCATGGTGGTGGGCACACCTGTAATCCCAGCTACTTGGAAGGCTAAGACAGGAAAATGCCTGAACCCAGTGTGGCTGGAATTGGTGGGTTCTTGATCTCACTGACCTCAAGAATGAAGCCACGGACCCTCACGGTGAGTGTCACACTTCAAGGTGGCACGTCCAGTTTGTTCCTTCTGATGTTCGGATGTGCTCAGAGTTTCTTTCTTCTGGTGGGTTCATGGTCTCGCTGGCTCAGGAGTGAAGCTACAGACGTTCACCGGGAGTGTTACAGCTCTTAAGGCCTTGCGCCTGGAGTTGTTAGTTCCTCCCAGTGGCTTCGTGGTCTCACTGGCTTCAGGAATCAAGCAGCACGGTGAGCGTTACAGCTCACAAAGGCAGTGTGCACCCACAGTGAGCAACAGCAAAATCTATTGCAAAGAGGACAGAACAAAACCCCCACACTGGGGAAAAGGACCGGAACAGCTTGCCACTGCTGGCTCAGGCAGCCTGCTTTTATTCTCTTATCTGGCCCCACCCACATCCTCCTGATTGGTCCATTTTACAGAGAGCTGATTAGTTTGCTTTACAGTGAACTGATTGGTCCATTTTGACAGATTGGTGCTGATTGGTGCGTTTACAATCCCTGAGCTAGACACAAAAGTTTTCCACGTCCCCATTAGAATAGCTAGATACAGAGTGTCCATAGGTGTATTTACAAACCCTGAGCTAGACACGGAGTGATGATTGGTGCATTTACAAACATGGAGCTAGATACAGAGTGCCGATTGGTGCATTCACAATCCCTTAGCTAGACATAAAGGTTCTCAAGTTCCCACCAGATCAGCTAGACATAGAGCGCTGATTGGTGCATTTACAAAACTTGAGCTCGACACAGGGTGCTGATTGGTGCATTCACAAACCTTGAGCTAGACACAGGGTGCTGATTGGTGTGTTTACAAACCTTGAGCTAGATGCAGAGCGCTGATTGGTGTATTTACAATTCCTTAGCTAGACATAAAGGTTCTCCAAGTCCCCACTAGACTCAGGAGCCCAGCTGGCCTCACCCAGTGGATGTCACACTGGGGCCATAGGTGGAGCTGCCTGCCAGTTCCGTGTCCTGCGCCCACACTCCTCAGCCCTTGGGCGGTGGATGGGATTGGGCACCGTGCAGCAGGGGGTCGCGCTCCTGGGGGAGGCTCGGGCGGTGCAGGAGCCCACGGTGGCGGGGCGGGGCAGACTCAGGCATGGCGGGCTCCGGGTCCCAAGCCCTGCCGGGTGGGGAGGCACCTAAGGCCAGGCGAGAAATGGAGCGCAGCGCTGGTGGGCCAGCACTGCTGGGGGACCAGGCGCATCCTCCGCAGCTGTTGGCCTGGGTGCTAAGCCCCTCACTGCCCAGGGCTGGCAGGGCCCGCCGGCCGCTCCGAGTGCCGGGCCCGCCAAGCCCACGCCCACTTGGAACTCTAGCTGGCCCGCAAGCGCGGCGCGCAGCCCTGGTTCCCCCCCGTGCCTCTCCCTCCACACCTCCCCGCGGGCTGAGGGAGCCGGCTCCGGCCTCGGCCATCCCAGGAAGGGGCTCCCACACTGCAGCGGCGTGCTGAAGGGCTCCTCAAGCACGGCCAGAGTGGGCGAGGAGGCTGAGGAGGCGCCAAGAGTGAGCCAGGGCTGCCAGCATGCTGTCACCTCTCACCAGGAGGCGGAGATTGCAGTGAACCAAGACTGTGCCATTGCACTCCAGCCTGGGCAACAAGAGTGAAACTCCATCTCAAAAAAAATAATAAA","GGCTGGGCGCAGTGGCTCACACCTGTAATCCCAGCACTTAGGGAAGCTGAGGCGAGTAGATCACCTGAGGTCAGGAGTTAGAGACCAGCCTGGCCATCATGGTGAAACCCCGTCTCTACTAAAGATACCAAAAATTAGCTGAGTGTGGTGCTGGGTGCCTGTAATCCCAGAAACTCAGGGTGCCTGTAATCCCAGCAACTCAGGGTGCCTTTAATCCCAGCAACTGAGGGTACCAGTAATCCCAGCAACTCAGGGTGTCTTTAATCCTAGCAACTGAGGGCACCTGTAATCCCAGCAACTCAGGAAGCTGAGACAGGAGAAGTACTTGAACCCAGAAGGCAGAGGTTGCAGTGAGCCGATATTGCACCATTGCACTCCAGTCTGGGCAACAAGAGTGAAACTCTGTCTCAAAAAAAAA"
"chr17","64473614","64473953","JH378109","21565230","21565567","55","42908384","GGCCGGGTGTGGTGGCTCATGCCTGTAATCCCAGTACTTTGGGAGGCCGAGGCAGGCAGATCTCCTGAGGTCAGGAGTTTGAGACCAGCCTGGCCAACATGATGAAATGCTGTCTCTCCTAAAAATACAAAAATTAGCCAGACATAGTGGCAGGTGCCTGTAATCCCAGCTACTTGGGAGGCTGAGGGAGGAGAATTGCTTGAACCTGGGAGGCAGAGGTTGCAGTGAGTCAAGATCACGCCATTGCGCTCCAACCTGGGTGACAAAAGTGAGACTTCATCTCAAAATAAATAAATAAATAAATAAATAAATAAATAAATAAATAATAATTAAAAAAAAA","GGCCGGGCGCGGTGGCTCAAGCCTGTAATACCAGCACTTTGGGAGGCCGAGGCGGGTGGATCACGAGGTCAAGAGATCGAGACCATCCTGGTCAACATGGTGAAACCCCGTCTCTACTAAAAATACAAACAATTAGCTGGGCATGGTGGCGGGTGCCTGTAATCCCAGCTACTCCAGAGGCTGAGGCAGGAGAATTGCCTGAACCCAGGAGACGGAGGTTGCGGTGAGCCAAGATCGCGCCATTGCACTCCAGCCTGGGTGACAAGAGCGAAACTCCGTCTCAATAAATAAATAAATAAATAAATAAATAAAAATAAAATAAATAAATAAATAAATAA"
"chr17","67747489","67748097","JH378118","18053084","18053501","256","49694405","GCTGGGTGTGGTGGCTCACGCCTATAATCCCAGCACTTTGGGAGGCCAAGGCAGGTGGATCACCTGAGGTCAGGAGTTTGAGACCAGCCTGGCCAACATGATGAAACCCCGTCTCTACTAAAAATACAAAGAATTAGGCTGGGCGCGGTGGCTCACGCCTGTAATCCCAGCACTTTGGGAGGCCGAGGCGGGTGGATCACGAGGTCAGGAGATCGAGACCATCCTGGCTAACACGGTGAAACCCCGTCTCTAATAAAAATAAAAAAAAATTAGCTGGGCGTGGTGGTTGGCGCCTGTAGTCCCAGCTACTCGGGAGGCTGAGGCAGGGGAATGGCGTGAACCCGGGAGGTGGAGCTTGTAGTGAGCCGAGATCACGCCACTGCACTCCAGCCTGGGCGACAGAGCAAGACTCCGTCTCAAAAAAAAAAAAAAAAAAAATTAGCCAGGCGTGGTGGCGGGTGCCTGTAATCCCAGCTACTCTGGAGGCTGAGGCAGGAAAATCACTTTAACTCAGGAAACAGAGGTTGCAGTAAGCCGAGATCACGCCATTGTGCTCCATCCTGGGCAACAAGAGCGAAACTCCGACTCGGAAAAAAAGAAAAAAAAAAA","GGCTGGGCGCAGTGGCTCACACCTGTAATCCCAGCACTTAGGGAAGCTGAGGCGAGTAGATCACCTGAGGTCAGGAGTTAGAGACCAGCCTGGCCATCATGGTGAAACCCCGTCTCTACTAAAGATACCAAAAATTAGCTGAGTGTGGTGCTGGGTGCCTGTAATCCCAGAAACTCAGGGTGCCTGTAATCCCAGCAACTCAGGGTGCCTTTAATCCCAGCAACTGAGGGTACCAGTAATCCCAGCAACTCAGGGTGTCTTTAATCCTAGCAACTGAGGGCACCTGTAATCCCAGCAACTCAGGAAGCTGAGACAGGAGAAGTACTTGAACCCAGAAGGCAGAGGTTGCAGTGAGCCGATATTGCACCATTGCACTCCAGTCTGGGCAACAAGAGTGAAACTCTGTCTCAAAAAAAAA"
"chr17","71197353","71197681","JH378262","266823","267148","47","70930530","GACCGGACACAGTGGCTCACGTCTGTAATCCCAGCACTTTGGGAGGCTGAGGCGGGTGGATCACCTGAGGTCAGGAGTTCAAAACCAGCCTGGCCAATATGGTGAAAACCCGTCTATACTAAAAATAAAAAATTAGCCAGGCTTGGTGGCAGGCACCTGTAATCCTAGGTACTCTGGAGGCTTAGACAGGAGAATCACTTGAACCCGAGAAGTGGAGGTTGCAGTGAGCCAAGATCGTGCCATTGCACTCCAGCCTGGGCGACAAGAGTGAGACTCCATCTCAAAAACAAACAAACAAACAAACAAAAAACAAATGAACAAAAAAAAAA","GGCCGGGCGCGGTGGCTCAAGCCTGTAATCCCAGCACTTTGGGAGGCCGAGGCGGGTAGATCATGAGGTCAGGAGTTTGAGACCAGCCTGGCCAACATGGTGAAACCCCGTCTCTACTAAAAATACAAAAATTAGCCGGGCATGGTGGCCTGTGCCTGTAATCCTAGCTACCCAGGAAGCTGAGGCAGGAGAATTGCCTGAACCCAGGAGGCGGAGGTTGCGGTGAGCCGAGATCGTGCCATTGCACTCCAGCCTGGGTAACAAGAGCGAAACTCCGTCTCAAAAACAAACAAACAAACAAACAAAAACAAAAAACAAAAAACAAA"
"chr17","72892082","72892699","JH378118","18053084","18053501","266","54838998","GGCCAGGTGCAGTGGTTCACACCTATAATCCCAGCACTCTAGGAGGCCAAAGTGGGCAGATCACCTGAGGTCAGAAGTTCGAGACCAGCCTGGCCAACATGGTGAAACCATCTCTACTAAAAACACAAAAATTAGGCTGGGCACGGTGGCTCACACCTGTAATCCCAGCACTTTGGGAGGCCGAGGTGGGTGGATCACGAAGTCAGGAGATCAAGACCATCCTGGCTAACACGGTGAAACCCCGTCTCTACTAAAAATACAAAAAATTAGCCAGGCGTGGTGGCGGGCGCCTATAGTCCCAGCTACTTGGGAGGCTGAGGCAGGAGAATGGCGTGAACCCAGGAGGCGGAGCTTGCAGTGAGCCAAGATTGCGCCACTGCACTCCAGCCTGGGTGAGAGAGCTAGACTCTGTCTCAAAAAAAAAAAAAAAAAAAACACAAAAATTAGCCGGGCTTGGTGGCAGGTGCCCGTAATCCCAGCTACTCAGGACGCTGGGACAGGAGAATCTCATGAACCCTGGAGGTGGAGGTTGTAGTGAGCCAAGATCTCACCATCGCACTCCAGCCAGGGTGACAAGAGTGAAACTCTGTCTTAAAAAGATAAATAAATAAAATAAAA","GGCTGGGCGCAGTGGCTCACACCTGTAATCCCAGCACTTAGGGAAGCTGAGGCGAGTAGATCACCTGAGGTCAGGAGTTAGAGACCAGCCTGGCCATCATGGTGAAACCCCGTCTCTACTAAAGATACCAAAAATTAGCTGAGTGTGGTGCTGGGTGCCTGTAATCCCAGAAACTCAGGGTGCCTGTAATCCCAGCAACTCAGGGTGCCTTTAATCCCAGCAACTGAGGGTACCAGTAATCCCAGCAACTCAGGGTGTCTTTAATCCTAGCAACTGAGGGCACCTGTAATCCCAGCAACTCAGGAAGCTGAGACAGGAGAAGTACTTGAACCCAGAAGGCAGAGGTTGCAGTGAGCCGATATTGCACCATTGCACTCCAGTCTGGGCAACAAGAGTGAAACTCTGTCTCAAAAAAAAA"
"chr17","74365360","74365846","JH378118","18053084","18053501","163","56312276","TATAAAAAATCAGCTAGGCTTGGTGGCTTGTGCCTGTAATCCCAGCACTTTGGGAGGCTGAGGCAGGTGGATCACCTGACGTAGGTGTTTAAGACCAGATTGACTAACATGTTGAAACCCCGTCTCTACTAAAAATACAAAAATTATCTGGGCTTGGTGGTGCATGCCTGTAATCCCAGCTGCTCAGGAGGCTGAGACAGGAGAATCGCCTGAACCTGGGAAACGGAAGTTGCAGTGAGTGGAGGTTGCAGTGAGCCGAGATTGCACCACTGCACTCCAGTCTGGGCAACGGAAAAAGACTGTCTCAAAAAAAAAAAAAAAATTAGCTGGGTGTGGTGGTTGGCGCCTGTAATTCCAGCTACTCAGGAGGCTGAGGCAGGAGAATCACTTGAACTCAAGAGGCAGAGGTTGCAATGAGCCAAGATTGCGCCATTGTACTCCAGCCTGGGCCACAAGATTGAAACTTCATCTTGGGGAAAGAAAACAA","GGCTGGGCGCAGTGGCTCACACCTGTAATCCCAGCACTTAGGGAAGCTGAGGCGAGTAGATCACCTGAGGTCAGGAGTTAGAGACCAGCCTGGCCATCATGGTGAAACCCCGTCTCTACTAAAGATACCAAAAATTAGCTGAGTGTGGTGCTGGGTGCCTGTAATCCCAGAAACTCAGGGTGCCTGTAATCCCAGCAACTCAGGGTGCCTTTAATCCCAGCAACTGAGGGTACCAGTAATCCCAGCAACTCAGGGTGTCTTTAATCCTAGCAACTGAGGGCACCTGTAATCCCAGCAACTCAGGAAGCTGAGACAGGAGAAGTACTTGAACCCAGAAGGCAGAGGTTGCAGTGAGCCGATATTGCACCATTGCACTCCAGTCTGGGCAACAAGAGTGAAACTCTGTCTCAAAAAAAAA"
"chr17","74566963","74567566","JH378119","32351107","32351490","260","42215856","GCCGGGCATGGTGTATCACGCCTGTAATCCCAGCACTTTGGGAGGCAGAGGTAGGCAGATCACCTGAGGTCAGGAGTTCAAAACCAGCCTAGCCAACATGGTGAAACCCCGTCTCTACTAAAAATACAAAAAATTAGTGGCCAGGCACGGCAGCTCACGCCTGTAATTCCAGCACTTTGGGAGGCCGAGGCGGGCAGATCACGAGGTCAGAAGATTGAGACCATCCTGGCTAACACGGTGGAACCCCATCTCTACTAAAAATACAAAAAATTAGCTGGGCATGGTGGCTGGTGCCTGTAGTCCCAGCTACTCGGGAGGCTGAGGCAGGAGACTGGCATGAACCCGGGAGGCGGAGCTTGCAGCAAGCCAAGATCGTGCCACTGCACTCCACTCCATCCTGGGCGACAGAGCAAGACTCCGCTTCAAAAAAAAAAAAATTAACCGGGCAAGGTGGCAGGTGCCTGTAATCCCAGCTACTTGGGAGGCTGAGGCAGGAGAATTGCTTGCAGAGGTTGAAGTGAGCCGAGATTACGCCATTGCACTCCAGCCCAAGTGACAAGAGTGAAACTCCATCTCAAAAAAAAAAAAAAAAAAAAGAAAAAAA","GGCCAGGTATGGTGGCTCACACCTGTAATCCCAGCACTTTGGGAGGCCAAGGCAGGCAGACCACCTGAGGTCAGGAGTTCGAGATCAGCCTAGCCAACATGGTGAAACCCCATCTCTAGTAAAAATAAAATTAGCCAGGCATGGTGGTGCATGCCTGTAACGCAGGTCAGGAGTTCGAGATCAGCTTAGCCAACATGGTGAAACCCCATCTCTAGTAAAAATAAAATTAGCCAGGCAGGTGGTGCCGCCTGTACTCGGGAGGCTGAGGCAGGAGAATCACTTGAACCCAAGAGGCAGAGGTTGCAGTCAGCCAAGATCATGCCATTGCACTCCAGCCTAAGCAAAAAGAGTAAAACTCAGTCTCAAAACAAAAAAACAAAAAAA"
"chr17","75365782","75366409","JH378153","2355361","2355755","282","73010421","CCAGGCGTGGTGGCTCATGCCGGTAATCCCAGCACTTTGGGAGGCCAAGGCAGGTGGATCATCTGAGGTCAGGAGTTCGAGACCAGCCTGACCAACATGGTGAAACCTCACCTCTACTAAAAATACAAAAACTAGACAGGCGTGGTGGCGGGTGCCTGTAGTCCCAGCTACTTGGGAGGCTGAGGCAGAAAAATCGCTTGAACCCAGTAGGCAGAGGTTGCAGTGAGCCGAGATCACACCATTGCACTCCAGCCTGGGCAAAAAAGAGCGAAACTCCATCTCAGAAGAAAAGACCGGGTGCAGTGGCTCATGCTTGTAACCCCAGCACTTTGGGAGGCCAAGGCGGGTGGATCACGAGGTCAGAAGATCGAGACCATCCTGGCTAACACGGTGAAACCCCGTCTCTACTAAAAATACAAAAAAAAAAAAATAATTAGCCGAGTGTGGTGGCGGATGCCTGTAGTCCCAGCTACTCGGGAGGCTGAGGCAGGAGAATGGCGTGAACCCAGGAGGCGTAGCTTGCAGTGAGCCGAGATCACGCCACTGCACTCCAGCCTGGGCGACAGAGCAAGACTCGTCTTAAAAAAAAAAAAAAAAAGAAAAAGTAAAAGAAAAGAAAAAGCAACAA","GGCGGGGCATGGTGGCTCACACCTGTCATCCCAACACTTTGGGAGGCTGAGGCAGGCAGATCACCTGAGGTCAGGAGTTTGAGACCAGCCTGGCCAACATGGTGAAACCCCATCTCTACTAAAAATACAAAAATACAAAAAACCCCATCTCTACTAAAAATACAAAAAGCTTGTCTCTATTAAAAATACAAAAAACAAAAAACAAACAAAAAAAAAACCACCATGGTGGTGGGTGCCTATAATCCCAGCTACTCGGGAGGCTGAGGCAGGAGAATCGCTTGAACCCAGGAGGCAGAGGTTGCAGTGAGCCAAGATCCCACCATTGCACTCCAGCCTGGGCAACAGAGAGAGAGACTCTGCCTCAGAAAAAAGAAAGAAAGAAAGAAAGAAAGAAA"
"chr18","19875","20142","JH378153","8929988","8930242","54","8910113","TTGGGAGGCTGAGGTGGGTGGATCATCTGAGGTCAGGAGTTAAGACCAGCCTGGCCAACATGGTGAAACCCCATCTCTACTAAAAATACAAAAACAAAACAAAACAAAACAAAAAAAACCAGCATGGTGGCAGACACCTGTAATCCCAGCTACTCGGGAGACTGAGGCAGGAGAATCACTTGAACCTGGGAGGCGGAGGTTACAGTGAGCCAAGATCTTGTCATGTCACTCCAGCCCAGGCAACAAGAGCAAAACTGTCTTAAAAAAA","TTTGAGAGGCTGAGGTGGGTGGATCACCTAGGTCAGGAGTTTGAGACCAGCCTGACCAACATGGTGAAACCTCATCTCTACTAAAAATAAAAATAAAAAACTAGCCAGGTGCAATGGTGCATGCCTGTAATCCCAGCTACTTGGGAGGCTGAGATGGGAGACTCACTTGAACCTGGGAGGTGGAGGTTGCAGTGAGCCAAGATCATACCATTGCACTCCAGCCTGGGCAACAAGAGTGAAACCTCTTCTCAAAAA"
"chr18","4520498","4521101","JH378118","18053084","18053501","246","13532586","GGCTGGGCGCAGTGGCCCACCCCTGTAATCCCAGCACTTTGGGAGGCCGAGGCGGGTAGATCACCTGACGTCAGGAGTTCAAGACCAGCCTGGCCAACATGGTGAAACCCTGTCTCTACTAAAATACAAAAATTAGGCTGGGCGCAGTGGCTCAAGCCTGTAATCCAGCACTTTGGGAGGCCAAGGCGGGCAGATCACCTGAGGTCAGGAGTTCGAGACTAGCCTGGCCAACCTGGCAAAACCCCATCTCTACTAAAAGTACGAAAATTAGCCAGGGTGATGGTGTGCACCTGTAATCCTAGGTACTCAGGAGGCTGAGGGCAAGAGAATCGCTTGAACCTGGGAGGCAGAGGTTGTAGTGGGCCAAGATCGCGCCATTGCACTGCAGCCTCGGTGACAGAGAAAGACTCCGTCTCAAAAAAAAAAAAAAACAAAAATTAGCTGGGCGTGGTGGTGGGCGTCTGTAGTCCCATCTACACGGGAGGCTGAGGCAGAAGAATCACTTAAACCCAGGATGTGGAGGTTGCAGTGAGCTGAGATCACGCCATTGCACTCCAGACTGGGTAACAAGAGCAAAACTCCATCTCAAATAAATAAAATAAAA","GGCTGGGCGCAGTGGCTCACACCTGTAATCCCAGCACTTAGGGAAGCTGAGGCGAGTAGATCACCTGAGGTCAGGAGTTAGAGACCAGCCTGGCCATCATGGTGAAACCCCGTCTCTACTAAAGATACCAAAAATTAGCTGAGTGTGGTGCTGGGTGCCTGTAATCCCAGAAACTCAGGGTGCCTGTAATCCCAGCAACTCAGGGTGCCTTTAATCCCAGCAACTGAGGGTACCAGTAATCCCAGCAACTCAGGGTGTCTTTAATCCTAGCAACTGAGGGCACCTGTAATCCCAGCAACTCAGGAAGCTGAGACAGGAGAAGTACTTGAACCCAGAAGGCAGAGGTTGCAGTGAGCCGATATTGCACCATTGCACTCCAGTCTGGGCAACAAGAGTGAAACTCTGTCTCAAAAAAAAA"
"chr18","8281535","8282152","JH378118","18053084","18053501","271","9771549","GGCCAGGTGCGATAGCTCACACTGGTAATCCCAACACTTTGGGAGGCCGAGGTGGGCGGATCACCTGAGGCCAGGAGTTTGAGACCAGCCTGGCCAACACAGTGAAACCCCATCTCTACTAAAAATACAAAATTAGGCAGGGTGCAGTGGCTCACGCCTGTAATACCAGCACTTTGGGAGGCCGAGACAGGCGGATTACGAGGTCAGGAGATCGAGACCATCCTAGCTAACACAGTGAAACCCCGTCTCTACTAAAAAAAAAAAAAAAAAAAAAAGTACAAAAAAATTAGCCAGGCGTGGCGGCAGGTGCCTGTAGTCCCAGCTACTCAGGAGACTGAGGCAGGAGAATGGCGTGAACCCGGGAGGCGGAGCTTGCAGTGAACTGAGATCACACCACTGCACTCCAGCCTGGGCAACAGAGTGAGACTCCGTCTCAAAAACAAAACAAAATTAGCCGGGCATGGTGGTGGATGCCCGTAATCCCAGCTACTCGGGAGGCTGAGGCCGCCAAGGCAGGAGAATCTCTTGAATGTGGGAGGCAAAGGCTGCAGTGAGCTGAGATCATGCCATTGCACTGTAGCCTGGGCGACAAAAGTGAGACTCCGTCTCAAAAAAAAA","GGCTGGGCGCAGTGGCTCACACCTGTAATCCCAGCACTTAGGGAAGCTGAGGCGAGTAGATCACCTGAGGTCAGGAGTTAGAGACCAGCCTGGCCATCATGGTGAAACCCCGTCTCTACTAAAGATACCAAAAATTAGCTGAGTGTGGTGCTGGGTGCCTGTAATCCCAGAAACTCAGGGTGCCTGTAATCCCAGCAACTCAGGGTGCCTTTAATCCCAGCAACTGAGGGTACCAGTAATCCCAGCAACTCAGGGTGTCTTTAATCCTAGCAACTGAGGGCACCTGTAATCCCAGCAACTCAGGAAGCTGAGACAGGAGAAGTACTTGAACCCAGAAGGCAGAGGTTGCAGTGAGCCGATATTGCACCATTGCACTCCAGTCTGGGCAACAAGAGTGAAACTCTGTCTCAAAAAAAAA"
"chr18","14964693","14965321","JH378118","18053084","18053501","273","3088391","GGCTGGGTGCGGTGGCTCACACCTGTAATCCCAGCACTTTGGGAGGCTGAGGCAGGCGGATCACCTGAGGTCAGGAGTTCAGGACCAGCCTGATCAACATAGCGAAACCCTGTCTCTATTAAAAATATAAAAATTGCTGGGTGCGGTGGCTCACGCCTGTAATCCCAGCACTTTGGGAAGCCGAGGCGGGCGGATCATGAGCTCAGGAGATCGAGACCATCTTGGCTAACATGGTGAAACCCTGTCTCTACTAAAAATACAAAAAAATTAGCCAGGTGTGGTGGCGGGCGCCTGTAGTCCCAGCTACTCTGGAGGCTGAGGCAGGAGAATCACTTGAACCTGGGAGGCGGAGGTTGCGGTGAGCCAAGATGGTGCCATTGCACTCCAGCCTGGGCAACAAGAGTGAAACTCCATCTCAAAAAAAAAGAAAAAAAAAAAAAAAAACAACCCACAAAAATTAGCCAGGTGTGATGGCGGGTGTCTGTAATCCCAGCTACTTGGGAGACTGAGGCAGGAGAATGGCTTGAACCCGGGAGGTGGAGGTTGCAGTAAGCCGAGATTGCGCCACTGCACTCCAGCCTGGGTGACCAGAGTGAAACTTCATCTCAAAAAAAAAAAAAAAAAAAAAA","GGCTGGGCGCAGTGGCTCACACCTGTAATCCCAGCACTTAGGGAAGCTGAGGCGAGTAGATCACCTGAGGTCAGGAGTTAGAGACCAGCCTGGCCATCATGGTGAAACCCCGTCTCTACTAAAGATACCAAAAATTAGCTGAGTGTGGTGCTGGGTGCCTGTAATCCCAGAAACTCAGGGTGCCTGTAATCCCAGCAACTCAGGGTGCCTTTAATCCCAGCAACTGAGGGTACCAGTAATCCCAGCAACTCAGGGTGTCTTTAATCCTAGCAACTGAGGGCACCTGTAATCCCAGCAACTCAGGAAGCTGAGACAGGAGAAGTACTTGAACCCAGAAGGCAGAGGTTGCAGTGAGCCGATATTGCACCATTGCACTCCAGTCTGGGCAACAAGAGTGAAACTCTGTCTCAAAAAAAAA"
"chr18","15291276","15291680","JH378105","31074364","31074738","116","15783088","CTCGTGCCTGTAATCCTAGCACTTTGGGAGGCCAAGGTGGGCAGATCATCTGAGGTCAGGAGTTCGAGACCAGCCTGGCCAACATAGAGAAATCCCATCTCTACTAAAAATACAAAAATTGACGAGTTAATGGGTGCAGCACACGAACATGGCACATGTATACATATGTAACAAACCTGCACGTTGTGCACATGTACCCTAAAACTTAAAGTATATTTAAAAAAAATACAAAAATTAGCCGGGCATGGTAGCAGGCACCTGTAATCCCAGCTACTCGGGAGGCTGAGGCAGGAGAATCACTTGAACCTGGGAGGCAGAGGTTGCAGTGAGCTAAGATCATTCCATTGTACTCCAACCTGGGCAACAAGAGTGAAATTCCGTCTAATAAAAAATGAAATAAATAAA","GGCCGGGCACAGTGGCTCACACCTGTAAACCCAGCACTTTGGGAGAATGAGGTGGGCAGATGACTTCAGGTCAGGAGTTCGAGACCAGCCTGGCCAACACTGTGAAATCCCATCTCTACTAAAAATACAAAAATTAGCCATGGTGGTCAGAAGATCAAGACTATCCTGGCCAACATGGTGAAACCTTGTCTCTACTGAAAATAGAAAAATTAGCTGGGTATGGTGGCATGCGCCTGTAGTCCCAGATACTCAGGAGGCTGGGGCAGGAGAATCACTTGAACCCAGGAGGCAGAGGTTGCAGTGAGCTGAGATCATGCCATTGCACTCTAGATTAGGCAACAAGAGTGAAACTGTCTCAAAAAGAGAGAGAGAAAA"
"chr18","15802064","15802689","JH378153","2355361","2355755","270","13446703","GACCGGGCATGGTGGCTCACACCTGTAATCCCAGCACTTTGGGAGGCGTAGGCGAGTGGCCCCTGAGGTCAGGAGATCGAGACAACCCTGGCCAACATGGTGAAACTCTACTAAAAATACAAAATTAGGCCGGGTGCCGTGGTTCACGCCTATAATCCCAGCACTTTGGGAGGTCAAGGTGGGCAGATCACCTGAGGTCAGGAGTTTGAGACCAGCCTGGCCAACATGGTGAAACCCAGTCTCTACTAAAAATACAAAAATTAGCTGGGCATGGTGGTGGACACTTGTAATCCCAGCTACTTGGGGGGCTGAGGCAGGAGAATCACTTGAACCCAGGAGGCAGAGGTTGCAGTGAGCCTAAATCACCCCATTGCACTCCAGCCTGGGCAACAAGAGTGAAATTCTGTCTCGAAAAAAAAAAAAAAAGAAAAGAAAAGAAAAAAAAATTAGCCAGGTGTGGTGCTGCATGCCTGTAATCCCAGCTACTCAGGAGGCTGAGGCAGGAGAATCGCTTGAACCCGGGAGGCAGAGGTTGCAGTGAGCTGAGACCACACCATTGCACTCCAGCCTGGGCGACAAGAGAGTAACTCCATTTCAAAAAAAAAAAAAAAAAAAAGAAAAAAGAA","GGCGGGGCATGGTGGCTCACACCTGTCATCCCAACACTTTGGGAGGCTGAGGCAGGCAGATCACCTGAGGTCAGGAGTTTGAGACCAGCCTGGCCAACATGGTGAAACCCCATCTCTACTAAAAATACAAAAATACAAAAAACCCCATCTCTACTAAAAATACAAAAAGCTTGTCTCTATTAAAAATACAAAAAACAAAAAACAAACAAAAAAAAAACCACCATGGTGGTGGGTGCCTATAATCCCAGCTACTCGGGAGGCTGAGGCAGGAGAATCGCTTGAACCCAGGAGGCAGAGGTTGCAGTGAGCCAAGATCCCACCATTGCACTCCAGCCTGGGCAACAGAGAGAGAGACTCTGCCTCAGAAAAAAGAAAGAAAGAAAGAAAGAAAGAAA"
"chr18","15849226","15849860","JH378118","18053084","18053501","290","2203858","GGCCAGGCACAGTAGCTTACGCCTATAATCTCAGCACCCTAGGAGGCCGAGGCTGGCAGACCACCTGAGGTCACGAGTTCAAGACTAGCCTGGTCAACATAGCAAAACCCCATCTCTACTAAAAATACAAAAATTAGGCTGGGCACAGTGGCTCATGCTTGTAATCCCAGCACTTTGGGAGGCCAAGTCGGGAGAATCACCTGAGGTTGGGAGTTCGAGATCAGCCTGACCAACATAGAGAAACTCCATCTCTACTAAAAATGCAAAATTAGCTAGGCATGGTGGTGCATGCCTGTAATCCCAGCTACTCGTAAGGCTGAGGCAGGAGTATCGCTTGAATCTGGGAGGTGGAGGTTGCGGTGAGCCAAGATCACGCCATCGTACTCCAGCCTGGGCAACAAGAGCGAAACTCCATCTCAAAACAAAAAAAATGAGCCAGGAGTGGTGGCGGGCGCCTATAATTCCAGCTACTCCAGAGGCTGAGGCAGGAGAATCACTTAAACCCGGGAAGCAGAGGTTGCAGTGAGCTGAGATTGTGCCATTGCACCCCAGCCTAGGTGAAAAGAGCAAAACTCCATCTCAAAAAAAAAAAAAAAAAAAAAAAAAAAGAAAGAAAGAAAGAAAAAGAAAAAAAA","GGCTGGGCGCAGTGGCTCACACCTGTAATCCCAGCACTTAGGGAAGCTGAGGCGAGTAGATCACCTGAGGTCAGGAGTTAGAGACCAGCCTGGCCATCATGGTGAAACCCCGTCTCTACTAAAGATACCAAAAATTAGCTGAGTGTGGTGCTGGGTGCCTGTAATCCCAGAAACTCAGGGTGCCTGTAATCCCAGCAACTCAGGGTGCCTTTAATCCCAGCAACTGAGGGTACCAGTAATCCCAGCAACTCAGGGTGTCTTTAATCCTAGCAACTGAGGGCACCTGTAATCCCAGCAACTCAGGAAGCTGAGACAGGAGAAGTACTTGAACCCAGAAGGCAGAGGTTGCAGTGAGCCGATATTGCACCATTGCACTCCAGTCTGGGCAACAAGAGTGAAACTCTGTCTCAAAAAAAAA"
"chr18","16042035","16042617","JH378118","18053084","18053501","243","2011049","GGCTATGCACGGTGGCTCACGCCTGTAATCCCAGCACTTTGGGAGGCCGAGTCAGGTGGATCACTTGAGGTCAGGAGTTCGAGACCAGCCTGGCCAACATGGTGAAGCCCCATCTCCACTAGAAATACAAAAATTAGTCTGGGAGCAGTGGCTTACACCTGTAATTGCAGCACTTTGGGAGGCCAAGGTGGGTGGATCACCTGAGGTCAGGAGTTTGAGACCAGCATGACCAACATGGTGAAACTCCATCTATACAAAAAAATTAGCCGGGTGTGGTGGCGCATGCCTGTAATCCCAGCTACTCAGGAGACTGAGGCAGGAGAATTGCTTGAACCCGGGAGGCAGAGGTTGCAGTGAGCCAAGTCTGTGCCATTGCACTCCAACCTGGGCAACAAAAGCGAAACTCTGTCTCAAAAATAAACAACAAAAAAAATTAGCCAGGTGTGGTGGCACATGCCTATAATCCCAGCTACTCGGGAGGCTGAGGCAGAAGAATTGCTTGAACCTGGGAGGTGGAGGTTGCAGTGAGCCGAGATCATGCCATTCTACTCCAGCCTGGGCCACAAGAGCGAAACTCTGTCTC","GGCTGGGCGCAGTGGCTCACACCTGTAATCCCAGCACTTAGGGAAGCTGAGGCGAGTAGATCACCTGAGGTCAGGAGTTAGAGACCAGCCTGGCCATCATGGTGAAACCCCGTCTCTACTAAAGATACCAAAAATTAGCTGAGTGTGGTGCTGGGTGCCTGTAATCCCAGAAACTCAGGGTGCCTGTAATCCCAGCAACTCAGGGTGCCTTTAATCCCAGCAACTGAGGGTACCAGTAATCCCAGCAACTCAGGGTGTCTTTAATCCTAGCAACTGAGGGCACCTGTAATCCCAGCAACTCAGGAAGCTGAGACAGGAGAAGTACTTGAACCCAGAAGGCAGAGGTTGCAGTGAGCCGATATTGCACCATTGCACTCCAGTCTGGGCAACAAGAGTGAAACTCTGTCTCAAAAAAAAA"
"chr18","25849088","25849351","JH378114","20445944","20446195","60","5403144","GGGAAGATGAGGCGGGTGGATCACTTGAGGTCAGGAGTTCGAGACCAGCCTGGCCAACATGGTGACACCCTGTCTCCAAAAAATACACACACACACACACACACACACACACACACAAATTAGCTGGGCATGGTGGCGGGCACCTGTAATCCTAGCTACTCGAGAGGCTGCGGCAGGAGAATTGCTTTAACTTGGGAGGTAGAGGTTGCAGAGAGCCGAGATTGCACCATTGTACTCCAGCCTGGGTGACAAGAGCGAAACTCC","TTGGGAGGCCAAGGCGGGTGGATCACCTGAGGTCAGGAGTTCGAGACCAGCCTGGCCAACATGATAAAACCCCCGTATCTAATAAAAATAGGAAAAAAAAATAAATAAATAGCTGGGCGTTGTGGCAGGTGCCTGTAATCCCAGCTACTCGGGAGGCTCAGGCAGGAGAATCGCTTGAACCCAGGAGGCAGAGGTTGCAGTGAGCCAAAATTGTGCCATTGCACTCCCGCCTGGGAAACAAGAGCAAAACTC"
"chr18","38083500","38083832","JH378152","15993594","15993909","55","22089906","GGCTGGGTGCGGTGGCTCACGCCTGTAATCCCAGCACTTTGGGAAGCCAAGTCAGGTGACCTCACCTGAGGTCAGGAGTCCAAGACCAGCCTGACCAACATGGTGAAACCTCGTCTCTACTAAAAAGACAAAAAATTAGCCAGGCATGGTGGTGGGCACCTGTAATCTCAGCTACTCTGGAGGCTGAGGCAGGAGAATCACTTGAACCCTGGAGGGGGAGGTTGCAGTGAACCAAGATTGCACCATTGCAGTCCAGCCTGGGCGACAAGAGCAAAACTCCATCTCACAAACACACACACACACACACACACACACACACACAGAAAAAAAAAA","GGCTGGGTGTGGTGGCTCATGCCGGTAATCCCAGCACTTTGGGAAGCGGAGGCAGGCAGATCACCTGAGGTCAGGAGTTCAAGACCAACCTGGCCAACATGGAGAAACCATGTCTCTACTAAAAATACAAAAAATTAGCCAGGCATGGTGGGTGCCTGTAATCCCCACTACTCGGGAGGCTGAGGCAGGAGAATTTCTTGAACCCAGGAGGTGGAGGTTTCAGTGAAGCGGAGATCACCCCATTGCACTCCAGCCTGGGTGACAAGAGCAAAACTCCATCTCACAAAATCAACAACAACAACTTAAAAAAAAAAAA"
"chr18","44076326","44076933","JH378118","18053084","18053501","257","26023242","GCTGGGCGCGGTGGCTTGCGCCTGTAATCCCAGCCATTTGGGAGGCCGAGGCAGGTGGATCACCTGAGGTTAGGAGTTCAAAACCAGCCTGGCCAACATGGTGAAACCCCGTCTCTACTAAAAATACAAAAATTAGGCCAGGCACAGTGGCTCACGCCTGTCATCCCAGCACTTTGGGAGGCCAAGGCGGGCGGATCATGAGGTCAGGAGATTGAGACCATCCTGGCTAACACAGTGAAACCCTGTCTCTACTAAAAAAATATATAAAAAATTAGCCGGGCTTGGTGGCGGGTGCCCGTAATCCCAGCTACTCGGGAGGCTGAGGCAGGAGAATGGCGTGAACCTGGAAGGCGGAGCTTGCAGTGAGCCGAGATTGCACCACTGCACTCCAGCCTGGGTGACAGAGTGAGACTCTGTCTCAAAAAAAAAAAAAAAACAAAAAACAAAAATTAGTTGGGTGTGGTGGTGGACGCCTGTAATCCCGGCTACTCGGGAGGCTGAGGCAGGAAAATCACTTCAACCCGGGAGGCAGAGGTTGCCGTGAGCCAAGATCGTGCCATTGCACTCCAGCCTGGGTGACAAGAGCAAAACTCTGTCTCAAAAAAAAA","GGCTGGGCGCAGTGGCTCACACCTGTAATCCCAGCACTTAGGGAAGCTGAGGCGAGTAGATCACCTGAGGTCAGGAGTTAGAGACCAGCCTGGCCATCATGGTGAAACCCCGTCTCTACTAAAGATACCAAAAATTAGCTGAGTGTGGTGCTGGGTGCCTGTAATCCCAGAAACTCAGGGTGCCTGTAATCCCAGCAACTCAGGGTGCCTTTAATCCCAGCAACTGAGGGTACCAGTAATCCCAGCAACTCAGGGTGTCTTTAATCCTAGCAACTGAGGGCACCTGTAATCCCAGCAACTCAGGAAGCTGAGACAGGAGAAGTACTTGAACCCAGAAGGCAGAGGTTGCAGTGAGCCGATATTGCACCATTGCACTCCAGTCTGGGCAACAAGAGTGAAACTCTGTCTCAAAAAAAAA"
"chr18","44546829","44547449","JH378118","18053084","18053501","262","26493745","GGCCAGGCACGGTCGCTCACACCTGTAATTCCAGCACTTTGGGAGGCCAAGGCGGATGGGTCACCTGAGGTCAGGAGTTTGAGACCAGCCTGACCAATATGATGAAACCCCATCTCTATTAAAAATACAAAAATTAGGCTGGGCGCAGTGGTTCATGCCTGTAATTCCAACACTTTGGGAGGCCGAGACGGGCGGACCATGAGGTCAGGAGATCGAGACCATCCTGGCCAACGTGGTGAAACCCCGTGTCTACTAAAATACAAAAAAAATTAGCCAGGTGTGGTGGCACGTGCCTGTAGTCCCAGCTATTAGGGAGGCTGAGGCAGGGGAATCACTTGAACCTGGGAGGTGGAGGTTGCAGTGAGCTGAGATCTTGCCACTACACTCCATTCTGGGCAACAGAGCAAGACTCCGTCTGAAAAAAAACAAAAAAATACAAAAATTAGCTGGGCATGGTGGCGGGTACCTGTAATCCCAGCTACTTGGGAGGCTGAGACAGGAGAATCACTTGAACTCGGGAGGCAGAGGTTGCAGTGAGCCAAGATCGCACCATTGCATTCCAGCCTGGGCAACAAGAGCGAAACTCCATCTCAAAAAAACAAAAAAAAAAAAAAAGAAAAA","GGCTGGGCGCAGTGGCTCACACCTGTAATCCCAGCACTTAGGGAAGCTGAGGCGAGTAGATCACCTGAGGTCAGGAGTTAGAGACCAGCCTGGCCATCATGGTGAAACCCCGTCTCTACTAAAGATACCAAAAATTAGCTGAGTGTGGTGCTGGGTGCCTGTAATCCCAGAAACTCAGGGTGCCTGTAATCCCAGCAACTCAGGGTGCCTTTAATCCCAGCAACTGAGGGTACCAGTAATCCCAGCAACTCAGGGTGTCTTTAATCCTAGCAACTGAGGGCACCTGTAATCCCAGCAACTCAGGAAGCTGAGACAGGAGAAGTACTTGAACCCAGAAGGCAGAGGTTGCAGTGAGCCGATATTGCACCATTGCACTCCAGTCTGGGCAACAAGAGTGAAACTCTGTCTCAAAAAAAAA"
"chr18","45772849","45773450","JH378118","18053084","18053501","269","27719765","CACGCCTATAATCCCAGCACTTTAGGAGGCTGAGGCAGGTGGATCACCTGAGATCAGGAGTTCAAAACCAGCCTGGCCAACATGGTGAAACCCTGTGTCTACTACAAATACAAAAAAATGGGCAGGGTGTGGTGGCTCACACCTGTAATCCCAGCACTTAGGGAGGCCGAGGCGGGTGGATCATGAGGTCAAGAGATCAAGACCATCCTGGCCAACATGGTAAAACCCCGCCTCTACTAAAAATATAAAAATTAGCTGGGCAAGGTGGTGCGCGCCTGTAGTCCCAGCTATTTGGGAGGCTGAGGCAGGAGAATTGCTTGAACCTGGGAGGTGGAGGTTGCAGTGAGCCAAAATCGCGCCACTGCACTCCAGCCTGGCAACAGAGTGAGACTCTGTCTCAAAAAAAAACAAAAACAAAACAAAACAGAAACCAAAATTAGCTGGGCGTGGTGGCGGGCGCCTGTAGTCCCAGCTACTTGGGAGGCTGAGGCAGGAGAATCGCATGAACCCAGGAGGCGGAGGTTGCAGTGAGCCAAGACTGCACTATTGCACTCCAGTCTGGGCTACAAGAGCGAACTCCGTCTCAAAAAAAAAAAAAAAAA","GGCTGGGCGCAGTGGCTCACACCTGTAATCCCAGCACTTAGGGAAGCTGAGGCGAGTAGATCACCTGAGGTCAGGAGTTAGAGACCAGCCTGGCCATCATGGTGAAACCCCGTCTCTACTAAAGATACCAAAAATTAGCTGAGTGTGGTGCTGGGTGCCTGTAATCCCAGAAACTCAGGGTGCCTGTAATCCCAGCAACTCAGGGTGCCTTTAATCCCAGCAACTGAGGGTACCAGTAATCCCAGCAACTCAGGGTGTCTTTAATCCTAGCAACTGAGGGCACCTGTAATCCCAGCAACTCAGGAAGCTGAGACAGGAGAAGTACTTGAACCCAGAAGGCAGAGGTTGCAGTGAGCCGATATTGCACCATTGCACTCCAGTCTGGGCAACAAGAGTGAAACTCTGTCTCAAAAAAAAA"
"chr18","50079974","50080314","JH378127","6796468","6796795","54","43283506","GGTCTGGCGCCAGTGGCTCATGCCTGTAATCCCAGCACTTTGGGAGGCTGAGGCGGGTGTATCACCTGAGGTCAGGAGTTCGAGACCAGCCTGGCCAACATGGCAAAACCCCGTCTCTACGAAAAATACAAAAAAATTAGCCGGGCGTGGTAGCAGTCGCCTGTAATCCCAGCAACTTGGGAAGCTGAGGCAGAAGAATCGCTTAAACCTAGGAGGCGGAGGTTGCAGTGAGCCAAGATTGCGCCATTGCACTCCAGCCTGGTCAACAAGAGCAAAACTCTGTCTCAAAACAACAACAACAACAACAACAACAACAAACAAAAACCAAAAAAACCAAAAAA","GGCCGGGCGCGGTGGCTCAAGCCTGTAATCCCAGCATTTTGGGAGGCCGAGGCGGGTGGATCACGAGGTCAGGAAATCGAGACCATCCTGGTCAACATGGCGAAACCCCATGTCTACTAAAAATACAAAAATTAGCTGGGCATGGTGGCACGTGCCTGTAATCCCAGCTACTCAGGAGGCTGAGGCAGGAGAATTGCCTGAACCCAGGAGGCGGAGCTTGCAGTGAGCCGAGATCGCGCCATTGCACTCCAGCCTGGGTAACAAGAGCGAAACTCCGTCTCAAAAAAACAAACAAAAACAAAACAAAACAAAACAAAACAAAAAAAAC"
"chr18","53653883","53654201","AGCE01149660","956","1264","46","53652927","GGCCAGGCATGGTGGCTCACGTTTGTAATCCTAGCACTTTGGGAGGCTGTAGCGGGCGGATCACCTGAGGTCAGGAGTTTGAGACCAGCCTGGCCAACATGGTGAAACCCTGTCTCTACTAAAAAAAAAAAAAAAAAAAAAAAAAAAATTAGCCAGGTGTGGTGGTGGTGGATGCCTATAATCCCAGCTACTCGGGAGGCTGAGGCAGGAGAATCACTTGAACCTGGGAAGCAGAGGTTGCAATGAGCTGAGATTGAGCCATTGCACTCCAGCCTGGACAACAAGAATGAGACTCTGTCTCAATAAATAAGTAAATAAA","GGCCAGGCACGGTGGCTCATGCCTATAATCCCAGCACTTTGGGAGGCTGCGATGGGTGGTTCACTTGAGGTCTGGAGTTTGAGACCAGCCTGGCCAACATGGAGAAACCCTTTCTCTACTAAAAATACAAAAAAAAAAAAAAAAAAAATTAGCCAGGCATGGTGGCGGGTGCCTGTAATCCCAGCTACTCAGCAGGCTGAGGGAAGAGAATCACTTGAACCGGGGAGGCAGAGGTTGCAGTGAGCTGAGATGATGCCATTGCACTCCAGCCTGGGCAACAAGAGCAAAACTGTCTCAAAAAAAAAAAAA"
"chr18","53971096","53971710","JH378118","18053084","18053501","262","35918012","GGTCGGGTGTGGTGGCTCATGCCTATAATCCCAGCACTTTGGGAGGCTGAGGCAGGCAGATTACCTGAGGTCAGGAGTTCGAGACCAGCCTGGCCAACATGATGAAACCTTGTCTCTACTAAAAATACAAAAATTAGGCCGGGCACGGTGGCTCATGCCTGTAATCCCAGCACTTTGGGAGGCCGAGGCGGGTAGATCACAAGGTCAGAAGTTCAAGACCAGCCTGGCCAACATGGTGAAACTCTGTCTTTACTAAAAATACAAAAATTAGCTAGGCATGGTGGCGCACACCTATAATCCCAGCTACTGGGGAGGCTGAGGCAGGAGAATTGCTTGAACCAGGACCCGGGAGGTGGAGGTTGCTGTGAGCCGAGATTGCGCCACTGCACTCCAGCCTGGGAGACAGAGTGAGACTCCGTCTAAAAAAAAAAAAAAAAAATTAGCCAGGTGTGGTGGCGCATGCCTGTAATCCCAGCTACTCGGGAGGCTGACGCAGAAGAATCATTTGAACGTGGGAGGCAGAGGTTACAATGAGCTGAGATCACACCATTGTACTCCAGCCTGGGCAACAAGAGCAAACTCAATCTCAAAAAAATAAAAATAAAAAAAAAGAAA","GGCTGGGCGCAGTGGCTCACACCTGTAATCCCAGCACTTAGGGAAGCTGAGGCGAGTAGATCACCTGAGGTCAGGAGTTAGAGACCAGCCTGGCCATCATGGTGAAACCCCGTCTCTACTAAAGATACCAAAAATTAGCTGAGTGTGGTGCTGGGTGCCTGTAATCCCAGAAACTCAGGGTGCCTGTAATCCCAGCAACTCAGGGTGCCTTTAATCCCAGCAACTGAGGGTACCAGTAATCCCAGCAACTCAGGGTGTCTTTAATCCTAGCAACTGAGGGCACCTGTAATCCCAGCAACTCAGGAAGCTGAGACAGGAGAAGTACTTGAACCCAGAAGGCAGAGGTTGCAGTGAGCCGATATTGCACCATTGCACTCCAGTCTGGGCAACAAGAGTGAAACTCTGTCTCAAAAAAAAA"
"chr18","57837437","57837748","JH378115","16887097","16887400","43","40950340","GCTGGGCATGGTGGCTCACACCTGTAATCCCAGCACCTTGGGAGGCCGAGGTGGGTAGATCACCTGAGGTCAGGAATTCGAGACCAACCTGGCCAACATGGTGAAACCCCGTCTCTACTAAAAATACAAAAAAAAAAAAAAAAAAAAAAAAAGCTGGGCATGGTGGTGGGTACCTGTAATCCCAGCTACTCAGGAGTCCGAGGCAGGAGAATCGCTTGAACCTGGCAGGTGGAGGTTGCAGTGTGCCAGGATTGTGCCATTGCACTCCAGCCTGGGTGACAAGAGCAAAACTCCAACTCAAAACAAAAACAA","GCCGGGCACGGTGGCTCAAGCCTGTAATCCCAGCACTTTGGGAGGCCGAGGCGGGTGGATCACAAGGTCAAGAGATCGAGACCAACCTGGTCAACATGGTGAAACCCCATCTCTACTAAAAAATACAAAAAAAAAAAAAAAATTAGCTGGGCATGGTGGCGCGTGCCTATAATCCCAGCTACTCAGGAGGCTGAGGCAGGAGAATTGCCTGAACCTAGGAGGTGGAGGTTGCAGTGAGCCAAGATCATGCCATTGCACTCCAGCCTGGGTAACAAGAGCGAAACTCCATCTCAAAAAAAAAAAA"
"chr18","58257354","58257943","JH378118","18053084","18053501","263","40204270","GCCTGTAATCACAGCACTTAGGGGGGCCGAGGCAGGAGGATCACCTGAGGTCAGGAGTTCGAGACCAGCCTGGCCAACATGGTGAAACCCCGTCCCTACTAAAAATACAAAAATTGGCCGGACACATTGGCTCATGCCTGTAATCCCAGCACTTTGGGAGGCCGAGGCGGGTGGATCACCTGAGGTCAGGAGTTCAAGACCAGCCTGACCAACCTGGAGAAACCCTGTTTCTACTAAAAATACAAAATTAGCCAGGCATAGTGGCGCATGCCTGTAATCCCAGCTACTCGAGAGGCTGAGGCAGGAGAATCGCTTGAACCCGGAAGGTGGAGGTTGCGGTGAACCGAGATTGTGCCATTGCACTCCAGCCTGGGCAACAAGAGCAAAACTCCGTCTCAAAAACAAAACAAAACAAAACAAAAATTAACCCGGCGTGGAGGTGGATGCCTGTAATCCCAGCCACTTTGGGAGACTGAGGCAAGAGAATTGCTTGAACCCGGGATGTGGAGGCTGCAGTGACCCGAGATCACGCCATTGCATTCCAGCCTGGCAACAAGAGTAAGACTCCATCTCAAAAACAAGCAAACAAA","GGCTGGGCGCAGTGGCTCACACCTGTAATCCCAGCACTTAGGGAAGCTGAGGCGAGTAGATCACCTGAGGTCAGGAGTTAGAGACCAGCCTGGCCATCATGGTGAAACCCCGTCTCTACTAAAGATACCAAAAATTAGCTGAGTGTGGTGCTGGGTGCCTGTAATCCCAGAAACTCAGGGTGCCTGTAATCCCAGCAACTCAGGGTGCCTTTAATCCCAGCAACTGAGGGTACCAGTAATCCCAGCAACTCAGGGTGTCTTTAATCCTAGCAACTGAGGGCACCTGTAATCCCAGCAACTCAGGAAGCTGAGACAGGAGAAGTACTTGAACCCAGAAGGCAGAGGTTGCAGTGAGCCGATATTGCACCATTGCACTCCAGTCTGGGCAACAAGAGTGAAACTCTGTCTCAAAAAAAAA"
"chr18","59255477","59255805","JH378228","5665092","5665424","52","53590385","GGTTGGGCGCAGTGGCTCACGCCTGTAACCCCAGCACTTTCGGAAGCTGAGGCAGGCGGATCACCTGAGGTCAGGGGTTCGAGACCAGCCCGGACAACGTGATTAAACCCTGCCTCTACTAAAAATACAAAAATTAGCGACTGTGGTGTTGGGCGCCTGTAATCGCAGCTACTTGGGAGGCTGAGGCATGAGAATTGCTTGAACCCAGGAGGCAGAGGTTGCAGTGAGCAGAGATTGCTCCATTGCACTCCAGCCTGGGCAACAAGAGCAGAACTCTGTCTCAAAATAAATAAATAAATAAATAAATAAATAAATAACAGAAAAGAAAA","GGCCGGGCGCGGTGGCTCAAGCCTGTAATCCCAGCACTTTGGGAGGCTGAGGCGGGTGGATCACGAGGTCAAGAGATCGAGACCATCCTGGTCAACATGGTGAAACCCTGTCTCTACTAAAAATACTAAAAATTAGCTGGGCATGGTGGCGTGTGCCTGTAATCCCAGCTACTCAGGAGGCTGAGGCAGGAGAATTGCCTGAACCCAGGAGGCGGAGGTTGCGGTGAGCCGAGATCGCGCCATTGCACTCCAGCCTGGGCAACAAGAGCGAAACTCTGTCTCAAAAAAAAAAAATAAATAAATAAAATAAAATAAAATAAAATAAAATAAAAT"
"chr18","59405673","59406877","JH378118","18053084","18053501","805","41352589","GGCTAGATGCGGTGGCTCATGCCTGTAATCCCAGCACTTTGGGAGGCCAAGGCAGGTGGATCACCTGAGGTCAGGAGTTTGACACCAGCCTGGCCAACATGTTGAAACCCTGTCTCCACTAAAAATACAAAAAAAGATTATCTGGGTTATTGTGGGATCTGGCCAGCAGCCCGCAATGCAATGGGGCTCTCTCTTTGTTCCCAGGCAGATTGGCAGGTTGAGAAATAATAGACACACACAAGATAGTGAAAGTTGGGTCCAGGGGGGTCACCGCCTTCTGGTCCCATGGTGCCAACAATGCACTGGATATACCAGCATTTATTATTAAGTTTAGTGAGGGCGGGGGTAGGTTAGTGAGGGATTTAGGGTCATTTGATTATGAGGTGAGATGGTCACATGGAAATGAAGTAATTCTTTAACGTAACATTTGTATGTAGAAGTACAGTACATTTGTATGTAGAAGTACAGTATACAGAGATAAGAATTTACAATATAGTGTGTGCATCAGTAATTTCTAACAGAGCCTTAAAACAGAAAGACAATCTTTCCATAATCTATGATTAGCAAGATATTAATCAGCAGTAACAATTGCAATGAAAGCTGGTTACAAACAGTCCATGGAAACAGGAGGTGAAGCTAGACAATCGGTTAGACCAGAAATTCTCAGAAGGGAATATGCCTTAACCCTAAAGAGGCCTAGAAGAGCCGTGGCAAGATGAGGGTGTTTATAGCCCTATCTTATCCATATGGACAGGCACCTCCCCATGCGTCCGTTTATAGGCTCTCCATGAGGGTCGCATTCCATTCCCAGAGCTATGAACATCTGCTTTTCTGGGATAGGAATCTTGGTGATGTGAAACCTCCCTGACTACACGTCCATTCATAGGATCTCTGCAGGGGGAAGCACATCACACACTGTTGGCTCGTTCTGGCAGTCCAACCTGGCATTGTGTCTTTACACAATCCTGCATGCAATTTTGTATTTACAATAATCAGGAGCATTTCATCTTTTATTCTGTAGCAATAGTTTCAGGGGGTCTCCCTACACTGGGTGTGGTGACGGGTACCTGTAATCCCAGCTACTCAGGAGGCTGAGGCAGGAGAATCACTTGAGCCTTAGAGGCAGAGGTTGCAGTGAGCTGAGATCAGACCATTGCACTCCAGCCTGGGCAACAAGAGCAAACCTCCGTCTCAAAAAAAAAAAA","GGCTGGGCGCAGTGGCTCACACCTGTAATCCCAGCACTTAGGGAAGCTGAGGCGAGTAGATCACCTGAGGTCAGGAGTTAGAGACCAGCCTGGCCATCATGGTGAAACCCCGTCTCTACTAAAGATACCAAAAATTAGCTGAGTGTGGTGCTGGGTGCCTGTAATCCCAGAAACTCAGGGTGCCTGTAATCCCAGCAACTCAGGGTGCCTTTAATCCCAGCAACTGAGGGTACCAGTAATCCCAGCAACTCAGGGTGTCTTTAATCCTAGCAACTGAGGGCACCTGTAATCCCAGCAACTCAGGAAGCTGAGACAGGAGAAGTACTTGAACCCAGAAGGCAGAGGTTGCAGTGAGCCGATATTGCACCATTGCACTCCAGTCTGGGCAACAAGAGTGAAACTCTGTCTCAAAAAAAAA"
"chr18","71500430","71500770","JH378228","5665092","5665424","54","65835338","GCTGGGTGCGGTGGCTCACGCCTGTAATCACAGCACTTTGGTAAGCCCGAGGCAGGTGGATCACCTGAGGTCAGGAGTTCGAGACCAGCCTGACCAACATGGTGAAACCCTTTCTCTACTAAAAATGCAAAAATTAGCTGGGCGTCATGGCGGGCGTCTGTGATCCCAGCTACTAGGGAGGCTAAGGCAGGAGAATTGCTTGAACCTGGGAGGCGGAGGTTGCAGTGAGCAGAGATTGCACCATTACACTCCAGCCTGGGCAACAAGAGCAAAACTCCATCTCAAAATAAATAAATAACTAAATAAATAAATAAAATGAAATTAAAAAGAAAGAAAGAAAA","GGCCGGGCGCGGTGGCTCAAGCCTGTAATCCCAGCACTTTGGGAGGCTGAGGCGGGTGGATCACGAGGTCAAGAGATCGAGACCATCCTGGTCAACATGGTGAAACCCTGTCTCTACTAAAAATACTAAAAATTAGCTGGGCATGGTGGCGTGTGCCTGTAATCCCAGCTACTCAGGAGGCTGAGGCAGGAGAATTGCCTGAACCCAGGAGGCGGAGGTTGCGGTGAGCCGAGATCGCGCCATTGCACTCCAGCCTGGGCAACAAGAGCGAAACTCTGTCTCAAAAAAAAAAAATAAATAAATAAAATAAAATAAAATAAAATAAAATAAAAT"
"chr19","1465612","1466244","JH378118","18053084","18053501","284","16587472","GGCTGGGGACGGTGGCTCAGGCCTGTAACCCCAGCACTTTGAGAGGACCAGGAGGGAGGATTGCTTGAGCCCAGGAGTCCGAGACCAGCCTGGGCAGCAAAGCAAGGCCCTGTCTCTACAAAAATACTTTAAAATTAGCCAAGTGTTGGCTGGGTGCGGTTGCTCATGCCTATAATCCCAGCACTTTGGGAGGCCGAGGTGGGTGGATCACCTGAGGTCAGGAGTTTGAGACCAGCCTGGCCAACATGGCAAAACCCCGTCTCTACTAAAAATACGAAAATTAGCCAGACGTGGTGGCTCATTCCTGTAATCCCAGCTACTCGGGAGGCTGAGGCAGGAGAATCGCTTGAACTCGCAAGGCGGAGGTTGCAGTGAGCCAAGATCATGCCATTGCATTCCAGCCTGGGTGACAGAGCAAAACTCCGTCTCAAAAAAAAAAAAAAAAAAAAAAAATTAGCCAGGCGTGGTGGTGGGCACCTGTAGTCCCAGCTACCCGGGAGGCTGAGGCAGGAGAATCGCTTGAGCCCGGGAGGCAGAGGTTACAGTGAGCCGAGATCGTGCCATTGCACTCCAGCCTGGGCAACAAGAGTGAAAATCCGTCTCAAAAAAATAAATAAATACAAAATAAAAAAA","GGCTGGGCGCAGTGGCTCACACCTGTAATCCCAGCACTTAGGGAAGCTGAGGCGAGTAGATCACCTGAGGTCAGGAGTTAGAGACCAGCCTGGCCATCATGGTGAAACCCCGTCTCTACTAAAGATACCAAAAATTAGCTGAGTGTGGTGCTGGGTGCCTGTAATCCCAGAAACTCAGGGTGCCTGTAATCCCAGCAACTCAGGGTGCCTTTAATCCCAGCAACTGAGGGTACCAGTAATCCCAGCAACTCAGGGTGTCTTTAATCCTAGCAACTGAGGGCACCTGTAATCCCAGCAACTCAGGAAGCTGAGACAGGAGAAGTACTTGAACCCAGAAGGCAGAGGTTGCAGTGAGCCGATATTGCACCATTGCACTCCAGTCTGGGCAACAAGAGTGAAACTCTGTCTCAAAAAAAAA"
"chr19","1761610","1762212","JH378118","18053084","18053501","248","16291474","GGCCGGGTGCGGTGGTTTACACCTGTAATCCTGGCATTTTGGGAGGCCGAGGCAGGAGTATCACCTCAGGTCAGGAGTTCAAGACCAGCCTGGCCAACATGGTGATACTCCGTCTCTACTAAAAATACAAAAATTGGCCGAGTGCAGTGGCTCACACCTGTAATCCCAGCACTTTGGGAGGCCGAGGCAGGTGGATCATGAGGTCAGGAGTTCGAGACCAGCCTGGCCAAGATGGTGAAACCCCGTCTCTACTAAAAATACAAAAATCAGCTGGGTGTGGTGGCGGGTGCCTGTAATCCCAGCTACTCGGGAGGCTGAGGCAGGAGAATTGCTTGGACCTGGGCAGCAGAGGTTGCAGCGAGCTGAGATGGCGCCACTGCACTCCAGCCTGGGCGACAGAGCGAGACTCTTGTCTCAGAAAAATAAAAAATAAAAAAATTAGCTGGGTGTGGTGGTGCGCACCTGTAATCCCAGCTACTCGGGAGGCTGAGGCAGGAGAATCGCTTGAATCTGGGAGGAGGAGGAGGTTGCAGTGAGCTGAGATAGTGCCAGTGCAGGCCAGCCTGGTCAACAAGAGTGAAACTCCGTCTCAGAAAAAAAAAA","GGCTGGGCGCAGTGGCTCACACCTGTAATCCCAGCACTTAGGGAAGCTGAGGCGAGTAGATCACCTGAGGTCAGGAGTTAGAGACCAGCCTGGCCATCATGGTGAAACCCCGTCTCTACTAAAGATACCAAAAATTAGCTGAGTGTGGTGCTGGGTGCCTGTAATCCCAGAAACTCAGGGTGCCTGTAATCCCAGCAACTCAGGGTGCCTTTAATCCCAGCAACTGAGGGTACCAGTAATCCCAGCAACTCAGGGTGTCTTTAATCCTAGCAACTGAGGGCACCTGTAATCCCAGCAACTCAGGAAGCTGAGACAGGAGAAGTACTTGAACCCAGAAGGCAGAGGTTGCAGTGAGCCGATATTGCACCATTGCACTCCAGTCTGGGCAACAAGAGTGAAACTCTGTCTCAAAAAAAAA"
"chr19","2871458","2872098","JH378118","18053084","18053501","282","15181626","GGCCGGGCGCGGTGGCTCACGCTTGTAATCCCAGCACTTTGGGAGGCCTAGGTAGTGGATCACCTGAGGTCAGGAGTTTGAGACCAGCCTGGCCAACATGGGGAAACCCAGTCTCTACTAAAAATACAAAAATGAGGCCGGGTGCAGTGGCTCATGCCTGTAGTCTCAACACTTTGGGAGACCAAGGCAGGCGGATCACCTGAGGTCAGGAGTTCAAGCCCAACCTGGCCAACATGGTGAAACCCTGCCTCTTCTAAAAATACAAAAATTAGCCAGGTGTGGTGGCATGTACCTGCAATCCCAGCTGCTTAGGAGTTCGAGATAGAAGGATTGCCTGAACCTGGGAGGCGGAGGTTGCAGTGAGCTGAGATCATGCCATTGCACTCCAGCCTGGGTGACAGAGACCCTGTCTCACACACACACACACAAATTATATATATATATATATATATACACACACACACACACGCACACACAAATTGGCCAGGCGTGGTGGCGGGTGCCTATAATTCCAGCTACTTGGGAGGCTGAGGCAGGAGAATGTCTTGAACCCGGGAGGTGGAGGTTGCAGTGAGCCGAGATTGCGCCACTGCACTTTAGCCTGGACGACAAGAACAAAACTCCATCTCAAAAAAACGAAA","GGCTGGGCGCAGTGGCTCACACCTGTAATCCCAGCACTTAGGGAAGCTGAGGCGAGTAGATCACCTGAGGTCAGGAGTTAGAGACCAGCCTGGCCATCATGGTGAAACCCCGTCTCTACTAAAGATACCAAAAATTAGCTGAGTGTGGTGCTGGGTGCCTGTAATCCCAGAAACTCAGGGTGCCTGTAATCCCAGCAACTCAGGGTGCCTTTAATCCCAGCAACTGAGGGTACCAGTAATCCCAGCAACTCAGGGTGTCTTTAATCCTAGCAACTGAGGGCACCTGTAATCCCAGCAACTCAGGAAGCTGAGACAGGAGAAGTACTTGAACCCAGAAGGCAGAGGTTGCAGTGAGCCGATATTGCACCATTGCACTCCAGTCTGGGCAACAAGAGTGAAACTCTGTCTCAAAAAAAAA"
"chr19","2912949","2913566","JH378118","18053084","18053501","268","15140135","GGCTGGGCGTGGTGGCTCACACCTGTAATCCCAGCACTTTGGGAGGCCAAGGTGGAGGGACTGCCTGAAGCCAGGGGTTCGAGACCAGCCTGGCCAACATGGTGAAACCCTGTCTCTACTAAAAATAGAAAAATTAAGGCCGGGCGCGGTGGCTCATGCCTGTAATCCCAGCACTTTGGAAGGCCGAGGCGGGCGGATCACTTGAGGTCGGGAGTTCAAGACCAGCCTGACCAACATGGAGAAACCCTGTCTCTACTAAAAATACAAAATTAGCCAGGGTGGTGGCGCATGCCTGTAATCCCAGCTACTTGGGAGGCTGAGGCAGGAGAATCGCTTGAACCCGGGAGGTGGAGGTTGCAGTGAGCTGAGATCGCACCATTGCACTCCAGCCTGGGCAACAAGAGCAAAACCACGTCTCAAAAAAAATAAAAATAAAAATAAAAAAATTAGCTGGGTGTGGTGGCAGGCGCCTGTAGCTGCTTGGGAGGCTGAGACAGGAGAATTGCTTGAACCTGGGAGGCGGAGGTTGCAGTGAGCTGAGACCGTGCCATTGCACTCCAGGCTGGGCAAGAAGAGCAAAACTCTATCCTTCCCCCACTCCAAAAAAAAAAAAAAAAA","GGCTGGGCGCAGTGGCTCACACCTGTAATCCCAGCACTTAGGGAAGCTGAGGCGAGTAGATCACCTGAGGTCAGGAGTTAGAGACCAGCCTGGCCATCATGGTGAAACCCCGTCTCTACTAAAGATACCAAAAATTAGCTGAGTGTGGTGCTGGGTGCCTGTAATCCCAGAAACTCAGGGTGCCTGTAATCCCAGCAACTCAGGGTGCCTTTAATCCCAGCAACTGAGGGTACCAGTAATCCCAGCAACTCAGGGTGTCTTTAATCCTAGCAACTGAGGGCACCTGTAATCCCAGCAACTCAGGAAGCTGAGACAGGAGAAGTACTTGAACCCAGAAGGCAGAGGTTGCAGTGAGCCGATATTGCACCATTGCACTCCAGTCTGGGCAACAAGAGTGAAACTCTGTCTCAAAAAAAAA"
"chr19","3601333","3601668","JH378148","10302642","10302970","47","6701309","GCTGGGCGTGGTGGCTCACACCTGTAATCCCAGCACTTTGGGAGGCTGAGGTGGGCGGATCACGTGAGGTCAGGAGTTCCAGACTAGCCTGGCCAACATGGGGAAACCCCATCTCTGCTAAAAATAAAAAATTTAGCCGAGTGTGGTGGTGGGTGCCTGTAATCCCAGCTACTCAGGAGGCCGAGGCAGGAGAATTGCTTGAACCCAGGAGGCAGAGGTTGCAGTGAGCCGAGATCACGCCATTGCACTCCAGCCTGGATGACAACAGTGAGACTCCAACTCAAAAAATAATAATAATAATAATAATAATAATAAAATAAAACAATAAAAAAAAAA","GGCCGGGCGCGGTGGCTCAAGCCTGTAATCCCAGCACTTTGGGAGGCCGAGGCGGGTGGATCACGAGGTCAAGAGATCGAGACCATCCTGGTCAACATGGTGAAACCCCGTCTCTACTAAAAATACAAAAAATTAGCTGGGCATGGTGGTGGGTGCCTGTAATCCCAGCTACTCAGGAGGCTGAGGCAGGAGAATTGCCTGAACCCAGGAGGCGGAGGTTGCGGTGAGCCGAGATCGCGCCATTGCACTCCAGCCTGGGTAACAAGAGTGAAACTCTGCCTCAAAAAAAAAAAATAAAATAAAATAAAATAAAATAAAATAAAATAAAA"
"chr19","4440800","4441421","JH378118","18053084","18053501","276","13612284","GGCTGGGTGCGGTGGCTCATGCCTGTAATCCCAGCACTTTGGGAGGCCAAGCGGGCAGATCAACTGAGGTCAGGAGTTCGAGACCAGCCTGGCCAACATAGTAAAACCCTGTTTCTACTAAAAAAAAAAAAAAAAAAAAAAAAAAAATTGGCTGGGCGCAGTGGCTCACGCATGTAATCCCTGCACTTTGGGAGGCCAAGGCAGGTGGATCACCTGAGGTCAGTAGTTTGAGACCAGCCTGACCAACGTGGAGAAACCCCATCTCTACTAAAAATACAAACAAAAAAAACAAAAAACAAAAAAAACCGGGTATGGTGGTACATCCCTGTAATCCCAGCTCCTCGGGAGGCTGAGGCAGGAGAATCACTTGAACCCGGGAGGCGGAGGTTGCACTGAGCCGAGATTGCGCCACTGCACTCCAGCCTGGGCGATAGAGCGAGACTCCCTCTTAAATAATGATTATAATTGCCAGGTGTGGTGGCGGGTGCCTGTAATCCCAGCTACTTGGGAGGCTGAGGCAGGAGAATCGTTTGAATCCAGGAGGAGGAGGTTGCAGTGAGCCGAGATGGTGCCACAGCACTCCAGCCTGGGTGACAAGAGTGAAACCCCATTACAAACAAAA","GGCTGGGCGCAGTGGCTCACACCTGTAATCCCAGCACTTAGGGAAGCTGAGGCGAGTAGATCACCTGAGGTCAGGAGTTAGAGACCAGCCTGGCCATCATGGTGAAACCCCGTCTCTACTAAAGATACCAAAAATTAGCTGAGTGTGGTGCTGGGTGCCTGTAATCCCAGAAACTCAGGGTGCCTGTAATCCCAGCAACTCAGGGTGCCTTTAATCCCAGCAACTGAGGGTACCAGTAATCCCAGCAACTCAGGGTGTCTTTAATCCTAGCAACTGAGGGCACCTGTAATCCCAGCAACTCAGGAAGCTGAGACAGGAGAAGTACTTGAACCCAGAAGGCAGAGGTTGCAGTGAGCCGATATTGCACCATTGCACTCCAGTCTGGGCAACAAGAGTGAAACTCTGTCTCAAAAAAAAA"
"chr19","5462237","5462567","JH378255","1377129","1377437","56","4085108","GACCAGGTGCGGTGGCTCACGCCTGTCATTCCAGCACTTTGGGAGGCCGAGGGGGGCGTGGATCACTTGAGGTCAGGAGTTCAAGACCAGCCTGACCAACATGGTGAAACTCCGTCTCTACTAAAAATACAAAAATTAGCCAGGTGTGGTGGCACATGCCTGTAATCCCAGCTACTTGGGAGGCTGAGGCAGGAGAATCACTTGAACCTGGGAGATGGAGGTTTCATTCAGTGAGCTGAGATTGCACCATTGCACTCCAGCCTGGGTGACAAGAACGAAACTCTGTCTCAGAACACACACACACACACACACACACACACCCCAGAAAAAA","GGCCTGGCGTGGTGGCTCACGCCTGTAATCTCAGCACTTTGGGAGGCCAAGGTGGGTGGATCACCTGAGGTCAGGAGTTCAAGACCAGCCTGGCCAACATGGTGAAACCCCGTCTCTACTAAAAATACAAAAATTAGCTGGGTGTGGTGGCAGACACCTGTAATTCCAGCTACTTGGGAGGCTGAGGCAGGAGAATAGCTTGAACCTGGGAGGTGAGGGTTGCAGTGAGCCGAGATCGCACCATTTTACTCCAACCTGGGCAACAAGAGCGAAACTCCGTCTCAAAATCCAAACAAACCAAAACAAAAA"
"chr19","8011731","8012413","JH378118","18053084","18053501","321","10041353","GGCCGGGTACAGTGGCTCACTCCTGTAATCCCAGAACTTTGGGAGACCGAGGTGGGGGGATCACTTGAGGTCAGGAGTTCGAGACCACCCTGGCCAATATAGTGCTAAACCCCATCTCTACTCAAAATACAAAAAAAAAAAAAAAAAAAAAAAAAAAGCAAAACCCAGGCTGGGCACAGTAGCTCATACCTGTAATCCCAGCACTTTGGGAGGCTGAGGTGGGTAGATCATGAGGTCAGGAGTTCGAGACCAGCCTGACCAACATGGTGAAACCCCGTCTCTACTAAAAATACAAAAATTAGCCGGGCATGGTGGTGCGTGCCTGTAATCCCAGCTACTCAGGAGGCTGAGGCAGGAGAATCGCTTGAAGCTGGGAGGCAGAGGTTGCAGTGAGCCGAGATCGTGCTACTGTACTCCAGCCTGGGCAACAGGGCGACAGAGCAAGACTCTGTCTCAAAAAAAAAAAAAAAAAAAAAAAAAAGCAAAACCCCATCTCTACTAAAAATACAAAAAATTAGCCAGGCATGGTGGCATGTGCCTGTAATCCCAGCTACTCGAGAGGCTGAGGCAGAAGAATCACTTGAACCCAGGAGGCAGAGGTTGCAGCGAGCCAAGATTGTGCCATTGCACTCCAATCTGGGTGACAAGAGTAAAATCCTGTCTCAAAAAAATAAAAAATAAAA","GGCTGGGCGCAGTGGCTCACACCTGTAATCCCAGCACTTAGGGAAGCTGAGGCGAGTAGATCACCTGAGGTCAGGAGTTAGAGACCAGCCTGGCCATCATGGTGAAACCCCGTCTCTACTAAAGATACCAAAAATTAGCTGAGTGTGGTGCTGGGTGCCTGTAATCCCAGAAACTCAGGGTGCCTGTAATCCCAGCAACTCAGGGTGCCTTTAATCCCAGCAACTGAGGGTACCAGTAATCCCAGCAACTCAGGGTGTCTTTAATCCTAGCAACTGAGGGCACCTGTAATCCCAGCAACTCAGGAAGCTGAGACAGGAGAAGTACTTGAACCCAGAAGGCAGAGGTTGCAGTGAGCCGATATTGCACCATTGCACTCCAGTCTGGGCAACAAGAGTGAAACTCTGTCTCAAAAAAAAA"
"chr19","8026835","8027736","JH378118","18053084","18053501","522","10026249","GCGCGGTGGCTCATGCCTGTAAACCCAGCACTTTGGGAGGCTGAGGTGGGTGGATCACCTGAGGTCAGGAGTTTGAGACCAGCCTGGCCAATATGGTGAAACCCGTCTCTACTAAAACATACAAAAATTAGGCTGGGCGCGGTGGCTCATGCCTTTAATCCCAACACTTTGGGAGGCCGAGGCGGGCGGATCACGAGGTCAGGAGTTTGAGACCATCCTGGCTAACATGGTGAAAGCCCGTCTCTACTAAAAATATAAAAATTAGCTGGGCGTGGTGGTGGGCACCTGGAGTCCCAGCTACTTGGGAGGCTGAGGCAGGAGAATGGCGTGAACCCGGGAGGCGGAGCTTGCAGTGAGCCAGGATCACGCCACTGCACTCCAGCCTGGGCGACAGAGCGAGACACCGTCTCAAAAAAAAAACAACAAAAATTAGCCAGGCATGGTGGTGGGCGCCTTTTTTTTTTTTTTTTTCAGAGTCTCACTCTGTCACCCAGGCTGGAGTGCAGTGGCTCAATCTCGGTTCACTGCAACCTCCGCCTCCCAGGTTCAAGCGATTCTCCTGCCTCAGCCTCCCGAATAACTGGGATTACAGGCACCCGCCACTACAACCAGCTAATTTTTGTATTTTTAGTAGAGATGGGGTTTCGCCATGTTGGCCAGGATGGTCTTGATCTCTTGACCTCGTGATCCACCCTCCTTGGCCTCTCAAAGTGCTGGGATTACAGGTGTGAGCCACTGTTCCCAGCTGATAGTGGGCACTTTTAATCCCAGCTACTCCGGAGGCTGAGGCAGGAGAATTGCTTGAACCCAGGAGGTGGAGGTTGCAGTGAGCCAAGATCGCGCCATTGCACTCCAGCCTGGGTGACAATAGCAAAACTCTGTCTCAATGAAACAAAACAAAA","GGCTGGGCGCAGTGGCTCACACCTGTAATCCCAGCACTTAGGGAAGCTGAGGCGAGTAGATCACCTGAGGTCAGGAGTTAGAGACCAGCCTGGCCATCATGGTGAAACCCCGTCTCTACTAAAGATACCAAAAATTAGCTGAGTGTGGTGCTGGGTGCCTGTAATCCCAGAAACTCAGGGTGCCTGTAATCCCAGCAACTCAGGGTGCCTTTAATCCCAGCAACTGAGGGTACCAGTAATCCCAGCAACTCAGGGTGTCTTTAATCCTAGCAACTGAGGGCACCTGTAATCCCAGCAACTCAGGAAGCTGAGACAGGAGAAGTACTTGAACCCAGAAGGCAGAGGTTGCAGTGAGCCGATATTGCACCATTGCACTCCAGTCTGGGCAACAAGAGTGAAACTCTGTCTCAAAAAAAAA"
"chr19","9069244","9069863","JH378118","18053084","18053501","266","8983840","GGCCGGGCACGGTGGCTCATTCCTGTAGTCTCTGTACTTTAGGAGGCTGAGGTGGGTGGATCACTTGAGGTCAGGAGTTCCAGACCAGTCTGGCCAAAATGGTGAAACCCCGTCTGTACTAAAAATACAAAAAAAAAGGCCGGGCGCGGTGGCTCACGCCTGTAATCCCAGCACTTTGGGAGGCTGAGGTGGGTGGATCACAAGGTCAGGAGATTGAGACCATCCTGGCTAACATGGTGAAACCCCGTCTCTACTAAAAATACAAAAAATTAGCTGAGTGTGGTAGCAGGCACCTGTAATCCCAGCTACTCAGGAGGCTGAGGTGGGAGAATGGCATGAACCCAGGAAGCAGAGCTTGCAGTGAGCTGAGATCATGCCACTGCACTCCAGCCTGGGTGACAGAGCGAGACTCCATCTCAAAAAAAAAAAATACAAAAAAATTAGCCAGGCGTAGTGGTGCATGCTTGTAGTCTCGGCTACTCAGGAGACTGACGCAGGAGAATCACTTGAACCCAGGAGGCGGAGGTTGCAGTGAGCCGAAATTATGCCATTGCACTCCAGCCTGGGAGACAAGAACAAAACTCTATCTCAAAAACCAACCAACCAAACAAACAAAAAAA","GGCTGGGCGCAGTGGCTCACACCTGTAATCCCAGCACTTAGGGAAGCTGAGGCGAGTAGATCACCTGAGGTCAGGAGTTAGAGACCAGCCTGGCCATCATGGTGAAACCCCGTCTCTACTAAAGATACCAAAAATTAGCTGAGTGTGGTGCTGGGTGCCTGTAATCCCAGAAACTCAGGGTGCCTGTAATCCCAGCAACTCAGGGTGCCTTTAATCCCAGCAACTGAGGGTACCAGTAATCCCAGCAACTCAGGGTGTCTTTAATCCTAGCAACTGAGGGCACCTGTAATCCCAGCAACTCAGGAAGCTGAGACAGGAGAAGTACTTGAACCCAGAAGGCAGAGGTTGCAGTGAGCCGATATTGCACCATTGCACTCCAGTCTGGGCAACAAGAGTGAAACTCTGTCTCAAAAAAAAA"
"chr19","9785992","9786608","JH378118","18053084","18053501","261","8267092","GGCCGGGAACGGTGGCTCACACCTATAATCCCAGCACTTTGGGAGGCCGAGGCAGGTGGATCACCTGAGGTCAGGAGTTCAAGACCAGCGTGGCCAACATAATGAAACCCCATCTTGGCCGGGTGCGGTGACTCACGCCTGTAATCCCAGCACTTTGGGAGGCCAAGGCGGGTGGATCACGAGGTCAGGGGATCGAGACCATCCTGGCTAACACAGTGAAACCCTGTCTCTACTAAAAATACAAAAAAATTAGCTGGGCATGGTGGCGGACGCCTGTAGTCCCAGCTACTCGGGAGGCTGAGGCAGGAGAATGGTGTGAACCTGGGAGGCAGAGCTTGCAGTGAGCCGAGATTGCGCCACTGCACTCCAGCTTGGGTGACAAAGTGAGACTCCATCTCAAAAAAAAAAAAAGAAACCCCATCTCTACTAAAAATACAAAAAATTTGCTGGGTGTGGTTGTGGGCACCTGTAATCCCAGCTACTTGGGAGGCTGAGGCAGGAGAATCACCTGAACCCAGGAGGCAGAGGTTGCAGTGAGCCGAAACAGTGCCATTGCACTCCAGCCTGGGCAACAAGAGTGAAACTCAATCTCAAAAAAAAAAAAAAAAGTACAAAAA","GGCTGGGCGCAGTGGCTCACACCTGTAATCCCAGCACTTAGGGAAGCTGAGGCGAGTAGATCACCTGAGGTCAGGAGTTAGAGACCAGCCTGGCCATCATGGTGAAACCCCGTCTCTACTAAAGATACCAAAAATTAGCTGAGTGTGGTGCTGGGTGCCTGTAATCCCAGAAACTCAGGGTGCCTGTAATCCCAGCAACTCAGGGTGCCTTTAATCCCAGCAACTGAGGGTACCAGTAATCCCAGCAACTCAGGGTGTCTTTAATCCTAGCAACTGAGGGCACCTGTAATCCCAGCAACTCAGGAAGCTGAGACAGGAGAAGTACTTGAACCCAGAAGGCAGAGGTTGCAGTGAGCCGATATTGCACCATTGCACTCCAGTCTGGGCAACAAGAGTGAAACTCTGTCTCAAAAAAAAA"
"chr19","9897689","9898264","JH378206","6546474","6546861","233","3351215","GCCAGGCACGGTGGCTCACACCTGTAATCCCAGCACTTTGGGAGGCCAAGGTGGGTGGATCACCTGAGGTCAGGAGTTCAAGACCAGCCTGACCAACATGGTGAAACCCAGGGCTCACACCTGTAATCCCAGCGCTTTGGGAGGCTGACGCGGGCAGATCACGAGGTCAGGAGATCGAGACCATCCTGGCTAACATGGTGAAACCCCGTCTCTACTAAAAATACAATAATTAGCTGGGCATGGTGGTGGGTGCCTGCAGTCCCAGCTACTTGGGAAGCTGAGGCAGGAGAATGGCGTGAACCCAGGAGGTGGAGCTCTCAGTGAGCTGAGATTGCATCACTGCACTTCCAGCCTGGGTGACAGAGCAAGACTCTGTCTCAAAAAAAAAAAAAAAAAAAAAAAAAATTAGCCAGGTGTGATGGCAGGCACCTGTAATCCCAGCTACTTAGGAGGCTGAGGCAGGAGAACCCAGGAGGCAGAGGTTGCAGTGAGCCAAGATCGCGCCATTGCACTCCAGCCTGGGTGACAAGAGCAAAATTCCATCTCAAAAAAAAAAAAAAAGAAGAAAAAGAAGAA","GGCCACACATGGTGGCTAACGCCTGTAATCCCAGCACTTTGGGAGGCCAAGTCGGGTGGATCATGAGGTCAGGAGACCAAGACCATCCTGGCCAAATGGTGAAACCCCGTCTCTACTAAAAATACAAAAATTAGCTGGGCATGGTGGCGTGTGCCTGTAATCCCAGCTACTCAGGAGGCTGAGGCAGGACAATTGCCTGAACCCAGGAGAATTAGCTGGGCATGGTGGCGTGTGCCTGTAATCCCAGCTACTCAGGAGGCTGAGGCAGGACAATTGCCTGAACCCAGGAGGCGAAGGTTGCGGTGAGCCGAGATTGTGCCATTGCACTCCAGCCTGGGTAACAAGAGCGACACTCTGTCTCAAAAAAAAAAAAAAAAAAAAAAAAAAA"
"chr19","10210761","10211695","JH378118","18053084","18053501","553","7842323","GGCCGGGTGTGGTGGCTCATGCCTGTAATCCCAGGCATGATTTGGGAGGCCGAGGGAGGCAGATCACCTGAGGTCAGGAGTTTTTTTGTTTTGTTTTGTTTTGTTTTTGAGACAGAGTCTTGTTCTGTTGCCCAGGCTGGAGTGCAATGATGTGATCTCGACTCACTACAACCTCCACCTCCTGAGTTCAAGCGATTCTGCTGCCTCAGCCTCCCGAGTAGCTGGCATTACAGGCATGTGCCACCAAGCCTGGCTAATTTTTGTATTTATAGTAGAGACGGGGGTTTCACCATGTTGATCAGGCTGGTGTCGAACTCCTGGCCTCAAGTGATCCGCTCGCCTTGGCCTCCCAAAATGCTGGGATTACAGATGTGAGCCACTGTGCCCAGCCAAGGTCAAGAGTTTGAAACCAGCCTGGCCAGCATGGTGAAACCCTATCTCTACTAAAAATACAAAATCAGTCCATGTGCCTAATTTTGGGATCACACCTGGGATCATGCCTGCAATCCCAGCACTTTGGGAGGCCAAGGCGGGTGGGTCATGAAGTCAGGAGTTCAAGACCAGCCTGGCCAACATGGTGAAACCCTGTCTCTACTAAAAATACAAAAGTTAGCTGGGCGTGGTGGCACGCACCTGTAGTCCCAGCTACTAGGAAGGCTGAGGCAGGAGAATTCTTGAACCCGGGTGATGGAGGTTGCAGTGAGCCGAGATTGCGCCACTGCACTCCAGCCTGGGCAACAGAGTGAGACTCTGTCTAAAAAAAAAATTAGTCAGGCGTGGTGGTGAGCACCTGTAATCACAGCTACTGGGGAGGCTGAGGCTGGAGAATTGCTTGAACCCGGGAGGCGGAGGTTGCAGTGAGCCAAGATCGCGCCTTTGCACTCCAGCCTGGGCAACAGGAGTGAAACTGCATCTCAAAAAAAAAAAAAAAAAAA","GGCTGGGCGCAGTGGCTCACACCTGTAATCCCAGCACTTAGGGAAGCTGAGGCGAGTAGATCACCTGAGGTCAGGAGTTAGAGACCAGCCTGGCCATCATGGTGAAACCCCGTCTCTACTAAAGATACCAAAAATTAGCTGAGTGTGGTGCTGGGTGCCTGTAATCCCAGAAACTCAGGGTGCCTGTAATCCCAGCAACTCAGGGTGCCTTTAATCCCAGCAACTGAGGGTACCAGTAATCCCAGCAACTCAGGGTGTCTTTAATCCTAGCAACTGAGGGCACCTGTAATCCCAGCAACTCAGGAAGCTGAGACAGGAGAAGTACTTGAACCCAGAAGGCAGAGGTTGCAGTGAGCCGATATTGCACCATTGCACTCCAGTCTGGGCAACAAGAGTGAAACTCTGTCTCAAAAAAAAA"
"chr19","10485431","10486007","JH378118","18053084","18053501","237","7567653","GGCCGGGCGCAGTGGCTCATGCCTAATCCCAAGACTTTCAGAGGCTGAGGCAGGTGGATCACCTGAGGTCAGGAGCTCAAGACCAGCCTGGCTAACATTGTGAAACCGCGTCTCTACTAAAAATCAAAATTGGCCGGGCACGGTGGCTCACACCTGTAATCCCATCCCTCTGGGAGACCGAGGCGGGCAGATCACCTAAGGTCAGGAGTTCGAGACCAGCCTGACCAACATGGAGAAAACCCTTCTCTGCTAAAAATACAAAATTAGCCGGGCGTGGTGGCGCATGCCTGTAACCTCAGCTACTCGGGAGGCTGAGGGAAAATCGCTTGAACCTGCCAGGTGGAGGTTGCAGTGAGCCGAGATCGAGCCATTGCACTCCAGCATGGGCAACGAAAGCGAAACTCCATCTCAAAAAAAAAAAAAATTAGCTAGGCGTGGTGGCGCGTGCCTGTATTCCCAGCTACTCAGGAGGCTGAGACAGGAGAATCACTTGAACCTGGGAGGCAGAGGTTGCAGTGAGCCAAGATTGCACCATTGCACTCCAGCCTGGGCAACACGAGCAAAACTCTGTCTCAAA","GGCTGGGCGCAGTGGCTCACACCTGTAATCCCAGCACTTAGGGAAGCTGAGGCGAGTAGATCACCTGAGGTCAGGAGTTAGAGACCAGCCTGGCCATCATGGTGAAACCCCGTCTCTACTAAAGATACCAAAAATTAGCTGAGTGTGGTGCTGGGTGCCTGTAATCCCAGAAACTCAGGGTGCCTGTAATCCCAGCAACTCAGGGTGCCTTTAATCCCAGCAACTGAGGGTACCAGTAATCCCAGCAACTCAGGGTGTCTTTAATCCTAGCAACTGAGGGCACCTGTAATCCCAGCAACTCAGGAAGCTGAGACAGGAGAAGTACTTGAACCCAGAAGGCAGAGGTTGCAGTGAGCCGATATTGCACCATTGCACTCCAGTCTGGGCAACAAGAGTGAAACTCTGTCTCAAAAAAAAA"
"chr19","10538873","10539199","JH378118","15020968","15021286","46","4482095","GCTGGGCGCGGTGGCTCACGCCTGTAATCCCAGCACTTTGGGAGGCTGAGGCAGGCAGATCACCTGAGGTCAGGAGTTCAAGACCAGCCTGGTTAACACAGTGAAACCCCCGTCTCTACTAAAAATACAAAAACAAAAATTAGCCGGGTGTGGTGGCGGGCGCCTGTAATCCCAGTTACTCGGGAGGCTGAGGCAGGAGAATCGCTTGAACCCGGGAGGCGGAGGTTGTGGTGAGCCGAGATTGCCATTGCACTCCAGCCTGGGCAAAAAGAGCGAAACTCCATCTAAAACAAACAAACAAACAAACAAACAAAAAATAGAAAAGAA","GCCGGGCGCGGTGGCTCAAGCCTGTAATCCCAGCACTTTGGGAGGCTGAGGCGGGTGGATCCCGAGGTCAAGAGATCGAGACCATCCTGGTCAACATGGTGAAACCCCGTCTCTACTAAAAATACAAAACATTAGCTGGGTATGGTGGCGCGTGCCTGTAATCCCAGCTACTCAGGAGGCTGAGGCAGGAGAATTGCCTGAACCCAGGAGGCGGAGGTTGCGGTGAGCTGAGATCGCGCCATTGCACTCCAGCCTGGGTAACAAGAGCGAAACTTCCATCTCAAAAACAAACAAACAAACAAACAAACAAAAAACAAAC"
"chr19","10973032","10973651","JH378118","18053084","18053501","265","7080052","GGCTGGACGTGGTGGCTCACGCCTGTAATCCCAACACTTTGGGAGACCAAGGCAGGTGGATCGCCTGAGGTTAGGGGTTCGAGACCAGCCTGACCAACATGGTGAAACCCCATCTCTACTAATAATAAAAAAATTAGGACCAGGCTTGGTGGCTCATGCCTGTAATTCCAACACTTTGGGAGGCCAAGGCGAGTGGATAACTTGAGGTCAGGAGTTTGAGACCAGCCTGGCCAACATGGTGAAACCTCATCTCTACTAAAAATACAAAAATTAGCCGGCATGGTGGCGGGCACCCGTAATCCCAGCTACTCGGTGTGGGGGCTGGGACAGGAGAATCGCTTGAACCCAGGAGGTGGAGGTTGCCGTGAGCTAAGATTGCGCCACTGCACTCTAGTTGGGGCAACAGAGCGGACTCCGTCTCAAAAAAAAAAAAAAAATTAGCCGAGCGTGGTGGTGGACACCTGTAATCCCAGCTACTCAGGAGGCTGAGGCAGGAAAATTGAAATCGCTTAAACCTGGGAGGAGGAGGTTGCAGTGAGCCAAGATCGCACCATTGCACTCCAGCCTGGGCGACAAGAACAAAACTCCGTCTCCCCACTCCAAAAAAAAAAAAAAAAAAA","GGCTGGGCGCAGTGGCTCACACCTGTAATCCCAGCACTTAGGGAAGCTGAGGCGAGTAGATCACCTGAGGTCAGGAGTTAGAGACCAGCCTGGCCATCATGGTGAAACCCCGTCTCTACTAAAGATACCAAAAATTAGCTGAGTGTGGTGCTGGGTGCCTGTAATCCCAGAAACTCAGGGTGCCTGTAATCCCAGCAACTCAGGGTGCCTTTAATCCCAGCAACTGAGGGTACCAGTAATCCCAGCAACTCAGGGTGTCTTTAATCCTAGCAACTGAGGGCACCTGTAATCCCAGCAACTCAGGAAGCTGAGACAGGAGAAGTACTTGAACCCAGAAGGCAGAGGTTGCAGTGAGCCGATATTGCACCATTGCACTCCAGTCTGGGCAACAAGAGTGAAACTCTGTCTCAAAAAAAAA"
"chr19","11513769","11514351","JH378206","6546474","6546861","242","4967295","TCCCAGCACTTTGGGAGGCCGCGATGGGTGGATCACCTTAGGTCAGGAATTCGAGACCATCCTGGCCAACATGGTGAAACCCCGTCTCTACTAAAAACACAAAAATTAGGCCGGGCACGGTGGCTCACATCTGTAATCCCAGCACTTTGGGAGGCTGAGGTGGGCGGATCACAAGGTCAGGAGTTCAAGACCAGCCTGGCCAACATGGTGAAACCCTGTCTCTACTAAAAATACAAAAATTAACTGGGCATGGTGGCATGTGCCTGTAATCCCAGCTACTTGGGAGGCTGAGGCAGAAGAATTGCTTGAACCAGGGAGTCAGAGGTTATAGTGAGCTGAGATCGTGCGACTGCACTCCAGCCTGGTGACAGAGCGAGACTCCGTTTCAGGAAAAACAAACAAAACACAAAAATTAGCTGGGCATGGTGGCAGGCGCCTGTAATCCTAGCTACTTGGGAGGCTGAGGCAGGAGAATCGCTTGAACCCAGAAGGCAAAGGTTGCAGTGAGCTGAGATGATGCCATTGCACTCCAGCCTGGGCAACAAGTGAAACTCTGTCTCAAGAAAAAAAGTAAAAGAAAGAA","GGCCACACATGGTGGCTAACGCCTGTAATCCCAGCACTTTGGGAGGCCAAGTCGGGTGGATCATGAGGTCAGGAGACCAAGACCATCCTGGCCAAATGGTGAAACCCCGTCTCTACTAAAAATACAAAAATTAGCTGGGCATGGTGGCGTGTGCCTGTAATCCCAGCTACTCAGGAGGCTGAGGCAGGACAATTGCCTGAACCCAGGAGAATTAGCTGGGCATGGTGGCGTGTGCCTGTAATCCCAGCTACTCAGGAGGCTGAGGCAGGACAATTGCCTGAACCCAGGAGGCGAAGGTTGCGGTGAGCCGAGATTGTGCCATTGCACTCCAGCCTGGGTAACAAGAGCGACACTCTGTCTCAAAAAAAAAAAAAAAAAAAAAAAAAAA"
"chr19","11535200","11535780","JH378206","6546474","6546861","242","4988726","TCCCAGCACTTTGGGAGGCCGCGATGGGTGGATCACCTTAGGTCAGGAATTCGAGACCATCCTGGCCAACATGGTGAAACCCCGTCTCTACTAAAAACACAAAAATTAGGCCGGGCACGGTGGCTCACATTGTAATCCCAGCACTTTGGGAGGCTGAGGTGGGCGGATCACAAGGTCAGGAGTTCAAGACCAGCCTGGCCAACATGGTGAAACCCTGTCTCTACTAAAAATACAAAAATTAACTGGGCATGGTGGCATGTGCCTGTAATCCCAGCTACTTGGGAGGCTGAGGCAGAAGAATTGCTTGAACCAGGGAGTCAGAGGTTATAGTGAGCTGAGATCGTGCGACTGCACTCCAGCCTGGTGACAGAGCGAGACTCCGTTTCAGGAAAAACAAACAAAACACAAAAATTAGCTGGCATGGTGGCAGGCGCCTGTAATCCTAGCTACTTGGAGGCTGAGGCAGGAGAATCGCTTGAAACCCAGAAGGCAAAGGTTGCAGTGAGCTGAGATGATGCCATTGCACTCCAGCCTGGGCAACAAGTGAAACTCTGTCTCAAGAAAAAAAGTAAAAGAAAGAA","GGCCACACATGGTGGCTAACGCCTGTAATCCCAGCACTTTGGGAGGCCAAGTCGGGTGGATCATGAGGTCAGGAGACCAAGACCATCCTGGCCAAATGGTGAAACCCCGTCTCTACTAAAAATACAAAAATTAGCTGGGCATGGTGGCGTGTGCCTGTAATCCCAGCTACTCAGGAGGCTGAGGCAGGACAATTGCCTGAACCCAGGAGAATTAGCTGGGCATGGTGGCGTGTGCCTGTAATCCCAGCTACTCAGGAGGCTGAGGCAGGACAATTGCCTGAACCCAGGAGGCGAAGGTTGCGGTGAGCCGAGATTGTGCCATTGCACTCCAGCCTGGGTAACAAGAGCGACACTCTGTCTCAAAAAAAAAAAAAAAAAAAAAAAAAAA"
"chr19","12911527","12912140","JH378118","18053084","18053501","266","5141557","GGCCAGGCATGGTGGCTCATGCCTGTAATCCAGCACTTTGGTAGGCCAAGGTGGGTGGATGGATTACTTGAGGCCAGGAGTTCAAGACCAACCTGGCCAACATGGTGAAAACCCATCTCTATTAAAAATATAAAAGCTAGGCCAGGTGCGGTGGCTCACGCCTGTAATCCCAGCACTTTGGGAGGCTGAGGCGGGCGGATCACGAGGTCAGGAGATCGAGACCACTGTGAAACCCTGTCTCTACTAAAAATACAAAAAAAATTAGCTGGGTGGGGTGGCGGGTGCCTGTAGTCCCAGCTACTTGGGAGGCTGAGGCAGGAGAATGGCGTGAACCCGGGAGGCGGAGCTTGCAGTGAGCCGAGATCGCGCCACTGCACTCCAGCCTGGGCTACAGAGCAAGACTCCGTCTCAAAAAAAAAATAAATAAATAAATAAAAATAAAAACTAACTGGGCATGGTGGTGTGCACCTGTAATCCCAGCTACTCGGGAGGCTGAGACAGGAGAATTGCTTGAACCTGGGAGGTGGAGGTTGCAGTGAACCAAGATGATGCCATTGCACTCCAACCTGGGCAACAAGAGCAAAACTCCGTCTCAAAAAAAAAAAAAAAAAAAA","GGCTGGGCGCAGTGGCTCACACCTGTAATCCCAGCACTTAGGGAAGCTGAGGCGAGTAGATCACCTGAGGTCAGGAGTTAGAGACCAGCCTGGCCATCATGGTGAAACCCCGTCTCTACTAAAGATACCAAAAATTAGCTGAGTGTGGTGCTGGGTGCCTGTAATCCCAGAAACTCAGGGTGCCTGTAATCCCAGCAACTCAGGGTGCCTTTAATCCCAGCAACTGAGGGTACCAGTAATCCCAGCAACTCAGGGTGTCTTTAATCCTAGCAACTGAGGGCACCTGTAATCCCAGCAACTCAGGAAGCTGAGACAGGAGAAGTACTTGAACCCAGAAGGCAGAGGTTGCAGTGAGCCGATATTGCACCATTGCACTCCAGTCTGGGCAACAAGAGTGAAACTCTGTCTCAAAAAAAAA"
"chr19","13205284","13205895","JH378118","18053084","18053501","258","4847800","GCCAGGCGCAGTGGATTACGCCTGTAATCCCAGCGCTTTGGTATACCGAGGCGGGCAGATCGTCTGAGGTCAGGAGTTCAAGACCAGCCTGGAGAACATGGTGAAACCCCGTCTCTATTAAAAATACAGGCTGGGCGCGGTGGCTTACGCCTGTAATCTCAGCACTTTGGGAGGCCAAGGCGGGTGGATCACGAGGTCAGGAGATCGAGACCATCCTGGCTAACATGGTGAAACCCTGTCTCTACTGAAAATACAAAAAAATTAGTTGTGGTGGGTGCCTGTAATCCCAGCTACTCGGGAGGCTGAGGCAGGAGAATGGCGTGAACCCGGGAAGCAGAGATTGCAGTAAGCCAAGATCGCTCCACTGCACTCCAGCCTGGGCTACAGAGCAAGACTCCATCTCAAAAAAAAATAAATAAATAAAATAAAAAATTAGCCTGGCGTGGTGGCGCATGCCTGTAATCCCAGCTACTTGGGAGGCTGAGGCAGGAGAATTGCTTGAACCCAAGAGGTGGAGGTTGCAGTGAGTCGAGATTGAGCCATTGCCATCCAGCCTGGGCAACAAGAGTGAAACTCTGTCTCAAAAAAAAAGAGAGAGAAAAGAAAGTAAAA","GGCTGGGCGCAGTGGCTCACACCTGTAATCCCAGCACTTAGGGAAGCTGAGGCGAGTAGATCACCTGAGGTCAGGAGTTAGAGACCAGCCTGGCCATCATGGTGAAACCCCGTCTCTACTAAAGATACCAAAAATTAGCTGAGTGTGGTGCTGGGTGCCTGTAATCCCAGAAACTCAGGGTGCCTGTAATCCCAGCAACTCAGGGTGCCTTTAATCCCAGCAACTGAGGGTACCAGTAATCCCAGCAACTCAGGGTGTCTTTAATCCTAGCAACTGAGGGCACCTGTAATCCCAGCAACTCAGGAAGCTGAGACAGGAGAAGTACTTGAACCCAGAAGGCAGAGGTTGCAGTGAGCCGATATTGCACCATTGCACTCCAGTCTGGGCAACAAGAGTGAAACTCTGTCTCAAAAAAAAA"
"chr19","14119695","14120238","JH378206","6546474","6546861","206","7573221","ACCAGCCTGGCCAAAATGGTGAAACCCTGTCTCTACTAAAAATATTTAAAAATTGGCCAGGTGCGGTGGCTCACGCCTGTAATCCCAGCACTTTGGGAGGCCGAGGCGGGCGGATTACAAGGTCAGGAGATCGAGACCATCCTGACTAACATGGTGAAACCCCGTCTCTACTAAAAATACAAAAAATTGGCCGGGCGTGGTAGCGGGCGCCTGTAGTTCCAGCTACTCGGGAGGCTGAGGCAGGAGAATGGCGTGAACCCGGAAGGCAGAGCTTGCAGTGAGCCAAGATCGTGCCACTGCACTCCAGCCTGAGCGACAGAGCAAGACTCCATCTCAAAAAAAAAAAAAAAAAAAAAAAAAATTAAAAAATTAGCTGGGCGTGGTAGCCGGCACCTGTAATTCCAGCTACTCAGGAGGCTGGAGCACAAGAATCGCTTGAAACCAGGAGGCAGAGTTGTAGTGAGCCGAGATCGTGCCATTGCACTCCAGCCTGGGCATCAAGAGCGAAACTCCATCTCAAAAACAAAACAAAACAAAACAAAAA","GGCCACACATGGTGGCTAACGCCTGTAATCCCAGCACTTTGGGAGGCCAAGTCGGGTGGATCATGAGGTCAGGAGACCAAGACCATCCTGGCCAAATGGTGAAACCCCGTCTCTACTAAAAATACAAAAATTAGCTGGGCATGGTGGCGTGTGCCTGTAATCCCAGCTACTCAGGAGGCTGAGGCAGGACAATTGCCTGAACCCAGGAGAATTAGCTGGGCATGGTGGCGTGTGCCTGTAATCCCAGCTACTCAGGAGGCTGAGGCAGGACAATTGCCTGAACCCAGGAGGCGAAGGTTGCGGTGAGCCGAGATTGTGCCATTGCACTCCAGCCTGGGTAACAAGAGCGACACTCTGTCTCAAAAAAAAAAAAAAAAAAAAAAAAAAA"
"chr14","584088","584429","JH378109","21565230","21565567","54","20981142","GGCCGGGTACGGTGGCTCACGCCTGTAGTCCTGGCACTTTGGGAGGCCGAGGCAGGTGGATCCCCGAGGTCACGAGTTTGAGACCAGCCTGGCCAGCATGGTGAAATCCCATCTCTACTAAAAATACAAAACTTAGCCGGGCATGGTGACGTGTGCCTGTAATCCCAGCTACTTGGGAGGCTGAGGCAGGAGAATTGCTTGAACCAGGGAGGCAGAGGTTGCAGTGAGCTGAGATCATGAAACTGCAGTCCAGTCTAGGCGACAAGAGCAAAACTCCGTCTCAAAAAAATAAATAAATAAATAAATAAATAAAAAATAAAACAAACAACAAAAAAAACAAAA","GGCCGGGCGCGGTGGCTCAAGCCTGTAATACCAGCACTTTGGGAGGCCGAGGCGGGTGGATCACGAGGTCAAGAGATCGAGACCATCCTGGTCAACATGGTGAAACCCCGTCTCTACTAAAAATACAAACAATTAGCTGGGCATGGTGGCGGGTGCCTGTAATCCCAGCTACTCCAGAGGCTGAGGCAGGAGAATTGCCTGAACCCAGGAGACGGAGGTTGCGGTGAGCCAAGATCGCGCCATTGCACTCCAGCCTGGGTGACAAGAGCGAAACTCCGTCTCAATAAATAAATAAATAAATAAATAAATAAAAATAAAATAAATAAATAAATAAATAA"
"chr14","620575","620915","JH378109","21565230","21565567","56","20944655","GGCCGGGTACGGTGGCTCACGCCTGTAGTCCTGGCACTTTGGGAGGCCGAGGCAGGTGGATCCCCGAGGTCACGAGTTTGAGACCAGCCTGGCCAGCATGGTGAAATCCCATCTCTACTAAAAATACAAAACTTAGCCGGGCATGGTGACGTGTGCCTGTAATCCAGCTAACTTGGGAGGCTGAGGCAGGAGAATTGCTTGAACCAGGGAGGCAGAGGTTGCAGTGAGCTGAGATCATGAAACTGCAGTCCAGTCTAGGCGACAAGAGCAAAACTCCGTCTCAAAAAATAAATAAATAAATAAATAAATAAAAAATAAAACAAACAACAAACAAAACAAAA","GGCCGGGCGCGGTGGCTCAAGCCTGTAATACCAGCACTTTGGGAGGCCGAGGCGGGTGGATCACGAGGTCAAGAGATCGAGACCATCCTGGTCAACATGGTGAAACCCCGTCTCTACTAAAAATACAAACAATTAGCTGGGCATGGTGGCGGGTGCCTGTAATCCCAGCTACTCCAGAGGCTGAGGCAGGAGAATTGCCTGAACCCAGGAGACGGAGGTTGCGGTGAGCCAAGATCGCGCCATTGCACTCCAGCCTGGGTGACAAGAGCGAAACTCCGTCTCAATAAATAAATAAATAAATAAATAAATAAAAATAAAATAAATAAATAAATAAATAA"
"chr14","1107083","1107723","JH378118","18053084","18053501","303","16946001","GGCGTGGTGGCTCACACCTGTAATCCCAGCACTTCAGGAGGCCAAGGCAGGTAGATTGCTTGATCACAGGAGTTCAAACCAGCCATGGGCAATGTCAGGCCTCTGAGCCCAAGCTTGCACGTATCCAGATGGCCTGAAGCAACTGAAGAATCACAAAAGAAGTGAAAACAGCCAGTTCCTTCCTTAACTGATGACATTACCTTGTGAAATTCCTTCTCCTGGCTCAGAAGCTCCCCTACTGAGCACCTTGTGACCCCTGCCCCTGCCAGCCAGAGAACAATCCCCTTTGACTGTAATTTTCCACTACCTACCCAAATCCTATAAAACAGCCCCACCCCATCTCCCTTTGCTGACTCCTTTTTCGGACTAGGTCCGCCTGCACCCAGGTGATTAAAAAGCTTTATTGCTCACACAAAGCCTGTTGGTGGTCTCTTCACACGGACGCACGTGACAGGCAACATGGTGAAACCCTATCTCTATAAAAAAATAAAAATAAAAATTAGTTGGGCGTGGAGACTGAGGTGAGAGAATCCAGAGGATCCAAGAGGATCGAGTCAAGGAGGTGGAGGCCGCAGTGAGCCGAGATCGCACCGCTGCACTCCAGCCTGGGCGACAAGAGTGAAACTCTGTCTTAAAAAAAA","GGCTGGGCGCAGTGGCTCACACCTGTAATCCCAGCACTTAGGGAAGCTGAGGCGAGTAGATCACCTGAGGTCAGGAGTTAGAGACCAGCCTGGCCATCATGGTGAAACCCCGTCTCTACTAAAGATACCAAAAATTAGCTGAGTGTGGTGCTGGGTGCCTGTAATCCCAGAAACTCAGGGTGCCTGTAATCCCAGCAACTCAGGGTGCCTTTAATCCCAGCAACTGAGGGTACCAGTAATCCCAGCAACTCAGGGTGTCTTTAATCCTAGCAACTGAGGGCACCTGTAATCCCAGCAACTCAGGAAGCTGAGACAGGAGAAGTACTTGAACCCAGAAGGCAGAGGTTGCAGTGAGCCGATATTGCACCATTGCACTCCAGTCTGGGCAACAAGAGTGAAACTCTGTCTCAAAAAAAAA"
"chr14","1362660","1363231","JH378118","18053084","18053501","229","16690424","GGCTGGGCACAGTGGCTTATACCCATAATCTCAGCAGTTTGGGAGGCCAAGGCAGGTGTATCACCTGAGGTCAGGAGTTCGAGAAACACCATGGCCAACATGGTGAAACCCCATCTCTACTAAAAATACAAAAAGTAGGCTGGGCGTGGTGGCTCACGCCTGTAATCCCAGTACTTTGGGAGGCCGAGGCGGGCGGATCACAAGGTCAGGAAACCGAGACCATCCTGACTAACATGGTGAAACCCCGTCTCTACTAAAAATACAAAAAAAGCTAGCCGGGCATGGTGGCGGGTGCCTGTAGTCCCAGCTACTCGGGAGGCTGAGGCAGGAGAATGGCGTGACCCCAGGAGGCAGAGCTTCCAGCTTGGGTGACTCCGTCTCAAAAAAAAAAAAACAAAAACAAAAAGTAGCTGGACGTGGTGGCTGTAGACCTAGCTACTCGAGAGGCTGAGGCAGGAGAATCGCTTGAACCTAGGAGGCGGAGGTTGCGGTGAGCCGAGATCACGCTTCTGCACTCCAGCCTGGGTGACAAGAGCAAAACTCCATCTCCAAAAAAAAAAAACAAAAAAAAA","GGCTGGGCGCAGTGGCTCACACCTGTAATCCCAGCACTTAGGGAAGCTGAGGCGAGTAGATCACCTGAGGTCAGGAGTTAGAGACCAGCCTGGCCATCATGGTGAAACCCCGTCTCTACTAAAGATACCAAAAATTAGCTGAGTGTGGTGCTGGGTGCCTGTAATCCCAGAAACTCAGGGTGCCTGTAATCCCAGCAACTCAGGGTGCCTTTAATCCCAGCAACTGAGGGTACCAGTAATCCCAGCAACTCAGGGTGTCTTTAATCCTAGCAACTGAGGGCACCTGTAATCCCAGCAACTCAGGAAGCTGAGACAGGAGAAGTACTTGAACCCAGAAGGCAGAGGTTGCAGTGAGCCGATATTGCACCATTGCACTCCAGTCTGGGCAACAAGAGTGAAACTCTGTCTCAAAAAAAAA"
"chr14","2088506","2089110","JH378118","18053084","18053501","257","15964578","GGCTGGGCACTGCGGCTCACACCTGTAATCCCAGCATTTTGAGAGGCCTAGGTGGGTGGATCACCTGAGATCAGTTCAAGACCAGCCTGACCAACATGGCAAAACCCCATCTCTATTAAAAACACAAAAAACGCCCAGGAGCGGTGGCTCACACCTGTAATCCCGGCACTTTGGGAGGCTGAGGCAGGCGGATCACGAGGTCAGGAGATCGAGACCATGCTGGCTAACACGGTGAAACCCCGTCTCTACTAAAAATACAAAAAATTAGCCAGGCGTGGTGTCGGGCGCCTGTAGTCCCAGCTATTCGGGAGGCTGAGACAGGAGAATGGCATGAACCCGGGAGGCAGAGCTTGCAGTGAGCTGAGATCGCGCCACTGCACTCCAGCCTGGGCGACAGAGTAAGACTCTGTCTCAAAAAAAAAAATACAAAAAATACAAAAAACATTAGCCACATGTGGTGGTGGGTGCCTGTAATCCCAGCTACTCAGGAGGCTGAGGCTGGAGAATTGCTTGAACCCAGGAGGTGGAGGTTGTGGTGAGCCAAGATCACGCCATTGCATTCCAGCCTGGGTGACAAGAGTGAACCTCTGTCTCAAAAAAAAGAA","GGCTGGGCGCAGTGGCTCACACCTGTAATCCCAGCACTTAGGGAAGCTGAGGCGAGTAGATCACCTGAGGTCAGGAGTTAGAGACCAGCCTGGCCATCATGGTGAAACCCCGTCTCTACTAAAGATACCAAAAATTAGCTGAGTGTGGTGCTGGGTGCCTGTAATCCCAGAAACTCAGGGTGCCTGTAATCCCAGCAACTCAGGGTGCCTTTAATCCCAGCAACTGAGGGTACCAGTAATCCCAGCAACTCAGGGTGTCTTTAATCCTAGCAACTGAGGGCACCTGTAATCCCAGCAACTCAGGAAGCTGAGACAGGAGAAGTACTTGAACCCAGAAGGCAGAGGTTGCAGTGAGCCGATATTGCACCATTGCACTCCAGTCTGGGCAACAAGAGTGAAACTCTGTCTCAAAAAAAAA"
"chr14","2164771","2165383","JH378118","18053084","18053501","243","15888313","GGCTGGGCGCAGTGGCTCACACCTGTAATCCCAGCACTCTGGGAGGCCAAGGCAGGTGGATCACCTGAGGTCAGGAGTTCGAGACCAGCCTGGCCAACATGGTGAAACCCCATCTTTACTAAAAATACAAAAATTAGCTAGGCGTGAGGCCGGGCGTGGCGGCTCATGCCTGTAATCCCAGCACTATGGGAGGCTGAGGCAGGCTGATCATGAGGTCAGGAGATTGAGACCTGGCTAACACAGTGAAACCCCGTCTCTACTAAAAATACAAAAAAAAAATAGCCAGGCATGATGGCAGGCTCCTGTAGTCCCAGCTTCTTGGGAGGCTGAGGCAGGAGAATGGTGTGAACCCGGGAGGCAGAGCTTGCAGTGAGCCGAGATCATGCCACTGCACTCCAGCCTGGGTGACAGAGCAAGACTCTGTCTCAAAAAAAAAAAAAAAAAATTAGCTAGGCGTGGTGAGGGGCACCTGGAATCCCAGCTACTCAGGAGGCTGAGGCAGGAGCATCGTTTAAACCCAGGAGGCAGAGGTTGCAGTGAGCCGAAATCACACCATTGCACTCCAGCCTGGGCAACAAGAGCAAGTCTCCATCTTAAAAAAAAAAAAAAAAAA","GGCTGGGCGCAGTGGCTCACACCTGTAATCCCAGCACTTAGGGAAGCTGAGGCGAGTAGATCACCTGAGGTCAGGAGTTAGAGACCAGCCTGGCCATCATGGTGAAACCCCGTCTCTACTAAAGATACCAAAAATTAGCTGAGTGTGGTGCTGGGTGCCTGTAATCCCAGAAACTCAGGGTGCCTGTAATCCCAGCAACTCAGGGTGCCTTTAATCCCAGCAACTGAGGGTACCAGTAATCCCAGCAACTCAGGGTGTCTTTAATCCTAGCAACTGAGGGCACCTGTAATCCCAGCAACTCAGGAAGCTGAGACAGGAGAAGTACTTGAACCCAGAAGGCAGAGGTTGCAGTGAGCCGATATTGCACCATTGCACTCCAGTCTGGGCAACAAGAGTGAAACTCTGTCTCAAAAAAAAA"
"chr14","3757666","3758004","JH378113","23438980","23439304","67","19681314","CTGGGCATGGTGGCTCATGCCTGTAATCCCAGCACTTTGGGAGACAGAGGAGGGCAGATCATCTGAGGTCAGGAGTTTGAGACCAGCCTGGCCACCATGGTGAAACCCCCGTCTCTACTGAAAATACAAAAAAATTCAGCTGGGTGTGGTAGTGGATGTCTGTAATCCTAGCTGCTTGGGAGGCTGAGACAGGAGAATCGCTTGAACCCGGGAGGTGGAGGTTGCAGTGAGCCGCCATTGCGCTCCAGCCTGGGCAACAAGAGCGAAACTCCATCTCAAAAATTAATTAATTAATTAATTAATTAAAAGTGGACTAAAGCAAAGACAAGAGAAAAAAGA","GGCAGGGTGTGGTAGCTCATGCTTGTAATCCCAGCACTTTGGGAAGTGGAGGCGGGCAGATCATCTGAGGTCAGGAGTTTGAGGCCAGCCTGGCCAACATGGTGAAACCCTGTCTCTACTAAAAATACAAAAAATTAACTGGGCGTGGTGGTGGACACCTGTAATCCCAGCTGCTTGGGAGGCTGAGGCAGGAGAATCGCTTGAACCCAGGAGATGGAGGTTGCAGTGAGCCAAGATGGCACCATTGCACTCTAGCCTGGGCAAAAAGAGTGAAACTCCGTCTCAAAAAAAAAAAAGAAAAGAAAAGAAAAGAAAAGAAAAGAAA"
"chr14","10702105","10702681","JH378118","18053084","18053501","246","7350979","GGCCAGGCGCAATGGCTCACACCTGTAATCCAAGCACTTTGGGAGGCCAGTTCAAGACCAGCCTGGCCAACATGGTGAAAACCTGTCTCTGCTAAAAATGCCAAATTTCCCAGCACTTTGGGAGGCTGAGGCGGGTGGATCACGAGGTCAGGAGATTGAGACCATCCCGGCTAACACGGTGAAACCCCATCTCTACTAAAAATAGAAAAAAATTAGCCGGGCGTGGTGGCAGACGCCTGTAGTCCCAGCTACTCTGGAGGCTGAGGGAAGAGAATGGCATAAACCCGGGAGGCGGAGCTTGCAGCGAGCTGAGATTGCGCCACTGCACTCCAGCCTGGGCGACAGAGCAAGACTCCGTCTCAAAATAAATAAATAAATAAAATTAAAATTAAAAATAAAATACAAAATTTAGCCGAGCATGGTGGTGAGCACCTATAATCCCAGCTACTTGGGAGGCTGAGGCAGAAGAATCTCTTGAACCAGGGAAGTGGAGGTTGCAGTGGGCTGAGATCCAGCCACTGTACTCCAGCCTGGGCGACAAAAGCGAAACACTGTCTAAAAAAATAAAAAATAAAAA","GGCTGGGCGCAGTGGCTCACACCTGTAATCCCAGCACTTAGGGAAGCTGAGGCGAGTAGATCACCTGAGGTCAGGAGTTAGAGACCAGCCTGGCCATCATGGTGAAACCCCGTCTCTACTAAAGATACCAAAAATTAGCTGAGTGTGGTGCTGGGTGCCTGTAATCCCAGAAACTCAGGGTGCCTGTAATCCCAGCAACTCAGGGTGCCTTTAATCCCAGCAACTGAGGGTACCAGTAATCCCAGCAACTCAGGGTGTCTTTAATCCTAGCAACTGAGGGCACCTGTAATCCCAGCAACTCAGGAAGCTGAGACAGGAGAAGTACTTGAACCCAGAAGGCAGAGGTTGCAGTGAGCCGATATTGCACCATTGCACTCCAGTCTGGGCAACAAGAGTGAAACTCTGTCTCAAAAAAAAA"
"chr14","11790883","11791455","JH378118","18053084","18053501","226","6262201","GGCTGGGTGGCCATGGCTCATGCCTGTAATCCTAGAACTTTGGGAGGCTGCGGCAGGCAAATCACCTGAAGTCAGGAGTTCAAGACCAGCCTGGCCAACATACTGAAACCCCGTCTCTCCAGGCCTGGTGGCTCATGCCTGTAATCCCAGCACTTTGGAAAGCCGAGGTGGGCGGATCACCTGAGGTCAGGAGTTCAAGACCAGTCTGACCAACATGGGGAAACCCCATCTCTACTAAAAATACAAAATTAGCTGGATGTGGTGGCACATGCCTGTATTCCCAGCTACTTGGGAGGCTGAGGCAGGAGAATCGCTTGATCCCGAGAGGTGGAGCTTGCCGTGAGCTGAGATTGTGCGCCATTGCACTCCAGCCTGGGCAACAAGAGTGAAACTCCGTCTCTACTAAAAATACAAAAATTAGCCGGGTGTGGTGGCGGGTGCCTGTAATCCAAGCTACTCGGGAGGCTAAGGCAGGAGAATTGCTTGAACCCACGAGGCCGAGGTTGCAGTGAGCCGAGATTGCACTATTGCACTCCAGCCTGGGCGACAAGAGTGAGACTGTGTCTCAAAAAA","GGCTGGGCGCAGTGGCTCACACCTGTAATCCCAGCACTTAGGGAAGCTGAGGCGAGTAGATCACCTGAGGTCAGGAGTTAGAGACCAGCCTGGCCATCATGGTGAAACCCCGTCTCTACTAAAGATACCAAAAATTAGCTGAGTGTGGTGCTGGGTGCCTGTAATCCCAGAAACTCAGGGTGCCTGTAATCCCAGCAACTCAGGGTGCCTTTAATCCCAGCAACTGAGGGTACCAGTAATCCCAGCAACTCAGGGTGTCTTTAATCCTAGCAACTGAGGGCACCTGTAATCCCAGCAACTCAGGAAGCTGAGACAGGAGAAGTACTTGAACCCAGAAGGCAGAGGTTGCAGTGAGCCGATATTGCACCATTGCACTCCAGTCTGGGCAACAAGAGTGAAACTCTGTCTCAAAAAAAAA"
"chr14","12236526","12237360","JH378118","18053084","18053501","465","5816558","GGCTGGGTGGGGTGGCTCACGCGTGTAATCCCAACACTTTTGAGGCTGAGGTGGGTGGATCACTTGAGGTCCGGAGTTTGAGACCAGCCTGGTCAACATGGTGAAACCCCATGTCTCAGGATGGGGAACATCACATACCGGGGCCTGTCGTGGGGTGTGGGGAGGGGAAGGGATAGCATTAGGAGATATACCTAATGTAAATGACAAGTTAATGGGTGCAGCACACCAACATGGCACATGTATACATATGTAACAAACCTGCATGTTGTGCACATGTACCCTAGAACTTAAAGTATAGCAATAAAAAAAAAAAAAGAAACCCCGTGTCTACAAAAAAAATACAAAATTAGGCCAGGCGCAGTGGCACATACCTGTAATCCCAGCACTTTGGGAGGCCAAGGTGGGCAGATCACGAGGTCAGGAGTTTGAGACCAGCCTGTCCAAAATGGTGAAACCCCATCTCTACTAAAAAAATACAAAAATTAGCCAGGCATGGTGGCCCGTGCCTGCAATCCCAGCTACTCAGGAGGCTAAGGCAGGAGAATCACTTGAACGTGGGAGGCGGAGGTTGCAGTGAGCCGAGATCACACCATTGCACTCCAGCCTAGGCAACAGAGCGAGACTCTGTCTCAAAAAAACAAAAAGCAAAAAAACCCAAATTAGCCAGGCATGGTGGTAGTCACCTGTAATCCCAGCTACTTGGGAGGCTTAGGCAGGAGAATCGCTTGAACCCCAGAGGCAGAGGTTGCAGTAAGCCAAGATCGCACCAAGATCACTCCAGCCTGGGCGACAGTGAAACTGTGTCTCAAAAGAAAAAGAAAAAAAAGAAAGAAAA","GGCTGGGCGCAGTGGCTCACACCTGTAATCCCAGCACTTAGGGAAGCTGAGGCGAGTAGATCACCTGAGGTCAGGAGTTAGAGACCAGCCTGGCCATCATGGTGAAACCCCGTCTCTACTAAAGATACCAAAAATTAGCTGAGTGTGGTGCTGGGTGCCTGTAATCCCAGAAACTCAGGGTGCCTGTAATCCCAGCAACTCAGGGTGCCTTTAATCCCAGCAACTGAGGGTACCAGTAATCCCAGCAACTCAGGGTGTCTTTAATCCTAGCAACTGAGGGCACCTGTAATCCCAGCAACTCAGGAAGCTGAGACAGGAGAAGTACTTGAACCCAGAAGGCAGAGGTTGCAGTGAGCCGATATTGCACCATTGCACTCCAGTCTGGGCAACAAGAGTGAAACTCTGTCTCAAAAAAAAA"
"chr14","12551961","12552292","JH378124","27069096","27069413","54","14517135","GGCCAGGCGCGGTGGCTCACGCCTGTAATCCCAGCACTCTGGGAGGCCAAGGCGGACGGATCATCCGAGGTCAGGAGTTTGAGACCAGCCTGGCCAACATGGTGAAACCCCATCTCTACTAAAAATATATATATATATGTATATATATATATATATTAGCCAGGTGTAGTGGTGGGCATCTGTAATCCCAGCTACTCGGGAGGCTGAGGCAGGAGAATTGCTTGAACCCAGGAGGCGGAGGTTGCAGTGAGCTGAGATTGCACCACTGCACTCCAGCCTGGGTGATAAGAATGAGACTCCATCTCAAAACAAACAAACAAACAAATAAAAAA","GGCCGGGCACGGTGGCTCATGCCTGTAATCCCAGCACTTTGGGAGGCCGAGGCGGGTGGATCATGAGGTCAAGAGATCGAGACCATCCTAGTCAACATGGTGAAACTCCATCTCTACTAAAAATACAAAAAAAAAAAAAAATTAGCTGAGCATGGTGGTGCATGCTTGTAATTCCAGCTACTCAGGAGGCTGAGGCAGGAGAATTGCCTGAACCCAGGAGGCGGAGGTTGCAGTGAGCCGAGATTGCGCCATTGCACTCCAGCCTGGGTAATAAGAGTGAAACTCCGTCTCAAAAAAAAAAAACAAAAAAACAAAAAA"
"chr14","15131045","15131391","JH378121","20921542","20921875","62","5790497","GGCTGGGCCCGGTGACTCATGCCTGTAATCCCAGCACTTCGGGAGGACAAGGCGGGTGGATCACCTGAGGTCAGGAGTTCGAGACCAGCCTGGCCAACATGGCGAAACCCCGTCTCTACTGAAAATACAAAAATTAGCCAGGCATGGTGGTGGGCGCCTGTAATCCCAGCTACTCAGAGGCTGAGACAGGAGAATCACTTGAACCTGGGGTGGGGGCGGGGGCGGGGGCGGGGGCGGGGTGGGAGTGGAGGTTGCAGACAGTGAGTGGTGATGGCGCCAGTTCACTCCAGCCTGGGCGAAAGAGTGAAACTCCATCTCAGAAAAAAAAAAAAAAAAAAAAAGTAAAA","GGCTGGGTACGGTGGCTCATGCTGTAATCCCAGCACTTTGGGAGGTCAAAGCAGGCGGATCACCTGAGGTCAGGAGTTTGAGACCAGCCTTGCTAACATGGTGAAACCCCGTTTCTACTAAAAATAAAAAAATTAGCCAGGCGTGGTGGTGTGCACCTGTAATCCCAGCTACTTGGGAGGCTGAAGCAGGAGAGTTGCTTGAACCGGGGTGGTGGGGGGGCAGGGGCAGGGGTGGGTGGCAGGCAGAGGTTGCAGTGAGCCGAGATGGTGCCATTGCACTCCAGCCTGGGCAACAAGAGCAAAACTCCGTCTCAAAAAGAAAAAAAAAAAAGAA"
"chr14","15292066","15292693","JH378118","18053084","18053501","267","2761018","GGCCGGAGACGGTGGCTCACACCTGTAATCCCAGCACTTTGGGAGGCTGAGGCAGGCAGATCACCTGAAGTCAGGAGTTTGAGACCAGCCTGGCCAACATGGTATAAACCCCATCTCTACTAAAAATACAAAAATTAGGCTGGGCGCGGTGGCTCACGCCTGTAATCCCAACACTTTGGGAGGCCGAGGTGGGTGGATCACCTGAGGTCGGGAGTTTGAGACCAGCCTGACCAACATGAAGAAACCCTGTCTCTACTAAAAAAAAAAAAAAATACAAAATTAGCCGGGCATCATGGCACAAGCCTGTAATCCCAGCTACTCAGGAGTCTGAGGCAGGAGAATCGCTTGAACCTGGGAGGCGAAGGTTGCAGTGAGCTGAGATCGTGCCATTGCACTCCAGCCTGGGCAACAAGAGCGAAACTCCTTCTCTAAATAAATAAATAAAAATACAAAAATTTAGCCGGGCATGGTGGCGGGCACCTGTAATCCTAGCTACTTGAGAGGCTGAGGCAGGAGAATCGCTTGAACCCGGGAGGCGGAGGTTGCAGTAAGCAGAGATTGTGCCATTGCACTCCATCCTGGGCAACAAGAGTGAAACTCCATCTCAAAAAAAAAAAAAAAAAAAAAA","GGCTGGGCGCAGTGGCTCACACCTGTAATCCCAGCACTTAGGGAAGCTGAGGCGAGTAGATCACCTGAGGTCAGGAGTTAGAGACCAGCCTGGCCATCATGGTGAAACCCCGTCTCTACTAAAGATACCAAAAATTAGCTGAGTGTGGTGCTGGGTGCCTGTAATCCCAGAAACTCAGGGTGCCTGTAATCCCAGCAACTCAGGGTGCCTTTAATCCCAGCAACTGAGGGTACCAGTAATCCCAGCAACTCAGGGTGTCTTTAATCCTAGCAACTGAGGGCACCTGTAATCCCAGCAACTCAGGAAGCTGAGACAGGAGAAGTACTTGAACCCAGAAGGCAGAGGTTGCAGTGAGCCGATATTGCACCATTGCACTCCAGTCTGGGCAACAAGAGTGAAACTCTGTCTCAAAAAAAAA"
"chr14","15354689","15355313","JH378118","18053084","18053501","269","2698395","GGACGGGCGCAGTAGCTCACACCTGTAATCCTAGCAGTTTGGGAGGCCAAGGTGGGTGGATCACCTGACGTCAGGAGATCGAGACCAGCCTGGACAACATGGCGAAACCCTGTCTCTACTAAAAATACAAAATTAGGGCCAGGTGCGGTGGCTCACGCCTGTAATCCCAGCACTTTGGGAGACTGAGGCGGGCAGATCACCTGAGGTCAGGAGTTCGAGACCAGCCTGGCCAACATGGTGAAACCGCCTCTCTACTAAAAATATAAAAATTGGCTGGGCATTGTAGCAGCCACCTGTAATCCCAGCTACTTGGGGGCCCGAGGCAGAAAAACTGCTTGAACCCAGGAGGCAGAGGTTGTAGTGAGCCGAAATCATGCCACTGCACTCCAGCCTGGGTGACGAGAGTGAGACTCCGTTTCAAAGAAAAAGAAAAAAAATAAAATAAAACACAAAATTAGCCAGTCATGGTGGCAGGCACCTATAATCCCAGCTACCTGGGAGGCTAAGGCAGGAGAATCACTTGAACCCAGGAGGTAGAGGGTGTGGTGAGCCGAGATCACGCCATTGCACTCTAGCCTGGGCAACAAGAGCAAAACTCTGTCTCAAAACAAAAAGTTAAAAAAAA","GGCTGGGCGCAGTGGCTCACACCTGTAATCCCAGCACTTAGGGAAGCTGAGGCGAGTAGATCACCTGAGGTCAGGAGTTAGAGACCAGCCTGGCCATCATGGTGAAACCCCGTCTCTACTAAAGATACCAAAAATTAGCTGAGTGTGGTGCTGGGTGCCTGTAATCCCAGAAACTCAGGGTGCCTGTAATCCCAGCAACTCAGGGTGCCTTTAATCCCAGCAACTGAGGGTACCAGTAATCCCAGCAACTCAGGGTGTCTTTAATCCTAGCAACTGAGGGCACCTGTAATCCCAGCAACTCAGGAAGCTGAGACAGGAGAAGTACTTGAACCCAGAAGGCAGAGGTTGCAGTGAGCCGATATTGCACCATTGCACTCCAGTCTGGGCAACAAGAGTGAAACTCTGTCTCAAAAAAAAA"
"chr14","15366797","15367405","JH378129","11955248","11955630","263","3411549","GGTTGGGTGCGGTGGCTTACCCCTGTAATCCCAGCACTTTGGGGGTACAAAGTGGGAAGATTGCTTGAGCCCAGGAGTTCAAGACCAGCCTGGGCAACTAAGCGAGATCCTATCTCTCAAAAAAATTTTGAAACAACTTTTTGGCCGGGCGCAGTGGCTCACGCCTGTGATCCCAGCACTTTGGGAGGCCAGGGCGGGCGGATCACGAGGTCAGGAGATCAAGACCATCCTGGCTAACACGGTGAAACCCCGTCTCTACTAAAAATACAAAAAATTAGCCGGGTGCGGTGGCGGGCACCTGTAGTCCCAGCTACTCGGGAGGCTGAGGCAGGAGGATGGCGTGAACCCGGGAGGTGGAGCTTGCAGTGAGCTGAGATCGGGCCACTGCACTCCAACCTGGACGACAGATCGAGACTCCGGCTCAAAAAAAAAAAATTAGCTGGGCGTGGTGGCGGGTGCGTGTAATCCCAGCTACTCGGGAGGCTGAGGCAGGAGAATCACTTGAACCTGGGAGGCAGAGGCTGCAGTGAGCCAAGATCGCGCCATTGCACTCCAGCCTGGGCAACAAGAGCGAAACTCTGTCTCTAAATAATAAAATAAAATAAAAAA","GGCTGGGTACGGTGGCTCATGCCTGTAATCCCAGCACTTTGGGAGGTGGGTCACTTGAGGTCAGGAGTTCGAGACCAGCCTGTGCAGTGCCTCCATCCTCAACTGCTGCCTCATCAGCCTGGACCACTACCTGCTCATCCTCTCACCACTGCCACAAGCTGCGCATGAAGCTCCTGCGCGCGCCGGTGCCCGTCTCTACTAAAAATACAAAAATTAGCTGGGTGTGGTGGCAGGTGCCTGTAATCCCAGCTACTCAGGAGGCTGAGGCAGGAGAATCACTTGAACCCAGGAGGCAGAGGTTGCAGTGAGCCGATATCGCATCATTGCACTCCAGCCTGAGCAACAAGAGTGAAATTTTGTCTCAAAAAAAAAAAAAAAAGAAA"
"chr14","15379094","15379705","JH378129","11955248","11955630","265","3423846","GGTTGGGTGCGGTGGCTTACCCCTGTAATCCCAGCACTTTGGGGGTACAAAGTGGGAAGATTGCTTGAGCCCAGGAGTTCAAGACCAGCCTGGGCAACTAAGCGAGATCCTATCTCTCAAAAAAATTTTGAAACAACTTTTTGGCCGGGCGCAGTGGCTCACGCCTGTGATCCCAGCACTTTGGGAGGCCAGGGCGGGCGGATCACGAGGTCAGGAGATCAAGACCATCCTGGCTAACACGGTGAAACCCCGTCTCTACTAAAAATACAAAAAATTAGCCGGGTGCGGTGGCGGGCACCTGTAGTCCCAGCTACTCGGGAGGCTGAGGCAGGAGGATGGCGTGAACCCGGGAGGTGGAGCTTGCAGTGAGCTGAGATCGGGCCACTGCACTCCAACCTGGACGACAGATCGAGACTCCGGCTCAAAAAAAAAAAAAATTAGCTGGGCGTGGTGGCGGGTGCGTGTAATCCCAGCTACTCGGGAGGCTGAGGCAGGAGAATCACTTGAACCTGGGAGGCAGAGGCTGCAGTGAGCCAAGATCGCGCCATTGCACTCCAGCCTGGGCAACAAGAGCGAAACTCTGTCTCTAAATAAATAAAATAAAATAAAAAA","GGCTGGGTACGGTGGCTCATGCCTGTAATCCCAGCACTTTGGGAGGTGGGTCACTTGAGGTCAGGAGTTCGAGACCAGCCTGTGCAGTGCCTCCATCCTCAACTGCTGCCTCATCAGCCTGGACCACTACCTGCTCATCCTCTCACCACTGCCACAAGCTGCGCATGAAGCTCCTGCGCGCGCCGGTGCCCGTCTCTACTAAAAATACAAAAATTAGCTGGGTGTGGTGGCAGGTGCCTGTAATCCCAGCTACTCAGGAGGCTGAGGCAGGAGAATCACTTGAACCCAGGAGGCAGAGGTTGCAGTGAGCCGATATCGCATCATTGCACTCCAGCCTGAGCAACAAGAGTGAAATTTTGTCTCAAAAAAAAAAAAAAAAGAAA"
"chr14","15386894","15387394","JH378114","15957391","15957789","201","570497","GCTGAGTGCAGTGGCTCACGCCTGTAATCCACTTTAGCAGGCCAAAATAGGGGGATCACTTTGAGGCCACGAGTTTGAGACCTGCCTGGGCAACATAGTGAGGCCCCGTCTCTACAAAAATCTTTAAATATTAGAATAACTTTGGGAGGCCGAGGCGGGTGGATCACGAGGTCAAGAGATTGAGACCATCCTGGCCAACATGGTGAAATCCCATCCCTACTAAAGCTACAAAAATTAGCCAGGCGTGGTGGTGTGCGCCTGTAGTCCCAGCTACTCGGGAGACTGAGGCAGGAGAATTGCTTGAATCCGCGTGGCGGAGGTTGCAGTGAGCTGAGATCGCGCCACTGCACTCCAGCCTGGTGACAGAGCGAGACTCCGTCTTAAAAAAAAAAAAAAAAAAAAAAAAAAAAACTTCGGAGGTTGCGGTGAGCCAAGATCACGCCATTGTACTCCAGCCTGGGCCACAAGAGCAAAACTCCGCTTCAAAAAAAAAAAAAAAAA","GCAAGGAACGGTGGCTCATGCCTGTCATCCCAGCACTTTGGGAGGCTAAGGAGGGTGGATTACCGAAGGTCATGAGTTTGAGACCAGCCTGACCAACATGGTGAAAACCCCATCTCTACTAAAAATACAAAAAATTAGCCAGATACAGCTATGCGGCAGACTGGGGCAGGAGAATCGCTTGGACCCAAACCCCATCTCTACTAAAAATACAAAAAATTAGCCGGATACAGCTATGCGGGAGACTGGGGCAGGAGAATCGCTTGGACCCGGGAGGCAGAGATTGCAGTGAGATGAGACCATGCCATTGCTCTCTAGCTTGTGCGATGAGAACAAGACTCTGTCTCAAAAAAAAAAAAAAAAAAAAAAAAAAAAAAAAAAAAAAAAGAGAGAGAGAGAAAA"
"chr14","20140478","20141066","JH378118","18053084","18053501","250","2087394","GCCAGGCGAGGTGGCTCATGCCTGTAATCCCAGCACTTTGGGAGGCTGAGGTGGGTGGAACACTTGAGGTCAGGAGTTCAAGACCAGCCTGGCCAACATGATGAAACCCCCATCTCTACTAAAAACACAAAAATTAGCCAGGAGTGGGCAGGGTGCGGTGGCTCACGCCTGTAATCCCAGCACTTTGGGAGGCTGGGATGGGTGGATCATGAGGTCGGGAGTTCAAGACCAGCCTGGCCAAGATGGTGAAACCCTGTCTCTATTAAAACTTCAAAAATTAGCCAGGCACGGTGGCAGGTGCTTGTAATCCCAGCTACTTGGGAGGCTGAGGCAGGAGAATCACTTGAAACTGGGCGGCAGAGGTTGCAGTGAGCCAAGATCGCGCCACTGGACTCCAGACTGGGCGACACAGTGAGATACCGTCTCAAAAAAAAAAAAAAAAAAAATTAGCCAGGAGTGGTGGCGGAAATCCCAGCTACTTGAGAGGCTGAGGCAGGAGAATCGTTTGAACCCAGGAGGCAGAGGTTGCAGTGAGCCAAGATCTTGCCATTGCACTCCAGCTTGGGAGACAAGAGCAAAACTCTGTCTC","GGCTGGGCGCAGTGGCTCACACCTGTAATCCCAGCACTTAGGGAAGCTGAGGCGAGTAGATCACCTGAGGTCAGGAGTTAGAGACCAGCCTGGCCATCATGGTGAAACCCCGTCTCTACTAAAGATACCAAAAATTAGCTGAGTGTGGTGCTGGGTGCCTGTAATCCCAGAAACTCAGGGTGCCTGTAATCCCAGCAACTCAGGGTGCCTTTAATCCCAGCAACTGAGGGTACCAGTAATCCCAGCAACTCAGGGTGTCTTTAATCCTAGCAACTGAGGGCACCTGTAATCCCAGCAACTCAGGAAGCTGAGACAGGAGAAGTACTTGAACCCAGAAGGCAGAGGTTGCAGTGAGCCGATATTGCACCATTGCACTCCAGTCTGGGCAACAAGAGTGAAACTCTGTCTCAAAAAAAAA"
"chr14","32019134","32019479","JH378197","6655183","6655524","67","25363951","GGCTGGGGCAGTGGCTCACTGTAATTCCAGCACTTGGCCAAGGCAGGTGGATCACCTGAGGTCAGGAGTTCAAGACCAGCAGGGCCAACATGGTGAAACCCTATCTCTAAAAATAAATAAATAAATAAATAAATAAAATAAAATAAAATAAAATAAAAAATAAAAAAAATTAGCTGGGCGTTGTGGTGGGCGCCTGTAATCCCAGCTACTTGGGAGGCTGAGGCAGGAGGATCGCTTGAACCTGGAAGGCAGAGGTTGCAGTGAGCCGAAATCACATAATTGCACTCCAGCCTGGGCGACAAGAGCAAAACTCCATCTCAAAAAAAAAAAAAAAAAAAAAAAAAAA","GGCCGGGCGCAGTGGCTCATGCCTGTAATCCCAGCACTTTGGGAGGCAGAGGCGGGCAGATCACCCAAGGTCAGGAGTTCAAGACCAGCCTGGCTAACATGGTGAAACCCCATTTCTACTAAAAATACAAAAAAAAAAAAAAAAAAAAAAAAAAAAAAAAAAAAAAATTAGCTGAGCGAGGTGGTGGGCACATGTAATCCCAGCTACTTCGGAGACTAAGGCAGGACAATTGCTTAAGCCTGGGAGGCAGAGGTTGTAGTAAGCTGAGATCACACCATTGCACTCCAGCTTGAGCAACAAGAGCGAAACTCCGTCTCAAAAAAAAACCCAAAAAACAAAAAA"
"chr14","39734996","39735596","JH378118","18053084","18053501","237","21681912","GGCTGGGCGCGGTGGCTCATGCCTGTAATCCCAGCATTTTGGGAGGCCGAGGCGGGTGGATCACCTGAGGTCAGGAGTTTGAGACCAGCCTGGCCAACATGGTGAAACCCTGTCTCTACTAAAAATGCAAAAATTAGGCTGGTGCAGTGGCTCACGCCTGTAATCACAGCACTTTGGGAGGCCGAGGTGGGCGGATCACGAGGTCAGGAGATCGAGACCATCCTGGCTAATACAATGAAACCCCGTCTCTATGAAAAATACAAAAAATTAGCCGGGCGTAGTGGCAGGCGTCTGTAGTCCCAGCTACTCAGGAGGCTGAGGCAGGAGAATGGCATGAACCTGGGAGGCGGAGCTTGCAGTGAGCCGAGATTGCGCCACTGCACTCCAGCCTGGGCGACAGCGAGACTCTGTCTCAAAAAAAAAAAAAAAAATTAGCTAGGCATGGTGGCGCATGCCTGTAATCCCAGCTACTTGGGAGGCTGAGGCAGGAGAATCGCTTGAACCTGGGAGGCAGAGGCTGCAGTGAGACAAGATCACGCCATTGCACTCCAGCCTGGGCAACAAGAGTGAAACTCCATCTTCCCCCTACCAAAAAAAAAAA","GGCTGGGCGCAGTGGCTCACACCTGTAATCCCAGCACTTAGGGAAGCTGAGGCGAGTAGATCACCTGAGGTCAGGAGTTAGAGACCAGCCTGGCCATCATGGTGAAACCCCGTCTCTACTAAAGATACCAAAAATTAGCTGAGTGTGGTGCTGGGTGCCTGTAATCCCAGAAACTCAGGGTGCCTGTAATCCCAGCAACTCAGGGTGCCTTTAATCCCAGCAACTGAGGGTACCAGTAATCCCAGCAACTCAGGGTGTCTTTAATCCTAGCAACTGAGGGCACCTGTAATCCCAGCAACTCAGGAAGCTGAGACAGGAGAAGTACTTGAACCCAGAAGGCAGAGGTTGCAGTGAGCCGATATTGCACCATTGCACTCCAGTCTGGGCAACAAGAGTGAAACTCTGTCTCAAAAAAAAA"
"chr14","49081899","49082239","JH378114","14264965","14265292","65","34816934","GGCCAGGTACAGTGGCTCATGCCTGTAATCTCAGCATTTTGGGAGGCTGAGGCAGGCAGATCACCTGAGGTCAGGAGTTCGTGACCAGCCTGACCAGTGAAACCCTGTCTCTACTGAAAAAAATAAAATAAAATAAAATAAAAATAAAAATTAGCTGGGTGTGGTGGTGGGCGCCTGTAATCCCAGCTACTCGGCAGGCTGAGGCAGGAGAATTGCTTGTACCCGGGAGGCGGAGGTTGCAGTGAGCCAAGATCATGCCATTGCACTACAGCCTAGGTGACAAGAGCAAAACTCTGTCTCAAAACAAAACAACAACAACAACAACAACTAAAAAAAAAAAA","GGCCAGGCGCGGTGGCTCAAGCCTGTAATCCCAGCACTTTGGGAGGCCGAGGCGGGTGGATCATGAGGTCAAGAGATCGAGACCATCCTGGTCAACATGGTGAAACCCCGTCTCTACTAAAAACAGAAAAAAAATAAAAATAAAAATAATTAGCTGGGCATGGTGGAGCATGCCTGTAATCCCAGCTACTCAGGAGGCTGAGGCAGGAGAATTGCCTGAACCGAGGAGGCGGAGGTTGCGGGGAGCCAAGATCGCGCCATTGCACTCCAGCCTGGGCAACAAGAGCGAAACTCCGTCTCAAAAAAAAAAAAAAAAAAAAAAAAAAAAA"
"chr14","54833704","54834332","JH378118","18053084","18053501","272","36780620","GGCCAGGTGCAGTGGCTCACTCCTGTAATTCCAGCACTTTGGGAGGCTGCCGGTGGATCACCTGAGGTCAGGAGTTCGAGATCAGCCTGGCCAACATGGTGAAACCCCGTCTCTACTAATAATACAAAAATTAGCCAGGCAAGGCCGGGCGCAGTGGCTCACACCTGTAATCCCAGCACTTTGGGAGGCCGAGGCGGGCGGATCACCTGAGGTCGGGAGTTCAAGACCAGCCTGACCAACATGGAGAAACCCCATCTCTACTAAAAATACAAAATTAGCTGGGCATGGTGGCACATGCCTGTAATCCCAGCTACTAGGGAGGCTGAGGCAGGCGAATCGCTTGAACCTGGGAGGTGGAGGTTGCGGTGGGCCGAGATGGTGCCATTGCACTCTAGCCCGGGCAACAAGAGCGAAACTCTGTCTCAAAAAAAAAAAAAAAAAAAAAAAAATTAGCCAGGCATGGTAGCACACCCTTGTAATCCCAGCTACTCGGGAGGCTGAGGCAGGAGAGTTGCTTGAACCCGAGAGACGGAGGTTGCAGTGAGCTGAGATCGTGCCATTGCACTCCAACCTGGGTGACAAGAGTGAAACTCCATCTCCAAAAAAAAAAATAAATAAAATAAATAAAA","GGCTGGGCGCAGTGGCTCACACCTGTAATCCCAGCACTTAGGGAAGCTGAGGCGAGTAGATCACCTGAGGTCAGGAGTTAGAGACCAGCCTGGCCATCATGGTGAAACCCCGTCTCTACTAAAGATACCAAAAATTAGCTGAGTGTGGTGCTGGGTGCCTGTAATCCCAGAAACTCAGGGTGCCTGTAATCCCAGCAACTCAGGGTGCCTTTAATCCCAGCAACTGAGGGTACCAGTAATCCCAGCAACTCAGGGTGTCTTTAATCCTAGCAACTGAGGGCACCTGTAATCCCAGCAACTCAGGAAGCTGAGACAGGAGAAGTACTTGAACCCAGAAGGCAGAGGTTGCAGTGAGCCGATATTGCACCATTGCACTCCAGTCTGGGCAACAAGAGTGAAACTCTGTCTCAAAAAAAAA"
"chr14","55277737","55278067","JH378148","10302642","10302970","61","44975095","GGCCGGGTGCAGTGGCCCACCTCTGTAATCCTAACACTTTGGGAGGCCAAGGCAGGCAGGTCACTTGAGGTCAGGAGTTCAAGACTAACCTGGCCAACATGGTGAAACCCCGTCTCTACTAAAAATACGAAAATTAGCCGGGCTTCATGATGCATGCCTGTAATCCCAGCTACTAAGGAGGCTGAGGCAGAAGAATCTCTTGAACCCATGAGGTTGCAGTGAGCTGAGATCTCGCCATTGCACTCCAGCCTGGAGGACAAGAGCGAAACTCTGTCTCAAAAAAATAAAATAAAATAAATAAGAATAAAATAATAATAAAAGGCAAAAAGAA","GGCCGGGCGCGGTGGCTCAAGCCTGTAATCCCAGCACTTTGGGAGGCCGAGGCGGGTGGATCACGAGGTCAAGAGATCGAGACCATCCTGGTCAACATGGTGAAACCCCGTCTCTACTAAAAATACAAAAAATTAGCTGGGCATGGTGGTGGGTGCCTGTAATCCCAGCTACTCAGGAGGCTGAGGCAGGAGAATTGCCTGAACCCAGGAGGCGGAGGTTGCGGTGAGCCGAGATCGCGCCATTGCACTCCAGCCTGGGTAACAAGAGTGAAACTCTGCCTCAAAAAAAAAAAATAAAATAAAATAAAATAAAATAAAATAAAATAAAA"
"chr14","55822103","55822700","JH378118","18053084","18053501","240","37769019","GGCCAGGCGCAGTGGCTCACGCCTGTAATCCCAGCACTTTAGGAGGCCGAGGCAGGTGGATCGCCTGAGTTCAGGAGTTCAAACCCACCCTGGCCAACATGGTGAAACCCTGCCTCTACTAAAAAACAAAAAAATGGCCAAGCGTGGTGGCTCACGCCTGTAATTCCAGCACTTTGGGAGGCTGAGGCAGGCGAATCACGAGGTCAGGAGATCGAGACCATCCTGGCTAACATGGTGAAACCCCATCTCTATTAAAAATACAGAAAATTAGCCAGGCGTGGTGGTGGACGCCTGTAGTCCCAGCTTCTTGGGAGGCTGAGGCAGGAGAATGGCATGAACCCGGGAGGCAGAGCTTGCAGTGAGCTGAGATTGCGCCAGTGCACTACAGCCTGTGGGACAGAGCAACTCCGTCTCAAAAAAAAAAAAAATTAGCTGGGCATGGTGGCATATGCCTGTAATCCCAGCTACTAAGGAGGCTGAGGCGGGAGAATCGCTTGAACCCGGGAGGCAGAGGTTGCAGTGAGCCGAGATTGCGCCATTGCACTCCAGTCTGGACAACAAGAGTGAACTGTGTCTCAAAAAAAAAAAAAAAAAAAGA","GGCTGGGCGCAGTGGCTCACACCTGTAATCCCAGCACTTAGGGAAGCTGAGGCGAGTAGATCACCTGAGGTCAGGAGTTAGAGACCAGCCTGGCCATCATGGTGAAACCCCGTCTCTACTAAAGATACCAAAAATTAGCTGAGTGTGGTGCTGGGTGCCTGTAATCCCAGAAACTCAGGGTGCCTGTAATCCCAGCAACTCAGGGTGCCTTTAATCCCAGCAACTGAGGGTACCAGTAATCCCAGCAACTCAGGGTGTCTTTAATCCTAGCAACTGAGGGCACCTGTAATCCCAGCAACTCAGGAAGCTGAGACAGGAGAAGTACTTGAACCCAGAAGGCAGAGGTTGCAGTGAGCCGATATTGCACCATTGCACTCCAGTCTGGGCAACAAGAGTGAAACTCTGTCTCAAAAAAAAA"
"chr14","55860214","55860812","JH378118","18053084","18053501","246","37807130","GGCCGGATGCAGTGGCTCACGCCTGTAATCCCAGCACTTTGGGAGGCCAAGGCAAGCGGATCACCTGAGGTCAGGAGTTCAAGACCAGCCTGGCCAGCATGGTGAAACCCCTTCTCTACTAAAAATACAAAAATTAGCCGGGGCCTTGCGTGGTGGCTCACACCTGTAAATCCCAGCGCTTTGGGAGGCCGAGGCAGGCGGATCACCTGAGGTCGGGAGTTCAAGAACAGCCTGACCAACATGGAGAAACCCCGTCTCCACTAAAAATAGAAAAATAGCCGGGCATGGTGGCGCATGCTTGTAATCTCAGCTACTCGGGAGGCTGAGGCAGGAGATCACTTGAACCCAAGAGGCAGAGGTTGCGGTGAGCCGAGATCGCGCCATTGCACTCCAGCCTGGGCAACAAAGAGCGAAACTCCGTCTCCAAAAAAAAAAAAAAAAAATTAGCCGGGCGTGGTGGCACATACCTGTAATCCCAGCTATTCAGGAGGCTGAGGCAGGAGAATCCCTTGAACCCGGGAGGCAGAGATGGCAGTGAGCTGAGATCACGCCATTGCACTCCAGCCTGGGTGAGAGGAGTGAAACTCCGTCTAAAAAAA","GGCTGGGCGCAGTGGCTCACACCTGTAATCCCAGCACTTAGGGAAGCTGAGGCGAGTAGATCACCTGAGGTCAGGAGTTAGAGACCAGCCTGGCCATCATGGTGAAACCCCGTCTCTACTAAAGATACCAAAAATTAGCTGAGTGTGGTGCTGGGTGCCTGTAATCCCAGAAACTCAGGGTGCCTGTAATCCCAGCAACTCAGGGTGCCTTTAATCCCAGCAACTGAGGGTACCAGTAATCCCAGCAACTCAGGGTGTCTTTAATCCTAGCAACTGAGGGCACCTGTAATCCCAGCAACTCAGGAAGCTGAGACAGGAGAAGTACTTGAACCCAGAAGGCAGAGGTTGCAGTGAGCCGATATTGCACCATTGCACTCCAGTCTGGGCAACAAGAGTGAAACTCTGTCTCAAAAAAAAA"
"chr14","56736257","56736880","JH378206","6546474","6546861","276","50189783","GGCCAGGCACAGTGGCTCATGCCTGTAATCCCTGCACTTTGGGAGGCCAAGGCGGGTGGATCACCTGAGGTCAGGAGTTCGAGACTAGCCTGGCCAACATGGTTGGCCATCTCTTCTAAAAATACAAAAAATTAAGTTGGGCATGGTGGCTCATGCCTGTAATCCCAGCATTTTGGGAGGCCAAGGCAGGTGGATCATAAGGTCAAGAGATTGAGACCATCCTGGCCAACATGGTGAAACCCCATCTCTACTAAAAATACAAAAATTAGCTGGGCGTGGTGGTAGCACACACCTGCAGTCCCAGCTGCTCAGGAGGCTGAGGCAGGAGAATCACTTGAACCCGGGAAGCAGAGGTTGCAGTGAGCCGAAATTGCACCACTGCACTCCAGCCTGGCGACAAAGCAAGACTCCGTCAAAAAAAAAAAAAAAAAAAAAAAAATTAGCCAGGAGTGGTGGCACGTGCCTATAGTTCCAGCTACTCGGGAGGCTGAGGCAAGAGATTTGCTTGAACCTGGGAAGCAGAGGTTGCATATATTGCAGTGAGCCAAGATTATGCCATTGCACTCCAGCCTGGGCAACAAGAGTGAAAATCTGTCTAAAAAGAAAAAAAAAAGAAAAGAAAAA","GGCCACACATGGTGGCTAACGCCTGTAATCCCAGCACTTTGGGAGGCCAAGTCGGGTGGATCATGAGGTCAGGAGACCAAGACCATCCTGGCCAAATGGTGAAACCCCGTCTCTACTAAAAATACAAAAATTAGCTGGGCATGGTGGCGTGTGCCTGTAATCCCAGCTACTCAGGAGGCTGAGGCAGGACAATTGCCTGAACCCAGGAGAATTAGCTGGGCATGGTGGCGTGTGCCTGTAATCCCAGCTACTCAGGAGGCTGAGGCAGGACAATTGCCTGAACCCAGGAGGCGAAGGTTGCGGTGAGCCGAGATTGTGCCATTGCACTCCAGCCTGGGTAACAAGAGCGACACTCTGTCTCAAAAAAAAAAAAAAAAAAAAAAAAAAA"
"chr14","56744047","56744674","JH378118","18053084","18053501","281","38690963","GGCCGGGTGCGGTGACTCACATCTATAATCCCAGCACTTTGGGAGGCCAAGGCAGGTGGATCACCTGAGGTCAGGAGTTCAAGACCAGCCTGGCCAACTTGGTGAAACCCCATCTCTACTAAAAAATATAAAAATTTGCCAGGTGCGGTGGCTCATACCTGTAATCCCAGCACTTTGAGAGGCAGAGGTGGGTGGATCACGAGGTCAGGAGTTCGAGACCAGCCTGGCCAATGTGGTGAAACCCCATCTCTACTAAAAATACAAAAATTAGCCGGGTGTGGTGATGCGTGCCTGTAGTCCCAGCTATTCGGGAGGTTGAGGCAGGAGAATGGCGTGAACCAGGAAGGCGGAGCTTTCACTGAGCGGAGATCGCACCACTGCACTCCAGCCTGGGCGACGGAGCGAGACTCTGTCTCAAAAACAAAACAAAACAAAAAAACAAACAAACAAAAAAACATTATCCGGGTGTGGTGGTGGGCGCCTGTAATCCCAGCTACTTGGGAGGCTGAAGCAGGAGGATTGCTTGAACCTGGGAGGTGGAGGTTGCAGTGAGCTGAGATCACGCCTCTGCACTGCAGGCTGGACGACAAGAACAAAACTCTGAATCAACAACAACAACAACAAAAAA","GGCTGGGCGCAGTGGCTCACACCTGTAATCCCAGCACTTAGGGAAGCTGAGGCGAGTAGATCACCTGAGGTCAGGAGTTAGAGACCAGCCTGGCCATCATGGTGAAACCCCGTCTCTACTAAAGATACCAAAAATTAGCTGAGTGTGGTGCTGGGTGCCTGTAATCCCAGAAACTCAGGGTGCCTGTAATCCCAGCAACTCAGGGTGCCTTTAATCCCAGCAACTGAGGGTACCAGTAATCCCAGCAACTCAGGGTGTCTTTAATCCTAGCAACTGAGGGCACCTGTAATCCCAGCAACTCAGGAAGCTGAGACAGGAGAAGTACTTGAACCCAGAAGGCAGAGGTTGCAGTGAGCCGATATTGCACCATTGCACTCCAGTCTGGGCAACAAGAGTGAAACTCTGTCTCAAAAAAAAA"
"chr14","58283278","58283584","JH378115","34663603","34663898","52","23619675","CCGGGTGCGGTGGCTCACGCCTGTAATCCCAGCACTTTGGGAAGCTGAGGTGGGTGGATCATTTGAGGTCAAGAGTTCTAGACCAGCCTGGCCAACATGGTGAAACCCTACTTCTAATAAACACACACACACACACACACACACACACACACACACAAATTAGCCAGCAGGCACCTGTAATCCCAGCTACTCGGAAGGCTGAGGCAGGACAATCGCTTGAACCTGGGAGGCCAGAAGTTGCAGTGAGCCAAGATCATGCCACTGCACTCCAGTCTGGGTGACAAGAGCAAGACTCCATTTCAAAAAA","GGCCTGGTGAAGTGGCTCACGCCTGTAATCCCAACACTTTGGGAGGCTGAGATGGATGGCTCATTTGAGGTCAGGAGTTCTAGACCAGCCTGGCCAACATGGTAAAAGCCCACCTCTACCAAAAATACAAAAACAAAAACAAAAAAATTTTAGCCAACAGGCACCTTTAATCCCAGCTACTCAGGAGGCTGAGGCAGGAGAATTGCTTGAATCTGGGAGGCCAGAAGTTGCAGTGAGCCAGGATCACACCACTGCACTCCATCCTAGGCGACAAGAGCAAGACTCCAAAAAAAAAA"
"chr14","59226808","59227410","JH378118","18053084","18053501","257","41173724","GGCTGGGCGCTGTGGCTCATGCCTGTAATCCCAGCACTTTAGGAAGCCAAGGGAGGTGGATCACCTGAGGTCAGAGTTCAAGTCCGGCCTGACCAACATGGCGAAACCCAGTCTCTACTAAAAATACAAAATTGGCCAGGCGTGGGGTGGCTCACACCTGTAATCCCAGCACTTTGGGAGGCCGAAGTGGGTGGATCACTTGAGGTCAGGAGTTTGAGACCAGCCTGGTTAACATGGTGAAACCCCATCTCTACTAAAAATACAAAAATTAGCCAGGCATGGTGGCAGGCGCCTGCAATCCCAGTTACTCAGGAGGCTGGTGCAGGAGAATCGCTTAAACCTAGGAGGCAGAGGTTGCAGTGAACTGAGATCGTGCCATTGCACTCCAGCCTGGGTAACAACAGCAAGACTTCATCTCAAAAAAAAAAATACATAATTATAATTAGCTGGGCGTGTTGGCGAGCGCCTGTAGTCCCTGCTACTTGGGAGGCTGAGGCAGGGGAATCACTTGAACCTGAGAGGCGGAGGTTGCAGTGAGCCAAGTCACGCCATTGCATTCCAGCCTCGGCAACAAGAGCAAAACTCCATCTCAAAAAAAAAAAA","GGCTGGGCGCAGTGGCTCACACCTGTAATCCCAGCACTTAGGGAAGCTGAGGCGAGTAGATCACCTGAGGTCAGGAGTTAGAGACCAGCCTGGCCATCATGGTGAAACCCCGTCTCTACTAAAGATACCAAAAATTAGCTGAGTGTGGTGCTGGGTGCCTGTAATCCCAGAAACTCAGGGTGCCTGTAATCCCAGCAACTCAGGGTGCCTTTAATCCCAGCAACTGAGGGTACCAGTAATCCCAGCAACTCAGGGTGTCTTTAATCCTAGCAACTGAGGGCACCTGTAATCCCAGCAACTCAGGAAGCTGAGACAGGAGAAGTACTTGAACCCAGAAGGCAGAGGTTGCAGTGAGCCGATATTGCACCATTGCACTCCAGTCTGGGCAACAAGAGTGAAACTCTGTCTCAAAAAAAAA"
"chr14","62992080","62992681","JH378118","18053084","18053501","256","44938996","GGCCGGATGCAGTGGCCCACACCTGTAATCCTAGCACTTTGAGAGGCTGAAGCAGGCAGATCACTTGCGGTCAGGAGTTTGAGACCAGCCTGGCCAACATAGTAAAACCTCATCTCTACTAAAAATAGAAAAATTTTCTGACCAGGCACGGTGGCTCGCGCCTGTAATCCCAGCACTTTGGGAGGCCAAGGTGGGCACATTACCTGAGATCAAGAGTTCAAGACCAGCCTGACCAACATGGCAAAACTCTGTCTCTACTAAAAATACAAAATTAGCCGGGCATAGTGGCGCATTCCTGTAATCCCAGCTACTAAGGAGGCTGAGGCAGGAGAATTGCTTGAACCCGGGAGCCGGAGGTTGCAGTAAGCCAAGATTGCGCACTGCACTCTAGGCTGGGCAACAACAGCGAAACTCTGTCTCGAAAAAAAAAAAAAAAAAAATTAGCTGGGCGTGGTGGTGAGTACCTGTAATCCCAGCTACTTGGGAGACTGAGGCAGGAGAATCTCTTGAACCTGGGAGGTAGAGGTTGCAGCGAGCTTAGATCACACCACTGCACTAAAGCCTGGGGGACAAGAGCAAAACTCTATCTCAAAAAAATAAAA","GGCTGGGCGCAGTGGCTCACACCTGTAATCCCAGCACTTAGGGAAGCTGAGGCGAGTAGATCACCTGAGGTCAGGAGTTAGAGACCAGCCTGGCCATCATGGTGAAACCCCGTCTCTACTAAAGATACCAAAAATTAGCTGAGTGTGGTGCTGGGTGCCTGTAATCCCAGAAACTCAGGGTGCCTGTAATCCCAGCAACTCAGGGTGCCTTTAATCCCAGCAACTGAGGGTACCAGTAATCCCAGCAACTCAGGGTGTCTTTAATCCTAGCAACTGAGGGCACCTGTAATCCCAGCAACTCAGGAAGCTGAGACAGGAGAAGTACTTGAACCCAGAAGGCAGAGGTTGCAGTGAGCCGATATTGCACCATTGCACTCCAGTCTGGGCAACAAGAGTGAAACTCTGTCTCAAAAAAAAA"
"chr14","75046278","75046878","JH378118","18053084","18053501","246","56993194","GGCCGGGCACAGTGGCTCACACCTATAATCTCAGTACTTTGGGAGGCCAAGGCGGGCAGATCACTTGAGGTCAGGAGTTCGAGACCACCCTGGCCAACATGGTGAAACCTCATCTCTACTAAAAATACAAAAAACTGGCTGGGTGAAGTGGCTCACGCCTGTAATCCCAGCAGTTTGGGAGGCCAAGGCGGGCCAATCACGAGGTCAGGAGTTCGAGACCAGCCTGGCCAATATGGTGAAACCCCGTCTCTATTAAAAATTCAAAAATTAGCTGGATGTGGTGGCAGGCACCTACAATCCCAGCTACTTGGAAGGCTGAGGCAGGAGAGTCTGCTTGAAACCAGAAGGCGGAGGTTGCAGTGAGTGAGCTGAGAACGTGCCACTGCACTCCAGCCTGGGCGAAAGAGCAAAACGCTGTCTCAGGGGGAAAAAAAAAACTAGCCGGGCATGGTGGCAGGTGCCTGTAATCCCAGCTACTCAGGAGGCTGAGGCAGGAGAATTGCTTGAACCCAGGAGGAGGAGGTTGCAGTGAGTCGAGATCACGTCATTGCACTCCCAGCCTGGCTGATAAGAGCGAAACTCCGTCAAAAAAAAAAAAAAA","GGCTGGGCGCAGTGGCTCACACCTGTAATCCCAGCACTTAGGGAAGCTGAGGCGAGTAGATCACCTGAGGTCAGGAGTTAGAGACCAGCCTGGCCATCATGGTGAAACCCCGTCTCTACTAAAGATACCAAAAATTAGCTGAGTGTGGTGCTGGGTGCCTGTAATCCCAGAAACTCAGGGTGCCTGTAATCCCAGCAACTCAGGGTGCCTTTAATCCCAGCAACTGAGGGTACCAGTAATCCCAGCAACTCAGGGTGTCTTTAATCCTAGCAACTGAGGGCACCTGTAATCCCAGCAACTCAGGAAGCTGAGACAGGAGAAGTACTTGAACCCAGAAGGCAGAGGTTGCAGTGAGCCGATATTGCACCATTGCACTCCAGTCTGGGCAACAAGAGTGAAACTCTGTCTCAAAAAAAAA"
"chr14","83813857","83814442","JH378118","18053084","18053501","240","65760773","GGCCAGGCGCGGTGGCTCACGCCTGTAATCCCAGCACTTTGGGAGGCCGAGGCGGGCGGATCACCTGAGGTCAGGGGTTCAAGACCAGCCTGACCATCCCAGAACTTTGGGAGGCCGAGACGGGTGGATCATGAGGTCAGGAGATCGAGACCATCCTGGCTAACACAGTGAAACCCCATCTCTATTAAAAATACAAAAAATTAGCCGGGCGTGGTGGCAGCTCCTGTAGTCCCAGCTACTCGGGAGGCTGAGGCAGGAGAATGGCGTGAACCCGGGAGGCGGAGCTTGCCGTGAGCCGAGATCGCACCACTGCACTCCAGCCTGCAAGATAGCGAGGCTATGTCTCAGGAAAAAAAAAAAAAAAAAAAAAAAGACCAACCTGACCAACATGGTAAAACCCCATCTCTACTAAAAATACAAAATTAGCCGGGCATGGTGGCAGACGCCTGTAATCCCAGCTACTCAGGAGGCTGAGGCAGGAAAATCACTTGAACCCAGGAGGTGGAGGTTGCGGTGAGCCGAGATCGTGCCATTGCACTCCGGCCTGGGTGACAACAGCGAAACTCCATCTCAAAAAAAAGAAAAA","GGCTGGGCGCAGTGGCTCACACCTGTAATCCCAGCACTTAGGGAAGCTGAGGCGAGTAGATCACCTGAGGTCAGGAGTTAGAGACCAGCCTGGCCATCATGGTGAAACCCCGTCTCTACTAAAGATACCAAAAATTAGCTGAGTGTGGTGCTGGGTGCCTGTAATCCCAGAAACTCAGGGTGCCTGTAATCCCAGCAACTCAGGGTGCCTTTAATCCCAGCAACTGAGGGTACCAGTAATCCCAGCAACTCAGGGTGTCTTTAATCCTAGCAACTGAGGGCACCTGTAATCCCAGCAACTCAGGAAGCTGAGACAGGAGAAGTACTTGAACCCAGAAGGCAGAGGTTGCAGTGAGCCGATATTGCACCATTGCACTCCAGTCTGGGCAACAAGAGTGAAACTCTGTCTCAAAAAAAAA"
"chr14","84224287","84224910","JH378118","18053084","18053501","265","66171203","GGCAGGGTGCAGTGGCTCATACCTGTAATCCCAGCACTCTGGGAGGCCGAGGTGGGCAGATCACTTGAGCTCAGGAGTTTGAGACCAGCCTGGCCAACATAGTGAAACCCCATCTCTACTAAAAATACAAAATTAGGCTGGGCACAGTGACTCACGTCTGTAATCCCAGCACTTTGGGAGGCCGAGGCTGGTGGATCACAAGGTCAGGAGATCAAGACCATCCTGTCCAACATAGTGAAACCCCATCTCTACTAAAAATACAAAAATTAGCTGGACGTGGAGGTGCACATCTGTAGTCCCAGCTACTTGTGAGGCTGAGGCAGGAGAACTGCTTGAACCCAGGAGGCGGAGGCTGCAGTGAGCTGAGATTGTGCCACTGCACTCCAGCCTGGGCGACAGAGCGAGACTCTGTCTCAAAAAAAAAAAAAAACAGAAAAAACAAAATTAGCCGGGCATGGTGGTGCACGCCTGTAACCCCAGCTACTTGGGGGGCTGAGGCAGGAGAATTGCTTGAACCTGAGAGGTGGAGGTTTCAGTGAGCCGAGATTGTGCCATTGCCCTCCAGTCTGGGCAACAAGAGCAAAACTCCGTCTCAAAAAAAAAAAAAAGAAAAAAAAAGAAGAA","GGCTGGGCGCAGTGGCTCACACCTGTAATCCCAGCACTTAGGGAAGCTGAGGCGAGTAGATCACCTGAGGTCAGGAGTTAGAGACCAGCCTGGCCATCATGGTGAAACCCCGTCTCTACTAAAGATACCAAAAATTAGCTGAGTGTGGTGCTGGGTGCCTGTAATCCCAGAAACTCAGGGTGCCTGTAATCCCAGCAACTCAGGGTGCCTTTAATCCCAGCAACTGAGGGTACCAGTAATCCCAGCAACTCAGGGTGTCTTTAATCCTAGCAACTGAGGGCACCTGTAATCCCAGCAACTCAGGAAGCTGAGACAGGAGAAGTACTTGAACCCAGAAGGCAGAGGTTGCAGTGAGCCGATATTGCACCATTGCACTCCAGTCTGGGCAACAAGAGTGAAACTCTGTCTCAAAAAAAAA"
"chr14","85020958","85021268","JH378108","34510794","34511096","52","50510164","GCCAGGTGCAGTGGCTCATGCCTGTAATTCCAGTACTTTGAGAGGTCGAGACAGGGAGATCACCTGAGGCCAGGAGTTCAAGACTAGCTTGGCCAACATGGCAAAACCCTGTCTCTACTAAAAATGCAAAAAAAAAAAAAAAAAAAAAAAAAAAATTAGCCTGGCATGGTGGTAGACACCTGTAATCCCAGCTACTTGGGAGGCTGAGACAGGAGAACCTCTTGAATCTGGGAGGAGGAGGTTGCTGTGAGCTGAGATCGTGCCACTGCACTCCAGCCTGGGTAACAAGAGAGAAACTCTGTCTCAAAAAA","GGGTGCCGTGTCTCATGCCTGTAATTCCAGCACTTTGGGAGGTCAAGGCAGTCCGATCACCTGAGGTCAGGAGTTTGAGACTAGCCTGGCCAAAATGGTGAAACCCTGTCTCTAGAAAAAATACAAAAAAAAAAAAAAAAAAAAAAAAAAATTAGCTGGATGTAGTGGTGCATACCTGTAGTCCCAGCTACTCTGGAGGCTGAGGCAGGAGAATTGTTTGAACCCAGGAGGCGGAGGTTGCGGTGAGCCGAGATCATGCCATTGCACTCCAGCCTGGGAAACAAGAGTGAAACTCTGTCTCAA"
"chr14","86696589","86696920","JH378203","2698403","2698735","56","83998186","GGCCAGGCACGGTGGCTCATGCCTATAACCAGCACTTTGGAGGCCGAGGCAGGTGGATCACCTGAGGTCAGGAGTTTGAGACTGGCCTGGCCAGCATGGTGAAACTCTGTCTCTACTAAAAAAAAAAAAAAAAAAAAAAAAAAAAAAGTACAAAATTAGCTGGATGTGGTGGTAGGCACCTGTAATCCCAGCTACTTGGGAGGCTGAGGCAGGAGAATCGCTTGAACCCAGGAGGCAGAGATTGCAGTGAGCCAAGATTGCGCCATTGTACTCCACTCTGGGCAATGAGCGAAACTCCGTCTCAAAAAAAAAATAAAATAAAAATAAAATAA","GCCGGGTGCAGTGGCTCATACCTCTAATCCCAGCACTTTGGGAGGCCAAGGCAGGTGATCACCTGTGGTCAGGAGTTCGAGACCAGCCTGGCCAACATGGTGAAACCCTGTCTTTACTAAAAATACAAAAAAAAAAAAAAAAAAAAAAAAAAAAAACTTAGCCCACCATGGTGGTGGGCTCTTGTAGTCCCAGCTACATGGGAGGCTGAGGCAGAAGAATCGCTTGAAGACAGGAGGTGGAGGTTGCAGTGAGCCAAGACTGCGCCATTGCACTCAGCCTGGGTGACGAGCCAAACTCCATCTCAAAAAAAAAAAAAAAAAAAAAAAAAAAAA"
"chr14","86944567","86945185","JH378118","18053084","18053501","274","68891483","GAGCACGGTGGCTCACGCCTGCAATCCCAGCACTTTGGGAGGCCGAGGTGGGTGGATCACCTGAGGTTAGGAGTTTGAGACCAGCCTGGCCAACATGGTGAAACCGTCTCTACTAAAAATGCAAAAAAGTAGGGGCCGGGCACGGTGGCTCACGCCTGTAATCCCAGCACTTTGGGAGTCTGAGGCAGACGGATCACAAGGTCAGGAGATCAAGACCATGGTGAAACTCCGTCTCTACTAAAAATACAAAAAATTAGCTGGGCGTGGTGGTGGGCACCTGTAGTCCCAGCTGCTTGGGAGGCTGAGGCAGGAGAATGGTGTGAACCCGGGAGGCGGAGCTTGCAGTGAGCCGAGATCGCAACACTGCACTCCAGCCTGGGCGACAGAGCGAGACCCTGTCTCAAAAAAAACAAAAATAAACAAAAATAAATAAATACAAAAAAGTAGCCAGGCATGGTGGTGGGTGCCTGTAATCCCAGCTACTTGGGAGGCTGAGGCAGGAGAATCACCTGAACCCGGGAGGTGGAGGTTGCAGTGAGCCAAGACCGTGTCATTACACTCTAGCCTGGGCAACAAGAGCGAAATTCCATCTGAAAAAATAAATAAATAAAAATAAAAA","GGCTGGGCGCAGTGGCTCACACCTGTAATCCCAGCACTTAGGGAAGCTGAGGCGAGTAGATCACCTGAGGTCAGGAGTTAGAGACCAGCCTGGCCATCATGGTGAAACCCCGTCTCTACTAAAGATACCAAAAATTAGCTGAGTGTGGTGCTGGGTGCCTGTAATCCCAGAAACTCAGGGTGCCTGTAATCCCAGCAACTCAGGGTGCCTTTAATCCCAGCAACTGAGGGTACCAGTAATCCCAGCAACTCAGGGTGTCTTTAATCCTAGCAACTGAGGGCACCTGTAATCCCAGCAACTCAGGAAGCTGAGACAGGAGAAGTACTTGAACCCAGAAGGCAGAGGTTGCAGTGAGCCGATATTGCACCATTGCACTCCAGTCTGGGCAACAAGAGTGAAACTCTGTCTCAAAAAAAAA"
"chr14","87180871","87181803","JH378118","18053084","18053501","547","69127787","GGCCATGTGCGGTGGCTCACACCTGTAATCCCAGCACTGTGGGAGGCCAAGGTGGGCGGATCATTTGAGGTCAGGAGTTCTAAACCAGCCTGGCCAATATGGTGAAACACTGTCTCTGCTAAAAATACAAAAAAAGAAAAAGAAAAAAAAAAAAAGGCTGGGCACGGTGGCTCACGCCTGTAATCTCAGCACTTTGGGAGGCTGAGGTGGGTGGATTACCTGAGGTCAGGAGTTCGAGACCAGCCTGGCCAACATGGTGAAACCTTGTCTCTACTAAAAGTATAAAAATTAGCCAGGTGTGGTGGAGGTCGCCTGTAATCCCAGCTACTCAGTAGGCAGAGGCAGAAGAATCCGTTGAACCTGGGAGGCGGAGGTTGCAGTGAGCTGAGATTGCACCAGTGCATTCCAGCCCGGGTGACAAGAGTGAGACTCTGTCTCAAAATAAACAAACAAAAAAATTAGTGGGCCGGGTTCAATGACTCACGCCGGTAATCCCAGCACTTTGGGAGGCCAAGGAAGGCAGGTCACCTGAGGTCGGGAGCTCGAGACCAGCCTGACCAACATGGAGAAACCCCGTCTCTACTAAAAATACAAAATTAGCTGGGCGTGGTGGCACATGCCTGTAATTCCAGCTACTCAGGACGCTGAGGCAGGAGAATTGCTTGAACCCAGGAGGCGGAAGTTGCAGTGAGCCAAGATCATGACATTGCACTCCCGCCTGGGCGCCAAGAGTGAGATTTCGTCTCAAACAAACAAACAAAAAAACGAATTAGTGGAGCGTGGTGGCAGGCACCTAAAGTCCCAGCTATTCAGGAGGCTGAGGCAGGAGAATTGCTTGAACCTGGGAAGTGGAGGTTATAGTGAGCTGAGATCGCGCCATTGCACTCCAGCCTGGGCAACAAGAGTGAGAATCTGTCTAAAAAAAAAAAAGAA","GGCTGGGCGCAGTGGCTCACACCTGTAATCCCAGCACTTAGGGAAGCTGAGGCGAGTAGATCACCTGAGGTCAGGAGTTAGAGACCAGCCTGGCCATCATGGTGAAACCCCGTCTCTACTAAAGATACCAAAAATTAGCTGAGTGTGGTGCTGGGTGCCTGTAATCCCAGAAACTCAGGGTGCCTGTAATCCCAGCAACTCAGGGTGCCTTTAATCCCAGCAACTGAGGGTACCAGTAATCCCAGCAACTCAGGGTGTCTTTAATCCTAGCAACTGAGGGCACCTGTAATCCCAGCAACTCAGGAAGCTGAGACAGGAGAAGTACTTGAACCCAGAAGGCAGAGGTTGCAGTGAGCCGATATTGCACCATTGCACTCCAGTCTGGGCAACAAGAGTGAAACTCTGTCTCAAAAAAAAA"
"chr15","7203590","7204226","JH378118","18053084","18053501","285","10849494","GGCCAGGTGCAGTGGCTCATGCCTCTAATCCCAGCACTTTGGGAGGCCGAGATGGGCAGATCACCGGAGGTCAGGAGTTTGAGACCAGCTTGGCCAAAATGGTGAAACCCTGTCTCTACAAAAAAATACAAAAATGGCTAGGCACGGTGGCTCACACCTGTAATCCCAGCACTTTGGGATACAGGTGGATCATGAGGTCAAGAGATCAAGATCATCTTGGCCAACATGGCAAAACCCTGTCTCTACTAAAAAATACAAAAAATTAGCTGGGCGTGGTGGTGCACGCCTGTAGTCCCAGCTACTCAGGAAACTGAGGCAAGAGAATCGCTTGAACCTGGGAGGTAGAGGTTGCAGTGAGCCGAGATGCACTCCAGCCTGGCAACAGAACAAGACTCCATCTCAAAGAACAAAAACAAAACAAAACAAAACAAAAGACAAGCAAACAAAAAAATACAAAAATTAGCTAGGTGTGGTGGCAGGCGCCTGTAATCCCAGCTACTCAGGAGGCTGAGGCAGGAGAATCGCTTGAACCTGGGAGGCGGAGGTTGCAGTGAGCCAAGATTGTGCCATTGCACTCCAGCCTAGGTGACAAGAGTGAAAAGACGTCTCAAAAACAAAACCAAAAAAAAAAATAAAA","GGCTGGGCGCAGTGGCTCACACCTGTAATCCCAGCACTTAGGGAAGCTGAGGCGAGTAGATCACCTGAGGTCAGGAGTTAGAGACCAGCCTGGCCATCATGGTGAAACCCCGTCTCTACTAAAGATACCAAAAATTAGCTGAGTGTGGTGCTGGGTGCCTGTAATCCCAGAAACTCAGGGTGCCTGTAATCCCAGCAACTCAGGGTGCCTTTAATCCCAGCAACTGAGGGTACCAGTAATCCCAGCAACTCAGGGTGTCTTTAATCCTAGCAACTGAGGGCACCTGTAATCCCAGCAACTCAGGAAGCTGAGACAGGAGAAGTACTTGAACCCAGAAGGCAGAGGTTGCAGTGAGCCGATATTGCACCATTGCACTCCAGTCTGGGCAACAAGAGTGAAACTCTGTCTCAAAAAAAAA"
"chr15","13675429","13675731","JH378235","1186107","1186418","53","12489322","GGCTTGGCACAGTGGCTCATGCCTGTAATCCCAGCACTTTGAGAGACCGAGGCAAGTGGATCCCAGGAGTTCAAGACCAGCCTGGCCAAGATGGTGAAACCCCCCATCTCTACTAAAAATACAAAAAAAAAAAAAAAAAAAAAAAAAGGGCTTAGTGGCTGGCAGCTGTAGTCCCAGCTACTCGGGAGGCTGAGGCAGGAGAATCGCTTGAACCTGGGAAGCGGAGGTTGCAGTGAGCCAAGATCACACCATTGCACTCTAGCCTGGGCAACAAGGGCAAAACTCCATCTCAAAAAAAAAGAA","GGCTGGGCGCAGTGGCTCAAGCCTGTAATCCCAGCACTTTGGGAGGCCGAGGGGGGTGGATCACGAGGTCAAGAGATCAAGACCATCCTGGTCAACATGGTGAAACCCCGTCTCTACTAAAAAAAAAAAAAAAAAAAAAAAAAAAAAAAAAAAATTAGCTGGGCATGGTGGCGTGTAATCCCAGCTACTCAGGAGGCTGAGGCAGGAGAATTGCCTGAACCCAGGAGGCGGAGTTTGCGGTGAGCCAAGATCGCGCCATTGCACTCCAGCCTGGGTAACAAGAGCAAAACTCTGTCTCAAAAAAAAAAAAAA"
"chr15","14837014","14837358","JH378137","13677298","13677634","59","1159716","GCCGGGTATGGTGGCTCATGCCTGTAATTCCAGCACTTTGGGAGGCCGAGGCAGGCGGATCACCTGAGGTCAGGAGTTTGAGACCAGCCTGGCTAACATGGTGAAACTACGTTTCTACTAAAAATACAAAAAAAAAAAAAAAAAAAAAAAAAAAAAAAAAAAAAAAAAAAATTAGCCAGGCGTGGAGGCGCGTGCCTATAATCCCAGTTACTCGGGAGGCCGAGGCAGGAGAATCGCTTGAACCCAGGAGCCGGAGGGTGTAGTGAGCCGAGATCATGCCATTGCGCTCCAGGTTGGGCAACAAGAGCAGAACTCCGTCTCAAAAAAAAAAAAAAAAAAAAAAAA","GGCTGGGCATTGTGGCTCATGCCTGTAATCCCAGCACTTTGGGAGGCCGAGGTGGGCGGATCACCTGAGGTCGGGAGTTCAAGACCAGCCTGGCCACAATGGTGAAACTCTGTCTCTGCTAAAAAAAAAAAAAAAAAAAAAAAAAAAAAAAAAAAAAAAATTAGCCAGGCGTGGTGGCACACGCCTGTAATCCCAGCTATTTGGGAGGCTGAGGCAGGAGAATCGCTTGAACCTGAGAGGTGGAGGTTGCAGTGAGCCAAGATCATACCATTGCACTCCAGCTTGGGAACAAAGAGCAAAACGCCATCTCAAAAACAAAACAAACAAACTGAAAAAA"
"chr15","20684723","20685060","JH378262","266823","267148","57","20417900","GGCTGGGCGTGTTGGCTTACACCTGAAATCCCAGCACTCTGGGAGGCCGAGGCGGGCAGATCACCTGAGGTCAGGGGTTCGAGACCAGCTTGGCCAACATGGTGAAACCCCGTCGCTACTAAAAATACAAAAATTAGCTGGGCATGGTGGTGGGAGCCTGTAATCCCAGCTACTCAGGAGACTGAGGCAGGACAATCGCTTGAACCCAGGAGGCAGAGGTTGCAGCGAGCCGAGATCGTGCCACTGCACTCCAGCCTGGGAGGGAAGAGTGAAAGTCCATAACAACAACAAAACAACAAAACAACAACAACAACAACAACAACATCTCTGAAAGGAAA","GGCCGGGCGCGGTGGCTCAAGCCTGTAATCCCAGCACTTTGGGAGGCCGAGGCGGGTAGATCATGAGGTCAGGAGTTTGAGACCAGCCTGGCCAACATGGTGAAACCCCGTCTCTACTAAAAATACAAAAATTAGCCGGGCATGGTGGCCTGTGCCTGTAATCCTAGCTACCCAGGAAGCTGAGGCAGGAGAATTGCCTGAACCCAGGAGGCGGAGGTTGCGGTGAGCCGAGATCGTGCCATTGCACTCCAGCCTGGGTAACAAGAGCGAAACTCCGTCTCAAAAACAAACAAACAAACAAACAAAAACAAAAAACAAAAAACAAA"
"chr15","20894395","20894976","JH378119","32351107","32351490","257","11456712","GGTGGCTCACACCTGTAATCCCAGCACTTTGGGAAGCCGAGGTAGGTGGATCACCTGAGGTCAGGAGTTAGAGATCAGCCTGGACAACATGGTGAAACCCCATCTCTACTAAAAATACAAAAACTAACCAGGCTTGGTGGCTCACACCTGTAATCCCATCACTTTGGGAGGCCAAGGCGGGTGGACTACTTGAGGTCAGGAGTTTGAGACCAGCCTGGCTAACATGGTGAAACCCCATCTCTACTAAAAATACAAAAATTAGCTGGGCATGGCAGTGCGCGCCTGCAATCCCAGCTACCTGGGAGGCTAAGGCAGGGGAATTGTTTGAACCTGGGAGGCAGAGGTTGCAGTGAGCCGACACTGCACCACTGCACTCCAGCCTGGGTGACAGAGTGAGCCTCCGTCTCAAAAAAAAAAAAAAAAAAAAAAAAAAATTAGCCAGGTGTGGTGGCAGGCACCTGTGATCCCAGCTACTCAGGAGGCTGAGGCAGGAGAATTGCTTGAACCCAGGAGGCGGAGAGTGCAGTGAGCTGAGATCATGCCATTGCACTCCAGCCTGGGTGACAAGAGAGAAACTCTGTC","GGCCAGGTATGGTGGCTCACACCTGTAATCCCAGCACTTTGGGAGGCCAAGGCAGGCAGACCACCTGAGGTCAGGAGTTCGAGATCAGCCTAGCCAACATGGTGAAACCCCATCTCTAGTAAAAATAAAATTAGCCAGGCATGGTGGTGCATGCCTGTAACGCAGGTCAGGAGTTCGAGATCAGCTTAGCCAACATGGTGAAACCCCATCTCTAGTAAAAATAAAATTAGCCAGGCAGGTGGTGCCGCCTGTACTCGGGAGGCTGAGGCAGGAGAATCACTTGAACCCAAGAGGCAGAGGTTGCAGTCAGCCAAGATCATGCCATTGCACTCCAGCCTAAGCAAAAAGAGTAAAACTCAGTCTCAAAACAAAAAAACAAAAAAA"
"chr15","21092189","21092737","JH378206","6546474","6546861","200","14545715","GCCGGGCGTGGTGGCTCACGCCTGGCCTGTAATCCCAGCACTTTGGGAAGCCAAGGCGGGTGGTTCACCTGAGGTCAGGAGTTCAAGACCAGCCTGGCCAACATGGTGAAACCCTGTCTCTACTAATAATACAAAAATTAGCTGGGCATGGTGGTGCATGCCTGTAATCCCAGCTACTTGGGAGGCCGAGGCGAGCAGATCACCTGAGGTCAAGAGTTCGATACCAGCCTGACCAACATAGAGAAACCCCGTCTCTACTAAAAATGCAAAATTAGCCGGGCATGGTGGTGCATGCCTGTAATCCCCAGCTACTCGGGAGGCTGAGGCAGGAGAATCGCTTGAACCTGGGAGGCAGAGGTTGTGGTGAGCTGAGATCACGCCATTGCACTCCAGCCTGGGCTCGAAACTCCATCTTAAAAAAAAAAAAAAAAAAAAGAATCACTTGAACCCAGGAGGTGGAGGTTGCAGTGAGCTGAGAGTGCACCATTGTACTCCAGCCTGGGCGACAACAGCAAAACTCCATCACCTTAAAAAAAAAAAAAAAAAAGA","GGCCACACATGGTGGCTAACGCCTGTAATCCCAGCACTTTGGGAGGCCAAGTCGGGTGGATCATGAGGTCAGGAGACCAAGACCATCCTGGCCAAATGGTGAAACCCCGTCTCTACTAAAAATACAAAAATTAGCTGGGCATGGTGGCGTGTGCCTGTAATCCCAGCTACTCAGGAGGCTGAGGCAGGACAATTGCCTGAACCCAGGAGAATTAGCTGGGCATGGTGGCGTGTGCCTGTAATCCCAGCTACTCAGGAGGCTGAGGCAGGACAATTGCCTGAACCCAGGAGGCGAAGGTTGCGGTGAGCCGAGATTGTGCCATTGCACTCCAGCCTGGGTAACAAGAGCGACACTCTGTCTCAAAAAAAAAAAAAAAAAAAAAAAAAAA"
"chr15","21150084","21150391","JH378158","10397018","10397312","55","10753066","GGCCGGGCATGGTGGCTTATGCCTGTAATCCCAGCACTTTGGGAGGCTGAGGTGGGTGGATCACCTGAGGTCAGGAGTTCAAGACCACCCTGGTCAACATGGCAAAATCCTGTCTCTACTAAAAATACAAAATTAGCTGGGCGTGGTGGTGGGCGTCTGCCTGGGTGAGGCAGGAGAATCGCTTGAACCCAAGAGGCAGAGGTTGGAGTGAGCCAAGATCGTGCCATTGCACTCCAGCCTGGGCAACGAGAGTGAAACCCCATCTCAGAAAAAAAAAAGAAAAAGAAAAAGAAAAAAGTAAAAAAAAA","GGCTGAGCACAGTGGCTCACACCTGTAATCCCAGCACTTTGGGAGGCCGAGGCGGGTGGATCACCTGAGATCAGGAGTTCAAGAACAGCCTGACCAACATGGTGAAACCTATCTCTACTAAAAATACAAAATTAGCCTGGCATGGTGGCGCGTGCCTGTAATCTGGCTGAGGCAGAAGAATCGCTTAAACCCAGAGGCAGAGATTGCAGTGAGCCAAGATTGTGTCATTGCACTCCAGCCTGGGCAACAAGAGCAAAACTCCATCTCAGAAAAAAAAAAAAAAAGAAGAAAAAAA"
"chr15","21563578","21564184","JH378118","18053084","18053501","255","3510494","GGCCAGGCATGGTGGCTCACACCTGTAATCGCAGCACTTTGGGAGACTGAGGCAAGCAGATCACCTGAGGTTAGAAGTTCAAGACCAGCCTGGCCAACACAGTGAAACCCCATCTCTACTAAAAATACAAAAAAATGGCCGGGTGCAGTGGCTCATGCCTGTAATCCCAGCACTTTGGGAGGCTAAGGCAGGGGGAATCACAAGGTCAAGAGATCAAGACCATCCTGGTAAAACCCCGTCGGTACTAAAAATACAAAAATTAGCTGGGTGAGGTGGCATGCACCTGTAGCCCCAGCTACTCGGGAGGCTGAGACAGGAGAATCACTTGAACCTGGGAGGCAGAGGTTGCAGTGAGCTGAGATCGCACCACTGCACTCCAGCCTGGCAACAGAGGAAGACTCTGTCTAAAACTAATAATAATAATAATAATAATAATAAAATTAGCTGGGAGTAGTGGCGGGCACCTGTAATCCCAGCTACTTGGGGGGGCTGAGGCAGGAGAAAAGCTTGAACCCGGGAGGTGAAGGTTGCAGTAAGCCAAGATCACGCCATTGCACTCCAGCCCGGGCAACAAGAGCGAAACTTCGTTTCAAAAAAAAAAAAAAAA","GGCTGGGCGCAGTGGCTCACACCTGTAATCCCAGCACTTAGGGAAGCTGAGGCGAGTAGATCACCTGAGGTCAGGAGTTAGAGACCAGCCTGGCCATCATGGTGAAACCCCGTCTCTACTAAAGATACCAAAAATTAGCTGAGTGTGGTGCTGGGTGCCTGTAATCCCAGAAACTCAGGGTGCCTGTAATCCCAGCAACTCAGGGTGCCTTTAATCCCAGCAACTGAGGGTACCAGTAATCCCAGCAACTCAGGGTGTCTTTAATCCTAGCAACTGAGGGCACCTGTAATCCCAGCAACTCAGGAAGCTGAGACAGGAGAAGTACTTGAACCCAGAAGGCAGAGGTTGCAGTGAGCCGATATTGCACCATTGCACTCCAGTCTGGGCAACAAGAGTGAAACTCTGTCTCAAAAAAAAA"
"chr15","22132229","22132799","JH378118","18053084","18053501","233","4079145","GGAGGCCAAGGTGGGCGAATCACCGGTGGTCAGGAGTTTGAGACTAGCCTGGCCAACATGGTGAAACCCCGTCTCTACTAAAAAATACAAAAATTAGGCCGAGTGTGGTGGCTCATGCCTGTAATCCCAGCAGTTTGGAAGGCCAAGGCGGGCAGATCACCTGAGGTCAGGAGTTCAAGACCAGCCTGGCCAACACAGTGGAACCCTGTCTCTACTAAAAATACAAAAAAAATTTGCCAGGCATGGTGGTGTGTGTGCCTATAATCCCAGCTACTCAGGAGACTGAGGCAAGAGAACTGCATGAACCCCAGAGGGAGAGGCTGCAGTGAGCTGAGATCGTACCACTGCACTCCAGCCTGGGTGACAGGGCAGGACTCCGTCTCAAAAAAAAAAAAAAAAAAAAAAAATTAGCCAGGTGTGGTGGCGAGCACCTGTAATCCTAGGTACTTGGGAGGCTGAGAAAGGAGAACCACTTGAACCCCGGAGGCAGAGGTTGCAGTGAGTGGAGATTGTGCGCCATTGCACTCCAGCCTGGGTGACAAGTGTGAAATTCTGCCTCAAAAAAAAAAAA","GGCTGGGCGCAGTGGCTCACACCTGTAATCCCAGCACTTAGGGAAGCTGAGGCGAGTAGATCACCTGAGGTCAGGAGTTAGAGACCAGCCTGGCCATCATGGTGAAACCCCGTCTCTACTAAAGATACCAAAAATTAGCTGAGTGTGGTGCTGGGTGCCTGTAATCCCAGAAACTCAGGGTGCCTGTAATCCCAGCAACTCAGGGTGCCTTTAATCCCAGCAACTGAGGGTACCAGTAATCCCAGCAACTCAGGGTGTCTTTAATCCTAGCAACTGAGGGCACCTGTAATCCCAGCAACTCAGGAAGCTGAGACAGGAGAAGTACTTGAACCCAGAAGGCAGAGGTTGCAGTGAGCCGATATTGCACCATTGCACTCCAGTCTGGGCAACAAGAGTGAAACTCTGTCTCAAAAAAAAA"
"chr15","23508255","23508883","JH378118","18053084","18053501","275","5455171","GGTCGGGTGTGGTGGCTCATGCATGTAATCCTGGCACTTTGGGAGGCCGAGGCGGGTAGATCACCTGAGGTCACGAGTTTGAGACCAGCCTGACCAACATGGTAAAACTTTGTTTCTACTACAAATACAAAAAATTGGCCAGGCTCGGTGGCTTCCGCCTGTAATCCCAGCACTTTGGGAGGCCGGGGTGCATGGATCACCTGAGGTCAGGACTTCGAGACCAGCCTGGCCAACATGGTGAAACCCCATCTCTACTAAAAATACAAAAAAAAAAAAAAAAATGAGCCAGGCATATTGGTGGGCGCCTGTAATCCCAGCTACTTGGAAGGCTGAGACAGGAGAATCACTTGAACCTGGGAGGCGGAGATTGCAGTGAGCCGAGATCATGCCACTGTACTCCATCCTGGGTGACAAGAGTGAGACTGCATCTCAAAAAAAAAAAAACCAAAAAACCAAAAAAAAACAAAAAATTAGTCAACCGTAGTGGTGGGCCCCTATAATCTCAGCTGCTCAGGAGGCTGAGGCAGTAGAATCACTTGATCCCAGGAGGTGGAGGTTTCAGTGAGCTGAGATCATGCCATTGTACTCCAGCCTGGGCAACAAGAGCGAAACTCTATCTCAAAAAATAA","GGCTGGGCGCAGTGGCTCACACCTGTAATCCCAGCACTTAGGGAAGCTGAGGCGAGTAGATCACCTGAGGTCAGGAGTTAGAGACCAGCCTGGCCATCATGGTGAAACCCCGTCTCTACTAAAGATACCAAAAATTAGCTGAGTGTGGTGCTGGGTGCCTGTAATCCCAGAAACTCAGGGTGCCTGTAATCCCAGCAACTCAGGGTGCCTTTAATCCCAGCAACTGAGGGTACCAGTAATCCCAGCAACTCAGGGTGTCTTTAATCCTAGCAACTGAGGGCACCTGTAATCCCAGCAACTCAGGAAGCTGAGACAGGAGAAGTACTTGAACCCAGAAGGCAGAGGTTGCAGTGAGCCGATATTGCACCATTGCACTCCAGTCTGGGCAACAAGAGTGAAACTCTGTCTCAAAAAAAAA"
"chr15","23602365","23603005","JH378118","18053084","18053501","286","5549281","GGTCGGGTGTGGTGGCTCATGCATGTAATCCTGGCACTTTGGGAGGCCGAGGCGGGTAGATCACCTGAGGTCACGAGTTTGAGACCAGCCTGACCAACATGGTAAAACCTTGTTTCTACTACAAATACAAAAAATTGGCCAGGCTCGGTGGCTTCCGCCTGTAATCCCAGCACTTTGGGAGGCCGGGGTGCATGGATCACCTGAGGTCAGGACTTCGAGACCAGCCTGGCCAACATGGTGAAACCCCATCTCTACTAAAAATACAAAAAAAAAAAAATGAGCCAGGCATATTGGTGGGCGCCTGTAATCCCAGCTACTTGGAAGGCTGAGACAGGAGAATCACTTGAACCTGGGAGGCGGAGATTGCAGTGAGCCGAGATCATGCCACTGTACTCCATCCTGGGTGACAAGAGTGAGACTGCATCTCAAAAAAAAAAAAAACCAAAAAACCAAAAAAAACCAAAAAATTAGTCAACCGTAGTGGTGGGCCCCTATAATCTCAGCTGCTCAGGAGGCTGAGGCAGTAGAATCACTTGATCCCAGGAGGTGGAGGTTTCAGTGAGCTGAGATCATGCCATTGTACTCCAGCCTGGGCAACAAGAGCAAAACTCTATCTCAAAAAAAAAAAAAAAAAAGAAAAA","GGCTGGGCGCAGTGGCTCACACCTGTAATCCCAGCACTTAGGGAAGCTGAGGCGAGTAGATCACCTGAGGTCAGGAGTTAGAGACCAGCCTGGCCATCATGGTGAAACCCCGTCTCTACTAAAGATACCAAAAATTAGCTGAGTGTGGTGCTGGGTGCCTGTAATCCCAGAAACTCAGGGTGCCTGTAATCCCAGCAACTCAGGGTGCCTTTAATCCCAGCAACTGAGGGTACCAGTAATCCCAGCAACTCAGGGTGTCTTTAATCCTAGCAACTGAGGGCACCTGTAATCCCAGCAACTCAGGAAGCTGAGACAGGAGAAGTACTTGAACCCAGAAGGCAGAGGTTGCAGTGAGCCGATATTGCACCATTGCACTCCAGTCTGGGCAACAAGAGTGAAACTCTGTCTCAAAAAAAAA"
"chr15","23603280","23603615","JH378109","21565230","21565567","55","2038050","GGCCAGGCGCGGTGGCTCATGCCTATAAACTCAGCACTTTGAGAGGCTGAGGCGGGTGGGTCACCTGAGGTCAGGAGTTAGAGACCAGCCTGGCCAACATGGTGAAACCGTGTTTCTACTAAAGATACAACATTAGCCAGGCATGGTGGCGCATGCCTGTAATCCCAGCTACTAGGGAGGCTGCGGCAGGAGAATCGCTTGAACGCAGGAGGTGAAGGTTGCAGTGAGCTGAGATCGTGCCATTGCACTCCAGCCTGGGTGACAAGAGCGAAACTCCATCCCAATCAATCAATCAATCAATCAATCAATTAAATTAAAAAAATAAAAAGAAAGAAA","GGCCGGGCGCGGTGGCTCAAGCCTGTAATACCAGCACTTTGGGAGGCCGAGGCGGGTGGATCACGAGGTCAAGAGATCGAGACCATCCTGGTCAACATGGTGAAACCCCGTCTCTACTAAAAATACAAACAATTAGCTGGGCATGGTGGCGGGTGCCTGTAATCCCAGCTACTCCAGAGGCTGAGGCAGGAGAATTGCCTGAACCCAGGAGACGGAGGTTGCGGTGAGCCAAGATCGCGCCATTGCACTCCAGCCTGGGTGACAAGAGCGAAACTCCGTCTCAATAAATAAATAAATAAATAAATAAATAAAAATAAAATAAATAAATAAATAAATAA"
"chr15","38315253","38315599","JH378169","5922203","5922541","56","32393050","GCCAGACACGGTGGCTCACGCCTGTAATCCCAGCACTTTGGGAGGCCGAGGCGGGTGGATCACCTGAGGTCAGGAGTTCGAGACCAGCCTGGCCAACATGGCGAAATCCTGTCTCTACTAAAAATACACACACACACACACACACACACACACACACACACACACATACACACACAAAATTAGCTGGGCATGGTGGCAGGTGCCTGTAATCCCAGCTACTTGGGAGGCTGAGGCAGGAGAATCACTTGAACCTGGGAGGCGGAGATTGCAGTGAGCCAAGATCATGCCATTGCACTTCAGCCTGGGCAACGAGAGTGAAACTCTGTCTCAAAAAAAAAAAAAAAAAA","GGCCAAGGGTGGTGGCTCACACCTGTAATCCCAACACTCTGGGAGGCCAAGGTGGGTGGATCACCTAAGGTCAGGAGTTCAAGACCAGCATGGCCAATATAGTGAAACTCTGTCTCTACTAAAAATACACACACACAAAAAAAAACAAAACACAAAAAAAACCACAAAATTAGCCGGGCATGGTGGCATGTGCCTGTAATCCCAGCTACTCAGGAGGCTGAGGCAGGAGAATCACTTAAACCCAGGAAGCGGAGGTTGCAGTGAGCCAAGATTGCGCCACTGCACTCCAGCCTAGGTGACAAGAGCAAAACTCTGTCTCAAAAAAAAAAAAAAAAAAAA"
"chr15","39410478","39411079","JH378118","18053084","18053501","249","21357394","GGCCGGGCACGGTGGCTCACGCCTGTAATCCCAGCACTTTGGGAGTCTGAGGTGGGCAGATCCACCTGAGGTCAGGGGTTCAAGACCAGCATGGCCAACATGGTGAAACCTCATCTCTACTAAAAATACAAAAATTAGGCTGGGTGCGGTGGCTCACGCCTGTAATCCCAGCACTTTGGGAGGCCAAGGCAGGTGGATCACCTGAGGTCAGGAGTTCGAGACCAGCATGGCCAACATAGCGAAAATCCGTCTCTACTAAAAACACAAAAATTAGCCAGGTGTGTTGGCTTACACCTGTAATCCCAGCTACACAGGAGGCTGAGGCAGAAGAATCACTTGAATCCAGGAGGTGGAGGTTGCAGTGAGCCGAGATCGCGCCACTGCCCTCCAGCCTGGGTGACAGAGCAAGACACCATCTCAAAAAAAAAAAAAAAAAAATTAGCTGGGCATGGTCACAGGTGCCCCTAATCCCAGCTACTCAGGAGGCTGAGGCAGGAGAATTGCTTGAACCCAGGAGACGGAGGTCACAGTGAGCGGTAATTGTGCCATTGCACTTCAACCTGGGTGACAAGAGCAAAAGTCCATCTCAAAAAAAAAAAAAA","GGCTGGGCGCAGTGGCTCACACCTGTAATCCCAGCACTTAGGGAAGCTGAGGCGAGTAGATCACCTGAGGTCAGGAGTTAGAGACCAGCCTGGCCATCATGGTGAAACCCCGTCTCTACTAAAGATACCAAAAATTAGCTGAGTGTGGTGCTGGGTGCCTGTAATCCCAGAAACTCAGGGTGCCTGTAATCCCAGCAACTCAGGGTGCCTTTAATCCCAGCAACTGAGGGTACCAGTAATCCCAGCAACTCAGGGTGTCTTTAATCCTAGCAACTGAGGGCACCTGTAATCCCAGCAACTCAGGAAGCTGAGACAGGAGAAGTACTTGAACCCAGAAGGCAGAGGTTGCAGTGAGCCGATATTGCACCATTGCACTCCAGTCTGGGCAACAAGAGTGAAACTCTGTCTCAAAAAAAAA"
"chr15","45225530","45226131","JH378133","19690365","19690767","253","25535165","GGCCGGGCACAGTGGCTCATGCCTGCAGTTCCAGCACTTTTGGAGGCCGAGGCAGGCCGATCACTTGAGGTCAGGAGTTCGAGACCACCCCGGCTAACGTGGTGCAACTCCATCTCTACTAAAAATACAAAATTGGCCGGGTGCGGTGGCTCATGCCTGTAATCCCAGCACTTTGGGAGGCCGAGGCGGATGGATCACCTCAGGTCAGGAGTTCGAGACCAGCCTGGCCAATGTGGTGAAACCCCGTCTCTACTAATAATACAAAAATTAACTGGGTGTGGTGGTGGGCACCTATAATCCCAGCTACTCGGGAAGCTGAGGCAGGAGAATCACTTGAACCTGGGAGGTGGAGATTGCAGTGAGCTGAGATGGTGCCATTACACTCCAGCCTGGGCAACGAGAGTGAAACTCTGTCTCTAAATAAATAAATACAAAATTAGCCGGGCATGGTGGCGGATGCCTATAATCACAGCTACTTGGGAGGCTGAGGCAAGAGAATCACTTGAACCTGGGAGGTGGAGGTTGCAGTGAGCTGAGATCAAGCCATTGCACTCCAGCCTGGGCAAAAAGAGTGAAACTCTGTCTCAAAAAAAAGAAAGAAA","GGCCAGGCACAGTGGTTCATGTCTGTAATCAGCATTTTGGGAGGCTGAGGCGGGAGAATCACCTGAGGCCAGGAGTTCTAGATGAGCCTGGGCAAATAGTGACAACCTGTCCCTACAAAAAAATTTAAAATTAGCCAGGATTGAGACCATCCTGGCTCACGTGGTGAAACCCCATCTTTACTTAAAATACTTAAAATGCAAAAAACATTTTTTTTTGTATTTTATTTAAAATACAAAAAAACTAGGCAGGCATGTTGGCACGTGCCTGTAGTCCCAGATACTTGGGAGGCTGAGGCAAGAGAATCACTTGAACCCAGGAGGTGGAGGTTGCAGTGAGCCGAGATCATACCACTGCACTCCAGCCTGGGTGACAAGAGTGAAACTCTGTCTCAAAAAAAAACAA"
"chr15","46581057","46581661","JH378118","18053084","18053501","254","28527973","GGCCGGGCGCGGTGGCTCACGCCTGTAGTCCCAGACTTTGGGAGGCCGAGGTGGGCGGATTGCCTGAGGTCAGGAGTTCAAGACCAACCTGGCCAACATGGTGAAATGCCGTCTCTACTAAAAATACAAAAATTAGGCCGGGCACGGTGGCTCATGTCTATAATCCCAGCACTTTGGGAGGCCGAGGTGGGCGGATCACGAGGTCAGGAGATCGAGACCATCCTGGCTAACACGGTGAAACCCCGTCTCTACTAAAAACACAAAAAATTAGCCGGGCGTGGTGGCAGGCACCTGTAGTCTCAGCTACTCAGGAGGCTGAGGCAGGAGAATGGCGTGAACTTGGGAGGCGGAGCTTGCAGTGAGCCAAGATTGTGCCACTGCACTCCAGCCTGGGCAACAGAGCGAGACTCTGTCTCAAAAAAAAAAAAAAAAATTAGCCAGGTGTGGTGGCAGGTGCCTGTAATCCCAGCTAATTGGGAGGCTAAGGCAGGAGAATCTCTTGAACCCAGGAGGCAGAGGTTGCAGTGAGCCAAGATTTCGCCATTACACTCCAGCCTGGGCAACAAGAGCTAGACTCCATCTCAAAAATAAATAAATAAAATAAA","GGCTGGGCGCAGTGGCTCACACCTGTAATCCCAGCACTTAGGGAAGCTGAGGCGAGTAGATCACCTGAGGTCAGGAGTTAGAGACCAGCCTGGCCATCATGGTGAAACCCCGTCTCTACTAAAGATACCAAAAATTAGCTGAGTGTGGTGCTGGGTGCCTGTAATCCCAGAAACTCAGGGTGCCTGTAATCCCAGCAACTCAGGGTGCCTTTAATCCCAGCAACTGAGGGTACCAGTAATCCCAGCAACTCAGGGTGTCTTTAATCCTAGCAACTGAGGGCACCTGTAATCCCAGCAACTCAGGAAGCTGAGACAGGAGAAGTACTTGAACCCAGAAGGCAGAGGTTGCAGTGAGCCGATATTGCACCATTGCACTCCAGTCTGGGCAACAAGAGTGAAACTCTGTCTCAAAAAAAAA"
"chr15","46659994","46660594","JH378118","18053084","18053501","247","28606910","GCTGGGCATGGTGGCTTACGCCTGTAATCCCAGCACCTTGGGAGGCTGAAGTGAGCAAATCACCTGAGTTCAGGAGTTCAAGACCAGCCTGGCCAACATGGTGAAAACCCATCTCTATTAAAAATTACAAAAATGGCCAGACACGGTAGCTCACGCCTGTAATCCCAGCACTTTGGGAGGCTGAGGCGGGCAGATCACCTGAGGTTGGGAGTTGGAGACCAGCTTGACCAACATGGAGAAACCCCCTCTCTACTAAAAATACAAAATTAGCCAGGCGTGGTGGCACATGCCTGTAATCCCAGCTACTTGGGAGGCTGAGGCAGGAGAATCACTTCAACCCGGAAGGTGGAGGTTGTGGTGAGCTGAGATTGTGTCATTGCACTCTAGCCTGGATAACAAAGGCAAAACTCAGTCTCAAAAAAAAAAAAAATTACAAAAATTAGCTGGCGTGGTGGCAGGTGCCTATAATCCCAGCTACTCAGGAAGCTGAGGCAGGAGAATCACTTGAAACCAGGAGGCAGAGGTTGCAGTGAGCTGAGACCACGCCATTGCCCTCCTGCCTGGGTGACAAGAGTGAAACTCCATCTCAAAAAAAAAAAAA","GGCTGGGCGCAGTGGCTCACACCTGTAATCCCAGCACTTAGGGAAGCTGAGGCGAGTAGATCACCTGAGGTCAGGAGTTAGAGACCAGCCTGGCCATCATGGTGAAACCCCGTCTCTACTAAAGATACCAAAAATTAGCTGAGTGTGGTGCTGGGTGCCTGTAATCCCAGAAACTCAGGGTGCCTGTAATCCCAGCAACTCAGGGTGCCTTTAATCCCAGCAACTGAGGGTACCAGTAATCCCAGCAACTCAGGGTGTCTTTAATCCTAGCAACTGAGGGCACCTGTAATCCCAGCAACTCAGGAAGCTGAGACAGGAGAAGTACTTGAACCCAGAAGGCAGAGGTTGCAGTGAGCCGATATTGCACCATTGCACTCCAGTCTGGGCAACAAGAGTGAAACTCTGTCTCAAAAAAAAA"
"chr15","46772064","46772669","JH378118","18053084","18053501","251","28718980","GGCTGGGTGCAATGGCTCATGCCTGTAATTCCAGTGTTTTGGGAGGCCGAGGCAGGTGGATCACTTGAGATCAGGAGTTCGCGACCAACCTGGCTAACATGGTGAAACCCCGTCTCTACTAAAAATACAAAAAATTGGCCAGGAGCGGTGGCTCAAACCTGTAATTCCAGCACTTTGGGAGGCCGAGGGGGGCAGATCACGATGTTTAGGAGTTTGAGATCAGACTGACCAACATGGTGAAACCCCATCTCTACTAAAAATACAAAAATTAGCCAGGCGTGGTGGTGCATGTCTGTAATCCCAGCTACTTGGGAGGCTGAGGCAGGAGAGTTGCTTGAAGCCGGGAGGTGGAGGTTGCAGTGAGCTGAGATCACACCACTGCACTCCAGCCTGGGCGACAGAGCAAGACTGTCTCAAAAAAAAAAAAAAAAAAAAAAATTAGCCAGCTTGGTGGCGGGCATCTGTAATCCCAGCTACTCGGGAGGCTGAGGCAGGAGAATCACTTGAACCCAGGAGGCAGAGGTCGCAGTGAGCCAAGATCACGCCATTGTACTCCAGCCTGGGCAACAAGAGCAAAACTCCATCTCAAAAAACAAAAAATAAAAA","GGCTGGGCGCAGTGGCTCACACCTGTAATCCCAGCACTTAGGGAAGCTGAGGCGAGTAGATCACCTGAGGTCAGGAGTTAGAGACCAGCCTGGCCATCATGGTGAAACCCCGTCTCTACTAAAGATACCAAAAATTAGCTGAGTGTGGTGCTGGGTGCCTGTAATCCCAGAAACTCAGGGTGCCTGTAATCCCAGCAACTCAGGGTGCCTTTAATCCCAGCAACTGAGGGTACCAGTAATCCCAGCAACTCAGGGTGTCTTTAATCCTAGCAACTGAGGGCACCTGTAATCCCAGCAACTCAGGAAGCTGAGACAGGAGAAGTACTTGAACCCAGAAGGCAGAGGTTGCAGTGAGCCGATATTGCACCATTGCACTCCAGTCTGGGCAACAAGAGTGAAACTCTGTCTCAAAAAAAAA"
"chr15","48446925","48447526","JH378118","18053084","18053501","252","30393841","GGCCAAGTGCAGTGGCTCACGTTTGTAATCCCAGCACTTTGGGAGGCCGAGGCGGGTGGATCACCTGATGTCAGGGGTTTGAAACCAGCCTGGCCAACATGGTGAAACCCCATCTCTAATAAAAATACAAAACTGGCCAGGTGCAGTGGCTCATGCCTGTAATCCCAGCACTTTGAGAGACCAAGGGAGGCAGATCACCTGAGGTCAGGAGTTCCAGACCAGCCTAGCCAACATGGTGAAACCCTATCTCTACTAAGAGTACAAAAATTAGCCTGGCGTGGTGGCAGGCGCCTGTAATCCCAGCTACTCAGAAGGCTGAGGCAGGAGAATCACTTGAACCCAGGAGGCGGAGGTTGCAGTGAGCCGAGATTGAGCCACTACACTCCAGCCTGGGTGACAAGAACAAGACTCTGTCTCAAAAAAAAAAAAAAAAAAAGCCGGTCATGGTGGCACATGCCTATAATCCCAGCTTCTTGGGAGGCTGAGGCAGGAGAACCACTTGAACCTGGGAGGTGGAGGCTGCAGTGAGCCGAAATTGTGCCATTGCACTCTAGCCTGGGCAACAAGAGCAAAACTCTCTCAAAAAAAAAAAAAAAAAAAAA","GGCTGGGCGCAGTGGCTCACACCTGTAATCCCAGCACTTAGGGAAGCTGAGGCGAGTAGATCACCTGAGGTCAGGAGTTAGAGACCAGCCTGGCCATCATGGTGAAACCCCGTCTCTACTAAAGATACCAAAAATTAGCTGAGTGTGGTGCTGGGTGCCTGTAATCCCAGAAACTCAGGGTGCCTGTAATCCCAGCAACTCAGGGTGCCTTTAATCCCAGCAACTGAGGGTACCAGTAATCCCAGCAACTCAGGGTGTCTTTAATCCTAGCAACTGAGGGCACCTGTAATCCCAGCAACTCAGGAAGCTGAGACAGGAGAAGTACTTGAACCCAGAAGGCAGAGGTTGCAGTGAGCCGATATTGCACCATTGCACTCCAGTCTGGGCAACAAGAGTGAAACTCTGTCTCAAAAAAAAA"
"chr15","59372839","59373447","JH378118","18053084","18053501","260","41319755","GGCCAGGATCAGTGTCTCACACCTGTAATCCTAGCACTTTGGGAGGCTAAGGTGGGCGGATTACTTGAGGTCAGGAGTTTGAGACCAGCCTGGGCAACATGGTGAAACCCCGTCTCTACTAAAAATACAAAAATTAGCTGGGCATAGGCCAGGAGTGGTGGCTTACGCCTGTAATTCCAGGACTTTGGGAGGCTGAGGCGGGCAGATCATGAGGTCAGGAGATTGAGACCATCCTGGCTAACATGGTGAAACCTCATCTCTACTAAAAATACAAAAATTAGCCAGTCGTGGTGGTAGGCGCCTGTAGTCCCAGCTACTTGAGAGGCTGAGGCAGGAGAATCACTTGAATCCGGGAGGTGGAGGTTGCAGTGAGCCGAGATTATGCCACTTCACTCCAACCTGGTGACAGAGCAAGACTCCGTCTAAAAAAAAAAAAAAAAATTAGCTGGGTGTGGCGGGCACTTGCAATCCCAGCTACTTAGGAGGCTGAGGCAGGAGAACCGCTTGAACCTGGGAGGTAGAGGTTCCAGATCACGCCATTGCACTCCTGCTTGGGCAACAAGAGTGACACTCCATCTCAAAAAAACAAAAAAAAAAAAGAAAAAGAAA","GGCTGGGCGCAGTGGCTCACACCTGTAATCCCAGCACTTAGGGAAGCTGAGGCGAGTAGATCACCTGAGGTCAGGAGTTAGAGACCAGCCTGGCCATCATGGTGAAACCCCGTCTCTACTAAAGATACCAAAAATTAGCTGAGTGTGGTGCTGGGTGCCTGTAATCCCAGAAACTCAGGGTGCCTGTAATCCCAGCAACTCAGGGTGCCTTTAATCCCAGCAACTGAGGGTACCAGTAATCCCAGCAACTCAGGGTGTCTTTAATCCTAGCAACTGAGGGCACCTGTAATCCCAGCAACTCAGGAAGCTGAGACAGGAGAAGTACTTGAACCCAGAAGGCAGAGGTTGCAGTGAGCCGATATTGCACCATTGCACTCCAGTCTGGGCAACAAGAGTGAAACTCTGTCTCAAAAAAAAA"
"chr15","64220715","64221335","JH378118","18053084","18053501","268","46167631","CCAGGCACAGTGGCTCATACCTGTAATCCCAGCACTTTGGGAGCCCAAGGCGGGCAGATCACCTGAGGTCAGGAGTTCGAGACCAGCCTGGACAACATGGAGAAACTCCATCTCTACTAAAAATACAAAATGAGGCCGGGCACAGTGGCTCACACCTATAATCCCAGCACTTTTGGAGGCCGAGACAGGCAGCTCACGAGGTCAGGAGTTCAAGACCAGCCTGGCCAGCATGGTGTAACCCCGTTTCTACTAAAAATACAAAAATTAGCCAGGCATGGTGGTGCGTGCCTGTAGTCCTCAGGAGGCTGAGGCAGGAGAATCGCTTGAATCTGGGAGGCGGAGCTTGCAGTCAGCTGAGATCAGGCTACTGCACTGCAGCTTGGGCAACAGAGTGAGACTCCGTCTCAAAAACAAACAAACAAACAAACAAAACACAACAAAATTAGCTGGGCATGGTGGCAGGTGCCTGTAATCCCAGCTACTCAGCTACTCAGGAGGCTGAGGCAGGAGAGTCACGTGAACCTGGGAGGCAGAGGTTGCAGTGAGCCAAGATCACGCCATTGCACTCCAGCCTGGGCAACAAGAGGGAAATTACATCTCAAAAAAAAAAAAAAAAAAAAA","GGCTGGGCGCAGTGGCTCACACCTGTAATCCCAGCACTTAGGGAAGCTGAGGCGAGTAGATCACCTGAGGTCAGGAGTTAGAGACCAGCCTGGCCATCATGGTGAAACCCCGTCTCTACTAAAGATACCAAAAATTAGCTGAGTGTGGTGCTGGGTGCCTGTAATCCCAGAAACTCAGGGTGCCTGTAATCCCAGCAACTCAGGGTGCCTTTAATCCCAGCAACTGAGGGTACCAGTAATCCCAGCAACTCAGGGTGTCTTTAATCCTAGCAACTGAGGGCACCTGTAATCCCAGCAACTCAGGAAGCTGAGACAGGAGAAGTACTTGAACCCAGAAGGCAGAGGTTGCAGTGAGCCGATATTGCACCATTGCACTCCAGTCTGGGCAACAAGAGTGAAACTCTGTCTCAAAAAAAAA"
"chr15","65873443","65873774","JH378165","3784440","3784761","45","62089003","GGCCAGGCACGGTGGCTCACACGTGTAATCCCAGCACCTTGGGAGACCGAAGCAGGTGGATCACCTGAGGTCAGGAGTTTGAGGCCAGCCTGGCCGATATGGTGAAACCCTATCTCTATTAAAAATACCAAAAAAAAAAAAAAAAAAAAAAAAACCTGCTGGGCGTGGTGGCGCACGCCTGTAATCCCAACTACTCAGGAGGCTGAGGCAGGAGAATCACTTGAATCCAGGAGGCAGAGGTTGCAGTGAGCCGAGATCGCGCCATTGCACTCCAGCCTGGGCAACAAGAGCGAAACTCGGTCTCAAAAAAAAAAAAAAAAAAAGAAAAGAAA","GGCCGGGCGCGGTGGCTCAAGCCTGTAATCCCAGCACTTTGGGAGGCCGAGGCAGGTGGATCATGAGGTCAAGAGATCAAGACCATCCTGGTCAACATGGTGAAACCCCGTCTCTACTAAAAATACAAAAAAAAAAAAAAAAAAACTAGCTGGGCGTGGTGGCGCATGCCTGTAATCCCAGCTACTCAGGAGGCTGAGGCAGGAGAATTGCTTGAACCCAGGAGGCGGAGGTTGCGGTGAGCCCAGATCGCGCCATTGCACTCCAGCCTGGGTAACAAGAGCAAAACTCCATCTCAAAAAAAAAAAAAAAAAAAAAAAAAAA"
"chr15","70453292","70453944","JH378118","18053084","18053501","292","52400208","GGCCAGGCACGGTGGCTCATGCCTGTAATCCCAACACTTTGGGAGGCTGAGGTAGGTAGATCACCTGAGGTTGAGGTCAGGAGTTTGAGACCAGCCTGGCCAACATGGTGAAACTCTGTCTCTACTAAAAATACAAAAATTTGGCCCGGCGCAGTGGCTCACCTGTAATCCCAGCACTTTGGGAGGCCGAGGCAGGCAGATCACGAGGTCTGGAGATCAAGACCATCCTGGCTAACTCGGTGAAATCCCATCTCTACTAAAAATACGAAAAATTAGCCAGGTGTGGTGGCGGGCACCTGTAGTCCCAGCTACTTGGGAGGCTGAGGCAGGAGAATGGCGTGAACCTGGGAGGTGGAGCTTGCAGTGGGCCAAGATCACGCCACTGCACTCCAGCCTGGGCAACAGAGTGAGACTCTGTCTCAAAATAAAATAACATAAAATAAAATAAAGTAATATAAAATAAAAATACAAAAATTAGCTGGGCATGGTAGCGGGTACCTATAATTCCAGCTACTTGAGAGGCTGAGGCTGGAGAATCACTTGAATCTGGGAGGTGGAGGTTGCAGTGAGCCAAGATTGCACCATTGCACTCCAGCCTGGGCAACAAGAGCCAAACTCCGTATCAAAAAAAAAAAAAAAAAGAAAAAGAAAAA","GGCTGGGCGCAGTGGCTCACACCTGTAATCCCAGCACTTAGGGAAGCTGAGGCGAGTAGATCACCTGAGGTCAGGAGTTAGAGACCAGCCTGGCCATCATGGTGAAACCCCGTCTCTACTAAAGATACCAAAAATTAGCTGAGTGTGGTGCTGGGTGCCTGTAATCCCAGAAACTCAGGGTGCCTGTAATCCCAGCAACTCAGGGTGCCTTTAATCCCAGCAACTGAGGGTACCAGTAATCCCAGCAACTCAGGGTGTCTTTAATCCTAGCAACTGAGGGCACCTGTAATCCCAGCAACTCAGGAAGCTGAGACAGGAGAAGTACTTGAACCCAGAAGGCAGAGGTTGCAGTGAGCCGATATTGCACCATTGCACTCCAGTCTGGGCAACAAGAGTGAAACTCTGTCTCAAAAAAAAA"
"chr16","217191","217526","JH378138","4229795","4230103","77","4012604","ATTTTGGGAGGCTGAGATGAGTGATGAGCGGATCACCTGAGGTCAGGAGCTCGAGACCAGTCTGGCCAACACGGTGAAACCCTGTCTCTACTAAAAGTACCAAAAAAATTAGCCAGGCATGGCAGTGGGCGCCTGTAATCCCAACTACTCGGGAGGCTGAGGCAGGAGAATCACTTGAACCTGGGAGGTGGATGTAGCAGTGAGCCGGGATCGTGCCACTGAACTCCAGCCTGGGCGATAAGATCAAAACTCTGTCTCTCTCTCACACACACACACACACACACACACACACACACACACACCCCCAAAAAAAAAAACAAAAAAAAGAAAAAGAAA","CACTTTGGGAGGTGAAGGCGGGCAGATCACCTGAGGTCAGGAGTTCGAGACCAGCCTGGCCAACATGGTGAAACCCCGCCTCTACTAAAAATACAAAAATTAGCCAGGTGTGACACTAGGCATCTGTAATCCCAGCTACTTGGGAGGCTGAGACAGGAGAATCACTTGAACCCAGGAGGCGGAAGTTGCAGTGAGCCAAGATCATGCCATTGCACTCCAGCCTGGGTGACAGGAGCAAAACTCTGTCTCAAAAAAAAAAAAAAAAAAAAAAAAAAAAAAAAAAAAAAAAGAAAAGAAAAGAAAAGTAAA"
"chr16","384893","385508","JH378118","18053084","18053501","265","17668191","GGCCGGGCGTGGTGGCTAACACGGGTAGTCCTAGCACTTTGGGAAGCCAAGGCAGGCAGATCACTTGAGGTCAGGAGTTTGAGATCAGTCTGGCCAACATGGTGAAACCACGCCTCTACTAAAAATACAAAAGTTATGGCCGAGCGTGGTGGCACGCGCCTGTAATCCCAGCACTTTGGGATGCTGAGGCAGGCGCATCACCTAAGGTCGGGAATTCAAGACCAGCCTGACCAACATGGAGAAACCACGTTTCTACTAAAAATACAAAATTAGCCGGGTGTGGTGGCACATGCCTGTAGTTTCAGCTACTCAGGAGGCTGAGGCAGGAGAATCACTTGAATCCGGGAGGCGGAGATTGTGGTGAGCCGAGATCGGGCCATTGCACTCCAGCCTGGGCAACAAGAGAGAAACTCTGTCTCAAAAAAAAAAAAAAAAAATTAGCCAGGCATGGTAGCCTGTGCCTGTAATCCCAGCTACTTGGGAGGCTGAGGCAGGAGAATCGCTTGAACCTGGGAGGCAGAGGTTGCAGTGAGCCGCGATTGCGCCATTGCACTCTCCAGCCTGGGGGAGAAGAGCAAAACTCCATCTCAAAAATAAATAAATAAATAAAAATAAA","GGCTGGGCGCAGTGGCTCACACCTGTAATCCCAGCACTTAGGGAAGCTGAGGCGAGTAGATCACCTGAGGTCAGGAGTTAGAGACCAGCCTGGCCATCATGGTGAAACCCCGTCTCTACTAAAGATACCAAAAATTAGCTGAGTGTGGTGCTGGGTGCCTGTAATCCCAGAAACTCAGGGTGCCTGTAATCCCAGCAACTCAGGGTGCCTTTAATCCCAGCAACTGAGGGTACCAGTAATCCCAGCAACTCAGGGTGTCTTTAATCCTAGCAACTGAGGGCACCTGTAATCCCAGCAACTCAGGAAGCTGAGACAGGAGAAGTACTTGAACCCAGAAGGCAGAGGTTGCAGTGAGCCGATATTGCACCATTGCACTCCAGTCTGGGCAACAAGAGTGAAACTCTGTCTCAAAAAAAAA"
"chr16","1668152","1668787","JH378118","18053084","18053501","287","16384932","GGCCGGGCACGGTGCCTCGTTCCTGTAATCCCAGCACTTTGGGAGGCCAAGGTGGGTGGATCACCTGAGGTCAGGAGTTCGAGACATGCCTGGCCAACATGGCAAAATCCTGTCTTTACTAAAAATACAAAAATTAAGCCGGGCGCTGTGACTCATGCCTGTAATCCCAGCACTTTGGGAGGCCAAGGCGGGCGGATCACAAGGTCAGGAGATTGAGACCATCCTGGCTAACACGGTGAAAACCCGTCTCTACTAAAAATACAAAAAATTAGCCAGGTGTGGTGGCGGGTGCCTGTAGTCCCAGCTACTCGGGAGGCTGAGGCAGGAGAATGGCGTGAACCCGGGAGGCGGAGCTTGCAGTGAGCCGAGATCGTGCCACTGCACTCCAGTCTGGGCAACAGAGCAAGACTCTCTCTCAAAAAGAAACAAACAAAAAAAAAAATGAAAAAAGAAAAATTAGCCAGGCGTGGTGGCGGGTGCCTATAATCTCAGCTACTCGGGAGGCTGAGGCAGAAGTATCATTTGAACCCAGGAGGCGGAGGTTGTAGTGATCCAAGATAGCGCCATTGCACTGCAGCCTGGGTGACAACAGTGAAACTCCGTCTCAAAAAAAAAAAAAAAAAAGAAAGAAAGAAA","GGCTGGGCGCAGTGGCTCACACCTGTAATCCCAGCACTTAGGGAAGCTGAGGCGAGTAGATCACCTGAGGTCAGGAGTTAGAGACCAGCCTGGCCATCATGGTGAAACCCCGTCTCTACTAAAGATACCAAAAATTAGCTGAGTGTGGTGCTGGGTGCCTGTAATCCCAGAAACTCAGGGTGCCTGTAATCCCAGCAACTCAGGGTGCCTTTAATCCCAGCAACTGAGGGTACCAGTAATCCCAGCAACTCAGGGTGTCTTTAATCCTAGCAACTGAGGGCACCTGTAATCCCAGCAACTCAGGAAGCTGAGACAGGAGAAGTACTTGAACCCAGAAGGCAGAGGTTGCAGTGAGCCGATATTGCACCATTGCACTCCAGTCTGGGCAACAAGAGTGAAACTCTGTCTCAAAAAAAAA"
"chr16","2310740","2311369","JH378118","18053084","18053501","271","15742344","GGCCGGGCACAGTGGCTCACGCCTATAATATCAGCACTTTGGGAGACCAAGGCGGGTGGATCACCTAAGGTCAGGAGTTCAAGACCAGCCTGACCAACATGGTGAAACCCCATCTCTACCAAAAATAGAAAACATTAGTCTTGGCCGGGCACGGTGACTCATACCTGTAATTCCAGCACTTTGGGAGGCCGATCACCTGGCGGATCACCTGAGGTCGGGAGTTTGAGACCAGCCTGACCAACATGGAGAAACCCCGTCTCTACTAAAAATACAAAATTAGCTGTGCGTAGTGGCCCATGCGTGTAATCCCAGCTACTCAGGAGACTGAGGCAGGAGAATGGCTTGAACCTGGGAGGCGGAGGTTGTGCTGAGCCAAGATCGCACCATTGCACTCCAGCCTGGGCAATAAGAGTGAAACTCCGTTTCATAAAACAAAAAACAAAAAACAAAAAAAAAACCATTAGCCAGGCATTGTGGCAGGCACCTGTAATCCCAGCTACTCAGGAGGCTGAGGCAGAATGGCTTGAACCGGGGAGGCAGAGGTTGCAGTGAGCCGAGATCGCGCCATTGCACTCCAGCCTGGGCAACAAAAGTAAAACTCTGTCTCAAATAAAAAAAAGAGAGAAAAAA","GGCTGGGCGCAGTGGCTCACACCTGTAATCCCAGCACTTAGGGAAGCTGAGGCGAGTAGATCACCTGAGGTCAGGAGTTAGAGACCAGCCTGGCCATCATGGTGAAACCCCGTCTCTACTAAAGATACCAAAAATTAGCTGAGTGTGGTGCTGGGTGCCTGTAATCCCAGAAACTCAGGGTGCCTGTAATCCCAGCAACTCAGGGTGCCTTTAATCCCAGCAACTGAGGGTACCAGTAATCCCAGCAACTCAGGGTGTCTTTAATCCTAGCAACTGAGGGCACCTGTAATCCCAGCAACTCAGGAAGCTGAGACAGGAGAAGTACTTGAACCCAGAAGGCAGAGGTTGCAGTGAGCCGATATTGCACCATTGCACTCCAGTCTGGGCAACAAGAGTGAAACTCTGTCTCAAAAAAAAA"
"chr16","3075498","3075819","JH378114","26407278","26407597","46","23331780","GGCCAGGCGCGGTGGCTCACACCTGTAATCCCAGCACTTTGGGAGGCCAAGGCGGGCAGATCACGAGGTCAAGAGATCGAGACCATCCTGGCCAACCTGGTGAAACTCTGTCTCTACTAAAAATACCAAAAAAAAAAAAAAAAAAAAAAAAAAAAAGCATGGTGGCAGGTGCCTGTAATCCCAGCTACTTGGGAGGCTGAGGCAGAATTGCTTGAACCCGGGAGGCAGAGGTTGCAGTGAGTTGAGATCATGCCATTGCACTCCAGCCTGGGCAAAAAGAGCGAAACTCTGTCTCAAAAAACAAAACAAAAACAAAAACAAA","GGCCGGGCGCAGTGGCTCAAGCTTGTAATCCCAGCACTTTGGGAGGCCGAGGCGGGTGGATCACGAGGTCAAGAGATCGAGACCATCCTGGTCAACATGGTGAAACCCCGTCTCTACTAAAAATACAAAAAAAAAAAAAAAAAATTAGTTGGGCATGGTGGTGTGTGCCTGTAATCCCAGCTACTCAGGAGGCTGAGGCAGGAGAATTGCCTGAACCCAGGAGGCGGAGGTTGCGGTGAGCCGAGATCGCGCCATTGCACTCCAGCCTGGGTAACAAGAGCGAAACTCCGTCTCAAAAAAAAAAAAAAAAAAAAAAAAAA"
"chr16","3161549","3162150","JH378118","18053084","18053501","252","14891535","CTGGGCACCGTGGCTCACGCCTGTAATCCCAACACTTTGGGAGGCCAAGGCGGGTGGAACACCTGAAGTCAGGAGTTCGAGACCAGTCTGGACAACATGATGAAACCCCGTCTCTACTAAAAATACAAAAAGTAGCCAGGTATGGCCGGGCGCGGTGGCTCACGCCTGTAATCCCGGCACTTTGAGAGGCCGAGGCAGGTGGATCACAAGGTCAGGAGTTCAAGAGCAGCCTGGCCAAGATAGTGAAACCCCGTCTCTACTAAAAGCAAAATTACAGTGCGCCTGTAATCCCAGCTGCTCGGGAGGCTGAGGCAGGAGAATCGCTTGAACCTGGAGGGCGGAGGTTGCAGTGAGCCAAGATCGCTCTACTGCACCCTAGCCTGGGTGACAGAGCAAGACTCTGTATCAAAAAAAAAATAAATAAATAATTAGCCAGGTATGGTGGTGCAGGCTTGTAATCCTAGCTGCTCAGGAGGCTGAGGCAGGAGAATCGATTGAACCCAGGAGACGGAGGTTGCAGTGAGCAGAGATCACACCATTGTACTCCAGCCTGAGTGACAAAAACGAAACTCCGTCTCAAAAAAAAACCAAAAAAACAAAAA","GGCTGGGCGCAGTGGCTCACACCTGTAATCCCAGCACTTAGGGAAGCTGAGGCGAGTAGATCACCTGAGGTCAGGAGTTAGAGACCAGCCTGGCCATCATGGTGAAACCCCGTCTCTACTAAAGATACCAAAAATTAGCTGAGTGTGGTGCTGGGTGCCTGTAATCCCAGAAACTCAGGGTGCCTGTAATCCCAGCAACTCAGGGTGCCTTTAATCCCAGCAACTGAGGGTACCAGTAATCCCAGCAACTCAGGGTGTCTTTAATCCTAGCAACTGAGGGCACCTGTAATCCCAGCAACTCAGGAAGCTGAGACAGGAGAAGTACTTGAACCCAGAAGGCAGAGGTTGCAGTGAGCCGATATTGCACCATTGCACTCCAGTCTGGGCAACAAGAGTGAAACTCTGTCTCAAAAAAAAA"
"chr16","3211652","3212251","JH378118","18053084","18053501","260","14841432","GTCAGACGCAGTAGTTTATGCCTGTAATCCTTGCACTTTGGGAGGCAGGTGGATCACCTGAGGCCAGGAGTTGGAGACCAGCCAGGCCAATATGGCAAAACCCCGTCTCTACTAAAAATACAAAAACTAGCCGGGCGCAGTGGCTCACACCTGTAATCCCAGCACTTTGGGAGGCTGAGGTGGGTGGATCACTAGGTCAGGAGTTCAAGACCAGCCTGGCCAACATGGTGAAACCGCGTCTCTACTAAAAACACCAAAAAATTAGCTGGGCGTGGTGGCAGTCGCCTGTAATCCCTGCTACTCGGAAGGCTGAGGCAGGAGAATCACTTGAACGCAGGAGGCAGAGGTTGCGGTGAGCCGAGATCACGCCACTGCACTCCAGCCTGGGTGACAGAGCAAGACTCTGTCTCAAAAAACAACAACAACAACTAGCTGGGCGTGGTGGCACATGCCTGTAACCCCAGCTACTCAGGAGGCTGAGGCTGAGGGAGAAAAATCGCTTGTACCTGGGAGGTGGAAGTTGCAGTGAGCGGAGATCCCACCATTGCACTCCAGCCTGGGTGACAAGAGCGAAACTCCATCTCAAAAAAAAAAAAAAAA","GGCTGGGCGCAGTGGCTCACACCTGTAATCCCAGCACTTAGGGAAGCTGAGGCGAGTAGATCACCTGAGGTCAGGAGTTAGAGACCAGCCTGGCCATCATGGTGAAACCCCGTCTCTACTAAAGATACCAAAAATTAGCTGAGTGTGGTGCTGGGTGCCTGTAATCCCAGAAACTCAGGGTGCCTGTAATCCCAGCAACTCAGGGTGCCTTTAATCCCAGCAACTGAGGGTACCAGTAATCCCAGCAACTCAGGGTGTCTTTAATCCTAGCAACTGAGGGCACCTGTAATCCCAGCAACTCAGGAAGCTGAGACAGGAGAAGTACTTGAACCCAGAAGGCAGAGGTTGCAGTGAGCCGATATTGCACCATTGCACTCCAGTCTGGGCAACAAGAGTGAAACTCTGTCTCAAAAAAAAA"
"chr16","3990675","3991277","JH378118","18053084","18053501","250","14062409","GGCTGGGCGTGGTGGCTCACGCCTTTAATCCCAGTACTTTGGGAGGCCGAGAAGGGCACATCACCTGAGGTCAGGAGTTTGAGACCAGCCTGGCCAATATGGTAAAACCCTGTCTCTACTTAAAAAATAGAAAAATCAGGCTGGACGCAGTGGCTCACGCCTGTAATCCCAGCACTTTGGGAGGCCGAGGCGGGTGGATCATGAGGTCAGGAGTTACCAGCCTGCCAACATGGTGAAACCCCATCTCTACTAAAAAAACAAAAAAAATTAGCCAGTCGTAGTGGCAGGCACCTGTAATCCCAGCCACTCGGGAGGCTGAGGCAGAGAATTGCTTGAACCTGGGAGGTGGAGATTGCTGTGCACCAAAATCACACCACTGCACTTGAGCCTGGGCGACAGAGGGAGACTCATCTGAAAAAAAAAAAAAAAAAAAAATTAGCCGGTTATGGTGGCAGGTGCCTGTGATCCCAGCTACTTGGGAGGCTGAGGCAGGAGAATTGCTTGAACCCGGGAGGCAGAGGTTGCAGTGAGCTGAGATCGCACCACTGCACTCCAGCCTGGAGGACAAGAGTGAGACTTGTCTGATTGGAAAAAAAAAAAAAA","GGCTGGGCGCAGTGGCTCACACCTGTAATCCCAGCACTTAGGGAAGCTGAGGCGAGTAGATCACCTGAGGTCAGGAGTTAGAGACCAGCCTGGCCATCATGGTGAAACCCCGTCTCTACTAAAGATACCAAAAATTAGCTGAGTGTGGTGCTGGGTGCCTGTAATCCCAGAAACTCAGGGTGCCTGTAATCCCAGCAACTCAGGGTGCCTTTAATCCCAGCAACTGAGGGTACCAGTAATCCCAGCAACTCAGGGTGTCTTTAATCCTAGCAACTGAGGGCACCTGTAATCCCAGCAACTCAGGAAGCTGAGACAGGAGAAGTACTTGAACCCAGAAGGCAGAGGTTGCAGTGAGCCGATATTGCACCATTGCACTCCAGTCTGGGCAACAAGAGTGAAACTCTGTCTCAAAAAAAAA"
"chr16","4259838","4260446","JH378118","18053084","18053501","263","13793246","GGCCGGGTGCAGTGGCTCACGCCTGTAATCGCAGGACTTTGGGAGGCCAAGGCAGGTGCATCACCTGAGGTCAGGATTTCAAGACCATCCAGCCTGATCAACATGGTGAAACCCTGTCTCTACTAAAAATATAAAAATTGGCCGGGCACAGTGACTCACGCCTGTAATCCCAGCACTTTGGGAGGCTGAGGCAGGTGGATCACAAGGTCAGGAGATCGAGACCATCCTGGCTAACACAGTGAAACCCCGTCTCTACTAAAAATATAAAAAATTAGCCGGGCGTGGTGGTAGGCACCTGTAGTCCCAGCTACTCGGGAGACTGAGGCAGGAGAATGGCGTGAACCTGGGAGGTGGAGCTTGCAGTGAGCAGAGATCGCGCCACTGTACTCCAGCCTGGGTGACAGAGCGAGACTCCGTCTCAAAAAAAAAAAAAAAAAAAAAAATTAGCTGGGCGTGGTGGCGGGCACCTGTAATCCCAGCTACTTGGGAGGCTGAGGCAGGAGAATTGCTTGAACCTGGGAAGTGGAGGTTGCAGTGAGCTGAGATTGTGCCCTTGTACTCCAGCCTGGGCAATAAAAGCAAAACTCCGTCTTAAAAAAAAAAAAAAAA","GGCTGGGCGCAGTGGCTCACACCTGTAATCCCAGCACTTAGGGAAGCTGAGGCGAGTAGATCACCTGAGGTCAGGAGTTAGAGACCAGCCTGGCCATCATGGTGAAACCCCGTCTCTACTAAAGATACCAAAAATTAGCTGAGTGTGGTGCTGGGTGCCTGTAATCCCAGAAACTCAGGGTGCCTGTAATCCCAGCAACTCAGGGTGCCTTTAATCCCAGCAACTGAGGGTACCAGTAATCCCAGCAACTCAGGGTGTCTTTAATCCTAGCAACTGAGGGCACCTGTAATCCCAGCAACTCAGGAAGCTGAGACAGGAGAAGTACTTGAACCCAGAAGGCAGAGGTTGCAGTGAGCCGATATTGCACCATTGCACTCCAGTCTGGGCAACAAGAGTGAAACTCTGTCTCAAAAAAAAA"
"chr16","4899850","4900511","JH378118","18053084","18053501","313","13153234","GGCCAGGCACGGTGGCATGCACCTGTAATCTCAGCTCTTTGGGAGGCTGAGGCAAGAGGATCACTTGAGCCCAGGAGTTGGTGATTGCAGTGAGCTCTGATCACTCCACTGCACTCCAGCCTGGGTGACAGAGTGAGATCCTGTCTCTACGAAAAAAAGACAAGACACAAATACGTTAAAAGTAAAATGATATAAAAAGATATTCCAGTGGGGCACAGTGGCTCACCCCTATAATCCCAACACTTTGGGAGGCTGAGGTGGGTGGATCACCTGAGGTCAGGAATTCAAGACCAGCCTGACCAACATGGAGAAACCCGTCTCTACTAAAAATACAAAATTAGCCGGGTGTGGTGGCACATGCCTGTAATCCCAGCTACTCAGGAGGCTGAGAATGGCTTGAACCTGGGAGGTGGAGGTTGTGGTGAGCCGAGATTGCACCACTGCACTCCAGCCTGGGCAACAAGAGCTGAAACTCCGTCGAAAAAAAAAATTAGCCTGGCGTGGTGGCGGGAGCCTGTAATCCCAGCTACTGGGGAGGCTGAGGCAGGAGAATCACTTGAACCTGGGAGGCAGAATTTGCAGTGAGCCGAGATCGCGCCACCACACTCCAGCCTGGGTGACAAAAACGAAACCCCATCTCAAAAAAATTAAAAAATAACAAA","GGCTGGGCGCAGTGGCTCACACCTGTAATCCCAGCACTTAGGGAAGCTGAGGCGAGTAGATCACCTGAGGTCAGGAGTTAGAGACCAGCCTGGCCATCATGGTGAAACCCCGTCTCTACTAAAGATACCAAAAATTAGCTGAGTGTGGTGCTGGGTGCCTGTAATCCCAGAAACTCAGGGTGCCTGTAATCCCAGCAACTCAGGGTGCCTTTAATCCCAGCAACTGAGGGTACCAGTAATCCCAGCAACTCAGGGTGTCTTTAATCCTAGCAACTGAGGGCACCTGTAATCCCAGCAACTCAGGAAGCTGAGACAGGAGAAGTACTTGAACCCAGAAGGCAGAGGTTGCAGTGAGCCGATATTGCACCATTGCACTCCAGTCTGGGCAACAAGAGTGAAACTCTGTCTCAAAAAAAAA"
"chr16","4919663","4920295","JH378118","18053084","18053501","281","13133421","CTGGGCGCAGTGGCTCACACCTATAATCCCAGCACTTTGGGAGGCCGAGGTGGGGTGGATCACTTGAGGTCAGGAGTTTGAGACCAGCCTGGCCAACATGGTGAAACCCCATCTCTTCTAGAAAAATACAAAATTAGGCTGGGCGCGGTGGCTCACGCTTGTAATCCCAGCACTTTGGGAGGCTGAGGCAGGCGGATCATCTGAGGTTGGGAGTTCGAGACCAGCCTGACCAACATAGAGAAACCCTGTCTCTACTAAAAATACAAAATTAGCCGGGCGTGGTGGCGCATGCCTGTAATCCCAGCTAGTCAGGAGGCTGAGGCAGGAGAATCCCTTGAACTGGGGAGGCAGAGGTTGTGGTGAGCCCAGATCGTGCCATTGCACTCCAGCTTGGGTAAGAAGAGCAAAACTCTGTCTAAAAAATATATATATTTATACATATATATATATTTATATATATAATTAGCCACGCATAGTGGCACACACCTGTAACCCCAGCTACCTGGGAGGATGAGGCAGGAGAATAGCTTGAACTTGGGAGGTGGAGGTTGCACTGAGCTGAGACTGCGCCATTGCATTCCAGCCTGGGCAACAAGAGCGAAACTGTCTCAAAAAAAAAAAAAAAAAAAAAAA","GGCTGGGCGCAGTGGCTCACACCTGTAATCCCAGCACTTAGGGAAGCTGAGGCGAGTAGATCACCTGAGGTCAGGAGTTAGAGACCAGCCTGGCCATCATGGTGAAACCCCGTCTCTACTAAAGATACCAAAAATTAGCTGAGTGTGGTGCTGGGTGCCTGTAATCCCAGAAACTCAGGGTGCCTGTAATCCCAGCAACTCAGGGTGCCTTTAATCCCAGCAACTGAGGGTACCAGTAATCCCAGCAACTCAGGGTGTCTTTAATCCTAGCAACTGAGGGCACCTGTAATCCCAGCAACTCAGGAAGCTGAGACAGGAGAAGTACTTGAACCCAGAAGGCAGAGGTTGCAGTGAGCCGATATTGCACCATTGCACTCCAGTCTGGGCAACAAGAGTGAAACTCTGTCTCAAAAAAAAA"
"chr16","5124255","5124811","JH378118","18053084","18053501","213","12928829","GGCCAGGTGCGGTGGCTCATGCGTGTAATCCCAGCGCTTTGGGAGGCTGAGGCAAGTGGATCACCTGAGGTCAGGAGTTTGAGACCAGCCTGGCCAACATGGGGAAATCCCTGTCTCTACTAAAAATACAAAAATTGGGCCGGGTGTGGTGGCTCACACCTGTAATCCCAGCACTTTGGGAGACTGAGGTGGGCGGATCACCCAAGGTCAGGAGTTTGAGACCATCCTGGCCAACATGGTGAAACCCCGTCTCTACTAAATAAATACAAAAAAGTAGCCGAGCGTGTTGGCGGATGCCTGTAATCCCAGCTACTTGGGAGGCTGAGGCAGGAGAATTGCTTGAACCCTGAGAGGTGGAGGTTGCAGTGAGCAGAGATTGTGCCACTGCACTCTGGCCTGGGCGACAAGAGGGAGTCTCTGTCTTAAAAAAAAAAAAAAAAAAAATTAGCTGGAAATCGCTTGAACCCAGGAGGCGGAGGTTGCAGTGAGCCGAGATTGTGCCACTGCACTCTGGCCTGGGCGACAAGAGCGAGATTCTGTCTCAAAAAAAAAAAAGA","GGCTGGGCGCAGTGGCTCACACCTGTAATCCCAGCACTTAGGGAAGCTGAGGCGAGTAGATCACCTGAGGTCAGGAGTTAGAGACCAGCCTGGCCATCATGGTGAAACCCCGTCTCTACTAAAGATACCAAAAATTAGCTGAGTGTGGTGCTGGGTGCCTGTAATCCCAGAAACTCAGGGTGCCTGTAATCCCAGCAACTCAGGGTGCCTTTAATCCCAGCAACTGAGGGTACCAGTAATCCCAGCAACTCAGGGTGTCTTTAATCCTAGCAACTGAGGGCACCTGTAATCCCAGCAACTCAGGAAGCTGAGACAGGAGAAGTACTTGAACCCAGAAGGCAGAGGTTGCAGTGAGCCGATATTGCACCATTGCACTCCAGTCTGGGCAACAAGAGTGAAACTCTGTCTCAAAAAAAAA"
"chr16","8088191","8088522","JH378114","21211700","21212024","70","13123509","GGCTGGGCGCGGTGGCTTTTGACCATAATCCCAGCACTTTGGGAGGCCGAGGTGGTCAGGTCACCTGAGGTCAGGAGTTCAAGAGCAGCCTGGCCAACGTGGTGAAACTCTGTCTCTACCAAAAATACCAAATAATAATAATAATAATAATAATAATAATAAAATAATATAATTGCAGGGTGTGGCAGCCCATGCATGTAATGCCAGCTACTTGGGAGACTGAGGCAGGATAATCACTTCAACCCAAGAGGCGGAGGTTGCAGTGAGCTGAGATCATGCCATTGCATTCCAGCGTAGGCAACAAGAGCGAAACTCTGTTTCAAATAAATAAA","GGCTGGGTGCGGTGGCTCAGGCCTGTAATCCCAGCACTTTGGGAGGCCGAGGTGGGTACATCACCTAAGGTCAGGAGTTCAAGACCAGCCTGACCAACATGGTAAAACCCTGTCTCTACTAAAATTACAAAAGAAAATTAGAAAAAAAAAAAAGAAAGAAAGAAAATTAGATGGCATGGTGGTGGCGGGCACCTGTAATTTCAACTACTCGGGAGGCTAAGGCAGGAGAATCACTTGAACCCAGGAGGTGGAGGTTGCAGTGAGCCGAGATCACACCATTGCACTGCAGCCTGGGCAATAAGAGCAAAACTCCATCTCAAAAAAA"
"chr16","9762791","9763467","JH378118","18053084","18053501","323","8290293","CAGGCATGGTAGCTCACGCCTGTAATCTCAGCACTTTGGGAGGCCGAGGTGCGCAGATCACTTGAGGTCAGGTGTTGGTGACCAGCCTGGCCAACATGGTGAAACCCTATCTCTACTAAAAATACAAAAATTATGGCCGGGCGCAGTGGCTCACGCCTGTAATCCCAGCACTTTGGGAGGCCGAGGTGGGCAGATCACTTGAGGTCAGGAGTTCAAGACCAGCCTAGGCAACATAGTGAAACCCCGTTGCTACTAAAAATACAAAAATTAGCTGGGCGTGATGGCACATACCTGTAGTCCCACCTACTTGGGAGGCTGAGGCAGGAAAATCGCTTGAACCTGGAGGCAGAGGTTGCAGCGAGCCAAGACTGTGCCAATGCACCACAGCCTGGATAACAGAGTGAGACTCAATCTCAAAAAAAAAAAAAAAAAAAAAAGGCGGGCTGGTGGCTCATGCCCATGCAAACCCCGTCTCTACTAAAAGGACAAAAATTAGCTGGGCATGGTGGCGGGGGCCTGTAATCTCAGGATTACAGGAGATACTACTACTCGGGAGGCTGAGGCAGTAGAATTGCTTGAACCAGGGAGGCGGAGGTTGCAGTGAGCTGAGATCGCGCCATTGCACTCCAGGCTGGGTGACAACAATGACTCCGTCTCAAAAACAACAACAACAACAA","GGCTGGGCGCAGTGGCTCACACCTGTAATCCCAGCACTTAGGGAAGCTGAGGCGAGTAGATCACCTGAGGTCAGGAGTTAGAGACCAGCCTGGCCATCATGGTGAAACCCCGTCTCTACTAAAGATACCAAAAATTAGCTGAGTGTGGTGCTGGGTGCCTGTAATCCCAGAAACTCAGGGTGCCTGTAATCCCAGCAACTCAGGGTGCCTTTAATCCCAGCAACTGAGGGTACCAGTAATCCCAGCAACTCAGGGTGTCTTTAATCCTAGCAACTGAGGGCACCTGTAATCCCAGCAACTCAGGAAGCTGAGACAGGAGAAGTACTTGAACCCAGAAGGCAGAGGTTGCAGTGAGCCGATATTGCACCATTGCACTCCAGTCTGGGCAACAAGAGTGAAACTCTGTCTCAAAAAAAAA"
"chr16","9769317","9769634","JH378153","10517405","10517727","57","748088","GGTTGGGCATGGTGGCTCACACCTGTAATGCCAGCACTTTGGGAGGCGGGCAGATCACCTGAGGTCAGGAGTTCAAGACCAGCCTGGCCAACATGGTGAAATCCTGTCATTACAAAAATACAAAAAAAAAAAAAAAAAAAAAAAAAAAAAGCCAGTAATGATAGTGGGTGCGTATAATCCCAGCTACTTTGGAGGCTAAGGCAGGAGACTCACTTGAACCCAGGAGGCGGAGGTTATGGTGAGCCGAGATCACACCATTGCACTCCAGCCTGGGCGACAAGAGCAAAACTCCATCTCAAAAAAAAAAAAAAAAAAAAA","GGCCGGGCGTGGTGGCTCACGCCTGTAATCCCAGCACTTTGGGAGGCCGAGGTGGGTGGATCATGAGGTCAAGAGATCGAGACCATCCTGGTCAACATGGTGAAACCCTGTCTCTACTAAAAAAAAAAAAAAAAAAAAAAAATACAAAAAAATTAGCTGGGCATGGTGGCGCATGCCTGTAATCCCAGCTACTCCGGAGGTTGAGGTAGGAGAATTGCCTGAACCCAGGAGGCGGAGGTTGCGGTGAGCCGAGATCGCGCCATTGCACTCCAGCCTGGGTAACAAGAGCAAAACTCCGTCTCAAAAAAAAAAAAAAAAAAGAA"
"chr16","13753079","13753710","JH378118","18053084","18053501","278","4300005","GGCTGATTGTGATGGCTCACACTTGTAATCCCCTCACTTTGGGAGGCCAAAGCGGGAGCATCACCTGAGGTCAGGAGTTCAAGACCAGCCTGGCCAACATGGTGAAACCCCATCTCTACTAAAAATAAAAAATTAGCTGGGCACAGTGACTCATGCCTGTAATCCCAGCACTTTGGGAGGCCGAGGCAGGCAGATCACAATCACGAGGTCAGGAGTTCGAGACCAGCCTGACCAACATGGTGAAACCCCGTCTCTACTAAAAATAGAAAAATTAGCCAGGCGTGGTGGCACACGCCTGTAATCCCAGCTCCTCAGGAGACTGAGGCAGGAGAATCACTTGAACCCAGGAGGTGGAGGTTGCAGTGAGCAGAGATCGCACCACTGCACTCCAGCCTGGGTAACAGAGTGAGACTCCGTCTCAAAAAAAAAAAAAAAAAAAAAAAAAAAACGAAATTAACCAGGTGTGGTGGCACATGCCTGTAATCCCAGCTACTTGGGAGGCTGAGGCAGGAGAATCGCTTGAACCCGGGAGACAGAGGTTCCAGAGAACTGAGATCATGCCATTGCACTCCAGCCTGGGCAACAAGAGTGAAACTCCATCTAAAAAATAAATAAATACATAAACAAACAAA","GGCTGGGCGCAGTGGCTCACACCTGTAATCCCAGCACTTAGGGAAGCTGAGGCGAGTAGATCACCTGAGGTCAGGAGTTAGAGACCAGCCTGGCCATCATGGTGAAACCCCGTCTCTACTAAAGATACCAAAAATTAGCTGAGTGTGGTGCTGGGTGCCTGTAATCCCAGAAACTCAGGGTGCCTGTAATCCCAGCAACTCAGGGTGCCTTTAATCCCAGCAACTGAGGGTACCAGTAATCCCAGCAACTCAGGGTGTCTTTAATCCTAGCAACTGAGGGCACCTGTAATCCCAGCAACTCAGGAAGCTGAGACAGGAGAAGTACTTGAACCCAGAAGGCAGAGGTTGCAGTGAGCCGATATTGCACCATTGCACTCCAGTCTGGGCAACAAGAGTGAAACTCTGTCTCAAAAAAAAA"
"chr16","13951847","13952482","JH378118","18053084","18053501","292","4101237","GGCCAGGTGCGGTGGCTCATGCCTGTAATCCCAGCACTTTGGGAGGCTATGGCAGCGGATAACCTGAGGTCACAAGTTTGAGACCAGCCTGGCAAACATGGTGAAACCGTCTCTACTAAAAATACAAAAATTACACCAGGCGCGGTGGCTCATGCCTGTAATCCCAGCACTTTGGAAGGCCGAGGCAGGTGGATCATGAGGTCAGGAGATCAAGACCATCCTGGCTAACGCAGTGAAACCCCGTCTCTACTAAAAATATAAAAAATTGGCCAGGCGTGGTGGCGGACGCCTGTAGTCCCAGCTACTCGGGAGGCTGAGCCAGGAGAATGGCGTGAACCCGGGAGGCGGAGCTTGTGGTGAGCCGAGATAGCGCCACTGCACTGCCGCCTGGGTGACAGAGTGAGACTCTGTCTCAAAAAACAAAACAAAACAAAAACCAAAAACAAAAACAAAAAAACAAAAATTAGCCAGGTGTGGTGGTGCACGCCTGTCATCCCAGCTACTTGGGGGGCTGAGACGTGATAATCACTTGAACCCGGGAGGGAGAGGTTGCAGTGAGTGGAGATCACGCCATTGTATTCCAGCCTGGGGGCAAGAGCAAAACTCTGTCTCAAAAACAACAACAACAACAACAAA","GGCTGGGCGCAGTGGCTCACACCTGTAATCCCAGCACTTAGGGAAGCTGAGGCGAGTAGATCACCTGAGGTCAGGAGTTAGAGACCAGCCTGGCCATCATGGTGAAACCCCGTCTCTACTAAAGATACCAAAAATTAGCTGAGTGTGGTGCTGGGTGCCTGTAATCCCAGAAACTCAGGGTGCCTGTAATCCCAGCAACTCAGGGTGCCTTTAATCCCAGCAACTGAGGGTACCAGTAATCCCAGCAACTCAGGGTGTCTTTAATCCTAGCAACTGAGGGCACCTGTAATCCCAGCAACTCAGGAAGCTGAGACAGGAGAAGTACTTGAACCCAGAAGGCAGAGGTTGCAGTGAGCCGATATTGCACCATTGCACTCCAGTCTGGGCAACAAGAGTGAAACTCTGTCTCAAAAAAAAA"
"chr16","19006984","19007584","JH378118","18053084","18053501","263","953900","GGTGGCTGATGCCTGTAAACCCAGCATTTTGGGAGGCCGAGGCTGGTGGATCACCTGAGGTCAGGTGTTCGAGACCAGTCTGGCCAACATGGTGAAACCTCGTCTCTACCAAAAATACAAAAATTAGTTGGGTGTGGCCGGGTGTGGTGGCTTACGCTTGTAATCTCAGCACTTTGGGAGGCCGAGGTGGGTGGATCACGAGGTCAGGAGTTCAAGACCAGCCTGGCCAAGATGGTGAAACCCTGTCTCTACTAAAAATACAAAAAATTAGCCAGGCATGGTGGCGGGTGCCTGTAATCCCAGCTACTCGGGAGGCTGAGGCAGAGAATTGCTTGAACCTGGGAGGTGGAGGTTGCAGTGAGCCGAGATTGTGCCACGACACTCCAGCCTGGGTGACAGAGCGAGACTCTGTCTAAAAAAAAAAAAAAAAATTAGTTGGATGTGGTGGTGGGTGTCTGTAATCTCAGCTACTCAGGAGACTGAATCAGGAGAATCACTTGAACCCAGGGGGCTGGAGGTTGCAGTGAGCCGAGATCTTGCCATTGCACTCCAGCCCGGGCGACAAGAGCAAAACTCTCTTTCAAAAAAAAAAAAAAAAAGA","GGCTGGGCGCAGTGGCTCACACCTGTAATCCCAGCACTTAGGGAAGCTGAGGCGAGTAGATCACCTGAGGTCAGGAGTTAGAGACCAGCCTGGCCATCATGGTGAAACCCCGTCTCTACTAAAGATACCAAAAATTAGCTGAGTGTGGTGCTGGGTGCCTGTAATCCCAGAAACTCAGGGTGCCTGTAATCCCAGCAACTCAGGGTGCCTTTAATCCCAGCAACTGAGGGTACCAGTAATCCCAGCAACTCAGGGTGTCTTTAATCCTAGCAACTGAGGGCACCTGTAATCCCAGCAACTCAGGAAGCTGAGACAGGAGAAGTACTTGAACCCAGAAGGCAGAGGTTGCAGTGAGCCGATATTGCACCATTGCACTCCAGTCTGGGCAACAAGAGTGAAACTCTGTCTCAAAAAAAAA"
"chr16","19554918","19555551","JH378118","18053084","18053501","281","1501834","GGCCGGGCGCAGTGGCTCACACCTGTAATCCCAGCACTTTGGGAGGCCGAGGCGGGTGGATCACTTGAGGTCAGGAGTTCAAGACCAGCCTGGCTGACATGGTGAAACCCTGTCTCTACTGAAAACACAAAAATTAGGCCGGGCATAGTGGCTCATGCCTGTAATACCAGCACTTTGGGAGGCCGAGGTGGGTGGATCACCTGAGGTCAGGAGTTTGAGACCAGCTTGACCAACATGGTGAAACCCCGTCTCTACTAAAAATATAAAAATTAGTCTGGCATGGTGGCAGATGCCTGTAATCCCAGCTACTCAGGAGGCTGAGGCAGGAGAATTGCTTGAACCTGGAAGGTGGAGGTTGTAATGAGCCAAGATCACACCACTGCACTCCAGCCACTGTACTCCAGCCTGGGTGACAGAGTGAGACTCTGTCTCAAAAAACATACATACACACACATACACACACACACACACACACACACAAATTAGCTGGACGTGATAGCACACCCCTGTAGTCCCAGCTGCTTGAGAGACCGAGGCACAAGAATCACACGAACCCGGGAGGCGGAGGTTCCTGTGAGCCAAGATCGCACCATTGTACTCCATTCTGGGTGACAAGAGTGAAGCTCTGTCTCAA","GGCTGGGCGCAGTGGCTCACACCTGTAATCCCAGCACTTAGGGAAGCTGAGGCGAGTAGATCACCTGAGGTCAGGAGTTAGAGACCAGCCTGGCCATCATGGTGAAACCCCGTCTCTACTAAAGATACCAAAAATTAGCTGAGTGTGGTGCTGGGTGCCTGTAATCCCAGAAACTCAGGGTGCCTGTAATCCCAGCAACTCAGGGTGCCTTTAATCCCAGCAACTGAGGGTACCAGTAATCCCAGCAACTCAGGGTGTCTTTAATCCTAGCAACTGAGGGCACCTGTAATCCCAGCAACTCAGGAAGCTGAGACAGGAGAAGTACTTGAACCCAGAAGGCAGAGGTTGCAGTGAGCCGATATTGCACCATTGCACTCCAGTCTGGGCAACAAGAGTGAAACTCTGTCTCAAAAAAAAA"
"chr16","19576859","19577465","JH378118","18053084","18053501","251","1523775","GGCCAGGCATGGTGGCTCACACCTGTAATCCCAGCCCTTTGGGAGGCCGAGGCAGGTGGATCACCTGAGGTCAGGAGTTCGAGACCAGCCTGGCCAACATGGTGACACCCCACTCTACCAAAAATACAAAAATTAGGTTGGGTGCAGCGGTTCACACCTGTAATCCCAGCACTTTGGGAGGCCAAGGTGGATGGATCACCTGAGGTCAGGAGTTTGTGACCAGCCTGGCCAACATGGCGAAACCCTGCCTCTACTAAAAATAAAAAATTAGCCAGGTGTGGTGGCATGCGCCTGTAATCCTAGCTACTGAGGCAGGAGAATCGCTTGGACCAGGGAAGCAGAGTTTGCAGTGAGCCAAGATCACGCCACTGCACTCTAGCCTGGGTGACAGAGTAAGACTCCATCTCAAAAAAAAAAAAAAATACAAATATTAGCTGGGCATGGTGGCGCACACCTGTAGTTCTGGCTACTCAGGAGGCTGAGGCAGGAGAATTGCTTGAACCCAGAAGGCAGAGGTTGCAGTGAGCTGAGATTGTGCCATTGCACTCAGCCTGGGCAACAAAAGTGAAACTCCATCTCAAAATAAATAGATAAATAAATAAATAAA","GGCTGGGCGCAGTGGCTCACACCTGTAATCCCAGCACTTAGGGAAGCTGAGGCGAGTAGATCACCTGAGGTCAGGAGTTAGAGACCAGCCTGGCCATCATGGTGAAACCCCGTCTCTACTAAAGATACCAAAAATTAGCTGAGTGTGGTGCTGGGTGCCTGTAATCCCAGAAACTCAGGGTGCCTGTAATCCCAGCAACTCAGGGTGCCTTTAATCCCAGCAACTGAGGGTACCAGTAATCCCAGCAACTCAGGGTGTCTTTAATCCTAGCAACTGAGGGCACCTGTAATCCCAGCAACTCAGGAAGCTGAGACAGGAGAAGTACTTGAACCCAGAAGGCAGAGGTTGCAGTGAGCCGATATTGCACCATTGCACTCCAGTCTGGGCAACAAGAGTGAAACTCTGTCTCAAAAAAAAA"
"chr16","19983557","19984148","JH378118","18053084","18053501","244","1930473","GGCCGAGTGCGGTGGCTCATGCCTGTAATCCCAGCACTTTGGGAGGCCGAGACAGGTGAATCACCTGAGGTCTGGAGTTTGAGACCAGCTGACCAACATGGTGAAACCCTGTCTCTACTAAAAATACAAAAAATTGGCTGAGCGCAGTGGCCACGCCTGTTATCCCAGTACTTTGGGAGGCCGAGGCGGGTGGATCACGAGGTCAGGAATTCGAGACCAGCCTGACCAACATGGTGAAGCCCCGTCTCTACTAAAAATAAAAAAATTAGCCAGGTGTGGTGGTGCGCCCCTGTAAACCCAGCTACTCAGGAGGCTGAGGCAGGAGAATCACTTGAATCTGGGAGGCGGAGGTTGCAGTGAGCCAAGATCGAGCCACTGTACTCCAGCCTGGGAGACGGAGTGAGACTCCATCTAAAAAAAAAAAAAAATTAGCCAGGCGTGGTGGCACAAGCCTGTAATCCCAGCTACCTGGGAGGCTGAGATAGGAGAATTCCTTGAATCTGGGAGGCGGAGGTTGCAGTGAGCTGAGATTGTGCCATTGCACACCAGCCTGGGTGACAAGAGCAAAATTCCATCTCAAAAAAAAAAAAAA","GGCTGGGCGCAGTGGCTCACACCTGTAATCCCAGCACTTAGGGAAGCTGAGGCGAGTAGATCACCTGAGGTCAGGAGTTAGAGACCAGCCTGGCCATCATGGTGAAACCCCGTCTCTACTAAAGATACCAAAAATTAGCTGAGTGTGGTGCTGGGTGCCTGTAATCCCAGAAACTCAGGGTGCCTGTAATCCCAGCAACTCAGGGTGCCTTTAATCCCAGCAACTGAGGGTACCAGTAATCCCAGCAACTCAGGGTGTCTTTAATCCTAGCAACTGAGGGCACCTGTAATCCCAGCAACTCAGGAAGCTGAGACAGGAGAAGTACTTGAACCCAGAAGGCAGAGGTTGCAGTGAGCCGATATTGCACCATTGCACTCCAGTCTGGGCAACAAGAGTGAAACTCTGTCTCAAAAAAAAA"
"chr16","20117717","20118289","JH378118","18053084","18053501","224","2064633","GGCTGGGTGCGGTGGCTCACGCCTGTAATCCCAGCACTTTGGGAGGCCAAGGCGGGTAGATCATCTGAGGTCAGGAGTTCAAGACCAGCCTGGCCAACATGGTGAAACCCCGTCTCTACTAAAAATATTTTTAAAAGGCCAGGCGTGGTGGCTCACGCCTGTAATCCCAGCACTTTGGGAGGCCGAGGCGGGCAGATCATGAGGTCAGGAGTTCGAGACCATCCTGGCTAACACGGTGAAACCCCCGTCTCTACCAAAAAATACAAAAAATTAGCCGGGCATGGTGGCAGGTGCCTGTAGTCCCAGCTACTCGGGAGGCTGAGGCAGGAGGATGGCGTGAACCCAGGAGACAGAGCTTCCAGTGAGCTGAGATCGTGTCACTGCACTCCAGCCTGGGCGACAGAGGAGATTCTGTCTCAAAAAAAAAAAAAAAAAATTAGCTTGGTGTGGTGGCAGGTGCCTGTAATCCCAGTTACTCGGGAGGCTGAGGCAGAGGTTTCAGTGAACCGAGATCGCGCCATTGCACTCCAGCCTGGGCAACAAGAGTGAAACTCCGTCTCAAAGGAAAAAAAA","GGCTGGGCGCAGTGGCTCACACCTGTAATCCCAGCACTTAGGGAAGCTGAGGCGAGTAGATCACCTGAGGTCAGGAGTTAGAGACCAGCCTGGCCATCATGGTGAAACCCCGTCTCTACTAAAGATACCAAAAATTAGCTGAGTGTGGTGCTGGGTGCCTGTAATCCCAGAAACTCAGGGTGCCTGTAATCCCAGCAACTCAGGGTGCCTTTAATCCCAGCAACTGAGGGTACCAGTAATCCCAGCAACTCAGGGTGTCTTTAATCCTAGCAACTGAGGGCACCTGTAATCCCAGCAACTCAGGAAGCTGAGACAGGAGAAGTACTTGAACCCAGAAGGCAGAGGTTGCAGTGAGCCGATATTGCACCATTGCACTCCAGTCTGGGCAACAAGAGTGAAACTCTGTCTCAAAAAAAAA"
"chr16","20574957","20575888","JH378118","18053084","18053501","543","2521873","GGCCAGGCGTGGTGGCTCATGCCTGTAATCCCAGCACTGTGAGAGGCCGAGGCGGGCGGATCACCTGAGCTGAGGAGTTCGAGACCAGCCTGGCCAACATGGCGAAACCCCATCTCTACTAAAAACACAAAAATTAGGCCAGGTGTGGTGGCTCACACCTGTAATCCCAGCACTTTGGGAGGCCAAGGCGGGCGGATCACCTGAGGTCAGGAGTTCCAGACCTGCCTGGCCAACATGGTGGAATCCCATCTCTACTAAAAATACAAAAATCTGCCAGGTGTGGTGGCACACTTCTGTAATCCCAGATACTCAGGAGGCTGAGGCAGGAGAATCACTTGAACCCTGGAGATGGAGGTTGCAGTGAGCCAAGATCAAGAGATTGCACTCTAGCCAGGGTGACTAGAGTGAGACTCGGTCTCAAAAAAAATGTAATTAATTAATTAATTAATACAAAAATTAGCTGGGCGTGGGCTAGGTGTGGTGGCTCACGCCTGTAATCCCAGCACTTTGGGAGGCCGAGACAGGCGGATCACCTGAGGTCAGGAGTTCAAGACCAGTTTAACCAACATGGAGAAACCCCATCTCTACTAAAAATACAAAATTAGCTGGGCGTGGTGGTGCATGCCTGTAATCCCAGCTACTCGGGAGGCTGAGGCAGAAGAATCGCTTGAGCCTGGTAGGCGGAGATCGTGGTGAGCCGAGATCGCGCCATTGCACTCCAGCCTGGACAACAAGAGCGAAACTCCGTCTAAAAAAAAAAAAAAAATTAGCTGGGCATGGTAACAGGCGCCTGTAAACCCAGTTTCCTCGGGAGGCTGAAGCAGAATTGCTTGATCCCAGAGGCAGAGGTTGCAGTGAGCCAAGATAGTGCCATTGCAGTCCAGCCTGGGCAACAAGAGTGAAACTCCGTCTCAAAAAAAAAAAAAAAAAAA","GGCTGGGCGCAGTGGCTCACACCTGTAATCCCAGCACTTAGGGAAGCTGAGGCGAGTAGATCACCTGAGGTCAGGAGTTAGAGACCAGCCTGGCCATCATGGTGAAACCCCGTCTCTACTAAAGATACCAAAAATTAGCTGAGTGTGGTGCTGGGTGCCTGTAATCCCAGAAACTCAGGGTGCCTGTAATCCCAGCAACTCAGGGTGCCTTTAATCCCAGCAACTGAGGGTACCAGTAATCCCAGCAACTCAGGGTGTCTTTAATCCTAGCAACTGAGGGCACCTGTAATCCCAGCAACTCAGGAAGCTGAGACAGGAGAAGTACTTGAACCCAGAAGGCAGAGGTTGCAGTGAGCCGATATTGCACCATTGCACTCCAGTCTGGGCAACAAGAGTGAAACTCTGTCTCAAAAAAAAA"
"chr16","20816618","20817242","JH378118","18053084","18053501","267","2763534","GGCCCGGCGTGGTGGCTCATGCCTGTAATCCCAGCACTTTGGGAGGCCGAGGCCGGCGGATCACCTGAGGTCAGGAGTTTGAGACCACCCTGGCCAACACGGTGAAAACCTGTCTCTACTAAAAATACAAAAATTAGCCAGGCGCAGTGGCTCACGTCTGTAATTCCAGCACTTTGGAGGGCCGAGGGGGGCAGATCACAAGGTCAGGAGTCCAAGACCAGCCAGGCCAACATAGTGAAACCCGGTCTCTACTAAAAATACAAAAAATTAGCCGGGCGTGGTGGCGGACCCCTGTAGTCCCAGCTACTCAGGAGGCTGAGACAGGAGAATCTCTTGAACCCAGGAGGCAGAGGTTGCAGTGAGCCAAGATCATGCCATTCCACTCCAGCCTGGGCGACAGTGCAAGACTCTGTCTCAAAAACAAAAACAAAAAACCCCCAAACCAAAAATTAGCCAGGCGTGGTGGCATGCACCTGTAGTCCCAGCTACTTGGGAGGCTAAGGCAAGAGAATAGCTTGAACCCAGGAGGCAGAGGTTGCAGTGAGCCGAGATAGTGCCATTGCACTCCAACGTGGGTGACAAGAGCAAAACTCTGTCTCAAAAAAAAAAAAAAAAAAGGAAGGAA","GGCTGGGCGCAGTGGCTCACACCTGTAATCCCAGCACTTAGGGAAGCTGAGGCGAGTAGATCACCTGAGGTCAGGAGTTAGAGACCAGCCTGGCCATCATGGTGAAACCCCGTCTCTACTAAAGATACCAAAAATTAGCTGAGTGTGGTGCTGGGTGCCTGTAATCCCAGAAACTCAGGGTGCCTGTAATCCCAGCAACTCAGGGTGCCTTTAATCCCAGCAACTGAGGGTACCAGTAATCCCAGCAACTCAGGGTGTCTTTAATCCTAGCAACTGAGGGCACCTGTAATCCCAGCAACTCAGGAAGCTGAGACAGGAGAAGTACTTGAACCCAGAAGGCAGAGGTTGCAGTGAGCCGATATTGCACCATTGCACTCCAGTCTGGGCAACAAGAGTGAAACTCTGTCTCAAAAAAAAA"
"chr16","21054922","21055508","JH378118","18053084","18053501","243","3001838","GGCCGGGTGCGGTGGCTCACACCTATAATCCCAGCACTTTGAGAGTCTGAGGCAGGCGGATCACCTGAGGTCAGGAGTTCCAGACCAGCCTGGCCAACATGGTGAAACCCAGTCTCTACTAAAAATACAAAAAAAGACCGGGCACAGTGGCTCACGCCTGTAATTCCAGCACTTTGGGAGGCCGAGGCAGGTGGATCACCTGAGGTTGGGAGTTCGCGACCAGCCTGACCGACATGGAGAAATCCCATCTCTACTAAAAATACAAAATTAGCCGGGCGTGGTGGCACATGCCTGTAATTCCAGCTACTCAGGAGGCTGAGGGAGGAGAATCACTTGAACCTGGGAGGCGGAAGTTGTGGCGAGCCAAGATCACGCCATTGCACTCCAGCCTGGGCAACAAGAGTGAAACCCCATTTCAAAAAAAAAAAAAATTAGCCAGGGGTGGTGGTGCATTCTTGTAATACCAGCTACTCGGGAGGCTGAGGTAGGAGAATCACTTGAGCGCAGGAGGCAGATGTTGTAGTGAGCCGAGTGCCATTGCACTACAGCCTGGGCGACAAGAAAGTAACTCCACCTCAAAAAAAAAA","GGCTGGGCGCAGTGGCTCACACCTGTAATCCCAGCACTTAGGGAAGCTGAGGCGAGTAGATCACCTGAGGTCAGGAGTTAGAGACCAGCCTGGCCATCATGGTGAAACCCCGTCTCTACTAAAGATACCAAAAATTAGCTGAGTGTGGTGCTGGGTGCCTGTAATCCCAGAAACTCAGGGTGCCTGTAATCCCAGCAACTCAGGGTGCCTTTAATCCCAGCAACTGAGGGTACCAGTAATCCCAGCAACTCAGGGTGTCTTTAATCCTAGCAACTGAGGGCACCTGTAATCCCAGCAACTCAGGAAGCTGAGACAGGAGAAGTACTTGAACCCAGAAGGCAGAGGTTGCAGTGAGCCGATATTGCACCATTGCACTCCAGTCTGGGCAACAAGAGTGAAACTCTGTCTCAAAAAAAAA"
"chr16","27896431","27896766","JH378166","6401112","6401453","56","21495319","GGCCAGGCGCGGTGGCTCACGCCTGTAATCCCAGGACTTTGGTAGTCCAAGGCGGGTGGATCACCTGAGGTCAGGAGTTCAAGATCAGCCTGACCAACATGGCAAAACCTCGTCTCTACTAAAAAATACAAAAATTAGCCGGTGTGGTGGCAGGTGCCTGTAATTCCAGCTACTCGGGACGCTGAGTCATGAGAATTGCTTGAACCTAGGAGGCAGATGTTGCAATGAGCCGAGATCGCACCATTGTACTCCAGCCTGGGCGACAAGAGGGAAACTGTCTCCAAAAAAAAAAAAGAAAGAAAGAAAGAAAGAAAGAAAAAAGAAAAACAAAACAAA","GGCCAGGTGCAGTGGCTCACCCCTGTAATCCCAGCACTTTGGGAGGTCGAGGTGGGTGGATCACCTGAGGTCAGGAGTTCAAGACCAGCCTGACCAAAATGGTGAAACCCCATCTCTACTAAAAATACAAAACATTAGCCAGACATCGTGGCGGGCACCTGTAATCCCAGCTACTTGGGAGGCTGAGGCAGGAGAATTGCTTGAGCCTAGGAGGCGGAGGTTACAGTGAGCCATGATCGTGCCATTGGACTCCAGCCTGGGCTACAAGAGCGAGACTCCATCTCAAAAAAAAAAAAAAAAAAAAAAAAGAAAGAAAGAAAGAAAGAAAGAAAAGAAAGAAAG"
"chr16","36524888","36525430","JH378206","6546474","6546861","201","29978414","TTTGAGACCAGCCTGGCCATTGTGGTGAAACCCCGTCTCTACTAAAAAAAATTCAAAAAATGGCTGGGTATGGTGGCTCACGCCTGTAATCCCAGGACTTTGGGAGGCCAAGGTGGGCGGATCACCTGAGGTCAGGAGTTTGAGACCAGCCTAGCCAACATGGTGAAACCCCGTCTCTACCAAAAATACAAAAATTAGCCGGGCTTGGTGGCGCGCACCTGTAATCCCAGGTACACTGGAGGTTGAGGCACAAGAATCGTTTGATCCTGGGAGGTTGCAGTGAGCCAAGATCACGCCACTGCACTCCAGACTGGGTGACAGAGCGAGATTCCATCTCAAAACAACAACAACAAACCCAAAAAATTAGCTGGGTGTGGTGGTGGGTGCCTGTAATCCCAGCTACTTAGGAGGCTGAGGCAGAAGAATCGCTTGAACCCAGGAGGTGGAGGTTGTTGCAGTGAGCAGAGATCGCACCATTGCACTCCAGCCTGGGCAACGAGTGAAACTCCATCTCAAAAAAAAAAAAAAAAAAAGAAAAAAAAA","GGCCACACATGGTGGCTAACGCCTGTAATCCCAGCACTTTGGGAGGCCAAGTCGGGTGGATCATGAGGTCAGGAGACCAAGACCATCCTGGCCAAATGGTGAAACCCCGTCTCTACTAAAAATACAAAAATTAGCTGGGCATGGTGGCGTGTGCCTGTAATCCCAGCTACTCAGGAGGCTGAGGCAGGACAATTGCCTGAACCCAGGAGAATTAGCTGGGCATGGTGGCGTGTGCCTGTAATCCCAGCTACTCAGGAGGCTGAGGCAGGACAATTGCCTGAACCCAGGAGGCGAAGGTTGCGGTGAGCCGAGATTGTGCCATTGCACTCCAGCCTGGGTAACAAGAGCGACACTCTGTCTCAAAAAAAAAAAAAAAAAAAAAAAAAAA"
"chr16","36528224","36528842","JH378119","32351107","32351490","270","4177117","GGCCAGGCGTGGTGGCTCACGCCTGTAATCCCAGCACTTTGGGAGGCTGAGGCAGGCAGATCACCTGAGGTCAGGAGTTCAAGACCAGCCTGGCCAACATGGTGAAACTCCATCTCTACTAAAAATACAAAATTAAGCCGGGCACGGTGGCTCACATCTGAAATCCCAGCACCTTGGGAGGCTAAGGCAGGCGGATCACGAGGTCAGGAGTTCAAGACTAGCTGACCAATATGGTGAAACCCCGTGTCTACTAAAAATACAAAAAAAATTAGCTGGGCGTGGTGGCGCATGCCTGTAGTTCCAGGTACTCAGGAGGCTGAGGAAGGAGAATCACTTGAACCTGGGAGGCGGAGGTTGCAGTGAGCCAAGATCATGCCACTGCATTCCAGCCTGGGCAACAGAGCAAGACTCTGTCTCAAAAATAAAAATAAAAATAAAAGTAAAAATACAAAATTAGCCAGGCGTGGTGGTGTGTGCCTGTAATCACAGCTACTCAGGAGGCAGGAAAATCACTTGAACCTAGGAGGAGGAGGTTGGTGAGCCAAGATCACACCATTGCACTCCAGCCTGGGCAAAAAGAGCAAAACTCCGAACTCTGTCTCAAAAAAAAAAAAAAAAA","GGCCAGGTATGGTGGCTCACACCTGTAATCCCAGCACTTTGGGAGGCCAAGGCAGGCAGACCACCTGAGGTCAGGAGTTCGAGATCAGCCTAGCCAACATGGTGAAACCCCATCTCTAGTAAAAATAAAATTAGCCAGGCATGGTGGTGCATGCCTGTAACGCAGGTCAGGAGTTCGAGATCAGCTTAGCCAACATGGTGAAACCCCATCTCTAGTAAAAATAAAATTAGCCAGGCAGGTGGTGCCGCCTGTACTCGGGAGGCTGAGGCAGGAGAATCACTTGAACCCAAGAGGCAGAGGTTGCAGTCAGCCAAGATCATGCCATTGCACTCCAGCCTAAGCAAAAAGAGTAAAACTCAGTCTCAAAACAAAAAAACAAAAAAA"
"chr16","44800308","44800913","JH378118","18053084","18053501","244","26747224","GGCCTGGTGCAGTGGCTCACACCTGTAATCCCAGCACTTTGGGAGCCCAAGGCGGGTGGATCACCTGAGGTCAGGAGTTCGAGACCAGCCTGGCCAACATGGTGAAATCCTCTCTACTAAAAATGCAAAAAATTAGCTGGGCGGCCAGGCGCAGTGGCTCACGCCTGTAATCCCAGCACTTTGGGAGGCCGAGGTGGGCGGATCACAAGGTCAGGAGATCGAGACCATGCTGGCTAACACGGTGAAACTCCGTCTCTACTGAAAATACAAAAAATTAGCCAGGCACGGTGGCGGGCGCCTGTAGTCCCAGCTACTGGGGAGGCTGAGGCAGGAGAATGGCGTGAACCTGGGAGGTGGAGGTAGCAGTGAGCCAAGATTGCGCCACCGCAGTCCGGCCTGGGTGAAAGAGCGAGACGCTGTCTCAAAAAAAAAAAAAAAAAATTAGCTGGGCATGGTGGCGGGCGCCTGTAATCCCAGTTACTCGGGAGGCTGAGGCAGGAGAATCAGTTGAACCCAGGAGGTGGAGGTTGCAGTAAGCCAAGATTGTGCCATTGTACTCCAGTCTGGGCAACAAGAGCGAAACTCTGTCTTAAAAAACAAAAAAAA","GGCTGGGCGCAGTGGCTCACACCTGTAATCCCAGCACTTAGGGAAGCTGAGGCGAGTAGATCACCTGAGGTCAGGAGTTAGAGACCAGCCTGGCCATCATGGTGAAACCCCGTCTCTACTAAAGATACCAAAAATTAGCTGAGTGTGGTGCTGGGTGCCTGTAATCCCAGAAACTCAGGGTGCCTGTAATCCCAGCAACTCAGGGTGCCTTTAATCCCAGCAACTGAGGGTACCAGTAATCCCAGCAACTCAGGGTGTCTTTAATCCTAGCAACTGAGGGCACCTGTAATCCCAGCAACTCAGGAAGCTGAGACAGGAGAAGTACTTGAACCCAGAAGGCAGAGGTTGCAGTGAGCCGATATTGCACCATTGCACTCCAGTCTGGGCAACAAGAGTGAAACTCTGTCTCAAAAAAAAA"
"chr16","45828895","45829498","JH378118","18053084","18053501","256","27775811","GGCCAGGAGAGGTGGCTCATGCTTGTAATTCCAGTATTTTGGGAGCCCAAGGCGGGTGGATCACTTGAGGTCAGGAGTTTGAAACCAGCCTGACCAACATGGTGAAACCCCGTCTCTACTAAAAATTCAAAATTAGGCAAGGCCTGGTGGCTCATGCCTGTAATCCCAGCACTTTGGGAGGCCAAGGAGGGAGGATCACCTGAGGTCGGGAGTTTGAGACCAGCCTGACCAACATGGAGAAACCCCGTCTCTACTAAAACTACAAAATTAGCCGGGTGTGGTGGCCCATGCCTCTAATCCCAGCTACTCTGGAGGCTGAGGCAGGAGAATCACTTGGACCTGGGATGTGAAGGTTGCAGTGAGCCAAGATCGAGCCATTGCACTCCAGCCTGGGCCACAAGAGTGAAACTCCGTCCCAGAAAAAAAAAAAAAAATTAACCTGGCATGGTGGTGTATGCCTGTAATCCCAGCTACTCGGGAGACTGAGGCAGGAGAATCTCTTGAACCCGGGAGGCGGAGGTTGCAGTAAACCGAGATTGCGCCATTGCACTCCGGCCTGGGTGACAAGAGCGAAACTCCGCCTAAAAAAAAAAAGAAAAGAAAA","GGCTGGGCGCAGTGGCTCACACCTGTAATCCCAGCACTTAGGGAAGCTGAGGCGAGTAGATCACCTGAGGTCAGGAGTTAGAGACCAGCCTGGCCATCATGGTGAAACCCCGTCTCTACTAAAGATACCAAAAATTAGCTGAGTGTGGTGCTGGGTGCCTGTAATCCCAGAAACTCAGGGTGCCTGTAATCCCAGCAACTCAGGGTGCCTTTAATCCCAGCAACTGAGGGTACCAGTAATCCCAGCAACTCAGGGTGTCTTTAATCCTAGCAACTGAGGGCACCTGTAATCCCAGCAACTCAGGAAGCTGAGACAGGAGAAGTACTTGAACCCAGAAGGCAGAGGTTGCAGTGAGCCGATATTGCACCATTGCACTCCAGTCTGGGCAACAAGAGTGAAACTCTGTCTCAAAAAAAAA"
"chr16","47110839","47111458","JH378118","18053084","18053501","268","29057755","GGCCAGGCGTGGTGGCTCACGCCTTTAATCCCAGCACTTTGGGAGGCCGAGGCAGGCAGATCACCTAAGGTCAGGAGTTCGAGACCAGCCTGGCCAACATGGTGAAACCCCCTCTCTACTAAAAATGCAAAAATTTCTGGGCATGGTGGCTCACGCCTGTAGTCCCAGCACTTTGGGAGGCCAAGGCAGGCGGATCACTTGAGGTCAGGAGTTTGAGACCAGCCTGGCCAACATGGTGAGACCCCTGTCTCTACTAAAAATATAAAAAAGTAGCCAGGCGTGGTGGTGTATGCCTCCCAGATAATTGGGAGGCTGAGGTGGGATAATTGCTTGAACCCGGGAGGCAGAGGTTGTAGTGAGCCAAGATAGCGCCAATGCACTCCAGCCTGGGCAACAGAGCGAGACTCTGTCTCAAAAAAAAAAAAAAAAAGAAAAAAGAAAAGAAATTAGCTGGGCGTGGTGATGGGTGCCTGTAATCCCAGCTGCTTAGGAAGCTGAGGAAGGAGAATCACTTAGACCCAGGAGACAGAGGTTGCAGTGAGCCGAGATCGCACCATTGTATTCCAGCCTGGGTGACAAGAGAAAAACTATGTCTCAAAAAAAAAAAAAAGAGTAGAAAA","GGCTGGGCGCAGTGGCTCACACCTGTAATCCCAGCACTTAGGGAAGCTGAGGCGAGTAGATCACCTGAGGTCAGGAGTTAGAGACCAGCCTGGCCATCATGGTGAAACCCCGTCTCTACTAAAGATACCAAAAATTAGCTGAGTGTGGTGCTGGGTGCCTGTAATCCCAGAAACTCAGGGTGCCTGTAATCCCAGCAACTCAGGGTGCCTTTAATCCCAGCAACTGAGGGTACCAGTAATCCCAGCAACTCAGGGTGTCTTTAATCCTAGCAACTGAGGGCACCTGTAATCCCAGCAACTCAGGAAGCTGAGACAGGAGAAGTACTTGAACCCAGAAGGCAGAGGTTGCAGTGAGCCGATATTGCACCATTGCACTCCAGTCTGGGCAACAAGAGTGAAACTCTGTCTCAAAAAAAAA"
"chr16","48159907","48160229","JH378222","6231244","6231546","61","41928663","GGCTGGGCACAGTGGCTCATGCCTGTAATCCCAGCACTTTGGGAGGCCGAGGCAGGCGGATCACCTGAGGTCAGGAGTTCGAGACTAGCCTGGCCAATATAGCGAAACCCCGTCTCTACTAAAAATTAGTTGGGCATGGTGGCAGGCGCCTTAATCCCAGCTACTTGGGATGCTGAGGCAGAAGAATCGCTTGAACCCAGAGGGTGGAGGTTTCAGTGAGATGAGATCGTGCCATTGCACTCCAGACTGGGCAACAAGAGCGAGACTCTGTAAAAAAAATTAATTAATTAATTAACTAATTAATTAAAATAAAATGAGAAAAA","GGCTGGGCATGGTGGCTCACGCCTGTAATCCCAGCACTTTGGGACGCTTAGGCAGGTGGATTGCCTGAGGTCAGGAGTTCAAGACTACCCTGACCAACATAGTGAAACCCCGTCTCTACTAAAAATTAGCTGGGCATGGTGGCAGAGGCCTGTAATCCCAGCTACTCGGGAGGCTGAGGCAGGAGAATCACTTAAACCTGGGAGTTGGAGGTTGCAGTGAGCCAAGATCAAGCCATTGCACTCCAGTCTGGGCAACAAGAGCAAGACTCTGTCTCAAAAAAAAAAAAAAAAAGAAAAGAAAAA"
"chr16","49252302","49252639","JH378314","538162","538484","57","48714140","GGCCAGGCGCAGTGGTGCATGTCTGTAATCTTAGCACTTTGGGAGGCCGAGGTGGACGGATTACATGAGGTCAGGAGTTCAAGACCAGCCTGGCCAACATGGTGAAATTCCATCTCTACTACTAAAAAAAAAAAAAAAAAAAAAAAAAAAAAAAAAAAAAAATACAAAAATTAGCTGGGCTTGGTGGCGGGTGCCTGTAATCCCAGCTACTTGGGAGGCTGAGGCAGGAATCACTTAAACCCAGGAGGTGGAGGTTGCAGTGAGCCAAGACCATGCCATTGCACTCCAGCCTGGGCAACAAGAGCAAAACTCCGTCTCAAAAAAACAAAACAAAAAAA","GGCTGGGTGCGGTGCCTCACACCTGTAATCCCAGCACTTTGGGAGGCCGAGGTGGGTGGATCACGAGGTCAAGAGATCAAGACCATCCTGGTCAACATGGTGAAACCCTGTCTCTACTAAAAAAAAAAAAAAAAAAAAAAAAAAAAAAAAAAAAATTAGCTGGGCATGGTGGCGTGTGCCTGTAATCCCAGCTACTCAGGAGGCTGAGGCAGGAGAATTGCCTGAACCCAGGAGGCGGAGGTTGCGGTGAGCCGAGACTGTACCATTGCACTCCAGCCTGGGTAACAAGAGCGAAACTCCATCTCAAAAAAAAAAAAAAAAAA"
"chr16","49464616","49465219","JH378118","18053084","18053501","254","31411532","GGCCAGGCGTGGTGGCTCACACCTGTAATCCTAGCACTTTGGGAGACTGAGGCAGGTGGATCACATGAGGTGAGGAGTTCAAAACCACCCTGGCCGACATGGTGAAACCCCGTCTCTACTAAAAATATTTTTAAAAAGGCCAGGCGTGGTGGCTCACACCTGTAATTCCAGCACTTCGGGAGGCTGGGGCAGGCAGATCACAAGGTCAGGAGATCGAGACCATTCTGGCCAACGTGGTGAAACCCCGTCTCTACTAAAAATACAAAAATTAGCTGGGCGTGGTGGCGCGTGCCTGTAATCCCAGCTACTTGGGAGGCTGATACAGGAGAATTGCTTGAACCAGTGAGTCAGAGGTTGCAGTGAGCTGAGATTGCGCCATTGCACTCCAGCCTGGCAACAGAATGAGACTCCGTCTCAAAAAAAAAAAAAAAATTAGCTGGGCATGGTGGCAGGCACCTGTGATCCCAGCTACTTGGGAGGCTGAGGCAGGAGAATCGCTTGAACCTGGGAGGTGGAGGTTGCAGTGAGCTGAGATTGCGCCATTGCACTCCAACCTGGGCGTCAAGAGCAAAACTCCATCTCAAAAATAAATAAATAAATAAAA","GGCTGGGCGCAGTGGCTCACACCTGTAATCCCAGCACTTAGGGAAGCTGAGGCGAGTAGATCACCTGAGGTCAGGAGTTAGAGACCAGCCTGGCCATCATGGTGAAACCCCGTCTCTACTAAAGATACCAAAAATTAGCTGAGTGTGGTGCTGGGTGCCTGTAATCCCAGAAACTCAGGGTGCCTGTAATCCCAGCAACTCAGGGTGCCTTTAATCCCAGCAACTGAGGGTACCAGTAATCCCAGCAACTCAGGGTGTCTTTAATCCTAGCAACTGAGGGCACCTGTAATCCCAGCAACTCAGGAAGCTGAGACAGGAGAAGTACTTGAACCCAGAAGGCAGAGGTTGCAGTGAGCCGATATTGCACCATTGCACTCCAGTCTGGGCAACAAGAGTGAAACTCTGTCTCAAAAAAAAA"
"chr16","49983504","49983843","JH378316","567988","568320","50","49415516","GGCCAGGCATGGTGGCTTACGCCTGTAATCTCAGCACTTTGGGAGGCCAAGGCAGGCGGATCACCTGAGGTCAGGAGTTCAAGACCAGCCTGGTCAACATGGCGAAACCCTGTCTCTACTAAAAAAATACAAAAATTAGCCAGGCGTGGTGGTGGGCGCCTGTAATCTCTCCTACTTGGGAGACTGAGGCAGGAGAATTGCTTGAACTCAGAAGGCAGAGGTTGCAGTGAGCTGAGATCACGCCATTGCACTCCAGCCTGGATGACAAGAGCAAAACTCCATCTCAAACAAACAAAAAACAAACAAACAAAAAAAAACAAAAAAACCTCCAAAAAACAAA","GGCCGGGCGTGGTGGCTCACGCCTGTAATCCCAGCACCTTGGGAGGCTGAGGCGGGTGGATCACGAGGTCAAGAGATTGAGACCAGCCTGGTCAACATGGTGAAACCCTGTCTACTAAAAAAATACAAAAATTAGCTGGGCATGGTGGCACGTGCCTGTAATCCCAGCTACTCAGGAGGCTGAGGCAGGAGAATTGCCTGAACCCAGGAGGCGGAGGTTGCGGTGAGCCGAGATCGCGCCATTGCACTCCAGCCTGGGTAACAAGAGCGAAACTCCGTCTCAAAAAACAAAAAACAAAAAAACAAAAAACAAACAAACAAACAAAAAAACAAA"
"chr16","50470493","50471105","JH378118","18053084","18053501","251","32417409","GGCTGGGAGCGGTGGCTCATACCTGTAATCCCAGCACTCTGGGAGGCCGAGGCGCGTGGATCACCTGAGGTCAGGAGTTTGAGACCAGCCTGGCCAGCATGGTGAAACCCTGTCTCTACTAAAAATAGAAAAAGTTAGCTGGGTGAACAGCCGGGCGCGGTGGCTCACACCTGTAATCCCAGCACTTTGGGAGGCCGAGGCAGGTGGATCACAAGGTCAGGAGATCGAGACCATCCTGGCTAACACGGTGAAACCCTGTCTCTACTAAAAATATAAAAAATTAGCCGGGCATGGTGGTGGGTGCCTGTAGTCCCAGCTGCTCAGGAGGCTGAGGCAGGAGAATGGCGTGAAGCCAGGAGGCAGAGGTTGCAGTGAGCCGAGATCGTACCACTGCACTCTAGCCTGGGTGACAGAACGAGACTGTGTCTCAAAGAAAAAAAAAATTAGCTGGGTGTGGTGGCAGACACCTGTAATCCTAGCTACTTGGGAGGTTGAGGCAGGAGAATCGCTTGGACCTGGGAGGCGGAGGTTGCAGTAGGCTGAAATCGCACCATTGCACTCCAGCCTGGGCAACAAGAGGGAAACTCAGTCTCAAAAAAAAAAAAAAAAAAAA","GGCTGGGCGCAGTGGCTCACACCTGTAATCCCAGCACTTAGGGAAGCTGAGGCGAGTAGATCACCTGAGGTCAGGAGTTAGAGACCAGCCTGGCCATCATGGTGAAACCCCGTCTCTACTAAAGATACCAAAAATTAGCTGAGTGTGGTGCTGGGTGCCTGTAATCCCAGAAACTCAGGGTGCCTGTAATCCCAGCAACTCAGGGTGCCTTTAATCCCAGCAACTGAGGGTACCAGTAATCCCAGCAACTCAGGGTGTCTTTAATCCTAGCAACTGAGGGCACCTGTAATCCCAGCAACTCAGGAAGCTGAGACAGGAGAAGTACTTGAACCCAGAAGGCAGAGGTTGCAGTGAGCCGATATTGCACCATTGCACTCCAGTCTGGGCAACAAGAGTGAAACTCTGTCTCAAAAAAAAA"
"chr16","50478366","50478929","JH378114","15957391","15957789","242","34520975","GGCTGGGCACGGTGGCTCATGCCTGTAATCCTAGTACCCTGGGAGGCTGAAGCTGGCAGATCACTTGAGGTCAGGAGTTCGAAACCAGCCTGGCCAACATGGTGAAACCTCATCACTACTAAAAATACAAAAAGTCAGCCGAGCGCGGTGGCTCACGCCTTTAATCCCAGCACTTTAGGAGTCTGAGGCGGGTGGATCACAAGGTCAGGGGTTTGAGACTAGCCTGACCAACACGGTGAAACATCTTTACTAAAAATAGCCAGGCATGGTGGTGCAGGCCTGTAGCAGGTACTCAGGAGGCTGAGGCAGCAGAATCGCTTGAACCCGGGAGGCGGAGGTTGCAGTGAGCCGAGATTGAGCCACTGCACTCCACCCTGGGCAACTGAGCGAGACTCCGTCTCAAAAAAAAAAAAAAAAATTAGCTGGACGTGGTGGTGGATGCCTGTAATCCCGGCTACTTGGTACTTGGAAGGCTGAGACAGGAGAATCGCTTGAACCCGGGAGGTGGAGGTTGCAGTGAGCTGAGATAGCGCCATTGCACTCCAGCCTGGGCAACAAGAGTGA","GCAAGGAACGGTGGCTCATGCCTGTCATCCCAGCACTTTGGGAGGCTAAGGAGGGTGGATTACCGAAGGTCATGAGTTTGAGACCAGCCTGACCAACATGGTGAAAACCCCATCTCTACTAAAAATACAAAAAATTAGCCAGATACAGCTATGCGGCAGACTGGGGCAGGAGAATCGCTTGGACCCAAACCCCATCTCTACTAAAAATACAAAAAATTAGCCGGATACAGCTATGCGGGAGACTGGGGCAGGAGAATCGCTTGGACCCGGGAGGCAGAGATTGCAGTGAGATGAGACCATGCCATTGCTCTCTAGCTTGTGCGATGAGAACAAGACTCTGTCTCAAAAAAAAAAAAAAAAAAAAAAAAAAAAAAAAAAAAAAAAGAGAGAGAGAGAAAA"
"chr16","51388263","51388584","JH378271","2122362","2122678","46","49265901","GGCTGGGTACGGTGGCCCACACCTGTAATCCCAGCACCTTGGGAGGCTGAGGTGGGCGGATTACCTGAGGTCAAAAGTTCAAGACCAGCCTGGCCAACATGGTGAAATCCCATCTCTGCTAAAAATACAAAAAAAAAAAAAAAAAAAAAAAAAAAATTGCCAGGCATGGTGGCAGGCACCTGTAATCCCAGCTACTTGGGAGGCTGAGGCAGGGGAATCGCTTGAACCTGGGAGGCAGAGGTTGCAGTGAGCCCAGATAGCGCCATTGCACTCCAGCCTGGGCGACAAGAGCGAAACTCTGTCCAAAAAAAAAAAAAAAAAA","GGCCGGGCACGGTGGCTCACACCTGTAATCCCAGCACTTTGGGAGGCTGAGGTGGGTGAATCACCTGAGGTCAGGAGTTTGAGACCAGCCTGACCAACATGATGAAACCCGGTCTCTGCTAAAAATACAAAAAAAAAAAAAAAAAAAAAAAAAAAAAGCTGGGCATGATGGTGGGCACCTGTAATCCCAGCTACTCGGGAGGCTGAGGCAGGAGAATCGCTTGAACACCAGGAGGTGGAGGTTGCTATGAGCCGAGATCGCACCATTGCACTCTAGCTTGGGCAACAAGAGAGAAACTCCATCAAAAAAAAAAAAAA"
"chr16","51876298","51876882","JH378118","18053084","18053501","253","33823214","GTAATCCCAGCACTTTGGGAGGCCCAAGTGGGTGGATCACCTGAGGTCAGGAGTTCATGACCAGCCTGGCCACATGGTGAAACCCCATCTCTACTAAAAATACAAAATTAGGCTGGGCGCGGTGGCTTACGTCTGTAATTCCAGCACTTTGGGAGGCCGAGGCAGGCGGATCATGAGGTCAGGAGATTGAAACCATCCTGGCTAACACGGTGAAACCCTGTCTCTACTAAAAATACAAAAAATTAGCCGGGTGTGGTGGGGGGGCGCCTGTAGTCCCAGCTGCTCAGGAGGCTGAGGCAGGAGAATGGCATGAACCCGGGGGGGCGGAGCTTGCAGTGAGCTGAGATCATGCCACTGCACTCCAGCCTGGGCAACAAAGTGAGACTCCGTCTCAAAAAAAAAAACCAAAAAACAAAATGAGCTGGGTGTGGTGGTGGGGGCGTATAATCCCAGCTATACAGGAGGCTGAGGTAGGAGAATCACTTGAACCCGGGAGGTGGAGGTTGCAGTGAGCCGAGATTGTGCCATTTCACACCAACCTGGGTAACAAGAGTAAAATGCTGTCTCAAAAAAAAAAAAGAAAAA","GGCTGGGCGCAGTGGCTCACACCTGTAATCCCAGCACTTAGGGAAGCTGAGGCGAGTAGATCACCTGAGGTCAGGAGTTAGAGACCAGCCTGGCCATCATGGTGAAACCCCGTCTCTACTAAAGATACCAAAAATTAGCTGAGTGTGGTGCTGGGTGCCTGTAATCCCAGAAACTCAGGGTGCCTGTAATCCCAGCAACTCAGGGTGCCTTTAATCCCAGCAACTGAGGGTACCAGTAATCCCAGCAACTCAGGGTGTCTTTAATCCTAGCAACTGAGGGCACCTGTAATCCCAGCAACTCAGGAAGCTGAGACAGGAGAAGTACTTGAACCCAGAAGGCAGAGGTTGCAGTGAGCCGATATTGCACCATTGCACTCCAGTCTGGGCAACAAGAGTGAAACTCTGTCTCAAAAAAAAA"
"chr16","59738190","59738518","JH378138","4229795","4230103","67","55508395","TCACAGCATTTTGGGAGGCCAAGGCAGGCGGATCACCTGTGGTCAGGAGTTTGAGACCAGCCTGGCCAACATGGTGAAACCCCATCTCTACTAAAAATACAAAACAATTAGCCAGGTTTGGTGGCAGGCGCCTATAATCCCAGCTACTTGGGAGGCTGAGGCAGGAGAATCGCTTGAACCCAGGAGGCGGAGGTTGCAGTGAGCCGAGAACACACCATTGTACTCCAGCCTGCGACAAGAACGAAACTGTATCTCAATTAAAAAAAAAAAAAGAAAGGGAGGAAGGAAGGAAGGAAGGAAGGAAGGAAGGAAGGAAGAAAGAAAGAAAA","CACTTTGGGAGGTGAAGGCGGGCAGATCACCTGAGGTCAGGAGTTCGAGACCAGCCTGGCCAACATGGTGAAACCCCGCCTCTACTAAAAATACAAAAATTAGCCAGGTGTGACACTAGGCATCTGTAATCCCAGCTACTTGGGAGGCTGAGACAGGAGAATCACTTGAACCCAGGAGGCGGAAGTTGCAGTGAGCCAAGATCATGCCATTGCACTCCAGCCTGGGTGACAGGAGCAAAACTCTGTCTCAAAAAAAAAAAAAAAAAAAAAAAAAAAAAAAAAAAAAAAAGAAAAGAAAAGAAAAGTAAA"
"chr16","64682336","64682940","JH378118","18053084","18053501","253","46629252","GGCCGGGCACGGTGGCTCACTCCTGTAATCCCAGCACTTTGGGAGGGTGAGGCAGGTAGATCAAAAGGTCAGGAGTGGCCAGGCGTGGTGGCTCACACTTGTAATCCCAGCACTTTGGGAGGCCGAGATGGGCAGATCACGAGGTCAAGAGATTGAGACCATCCTGGCTAACATGGTGAAACCCCGTCTCTACTAAAAATACAAAAAATTAGCCGGGTGTGGTGGCAGGCGTCTGTAATCCCAGCCACTTGGGAGGCTGAGGCAGGAGAATCGCTTGAACCTGGGCGGCAGAGGTTGCATTGAGCCAGGATCGCGCCACTGCACTCCAGCCTGAGCAAAAAGAGCGAAACTCTGTCTCAGAAAAAAAAAAAAGTCAGGAGTTTGAGACCAGCCTGGCCAATATGGTGAAACCCCGTCTCTACTAAAAATACAAAAATTAGCCGAGCGTGGTGGTGGGTGCCTATACTCCCAGCTACTCAGGAGGCTGAGGCAGGAGAATCACTTGAACCCCAGGGGCAGAGGTTGCAGTGAGCCGAGATCGTGCCATTGCACTTCACCCTGGGTGAAAGAGCAAAACTCCGTCTCAAAAAAACAAAACAAAAAAA","GGCTGGGCGCAGTGGCTCACACCTGTAATCCCAGCACTTAGGGAAGCTGAGGCGAGTAGATCACCTGAGGTCAGGAGTTAGAGACCAGCCTGGCCATCATGGTGAAACCCCGTCTCTACTAAAGATACCAAAAATTAGCTGAGTGTGGTGCTGGGTGCCTGTAATCCCAGAAACTCAGGGTGCCTGTAATCCCAGCAACTCAGGGTGCCTTTAATCCCAGCAACTGAGGGTACCAGTAATCCCAGCAACTCAGGGTGTCTTTAATCCTAGCAACTGAGGGCACCTGTAATCCCAGCAACTCAGGAAGCTGAGACAGGAGAAGTACTTGAACCCAGAAGGCAGAGGTTGCAGTGAGCCGATATTGCACCATTGCACTCCAGTCTGGGCAACAAGAGTGAAACTCTGTCTCAAAAAAAAA"
"chr16","67872770","67873371","JH378118","18053084","18053501","260","49819686","GGCTGGGCATGGTGGCTCATGCCTGTAATCCCAGCACTTTGGGAGGCCAAGACGGGCAAATCACCTCAGGTCAGGAGATCGAGACCAGCCTGGCCAACACAGCAAAACCCACCTCTCTACTAAAAATAGAAAAATTACCCAGGCGTCACAGCTCACGCTTATAATCCCAGCACTTTGGGAGGCCGAAGCAGGTGGATCACAAGGTCAGGAGATCGAGACCAGCCTCACTAACATGGTGAAACCCCGTCTCTACTGAATATACGAAAAATTAGTCGGGTGTGGTGGCAGGCACCTGTAGTCCCAGCTACTTGGGAGGCTGAGGCAGGAGAATGGCTTTAACTCAGGAAGAGGAGCTTACGGTGAGCTGAGATTGTGCCACTGCACCCCAGCCTGGGCGACAGAGCAAGACTCCGTCAAAAAAAAAAAAAACCCCAAAACCCCAGCGTGGCAGCAGGTACCTGTAGTCCCAGCTACTCGGGAGGCTGAGACAGGAGAATGGCTTGAACCCGGGAGGCGGAGCTTGCGGTGAGCCAAGACGGCGCCACTTCATTCCAGCTATGGTGATAAGAGGGAGACCGTCTCAATCAATAAATTTAAAAAAA","GGCTGGGCGCAGTGGCTCACACCTGTAATCCCAGCACTTAGGGAAGCTGAGGCGAGTAGATCACCTGAGGTCAGGAGTTAGAGACCAGCCTGGCCATCATGGTGAAACCCCGTCTCTACTAAAGATACCAAAAATTAGCTGAGTGTGGTGCTGGGTGCCTGTAATCCCAGAAACTCAGGGTGCCTGTAATCCCAGCAACTCAGGGTGCCTTTAATCCCAGCAACTGAGGGTACCAGTAATCCCAGCAACTCAGGGTGTCTTTAATCCTAGCAACTGAGGGCACCTGTAATCCCAGCAACTCAGGAAGCTGAGACAGGAGAAGTACTTGAACCCAGAAGGCAGAGGTTGCAGTGAGCCGATATTGCACCATTGCACTCCAGTCTGGGCAACAAGAGTGAAACTCTGTCTCAAAAAAAAA"
"chr16","67970409","67971018","JH378118","18053084","18053501","252","49917325","GGGCGGGTGCGGTGGCTCACCCTGTAATCCCAGCACTTTCGGAGGCTTAAGCAGGCGGATCACCTGAGGTCAGGAGTTCGAGACCAGCCTGGCCAACATGGTGAAACCCCATCTCTACTAAAAATACAAAAAAATGGCCGGGTGCGGCGGCTCATGCCTGTCATCCCAGCACTTTCGGAGGCTGAGGCAGGCGGATCACCGGAGGTCAGGAGTTCGAGACCAGCTTGGCCAACATGGTGAAACCCCGTCTCTACTAAAAATACAAAAGTTAGCTGGGCATGGTGGCACATGCCTGTAATCCCAGCTACTCCGGAGGCTGAGGCAGGAGAATCACTTGAACCTGGGGAGGCGGAGGTTGCAGTGAGCTGAAATCACGGCATTGCACTCCAGCCTAGGCAACAGAGCGAAAGTCCGTCTCAGAAAAAAAAAAAAAAAAATTAGATGGGTTTGGTGGCGGGCGCGCTGTAATCCCAGCTACTTGGGAGGCTGGAGGCAGGAGAATCGCTTGAACTCAGGAGGCTGAGGTTACAGTGAGCCGAGATCATGCCATTGCACTCCAGCCTGGGCAATAAGAGTGAAACTCTGTCTCAAAAAACAACAACAACAAAAA","GGCTGGGCGCAGTGGCTCACACCTGTAATCCCAGCACTTAGGGAAGCTGAGGCGAGTAGATCACCTGAGGTCAGGAGTTAGAGACCAGCCTGGCCATCATGGTGAAACCCCGTCTCTACTAAAGATACCAAAAATTAGCTGAGTGTGGTGCTGGGTGCCTGTAATCCCAGAAACTCAGGGTGCCTGTAATCCCAGCAACTCAGGGTGCCTTTAATCCCAGCAACTGAGGGTACCAGTAATCCCAGCAACTCAGGGTGTCTTTAATCCTAGCAACTGAGGGCACCTGTAATCCCAGCAACTCAGGAAGCTGAGACAGGAGAAGTACTTGAACCCAGAAGGCAGAGGTTGCAGTGAGCCGATATTGCACCATTGCACTCCAGTCTGGGCAACAAGAGTGAAACTCTGTCTCAAAAAAAAA"
"chr16","68229729","68230314","JH378206","6546474","6546861","256","61683255","TGGTTTCCGCCTGTACTCCCAGCACTTTCGGAGGCTCAAGTGAGCAGATCGCTTGAGGCCAGGAGTTTAAGACCTACCTAGTCAACACCGGGGAAACCCACATCTCCACTAAACAATGGCCAGGAGCAGTGGCTCATACCTGTAATCACAACACTTTGGGATCCCAGCCAGACGGATCACAAAGTCAGGAGTTTGCGACCAGCCTATTAGAATGGTGAAACCCTGTCTCTACTAAAAATACAAAAAATTAGCCAGGCATGGTGGCGCATGCCTGTCATCCCAGCTACTCGGGAGGCTGAGGCAAGAGAATCACTTAAACCCAGGAGGCAGATGGAGGTTGCAGTGAGCCAAGATCACACCACTGCACTACAGCATGGGCGACAGAGCAAGACTCGGTCTCAAAAAAAAAAAAATTGGCCAGGCACGGTGGCTGACACCTGTAATCCCAGCACTTTGGGAGGCTGAGGCGGGAGAATCGCTTGAACCTGGGAGACGAAGGTTGCAGTGAGCCGAGACTAAGCCATTGCACCCCAACCTGGGCGGCAAGAGTGAAACTCTGTCTCAAAAAAAATTAAAAAATAAAAAA","GGCCACACATGGTGGCTAACGCCTGTAATCCCAGCACTTTGGGAGGCCAAGTCGGGTGGATCATGAGGTCAGGAGACCAAGACCATCCTGGCCAAATGGTGAAACCCCGTCTCTACTAAAAATACAAAAATTAGCTGGGCATGGTGGCGTGTGCCTGTAATCCCAGCTACTCAGGAGGCTGAGGCAGGACAATTGCCTGAACCCAGGAGAATTAGCTGGGCATGGTGGCGTGTGCCTGTAATCCCAGCTACTCAGGAGGCTGAGGCAGGACAATTGCCTGAACCCAGGAGGCGAAGGTTGCGGTGAGCCGAGATTGTGCCATTGCACTCCAGCCTGGGTAACAAGAGCGACACTCTGTCTCAAAAAAAAAAAAAAAAAAAAAAAAAAA"
"chr17","3506470","3507049","JH378118","18053084","18053501","238","14546614","CCTGTCATCCCAGCACTTTGGGAGGCCGAGGCGGGTAGATCACCTGAGGTCAGGAGTTTGAGACCAGCCTGGCCAACATGGCGAAACCCCGTCTCTACTAAAAATACAAAAACTGGCTGGGCGCGGTGGCTCACGCCTGTAATCCCAGCACTTTGGGAGGCTGAGGCGGGTGGATCATAAGGTCAGGAGTTCAAGACCAGCCTGGCCAACATGGTGAAACCCCATCTCTACTAAAAATACAAAAATTAGCCAGGTATGGTGGCAGGTGCCTGTAATCCCAGCTACTCAGGAGGCTGAGGCAGAGAATTGCTTGAACCCGGGAGGGGGAGGTTGCAGAGGGCCAAGATCGTACCACTATACTCCAGCCTGGGTGACAGGATGAGACTCCATCTTAAAAAAAAAAAAAAAAAAAAAAATTAGCCAGGCGTGGTGCGGGCACTTGTAATCCCAGCTATTCAGGAGGCTGAGGCAGGAGAATTGCTTGAACCCGGGAGGCAGAGGTTGCGGTGAGCTGAGATCGCACCATTGCACTCCAGCCTGGGCAACAAGAGTGAAACTCTGTCTCAAAAAAAAAACAAAA","GGCTGGGCGCAGTGGCTCACACCTGTAATCCCAGCACTTAGGGAAGCTGAGGCGAGTAGATCACCTGAGGTCAGGAGTTAGAGACCAGCCTGGCCATCATGGTGAAACCCCGTCTCTACTAAAGATACCAAAAATTAGCTGAGTGTGGTGCTGGGTGCCTGTAATCCCAGAAACTCAGGGTGCCTGTAATCCCAGCAACTCAGGGTGCCTTTAATCCCAGCAACTGAGGGTACCAGTAATCCCAGCAACTCAGGGTGTCTTTAATCCTAGCAACTGAGGGCACCTGTAATCCCAGCAACTCAGGAAGCTGAGACAGGAGAAGTACTTGAACCCAGAAGGCAGAGGTTGCAGTGAGCCGATATTGCACCATTGCACTCCAGTCTGGGCAACAAGAGTGAAACTCTGTCTCAAAAAAAAA"
"chr17","3641899","3642243","JH378198","5062782","5063109","59","1420883","GGCCAGGCACAGTGGCTCACACCTGTAATCCCAGCACTTCAGGAGGCCGAGGTGGGTAGATCACCTGAGGTCAGGGGTTTGAGACCAGCCTGACCGACGTGGCGAAACCCTGTCTCTACTACAAATACAAAAATTAGCCTTATGTGGTGGCGGGCACGTGTAATCCCAGCTACTTGGGAGGCTGAGGCAGGAGAATCGCTTGAATCTGGGAGGTGGAGGTTGCAGTGAGCCGAGATCACGCCATTGCACTCCAGCCTGGGTGACAAGAGCGAAACTCCATCTCAAAATAAATAAATACATACATACATGTATACATACATACATACATAAAAATAAAAAGTAAAA","GCCAGGCATGGTGGCTCACGCCTATAATCTCAGCACTTTGGGAGGCTGAGGCAGGCAGATCACTTGAGGTCAGGAGTTCAAGACCAGCCTGGCCAACATGGTGAAACCCTGGCTCTACTAAAAATACAAAAATTAGCCGGGTGTGGTGGCACGTGCCTATAATCCCAGCTACTCAGGAGGCTGAGGCAGAAGAATCGCTTGAATCCAGGAGGTGGAGGTTGCAGCGAGCCGAGATCACACCATTGGACTCCAGCCTGGGTGACAAGAGCGAAACTCCATCTCAAAATAAATAAATAAATACATAAAATTAAAAATAAATAAATAAATA"
"chr17","4508039","4508546","JH378206","6546474","6546861","194","2038435","GAGTTGGAGACCAGCCTGGCCAACACGGTGAAACCTCGTCCCCACTAAAAATATAAAAATTAGGCCAGGCGCGGTGGCTCACTCCTGTAATCCCAGCACTTTGGGAGGCTGAGGCGGGTAGATCATCTGAGGTCAGGAGTTCGAGACCAGCCTGGCCAACATGGTGAAACTCCGTCTCTACTAAAAATACAAAAATTAGCTGGGCTGGTAGCGGGCACCTGTAATCCCAGCTACTTGGAAGGGTGAGGCAGGAGAATCACTTGAACCCAGGAGGTGGAGGTTGCAGTGAGCCAAGATTGCAGCACTGTACTCCAGCCTGGGTGACAAAGCAAGACTCTGTCTCAAAAAAAAAAAAAAAAAAAAAGCCGGGCTTGGTGGTGAGTACCGGTAATCCCAGCTACTTGGAAGGCTGAGGCGGCGGACGTTGTACTTAGCCGAGATCATGCCATTGCACTCCAGCCTGGGTAACAGGCAAAAACTCTGTCTCAAAAAATAATAAATAATAAAA","GGCCACACATGGTGGCTAACGCCTGTAATCCCAGCACTTTGGGAGGCCAAGTCGGGTGGATCATGAGGTCAGGAGACCAAGACCATCCTGGCCAAATGGTGAAACCCCGTCTCTACTAAAAATACAAAAATTAGCTGGGCATGGTGGCGTGTGCCTGTAATCCCAGCTACTCAGGAGGCTGAGGCAGGACAATTGCCTGAACCCAGGAGAATTAGCTGGGCATGGTGGCGTGTGCCTGTAATCCCAGCTACTCAGGAGGCTGAGGCAGGACAATTGCCTGAACCCAGGAGGCGAAGGTTGCGGTGAGCCGAGATTGTGCCATTGCACTCCAGCCTGGGTAACAAGAGCGACACTCTGTCTCAAAAAAAAAAAAAAAAAAAAAAAAAAA"
"chr17","4560867","4561450","JH378118","18053084","18053501","257","13492217","GGCTGGGGGTGGTGTCTCTTGCCTGTAATCCCAACACTTTAGCAGGCTGAGGTGTGAGTATGGCTTGAGCCAGGAGTTCTAGACCAGCCTAGGAAACATGGCGAGATCCCTATCTCTACTAATACAAAAATTAGCCGGGCGTGGTGGCAAGCACCTGCAATCTCAGCTACTCGGGAGGCTGAGGTGGGAGGGCCGCTTGAGCCCAGGAGGTCCAGGCTGCAGTAAGCACTTATTTAAAAAAAAAAGAAGAGAAAAGATACAGAAATTAGCCAGGCGTGGTGGTGGGCACCTGTAATCCCAGCTACTCAGGAGGCTGAGGCAGGAAAATCACTTGAACCCGGGAGGCAGAGGTTGCAGTGGGCCGAGATCACACCATTGTACTCCAGCCTGGGCAACAAGAGCGAAACTCTGTCTCAAAAAAAAGAAAAGTAAAGTAAAGAAAAGATACAGAAATTAGCCAGGTGTGGTGGCGGGTGCCTGTAATCCCGCTACTTGGGAGGCTGAGGCAGGAGATTGCAGTGAGCCAAGATTGTGCCATTGCATTCCAGCCTGGGCAACAAGAGCAAAACTCCGCCTCAAAAAAA","GGCTGGGCGCAGTGGCTCACACCTGTAATCCCAGCACTTAGGGAAGCTGAGGCGAGTAGATCACCTGAGGTCAGGAGTTAGAGACCAGCCTGGCCATCATGGTGAAACCCCGTCTCTACTAAAGATACCAAAAATTAGCTGAGTGTGGTGCTGGGTGCCTGTAATCCCAGAAACTCAGGGTGCCTGTAATCCCAGCAACTCAGGGTGCCTTTAATCCCAGCAACTGAGGGTACCAGTAATCCCAGCAACTCAGGGTGTCTTTAATCCTAGCAACTGAGGGCACCTGTAATCCCAGCAACTCAGGAAGCTGAGACAGGAGAAGTACTTGAACCCAGAAGGCAGAGGTTGCAGTGAGCCGATATTGCACCATTGCACTCCAGTCTGGGCAACAAGAGTGAAACTCTGTCTCAAAAAAAAA"
"chr17","4846296","4846953","JH378118","18053084","18053501","290","13206788","GGCCAGGTGCAGTGGCTCACGCCTGTAATCCCAGCACTTTGGGAAGCCCAGGTGGGCGGATCACCCAAGGTCAGGGGTTCGAGACCAGCCTGGCCAACATGGTGAAACTCCATCTCTACTAAAAATAGAAAAAAATGGCCTGGTACGGTGGCTAACGCCTGTAATCCCAGCACTTTGGTAGGCCGAGGCAGGCAGATCACGAGGTCAGAAGATCGAGACCATCCTGGCTAACATGGTGAAACCCCGTCTCTACTAAAAATACAAAAAAGTAGCCAGGTGTGGTGGTGGGTGCCTGTAGTCCTAGCTACTCGGGAGGCTGAGGCAGGAGAATGCCGTGAACCCGGGAGGTGGAGCTTGCAGTGAGCTGAGATCACGCCACTGCACTCCAGCCTGGGTGACAGTGCGAGACTGTCTCCAAAAAAAAAAAAAAAAAAAAATTATATATATAATACACACACACACACACACACACACACACACACACAAATCAGCCAGGCGTGGTGGTGCGCACCTGTAATCCCAGCTACTCGGGAGGCTGAGGCAGGAGAGCTCCTCGAACCCAGGAGGCGAAGGTTGCAGTGAGCCGAGATCACACCATTGCACTCCAGCCTGGGCAACAAGAGCGAAACTCTGTCTCAAGGAAAAAAAAAAAAAAAAA","GGCTGGGCGCAGTGGCTCACACCTGTAATCCCAGCACTTAGGGAAGCTGAGGCGAGTAGATCACCTGAGGTCAGGAGTTAGAGACCAGCCTGGCCATCATGGTGAAACCCCGTCTCTACTAAAGATACCAAAAATTAGCTGAGTGTGGTGCTGGGTGCCTGTAATCCCAGAAACTCAGGGTGCCTGTAATCCCAGCAACTCAGGGTGCCTTTAATCCCAGCAACTGAGGGTACCAGTAATCCCAGCAACTCAGGGTGTCTTTAATCCTAGCAACTGAGGGCACCTGTAATCCCAGCAACTCAGGAAGCTGAGACAGGAGAAGTACTTGAACCCAGAAGGCAGAGGTTGCAGTGAGCCGATATTGCACCATTGCACTCCAGTCTGGGCAACAAGAGTGAAACTCTGTCTCAAAAAAAAA"
"chr17","6289040","6289368","JH378152","15932639","15932952","57","9643599","GGCTGGGCGTGGTGGCTCACGCCTGTAATCCCAGCACTTTGGGAGGCCAAGGTGGGTAGATCACCTGAGGTCAGGAGTTTGAGACCAGCCTGGCCAATGTGATGAAACCCTGTATCCACTAAAAAAAAAAAAAAAAAAAAAAAAAAAAATAGCTGGGTGAAGTGGCAAGCACCTGTAATCCCAGCTACTTGGGAGGCTGAGGCAGGAGAATCCCAGGAGGTGGAGATTGATCCCAGGAGGTGGAGGTTGCAGTGAGTCAAGATCATGCCATTGCACTCCAGCCTGGGTGACAAGAGCAAAATTCCATCTCAAAAAAAAAAAAAAGAAAA","GGCCGGGCATGGTGGCTCAAGCCTGTAATCCCAGCACTTTGGGAGGCCGAGGCGGGTGGATCACGAGGTCAAGAGATTGAGACCATCCTGGTCAACATGGTGAAACCCCGTCTCTACTAAAAATACAAAAAAAAAAAAAAAAAAAATAGCTGGGTGTGGTGGCGTGTGCCTGTAATCCCAGCTACTCAGGAGGCTGAGGCAGGAGAATTGCCTGAACCCGGGAGGCGGAGGTTGCGGTGAGCCGAGATCGCGCCATTGCACTCCAGCCTGGGTAACAAGAGCGAAACTCCGTCTCAAAAACAAAAAAAACAAAA"
"chr17","7490664","7491294","JH378118","18053084","18053501","283","10562420","GGCCGGGAGCGGTGGTTCACTCCTGTAATCCCAGCACTTTGGCAGACCGAGGAGGGTGGATCAACTGAGGTCAGAACTTCAAGACCAGCCTGCCGGGCACAGTGGCTCACACCTGTAATCCCAGCACTTTGGGAGGCTGAGGCAGGTGGATCACCCGAGGTCGGGAGTTCAAGACCAGCCTGACCAACGTGGAGAAACCCCGTCTCTACTAAAAATACAAAATTAGCTGGGGTGGTGGCACGTACCTGTAATCCCAGCTACTCGGGAGGCTGAGGCAAGAGAATCGCTTGAACCCGGGAGGCGGAGGTTGCGGTGCGCCGAGATCGCGCCATTACACTCCAGCCTGGGCAAAAAGAGCGAAACTCTGTCTCAAAAAATAAAAAAAGAAAAAGAAAAAGAAAAAGAAGTTCAAGACCAGCCTGGTCAACGTGGTGAAACCCCGTCTCTACTAAAAACACAAAAAAAATTAGGCGGGTGTTGTGGTGGGTGCCTGTAATCCCAGCTACTCAGGAGGCCAAGGCAGGAGAATCACCTGAACCCTGGAGGTGGAGGTTGCAGTGAGTCGAGATCGCACCATTGCACTCCAGCGTGGGTGACAGAGAGCGAGACTCCGTCTCAAAAAAAAAGAAAA","GGCTGGGCGCAGTGGCTCACACCTGTAATCCCAGCACTTAGGGAAGCTGAGGCGAGTAGATCACCTGAGGTCAGGAGTTAGAGACCAGCCTGGCCATCATGGTGAAACCCCGTCTCTACTAAAGATACCAAAAATTAGCTGAGTGTGGTGCTGGGTGCCTGTAATCCCAGAAACTCAGGGTGCCTGTAATCCCAGCAACTCAGGGTGCCTTTAATCCCAGCAACTGAGGGTACCAGTAATCCCAGCAACTCAGGGTGTCTTTAATCCTAGCAACTGAGGGCACCTGTAATCCCAGCAACTCAGGAAGCTGAGACAGGAGAAGTACTTGAACCCAGAAGGCAGAGGTTGCAGTGAGCCGATATTGCACCATTGCACTCCAGTCTGGGCAACAAGAGTGAAACTCTGTCTCAAAAAAAAA"
"chr17","9634166","9634493","JH378110","12773123","12773444","45","3138957","GGCTGGGTGCGGTGGCTCACGCCTGTAATCCCAGCACTGTGGGAGGCCGAGGCAGGTGGATCACCTGAGGTCAGGAGTTTGAGACCAGCTTGGCCAACATGGTGAAACCCTGTCTGCACTAAAAATACAAAAAAAAAAAAAAAAAAAAAAAAATTAGCTGGGTGTGGTGGCGGACGCCTATAATCCCAGCTACTGGGGAGGCTAAGGCAGGAGAATCGCTTGAACCTGGGAGGTGGAGATTGCAGTGAGCCAAGATGGTGCCATTGCACTCCAGCCTGGACAACAAGAGCGAAACTCGGTTTCAAAAAAAAAAAAAAAAAAAAAAAAA","GGCTGGGCGTGGTGGCTCATGCCTATAATCCCAGCACTTGGAGAGGCCAAAGCAGGCAGATTATTTGAGGTCAGGAGTTCCAAACCAGCCTGGCCAACATGGTGAAACCCTGTATCTACTAAAAATGCAAAAAAAAAAAAAAAAAAAAAAATTAGCTGGGCGTGGTGGCAGGTGACTGTATCCCAGTACTTGGTAGGCTGAGGCAGGAGAATTGCTTGAACCTGGGAGGTGGAGGTTGCAGTGAGCTGAGATTGTGCCATTGCACTCCAGCCTGGGCAACAAGAGCAAAACTCTGTCTCAAAAAAAAAAAAAAAAAAAAAAA"
"chr17","9636859","9637187","JH378193","2430153","2430476","55","7206706","GACACGGTAGCTCACGCCTGTAATCCCAGCACTTTGGGAGGTCGAGGCGGGTGGATCACCTGAGGTCAGGAGTTTAAGACCAGCCTGGCCAACATGGTGAAACCCCGTCTCTGCTAAAAATACAAGAATTAGCCAGGCGTGGTGGTGGGCGCCTGTAATCCCAGCTACTGGGGAGGCTGAGGCAGGAGAATCACTTGAACCCAGAAGGTGGAGGTTGCAGTGAGCCAAGACCACACCACTGGACTGCAGCCTGGCGGACAAGAGCGAGACTCTGTCTCAAAAACAACAACAACAACAACAACAACAACAAAAGAAAGAAAAGAAAAGAA","GGCCGGGCACAGTGGCTCAAGCCTGTAATCCCAGCACTTTGGGAGGCCGAGGTGGGTGGATCACGAGGTCAAGAGATCGAGACCAACCTGGTCAACATGGTGAAACCCCGTCTCTACTAAAAATACAAAAATTAGCTGGGCATGGTGGTGTGTGCCTGTAATCCCAGCTACTCAGGAGGCTGAAGCAGGAGAATTGCCTGAACCCAGGAGGAGGAGGTTGCGGTGAACCAAGATCACGCCATTGCACTCCAGCCTGGGTAACAAGAGCGAAACTCTGTCTCAAAACAAAACAAAACAAAACAAAACAAAACAAACAAAAAAAAA"
"chr17","9725612","9725938","JH378224","2846632","2846964","49","6878980","GGGCGTGGTGGCTCACACCTGTAATCCCAGCACTTTGGGAGGCCGAGGTGGGCGGATTGCCTGAGGTCAGGAGTTCGAGACCAGCCTGGCCAACCCGGTGAAACCCTGTCTCTACTAAAATACAAAAAAAAAAAAAAAAAAAAAAAAAAATTTAGCTGTGTGTGGTGGTGTGCACCTGTAATCCCAGCTACTCAGAAGGCTGAGGCAGGAGAATCGCTAGAACCCGGGAGGCGGAGGTTGCAGTGAGCCGAGATCGCACCATTACGCTCCAGCTTGGGCAACAAGAGTGAAACTCCATCTCAAAAACAAAACAAAACAAAACAAAAA","GGCCAGGCAGGGTGGCTTACATCTGTAATCCCAGCACTTTGGGAGGTCAAGGCGAGTGGATCACCTGAGGTCATGAGTTCAAGACCAGCCTGGCCAACTTGGTGAAACCCTGTCTCTACTAAAAATACAAAAAAAAAAAAAAAAAAAAAAAAAAAAATTAACTGGGTGTGGTGGTGCACACCTGTAATCCCAGCTACTCAGGAGGCTGAGGCAGGAGAATCCCTTGAACACGGGAGGTGGAGGTTGCAGTGAGCCGAGATCATGCCATTGCACTCCAGCCTTGGTGAAAAGAGCAAAACTCTGTCTTAAACAAAACAAAACAAAACCAGAAAA"
"chr17","11904179","11904388","JH378115","24252957","24253162","48","12348778","CCTGTCTTTACAAAAAATGCAAAAACAAAACAAAACAAAACAAAACAAAAACCGGGCATGGTGGTGAGCACCTGTAATCCCAGCTACTTGGGAGTTTGAGGCAGGAGAATCACTTGAACCTGGGAAGCGGAGGTTGCAGTGAGCCGAGACCGCGCCATTGCACTCCAGCCTGGGCAACAAGAATGAAACTCTGTCTCAAAAAAAAAAAAA","TGGTGAAACCCTGTCTTTACTAAAAATACAAAAAAAAAAAAAATTAGCTGGGCATGGTGGCACATGCCTGTAGTCCCAGCTGCTCGGGAGGCTGAGGCAGGAGAATTGCTTGAACCCAGGAGGCGGAGGTTGCAGTGAGCCGAGATCGAGCCATTGCACTCCAGCCTGGGCAACAAGAGCAAAACTCCGTCTCAAAACAAAATAAA"
"chr17","15884346","15884946","JH378118","18053084","18053501","249","2168738","GCCAGGCAGGTGGCTCAGGACTGTAATCCCAGCCTTTTGGGAGGCTGAGGCGAGTGGATCACCTGAGGTCAGGAGTTCGACACCAGCCTGGTCAACATGGTGAAACCCCGTCTCTACTAAAAAATACAAAAAATTGGCCAGGCGCAGTGTCTCACGCCTGTAATCCCAGCACTTTAGGAGGCTGAGGCAGGTGGATCACTTGGTCAGGAGATCGAGACCATCCTGGCCAACATGGTGAAACCCTGTCTCTATCAAAAATACAAAAATTAGCTGGGCGTGGTGGCATATGCCTATAATCCCAGCTACTTGGGACGCTGAGGCAGGAGAATCACTTGAACCAGGGAGTCAGAAGTTGCAGTGAGCCGAGATTGCGCCACTGCACCCCAGCCTGGTGACAGAGTGAGACTGTCTTAAAAAACAAAAAACAAAAAATTAGCCAGGTATGGTACCAGGTGCCTGTAACCCCAGCTACTTGGGAGGCTGAGGCAGGAGTATCGCTTGAACCCTGGAGGTGGAGGATGCAGTGAGCTGAGAGCACGCCATTGTACTCCAGCCTGGGCAACAAGAGTGAAACTCCATCTAAAATAAATAAAAATAAAAA","GGCTGGGCGCAGTGGCTCACACCTGTAATCCCAGCACTTAGGGAAGCTGAGGCGAGTAGATCACCTGAGGTCAGGAGTTAGAGACCAGCCTGGCCATCATGGTGAAACCCCGTCTCTACTAAAGATACCAAAAATTAGCTGAGTGTGGTGCTGGGTGCCTGTAATCCCAGAAACTCAGGGTGCCTGTAATCCCAGCAACTCAGGGTGCCTTTAATCCCAGCAACTGAGGGTACCAGTAATCCCAGCAACTCAGGGTGTCTTTAATCCTAGCAACTGAGGGCACCTGTAATCCCAGCAACTCAGGAAGCTGAGACAGGAGAAGTACTTGAACCCAGAAGGCAGAGGTTGCAGTGAGCCGATATTGCACCATTGCACTCCAGTCTGGGCAACAAGAGTGAAACTCTGTCTCAAAAAAAAA"
"chr17","16331846","16332458","JH378118","18053084","18053501","252","1721238","GGCCATGTGTGGTGGTTCACACCTGTAATCTCAGAACTTTGGGAGGCCGAGGTGGGTGGATCACCTGAGGTCAGGAGTTCGAGACCAGCCTGGCCAACATGGTGAAACCTCATCTCTACTAAAAATACAAAAAATTAAGGCCATACCCAGAGACTCATGCCTGTAATCCCAGCACTTTGGGAGGCTGAGGCGGATGGATCACTTGAGGTCAGGAGTTCAAAACCAGCCTGGCCAACATGGTGAAACCCCATCTCTACTAAAAATATAAAAATTAGCCGGGTGTGATGGCAGGCACCTGTAATCCCAGCTACTTGGGAGGCTGAGGCAGGAGAATTGCTTGAACCCAGGAAGCAGAGGTTGTGGTGAGCCGAGGTCGCGCCATTGCACTCCAGCCTGGGCAACAGAATGAGACTGTCTCAAAAAAAAAAAAAAAAAAAAATCAGCCAGGAGTGGTGGCGGGGGCACCTGTAATCCCAGCTACTCGGGAGGCTGAGGCAGGAGAATCGCTTGAACTCAGGAGGCAGAGGTTGCAGTGAGCTGATATCTCGCCATTGCACTCCAGCCTGGGCAACAAGAGTGAAACTGTCTCAAAAAAAAAAAAAAAAAAAAAGAA","GGCTGGGCGCAGTGGCTCACACCTGTAATCCCAGCACTTAGGGAAGCTGAGGCGAGTAGATCACCTGAGGTCAGGAGTTAGAGACCAGCCTGGCCATCATGGTGAAACCCCGTCTCTACTAAAGATACCAAAAATTAGCTGAGTGTGGTGCTGGGTGCCTGTAATCCCAGAAACTCAGGGTGCCTGTAATCCCAGCAACTCAGGGTGCCTTTAATCCCAGCAACTGAGGGTACCAGTAATCCCAGCAACTCAGGGTGTCTTTAATCCTAGCAACTGAGGGCACCTGTAATCCCAGCAACTCAGGAAGCTGAGACAGGAGAAGTACTTGAACCCAGAAGGCAGAGGTTGCAGTGAGCCGATATTGCACCATTGCACTCCAGTCTGGGCAACAAGAGTGAAACTCTGTCTCAAAAAAAAA"
"chr17","16464101","16464461","JH378293","1845184","1845523","61","14618917","GGCCGGGCGCCGTGGCTCACGCCTATAATCCCAGCACTTTGGGAGGCCGAGGCGGGTGGATCACCTGAGGTCAGGAGTTCGAGACCAGCCTGACCAACATGGTGAAACCCCCGTCTCTGCTAAAAAAAAAAAAATATATATATATATATATATAATATATAATATATATATATATATATATATAAAATAGCTGGGCATGGTGGCAGGCACCTGTAATCCCAGCTACTCAGGAGGCTGAGGCAGGAGAATCGCTTGAACCTGGGAGGTGGAGGTTGCAGTGGGCTAAGATCACACCATCGCACTCCAGCCTGGGCGACAGGAATGAAACGCTGTCTCAAAAAAAAAAAAAAAAAAAAAAAAA","GGCCGGGTGCGGTGGCTCACGCCTGTAATCCCAGCACTTTGGGAGGCCAAGGCGGGTGGATCACCTGAGGTCAGAAGTTCGAGACCAGCCTGGCCAACATGGTGAAACCCCGTCTCTGCTAAAAAGAAAAAAATAAGAAAAAAACAAAATAAGAAAATAATTTTAAAAAATACAAAATTAGCTGGGCGTGGTGGCAGGCACCTGTAATTCCAGCTATTCAGGAGGCTGAGGCAGGGGAATCACTTGAACCCAGGAGGCAGAGGTTGCAGTGAGCCAAGATGACGCCATTGCACACCAGCCTGGGCAACAAGAGTGAAACTCCGTCTCAAAAAAAAAACAA"
"chr17","16469420","16470033","JH378118","18053084","18053501","254","1583664","GCCAGGGGTGGTGGCTCATGCCTGTAATCCCAGCACTTTGGGAGGCTGAGGCGGGCAGATTGCCTGAGGTCAGGAATTCAAGACCAGCCTGGCCAACATAGTGAAACCCTGTCTCTACTAAAAATGCAAAGAATTAGCTGGGTGTTGGCCGGGCACGGTGGCTGACACCTGTAATCCCAGCACTTTGGGAGGCCTAGGCAGGCGGATCACCTGAGGTTGGGAGTTCGAGACCAGCCTGACCAACATGGAGAAACCCCGTCTCTACTGAAAATAAAAAACTAGCCAGGCATGGTGGCCCATGCCTGTAATCCCAGCTAATTGGGAGGCTGAGGCAGGAGAATCGCTTGAACCCAGGAGGCAGAGGTTGCGGTGAACCAAGATCGCATCAATGCACTCCAGCCTAGGCGACAAGAGCAAAACTCCGTCTCAAAAAAAAGAATTAGCTGGGTGTGGTGGGTGGGAACCTGTAATCCCAGTTACTAGGGAGGCTGAGGCAGGAGAATTGCTTGAACCCAGGAGGCGGAGGTTGTGGTGAGCCGAGATCGCGCCATTGCACTCCAGCCTGGACAACAAGAGCGAATCTCCGTCTCAAAAAAAAAAAAAAAAAAAAAAAA","GGCTGGGCGCAGTGGCTCACACCTGTAATCCCAGCACTTAGGGAAGCTGAGGCGAGTAGATCACCTGAGGTCAGGAGTTAGAGACCAGCCTGGCCATCATGGTGAAACCCCGTCTCTACTAAAGATACCAAAAATTAGCTGAGTGTGGTGCTGGGTGCCTGTAATCCCAGAAACTCAGGGTGCCTGTAATCCCAGCAACTCAGGGTGCCTTTAATCCCAGCAACTGAGGGTACCAGTAATCCCAGCAACTCAGGGTGTCTTTAATCCTAGCAACTGAGGGCACCTGTAATCCCAGCAACTCAGGAAGCTGAGACAGGAGAAGTACTTGAACCCAGAAGGCAGAGGTTGCAGTGAGCCGATATTGCACCATTGCACTCCAGTCTGGGCAACAAGAGTGAAACTCTGTCTCAAAAAAAAA"
"chr17","17534259","17534875","JH378118","18053084","18053501","268","518825","GGCTGGGGCGGTGGCTCACCTGTAATCCCAGCACTTTGGGAGGCAGAGGTGGGCGGATCGCCTGAGGTCAGAAGTTGGAGACCAGCCTGGCAACATGGTGAAACCCTGTCTCTACTAAAAAAAAAAAAAAAAAAAAAAAATGGCCGGGCATGGTGGCTCAAGCCTGTAATCCTAGCACTTTGGAAGGCTGAGGCGGGTGGATCACAAGGTCAGGAAATCGAGACCATCCTGGCTAACATGGTGAAACTCCGTCTCTACTAAAAATACAAAAAAAATTAGCCGGGCGTGGTGGTGGGTGCCTGTAGTCCCAGCTACTCGGGAGGCTGAGGCAGGCAAATGGAGTGAACCCGGGAGGCAAACTTGCAGTGAGCCAAGATGGCGCCATTGCACTCCAGCCTGGGCAACAAGAGCAAGACTCCTTCTCAAAAAAAAAAAAAATATATATATATATATATAGTCGGGCATGGTGGCAGGCACCTGTAATCCCAGCTACTCAGAGGCTGAGGCAGGAGAATCGCTTGAACCCTGGAGGTGGAGGTTGCAGTGAGCCAAGGTCATGCCATTGCACTCCAGCCTGGGCAACAAGAGCAAGACTCCGTCTCAAAAAAAAAAAAAAA","GGCTGGGCGCAGTGGCTCACACCTGTAATCCCAGCACTTAGGGAAGCTGAGGCGAGTAGATCACCTGAGGTCAGGAGTTAGAGACCAGCCTGGCCATCATGGTGAAACCCCGTCTCTACTAAAGATACCAAAAATTAGCTGAGTGTGGTGCTGGGTGCCTGTAATCCCAGAAACTCAGGGTGCCTGTAATCCCAGCAACTCAGGGTGCCTTTAATCCCAGCAACTGAGGGTACCAGTAATCCCAGCAACTCAGGGTGTCTTTAATCCTAGCAACTGAGGGCACCTGTAATCCCAGCAACTCAGGAAGCTGAGACAGGAGAAGTACTTGAACCCAGAAGGCAGAGGTTGCAGTGAGCCGATATTGCACCATTGCACTCCAGTCTGGGCAACAAGAGTGAAACTCTGTCTCAAAAAAAAA"
"chr17","17916069","17916669","JH378118","18053084","18053501","243","137015","GCCGGGTACAGTGGCTCACACCTGTAATCCTAGCACTTTGGGAGGCCGAGGCGGGTGGATCACCTGAGGTCAGGAGTTCGAGACCAGCCTGGCCAACATGATGAAACCCTACCTCAGCCAGGTACGGTGGTTCACGCCTGTAATCCTAGCACTTTGGGAGGCTGAGGCAGGTGGATTGCCTGAACTCAGGAGTTTGAGACCAGCCTGGGCAGCATGGTGAAACCCCATCTGTACTAAAATACAAAAACTTTGCTGGGCGTGGCGGCATGCACATGTAGTCCCAGTTACTTGGGAGGCTGAGGCAGGATAATTGTTTGAACCTGGGAGGCGGAGGTTGTACAGTGAGCCAAGATCGCGCCACTACACTCTAGCGTAGGTGACAGAGCGAGATTCCGCCTCCAAAAAAAAAAGAAACCCTGTCTCTACTAAAAATACAAACAATTAGCTGGGCGTGGTGGTGGGCGCCTGTAATCCCAGCTACTTAGGAGGCTGAAGCAGGAGAATCGCTTGAGCCCAGGAAGTGGAGGTTGCAGTGAGCTGAGATTGCTCCATTGCACTCTAGCCTGGGCAACAAGAGTGAAACTCTGTCTCAAAAAAAGAA","GGCTGGGCGCAGTGGCTCACACCTGTAATCCCAGCACTTAGGGAAGCTGAGGCGAGTAGATCACCTGAGGTCAGGAGTTAGAGACCAGCCTGGCCATCATGGTGAAACCCCGTCTCTACTAAAGATACCAAAAATTAGCTGAGTGTGGTGCTGGGTGCCTGTAATCCCAGAAACTCAGGGTGCCTGTAATCCCAGCAACTCAGGGTGCCTTTAATCCCAGCAACTGAGGGTACCAGTAATCCCAGCAACTCAGGGTGTCTTTAATCCTAGCAACTGAGGGCACCTGTAATCCCAGCAACTCAGGAAGCTGAGACAGGAGAAGTACTTGAACCCAGAAGGCAGAGGTTGCAGTGAGCCGATATTGCACCATTGCACTCCAGTCTGGGCAACAAGAGTGAAACTCTGTCTCAAAAAAAAA"
"chr17","18237318","18237912","JH378118","18053084","18053501","239","184234","GGCCATGCGTGGTGGCTCACGCCTGTAATCCCAGTACTTTGGGAGGCTGAGGTGGGAGGATCACCTGAGGTCAGGAGTTCGAGACCAGCCTGGCCAACATGATGAAACCCTGTCTCTACTAAAAATGCAAAAAATTGGCCGGGCACGGTGGCTCACGCCTGTAATCCCAGCACTTTGGGAGGCCAAGGCGGGTGGATCACAAGGTCAGGAGCTTGAGACCAGCCTGGCCAATATGGTGAAACCCCATCTCTACTAAAAATACAAAAATTAGCCAGGCGTGGTGGTACACACCTGTAGTCCCAGCTACTCGGGAGGCTGAGGCAGGAGAATTGCTTGAACTCAGGAGGCAGAGGTTGCAGTGAGCTGAGATGGTGCCACTGCACTGCAGCCTGGGCAACAGAGTGAGACTTCATCTCAAAAAAAAAAAAAAAATTAACCGGGTGTGGTGGCACGTGCCTATGGTCCCAGCCACTGGGGAGGCTGAGGCAGGAGAATCGCTTGAACACAGGAGGCAGAAGTTGCAGTGAGCTGAGATTGCACCACTGCACTCCAGCCTGGGTGACAAGAGTGGAACTCCATCTCAAAAAAAAAAGAA","GGCTGGGCGCAGTGGCTCACACCTGTAATCCCAGCACTTAGGGAAGCTGAGGCGAGTAGATCACCTGAGGTCAGGAGTTAGAGACCAGCCTGGCCATCATGGTGAAACCCCGTCTCTACTAAAGATACCAAAAATTAGCTGAGTGTGGTGCTGGGTGCCTGTAATCCCAGAAACTCAGGGTGCCTGTAATCCCAGCAACTCAGGGTGCCTTTAATCCCAGCAACTGAGGGTACCAGTAATCCCAGCAACTCAGGGTGTCTTTAATCCTAGCAACTGAGGGCACCTGTAATCCCAGCAACTCAGGAAGCTGAGACAGGAGAAGTACTTGAACCCAGAAGGCAGAGGTTGCAGTGAGCCGATATTGCACCATTGCACTCCAGTCTGGGCAACAAGAGTGAAACTCTGTCTCAAAAAAAAA"
"chr17","18951167","18952093","JH378118","18053084","18053501","537","898083","GGCCAGGGGCAGTGGCTCATGCCTGTAATCCCAGCATTTTGGGATGCCAAGGCTGGTGGATCAACTGAGGTCAGGAGTTTCAGACCACCCTGGCCAACATGGCGAAATCCCATCTCTACTAAAAATACAAAAATTAGGCCAGGCACAGTGGCTCATGCCTGTAATCCCAGCACTTTGAGAGGCCAAGGCGGGCGATCACGAGGTCAGGAGATTGAGACCATCCTGGCTAACACGGTGAAATCCTGTCTCTACTAAAAAAAAAAAATACAAAAAATTAGCCGGGACGTGGTGGCTGGCACCTGTAGTCCCAGCTACTCGGGAGGCTAAGGCAGGAGAATGGCATGAACCCGGGAGATGGAGCTTGCAGTGACCCGAGATCGCGTCACTGCACTCCAGCCTGAACAACAGAGCAAGACTATATCTCAAAAAAAAAAAAAAAAAAAAGGCCGGGTGCAGTGGCTCACGTCTGTAATCCCAGCACTTTGGGAGGCCGAGGTGGGTGGATCACGAGGTCAGGAGATCGAGACCATCCTGGCTAACATGATGAAACCCCATCTCTACTAAAAAATACAAAAAATTAGCCGGGTGTGGTGGCAGGCACCTGTAGTCCCAGCTACTCGGGAGGCTGAGGCAGGAGAATGGCATGAACCTGGGTAGTGGAACTTGCAGTGAGCCGAGATCACGCCACTGCACTCCAGCCTGGGCGACAGAGCGAGACTCTGTCTCAAAAAAAAAAAAAAAAAAAAAATTAGCCGGGCATGGTGGTGGGTGCCTGCAATCCCAGCTAGTCAGGAGGCTGAGGCTGGAGAATCCCTTGAACCCAGGAGGTAGAGGTTGCAGTGAGCCAAGATCACGCCATTGCATTCCAGCCTGGGCAACAAGAGTGAAATTCTGTCTCAAAAAAATAAACAAACAAGTAAAATAAAA","GGCTGGGCGCAGTGGCTCACACCTGTAATCCCAGCACTTAGGGAAGCTGAGGCGAGTAGATCACCTGAGGTCAGGAGTTAGAGACCAGCCTGGCCATCATGGTGAAACCCCGTCTCTACTAAAGATACCAAAAATTAGCTGAGTGTGGTGCTGGGTGCCTGTAATCCCAGAAACTCAGGGTGCCTGTAATCCCAGCAACTCAGGGTGCCTTTAATCCCAGCAACTGAGGGTACCAGTAATCCCAGCAACTCAGGGTGTCTTTAATCCTAGCAACTGAGGGCACCTGTAATCCCAGCAACTCAGGAAGCTGAGACAGGAGAAGTACTTGAACCCAGAAGGCAGAGGTTGCAGTGAGCCGATATTGCACCATTGCACTCCAGTCTGGGCAACAAGAGTGAAACTCTGTCTCAAAAAAAAA"
"chr17","20996420","20997041","JH378118","18053084","18053501","266","2943336","GGCTAGGCGCGGTGGTTCACACCTGTAATCCCAGCACTTTGGGAGGCCAAGGTGGGTGGATCACCTGTGGTCAGGAGTTCGAGACCAGCCTGGCCAACATTGTGAAACCCCGTCTCTACTAAAAATGCAAAAAATTAGCTGGGCGACCAGTCATGGTAGCTCACGCCTGTAATCCTAGCACTTTGGGAGGCCAAGGCGGGTGGATTGCCTGAGCTCAGGAGTTAGAGGCCAGCCTGGGCAACATGGTAAAACCCTGTCTCTACTAAAATACAAAAAAAAAAAAAAAAATTAGCTGGGTGTGACAGCGTGCATCTGTAATCCCGGTTACTTGGGAGGTTGAGGCAGGAGAATTCCTTGAACCTAGGAGGCGGAGGTTACAGTTAGCCGAGATCACGCCATTGCACTCCAGCCTGGGCAACAGAGCGAGACTCCATCTCAAAAAAAAAAAAAAAAATTCAGCTGGGCGTGGTGGCGGGCACCTGTGATCCTAGCTACTCAGGAGGCTGAGGCAGGAGAATCATTTGAACTCCGGAGGCGGAGGTTGCAGTGACCCTAGATCGCACCATTGTGTTCCAGCCTGAGCAACAAGAGCGAGACGCCATCTGAAAAAAAAAAAAAGAAA","GGCTGGGCGCAGTGGCTCACACCTGTAATCCCAGCACTTAGGGAAGCTGAGGCGAGTAGATCACCTGAGGTCAGGAGTTAGAGACCAGCCTGGCCATCATGGTGAAACCCCGTCTCTACTAAAGATACCAAAAATTAGCTGAGTGTGGTGCTGGGTGCCTGTAATCCCAGAAACTCAGGGTGCCTGTAATCCCAGCAACTCAGGGTGCCTTTAATCCCAGCAACTGAGGGTACCAGTAATCCCAGCAACTCAGGGTGTCTTTAATCCTAGCAACTGAGGGCACCTGTAATCCCAGCAACTCAGGAAGCTGAGACAGGAGAAGTACTTGAACCCAGAAGGCAGAGGTTGCAGTGAGCCGATATTGCACCATTGCACTCCAGTCTGGGCAACAAGAGTGAAACTCTGTCTCAAAAAAAAA"
"chr17","21298865","21299429","JH378206","6546474","6546861","222","14752391","GGCCGAGGCAGGTGGATCACCTGAGGTCAGGAGTTCAAGACTAGTCTGGCCAACATGGTGAAACCCTGTCTCTACTAAAAATACAAAAAATTGGCCGGGCGCGGTGGCTCATGCCTGTAATCCCAGCACTTTGGGAGGCTGAGGCGGGTGGATCACGAGGTCGGGAGATCGAGACCATCCTGGCTAACACAGTTAAACCCTTTCTCTACTAAAAAATACAAAAAATTAGCCGGGCGTAGTGGGGGGCGCCTGTAGTCCCAGCTACTCAGGAGGCTGAGGCAGGAGACTGGCGTGAACCCGGGAGGCAGAGCTTGCAGTGAGCTGAGATCACGTCACTGCATGCCAGCCTGGGCGACAGAGCGAGACTCTGTCTCAAAAAAAAAAAATTAGCCAGGCATGGTGGTGTACACCTGTAATCCTAGCTACTCGGGAAGCTGAGCAGGAGAACAGCTTGAACCCAGGAGGCAGAGGTTGCAGTGAGCTGAGATCACGCCATTGCACTCCAGCCTGGGCAACAAGAGTGAAACTCCGTCTCAAAAAAAAAAAAAGAAAAGAAAAAAGAAAA","GGCCACACATGGTGGCTAACGCCTGTAATCCCAGCACTTTGGGAGGCCAAGTCGGGTGGATCATGAGGTCAGGAGACCAAGACCATCCTGGCCAAATGGTGAAACCCCGTCTCTACTAAAAATACAAAAATTAGCTGGGCATGGTGGCGTGTGCCTGTAATCCCAGCTACTCAGGAGGCTGAGGCAGGACAATTGCCTGAACCCAGGAGAATTAGCTGGGCATGGTGGCGTGTGCCTGTAATCCCAGCTACTCAGGAGGCTGAGGCAGGACAATTGCCTGAACCCAGGAGGCGAAGGTTGCGGTGAGCCGAGATTGTGCCATTGCACTCCAGCCTGGGTAACAAGAGCGACACTCTGTCTCAAAAAAAAAAAAAAAAAAAAAAAAAAA"
"chr17","21663027","21663921","JH378118","18053084","18053501","517","3609943","TTGGGAGGCCAAGGTGGGCCTCCCAGACACGTGAGGTCAGGAGTTTGAGACCAGCCTGGACAATATGGCGAAACCCCATCTCTACTAAAAAAACACAAAAATTGGTTGGGCCGGGCACGGTGGCTCACGCCTGTAATCCCAGCACTTTGGGAGGCCGAAGTGGGCAGATCACGAGGTCAGGAGATCGAGATCATCTTGGCTAACATGGTGAAACTCCGTCTTTACTTAAAATACAAAAAATTAGCTGGGCATGATGGCAGGCAGTTGGAGTCCCAGCTACTTGGGAGGCTGAGGCAGGAGAATCGCTTGAACCCGGGAGGCAGAGGTTGCAGTGAGCTGAGATCGTGCCATTGCACTCCAGCCTGGGTGACAGAATGAGACTCCGTCTGAAAAAAAAACAAAAAACAAAAAACAAAAATTGGCCAGGTGCGGTGGCTCACGCCTGTAATCCCAGAACTTTGGGAGGCCGAGGCAGGTGGATCATGAGGTCAGGAGTTCAAGACCAGCCTGGCCAAGATGGTGAAACCCCATCTCTACTAAAAATACAAAAATTAGGCGGGCACGGTGGCAGGTGCCTGTAATCTCAGCTACTCAGGAGGCTGAGGCAGGAGAATTGCCTGAAGCCGGGTGGCAGAGGTTGCAGAGAGCTAAGATCACGCCACTGCACTCCAGCCTGGGTGATAGAGTAAGACTCTATCTCAAAAAAAGAAAAAAAAAAATAGCCGGGCATTGTGCTGGGCGCCTGTAATCCCAGCTACTTGGGAGGCTGAGACAAGAGAATCACTTGAACCTGGGAGGCGGAGGTTGCAGTGAGCCGAGATCGTGCCATTGCACTCCAGCCTGGGTGAGAAGAGCAAAACTCTGTCTCAAAAAAACAAAAAAAGAAGAAAACAAA","GGCTGGGCGCAGTGGCTCACACCTGTAATCCCAGCACTTAGGGAAGCTGAGGCGAGTAGATCACCTGAGGTCAGGAGTTAGAGACCAGCCTGGCCATCATGGTGAAACCCCGTCTCTACTAAAGATACCAAAAATTAGCTGAGTGTGGTGCTGGGTGCCTGTAATCCCAGAAACTCAGGGTGCCTGTAATCCCAGCAACTCAGGGTGCCTTTAATCCCAGCAACTGAGGGTACCAGTAATCCCAGCAACTCAGGGTGTCTTTAATCCTAGCAACTGAGGGCACCTGTAATCCCAGCAACTCAGGAAGCTGAGACAGGAGAAGTACTTGAACCCAGAAGGCAGAGGTTGCAGTGAGCCGATATTGCACCATTGCACTCCAGTCTGGGCAACAAGAGTGAAACTCTGTCTCAAAAAAAAA"
"chr17","21688652","21689276","JH378118","18053084","18053501","258","3635568","GGCCGGGTGCCATGGCTCACGCCTATAATCCCAGCACTTTGGGAGGCCAAGGTGGGCGGATCACCTGAGGTCAGGAGTTTGAGACCAGCCTGGCCAACATAGTGAAACCCCGTCTCTACTAAAAATACGAAAAGTTAGCTGGGGGTGCAGTGGCTCACACCTGTAATTCCAGCACTTTGGGAGGCCGAGGCAGGTGAATCACGAGGGGAGGAGTTTGAGACCAGCCTAACCAATATGTTGAAACCCCGTTTCTACTAAAAATACAAAAATTAGCTGGGCGTGGTGGCACGTGCCTATAATCCCAGCTACTCAGGAGGCTGAGGCAGGAGAATCGCCTGAACCTGGGAGGCGGAGGTGGCAGTGAGCCAAGATCACACCACTGCACTTTAGCCTGGGTGACAGAGGGAGACTCTGTCTCAAAAAACAAAACAAAACAAAACAAAAAATTAGGCAGGCTTGGTGGCACATGCCTGTAATCCCAGCTACTCAGGAGGCTGAGGCAGGAGAATTGCTTGAACCCAGGAGGCAGAAGTTGCAGTGAGCTGAGATCGCGCCATTGCACTCCAGCCTGGGTAACAAGAGTGAAACTCCATCTCAAAAAAAAAAAAAAAAAAAAAAAAAAAAA","GGCTGGGCGCAGTGGCTCACACCTGTAATCCCAGCACTTAGGGAAGCTGAGGCGAGTAGATCACCTGAGGTCAGGAGTTAGAGACCAGCCTGGCCATCATGGTGAAACCCCGTCTCTACTAAAGATACCAAAAATTAGCTGAGTGTGGTGCTGGGTGCCTGTAATCCCAGAAACTCAGGGTGCCTGTAATCCCAGCAACTCAGGGTGCCTTTAATCCCAGCAACTGAGGGTACCAGTAATCCCAGCAACTCAGGGTGTCTTTAATCCTAGCAACTGAGGGCACCTGTAATCCCAGCAACTCAGGAAGCTGAGACAGGAGAAGTACTTGAACCCAGAAGGCAGAGGTTGCAGTGAGCCGATATTGCACCATTGCACTCCAGTCTGGGCAACAAGAGTGAAACTCTGTCTCAAAAAAAAA"
"chr17","22129020","22129352","JH378128","1602813","1603145","53","20526207","GCCAGGCACGGTGGCTCACACCTGAATTCCAGTACTTTGGGAGGCCGAGGCGGGCGGATCTCTTGAGGTCAGGAGTTTGAGACCAGCCTGGCCAACATGGTGAAACCCCATCTCTACTAAAAATACAAAAATTAGCCGGGCGTGGTGGCAGGTGCCTGTAATCCCAGCTACTTGGGAGGCTGAGGCAGGAGAACCTCTTGAACCCAGGAGGTGGAGGCTGCAGTGAGCTGAGATTGTGCCACTTCACTCCAGCCTGGAAGACAAGAGCAAGACTTCATCTCAAAAAAAAATAAAAAAAAAATAAATAAATAAATAAATAAAAATTTAAAAAAA","GGCCAGGTGCAGTGGCTCACGCCTGTAATACCAGCATTTTGGGAGGCCGAGGCAGGTGGATCACGAGGTTAGGAGTTTGAGACCAGCATGGCCAACATGGAGAAACCCCGTCTCTACTAAAAATACAAAAATTAACCAGGCATGGTGGCAGGTGCCTGTAATTCCATCTACTCGGGAGGCTGAGGCAGGAGAATCCCTTGAACCTGGGAGGCGGAGGTTGCAGTGAGCCGAGATTGTGCCATTGCACTCAGTCTGGGTGACAAAAACAAGACTCCATCTCAAAAAAAAAAAAAAGAAAAGAAAAAGAAAAAAAGAAAGAAAGAAAGAAAGAAA"
"chr17","22130129","22130738","JH378118","18053084","18053501","262","4077045","GGCTGGGCACAGTGGCTCACGCCTGTAATCTCAGCACTTCGGGAAGCCGAGGCGGGCAGATCAGCTGAGGTCAGGAGTTCAAGACCAGCCTGGCCATGGCAAAACCCTGTCTCTACTAAAAAATGCAAAAAATAGGGGCCAGGCACGGTGGCTCACGCCTGTAATCCCAGCATTTTGGGAGGCCAAGGCAGGCGGATCACAAGGTCAGGAGGTTGAGACCATCCTGGCCAACATGGTGAAACCCCATCTCTACTAAAAATACAAAAATTAGCTGGGTGTGGTGGCCTGTGCCTGTAATCCCAGCTACTTGGGAGGCTGAGGCAGGGGAATCACTTGAATCCAGGAGACAGAGGTTGTAGTGAGCTGAAATGGAGCCACTGCACTCCAGCCTGGCGGCAGAGCGAGACTCTGTCTCAAAAAAAAAAAAAATACAAAAAATAGCTAGGTGTGATGGTGGGCACCTGTAATCCCAGCTACTTGGGTAGCCGAAGCAGGAGAATCGCTAGAACCTGGGAGGTGGAGGTTTAGTAAGCTGAGATCACACCATTGCACTCCAGCCTGGGTATCAACAGCGAAACTCCATCTCAAAAAAAAAAAAAAAAAAAGAAAA","GGCTGGGCGCAGTGGCTCACACCTGTAATCCCAGCACTTAGGGAAGCTGAGGCGAGTAGATCACCTGAGGTCAGGAGTTAGAGACCAGCCTGGCCATCATGGTGAAACCCCGTCTCTACTAAAGATACCAAAAATTAGCTGAGTGTGGTGCTGGGTGCCTGTAATCCCAGAAACTCAGGGTGCCTGTAATCCCAGCAACTCAGGGTGCCTTTAATCCCAGCAACTGAGGGTACCAGTAATCCCAGCAACTCAGGGTGTCTTTAATCCTAGCAACTGAGGGCACCTGTAATCCCAGCAACTCAGGAAGCTGAGACAGGAGAAGTACTTGAACCCAGAAGGCAGAGGTTGCAGTGAGCCGATATTGCACCATTGCACTCCAGTCTGGGCAACAAGAGTGAAACTCTGTCTCAAAAAAAAA"
"chr17","23633062","23633662","JH378118","18053084","18053501","247","5579978","GGCCAGGCGTGGTGGCTTACGCCTGTAATCCCAGCATTTTGGGAAGCTGAGGCAGGTGGATCACCTGAGGTCAAGAGTTCAAGACCAGCCTGGCCAACATGGTGAAACCCCGTCTCTACTGCAAATACAAAAAATTAGTAGCCGGGCATGGTGGCTCACGCCTGTAATCCCAACACTTTGGTAGGCCAAGGCGGGTGGATCACCTGAGGTCGGGAGTTCGAGACCAGCCTGACCAACATGGAGAAACCCCGTCTCTACTAAAAGTACAAAATTAGCCAGGGATGGTGGCATGTGCCTGTAATCCCAGCTATTTGGGAAGCTAAGGCACAAGAATCGCTTTGAACCTGGGAGACAGAGGTTGCAGTGAGCTGAGATCGCACCATTGCACTCCCGCCTGGGCAACAAGAGCGAAACTCCATCTAAAAAAAAAAAAAAAAAAAAAAAAGCCAGGCATGGTGACAGGCACCTTGTAATCCCAGCTACTCGGAAGGCTGAGGCAGGAGAATCGCTTGAACACTGCAGAGGTTGCAGTGAGCTGAGATCACGCCATTGCACTGCAGCCTAGGCAACAAGAGTGAGACTCTATCTCAAAAAAAAGAAA","GGCTGGGCGCAGTGGCTCACACCTGTAATCCCAGCACTTAGGGAAGCTGAGGCGAGTAGATCACCTGAGGTCAGGAGTTAGAGACCAGCCTGGCCATCATGGTGAAACCCCGTCTCTACTAAAGATACCAAAAATTAGCTGAGTGTGGTGCTGGGTGCCTGTAATCCCAGAAACTCAGGGTGCCTGTAATCCCAGCAACTCAGGGTGCCTTTAATCCCAGCAACTGAGGGTACCAGTAATCCCAGCAACTCAGGGTGTCTTTAATCCTAGCAACTGAGGGCACCTGTAATCCCAGCAACTCAGGAAGCTGAGACAGGAGAAGTACTTGAACCCAGAAGGCAGAGGTTGCAGTGAGCCGATATTGCACCATTGCACTCCAGTCTGGGCAACAAGAGTGAAACTCTGTCTCAAAAAAAAA"
"chr17","34071612","34072215","JH378118","18053084","18053501","250","16018528","GGCCAGGTGTGGTGCCTTACATCTGTAATTCCAGCACTTTGGGAGGCTGAGGTGGGTGGATCACCTGAGGTCAGGAGTTCAGGACCAACCTGGCCAACATAGTGAAACCCCGTCTCACTAAAAATACAAAAATTAAAAAGAAAGAAAGAAAAAAGCCAGGTGCGGTGGCTCACACCTGTAACCCCAGCACTTTGGGAGGCCAAGATGGGCGGATCACCTGAGGTCGGGAGTTTGAGACCAGCCTGACCAACATGGAGAAACCCCGTCTCTACTAAAAATACAAAATTAACCAGGCGTGGTGGTGCATGCCTGTAATCCCAGCTACTTGGGAGGATGAGGCAGGAGAATCGCTTGAACCCTGGAGGCGGAGGTTGTGGTGAGCTGAGATCATGCCATTGCACTCCAGCCTAGGCAACAAGAGCGAGACTCCATCTCAAAAAAAAAAAAAAAATTGGGCATGGTGGTGCATGCCTGTAATCCCAGCTACTCAGGAGTCTAAGGCAGGAGAATCACTTGAACCCAGGAGGCAGAGGTTGCAGTGAGCTGAGATCACGCCATTGCACTCCAGCCTGAGCGACAAGAGTGAAACTACGTCTCAAAAAAA","GGCTGGGCGCAGTGGCTCACACCTGTAATCCCAGCACTTAGGGAAGCTGAGGCGAGTAGATCACCTGAGGTCAGGAGTTAGAGACCAGCCTGGCCATCATGGTGAAACCCCGTCTCTACTAAAGATACCAAAAATTAGCTGAGTGTGGTGCTGGGTGCCTGTAATCCCAGAAACTCAGGGTGCCTGTAATCCCAGCAACTCAGGGTGCCTTTAATCCCAGCAACTGAGGGTACCAGTAATCCCAGCAACTCAGGGTGTCTTTAATCCTAGCAACTGAGGGCACCTGTAATCCCAGCAACTCAGGAAGCTGAGACAGGAGAAGTACTTGAACCCAGAAGGCAGAGGTTGCAGTGAGCCGATATTGCACCATTGCACTCCAGTCTGGGCAACAAGAGTGAAACTCTGTCTCAAAAAAAAA"
"chr17","34329459","34330029","JH378119","32351107","32351490","237","1978352","GGCCAGGTGCCGTGGCTCACACATGTAGTCCCAGCACGTTGGGAGGCTGAGGTTAATGGATCACCTGAAGTCACAAGTTCGAGACCAGCCTGACCAACATGGTGAAACCCTGTCTCTACTAAAATATAAAAAGTAGTCGGCCGGGCGCAGTTGCTCATGCCTGTGATCGCCTGAGGTCAGGATTTCAAGCCCAGCCTGGCCAAAATGGTGAAACCCCATCTCTACTAAAAATATAAAAATTAGCCAGGCATGGTGGCAGGTGCCTGTAATCCCAGCTACTCAGGAGGTTGAGGCAGGAGAATCACTTGGACCCAGGGGGCAGAGGTTGCAGTGAGCCAAGATCACAGCATCGCACTCCAGCTTAGGCAACAAGAGAGAAACTCCATCTCAAAAAAAACCCAAAAAAAACAAAAAAACAAAAAAACCCAGGCATGGTGGCAGGCGTCTGTAATCTCAGCTACTCGGGAGGCTGAGGCAAGAGAATCGCTTGAACCTGGGAGGCAGAGGTTGCAGTGAGCCAAGATCATGCCATTGCACTCCAGACTGAGCAATAAGAGCGAAACTCCATCTC","GGCCAGGTATGGTGGCTCACACCTGTAATCCCAGCACTTTGGGAGGCCAAGGCAGGCAGACCACCTGAGGTCAGGAGTTCGAGATCAGCCTAGCCAACATGGTGAAACCCCATCTCTAGTAAAAATAAAATTAGCCAGGCATGGTGGTGCATGCCTGTAACGCAGGTCAGGAGTTCGAGATCAGCTTAGCCAACATGGTGAAACCCCATCTCTAGTAAAAATAAAATTAGCCAGGCAGGTGGTGCCGCCTGTACTCGGGAGGCTGAGGCAGGAGAATCACTTGAACCCAAGAGGCAGAGGTTGCAGTCAGCCAAGATCATGCCATTGCACTCCAGCCTAAGCAAAAAGAGTAAAACTCAGTCTCAAAACAAAAAAACAAAAAAA"
"chr17","35196292","35196625","JH378228","5665092","5665424","47","29531200","GGCTGGGCATGGTGTCTTACGCCTGGAATCCCAGCACTTTGGGAGGCCAAGGCGGGTGGATCACCTGAGGTCAGGAGTTTGAGACCAGCCTGGCCAACATGTTGAAACTCTGTCTCTACTAAAAATACAAAAATTAGCCGGGCATGGTGGCGGATGCCTGTAATCCCAACTACGTGGGAGGCTGAGGCAGGAGAATCGCTTGAACCCAGGAGATGGAGGTTGTGGTGAGCCGAGATCATGCCATTGCACTCCAGCCTGGGCAACAAGAACAAAACTCTGTCTCAAAATAAATAAAAAAATAAATAAATAAATAAAAACAACAACAACAACAAAA","GGCCGGGCGCGGTGGCTCAAGCCTGTAATCCCAGCACTTTGGGAGGCTGAGGCGGGTGGATCACGAGGTCAAGAGATCGAGACCATCCTGGTCAACATGGTGAAACCCTGTCTCTACTAAAAATACTAAAAATTAGCTGGGCATGGTGGCGTGTGCCTGTAATCCCAGCTACTCAGGAGGCTGAGGCAGGAGAATTGCCTGAACCCAGGAGGCGGAGGTTGCGGTGAGCCGAGATCGCGCCATTGCACTCCAGCCTGGGCAACAAGAGCGAAACTCTGTCTCAAAAAAAAAAAATAAATAAATAAAATAAAATAAAATAAAATAAAATAAAAT"
"chr17","40291413","40291755","JH378144","13229286","13229620","52","27062127","GGCCAGGCACAGTGGCTCATGCCTGTAATCCCAGCACTTTGCGAGGCTGAGCCAGGTGGATCACCTGAGGTCAGGAGTTCAAGAGCAGCCTGGCCAACATGGTGAAACCCCGTCTCTACTAAAAATACAAAAATTATCTGGAGTGGTGGTAGGTGCCTATAATTGCAGATACACAGAAGGCTGAGACAGGAGAATTGCTTGAACCCAGGAGGCGGAGGTTGCTGTGAGCCGAGATCGCGCCATTGCACCCCAGCCTGGGAGACAAGAGCGAAACTCCATCTCAATAAATAAATACATACATACATACATACATACATGCATACATACATAAAATAAAATAAAA","GGCCGGGCGCGGTGGCTCAAGCCTGTAATCCCAGCACTTTGGGAGGCCGAGGCGGGTGGATCACCTGTGGTCAGGAGTTCAAGACAGCTTGGTCAACATGGTGAAACCCCGTCTCTACCAAAAATACAAAAAATTAGCTGGGCATGGTAGCGCATGCCTGTAATCCCAGCTACTCAGGAGGCTGAGGCAGGAGAATTGCCTGAACCCAGGAGGCAGAGGTTGCGGTGAGCCGAGATCGCGCCATTGCACTCCAGCCTGGGTAACAAGAGCGAAACTCCCTCTCATAAAAAATAAATAAATAAATAAATAAATAAATAAATAAATAAATAAATAAA"
"chr17","45148344","45148987","JH378206","6546474","6546861","299","38601870","GGCTTGGTGCCATGGTTCATGCCTGTAATCCTGGCACTTTGGGAGGCCGAGGTGGGCAGATCACTTGAGCTCAGGAGTTCAAGACCACCTTGGGCGACATGGTGAAACCTCATCTCTCCTTAAAAAAAAAAAAAACAGCCGGGCGCGGTGGCTCACACCTGTAATCCCAGCACTTTGGGAGGCCAAGGCGGGTGGGGTTCATGAGGTCAGAAGATCGAGACCATCCTGGCTAACACGGTGAAACCCCGTCTCACTAAAAATAGAAAAAACTAGCCGGGCGTGGTGGCGGGCACCTGTAGTCCCAGCTACTCGGGAGGCTGAGGCAGGAGAATGGCGTGAACCCGGGAGGCGGAGCTTGCAGTGAGCTGAGATCTTGCCATTGCACTCCAGCCTGGGCAACAAGAGTGAAACTCTGTCTCAAAAAAAAAAAATTAAAAAAACAAATAAAAATAAAAATACATAATTAGCAGGACATGGTGGCACATGCCTGTAATCCCCAGCTACTCGGGAGGCTGAGGCATGGGAATTGTTTAAACCTGTGAGGCGGTGGTTGCAGTGAGCCAAGATCAAGCCATTGCACTCCAGCCTGGGCAACAAGAGTGAAACTCCATCTCAAAAAAAAAAAAAAAAAAGAGAAAAGAAAA","GGCCACACATGGTGGCTAACGCCTGTAATCCCAGCACTTTGGGAGGCCAAGTCGGGTGGATCATGAGGTCAGGAGACCAAGACCATCCTGGCCAAATGGTGAAACCCCGTCTCTACTAAAAATACAAAAATTAGCTGGGCATGGTGGCGTGTGCCTGTAATCCCAGCTACTCAGGAGGCTGAGGCAGGACAATTGCCTGAACCCAGGAGAATTAGCTGGGCATGGTGGCGTGTGCCTGTAATCCCAGCTACTCAGGAGGCTGAGGCAGGACAATTGCCTGAACCCAGGAGGCGAAGGTTGCGGTGAGCCGAGATTGTGCCATTGCACTCCAGCCTGGGTAACAAGAGCGACACTCTGTCTCAAAAAAAAAAAAAAAAAAAAAAAAAAA"
"chr17","47866693","47867898","JH378118","18053084","18053501","809","29813609","GGCTGGGCTTGGTGGCTCATGCCTATAATTCTAGGACTTTGGGAGGCCAAGGCGGATGGATCACCTGAGGTCAAGAGTTGGAGACCAACCTGTCCAACATGGTGAAACCCCCTCTGTACTAAAAATACAAAAATTGGCCGAGCGTAGTGGCTCATGCCTGTGATCACAGCACTTTGAGAGGCTGAGGCGGGCGGATCACAAGGTCAGGAGATCAAAACCATCCTGGCTAACAAGGTGAAACCCCATCTCTGCTAAAAAATAACAGGGCGTGGTGGCACACGGCTGTAGTCCCAGCTACTTGGGAAGCTGAGGCAGGAGAATCGCTTGAACCTGAGAGGCAGAGGTTGCAGTGAGCTGAGATCAGGCCACTGCTCTCCAGCCTGGGCAACAGAGTGAAACTCCATCTCAAAAAAAAAAAGAAAAAGGCCAGGCATGGTGGCTCACGCCTGTAATGCCAGCACTTTGGAAGACTAAGTTGGGCAGATCACAACATCAGAAGATGGAGACCATCCTGGCTAACACGGTGAAACCCCGTCTCTACTAAAAATACAAAAAAAAAAAAAAAAAAAATTAGCCGGGCGTGGTGACATGCGCCTGTAATCCTAGCTACTCCGGAGGCTGAGGCAGGAGAATGGCGTGAACCCGGGAGGCGGAGCTTGCAGTGAGCCGAGATGGTGCCACTGCACTCCAACCTGGGCGACAGAGCGAGACTCTGTCTCAAAAAAAAAAAAAAAAAAGAAAAAAGGTCGGGCGCAGTGGCTCACACCAGTAATCACAGCACTTTGGGAGGCCGAGGCGGGTGGATCACCTGAGCTCGGGAGTTCAAGACCAGCCTGACCAACATGGTGAAACTCCGTCTCTACTAAAAATACAAAATATTAGCCGGGCGTGGTGGCGCGTGCCTGTAATCCCAGTTACACGGGAGGCTGAGGCAGGAGAATCACTTGAACTTGGGAAGTGGAGGTTGTGGGAGCCGAAATCGTGCCATCGCATTCCACAAGAGTGAAACTCCATTTCAAAAAAAAAAAATACAAAAATTAGCTGGGCGTGGTGGCGGGCGCCTTTAATCCCAGGGGCTCGGGAGGCTGAGGCAGGAGAATCGCTTGAACCTAGGAGGCAGAGGTTGCAGTGTGCCAAGATGACACCATTGCACTCCAGGCTGGGCAAGAGAGCAGTAACTCCCGTCTCAAAAAAAAAGAAGGAAAA","GGCTGGGCGCAGTGGCTCACACCTGTAATCCCAGCACTTAGGGAAGCTGAGGCGAGTAGATCACCTGAGGTCAGGAGTTAGAGACCAGCCTGGCCATCATGGTGAAACCCCGTCTCTACTAAAGATACCAAAAATTAGCTGAGTGTGGTGCTGGGTGCCTGTAATCCCAGAAACTCAGGGTGCCTGTAATCCCAGCAACTCAGGGTGCCTTTAATCCCAGCAACTGAGGGTACCAGTAATCCCAGCAACTCAGGGTGTCTTTAATCCTAGCAACTGAGGGCACCTGTAATCCCAGCAACTCAGGAAGCTGAGACAGGAGAAGTACTTGAACCCAGAAGGCAGAGGTTGCAGTGAGCCGATATTGCACCATTGCACTCCAGTCTGGGCAACAAGAGTGAAACTCTGTCTCAAAAAAAAA"
"chr17","48059944","48060302","JH378108","45564157","45564495","64","2495787","GGCCGGGCGCAGTGGTTCATGCCTGTAATCCCAACACTTTAGGGGGCTGAGGCAGGTGGATCACCTGAGGTCAGGAGTTCAAGACCAGCCTGGCCAACATGGTGAAAGCCCATCTCTACTAAAAATACAAAAAATTAGCTGGGCATGGTGGTGCGTGCCTGTAATCCCAGCTACTTGGGATGCTGAGGCAGGAGAATCGCTTGAACCCGGGAGGTGGAGGCTGCAGTGAGCTGAGATTGTGCCATTGCACTCCAGCCTGGGCAACAAGAGTGAAACTCCATCTAAAAAAAAAAAAGAAGAGGAGGAGGAGGAGGAGGGGGAGGGGGAGGAGGAGGAGGAGGAGAAGAAGAAAAAAGAAA","GCTAGGCAAGGTGGCTCATGCCTGTAATCCCAACATTTTGGGAGGCCGAGGCAGATGGATCACCTGAGGTTAGGAGTTCAAGACCAGCCTGGCCAACATGGTGAAACTCCATCTCTACTAAAAATACAAAAAATTAGCTTGGCACGGTGGTGGGTGCCTCTAATCCCAGCTGCTTGGGAGGCTGAGGCAGGAGAATCGCTTGAACTCAGGAGGTGGAGGTTGCAGTGAGCCAAGATCATGGCATTGCACTCCAGCCTGGGCGACAAGAGCGAGACTCCCTCTAAGAAAGAAAAGAAAGAAAAGAAAAGAAAAAAGGAAAGGAAAGGAAAGAAAGAGAAA"
"chr17","50365982","50366602","JH378118","18053084","18053501","274","32312898","GGCAAGGCGTGGTGGCTGATGTCTGTAATCCCAGCAATTTGGGGGGCTGAGGTGGATGGATCACCTGAGATCAGAAGTTCGAGACTAGGCTAGCCAACATAGTGAAACCCCATCTCTACTAAAAATATAAAAAGTTAGCCAGGCGCGGTGGTTCATGCCTGTAATCCCAGCACTTTGGGAGGCCGAGGTAGGTGGATCACAAGGTCAGGAGTTCAAGACCAACCTGGCCAAGATAGTGAAACCTCATCTCTACTAAAAATACAAAAATTAGCTGGGCGTGGTGGCAACCACCTATGATCCCAGCTACTTGGGAGGCTGAGGCAGAGAACTGCTTGAACCCAGGAAGTGGAGGTTGTAGTGAGCCAAGATTGCATCACTGTACTCCAGCCTGGGCAACAGAGCAAGACTCCATCTCAAAAAAAAAAAAAAAAAAAATACAAAAAATTAGCCAGGCGTGGTGGCAGGCACCTGTAATCCCAGCTACTCGGAAGGCTGAGGCAGGAGAATTGCTTGAACCTGGGAGGTAGAGGTTGCAGTGAGCTGAGATTGTGCCATTGCACTCTAGCCTATGTGACAAGAGCGAAACTCCATCTCAAAAAAAAAAAAAAAAAAGAAAGAAAA","GGCTGGGCGCAGTGGCTCACACCTGTAATCCCAGCACTTAGGGAAGCTGAGGCGAGTAGATCACCTGAGGTCAGGAGTTAGAGACCAGCCTGGCCATCATGGTGAAACCCCGTCTCTACTAAAGATACCAAAAATTAGCTGAGTGTGGTGCTGGGTGCCTGTAATCCCAGAAACTCAGGGTGCCTGTAATCCCAGCAACTCAGGGTGCCTTTAATCCCAGCAACTGAGGGTACCAGTAATCCCAGCAACTCAGGGTGTCTTTAATCCTAGCAACTGAGGGCACCTGTAATCCCAGCAACTCAGGAAGCTGAGACAGGAGAAGTACTTGAACCCAGAAGGCAGAGGTTGCAGTGAGCCGATATTGCACCATTGCACTCCAGTCTGGGCAACAAGAGTGAAACTCTGTCTCAAAAAAAAA"
"chr17","50542261","50542886","JH378206","6546474","6546861","277","43995787","GCCGGGCGCTGTGGCTCAAGCCTGTAATCCCAGCATTTTGGGAGACTAAGGGAAGCAGATCCTGTGAGCTCAGGATTTCGAGACCAGCCTGGCCAACATGGTGAAACCCTGTCTCTACAAAAATTAGCCATGCCGGGCACGGTGGCTCACGCCTGTAATCCCAGCACTTTGGGAGGCTGAGGCGGGCGGATCACAAGGTCAGGAGTTTGAGACCATCCTGCCTAACACGGTGCAACCCCGTCTCTACCAAAAATACAAAAAATTAGCTGGGCGTGGTGGCGGGTGCCTGTAGTCCCAGCTACTCGGGGGGCTGAGGCAAGAGAATGGCATGAACCTGTGGGGCGGAGCTTGCTGTGAGCCGATATCCTGCCACTGCACTCCAGCCTGGGCGACAGAGCGAGACTCCATCTCAAAAAAAAAAAAAAAAAAAAAAAAAAAAAAAAATGAGCCAGCTGTGGTGGCGTGTGTGCCTGTAATCCCAGCTACTCGGGAGGCTGAGGCAAGAGAATCACTTGAATCTGGGAGGCAGAGGTTGCAGTGAGCCAAGATCATGCTATTGCACTTCAGCCTGGGCAACAAGAGTGAAACTCTGTCTCAAAAAAAAAAAAAAAAAAAAAGAAAAAGAA","GGCCACACATGGTGGCTAACGCCTGTAATCCCAGCACTTTGGGAGGCCAAGTCGGGTGGATCATGAGGTCAGGAGACCAAGACCATCCTGGCCAAATGGTGAAACCCCGTCTCTACTAAAAATACAAAAATTAGCTGGGCATGGTGGCGTGTGCCTGTAATCCCAGCTACTCAGGAGGCTGAGGCAGGACAATTGCCTGAACCCAGGAGAATTAGCTGGGCATGGTGGCGTGTGCCTGTAATCCCAGCTACTCAGGAGGCTGAGGCAGGACAATTGCCTGAACCCAGGAGGCGAAGGTTGCGGTGAGCCGAGATTGTGCCATTGCACTCCAGCCTGGGTAACAAGAGCGACACTCTGTCTCAAAAAAAAAAAAAAAAAAAAAAAAAAA"
"chr17","51121894","51122508","JH378118","18053084","18053501","260","33068810","GGCTGGGTGCAGTGGCTCATGCCTGTATTCCCAACACTTTGAGAGGCCAAGGCGGGCAGATCACCTGAGGTCAGGAATTCGAGACCAGCCTGGCTAACATGGCGAAACCCTGTCTCTATTAAAAACACAAAAATTAGGCCAGGCACGGTGGCTCACACCTGTAATCCCAGCACTTTGGGAGGCTGAGGCGGGCAGATCACGAAGTCAGGAGATCGAGACCATCCTGGCTAACATGGTGAAACCCTGTCTCTGCTAAAAATACAAAAAAAATAGCGGGGCGTGGTGGCAGGCGCCTGTAGTCCCAGCTACTCAGGAGGCTGAGGCAGGAGAATGGCGTGAACCTGGGAGGCGGAGGTTGCAGTGAGCCGAGATCGCGCCACTGCACTACAGCTTGGGTGACAGAGCGAGACTCTGTCTCAAAAAAAAAAAAAAAAGTTAGTCGGGCATGGTGGTGGGCTCCTGTATTCCCAGCTACTCAGGAGGCTGAGGTGGGAGAATCACTTGAACCTGGAAGGCAGAGGTTGCTGTGAGCCAAGATTGCACCATTGCATTCCAGCCTGGGTGACAAGAGCAAAACTCTGTCTCAAAAAATATATATAAAATAATAAAAATAAA","GGCTGGGCGCAGTGGCTCACACCTGTAATCCCAGCACTTAGGGAAGCTGAGGCGAGTAGATCACCTGAGGTCAGGAGTTAGAGACCAGCCTGGCCATCATGGTGAAACCCCGTCTCTACTAAAGATACCAAAAATTAGCTGAGTGTGGTGCTGGGTGCCTGTAATCCCAGAAACTCAGGGTGCCTGTAATCCCAGCAACTCAGGGTGCCTTTAATCCCAGCAACTGAGGGTACCAGTAATCCCAGCAACTCAGGGTGTCTTTAATCCTAGCAACTGAGGGCACCTGTAATCCCAGCAACTCAGGAAGCTGAGACAGGAGAAGTACTTGAACCCAGAAGGCAGAGGTTGCAGTGAGCCGATATTGCACCATTGCACTCCAGTCTGGGCAACAAGAGTGAAACTCTGTCTCAAAAAAAAA"
"chr17","51573403","51574012","JH378118","18053084","18053501","260","33520319","GGCCGGGTGTGGTGGCTCACGCCTATTATCCCAGCAGTTTGGGAGGCCAAGTGGGGGTTGGATCACCTGAGGTCAGGGGTTCGAGACCAGCATGGCCAACATGGTGAAAACCCATCTATACTAAAGATACAAAAAATTAGGCTGGGCACAGTGGCTCATGCCTGTAATCCCAGCACTTTGGGAGGCCAAGGATCACGAGGTCAGGAGATCGAGACCATCCTGGCTAACACAGTGAAACCCCGTCTCTACTAAAAATACAAAAAAATTAGCCGGGAGTGGTGGCAAGTGCCTGTAGTCCCAGCTACTCAGGAGGCTGAGGCAGGTGAATAGTGTGAACGCAGGAGGCAGAGCTTGCAGTGAGCCGAGATCGTGCCACTACACTCCAGCCTGGGCGACAAGGTGAGACAACGTCTCAAAAAAAAAAAAAAAAAAAAGCCGGGCATGGTGGGAGGCACCTGTAATTCCACCTACTTGGGAGGGTGAGGCAGGAGAATTGCTTGAATCTGGGAGATGGAGGTTGGAGTAAGCCAAGTTCGCACCATTGCACTCCAGCCTGGGTGACAAGAGCGAAACTCTTGTCTCAAAAAAAAAAAAAAAAAAAAAAAAAAAA","GGCTGGGCGCAGTGGCTCACACCTGTAATCCCAGCACTTAGGGAAGCTGAGGCGAGTAGATCACCTGAGGTCAGGAGTTAGAGACCAGCCTGGCCATCATGGTGAAACCCCGTCTCTACTAAAGATACCAAAAATTAGCTGAGTGTGGTGCTGGGTGCCTGTAATCCCAGAAACTCAGGGTGCCTGTAATCCCAGCAACTCAGGGTGCCTTTAATCCCAGCAACTGAGGGTACCAGTAATCCCAGCAACTCAGGGTGTCTTTAATCCTAGCAACTGAGGGCACCTGTAATCCCAGCAACTCAGGAAGCTGAGACAGGAGAAGTACTTGAACCCAGAAGGCAGAGGTTGCAGTGAGCCGATATTGCACCATTGCACTCCAGTCTGGGCAACAAGAGTGAAACTCTGTCTCAAAAAAAAA"
"chr17","51598763","51599361","JH378118","18053084","18053501","241","33545679","GCCGGGCGTGGTGACTCACGCCTGTAATACCAGCACTTTAGGAGGCTGAGGTGGGTGGATCACCTGAGGTCAGGAGTTCGAGACCGGCCTGGCCAACATGGTGAAATCCTGTCTCTACTAAAAATACAAAAAAATGGCCAGGCGTGGTGGCTCACGCCTGTAATCCTAGCACTTTGGGCGGCCCAGGTGAGTGGATCACGAGGTCAGGAGATCGAGACCATCCTGGCTAACATGGTGAAACCCCATCTCTACTAAAAAACTACAAAAAAATTAGCTGGGCGTGGTGGCAGGCGCCTGTAGTCCCAGCTACTCGGGAGGCTGAGGCAGGAGAATGACGTGAACCCGGGAGGCGGAGCTTGCAGTGAGCAGAGCTTGAGCCACTGCACTCCAGCTTGGGCGACAGAGTGAGACTCCGTCTCAAAAAAAAAAAAAAAAAAATTAGCTGGGGATGGTGGCGGGCACCTGTAATCCCAGCTACTCTGGAGGCTGAGACAGGAGAATCGCTTGAACCCAGGAGGCGGAGGTTGCAGTGAGCTGAGATCGTGCCATTGTACTCCAGCCTGGGCAACAAGAGTGAAACTCAATCCGAAGAAAAAAAA","GGCTGGGCGCAGTGGCTCACACCTGTAATCCCAGCACTTAGGGAAGCTGAGGCGAGTAGATCACCTGAGGTCAGGAGTTAGAGACCAGCCTGGCCATCATGGTGAAACCCCGTCTCTACTAAAGATACCAAAAATTAGCTGAGTGTGGTGCTGGGTGCCTGTAATCCCAGAAACTCAGGGTGCCTGTAATCCCAGCAACTCAGGGTGCCTTTAATCCCAGCAACTGAGGGTACCAGTAATCCCAGCAACTCAGGGTGTCTTTAATCCTAGCAACTGAGGGCACCTGTAATCCCAGCAACTCAGGAAGCTGAGACAGGAGAAGTACTTGAACCCAGAAGGCAGAGGTTGCAGTGAGCCGATATTGCACCATTGCACTCCAGTCTGGGCAACAAGAGTGAAACTCTGTCTCAAAAAAAAA"
"chr17","51738482","51739094","JH378118","18053084","18053501","257","33685398","GCCGGGTGCGGTGGCTCACACCTGTAATCCCAGCACTTTGGGAGACTGAGGCGGGAGGATCACCTGAGGTCAGGAGTTCGAGACCAACCTGACCAACATGGTAAAACCCTGTCTGTACTAAAACTACAAAAAATTAGGCCAGGCGCAGTGGTCCATGCCTGTAATCCCAGCACTTTGGGAGGCCAAGGTGGGCGGATCATGAGGTCAGGAGTTTGAGACCAGCCTGGCCAACATAGTGAAACCCTGTCTCTACTAAAAACACAAAAATTAGTCGGGCATGGTGGCGGATGCCTGTAATCTCAGCTACTCAGGAGGTTGAGGCAGGAGAATCACTTGAACCCGGGAGGTGGAGGTTGCAGTGAGCCAAGATCACGCCACTGTACTCCAGCCTGGGCAACAGAGCGGGACTCCATCTTAAAAAAAAAAAAAAAAAAATTAGCCAGGCGTGGTGGCGCATGCCTGTAGTCCCAGCTACTTAGGAGGCTGAGGCAGGAGAATTGCTTGAACCCGGGAGGCAGAGGCTGCAGTGAGCCAAGACCACGCTATTGCATTCCAGCCTGGGTGACAAGAGCAAAACTCTGTCTCAAAAAACAAAACAAAACAAACAAAAAAA","GGCTGGGCGCAGTGGCTCACACCTGTAATCCCAGCACTTAGGGAAGCTGAGGCGAGTAGATCACCTGAGGTCAGGAGTTAGAGACCAGCCTGGCCATCATGGTGAAACCCCGTCTCTACTAAAGATACCAAAAATTAGCTGAGTGTGGTGCTGGGTGCCTGTAATCCCAGAAACTCAGGGTGCCTGTAATCCCAGCAACTCAGGGTGCCTTTAATCCCAGCAACTGAGGGTACCAGTAATCCCAGCAACTCAGGGTGTCTTTAATCCTAGCAACTGAGGGCACCTGTAATCCCAGCAACTCAGGAAGCTGAGACAGGAGAAGTACTTGAACCCAGAAGGCAGAGGTTGCAGTGAGCCGATATTGCACCATTGCACTCCAGTCTGGGCAACAAGAGTGAAACTCTGTCTCAAAAAAAAA"
"chr17","52245950","52246538","JH378118","18053084","18053501","254","34192866","TGTAATCCCAGCACTTTGGGAAGCCAACGCGGGTAGATCAGCTGAGGTCAGGAGCTCGAGACCAGCCTGGCCAACTGGTGAAACCCCATCTCTACTAAAAAAAATACAAAAAAATGGCCCAGCGCGGTGGCTCACACCTGTAATCCCAGCACTTTGGGAGGCCGAGGCGGGCAGATCACGAGGTCAGGAGATCGAGACCATCCTGGATAATACGGTGAAACCCCGTCTCTACTAAAAATACAAAAAAAAATTAACCGGGTGTGGTGGCGGGCGCCTGTAGTCCCAGCTACTAGGGAGGCTGAAGCAGGAGAATGGCGCGAAACCGGGAGGCGGAGCTTGCAGTGAGCCAAGACAGGCCACTGCACTCCAGCCTGGGCGACAGAGCGAGACTCCATCTCAAAAAAACAAAAAACAAAAAAATTAGCCAGCTGTGGTGGTGGGCGCATGTAATCCCAGTTACTTGGGAGGCTGAGGCAGGAGAATTGCTTGAAACCAGGAGGCAGAGGTTGCAGTGAGCCAAGATTACGCCATTGTACTCCAGCCTGGGCAACAAGGGCAAAACTCTGTCTCAACAAAAAAAAAGAAAAAA","GGCTGGGCGCAGTGGCTCACACCTGTAATCCCAGCACTTAGGGAAGCTGAGGCGAGTAGATCACCTGAGGTCAGGAGTTAGAGACCAGCCTGGCCATCATGGTGAAACCCCGTCTCTACTAAAGATACCAAAAATTAGCTGAGTGTGGTGCTGGGTGCCTGTAATCCCAGAAACTCAGGGTGCCTGTAATCCCAGCAACTCAGGGTGCCTTTAATCCCAGCAACTGAGGGTACCAGTAATCCCAGCAACTCAGGGTGTCTTTAATCCTAGCAACTGAGGGCACCTGTAATCCCAGCAACTCAGGAAGCTGAGACAGGAGAAGTACTTGAACCCAGAAGGCAGAGGTTGCAGTGAGCCGATATTGCACCATTGCACTCCAGTCTGGGCAACAAGAGTGAAACTCTGTCTCAAAAAAAAA"
"chr17","52264620","52265210","JH378118","18053084","18053501","242","34211536","GGCCACATGTGGTGGCTCACACCTGTAATCCCAGCACTTTGGGAGGCCAAGGCAGGCAGATCACCTGAGATCAGAAGTTCAAGACCAGCCTGGCCAATGTGGTGAAACCCTGTCTCTACTAAAAATAGAAAAAACACAGCCAGGCGCGGTAGCTCACACCTGCAATCCCAGCACTTTGGGAGGCCGAGGCAGGCAGATCACGAGGTCAGGAGATTGAGACCACGGTGAAACCCCATCTCTACTAAAAATACAAAAAATTAGCTGGGCATGGTGGCGGGCACCTGTAGTCCCAGCCACTTGGGAGGCTGAGGCAGGAGAATGGCGTGAACTCGGGAGGTGGAGCTTGCAGTGAGCAAAATTGCGCCACTGCACTCCAGCCTGGGCAACAGAGCAAGACTCCGTCTCAAAAAAAAAAAAAAAAAAAAATTAGCCGGCGTAGTGGCAAGCTCCTGTAATCCCAGCTACTTGGGAGGCTGAAGCAGGAGAATCGCTTGAACCCAGGAGGTGGAGGTTGCAGTGAGCCGAGACTGCGCCATTGCACTCCAGCCTGGGCAACAAGAATGAAACTCCGTCTCAGAAAAGAAAAAAAAA","GGCTGGGCGCAGTGGCTCACACCTGTAATCCCAGCACTTAGGGAAGCTGAGGCGAGTAGATCACCTGAGGTCAGGAGTTAGAGACCAGCCTGGCCATCATGGTGAAACCCCGTCTCTACTAAAGATACCAAAAATTAGCTGAGTGTGGTGCTGGGTGCCTGTAATCCCAGAAACTCAGGGTGCCTGTAATCCCAGCAACTCAGGGTGCCTTTAATCCCAGCAACTGAGGGTACCAGTAATCCCAGCAACTCAGGGTGTCTTTAATCCTAGCAACTGAGGGCACCTGTAATCCCAGCAACTCAGGAAGCTGAGACAGGAGAAGTACTTGAACCCAGAAGGCAGAGGTTGCAGTGAGCCGATATTGCACCATTGCACTCCAGTCTGGGCAACAAGAGTGAAACTCTGTCTCAAAAAAAAA"
"chr17","52281488","52282107","JH378118","18053084","18053501","287","34228404","GGCCAGGCGCGGTGGCTCACGCCTGTAATCCCAGCACTTTGGGAGGTCAAGGCGGGTGGATCACCTGAGGTCAGGAGTTCAAGACCAGCCTGGCCAACATGATGAAACTTCATCTTGGCCGGGCGCGGTGGCTCATGCTTGTAATCCCAGCACTTTGGGAGGCCAAGGCAGGCGGCGGATCATGAGGTCAGGAGATTGAGACCATCCTGGCTAAAACGGTGAAACCCCGTCTCTACTAAAAATACAAAAAAAAAAAAATTAGCCGGGCGTGGTGGCAGGCGCCTGTAGTCCCAGCTACTCGGGAGGCTGAGGCAGGAGAATGGCGTGAACCCGGGAGGCGGAGCTTGCAGTGAGCCGAGATAGCACCACTGCAGTCCGGCCTGGGTGAAAGAGTGAGACTCCGTCTCAAAAAAAAAAAAAAAGAAGAAAGAACTTCGTCTTTACTAAAAGTACAAAAAAAAAAAAAAAAAATTAGCCGGGCATGGTGGCAGGCGCCTGTAAACCCAACTACTCTGGAGGCTGAGGAAGGAGAACTGCTTGCACCTGGGAGTCGGAGGTTGCAGTAAGCCAAGATCGCACCATTGCACTCCAGCCTGGGCATCAAGAGTGAGACTTTGTCT","GGCTGGGCGCAGTGGCTCACACCTGTAATCCCAGCACTTAGGGAAGCTGAGGCGAGTAGATCACCTGAGGTCAGGAGTTAGAGACCAGCCTGGCCATCATGGTGAAACCCCGTCTCTACTAAAGATACCAAAAATTAGCTGAGTGTGGTGCTGGGTGCCTGTAATCCCAGAAACTCAGGGTGCCTGTAATCCCAGCAACTCAGGGTGCCTTTAATCCCAGCAACTGAGGGTACCAGTAATCCCAGCAACTCAGGGTGTCTTTAATCCTAGCAACTGAGGGCACCTGTAATCCCAGCAACTCAGGAAGCTGAGACAGGAGAAGTACTTGAACCCAGAAGGCAGAGGTTGCAGTGAGCCGATATTGCACCATTGCACTCCAGTCTGGGCAACAAGAGTGAAACTCTGTCTCAAAAAAAAA"
"chr17","52731467","52732093","JH378129","11955248","11955630","276","40776219","GGCCGGGTGCGGTGGCTCACGCCTGTAATCCTGGCACTTTGGGAGGCTGAGATGGACGGATCACCTGAGGTCAGGAGTTTTTTGTTTTTTTCTTTTTTTTTGAGACAGAGTCTGGCTCTGTTGCCCAGGCTGGAGTGCAGTGGCTCGATCTCGGCTCACTGCAAGCTCCGCCTCCCGGGTTCATGCCATTCTCCTGCCTCAGCCTCCCGGTAGCTGGGACTACAGGTGCCCGCCAGCACATCCGGTTATTTTTTTGTATTTTTAGTAGAGACAGTGTTTCACAGTGTTAGCCAGGATGGTCTCGATCTCCTGACCTCGTGATCCGCCCACCTCGGCCTCCCAAAAGTGCTGGGATTACAGGCATGAGCCACCGCGCCCGGCCAGGAGTTTTTGAGACCAGCCTGGCCAACAGGGTGAAACTCTGTCTCTACTAAAAATACAAAAATTAGTTGGGCATGGTGGCAGGCACCTGTAATCCCAGCTACATGGGAGGCTGAGGCAGGAGAATTGCTTGAACCTGGGAGGCGGAGGTTGCAGTGAGCTGAGATTGCGCCATTGCACTCCAGCCTGGGCAACAAGAGTGAAATTGCGTCTCAAAAACCAAAACAAACAAAAAAAGAATGAAAA","GGCTGGGTACGGTGGCTCATGCCTGTAATCCCAGCACTTTGGGAGGTGGGTCACTTGAGGTCAGGAGTTCGAGACCAGCCTGTGCAGTGCCTCCATCCTCAACTGCTGCCTCATCAGCCTGGACCACTACCTGCTCATCCTCTCACCACTGCCACAAGCTGCGCATGAAGCTCCTGCGCGCGCCGGTGCCCGTCTCTACTAAAAATACAAAAATTAGCTGGGTGTGGTGGCAGGTGCCTGTAATCCCAGCTACTCAGGAGGCTGAGGCAGGAGAATCACTTGAACCCAGGAGGCAGAGGTTGCAGTGAGCCGATATCGCATCATTGCACTCCAGCCTGAGCAACAAGAGTGAAATTTTGTCTCAAAAAAAAAAAAAAAAGAAA"
"chr17","54416242","54416805","JH378115","26183910","26184297","228","28232332","ACTTTGGGAGGCCATGGCAGGCGGATCACCTGAGATCAGGAGTTGGAAACCAGCCTGGCCAACATGGTAAAACCCCGTCTCTACTAAAAATACTTGGCTGGGCACGGTGGCTCACACTTGTAATTCCAACACTTTGGAAGGCCAAGGCGGGCAGATCACCTGAGGTTGGGAGTTCGAGACCAGCCTGACCAACATGGAGAAACCCTGTCTCTACTAAAAATACAAAATTAGCTGGGCATGGTGGTCTATGCCTGTAATCCCAGCTACTTGGGAGGCTGAGGCAGGAGAATTGCTTGAACCCGGGAGGCAGAGGTTGCGGTAAGCCAAGATCATGCCATTGCACTCCAGCCTGGGCAACAAGAGCAAAACCCCGTCTCAAAAAAAAAAAAAAAATTAGCCCAGTGTGGTGGCGTGCACCTGTAATCCCAGCTACTTACTTAGGAGCCTGAGGCAGGAGAATTGCTTGAACCCGGGAGGCAGAGTTTGCAGTGAGCCAAGATTGCACCATTGCACTCCAGCCTGGGTGACAAGAGTGAGACTGTCTCAAAAAAAAAAAAAAAAAAA","GGCCAGGTGCAGTGGCTCATATGTATAACCCCAACACTTTGGGAGGCCAACGCAGGTGGATCACCTGAGTTAGGAGTTTGAGACCAGCCTGACCAACATGGTGAAACCCTGTCTCTACTAAAAATACAGAAATGGCCGGGCATAGTGACACATACCTGTAATCCCAGATACTTGGGATGCTGAGTTTGCTTAAACCCAGAGGAGAACTGCTTAAACCCGGGAGGTAGAGGTCACAGTGAGCCAAGATTGGGATGCTGAGATTTGCTTAAACCCAGAGGAGAACTGCTTAAACCCAGGAGGCAGAGGTTGCAGTGAGTTGAGATTGCACCATTGCACTCCAGCCTGGACAACAAGAGTGAAACTCTGTCTCAAAAAAAAAAAAAAAAAA"
"chr17","55179146","55179483","JH378144","13229286","13229620","44","41949860","GGCCGGGTGCGGTGGCTCACGCCTGTAATCCCAGCACTTTGGGAGGCCGACGCAGGTGGATCACTTGAGGTCTGGTGTTCAAGACCAGCCTGGCCAACATTGTGAAACCCCGTCTCTACTAAAAATACAAAAAGTTAGCTGGGCATGGTAGCAGGTGCCTGTAATCCCAGCTACTTGGGAGGCTGAGGCAGGAGAATTGCTTGAACCTGGGAGGCAGAGGTTGCAGTGAGCTGAGATCGCACCATTGCACTCCAGCCCAGGCAACAAGAGCGAAACTTCGTCTCAAATAATAATAATAATAATAATAATAAATAAATAAATTTTTAAAAAAGAAAAAA","GGCCGGGCGCGGTGGCTCAAGCCTGTAATCCCAGCACTTTGGGAGGCCGAGGCGGGTGGATCACCTGTGGTCAGGAGTTCAAGACAGCTTGGTCAACATGGTGAAACCCCGTCTCTACCAAAAATACAAAAAATTAGCTGGGCATGGTAGCGCATGCCTGTAATCCCAGCTACTCAGGAGGCTGAGGCAGGAGAATTGCCTGAACCCAGGAGGCAGAGGTTGCGGTGAGCCGAGATCGCGCCATTGCACTCCAGCCTGGGTAACAAGAGCGAAACTCCCTCTCATAAAAAATAAATAAATAAATAAATAAATAAATAAATAAATAAATAAATAAA"
"chr17","59543657","59543981","JH378109","3329188","3329514","46","56214469","GGTTGGGCACAGTGGCTCACGCCTGTAATCCCAACACTTTGGGAGGCCAAGGCGGGTGGATCACCTGAGGTCGGGAGTTCAAGACCAGCCTGGCCAACATGCTGAAACCCTATCTCTACTAAAAATACAAAAAAAAAAAAAAAAAAAAAAAAAAAAAATAGCCCAGTGTGGTGTCAGGCGCCTATAATCTCAGCTACTTGGGTGGCTGAGGCAGGAGAGTCGCTTGAACCTGGGAGGCGGAGGTTGCAGTGAGCGGAGATCGCACCATTGCACTCCAGCGTGGGCAACAAGAGTGAAACTCCATCTCAAAAAAAAAGAAAAGAAA","GGCCAGGCATGGTGGCTCACGCCTGTAATCCCAGCACTTTGGGAGCCCAAGCCGGGTGGATTACCTAAGGTCAGGAATTCCAGAACAGCCTGGACAATATGGTGAAACCTTGTCTCTACTAAAAATACAAAAAAAAAAAAAAAAAAAAAAAAAAAAAAAATTTAGCCGGGTGTGGTGGTAGGTACCTGTAATCCCAGCTACTAGGGAGGCTGAGGCAGGAGAATCGCTTGAACTTGGGAGGCGGAGGTTGCAGTGAACAGAGATCACACCACTGCACTCCAGCCTGGGCGACAAGAGCAAAACTCCATCTCAAAGAAAAAAAAAGAA"
"chr17","60766805","60768705","JH378118","18053084","18053501","1483","42713721","GGCCAGGTACCGTGGCTCATGCCTCTTATCCCACCACTTTTGGAAGCTGAGGTGTGAGGATCACCCGAAGTCAGGAGTTTGGAACCATCCTGGCCAATGTTGTAAAACCCCGTCTCTAATAAAAATACAAAAGTTACCCAAGCATGGTGGTGGGCACACCTGTAATCCCAGCTACTTGGAAGGCTAAGACAGGAAAATGCCTGAACCCAGTGTGGCTGGAATTGGTGGGTTCTTGATCTCACTGACCTCAAGAATGAAGCCACGGACCCTCACGGTGAGTGTCACACTTCAAGGTGGCACGTCCAGTTTGTTCCTTCTGATGTTCGGATGTGCTCAGAGTTTCTTTCTTCTGGTGGGTTCATGGTCTCGCTGGCTCAGGAGTGAAGCTACAGACGTTCACCGGGAGTGTTACAGCTCTTAAGGCCTTGCGCCTGGAGTTGTTAGTTCCTCCCAGTGGCTTCGTGGTCTCACTGGCTTCAGGAATCAAGCAGCACGGTGAGCGTTACAGCTCACAAAGGCAGTGTGCACCCACAGTGAGCAACAGCAAAATCTATTGCAAAGAGGACAGAACAAAACCCCCACACTGGGGAAAAGGACCGGAACAGCTTGCCACTGCTGGCTCAGGCAGCCTGCTTTTATTCTCTTATCTGGCCCCACCCACATCCTCCTGATTGGTCCATTTTACAGAGAGCTGATTAGTTTGCTTTACAGTGAACTGATTGGTCCATTTTGACAGATTGGTGCTGATTGGTGCGTTTACAATCCCTGAGCTAGACACAAAAGTTTTCCACGTCCCCATTAGAATAGCTAGATACAGAGTGTCCATAGGTGTATTTACAAACCCTGAGCTAGACACGGAGTGATGATTGGTGCATTTACAAACATGGAGCTAGATACAGAGTGCCGATTGGTGCATTCACAATCCCTTAGCTAGACATAAAGGTTCTCAAGTTCCCACCAGATCAGCTAGACATAGAGCGCTGATTGGTGCATTTACAAAACTTGAGCTCGACACAGGGTGCTGATTGGTGCATTCACAAACCTTGAGCTAGACACAGGGTGCTGATTGGTGTGTTTACAAACCTTGAGCTAGATGCAGAGCGCTGATTGGTGTATTTACAATTCCTTAGCTAGACATAAAGGTTCTCCAAGTCCCCACTAGACTCAGGAGCCCAGCTGGCCTCACCCAGTGGATGTCACACTGGGGCCATAGGTGGAGCTGCCTGCCAGTTCCGTGTCCTGCGCCCACACTCCTCAGCCCTTGGGCGGTGGATGGGATTGGGCACCGTGCAGCAGGGGGTCGCGCTCCTGGGGGAGGCTCGGGCGGTGCAGGAGCCCACGGTGGCGGGGCGGGGCAGACTCAGGCATGGCGGGCTCCGGGTCCCAAGCCCTGCCGGGTGGGGAGGCACCTAAGGCCAGGCGAGAAATGGAGCGCAGCGCTGGTGGGCCAGCACTGCTGGGGGACCAGGCGCATCCTCCGCAGCTGTTGGCCTGGGTGCTAAGCCCCTCACTGCCCAGGGCTGGCAGGGCCCGCCGGCCGCTCCGAGTGCCGGGCCCGCCAAGCCCACGCCCACTTGGAACTCTAGCTGGCCCGCAAGCGCGGCGCGCAGCCCTGGTTCCCCCCCGTGCCTCTCCCTCCACACCTCCCCGCGGGCTGAGGGAGCCGGCTCCGGCCTCGGCCATCCCAGGAAGGGGCTCCCACACTGCAGCGGCGTGCTGAAGGGCTCCTCAAGCACGGCCAGAGTGGGCGAGGAGGCTGAGGAGGCGCCAAGAGTGAGCCAGGGCTGCCAGCATGCTGTCACCTCTCACCAGGAGGCGGAGATTGCAGTGAACCAAGACTGTGCCATTGCACTCCAGCCTGGGCAACAAGAGTGAAACTCCATCTCAAAAAAAATAATAAA","GGCTGGGCGCAGTGGCTCACACCTGTAATCCCAGCACTTAGGGAAGCTGAGGCGAGTAGATCACCTGAGGTCAGGAGTTAGAGACCAGCCTGGCCATCATGGTGAAACCCCGTCTCTACTAAAGATACCAAAAATTAGCTGAGTGTGGTGCTGGGTGCCTGTAATCCCAGAAACTCAGGGTGCCTGTAATCCCAGCAACTCAGGGTGCCTTTAATCCCAGCAACTGAGGGTACCAGTAATCCCAGCAACTCAGGGTGTCTTTAATCCTAGCAACTGAGGGCACCTGTAATCCCAGCAACTCAGGAAGCTGAGACAGGAGAAGTACTTGAACCCAGAAGGCAGAGGTTGCAGTGAGCCGATATTGCACCATTGCACTCCAGTCTGGGCAACAAGAGTGAAACTCTGTCTCAAAAAAAAA"
"chr17","64473614","64473953","JH378109","21565230","21565567","55","42908384","GGCCGGGTGTGGTGGCTCATGCCTGTAATCCCAGTACTTTGGGAGGCCGAGGCAGGCAGATCTCCTGAGGTCAGGAGTTTGAGACCAGCCTGGCCAACATGATGAAATGCTGTCTCTCCTAAAAATACAAAAATTAGCCAGACATAGTGGCAGGTGCCTGTAATCCCAGCTACTTGGGAGGCTGAGGGAGGAGAATTGCTTGAACCTGGGAGGCAGAGGTTGCAGTGAGTCAAGATCACGCCATTGCGCTCCAACCTGGGTGACAAAAGTGAGACTTCATCTCAAAATAAATAAATAAATAAATAAATAAATAAATAAATAAATAATAATTAAAAAAAAA","GGCCGGGCGCGGTGGCTCAAGCCTGTAATACCAGCACTTTGGGAGGCCGAGGCGGGTGGATCACGAGGTCAAGAGATCGAGACCATCCTGGTCAACATGGTGAAACCCCGTCTCTACTAAAAATACAAACAATTAGCTGGGCATGGTGGCGGGTGCCTGTAATCCCAGCTACTCCAGAGGCTGAGGCAGGAGAATTGCCTGAACCCAGGAGACGGAGGTTGCGGTGAGCCAAGATCGCGCCATTGCACTCCAGCCTGGGTGACAAGAGCGAAACTCCGTCTCAATAAATAAATAAATAAATAAATAAATAAAAATAAAATAAATAAATAAATAAATAA"
"chr17","67747489","67748097","JH378118","18053084","18053501","256","49694405","GCTGGGTGTGGTGGCTCACGCCTATAATCCCAGCACTTTGGGAGGCCAAGGCAGGTGGATCACCTGAGGTCAGGAGTTTGAGACCAGCCTGGCCAACATGATGAAACCCCGTCTCTACTAAAAATACAAAGAATTAGGCTGGGCGCGGTGGCTCACGCCTGTAATCCCAGCACTTTGGGAGGCCGAGGCGGGTGGATCACGAGGTCAGGAGATCGAGACCATCCTGGCTAACACGGTGAAACCCCGTCTCTAATAAAAATAAAAAAAAATTAGCTGGGCGTGGTGGTTGGCGCCTGTAGTCCCAGCTACTCGGGAGGCTGAGGCAGGGGAATGGCGTGAACCCGGGAGGTGGAGCTTGTAGTGAGCCGAGATCACGCCACTGCACTCCAGCCTGGGCGACAGAGCAAGACTCCGTCTCAAAAAAAAAAAAAAAAAAAATTAGCCAGGCGTGGTGGCGGGTGCCTGTAATCCCAGCTACTCTGGAGGCTGAGGCAGGAAAATCACTTTAACTCAGGAAACAGAGGTTGCAGTAAGCCGAGATCACGCCATTGTGCTCCATCCTGGGCAACAAGAGCGAAACTCCGACTCGGAAAAAAAGAAAAAAAAAAA","GGCTGGGCGCAGTGGCTCACACCTGTAATCCCAGCACTTAGGGAAGCTGAGGCGAGTAGATCACCTGAGGTCAGGAGTTAGAGACCAGCCTGGCCATCATGGTGAAACCCCGTCTCTACTAAAGATACCAAAAATTAGCTGAGTGTGGTGCTGGGTGCCTGTAATCCCAGAAACTCAGGGTGCCTGTAATCCCAGCAACTCAGGGTGCCTTTAATCCCAGCAACTGAGGGTACCAGTAATCCCAGCAACTCAGGGTGTCTTTAATCCTAGCAACTGAGGGCACCTGTAATCCCAGCAACTCAGGAAGCTGAGACAGGAGAAGTACTTGAACCCAGAAGGCAGAGGTTGCAGTGAGCCGATATTGCACCATTGCACTCCAGTCTGGGCAACAAGAGTGAAACTCTGTCTCAAAAAAAAA"
"chr17","71197353","71197681","JH378262","266823","267148","47","70930530","GACCGGACACAGTGGCTCACGTCTGTAATCCCAGCACTTTGGGAGGCTGAGGCGGGTGGATCACCTGAGGTCAGGAGTTCAAAACCAGCCTGGCCAATATGGTGAAAACCCGTCTATACTAAAAATAAAAAATTAGCCAGGCTTGGTGGCAGGCACCTGTAATCCTAGGTACTCTGGAGGCTTAGACAGGAGAATCACTTGAACCCGAGAAGTGGAGGTTGCAGTGAGCCAAGATCGTGCCATTGCACTCCAGCCTGGGCGACAAGAGTGAGACTCCATCTCAAAAACAAACAAACAAACAAACAAAAAACAAATGAACAAAAAAAAAA","GGCCGGGCGCGGTGGCTCAAGCCTGTAATCCCAGCACTTTGGGAGGCCGAGGCGGGTAGATCATGAGGTCAGGAGTTTGAGACCAGCCTGGCCAACATGGTGAAACCCCGTCTCTACTAAAAATACAAAAATTAGCCGGGCATGGTGGCCTGTGCCTGTAATCCTAGCTACCCAGGAAGCTGAGGCAGGAGAATTGCCTGAACCCAGGAGGCGGAGGTTGCGGTGAGCCGAGATCGTGCCATTGCACTCCAGCCTGGGTAACAAGAGCGAAACTCCGTCTCAAAAACAAACAAACAAACAAACAAAAACAAAAAACAAAAAACAAA"
"chr17","72892082","72892699","JH378118","18053084","18053501","266","54838998","GGCCAGGTGCAGTGGTTCACACCTATAATCCCAGCACTCTAGGAGGCCAAAGTGGGCAGATCACCTGAGGTCAGAAGTTCGAGACCAGCCTGGCCAACATGGTGAAACCATCTCTACTAAAAACACAAAAATTAGGCTGGGCACGGTGGCTCACACCTGTAATCCCAGCACTTTGGGAGGCCGAGGTGGGTGGATCACGAAGTCAGGAGATCAAGACCATCCTGGCTAACACGGTGAAACCCCGTCTCTACTAAAAATACAAAAAATTAGCCAGGCGTGGTGGCGGGCGCCTATAGTCCCAGCTACTTGGGAGGCTGAGGCAGGAGAATGGCGTGAACCCAGGAGGCGGAGCTTGCAGTGAGCCAAGATTGCGCCACTGCACTCCAGCCTGGGTGAGAGAGCTAGACTCTGTCTCAAAAAAAAAAAAAAAAAAAACACAAAAATTAGCCGGGCTTGGTGGCAGGTGCCCGTAATCCCAGCTACTCAGGACGCTGGGACAGGAGAATCTCATGAACCCTGGAGGTGGAGGTTGTAGTGAGCCAAGATCTCACCATCGCACTCCAGCCAGGGTGACAAGAGTGAAACTCTGTCTTAAAAAGATAAATAAATAAAATAAAA","GGCTGGGCGCAGTGGCTCACACCTGTAATCCCAGCACTTAGGGAAGCTGAGGCGAGTAGATCACCTGAGGTCAGGAGTTAGAGACCAGCCTGGCCATCATGGTGAAACCCCGTCTCTACTAAAGATACCAAAAATTAGCTGAGTGTGGTGCTGGGTGCCTGTAATCCCAGAAACTCAGGGTGCCTGTAATCCCAGCAACTCAGGGTGCCTTTAATCCCAGCAACTGAGGGTACCAGTAATCCCAGCAACTCAGGGTGTCTTTAATCCTAGCAACTGAGGGCACCTGTAATCCCAGCAACTCAGGAAGCTGAGACAGGAGAAGTACTTGAACCCAGAAGGCAGAGGTTGCAGTGAGCCGATATTGCACCATTGCACTCCAGTCTGGGCAACAAGAGTGAAACTCTGTCTCAAAAAAAAA"
"chr17","74365360","74365846","JH378118","18053084","18053501","163","56312276","TATAAAAAATCAGCTAGGCTTGGTGGCTTGTGCCTGTAATCCCAGCACTTTGGGAGGCTGAGGCAGGTGGATCACCTGACGTAGGTGTTTAAGACCAGATTGACTAACATGTTGAAACCCCGTCTCTACTAAAAATACAAAAATTATCTGGGCTTGGTGGTGCATGCCTGTAATCCCAGCTGCTCAGGAGGCTGAGACAGGAGAATCGCCTGAACCTGGGAAACGGAAGTTGCAGTGAGTGGAGGTTGCAGTGAGCCGAGATTGCACCACTGCACTCCAGTCTGGGCAACGGAAAAAGACTGTCTCAAAAAAAAAAAAAAAATTAGCTGGGTGTGGTGGTTGGCGCCTGTAATTCCAGCTACTCAGGAGGCTGAGGCAGGAGAATCACTTGAACTCAAGAGGCAGAGGTTGCAATGAGCCAAGATTGCGCCATTGTACTCCAGCCTGGGCCACAAGATTGAAACTTCATCTTGGGGAAAGAAAACAA","GGCTGGGCGCAGTGGCTCACACCTGTAATCCCAGCACTTAGGGAAGCTGAGGCGAGTAGATCACCTGAGGTCAGGAGTTAGAGACCAGCCTGGCCATCATGGTGAAACCCCGTCTCTACTAAAGATACCAAAAATTAGCTGAGTGTGGTGCTGGGTGCCTGTAATCCCAGAAACTCAGGGTGCCTGTAATCCCAGCAACTCAGGGTGCCTTTAATCCCAGCAACTGAGGGTACCAGTAATCCCAGCAACTCAGGGTGTCTTTAATCCTAGCAACTGAGGGCACCTGTAATCCCAGCAACTCAGGAAGCTGAGACAGGAGAAGTACTTGAACCCAGAAGGCAGAGGTTGCAGTGAGCCGATATTGCACCATTGCACTCCAGTCTGGGCAACAAGAGTGAAACTCTGTCTCAAAAAAAAA"
"chr17","74566963","74567566","JH378119","32351107","32351490","260","42215856","GCCGGGCATGGTGTATCACGCCTGTAATCCCAGCACTTTGGGAGGCAGAGGTAGGCAGATCACCTGAGGTCAGGAGTTCAAAACCAGCCTAGCCAACATGGTGAAACCCCGTCTCTACTAAAAATACAAAAAATTAGTGGCCAGGCACGGCAGCTCACGCCTGTAATTCCAGCACTTTGGGAGGCCGAGGCGGGCAGATCACGAGGTCAGAAGATTGAGACCATCCTGGCTAACACGGTGGAACCCCATCTCTACTAAAAATACAAAAAATTAGCTGGGCATGGTGGCTGGTGCCTGTAGTCCCAGCTACTCGGGAGGCTGAGGCAGGAGACTGGCATGAACCCGGGAGGCGGAGCTTGCAGCAAGCCAAGATCGTGCCACTGCACTCCACTCCATCCTGGGCGACAGAGCAAGACTCCGCTTCAAAAAAAAAAAAATTAACCGGGCAAGGTGGCAGGTGCCTGTAATCCCAGCTACTTGGGAGGCTGAGGCAGGAGAATTGCTTGCAGAGGTTGAAGTGAGCCGAGATTACGCCATTGCACTCCAGCCCAAGTGACAAGAGTGAAACTCCATCTCAAAAAAAAAAAAAAAAAAAAGAAAAAAA","GGCCAGGTATGGTGGCTCACACCTGTAATCCCAGCACTTTGGGAGGCCAAGGCAGGCAGACCACCTGAGGTCAGGAGTTCGAGATCAGCCTAGCCAACATGGTGAAACCCCATCTCTAGTAAAAATAAAATTAGCCAGGCATGGTGGTGCATGCCTGTAACGCAGGTCAGGAGTTCGAGATCAGCTTAGCCAACATGGTGAAACCCCATCTCTAGTAAAAATAAAATTAGCCAGGCAGGTGGTGCCGCCTGTACTCGGGAGGCTGAGGCAGGAGAATCACTTGAACCCAAGAGGCAGAGGTTGCAGTCAGCCAAGATCATGCCATTGCACTCCAGCCTAAGCAAAAAGAGTAAAACTCAGTCTCAAAACAAAAAAACAAAAAAA"
"chr17","75365782","75366409","JH378153","2355361","2355755","282","73010421","CCAGGCGTGGTGGCTCATGCCGGTAATCCCAGCACTTTGGGAGGCCAAGGCAGGTGGATCATCTGAGGTCAGGAGTTCGAGACCAGCCTGACCAACATGGTGAAACCTCACCTCTACTAAAAATACAAAAACTAGACAGGCGTGGTGGCGGGTGCCTGTAGTCCCAGCTACTTGGGAGGCTGAGGCAGAAAAATCGCTTGAACCCAGTAGGCAGAGGTTGCAGTGAGCCGAGATCACACCATTGCACTCCAGCCTGGGCAAAAAAGAGCGAAACTCCATCTCAGAAGAAAAGACCGGGTGCAGTGGCTCATGCTTGTAACCCCAGCACTTTGGGAGGCCAAGGCGGGTGGATCACGAGGTCAGAAGATCGAGACCATCCTGGCTAACACGGTGAAACCCCGTCTCTACTAAAAATACAAAAAAAAAAAAATAATTAGCCGAGTGTGGTGGCGGATGCCTGTAGTCCCAGCTACTCGGGAGGCTGAGGCAGGAGAATGGCGTGAACCCAGGAGGCGTAGCTTGCAGTGAGCCGAGATCACGCCACTGCACTCCAGCCTGGGCGACAGAGCAAGACTCGTCTTAAAAAAAAAAAAAAAAAGAAAAAGTAAAAGAAAAGAAAAAGCAACAA","GGCGGGGCATGGTGGCTCACACCTGTCATCCCAACACTTTGGGAGGCTGAGGCAGGCAGATCACCTGAGGTCAGGAGTTTGAGACCAGCCTGGCCAACATGGTGAAACCCCATCTCTACTAAAAATACAAAAATACAAAAAACCCCATCTCTACTAAAAATACAAAAAGCTTGTCTCTATTAAAAATACAAAAAACAAAAAACAAACAAAAAAAAAACCACCATGGTGGTGGGTGCCTATAATCCCAGCTACTCGGGAGGCTGAGGCAGGAGAATCGCTTGAACCCAGGAGGCAGAGGTTGCAGTGAGCCAAGATCCCACCATTGCACTCCAGCCTGGGCAACAGAGAGAGAGACTCTGCCTCAGAAAAAAGAAAGAAAGAAAGAAAGAAAGAAA"
"chr18","19875","20142","JH378153","8929988","8930242","54","8910113","TTGGGAGGCTGAGGTGGGTGGATCATCTGAGGTCAGGAGTTAAGACCAGCCTGGCCAACATGGTGAAACCCCATCTCTACTAAAAATACAAAAACAAAACAAAACAAAACAAAAAAAACCAGCATGGTGGCAGACACCTGTAATCCCAGCTACTCGGGAGACTGAGGCAGGAGAATCACTTGAACCTGGGAGGCGGAGGTTACAGTGAGCCAAGATCTTGTCATGTCACTCCAGCCCAGGCAACAAGAGCAAAACTGTCTTAAAAAAA","TTTGAGAGGCTGAGGTGGGTGGATCACCTAGGTCAGGAGTTTGAGACCAGCCTGACCAACATGGTGAAACCTCATCTCTACTAAAAATAAAAATAAAAAACTAGCCAGGTGCAATGGTGCATGCCTGTAATCCCAGCTACTTGGGAGGCTGAGATGGGAGACTCACTTGAACCTGGGAGGTGGAGGTTGCAGTGAGCCAAGATCATACCATTGCACTCCAGCCTGGGCAACAAGAGTGAAACCTCTTCTCAAAAA"
"chr18","4520498","4521101","JH378118","18053084","18053501","246","13532586","GGCTGGGCGCAGTGGCCCACCCCTGTAATCCCAGCACTTTGGGAGGCCGAGGCGGGTAGATCACCTGACGTCAGGAGTTCAAGACCAGCCTGGCCAACATGGTGAAACCCTGTCTCTACTAAAATACAAAAATTAGGCTGGGCGCAGTGGCTCAAGCCTGTAATCCAGCACTTTGGGAGGCCAAGGCGGGCAGATCACCTGAGGTCAGGAGTTCGAGACTAGCCTGGCCAACCTGGCAAAACCCCATCTCTACTAAAAGTACGAAAATTAGCCAGGGTGATGGTGTGCACCTGTAATCCTAGGTACTCAGGAGGCTGAGGGCAAGAGAATCGCTTGAACCTGGGAGGCAGAGGTTGTAGTGGGCCAAGATCGCGCCATTGCACTGCAGCCTCGGTGACAGAGAAAGACTCCGTCTCAAAAAAAAAAAAAAACAAAAATTAGCTGGGCGTGGTGGTGGGCGTCTGTAGTCCCATCTACACGGGAGGCTGAGGCAGAAGAATCACTTAAACCCAGGATGTGGAGGTTGCAGTGAGCTGAGATCACGCCATTGCACTCCAGACTGGGTAACAAGAGCAAAACTCCATCTCAAATAAATAAAATAAAA","GGCTGGGCGCAGTGGCTCACACCTGTAATCCCAGCACTTAGGGAAGCTGAGGCGAGTAGATCACCTGAGGTCAGGAGTTAGAGACCAGCCTGGCCATCATGGTGAAACCCCGTCTCTACTAAAGATACCAAAAATTAGCTGAGTGTGGTGCTGGGTGCCTGTAATCCCAGAAACTCAGGGTGCCTGTAATCCCAGCAACTCAGGGTGCCTTTAATCCCAGCAACTGAGGGTACCAGTAATCCCAGCAACTCAGGGTGTCTTTAATCCTAGCAACTGAGGGCACCTGTAATCCCAGCAACTCAGGAAGCTGAGACAGGAGAAGTACTTGAACCCAGAAGGCAGAGGTTGCAGTGAGCCGATATTGCACCATTGCACTCCAGTCTGGGCAACAAGAGTGAAACTCTGTCTCAAAAAAAAA"
"chr18","8281535","8282152","JH378118","18053084","18053501","271","9771549","GGCCAGGTGCGATAGCTCACACTGGTAATCCCAACACTTTGGGAGGCCGAGGTGGGCGGATCACCTGAGGCCAGGAGTTTGAGACCAGCCTGGCCAACACAGTGAAACCCCATCTCTACTAAAAATACAAAATTAGGCAGGGTGCAGTGGCTCACGCCTGTAATACCAGCACTTTGGGAGGCCGAGACAGGCGGATTACGAGGTCAGGAGATCGAGACCATCCTAGCTAACACAGTGAAACCCCGTCTCTACTAAAAAAAAAAAAAAAAAAAAAAGTACAAAAAAATTAGCCAGGCGTGGCGGCAGGTGCCTGTAGTCCCAGCTACTCAGGAGACTGAGGCAGGAGAATGGCGTGAACCCGGGAGGCGGAGCTTGCAGTGAACTGAGATCACACCACTGCACTCCAGCCTGGGCAACAGAGTGAGACTCCGTCTCAAAAACAAAACAAAATTAGCCGGGCATGGTGGTGGATGCCCGTAATCCCAGCTACTCGGGAGGCTGAGGCCGCCAAGGCAGGAGAATCTCTTGAATGTGGGAGGCAAAGGCTGCAGTGAGCTGAGATCATGCCATTGCACTGTAGCCTGGGCGACAAAAGTGAGACTCCGTCTCAAAAAAAAA","GGCTGGGCGCAGTGGCTCACACCTGTAATCCCAGCACTTAGGGAAGCTGAGGCGAGTAGATCACCTGAGGTCAGGAGTTAGAGACCAGCCTGGCCATCATGGTGAAACCCCGTCTCTACTAAAGATACCAAAAATTAGCTGAGTGTGGTGCTGGGTGCCTGTAATCCCAGAAACTCAGGGTGCCTGTAATCCCAGCAACTCAGGGTGCCTTTAATCCCAGCAACTGAGGGTACCAGTAATCCCAGCAACTCAGGGTGTCTTTAATCCTAGCAACTGAGGGCACCTGTAATCCCAGCAACTCAGGAAGCTGAGACAGGAGAAGTACTTGAACCCAGAAGGCAGAGGTTGCAGTGAGCCGATATTGCACCATTGCACTCCAGTCTGGGCAACAAGAGTGAAACTCTGTCTCAAAAAAAAA"
"chr18","14964693","14965321","JH378118","18053084","18053501","273","3088391","GGCTGGGTGCGGTGGCTCACACCTGTAATCCCAGCACTTTGGGAGGCTGAGGCAGGCGGATCACCTGAGGTCAGGAGTTCAGGACCAGCCTGATCAACATAGCGAAACCCTGTCTCTATTAAAAATATAAAAATTGCTGGGTGCGGTGGCTCACGCCTGTAATCCCAGCACTTTGGGAAGCCGAGGCGGGCGGATCATGAGCTCAGGAGATCGAGACCATCTTGGCTAACATGGTGAAACCCTGTCTCTACTAAAAATACAAAAAAATTAGCCAGGTGTGGTGGCGGGCGCCTGTAGTCCCAGCTACTCTGGAGGCTGAGGCAGGAGAATCACTTGAACCTGGGAGGCGGAGGTTGCGGTGAGCCAAGATGGTGCCATTGCACTCCAGCCTGGGCAACAAGAGTGAAACTCCATCTCAAAAAAAAAGAAAAAAAAAAAAAAAAACAACCCACAAAAATTAGCCAGGTGTGATGGCGGGTGTCTGTAATCCCAGCTACTTGGGAGACTGAGGCAGGAGAATGGCTTGAACCCGGGAGGTGGAGGTTGCAGTAAGCCGAGATTGCGCCACTGCACTCCAGCCTGGGTGACCAGAGTGAAACTTCATCTCAAAAAAAAAAAAAAAAAAAAAA","GGCTGGGCGCAGTGGCTCACACCTGTAATCCCAGCACTTAGGGAAGCTGAGGCGAGTAGATCACCTGAGGTCAGGAGTTAGAGACCAGCCTGGCCATCATGGTGAAACCCCGTCTCTACTAAAGATACCAAAAATTAGCTGAGTGTGGTGCTGGGTGCCTGTAATCCCAGAAACTCAGGGTGCCTGTAATCCCAGCAACTCAGGGTGCCTTTAATCCCAGCAACTGAGGGTACCAGTAATCCCAGCAACTCAGGGTGTCTTTAATCCTAGCAACTGAGGGCACCTGTAATCCCAGCAACTCAGGAAGCTGAGACAGGAGAAGTACTTGAACCCAGAAGGCAGAGGTTGCAGTGAGCCGATATTGCACCATTGCACTCCAGTCTGGGCAACAAGAGTGAAACTCTGTCTCAAAAAAAAA"
"chr18","15291276","15291680","JH378105","31074364","31074738","116","15783088","CTCGTGCCTGTAATCCTAGCACTTTGGGAGGCCAAGGTGGGCAGATCATCTGAGGTCAGGAGTTCGAGACCAGCCTGGCCAACATAGAGAAATCCCATCTCTACTAAAAATACAAAAATTGACGAGTTAATGGGTGCAGCACACGAACATGGCACATGTATACATATGTAACAAACCTGCACGTTGTGCACATGTACCCTAAAACTTAAAGTATATTTAAAAAAAATACAAAAATTAGCCGGGCATGGTAGCAGGCACCTGTAATCCCAGCTACTCGGGAGGCTGAGGCAGGAGAATCACTTGAACCTGGGAGGCAGAGGTTGCAGTGAGCTAAGATCATTCCATTGTACTCCAACCTGGGCAACAAGAGTGAAATTCCGTCTAATAAAAAATGAAATAAATAAA","GGCCGGGCACAGTGGCTCACACCTGTAAACCCAGCACTTTGGGAGAATGAGGTGGGCAGATGACTTCAGGTCAGGAGTTCGAGACCAGCCTGGCCAACACTGTGAAATCCCATCTCTACTAAAAATACAAAAATTAGCCATGGTGGTCAGAAGATCAAGACTATCCTGGCCAACATGGTGAAACCTTGTCTCTACTGAAAATAGAAAAATTAGCTGGGTATGGTGGCATGCGCCTGTAGTCCCAGATACTCAGGAGGCTGGGGCAGGAGAATCACTTGAACCCAGGAGGCAGAGGTTGCAGTGAGCTGAGATCATGCCATTGCACTCTAGATTAGGCAACAAGAGTGAAACTGTCTCAAAAAGAGAGAGAGAAAA"
"chr18","15802064","15802689","JH378153","2355361","2355755","270","13446703","GACCGGGCATGGTGGCTCACACCTGTAATCCCAGCACTTTGGGAGGCGTAGGCGAGTGGCCCCTGAGGTCAGGAGATCGAGACAACCCTGGCCAACATGGTGAAACTCTACTAAAAATACAAAATTAGGCCGGGTGCCGTGGTTCACGCCTATAATCCCAGCACTTTGGGAGGTCAAGGTGGGCAGATCACCTGAGGTCAGGAGTTTGAGACCAGCCTGGCCAACATGGTGAAACCCAGTCTCTACTAAAAATACAAAAATTAGCTGGGCATGGTGGTGGACACTTGTAATCCCAGCTACTTGGGGGGCTGAGGCAGGAGAATCACTTGAACCCAGGAGGCAGAGGTTGCAGTGAGCCTAAATCACCCCATTGCACTCCAGCCTGGGCAACAAGAGTGAAATTCTGTCTCGAAAAAAAAAAAAAAAGAAAAGAAAAGAAAAAAAAATTAGCCAGGTGTGGTGCTGCATGCCTGTAATCCCAGCTACTCAGGAGGCTGAGGCAGGAGAATCGCTTGAACCCGGGAGGCAGAGGTTGCAGTGAGCTGAGACCACACCATTGCACTCCAGCCTGGGCGACAAGAGAGTAACTCCATTTCAAAAAAAAAAAAAAAAAAAAGAAAAAAGAA","GGCGGGGCATGGTGGCTCACACCTGTCATCCCAACACTTTGGGAGGCTGAGGCAGGCAGATCACCTGAGGTCAGGAGTTTGAGACCAGCCTGGCCAACATGGTGAAACCCCATCTCTACTAAAAATACAAAAATACAAAAAACCCCATCTCTACTAAAAATACAAAAAGCTTGTCTCTATTAAAAATACAAAAAACAAAAAACAAACAAAAAAAAAACCACCATGGTGGTGGGTGCCTATAATCCCAGCTACTCGGGAGGCTGAGGCAGGAGAATCGCTTGAACCCAGGAGGCAGAGGTTGCAGTGAGCCAAGATCCCACCATTGCACTCCAGCCTGGGCAACAGAGAGAGAGACTCTGCCTCAGAAAAAAGAAAGAAAGAAAGAAAGAAAGAAA"
"chr18","15849226","15849860","JH378118","18053084","18053501","290","2203858","GGCCAGGCACAGTAGCTTACGCCTATAATCTCAGCACCCTAGGAGGCCGAGGCTGGCAGACCACCTGAGGTCACGAGTTCAAGACTAGCCTGGTCAACATAGCAAAACCCCATCTCTACTAAAAATACAAAAATTAGGCTGGGCACAGTGGCTCATGCTTGTAATCCCAGCACTTTGGGAGGCCAAGTCGGGAGAATCACCTGAGGTTGGGAGTTCGAGATCAGCCTGACCAACATAGAGAAACTCCATCTCTACTAAAAATGCAAAATTAGCTAGGCATGGTGGTGCATGCCTGTAATCCCAGCTACTCGTAAGGCTGAGGCAGGAGTATCGCTTGAATCTGGGAGGTGGAGGTTGCGGTGAGCCAAGATCACGCCATCGTACTCCAGCCTGGGCAACAAGAGCGAAACTCCATCTCAAAACAAAAAAAATGAGCCAGGAGTGGTGGCGGGCGCCTATAATTCCAGCTACTCCAGAGGCTGAGGCAGGAGAATCACTTAAACCCGGGAAGCAGAGGTTGCAGTGAGCTGAGATTGTGCCATTGCACCCCAGCCTAGGTGAAAAGAGCAAAACTCCATCTCAAAAAAAAAAAAAAAAAAAAAAAAAAAGAAAGAAAGAAAGAAAAAGAAAAAAAA","GGCTGGGCGCAGTGGCTCACACCTGTAATCCCAGCACTTAGGGAAGCTGAGGCGAGTAGATCACCTGAGGTCAGGAGTTAGAGACCAGCCTGGCCATCATGGTGAAACCCCGTCTCTACTAAAGATACCAAAAATTAGCTGAGTGTGGTGCTGGGTGCCTGTAATCCCAGAAACTCAGGGTGCCTGTAATCCCAGCAACTCAGGGTGCCTTTAATCCCAGCAACTGAGGGTACCAGTAATCCCAGCAACTCAGGGTGTCTTTAATCCTAGCAACTGAGGGCACCTGTAATCCCAGCAACTCAGGAAGCTGAGACAGGAGAAGTACTTGAACCCAGAAGGCAGAGGTTGCAGTGAGCCGATATTGCACCATTGCACTCCAGTCTGGGCAACAAGAGTGAAACTCTGTCTCAAAAAAAAA"
"chr18","16042035","16042617","JH378118","18053084","18053501","243","2011049","GGCTATGCACGGTGGCTCACGCCTGTAATCCCAGCACTTTGGGAGGCCGAGTCAGGTGGATCACTTGAGGTCAGGAGTTCGAGACCAGCCTGGCCAACATGGTGAAGCCCCATCTCCACTAGAAATACAAAAATTAGTCTGGGAGCAGTGGCTTACACCTGTAATTGCAGCACTTTGGGAGGCCAAGGTGGGTGGATCACCTGAGGTCAGGAGTTTGAGACCAGCATGACCAACATGGTGAAACTCCATCTATACAAAAAAATTAGCCGGGTGTGGTGGCGCATGCCTGTAATCCCAGCTACTCAGGAGACTGAGGCAGGAGAATTGCTTGAACCCGGGAGGCAGAGGTTGCAGTGAGCCAAGTCTGTGCCATTGCACTCCAACCTGGGCAACAAAAGCGAAACTCTGTCTCAAAAATAAACAACAAAAAAAATTAGCCAGGTGTGGTGGCACATGCCTATAATCCCAGCTACTCGGGAGGCTGAGGCAGAAGAATTGCTTGAACCTGGGAGGTGGAGGTTGCAGTGAGCCGAGATCATGCCATTCTACTCCAGCCTGGGCCACAAGAGCGAAACTCTGTCTC","GGCTGGGCGCAGTGGCTCACACCTGTAATCCCAGCACTTAGGGAAGCTGAGGCGAGTAGATCACCTGAGGTCAGGAGTTAGAGACCAGCCTGGCCATCATGGTGAAACCCCGTCTCTACTAAAGATACCAAAAATTAGCTGAGTGTGGTGCTGGGTGCCTGTAATCCCAGAAACTCAGGGTGCCTGTAATCCCAGCAACTCAGGGTGCCTTTAATCCCAGCAACTGAGGGTACCAGTAATCCCAGCAACTCAGGGTGTCTTTAATCCTAGCAACTGAGGGCACCTGTAATCCCAGCAACTCAGGAAGCTGAGACAGGAGAAGTACTTGAACCCAGAAGGCAGAGGTTGCAGTGAGCCGATATTGCACCATTGCACTCCAGTCTGGGCAACAAGAGTGAAACTCTGTCTCAAAAAAAAA"
"chr18","25849088","25849351","JH378114","20445944","20446195","60","5403144","GGGAAGATGAGGCGGGTGGATCACTTGAGGTCAGGAGTTCGAGACCAGCCTGGCCAACATGGTGACACCCTGTCTCCAAAAAATACACACACACACACACACACACACACACACACAAATTAGCTGGGCATGGTGGCGGGCACCTGTAATCCTAGCTACTCGAGAGGCTGCGGCAGGAGAATTGCTTTAACTTGGGAGGTAGAGGTTGCAGAGAGCCGAGATTGCACCATTGTACTCCAGCCTGGGTGACAAGAGCGAAACTCC","TTGGGAGGCCAAGGCGGGTGGATCACCTGAGGTCAGGAGTTCGAGACCAGCCTGGCCAACATGATAAAACCCCCGTATCTAATAAAAATAGGAAAAAAAAATAAATAAATAGCTGGGCGTTGTGGCAGGTGCCTGTAATCCCAGCTACTCGGGAGGCTCAGGCAGGAGAATCGCTTGAACCCAGGAGGCAGAGGTTGCAGTGAGCCAAAATTGTGCCATTGCACTCCCGCCTGGGAAACAAGAGCAAAACTC"
"chr18","38083500","38083832","JH378152","15993594","15993909","55","22089906","GGCTGGGTGCGGTGGCTCACGCCTGTAATCCCAGCACTTTGGGAAGCCAAGTCAGGTGACCTCACCTGAGGTCAGGAGTCCAAGACCAGCCTGACCAACATGGTGAAACCTCGTCTCTACTAAAAAGACAAAAAATTAGCCAGGCATGGTGGTGGGCACCTGTAATCTCAGCTACTCTGGAGGCTGAGGCAGGAGAATCACTTGAACCCTGGAGGGGGAGGTTGCAGTGAACCAAGATTGCACCATTGCAGTCCAGCCTGGGCGACAAGAGCAAAACTCCATCTCACAAACACACACACACACACACACACACACACACACAGAAAAAAAAAA","GGCTGGGTGTGGTGGCTCATGCCGGTAATCCCAGCACTTTGGGAAGCGGAGGCAGGCAGATCACCTGAGGTCAGGAGTTCAAGACCAACCTGGCCAACATGGAGAAACCATGTCTCTACTAAAAATACAAAAAATTAGCCAGGCATGGTGGGTGCCTGTAATCCCCACTACTCGGGAGGCTGAGGCAGGAGAATTTCTTGAACCCAGGAGGTGGAGGTTTCAGTGAAGCGGAGATCACCCCATTGCACTCCAGCCTGGGTGACAAGAGCAAAACTCCATCTCACAAAATCAACAACAACAACTTAAAAAAAAAAAA"
"chr18","44076326","44076933","JH378118","18053084","18053501","257","26023242","GCTGGGCGCGGTGGCTTGCGCCTGTAATCCCAGCCATTTGGGAGGCCGAGGCAGGTGGATCACCTGAGGTTAGGAGTTCAAAACCAGCCTGGCCAACATGGTGAAACCCCGTCTCTACTAAAAATACAAAAATTAGGCCAGGCACAGTGGCTCACGCCTGTCATCCCAGCACTTTGGGAGGCCAAGGCGGGCGGATCATGAGGTCAGGAGATTGAGACCATCCTGGCTAACACAGTGAAACCCTGTCTCTACTAAAAAAATATATAAAAAATTAGCCGGGCTTGGTGGCGGGTGCCCGTAATCCCAGCTACTCGGGAGGCTGAGGCAGGAGAATGGCGTGAACCTGGAAGGCGGAGCTTGCAGTGAGCCGAGATTGCACCACTGCACTCCAGCCTGGGTGACAGAGTGAGACTCTGTCTCAAAAAAAAAAAAAAAACAAAAAACAAAAATTAGTTGGGTGTGGTGGTGGACGCCTGTAATCCCGGCTACTCGGGAGGCTGAGGCAGGAAAATCACTTCAACCCGGGAGGCAGAGGTTGCCGTGAGCCAAGATCGTGCCATTGCACTCCAGCCTGGGTGACAAGAGCAAAACTCTGTCTCAAAAAAAAA","GGCTGGGCGCAGTGGCTCACACCTGTAATCCCAGCACTTAGGGAAGCTGAGGCGAGTAGATCACCTGAGGTCAGGAGTTAGAGACCAGCCTGGCCATCATGGTGAAACCCCGTCTCTACTAAAGATACCAAAAATTAGCTGAGTGTGGTGCTGGGTGCCTGTAATCCCAGAAACTCAGGGTGCCTGTAATCCCAGCAACTCAGGGTGCCTTTAATCCCAGCAACTGAGGGTACCAGTAATCCCAGCAACTCAGGGTGTCTTTAATCCTAGCAACTGAGGGCACCTGTAATCCCAGCAACTCAGGAAGCTGAGACAGGAGAAGTACTTGAACCCAGAAGGCAGAGGTTGCAGTGAGCCGATATTGCACCATTGCACTCCAGTCTGGGCAACAAGAGTGAAACTCTGTCTCAAAAAAAAA"
"chr18","44546829","44547449","JH378118","18053084","18053501","262","26493745","GGCCAGGCACGGTCGCTCACACCTGTAATTCCAGCACTTTGGGAGGCCAAGGCGGATGGGTCACCTGAGGTCAGGAGTTTGAGACCAGCCTGACCAATATGATGAAACCCCATCTCTATTAAAAATACAAAAATTAGGCTGGGCGCAGTGGTTCATGCCTGTAATTCCAACACTTTGGGAGGCCGAGACGGGCGGACCATGAGGTCAGGAGATCGAGACCATCCTGGCCAACGTGGTGAAACCCCGTGTCTACTAAAATACAAAAAAAATTAGCCAGGTGTGGTGGCACGTGCCTGTAGTCCCAGCTATTAGGGAGGCTGAGGCAGGGGAATCACTTGAACCTGGGAGGTGGAGGTTGCAGTGAGCTGAGATCTTGCCACTACACTCCATTCTGGGCAACAGAGCAAGACTCCGTCTGAAAAAAAACAAAAAAATACAAAAATTAGCTGGGCATGGTGGCGGGTACCTGTAATCCCAGCTACTTGGGAGGCTGAGACAGGAGAATCACTTGAACTCGGGAGGCAGAGGTTGCAGTGAGCCAAGATCGCACCATTGCATTCCAGCCTGGGCAACAAGAGCGAAACTCCATCTCAAAAAAACAAAAAAAAAAAAAAAGAAAAA","GGCTGGGCGCAGTGGCTCACACCTGTAATCCCAGCACTTAGGGAAGCTGAGGCGAGTAGATCACCTGAGGTCAGGAGTTAGAGACCAGCCTGGCCATCATGGTGAAACCCCGTCTCTACTAAAGATACCAAAAATTAGCTGAGTGTGGTGCTGGGTGCCTGTAATCCCAGAAACTCAGGGTGCCTGTAATCCCAGCAACTCAGGGTGCCTTTAATCCCAGCAACTGAGGGTACCAGTAATCCCAGCAACTCAGGGTGTCTTTAATCCTAGCAACTGAGGGCACCTGTAATCCCAGCAACTCAGGAAGCTGAGACAGGAGAAGTACTTGAACCCAGAAGGCAGAGGTTGCAGTGAGCCGATATTGCACCATTGCACTCCAGTCTGGGCAACAAGAGTGAAACTCTGTCTCAAAAAAAAA"
"chr18","45772849","45773450","JH378118","18053084","18053501","269","27719765","CACGCCTATAATCCCAGCACTTTAGGAGGCTGAGGCAGGTGGATCACCTGAGATCAGGAGTTCAAAACCAGCCTGGCCAACATGGTGAAACCCTGTGTCTACTACAAATACAAAAAAATGGGCAGGGTGTGGTGGCTCACACCTGTAATCCCAGCACTTAGGGAGGCCGAGGCGGGTGGATCATGAGGTCAAGAGATCAAGACCATCCTGGCCAACATGGTAAAACCCCGCCTCTACTAAAAATATAAAAATTAGCTGGGCAAGGTGGTGCGCGCCTGTAGTCCCAGCTATTTGGGAGGCTGAGGCAGGAGAATTGCTTGAACCTGGGAGGTGGAGGTTGCAGTGAGCCAAAATCGCGCCACTGCACTCCAGCCTGGCAACAGAGTGAGACTCTGTCTCAAAAAAAAACAAAAACAAAACAAAACAGAAACCAAAATTAGCTGGGCGTGGTGGCGGGCGCCTGTAGTCCCAGCTACTTGGGAGGCTGAGGCAGGAGAATCGCATGAACCCAGGAGGCGGAGGTTGCAGTGAGCCAAGACTGCACTATTGCACTCCAGTCTGGGCTACAAGAGCGAACTCCGTCTCAAAAAAAAAAAAAAAAA","GGCTGGGCGCAGTGGCTCACACCTGTAATCCCAGCACTTAGGGAAGCTGAGGCGAGTAGATCACCTGAGGTCAGGAGTTAGAGACCAGCCTGGCCATCATGGTGAAACCCCGTCTCTACTAAAGATACCAAAAATTAGCTGAGTGTGGTGCTGGGTGCCTGTAATCCCAGAAACTCAGGGTGCCTGTAATCCCAGCAACTCAGGGTGCCTTTAATCCCAGCAACTGAGGGTACCAGTAATCCCAGCAACTCAGGGTGTCTTTAATCCTAGCAACTGAGGGCACCTGTAATCCCAGCAACTCAGGAAGCTGAGACAGGAGAAGTACTTGAACCCAGAAGGCAGAGGTTGCAGTGAGCCGATATTGCACCATTGCACTCCAGTCTGGGCAACAAGAGTGAAACTCTGTCTCAAAAAAAAA"
"chr18","50079974","50080314","JH378127","6796468","6796795","54","43283506","GGTCTGGCGCCAGTGGCTCATGCCTGTAATCCCAGCACTTTGGGAGGCTGAGGCGGGTGTATCACCTGAGGTCAGGAGTTCGAGACCAGCCTGGCCAACATGGCAAAACCCCGTCTCTACGAAAAATACAAAAAAATTAGCCGGGCGTGGTAGCAGTCGCCTGTAATCCCAGCAACTTGGGAAGCTGAGGCAGAAGAATCGCTTAAACCTAGGAGGCGGAGGTTGCAGTGAGCCAAGATTGCGCCATTGCACTCCAGCCTGGTCAACAAGAGCAAAACTCTGTCTCAAAACAACAACAACAACAACAACAACAACAAACAAAAACCAAAAAAACCAAAAAA","GGCCGGGCGCGGTGGCTCAAGCCTGTAATCCCAGCATTTTGGGAGGCCGAGGCGGGTGGATCACGAGGTCAGGAAATCGAGACCATCCTGGTCAACATGGCGAAACCCCATGTCTACTAAAAATACAAAAATTAGCTGGGCATGGTGGCACGTGCCTGTAATCCCAGCTACTCAGGAGGCTGAGGCAGGAGAATTGCCTGAACCCAGGAGGCGGAGCTTGCAGTGAGCCGAGATCGCGCCATTGCACTCCAGCCTGGGTAACAAGAGCGAAACTCCGTCTCAAAAAAACAAACAAAAACAAAACAAAACAAAACAAAACAAAAAAAAC"
"chr18","53653883","53654201","AGCE01149660","956","1264","46","53652927","GGCCAGGCATGGTGGCTCACGTTTGTAATCCTAGCACTTTGGGAGGCTGTAGCGGGCGGATCACCTGAGGTCAGGAGTTTGAGACCAGCCTGGCCAACATGGTGAAACCCTGTCTCTACTAAAAAAAAAAAAAAAAAAAAAAAAAAAATTAGCCAGGTGTGGTGGTGGTGGATGCCTATAATCCCAGCTACTCGGGAGGCTGAGGCAGGAGAATCACTTGAACCTGGGAAGCAGAGGTTGCAATGAGCTGAGATTGAGCCATTGCACTCCAGCCTGGACAACAAGAATGAGACTCTGTCTCAATAAATAAGTAAATAAA","GGCCAGGCACGGTGGCTCATGCCTATAATCCCAGCACTTTGGGAGGCTGCGATGGGTGGTTCACTTGAGGTCTGGAGTTTGAGACCAGCCTGGCCAACATGGAGAAACCCTTTCTCTACTAAAAATACAAAAAAAAAAAAAAAAAAAATTAGCCAGGCATGGTGGCGGGTGCCTGTAATCCCAGCTACTCAGCAGGCTGAGGGAAGAGAATCACTTGAACCGGGGAGGCAGAGGTTGCAGTGAGCTGAGATGATGCCATTGCACTCCAGCCTGGGCAACAAGAGCAAAACTGTCTCAAAAAAAAAAAAA"
"chr18","53971096","53971710","JH378118","18053084","18053501","262","35918012","GGTCGGGTGTGGTGGCTCATGCCTATAATCCCAGCACTTTGGGAGGCTGAGGCAGGCAGATTACCTGAGGTCAGGAGTTCGAGACCAGCCTGGCCAACATGATGAAACCTTGTCTCTACTAAAAATACAAAAATTAGGCCGGGCACGGTGGCTCATGCCTGTAATCCCAGCACTTTGGGAGGCCGAGGCGGGTAGATCACAAGGTCAGAAGTTCAAGACCAGCCTGGCCAACATGGTGAAACTCTGTCTTTACTAAAAATACAAAAATTAGCTAGGCATGGTGGCGCACACCTATAATCCCAGCTACTGGGGAGGCTGAGGCAGGAGAATTGCTTGAACCAGGACCCGGGAGGTGGAGGTTGCTGTGAGCCGAGATTGCGCCACTGCACTCCAGCCTGGGAGACAGAGTGAGACTCCGTCTAAAAAAAAAAAAAAAAAATTAGCCAGGTGTGGTGGCGCATGCCTGTAATCCCAGCTACTCGGGAGGCTGACGCAGAAGAATCATTTGAACGTGGGAGGCAGAGGTTACAATGAGCTGAGATCACACCATTGTACTCCAGCCTGGGCAACAAGAGCAAACTCAATCTCAAAAAAATAAAAATAAAAAAAAAGAAA","GGCTGGGCGCAGTGGCTCACACCTGTAATCCCAGCACTTAGGGAAGCTGAGGCGAGTAGATCACCTGAGGTCAGGAGTTAGAGACCAGCCTGGCCATCATGGTGAAACCCCGTCTCTACTAAAGATACCAAAAATTAGCTGAGTGTGGTGCTGGGTGCCTGTAATCCCAGAAACTCAGGGTGCCTGTAATCCCAGCAACTCAGGGTGCCTTTAATCCCAGCAACTGAGGGTACCAGTAATCCCAGCAACTCAGGGTGTCTTTAATCCTAGCAACTGAGGGCACCTGTAATCCCAGCAACTCAGGAAGCTGAGACAGGAGAAGTACTTGAACCCAGAAGGCAGAGGTTGCAGTGAGCCGATATTGCACCATTGCACTCCAGTCTGGGCAACAAGAGTGAAACTCTGTCTCAAAAAAAAA"
"chr18","57837437","57837748","JH378115","16887097","16887400","43","40950340","GCTGGGCATGGTGGCTCACACCTGTAATCCCAGCACCTTGGGAGGCCGAGGTGGGTAGATCACCTGAGGTCAGGAATTCGAGACCAACCTGGCCAACATGGTGAAACCCCGTCTCTACTAAAAATACAAAAAAAAAAAAAAAAAAAAAAAAAGCTGGGCATGGTGGTGGGTACCTGTAATCCCAGCTACTCAGGAGTCCGAGGCAGGAGAATCGCTTGAACCTGGCAGGTGGAGGTTGCAGTGTGCCAGGATTGTGCCATTGCACTCCAGCCTGGGTGACAAGAGCAAAACTCCAACTCAAAACAAAAACAA","GCCGGGCACGGTGGCTCAAGCCTGTAATCCCAGCACTTTGGGAGGCCGAGGCGGGTGGATCACAAGGTCAAGAGATCGAGACCAACCTGGTCAACATGGTGAAACCCCATCTCTACTAAAAAATACAAAAAAAAAAAAAAAATTAGCTGGGCATGGTGGCGCGTGCCTATAATCCCAGCTACTCAGGAGGCTGAGGCAGGAGAATTGCCTGAACCTAGGAGGTGGAGGTTGCAGTGAGCCAAGATCATGCCATTGCACTCCAGCCTGGGTAACAAGAGCGAAACTCCATCTCAAAAAAAAAAAA"
"chr18","58257354","58257943","JH378118","18053084","18053501","263","40204270","GCCTGTAATCACAGCACTTAGGGGGGCCGAGGCAGGAGGATCACCTGAGGTCAGGAGTTCGAGACCAGCCTGGCCAACATGGTGAAACCCCGTCCCTACTAAAAATACAAAAATTGGCCGGACACATTGGCTCATGCCTGTAATCCCAGCACTTTGGGAGGCCGAGGCGGGTGGATCACCTGAGGTCAGGAGTTCAAGACCAGCCTGACCAACCTGGAGAAACCCTGTTTCTACTAAAAATACAAAATTAGCCAGGCATAGTGGCGCATGCCTGTAATCCCAGCTACTCGAGAGGCTGAGGCAGGAGAATCGCTTGAACCCGGAAGGTGGAGGTTGCGGTGAACCGAGATTGTGCCATTGCACTCCAGCCTGGGCAACAAGAGCAAAACTCCGTCTCAAAAACAAAACAAAACAAAACAAAAATTAACCCGGCGTGGAGGTGGATGCCTGTAATCCCAGCCACTTTGGGAGACTGAGGCAAGAGAATTGCTTGAACCCGGGATGTGGAGGCTGCAGTGACCCGAGATCACGCCATTGCATTCCAGCCTGGCAACAAGAGTAAGACTCCATCTCAAAAACAAGCAAACAAA","GGCTGGGCGCAGTGGCTCACACCTGTAATCCCAGCACTTAGGGAAGCTGAGGCGAGTAGATCACCTGAGGTCAGGAGTTAGAGACCAGCCTGGCCATCATGGTGAAACCCCGTCTCTACTAAAGATACCAAAAATTAGCTGAGTGTGGTGCTGGGTGCCTGTAATCCCAGAAACTCAGGGTGCCTGTAATCCCAGCAACTCAGGGTGCCTTTAATCCCAGCAACTGAGGGTACCAGTAATCCCAGCAACTCAGGGTGTCTTTAATCCTAGCAACTGAGGGCACCTGTAATCCCAGCAACTCAGGAAGCTGAGACAGGAGAAGTACTTGAACCCAGAAGGCAGAGGTTGCAGTGAGCCGATATTGCACCATTGCACTCCAGTCTGGGCAACAAGAGTGAAACTCTGTCTCAAAAAAAAA"
"chr18","59255477","59255805","JH378228","5665092","5665424","52","53590385","GGTTGGGCGCAGTGGCTCACGCCTGTAACCCCAGCACTTTCGGAAGCTGAGGCAGGCGGATCACCTGAGGTCAGGGGTTCGAGACCAGCCCGGACAACGTGATTAAACCCTGCCTCTACTAAAAATACAAAAATTAGCGACTGTGGTGTTGGGCGCCTGTAATCGCAGCTACTTGGGAGGCTGAGGCATGAGAATTGCTTGAACCCAGGAGGCAGAGGTTGCAGTGAGCAGAGATTGCTCCATTGCACTCCAGCCTGGGCAACAAGAGCAGAACTCTGTCTCAAAATAAATAAATAAATAAATAAATAAATAAATAACAGAAAAGAAAA","GGCCGGGCGCGGTGGCTCAAGCCTGTAATCCCAGCACTTTGGGAGGCTGAGGCGGGTGGATCACGAGGTCAAGAGATCGAGACCATCCTGGTCAACATGGTGAAACCCTGTCTCTACTAAAAATACTAAAAATTAGCTGGGCATGGTGGCGTGTGCCTGTAATCCCAGCTACTCAGGAGGCTGAGGCAGGAGAATTGCCTGAACCCAGGAGGCGGAGGTTGCGGTGAGCCGAGATCGCGCCATTGCACTCCAGCCTGGGCAACAAGAGCGAAACTCTGTCTCAAAAAAAAAAAATAAATAAATAAAATAAAATAAAATAAAATAAAATAAAAT"
"chr18","59405673","59406877","JH378118","18053084","18053501","805","41352589","GGCTAGATGCGGTGGCTCATGCCTGTAATCCCAGCACTTTGGGAGGCCAAGGCAGGTGGATCACCTGAGGTCAGGAGTTTGACACCAGCCTGGCCAACATGTTGAAACCCTGTCTCCACTAAAAATACAAAAAAAGATTATCTGGGTTATTGTGGGATCTGGCCAGCAGCCCGCAATGCAATGGGGCTCTCTCTTTGTTCCCAGGCAGATTGGCAGGTTGAGAAATAATAGACACACACAAGATAGTGAAAGTTGGGTCCAGGGGGGTCACCGCCTTCTGGTCCCATGGTGCCAACAATGCACTGGATATACCAGCATTTATTATTAAGTTTAGTGAGGGCGGGGGTAGGTTAGTGAGGGATTTAGGGTCATTTGATTATGAGGTGAGATGGTCACATGGAAATGAAGTAATTCTTTAACGTAACATTTGTATGTAGAAGTACAGTACATTTGTATGTAGAAGTACAGTATACAGAGATAAGAATTTACAATATAGTGTGTGCATCAGTAATTTCTAACAGAGCCTTAAAACAGAAAGACAATCTTTCCATAATCTATGATTAGCAAGATATTAATCAGCAGTAACAATTGCAATGAAAGCTGGTTACAAACAGTCCATGGAAACAGGAGGTGAAGCTAGACAATCGGTTAGACCAGAAATTCTCAGAAGGGAATATGCCTTAACCCTAAAGAGGCCTAGAAGAGCCGTGGCAAGATGAGGGTGTTTATAGCCCTATCTTATCCATATGGACAGGCACCTCCCCATGCGTCCGTTTATAGGCTCTCCATGAGGGTCGCATTCCATTCCCAGAGCTATGAACATCTGCTTTTCTGGGATAGGAATCTTGGTGATGTGAAACCTCCCTGACTACACGTCCATTCATAGGATCTCTGCAGGGGGAAGCACATCACACACTGTTGGCTCGTTCTGGCAGTCCAACCTGGCATTGTGTCTTTACACAATCCTGCATGCAATTTTGTATTTACAATAATCAGGAGCATTTCATCTTTTATTCTGTAGCAATAGTTTCAGGGGGTCTCCCTACACTGGGTGTGGTGACGGGTACCTGTAATCCCAGCTACTCAGGAGGCTGAGGCAGGAGAATCACTTGAGCCTTAGAGGCAGAGGTTGCAGTGAGCTGAGATCAGACCATTGCACTCCAGCCTGGGCAACAAGAGCAAACCTCCGTCTCAAAAAAAAAAAA","GGCTGGGCGCAGTGGCTCACACCTGTAATCCCAGCACTTAGGGAAGCTGAGGCGAGTAGATCACCTGAGGTCAGGAGTTAGAGACCAGCCTGGCCATCATGGTGAAACCCCGTCTCTACTAAAGATACCAAAAATTAGCTGAGTGTGGTGCTGGGTGCCTGTAATCCCAGAAACTCAGGGTGCCTGTAATCCCAGCAACTCAGGGTGCCTTTAATCCCAGCAACTGAGGGTACCAGTAATCCCAGCAACTCAGGGTGTCTTTAATCCTAGCAACTGAGGGCACCTGTAATCCCAGCAACTCAGGAAGCTGAGACAGGAGAAGTACTTGAACCCAGAAGGCAGAGGTTGCAGTGAGCCGATATTGCACCATTGCACTCCAGTCTGGGCAACAAGAGTGAAACTCTGTCTCAAAAAAAAA"
"chr18","71500430","71500770","JH378228","5665092","5665424","54","65835338","GCTGGGTGCGGTGGCTCACGCCTGTAATCACAGCACTTTGGTAAGCCCGAGGCAGGTGGATCACCTGAGGTCAGGAGTTCGAGACCAGCCTGACCAACATGGTGAAACCCTTTCTCTACTAAAAATGCAAAAATTAGCTGGGCGTCATGGCGGGCGTCTGTGATCCCAGCTACTAGGGAGGCTAAGGCAGGAGAATTGCTTGAACCTGGGAGGCGGAGGTTGCAGTGAGCAGAGATTGCACCATTACACTCCAGCCTGGGCAACAAGAGCAAAACTCCATCTCAAAATAAATAAATAACTAAATAAATAAATAAAATGAAATTAAAAAGAAAGAAAGAAAA","GGCCGGGCGCGGTGGCTCAAGCCTGTAATCCCAGCACTTTGGGAGGCTGAGGCGGGTGGATCACGAGGTCAAGAGATCGAGACCATCCTGGTCAACATGGTGAAACCCTGTCTCTACTAAAAATACTAAAAATTAGCTGGGCATGGTGGCGTGTGCCTGTAATCCCAGCTACTCAGGAGGCTGAGGCAGGAGAATTGCCTGAACCCAGGAGGCGGAGGTTGCGGTGAGCCGAGATCGCGCCATTGCACTCCAGCCTGGGCAACAAGAGCGAAACTCTGTCTCAAAAAAAAAAAATAAATAAATAAAATAAAATAAAATAAAATAAAATAAAAT"
"chr19","1465612","1466244","JH378118","18053084","18053501","284","16587472","GGCTGGGGACGGTGGCTCAGGCCTGTAACCCCAGCACTTTGAGAGGACCAGGAGGGAGGATTGCTTGAGCCCAGGAGTCCGAGACCAGCCTGGGCAGCAAAGCAAGGCCCTGTCTCTACAAAAATACTTTAAAATTAGCCAAGTGTTGGCTGGGTGCGGTTGCTCATGCCTATAATCCCAGCACTTTGGGAGGCCGAGGTGGGTGGATCACCTGAGGTCAGGAGTTTGAGACCAGCCTGGCCAACATGGCAAAACCCCGTCTCTACTAAAAATACGAAAATTAGCCAGACGTGGTGGCTCATTCCTGTAATCCCAGCTACTCGGGAGGCTGAGGCAGGAGAATCGCTTGAACTCGCAAGGCGGAGGTTGCAGTGAGCCAAGATCATGCCATTGCATTCCAGCCTGGGTGACAGAGCAAAACTCCGTCTCAAAAAAAAAAAAAAAAAAAAAAAATTAGCCAGGCGTGGTGGTGGGCACCTGTAGTCCCAGCTACCCGGGAGGCTGAGGCAGGAGAATCGCTTGAGCCCGGGAGGCAGAGGTTACAGTGAGCCGAGATCGTGCCATTGCACTCCAGCCTGGGCAACAAGAGTGAAAATCCGTCTCAAAAAAATAAATAAATACAAAATAAAAAAA","GGCTGGGCGCAGTGGCTCACACCTGTAATCCCAGCACTTAGGGAAGCTGAGGCGAGTAGATCACCTGAGGTCAGGAGTTAGAGACCAGCCTGGCCATCATGGTGAAACCCCGTCTCTACTAAAGATACCAAAAATTAGCTGAGTGTGGTGCTGGGTGCCTGTAATCCCAGAAACTCAGGGTGCCTGTAATCCCAGCAACTCAGGGTGCCTTTAATCCCAGCAACTGAGGGTACCAGTAATCCCAGCAACTCAGGGTGTCTTTAATCCTAGCAACTGAGGGCACCTGTAATCCCAGCAACTCAGGAAGCTGAGACAGGAGAAGTACTTGAACCCAGAAGGCAGAGGTTGCAGTGAGCCGATATTGCACCATTGCACTCCAGTCTGGGCAACAAGAGTGAAACTCTGTCTCAAAAAAAAA"
"chr19","1761610","1762212","JH378118","18053084","18053501","248","16291474","GGCCGGGTGCGGTGGTTTACACCTGTAATCCTGGCATTTTGGGAGGCCGAGGCAGGAGTATCACCTCAGGTCAGGAGTTCAAGACCAGCCTGGCCAACATGGTGATACTCCGTCTCTACTAAAAATACAAAAATTGGCCGAGTGCAGTGGCTCACACCTGTAATCCCAGCACTTTGGGAGGCCGAGGCAGGTGGATCATGAGGTCAGGAGTTCGAGACCAGCCTGGCCAAGATGGTGAAACCCCGTCTCTACTAAAAATACAAAAATCAGCTGGGTGTGGTGGCGGGTGCCTGTAATCCCAGCTACTCGGGAGGCTGAGGCAGGAGAATTGCTTGGACCTGGGCAGCAGAGGTTGCAGCGAGCTGAGATGGCGCCACTGCACTCCAGCCTGGGCGACAGAGCGAGACTCTTGTCTCAGAAAAATAAAAAATAAAAAAATTAGCTGGGTGTGGTGGTGCGCACCTGTAATCCCAGCTACTCGGGAGGCTGAGGCAGGAGAATCGCTTGAATCTGGGAGGAGGAGGAGGTTGCAGTGAGCTGAGATAGTGCCAGTGCAGGCCAGCCTGGTCAACAAGAGTGAAACTCCGTCTCAGAAAAAAAAAA","GGCTGGGCGCAGTGGCTCACACCTGTAATCCCAGCACTTAGGGAAGCTGAGGCGAGTAGATCACCTGAGGTCAGGAGTTAGAGACCAGCCTGGCCATCATGGTGAAACCCCGTCTCTACTAAAGATACCAAAAATTAGCTGAGTGTGGTGCTGGGTGCCTGTAATCCCAGAAACTCAGGGTGCCTGTAATCCCAGCAACTCAGGGTGCCTTTAATCCCAGCAACTGAGGGTACCAGTAATCCCAGCAACTCAGGGTGTCTTTAATCCTAGCAACTGAGGGCACCTGTAATCCCAGCAACTCAGGAAGCTGAGACAGGAGAAGTACTTGAACCCAGAAGGCAGAGGTTGCAGTGAGCCGATATTGCACCATTGCACTCCAGTCTGGGCAACAAGAGTGAAACTCTGTCTCAAAAAAAAA"
"chr19","2871458","2872098","JH378118","18053084","18053501","282","15181626","GGCCGGGCGCGGTGGCTCACGCTTGTAATCCCAGCACTTTGGGAGGCCTAGGTAGTGGATCACCTGAGGTCAGGAGTTTGAGACCAGCCTGGCCAACATGGGGAAACCCAGTCTCTACTAAAAATACAAAAATGAGGCCGGGTGCAGTGGCTCATGCCTGTAGTCTCAACACTTTGGGAGACCAAGGCAGGCGGATCACCTGAGGTCAGGAGTTCAAGCCCAACCTGGCCAACATGGTGAAACCCTGCCTCTTCTAAAAATACAAAAATTAGCCAGGTGTGGTGGCATGTACCTGCAATCCCAGCTGCTTAGGAGTTCGAGATAGAAGGATTGCCTGAACCTGGGAGGCGGAGGTTGCAGTGAGCTGAGATCATGCCATTGCACTCCAGCCTGGGTGACAGAGACCCTGTCTCACACACACACACACAAATTATATATATATATATATATATACACACACACACACACGCACACACAAATTGGCCAGGCGTGGTGGCGGGTGCCTATAATTCCAGCTACTTGGGAGGCTGAGGCAGGAGAATGTCTTGAACCCGGGAGGTGGAGGTTGCAGTGAGCCGAGATTGCGCCACTGCACTTTAGCCTGGACGACAAGAACAAAACTCCATCTCAAAAAAACGAAA","GGCTGGGCGCAGTGGCTCACACCTGTAATCCCAGCACTTAGGGAAGCTGAGGCGAGTAGATCACCTGAGGTCAGGAGTTAGAGACCAGCCTGGCCATCATGGTGAAACCCCGTCTCTACTAAAGATACCAAAAATTAGCTGAGTGTGGTGCTGGGTGCCTGTAATCCCAGAAACTCAGGGTGCCTGTAATCCCAGCAACTCAGGGTGCCTTTAATCCCAGCAACTGAGGGTACCAGTAATCCCAGCAACTCAGGGTGTCTTTAATCCTAGCAACTGAGGGCACCTGTAATCCCAGCAACTCAGGAAGCTGAGACAGGAGAAGTACTTGAACCCAGAAGGCAGAGGTTGCAGTGAGCCGATATTGCACCATTGCACTCCAGTCTGGGCAACAAGAGTGAAACTCTGTCTCAAAAAAAAA"
"chr19","2912949","2913566","JH378118","18053084","18053501","268","15140135","GGCTGGGCGTGGTGGCTCACACCTGTAATCCCAGCACTTTGGGAGGCCAAGGTGGAGGGACTGCCTGAAGCCAGGGGTTCGAGACCAGCCTGGCCAACATGGTGAAACCCTGTCTCTACTAAAAATAGAAAAATTAAGGCCGGGCGCGGTGGCTCATGCCTGTAATCCCAGCACTTTGGAAGGCCGAGGCGGGCGGATCACTTGAGGTCGGGAGTTCAAGACCAGCCTGACCAACATGGAGAAACCCTGTCTCTACTAAAAATACAAAATTAGCCAGGGTGGTGGCGCATGCCTGTAATCCCAGCTACTTGGGAGGCTGAGGCAGGAGAATCGCTTGAACCCGGGAGGTGGAGGTTGCAGTGAGCTGAGATCGCACCATTGCACTCCAGCCTGGGCAACAAGAGCAAAACCACGTCTCAAAAAAAATAAAAATAAAAATAAAAAAATTAGCTGGGTGTGGTGGCAGGCGCCTGTAGCTGCTTGGGAGGCTGAGACAGGAGAATTGCTTGAACCTGGGAGGCGGAGGTTGCAGTGAGCTGAGACCGTGCCATTGCACTCCAGGCTGGGCAAGAAGAGCAAAACTCTATCCTTCCCCCACTCCAAAAAAAAAAAAAAAAA","GGCTGGGCGCAGTGGCTCACACCTGTAATCCCAGCACTTAGGGAAGCTGAGGCGAGTAGATCACCTGAGGTCAGGAGTTAGAGACCAGCCTGGCCATCATGGTGAAACCCCGTCTCTACTAAAGATACCAAAAATTAGCTGAGTGTGGTGCTGGGTGCCTGTAATCCCAGAAACTCAGGGTGCCTGTAATCCCAGCAACTCAGGGTGCCTTTAATCCCAGCAACTGAGGGTACCAGTAATCCCAGCAACTCAGGGTGTCTTTAATCCTAGCAACTGAGGGCACCTGTAATCCCAGCAACTCAGGAAGCTGAGACAGGAGAAGTACTTGAACCCAGAAGGCAGAGGTTGCAGTGAGCCGATATTGCACCATTGCACTCCAGTCTGGGCAACAAGAGTGAAACTCTGTCTCAAAAAAAAA"
"chr19","3601333","3601668","JH378148","10302642","10302970","47","6701309","GCTGGGCGTGGTGGCTCACACCTGTAATCCCAGCACTTTGGGAGGCTGAGGTGGGCGGATCACGTGAGGTCAGGAGTTCCAGACTAGCCTGGCCAACATGGGGAAACCCCATCTCTGCTAAAAATAAAAAATTTAGCCGAGTGTGGTGGTGGGTGCCTGTAATCCCAGCTACTCAGGAGGCCGAGGCAGGAGAATTGCTTGAACCCAGGAGGCAGAGGTTGCAGTGAGCCGAGATCACGCCATTGCACTCCAGCCTGGATGACAACAGTGAGACTCCAACTCAAAAAATAATAATAATAATAATAATAATAATAAAATAAAACAATAAAAAAAAAA","GGCCGGGCGCGGTGGCTCAAGCCTGTAATCCCAGCACTTTGGGAGGCCGAGGCGGGTGGATCACGAGGTCAAGAGATCGAGACCATCCTGGTCAACATGGTGAAACCCCGTCTCTACTAAAAATACAAAAAATTAGCTGGGCATGGTGGTGGGTGCCTGTAATCCCAGCTACTCAGGAGGCTGAGGCAGGAGAATTGCCTGAACCCAGGAGGCGGAGGTTGCGGTGAGCCGAGATCGCGCCATTGCACTCCAGCCTGGGTAACAAGAGTGAAACTCTGCCTCAAAAAAAAAAAATAAAATAAAATAAAATAAAATAAAATAAAATAAAA"
"chr19","4440800","4441421","JH378118","18053084","18053501","276","13612284","GGCTGGGTGCGGTGGCTCATGCCTGTAATCCCAGCACTTTGGGAGGCCAAGCGGGCAGATCAACTGAGGTCAGGAGTTCGAGACCAGCCTGGCCAACATAGTAAAACCCTGTTTCTACTAAAAAAAAAAAAAAAAAAAAAAAAAAAATTGGCTGGGCGCAGTGGCTCACGCATGTAATCCCTGCACTTTGGGAGGCCAAGGCAGGTGGATCACCTGAGGTCAGTAGTTTGAGACCAGCCTGACCAACGTGGAGAAACCCCATCTCTACTAAAAATACAAACAAAAAAAACAAAAAACAAAAAAAACCGGGTATGGTGGTACATCCCTGTAATCCCAGCTCCTCGGGAGGCTGAGGCAGGAGAATCACTTGAACCCGGGAGGCGGAGGTTGCACTGAGCCGAGATTGCGCCACTGCACTCCAGCCTGGGCGATAGAGCGAGACTCCCTCTTAAATAATGATTATAATTGCCAGGTGTGGTGGCGGGTGCCTGTAATCCCAGCTACTTGGGAGGCTGAGGCAGGAGAATCGTTTGAATCCAGGAGGAGGAGGTTGCAGTGAGCCGAGATGGTGCCACAGCACTCCAGCCTGGGTGACAAGAGTGAAACCCCATTACAAACAAAA","GGCTGGGCGCAGTGGCTCACACCTGTAATCCCAGCACTTAGGGAAGCTGAGGCGAGTAGATCACCTGAGGTCAGGAGTTAGAGACCAGCCTGGCCATCATGGTGAAACCCCGTCTCTACTAAAGATACCAAAAATTAGCTGAGTGTGGTGCTGGGTGCCTGTAATCCCAGAAACTCAGGGTGCCTGTAATCCCAGCAACTCAGGGTGCCTTTAATCCCAGCAACTGAGGGTACCAGTAATCCCAGCAACTCAGGGTGTCTTTAATCCTAGCAACTGAGGGCACCTGTAATCCCAGCAACTCAGGAAGCTGAGACAGGAGAAGTACTTGAACCCAGAAGGCAGAGGTTGCAGTGAGCCGATATTGCACCATTGCACTCCAGTCTGGGCAACAAGAGTGAAACTCTGTCTCAAAAAAAAA"
"chr19","5462237","5462567","JH378255","1377129","1377437","56","4085108","GACCAGGTGCGGTGGCTCACGCCTGTCATTCCAGCACTTTGGGAGGCCGAGGGGGGCGTGGATCACTTGAGGTCAGGAGTTCAAGACCAGCCTGACCAACATGGTGAAACTCCGTCTCTACTAAAAATACAAAAATTAGCCAGGTGTGGTGGCACATGCCTGTAATCCCAGCTACTTGGGAGGCTGAGGCAGGAGAATCACTTGAACCTGGGAGATGGAGGTTTCATTCAGTGAGCTGAGATTGCACCATTGCACTCCAGCCTGGGTGACAAGAACGAAACTCTGTCTCAGAACACACACACACACACACACACACACACCCCAGAAAAAA","GGCCTGGCGTGGTGGCTCACGCCTGTAATCTCAGCACTTTGGGAGGCCAAGGTGGGTGGATCACCTGAGGTCAGGAGTTCAAGACCAGCCTGGCCAACATGGTGAAACCCCGTCTCTACTAAAAATACAAAAATTAGCTGGGTGTGGTGGCAGACACCTGTAATTCCAGCTACTTGGGAGGCTGAGGCAGGAGAATAGCTTGAACCTGGGAGGTGAGGGTTGCAGTGAGCCGAGATCGCACCATTTTACTCCAACCTGGGCAACAAGAGCGAAACTCCGTCTCAAAATCCAAACAAACCAAAACAAAAA"
"chr19","8011731","8012413","JH378118","18053084","18053501","321","10041353","GGCCGGGTACAGTGGCTCACTCCTGTAATCCCAGAACTTTGGGAGACCGAGGTGGGGGGATCACTTGAGGTCAGGAGTTCGAGACCACCCTGGCCAATATAGTGCTAAACCCCATCTCTACTCAAAATACAAAAAAAAAAAAAAAAAAAAAAAAAAAGCAAAACCCAGGCTGGGCACAGTAGCTCATACCTGTAATCCCAGCACTTTGGGAGGCTGAGGTGGGTAGATCATGAGGTCAGGAGTTCGAGACCAGCCTGACCAACATGGTGAAACCCCGTCTCTACTAAAAATACAAAAATTAGCCGGGCATGGTGGTGCGTGCCTGTAATCCCAGCTACTCAGGAGGCTGAGGCAGGAGAATCGCTTGAAGCTGGGAGGCAGAGGTTGCAGTGAGCCGAGATCGTGCTACTGTACTCCAGCCTGGGCAACAGGGCGACAGAGCAAGACTCTGTCTCAAAAAAAAAAAAAAAAAAAAAAAAAAGCAAAACCCCATCTCTACTAAAAATACAAAAAATTAGCCAGGCATGGTGGCATGTGCCTGTAATCCCAGCTACTCGAGAGGCTGAGGCAGAAGAATCACTTGAACCCAGGAGGCAGAGGTTGCAGCGAGCCAAGATTGTGCCATTGCACTCCAATCTGGGTGACAAGAGTAAAATCCTGTCTCAAAAAAATAAAAAATAAAA","GGCTGGGCGCAGTGGCTCACACCTGTAATCCCAGCACTTAGGGAAGCTGAGGCGAGTAGATCACCTGAGGTCAGGAGTTAGAGACCAGCCTGGCCATCATGGTGAAACCCCGTCTCTACTAAAGATACCAAAAATTAGCTGAGTGTGGTGCTGGGTGCCTGTAATCCCAGAAACTCAGGGTGCCTGTAATCCCAGCAACTCAGGGTGCCTTTAATCCCAGCAACTGAGGGTACCAGTAATCCCAGCAACTCAGGGTGTCTTTAATCCTAGCAACTGAGGGCACCTGTAATCCCAGCAACTCAGGAAGCTGAGACAGGAGAAGTACTTGAACCCAGAAGGCAGAGGTTGCAGTGAGCCGATATTGCACCATTGCACTCCAGTCTGGGCAACAAGAGTGAAACTCTGTCTCAAAAAAAAA"
"chr19","8026835","8027736","JH378118","18053084","18053501","522","10026249","GCGCGGTGGCTCATGCCTGTAAACCCAGCACTTTGGGAGGCTGAGGTGGGTGGATCACCTGAGGTCAGGAGTTTGAGACCAGCCTGGCCAATATGGTGAAACCCGTCTCTACTAAAACATACAAAAATTAGGCTGGGCGCGGTGGCTCATGCCTTTAATCCCAACACTTTGGGAGGCCGAGGCGGGCGGATCACGAGGTCAGGAGTTTGAGACCATCCTGGCTAACATGGTGAAAGCCCGTCTCTACTAAAAATATAAAAATTAGCTGGGCGTGGTGGTGGGCACCTGGAGTCCCAGCTACTTGGGAGGCTGAGGCAGGAGAATGGCGTGAACCCGGGAGGCGGAGCTTGCAGTGAGCCAGGATCACGCCACTGCACTCCAGCCTGGGCGACAGAGCGAGACACCGTCTCAAAAAAAAAACAACAAAAATTAGCCAGGCATGGTGGTGGGCGCCTTTTTTTTTTTTTTTTTCAGAGTCTCACTCTGTCACCCAGGCTGGAGTGCAGTGGCTCAATCTCGGTTCACTGCAACCTCCGCCTCCCAGGTTCAAGCGATTCTCCTGCCTCAGCCTCCCGAATAACTGGGATTACAGGCACCCGCCACTACAACCAGCTAATTTTTGTATTTTTAGTAGAGATGGGGTTTCGCCATGTTGGCCAGGATGGTCTTGATCTCTTGACCTCGTGATCCACCCTCCTTGGCCTCTCAAAGTGCTGGGATTACAGGTGTGAGCCACTGTTCCCAGCTGATAGTGGGCACTTTTAATCCCAGCTACTCCGGAGGCTGAGGCAGGAGAATTGCTTGAACCCAGGAGGTGGAGGTTGCAGTGAGCCAAGATCGCGCCATTGCACTCCAGCCTGGGTGACAATAGCAAAACTCTGTCTCAATGAAACAAAACAAAA","GGCTGGGCGCAGTGGCTCACACCTGTAATCCCAGCACTTAGGGAAGCTGAGGCGAGTAGATCACCTGAGGTCAGGAGTTAGAGACCAGCCTGGCCATCATGGTGAAACCCCGTCTCTACTAAAGATACCAAAAATTAGCTGAGTGTGGTGCTGGGTGCCTGTAATCCCAGAAACTCAGGGTGCCTGTAATCCCAGCAACTCAGGGTGCCTTTAATCCCAGCAACTGAGGGTACCAGTAATCCCAGCAACTCAGGGTGTCTTTAATCCTAGCAACTGAGGGCACCTGTAATCCCAGCAACTCAGGAAGCTGAGACAGGAGAAGTACTTGAACCCAGAAGGCAGAGGTTGCAGTGAGCCGATATTGCACCATTGCACTCCAGTCTGGGCAACAAGAGTGAAACTCTGTCTCAAAAAAAAA"
"chr19","9069244","9069863","JH378118","18053084","18053501","266","8983840","GGCCGGGCACGGTGGCTCATTCCTGTAGTCTCTGTACTTTAGGAGGCTGAGGTGGGTGGATCACTTGAGGTCAGGAGTTCCAGACCAGTCTGGCCAAAATGGTGAAACCCCGTCTGTACTAAAAATACAAAAAAAAAGGCCGGGCGCGGTGGCTCACGCCTGTAATCCCAGCACTTTGGGAGGCTGAGGTGGGTGGATCACAAGGTCAGGAGATTGAGACCATCCTGGCTAACATGGTGAAACCCCGTCTCTACTAAAAATACAAAAAATTAGCTGAGTGTGGTAGCAGGCACCTGTAATCCCAGCTACTCAGGAGGCTGAGGTGGGAGAATGGCATGAACCCAGGAAGCAGAGCTTGCAGTGAGCTGAGATCATGCCACTGCACTCCAGCCTGGGTGACAGAGCGAGACTCCATCTCAAAAAAAAAAAATACAAAAAAATTAGCCAGGCGTAGTGGTGCATGCTTGTAGTCTCGGCTACTCAGGAGACTGACGCAGGAGAATCACTTGAACCCAGGAGGCGGAGGTTGCAGTGAGCCGAAATTATGCCATTGCACTCCAGCCTGGGAGACAAGAACAAAACTCTATCTCAAAAACCAACCAACCAAACAAACAAAAAAA","GGCTGGGCGCAGTGGCTCACACCTGTAATCCCAGCACTTAGGGAAGCTGAGGCGAGTAGATCACCTGAGGTCAGGAGTTAGAGACCAGCCTGGCCATCATGGTGAAACCCCGTCTCTACTAAAGATACCAAAAATTAGCTGAGTGTGGTGCTGGGTGCCTGTAATCCCAGAAACTCAGGGTGCCTGTAATCCCAGCAACTCAGGGTGCCTTTAATCCCAGCAACTGAGGGTACCAGTAATCCCAGCAACTCAGGGTGTCTTTAATCCTAGCAACTGAGGGCACCTGTAATCCCAGCAACTCAGGAAGCTGAGACAGGAGAAGTACTTGAACCCAGAAGGCAGAGGTTGCAGTGAGCCGATATTGCACCATTGCACTCCAGTCTGGGCAACAAGAGTGAAACTCTGTCTCAAAAAAAAA"
"chr19","9785992","9786608","JH378118","18053084","18053501","261","8267092","GGCCGGGAACGGTGGCTCACACCTATAATCCCAGCACTTTGGGAGGCCGAGGCAGGTGGATCACCTGAGGTCAGGAGTTCAAGACCAGCGTGGCCAACATAATGAAACCCCATCTTGGCCGGGTGCGGTGACTCACGCCTGTAATCCCAGCACTTTGGGAGGCCAAGGCGGGTGGATCACGAGGTCAGGGGATCGAGACCATCCTGGCTAACACAGTGAAACCCTGTCTCTACTAAAAATACAAAAAAATTAGCTGGGCATGGTGGCGGACGCCTGTAGTCCCAGCTACTCGGGAGGCTGAGGCAGGAGAATGGTGTGAACCTGGGAGGCAGAGCTTGCAGTGAGCCGAGATTGCGCCACTGCACTCCAGCTTGGGTGACAAAGTGAGACTCCATCTCAAAAAAAAAAAAAGAAACCCCATCTCTACTAAAAATACAAAAAATTTGCTGGGTGTGGTTGTGGGCACCTGTAATCCCAGCTACTTGGGAGGCTGAGGCAGGAGAATCACCTGAACCCAGGAGGCAGAGGTTGCAGTGAGCCGAAACAGTGCCATTGCACTCCAGCCTGGGCAACAAGAGTGAAACTCAATCTCAAAAAAAAAAAAAAAAGTACAAAAA","GGCTGGGCGCAGTGGCTCACACCTGTAATCCCAGCACTTAGGGAAGCTGAGGCGAGTAGATCACCTGAGGTCAGGAGTTAGAGACCAGCCTGGCCATCATGGTGAAACCCCGTCTCTACTAAAGATACCAAAAATTAGCTGAGTGTGGTGCTGGGTGCCTGTAATCCCAGAAACTCAGGGTGCCTGTAATCCCAGCAACTCAGGGTGCCTTTAATCCCAGCAACTGAGGGTACCAGTAATCCCAGCAACTCAGGGTGTCTTTAATCCTAGCAACTGAGGGCACCTGTAATCCCAGCAACTCAGGAAGCTGAGACAGGAGAAGTACTTGAACCCAGAAGGCAGAGGTTGCAGTGAGCCGATATTGCACCATTGCACTCCAGTCTGGGCAACAAGAGTGAAACTCTGTCTCAAAAAAAAA"
"chr19","9897689","9898264","JH378206","6546474","6546861","233","3351215","GCCAGGCACGGTGGCTCACACCTGTAATCCCAGCACTTTGGGAGGCCAAGGTGGGTGGATCACCTGAGGTCAGGAGTTCAAGACCAGCCTGACCAACATGGTGAAACCCAGGGCTCACACCTGTAATCCCAGCGCTTTGGGAGGCTGACGCGGGCAGATCACGAGGTCAGGAGATCGAGACCATCCTGGCTAACATGGTGAAACCCCGTCTCTACTAAAAATACAATAATTAGCTGGGCATGGTGGTGGGTGCCTGCAGTCCCAGCTACTTGGGAAGCTGAGGCAGGAGAATGGCGTGAACCCAGGAGGTGGAGCTCTCAGTGAGCTGAGATTGCATCACTGCACTTCCAGCCTGGGTGACAGAGCAAGACTCTGTCTCAAAAAAAAAAAAAAAAAAAAAAAAAATTAGCCAGGTGTGATGGCAGGCACCTGTAATCCCAGCTACTTAGGAGGCTGAGGCAGGAGAACCCAGGAGGCAGAGGTTGCAGTGAGCCAAGATCGCGCCATTGCACTCCAGCCTGGGTGACAAGAGCAAAATTCCATCTCAAAAAAAAAAAAAAAGAAGAAAAAGAAGAA","GGCCACACATGGTGGCTAACGCCTGTAATCCCAGCACTTTGGGAGGCCAAGTCGGGTGGATCATGAGGTCAGGAGACCAAGACCATCCTGGCCAAATGGTGAAACCCCGTCTCTACTAAAAATACAAAAATTAGCTGGGCATGGTGGCGTGTGCCTGTAATCCCAGCTACTCAGGAGGCTGAGGCAGGACAATTGCCTGAACCCAGGAGAATTAGCTGGGCATGGTGGCGTGTGCCTGTAATCCCAGCTACTCAGGAGGCTGAGGCAGGACAATTGCCTGAACCCAGGAGGCGAAGGTTGCGGTGAGCCGAGATTGTGCCATTGCACTCCAGCCTGGGTAACAAGAGCGACACTCTGTCTCAAAAAAAAAAAAAAAAAAAAAAAAAAA"
"chr19","10210761","10211695","JH378118","18053084","18053501","553","7842323","GGCCGGGTGTGGTGGCTCATGCCTGTAATCCCAGGCATGATTTGGGAGGCCGAGGGAGGCAGATCACCTGAGGTCAGGAGTTTTTTTGTTTTGTTTTGTTTTGTTTTTGAGACAGAGTCTTGTTCTGTTGCCCAGGCTGGAGTGCAATGATGTGATCTCGACTCACTACAACCTCCACCTCCTGAGTTCAAGCGATTCTGCTGCCTCAGCCTCCCGAGTAGCTGGCATTACAGGCATGTGCCACCAAGCCTGGCTAATTTTTGTATTTATAGTAGAGACGGGGGTTTCACCATGTTGATCAGGCTGGTGTCGAACTCCTGGCCTCAAGTGATCCGCTCGCCTTGGCCTCCCAAAATGCTGGGATTACAGATGTGAGCCACTGTGCCCAGCCAAGGTCAAGAGTTTGAAACCAGCCTGGCCAGCATGGTGAAACCCTATCTCTACTAAAAATACAAAATCAGTCCATGTGCCTAATTTTGGGATCACACCTGGGATCATGCCTGCAATCCCAGCACTTTGGGAGGCCAAGGCGGGTGGGTCATGAAGTCAGGAGTTCAAGACCAGCCTGGCCAACATGGTGAAACCCTGTCTCTACTAAAAATACAAAAGTTAGCTGGGCGTGGTGGCACGCACCTGTAGTCCCAGCTACTAGGAAGGCTGAGGCAGGAGAATTCTTGAACCCGGGTGATGGAGGTTGCAGTGAGCCGAGATTGCGCCACTGCACTCCAGCCTGGGCAACAGAGTGAGACTCTGTCTAAAAAAAAAATTAGTCAGGCGTGGTGGTGAGCACCTGTAATCACAGCTACTGGGGAGGCTGAGGCTGGAGAATTGCTTGAACCCGGGAGGCGGAGGTTGCAGTGAGCCAAGATCGCGCCTTTGCACTCCAGCCTGGGCAACAGGAGTGAAACTGCATCTCAAAAAAAAAAAAAAAAAAA","GGCTGGGCGCAGTGGCTCACACCTGTAATCCCAGCACTTAGGGAAGCTGAGGCGAGTAGATCACCTGAGGTCAGGAGTTAGAGACCAGCCTGGCCATCATGGTGAAACCCCGTCTCTACTAAAGATACCAAAAATTAGCTGAGTGTGGTGCTGGGTGCCTGTAATCCCAGAAACTCAGGGTGCCTGTAATCCCAGCAACTCAGGGTGCCTTTAATCCCAGCAACTGAGGGTACCAGTAATCCCAGCAACTCAGGGTGTCTTTAATCCTAGCAACTGAGGGCACCTGTAATCCCAGCAACTCAGGAAGCTGAGACAGGAGAAGTACTTGAACCCAGAAGGCAGAGGTTGCAGTGAGCCGATATTGCACCATTGCACTCCAGTCTGGGCAACAAGAGTGAAACTCTGTCTCAAAAAAAAA"
"chr19","10485431","10486007","JH378118","18053084","18053501","237","7567653","GGCCGGGCGCAGTGGCTCATGCCTAATCCCAAGACTTTCAGAGGCTGAGGCAGGTGGATCACCTGAGGTCAGGAGCTCAAGACCAGCCTGGCTAACATTGTGAAACCGCGTCTCTACTAAAAATCAAAATTGGCCGGGCACGGTGGCTCACACCTGTAATCCCATCCCTCTGGGAGACCGAGGCGGGCAGATCACCTAAGGTCAGGAGTTCGAGACCAGCCTGACCAACATGGAGAAAACCCTTCTCTGCTAAAAATACAAAATTAGCCGGGCGTGGTGGCGCATGCCTGTAACCTCAGCTACTCGGGAGGCTGAGGGAAAATCGCTTGAACCTGCCAGGTGGAGGTTGCAGTGAGCCGAGATCGAGCCATTGCACTCCAGCATGGGCAACGAAAGCGAAACTCCATCTCAAAAAAAAAAAAAATTAGCTAGGCGTGGTGGCGCGTGCCTGTATTCCCAGCTACTCAGGAGGCTGAGACAGGAGAATCACTTGAACCTGGGAGGCAGAGGTTGCAGTGAGCCAAGATTGCACCATTGCACTCCAGCCTGGGCAACACGAGCAAAACTCTGTCTCAAA","GGCTGGGCGCAGTGGCTCACACCTGTAATCCCAGCACTTAGGGAAGCTGAGGCGAGTAGATCACCTGAGGTCAGGAGTTAGAGACCAGCCTGGCCATCATGGTGAAACCCCGTCTCTACTAAAGATACCAAAAATTAGCTGAGTGTGGTGCTGGGTGCCTGTAATCCCAGAAACTCAGGGTGCCTGTAATCCCAGCAACTCAGGGTGCCTTTAATCCCAGCAACTGAGGGTACCAGTAATCCCAGCAACTCAGGGTGTCTTTAATCCTAGCAACTGAGGGCACCTGTAATCCCAGCAACTCAGGAAGCTGAGACAGGAGAAGTACTTGAACCCAGAAGGCAGAGGTTGCAGTGAGCCGATATTGCACCATTGCACTCCAGTCTGGGCAACAAGAGTGAAACTCTGTCTCAAAAAAAAA"
"chr19","10538873","10539199","JH378118","15020968","15021286","46","4482095","GCTGGGCGCGGTGGCTCACGCCTGTAATCCCAGCACTTTGGGAGGCTGAGGCAGGCAGATCACCTGAGGTCAGGAGTTCAAGACCAGCCTGGTTAACACAGTGAAACCCCCGTCTCTACTAAAAATACAAAAACAAAAATTAGCCGGGTGTGGTGGCGGGCGCCTGTAATCCCAGTTACTCGGGAGGCTGAGGCAGGAGAATCGCTTGAACCCGGGAGGCGGAGGTTGTGGTGAGCCGAGATTGCCATTGCACTCCAGCCTGGGCAAAAAGAGCGAAACTCCATCTAAAACAAACAAACAAACAAACAAACAAAAAATAGAAAAGAA","GCCGGGCGCGGTGGCTCAAGCCTGTAATCCCAGCACTTTGGGAGGCTGAGGCGGGTGGATCCCGAGGTCAAGAGATCGAGACCATCCTGGTCAACATGGTGAAACCCCGTCTCTACTAAAAATACAAAACATTAGCTGGGTATGGTGGCGCGTGCCTGTAATCCCAGCTACTCAGGAGGCTGAGGCAGGAGAATTGCCTGAACCCAGGAGGCGGAGGTTGCGGTGAGCTGAGATCGCGCCATTGCACTCCAGCCTGGGTAACAAGAGCGAAACTTCCATCTCAAAAACAAACAAACAAACAAACAAACAAAAAACAAAC"
"chr19","10973032","10973651","JH378118","18053084","18053501","265","7080052","GGCTGGACGTGGTGGCTCACGCCTGTAATCCCAACACTTTGGGAGACCAAGGCAGGTGGATCGCCTGAGGTTAGGGGTTCGAGACCAGCCTGACCAACATGGTGAAACCCCATCTCTACTAATAATAAAAAAATTAGGACCAGGCTTGGTGGCTCATGCCTGTAATTCCAACACTTTGGGAGGCCAAGGCGAGTGGATAACTTGAGGTCAGGAGTTTGAGACCAGCCTGGCCAACATGGTGAAACCTCATCTCTACTAAAAATACAAAAATTAGCCGGCATGGTGGCGGGCACCCGTAATCCCAGCTACTCGGTGTGGGGGCTGGGACAGGAGAATCGCTTGAACCCAGGAGGTGGAGGTTGCCGTGAGCTAAGATTGCGCCACTGCACTCTAGTTGGGGCAACAGAGCGGACTCCGTCTCAAAAAAAAAAAAAAAATTAGCCGAGCGTGGTGGTGGACACCTGTAATCCCAGCTACTCAGGAGGCTGAGGCAGGAAAATTGAAATCGCTTAAACCTGGGAGGAGGAGGTTGCAGTGAGCCAAGATCGCACCATTGCACTCCAGCCTGGGCGACAAGAACAAAACTCCGTCTCCCCACTCCAAAAAAAAAAAAAAAAAAA","GGCTGGGCGCAGTGGCTCACACCTGTAATCCCAGCACTTAGGGAAGCTGAGGCGAGTAGATCACCTGAGGTCAGGAGTTAGAGACCAGCCTGGCCATCATGGTGAAACCCCGTCTCTACTAAAGATACCAAAAATTAGCTGAGTGTGGTGCTGGGTGCCTGTAATCCCAGAAACTCAGGGTGCCTGTAATCCCAGCAACTCAGGGTGCCTTTAATCCCAGCAACTGAGGGTACCAGTAATCCCAGCAACTCAGGGTGTCTTTAATCCTAGCAACTGAGGGCACCTGTAATCCCAGCAACTCAGGAAGCTGAGACAGGAGAAGTACTTGAACCCAGAAGGCAGAGGTTGCAGTGAGCCGATATTGCACCATTGCACTCCAGTCTGGGCAACAAGAGTGAAACTCTGTCTCAAAAAAAAA"
"chr19","11513769","11514351","JH378206","6546474","6546861","242","4967295","TCCCAGCACTTTGGGAGGCCGCGATGGGTGGATCACCTTAGGTCAGGAATTCGAGACCATCCTGGCCAACATGGTGAAACCCCGTCTCTACTAAAAACACAAAAATTAGGCCGGGCACGGTGGCTCACATCTGTAATCCCAGCACTTTGGGAGGCTGAGGTGGGCGGATCACAAGGTCAGGAGTTCAAGACCAGCCTGGCCAACATGGTGAAACCCTGTCTCTACTAAAAATACAAAAATTAACTGGGCATGGTGGCATGTGCCTGTAATCCCAGCTACTTGGGAGGCTGAGGCAGAAGAATTGCTTGAACCAGGGAGTCAGAGGTTATAGTGAGCTGAGATCGTGCGACTGCACTCCAGCCTGGTGACAGAGCGAGACTCCGTTTCAGGAAAAACAAACAAAACACAAAAATTAGCTGGGCATGGTGGCAGGCGCCTGTAATCCTAGCTACTTGGGAGGCTGAGGCAGGAGAATCGCTTGAACCCAGAAGGCAAAGGTTGCAGTGAGCTGAGATGATGCCATTGCACTCCAGCCTGGGCAACAAGTGAAACTCTGTCTCAAGAAAAAAAGTAAAAGAAAGAA","GGCCACACATGGTGGCTAACGCCTGTAATCCCAGCACTTTGGGAGGCCAAGTCGGGTGGATCATGAGGTCAGGAGACCAAGACCATCCTGGCCAAATGGTGAAACCCCGTCTCTACTAAAAATACAAAAATTAGCTGGGCATGGTGGCGTGTGCCTGTAATCCCAGCTACTCAGGAGGCTGAGGCAGGACAATTGCCTGAACCCAGGAGAATTAGCTGGGCATGGTGGCGTGTGCCTGTAATCCCAGCTACTCAGGAGGCTGAGGCAGGACAATTGCCTGAACCCAGGAGGCGAAGGTTGCGGTGAGCCGAGATTGTGCCATTGCACTCCAGCCTGGGTAACAAGAGCGACACTCTGTCTCAAAAAAAAAAAAAAAAAAAAAAAAAAA"
"chr19","11535200","11535780","JH378206","6546474","6546861","242","4988726","TCCCAGCACTTTGGGAGGCCGCGATGGGTGGATCACCTTAGGTCAGGAATTCGAGACCATCCTGGCCAACATGGTGAAACCCCGTCTCTACTAAAAACACAAAAATTAGGCCGGGCACGGTGGCTCACATTGTAATCCCAGCACTTTGGGAGGCTGAGGTGGGCGGATCACAAGGTCAGGAGTTCAAGACCAGCCTGGCCAACATGGTGAAACCCTGTCTCTACTAAAAATACAAAAATTAACTGGGCATGGTGGCATGTGCCTGTAATCCCAGCTACTTGGGAGGCTGAGGCAGAAGAATTGCTTGAACCAGGGAGTCAGAGGTTATAGTGAGCTGAGATCGTGCGACTGCACTCCAGCCTGGTGACAGAGCGAGACTCCGTTTCAGGAAAAACAAACAAAACACAAAAATTAGCTGGCATGGTGGCAGGCGCCTGTAATCCTAGCTACTTGGAGGCTGAGGCAGGAGAATCGCTTGAAACCCAGAAGGCAAAGGTTGCAGTGAGCTGAGATGATGCCATTGCACTCCAGCCTGGGCAACAAGTGAAACTCTGTCTCAAGAAAAAAAGTAAAAGAAAGAA","GGCCACACATGGTGGCTAACGCCTGTAATCCCAGCACTTTGGGAGGCCAAGTCGGGTGGATCATGAGGTCAGGAGACCAAGACCATCCTGGCCAAATGGTGAAACCCCGTCTCTACTAAAAATACAAAAATTAGCTGGGCATGGTGGCGTGTGCCTGTAATCCCAGCTACTCAGGAGGCTGAGGCAGGACAATTGCCTGAACCCAGGAGAATTAGCTGGGCATGGTGGCGTGTGCCTGTAATCCCAGCTACTCAGGAGGCTGAGGCAGGACAATTGCCTGAACCCAGGAGGCGAAGGTTGCGGTGAGCCGAGATTGTGCCATTGCACTCCAGCCTGGGTAACAAGAGCGACACTCTGTCTCAAAAAAAAAAAAAAAAAAAAAAAAAAA"
"chr19","12911527","12912140","JH378118","18053084","18053501","266","5141557","GGCCAGGCATGGTGGCTCATGCCTGTAATCCAGCACTTTGGTAGGCCAAGGTGGGTGGATGGATTACTTGAGGCCAGGAGTTCAAGACCAACCTGGCCAACATGGTGAAAACCCATCTCTATTAAAAATATAAAAGCTAGGCCAGGTGCGGTGGCTCACGCCTGTAATCCCAGCACTTTGGGAGGCTGAGGCGGGCGGATCACGAGGTCAGGAGATCGAGACCACTGTGAAACCCTGTCTCTACTAAAAATACAAAAAAAATTAGCTGGGTGGGGTGGCGGGTGCCTGTAGTCCCAGCTACTTGGGAGGCTGAGGCAGGAGAATGGCGTGAACCCGGGAGGCGGAGCTTGCAGTGAGCCGAGATCGCGCCACTGCACTCCAGCCTGGGCTACAGAGCAAGACTCCGTCTCAAAAAAAAAATAAATAAATAAATAAAAATAAAAACTAACTGGGCATGGTGGTGTGCACCTGTAATCCCAGCTACTCGGGAGGCTGAGACAGGAGAATTGCTTGAACCTGGGAGGTGGAGGTTGCAGTGAACCAAGATGATGCCATTGCACTCCAACCTGGGCAACAAGAGCAAAACTCCGTCTCAAAAAAAAAAAAAAAAAAAA","GGCTGGGCGCAGTGGCTCACACCTGTAATCCCAGCACTTAGGGAAGCTGAGGCGAGTAGATCACCTGAGGTCAGGAGTTAGAGACCAGCCTGGCCATCATGGTGAAACCCCGTCTCTACTAAAGATACCAAAAATTAGCTGAGTGTGGTGCTGGGTGCCTGTAATCCCAGAAACTCAGGGTGCCTGTAATCCCAGCAACTCAGGGTGCCTTTAATCCCAGCAACTGAGGGTACCAGTAATCCCAGCAACTCAGGGTGTCTTTAATCCTAGCAACTGAGGGCACCTGTAATCCCAGCAACTCAGGAAGCTGAGACAGGAGAAGTACTTGAACCCAGAAGGCAGAGGTTGCAGTGAGCCGATATTGCACCATTGCACTCCAGTCTGGGCAACAAGAGTGAAACTCTGTCTCAAAAAAAAA"
"chr19","13205284","13205895","JH378118","18053084","18053501","258","4847800","GCCAGGCGCAGTGGATTACGCCTGTAATCCCAGCGCTTTGGTATACCGAGGCGGGCAGATCGTCTGAGGTCAGGAGTTCAAGACCAGCCTGGAGAACATGGTGAAACCCCGTCTCTATTAAAAATACAGGCTGGGCGCGGTGGCTTACGCCTGTAATCTCAGCACTTTGGGAGGCCAAGGCGGGTGGATCACGAGGTCAGGAGATCGAGACCATCCTGGCTAACATGGTGAAACCCTGTCTCTACTGAAAATACAAAAAAATTAGTTGTGGTGGGTGCCTGTAATCCCAGCTACTCGGGAGGCTGAGGCAGGAGAATGGCGTGAACCCGGGAAGCAGAGATTGCAGTAAGCCAAGATCGCTCCACTGCACTCCAGCCTGGGCTACAGAGCAAGACTCCATCTCAAAAAAAAATAAATAAATAAAATAAAAAATTAGCCTGGCGTGGTGGCGCATGCCTGTAATCCCAGCTACTTGGGAGGCTGAGGCAGGAGAATTGCTTGAACCCAAGAGGTGGAGGTTGCAGTGAGTCGAGATTGAGCCATTGCCATCCAGCCTGGGCAACAAGAGTGAAACTCTGTCTCAAAAAAAAAGAGAGAGAAAAGAAAGTAAAA","GGCTGGGCGCAGTGGCTCACACCTGTAATCCCAGCACTTAGGGAAGCTGAGGCGAGTAGATCACCTGAGGTCAGGAGTTAGAGACCAGCCTGGCCATCATGGTGAAACCCCGTCTCTACTAAAGATACCAAAAATTAGCTGAGTGTGGTGCTGGGTGCCTGTAATCCCAGAAACTCAGGGTGCCTGTAATCCCAGCAACTCAGGGTGCCTTTAATCCCAGCAACTGAGGGTACCAGTAATCCCAGCAACTCAGGGTGTCTTTAATCCTAGCAACTGAGGGCACCTGTAATCCCAGCAACTCAGGAAGCTGAGACAGGAGAAGTACTTGAACCCAGAAGGCAGAGGTTGCAGTGAGCCGATATTGCACCATTGCACTCCAGTCTGGGCAACAAGAGTGAAACTCTGTCTCAAAAAAAAA"
"chr19","14119695","14120238","JH378206","6546474","6546861","206","7573221","ACCAGCCTGGCCAAAATGGTGAAACCCTGTCTCTACTAAAAATATTTAAAAATTGGCCAGGTGCGGTGGCTCACGCCTGTAATCCCAGCACTTTGGGAGGCCGAGGCGGGCGGATTACAAGGTCAGGAGATCGAGACCATCCTGACTAACATGGTGAAACCCCGTCTCTACTAAAAATACAAAAAATTGGCCGGGCGTGGTAGCGGGCGCCTGTAGTTCCAGCTACTCGGGAGGCTGAGGCAGGAGAATGGCGTGAACCCGGAAGGCAGAGCTTGCAGTGAGCCAAGATCGTGCCACTGCACTCCAGCCTGAGCGACAGAGCAAGACTCCATCTCAAAAAAAAAAAAAAAAAAAAAAAAAATTAAAAAATTAGCTGGGCGTGGTAGCCGGCACCTGTAATTCCAGCTACTCAGGAGGCTGGAGCACAAGAATCGCTTGAAACCAGGAGGCAGAGTTGTAGTGAGCCGAGATCGTGCCATTGCACTCCAGCCTGGGCATCAAGAGCGAAACTCCATCTCAAAAACAAAACAAAACAAAACAAAAA","GGCCACACATGGTGGCTAACGCCTGTAATCCCAGCACTTTGGGAGGCCAAGTCGGGTGGATCATGAGGTCAGGAGACCAAGACCATCCTGGCCAAATGGTGAAACCCCGTCTCTACTAAAAATACAAAAATTAGCTGGGCATGGTGGCGTGTGCCTGTAATCCCAGCTACTCAGGAGGCTGAGGCAGGACAATTGCCTGAACCCAGGAGAATTAGCTGGGCATGGTGGCGTGTGCCTGTAATCCCAGCTACTCAGGAGGCTGAGGCAGGACAATTGCCTGAACCCAGGAGGCGAAGGTTGCGGTGAGCCGAGATTGTGCCATTGCACTCCAGCCTGGGTAACAAGAGCGACACTCTGTCTCAAAAAAAAAAAAAAAAAAAAAAAAAAA"
"chr14","584088","584429","JH378109","21565230","21565567","54","20981142","GGCCGGGTACGGTGGCTCACGCCTGTAGTCCTGGCACTTTGGGAGGCCGAGGCAGGTGGATCCCCGAGGTCACGAGTTTGAGACCAGCCTGGCCAGCATGGTGAAATCCCATCTCTACTAAAAATACAAAACTTAGCCGGGCATGGTGACGTGTGCCTGTAATCCCAGCTACTTGGGAGGCTGAGGCAGGAGAATTGCTTGAACCAGGGAGGCAGAGGTTGCAGTGAGCTGAGATCATGAAACTGCAGTCCAGTCTAGGCGACAAGAGCAAAACTCCGTCTCAAAAAAATAAATAAATAAATAAATAAATAAAAAATAAAACAAACAACAAAAAAAACAAAA","GGCCGGGCGCGGTGGCTCAAGCCTGTAATACCAGCACTTTGGGAGGCCGAGGCGGGTGGATCACGAGGTCAAGAGATCGAGACCATCCTGGTCAACATGGTGAAACCCCGTCTCTACTAAAAATACAAACAATTAGCTGGGCATGGTGGCGGGTGCCTGTAATCCCAGCTACTCCAGAGGCTGAGGCAGGAGAATTGCCTGAACCCAGGAGACGGAGGTTGCGGTGAGCCAAGATCGCGCCATTGCACTCCAGCCTGGGTGACAAGAGCGAAACTCCGTCTCAATAAATAAATAAATAAATAAATAAATAAAAATAAAATAAATAAATAAATAAATAA"
"chr14","620575","620915","JH378109","21565230","21565567","56","20944655","GGCCGGGTACGGTGGCTCACGCCTGTAGTCCTGGCACTTTGGGAGGCCGAGGCAGGTGGATCCCCGAGGTCACGAGTTTGAGACCAGCCTGGCCAGCATGGTGAAATCCCATCTCTACTAAAAATACAAAACTTAGCCGGGCATGGTGACGTGTGCCTGTAATCCAGCTAACTTGGGAGGCTGAGGCAGGAGAATTGCTTGAACCAGGGAGGCAGAGGTTGCAGTGAGCTGAGATCATGAAACTGCAGTCCAGTCTAGGCGACAAGAGCAAAACTCCGTCTCAAAAAATAAATAAATAAATAAATAAATAAAAAATAAAACAAACAACAAACAAAACAAAA","GGCCGGGCGCGGTGGCTCAAGCCTGTAATACCAGCACTTTGGGAGGCCGAGGCGGGTGGATCACGAGGTCAAGAGATCGAGACCATCCTGGTCAACATGGTGAAACCCCGTCTCTACTAAAAATACAAACAATTAGCTGGGCATGGTGGCGGGTGCCTGTAATCCCAGCTACTCCAGAGGCTGAGGCAGGAGAATTGCCTGAACCCAGGAGACGGAGGTTGCGGTGAGCCAAGATCGCGCCATTGCACTCCAGCCTGGGTGACAAGAGCGAAACTCCGTCTCAATAAATAAATAAATAAATAAATAAATAAAAATAAAATAAATAAATAAATAAATAA"
"chr14","1107083","1107723","JH378118","18053084","18053501","303","16946001","GGCGTGGTGGCTCACACCTGTAATCCCAGCACTTCAGGAGGCCAAGGCAGGTAGATTGCTTGATCACAGGAGTTCAAACCAGCCATGGGCAATGTCAGGCCTCTGAGCCCAAGCTTGCACGTATCCAGATGGCCTGAAGCAACTGAAGAATCACAAAAGAAGTGAAAACAGCCAGTTCCTTCCTTAACTGATGACATTACCTTGTGAAATTCCTTCTCCTGGCTCAGAAGCTCCCCTACTGAGCACCTTGTGACCCCTGCCCCTGCCAGCCAGAGAACAATCCCCTTTGACTGTAATTTTCCACTACCTACCCAAATCCTATAAAACAGCCCCACCCCATCTCCCTTTGCTGACTCCTTTTTCGGACTAGGTCCGCCTGCACCCAGGTGATTAAAAAGCTTTATTGCTCACACAAAGCCTGTTGGTGGTCTCTTCACACGGACGCACGTGACAGGCAACATGGTGAAACCCTATCTCTATAAAAAAATAAAAATAAAAATTAGTTGGGCGTGGAGACTGAGGTGAGAGAATCCAGAGGATCCAAGAGGATCGAGTCAAGGAGGTGGAGGCCGCAGTGAGCCGAGATCGCACCGCTGCACTCCAGCCTGGGCGACAAGAGTGAAACTCTGTCTTAAAAAAAA","GGCTGGGCGCAGTGGCTCACACCTGTAATCCCAGCACTTAGGGAAGCTGAGGCGAGTAGATCACCTGAGGTCAGGAGTTAGAGACCAGCCTGGCCATCATGGTGAAACCCCGTCTCTACTAAAGATACCAAAAATTAGCTGAGTGTGGTGCTGGGTGCCTGTAATCCCAGAAACTCAGGGTGCCTGTAATCCCAGCAACTCAGGGTGCCTTTAATCCCAGCAACTGAGGGTACCAGTAATCCCAGCAACTCAGGGTGTCTTTAATCCTAGCAACTGAGGGCACCTGTAATCCCAGCAACTCAGGAAGCTGAGACAGGAGAAGTACTTGAACCCAGAAGGCAGAGGTTGCAGTGAGCCGATATTGCACCATTGCACTCCAGTCTGGGCAACAAGAGTGAAACTCTGTCTCAAAAAAAAA"
"chr14","1362660","1363231","JH378118","18053084","18053501","229","16690424","GGCTGGGCACAGTGGCTTATACCCATAATCTCAGCAGTTTGGGAGGCCAAGGCAGGTGTATCACCTGAGGTCAGGAGTTCGAGAAACACCATGGCCAACATGGTGAAACCCCATCTCTACTAAAAATACAAAAAGTAGGCTGGGCGTGGTGGCTCACGCCTGTAATCCCAGTACTTTGGGAGGCCGAGGCGGGCGGATCACAAGGTCAGGAAACCGAGACCATCCTGACTAACATGGTGAAACCCCGTCTCTACTAAAAATACAAAAAAAGCTAGCCGGGCATGGTGGCGGGTGCCTGTAGTCCCAGCTACTCGGGAGGCTGAGGCAGGAGAATGGCGTGACCCCAGGAGGCAGAGCTTCCAGCTTGGGTGACTCCGTCTCAAAAAAAAAAAAACAAAAACAAAAAGTAGCTGGACGTGGTGGCTGTAGACCTAGCTACTCGAGAGGCTGAGGCAGGAGAATCGCTTGAACCTAGGAGGCGGAGGTTGCGGTGAGCCGAGATCACGCTTCTGCACTCCAGCCTGGGTGACAAGAGCAAAACTCCATCTCCAAAAAAAAAAAACAAAAAAAAA","GGCTGGGCGCAGTGGCTCACACCTGTAATCCCAGCACTTAGGGAAGCTGAGGCGAGTAGATCACCTGAGGTCAGGAGTTAGAGACCAGCCTGGCCATCATGGTGAAACCCCGTCTCTACTAAAGATACCAAAAATTAGCTGAGTGTGGTGCTGGGTGCCTGTAATCCCAGAAACTCAGGGTGCCTGTAATCCCAGCAACTCAGGGTGCCTTTAATCCCAGCAACTGAGGGTACCAGTAATCCCAGCAACTCAGGGTGTCTTTAATCCTAGCAACTGAGGGCACCTGTAATCCCAGCAACTCAGGAAGCTGAGACAGGAGAAGTACTTGAACCCAGAAGGCAGAGGTTGCAGTGAGCCGATATTGCACCATTGCACTCCAGTCTGGGCAACAAGAGTGAAACTCTGTCTCAAAAAAAAA"
"chr14","2088506","2089110","JH378118","18053084","18053501","257","15964578","GGCTGGGCACTGCGGCTCACACCTGTAATCCCAGCATTTTGAGAGGCCTAGGTGGGTGGATCACCTGAGATCAGTTCAAGACCAGCCTGACCAACATGGCAAAACCCCATCTCTATTAAAAACACAAAAAACGCCCAGGAGCGGTGGCTCACACCTGTAATCCCGGCACTTTGGGAGGCTGAGGCAGGCGGATCACGAGGTCAGGAGATCGAGACCATGCTGGCTAACACGGTGAAACCCCGTCTCTACTAAAAATACAAAAAATTAGCCAGGCGTGGTGTCGGGCGCCTGTAGTCCCAGCTATTCGGGAGGCTGAGACAGGAGAATGGCATGAACCCGGGAGGCAGAGCTTGCAGTGAGCTGAGATCGCGCCACTGCACTCCAGCCTGGGCGACAGAGTAAGACTCTGTCTCAAAAAAAAAAATACAAAAAATACAAAAAACATTAGCCACATGTGGTGGTGGGTGCCTGTAATCCCAGCTACTCAGGAGGCTGAGGCTGGAGAATTGCTTGAACCCAGGAGGTGGAGGTTGTGGTGAGCCAAGATCACGCCATTGCATTCCAGCCTGGGTGACAAGAGTGAACCTCTGTCTCAAAAAAAAGAA","GGCTGGGCGCAGTGGCTCACACCTGTAATCCCAGCACTTAGGGAAGCTGAGGCGAGTAGATCACCTGAGGTCAGGAGTTAGAGACCAGCCTGGCCATCATGGTGAAACCCCGTCTCTACTAAAGATACCAAAAATTAGCTGAGTGTGGTGCTGGGTGCCTGTAATCCCAGAAACTCAGGGTGCCTGTAATCCCAGCAACTCAGGGTGCCTTTAATCCCAGCAACTGAGGGTACCAGTAATCCCAGCAACTCAGGGTGTCTTTAATCCTAGCAACTGAGGGCACCTGTAATCCCAGCAACTCAGGAAGCTGAGACAGGAGAAGTACTTGAACCCAGAAGGCAGAGGTTGCAGTGAGCCGATATTGCACCATTGCACTCCAGTCTGGGCAACAAGAGTGAAACTCTGTCTCAAAAAAAAA"
"chr14","2164771","2165383","JH378118","18053084","18053501","243","15888313","GGCTGGGCGCAGTGGCTCACACCTGTAATCCCAGCACTCTGGGAGGCCAAGGCAGGTGGATCACCTGAGGTCAGGAGTTCGAGACCAGCCTGGCCAACATGGTGAAACCCCATCTTTACTAAAAATACAAAAATTAGCTAGGCGTGAGGCCGGGCGTGGCGGCTCATGCCTGTAATCCCAGCACTATGGGAGGCTGAGGCAGGCTGATCATGAGGTCAGGAGATTGAGACCTGGCTAACACAGTGAAACCCCGTCTCTACTAAAAATACAAAAAAAAAATAGCCAGGCATGATGGCAGGCTCCTGTAGTCCCAGCTTCTTGGGAGGCTGAGGCAGGAGAATGGTGTGAACCCGGGAGGCAGAGCTTGCAGTGAGCCGAGATCATGCCACTGCACTCCAGCCTGGGTGACAGAGCAAGACTCTGTCTCAAAAAAAAAAAAAAAAAATTAGCTAGGCGTGGTGAGGGGCACCTGGAATCCCAGCTACTCAGGAGGCTGAGGCAGGAGCATCGTTTAAACCCAGGAGGCAGAGGTTGCAGTGAGCCGAAATCACACCATTGCACTCCAGCCTGGGCAACAAGAGCAAGTCTCCATCTTAAAAAAAAAAAAAAAAAA","GGCTGGGCGCAGTGGCTCACACCTGTAATCCCAGCACTTAGGGAAGCTGAGGCGAGTAGATCACCTGAGGTCAGGAGTTAGAGACCAGCCTGGCCATCATGGTGAAACCCCGTCTCTACTAAAGATACCAAAAATTAGCTGAGTGTGGTGCTGGGTGCCTGTAATCCCAGAAACTCAGGGTGCCTGTAATCCCAGCAACTCAGGGTGCCTTTAATCCCAGCAACTGAGGGTACCAGTAATCCCAGCAACTCAGGGTGTCTTTAATCCTAGCAACTGAGGGCACCTGTAATCCCAGCAACTCAGGAAGCTGAGACAGGAGAAGTACTTGAACCCAGAAGGCAGAGGTTGCAGTGAGCCGATATTGCACCATTGCACTCCAGTCTGGGCAACAAGAGTGAAACTCTGTCTCAAAAAAAAA"
"chr14","3757666","3758004","JH378113","23438980","23439304","67","19681314","CTGGGCATGGTGGCTCATGCCTGTAATCCCAGCACTTTGGGAGACAGAGGAGGGCAGATCATCTGAGGTCAGGAGTTTGAGACCAGCCTGGCCACCATGGTGAAACCCCCGTCTCTACTGAAAATACAAAAAAATTCAGCTGGGTGTGGTAGTGGATGTCTGTAATCCTAGCTGCTTGGGAGGCTGAGACAGGAGAATCGCTTGAACCCGGGAGGTGGAGGTTGCAGTGAGCCGCCATTGCGCTCCAGCCTGGGCAACAAGAGCGAAACTCCATCTCAAAAATTAATTAATTAATTAATTAATTAAAAGTGGACTAAAGCAAAGACAAGAGAAAAAAGA","GGCAGGGTGTGGTAGCTCATGCTTGTAATCCCAGCACTTTGGGAAGTGGAGGCGGGCAGATCATCTGAGGTCAGGAGTTTGAGGCCAGCCTGGCCAACATGGTGAAACCCTGTCTCTACTAAAAATACAAAAAATTAACTGGGCGTGGTGGTGGACACCTGTAATCCCAGCTGCTTGGGAGGCTGAGGCAGGAGAATCGCTTGAACCCAGGAGATGGAGGTTGCAGTGAGCCAAGATGGCACCATTGCACTCTAGCCTGGGCAAAAAGAGTGAAACTCCGTCTCAAAAAAAAAAAAGAAAAGAAAAGAAAAGAAAAGAAAAGAAA"
"chr14","10702105","10702681","JH378118","18053084","18053501","246","7350979","GGCCAGGCGCAATGGCTCACACCTGTAATCCAAGCACTTTGGGAGGCCAGTTCAAGACCAGCCTGGCCAACATGGTGAAAACCTGTCTCTGCTAAAAATGCCAAATTTCCCAGCACTTTGGGAGGCTGAGGCGGGTGGATCACGAGGTCAGGAGATTGAGACCATCCCGGCTAACACGGTGAAACCCCATCTCTACTAAAAATAGAAAAAAATTAGCCGGGCGTGGTGGCAGACGCCTGTAGTCCCAGCTACTCTGGAGGCTGAGGGAAGAGAATGGCATAAACCCGGGAGGCGGAGCTTGCAGCGAGCTGAGATTGCGCCACTGCACTCCAGCCTGGGCGACAGAGCAAGACTCCGTCTCAAAATAAATAAATAAATAAAATTAAAATTAAAAATAAAATACAAAATTTAGCCGAGCATGGTGGTGAGCACCTATAATCCCAGCTACTTGGGAGGCTGAGGCAGAAGAATCTCTTGAACCAGGGAAGTGGAGGTTGCAGTGGGCTGAGATCCAGCCACTGTACTCCAGCCTGGGCGACAAAAGCGAAACACTGTCTAAAAAAATAAAAAATAAAAA","GGCTGGGCGCAGTGGCTCACACCTGTAATCCCAGCACTTAGGGAAGCTGAGGCGAGTAGATCACCTGAGGTCAGGAGTTAGAGACCAGCCTGGCCATCATGGTGAAACCCCGTCTCTACTAAAGATACCAAAAATTAGCTGAGTGTGGTGCTGGGTGCCTGTAATCCCAGAAACTCAGGGTGCCTGTAATCCCAGCAACTCAGGGTGCCTTTAATCCCAGCAACTGAGGGTACCAGTAATCCCAGCAACTCAGGGTGTCTTTAATCCTAGCAACTGAGGGCACCTGTAATCCCAGCAACTCAGGAAGCTGAGACAGGAGAAGTACTTGAACCCAGAAGGCAGAGGTTGCAGTGAGCCGATATTGCACCATTGCACTCCAGTCTGGGCAACAAGAGTGAAACTCTGTCTCAAAAAAAAA"
"chr14","11790883","11791455","JH378118","18053084","18053501","226","6262201","GGCTGGGTGGCCATGGCTCATGCCTGTAATCCTAGAACTTTGGGAGGCTGCGGCAGGCAAATCACCTGAAGTCAGGAGTTCAAGACCAGCCTGGCCAACATACTGAAACCCCGTCTCTCCAGGCCTGGTGGCTCATGCCTGTAATCCCAGCACTTTGGAAAGCCGAGGTGGGCGGATCACCTGAGGTCAGGAGTTCAAGACCAGTCTGACCAACATGGGGAAACCCCATCTCTACTAAAAATACAAAATTAGCTGGATGTGGTGGCACATGCCTGTATTCCCAGCTACTTGGGAGGCTGAGGCAGGAGAATCGCTTGATCCCGAGAGGTGGAGCTTGCCGTGAGCTGAGATTGTGCGCCATTGCACTCCAGCCTGGGCAACAAGAGTGAAACTCCGTCTCTACTAAAAATACAAAAATTAGCCGGGTGTGGTGGCGGGTGCCTGTAATCCAAGCTACTCGGGAGGCTAAGGCAGGAGAATTGCTTGAACCCACGAGGCCGAGGTTGCAGTGAGCCGAGATTGCACTATTGCACTCCAGCCTGGGCGACAAGAGTGAGACTGTGTCTCAAAAAA","GGCTGGGCGCAGTGGCTCACACCTGTAATCCCAGCACTTAGGGAAGCTGAGGCGAGTAGATCACCTGAGGTCAGGAGTTAGAGACCAGCCTGGCCATCATGGTGAAACCCCGTCTCTACTAAAGATACCAAAAATTAGCTGAGTGTGGTGCTGGGTGCCTGTAATCCCAGAAACTCAGGGTGCCTGTAATCCCAGCAACTCAGGGTGCCTTTAATCCCAGCAACTGAGGGTACCAGTAATCCCAGCAACTCAGGGTGTCTTTAATCCTAGCAACTGAGGGCACCTGTAATCCCAGCAACTCAGGAAGCTGAGACAGGAGAAGTACTTGAACCCAGAAGGCAGAGGTTGCAGTGAGCCGATATTGCACCATTGCACTCCAGTCTGGGCAACAAGAGTGAAACTCTGTCTCAAAAAAAAA"
"chr14","12236526","12237360","JH378118","18053084","18053501","465","5816558","GGCTGGGTGGGGTGGCTCACGCGTGTAATCCCAACACTTTTGAGGCTGAGGTGGGTGGATCACTTGAGGTCCGGAGTTTGAGACCAGCCTGGTCAACATGGTGAAACCCCATGTCTCAGGATGGGGAACATCACATACCGGGGCCTGTCGTGGGGTGTGGGGAGGGGAAGGGATAGCATTAGGAGATATACCTAATGTAAATGACAAGTTAATGGGTGCAGCACACCAACATGGCACATGTATACATATGTAACAAACCTGCATGTTGTGCACATGTACCCTAGAACTTAAAGTATAGCAATAAAAAAAAAAAAAGAAACCCCGTGTCTACAAAAAAAATACAAAATTAGGCCAGGCGCAGTGGCACATACCTGTAATCCCAGCACTTTGGGAGGCCAAGGTGGGCAGATCACGAGGTCAGGAGTTTGAGACCAGCCTGTCCAAAATGGTGAAACCCCATCTCTACTAAAAAAATACAAAAATTAGCCAGGCATGGTGGCCCGTGCCTGCAATCCCAGCTACTCAGGAGGCTAAGGCAGGAGAATCACTTGAACGTGGGAGGCGGAGGTTGCAGTGAGCCGAGATCACACCATTGCACTCCAGCCTAGGCAACAGAGCGAGACTCTGTCTCAAAAAAACAAAAAGCAAAAAAACCCAAATTAGCCAGGCATGGTGGTAGTCACCTGTAATCCCAGCTACTTGGGAGGCTTAGGCAGGAGAATCGCTTGAACCCCAGAGGCAGAGGTTGCAGTAAGCCAAGATCGCACCAAGATCACTCCAGCCTGGGCGACAGTGAAACTGTGTCTCAAAAGAAAAAGAAAAAAAAGAAAGAAAA","GGCTGGGCGCAGTGGCTCACACCTGTAATCCCAGCACTTAGGGAAGCTGAGGCGAGTAGATCACCTGAGGTCAGGAGTTAGAGACCAGCCTGGCCATCATGGTGAAACCCCGTCTCTACTAAAGATACCAAAAATTAGCTGAGTGTGGTGCTGGGTGCCTGTAATCCCAGAAACTCAGGGTGCCTGTAATCCCAGCAACTCAGGGTGCCTTTAATCCCAGCAACTGAGGGTACCAGTAATCCCAGCAACTCAGGGTGTCTTTAATCCTAGCAACTGAGGGCACCTGTAATCCCAGCAACTCAGGAAGCTGAGACAGGAGAAGTACTTGAACCCAGAAGGCAGAGGTTGCAGTGAGCCGATATTGCACCATTGCACTCCAGTCTGGGCAACAAGAGTGAAACTCTGTCTCAAAAAAAAA"
"chr14","12551961","12552292","JH378124","27069096","27069413","54","14517135","GGCCAGGCGCGGTGGCTCACGCCTGTAATCCCAGCACTCTGGGAGGCCAAGGCGGACGGATCATCCGAGGTCAGGAGTTTGAGACCAGCCTGGCCAACATGGTGAAACCCCATCTCTACTAAAAATATATATATATATGTATATATATATATATATTAGCCAGGTGTAGTGGTGGGCATCTGTAATCCCAGCTACTCGGGAGGCTGAGGCAGGAGAATTGCTTGAACCCAGGAGGCGGAGGTTGCAGTGAGCTGAGATTGCACCACTGCACTCCAGCCTGGGTGATAAGAATGAGACTCCATCTCAAAACAAACAAACAAACAAATAAAAAA","GGCCGGGCACGGTGGCTCATGCCTGTAATCCCAGCACTTTGGGAGGCCGAGGCGGGTGGATCATGAGGTCAAGAGATCGAGACCATCCTAGTCAACATGGTGAAACTCCATCTCTACTAAAAATACAAAAAAAAAAAAAAATTAGCTGAGCATGGTGGTGCATGCTTGTAATTCCAGCTACTCAGGAGGCTGAGGCAGGAGAATTGCCTGAACCCAGGAGGCGGAGGTTGCAGTGAGCCGAGATTGCGCCATTGCACTCCAGCCTGGGTAATAAGAGTGAAACTCCGTCTCAAAAAAAAAAAACAAAAAAACAAAAAA"
"chr14","15131045","15131391","JH378121","20921542","20921875","62","5790497","GGCTGGGCCCGGTGACTCATGCCTGTAATCCCAGCACTTCGGGAGGACAAGGCGGGTGGATCACCTGAGGTCAGGAGTTCGAGACCAGCCTGGCCAACATGGCGAAACCCCGTCTCTACTGAAAATACAAAAATTAGCCAGGCATGGTGGTGGGCGCCTGTAATCCCAGCTACTCAGAGGCTGAGACAGGAGAATCACTTGAACCTGGGGTGGGGGCGGGGGCGGGGGCGGGGGCGGGGTGGGAGTGGAGGTTGCAGACAGTGAGTGGTGATGGCGCCAGTTCACTCCAGCCTGGGCGAAAGAGTGAAACTCCATCTCAGAAAAAAAAAAAAAAAAAAAAAGTAAAA","GGCTGGGTACGGTGGCTCATGCTGTAATCCCAGCACTTTGGGAGGTCAAAGCAGGCGGATCACCTGAGGTCAGGAGTTTGAGACCAGCCTTGCTAACATGGTGAAACCCCGTTTCTACTAAAAATAAAAAAATTAGCCAGGCGTGGTGGTGTGCACCTGTAATCCCAGCTACTTGGGAGGCTGAAGCAGGAGAGTTGCTTGAACCGGGGTGGTGGGGGGGCAGGGGCAGGGGTGGGTGGCAGGCAGAGGTTGCAGTGAGCCGAGATGGTGCCATTGCACTCCAGCCTGGGCAACAAGAGCAAAACTCCGTCTCAAAAAGAAAAAAAAAAAAGAA"
"chr14","15292066","15292693","JH378118","18053084","18053501","267","2761018","GGCCGGAGACGGTGGCTCACACCTGTAATCCCAGCACTTTGGGAGGCTGAGGCAGGCAGATCACCTGAAGTCAGGAGTTTGAGACCAGCCTGGCCAACATGGTATAAACCCCATCTCTACTAAAAATACAAAAATTAGGCTGGGCGCGGTGGCTCACGCCTGTAATCCCAACACTTTGGGAGGCCGAGGTGGGTGGATCACCTGAGGTCGGGAGTTTGAGACCAGCCTGACCAACATGAAGAAACCCTGTCTCTACTAAAAAAAAAAAAAAATACAAAATTAGCCGGGCATCATGGCACAAGCCTGTAATCCCAGCTACTCAGGAGTCTGAGGCAGGAGAATCGCTTGAACCTGGGAGGCGAAGGTTGCAGTGAGCTGAGATCGTGCCATTGCACTCCAGCCTGGGCAACAAGAGCGAAACTCCTTCTCTAAATAAATAAATAAAAATACAAAAATTTAGCCGGGCATGGTGGCGGGCACCTGTAATCCTAGCTACTTGAGAGGCTGAGGCAGGAGAATCGCTTGAACCCGGGAGGCGGAGGTTGCAGTAAGCAGAGATTGTGCCATTGCACTCCATCCTGGGCAACAAGAGTGAAACTCCATCTCAAAAAAAAAAAAAAAAAAAAAA","GGCTGGGCGCAGTGGCTCACACCTGTAATCCCAGCACTTAGGGAAGCTGAGGCGAGTAGATCACCTGAGGTCAGGAGTTAGAGACCAGCCTGGCCATCATGGTGAAACCCCGTCTCTACTAAAGATACCAAAAATTAGCTGAGTGTGGTGCTGGGTGCCTGTAATCCCAGAAACTCAGGGTGCCTGTAATCCCAGCAACTCAGGGTGCCTTTAATCCCAGCAACTGAGGGTACCAGTAATCCCAGCAACTCAGGGTGTCTTTAATCCTAGCAACTGAGGGCACCTGTAATCCCAGCAACTCAGGAAGCTGAGACAGGAGAAGTACTTGAACCCAGAAGGCAGAGGTTGCAGTGAGCCGATATTGCACCATTGCACTCCAGTCTGGGCAACAAGAGTGAAACTCTGTCTCAAAAAAAAA"
"chr14","15354689","15355313","JH378118","18053084","18053501","269","2698395","GGACGGGCGCAGTAGCTCACACCTGTAATCCTAGCAGTTTGGGAGGCCAAGGTGGGTGGATCACCTGACGTCAGGAGATCGAGACCAGCCTGGACAACATGGCGAAACCCTGTCTCTACTAAAAATACAAAATTAGGGCCAGGTGCGGTGGCTCACGCCTGTAATCCCAGCACTTTGGGAGACTGAGGCGGGCAGATCACCTGAGGTCAGGAGTTCGAGACCAGCCTGGCCAACATGGTGAAACCGCCTCTCTACTAAAAATATAAAAATTGGCTGGGCATTGTAGCAGCCACCTGTAATCCCAGCTACTTGGGGGCCCGAGGCAGAAAAACTGCTTGAACCCAGGAGGCAGAGGTTGTAGTGAGCCGAAATCATGCCACTGCACTCCAGCCTGGGTGACGAGAGTGAGACTCCGTTTCAAAGAAAAAGAAAAAAAATAAAATAAAACACAAAATTAGCCAGTCATGGTGGCAGGCACCTATAATCCCAGCTACCTGGGAGGCTAAGGCAGGAGAATCACTTGAACCCAGGAGGTAGAGGGTGTGGTGAGCCGAGATCACGCCATTGCACTCTAGCCTGGGCAACAAGAGCAAAACTCTGTCTCAAAACAAAAAGTTAAAAAAAA","GGCTGGGCGCAGTGGCTCACACCTGTAATCCCAGCACTTAGGGAAGCTGAGGCGAGTAGATCACCTGAGGTCAGGAGTTAGAGACCAGCCTGGCCATCATGGTGAAACCCCGTCTCTACTAAAGATACCAAAAATTAGCTGAGTGTGGTGCTGGGTGCCTGTAATCCCAGAAACTCAGGGTGCCTGTAATCCCAGCAACTCAGGGTGCCTTTAATCCCAGCAACTGAGGGTACCAGTAATCCCAGCAACTCAGGGTGTCTTTAATCCTAGCAACTGAGGGCACCTGTAATCCCAGCAACTCAGGAAGCTGAGACAGGAGAAGTACTTGAACCCAGAAGGCAGAGGTTGCAGTGAGCCGATATTGCACCATTGCACTCCAGTCTGGGCAACAAGAGTGAAACTCTGTCTCAAAAAAAAA"
"chr14","15366797","15367405","JH378129","11955248","11955630","263","3411549","GGTTGGGTGCGGTGGCTTACCCCTGTAATCCCAGCACTTTGGGGGTACAAAGTGGGAAGATTGCTTGAGCCCAGGAGTTCAAGACCAGCCTGGGCAACTAAGCGAGATCCTATCTCTCAAAAAAATTTTGAAACAACTTTTTGGCCGGGCGCAGTGGCTCACGCCTGTGATCCCAGCACTTTGGGAGGCCAGGGCGGGCGGATCACGAGGTCAGGAGATCAAGACCATCCTGGCTAACACGGTGAAACCCCGTCTCTACTAAAAATACAAAAAATTAGCCGGGTGCGGTGGCGGGCACCTGTAGTCCCAGCTACTCGGGAGGCTGAGGCAGGAGGATGGCGTGAACCCGGGAGGTGGAGCTTGCAGTGAGCTGAGATCGGGCCACTGCACTCCAACCTGGACGACAGATCGAGACTCCGGCTCAAAAAAAAAAAATTAGCTGGGCGTGGTGGCGGGTGCGTGTAATCCCAGCTACTCGGGAGGCTGAGGCAGGAGAATCACTTGAACCTGGGAGGCAGAGGCTGCAGTGAGCCAAGATCGCGCCATTGCACTCCAGCCTGGGCAACAAGAGCGAAACTCTGTCTCTAAATAATAAAATAAAATAAAAAA","GGCTGGGTACGGTGGCTCATGCCTGTAATCCCAGCACTTTGGGAGGTGGGTCACTTGAGGTCAGGAGTTCGAGACCAGCCTGTGCAGTGCCTCCATCCTCAACTGCTGCCTCATCAGCCTGGACCACTACCTGCTCATCCTCTCACCACTGCCACAAGCTGCGCATGAAGCTCCTGCGCGCGCCGGTGCCCGTCTCTACTAAAAATACAAAAATTAGCTGGGTGTGGTGGCAGGTGCCTGTAATCCCAGCTACTCAGGAGGCTGAGGCAGGAGAATCACTTGAACCCAGGAGGCAGAGGTTGCAGTGAGCCGATATCGCATCATTGCACTCCAGCCTGAGCAACAAGAGTGAAATTTTGTCTCAAAAAAAAAAAAAAAAGAAA"
"chr14","15379094","15379705","JH378129","11955248","11955630","265","3423846","GGTTGGGTGCGGTGGCTTACCCCTGTAATCCCAGCACTTTGGGGGTACAAAGTGGGAAGATTGCTTGAGCCCAGGAGTTCAAGACCAGCCTGGGCAACTAAGCGAGATCCTATCTCTCAAAAAAATTTTGAAACAACTTTTTGGCCGGGCGCAGTGGCTCACGCCTGTGATCCCAGCACTTTGGGAGGCCAGGGCGGGCGGATCACGAGGTCAGGAGATCAAGACCATCCTGGCTAACACGGTGAAACCCCGTCTCTACTAAAAATACAAAAAATTAGCCGGGTGCGGTGGCGGGCACCTGTAGTCCCAGCTACTCGGGAGGCTGAGGCAGGAGGATGGCGTGAACCCGGGAGGTGGAGCTTGCAGTGAGCTGAGATCGGGCCACTGCACTCCAACCTGGACGACAGATCGAGACTCCGGCTCAAAAAAAAAAAAAATTAGCTGGGCGTGGTGGCGGGTGCGTGTAATCCCAGCTACTCGGGAGGCTGAGGCAGGAGAATCACTTGAACCTGGGAGGCAGAGGCTGCAGTGAGCCAAGATCGCGCCATTGCACTCCAGCCTGGGCAACAAGAGCGAAACTCTGTCTCTAAATAAATAAAATAAAATAAAAAA","GGCTGGGTACGGTGGCTCATGCCTGTAATCCCAGCACTTTGGGAGGTGGGTCACTTGAGGTCAGGAGTTCGAGACCAGCCTGTGCAGTGCCTCCATCCTCAACTGCTGCCTCATCAGCCTGGACCACTACCTGCTCATCCTCTCACCACTGCCACAAGCTGCGCATGAAGCTCCTGCGCGCGCCGGTGCCCGTCTCTACTAAAAATACAAAAATTAGCTGGGTGTGGTGGCAGGTGCCTGTAATCCCAGCTACTCAGGAGGCTGAGGCAGGAGAATCACTTGAACCCAGGAGGCAGAGGTTGCAGTGAGCCGATATCGCATCATTGCACTCCAGCCTGAGCAACAAGAGTGAAATTTTGTCTCAAAAAAAAAAAAAAAAGAAA"
"chr14","15386894","15387394","JH378114","15957391","15957789","201","570497","GCTGAGTGCAGTGGCTCACGCCTGTAATCCACTTTAGCAGGCCAAAATAGGGGGATCACTTTGAGGCCACGAGTTTGAGACCTGCCTGGGCAACATAGTGAGGCCCCGTCTCTACAAAAATCTTTAAATATTAGAATAACTTTGGGAGGCCGAGGCGGGTGGATCACGAGGTCAAGAGATTGAGACCATCCTGGCCAACATGGTGAAATCCCATCCCTACTAAAGCTACAAAAATTAGCCAGGCGTGGTGGTGTGCGCCTGTAGTCCCAGCTACTCGGGAGACTGAGGCAGGAGAATTGCTTGAATCCGCGTGGCGGAGGTTGCAGTGAGCTGAGATCGCGCCACTGCACTCCAGCCTGGTGACAGAGCGAGACTCCGTCTTAAAAAAAAAAAAAAAAAAAAAAAAAAAAACTTCGGAGGTTGCGGTGAGCCAAGATCACGCCATTGTACTCCAGCCTGGGCCACAAGAGCAAAACTCCGCTTCAAAAAAAAAAAAAAAAA","GCAAGGAACGGTGGCTCATGCCTGTCATCCCAGCACTTTGGGAGGCTAAGGAGGGTGGATTACCGAAGGTCATGAGTTTGAGACCAGCCTGACCAACATGGTGAAAACCCCATCTCTACTAAAAATACAAAAAATTAGCCAGATACAGCTATGCGGCAGACTGGGGCAGGAGAATCGCTTGGACCCAAACCCCATCTCTACTAAAAATACAAAAAATTAGCCGGATACAGCTATGCGGGAGACTGGGGCAGGAGAATCGCTTGGACCCGGGAGGCAGAGATTGCAGTGAGATGAGACCATGCCATTGCTCTCTAGCTTGTGCGATGAGAACAAGACTCTGTCTCAAAAAAAAAAAAAAAAAAAAAAAAAAAAAAAAAAAAAAAAGAGAGAGAGAGAAAA"
"chr14","20140478","20141066","JH378118","18053084","18053501","250","2087394","GCCAGGCGAGGTGGCTCATGCCTGTAATCCCAGCACTTTGGGAGGCTGAGGTGGGTGGAACACTTGAGGTCAGGAGTTCAAGACCAGCCTGGCCAACATGATGAAACCCCCATCTCTACTAAAAACACAAAAATTAGCCAGGAGTGGGCAGGGTGCGGTGGCTCACGCCTGTAATCCCAGCACTTTGGGAGGCTGGGATGGGTGGATCATGAGGTCGGGAGTTCAAGACCAGCCTGGCCAAGATGGTGAAACCCTGTCTCTATTAAAACTTCAAAAATTAGCCAGGCACGGTGGCAGGTGCTTGTAATCCCAGCTACTTGGGAGGCTGAGGCAGGAGAATCACTTGAAACTGGGCGGCAGAGGTTGCAGTGAGCCAAGATCGCGCCACTGGACTCCAGACTGGGCGACACAGTGAGATACCGTCTCAAAAAAAAAAAAAAAAAAAATTAGCCAGGAGTGGTGGCGGAAATCCCAGCTACTTGAGAGGCTGAGGCAGGAGAATCGTTTGAACCCAGGAGGCAGAGGTTGCAGTGAGCCAAGATCTTGCCATTGCACTCCAGCTTGGGAGACAAGAGCAAAACTCTGTCTC","GGCTGGGCGCAGTGGCTCACACCTGTAATCCCAGCACTTAGGGAAGCTGAGGCGAGTAGATCACCTGAGGTCAGGAGTTAGAGACCAGCCTGGCCATCATGGTGAAACCCCGTCTCTACTAAAGATACCAAAAATTAGCTGAGTGTGGTGCTGGGTGCCTGTAATCCCAGAAACTCAGGGTGCCTGTAATCCCAGCAACTCAGGGTGCCTTTAATCCCAGCAACTGAGGGTACCAGTAATCCCAGCAACTCAGGGTGTCTTTAATCCTAGCAACTGAGGGCACCTGTAATCCCAGCAACTCAGGAAGCTGAGACAGGAGAAGTACTTGAACCCAGAAGGCAGAGGTTGCAGTGAGCCGATATTGCACCATTGCACTCCAGTCTGGGCAACAAGAGTGAAACTCTGTCTCAAAAAAAAA"
"chr14","32019134","32019479","JH378197","6655183","6655524","67","25363951","GGCTGGGGCAGTGGCTCACTGTAATTCCAGCACTTGGCCAAGGCAGGTGGATCACCTGAGGTCAGGAGTTCAAGACCAGCAGGGCCAACATGGTGAAACCCTATCTCTAAAAATAAATAAATAAATAAATAAATAAAATAAAATAAAATAAAATAAAAAATAAAAAAAATTAGCTGGGCGTTGTGGTGGGCGCCTGTAATCCCAGCTACTTGGGAGGCTGAGGCAGGAGGATCGCTTGAACCTGGAAGGCAGAGGTTGCAGTGAGCCGAAATCACATAATTGCACTCCAGCCTGGGCGACAAGAGCAAAACTCCATCTCAAAAAAAAAAAAAAAAAAAAAAAAAAA","GGCCGGGCGCAGTGGCTCATGCCTGTAATCCCAGCACTTTGGGAGGCAGAGGCGGGCAGATCACCCAAGGTCAGGAGTTCAAGACCAGCCTGGCTAACATGGTGAAACCCCATTTCTACTAAAAATACAAAAAAAAAAAAAAAAAAAAAAAAAAAAAAAAAAAAAAATTAGCTGAGCGAGGTGGTGGGCACATGTAATCCCAGCTACTTCGGAGACTAAGGCAGGACAATTGCTTAAGCCTGGGAGGCAGAGGTTGTAGTAAGCTGAGATCACACCATTGCACTCCAGCTTGAGCAACAAGAGCGAAACTCCGTCTCAAAAAAAAACCCAAAAAACAAAAAA"
"chr14","39734996","39735596","JH378118","18053084","18053501","237","21681912","GGCTGGGCGCGGTGGCTCATGCCTGTAATCCCAGCATTTTGGGAGGCCGAGGCGGGTGGATCACCTGAGGTCAGGAGTTTGAGACCAGCCTGGCCAACATGGTGAAACCCTGTCTCTACTAAAAATGCAAAAATTAGGCTGGTGCAGTGGCTCACGCCTGTAATCACAGCACTTTGGGAGGCCGAGGTGGGCGGATCACGAGGTCAGGAGATCGAGACCATCCTGGCTAATACAATGAAACCCCGTCTCTATGAAAAATACAAAAAATTAGCCGGGCGTAGTGGCAGGCGTCTGTAGTCCCAGCTACTCAGGAGGCTGAGGCAGGAGAATGGCATGAACCTGGGAGGCGGAGCTTGCAGTGAGCCGAGATTGCGCCACTGCACTCCAGCCTGGGCGACAGCGAGACTCTGTCTCAAAAAAAAAAAAAAAAATTAGCTAGGCATGGTGGCGCATGCCTGTAATCCCAGCTACTTGGGAGGCTGAGGCAGGAGAATCGCTTGAACCTGGGAGGCAGAGGCTGCAGTGAGACAAGATCACGCCATTGCACTCCAGCCTGGGCAACAAGAGTGAAACTCCATCTTCCCCCTACCAAAAAAAAAAA","GGCTGGGCGCAGTGGCTCACACCTGTAATCCCAGCACTTAGGGAAGCTGAGGCGAGTAGATCACCTGAGGTCAGGAGTTAGAGACCAGCCTGGCCATCATGGTGAAACCCCGTCTCTACTAAAGATACCAAAAATTAGCTGAGTGTGGTGCTGGGTGCCTGTAATCCCAGAAACTCAGGGTGCCTGTAATCCCAGCAACTCAGGGTGCCTTTAATCCCAGCAACTGAGGGTACCAGTAATCCCAGCAACTCAGGGTGTCTTTAATCCTAGCAACTGAGGGCACCTGTAATCCCAGCAACTCAGGAAGCTGAGACAGGAGAAGTACTTGAACCCAGAAGGCAGAGGTTGCAGTGAGCCGATATTGCACCATTGCACTCCAGTCTGGGCAACAAGAGTGAAACTCTGTCTCAAAAAAAAA"
"chr14","49081899","49082239","JH378114","14264965","14265292","65","34816934","GGCCAGGTACAGTGGCTCATGCCTGTAATCTCAGCATTTTGGGAGGCTGAGGCAGGCAGATCACCTGAGGTCAGGAGTTCGTGACCAGCCTGACCAGTGAAACCCTGTCTCTACTGAAAAAAATAAAATAAAATAAAATAAAAATAAAAATTAGCTGGGTGTGGTGGTGGGCGCCTGTAATCCCAGCTACTCGGCAGGCTGAGGCAGGAGAATTGCTTGTACCCGGGAGGCGGAGGTTGCAGTGAGCCAAGATCATGCCATTGCACTACAGCCTAGGTGACAAGAGCAAAACTCTGTCTCAAAACAAAACAACAACAACAACAACAACTAAAAAAAAAAAA","GGCCAGGCGCGGTGGCTCAAGCCTGTAATCCCAGCACTTTGGGAGGCCGAGGCGGGTGGATCATGAGGTCAAGAGATCGAGACCATCCTGGTCAACATGGTGAAACCCCGTCTCTACTAAAAACAGAAAAAAAATAAAAATAAAAATAATTAGCTGGGCATGGTGGAGCATGCCTGTAATCCCAGCTACTCAGGAGGCTGAGGCAGGAGAATTGCCTGAACCGAGGAGGCGGAGGTTGCGGGGAGCCAAGATCGCGCCATTGCACTCCAGCCTGGGCAACAAGAGCGAAACTCCGTCTCAAAAAAAAAAAAAAAAAAAAAAAAAAAAA"
"chr14","54833704","54834332","JH378118","18053084","18053501","272","36780620","GGCCAGGTGCAGTGGCTCACTCCTGTAATTCCAGCACTTTGGGAGGCTGCCGGTGGATCACCTGAGGTCAGGAGTTCGAGATCAGCCTGGCCAACATGGTGAAACCCCGTCTCTACTAATAATACAAAAATTAGCCAGGCAAGGCCGGGCGCAGTGGCTCACACCTGTAATCCCAGCACTTTGGGAGGCCGAGGCGGGCGGATCACCTGAGGTCGGGAGTTCAAGACCAGCCTGACCAACATGGAGAAACCCCATCTCTACTAAAAATACAAAATTAGCTGGGCATGGTGGCACATGCCTGTAATCCCAGCTACTAGGGAGGCTGAGGCAGGCGAATCGCTTGAACCTGGGAGGTGGAGGTTGCGGTGGGCCGAGATGGTGCCATTGCACTCTAGCCCGGGCAACAAGAGCGAAACTCTGTCTCAAAAAAAAAAAAAAAAAAAAAAAAATTAGCCAGGCATGGTAGCACACCCTTGTAATCCCAGCTACTCGGGAGGCTGAGGCAGGAGAGTTGCTTGAACCCGAGAGACGGAGGTTGCAGTGAGCTGAGATCGTGCCATTGCACTCCAACCTGGGTGACAAGAGTGAAACTCCATCTCCAAAAAAAAAAATAAATAAAATAAATAAAA","GGCTGGGCGCAGTGGCTCACACCTGTAATCCCAGCACTTAGGGAAGCTGAGGCGAGTAGATCACCTGAGGTCAGGAGTTAGAGACCAGCCTGGCCATCATGGTGAAACCCCGTCTCTACTAAAGATACCAAAAATTAGCTGAGTGTGGTGCTGGGTGCCTGTAATCCCAGAAACTCAGGGTGCCTGTAATCCCAGCAACTCAGGGTGCCTTTAATCCCAGCAACTGAGGGTACCAGTAATCCCAGCAACTCAGGGTGTCTTTAATCCTAGCAACTGAGGGCACCTGTAATCCCAGCAACTCAGGAAGCTGAGACAGGAGAAGTACTTGAACCCAGAAGGCAGAGGTTGCAGTGAGCCGATATTGCACCATTGCACTCCAGTCTGGGCAACAAGAGTGAAACTCTGTCTCAAAAAAAAA"
"chr14","55277737","55278067","JH378148","10302642","10302970","61","44975095","GGCCGGGTGCAGTGGCCCACCTCTGTAATCCTAACACTTTGGGAGGCCAAGGCAGGCAGGTCACTTGAGGTCAGGAGTTCAAGACTAACCTGGCCAACATGGTGAAACCCCGTCTCTACTAAAAATACGAAAATTAGCCGGGCTTCATGATGCATGCCTGTAATCCCAGCTACTAAGGAGGCTGAGGCAGAAGAATCTCTTGAACCCATGAGGTTGCAGTGAGCTGAGATCTCGCCATTGCACTCCAGCCTGGAGGACAAGAGCGAAACTCTGTCTCAAAAAAATAAAATAAAATAAATAAGAATAAAATAATAATAAAAGGCAAAAAGAA","GGCCGGGCGCGGTGGCTCAAGCCTGTAATCCCAGCACTTTGGGAGGCCGAGGCGGGTGGATCACGAGGTCAAGAGATCGAGACCATCCTGGTCAACATGGTGAAACCCCGTCTCTACTAAAAATACAAAAAATTAGCTGGGCATGGTGGTGGGTGCCTGTAATCCCAGCTACTCAGGAGGCTGAGGCAGGAGAATTGCCTGAACCCAGGAGGCGGAGGTTGCGGTGAGCCGAGATCGCGCCATTGCACTCCAGCCTGGGTAACAAGAGTGAAACTCTGCCTCAAAAAAAAAAAATAAAATAAAATAAAATAAAATAAAATAAAATAAAA"
"chr14","55822103","55822700","JH378118","18053084","18053501","240","37769019","GGCCAGGCGCAGTGGCTCACGCCTGTAATCCCAGCACTTTAGGAGGCCGAGGCAGGTGGATCGCCTGAGTTCAGGAGTTCAAACCCACCCTGGCCAACATGGTGAAACCCTGCCTCTACTAAAAAACAAAAAAATGGCCAAGCGTGGTGGCTCACGCCTGTAATTCCAGCACTTTGGGAGGCTGAGGCAGGCGAATCACGAGGTCAGGAGATCGAGACCATCCTGGCTAACATGGTGAAACCCCATCTCTATTAAAAATACAGAAAATTAGCCAGGCGTGGTGGTGGACGCCTGTAGTCCCAGCTTCTTGGGAGGCTGAGGCAGGAGAATGGCATGAACCCGGGAGGCAGAGCTTGCAGTGAGCTGAGATTGCGCCAGTGCACTACAGCCTGTGGGACAGAGCAACTCCGTCTCAAAAAAAAAAAAAATTAGCTGGGCATGGTGGCATATGCCTGTAATCCCAGCTACTAAGGAGGCTGAGGCGGGAGAATCGCTTGAACCCGGGAGGCAGAGGTTGCAGTGAGCCGAGATTGCGCCATTGCACTCCAGTCTGGACAACAAGAGTGAACTGTGTCTCAAAAAAAAAAAAAAAAAAAGA","GGCTGGGCGCAGTGGCTCACACCTGTAATCCCAGCACTTAGGGAAGCTGAGGCGAGTAGATCACCTGAGGTCAGGAGTTAGAGACCAGCCTGGCCATCATGGTGAAACCCCGTCTCTACTAAAGATACCAAAAATTAGCTGAGTGTGGTGCTGGGTGCCTGTAATCCCAGAAACTCAGGGTGCCTGTAATCCCAGCAACTCAGGGTGCCTTTAATCCCAGCAACTGAGGGTACCAGTAATCCCAGCAACTCAGGGTGTCTTTAATCCTAGCAACTGAGGGCACCTGTAATCCCAGCAACTCAGGAAGCTGAGACAGGAGAAGTACTTGAACCCAGAAGGCAGAGGTTGCAGTGAGCCGATATTGCACCATTGCACTCCAGTCTGGGCAACAAGAGTGAAACTCTGTCTCAAAAAAAAA"
"chr14","55860214","55860812","JH378118","18053084","18053501","246","37807130","GGCCGGATGCAGTGGCTCACGCCTGTAATCCCAGCACTTTGGGAGGCCAAGGCAAGCGGATCACCTGAGGTCAGGAGTTCAAGACCAGCCTGGCCAGCATGGTGAAACCCCTTCTCTACTAAAAATACAAAAATTAGCCGGGGCCTTGCGTGGTGGCTCACACCTGTAAATCCCAGCGCTTTGGGAGGCCGAGGCAGGCGGATCACCTGAGGTCGGGAGTTCAAGAACAGCCTGACCAACATGGAGAAACCCCGTCTCCACTAAAAATAGAAAAATAGCCGGGCATGGTGGCGCATGCTTGTAATCTCAGCTACTCGGGAGGCTGAGGCAGGAGATCACTTGAACCCAAGAGGCAGAGGTTGCGGTGAGCCGAGATCGCGCCATTGCACTCCAGCCTGGGCAACAAAGAGCGAAACTCCGTCTCCAAAAAAAAAAAAAAAAAATTAGCCGGGCGTGGTGGCACATACCTGTAATCCCAGCTATTCAGGAGGCTGAGGCAGGAGAATCCCTTGAACCCGGGAGGCAGAGATGGCAGTGAGCTGAGATCACGCCATTGCACTCCAGCCTGGGTGAGAGGAGTGAAACTCCGTCTAAAAAAA","GGCTGGGCGCAGTGGCTCACACCTGTAATCCCAGCACTTAGGGAAGCTGAGGCGAGTAGATCACCTGAGGTCAGGAGTTAGAGACCAGCCTGGCCATCATGGTGAAACCCCGTCTCTACTAAAGATACCAAAAATTAGCTGAGTGTGGTGCTGGGTGCCTGTAATCCCAGAAACTCAGGGTGCCTGTAATCCCAGCAACTCAGGGTGCCTTTAATCCCAGCAACTGAGGGTACCAGTAATCCCAGCAACTCAGGGTGTCTTTAATCCTAGCAACTGAGGGCACCTGTAATCCCAGCAACTCAGGAAGCTGAGACAGGAGAAGTACTTGAACCCAGAAGGCAGAGGTTGCAGTGAGCCGATATTGCACCATTGCACTCCAGTCTGGGCAACAAGAGTGAAACTCTGTCTCAAAAAAAAA"
"chr14","56736257","56736880","JH378206","6546474","6546861","276","50189783","GGCCAGGCACAGTGGCTCATGCCTGTAATCCCTGCACTTTGGGAGGCCAAGGCGGGTGGATCACCTGAGGTCAGGAGTTCGAGACTAGCCTGGCCAACATGGTTGGCCATCTCTTCTAAAAATACAAAAAATTAAGTTGGGCATGGTGGCTCATGCCTGTAATCCCAGCATTTTGGGAGGCCAAGGCAGGTGGATCATAAGGTCAAGAGATTGAGACCATCCTGGCCAACATGGTGAAACCCCATCTCTACTAAAAATACAAAAATTAGCTGGGCGTGGTGGTAGCACACACCTGCAGTCCCAGCTGCTCAGGAGGCTGAGGCAGGAGAATCACTTGAACCCGGGAAGCAGAGGTTGCAGTGAGCCGAAATTGCACCACTGCACTCCAGCCTGGCGACAAAGCAAGACTCCGTCAAAAAAAAAAAAAAAAAAAAAAAAATTAGCCAGGAGTGGTGGCACGTGCCTATAGTTCCAGCTACTCGGGAGGCTGAGGCAAGAGATTTGCTTGAACCTGGGAAGCAGAGGTTGCATATATTGCAGTGAGCCAAGATTATGCCATTGCACTCCAGCCTGGGCAACAAGAGTGAAAATCTGTCTAAAAAGAAAAAAAAAAGAAAAGAAAAA","GGCCACACATGGTGGCTAACGCCTGTAATCCCAGCACTTTGGGAGGCCAAGTCGGGTGGATCATGAGGTCAGGAGACCAAGACCATCCTGGCCAAATGGTGAAACCCCGTCTCTACTAAAAATACAAAAATTAGCTGGGCATGGTGGCGTGTGCCTGTAATCCCAGCTACTCAGGAGGCTGAGGCAGGACAATTGCCTGAACCCAGGAGAATTAGCTGGGCATGGTGGCGTGTGCCTGTAATCCCAGCTACTCAGGAGGCTGAGGCAGGACAATTGCCTGAACCCAGGAGGCGAAGGTTGCGGTGAGCCGAGATTGTGCCATTGCACTCCAGCCTGGGTAACAAGAGCGACACTCTGTCTCAAAAAAAAAAAAAAAAAAAAAAAAAAA"
"chr14","56744047","56744674","JH378118","18053084","18053501","281","38690963","GGCCGGGTGCGGTGACTCACATCTATAATCCCAGCACTTTGGGAGGCCAAGGCAGGTGGATCACCTGAGGTCAGGAGTTCAAGACCAGCCTGGCCAACTTGGTGAAACCCCATCTCTACTAAAAAATATAAAAATTTGCCAGGTGCGGTGGCTCATACCTGTAATCCCAGCACTTTGAGAGGCAGAGGTGGGTGGATCACGAGGTCAGGAGTTCGAGACCAGCCTGGCCAATGTGGTGAAACCCCATCTCTACTAAAAATACAAAAATTAGCCGGGTGTGGTGATGCGTGCCTGTAGTCCCAGCTATTCGGGAGGTTGAGGCAGGAGAATGGCGTGAACCAGGAAGGCGGAGCTTTCACTGAGCGGAGATCGCACCACTGCACTCCAGCCTGGGCGACGGAGCGAGACTCTGTCTCAAAAACAAAACAAAACAAAAAAACAAACAAACAAAAAAACATTATCCGGGTGTGGTGGTGGGCGCCTGTAATCCCAGCTACTTGGGAGGCTGAAGCAGGAGGATTGCTTGAACCTGGGAGGTGGAGGTTGCAGTGAGCTGAGATCACGCCTCTGCACTGCAGGCTGGACGACAAGAACAAAACTCTGAATCAACAACAACAACAACAAAAAA","GGCTGGGCGCAGTGGCTCACACCTGTAATCCCAGCACTTAGGGAAGCTGAGGCGAGTAGATCACCTGAGGTCAGGAGTTAGAGACCAGCCTGGCCATCATGGTGAAACCCCGTCTCTACTAAAGATACCAAAAATTAGCTGAGTGTGGTGCTGGGTGCCTGTAATCCCAGAAACTCAGGGTGCCTGTAATCCCAGCAACTCAGGGTGCCTTTAATCCCAGCAACTGAGGGTACCAGTAATCCCAGCAACTCAGGGTGTCTTTAATCCTAGCAACTGAGGGCACCTGTAATCCCAGCAACTCAGGAAGCTGAGACAGGAGAAGTACTTGAACCCAGAAGGCAGAGGTTGCAGTGAGCCGATATTGCACCATTGCACTCCAGTCTGGGCAACAAGAGTGAAACTCTGTCTCAAAAAAAAA"
"chr14","58283278","58283584","JH378115","34663603","34663898","52","23619675","CCGGGTGCGGTGGCTCACGCCTGTAATCCCAGCACTTTGGGAAGCTGAGGTGGGTGGATCATTTGAGGTCAAGAGTTCTAGACCAGCCTGGCCAACATGGTGAAACCCTACTTCTAATAAACACACACACACACACACACACACACACACACACACAAATTAGCCAGCAGGCACCTGTAATCCCAGCTACTCGGAAGGCTGAGGCAGGACAATCGCTTGAACCTGGGAGGCCAGAAGTTGCAGTGAGCCAAGATCATGCCACTGCACTCCAGTCTGGGTGACAAGAGCAAGACTCCATTTCAAAAAA","GGCCTGGTGAAGTGGCTCACGCCTGTAATCCCAACACTTTGGGAGGCTGAGATGGATGGCTCATTTGAGGTCAGGAGTTCTAGACCAGCCTGGCCAACATGGTAAAAGCCCACCTCTACCAAAAATACAAAAACAAAAACAAAAAAATTTTAGCCAACAGGCACCTTTAATCCCAGCTACTCAGGAGGCTGAGGCAGGAGAATTGCTTGAATCTGGGAGGCCAGAAGTTGCAGTGAGCCAGGATCACACCACTGCACTCCATCCTAGGCGACAAGAGCAAGACTCCAAAAAAAAAA"
"chr14","59226808","59227410","JH378118","18053084","18053501","257","41173724","GGCTGGGCGCTGTGGCTCATGCCTGTAATCCCAGCACTTTAGGAAGCCAAGGGAGGTGGATCACCTGAGGTCAGAGTTCAAGTCCGGCCTGACCAACATGGCGAAACCCAGTCTCTACTAAAAATACAAAATTGGCCAGGCGTGGGGTGGCTCACACCTGTAATCCCAGCACTTTGGGAGGCCGAAGTGGGTGGATCACTTGAGGTCAGGAGTTTGAGACCAGCCTGGTTAACATGGTGAAACCCCATCTCTACTAAAAATACAAAAATTAGCCAGGCATGGTGGCAGGCGCCTGCAATCCCAGTTACTCAGGAGGCTGGTGCAGGAGAATCGCTTAAACCTAGGAGGCAGAGGTTGCAGTGAACTGAGATCGTGCCATTGCACTCCAGCCTGGGTAACAACAGCAAGACTTCATCTCAAAAAAAAAAATACATAATTATAATTAGCTGGGCGTGTTGGCGAGCGCCTGTAGTCCCTGCTACTTGGGAGGCTGAGGCAGGGGAATCACTTGAACCTGAGAGGCGGAGGTTGCAGTGAGCCAAGTCACGCCATTGCATTCCAGCCTCGGCAACAAGAGCAAAACTCCATCTCAAAAAAAAAAAA","GGCTGGGCGCAGTGGCTCACACCTGTAATCCCAGCACTTAGGGAAGCTGAGGCGAGTAGATCACCTGAGGTCAGGAGTTAGAGACCAGCCTGGCCATCATGGTGAAACCCCGTCTCTACTAAAGATACCAAAAATTAGCTGAGTGTGGTGCTGGGTGCCTGTAATCCCAGAAACTCAGGGTGCCTGTAATCCCAGCAACTCAGGGTGCCTTTAATCCCAGCAACTGAGGGTACCAGTAATCCCAGCAACTCAGGGTGTCTTTAATCCTAGCAACTGAGGGCACCTGTAATCCCAGCAACTCAGGAAGCTGAGACAGGAGAAGTACTTGAACCCAGAAGGCAGAGGTTGCAGTGAGCCGATATTGCACCATTGCACTCCAGTCTGGGCAACAAGAGTGAAACTCTGTCTCAAAAAAAAA"
"chr14","62992080","62992681","JH378118","18053084","18053501","256","44938996","GGCCGGATGCAGTGGCCCACACCTGTAATCCTAGCACTTTGAGAGGCTGAAGCAGGCAGATCACTTGCGGTCAGGAGTTTGAGACCAGCCTGGCCAACATAGTAAAACCTCATCTCTACTAAAAATAGAAAAATTTTCTGACCAGGCACGGTGGCTCGCGCCTGTAATCCCAGCACTTTGGGAGGCCAAGGTGGGCACATTACCTGAGATCAAGAGTTCAAGACCAGCCTGACCAACATGGCAAAACTCTGTCTCTACTAAAAATACAAAATTAGCCGGGCATAGTGGCGCATTCCTGTAATCCCAGCTACTAAGGAGGCTGAGGCAGGAGAATTGCTTGAACCCGGGAGCCGGAGGTTGCAGTAAGCCAAGATTGCGCACTGCACTCTAGGCTGGGCAACAACAGCGAAACTCTGTCTCGAAAAAAAAAAAAAAAAAAATTAGCTGGGCGTGGTGGTGAGTACCTGTAATCCCAGCTACTTGGGAGACTGAGGCAGGAGAATCTCTTGAACCTGGGAGGTAGAGGTTGCAGCGAGCTTAGATCACACCACTGCACTAAAGCCTGGGGGACAAGAGCAAAACTCTATCTCAAAAAAATAAAA","GGCTGGGCGCAGTGGCTCACACCTGTAATCCCAGCACTTAGGGAAGCTGAGGCGAGTAGATCACCTGAGGTCAGGAGTTAGAGACCAGCCTGGCCATCATGGTGAAACCCCGTCTCTACTAAAGATACCAAAAATTAGCTGAGTGTGGTGCTGGGTGCCTGTAATCCCAGAAACTCAGGGTGCCTGTAATCCCAGCAACTCAGGGTGCCTTTAATCCCAGCAACTGAGGGTACCAGTAATCCCAGCAACTCAGGGTGTCTTTAATCCTAGCAACTGAGGGCACCTGTAATCCCAGCAACTCAGGAAGCTGAGACAGGAGAAGTACTTGAACCCAGAAGGCAGAGGTTGCAGTGAGCCGATATTGCACCATTGCACTCCAGTCTGGGCAACAAGAGTGAAACTCTGTCTCAAAAAAAAA"
"chr14","75046278","75046878","JH378118","18053084","18053501","246","56993194","GGCCGGGCACAGTGGCTCACACCTATAATCTCAGTACTTTGGGAGGCCAAGGCGGGCAGATCACTTGAGGTCAGGAGTTCGAGACCACCCTGGCCAACATGGTGAAACCTCATCTCTACTAAAAATACAAAAAACTGGCTGGGTGAAGTGGCTCACGCCTGTAATCCCAGCAGTTTGGGAGGCCAAGGCGGGCCAATCACGAGGTCAGGAGTTCGAGACCAGCCTGGCCAATATGGTGAAACCCCGTCTCTATTAAAAATTCAAAAATTAGCTGGATGTGGTGGCAGGCACCTACAATCCCAGCTACTTGGAAGGCTGAGGCAGGAGAGTCTGCTTGAAACCAGAAGGCGGAGGTTGCAGTGAGTGAGCTGAGAACGTGCCACTGCACTCCAGCCTGGGCGAAAGAGCAAAACGCTGTCTCAGGGGGAAAAAAAAAACTAGCCGGGCATGGTGGCAGGTGCCTGTAATCCCAGCTACTCAGGAGGCTGAGGCAGGAGAATTGCTTGAACCCAGGAGGAGGAGGTTGCAGTGAGTCGAGATCACGTCATTGCACTCCCAGCCTGGCTGATAAGAGCGAAACTCCGTCAAAAAAAAAAAAAAA","GGCTGGGCGCAGTGGCTCACACCTGTAATCCCAGCACTTAGGGAAGCTGAGGCGAGTAGATCACCTGAGGTCAGGAGTTAGAGACCAGCCTGGCCATCATGGTGAAACCCCGTCTCTACTAAAGATACCAAAAATTAGCTGAGTGTGGTGCTGGGTGCCTGTAATCCCAGAAACTCAGGGTGCCTGTAATCCCAGCAACTCAGGGTGCCTTTAATCCCAGCAACTGAGGGTACCAGTAATCCCAGCAACTCAGGGTGTCTTTAATCCTAGCAACTGAGGGCACCTGTAATCCCAGCAACTCAGGAAGCTGAGACAGGAGAAGTACTTGAACCCAGAAGGCAGAGGTTGCAGTGAGCCGATATTGCACCATTGCACTCCAGTCTGGGCAACAAGAGTGAAACTCTGTCTCAAAAAAAAA"
"chr14","83813857","83814442","JH378118","18053084","18053501","240","65760773","GGCCAGGCGCGGTGGCTCACGCCTGTAATCCCAGCACTTTGGGAGGCCGAGGCGGGCGGATCACCTGAGGTCAGGGGTTCAAGACCAGCCTGACCATCCCAGAACTTTGGGAGGCCGAGACGGGTGGATCATGAGGTCAGGAGATCGAGACCATCCTGGCTAACACAGTGAAACCCCATCTCTATTAAAAATACAAAAAATTAGCCGGGCGTGGTGGCAGCTCCTGTAGTCCCAGCTACTCGGGAGGCTGAGGCAGGAGAATGGCGTGAACCCGGGAGGCGGAGCTTGCCGTGAGCCGAGATCGCACCACTGCACTCCAGCCTGCAAGATAGCGAGGCTATGTCTCAGGAAAAAAAAAAAAAAAAAAAAAAAGACCAACCTGACCAACATGGTAAAACCCCATCTCTACTAAAAATACAAAATTAGCCGGGCATGGTGGCAGACGCCTGTAATCCCAGCTACTCAGGAGGCTGAGGCAGGAAAATCACTTGAACCCAGGAGGTGGAGGTTGCGGTGAGCCGAGATCGTGCCATTGCACTCCGGCCTGGGTGACAACAGCGAAACTCCATCTCAAAAAAAAGAAAAA","GGCTGGGCGCAGTGGCTCACACCTGTAATCCCAGCACTTAGGGAAGCTGAGGCGAGTAGATCACCTGAGGTCAGGAGTTAGAGACCAGCCTGGCCATCATGGTGAAACCCCGTCTCTACTAAAGATACCAAAAATTAGCTGAGTGTGGTGCTGGGTGCCTGTAATCCCAGAAACTCAGGGTGCCTGTAATCCCAGCAACTCAGGGTGCCTTTAATCCCAGCAACTGAGGGTACCAGTAATCCCAGCAACTCAGGGTGTCTTTAATCCTAGCAACTGAGGGCACCTGTAATCCCAGCAACTCAGGAAGCTGAGACAGGAGAAGTACTTGAACCCAGAAGGCAGAGGTTGCAGTGAGCCGATATTGCACCATTGCACTCCAGTCTGGGCAACAAGAGTGAAACTCTGTCTCAAAAAAAAA"
"chr14","84224287","84224910","JH378118","18053084","18053501","265","66171203","GGCAGGGTGCAGTGGCTCATACCTGTAATCCCAGCACTCTGGGAGGCCGAGGTGGGCAGATCACTTGAGCTCAGGAGTTTGAGACCAGCCTGGCCAACATAGTGAAACCCCATCTCTACTAAAAATACAAAATTAGGCTGGGCACAGTGACTCACGTCTGTAATCCCAGCACTTTGGGAGGCCGAGGCTGGTGGATCACAAGGTCAGGAGATCAAGACCATCCTGTCCAACATAGTGAAACCCCATCTCTACTAAAAATACAAAAATTAGCTGGACGTGGAGGTGCACATCTGTAGTCCCAGCTACTTGTGAGGCTGAGGCAGGAGAACTGCTTGAACCCAGGAGGCGGAGGCTGCAGTGAGCTGAGATTGTGCCACTGCACTCCAGCCTGGGCGACAGAGCGAGACTCTGTCTCAAAAAAAAAAAAAAACAGAAAAAACAAAATTAGCCGGGCATGGTGGTGCACGCCTGTAACCCCAGCTACTTGGGGGGCTGAGGCAGGAGAATTGCTTGAACCTGAGAGGTGGAGGTTTCAGTGAGCCGAGATTGTGCCATTGCCCTCCAGTCTGGGCAACAAGAGCAAAACTCCGTCTCAAAAAAAAAAAAAAGAAAAAAAAAGAAGAA","GGCTGGGCGCAGTGGCTCACACCTGTAATCCCAGCACTTAGGGAAGCTGAGGCGAGTAGATCACCTGAGGTCAGGAGTTAGAGACCAGCCTGGCCATCATGGTGAAACCCCGTCTCTACTAAAGATACCAAAAATTAGCTGAGTGTGGTGCTGGGTGCCTGTAATCCCAGAAACTCAGGGTGCCTGTAATCCCAGCAACTCAGGGTGCCTTTAATCCCAGCAACTGAGGGTACCAGTAATCCCAGCAACTCAGGGTGTCTTTAATCCTAGCAACTGAGGGCACCTGTAATCCCAGCAACTCAGGAAGCTGAGACAGGAGAAGTACTTGAACCCAGAAGGCAGAGGTTGCAGTGAGCCGATATTGCACCATTGCACTCCAGTCTGGGCAACAAGAGTGAAACTCTGTCTCAAAAAAAAA"
"chr14","85020958","85021268","JH378108","34510794","34511096","52","50510164","GCCAGGTGCAGTGGCTCATGCCTGTAATTCCAGTACTTTGAGAGGTCGAGACAGGGAGATCACCTGAGGCCAGGAGTTCAAGACTAGCTTGGCCAACATGGCAAAACCCTGTCTCTACTAAAAATGCAAAAAAAAAAAAAAAAAAAAAAAAAAAATTAGCCTGGCATGGTGGTAGACACCTGTAATCCCAGCTACTTGGGAGGCTGAGACAGGAGAACCTCTTGAATCTGGGAGGAGGAGGTTGCTGTGAGCTGAGATCGTGCCACTGCACTCCAGCCTGGGTAACAAGAGAGAAACTCTGTCTCAAAAAA","GGGTGCCGTGTCTCATGCCTGTAATTCCAGCACTTTGGGAGGTCAAGGCAGTCCGATCACCTGAGGTCAGGAGTTTGAGACTAGCCTGGCCAAAATGGTGAAACCCTGTCTCTAGAAAAAATACAAAAAAAAAAAAAAAAAAAAAAAAAAATTAGCTGGATGTAGTGGTGCATACCTGTAGTCCCAGCTACTCTGGAGGCTGAGGCAGGAGAATTGTTTGAACCCAGGAGGCGGAGGTTGCGGTGAGCCGAGATCATGCCATTGCACTCCAGCCTGGGAAACAAGAGTGAAACTCTGTCTCAA"
"chr14","86696589","86696920","JH378203","2698403","2698735","56","83998186","GGCCAGGCACGGTGGCTCATGCCTATAACCAGCACTTTGGAGGCCGAGGCAGGTGGATCACCTGAGGTCAGGAGTTTGAGACTGGCCTGGCCAGCATGGTGAAACTCTGTCTCTACTAAAAAAAAAAAAAAAAAAAAAAAAAAAAAAGTACAAAATTAGCTGGATGTGGTGGTAGGCACCTGTAATCCCAGCTACTTGGGAGGCTGAGGCAGGAGAATCGCTTGAACCCAGGAGGCAGAGATTGCAGTGAGCCAAGATTGCGCCATTGTACTCCACTCTGGGCAATGAGCGAAACTCCGTCTCAAAAAAAAAATAAAATAAAAATAAAATAA","GCCGGGTGCAGTGGCTCATACCTCTAATCCCAGCACTTTGGGAGGCCAAGGCAGGTGATCACCTGTGGTCAGGAGTTCGAGACCAGCCTGGCCAACATGGTGAAACCCTGTCTTTACTAAAAATACAAAAAAAAAAAAAAAAAAAAAAAAAAAAAACTTAGCCCACCATGGTGGTGGGCTCTTGTAGTCCCAGCTACATGGGAGGCTGAGGCAGAAGAATCGCTTGAAGACAGGAGGTGGAGGTTGCAGTGAGCCAAGACTGCGCCATTGCACTCAGCCTGGGTGACGAGCCAAACTCCATCTCAAAAAAAAAAAAAAAAAAAAAAAAAAAAA"
"chr14","86944567","86945185","JH378118","18053084","18053501","274","68891483","GAGCACGGTGGCTCACGCCTGCAATCCCAGCACTTTGGGAGGCCGAGGTGGGTGGATCACCTGAGGTTAGGAGTTTGAGACCAGCCTGGCCAACATGGTGAAACCGTCTCTACTAAAAATGCAAAAAAGTAGGGGCCGGGCACGGTGGCTCACGCCTGTAATCCCAGCACTTTGGGAGTCTGAGGCAGACGGATCACAAGGTCAGGAGATCAAGACCATGGTGAAACTCCGTCTCTACTAAAAATACAAAAAATTAGCTGGGCGTGGTGGTGGGCACCTGTAGTCCCAGCTGCTTGGGAGGCTGAGGCAGGAGAATGGTGTGAACCCGGGAGGCGGAGCTTGCAGTGAGCCGAGATCGCAACACTGCACTCCAGCCTGGGCGACAGAGCGAGACCCTGTCTCAAAAAAAACAAAAATAAACAAAAATAAATAAATACAAAAAAGTAGCCAGGCATGGTGGTGGGTGCCTGTAATCCCAGCTACTTGGGAGGCTGAGGCAGGAGAATCACCTGAACCCGGGAGGTGGAGGTTGCAGTGAGCCAAGACCGTGTCATTACACTCTAGCCTGGGCAACAAGAGCGAAATTCCATCTGAAAAAATAAATAAATAAAAATAAAAA","GGCTGGGCGCAGTGGCTCACACCTGTAATCCCAGCACTTAGGGAAGCTGAGGCGAGTAGATCACCTGAGGTCAGGAGTTAGAGACCAGCCTGGCCATCATGGTGAAACCCCGTCTCTACTAAAGATACCAAAAATTAGCTGAGTGTGGTGCTGGGTGCCTGTAATCCCAGAAACTCAGGGTGCCTGTAATCCCAGCAACTCAGGGTGCCTTTAATCCCAGCAACTGAGGGTACCAGTAATCCCAGCAACTCAGGGTGTCTTTAATCCTAGCAACTGAGGGCACCTGTAATCCCAGCAACTCAGGAAGCTGAGACAGGAGAAGTACTTGAACCCAGAAGGCAGAGGTTGCAGTGAGCCGATATTGCACCATTGCACTCCAGTCTGGGCAACAAGAGTGAAACTCTGTCTCAAAAAAAAA"
"chr14","87180871","87181803","JH378118","18053084","18053501","547","69127787","GGCCATGTGCGGTGGCTCACACCTGTAATCCCAGCACTGTGGGAGGCCAAGGTGGGCGGATCATTTGAGGTCAGGAGTTCTAAACCAGCCTGGCCAATATGGTGAAACACTGTCTCTGCTAAAAATACAAAAAAAGAAAAAGAAAAAAAAAAAAAGGCTGGGCACGGTGGCTCACGCCTGTAATCTCAGCACTTTGGGAGGCTGAGGTGGGTGGATTACCTGAGGTCAGGAGTTCGAGACCAGCCTGGCCAACATGGTGAAACCTTGTCTCTACTAAAAGTATAAAAATTAGCCAGGTGTGGTGGAGGTCGCCTGTAATCCCAGCTACTCAGTAGGCAGAGGCAGAAGAATCCGTTGAACCTGGGAGGCGGAGGTTGCAGTGAGCTGAGATTGCACCAGTGCATTCCAGCCCGGGTGACAAGAGTGAGACTCTGTCTCAAAATAAACAAACAAAAAAATTAGTGGGCCGGGTTCAATGACTCACGCCGGTAATCCCAGCACTTTGGGAGGCCAAGGAAGGCAGGTCACCTGAGGTCGGGAGCTCGAGACCAGCCTGACCAACATGGAGAAACCCCGTCTCTACTAAAAATACAAAATTAGCTGGGCGTGGTGGCACATGCCTGTAATTCCAGCTACTCAGGACGCTGAGGCAGGAGAATTGCTTGAACCCAGGAGGCGGAAGTTGCAGTGAGCCAAGATCATGACATTGCACTCCCGCCTGGGCGCCAAGAGTGAGATTTCGTCTCAAACAAACAAACAAAAAAACGAATTAGTGGAGCGTGGTGGCAGGCACCTAAAGTCCCAGCTATTCAGGAGGCTGAGGCAGGAGAATTGCTTGAACCTGGGAAGTGGAGGTTATAGTGAGCTGAGATCGCGCCATTGCACTCCAGCCTGGGCAACAAGAGTGAGAATCTGTCTAAAAAAAAAAAAGAA","GGCTGGGCGCAGTGGCTCACACCTGTAATCCCAGCACTTAGGGAAGCTGAGGCGAGTAGATCACCTGAGGTCAGGAGTTAGAGACCAGCCTGGCCATCATGGTGAAACCCCGTCTCTACTAAAGATACCAAAAATTAGCTGAGTGTGGTGCTGGGTGCCTGTAATCCCAGAAACTCAGGGTGCCTGTAATCCCAGCAACTCAGGGTGCCTTTAATCCCAGCAACTGAGGGTACCAGTAATCCCAGCAACTCAGGGTGTCTTTAATCCTAGCAACTGAGGGCACCTGTAATCCCAGCAACTCAGGAAGCTGAGACAGGAGAAGTACTTGAACCCAGAAGGCAGAGGTTGCAGTGAGCCGATATTGCACCATTGCACTCCAGTCTGGGCAACAAGAGTGAAACTCTGTCTCAAAAAAAAA"
"chr15","7203590","7204226","JH378118","18053084","18053501","285","10849494","GGCCAGGTGCAGTGGCTCATGCCTCTAATCCCAGCACTTTGGGAGGCCGAGATGGGCAGATCACCGGAGGTCAGGAGTTTGAGACCAGCTTGGCCAAAATGGTGAAACCCTGTCTCTACAAAAAAATACAAAAATGGCTAGGCACGGTGGCTCACACCTGTAATCCCAGCACTTTGGGATACAGGTGGATCATGAGGTCAAGAGATCAAGATCATCTTGGCCAACATGGCAAAACCCTGTCTCTACTAAAAAATACAAAAAATTAGCTGGGCGTGGTGGTGCACGCCTGTAGTCCCAGCTACTCAGGAAACTGAGGCAAGAGAATCGCTTGAACCTGGGAGGTAGAGGTTGCAGTGAGCCGAGATGCACTCCAGCCTGGCAACAGAACAAGACTCCATCTCAAAGAACAAAAACAAAACAAAACAAAACAAAAGACAAGCAAACAAAAAAATACAAAAATTAGCTAGGTGTGGTGGCAGGCGCCTGTAATCCCAGCTACTCAGGAGGCTGAGGCAGGAGAATCGCTTGAACCTGGGAGGCGGAGGTTGCAGTGAGCCAAGATTGTGCCATTGCACTCCAGCCTAGGTGACAAGAGTGAAAAGACGTCTCAAAAACAAAACCAAAAAAAAAAATAAAA","GGCTGGGCGCAGTGGCTCACACCTGTAATCCCAGCACTTAGGGAAGCTGAGGCGAGTAGATCACCTGAGGTCAGGAGTTAGAGACCAGCCTGGCCATCATGGTGAAACCCCGTCTCTACTAAAGATACCAAAAATTAGCTGAGTGTGGTGCTGGGTGCCTGTAATCCCAGAAACTCAGGGTGCCTGTAATCCCAGCAACTCAGGGTGCCTTTAATCCCAGCAACTGAGGGTACCAGTAATCCCAGCAACTCAGGGTGTCTTTAATCCTAGCAACTGAGGGCACCTGTAATCCCAGCAACTCAGGAAGCTGAGACAGGAGAAGTACTTGAACCCAGAAGGCAGAGGTTGCAGTGAGCCGATATTGCACCATTGCACTCCAGTCTGGGCAACAAGAGTGAAACTCTGTCTCAAAAAAAAA"
"chr15","13675429","13675731","JH378235","1186107","1186418","53","12489322","GGCTTGGCACAGTGGCTCATGCCTGTAATCCCAGCACTTTGAGAGACCGAGGCAAGTGGATCCCAGGAGTTCAAGACCAGCCTGGCCAAGATGGTGAAACCCCCCATCTCTACTAAAAATACAAAAAAAAAAAAAAAAAAAAAAAAAGGGCTTAGTGGCTGGCAGCTGTAGTCCCAGCTACTCGGGAGGCTGAGGCAGGAGAATCGCTTGAACCTGGGAAGCGGAGGTTGCAGTGAGCCAAGATCACACCATTGCACTCTAGCCTGGGCAACAAGGGCAAAACTCCATCTCAAAAAAAAAGAA","GGCTGGGCGCAGTGGCTCAAGCCTGTAATCCCAGCACTTTGGGAGGCCGAGGGGGGTGGATCACGAGGTCAAGAGATCAAGACCATCCTGGTCAACATGGTGAAACCCCGTCTCTACTAAAAAAAAAAAAAAAAAAAAAAAAAAAAAAAAAAAATTAGCTGGGCATGGTGGCGTGTAATCCCAGCTACTCAGGAGGCTGAGGCAGGAGAATTGCCTGAACCCAGGAGGCGGAGTTTGCGGTGAGCCAAGATCGCGCCATTGCACTCCAGCCTGGGTAACAAGAGCAAAACTCTGTCTCAAAAAAAAAAAAAA"
"chr15","14837014","14837358","JH378137","13677298","13677634","59","1159716","GCCGGGTATGGTGGCTCATGCCTGTAATTCCAGCACTTTGGGAGGCCGAGGCAGGCGGATCACCTGAGGTCAGGAGTTTGAGACCAGCCTGGCTAACATGGTGAAACTACGTTTCTACTAAAAATACAAAAAAAAAAAAAAAAAAAAAAAAAAAAAAAAAAAAAAAAAAAATTAGCCAGGCGTGGAGGCGCGTGCCTATAATCCCAGTTACTCGGGAGGCCGAGGCAGGAGAATCGCTTGAACCCAGGAGCCGGAGGGTGTAGTGAGCCGAGATCATGCCATTGCGCTCCAGGTTGGGCAACAAGAGCAGAACTCCGTCTCAAAAAAAAAAAAAAAAAAAAAAAA","GGCTGGGCATTGTGGCTCATGCCTGTAATCCCAGCACTTTGGGAGGCCGAGGTGGGCGGATCACCTGAGGTCGGGAGTTCAAGACCAGCCTGGCCACAATGGTGAAACTCTGTCTCTGCTAAAAAAAAAAAAAAAAAAAAAAAAAAAAAAAAAAAAAAAATTAGCCAGGCGTGGTGGCACACGCCTGTAATCCCAGCTATTTGGGAGGCTGAGGCAGGAGAATCGCTTGAACCTGAGAGGTGGAGGTTGCAGTGAGCCAAGATCATACCATTGCACTCCAGCTTGGGAACAAAGAGCAAAACGCCATCTCAAAAACAAAACAAACAAACTGAAAAAA"
"chr15","20684723","20685060","JH378262","266823","267148","57","20417900","GGCTGGGCGTGTTGGCTTACACCTGAAATCCCAGCACTCTGGGAGGCCGAGGCGGGCAGATCACCTGAGGTCAGGGGTTCGAGACCAGCTTGGCCAACATGGTGAAACCCCGTCGCTACTAAAAATACAAAAATTAGCTGGGCATGGTGGTGGGAGCCTGTAATCCCAGCTACTCAGGAGACTGAGGCAGGACAATCGCTTGAACCCAGGAGGCAGAGGTTGCAGCGAGCCGAGATCGTGCCACTGCACTCCAGCCTGGGAGGGAAGAGTGAAAGTCCATAACAACAACAAAACAACAAAACAACAACAACAACAACAACAACATCTCTGAAAGGAAA","GGCCGGGCGCGGTGGCTCAAGCCTGTAATCCCAGCACTTTGGGAGGCCGAGGCGGGTAGATCATGAGGTCAGGAGTTTGAGACCAGCCTGGCCAACATGGTGAAACCCCGTCTCTACTAAAAATACAAAAATTAGCCGGGCATGGTGGCCTGTGCCTGTAATCCTAGCTACCCAGGAAGCTGAGGCAGGAGAATTGCCTGAACCCAGGAGGCGGAGGTTGCGGTGAGCCGAGATCGTGCCATTGCACTCCAGCCTGGGTAACAAGAGCGAAACTCCGTCTCAAAAACAAACAAACAAACAAACAAAAACAAAAAACAAAAAACAAA"
"chr15","20894395","20894976","JH378119","32351107","32351490","257","11456712","GGTGGCTCACACCTGTAATCCCAGCACTTTGGGAAGCCGAGGTAGGTGGATCACCTGAGGTCAGGAGTTAGAGATCAGCCTGGACAACATGGTGAAACCCCATCTCTACTAAAAATACAAAAACTAACCAGGCTTGGTGGCTCACACCTGTAATCCCATCACTTTGGGAGGCCAAGGCGGGTGGACTACTTGAGGTCAGGAGTTTGAGACCAGCCTGGCTAACATGGTGAAACCCCATCTCTACTAAAAATACAAAAATTAGCTGGGCATGGCAGTGCGCGCCTGCAATCCCAGCTACCTGGGAGGCTAAGGCAGGGGAATTGTTTGAACCTGGGAGGCAGAGGTTGCAGTGAGCCGACACTGCACCACTGCACTCCAGCCTGGGTGACAGAGTGAGCCTCCGTCTCAAAAAAAAAAAAAAAAAAAAAAAAAAATTAGCCAGGTGTGGTGGCAGGCACCTGTGATCCCAGCTACTCAGGAGGCTGAGGCAGGAGAATTGCTTGAACCCAGGAGGCGGAGAGTGCAGTGAGCTGAGATCATGCCATTGCACTCCAGCCTGGGTGACAAGAGAGAAACTCTGTC","GGCCAGGTATGGTGGCTCACACCTGTAATCCCAGCACTTTGGGAGGCCAAGGCAGGCAGACCACCTGAGGTCAGGAGTTCGAGATCAGCCTAGCCAACATGGTGAAACCCCATCTCTAGTAAAAATAAAATTAGCCAGGCATGGTGGTGCATGCCTGTAACGCAGGTCAGGAGTTCGAGATCAGCTTAGCCAACATGGTGAAACCCCATCTCTAGTAAAAATAAAATTAGCCAGGCAGGTGGTGCCGCCTGTACTCGGGAGGCTGAGGCAGGAGAATCACTTGAACCCAAGAGGCAGAGGTTGCAGTCAGCCAAGATCATGCCATTGCACTCCAGCCTAAGCAAAAAGAGTAAAACTCAGTCTCAAAACAAAAAAACAAAAAAA"
"chr15","21092189","21092737","JH378206","6546474","6546861","200","14545715","GCCGGGCGTGGTGGCTCACGCCTGGCCTGTAATCCCAGCACTTTGGGAAGCCAAGGCGGGTGGTTCACCTGAGGTCAGGAGTTCAAGACCAGCCTGGCCAACATGGTGAAACCCTGTCTCTACTAATAATACAAAAATTAGCTGGGCATGGTGGTGCATGCCTGTAATCCCAGCTACTTGGGAGGCCGAGGCGAGCAGATCACCTGAGGTCAAGAGTTCGATACCAGCCTGACCAACATAGAGAAACCCCGTCTCTACTAAAAATGCAAAATTAGCCGGGCATGGTGGTGCATGCCTGTAATCCCCAGCTACTCGGGAGGCTGAGGCAGGAGAATCGCTTGAACCTGGGAGGCAGAGGTTGTGGTGAGCTGAGATCACGCCATTGCACTCCAGCCTGGGCTCGAAACTCCATCTTAAAAAAAAAAAAAAAAAAAAGAATCACTTGAACCCAGGAGGTGGAGGTTGCAGTGAGCTGAGAGTGCACCATTGTACTCCAGCCTGGGCGACAACAGCAAAACTCCATCACCTTAAAAAAAAAAAAAAAAAAGA","GGCCACACATGGTGGCTAACGCCTGTAATCCCAGCACTTTGGGAGGCCAAGTCGGGTGGATCATGAGGTCAGGAGACCAAGACCATCCTGGCCAAATGGTGAAACCCCGTCTCTACTAAAAATACAAAAATTAGCTGGGCATGGTGGCGTGTGCCTGTAATCCCAGCTACTCAGGAGGCTGAGGCAGGACAATTGCCTGAACCCAGGAGAATTAGCTGGGCATGGTGGCGTGTGCCTGTAATCCCAGCTACTCAGGAGGCTGAGGCAGGACAATTGCCTGAACCCAGGAGGCGAAGGTTGCGGTGAGCCGAGATTGTGCCATTGCACTCCAGCCTGGGTAACAAGAGCGACACTCTGTCTCAAAAAAAAAAAAAAAAAAAAAAAAAAA"
"chr15","21150084","21150391","JH378158","10397018","10397312","55","10753066","GGCCGGGCATGGTGGCTTATGCCTGTAATCCCAGCACTTTGGGAGGCTGAGGTGGGTGGATCACCTGAGGTCAGGAGTTCAAGACCACCCTGGTCAACATGGCAAAATCCTGTCTCTACTAAAAATACAAAATTAGCTGGGCGTGGTGGTGGGCGTCTGCCTGGGTGAGGCAGGAGAATCGCTTGAACCCAAGAGGCAGAGGTTGGAGTGAGCCAAGATCGTGCCATTGCACTCCAGCCTGGGCAACGAGAGTGAAACCCCATCTCAGAAAAAAAAAAGAAAAAGAAAAAGAAAAAAGTAAAAAAAAA","GGCTGAGCACAGTGGCTCACACCTGTAATCCCAGCACTTTGGGAGGCCGAGGCGGGTGGATCACCTGAGATCAGGAGTTCAAGAACAGCCTGACCAACATGGTGAAACCTATCTCTACTAAAAATACAAAATTAGCCTGGCATGGTGGCGCGTGCCTGTAATCTGGCTGAGGCAGAAGAATCGCTTAAACCCAGAGGCAGAGATTGCAGTGAGCCAAGATTGTGTCATTGCACTCCAGCCTGGGCAACAAGAGCAAAACTCCATCTCAGAAAAAAAAAAAAAAAGAAGAAAAAAA"
"chr15","21563578","21564184","JH378118","18053084","18053501","255","3510494","GGCCAGGCATGGTGGCTCACACCTGTAATCGCAGCACTTTGGGAGACTGAGGCAAGCAGATCACCTGAGGTTAGAAGTTCAAGACCAGCCTGGCCAACACAGTGAAACCCCATCTCTACTAAAAATACAAAAAAATGGCCGGGTGCAGTGGCTCATGCCTGTAATCCCAGCACTTTGGGAGGCTAAGGCAGGGGGAATCACAAGGTCAAGAGATCAAGACCATCCTGGTAAAACCCCGTCGGTACTAAAAATACAAAAATTAGCTGGGTGAGGTGGCATGCACCTGTAGCCCCAGCTACTCGGGAGGCTGAGACAGGAGAATCACTTGAACCTGGGAGGCAGAGGTTGCAGTGAGCTGAGATCGCACCACTGCACTCCAGCCTGGCAACAGAGGAAGACTCTGTCTAAAACTAATAATAATAATAATAATAATAATAAAATTAGCTGGGAGTAGTGGCGGGCACCTGTAATCCCAGCTACTTGGGGGGGCTGAGGCAGGAGAAAAGCTTGAACCCGGGAGGTGAAGGTTGCAGTAAGCCAAGATCACGCCATTGCACTCCAGCCCGGGCAACAAGAGCGAAACTTCGTTTCAAAAAAAAAAAAAAAA","GGCTGGGCGCAGTGGCTCACACCTGTAATCCCAGCACTTAGGGAAGCTGAGGCGAGTAGATCACCTGAGGTCAGGAGTTAGAGACCAGCCTGGCCATCATGGTGAAACCCCGTCTCTACTAAAGATACCAAAAATTAGCTGAGTGTGGTGCTGGGTGCCTGTAATCCCAGAAACTCAGGGTGCCTGTAATCCCAGCAACTCAGGGTGCCTTTAATCCCAGCAACTGAGGGTACCAGTAATCCCAGCAACTCAGGGTGTCTTTAATCCTAGCAACTGAGGGCACCTGTAATCCCAGCAACTCAGGAAGCTGAGACAGGAGAAGTACTTGAACCCAGAAGGCAGAGGTTGCAGTGAGCCGATATTGCACCATTGCACTCCAGTCTGGGCAACAAGAGTGAAACTCTGTCTCAAAAAAAAA"
"chr15","22132229","22132799","JH378118","18053084","18053501","233","4079145","GGAGGCCAAGGTGGGCGAATCACCGGTGGTCAGGAGTTTGAGACTAGCCTGGCCAACATGGTGAAACCCCGTCTCTACTAAAAAATACAAAAATTAGGCCGAGTGTGGTGGCTCATGCCTGTAATCCCAGCAGTTTGGAAGGCCAAGGCGGGCAGATCACCTGAGGTCAGGAGTTCAAGACCAGCCTGGCCAACACAGTGGAACCCTGTCTCTACTAAAAATACAAAAAAAATTTGCCAGGCATGGTGGTGTGTGTGCCTATAATCCCAGCTACTCAGGAGACTGAGGCAAGAGAACTGCATGAACCCCAGAGGGAGAGGCTGCAGTGAGCTGAGATCGTACCACTGCACTCCAGCCTGGGTGACAGGGCAGGACTCCGTCTCAAAAAAAAAAAAAAAAAAAAAAAATTAGCCAGGTGTGGTGGCGAGCACCTGTAATCCTAGGTACTTGGGAGGCTGAGAAAGGAGAACCACTTGAACCCCGGAGGCAGAGGTTGCAGTGAGTGGAGATTGTGCGCCATTGCACTCCAGCCTGGGTGACAAGTGTGAAATTCTGCCTCAAAAAAAAAAAA","GGCTGGGCGCAGTGGCTCACACCTGTAATCCCAGCACTTAGGGAAGCTGAGGCGAGTAGATCACCTGAGGTCAGGAGTTAGAGACCAGCCTGGCCATCATGGTGAAACCCCGTCTCTACTAAAGATACCAAAAATTAGCTGAGTGTGGTGCTGGGTGCCTGTAATCCCAGAAACTCAGGGTGCCTGTAATCCCAGCAACTCAGGGTGCCTTTAATCCCAGCAACTGAGGGTACCAGTAATCCCAGCAACTCAGGGTGTCTTTAATCCTAGCAACTGAGGGCACCTGTAATCCCAGCAACTCAGGAAGCTGAGACAGGAGAAGTACTTGAACCCAGAAGGCAGAGGTTGCAGTGAGCCGATATTGCACCATTGCACTCCAGTCTGGGCAACAAGAGTGAAACTCTGTCTCAAAAAAAAA"
"chr15","23508255","23508883","JH378118","18053084","18053501","275","5455171","GGTCGGGTGTGGTGGCTCATGCATGTAATCCTGGCACTTTGGGAGGCCGAGGCGGGTAGATCACCTGAGGTCACGAGTTTGAGACCAGCCTGACCAACATGGTAAAACTTTGTTTCTACTACAAATACAAAAAATTGGCCAGGCTCGGTGGCTTCCGCCTGTAATCCCAGCACTTTGGGAGGCCGGGGTGCATGGATCACCTGAGGTCAGGACTTCGAGACCAGCCTGGCCAACATGGTGAAACCCCATCTCTACTAAAAATACAAAAAAAAAAAAAAAAATGAGCCAGGCATATTGGTGGGCGCCTGTAATCCCAGCTACTTGGAAGGCTGAGACAGGAGAATCACTTGAACCTGGGAGGCGGAGATTGCAGTGAGCCGAGATCATGCCACTGTACTCCATCCTGGGTGACAAGAGTGAGACTGCATCTCAAAAAAAAAAAAACCAAAAAACCAAAAAAAAACAAAAAATTAGTCAACCGTAGTGGTGGGCCCCTATAATCTCAGCTGCTCAGGAGGCTGAGGCAGTAGAATCACTTGATCCCAGGAGGTGGAGGTTTCAGTGAGCTGAGATCATGCCATTGTACTCCAGCCTGGGCAACAAGAGCGAAACTCTATCTCAAAAAATAA","GGCTGGGCGCAGTGGCTCACACCTGTAATCCCAGCACTTAGGGAAGCTGAGGCGAGTAGATCACCTGAGGTCAGGAGTTAGAGACCAGCCTGGCCATCATGGTGAAACCCCGTCTCTACTAAAGATACCAAAAATTAGCTGAGTGTGGTGCTGGGTGCCTGTAATCCCAGAAACTCAGGGTGCCTGTAATCCCAGCAACTCAGGGTGCCTTTAATCCCAGCAACTGAGGGTACCAGTAATCCCAGCAACTCAGGGTGTCTTTAATCCTAGCAACTGAGGGCACCTGTAATCCCAGCAACTCAGGAAGCTGAGACAGGAGAAGTACTTGAACCCAGAAGGCAGAGGTTGCAGTGAGCCGATATTGCACCATTGCACTCCAGTCTGGGCAACAAGAGTGAAACTCTGTCTCAAAAAAAAA"
"chr15","23602365","23603005","JH378118","18053084","18053501","286","5549281","GGTCGGGTGTGGTGGCTCATGCATGTAATCCTGGCACTTTGGGAGGCCGAGGCGGGTAGATCACCTGAGGTCACGAGTTTGAGACCAGCCTGACCAACATGGTAAAACCTTGTTTCTACTACAAATACAAAAAATTGGCCAGGCTCGGTGGCTTCCGCCTGTAATCCCAGCACTTTGGGAGGCCGGGGTGCATGGATCACCTGAGGTCAGGACTTCGAGACCAGCCTGGCCAACATGGTGAAACCCCATCTCTACTAAAAATACAAAAAAAAAAAAATGAGCCAGGCATATTGGTGGGCGCCTGTAATCCCAGCTACTTGGAAGGCTGAGACAGGAGAATCACTTGAACCTGGGAGGCGGAGATTGCAGTGAGCCGAGATCATGCCACTGTACTCCATCCTGGGTGACAAGAGTGAGACTGCATCTCAAAAAAAAAAAAAACCAAAAAACCAAAAAAAACCAAAAAATTAGTCAACCGTAGTGGTGGGCCCCTATAATCTCAGCTGCTCAGGAGGCTGAGGCAGTAGAATCACTTGATCCCAGGAGGTGGAGGTTTCAGTGAGCTGAGATCATGCCATTGTACTCCAGCCTGGGCAACAAGAGCAAAACTCTATCTCAAAAAAAAAAAAAAAAAAGAAAAA","GGCTGGGCGCAGTGGCTCACACCTGTAATCCCAGCACTTAGGGAAGCTGAGGCGAGTAGATCACCTGAGGTCAGGAGTTAGAGACCAGCCTGGCCATCATGGTGAAACCCCGTCTCTACTAAAGATACCAAAAATTAGCTGAGTGTGGTGCTGGGTGCCTGTAATCCCAGAAACTCAGGGTGCCTGTAATCCCAGCAACTCAGGGTGCCTTTAATCCCAGCAACTGAGGGTACCAGTAATCCCAGCAACTCAGGGTGTCTTTAATCCTAGCAACTGAGGGCACCTGTAATCCCAGCAACTCAGGAAGCTGAGACAGGAGAAGTACTTGAACCCAGAAGGCAGAGGTTGCAGTGAGCCGATATTGCACCATTGCACTCCAGTCTGGGCAACAAGAGTGAAACTCTGTCTCAAAAAAAAA"
"chr15","23603280","23603615","JH378109","21565230","21565567","55","2038050","GGCCAGGCGCGGTGGCTCATGCCTATAAACTCAGCACTTTGAGAGGCTGAGGCGGGTGGGTCACCTGAGGTCAGGAGTTAGAGACCAGCCTGGCCAACATGGTGAAACCGTGTTTCTACTAAAGATACAACATTAGCCAGGCATGGTGGCGCATGCCTGTAATCCCAGCTACTAGGGAGGCTGCGGCAGGAGAATCGCTTGAACGCAGGAGGTGAAGGTTGCAGTGAGCTGAGATCGTGCCATTGCACTCCAGCCTGGGTGACAAGAGCGAAACTCCATCCCAATCAATCAATCAATCAATCAATCAATTAAATTAAAAAAATAAAAAGAAAGAAA","GGCCGGGCGCGGTGGCTCAAGCCTGTAATACCAGCACTTTGGGAGGCCGAGGCGGGTGGATCACGAGGTCAAGAGATCGAGACCATCCTGGTCAACATGGTGAAACCCCGTCTCTACTAAAAATACAAACAATTAGCTGGGCATGGTGGCGGGTGCCTGTAATCCCAGCTACTCCAGAGGCTGAGGCAGGAGAATTGCCTGAACCCAGGAGACGGAGGTTGCGGTGAGCCAAGATCGCGCCATTGCACTCCAGCCTGGGTGACAAGAGCGAAACTCCGTCTCAATAAATAAATAAATAAATAAATAAATAAAAATAAAATAAATAAATAAATAAATAA"
"chr15","38315253","38315599","JH378169","5922203","5922541","56","32393050","GCCAGACACGGTGGCTCACGCCTGTAATCCCAGCACTTTGGGAGGCCGAGGCGGGTGGATCACCTGAGGTCAGGAGTTCGAGACCAGCCTGGCCAACATGGCGAAATCCTGTCTCTACTAAAAATACACACACACACACACACACACACACACACACACACACACATACACACACAAAATTAGCTGGGCATGGTGGCAGGTGCCTGTAATCCCAGCTACTTGGGAGGCTGAGGCAGGAGAATCACTTGAACCTGGGAGGCGGAGATTGCAGTGAGCCAAGATCATGCCATTGCACTTCAGCCTGGGCAACGAGAGTGAAACTCTGTCTCAAAAAAAAAAAAAAAAAA","GGCCAAGGGTGGTGGCTCACACCTGTAATCCCAACACTCTGGGAGGCCAAGGTGGGTGGATCACCTAAGGTCAGGAGTTCAAGACCAGCATGGCCAATATAGTGAAACTCTGTCTCTACTAAAAATACACACACACAAAAAAAAACAAAACACAAAAAAAACCACAAAATTAGCCGGGCATGGTGGCATGTGCCTGTAATCCCAGCTACTCAGGAGGCTGAGGCAGGAGAATCACTTAAACCCAGGAAGCGGAGGTTGCAGTGAGCCAAGATTGCGCCACTGCACTCCAGCCTAGGTGACAAGAGCAAAACTCTGTCTCAAAAAAAAAAAAAAAAAAAA"
"chr15","39410478","39411079","JH378118","18053084","18053501","249","21357394","GGCCGGGCACGGTGGCTCACGCCTGTAATCCCAGCACTTTGGGAGTCTGAGGTGGGCAGATCCACCTGAGGTCAGGGGTTCAAGACCAGCATGGCCAACATGGTGAAACCTCATCTCTACTAAAAATACAAAAATTAGGCTGGGTGCGGTGGCTCACGCCTGTAATCCCAGCACTTTGGGAGGCCAAGGCAGGTGGATCACCTGAGGTCAGGAGTTCGAGACCAGCATGGCCAACATAGCGAAAATCCGTCTCTACTAAAAACACAAAAATTAGCCAGGTGTGTTGGCTTACACCTGTAATCCCAGCTACACAGGAGGCTGAGGCAGAAGAATCACTTGAATCCAGGAGGTGGAGGTTGCAGTGAGCCGAGATCGCGCCACTGCCCTCCAGCCTGGGTGACAGAGCAAGACACCATCTCAAAAAAAAAAAAAAAAAAATTAGCTGGGCATGGTCACAGGTGCCCCTAATCCCAGCTACTCAGGAGGCTGAGGCAGGAGAATTGCTTGAACCCAGGAGACGGAGGTCACAGTGAGCGGTAATTGTGCCATTGCACTTCAACCTGGGTGACAAGAGCAAAAGTCCATCTCAAAAAAAAAAAAAA","GGCTGGGCGCAGTGGCTCACACCTGTAATCCCAGCACTTAGGGAAGCTGAGGCGAGTAGATCACCTGAGGTCAGGAGTTAGAGACCAGCCTGGCCATCATGGTGAAACCCCGTCTCTACTAAAGATACCAAAAATTAGCTGAGTGTGGTGCTGGGTGCCTGTAATCCCAGAAACTCAGGGTGCCTGTAATCCCAGCAACTCAGGGTGCCTTTAATCCCAGCAACTGAGGGTACCAGTAATCCCAGCAACTCAGGGTGTCTTTAATCCTAGCAACTGAGGGCACCTGTAATCCCAGCAACTCAGGAAGCTGAGACAGGAGAAGTACTTGAACCCAGAAGGCAGAGGTTGCAGTGAGCCGATATTGCACCATTGCACTCCAGTCTGGGCAACAAGAGTGAAACTCTGTCTCAAAAAAAAA"
"chr15","45225530","45226131","JH378133","19690365","19690767","253","25535165","GGCCGGGCACAGTGGCTCATGCCTGCAGTTCCAGCACTTTTGGAGGCCGAGGCAGGCCGATCACTTGAGGTCAGGAGTTCGAGACCACCCCGGCTAACGTGGTGCAACTCCATCTCTACTAAAAATACAAAATTGGCCGGGTGCGGTGGCTCATGCCTGTAATCCCAGCACTTTGGGAGGCCGAGGCGGATGGATCACCTCAGGTCAGGAGTTCGAGACCAGCCTGGCCAATGTGGTGAAACCCCGTCTCTACTAATAATACAAAAATTAACTGGGTGTGGTGGTGGGCACCTATAATCCCAGCTACTCGGGAAGCTGAGGCAGGAGAATCACTTGAACCTGGGAGGTGGAGATTGCAGTGAGCTGAGATGGTGCCATTACACTCCAGCCTGGGCAACGAGAGTGAAACTCTGTCTCTAAATAAATAAATACAAAATTAGCCGGGCATGGTGGCGGATGCCTATAATCACAGCTACTTGGGAGGCTGAGGCAAGAGAATCACTTGAACCTGGGAGGTGGAGGTTGCAGTGAGCTGAGATCAAGCCATTGCACTCCAGCCTGGGCAAAAAGAGTGAAACTCTGTCTCAAAAAAAAGAAAGAAA","GGCCAGGCACAGTGGTTCATGTCTGTAATCAGCATTTTGGGAGGCTGAGGCGGGAGAATCACCTGAGGCCAGGAGTTCTAGATGAGCCTGGGCAAATAGTGACAACCTGTCCCTACAAAAAAATTTAAAATTAGCCAGGATTGAGACCATCCTGGCTCACGTGGTGAAACCCCATCTTTACTTAAAATACTTAAAATGCAAAAAACATTTTTTTTTGTATTTTATTTAAAATACAAAAAAACTAGGCAGGCATGTTGGCACGTGCCTGTAGTCCCAGATACTTGGGAGGCTGAGGCAAGAGAATCACTTGAACCCAGGAGGTGGAGGTTGCAGTGAGCCGAGATCATACCACTGCACTCCAGCCTGGGTGACAAGAGTGAAACTCTGTCTCAAAAAAAAACAA"
"chr15","46581057","46581661","JH378118","18053084","18053501","254","28527973","GGCCGGGCGCGGTGGCTCACGCCTGTAGTCCCAGACTTTGGGAGGCCGAGGTGGGCGGATTGCCTGAGGTCAGGAGTTCAAGACCAACCTGGCCAACATGGTGAAATGCCGTCTCTACTAAAAATACAAAAATTAGGCCGGGCACGGTGGCTCATGTCTATAATCCCAGCACTTTGGGAGGCCGAGGTGGGCGGATCACGAGGTCAGGAGATCGAGACCATCCTGGCTAACACGGTGAAACCCCGTCTCTACTAAAAACACAAAAAATTAGCCGGGCGTGGTGGCAGGCACCTGTAGTCTCAGCTACTCAGGAGGCTGAGGCAGGAGAATGGCGTGAACTTGGGAGGCGGAGCTTGCAGTGAGCCAAGATTGTGCCACTGCACTCCAGCCTGGGCAACAGAGCGAGACTCTGTCTCAAAAAAAAAAAAAAAAATTAGCCAGGTGTGGTGGCAGGTGCCTGTAATCCCAGCTAATTGGGAGGCTAAGGCAGGAGAATCTCTTGAACCCAGGAGGCAGAGGTTGCAGTGAGCCAAGATTTCGCCATTACACTCCAGCCTGGGCAACAAGAGCTAGACTCCATCTCAAAAATAAATAAATAAAATAAA","GGCTGGGCGCAGTGGCTCACACCTGTAATCCCAGCACTTAGGGAAGCTGAGGCGAGTAGATCACCTGAGGTCAGGAGTTAGAGACCAGCCTGGCCATCATGGTGAAACCCCGTCTCTACTAAAGATACCAAAAATTAGCTGAGTGTGGTGCTGGGTGCCTGTAATCCCAGAAACTCAGGGTGCCTGTAATCCCAGCAACTCAGGGTGCCTTTAATCCCAGCAACTGAGGGTACCAGTAATCCCAGCAACTCAGGGTGTCTTTAATCCTAGCAACTGAGGGCACCTGTAATCCCAGCAACTCAGGAAGCTGAGACAGGAGAAGTACTTGAACCCAGAAGGCAGAGGTTGCAGTGAGCCGATATTGCACCATTGCACTCCAGTCTGGGCAACAAGAGTGAAACTCTGTCTCAAAAAAAAA"
"chr15","46659994","46660594","JH378118","18053084","18053501","247","28606910","GCTGGGCATGGTGGCTTACGCCTGTAATCCCAGCACCTTGGGAGGCTGAAGTGAGCAAATCACCTGAGTTCAGGAGTTCAAGACCAGCCTGGCCAACATGGTGAAAACCCATCTCTATTAAAAATTACAAAAATGGCCAGACACGGTAGCTCACGCCTGTAATCCCAGCACTTTGGGAGGCTGAGGCGGGCAGATCACCTGAGGTTGGGAGTTGGAGACCAGCTTGACCAACATGGAGAAACCCCCTCTCTACTAAAAATACAAAATTAGCCAGGCGTGGTGGCACATGCCTGTAATCCCAGCTACTTGGGAGGCTGAGGCAGGAGAATCACTTCAACCCGGAAGGTGGAGGTTGTGGTGAGCTGAGATTGTGTCATTGCACTCTAGCCTGGATAACAAAGGCAAAACTCAGTCTCAAAAAAAAAAAAAATTACAAAAATTAGCTGGCGTGGTGGCAGGTGCCTATAATCCCAGCTACTCAGGAAGCTGAGGCAGGAGAATCACTTGAAACCAGGAGGCAGAGGTTGCAGTGAGCTGAGACCACGCCATTGCCCTCCTGCCTGGGTGACAAGAGTGAAACTCCATCTCAAAAAAAAAAAAA","GGCTGGGCGCAGTGGCTCACACCTGTAATCCCAGCACTTAGGGAAGCTGAGGCGAGTAGATCACCTGAGGTCAGGAGTTAGAGACCAGCCTGGCCATCATGGTGAAACCCCGTCTCTACTAAAGATACCAAAAATTAGCTGAGTGTGGTGCTGGGTGCCTGTAATCCCAGAAACTCAGGGTGCCTGTAATCCCAGCAACTCAGGGTGCCTTTAATCCCAGCAACTGAGGGTACCAGTAATCCCAGCAACTCAGGGTGTCTTTAATCCTAGCAACTGAGGGCACCTGTAATCCCAGCAACTCAGGAAGCTGAGACAGGAGAAGTACTTGAACCCAGAAGGCAGAGGTTGCAGTGAGCCGATATTGCACCATTGCACTCCAGTCTGGGCAACAAGAGTGAAACTCTGTCTCAAAAAAAAA"
"chr15","46772064","46772669","JH378118","18053084","18053501","251","28718980","GGCTGGGTGCAATGGCTCATGCCTGTAATTCCAGTGTTTTGGGAGGCCGAGGCAGGTGGATCACTTGAGATCAGGAGTTCGCGACCAACCTGGCTAACATGGTGAAACCCCGTCTCTACTAAAAATACAAAAAATTGGCCAGGAGCGGTGGCTCAAACCTGTAATTCCAGCACTTTGGGAGGCCGAGGGGGGCAGATCACGATGTTTAGGAGTTTGAGATCAGACTGACCAACATGGTGAAACCCCATCTCTACTAAAAATACAAAAATTAGCCAGGCGTGGTGGTGCATGTCTGTAATCCCAGCTACTTGGGAGGCTGAGGCAGGAGAGTTGCTTGAAGCCGGGAGGTGGAGGTTGCAGTGAGCTGAGATCACACCACTGCACTCCAGCCTGGGCGACAGAGCAAGACTGTCTCAAAAAAAAAAAAAAAAAAAAAAATTAGCCAGCTTGGTGGCGGGCATCTGTAATCCCAGCTACTCGGGAGGCTGAGGCAGGAGAATCACTTGAACCCAGGAGGCAGAGGTCGCAGTGAGCCAAGATCACGCCATTGTACTCCAGCCTGGGCAACAAGAGCAAAACTCCATCTCAAAAAACAAAAAATAAAAA","GGCTGGGCGCAGTGGCTCACACCTGTAATCCCAGCACTTAGGGAAGCTGAGGCGAGTAGATCACCTGAGGTCAGGAGTTAGAGACCAGCCTGGCCATCATGGTGAAACCCCGTCTCTACTAAAGATACCAAAAATTAGCTGAGTGTGGTGCTGGGTGCCTGTAATCCCAGAAACTCAGGGTGCCTGTAATCCCAGCAACTCAGGGTGCCTTTAATCCCAGCAACTGAGGGTACCAGTAATCCCAGCAACTCAGGGTGTCTTTAATCCTAGCAACTGAGGGCACCTGTAATCCCAGCAACTCAGGAAGCTGAGACAGGAGAAGTACTTGAACCCAGAAGGCAGAGGTTGCAGTGAGCCGATATTGCACCATTGCACTCCAGTCTGGGCAACAAGAGTGAAACTCTGTCTCAAAAAAAAA"
"chr15","48446925","48447526","JH378118","18053084","18053501","252","30393841","GGCCAAGTGCAGTGGCTCACGTTTGTAATCCCAGCACTTTGGGAGGCCGAGGCGGGTGGATCACCTGATGTCAGGGGTTTGAAACCAGCCTGGCCAACATGGTGAAACCCCATCTCTAATAAAAATACAAAACTGGCCAGGTGCAGTGGCTCATGCCTGTAATCCCAGCACTTTGAGAGACCAAGGGAGGCAGATCACCTGAGGTCAGGAGTTCCAGACCAGCCTAGCCAACATGGTGAAACCCTATCTCTACTAAGAGTACAAAAATTAGCCTGGCGTGGTGGCAGGCGCCTGTAATCCCAGCTACTCAGAAGGCTGAGGCAGGAGAATCACTTGAACCCAGGAGGCGGAGGTTGCAGTGAGCCGAGATTGAGCCACTACACTCCAGCCTGGGTGACAAGAACAAGACTCTGTCTCAAAAAAAAAAAAAAAAAAAGCCGGTCATGGTGGCACATGCCTATAATCCCAGCTTCTTGGGAGGCTGAGGCAGGAGAACCACTTGAACCTGGGAGGTGGAGGCTGCAGTGAGCCGAAATTGTGCCATTGCACTCTAGCCTGGGCAACAAGAGCAAAACTCTCTCAAAAAAAAAAAAAAAAAAAAA","GGCTGGGCGCAGTGGCTCACACCTGTAATCCCAGCACTTAGGGAAGCTGAGGCGAGTAGATCACCTGAGGTCAGGAGTTAGAGACCAGCCTGGCCATCATGGTGAAACCCCGTCTCTACTAAAGATACCAAAAATTAGCTGAGTGTGGTGCTGGGTGCCTGTAATCCCAGAAACTCAGGGTGCCTGTAATCCCAGCAACTCAGGGTGCCTTTAATCCCAGCAACTGAGGGTACCAGTAATCCCAGCAACTCAGGGTGTCTTTAATCCTAGCAACTGAGGGCACCTGTAATCCCAGCAACTCAGGAAGCTGAGACAGGAGAAGTACTTGAACCCAGAAGGCAGAGGTTGCAGTGAGCCGATATTGCACCATTGCACTCCAGTCTGGGCAACAAGAGTGAAACTCTGTCTCAAAAAAAAA"
"chr15","59372839","59373447","JH378118","18053084","18053501","260","41319755","GGCCAGGATCAGTGTCTCACACCTGTAATCCTAGCACTTTGGGAGGCTAAGGTGGGCGGATTACTTGAGGTCAGGAGTTTGAGACCAGCCTGGGCAACATGGTGAAACCCCGTCTCTACTAAAAATACAAAAATTAGCTGGGCATAGGCCAGGAGTGGTGGCTTACGCCTGTAATTCCAGGACTTTGGGAGGCTGAGGCGGGCAGATCATGAGGTCAGGAGATTGAGACCATCCTGGCTAACATGGTGAAACCTCATCTCTACTAAAAATACAAAAATTAGCCAGTCGTGGTGGTAGGCGCCTGTAGTCCCAGCTACTTGAGAGGCTGAGGCAGGAGAATCACTTGAATCCGGGAGGTGGAGGTTGCAGTGAGCCGAGATTATGCCACTTCACTCCAACCTGGTGACAGAGCAAGACTCCGTCTAAAAAAAAAAAAAAAAATTAGCTGGGTGTGGCGGGCACTTGCAATCCCAGCTACTTAGGAGGCTGAGGCAGGAGAACCGCTTGAACCTGGGAGGTAGAGGTTCCAGATCACGCCATTGCACTCCTGCTTGGGCAACAAGAGTGACACTCCATCTCAAAAAAACAAAAAAAAAAAAGAAAAAGAAA","GGCTGGGCGCAGTGGCTCACACCTGTAATCCCAGCACTTAGGGAAGCTGAGGCGAGTAGATCACCTGAGGTCAGGAGTTAGAGACCAGCCTGGCCATCATGGTGAAACCCCGTCTCTACTAAAGATACCAAAAATTAGCTGAGTGTGGTGCTGGGTGCCTGTAATCCCAGAAACTCAGGGTGCCTGTAATCCCAGCAACTCAGGGTGCCTTTAATCCCAGCAACTGAGGGTACCAGTAATCCCAGCAACTCAGGGTGTCTTTAATCCTAGCAACTGAGGGCACCTGTAATCCCAGCAACTCAGGAAGCTGAGACAGGAGAAGTACTTGAACCCAGAAGGCAGAGGTTGCAGTGAGCCGATATTGCACCATTGCACTCCAGTCTGGGCAACAAGAGTGAAACTCTGTCTCAAAAAAAAA"
"chr15","64220715","64221335","JH378118","18053084","18053501","268","46167631","CCAGGCACAGTGGCTCATACCTGTAATCCCAGCACTTTGGGAGCCCAAGGCGGGCAGATCACCTGAGGTCAGGAGTTCGAGACCAGCCTGGACAACATGGAGAAACTCCATCTCTACTAAAAATACAAAATGAGGCCGGGCACAGTGGCTCACACCTATAATCCCAGCACTTTTGGAGGCCGAGACAGGCAGCTCACGAGGTCAGGAGTTCAAGACCAGCCTGGCCAGCATGGTGTAACCCCGTTTCTACTAAAAATACAAAAATTAGCCAGGCATGGTGGTGCGTGCCTGTAGTCCTCAGGAGGCTGAGGCAGGAGAATCGCTTGAATCTGGGAGGCGGAGCTTGCAGTCAGCTGAGATCAGGCTACTGCACTGCAGCTTGGGCAACAGAGTGAGACTCCGTCTCAAAAACAAACAAACAAACAAACAAAACACAACAAAATTAGCTGGGCATGGTGGCAGGTGCCTGTAATCCCAGCTACTCAGCTACTCAGGAGGCTGAGGCAGGAGAGTCACGTGAACCTGGGAGGCAGAGGTTGCAGTGAGCCAAGATCACGCCATTGCACTCCAGCCTGGGCAACAAGAGGGAAATTACATCTCAAAAAAAAAAAAAAAAAAAAA","GGCTGGGCGCAGTGGCTCACACCTGTAATCCCAGCACTTAGGGAAGCTGAGGCGAGTAGATCACCTGAGGTCAGGAGTTAGAGACCAGCCTGGCCATCATGGTGAAACCCCGTCTCTACTAAAGATACCAAAAATTAGCTGAGTGTGGTGCTGGGTGCCTGTAATCCCAGAAACTCAGGGTGCCTGTAATCCCAGCAACTCAGGGTGCCTTTAATCCCAGCAACTGAGGGTACCAGTAATCCCAGCAACTCAGGGTGTCTTTAATCCTAGCAACTGAGGGCACCTGTAATCCCAGCAACTCAGGAAGCTGAGACAGGAGAAGTACTTGAACCCAGAAGGCAGAGGTTGCAGTGAGCCGATATTGCACCATTGCACTCCAGTCTGGGCAACAAGAGTGAAACTCTGTCTCAAAAAAAAA"
"chr15","65873443","65873774","JH378165","3784440","3784761","45","62089003","GGCCAGGCACGGTGGCTCACACGTGTAATCCCAGCACCTTGGGAGACCGAAGCAGGTGGATCACCTGAGGTCAGGAGTTTGAGGCCAGCCTGGCCGATATGGTGAAACCCTATCTCTATTAAAAATACCAAAAAAAAAAAAAAAAAAAAAAAAACCTGCTGGGCGTGGTGGCGCACGCCTGTAATCCCAACTACTCAGGAGGCTGAGGCAGGAGAATCACTTGAATCCAGGAGGCAGAGGTTGCAGTGAGCCGAGATCGCGCCATTGCACTCCAGCCTGGGCAACAAGAGCGAAACTCGGTCTCAAAAAAAAAAAAAAAAAAAGAAAAGAAA","GGCCGGGCGCGGTGGCTCAAGCCTGTAATCCCAGCACTTTGGGAGGCCGAGGCAGGTGGATCATGAGGTCAAGAGATCAAGACCATCCTGGTCAACATGGTGAAACCCCGTCTCTACTAAAAATACAAAAAAAAAAAAAAAAAAACTAGCTGGGCGTGGTGGCGCATGCCTGTAATCCCAGCTACTCAGGAGGCTGAGGCAGGAGAATTGCTTGAACCCAGGAGGCGGAGGTTGCGGTGAGCCCAGATCGCGCCATTGCACTCCAGCCTGGGTAACAAGAGCAAAACTCCATCTCAAAAAAAAAAAAAAAAAAAAAAAAAAA"
"chr15","70453292","70453944","JH378118","18053084","18053501","292","52400208","GGCCAGGCACGGTGGCTCATGCCTGTAATCCCAACACTTTGGGAGGCTGAGGTAGGTAGATCACCTGAGGTTGAGGTCAGGAGTTTGAGACCAGCCTGGCCAACATGGTGAAACTCTGTCTCTACTAAAAATACAAAAATTTGGCCCGGCGCAGTGGCTCACCTGTAATCCCAGCACTTTGGGAGGCCGAGGCAGGCAGATCACGAGGTCTGGAGATCAAGACCATCCTGGCTAACTCGGTGAAATCCCATCTCTACTAAAAATACGAAAAATTAGCCAGGTGTGGTGGCGGGCACCTGTAGTCCCAGCTACTTGGGAGGCTGAGGCAGGAGAATGGCGTGAACCTGGGAGGTGGAGCTTGCAGTGGGCCAAGATCACGCCACTGCACTCCAGCCTGGGCAACAGAGTGAGACTCTGTCTCAAAATAAAATAACATAAAATAAAATAAAGTAATATAAAATAAAAATACAAAAATTAGCTGGGCATGGTAGCGGGTACCTATAATTCCAGCTACTTGAGAGGCTGAGGCTGGAGAATCACTTGAATCTGGGAGGTGGAGGTTGCAGTGAGCCAAGATTGCACCATTGCACTCCAGCCTGGGCAACAAGAGCCAAACTCCGTATCAAAAAAAAAAAAAAAAAGAAAAAGAAAAA","GGCTGGGCGCAGTGGCTCACACCTGTAATCCCAGCACTTAGGGAAGCTGAGGCGAGTAGATCACCTGAGGTCAGGAGTTAGAGACCAGCCTGGCCATCATGGTGAAACCCCGTCTCTACTAAAGATACCAAAAATTAGCTGAGTGTGGTGCTGGGTGCCTGTAATCCCAGAAACTCAGGGTGCCTGTAATCCCAGCAACTCAGGGTGCCTTTAATCCCAGCAACTGAGGGTACCAGTAATCCCAGCAACTCAGGGTGTCTTTAATCCTAGCAACTGAGGGCACCTGTAATCCCAGCAACTCAGGAAGCTGAGACAGGAGAAGTACTTGAACCCAGAAGGCAGAGGTTGCAGTGAGCCGATATTGCACCATTGCACTCCAGTCTGGGCAACAAGAGTGAAACTCTGTCTCAAAAAAAAA"
"chr16","217191","217526","JH378138","4229795","4230103","77","4012604","ATTTTGGGAGGCTGAGATGAGTGATGAGCGGATCACCTGAGGTCAGGAGCTCGAGACCAGTCTGGCCAACACGGTGAAACCCTGTCTCTACTAAAAGTACCAAAAAAATTAGCCAGGCATGGCAGTGGGCGCCTGTAATCCCAACTACTCGGGAGGCTGAGGCAGGAGAATCACTTGAACCTGGGAGGTGGATGTAGCAGTGAGCCGGGATCGTGCCACTGAACTCCAGCCTGGGCGATAAGATCAAAACTCTGTCTCTCTCTCACACACACACACACACACACACACACACACACACACACCCCCAAAAAAAAAAACAAAAAAAAGAAAAAGAAA","CACTTTGGGAGGTGAAGGCGGGCAGATCACCTGAGGTCAGGAGTTCGAGACCAGCCTGGCCAACATGGTGAAACCCCGCCTCTACTAAAAATACAAAAATTAGCCAGGTGTGACACTAGGCATCTGTAATCCCAGCTACTTGGGAGGCTGAGACAGGAGAATCACTTGAACCCAGGAGGCGGAAGTTGCAGTGAGCCAAGATCATGCCATTGCACTCCAGCCTGGGTGACAGGAGCAAAACTCTGTCTCAAAAAAAAAAAAAAAAAAAAAAAAAAAAAAAAAAAAAAAAGAAAAGAAAAGAAAAGTAAA"
"chr16","384893","385508","JH378118","18053084","18053501","265","17668191","GGCCGGGCGTGGTGGCTAACACGGGTAGTCCTAGCACTTTGGGAAGCCAAGGCAGGCAGATCACTTGAGGTCAGGAGTTTGAGATCAGTCTGGCCAACATGGTGAAACCACGCCTCTACTAAAAATACAAAAGTTATGGCCGAGCGTGGTGGCACGCGCCTGTAATCCCAGCACTTTGGGATGCTGAGGCAGGCGCATCACCTAAGGTCGGGAATTCAAGACCAGCCTGACCAACATGGAGAAACCACGTTTCTACTAAAAATACAAAATTAGCCGGGTGTGGTGGCACATGCCTGTAGTTTCAGCTACTCAGGAGGCTGAGGCAGGAGAATCACTTGAATCCGGGAGGCGGAGATTGTGGTGAGCCGAGATCGGGCCATTGCACTCCAGCCTGGGCAACAAGAGAGAAACTCTGTCTCAAAAAAAAAAAAAAAAAATTAGCCAGGCATGGTAGCCTGTGCCTGTAATCCCAGCTACTTGGGAGGCTGAGGCAGGAGAATCGCTTGAACCTGGGAGGCAGAGGTTGCAGTGAGCCGCGATTGCGCCATTGCACTCTCCAGCCTGGGGGAGAAGAGCAAAACTCCATCTCAAAAATAAATAAATAAATAAAAATAAA","GGCTGGGCGCAGTGGCTCACACCTGTAATCCCAGCACTTAGGGAAGCTGAGGCGAGTAGATCACCTGAGGTCAGGAGTTAGAGACCAGCCTGGCCATCATGGTGAAACCCCGTCTCTACTAAAGATACCAAAAATTAGCTGAGTGTGGTGCTGGGTGCCTGTAATCCCAGAAACTCAGGGTGCCTGTAATCCCAGCAACTCAGGGTGCCTTTAATCCCAGCAACTGAGGGTACCAGTAATCCCAGCAACTCAGGGTGTCTTTAATCCTAGCAACTGAGGGCACCTGTAATCCCAGCAACTCAGGAAGCTGAGACAGGAGAAGTACTTGAACCCAGAAGGCAGAGGTTGCAGTGAGCCGATATTGCACCATTGCACTCCAGTCTGGGCAACAAGAGTGAAACTCTGTCTCAAAAAAAAA"
"chr16","1668152","1668787","JH378118","18053084","18053501","287","16384932","GGCCGGGCACGGTGCCTCGTTCCTGTAATCCCAGCACTTTGGGAGGCCAAGGTGGGTGGATCACCTGAGGTCAGGAGTTCGAGACATGCCTGGCCAACATGGCAAAATCCTGTCTTTACTAAAAATACAAAAATTAAGCCGGGCGCTGTGACTCATGCCTGTAATCCCAGCACTTTGGGAGGCCAAGGCGGGCGGATCACAAGGTCAGGAGATTGAGACCATCCTGGCTAACACGGTGAAAACCCGTCTCTACTAAAAATACAAAAAATTAGCCAGGTGTGGTGGCGGGTGCCTGTAGTCCCAGCTACTCGGGAGGCTGAGGCAGGAGAATGGCGTGAACCCGGGAGGCGGAGCTTGCAGTGAGCCGAGATCGTGCCACTGCACTCCAGTCTGGGCAACAGAGCAAGACTCTCTCTCAAAAAGAAACAAACAAAAAAAAAAATGAAAAAAGAAAAATTAGCCAGGCGTGGTGGCGGGTGCCTATAATCTCAGCTACTCGGGAGGCTGAGGCAGAAGTATCATTTGAACCCAGGAGGCGGAGGTTGTAGTGATCCAAGATAGCGCCATTGCACTGCAGCCTGGGTGACAACAGTGAAACTCCGTCTCAAAAAAAAAAAAAAAAAAGAAAGAAAGAAA","GGCTGGGCGCAGTGGCTCACACCTGTAATCCCAGCACTTAGGGAAGCTGAGGCGAGTAGATCACCTGAGGTCAGGAGTTAGAGACCAGCCTGGCCATCATGGTGAAACCCCGTCTCTACTAAAGATACCAAAAATTAGCTGAGTGTGGTGCTGGGTGCCTGTAATCCCAGAAACTCAGGGTGCCTGTAATCCCAGCAACTCAGGGTGCCTTTAATCCCAGCAACTGAGGGTACCAGTAATCCCAGCAACTCAGGGTGTCTTTAATCCTAGCAACTGAGGGCACCTGTAATCCCAGCAACTCAGGAAGCTGAGACAGGAGAAGTACTTGAACCCAGAAGGCAGAGGTTGCAGTGAGCCGATATTGCACCATTGCACTCCAGTCTGGGCAACAAGAGTGAAACTCTGTCTCAAAAAAAAA"
"chr16","2310740","2311369","JH378118","18053084","18053501","271","15742344","GGCCGGGCACAGTGGCTCACGCCTATAATATCAGCACTTTGGGAGACCAAGGCGGGTGGATCACCTAAGGTCAGGAGTTCAAGACCAGCCTGACCAACATGGTGAAACCCCATCTCTACCAAAAATAGAAAACATTAGTCTTGGCCGGGCACGGTGACTCATACCTGTAATTCCAGCACTTTGGGAGGCCGATCACCTGGCGGATCACCTGAGGTCGGGAGTTTGAGACCAGCCTGACCAACATGGAGAAACCCCGTCTCTACTAAAAATACAAAATTAGCTGTGCGTAGTGGCCCATGCGTGTAATCCCAGCTACTCAGGAGACTGAGGCAGGAGAATGGCTTGAACCTGGGAGGCGGAGGTTGTGCTGAGCCAAGATCGCACCATTGCACTCCAGCCTGGGCAATAAGAGTGAAACTCCGTTTCATAAAACAAAAAACAAAAAACAAAAAAAAAACCATTAGCCAGGCATTGTGGCAGGCACCTGTAATCCCAGCTACTCAGGAGGCTGAGGCAGAATGGCTTGAACCGGGGAGGCAGAGGTTGCAGTGAGCCGAGATCGCGCCATTGCACTCCAGCCTGGGCAACAAAAGTAAAACTCTGTCTCAAATAAAAAAAAGAGAGAAAAAA","GGCTGGGCGCAGTGGCTCACACCTGTAATCCCAGCACTTAGGGAAGCTGAGGCGAGTAGATCACCTGAGGTCAGGAGTTAGAGACCAGCCTGGCCATCATGGTGAAACCCCGTCTCTACTAAAGATACCAAAAATTAGCTGAGTGTGGTGCTGGGTGCCTGTAATCCCAGAAACTCAGGGTGCCTGTAATCCCAGCAACTCAGGGTGCCTTTAATCCCAGCAACTGAGGGTACCAGTAATCCCAGCAACTCAGGGTGTCTTTAATCCTAGCAACTGAGGGCACCTGTAATCCCAGCAACTCAGGAAGCTGAGACAGGAGAAGTACTTGAACCCAGAAGGCAGAGGTTGCAGTGAGCCGATATTGCACCATTGCACTCCAGTCTGGGCAACAAGAGTGAAACTCTGTCTCAAAAAAAAA"
"chr16","3075498","3075819","JH378114","26407278","26407597","46","23331780","GGCCAGGCGCGGTGGCTCACACCTGTAATCCCAGCACTTTGGGAGGCCAAGGCGGGCAGATCACGAGGTCAAGAGATCGAGACCATCCTGGCCAACCTGGTGAAACTCTGTCTCTACTAAAAATACCAAAAAAAAAAAAAAAAAAAAAAAAAAAAAGCATGGTGGCAGGTGCCTGTAATCCCAGCTACTTGGGAGGCTGAGGCAGAATTGCTTGAACCCGGGAGGCAGAGGTTGCAGTGAGTTGAGATCATGCCATTGCACTCCAGCCTGGGCAAAAAGAGCGAAACTCTGTCTCAAAAAACAAAACAAAAACAAAAACAAA","GGCCGGGCGCAGTGGCTCAAGCTTGTAATCCCAGCACTTTGGGAGGCCGAGGCGGGTGGATCACGAGGTCAAGAGATCGAGACCATCCTGGTCAACATGGTGAAACCCCGTCTCTACTAAAAATACAAAAAAAAAAAAAAAAAATTAGTTGGGCATGGTGGTGTGTGCCTGTAATCCCAGCTACTCAGGAGGCTGAGGCAGGAGAATTGCCTGAACCCAGGAGGCGGAGGTTGCGGTGAGCCGAGATCGCGCCATTGCACTCCAGCCTGGGTAACAAGAGCGAAACTCCGTCTCAAAAAAAAAAAAAAAAAAAAAAAAAA"
"chr16","3161549","3162150","JH378118","18053084","18053501","252","14891535","CTGGGCACCGTGGCTCACGCCTGTAATCCCAACACTTTGGGAGGCCAAGGCGGGTGGAACACCTGAAGTCAGGAGTTCGAGACCAGTCTGGACAACATGATGAAACCCCGTCTCTACTAAAAATACAAAAAGTAGCCAGGTATGGCCGGGCGCGGTGGCTCACGCCTGTAATCCCGGCACTTTGAGAGGCCGAGGCAGGTGGATCACAAGGTCAGGAGTTCAAGAGCAGCCTGGCCAAGATAGTGAAACCCCGTCTCTACTAAAAGCAAAATTACAGTGCGCCTGTAATCCCAGCTGCTCGGGAGGCTGAGGCAGGAGAATCGCTTGAACCTGGAGGGCGGAGGTTGCAGTGAGCCAAGATCGCTCTACTGCACCCTAGCCTGGGTGACAGAGCAAGACTCTGTATCAAAAAAAAAATAAATAAATAATTAGCCAGGTATGGTGGTGCAGGCTTGTAATCCTAGCTGCTCAGGAGGCTGAGGCAGGAGAATCGATTGAACCCAGGAGACGGAGGTTGCAGTGAGCAGAGATCACACCATTGTACTCCAGCCTGAGTGACAAAAACGAAACTCCGTCTCAAAAAAAAACCAAAAAAACAAAAA","GGCTGGGCGCAGTGGCTCACACCTGTAATCCCAGCACTTAGGGAAGCTGAGGCGAGTAGATCACCTGAGGTCAGGAGTTAGAGACCAGCCTGGCCATCATGGTGAAACCCCGTCTCTACTAAAGATACCAAAAATTAGCTGAGTGTGGTGCTGGGTGCCTGTAATCCCAGAAACTCAGGGTGCCTGTAATCCCAGCAACTCAGGGTGCCTTTAATCCCAGCAACTGAGGGTACCAGTAATCCCAGCAACTCAGGGTGTCTTTAATCCTAGCAACTGAGGGCACCTGTAATCCCAGCAACTCAGGAAGCTGAGACAGGAGAAGTACTTGAACCCAGAAGGCAGAGGTTGCAGTGAGCCGATATTGCACCATTGCACTCCAGTCTGGGCAACAAGAGTGAAACTCTGTCTCAAAAAAAAA"
"chr16","3211652","3212251","JH378118","18053084","18053501","260","14841432","GTCAGACGCAGTAGTTTATGCCTGTAATCCTTGCACTTTGGGAGGCAGGTGGATCACCTGAGGCCAGGAGTTGGAGACCAGCCAGGCCAATATGGCAAAACCCCGTCTCTACTAAAAATACAAAAACTAGCCGGGCGCAGTGGCTCACACCTGTAATCCCAGCACTTTGGGAGGCTGAGGTGGGTGGATCACTAGGTCAGGAGTTCAAGACCAGCCTGGCCAACATGGTGAAACCGCGTCTCTACTAAAAACACCAAAAAATTAGCTGGGCGTGGTGGCAGTCGCCTGTAATCCCTGCTACTCGGAAGGCTGAGGCAGGAGAATCACTTGAACGCAGGAGGCAGAGGTTGCGGTGAGCCGAGATCACGCCACTGCACTCCAGCCTGGGTGACAGAGCAAGACTCTGTCTCAAAAAACAACAACAACAACTAGCTGGGCGTGGTGGCACATGCCTGTAACCCCAGCTACTCAGGAGGCTGAGGCTGAGGGAGAAAAATCGCTTGTACCTGGGAGGTGGAAGTTGCAGTGAGCGGAGATCCCACCATTGCACTCCAGCCTGGGTGACAAGAGCGAAACTCCATCTCAAAAAAAAAAAAAAAA","GGCTGGGCGCAGTGGCTCACACCTGTAATCCCAGCACTTAGGGAAGCTGAGGCGAGTAGATCACCTGAGGTCAGGAGTTAGAGACCAGCCTGGCCATCATGGTGAAACCCCGTCTCTACTAAAGATACCAAAAATTAGCTGAGTGTGGTGCTGGGTGCCTGTAATCCCAGAAACTCAGGGTGCCTGTAATCCCAGCAACTCAGGGTGCCTTTAATCCCAGCAACTGAGGGTACCAGTAATCCCAGCAACTCAGGGTGTCTTTAATCCTAGCAACTGAGGGCACCTGTAATCCCAGCAACTCAGGAAGCTGAGACAGGAGAAGTACTTGAACCCAGAAGGCAGAGGTTGCAGTGAGCCGATATTGCACCATTGCACTCCAGTCTGGGCAACAAGAGTGAAACTCTGTCTCAAAAAAAAA"
"chr16","3990675","3991277","JH378118","18053084","18053501","250","14062409","GGCTGGGCGTGGTGGCTCACGCCTTTAATCCCAGTACTTTGGGAGGCCGAGAAGGGCACATCACCTGAGGTCAGGAGTTTGAGACCAGCCTGGCCAATATGGTAAAACCCTGTCTCTACTTAAAAAATAGAAAAATCAGGCTGGACGCAGTGGCTCACGCCTGTAATCCCAGCACTTTGGGAGGCCGAGGCGGGTGGATCATGAGGTCAGGAGTTACCAGCCTGCCAACATGGTGAAACCCCATCTCTACTAAAAAAACAAAAAAAATTAGCCAGTCGTAGTGGCAGGCACCTGTAATCCCAGCCACTCGGGAGGCTGAGGCAGAGAATTGCTTGAACCTGGGAGGTGGAGATTGCTGTGCACCAAAATCACACCACTGCACTTGAGCCTGGGCGACAGAGGGAGACTCATCTGAAAAAAAAAAAAAAAAAAAAATTAGCCGGTTATGGTGGCAGGTGCCTGTGATCCCAGCTACTTGGGAGGCTGAGGCAGGAGAATTGCTTGAACCCGGGAGGCAGAGGTTGCAGTGAGCTGAGATCGCACCACTGCACTCCAGCCTGGAGGACAAGAGTGAGACTTGTCTGATTGGAAAAAAAAAAAAAA","GGCTGGGCGCAGTGGCTCACACCTGTAATCCCAGCACTTAGGGAAGCTGAGGCGAGTAGATCACCTGAGGTCAGGAGTTAGAGACCAGCCTGGCCATCATGGTGAAACCCCGTCTCTACTAAAGATACCAAAAATTAGCTGAGTGTGGTGCTGGGTGCCTGTAATCCCAGAAACTCAGGGTGCCTGTAATCCCAGCAACTCAGGGTGCCTTTAATCCCAGCAACTGAGGGTACCAGTAATCCCAGCAACTCAGGGTGTCTTTAATCCTAGCAACTGAGGGCACCTGTAATCCCAGCAACTCAGGAAGCTGAGACAGGAGAAGTACTTGAACCCAGAAGGCAGAGGTTGCAGTGAGCCGATATTGCACCATTGCACTCCAGTCTGGGCAACAAGAGTGAAACTCTGTCTCAAAAAAAAA"
"chr16","4259838","4260446","JH378118","18053084","18053501","263","13793246","GGCCGGGTGCAGTGGCTCACGCCTGTAATCGCAGGACTTTGGGAGGCCAAGGCAGGTGCATCACCTGAGGTCAGGATTTCAAGACCATCCAGCCTGATCAACATGGTGAAACCCTGTCTCTACTAAAAATATAAAAATTGGCCGGGCACAGTGACTCACGCCTGTAATCCCAGCACTTTGGGAGGCTGAGGCAGGTGGATCACAAGGTCAGGAGATCGAGACCATCCTGGCTAACACAGTGAAACCCCGTCTCTACTAAAAATATAAAAAATTAGCCGGGCGTGGTGGTAGGCACCTGTAGTCCCAGCTACTCGGGAGACTGAGGCAGGAGAATGGCGTGAACCTGGGAGGTGGAGCTTGCAGTGAGCAGAGATCGCGCCACTGTACTCCAGCCTGGGTGACAGAGCGAGACTCCGTCTCAAAAAAAAAAAAAAAAAAAAAAATTAGCTGGGCGTGGTGGCGGGCACCTGTAATCCCAGCTACTTGGGAGGCTGAGGCAGGAGAATTGCTTGAACCTGGGAAGTGGAGGTTGCAGTGAGCTGAGATTGTGCCCTTGTACTCCAGCCTGGGCAATAAAAGCAAAACTCCGTCTTAAAAAAAAAAAAAAAA","GGCTGGGCGCAGTGGCTCACACCTGTAATCCCAGCACTTAGGGAAGCTGAGGCGAGTAGATCACCTGAGGTCAGGAGTTAGAGACCAGCCTGGCCATCATGGTGAAACCCCGTCTCTACTAAAGATACCAAAAATTAGCTGAGTGTGGTGCTGGGTGCCTGTAATCCCAGAAACTCAGGGTGCCTGTAATCCCAGCAACTCAGGGTGCCTTTAATCCCAGCAACTGAGGGTACCAGTAATCCCAGCAACTCAGGGTGTCTTTAATCCTAGCAACTGAGGGCACCTGTAATCCCAGCAACTCAGGAAGCTGAGACAGGAGAAGTACTTGAACCCAGAAGGCAGAGGTTGCAGTGAGCCGATATTGCACCATTGCACTCCAGTCTGGGCAACAAGAGTGAAACTCTGTCTCAAAAAAAAA"
"chr16","4899850","4900511","JH378118","18053084","18053501","313","13153234","GGCCAGGCACGGTGGCATGCACCTGTAATCTCAGCTCTTTGGGAGGCTGAGGCAAGAGGATCACTTGAGCCCAGGAGTTGGTGATTGCAGTGAGCTCTGATCACTCCACTGCACTCCAGCCTGGGTGACAGAGTGAGATCCTGTCTCTACGAAAAAAAGACAAGACACAAATACGTTAAAAGTAAAATGATATAAAAAGATATTCCAGTGGGGCACAGTGGCTCACCCCTATAATCCCAACACTTTGGGAGGCTGAGGTGGGTGGATCACCTGAGGTCAGGAATTCAAGACCAGCCTGACCAACATGGAGAAACCCGTCTCTACTAAAAATACAAAATTAGCCGGGTGTGGTGGCACATGCCTGTAATCCCAGCTACTCAGGAGGCTGAGAATGGCTTGAACCTGGGAGGTGGAGGTTGTGGTGAGCCGAGATTGCACCACTGCACTCCAGCCTGGGCAACAAGAGCTGAAACTCCGTCGAAAAAAAAAATTAGCCTGGCGTGGTGGCGGGAGCCTGTAATCCCAGCTACTGGGGAGGCTGAGGCAGGAGAATCACTTGAACCTGGGAGGCAGAATTTGCAGTGAGCCGAGATCGCGCCACCACACTCCAGCCTGGGTGACAAAAACGAAACCCCATCTCAAAAAAATTAAAAAATAACAAA","GGCTGGGCGCAGTGGCTCACACCTGTAATCCCAGCACTTAGGGAAGCTGAGGCGAGTAGATCACCTGAGGTCAGGAGTTAGAGACCAGCCTGGCCATCATGGTGAAACCCCGTCTCTACTAAAGATACCAAAAATTAGCTGAGTGTGGTGCTGGGTGCCTGTAATCCCAGAAACTCAGGGTGCCTGTAATCCCAGCAACTCAGGGTGCCTTTAATCCCAGCAACTGAGGGTACCAGTAATCCCAGCAACTCAGGGTGTCTTTAATCCTAGCAACTGAGGGCACCTGTAATCCCAGCAACTCAGGAAGCTGAGACAGGAGAAGTACTTGAACCCAGAAGGCAGAGGTTGCAGTGAGCCGATATTGCACCATTGCACTCCAGTCTGGGCAACAAGAGTGAAACTCTGTCTCAAAAAAAAA"
"chr16","4919663","4920295","JH378118","18053084","18053501","281","13133421","CTGGGCGCAGTGGCTCACACCTATAATCCCAGCACTTTGGGAGGCCGAGGTGGGGTGGATCACTTGAGGTCAGGAGTTTGAGACCAGCCTGGCCAACATGGTGAAACCCCATCTCTTCTAGAAAAATACAAAATTAGGCTGGGCGCGGTGGCTCACGCTTGTAATCCCAGCACTTTGGGAGGCTGAGGCAGGCGGATCATCTGAGGTTGGGAGTTCGAGACCAGCCTGACCAACATAGAGAAACCCTGTCTCTACTAAAAATACAAAATTAGCCGGGCGTGGTGGCGCATGCCTGTAATCCCAGCTAGTCAGGAGGCTGAGGCAGGAGAATCCCTTGAACTGGGGAGGCAGAGGTTGTGGTGAGCCCAGATCGTGCCATTGCACTCCAGCTTGGGTAAGAAGAGCAAAACTCTGTCTAAAAAATATATATATTTATACATATATATATATTTATATATATAATTAGCCACGCATAGTGGCACACACCTGTAACCCCAGCTACCTGGGAGGATGAGGCAGGAGAATAGCTTGAACTTGGGAGGTGGAGGTTGCACTGAGCTGAGACTGCGCCATTGCATTCCAGCCTGGGCAACAAGAGCGAAACTGTCTCAAAAAAAAAAAAAAAAAAAAAAA","GGCTGGGCGCAGTGGCTCACACCTGTAATCCCAGCACTTAGGGAAGCTGAGGCGAGTAGATCACCTGAGGTCAGGAGTTAGAGACCAGCCTGGCCATCATGGTGAAACCCCGTCTCTACTAAAGATACCAAAAATTAGCTGAGTGTGGTGCTGGGTGCCTGTAATCCCAGAAACTCAGGGTGCCTGTAATCCCAGCAACTCAGGGTGCCTTTAATCCCAGCAACTGAGGGTACCAGTAATCCCAGCAACTCAGGGTGTCTTTAATCCTAGCAACTGAGGGCACCTGTAATCCCAGCAACTCAGGAAGCTGAGACAGGAGAAGTACTTGAACCCAGAAGGCAGAGGTTGCAGTGAGCCGATATTGCACCATTGCACTCCAGTCTGGGCAACAAGAGTGAAACTCTGTCTCAAAAAAAAA"
"chr16","5124255","5124811","JH378118","18053084","18053501","213","12928829","GGCCAGGTGCGGTGGCTCATGCGTGTAATCCCAGCGCTTTGGGAGGCTGAGGCAAGTGGATCACCTGAGGTCAGGAGTTTGAGACCAGCCTGGCCAACATGGGGAAATCCCTGTCTCTACTAAAAATACAAAAATTGGGCCGGGTGTGGTGGCTCACACCTGTAATCCCAGCACTTTGGGAGACTGAGGTGGGCGGATCACCCAAGGTCAGGAGTTTGAGACCATCCTGGCCAACATGGTGAAACCCCGTCTCTACTAAATAAATACAAAAAAGTAGCCGAGCGTGTTGGCGGATGCCTGTAATCCCAGCTACTTGGGAGGCTGAGGCAGGAGAATTGCTTGAACCCTGAGAGGTGGAGGTTGCAGTGAGCAGAGATTGTGCCACTGCACTCTGGCCTGGGCGACAAGAGGGAGTCTCTGTCTTAAAAAAAAAAAAAAAAAAAATTAGCTGGAAATCGCTTGAACCCAGGAGGCGGAGGTTGCAGTGAGCCGAGATTGTGCCACTGCACTCTGGCCTGGGCGACAAGAGCGAGATTCTGTCTCAAAAAAAAAAAAGA","GGCTGGGCGCAGTGGCTCACACCTGTAATCCCAGCACTTAGGGAAGCTGAGGCGAGTAGATCACCTGAGGTCAGGAGTTAGAGACCAGCCTGGCCATCATGGTGAAACCCCGTCTCTACTAAAGATACCAAAAATTAGCTGAGTGTGGTGCTGGGTGCCTGTAATCCCAGAAACTCAGGGTGCCTGTAATCCCAGCAACTCAGGGTGCCTTTAATCCCAGCAACTGAGGGTACCAGTAATCCCAGCAACTCAGGGTGTCTTTAATCCTAGCAACTGAGGGCACCTGTAATCCCAGCAACTCAGGAAGCTGAGACAGGAGAAGTACTTGAACCCAGAAGGCAGAGGTTGCAGTGAGCCGATATTGCACCATTGCACTCCAGTCTGGGCAACAAGAGTGAAACTCTGTCTCAAAAAAAAA"
"chr16","8088191","8088522","JH378114","21211700","21212024","70","13123509","GGCTGGGCGCGGTGGCTTTTGACCATAATCCCAGCACTTTGGGAGGCCGAGGTGGTCAGGTCACCTGAGGTCAGGAGTTCAAGAGCAGCCTGGCCAACGTGGTGAAACTCTGTCTCTACCAAAAATACCAAATAATAATAATAATAATAATAATAATAATAAAATAATATAATTGCAGGGTGTGGCAGCCCATGCATGTAATGCCAGCTACTTGGGAGACTGAGGCAGGATAATCACTTCAACCCAAGAGGCGGAGGTTGCAGTGAGCTGAGATCATGCCATTGCATTCCAGCGTAGGCAACAAGAGCGAAACTCTGTTTCAAATAAATAAA","GGCTGGGTGCGGTGGCTCAGGCCTGTAATCCCAGCACTTTGGGAGGCCGAGGTGGGTACATCACCTAAGGTCAGGAGTTCAAGACCAGCCTGACCAACATGGTAAAACCCTGTCTCTACTAAAATTACAAAAGAAAATTAGAAAAAAAAAAAAGAAAGAAAGAAAATTAGATGGCATGGTGGTGGCGGGCACCTGTAATTTCAACTACTCGGGAGGCTAAGGCAGGAGAATCACTTGAACCCAGGAGGTGGAGGTTGCAGTGAGCCGAGATCACACCATTGCACTGCAGCCTGGGCAATAAGAGCAAAACTCCATCTCAAAAAAA"
"chr16","9762791","9763467","JH378118","18053084","18053501","323","8290293","CAGGCATGGTAGCTCACGCCTGTAATCTCAGCACTTTGGGAGGCCGAGGTGCGCAGATCACTTGAGGTCAGGTGTTGGTGACCAGCCTGGCCAACATGGTGAAACCCTATCTCTACTAAAAATACAAAAATTATGGCCGGGCGCAGTGGCTCACGCCTGTAATCCCAGCACTTTGGGAGGCCGAGGTGGGCAGATCACTTGAGGTCAGGAGTTCAAGACCAGCCTAGGCAACATAGTGAAACCCCGTTGCTACTAAAAATACAAAAATTAGCTGGGCGTGATGGCACATACCTGTAGTCCCACCTACTTGGGAGGCTGAGGCAGGAAAATCGCTTGAACCTGGAGGCAGAGGTTGCAGCGAGCCAAGACTGTGCCAATGCACCACAGCCTGGATAACAGAGTGAGACTCAATCTCAAAAAAAAAAAAAAAAAAAAAAGGCGGGCTGGTGGCTCATGCCCATGCAAACCCCGTCTCTACTAAAAGGACAAAAATTAGCTGGGCATGGTGGCGGGGGCCTGTAATCTCAGGATTACAGGAGATACTACTACTCGGGAGGCTGAGGCAGTAGAATTGCTTGAACCAGGGAGGCGGAGGTTGCAGTGAGCTGAGATCGCGCCATTGCACTCCAGGCTGGGTGACAACAATGACTCCGTCTCAAAAACAACAACAACAACAA","GGCTGGGCGCAGTGGCTCACACCTGTAATCCCAGCACTTAGGGAAGCTGAGGCGAGTAGATCACCTGAGGTCAGGAGTTAGAGACCAGCCTGGCCATCATGGTGAAACCCCGTCTCTACTAAAGATACCAAAAATTAGCTGAGTGTGGTGCTGGGTGCCTGTAATCCCAGAAACTCAGGGTGCCTGTAATCCCAGCAACTCAGGGTGCCTTTAATCCCAGCAACTGAGGGTACCAGTAATCCCAGCAACTCAGGGTGTCTTTAATCCTAGCAACTGAGGGCACCTGTAATCCCAGCAACTCAGGAAGCTGAGACAGGAGAAGTACTTGAACCCAGAAGGCAGAGGTTGCAGTGAGCCGATATTGCACCATTGCACTCCAGTCTGGGCAACAAGAGTGAAACTCTGTCTCAAAAAAAAA"
"chr16","9769317","9769634","JH378153","10517405","10517727","57","748088","GGTTGGGCATGGTGGCTCACACCTGTAATGCCAGCACTTTGGGAGGCGGGCAGATCACCTGAGGTCAGGAGTTCAAGACCAGCCTGGCCAACATGGTGAAATCCTGTCATTACAAAAATACAAAAAAAAAAAAAAAAAAAAAAAAAAAAAGCCAGTAATGATAGTGGGTGCGTATAATCCCAGCTACTTTGGAGGCTAAGGCAGGAGACTCACTTGAACCCAGGAGGCGGAGGTTATGGTGAGCCGAGATCACACCATTGCACTCCAGCCTGGGCGACAAGAGCAAAACTCCATCTCAAAAAAAAAAAAAAAAAAAAA","GGCCGGGCGTGGTGGCTCACGCCTGTAATCCCAGCACTTTGGGAGGCCGAGGTGGGTGGATCATGAGGTCAAGAGATCGAGACCATCCTGGTCAACATGGTGAAACCCTGTCTCTACTAAAAAAAAAAAAAAAAAAAAAAAATACAAAAAAATTAGCTGGGCATGGTGGCGCATGCCTGTAATCCCAGCTACTCCGGAGGTTGAGGTAGGAGAATTGCCTGAACCCAGGAGGCGGAGGTTGCGGTGAGCCGAGATCGCGCCATTGCACTCCAGCCTGGGTAACAAGAGCAAAACTCCGTCTCAAAAAAAAAAAAAAAAAAGAA"
"chr16","13753079","13753710","JH378118","18053084","18053501","278","4300005","GGCTGATTGTGATGGCTCACACTTGTAATCCCCTCACTTTGGGAGGCCAAAGCGGGAGCATCACCTGAGGTCAGGAGTTCAAGACCAGCCTGGCCAACATGGTGAAACCCCATCTCTACTAAAAATAAAAAATTAGCTGGGCACAGTGACTCATGCCTGTAATCCCAGCACTTTGGGAGGCCGAGGCAGGCAGATCACAATCACGAGGTCAGGAGTTCGAGACCAGCCTGACCAACATGGTGAAACCCCGTCTCTACTAAAAATAGAAAAATTAGCCAGGCGTGGTGGCACACGCCTGTAATCCCAGCTCCTCAGGAGACTGAGGCAGGAGAATCACTTGAACCCAGGAGGTGGAGGTTGCAGTGAGCAGAGATCGCACCACTGCACTCCAGCCTGGGTAACAGAGTGAGACTCCGTCTCAAAAAAAAAAAAAAAAAAAAAAAAAAAACGAAATTAACCAGGTGTGGTGGCACATGCCTGTAATCCCAGCTACTTGGGAGGCTGAGGCAGGAGAATCGCTTGAACCCGGGAGACAGAGGTTCCAGAGAACTGAGATCATGCCATTGCACTCCAGCCTGGGCAACAAGAGTGAAACTCCATCTAAAAAATAAATAAATACATAAACAAACAAA","GGCTGGGCGCAGTGGCTCACACCTGTAATCCCAGCACTTAGGGAAGCTGAGGCGAGTAGATCACCTGAGGTCAGGAGTTAGAGACCAGCCTGGCCATCATGGTGAAACCCCGTCTCTACTAAAGATACCAAAAATTAGCTGAGTGTGGTGCTGGGTGCCTGTAATCCCAGAAACTCAGGGTGCCTGTAATCCCAGCAACTCAGGGTGCCTTTAATCCCAGCAACTGAGGGTACCAGTAATCCCAGCAACTCAGGGTGTCTTTAATCCTAGCAACTGAGGGCACCTGTAATCCCAGCAACTCAGGAAGCTGAGACAGGAGAAGTACTTGAACCCAGAAGGCAGAGGTTGCAGTGAGCCGATATTGCACCATTGCACTCCAGTCTGGGCAACAAGAGTGAAACTCTGTCTCAAAAAAAAA"
"chr16","13951847","13952482","JH378118","18053084","18053501","292","4101237","GGCCAGGTGCGGTGGCTCATGCCTGTAATCCCAGCACTTTGGGAGGCTATGGCAGCGGATAACCTGAGGTCACAAGTTTGAGACCAGCCTGGCAAACATGGTGAAACCGTCTCTACTAAAAATACAAAAATTACACCAGGCGCGGTGGCTCATGCCTGTAATCCCAGCACTTTGGAAGGCCGAGGCAGGTGGATCATGAGGTCAGGAGATCAAGACCATCCTGGCTAACGCAGTGAAACCCCGTCTCTACTAAAAATATAAAAAATTGGCCAGGCGTGGTGGCGGACGCCTGTAGTCCCAGCTACTCGGGAGGCTGAGCCAGGAGAATGGCGTGAACCCGGGAGGCGGAGCTTGTGGTGAGCCGAGATAGCGCCACTGCACTGCCGCCTGGGTGACAGAGTGAGACTCTGTCTCAAAAAACAAAACAAAACAAAAACCAAAAACAAAAACAAAAAAACAAAAATTAGCCAGGTGTGGTGGTGCACGCCTGTCATCCCAGCTACTTGGGGGGCTGAGACGTGATAATCACTTGAACCCGGGAGGGAGAGGTTGCAGTGAGTGGAGATCACGCCATTGTATTCCAGCCTGGGGGCAAGAGCAAAACTCTGTCTCAAAAACAACAACAACAACAACAAA","GGCTGGGCGCAGTGGCTCACACCTGTAATCCCAGCACTTAGGGAAGCTGAGGCGAGTAGATCACCTGAGGTCAGGAGTTAGAGACCAGCCTGGCCATCATGGTGAAACCCCGTCTCTACTAAAGATACCAAAAATTAGCTGAGTGTGGTGCTGGGTGCCTGTAATCCCAGAAACTCAGGGTGCCTGTAATCCCAGCAACTCAGGGTGCCTTTAATCCCAGCAACTGAGGGTACCAGTAATCCCAGCAACTCAGGGTGTCTTTAATCCTAGCAACTGAGGGCACCTGTAATCCCAGCAACTCAGGAAGCTGAGACAGGAGAAGTACTTGAACCCAGAAGGCAGAGGTTGCAGTGAGCCGATATTGCACCATTGCACTCCAGTCTGGGCAACAAGAGTGAAACTCTGTCTCAAAAAAAAA"
"chr16","19006984","19007584","JH378118","18053084","18053501","263","953900","GGTGGCTGATGCCTGTAAACCCAGCATTTTGGGAGGCCGAGGCTGGTGGATCACCTGAGGTCAGGTGTTCGAGACCAGTCTGGCCAACATGGTGAAACCTCGTCTCTACCAAAAATACAAAAATTAGTTGGGTGTGGCCGGGTGTGGTGGCTTACGCTTGTAATCTCAGCACTTTGGGAGGCCGAGGTGGGTGGATCACGAGGTCAGGAGTTCAAGACCAGCCTGGCCAAGATGGTGAAACCCTGTCTCTACTAAAAATACAAAAAATTAGCCAGGCATGGTGGCGGGTGCCTGTAATCCCAGCTACTCGGGAGGCTGAGGCAGAGAATTGCTTGAACCTGGGAGGTGGAGGTTGCAGTGAGCCGAGATTGTGCCACGACACTCCAGCCTGGGTGACAGAGCGAGACTCTGTCTAAAAAAAAAAAAAAAAATTAGTTGGATGTGGTGGTGGGTGTCTGTAATCTCAGCTACTCAGGAGACTGAATCAGGAGAATCACTTGAACCCAGGGGGCTGGAGGTTGCAGTGAGCCGAGATCTTGCCATTGCACTCCAGCCCGGGCGACAAGAGCAAAACTCTCTTTCAAAAAAAAAAAAAAAAAGA","GGCTGGGCGCAGTGGCTCACACCTGTAATCCCAGCACTTAGGGAAGCTGAGGCGAGTAGATCACCTGAGGTCAGGAGTTAGAGACCAGCCTGGCCATCATGGTGAAACCCCGTCTCTACTAAAGATACCAAAAATTAGCTGAGTGTGGTGCTGGGTGCCTGTAATCCCAGAAACTCAGGGTGCCTGTAATCCCAGCAACTCAGGGTGCCTTTAATCCCAGCAACTGAGGGTACCAGTAATCCCAGCAACTCAGGGTGTCTTTAATCCTAGCAACTGAGGGCACCTGTAATCCCAGCAACTCAGGAAGCTGAGACAGGAGAAGTACTTGAACCCAGAAGGCAGAGGTTGCAGTGAGCCGATATTGCACCATTGCACTCCAGTCTGGGCAACAAGAGTGAAACTCTGTCTCAAAAAAAAA"
"chr16","19554918","19555551","JH378118","18053084","18053501","281","1501834","GGCCGGGCGCAGTGGCTCACACCTGTAATCCCAGCACTTTGGGAGGCCGAGGCGGGTGGATCACTTGAGGTCAGGAGTTCAAGACCAGCCTGGCTGACATGGTGAAACCCTGTCTCTACTGAAAACACAAAAATTAGGCCGGGCATAGTGGCTCATGCCTGTAATACCAGCACTTTGGGAGGCCGAGGTGGGTGGATCACCTGAGGTCAGGAGTTTGAGACCAGCTTGACCAACATGGTGAAACCCCGTCTCTACTAAAAATATAAAAATTAGTCTGGCATGGTGGCAGATGCCTGTAATCCCAGCTACTCAGGAGGCTGAGGCAGGAGAATTGCTTGAACCTGGAAGGTGGAGGTTGTAATGAGCCAAGATCACACCACTGCACTCCAGCCACTGTACTCCAGCCTGGGTGACAGAGTGAGACTCTGTCTCAAAAAACATACATACACACACATACACACACACACACACACACACACAAATTAGCTGGACGTGATAGCACACCCCTGTAGTCCCAGCTGCTTGAGAGACCGAGGCACAAGAATCACACGAACCCGGGAGGCGGAGGTTCCTGTGAGCCAAGATCGCACCATTGTACTCCATTCTGGGTGACAAGAGTGAAGCTCTGTCTCAA","GGCTGGGCGCAGTGGCTCACACCTGTAATCCCAGCACTTAGGGAAGCTGAGGCGAGTAGATCACCTGAGGTCAGGAGTTAGAGACCAGCCTGGCCATCATGGTGAAACCCCGTCTCTACTAAAGATACCAAAAATTAGCTGAGTGTGGTGCTGGGTGCCTGTAATCCCAGAAACTCAGGGTGCCTGTAATCCCAGCAACTCAGGGTGCCTTTAATCCCAGCAACTGAGGGTACCAGTAATCCCAGCAACTCAGGGTGTCTTTAATCCTAGCAACTGAGGGCACCTGTAATCCCAGCAACTCAGGAAGCTGAGACAGGAGAAGTACTTGAACCCAGAAGGCAGAGGTTGCAGTGAGCCGATATTGCACCATTGCACTCCAGTCTGGGCAACAAGAGTGAAACTCTGTCTCAAAAAAAAA"
"chr16","19576859","19577465","JH378118","18053084","18053501","251","1523775","GGCCAGGCATGGTGGCTCACACCTGTAATCCCAGCCCTTTGGGAGGCCGAGGCAGGTGGATCACCTGAGGTCAGGAGTTCGAGACCAGCCTGGCCAACATGGTGACACCCCACTCTACCAAAAATACAAAAATTAGGTTGGGTGCAGCGGTTCACACCTGTAATCCCAGCACTTTGGGAGGCCAAGGTGGATGGATCACCTGAGGTCAGGAGTTTGTGACCAGCCTGGCCAACATGGCGAAACCCTGCCTCTACTAAAAATAAAAAATTAGCCAGGTGTGGTGGCATGCGCCTGTAATCCTAGCTACTGAGGCAGGAGAATCGCTTGGACCAGGGAAGCAGAGTTTGCAGTGAGCCAAGATCACGCCACTGCACTCTAGCCTGGGTGACAGAGTAAGACTCCATCTCAAAAAAAAAAAAAAATACAAATATTAGCTGGGCATGGTGGCGCACACCTGTAGTTCTGGCTACTCAGGAGGCTGAGGCAGGAGAATTGCTTGAACCCAGAAGGCAGAGGTTGCAGTGAGCTGAGATTGTGCCATTGCACTCAGCCTGGGCAACAAAAGTGAAACTCCATCTCAAAATAAATAGATAAATAAATAAATAAA","GGCTGGGCGCAGTGGCTCACACCTGTAATCCCAGCACTTAGGGAAGCTGAGGCGAGTAGATCACCTGAGGTCAGGAGTTAGAGACCAGCCTGGCCATCATGGTGAAACCCCGTCTCTACTAAAGATACCAAAAATTAGCTGAGTGTGGTGCTGGGTGCCTGTAATCCCAGAAACTCAGGGTGCCTGTAATCCCAGCAACTCAGGGTGCCTTTAATCCCAGCAACTGAGGGTACCAGTAATCCCAGCAACTCAGGGTGTCTTTAATCCTAGCAACTGAGGGCACCTGTAATCCCAGCAACTCAGGAAGCTGAGACAGGAGAAGTACTTGAACCCAGAAGGCAGAGGTTGCAGTGAGCCGATATTGCACCATTGCACTCCAGTCTGGGCAACAAGAGTGAAACTCTGTCTCAAAAAAAAA"
"chr16","19983557","19984148","JH378118","18053084","18053501","244","1930473","GGCCGAGTGCGGTGGCTCATGCCTGTAATCCCAGCACTTTGGGAGGCCGAGACAGGTGAATCACCTGAGGTCTGGAGTTTGAGACCAGCTGACCAACATGGTGAAACCCTGTCTCTACTAAAAATACAAAAAATTGGCTGAGCGCAGTGGCCACGCCTGTTATCCCAGTACTTTGGGAGGCCGAGGCGGGTGGATCACGAGGTCAGGAATTCGAGACCAGCCTGACCAACATGGTGAAGCCCCGTCTCTACTAAAAATAAAAAAATTAGCCAGGTGTGGTGGTGCGCCCCTGTAAACCCAGCTACTCAGGAGGCTGAGGCAGGAGAATCACTTGAATCTGGGAGGCGGAGGTTGCAGTGAGCCAAGATCGAGCCACTGTACTCCAGCCTGGGAGACGGAGTGAGACTCCATCTAAAAAAAAAAAAAAATTAGCCAGGCGTGGTGGCACAAGCCTGTAATCCCAGCTACCTGGGAGGCTGAGATAGGAGAATTCCTTGAATCTGGGAGGCGGAGGTTGCAGTGAGCTGAGATTGTGCCATTGCACACCAGCCTGGGTGACAAGAGCAAAATTCCATCTCAAAAAAAAAAAAAA","GGCTGGGCGCAGTGGCTCACACCTGTAATCCCAGCACTTAGGGAAGCTGAGGCGAGTAGATCACCTGAGGTCAGGAGTTAGAGACCAGCCTGGCCATCATGGTGAAACCCCGTCTCTACTAAAGATACCAAAAATTAGCTGAGTGTGGTGCTGGGTGCCTGTAATCCCAGAAACTCAGGGTGCCTGTAATCCCAGCAACTCAGGGTGCCTTTAATCCCAGCAACTGAGGGTACCAGTAATCCCAGCAACTCAGGGTGTCTTTAATCCTAGCAACTGAGGGCACCTGTAATCCCAGCAACTCAGGAAGCTGAGACAGGAGAAGTACTTGAACCCAGAAGGCAGAGGTTGCAGTGAGCCGATATTGCACCATTGCACTCCAGTCTGGGCAACAAGAGTGAAACTCTGTCTCAAAAAAAAA"
"chr16","20117717","20118289","JH378118","18053084","18053501","224","2064633","GGCTGGGTGCGGTGGCTCACGCCTGTAATCCCAGCACTTTGGGAGGCCAAGGCGGGTAGATCATCTGAGGTCAGGAGTTCAAGACCAGCCTGGCCAACATGGTGAAACCCCGTCTCTACTAAAAATATTTTTAAAAGGCCAGGCGTGGTGGCTCACGCCTGTAATCCCAGCACTTTGGGAGGCCGAGGCGGGCAGATCATGAGGTCAGGAGTTCGAGACCATCCTGGCTAACACGGTGAAACCCCCGTCTCTACCAAAAAATACAAAAAATTAGCCGGGCATGGTGGCAGGTGCCTGTAGTCCCAGCTACTCGGGAGGCTGAGGCAGGAGGATGGCGTGAACCCAGGAGACAGAGCTTCCAGTGAGCTGAGATCGTGTCACTGCACTCCAGCCTGGGCGACAGAGGAGATTCTGTCTCAAAAAAAAAAAAAAAAAATTAGCTTGGTGTGGTGGCAGGTGCCTGTAATCCCAGTTACTCGGGAGGCTGAGGCAGAGGTTTCAGTGAACCGAGATCGCGCCATTGCACTCCAGCCTGGGCAACAAGAGTGAAACTCCGTCTCAAAGGAAAAAAAA","GGCTGGGCGCAGTGGCTCACACCTGTAATCCCAGCACTTAGGGAAGCTGAGGCGAGTAGATCACCTGAGGTCAGGAGTTAGAGACCAGCCTGGCCATCATGGTGAAACCCCGTCTCTACTAAAGATACCAAAAATTAGCTGAGTGTGGTGCTGGGTGCCTGTAATCCCAGAAACTCAGGGTGCCTGTAATCCCAGCAACTCAGGGTGCCTTTAATCCCAGCAACTGAGGGTACCAGTAATCCCAGCAACTCAGGGTGTCTTTAATCCTAGCAACTGAGGGCACCTGTAATCCCAGCAACTCAGGAAGCTGAGACAGGAGAAGTACTTGAACCCAGAAGGCAGAGGTTGCAGTGAGCCGATATTGCACCATTGCACTCCAGTCTGGGCAACAAGAGTGAAACTCTGTCTCAAAAAAAAA"
"chr16","20574957","20575888","JH378118","18053084","18053501","543","2521873","GGCCAGGCGTGGTGGCTCATGCCTGTAATCCCAGCACTGTGAGAGGCCGAGGCGGGCGGATCACCTGAGCTGAGGAGTTCGAGACCAGCCTGGCCAACATGGCGAAACCCCATCTCTACTAAAAACACAAAAATTAGGCCAGGTGTGGTGGCTCACACCTGTAATCCCAGCACTTTGGGAGGCCAAGGCGGGCGGATCACCTGAGGTCAGGAGTTCCAGACCTGCCTGGCCAACATGGTGGAATCCCATCTCTACTAAAAATACAAAAATCTGCCAGGTGTGGTGGCACACTTCTGTAATCCCAGATACTCAGGAGGCTGAGGCAGGAGAATCACTTGAACCCTGGAGATGGAGGTTGCAGTGAGCCAAGATCAAGAGATTGCACTCTAGCCAGGGTGACTAGAGTGAGACTCGGTCTCAAAAAAAATGTAATTAATTAATTAATTAATACAAAAATTAGCTGGGCGTGGGCTAGGTGTGGTGGCTCACGCCTGTAATCCCAGCACTTTGGGAGGCCGAGACAGGCGGATCACCTGAGGTCAGGAGTTCAAGACCAGTTTAACCAACATGGAGAAACCCCATCTCTACTAAAAATACAAAATTAGCTGGGCGTGGTGGTGCATGCCTGTAATCCCAGCTACTCGGGAGGCTGAGGCAGAAGAATCGCTTGAGCCTGGTAGGCGGAGATCGTGGTGAGCCGAGATCGCGCCATTGCACTCCAGCCTGGACAACAAGAGCGAAACTCCGTCTAAAAAAAAAAAAAAAATTAGCTGGGCATGGTAACAGGCGCCTGTAAACCCAGTTTCCTCGGGAGGCTGAAGCAGAATTGCTTGATCCCAGAGGCAGAGGTTGCAGTGAGCCAAGATAGTGCCATTGCAGTCCAGCCTGGGCAACAAGAGTGAAACTCCGTCTCAAAAAAAAAAAAAAAAAAA","GGCTGGGCGCAGTGGCTCACACCTGTAATCCCAGCACTTAGGGAAGCTGAGGCGAGTAGATCACCTGAGGTCAGGAGTTAGAGACCAGCCTGGCCATCATGGTGAAACCCCGTCTCTACTAAAGATACCAAAAATTAGCTGAGTGTGGTGCTGGGTGCCTGTAATCCCAGAAACTCAGGGTGCCTGTAATCCCAGCAACTCAGGGTGCCTTTAATCCCAGCAACTGAGGGTACCAGTAATCCCAGCAACTCAGGGTGTCTTTAATCCTAGCAACTGAGGGCACCTGTAATCCCAGCAACTCAGGAAGCTGAGACAGGAGAAGTACTTGAACCCAGAAGGCAGAGGTTGCAGTGAGCCGATATTGCACCATTGCACTCCAGTCTGGGCAACAAGAGTGAAACTCTGTCTCAAAAAAAAA"
"chr16","20816618","20817242","JH378118","18053084","18053501","267","2763534","GGCCCGGCGTGGTGGCTCATGCCTGTAATCCCAGCACTTTGGGAGGCCGAGGCCGGCGGATCACCTGAGGTCAGGAGTTTGAGACCACCCTGGCCAACACGGTGAAAACCTGTCTCTACTAAAAATACAAAAATTAGCCAGGCGCAGTGGCTCACGTCTGTAATTCCAGCACTTTGGAGGGCCGAGGGGGGCAGATCACAAGGTCAGGAGTCCAAGACCAGCCAGGCCAACATAGTGAAACCCGGTCTCTACTAAAAATACAAAAAATTAGCCGGGCGTGGTGGCGGACCCCTGTAGTCCCAGCTACTCAGGAGGCTGAGACAGGAGAATCTCTTGAACCCAGGAGGCAGAGGTTGCAGTGAGCCAAGATCATGCCATTCCACTCCAGCCTGGGCGACAGTGCAAGACTCTGTCTCAAAAACAAAAACAAAAAACCCCCAAACCAAAAATTAGCCAGGCGTGGTGGCATGCACCTGTAGTCCCAGCTACTTGGGAGGCTAAGGCAAGAGAATAGCTTGAACCCAGGAGGCAGAGGTTGCAGTGAGCCGAGATAGTGCCATTGCACTCCAACGTGGGTGACAAGAGCAAAACTCTGTCTCAAAAAAAAAAAAAAAAAAGGAAGGAA","GGCTGGGCGCAGTGGCTCACACCTGTAATCCCAGCACTTAGGGAAGCTGAGGCGAGTAGATCACCTGAGGTCAGGAGTTAGAGACCAGCCTGGCCATCATGGTGAAACCCCGTCTCTACTAAAGATACCAAAAATTAGCTGAGTGTGGTGCTGGGTGCCTGTAATCCCAGAAACTCAGGGTGCCTGTAATCCCAGCAACTCAGGGTGCCTTTAATCCCAGCAACTGAGGGTACCAGTAATCCCAGCAACTCAGGGTGTCTTTAATCCTAGCAACTGAGGGCACCTGTAATCCCAGCAACTCAGGAAGCTGAGACAGGAGAAGTACTTGAACCCAGAAGGCAGAGGTTGCAGTGAGCCGATATTGCACCATTGCACTCCAGTCTGGGCAACAAGAGTGAAACTCTGTCTCAAAAAAAAA"
"chr16","21054922","21055508","JH378118","18053084","18053501","243","3001838","GGCCGGGTGCGGTGGCTCACACCTATAATCCCAGCACTTTGAGAGTCTGAGGCAGGCGGATCACCTGAGGTCAGGAGTTCCAGACCAGCCTGGCCAACATGGTGAAACCCAGTCTCTACTAAAAATACAAAAAAAGACCGGGCACAGTGGCTCACGCCTGTAATTCCAGCACTTTGGGAGGCCGAGGCAGGTGGATCACCTGAGGTTGGGAGTTCGCGACCAGCCTGACCGACATGGAGAAATCCCATCTCTACTAAAAATACAAAATTAGCCGGGCGTGGTGGCACATGCCTGTAATTCCAGCTACTCAGGAGGCTGAGGGAGGAGAATCACTTGAACCTGGGAGGCGGAAGTTGTGGCGAGCCAAGATCACGCCATTGCACTCCAGCCTGGGCAACAAGAGTGAAACCCCATTTCAAAAAAAAAAAAAATTAGCCAGGGGTGGTGGTGCATTCTTGTAATACCAGCTACTCGGGAGGCTGAGGTAGGAGAATCACTTGAGCGCAGGAGGCAGATGTTGTAGTGAGCCGAGTGCCATTGCACTACAGCCTGGGCGACAAGAAAGTAACTCCACCTCAAAAAAAAAA","GGCTGGGCGCAGTGGCTCACACCTGTAATCCCAGCACTTAGGGAAGCTGAGGCGAGTAGATCACCTGAGGTCAGGAGTTAGAGACCAGCCTGGCCATCATGGTGAAACCCCGTCTCTACTAAAGATACCAAAAATTAGCTGAGTGTGGTGCTGGGTGCCTGTAATCCCAGAAACTCAGGGTGCCTGTAATCCCAGCAACTCAGGGTGCCTTTAATCCCAGCAACTGAGGGTACCAGTAATCCCAGCAACTCAGGGTGTCTTTAATCCTAGCAACTGAGGGCACCTGTAATCCCAGCAACTCAGGAAGCTGAGACAGGAGAAGTACTTGAACCCAGAAGGCAGAGGTTGCAGTGAGCCGATATTGCACCATTGCACTCCAGTCTGGGCAACAAGAGTGAAACTCTGTCTCAAAAAAAAA"
"chr16","27896431","27896766","JH378166","6401112","6401453","56","21495319","GGCCAGGCGCGGTGGCTCACGCCTGTAATCCCAGGACTTTGGTAGTCCAAGGCGGGTGGATCACCTGAGGTCAGGAGTTCAAGATCAGCCTGACCAACATGGCAAAACCTCGTCTCTACTAAAAAATACAAAAATTAGCCGGTGTGGTGGCAGGTGCCTGTAATTCCAGCTACTCGGGACGCTGAGTCATGAGAATTGCTTGAACCTAGGAGGCAGATGTTGCAATGAGCCGAGATCGCACCATTGTACTCCAGCCTGGGCGACAAGAGGGAAACTGTCTCCAAAAAAAAAAAAGAAAGAAAGAAAGAAAGAAAGAAAAAAGAAAAACAAAACAAA","GGCCAGGTGCAGTGGCTCACCCCTGTAATCCCAGCACTTTGGGAGGTCGAGGTGGGTGGATCACCTGAGGTCAGGAGTTCAAGACCAGCCTGACCAAAATGGTGAAACCCCATCTCTACTAAAAATACAAAACATTAGCCAGACATCGTGGCGGGCACCTGTAATCCCAGCTACTTGGGAGGCTGAGGCAGGAGAATTGCTTGAGCCTAGGAGGCGGAGGTTACAGTGAGCCATGATCGTGCCATTGGACTCCAGCCTGGGCTACAAGAGCGAGACTCCATCTCAAAAAAAAAAAAAAAAAAAAAAAAGAAAGAAAGAAAGAAAGAAAGAAAAGAAAGAAAG"
"chr16","36524888","36525430","JH378206","6546474","6546861","201","29978414","TTTGAGACCAGCCTGGCCATTGTGGTGAAACCCCGTCTCTACTAAAAAAAATTCAAAAAATGGCTGGGTATGGTGGCTCACGCCTGTAATCCCAGGACTTTGGGAGGCCAAGGTGGGCGGATCACCTGAGGTCAGGAGTTTGAGACCAGCCTAGCCAACATGGTGAAACCCCGTCTCTACCAAAAATACAAAAATTAGCCGGGCTTGGTGGCGCGCACCTGTAATCCCAGGTACACTGGAGGTTGAGGCACAAGAATCGTTTGATCCTGGGAGGTTGCAGTGAGCCAAGATCACGCCACTGCACTCCAGACTGGGTGACAGAGCGAGATTCCATCTCAAAACAACAACAACAAACCCAAAAAATTAGCTGGGTGTGGTGGTGGGTGCCTGTAATCCCAGCTACTTAGGAGGCTGAGGCAGAAGAATCGCTTGAACCCAGGAGGTGGAGGTTGTTGCAGTGAGCAGAGATCGCACCATTGCACTCCAGCCTGGGCAACGAGTGAAACTCCATCTCAAAAAAAAAAAAAAAAAAAGAAAAAAAAA","GGCCACACATGGTGGCTAACGCCTGTAATCCCAGCACTTTGGGAGGCCAAGTCGGGTGGATCATGAGGTCAGGAGACCAAGACCATCCTGGCCAAATGGTGAAACCCCGTCTCTACTAAAAATACAAAAATTAGCTGGGCATGGTGGCGTGTGCCTGTAATCCCAGCTACTCAGGAGGCTGAGGCAGGACAATTGCCTGAACCCAGGAGAATTAGCTGGGCATGGTGGCGTGTGCCTGTAATCCCAGCTACTCAGGAGGCTGAGGCAGGACAATTGCCTGAACCCAGGAGGCGAAGGTTGCGGTGAGCCGAGATTGTGCCATTGCACTCCAGCCTGGGTAACAAGAGCGACACTCTGTCTCAAAAAAAAAAAAAAAAAAAAAAAAAAA"
"chr16","36528224","36528842","JH378119","32351107","32351490","270","4177117","GGCCAGGCGTGGTGGCTCACGCCTGTAATCCCAGCACTTTGGGAGGCTGAGGCAGGCAGATCACCTGAGGTCAGGAGTTCAAGACCAGCCTGGCCAACATGGTGAAACTCCATCTCTACTAAAAATACAAAATTAAGCCGGGCACGGTGGCTCACATCTGAAATCCCAGCACCTTGGGAGGCTAAGGCAGGCGGATCACGAGGTCAGGAGTTCAAGACTAGCTGACCAATATGGTGAAACCCCGTGTCTACTAAAAATACAAAAAAAATTAGCTGGGCGTGGTGGCGCATGCCTGTAGTTCCAGGTACTCAGGAGGCTGAGGAAGGAGAATCACTTGAACCTGGGAGGCGGAGGTTGCAGTGAGCCAAGATCATGCCACTGCATTCCAGCCTGGGCAACAGAGCAAGACTCTGTCTCAAAAATAAAAATAAAAATAAAAGTAAAAATACAAAATTAGCCAGGCGTGGTGGTGTGTGCCTGTAATCACAGCTACTCAGGAGGCAGGAAAATCACTTGAACCTAGGAGGAGGAGGTTGGTGAGCCAAGATCACACCATTGCACTCCAGCCTGGGCAAAAAGAGCAAAACTCCGAACTCTGTCTCAAAAAAAAAAAAAAAAA","GGCCAGGTATGGTGGCTCACACCTGTAATCCCAGCACTTTGGGAGGCCAAGGCAGGCAGACCACCTGAGGTCAGGAGTTCGAGATCAGCCTAGCCAACATGGTGAAACCCCATCTCTAGTAAAAATAAAATTAGCCAGGCATGGTGGTGCATGCCTGTAACGCAGGTCAGGAGTTCGAGATCAGCTTAGCCAACATGGTGAAACCCCATCTCTAGTAAAAATAAAATTAGCCAGGCAGGTGGTGCCGCCTGTACTCGGGAGGCTGAGGCAGGAGAATCACTTGAACCCAAGAGGCAGAGGTTGCAGTCAGCCAAGATCATGCCATTGCACTCCAGCCTAAGCAAAAAGAGTAAAACTCAGTCTCAAAACAAAAAAACAAAAAAA"
"chr16","44800308","44800913","JH378118","18053084","18053501","244","26747224","GGCCTGGTGCAGTGGCTCACACCTGTAATCCCAGCACTTTGGGAGCCCAAGGCGGGTGGATCACCTGAGGTCAGGAGTTCGAGACCAGCCTGGCCAACATGGTGAAATCCTCTCTACTAAAAATGCAAAAAATTAGCTGGGCGGCCAGGCGCAGTGGCTCACGCCTGTAATCCCAGCACTTTGGGAGGCCGAGGTGGGCGGATCACAAGGTCAGGAGATCGAGACCATGCTGGCTAACACGGTGAAACTCCGTCTCTACTGAAAATACAAAAAATTAGCCAGGCACGGTGGCGGGCGCCTGTAGTCCCAGCTACTGGGGAGGCTGAGGCAGGAGAATGGCGTGAACCTGGGAGGTGGAGGTAGCAGTGAGCCAAGATTGCGCCACCGCAGTCCGGCCTGGGTGAAAGAGCGAGACGCTGTCTCAAAAAAAAAAAAAAAAAATTAGCTGGGCATGGTGGCGGGCGCCTGTAATCCCAGTTACTCGGGAGGCTGAGGCAGGAGAATCAGTTGAACCCAGGAGGTGGAGGTTGCAGTAAGCCAAGATTGTGCCATTGTACTCCAGTCTGGGCAACAAGAGCGAAACTCTGTCTTAAAAAACAAAAAAAA","GGCTGGGCGCAGTGGCTCACACCTGTAATCCCAGCACTTAGGGAAGCTGAGGCGAGTAGATCACCTGAGGTCAGGAGTTAGAGACCAGCCTGGCCATCATGGTGAAACCCCGTCTCTACTAAAGATACCAAAAATTAGCTGAGTGTGGTGCTGGGTGCCTGTAATCCCAGAAACTCAGGGTGCCTGTAATCCCAGCAACTCAGGGTGCCTTTAATCCCAGCAACTGAGGGTACCAGTAATCCCAGCAACTCAGGGTGTCTTTAATCCTAGCAACTGAGGGCACCTGTAATCCCAGCAACTCAGGAAGCTGAGACAGGAGAAGTACTTGAACCCAGAAGGCAGAGGTTGCAGTGAGCCGATATTGCACCATTGCACTCCAGTCTGGGCAACAAGAGTGAAACTCTGTCTCAAAAAAAAA"
"chr16","45828895","45829498","JH378118","18053084","18053501","256","27775811","GGCCAGGAGAGGTGGCTCATGCTTGTAATTCCAGTATTTTGGGAGCCCAAGGCGGGTGGATCACTTGAGGTCAGGAGTTTGAAACCAGCCTGACCAACATGGTGAAACCCCGTCTCTACTAAAAATTCAAAATTAGGCAAGGCCTGGTGGCTCATGCCTGTAATCCCAGCACTTTGGGAGGCCAAGGAGGGAGGATCACCTGAGGTCGGGAGTTTGAGACCAGCCTGACCAACATGGAGAAACCCCGTCTCTACTAAAACTACAAAATTAGCCGGGTGTGGTGGCCCATGCCTCTAATCCCAGCTACTCTGGAGGCTGAGGCAGGAGAATCACTTGGACCTGGGATGTGAAGGTTGCAGTGAGCCAAGATCGAGCCATTGCACTCCAGCCTGGGCCACAAGAGTGAAACTCCGTCCCAGAAAAAAAAAAAAAAATTAACCTGGCATGGTGGTGTATGCCTGTAATCCCAGCTACTCGGGAGACTGAGGCAGGAGAATCTCTTGAACCCGGGAGGCGGAGGTTGCAGTAAACCGAGATTGCGCCATTGCACTCCGGCCTGGGTGACAAGAGCGAAACTCCGCCTAAAAAAAAAAAGAAAAGAAAA","GGCTGGGCGCAGTGGCTCACACCTGTAATCCCAGCACTTAGGGAAGCTGAGGCGAGTAGATCACCTGAGGTCAGGAGTTAGAGACCAGCCTGGCCATCATGGTGAAACCCCGTCTCTACTAAAGATACCAAAAATTAGCTGAGTGTGGTGCTGGGTGCCTGTAATCCCAGAAACTCAGGGTGCCTGTAATCCCAGCAACTCAGGGTGCCTTTAATCCCAGCAACTGAGGGTACCAGTAATCCCAGCAACTCAGGGTGTCTTTAATCCTAGCAACTGAGGGCACCTGTAATCCCAGCAACTCAGGAAGCTGAGACAGGAGAAGTACTTGAACCCAGAAGGCAGAGGTTGCAGTGAGCCGATATTGCACCATTGCACTCCAGTCTGGGCAACAAGAGTGAAACTCTGTCTCAAAAAAAAA"
"chr16","47110839","47111458","JH378118","18053084","18053501","268","29057755","GGCCAGGCGTGGTGGCTCACGCCTTTAATCCCAGCACTTTGGGAGGCCGAGGCAGGCAGATCACCTAAGGTCAGGAGTTCGAGACCAGCCTGGCCAACATGGTGAAACCCCCTCTCTACTAAAAATGCAAAAATTTCTGGGCATGGTGGCTCACGCCTGTAGTCCCAGCACTTTGGGAGGCCAAGGCAGGCGGATCACTTGAGGTCAGGAGTTTGAGACCAGCCTGGCCAACATGGTGAGACCCCTGTCTCTACTAAAAATATAAAAAAGTAGCCAGGCGTGGTGGTGTATGCCTCCCAGATAATTGGGAGGCTGAGGTGGGATAATTGCTTGAACCCGGGAGGCAGAGGTTGTAGTGAGCCAAGATAGCGCCAATGCACTCCAGCCTGGGCAACAGAGCGAGACTCTGTCTCAAAAAAAAAAAAAAAAAGAAAAAAGAAAAGAAATTAGCTGGGCGTGGTGATGGGTGCCTGTAATCCCAGCTGCTTAGGAAGCTGAGGAAGGAGAATCACTTAGACCCAGGAGACAGAGGTTGCAGTGAGCCGAGATCGCACCATTGTATTCCAGCCTGGGTGACAAGAGAAAAACTATGTCTCAAAAAAAAAAAAAAGAGTAGAAAA","GGCTGGGCGCAGTGGCTCACACCTGTAATCCCAGCACTTAGGGAAGCTGAGGCGAGTAGATCACCTGAGGTCAGGAGTTAGAGACCAGCCTGGCCATCATGGTGAAACCCCGTCTCTACTAAAGATACCAAAAATTAGCTGAGTGTGGTGCTGGGTGCCTGTAATCCCAGAAACTCAGGGTGCCTGTAATCCCAGCAACTCAGGGTGCCTTTAATCCCAGCAACTGAGGGTACCAGTAATCCCAGCAACTCAGGGTGTCTTTAATCCTAGCAACTGAGGGCACCTGTAATCCCAGCAACTCAGGAAGCTGAGACAGGAGAAGTACTTGAACCCAGAAGGCAGAGGTTGCAGTGAGCCGATATTGCACCATTGCACTCCAGTCTGGGCAACAAGAGTGAAACTCTGTCTCAAAAAAAAA"
"chr16","48159907","48160229","JH378222","6231244","6231546","61","41928663","GGCTGGGCACAGTGGCTCATGCCTGTAATCCCAGCACTTTGGGAGGCCGAGGCAGGCGGATCACCTGAGGTCAGGAGTTCGAGACTAGCCTGGCCAATATAGCGAAACCCCGTCTCTACTAAAAATTAGTTGGGCATGGTGGCAGGCGCCTTAATCCCAGCTACTTGGGATGCTGAGGCAGAAGAATCGCTTGAACCCAGAGGGTGGAGGTTTCAGTGAGATGAGATCGTGCCATTGCACTCCAGACTGGGCAACAAGAGCGAGACTCTGTAAAAAAAATTAATTAATTAATTAACTAATTAATTAAAATAAAATGAGAAAAA","GGCTGGGCATGGTGGCTCACGCCTGTAATCCCAGCACTTTGGGACGCTTAGGCAGGTGGATTGCCTGAGGTCAGGAGTTCAAGACTACCCTGACCAACATAGTGAAACCCCGTCTCTACTAAAAATTAGCTGGGCATGGTGGCAGAGGCCTGTAATCCCAGCTACTCGGGAGGCTGAGGCAGGAGAATCACTTAAACCTGGGAGTTGGAGGTTGCAGTGAGCCAAGATCAAGCCATTGCACTCCAGTCTGGGCAACAAGAGCAAGACTCTGTCTCAAAAAAAAAAAAAAAAAGAAAAGAAAAA"
"chr16","49252302","49252639","JH378314","538162","538484","57","48714140","GGCCAGGCGCAGTGGTGCATGTCTGTAATCTTAGCACTTTGGGAGGCCGAGGTGGACGGATTACATGAGGTCAGGAGTTCAAGACCAGCCTGGCCAACATGGTGAAATTCCATCTCTACTACTAAAAAAAAAAAAAAAAAAAAAAAAAAAAAAAAAAAAAAATACAAAAATTAGCTGGGCTTGGTGGCGGGTGCCTGTAATCCCAGCTACTTGGGAGGCTGAGGCAGGAATCACTTAAACCCAGGAGGTGGAGGTTGCAGTGAGCCAAGACCATGCCATTGCACTCCAGCCTGGGCAACAAGAGCAAAACTCCGTCTCAAAAAAACAAAACAAAAAAA","GGCTGGGTGCGGTGCCTCACACCTGTAATCCCAGCACTTTGGGAGGCCGAGGTGGGTGGATCACGAGGTCAAGAGATCAAGACCATCCTGGTCAACATGGTGAAACCCTGTCTCTACTAAAAAAAAAAAAAAAAAAAAAAAAAAAAAAAAAAAAATTAGCTGGGCATGGTGGCGTGTGCCTGTAATCCCAGCTACTCAGGAGGCTGAGGCAGGAGAATTGCCTGAACCCAGGAGGCGGAGGTTGCGGTGAGCCGAGACTGTACCATTGCACTCCAGCCTGGGTAACAAGAGCGAAACTCCATCTCAAAAAAAAAAAAAAAAAA"
"chr16","49464616","49465219","JH378118","18053084","18053501","254","31411532","GGCCAGGCGTGGTGGCTCACACCTGTAATCCTAGCACTTTGGGAGACTGAGGCAGGTGGATCACATGAGGTGAGGAGTTCAAAACCACCCTGGCCGACATGGTGAAACCCCGTCTCTACTAAAAATATTTTTAAAAAGGCCAGGCGTGGTGGCTCACACCTGTAATTCCAGCACTTCGGGAGGCTGGGGCAGGCAGATCACAAGGTCAGGAGATCGAGACCATTCTGGCCAACGTGGTGAAACCCCGTCTCTACTAAAAATACAAAAATTAGCTGGGCGTGGTGGCGCGTGCCTGTAATCCCAGCTACTTGGGAGGCTGATACAGGAGAATTGCTTGAACCAGTGAGTCAGAGGTTGCAGTGAGCTGAGATTGCGCCATTGCACTCCAGCCTGGCAACAGAATGAGACTCCGTCTCAAAAAAAAAAAAAAAATTAGCTGGGCATGGTGGCAGGCACCTGTGATCCCAGCTACTTGGGAGGCTGAGGCAGGAGAATCGCTTGAACCTGGGAGGTGGAGGTTGCAGTGAGCTGAGATTGCGCCATTGCACTCCAACCTGGGCGTCAAGAGCAAAACTCCATCTCAAAAATAAATAAATAAATAAAA","GGCTGGGCGCAGTGGCTCACACCTGTAATCCCAGCACTTAGGGAAGCTGAGGCGAGTAGATCACCTGAGGTCAGGAGTTAGAGACCAGCCTGGCCATCATGGTGAAACCCCGTCTCTACTAAAGATACCAAAAATTAGCTGAGTGTGGTGCTGGGTGCCTGTAATCCCAGAAACTCAGGGTGCCTGTAATCCCAGCAACTCAGGGTGCCTTTAATCCCAGCAACTGAGGGTACCAGTAATCCCAGCAACTCAGGGTGTCTTTAATCCTAGCAACTGAGGGCACCTGTAATCCCAGCAACTCAGGAAGCTGAGACAGGAGAAGTACTTGAACCCAGAAGGCAGAGGTTGCAGTGAGCCGATATTGCACCATTGCACTCCAGTCTGGGCAACAAGAGTGAAACTCTGTCTCAAAAAAAAA"
"chr16","49983504","49983843","JH378316","567988","568320","50","49415516","GGCCAGGCATGGTGGCTTACGCCTGTAATCTCAGCACTTTGGGAGGCCAAGGCAGGCGGATCACCTGAGGTCAGGAGTTCAAGACCAGCCTGGTCAACATGGCGAAACCCTGTCTCTACTAAAAAAATACAAAAATTAGCCAGGCGTGGTGGTGGGCGCCTGTAATCTCTCCTACTTGGGAGACTGAGGCAGGAGAATTGCTTGAACTCAGAAGGCAGAGGTTGCAGTGAGCTGAGATCACGCCATTGCACTCCAGCCTGGATGACAAGAGCAAAACTCCATCTCAAACAAACAAAAAACAAACAAACAAAAAAAAACAAAAAAACCTCCAAAAAACAAA","GGCCGGGCGTGGTGGCTCACGCCTGTAATCCCAGCACCTTGGGAGGCTGAGGCGGGTGGATCACGAGGTCAAGAGATTGAGACCAGCCTGGTCAACATGGTGAAACCCTGTCTACTAAAAAAATACAAAAATTAGCTGGGCATGGTGGCACGTGCCTGTAATCCCAGCTACTCAGGAGGCTGAGGCAGGAGAATTGCCTGAACCCAGGAGGCGGAGGTTGCGGTGAGCCGAGATCGCGCCATTGCACTCCAGCCTGGGTAACAAGAGCGAAACTCCGTCTCAAAAAACAAAAAACAAAAAAACAAAAAACAAACAAACAAACAAAAAAACAAA"
"chr16","50470493","50471105","JH378118","18053084","18053501","251","32417409","GGCTGGGAGCGGTGGCTCATACCTGTAATCCCAGCACTCTGGGAGGCCGAGGCGCGTGGATCACCTGAGGTCAGGAGTTTGAGACCAGCCTGGCCAGCATGGTGAAACCCTGTCTCTACTAAAAATAGAAAAAGTTAGCTGGGTGAACAGCCGGGCGCGGTGGCTCACACCTGTAATCCCAGCACTTTGGGAGGCCGAGGCAGGTGGATCACAAGGTCAGGAGATCGAGACCATCCTGGCTAACACGGTGAAACCCTGTCTCTACTAAAAATATAAAAAATTAGCCGGGCATGGTGGTGGGTGCCTGTAGTCCCAGCTGCTCAGGAGGCTGAGGCAGGAGAATGGCGTGAAGCCAGGAGGCAGAGGTTGCAGTGAGCCGAGATCGTACCACTGCACTCTAGCCTGGGTGACAGAACGAGACTGTGTCTCAAAGAAAAAAAAAATTAGCTGGGTGTGGTGGCAGACACCTGTAATCCTAGCTACTTGGGAGGTTGAGGCAGGAGAATCGCTTGGACCTGGGAGGCGGAGGTTGCAGTAGGCTGAAATCGCACCATTGCACTCCAGCCTGGGCAACAAGAGGGAAACTCAGTCTCAAAAAAAAAAAAAAAAAAAA","GGCTGGGCGCAGTGGCTCACACCTGTAATCCCAGCACTTAGGGAAGCTGAGGCGAGTAGATCACCTGAGGTCAGGAGTTAGAGACCAGCCTGGCCATCATGGTGAAACCCCGTCTCTACTAAAGATACCAAAAATTAGCTGAGTGTGGTGCTGGGTGCCTGTAATCCCAGAAACTCAGGGTGCCTGTAATCCCAGCAACTCAGGGTGCCTTTAATCCCAGCAACTGAGGGTACCAGTAATCCCAGCAACTCAGGGTGTCTTTAATCCTAGCAACTGAGGGCACCTGTAATCCCAGCAACTCAGGAAGCTGAGACAGGAGAAGTACTTGAACCCAGAAGGCAGAGGTTGCAGTGAGCCGATATTGCACCATTGCACTCCAGTCTGGGCAACAAGAGTGAAACTCTGTCTCAAAAAAAAA"
"chr16","50478366","50478929","JH378114","15957391","15957789","242","34520975","GGCTGGGCACGGTGGCTCATGCCTGTAATCCTAGTACCCTGGGAGGCTGAAGCTGGCAGATCACTTGAGGTCAGGAGTTCGAAACCAGCCTGGCCAACATGGTGAAACCTCATCACTACTAAAAATACAAAAAGTCAGCCGAGCGCGGTGGCTCACGCCTTTAATCCCAGCACTTTAGGAGTCTGAGGCGGGTGGATCACAAGGTCAGGGGTTTGAGACTAGCCTGACCAACACGGTGAAACATCTTTACTAAAAATAGCCAGGCATGGTGGTGCAGGCCTGTAGCAGGTACTCAGGAGGCTGAGGCAGCAGAATCGCTTGAACCCGGGAGGCGGAGGTTGCAGTGAGCCGAGATTGAGCCACTGCACTCCACCCTGGGCAACTGAGCGAGACTCCGTCTCAAAAAAAAAAAAAAAAATTAGCTGGACGTGGTGGTGGATGCCTGTAATCCCGGCTACTTGGTACTTGGAAGGCTGAGACAGGAGAATCGCTTGAACCCGGGAGGTGGAGGTTGCAGTGAGCTGAGATAGCGCCATTGCACTCCAGCCTGGGCAACAAGAGTGA","GCAAGGAACGGTGGCTCATGCCTGTCATCCCAGCACTTTGGGAGGCTAAGGAGGGTGGATTACCGAAGGTCATGAGTTTGAGACCAGCCTGACCAACATGGTGAAAACCCCATCTCTACTAAAAATACAAAAAATTAGCCAGATACAGCTATGCGGCAGACTGGGGCAGGAGAATCGCTTGGACCCAAACCCCATCTCTACTAAAAATACAAAAAATTAGCCGGATACAGCTATGCGGGAGACTGGGGCAGGAGAATCGCTTGGACCCGGGAGGCAGAGATTGCAGTGAGATGAGACCATGCCATTGCTCTCTAGCTTGTGCGATGAGAACAAGACTCTGTCTCAAAAAAAAAAAAAAAAAAAAAAAAAAAAAAAAAAAAAAAAGAGAGAGAGAGAAAA"
"chr16","51388263","51388584","JH378271","2122362","2122678","46","49265901","GGCTGGGTACGGTGGCCCACACCTGTAATCCCAGCACCTTGGGAGGCTGAGGTGGGCGGATTACCTGAGGTCAAAAGTTCAAGACCAGCCTGGCCAACATGGTGAAATCCCATCTCTGCTAAAAATACAAAAAAAAAAAAAAAAAAAAAAAAAAAATTGCCAGGCATGGTGGCAGGCACCTGTAATCCCAGCTACTTGGGAGGCTGAGGCAGGGGAATCGCTTGAACCTGGGAGGCAGAGGTTGCAGTGAGCCCAGATAGCGCCATTGCACTCCAGCCTGGGCGACAAGAGCGAAACTCTGTCCAAAAAAAAAAAAAAAAAA","GGCCGGGCACGGTGGCTCACACCTGTAATCCCAGCACTTTGGGAGGCTGAGGTGGGTGAATCACCTGAGGTCAGGAGTTTGAGACCAGCCTGACCAACATGATGAAACCCGGTCTCTGCTAAAAATACAAAAAAAAAAAAAAAAAAAAAAAAAAAAAGCTGGGCATGATGGTGGGCACCTGTAATCCCAGCTACTCGGGAGGCTGAGGCAGGAGAATCGCTTGAACACCAGGAGGTGGAGGTTGCTATGAGCCGAGATCGCACCATTGCACTCTAGCTTGGGCAACAAGAGAGAAACTCCATCAAAAAAAAAAAAAA"
"chr16","51876298","51876882","JH378118","18053084","18053501","253","33823214","GTAATCCCAGCACTTTGGGAGGCCCAAGTGGGTGGATCACCTGAGGTCAGGAGTTCATGACCAGCCTGGCCACATGGTGAAACCCCATCTCTACTAAAAATACAAAATTAGGCTGGGCGCGGTGGCTTACGTCTGTAATTCCAGCACTTTGGGAGGCCGAGGCAGGCGGATCATGAGGTCAGGAGATTGAAACCATCCTGGCTAACACGGTGAAACCCTGTCTCTACTAAAAATACAAAAAATTAGCCGGGTGTGGTGGGGGGGCGCCTGTAGTCCCAGCTGCTCAGGAGGCTGAGGCAGGAGAATGGCATGAACCCGGGGGGGCGGAGCTTGCAGTGAGCTGAGATCATGCCACTGCACTCCAGCCTGGGCAACAAAGTGAGACTCCGTCTCAAAAAAAAAAACCAAAAAACAAAATGAGCTGGGTGTGGTGGTGGGGGCGTATAATCCCAGCTATACAGGAGGCTGAGGTAGGAGAATCACTTGAACCCGGGAGGTGGAGGTTGCAGTGAGCCGAGATTGTGCCATTTCACACCAACCTGGGTAACAAGAGTAAAATGCTGTCTCAAAAAAAAAAAAGAAAAA","GGCTGGGCGCAGTGGCTCACACCTGTAATCCCAGCACTTAGGGAAGCTGAGGCGAGTAGATCACCTGAGGTCAGGAGTTAGAGACCAGCCTGGCCATCATGGTGAAACCCCGTCTCTACTAAAGATACCAAAAATTAGCTGAGTGTGGTGCTGGGTGCCTGTAATCCCAGAAACTCAGGGTGCCTGTAATCCCAGCAACTCAGGGTGCCTTTAATCCCAGCAACTGAGGGTACCAGTAATCCCAGCAACTCAGGGTGTCTTTAATCCTAGCAACTGAGGGCACCTGTAATCCCAGCAACTCAGGAAGCTGAGACAGGAGAAGTACTTGAACCCAGAAGGCAGAGGTTGCAGTGAGCCGATATTGCACCATTGCACTCCAGTCTGGGCAACAAGAGTGAAACTCTGTCTCAAAAAAAAA"
"chr16","59738190","59738518","JH378138","4229795","4230103","67","55508395","TCACAGCATTTTGGGAGGCCAAGGCAGGCGGATCACCTGTGGTCAGGAGTTTGAGACCAGCCTGGCCAACATGGTGAAACCCCATCTCTACTAAAAATACAAAACAATTAGCCAGGTTTGGTGGCAGGCGCCTATAATCCCAGCTACTTGGGAGGCTGAGGCAGGAGAATCGCTTGAACCCAGGAGGCGGAGGTTGCAGTGAGCCGAGAACACACCATTGTACTCCAGCCTGCGACAAGAACGAAACTGTATCTCAATTAAAAAAAAAAAAAGAAAGGGAGGAAGGAAGGAAGGAAGGAAGGAAGGAAGGAAGGAAGAAAGAAAGAAAA","CACTTTGGGAGGTGAAGGCGGGCAGATCACCTGAGGTCAGGAGTTCGAGACCAGCCTGGCCAACATGGTGAAACCCCGCCTCTACTAAAAATACAAAAATTAGCCAGGTGTGACACTAGGCATCTGTAATCCCAGCTACTTGGGAGGCTGAGACAGGAGAATCACTTGAACCCAGGAGGCGGAAGTTGCAGTGAGCCAAGATCATGCCATTGCACTCCAGCCTGGGTGACAGGAGCAAAACTCTGTCTCAAAAAAAAAAAAAAAAAAAAAAAAAAAAAAAAAAAAAAAAGAAAAGAAAAGAAAAGTAAA"
"chr16","64682336","64682940","JH378118","18053084","18053501","253","46629252","GGCCGGGCACGGTGGCTCACTCCTGTAATCCCAGCACTTTGGGAGGGTGAGGCAGGTAGATCAAAAGGTCAGGAGTGGCCAGGCGTGGTGGCTCACACTTGTAATCCCAGCACTTTGGGAGGCCGAGATGGGCAGATCACGAGGTCAAGAGATTGAGACCATCCTGGCTAACATGGTGAAACCCCGTCTCTACTAAAAATACAAAAAATTAGCCGGGTGTGGTGGCAGGCGTCTGTAATCCCAGCCACTTGGGAGGCTGAGGCAGGAGAATCGCTTGAACCTGGGCGGCAGAGGTTGCATTGAGCCAGGATCGCGCCACTGCACTCCAGCCTGAGCAAAAAGAGCGAAACTCTGTCTCAGAAAAAAAAAAAAGTCAGGAGTTTGAGACCAGCCTGGCCAATATGGTGAAACCCCGTCTCTACTAAAAATACAAAAATTAGCCGAGCGTGGTGGTGGGTGCCTATACTCCCAGCTACTCAGGAGGCTGAGGCAGGAGAATCACTTGAACCCCAGGGGCAGAGGTTGCAGTGAGCCGAGATCGTGCCATTGCACTTCACCCTGGGTGAAAGAGCAAAACTCCGTCTCAAAAAAACAAAACAAAAAAA","GGCTGGGCGCAGTGGCTCACACCTGTAATCCCAGCACTTAGGGAAGCTGAGGCGAGTAGATCACCTGAGGTCAGGAGTTAGAGACCAGCCTGGCCATCATGGTGAAACCCCGTCTCTACTAAAGATACCAAAAATTAGCTGAGTGTGGTGCTGGGTGCCTGTAATCCCAGAAACTCAGGGTGCCTGTAATCCCAGCAACTCAGGGTGCCTTTAATCCCAGCAACTGAGGGTACCAGTAATCCCAGCAACTCAGGGTGTCTTTAATCCTAGCAACTGAGGGCACCTGTAATCCCAGCAACTCAGGAAGCTGAGACAGGAGAAGTACTTGAACCCAGAAGGCAGAGGTTGCAGTGAGCCGATATTGCACCATTGCACTCCAGTCTGGGCAACAAGAGTGAAACTCTGTCTCAAAAAAAAA"
"chr16","67872770","67873371","JH378118","18053084","18053501","260","49819686","GGCTGGGCATGGTGGCTCATGCCTGTAATCCCAGCACTTTGGGAGGCCAAGACGGGCAAATCACCTCAGGTCAGGAGATCGAGACCAGCCTGGCCAACACAGCAAAACCCACCTCTCTACTAAAAATAGAAAAATTACCCAGGCGTCACAGCTCACGCTTATAATCCCAGCACTTTGGGAGGCCGAAGCAGGTGGATCACAAGGTCAGGAGATCGAGACCAGCCTCACTAACATGGTGAAACCCCGTCTCTACTGAATATACGAAAAATTAGTCGGGTGTGGTGGCAGGCACCTGTAGTCCCAGCTACTTGGGAGGCTGAGGCAGGAGAATGGCTTTAACTCAGGAAGAGGAGCTTACGGTGAGCTGAGATTGTGCCACTGCACCCCAGCCTGGGCGACAGAGCAAGACTCCGTCAAAAAAAAAAAAAACCCCAAAACCCCAGCGTGGCAGCAGGTACCTGTAGTCCCAGCTACTCGGGAGGCTGAGACAGGAGAATGGCTTGAACCCGGGAGGCGGAGCTTGCGGTGAGCCAAGACGGCGCCACTTCATTCCAGCTATGGTGATAAGAGGGAGACCGTCTCAATCAATAAATTTAAAAAAA","GGCTGGGCGCAGTGGCTCACACCTGTAATCCCAGCACTTAGGGAAGCTGAGGCGAGTAGATCACCTGAGGTCAGGAGTTAGAGACCAGCCTGGCCATCATGGTGAAACCCCGTCTCTACTAAAGATACCAAAAATTAGCTGAGTGTGGTGCTGGGTGCCTGTAATCCCAGAAACTCAGGGTGCCTGTAATCCCAGCAACTCAGGGTGCCTTTAATCCCAGCAACTGAGGGTACCAGTAATCCCAGCAACTCAGGGTGTCTTTAATCCTAGCAACTGAGGGCACCTGTAATCCCAGCAACTCAGGAAGCTGAGACAGGAGAAGTACTTGAACCCAGAAGGCAGAGGTTGCAGTGAGCCGATATTGCACCATTGCACTCCAGTCTGGGCAACAAGAGTGAAACTCTGTCTCAAAAAAAAA"
"chr16","67970409","67971018","JH378118","18053084","18053501","252","49917325","GGGCGGGTGCGGTGGCTCACCCTGTAATCCCAGCACTTTCGGAGGCTTAAGCAGGCGGATCACCTGAGGTCAGGAGTTCGAGACCAGCCTGGCCAACATGGTGAAACCCCATCTCTACTAAAAATACAAAAAAATGGCCGGGTGCGGCGGCTCATGCCTGTCATCCCAGCACTTTCGGAGGCTGAGGCAGGCGGATCACCGGAGGTCAGGAGTTCGAGACCAGCTTGGCCAACATGGTGAAACCCCGTCTCTACTAAAAATACAAAAGTTAGCTGGGCATGGTGGCACATGCCTGTAATCCCAGCTACTCCGGAGGCTGAGGCAGGAGAATCACTTGAACCTGGGGAGGCGGAGGTTGCAGTGAGCTGAAATCACGGCATTGCACTCCAGCCTAGGCAACAGAGCGAAAGTCCGTCTCAGAAAAAAAAAAAAAAAAATTAGATGGGTTTGGTGGCGGGCGCGCTGTAATCCCAGCTACTTGGGAGGCTGGAGGCAGGAGAATCGCTTGAACTCAGGAGGCTGAGGTTACAGTGAGCCGAGATCATGCCATTGCACTCCAGCCTGGGCAATAAGAGTGAAACTCTGTCTCAAAAAACAACAACAACAAAAA","GGCTGGGCGCAGTGGCTCACACCTGTAATCCCAGCACTTAGGGAAGCTGAGGCGAGTAGATCACCTGAGGTCAGGAGTTAGAGACCAGCCTGGCCATCATGGTGAAACCCCGTCTCTACTAAAGATACCAAAAATTAGCTGAGTGTGGTGCTGGGTGCCTGTAATCCCAGAAACTCAGGGTGCCTGTAATCCCAGCAACTCAGGGTGCCTTTAATCCCAGCAACTGAGGGTACCAGTAATCCCAGCAACTCAGGGTGTCTTTAATCCTAGCAACTGAGGGCACCTGTAATCCCAGCAACTCAGGAAGCTGAGACAGGAGAAGTACTTGAACCCAGAAGGCAGAGGTTGCAGTGAGCCGATATTGCACCATTGCACTCCAGTCTGGGCAACAAGAGTGAAACTCTGTCTCAAAAAAAAA"
"chr16","68229729","68230314","JH378206","6546474","6546861","256","61683255","TGGTTTCCGCCTGTACTCCCAGCACTTTCGGAGGCTCAAGTGAGCAGATCGCTTGAGGCCAGGAGTTTAAGACCTACCTAGTCAACACCGGGGAAACCCACATCTCCACTAAACAATGGCCAGGAGCAGTGGCTCATACCTGTAATCACAACACTTTGGGATCCCAGCCAGACGGATCACAAAGTCAGGAGTTTGCGACCAGCCTATTAGAATGGTGAAACCCTGTCTCTACTAAAAATACAAAAAATTAGCCAGGCATGGTGGCGCATGCCTGTCATCCCAGCTACTCGGGAGGCTGAGGCAAGAGAATCACTTAAACCCAGGAGGCAGATGGAGGTTGCAGTGAGCCAAGATCACACCACTGCACTACAGCATGGGCGACAGAGCAAGACTCGGTCTCAAAAAAAAAAAAATTGGCCAGGCACGGTGGCTGACACCTGTAATCCCAGCACTTTGGGAGGCTGAGGCGGGAGAATCGCTTGAACCTGGGAGACGAAGGTTGCAGTGAGCCGAGACTAAGCCATTGCACCCCAACCTGGGCGGCAAGAGTGAAACTCTGTCTCAAAAAAAATTAAAAAATAAAAAA","GGCCACACATGGTGGCTAACGCCTGTAATCCCAGCACTTTGGGAGGCCAAGTCGGGTGGATCATGAGGTCAGGAGACCAAGACCATCCTGGCCAAATGGTGAAACCCCGTCTCTACTAAAAATACAAAAATTAGCTGGGCATGGTGGCGTGTGCCTGTAATCCCAGCTACTCAGGAGGCTGAGGCAGGACAATTGCCTGAACCCAGGAGAATTAGCTGGGCATGGTGGCGTGTGCCTGTAATCCCAGCTACTCAGGAGGCTGAGGCAGGACAATTGCCTGAACCCAGGAGGCGAAGGTTGCGGTGAGCCGAGATTGTGCCATTGCACTCCAGCCTGGGTAACAAGAGCGACACTCTGTCTCAAAAAAAAAAAAAAAAAAAAAAAAAAA"
"chr17","3506470","3507049","JH378118","18053084","18053501","238","14546614","CCTGTCATCCCAGCACTTTGGGAGGCCGAGGCGGGTAGATCACCTGAGGTCAGGAGTTTGAGACCAGCCTGGCCAACATGGCGAAACCCCGTCTCTACTAAAAATACAAAAACTGGCTGGGCGCGGTGGCTCACGCCTGTAATCCCAGCACTTTGGGAGGCTGAGGCGGGTGGATCATAAGGTCAGGAGTTCAAGACCAGCCTGGCCAACATGGTGAAACCCCATCTCTACTAAAAATACAAAAATTAGCCAGGTATGGTGGCAGGTGCCTGTAATCCCAGCTACTCAGGAGGCTGAGGCAGAGAATTGCTTGAACCCGGGAGGGGGAGGTTGCAGAGGGCCAAGATCGTACCACTATACTCCAGCCTGGGTGACAGGATGAGACTCCATCTTAAAAAAAAAAAAAAAAAAAAAAATTAGCCAGGCGTGGTGCGGGCACTTGTAATCCCAGCTATTCAGGAGGCTGAGGCAGGAGAATTGCTTGAACCCGGGAGGCAGAGGTTGCGGTGAGCTGAGATCGCACCATTGCACTCCAGCCTGGGCAACAAGAGTGAAACTCTGTCTCAAAAAAAAAACAAAA","GGCTGGGCGCAGTGGCTCACACCTGTAATCCCAGCACTTAGGGAAGCTGAGGCGAGTAGATCACCTGAGGTCAGGAGTTAGAGACCAGCCTGGCCATCATGGTGAAACCCCGTCTCTACTAAAGATACCAAAAATTAGCTGAGTGTGGTGCTGGGTGCCTGTAATCCCAGAAACTCAGGGTGCCTGTAATCCCAGCAACTCAGGGTGCCTTTAATCCCAGCAACTGAGGGTACCAGTAATCCCAGCAACTCAGGGTGTCTTTAATCCTAGCAACTGAGGGCACCTGTAATCCCAGCAACTCAGGAAGCTGAGACAGGAGAAGTACTTGAACCCAGAAGGCAGAGGTTGCAGTGAGCCGATATTGCACCATTGCACTCCAGTCTGGGCAACAAGAGTGAAACTCTGTCTCAAAAAAAAA"
"chr17","3641899","3642243","JH378198","5062782","5063109","59","1420883","GGCCAGGCACAGTGGCTCACACCTGTAATCCCAGCACTTCAGGAGGCCGAGGTGGGTAGATCACCTGAGGTCAGGGGTTTGAGACCAGCCTGACCGACGTGGCGAAACCCTGTCTCTACTACAAATACAAAAATTAGCCTTATGTGGTGGCGGGCACGTGTAATCCCAGCTACTTGGGAGGCTGAGGCAGGAGAATCGCTTGAATCTGGGAGGTGGAGGTTGCAGTGAGCCGAGATCACGCCATTGCACTCCAGCCTGGGTGACAAGAGCGAAACTCCATCTCAAAATAAATAAATACATACATACATGTATACATACATACATACATAAAAATAAAAAGTAAAA","GCCAGGCATGGTGGCTCACGCCTATAATCTCAGCACTTTGGGAGGCTGAGGCAGGCAGATCACTTGAGGTCAGGAGTTCAAGACCAGCCTGGCCAACATGGTGAAACCCTGGCTCTACTAAAAATACAAAAATTAGCCGGGTGTGGTGGCACGTGCCTATAATCCCAGCTACTCAGGAGGCTGAGGCAGAAGAATCGCTTGAATCCAGGAGGTGGAGGTTGCAGCGAGCCGAGATCACACCATTGGACTCCAGCCTGGGTGACAAGAGCGAAACTCCATCTCAAAATAAATAAATAAATACATAAAATTAAAAATAAATAAATAAATA"
"chr17","4508039","4508546","JH378206","6546474","6546861","194","2038435","GAGTTGGAGACCAGCCTGGCCAACACGGTGAAACCTCGTCCCCACTAAAAATATAAAAATTAGGCCAGGCGCGGTGGCTCACTCCTGTAATCCCAGCACTTTGGGAGGCTGAGGCGGGTAGATCATCTGAGGTCAGGAGTTCGAGACCAGCCTGGCCAACATGGTGAAACTCCGTCTCTACTAAAAATACAAAAATTAGCTGGGCTGGTAGCGGGCACCTGTAATCCCAGCTACTTGGAAGGGTGAGGCAGGAGAATCACTTGAACCCAGGAGGTGGAGGTTGCAGTGAGCCAAGATTGCAGCACTGTACTCCAGCCTGGGTGACAAAGCAAGACTCTGTCTCAAAAAAAAAAAAAAAAAAAAAGCCGGGCTTGGTGGTGAGTACCGGTAATCCCAGCTACTTGGAAGGCTGAGGCGGCGGACGTTGTACTTAGCCGAGATCATGCCATTGCACTCCAGCCTGGGTAACAGGCAAAAACTCTGTCTCAAAAAATAATAAATAATAAAA","GGCCACACATGGTGGCTAACGCCTGTAATCCCAGCACTTTGGGAGGCCAAGTCGGGTGGATCATGAGGTCAGGAGACCAAGACCATCCTGGCCAAATGGTGAAACCCCGTCTCTACTAAAAATACAAAAATTAGCTGGGCATGGTGGCGTGTGCCTGTAATCCCAGCTACTCAGGAGGCTGAGGCAGGACAATTGCCTGAACCCAGGAGAATTAGCTGGGCATGGTGGCGTGTGCCTGTAATCCCAGCTACTCAGGAGGCTGAGGCAGGACAATTGCCTGAACCCAGGAGGCGAAGGTTGCGGTGAGCCGAGATTGTGCCATTGCACTCCAGCCTGGGTAACAAGAGCGACACTCTGTCTCAAAAAAAAAAAAAAAAAAAAAAAAAAA"
"chr17","4560867","4561450","JH378118","18053084","18053501","257","13492217","GGCTGGGGGTGGTGTCTCTTGCCTGTAATCCCAACACTTTAGCAGGCTGAGGTGTGAGTATGGCTTGAGCCAGGAGTTCTAGACCAGCCTAGGAAACATGGCGAGATCCCTATCTCTACTAATACAAAAATTAGCCGGGCGTGGTGGCAAGCACCTGCAATCTCAGCTACTCGGGAGGCTGAGGTGGGAGGGCCGCTTGAGCCCAGGAGGTCCAGGCTGCAGTAAGCACTTATTTAAAAAAAAAAGAAGAGAAAAGATACAGAAATTAGCCAGGCGTGGTGGTGGGCACCTGTAATCCCAGCTACTCAGGAGGCTGAGGCAGGAAAATCACTTGAACCCGGGAGGCAGAGGTTGCAGTGGGCCGAGATCACACCATTGTACTCCAGCCTGGGCAACAAGAGCGAAACTCTGTCTCAAAAAAAAGAAAAGTAAAGTAAAGAAAAGATACAGAAATTAGCCAGGTGTGGTGGCGGGTGCCTGTAATCCCGCTACTTGGGAGGCTGAGGCAGGAGATTGCAGTGAGCCAAGATTGTGCCATTGCATTCCAGCCTGGGCAACAAGAGCAAAACTCCGCCTCAAAAAAA","GGCTGGGCGCAGTGGCTCACACCTGTAATCCCAGCACTTAGGGAAGCTGAGGCGAGTAGATCACCTGAGGTCAGGAGTTAGAGACCAGCCTGGCCATCATGGTGAAACCCCGTCTCTACTAAAGATACCAAAAATTAGCTGAGTGTGGTGCTGGGTGCCTGTAATCCCAGAAACTCAGGGTGCCTGTAATCCCAGCAACTCAGGGTGCCTTTAATCCCAGCAACTGAGGGTACCAGTAATCCCAGCAACTCAGGGTGTCTTTAATCCTAGCAACTGAGGGCACCTGTAATCCCAGCAACTCAGGAAGCTGAGACAGGAGAAGTACTTGAACCCAGAAGGCAGAGGTTGCAGTGAGCCGATATTGCACCATTGCACTCCAGTCTGGGCAACAAGAGTGAAACTCTGTCTCAAAAAAAAA"
"chr17","4846296","4846953","JH378118","18053084","18053501","290","13206788","GGCCAGGTGCAGTGGCTCACGCCTGTAATCCCAGCACTTTGGGAAGCCCAGGTGGGCGGATCACCCAAGGTCAGGGGTTCGAGACCAGCCTGGCCAACATGGTGAAACTCCATCTCTACTAAAAATAGAAAAAAATGGCCTGGTACGGTGGCTAACGCCTGTAATCCCAGCACTTTGGTAGGCCGAGGCAGGCAGATCACGAGGTCAGAAGATCGAGACCATCCTGGCTAACATGGTGAAACCCCGTCTCTACTAAAAATACAAAAAAGTAGCCAGGTGTGGTGGTGGGTGCCTGTAGTCCTAGCTACTCGGGAGGCTGAGGCAGGAGAATGCCGTGAACCCGGGAGGTGGAGCTTGCAGTGAGCTGAGATCACGCCACTGCACTCCAGCCTGGGTGACAGTGCGAGACTGTCTCCAAAAAAAAAAAAAAAAAAAAATTATATATATAATACACACACACACACACACACACACACACACACACAAATCAGCCAGGCGTGGTGGTGCGCACCTGTAATCCCAGCTACTCGGGAGGCTGAGGCAGGAGAGCTCCTCGAACCCAGGAGGCGAAGGTTGCAGTGAGCCGAGATCACACCATTGCACTCCAGCCTGGGCAACAAGAGCGAAACTCTGTCTCAAGGAAAAAAAAAAAAAAAAA","GGCTGGGCGCAGTGGCTCACACCTGTAATCCCAGCACTTAGGGAAGCTGAGGCGAGTAGATCACCTGAGGTCAGGAGTTAGAGACCAGCCTGGCCATCATGGTGAAACCCCGTCTCTACTAAAGATACCAAAAATTAGCTGAGTGTGGTGCTGGGTGCCTGTAATCCCAGAAACTCAGGGTGCCTGTAATCCCAGCAACTCAGGGTGCCTTTAATCCCAGCAACTGAGGGTACCAGTAATCCCAGCAACTCAGGGTGTCTTTAATCCTAGCAACTGAGGGCACCTGTAATCCCAGCAACTCAGGAAGCTGAGACAGGAGAAGTACTTGAACCCAGAAGGCAGAGGTTGCAGTGAGCCGATATTGCACCATTGCACTCCAGTCTGGGCAACAAGAGTGAAACTCTGTCTCAAAAAAAAA"
"chr17","6289040","6289368","JH378152","15932639","15932952","57","9643599","GGCTGGGCGTGGTGGCTCACGCCTGTAATCCCAGCACTTTGGGAGGCCAAGGTGGGTAGATCACCTGAGGTCAGGAGTTTGAGACCAGCCTGGCCAATGTGATGAAACCCTGTATCCACTAAAAAAAAAAAAAAAAAAAAAAAAAAAAATAGCTGGGTGAAGTGGCAAGCACCTGTAATCCCAGCTACTTGGGAGGCTGAGGCAGGAGAATCCCAGGAGGTGGAGATTGATCCCAGGAGGTGGAGGTTGCAGTGAGTCAAGATCATGCCATTGCACTCCAGCCTGGGTGACAAGAGCAAAATTCCATCTCAAAAAAAAAAAAAAGAAAA","GGCCGGGCATGGTGGCTCAAGCCTGTAATCCCAGCACTTTGGGAGGCCGAGGCGGGTGGATCACGAGGTCAAGAGATTGAGACCATCCTGGTCAACATGGTGAAACCCCGTCTCTACTAAAAATACAAAAAAAAAAAAAAAAAAAATAGCTGGGTGTGGTGGCGTGTGCCTGTAATCCCAGCTACTCAGGAGGCTGAGGCAGGAGAATTGCCTGAACCCGGGAGGCGGAGGTTGCGGTGAGCCGAGATCGCGCCATTGCACTCCAGCCTGGGTAACAAGAGCGAAACTCCGTCTCAAAAACAAAAAAAACAAAA"
"chr17","7490664","7491294","JH378118","18053084","18053501","283","10562420","GGCCGGGAGCGGTGGTTCACTCCTGTAATCCCAGCACTTTGGCAGACCGAGGAGGGTGGATCAACTGAGGTCAGAACTTCAAGACCAGCCTGCCGGGCACAGTGGCTCACACCTGTAATCCCAGCACTTTGGGAGGCTGAGGCAGGTGGATCACCCGAGGTCGGGAGTTCAAGACCAGCCTGACCAACGTGGAGAAACCCCGTCTCTACTAAAAATACAAAATTAGCTGGGGTGGTGGCACGTACCTGTAATCCCAGCTACTCGGGAGGCTGAGGCAAGAGAATCGCTTGAACCCGGGAGGCGGAGGTTGCGGTGCGCCGAGATCGCGCCATTACACTCCAGCCTGGGCAAAAAGAGCGAAACTCTGTCTCAAAAAATAAAAAAAGAAAAAGAAAAAGAAAAAGAAGTTCAAGACCAGCCTGGTCAACGTGGTGAAACCCCGTCTCTACTAAAAACACAAAAAAAATTAGGCGGGTGTTGTGGTGGGTGCCTGTAATCCCAGCTACTCAGGAGGCCAAGGCAGGAGAATCACCTGAACCCTGGAGGTGGAGGTTGCAGTGAGTCGAGATCGCACCATTGCACTCCAGCGTGGGTGACAGAGAGCGAGACTCCGTCTCAAAAAAAAAGAAAA","GGCTGGGCGCAGTGGCTCACACCTGTAATCCCAGCACTTAGGGAAGCTGAGGCGAGTAGATCACCTGAGGTCAGGAGTTAGAGACCAGCCTGGCCATCATGGTGAAACCCCGTCTCTACTAAAGATACCAAAAATTAGCTGAGTGTGGTGCTGGGTGCCTGTAATCCCAGAAACTCAGGGTGCCTGTAATCCCAGCAACTCAGGGTGCCTTTAATCCCAGCAACTGAGGGTACCAGTAATCCCAGCAACTCAGGGTGTCTTTAATCCTAGCAACTGAGGGCACCTGTAATCCCAGCAACTCAGGAAGCTGAGACAGGAGAAGTACTTGAACCCAGAAGGCAGAGGTTGCAGTGAGCCGATATTGCACCATTGCACTCCAGTCTGGGCAACAAGAGTGAAACTCTGTCTCAAAAAAAAA"
"chr17","9634166","9634493","JH378110","12773123","12773444","45","3138957","GGCTGGGTGCGGTGGCTCACGCCTGTAATCCCAGCACTGTGGGAGGCCGAGGCAGGTGGATCACCTGAGGTCAGGAGTTTGAGACCAGCTTGGCCAACATGGTGAAACCCTGTCTGCACTAAAAATACAAAAAAAAAAAAAAAAAAAAAAAAATTAGCTGGGTGTGGTGGCGGACGCCTATAATCCCAGCTACTGGGGAGGCTAAGGCAGGAGAATCGCTTGAACCTGGGAGGTGGAGATTGCAGTGAGCCAAGATGGTGCCATTGCACTCCAGCCTGGACAACAAGAGCGAAACTCGGTTTCAAAAAAAAAAAAAAAAAAAAAAAAA","GGCTGGGCGTGGTGGCTCATGCCTATAATCCCAGCACTTGGAGAGGCCAAAGCAGGCAGATTATTTGAGGTCAGGAGTTCCAAACCAGCCTGGCCAACATGGTGAAACCCTGTATCTACTAAAAATGCAAAAAAAAAAAAAAAAAAAAAAATTAGCTGGGCGTGGTGGCAGGTGACTGTATCCCAGTACTTGGTAGGCTGAGGCAGGAGAATTGCTTGAACCTGGGAGGTGGAGGTTGCAGTGAGCTGAGATTGTGCCATTGCACTCCAGCCTGGGCAACAAGAGCAAAACTCTGTCTCAAAAAAAAAAAAAAAAAAAAAAA"
"chr17","9636859","9637187","JH378193","2430153","2430476","55","7206706","GACACGGTAGCTCACGCCTGTAATCCCAGCACTTTGGGAGGTCGAGGCGGGTGGATCACCTGAGGTCAGGAGTTTAAGACCAGCCTGGCCAACATGGTGAAACCCCGTCTCTGCTAAAAATACAAGAATTAGCCAGGCGTGGTGGTGGGCGCCTGTAATCCCAGCTACTGGGGAGGCTGAGGCAGGAGAATCACTTGAACCCAGAAGGTGGAGGTTGCAGTGAGCCAAGACCACACCACTGGACTGCAGCCTGGCGGACAAGAGCGAGACTCTGTCTCAAAAACAACAACAACAACAACAACAACAACAAAAGAAAGAAAAGAAAAGAA","GGCCGGGCACAGTGGCTCAAGCCTGTAATCCCAGCACTTTGGGAGGCCGAGGTGGGTGGATCACGAGGTCAAGAGATCGAGACCAACCTGGTCAACATGGTGAAACCCCGTCTCTACTAAAAATACAAAAATTAGCTGGGCATGGTGGTGTGTGCCTGTAATCCCAGCTACTCAGGAGGCTGAAGCAGGAGAATTGCCTGAACCCAGGAGGAGGAGGTTGCGGTGAACCAAGATCACGCCATTGCACTCCAGCCTGGGTAACAAGAGCGAAACTCTGTCTCAAAACAAAACAAAACAAAACAAAACAAAACAAACAAAAAAAAA"
"chr17","9725612","9725938","JH378224","2846632","2846964","49","6878980","GGGCGTGGTGGCTCACACCTGTAATCCCAGCACTTTGGGAGGCCGAGGTGGGCGGATTGCCTGAGGTCAGGAGTTCGAGACCAGCCTGGCCAACCCGGTGAAACCCTGTCTCTACTAAAATACAAAAAAAAAAAAAAAAAAAAAAAAAAATTTAGCTGTGTGTGGTGGTGTGCACCTGTAATCCCAGCTACTCAGAAGGCTGAGGCAGGAGAATCGCTAGAACCCGGGAGGCGGAGGTTGCAGTGAGCCGAGATCGCACCATTACGCTCCAGCTTGGGCAACAAGAGTGAAACTCCATCTCAAAAACAAAACAAAACAAAACAAAAA","GGCCAGGCAGGGTGGCTTACATCTGTAATCCCAGCACTTTGGGAGGTCAAGGCGAGTGGATCACCTGAGGTCATGAGTTCAAGACCAGCCTGGCCAACTTGGTGAAACCCTGTCTCTACTAAAAATACAAAAAAAAAAAAAAAAAAAAAAAAAAAAATTAACTGGGTGTGGTGGTGCACACCTGTAATCCCAGCTACTCAGGAGGCTGAGGCAGGAGAATCCCTTGAACACGGGAGGTGGAGGTTGCAGTGAGCCGAGATCATGCCATTGCACTCCAGCCTTGGTGAAAAGAGCAAAACTCTGTCTTAAACAAAACAAAACAAAACCAGAAAA"
"chr17","11904179","11904388","JH378115","24252957","24253162","48","12348778","CCTGTCTTTACAAAAAATGCAAAAACAAAACAAAACAAAACAAAACAAAAACCGGGCATGGTGGTGAGCACCTGTAATCCCAGCTACTTGGGAGTTTGAGGCAGGAGAATCACTTGAACCTGGGAAGCGGAGGTTGCAGTGAGCCGAGACCGCGCCATTGCACTCCAGCCTGGGCAACAAGAATGAAACTCTGTCTCAAAAAAAAAAAAA","TGGTGAAACCCTGTCTTTACTAAAAATACAAAAAAAAAAAAAATTAGCTGGGCATGGTGGCACATGCCTGTAGTCCCAGCTGCTCGGGAGGCTGAGGCAGGAGAATTGCTTGAACCCAGGAGGCGGAGGTTGCAGTGAGCCGAGATCGAGCCATTGCACTCCAGCCTGGGCAACAAGAGCAAAACTCCGTCTCAAAACAAAATAAA"
"chr17","15884346","15884946","JH378118","18053084","18053501","249","2168738","GCCAGGCAGGTGGCTCAGGACTGTAATCCCAGCCTTTTGGGAGGCTGAGGCGAGTGGATCACCTGAGGTCAGGAGTTCGACACCAGCCTGGTCAACATGGTGAAACCCCGTCTCTACTAAAAAATACAAAAAATTGGCCAGGCGCAGTGTCTCACGCCTGTAATCCCAGCACTTTAGGAGGCTGAGGCAGGTGGATCACTTGGTCAGGAGATCGAGACCATCCTGGCCAACATGGTGAAACCCTGTCTCTATCAAAAATACAAAAATTAGCTGGGCGTGGTGGCATATGCCTATAATCCCAGCTACTTGGGACGCTGAGGCAGGAGAATCACTTGAACCAGGGAGTCAGAAGTTGCAGTGAGCCGAGATTGCGCCACTGCACCCCAGCCTGGTGACAGAGTGAGACTGTCTTAAAAAACAAAAAACAAAAAATTAGCCAGGTATGGTACCAGGTGCCTGTAACCCCAGCTACTTGGGAGGCTGAGGCAGGAGTATCGCTTGAACCCTGGAGGTGGAGGATGCAGTGAGCTGAGAGCACGCCATTGTACTCCAGCCTGGGCAACAAGAGTGAAACTCCATCTAAAATAAATAAAAATAAAAA","GGCTGGGCGCAGTGGCTCACACCTGTAATCCCAGCACTTAGGGAAGCTGAGGCGAGTAGATCACCTGAGGTCAGGAGTTAGAGACCAGCCTGGCCATCATGGTGAAACCCCGTCTCTACTAAAGATACCAAAAATTAGCTGAGTGTGGTGCTGGGTGCCTGTAATCCCAGAAACTCAGGGTGCCTGTAATCCCAGCAACTCAGGGTGCCTTTAATCCCAGCAACTGAGGGTACCAGTAATCCCAGCAACTCAGGGTGTCTTTAATCCTAGCAACTGAGGGCACCTGTAATCCCAGCAACTCAGGAAGCTGAGACAGGAGAAGTACTTGAACCCAGAAGGCAGAGGTTGCAGTGAGCCGATATTGCACCATTGCACTCCAGTCTGGGCAACAAGAGTGAAACTCTGTCTCAAAAAAAAA"
"chr17","16331846","16332458","JH378118","18053084","18053501","252","1721238","GGCCATGTGTGGTGGTTCACACCTGTAATCTCAGAACTTTGGGAGGCCGAGGTGGGTGGATCACCTGAGGTCAGGAGTTCGAGACCAGCCTGGCCAACATGGTGAAACCTCATCTCTACTAAAAATACAAAAAATTAAGGCCATACCCAGAGACTCATGCCTGTAATCCCAGCACTTTGGGAGGCTGAGGCGGATGGATCACTTGAGGTCAGGAGTTCAAAACCAGCCTGGCCAACATGGTGAAACCCCATCTCTACTAAAAATATAAAAATTAGCCGGGTGTGATGGCAGGCACCTGTAATCCCAGCTACTTGGGAGGCTGAGGCAGGAGAATTGCTTGAACCCAGGAAGCAGAGGTTGTGGTGAGCCGAGGTCGCGCCATTGCACTCCAGCCTGGGCAACAGAATGAGACTGTCTCAAAAAAAAAAAAAAAAAAAAATCAGCCAGGAGTGGTGGCGGGGGCACCTGTAATCCCAGCTACTCGGGAGGCTGAGGCAGGAGAATCGCTTGAACTCAGGAGGCAGAGGTTGCAGTGAGCTGATATCTCGCCATTGCACTCCAGCCTGGGCAACAAGAGTGAAACTGTCTCAAAAAAAAAAAAAAAAAAAAAGAA","GGCTGGGCGCAGTGGCTCACACCTGTAATCCCAGCACTTAGGGAAGCTGAGGCGAGTAGATCACCTGAGGTCAGGAGTTAGAGACCAGCCTGGCCATCATGGTGAAACCCCGTCTCTACTAAAGATACCAAAAATTAGCTGAGTGTGGTGCTGGGTGCCTGTAATCCCAGAAACTCAGGGTGCCTGTAATCCCAGCAACTCAGGGTGCCTTTAATCCCAGCAACTGAGGGTACCAGTAATCCCAGCAACTCAGGGTGTCTTTAATCCTAGCAACTGAGGGCACCTGTAATCCCAGCAACTCAGGAAGCTGAGACAGGAGAAGTACTTGAACCCAGAAGGCAGAGGTTGCAGTGAGCCGATATTGCACCATTGCACTCCAGTCTGGGCAACAAGAGTGAAACTCTGTCTCAAAAAAAAA"
"chr17","16464101","16464461","JH378293","1845184","1845523","61","14618917","GGCCGGGCGCCGTGGCTCACGCCTATAATCCCAGCACTTTGGGAGGCCGAGGCGGGTGGATCACCTGAGGTCAGGAGTTCGAGACCAGCCTGACCAACATGGTGAAACCCCCGTCTCTGCTAAAAAAAAAAAAATATATATATATATATATATAATATATAATATATATATATATATATATATAAAATAGCTGGGCATGGTGGCAGGCACCTGTAATCCCAGCTACTCAGGAGGCTGAGGCAGGAGAATCGCTTGAACCTGGGAGGTGGAGGTTGCAGTGGGCTAAGATCACACCATCGCACTCCAGCCTGGGCGACAGGAATGAAACGCTGTCTCAAAAAAAAAAAAAAAAAAAAAAAAA","GGCCGGGTGCGGTGGCTCACGCCTGTAATCCCAGCACTTTGGGAGGCCAAGGCGGGTGGATCACCTGAGGTCAGAAGTTCGAGACCAGCCTGGCCAACATGGTGAAACCCCGTCTCTGCTAAAAAGAAAAAAATAAGAAAAAAACAAAATAAGAAAATAATTTTAAAAAATACAAAATTAGCTGGGCGTGGTGGCAGGCACCTGTAATTCCAGCTATTCAGGAGGCTGAGGCAGGGGAATCACTTGAACCCAGGAGGCAGAGGTTGCAGTGAGCCAAGATGACGCCATTGCACACCAGCCTGGGCAACAAGAGTGAAACTCCGTCTCAAAAAAAAAACAA"
"chr17","16469420","16470033","JH378118","18053084","18053501","254","1583664","GCCAGGGGTGGTGGCTCATGCCTGTAATCCCAGCACTTTGGGAGGCTGAGGCGGGCAGATTGCCTGAGGTCAGGAATTCAAGACCAGCCTGGCCAACATAGTGAAACCCTGTCTCTACTAAAAATGCAAAGAATTAGCTGGGTGTTGGCCGGGCACGGTGGCTGACACCTGTAATCCCAGCACTTTGGGAGGCCTAGGCAGGCGGATCACCTGAGGTTGGGAGTTCGAGACCAGCCTGACCAACATGGAGAAACCCCGTCTCTACTGAAAATAAAAAACTAGCCAGGCATGGTGGCCCATGCCTGTAATCCCAGCTAATTGGGAGGCTGAGGCAGGAGAATCGCTTGAACCCAGGAGGCAGAGGTTGCGGTGAACCAAGATCGCATCAATGCACTCCAGCCTAGGCGACAAGAGCAAAACTCCGTCTCAAAAAAAAGAATTAGCTGGGTGTGGTGGGTGGGAACCTGTAATCCCAGTTACTAGGGAGGCTGAGGCAGGAGAATTGCTTGAACCCAGGAGGCGGAGGTTGTGGTGAGCCGAGATCGCGCCATTGCACTCCAGCCTGGACAACAAGAGCGAATCTCCGTCTCAAAAAAAAAAAAAAAAAAAAAAAA","GGCTGGGCGCAGTGGCTCACACCTGTAATCCCAGCACTTAGGGAAGCTGAGGCGAGTAGATCACCTGAGGTCAGGAGTTAGAGACCAGCCTGGCCATCATGGTGAAACCCCGTCTCTACTAAAGATACCAAAAATTAGCTGAGTGTGGTGCTGGGTGCCTGTAATCCCAGAAACTCAGGGTGCCTGTAATCCCAGCAACTCAGGGTGCCTTTAATCCCAGCAACTGAGGGTACCAGTAATCCCAGCAACTCAGGGTGTCTTTAATCCTAGCAACTGAGGGCACCTGTAATCCCAGCAACTCAGGAAGCTGAGACAGGAGAAGTACTTGAACCCAGAAGGCAGAGGTTGCAGTGAGCCGATATTGCACCATTGCACTCCAGTCTGGGCAACAAGAGTGAAACTCTGTCTCAAAAAAAAA"
"chr17","17534259","17534875","JH378118","18053084","18053501","268","518825","GGCTGGGGCGGTGGCTCACCTGTAATCCCAGCACTTTGGGAGGCAGAGGTGGGCGGATCGCCTGAGGTCAGAAGTTGGAGACCAGCCTGGCAACATGGTGAAACCCTGTCTCTACTAAAAAAAAAAAAAAAAAAAAAAAATGGCCGGGCATGGTGGCTCAAGCCTGTAATCCTAGCACTTTGGAAGGCTGAGGCGGGTGGATCACAAGGTCAGGAAATCGAGACCATCCTGGCTAACATGGTGAAACTCCGTCTCTACTAAAAATACAAAAAAAATTAGCCGGGCGTGGTGGTGGGTGCCTGTAGTCCCAGCTACTCGGGAGGCTGAGGCAGGCAAATGGAGTGAACCCGGGAGGCAAACTTGCAGTGAGCCAAGATGGCGCCATTGCACTCCAGCCTGGGCAACAAGAGCAAGACTCCTTCTCAAAAAAAAAAAAAATATATATATATATATATAGTCGGGCATGGTGGCAGGCACCTGTAATCCCAGCTACTCAGAGGCTGAGGCAGGAGAATCGCTTGAACCCTGGAGGTGGAGGTTGCAGTGAGCCAAGGTCATGCCATTGCACTCCAGCCTGGGCAACAAGAGCAAGACTCCGTCTCAAAAAAAAAAAAAAA","GGCTGGGCGCAGTGGCTCACACCTGTAATCCCAGCACTTAGGGAAGCTGAGGCGAGTAGATCACCTGAGGTCAGGAGTTAGAGACCAGCCTGGCCATCATGGTGAAACCCCGTCTCTACTAAAGATACCAAAAATTAGCTGAGTGTGGTGCTGGGTGCCTGTAATCCCAGAAACTCAGGGTGCCTGTAATCCCAGCAACTCAGGGTGCCTTTAATCCCAGCAACTGAGGGTACCAGTAATCCCAGCAACTCAGGGTGTCTTTAATCCTAGCAACTGAGGGCACCTGTAATCCCAGCAACTCAGGAAGCTGAGACAGGAGAAGTACTTGAACCCAGAAGGCAGAGGTTGCAGTGAGCCGATATTGCACCATTGCACTCCAGTCTGGGCAACAAGAGTGAAACTCTGTCTCAAAAAAAAA"
"chr17","17916069","17916669","JH378118","18053084","18053501","243","137015","GCCGGGTACAGTGGCTCACACCTGTAATCCTAGCACTTTGGGAGGCCGAGGCGGGTGGATCACCTGAGGTCAGGAGTTCGAGACCAGCCTGGCCAACATGATGAAACCCTACCTCAGCCAGGTACGGTGGTTCACGCCTGTAATCCTAGCACTTTGGGAGGCTGAGGCAGGTGGATTGCCTGAACTCAGGAGTTTGAGACCAGCCTGGGCAGCATGGTGAAACCCCATCTGTACTAAAATACAAAAACTTTGCTGGGCGTGGCGGCATGCACATGTAGTCCCAGTTACTTGGGAGGCTGAGGCAGGATAATTGTTTGAACCTGGGAGGCGGAGGTTGTACAGTGAGCCAAGATCGCGCCACTACACTCTAGCGTAGGTGACAGAGCGAGATTCCGCCTCCAAAAAAAAAAGAAACCCTGTCTCTACTAAAAATACAAACAATTAGCTGGGCGTGGTGGTGGGCGCCTGTAATCCCAGCTACTTAGGAGGCTGAAGCAGGAGAATCGCTTGAGCCCAGGAAGTGGAGGTTGCAGTGAGCTGAGATTGCTCCATTGCACTCTAGCCTGGGCAACAAGAGTGAAACTCTGTCTCAAAAAAAGAA","GGCTGGGCGCAGTGGCTCACACCTGTAATCCCAGCACTTAGGGAAGCTGAGGCGAGTAGATCACCTGAGGTCAGGAGTTAGAGACCAGCCTGGCCATCATGGTGAAACCCCGTCTCTACTAAAGATACCAAAAATTAGCTGAGTGTGGTGCTGGGTGCCTGTAATCCCAGAAACTCAGGGTGCCTGTAATCCCAGCAACTCAGGGTGCCTTTAATCCCAGCAACTGAGGGTACCAGTAATCCCAGCAACTCAGGGTGTCTTTAATCCTAGCAACTGAGGGCACCTGTAATCCCAGCAACTCAGGAAGCTGAGACAGGAGAAGTACTTGAACCCAGAAGGCAGAGGTTGCAGTGAGCCGATATTGCACCATTGCACTCCAGTCTGGGCAACAAGAGTGAAACTCTGTCTCAAAAAAAAA"
"chr17","18237318","18237912","JH378118","18053084","18053501","239","184234","GGCCATGCGTGGTGGCTCACGCCTGTAATCCCAGTACTTTGGGAGGCTGAGGTGGGAGGATCACCTGAGGTCAGGAGTTCGAGACCAGCCTGGCCAACATGATGAAACCCTGTCTCTACTAAAAATGCAAAAAATTGGCCGGGCACGGTGGCTCACGCCTGTAATCCCAGCACTTTGGGAGGCCAAGGCGGGTGGATCACAAGGTCAGGAGCTTGAGACCAGCCTGGCCAATATGGTGAAACCCCATCTCTACTAAAAATACAAAAATTAGCCAGGCGTGGTGGTACACACCTGTAGTCCCAGCTACTCGGGAGGCTGAGGCAGGAGAATTGCTTGAACTCAGGAGGCAGAGGTTGCAGTGAGCTGAGATGGTGCCACTGCACTGCAGCCTGGGCAACAGAGTGAGACTTCATCTCAAAAAAAAAAAAAAAATTAACCGGGTGTGGTGGCACGTGCCTATGGTCCCAGCCACTGGGGAGGCTGAGGCAGGAGAATCGCTTGAACACAGGAGGCAGAAGTTGCAGTGAGCTGAGATTGCACCACTGCACTCCAGCCTGGGTGACAAGAGTGGAACTCCATCTCAAAAAAAAAAGAA","GGCTGGGCGCAGTGGCTCACACCTGTAATCCCAGCACTTAGGGAAGCTGAGGCGAGTAGATCACCTGAGGTCAGGAGTTAGAGACCAGCCTGGCCATCATGGTGAAACCCCGTCTCTACTAAAGATACCAAAAATTAGCTGAGTGTGGTGCTGGGTGCCTGTAATCCCAGAAACTCAGGGTGCCTGTAATCCCAGCAACTCAGGGTGCCTTTAATCCCAGCAACTGAGGGTACCAGTAATCCCAGCAACTCAGGGTGTCTTTAATCCTAGCAACTGAGGGCACCTGTAATCCCAGCAACTCAGGAAGCTGAGACAGGAGAAGTACTTGAACCCAGAAGGCAGAGGTTGCAGTGAGCCGATATTGCACCATTGCACTCCAGTCTGGGCAACAAGAGTGAAACTCTGTCTCAAAAAAAAA"
"chr17","18951167","18952093","JH378118","18053084","18053501","537","898083","GGCCAGGGGCAGTGGCTCATGCCTGTAATCCCAGCATTTTGGGATGCCAAGGCTGGTGGATCAACTGAGGTCAGGAGTTTCAGACCACCCTGGCCAACATGGCGAAATCCCATCTCTACTAAAAATACAAAAATTAGGCCAGGCACAGTGGCTCATGCCTGTAATCCCAGCACTTTGAGAGGCCAAGGCGGGCGATCACGAGGTCAGGAGATTGAGACCATCCTGGCTAACACGGTGAAATCCTGTCTCTACTAAAAAAAAAAAATACAAAAAATTAGCCGGGACGTGGTGGCTGGCACCTGTAGTCCCAGCTACTCGGGAGGCTAAGGCAGGAGAATGGCATGAACCCGGGAGATGGAGCTTGCAGTGACCCGAGATCGCGTCACTGCACTCCAGCCTGAACAACAGAGCAAGACTATATCTCAAAAAAAAAAAAAAAAAAAAGGCCGGGTGCAGTGGCTCACGTCTGTAATCCCAGCACTTTGGGAGGCCGAGGTGGGTGGATCACGAGGTCAGGAGATCGAGACCATCCTGGCTAACATGATGAAACCCCATCTCTACTAAAAAATACAAAAAATTAGCCGGGTGTGGTGGCAGGCACCTGTAGTCCCAGCTACTCGGGAGGCTGAGGCAGGAGAATGGCATGAACCTGGGTAGTGGAACTTGCAGTGAGCCGAGATCACGCCACTGCACTCCAGCCTGGGCGACAGAGCGAGACTCTGTCTCAAAAAAAAAAAAAAAAAAAAAATTAGCCGGGCATGGTGGTGGGTGCCTGCAATCCCAGCTAGTCAGGAGGCTGAGGCTGGAGAATCCCTTGAACCCAGGAGGTAGAGGTTGCAGTGAGCCAAGATCACGCCATTGCATTCCAGCCTGGGCAACAAGAGTGAAATTCTGTCTCAAAAAAATAAACAAACAAGTAAAATAAAA","GGCTGGGCGCAGTGGCTCACACCTGTAATCCCAGCACTTAGGGAAGCTGAGGCGAGTAGATCACCTGAGGTCAGGAGTTAGAGACCAGCCTGGCCATCATGGTGAAACCCCGTCTCTACTAAAGATACCAAAAATTAGCTGAGTGTGGTGCTGGGTGCCTGTAATCCCAGAAACTCAGGGTGCCTGTAATCCCAGCAACTCAGGGTGCCTTTAATCCCAGCAACTGAGGGTACCAGTAATCCCAGCAACTCAGGGTGTCTTTAATCCTAGCAACTGAGGGCACCTGTAATCCCAGCAACTCAGGAAGCTGAGACAGGAGAAGTACTTGAACCCAGAAGGCAGAGGTTGCAGTGAGCCGATATTGCACCATTGCACTCCAGTCTGGGCAACAAGAGTGAAACTCTGTCTCAAAAAAAAA"
"chr17","20996420","20997041","JH378118","18053084","18053501","266","2943336","GGCTAGGCGCGGTGGTTCACACCTGTAATCCCAGCACTTTGGGAGGCCAAGGTGGGTGGATCACCTGTGGTCAGGAGTTCGAGACCAGCCTGGCCAACATTGTGAAACCCCGTCTCTACTAAAAATGCAAAAAATTAGCTGGGCGACCAGTCATGGTAGCTCACGCCTGTAATCCTAGCACTTTGGGAGGCCAAGGCGGGTGGATTGCCTGAGCTCAGGAGTTAGAGGCCAGCCTGGGCAACATGGTAAAACCCTGTCTCTACTAAAATACAAAAAAAAAAAAAAAAATTAGCTGGGTGTGACAGCGTGCATCTGTAATCCCGGTTACTTGGGAGGTTGAGGCAGGAGAATTCCTTGAACCTAGGAGGCGGAGGTTACAGTTAGCCGAGATCACGCCATTGCACTCCAGCCTGGGCAACAGAGCGAGACTCCATCTCAAAAAAAAAAAAAAAAATTCAGCTGGGCGTGGTGGCGGGCACCTGTGATCCTAGCTACTCAGGAGGCTGAGGCAGGAGAATCATTTGAACTCCGGAGGCGGAGGTTGCAGTGACCCTAGATCGCACCATTGTGTTCCAGCCTGAGCAACAAGAGCGAGACGCCATCTGAAAAAAAAAAAAAGAAA","GGCTGGGCGCAGTGGCTCACACCTGTAATCCCAGCACTTAGGGAAGCTGAGGCGAGTAGATCACCTGAGGTCAGGAGTTAGAGACCAGCCTGGCCATCATGGTGAAACCCCGTCTCTACTAAAGATACCAAAAATTAGCTGAGTGTGGTGCTGGGTGCCTGTAATCCCAGAAACTCAGGGTGCCTGTAATCCCAGCAACTCAGGGTGCCTTTAATCCCAGCAACTGAGGGTACCAGTAATCCCAGCAACTCAGGGTGTCTTTAATCCTAGCAACTGAGGGCACCTGTAATCCCAGCAACTCAGGAAGCTGAGACAGGAGAAGTACTTGAACCCAGAAGGCAGAGGTTGCAGTGAGCCGATATTGCACCATTGCACTCCAGTCTGGGCAACAAGAGTGAAACTCTGTCTCAAAAAAAAA"
"chr17","21298865","21299429","JH378206","6546474","6546861","222","14752391","GGCCGAGGCAGGTGGATCACCTGAGGTCAGGAGTTCAAGACTAGTCTGGCCAACATGGTGAAACCCTGTCTCTACTAAAAATACAAAAAATTGGCCGGGCGCGGTGGCTCATGCCTGTAATCCCAGCACTTTGGGAGGCTGAGGCGGGTGGATCACGAGGTCGGGAGATCGAGACCATCCTGGCTAACACAGTTAAACCCTTTCTCTACTAAAAAATACAAAAAATTAGCCGGGCGTAGTGGGGGGCGCCTGTAGTCCCAGCTACTCAGGAGGCTGAGGCAGGAGACTGGCGTGAACCCGGGAGGCAGAGCTTGCAGTGAGCTGAGATCACGTCACTGCATGCCAGCCTGGGCGACAGAGCGAGACTCTGTCTCAAAAAAAAAAAATTAGCCAGGCATGGTGGTGTACACCTGTAATCCTAGCTACTCGGGAAGCTGAGCAGGAGAACAGCTTGAACCCAGGAGGCAGAGGTTGCAGTGAGCTGAGATCACGCCATTGCACTCCAGCCTGGGCAACAAGAGTGAAACTCCGTCTCAAAAAAAAAAAAAGAAAAGAAAAAAGAAAA","GGCCACACATGGTGGCTAACGCCTGTAATCCCAGCACTTTGGGAGGCCAAGTCGGGTGGATCATGAGGTCAGGAGACCAAGACCATCCTGGCCAAATGGTGAAACCCCGTCTCTACTAAAAATACAAAAATTAGCTGGGCATGGTGGCGTGTGCCTGTAATCCCAGCTACTCAGGAGGCTGAGGCAGGACAATTGCCTGAACCCAGGAGAATTAGCTGGGCATGGTGGCGTGTGCCTGTAATCCCAGCTACTCAGGAGGCTGAGGCAGGACAATTGCCTGAACCCAGGAGGCGAAGGTTGCGGTGAGCCGAGATTGTGCCATTGCACTCCAGCCTGGGTAACAAGAGCGACACTCTGTCTCAAAAAAAAAAAAAAAAAAAAAAAAAAA"
"chr17","21663027","21663921","JH378118","18053084","18053501","517","3609943","TTGGGAGGCCAAGGTGGGCCTCCCAGACACGTGAGGTCAGGAGTTTGAGACCAGCCTGGACAATATGGCGAAACCCCATCTCTACTAAAAAAACACAAAAATTGGTTGGGCCGGGCACGGTGGCTCACGCCTGTAATCCCAGCACTTTGGGAGGCCGAAGTGGGCAGATCACGAGGTCAGGAGATCGAGATCATCTTGGCTAACATGGTGAAACTCCGTCTTTACTTAAAATACAAAAAATTAGCTGGGCATGATGGCAGGCAGTTGGAGTCCCAGCTACTTGGGAGGCTGAGGCAGGAGAATCGCTTGAACCCGGGAGGCAGAGGTTGCAGTGAGCTGAGATCGTGCCATTGCACTCCAGCCTGGGTGACAGAATGAGACTCCGTCTGAAAAAAAAACAAAAAACAAAAAACAAAAATTGGCCAGGTGCGGTGGCTCACGCCTGTAATCCCAGAACTTTGGGAGGCCGAGGCAGGTGGATCATGAGGTCAGGAGTTCAAGACCAGCCTGGCCAAGATGGTGAAACCCCATCTCTACTAAAAATACAAAAATTAGGCGGGCACGGTGGCAGGTGCCTGTAATCTCAGCTACTCAGGAGGCTGAGGCAGGAGAATTGCCTGAAGCCGGGTGGCAGAGGTTGCAGAGAGCTAAGATCACGCCACTGCACTCCAGCCTGGGTGATAGAGTAAGACTCTATCTCAAAAAAAGAAAAAAAAAAATAGCCGGGCATTGTGCTGGGCGCCTGTAATCCCAGCTACTTGGGAGGCTGAGACAAGAGAATCACTTGAACCTGGGAGGCGGAGGTTGCAGTGAGCCGAGATCGTGCCATTGCACTCCAGCCTGGGTGAGAAGAGCAAAACTCTGTCTCAAAAAAACAAAAAAAGAAGAAAACAAA","GGCTGGGCGCAGTGGCTCACACCTGTAATCCCAGCACTTAGGGAAGCTGAGGCGAGTAGATCACCTGAGGTCAGGAGTTAGAGACCAGCCTGGCCATCATGGTGAAACCCCGTCTCTACTAAAGATACCAAAAATTAGCTGAGTGTGGTGCTGGGTGCCTGTAATCCCAGAAACTCAGGGTGCCTGTAATCCCAGCAACTCAGGGTGCCTTTAATCCCAGCAACTGAGGGTACCAGTAATCCCAGCAACTCAGGGTGTCTTTAATCCTAGCAACTGAGGGCACCTGTAATCCCAGCAACTCAGGAAGCTGAGACAGGAGAAGTACTTGAACCCAGAAGGCAGAGGTTGCAGTGAGCCGATATTGCACCATTGCACTCCAGTCTGGGCAACAAGAGTGAAACTCTGTCTCAAAAAAAAA"
"chr17","21688652","21689276","JH378118","18053084","18053501","258","3635568","GGCCGGGTGCCATGGCTCACGCCTATAATCCCAGCACTTTGGGAGGCCAAGGTGGGCGGATCACCTGAGGTCAGGAGTTTGAGACCAGCCTGGCCAACATAGTGAAACCCCGTCTCTACTAAAAATACGAAAAGTTAGCTGGGGGTGCAGTGGCTCACACCTGTAATTCCAGCACTTTGGGAGGCCGAGGCAGGTGAATCACGAGGGGAGGAGTTTGAGACCAGCCTAACCAATATGTTGAAACCCCGTTTCTACTAAAAATACAAAAATTAGCTGGGCGTGGTGGCACGTGCCTATAATCCCAGCTACTCAGGAGGCTGAGGCAGGAGAATCGCCTGAACCTGGGAGGCGGAGGTGGCAGTGAGCCAAGATCACACCACTGCACTTTAGCCTGGGTGACAGAGGGAGACTCTGTCTCAAAAAACAAAACAAAACAAAACAAAAAATTAGGCAGGCTTGGTGGCACATGCCTGTAATCCCAGCTACTCAGGAGGCTGAGGCAGGAGAATTGCTTGAACCCAGGAGGCAGAAGTTGCAGTGAGCTGAGATCGCGCCATTGCACTCCAGCCTGGGTAACAAGAGTGAAACTCCATCTCAAAAAAAAAAAAAAAAAAAAAAAAAAAAA","GGCTGGGCGCAGTGGCTCACACCTGTAATCCCAGCACTTAGGGAAGCTGAGGCGAGTAGATCACCTGAGGTCAGGAGTTAGAGACCAGCCTGGCCATCATGGTGAAACCCCGTCTCTACTAAAGATACCAAAAATTAGCTGAGTGTGGTGCTGGGTGCCTGTAATCCCAGAAACTCAGGGTGCCTGTAATCCCAGCAACTCAGGGTGCCTTTAATCCCAGCAACTGAGGGTACCAGTAATCCCAGCAACTCAGGGTGTCTTTAATCCTAGCAACTGAGGGCACCTGTAATCCCAGCAACTCAGGAAGCTGAGACAGGAGAAGTACTTGAACCCAGAAGGCAGAGGTTGCAGTGAGCCGATATTGCACCATTGCACTCCAGTCTGGGCAACAAGAGTGAAACTCTGTCTCAAAAAAAAA"
"chr17","22129020","22129352","JH378128","1602813","1603145","53","20526207","GCCAGGCACGGTGGCTCACACCTGAATTCCAGTACTTTGGGAGGCCGAGGCGGGCGGATCTCTTGAGGTCAGGAGTTTGAGACCAGCCTGGCCAACATGGTGAAACCCCATCTCTACTAAAAATACAAAAATTAGCCGGGCGTGGTGGCAGGTGCCTGTAATCCCAGCTACTTGGGAGGCTGAGGCAGGAGAACCTCTTGAACCCAGGAGGTGGAGGCTGCAGTGAGCTGAGATTGTGCCACTTCACTCCAGCCTGGAAGACAAGAGCAAGACTTCATCTCAAAAAAAAATAAAAAAAAAATAAATAAATAAATAAATAAAAATTTAAAAAAA","GGCCAGGTGCAGTGGCTCACGCCTGTAATACCAGCATTTTGGGAGGCCGAGGCAGGTGGATCACGAGGTTAGGAGTTTGAGACCAGCATGGCCAACATGGAGAAACCCCGTCTCTACTAAAAATACAAAAATTAACCAGGCATGGTGGCAGGTGCCTGTAATTCCATCTACTCGGGAGGCTGAGGCAGGAGAATCCCTTGAACCTGGGAGGCGGAGGTTGCAGTGAGCCGAGATTGTGCCATTGCACTCAGTCTGGGTGACAAAAACAAGACTCCATCTCAAAAAAAAAAAAAAGAAAAGAAAAAGAAAAAAAGAAAGAAAGAAAGAAAGAAA"
"chr17","22130129","22130738","JH378118","18053084","18053501","262","4077045","GGCTGGGCACAGTGGCTCACGCCTGTAATCTCAGCACTTCGGGAAGCCGAGGCGGGCAGATCAGCTGAGGTCAGGAGTTCAAGACCAGCCTGGCCATGGCAAAACCCTGTCTCTACTAAAAAATGCAAAAAATAGGGGCCAGGCACGGTGGCTCACGCCTGTAATCCCAGCATTTTGGGAGGCCAAGGCAGGCGGATCACAAGGTCAGGAGGTTGAGACCATCCTGGCCAACATGGTGAAACCCCATCTCTACTAAAAATACAAAAATTAGCTGGGTGTGGTGGCCTGTGCCTGTAATCCCAGCTACTTGGGAGGCTGAGGCAGGGGAATCACTTGAATCCAGGAGACAGAGGTTGTAGTGAGCTGAAATGGAGCCACTGCACTCCAGCCTGGCGGCAGAGCGAGACTCTGTCTCAAAAAAAAAAAAAATACAAAAAATAGCTAGGTGTGATGGTGGGCACCTGTAATCCCAGCTACTTGGGTAGCCGAAGCAGGAGAATCGCTAGAACCTGGGAGGTGGAGGTTTAGTAAGCTGAGATCACACCATTGCACTCCAGCCTGGGTATCAACAGCGAAACTCCATCTCAAAAAAAAAAAAAAAAAAAGAAAA","GGCTGGGCGCAGTGGCTCACACCTGTAATCCCAGCACTTAGGGAAGCTGAGGCGAGTAGATCACCTGAGGTCAGGAGTTAGAGACCAGCCTGGCCATCATGGTGAAACCCCGTCTCTACTAAAGATACCAAAAATTAGCTGAGTGTGGTGCTGGGTGCCTGTAATCCCAGAAACTCAGGGTGCCTGTAATCCCAGCAACTCAGGGTGCCTTTAATCCCAGCAACTGAGGGTACCAGTAATCCCAGCAACTCAGGGTGTCTTTAATCCTAGCAACTGAGGGCACCTGTAATCCCAGCAACTCAGGAAGCTGAGACAGGAGAAGTACTTGAACCCAGAAGGCAGAGGTTGCAGTGAGCCGATATTGCACCATTGCACTCCAGTCTGGGCAACAAGAGTGAAACTCTGTCTCAAAAAAAAA"
"chr17","23633062","23633662","JH378118","18053084","18053501","247","5579978","GGCCAGGCGTGGTGGCTTACGCCTGTAATCCCAGCATTTTGGGAAGCTGAGGCAGGTGGATCACCTGAGGTCAAGAGTTCAAGACCAGCCTGGCCAACATGGTGAAACCCCGTCTCTACTGCAAATACAAAAAATTAGTAGCCGGGCATGGTGGCTCACGCCTGTAATCCCAACACTTTGGTAGGCCAAGGCGGGTGGATCACCTGAGGTCGGGAGTTCGAGACCAGCCTGACCAACATGGAGAAACCCCGTCTCTACTAAAAGTACAAAATTAGCCAGGGATGGTGGCATGTGCCTGTAATCCCAGCTATTTGGGAAGCTAAGGCACAAGAATCGCTTTGAACCTGGGAGACAGAGGTTGCAGTGAGCTGAGATCGCACCATTGCACTCCCGCCTGGGCAACAAGAGCGAAACTCCATCTAAAAAAAAAAAAAAAAAAAAAAAAGCCAGGCATGGTGACAGGCACCTTGTAATCCCAGCTACTCGGAAGGCTGAGGCAGGAGAATCGCTTGAACACTGCAGAGGTTGCAGTGAGCTGAGATCACGCCATTGCACTGCAGCCTAGGCAACAAGAGTGAGACTCTATCTCAAAAAAAAGAAA","GGCTGGGCGCAGTGGCTCACACCTGTAATCCCAGCACTTAGGGAAGCTGAGGCGAGTAGATCACCTGAGGTCAGGAGTTAGAGACCAGCCTGGCCATCATGGTGAAACCCCGTCTCTACTAAAGATACCAAAAATTAGCTGAGTGTGGTGCTGGGTGCCTGTAATCCCAGAAACTCAGGGTGCCTGTAATCCCAGCAACTCAGGGTGCCTTTAATCCCAGCAACTGAGGGTACCAGTAATCCCAGCAACTCAGGGTGTCTTTAATCCTAGCAACTGAGGGCACCTGTAATCCCAGCAACTCAGGAAGCTGAGACAGGAGAAGTACTTGAACCCAGAAGGCAGAGGTTGCAGTGAGCCGATATTGCACCATTGCACTCCAGTCTGGGCAACAAGAGTGAAACTCTGTCTCAAAAAAAAA"
"chr17","34071612","34072215","JH378118","18053084","18053501","250","16018528","GGCCAGGTGTGGTGCCTTACATCTGTAATTCCAGCACTTTGGGAGGCTGAGGTGGGTGGATCACCTGAGGTCAGGAGTTCAGGACCAACCTGGCCAACATAGTGAAACCCCGTCTCACTAAAAATACAAAAATTAAAAAGAAAGAAAGAAAAAAGCCAGGTGCGGTGGCTCACACCTGTAACCCCAGCACTTTGGGAGGCCAAGATGGGCGGATCACCTGAGGTCGGGAGTTTGAGACCAGCCTGACCAACATGGAGAAACCCCGTCTCTACTAAAAATACAAAATTAACCAGGCGTGGTGGTGCATGCCTGTAATCCCAGCTACTTGGGAGGATGAGGCAGGAGAATCGCTTGAACCCTGGAGGCGGAGGTTGTGGTGAGCTGAGATCATGCCATTGCACTCCAGCCTAGGCAACAAGAGCGAGACTCCATCTCAAAAAAAAAAAAAAAATTGGGCATGGTGGTGCATGCCTGTAATCCCAGCTACTCAGGAGTCTAAGGCAGGAGAATCACTTGAACCCAGGAGGCAGAGGTTGCAGTGAGCTGAGATCACGCCATTGCACTCCAGCCTGAGCGACAAGAGTGAAACTACGTCTCAAAAAAA","GGCTGGGCGCAGTGGCTCACACCTGTAATCCCAGCACTTAGGGAAGCTGAGGCGAGTAGATCACCTGAGGTCAGGAGTTAGAGACCAGCCTGGCCATCATGGTGAAACCCCGTCTCTACTAAAGATACCAAAAATTAGCTGAGTGTGGTGCTGGGTGCCTGTAATCCCAGAAACTCAGGGTGCCTGTAATCCCAGCAACTCAGGGTGCCTTTAATCCCAGCAACTGAGGGTACCAGTAATCCCAGCAACTCAGGGTGTCTTTAATCCTAGCAACTGAGGGCACCTGTAATCCCAGCAACTCAGGAAGCTGAGACAGGAGAAGTACTTGAACCCAGAAGGCAGAGGTTGCAGTGAGCCGATATTGCACCATTGCACTCCAGTCTGGGCAACAAGAGTGAAACTCTGTCTCAAAAAAAAA"
"chr17","34329459","34330029","JH378119","32351107","32351490","237","1978352","GGCCAGGTGCCGTGGCTCACACATGTAGTCCCAGCACGTTGGGAGGCTGAGGTTAATGGATCACCTGAAGTCACAAGTTCGAGACCAGCCTGACCAACATGGTGAAACCCTGTCTCTACTAAAATATAAAAAGTAGTCGGCCGGGCGCAGTTGCTCATGCCTGTGATCGCCTGAGGTCAGGATTTCAAGCCCAGCCTGGCCAAAATGGTGAAACCCCATCTCTACTAAAAATATAAAAATTAGCCAGGCATGGTGGCAGGTGCCTGTAATCCCAGCTACTCAGGAGGTTGAGGCAGGAGAATCACTTGGACCCAGGGGGCAGAGGTTGCAGTGAGCCAAGATCACAGCATCGCACTCCAGCTTAGGCAACAAGAGAGAAACTCCATCTCAAAAAAAACCCAAAAAAAACAAAAAAACAAAAAAACCCAGGCATGGTGGCAGGCGTCTGTAATCTCAGCTACTCGGGAGGCTGAGGCAAGAGAATCGCTTGAACCTGGGAGGCAGAGGTTGCAGTGAGCCAAGATCATGCCATTGCACTCCAGACTGAGCAATAAGAGCGAAACTCCATCTC","GGCCAGGTATGGTGGCTCACACCTGTAATCCCAGCACTTTGGGAGGCCAAGGCAGGCAGACCACCTGAGGTCAGGAGTTCGAGATCAGCCTAGCCAACATGGTGAAACCCCATCTCTAGTAAAAATAAAATTAGCCAGGCATGGTGGTGCATGCCTGTAACGCAGGTCAGGAGTTCGAGATCAGCTTAGCCAACATGGTGAAACCCCATCTCTAGTAAAAATAAAATTAGCCAGGCAGGTGGTGCCGCCTGTACTCGGGAGGCTGAGGCAGGAGAATCACTTGAACCCAAGAGGCAGAGGTTGCAGTCAGCCAAGATCATGCCATTGCACTCCAGCCTAAGCAAAAAGAGTAAAACTCAGTCTCAAAACAAAAAAACAAAAAAA"
"chr17","35196292","35196625","JH378228","5665092","5665424","47","29531200","GGCTGGGCATGGTGTCTTACGCCTGGAATCCCAGCACTTTGGGAGGCCAAGGCGGGTGGATCACCTGAGGTCAGGAGTTTGAGACCAGCCTGGCCAACATGTTGAAACTCTGTCTCTACTAAAAATACAAAAATTAGCCGGGCATGGTGGCGGATGCCTGTAATCCCAACTACGTGGGAGGCTGAGGCAGGAGAATCGCTTGAACCCAGGAGATGGAGGTTGTGGTGAGCCGAGATCATGCCATTGCACTCCAGCCTGGGCAACAAGAACAAAACTCTGTCTCAAAATAAATAAAAAAATAAATAAATAAATAAAAACAACAACAACAACAAAA","GGCCGGGCGCGGTGGCTCAAGCCTGTAATCCCAGCACTTTGGGAGGCTGAGGCGGGTGGATCACGAGGTCAAGAGATCGAGACCATCCTGGTCAACATGGTGAAACCCTGTCTCTACTAAAAATACTAAAAATTAGCTGGGCATGGTGGCGTGTGCCTGTAATCCCAGCTACTCAGGAGGCTGAGGCAGGAGAATTGCCTGAACCCAGGAGGCGGAGGTTGCGGTGAGCCGAGATCGCGCCATTGCACTCCAGCCTGGGCAACAAGAGCGAAACTCTGTCTCAAAAAAAAAAAATAAATAAATAAAATAAAATAAAATAAAATAAAATAAAAT"
"chr17","40291413","40291755","JH378144","13229286","13229620","52","27062127","GGCCAGGCACAGTGGCTCATGCCTGTAATCCCAGCACTTTGCGAGGCTGAGCCAGGTGGATCACCTGAGGTCAGGAGTTCAAGAGCAGCCTGGCCAACATGGTGAAACCCCGTCTCTACTAAAAATACAAAAATTATCTGGAGTGGTGGTAGGTGCCTATAATTGCAGATACACAGAAGGCTGAGACAGGAGAATTGCTTGAACCCAGGAGGCGGAGGTTGCTGTGAGCCGAGATCGCGCCATTGCACCCCAGCCTGGGAGACAAGAGCGAAACTCCATCTCAATAAATAAATACATACATACATACATACATACATGCATACATACATAAAATAAAATAAAA","GGCCGGGCGCGGTGGCTCAAGCCTGTAATCCCAGCACTTTGGGAGGCCGAGGCGGGTGGATCACCTGTGGTCAGGAGTTCAAGACAGCTTGGTCAACATGGTGAAACCCCGTCTCTACCAAAAATACAAAAAATTAGCTGGGCATGGTAGCGCATGCCTGTAATCCCAGCTACTCAGGAGGCTGAGGCAGGAGAATTGCCTGAACCCAGGAGGCAGAGGTTGCGGTGAGCCGAGATCGCGCCATTGCACTCCAGCCTGGGTAACAAGAGCGAAACTCCCTCTCATAAAAAATAAATAAATAAATAAATAAATAAATAAATAAATAAATAAATAAA"
"chr17","45148344","45148987","JH378206","6546474","6546861","299","38601870","GGCTTGGTGCCATGGTTCATGCCTGTAATCCTGGCACTTTGGGAGGCCGAGGTGGGCAGATCACTTGAGCTCAGGAGTTCAAGACCACCTTGGGCGACATGGTGAAACCTCATCTCTCCTTAAAAAAAAAAAAAACAGCCGGGCGCGGTGGCTCACACCTGTAATCCCAGCACTTTGGGAGGCCAAGGCGGGTGGGGTTCATGAGGTCAGAAGATCGAGACCATCCTGGCTAACACGGTGAAACCCCGTCTCACTAAAAATAGAAAAAACTAGCCGGGCGTGGTGGCGGGCACCTGTAGTCCCAGCTACTCGGGAGGCTGAGGCAGGAGAATGGCGTGAACCCGGGAGGCGGAGCTTGCAGTGAGCTGAGATCTTGCCATTGCACTCCAGCCTGGGCAACAAGAGTGAAACTCTGTCTCAAAAAAAAAAAATTAAAAAAACAAATAAAAATAAAAATACATAATTAGCAGGACATGGTGGCACATGCCTGTAATCCCCAGCTACTCGGGAGGCTGAGGCATGGGAATTGTTTAAACCTGTGAGGCGGTGGTTGCAGTGAGCCAAGATCAAGCCATTGCACTCCAGCCTGGGCAACAAGAGTGAAACTCCATCTCAAAAAAAAAAAAAAAAAAGAGAAAAGAAAA","GGCCACACATGGTGGCTAACGCCTGTAATCCCAGCACTTTGGGAGGCCAAGTCGGGTGGATCATGAGGTCAGGAGACCAAGACCATCCTGGCCAAATGGTGAAACCCCGTCTCTACTAAAAATACAAAAATTAGCTGGGCATGGTGGCGTGTGCCTGTAATCCCAGCTACTCAGGAGGCTGAGGCAGGACAATTGCCTGAACCCAGGAGAATTAGCTGGGCATGGTGGCGTGTGCCTGTAATCCCAGCTACTCAGGAGGCTGAGGCAGGACAATTGCCTGAACCCAGGAGGCGAAGGTTGCGGTGAGCCGAGATTGTGCCATTGCACTCCAGCCTGGGTAACAAGAGCGACACTCTGTCTCAAAAAAAAAAAAAAAAAAAAAAAAAAA"
"chr17","47866693","47867898","JH378118","18053084","18053501","809","29813609","GGCTGGGCTTGGTGGCTCATGCCTATAATTCTAGGACTTTGGGAGGCCAAGGCGGATGGATCACCTGAGGTCAAGAGTTGGAGACCAACCTGTCCAACATGGTGAAACCCCCTCTGTACTAAAAATACAAAAATTGGCCGAGCGTAGTGGCTCATGCCTGTGATCACAGCACTTTGAGAGGCTGAGGCGGGCGGATCACAAGGTCAGGAGATCAAAACCATCCTGGCTAACAAGGTGAAACCCCATCTCTGCTAAAAAATAACAGGGCGTGGTGGCACACGGCTGTAGTCCCAGCTACTTGGGAAGCTGAGGCAGGAGAATCGCTTGAACCTGAGAGGCAGAGGTTGCAGTGAGCTGAGATCAGGCCACTGCTCTCCAGCCTGGGCAACAGAGTGAAACTCCATCTCAAAAAAAAAAAGAAAAAGGCCAGGCATGGTGGCTCACGCCTGTAATGCCAGCACTTTGGAAGACTAAGTTGGGCAGATCACAACATCAGAAGATGGAGACCATCCTGGCTAACACGGTGAAACCCCGTCTCTACTAAAAATACAAAAAAAAAAAAAAAAAAAATTAGCCGGGCGTGGTGACATGCGCCTGTAATCCTAGCTACTCCGGAGGCTGAGGCAGGAGAATGGCGTGAACCCGGGAGGCGGAGCTTGCAGTGAGCCGAGATGGTGCCACTGCACTCCAACCTGGGCGACAGAGCGAGACTCTGTCTCAAAAAAAAAAAAAAAAAAGAAAAAAGGTCGGGCGCAGTGGCTCACACCAGTAATCACAGCACTTTGGGAGGCCGAGGCGGGTGGATCACCTGAGCTCGGGAGTTCAAGACCAGCCTGACCAACATGGTGAAACTCCGTCTCTACTAAAAATACAAAATATTAGCCGGGCGTGGTGGCGCGTGCCTGTAATCCCAGTTACACGGGAGGCTGAGGCAGGAGAATCACTTGAACTTGGGAAGTGGAGGTTGTGGGAGCCGAAATCGTGCCATCGCATTCCACAAGAGTGAAACTCCATTTCAAAAAAAAAAAATACAAAAATTAGCTGGGCGTGGTGGCGGGCGCCTTTAATCCCAGGGGCTCGGGAGGCTGAGGCAGGAGAATCGCTTGAACCTAGGAGGCAGAGGTTGCAGTGTGCCAAGATGACACCATTGCACTCCAGGCTGGGCAAGAGAGCAGTAACTCCCGTCTCAAAAAAAAAGAAGGAAAA","GGCTGGGCGCAGTGGCTCACACCTGTAATCCCAGCACTTAGGGAAGCTGAGGCGAGTAGATCACCTGAGGTCAGGAGTTAGAGACCAGCCTGGCCATCATGGTGAAACCCCGTCTCTACTAAAGATACCAAAAATTAGCTGAGTGTGGTGCTGGGTGCCTGTAATCCCAGAAACTCAGGGTGCCTGTAATCCCAGCAACTCAGGGTGCCTTTAATCCCAGCAACTGAGGGTACCAGTAATCCCAGCAACTCAGGGTGTCTTTAATCCTAGCAACTGAGGGCACCTGTAATCCCAGCAACTCAGGAAGCTGAGACAGGAGAAGTACTTGAACCCAGAAGGCAGAGGTTGCAGTGAGCCGATATTGCACCATTGCACTCCAGTCTGGGCAACAAGAGTGAAACTCTGTCTCAAAAAAAAA"
"chr17","48059944","48060302","JH378108","45564157","45564495","64","2495787","GGCCGGGCGCAGTGGTTCATGCCTGTAATCCCAACACTTTAGGGGGCTGAGGCAGGTGGATCACCTGAGGTCAGGAGTTCAAGACCAGCCTGGCCAACATGGTGAAAGCCCATCTCTACTAAAAATACAAAAAATTAGCTGGGCATGGTGGTGCGTGCCTGTAATCCCAGCTACTTGGGATGCTGAGGCAGGAGAATCGCTTGAACCCGGGAGGTGGAGGCTGCAGTGAGCTGAGATTGTGCCATTGCACTCCAGCCTGGGCAACAAGAGTGAAACTCCATCTAAAAAAAAAAAAGAAGAGGAGGAGGAGGAGGAGGGGGAGGGGGAGGAGGAGGAGGAGGAGAAGAAGAAAAAAGAAA","GCTAGGCAAGGTGGCTCATGCCTGTAATCCCAACATTTTGGGAGGCCGAGGCAGATGGATCACCTGAGGTTAGGAGTTCAAGACCAGCCTGGCCAACATGGTGAAACTCCATCTCTACTAAAAATACAAAAAATTAGCTTGGCACGGTGGTGGGTGCCTCTAATCCCAGCTGCTTGGGAGGCTGAGGCAGGAGAATCGCTTGAACTCAGGAGGTGGAGGTTGCAGTGAGCCAAGATCATGGCATTGCACTCCAGCCTGGGCGACAAGAGCGAGACTCCCTCTAAGAAAGAAAAGAAAGAAAAGAAAAGAAAAAAGGAAAGGAAAGGAAAGAAAGAGAAA"
"chr17","50365982","50366602","JH378118","18053084","18053501","274","32312898","GGCAAGGCGTGGTGGCTGATGTCTGTAATCCCAGCAATTTGGGGGGCTGAGGTGGATGGATCACCTGAGATCAGAAGTTCGAGACTAGGCTAGCCAACATAGTGAAACCCCATCTCTACTAAAAATATAAAAAGTTAGCCAGGCGCGGTGGTTCATGCCTGTAATCCCAGCACTTTGGGAGGCCGAGGTAGGTGGATCACAAGGTCAGGAGTTCAAGACCAACCTGGCCAAGATAGTGAAACCTCATCTCTACTAAAAATACAAAAATTAGCTGGGCGTGGTGGCAACCACCTATGATCCCAGCTACTTGGGAGGCTGAGGCAGAGAACTGCTTGAACCCAGGAAGTGGAGGTTGTAGTGAGCCAAGATTGCATCACTGTACTCCAGCCTGGGCAACAGAGCAAGACTCCATCTCAAAAAAAAAAAAAAAAAAAATACAAAAAATTAGCCAGGCGTGGTGGCAGGCACCTGTAATCCCAGCTACTCGGAAGGCTGAGGCAGGAGAATTGCTTGAACCTGGGAGGTAGAGGTTGCAGTGAGCTGAGATTGTGCCATTGCACTCTAGCCTATGTGACAAGAGCGAAACTCCATCTCAAAAAAAAAAAAAAAAAAGAAAGAAAA","GGCTGGGCGCAGTGGCTCACACCTGTAATCCCAGCACTTAGGGAAGCTGAGGCGAGTAGATCACCTGAGGTCAGGAGTTAGAGACCAGCCTGGCCATCATGGTGAAACCCCGTCTCTACTAAAGATACCAAAAATTAGCTGAGTGTGGTGCTGGGTGCCTGTAATCCCAGAAACTCAGGGTGCCTGTAATCCCAGCAACTCAGGGTGCCTTTAATCCCAGCAACTGAGGGTACCAGTAATCCCAGCAACTCAGGGTGTCTTTAATCCTAGCAACTGAGGGCACCTGTAATCCCAGCAACTCAGGAAGCTGAGACAGGAGAAGTACTTGAACCCAGAAGGCAGAGGTTGCAGTGAGCCGATATTGCACCATTGCACTCCAGTCTGGGCAACAAGAGTGAAACTCTGTCTCAAAAAAAAA"
"chr17","50542261","50542886","JH378206","6546474","6546861","277","43995787","GCCGGGCGCTGTGGCTCAAGCCTGTAATCCCAGCATTTTGGGAGACTAAGGGAAGCAGATCCTGTGAGCTCAGGATTTCGAGACCAGCCTGGCCAACATGGTGAAACCCTGTCTCTACAAAAATTAGCCATGCCGGGCACGGTGGCTCACGCCTGTAATCCCAGCACTTTGGGAGGCTGAGGCGGGCGGATCACAAGGTCAGGAGTTTGAGACCATCCTGCCTAACACGGTGCAACCCCGTCTCTACCAAAAATACAAAAAATTAGCTGGGCGTGGTGGCGGGTGCCTGTAGTCCCAGCTACTCGGGGGGCTGAGGCAAGAGAATGGCATGAACCTGTGGGGCGGAGCTTGCTGTGAGCCGATATCCTGCCACTGCACTCCAGCCTGGGCGACAGAGCGAGACTCCATCTCAAAAAAAAAAAAAAAAAAAAAAAAAAAAAAAAATGAGCCAGCTGTGGTGGCGTGTGTGCCTGTAATCCCAGCTACTCGGGAGGCTGAGGCAAGAGAATCACTTGAATCTGGGAGGCAGAGGTTGCAGTGAGCCAAGATCATGCTATTGCACTTCAGCCTGGGCAACAAGAGTGAAACTCTGTCTCAAAAAAAAAAAAAAAAAAAAAGAAAAAGAA","GGCCACACATGGTGGCTAACGCCTGTAATCCCAGCACTTTGGGAGGCCAAGTCGGGTGGATCATGAGGTCAGGAGACCAAGACCATCCTGGCCAAATGGTGAAACCCCGTCTCTACTAAAAATACAAAAATTAGCTGGGCATGGTGGCGTGTGCCTGTAATCCCAGCTACTCAGGAGGCTGAGGCAGGACAATTGCCTGAACCCAGGAGAATTAGCTGGGCATGGTGGCGTGTGCCTGTAATCCCAGCTACTCAGGAGGCTGAGGCAGGACAATTGCCTGAACCCAGGAGGCGAAGGTTGCGGTGAGCCGAGATTGTGCCATTGCACTCCAGCCTGGGTAACAAGAGCGACACTCTGTCTCAAAAAAAAAAAAAAAAAAAAAAAAAAA"
"chr17","51121894","51122508","JH378118","18053084","18053501","260","33068810","GGCTGGGTGCAGTGGCTCATGCCTGTATTCCCAACACTTTGAGAGGCCAAGGCGGGCAGATCACCTGAGGTCAGGAATTCGAGACCAGCCTGGCTAACATGGCGAAACCCTGTCTCTATTAAAAACACAAAAATTAGGCCAGGCACGGTGGCTCACACCTGTAATCCCAGCACTTTGGGAGGCTGAGGCGGGCAGATCACGAAGTCAGGAGATCGAGACCATCCTGGCTAACATGGTGAAACCCTGTCTCTGCTAAAAATACAAAAAAAATAGCGGGGCGTGGTGGCAGGCGCCTGTAGTCCCAGCTACTCAGGAGGCTGAGGCAGGAGAATGGCGTGAACCTGGGAGGCGGAGGTTGCAGTGAGCCGAGATCGCGCCACTGCACTACAGCTTGGGTGACAGAGCGAGACTCTGTCTCAAAAAAAAAAAAAAAAGTTAGTCGGGCATGGTGGTGGGCTCCTGTATTCCCAGCTACTCAGGAGGCTGAGGTGGGAGAATCACTTGAACCTGGAAGGCAGAGGTTGCTGTGAGCCAAGATTGCACCATTGCATTCCAGCCTGGGTGACAAGAGCAAAACTCTGTCTCAAAAAATATATATAAAATAATAAAAATAAA","GGCTGGGCGCAGTGGCTCACACCTGTAATCCCAGCACTTAGGGAAGCTGAGGCGAGTAGATCACCTGAGGTCAGGAGTTAGAGACCAGCCTGGCCATCATGGTGAAACCCCGTCTCTACTAAAGATACCAAAAATTAGCTGAGTGTGGTGCTGGGTGCCTGTAATCCCAGAAACTCAGGGTGCCTGTAATCCCAGCAACTCAGGGTGCCTTTAATCCCAGCAACTGAGGGTACCAGTAATCCCAGCAACTCAGGGTGTCTTTAATCCTAGCAACTGAGGGCACCTGTAATCCCAGCAACTCAGGAAGCTGAGACAGGAGAAGTACTTGAACCCAGAAGGCAGAGGTTGCAGTGAGCCGATATTGCACCATTGCACTCCAGTCTGGGCAACAAGAGTGAAACTCTGTCTCAAAAAAAAA"
"chr17","51573403","51574012","JH378118","18053084","18053501","260","33520319","GGCCGGGTGTGGTGGCTCACGCCTATTATCCCAGCAGTTTGGGAGGCCAAGTGGGGGTTGGATCACCTGAGGTCAGGGGTTCGAGACCAGCATGGCCAACATGGTGAAAACCCATCTATACTAAAGATACAAAAAATTAGGCTGGGCACAGTGGCTCATGCCTGTAATCCCAGCACTTTGGGAGGCCAAGGATCACGAGGTCAGGAGATCGAGACCATCCTGGCTAACACAGTGAAACCCCGTCTCTACTAAAAATACAAAAAAATTAGCCGGGAGTGGTGGCAAGTGCCTGTAGTCCCAGCTACTCAGGAGGCTGAGGCAGGTGAATAGTGTGAACGCAGGAGGCAGAGCTTGCAGTGAGCCGAGATCGTGCCACTACACTCCAGCCTGGGCGACAAGGTGAGACAACGTCTCAAAAAAAAAAAAAAAAAAAAGCCGGGCATGGTGGGAGGCACCTGTAATTCCACCTACTTGGGAGGGTGAGGCAGGAGAATTGCTTGAATCTGGGAGATGGAGGTTGGAGTAAGCCAAGTTCGCACCATTGCACTCCAGCCTGGGTGACAAGAGCGAAACTCTTGTCTCAAAAAAAAAAAAAAAAAAAAAAAAAAAA","GGCTGGGCGCAGTGGCTCACACCTGTAATCCCAGCACTTAGGGAAGCTGAGGCGAGTAGATCACCTGAGGTCAGGAGTTAGAGACCAGCCTGGCCATCATGGTGAAACCCCGTCTCTACTAAAGATACCAAAAATTAGCTGAGTGTGGTGCTGGGTGCCTGTAATCCCAGAAACTCAGGGTGCCTGTAATCCCAGCAACTCAGGGTGCCTTTAATCCCAGCAACTGAGGGTACCAGTAATCCCAGCAACTCAGGGTGTCTTTAATCCTAGCAACTGAGGGCACCTGTAATCCCAGCAACTCAGGAAGCTGAGACAGGAGAAGTACTTGAACCCAGAAGGCAGAGGTTGCAGTGAGCCGATATTGCACCATTGCACTCCAGTCTGGGCAACAAGAGTGAAACTCTGTCTCAAAAAAAAA"
"chr17","51598763","51599361","JH378118","18053084","18053501","241","33545679","GCCGGGCGTGGTGACTCACGCCTGTAATACCAGCACTTTAGGAGGCTGAGGTGGGTGGATCACCTGAGGTCAGGAGTTCGAGACCGGCCTGGCCAACATGGTGAAATCCTGTCTCTACTAAAAATACAAAAAAATGGCCAGGCGTGGTGGCTCACGCCTGTAATCCTAGCACTTTGGGCGGCCCAGGTGAGTGGATCACGAGGTCAGGAGATCGAGACCATCCTGGCTAACATGGTGAAACCCCATCTCTACTAAAAAACTACAAAAAAATTAGCTGGGCGTGGTGGCAGGCGCCTGTAGTCCCAGCTACTCGGGAGGCTGAGGCAGGAGAATGACGTGAACCCGGGAGGCGGAGCTTGCAGTGAGCAGAGCTTGAGCCACTGCACTCCAGCTTGGGCGACAGAGTGAGACTCCGTCTCAAAAAAAAAAAAAAAAAAATTAGCTGGGGATGGTGGCGGGCACCTGTAATCCCAGCTACTCTGGAGGCTGAGACAGGAGAATCGCTTGAACCCAGGAGGCGGAGGTTGCAGTGAGCTGAGATCGTGCCATTGTACTCCAGCCTGGGCAACAAGAGTGAAACTCAATCCGAAGAAAAAAAA","GGCTGGGCGCAGTGGCTCACACCTGTAATCCCAGCACTTAGGGAAGCTGAGGCGAGTAGATCACCTGAGGTCAGGAGTTAGAGACCAGCCTGGCCATCATGGTGAAACCCCGTCTCTACTAAAGATACCAAAAATTAGCTGAGTGTGGTGCTGGGTGCCTGTAATCCCAGAAACTCAGGGTGCCTGTAATCCCAGCAACTCAGGGTGCCTTTAATCCCAGCAACTGAGGGTACCAGTAATCCCAGCAACTCAGGGTGTCTTTAATCCTAGCAACTGAGGGCACCTGTAATCCCAGCAACTCAGGAAGCTGAGACAGGAGAAGTACTTGAACCCAGAAGGCAGAGGTTGCAGTGAGCCGATATTGCACCATTGCACTCCAGTCTGGGCAACAAGAGTGAAACTCTGTCTCAAAAAAAAA"
"chr17","51738482","51739094","JH378118","18053084","18053501","257","33685398","GCCGGGTGCGGTGGCTCACACCTGTAATCCCAGCACTTTGGGAGACTGAGGCGGGAGGATCACCTGAGGTCAGGAGTTCGAGACCAACCTGACCAACATGGTAAAACCCTGTCTGTACTAAAACTACAAAAAATTAGGCCAGGCGCAGTGGTCCATGCCTGTAATCCCAGCACTTTGGGAGGCCAAGGTGGGCGGATCATGAGGTCAGGAGTTTGAGACCAGCCTGGCCAACATAGTGAAACCCTGTCTCTACTAAAAACACAAAAATTAGTCGGGCATGGTGGCGGATGCCTGTAATCTCAGCTACTCAGGAGGTTGAGGCAGGAGAATCACTTGAACCCGGGAGGTGGAGGTTGCAGTGAGCCAAGATCACGCCACTGTACTCCAGCCTGGGCAACAGAGCGGGACTCCATCTTAAAAAAAAAAAAAAAAAAATTAGCCAGGCGTGGTGGCGCATGCCTGTAGTCCCAGCTACTTAGGAGGCTGAGGCAGGAGAATTGCTTGAACCCGGGAGGCAGAGGCTGCAGTGAGCCAAGACCACGCTATTGCATTCCAGCCTGGGTGACAAGAGCAAAACTCTGTCTCAAAAAACAAAACAAAACAAACAAAAAAA","GGCTGGGCGCAGTGGCTCACACCTGTAATCCCAGCACTTAGGGAAGCTGAGGCGAGTAGATCACCTGAGGTCAGGAGTTAGAGACCAGCCTGGCCATCATGGTGAAACCCCGTCTCTACTAAAGATACCAAAAATTAGCTGAGTGTGGTGCTGGGTGCCTGTAATCCCAGAAACTCAGGGTGCCTGTAATCCCAGCAACTCAGGGTGCCTTTAATCCCAGCAACTGAGGGTACCAGTAATCCCAGCAACTCAGGGTGTCTTTAATCCTAGCAACTGAGGGCACCTGTAATCCCAGCAACTCAGGAAGCTGAGACAGGAGAAGTACTTGAACCCAGAAGGCAGAGGTTGCAGTGAGCCGATATTGCACCATTGCACTCCAGTCTGGGCAACAAGAGTGAAACTCTGTCTCAAAAAAAAA"
"chr17","52245950","52246538","JH378118","18053084","18053501","254","34192866","TGTAATCCCAGCACTTTGGGAAGCCAACGCGGGTAGATCAGCTGAGGTCAGGAGCTCGAGACCAGCCTGGCCAACTGGTGAAACCCCATCTCTACTAAAAAAAATACAAAAAAATGGCCCAGCGCGGTGGCTCACACCTGTAATCCCAGCACTTTGGGAGGCCGAGGCGGGCAGATCACGAGGTCAGGAGATCGAGACCATCCTGGATAATACGGTGAAACCCCGTCTCTACTAAAAATACAAAAAAAAATTAACCGGGTGTGGTGGCGGGCGCCTGTAGTCCCAGCTACTAGGGAGGCTGAAGCAGGAGAATGGCGCGAAACCGGGAGGCGGAGCTTGCAGTGAGCCAAGACAGGCCACTGCACTCCAGCCTGGGCGACAGAGCGAGACTCCATCTCAAAAAAACAAAAAACAAAAAAATTAGCCAGCTGTGGTGGTGGGCGCATGTAATCCCAGTTACTTGGGAGGCTGAGGCAGGAGAATTGCTTGAAACCAGGAGGCAGAGGTTGCAGTGAGCCAAGATTACGCCATTGTACTCCAGCCTGGGCAACAAGGGCAAAACTCTGTCTCAACAAAAAAAAAGAAAAAA","GGCTGGGCGCAGTGGCTCACACCTGTAATCCCAGCACTTAGGGAAGCTGAGGCGAGTAGATCACCTGAGGTCAGGAGTTAGAGACCAGCCTGGCCATCATGGTGAAACCCCGTCTCTACTAAAGATACCAAAAATTAGCTGAGTGTGGTGCTGGGTGCCTGTAATCCCAGAAACTCAGGGTGCCTGTAATCCCAGCAACTCAGGGTGCCTTTAATCCCAGCAACTGAGGGTACCAGTAATCCCAGCAACTCAGGGTGTCTTTAATCCTAGCAACTGAGGGCACCTGTAATCCCAGCAACTCAGGAAGCTGAGACAGGAGAAGTACTTGAACCCAGAAGGCAGAGGTTGCAGTGAGCCGATATTGCACCATTGCACTCCAGTCTGGGCAACAAGAGTGAAACTCTGTCTCAAAAAAAAA"
"chr17","52264620","52265210","JH378118","18053084","18053501","242","34211536","GGCCACATGTGGTGGCTCACACCTGTAATCCCAGCACTTTGGGAGGCCAAGGCAGGCAGATCACCTGAGATCAGAAGTTCAAGACCAGCCTGGCCAATGTGGTGAAACCCTGTCTCTACTAAAAATAGAAAAAACACAGCCAGGCGCGGTAGCTCACACCTGCAATCCCAGCACTTTGGGAGGCCGAGGCAGGCAGATCACGAGGTCAGGAGATTGAGACCACGGTGAAACCCCATCTCTACTAAAAATACAAAAAATTAGCTGGGCATGGTGGCGGGCACCTGTAGTCCCAGCCACTTGGGAGGCTGAGGCAGGAGAATGGCGTGAACTCGGGAGGTGGAGCTTGCAGTGAGCAAAATTGCGCCACTGCACTCCAGCCTGGGCAACAGAGCAAGACTCCGTCTCAAAAAAAAAAAAAAAAAAAAATTAGCCGGCGTAGTGGCAAGCTCCTGTAATCCCAGCTACTTGGGAGGCTGAAGCAGGAGAATCGCTTGAACCCAGGAGGTGGAGGTTGCAGTGAGCCGAGACTGCGCCATTGCACTCCAGCCTGGGCAACAAGAATGAAACTCCGTCTCAGAAAAGAAAAAAAAA","GGCTGGGCGCAGTGGCTCACACCTGTAATCCCAGCACTTAGGGAAGCTGAGGCGAGTAGATCACCTGAGGTCAGGAGTTAGAGACCAGCCTGGCCATCATGGTGAAACCCCGTCTCTACTAAAGATACCAAAAATTAGCTGAGTGTGGTGCTGGGTGCCTGTAATCCCAGAAACTCAGGGTGCCTGTAATCCCAGCAACTCAGGGTGCCTTTAATCCCAGCAACTGAGGGTACCAGTAATCCCAGCAACTCAGGGTGTCTTTAATCCTAGCAACTGAGGGCACCTGTAATCCCAGCAACTCAGGAAGCTGAGACAGGAGAAGTACTTGAACCCAGAAGGCAGAGGTTGCAGTGAGCCGATATTGCACCATTGCACTCCAGTCTGGGCAACAAGAGTGAAACTCTGTCTCAAAAAAAAA"
"chr17","52281488","52282107","JH378118","18053084","18053501","287","34228404","GGCCAGGCGCGGTGGCTCACGCCTGTAATCCCAGCACTTTGGGAGGTCAAGGCGGGTGGATCACCTGAGGTCAGGAGTTCAAGACCAGCCTGGCCAACATGATGAAACTTCATCTTGGCCGGGCGCGGTGGCTCATGCTTGTAATCCCAGCACTTTGGGAGGCCAAGGCAGGCGGCGGATCATGAGGTCAGGAGATTGAGACCATCCTGGCTAAAACGGTGAAACCCCGTCTCTACTAAAAATACAAAAAAAAAAAAATTAGCCGGGCGTGGTGGCAGGCGCCTGTAGTCCCAGCTACTCGGGAGGCTGAGGCAGGAGAATGGCGTGAACCCGGGAGGCGGAGCTTGCAGTGAGCCGAGATAGCACCACTGCAGTCCGGCCTGGGTGAAAGAGTGAGACTCCGTCTCAAAAAAAAAAAAAAAGAAGAAAGAACTTCGTCTTTACTAAAAGTACAAAAAAAAAAAAAAAAAATTAGCCGGGCATGGTGGCAGGCGCCTGTAAACCCAACTACTCTGGAGGCTGAGGAAGGAGAACTGCTTGCACCTGGGAGTCGGAGGTTGCAGTAAGCCAAGATCGCACCATTGCACTCCAGCCTGGGCATCAAGAGTGAGACTTTGTCT","GGCTGGGCGCAGTGGCTCACACCTGTAATCCCAGCACTTAGGGAAGCTGAGGCGAGTAGATCACCTGAGGTCAGGAGTTAGAGACCAGCCTGGCCATCATGGTGAAACCCCGTCTCTACTAAAGATACCAAAAATTAGCTGAGTGTGGTGCTGGGTGCCTGTAATCCCAGAAACTCAGGGTGCCTGTAATCCCAGCAACTCAGGGTGCCTTTAATCCCAGCAACTGAGGGTACCAGTAATCCCAGCAACTCAGGGTGTCTTTAATCCTAGCAACTGAGGGCACCTGTAATCCCAGCAACTCAGGAAGCTGAGACAGGAGAAGTACTTGAACCCAGAAGGCAGAGGTTGCAGTGAGCCGATATTGCACCATTGCACTCCAGTCTGGGCAACAAGAGTGAAACTCTGTCTCAAAAAAAAA"
"chr17","52731467","52732093","JH378129","11955248","11955630","276","40776219","GGCCGGGTGCGGTGGCTCACGCCTGTAATCCTGGCACTTTGGGAGGCTGAGATGGACGGATCACCTGAGGTCAGGAGTTTTTTGTTTTTTTCTTTTTTTTTGAGACAGAGTCTGGCTCTGTTGCCCAGGCTGGAGTGCAGTGGCTCGATCTCGGCTCACTGCAAGCTCCGCCTCCCGGGTTCATGCCATTCTCCTGCCTCAGCCTCCCGGTAGCTGGGACTACAGGTGCCCGCCAGCACATCCGGTTATTTTTTTGTATTTTTAGTAGAGACAGTGTTTCACAGTGTTAGCCAGGATGGTCTCGATCTCCTGACCTCGTGATCCGCCCACCTCGGCCTCCCAAAAGTGCTGGGATTACAGGCATGAGCCACCGCGCCCGGCCAGGAGTTTTTGAGACCAGCCTGGCCAACAGGGTGAAACTCTGTCTCTACTAAAAATACAAAAATTAGTTGGGCATGGTGGCAGGCACCTGTAATCCCAGCTACATGGGAGGCTGAGGCAGGAGAATTGCTTGAACCTGGGAGGCGGAGGTTGCAGTGAGCTGAGATTGCGCCATTGCACTCCAGCCTGGGCAACAAGAGTGAAATTGCGTCTCAAAAACCAAAACAAACAAAAAAAGAATGAAAA","GGCTGGGTACGGTGGCTCATGCCTGTAATCCCAGCACTTTGGGAGGTGGGTCACTTGAGGTCAGGAGTTCGAGACCAGCCTGTGCAGTGCCTCCATCCTCAACTGCTGCCTCATCAGCCTGGACCACTACCTGCTCATCCTCTCACCACTGCCACAAGCTGCGCATGAAGCTCCTGCGCGCGCCGGTGCCCGTCTCTACTAAAAATACAAAAATTAGCTGGGTGTGGTGGCAGGTGCCTGTAATCCCAGCTACTCAGGAGGCTGAGGCAGGAGAATCACTTGAACCCAGGAGGCAGAGGTTGCAGTGAGCCGATATCGCATCATTGCACTCCAGCCTGAGCAACAAGAGTGAAATTTTGTCTCAAAAAAAAAAAAAAAAGAAA"
"chr17","54416242","54416805","JH378115","26183910","26184297","228","28232332","ACTTTGGGAGGCCATGGCAGGCGGATCACCTGAGATCAGGAGTTGGAAACCAGCCTGGCCAACATGGTAAAACCCCGTCTCTACTAAAAATACTTGGCTGGGCACGGTGGCTCACACTTGTAATTCCAACACTTTGGAAGGCCAAGGCGGGCAGATCACCTGAGGTTGGGAGTTCGAGACCAGCCTGACCAACATGGAGAAACCCTGTCTCTACTAAAAATACAAAATTAGCTGGGCATGGTGGTCTATGCCTGTAATCCCAGCTACTTGGGAGGCTGAGGCAGGAGAATTGCTTGAACCCGGGAGGCAGAGGTTGCGGTAAGCCAAGATCATGCCATTGCACTCCAGCCTGGGCAACAAGAGCAAAACCCCGTCTCAAAAAAAAAAAAAAAATTAGCCCAGTGTGGTGGCGTGCACCTGTAATCCCAGCTACTTACTTAGGAGCCTGAGGCAGGAGAATTGCTTGAACCCGGGAGGCAGAGTTTGCAGTGAGCCAAGATTGCACCATTGCACTCCAGCCTGGGTGACAAGAGTGAGACTGTCTCAAAAAAAAAAAAAAAAAAA","GGCCAGGTGCAGTGGCTCATATGTATAACCCCAACACTTTGGGAGGCCAACGCAGGTGGATCACCTGAGTTAGGAGTTTGAGACCAGCCTGACCAACATGGTGAAACCCTGTCTCTACTAAAAATACAGAAATGGCCGGGCATAGTGACACATACCTGTAATCCCAGATACTTGGGATGCTGAGTTTGCTTAAACCCAGAGGAGAACTGCTTAAACCCGGGAGGTAGAGGTCACAGTGAGCCAAGATTGGGATGCTGAGATTTGCTTAAACCCAGAGGAGAACTGCTTAAACCCAGGAGGCAGAGGTTGCAGTGAGTTGAGATTGCACCATTGCACTCCAGCCTGGACAACAAGAGTGAAACTCTGTCTCAAAAAAAAAAAAAAAAAA"
"chr17","55179146","55179483","JH378144","13229286","13229620","44","41949860","GGCCGGGTGCGGTGGCTCACGCCTGTAATCCCAGCACTTTGGGAGGCCGACGCAGGTGGATCACTTGAGGTCTGGTGTTCAAGACCAGCCTGGCCAACATTGTGAAACCCCGTCTCTACTAAAAATACAAAAAGTTAGCTGGGCATGGTAGCAGGTGCCTGTAATCCCAGCTACTTGGGAGGCTGAGGCAGGAGAATTGCTTGAACCTGGGAGGCAGAGGTTGCAGTGAGCTGAGATCGCACCATTGCACTCCAGCCCAGGCAACAAGAGCGAAACTTCGTCTCAAATAATAATAATAATAATAATAATAAATAAATAAATTTTTAAAAAAGAAAAAA","GGCCGGGCGCGGTGGCTCAAGCCTGTAATCCCAGCACTTTGGGAGGCCGAGGCGGGTGGATCACCTGTGGTCAGGAGTTCAAGACAGCTTGGTCAACATGGTGAAACCCCGTCTCTACCAAAAATACAAAAAATTAGCTGGGCATGGTAGCGCATGCCTGTAATCCCAGCTACTCAGGAGGCTGAGGCAGGAGAATTGCCTGAACCCAGGAGGCAGAGGTTGCGGTGAGCCGAGATCGCGCCATTGCACTCCAGCCTGGGTAACAAGAGCGAAACTCCCTCTCATAAAAAATAAATAAATAAATAAATAAATAAATAAATAAATAAATAAATAAA"
"chr17","59543657","59543981","JH378109","3329188","3329514","46","56214469","GGTTGGGCACAGTGGCTCACGCCTGTAATCCCAACACTTTGGGAGGCCAAGGCGGGTGGATCACCTGAGGTCGGGAGTTCAAGACCAGCCTGGCCAACATGCTGAAACCCTATCTCTACTAAAAATACAAAAAAAAAAAAAAAAAAAAAAAAAAAAAATAGCCCAGTGTGGTGTCAGGCGCCTATAATCTCAGCTACTTGGGTGGCTGAGGCAGGAGAGTCGCTTGAACCTGGGAGGCGGAGGTTGCAGTGAGCGGAGATCGCACCATTGCACTCCAGCGTGGGCAACAAGAGTGAAACTCCATCTCAAAAAAAAAGAAAAGAAA","GGCCAGGCATGGTGGCTCACGCCTGTAATCCCAGCACTTTGGGAGCCCAAGCCGGGTGGATTACCTAAGGTCAGGAATTCCAGAACAGCCTGGACAATATGGTGAAACCTTGTCTCTACTAAAAATACAAAAAAAAAAAAAAAAAAAAAAAAAAAAAAAATTTAGCCGGGTGTGGTGGTAGGTACCTGTAATCCCAGCTACTAGGGAGGCTGAGGCAGGAGAATCGCTTGAACTTGGGAGGCGGAGGTTGCAGTGAACAGAGATCACACCACTGCACTCCAGCCTGGGCGACAAGAGCAAAACTCCATCTCAAAGAAAAAAAAAGAA"
"chr17","60766805","60768705","JH378118","18053084","18053501","1483","42713721","GGCCAGGTACCGTGGCTCATGCCTCTTATCCCACCACTTTTGGAAGCTGAGGTGTGAGGATCACCCGAAGTCAGGAGTTTGGAACCATCCTGGCCAATGTTGTAAAACCCCGTCTCTAATAAAAATACAAAAGTTACCCAAGCATGGTGGTGGGCACACCTGTAATCCCAGCTACTTGGAAGGCTAAGACAGGAAAATGCCTGAACCCAGTGTGGCTGGAATTGGTGGGTTCTTGATCTCACTGACCTCAAGAATGAAGCCACGGACCCTCACGGTGAGTGTCACACTTCAAGGTGGCACGTCCAGTTTGTTCCTTCTGATGTTCGGATGTGCTCAGAGTTTCTTTCTTCTGGTGGGTTCATGGTCTCGCTGGCTCAGGAGTGAAGCTACAGACGTTCACCGGGAGTGTTACAGCTCTTAAGGCCTTGCGCCTGGAGTTGTTAGTTCCTCCCAGTGGCTTCGTGGTCTCACTGGCTTCAGGAATCAAGCAGCACGGTGAGCGTTACAGCTCACAAAGGCAGTGTGCACCCACAGTGAGCAACAGCAAAATCTATTGCAAAGAGGACAGAACAAAACCCCCACACTGGGGAAAAGGACCGGAACAGCTTGCCACTGCTGGCTCAGGCAGCCTGCTTTTATTCTCTTATCTGGCCCCACCCACATCCTCCTGATTGGTCCATTTTACAGAGAGCTGATTAGTTTGCTTTACAGTGAACTGATTGGTCCATTTTGACAGATTGGTGCTGATTGGTGCGTTTACAATCCCTGAGCTAGACACAAAAGTTTTCCACGTCCCCATTAGAATAGCTAGATACAGAGTGTCCATAGGTGTATTTACAAACCCTGAGCTAGACACGGAGTGATGATTGGTGCATTTACAAACATGGAGCTAGATACAGAGTGCCGATTGGTGCATTCACAATCCCTTAGCTAGACATAAAGGTTCTCAAGTTCCCACCAGATCAGCTAGACATAGAGCGCTGATTGGTGCATTTACAAAACTTGAGCTCGACACAGGGTGCTGATTGGTGCATTCACAAACCTTGAGCTAGACACAGGGTGCTGATTGGTGTGTTTACAAACCTTGAGCTAGATGCAGAGCGCTGATTGGTGTATTTACAATTCCTTAGCTAGACATAAAGGTTCTCCAAGTCCCCACTAGACTCAGGAGCCCAGCTGGCCTCACCCAGTGGATGTCACACTGGGGCCATAGGTGGAGCTGCCTGCCAGTTCCGTGTCCTGCGCCCACACTCCTCAGCCCTTGGGCGGTGGATGGGATTGGGCACCGTGCAGCAGGGGGTCGCGCTCCTGGGGGAGGCTCGGGCGGTGCAGGAGCCCACGGTGGCGGGGCGGGGCAGACTCAGGCATGGCGGGCTCCGGGTCCCAAGCCCTGCCGGGTGGGGAGGCACCTAAGGCCAGGCGAGAAATGGAGCGCAGCGCTGGTGGGCCAGCACTGCTGGGGGACCAGGCGCATCCTCCGCAGCTGTTGGCCTGGGTGCTAAGCCCCTCACTGCCCAGGGCTGGCAGGGCCCGCCGGCCGCTCCGAGTGCCGGGCCCGCCAAGCCCACGCCCACTTGGAACTCTAGCTGGCCCGCAAGCGCGGCGCGCAGCCCTGGTTCCCCCCCGTGCCTCTCCCTCCACACCTCCCCGCGGGCTGAGGGAGCCGGCTCCGGCCTCGGCCATCCCAGGAAGGGGCTCCCACACTGCAGCGGCGTGCTGAAGGGCTCCTCAAGCACGGCCAGAGTGGGCGAGGAGGCTGAGGAGGCGCCAAGAGTGAGCCAGGGCTGCCAGCATGCTGTCACCTCTCACCAGGAGGCGGAGATTGCAGTGAACCAAGACTGTGCCATTGCACTCCAGCCTGGGCAACAAGAGTGAAACTCCATCTCAAAAAAAATAATAAA","GGCTGGGCGCAGTGGCTCACACCTGTAATCCCAGCACTTAGGGAAGCTGAGGCGAGTAGATCACCTGAGGTCAGGAGTTAGAGACCAGCCTGGCCATCATGGTGAAACCCCGTCTCTACTAAAGATACCAAAAATTAGCTGAGTGTGGTGCTGGGTGCCTGTAATCCCAGAAACTCAGGGTGCCTGTAATCCCAGCAACTCAGGGTGCCTTTAATCCCAGCAACTGAGGGTACCAGTAATCCCAGCAACTCAGGGTGTCTTTAATCCTAGCAACTGAGGGCACCTGTAATCCCAGCAACTCAGGAAGCTGAGACAGGAGAAGTACTTGAACCCAGAAGGCAGAGGTTGCAGTGAGCCGATATTGCACCATTGCACTCCAGTCTGGGCAACAAGAGTGAAACTCTGTCTCAAAAAAAAA"
"chr17","64473614","64473953","JH378109","21565230","21565567","55","42908384","GGCCGGGTGTGGTGGCTCATGCCTGTAATCCCAGTACTTTGGGAGGCCGAGGCAGGCAGATCTCCTGAGGTCAGGAGTTTGAGACCAGCCTGGCCAACATGATGAAATGCTGTCTCTCCTAAAAATACAAAAATTAGCCAGACATAGTGGCAGGTGCCTGTAATCCCAGCTACTTGGGAGGCTGAGGGAGGAGAATTGCTTGAACCTGGGAGGCAGAGGTTGCAGTGAGTCAAGATCACGCCATTGCGCTCCAACCTGGGTGACAAAAGTGAGACTTCATCTCAAAATAAATAAATAAATAAATAAATAAATAAATAAATAAATAATAATTAAAAAAAAA","GGCCGGGCGCGGTGGCTCAAGCCTGTAATACCAGCACTTTGGGAGGCCGAGGCGGGTGGATCACGAGGTCAAGAGATCGAGACCATCCTGGTCAACATGGTGAAACCCCGTCTCTACTAAAAATACAAACAATTAGCTGGGCATGGTGGCGGGTGCCTGTAATCCCAGCTACTCCAGAGGCTGAGGCAGGAGAATTGCCTGAACCCAGGAGACGGAGGTTGCGGTGAGCCAAGATCGCGCCATTGCACTCCAGCCTGGGTGACAAGAGCGAAACTCCGTCTCAATAAATAAATAAATAAATAAATAAATAAAAATAAAATAAATAAATAAATAAATAA"
"chr17","67747489","67748097","JH378118","18053084","18053501","256","49694405","GCTGGGTGTGGTGGCTCACGCCTATAATCCCAGCACTTTGGGAGGCCAAGGCAGGTGGATCACCTGAGGTCAGGAGTTTGAGACCAGCCTGGCCAACATGATGAAACCCCGTCTCTACTAAAAATACAAAGAATTAGGCTGGGCGCGGTGGCTCACGCCTGTAATCCCAGCACTTTGGGAGGCCGAGGCGGGTGGATCACGAGGTCAGGAGATCGAGACCATCCTGGCTAACACGGTGAAACCCCGTCTCTAATAAAAATAAAAAAAAATTAGCTGGGCGTGGTGGTTGGCGCCTGTAGTCCCAGCTACTCGGGAGGCTGAGGCAGGGGAATGGCGTGAACCCGGGAGGTGGAGCTTGTAGTGAGCCGAGATCACGCCACTGCACTCCAGCCTGGGCGACAGAGCAAGACTCCGTCTCAAAAAAAAAAAAAAAAAAAATTAGCCAGGCGTGGTGGCGGGTGCCTGTAATCCCAGCTACTCTGGAGGCTGAGGCAGGAAAATCACTTTAACTCAGGAAACAGAGGTTGCAGTAAGCCGAGATCACGCCATTGTGCTCCATCCTGGGCAACAAGAGCGAAACTCCGACTCGGAAAAAAAGAAAAAAAAAAA","GGCTGGGCGCAGTGGCTCACACCTGTAATCCCAGCACTTAGGGAAGCTGAGGCGAGTAGATCACCTGAGGTCAGGAGTTAGAGACCAGCCTGGCCATCATGGTGAAACCCCGTCTCTACTAAAGATACCAAAAATTAGCTGAGTGTGGTGCTGGGTGCCTGTAATCCCAGAAACTCAGGGTGCCTGTAATCCCAGCAACTCAGGGTGCCTTTAATCCCAGCAACTGAGGGTACCAGTAATCCCAGCAACTCAGGGTGTCTTTAATCCTAGCAACTGAGGGCACCTGTAATCCCAGCAACTCAGGAAGCTGAGACAGGAGAAGTACTTGAACCCAGAAGGCAGAGGTTGCAGTGAGCCGATATTGCACCATTGCACTCCAGTCTGGGCAACAAGAGTGAAACTCTGTCTCAAAAAAAAA"
"chr17","71197353","71197681","JH378262","266823","267148","47","70930530","GACCGGACACAGTGGCTCACGTCTGTAATCCCAGCACTTTGGGAGGCTGAGGCGGGTGGATCACCTGAGGTCAGGAGTTCAAAACCAGCCTGGCCAATATGGTGAAAACCCGTCTATACTAAAAATAAAAAATTAGCCAGGCTTGGTGGCAGGCACCTGTAATCCTAGGTACTCTGGAGGCTTAGACAGGAGAATCACTTGAACCCGAGAAGTGGAGGTTGCAGTGAGCCAAGATCGTGCCATTGCACTCCAGCCTGGGCGACAAGAGTGAGACTCCATCTCAAAAACAAACAAACAAACAAACAAAAAACAAATGAACAAAAAAAAAA","GGCCGGGCGCGGTGGCTCAAGCCTGTAATCCCAGCACTTTGGGAGGCCGAGGCGGGTAGATCATGAGGTCAGGAGTTTGAGACCAGCCTGGCCAACATGGTGAAACCCCGTCTCTACTAAAAATACAAAAATTAGCCGGGCATGGTGGCCTGTGCCTGTAATCCTAGCTACCCAGGAAGCTGAGGCAGGAGAATTGCCTGAACCCAGGAGGCGGAGGTTGCGGTGAGCCGAGATCGTGCCATTGCACTCCAGCCTGGGTAACAAGAGCGAAACTCCGTCTCAAAAACAAACAAACAAACAAACAAAAACAAAAAACAAAAAACAAA"
"chr17","72892082","72892699","JH378118","18053084","18053501","266","54838998","GGCCAGGTGCAGTGGTTCACACCTATAATCCCAGCACTCTAGGAGGCCAAAGTGGGCAGATCACCTGAGGTCAGAAGTTCGAGACCAGCCTGGCCAACATGGTGAAACCATCTCTACTAAAAACACAAAAATTAGGCTGGGCACGGTGGCTCACACCTGTAATCCCAGCACTTTGGGAGGCCGAGGTGGGTGGATCACGAAGTCAGGAGATCAAGACCATCCTGGCTAACACGGTGAAACCCCGTCTCTACTAAAAATACAAAAAATTAGCCAGGCGTGGTGGCGGGCGCCTATAGTCCCAGCTACTTGGGAGGCTGAGGCAGGAGAATGGCGTGAACCCAGGAGGCGGAGCTTGCAGTGAGCCAAGATTGCGCCACTGCACTCCAGCCTGGGTGAGAGAGCTAGACTCTGTCTCAAAAAAAAAAAAAAAAAAAACACAAAAATTAGCCGGGCTTGGTGGCAGGTGCCCGTAATCCCAGCTACTCAGGACGCTGGGACAGGAGAATCTCATGAACCCTGGAGGTGGAGGTTGTAGTGAGCCAAGATCTCACCATCGCACTCCAGCCAGGGTGACAAGAGTGAAACTCTGTCTTAAAAAGATAAATAAATAAAATAAAA","GGCTGGGCGCAGTGGCTCACACCTGTAATCCCAGCACTTAGGGAAGCTGAGGCGAGTAGATCACCTGAGGTCAGGAGTTAGAGACCAGCCTGGCCATCATGGTGAAACCCCGTCTCTACTAAAGATACCAAAAATTAGCTGAGTGTGGTGCTGGGTGCCTGTAATCCCAGAAACTCAGGGTGCCTGTAATCCCAGCAACTCAGGGTGCCTTTAATCCCAGCAACTGAGGGTACCAGTAATCCCAGCAACTCAGGGTGTCTTTAATCCTAGCAACTGAGGGCACCTGTAATCCCAGCAACTCAGGAAGCTGAGACAGGAGAAGTACTTGAACCCAGAAGGCAGAGGTTGCAGTGAGCCGATATTGCACCATTGCACTCCAGTCTGGGCAACAAGAGTGAAACTCTGTCTCAAAAAAAAA"
"chr17","74365360","74365846","JH378118","18053084","18053501","163","56312276","TATAAAAAATCAGCTAGGCTTGGTGGCTTGTGCCTGTAATCCCAGCACTTTGGGAGGCTGAGGCAGGTGGATCACCTGACGTAGGTGTTTAAGACCAGATTGACTAACATGTTGAAACCCCGTCTCTACTAAAAATACAAAAATTATCTGGGCTTGGTGGTGCATGCCTGTAATCCCAGCTGCTCAGGAGGCTGAGACAGGAGAATCGCCTGAACCTGGGAAACGGAAGTTGCAGTGAGTGGAGGTTGCAGTGAGCCGAGATTGCACCACTGCACTCCAGTCTGGGCAACGGAAAAAGACTGTCTCAAAAAAAAAAAAAAAATTAGCTGGGTGTGGTGGTTGGCGCCTGTAATTCCAGCTACTCAGGAGGCTGAGGCAGGAGAATCACTTGAACTCAAGAGGCAGAGGTTGCAATGAGCCAAGATTGCGCCATTGTACTCCAGCCTGGGCCACAAGATTGAAACTTCATCTTGGGGAAAGAAAACAA","GGCTGGGCGCAGTGGCTCACACCTGTAATCCCAGCACTTAGGGAAGCTGAGGCGAGTAGATCACCTGAGGTCAGGAGTTAGAGACCAGCCTGGCCATCATGGTGAAACCCCGTCTCTACTAAAGATACCAAAAATTAGCTGAGTGTGGTGCTGGGTGCCTGTAATCCCAGAAACTCAGGGTGCCTGTAATCCCAGCAACTCAGGGTGCCTTTAATCCCAGCAACTGAGGGTACCAGTAATCCCAGCAACTCAGGGTGTCTTTAATCCTAGCAACTGAGGGCACCTGTAATCCCAGCAACTCAGGAAGCTGAGACAGGAGAAGTACTTGAACCCAGAAGGCAGAGGTTGCAGTGAGCCGATATTGCACCATTGCACTCCAGTCTGGGCAACAAGAGTGAAACTCTGTCTCAAAAAAAAA"
"chr17","74566963","74567566","JH378119","32351107","32351490","260","42215856","GCCGGGCATGGTGTATCACGCCTGTAATCCCAGCACTTTGGGAGGCAGAGGTAGGCAGATCACCTGAGGTCAGGAGTTCAAAACCAGCCTAGCCAACATGGTGAAACCCCGTCTCTACTAAAAATACAAAAAATTAGTGGCCAGGCACGGCAGCTCACGCCTGTAATTCCAGCACTTTGGGAGGCCGAGGCGGGCAGATCACGAGGTCAGAAGATTGAGACCATCCTGGCTAACACGGTGGAACCCCATCTCTACTAAAAATACAAAAAATTAGCTGGGCATGGTGGCTGGTGCCTGTAGTCCCAGCTACTCGGGAGGCTGAGGCAGGAGACTGGCATGAACCCGGGAGGCGGAGCTTGCAGCAAGCCAAGATCGTGCCACTGCACTCCACTCCATCCTGGGCGACAGAGCAAGACTCCGCTTCAAAAAAAAAAAAATTAACCGGGCAAGGTGGCAGGTGCCTGTAATCCCAGCTACTTGGGAGGCTGAGGCAGGAGAATTGCTTGCAGAGGTTGAAGTGAGCCGAGATTACGCCATTGCACTCCAGCCCAAGTGACAAGAGTGAAACTCCATCTCAAAAAAAAAAAAAAAAAAAAGAAAAAAA","GGCCAGGTATGGTGGCTCACACCTGTAATCCCAGCACTTTGGGAGGCCAAGGCAGGCAGACCACCTGAGGTCAGGAGTTCGAGATCAGCCTAGCCAACATGGTGAAACCCCATCTCTAGTAAAAATAAAATTAGCCAGGCATGGTGGTGCATGCCTGTAACGCAGGTCAGGAGTTCGAGATCAGCTTAGCCAACATGGTGAAACCCCATCTCTAGTAAAAATAAAATTAGCCAGGCAGGTGGTGCCGCCTGTACTCGGGAGGCTGAGGCAGGAGAATCACTTGAACCCAAGAGGCAGAGGTTGCAGTCAGCCAAGATCATGCCATTGCACTCCAGCCTAAGCAAAAAGAGTAAAACTCAGTCTCAAAACAAAAAAACAAAAAAA"
"chr17","75365782","75366409","JH378153","2355361","2355755","282","73010421","CCAGGCGTGGTGGCTCATGCCGGTAATCCCAGCACTTTGGGAGGCCAAGGCAGGTGGATCATCTGAGGTCAGGAGTTCGAGACCAGCCTGACCAACATGGTGAAACCTCACCTCTACTAAAAATACAAAAACTAGACAGGCGTGGTGGCGGGTGCCTGTAGTCCCAGCTACTTGGGAGGCTGAGGCAGAAAAATCGCTTGAACCCAGTAGGCAGAGGTTGCAGTGAGCCGAGATCACACCATTGCACTCCAGCCTGGGCAAAAAAGAGCGAAACTCCATCTCAGAAGAAAAGACCGGGTGCAGTGGCTCATGCTTGTAACCCCAGCACTTTGGGAGGCCAAGGCGGGTGGATCACGAGGTCAGAAGATCGAGACCATCCTGGCTAACACGGTGAAACCCCGTCTCTACTAAAAATACAAAAAAAAAAAAATAATTAGCCGAGTGTGGTGGCGGATGCCTGTAGTCCCAGCTACTCGGGAGGCTGAGGCAGGAGAATGGCGTGAACCCAGGAGGCGTAGCTTGCAGTGAGCCGAGATCACGCCACTGCACTCCAGCCTGGGCGACAGAGCAAGACTCGTCTTAAAAAAAAAAAAAAAAAGAAAAAGTAAAAGAAAAGAAAAAGCAACAA","GGCGGGGCATGGTGGCTCACACCTGTCATCCCAACACTTTGGGAGGCTGAGGCAGGCAGATCACCTGAGGTCAGGAGTTTGAGACCAGCCTGGCCAACATGGTGAAACCCCATCTCTACTAAAAATACAAAAATACAAAAAACCCCATCTCTACTAAAAATACAAAAAGCTTGTCTCTATTAAAAATACAAAAAACAAAAAACAAACAAAAAAAAAACCACCATGGTGGTGGGTGCCTATAATCCCAGCTACTCGGGAGGCTGAGGCAGGAGAATCGCTTGAACCCAGGAGGCAGAGGTTGCAGTGAGCCAAGATCCCACCATTGCACTCCAGCCTGGGCAACAGAGAGAGAGACTCTGCCTCAGAAAAAAGAAAGAAAGAAAGAAAGAAAGAAA"
"chr18","19875","20142","JH378153","8929988","8930242","54","8910113","TTGGGAGGCTGAGGTGGGTGGATCATCTGAGGTCAGGAGTTAAGACCAGCCTGGCCAACATGGTGAAACCCCATCTCTACTAAAAATACAAAAACAAAACAAAACAAAACAAAAAAAACCAGCATGGTGGCAGACACCTGTAATCCCAGCTACTCGGGAGACTGAGGCAGGAGAATCACTTGAACCTGGGAGGCGGAGGTTACAGTGAGCCAAGATCTTGTCATGTCACTCCAGCCCAGGCAACAAGAGCAAAACTGTCTTAAAAAAA","TTTGAGAGGCTGAGGTGGGTGGATCACCTAGGTCAGGAGTTTGAGACCAGCCTGACCAACATGGTGAAACCTCATCTCTACTAAAAATAAAAATAAAAAACTAGCCAGGTGCAATGGTGCATGCCTGTAATCCCAGCTACTTGGGAGGCTGAGATGGGAGACTCACTTGAACCTGGGAGGTGGAGGTTGCAGTGAGCCAAGATCATACCATTGCACTCCAGCCTGGGCAACAAGAGTGAAACCTCTTCTCAAAAA"
"chr18","4520498","4521101","JH378118","18053084","18053501","246","13532586","GGCTGGGCGCAGTGGCCCACCCCTGTAATCCCAGCACTTTGGGAGGCCGAGGCGGGTAGATCACCTGACGTCAGGAGTTCAAGACCAGCCTGGCCAACATGGTGAAACCCTGTCTCTACTAAAATACAAAAATTAGGCTGGGCGCAGTGGCTCAAGCCTGTAATCCAGCACTTTGGGAGGCCAAGGCGGGCAGATCACCTGAGGTCAGGAGTTCGAGACTAGCCTGGCCAACCTGGCAAAACCCCATCTCTACTAAAAGTACGAAAATTAGCCAGGGTGATGGTGTGCACCTGTAATCCTAGGTACTCAGGAGGCTGAGGGCAAGAGAATCGCTTGAACCTGGGAGGCAGAGGTTGTAGTGGGCCAAGATCGCGCCATTGCACTGCAGCCTCGGTGACAGAGAAAGACTCCGTCTCAAAAAAAAAAAAAAACAAAAATTAGCTGGGCGTGGTGGTGGGCGTCTGTAGTCCCATCTACACGGGAGGCTGAGGCAGAAGAATCACTTAAACCCAGGATGTGGAGGTTGCAGTGAGCTGAGATCACGCCATTGCACTCCAGACTGGGTAACAAGAGCAAAACTCCATCTCAAATAAATAAAATAAAA","GGCTGGGCGCAGTGGCTCACACCTGTAATCCCAGCACTTAGGGAAGCTGAGGCGAGTAGATCACCTGAGGTCAGGAGTTAGAGACCAGCCTGGCCATCATGGTGAAACCCCGTCTCTACTAAAGATACCAAAAATTAGCTGAGTGTGGTGCTGGGTGCCTGTAATCCCAGAAACTCAGGGTGCCTGTAATCCCAGCAACTCAGGGTGCCTTTAATCCCAGCAACTGAGGGTACCAGTAATCCCAGCAACTCAGGGTGTCTTTAATCCTAGCAACTGAGGGCACCTGTAATCCCAGCAACTCAGGAAGCTGAGACAGGAGAAGTACTTGAACCCAGAAGGCAGAGGTTGCAGTGAGCCGATATTGCACCATTGCACTCCAGTCTGGGCAACAAGAGTGAAACTCTGTCTCAAAAAAAAA"
"chr18","8281535","8282152","JH378118","18053084","18053501","271","9771549","GGCCAGGTGCGATAGCTCACACTGGTAATCCCAACACTTTGGGAGGCCGAGGTGGGCGGATCACCTGAGGCCAGGAGTTTGAGACCAGCCTGGCCAACACAGTGAAACCCCATCTCTACTAAAAATACAAAATTAGGCAGGGTGCAGTGGCTCACGCCTGTAATACCAGCACTTTGGGAGGCCGAGACAGGCGGATTACGAGGTCAGGAGATCGAGACCATCCTAGCTAACACAGTGAAACCCCGTCTCTACTAAAAAAAAAAAAAAAAAAAAAAGTACAAAAAAATTAGCCAGGCGTGGCGGCAGGTGCCTGTAGTCCCAGCTACTCAGGAGACTGAGGCAGGAGAATGGCGTGAACCCGGGAGGCGGAGCTTGCAGTGAACTGAGATCACACCACTGCACTCCAGCCTGGGCAACAGAGTGAGACTCCGTCTCAAAAACAAAACAAAATTAGCCGGGCATGGTGGTGGATGCCCGTAATCCCAGCTACTCGGGAGGCTGAGGCCGCCAAGGCAGGAGAATCTCTTGAATGTGGGAGGCAAAGGCTGCAGTGAGCTGAGATCATGCCATTGCACTGTAGCCTGGGCGACAAAAGTGAGACTCCGTCTCAAAAAAAAA","GGCTGGGCGCAGTGGCTCACACCTGTAATCCCAGCACTTAGGGAAGCTGAGGCGAGTAGATCACCTGAGGTCAGGAGTTAGAGACCAGCCTGGCCATCATGGTGAAACCCCGTCTCTACTAAAGATACCAAAAATTAGCTGAGTGTGGTGCTGGGTGCCTGTAATCCCAGAAACTCAGGGTGCCTGTAATCCCAGCAACTCAGGGTGCCTTTAATCCCAGCAACTGAGGGTACCAGTAATCCCAGCAACTCAGGGTGTCTTTAATCCTAGCAACTGAGGGCACCTGTAATCCCAGCAACTCAGGAAGCTGAGACAGGAGAAGTACTTGAACCCAGAAGGCAGAGGTTGCAGTGAGCCGATATTGCACCATTGCACTCCAGTCTGGGCAACAAGAGTGAAACTCTGTCTCAAAAAAAAA"
"chr18","14964693","14965321","JH378118","18053084","18053501","273","3088391","GGCTGGGTGCGGTGGCTCACACCTGTAATCCCAGCACTTTGGGAGGCTGAGGCAGGCGGATCACCTGAGGTCAGGAGTTCAGGACCAGCCTGATCAACATAGCGAAACCCTGTCTCTATTAAAAATATAAAAATTGCTGGGTGCGGTGGCTCACGCCTGTAATCCCAGCACTTTGGGAAGCCGAGGCGGGCGGATCATGAGCTCAGGAGATCGAGACCATCTTGGCTAACATGGTGAAACCCTGTCTCTACTAAAAATACAAAAAAATTAGCCAGGTGTGGTGGCGGGCGCCTGTAGTCCCAGCTACTCTGGAGGCTGAGGCAGGAGAATCACTTGAACCTGGGAGGCGGAGGTTGCGGTGAGCCAAGATGGTGCCATTGCACTCCAGCCTGGGCAACAAGAGTGAAACTCCATCTCAAAAAAAAAGAAAAAAAAAAAAAAAAACAACCCACAAAAATTAGCCAGGTGTGATGGCGGGTGTCTGTAATCCCAGCTACTTGGGAGACTGAGGCAGGAGAATGGCTTGAACCCGGGAGGTGGAGGTTGCAGTAAGCCGAGATTGCGCCACTGCACTCCAGCCTGGGTGACCAGAGTGAAACTTCATCTCAAAAAAAAAAAAAAAAAAAAAA","GGCTGGGCGCAGTGGCTCACACCTGTAATCCCAGCACTTAGGGAAGCTGAGGCGAGTAGATCACCTGAGGTCAGGAGTTAGAGACCAGCCTGGCCATCATGGTGAAACCCCGTCTCTACTAAAGATACCAAAAATTAGCTGAGTGTGGTGCTGGGTGCCTGTAATCCCAGAAACTCAGGGTGCCTGTAATCCCAGCAACTCAGGGTGCCTTTAATCCCAGCAACTGAGGGTACCAGTAATCCCAGCAACTCAGGGTGTCTTTAATCCTAGCAACTGAGGGCACCTGTAATCCCAGCAACTCAGGAAGCTGAGACAGGAGAAGTACTTGAACCCAGAAGGCAGAGGTTGCAGTGAGCCGATATTGCACCATTGCACTCCAGTCTGGGCAACAAGAGTGAAACTCTGTCTCAAAAAAAAA"
"chr18","15291276","15291680","JH378105","31074364","31074738","116","15783088","CTCGTGCCTGTAATCCTAGCACTTTGGGAGGCCAAGGTGGGCAGATCATCTGAGGTCAGGAGTTCGAGACCAGCCTGGCCAACATAGAGAAATCCCATCTCTACTAAAAATACAAAAATTGACGAGTTAATGGGTGCAGCACACGAACATGGCACATGTATACATATGTAACAAACCTGCACGTTGTGCACATGTACCCTAAAACTTAAAGTATATTTAAAAAAAATACAAAAATTAGCCGGGCATGGTAGCAGGCACCTGTAATCCCAGCTACTCGGGAGGCTGAGGCAGGAGAATCACTTGAACCTGGGAGGCAGAGGTTGCAGTGAGCTAAGATCATTCCATTGTACTCCAACCTGGGCAACAAGAGTGAAATTCCGTCTAATAAAAAATGAAATAAATAAA","GGCCGGGCACAGTGGCTCACACCTGTAAACCCAGCACTTTGGGAGAATGAGGTGGGCAGATGACTTCAGGTCAGGAGTTCGAGACCAGCCTGGCCAACACTGTGAAATCCCATCTCTACTAAAAATACAAAAATTAGCCATGGTGGTCAGAAGATCAAGACTATCCTGGCCAACATGGTGAAACCTTGTCTCTACTGAAAATAGAAAAATTAGCTGGGTATGGTGGCATGCGCCTGTAGTCCCAGATACTCAGGAGGCTGGGGCAGGAGAATCACTTGAACCCAGGAGGCAGAGGTTGCAGTGAGCTGAGATCATGCCATTGCACTCTAGATTAGGCAACAAGAGTGAAACTGTCTCAAAAAGAGAGAGAGAAAA"
"chr18","15802064","15802689","JH378153","2355361","2355755","270","13446703","GACCGGGCATGGTGGCTCACACCTGTAATCCCAGCACTTTGGGAGGCGTAGGCGAGTGGCCCCTGAGGTCAGGAGATCGAGACAACCCTGGCCAACATGGTGAAACTCTACTAAAAATACAAAATTAGGCCGGGTGCCGTGGTTCACGCCTATAATCCCAGCACTTTGGGAGGTCAAGGTGGGCAGATCACCTGAGGTCAGGAGTTTGAGACCAGCCTGGCCAACATGGTGAAACCCAGTCTCTACTAAAAATACAAAAATTAGCTGGGCATGGTGGTGGACACTTGTAATCCCAGCTACTTGGGGGGCTGAGGCAGGAGAATCACTTGAACCCAGGAGGCAGAGGTTGCAGTGAGCCTAAATCACCCCATTGCACTCCAGCCTGGGCAACAAGAGTGAAATTCTGTCTCGAAAAAAAAAAAAAAAGAAAAGAAAAGAAAAAAAAATTAGCCAGGTGTGGTGCTGCATGCCTGTAATCCCAGCTACTCAGGAGGCTGAGGCAGGAGAATCGCTTGAACCCGGGAGGCAGAGGTTGCAGTGAGCTGAGACCACACCATTGCACTCCAGCCTGGGCGACAAGAGAGTAACTCCATTTCAAAAAAAAAAAAAAAAAAAAGAAAAAAGAA","GGCGGGGCATGGTGGCTCACACCTGTCATCCCAACACTTTGGGAGGCTGAGGCAGGCAGATCACCTGAGGTCAGGAGTTTGAGACCAGCCTGGCCAACATGGTGAAACCCCATCTCTACTAAAAATACAAAAATACAAAAAACCCCATCTCTACTAAAAATACAAAAAGCTTGTCTCTATTAAAAATACAAAAAACAAAAAACAAACAAAAAAAAAACCACCATGGTGGTGGGTGCCTATAATCCCAGCTACTCGGGAGGCTGAGGCAGGAGAATCGCTTGAACCCAGGAGGCAGAGGTTGCAGTGAGCCAAGATCCCACCATTGCACTCCAGCCTGGGCAACAGAGAGAGAGACTCTGCCTCAGAAAAAAGAAAGAAAGAAAGAAAGAAAGAAA"
"chr18","15849226","15849860","JH378118","18053084","18053501","290","2203858","GGCCAGGCACAGTAGCTTACGCCTATAATCTCAGCACCCTAGGAGGCCGAGGCTGGCAGACCACCTGAGGTCACGAGTTCAAGACTAGCCTGGTCAACATAGCAAAACCCCATCTCTACTAAAAATACAAAAATTAGGCTGGGCACAGTGGCTCATGCTTGTAATCCCAGCACTTTGGGAGGCCAAGTCGGGAGAATCACCTGAGGTTGGGAGTTCGAGATCAGCCTGACCAACATAGAGAAACTCCATCTCTACTAAAAATGCAAAATTAGCTAGGCATGGTGGTGCATGCCTGTAATCCCAGCTACTCGTAAGGCTGAGGCAGGAGTATCGCTTGAATCTGGGAGGTGGAGGTTGCGGTGAGCCAAGATCACGCCATCGTACTCCAGCCTGGGCAACAAGAGCGAAACTCCATCTCAAAACAAAAAAAATGAGCCAGGAGTGGTGGCGGGCGCCTATAATTCCAGCTACTCCAGAGGCTGAGGCAGGAGAATCACTTAAACCCGGGAAGCAGAGGTTGCAGTGAGCTGAGATTGTGCCATTGCACCCCAGCCTAGGTGAAAAGAGCAAAACTCCATCTCAAAAAAAAAAAAAAAAAAAAAAAAAAAGAAAGAAAGAAAGAAAAAGAAAAAAAA","GGCTGGGCGCAGTGGCTCACACCTGTAATCCCAGCACTTAGGGAAGCTGAGGCGAGTAGATCACCTGAGGTCAGGAGTTAGAGACCAGCCTGGCCATCATGGTGAAACCCCGTCTCTACTAAAGATACCAAAAATTAGCTGAGTGTGGTGCTGGGTGCCTGTAATCCCAGAAACTCAGGGTGCCTGTAATCCCAGCAACTCAGGGTGCCTTTAATCCCAGCAACTGAGGGTACCAGTAATCCCAGCAACTCAGGGTGTCTTTAATCCTAGCAACTGAGGGCACCTGTAATCCCAGCAACTCAGGAAGCTGAGACAGGAGAAGTACTTGAACCCAGAAGGCAGAGGTTGCAGTGAGCCGATATTGCACCATTGCACTCCAGTCTGGGCAACAAGAGTGAAACTCTGTCTCAAAAAAAAA"
"chr18","16042035","16042617","JH378118","18053084","18053501","243","2011049","GGCTATGCACGGTGGCTCACGCCTGTAATCCCAGCACTTTGGGAGGCCGAGTCAGGTGGATCACTTGAGGTCAGGAGTTCGAGACCAGCCTGGCCAACATGGTGAAGCCCCATCTCCACTAGAAATACAAAAATTAGTCTGGGAGCAGTGGCTTACACCTGTAATTGCAGCACTTTGGGAGGCCAAGGTGGGTGGATCACCTGAGGTCAGGAGTTTGAGACCAGCATGACCAACATGGTGAAACTCCATCTATACAAAAAAATTAGCCGGGTGTGGTGGCGCATGCCTGTAATCCCAGCTACTCAGGAGACTGAGGCAGGAGAATTGCTTGAACCCGGGAGGCAGAGGTTGCAGTGAGCCAAGTCTGTGCCATTGCACTCCAACCTGGGCAACAAAAGCGAAACTCTGTCTCAAAAATAAACAACAAAAAAAATTAGCCAGGTGTGGTGGCACATGCCTATAATCCCAGCTACTCGGGAGGCTGAGGCAGAAGAATTGCTTGAACCTGGGAGGTGGAGGTTGCAGTGAGCCGAGATCATGCCATTCTACTCCAGCCTGGGCCACAAGAGCGAAACTCTGTCTC","GGCTGGGCGCAGTGGCTCACACCTGTAATCCCAGCACTTAGGGAAGCTGAGGCGAGTAGATCACCTGAGGTCAGGAGTTAGAGACCAGCCTGGCCATCATGGTGAAACCCCGTCTCTACTAAAGATACCAAAAATTAGCTGAGTGTGGTGCTGGGTGCCTGTAATCCCAGAAACTCAGGGTGCCTGTAATCCCAGCAACTCAGGGTGCCTTTAATCCCAGCAACTGAGGGTACCAGTAATCCCAGCAACTCAGGGTGTCTTTAATCCTAGCAACTGAGGGCACCTGTAATCCCAGCAACTCAGGAAGCTGAGACAGGAGAAGTACTTGAACCCAGAAGGCAGAGGTTGCAGTGAGCCGATATTGCACCATTGCACTCCAGTCTGGGCAACAAGAGTGAAACTCTGTCTCAAAAAAAAA"
"chr18","25849088","25849351","JH378114","20445944","20446195","60","5403144","GGGAAGATGAGGCGGGTGGATCACTTGAGGTCAGGAGTTCGAGACCAGCCTGGCCAACATGGTGACACCCTGTCTCCAAAAAATACACACACACACACACACACACACACACACACAAATTAGCTGGGCATGGTGGCGGGCACCTGTAATCCTAGCTACTCGAGAGGCTGCGGCAGGAGAATTGCTTTAACTTGGGAGGTAGAGGTTGCAGAGAGCCGAGATTGCACCATTGTACTCCAGCCTGGGTGACAAGAGCGAAACTCC","TTGGGAGGCCAAGGCGGGTGGATCACCTGAGGTCAGGAGTTCGAGACCAGCCTGGCCAACATGATAAAACCCCCGTATCTAATAAAAATAGGAAAAAAAAATAAATAAATAGCTGGGCGTTGTGGCAGGTGCCTGTAATCCCAGCTACTCGGGAGGCTCAGGCAGGAGAATCGCTTGAACCCAGGAGGCAGAGGTTGCAGTGAGCCAAAATTGTGCCATTGCACTCCCGCCTGGGAAACAAGAGCAAAACTC"
"chr18","38083500","38083832","JH378152","15993594","15993909","55","22089906","GGCTGGGTGCGGTGGCTCACGCCTGTAATCCCAGCACTTTGGGAAGCCAAGTCAGGTGACCTCACCTGAGGTCAGGAGTCCAAGACCAGCCTGACCAACATGGTGAAACCTCGTCTCTACTAAAAAGACAAAAAATTAGCCAGGCATGGTGGTGGGCACCTGTAATCTCAGCTACTCTGGAGGCTGAGGCAGGAGAATCACTTGAACCCTGGAGGGGGAGGTTGCAGTGAACCAAGATTGCACCATTGCAGTCCAGCCTGGGCGACAAGAGCAAAACTCCATCTCACAAACACACACACACACACACACACACACACACACAGAAAAAAAAAA","GGCTGGGTGTGGTGGCTCATGCCGGTAATCCCAGCACTTTGGGAAGCGGAGGCAGGCAGATCACCTGAGGTCAGGAGTTCAAGACCAACCTGGCCAACATGGAGAAACCATGTCTCTACTAAAAATACAAAAAATTAGCCAGGCATGGTGGGTGCCTGTAATCCCCACTACTCGGGAGGCTGAGGCAGGAGAATTTCTTGAACCCAGGAGGTGGAGGTTTCAGTGAAGCGGAGATCACCCCATTGCACTCCAGCCTGGGTGACAAGAGCAAAACTCCATCTCACAAAATCAACAACAACAACTTAAAAAAAAAAAA"
"chr18","44076326","44076933","JH378118","18053084","18053501","257","26023242","GCTGGGCGCGGTGGCTTGCGCCTGTAATCCCAGCCATTTGGGAGGCCGAGGCAGGTGGATCACCTGAGGTTAGGAGTTCAAAACCAGCCTGGCCAACATGGTGAAACCCCGTCTCTACTAAAAATACAAAAATTAGGCCAGGCACAGTGGCTCACGCCTGTCATCCCAGCACTTTGGGAGGCCAAGGCGGGCGGATCATGAGGTCAGGAGATTGAGACCATCCTGGCTAACACAGTGAAACCCTGTCTCTACTAAAAAAATATATAAAAAATTAGCCGGGCTTGGTGGCGGGTGCCCGTAATCCCAGCTACTCGGGAGGCTGAGGCAGGAGAATGGCGTGAACCTGGAAGGCGGAGCTTGCAGTGAGCCGAGATTGCACCACTGCACTCCAGCCTGGGTGACAGAGTGAGACTCTGTCTCAAAAAAAAAAAAAAAACAAAAAACAAAAATTAGTTGGGTGTGGTGGTGGACGCCTGTAATCCCGGCTACTCGGGAGGCTGAGGCAGGAAAATCACTTCAACCCGGGAGGCAGAGGTTGCCGTGAGCCAAGATCGTGCCATTGCACTCCAGCCTGGGTGACAAGAGCAAAACTCTGTCTCAAAAAAAAA","GGCTGGGCGCAGTGGCTCACACCTGTAATCCCAGCACTTAGGGAAGCTGAGGCGAGTAGATCACCTGAGGTCAGGAGTTAGAGACCAGCCTGGCCATCATGGTGAAACCCCGTCTCTACTAAAGATACCAAAAATTAGCTGAGTGTGGTGCTGGGTGCCTGTAATCCCAGAAACTCAGGGTGCCTGTAATCCCAGCAACTCAGGGTGCCTTTAATCCCAGCAACTGAGGGTACCAGTAATCCCAGCAACTCAGGGTGTCTTTAATCCTAGCAACTGAGGGCACCTGTAATCCCAGCAACTCAGGAAGCTGAGACAGGAGAAGTACTTGAACCCAGAAGGCAGAGGTTGCAGTGAGCCGATATTGCACCATTGCACTCCAGTCTGGGCAACAAGAGTGAAACTCTGTCTCAAAAAAAAA"
"chr18","44546829","44547449","JH378118","18053084","18053501","262","26493745","GGCCAGGCACGGTCGCTCACACCTGTAATTCCAGCACTTTGGGAGGCCAAGGCGGATGGGTCACCTGAGGTCAGGAGTTTGAGACCAGCCTGACCAATATGATGAAACCCCATCTCTATTAAAAATACAAAAATTAGGCTGGGCGCAGTGGTTCATGCCTGTAATTCCAACACTTTGGGAGGCCGAGACGGGCGGACCATGAGGTCAGGAGATCGAGACCATCCTGGCCAACGTGGTGAAACCCCGTGTCTACTAAAATACAAAAAAAATTAGCCAGGTGTGGTGGCACGTGCCTGTAGTCCCAGCTATTAGGGAGGCTGAGGCAGGGGAATCACTTGAACCTGGGAGGTGGAGGTTGCAGTGAGCTGAGATCTTGCCACTACACTCCATTCTGGGCAACAGAGCAAGACTCCGTCTGAAAAAAAACAAAAAAATACAAAAATTAGCTGGGCATGGTGGCGGGTACCTGTAATCCCAGCTACTTGGGAGGCTGAGACAGGAGAATCACTTGAACTCGGGAGGCAGAGGTTGCAGTGAGCCAAGATCGCACCATTGCATTCCAGCCTGGGCAACAAGAGCGAAACTCCATCTCAAAAAAACAAAAAAAAAAAAAAAGAAAAA","GGCTGGGCGCAGTGGCTCACACCTGTAATCCCAGCACTTAGGGAAGCTGAGGCGAGTAGATCACCTGAGGTCAGGAGTTAGAGACCAGCCTGGCCATCATGGTGAAACCCCGTCTCTACTAAAGATACCAAAAATTAGCTGAGTGTGGTGCTGGGTGCCTGTAATCCCAGAAACTCAGGGTGCCTGTAATCCCAGCAACTCAGGGTGCCTTTAATCCCAGCAACTGAGGGTACCAGTAATCCCAGCAACTCAGGGTGTCTTTAATCCTAGCAACTGAGGGCACCTGTAATCCCAGCAACTCAGGAAGCTGAGACAGGAGAAGTACTTGAACCCAGAAGGCAGAGGTTGCAGTGAGCCGATATTGCACCATTGCACTCCAGTCTGGGCAACAAGAGTGAAACTCTGTCTCAAAAAAAAA"
"chr18","45772849","45773450","JH378118","18053084","18053501","269","27719765","CACGCCTATAATCCCAGCACTTTAGGAGGCTGAGGCAGGTGGATCACCTGAGATCAGGAGTTCAAAACCAGCCTGGCCAACATGGTGAAACCCTGTGTCTACTACAAATACAAAAAAATGGGCAGGGTGTGGTGGCTCACACCTGTAATCCCAGCACTTAGGGAGGCCGAGGCGGGTGGATCATGAGGTCAAGAGATCAAGACCATCCTGGCCAACATGGTAAAACCCCGCCTCTACTAAAAATATAAAAATTAGCTGGGCAAGGTGGTGCGCGCCTGTAGTCCCAGCTATTTGGGAGGCTGAGGCAGGAGAATTGCTTGAACCTGGGAGGTGGAGGTTGCAGTGAGCCAAAATCGCGCCACTGCACTCCAGCCTGGCAACAGAGTGAGACTCTGTCTCAAAAAAAAACAAAAACAAAACAAAACAGAAACCAAAATTAGCTGGGCGTGGTGGCGGGCGCCTGTAGTCCCAGCTACTTGGGAGGCTGAGGCAGGAGAATCGCATGAACCCAGGAGGCGGAGGTTGCAGTGAGCCAAGACTGCACTATTGCACTCCAGTCTGGGCTACAAGAGCGAACTCCGTCTCAAAAAAAAAAAAAAAAA","GGCTGGGCGCAGTGGCTCACACCTGTAATCCCAGCACTTAGGGAAGCTGAGGCGAGTAGATCACCTGAGGTCAGGAGTTAGAGACCAGCCTGGCCATCATGGTGAAACCCCGTCTCTACTAAAGATACCAAAAATTAGCTGAGTGTGGTGCTGGGTGCCTGTAATCCCAGAAACTCAGGGTGCCTGTAATCCCAGCAACTCAGGGTGCCTTTAATCCCAGCAACTGAGGGTACCAGTAATCCCAGCAACTCAGGGTGTCTTTAATCCTAGCAACTGAGGGCACCTGTAATCCCAGCAACTCAGGAAGCTGAGACAGGAGAAGTACTTGAACCCAGAAGGCAGAGGTTGCAGTGAGCCGATATTGCACCATTGCACTCCAGTCTGGGCAACAAGAGTGAAACTCTGTCTCAAAAAAAAA"
"chr18","50079974","50080314","JH378127","6796468","6796795","54","43283506","GGTCTGGCGCCAGTGGCTCATGCCTGTAATCCCAGCACTTTGGGAGGCTGAGGCGGGTGTATCACCTGAGGTCAGGAGTTCGAGACCAGCCTGGCCAACATGGCAAAACCCCGTCTCTACGAAAAATACAAAAAAATTAGCCGGGCGTGGTAGCAGTCGCCTGTAATCCCAGCAACTTGGGAAGCTGAGGCAGAAGAATCGCTTAAACCTAGGAGGCGGAGGTTGCAGTGAGCCAAGATTGCGCCATTGCACTCCAGCCTGGTCAACAAGAGCAAAACTCTGTCTCAAAACAACAACAACAACAACAACAACAACAAACAAAAACCAAAAAAACCAAAAAA","GGCCGGGCGCGGTGGCTCAAGCCTGTAATCCCAGCATTTTGGGAGGCCGAGGCGGGTGGATCACGAGGTCAGGAAATCGAGACCATCCTGGTCAACATGGCGAAACCCCATGTCTACTAAAAATACAAAAATTAGCTGGGCATGGTGGCACGTGCCTGTAATCCCAGCTACTCAGGAGGCTGAGGCAGGAGAATTGCCTGAACCCAGGAGGCGGAGCTTGCAGTGAGCCGAGATCGCGCCATTGCACTCCAGCCTGGGTAACAAGAGCGAAACTCCGTCTCAAAAAAACAAACAAAAACAAAACAAAACAAAACAAAACAAAAAAAAC"
"chr18","53653883","53654201","AGCE01149660","956","1264","46","53652927","GGCCAGGCATGGTGGCTCACGTTTGTAATCCTAGCACTTTGGGAGGCTGTAGCGGGCGGATCACCTGAGGTCAGGAGTTTGAGACCAGCCTGGCCAACATGGTGAAACCCTGTCTCTACTAAAAAAAAAAAAAAAAAAAAAAAAAAAATTAGCCAGGTGTGGTGGTGGTGGATGCCTATAATCCCAGCTACTCGGGAGGCTGAGGCAGGAGAATCACTTGAACCTGGGAAGCAGAGGTTGCAATGAGCTGAGATTGAGCCATTGCACTCCAGCCTGGACAACAAGAATGAGACTCTGTCTCAATAAATAAGTAAATAAA","GGCCAGGCACGGTGGCTCATGCCTATAATCCCAGCACTTTGGGAGGCTGCGATGGGTGGTTCACTTGAGGTCTGGAGTTTGAGACCAGCCTGGCCAACATGGAGAAACCCTTTCTCTACTAAAAATACAAAAAAAAAAAAAAAAAAAATTAGCCAGGCATGGTGGCGGGTGCCTGTAATCCCAGCTACTCAGCAGGCTGAGGGAAGAGAATCACTTGAACCGGGGAGGCAGAGGTTGCAGTGAGCTGAGATGATGCCATTGCACTCCAGCCTGGGCAACAAGAGCAAAACTGTCTCAAAAAAAAAAAAA"
"chr18","53971096","53971710","JH378118","18053084","18053501","262","35918012","GGTCGGGTGTGGTGGCTCATGCCTATAATCCCAGCACTTTGGGAGGCTGAGGCAGGCAGATTACCTGAGGTCAGGAGTTCGAGACCAGCCTGGCCAACATGATGAAACCTTGTCTCTACTAAAAATACAAAAATTAGGCCGGGCACGGTGGCTCATGCCTGTAATCCCAGCACTTTGGGAGGCCGAGGCGGGTAGATCACAAGGTCAGAAGTTCAAGACCAGCCTGGCCAACATGGTGAAACTCTGTCTTTACTAAAAATACAAAAATTAGCTAGGCATGGTGGCGCACACCTATAATCCCAGCTACTGGGGAGGCTGAGGCAGGAGAATTGCTTGAACCAGGACCCGGGAGGTGGAGGTTGCTGTGAGCCGAGATTGCGCCACTGCACTCCAGCCTGGGAGACAGAGTGAGACTCCGTCTAAAAAAAAAAAAAAAAAATTAGCCAGGTGTGGTGGCGCATGCCTGTAATCCCAGCTACTCGGGAGGCTGACGCAGAAGAATCATTTGAACGTGGGAGGCAGAGGTTACAATGAGCTGAGATCACACCATTGTACTCCAGCCTGGGCAACAAGAGCAAACTCAATCTCAAAAAAATAAAAATAAAAAAAAAGAAA","GGCTGGGCGCAGTGGCTCACACCTGTAATCCCAGCACTTAGGGAAGCTGAGGCGAGTAGATCACCTGAGGTCAGGAGTTAGAGACCAGCCTGGCCATCATGGTGAAACCCCGTCTCTACTAAAGATACCAAAAATTAGCTGAGTGTGGTGCTGGGTGCCTGTAATCCCAGAAACTCAGGGTGCCTGTAATCCCAGCAACTCAGGGTGCCTTTAATCCCAGCAACTGAGGGTACCAGTAATCCCAGCAACTCAGGGTGTCTTTAATCCTAGCAACTGAGGGCACCTGTAATCCCAGCAACTCAGGAAGCTGAGACAGGAGAAGTACTTGAACCCAGAAGGCAGAGGTTGCAGTGAGCCGATATTGCACCATTGCACTCCAGTCTGGGCAACAAGAGTGAAACTCTGTCTCAAAAAAAAA"
"chr18","57837437","57837748","JH378115","16887097","16887400","43","40950340","GCTGGGCATGGTGGCTCACACCTGTAATCCCAGCACCTTGGGAGGCCGAGGTGGGTAGATCACCTGAGGTCAGGAATTCGAGACCAACCTGGCCAACATGGTGAAACCCCGTCTCTACTAAAAATACAAAAAAAAAAAAAAAAAAAAAAAAAGCTGGGCATGGTGGTGGGTACCTGTAATCCCAGCTACTCAGGAGTCCGAGGCAGGAGAATCGCTTGAACCTGGCAGGTGGAGGTTGCAGTGTGCCAGGATTGTGCCATTGCACTCCAGCCTGGGTGACAAGAGCAAAACTCCAACTCAAAACAAAAACAA","GCCGGGCACGGTGGCTCAAGCCTGTAATCCCAGCACTTTGGGAGGCCGAGGCGGGTGGATCACAAGGTCAAGAGATCGAGACCAACCTGGTCAACATGGTGAAACCCCATCTCTACTAAAAAATACAAAAAAAAAAAAAAAATTAGCTGGGCATGGTGGCGCGTGCCTATAATCCCAGCTACTCAGGAGGCTGAGGCAGGAGAATTGCCTGAACCTAGGAGGTGGAGGTTGCAGTGAGCCAAGATCATGCCATTGCACTCCAGCCTGGGTAACAAGAGCGAAACTCCATCTCAAAAAAAAAAAA"
"chr18","58257354","58257943","JH378118","18053084","18053501","263","40204270","GCCTGTAATCACAGCACTTAGGGGGGCCGAGGCAGGAGGATCACCTGAGGTCAGGAGTTCGAGACCAGCCTGGCCAACATGGTGAAACCCCGTCCCTACTAAAAATACAAAAATTGGCCGGACACATTGGCTCATGCCTGTAATCCCAGCACTTTGGGAGGCCGAGGCGGGTGGATCACCTGAGGTCAGGAGTTCAAGACCAGCCTGACCAACCTGGAGAAACCCTGTTTCTACTAAAAATACAAAATTAGCCAGGCATAGTGGCGCATGCCTGTAATCCCAGCTACTCGAGAGGCTGAGGCAGGAGAATCGCTTGAACCCGGAAGGTGGAGGTTGCGGTGAACCGAGATTGTGCCATTGCACTCCAGCCTGGGCAACAAGAGCAAAACTCCGTCTCAAAAACAAAACAAAACAAAACAAAAATTAACCCGGCGTGGAGGTGGATGCCTGTAATCCCAGCCACTTTGGGAGACTGAGGCAAGAGAATTGCTTGAACCCGGGATGTGGAGGCTGCAGTGACCCGAGATCACGCCATTGCATTCCAGCCTGGCAACAAGAGTAAGACTCCATCTCAAAAACAAGCAAACAAA","GGCTGGGCGCAGTGGCTCACACCTGTAATCCCAGCACTTAGGGAAGCTGAGGCGAGTAGATCACCTGAGGTCAGGAGTTAGAGACCAGCCTGGCCATCATGGTGAAACCCCGTCTCTACTAAAGATACCAAAAATTAGCTGAGTGTGGTGCTGGGTGCCTGTAATCCCAGAAACTCAGGGTGCCTGTAATCCCAGCAACTCAGGGTGCCTTTAATCCCAGCAACTGAGGGTACCAGTAATCCCAGCAACTCAGGGTGTCTTTAATCCTAGCAACTGAGGGCACCTGTAATCCCAGCAACTCAGGAAGCTGAGACAGGAGAAGTACTTGAACCCAGAAGGCAGAGGTTGCAGTGAGCCGATATTGCACCATTGCACTCCAGTCTGGGCAACAAGAGTGAAACTCTGTCTCAAAAAAAAA"
"chr18","59255477","59255805","JH378228","5665092","5665424","52","53590385","GGTTGGGCGCAGTGGCTCACGCCTGTAACCCCAGCACTTTCGGAAGCTGAGGCAGGCGGATCACCTGAGGTCAGGGGTTCGAGACCAGCCCGGACAACGTGATTAAACCCTGCCTCTACTAAAAATACAAAAATTAGCGACTGTGGTGTTGGGCGCCTGTAATCGCAGCTACTTGGGAGGCTGAGGCATGAGAATTGCTTGAACCCAGGAGGCAGAGGTTGCAGTGAGCAGAGATTGCTCCATTGCACTCCAGCCTGGGCAACAAGAGCAGAACTCTGTCTCAAAATAAATAAATAAATAAATAAATAAATAAATAACAGAAAAGAAAA","GGCCGGGCGCGGTGGCTCAAGCCTGTAATCCCAGCACTTTGGGAGGCTGAGGCGGGTGGATCACGAGGTCAAGAGATCGAGACCATCCTGGTCAACATGGTGAAACCCTGTCTCTACTAAAAATACTAAAAATTAGCTGGGCATGGTGGCGTGTGCCTGTAATCCCAGCTACTCAGGAGGCTGAGGCAGGAGAATTGCCTGAACCCAGGAGGCGGAGGTTGCGGTGAGCCGAGATCGCGCCATTGCACTCCAGCCTGGGCAACAAGAGCGAAACTCTGTCTCAAAAAAAAAAAATAAATAAATAAAATAAAATAAAATAAAATAAAATAAAAT"
"chr18","59405673","59406877","JH378118","18053084","18053501","805","41352589","GGCTAGATGCGGTGGCTCATGCCTGTAATCCCAGCACTTTGGGAGGCCAAGGCAGGTGGATCACCTGAGGTCAGGAGTTTGACACCAGCCTGGCCAACATGTTGAAACCCTGTCTCCACTAAAAATACAAAAAAAGATTATCTGGGTTATTGTGGGATCTGGCCAGCAGCCCGCAATGCAATGGGGCTCTCTCTTTGTTCCCAGGCAGATTGGCAGGTTGAGAAATAATAGACACACACAAGATAGTGAAAGTTGGGTCCAGGGGGGTCACCGCCTTCTGGTCCCATGGTGCCAACAATGCACTGGATATACCAGCATTTATTATTAAGTTTAGTGAGGGCGGGGGTAGGTTAGTGAGGGATTTAGGGTCATTTGATTATGAGGTGAGATGGTCACATGGAAATGAAGTAATTCTTTAACGTAACATTTGTATGTAGAAGTACAGTACATTTGTATGTAGAAGTACAGTATACAGAGATAAGAATTTACAATATAGTGTGTGCATCAGTAATTTCTAACAGAGCCTTAAAACAGAAAGACAATCTTTCCATAATCTATGATTAGCAAGATATTAATCAGCAGTAACAATTGCAATGAAAGCTGGTTACAAACAGTCCATGGAAACAGGAGGTGAAGCTAGACAATCGGTTAGACCAGAAATTCTCAGAAGGGAATATGCCTTAACCCTAAAGAGGCCTAGAAGAGCCGTGGCAAGATGAGGGTGTTTATAGCCCTATCTTATCCATATGGACAGGCACCTCCCCATGCGTCCGTTTATAGGCTCTCCATGAGGGTCGCATTCCATTCCCAGAGCTATGAACATCTGCTTTTCTGGGATAGGAATCTTGGTGATGTGAAACCTCCCTGACTACACGTCCATTCATAGGATCTCTGCAGGGGGAAGCACATCACACACTGTTGGCTCGTTCTGGCAGTCCAACCTGGCATTGTGTCTTTACACAATCCTGCATGCAATTTTGTATTTACAATAATCAGGAGCATTTCATCTTTTATTCTGTAGCAATAGTTTCAGGGGGTCTCCCTACACTGGGTGTGGTGACGGGTACCTGTAATCCCAGCTACTCAGGAGGCTGAGGCAGGAGAATCACTTGAGCCTTAGAGGCAGAGGTTGCAGTGAGCTGAGATCAGACCATTGCACTCCAGCCTGGGCAACAAGAGCAAACCTCCGTCTCAAAAAAAAAAAA","GGCTGGGCGCAGTGGCTCACACCTGTAATCCCAGCACTTAGGGAAGCTGAGGCGAGTAGATCACCTGAGGTCAGGAGTTAGAGACCAGCCTGGCCATCATGGTGAAACCCCGTCTCTACTAAAGATACCAAAAATTAGCTGAGTGTGGTGCTGGGTGCCTGTAATCCCAGAAACTCAGGGTGCCTGTAATCCCAGCAACTCAGGGTGCCTTTAATCCCAGCAACTGAGGGTACCAGTAATCCCAGCAACTCAGGGTGTCTTTAATCCTAGCAACTGAGGGCACCTGTAATCCCAGCAACTCAGGAAGCTGAGACAGGAGAAGTACTTGAACCCAGAAGGCAGAGGTTGCAGTGAGCCGATATTGCACCATTGCACTCCAGTCTGGGCAACAAGAGTGAAACTCTGTCTCAAAAAAAAA"
"chr18","71500430","71500770","JH378228","5665092","5665424","54","65835338","GCTGGGTGCGGTGGCTCACGCCTGTAATCACAGCACTTTGGTAAGCCCGAGGCAGGTGGATCACCTGAGGTCAGGAGTTCGAGACCAGCCTGACCAACATGGTGAAACCCTTTCTCTACTAAAAATGCAAAAATTAGCTGGGCGTCATGGCGGGCGTCTGTGATCCCAGCTACTAGGGAGGCTAAGGCAGGAGAATTGCTTGAACCTGGGAGGCGGAGGTTGCAGTGAGCAGAGATTGCACCATTACACTCCAGCCTGGGCAACAAGAGCAAAACTCCATCTCAAAATAAATAAATAACTAAATAAATAAATAAAATGAAATTAAAAAGAAAGAAAGAAAA","GGCCGGGCGCGGTGGCTCAAGCCTGTAATCCCAGCACTTTGGGAGGCTGAGGCGGGTGGATCACGAGGTCAAGAGATCGAGACCATCCTGGTCAACATGGTGAAACCCTGTCTCTACTAAAAATACTAAAAATTAGCTGGGCATGGTGGCGTGTGCCTGTAATCCCAGCTACTCAGGAGGCTGAGGCAGGAGAATTGCCTGAACCCAGGAGGCGGAGGTTGCGGTGAGCCGAGATCGCGCCATTGCACTCCAGCCTGGGCAACAAGAGCGAAACTCTGTCTCAAAAAAAAAAAATAAATAAATAAAATAAAATAAAATAAAATAAAATAAAAT"
"chr19","1465612","1466244","JH378118","18053084","18053501","284","16587472","GGCTGGGGACGGTGGCTCAGGCCTGTAACCCCAGCACTTTGAGAGGACCAGGAGGGAGGATTGCTTGAGCCCAGGAGTCCGAGACCAGCCTGGGCAGCAAAGCAAGGCCCTGTCTCTACAAAAATACTTTAAAATTAGCCAAGTGTTGGCTGGGTGCGGTTGCTCATGCCTATAATCCCAGCACTTTGGGAGGCCGAGGTGGGTGGATCACCTGAGGTCAGGAGTTTGAGACCAGCCTGGCCAACATGGCAAAACCCCGTCTCTACTAAAAATACGAAAATTAGCCAGACGTGGTGGCTCATTCCTGTAATCCCAGCTACTCGGGAGGCTGAGGCAGGAGAATCGCTTGAACTCGCAAGGCGGAGGTTGCAGTGAGCCAAGATCATGCCATTGCATTCCAGCCTGGGTGACAGAGCAAAACTCCGTCTCAAAAAAAAAAAAAAAAAAAAAAAATTAGCCAGGCGTGGTGGTGGGCACCTGTAGTCCCAGCTACCCGGGAGGCTGAGGCAGGAGAATCGCTTGAGCCCGGGAGGCAGAGGTTACAGTGAGCCGAGATCGTGCCATTGCACTCCAGCCTGGGCAACAAGAGTGAAAATCCGTCTCAAAAAAATAAATAAATACAAAATAAAAAAA","GGCTGGGCGCAGTGGCTCACACCTGTAATCCCAGCACTTAGGGAAGCTGAGGCGAGTAGATCACCTGAGGTCAGGAGTTAGAGACCAGCCTGGCCATCATGGTGAAACCCCGTCTCTACTAAAGATACCAAAAATTAGCTGAGTGTGGTGCTGGGTGCCTGTAATCCCAGAAACTCAGGGTGCCTGTAATCCCAGCAACTCAGGGTGCCTTTAATCCCAGCAACTGAGGGTACCAGTAATCCCAGCAACTCAGGGTGTCTTTAATCCTAGCAACTGAGGGCACCTGTAATCCCAGCAACTCAGGAAGCTGAGACAGGAGAAGTACTTGAACCCAGAAGGCAGAGGTTGCAGTGAGCCGATATTGCACCATTGCACTCCAGTCTGGGCAACAAGAGTGAAACTCTGTCTCAAAAAAAAA"
"chr19","1761610","1762212","JH378118","18053084","18053501","248","16291474","GGCCGGGTGCGGTGGTTTACACCTGTAATCCTGGCATTTTGGGAGGCCGAGGCAGGAGTATCACCTCAGGTCAGGAGTTCAAGACCAGCCTGGCCAACATGGTGATACTCCGTCTCTACTAAAAATACAAAAATTGGCCGAGTGCAGTGGCTCACACCTGTAATCCCAGCACTTTGGGAGGCCGAGGCAGGTGGATCATGAGGTCAGGAGTTCGAGACCAGCCTGGCCAAGATGGTGAAACCCCGTCTCTACTAAAAATACAAAAATCAGCTGGGTGTGGTGGCGGGTGCCTGTAATCCCAGCTACTCGGGAGGCTGAGGCAGGAGAATTGCTTGGACCTGGGCAGCAGAGGTTGCAGCGAGCTGAGATGGCGCCACTGCACTCCAGCCTGGGCGACAGAGCGAGACTCTTGTCTCAGAAAAATAAAAAATAAAAAAATTAGCTGGGTGTGGTGGTGCGCACCTGTAATCCCAGCTACTCGGGAGGCTGAGGCAGGAGAATCGCTTGAATCTGGGAGGAGGAGGAGGTTGCAGTGAGCTGAGATAGTGCCAGTGCAGGCCAGCCTGGTCAACAAGAGTGAAACTCCGTCTCAGAAAAAAAAAA","GGCTGGGCGCAGTGGCTCACACCTGTAATCCCAGCACTTAGGGAAGCTGAGGCGAGTAGATCACCTGAGGTCAGGAGTTAGAGACCAGCCTGGCCATCATGGTGAAACCCCGTCTCTACTAAAGATACCAAAAATTAGCTGAGTGTGGTGCTGGGTGCCTGTAATCCCAGAAACTCAGGGTGCCTGTAATCCCAGCAACTCAGGGTGCCTTTAATCCCAGCAACTGAGGGTACCAGTAATCCCAGCAACTCAGGGTGTCTTTAATCCTAGCAACTGAGGGCACCTGTAATCCCAGCAACTCAGGAAGCTGAGACAGGAGAAGTACTTGAACCCAGAAGGCAGAGGTTGCAGTGAGCCGATATTGCACCATTGCACTCCAGTCTGGGCAACAAGAGTGAAACTCTGTCTCAAAAAAAAA"
"chr19","2871458","2872098","JH378118","18053084","18053501","282","15181626","GGCCGGGCGCGGTGGCTCACGCTTGTAATCCCAGCACTTTGGGAGGCCTAGGTAGTGGATCACCTGAGGTCAGGAGTTTGAGACCAGCCTGGCCAACATGGGGAAACCCAGTCTCTACTAAAAATACAAAAATGAGGCCGGGTGCAGTGGCTCATGCCTGTAGTCTCAACACTTTGGGAGACCAAGGCAGGCGGATCACCTGAGGTCAGGAGTTCAAGCCCAACCTGGCCAACATGGTGAAACCCTGCCTCTTCTAAAAATACAAAAATTAGCCAGGTGTGGTGGCATGTACCTGCAATCCCAGCTGCTTAGGAGTTCGAGATAGAAGGATTGCCTGAACCTGGGAGGCGGAGGTTGCAGTGAGCTGAGATCATGCCATTGCACTCCAGCCTGGGTGACAGAGACCCTGTCTCACACACACACACACAAATTATATATATATATATATATATACACACACACACACACGCACACACAAATTGGCCAGGCGTGGTGGCGGGTGCCTATAATTCCAGCTACTTGGGAGGCTGAGGCAGGAGAATGTCTTGAACCCGGGAGGTGGAGGTTGCAGTGAGCCGAGATTGCGCCACTGCACTTTAGCCTGGACGACAAGAACAAAACTCCATCTCAAAAAAACGAAA","GGCTGGGCGCAGTGGCTCACACCTGTAATCCCAGCACTTAGGGAAGCTGAGGCGAGTAGATCACCTGAGGTCAGGAGTTAGAGACCAGCCTGGCCATCATGGTGAAACCCCGTCTCTACTAAAGATACCAAAAATTAGCTGAGTGTGGTGCTGGGTGCCTGTAATCCCAGAAACTCAGGGTGCCTGTAATCCCAGCAACTCAGGGTGCCTTTAATCCCAGCAACTGAGGGTACCAGTAATCCCAGCAACTCAGGGTGTCTTTAATCCTAGCAACTGAGGGCACCTGTAATCCCAGCAACTCAGGAAGCTGAGACAGGAGAAGTACTTGAACCCAGAAGGCAGAGGTTGCAGTGAGCCGATATTGCACCATTGCACTCCAGTCTGGGCAACAAGAGTGAAACTCTGTCTCAAAAAAAAA"
"chr19","2912949","2913566","JH378118","18053084","18053501","268","15140135","GGCTGGGCGTGGTGGCTCACACCTGTAATCCCAGCACTTTGGGAGGCCAAGGTGGAGGGACTGCCTGAAGCCAGGGGTTCGAGACCAGCCTGGCCAACATGGTGAAACCCTGTCTCTACTAAAAATAGAAAAATTAAGGCCGGGCGCGGTGGCTCATGCCTGTAATCCCAGCACTTTGGAAGGCCGAGGCGGGCGGATCACTTGAGGTCGGGAGTTCAAGACCAGCCTGACCAACATGGAGAAACCCTGTCTCTACTAAAAATACAAAATTAGCCAGGGTGGTGGCGCATGCCTGTAATCCCAGCTACTTGGGAGGCTGAGGCAGGAGAATCGCTTGAACCCGGGAGGTGGAGGTTGCAGTGAGCTGAGATCGCACCATTGCACTCCAGCCTGGGCAACAAGAGCAAAACCACGTCTCAAAAAAAATAAAAATAAAAATAAAAAAATTAGCTGGGTGTGGTGGCAGGCGCCTGTAGCTGCTTGGGAGGCTGAGACAGGAGAATTGCTTGAACCTGGGAGGCGGAGGTTGCAGTGAGCTGAGACCGTGCCATTGCACTCCAGGCTGGGCAAGAAGAGCAAAACTCTATCCTTCCCCCACTCCAAAAAAAAAAAAAAAAA","GGCTGGGCGCAGTGGCTCACACCTGTAATCCCAGCACTTAGGGAAGCTGAGGCGAGTAGATCACCTGAGGTCAGGAGTTAGAGACCAGCCTGGCCATCATGGTGAAACCCCGTCTCTACTAAAGATACCAAAAATTAGCTGAGTGTGGTGCTGGGTGCCTGTAATCCCAGAAACTCAGGGTGCCTGTAATCCCAGCAACTCAGGGTGCCTTTAATCCCAGCAACTGAGGGTACCAGTAATCCCAGCAACTCAGGGTGTCTTTAATCCTAGCAACTGAGGGCACCTGTAATCCCAGCAACTCAGGAAGCTGAGACAGGAGAAGTACTTGAACCCAGAAGGCAGAGGTTGCAGTGAGCCGATATTGCACCATTGCACTCCAGTCTGGGCAACAAGAGTGAAACTCTGTCTCAAAAAAAAA"
"chr19","3601333","3601668","JH378148","10302642","10302970","47","6701309","GCTGGGCGTGGTGGCTCACACCTGTAATCCCAGCACTTTGGGAGGCTGAGGTGGGCGGATCACGTGAGGTCAGGAGTTCCAGACTAGCCTGGCCAACATGGGGAAACCCCATCTCTGCTAAAAATAAAAAATTTAGCCGAGTGTGGTGGTGGGTGCCTGTAATCCCAGCTACTCAGGAGGCCGAGGCAGGAGAATTGCTTGAACCCAGGAGGCAGAGGTTGCAGTGAGCCGAGATCACGCCATTGCACTCCAGCCTGGATGACAACAGTGAGACTCCAACTCAAAAAATAATAATAATAATAATAATAATAATAAAATAAAACAATAAAAAAAAAA","GGCCGGGCGCGGTGGCTCAAGCCTGTAATCCCAGCACTTTGGGAGGCCGAGGCGGGTGGATCACGAGGTCAAGAGATCGAGACCATCCTGGTCAACATGGTGAAACCCCGTCTCTACTAAAAATACAAAAAATTAGCTGGGCATGGTGGTGGGTGCCTGTAATCCCAGCTACTCAGGAGGCTGAGGCAGGAGAATTGCCTGAACCCAGGAGGCGGAGGTTGCGGTGAGCCGAGATCGCGCCATTGCACTCCAGCCTGGGTAACAAGAGTGAAACTCTGCCTCAAAAAAAAAAAATAAAATAAAATAAAATAAAATAAAATAAAATAAAA"
"chr19","4440800","4441421","JH378118","18053084","18053501","276","13612284","GGCTGGGTGCGGTGGCTCATGCCTGTAATCCCAGCACTTTGGGAGGCCAAGCGGGCAGATCAACTGAGGTCAGGAGTTCGAGACCAGCCTGGCCAACATAGTAAAACCCTGTTTCTACTAAAAAAAAAAAAAAAAAAAAAAAAAAAATTGGCTGGGCGCAGTGGCTCACGCATGTAATCCCTGCACTTTGGGAGGCCAAGGCAGGTGGATCACCTGAGGTCAGTAGTTTGAGACCAGCCTGACCAACGTGGAGAAACCCCATCTCTACTAAAAATACAAACAAAAAAAACAAAAAACAAAAAAAACCGGGTATGGTGGTACATCCCTGTAATCCCAGCTCCTCGGGAGGCTGAGGCAGGAGAATCACTTGAACCCGGGAGGCGGAGGTTGCACTGAGCCGAGATTGCGCCACTGCACTCCAGCCTGGGCGATAGAGCGAGACTCCCTCTTAAATAATGATTATAATTGCCAGGTGTGGTGGCGGGTGCCTGTAATCCCAGCTACTTGGGAGGCTGAGGCAGGAGAATCGTTTGAATCCAGGAGGAGGAGGTTGCAGTGAGCCGAGATGGTGCCACAGCACTCCAGCCTGGGTGACAAGAGTGAAACCCCATTACAAACAAAA","GGCTGGGCGCAGTGGCTCACACCTGTAATCCCAGCACTTAGGGAAGCTGAGGCGAGTAGATCACCTGAGGTCAGGAGTTAGAGACCAGCCTGGCCATCATGGTGAAACCCCGTCTCTACTAAAGATACCAAAAATTAGCTGAGTGTGGTGCTGGGTGCCTGTAATCCCAGAAACTCAGGGTGCCTGTAATCCCAGCAACTCAGGGTGCCTTTAATCCCAGCAACTGAGGGTACCAGTAATCCCAGCAACTCAGGGTGTCTTTAATCCTAGCAACTGAGGGCACCTGTAATCCCAGCAACTCAGGAAGCTGAGACAGGAGAAGTACTTGAACCCAGAAGGCAGAGGTTGCAGTGAGCCGATATTGCACCATTGCACTCCAGTCTGGGCAACAAGAGTGAAACTCTGTCTCAAAAAAAAA"
"chr19","5462237","5462567","JH378255","1377129","1377437","56","4085108","GACCAGGTGCGGTGGCTCACGCCTGTCATTCCAGCACTTTGGGAGGCCGAGGGGGGCGTGGATCACTTGAGGTCAGGAGTTCAAGACCAGCCTGACCAACATGGTGAAACTCCGTCTCTACTAAAAATACAAAAATTAGCCAGGTGTGGTGGCACATGCCTGTAATCCCAGCTACTTGGGAGGCTGAGGCAGGAGAATCACTTGAACCTGGGAGATGGAGGTTTCATTCAGTGAGCTGAGATTGCACCATTGCACTCCAGCCTGGGTGACAAGAACGAAACTCTGTCTCAGAACACACACACACACACACACACACACACCCCAGAAAAAA","GGCCTGGCGTGGTGGCTCACGCCTGTAATCTCAGCACTTTGGGAGGCCAAGGTGGGTGGATCACCTGAGGTCAGGAGTTCAAGACCAGCCTGGCCAACATGGTGAAACCCCGTCTCTACTAAAAATACAAAAATTAGCTGGGTGTGGTGGCAGACACCTGTAATTCCAGCTACTTGGGAGGCTGAGGCAGGAGAATAGCTTGAACCTGGGAGGTGAGGGTTGCAGTGAGCCGAGATCGCACCATTTTACTCCAACCTGGGCAACAAGAGCGAAACTCCGTCTCAAAATCCAAACAAACCAAAACAAAAA"
"chr19","8011731","8012413","JH378118","18053084","18053501","321","10041353","GGCCGGGTACAGTGGCTCACTCCTGTAATCCCAGAACTTTGGGAGACCGAGGTGGGGGGATCACTTGAGGTCAGGAGTTCGAGACCACCCTGGCCAATATAGTGCTAAACCCCATCTCTACTCAAAATACAAAAAAAAAAAAAAAAAAAAAAAAAAAGCAAAACCCAGGCTGGGCACAGTAGCTCATACCTGTAATCCCAGCACTTTGGGAGGCTGAGGTGGGTAGATCATGAGGTCAGGAGTTCGAGACCAGCCTGACCAACATGGTGAAACCCCGTCTCTACTAAAAATACAAAAATTAGCCGGGCATGGTGGTGCGTGCCTGTAATCCCAGCTACTCAGGAGGCTGAGGCAGGAGAATCGCTTGAAGCTGGGAGGCAGAGGTTGCAGTGAGCCGAGATCGTGCTACTGTACTCCAGCCTGGGCAACAGGGCGACAGAGCAAGACTCTGTCTCAAAAAAAAAAAAAAAAAAAAAAAAAAGCAAAACCCCATCTCTACTAAAAATACAAAAAATTAGCCAGGCATGGTGGCATGTGCCTGTAATCCCAGCTACTCGAGAGGCTGAGGCAGAAGAATCACTTGAACCCAGGAGGCAGAGGTTGCAGCGAGCCAAGATTGTGCCATTGCACTCCAATCTGGGTGACAAGAGTAAAATCCTGTCTCAAAAAAATAAAAAATAAAA","GGCTGGGCGCAGTGGCTCACACCTGTAATCCCAGCACTTAGGGAAGCTGAGGCGAGTAGATCACCTGAGGTCAGGAGTTAGAGACCAGCCTGGCCATCATGGTGAAACCCCGTCTCTACTAAAGATACCAAAAATTAGCTGAGTGTGGTGCTGGGTGCCTGTAATCCCAGAAACTCAGGGTGCCTGTAATCCCAGCAACTCAGGGTGCCTTTAATCCCAGCAACTGAGGGTACCAGTAATCCCAGCAACTCAGGGTGTCTTTAATCCTAGCAACTGAGGGCACCTGTAATCCCAGCAACTCAGGAAGCTGAGACAGGAGAAGTACTTGAACCCAGAAGGCAGAGGTTGCAGTGAGCCGATATTGCACCATTGCACTCCAGTCTGGGCAACAAGAGTGAAACTCTGTCTCAAAAAAAAA"
"chr19","8026835","8027736","JH378118","18053084","18053501","522","10026249","GCGCGGTGGCTCATGCCTGTAAACCCAGCACTTTGGGAGGCTGAGGTGGGTGGATCACCTGAGGTCAGGAGTTTGAGACCAGCCTGGCCAATATGGTGAAACCCGTCTCTACTAAAACATACAAAAATTAGGCTGGGCGCGGTGGCTCATGCCTTTAATCCCAACACTTTGGGAGGCCGAGGCGGGCGGATCACGAGGTCAGGAGTTTGAGACCATCCTGGCTAACATGGTGAAAGCCCGTCTCTACTAAAAATATAAAAATTAGCTGGGCGTGGTGGTGGGCACCTGGAGTCCCAGCTACTTGGGAGGCTGAGGCAGGAGAATGGCGTGAACCCGGGAGGCGGAGCTTGCAGTGAGCCAGGATCACGCCACTGCACTCCAGCCTGGGCGACAGAGCGAGACACCGTCTCAAAAAAAAAACAACAAAAATTAGCCAGGCATGGTGGTGGGCGCCTTTTTTTTTTTTTTTTTCAGAGTCTCACTCTGTCACCCAGGCTGGAGTGCAGTGGCTCAATCTCGGTTCACTGCAACCTCCGCCTCCCAGGTTCAAGCGATTCTCCTGCCTCAGCCTCCCGAATAACTGGGATTACAGGCACCCGCCACTACAACCAGCTAATTTTTGTATTTTTAGTAGAGATGGGGTTTCGCCATGTTGGCCAGGATGGTCTTGATCTCTTGACCTCGTGATCCACCCTCCTTGGCCTCTCAAAGTGCTGGGATTACAGGTGTGAGCCACTGTTCCCAGCTGATAGTGGGCACTTTTAATCCCAGCTACTCCGGAGGCTGAGGCAGGAGAATTGCTTGAACCCAGGAGGTGGAGGTTGCAGTGAGCCAAGATCGCGCCATTGCACTCCAGCCTGGGTGACAATAGCAAAACTCTGTCTCAATGAAACAAAACAAAA","GGCTGGGCGCAGTGGCTCACACCTGTAATCCCAGCACTTAGGGAAGCTGAGGCGAGTAGATCACCTGAGGTCAGGAGTTAGAGACCAGCCTGGCCATCATGGTGAAACCCCGTCTCTACTAAAGATACCAAAAATTAGCTGAGTGTGGTGCTGGGTGCCTGTAATCCCAGAAACTCAGGGTGCCTGTAATCCCAGCAACTCAGGGTGCCTTTAATCCCAGCAACTGAGGGTACCAGTAATCCCAGCAACTCAGGGTGTCTTTAATCCTAGCAACTGAGGGCACCTGTAATCCCAGCAACTCAGGAAGCTGAGACAGGAGAAGTACTTGAACCCAGAAGGCAGAGGTTGCAGTGAGCCGATATTGCACCATTGCACTCCAGTCTGGGCAACAAGAGTGAAACTCTGTCTCAAAAAAAAA"
"chr19","9069244","9069863","JH378118","18053084","18053501","266","8983840","GGCCGGGCACGGTGGCTCATTCCTGTAGTCTCTGTACTTTAGGAGGCTGAGGTGGGTGGATCACTTGAGGTCAGGAGTTCCAGACCAGTCTGGCCAAAATGGTGAAACCCCGTCTGTACTAAAAATACAAAAAAAAAGGCCGGGCGCGGTGGCTCACGCCTGTAATCCCAGCACTTTGGGAGGCTGAGGTGGGTGGATCACAAGGTCAGGAGATTGAGACCATCCTGGCTAACATGGTGAAACCCCGTCTCTACTAAAAATACAAAAAATTAGCTGAGTGTGGTAGCAGGCACCTGTAATCCCAGCTACTCAGGAGGCTGAGGTGGGAGAATGGCATGAACCCAGGAAGCAGAGCTTGCAGTGAGCTGAGATCATGCCACTGCACTCCAGCCTGGGTGACAGAGCGAGACTCCATCTCAAAAAAAAAAAATACAAAAAAATTAGCCAGGCGTAGTGGTGCATGCTTGTAGTCTCGGCTACTCAGGAGACTGACGCAGGAGAATCACTTGAACCCAGGAGGCGGAGGTTGCAGTGAGCCGAAATTATGCCATTGCACTCCAGCCTGGGAGACAAGAACAAAACTCTATCTCAAAAACCAACCAACCAAACAAACAAAAAAA","GGCTGGGCGCAGTGGCTCACACCTGTAATCCCAGCACTTAGGGAAGCTGAGGCGAGTAGATCACCTGAGGTCAGGAGTTAGAGACCAGCCTGGCCATCATGGTGAAACCCCGTCTCTACTAAAGATACCAAAAATTAGCTGAGTGTGGTGCTGGGTGCCTGTAATCCCAGAAACTCAGGGTGCCTGTAATCCCAGCAACTCAGGGTGCCTTTAATCCCAGCAACTGAGGGTACCAGTAATCCCAGCAACTCAGGGTGTCTTTAATCCTAGCAACTGAGGGCACCTGTAATCCCAGCAACTCAGGAAGCTGAGACAGGAGAAGTACTTGAACCCAGAAGGCAGAGGTTGCAGTGAGCCGATATTGCACCATTGCACTCCAGTCTGGGCAACAAGAGTGAAACTCTGTCTCAAAAAAAAA"
"chr19","9785992","9786608","JH378118","18053084","18053501","261","8267092","GGCCGGGAACGGTGGCTCACACCTATAATCCCAGCACTTTGGGAGGCCGAGGCAGGTGGATCACCTGAGGTCAGGAGTTCAAGACCAGCGTGGCCAACATAATGAAACCCCATCTTGGCCGGGTGCGGTGACTCACGCCTGTAATCCCAGCACTTTGGGAGGCCAAGGCGGGTGGATCACGAGGTCAGGGGATCGAGACCATCCTGGCTAACACAGTGAAACCCTGTCTCTACTAAAAATACAAAAAAATTAGCTGGGCATGGTGGCGGACGCCTGTAGTCCCAGCTACTCGGGAGGCTGAGGCAGGAGAATGGTGTGAACCTGGGAGGCAGAGCTTGCAGTGAGCCGAGATTGCGCCACTGCACTCCAGCTTGGGTGACAAAGTGAGACTCCATCTCAAAAAAAAAAAAAGAAACCCCATCTCTACTAAAAATACAAAAAATTTGCTGGGTGTGGTTGTGGGCACCTGTAATCCCAGCTACTTGGGAGGCTGAGGCAGGAGAATCACCTGAACCCAGGAGGCAGAGGTTGCAGTGAGCCGAAACAGTGCCATTGCACTCCAGCCTGGGCAACAAGAGTGAAACTCAATCTCAAAAAAAAAAAAAAAAGTACAAAAA","GGCTGGGCGCAGTGGCTCACACCTGTAATCCCAGCACTTAGGGAAGCTGAGGCGAGTAGATCACCTGAGGTCAGGAGTTAGAGACCAGCCTGGCCATCATGGTGAAACCCCGTCTCTACTAAAGATACCAAAAATTAGCTGAGTGTGGTGCTGGGTGCCTGTAATCCCAGAAACTCAGGGTGCCTGTAATCCCAGCAACTCAGGGTGCCTTTAATCCCAGCAACTGAGGGTACCAGTAATCCCAGCAACTCAGGGTGTCTTTAATCCTAGCAACTGAGGGCACCTGTAATCCCAGCAACTCAGGAAGCTGAGACAGGAGAAGTACTTGAACCCAGAAGGCAGAGGTTGCAGTGAGCCGATATTGCACCATTGCACTCCAGTCTGGGCAACAAGAGTGAAACTCTGTCTCAAAAAAAAA"
"chr19","9897689","9898264","JH378206","6546474","6546861","233","3351215","GCCAGGCACGGTGGCTCACACCTGTAATCCCAGCACTTTGGGAGGCCAAGGTGGGTGGATCACCTGAGGTCAGGAGTTCAAGACCAGCCTGACCAACATGGTGAAACCCAGGGCTCACACCTGTAATCCCAGCGCTTTGGGAGGCTGACGCGGGCAGATCACGAGGTCAGGAGATCGAGACCATCCTGGCTAACATGGTGAAACCCCGTCTCTACTAAAAATACAATAATTAGCTGGGCATGGTGGTGGGTGCCTGCAGTCCCAGCTACTTGGGAAGCTGAGGCAGGAGAATGGCGTGAACCCAGGAGGTGGAGCTCTCAGTGAGCTGAGATTGCATCACTGCACTTCCAGCCTGGGTGACAGAGCAAGACTCTGTCTCAAAAAAAAAAAAAAAAAAAAAAAAAATTAGCCAGGTGTGATGGCAGGCACCTGTAATCCCAGCTACTTAGGAGGCTGAGGCAGGAGAACCCAGGAGGCAGAGGTTGCAGTGAGCCAAGATCGCGCCATTGCACTCCAGCCTGGGTGACAAGAGCAAAATTCCATCTCAAAAAAAAAAAAAAAGAAGAAAAAGAAGAA","GGCCACACATGGTGGCTAACGCCTGTAATCCCAGCACTTTGGGAGGCCAAGTCGGGTGGATCATGAGGTCAGGAGACCAAGACCATCCTGGCCAAATGGTGAAACCCCGTCTCTACTAAAAATACAAAAATTAGCTGGGCATGGTGGCGTGTGCCTGTAATCCCAGCTACTCAGGAGGCTGAGGCAGGACAATTGCCTGAACCCAGGAGAATTAGCTGGGCATGGTGGCGTGTGCCTGTAATCCCAGCTACTCAGGAGGCTGAGGCAGGACAATTGCCTGAACCCAGGAGGCGAAGGTTGCGGTGAGCCGAGATTGTGCCATTGCACTCCAGCCTGGGTAACAAGAGCGACACTCTGTCTCAAAAAAAAAAAAAAAAAAAAAAAAAAA"
"chr19","10210761","10211695","JH378118","18053084","18053501","553","7842323","GGCCGGGTGTGGTGGCTCATGCCTGTAATCCCAGGCATGATTTGGGAGGCCGAGGGAGGCAGATCACCTGAGGTCAGGAGTTTTTTTGTTTTGTTTTGTTTTGTTTTTGAGACAGAGTCTTGTTCTGTTGCCCAGGCTGGAGTGCAATGATGTGATCTCGACTCACTACAACCTCCACCTCCTGAGTTCAAGCGATTCTGCTGCCTCAGCCTCCCGAGTAGCTGGCATTACAGGCATGTGCCACCAAGCCTGGCTAATTTTTGTATTTATAGTAGAGACGGGGGTTTCACCATGTTGATCAGGCTGGTGTCGAACTCCTGGCCTCAAGTGATCCGCTCGCCTTGGCCTCCCAAAATGCTGGGATTACAGATGTGAGCCACTGTGCCCAGCCAAGGTCAAGAGTTTGAAACCAGCCTGGCCAGCATGGTGAAACCCTATCTCTACTAAAAATACAAAATCAGTCCATGTGCCTAATTTTGGGATCACACCTGGGATCATGCCTGCAATCCCAGCACTTTGGGAGGCCAAGGCGGGTGGGTCATGAAGTCAGGAGTTCAAGACCAGCCTGGCCAACATGGTGAAACCCTGTCTCTACTAAAAATACAAAAGTTAGCTGGGCGTGGTGGCACGCACCTGTAGTCCCAGCTACTAGGAAGGCTGAGGCAGGAGAATTCTTGAACCCGGGTGATGGAGGTTGCAGTGAGCCGAGATTGCGCCACTGCACTCCAGCCTGGGCAACAGAGTGAGACTCTGTCTAAAAAAAAAATTAGTCAGGCGTGGTGGTGAGCACCTGTAATCACAGCTACTGGGGAGGCTGAGGCTGGAGAATTGCTTGAACCCGGGAGGCGGAGGTTGCAGTGAGCCAAGATCGCGCCTTTGCACTCCAGCCTGGGCAACAGGAGTGAAACTGCATCTCAAAAAAAAAAAAAAAAAAA","GGCTGGGCGCAGTGGCTCACACCTGTAATCCCAGCACTTAGGGAAGCTGAGGCGAGTAGATCACCTGAGGTCAGGAGTTAGAGACCAGCCTGGCCATCATGGTGAAACCCCGTCTCTACTAAAGATACCAAAAATTAGCTGAGTGTGGTGCTGGGTGCCTGTAATCCCAGAAACTCAGGGTGCCTGTAATCCCAGCAACTCAGGGTGCCTTTAATCCCAGCAACTGAGGGTACCAGTAATCCCAGCAACTCAGGGTGTCTTTAATCCTAGCAACTGAGGGCACCTGTAATCCCAGCAACTCAGGAAGCTGAGACAGGAGAAGTACTTGAACCCAGAAGGCAGAGGTTGCAGTGAGCCGATATTGCACCATTGCACTCCAGTCTGGGCAACAAGAGTGAAACTCTGTCTCAAAAAAAAA"
"chr19","10485431","10486007","JH378118","18053084","18053501","237","7567653","GGCCGGGCGCAGTGGCTCATGCCTAATCCCAAGACTTTCAGAGGCTGAGGCAGGTGGATCACCTGAGGTCAGGAGCTCAAGACCAGCCTGGCTAACATTGTGAAACCGCGTCTCTACTAAAAATCAAAATTGGCCGGGCACGGTGGCTCACACCTGTAATCCCATCCCTCTGGGAGACCGAGGCGGGCAGATCACCTAAGGTCAGGAGTTCGAGACCAGCCTGACCAACATGGAGAAAACCCTTCTCTGCTAAAAATACAAAATTAGCCGGGCGTGGTGGCGCATGCCTGTAACCTCAGCTACTCGGGAGGCTGAGGGAAAATCGCTTGAACCTGCCAGGTGGAGGTTGCAGTGAGCCGAGATCGAGCCATTGCACTCCAGCATGGGCAACGAAAGCGAAACTCCATCTCAAAAAAAAAAAAAATTAGCTAGGCGTGGTGGCGCGTGCCTGTATTCCCAGCTACTCAGGAGGCTGAGACAGGAGAATCACTTGAACCTGGGAGGCAGAGGTTGCAGTGAGCCAAGATTGCACCATTGCACTCCAGCCTGGGCAACACGAGCAAAACTCTGTCTCAAA","GGCTGGGCGCAGTGGCTCACACCTGTAATCCCAGCACTTAGGGAAGCTGAGGCGAGTAGATCACCTGAGGTCAGGAGTTAGAGACCAGCCTGGCCATCATGGTGAAACCCCGTCTCTACTAAAGATACCAAAAATTAGCTGAGTGTGGTGCTGGGTGCCTGTAATCCCAGAAACTCAGGGTGCCTGTAATCCCAGCAACTCAGGGTGCCTTTAATCCCAGCAACTGAGGGTACCAGTAATCCCAGCAACTCAGGGTGTCTTTAATCCTAGCAACTGAGGGCACCTGTAATCCCAGCAACTCAGGAAGCTGAGACAGGAGAAGTACTTGAACCCAGAAGGCAGAGGTTGCAGTGAGCCGATATTGCACCATTGCACTCCAGTCTGGGCAACAAGAGTGAAACTCTGTCTCAAAAAAAAA"
"chr19","10538873","10539199","JH378118","15020968","15021286","46","4482095","GCTGGGCGCGGTGGCTCACGCCTGTAATCCCAGCACTTTGGGAGGCTGAGGCAGGCAGATCACCTGAGGTCAGGAGTTCAAGACCAGCCTGGTTAACACAGTGAAACCCCCGTCTCTACTAAAAATACAAAAACAAAAATTAGCCGGGTGTGGTGGCGGGCGCCTGTAATCCCAGTTACTCGGGAGGCTGAGGCAGGAGAATCGCTTGAACCCGGGAGGCGGAGGTTGTGGTGAGCCGAGATTGCCATTGCACTCCAGCCTGGGCAAAAAGAGCGAAACTCCATCTAAAACAAACAAACAAACAAACAAACAAAAAATAGAAAAGAA","GCCGGGCGCGGTGGCTCAAGCCTGTAATCCCAGCACTTTGGGAGGCTGAGGCGGGTGGATCCCGAGGTCAAGAGATCGAGACCATCCTGGTCAACATGGTGAAACCCCGTCTCTACTAAAAATACAAAACATTAGCTGGGTATGGTGGCGCGTGCCTGTAATCCCAGCTACTCAGGAGGCTGAGGCAGGAGAATTGCCTGAACCCAGGAGGCGGAGGTTGCGGTGAGCTGAGATCGCGCCATTGCACTCCAGCCTGGGTAACAAGAGCGAAACTTCCATCTCAAAAACAAACAAACAAACAAACAAACAAAAAACAAAC"
"chr19","10973032","10973651","JH378118","18053084","18053501","265","7080052","GGCTGGACGTGGTGGCTCACGCCTGTAATCCCAACACTTTGGGAGACCAAGGCAGGTGGATCGCCTGAGGTTAGGGGTTCGAGACCAGCCTGACCAACATGGTGAAACCCCATCTCTACTAATAATAAAAAAATTAGGACCAGGCTTGGTGGCTCATGCCTGTAATTCCAACACTTTGGGAGGCCAAGGCGAGTGGATAACTTGAGGTCAGGAGTTTGAGACCAGCCTGGCCAACATGGTGAAACCTCATCTCTACTAAAAATACAAAAATTAGCCGGCATGGTGGCGGGCACCCGTAATCCCAGCTACTCGGTGTGGGGGCTGGGACAGGAGAATCGCTTGAACCCAGGAGGTGGAGGTTGCCGTGAGCTAAGATTGCGCCACTGCACTCTAGTTGGGGCAACAGAGCGGACTCCGTCTCAAAAAAAAAAAAAAAATTAGCCGAGCGTGGTGGTGGACACCTGTAATCCCAGCTACTCAGGAGGCTGAGGCAGGAAAATTGAAATCGCTTAAACCTGGGAGGAGGAGGTTGCAGTGAGCCAAGATCGCACCATTGCACTCCAGCCTGGGCGACAAGAACAAAACTCCGTCTCCCCACTCCAAAAAAAAAAAAAAAAAAA","GGCTGGGCGCAGTGGCTCACACCTGTAATCCCAGCACTTAGGGAAGCTGAGGCGAGTAGATCACCTGAGGTCAGGAGTTAGAGACCAGCCTGGCCATCATGGTGAAACCCCGTCTCTACTAAAGATACCAAAAATTAGCTGAGTGTGGTGCTGGGTGCCTGTAATCCCAGAAACTCAGGGTGCCTGTAATCCCAGCAACTCAGGGTGCCTTTAATCCCAGCAACTGAGGGTACCAGTAATCCCAGCAACTCAGGGTGTCTTTAATCCTAGCAACTGAGGGCACCTGTAATCCCAGCAACTCAGGAAGCTGAGACAGGAGAAGTACTTGAACCCAGAAGGCAGAGGTTGCAGTGAGCCGATATTGCACCATTGCACTCCAGTCTGGGCAACAAGAGTGAAACTCTGTCTCAAAAAAAAA"
"chr19","11513769","11514351","JH378206","6546474","6546861","242","4967295","TCCCAGCACTTTGGGAGGCCGCGATGGGTGGATCACCTTAGGTCAGGAATTCGAGACCATCCTGGCCAACATGGTGAAACCCCGTCTCTACTAAAAACACAAAAATTAGGCCGGGCACGGTGGCTCACATCTGTAATCCCAGCACTTTGGGAGGCTGAGGTGGGCGGATCACAAGGTCAGGAGTTCAAGACCAGCCTGGCCAACATGGTGAAACCCTGTCTCTACTAAAAATACAAAAATTAACTGGGCATGGTGGCATGTGCCTGTAATCCCAGCTACTTGGGAGGCTGAGGCAGAAGAATTGCTTGAACCAGGGAGTCAGAGGTTATAGTGAGCTGAGATCGTGCGACTGCACTCCAGCCTGGTGACAGAGCGAGACTCCGTTTCAGGAAAAACAAACAAAACACAAAAATTAGCTGGGCATGGTGGCAGGCGCCTGTAATCCTAGCTACTTGGGAGGCTGAGGCAGGAGAATCGCTTGAACCCAGAAGGCAAAGGTTGCAGTGAGCTGAGATGATGCCATTGCACTCCAGCCTGGGCAACAAGTGAAACTCTGTCTCAAGAAAAAAAGTAAAAGAAAGAA","GGCCACACATGGTGGCTAACGCCTGTAATCCCAGCACTTTGGGAGGCCAAGTCGGGTGGATCATGAGGTCAGGAGACCAAGACCATCCTGGCCAAATGGTGAAACCCCGTCTCTACTAAAAATACAAAAATTAGCTGGGCATGGTGGCGTGTGCCTGTAATCCCAGCTACTCAGGAGGCTGAGGCAGGACAATTGCCTGAACCCAGGAGAATTAGCTGGGCATGGTGGCGTGTGCCTGTAATCCCAGCTACTCAGGAGGCTGAGGCAGGACAATTGCCTGAACCCAGGAGGCGAAGGTTGCGGTGAGCCGAGATTGTGCCATTGCACTCCAGCCTGGGTAACAAGAGCGACACTCTGTCTCAAAAAAAAAAAAAAAAAAAAAAAAAAA"
"chr19","11535200","11535780","JH378206","6546474","6546861","242","4988726","TCCCAGCACTTTGGGAGGCCGCGATGGGTGGATCACCTTAGGTCAGGAATTCGAGACCATCCTGGCCAACATGGTGAAACCCCGTCTCTACTAAAAACACAAAAATTAGGCCGGGCACGGTGGCTCACATTGTAATCCCAGCACTTTGGGAGGCTGAGGTGGGCGGATCACAAGGTCAGGAGTTCAAGACCAGCCTGGCCAACATGGTGAAACCCTGTCTCTACTAAAAATACAAAAATTAACTGGGCATGGTGGCATGTGCCTGTAATCCCAGCTACTTGGGAGGCTGAGGCAGAAGAATTGCTTGAACCAGGGAGTCAGAGGTTATAGTGAGCTGAGATCGTGCGACTGCACTCCAGCCTGGTGACAGAGCGAGACTCCGTTTCAGGAAAAACAAACAAAACACAAAAATTAGCTGGCATGGTGGCAGGCGCCTGTAATCCTAGCTACTTGGAGGCTGAGGCAGGAGAATCGCTTGAAACCCAGAAGGCAAAGGTTGCAGTGAGCTGAGATGATGCCATTGCACTCCAGCCTGGGCAACAAGTGAAACTCTGTCTCAAGAAAAAAAGTAAAAGAAAGAA","GGCCACACATGGTGGCTAACGCCTGTAATCCCAGCACTTTGGGAGGCCAAGTCGGGTGGATCATGAGGTCAGGAGACCAAGACCATCCTGGCCAAATGGTGAAACCCCGTCTCTACTAAAAATACAAAAATTAGCTGGGCATGGTGGCGTGTGCCTGTAATCCCAGCTACTCAGGAGGCTGAGGCAGGACAATTGCCTGAACCCAGGAGAATTAGCTGGGCATGGTGGCGTGTGCCTGTAATCCCAGCTACTCAGGAGGCTGAGGCAGGACAATTGCCTGAACCCAGGAGGCGAAGGTTGCGGTGAGCCGAGATTGTGCCATTGCACTCCAGCCTGGGTAACAAGAGCGACACTCTGTCTCAAAAAAAAAAAAAAAAAAAAAAAAAAA"
"chr19","12911527","12912140","JH378118","18053084","18053501","266","5141557","GGCCAGGCATGGTGGCTCATGCCTGTAATCCAGCACTTTGGTAGGCCAAGGTGGGTGGATGGATTACTTGAGGCCAGGAGTTCAAGACCAACCTGGCCAACATGGTGAAAACCCATCTCTATTAAAAATATAAAAGCTAGGCCAGGTGCGGTGGCTCACGCCTGTAATCCCAGCACTTTGGGAGGCTGAGGCGGGCGGATCACGAGGTCAGGAGATCGAGACCACTGTGAAACCCTGTCTCTACTAAAAATACAAAAAAAATTAGCTGGGTGGGGTGGCGGGTGCCTGTAGTCCCAGCTACTTGGGAGGCTGAGGCAGGAGAATGGCGTGAACCCGGGAGGCGGAGCTTGCAGTGAGCCGAGATCGCGCCACTGCACTCCAGCCTGGGCTACAGAGCAAGACTCCGTCTCAAAAAAAAAATAAATAAATAAATAAAAATAAAAACTAACTGGGCATGGTGGTGTGCACCTGTAATCCCAGCTACTCGGGAGGCTGAGACAGGAGAATTGCTTGAACCTGGGAGGTGGAGGTTGCAGTGAACCAAGATGATGCCATTGCACTCCAACCTGGGCAACAAGAGCAAAACTCCGTCTCAAAAAAAAAAAAAAAAAAAA","GGCTGGGCGCAGTGGCTCACACCTGTAATCCCAGCACTTAGGGAAGCTGAGGCGAGTAGATCACCTGAGGTCAGGAGTTAGAGACCAGCCTGGCCATCATGGTGAAACCCCGTCTCTACTAAAGATACCAAAAATTAGCTGAGTGTGGTGCTGGGTGCCTGTAATCCCAGAAACTCAGGGTGCCTGTAATCCCAGCAACTCAGGGTGCCTTTAATCCCAGCAACTGAGGGTACCAGTAATCCCAGCAACTCAGGGTGTCTTTAATCCTAGCAACTGAGGGCACCTGTAATCCCAGCAACTCAGGAAGCTGAGACAGGAGAAGTACTTGAACCCAGAAGGCAGAGGTTGCAGTGAGCCGATATTGCACCATTGCACTCCAGTCTGGGCAACAAGAGTGAAACTCTGTCTCAAAAAAAAA"
"chr19","13205284","13205895","JH378118","18053084","18053501","258","4847800","GCCAGGCGCAGTGGATTACGCCTGTAATCCCAGCGCTTTGGTATACCGAGGCGGGCAGATCGTCTGAGGTCAGGAGTTCAAGACCAGCCTGGAGAACATGGTGAAACCCCGTCTCTATTAAAAATACAGGCTGGGCGCGGTGGCTTACGCCTGTAATCTCAGCACTTTGGGAGGCCAAGGCGGGTGGATCACGAGGTCAGGAGATCGAGACCATCCTGGCTAACATGGTGAAACCCTGTCTCTACTGAAAATACAAAAAAATTAGTTGTGGTGGGTGCCTGTAATCCCAGCTACTCGGGAGGCTGAGGCAGGAGAATGGCGTGAACCCGGGAAGCAGAGATTGCAGTAAGCCAAGATCGCTCCACTGCACTCCAGCCTGGGCTACAGAGCAAGACTCCATCTCAAAAAAAAATAAATAAATAAAATAAAAAATTAGCCTGGCGTGGTGGCGCATGCCTGTAATCCCAGCTACTTGGGAGGCTGAGGCAGGAGAATTGCTTGAACCCAAGAGGTGGAGGTTGCAGTGAGTCGAGATTGAGCCATTGCCATCCAGCCTGGGCAACAAGAGTGAAACTCTGTCTCAAAAAAAAAGAGAGAGAAAAGAAAGTAAAA","GGCTGGGCGCAGTGGCTCACACCTGTAATCCCAGCACTTAGGGAAGCTGAGGCGAGTAGATCACCTGAGGTCAGGAGTTAGAGACCAGCCTGGCCATCATGGTGAAACCCCGTCTCTACTAAAGATACCAAAAATTAGCTGAGTGTGGTGCTGGGTGCCTGTAATCCCAGAAACTCAGGGTGCCTGTAATCCCAGCAACTCAGGGTGCCTTTAATCCCAGCAACTGAGGGTACCAGTAATCCCAGCAACTCAGGGTGTCTTTAATCCTAGCAACTGAGGGCACCTGTAATCCCAGCAACTCAGGAAGCTGAGACAGGAGAAGTACTTGAACCCAGAAGGCAGAGGTTGCAGTGAGCCGATATTGCACCATTGCACTCCAGTCTGGGCAACAAGAGTGAAACTCTGTCTCAAAAAAAAA"
"chr19","14119695","14120238","JH378206","6546474","6546861","206","7573221","ACCAGCCTGGCCAAAATGGTGAAACCCTGTCTCTACTAAAAATATTTAAAAATTGGCCAGGTGCGGTGGCTCACGCCTGTAATCCCAGCACTTTGGGAGGCCGAGGCGGGCGGATTACAAGGTCAGGAGATCGAGACCATCCTGACTAACATGGTGAAACCCCGTCTCTACTAAAAATACAAAAAATTGGCCGGGCGTGGTAGCGGGCGCCTGTAGTTCCAGCTACTCGGGAGGCTGAGGCAGGAGAATGGCGTGAACCCGGAAGGCAGAGCTTGCAGTGAGCCAAGATCGTGCCACTGCACTCCAGCCTGAGCGACAGAGCAAGACTCCATCTCAAAAAAAAAAAAAAAAAAAAAAAAAATTAAAAAATTAGCTGGGCGTGGTAGCCGGCACCTGTAATTCCAGCTACTCAGGAGGCTGGAGCACAAGAATCGCTTGAAACCAGGAGGCAGAGTTGTAGTGAGCCGAGATCGTGCCATTGCACTCCAGCCTGGGCATCAAGAGCGAAACTCCATCTCAAAAACAAAACAAAACAAAACAAAAA","GGCCACACATGGTGGCTAACGCCTGTAATCCCAGCACTTTGGGAGGCCAAGTCGGGTGGATCATGAGGTCAGGAGACCAAGACCATCCTGGCCAAATGGTGAAACCCCGTCTCTACTAAAAATACAAAAATTAGCTGGGCATGGTGGCGTGTGCCTGTAATCCCAGCTACTCAGGAGGCTGAGGCAGGACAATTGCCTGAACCCAGGAGAATTAGCTGGGCATGGTGGCGTGTGCCTGTAATCCCAGCTACTCAGGAGGCTGAGGCAGGACAATTGCCTGAACCCAGGAGGCGAAGGTTGCGGTGAGCCGAGATTGTGCCATTGCACTCCAGCCTGGGTAACAAGAGCGACACTCTGTCTCAAAAAAAAAAAAAAAAAAAAAAAAAAA"
"chr14","584088","584429","JH378109","21565230","21565567","54","20981142","GGCCGGGTACGGTGGCTCACGCCTGTAGTCCTGGCACTTTGGGAGGCCGAGGCAGGTGGATCCCCGAGGTCACGAGTTTGAGACCAGCCTGGCCAGCATGGTGAAATCCCATCTCTACTAAAAATACAAAACTTAGCCGGGCATGGTGACGTGTGCCTGTAATCCCAGCTACTTGGGAGGCTGAGGCAGGAGAATTGCTTGAACCAGGGAGGCAGAGGTTGCAGTGAGCTGAGATCATGAAACTGCAGTCCAGTCTAGGCGACAAGAGCAAAACTCCGTCTCAAAAAAATAAATAAATAAATAAATAAATAAAAAATAAAACAAACAACAAAAAAAACAAAA","GGCCGGGCGCGGTGGCTCAAGCCTGTAATACCAGCACTTTGGGAGGCCGAGGCGGGTGGATCACGAGGTCAAGAGATCGAGACCATCCTGGTCAACATGGTGAAACCCCGTCTCTACTAAAAATACAAACAATTAGCTGGGCATGGTGGCGGGTGCCTGTAATCCCAGCTACTCCAGAGGCTGAGGCAGGAGAATTGCCTGAACCCAGGAGACGGAGGTTGCGGTGAGCCAAGATCGCGCCATTGCACTCCAGCCTGGGTGACAAGAGCGAAACTCCGTCTCAATAAATAAATAAATAAATAAATAAATAAAAATAAAATAAATAAATAAATAAATAA"
"chr14","620575","620915","JH378109","21565230","21565567","56","20944655","GGCCGGGTACGGTGGCTCACGCCTGTAGTCCTGGCACTTTGGGAGGCCGAGGCAGGTGGATCCCCGAGGTCACGAGTTTGAGACCAGCCTGGCCAGCATGGTGAAATCCCATCTCTACTAAAAATACAAAACTTAGCCGGGCATGGTGACGTGTGCCTGTAATCCAGCTAACTTGGGAGGCTGAGGCAGGAGAATTGCTTGAACCAGGGAGGCAGAGGTTGCAGTGAGCTGAGATCATGAAACTGCAGTCCAGTCTAGGCGACAAGAGCAAAACTCCGTCTCAAAAAATAAATAAATAAATAAATAAATAAAAAATAAAACAAACAACAAACAAAACAAAA","GGCCGGGCGCGGTGGCTCAAGCCTGTAATACCAGCACTTTGGGAGGCCGAGGCGGGTGGATCACGAGGTCAAGAGATCGAGACCATCCTGGTCAACATGGTGAAACCCCGTCTCTACTAAAAATACAAACAATTAGCTGGGCATGGTGGCGGGTGCCTGTAATCCCAGCTACTCCAGAGGCTGAGGCAGGAGAATTGCCTGAACCCAGGAGACGGAGGTTGCGGTGAGCCAAGATCGCGCCATTGCACTCCAGCCTGGGTGACAAGAGCGAAACTCCGTCTCAATAAATAAATAAATAAATAAATAAATAAAAATAAAATAAATAAATAAATAAATAA"
"chr14","1107083","1107723","JH378118","18053084","18053501","303","16946001","GGCGTGGTGGCTCACACCTGTAATCCCAGCACTTCAGGAGGCCAAGGCAGGTAGATTGCTTGATCACAGGAGTTCAAACCAGCCATGGGCAATGTCAGGCCTCTGAGCCCAAGCTTGCACGTATCCAGATGGCCTGAAGCAACTGAAGAATCACAAAAGAAGTGAAAACAGCCAGTTCCTTCCTTAACTGATGACATTACCTTGTGAAATTCCTTCTCCTGGCTCAGAAGCTCCCCTACTGAGCACCTTGTGACCCCTGCCCCTGCCAGCCAGAGAACAATCCCCTTTGACTGTAATTTTCCACTACCTACCCAAATCCTATAAAACAGCCCCACCCCATCTCCCTTTGCTGACTCCTTTTTCGGACTAGGTCCGCCTGCACCCAGGTGATTAAAAAGCTTTATTGCTCACACAAAGCCTGTTGGTGGTCTCTTCACACGGACGCACGTGACAGGCAACATGGTGAAACCCTATCTCTATAAAAAAATAAAAATAAAAATTAGTTGGGCGTGGAGACTGAGGTGAGAGAATCCAGAGGATCCAAGAGGATCGAGTCAAGGAGGTGGAGGCCGCAGTGAGCCGAGATCGCACCGCTGCACTCCAGCCTGGGCGACAAGAGTGAAACTCTGTCTTAAAAAAAA","GGCTGGGCGCAGTGGCTCACACCTGTAATCCCAGCACTTAGGGAAGCTGAGGCGAGTAGATCACCTGAGGTCAGGAGTTAGAGACCAGCCTGGCCATCATGGTGAAACCCCGTCTCTACTAAAGATACCAAAAATTAGCTGAGTGTGGTGCTGGGTGCCTGTAATCCCAGAAACTCAGGGTGCCTGTAATCCCAGCAACTCAGGGTGCCTTTAATCCCAGCAACTGAGGGTACCAGTAATCCCAGCAACTCAGGGTGTCTTTAATCCTAGCAACTGAGGGCACCTGTAATCCCAGCAACTCAGGAAGCTGAGACAGGAGAAGTACTTGAACCCAGAAGGCAGAGGTTGCAGTGAGCCGATATTGCACCATTGCACTCCAGTCTGGGCAACAAGAGTGAAACTCTGTCTCAAAAAAAAA"
"chr14","1362660","1363231","JH378118","18053084","18053501","229","16690424","GGCTGGGCACAGTGGCTTATACCCATAATCTCAGCAGTTTGGGAGGCCAAGGCAGGTGTATCACCTGAGGTCAGGAGTTCGAGAAACACCATGGCCAACATGGTGAAACCCCATCTCTACTAAAAATACAAAAAGTAGGCTGGGCGTGGTGGCTCACGCCTGTAATCCCAGTACTTTGGGAGGCCGAGGCGGGCGGATCACAAGGTCAGGAAACCGAGACCATCCTGACTAACATGGTGAAACCCCGTCTCTACTAAAAATACAAAAAAAGCTAGCCGGGCATGGTGGCGGGTGCCTGTAGTCCCAGCTACTCGGGAGGCTGAGGCAGGAGAATGGCGTGACCCCAGGAGGCAGAGCTTCCAGCTTGGGTGACTCCGTCTCAAAAAAAAAAAAACAAAAACAAAAAGTAGCTGGACGTGGTGGCTGTAGACCTAGCTACTCGAGAGGCTGAGGCAGGAGAATCGCTTGAACCTAGGAGGCGGAGGTTGCGGTGAGCCGAGATCACGCTTCTGCACTCCAGCCTGGGTGACAAGAGCAAAACTCCATCTCCAAAAAAAAAAAACAAAAAAAAA","GGCTGGGCGCAGTGGCTCACACCTGTAATCCCAGCACTTAGGGAAGCTGAGGCGAGTAGATCACCTGAGGTCAGGAGTTAGAGACCAGCCTGGCCATCATGGTGAAACCCCGTCTCTACTAAAGATACCAAAAATTAGCTGAGTGTGGTGCTGGGTGCCTGTAATCCCAGAAACTCAGGGTGCCTGTAATCCCAGCAACTCAGGGTGCCTTTAATCCCAGCAACTGAGGGTACCAGTAATCCCAGCAACTCAGGGTGTCTTTAATCCTAGCAACTGAGGGCACCTGTAATCCCAGCAACTCAGGAAGCTGAGACAGGAGAAGTACTTGAACCCAGAAGGCAGAGGTTGCAGTGAGCCGATATTGCACCATTGCACTCCAGTCTGGGCAACAAGAGTGAAACTCTGTCTCAAAAAAAAA"
"chr14","2088506","2089110","JH378118","18053084","18053501","257","15964578","GGCTGGGCACTGCGGCTCACACCTGTAATCCCAGCATTTTGAGAGGCCTAGGTGGGTGGATCACCTGAGATCAGTTCAAGACCAGCCTGACCAACATGGCAAAACCCCATCTCTATTAAAAACACAAAAAACGCCCAGGAGCGGTGGCTCACACCTGTAATCCCGGCACTTTGGGAGGCTGAGGCAGGCGGATCACGAGGTCAGGAGATCGAGACCATGCTGGCTAACACGGTGAAACCCCGTCTCTACTAAAAATACAAAAAATTAGCCAGGCGTGGTGTCGGGCGCCTGTAGTCCCAGCTATTCGGGAGGCTGAGACAGGAGAATGGCATGAACCCGGGAGGCAGAGCTTGCAGTGAGCTGAGATCGCGCCACTGCACTCCAGCCTGGGCGACAGAGTAAGACTCTGTCTCAAAAAAAAAAATACAAAAAATACAAAAAACATTAGCCACATGTGGTGGTGGGTGCCTGTAATCCCAGCTACTCAGGAGGCTGAGGCTGGAGAATTGCTTGAACCCAGGAGGTGGAGGTTGTGGTGAGCCAAGATCACGCCATTGCATTCCAGCCTGGGTGACAAGAGTGAACCTCTGTCTCAAAAAAAAGAA","GGCTGGGCGCAGTGGCTCACACCTGTAATCCCAGCACTTAGGGAAGCTGAGGCGAGTAGATCACCTGAGGTCAGGAGTTAGAGACCAGCCTGGCCATCATGGTGAAACCCCGTCTCTACTAAAGATACCAAAAATTAGCTGAGTGTGGTGCTGGGTGCCTGTAATCCCAGAAACTCAGGGTGCCTGTAATCCCAGCAACTCAGGGTGCCTTTAATCCCAGCAACTGAGGGTACCAGTAATCCCAGCAACTCAGGGTGTCTTTAATCCTAGCAACTGAGGGCACCTGTAATCCCAGCAACTCAGGAAGCTGAGACAGGAGAAGTACTTGAACCCAGAAGGCAGAGGTTGCAGTGAGCCGATATTGCACCATTGCACTCCAGTCTGGGCAACAAGAGTGAAACTCTGTCTCAAAAAAAAA"
"chr14","2164771","2165383","JH378118","18053084","18053501","243","15888313","GGCTGGGCGCAGTGGCTCACACCTGTAATCCCAGCACTCTGGGAGGCCAAGGCAGGTGGATCACCTGAGGTCAGGAGTTCGAGACCAGCCTGGCCAACATGGTGAAACCCCATCTTTACTAAAAATACAAAAATTAGCTAGGCGTGAGGCCGGGCGTGGCGGCTCATGCCTGTAATCCCAGCACTATGGGAGGCTGAGGCAGGCTGATCATGAGGTCAGGAGATTGAGACCTGGCTAACACAGTGAAACCCCGTCTCTACTAAAAATACAAAAAAAAAATAGCCAGGCATGATGGCAGGCTCCTGTAGTCCCAGCTTCTTGGGAGGCTGAGGCAGGAGAATGGTGTGAACCCGGGAGGCAGAGCTTGCAGTGAGCCGAGATCATGCCACTGCACTCCAGCCTGGGTGACAGAGCAAGACTCTGTCTCAAAAAAAAAAAAAAAAAATTAGCTAGGCGTGGTGAGGGGCACCTGGAATCCCAGCTACTCAGGAGGCTGAGGCAGGAGCATCGTTTAAACCCAGGAGGCAGAGGTTGCAGTGAGCCGAAATCACACCATTGCACTCCAGCCTGGGCAACAAGAGCAAGTCTCCATCTTAAAAAAAAAAAAAAAAAA","GGCTGGGCGCAGTGGCTCACACCTGTAATCCCAGCACTTAGGGAAGCTGAGGCGAGTAGATCACCTGAGGTCAGGAGTTAGAGACCAGCCTGGCCATCATGGTGAAACCCCGTCTCTACTAAAGATACCAAAAATTAGCTGAGTGTGGTGCTGGGTGCCTGTAATCCCAGAAACTCAGGGTGCCTGTAATCCCAGCAACTCAGGGTGCCTTTAATCCCAGCAACTGAGGGTACCAGTAATCCCAGCAACTCAGGGTGTCTTTAATCCTAGCAACTGAGGGCACCTGTAATCCCAGCAACTCAGGAAGCTGAGACAGGAGAAGTACTTGAACCCAGAAGGCAGAGGTTGCAGTGAGCCGATATTGCACCATTGCACTCCAGTCTGGGCAACAAGAGTGAAACTCTGTCTCAAAAAAAAA"
"chr14","3757666","3758004","JH378113","23438980","23439304","67","19681314","CTGGGCATGGTGGCTCATGCCTGTAATCCCAGCACTTTGGGAGACAGAGGAGGGCAGATCATCTGAGGTCAGGAGTTTGAGACCAGCCTGGCCACCATGGTGAAACCCCCGTCTCTACTGAAAATACAAAAAAATTCAGCTGGGTGTGGTAGTGGATGTCTGTAATCCTAGCTGCTTGGGAGGCTGAGACAGGAGAATCGCTTGAACCCGGGAGGTGGAGGTTGCAGTGAGCCGCCATTGCGCTCCAGCCTGGGCAACAAGAGCGAAACTCCATCTCAAAAATTAATTAATTAATTAATTAATTAAAAGTGGACTAAAGCAAAGACAAGAGAAAAAAGA","GGCAGGGTGTGGTAGCTCATGCTTGTAATCCCAGCACTTTGGGAAGTGGAGGCGGGCAGATCATCTGAGGTCAGGAGTTTGAGGCCAGCCTGGCCAACATGGTGAAACCCTGTCTCTACTAAAAATACAAAAAATTAACTGGGCGTGGTGGTGGACACCTGTAATCCCAGCTGCTTGGGAGGCTGAGGCAGGAGAATCGCTTGAACCCAGGAGATGGAGGTTGCAGTGAGCCAAGATGGCACCATTGCACTCTAGCCTGGGCAAAAAGAGTGAAACTCCGTCTCAAAAAAAAAAAAGAAAAGAAAAGAAAAGAAAAGAAAAGAAA"
"chr14","10702105","10702681","JH378118","18053084","18053501","246","7350979","GGCCAGGCGCAATGGCTCACACCTGTAATCCAAGCACTTTGGGAGGCCAGTTCAAGACCAGCCTGGCCAACATGGTGAAAACCTGTCTCTGCTAAAAATGCCAAATTTCCCAGCACTTTGGGAGGCTGAGGCGGGTGGATCACGAGGTCAGGAGATTGAGACCATCCCGGCTAACACGGTGAAACCCCATCTCTACTAAAAATAGAAAAAAATTAGCCGGGCGTGGTGGCAGACGCCTGTAGTCCCAGCTACTCTGGAGGCTGAGGGAAGAGAATGGCATAAACCCGGGAGGCGGAGCTTGCAGCGAGCTGAGATTGCGCCACTGCACTCCAGCCTGGGCGACAGAGCAAGACTCCGTCTCAAAATAAATAAATAAATAAAATTAAAATTAAAAATAAAATACAAAATTTAGCCGAGCATGGTGGTGAGCACCTATAATCCCAGCTACTTGGGAGGCTGAGGCAGAAGAATCTCTTGAACCAGGGAAGTGGAGGTTGCAGTGGGCTGAGATCCAGCCACTGTACTCCAGCCTGGGCGACAAAAGCGAAACACTGTCTAAAAAAATAAAAAATAAAAA","GGCTGGGCGCAGTGGCTCACACCTGTAATCCCAGCACTTAGGGAAGCTGAGGCGAGTAGATCACCTGAGGTCAGGAGTTAGAGACCAGCCTGGCCATCATGGTGAAACCCCGTCTCTACTAAAGATACCAAAAATTAGCTGAGTGTGGTGCTGGGTGCCTGTAATCCCAGAAACTCAGGGTGCCTGTAATCCCAGCAACTCAGGGTGCCTTTAATCCCAGCAACTGAGGGTACCAGTAATCCCAGCAACTCAGGGTGTCTTTAATCCTAGCAACTGAGGGCACCTGTAATCCCAGCAACTCAGGAAGCTGAGACAGGAGAAGTACTTGAACCCAGAAGGCAGAGGTTGCAGTGAGCCGATATTGCACCATTGCACTCCAGTCTGGGCAACAAGAGTGAAACTCTGTCTCAAAAAAAAA"
"chr14","11790883","11791455","JH378118","18053084","18053501","226","6262201","GGCTGGGTGGCCATGGCTCATGCCTGTAATCCTAGAACTTTGGGAGGCTGCGGCAGGCAAATCACCTGAAGTCAGGAGTTCAAGACCAGCCTGGCCAACATACTGAAACCCCGTCTCTCCAGGCCTGGTGGCTCATGCCTGTAATCCCAGCACTTTGGAAAGCCGAGGTGGGCGGATCACCTGAGGTCAGGAGTTCAAGACCAGTCTGACCAACATGGGGAAACCCCATCTCTACTAAAAATACAAAATTAGCTGGATGTGGTGGCACATGCCTGTATTCCCAGCTACTTGGGAGGCTGAGGCAGGAGAATCGCTTGATCCCGAGAGGTGGAGCTTGCCGTGAGCTGAGATTGTGCGCCATTGCACTCCAGCCTGGGCAACAAGAGTGAAACTCCGTCTCTACTAAAAATACAAAAATTAGCCGGGTGTGGTGGCGGGTGCCTGTAATCCAAGCTACTCGGGAGGCTAAGGCAGGAGAATTGCTTGAACCCACGAGGCCGAGGTTGCAGTGAGCCGAGATTGCACTATTGCACTCCAGCCTGGGCGACAAGAGTGAGACTGTGTCTCAAAAAA","GGCTGGGCGCAGTGGCTCACACCTGTAATCCCAGCACTTAGGGAAGCTGAGGCGAGTAGATCACCTGAGGTCAGGAGTTAGAGACCAGCCTGGCCATCATGGTGAAACCCCGTCTCTACTAAAGATACCAAAAATTAGCTGAGTGTGGTGCTGGGTGCCTGTAATCCCAGAAACTCAGGGTGCCTGTAATCCCAGCAACTCAGGGTGCCTTTAATCCCAGCAACTGAGGGTACCAGTAATCCCAGCAACTCAGGGTGTCTTTAATCCTAGCAACTGAGGGCACCTGTAATCCCAGCAACTCAGGAAGCTGAGACAGGAGAAGTACTTGAACCCAGAAGGCAGAGGTTGCAGTGAGCCGATATTGCACCATTGCACTCCAGTCTGGGCAACAAGAGTGAAACTCTGTCTCAAAAAAAAA"
"chr14","12236526","12237360","JH378118","18053084","18053501","465","5816558","GGCTGGGTGGGGTGGCTCACGCGTGTAATCCCAACACTTTTGAGGCTGAGGTGGGTGGATCACTTGAGGTCCGGAGTTTGAGACCAGCCTGGTCAACATGGTGAAACCCCATGTCTCAGGATGGGGAACATCACATACCGGGGCCTGTCGTGGGGTGTGGGGAGGGGAAGGGATAGCATTAGGAGATATACCTAATGTAAATGACAAGTTAATGGGTGCAGCACACCAACATGGCACATGTATACATATGTAACAAACCTGCATGTTGTGCACATGTACCCTAGAACTTAAAGTATAGCAATAAAAAAAAAAAAAGAAACCCCGTGTCTACAAAAAAAATACAAAATTAGGCCAGGCGCAGTGGCACATACCTGTAATCCCAGCACTTTGGGAGGCCAAGGTGGGCAGATCACGAGGTCAGGAGTTTGAGACCAGCCTGTCCAAAATGGTGAAACCCCATCTCTACTAAAAAAATACAAAAATTAGCCAGGCATGGTGGCCCGTGCCTGCAATCCCAGCTACTCAGGAGGCTAAGGCAGGAGAATCACTTGAACGTGGGAGGCGGAGGTTGCAGTGAGCCGAGATCACACCATTGCACTCCAGCCTAGGCAACAGAGCGAGACTCTGTCTCAAAAAAACAAAAAGCAAAAAAACCCAAATTAGCCAGGCATGGTGGTAGTCACCTGTAATCCCAGCTACTTGGGAGGCTTAGGCAGGAGAATCGCTTGAACCCCAGAGGCAGAGGTTGCAGTAAGCCAAGATCGCACCAAGATCACTCCAGCCTGGGCGACAGTGAAACTGTGTCTCAAAAGAAAAAGAAAAAAAAGAAAGAAAA","GGCTGGGCGCAGTGGCTCACACCTGTAATCCCAGCACTTAGGGAAGCTGAGGCGAGTAGATCACCTGAGGTCAGGAGTTAGAGACCAGCCTGGCCATCATGGTGAAACCCCGTCTCTACTAAAGATACCAAAAATTAGCTGAGTGTGGTGCTGGGTGCCTGTAATCCCAGAAACTCAGGGTGCCTGTAATCCCAGCAACTCAGGGTGCCTTTAATCCCAGCAACTGAGGGTACCAGTAATCCCAGCAACTCAGGGTGTCTTTAATCCTAGCAACTGAGGGCACCTGTAATCCCAGCAACTCAGGAAGCTGAGACAGGAGAAGTACTTGAACCCAGAAGGCAGAGGTTGCAGTGAGCCGATATTGCACCATTGCACTCCAGTCTGGGCAACAAGAGTGAAACTCTGTCTCAAAAAAAAA"
"chr14","12551961","12552292","JH378124","27069096","27069413","54","14517135","GGCCAGGCGCGGTGGCTCACGCCTGTAATCCCAGCACTCTGGGAGGCCAAGGCGGACGGATCATCCGAGGTCAGGAGTTTGAGACCAGCCTGGCCAACATGGTGAAACCCCATCTCTACTAAAAATATATATATATATGTATATATATATATATATTAGCCAGGTGTAGTGGTGGGCATCTGTAATCCCAGCTACTCGGGAGGCTGAGGCAGGAGAATTGCTTGAACCCAGGAGGCGGAGGTTGCAGTGAGCTGAGATTGCACCACTGCACTCCAGCCTGGGTGATAAGAATGAGACTCCATCTCAAAACAAACAAACAAACAAATAAAAAA","GGCCGGGCACGGTGGCTCATGCCTGTAATCCCAGCACTTTGGGAGGCCGAGGCGGGTGGATCATGAGGTCAAGAGATCGAGACCATCCTAGTCAACATGGTGAAACTCCATCTCTACTAAAAATACAAAAAAAAAAAAAAATTAGCTGAGCATGGTGGTGCATGCTTGTAATTCCAGCTACTCAGGAGGCTGAGGCAGGAGAATTGCCTGAACCCAGGAGGCGGAGGTTGCAGTGAGCCGAGATTGCGCCATTGCACTCCAGCCTGGGTAATAAGAGTGAAACTCCGTCTCAAAAAAAAAAAACAAAAAAACAAAAAA"
"chr14","15131045","15131391","JH378121","20921542","20921875","62","5790497","GGCTGGGCCCGGTGACTCATGCCTGTAATCCCAGCACTTCGGGAGGACAAGGCGGGTGGATCACCTGAGGTCAGGAGTTCGAGACCAGCCTGGCCAACATGGCGAAACCCCGTCTCTACTGAAAATACAAAAATTAGCCAGGCATGGTGGTGGGCGCCTGTAATCCCAGCTACTCAGAGGCTGAGACAGGAGAATCACTTGAACCTGGGGTGGGGGCGGGGGCGGGGGCGGGGGCGGGGTGGGAGTGGAGGTTGCAGACAGTGAGTGGTGATGGCGCCAGTTCACTCCAGCCTGGGCGAAAGAGTGAAACTCCATCTCAGAAAAAAAAAAAAAAAAAAAAAGTAAAA","GGCTGGGTACGGTGGCTCATGCTGTAATCCCAGCACTTTGGGAGGTCAAAGCAGGCGGATCACCTGAGGTCAGGAGTTTGAGACCAGCCTTGCTAACATGGTGAAACCCCGTTTCTACTAAAAATAAAAAAATTAGCCAGGCGTGGTGGTGTGCACCTGTAATCCCAGCTACTTGGGAGGCTGAAGCAGGAGAGTTGCTTGAACCGGGGTGGTGGGGGGGCAGGGGCAGGGGTGGGTGGCAGGCAGAGGTTGCAGTGAGCCGAGATGGTGCCATTGCACTCCAGCCTGGGCAACAAGAGCAAAACTCCGTCTCAAAAAGAAAAAAAAAAAAGAA"
"chr14","15292066","15292693","JH378118","18053084","18053501","267","2761018","GGCCGGAGACGGTGGCTCACACCTGTAATCCCAGCACTTTGGGAGGCTGAGGCAGGCAGATCACCTGAAGTCAGGAGTTTGAGACCAGCCTGGCCAACATGGTATAAACCCCATCTCTACTAAAAATACAAAAATTAGGCTGGGCGCGGTGGCTCACGCCTGTAATCCCAACACTTTGGGAGGCCGAGGTGGGTGGATCACCTGAGGTCGGGAGTTTGAGACCAGCCTGACCAACATGAAGAAACCCTGTCTCTACTAAAAAAAAAAAAAAATACAAAATTAGCCGGGCATCATGGCACAAGCCTGTAATCCCAGCTACTCAGGAGTCTGAGGCAGGAGAATCGCTTGAACCTGGGAGGCGAAGGTTGCAGTGAGCTGAGATCGTGCCATTGCACTCCAGCCTGGGCAACAAGAGCGAAACTCCTTCTCTAAATAAATAAATAAAAATACAAAAATTTAGCCGGGCATGGTGGCGGGCACCTGTAATCCTAGCTACTTGAGAGGCTGAGGCAGGAGAATCGCTTGAACCCGGGAGGCGGAGGTTGCAGTAAGCAGAGATTGTGCCATTGCACTCCATCCTGGGCAACAAGAGTGAAACTCCATCTCAAAAAAAAAAAAAAAAAAAAAA","GGCTGGGCGCAGTGGCTCACACCTGTAATCCCAGCACTTAGGGAAGCTGAGGCGAGTAGATCACCTGAGGTCAGGAGTTAGAGACCAGCCTGGCCATCATGGTGAAACCCCGTCTCTACTAAAGATACCAAAAATTAGCTGAGTGTGGTGCTGGGTGCCTGTAATCCCAGAAACTCAGGGTGCCTGTAATCCCAGCAACTCAGGGTGCCTTTAATCCCAGCAACTGAGGGTACCAGTAATCCCAGCAACTCAGGGTGTCTTTAATCCTAGCAACTGAGGGCACCTGTAATCCCAGCAACTCAGGAAGCTGAGACAGGAGAAGTACTTGAACCCAGAAGGCAGAGGTTGCAGTGAGCCGATATTGCACCATTGCACTCCAGTCTGGGCAACAAGAGTGAAACTCTGTCTCAAAAAAAAA"
"chr14","15354689","15355313","JH378118","18053084","18053501","269","2698395","GGACGGGCGCAGTAGCTCACACCTGTAATCCTAGCAGTTTGGGAGGCCAAGGTGGGTGGATCACCTGACGTCAGGAGATCGAGACCAGCCTGGACAACATGGCGAAACCCTGTCTCTACTAAAAATACAAAATTAGGGCCAGGTGCGGTGGCTCACGCCTGTAATCCCAGCACTTTGGGAGACTGAGGCGGGCAGATCACCTGAGGTCAGGAGTTCGAGACCAGCCTGGCCAACATGGTGAAACCGCCTCTCTACTAAAAATATAAAAATTGGCTGGGCATTGTAGCAGCCACCTGTAATCCCAGCTACTTGGGGGCCCGAGGCAGAAAAACTGCTTGAACCCAGGAGGCAGAGGTTGTAGTGAGCCGAAATCATGCCACTGCACTCCAGCCTGGGTGACGAGAGTGAGACTCCGTTTCAAAGAAAAAGAAAAAAAATAAAATAAAACACAAAATTAGCCAGTCATGGTGGCAGGCACCTATAATCCCAGCTACCTGGGAGGCTAAGGCAGGAGAATCACTTGAACCCAGGAGGTAGAGGGTGTGGTGAGCCGAGATCACGCCATTGCACTCTAGCCTGGGCAACAAGAGCAAAACTCTGTCTCAAAACAAAAAGTTAAAAAAAA","GGCTGGGCGCAGTGGCTCACACCTGTAATCCCAGCACTTAGGGAAGCTGAGGCGAGTAGATCACCTGAGGTCAGGAGTTAGAGACCAGCCTGGCCATCATGGTGAAACCCCGTCTCTACTAAAGATACCAAAAATTAGCTGAGTGTGGTGCTGGGTGCCTGTAATCCCAGAAACTCAGGGTGCCTGTAATCCCAGCAACTCAGGGTGCCTTTAATCCCAGCAACTGAGGGTACCAGTAATCCCAGCAACTCAGGGTGTCTTTAATCCTAGCAACTGAGGGCACCTGTAATCCCAGCAACTCAGGAAGCTGAGACAGGAGAAGTACTTGAACCCAGAAGGCAGAGGTTGCAGTGAGCCGATATTGCACCATTGCACTCCAGTCTGGGCAACAAGAGTGAAACTCTGTCTCAAAAAAAAA"
"chr14","15366797","15367405","JH378129","11955248","11955630","263","3411549","GGTTGGGTGCGGTGGCTTACCCCTGTAATCCCAGCACTTTGGGGGTACAAAGTGGGAAGATTGCTTGAGCCCAGGAGTTCAAGACCAGCCTGGGCAACTAAGCGAGATCCTATCTCTCAAAAAAATTTTGAAACAACTTTTTGGCCGGGCGCAGTGGCTCACGCCTGTGATCCCAGCACTTTGGGAGGCCAGGGCGGGCGGATCACGAGGTCAGGAGATCAAGACCATCCTGGCTAACACGGTGAAACCCCGTCTCTACTAAAAATACAAAAAATTAGCCGGGTGCGGTGGCGGGCACCTGTAGTCCCAGCTACTCGGGAGGCTGAGGCAGGAGGATGGCGTGAACCCGGGAGGTGGAGCTTGCAGTGAGCTGAGATCGGGCCACTGCACTCCAACCTGGACGACAGATCGAGACTCCGGCTCAAAAAAAAAAAATTAGCTGGGCGTGGTGGCGGGTGCGTGTAATCCCAGCTACTCGGGAGGCTGAGGCAGGAGAATCACTTGAACCTGGGAGGCAGAGGCTGCAGTGAGCCAAGATCGCGCCATTGCACTCCAGCCTGGGCAACAAGAGCGAAACTCTGTCTCTAAATAATAAAATAAAATAAAAAA","GGCTGGGTACGGTGGCTCATGCCTGTAATCCCAGCACTTTGGGAGGTGGGTCACTTGAGGTCAGGAGTTCGAGACCAGCCTGTGCAGTGCCTCCATCCTCAACTGCTGCCTCATCAGCCTGGACCACTACCTGCTCATCCTCTCACCACTGCCACAAGCTGCGCATGAAGCTCCTGCGCGCGCCGGTGCCCGTCTCTACTAAAAATACAAAAATTAGCTGGGTGTGGTGGCAGGTGCCTGTAATCCCAGCTACTCAGGAGGCTGAGGCAGGAGAATCACTTGAACCCAGGAGGCAGAGGTTGCAGTGAGCCGATATCGCATCATTGCACTCCAGCCTGAGCAACAAGAGTGAAATTTTGTCTCAAAAAAAAAAAAAAAAGAAA"
"chr14","15379094","15379705","JH378129","11955248","11955630","265","3423846","GGTTGGGTGCGGTGGCTTACCCCTGTAATCCCAGCACTTTGGGGGTACAAAGTGGGAAGATTGCTTGAGCCCAGGAGTTCAAGACCAGCCTGGGCAACTAAGCGAGATCCTATCTCTCAAAAAAATTTTGAAACAACTTTTTGGCCGGGCGCAGTGGCTCACGCCTGTGATCCCAGCACTTTGGGAGGCCAGGGCGGGCGGATCACGAGGTCAGGAGATCAAGACCATCCTGGCTAACACGGTGAAACCCCGTCTCTACTAAAAATACAAAAAATTAGCCGGGTGCGGTGGCGGGCACCTGTAGTCCCAGCTACTCGGGAGGCTGAGGCAGGAGGATGGCGTGAACCCGGGAGGTGGAGCTTGCAGTGAGCTGAGATCGGGCCACTGCACTCCAACCTGGACGACAGATCGAGACTCCGGCTCAAAAAAAAAAAAAATTAGCTGGGCGTGGTGGCGGGTGCGTGTAATCCCAGCTACTCGGGAGGCTGAGGCAGGAGAATCACTTGAACCTGGGAGGCAGAGGCTGCAGTGAGCCAAGATCGCGCCATTGCACTCCAGCCTGGGCAACAAGAGCGAAACTCTGTCTCTAAATAAATAAAATAAAATAAAAAA","GGCTGGGTACGGTGGCTCATGCCTGTAATCCCAGCACTTTGGGAGGTGGGTCACTTGAGGTCAGGAGTTCGAGACCAGCCTGTGCAGTGCCTCCATCCTCAACTGCTGCCTCATCAGCCTGGACCACTACCTGCTCATCCTCTCACCACTGCCACAAGCTGCGCATGAAGCTCCTGCGCGCGCCGGTGCCCGTCTCTACTAAAAATACAAAAATTAGCTGGGTGTGGTGGCAGGTGCCTGTAATCCCAGCTACTCAGGAGGCTGAGGCAGGAGAATCACTTGAACCCAGGAGGCAGAGGTTGCAGTGAGCCGATATCGCATCATTGCACTCCAGCCTGAGCAACAAGAGTGAAATTTTGTCTCAAAAAAAAAAAAAAAAGAAA"
"chr14","15386894","15387394","JH378114","15957391","15957789","201","570497","GCTGAGTGCAGTGGCTCACGCCTGTAATCCACTTTAGCAGGCCAAAATAGGGGGATCACTTTGAGGCCACGAGTTTGAGACCTGCCTGGGCAACATAGTGAGGCCCCGTCTCTACAAAAATCTTTAAATATTAGAATAACTTTGGGAGGCCGAGGCGGGTGGATCACGAGGTCAAGAGATTGAGACCATCCTGGCCAACATGGTGAAATCCCATCCCTACTAAAGCTACAAAAATTAGCCAGGCGTGGTGGTGTGCGCCTGTAGTCCCAGCTACTCGGGAGACTGAGGCAGGAGAATTGCTTGAATCCGCGTGGCGGAGGTTGCAGTGAGCTGAGATCGCGCCACTGCACTCCAGCCTGGTGACAGAGCGAGACTCCGTCTTAAAAAAAAAAAAAAAAAAAAAAAAAAAAACTTCGGAGGTTGCGGTGAGCCAAGATCACGCCATTGTACTCCAGCCTGGGCCACAAGAGCAAAACTCCGCTTCAAAAAAAAAAAAAAAAA","GCAAGGAACGGTGGCTCATGCCTGTCATCCCAGCACTTTGGGAGGCTAAGGAGGGTGGATTACCGAAGGTCATGAGTTTGAGACCAGCCTGACCAACATGGTGAAAACCCCATCTCTACTAAAAATACAAAAAATTAGCCAGATACAGCTATGCGGCAGACTGGGGCAGGAGAATCGCTTGGACCCAAACCCCATCTCTACTAAAAATACAAAAAATTAGCCGGATACAGCTATGCGGGAGACTGGGGCAGGAGAATCGCTTGGACCCGGGAGGCAGAGATTGCAGTGAGATGAGACCATGCCATTGCTCTCTAGCTTGTGCGATGAGAACAAGACTCTGTCTCAAAAAAAAAAAAAAAAAAAAAAAAAAAAAAAAAAAAAAAAGAGAGAGAGAGAAAA"
"chr14","20140478","20141066","JH378118","18053084","18053501","250","2087394","GCCAGGCGAGGTGGCTCATGCCTGTAATCCCAGCACTTTGGGAGGCTGAGGTGGGTGGAACACTTGAGGTCAGGAGTTCAAGACCAGCCTGGCCAACATGATGAAACCCCCATCTCTACTAAAAACACAAAAATTAGCCAGGAGTGGGCAGGGTGCGGTGGCTCACGCCTGTAATCCCAGCACTTTGGGAGGCTGGGATGGGTGGATCATGAGGTCGGGAGTTCAAGACCAGCCTGGCCAAGATGGTGAAACCCTGTCTCTATTAAAACTTCAAAAATTAGCCAGGCACGGTGGCAGGTGCTTGTAATCCCAGCTACTTGGGAGGCTGAGGCAGGAGAATCACTTGAAACTGGGCGGCAGAGGTTGCAGTGAGCCAAGATCGCGCCACTGGACTCCAGACTGGGCGACACAGTGAGATACCGTCTCAAAAAAAAAAAAAAAAAAAATTAGCCAGGAGTGGTGGCGGAAATCCCAGCTACTTGAGAGGCTGAGGCAGGAGAATCGTTTGAACCCAGGAGGCAGAGGTTGCAGTGAGCCAAGATCTTGCCATTGCACTCCAGCTTGGGAGACAAGAGCAAAACTCTGTCTC","GGCTGGGCGCAGTGGCTCACACCTGTAATCCCAGCACTTAGGGAAGCTGAGGCGAGTAGATCACCTGAGGTCAGGAGTTAGAGACCAGCCTGGCCATCATGGTGAAACCCCGTCTCTACTAAAGATACCAAAAATTAGCTGAGTGTGGTGCTGGGTGCCTGTAATCCCAGAAACTCAGGGTGCCTGTAATCCCAGCAACTCAGGGTGCCTTTAATCCCAGCAACTGAGGGTACCAGTAATCCCAGCAACTCAGGGTGTCTTTAATCCTAGCAACTGAGGGCACCTGTAATCCCAGCAACTCAGGAAGCTGAGACAGGAGAAGTACTTGAACCCAGAAGGCAGAGGTTGCAGTGAGCCGATATTGCACCATTGCACTCCAGTCTGGGCAACAAGAGTGAAACTCTGTCTCAAAAAAAAA"
"chr14","32019134","32019479","JH378197","6655183","6655524","67","25363951","GGCTGGGGCAGTGGCTCACTGTAATTCCAGCACTTGGCCAAGGCAGGTGGATCACCTGAGGTCAGGAGTTCAAGACCAGCAGGGCCAACATGGTGAAACCCTATCTCTAAAAATAAATAAATAAATAAATAAATAAAATAAAATAAAATAAAATAAAAAATAAAAAAAATTAGCTGGGCGTTGTGGTGGGCGCCTGTAATCCCAGCTACTTGGGAGGCTGAGGCAGGAGGATCGCTTGAACCTGGAAGGCAGAGGTTGCAGTGAGCCGAAATCACATAATTGCACTCCAGCCTGGGCGACAAGAGCAAAACTCCATCTCAAAAAAAAAAAAAAAAAAAAAAAAAAA","GGCCGGGCGCAGTGGCTCATGCCTGTAATCCCAGCACTTTGGGAGGCAGAGGCGGGCAGATCACCCAAGGTCAGGAGTTCAAGACCAGCCTGGCTAACATGGTGAAACCCCATTTCTACTAAAAATACAAAAAAAAAAAAAAAAAAAAAAAAAAAAAAAAAAAAAAATTAGCTGAGCGAGGTGGTGGGCACATGTAATCCCAGCTACTTCGGAGACTAAGGCAGGACAATTGCTTAAGCCTGGGAGGCAGAGGTTGTAGTAAGCTGAGATCACACCATTGCACTCCAGCTTGAGCAACAAGAGCGAAACTCCGTCTCAAAAAAAAACCCAAAAAACAAAAAA"
"chr14","39734996","39735596","JH378118","18053084","18053501","237","21681912","GGCTGGGCGCGGTGGCTCATGCCTGTAATCCCAGCATTTTGGGAGGCCGAGGCGGGTGGATCACCTGAGGTCAGGAGTTTGAGACCAGCCTGGCCAACATGGTGAAACCCTGTCTCTACTAAAAATGCAAAAATTAGGCTGGTGCAGTGGCTCACGCCTGTAATCACAGCACTTTGGGAGGCCGAGGTGGGCGGATCACGAGGTCAGGAGATCGAGACCATCCTGGCTAATACAATGAAACCCCGTCTCTATGAAAAATACAAAAAATTAGCCGGGCGTAGTGGCAGGCGTCTGTAGTCCCAGCTACTCAGGAGGCTGAGGCAGGAGAATGGCATGAACCTGGGAGGCGGAGCTTGCAGTGAGCCGAGATTGCGCCACTGCACTCCAGCCTGGGCGACAGCGAGACTCTGTCTCAAAAAAAAAAAAAAAAATTAGCTAGGCATGGTGGCGCATGCCTGTAATCCCAGCTACTTGGGAGGCTGAGGCAGGAGAATCGCTTGAACCTGGGAGGCAGAGGCTGCAGTGAGACAAGATCACGCCATTGCACTCCAGCCTGGGCAACAAGAGTGAAACTCCATCTTCCCCCTACCAAAAAAAAAAA","GGCTGGGCGCAGTGGCTCACACCTGTAATCCCAGCACTTAGGGAAGCTGAGGCGAGTAGATCACCTGAGGTCAGGAGTTAGAGACCAGCCTGGCCATCATGGTGAAACCCCGTCTCTACTAAAGATACCAAAAATTAGCTGAGTGTGGTGCTGGGTGCCTGTAATCCCAGAAACTCAGGGTGCCTGTAATCCCAGCAACTCAGGGTGCCTTTAATCCCAGCAACTGAGGGTACCAGTAATCCCAGCAACTCAGGGTGTCTTTAATCCTAGCAACTGAGGGCACCTGTAATCCCAGCAACTCAGGAAGCTGAGACAGGAGAAGTACTTGAACCCAGAAGGCAGAGGTTGCAGTGAGCCGATATTGCACCATTGCACTCCAGTCTGGGCAACAAGAGTGAAACTCTGTCTCAAAAAAAAA"
"chr14","49081899","49082239","JH378114","14264965","14265292","65","34816934","GGCCAGGTACAGTGGCTCATGCCTGTAATCTCAGCATTTTGGGAGGCTGAGGCAGGCAGATCACCTGAGGTCAGGAGTTCGTGACCAGCCTGACCAGTGAAACCCTGTCTCTACTGAAAAAAATAAAATAAAATAAAATAAAAATAAAAATTAGCTGGGTGTGGTGGTGGGCGCCTGTAATCCCAGCTACTCGGCAGGCTGAGGCAGGAGAATTGCTTGTACCCGGGAGGCGGAGGTTGCAGTGAGCCAAGATCATGCCATTGCACTACAGCCTAGGTGACAAGAGCAAAACTCTGTCTCAAAACAAAACAACAACAACAACAACAACTAAAAAAAAAAAA","GGCCAGGCGCGGTGGCTCAAGCCTGTAATCCCAGCACTTTGGGAGGCCGAGGCGGGTGGATCATGAGGTCAAGAGATCGAGACCATCCTGGTCAACATGGTGAAACCCCGTCTCTACTAAAAACAGAAAAAAAATAAAAATAAAAATAATTAGCTGGGCATGGTGGAGCATGCCTGTAATCCCAGCTACTCAGGAGGCTGAGGCAGGAGAATTGCCTGAACCGAGGAGGCGGAGGTTGCGGGGAGCCAAGATCGCGCCATTGCACTCCAGCCTGGGCAACAAGAGCGAAACTCCGTCTCAAAAAAAAAAAAAAAAAAAAAAAAAAAAA"
"chr14","54833704","54834332","JH378118","18053084","18053501","272","36780620","GGCCAGGTGCAGTGGCTCACTCCTGTAATTCCAGCACTTTGGGAGGCTGCCGGTGGATCACCTGAGGTCAGGAGTTCGAGATCAGCCTGGCCAACATGGTGAAACCCCGTCTCTACTAATAATACAAAAATTAGCCAGGCAAGGCCGGGCGCAGTGGCTCACACCTGTAATCCCAGCACTTTGGGAGGCCGAGGCGGGCGGATCACCTGAGGTCGGGAGTTCAAGACCAGCCTGACCAACATGGAGAAACCCCATCTCTACTAAAAATACAAAATTAGCTGGGCATGGTGGCACATGCCTGTAATCCCAGCTACTAGGGAGGCTGAGGCAGGCGAATCGCTTGAACCTGGGAGGTGGAGGTTGCGGTGGGCCGAGATGGTGCCATTGCACTCTAGCCCGGGCAACAAGAGCGAAACTCTGTCTCAAAAAAAAAAAAAAAAAAAAAAAAATTAGCCAGGCATGGTAGCACACCCTTGTAATCCCAGCTACTCGGGAGGCTGAGGCAGGAGAGTTGCTTGAACCCGAGAGACGGAGGTTGCAGTGAGCTGAGATCGTGCCATTGCACTCCAACCTGGGTGACAAGAGTGAAACTCCATCTCCAAAAAAAAAAATAAATAAAATAAATAAAA","GGCTGGGCGCAGTGGCTCACACCTGTAATCCCAGCACTTAGGGAAGCTGAGGCGAGTAGATCACCTGAGGTCAGGAGTTAGAGACCAGCCTGGCCATCATGGTGAAACCCCGTCTCTACTAAAGATACCAAAAATTAGCTGAGTGTGGTGCTGGGTGCCTGTAATCCCAGAAACTCAGGGTGCCTGTAATCCCAGCAACTCAGGGTGCCTTTAATCCCAGCAACTGAGGGTACCAGTAATCCCAGCAACTCAGGGTGTCTTTAATCCTAGCAACTGAGGGCACCTGTAATCCCAGCAACTCAGGAAGCTGAGACAGGAGAAGTACTTGAACCCAGAAGGCAGAGGTTGCAGTGAGCCGATATTGCACCATTGCACTCCAGTCTGGGCAACAAGAGTGAAACTCTGTCTCAAAAAAAAA"
"chr14","55277737","55278067","JH378148","10302642","10302970","61","44975095","GGCCGGGTGCAGTGGCCCACCTCTGTAATCCTAACACTTTGGGAGGCCAAGGCAGGCAGGTCACTTGAGGTCAGGAGTTCAAGACTAACCTGGCCAACATGGTGAAACCCCGTCTCTACTAAAAATACGAAAATTAGCCGGGCTTCATGATGCATGCCTGTAATCCCAGCTACTAAGGAGGCTGAGGCAGAAGAATCTCTTGAACCCATGAGGTTGCAGTGAGCTGAGATCTCGCCATTGCACTCCAGCCTGGAGGACAAGAGCGAAACTCTGTCTCAAAAAAATAAAATAAAATAAATAAGAATAAAATAATAATAAAAGGCAAAAAGAA","GGCCGGGCGCGGTGGCTCAAGCCTGTAATCCCAGCACTTTGGGAGGCCGAGGCGGGTGGATCACGAGGTCAAGAGATCGAGACCATCCTGGTCAACATGGTGAAACCCCGTCTCTACTAAAAATACAAAAAATTAGCTGGGCATGGTGGTGGGTGCCTGTAATCCCAGCTACTCAGGAGGCTGAGGCAGGAGAATTGCCTGAACCCAGGAGGCGGAGGTTGCGGTGAGCCGAGATCGCGCCATTGCACTCCAGCCTGGGTAACAAGAGTGAAACTCTGCCTCAAAAAAAAAAAATAAAATAAAATAAAATAAAATAAAATAAAATAAAA"
"chr14","55822103","55822700","JH378118","18053084","18053501","240","37769019","GGCCAGGCGCAGTGGCTCACGCCTGTAATCCCAGCACTTTAGGAGGCCGAGGCAGGTGGATCGCCTGAGTTCAGGAGTTCAAACCCACCCTGGCCAACATGGTGAAACCCTGCCTCTACTAAAAAACAAAAAAATGGCCAAGCGTGGTGGCTCACGCCTGTAATTCCAGCACTTTGGGAGGCTGAGGCAGGCGAATCACGAGGTCAGGAGATCGAGACCATCCTGGCTAACATGGTGAAACCCCATCTCTATTAAAAATACAGAAAATTAGCCAGGCGTGGTGGTGGACGCCTGTAGTCCCAGCTTCTTGGGAGGCTGAGGCAGGAGAATGGCATGAACCCGGGAGGCAGAGCTTGCAGTGAGCTGAGATTGCGCCAGTGCACTACAGCCTGTGGGACAGAGCAACTCCGTCTCAAAAAAAAAAAAAATTAGCTGGGCATGGTGGCATATGCCTGTAATCCCAGCTACTAAGGAGGCTGAGGCGGGAGAATCGCTTGAACCCGGGAGGCAGAGGTTGCAGTGAGCCGAGATTGCGCCATTGCACTCCAGTCTGGACAACAAGAGTGAACTGTGTCTCAAAAAAAAAAAAAAAAAAAGA","GGCTGGGCGCAGTGGCTCACACCTGTAATCCCAGCACTTAGGGAAGCTGAGGCGAGTAGATCACCTGAGGTCAGGAGTTAGAGACCAGCCTGGCCATCATGGTGAAACCCCGTCTCTACTAAAGATACCAAAAATTAGCTGAGTGTGGTGCTGGGTGCCTGTAATCCCAGAAACTCAGGGTGCCTGTAATCCCAGCAACTCAGGGTGCCTTTAATCCCAGCAACTGAGGGTACCAGTAATCCCAGCAACTCAGGGTGTCTTTAATCCTAGCAACTGAGGGCACCTGTAATCCCAGCAACTCAGGAAGCTGAGACAGGAGAAGTACTTGAACCCAGAAGGCAGAGGTTGCAGTGAGCCGATATTGCACCATTGCACTCCAGTCTGGGCAACAAGAGTGAAACTCTGTCTCAAAAAAAAA"
"chr14","55860214","55860812","JH378118","18053084","18053501","246","37807130","GGCCGGATGCAGTGGCTCACGCCTGTAATCCCAGCACTTTGGGAGGCCAAGGCAAGCGGATCACCTGAGGTCAGGAGTTCAAGACCAGCCTGGCCAGCATGGTGAAACCCCTTCTCTACTAAAAATACAAAAATTAGCCGGGGCCTTGCGTGGTGGCTCACACCTGTAAATCCCAGCGCTTTGGGAGGCCGAGGCAGGCGGATCACCTGAGGTCGGGAGTTCAAGAACAGCCTGACCAACATGGAGAAACCCCGTCTCCACTAAAAATAGAAAAATAGCCGGGCATGGTGGCGCATGCTTGTAATCTCAGCTACTCGGGAGGCTGAGGCAGGAGATCACTTGAACCCAAGAGGCAGAGGTTGCGGTGAGCCGAGATCGCGCCATTGCACTCCAGCCTGGGCAACAAAGAGCGAAACTCCGTCTCCAAAAAAAAAAAAAAAAAATTAGCCGGGCGTGGTGGCACATACCTGTAATCCCAGCTATTCAGGAGGCTGAGGCAGGAGAATCCCTTGAACCCGGGAGGCAGAGATGGCAGTGAGCTGAGATCACGCCATTGCACTCCAGCCTGGGTGAGAGGAGTGAAACTCCGTCTAAAAAAA","GGCTGGGCGCAGTGGCTCACACCTGTAATCCCAGCACTTAGGGAAGCTGAGGCGAGTAGATCACCTGAGGTCAGGAGTTAGAGACCAGCCTGGCCATCATGGTGAAACCCCGTCTCTACTAAAGATACCAAAAATTAGCTGAGTGTGGTGCTGGGTGCCTGTAATCCCAGAAACTCAGGGTGCCTGTAATCCCAGCAACTCAGGGTGCCTTTAATCCCAGCAACTGAGGGTACCAGTAATCCCAGCAACTCAGGGTGTCTTTAATCCTAGCAACTGAGGGCACCTGTAATCCCAGCAACTCAGGAAGCTGAGACAGGAGAAGTACTTGAACCCAGAAGGCAGAGGTTGCAGTGAGCCGATATTGCACCATTGCACTCCAGTCTGGGCAACAAGAGTGAAACTCTGTCTCAAAAAAAAA"
"chr14","56736257","56736880","JH378206","6546474","6546861","276","50189783","GGCCAGGCACAGTGGCTCATGCCTGTAATCCCTGCACTTTGGGAGGCCAAGGCGGGTGGATCACCTGAGGTCAGGAGTTCGAGACTAGCCTGGCCAACATGGTTGGCCATCTCTTCTAAAAATACAAAAAATTAAGTTGGGCATGGTGGCTCATGCCTGTAATCCCAGCATTTTGGGAGGCCAAGGCAGGTGGATCATAAGGTCAAGAGATTGAGACCATCCTGGCCAACATGGTGAAACCCCATCTCTACTAAAAATACAAAAATTAGCTGGGCGTGGTGGTAGCACACACCTGCAGTCCCAGCTGCTCAGGAGGCTGAGGCAGGAGAATCACTTGAACCCGGGAAGCAGAGGTTGCAGTGAGCCGAAATTGCACCACTGCACTCCAGCCTGGCGACAAAGCAAGACTCCGTCAAAAAAAAAAAAAAAAAAAAAAAAATTAGCCAGGAGTGGTGGCACGTGCCTATAGTTCCAGCTACTCGGGAGGCTGAGGCAAGAGATTTGCTTGAACCTGGGAAGCAGAGGTTGCATATATTGCAGTGAGCCAAGATTATGCCATTGCACTCCAGCCTGGGCAACAAGAGTGAAAATCTGTCTAAAAAGAAAAAAAAAAGAAAAGAAAAA","GGCCACACATGGTGGCTAACGCCTGTAATCCCAGCACTTTGGGAGGCCAAGTCGGGTGGATCATGAGGTCAGGAGACCAAGACCATCCTGGCCAAATGGTGAAACCCCGTCTCTACTAAAAATACAAAAATTAGCTGGGCATGGTGGCGTGTGCCTGTAATCCCAGCTACTCAGGAGGCTGAGGCAGGACAATTGCCTGAACCCAGGAGAATTAGCTGGGCATGGTGGCGTGTGCCTGTAATCCCAGCTACTCAGGAGGCTGAGGCAGGACAATTGCCTGAACCCAGGAGGCGAAGGTTGCGGTGAGCCGAGATTGTGCCATTGCACTCCAGCCTGGGTAACAAGAGCGACACTCTGTCTCAAAAAAAAAAAAAAAAAAAAAAAAAAA"
"chr14","56744047","56744674","JH378118","18053084","18053501","281","38690963","GGCCGGGTGCGGTGACTCACATCTATAATCCCAGCACTTTGGGAGGCCAAGGCAGGTGGATCACCTGAGGTCAGGAGTTCAAGACCAGCCTGGCCAACTTGGTGAAACCCCATCTCTACTAAAAAATATAAAAATTTGCCAGGTGCGGTGGCTCATACCTGTAATCCCAGCACTTTGAGAGGCAGAGGTGGGTGGATCACGAGGTCAGGAGTTCGAGACCAGCCTGGCCAATGTGGTGAAACCCCATCTCTACTAAAAATACAAAAATTAGCCGGGTGTGGTGATGCGTGCCTGTAGTCCCAGCTATTCGGGAGGTTGAGGCAGGAGAATGGCGTGAACCAGGAAGGCGGAGCTTTCACTGAGCGGAGATCGCACCACTGCACTCCAGCCTGGGCGACGGAGCGAGACTCTGTCTCAAAAACAAAACAAAACAAAAAAACAAACAAACAAAAAAACATTATCCGGGTGTGGTGGTGGGCGCCTGTAATCCCAGCTACTTGGGAGGCTGAAGCAGGAGGATTGCTTGAACCTGGGAGGTGGAGGTTGCAGTGAGCTGAGATCACGCCTCTGCACTGCAGGCTGGACGACAAGAACAAAACTCTGAATCAACAACAACAACAACAAAAAA","GGCTGGGCGCAGTGGCTCACACCTGTAATCCCAGCACTTAGGGAAGCTGAGGCGAGTAGATCACCTGAGGTCAGGAGTTAGAGACCAGCCTGGCCATCATGGTGAAACCCCGTCTCTACTAAAGATACCAAAAATTAGCTGAGTGTGGTGCTGGGTGCCTGTAATCCCAGAAACTCAGGGTGCCTGTAATCCCAGCAACTCAGGGTGCCTTTAATCCCAGCAACTGAGGGTACCAGTAATCCCAGCAACTCAGGGTGTCTTTAATCCTAGCAACTGAGGGCACCTGTAATCCCAGCAACTCAGGAAGCTGAGACAGGAGAAGTACTTGAACCCAGAAGGCAGAGGTTGCAGTGAGCCGATATTGCACCATTGCACTCCAGTCTGGGCAACAAGAGTGAAACTCTGTCTCAAAAAAAAA"
"chr14","58283278","58283584","JH378115","34663603","34663898","52","23619675","CCGGGTGCGGTGGCTCACGCCTGTAATCCCAGCACTTTGGGAAGCTGAGGTGGGTGGATCATTTGAGGTCAAGAGTTCTAGACCAGCCTGGCCAACATGGTGAAACCCTACTTCTAATAAACACACACACACACACACACACACACACACACACACAAATTAGCCAGCAGGCACCTGTAATCCCAGCTACTCGGAAGGCTGAGGCAGGACAATCGCTTGAACCTGGGAGGCCAGAAGTTGCAGTGAGCCAAGATCATGCCACTGCACTCCAGTCTGGGTGACAAGAGCAAGACTCCATTTCAAAAAA","GGCCTGGTGAAGTGGCTCACGCCTGTAATCCCAACACTTTGGGAGGCTGAGATGGATGGCTCATTTGAGGTCAGGAGTTCTAGACCAGCCTGGCCAACATGGTAAAAGCCCACCTCTACCAAAAATACAAAAACAAAAACAAAAAAATTTTAGCCAACAGGCACCTTTAATCCCAGCTACTCAGGAGGCTGAGGCAGGAGAATTGCTTGAATCTGGGAGGCCAGAAGTTGCAGTGAGCCAGGATCACACCACTGCACTCCATCCTAGGCGACAAGAGCAAGACTCCAAAAAAAAAA"
"chr14","59226808","59227410","JH378118","18053084","18053501","257","41173724","GGCTGGGCGCTGTGGCTCATGCCTGTAATCCCAGCACTTTAGGAAGCCAAGGGAGGTGGATCACCTGAGGTCAGAGTTCAAGTCCGGCCTGACCAACATGGCGAAACCCAGTCTCTACTAAAAATACAAAATTGGCCAGGCGTGGGGTGGCTCACACCTGTAATCCCAGCACTTTGGGAGGCCGAAGTGGGTGGATCACTTGAGGTCAGGAGTTTGAGACCAGCCTGGTTAACATGGTGAAACCCCATCTCTACTAAAAATACAAAAATTAGCCAGGCATGGTGGCAGGCGCCTGCAATCCCAGTTACTCAGGAGGCTGGTGCAGGAGAATCGCTTAAACCTAGGAGGCAGAGGTTGCAGTGAACTGAGATCGTGCCATTGCACTCCAGCCTGGGTAACAACAGCAAGACTTCATCTCAAAAAAAAAAATACATAATTATAATTAGCTGGGCGTGTTGGCGAGCGCCTGTAGTCCCTGCTACTTGGGAGGCTGAGGCAGGGGAATCACTTGAACCTGAGAGGCGGAGGTTGCAGTGAGCCAAGTCACGCCATTGCATTCCAGCCTCGGCAACAAGAGCAAAACTCCATCTCAAAAAAAAAAAA","GGCTGGGCGCAGTGGCTCACACCTGTAATCCCAGCACTTAGGGAAGCTGAGGCGAGTAGATCACCTGAGGTCAGGAGTTAGAGACCAGCCTGGCCATCATGGTGAAACCCCGTCTCTACTAAAGATACCAAAAATTAGCTGAGTGTGGTGCTGGGTGCCTGTAATCCCAGAAACTCAGGGTGCCTGTAATCCCAGCAACTCAGGGTGCCTTTAATCCCAGCAACTGAGGGTACCAGTAATCCCAGCAACTCAGGGTGTCTTTAATCCTAGCAACTGAGGGCACCTGTAATCCCAGCAACTCAGGAAGCTGAGACAGGAGAAGTACTTGAACCCAGAAGGCAGAGGTTGCAGTGAGCCGATATTGCACCATTGCACTCCAGTCTGGGCAACAAGAGTGAAACTCTGTCTCAAAAAAAAA"
"chr14","62992080","62992681","JH378118","18053084","18053501","256","44938996","GGCCGGATGCAGTGGCCCACACCTGTAATCCTAGCACTTTGAGAGGCTGAAGCAGGCAGATCACTTGCGGTCAGGAGTTTGAGACCAGCCTGGCCAACATAGTAAAACCTCATCTCTACTAAAAATAGAAAAATTTTCTGACCAGGCACGGTGGCTCGCGCCTGTAATCCCAGCACTTTGGGAGGCCAAGGTGGGCACATTACCTGAGATCAAGAGTTCAAGACCAGCCTGACCAACATGGCAAAACTCTGTCTCTACTAAAAATACAAAATTAGCCGGGCATAGTGGCGCATTCCTGTAATCCCAGCTACTAAGGAGGCTGAGGCAGGAGAATTGCTTGAACCCGGGAGCCGGAGGTTGCAGTAAGCCAAGATTGCGCACTGCACTCTAGGCTGGGCAACAACAGCGAAACTCTGTCTCGAAAAAAAAAAAAAAAAAAATTAGCTGGGCGTGGTGGTGAGTACCTGTAATCCCAGCTACTTGGGAGACTGAGGCAGGAGAATCTCTTGAACCTGGGAGGTAGAGGTTGCAGCGAGCTTAGATCACACCACTGCACTAAAGCCTGGGGGACAAGAGCAAAACTCTATCTCAAAAAAATAAAA","GGCTGGGCGCAGTGGCTCACACCTGTAATCCCAGCACTTAGGGAAGCTGAGGCGAGTAGATCACCTGAGGTCAGGAGTTAGAGACCAGCCTGGCCATCATGGTGAAACCCCGTCTCTACTAAAGATACCAAAAATTAGCTGAGTGTGGTGCTGGGTGCCTGTAATCCCAGAAACTCAGGGTGCCTGTAATCCCAGCAACTCAGGGTGCCTTTAATCCCAGCAACTGAGGGTACCAGTAATCCCAGCAACTCAGGGTGTCTTTAATCCTAGCAACTGAGGGCACCTGTAATCCCAGCAACTCAGGAAGCTGAGACAGGAGAAGTACTTGAACCCAGAAGGCAGAGGTTGCAGTGAGCCGATATTGCACCATTGCACTCCAGTCTGGGCAACAAGAGTGAAACTCTGTCTCAAAAAAAAA"
"chr14","75046278","75046878","JH378118","18053084","18053501","246","56993194","GGCCGGGCACAGTGGCTCACACCTATAATCTCAGTACTTTGGGAGGCCAAGGCGGGCAGATCACTTGAGGTCAGGAGTTCGAGACCACCCTGGCCAACATGGTGAAACCTCATCTCTACTAAAAATACAAAAAACTGGCTGGGTGAAGTGGCTCACGCCTGTAATCCCAGCAGTTTGGGAGGCCAAGGCGGGCCAATCACGAGGTCAGGAGTTCGAGACCAGCCTGGCCAATATGGTGAAACCCCGTCTCTATTAAAAATTCAAAAATTAGCTGGATGTGGTGGCAGGCACCTACAATCCCAGCTACTTGGAAGGCTGAGGCAGGAGAGTCTGCTTGAAACCAGAAGGCGGAGGTTGCAGTGAGTGAGCTGAGAACGTGCCACTGCACTCCAGCCTGGGCGAAAGAGCAAAACGCTGTCTCAGGGGGAAAAAAAAAACTAGCCGGGCATGGTGGCAGGTGCCTGTAATCCCAGCTACTCAGGAGGCTGAGGCAGGAGAATTGCTTGAACCCAGGAGGAGGAGGTTGCAGTGAGTCGAGATCACGTCATTGCACTCCCAGCCTGGCTGATAAGAGCGAAACTCCGTCAAAAAAAAAAAAAAA","GGCTGGGCGCAGTGGCTCACACCTGTAATCCCAGCACTTAGGGAAGCTGAGGCGAGTAGATCACCTGAGGTCAGGAGTTAGAGACCAGCCTGGCCATCATGGTGAAACCCCGTCTCTACTAAAGATACCAAAAATTAGCTGAGTGTGGTGCTGGGTGCCTGTAATCCCAGAAACTCAGGGTGCCTGTAATCCCAGCAACTCAGGGTGCCTTTAATCCCAGCAACTGAGGGTACCAGTAATCCCAGCAACTCAGGGTGTCTTTAATCCTAGCAACTGAGGGCACCTGTAATCCCAGCAACTCAGGAAGCTGAGACAGGAGAAGTACTTGAACCCAGAAGGCAGAGGTTGCAGTGAGCCGATATTGCACCATTGCACTCCAGTCTGGGCAACAAGAGTGAAACTCTGTCTCAAAAAAAAA"
"chr14","83813857","83814442","JH378118","18053084","18053501","240","65760773","GGCCAGGCGCGGTGGCTCACGCCTGTAATCCCAGCACTTTGGGAGGCCGAGGCGGGCGGATCACCTGAGGTCAGGGGTTCAAGACCAGCCTGACCATCCCAGAACTTTGGGAGGCCGAGACGGGTGGATCATGAGGTCAGGAGATCGAGACCATCCTGGCTAACACAGTGAAACCCCATCTCTATTAAAAATACAAAAAATTAGCCGGGCGTGGTGGCAGCTCCTGTAGTCCCAGCTACTCGGGAGGCTGAGGCAGGAGAATGGCGTGAACCCGGGAGGCGGAGCTTGCCGTGAGCCGAGATCGCACCACTGCACTCCAGCCTGCAAGATAGCGAGGCTATGTCTCAGGAAAAAAAAAAAAAAAAAAAAAAAGACCAACCTGACCAACATGGTAAAACCCCATCTCTACTAAAAATACAAAATTAGCCGGGCATGGTGGCAGACGCCTGTAATCCCAGCTACTCAGGAGGCTGAGGCAGGAAAATCACTTGAACCCAGGAGGTGGAGGTTGCGGTGAGCCGAGATCGTGCCATTGCACTCCGGCCTGGGTGACAACAGCGAAACTCCATCTCAAAAAAAAGAAAAA","GGCTGGGCGCAGTGGCTCACACCTGTAATCCCAGCACTTAGGGAAGCTGAGGCGAGTAGATCACCTGAGGTCAGGAGTTAGAGACCAGCCTGGCCATCATGGTGAAACCCCGTCTCTACTAAAGATACCAAAAATTAGCTGAGTGTGGTGCTGGGTGCCTGTAATCCCAGAAACTCAGGGTGCCTGTAATCCCAGCAACTCAGGGTGCCTTTAATCCCAGCAACTGAGGGTACCAGTAATCCCAGCAACTCAGGGTGTCTTTAATCCTAGCAACTGAGGGCACCTGTAATCCCAGCAACTCAGGAAGCTGAGACAGGAGAAGTACTTGAACCCAGAAGGCAGAGGTTGCAGTGAGCCGATATTGCACCATTGCACTCCAGTCTGGGCAACAAGAGTGAAACTCTGTCTCAAAAAAAAA"
"chr14","84224287","84224910","JH378118","18053084","18053501","265","66171203","GGCAGGGTGCAGTGGCTCATACCTGTAATCCCAGCACTCTGGGAGGCCGAGGTGGGCAGATCACTTGAGCTCAGGAGTTTGAGACCAGCCTGGCCAACATAGTGAAACCCCATCTCTACTAAAAATACAAAATTAGGCTGGGCACAGTGACTCACGTCTGTAATCCCAGCACTTTGGGAGGCCGAGGCTGGTGGATCACAAGGTCAGGAGATCAAGACCATCCTGTCCAACATAGTGAAACCCCATCTCTACTAAAAATACAAAAATTAGCTGGACGTGGAGGTGCACATCTGTAGTCCCAGCTACTTGTGAGGCTGAGGCAGGAGAACTGCTTGAACCCAGGAGGCGGAGGCTGCAGTGAGCTGAGATTGTGCCACTGCACTCCAGCCTGGGCGACAGAGCGAGACTCTGTCTCAAAAAAAAAAAAAAACAGAAAAAACAAAATTAGCCGGGCATGGTGGTGCACGCCTGTAACCCCAGCTACTTGGGGGGCTGAGGCAGGAGAATTGCTTGAACCTGAGAGGTGGAGGTTTCAGTGAGCCGAGATTGTGCCATTGCCCTCCAGTCTGGGCAACAAGAGCAAAACTCCGTCTCAAAAAAAAAAAAAAGAAAAAAAAAGAAGAA","GGCTGGGCGCAGTGGCTCACACCTGTAATCCCAGCACTTAGGGAAGCTGAGGCGAGTAGATCACCTGAGGTCAGGAGTTAGAGACCAGCCTGGCCATCATGGTGAAACCCCGTCTCTACTAAAGATACCAAAAATTAGCTGAGTGTGGTGCTGGGTGCCTGTAATCCCAGAAACTCAGGGTGCCTGTAATCCCAGCAACTCAGGGTGCCTTTAATCCCAGCAACTGAGGGTACCAGTAATCCCAGCAACTCAGGGTGTCTTTAATCCTAGCAACTGAGGGCACCTGTAATCCCAGCAACTCAGGAAGCTGAGACAGGAGAAGTACTTGAACCCAGAAGGCAGAGGTTGCAGTGAGCCGATATTGCACCATTGCACTCCAGTCTGGGCAACAAGAGTGAAACTCTGTCTCAAAAAAAAA"
"chr14","85020958","85021268","JH378108","34510794","34511096","52","50510164","GCCAGGTGCAGTGGCTCATGCCTGTAATTCCAGTACTTTGAGAGGTCGAGACAGGGAGATCACCTGAGGCCAGGAGTTCAAGACTAGCTTGGCCAACATGGCAAAACCCTGTCTCTACTAAAAATGCAAAAAAAAAAAAAAAAAAAAAAAAAAAATTAGCCTGGCATGGTGGTAGACACCTGTAATCCCAGCTACTTGGGAGGCTGAGACAGGAGAACCTCTTGAATCTGGGAGGAGGAGGTTGCTGTGAGCTGAGATCGTGCCACTGCACTCCAGCCTGGGTAACAAGAGAGAAACTCTGTCTCAAAAAA","GGGTGCCGTGTCTCATGCCTGTAATTCCAGCACTTTGGGAGGTCAAGGCAGTCCGATCACCTGAGGTCAGGAGTTTGAGACTAGCCTGGCCAAAATGGTGAAACCCTGTCTCTAGAAAAAATACAAAAAAAAAAAAAAAAAAAAAAAAAAATTAGCTGGATGTAGTGGTGCATACCTGTAGTCCCAGCTACTCTGGAGGCTGAGGCAGGAGAATTGTTTGAACCCAGGAGGCGGAGGTTGCGGTGAGCCGAGATCATGCCATTGCACTCCAGCCTGGGAAACAAGAGTGAAACTCTGTCTCAA"
"chr14","86696589","86696920","JH378203","2698403","2698735","56","83998186","GGCCAGGCACGGTGGCTCATGCCTATAACCAGCACTTTGGAGGCCGAGGCAGGTGGATCACCTGAGGTCAGGAGTTTGAGACTGGCCTGGCCAGCATGGTGAAACTCTGTCTCTACTAAAAAAAAAAAAAAAAAAAAAAAAAAAAAAGTACAAAATTAGCTGGATGTGGTGGTAGGCACCTGTAATCCCAGCTACTTGGGAGGCTGAGGCAGGAGAATCGCTTGAACCCAGGAGGCAGAGATTGCAGTGAGCCAAGATTGCGCCATTGTACTCCACTCTGGGCAATGAGCGAAACTCCGTCTCAAAAAAAAAATAAAATAAAAATAAAATAA","GCCGGGTGCAGTGGCTCATACCTCTAATCCCAGCACTTTGGGAGGCCAAGGCAGGTGATCACCTGTGGTCAGGAGTTCGAGACCAGCCTGGCCAACATGGTGAAACCCTGTCTTTACTAAAAATACAAAAAAAAAAAAAAAAAAAAAAAAAAAAAACTTAGCCCACCATGGTGGTGGGCTCTTGTAGTCCCAGCTACATGGGAGGCTGAGGCAGAAGAATCGCTTGAAGACAGGAGGTGGAGGTTGCAGTGAGCCAAGACTGCGCCATTGCACTCAGCCTGGGTGACGAGCCAAACTCCATCTCAAAAAAAAAAAAAAAAAAAAAAAAAAAAA"
"chr14","86944567","86945185","JH378118","18053084","18053501","274","68891483","GAGCACGGTGGCTCACGCCTGCAATCCCAGCACTTTGGGAGGCCGAGGTGGGTGGATCACCTGAGGTTAGGAGTTTGAGACCAGCCTGGCCAACATGGTGAAACCGTCTCTACTAAAAATGCAAAAAAGTAGGGGCCGGGCACGGTGGCTCACGCCTGTAATCCCAGCACTTTGGGAGTCTGAGGCAGACGGATCACAAGGTCAGGAGATCAAGACCATGGTGAAACTCCGTCTCTACTAAAAATACAAAAAATTAGCTGGGCGTGGTGGTGGGCACCTGTAGTCCCAGCTGCTTGGGAGGCTGAGGCAGGAGAATGGTGTGAACCCGGGAGGCGGAGCTTGCAGTGAGCCGAGATCGCAACACTGCACTCCAGCCTGGGCGACAGAGCGAGACCCTGTCTCAAAAAAAACAAAAATAAACAAAAATAAATAAATACAAAAAAGTAGCCAGGCATGGTGGTGGGTGCCTGTAATCCCAGCTACTTGGGAGGCTGAGGCAGGAGAATCACCTGAACCCGGGAGGTGGAGGTTGCAGTGAGCCAAGACCGTGTCATTACACTCTAGCCTGGGCAACAAGAGCGAAATTCCATCTGAAAAAATAAATAAATAAAAATAAAAA","GGCTGGGCGCAGTGGCTCACACCTGTAATCCCAGCACTTAGGGAAGCTGAGGCGAGTAGATCACCTGAGGTCAGGAGTTAGAGACCAGCCTGGCCATCATGGTGAAACCCCGTCTCTACTAAAGATACCAAAAATTAGCTGAGTGTGGTGCTGGGTGCCTGTAATCCCAGAAACTCAGGGTGCCTGTAATCCCAGCAACTCAGGGTGCCTTTAATCCCAGCAACTGAGGGTACCAGTAATCCCAGCAACTCAGGGTGTCTTTAATCCTAGCAACTGAGGGCACCTGTAATCCCAGCAACTCAGGAAGCTGAGACAGGAGAAGTACTTGAACCCAGAAGGCAGAGGTTGCAGTGAGCCGATATTGCACCATTGCACTCCAGTCTGGGCAACAAGAGTGAAACTCTGTCTCAAAAAAAAA"
"chr14","87180871","87181803","JH378118","18053084","18053501","547","69127787","GGCCATGTGCGGTGGCTCACACCTGTAATCCCAGCACTGTGGGAGGCCAAGGTGGGCGGATCATTTGAGGTCAGGAGTTCTAAACCAGCCTGGCCAATATGGTGAAACACTGTCTCTGCTAAAAATACAAAAAAAGAAAAAGAAAAAAAAAAAAAGGCTGGGCACGGTGGCTCACGCCTGTAATCTCAGCACTTTGGGAGGCTGAGGTGGGTGGATTACCTGAGGTCAGGAGTTCGAGACCAGCCTGGCCAACATGGTGAAACCTTGTCTCTACTAAAAGTATAAAAATTAGCCAGGTGTGGTGGAGGTCGCCTGTAATCCCAGCTACTCAGTAGGCAGAGGCAGAAGAATCCGTTGAACCTGGGAGGCGGAGGTTGCAGTGAGCTGAGATTGCACCAGTGCATTCCAGCCCGGGTGACAAGAGTGAGACTCTGTCTCAAAATAAACAAACAAAAAAATTAGTGGGCCGGGTTCAATGACTCACGCCGGTAATCCCAGCACTTTGGGAGGCCAAGGAAGGCAGGTCACCTGAGGTCGGGAGCTCGAGACCAGCCTGACCAACATGGAGAAACCCCGTCTCTACTAAAAATACAAAATTAGCTGGGCGTGGTGGCACATGCCTGTAATTCCAGCTACTCAGGACGCTGAGGCAGGAGAATTGCTTGAACCCAGGAGGCGGAAGTTGCAGTGAGCCAAGATCATGACATTGCACTCCCGCCTGGGCGCCAAGAGTGAGATTTCGTCTCAAACAAACAAACAAAAAAACGAATTAGTGGAGCGTGGTGGCAGGCACCTAAAGTCCCAGCTATTCAGGAGGCTGAGGCAGGAGAATTGCTTGAACCTGGGAAGTGGAGGTTATAGTGAGCTGAGATCGCGCCATTGCACTCCAGCCTGGGCAACAAGAGTGAGAATCTGTCTAAAAAAAAAAAAGAA","GGCTGGGCGCAGTGGCTCACACCTGTAATCCCAGCACTTAGGGAAGCTGAGGCGAGTAGATCACCTGAGGTCAGGAGTTAGAGACCAGCCTGGCCATCATGGTGAAACCCCGTCTCTACTAAAGATACCAAAAATTAGCTGAGTGTGGTGCTGGGTGCCTGTAATCCCAGAAACTCAGGGTGCCTGTAATCCCAGCAACTCAGGGTGCCTTTAATCCCAGCAACTGAGGGTACCAGTAATCCCAGCAACTCAGGGTGTCTTTAATCCTAGCAACTGAGGGCACCTGTAATCCCAGCAACTCAGGAAGCTGAGACAGGAGAAGTACTTGAACCCAGAAGGCAGAGGTTGCAGTGAGCCGATATTGCACCATTGCACTCCAGTCTGGGCAACAAGAGTGAAACTCTGTCTCAAAAAAAAA"
"chr15","7203590","7204226","JH378118","18053084","18053501","285","10849494","GGCCAGGTGCAGTGGCTCATGCCTCTAATCCCAGCACTTTGGGAGGCCGAGATGGGCAGATCACCGGAGGTCAGGAGTTTGAGACCAGCTTGGCCAAAATGGTGAAACCCTGTCTCTACAAAAAAATACAAAAATGGCTAGGCACGGTGGCTCACACCTGTAATCCCAGCACTTTGGGATACAGGTGGATCATGAGGTCAAGAGATCAAGATCATCTTGGCCAACATGGCAAAACCCTGTCTCTACTAAAAAATACAAAAAATTAGCTGGGCGTGGTGGTGCACGCCTGTAGTCCCAGCTACTCAGGAAACTGAGGCAAGAGAATCGCTTGAACCTGGGAGGTAGAGGTTGCAGTGAGCCGAGATGCACTCCAGCCTGGCAACAGAACAAGACTCCATCTCAAAGAACAAAAACAAAACAAAACAAAACAAAAGACAAGCAAACAAAAAAATACAAAAATTAGCTAGGTGTGGTGGCAGGCGCCTGTAATCCCAGCTACTCAGGAGGCTGAGGCAGGAGAATCGCTTGAACCTGGGAGGCGGAGGTTGCAGTGAGCCAAGATTGTGCCATTGCACTCCAGCCTAGGTGACAAGAGTGAAAAGACGTCTCAAAAACAAAACCAAAAAAAAAAATAAAA","GGCTGGGCGCAGTGGCTCACACCTGTAATCCCAGCACTTAGGGAAGCTGAGGCGAGTAGATCACCTGAGGTCAGGAGTTAGAGACCAGCCTGGCCATCATGGTGAAACCCCGTCTCTACTAAAGATACCAAAAATTAGCTGAGTGTGGTGCTGGGTGCCTGTAATCCCAGAAACTCAGGGTGCCTGTAATCCCAGCAACTCAGGGTGCCTTTAATCCCAGCAACTGAGGGTACCAGTAATCCCAGCAACTCAGGGTGTCTTTAATCCTAGCAACTGAGGGCACCTGTAATCCCAGCAACTCAGGAAGCTGAGACAGGAGAAGTACTTGAACCCAGAAGGCAGAGGTTGCAGTGAGCCGATATTGCACCATTGCACTCCAGTCTGGGCAACAAGAGTGAAACTCTGTCTCAAAAAAAAA"
"chr15","13675429","13675731","JH378235","1186107","1186418","53","12489322","GGCTTGGCACAGTGGCTCATGCCTGTAATCCCAGCACTTTGAGAGACCGAGGCAAGTGGATCCCAGGAGTTCAAGACCAGCCTGGCCAAGATGGTGAAACCCCCCATCTCTACTAAAAATACAAAAAAAAAAAAAAAAAAAAAAAAAGGGCTTAGTGGCTGGCAGCTGTAGTCCCAGCTACTCGGGAGGCTGAGGCAGGAGAATCGCTTGAACCTGGGAAGCGGAGGTTGCAGTGAGCCAAGATCACACCATTGCACTCTAGCCTGGGCAACAAGGGCAAAACTCCATCTCAAAAAAAAAGAA","GGCTGGGCGCAGTGGCTCAAGCCTGTAATCCCAGCACTTTGGGAGGCCGAGGGGGGTGGATCACGAGGTCAAGAGATCAAGACCATCCTGGTCAACATGGTGAAACCCCGTCTCTACTAAAAAAAAAAAAAAAAAAAAAAAAAAAAAAAAAAAATTAGCTGGGCATGGTGGCGTGTAATCCCAGCTACTCAGGAGGCTGAGGCAGGAGAATTGCCTGAACCCAGGAGGCGGAGTTTGCGGTGAGCCAAGATCGCGCCATTGCACTCCAGCCTGGGTAACAAGAGCAAAACTCTGTCTCAAAAAAAAAAAAAA"
"chr15","14837014","14837358","JH378137","13677298","13677634","59","1159716","GCCGGGTATGGTGGCTCATGCCTGTAATTCCAGCACTTTGGGAGGCCGAGGCAGGCGGATCACCTGAGGTCAGGAGTTTGAGACCAGCCTGGCTAACATGGTGAAACTACGTTTCTACTAAAAATACAAAAAAAAAAAAAAAAAAAAAAAAAAAAAAAAAAAAAAAAAAAATTAGCCAGGCGTGGAGGCGCGTGCCTATAATCCCAGTTACTCGGGAGGCCGAGGCAGGAGAATCGCTTGAACCCAGGAGCCGGAGGGTGTAGTGAGCCGAGATCATGCCATTGCGCTCCAGGTTGGGCAACAAGAGCAGAACTCCGTCTCAAAAAAAAAAAAAAAAAAAAAAAA","GGCTGGGCATTGTGGCTCATGCCTGTAATCCCAGCACTTTGGGAGGCCGAGGTGGGCGGATCACCTGAGGTCGGGAGTTCAAGACCAGCCTGGCCACAATGGTGAAACTCTGTCTCTGCTAAAAAAAAAAAAAAAAAAAAAAAAAAAAAAAAAAAAAAAATTAGCCAGGCGTGGTGGCACACGCCTGTAATCCCAGCTATTTGGGAGGCTGAGGCAGGAGAATCGCTTGAACCTGAGAGGTGGAGGTTGCAGTGAGCCAAGATCATACCATTGCACTCCAGCTTGGGAACAAAGAGCAAAACGCCATCTCAAAAACAAAACAAACAAACTGAAAAAA"
"chr15","20684723","20685060","JH378262","266823","267148","57","20417900","GGCTGGGCGTGTTGGCTTACACCTGAAATCCCAGCACTCTGGGAGGCCGAGGCGGGCAGATCACCTGAGGTCAGGGGTTCGAGACCAGCTTGGCCAACATGGTGAAACCCCGTCGCTACTAAAAATACAAAAATTAGCTGGGCATGGTGGTGGGAGCCTGTAATCCCAGCTACTCAGGAGACTGAGGCAGGACAATCGCTTGAACCCAGGAGGCAGAGGTTGCAGCGAGCCGAGATCGTGCCACTGCACTCCAGCCTGGGAGGGAAGAGTGAAAGTCCATAACAACAACAAAACAACAAAACAACAACAACAACAACAACAACATCTCTGAAAGGAAA","GGCCGGGCGCGGTGGCTCAAGCCTGTAATCCCAGCACTTTGGGAGGCCGAGGCGGGTAGATCATGAGGTCAGGAGTTTGAGACCAGCCTGGCCAACATGGTGAAACCCCGTCTCTACTAAAAATACAAAAATTAGCCGGGCATGGTGGCCTGTGCCTGTAATCCTAGCTACCCAGGAAGCTGAGGCAGGAGAATTGCCTGAACCCAGGAGGCGGAGGTTGCGGTGAGCCGAGATCGTGCCATTGCACTCCAGCCTGGGTAACAAGAGCGAAACTCCGTCTCAAAAACAAACAAACAAACAAACAAAAACAAAAAACAAAAAACAAA"
"chr15","20894395","20894976","JH378119","32351107","32351490","257","11456712","GGTGGCTCACACCTGTAATCCCAGCACTTTGGGAAGCCGAGGTAGGTGGATCACCTGAGGTCAGGAGTTAGAGATCAGCCTGGACAACATGGTGAAACCCCATCTCTACTAAAAATACAAAAACTAACCAGGCTTGGTGGCTCACACCTGTAATCCCATCACTTTGGGAGGCCAAGGCGGGTGGACTACTTGAGGTCAGGAGTTTGAGACCAGCCTGGCTAACATGGTGAAACCCCATCTCTACTAAAAATACAAAAATTAGCTGGGCATGGCAGTGCGCGCCTGCAATCCCAGCTACCTGGGAGGCTAAGGCAGGGGAATTGTTTGAACCTGGGAGGCAGAGGTTGCAGTGAGCCGACACTGCACCACTGCACTCCAGCCTGGGTGACAGAGTGAGCCTCCGTCTCAAAAAAAAAAAAAAAAAAAAAAAAAAATTAGCCAGGTGTGGTGGCAGGCACCTGTGATCCCAGCTACTCAGGAGGCTGAGGCAGGAGAATTGCTTGAACCCAGGAGGCGGAGAGTGCAGTGAGCTGAGATCATGCCATTGCACTCCAGCCTGGGTGACAAGAGAGAAACTCTGTC","GGCCAGGTATGGTGGCTCACACCTGTAATCCCAGCACTTTGGGAGGCCAAGGCAGGCAGACCACCTGAGGTCAGGAGTTCGAGATCAGCCTAGCCAACATGGTGAAACCCCATCTCTAGTAAAAATAAAATTAGCCAGGCATGGTGGTGCATGCCTGTAACGCAGGTCAGGAGTTCGAGATCAGCTTAGCCAACATGGTGAAACCCCATCTCTAGTAAAAATAAAATTAGCCAGGCAGGTGGTGCCGCCTGTACTCGGGAGGCTGAGGCAGGAGAATCACTTGAACCCAAGAGGCAGAGGTTGCAGTCAGCCAAGATCATGCCATTGCACTCCAGCCTAAGCAAAAAGAGTAAAACTCAGTCTCAAAACAAAAAAACAAAAAAA"
"chr15","21092189","21092737","JH378206","6546474","6546861","200","14545715","GCCGGGCGTGGTGGCTCACGCCTGGCCTGTAATCCCAGCACTTTGGGAAGCCAAGGCGGGTGGTTCACCTGAGGTCAGGAGTTCAAGACCAGCCTGGCCAACATGGTGAAACCCTGTCTCTACTAATAATACAAAAATTAGCTGGGCATGGTGGTGCATGCCTGTAATCCCAGCTACTTGGGAGGCCGAGGCGAGCAGATCACCTGAGGTCAAGAGTTCGATACCAGCCTGACCAACATAGAGAAACCCCGTCTCTACTAAAAATGCAAAATTAGCCGGGCATGGTGGTGCATGCCTGTAATCCCCAGCTACTCGGGAGGCTGAGGCAGGAGAATCGCTTGAACCTGGGAGGCAGAGGTTGTGGTGAGCTGAGATCACGCCATTGCACTCCAGCCTGGGCTCGAAACTCCATCTTAAAAAAAAAAAAAAAAAAAAGAATCACTTGAACCCAGGAGGTGGAGGTTGCAGTGAGCTGAGAGTGCACCATTGTACTCCAGCCTGGGCGACAACAGCAAAACTCCATCACCTTAAAAAAAAAAAAAAAAAAGA","GGCCACACATGGTGGCTAACGCCTGTAATCCCAGCACTTTGGGAGGCCAAGTCGGGTGGATCATGAGGTCAGGAGACCAAGACCATCCTGGCCAAATGGTGAAACCCCGTCTCTACTAAAAATACAAAAATTAGCTGGGCATGGTGGCGTGTGCCTGTAATCCCAGCTACTCAGGAGGCTGAGGCAGGACAATTGCCTGAACCCAGGAGAATTAGCTGGGCATGGTGGCGTGTGCCTGTAATCCCAGCTACTCAGGAGGCTGAGGCAGGACAATTGCCTGAACCCAGGAGGCGAAGGTTGCGGTGAGCCGAGATTGTGCCATTGCACTCCAGCCTGGGTAACAAGAGCGACACTCTGTCTCAAAAAAAAAAAAAAAAAAAAAAAAAAA"
"chr15","21150084","21150391","JH378158","10397018","10397312","55","10753066","GGCCGGGCATGGTGGCTTATGCCTGTAATCCCAGCACTTTGGGAGGCTGAGGTGGGTGGATCACCTGAGGTCAGGAGTTCAAGACCACCCTGGTCAACATGGCAAAATCCTGTCTCTACTAAAAATACAAAATTAGCTGGGCGTGGTGGTGGGCGTCTGCCTGGGTGAGGCAGGAGAATCGCTTGAACCCAAGAGGCAGAGGTTGGAGTGAGCCAAGATCGTGCCATTGCACTCCAGCCTGGGCAACGAGAGTGAAACCCCATCTCAGAAAAAAAAAAGAAAAAGAAAAAGAAAAAAGTAAAAAAAAA","GGCTGAGCACAGTGGCTCACACCTGTAATCCCAGCACTTTGGGAGGCCGAGGCGGGTGGATCACCTGAGATCAGGAGTTCAAGAACAGCCTGACCAACATGGTGAAACCTATCTCTACTAAAAATACAAAATTAGCCTGGCATGGTGGCGCGTGCCTGTAATCTGGCTGAGGCAGAAGAATCGCTTAAACCCAGAGGCAGAGATTGCAGTGAGCCAAGATTGTGTCATTGCACTCCAGCCTGGGCAACAAGAGCAAAACTCCATCTCAGAAAAAAAAAAAAAAAGAAGAAAAAAA"
"chr15","21563578","21564184","JH378118","18053084","18053501","255","3510494","GGCCAGGCATGGTGGCTCACACCTGTAATCGCAGCACTTTGGGAGACTGAGGCAAGCAGATCACCTGAGGTTAGAAGTTCAAGACCAGCCTGGCCAACACAGTGAAACCCCATCTCTACTAAAAATACAAAAAAATGGCCGGGTGCAGTGGCTCATGCCTGTAATCCCAGCACTTTGGGAGGCTAAGGCAGGGGGAATCACAAGGTCAAGAGATCAAGACCATCCTGGTAAAACCCCGTCGGTACTAAAAATACAAAAATTAGCTGGGTGAGGTGGCATGCACCTGTAGCCCCAGCTACTCGGGAGGCTGAGACAGGAGAATCACTTGAACCTGGGAGGCAGAGGTTGCAGTGAGCTGAGATCGCACCACTGCACTCCAGCCTGGCAACAGAGGAAGACTCTGTCTAAAACTAATAATAATAATAATAATAATAATAAAATTAGCTGGGAGTAGTGGCGGGCACCTGTAATCCCAGCTACTTGGGGGGGCTGAGGCAGGAGAAAAGCTTGAACCCGGGAGGTGAAGGTTGCAGTAAGCCAAGATCACGCCATTGCACTCCAGCCCGGGCAACAAGAGCGAAACTTCGTTTCAAAAAAAAAAAAAAAA","GGCTGGGCGCAGTGGCTCACACCTGTAATCCCAGCACTTAGGGAAGCTGAGGCGAGTAGATCACCTGAGGTCAGGAGTTAGAGACCAGCCTGGCCATCATGGTGAAACCCCGTCTCTACTAAAGATACCAAAAATTAGCTGAGTGTGGTGCTGGGTGCCTGTAATCCCAGAAACTCAGGGTGCCTGTAATCCCAGCAACTCAGGGTGCCTTTAATCCCAGCAACTGAGGGTACCAGTAATCCCAGCAACTCAGGGTGTCTTTAATCCTAGCAACTGAGGGCACCTGTAATCCCAGCAACTCAGGAAGCTGAGACAGGAGAAGTACTTGAACCCAGAAGGCAGAGGTTGCAGTGAGCCGATATTGCACCATTGCACTCCAGTCTGGGCAACAAGAGTGAAACTCTGTCTCAAAAAAAAA"
"chr15","22132229","22132799","JH378118","18053084","18053501","233","4079145","GGAGGCCAAGGTGGGCGAATCACCGGTGGTCAGGAGTTTGAGACTAGCCTGGCCAACATGGTGAAACCCCGTCTCTACTAAAAAATACAAAAATTAGGCCGAGTGTGGTGGCTCATGCCTGTAATCCCAGCAGTTTGGAAGGCCAAGGCGGGCAGATCACCTGAGGTCAGGAGTTCAAGACCAGCCTGGCCAACACAGTGGAACCCTGTCTCTACTAAAAATACAAAAAAAATTTGCCAGGCATGGTGGTGTGTGTGCCTATAATCCCAGCTACTCAGGAGACTGAGGCAAGAGAACTGCATGAACCCCAGAGGGAGAGGCTGCAGTGAGCTGAGATCGTACCACTGCACTCCAGCCTGGGTGACAGGGCAGGACTCCGTCTCAAAAAAAAAAAAAAAAAAAAAAAATTAGCCAGGTGTGGTGGCGAGCACCTGTAATCCTAGGTACTTGGGAGGCTGAGAAAGGAGAACCACTTGAACCCCGGAGGCAGAGGTTGCAGTGAGTGGAGATTGTGCGCCATTGCACTCCAGCCTGGGTGACAAGTGTGAAATTCTGCCTCAAAAAAAAAAAA","GGCTGGGCGCAGTGGCTCACACCTGTAATCCCAGCACTTAGGGAAGCTGAGGCGAGTAGATCACCTGAGGTCAGGAGTTAGAGACCAGCCTGGCCATCATGGTGAAACCCCGTCTCTACTAAAGATACCAAAAATTAGCTGAGTGTGGTGCTGGGTGCCTGTAATCCCAGAAACTCAGGGTGCCTGTAATCCCAGCAACTCAGGGTGCCTTTAATCCCAGCAACTGAGGGTACCAGTAATCCCAGCAACTCAGGGTGTCTTTAATCCTAGCAACTGAGGGCACCTGTAATCCCAGCAACTCAGGAAGCTGAGACAGGAGAAGTACTTGAACCCAGAAGGCAGAGGTTGCAGTGAGCCGATATTGCACCATTGCACTCCAGTCTGGGCAACAAGAGTGAAACTCTGTCTCAAAAAAAAA"
"chr15","23508255","23508883","JH378118","18053084","18053501","275","5455171","GGTCGGGTGTGGTGGCTCATGCATGTAATCCTGGCACTTTGGGAGGCCGAGGCGGGTAGATCACCTGAGGTCACGAGTTTGAGACCAGCCTGACCAACATGGTAAAACTTTGTTTCTACTACAAATACAAAAAATTGGCCAGGCTCGGTGGCTTCCGCCTGTAATCCCAGCACTTTGGGAGGCCGGGGTGCATGGATCACCTGAGGTCAGGACTTCGAGACCAGCCTGGCCAACATGGTGAAACCCCATCTCTACTAAAAATACAAAAAAAAAAAAAAAAATGAGCCAGGCATATTGGTGGGCGCCTGTAATCCCAGCTACTTGGAAGGCTGAGACAGGAGAATCACTTGAACCTGGGAGGCGGAGATTGCAGTGAGCCGAGATCATGCCACTGTACTCCATCCTGGGTGACAAGAGTGAGACTGCATCTCAAAAAAAAAAAAACCAAAAAACCAAAAAAAAACAAAAAATTAGTCAACCGTAGTGGTGGGCCCCTATAATCTCAGCTGCTCAGGAGGCTGAGGCAGTAGAATCACTTGATCCCAGGAGGTGGAGGTTTCAGTGAGCTGAGATCATGCCATTGTACTCCAGCCTGGGCAACAAGAGCGAAACTCTATCTCAAAAAATAA","GGCTGGGCGCAGTGGCTCACACCTGTAATCCCAGCACTTAGGGAAGCTGAGGCGAGTAGATCACCTGAGGTCAGGAGTTAGAGACCAGCCTGGCCATCATGGTGAAACCCCGTCTCTACTAAAGATACCAAAAATTAGCTGAGTGTGGTGCTGGGTGCCTGTAATCCCAGAAACTCAGGGTGCCTGTAATCCCAGCAACTCAGGGTGCCTTTAATCCCAGCAACTGAGGGTACCAGTAATCCCAGCAACTCAGGGTGTCTTTAATCCTAGCAACTGAGGGCACCTGTAATCCCAGCAACTCAGGAAGCTGAGACAGGAGAAGTACTTGAACCCAGAAGGCAGAGGTTGCAGTGAGCCGATATTGCACCATTGCACTCCAGTCTGGGCAACAAGAGTGAAACTCTGTCTCAAAAAAAAA"
"chr15","23602365","23603005","JH378118","18053084","18053501","286","5549281","GGTCGGGTGTGGTGGCTCATGCATGTAATCCTGGCACTTTGGGAGGCCGAGGCGGGTAGATCACCTGAGGTCACGAGTTTGAGACCAGCCTGACCAACATGGTAAAACCTTGTTTCTACTACAAATACAAAAAATTGGCCAGGCTCGGTGGCTTCCGCCTGTAATCCCAGCACTTTGGGAGGCCGGGGTGCATGGATCACCTGAGGTCAGGACTTCGAGACCAGCCTGGCCAACATGGTGAAACCCCATCTCTACTAAAAATACAAAAAAAAAAAAATGAGCCAGGCATATTGGTGGGCGCCTGTAATCCCAGCTACTTGGAAGGCTGAGACAGGAGAATCACTTGAACCTGGGAGGCGGAGATTGCAGTGAGCCGAGATCATGCCACTGTACTCCATCCTGGGTGACAAGAGTGAGACTGCATCTCAAAAAAAAAAAAAACCAAAAAACCAAAAAAAACCAAAAAATTAGTCAACCGTAGTGGTGGGCCCCTATAATCTCAGCTGCTCAGGAGGCTGAGGCAGTAGAATCACTTGATCCCAGGAGGTGGAGGTTTCAGTGAGCTGAGATCATGCCATTGTACTCCAGCCTGGGCAACAAGAGCAAAACTCTATCTCAAAAAAAAAAAAAAAAAAGAAAAA","GGCTGGGCGCAGTGGCTCACACCTGTAATCCCAGCACTTAGGGAAGCTGAGGCGAGTAGATCACCTGAGGTCAGGAGTTAGAGACCAGCCTGGCCATCATGGTGAAACCCCGTCTCTACTAAAGATACCAAAAATTAGCTGAGTGTGGTGCTGGGTGCCTGTAATCCCAGAAACTCAGGGTGCCTGTAATCCCAGCAACTCAGGGTGCCTTTAATCCCAGCAACTGAGGGTACCAGTAATCCCAGCAACTCAGGGTGTCTTTAATCCTAGCAACTGAGGGCACCTGTAATCCCAGCAACTCAGGAAGCTGAGACAGGAGAAGTACTTGAACCCAGAAGGCAGAGGTTGCAGTGAGCCGATATTGCACCATTGCACTCCAGTCTGGGCAACAAGAGTGAAACTCTGTCTCAAAAAAAAA"
"chr15","23603280","23603615","JH378109","21565230","21565567","55","2038050","GGCCAGGCGCGGTGGCTCATGCCTATAAACTCAGCACTTTGAGAGGCTGAGGCGGGTGGGTCACCTGAGGTCAGGAGTTAGAGACCAGCCTGGCCAACATGGTGAAACCGTGTTTCTACTAAAGATACAACATTAGCCAGGCATGGTGGCGCATGCCTGTAATCCCAGCTACTAGGGAGGCTGCGGCAGGAGAATCGCTTGAACGCAGGAGGTGAAGGTTGCAGTGAGCTGAGATCGTGCCATTGCACTCCAGCCTGGGTGACAAGAGCGAAACTCCATCCCAATCAATCAATCAATCAATCAATCAATTAAATTAAAAAAATAAAAAGAAAGAAA","GGCCGGGCGCGGTGGCTCAAGCCTGTAATACCAGCACTTTGGGAGGCCGAGGCGGGTGGATCACGAGGTCAAGAGATCGAGACCATCCTGGTCAACATGGTGAAACCCCGTCTCTACTAAAAATACAAACAATTAGCTGGGCATGGTGGCGGGTGCCTGTAATCCCAGCTACTCCAGAGGCTGAGGCAGGAGAATTGCCTGAACCCAGGAGACGGAGGTTGCGGTGAGCCAAGATCGCGCCATTGCACTCCAGCCTGGGTGACAAGAGCGAAACTCCGTCTCAATAAATAAATAAATAAATAAATAAATAAAAATAAAATAAATAAATAAATAAATAA"
"chr15","38315253","38315599","JH378169","5922203","5922541","56","32393050","GCCAGACACGGTGGCTCACGCCTGTAATCCCAGCACTTTGGGAGGCCGAGGCGGGTGGATCACCTGAGGTCAGGAGTTCGAGACCAGCCTGGCCAACATGGCGAAATCCTGTCTCTACTAAAAATACACACACACACACACACACACACACACACACACACACACATACACACACAAAATTAGCTGGGCATGGTGGCAGGTGCCTGTAATCCCAGCTACTTGGGAGGCTGAGGCAGGAGAATCACTTGAACCTGGGAGGCGGAGATTGCAGTGAGCCAAGATCATGCCATTGCACTTCAGCCTGGGCAACGAGAGTGAAACTCTGTCTCAAAAAAAAAAAAAAAAAA","GGCCAAGGGTGGTGGCTCACACCTGTAATCCCAACACTCTGGGAGGCCAAGGTGGGTGGATCACCTAAGGTCAGGAGTTCAAGACCAGCATGGCCAATATAGTGAAACTCTGTCTCTACTAAAAATACACACACACAAAAAAAAACAAAACACAAAAAAAACCACAAAATTAGCCGGGCATGGTGGCATGTGCCTGTAATCCCAGCTACTCAGGAGGCTGAGGCAGGAGAATCACTTAAACCCAGGAAGCGGAGGTTGCAGTGAGCCAAGATTGCGCCACTGCACTCCAGCCTAGGTGACAAGAGCAAAACTCTGTCTCAAAAAAAAAAAAAAAAAAAA"
"chr15","39410478","39411079","JH378118","18053084","18053501","249","21357394","GGCCGGGCACGGTGGCTCACGCCTGTAATCCCAGCACTTTGGGAGTCTGAGGTGGGCAGATCCACCTGAGGTCAGGGGTTCAAGACCAGCATGGCCAACATGGTGAAACCTCATCTCTACTAAAAATACAAAAATTAGGCTGGGTGCGGTGGCTCACGCCTGTAATCCCAGCACTTTGGGAGGCCAAGGCAGGTGGATCACCTGAGGTCAGGAGTTCGAGACCAGCATGGCCAACATAGCGAAAATCCGTCTCTACTAAAAACACAAAAATTAGCCAGGTGTGTTGGCTTACACCTGTAATCCCAGCTACACAGGAGGCTGAGGCAGAAGAATCACTTGAATCCAGGAGGTGGAGGTTGCAGTGAGCCGAGATCGCGCCACTGCCCTCCAGCCTGGGTGACAGAGCAAGACACCATCTCAAAAAAAAAAAAAAAAAAATTAGCTGGGCATGGTCACAGGTGCCCCTAATCCCAGCTACTCAGGAGGCTGAGGCAGGAGAATTGCTTGAACCCAGGAGACGGAGGTCACAGTGAGCGGTAATTGTGCCATTGCACTTCAACCTGGGTGACAAGAGCAAAAGTCCATCTCAAAAAAAAAAAAAA","GGCTGGGCGCAGTGGCTCACACCTGTAATCCCAGCACTTAGGGAAGCTGAGGCGAGTAGATCACCTGAGGTCAGGAGTTAGAGACCAGCCTGGCCATCATGGTGAAACCCCGTCTCTACTAAAGATACCAAAAATTAGCTGAGTGTGGTGCTGGGTGCCTGTAATCCCAGAAACTCAGGGTGCCTGTAATCCCAGCAACTCAGGGTGCCTTTAATCCCAGCAACTGAGGGTACCAGTAATCCCAGCAACTCAGGGTGTCTTTAATCCTAGCAACTGAGGGCACCTGTAATCCCAGCAACTCAGGAAGCTGAGACAGGAGAAGTACTTGAACCCAGAAGGCAGAGGTTGCAGTGAGCCGATATTGCACCATTGCACTCCAGTCTGGGCAACAAGAGTGAAACTCTGTCTCAAAAAAAAA"
"chr15","45225530","45226131","JH378133","19690365","19690767","253","25535165","GGCCGGGCACAGTGGCTCATGCCTGCAGTTCCAGCACTTTTGGAGGCCGAGGCAGGCCGATCACTTGAGGTCAGGAGTTCGAGACCACCCCGGCTAACGTGGTGCAACTCCATCTCTACTAAAAATACAAAATTGGCCGGGTGCGGTGGCTCATGCCTGTAATCCCAGCACTTTGGGAGGCCGAGGCGGATGGATCACCTCAGGTCAGGAGTTCGAGACCAGCCTGGCCAATGTGGTGAAACCCCGTCTCTACTAATAATACAAAAATTAACTGGGTGTGGTGGTGGGCACCTATAATCCCAGCTACTCGGGAAGCTGAGGCAGGAGAATCACTTGAACCTGGGAGGTGGAGATTGCAGTGAGCTGAGATGGTGCCATTACACTCCAGCCTGGGCAACGAGAGTGAAACTCTGTCTCTAAATAAATAAATACAAAATTAGCCGGGCATGGTGGCGGATGCCTATAATCACAGCTACTTGGGAGGCTGAGGCAAGAGAATCACTTGAACCTGGGAGGTGGAGGTTGCAGTGAGCTGAGATCAAGCCATTGCACTCCAGCCTGGGCAAAAAGAGTGAAACTCTGTCTCAAAAAAAAGAAAGAAA","GGCCAGGCACAGTGGTTCATGTCTGTAATCAGCATTTTGGGAGGCTGAGGCGGGAGAATCACCTGAGGCCAGGAGTTCTAGATGAGCCTGGGCAAATAGTGACAACCTGTCCCTACAAAAAAATTTAAAATTAGCCAGGATTGAGACCATCCTGGCTCACGTGGTGAAACCCCATCTTTACTTAAAATACTTAAAATGCAAAAAACATTTTTTTTTGTATTTTATTTAAAATACAAAAAAACTAGGCAGGCATGTTGGCACGTGCCTGTAGTCCCAGATACTTGGGAGGCTGAGGCAAGAGAATCACTTGAACCCAGGAGGTGGAGGTTGCAGTGAGCCGAGATCATACCACTGCACTCCAGCCTGGGTGACAAGAGTGAAACTCTGTCTCAAAAAAAAACAA"
"chr15","46581057","46581661","JH378118","18053084","18053501","254","28527973","GGCCGGGCGCGGTGGCTCACGCCTGTAGTCCCAGACTTTGGGAGGCCGAGGTGGGCGGATTGCCTGAGGTCAGGAGTTCAAGACCAACCTGGCCAACATGGTGAAATGCCGTCTCTACTAAAAATACAAAAATTAGGCCGGGCACGGTGGCTCATGTCTATAATCCCAGCACTTTGGGAGGCCGAGGTGGGCGGATCACGAGGTCAGGAGATCGAGACCATCCTGGCTAACACGGTGAAACCCCGTCTCTACTAAAAACACAAAAAATTAGCCGGGCGTGGTGGCAGGCACCTGTAGTCTCAGCTACTCAGGAGGCTGAGGCAGGAGAATGGCGTGAACTTGGGAGGCGGAGCTTGCAGTGAGCCAAGATTGTGCCACTGCACTCCAGCCTGGGCAACAGAGCGAGACTCTGTCTCAAAAAAAAAAAAAAAAATTAGCCAGGTGTGGTGGCAGGTGCCTGTAATCCCAGCTAATTGGGAGGCTAAGGCAGGAGAATCTCTTGAACCCAGGAGGCAGAGGTTGCAGTGAGCCAAGATTTCGCCATTACACTCCAGCCTGGGCAACAAGAGCTAGACTCCATCTCAAAAATAAATAAATAAAATAAA","GGCTGGGCGCAGTGGCTCACACCTGTAATCCCAGCACTTAGGGAAGCTGAGGCGAGTAGATCACCTGAGGTCAGGAGTTAGAGACCAGCCTGGCCATCATGGTGAAACCCCGTCTCTACTAAAGATACCAAAAATTAGCTGAGTGTGGTGCTGGGTGCCTGTAATCCCAGAAACTCAGGGTGCCTGTAATCCCAGCAACTCAGGGTGCCTTTAATCCCAGCAACTGAGGGTACCAGTAATCCCAGCAACTCAGGGTGTCTTTAATCCTAGCAACTGAGGGCACCTGTAATCCCAGCAACTCAGGAAGCTGAGACAGGAGAAGTACTTGAACCCAGAAGGCAGAGGTTGCAGTGAGCCGATATTGCACCATTGCACTCCAGTCTGGGCAACAAGAGTGAAACTCTGTCTCAAAAAAAAA"
"chr15","46659994","46660594","JH378118","18053084","18053501","247","28606910","GCTGGGCATGGTGGCTTACGCCTGTAATCCCAGCACCTTGGGAGGCTGAAGTGAGCAAATCACCTGAGTTCAGGAGTTCAAGACCAGCCTGGCCAACATGGTGAAAACCCATCTCTATTAAAAATTACAAAAATGGCCAGACACGGTAGCTCACGCCTGTAATCCCAGCACTTTGGGAGGCTGAGGCGGGCAGATCACCTGAGGTTGGGAGTTGGAGACCAGCTTGACCAACATGGAGAAACCCCCTCTCTACTAAAAATACAAAATTAGCCAGGCGTGGTGGCACATGCCTGTAATCCCAGCTACTTGGGAGGCTGAGGCAGGAGAATCACTTCAACCCGGAAGGTGGAGGTTGTGGTGAGCTGAGATTGTGTCATTGCACTCTAGCCTGGATAACAAAGGCAAAACTCAGTCTCAAAAAAAAAAAAAATTACAAAAATTAGCTGGCGTGGTGGCAGGTGCCTATAATCCCAGCTACTCAGGAAGCTGAGGCAGGAGAATCACTTGAAACCAGGAGGCAGAGGTTGCAGTGAGCTGAGACCACGCCATTGCCCTCCTGCCTGGGTGACAAGAGTGAAACTCCATCTCAAAAAAAAAAAAA","GGCTGGGCGCAGTGGCTCACACCTGTAATCCCAGCACTTAGGGAAGCTGAGGCGAGTAGATCACCTGAGGTCAGGAGTTAGAGACCAGCCTGGCCATCATGGTGAAACCCCGTCTCTACTAAAGATACCAAAAATTAGCTGAGTGTGGTGCTGGGTGCCTGTAATCCCAGAAACTCAGGGTGCCTGTAATCCCAGCAACTCAGGGTGCCTTTAATCCCAGCAACTGAGGGTACCAGTAATCCCAGCAACTCAGGGTGTCTTTAATCCTAGCAACTGAGGGCACCTGTAATCCCAGCAACTCAGGAAGCTGAGACAGGAGAAGTACTTGAACCCAGAAGGCAGAGGTTGCAGTGAGCCGATATTGCACCATTGCACTCCAGTCTGGGCAACAAGAGTGAAACTCTGTCTCAAAAAAAAA"
"chr15","46772064","46772669","JH378118","18053084","18053501","251","28718980","GGCTGGGTGCAATGGCTCATGCCTGTAATTCCAGTGTTTTGGGAGGCCGAGGCAGGTGGATCACTTGAGATCAGGAGTTCGCGACCAACCTGGCTAACATGGTGAAACCCCGTCTCTACTAAAAATACAAAAAATTGGCCAGGAGCGGTGGCTCAAACCTGTAATTCCAGCACTTTGGGAGGCCGAGGGGGGCAGATCACGATGTTTAGGAGTTTGAGATCAGACTGACCAACATGGTGAAACCCCATCTCTACTAAAAATACAAAAATTAGCCAGGCGTGGTGGTGCATGTCTGTAATCCCAGCTACTTGGGAGGCTGAGGCAGGAGAGTTGCTTGAAGCCGGGAGGTGGAGGTTGCAGTGAGCTGAGATCACACCACTGCACTCCAGCCTGGGCGACAGAGCAAGACTGTCTCAAAAAAAAAAAAAAAAAAAAAAATTAGCCAGCTTGGTGGCGGGCATCTGTAATCCCAGCTACTCGGGAGGCTGAGGCAGGAGAATCACTTGAACCCAGGAGGCAGAGGTCGCAGTGAGCCAAGATCACGCCATTGTACTCCAGCCTGGGCAACAAGAGCAAAACTCCATCTCAAAAAACAAAAAATAAAAA","GGCTGGGCGCAGTGGCTCACACCTGTAATCCCAGCACTTAGGGAAGCTGAGGCGAGTAGATCACCTGAGGTCAGGAGTTAGAGACCAGCCTGGCCATCATGGTGAAACCCCGTCTCTACTAAAGATACCAAAAATTAGCTGAGTGTGGTGCTGGGTGCCTGTAATCCCAGAAACTCAGGGTGCCTGTAATCCCAGCAACTCAGGGTGCCTTTAATCCCAGCAACTGAGGGTACCAGTAATCCCAGCAACTCAGGGTGTCTTTAATCCTAGCAACTGAGGGCACCTGTAATCCCAGCAACTCAGGAAGCTGAGACAGGAGAAGTACTTGAACCCAGAAGGCAGAGGTTGCAGTGAGCCGATATTGCACCATTGCACTCCAGTCTGGGCAACAAGAGTGAAACTCTGTCTCAAAAAAAAA"
"chr15","48446925","48447526","JH378118","18053084","18053501","252","30393841","GGCCAAGTGCAGTGGCTCACGTTTGTAATCCCAGCACTTTGGGAGGCCGAGGCGGGTGGATCACCTGATGTCAGGGGTTTGAAACCAGCCTGGCCAACATGGTGAAACCCCATCTCTAATAAAAATACAAAACTGGCCAGGTGCAGTGGCTCATGCCTGTAATCCCAGCACTTTGAGAGACCAAGGGAGGCAGATCACCTGAGGTCAGGAGTTCCAGACCAGCCTAGCCAACATGGTGAAACCCTATCTCTACTAAGAGTACAAAAATTAGCCTGGCGTGGTGGCAGGCGCCTGTAATCCCAGCTACTCAGAAGGCTGAGGCAGGAGAATCACTTGAACCCAGGAGGCGGAGGTTGCAGTGAGCCGAGATTGAGCCACTACACTCCAGCCTGGGTGACAAGAACAAGACTCTGTCTCAAAAAAAAAAAAAAAAAAAGCCGGTCATGGTGGCACATGCCTATAATCCCAGCTTCTTGGGAGGCTGAGGCAGGAGAACCACTTGAACCTGGGAGGTGGAGGCTGCAGTGAGCCGAAATTGTGCCATTGCACTCTAGCCTGGGCAACAAGAGCAAAACTCTCTCAAAAAAAAAAAAAAAAAAAAA","GGCTGGGCGCAGTGGCTCACACCTGTAATCCCAGCACTTAGGGAAGCTGAGGCGAGTAGATCACCTGAGGTCAGGAGTTAGAGACCAGCCTGGCCATCATGGTGAAACCCCGTCTCTACTAAAGATACCAAAAATTAGCTGAGTGTGGTGCTGGGTGCCTGTAATCCCAGAAACTCAGGGTGCCTGTAATCCCAGCAACTCAGGGTGCCTTTAATCCCAGCAACTGAGGGTACCAGTAATCCCAGCAACTCAGGGTGTCTTTAATCCTAGCAACTGAGGGCACCTGTAATCCCAGCAACTCAGGAAGCTGAGACAGGAGAAGTACTTGAACCCAGAAGGCAGAGGTTGCAGTGAGCCGATATTGCACCATTGCACTCCAGTCTGGGCAACAAGAGTGAAACTCTGTCTCAAAAAAAAA"
"chr15","59372839","59373447","JH378118","18053084","18053501","260","41319755","GGCCAGGATCAGTGTCTCACACCTGTAATCCTAGCACTTTGGGAGGCTAAGGTGGGCGGATTACTTGAGGTCAGGAGTTTGAGACCAGCCTGGGCAACATGGTGAAACCCCGTCTCTACTAAAAATACAAAAATTAGCTGGGCATAGGCCAGGAGTGGTGGCTTACGCCTGTAATTCCAGGACTTTGGGAGGCTGAGGCGGGCAGATCATGAGGTCAGGAGATTGAGACCATCCTGGCTAACATGGTGAAACCTCATCTCTACTAAAAATACAAAAATTAGCCAGTCGTGGTGGTAGGCGCCTGTAGTCCCAGCTACTTGAGAGGCTGAGGCAGGAGAATCACTTGAATCCGGGAGGTGGAGGTTGCAGTGAGCCGAGATTATGCCACTTCACTCCAACCTGGTGACAGAGCAAGACTCCGTCTAAAAAAAAAAAAAAAAATTAGCTGGGTGTGGCGGGCACTTGCAATCCCAGCTACTTAGGAGGCTGAGGCAGGAGAACCGCTTGAACCTGGGAGGTAGAGGTTCCAGATCACGCCATTGCACTCCTGCTTGGGCAACAAGAGTGACACTCCATCTCAAAAAAACAAAAAAAAAAAAGAAAAAGAAA","GGCTGGGCGCAGTGGCTCACACCTGTAATCCCAGCACTTAGGGAAGCTGAGGCGAGTAGATCACCTGAGGTCAGGAGTTAGAGACCAGCCTGGCCATCATGGTGAAACCCCGTCTCTACTAAAGATACCAAAAATTAGCTGAGTGTGGTGCTGGGTGCCTGTAATCCCAGAAACTCAGGGTGCCTGTAATCCCAGCAACTCAGGGTGCCTTTAATCCCAGCAACTGAGGGTACCAGTAATCCCAGCAACTCAGGGTGTCTTTAATCCTAGCAACTGAGGGCACCTGTAATCCCAGCAACTCAGGAAGCTGAGACAGGAGAAGTACTTGAACCCAGAAGGCAGAGGTTGCAGTGAGCCGATATTGCACCATTGCACTCCAGTCTGGGCAACAAGAGTGAAACTCTGTCTCAAAAAAAAA"
"chr15","64220715","64221335","JH378118","18053084","18053501","268","46167631","CCAGGCACAGTGGCTCATACCTGTAATCCCAGCACTTTGGGAGCCCAAGGCGGGCAGATCACCTGAGGTCAGGAGTTCGAGACCAGCCTGGACAACATGGAGAAACTCCATCTCTACTAAAAATACAAAATGAGGCCGGGCACAGTGGCTCACACCTATAATCCCAGCACTTTTGGAGGCCGAGACAGGCAGCTCACGAGGTCAGGAGTTCAAGACCAGCCTGGCCAGCATGGTGTAACCCCGTTTCTACTAAAAATACAAAAATTAGCCAGGCATGGTGGTGCGTGCCTGTAGTCCTCAGGAGGCTGAGGCAGGAGAATCGCTTGAATCTGGGAGGCGGAGCTTGCAGTCAGCTGAGATCAGGCTACTGCACTGCAGCTTGGGCAACAGAGTGAGACTCCGTCTCAAAAACAAACAAACAAACAAACAAAACACAACAAAATTAGCTGGGCATGGTGGCAGGTGCCTGTAATCCCAGCTACTCAGCTACTCAGGAGGCTGAGGCAGGAGAGTCACGTGAACCTGGGAGGCAGAGGTTGCAGTGAGCCAAGATCACGCCATTGCACTCCAGCCTGGGCAACAAGAGGGAAATTACATCTCAAAAAAAAAAAAAAAAAAAAA","GGCTGGGCGCAGTGGCTCACACCTGTAATCCCAGCACTTAGGGAAGCTGAGGCGAGTAGATCACCTGAGGTCAGGAGTTAGAGACCAGCCTGGCCATCATGGTGAAACCCCGTCTCTACTAAAGATACCAAAAATTAGCTGAGTGTGGTGCTGGGTGCCTGTAATCCCAGAAACTCAGGGTGCCTGTAATCCCAGCAACTCAGGGTGCCTTTAATCCCAGCAACTGAGGGTACCAGTAATCCCAGCAACTCAGGGTGTCTTTAATCCTAGCAACTGAGGGCACCTGTAATCCCAGCAACTCAGGAAGCTGAGACAGGAGAAGTACTTGAACCCAGAAGGCAGAGGTTGCAGTGAGCCGATATTGCACCATTGCACTCCAGTCTGGGCAACAAGAGTGAAACTCTGTCTCAAAAAAAAA"
"chr15","65873443","65873774","JH378165","3784440","3784761","45","62089003","GGCCAGGCACGGTGGCTCACACGTGTAATCCCAGCACCTTGGGAGACCGAAGCAGGTGGATCACCTGAGGTCAGGAGTTTGAGGCCAGCCTGGCCGATATGGTGAAACCCTATCTCTATTAAAAATACCAAAAAAAAAAAAAAAAAAAAAAAAACCTGCTGGGCGTGGTGGCGCACGCCTGTAATCCCAACTACTCAGGAGGCTGAGGCAGGAGAATCACTTGAATCCAGGAGGCAGAGGTTGCAGTGAGCCGAGATCGCGCCATTGCACTCCAGCCTGGGCAACAAGAGCGAAACTCGGTCTCAAAAAAAAAAAAAAAAAAAGAAAAGAAA","GGCCGGGCGCGGTGGCTCAAGCCTGTAATCCCAGCACTTTGGGAGGCCGAGGCAGGTGGATCATGAGGTCAAGAGATCAAGACCATCCTGGTCAACATGGTGAAACCCCGTCTCTACTAAAAATACAAAAAAAAAAAAAAAAAAACTAGCTGGGCGTGGTGGCGCATGCCTGTAATCCCAGCTACTCAGGAGGCTGAGGCAGGAGAATTGCTTGAACCCAGGAGGCGGAGGTTGCGGTGAGCCCAGATCGCGCCATTGCACTCCAGCCTGGGTAACAAGAGCAAAACTCCATCTCAAAAAAAAAAAAAAAAAAAAAAAAAAA"
"chr15","70453292","70453944","JH378118","18053084","18053501","292","52400208","GGCCAGGCACGGTGGCTCATGCCTGTAATCCCAACACTTTGGGAGGCTGAGGTAGGTAGATCACCTGAGGTTGAGGTCAGGAGTTTGAGACCAGCCTGGCCAACATGGTGAAACTCTGTCTCTACTAAAAATACAAAAATTTGGCCCGGCGCAGTGGCTCACCTGTAATCCCAGCACTTTGGGAGGCCGAGGCAGGCAGATCACGAGGTCTGGAGATCAAGACCATCCTGGCTAACTCGGTGAAATCCCATCTCTACTAAAAATACGAAAAATTAGCCAGGTGTGGTGGCGGGCACCTGTAGTCCCAGCTACTTGGGAGGCTGAGGCAGGAGAATGGCGTGAACCTGGGAGGTGGAGCTTGCAGTGGGCCAAGATCACGCCACTGCACTCCAGCCTGGGCAACAGAGTGAGACTCTGTCTCAAAATAAAATAACATAAAATAAAATAAAGTAATATAAAATAAAAATACAAAAATTAGCTGGGCATGGTAGCGGGTACCTATAATTCCAGCTACTTGAGAGGCTGAGGCTGGAGAATCACTTGAATCTGGGAGGTGGAGGTTGCAGTGAGCCAAGATTGCACCATTGCACTCCAGCCTGGGCAACAAGAGCCAAACTCCGTATCAAAAAAAAAAAAAAAAAGAAAAAGAAAAA","GGCTGGGCGCAGTGGCTCACACCTGTAATCCCAGCACTTAGGGAAGCTGAGGCGAGTAGATCACCTGAGGTCAGGAGTTAGAGACCAGCCTGGCCATCATGGTGAAACCCCGTCTCTACTAAAGATACCAAAAATTAGCTGAGTGTGGTGCTGGGTGCCTGTAATCCCAGAAACTCAGGGTGCCTGTAATCCCAGCAACTCAGGGTGCCTTTAATCCCAGCAACTGAGGGTACCAGTAATCCCAGCAACTCAGGGTGTCTTTAATCCTAGCAACTGAGGGCACCTGTAATCCCAGCAACTCAGGAAGCTGAGACAGGAGAAGTACTTGAACCCAGAAGGCAGAGGTTGCAGTGAGCCGATATTGCACCATTGCACTCCAGTCTGGGCAACAAGAGTGAAACTCTGTCTCAAAAAAAAA"
"chr16","217191","217526","JH378138","4229795","4230103","77","4012604","ATTTTGGGAGGCTGAGATGAGTGATGAGCGGATCACCTGAGGTCAGGAGCTCGAGACCAGTCTGGCCAACACGGTGAAACCCTGTCTCTACTAAAAGTACCAAAAAAATTAGCCAGGCATGGCAGTGGGCGCCTGTAATCCCAACTACTCGGGAGGCTGAGGCAGGAGAATCACTTGAACCTGGGAGGTGGATGTAGCAGTGAGCCGGGATCGTGCCACTGAACTCCAGCCTGGGCGATAAGATCAAAACTCTGTCTCTCTCTCACACACACACACACACACACACACACACACACACACACCCCCAAAAAAAAAAACAAAAAAAAGAAAAAGAAA","CACTTTGGGAGGTGAAGGCGGGCAGATCACCTGAGGTCAGGAGTTCGAGACCAGCCTGGCCAACATGGTGAAACCCCGCCTCTACTAAAAATACAAAAATTAGCCAGGTGTGACACTAGGCATCTGTAATCCCAGCTACTTGGGAGGCTGAGACAGGAGAATCACTTGAACCCAGGAGGCGGAAGTTGCAGTGAGCCAAGATCATGCCATTGCACTCCAGCCTGGGTGACAGGAGCAAAACTCTGTCTCAAAAAAAAAAAAAAAAAAAAAAAAAAAAAAAAAAAAAAAAGAAAAGAAAAGAAAAGTAAA"
"chr16","384893","385508","JH378118","18053084","18053501","265","17668191","GGCCGGGCGTGGTGGCTAACACGGGTAGTCCTAGCACTTTGGGAAGCCAAGGCAGGCAGATCACTTGAGGTCAGGAGTTTGAGATCAGTCTGGCCAACATGGTGAAACCACGCCTCTACTAAAAATACAAAAGTTATGGCCGAGCGTGGTGGCACGCGCCTGTAATCCCAGCACTTTGGGATGCTGAGGCAGGCGCATCACCTAAGGTCGGGAATTCAAGACCAGCCTGACCAACATGGAGAAACCACGTTTCTACTAAAAATACAAAATTAGCCGGGTGTGGTGGCACATGCCTGTAGTTTCAGCTACTCAGGAGGCTGAGGCAGGAGAATCACTTGAATCCGGGAGGCGGAGATTGTGGTGAGCCGAGATCGGGCCATTGCACTCCAGCCTGGGCAACAAGAGAGAAACTCTGTCTCAAAAAAAAAAAAAAAAAATTAGCCAGGCATGGTAGCCTGTGCCTGTAATCCCAGCTACTTGGGAGGCTGAGGCAGGAGAATCGCTTGAACCTGGGAGGCAGAGGTTGCAGTGAGCCGCGATTGCGCCATTGCACTCTCCAGCCTGGGGGAGAAGAGCAAAACTCCATCTCAAAAATAAATAAATAAATAAAAATAAA","GGCTGGGCGCAGTGGCTCACACCTGTAATCCCAGCACTTAGGGAAGCTGAGGCGAGTAGATCACCTGAGGTCAGGAGTTAGAGACCAGCCTGGCCATCATGGTGAAACCCCGTCTCTACTAAAGATACCAAAAATTAGCTGAGTGTGGTGCTGGGTGCCTGTAATCCCAGAAACTCAGGGTGCCTGTAATCCCAGCAACTCAGGGTGCCTTTAATCCCAGCAACTGAGGGTACCAGTAATCCCAGCAACTCAGGGTGTCTTTAATCCTAGCAACTGAGGGCACCTGTAATCCCAGCAACTCAGGAAGCTGAGACAGGAGAAGTACTTGAACCCAGAAGGCAGAGGTTGCAGTGAGCCGATATTGCACCATTGCACTCCAGTCTGGGCAACAAGAGTGAAACTCTGTCTCAAAAAAAAA"
"chr16","1668152","1668787","JH378118","18053084","18053501","287","16384932","GGCCGGGCACGGTGCCTCGTTCCTGTAATCCCAGCACTTTGGGAGGCCAAGGTGGGTGGATCACCTGAGGTCAGGAGTTCGAGACATGCCTGGCCAACATGGCAAAATCCTGTCTTTACTAAAAATACAAAAATTAAGCCGGGCGCTGTGACTCATGCCTGTAATCCCAGCACTTTGGGAGGCCAAGGCGGGCGGATCACAAGGTCAGGAGATTGAGACCATCCTGGCTAACACGGTGAAAACCCGTCTCTACTAAAAATACAAAAAATTAGCCAGGTGTGGTGGCGGGTGCCTGTAGTCCCAGCTACTCGGGAGGCTGAGGCAGGAGAATGGCGTGAACCCGGGAGGCGGAGCTTGCAGTGAGCCGAGATCGTGCCACTGCACTCCAGTCTGGGCAACAGAGCAAGACTCTCTCTCAAAAAGAAACAAACAAAAAAAAAAATGAAAAAAGAAAAATTAGCCAGGCGTGGTGGCGGGTGCCTATAATCTCAGCTACTCGGGAGGCTGAGGCAGAAGTATCATTTGAACCCAGGAGGCGGAGGTTGTAGTGATCCAAGATAGCGCCATTGCACTGCAGCCTGGGTGACAACAGTGAAACTCCGTCTCAAAAAAAAAAAAAAAAAAGAAAGAAAGAAA","GGCTGGGCGCAGTGGCTCACACCTGTAATCCCAGCACTTAGGGAAGCTGAGGCGAGTAGATCACCTGAGGTCAGGAGTTAGAGACCAGCCTGGCCATCATGGTGAAACCCCGTCTCTACTAAAGATACCAAAAATTAGCTGAGTGTGGTGCTGGGTGCCTGTAATCCCAGAAACTCAGGGTGCCTGTAATCCCAGCAACTCAGGGTGCCTTTAATCCCAGCAACTGAGGGTACCAGTAATCCCAGCAACTCAGGGTGTCTTTAATCCTAGCAACTGAGGGCACCTGTAATCCCAGCAACTCAGGAAGCTGAGACAGGAGAAGTACTTGAACCCAGAAGGCAGAGGTTGCAGTGAGCCGATATTGCACCATTGCACTCCAGTCTGGGCAACAAGAGTGAAACTCTGTCTCAAAAAAAAA"
"chr16","2310740","2311369","JH378118","18053084","18053501","271","15742344","GGCCGGGCACAGTGGCTCACGCCTATAATATCAGCACTTTGGGAGACCAAGGCGGGTGGATCACCTAAGGTCAGGAGTTCAAGACCAGCCTGACCAACATGGTGAAACCCCATCTCTACCAAAAATAGAAAACATTAGTCTTGGCCGGGCACGGTGACTCATACCTGTAATTCCAGCACTTTGGGAGGCCGATCACCTGGCGGATCACCTGAGGTCGGGAGTTTGAGACCAGCCTGACCAACATGGAGAAACCCCGTCTCTACTAAAAATACAAAATTAGCTGTGCGTAGTGGCCCATGCGTGTAATCCCAGCTACTCAGGAGACTGAGGCAGGAGAATGGCTTGAACCTGGGAGGCGGAGGTTGTGCTGAGCCAAGATCGCACCATTGCACTCCAGCCTGGGCAATAAGAGTGAAACTCCGTTTCATAAAACAAAAAACAAAAAACAAAAAAAAAACCATTAGCCAGGCATTGTGGCAGGCACCTGTAATCCCAGCTACTCAGGAGGCTGAGGCAGAATGGCTTGAACCGGGGAGGCAGAGGTTGCAGTGAGCCGAGATCGCGCCATTGCACTCCAGCCTGGGCAACAAAAGTAAAACTCTGTCTCAAATAAAAAAAAGAGAGAAAAAA","GGCTGGGCGCAGTGGCTCACACCTGTAATCCCAGCACTTAGGGAAGCTGAGGCGAGTAGATCACCTGAGGTCAGGAGTTAGAGACCAGCCTGGCCATCATGGTGAAACCCCGTCTCTACTAAAGATACCAAAAATTAGCTGAGTGTGGTGCTGGGTGCCTGTAATCCCAGAAACTCAGGGTGCCTGTAATCCCAGCAACTCAGGGTGCCTTTAATCCCAGCAACTGAGGGTACCAGTAATCCCAGCAACTCAGGGTGTCTTTAATCCTAGCAACTGAGGGCACCTGTAATCCCAGCAACTCAGGAAGCTGAGACAGGAGAAGTACTTGAACCCAGAAGGCAGAGGTTGCAGTGAGCCGATATTGCACCATTGCACTCCAGTCTGGGCAACAAGAGTGAAACTCTGTCTCAAAAAAAAA"
"chr16","3075498","3075819","JH378114","26407278","26407597","46","23331780","GGCCAGGCGCGGTGGCTCACACCTGTAATCCCAGCACTTTGGGAGGCCAAGGCGGGCAGATCACGAGGTCAAGAGATCGAGACCATCCTGGCCAACCTGGTGAAACTCTGTCTCTACTAAAAATACCAAAAAAAAAAAAAAAAAAAAAAAAAAAAAGCATGGTGGCAGGTGCCTGTAATCCCAGCTACTTGGGAGGCTGAGGCAGAATTGCTTGAACCCGGGAGGCAGAGGTTGCAGTGAGTTGAGATCATGCCATTGCACTCCAGCCTGGGCAAAAAGAGCGAAACTCTGTCTCAAAAAACAAAACAAAAACAAAAACAAA","GGCCGGGCGCAGTGGCTCAAGCTTGTAATCCCAGCACTTTGGGAGGCCGAGGCGGGTGGATCACGAGGTCAAGAGATCGAGACCATCCTGGTCAACATGGTGAAACCCCGTCTCTACTAAAAATACAAAAAAAAAAAAAAAAAATTAGTTGGGCATGGTGGTGTGTGCCTGTAATCCCAGCTACTCAGGAGGCTGAGGCAGGAGAATTGCCTGAACCCAGGAGGCGGAGGTTGCGGTGAGCCGAGATCGCGCCATTGCACTCCAGCCTGGGTAACAAGAGCGAAACTCCGTCTCAAAAAAAAAAAAAAAAAAAAAAAAAA"
"chr16","3161549","3162150","JH378118","18053084","18053501","252","14891535","CTGGGCACCGTGGCTCACGCCTGTAATCCCAACACTTTGGGAGGCCAAGGCGGGTGGAACACCTGAAGTCAGGAGTTCGAGACCAGTCTGGACAACATGATGAAACCCCGTCTCTACTAAAAATACAAAAAGTAGCCAGGTATGGCCGGGCGCGGTGGCTCACGCCTGTAATCCCGGCACTTTGAGAGGCCGAGGCAGGTGGATCACAAGGTCAGGAGTTCAAGAGCAGCCTGGCCAAGATAGTGAAACCCCGTCTCTACTAAAAGCAAAATTACAGTGCGCCTGTAATCCCAGCTGCTCGGGAGGCTGAGGCAGGAGAATCGCTTGAACCTGGAGGGCGGAGGTTGCAGTGAGCCAAGATCGCTCTACTGCACCCTAGCCTGGGTGACAGAGCAAGACTCTGTATCAAAAAAAAAATAAATAAATAATTAGCCAGGTATGGTGGTGCAGGCTTGTAATCCTAGCTGCTCAGGAGGCTGAGGCAGGAGAATCGATTGAACCCAGGAGACGGAGGTTGCAGTGAGCAGAGATCACACCATTGTACTCCAGCCTGAGTGACAAAAACGAAACTCCGTCTCAAAAAAAAACCAAAAAAACAAAAA","GGCTGGGCGCAGTGGCTCACACCTGTAATCCCAGCACTTAGGGAAGCTGAGGCGAGTAGATCACCTGAGGTCAGGAGTTAGAGACCAGCCTGGCCATCATGGTGAAACCCCGTCTCTACTAAAGATACCAAAAATTAGCTGAGTGTGGTGCTGGGTGCCTGTAATCCCAGAAACTCAGGGTGCCTGTAATCCCAGCAACTCAGGGTGCCTTTAATCCCAGCAACTGAGGGTACCAGTAATCCCAGCAACTCAGGGTGTCTTTAATCCTAGCAACTGAGGGCACCTGTAATCCCAGCAACTCAGGAAGCTGAGACAGGAGAAGTACTTGAACCCAGAAGGCAGAGGTTGCAGTGAGCCGATATTGCACCATTGCACTCCAGTCTGGGCAACAAGAGTGAAACTCTGTCTCAAAAAAAAA"
"chr16","3211652","3212251","JH378118","18053084","18053501","260","14841432","GTCAGACGCAGTAGTTTATGCCTGTAATCCTTGCACTTTGGGAGGCAGGTGGATCACCTGAGGCCAGGAGTTGGAGACCAGCCAGGCCAATATGGCAAAACCCCGTCTCTACTAAAAATACAAAAACTAGCCGGGCGCAGTGGCTCACACCTGTAATCCCAGCACTTTGGGAGGCTGAGGTGGGTGGATCACTAGGTCAGGAGTTCAAGACCAGCCTGGCCAACATGGTGAAACCGCGTCTCTACTAAAAACACCAAAAAATTAGCTGGGCGTGGTGGCAGTCGCCTGTAATCCCTGCTACTCGGAAGGCTGAGGCAGGAGAATCACTTGAACGCAGGAGGCAGAGGTTGCGGTGAGCCGAGATCACGCCACTGCACTCCAGCCTGGGTGACAGAGCAAGACTCTGTCTCAAAAAACAACAACAACAACTAGCTGGGCGTGGTGGCACATGCCTGTAACCCCAGCTACTCAGGAGGCTGAGGCTGAGGGAGAAAAATCGCTTGTACCTGGGAGGTGGAAGTTGCAGTGAGCGGAGATCCCACCATTGCACTCCAGCCTGGGTGACAAGAGCGAAACTCCATCTCAAAAAAAAAAAAAAAA","GGCTGGGCGCAGTGGCTCACACCTGTAATCCCAGCACTTAGGGAAGCTGAGGCGAGTAGATCACCTGAGGTCAGGAGTTAGAGACCAGCCTGGCCATCATGGTGAAACCCCGTCTCTACTAAAGATACCAAAAATTAGCTGAGTGTGGTGCTGGGTGCCTGTAATCCCAGAAACTCAGGGTGCCTGTAATCCCAGCAACTCAGGGTGCCTTTAATCCCAGCAACTGAGGGTACCAGTAATCCCAGCAACTCAGGGTGTCTTTAATCCTAGCAACTGAGGGCACCTGTAATCCCAGCAACTCAGGAAGCTGAGACAGGAGAAGTACTTGAACCCAGAAGGCAGAGGTTGCAGTGAGCCGATATTGCACCATTGCACTCCAGTCTGGGCAACAAGAGTGAAACTCTGTCTCAAAAAAAAA"
"chr16","3990675","3991277","JH378118","18053084","18053501","250","14062409","GGCTGGGCGTGGTGGCTCACGCCTTTAATCCCAGTACTTTGGGAGGCCGAGAAGGGCACATCACCTGAGGTCAGGAGTTTGAGACCAGCCTGGCCAATATGGTAAAACCCTGTCTCTACTTAAAAAATAGAAAAATCAGGCTGGACGCAGTGGCTCACGCCTGTAATCCCAGCACTTTGGGAGGCCGAGGCGGGTGGATCATGAGGTCAGGAGTTACCAGCCTGCCAACATGGTGAAACCCCATCTCTACTAAAAAAACAAAAAAAATTAGCCAGTCGTAGTGGCAGGCACCTGTAATCCCAGCCACTCGGGAGGCTGAGGCAGAGAATTGCTTGAACCTGGGAGGTGGAGATTGCTGTGCACCAAAATCACACCACTGCACTTGAGCCTGGGCGACAGAGGGAGACTCATCTGAAAAAAAAAAAAAAAAAAAAATTAGCCGGTTATGGTGGCAGGTGCCTGTGATCCCAGCTACTTGGGAGGCTGAGGCAGGAGAATTGCTTGAACCCGGGAGGCAGAGGTTGCAGTGAGCTGAGATCGCACCACTGCACTCCAGCCTGGAGGACAAGAGTGAGACTTGTCTGATTGGAAAAAAAAAAAAAA","GGCTGGGCGCAGTGGCTCACACCTGTAATCCCAGCACTTAGGGAAGCTGAGGCGAGTAGATCACCTGAGGTCAGGAGTTAGAGACCAGCCTGGCCATCATGGTGAAACCCCGTCTCTACTAAAGATACCAAAAATTAGCTGAGTGTGGTGCTGGGTGCCTGTAATCCCAGAAACTCAGGGTGCCTGTAATCCCAGCAACTCAGGGTGCCTTTAATCCCAGCAACTGAGGGTACCAGTAATCCCAGCAACTCAGGGTGTCTTTAATCCTAGCAACTGAGGGCACCTGTAATCCCAGCAACTCAGGAAGCTGAGACAGGAGAAGTACTTGAACCCAGAAGGCAGAGGTTGCAGTGAGCCGATATTGCACCATTGCACTCCAGTCTGGGCAACAAGAGTGAAACTCTGTCTCAAAAAAAAA"
"chr16","4259838","4260446","JH378118","18053084","18053501","263","13793246","GGCCGGGTGCAGTGGCTCACGCCTGTAATCGCAGGACTTTGGGAGGCCAAGGCAGGTGCATCACCTGAGGTCAGGATTTCAAGACCATCCAGCCTGATCAACATGGTGAAACCCTGTCTCTACTAAAAATATAAAAATTGGCCGGGCACAGTGACTCACGCCTGTAATCCCAGCACTTTGGGAGGCTGAGGCAGGTGGATCACAAGGTCAGGAGATCGAGACCATCCTGGCTAACACAGTGAAACCCCGTCTCTACTAAAAATATAAAAAATTAGCCGGGCGTGGTGGTAGGCACCTGTAGTCCCAGCTACTCGGGAGACTGAGGCAGGAGAATGGCGTGAACCTGGGAGGTGGAGCTTGCAGTGAGCAGAGATCGCGCCACTGTACTCCAGCCTGGGTGACAGAGCGAGACTCCGTCTCAAAAAAAAAAAAAAAAAAAAAAATTAGCTGGGCGTGGTGGCGGGCACCTGTAATCCCAGCTACTTGGGAGGCTGAGGCAGGAGAATTGCTTGAACCTGGGAAGTGGAGGTTGCAGTGAGCTGAGATTGTGCCCTTGTACTCCAGCCTGGGCAATAAAAGCAAAACTCCGTCTTAAAAAAAAAAAAAAAA","GGCTGGGCGCAGTGGCTCACACCTGTAATCCCAGCACTTAGGGAAGCTGAGGCGAGTAGATCACCTGAGGTCAGGAGTTAGAGACCAGCCTGGCCATCATGGTGAAACCCCGTCTCTACTAAAGATACCAAAAATTAGCTGAGTGTGGTGCTGGGTGCCTGTAATCCCAGAAACTCAGGGTGCCTGTAATCCCAGCAACTCAGGGTGCCTTTAATCCCAGCAACTGAGGGTACCAGTAATCCCAGCAACTCAGGGTGTCTTTAATCCTAGCAACTGAGGGCACCTGTAATCCCAGCAACTCAGGAAGCTGAGACAGGAGAAGTACTTGAACCCAGAAGGCAGAGGTTGCAGTGAGCCGATATTGCACCATTGCACTCCAGTCTGGGCAACAAGAGTGAAACTCTGTCTCAAAAAAAAA"
"chr16","4899850","4900511","JH378118","18053084","18053501","313","13153234","GGCCAGGCACGGTGGCATGCACCTGTAATCTCAGCTCTTTGGGAGGCTGAGGCAAGAGGATCACTTGAGCCCAGGAGTTGGTGATTGCAGTGAGCTCTGATCACTCCACTGCACTCCAGCCTGGGTGACAGAGTGAGATCCTGTCTCTACGAAAAAAAGACAAGACACAAATACGTTAAAAGTAAAATGATATAAAAAGATATTCCAGTGGGGCACAGTGGCTCACCCCTATAATCCCAACACTTTGGGAGGCTGAGGTGGGTGGATCACCTGAGGTCAGGAATTCAAGACCAGCCTGACCAACATGGAGAAACCCGTCTCTACTAAAAATACAAAATTAGCCGGGTGTGGTGGCACATGCCTGTAATCCCAGCTACTCAGGAGGCTGAGAATGGCTTGAACCTGGGAGGTGGAGGTTGTGGTGAGCCGAGATTGCACCACTGCACTCCAGCCTGGGCAACAAGAGCTGAAACTCCGTCGAAAAAAAAAATTAGCCTGGCGTGGTGGCGGGAGCCTGTAATCCCAGCTACTGGGGAGGCTGAGGCAGGAGAATCACTTGAACCTGGGAGGCAGAATTTGCAGTGAGCCGAGATCGCGCCACCACACTCCAGCCTGGGTGACAAAAACGAAACCCCATCTCAAAAAAATTAAAAAATAACAAA","GGCTGGGCGCAGTGGCTCACACCTGTAATCCCAGCACTTAGGGAAGCTGAGGCGAGTAGATCACCTGAGGTCAGGAGTTAGAGACCAGCCTGGCCATCATGGTGAAACCCCGTCTCTACTAAAGATACCAAAAATTAGCTGAGTGTGGTGCTGGGTGCCTGTAATCCCAGAAACTCAGGGTGCCTGTAATCCCAGCAACTCAGGGTGCCTTTAATCCCAGCAACTGAGGGTACCAGTAATCCCAGCAACTCAGGGTGTCTTTAATCCTAGCAACTGAGGGCACCTGTAATCCCAGCAACTCAGGAAGCTGAGACAGGAGAAGTACTTGAACCCAGAAGGCAGAGGTTGCAGTGAGCCGATATTGCACCATTGCACTCCAGTCTGGGCAACAAGAGTGAAACTCTGTCTCAAAAAAAAA"
"chr16","4919663","4920295","JH378118","18053084","18053501","281","13133421","CTGGGCGCAGTGGCTCACACCTATAATCCCAGCACTTTGGGAGGCCGAGGTGGGGTGGATCACTTGAGGTCAGGAGTTTGAGACCAGCCTGGCCAACATGGTGAAACCCCATCTCTTCTAGAAAAATACAAAATTAGGCTGGGCGCGGTGGCTCACGCTTGTAATCCCAGCACTTTGGGAGGCTGAGGCAGGCGGATCATCTGAGGTTGGGAGTTCGAGACCAGCCTGACCAACATAGAGAAACCCTGTCTCTACTAAAAATACAAAATTAGCCGGGCGTGGTGGCGCATGCCTGTAATCCCAGCTAGTCAGGAGGCTGAGGCAGGAGAATCCCTTGAACTGGGGAGGCAGAGGTTGTGGTGAGCCCAGATCGTGCCATTGCACTCCAGCTTGGGTAAGAAGAGCAAAACTCTGTCTAAAAAATATATATATTTATACATATATATATATTTATATATATAATTAGCCACGCATAGTGGCACACACCTGTAACCCCAGCTACCTGGGAGGATGAGGCAGGAGAATAGCTTGAACTTGGGAGGTGGAGGTTGCACTGAGCTGAGACTGCGCCATTGCATTCCAGCCTGGGCAACAAGAGCGAAACTGTCTCAAAAAAAAAAAAAAAAAAAAAAA","GGCTGGGCGCAGTGGCTCACACCTGTAATCCCAGCACTTAGGGAAGCTGAGGCGAGTAGATCACCTGAGGTCAGGAGTTAGAGACCAGCCTGGCCATCATGGTGAAACCCCGTCTCTACTAAAGATACCAAAAATTAGCTGAGTGTGGTGCTGGGTGCCTGTAATCCCAGAAACTCAGGGTGCCTGTAATCCCAGCAACTCAGGGTGCCTTTAATCCCAGCAACTGAGGGTACCAGTAATCCCAGCAACTCAGGGTGTCTTTAATCCTAGCAACTGAGGGCACCTGTAATCCCAGCAACTCAGGAAGCTGAGACAGGAGAAGTACTTGAACCCAGAAGGCAGAGGTTGCAGTGAGCCGATATTGCACCATTGCACTCCAGTCTGGGCAACAAGAGTGAAACTCTGTCTCAAAAAAAAA"
"chr16","5124255","5124811","JH378118","18053084","18053501","213","12928829","GGCCAGGTGCGGTGGCTCATGCGTGTAATCCCAGCGCTTTGGGAGGCTGAGGCAAGTGGATCACCTGAGGTCAGGAGTTTGAGACCAGCCTGGCCAACATGGGGAAATCCCTGTCTCTACTAAAAATACAAAAATTGGGCCGGGTGTGGTGGCTCACACCTGTAATCCCAGCACTTTGGGAGACTGAGGTGGGCGGATCACCCAAGGTCAGGAGTTTGAGACCATCCTGGCCAACATGGTGAAACCCCGTCTCTACTAAATAAATACAAAAAAGTAGCCGAGCGTGTTGGCGGATGCCTGTAATCCCAGCTACTTGGGAGGCTGAGGCAGGAGAATTGCTTGAACCCTGAGAGGTGGAGGTTGCAGTGAGCAGAGATTGTGCCACTGCACTCTGGCCTGGGCGACAAGAGGGAGTCTCTGTCTTAAAAAAAAAAAAAAAAAAAATTAGCTGGAAATCGCTTGAACCCAGGAGGCGGAGGTTGCAGTGAGCCGAGATTGTGCCACTGCACTCTGGCCTGGGCGACAAGAGCGAGATTCTGTCTCAAAAAAAAAAAAGA","GGCTGGGCGCAGTGGCTCACACCTGTAATCCCAGCACTTAGGGAAGCTGAGGCGAGTAGATCACCTGAGGTCAGGAGTTAGAGACCAGCCTGGCCATCATGGTGAAACCCCGTCTCTACTAAAGATACCAAAAATTAGCTGAGTGTGGTGCTGGGTGCCTGTAATCCCAGAAACTCAGGGTGCCTGTAATCCCAGCAACTCAGGGTGCCTTTAATCCCAGCAACTGAGGGTACCAGTAATCCCAGCAACTCAGGGTGTCTTTAATCCTAGCAACTGAGGGCACCTGTAATCCCAGCAACTCAGGAAGCTGAGACAGGAGAAGTACTTGAACCCAGAAGGCAGAGGTTGCAGTGAGCCGATATTGCACCATTGCACTCCAGTCTGGGCAACAAGAGTGAAACTCTGTCTCAAAAAAAAA"
"chr16","8088191","8088522","JH378114","21211700","21212024","70","13123509","GGCTGGGCGCGGTGGCTTTTGACCATAATCCCAGCACTTTGGGAGGCCGAGGTGGTCAGGTCACCTGAGGTCAGGAGTTCAAGAGCAGCCTGGCCAACGTGGTGAAACTCTGTCTCTACCAAAAATACCAAATAATAATAATAATAATAATAATAATAATAAAATAATATAATTGCAGGGTGTGGCAGCCCATGCATGTAATGCCAGCTACTTGGGAGACTGAGGCAGGATAATCACTTCAACCCAAGAGGCGGAGGTTGCAGTGAGCTGAGATCATGCCATTGCATTCCAGCGTAGGCAACAAGAGCGAAACTCTGTTTCAAATAAATAAA","GGCTGGGTGCGGTGGCTCAGGCCTGTAATCCCAGCACTTTGGGAGGCCGAGGTGGGTACATCACCTAAGGTCAGGAGTTCAAGACCAGCCTGACCAACATGGTAAAACCCTGTCTCTACTAAAATTACAAAAGAAAATTAGAAAAAAAAAAAAGAAAGAAAGAAAATTAGATGGCATGGTGGTGGCGGGCACCTGTAATTTCAACTACTCGGGAGGCTAAGGCAGGAGAATCACTTGAACCCAGGAGGTGGAGGTTGCAGTGAGCCGAGATCACACCATTGCACTGCAGCCTGGGCAATAAGAGCAAAACTCCATCTCAAAAAAA"
"chr16","9762791","9763467","JH378118","18053084","18053501","323","8290293","CAGGCATGGTAGCTCACGCCTGTAATCTCAGCACTTTGGGAGGCCGAGGTGCGCAGATCACTTGAGGTCAGGTGTTGGTGACCAGCCTGGCCAACATGGTGAAACCCTATCTCTACTAAAAATACAAAAATTATGGCCGGGCGCAGTGGCTCACGCCTGTAATCCCAGCACTTTGGGAGGCCGAGGTGGGCAGATCACTTGAGGTCAGGAGTTCAAGACCAGCCTAGGCAACATAGTGAAACCCCGTTGCTACTAAAAATACAAAAATTAGCTGGGCGTGATGGCACATACCTGTAGTCCCACCTACTTGGGAGGCTGAGGCAGGAAAATCGCTTGAACCTGGAGGCAGAGGTTGCAGCGAGCCAAGACTGTGCCAATGCACCACAGCCTGGATAACAGAGTGAGACTCAATCTCAAAAAAAAAAAAAAAAAAAAAAGGCGGGCTGGTGGCTCATGCCCATGCAAACCCCGTCTCTACTAAAAGGACAAAAATTAGCTGGGCATGGTGGCGGGGGCCTGTAATCTCAGGATTACAGGAGATACTACTACTCGGGAGGCTGAGGCAGTAGAATTGCTTGAACCAGGGAGGCGGAGGTTGCAGTGAGCTGAGATCGCGCCATTGCACTCCAGGCTGGGTGACAACAATGACTCCGTCTCAAAAACAACAACAACAACAA","GGCTGGGCGCAGTGGCTCACACCTGTAATCCCAGCACTTAGGGAAGCTGAGGCGAGTAGATCACCTGAGGTCAGGAGTTAGAGACCAGCCTGGCCATCATGGTGAAACCCCGTCTCTACTAAAGATACCAAAAATTAGCTGAGTGTGGTGCTGGGTGCCTGTAATCCCAGAAACTCAGGGTGCCTGTAATCCCAGCAACTCAGGGTGCCTTTAATCCCAGCAACTGAGGGTACCAGTAATCCCAGCAACTCAGGGTGTCTTTAATCCTAGCAACTGAGGGCACCTGTAATCCCAGCAACTCAGGAAGCTGAGACAGGAGAAGTACTTGAACCCAGAAGGCAGAGGTTGCAGTGAGCCGATATTGCACCATTGCACTCCAGTCTGGGCAACAAGAGTGAAACTCTGTCTCAAAAAAAAA"
"chr16","9769317","9769634","JH378153","10517405","10517727","57","748088","GGTTGGGCATGGTGGCTCACACCTGTAATGCCAGCACTTTGGGAGGCGGGCAGATCACCTGAGGTCAGGAGTTCAAGACCAGCCTGGCCAACATGGTGAAATCCTGTCATTACAAAAATACAAAAAAAAAAAAAAAAAAAAAAAAAAAAAGCCAGTAATGATAGTGGGTGCGTATAATCCCAGCTACTTTGGAGGCTAAGGCAGGAGACTCACTTGAACCCAGGAGGCGGAGGTTATGGTGAGCCGAGATCACACCATTGCACTCCAGCCTGGGCGACAAGAGCAAAACTCCATCTCAAAAAAAAAAAAAAAAAAAAA","GGCCGGGCGTGGTGGCTCACGCCTGTAATCCCAGCACTTTGGGAGGCCGAGGTGGGTGGATCATGAGGTCAAGAGATCGAGACCATCCTGGTCAACATGGTGAAACCCTGTCTCTACTAAAAAAAAAAAAAAAAAAAAAAAATACAAAAAAATTAGCTGGGCATGGTGGCGCATGCCTGTAATCCCAGCTACTCCGGAGGTTGAGGTAGGAGAATTGCCTGAACCCAGGAGGCGGAGGTTGCGGTGAGCCGAGATCGCGCCATTGCACTCCAGCCTGGGTAACAAGAGCAAAACTCCGTCTCAAAAAAAAAAAAAAAAAAGAA"
"chr16","13753079","13753710","JH378118","18053084","18053501","278","4300005","GGCTGATTGTGATGGCTCACACTTGTAATCCCCTCACTTTGGGAGGCCAAAGCGGGAGCATCACCTGAGGTCAGGAGTTCAAGACCAGCCTGGCCAACATGGTGAAACCCCATCTCTACTAAAAATAAAAAATTAGCTGGGCACAGTGACTCATGCCTGTAATCCCAGCACTTTGGGAGGCCGAGGCAGGCAGATCACAATCACGAGGTCAGGAGTTCGAGACCAGCCTGACCAACATGGTGAAACCCCGTCTCTACTAAAAATAGAAAAATTAGCCAGGCGTGGTGGCACACGCCTGTAATCCCAGCTCCTCAGGAGACTGAGGCAGGAGAATCACTTGAACCCAGGAGGTGGAGGTTGCAGTGAGCAGAGATCGCACCACTGCACTCCAGCCTGGGTAACAGAGTGAGACTCCGTCTCAAAAAAAAAAAAAAAAAAAAAAAAAAAACGAAATTAACCAGGTGTGGTGGCACATGCCTGTAATCCCAGCTACTTGGGAGGCTGAGGCAGGAGAATCGCTTGAACCCGGGAGACAGAGGTTCCAGAGAACTGAGATCATGCCATTGCACTCCAGCCTGGGCAACAAGAGTGAAACTCCATCTAAAAAATAAATAAATACATAAACAAACAAA","GGCTGGGCGCAGTGGCTCACACCTGTAATCCCAGCACTTAGGGAAGCTGAGGCGAGTAGATCACCTGAGGTCAGGAGTTAGAGACCAGCCTGGCCATCATGGTGAAACCCCGTCTCTACTAAAGATACCAAAAATTAGCTGAGTGTGGTGCTGGGTGCCTGTAATCCCAGAAACTCAGGGTGCCTGTAATCCCAGCAACTCAGGGTGCCTTTAATCCCAGCAACTGAGGGTACCAGTAATCCCAGCAACTCAGGGTGTCTTTAATCCTAGCAACTGAGGGCACCTGTAATCCCAGCAACTCAGGAAGCTGAGACAGGAGAAGTACTTGAACCCAGAAGGCAGAGGTTGCAGTGAGCCGATATTGCACCATTGCACTCCAGTCTGGGCAACAAGAGTGAAACTCTGTCTCAAAAAAAAA"
"chr16","13951847","13952482","JH378118","18053084","18053501","292","4101237","GGCCAGGTGCGGTGGCTCATGCCTGTAATCCCAGCACTTTGGGAGGCTATGGCAGCGGATAACCTGAGGTCACAAGTTTGAGACCAGCCTGGCAAACATGGTGAAACCGTCTCTACTAAAAATACAAAAATTACACCAGGCGCGGTGGCTCATGCCTGTAATCCCAGCACTTTGGAAGGCCGAGGCAGGTGGATCATGAGGTCAGGAGATCAAGACCATCCTGGCTAACGCAGTGAAACCCCGTCTCTACTAAAAATATAAAAAATTGGCCAGGCGTGGTGGCGGACGCCTGTAGTCCCAGCTACTCGGGAGGCTGAGCCAGGAGAATGGCGTGAACCCGGGAGGCGGAGCTTGTGGTGAGCCGAGATAGCGCCACTGCACTGCCGCCTGGGTGACAGAGTGAGACTCTGTCTCAAAAAACAAAACAAAACAAAAACCAAAAACAAAAACAAAAAAACAAAAATTAGCCAGGTGTGGTGGTGCACGCCTGTCATCCCAGCTACTTGGGGGGCTGAGACGTGATAATCACTTGAACCCGGGAGGGAGAGGTTGCAGTGAGTGGAGATCACGCCATTGTATTCCAGCCTGGGGGCAAGAGCAAAACTCTGTCTCAAAAACAACAACAACAACAACAAA","GGCTGGGCGCAGTGGCTCACACCTGTAATCCCAGCACTTAGGGAAGCTGAGGCGAGTAGATCACCTGAGGTCAGGAGTTAGAGACCAGCCTGGCCATCATGGTGAAACCCCGTCTCTACTAAAGATACCAAAAATTAGCTGAGTGTGGTGCTGGGTGCCTGTAATCCCAGAAACTCAGGGTGCCTGTAATCCCAGCAACTCAGGGTGCCTTTAATCCCAGCAACTGAGGGTACCAGTAATCCCAGCAACTCAGGGTGTCTTTAATCCTAGCAACTGAGGGCACCTGTAATCCCAGCAACTCAGGAAGCTGAGACAGGAGAAGTACTTGAACCCAGAAGGCAGAGGTTGCAGTGAGCCGATATTGCACCATTGCACTCCAGTCTGGGCAACAAGAGTGAAACTCTGTCTCAAAAAAAAA"
"chr16","19006984","19007584","JH378118","18053084","18053501","263","953900","GGTGGCTGATGCCTGTAAACCCAGCATTTTGGGAGGCCGAGGCTGGTGGATCACCTGAGGTCAGGTGTTCGAGACCAGTCTGGCCAACATGGTGAAACCTCGTCTCTACCAAAAATACAAAAATTAGTTGGGTGTGGCCGGGTGTGGTGGCTTACGCTTGTAATCTCAGCACTTTGGGAGGCCGAGGTGGGTGGATCACGAGGTCAGGAGTTCAAGACCAGCCTGGCCAAGATGGTGAAACCCTGTCTCTACTAAAAATACAAAAAATTAGCCAGGCATGGTGGCGGGTGCCTGTAATCCCAGCTACTCGGGAGGCTGAGGCAGAGAATTGCTTGAACCTGGGAGGTGGAGGTTGCAGTGAGCCGAGATTGTGCCACGACACTCCAGCCTGGGTGACAGAGCGAGACTCTGTCTAAAAAAAAAAAAAAAAATTAGTTGGATGTGGTGGTGGGTGTCTGTAATCTCAGCTACTCAGGAGACTGAATCAGGAGAATCACTTGAACCCAGGGGGCTGGAGGTTGCAGTGAGCCGAGATCTTGCCATTGCACTCCAGCCCGGGCGACAAGAGCAAAACTCTCTTTCAAAAAAAAAAAAAAAAAGA","GGCTGGGCGCAGTGGCTCACACCTGTAATCCCAGCACTTAGGGAAGCTGAGGCGAGTAGATCACCTGAGGTCAGGAGTTAGAGACCAGCCTGGCCATCATGGTGAAACCCCGTCTCTACTAAAGATACCAAAAATTAGCTGAGTGTGGTGCTGGGTGCCTGTAATCCCAGAAACTCAGGGTGCCTGTAATCCCAGCAACTCAGGGTGCCTTTAATCCCAGCAACTGAGGGTACCAGTAATCCCAGCAACTCAGGGTGTCTTTAATCCTAGCAACTGAGGGCACCTGTAATCCCAGCAACTCAGGAAGCTGAGACAGGAGAAGTACTTGAACCCAGAAGGCAGAGGTTGCAGTGAGCCGATATTGCACCATTGCACTCCAGTCTGGGCAACAAGAGTGAAACTCTGTCTCAAAAAAAAA"
"chr16","19554918","19555551","JH378118","18053084","18053501","281","1501834","GGCCGGGCGCAGTGGCTCACACCTGTAATCCCAGCACTTTGGGAGGCCGAGGCGGGTGGATCACTTGAGGTCAGGAGTTCAAGACCAGCCTGGCTGACATGGTGAAACCCTGTCTCTACTGAAAACACAAAAATTAGGCCGGGCATAGTGGCTCATGCCTGTAATACCAGCACTTTGGGAGGCCGAGGTGGGTGGATCACCTGAGGTCAGGAGTTTGAGACCAGCTTGACCAACATGGTGAAACCCCGTCTCTACTAAAAATATAAAAATTAGTCTGGCATGGTGGCAGATGCCTGTAATCCCAGCTACTCAGGAGGCTGAGGCAGGAGAATTGCTTGAACCTGGAAGGTGGAGGTTGTAATGAGCCAAGATCACACCACTGCACTCCAGCCACTGTACTCCAGCCTGGGTGACAGAGTGAGACTCTGTCTCAAAAAACATACATACACACACATACACACACACACACACACACACACAAATTAGCTGGACGTGATAGCACACCCCTGTAGTCCCAGCTGCTTGAGAGACCGAGGCACAAGAATCACACGAACCCGGGAGGCGGAGGTTCCTGTGAGCCAAGATCGCACCATTGTACTCCATTCTGGGTGACAAGAGTGAAGCTCTGTCTCAA","GGCTGGGCGCAGTGGCTCACACCTGTAATCCCAGCACTTAGGGAAGCTGAGGCGAGTAGATCACCTGAGGTCAGGAGTTAGAGACCAGCCTGGCCATCATGGTGAAACCCCGTCTCTACTAAAGATACCAAAAATTAGCTGAGTGTGGTGCTGGGTGCCTGTAATCCCAGAAACTCAGGGTGCCTGTAATCCCAGCAACTCAGGGTGCCTTTAATCCCAGCAACTGAGGGTACCAGTAATCCCAGCAACTCAGGGTGTCTTTAATCCTAGCAACTGAGGGCACCTGTAATCCCAGCAACTCAGGAAGCTGAGACAGGAGAAGTACTTGAACCCAGAAGGCAGAGGTTGCAGTGAGCCGATATTGCACCATTGCACTCCAGTCTGGGCAACAAGAGTGAAACTCTGTCTCAAAAAAAAA"
"chr16","19576859","19577465","JH378118","18053084","18053501","251","1523775","GGCCAGGCATGGTGGCTCACACCTGTAATCCCAGCCCTTTGGGAGGCCGAGGCAGGTGGATCACCTGAGGTCAGGAGTTCGAGACCAGCCTGGCCAACATGGTGACACCCCACTCTACCAAAAATACAAAAATTAGGTTGGGTGCAGCGGTTCACACCTGTAATCCCAGCACTTTGGGAGGCCAAGGTGGATGGATCACCTGAGGTCAGGAGTTTGTGACCAGCCTGGCCAACATGGCGAAACCCTGCCTCTACTAAAAATAAAAAATTAGCCAGGTGTGGTGGCATGCGCCTGTAATCCTAGCTACTGAGGCAGGAGAATCGCTTGGACCAGGGAAGCAGAGTTTGCAGTGAGCCAAGATCACGCCACTGCACTCTAGCCTGGGTGACAGAGTAAGACTCCATCTCAAAAAAAAAAAAAAATACAAATATTAGCTGGGCATGGTGGCGCACACCTGTAGTTCTGGCTACTCAGGAGGCTGAGGCAGGAGAATTGCTTGAACCCAGAAGGCAGAGGTTGCAGTGAGCTGAGATTGTGCCATTGCACTCAGCCTGGGCAACAAAAGTGAAACTCCATCTCAAAATAAATAGATAAATAAATAAATAAA","GGCTGGGCGCAGTGGCTCACACCTGTAATCCCAGCACTTAGGGAAGCTGAGGCGAGTAGATCACCTGAGGTCAGGAGTTAGAGACCAGCCTGGCCATCATGGTGAAACCCCGTCTCTACTAAAGATACCAAAAATTAGCTGAGTGTGGTGCTGGGTGCCTGTAATCCCAGAAACTCAGGGTGCCTGTAATCCCAGCAACTCAGGGTGCCTTTAATCCCAGCAACTGAGGGTACCAGTAATCCCAGCAACTCAGGGTGTCTTTAATCCTAGCAACTGAGGGCACCTGTAATCCCAGCAACTCAGGAAGCTGAGACAGGAGAAGTACTTGAACCCAGAAGGCAGAGGTTGCAGTGAGCCGATATTGCACCATTGCACTCCAGTCTGGGCAACAAGAGTGAAACTCTGTCTCAAAAAAAAA"
"chr16","19983557","19984148","JH378118","18053084","18053501","244","1930473","GGCCGAGTGCGGTGGCTCATGCCTGTAATCCCAGCACTTTGGGAGGCCGAGACAGGTGAATCACCTGAGGTCTGGAGTTTGAGACCAGCTGACCAACATGGTGAAACCCTGTCTCTACTAAAAATACAAAAAATTGGCTGAGCGCAGTGGCCACGCCTGTTATCCCAGTACTTTGGGAGGCCGAGGCGGGTGGATCACGAGGTCAGGAATTCGAGACCAGCCTGACCAACATGGTGAAGCCCCGTCTCTACTAAAAATAAAAAAATTAGCCAGGTGTGGTGGTGCGCCCCTGTAAACCCAGCTACTCAGGAGGCTGAGGCAGGAGAATCACTTGAATCTGGGAGGCGGAGGTTGCAGTGAGCCAAGATCGAGCCACTGTACTCCAGCCTGGGAGACGGAGTGAGACTCCATCTAAAAAAAAAAAAAAATTAGCCAGGCGTGGTGGCACAAGCCTGTAATCCCAGCTACCTGGGAGGCTGAGATAGGAGAATTCCTTGAATCTGGGAGGCGGAGGTTGCAGTGAGCTGAGATTGTGCCATTGCACACCAGCCTGGGTGACAAGAGCAAAATTCCATCTCAAAAAAAAAAAAAA","GGCTGGGCGCAGTGGCTCACACCTGTAATCCCAGCACTTAGGGAAGCTGAGGCGAGTAGATCACCTGAGGTCAGGAGTTAGAGACCAGCCTGGCCATCATGGTGAAACCCCGTCTCTACTAAAGATACCAAAAATTAGCTGAGTGTGGTGCTGGGTGCCTGTAATCCCAGAAACTCAGGGTGCCTGTAATCCCAGCAACTCAGGGTGCCTTTAATCCCAGCAACTGAGGGTACCAGTAATCCCAGCAACTCAGGGTGTCTTTAATCCTAGCAACTGAGGGCACCTGTAATCCCAGCAACTCAGGAAGCTGAGACAGGAGAAGTACTTGAACCCAGAAGGCAGAGGTTGCAGTGAGCCGATATTGCACCATTGCACTCCAGTCTGGGCAACAAGAGTGAAACTCTGTCTCAAAAAAAAA"
"chr16","20117717","20118289","JH378118","18053084","18053501","224","2064633","GGCTGGGTGCGGTGGCTCACGCCTGTAATCCCAGCACTTTGGGAGGCCAAGGCGGGTAGATCATCTGAGGTCAGGAGTTCAAGACCAGCCTGGCCAACATGGTGAAACCCCGTCTCTACTAAAAATATTTTTAAAAGGCCAGGCGTGGTGGCTCACGCCTGTAATCCCAGCACTTTGGGAGGCCGAGGCGGGCAGATCATGAGGTCAGGAGTTCGAGACCATCCTGGCTAACACGGTGAAACCCCCGTCTCTACCAAAAAATACAAAAAATTAGCCGGGCATGGTGGCAGGTGCCTGTAGTCCCAGCTACTCGGGAGGCTGAGGCAGGAGGATGGCGTGAACCCAGGAGACAGAGCTTCCAGTGAGCTGAGATCGTGTCACTGCACTCCAGCCTGGGCGACAGAGGAGATTCTGTCTCAAAAAAAAAAAAAAAAAATTAGCTTGGTGTGGTGGCAGGTGCCTGTAATCCCAGTTACTCGGGAGGCTGAGGCAGAGGTTTCAGTGAACCGAGATCGCGCCATTGCACTCCAGCCTGGGCAACAAGAGTGAAACTCCGTCTCAAAGGAAAAAAAA","GGCTGGGCGCAGTGGCTCACACCTGTAATCCCAGCACTTAGGGAAGCTGAGGCGAGTAGATCACCTGAGGTCAGGAGTTAGAGACCAGCCTGGCCATCATGGTGAAACCCCGTCTCTACTAAAGATACCAAAAATTAGCTGAGTGTGGTGCTGGGTGCCTGTAATCCCAGAAACTCAGGGTGCCTGTAATCCCAGCAACTCAGGGTGCCTTTAATCCCAGCAACTGAGGGTACCAGTAATCCCAGCAACTCAGGGTGTCTTTAATCCTAGCAACTGAGGGCACCTGTAATCCCAGCAACTCAGGAAGCTGAGACAGGAGAAGTACTTGAACCCAGAAGGCAGAGGTTGCAGTGAGCCGATATTGCACCATTGCACTCCAGTCTGGGCAACAAGAGTGAAACTCTGTCTCAAAAAAAAA"
"chr16","20574957","20575888","JH378118","18053084","18053501","543","2521873","GGCCAGGCGTGGTGGCTCATGCCTGTAATCCCAGCACTGTGAGAGGCCGAGGCGGGCGGATCACCTGAGCTGAGGAGTTCGAGACCAGCCTGGCCAACATGGCGAAACCCCATCTCTACTAAAAACACAAAAATTAGGCCAGGTGTGGTGGCTCACACCTGTAATCCCAGCACTTTGGGAGGCCAAGGCGGGCGGATCACCTGAGGTCAGGAGTTCCAGACCTGCCTGGCCAACATGGTGGAATCCCATCTCTACTAAAAATACAAAAATCTGCCAGGTGTGGTGGCACACTTCTGTAATCCCAGATACTCAGGAGGCTGAGGCAGGAGAATCACTTGAACCCTGGAGATGGAGGTTGCAGTGAGCCAAGATCAAGAGATTGCACTCTAGCCAGGGTGACTAGAGTGAGACTCGGTCTCAAAAAAAATGTAATTAATTAATTAATTAATACAAAAATTAGCTGGGCGTGGGCTAGGTGTGGTGGCTCACGCCTGTAATCCCAGCACTTTGGGAGGCCGAGACAGGCGGATCACCTGAGGTCAGGAGTTCAAGACCAGTTTAACCAACATGGAGAAACCCCATCTCTACTAAAAATACAAAATTAGCTGGGCGTGGTGGTGCATGCCTGTAATCCCAGCTACTCGGGAGGCTGAGGCAGAAGAATCGCTTGAGCCTGGTAGGCGGAGATCGTGGTGAGCCGAGATCGCGCCATTGCACTCCAGCCTGGACAACAAGAGCGAAACTCCGTCTAAAAAAAAAAAAAAAATTAGCTGGGCATGGTAACAGGCGCCTGTAAACCCAGTTTCCTCGGGAGGCTGAAGCAGAATTGCTTGATCCCAGAGGCAGAGGTTGCAGTGAGCCAAGATAGTGCCATTGCAGTCCAGCCTGGGCAACAAGAGTGAAACTCCGTCTCAAAAAAAAAAAAAAAAAAA","GGCTGGGCGCAGTGGCTCACACCTGTAATCCCAGCACTTAGGGAAGCTGAGGCGAGTAGATCACCTGAGGTCAGGAGTTAGAGACCAGCCTGGCCATCATGGTGAAACCCCGTCTCTACTAAAGATACCAAAAATTAGCTGAGTGTGGTGCTGGGTGCCTGTAATCCCAGAAACTCAGGGTGCCTGTAATCCCAGCAACTCAGGGTGCCTTTAATCCCAGCAACTGAGGGTACCAGTAATCCCAGCAACTCAGGGTGTCTTTAATCCTAGCAACTGAGGGCACCTGTAATCCCAGCAACTCAGGAAGCTGAGACAGGAGAAGTACTTGAACCCAGAAGGCAGAGGTTGCAGTGAGCCGATATTGCACCATTGCACTCCAGTCTGGGCAACAAGAGTGAAACTCTGTCTCAAAAAAAAA"
"chr16","20816618","20817242","JH378118","18053084","18053501","267","2763534","GGCCCGGCGTGGTGGCTCATGCCTGTAATCCCAGCACTTTGGGAGGCCGAGGCCGGCGGATCACCTGAGGTCAGGAGTTTGAGACCACCCTGGCCAACACGGTGAAAACCTGTCTCTACTAAAAATACAAAAATTAGCCAGGCGCAGTGGCTCACGTCTGTAATTCCAGCACTTTGGAGGGCCGAGGGGGGCAGATCACAAGGTCAGGAGTCCAAGACCAGCCAGGCCAACATAGTGAAACCCGGTCTCTACTAAAAATACAAAAAATTAGCCGGGCGTGGTGGCGGACCCCTGTAGTCCCAGCTACTCAGGAGGCTGAGACAGGAGAATCTCTTGAACCCAGGAGGCAGAGGTTGCAGTGAGCCAAGATCATGCCATTCCACTCCAGCCTGGGCGACAGTGCAAGACTCTGTCTCAAAAACAAAAACAAAAAACCCCCAAACCAAAAATTAGCCAGGCGTGGTGGCATGCACCTGTAGTCCCAGCTACTTGGGAGGCTAAGGCAAGAGAATAGCTTGAACCCAGGAGGCAGAGGTTGCAGTGAGCCGAGATAGTGCCATTGCACTCCAACGTGGGTGACAAGAGCAAAACTCTGTCTCAAAAAAAAAAAAAAAAAAGGAAGGAA","GGCTGGGCGCAGTGGCTCACACCTGTAATCCCAGCACTTAGGGAAGCTGAGGCGAGTAGATCACCTGAGGTCAGGAGTTAGAGACCAGCCTGGCCATCATGGTGAAACCCCGTCTCTACTAAAGATACCAAAAATTAGCTGAGTGTGGTGCTGGGTGCCTGTAATCCCAGAAACTCAGGGTGCCTGTAATCCCAGCAACTCAGGGTGCCTTTAATCCCAGCAACTGAGGGTACCAGTAATCCCAGCAACTCAGGGTGTCTTTAATCCTAGCAACTGAGGGCACCTGTAATCCCAGCAACTCAGGAAGCTGAGACAGGAGAAGTACTTGAACCCAGAAGGCAGAGGTTGCAGTGAGCCGATATTGCACCATTGCACTCCAGTCTGGGCAACAAGAGTGAAACTCTGTCTCAAAAAAAAA"
"chr16","21054922","21055508","JH378118","18053084","18053501","243","3001838","GGCCGGGTGCGGTGGCTCACACCTATAATCCCAGCACTTTGAGAGTCTGAGGCAGGCGGATCACCTGAGGTCAGGAGTTCCAGACCAGCCTGGCCAACATGGTGAAACCCAGTCTCTACTAAAAATACAAAAAAAGACCGGGCACAGTGGCTCACGCCTGTAATTCCAGCACTTTGGGAGGCCGAGGCAGGTGGATCACCTGAGGTTGGGAGTTCGCGACCAGCCTGACCGACATGGAGAAATCCCATCTCTACTAAAAATACAAAATTAGCCGGGCGTGGTGGCACATGCCTGTAATTCCAGCTACTCAGGAGGCTGAGGGAGGAGAATCACTTGAACCTGGGAGGCGGAAGTTGTGGCGAGCCAAGATCACGCCATTGCACTCCAGCCTGGGCAACAAGAGTGAAACCCCATTTCAAAAAAAAAAAAAATTAGCCAGGGGTGGTGGTGCATTCTTGTAATACCAGCTACTCGGGAGGCTGAGGTAGGAGAATCACTTGAGCGCAGGAGGCAGATGTTGTAGTGAGCCGAGTGCCATTGCACTACAGCCTGGGCGACAAGAAAGTAACTCCACCTCAAAAAAAAAA","GGCTGGGCGCAGTGGCTCACACCTGTAATCCCAGCACTTAGGGAAGCTGAGGCGAGTAGATCACCTGAGGTCAGGAGTTAGAGACCAGCCTGGCCATCATGGTGAAACCCCGTCTCTACTAAAGATACCAAAAATTAGCTGAGTGTGGTGCTGGGTGCCTGTAATCCCAGAAACTCAGGGTGCCTGTAATCCCAGCAACTCAGGGTGCCTTTAATCCCAGCAACTGAGGGTACCAGTAATCCCAGCAACTCAGGGTGTCTTTAATCCTAGCAACTGAGGGCACCTGTAATCCCAGCAACTCAGGAAGCTGAGACAGGAGAAGTACTTGAACCCAGAAGGCAGAGGTTGCAGTGAGCCGATATTGCACCATTGCACTCCAGTCTGGGCAACAAGAGTGAAACTCTGTCTCAAAAAAAAA"
"chr16","27896431","27896766","JH378166","6401112","6401453","56","21495319","GGCCAGGCGCGGTGGCTCACGCCTGTAATCCCAGGACTTTGGTAGTCCAAGGCGGGTGGATCACCTGAGGTCAGGAGTTCAAGATCAGCCTGACCAACATGGCAAAACCTCGTCTCTACTAAAAAATACAAAAATTAGCCGGTGTGGTGGCAGGTGCCTGTAATTCCAGCTACTCGGGACGCTGAGTCATGAGAATTGCTTGAACCTAGGAGGCAGATGTTGCAATGAGCCGAGATCGCACCATTGTACTCCAGCCTGGGCGACAAGAGGGAAACTGTCTCCAAAAAAAAAAAAGAAAGAAAGAAAGAAAGAAAGAAAAAAGAAAAACAAAACAAA","GGCCAGGTGCAGTGGCTCACCCCTGTAATCCCAGCACTTTGGGAGGTCGAGGTGGGTGGATCACCTGAGGTCAGGAGTTCAAGACCAGCCTGACCAAAATGGTGAAACCCCATCTCTACTAAAAATACAAAACATTAGCCAGACATCGTGGCGGGCACCTGTAATCCCAGCTACTTGGGAGGCTGAGGCAGGAGAATTGCTTGAGCCTAGGAGGCGGAGGTTACAGTGAGCCATGATCGTGCCATTGGACTCCAGCCTGGGCTACAAGAGCGAGACTCCATCTCAAAAAAAAAAAAAAAAAAAAAAAAGAAAGAAAGAAAGAAAGAAAGAAAAGAAAGAAAG"
"chr16","36524888","36525430","JH378206","6546474","6546861","201","29978414","TTTGAGACCAGCCTGGCCATTGTGGTGAAACCCCGTCTCTACTAAAAAAAATTCAAAAAATGGCTGGGTATGGTGGCTCACGCCTGTAATCCCAGGACTTTGGGAGGCCAAGGTGGGCGGATCACCTGAGGTCAGGAGTTTGAGACCAGCCTAGCCAACATGGTGAAACCCCGTCTCTACCAAAAATACAAAAATTAGCCGGGCTTGGTGGCGCGCACCTGTAATCCCAGGTACACTGGAGGTTGAGGCACAAGAATCGTTTGATCCTGGGAGGTTGCAGTGAGCCAAGATCACGCCACTGCACTCCAGACTGGGTGACAGAGCGAGATTCCATCTCAAAACAACAACAACAAACCCAAAAAATTAGCTGGGTGTGGTGGTGGGTGCCTGTAATCCCAGCTACTTAGGAGGCTGAGGCAGAAGAATCGCTTGAACCCAGGAGGTGGAGGTTGTTGCAGTGAGCAGAGATCGCACCATTGCACTCCAGCCTGGGCAACGAGTGAAACTCCATCTCAAAAAAAAAAAAAAAAAAAGAAAAAAAAA","GGCCACACATGGTGGCTAACGCCTGTAATCCCAGCACTTTGGGAGGCCAAGTCGGGTGGATCATGAGGTCAGGAGACCAAGACCATCCTGGCCAAATGGTGAAACCCCGTCTCTACTAAAAATACAAAAATTAGCTGGGCATGGTGGCGTGTGCCTGTAATCCCAGCTACTCAGGAGGCTGAGGCAGGACAATTGCCTGAACCCAGGAGAATTAGCTGGGCATGGTGGCGTGTGCCTGTAATCCCAGCTACTCAGGAGGCTGAGGCAGGACAATTGCCTGAACCCAGGAGGCGAAGGTTGCGGTGAGCCGAGATTGTGCCATTGCACTCCAGCCTGGGTAACAAGAGCGACACTCTGTCTCAAAAAAAAAAAAAAAAAAAAAAAAAAA"
"chr16","36528224","36528842","JH378119","32351107","32351490","270","4177117","GGCCAGGCGTGGTGGCTCACGCCTGTAATCCCAGCACTTTGGGAGGCTGAGGCAGGCAGATCACCTGAGGTCAGGAGTTCAAGACCAGCCTGGCCAACATGGTGAAACTCCATCTCTACTAAAAATACAAAATTAAGCCGGGCACGGTGGCTCACATCTGAAATCCCAGCACCTTGGGAGGCTAAGGCAGGCGGATCACGAGGTCAGGAGTTCAAGACTAGCTGACCAATATGGTGAAACCCCGTGTCTACTAAAAATACAAAAAAAATTAGCTGGGCGTGGTGGCGCATGCCTGTAGTTCCAGGTACTCAGGAGGCTGAGGAAGGAGAATCACTTGAACCTGGGAGGCGGAGGTTGCAGTGAGCCAAGATCATGCCACTGCATTCCAGCCTGGGCAACAGAGCAAGACTCTGTCTCAAAAATAAAAATAAAAATAAAAGTAAAAATACAAAATTAGCCAGGCGTGGTGGTGTGTGCCTGTAATCACAGCTACTCAGGAGGCAGGAAAATCACTTGAACCTAGGAGGAGGAGGTTGGTGAGCCAAGATCACACCATTGCACTCCAGCCTGGGCAAAAAGAGCAAAACTCCGAACTCTGTCTCAAAAAAAAAAAAAAAAA","GGCCAGGTATGGTGGCTCACACCTGTAATCCCAGCACTTTGGGAGGCCAAGGCAGGCAGACCACCTGAGGTCAGGAGTTCGAGATCAGCCTAGCCAACATGGTGAAACCCCATCTCTAGTAAAAATAAAATTAGCCAGGCATGGTGGTGCATGCCTGTAACGCAGGTCAGGAGTTCGAGATCAGCTTAGCCAACATGGTGAAACCCCATCTCTAGTAAAAATAAAATTAGCCAGGCAGGTGGTGCCGCCTGTACTCGGGAGGCTGAGGCAGGAGAATCACTTGAACCCAAGAGGCAGAGGTTGCAGTCAGCCAAGATCATGCCATTGCACTCCAGCCTAAGCAAAAAGAGTAAAACTCAGTCTCAAAACAAAAAAACAAAAAAA"
"chr16","44800308","44800913","JH378118","18053084","18053501","244","26747224","GGCCTGGTGCAGTGGCTCACACCTGTAATCCCAGCACTTTGGGAGCCCAAGGCGGGTGGATCACCTGAGGTCAGGAGTTCGAGACCAGCCTGGCCAACATGGTGAAATCCTCTCTACTAAAAATGCAAAAAATTAGCTGGGCGGCCAGGCGCAGTGGCTCACGCCTGTAATCCCAGCACTTTGGGAGGCCGAGGTGGGCGGATCACAAGGTCAGGAGATCGAGACCATGCTGGCTAACACGGTGAAACTCCGTCTCTACTGAAAATACAAAAAATTAGCCAGGCACGGTGGCGGGCGCCTGTAGTCCCAGCTACTGGGGAGGCTGAGGCAGGAGAATGGCGTGAACCTGGGAGGTGGAGGTAGCAGTGAGCCAAGATTGCGCCACCGCAGTCCGGCCTGGGTGAAAGAGCGAGACGCTGTCTCAAAAAAAAAAAAAAAAAATTAGCTGGGCATGGTGGCGGGCGCCTGTAATCCCAGTTACTCGGGAGGCTGAGGCAGGAGAATCAGTTGAACCCAGGAGGTGGAGGTTGCAGTAAGCCAAGATTGTGCCATTGTACTCCAGTCTGGGCAACAAGAGCGAAACTCTGTCTTAAAAAACAAAAAAAA","GGCTGGGCGCAGTGGCTCACACCTGTAATCCCAGCACTTAGGGAAGCTGAGGCGAGTAGATCACCTGAGGTCAGGAGTTAGAGACCAGCCTGGCCATCATGGTGAAACCCCGTCTCTACTAAAGATACCAAAAATTAGCTGAGTGTGGTGCTGGGTGCCTGTAATCCCAGAAACTCAGGGTGCCTGTAATCCCAGCAACTCAGGGTGCCTTTAATCCCAGCAACTGAGGGTACCAGTAATCCCAGCAACTCAGGGTGTCTTTAATCCTAGCAACTGAGGGCACCTGTAATCCCAGCAACTCAGGAAGCTGAGACAGGAGAAGTACTTGAACCCAGAAGGCAGAGGTTGCAGTGAGCCGATATTGCACCATTGCACTCCAGTCTGGGCAACAAGAGTGAAACTCTGTCTCAAAAAAAAA"
"chr16","45828895","45829498","JH378118","18053084","18053501","256","27775811","GGCCAGGAGAGGTGGCTCATGCTTGTAATTCCAGTATTTTGGGAGCCCAAGGCGGGTGGATCACTTGAGGTCAGGAGTTTGAAACCAGCCTGACCAACATGGTGAAACCCCGTCTCTACTAAAAATTCAAAATTAGGCAAGGCCTGGTGGCTCATGCCTGTAATCCCAGCACTTTGGGAGGCCAAGGAGGGAGGATCACCTGAGGTCGGGAGTTTGAGACCAGCCTGACCAACATGGAGAAACCCCGTCTCTACTAAAACTACAAAATTAGCCGGGTGTGGTGGCCCATGCCTCTAATCCCAGCTACTCTGGAGGCTGAGGCAGGAGAATCACTTGGACCTGGGATGTGAAGGTTGCAGTGAGCCAAGATCGAGCCATTGCACTCCAGCCTGGGCCACAAGAGTGAAACTCCGTCCCAGAAAAAAAAAAAAAAATTAACCTGGCATGGTGGTGTATGCCTGTAATCCCAGCTACTCGGGAGACTGAGGCAGGAGAATCTCTTGAACCCGGGAGGCGGAGGTTGCAGTAAACCGAGATTGCGCCATTGCACTCCGGCCTGGGTGACAAGAGCGAAACTCCGCCTAAAAAAAAAAAGAAAAGAAAA","GGCTGGGCGCAGTGGCTCACACCTGTAATCCCAGCACTTAGGGAAGCTGAGGCGAGTAGATCACCTGAGGTCAGGAGTTAGAGACCAGCCTGGCCATCATGGTGAAACCCCGTCTCTACTAAAGATACCAAAAATTAGCTGAGTGTGGTGCTGGGTGCCTGTAATCCCAGAAACTCAGGGTGCCTGTAATCCCAGCAACTCAGGGTGCCTTTAATCCCAGCAACTGAGGGTACCAGTAATCCCAGCAACTCAGGGTGTCTTTAATCCTAGCAACTGAGGGCACCTGTAATCCCAGCAACTCAGGAAGCTGAGACAGGAGAAGTACTTGAACCCAGAAGGCAGAGGTTGCAGTGAGCCGATATTGCACCATTGCACTCCAGTCTGGGCAACAAGAGTGAAACTCTGTCTCAAAAAAAAA"
"chr16","47110839","47111458","JH378118","18053084","18053501","268","29057755","GGCCAGGCGTGGTGGCTCACGCCTTTAATCCCAGCACTTTGGGAGGCCGAGGCAGGCAGATCACCTAAGGTCAGGAGTTCGAGACCAGCCTGGCCAACATGGTGAAACCCCCTCTCTACTAAAAATGCAAAAATTTCTGGGCATGGTGGCTCACGCCTGTAGTCCCAGCACTTTGGGAGGCCAAGGCAGGCGGATCACTTGAGGTCAGGAGTTTGAGACCAGCCTGGCCAACATGGTGAGACCCCTGTCTCTACTAAAAATATAAAAAAGTAGCCAGGCGTGGTGGTGTATGCCTCCCAGATAATTGGGAGGCTGAGGTGGGATAATTGCTTGAACCCGGGAGGCAGAGGTTGTAGTGAGCCAAGATAGCGCCAATGCACTCCAGCCTGGGCAACAGAGCGAGACTCTGTCTCAAAAAAAAAAAAAAAAAGAAAAAAGAAAAGAAATTAGCTGGGCGTGGTGATGGGTGCCTGTAATCCCAGCTGCTTAGGAAGCTGAGGAAGGAGAATCACTTAGACCCAGGAGACAGAGGTTGCAGTGAGCCGAGATCGCACCATTGTATTCCAGCCTGGGTGACAAGAGAAAAACTATGTCTCAAAAAAAAAAAAAAGAGTAGAAAA","GGCTGGGCGCAGTGGCTCACACCTGTAATCCCAGCACTTAGGGAAGCTGAGGCGAGTAGATCACCTGAGGTCAGGAGTTAGAGACCAGCCTGGCCATCATGGTGAAACCCCGTCTCTACTAAAGATACCAAAAATTAGCTGAGTGTGGTGCTGGGTGCCTGTAATCCCAGAAACTCAGGGTGCCTGTAATCCCAGCAACTCAGGGTGCCTTTAATCCCAGCAACTGAGGGTACCAGTAATCCCAGCAACTCAGGGTGTCTTTAATCCTAGCAACTGAGGGCACCTGTAATCCCAGCAACTCAGGAAGCTGAGACAGGAGAAGTACTTGAACCCAGAAGGCAGAGGTTGCAGTGAGCCGATATTGCACCATTGCACTCCAGTCTGGGCAACAAGAGTGAAACTCTGTCTCAAAAAAAAA"
"chr16","48159907","48160229","JH378222","6231244","6231546","61","41928663","GGCTGGGCACAGTGGCTCATGCCTGTAATCCCAGCACTTTGGGAGGCCGAGGCAGGCGGATCACCTGAGGTCAGGAGTTCGAGACTAGCCTGGCCAATATAGCGAAACCCCGTCTCTACTAAAAATTAGTTGGGCATGGTGGCAGGCGCCTTAATCCCAGCTACTTGGGATGCTGAGGCAGAAGAATCGCTTGAACCCAGAGGGTGGAGGTTTCAGTGAGATGAGATCGTGCCATTGCACTCCAGACTGGGCAACAAGAGCGAGACTCTGTAAAAAAAATTAATTAATTAATTAACTAATTAATTAAAATAAAATGAGAAAAA","GGCTGGGCATGGTGGCTCACGCCTGTAATCCCAGCACTTTGGGACGCTTAGGCAGGTGGATTGCCTGAGGTCAGGAGTTCAAGACTACCCTGACCAACATAGTGAAACCCCGTCTCTACTAAAAATTAGCTGGGCATGGTGGCAGAGGCCTGTAATCCCAGCTACTCGGGAGGCTGAGGCAGGAGAATCACTTAAACCTGGGAGTTGGAGGTTGCAGTGAGCCAAGATCAAGCCATTGCACTCCAGTCTGGGCAACAAGAGCAAGACTCTGTCTCAAAAAAAAAAAAAAAAAGAAAAGAAAAA"
"chr16","49252302","49252639","JH378314","538162","538484","57","48714140","GGCCAGGCGCAGTGGTGCATGTCTGTAATCTTAGCACTTTGGGAGGCCGAGGTGGACGGATTACATGAGGTCAGGAGTTCAAGACCAGCCTGGCCAACATGGTGAAATTCCATCTCTACTACTAAAAAAAAAAAAAAAAAAAAAAAAAAAAAAAAAAAAAAATACAAAAATTAGCTGGGCTTGGTGGCGGGTGCCTGTAATCCCAGCTACTTGGGAGGCTGAGGCAGGAATCACTTAAACCCAGGAGGTGGAGGTTGCAGTGAGCCAAGACCATGCCATTGCACTCCAGCCTGGGCAACAAGAGCAAAACTCCGTCTCAAAAAAACAAAACAAAAAAA","GGCTGGGTGCGGTGCCTCACACCTGTAATCCCAGCACTTTGGGAGGCCGAGGTGGGTGGATCACGAGGTCAAGAGATCAAGACCATCCTGGTCAACATGGTGAAACCCTGTCTCTACTAAAAAAAAAAAAAAAAAAAAAAAAAAAAAAAAAAAAATTAGCTGGGCATGGTGGCGTGTGCCTGTAATCCCAGCTACTCAGGAGGCTGAGGCAGGAGAATTGCCTGAACCCAGGAGGCGGAGGTTGCGGTGAGCCGAGACTGTACCATTGCACTCCAGCCTGGGTAACAAGAGCGAAACTCCATCTCAAAAAAAAAAAAAAAAAA"
"chr16","49464616","49465219","JH378118","18053084","18053501","254","31411532","GGCCAGGCGTGGTGGCTCACACCTGTAATCCTAGCACTTTGGGAGACTGAGGCAGGTGGATCACATGAGGTGAGGAGTTCAAAACCACCCTGGCCGACATGGTGAAACCCCGTCTCTACTAAAAATATTTTTAAAAAGGCCAGGCGTGGTGGCTCACACCTGTAATTCCAGCACTTCGGGAGGCTGGGGCAGGCAGATCACAAGGTCAGGAGATCGAGACCATTCTGGCCAACGTGGTGAAACCCCGTCTCTACTAAAAATACAAAAATTAGCTGGGCGTGGTGGCGCGTGCCTGTAATCCCAGCTACTTGGGAGGCTGATACAGGAGAATTGCTTGAACCAGTGAGTCAGAGGTTGCAGTGAGCTGAGATTGCGCCATTGCACTCCAGCCTGGCAACAGAATGAGACTCCGTCTCAAAAAAAAAAAAAAAATTAGCTGGGCATGGTGGCAGGCACCTGTGATCCCAGCTACTTGGGAGGCTGAGGCAGGAGAATCGCTTGAACCTGGGAGGTGGAGGTTGCAGTGAGCTGAGATTGCGCCATTGCACTCCAACCTGGGCGTCAAGAGCAAAACTCCATCTCAAAAATAAATAAATAAATAAAA","GGCTGGGCGCAGTGGCTCACACCTGTAATCCCAGCACTTAGGGAAGCTGAGGCGAGTAGATCACCTGAGGTCAGGAGTTAGAGACCAGCCTGGCCATCATGGTGAAACCCCGTCTCTACTAAAGATACCAAAAATTAGCTGAGTGTGGTGCTGGGTGCCTGTAATCCCAGAAACTCAGGGTGCCTGTAATCCCAGCAACTCAGGGTGCCTTTAATCCCAGCAACTGAGGGTACCAGTAATCCCAGCAACTCAGGGTGTCTTTAATCCTAGCAACTGAGGGCACCTGTAATCCCAGCAACTCAGGAAGCTGAGACAGGAGAAGTACTTGAACCCAGAAGGCAGAGGTTGCAGTGAGCCGATATTGCACCATTGCACTCCAGTCTGGGCAACAAGAGTGAAACTCTGTCTCAAAAAAAAA"
"chr16","49983504","49983843","JH378316","567988","568320","50","49415516","GGCCAGGCATGGTGGCTTACGCCTGTAATCTCAGCACTTTGGGAGGCCAAGGCAGGCGGATCACCTGAGGTCAGGAGTTCAAGACCAGCCTGGTCAACATGGCGAAACCCTGTCTCTACTAAAAAAATACAAAAATTAGCCAGGCGTGGTGGTGGGCGCCTGTAATCTCTCCTACTTGGGAGACTGAGGCAGGAGAATTGCTTGAACTCAGAAGGCAGAGGTTGCAGTGAGCTGAGATCACGCCATTGCACTCCAGCCTGGATGACAAGAGCAAAACTCCATCTCAAACAAACAAAAAACAAACAAACAAAAAAAAACAAAAAAACCTCCAAAAAACAAA","GGCCGGGCGTGGTGGCTCACGCCTGTAATCCCAGCACCTTGGGAGGCTGAGGCGGGTGGATCACGAGGTCAAGAGATTGAGACCAGCCTGGTCAACATGGTGAAACCCTGTCTACTAAAAAAATACAAAAATTAGCTGGGCATGGTGGCACGTGCCTGTAATCCCAGCTACTCAGGAGGCTGAGGCAGGAGAATTGCCTGAACCCAGGAGGCGGAGGTTGCGGTGAGCCGAGATCGCGCCATTGCACTCCAGCCTGGGTAACAAGAGCGAAACTCCGTCTCAAAAAACAAAAAACAAAAAAACAAAAAACAAACAAACAAACAAAAAAACAAA"
"chr16","50470493","50471105","JH378118","18053084","18053501","251","32417409","GGCTGGGAGCGGTGGCTCATACCTGTAATCCCAGCACTCTGGGAGGCCGAGGCGCGTGGATCACCTGAGGTCAGGAGTTTGAGACCAGCCTGGCCAGCATGGTGAAACCCTGTCTCTACTAAAAATAGAAAAAGTTAGCTGGGTGAACAGCCGGGCGCGGTGGCTCACACCTGTAATCCCAGCACTTTGGGAGGCCGAGGCAGGTGGATCACAAGGTCAGGAGATCGAGACCATCCTGGCTAACACGGTGAAACCCTGTCTCTACTAAAAATATAAAAAATTAGCCGGGCATGGTGGTGGGTGCCTGTAGTCCCAGCTGCTCAGGAGGCTGAGGCAGGAGAATGGCGTGAAGCCAGGAGGCAGAGGTTGCAGTGAGCCGAGATCGTACCACTGCACTCTAGCCTGGGTGACAGAACGAGACTGTGTCTCAAAGAAAAAAAAAATTAGCTGGGTGTGGTGGCAGACACCTGTAATCCTAGCTACTTGGGAGGTTGAGGCAGGAGAATCGCTTGGACCTGGGAGGCGGAGGTTGCAGTAGGCTGAAATCGCACCATTGCACTCCAGCCTGGGCAACAAGAGGGAAACTCAGTCTCAAAAAAAAAAAAAAAAAAAA","GGCTGGGCGCAGTGGCTCACACCTGTAATCCCAGCACTTAGGGAAGCTGAGGCGAGTAGATCACCTGAGGTCAGGAGTTAGAGACCAGCCTGGCCATCATGGTGAAACCCCGTCTCTACTAAAGATACCAAAAATTAGCTGAGTGTGGTGCTGGGTGCCTGTAATCCCAGAAACTCAGGGTGCCTGTAATCCCAGCAACTCAGGGTGCCTTTAATCCCAGCAACTGAGGGTACCAGTAATCCCAGCAACTCAGGGTGTCTTTAATCCTAGCAACTGAGGGCACCTGTAATCCCAGCAACTCAGGAAGCTGAGACAGGAGAAGTACTTGAACCCAGAAGGCAGAGGTTGCAGTGAGCCGATATTGCACCATTGCACTCCAGTCTGGGCAACAAGAGTGAAACTCTGTCTCAAAAAAAAA"
"chr16","50478366","50478929","JH378114","15957391","15957789","242","34520975","GGCTGGGCACGGTGGCTCATGCCTGTAATCCTAGTACCCTGGGAGGCTGAAGCTGGCAGATCACTTGAGGTCAGGAGTTCGAAACCAGCCTGGCCAACATGGTGAAACCTCATCACTACTAAAAATACAAAAAGTCAGCCGAGCGCGGTGGCTCACGCCTTTAATCCCAGCACTTTAGGAGTCTGAGGCGGGTGGATCACAAGGTCAGGGGTTTGAGACTAGCCTGACCAACACGGTGAAACATCTTTACTAAAAATAGCCAGGCATGGTGGTGCAGGCCTGTAGCAGGTACTCAGGAGGCTGAGGCAGCAGAATCGCTTGAACCCGGGAGGCGGAGGTTGCAGTGAGCCGAGATTGAGCCACTGCACTCCACCCTGGGCAACTGAGCGAGACTCCGTCTCAAAAAAAAAAAAAAAAATTAGCTGGACGTGGTGGTGGATGCCTGTAATCCCGGCTACTTGGTACTTGGAAGGCTGAGACAGGAGAATCGCTTGAACCCGGGAGGTGGAGGTTGCAGTGAGCTGAGATAGCGCCATTGCACTCCAGCCTGGGCAACAAGAGTGA","GCAAGGAACGGTGGCTCATGCCTGTCATCCCAGCACTTTGGGAGGCTAAGGAGGGTGGATTACCGAAGGTCATGAGTTTGAGACCAGCCTGACCAACATGGTGAAAACCCCATCTCTACTAAAAATACAAAAAATTAGCCAGATACAGCTATGCGGCAGACTGGGGCAGGAGAATCGCTTGGACCCAAACCCCATCTCTACTAAAAATACAAAAAATTAGCCGGATACAGCTATGCGGGAGACTGGGGCAGGAGAATCGCTTGGACCCGGGAGGCAGAGATTGCAGTGAGATGAGACCATGCCATTGCTCTCTAGCTTGTGCGATGAGAACAAGACTCTGTCTCAAAAAAAAAAAAAAAAAAAAAAAAAAAAAAAAAAAAAAAAGAGAGAGAGAGAAAA"
"chr16","51388263","51388584","JH378271","2122362","2122678","46","49265901","GGCTGGGTACGGTGGCCCACACCTGTAATCCCAGCACCTTGGGAGGCTGAGGTGGGCGGATTACCTGAGGTCAAAAGTTCAAGACCAGCCTGGCCAACATGGTGAAATCCCATCTCTGCTAAAAATACAAAAAAAAAAAAAAAAAAAAAAAAAAAATTGCCAGGCATGGTGGCAGGCACCTGTAATCCCAGCTACTTGGGAGGCTGAGGCAGGGGAATCGCTTGAACCTGGGAGGCAGAGGTTGCAGTGAGCCCAGATAGCGCCATTGCACTCCAGCCTGGGCGACAAGAGCGAAACTCTGTCCAAAAAAAAAAAAAAAAAA","GGCCGGGCACGGTGGCTCACACCTGTAATCCCAGCACTTTGGGAGGCTGAGGTGGGTGAATCACCTGAGGTCAGGAGTTTGAGACCAGCCTGACCAACATGATGAAACCCGGTCTCTGCTAAAAATACAAAAAAAAAAAAAAAAAAAAAAAAAAAAAGCTGGGCATGATGGTGGGCACCTGTAATCCCAGCTACTCGGGAGGCTGAGGCAGGAGAATCGCTTGAACACCAGGAGGTGGAGGTTGCTATGAGCCGAGATCGCACCATTGCACTCTAGCTTGGGCAACAAGAGAGAAACTCCATCAAAAAAAAAAAAAA"
"chr16","51876298","51876882","JH378118","18053084","18053501","253","33823214","GTAATCCCAGCACTTTGGGAGGCCCAAGTGGGTGGATCACCTGAGGTCAGGAGTTCATGACCAGCCTGGCCACATGGTGAAACCCCATCTCTACTAAAAATACAAAATTAGGCTGGGCGCGGTGGCTTACGTCTGTAATTCCAGCACTTTGGGAGGCCGAGGCAGGCGGATCATGAGGTCAGGAGATTGAAACCATCCTGGCTAACACGGTGAAACCCTGTCTCTACTAAAAATACAAAAAATTAGCCGGGTGTGGTGGGGGGGCGCCTGTAGTCCCAGCTGCTCAGGAGGCTGAGGCAGGAGAATGGCATGAACCCGGGGGGGCGGAGCTTGCAGTGAGCTGAGATCATGCCACTGCACTCCAGCCTGGGCAACAAAGTGAGACTCCGTCTCAAAAAAAAAAACCAAAAAACAAAATGAGCTGGGTGTGGTGGTGGGGGCGTATAATCCCAGCTATACAGGAGGCTGAGGTAGGAGAATCACTTGAACCCGGGAGGTGGAGGTTGCAGTGAGCCGAGATTGTGCCATTTCACACCAACCTGGGTAACAAGAGTAAAATGCTGTCTCAAAAAAAAAAAAGAAAAA","GGCTGGGCGCAGTGGCTCACACCTGTAATCCCAGCACTTAGGGAAGCTGAGGCGAGTAGATCACCTGAGGTCAGGAGTTAGAGACCAGCCTGGCCATCATGGTGAAACCCCGTCTCTACTAAAGATACCAAAAATTAGCTGAGTGTGGTGCTGGGTGCCTGTAATCCCAGAAACTCAGGGTGCCTGTAATCCCAGCAACTCAGGGTGCCTTTAATCCCAGCAACTGAGGGTACCAGTAATCCCAGCAACTCAGGGTGTCTTTAATCCTAGCAACTGAGGGCACCTGTAATCCCAGCAACTCAGGAAGCTGAGACAGGAGAAGTACTTGAACCCAGAAGGCAGAGGTTGCAGTGAGCCGATATTGCACCATTGCACTCCAGTCTGGGCAACAAGAGTGAAACTCTGTCTCAAAAAAAAA"
"chr16","59738190","59738518","JH378138","4229795","4230103","67","55508395","TCACAGCATTTTGGGAGGCCAAGGCAGGCGGATCACCTGTGGTCAGGAGTTTGAGACCAGCCTGGCCAACATGGTGAAACCCCATCTCTACTAAAAATACAAAACAATTAGCCAGGTTTGGTGGCAGGCGCCTATAATCCCAGCTACTTGGGAGGCTGAGGCAGGAGAATCGCTTGAACCCAGGAGGCGGAGGTTGCAGTGAGCCGAGAACACACCATTGTACTCCAGCCTGCGACAAGAACGAAACTGTATCTCAATTAAAAAAAAAAAAAGAAAGGGAGGAAGGAAGGAAGGAAGGAAGGAAGGAAGGAAGGAAGAAAGAAAGAAAA","CACTTTGGGAGGTGAAGGCGGGCAGATCACCTGAGGTCAGGAGTTCGAGACCAGCCTGGCCAACATGGTGAAACCCCGCCTCTACTAAAAATACAAAAATTAGCCAGGTGTGACACTAGGCATCTGTAATCCCAGCTACTTGGGAGGCTGAGACAGGAGAATCACTTGAACCCAGGAGGCGGAAGTTGCAGTGAGCCAAGATCATGCCATTGCACTCCAGCCTGGGTGACAGGAGCAAAACTCTGTCTCAAAAAAAAAAAAAAAAAAAAAAAAAAAAAAAAAAAAAAAAGAAAAGAAAAGAAAAGTAAA"
"chr16","64682336","64682940","JH378118","18053084","18053501","253","46629252","GGCCGGGCACGGTGGCTCACTCCTGTAATCCCAGCACTTTGGGAGGGTGAGGCAGGTAGATCAAAAGGTCAGGAGTGGCCAGGCGTGGTGGCTCACACTTGTAATCCCAGCACTTTGGGAGGCCGAGATGGGCAGATCACGAGGTCAAGAGATTGAGACCATCCTGGCTAACATGGTGAAACCCCGTCTCTACTAAAAATACAAAAAATTAGCCGGGTGTGGTGGCAGGCGTCTGTAATCCCAGCCACTTGGGAGGCTGAGGCAGGAGAATCGCTTGAACCTGGGCGGCAGAGGTTGCATTGAGCCAGGATCGCGCCACTGCACTCCAGCCTGAGCAAAAAGAGCGAAACTCTGTCTCAGAAAAAAAAAAAAGTCAGGAGTTTGAGACCAGCCTGGCCAATATGGTGAAACCCCGTCTCTACTAAAAATACAAAAATTAGCCGAGCGTGGTGGTGGGTGCCTATACTCCCAGCTACTCAGGAGGCTGAGGCAGGAGAATCACTTGAACCCCAGGGGCAGAGGTTGCAGTGAGCCGAGATCGTGCCATTGCACTTCACCCTGGGTGAAAGAGCAAAACTCCGTCTCAAAAAAACAAAACAAAAAAA","GGCTGGGCGCAGTGGCTCACACCTGTAATCCCAGCACTTAGGGAAGCTGAGGCGAGTAGATCACCTGAGGTCAGGAGTTAGAGACCAGCCTGGCCATCATGGTGAAACCCCGTCTCTACTAAAGATACCAAAAATTAGCTGAGTGTGGTGCTGGGTGCCTGTAATCCCAGAAACTCAGGGTGCCTGTAATCCCAGCAACTCAGGGTGCCTTTAATCCCAGCAACTGAGGGTACCAGTAATCCCAGCAACTCAGGGTGTCTTTAATCCTAGCAACTGAGGGCACCTGTAATCCCAGCAACTCAGGAAGCTGAGACAGGAGAAGTACTTGAACCCAGAAGGCAGAGGTTGCAGTGAGCCGATATTGCACCATTGCACTCCAGTCTGGGCAACAAGAGTGAAACTCTGTCTCAAAAAAAAA"
"chr16","67872770","67873371","JH378118","18053084","18053501","260","49819686","GGCTGGGCATGGTGGCTCATGCCTGTAATCCCAGCACTTTGGGAGGCCAAGACGGGCAAATCACCTCAGGTCAGGAGATCGAGACCAGCCTGGCCAACACAGCAAAACCCACCTCTCTACTAAAAATAGAAAAATTACCCAGGCGTCACAGCTCACGCTTATAATCCCAGCACTTTGGGAGGCCGAAGCAGGTGGATCACAAGGTCAGGAGATCGAGACCAGCCTCACTAACATGGTGAAACCCCGTCTCTACTGAATATACGAAAAATTAGTCGGGTGTGGTGGCAGGCACCTGTAGTCCCAGCTACTTGGGAGGCTGAGGCAGGAGAATGGCTTTAACTCAGGAAGAGGAGCTTACGGTGAGCTGAGATTGTGCCACTGCACCCCAGCCTGGGCGACAGAGCAAGACTCCGTCAAAAAAAAAAAAAACCCCAAAACCCCAGCGTGGCAGCAGGTACCTGTAGTCCCAGCTACTCGGGAGGCTGAGACAGGAGAATGGCTTGAACCCGGGAGGCGGAGCTTGCGGTGAGCCAAGACGGCGCCACTTCATTCCAGCTATGGTGATAAGAGGGAGACCGTCTCAATCAATAAATTTAAAAAAA","GGCTGGGCGCAGTGGCTCACACCTGTAATCCCAGCACTTAGGGAAGCTGAGGCGAGTAGATCACCTGAGGTCAGGAGTTAGAGACCAGCCTGGCCATCATGGTGAAACCCCGTCTCTACTAAAGATACCAAAAATTAGCTGAGTGTGGTGCTGGGTGCCTGTAATCCCAGAAACTCAGGGTGCCTGTAATCCCAGCAACTCAGGGTGCCTTTAATCCCAGCAACTGAGGGTACCAGTAATCCCAGCAACTCAGGGTGTCTTTAATCCTAGCAACTGAGGGCACCTGTAATCCCAGCAACTCAGGAAGCTGAGACAGGAGAAGTACTTGAACCCAGAAGGCAGAGGTTGCAGTGAGCCGATATTGCACCATTGCACTCCAGTCTGGGCAACAAGAGTGAAACTCTGTCTCAAAAAAAAA"
"chr16","67970409","67971018","JH378118","18053084","18053501","252","49917325","GGGCGGGTGCGGTGGCTCACCCTGTAATCCCAGCACTTTCGGAGGCTTAAGCAGGCGGATCACCTGAGGTCAGGAGTTCGAGACCAGCCTGGCCAACATGGTGAAACCCCATCTCTACTAAAAATACAAAAAAATGGCCGGGTGCGGCGGCTCATGCCTGTCATCCCAGCACTTTCGGAGGCTGAGGCAGGCGGATCACCGGAGGTCAGGAGTTCGAGACCAGCTTGGCCAACATGGTGAAACCCCGTCTCTACTAAAAATACAAAAGTTAGCTGGGCATGGTGGCACATGCCTGTAATCCCAGCTACTCCGGAGGCTGAGGCAGGAGAATCACTTGAACCTGGGGAGGCGGAGGTTGCAGTGAGCTGAAATCACGGCATTGCACTCCAGCCTAGGCAACAGAGCGAAAGTCCGTCTCAGAAAAAAAAAAAAAAAAATTAGATGGGTTTGGTGGCGGGCGCGCTGTAATCCCAGCTACTTGGGAGGCTGGAGGCAGGAGAATCGCTTGAACTCAGGAGGCTGAGGTTACAGTGAGCCGAGATCATGCCATTGCACTCCAGCCTGGGCAATAAGAGTGAAACTCTGTCTCAAAAAACAACAACAACAAAAA","GGCTGGGCGCAGTGGCTCACACCTGTAATCCCAGCACTTAGGGAAGCTGAGGCGAGTAGATCACCTGAGGTCAGGAGTTAGAGACCAGCCTGGCCATCATGGTGAAACCCCGTCTCTACTAAAGATACCAAAAATTAGCTGAGTGTGGTGCTGGGTGCCTGTAATCCCAGAAACTCAGGGTGCCTGTAATCCCAGCAACTCAGGGTGCCTTTAATCCCAGCAACTGAGGGTACCAGTAATCCCAGCAACTCAGGGTGTCTTTAATCCTAGCAACTGAGGGCACCTGTAATCCCAGCAACTCAGGAAGCTGAGACAGGAGAAGTACTTGAACCCAGAAGGCAGAGGTTGCAGTGAGCCGATATTGCACCATTGCACTCCAGTCTGGGCAACAAGAGTGAAACTCTGTCTCAAAAAAAAA"
"chr16","68229729","68230314","JH378206","6546474","6546861","256","61683255","TGGTTTCCGCCTGTACTCCCAGCACTTTCGGAGGCTCAAGTGAGCAGATCGCTTGAGGCCAGGAGTTTAAGACCTACCTAGTCAACACCGGGGAAACCCACATCTCCACTAAACAATGGCCAGGAGCAGTGGCTCATACCTGTAATCACAACACTTTGGGATCCCAGCCAGACGGATCACAAAGTCAGGAGTTTGCGACCAGCCTATTAGAATGGTGAAACCCTGTCTCTACTAAAAATACAAAAAATTAGCCAGGCATGGTGGCGCATGCCTGTCATCCCAGCTACTCGGGAGGCTGAGGCAAGAGAATCACTTAAACCCAGGAGGCAGATGGAGGTTGCAGTGAGCCAAGATCACACCACTGCACTACAGCATGGGCGACAGAGCAAGACTCGGTCTCAAAAAAAAAAAAATTGGCCAGGCACGGTGGCTGACACCTGTAATCCCAGCACTTTGGGAGGCTGAGGCGGGAGAATCGCTTGAACCTGGGAGACGAAGGTTGCAGTGAGCCGAGACTAAGCCATTGCACCCCAACCTGGGCGGCAAGAGTGAAACTCTGTCTCAAAAAAAATTAAAAAATAAAAAA","GGCCACACATGGTGGCTAACGCCTGTAATCCCAGCACTTTGGGAGGCCAAGTCGGGTGGATCATGAGGTCAGGAGACCAAGACCATCCTGGCCAAATGGTGAAACCCCGTCTCTACTAAAAATACAAAAATTAGCTGGGCATGGTGGCGTGTGCCTGTAATCCCAGCTACTCAGGAGGCTGAGGCAGGACAATTGCCTGAACCCAGGAGAATTAGCTGGGCATGGTGGCGTGTGCCTGTAATCCCAGCTACTCAGGAGGCTGAGGCAGGACAATTGCCTGAACCCAGGAGGCGAAGGTTGCGGTGAGCCGAGATTGTGCCATTGCACTCCAGCCTGGGTAACAAGAGCGACACTCTGTCTCAAAAAAAAAAAAAAAAAAAAAAAAAAA"
"chr17","3506470","3507049","JH378118","18053084","18053501","238","14546614","CCTGTCATCCCAGCACTTTGGGAGGCCGAGGCGGGTAGATCACCTGAGGTCAGGAGTTTGAGACCAGCCTGGCCAACATGGCGAAACCCCGTCTCTACTAAAAATACAAAAACTGGCTGGGCGCGGTGGCTCACGCCTGTAATCCCAGCACTTTGGGAGGCTGAGGCGGGTGGATCATAAGGTCAGGAGTTCAAGACCAGCCTGGCCAACATGGTGAAACCCCATCTCTACTAAAAATACAAAAATTAGCCAGGTATGGTGGCAGGTGCCTGTAATCCCAGCTACTCAGGAGGCTGAGGCAGAGAATTGCTTGAACCCGGGAGGGGGAGGTTGCAGAGGGCCAAGATCGTACCACTATACTCCAGCCTGGGTGACAGGATGAGACTCCATCTTAAAAAAAAAAAAAAAAAAAAAAATTAGCCAGGCGTGGTGCGGGCACTTGTAATCCCAGCTATTCAGGAGGCTGAGGCAGGAGAATTGCTTGAACCCGGGAGGCAGAGGTTGCGGTGAGCTGAGATCGCACCATTGCACTCCAGCCTGGGCAACAAGAGTGAAACTCTGTCTCAAAAAAAAAACAAAA","GGCTGGGCGCAGTGGCTCACACCTGTAATCCCAGCACTTAGGGAAGCTGAGGCGAGTAGATCACCTGAGGTCAGGAGTTAGAGACCAGCCTGGCCATCATGGTGAAACCCCGTCTCTACTAAAGATACCAAAAATTAGCTGAGTGTGGTGCTGGGTGCCTGTAATCCCAGAAACTCAGGGTGCCTGTAATCCCAGCAACTCAGGGTGCCTTTAATCCCAGCAACTGAGGGTACCAGTAATCCCAGCAACTCAGGGTGTCTTTAATCCTAGCAACTGAGGGCACCTGTAATCCCAGCAACTCAGGAAGCTGAGACAGGAGAAGTACTTGAACCCAGAAGGCAGAGGTTGCAGTGAGCCGATATTGCACCATTGCACTCCAGTCTGGGCAACAAGAGTGAAACTCTGTCTCAAAAAAAAA"
"chr17","3641899","3642243","JH378198","5062782","5063109","59","1420883","GGCCAGGCACAGTGGCTCACACCTGTAATCCCAGCACTTCAGGAGGCCGAGGTGGGTAGATCACCTGAGGTCAGGGGTTTGAGACCAGCCTGACCGACGTGGCGAAACCCTGTCTCTACTACAAATACAAAAATTAGCCTTATGTGGTGGCGGGCACGTGTAATCCCAGCTACTTGGGAGGCTGAGGCAGGAGAATCGCTTGAATCTGGGAGGTGGAGGTTGCAGTGAGCCGAGATCACGCCATTGCACTCCAGCCTGGGTGACAAGAGCGAAACTCCATCTCAAAATAAATAAATACATACATACATGTATACATACATACATACATAAAAATAAAAAGTAAAA","GCCAGGCATGGTGGCTCACGCCTATAATCTCAGCACTTTGGGAGGCTGAGGCAGGCAGATCACTTGAGGTCAGGAGTTCAAGACCAGCCTGGCCAACATGGTGAAACCCTGGCTCTACTAAAAATACAAAAATTAGCCGGGTGTGGTGGCACGTGCCTATAATCCCAGCTACTCAGGAGGCTGAGGCAGAAGAATCGCTTGAATCCAGGAGGTGGAGGTTGCAGCGAGCCGAGATCACACCATTGGACTCCAGCCTGGGTGACAAGAGCGAAACTCCATCTCAAAATAAATAAATAAATACATAAAATTAAAAATAAATAAATAAATA"
"chr17","4508039","4508546","JH378206","6546474","6546861","194","2038435","GAGTTGGAGACCAGCCTGGCCAACACGGTGAAACCTCGTCCCCACTAAAAATATAAAAATTAGGCCAGGCGCGGTGGCTCACTCCTGTAATCCCAGCACTTTGGGAGGCTGAGGCGGGTAGATCATCTGAGGTCAGGAGTTCGAGACCAGCCTGGCCAACATGGTGAAACTCCGTCTCTACTAAAAATACAAAAATTAGCTGGGCTGGTAGCGGGCACCTGTAATCCCAGCTACTTGGAAGGGTGAGGCAGGAGAATCACTTGAACCCAGGAGGTGGAGGTTGCAGTGAGCCAAGATTGCAGCACTGTACTCCAGCCTGGGTGACAAAGCAAGACTCTGTCTCAAAAAAAAAAAAAAAAAAAAAGCCGGGCTTGGTGGTGAGTACCGGTAATCCCAGCTACTTGGAAGGCTGAGGCGGCGGACGTTGTACTTAGCCGAGATCATGCCATTGCACTCCAGCCTGGGTAACAGGCAAAAACTCTGTCTCAAAAAATAATAAATAATAAAA","GGCCACACATGGTGGCTAACGCCTGTAATCCCAGCACTTTGGGAGGCCAAGTCGGGTGGATCATGAGGTCAGGAGACCAAGACCATCCTGGCCAAATGGTGAAACCCCGTCTCTACTAAAAATACAAAAATTAGCTGGGCATGGTGGCGTGTGCCTGTAATCCCAGCTACTCAGGAGGCTGAGGCAGGACAATTGCCTGAACCCAGGAGAATTAGCTGGGCATGGTGGCGTGTGCCTGTAATCCCAGCTACTCAGGAGGCTGAGGCAGGACAATTGCCTGAACCCAGGAGGCGAAGGTTGCGGTGAGCCGAGATTGTGCCATTGCACTCCAGCCTGGGTAACAAGAGCGACACTCTGTCTCAAAAAAAAAAAAAAAAAAAAAAAAAAA"
"chr17","4560867","4561450","JH378118","18053084","18053501","257","13492217","GGCTGGGGGTGGTGTCTCTTGCCTGTAATCCCAACACTTTAGCAGGCTGAGGTGTGAGTATGGCTTGAGCCAGGAGTTCTAGACCAGCCTAGGAAACATGGCGAGATCCCTATCTCTACTAATACAAAAATTAGCCGGGCGTGGTGGCAAGCACCTGCAATCTCAGCTACTCGGGAGGCTGAGGTGGGAGGGCCGCTTGAGCCCAGGAGGTCCAGGCTGCAGTAAGCACTTATTTAAAAAAAAAAGAAGAGAAAAGATACAGAAATTAGCCAGGCGTGGTGGTGGGCACCTGTAATCCCAGCTACTCAGGAGGCTGAGGCAGGAAAATCACTTGAACCCGGGAGGCAGAGGTTGCAGTGGGCCGAGATCACACCATTGTACTCCAGCCTGGGCAACAAGAGCGAAACTCTGTCTCAAAAAAAAGAAAAGTAAAGTAAAGAAAAGATACAGAAATTAGCCAGGTGTGGTGGCGGGTGCCTGTAATCCCGCTACTTGGGAGGCTGAGGCAGGAGATTGCAGTGAGCCAAGATTGTGCCATTGCATTCCAGCCTGGGCAACAAGAGCAAAACTCCGCCTCAAAAAAA","GGCTGGGCGCAGTGGCTCACACCTGTAATCCCAGCACTTAGGGAAGCTGAGGCGAGTAGATCACCTGAGGTCAGGAGTTAGAGACCAGCCTGGCCATCATGGTGAAACCCCGTCTCTACTAAAGATACCAAAAATTAGCTGAGTGTGGTGCTGGGTGCCTGTAATCCCAGAAACTCAGGGTGCCTGTAATCCCAGCAACTCAGGGTGCCTTTAATCCCAGCAACTGAGGGTACCAGTAATCCCAGCAACTCAGGGTGTCTTTAATCCTAGCAACTGAGGGCACCTGTAATCCCAGCAACTCAGGAAGCTGAGACAGGAGAAGTACTTGAACCCAGAAGGCAGAGGTTGCAGTGAGCCGATATTGCACCATTGCACTCCAGTCTGGGCAACAAGAGTGAAACTCTGTCTCAAAAAAAAA"
"chr17","4846296","4846953","JH378118","18053084","18053501","290","13206788","GGCCAGGTGCAGTGGCTCACGCCTGTAATCCCAGCACTTTGGGAAGCCCAGGTGGGCGGATCACCCAAGGTCAGGGGTTCGAGACCAGCCTGGCCAACATGGTGAAACTCCATCTCTACTAAAAATAGAAAAAAATGGCCTGGTACGGTGGCTAACGCCTGTAATCCCAGCACTTTGGTAGGCCGAGGCAGGCAGATCACGAGGTCAGAAGATCGAGACCATCCTGGCTAACATGGTGAAACCCCGTCTCTACTAAAAATACAAAAAAGTAGCCAGGTGTGGTGGTGGGTGCCTGTAGTCCTAGCTACTCGGGAGGCTGAGGCAGGAGAATGCCGTGAACCCGGGAGGTGGAGCTTGCAGTGAGCTGAGATCACGCCACTGCACTCCAGCCTGGGTGACAGTGCGAGACTGTCTCCAAAAAAAAAAAAAAAAAAAAATTATATATATAATACACACACACACACACACACACACACACACACACAAATCAGCCAGGCGTGGTGGTGCGCACCTGTAATCCCAGCTACTCGGGAGGCTGAGGCAGGAGAGCTCCTCGAACCCAGGAGGCGAAGGTTGCAGTGAGCCGAGATCACACCATTGCACTCCAGCCTGGGCAACAAGAGCGAAACTCTGTCTCAAGGAAAAAAAAAAAAAAAAA","GGCTGGGCGCAGTGGCTCACACCTGTAATCCCAGCACTTAGGGAAGCTGAGGCGAGTAGATCACCTGAGGTCAGGAGTTAGAGACCAGCCTGGCCATCATGGTGAAACCCCGTCTCTACTAAAGATACCAAAAATTAGCTGAGTGTGGTGCTGGGTGCCTGTAATCCCAGAAACTCAGGGTGCCTGTAATCCCAGCAACTCAGGGTGCCTTTAATCCCAGCAACTGAGGGTACCAGTAATCCCAGCAACTCAGGGTGTCTTTAATCCTAGCAACTGAGGGCACCTGTAATCCCAGCAACTCAGGAAGCTGAGACAGGAGAAGTACTTGAACCCAGAAGGCAGAGGTTGCAGTGAGCCGATATTGCACCATTGCACTCCAGTCTGGGCAACAAGAGTGAAACTCTGTCTCAAAAAAAAA"
"chr17","6289040","6289368","JH378152","15932639","15932952","57","9643599","GGCTGGGCGTGGTGGCTCACGCCTGTAATCCCAGCACTTTGGGAGGCCAAGGTGGGTAGATCACCTGAGGTCAGGAGTTTGAGACCAGCCTGGCCAATGTGATGAAACCCTGTATCCACTAAAAAAAAAAAAAAAAAAAAAAAAAAAAATAGCTGGGTGAAGTGGCAAGCACCTGTAATCCCAGCTACTTGGGAGGCTGAGGCAGGAGAATCCCAGGAGGTGGAGATTGATCCCAGGAGGTGGAGGTTGCAGTGAGTCAAGATCATGCCATTGCACTCCAGCCTGGGTGACAAGAGCAAAATTCCATCTCAAAAAAAAAAAAAAGAAAA","GGCCGGGCATGGTGGCTCAAGCCTGTAATCCCAGCACTTTGGGAGGCCGAGGCGGGTGGATCACGAGGTCAAGAGATTGAGACCATCCTGGTCAACATGGTGAAACCCCGTCTCTACTAAAAATACAAAAAAAAAAAAAAAAAAAATAGCTGGGTGTGGTGGCGTGTGCCTGTAATCCCAGCTACTCAGGAGGCTGAGGCAGGAGAATTGCCTGAACCCGGGAGGCGGAGGTTGCGGTGAGCCGAGATCGCGCCATTGCACTCCAGCCTGGGTAACAAGAGCGAAACTCCGTCTCAAAAACAAAAAAAACAAAA"
"chr17","7490664","7491294","JH378118","18053084","18053501","283","10562420","GGCCGGGAGCGGTGGTTCACTCCTGTAATCCCAGCACTTTGGCAGACCGAGGAGGGTGGATCAACTGAGGTCAGAACTTCAAGACCAGCCTGCCGGGCACAGTGGCTCACACCTGTAATCCCAGCACTTTGGGAGGCTGAGGCAGGTGGATCACCCGAGGTCGGGAGTTCAAGACCAGCCTGACCAACGTGGAGAAACCCCGTCTCTACTAAAAATACAAAATTAGCTGGGGTGGTGGCACGTACCTGTAATCCCAGCTACTCGGGAGGCTGAGGCAAGAGAATCGCTTGAACCCGGGAGGCGGAGGTTGCGGTGCGCCGAGATCGCGCCATTACACTCCAGCCTGGGCAAAAAGAGCGAAACTCTGTCTCAAAAAATAAAAAAAGAAAAAGAAAAAGAAAAAGAAGTTCAAGACCAGCCTGGTCAACGTGGTGAAACCCCGTCTCTACTAAAAACACAAAAAAAATTAGGCGGGTGTTGTGGTGGGTGCCTGTAATCCCAGCTACTCAGGAGGCCAAGGCAGGAGAATCACCTGAACCCTGGAGGTGGAGGTTGCAGTGAGTCGAGATCGCACCATTGCACTCCAGCGTGGGTGACAGAGAGCGAGACTCCGTCTCAAAAAAAAAGAAAA","GGCTGGGCGCAGTGGCTCACACCTGTAATCCCAGCACTTAGGGAAGCTGAGGCGAGTAGATCACCTGAGGTCAGGAGTTAGAGACCAGCCTGGCCATCATGGTGAAACCCCGTCTCTACTAAAGATACCAAAAATTAGCTGAGTGTGGTGCTGGGTGCCTGTAATCCCAGAAACTCAGGGTGCCTGTAATCCCAGCAACTCAGGGTGCCTTTAATCCCAGCAACTGAGGGTACCAGTAATCCCAGCAACTCAGGGTGTCTTTAATCCTAGCAACTGAGGGCACCTGTAATCCCAGCAACTCAGGAAGCTGAGACAGGAGAAGTACTTGAACCCAGAAGGCAGAGGTTGCAGTGAGCCGATATTGCACCATTGCACTCCAGTCTGGGCAACAAGAGTGAAACTCTGTCTCAAAAAAAAA"
"chr17","9634166","9634493","JH378110","12773123","12773444","45","3138957","GGCTGGGTGCGGTGGCTCACGCCTGTAATCCCAGCACTGTGGGAGGCCGAGGCAGGTGGATCACCTGAGGTCAGGAGTTTGAGACCAGCTTGGCCAACATGGTGAAACCCTGTCTGCACTAAAAATACAAAAAAAAAAAAAAAAAAAAAAAAATTAGCTGGGTGTGGTGGCGGACGCCTATAATCCCAGCTACTGGGGAGGCTAAGGCAGGAGAATCGCTTGAACCTGGGAGGTGGAGATTGCAGTGAGCCAAGATGGTGCCATTGCACTCCAGCCTGGACAACAAGAGCGAAACTCGGTTTCAAAAAAAAAAAAAAAAAAAAAAAAA","GGCTGGGCGTGGTGGCTCATGCCTATAATCCCAGCACTTGGAGAGGCCAAAGCAGGCAGATTATTTGAGGTCAGGAGTTCCAAACCAGCCTGGCCAACATGGTGAAACCCTGTATCTACTAAAAATGCAAAAAAAAAAAAAAAAAAAAAAATTAGCTGGGCGTGGTGGCAGGTGACTGTATCCCAGTACTTGGTAGGCTGAGGCAGGAGAATTGCTTGAACCTGGGAGGTGGAGGTTGCAGTGAGCTGAGATTGTGCCATTGCACTCCAGCCTGGGCAACAAGAGCAAAACTCTGTCTCAAAAAAAAAAAAAAAAAAAAAAA"
"chr17","9636859","9637187","JH378193","2430153","2430476","55","7206706","GACACGGTAGCTCACGCCTGTAATCCCAGCACTTTGGGAGGTCGAGGCGGGTGGATCACCTGAGGTCAGGAGTTTAAGACCAGCCTGGCCAACATGGTGAAACCCCGTCTCTGCTAAAAATACAAGAATTAGCCAGGCGTGGTGGTGGGCGCCTGTAATCCCAGCTACTGGGGAGGCTGAGGCAGGAGAATCACTTGAACCCAGAAGGTGGAGGTTGCAGTGAGCCAAGACCACACCACTGGACTGCAGCCTGGCGGACAAGAGCGAGACTCTGTCTCAAAAACAACAACAACAACAACAACAACAACAAAAGAAAGAAAAGAAAAGAA","GGCCGGGCACAGTGGCTCAAGCCTGTAATCCCAGCACTTTGGGAGGCCGAGGTGGGTGGATCACGAGGTCAAGAGATCGAGACCAACCTGGTCAACATGGTGAAACCCCGTCTCTACTAAAAATACAAAAATTAGCTGGGCATGGTGGTGTGTGCCTGTAATCCCAGCTACTCAGGAGGCTGAAGCAGGAGAATTGCCTGAACCCAGGAGGAGGAGGTTGCGGTGAACCAAGATCACGCCATTGCACTCCAGCCTGGGTAACAAGAGCGAAACTCTGTCTCAAAACAAAACAAAACAAAACAAAACAAAACAAACAAAAAAAAA"
"chr17","9725612","9725938","JH378224","2846632","2846964","49","6878980","GGGCGTGGTGGCTCACACCTGTAATCCCAGCACTTTGGGAGGCCGAGGTGGGCGGATTGCCTGAGGTCAGGAGTTCGAGACCAGCCTGGCCAACCCGGTGAAACCCTGTCTCTACTAAAATACAAAAAAAAAAAAAAAAAAAAAAAAAAATTTAGCTGTGTGTGGTGGTGTGCACCTGTAATCCCAGCTACTCAGAAGGCTGAGGCAGGAGAATCGCTAGAACCCGGGAGGCGGAGGTTGCAGTGAGCCGAGATCGCACCATTACGCTCCAGCTTGGGCAACAAGAGTGAAACTCCATCTCAAAAACAAAACAAAACAAAACAAAAA","GGCCAGGCAGGGTGGCTTACATCTGTAATCCCAGCACTTTGGGAGGTCAAGGCGAGTGGATCACCTGAGGTCATGAGTTCAAGACCAGCCTGGCCAACTTGGTGAAACCCTGTCTCTACTAAAAATACAAAAAAAAAAAAAAAAAAAAAAAAAAAAATTAACTGGGTGTGGTGGTGCACACCTGTAATCCCAGCTACTCAGGAGGCTGAGGCAGGAGAATCCCTTGAACACGGGAGGTGGAGGTTGCAGTGAGCCGAGATCATGCCATTGCACTCCAGCCTTGGTGAAAAGAGCAAAACTCTGTCTTAAACAAAACAAAACAAAACCAGAAAA"
"chr17","11904179","11904388","JH378115","24252957","24253162","48","12348778","CCTGTCTTTACAAAAAATGCAAAAACAAAACAAAACAAAACAAAACAAAAACCGGGCATGGTGGTGAGCACCTGTAATCCCAGCTACTTGGGAGTTTGAGGCAGGAGAATCACTTGAACCTGGGAAGCGGAGGTTGCAGTGAGCCGAGACCGCGCCATTGCACTCCAGCCTGGGCAACAAGAATGAAACTCTGTCTCAAAAAAAAAAAAA","TGGTGAAACCCTGTCTTTACTAAAAATACAAAAAAAAAAAAAATTAGCTGGGCATGGTGGCACATGCCTGTAGTCCCAGCTGCTCGGGAGGCTGAGGCAGGAGAATTGCTTGAACCCAGGAGGCGGAGGTTGCAGTGAGCCGAGATCGAGCCATTGCACTCCAGCCTGGGCAACAAGAGCAAAACTCCGTCTCAAAACAAAATAAA"
"chr17","15884346","15884946","JH378118","18053084","18053501","249","2168738","GCCAGGCAGGTGGCTCAGGACTGTAATCCCAGCCTTTTGGGAGGCTGAGGCGAGTGGATCACCTGAGGTCAGGAGTTCGACACCAGCCTGGTCAACATGGTGAAACCCCGTCTCTACTAAAAAATACAAAAAATTGGCCAGGCGCAGTGTCTCACGCCTGTAATCCCAGCACTTTAGGAGGCTGAGGCAGGTGGATCACTTGGTCAGGAGATCGAGACCATCCTGGCCAACATGGTGAAACCCTGTCTCTATCAAAAATACAAAAATTAGCTGGGCGTGGTGGCATATGCCTATAATCCCAGCTACTTGGGACGCTGAGGCAGGAGAATCACTTGAACCAGGGAGTCAGAAGTTGCAGTGAGCCGAGATTGCGCCACTGCACCCCAGCCTGGTGACAGAGTGAGACTGTCTTAAAAAACAAAAAACAAAAAATTAGCCAGGTATGGTACCAGGTGCCTGTAACCCCAGCTACTTGGGAGGCTGAGGCAGGAGTATCGCTTGAACCCTGGAGGTGGAGGATGCAGTGAGCTGAGAGCACGCCATTGTACTCCAGCCTGGGCAACAAGAGTGAAACTCCATCTAAAATAAATAAAAATAAAAA","GGCTGGGCGCAGTGGCTCACACCTGTAATCCCAGCACTTAGGGAAGCTGAGGCGAGTAGATCACCTGAGGTCAGGAGTTAGAGACCAGCCTGGCCATCATGGTGAAACCCCGTCTCTACTAAAGATACCAAAAATTAGCTGAGTGTGGTGCTGGGTGCCTGTAATCCCAGAAACTCAGGGTGCCTGTAATCCCAGCAACTCAGGGTGCCTTTAATCCCAGCAACTGAGGGTACCAGTAATCCCAGCAACTCAGGGTGTCTTTAATCCTAGCAACTGAGGGCACCTGTAATCCCAGCAACTCAGGAAGCTGAGACAGGAGAAGTACTTGAACCCAGAAGGCAGAGGTTGCAGTGAGCCGATATTGCACCATTGCACTCCAGTCTGGGCAACAAGAGTGAAACTCTGTCTCAAAAAAAAA"
"chr17","16331846","16332458","JH378118","18053084","18053501","252","1721238","GGCCATGTGTGGTGGTTCACACCTGTAATCTCAGAACTTTGGGAGGCCGAGGTGGGTGGATCACCTGAGGTCAGGAGTTCGAGACCAGCCTGGCCAACATGGTGAAACCTCATCTCTACTAAAAATACAAAAAATTAAGGCCATACCCAGAGACTCATGCCTGTAATCCCAGCACTTTGGGAGGCTGAGGCGGATGGATCACTTGAGGTCAGGAGTTCAAAACCAGCCTGGCCAACATGGTGAAACCCCATCTCTACTAAAAATATAAAAATTAGCCGGGTGTGATGGCAGGCACCTGTAATCCCAGCTACTTGGGAGGCTGAGGCAGGAGAATTGCTTGAACCCAGGAAGCAGAGGTTGTGGTGAGCCGAGGTCGCGCCATTGCACTCCAGCCTGGGCAACAGAATGAGACTGTCTCAAAAAAAAAAAAAAAAAAAAATCAGCCAGGAGTGGTGGCGGGGGCACCTGTAATCCCAGCTACTCGGGAGGCTGAGGCAGGAGAATCGCTTGAACTCAGGAGGCAGAGGTTGCAGTGAGCTGATATCTCGCCATTGCACTCCAGCCTGGGCAACAAGAGTGAAACTGTCTCAAAAAAAAAAAAAAAAAAAAAGAA","GGCTGGGCGCAGTGGCTCACACCTGTAATCCCAGCACTTAGGGAAGCTGAGGCGAGTAGATCACCTGAGGTCAGGAGTTAGAGACCAGCCTGGCCATCATGGTGAAACCCCGTCTCTACTAAAGATACCAAAAATTAGCTGAGTGTGGTGCTGGGTGCCTGTAATCCCAGAAACTCAGGGTGCCTGTAATCCCAGCAACTCAGGGTGCCTTTAATCCCAGCAACTGAGGGTACCAGTAATCCCAGCAACTCAGGGTGTCTTTAATCCTAGCAACTGAGGGCACCTGTAATCCCAGCAACTCAGGAAGCTGAGACAGGAGAAGTACTTGAACCCAGAAGGCAGAGGTTGCAGTGAGCCGATATTGCACCATTGCACTCCAGTCTGGGCAACAAGAGTGAAACTCTGTCTCAAAAAAAAA"
"chr17","16464101","16464461","JH378293","1845184","1845523","61","14618917","GGCCGGGCGCCGTGGCTCACGCCTATAATCCCAGCACTTTGGGAGGCCGAGGCGGGTGGATCACCTGAGGTCAGGAGTTCGAGACCAGCCTGACCAACATGGTGAAACCCCCGTCTCTGCTAAAAAAAAAAAAATATATATATATATATATATAATATATAATATATATATATATATATATATAAAATAGCTGGGCATGGTGGCAGGCACCTGTAATCCCAGCTACTCAGGAGGCTGAGGCAGGAGAATCGCTTGAACCTGGGAGGTGGAGGTTGCAGTGGGCTAAGATCACACCATCGCACTCCAGCCTGGGCGACAGGAATGAAACGCTGTCTCAAAAAAAAAAAAAAAAAAAAAAAAA","GGCCGGGTGCGGTGGCTCACGCCTGTAATCCCAGCACTTTGGGAGGCCAAGGCGGGTGGATCACCTGAGGTCAGAAGTTCGAGACCAGCCTGGCCAACATGGTGAAACCCCGTCTCTGCTAAAAAGAAAAAAATAAGAAAAAAACAAAATAAGAAAATAATTTTAAAAAATACAAAATTAGCTGGGCGTGGTGGCAGGCACCTGTAATTCCAGCTATTCAGGAGGCTGAGGCAGGGGAATCACTTGAACCCAGGAGGCAGAGGTTGCAGTGAGCCAAGATGACGCCATTGCACACCAGCCTGGGCAACAAGAGTGAAACTCCGTCTCAAAAAAAAAACAA"
"chr17","16469420","16470033","JH378118","18053084","18053501","254","1583664","GCCAGGGGTGGTGGCTCATGCCTGTAATCCCAGCACTTTGGGAGGCTGAGGCGGGCAGATTGCCTGAGGTCAGGAATTCAAGACCAGCCTGGCCAACATAGTGAAACCCTGTCTCTACTAAAAATGCAAAGAATTAGCTGGGTGTTGGCCGGGCACGGTGGCTGACACCTGTAATCCCAGCACTTTGGGAGGCCTAGGCAGGCGGATCACCTGAGGTTGGGAGTTCGAGACCAGCCTGACCAACATGGAGAAACCCCGTCTCTACTGAAAATAAAAAACTAGCCAGGCATGGTGGCCCATGCCTGTAATCCCAGCTAATTGGGAGGCTGAGGCAGGAGAATCGCTTGAACCCAGGAGGCAGAGGTTGCGGTGAACCAAGATCGCATCAATGCACTCCAGCCTAGGCGACAAGAGCAAAACTCCGTCTCAAAAAAAAGAATTAGCTGGGTGTGGTGGGTGGGAACCTGTAATCCCAGTTACTAGGGAGGCTGAGGCAGGAGAATTGCTTGAACCCAGGAGGCGGAGGTTGTGGTGAGCCGAGATCGCGCCATTGCACTCCAGCCTGGACAACAAGAGCGAATCTCCGTCTCAAAAAAAAAAAAAAAAAAAAAAAA","GGCTGGGCGCAGTGGCTCACACCTGTAATCCCAGCACTTAGGGAAGCTGAGGCGAGTAGATCACCTGAGGTCAGGAGTTAGAGACCAGCCTGGCCATCATGGTGAAACCCCGTCTCTACTAAAGATACCAAAAATTAGCTGAGTGTGGTGCTGGGTGCCTGTAATCCCAGAAACTCAGGGTGCCTGTAATCCCAGCAACTCAGGGTGCCTTTAATCCCAGCAACTGAGGGTACCAGTAATCCCAGCAACTCAGGGTGTCTTTAATCCTAGCAACTGAGGGCACCTGTAATCCCAGCAACTCAGGAAGCTGAGACAGGAGAAGTACTTGAACCCAGAAGGCAGAGGTTGCAGTGAGCCGATATTGCACCATTGCACTCCAGTCTGGGCAACAAGAGTGAAACTCTGTCTCAAAAAAAAA"
"chr17","17534259","17534875","JH378118","18053084","18053501","268","518825","GGCTGGGGCGGTGGCTCACCTGTAATCCCAGCACTTTGGGAGGCAGAGGTGGGCGGATCGCCTGAGGTCAGAAGTTGGAGACCAGCCTGGCAACATGGTGAAACCCTGTCTCTACTAAAAAAAAAAAAAAAAAAAAAAAATGGCCGGGCATGGTGGCTCAAGCCTGTAATCCTAGCACTTTGGAAGGCTGAGGCGGGTGGATCACAAGGTCAGGAAATCGAGACCATCCTGGCTAACATGGTGAAACTCCGTCTCTACTAAAAATACAAAAAAAATTAGCCGGGCGTGGTGGTGGGTGCCTGTAGTCCCAGCTACTCGGGAGGCTGAGGCAGGCAAATGGAGTGAACCCGGGAGGCAAACTTGCAGTGAGCCAAGATGGCGCCATTGCACTCCAGCCTGGGCAACAAGAGCAAGACTCCTTCTCAAAAAAAAAAAAAATATATATATATATATATAGTCGGGCATGGTGGCAGGCACCTGTAATCCCAGCTACTCAGAGGCTGAGGCAGGAGAATCGCTTGAACCCTGGAGGTGGAGGTTGCAGTGAGCCAAGGTCATGCCATTGCACTCCAGCCTGGGCAACAAGAGCAAGACTCCGTCTCAAAAAAAAAAAAAAA","GGCTGGGCGCAGTGGCTCACACCTGTAATCCCAGCACTTAGGGAAGCTGAGGCGAGTAGATCACCTGAGGTCAGGAGTTAGAGACCAGCCTGGCCATCATGGTGAAACCCCGTCTCTACTAAAGATACCAAAAATTAGCTGAGTGTGGTGCTGGGTGCCTGTAATCCCAGAAACTCAGGGTGCCTGTAATCCCAGCAACTCAGGGTGCCTTTAATCCCAGCAACTGAGGGTACCAGTAATCCCAGCAACTCAGGGTGTCTTTAATCCTAGCAACTGAGGGCACCTGTAATCCCAGCAACTCAGGAAGCTGAGACAGGAGAAGTACTTGAACCCAGAAGGCAGAGGTTGCAGTGAGCCGATATTGCACCATTGCACTCCAGTCTGGGCAACAAGAGTGAAACTCTGTCTCAAAAAAAAA"
"chr17","17916069","17916669","JH378118","18053084","18053501","243","137015","GCCGGGTACAGTGGCTCACACCTGTAATCCTAGCACTTTGGGAGGCCGAGGCGGGTGGATCACCTGAGGTCAGGAGTTCGAGACCAGCCTGGCCAACATGATGAAACCCTACCTCAGCCAGGTACGGTGGTTCACGCCTGTAATCCTAGCACTTTGGGAGGCTGAGGCAGGTGGATTGCCTGAACTCAGGAGTTTGAGACCAGCCTGGGCAGCATGGTGAAACCCCATCTGTACTAAAATACAAAAACTTTGCTGGGCGTGGCGGCATGCACATGTAGTCCCAGTTACTTGGGAGGCTGAGGCAGGATAATTGTTTGAACCTGGGAGGCGGAGGTTGTACAGTGAGCCAAGATCGCGCCACTACACTCTAGCGTAGGTGACAGAGCGAGATTCCGCCTCCAAAAAAAAAAGAAACCCTGTCTCTACTAAAAATACAAACAATTAGCTGGGCGTGGTGGTGGGCGCCTGTAATCCCAGCTACTTAGGAGGCTGAAGCAGGAGAATCGCTTGAGCCCAGGAAGTGGAGGTTGCAGTGAGCTGAGATTGCTCCATTGCACTCTAGCCTGGGCAACAAGAGTGAAACTCTGTCTCAAAAAAAGAA","GGCTGGGCGCAGTGGCTCACACCTGTAATCCCAGCACTTAGGGAAGCTGAGGCGAGTAGATCACCTGAGGTCAGGAGTTAGAGACCAGCCTGGCCATCATGGTGAAACCCCGTCTCTACTAAAGATACCAAAAATTAGCTGAGTGTGGTGCTGGGTGCCTGTAATCCCAGAAACTCAGGGTGCCTGTAATCCCAGCAACTCAGGGTGCCTTTAATCCCAGCAACTGAGGGTACCAGTAATCCCAGCAACTCAGGGTGTCTTTAATCCTAGCAACTGAGGGCACCTGTAATCCCAGCAACTCAGGAAGCTGAGACAGGAGAAGTACTTGAACCCAGAAGGCAGAGGTTGCAGTGAGCCGATATTGCACCATTGCACTCCAGTCTGGGCAACAAGAGTGAAACTCTGTCTCAAAAAAAAA"
"chr17","18237318","18237912","JH378118","18053084","18053501","239","184234","GGCCATGCGTGGTGGCTCACGCCTGTAATCCCAGTACTTTGGGAGGCTGAGGTGGGAGGATCACCTGAGGTCAGGAGTTCGAGACCAGCCTGGCCAACATGATGAAACCCTGTCTCTACTAAAAATGCAAAAAATTGGCCGGGCACGGTGGCTCACGCCTGTAATCCCAGCACTTTGGGAGGCCAAGGCGGGTGGATCACAAGGTCAGGAGCTTGAGACCAGCCTGGCCAATATGGTGAAACCCCATCTCTACTAAAAATACAAAAATTAGCCAGGCGTGGTGGTACACACCTGTAGTCCCAGCTACTCGGGAGGCTGAGGCAGGAGAATTGCTTGAACTCAGGAGGCAGAGGTTGCAGTGAGCTGAGATGGTGCCACTGCACTGCAGCCTGGGCAACAGAGTGAGACTTCATCTCAAAAAAAAAAAAAAAATTAACCGGGTGTGGTGGCACGTGCCTATGGTCCCAGCCACTGGGGAGGCTGAGGCAGGAGAATCGCTTGAACACAGGAGGCAGAAGTTGCAGTGAGCTGAGATTGCACCACTGCACTCCAGCCTGGGTGACAAGAGTGGAACTCCATCTCAAAAAAAAAAGAA","GGCTGGGCGCAGTGGCTCACACCTGTAATCCCAGCACTTAGGGAAGCTGAGGCGAGTAGATCACCTGAGGTCAGGAGTTAGAGACCAGCCTGGCCATCATGGTGAAACCCCGTCTCTACTAAAGATACCAAAAATTAGCTGAGTGTGGTGCTGGGTGCCTGTAATCCCAGAAACTCAGGGTGCCTGTAATCCCAGCAACTCAGGGTGCCTTTAATCCCAGCAACTGAGGGTACCAGTAATCCCAGCAACTCAGGGTGTCTTTAATCCTAGCAACTGAGGGCACCTGTAATCCCAGCAACTCAGGAAGCTGAGACAGGAGAAGTACTTGAACCCAGAAGGCAGAGGTTGCAGTGAGCCGATATTGCACCATTGCACTCCAGTCTGGGCAACAAGAGTGAAACTCTGTCTCAAAAAAAAA"
"chr17","18951167","18952093","JH378118","18053084","18053501","537","898083","GGCCAGGGGCAGTGGCTCATGCCTGTAATCCCAGCATTTTGGGATGCCAAGGCTGGTGGATCAACTGAGGTCAGGAGTTTCAGACCACCCTGGCCAACATGGCGAAATCCCATCTCTACTAAAAATACAAAAATTAGGCCAGGCACAGTGGCTCATGCCTGTAATCCCAGCACTTTGAGAGGCCAAGGCGGGCGATCACGAGGTCAGGAGATTGAGACCATCCTGGCTAACACGGTGAAATCCTGTCTCTACTAAAAAAAAAAAATACAAAAAATTAGCCGGGACGTGGTGGCTGGCACCTGTAGTCCCAGCTACTCGGGAGGCTAAGGCAGGAGAATGGCATGAACCCGGGAGATGGAGCTTGCAGTGACCCGAGATCGCGTCACTGCACTCCAGCCTGAACAACAGAGCAAGACTATATCTCAAAAAAAAAAAAAAAAAAAAGGCCGGGTGCAGTGGCTCACGTCTGTAATCCCAGCACTTTGGGAGGCCGAGGTGGGTGGATCACGAGGTCAGGAGATCGAGACCATCCTGGCTAACATGATGAAACCCCATCTCTACTAAAAAATACAAAAAATTAGCCGGGTGTGGTGGCAGGCACCTGTAGTCCCAGCTACTCGGGAGGCTGAGGCAGGAGAATGGCATGAACCTGGGTAGTGGAACTTGCAGTGAGCCGAGATCACGCCACTGCACTCCAGCCTGGGCGACAGAGCGAGACTCTGTCTCAAAAAAAAAAAAAAAAAAAAAATTAGCCGGGCATGGTGGTGGGTGCCTGCAATCCCAGCTAGTCAGGAGGCTGAGGCTGGAGAATCCCTTGAACCCAGGAGGTAGAGGTTGCAGTGAGCCAAGATCACGCCATTGCATTCCAGCCTGGGCAACAAGAGTGAAATTCTGTCTCAAAAAAATAAACAAACAAGTAAAATAAAA","GGCTGGGCGCAGTGGCTCACACCTGTAATCCCAGCACTTAGGGAAGCTGAGGCGAGTAGATCACCTGAGGTCAGGAGTTAGAGACCAGCCTGGCCATCATGGTGAAACCCCGTCTCTACTAAAGATACCAAAAATTAGCTGAGTGTGGTGCTGGGTGCCTGTAATCCCAGAAACTCAGGGTGCCTGTAATCCCAGCAACTCAGGGTGCCTTTAATCCCAGCAACTGAGGGTACCAGTAATCCCAGCAACTCAGGGTGTCTTTAATCCTAGCAACTGAGGGCACCTGTAATCCCAGCAACTCAGGAAGCTGAGACAGGAGAAGTACTTGAACCCAGAAGGCAGAGGTTGCAGTGAGCCGATATTGCACCATTGCACTCCAGTCTGGGCAACAAGAGTGAAACTCTGTCTCAAAAAAAAA"
"chr17","20996420","20997041","JH378118","18053084","18053501","266","2943336","GGCTAGGCGCGGTGGTTCACACCTGTAATCCCAGCACTTTGGGAGGCCAAGGTGGGTGGATCACCTGTGGTCAGGAGTTCGAGACCAGCCTGGCCAACATTGTGAAACCCCGTCTCTACTAAAAATGCAAAAAATTAGCTGGGCGACCAGTCATGGTAGCTCACGCCTGTAATCCTAGCACTTTGGGAGGCCAAGGCGGGTGGATTGCCTGAGCTCAGGAGTTAGAGGCCAGCCTGGGCAACATGGTAAAACCCTGTCTCTACTAAAATACAAAAAAAAAAAAAAAAATTAGCTGGGTGTGACAGCGTGCATCTGTAATCCCGGTTACTTGGGAGGTTGAGGCAGGAGAATTCCTTGAACCTAGGAGGCGGAGGTTACAGTTAGCCGAGATCACGCCATTGCACTCCAGCCTGGGCAACAGAGCGAGACTCCATCTCAAAAAAAAAAAAAAAAATTCAGCTGGGCGTGGTGGCGGGCACCTGTGATCCTAGCTACTCAGGAGGCTGAGGCAGGAGAATCATTTGAACTCCGGAGGCGGAGGTTGCAGTGACCCTAGATCGCACCATTGTGTTCCAGCCTGAGCAACAAGAGCGAGACGCCATCTGAAAAAAAAAAAAAGAAA","GGCTGGGCGCAGTGGCTCACACCTGTAATCCCAGCACTTAGGGAAGCTGAGGCGAGTAGATCACCTGAGGTCAGGAGTTAGAGACCAGCCTGGCCATCATGGTGAAACCCCGTCTCTACTAAAGATACCAAAAATTAGCTGAGTGTGGTGCTGGGTGCCTGTAATCCCAGAAACTCAGGGTGCCTGTAATCCCAGCAACTCAGGGTGCCTTTAATCCCAGCAACTGAGGGTACCAGTAATCCCAGCAACTCAGGGTGTCTTTAATCCTAGCAACTGAGGGCACCTGTAATCCCAGCAACTCAGGAAGCTGAGACAGGAGAAGTACTTGAACCCAGAAGGCAGAGGTTGCAGTGAGCCGATATTGCACCATTGCACTCCAGTCTGGGCAACAAGAGTGAAACTCTGTCTCAAAAAAAAA"
"chr17","21298865","21299429","JH378206","6546474","6546861","222","14752391","GGCCGAGGCAGGTGGATCACCTGAGGTCAGGAGTTCAAGACTAGTCTGGCCAACATGGTGAAACCCTGTCTCTACTAAAAATACAAAAAATTGGCCGGGCGCGGTGGCTCATGCCTGTAATCCCAGCACTTTGGGAGGCTGAGGCGGGTGGATCACGAGGTCGGGAGATCGAGACCATCCTGGCTAACACAGTTAAACCCTTTCTCTACTAAAAAATACAAAAAATTAGCCGGGCGTAGTGGGGGGCGCCTGTAGTCCCAGCTACTCAGGAGGCTGAGGCAGGAGACTGGCGTGAACCCGGGAGGCAGAGCTTGCAGTGAGCTGAGATCACGTCACTGCATGCCAGCCTGGGCGACAGAGCGAGACTCTGTCTCAAAAAAAAAAAATTAGCCAGGCATGGTGGTGTACACCTGTAATCCTAGCTACTCGGGAAGCTGAGCAGGAGAACAGCTTGAACCCAGGAGGCAGAGGTTGCAGTGAGCTGAGATCACGCCATTGCACTCCAGCCTGGGCAACAAGAGTGAAACTCCGTCTCAAAAAAAAAAAAAGAAAAGAAAAAAGAAAA","GGCCACACATGGTGGCTAACGCCTGTAATCCCAGCACTTTGGGAGGCCAAGTCGGGTGGATCATGAGGTCAGGAGACCAAGACCATCCTGGCCAAATGGTGAAACCCCGTCTCTACTAAAAATACAAAAATTAGCTGGGCATGGTGGCGTGTGCCTGTAATCCCAGCTACTCAGGAGGCTGAGGCAGGACAATTGCCTGAACCCAGGAGAATTAGCTGGGCATGGTGGCGTGTGCCTGTAATCCCAGCTACTCAGGAGGCTGAGGCAGGACAATTGCCTGAACCCAGGAGGCGAAGGTTGCGGTGAGCCGAGATTGTGCCATTGCACTCCAGCCTGGGTAACAAGAGCGACACTCTGTCTCAAAAAAAAAAAAAAAAAAAAAAAAAAA"
"chr17","21663027","21663921","JH378118","18053084","18053501","517","3609943","TTGGGAGGCCAAGGTGGGCCTCCCAGACACGTGAGGTCAGGAGTTTGAGACCAGCCTGGACAATATGGCGAAACCCCATCTCTACTAAAAAAACACAAAAATTGGTTGGGCCGGGCACGGTGGCTCACGCCTGTAATCCCAGCACTTTGGGAGGCCGAAGTGGGCAGATCACGAGGTCAGGAGATCGAGATCATCTTGGCTAACATGGTGAAACTCCGTCTTTACTTAAAATACAAAAAATTAGCTGGGCATGATGGCAGGCAGTTGGAGTCCCAGCTACTTGGGAGGCTGAGGCAGGAGAATCGCTTGAACCCGGGAGGCAGAGGTTGCAGTGAGCTGAGATCGTGCCATTGCACTCCAGCCTGGGTGACAGAATGAGACTCCGTCTGAAAAAAAAACAAAAAACAAAAAACAAAAATTGGCCAGGTGCGGTGGCTCACGCCTGTAATCCCAGAACTTTGGGAGGCCGAGGCAGGTGGATCATGAGGTCAGGAGTTCAAGACCAGCCTGGCCAAGATGGTGAAACCCCATCTCTACTAAAAATACAAAAATTAGGCGGGCACGGTGGCAGGTGCCTGTAATCTCAGCTACTCAGGAGGCTGAGGCAGGAGAATTGCCTGAAGCCGGGTGGCAGAGGTTGCAGAGAGCTAAGATCACGCCACTGCACTCCAGCCTGGGTGATAGAGTAAGACTCTATCTCAAAAAAAGAAAAAAAAAAATAGCCGGGCATTGTGCTGGGCGCCTGTAATCCCAGCTACTTGGGAGGCTGAGACAAGAGAATCACTTGAACCTGGGAGGCGGAGGTTGCAGTGAGCCGAGATCGTGCCATTGCACTCCAGCCTGGGTGAGAAGAGCAAAACTCTGTCTCAAAAAAACAAAAAAAGAAGAAAACAAA","GGCTGGGCGCAGTGGCTCACACCTGTAATCCCAGCACTTAGGGAAGCTGAGGCGAGTAGATCACCTGAGGTCAGGAGTTAGAGACCAGCCTGGCCATCATGGTGAAACCCCGTCTCTACTAAAGATACCAAAAATTAGCTGAGTGTGGTGCTGGGTGCCTGTAATCCCAGAAACTCAGGGTGCCTGTAATCCCAGCAACTCAGGGTGCCTTTAATCCCAGCAACTGAGGGTACCAGTAATCCCAGCAACTCAGGGTGTCTTTAATCCTAGCAACTGAGGGCACCTGTAATCCCAGCAACTCAGGAAGCTGAGACAGGAGAAGTACTTGAACCCAGAAGGCAGAGGTTGCAGTGAGCCGATATTGCACCATTGCACTCCAGTCTGGGCAACAAGAGTGAAACTCTGTCTCAAAAAAAAA"
"chr17","21688652","21689276","JH378118","18053084","18053501","258","3635568","GGCCGGGTGCCATGGCTCACGCCTATAATCCCAGCACTTTGGGAGGCCAAGGTGGGCGGATCACCTGAGGTCAGGAGTTTGAGACCAGCCTGGCCAACATAGTGAAACCCCGTCTCTACTAAAAATACGAAAAGTTAGCTGGGGGTGCAGTGGCTCACACCTGTAATTCCAGCACTTTGGGAGGCCGAGGCAGGTGAATCACGAGGGGAGGAGTTTGAGACCAGCCTAACCAATATGTTGAAACCCCGTTTCTACTAAAAATACAAAAATTAGCTGGGCGTGGTGGCACGTGCCTATAATCCCAGCTACTCAGGAGGCTGAGGCAGGAGAATCGCCTGAACCTGGGAGGCGGAGGTGGCAGTGAGCCAAGATCACACCACTGCACTTTAGCCTGGGTGACAGAGGGAGACTCTGTCTCAAAAAACAAAACAAAACAAAACAAAAAATTAGGCAGGCTTGGTGGCACATGCCTGTAATCCCAGCTACTCAGGAGGCTGAGGCAGGAGAATTGCTTGAACCCAGGAGGCAGAAGTTGCAGTGAGCTGAGATCGCGCCATTGCACTCCAGCCTGGGTAACAAGAGTGAAACTCCATCTCAAAAAAAAAAAAAAAAAAAAAAAAAAAAA","GGCTGGGCGCAGTGGCTCACACCTGTAATCCCAGCACTTAGGGAAGCTGAGGCGAGTAGATCACCTGAGGTCAGGAGTTAGAGACCAGCCTGGCCATCATGGTGAAACCCCGTCTCTACTAAAGATACCAAAAATTAGCTGAGTGTGGTGCTGGGTGCCTGTAATCCCAGAAACTCAGGGTGCCTGTAATCCCAGCAACTCAGGGTGCCTTTAATCCCAGCAACTGAGGGTACCAGTAATCCCAGCAACTCAGGGTGTCTTTAATCCTAGCAACTGAGGGCACCTGTAATCCCAGCAACTCAGGAAGCTGAGACAGGAGAAGTACTTGAACCCAGAAGGCAGAGGTTGCAGTGAGCCGATATTGCACCATTGCACTCCAGTCTGGGCAACAAGAGTGAAACTCTGTCTCAAAAAAAAA"
"chr17","22129020","22129352","JH378128","1602813","1603145","53","20526207","GCCAGGCACGGTGGCTCACACCTGAATTCCAGTACTTTGGGAGGCCGAGGCGGGCGGATCTCTTGAGGTCAGGAGTTTGAGACCAGCCTGGCCAACATGGTGAAACCCCATCTCTACTAAAAATACAAAAATTAGCCGGGCGTGGTGGCAGGTGCCTGTAATCCCAGCTACTTGGGAGGCTGAGGCAGGAGAACCTCTTGAACCCAGGAGGTGGAGGCTGCAGTGAGCTGAGATTGTGCCACTTCACTCCAGCCTGGAAGACAAGAGCAAGACTTCATCTCAAAAAAAAATAAAAAAAAAATAAATAAATAAATAAATAAAAATTTAAAAAAA","GGCCAGGTGCAGTGGCTCACGCCTGTAATACCAGCATTTTGGGAGGCCGAGGCAGGTGGATCACGAGGTTAGGAGTTTGAGACCAGCATGGCCAACATGGAGAAACCCCGTCTCTACTAAAAATACAAAAATTAACCAGGCATGGTGGCAGGTGCCTGTAATTCCATCTACTCGGGAGGCTGAGGCAGGAGAATCCCTTGAACCTGGGAGGCGGAGGTTGCAGTGAGCCGAGATTGTGCCATTGCACTCAGTCTGGGTGACAAAAACAAGACTCCATCTCAAAAAAAAAAAAAAGAAAAGAAAAAGAAAAAAAGAAAGAAAGAAAGAAAGAAA"
"chr17","22130129","22130738","JH378118","18053084","18053501","262","4077045","GGCTGGGCACAGTGGCTCACGCCTGTAATCTCAGCACTTCGGGAAGCCGAGGCGGGCAGATCAGCTGAGGTCAGGAGTTCAAGACCAGCCTGGCCATGGCAAAACCCTGTCTCTACTAAAAAATGCAAAAAATAGGGGCCAGGCACGGTGGCTCACGCCTGTAATCCCAGCATTTTGGGAGGCCAAGGCAGGCGGATCACAAGGTCAGGAGGTTGAGACCATCCTGGCCAACATGGTGAAACCCCATCTCTACTAAAAATACAAAAATTAGCTGGGTGTGGTGGCCTGTGCCTGTAATCCCAGCTACTTGGGAGGCTGAGGCAGGGGAATCACTTGAATCCAGGAGACAGAGGTTGTAGTGAGCTGAAATGGAGCCACTGCACTCCAGCCTGGCGGCAGAGCGAGACTCTGTCTCAAAAAAAAAAAAAATACAAAAAATAGCTAGGTGTGATGGTGGGCACCTGTAATCCCAGCTACTTGGGTAGCCGAAGCAGGAGAATCGCTAGAACCTGGGAGGTGGAGGTTTAGTAAGCTGAGATCACACCATTGCACTCCAGCCTGGGTATCAACAGCGAAACTCCATCTCAAAAAAAAAAAAAAAAAAAGAAAA","GGCTGGGCGCAGTGGCTCACACCTGTAATCCCAGCACTTAGGGAAGCTGAGGCGAGTAGATCACCTGAGGTCAGGAGTTAGAGACCAGCCTGGCCATCATGGTGAAACCCCGTCTCTACTAAAGATACCAAAAATTAGCTGAGTGTGGTGCTGGGTGCCTGTAATCCCAGAAACTCAGGGTGCCTGTAATCCCAGCAACTCAGGGTGCCTTTAATCCCAGCAACTGAGGGTACCAGTAATCCCAGCAACTCAGGGTGTCTTTAATCCTAGCAACTGAGGGCACCTGTAATCCCAGCAACTCAGGAAGCTGAGACAGGAGAAGTACTTGAACCCAGAAGGCAGAGGTTGCAGTGAGCCGATATTGCACCATTGCACTCCAGTCTGGGCAACAAGAGTGAAACTCTGTCTCAAAAAAAAA"
"chr17","23633062","23633662","JH378118","18053084","18053501","247","5579978","GGCCAGGCGTGGTGGCTTACGCCTGTAATCCCAGCATTTTGGGAAGCTGAGGCAGGTGGATCACCTGAGGTCAAGAGTTCAAGACCAGCCTGGCCAACATGGTGAAACCCCGTCTCTACTGCAAATACAAAAAATTAGTAGCCGGGCATGGTGGCTCACGCCTGTAATCCCAACACTTTGGTAGGCCAAGGCGGGTGGATCACCTGAGGTCGGGAGTTCGAGACCAGCCTGACCAACATGGAGAAACCCCGTCTCTACTAAAAGTACAAAATTAGCCAGGGATGGTGGCATGTGCCTGTAATCCCAGCTATTTGGGAAGCTAAGGCACAAGAATCGCTTTGAACCTGGGAGACAGAGGTTGCAGTGAGCTGAGATCGCACCATTGCACTCCCGCCTGGGCAACAAGAGCGAAACTCCATCTAAAAAAAAAAAAAAAAAAAAAAAAGCCAGGCATGGTGACAGGCACCTTGTAATCCCAGCTACTCGGAAGGCTGAGGCAGGAGAATCGCTTGAACACTGCAGAGGTTGCAGTGAGCTGAGATCACGCCATTGCACTGCAGCCTAGGCAACAAGAGTGAGACTCTATCTCAAAAAAAAGAAA","GGCTGGGCGCAGTGGCTCACACCTGTAATCCCAGCACTTAGGGAAGCTGAGGCGAGTAGATCACCTGAGGTCAGGAGTTAGAGACCAGCCTGGCCATCATGGTGAAACCCCGTCTCTACTAAAGATACCAAAAATTAGCTGAGTGTGGTGCTGGGTGCCTGTAATCCCAGAAACTCAGGGTGCCTGTAATCCCAGCAACTCAGGGTGCCTTTAATCCCAGCAACTGAGGGTACCAGTAATCCCAGCAACTCAGGGTGTCTTTAATCCTAGCAACTGAGGGCACCTGTAATCCCAGCAACTCAGGAAGCTGAGACAGGAGAAGTACTTGAACCCAGAAGGCAGAGGTTGCAGTGAGCCGATATTGCACCATTGCACTCCAGTCTGGGCAACAAGAGTGAAACTCTGTCTCAAAAAAAAA"
"chr17","34071612","34072215","JH378118","18053084","18053501","250","16018528","GGCCAGGTGTGGTGCCTTACATCTGTAATTCCAGCACTTTGGGAGGCTGAGGTGGGTGGATCACCTGAGGTCAGGAGTTCAGGACCAACCTGGCCAACATAGTGAAACCCCGTCTCACTAAAAATACAAAAATTAAAAAGAAAGAAAGAAAAAAGCCAGGTGCGGTGGCTCACACCTGTAACCCCAGCACTTTGGGAGGCCAAGATGGGCGGATCACCTGAGGTCGGGAGTTTGAGACCAGCCTGACCAACATGGAGAAACCCCGTCTCTACTAAAAATACAAAATTAACCAGGCGTGGTGGTGCATGCCTGTAATCCCAGCTACTTGGGAGGATGAGGCAGGAGAATCGCTTGAACCCTGGAGGCGGAGGTTGTGGTGAGCTGAGATCATGCCATTGCACTCCAGCCTAGGCAACAAGAGCGAGACTCCATCTCAAAAAAAAAAAAAAAATTGGGCATGGTGGTGCATGCCTGTAATCCCAGCTACTCAGGAGTCTAAGGCAGGAGAATCACTTGAACCCAGGAGGCAGAGGTTGCAGTGAGCTGAGATCACGCCATTGCACTCCAGCCTGAGCGACAAGAGTGAAACTACGTCTCAAAAAAA","GGCTGGGCGCAGTGGCTCACACCTGTAATCCCAGCACTTAGGGAAGCTGAGGCGAGTAGATCACCTGAGGTCAGGAGTTAGAGACCAGCCTGGCCATCATGGTGAAACCCCGTCTCTACTAAAGATACCAAAAATTAGCTGAGTGTGGTGCTGGGTGCCTGTAATCCCAGAAACTCAGGGTGCCTGTAATCCCAGCAACTCAGGGTGCCTTTAATCCCAGCAACTGAGGGTACCAGTAATCCCAGCAACTCAGGGTGTCTTTAATCCTAGCAACTGAGGGCACCTGTAATCCCAGCAACTCAGGAAGCTGAGACAGGAGAAGTACTTGAACCCAGAAGGCAGAGGTTGCAGTGAGCCGATATTGCACCATTGCACTCCAGTCTGGGCAACAAGAGTGAAACTCTGTCTCAAAAAAAAA"
"chr17","34329459","34330029","JH378119","32351107","32351490","237","1978352","GGCCAGGTGCCGTGGCTCACACATGTAGTCCCAGCACGTTGGGAGGCTGAGGTTAATGGATCACCTGAAGTCACAAGTTCGAGACCAGCCTGACCAACATGGTGAAACCCTGTCTCTACTAAAATATAAAAAGTAGTCGGCCGGGCGCAGTTGCTCATGCCTGTGATCGCCTGAGGTCAGGATTTCAAGCCCAGCCTGGCCAAAATGGTGAAACCCCATCTCTACTAAAAATATAAAAATTAGCCAGGCATGGTGGCAGGTGCCTGTAATCCCAGCTACTCAGGAGGTTGAGGCAGGAGAATCACTTGGACCCAGGGGGCAGAGGTTGCAGTGAGCCAAGATCACAGCATCGCACTCCAGCTTAGGCAACAAGAGAGAAACTCCATCTCAAAAAAAACCCAAAAAAAACAAAAAAACAAAAAAACCCAGGCATGGTGGCAGGCGTCTGTAATCTCAGCTACTCGGGAGGCTGAGGCAAGAGAATCGCTTGAACCTGGGAGGCAGAGGTTGCAGTGAGCCAAGATCATGCCATTGCACTCCAGACTGAGCAATAAGAGCGAAACTCCATCTC","GGCCAGGTATGGTGGCTCACACCTGTAATCCCAGCACTTTGGGAGGCCAAGGCAGGCAGACCACCTGAGGTCAGGAGTTCGAGATCAGCCTAGCCAACATGGTGAAACCCCATCTCTAGTAAAAATAAAATTAGCCAGGCATGGTGGTGCATGCCTGTAACGCAGGTCAGGAGTTCGAGATCAGCTTAGCCAACATGGTGAAACCCCATCTCTAGTAAAAATAAAATTAGCCAGGCAGGTGGTGCCGCCTGTACTCGGGAGGCTGAGGCAGGAGAATCACTTGAACCCAAGAGGCAGAGGTTGCAGTCAGCCAAGATCATGCCATTGCACTCCAGCCTAAGCAAAAAGAGTAAAACTCAGTCTCAAAACAAAAAAACAAAAAAA"
"chr17","35196292","35196625","JH378228","5665092","5665424","47","29531200","GGCTGGGCATGGTGTCTTACGCCTGGAATCCCAGCACTTTGGGAGGCCAAGGCGGGTGGATCACCTGAGGTCAGGAGTTTGAGACCAGCCTGGCCAACATGTTGAAACTCTGTCTCTACTAAAAATACAAAAATTAGCCGGGCATGGTGGCGGATGCCTGTAATCCCAACTACGTGGGAGGCTGAGGCAGGAGAATCGCTTGAACCCAGGAGATGGAGGTTGTGGTGAGCCGAGATCATGCCATTGCACTCCAGCCTGGGCAACAAGAACAAAACTCTGTCTCAAAATAAATAAAAAAATAAATAAATAAATAAAAACAACAACAACAACAAAA","GGCCGGGCGCGGTGGCTCAAGCCTGTAATCCCAGCACTTTGGGAGGCTGAGGCGGGTGGATCACGAGGTCAAGAGATCGAGACCATCCTGGTCAACATGGTGAAACCCTGTCTCTACTAAAAATACTAAAAATTAGCTGGGCATGGTGGCGTGTGCCTGTAATCCCAGCTACTCAGGAGGCTGAGGCAGGAGAATTGCCTGAACCCAGGAGGCGGAGGTTGCGGTGAGCCGAGATCGCGCCATTGCACTCCAGCCTGGGCAACAAGAGCGAAACTCTGTCTCAAAAAAAAAAAATAAATAAATAAAATAAAATAAAATAAAATAAAATAAAAT"
"chr17","40291413","40291755","JH378144","13229286","13229620","52","27062127","GGCCAGGCACAGTGGCTCATGCCTGTAATCCCAGCACTTTGCGAGGCTGAGCCAGGTGGATCACCTGAGGTCAGGAGTTCAAGAGCAGCCTGGCCAACATGGTGAAACCCCGTCTCTACTAAAAATACAAAAATTATCTGGAGTGGTGGTAGGTGCCTATAATTGCAGATACACAGAAGGCTGAGACAGGAGAATTGCTTGAACCCAGGAGGCGGAGGTTGCTGTGAGCCGAGATCGCGCCATTGCACCCCAGCCTGGGAGACAAGAGCGAAACTCCATCTCAATAAATAAATACATACATACATACATACATACATGCATACATACATAAAATAAAATAAAA","GGCCGGGCGCGGTGGCTCAAGCCTGTAATCCCAGCACTTTGGGAGGCCGAGGCGGGTGGATCACCTGTGGTCAGGAGTTCAAGACAGCTTGGTCAACATGGTGAAACCCCGTCTCTACCAAAAATACAAAAAATTAGCTGGGCATGGTAGCGCATGCCTGTAATCCCAGCTACTCAGGAGGCTGAGGCAGGAGAATTGCCTGAACCCAGGAGGCAGAGGTTGCGGTGAGCCGAGATCGCGCCATTGCACTCCAGCCTGGGTAACAAGAGCGAAACTCCCTCTCATAAAAAATAAATAAATAAATAAATAAATAAATAAATAAATAAATAAATAAA"
"chr17","45148344","45148987","JH378206","6546474","6546861","299","38601870","GGCTTGGTGCCATGGTTCATGCCTGTAATCCTGGCACTTTGGGAGGCCGAGGTGGGCAGATCACTTGAGCTCAGGAGTTCAAGACCACCTTGGGCGACATGGTGAAACCTCATCTCTCCTTAAAAAAAAAAAAAACAGCCGGGCGCGGTGGCTCACACCTGTAATCCCAGCACTTTGGGAGGCCAAGGCGGGTGGGGTTCATGAGGTCAGAAGATCGAGACCATCCTGGCTAACACGGTGAAACCCCGTCTCACTAAAAATAGAAAAAACTAGCCGGGCGTGGTGGCGGGCACCTGTAGTCCCAGCTACTCGGGAGGCTGAGGCAGGAGAATGGCGTGAACCCGGGAGGCGGAGCTTGCAGTGAGCTGAGATCTTGCCATTGCACTCCAGCCTGGGCAACAAGAGTGAAACTCTGTCTCAAAAAAAAAAAATTAAAAAAACAAATAAAAATAAAAATACATAATTAGCAGGACATGGTGGCACATGCCTGTAATCCCCAGCTACTCGGGAGGCTGAGGCATGGGAATTGTTTAAACCTGTGAGGCGGTGGTTGCAGTGAGCCAAGATCAAGCCATTGCACTCCAGCCTGGGCAACAAGAGTGAAACTCCATCTCAAAAAAAAAAAAAAAAAAGAGAAAAGAAAA","GGCCACACATGGTGGCTAACGCCTGTAATCCCAGCACTTTGGGAGGCCAAGTCGGGTGGATCATGAGGTCAGGAGACCAAGACCATCCTGGCCAAATGGTGAAACCCCGTCTCTACTAAAAATACAAAAATTAGCTGGGCATGGTGGCGTGTGCCTGTAATCCCAGCTACTCAGGAGGCTGAGGCAGGACAATTGCCTGAACCCAGGAGAATTAGCTGGGCATGGTGGCGTGTGCCTGTAATCCCAGCTACTCAGGAGGCTGAGGCAGGACAATTGCCTGAACCCAGGAGGCGAAGGTTGCGGTGAGCCGAGATTGTGCCATTGCACTCCAGCCTGGGTAACAAGAGCGACACTCTGTCTCAAAAAAAAAAAAAAAAAAAAAAAAAAA"
"chr17","47866693","47867898","JH378118","18053084","18053501","809","29813609","GGCTGGGCTTGGTGGCTCATGCCTATAATTCTAGGACTTTGGGAGGCCAAGGCGGATGGATCACCTGAGGTCAAGAGTTGGAGACCAACCTGTCCAACATGGTGAAACCCCCTCTGTACTAAAAATACAAAAATTGGCCGAGCGTAGTGGCTCATGCCTGTGATCACAGCACTTTGAGAGGCTGAGGCGGGCGGATCACAAGGTCAGGAGATCAAAACCATCCTGGCTAACAAGGTGAAACCCCATCTCTGCTAAAAAATAACAGGGCGTGGTGGCACACGGCTGTAGTCCCAGCTACTTGGGAAGCTGAGGCAGGAGAATCGCTTGAACCTGAGAGGCAGAGGTTGCAGTGAGCTGAGATCAGGCCACTGCTCTCCAGCCTGGGCAACAGAGTGAAACTCCATCTCAAAAAAAAAAAGAAAAAGGCCAGGCATGGTGGCTCACGCCTGTAATGCCAGCACTTTGGAAGACTAAGTTGGGCAGATCACAACATCAGAAGATGGAGACCATCCTGGCTAACACGGTGAAACCCCGTCTCTACTAAAAATACAAAAAAAAAAAAAAAAAAAATTAGCCGGGCGTGGTGACATGCGCCTGTAATCCTAGCTACTCCGGAGGCTGAGGCAGGAGAATGGCGTGAACCCGGGAGGCGGAGCTTGCAGTGAGCCGAGATGGTGCCACTGCACTCCAACCTGGGCGACAGAGCGAGACTCTGTCTCAAAAAAAAAAAAAAAAAAGAAAAAAGGTCGGGCGCAGTGGCTCACACCAGTAATCACAGCACTTTGGGAGGCCGAGGCGGGTGGATCACCTGAGCTCGGGAGTTCAAGACCAGCCTGACCAACATGGTGAAACTCCGTCTCTACTAAAAATACAAAATATTAGCCGGGCGTGGTGGCGCGTGCCTGTAATCCCAGTTACACGGGAGGCTGAGGCAGGAGAATCACTTGAACTTGGGAAGTGGAGGTTGTGGGAGCCGAAATCGTGCCATCGCATTCCACAAGAGTGAAACTCCATTTCAAAAAAAAAAAATACAAAAATTAGCTGGGCGTGGTGGCGGGCGCCTTTAATCCCAGGGGCTCGGGAGGCTGAGGCAGGAGAATCGCTTGAACCTAGGAGGCAGAGGTTGCAGTGTGCCAAGATGACACCATTGCACTCCAGGCTGGGCAAGAGAGCAGTAACTCCCGTCTCAAAAAAAAAGAAGGAAAA","GGCTGGGCGCAGTGGCTCACACCTGTAATCCCAGCACTTAGGGAAGCTGAGGCGAGTAGATCACCTGAGGTCAGGAGTTAGAGACCAGCCTGGCCATCATGGTGAAACCCCGTCTCTACTAAAGATACCAAAAATTAGCTGAGTGTGGTGCTGGGTGCCTGTAATCCCAGAAACTCAGGGTGCCTGTAATCCCAGCAACTCAGGGTGCCTTTAATCCCAGCAACTGAGGGTACCAGTAATCCCAGCAACTCAGGGTGTCTTTAATCCTAGCAACTGAGGGCACCTGTAATCCCAGCAACTCAGGAAGCTGAGACAGGAGAAGTACTTGAACCCAGAAGGCAGAGGTTGCAGTGAGCCGATATTGCACCATTGCACTCCAGTCTGGGCAACAAGAGTGAAACTCTGTCTCAAAAAAAAA"
"chr17","48059944","48060302","JH378108","45564157","45564495","64","2495787","GGCCGGGCGCAGTGGTTCATGCCTGTAATCCCAACACTTTAGGGGGCTGAGGCAGGTGGATCACCTGAGGTCAGGAGTTCAAGACCAGCCTGGCCAACATGGTGAAAGCCCATCTCTACTAAAAATACAAAAAATTAGCTGGGCATGGTGGTGCGTGCCTGTAATCCCAGCTACTTGGGATGCTGAGGCAGGAGAATCGCTTGAACCCGGGAGGTGGAGGCTGCAGTGAGCTGAGATTGTGCCATTGCACTCCAGCCTGGGCAACAAGAGTGAAACTCCATCTAAAAAAAAAAAAGAAGAGGAGGAGGAGGAGGAGGGGGAGGGGGAGGAGGAGGAGGAGGAGAAGAAGAAAAAAGAAA","GCTAGGCAAGGTGGCTCATGCCTGTAATCCCAACATTTTGGGAGGCCGAGGCAGATGGATCACCTGAGGTTAGGAGTTCAAGACCAGCCTGGCCAACATGGTGAAACTCCATCTCTACTAAAAATACAAAAAATTAGCTTGGCACGGTGGTGGGTGCCTCTAATCCCAGCTGCTTGGGAGGCTGAGGCAGGAGAATCGCTTGAACTCAGGAGGTGGAGGTTGCAGTGAGCCAAGATCATGGCATTGCACTCCAGCCTGGGCGACAAGAGCGAGACTCCCTCTAAGAAAGAAAAGAAAGAAAAGAAAAGAAAAAAGGAAAGGAAAGGAAAGAAAGAGAAA"
"chr17","50365982","50366602","JH378118","18053084","18053501","274","32312898","GGCAAGGCGTGGTGGCTGATGTCTGTAATCCCAGCAATTTGGGGGGCTGAGGTGGATGGATCACCTGAGATCAGAAGTTCGAGACTAGGCTAGCCAACATAGTGAAACCCCATCTCTACTAAAAATATAAAAAGTTAGCCAGGCGCGGTGGTTCATGCCTGTAATCCCAGCACTTTGGGAGGCCGAGGTAGGTGGATCACAAGGTCAGGAGTTCAAGACCAACCTGGCCAAGATAGTGAAACCTCATCTCTACTAAAAATACAAAAATTAGCTGGGCGTGGTGGCAACCACCTATGATCCCAGCTACTTGGGAGGCTGAGGCAGAGAACTGCTTGAACCCAGGAAGTGGAGGTTGTAGTGAGCCAAGATTGCATCACTGTACTCCAGCCTGGGCAACAGAGCAAGACTCCATCTCAAAAAAAAAAAAAAAAAAAATACAAAAAATTAGCCAGGCGTGGTGGCAGGCACCTGTAATCCCAGCTACTCGGAAGGCTGAGGCAGGAGAATTGCTTGAACCTGGGAGGTAGAGGTTGCAGTGAGCTGAGATTGTGCCATTGCACTCTAGCCTATGTGACAAGAGCGAAACTCCATCTCAAAAAAAAAAAAAAAAAAGAAAGAAAA","GGCTGGGCGCAGTGGCTCACACCTGTAATCCCAGCACTTAGGGAAGCTGAGGCGAGTAGATCACCTGAGGTCAGGAGTTAGAGACCAGCCTGGCCATCATGGTGAAACCCCGTCTCTACTAAAGATACCAAAAATTAGCTGAGTGTGGTGCTGGGTGCCTGTAATCCCAGAAACTCAGGGTGCCTGTAATCCCAGCAACTCAGGGTGCCTTTAATCCCAGCAACTGAGGGTACCAGTAATCCCAGCAACTCAGGGTGTCTTTAATCCTAGCAACTGAGGGCACCTGTAATCCCAGCAACTCAGGAAGCTGAGACAGGAGAAGTACTTGAACCCAGAAGGCAGAGGTTGCAGTGAGCCGATATTGCACCATTGCACTCCAGTCTGGGCAACAAGAGTGAAACTCTGTCTCAAAAAAAAA"
"chr17","50542261","50542886","JH378206","6546474","6546861","277","43995787","GCCGGGCGCTGTGGCTCAAGCCTGTAATCCCAGCATTTTGGGAGACTAAGGGAAGCAGATCCTGTGAGCTCAGGATTTCGAGACCAGCCTGGCCAACATGGTGAAACCCTGTCTCTACAAAAATTAGCCATGCCGGGCACGGTGGCTCACGCCTGTAATCCCAGCACTTTGGGAGGCTGAGGCGGGCGGATCACAAGGTCAGGAGTTTGAGACCATCCTGCCTAACACGGTGCAACCCCGTCTCTACCAAAAATACAAAAAATTAGCTGGGCGTGGTGGCGGGTGCCTGTAGTCCCAGCTACTCGGGGGGCTGAGGCAAGAGAATGGCATGAACCTGTGGGGCGGAGCTTGCTGTGAGCCGATATCCTGCCACTGCACTCCAGCCTGGGCGACAGAGCGAGACTCCATCTCAAAAAAAAAAAAAAAAAAAAAAAAAAAAAAAAATGAGCCAGCTGTGGTGGCGTGTGTGCCTGTAATCCCAGCTACTCGGGAGGCTGAGGCAAGAGAATCACTTGAATCTGGGAGGCAGAGGTTGCAGTGAGCCAAGATCATGCTATTGCACTTCAGCCTGGGCAACAAGAGTGAAACTCTGTCTCAAAAAAAAAAAAAAAAAAAAAGAAAAAGAA","GGCCACACATGGTGGCTAACGCCTGTAATCCCAGCACTTTGGGAGGCCAAGTCGGGTGGATCATGAGGTCAGGAGACCAAGACCATCCTGGCCAAATGGTGAAACCCCGTCTCTACTAAAAATACAAAAATTAGCTGGGCATGGTGGCGTGTGCCTGTAATCCCAGCTACTCAGGAGGCTGAGGCAGGACAATTGCCTGAACCCAGGAGAATTAGCTGGGCATGGTGGCGTGTGCCTGTAATCCCAGCTACTCAGGAGGCTGAGGCAGGACAATTGCCTGAACCCAGGAGGCGAAGGTTGCGGTGAGCCGAGATTGTGCCATTGCACTCCAGCCTGGGTAACAAGAGCGACACTCTGTCTCAAAAAAAAAAAAAAAAAAAAAAAAAAA"
"chr17","51121894","51122508","JH378118","18053084","18053501","260","33068810","GGCTGGGTGCAGTGGCTCATGCCTGTATTCCCAACACTTTGAGAGGCCAAGGCGGGCAGATCACCTGAGGTCAGGAATTCGAGACCAGCCTGGCTAACATGGCGAAACCCTGTCTCTATTAAAAACACAAAAATTAGGCCAGGCACGGTGGCTCACACCTGTAATCCCAGCACTTTGGGAGGCTGAGGCGGGCAGATCACGAAGTCAGGAGATCGAGACCATCCTGGCTAACATGGTGAAACCCTGTCTCTGCTAAAAATACAAAAAAAATAGCGGGGCGTGGTGGCAGGCGCCTGTAGTCCCAGCTACTCAGGAGGCTGAGGCAGGAGAATGGCGTGAACCTGGGAGGCGGAGGTTGCAGTGAGCCGAGATCGCGCCACTGCACTACAGCTTGGGTGACAGAGCGAGACTCTGTCTCAAAAAAAAAAAAAAAAGTTAGTCGGGCATGGTGGTGGGCTCCTGTATTCCCAGCTACTCAGGAGGCTGAGGTGGGAGAATCACTTGAACCTGGAAGGCAGAGGTTGCTGTGAGCCAAGATTGCACCATTGCATTCCAGCCTGGGTGACAAGAGCAAAACTCTGTCTCAAAAAATATATATAAAATAATAAAAATAAA","GGCTGGGCGCAGTGGCTCACACCTGTAATCCCAGCACTTAGGGAAGCTGAGGCGAGTAGATCACCTGAGGTCAGGAGTTAGAGACCAGCCTGGCCATCATGGTGAAACCCCGTCTCTACTAAAGATACCAAAAATTAGCTGAGTGTGGTGCTGGGTGCCTGTAATCCCAGAAACTCAGGGTGCCTGTAATCCCAGCAACTCAGGGTGCCTTTAATCCCAGCAACTGAGGGTACCAGTAATCCCAGCAACTCAGGGTGTCTTTAATCCTAGCAACTGAGGGCACCTGTAATCCCAGCAACTCAGGAAGCTGAGACAGGAGAAGTACTTGAACCCAGAAGGCAGAGGTTGCAGTGAGCCGATATTGCACCATTGCACTCCAGTCTGGGCAACAAGAGTGAAACTCTGTCTCAAAAAAAAA"
"chr17","51573403","51574012","JH378118","18053084","18053501","260","33520319","GGCCGGGTGTGGTGGCTCACGCCTATTATCCCAGCAGTTTGGGAGGCCAAGTGGGGGTTGGATCACCTGAGGTCAGGGGTTCGAGACCAGCATGGCCAACATGGTGAAAACCCATCTATACTAAAGATACAAAAAATTAGGCTGGGCACAGTGGCTCATGCCTGTAATCCCAGCACTTTGGGAGGCCAAGGATCACGAGGTCAGGAGATCGAGACCATCCTGGCTAACACAGTGAAACCCCGTCTCTACTAAAAATACAAAAAAATTAGCCGGGAGTGGTGGCAAGTGCCTGTAGTCCCAGCTACTCAGGAGGCTGAGGCAGGTGAATAGTGTGAACGCAGGAGGCAGAGCTTGCAGTGAGCCGAGATCGTGCCACTACACTCCAGCCTGGGCGACAAGGTGAGACAACGTCTCAAAAAAAAAAAAAAAAAAAAGCCGGGCATGGTGGGAGGCACCTGTAATTCCACCTACTTGGGAGGGTGAGGCAGGAGAATTGCTTGAATCTGGGAGATGGAGGTTGGAGTAAGCCAAGTTCGCACCATTGCACTCCAGCCTGGGTGACAAGAGCGAAACTCTTGTCTCAAAAAAAAAAAAAAAAAAAAAAAAAAAA","GGCTGGGCGCAGTGGCTCACACCTGTAATCCCAGCACTTAGGGAAGCTGAGGCGAGTAGATCACCTGAGGTCAGGAGTTAGAGACCAGCCTGGCCATCATGGTGAAACCCCGTCTCTACTAAAGATACCAAAAATTAGCTGAGTGTGGTGCTGGGTGCCTGTAATCCCAGAAACTCAGGGTGCCTGTAATCCCAGCAACTCAGGGTGCCTTTAATCCCAGCAACTGAGGGTACCAGTAATCCCAGCAACTCAGGGTGTCTTTAATCCTAGCAACTGAGGGCACCTGTAATCCCAGCAACTCAGGAAGCTGAGACAGGAGAAGTACTTGAACCCAGAAGGCAGAGGTTGCAGTGAGCCGATATTGCACCATTGCACTCCAGTCTGGGCAACAAGAGTGAAACTCTGTCTCAAAAAAAAA"
"chr17","51598763","51599361","JH378118","18053084","18053501","241","33545679","GCCGGGCGTGGTGACTCACGCCTGTAATACCAGCACTTTAGGAGGCTGAGGTGGGTGGATCACCTGAGGTCAGGAGTTCGAGACCGGCCTGGCCAACATGGTGAAATCCTGTCTCTACTAAAAATACAAAAAAATGGCCAGGCGTGGTGGCTCACGCCTGTAATCCTAGCACTTTGGGCGGCCCAGGTGAGTGGATCACGAGGTCAGGAGATCGAGACCATCCTGGCTAACATGGTGAAACCCCATCTCTACTAAAAAACTACAAAAAAATTAGCTGGGCGTGGTGGCAGGCGCCTGTAGTCCCAGCTACTCGGGAGGCTGAGGCAGGAGAATGACGTGAACCCGGGAGGCGGAGCTTGCAGTGAGCAGAGCTTGAGCCACTGCACTCCAGCTTGGGCGACAGAGTGAGACTCCGTCTCAAAAAAAAAAAAAAAAAAATTAGCTGGGGATGGTGGCGGGCACCTGTAATCCCAGCTACTCTGGAGGCTGAGACAGGAGAATCGCTTGAACCCAGGAGGCGGAGGTTGCAGTGAGCTGAGATCGTGCCATTGTACTCCAGCCTGGGCAACAAGAGTGAAACTCAATCCGAAGAAAAAAAA","GGCTGGGCGCAGTGGCTCACACCTGTAATCCCAGCACTTAGGGAAGCTGAGGCGAGTAGATCACCTGAGGTCAGGAGTTAGAGACCAGCCTGGCCATCATGGTGAAACCCCGTCTCTACTAAAGATACCAAAAATTAGCTGAGTGTGGTGCTGGGTGCCTGTAATCCCAGAAACTCAGGGTGCCTGTAATCCCAGCAACTCAGGGTGCCTTTAATCCCAGCAACTGAGGGTACCAGTAATCCCAGCAACTCAGGGTGTCTTTAATCCTAGCAACTGAGGGCACCTGTAATCCCAGCAACTCAGGAAGCTGAGACAGGAGAAGTACTTGAACCCAGAAGGCAGAGGTTGCAGTGAGCCGATATTGCACCATTGCACTCCAGTCTGGGCAACAAGAGTGAAACTCTGTCTCAAAAAAAAA"
"chr17","51738482","51739094","JH378118","18053084","18053501","257","33685398","GCCGGGTGCGGTGGCTCACACCTGTAATCCCAGCACTTTGGGAGACTGAGGCGGGAGGATCACCTGAGGTCAGGAGTTCGAGACCAACCTGACCAACATGGTAAAACCCTGTCTGTACTAAAACTACAAAAAATTAGGCCAGGCGCAGTGGTCCATGCCTGTAATCCCAGCACTTTGGGAGGCCAAGGTGGGCGGATCATGAGGTCAGGAGTTTGAGACCAGCCTGGCCAACATAGTGAAACCCTGTCTCTACTAAAAACACAAAAATTAGTCGGGCATGGTGGCGGATGCCTGTAATCTCAGCTACTCAGGAGGTTGAGGCAGGAGAATCACTTGAACCCGGGAGGTGGAGGTTGCAGTGAGCCAAGATCACGCCACTGTACTCCAGCCTGGGCAACAGAGCGGGACTCCATCTTAAAAAAAAAAAAAAAAAAATTAGCCAGGCGTGGTGGCGCATGCCTGTAGTCCCAGCTACTTAGGAGGCTGAGGCAGGAGAATTGCTTGAACCCGGGAGGCAGAGGCTGCAGTGAGCCAAGACCACGCTATTGCATTCCAGCCTGGGTGACAAGAGCAAAACTCTGTCTCAAAAAACAAAACAAAACAAACAAAAAAA","GGCTGGGCGCAGTGGCTCACACCTGTAATCCCAGCACTTAGGGAAGCTGAGGCGAGTAGATCACCTGAGGTCAGGAGTTAGAGACCAGCCTGGCCATCATGGTGAAACCCCGTCTCTACTAAAGATACCAAAAATTAGCTGAGTGTGGTGCTGGGTGCCTGTAATCCCAGAAACTCAGGGTGCCTGTAATCCCAGCAACTCAGGGTGCCTTTAATCCCAGCAACTGAGGGTACCAGTAATCCCAGCAACTCAGGGTGTCTTTAATCCTAGCAACTGAGGGCACCTGTAATCCCAGCAACTCAGGAAGCTGAGACAGGAGAAGTACTTGAACCCAGAAGGCAGAGGTTGCAGTGAGCCGATATTGCACCATTGCACTCCAGTCTGGGCAACAAGAGTGAAACTCTGTCTCAAAAAAAAA"
"chr17","52245950","52246538","JH378118","18053084","18053501","254","34192866","TGTAATCCCAGCACTTTGGGAAGCCAACGCGGGTAGATCAGCTGAGGTCAGGAGCTCGAGACCAGCCTGGCCAACTGGTGAAACCCCATCTCTACTAAAAAAAATACAAAAAAATGGCCCAGCGCGGTGGCTCACACCTGTAATCCCAGCACTTTGGGAGGCCGAGGCGGGCAGATCACGAGGTCAGGAGATCGAGACCATCCTGGATAATACGGTGAAACCCCGTCTCTACTAAAAATACAAAAAAAAATTAACCGGGTGTGGTGGCGGGCGCCTGTAGTCCCAGCTACTAGGGAGGCTGAAGCAGGAGAATGGCGCGAAACCGGGAGGCGGAGCTTGCAGTGAGCCAAGACAGGCCACTGCACTCCAGCCTGGGCGACAGAGCGAGACTCCATCTCAAAAAAACAAAAAACAAAAAAATTAGCCAGCTGTGGTGGTGGGCGCATGTAATCCCAGTTACTTGGGAGGCTGAGGCAGGAGAATTGCTTGAAACCAGGAGGCAGAGGTTGCAGTGAGCCAAGATTACGCCATTGTACTCCAGCCTGGGCAACAAGGGCAAAACTCTGTCTCAACAAAAAAAAAGAAAAAA","GGCTGGGCGCAGTGGCTCACACCTGTAATCCCAGCACTTAGGGAAGCTGAGGCGAGTAGATCACCTGAGGTCAGGAGTTAGAGACCAGCCTGGCCATCATGGTGAAACCCCGTCTCTACTAAAGATACCAAAAATTAGCTGAGTGTGGTGCTGGGTGCCTGTAATCCCAGAAACTCAGGGTGCCTGTAATCCCAGCAACTCAGGGTGCCTTTAATCCCAGCAACTGAGGGTACCAGTAATCCCAGCAACTCAGGGTGTCTTTAATCCTAGCAACTGAGGGCACCTGTAATCCCAGCAACTCAGGAAGCTGAGACAGGAGAAGTACTTGAACCCAGAAGGCAGAGGTTGCAGTGAGCCGATATTGCACCATTGCACTCCAGTCTGGGCAACAAGAGTGAAACTCTGTCTCAAAAAAAAA"
"chr17","52264620","52265210","JH378118","18053084","18053501","242","34211536","GGCCACATGTGGTGGCTCACACCTGTAATCCCAGCACTTTGGGAGGCCAAGGCAGGCAGATCACCTGAGATCAGAAGTTCAAGACCAGCCTGGCCAATGTGGTGAAACCCTGTCTCTACTAAAAATAGAAAAAACACAGCCAGGCGCGGTAGCTCACACCTGCAATCCCAGCACTTTGGGAGGCCGAGGCAGGCAGATCACGAGGTCAGGAGATTGAGACCACGGTGAAACCCCATCTCTACTAAAAATACAAAAAATTAGCTGGGCATGGTGGCGGGCACCTGTAGTCCCAGCCACTTGGGAGGCTGAGGCAGGAGAATGGCGTGAACTCGGGAGGTGGAGCTTGCAGTGAGCAAAATTGCGCCACTGCACTCCAGCCTGGGCAACAGAGCAAGACTCCGTCTCAAAAAAAAAAAAAAAAAAAAATTAGCCGGCGTAGTGGCAAGCTCCTGTAATCCCAGCTACTTGGGAGGCTGAAGCAGGAGAATCGCTTGAACCCAGGAGGTGGAGGTTGCAGTGAGCCGAGACTGCGCCATTGCACTCCAGCCTGGGCAACAAGAATGAAACTCCGTCTCAGAAAAGAAAAAAAAA","GGCTGGGCGCAGTGGCTCACACCTGTAATCCCAGCACTTAGGGAAGCTGAGGCGAGTAGATCACCTGAGGTCAGGAGTTAGAGACCAGCCTGGCCATCATGGTGAAACCCCGTCTCTACTAAAGATACCAAAAATTAGCTGAGTGTGGTGCTGGGTGCCTGTAATCCCAGAAACTCAGGGTGCCTGTAATCCCAGCAACTCAGGGTGCCTTTAATCCCAGCAACTGAGGGTACCAGTAATCCCAGCAACTCAGGGTGTCTTTAATCCTAGCAACTGAGGGCACCTGTAATCCCAGCAACTCAGGAAGCTGAGACAGGAGAAGTACTTGAACCCAGAAGGCAGAGGTTGCAGTGAGCCGATATTGCACCATTGCACTCCAGTCTGGGCAACAAGAGTGAAACTCTGTCTCAAAAAAAAA"
"chr17","52281488","52282107","JH378118","18053084","18053501","287","34228404","GGCCAGGCGCGGTGGCTCACGCCTGTAATCCCAGCACTTTGGGAGGTCAAGGCGGGTGGATCACCTGAGGTCAGGAGTTCAAGACCAGCCTGGCCAACATGATGAAACTTCATCTTGGCCGGGCGCGGTGGCTCATGCTTGTAATCCCAGCACTTTGGGAGGCCAAGGCAGGCGGCGGATCATGAGGTCAGGAGATTGAGACCATCCTGGCTAAAACGGTGAAACCCCGTCTCTACTAAAAATACAAAAAAAAAAAAATTAGCCGGGCGTGGTGGCAGGCGCCTGTAGTCCCAGCTACTCGGGAGGCTGAGGCAGGAGAATGGCGTGAACCCGGGAGGCGGAGCTTGCAGTGAGCCGAGATAGCACCACTGCAGTCCGGCCTGGGTGAAAGAGTGAGACTCCGTCTCAAAAAAAAAAAAAAAGAAGAAAGAACTTCGTCTTTACTAAAAGTACAAAAAAAAAAAAAAAAAATTAGCCGGGCATGGTGGCAGGCGCCTGTAAACCCAACTACTCTGGAGGCTGAGGAAGGAGAACTGCTTGCACCTGGGAGTCGGAGGTTGCAGTAAGCCAAGATCGCACCATTGCACTCCAGCCTGGGCATCAAGAGTGAGACTTTGTCT","GGCTGGGCGCAGTGGCTCACACCTGTAATCCCAGCACTTAGGGAAGCTGAGGCGAGTAGATCACCTGAGGTCAGGAGTTAGAGACCAGCCTGGCCATCATGGTGAAACCCCGTCTCTACTAAAGATACCAAAAATTAGCTGAGTGTGGTGCTGGGTGCCTGTAATCCCAGAAACTCAGGGTGCCTGTAATCCCAGCAACTCAGGGTGCCTTTAATCCCAGCAACTGAGGGTACCAGTAATCCCAGCAACTCAGGGTGTCTTTAATCCTAGCAACTGAGGGCACCTGTAATCCCAGCAACTCAGGAAGCTGAGACAGGAGAAGTACTTGAACCCAGAAGGCAGAGGTTGCAGTGAGCCGATATTGCACCATTGCACTCCAGTCTGGGCAACAAGAGTGAAACTCTGTCTCAAAAAAAAA"
"chr17","52731467","52732093","JH378129","11955248","11955630","276","40776219","GGCCGGGTGCGGTGGCTCACGCCTGTAATCCTGGCACTTTGGGAGGCTGAGATGGACGGATCACCTGAGGTCAGGAGTTTTTTGTTTTTTTCTTTTTTTTTGAGACAGAGTCTGGCTCTGTTGCCCAGGCTGGAGTGCAGTGGCTCGATCTCGGCTCACTGCAAGCTCCGCCTCCCGGGTTCATGCCATTCTCCTGCCTCAGCCTCCCGGTAGCTGGGACTACAGGTGCCCGCCAGCACATCCGGTTATTTTTTTGTATTTTTAGTAGAGACAGTGTTTCACAGTGTTAGCCAGGATGGTCTCGATCTCCTGACCTCGTGATCCGCCCACCTCGGCCTCCCAAAAGTGCTGGGATTACAGGCATGAGCCACCGCGCCCGGCCAGGAGTTTTTGAGACCAGCCTGGCCAACAGGGTGAAACTCTGTCTCTACTAAAAATACAAAAATTAGTTGGGCATGGTGGCAGGCACCTGTAATCCCAGCTACATGGGAGGCTGAGGCAGGAGAATTGCTTGAACCTGGGAGGCGGAGGTTGCAGTGAGCTGAGATTGCGCCATTGCACTCCAGCCTGGGCAACAAGAGTGAAATTGCGTCTCAAAAACCAAAACAAACAAAAAAAGAATGAAAA","GGCTGGGTACGGTGGCTCATGCCTGTAATCCCAGCACTTTGGGAGGTGGGTCACTTGAGGTCAGGAGTTCGAGACCAGCCTGTGCAGTGCCTCCATCCTCAACTGCTGCCTCATCAGCCTGGACCACTACCTGCTCATCCTCTCACCACTGCCACAAGCTGCGCATGAAGCTCCTGCGCGCGCCGGTGCCCGTCTCTACTAAAAATACAAAAATTAGCTGGGTGTGGTGGCAGGTGCCTGTAATCCCAGCTACTCAGGAGGCTGAGGCAGGAGAATCACTTGAACCCAGGAGGCAGAGGTTGCAGTGAGCCGATATCGCATCATTGCACTCCAGCCTGAGCAACAAGAGTGAAATTTTGTCTCAAAAAAAAAAAAAAAAGAAA"
"chr17","54416242","54416805","JH378115","26183910","26184297","228","28232332","ACTTTGGGAGGCCATGGCAGGCGGATCACCTGAGATCAGGAGTTGGAAACCAGCCTGGCCAACATGGTAAAACCCCGTCTCTACTAAAAATACTTGGCTGGGCACGGTGGCTCACACTTGTAATTCCAACACTTTGGAAGGCCAAGGCGGGCAGATCACCTGAGGTTGGGAGTTCGAGACCAGCCTGACCAACATGGAGAAACCCTGTCTCTACTAAAAATACAAAATTAGCTGGGCATGGTGGTCTATGCCTGTAATCCCAGCTACTTGGGAGGCTGAGGCAGGAGAATTGCTTGAACCCGGGAGGCAGAGGTTGCGGTAAGCCAAGATCATGCCATTGCACTCCAGCCTGGGCAACAAGAGCAAAACCCCGTCTCAAAAAAAAAAAAAAAATTAGCCCAGTGTGGTGGCGTGCACCTGTAATCCCAGCTACTTACTTAGGAGCCTGAGGCAGGAGAATTGCTTGAACCCGGGAGGCAGAGTTTGCAGTGAGCCAAGATTGCACCATTGCACTCCAGCCTGGGTGACAAGAGTGAGACTGTCTCAAAAAAAAAAAAAAAAAAA","GGCCAGGTGCAGTGGCTCATATGTATAACCCCAACACTTTGGGAGGCCAACGCAGGTGGATCACCTGAGTTAGGAGTTTGAGACCAGCCTGACCAACATGGTGAAACCCTGTCTCTACTAAAAATACAGAAATGGCCGGGCATAGTGACACATACCTGTAATCCCAGATACTTGGGATGCTGAGTTTGCTTAAACCCAGAGGAGAACTGCTTAAACCCGGGAGGTAGAGGTCACAGTGAGCCAAGATTGGGATGCTGAGATTTGCTTAAACCCAGAGGAGAACTGCTTAAACCCAGGAGGCAGAGGTTGCAGTGAGTTGAGATTGCACCATTGCACTCCAGCCTGGACAACAAGAGTGAAACTCTGTCTCAAAAAAAAAAAAAAAAAA"
"chr17","55179146","55179483","JH378144","13229286","13229620","44","41949860","GGCCGGGTGCGGTGGCTCACGCCTGTAATCCCAGCACTTTGGGAGGCCGACGCAGGTGGATCACTTGAGGTCTGGTGTTCAAGACCAGCCTGGCCAACATTGTGAAACCCCGTCTCTACTAAAAATACAAAAAGTTAGCTGGGCATGGTAGCAGGTGCCTGTAATCCCAGCTACTTGGGAGGCTGAGGCAGGAGAATTGCTTGAACCTGGGAGGCAGAGGTTGCAGTGAGCTGAGATCGCACCATTGCACTCCAGCCCAGGCAACAAGAGCGAAACTTCGTCTCAAATAATAATAATAATAATAATAATAAATAAATAAATTTTTAAAAAAGAAAAAA","GGCCGGGCGCGGTGGCTCAAGCCTGTAATCCCAGCACTTTGGGAGGCCGAGGCGGGTGGATCACCTGTGGTCAGGAGTTCAAGACAGCTTGGTCAACATGGTGAAACCCCGTCTCTACCAAAAATACAAAAAATTAGCTGGGCATGGTAGCGCATGCCTGTAATCCCAGCTACTCAGGAGGCTGAGGCAGGAGAATTGCCTGAACCCAGGAGGCAGAGGTTGCGGTGAGCCGAGATCGCGCCATTGCACTCCAGCCTGGGTAACAAGAGCGAAACTCCCTCTCATAAAAAATAAATAAATAAATAAATAAATAAATAAATAAATAAATAAATAAA"
"chr17","59543657","59543981","JH378109","3329188","3329514","46","56214469","GGTTGGGCACAGTGGCTCACGCCTGTAATCCCAACACTTTGGGAGGCCAAGGCGGGTGGATCACCTGAGGTCGGGAGTTCAAGACCAGCCTGGCCAACATGCTGAAACCCTATCTCTACTAAAAATACAAAAAAAAAAAAAAAAAAAAAAAAAAAAAATAGCCCAGTGTGGTGTCAGGCGCCTATAATCTCAGCTACTTGGGTGGCTGAGGCAGGAGAGTCGCTTGAACCTGGGAGGCGGAGGTTGCAGTGAGCGGAGATCGCACCATTGCACTCCAGCGTGGGCAACAAGAGTGAAACTCCATCTCAAAAAAAAAGAAAAGAAA","GGCCAGGCATGGTGGCTCACGCCTGTAATCCCAGCACTTTGGGAGCCCAAGCCGGGTGGATTACCTAAGGTCAGGAATTCCAGAACAGCCTGGACAATATGGTGAAACCTTGTCTCTACTAAAAATACAAAAAAAAAAAAAAAAAAAAAAAAAAAAAAAATTTAGCCGGGTGTGGTGGTAGGTACCTGTAATCCCAGCTACTAGGGAGGCTGAGGCAGGAGAATCGCTTGAACTTGGGAGGCGGAGGTTGCAGTGAACAGAGATCACACCACTGCACTCCAGCCTGGGCGACAAGAGCAAAACTCCATCTCAAAGAAAAAAAAAGAA"
"chr17","60766805","60768705","JH378118","18053084","18053501","1483","42713721","GGCCAGGTACCGTGGCTCATGCCTCTTATCCCACCACTTTTGGAAGCTGAGGTGTGAGGATCACCCGAAGTCAGGAGTTTGGAACCATCCTGGCCAATGTTGTAAAACCCCGTCTCTAATAAAAATACAAAAGTTACCCAAGCATGGTGGTGGGCACACCTGTAATCCCAGCTACTTGGAAGGCTAAGACAGGAAAATGCCTGAACCCAGTGTGGCTGGAATTGGTGGGTTCTTGATCTCACTGACCTCAAGAATGAAGCCACGGACCCTCACGGTGAGTGTCACACTTCAAGGTGGCACGTCCAGTTTGTTCCTTCTGATGTTCGGATGTGCTCAGAGTTTCTTTCTTCTGGTGGGTTCATGGTCTCGCTGGCTCAGGAGTGAAGCTACAGACGTTCACCGGGAGTGTTACAGCTCTTAAGGCCTTGCGCCTGGAGTTGTTAGTTCCTCCCAGTGGCTTCGTGGTCTCACTGGCTTCAGGAATCAAGCAGCACGGTGAGCGTTACAGCTCACAAAGGCAGTGTGCACCCACAGTGAGCAACAGCAAAATCTATTGCAAAGAGGACAGAACAAAACCCCCACACTGGGGAAAAGGACCGGAACAGCTTGCCACTGCTGGCTCAGGCAGCCTGCTTTTATTCTCTTATCTGGCCCCACCCACATCCTCCTGATTGGTCCATTTTACAGAGAGCTGATTAGTTTGCTTTACAGTGAACTGATTGGTCCATTTTGACAGATTGGTGCTGATTGGTGCGTTTACAATCCCTGAGCTAGACACAAAAGTTTTCCACGTCCCCATTAGAATAGCTAGATACAGAGTGTCCATAGGTGTATTTACAAACCCTGAGCTAGACACGGAGTGATGATTGGTGCATTTACAAACATGGAGCTAGATACAGAGTGCCGATTGGTGCATTCACAATCCCTTAGCTAGACATAAAGGTTCTCAAGTTCCCACCAGATCAGCTAGACATAGAGCGCTGATTGGTGCATTTACAAAACTTGAGCTCGACACAGGGTGCTGATTGGTGCATTCACAAACCTTGAGCTAGACACAGGGTGCTGATTGGTGTGTTTACAAACCTTGAGCTAGATGCAGAGCGCTGATTGGTGTATTTACAATTCCTTAGCTAGACATAAAGGTTCTCCAAGTCCCCACTAGACTCAGGAGCCCAGCTGGCCTCACCCAGTGGATGTCACACTGGGGCCATAGGTGGAGCTGCCTGCCAGTTCCGTGTCCTGCGCCCACACTCCTCAGCCCTTGGGCGGTGGATGGGATTGGGCACCGTGCAGCAGGGGGTCGCGCTCCTGGGGGAGGCTCGGGCGGTGCAGGAGCCCACGGTGGCGGGGCGGGGCAGACTCAGGCATGGCGGGCTCCGGGTCCCAAGCCCTGCCGGGTGGGGAGGCACCTAAGGCCAGGCGAGAAATGGAGCGCAGCGCTGGTGGGCCAGCACTGCTGGGGGACCAGGCGCATCCTCCGCAGCTGTTGGCCTGGGTGCTAAGCCCCTCACTGCCCAGGGCTGGCAGGGCCCGCCGGCCGCTCCGAGTGCCGGGCCCGCCAAGCCCACGCCCACTTGGAACTCTAGCTGGCCCGCAAGCGCGGCGCGCAGCCCTGGTTCCCCCCCGTGCCTCTCCCTCCACACCTCCCCGCGGGCTGAGGGAGCCGGCTCCGGCCTCGGCCATCCCAGGAAGGGGCTCCCACACTGCAGCGGCGTGCTGAAGGGCTCCTCAAGCACGGCCAGAGTGGGCGAGGAGGCTGAGGAGGCGCCAAGAGTGAGCCAGGGCTGCCAGCATGCTGTCACCTCTCACCAGGAGGCGGAGATTGCAGTGAACCAAGACTGTGCCATTGCACTCCAGCCTGGGCAACAAGAGTGAAACTCCATCTCAAAAAAAATAATAAA","GGCTGGGCGCAGTGGCTCACACCTGTAATCCCAGCACTTAGGGAAGCTGAGGCGAGTAGATCACCTGAGGTCAGGAGTTAGAGACCAGCCTGGCCATCATGGTGAAACCCCGTCTCTACTAAAGATACCAAAAATTAGCTGAGTGTGGTGCTGGGTGCCTGTAATCCCAGAAACTCAGGGTGCCTGTAATCCCAGCAACTCAGGGTGCCTTTAATCCCAGCAACTGAGGGTACCAGTAATCCCAGCAACTCAGGGTGTCTTTAATCCTAGCAACTGAGGGCACCTGTAATCCCAGCAACTCAGGAAGCTGAGACAGGAGAAGTACTTGAACCCAGAAGGCAGAGGTTGCAGTGAGCCGATATTGCACCATTGCACTCCAGTCTGGGCAACAAGAGTGAAACTCTGTCTCAAAAAAAAA"
"chr17","64473614","64473953","JH378109","21565230","21565567","55","42908384","GGCCGGGTGTGGTGGCTCATGCCTGTAATCCCAGTACTTTGGGAGGCCGAGGCAGGCAGATCTCCTGAGGTCAGGAGTTTGAGACCAGCCTGGCCAACATGATGAAATGCTGTCTCTCCTAAAAATACAAAAATTAGCCAGACATAGTGGCAGGTGCCTGTAATCCCAGCTACTTGGGAGGCTGAGGGAGGAGAATTGCTTGAACCTGGGAGGCAGAGGTTGCAGTGAGTCAAGATCACGCCATTGCGCTCCAACCTGGGTGACAAAAGTGAGACTTCATCTCAAAATAAATAAATAAATAAATAAATAAATAAATAAATAAATAATAATTAAAAAAAAA","GGCCGGGCGCGGTGGCTCAAGCCTGTAATACCAGCACTTTGGGAGGCCGAGGCGGGTGGATCACGAGGTCAAGAGATCGAGACCATCCTGGTCAACATGGTGAAACCCCGTCTCTACTAAAAATACAAACAATTAGCTGGGCATGGTGGCGGGTGCCTGTAATCCCAGCTACTCCAGAGGCTGAGGCAGGAGAATTGCCTGAACCCAGGAGACGGAGGTTGCGGTGAGCCAAGATCGCGCCATTGCACTCCAGCCTGGGTGACAAGAGCGAAACTCCGTCTCAATAAATAAATAAATAAATAAATAAATAAAAATAAAATAAATAAATAAATAAATAA"
"chr17","67747489","67748097","JH378118","18053084","18053501","256","49694405","GCTGGGTGTGGTGGCTCACGCCTATAATCCCAGCACTTTGGGAGGCCAAGGCAGGTGGATCACCTGAGGTCAGGAGTTTGAGACCAGCCTGGCCAACATGATGAAACCCCGTCTCTACTAAAAATACAAAGAATTAGGCTGGGCGCGGTGGCTCACGCCTGTAATCCCAGCACTTTGGGAGGCCGAGGCGGGTGGATCACGAGGTCAGGAGATCGAGACCATCCTGGCTAACACGGTGAAACCCCGTCTCTAATAAAAATAAAAAAAAATTAGCTGGGCGTGGTGGTTGGCGCCTGTAGTCCCAGCTACTCGGGAGGCTGAGGCAGGGGAATGGCGTGAACCCGGGAGGTGGAGCTTGTAGTGAGCCGAGATCACGCCACTGCACTCCAGCCTGGGCGACAGAGCAAGACTCCGTCTCAAAAAAAAAAAAAAAAAAAATTAGCCAGGCGTGGTGGCGGGTGCCTGTAATCCCAGCTACTCTGGAGGCTGAGGCAGGAAAATCACTTTAACTCAGGAAACAGAGGTTGCAGTAAGCCGAGATCACGCCATTGTGCTCCATCCTGGGCAACAAGAGCGAAACTCCGACTCGGAAAAAAAGAAAAAAAAAAA","GGCTGGGCGCAGTGGCTCACACCTGTAATCCCAGCACTTAGGGAAGCTGAGGCGAGTAGATCACCTGAGGTCAGGAGTTAGAGACCAGCCTGGCCATCATGGTGAAACCCCGTCTCTACTAAAGATACCAAAAATTAGCTGAGTGTGGTGCTGGGTGCCTGTAATCCCAGAAACTCAGGGTGCCTGTAATCCCAGCAACTCAGGGTGCCTTTAATCCCAGCAACTGAGGGTACCAGTAATCCCAGCAACTCAGGGTGTCTTTAATCCTAGCAACTGAGGGCACCTGTAATCCCAGCAACTCAGGAAGCTGAGACAGGAGAAGTACTTGAACCCAGAAGGCAGAGGTTGCAGTGAGCCGATATTGCACCATTGCACTCCAGTCTGGGCAACAAGAGTGAAACTCTGTCTCAAAAAAAAA"
"chr17","71197353","71197681","JH378262","266823","267148","47","70930530","GACCGGACACAGTGGCTCACGTCTGTAATCCCAGCACTTTGGGAGGCTGAGGCGGGTGGATCACCTGAGGTCAGGAGTTCAAAACCAGCCTGGCCAATATGGTGAAAACCCGTCTATACTAAAAATAAAAAATTAGCCAGGCTTGGTGGCAGGCACCTGTAATCCTAGGTACTCTGGAGGCTTAGACAGGAGAATCACTTGAACCCGAGAAGTGGAGGTTGCAGTGAGCCAAGATCGTGCCATTGCACTCCAGCCTGGGCGACAAGAGTGAGACTCCATCTCAAAAACAAACAAACAAACAAACAAAAAACAAATGAACAAAAAAAAAA","GGCCGGGCGCGGTGGCTCAAGCCTGTAATCCCAGCACTTTGGGAGGCCGAGGCGGGTAGATCATGAGGTCAGGAGTTTGAGACCAGCCTGGCCAACATGGTGAAACCCCGTCTCTACTAAAAATACAAAAATTAGCCGGGCATGGTGGCCTGTGCCTGTAATCCTAGCTACCCAGGAAGCTGAGGCAGGAGAATTGCCTGAACCCAGGAGGCGGAGGTTGCGGTGAGCCGAGATCGTGCCATTGCACTCCAGCCTGGGTAACAAGAGCGAAACTCCGTCTCAAAAACAAACAAACAAACAAACAAAAACAAAAAACAAAAAACAAA"
"chr17","72892082","72892699","JH378118","18053084","18053501","266","54838998","GGCCAGGTGCAGTGGTTCACACCTATAATCCCAGCACTCTAGGAGGCCAAAGTGGGCAGATCACCTGAGGTCAGAAGTTCGAGACCAGCCTGGCCAACATGGTGAAACCATCTCTACTAAAAACACAAAAATTAGGCTGGGCACGGTGGCTCACACCTGTAATCCCAGCACTTTGGGAGGCCGAGGTGGGTGGATCACGAAGTCAGGAGATCAAGACCATCCTGGCTAACACGGTGAAACCCCGTCTCTACTAAAAATACAAAAAATTAGCCAGGCGTGGTGGCGGGCGCCTATAGTCCCAGCTACTTGGGAGGCTGAGGCAGGAGAATGGCGTGAACCCAGGAGGCGGAGCTTGCAGTGAGCCAAGATTGCGCCACTGCACTCCAGCCTGGGTGAGAGAGCTAGACTCTGTCTCAAAAAAAAAAAAAAAAAAAACACAAAAATTAGCCGGGCTTGGTGGCAGGTGCCCGTAATCCCAGCTACTCAGGACGCTGGGACAGGAGAATCTCATGAACCCTGGAGGTGGAGGTTGTAGTGAGCCAAGATCTCACCATCGCACTCCAGCCAGGGTGACAAGAGTGAAACTCTGTCTTAAAAAGATAAATAAATAAAATAAAA","GGCTGGGCGCAGTGGCTCACACCTGTAATCCCAGCACTTAGGGAAGCTGAGGCGAGTAGATCACCTGAGGTCAGGAGTTAGAGACCAGCCTGGCCATCATGGTGAAACCCCGTCTCTACTAAAGATACCAAAAATTAGCTGAGTGTGGTGCTGGGTGCCTGTAATCCCAGAAACTCAGGGTGCCTGTAATCCCAGCAACTCAGGGTGCCTTTAATCCCAGCAACTGAGGGTACCAGTAATCCCAGCAACTCAGGGTGTCTTTAATCCTAGCAACTGAGGGCACCTGTAATCCCAGCAACTCAGGAAGCTGAGACAGGAGAAGTACTTGAACCCAGAAGGCAGAGGTTGCAGTGAGCCGATATTGCACCATTGCACTCCAGTCTGGGCAACAAGAGTGAAACTCTGTCTCAAAAAAAAA"
"chr17","74365360","74365846","JH378118","18053084","18053501","163","56312276","TATAAAAAATCAGCTAGGCTTGGTGGCTTGTGCCTGTAATCCCAGCACTTTGGGAGGCTGAGGCAGGTGGATCACCTGACGTAGGTGTTTAAGACCAGATTGACTAACATGTTGAAACCCCGTCTCTACTAAAAATACAAAAATTATCTGGGCTTGGTGGTGCATGCCTGTAATCCCAGCTGCTCAGGAGGCTGAGACAGGAGAATCGCCTGAACCTGGGAAACGGAAGTTGCAGTGAGTGGAGGTTGCAGTGAGCCGAGATTGCACCACTGCACTCCAGTCTGGGCAACGGAAAAAGACTGTCTCAAAAAAAAAAAAAAAATTAGCTGGGTGTGGTGGTTGGCGCCTGTAATTCCAGCTACTCAGGAGGCTGAGGCAGGAGAATCACTTGAACTCAAGAGGCAGAGGTTGCAATGAGCCAAGATTGCGCCATTGTACTCCAGCCTGGGCCACAAGATTGAAACTTCATCTTGGGGAAAGAAAACAA","GGCTGGGCGCAGTGGCTCACACCTGTAATCCCAGCACTTAGGGAAGCTGAGGCGAGTAGATCACCTGAGGTCAGGAGTTAGAGACCAGCCTGGCCATCATGGTGAAACCCCGTCTCTACTAAAGATACCAAAAATTAGCTGAGTGTGGTGCTGGGTGCCTGTAATCCCAGAAACTCAGGGTGCCTGTAATCCCAGCAACTCAGGGTGCCTTTAATCCCAGCAACTGAGGGTACCAGTAATCCCAGCAACTCAGGGTGTCTTTAATCCTAGCAACTGAGGGCACCTGTAATCCCAGCAACTCAGGAAGCTGAGACAGGAGAAGTACTTGAACCCAGAAGGCAGAGGTTGCAGTGAGCCGATATTGCACCATTGCACTCCAGTCTGGGCAACAAGAGTGAAACTCTGTCTCAAAAAAAAA"
"chr17","74566963","74567566","JH378119","32351107","32351490","260","42215856","GCCGGGCATGGTGTATCACGCCTGTAATCCCAGCACTTTGGGAGGCAGAGGTAGGCAGATCACCTGAGGTCAGGAGTTCAAAACCAGCCTAGCCAACATGGTGAAACCCCGTCTCTACTAAAAATACAAAAAATTAGTGGCCAGGCACGGCAGCTCACGCCTGTAATTCCAGCACTTTGGGAGGCCGAGGCGGGCAGATCACGAGGTCAGAAGATTGAGACCATCCTGGCTAACACGGTGGAACCCCATCTCTACTAAAAATACAAAAAATTAGCTGGGCATGGTGGCTGGTGCCTGTAGTCCCAGCTACTCGGGAGGCTGAGGCAGGAGACTGGCATGAACCCGGGAGGCGGAGCTTGCAGCAAGCCAAGATCGTGCCACTGCACTCCACTCCATCCTGGGCGACAGAGCAAGACTCCGCTTCAAAAAAAAAAAAATTAACCGGGCAAGGTGGCAGGTGCCTGTAATCCCAGCTACTTGGGAGGCTGAGGCAGGAGAATTGCTTGCAGAGGTTGAAGTGAGCCGAGATTACGCCATTGCACTCCAGCCCAAGTGACAAGAGTGAAACTCCATCTCAAAAAAAAAAAAAAAAAAAAGAAAAAAA","GGCCAGGTATGGTGGCTCACACCTGTAATCCCAGCACTTTGGGAGGCCAAGGCAGGCAGACCACCTGAGGTCAGGAGTTCGAGATCAGCCTAGCCAACATGGTGAAACCCCATCTCTAGTAAAAATAAAATTAGCCAGGCATGGTGGTGCATGCCTGTAACGCAGGTCAGGAGTTCGAGATCAGCTTAGCCAACATGGTGAAACCCCATCTCTAGTAAAAATAAAATTAGCCAGGCAGGTGGTGCCGCCTGTACTCGGGAGGCTGAGGCAGGAGAATCACTTGAACCCAAGAGGCAGAGGTTGCAGTCAGCCAAGATCATGCCATTGCACTCCAGCCTAAGCAAAAAGAGTAAAACTCAGTCTCAAAACAAAAAAACAAAAAAA"
"chr17","75365782","75366409","JH378153","2355361","2355755","282","73010421","CCAGGCGTGGTGGCTCATGCCGGTAATCCCAGCACTTTGGGAGGCCAAGGCAGGTGGATCATCTGAGGTCAGGAGTTCGAGACCAGCCTGACCAACATGGTGAAACCTCACCTCTACTAAAAATACAAAAACTAGACAGGCGTGGTGGCGGGTGCCTGTAGTCCCAGCTACTTGGGAGGCTGAGGCAGAAAAATCGCTTGAACCCAGTAGGCAGAGGTTGCAGTGAGCCGAGATCACACCATTGCACTCCAGCCTGGGCAAAAAAGAGCGAAACTCCATCTCAGAAGAAAAGACCGGGTGCAGTGGCTCATGCTTGTAACCCCAGCACTTTGGGAGGCCAAGGCGGGTGGATCACGAGGTCAGAAGATCGAGACCATCCTGGCTAACACGGTGAAACCCCGTCTCTACTAAAAATACAAAAAAAAAAAAATAATTAGCCGAGTGTGGTGGCGGATGCCTGTAGTCCCAGCTACTCGGGAGGCTGAGGCAGGAGAATGGCGTGAACCCAGGAGGCGTAGCTTGCAGTGAGCCGAGATCACGCCACTGCACTCCAGCCTGGGCGACAGAGCAAGACTCGTCTTAAAAAAAAAAAAAAAAAGAAAAAGTAAAAGAAAAGAAAAAGCAACAA","GGCGGGGCATGGTGGCTCACACCTGTCATCCCAACACTTTGGGAGGCTGAGGCAGGCAGATCACCTGAGGTCAGGAGTTTGAGACCAGCCTGGCCAACATGGTGAAACCCCATCTCTACTAAAAATACAAAAATACAAAAAACCCCATCTCTACTAAAAATACAAAAAGCTTGTCTCTATTAAAAATACAAAAAACAAAAAACAAACAAAAAAAAAACCACCATGGTGGTGGGTGCCTATAATCCCAGCTACTCGGGAGGCTGAGGCAGGAGAATCGCTTGAACCCAGGAGGCAGAGGTTGCAGTGAGCCAAGATCCCACCATTGCACTCCAGCCTGGGCAACAGAGAGAGAGACTCTGCCTCAGAAAAAAGAAAGAAAGAAAGAAAGAAAGAAA"
"chr18","19875","20142","JH378153","8929988","8930242","54","8910113","TTGGGAGGCTGAGGTGGGTGGATCATCTGAGGTCAGGAGTTAAGACCAGCCTGGCCAACATGGTGAAACCCCATCTCTACTAAAAATACAAAAACAAAACAAAACAAAACAAAAAAAACCAGCATGGTGGCAGACACCTGTAATCCCAGCTACTCGGGAGACTGAGGCAGGAGAATCACTTGAACCTGGGAGGCGGAGGTTACAGTGAGCCAAGATCTTGTCATGTCACTCCAGCCCAGGCAACAAGAGCAAAACTGTCTTAAAAAAA","TTTGAGAGGCTGAGGTGGGTGGATCACCTAGGTCAGGAGTTTGAGACCAGCCTGACCAACATGGTGAAACCTCATCTCTACTAAAAATAAAAATAAAAAACTAGCCAGGTGCAATGGTGCATGCCTGTAATCCCAGCTACTTGGGAGGCTGAGATGGGAGACTCACTTGAACCTGGGAGGTGGAGGTTGCAGTGAGCCAAGATCATACCATTGCACTCCAGCCTGGGCAACAAGAGTGAAACCTCTTCTCAAAAA"
"chr18","4520498","4521101","JH378118","18053084","18053501","246","13532586","GGCTGGGCGCAGTGGCCCACCCCTGTAATCCCAGCACTTTGGGAGGCCGAGGCGGGTAGATCACCTGACGTCAGGAGTTCAAGACCAGCCTGGCCAACATGGTGAAACCCTGTCTCTACTAAAATACAAAAATTAGGCTGGGCGCAGTGGCTCAAGCCTGTAATCCAGCACTTTGGGAGGCCAAGGCGGGCAGATCACCTGAGGTCAGGAGTTCGAGACTAGCCTGGCCAACCTGGCAAAACCCCATCTCTACTAAAAGTACGAAAATTAGCCAGGGTGATGGTGTGCACCTGTAATCCTAGGTACTCAGGAGGCTGAGGGCAAGAGAATCGCTTGAACCTGGGAGGCAGAGGTTGTAGTGGGCCAAGATCGCGCCATTGCACTGCAGCCTCGGTGACAGAGAAAGACTCCGTCTCAAAAAAAAAAAAAAACAAAAATTAGCTGGGCGTGGTGGTGGGCGTCTGTAGTCCCATCTACACGGGAGGCTGAGGCAGAAGAATCACTTAAACCCAGGATGTGGAGGTTGCAGTGAGCTGAGATCACGCCATTGCACTCCAGACTGGGTAACAAGAGCAAAACTCCATCTCAAATAAATAAAATAAAA","GGCTGGGCGCAGTGGCTCACACCTGTAATCCCAGCACTTAGGGAAGCTGAGGCGAGTAGATCACCTGAGGTCAGGAGTTAGAGACCAGCCTGGCCATCATGGTGAAACCCCGTCTCTACTAAAGATACCAAAAATTAGCTGAGTGTGGTGCTGGGTGCCTGTAATCCCAGAAACTCAGGGTGCCTGTAATCCCAGCAACTCAGGGTGCCTTTAATCCCAGCAACTGAGGGTACCAGTAATCCCAGCAACTCAGGGTGTCTTTAATCCTAGCAACTGAGGGCACCTGTAATCCCAGCAACTCAGGAAGCTGAGACAGGAGAAGTACTTGAACCCAGAAGGCAGAGGTTGCAGTGAGCCGATATTGCACCATTGCACTCCAGTCTGGGCAACAAGAGTGAAACTCTGTCTCAAAAAAAAA"
"chr18","8281535","8282152","JH378118","18053084","18053501","271","9771549","GGCCAGGTGCGATAGCTCACACTGGTAATCCCAACACTTTGGGAGGCCGAGGTGGGCGGATCACCTGAGGCCAGGAGTTTGAGACCAGCCTGGCCAACACAGTGAAACCCCATCTCTACTAAAAATACAAAATTAGGCAGGGTGCAGTGGCTCACGCCTGTAATACCAGCACTTTGGGAGGCCGAGACAGGCGGATTACGAGGTCAGGAGATCGAGACCATCCTAGCTAACACAGTGAAACCCCGTCTCTACTAAAAAAAAAAAAAAAAAAAAAAGTACAAAAAAATTAGCCAGGCGTGGCGGCAGGTGCCTGTAGTCCCAGCTACTCAGGAGACTGAGGCAGGAGAATGGCGTGAACCCGGGAGGCGGAGCTTGCAGTGAACTGAGATCACACCACTGCACTCCAGCCTGGGCAACAGAGTGAGACTCCGTCTCAAAAACAAAACAAAATTAGCCGGGCATGGTGGTGGATGCCCGTAATCCCAGCTACTCGGGAGGCTGAGGCCGCCAAGGCAGGAGAATCTCTTGAATGTGGGAGGCAAAGGCTGCAGTGAGCTGAGATCATGCCATTGCACTGTAGCCTGGGCGACAAAAGTGAGACTCCGTCTCAAAAAAAAA","GGCTGGGCGCAGTGGCTCACACCTGTAATCCCAGCACTTAGGGAAGCTGAGGCGAGTAGATCACCTGAGGTCAGGAGTTAGAGACCAGCCTGGCCATCATGGTGAAACCCCGTCTCTACTAAAGATACCAAAAATTAGCTGAGTGTGGTGCTGGGTGCCTGTAATCCCAGAAACTCAGGGTGCCTGTAATCCCAGCAACTCAGGGTGCCTTTAATCCCAGCAACTGAGGGTACCAGTAATCCCAGCAACTCAGGGTGTCTTTAATCCTAGCAACTGAGGGCACCTGTAATCCCAGCAACTCAGGAAGCTGAGACAGGAGAAGTACTTGAACCCAGAAGGCAGAGGTTGCAGTGAGCCGATATTGCACCATTGCACTCCAGTCTGGGCAACAAGAGTGAAACTCTGTCTCAAAAAAAAA"
"chr18","14964693","14965321","JH378118","18053084","18053501","273","3088391","GGCTGGGTGCGGTGGCTCACACCTGTAATCCCAGCACTTTGGGAGGCTGAGGCAGGCGGATCACCTGAGGTCAGGAGTTCAGGACCAGCCTGATCAACATAGCGAAACCCTGTCTCTATTAAAAATATAAAAATTGCTGGGTGCGGTGGCTCACGCCTGTAATCCCAGCACTTTGGGAAGCCGAGGCGGGCGGATCATGAGCTCAGGAGATCGAGACCATCTTGGCTAACATGGTGAAACCCTGTCTCTACTAAAAATACAAAAAAATTAGCCAGGTGTGGTGGCGGGCGCCTGTAGTCCCAGCTACTCTGGAGGCTGAGGCAGGAGAATCACTTGAACCTGGGAGGCGGAGGTTGCGGTGAGCCAAGATGGTGCCATTGCACTCCAGCCTGGGCAACAAGAGTGAAACTCCATCTCAAAAAAAAAGAAAAAAAAAAAAAAAAACAACCCACAAAAATTAGCCAGGTGTGATGGCGGGTGTCTGTAATCCCAGCTACTTGGGAGACTGAGGCAGGAGAATGGCTTGAACCCGGGAGGTGGAGGTTGCAGTAAGCCGAGATTGCGCCACTGCACTCCAGCCTGGGTGACCAGAGTGAAACTTCATCTCAAAAAAAAAAAAAAAAAAAAAA","GGCTGGGCGCAGTGGCTCACACCTGTAATCCCAGCACTTAGGGAAGCTGAGGCGAGTAGATCACCTGAGGTCAGGAGTTAGAGACCAGCCTGGCCATCATGGTGAAACCCCGTCTCTACTAAAGATACCAAAAATTAGCTGAGTGTGGTGCTGGGTGCCTGTAATCCCAGAAACTCAGGGTGCCTGTAATCCCAGCAACTCAGGGTGCCTTTAATCCCAGCAACTGAGGGTACCAGTAATCCCAGCAACTCAGGGTGTCTTTAATCCTAGCAACTGAGGGCACCTGTAATCCCAGCAACTCAGGAAGCTGAGACAGGAGAAGTACTTGAACCCAGAAGGCAGAGGTTGCAGTGAGCCGATATTGCACCATTGCACTCCAGTCTGGGCAACAAGAGTGAAACTCTGTCTCAAAAAAAAA"
"chr18","15291276","15291680","JH378105","31074364","31074738","116","15783088","CTCGTGCCTGTAATCCTAGCACTTTGGGAGGCCAAGGTGGGCAGATCATCTGAGGTCAGGAGTTCGAGACCAGCCTGGCCAACATAGAGAAATCCCATCTCTACTAAAAATACAAAAATTGACGAGTTAATGGGTGCAGCACACGAACATGGCACATGTATACATATGTAACAAACCTGCACGTTGTGCACATGTACCCTAAAACTTAAAGTATATTTAAAAAAAATACAAAAATTAGCCGGGCATGGTAGCAGGCACCTGTAATCCCAGCTACTCGGGAGGCTGAGGCAGGAGAATCACTTGAACCTGGGAGGCAGAGGTTGCAGTGAGCTAAGATCATTCCATTGTACTCCAACCTGGGCAACAAGAGTGAAATTCCGTCTAATAAAAAATGAAATAAATAAA","GGCCGGGCACAGTGGCTCACACCTGTAAACCCAGCACTTTGGGAGAATGAGGTGGGCAGATGACTTCAGGTCAGGAGTTCGAGACCAGCCTGGCCAACACTGTGAAATCCCATCTCTACTAAAAATACAAAAATTAGCCATGGTGGTCAGAAGATCAAGACTATCCTGGCCAACATGGTGAAACCTTGTCTCTACTGAAAATAGAAAAATTAGCTGGGTATGGTGGCATGCGCCTGTAGTCCCAGATACTCAGGAGGCTGGGGCAGGAGAATCACTTGAACCCAGGAGGCAGAGGTTGCAGTGAGCTGAGATCATGCCATTGCACTCTAGATTAGGCAACAAGAGTGAAACTGTCTCAAAAAGAGAGAGAGAAAA"
"chr18","15802064","15802689","JH378153","2355361","2355755","270","13446703","GACCGGGCATGGTGGCTCACACCTGTAATCCCAGCACTTTGGGAGGCGTAGGCGAGTGGCCCCTGAGGTCAGGAGATCGAGACAACCCTGGCCAACATGGTGAAACTCTACTAAAAATACAAAATTAGGCCGGGTGCCGTGGTTCACGCCTATAATCCCAGCACTTTGGGAGGTCAAGGTGGGCAGATCACCTGAGGTCAGGAGTTTGAGACCAGCCTGGCCAACATGGTGAAACCCAGTCTCTACTAAAAATACAAAAATTAGCTGGGCATGGTGGTGGACACTTGTAATCCCAGCTACTTGGGGGGCTGAGGCAGGAGAATCACTTGAACCCAGGAGGCAGAGGTTGCAGTGAGCCTAAATCACCCCATTGCACTCCAGCCTGGGCAACAAGAGTGAAATTCTGTCTCGAAAAAAAAAAAAAAAGAAAAGAAAAGAAAAAAAAATTAGCCAGGTGTGGTGCTGCATGCCTGTAATCCCAGCTACTCAGGAGGCTGAGGCAGGAGAATCGCTTGAACCCGGGAGGCAGAGGTTGCAGTGAGCTGAGACCACACCATTGCACTCCAGCCTGGGCGACAAGAGAGTAACTCCATTTCAAAAAAAAAAAAAAAAAAAAGAAAAAAGAA","GGCGGGGCATGGTGGCTCACACCTGTCATCCCAACACTTTGGGAGGCTGAGGCAGGCAGATCACCTGAGGTCAGGAGTTTGAGACCAGCCTGGCCAACATGGTGAAACCCCATCTCTACTAAAAATACAAAAATACAAAAAACCCCATCTCTACTAAAAATACAAAAAGCTTGTCTCTATTAAAAATACAAAAAACAAAAAACAAACAAAAAAAAAACCACCATGGTGGTGGGTGCCTATAATCCCAGCTACTCGGGAGGCTGAGGCAGGAGAATCGCTTGAACCCAGGAGGCAGAGGTTGCAGTGAGCCAAGATCCCACCATTGCACTCCAGCCTGGGCAACAGAGAGAGAGACTCTGCCTCAGAAAAAAGAAAGAAAGAAAGAAAGAAAGAAA"
"chr18","15849226","15849860","JH378118","18053084","18053501","290","2203858","GGCCAGGCACAGTAGCTTACGCCTATAATCTCAGCACCCTAGGAGGCCGAGGCTGGCAGACCACCTGAGGTCACGAGTTCAAGACTAGCCTGGTCAACATAGCAAAACCCCATCTCTACTAAAAATACAAAAATTAGGCTGGGCACAGTGGCTCATGCTTGTAATCCCAGCACTTTGGGAGGCCAAGTCGGGAGAATCACCTGAGGTTGGGAGTTCGAGATCAGCCTGACCAACATAGAGAAACTCCATCTCTACTAAAAATGCAAAATTAGCTAGGCATGGTGGTGCATGCCTGTAATCCCAGCTACTCGTAAGGCTGAGGCAGGAGTATCGCTTGAATCTGGGAGGTGGAGGTTGCGGTGAGCCAAGATCACGCCATCGTACTCCAGCCTGGGCAACAAGAGCGAAACTCCATCTCAAAACAAAAAAAATGAGCCAGGAGTGGTGGCGGGCGCCTATAATTCCAGCTACTCCAGAGGCTGAGGCAGGAGAATCACTTAAACCCGGGAAGCAGAGGTTGCAGTGAGCTGAGATTGTGCCATTGCACCCCAGCCTAGGTGAAAAGAGCAAAACTCCATCTCAAAAAAAAAAAAAAAAAAAAAAAAAAAGAAAGAAAGAAAGAAAAAGAAAAAAAA","GGCTGGGCGCAGTGGCTCACACCTGTAATCCCAGCACTTAGGGAAGCTGAGGCGAGTAGATCACCTGAGGTCAGGAGTTAGAGACCAGCCTGGCCATCATGGTGAAACCCCGTCTCTACTAAAGATACCAAAAATTAGCTGAGTGTGGTGCTGGGTGCCTGTAATCCCAGAAACTCAGGGTGCCTGTAATCCCAGCAACTCAGGGTGCCTTTAATCCCAGCAACTGAGGGTACCAGTAATCCCAGCAACTCAGGGTGTCTTTAATCCTAGCAACTGAGGGCACCTGTAATCCCAGCAACTCAGGAAGCTGAGACAGGAGAAGTACTTGAACCCAGAAGGCAGAGGTTGCAGTGAGCCGATATTGCACCATTGCACTCCAGTCTGGGCAACAAGAGTGAAACTCTGTCTCAAAAAAAAA"
"chr18","16042035","16042617","JH378118","18053084","18053501","243","2011049","GGCTATGCACGGTGGCTCACGCCTGTAATCCCAGCACTTTGGGAGGCCGAGTCAGGTGGATCACTTGAGGTCAGGAGTTCGAGACCAGCCTGGCCAACATGGTGAAGCCCCATCTCCACTAGAAATACAAAAATTAGTCTGGGAGCAGTGGCTTACACCTGTAATTGCAGCACTTTGGGAGGCCAAGGTGGGTGGATCACCTGAGGTCAGGAGTTTGAGACCAGCATGACCAACATGGTGAAACTCCATCTATACAAAAAAATTAGCCGGGTGTGGTGGCGCATGCCTGTAATCCCAGCTACTCAGGAGACTGAGGCAGGAGAATTGCTTGAACCCGGGAGGCAGAGGTTGCAGTGAGCCAAGTCTGTGCCATTGCACTCCAACCTGGGCAACAAAAGCGAAACTCTGTCTCAAAAATAAACAACAAAAAAAATTAGCCAGGTGTGGTGGCACATGCCTATAATCCCAGCTACTCGGGAGGCTGAGGCAGAAGAATTGCTTGAACCTGGGAGGTGGAGGTTGCAGTGAGCCGAGATCATGCCATTCTACTCCAGCCTGGGCCACAAGAGCGAAACTCTGTCTC","GGCTGGGCGCAGTGGCTCACACCTGTAATCCCAGCACTTAGGGAAGCTGAGGCGAGTAGATCACCTGAGGTCAGGAGTTAGAGACCAGCCTGGCCATCATGGTGAAACCCCGTCTCTACTAAAGATACCAAAAATTAGCTGAGTGTGGTGCTGGGTGCCTGTAATCCCAGAAACTCAGGGTGCCTGTAATCCCAGCAACTCAGGGTGCCTTTAATCCCAGCAACTGAGGGTACCAGTAATCCCAGCAACTCAGGGTGTCTTTAATCCTAGCAACTGAGGGCACCTGTAATCCCAGCAACTCAGGAAGCTGAGACAGGAGAAGTACTTGAACCCAGAAGGCAGAGGTTGCAGTGAGCCGATATTGCACCATTGCACTCCAGTCTGGGCAACAAGAGTGAAACTCTGTCTCAAAAAAAAA"
"chr18","25849088","25849351","JH378114","20445944","20446195","60","5403144","GGGAAGATGAGGCGGGTGGATCACTTGAGGTCAGGAGTTCGAGACCAGCCTGGCCAACATGGTGACACCCTGTCTCCAAAAAATACACACACACACACACACACACACACACACACAAATTAGCTGGGCATGGTGGCGGGCACCTGTAATCCTAGCTACTCGAGAGGCTGCGGCAGGAGAATTGCTTTAACTTGGGAGGTAGAGGTTGCAGAGAGCCGAGATTGCACCATTGTACTCCAGCCTGGGTGACAAGAGCGAAACTCC","TTGGGAGGCCAAGGCGGGTGGATCACCTGAGGTCAGGAGTTCGAGACCAGCCTGGCCAACATGATAAAACCCCCGTATCTAATAAAAATAGGAAAAAAAAATAAATAAATAGCTGGGCGTTGTGGCAGGTGCCTGTAATCCCAGCTACTCGGGAGGCTCAGGCAGGAGAATCGCTTGAACCCAGGAGGCAGAGGTTGCAGTGAGCCAAAATTGTGCCATTGCACTCCCGCCTGGGAAACAAGAGCAAAACTC"
"chr18","38083500","38083832","JH378152","15993594","15993909","55","22089906","GGCTGGGTGCGGTGGCTCACGCCTGTAATCCCAGCACTTTGGGAAGCCAAGTCAGGTGACCTCACCTGAGGTCAGGAGTCCAAGACCAGCCTGACCAACATGGTGAAACCTCGTCTCTACTAAAAAGACAAAAAATTAGCCAGGCATGGTGGTGGGCACCTGTAATCTCAGCTACTCTGGAGGCTGAGGCAGGAGAATCACTTGAACCCTGGAGGGGGAGGTTGCAGTGAACCAAGATTGCACCATTGCAGTCCAGCCTGGGCGACAAGAGCAAAACTCCATCTCACAAACACACACACACACACACACACACACACACACAGAAAAAAAAAA","GGCTGGGTGTGGTGGCTCATGCCGGTAATCCCAGCACTTTGGGAAGCGGAGGCAGGCAGATCACCTGAGGTCAGGAGTTCAAGACCAACCTGGCCAACATGGAGAAACCATGTCTCTACTAAAAATACAAAAAATTAGCCAGGCATGGTGGGTGCCTGTAATCCCCACTACTCGGGAGGCTGAGGCAGGAGAATTTCTTGAACCCAGGAGGTGGAGGTTTCAGTGAAGCGGAGATCACCCCATTGCACTCCAGCCTGGGTGACAAGAGCAAAACTCCATCTCACAAAATCAACAACAACAACTTAAAAAAAAAAAA"
"chr18","44076326","44076933","JH378118","18053084","18053501","257","26023242","GCTGGGCGCGGTGGCTTGCGCCTGTAATCCCAGCCATTTGGGAGGCCGAGGCAGGTGGATCACCTGAGGTTAGGAGTTCAAAACCAGCCTGGCCAACATGGTGAAACCCCGTCTCTACTAAAAATACAAAAATTAGGCCAGGCACAGTGGCTCACGCCTGTCATCCCAGCACTTTGGGAGGCCAAGGCGGGCGGATCATGAGGTCAGGAGATTGAGACCATCCTGGCTAACACAGTGAAACCCTGTCTCTACTAAAAAAATATATAAAAAATTAGCCGGGCTTGGTGGCGGGTGCCCGTAATCCCAGCTACTCGGGAGGCTGAGGCAGGAGAATGGCGTGAACCTGGAAGGCGGAGCTTGCAGTGAGCCGAGATTGCACCACTGCACTCCAGCCTGGGTGACAGAGTGAGACTCTGTCTCAAAAAAAAAAAAAAAACAAAAAACAAAAATTAGTTGGGTGTGGTGGTGGACGCCTGTAATCCCGGCTACTCGGGAGGCTGAGGCAGGAAAATCACTTCAACCCGGGAGGCAGAGGTTGCCGTGAGCCAAGATCGTGCCATTGCACTCCAGCCTGGGTGACAAGAGCAAAACTCTGTCTCAAAAAAAAA","GGCTGGGCGCAGTGGCTCACACCTGTAATCCCAGCACTTAGGGAAGCTGAGGCGAGTAGATCACCTGAGGTCAGGAGTTAGAGACCAGCCTGGCCATCATGGTGAAACCCCGTCTCTACTAAAGATACCAAAAATTAGCTGAGTGTGGTGCTGGGTGCCTGTAATCCCAGAAACTCAGGGTGCCTGTAATCCCAGCAACTCAGGGTGCCTTTAATCCCAGCAACTGAGGGTACCAGTAATCCCAGCAACTCAGGGTGTCTTTAATCCTAGCAACTGAGGGCACCTGTAATCCCAGCAACTCAGGAAGCTGAGACAGGAGAAGTACTTGAACCCAGAAGGCAGAGGTTGCAGTGAGCCGATATTGCACCATTGCACTCCAGTCTGGGCAACAAGAGTGAAACTCTGTCTCAAAAAAAAA"
"chr18","44546829","44547449","JH378118","18053084","18053501","262","26493745","GGCCAGGCACGGTCGCTCACACCTGTAATTCCAGCACTTTGGGAGGCCAAGGCGGATGGGTCACCTGAGGTCAGGAGTTTGAGACCAGCCTGACCAATATGATGAAACCCCATCTCTATTAAAAATACAAAAATTAGGCTGGGCGCAGTGGTTCATGCCTGTAATTCCAACACTTTGGGAGGCCGAGACGGGCGGACCATGAGGTCAGGAGATCGAGACCATCCTGGCCAACGTGGTGAAACCCCGTGTCTACTAAAATACAAAAAAAATTAGCCAGGTGTGGTGGCACGTGCCTGTAGTCCCAGCTATTAGGGAGGCTGAGGCAGGGGAATCACTTGAACCTGGGAGGTGGAGGTTGCAGTGAGCTGAGATCTTGCCACTACACTCCATTCTGGGCAACAGAGCAAGACTCCGTCTGAAAAAAAACAAAAAAATACAAAAATTAGCTGGGCATGGTGGCGGGTACCTGTAATCCCAGCTACTTGGGAGGCTGAGACAGGAGAATCACTTGAACTCGGGAGGCAGAGGTTGCAGTGAGCCAAGATCGCACCATTGCATTCCAGCCTGGGCAACAAGAGCGAAACTCCATCTCAAAAAAACAAAAAAAAAAAAAAAGAAAAA","GGCTGGGCGCAGTGGCTCACACCTGTAATCCCAGCACTTAGGGAAGCTGAGGCGAGTAGATCACCTGAGGTCAGGAGTTAGAGACCAGCCTGGCCATCATGGTGAAACCCCGTCTCTACTAAAGATACCAAAAATTAGCTGAGTGTGGTGCTGGGTGCCTGTAATCCCAGAAACTCAGGGTGCCTGTAATCCCAGCAACTCAGGGTGCCTTTAATCCCAGCAACTGAGGGTACCAGTAATCCCAGCAACTCAGGGTGTCTTTAATCCTAGCAACTGAGGGCACCTGTAATCCCAGCAACTCAGGAAGCTGAGACAGGAGAAGTACTTGAACCCAGAAGGCAGAGGTTGCAGTGAGCCGATATTGCACCATTGCACTCCAGTCTGGGCAACAAGAGTGAAACTCTGTCTCAAAAAAAAA"
"chr18","45772849","45773450","JH378118","18053084","18053501","269","27719765","CACGCCTATAATCCCAGCACTTTAGGAGGCTGAGGCAGGTGGATCACCTGAGATCAGGAGTTCAAAACCAGCCTGGCCAACATGGTGAAACCCTGTGTCTACTACAAATACAAAAAAATGGGCAGGGTGTGGTGGCTCACACCTGTAATCCCAGCACTTAGGGAGGCCGAGGCGGGTGGATCATGAGGTCAAGAGATCAAGACCATCCTGGCCAACATGGTAAAACCCCGCCTCTACTAAAAATATAAAAATTAGCTGGGCAAGGTGGTGCGCGCCTGTAGTCCCAGCTATTTGGGAGGCTGAGGCAGGAGAATTGCTTGAACCTGGGAGGTGGAGGTTGCAGTGAGCCAAAATCGCGCCACTGCACTCCAGCCTGGCAACAGAGTGAGACTCTGTCTCAAAAAAAAACAAAAACAAAACAAAACAGAAACCAAAATTAGCTGGGCGTGGTGGCGGGCGCCTGTAGTCCCAGCTACTTGGGAGGCTGAGGCAGGAGAATCGCATGAACCCAGGAGGCGGAGGTTGCAGTGAGCCAAGACTGCACTATTGCACTCCAGTCTGGGCTACAAGAGCGAACTCCGTCTCAAAAAAAAAAAAAAAAA","GGCTGGGCGCAGTGGCTCACACCTGTAATCCCAGCACTTAGGGAAGCTGAGGCGAGTAGATCACCTGAGGTCAGGAGTTAGAGACCAGCCTGGCCATCATGGTGAAACCCCGTCTCTACTAAAGATACCAAAAATTAGCTGAGTGTGGTGCTGGGTGCCTGTAATCCCAGAAACTCAGGGTGCCTGTAATCCCAGCAACTCAGGGTGCCTTTAATCCCAGCAACTGAGGGTACCAGTAATCCCAGCAACTCAGGGTGTCTTTAATCCTAGCAACTGAGGGCACCTGTAATCCCAGCAACTCAGGAAGCTGAGACAGGAGAAGTACTTGAACCCAGAAGGCAGAGGTTGCAGTGAGCCGATATTGCACCATTGCACTCCAGTCTGGGCAACAAGAGTGAAACTCTGTCTCAAAAAAAAA"
"chr18","50079974","50080314","JH378127","6796468","6796795","54","43283506","GGTCTGGCGCCAGTGGCTCATGCCTGTAATCCCAGCACTTTGGGAGGCTGAGGCGGGTGTATCACCTGAGGTCAGGAGTTCGAGACCAGCCTGGCCAACATGGCAAAACCCCGTCTCTACGAAAAATACAAAAAAATTAGCCGGGCGTGGTAGCAGTCGCCTGTAATCCCAGCAACTTGGGAAGCTGAGGCAGAAGAATCGCTTAAACCTAGGAGGCGGAGGTTGCAGTGAGCCAAGATTGCGCCATTGCACTCCAGCCTGGTCAACAAGAGCAAAACTCTGTCTCAAAACAACAACAACAACAACAACAACAACAAACAAAAACCAAAAAAACCAAAAAA","GGCCGGGCGCGGTGGCTCAAGCCTGTAATCCCAGCATTTTGGGAGGCCGAGGCGGGTGGATCACGAGGTCAGGAAATCGAGACCATCCTGGTCAACATGGCGAAACCCCATGTCTACTAAAAATACAAAAATTAGCTGGGCATGGTGGCACGTGCCTGTAATCCCAGCTACTCAGGAGGCTGAGGCAGGAGAATTGCCTGAACCCAGGAGGCGGAGCTTGCAGTGAGCCGAGATCGCGCCATTGCACTCCAGCCTGGGTAACAAGAGCGAAACTCCGTCTCAAAAAAACAAACAAAAACAAAACAAAACAAAACAAAACAAAAAAAAC"
"chr18","53653883","53654201","AGCE01149660","956","1264","46","53652927","GGCCAGGCATGGTGGCTCACGTTTGTAATCCTAGCACTTTGGGAGGCTGTAGCGGGCGGATCACCTGAGGTCAGGAGTTTGAGACCAGCCTGGCCAACATGGTGAAACCCTGTCTCTACTAAAAAAAAAAAAAAAAAAAAAAAAAAAATTAGCCAGGTGTGGTGGTGGTGGATGCCTATAATCCCAGCTACTCGGGAGGCTGAGGCAGGAGAATCACTTGAACCTGGGAAGCAGAGGTTGCAATGAGCTGAGATTGAGCCATTGCACTCCAGCCTGGACAACAAGAATGAGACTCTGTCTCAATAAATAAGTAAATAAA","GGCCAGGCACGGTGGCTCATGCCTATAATCCCAGCACTTTGGGAGGCTGCGATGGGTGGTTCACTTGAGGTCTGGAGTTTGAGACCAGCCTGGCCAACATGGAGAAACCCTTTCTCTACTAAAAATACAAAAAAAAAAAAAAAAAAAATTAGCCAGGCATGGTGGCGGGTGCCTGTAATCCCAGCTACTCAGCAGGCTGAGGGAAGAGAATCACTTGAACCGGGGAGGCAGAGGTTGCAGTGAGCTGAGATGATGCCATTGCACTCCAGCCTGGGCAACAAGAGCAAAACTGTCTCAAAAAAAAAAAAA"
"chr18","53971096","53971710","JH378118","18053084","18053501","262","35918012","GGTCGGGTGTGGTGGCTCATGCCTATAATCCCAGCACTTTGGGAGGCTGAGGCAGGCAGATTACCTGAGGTCAGGAGTTCGAGACCAGCCTGGCCAACATGATGAAACCTTGTCTCTACTAAAAATACAAAAATTAGGCCGGGCACGGTGGCTCATGCCTGTAATCCCAGCACTTTGGGAGGCCGAGGCGGGTAGATCACAAGGTCAGAAGTTCAAGACCAGCCTGGCCAACATGGTGAAACTCTGTCTTTACTAAAAATACAAAAATTAGCTAGGCATGGTGGCGCACACCTATAATCCCAGCTACTGGGGAGGCTGAGGCAGGAGAATTGCTTGAACCAGGACCCGGGAGGTGGAGGTTGCTGTGAGCCGAGATTGCGCCACTGCACTCCAGCCTGGGAGACAGAGTGAGACTCCGTCTAAAAAAAAAAAAAAAAAATTAGCCAGGTGTGGTGGCGCATGCCTGTAATCCCAGCTACTCGGGAGGCTGACGCAGAAGAATCATTTGAACGTGGGAGGCAGAGGTTACAATGAGCTGAGATCACACCATTGTACTCCAGCCTGGGCAACAAGAGCAAACTCAATCTCAAAAAAATAAAAATAAAAAAAAAGAAA","GGCTGGGCGCAGTGGCTCACACCTGTAATCCCAGCACTTAGGGAAGCTGAGGCGAGTAGATCACCTGAGGTCAGGAGTTAGAGACCAGCCTGGCCATCATGGTGAAACCCCGTCTCTACTAAAGATACCAAAAATTAGCTGAGTGTGGTGCTGGGTGCCTGTAATCCCAGAAACTCAGGGTGCCTGTAATCCCAGCAACTCAGGGTGCCTTTAATCCCAGCAACTGAGGGTACCAGTAATCCCAGCAACTCAGGGTGTCTTTAATCCTAGCAACTGAGGGCACCTGTAATCCCAGCAACTCAGGAAGCTGAGACAGGAGAAGTACTTGAACCCAGAAGGCAGAGGTTGCAGTGAGCCGATATTGCACCATTGCACTCCAGTCTGGGCAACAAGAGTGAAACTCTGTCTCAAAAAAAAA"
"chr18","57837437","57837748","JH378115","16887097","16887400","43","40950340","GCTGGGCATGGTGGCTCACACCTGTAATCCCAGCACCTTGGGAGGCCGAGGTGGGTAGATCACCTGAGGTCAGGAATTCGAGACCAACCTGGCCAACATGGTGAAACCCCGTCTCTACTAAAAATACAAAAAAAAAAAAAAAAAAAAAAAAAGCTGGGCATGGTGGTGGGTACCTGTAATCCCAGCTACTCAGGAGTCCGAGGCAGGAGAATCGCTTGAACCTGGCAGGTGGAGGTTGCAGTGTGCCAGGATTGTGCCATTGCACTCCAGCCTGGGTGACAAGAGCAAAACTCCAACTCAAAACAAAAACAA","GCCGGGCACGGTGGCTCAAGCCTGTAATCCCAGCACTTTGGGAGGCCGAGGCGGGTGGATCACAAGGTCAAGAGATCGAGACCAACCTGGTCAACATGGTGAAACCCCATCTCTACTAAAAAATACAAAAAAAAAAAAAAAATTAGCTGGGCATGGTGGCGCGTGCCTATAATCCCAGCTACTCAGGAGGCTGAGGCAGGAGAATTGCCTGAACCTAGGAGGTGGAGGTTGCAGTGAGCCAAGATCATGCCATTGCACTCCAGCCTGGGTAACAAGAGCGAAACTCCATCTCAAAAAAAAAAAA"
"chr18","58257354","58257943","JH378118","18053084","18053501","263","40204270","GCCTGTAATCACAGCACTTAGGGGGGCCGAGGCAGGAGGATCACCTGAGGTCAGGAGTTCGAGACCAGCCTGGCCAACATGGTGAAACCCCGTCCCTACTAAAAATACAAAAATTGGCCGGACACATTGGCTCATGCCTGTAATCCCAGCACTTTGGGAGGCCGAGGCGGGTGGATCACCTGAGGTCAGGAGTTCAAGACCAGCCTGACCAACCTGGAGAAACCCTGTTTCTACTAAAAATACAAAATTAGCCAGGCATAGTGGCGCATGCCTGTAATCCCAGCTACTCGAGAGGCTGAGGCAGGAGAATCGCTTGAACCCGGAAGGTGGAGGTTGCGGTGAACCGAGATTGTGCCATTGCACTCCAGCCTGGGCAACAAGAGCAAAACTCCGTCTCAAAAACAAAACAAAACAAAACAAAAATTAACCCGGCGTGGAGGTGGATGCCTGTAATCCCAGCCACTTTGGGAGACTGAGGCAAGAGAATTGCTTGAACCCGGGATGTGGAGGCTGCAGTGACCCGAGATCACGCCATTGCATTCCAGCCTGGCAACAAGAGTAAGACTCCATCTCAAAAACAAGCAAACAAA","GGCTGGGCGCAGTGGCTCACACCTGTAATCCCAGCACTTAGGGAAGCTGAGGCGAGTAGATCACCTGAGGTCAGGAGTTAGAGACCAGCCTGGCCATCATGGTGAAACCCCGTCTCTACTAAAGATACCAAAAATTAGCTGAGTGTGGTGCTGGGTGCCTGTAATCCCAGAAACTCAGGGTGCCTGTAATCCCAGCAACTCAGGGTGCCTTTAATCCCAGCAACTGAGGGTACCAGTAATCCCAGCAACTCAGGGTGTCTTTAATCCTAGCAACTGAGGGCACCTGTAATCCCAGCAACTCAGGAAGCTGAGACAGGAGAAGTACTTGAACCCAGAAGGCAGAGGTTGCAGTGAGCCGATATTGCACCATTGCACTCCAGTCTGGGCAACAAGAGTGAAACTCTGTCTCAAAAAAAAA"
"chr18","59255477","59255805","JH378228","5665092","5665424","52","53590385","GGTTGGGCGCAGTGGCTCACGCCTGTAACCCCAGCACTTTCGGAAGCTGAGGCAGGCGGATCACCTGAGGTCAGGGGTTCGAGACCAGCCCGGACAACGTGATTAAACCCTGCCTCTACTAAAAATACAAAAATTAGCGACTGTGGTGTTGGGCGCCTGTAATCGCAGCTACTTGGGAGGCTGAGGCATGAGAATTGCTTGAACCCAGGAGGCAGAGGTTGCAGTGAGCAGAGATTGCTCCATTGCACTCCAGCCTGGGCAACAAGAGCAGAACTCTGTCTCAAAATAAATAAATAAATAAATAAATAAATAAATAACAGAAAAGAAAA","GGCCGGGCGCGGTGGCTCAAGCCTGTAATCCCAGCACTTTGGGAGGCTGAGGCGGGTGGATCACGAGGTCAAGAGATCGAGACCATCCTGGTCAACATGGTGAAACCCTGTCTCTACTAAAAATACTAAAAATTAGCTGGGCATGGTGGCGTGTGCCTGTAATCCCAGCTACTCAGGAGGCTGAGGCAGGAGAATTGCCTGAACCCAGGAGGCGGAGGTTGCGGTGAGCCGAGATCGCGCCATTGCACTCCAGCCTGGGCAACAAGAGCGAAACTCTGTCTCAAAAAAAAAAAATAAATAAATAAAATAAAATAAAATAAAATAAAATAAAAT"
"chr18","59405673","59406877","JH378118","18053084","18053501","805","41352589","GGCTAGATGCGGTGGCTCATGCCTGTAATCCCAGCACTTTGGGAGGCCAAGGCAGGTGGATCACCTGAGGTCAGGAGTTTGACACCAGCCTGGCCAACATGTTGAAACCCTGTCTCCACTAAAAATACAAAAAAAGATTATCTGGGTTATTGTGGGATCTGGCCAGCAGCCCGCAATGCAATGGGGCTCTCTCTTTGTTCCCAGGCAGATTGGCAGGTTGAGAAATAATAGACACACACAAGATAGTGAAAGTTGGGTCCAGGGGGGTCACCGCCTTCTGGTCCCATGGTGCCAACAATGCACTGGATATACCAGCATTTATTATTAAGTTTAGTGAGGGCGGGGGTAGGTTAGTGAGGGATTTAGGGTCATTTGATTATGAGGTGAGATGGTCACATGGAAATGAAGTAATTCTTTAACGTAACATTTGTATGTAGAAGTACAGTACATTTGTATGTAGAAGTACAGTATACAGAGATAAGAATTTACAATATAGTGTGTGCATCAGTAATTTCTAACAGAGCCTTAAAACAGAAAGACAATCTTTCCATAATCTATGATTAGCAAGATATTAATCAGCAGTAACAATTGCAATGAAAGCTGGTTACAAACAGTCCATGGAAACAGGAGGTGAAGCTAGACAATCGGTTAGACCAGAAATTCTCAGAAGGGAATATGCCTTAACCCTAAAGAGGCCTAGAAGAGCCGTGGCAAGATGAGGGTGTTTATAGCCCTATCTTATCCATATGGACAGGCACCTCCCCATGCGTCCGTTTATAGGCTCTCCATGAGGGTCGCATTCCATTCCCAGAGCTATGAACATCTGCTTTTCTGGGATAGGAATCTTGGTGATGTGAAACCTCCCTGACTACACGTCCATTCATAGGATCTCTGCAGGGGGAAGCACATCACACACTGTTGGCTCGTTCTGGCAGTCCAACCTGGCATTGTGTCTTTACACAATCCTGCATGCAATTTTGTATTTACAATAATCAGGAGCATTTCATCTTTTATTCTGTAGCAATAGTTTCAGGGGGTCTCCCTACACTGGGTGTGGTGACGGGTACCTGTAATCCCAGCTACTCAGGAGGCTGAGGCAGGAGAATCACTTGAGCCTTAGAGGCAGAGGTTGCAGTGAGCTGAGATCAGACCATTGCACTCCAGCCTGGGCAACAAGAGCAAACCTCCGTCTCAAAAAAAAAAAA","GGCTGGGCGCAGTGGCTCACACCTGTAATCCCAGCACTTAGGGAAGCTGAGGCGAGTAGATCACCTGAGGTCAGGAGTTAGAGACCAGCCTGGCCATCATGGTGAAACCCCGTCTCTACTAAAGATACCAAAAATTAGCTGAGTGTGGTGCTGGGTGCCTGTAATCCCAGAAACTCAGGGTGCCTGTAATCCCAGCAACTCAGGGTGCCTTTAATCCCAGCAACTGAGGGTACCAGTAATCCCAGCAACTCAGGGTGTCTTTAATCCTAGCAACTGAGGGCACCTGTAATCCCAGCAACTCAGGAAGCTGAGACAGGAGAAGTACTTGAACCCAGAAGGCAGAGGTTGCAGTGAGCCGATATTGCACCATTGCACTCCAGTCTGGGCAACAAGAGTGAAACTCTGTCTCAAAAAAAAA"
"chr18","71500430","71500770","JH378228","5665092","5665424","54","65835338","GCTGGGTGCGGTGGCTCACGCCTGTAATCACAGCACTTTGGTAAGCCCGAGGCAGGTGGATCACCTGAGGTCAGGAGTTCGAGACCAGCCTGACCAACATGGTGAAACCCTTTCTCTACTAAAAATGCAAAAATTAGCTGGGCGTCATGGCGGGCGTCTGTGATCCCAGCTACTAGGGAGGCTAAGGCAGGAGAATTGCTTGAACCTGGGAGGCGGAGGTTGCAGTGAGCAGAGATTGCACCATTACACTCCAGCCTGGGCAACAAGAGCAAAACTCCATCTCAAAATAAATAAATAACTAAATAAATAAATAAAATGAAATTAAAAAGAAAGAAAGAAAA","GGCCGGGCGCGGTGGCTCAAGCCTGTAATCCCAGCACTTTGGGAGGCTGAGGCGGGTGGATCACGAGGTCAAGAGATCGAGACCATCCTGGTCAACATGGTGAAACCCTGTCTCTACTAAAAATACTAAAAATTAGCTGGGCATGGTGGCGTGTGCCTGTAATCCCAGCTACTCAGGAGGCTGAGGCAGGAGAATTGCCTGAACCCAGGAGGCGGAGGTTGCGGTGAGCCGAGATCGCGCCATTGCACTCCAGCCTGGGCAACAAGAGCGAAACTCTGTCTCAAAAAAAAAAAATAAATAAATAAAATAAAATAAAATAAAATAAAATAAAAT"
"chr19","1465612","1466244","JH378118","18053084","18053501","284","16587472","GGCTGGGGACGGTGGCTCAGGCCTGTAACCCCAGCACTTTGAGAGGACCAGGAGGGAGGATTGCTTGAGCCCAGGAGTCCGAGACCAGCCTGGGCAGCAAAGCAAGGCCCTGTCTCTACAAAAATACTTTAAAATTAGCCAAGTGTTGGCTGGGTGCGGTTGCTCATGCCTATAATCCCAGCACTTTGGGAGGCCGAGGTGGGTGGATCACCTGAGGTCAGGAGTTTGAGACCAGCCTGGCCAACATGGCAAAACCCCGTCTCTACTAAAAATACGAAAATTAGCCAGACGTGGTGGCTCATTCCTGTAATCCCAGCTACTCGGGAGGCTGAGGCAGGAGAATCGCTTGAACTCGCAAGGCGGAGGTTGCAGTGAGCCAAGATCATGCCATTGCATTCCAGCCTGGGTGACAGAGCAAAACTCCGTCTCAAAAAAAAAAAAAAAAAAAAAAAATTAGCCAGGCGTGGTGGTGGGCACCTGTAGTCCCAGCTACCCGGGAGGCTGAGGCAGGAGAATCGCTTGAGCCCGGGAGGCAGAGGTTACAGTGAGCCGAGATCGTGCCATTGCACTCCAGCCTGGGCAACAAGAGTGAAAATCCGTCTCAAAAAAATAAATAAATACAAAATAAAAAAA","GGCTGGGCGCAGTGGCTCACACCTGTAATCCCAGCACTTAGGGAAGCTGAGGCGAGTAGATCACCTGAGGTCAGGAGTTAGAGACCAGCCTGGCCATCATGGTGAAACCCCGTCTCTACTAAAGATACCAAAAATTAGCTGAGTGTGGTGCTGGGTGCCTGTAATCCCAGAAACTCAGGGTGCCTGTAATCCCAGCAACTCAGGGTGCCTTTAATCCCAGCAACTGAGGGTACCAGTAATCCCAGCAACTCAGGGTGTCTTTAATCCTAGCAACTGAGGGCACCTGTAATCCCAGCAACTCAGGAAGCTGAGACAGGAGAAGTACTTGAACCCAGAAGGCAGAGGTTGCAGTGAGCCGATATTGCACCATTGCACTCCAGTCTGGGCAACAAGAGTGAAACTCTGTCTCAAAAAAAAA"
"chr19","1761610","1762212","JH378118","18053084","18053501","248","16291474","GGCCGGGTGCGGTGGTTTACACCTGTAATCCTGGCATTTTGGGAGGCCGAGGCAGGAGTATCACCTCAGGTCAGGAGTTCAAGACCAGCCTGGCCAACATGGTGATACTCCGTCTCTACTAAAAATACAAAAATTGGCCGAGTGCAGTGGCTCACACCTGTAATCCCAGCACTTTGGGAGGCCGAGGCAGGTGGATCATGAGGTCAGGAGTTCGAGACCAGCCTGGCCAAGATGGTGAAACCCCGTCTCTACTAAAAATACAAAAATCAGCTGGGTGTGGTGGCGGGTGCCTGTAATCCCAGCTACTCGGGAGGCTGAGGCAGGAGAATTGCTTGGACCTGGGCAGCAGAGGTTGCAGCGAGCTGAGATGGCGCCACTGCACTCCAGCCTGGGCGACAGAGCGAGACTCTTGTCTCAGAAAAATAAAAAATAAAAAAATTAGCTGGGTGTGGTGGTGCGCACCTGTAATCCCAGCTACTCGGGAGGCTGAGGCAGGAGAATCGCTTGAATCTGGGAGGAGGAGGAGGTTGCAGTGAGCTGAGATAGTGCCAGTGCAGGCCAGCCTGGTCAACAAGAGTGAAACTCCGTCTCAGAAAAAAAAAA","GGCTGGGCGCAGTGGCTCACACCTGTAATCCCAGCACTTAGGGAAGCTGAGGCGAGTAGATCACCTGAGGTCAGGAGTTAGAGACCAGCCTGGCCATCATGGTGAAACCCCGTCTCTACTAAAGATACCAAAAATTAGCTGAGTGTGGTGCTGGGTGCCTGTAATCCCAGAAACTCAGGGTGCCTGTAATCCCAGCAACTCAGGGTGCCTTTAATCCCAGCAACTGAGGGTACCAGTAATCCCAGCAACTCAGGGTGTCTTTAATCCTAGCAACTGAGGGCACCTGTAATCCCAGCAACTCAGGAAGCTGAGACAGGAGAAGTACTTGAACCCAGAAGGCAGAGGTTGCAGTGAGCCGATATTGCACCATTGCACTCCAGTCTGGGCAACAAGAGTGAAACTCTGTCTCAAAAAAAAA"
"chr19","2871458","2872098","JH378118","18053084","18053501","282","15181626","GGCCGGGCGCGGTGGCTCACGCTTGTAATCCCAGCACTTTGGGAGGCCTAGGTAGTGGATCACCTGAGGTCAGGAGTTTGAGACCAGCCTGGCCAACATGGGGAAACCCAGTCTCTACTAAAAATACAAAAATGAGGCCGGGTGCAGTGGCTCATGCCTGTAGTCTCAACACTTTGGGAGACCAAGGCAGGCGGATCACCTGAGGTCAGGAGTTCAAGCCCAACCTGGCCAACATGGTGAAACCCTGCCTCTTCTAAAAATACAAAAATTAGCCAGGTGTGGTGGCATGTACCTGCAATCCCAGCTGCTTAGGAGTTCGAGATAGAAGGATTGCCTGAACCTGGGAGGCGGAGGTTGCAGTGAGCTGAGATCATGCCATTGCACTCCAGCCTGGGTGACAGAGACCCTGTCTCACACACACACACACAAATTATATATATATATATATATATACACACACACACACACGCACACACAAATTGGCCAGGCGTGGTGGCGGGTGCCTATAATTCCAGCTACTTGGGAGGCTGAGGCAGGAGAATGTCTTGAACCCGGGAGGTGGAGGTTGCAGTGAGCCGAGATTGCGCCACTGCACTTTAGCCTGGACGACAAGAACAAAACTCCATCTCAAAAAAACGAAA","GGCTGGGCGCAGTGGCTCACACCTGTAATCCCAGCACTTAGGGAAGCTGAGGCGAGTAGATCACCTGAGGTCAGGAGTTAGAGACCAGCCTGGCCATCATGGTGAAACCCCGTCTCTACTAAAGATACCAAAAATTAGCTGAGTGTGGTGCTGGGTGCCTGTAATCCCAGAAACTCAGGGTGCCTGTAATCCCAGCAACTCAGGGTGCCTTTAATCCCAGCAACTGAGGGTACCAGTAATCCCAGCAACTCAGGGTGTCTTTAATCCTAGCAACTGAGGGCACCTGTAATCCCAGCAACTCAGGAAGCTGAGACAGGAGAAGTACTTGAACCCAGAAGGCAGAGGTTGCAGTGAGCCGATATTGCACCATTGCACTCCAGTCTGGGCAACAAGAGTGAAACTCTGTCTCAAAAAAAAA"
"chr19","2912949","2913566","JH378118","18053084","18053501","268","15140135","GGCTGGGCGTGGTGGCTCACACCTGTAATCCCAGCACTTTGGGAGGCCAAGGTGGAGGGACTGCCTGAAGCCAGGGGTTCGAGACCAGCCTGGCCAACATGGTGAAACCCTGTCTCTACTAAAAATAGAAAAATTAAGGCCGGGCGCGGTGGCTCATGCCTGTAATCCCAGCACTTTGGAAGGCCGAGGCGGGCGGATCACTTGAGGTCGGGAGTTCAAGACCAGCCTGACCAACATGGAGAAACCCTGTCTCTACTAAAAATACAAAATTAGCCAGGGTGGTGGCGCATGCCTGTAATCCCAGCTACTTGGGAGGCTGAGGCAGGAGAATCGCTTGAACCCGGGAGGTGGAGGTTGCAGTGAGCTGAGATCGCACCATTGCACTCCAGCCTGGGCAACAAGAGCAAAACCACGTCTCAAAAAAAATAAAAATAAAAATAAAAAAATTAGCTGGGTGTGGTGGCAGGCGCCTGTAGCTGCTTGGGAGGCTGAGACAGGAGAATTGCTTGAACCTGGGAGGCGGAGGTTGCAGTGAGCTGAGACCGTGCCATTGCACTCCAGGCTGGGCAAGAAGAGCAAAACTCTATCCTTCCCCCACTCCAAAAAAAAAAAAAAAAA","GGCTGGGCGCAGTGGCTCACACCTGTAATCCCAGCACTTAGGGAAGCTGAGGCGAGTAGATCACCTGAGGTCAGGAGTTAGAGACCAGCCTGGCCATCATGGTGAAACCCCGTCTCTACTAAAGATACCAAAAATTAGCTGAGTGTGGTGCTGGGTGCCTGTAATCCCAGAAACTCAGGGTGCCTGTAATCCCAGCAACTCAGGGTGCCTTTAATCCCAGCAACTGAGGGTACCAGTAATCCCAGCAACTCAGGGTGTCTTTAATCCTAGCAACTGAGGGCACCTGTAATCCCAGCAACTCAGGAAGCTGAGACAGGAGAAGTACTTGAACCCAGAAGGCAGAGGTTGCAGTGAGCCGATATTGCACCATTGCACTCCAGTCTGGGCAACAAGAGTGAAACTCTGTCTCAAAAAAAAA"
"chr19","3601333","3601668","JH378148","10302642","10302970","47","6701309","GCTGGGCGTGGTGGCTCACACCTGTAATCCCAGCACTTTGGGAGGCTGAGGTGGGCGGATCACGTGAGGTCAGGAGTTCCAGACTAGCCTGGCCAACATGGGGAAACCCCATCTCTGCTAAAAATAAAAAATTTAGCCGAGTGTGGTGGTGGGTGCCTGTAATCCCAGCTACTCAGGAGGCCGAGGCAGGAGAATTGCTTGAACCCAGGAGGCAGAGGTTGCAGTGAGCCGAGATCACGCCATTGCACTCCAGCCTGGATGACAACAGTGAGACTCCAACTCAAAAAATAATAATAATAATAATAATAATAATAAAATAAAACAATAAAAAAAAAA","GGCCGGGCGCGGTGGCTCAAGCCTGTAATCCCAGCACTTTGGGAGGCCGAGGCGGGTGGATCACGAGGTCAAGAGATCGAGACCATCCTGGTCAACATGGTGAAACCCCGTCTCTACTAAAAATACAAAAAATTAGCTGGGCATGGTGGTGGGTGCCTGTAATCCCAGCTACTCAGGAGGCTGAGGCAGGAGAATTGCCTGAACCCAGGAGGCGGAGGTTGCGGTGAGCCGAGATCGCGCCATTGCACTCCAGCCTGGGTAACAAGAGTGAAACTCTGCCTCAAAAAAAAAAAATAAAATAAAATAAAATAAAATAAAATAAAATAAAA"
"chr19","4440800","4441421","JH378118","18053084","18053501","276","13612284","GGCTGGGTGCGGTGGCTCATGCCTGTAATCCCAGCACTTTGGGAGGCCAAGCGGGCAGATCAACTGAGGTCAGGAGTTCGAGACCAGCCTGGCCAACATAGTAAAACCCTGTTTCTACTAAAAAAAAAAAAAAAAAAAAAAAAAAAATTGGCTGGGCGCAGTGGCTCACGCATGTAATCCCTGCACTTTGGGAGGCCAAGGCAGGTGGATCACCTGAGGTCAGTAGTTTGAGACCAGCCTGACCAACGTGGAGAAACCCCATCTCTACTAAAAATACAAACAAAAAAAACAAAAAACAAAAAAAACCGGGTATGGTGGTACATCCCTGTAATCCCAGCTCCTCGGGAGGCTGAGGCAGGAGAATCACTTGAACCCGGGAGGCGGAGGTTGCACTGAGCCGAGATTGCGCCACTGCACTCCAGCCTGGGCGATAGAGCGAGACTCCCTCTTAAATAATGATTATAATTGCCAGGTGTGGTGGCGGGTGCCTGTAATCCCAGCTACTTGGGAGGCTGAGGCAGGAGAATCGTTTGAATCCAGGAGGAGGAGGTTGCAGTGAGCCGAGATGGTGCCACAGCACTCCAGCCTGGGTGACAAGAGTGAAACCCCATTACAAACAAAA","GGCTGGGCGCAGTGGCTCACACCTGTAATCCCAGCACTTAGGGAAGCTGAGGCGAGTAGATCACCTGAGGTCAGGAGTTAGAGACCAGCCTGGCCATCATGGTGAAACCCCGTCTCTACTAAAGATACCAAAAATTAGCTGAGTGTGGTGCTGGGTGCCTGTAATCCCAGAAACTCAGGGTGCCTGTAATCCCAGCAACTCAGGGTGCCTTTAATCCCAGCAACTGAGGGTACCAGTAATCCCAGCAACTCAGGGTGTCTTTAATCCTAGCAACTGAGGGCACCTGTAATCCCAGCAACTCAGGAAGCTGAGACAGGAGAAGTACTTGAACCCAGAAGGCAGAGGTTGCAGTGAGCCGATATTGCACCATTGCACTCCAGTCTGGGCAACAAGAGTGAAACTCTGTCTCAAAAAAAAA"
"chr19","5462237","5462567","JH378255","1377129","1377437","56","4085108","GACCAGGTGCGGTGGCTCACGCCTGTCATTCCAGCACTTTGGGAGGCCGAGGGGGGCGTGGATCACTTGAGGTCAGGAGTTCAAGACCAGCCTGACCAACATGGTGAAACTCCGTCTCTACTAAAAATACAAAAATTAGCCAGGTGTGGTGGCACATGCCTGTAATCCCAGCTACTTGGGAGGCTGAGGCAGGAGAATCACTTGAACCTGGGAGATGGAGGTTTCATTCAGTGAGCTGAGATTGCACCATTGCACTCCAGCCTGGGTGACAAGAACGAAACTCTGTCTCAGAACACACACACACACACACACACACACACCCCAGAAAAAA","GGCCTGGCGTGGTGGCTCACGCCTGTAATCTCAGCACTTTGGGAGGCCAAGGTGGGTGGATCACCTGAGGTCAGGAGTTCAAGACCAGCCTGGCCAACATGGTGAAACCCCGTCTCTACTAAAAATACAAAAATTAGCTGGGTGTGGTGGCAGACACCTGTAATTCCAGCTACTTGGGAGGCTGAGGCAGGAGAATAGCTTGAACCTGGGAGGTGAGGGTTGCAGTGAGCCGAGATCGCACCATTTTACTCCAACCTGGGCAACAAGAGCGAAACTCCGTCTCAAAATCCAAACAAACCAAAACAAAAA"
"chr19","8011731","8012413","JH378118","18053084","18053501","321","10041353","GGCCGGGTACAGTGGCTCACTCCTGTAATCCCAGAACTTTGGGAGACCGAGGTGGGGGGATCACTTGAGGTCAGGAGTTCGAGACCACCCTGGCCAATATAGTGCTAAACCCCATCTCTACTCAAAATACAAAAAAAAAAAAAAAAAAAAAAAAAAAGCAAAACCCAGGCTGGGCACAGTAGCTCATACCTGTAATCCCAGCACTTTGGGAGGCTGAGGTGGGTAGATCATGAGGTCAGGAGTTCGAGACCAGCCTGACCAACATGGTGAAACCCCGTCTCTACTAAAAATACAAAAATTAGCCGGGCATGGTGGTGCGTGCCTGTAATCCCAGCTACTCAGGAGGCTGAGGCAGGAGAATCGCTTGAAGCTGGGAGGCAGAGGTTGCAGTGAGCCGAGATCGTGCTACTGTACTCCAGCCTGGGCAACAGGGCGACAGAGCAAGACTCTGTCTCAAAAAAAAAAAAAAAAAAAAAAAAAAGCAAAACCCCATCTCTACTAAAAATACAAAAAATTAGCCAGGCATGGTGGCATGTGCCTGTAATCCCAGCTACTCGAGAGGCTGAGGCAGAAGAATCACTTGAACCCAGGAGGCAGAGGTTGCAGCGAGCCAAGATTGTGCCATTGCACTCCAATCTGGGTGACAAGAGTAAAATCCTGTCTCAAAAAAATAAAAAATAAAA","GGCTGGGCGCAGTGGCTCACACCTGTAATCCCAGCACTTAGGGAAGCTGAGGCGAGTAGATCACCTGAGGTCAGGAGTTAGAGACCAGCCTGGCCATCATGGTGAAACCCCGTCTCTACTAAAGATACCAAAAATTAGCTGAGTGTGGTGCTGGGTGCCTGTAATCCCAGAAACTCAGGGTGCCTGTAATCCCAGCAACTCAGGGTGCCTTTAATCCCAGCAACTGAGGGTACCAGTAATCCCAGCAACTCAGGGTGTCTTTAATCCTAGCAACTGAGGGCACCTGTAATCCCAGCAACTCAGGAAGCTGAGACAGGAGAAGTACTTGAACCCAGAAGGCAGAGGTTGCAGTGAGCCGATATTGCACCATTGCACTCCAGTCTGGGCAACAAGAGTGAAACTCTGTCTCAAAAAAAAA"
"chr19","8026835","8027736","JH378118","18053084","18053501","522","10026249","GCGCGGTGGCTCATGCCTGTAAACCCAGCACTTTGGGAGGCTGAGGTGGGTGGATCACCTGAGGTCAGGAGTTTGAGACCAGCCTGGCCAATATGGTGAAACCCGTCTCTACTAAAACATACAAAAATTAGGCTGGGCGCGGTGGCTCATGCCTTTAATCCCAACACTTTGGGAGGCCGAGGCGGGCGGATCACGAGGTCAGGAGTTTGAGACCATCCTGGCTAACATGGTGAAAGCCCGTCTCTACTAAAAATATAAAAATTAGCTGGGCGTGGTGGTGGGCACCTGGAGTCCCAGCTACTTGGGAGGCTGAGGCAGGAGAATGGCGTGAACCCGGGAGGCGGAGCTTGCAGTGAGCCAGGATCACGCCACTGCACTCCAGCCTGGGCGACAGAGCGAGACACCGTCTCAAAAAAAAAACAACAAAAATTAGCCAGGCATGGTGGTGGGCGCCTTTTTTTTTTTTTTTTTCAGAGTCTCACTCTGTCACCCAGGCTGGAGTGCAGTGGCTCAATCTCGGTTCACTGCAACCTCCGCCTCCCAGGTTCAAGCGATTCTCCTGCCTCAGCCTCCCGAATAACTGGGATTACAGGCACCCGCCACTACAACCAGCTAATTTTTGTATTTTTAGTAGAGATGGGGTTTCGCCATGTTGGCCAGGATGGTCTTGATCTCTTGACCTCGTGATCCACCCTCCTTGGCCTCTCAAAGTGCTGGGATTACAGGTGTGAGCCACTGTTCCCAGCTGATAGTGGGCACTTTTAATCCCAGCTACTCCGGAGGCTGAGGCAGGAGAATTGCTTGAACCCAGGAGGTGGAGGTTGCAGTGAGCCAAGATCGCGCCATTGCACTCCAGCCTGGGTGACAATAGCAAAACTCTGTCTCAATGAAACAAAACAAAA","GGCTGGGCGCAGTGGCTCACACCTGTAATCCCAGCACTTAGGGAAGCTGAGGCGAGTAGATCACCTGAGGTCAGGAGTTAGAGACCAGCCTGGCCATCATGGTGAAACCCCGTCTCTACTAAAGATACCAAAAATTAGCTGAGTGTGGTGCTGGGTGCCTGTAATCCCAGAAACTCAGGGTGCCTGTAATCCCAGCAACTCAGGGTGCCTTTAATCCCAGCAACTGAGGGTACCAGTAATCCCAGCAACTCAGGGTGTCTTTAATCCTAGCAACTGAGGGCACCTGTAATCCCAGCAACTCAGGAAGCTGAGACAGGAGAAGTACTTGAACCCAGAAGGCAGAGGTTGCAGTGAGCCGATATTGCACCATTGCACTCCAGTCTGGGCAACAAGAGTGAAACTCTGTCTCAAAAAAAAA"
"chr19","9069244","9069863","JH378118","18053084","18053501","266","8983840","GGCCGGGCACGGTGGCTCATTCCTGTAGTCTCTGTACTTTAGGAGGCTGAGGTGGGTGGATCACTTGAGGTCAGGAGTTCCAGACCAGTCTGGCCAAAATGGTGAAACCCCGTCTGTACTAAAAATACAAAAAAAAAGGCCGGGCGCGGTGGCTCACGCCTGTAATCCCAGCACTTTGGGAGGCTGAGGTGGGTGGATCACAAGGTCAGGAGATTGAGACCATCCTGGCTAACATGGTGAAACCCCGTCTCTACTAAAAATACAAAAAATTAGCTGAGTGTGGTAGCAGGCACCTGTAATCCCAGCTACTCAGGAGGCTGAGGTGGGAGAATGGCATGAACCCAGGAAGCAGAGCTTGCAGTGAGCTGAGATCATGCCACTGCACTCCAGCCTGGGTGACAGAGCGAGACTCCATCTCAAAAAAAAAAAATACAAAAAAATTAGCCAGGCGTAGTGGTGCATGCTTGTAGTCTCGGCTACTCAGGAGACTGACGCAGGAGAATCACTTGAACCCAGGAGGCGGAGGTTGCAGTGAGCCGAAATTATGCCATTGCACTCCAGCCTGGGAGACAAGAACAAAACTCTATCTCAAAAACCAACCAACCAAACAAACAAAAAAA","GGCTGGGCGCAGTGGCTCACACCTGTAATCCCAGCACTTAGGGAAGCTGAGGCGAGTAGATCACCTGAGGTCAGGAGTTAGAGACCAGCCTGGCCATCATGGTGAAACCCCGTCTCTACTAAAGATACCAAAAATTAGCTGAGTGTGGTGCTGGGTGCCTGTAATCCCAGAAACTCAGGGTGCCTGTAATCCCAGCAACTCAGGGTGCCTTTAATCCCAGCAACTGAGGGTACCAGTAATCCCAGCAACTCAGGGTGTCTTTAATCCTAGCAACTGAGGGCACCTGTAATCCCAGCAACTCAGGAAGCTGAGACAGGAGAAGTACTTGAACCCAGAAGGCAGAGGTTGCAGTGAGCCGATATTGCACCATTGCACTCCAGTCTGGGCAACAAGAGTGAAACTCTGTCTCAAAAAAAAA"
"chr19","9785992","9786608","JH378118","18053084","18053501","261","8267092","GGCCGGGAACGGTGGCTCACACCTATAATCCCAGCACTTTGGGAGGCCGAGGCAGGTGGATCACCTGAGGTCAGGAGTTCAAGACCAGCGTGGCCAACATAATGAAACCCCATCTTGGCCGGGTGCGGTGACTCACGCCTGTAATCCCAGCACTTTGGGAGGCCAAGGCGGGTGGATCACGAGGTCAGGGGATCGAGACCATCCTGGCTAACACAGTGAAACCCTGTCTCTACTAAAAATACAAAAAAATTAGCTGGGCATGGTGGCGGACGCCTGTAGTCCCAGCTACTCGGGAGGCTGAGGCAGGAGAATGGTGTGAACCTGGGAGGCAGAGCTTGCAGTGAGCCGAGATTGCGCCACTGCACTCCAGCTTGGGTGACAAAGTGAGACTCCATCTCAAAAAAAAAAAAAGAAACCCCATCTCTACTAAAAATACAAAAAATTTGCTGGGTGTGGTTGTGGGCACCTGTAATCCCAGCTACTTGGGAGGCTGAGGCAGGAGAATCACCTGAACCCAGGAGGCAGAGGTTGCAGTGAGCCGAAACAGTGCCATTGCACTCCAGCCTGGGCAACAAGAGTGAAACTCAATCTCAAAAAAAAAAAAAAAAGTACAAAAA","GGCTGGGCGCAGTGGCTCACACCTGTAATCCCAGCACTTAGGGAAGCTGAGGCGAGTAGATCACCTGAGGTCAGGAGTTAGAGACCAGCCTGGCCATCATGGTGAAACCCCGTCTCTACTAAAGATACCAAAAATTAGCTGAGTGTGGTGCTGGGTGCCTGTAATCCCAGAAACTCAGGGTGCCTGTAATCCCAGCAACTCAGGGTGCCTTTAATCCCAGCAACTGAGGGTACCAGTAATCCCAGCAACTCAGGGTGTCTTTAATCCTAGCAACTGAGGGCACCTGTAATCCCAGCAACTCAGGAAGCTGAGACAGGAGAAGTACTTGAACCCAGAAGGCAGAGGTTGCAGTGAGCCGATATTGCACCATTGCACTCCAGTCTGGGCAACAAGAGTGAAACTCTGTCTCAAAAAAAAA"
"chr19","9897689","9898264","JH378206","6546474","6546861","233","3351215","GCCAGGCACGGTGGCTCACACCTGTAATCCCAGCACTTTGGGAGGCCAAGGTGGGTGGATCACCTGAGGTCAGGAGTTCAAGACCAGCCTGACCAACATGGTGAAACCCAGGGCTCACACCTGTAATCCCAGCGCTTTGGGAGGCTGACGCGGGCAGATCACGAGGTCAGGAGATCGAGACCATCCTGGCTAACATGGTGAAACCCCGTCTCTACTAAAAATACAATAATTAGCTGGGCATGGTGGTGGGTGCCTGCAGTCCCAGCTACTTGGGAAGCTGAGGCAGGAGAATGGCGTGAACCCAGGAGGTGGAGCTCTCAGTGAGCTGAGATTGCATCACTGCACTTCCAGCCTGGGTGACAGAGCAAGACTCTGTCTCAAAAAAAAAAAAAAAAAAAAAAAAAATTAGCCAGGTGTGATGGCAGGCACCTGTAATCCCAGCTACTTAGGAGGCTGAGGCAGGAGAACCCAGGAGGCAGAGGTTGCAGTGAGCCAAGATCGCGCCATTGCACTCCAGCCTGGGTGACAAGAGCAAAATTCCATCTCAAAAAAAAAAAAAAAGAAGAAAAAGAAGAA","GGCCACACATGGTGGCTAACGCCTGTAATCCCAGCACTTTGGGAGGCCAAGTCGGGTGGATCATGAGGTCAGGAGACCAAGACCATCCTGGCCAAATGGTGAAACCCCGTCTCTACTAAAAATACAAAAATTAGCTGGGCATGGTGGCGTGTGCCTGTAATCCCAGCTACTCAGGAGGCTGAGGCAGGACAATTGCCTGAACCCAGGAGAATTAGCTGGGCATGGTGGCGTGTGCCTGTAATCCCAGCTACTCAGGAGGCTGAGGCAGGACAATTGCCTGAACCCAGGAGGCGAAGGTTGCGGTGAGCCGAGATTGTGCCATTGCACTCCAGCCTGGGTAACAAGAGCGACACTCTGTCTCAAAAAAAAAAAAAAAAAAAAAAAAAAA"
"chr19","10210761","10211695","JH378118","18053084","18053501","553","7842323","GGCCGGGTGTGGTGGCTCATGCCTGTAATCCCAGGCATGATTTGGGAGGCCGAGGGAGGCAGATCACCTGAGGTCAGGAGTTTTTTTGTTTTGTTTTGTTTTGTTTTTGAGACAGAGTCTTGTTCTGTTGCCCAGGCTGGAGTGCAATGATGTGATCTCGACTCACTACAACCTCCACCTCCTGAGTTCAAGCGATTCTGCTGCCTCAGCCTCCCGAGTAGCTGGCATTACAGGCATGTGCCACCAAGCCTGGCTAATTTTTGTATTTATAGTAGAGACGGGGGTTTCACCATGTTGATCAGGCTGGTGTCGAACTCCTGGCCTCAAGTGATCCGCTCGCCTTGGCCTCCCAAAATGCTGGGATTACAGATGTGAGCCACTGTGCCCAGCCAAGGTCAAGAGTTTGAAACCAGCCTGGCCAGCATGGTGAAACCCTATCTCTACTAAAAATACAAAATCAGTCCATGTGCCTAATTTTGGGATCACACCTGGGATCATGCCTGCAATCCCAGCACTTTGGGAGGCCAAGGCGGGTGGGTCATGAAGTCAGGAGTTCAAGACCAGCCTGGCCAACATGGTGAAACCCTGTCTCTACTAAAAATACAAAAGTTAGCTGGGCGTGGTGGCACGCACCTGTAGTCCCAGCTACTAGGAAGGCTGAGGCAGGAGAATTCTTGAACCCGGGTGATGGAGGTTGCAGTGAGCCGAGATTGCGCCACTGCACTCCAGCCTGGGCAACAGAGTGAGACTCTGTCTAAAAAAAAAATTAGTCAGGCGTGGTGGTGAGCACCTGTAATCACAGCTACTGGGGAGGCTGAGGCTGGAGAATTGCTTGAACCCGGGAGGCGGAGGTTGCAGTGAGCCAAGATCGCGCCTTTGCACTCCAGCCTGGGCAACAGGAGTGAAACTGCATCTCAAAAAAAAAAAAAAAAAAA","GGCTGGGCGCAGTGGCTCACACCTGTAATCCCAGCACTTAGGGAAGCTGAGGCGAGTAGATCACCTGAGGTCAGGAGTTAGAGACCAGCCTGGCCATCATGGTGAAACCCCGTCTCTACTAAAGATACCAAAAATTAGCTGAGTGTGGTGCTGGGTGCCTGTAATCCCAGAAACTCAGGGTGCCTGTAATCCCAGCAACTCAGGGTGCCTTTAATCCCAGCAACTGAGGGTACCAGTAATCCCAGCAACTCAGGGTGTCTTTAATCCTAGCAACTGAGGGCACCTGTAATCCCAGCAACTCAGGAAGCTGAGACAGGAGAAGTACTTGAACCCAGAAGGCAGAGGTTGCAGTGAGCCGATATTGCACCATTGCACTCCAGTCTGGGCAACAAGAGTGAAACTCTGTCTCAAAAAAAAA"
"chr19","10485431","10486007","JH378118","18053084","18053501","237","7567653","GGCCGGGCGCAGTGGCTCATGCCTAATCCCAAGACTTTCAGAGGCTGAGGCAGGTGGATCACCTGAGGTCAGGAGCTCAAGACCAGCCTGGCTAACATTGTGAAACCGCGTCTCTACTAAAAATCAAAATTGGCCGGGCACGGTGGCTCACACCTGTAATCCCATCCCTCTGGGAGACCGAGGCGGGCAGATCACCTAAGGTCAGGAGTTCGAGACCAGCCTGACCAACATGGAGAAAACCCTTCTCTGCTAAAAATACAAAATTAGCCGGGCGTGGTGGCGCATGCCTGTAACCTCAGCTACTCGGGAGGCTGAGGGAAAATCGCTTGAACCTGCCAGGTGGAGGTTGCAGTGAGCCGAGATCGAGCCATTGCACTCCAGCATGGGCAACGAAAGCGAAACTCCATCTCAAAAAAAAAAAAAATTAGCTAGGCGTGGTGGCGCGTGCCTGTATTCCCAGCTACTCAGGAGGCTGAGACAGGAGAATCACTTGAACCTGGGAGGCAGAGGTTGCAGTGAGCCAAGATTGCACCATTGCACTCCAGCCTGGGCAACACGAGCAAAACTCTGTCTCAAA","GGCTGGGCGCAGTGGCTCACACCTGTAATCCCAGCACTTAGGGAAGCTGAGGCGAGTAGATCACCTGAGGTCAGGAGTTAGAGACCAGCCTGGCCATCATGGTGAAACCCCGTCTCTACTAAAGATACCAAAAATTAGCTGAGTGTGGTGCTGGGTGCCTGTAATCCCAGAAACTCAGGGTGCCTGTAATCCCAGCAACTCAGGGTGCCTTTAATCCCAGCAACTGAGGGTACCAGTAATCCCAGCAACTCAGGGTGTCTTTAATCCTAGCAACTGAGGGCACCTGTAATCCCAGCAACTCAGGAAGCTGAGACAGGAGAAGTACTTGAACCCAGAAGGCAGAGGTTGCAGTGAGCCGATATTGCACCATTGCACTCCAGTCTGGGCAACAAGAGTGAAACTCTGTCTCAAAAAAAAA"
"chr19","10538873","10539199","JH378118","15020968","15021286","46","4482095","GCTGGGCGCGGTGGCTCACGCCTGTAATCCCAGCACTTTGGGAGGCTGAGGCAGGCAGATCACCTGAGGTCAGGAGTTCAAGACCAGCCTGGTTAACACAGTGAAACCCCCGTCTCTACTAAAAATACAAAAACAAAAATTAGCCGGGTGTGGTGGCGGGCGCCTGTAATCCCAGTTACTCGGGAGGCTGAGGCAGGAGAATCGCTTGAACCCGGGAGGCGGAGGTTGTGGTGAGCCGAGATTGCCATTGCACTCCAGCCTGGGCAAAAAGAGCGAAACTCCATCTAAAACAAACAAACAAACAAACAAACAAAAAATAGAAAAGAA","GCCGGGCGCGGTGGCTCAAGCCTGTAATCCCAGCACTTTGGGAGGCTGAGGCGGGTGGATCCCGAGGTCAAGAGATCGAGACCATCCTGGTCAACATGGTGAAACCCCGTCTCTACTAAAAATACAAAACATTAGCTGGGTATGGTGGCGCGTGCCTGTAATCCCAGCTACTCAGGAGGCTGAGGCAGGAGAATTGCCTGAACCCAGGAGGCGGAGGTTGCGGTGAGCTGAGATCGCGCCATTGCACTCCAGCCTGGGTAACAAGAGCGAAACTTCCATCTCAAAAACAAACAAACAAACAAACAAACAAAAAACAAAC"
"chr19","10973032","10973651","JH378118","18053084","18053501","265","7080052","GGCTGGACGTGGTGGCTCACGCCTGTAATCCCAACACTTTGGGAGACCAAGGCAGGTGGATCGCCTGAGGTTAGGGGTTCGAGACCAGCCTGACCAACATGGTGAAACCCCATCTCTACTAATAATAAAAAAATTAGGACCAGGCTTGGTGGCTCATGCCTGTAATTCCAACACTTTGGGAGGCCAAGGCGAGTGGATAACTTGAGGTCAGGAGTTTGAGACCAGCCTGGCCAACATGGTGAAACCTCATCTCTACTAAAAATACAAAAATTAGCCGGCATGGTGGCGGGCACCCGTAATCCCAGCTACTCGGTGTGGGGGCTGGGACAGGAGAATCGCTTGAACCCAGGAGGTGGAGGTTGCCGTGAGCTAAGATTGCGCCACTGCACTCTAGTTGGGGCAACAGAGCGGACTCCGTCTCAAAAAAAAAAAAAAAATTAGCCGAGCGTGGTGGTGGACACCTGTAATCCCAGCTACTCAGGAGGCTGAGGCAGGAAAATTGAAATCGCTTAAACCTGGGAGGAGGAGGTTGCAGTGAGCCAAGATCGCACCATTGCACTCCAGCCTGGGCGACAAGAACAAAACTCCGTCTCCCCACTCCAAAAAAAAAAAAAAAAAAA","GGCTGGGCGCAGTGGCTCACACCTGTAATCCCAGCACTTAGGGAAGCTGAGGCGAGTAGATCACCTGAGGTCAGGAGTTAGAGACCAGCCTGGCCATCATGGTGAAACCCCGTCTCTACTAAAGATACCAAAAATTAGCTGAGTGTGGTGCTGGGTGCCTGTAATCCCAGAAACTCAGGGTGCCTGTAATCCCAGCAACTCAGGGTGCCTTTAATCCCAGCAACTGAGGGTACCAGTAATCCCAGCAACTCAGGGTGTCTTTAATCCTAGCAACTGAGGGCACCTGTAATCCCAGCAACTCAGGAAGCTGAGACAGGAGAAGTACTTGAACCCAGAAGGCAGAGGTTGCAGTGAGCCGATATTGCACCATTGCACTCCAGTCTGGGCAACAAGAGTGAAACTCTGTCTCAAAAAAAAA"
"chr19","11513769","11514351","JH378206","6546474","6546861","242","4967295","TCCCAGCACTTTGGGAGGCCGCGATGGGTGGATCACCTTAGGTCAGGAATTCGAGACCATCCTGGCCAACATGGTGAAACCCCGTCTCTACTAAAAACACAAAAATTAGGCCGGGCACGGTGGCTCACATCTGTAATCCCAGCACTTTGGGAGGCTGAGGTGGGCGGATCACAAGGTCAGGAGTTCAAGACCAGCCTGGCCAACATGGTGAAACCCTGTCTCTACTAAAAATACAAAAATTAACTGGGCATGGTGGCATGTGCCTGTAATCCCAGCTACTTGGGAGGCTGAGGCAGAAGAATTGCTTGAACCAGGGAGTCAGAGGTTATAGTGAGCTGAGATCGTGCGACTGCACTCCAGCCTGGTGACAGAGCGAGACTCCGTTTCAGGAAAAACAAACAAAACACAAAAATTAGCTGGGCATGGTGGCAGGCGCCTGTAATCCTAGCTACTTGGGAGGCTGAGGCAGGAGAATCGCTTGAACCCAGAAGGCAAAGGTTGCAGTGAGCTGAGATGATGCCATTGCACTCCAGCCTGGGCAACAAGTGAAACTCTGTCTCAAGAAAAAAAGTAAAAGAAAGAA","GGCCACACATGGTGGCTAACGCCTGTAATCCCAGCACTTTGGGAGGCCAAGTCGGGTGGATCATGAGGTCAGGAGACCAAGACCATCCTGGCCAAATGGTGAAACCCCGTCTCTACTAAAAATACAAAAATTAGCTGGGCATGGTGGCGTGTGCCTGTAATCCCAGCTACTCAGGAGGCTGAGGCAGGACAATTGCCTGAACCCAGGAGAATTAGCTGGGCATGGTGGCGTGTGCCTGTAATCCCAGCTACTCAGGAGGCTGAGGCAGGACAATTGCCTGAACCCAGGAGGCGAAGGTTGCGGTGAGCCGAGATTGTGCCATTGCACTCCAGCCTGGGTAACAAGAGCGACACTCTGTCTCAAAAAAAAAAAAAAAAAAAAAAAAAAA"
"chr19","11535200","11535780","JH378206","6546474","6546861","242","4988726","TCCCAGCACTTTGGGAGGCCGCGATGGGTGGATCACCTTAGGTCAGGAATTCGAGACCATCCTGGCCAACATGGTGAAACCCCGTCTCTACTAAAAACACAAAAATTAGGCCGGGCACGGTGGCTCACATTGTAATCCCAGCACTTTGGGAGGCTGAGGTGGGCGGATCACAAGGTCAGGAGTTCAAGACCAGCCTGGCCAACATGGTGAAACCCTGTCTCTACTAAAAATACAAAAATTAACTGGGCATGGTGGCATGTGCCTGTAATCCCAGCTACTTGGGAGGCTGAGGCAGAAGAATTGCTTGAACCAGGGAGTCAGAGGTTATAGTGAGCTGAGATCGTGCGACTGCACTCCAGCCTGGTGACAGAGCGAGACTCCGTTTCAGGAAAAACAAACAAAACACAAAAATTAGCTGGCATGGTGGCAGGCGCCTGTAATCCTAGCTACTTGGAGGCTGAGGCAGGAGAATCGCTTGAAACCCAGAAGGCAAAGGTTGCAGTGAGCTGAGATGATGCCATTGCACTCCAGCCTGGGCAACAAGTGAAACTCTGTCTCAAGAAAAAAAGTAAAAGAAAGAA","GGCCACACATGGTGGCTAACGCCTGTAATCCCAGCACTTTGGGAGGCCAAGTCGGGTGGATCATGAGGTCAGGAGACCAAGACCATCCTGGCCAAATGGTGAAACCCCGTCTCTACTAAAAATACAAAAATTAGCTGGGCATGGTGGCGTGTGCCTGTAATCCCAGCTACTCAGGAGGCTGAGGCAGGACAATTGCCTGAACCCAGGAGAATTAGCTGGGCATGGTGGCGTGTGCCTGTAATCCCAGCTACTCAGGAGGCTGAGGCAGGACAATTGCCTGAACCCAGGAGGCGAAGGTTGCGGTGAGCCGAGATTGTGCCATTGCACTCCAGCCTGGGTAACAAGAGCGACACTCTGTCTCAAAAAAAAAAAAAAAAAAAAAAAAAAA"
"chr19","12911527","12912140","JH378118","18053084","18053501","266","5141557","GGCCAGGCATGGTGGCTCATGCCTGTAATCCAGCACTTTGGTAGGCCAAGGTGGGTGGATGGATTACTTGAGGCCAGGAGTTCAAGACCAACCTGGCCAACATGGTGAAAACCCATCTCTATTAAAAATATAAAAGCTAGGCCAGGTGCGGTGGCTCACGCCTGTAATCCCAGCACTTTGGGAGGCTGAGGCGGGCGGATCACGAGGTCAGGAGATCGAGACCACTGTGAAACCCTGTCTCTACTAAAAATACAAAAAAAATTAGCTGGGTGGGGTGGCGGGTGCCTGTAGTCCCAGCTACTTGGGAGGCTGAGGCAGGAGAATGGCGTGAACCCGGGAGGCGGAGCTTGCAGTGAGCCGAGATCGCGCCACTGCACTCCAGCCTGGGCTACAGAGCAAGACTCCGTCTCAAAAAAAAAATAAATAAATAAATAAAAATAAAAACTAACTGGGCATGGTGGTGTGCACCTGTAATCCCAGCTACTCGGGAGGCTGAGACAGGAGAATTGCTTGAACCTGGGAGGTGGAGGTTGCAGTGAACCAAGATGATGCCATTGCACTCCAACCTGGGCAACAAGAGCAAAACTCCGTCTCAAAAAAAAAAAAAAAAAAAA","GGCTGGGCGCAGTGGCTCACACCTGTAATCCCAGCACTTAGGGAAGCTGAGGCGAGTAGATCACCTGAGGTCAGGAGTTAGAGACCAGCCTGGCCATCATGGTGAAACCCCGTCTCTACTAAAGATACCAAAAATTAGCTGAGTGTGGTGCTGGGTGCCTGTAATCCCAGAAACTCAGGGTGCCTGTAATCCCAGCAACTCAGGGTGCCTTTAATCCCAGCAACTGAGGGTACCAGTAATCCCAGCAACTCAGGGTGTCTTTAATCCTAGCAACTGAGGGCACCTGTAATCCCAGCAACTCAGGAAGCTGAGACAGGAGAAGTACTTGAACCCAGAAGGCAGAGGTTGCAGTGAGCCGATATTGCACCATTGCACTCCAGTCTGGGCAACAAGAGTGAAACTCTGTCTCAAAAAAAAA"
"chr19","13205284","13205895","JH378118","18053084","18053501","258","4847800","GCCAGGCGCAGTGGATTACGCCTGTAATCCCAGCGCTTTGGTATACCGAGGCGGGCAGATCGTCTGAGGTCAGGAGTTCAAGACCAGCCTGGAGAACATGGTGAAACCCCGTCTCTATTAAAAATACAGGCTGGGCGCGGTGGCTTACGCCTGTAATCTCAGCACTTTGGGAGGCCAAGGCGGGTGGATCACGAGGTCAGGAGATCGAGACCATCCTGGCTAACATGGTGAAACCCTGTCTCTACTGAAAATACAAAAAAATTAGTTGTGGTGGGTGCCTGTAATCCCAGCTACTCGGGAGGCTGAGGCAGGAGAATGGCGTGAACCCGGGAAGCAGAGATTGCAGTAAGCCAAGATCGCTCCACTGCACTCCAGCCTGGGCTACAGAGCAAGACTCCATCTCAAAAAAAAATAAATAAATAAAATAAAAAATTAGCCTGGCGTGGTGGCGCATGCCTGTAATCCCAGCTACTTGGGAGGCTGAGGCAGGAGAATTGCTTGAACCCAAGAGGTGGAGGTTGCAGTGAGTCGAGATTGAGCCATTGCCATCCAGCCTGGGCAACAAGAGTGAAACTCTGTCTCAAAAAAAAAGAGAGAGAAAAGAAAGTAAAA","GGCTGGGCGCAGTGGCTCACACCTGTAATCCCAGCACTTAGGGAAGCTGAGGCGAGTAGATCACCTGAGGTCAGGAGTTAGAGACCAGCCTGGCCATCATGGTGAAACCCCGTCTCTACTAAAGATACCAAAAATTAGCTGAGTGTGGTGCTGGGTGCCTGTAATCCCAGAAACTCAGGGTGCCTGTAATCCCAGCAACTCAGGGTGCCTTTAATCCCAGCAACTGAGGGTACCAGTAATCCCAGCAACTCAGGGTGTCTTTAATCCTAGCAACTGAGGGCACCTGTAATCCCAGCAACTCAGGAAGCTGAGACAGGAGAAGTACTTGAACCCAGAAGGCAGAGGTTGCAGTGAGCCGATATTGCACCATTGCACTCCAGTCTGGGCAACAAGAGTGAAACTCTGTCTCAAAAAAAAA"
"chr19","14119695","14120238","JH378206","6546474","6546861","206","7573221","ACCAGCCTGGCCAAAATGGTGAAACCCTGTCTCTACTAAAAATATTTAAAAATTGGCCAGGTGCGGTGGCTCACGCCTGTAATCCCAGCACTTTGGGAGGCCGAGGCGGGCGGATTACAAGGTCAGGAGATCGAGACCATCCTGACTAACATGGTGAAACCCCGTCTCTACTAAAAATACAAAAAATTGGCCGGGCGTGGTAGCGGGCGCCTGTAGTTCCAGCTACTCGGGAGGCTGAGGCAGGAGAATGGCGTGAACCCGGAAGGCAGAGCTTGCAGTGAGCCAAGATCGTGCCACTGCACTCCAGCCTGAGCGACAGAGCAAGACTCCATCTCAAAAAAAAAAAAAAAAAAAAAAAAAATTAAAAAATTAGCTGGGCGTGGTAGCCGGCACCTGTAATTCCAGCTACTCAGGAGGCTGGAGCACAAGAATCGCTTGAAACCAGGAGGCAGAGTTGTAGTGAGCCGAGATCGTGCCATTGCACTCCAGCCTGGGCATCAAGAGCGAAACTCCATCTCAAAAACAAAACAAAACAAAACAAAAA","GGCCACACATGGTGGCTAACGCCTGTAATCCCAGCACTTTGGGAGGCCAAGTCGGGTGGATCATGAGGTCAGGAGACCAAGACCATCCTGGCCAAATGGTGAAACCCCGTCTCTACTAAAAATACAAAAATTAGCTGGGCATGGTGGCGTGTGCCTGTAATCCCAGCTACTCAGGAGGCTGAGGCAGGACAATTGCCTGAACCCAGGAGAATTAGCTGGGCATGGTGGCGTGTGCCTGTAATCCCAGCTACTCAGGAGGCTGAGGCAGGACAATTGCCTGAACCCAGGAGGCGAAGGTTGCGGTGAGCCGAGATTGTGCCATTGCACTCCAGCCTGGGTAACAAGAGCGACACTCTGTCTCAAAAAAAAAAAAAAAAAAAAAAAAAAA"
"chr14","584088","584429","JH378109","21565230","21565567","54","20981142","GGCCGGGTACGGTGGCTCACGCCTGTAGTCCTGGCACTTTGGGAGGCCGAGGCAGGTGGATCCCCGAGGTCACGAGTTTGAGACCAGCCTGGCCAGCATGGTGAAATCCCATCTCTACTAAAAATACAAAACTTAGCCGGGCATGGTGACGTGTGCCTGTAATCCCAGCTACTTGGGAGGCTGAGGCAGGAGAATTGCTTGAACCAGGGAGGCAGAGGTTGCAGTGAGCTGAGATCATGAAACTGCAGTCCAGTCTAGGCGACAAGAGCAAAACTCCGTCTCAAAAAAATAAATAAATAAATAAATAAATAAAAAATAAAACAAACAACAAAAAAAACAAAA","GGCCGGGCGCGGTGGCTCAAGCCTGTAATACCAGCACTTTGGGAGGCCGAGGCGGGTGGATCACGAGGTCAAGAGATCGAGACCATCCTGGTCAACATGGTGAAACCCCGTCTCTACTAAAAATACAAACAATTAGCTGGGCATGGTGGCGGGTGCCTGTAATCCCAGCTACTCCAGAGGCTGAGGCAGGAGAATTGCCTGAACCCAGGAGACGGAGGTTGCGGTGAGCCAAGATCGCGCCATTGCACTCCAGCCTGGGTGACAAGAGCGAAACTCCGTCTCAATAAATAAATAAATAAATAAATAAATAAAAATAAAATAAATAAATAAATAAATAA"
"chr14","620575","620915","JH378109","21565230","21565567","56","20944655","GGCCGGGTACGGTGGCTCACGCCTGTAGTCCTGGCACTTTGGGAGGCCGAGGCAGGTGGATCCCCGAGGTCACGAGTTTGAGACCAGCCTGGCCAGCATGGTGAAATCCCATCTCTACTAAAAATACAAAACTTAGCCGGGCATGGTGACGTGTGCCTGTAATCCAGCTAACTTGGGAGGCTGAGGCAGGAGAATTGCTTGAACCAGGGAGGCAGAGGTTGCAGTGAGCTGAGATCATGAAACTGCAGTCCAGTCTAGGCGACAAGAGCAAAACTCCGTCTCAAAAAATAAATAAATAAATAAATAAATAAAAAATAAAACAAACAACAAACAAAACAAAA","GGCCGGGCGCGGTGGCTCAAGCCTGTAATACCAGCACTTTGGGAGGCCGAGGCGGGTGGATCACGAGGTCAAGAGATCGAGACCATCCTGGTCAACATGGTGAAACCCCGTCTCTACTAAAAATACAAACAATTAGCTGGGCATGGTGGCGGGTGCCTGTAATCCCAGCTACTCCAGAGGCTGAGGCAGGAGAATTGCCTGAACCCAGGAGACGGAGGTTGCGGTGAGCCAAGATCGCGCCATTGCACTCCAGCCTGGGTGACAAGAGCGAAACTCCGTCTCAATAAATAAATAAATAAATAAATAAATAAAAATAAAATAAATAAATAAATAAATAA"
"chr14","1107083","1107723","JH378118","18053084","18053501","303","16946001","GGCGTGGTGGCTCACACCTGTAATCCCAGCACTTCAGGAGGCCAAGGCAGGTAGATTGCTTGATCACAGGAGTTCAAACCAGCCATGGGCAATGTCAGGCCTCTGAGCCCAAGCTTGCACGTATCCAGATGGCCTGAAGCAACTGAAGAATCACAAAAGAAGTGAAAACAGCCAGTTCCTTCCTTAACTGATGACATTACCTTGTGAAATTCCTTCTCCTGGCTCAGAAGCTCCCCTACTGAGCACCTTGTGACCCCTGCCCCTGCCAGCCAGAGAACAATCCCCTTTGACTGTAATTTTCCACTACCTACCCAAATCCTATAAAACAGCCCCACCCCATCTCCCTTTGCTGACTCCTTTTTCGGACTAGGTCCGCCTGCACCCAGGTGATTAAAAAGCTTTATTGCTCACACAAAGCCTGTTGGTGGTCTCTTCACACGGACGCACGTGACAGGCAACATGGTGAAACCCTATCTCTATAAAAAAATAAAAATAAAAATTAGTTGGGCGTGGAGACTGAGGTGAGAGAATCCAGAGGATCCAAGAGGATCGAGTCAAGGAGGTGGAGGCCGCAGTGAGCCGAGATCGCACCGCTGCACTCCAGCCTGGGCGACAAGAGTGAAACTCTGTCTTAAAAAAAA","GGCTGGGCGCAGTGGCTCACACCTGTAATCCCAGCACTTAGGGAAGCTGAGGCGAGTAGATCACCTGAGGTCAGGAGTTAGAGACCAGCCTGGCCATCATGGTGAAACCCCGTCTCTACTAAAGATACCAAAAATTAGCTGAGTGTGGTGCTGGGTGCCTGTAATCCCAGAAACTCAGGGTGCCTGTAATCCCAGCAACTCAGGGTGCCTTTAATCCCAGCAACTGAGGGTACCAGTAATCCCAGCAACTCAGGGTGTCTTTAATCCTAGCAACTGAGGGCACCTGTAATCCCAGCAACTCAGGAAGCTGAGACAGGAGAAGTACTTGAACCCAGAAGGCAGAGGTTGCAGTGAGCCGATATTGCACCATTGCACTCCAGTCTGGGCAACAAGAGTGAAACTCTGTCTCAAAAAAAAA"
"chr14","1362660","1363231","JH378118","18053084","18053501","229","16690424","GGCTGGGCACAGTGGCTTATACCCATAATCTCAGCAGTTTGGGAGGCCAAGGCAGGTGTATCACCTGAGGTCAGGAGTTCGAGAAACACCATGGCCAACATGGTGAAACCCCATCTCTACTAAAAATACAAAAAGTAGGCTGGGCGTGGTGGCTCACGCCTGTAATCCCAGTACTTTGGGAGGCCGAGGCGGGCGGATCACAAGGTCAGGAAACCGAGACCATCCTGACTAACATGGTGAAACCCCGTCTCTACTAAAAATACAAAAAAAGCTAGCCGGGCATGGTGGCGGGTGCCTGTAGTCCCAGCTACTCGGGAGGCTGAGGCAGGAGAATGGCGTGACCCCAGGAGGCAGAGCTTCCAGCTTGGGTGACTCCGTCTCAAAAAAAAAAAAACAAAAACAAAAAGTAGCTGGACGTGGTGGCTGTAGACCTAGCTACTCGAGAGGCTGAGGCAGGAGAATCGCTTGAACCTAGGAGGCGGAGGTTGCGGTGAGCCGAGATCACGCTTCTGCACTCCAGCCTGGGTGACAAGAGCAAAACTCCATCTCCAAAAAAAAAAAACAAAAAAAAA","GGCTGGGCGCAGTGGCTCACACCTGTAATCCCAGCACTTAGGGAAGCTGAGGCGAGTAGATCACCTGAGGTCAGGAGTTAGAGACCAGCCTGGCCATCATGGTGAAACCCCGTCTCTACTAAAGATACCAAAAATTAGCTGAGTGTGGTGCTGGGTGCCTGTAATCCCAGAAACTCAGGGTGCCTGTAATCCCAGCAACTCAGGGTGCCTTTAATCCCAGCAACTGAGGGTACCAGTAATCCCAGCAACTCAGGGTGTCTTTAATCCTAGCAACTGAGGGCACCTGTAATCCCAGCAACTCAGGAAGCTGAGACAGGAGAAGTACTTGAACCCAGAAGGCAGAGGTTGCAGTGAGCCGATATTGCACCATTGCACTCCAGTCTGGGCAACAAGAGTGAAACTCTGTCTCAAAAAAAAA"
"chr14","2088506","2089110","JH378118","18053084","18053501","257","15964578","GGCTGGGCACTGCGGCTCACACCTGTAATCCCAGCATTTTGAGAGGCCTAGGTGGGTGGATCACCTGAGATCAGTTCAAGACCAGCCTGACCAACATGGCAAAACCCCATCTCTATTAAAAACACAAAAAACGCCCAGGAGCGGTGGCTCACACCTGTAATCCCGGCACTTTGGGAGGCTGAGGCAGGCGGATCACGAGGTCAGGAGATCGAGACCATGCTGGCTAACACGGTGAAACCCCGTCTCTACTAAAAATACAAAAAATTAGCCAGGCGTGGTGTCGGGCGCCTGTAGTCCCAGCTATTCGGGAGGCTGAGACAGGAGAATGGCATGAACCCGGGAGGCAGAGCTTGCAGTGAGCTGAGATCGCGCCACTGCACTCCAGCCTGGGCGACAGAGTAAGACTCTGTCTCAAAAAAAAAAATACAAAAAATACAAAAAACATTAGCCACATGTGGTGGTGGGTGCCTGTAATCCCAGCTACTCAGGAGGCTGAGGCTGGAGAATTGCTTGAACCCAGGAGGTGGAGGTTGTGGTGAGCCAAGATCACGCCATTGCATTCCAGCCTGGGTGACAAGAGTGAACCTCTGTCTCAAAAAAAAGAA","GGCTGGGCGCAGTGGCTCACACCTGTAATCCCAGCACTTAGGGAAGCTGAGGCGAGTAGATCACCTGAGGTCAGGAGTTAGAGACCAGCCTGGCCATCATGGTGAAACCCCGTCTCTACTAAAGATACCAAAAATTAGCTGAGTGTGGTGCTGGGTGCCTGTAATCCCAGAAACTCAGGGTGCCTGTAATCCCAGCAACTCAGGGTGCCTTTAATCCCAGCAACTGAGGGTACCAGTAATCCCAGCAACTCAGGGTGTCTTTAATCCTAGCAACTGAGGGCACCTGTAATCCCAGCAACTCAGGAAGCTGAGACAGGAGAAGTACTTGAACCCAGAAGGCAGAGGTTGCAGTGAGCCGATATTGCACCATTGCACTCCAGTCTGGGCAACAAGAGTGAAACTCTGTCTCAAAAAAAAA"
"chr14","2164771","2165383","JH378118","18053084","18053501","243","15888313","GGCTGGGCGCAGTGGCTCACACCTGTAATCCCAGCACTCTGGGAGGCCAAGGCAGGTGGATCACCTGAGGTCAGGAGTTCGAGACCAGCCTGGCCAACATGGTGAAACCCCATCTTTACTAAAAATACAAAAATTAGCTAGGCGTGAGGCCGGGCGTGGCGGCTCATGCCTGTAATCCCAGCACTATGGGAGGCTGAGGCAGGCTGATCATGAGGTCAGGAGATTGAGACCTGGCTAACACAGTGAAACCCCGTCTCTACTAAAAATACAAAAAAAAAATAGCCAGGCATGATGGCAGGCTCCTGTAGTCCCAGCTTCTTGGGAGGCTGAGGCAGGAGAATGGTGTGAACCCGGGAGGCAGAGCTTGCAGTGAGCCGAGATCATGCCACTGCACTCCAGCCTGGGTGACAGAGCAAGACTCTGTCTCAAAAAAAAAAAAAAAAAATTAGCTAGGCGTGGTGAGGGGCACCTGGAATCCCAGCTACTCAGGAGGCTGAGGCAGGAGCATCGTTTAAACCCAGGAGGCAGAGGTTGCAGTGAGCCGAAATCACACCATTGCACTCCAGCCTGGGCAACAAGAGCAAGTCTCCATCTTAAAAAAAAAAAAAAAAAA","GGCTGGGCGCAGTGGCTCACACCTGTAATCCCAGCACTTAGGGAAGCTGAGGCGAGTAGATCACCTGAGGTCAGGAGTTAGAGACCAGCCTGGCCATCATGGTGAAACCCCGTCTCTACTAAAGATACCAAAAATTAGCTGAGTGTGGTGCTGGGTGCCTGTAATCCCAGAAACTCAGGGTGCCTGTAATCCCAGCAACTCAGGGTGCCTTTAATCCCAGCAACTGAGGGTACCAGTAATCCCAGCAACTCAGGGTGTCTTTAATCCTAGCAACTGAGGGCACCTGTAATCCCAGCAACTCAGGAAGCTGAGACAGGAGAAGTACTTGAACCCAGAAGGCAGAGGTTGCAGTGAGCCGATATTGCACCATTGCACTCCAGTCTGGGCAACAAGAGTGAAACTCTGTCTCAAAAAAAAA"
"chr14","3757666","3758004","JH378113","23438980","23439304","67","19681314","CTGGGCATGGTGGCTCATGCCTGTAATCCCAGCACTTTGGGAGACAGAGGAGGGCAGATCATCTGAGGTCAGGAGTTTGAGACCAGCCTGGCCACCATGGTGAAACCCCCGTCTCTACTGAAAATACAAAAAAATTCAGCTGGGTGTGGTAGTGGATGTCTGTAATCCTAGCTGCTTGGGAGGCTGAGACAGGAGAATCGCTTGAACCCGGGAGGTGGAGGTTGCAGTGAGCCGCCATTGCGCTCCAGCCTGGGCAACAAGAGCGAAACTCCATCTCAAAAATTAATTAATTAATTAATTAATTAAAAGTGGACTAAAGCAAAGACAAGAGAAAAAAGA","GGCAGGGTGTGGTAGCTCATGCTTGTAATCCCAGCACTTTGGGAAGTGGAGGCGGGCAGATCATCTGAGGTCAGGAGTTTGAGGCCAGCCTGGCCAACATGGTGAAACCCTGTCTCTACTAAAAATACAAAAAATTAACTGGGCGTGGTGGTGGACACCTGTAATCCCAGCTGCTTGGGAGGCTGAGGCAGGAGAATCGCTTGAACCCAGGAGATGGAGGTTGCAGTGAGCCAAGATGGCACCATTGCACTCTAGCCTGGGCAAAAAGAGTGAAACTCCGTCTCAAAAAAAAAAAAGAAAAGAAAAGAAAAGAAAAGAAAAGAAA"
"chr14","10702105","10702681","JH378118","18053084","18053501","246","7350979","GGCCAGGCGCAATGGCTCACACCTGTAATCCAAGCACTTTGGGAGGCCAGTTCAAGACCAGCCTGGCCAACATGGTGAAAACCTGTCTCTGCTAAAAATGCCAAATTTCCCAGCACTTTGGGAGGCTGAGGCGGGTGGATCACGAGGTCAGGAGATTGAGACCATCCCGGCTAACACGGTGAAACCCCATCTCTACTAAAAATAGAAAAAAATTAGCCGGGCGTGGTGGCAGACGCCTGTAGTCCCAGCTACTCTGGAGGCTGAGGGAAGAGAATGGCATAAACCCGGGAGGCGGAGCTTGCAGCGAGCTGAGATTGCGCCACTGCACTCCAGCCTGGGCGACAGAGCAAGACTCCGTCTCAAAATAAATAAATAAATAAAATTAAAATTAAAAATAAAATACAAAATTTAGCCGAGCATGGTGGTGAGCACCTATAATCCCAGCTACTTGGGAGGCTGAGGCAGAAGAATCTCTTGAACCAGGGAAGTGGAGGTTGCAGTGGGCTGAGATCCAGCCACTGTACTCCAGCCTGGGCGACAAAAGCGAAACACTGTCTAAAAAAATAAAAAATAAAAA","GGCTGGGCGCAGTGGCTCACACCTGTAATCCCAGCACTTAGGGAAGCTGAGGCGAGTAGATCACCTGAGGTCAGGAGTTAGAGACCAGCCTGGCCATCATGGTGAAACCCCGTCTCTACTAAAGATACCAAAAATTAGCTGAGTGTGGTGCTGGGTGCCTGTAATCCCAGAAACTCAGGGTGCCTGTAATCCCAGCAACTCAGGGTGCCTTTAATCCCAGCAACTGAGGGTACCAGTAATCCCAGCAACTCAGGGTGTCTTTAATCCTAGCAACTGAGGGCACCTGTAATCCCAGCAACTCAGGAAGCTGAGACAGGAGAAGTACTTGAACCCAGAAGGCAGAGGTTGCAGTGAGCCGATATTGCACCATTGCACTCCAGTCTGGGCAACAAGAGTGAAACTCTGTCTCAAAAAAAAA"
"chr14","11790883","11791455","JH378118","18053084","18053501","226","6262201","GGCTGGGTGGCCATGGCTCATGCCTGTAATCCTAGAACTTTGGGAGGCTGCGGCAGGCAAATCACCTGAAGTCAGGAGTTCAAGACCAGCCTGGCCAACATACTGAAACCCCGTCTCTCCAGGCCTGGTGGCTCATGCCTGTAATCCCAGCACTTTGGAAAGCCGAGGTGGGCGGATCACCTGAGGTCAGGAGTTCAAGACCAGTCTGACCAACATGGGGAAACCCCATCTCTACTAAAAATACAAAATTAGCTGGATGTGGTGGCACATGCCTGTATTCCCAGCTACTTGGGAGGCTGAGGCAGGAGAATCGCTTGATCCCGAGAGGTGGAGCTTGCCGTGAGCTGAGATTGTGCGCCATTGCACTCCAGCCTGGGCAACAAGAGTGAAACTCCGTCTCTACTAAAAATACAAAAATTAGCCGGGTGTGGTGGCGGGTGCCTGTAATCCAAGCTACTCGGGAGGCTAAGGCAGGAGAATTGCTTGAACCCACGAGGCCGAGGTTGCAGTGAGCCGAGATTGCACTATTGCACTCCAGCCTGGGCGACAAGAGTGAGACTGTGTCTCAAAAAA","GGCTGGGCGCAGTGGCTCACACCTGTAATCCCAGCACTTAGGGAAGCTGAGGCGAGTAGATCACCTGAGGTCAGGAGTTAGAGACCAGCCTGGCCATCATGGTGAAACCCCGTCTCTACTAAAGATACCAAAAATTAGCTGAGTGTGGTGCTGGGTGCCTGTAATCCCAGAAACTCAGGGTGCCTGTAATCCCAGCAACTCAGGGTGCCTTTAATCCCAGCAACTGAGGGTACCAGTAATCCCAGCAACTCAGGGTGTCTTTAATCCTAGCAACTGAGGGCACCTGTAATCCCAGCAACTCAGGAAGCTGAGACAGGAGAAGTACTTGAACCCAGAAGGCAGAGGTTGCAGTGAGCCGATATTGCACCATTGCACTCCAGTCTGGGCAACAAGAGTGAAACTCTGTCTCAAAAAAAAA"
"chr14","12236526","12237360","JH378118","18053084","18053501","465","5816558","GGCTGGGTGGGGTGGCTCACGCGTGTAATCCCAACACTTTTGAGGCTGAGGTGGGTGGATCACTTGAGGTCCGGAGTTTGAGACCAGCCTGGTCAACATGGTGAAACCCCATGTCTCAGGATGGGGAACATCACATACCGGGGCCTGTCGTGGGGTGTGGGGAGGGGAAGGGATAGCATTAGGAGATATACCTAATGTAAATGACAAGTTAATGGGTGCAGCACACCAACATGGCACATGTATACATATGTAACAAACCTGCATGTTGTGCACATGTACCCTAGAACTTAAAGTATAGCAATAAAAAAAAAAAAAGAAACCCCGTGTCTACAAAAAAAATACAAAATTAGGCCAGGCGCAGTGGCACATACCTGTAATCCCAGCACTTTGGGAGGCCAAGGTGGGCAGATCACGAGGTCAGGAGTTTGAGACCAGCCTGTCCAAAATGGTGAAACCCCATCTCTACTAAAAAAATACAAAAATTAGCCAGGCATGGTGGCCCGTGCCTGCAATCCCAGCTACTCAGGAGGCTAAGGCAGGAGAATCACTTGAACGTGGGAGGCGGAGGTTGCAGTGAGCCGAGATCACACCATTGCACTCCAGCCTAGGCAACAGAGCGAGACTCTGTCTCAAAAAAACAAAAAGCAAAAAAACCCAAATTAGCCAGGCATGGTGGTAGTCACCTGTAATCCCAGCTACTTGGGAGGCTTAGGCAGGAGAATCGCTTGAACCCCAGAGGCAGAGGTTGCAGTAAGCCAAGATCGCACCAAGATCACTCCAGCCTGGGCGACAGTGAAACTGTGTCTCAAAAGAAAAAGAAAAAAAAGAAAGAAAA","GGCTGGGCGCAGTGGCTCACACCTGTAATCCCAGCACTTAGGGAAGCTGAGGCGAGTAGATCACCTGAGGTCAGGAGTTAGAGACCAGCCTGGCCATCATGGTGAAACCCCGTCTCTACTAAAGATACCAAAAATTAGCTGAGTGTGGTGCTGGGTGCCTGTAATCCCAGAAACTCAGGGTGCCTGTAATCCCAGCAACTCAGGGTGCCTTTAATCCCAGCAACTGAGGGTACCAGTAATCCCAGCAACTCAGGGTGTCTTTAATCCTAGCAACTGAGGGCACCTGTAATCCCAGCAACTCAGGAAGCTGAGACAGGAGAAGTACTTGAACCCAGAAGGCAGAGGTTGCAGTGAGCCGATATTGCACCATTGCACTCCAGTCTGGGCAACAAGAGTGAAACTCTGTCTCAAAAAAAAA"
"chr14","12551961","12552292","JH378124","27069096","27069413","54","14517135","GGCCAGGCGCGGTGGCTCACGCCTGTAATCCCAGCACTCTGGGAGGCCAAGGCGGACGGATCATCCGAGGTCAGGAGTTTGAGACCAGCCTGGCCAACATGGTGAAACCCCATCTCTACTAAAAATATATATATATATGTATATATATATATATATTAGCCAGGTGTAGTGGTGGGCATCTGTAATCCCAGCTACTCGGGAGGCTGAGGCAGGAGAATTGCTTGAACCCAGGAGGCGGAGGTTGCAGTGAGCTGAGATTGCACCACTGCACTCCAGCCTGGGTGATAAGAATGAGACTCCATCTCAAAACAAACAAACAAACAAATAAAAAA","GGCCGGGCACGGTGGCTCATGCCTGTAATCCCAGCACTTTGGGAGGCCGAGGCGGGTGGATCATGAGGTCAAGAGATCGAGACCATCCTAGTCAACATGGTGAAACTCCATCTCTACTAAAAATACAAAAAAAAAAAAAAATTAGCTGAGCATGGTGGTGCATGCTTGTAATTCCAGCTACTCAGGAGGCTGAGGCAGGAGAATTGCCTGAACCCAGGAGGCGGAGGTTGCAGTGAGCCGAGATTGCGCCATTGCACTCCAGCCTGGGTAATAAGAGTGAAACTCCGTCTCAAAAAAAAAAAACAAAAAAACAAAAAA"
"chr14","15131045","15131391","JH378121","20921542","20921875","62","5790497","GGCTGGGCCCGGTGACTCATGCCTGTAATCCCAGCACTTCGGGAGGACAAGGCGGGTGGATCACCTGAGGTCAGGAGTTCGAGACCAGCCTGGCCAACATGGCGAAACCCCGTCTCTACTGAAAATACAAAAATTAGCCAGGCATGGTGGTGGGCGCCTGTAATCCCAGCTACTCAGAGGCTGAGACAGGAGAATCACTTGAACCTGGGGTGGGGGCGGGGGCGGGGGCGGGGGCGGGGTGGGAGTGGAGGTTGCAGACAGTGAGTGGTGATGGCGCCAGTTCACTCCAGCCTGGGCGAAAGAGTGAAACTCCATCTCAGAAAAAAAAAAAAAAAAAAAAAGTAAAA","GGCTGGGTACGGTGGCTCATGCTGTAATCCCAGCACTTTGGGAGGTCAAAGCAGGCGGATCACCTGAGGTCAGGAGTTTGAGACCAGCCTTGCTAACATGGTGAAACCCCGTTTCTACTAAAAATAAAAAAATTAGCCAGGCGTGGTGGTGTGCACCTGTAATCCCAGCTACTTGGGAGGCTGAAGCAGGAGAGTTGCTTGAACCGGGGTGGTGGGGGGGCAGGGGCAGGGGTGGGTGGCAGGCAGAGGTTGCAGTGAGCCGAGATGGTGCCATTGCACTCCAGCCTGGGCAACAAGAGCAAAACTCCGTCTCAAAAAGAAAAAAAAAAAAGAA"
"chr14","15292066","15292693","JH378118","18053084","18053501","267","2761018","GGCCGGAGACGGTGGCTCACACCTGTAATCCCAGCACTTTGGGAGGCTGAGGCAGGCAGATCACCTGAAGTCAGGAGTTTGAGACCAGCCTGGCCAACATGGTATAAACCCCATCTCTACTAAAAATACAAAAATTAGGCTGGGCGCGGTGGCTCACGCCTGTAATCCCAACACTTTGGGAGGCCGAGGTGGGTGGATCACCTGAGGTCGGGAGTTTGAGACCAGCCTGACCAACATGAAGAAACCCTGTCTCTACTAAAAAAAAAAAAAAATACAAAATTAGCCGGGCATCATGGCACAAGCCTGTAATCCCAGCTACTCAGGAGTCTGAGGCAGGAGAATCGCTTGAACCTGGGAGGCGAAGGTTGCAGTGAGCTGAGATCGTGCCATTGCACTCCAGCCTGGGCAACAAGAGCGAAACTCCTTCTCTAAATAAATAAATAAAAATACAAAAATTTAGCCGGGCATGGTGGCGGGCACCTGTAATCCTAGCTACTTGAGAGGCTGAGGCAGGAGAATCGCTTGAACCCGGGAGGCGGAGGTTGCAGTAAGCAGAGATTGTGCCATTGCACTCCATCCTGGGCAACAAGAGTGAAACTCCATCTCAAAAAAAAAAAAAAAAAAAAAA","GGCTGGGCGCAGTGGCTCACACCTGTAATCCCAGCACTTAGGGAAGCTGAGGCGAGTAGATCACCTGAGGTCAGGAGTTAGAGACCAGCCTGGCCATCATGGTGAAACCCCGTCTCTACTAAAGATACCAAAAATTAGCTGAGTGTGGTGCTGGGTGCCTGTAATCCCAGAAACTCAGGGTGCCTGTAATCCCAGCAACTCAGGGTGCCTTTAATCCCAGCAACTGAGGGTACCAGTAATCCCAGCAACTCAGGGTGTCTTTAATCCTAGCAACTGAGGGCACCTGTAATCCCAGCAACTCAGGAAGCTGAGACAGGAGAAGTACTTGAACCCAGAAGGCAGAGGTTGCAGTGAGCCGATATTGCACCATTGCACTCCAGTCTGGGCAACAAGAGTGAAACTCTGTCTCAAAAAAAAA"
"chr14","15354689","15355313","JH378118","18053084","18053501","269","2698395","GGACGGGCGCAGTAGCTCACACCTGTAATCCTAGCAGTTTGGGAGGCCAAGGTGGGTGGATCACCTGACGTCAGGAGATCGAGACCAGCCTGGACAACATGGCGAAACCCTGTCTCTACTAAAAATACAAAATTAGGGCCAGGTGCGGTGGCTCACGCCTGTAATCCCAGCACTTTGGGAGACTGAGGCGGGCAGATCACCTGAGGTCAGGAGTTCGAGACCAGCCTGGCCAACATGGTGAAACCGCCTCTCTACTAAAAATATAAAAATTGGCTGGGCATTGTAGCAGCCACCTGTAATCCCAGCTACTTGGGGGCCCGAGGCAGAAAAACTGCTTGAACCCAGGAGGCAGAGGTTGTAGTGAGCCGAAATCATGCCACTGCACTCCAGCCTGGGTGACGAGAGTGAGACTCCGTTTCAAAGAAAAAGAAAAAAAATAAAATAAAACACAAAATTAGCCAGTCATGGTGGCAGGCACCTATAATCCCAGCTACCTGGGAGGCTAAGGCAGGAGAATCACTTGAACCCAGGAGGTAGAGGGTGTGGTGAGCCGAGATCACGCCATTGCACTCTAGCCTGGGCAACAAGAGCAAAACTCTGTCTCAAAACAAAAAGTTAAAAAAAA","GGCTGGGCGCAGTGGCTCACACCTGTAATCCCAGCACTTAGGGAAGCTGAGGCGAGTAGATCACCTGAGGTCAGGAGTTAGAGACCAGCCTGGCCATCATGGTGAAACCCCGTCTCTACTAAAGATACCAAAAATTAGCTGAGTGTGGTGCTGGGTGCCTGTAATCCCAGAAACTCAGGGTGCCTGTAATCCCAGCAACTCAGGGTGCCTTTAATCCCAGCAACTGAGGGTACCAGTAATCCCAGCAACTCAGGGTGTCTTTAATCCTAGCAACTGAGGGCACCTGTAATCCCAGCAACTCAGGAAGCTGAGACAGGAGAAGTACTTGAACCCAGAAGGCAGAGGTTGCAGTGAGCCGATATTGCACCATTGCACTCCAGTCTGGGCAACAAGAGTGAAACTCTGTCTCAAAAAAAAA"
"chr14","15366797","15367405","JH378129","11955248","11955630","263","3411549","GGTTGGGTGCGGTGGCTTACCCCTGTAATCCCAGCACTTTGGGGGTACAAAGTGGGAAGATTGCTTGAGCCCAGGAGTTCAAGACCAGCCTGGGCAACTAAGCGAGATCCTATCTCTCAAAAAAATTTTGAAACAACTTTTTGGCCGGGCGCAGTGGCTCACGCCTGTGATCCCAGCACTTTGGGAGGCCAGGGCGGGCGGATCACGAGGTCAGGAGATCAAGACCATCCTGGCTAACACGGTGAAACCCCGTCTCTACTAAAAATACAAAAAATTAGCCGGGTGCGGTGGCGGGCACCTGTAGTCCCAGCTACTCGGGAGGCTGAGGCAGGAGGATGGCGTGAACCCGGGAGGTGGAGCTTGCAGTGAGCTGAGATCGGGCCACTGCACTCCAACCTGGACGACAGATCGAGACTCCGGCTCAAAAAAAAAAAATTAGCTGGGCGTGGTGGCGGGTGCGTGTAATCCCAGCTACTCGGGAGGCTGAGGCAGGAGAATCACTTGAACCTGGGAGGCAGAGGCTGCAGTGAGCCAAGATCGCGCCATTGCACTCCAGCCTGGGCAACAAGAGCGAAACTCTGTCTCTAAATAATAAAATAAAATAAAAAA","GGCTGGGTACGGTGGCTCATGCCTGTAATCCCAGCACTTTGGGAGGTGGGTCACTTGAGGTCAGGAGTTCGAGACCAGCCTGTGCAGTGCCTCCATCCTCAACTGCTGCCTCATCAGCCTGGACCACTACCTGCTCATCCTCTCACCACTGCCACAAGCTGCGCATGAAGCTCCTGCGCGCGCCGGTGCCCGTCTCTACTAAAAATACAAAAATTAGCTGGGTGTGGTGGCAGGTGCCTGTAATCCCAGCTACTCAGGAGGCTGAGGCAGGAGAATCACTTGAACCCAGGAGGCAGAGGTTGCAGTGAGCCGATATCGCATCATTGCACTCCAGCCTGAGCAACAAGAGTGAAATTTTGTCTCAAAAAAAAAAAAAAAAGAAA"
"chr14","15379094","15379705","JH378129","11955248","11955630","265","3423846","GGTTGGGTGCGGTGGCTTACCCCTGTAATCCCAGCACTTTGGGGGTACAAAGTGGGAAGATTGCTTGAGCCCAGGAGTTCAAGACCAGCCTGGGCAACTAAGCGAGATCCTATCTCTCAAAAAAATTTTGAAACAACTTTTTGGCCGGGCGCAGTGGCTCACGCCTGTGATCCCAGCACTTTGGGAGGCCAGGGCGGGCGGATCACGAGGTCAGGAGATCAAGACCATCCTGGCTAACACGGTGAAACCCCGTCTCTACTAAAAATACAAAAAATTAGCCGGGTGCGGTGGCGGGCACCTGTAGTCCCAGCTACTCGGGAGGCTGAGGCAGGAGGATGGCGTGAACCCGGGAGGTGGAGCTTGCAGTGAGCTGAGATCGGGCCACTGCACTCCAACCTGGACGACAGATCGAGACTCCGGCTCAAAAAAAAAAAAAATTAGCTGGGCGTGGTGGCGGGTGCGTGTAATCCCAGCTACTCGGGAGGCTGAGGCAGGAGAATCACTTGAACCTGGGAGGCAGAGGCTGCAGTGAGCCAAGATCGCGCCATTGCACTCCAGCCTGGGCAACAAGAGCGAAACTCTGTCTCTAAATAAATAAAATAAAATAAAAAA","GGCTGGGTACGGTGGCTCATGCCTGTAATCCCAGCACTTTGGGAGGTGGGTCACTTGAGGTCAGGAGTTCGAGACCAGCCTGTGCAGTGCCTCCATCCTCAACTGCTGCCTCATCAGCCTGGACCACTACCTGCTCATCCTCTCACCACTGCCACAAGCTGCGCATGAAGCTCCTGCGCGCGCCGGTGCCCGTCTCTACTAAAAATACAAAAATTAGCTGGGTGTGGTGGCAGGTGCCTGTAATCCCAGCTACTCAGGAGGCTGAGGCAGGAGAATCACTTGAACCCAGGAGGCAGAGGTTGCAGTGAGCCGATATCGCATCATTGCACTCCAGCCTGAGCAACAAGAGTGAAATTTTGTCTCAAAAAAAAAAAAAAAAGAAA"
"chr14","15386894","15387394","JH378114","15957391","15957789","201","570497","GCTGAGTGCAGTGGCTCACGCCTGTAATCCACTTTAGCAGGCCAAAATAGGGGGATCACTTTGAGGCCACGAGTTTGAGACCTGCCTGGGCAACATAGTGAGGCCCCGTCTCTACAAAAATCTTTAAATATTAGAATAACTTTGGGAGGCCGAGGCGGGTGGATCACGAGGTCAAGAGATTGAGACCATCCTGGCCAACATGGTGAAATCCCATCCCTACTAAAGCTACAAAAATTAGCCAGGCGTGGTGGTGTGCGCCTGTAGTCCCAGCTACTCGGGAGACTGAGGCAGGAGAATTGCTTGAATCCGCGTGGCGGAGGTTGCAGTGAGCTGAGATCGCGCCACTGCACTCCAGCCTGGTGACAGAGCGAGACTCCGTCTTAAAAAAAAAAAAAAAAAAAAAAAAAAAAACTTCGGAGGTTGCGGTGAGCCAAGATCACGCCATTGTACTCCAGCCTGGGCCACAAGAGCAAAACTCCGCTTCAAAAAAAAAAAAAAAAA","GCAAGGAACGGTGGCTCATGCCTGTCATCCCAGCACTTTGGGAGGCTAAGGAGGGTGGATTACCGAAGGTCATGAGTTTGAGACCAGCCTGACCAACATGGTGAAAACCCCATCTCTACTAAAAATACAAAAAATTAGCCAGATACAGCTATGCGGCAGACTGGGGCAGGAGAATCGCTTGGACCCAAACCCCATCTCTACTAAAAATACAAAAAATTAGCCGGATACAGCTATGCGGGAGACTGGGGCAGGAGAATCGCTTGGACCCGGGAGGCAGAGATTGCAGTGAGATGAGACCATGCCATTGCTCTCTAGCTTGTGCGATGAGAACAAGACTCTGTCTCAAAAAAAAAAAAAAAAAAAAAAAAAAAAAAAAAAAAAAAAGAGAGAGAGAGAAAA"
"chr14","20140478","20141066","JH378118","18053084","18053501","250","2087394","GCCAGGCGAGGTGGCTCATGCCTGTAATCCCAGCACTTTGGGAGGCTGAGGTGGGTGGAACACTTGAGGTCAGGAGTTCAAGACCAGCCTGGCCAACATGATGAAACCCCCATCTCTACTAAAAACACAAAAATTAGCCAGGAGTGGGCAGGGTGCGGTGGCTCACGCCTGTAATCCCAGCACTTTGGGAGGCTGGGATGGGTGGATCATGAGGTCGGGAGTTCAAGACCAGCCTGGCCAAGATGGTGAAACCCTGTCTCTATTAAAACTTCAAAAATTAGCCAGGCACGGTGGCAGGTGCTTGTAATCCCAGCTACTTGGGAGGCTGAGGCAGGAGAATCACTTGAAACTGGGCGGCAGAGGTTGCAGTGAGCCAAGATCGCGCCACTGGACTCCAGACTGGGCGACACAGTGAGATACCGTCTCAAAAAAAAAAAAAAAAAAAATTAGCCAGGAGTGGTGGCGGAAATCCCAGCTACTTGAGAGGCTGAGGCAGGAGAATCGTTTGAACCCAGGAGGCAGAGGTTGCAGTGAGCCAAGATCTTGCCATTGCACTCCAGCTTGGGAGACAAGAGCAAAACTCTGTCTC","GGCTGGGCGCAGTGGCTCACACCTGTAATCCCAGCACTTAGGGAAGCTGAGGCGAGTAGATCACCTGAGGTCAGGAGTTAGAGACCAGCCTGGCCATCATGGTGAAACCCCGTCTCTACTAAAGATACCAAAAATTAGCTGAGTGTGGTGCTGGGTGCCTGTAATCCCAGAAACTCAGGGTGCCTGTAATCCCAGCAACTCAGGGTGCCTTTAATCCCAGCAACTGAGGGTACCAGTAATCCCAGCAACTCAGGGTGTCTTTAATCCTAGCAACTGAGGGCACCTGTAATCCCAGCAACTCAGGAAGCTGAGACAGGAGAAGTACTTGAACCCAGAAGGCAGAGGTTGCAGTGAGCCGATATTGCACCATTGCACTCCAGTCTGGGCAACAAGAGTGAAACTCTGTCTCAAAAAAAAA"
"chr14","32019134","32019479","JH378197","6655183","6655524","67","25363951","GGCTGGGGCAGTGGCTCACTGTAATTCCAGCACTTGGCCAAGGCAGGTGGATCACCTGAGGTCAGGAGTTCAAGACCAGCAGGGCCAACATGGTGAAACCCTATCTCTAAAAATAAATAAATAAATAAATAAATAAAATAAAATAAAATAAAATAAAAAATAAAAAAAATTAGCTGGGCGTTGTGGTGGGCGCCTGTAATCCCAGCTACTTGGGAGGCTGAGGCAGGAGGATCGCTTGAACCTGGAAGGCAGAGGTTGCAGTGAGCCGAAATCACATAATTGCACTCCAGCCTGGGCGACAAGAGCAAAACTCCATCTCAAAAAAAAAAAAAAAAAAAAAAAAAAA","GGCCGGGCGCAGTGGCTCATGCCTGTAATCCCAGCACTTTGGGAGGCAGAGGCGGGCAGATCACCCAAGGTCAGGAGTTCAAGACCAGCCTGGCTAACATGGTGAAACCCCATTTCTACTAAAAATACAAAAAAAAAAAAAAAAAAAAAAAAAAAAAAAAAAAAAAATTAGCTGAGCGAGGTGGTGGGCACATGTAATCCCAGCTACTTCGGAGACTAAGGCAGGACAATTGCTTAAGCCTGGGAGGCAGAGGTTGTAGTAAGCTGAGATCACACCATTGCACTCCAGCTTGAGCAACAAGAGCGAAACTCCGTCTCAAAAAAAAACCCAAAAAACAAAAAA"
"chr14","39734996","39735596","JH378118","18053084","18053501","237","21681912","GGCTGGGCGCGGTGGCTCATGCCTGTAATCCCAGCATTTTGGGAGGCCGAGGCGGGTGGATCACCTGAGGTCAGGAGTTTGAGACCAGCCTGGCCAACATGGTGAAACCCTGTCTCTACTAAAAATGCAAAAATTAGGCTGGTGCAGTGGCTCACGCCTGTAATCACAGCACTTTGGGAGGCCGAGGTGGGCGGATCACGAGGTCAGGAGATCGAGACCATCCTGGCTAATACAATGAAACCCCGTCTCTATGAAAAATACAAAAAATTAGCCGGGCGTAGTGGCAGGCGTCTGTAGTCCCAGCTACTCAGGAGGCTGAGGCAGGAGAATGGCATGAACCTGGGAGGCGGAGCTTGCAGTGAGCCGAGATTGCGCCACTGCACTCCAGCCTGGGCGACAGCGAGACTCTGTCTCAAAAAAAAAAAAAAAAATTAGCTAGGCATGGTGGCGCATGCCTGTAATCCCAGCTACTTGGGAGGCTGAGGCAGGAGAATCGCTTGAACCTGGGAGGCAGAGGCTGCAGTGAGACAAGATCACGCCATTGCACTCCAGCCTGGGCAACAAGAGTGAAACTCCATCTTCCCCCTACCAAAAAAAAAAA","GGCTGGGCGCAGTGGCTCACACCTGTAATCCCAGCACTTAGGGAAGCTGAGGCGAGTAGATCACCTGAGGTCAGGAGTTAGAGACCAGCCTGGCCATCATGGTGAAACCCCGTCTCTACTAAAGATACCAAAAATTAGCTGAGTGTGGTGCTGGGTGCCTGTAATCCCAGAAACTCAGGGTGCCTGTAATCCCAGCAACTCAGGGTGCCTTTAATCCCAGCAACTGAGGGTACCAGTAATCCCAGCAACTCAGGGTGTCTTTAATCCTAGCAACTGAGGGCACCTGTAATCCCAGCAACTCAGGAAGCTGAGACAGGAGAAGTACTTGAACCCAGAAGGCAGAGGTTGCAGTGAGCCGATATTGCACCATTGCACTCCAGTCTGGGCAACAAGAGTGAAACTCTGTCTCAAAAAAAAA"
"chr14","49081899","49082239","JH378114","14264965","14265292","65","34816934","GGCCAGGTACAGTGGCTCATGCCTGTAATCTCAGCATTTTGGGAGGCTGAGGCAGGCAGATCACCTGAGGTCAGGAGTTCGTGACCAGCCTGACCAGTGAAACCCTGTCTCTACTGAAAAAAATAAAATAAAATAAAATAAAAATAAAAATTAGCTGGGTGTGGTGGTGGGCGCCTGTAATCCCAGCTACTCGGCAGGCTGAGGCAGGAGAATTGCTTGTACCCGGGAGGCGGAGGTTGCAGTGAGCCAAGATCATGCCATTGCACTACAGCCTAGGTGACAAGAGCAAAACTCTGTCTCAAAACAAAACAACAACAACAACAACAACTAAAAAAAAAAAA","GGCCAGGCGCGGTGGCTCAAGCCTGTAATCCCAGCACTTTGGGAGGCCGAGGCGGGTGGATCATGAGGTCAAGAGATCGAGACCATCCTGGTCAACATGGTGAAACCCCGTCTCTACTAAAAACAGAAAAAAAATAAAAATAAAAATAATTAGCTGGGCATGGTGGAGCATGCCTGTAATCCCAGCTACTCAGGAGGCTGAGGCAGGAGAATTGCCTGAACCGAGGAGGCGGAGGTTGCGGGGAGCCAAGATCGCGCCATTGCACTCCAGCCTGGGCAACAAGAGCGAAACTCCGTCTCAAAAAAAAAAAAAAAAAAAAAAAAAAAAA"
"chr14","54833704","54834332","JH378118","18053084","18053501","272","36780620","GGCCAGGTGCAGTGGCTCACTCCTGTAATTCCAGCACTTTGGGAGGCTGCCGGTGGATCACCTGAGGTCAGGAGTTCGAGATCAGCCTGGCCAACATGGTGAAACCCCGTCTCTACTAATAATACAAAAATTAGCCAGGCAAGGCCGGGCGCAGTGGCTCACACCTGTAATCCCAGCACTTTGGGAGGCCGAGGCGGGCGGATCACCTGAGGTCGGGAGTTCAAGACCAGCCTGACCAACATGGAGAAACCCCATCTCTACTAAAAATACAAAATTAGCTGGGCATGGTGGCACATGCCTGTAATCCCAGCTACTAGGGAGGCTGAGGCAGGCGAATCGCTTGAACCTGGGAGGTGGAGGTTGCGGTGGGCCGAGATGGTGCCATTGCACTCTAGCCCGGGCAACAAGAGCGAAACTCTGTCTCAAAAAAAAAAAAAAAAAAAAAAAAATTAGCCAGGCATGGTAGCACACCCTTGTAATCCCAGCTACTCGGGAGGCTGAGGCAGGAGAGTTGCTTGAACCCGAGAGACGGAGGTTGCAGTGAGCTGAGATCGTGCCATTGCACTCCAACCTGGGTGACAAGAGTGAAACTCCATCTCCAAAAAAAAAAATAAATAAAATAAATAAAA","GGCTGGGCGCAGTGGCTCACACCTGTAATCCCAGCACTTAGGGAAGCTGAGGCGAGTAGATCACCTGAGGTCAGGAGTTAGAGACCAGCCTGGCCATCATGGTGAAACCCCGTCTCTACTAAAGATACCAAAAATTAGCTGAGTGTGGTGCTGGGTGCCTGTAATCCCAGAAACTCAGGGTGCCTGTAATCCCAGCAACTCAGGGTGCCTTTAATCCCAGCAACTGAGGGTACCAGTAATCCCAGCAACTCAGGGTGTCTTTAATCCTAGCAACTGAGGGCACCTGTAATCCCAGCAACTCAGGAAGCTGAGACAGGAGAAGTACTTGAACCCAGAAGGCAGAGGTTGCAGTGAGCCGATATTGCACCATTGCACTCCAGTCTGGGCAACAAGAGTGAAACTCTGTCTCAAAAAAAAA"
"chr14","55277737","55278067","JH378148","10302642","10302970","61","44975095","GGCCGGGTGCAGTGGCCCACCTCTGTAATCCTAACACTTTGGGAGGCCAAGGCAGGCAGGTCACTTGAGGTCAGGAGTTCAAGACTAACCTGGCCAACATGGTGAAACCCCGTCTCTACTAAAAATACGAAAATTAGCCGGGCTTCATGATGCATGCCTGTAATCCCAGCTACTAAGGAGGCTGAGGCAGAAGAATCTCTTGAACCCATGAGGTTGCAGTGAGCTGAGATCTCGCCATTGCACTCCAGCCTGGAGGACAAGAGCGAAACTCTGTCTCAAAAAAATAAAATAAAATAAATAAGAATAAAATAATAATAAAAGGCAAAAAGAA","GGCCGGGCGCGGTGGCTCAAGCCTGTAATCCCAGCACTTTGGGAGGCCGAGGCGGGTGGATCACGAGGTCAAGAGATCGAGACCATCCTGGTCAACATGGTGAAACCCCGTCTCTACTAAAAATACAAAAAATTAGCTGGGCATGGTGGTGGGTGCCTGTAATCCCAGCTACTCAGGAGGCTGAGGCAGGAGAATTGCCTGAACCCAGGAGGCGGAGGTTGCGGTGAGCCGAGATCGCGCCATTGCACTCCAGCCTGGGTAACAAGAGTGAAACTCTGCCTCAAAAAAAAAAAATAAAATAAAATAAAATAAAATAAAATAAAATAAAA"
"chr14","55822103","55822700","JH378118","18053084","18053501","240","37769019","GGCCAGGCGCAGTGGCTCACGCCTGTAATCCCAGCACTTTAGGAGGCCGAGGCAGGTGGATCGCCTGAGTTCAGGAGTTCAAACCCACCCTGGCCAACATGGTGAAACCCTGCCTCTACTAAAAAACAAAAAAATGGCCAAGCGTGGTGGCTCACGCCTGTAATTCCAGCACTTTGGGAGGCTGAGGCAGGCGAATCACGAGGTCAGGAGATCGAGACCATCCTGGCTAACATGGTGAAACCCCATCTCTATTAAAAATACAGAAAATTAGCCAGGCGTGGTGGTGGACGCCTGTAGTCCCAGCTTCTTGGGAGGCTGAGGCAGGAGAATGGCATGAACCCGGGAGGCAGAGCTTGCAGTGAGCTGAGATTGCGCCAGTGCACTACAGCCTGTGGGACAGAGCAACTCCGTCTCAAAAAAAAAAAAAATTAGCTGGGCATGGTGGCATATGCCTGTAATCCCAGCTACTAAGGAGGCTGAGGCGGGAGAATCGCTTGAACCCGGGAGGCAGAGGTTGCAGTGAGCCGAGATTGCGCCATTGCACTCCAGTCTGGACAACAAGAGTGAACTGTGTCTCAAAAAAAAAAAAAAAAAAAGA","GGCTGGGCGCAGTGGCTCACACCTGTAATCCCAGCACTTAGGGAAGCTGAGGCGAGTAGATCACCTGAGGTCAGGAGTTAGAGACCAGCCTGGCCATCATGGTGAAACCCCGTCTCTACTAAAGATACCAAAAATTAGCTGAGTGTGGTGCTGGGTGCCTGTAATCCCAGAAACTCAGGGTGCCTGTAATCCCAGCAACTCAGGGTGCCTTTAATCCCAGCAACTGAGGGTACCAGTAATCCCAGCAACTCAGGGTGTCTTTAATCCTAGCAACTGAGGGCACCTGTAATCCCAGCAACTCAGGAAGCTGAGACAGGAGAAGTACTTGAACCCAGAAGGCAGAGGTTGCAGTGAGCCGATATTGCACCATTGCACTCCAGTCTGGGCAACAAGAGTGAAACTCTGTCTCAAAAAAAAA"
"chr14","55860214","55860812","JH378118","18053084","18053501","246","37807130","GGCCGGATGCAGTGGCTCACGCCTGTAATCCCAGCACTTTGGGAGGCCAAGGCAAGCGGATCACCTGAGGTCAGGAGTTCAAGACCAGCCTGGCCAGCATGGTGAAACCCCTTCTCTACTAAAAATACAAAAATTAGCCGGGGCCTTGCGTGGTGGCTCACACCTGTAAATCCCAGCGCTTTGGGAGGCCGAGGCAGGCGGATCACCTGAGGTCGGGAGTTCAAGAACAGCCTGACCAACATGGAGAAACCCCGTCTCCACTAAAAATAGAAAAATAGCCGGGCATGGTGGCGCATGCTTGTAATCTCAGCTACTCGGGAGGCTGAGGCAGGAGATCACTTGAACCCAAGAGGCAGAGGTTGCGGTGAGCCGAGATCGCGCCATTGCACTCCAGCCTGGGCAACAAAGAGCGAAACTCCGTCTCCAAAAAAAAAAAAAAAAAATTAGCCGGGCGTGGTGGCACATACCTGTAATCCCAGCTATTCAGGAGGCTGAGGCAGGAGAATCCCTTGAACCCGGGAGGCAGAGATGGCAGTGAGCTGAGATCACGCCATTGCACTCCAGCCTGGGTGAGAGGAGTGAAACTCCGTCTAAAAAAA","GGCTGGGCGCAGTGGCTCACACCTGTAATCCCAGCACTTAGGGAAGCTGAGGCGAGTAGATCACCTGAGGTCAGGAGTTAGAGACCAGCCTGGCCATCATGGTGAAACCCCGTCTCTACTAAAGATACCAAAAATTAGCTGAGTGTGGTGCTGGGTGCCTGTAATCCCAGAAACTCAGGGTGCCTGTAATCCCAGCAACTCAGGGTGCCTTTAATCCCAGCAACTGAGGGTACCAGTAATCCCAGCAACTCAGGGTGTCTTTAATCCTAGCAACTGAGGGCACCTGTAATCCCAGCAACTCAGGAAGCTGAGACAGGAGAAGTACTTGAACCCAGAAGGCAGAGGTTGCAGTGAGCCGATATTGCACCATTGCACTCCAGTCTGGGCAACAAGAGTGAAACTCTGTCTCAAAAAAAAA"
"chr14","56736257","56736880","JH378206","6546474","6546861","276","50189783","GGCCAGGCACAGTGGCTCATGCCTGTAATCCCTGCACTTTGGGAGGCCAAGGCGGGTGGATCACCTGAGGTCAGGAGTTCGAGACTAGCCTGGCCAACATGGTTGGCCATCTCTTCTAAAAATACAAAAAATTAAGTTGGGCATGGTGGCTCATGCCTGTAATCCCAGCATTTTGGGAGGCCAAGGCAGGTGGATCATAAGGTCAAGAGATTGAGACCATCCTGGCCAACATGGTGAAACCCCATCTCTACTAAAAATACAAAAATTAGCTGGGCGTGGTGGTAGCACACACCTGCAGTCCCAGCTGCTCAGGAGGCTGAGGCAGGAGAATCACTTGAACCCGGGAAGCAGAGGTTGCAGTGAGCCGAAATTGCACCACTGCACTCCAGCCTGGCGACAAAGCAAGACTCCGTCAAAAAAAAAAAAAAAAAAAAAAAAATTAGCCAGGAGTGGTGGCACGTGCCTATAGTTCCAGCTACTCGGGAGGCTGAGGCAAGAGATTTGCTTGAACCTGGGAAGCAGAGGTTGCATATATTGCAGTGAGCCAAGATTATGCCATTGCACTCCAGCCTGGGCAACAAGAGTGAAAATCTGTCTAAAAAGAAAAAAAAAAGAAAAGAAAAA","GGCCACACATGGTGGCTAACGCCTGTAATCCCAGCACTTTGGGAGGCCAAGTCGGGTGGATCATGAGGTCAGGAGACCAAGACCATCCTGGCCAAATGGTGAAACCCCGTCTCTACTAAAAATACAAAAATTAGCTGGGCATGGTGGCGTGTGCCTGTAATCCCAGCTACTCAGGAGGCTGAGGCAGGACAATTGCCTGAACCCAGGAGAATTAGCTGGGCATGGTGGCGTGTGCCTGTAATCCCAGCTACTCAGGAGGCTGAGGCAGGACAATTGCCTGAACCCAGGAGGCGAAGGTTGCGGTGAGCCGAGATTGTGCCATTGCACTCCAGCCTGGGTAACAAGAGCGACACTCTGTCTCAAAAAAAAAAAAAAAAAAAAAAAAAAA"
"chr14","56744047","56744674","JH378118","18053084","18053501","281","38690963","GGCCGGGTGCGGTGACTCACATCTATAATCCCAGCACTTTGGGAGGCCAAGGCAGGTGGATCACCTGAGGTCAGGAGTTCAAGACCAGCCTGGCCAACTTGGTGAAACCCCATCTCTACTAAAAAATATAAAAATTTGCCAGGTGCGGTGGCTCATACCTGTAATCCCAGCACTTTGAGAGGCAGAGGTGGGTGGATCACGAGGTCAGGAGTTCGAGACCAGCCTGGCCAATGTGGTGAAACCCCATCTCTACTAAAAATACAAAAATTAGCCGGGTGTGGTGATGCGTGCCTGTAGTCCCAGCTATTCGGGAGGTTGAGGCAGGAGAATGGCGTGAACCAGGAAGGCGGAGCTTTCACTGAGCGGAGATCGCACCACTGCACTCCAGCCTGGGCGACGGAGCGAGACTCTGTCTCAAAAACAAAACAAAACAAAAAAACAAACAAACAAAAAAACATTATCCGGGTGTGGTGGTGGGCGCCTGTAATCCCAGCTACTTGGGAGGCTGAAGCAGGAGGATTGCTTGAACCTGGGAGGTGGAGGTTGCAGTGAGCTGAGATCACGCCTCTGCACTGCAGGCTGGACGACAAGAACAAAACTCTGAATCAACAACAACAACAACAAAAAA","GGCTGGGCGCAGTGGCTCACACCTGTAATCCCAGCACTTAGGGAAGCTGAGGCGAGTAGATCACCTGAGGTCAGGAGTTAGAGACCAGCCTGGCCATCATGGTGAAACCCCGTCTCTACTAAAGATACCAAAAATTAGCTGAGTGTGGTGCTGGGTGCCTGTAATCCCAGAAACTCAGGGTGCCTGTAATCCCAGCAACTCAGGGTGCCTTTAATCCCAGCAACTGAGGGTACCAGTAATCCCAGCAACTCAGGGTGTCTTTAATCCTAGCAACTGAGGGCACCTGTAATCCCAGCAACTCAGGAAGCTGAGACAGGAGAAGTACTTGAACCCAGAAGGCAGAGGTTGCAGTGAGCCGATATTGCACCATTGCACTCCAGTCTGGGCAACAAGAGTGAAACTCTGTCTCAAAAAAAAA"
"chr14","58283278","58283584","JH378115","34663603","34663898","52","23619675","CCGGGTGCGGTGGCTCACGCCTGTAATCCCAGCACTTTGGGAAGCTGAGGTGGGTGGATCATTTGAGGTCAAGAGTTCTAGACCAGCCTGGCCAACATGGTGAAACCCTACTTCTAATAAACACACACACACACACACACACACACACACACACACAAATTAGCCAGCAGGCACCTGTAATCCCAGCTACTCGGAAGGCTGAGGCAGGACAATCGCTTGAACCTGGGAGGCCAGAAGTTGCAGTGAGCCAAGATCATGCCACTGCACTCCAGTCTGGGTGACAAGAGCAAGACTCCATTTCAAAAAA","GGCCTGGTGAAGTGGCTCACGCCTGTAATCCCAACACTTTGGGAGGCTGAGATGGATGGCTCATTTGAGGTCAGGAGTTCTAGACCAGCCTGGCCAACATGGTAAAAGCCCACCTCTACCAAAAATACAAAAACAAAAACAAAAAAATTTTAGCCAACAGGCACCTTTAATCCCAGCTACTCAGGAGGCTGAGGCAGGAGAATTGCTTGAATCTGGGAGGCCAGAAGTTGCAGTGAGCCAGGATCACACCACTGCACTCCATCCTAGGCGACAAGAGCAAGACTCCAAAAAAAAAA"
"chr14","59226808","59227410","JH378118","18053084","18053501","257","41173724","GGCTGGGCGCTGTGGCTCATGCCTGTAATCCCAGCACTTTAGGAAGCCAAGGGAGGTGGATCACCTGAGGTCAGAGTTCAAGTCCGGCCTGACCAACATGGCGAAACCCAGTCTCTACTAAAAATACAAAATTGGCCAGGCGTGGGGTGGCTCACACCTGTAATCCCAGCACTTTGGGAGGCCGAAGTGGGTGGATCACTTGAGGTCAGGAGTTTGAGACCAGCCTGGTTAACATGGTGAAACCCCATCTCTACTAAAAATACAAAAATTAGCCAGGCATGGTGGCAGGCGCCTGCAATCCCAGTTACTCAGGAGGCTGGTGCAGGAGAATCGCTTAAACCTAGGAGGCAGAGGTTGCAGTGAACTGAGATCGTGCCATTGCACTCCAGCCTGGGTAACAACAGCAAGACTTCATCTCAAAAAAAAAAATACATAATTATAATTAGCTGGGCGTGTTGGCGAGCGCCTGTAGTCCCTGCTACTTGGGAGGCTGAGGCAGGGGAATCACTTGAACCTGAGAGGCGGAGGTTGCAGTGAGCCAAGTCACGCCATTGCATTCCAGCCTCGGCAACAAGAGCAAAACTCCATCTCAAAAAAAAAAAA","GGCTGGGCGCAGTGGCTCACACCTGTAATCCCAGCACTTAGGGAAGCTGAGGCGAGTAGATCACCTGAGGTCAGGAGTTAGAGACCAGCCTGGCCATCATGGTGAAACCCCGTCTCTACTAAAGATACCAAAAATTAGCTGAGTGTGGTGCTGGGTGCCTGTAATCCCAGAAACTCAGGGTGCCTGTAATCCCAGCAACTCAGGGTGCCTTTAATCCCAGCAACTGAGGGTACCAGTAATCCCAGCAACTCAGGGTGTCTTTAATCCTAGCAACTGAGGGCACCTGTAATCCCAGCAACTCAGGAAGCTGAGACAGGAGAAGTACTTGAACCCAGAAGGCAGAGGTTGCAGTGAGCCGATATTGCACCATTGCACTCCAGTCTGGGCAACAAGAGTGAAACTCTGTCTCAAAAAAAAA"
"chr14","62992080","62992681","JH378118","18053084","18053501","256","44938996","GGCCGGATGCAGTGGCCCACACCTGTAATCCTAGCACTTTGAGAGGCTGAAGCAGGCAGATCACTTGCGGTCAGGAGTTTGAGACCAGCCTGGCCAACATAGTAAAACCTCATCTCTACTAAAAATAGAAAAATTTTCTGACCAGGCACGGTGGCTCGCGCCTGTAATCCCAGCACTTTGGGAGGCCAAGGTGGGCACATTACCTGAGATCAAGAGTTCAAGACCAGCCTGACCAACATGGCAAAACTCTGTCTCTACTAAAAATACAAAATTAGCCGGGCATAGTGGCGCATTCCTGTAATCCCAGCTACTAAGGAGGCTGAGGCAGGAGAATTGCTTGAACCCGGGAGCCGGAGGTTGCAGTAAGCCAAGATTGCGCACTGCACTCTAGGCTGGGCAACAACAGCGAAACTCTGTCTCGAAAAAAAAAAAAAAAAAAATTAGCTGGGCGTGGTGGTGAGTACCTGTAATCCCAGCTACTTGGGAGACTGAGGCAGGAGAATCTCTTGAACCTGGGAGGTAGAGGTTGCAGCGAGCTTAGATCACACCACTGCACTAAAGCCTGGGGGACAAGAGCAAAACTCTATCTCAAAAAAATAAAA","GGCTGGGCGCAGTGGCTCACACCTGTAATCCCAGCACTTAGGGAAGCTGAGGCGAGTAGATCACCTGAGGTCAGGAGTTAGAGACCAGCCTGGCCATCATGGTGAAACCCCGTCTCTACTAAAGATACCAAAAATTAGCTGAGTGTGGTGCTGGGTGCCTGTAATCCCAGAAACTCAGGGTGCCTGTAATCCCAGCAACTCAGGGTGCCTTTAATCCCAGCAACTGAGGGTACCAGTAATCCCAGCAACTCAGGGTGTCTTTAATCCTAGCAACTGAGGGCACCTGTAATCCCAGCAACTCAGGAAGCTGAGACAGGAGAAGTACTTGAACCCAGAAGGCAGAGGTTGCAGTGAGCCGATATTGCACCATTGCACTCCAGTCTGGGCAACAAGAGTGAAACTCTGTCTCAAAAAAAAA"
"chr14","75046278","75046878","JH378118","18053084","18053501","246","56993194","GGCCGGGCACAGTGGCTCACACCTATAATCTCAGTACTTTGGGAGGCCAAGGCGGGCAGATCACTTGAGGTCAGGAGTTCGAGACCACCCTGGCCAACATGGTGAAACCTCATCTCTACTAAAAATACAAAAAACTGGCTGGGTGAAGTGGCTCACGCCTGTAATCCCAGCAGTTTGGGAGGCCAAGGCGGGCCAATCACGAGGTCAGGAGTTCGAGACCAGCCTGGCCAATATGGTGAAACCCCGTCTCTATTAAAAATTCAAAAATTAGCTGGATGTGGTGGCAGGCACCTACAATCCCAGCTACTTGGAAGGCTGAGGCAGGAGAGTCTGCTTGAAACCAGAAGGCGGAGGTTGCAGTGAGTGAGCTGAGAACGTGCCACTGCACTCCAGCCTGGGCGAAAGAGCAAAACGCTGTCTCAGGGGGAAAAAAAAAACTAGCCGGGCATGGTGGCAGGTGCCTGTAATCCCAGCTACTCAGGAGGCTGAGGCAGGAGAATTGCTTGAACCCAGGAGGAGGAGGTTGCAGTGAGTCGAGATCACGTCATTGCACTCCCAGCCTGGCTGATAAGAGCGAAACTCCGTCAAAAAAAAAAAAAAA","GGCTGGGCGCAGTGGCTCACACCTGTAATCCCAGCACTTAGGGAAGCTGAGGCGAGTAGATCACCTGAGGTCAGGAGTTAGAGACCAGCCTGGCCATCATGGTGAAACCCCGTCTCTACTAAAGATACCAAAAATTAGCTGAGTGTGGTGCTGGGTGCCTGTAATCCCAGAAACTCAGGGTGCCTGTAATCCCAGCAACTCAGGGTGCCTTTAATCCCAGCAACTGAGGGTACCAGTAATCCCAGCAACTCAGGGTGTCTTTAATCCTAGCAACTGAGGGCACCTGTAATCCCAGCAACTCAGGAAGCTGAGACAGGAGAAGTACTTGAACCCAGAAGGCAGAGGTTGCAGTGAGCCGATATTGCACCATTGCACTCCAGTCTGGGCAACAAGAGTGAAACTCTGTCTCAAAAAAAAA"
"chr14","83813857","83814442","JH378118","18053084","18053501","240","65760773","GGCCAGGCGCGGTGGCTCACGCCTGTAATCCCAGCACTTTGGGAGGCCGAGGCGGGCGGATCACCTGAGGTCAGGGGTTCAAGACCAGCCTGACCATCCCAGAACTTTGGGAGGCCGAGACGGGTGGATCATGAGGTCAGGAGATCGAGACCATCCTGGCTAACACAGTGAAACCCCATCTCTATTAAAAATACAAAAAATTAGCCGGGCGTGGTGGCAGCTCCTGTAGTCCCAGCTACTCGGGAGGCTGAGGCAGGAGAATGGCGTGAACCCGGGAGGCGGAGCTTGCCGTGAGCCGAGATCGCACCACTGCACTCCAGCCTGCAAGATAGCGAGGCTATGTCTCAGGAAAAAAAAAAAAAAAAAAAAAAAGACCAACCTGACCAACATGGTAAAACCCCATCTCTACTAAAAATACAAAATTAGCCGGGCATGGTGGCAGACGCCTGTAATCCCAGCTACTCAGGAGGCTGAGGCAGGAAAATCACTTGAACCCAGGAGGTGGAGGTTGCGGTGAGCCGAGATCGTGCCATTGCACTCCGGCCTGGGTGACAACAGCGAAACTCCATCTCAAAAAAAAGAAAAA","GGCTGGGCGCAGTGGCTCACACCTGTAATCCCAGCACTTAGGGAAGCTGAGGCGAGTAGATCACCTGAGGTCAGGAGTTAGAGACCAGCCTGGCCATCATGGTGAAACCCCGTCTCTACTAAAGATACCAAAAATTAGCTGAGTGTGGTGCTGGGTGCCTGTAATCCCAGAAACTCAGGGTGCCTGTAATCCCAGCAACTCAGGGTGCCTTTAATCCCAGCAACTGAGGGTACCAGTAATCCCAGCAACTCAGGGTGTCTTTAATCCTAGCAACTGAGGGCACCTGTAATCCCAGCAACTCAGGAAGCTGAGACAGGAGAAGTACTTGAACCCAGAAGGCAGAGGTTGCAGTGAGCCGATATTGCACCATTGCACTCCAGTCTGGGCAACAAGAGTGAAACTCTGTCTCAAAAAAAAA"
"chr14","84224287","84224910","JH378118","18053084","18053501","265","66171203","GGCAGGGTGCAGTGGCTCATACCTGTAATCCCAGCACTCTGGGAGGCCGAGGTGGGCAGATCACTTGAGCTCAGGAGTTTGAGACCAGCCTGGCCAACATAGTGAAACCCCATCTCTACTAAAAATACAAAATTAGGCTGGGCACAGTGACTCACGTCTGTAATCCCAGCACTTTGGGAGGCCGAGGCTGGTGGATCACAAGGTCAGGAGATCAAGACCATCCTGTCCAACATAGTGAAACCCCATCTCTACTAAAAATACAAAAATTAGCTGGACGTGGAGGTGCACATCTGTAGTCCCAGCTACTTGTGAGGCTGAGGCAGGAGAACTGCTTGAACCCAGGAGGCGGAGGCTGCAGTGAGCTGAGATTGTGCCACTGCACTCCAGCCTGGGCGACAGAGCGAGACTCTGTCTCAAAAAAAAAAAAAAACAGAAAAAACAAAATTAGCCGGGCATGGTGGTGCACGCCTGTAACCCCAGCTACTTGGGGGGCTGAGGCAGGAGAATTGCTTGAACCTGAGAGGTGGAGGTTTCAGTGAGCCGAGATTGTGCCATTGCCCTCCAGTCTGGGCAACAAGAGCAAAACTCCGTCTCAAAAAAAAAAAAAAGAAAAAAAAAGAAGAA","GGCTGGGCGCAGTGGCTCACACCTGTAATCCCAGCACTTAGGGAAGCTGAGGCGAGTAGATCACCTGAGGTCAGGAGTTAGAGACCAGCCTGGCCATCATGGTGAAACCCCGTCTCTACTAAAGATACCAAAAATTAGCTGAGTGTGGTGCTGGGTGCCTGTAATCCCAGAAACTCAGGGTGCCTGTAATCCCAGCAACTCAGGGTGCCTTTAATCCCAGCAACTGAGGGTACCAGTAATCCCAGCAACTCAGGGTGTCTTTAATCCTAGCAACTGAGGGCACCTGTAATCCCAGCAACTCAGGAAGCTGAGACAGGAGAAGTACTTGAACCCAGAAGGCAGAGGTTGCAGTGAGCCGATATTGCACCATTGCACTCCAGTCTGGGCAACAAGAGTGAAACTCTGTCTCAAAAAAAAA"
"chr14","85020958","85021268","JH378108","34510794","34511096","52","50510164","GCCAGGTGCAGTGGCTCATGCCTGTAATTCCAGTACTTTGAGAGGTCGAGACAGGGAGATCACCTGAGGCCAGGAGTTCAAGACTAGCTTGGCCAACATGGCAAAACCCTGTCTCTACTAAAAATGCAAAAAAAAAAAAAAAAAAAAAAAAAAAATTAGCCTGGCATGGTGGTAGACACCTGTAATCCCAGCTACTTGGGAGGCTGAGACAGGAGAACCTCTTGAATCTGGGAGGAGGAGGTTGCTGTGAGCTGAGATCGTGCCACTGCACTCCAGCCTGGGTAACAAGAGAGAAACTCTGTCTCAAAAAA","GGGTGCCGTGTCTCATGCCTGTAATTCCAGCACTTTGGGAGGTCAAGGCAGTCCGATCACCTGAGGTCAGGAGTTTGAGACTAGCCTGGCCAAAATGGTGAAACCCTGTCTCTAGAAAAAATACAAAAAAAAAAAAAAAAAAAAAAAAAAATTAGCTGGATGTAGTGGTGCATACCTGTAGTCCCAGCTACTCTGGAGGCTGAGGCAGGAGAATTGTTTGAACCCAGGAGGCGGAGGTTGCGGTGAGCCGAGATCATGCCATTGCACTCCAGCCTGGGAAACAAGAGTGAAACTCTGTCTCAA"
"chr14","86696589","86696920","JH378203","2698403","2698735","56","83998186","GGCCAGGCACGGTGGCTCATGCCTATAACCAGCACTTTGGAGGCCGAGGCAGGTGGATCACCTGAGGTCAGGAGTTTGAGACTGGCCTGGCCAGCATGGTGAAACTCTGTCTCTACTAAAAAAAAAAAAAAAAAAAAAAAAAAAAAAGTACAAAATTAGCTGGATGTGGTGGTAGGCACCTGTAATCCCAGCTACTTGGGAGGCTGAGGCAGGAGAATCGCTTGAACCCAGGAGGCAGAGATTGCAGTGAGCCAAGATTGCGCCATTGTACTCCACTCTGGGCAATGAGCGAAACTCCGTCTCAAAAAAAAAATAAAATAAAAATAAAATAA","GCCGGGTGCAGTGGCTCATACCTCTAATCCCAGCACTTTGGGAGGCCAAGGCAGGTGATCACCTGTGGTCAGGAGTTCGAGACCAGCCTGGCCAACATGGTGAAACCCTGTCTTTACTAAAAATACAAAAAAAAAAAAAAAAAAAAAAAAAAAAAACTTAGCCCACCATGGTGGTGGGCTCTTGTAGTCCCAGCTACATGGGAGGCTGAGGCAGAAGAATCGCTTGAAGACAGGAGGTGGAGGTTGCAGTGAGCCAAGACTGCGCCATTGCACTCAGCCTGGGTGACGAGCCAAACTCCATCTCAAAAAAAAAAAAAAAAAAAAAAAAAAAAA"
"chr14","86944567","86945185","JH378118","18053084","18053501","274","68891483","GAGCACGGTGGCTCACGCCTGCAATCCCAGCACTTTGGGAGGCCGAGGTGGGTGGATCACCTGAGGTTAGGAGTTTGAGACCAGCCTGGCCAACATGGTGAAACCGTCTCTACTAAAAATGCAAAAAAGTAGGGGCCGGGCACGGTGGCTCACGCCTGTAATCCCAGCACTTTGGGAGTCTGAGGCAGACGGATCACAAGGTCAGGAGATCAAGACCATGGTGAAACTCCGTCTCTACTAAAAATACAAAAAATTAGCTGGGCGTGGTGGTGGGCACCTGTAGTCCCAGCTGCTTGGGAGGCTGAGGCAGGAGAATGGTGTGAACCCGGGAGGCGGAGCTTGCAGTGAGCCGAGATCGCAACACTGCACTCCAGCCTGGGCGACAGAGCGAGACCCTGTCTCAAAAAAAACAAAAATAAACAAAAATAAATAAATACAAAAAAGTAGCCAGGCATGGTGGTGGGTGCCTGTAATCCCAGCTACTTGGGAGGCTGAGGCAGGAGAATCACCTGAACCCGGGAGGTGGAGGTTGCAGTGAGCCAAGACCGTGTCATTACACTCTAGCCTGGGCAACAAGAGCGAAATTCCATCTGAAAAAATAAATAAATAAAAATAAAAA","GGCTGGGCGCAGTGGCTCACACCTGTAATCCCAGCACTTAGGGAAGCTGAGGCGAGTAGATCACCTGAGGTCAGGAGTTAGAGACCAGCCTGGCCATCATGGTGAAACCCCGTCTCTACTAAAGATACCAAAAATTAGCTGAGTGTGGTGCTGGGTGCCTGTAATCCCAGAAACTCAGGGTGCCTGTAATCCCAGCAACTCAGGGTGCCTTTAATCCCAGCAACTGAGGGTACCAGTAATCCCAGCAACTCAGGGTGTCTTTAATCCTAGCAACTGAGGGCACCTGTAATCCCAGCAACTCAGGAAGCTGAGACAGGAGAAGTACTTGAACCCAGAAGGCAGAGGTTGCAGTGAGCCGATATTGCACCATTGCACTCCAGTCTGGGCAACAAGAGTGAAACTCTGTCTCAAAAAAAAA"
"chr14","87180871","87181803","JH378118","18053084","18053501","547","69127787","GGCCATGTGCGGTGGCTCACACCTGTAATCCCAGCACTGTGGGAGGCCAAGGTGGGCGGATCATTTGAGGTCAGGAGTTCTAAACCAGCCTGGCCAATATGGTGAAACACTGTCTCTGCTAAAAATACAAAAAAAGAAAAAGAAAAAAAAAAAAAGGCTGGGCACGGTGGCTCACGCCTGTAATCTCAGCACTTTGGGAGGCTGAGGTGGGTGGATTACCTGAGGTCAGGAGTTCGAGACCAGCCTGGCCAACATGGTGAAACCTTGTCTCTACTAAAAGTATAAAAATTAGCCAGGTGTGGTGGAGGTCGCCTGTAATCCCAGCTACTCAGTAGGCAGAGGCAGAAGAATCCGTTGAACCTGGGAGGCGGAGGTTGCAGTGAGCTGAGATTGCACCAGTGCATTCCAGCCCGGGTGACAAGAGTGAGACTCTGTCTCAAAATAAACAAACAAAAAAATTAGTGGGCCGGGTTCAATGACTCACGCCGGTAATCCCAGCACTTTGGGAGGCCAAGGAAGGCAGGTCACCTGAGGTCGGGAGCTCGAGACCAGCCTGACCAACATGGAGAAACCCCGTCTCTACTAAAAATACAAAATTAGCTGGGCGTGGTGGCACATGCCTGTAATTCCAGCTACTCAGGACGCTGAGGCAGGAGAATTGCTTGAACCCAGGAGGCGGAAGTTGCAGTGAGCCAAGATCATGACATTGCACTCCCGCCTGGGCGCCAAGAGTGAGATTTCGTCTCAAACAAACAAACAAAAAAACGAATTAGTGGAGCGTGGTGGCAGGCACCTAAAGTCCCAGCTATTCAGGAGGCTGAGGCAGGAGAATTGCTTGAACCTGGGAAGTGGAGGTTATAGTGAGCTGAGATCGCGCCATTGCACTCCAGCCTGGGCAACAAGAGTGAGAATCTGTCTAAAAAAAAAAAAGAA","GGCTGGGCGCAGTGGCTCACACCTGTAATCCCAGCACTTAGGGAAGCTGAGGCGAGTAGATCACCTGAGGTCAGGAGTTAGAGACCAGCCTGGCCATCATGGTGAAACCCCGTCTCTACTAAAGATACCAAAAATTAGCTGAGTGTGGTGCTGGGTGCCTGTAATCCCAGAAACTCAGGGTGCCTGTAATCCCAGCAACTCAGGGTGCCTTTAATCCCAGCAACTGAGGGTACCAGTAATCCCAGCAACTCAGGGTGTCTTTAATCCTAGCAACTGAGGGCACCTGTAATCCCAGCAACTCAGGAAGCTGAGACAGGAGAAGTACTTGAACCCAGAAGGCAGAGGTTGCAGTGAGCCGATATTGCACCATTGCACTCCAGTCTGGGCAACAAGAGTGAAACTCTGTCTCAAAAAAAAA"
"chr15","7203590","7204226","JH378118","18053084","18053501","285","10849494","GGCCAGGTGCAGTGGCTCATGCCTCTAATCCCAGCACTTTGGGAGGCCGAGATGGGCAGATCACCGGAGGTCAGGAGTTTGAGACCAGCTTGGCCAAAATGGTGAAACCCTGTCTCTACAAAAAAATACAAAAATGGCTAGGCACGGTGGCTCACACCTGTAATCCCAGCACTTTGGGATACAGGTGGATCATGAGGTCAAGAGATCAAGATCATCTTGGCCAACATGGCAAAACCCTGTCTCTACTAAAAAATACAAAAAATTAGCTGGGCGTGGTGGTGCACGCCTGTAGTCCCAGCTACTCAGGAAACTGAGGCAAGAGAATCGCTTGAACCTGGGAGGTAGAGGTTGCAGTGAGCCGAGATGCACTCCAGCCTGGCAACAGAACAAGACTCCATCTCAAAGAACAAAAACAAAACAAAACAAAACAAAAGACAAGCAAACAAAAAAATACAAAAATTAGCTAGGTGTGGTGGCAGGCGCCTGTAATCCCAGCTACTCAGGAGGCTGAGGCAGGAGAATCGCTTGAACCTGGGAGGCGGAGGTTGCAGTGAGCCAAGATTGTGCCATTGCACTCCAGCCTAGGTGACAAGAGTGAAAAGACGTCTCAAAAACAAAACCAAAAAAAAAAATAAAA","GGCTGGGCGCAGTGGCTCACACCTGTAATCCCAGCACTTAGGGAAGCTGAGGCGAGTAGATCACCTGAGGTCAGGAGTTAGAGACCAGCCTGGCCATCATGGTGAAACCCCGTCTCTACTAAAGATACCAAAAATTAGCTGAGTGTGGTGCTGGGTGCCTGTAATCCCAGAAACTCAGGGTGCCTGTAATCCCAGCAACTCAGGGTGCCTTTAATCCCAGCAACTGAGGGTACCAGTAATCCCAGCAACTCAGGGTGTCTTTAATCCTAGCAACTGAGGGCACCTGTAATCCCAGCAACTCAGGAAGCTGAGACAGGAGAAGTACTTGAACCCAGAAGGCAGAGGTTGCAGTGAGCCGATATTGCACCATTGCACTCCAGTCTGGGCAACAAGAGTGAAACTCTGTCTCAAAAAAAAA"
"chr15","13675429","13675731","JH378235","1186107","1186418","53","12489322","GGCTTGGCACAGTGGCTCATGCCTGTAATCCCAGCACTTTGAGAGACCGAGGCAAGTGGATCCCAGGAGTTCAAGACCAGCCTGGCCAAGATGGTGAAACCCCCCATCTCTACTAAAAATACAAAAAAAAAAAAAAAAAAAAAAAAAGGGCTTAGTGGCTGGCAGCTGTAGTCCCAGCTACTCGGGAGGCTGAGGCAGGAGAATCGCTTGAACCTGGGAAGCGGAGGTTGCAGTGAGCCAAGATCACACCATTGCACTCTAGCCTGGGCAACAAGGGCAAAACTCCATCTCAAAAAAAAAGAA","GGCTGGGCGCAGTGGCTCAAGCCTGTAATCCCAGCACTTTGGGAGGCCGAGGGGGGTGGATCACGAGGTCAAGAGATCAAGACCATCCTGGTCAACATGGTGAAACCCCGTCTCTACTAAAAAAAAAAAAAAAAAAAAAAAAAAAAAAAAAAAATTAGCTGGGCATGGTGGCGTGTAATCCCAGCTACTCAGGAGGCTGAGGCAGGAGAATTGCCTGAACCCAGGAGGCGGAGTTTGCGGTGAGCCAAGATCGCGCCATTGCACTCCAGCCTGGGTAACAAGAGCAAAACTCTGTCTCAAAAAAAAAAAAAA"
"chr15","14837014","14837358","JH378137","13677298","13677634","59","1159716","GCCGGGTATGGTGGCTCATGCCTGTAATTCCAGCACTTTGGGAGGCCGAGGCAGGCGGATCACCTGAGGTCAGGAGTTTGAGACCAGCCTGGCTAACATGGTGAAACTACGTTTCTACTAAAAATACAAAAAAAAAAAAAAAAAAAAAAAAAAAAAAAAAAAAAAAAAAAATTAGCCAGGCGTGGAGGCGCGTGCCTATAATCCCAGTTACTCGGGAGGCCGAGGCAGGAGAATCGCTTGAACCCAGGAGCCGGAGGGTGTAGTGAGCCGAGATCATGCCATTGCGCTCCAGGTTGGGCAACAAGAGCAGAACTCCGTCTCAAAAAAAAAAAAAAAAAAAAAAAA","GGCTGGGCATTGTGGCTCATGCCTGTAATCCCAGCACTTTGGGAGGCCGAGGTGGGCGGATCACCTGAGGTCGGGAGTTCAAGACCAGCCTGGCCACAATGGTGAAACTCTGTCTCTGCTAAAAAAAAAAAAAAAAAAAAAAAAAAAAAAAAAAAAAAAATTAGCCAGGCGTGGTGGCACACGCCTGTAATCCCAGCTATTTGGGAGGCTGAGGCAGGAGAATCGCTTGAACCTGAGAGGTGGAGGTTGCAGTGAGCCAAGATCATACCATTGCACTCCAGCTTGGGAACAAAGAGCAAAACGCCATCTCAAAAACAAAACAAACAAACTGAAAAAA"
"chr15","20684723","20685060","JH378262","266823","267148","57","20417900","GGCTGGGCGTGTTGGCTTACACCTGAAATCCCAGCACTCTGGGAGGCCGAGGCGGGCAGATCACCTGAGGTCAGGGGTTCGAGACCAGCTTGGCCAACATGGTGAAACCCCGTCGCTACTAAAAATACAAAAATTAGCTGGGCATGGTGGTGGGAGCCTGTAATCCCAGCTACTCAGGAGACTGAGGCAGGACAATCGCTTGAACCCAGGAGGCAGAGGTTGCAGCGAGCCGAGATCGTGCCACTGCACTCCAGCCTGGGAGGGAAGAGTGAAAGTCCATAACAACAACAAAACAACAAAACAACAACAACAACAACAACAACATCTCTGAAAGGAAA","GGCCGGGCGCGGTGGCTCAAGCCTGTAATCCCAGCACTTTGGGAGGCCGAGGCGGGTAGATCATGAGGTCAGGAGTTTGAGACCAGCCTGGCCAACATGGTGAAACCCCGTCTCTACTAAAAATACAAAAATTAGCCGGGCATGGTGGCCTGTGCCTGTAATCCTAGCTACCCAGGAAGCTGAGGCAGGAGAATTGCCTGAACCCAGGAGGCGGAGGTTGCGGTGAGCCGAGATCGTGCCATTGCACTCCAGCCTGGGTAACAAGAGCGAAACTCCGTCTCAAAAACAAACAAACAAACAAACAAAAACAAAAAACAAAAAACAAA"
"chr15","20894395","20894976","JH378119","32351107","32351490","257","11456712","GGTGGCTCACACCTGTAATCCCAGCACTTTGGGAAGCCGAGGTAGGTGGATCACCTGAGGTCAGGAGTTAGAGATCAGCCTGGACAACATGGTGAAACCCCATCTCTACTAAAAATACAAAAACTAACCAGGCTTGGTGGCTCACACCTGTAATCCCATCACTTTGGGAGGCCAAGGCGGGTGGACTACTTGAGGTCAGGAGTTTGAGACCAGCCTGGCTAACATGGTGAAACCCCATCTCTACTAAAAATACAAAAATTAGCTGGGCATGGCAGTGCGCGCCTGCAATCCCAGCTACCTGGGAGGCTAAGGCAGGGGAATTGTTTGAACCTGGGAGGCAGAGGTTGCAGTGAGCCGACACTGCACCACTGCACTCCAGCCTGGGTGACAGAGTGAGCCTCCGTCTCAAAAAAAAAAAAAAAAAAAAAAAAAAATTAGCCAGGTGTGGTGGCAGGCACCTGTGATCCCAGCTACTCAGGAGGCTGAGGCAGGAGAATTGCTTGAACCCAGGAGGCGGAGAGTGCAGTGAGCTGAGATCATGCCATTGCACTCCAGCCTGGGTGACAAGAGAGAAACTCTGTC","GGCCAGGTATGGTGGCTCACACCTGTAATCCCAGCACTTTGGGAGGCCAAGGCAGGCAGACCACCTGAGGTCAGGAGTTCGAGATCAGCCTAGCCAACATGGTGAAACCCCATCTCTAGTAAAAATAAAATTAGCCAGGCATGGTGGTGCATGCCTGTAACGCAGGTCAGGAGTTCGAGATCAGCTTAGCCAACATGGTGAAACCCCATCTCTAGTAAAAATAAAATTAGCCAGGCAGGTGGTGCCGCCTGTACTCGGGAGGCTGAGGCAGGAGAATCACTTGAACCCAAGAGGCAGAGGTTGCAGTCAGCCAAGATCATGCCATTGCACTCCAGCCTAAGCAAAAAGAGTAAAACTCAGTCTCAAAACAAAAAAACAAAAAAA"
"chr15","21092189","21092737","JH378206","6546474","6546861","200","14545715","GCCGGGCGTGGTGGCTCACGCCTGGCCTGTAATCCCAGCACTTTGGGAAGCCAAGGCGGGTGGTTCACCTGAGGTCAGGAGTTCAAGACCAGCCTGGCCAACATGGTGAAACCCTGTCTCTACTAATAATACAAAAATTAGCTGGGCATGGTGGTGCATGCCTGTAATCCCAGCTACTTGGGAGGCCGAGGCGAGCAGATCACCTGAGGTCAAGAGTTCGATACCAGCCTGACCAACATAGAGAAACCCCGTCTCTACTAAAAATGCAAAATTAGCCGGGCATGGTGGTGCATGCCTGTAATCCCCAGCTACTCGGGAGGCTGAGGCAGGAGAATCGCTTGAACCTGGGAGGCAGAGGTTGTGGTGAGCTGAGATCACGCCATTGCACTCCAGCCTGGGCTCGAAACTCCATCTTAAAAAAAAAAAAAAAAAAAAGAATCACTTGAACCCAGGAGGTGGAGGTTGCAGTGAGCTGAGAGTGCACCATTGTACTCCAGCCTGGGCGACAACAGCAAAACTCCATCACCTTAAAAAAAAAAAAAAAAAAGA","GGCCACACATGGTGGCTAACGCCTGTAATCCCAGCACTTTGGGAGGCCAAGTCGGGTGGATCATGAGGTCAGGAGACCAAGACCATCCTGGCCAAATGGTGAAACCCCGTCTCTACTAAAAATACAAAAATTAGCTGGGCATGGTGGCGTGTGCCTGTAATCCCAGCTACTCAGGAGGCTGAGGCAGGACAATTGCCTGAACCCAGGAGAATTAGCTGGGCATGGTGGCGTGTGCCTGTAATCCCAGCTACTCAGGAGGCTGAGGCAGGACAATTGCCTGAACCCAGGAGGCGAAGGTTGCGGTGAGCCGAGATTGTGCCATTGCACTCCAGCCTGGGTAACAAGAGCGACACTCTGTCTCAAAAAAAAAAAAAAAAAAAAAAAAAAA"
"chr15","21150084","21150391","JH378158","10397018","10397312","55","10753066","GGCCGGGCATGGTGGCTTATGCCTGTAATCCCAGCACTTTGGGAGGCTGAGGTGGGTGGATCACCTGAGGTCAGGAGTTCAAGACCACCCTGGTCAACATGGCAAAATCCTGTCTCTACTAAAAATACAAAATTAGCTGGGCGTGGTGGTGGGCGTCTGCCTGGGTGAGGCAGGAGAATCGCTTGAACCCAAGAGGCAGAGGTTGGAGTGAGCCAAGATCGTGCCATTGCACTCCAGCCTGGGCAACGAGAGTGAAACCCCATCTCAGAAAAAAAAAAGAAAAAGAAAAAGAAAAAAGTAAAAAAAAA","GGCTGAGCACAGTGGCTCACACCTGTAATCCCAGCACTTTGGGAGGCCGAGGCGGGTGGATCACCTGAGATCAGGAGTTCAAGAACAGCCTGACCAACATGGTGAAACCTATCTCTACTAAAAATACAAAATTAGCCTGGCATGGTGGCGCGTGCCTGTAATCTGGCTGAGGCAGAAGAATCGCTTAAACCCAGAGGCAGAGATTGCAGTGAGCCAAGATTGTGTCATTGCACTCCAGCCTGGGCAACAAGAGCAAAACTCCATCTCAGAAAAAAAAAAAAAAAGAAGAAAAAAA"
"chr15","21563578","21564184","JH378118","18053084","18053501","255","3510494","GGCCAGGCATGGTGGCTCACACCTGTAATCGCAGCACTTTGGGAGACTGAGGCAAGCAGATCACCTGAGGTTAGAAGTTCAAGACCAGCCTGGCCAACACAGTGAAACCCCATCTCTACTAAAAATACAAAAAAATGGCCGGGTGCAGTGGCTCATGCCTGTAATCCCAGCACTTTGGGAGGCTAAGGCAGGGGGAATCACAAGGTCAAGAGATCAAGACCATCCTGGTAAAACCCCGTCGGTACTAAAAATACAAAAATTAGCTGGGTGAGGTGGCATGCACCTGTAGCCCCAGCTACTCGGGAGGCTGAGACAGGAGAATCACTTGAACCTGGGAGGCAGAGGTTGCAGTGAGCTGAGATCGCACCACTGCACTCCAGCCTGGCAACAGAGGAAGACTCTGTCTAAAACTAATAATAATAATAATAATAATAATAAAATTAGCTGGGAGTAGTGGCGGGCACCTGTAATCCCAGCTACTTGGGGGGGCTGAGGCAGGAGAAAAGCTTGAACCCGGGAGGTGAAGGTTGCAGTAAGCCAAGATCACGCCATTGCACTCCAGCCCGGGCAACAAGAGCGAAACTTCGTTTCAAAAAAAAAAAAAAAA","GGCTGGGCGCAGTGGCTCACACCTGTAATCCCAGCACTTAGGGAAGCTGAGGCGAGTAGATCACCTGAGGTCAGGAGTTAGAGACCAGCCTGGCCATCATGGTGAAACCCCGTCTCTACTAAAGATACCAAAAATTAGCTGAGTGTGGTGCTGGGTGCCTGTAATCCCAGAAACTCAGGGTGCCTGTAATCCCAGCAACTCAGGGTGCCTTTAATCCCAGCAACTGAGGGTACCAGTAATCCCAGCAACTCAGGGTGTCTTTAATCCTAGCAACTGAGGGCACCTGTAATCCCAGCAACTCAGGAAGCTGAGACAGGAGAAGTACTTGAACCCAGAAGGCAGAGGTTGCAGTGAGCCGATATTGCACCATTGCACTCCAGTCTGGGCAACAAGAGTGAAACTCTGTCTCAAAAAAAAA"
"chr15","22132229","22132799","JH378118","18053084","18053501","233","4079145","GGAGGCCAAGGTGGGCGAATCACCGGTGGTCAGGAGTTTGAGACTAGCCTGGCCAACATGGTGAAACCCCGTCTCTACTAAAAAATACAAAAATTAGGCCGAGTGTGGTGGCTCATGCCTGTAATCCCAGCAGTTTGGAAGGCCAAGGCGGGCAGATCACCTGAGGTCAGGAGTTCAAGACCAGCCTGGCCAACACAGTGGAACCCTGTCTCTACTAAAAATACAAAAAAAATTTGCCAGGCATGGTGGTGTGTGTGCCTATAATCCCAGCTACTCAGGAGACTGAGGCAAGAGAACTGCATGAACCCCAGAGGGAGAGGCTGCAGTGAGCTGAGATCGTACCACTGCACTCCAGCCTGGGTGACAGGGCAGGACTCCGTCTCAAAAAAAAAAAAAAAAAAAAAAAATTAGCCAGGTGTGGTGGCGAGCACCTGTAATCCTAGGTACTTGGGAGGCTGAGAAAGGAGAACCACTTGAACCCCGGAGGCAGAGGTTGCAGTGAGTGGAGATTGTGCGCCATTGCACTCCAGCCTGGGTGACAAGTGTGAAATTCTGCCTCAAAAAAAAAAAA","GGCTGGGCGCAGTGGCTCACACCTGTAATCCCAGCACTTAGGGAAGCTGAGGCGAGTAGATCACCTGAGGTCAGGAGTTAGAGACCAGCCTGGCCATCATGGTGAAACCCCGTCTCTACTAAAGATACCAAAAATTAGCTGAGTGTGGTGCTGGGTGCCTGTAATCCCAGAAACTCAGGGTGCCTGTAATCCCAGCAACTCAGGGTGCCTTTAATCCCAGCAACTGAGGGTACCAGTAATCCCAGCAACTCAGGGTGTCTTTAATCCTAGCAACTGAGGGCACCTGTAATCCCAGCAACTCAGGAAGCTGAGACAGGAGAAGTACTTGAACCCAGAAGGCAGAGGTTGCAGTGAGCCGATATTGCACCATTGCACTCCAGTCTGGGCAACAAGAGTGAAACTCTGTCTCAAAAAAAAA"
"chr15","23508255","23508883","JH378118","18053084","18053501","275","5455171","GGTCGGGTGTGGTGGCTCATGCATGTAATCCTGGCACTTTGGGAGGCCGAGGCGGGTAGATCACCTGAGGTCACGAGTTTGAGACCAGCCTGACCAACATGGTAAAACTTTGTTTCTACTACAAATACAAAAAATTGGCCAGGCTCGGTGGCTTCCGCCTGTAATCCCAGCACTTTGGGAGGCCGGGGTGCATGGATCACCTGAGGTCAGGACTTCGAGACCAGCCTGGCCAACATGGTGAAACCCCATCTCTACTAAAAATACAAAAAAAAAAAAAAAAATGAGCCAGGCATATTGGTGGGCGCCTGTAATCCCAGCTACTTGGAAGGCTGAGACAGGAGAATCACTTGAACCTGGGAGGCGGAGATTGCAGTGAGCCGAGATCATGCCACTGTACTCCATCCTGGGTGACAAGAGTGAGACTGCATCTCAAAAAAAAAAAAACCAAAAAACCAAAAAAAAACAAAAAATTAGTCAACCGTAGTGGTGGGCCCCTATAATCTCAGCTGCTCAGGAGGCTGAGGCAGTAGAATCACTTGATCCCAGGAGGTGGAGGTTTCAGTGAGCTGAGATCATGCCATTGTACTCCAGCCTGGGCAACAAGAGCGAAACTCTATCTCAAAAAATAA","GGCTGGGCGCAGTGGCTCACACCTGTAATCCCAGCACTTAGGGAAGCTGAGGCGAGTAGATCACCTGAGGTCAGGAGTTAGAGACCAGCCTGGCCATCATGGTGAAACCCCGTCTCTACTAAAGATACCAAAAATTAGCTGAGTGTGGTGCTGGGTGCCTGTAATCCCAGAAACTCAGGGTGCCTGTAATCCCAGCAACTCAGGGTGCCTTTAATCCCAGCAACTGAGGGTACCAGTAATCCCAGCAACTCAGGGTGTCTTTAATCCTAGCAACTGAGGGCACCTGTAATCCCAGCAACTCAGGAAGCTGAGACAGGAGAAGTACTTGAACCCAGAAGGCAGAGGTTGCAGTGAGCCGATATTGCACCATTGCACTCCAGTCTGGGCAACAAGAGTGAAACTCTGTCTCAAAAAAAAA"
"chr15","23602365","23603005","JH378118","18053084","18053501","286","5549281","GGTCGGGTGTGGTGGCTCATGCATGTAATCCTGGCACTTTGGGAGGCCGAGGCGGGTAGATCACCTGAGGTCACGAGTTTGAGACCAGCCTGACCAACATGGTAAAACCTTGTTTCTACTACAAATACAAAAAATTGGCCAGGCTCGGTGGCTTCCGCCTGTAATCCCAGCACTTTGGGAGGCCGGGGTGCATGGATCACCTGAGGTCAGGACTTCGAGACCAGCCTGGCCAACATGGTGAAACCCCATCTCTACTAAAAATACAAAAAAAAAAAAATGAGCCAGGCATATTGGTGGGCGCCTGTAATCCCAGCTACTTGGAAGGCTGAGACAGGAGAATCACTTGAACCTGGGAGGCGGAGATTGCAGTGAGCCGAGATCATGCCACTGTACTCCATCCTGGGTGACAAGAGTGAGACTGCATCTCAAAAAAAAAAAAAACCAAAAAACCAAAAAAAACCAAAAAATTAGTCAACCGTAGTGGTGGGCCCCTATAATCTCAGCTGCTCAGGAGGCTGAGGCAGTAGAATCACTTGATCCCAGGAGGTGGAGGTTTCAGTGAGCTGAGATCATGCCATTGTACTCCAGCCTGGGCAACAAGAGCAAAACTCTATCTCAAAAAAAAAAAAAAAAAAGAAAAA","GGCTGGGCGCAGTGGCTCACACCTGTAATCCCAGCACTTAGGGAAGCTGAGGCGAGTAGATCACCTGAGGTCAGGAGTTAGAGACCAGCCTGGCCATCATGGTGAAACCCCGTCTCTACTAAAGATACCAAAAATTAGCTGAGTGTGGTGCTGGGTGCCTGTAATCCCAGAAACTCAGGGTGCCTGTAATCCCAGCAACTCAGGGTGCCTTTAATCCCAGCAACTGAGGGTACCAGTAATCCCAGCAACTCAGGGTGTCTTTAATCCTAGCAACTGAGGGCACCTGTAATCCCAGCAACTCAGGAAGCTGAGACAGGAGAAGTACTTGAACCCAGAAGGCAGAGGTTGCAGTGAGCCGATATTGCACCATTGCACTCCAGTCTGGGCAACAAGAGTGAAACTCTGTCTCAAAAAAAAA"
"chr15","23603280","23603615","JH378109","21565230","21565567","55","2038050","GGCCAGGCGCGGTGGCTCATGCCTATAAACTCAGCACTTTGAGAGGCTGAGGCGGGTGGGTCACCTGAGGTCAGGAGTTAGAGACCAGCCTGGCCAACATGGTGAAACCGTGTTTCTACTAAAGATACAACATTAGCCAGGCATGGTGGCGCATGCCTGTAATCCCAGCTACTAGGGAGGCTGCGGCAGGAGAATCGCTTGAACGCAGGAGGTGAAGGTTGCAGTGAGCTGAGATCGTGCCATTGCACTCCAGCCTGGGTGACAAGAGCGAAACTCCATCCCAATCAATCAATCAATCAATCAATCAATTAAATTAAAAAAATAAAAAGAAAGAAA","GGCCGGGCGCGGTGGCTCAAGCCTGTAATACCAGCACTTTGGGAGGCCGAGGCGGGTGGATCACGAGGTCAAGAGATCGAGACCATCCTGGTCAACATGGTGAAACCCCGTCTCTACTAAAAATACAAACAATTAGCTGGGCATGGTGGCGGGTGCCTGTAATCCCAGCTACTCCAGAGGCTGAGGCAGGAGAATTGCCTGAACCCAGGAGACGGAGGTTGCGGTGAGCCAAGATCGCGCCATTGCACTCCAGCCTGGGTGACAAGAGCGAAACTCCGTCTCAATAAATAAATAAATAAATAAATAAATAAAAATAAAATAAATAAATAAATAAATAA"
"chr15","38315253","38315599","JH378169","5922203","5922541","56","32393050","GCCAGACACGGTGGCTCACGCCTGTAATCCCAGCACTTTGGGAGGCCGAGGCGGGTGGATCACCTGAGGTCAGGAGTTCGAGACCAGCCTGGCCAACATGGCGAAATCCTGTCTCTACTAAAAATACACACACACACACACACACACACACACACACACACACACATACACACACAAAATTAGCTGGGCATGGTGGCAGGTGCCTGTAATCCCAGCTACTTGGGAGGCTGAGGCAGGAGAATCACTTGAACCTGGGAGGCGGAGATTGCAGTGAGCCAAGATCATGCCATTGCACTTCAGCCTGGGCAACGAGAGTGAAACTCTGTCTCAAAAAAAAAAAAAAAAAA","GGCCAAGGGTGGTGGCTCACACCTGTAATCCCAACACTCTGGGAGGCCAAGGTGGGTGGATCACCTAAGGTCAGGAGTTCAAGACCAGCATGGCCAATATAGTGAAACTCTGTCTCTACTAAAAATACACACACACAAAAAAAAACAAAACACAAAAAAAACCACAAAATTAGCCGGGCATGGTGGCATGTGCCTGTAATCCCAGCTACTCAGGAGGCTGAGGCAGGAGAATCACTTAAACCCAGGAAGCGGAGGTTGCAGTGAGCCAAGATTGCGCCACTGCACTCCAGCCTAGGTGACAAGAGCAAAACTCTGTCTCAAAAAAAAAAAAAAAAAAAA"
"chr15","39410478","39411079","JH378118","18053084","18053501","249","21357394","GGCCGGGCACGGTGGCTCACGCCTGTAATCCCAGCACTTTGGGAGTCTGAGGTGGGCAGATCCACCTGAGGTCAGGGGTTCAAGACCAGCATGGCCAACATGGTGAAACCTCATCTCTACTAAAAATACAAAAATTAGGCTGGGTGCGGTGGCTCACGCCTGTAATCCCAGCACTTTGGGAGGCCAAGGCAGGTGGATCACCTGAGGTCAGGAGTTCGAGACCAGCATGGCCAACATAGCGAAAATCCGTCTCTACTAAAAACACAAAAATTAGCCAGGTGTGTTGGCTTACACCTGTAATCCCAGCTACACAGGAGGCTGAGGCAGAAGAATCACTTGAATCCAGGAGGTGGAGGTTGCAGTGAGCCGAGATCGCGCCACTGCCCTCCAGCCTGGGTGACAGAGCAAGACACCATCTCAAAAAAAAAAAAAAAAAAATTAGCTGGGCATGGTCACAGGTGCCCCTAATCCCAGCTACTCAGGAGGCTGAGGCAGGAGAATTGCTTGAACCCAGGAGACGGAGGTCACAGTGAGCGGTAATTGTGCCATTGCACTTCAACCTGGGTGACAAGAGCAAAAGTCCATCTCAAAAAAAAAAAAAA","GGCTGGGCGCAGTGGCTCACACCTGTAATCCCAGCACTTAGGGAAGCTGAGGCGAGTAGATCACCTGAGGTCAGGAGTTAGAGACCAGCCTGGCCATCATGGTGAAACCCCGTCTCTACTAAAGATACCAAAAATTAGCTGAGTGTGGTGCTGGGTGCCTGTAATCCCAGAAACTCAGGGTGCCTGTAATCCCAGCAACTCAGGGTGCCTTTAATCCCAGCAACTGAGGGTACCAGTAATCCCAGCAACTCAGGGTGTCTTTAATCCTAGCAACTGAGGGCACCTGTAATCCCAGCAACTCAGGAAGCTGAGACAGGAGAAGTACTTGAACCCAGAAGGCAGAGGTTGCAGTGAGCCGATATTGCACCATTGCACTCCAGTCTGGGCAACAAGAGTGAAACTCTGTCTCAAAAAAAAA"
"chr15","45225530","45226131","JH378133","19690365","19690767","253","25535165","GGCCGGGCACAGTGGCTCATGCCTGCAGTTCCAGCACTTTTGGAGGCCGAGGCAGGCCGATCACTTGAGGTCAGGAGTTCGAGACCACCCCGGCTAACGTGGTGCAACTCCATCTCTACTAAAAATACAAAATTGGCCGGGTGCGGTGGCTCATGCCTGTAATCCCAGCACTTTGGGAGGCCGAGGCGGATGGATCACCTCAGGTCAGGAGTTCGAGACCAGCCTGGCCAATGTGGTGAAACCCCGTCTCTACTAATAATACAAAAATTAACTGGGTGTGGTGGTGGGCACCTATAATCCCAGCTACTCGGGAAGCTGAGGCAGGAGAATCACTTGAACCTGGGAGGTGGAGATTGCAGTGAGCTGAGATGGTGCCATTACACTCCAGCCTGGGCAACGAGAGTGAAACTCTGTCTCTAAATAAATAAATACAAAATTAGCCGGGCATGGTGGCGGATGCCTATAATCACAGCTACTTGGGAGGCTGAGGCAAGAGAATCACTTGAACCTGGGAGGTGGAGGTTGCAGTGAGCTGAGATCAAGCCATTGCACTCCAGCCTGGGCAAAAAGAGTGAAACTCTGTCTCAAAAAAAAGAAAGAAA","GGCCAGGCACAGTGGTTCATGTCTGTAATCAGCATTTTGGGAGGCTGAGGCGGGAGAATCACCTGAGGCCAGGAGTTCTAGATGAGCCTGGGCAAATAGTGACAACCTGTCCCTACAAAAAAATTTAAAATTAGCCAGGATTGAGACCATCCTGGCTCACGTGGTGAAACCCCATCTTTACTTAAAATACTTAAAATGCAAAAAACATTTTTTTTTGTATTTTATTTAAAATACAAAAAAACTAGGCAGGCATGTTGGCACGTGCCTGTAGTCCCAGATACTTGGGAGGCTGAGGCAAGAGAATCACTTGAACCCAGGAGGTGGAGGTTGCAGTGAGCCGAGATCATACCACTGCACTCCAGCCTGGGTGACAAGAGTGAAACTCTGTCTCAAAAAAAAACAA"
"chr15","46581057","46581661","JH378118","18053084","18053501","254","28527973","GGCCGGGCGCGGTGGCTCACGCCTGTAGTCCCAGACTTTGGGAGGCCGAGGTGGGCGGATTGCCTGAGGTCAGGAGTTCAAGACCAACCTGGCCAACATGGTGAAATGCCGTCTCTACTAAAAATACAAAAATTAGGCCGGGCACGGTGGCTCATGTCTATAATCCCAGCACTTTGGGAGGCCGAGGTGGGCGGATCACGAGGTCAGGAGATCGAGACCATCCTGGCTAACACGGTGAAACCCCGTCTCTACTAAAAACACAAAAAATTAGCCGGGCGTGGTGGCAGGCACCTGTAGTCTCAGCTACTCAGGAGGCTGAGGCAGGAGAATGGCGTGAACTTGGGAGGCGGAGCTTGCAGTGAGCCAAGATTGTGCCACTGCACTCCAGCCTGGGCAACAGAGCGAGACTCTGTCTCAAAAAAAAAAAAAAAAATTAGCCAGGTGTGGTGGCAGGTGCCTGTAATCCCAGCTAATTGGGAGGCTAAGGCAGGAGAATCTCTTGAACCCAGGAGGCAGAGGTTGCAGTGAGCCAAGATTTCGCCATTACACTCCAGCCTGGGCAACAAGAGCTAGACTCCATCTCAAAAATAAATAAATAAAATAAA","GGCTGGGCGCAGTGGCTCACACCTGTAATCCCAGCACTTAGGGAAGCTGAGGCGAGTAGATCACCTGAGGTCAGGAGTTAGAGACCAGCCTGGCCATCATGGTGAAACCCCGTCTCTACTAAAGATACCAAAAATTAGCTGAGTGTGGTGCTGGGTGCCTGTAATCCCAGAAACTCAGGGTGCCTGTAATCCCAGCAACTCAGGGTGCCTTTAATCCCAGCAACTGAGGGTACCAGTAATCCCAGCAACTCAGGGTGTCTTTAATCCTAGCAACTGAGGGCACCTGTAATCCCAGCAACTCAGGAAGCTGAGACAGGAGAAGTACTTGAACCCAGAAGGCAGAGGTTGCAGTGAGCCGATATTGCACCATTGCACTCCAGTCTGGGCAACAAGAGTGAAACTCTGTCTCAAAAAAAAA"
"chr15","46659994","46660594","JH378118","18053084","18053501","247","28606910","GCTGGGCATGGTGGCTTACGCCTGTAATCCCAGCACCTTGGGAGGCTGAAGTGAGCAAATCACCTGAGTTCAGGAGTTCAAGACCAGCCTGGCCAACATGGTGAAAACCCATCTCTATTAAAAATTACAAAAATGGCCAGACACGGTAGCTCACGCCTGTAATCCCAGCACTTTGGGAGGCTGAGGCGGGCAGATCACCTGAGGTTGGGAGTTGGAGACCAGCTTGACCAACATGGAGAAACCCCCTCTCTACTAAAAATACAAAATTAGCCAGGCGTGGTGGCACATGCCTGTAATCCCAGCTACTTGGGAGGCTGAGGCAGGAGAATCACTTCAACCCGGAAGGTGGAGGTTGTGGTGAGCTGAGATTGTGTCATTGCACTCTAGCCTGGATAACAAAGGCAAAACTCAGTCTCAAAAAAAAAAAAAATTACAAAAATTAGCTGGCGTGGTGGCAGGTGCCTATAATCCCAGCTACTCAGGAAGCTGAGGCAGGAGAATCACTTGAAACCAGGAGGCAGAGGTTGCAGTGAGCTGAGACCACGCCATTGCCCTCCTGCCTGGGTGACAAGAGTGAAACTCCATCTCAAAAAAAAAAAAA","GGCTGGGCGCAGTGGCTCACACCTGTAATCCCAGCACTTAGGGAAGCTGAGGCGAGTAGATCACCTGAGGTCAGGAGTTAGAGACCAGCCTGGCCATCATGGTGAAACCCCGTCTCTACTAAAGATACCAAAAATTAGCTGAGTGTGGTGCTGGGTGCCTGTAATCCCAGAAACTCAGGGTGCCTGTAATCCCAGCAACTCAGGGTGCCTTTAATCCCAGCAACTGAGGGTACCAGTAATCCCAGCAACTCAGGGTGTCTTTAATCCTAGCAACTGAGGGCACCTGTAATCCCAGCAACTCAGGAAGCTGAGACAGGAGAAGTACTTGAACCCAGAAGGCAGAGGTTGCAGTGAGCCGATATTGCACCATTGCACTCCAGTCTGGGCAACAAGAGTGAAACTCTGTCTCAAAAAAAAA"
"chr15","46772064","46772669","JH378118","18053084","18053501","251","28718980","GGCTGGGTGCAATGGCTCATGCCTGTAATTCCAGTGTTTTGGGAGGCCGAGGCAGGTGGATCACTTGAGATCAGGAGTTCGCGACCAACCTGGCTAACATGGTGAAACCCCGTCTCTACTAAAAATACAAAAAATTGGCCAGGAGCGGTGGCTCAAACCTGTAATTCCAGCACTTTGGGAGGCCGAGGGGGGCAGATCACGATGTTTAGGAGTTTGAGATCAGACTGACCAACATGGTGAAACCCCATCTCTACTAAAAATACAAAAATTAGCCAGGCGTGGTGGTGCATGTCTGTAATCCCAGCTACTTGGGAGGCTGAGGCAGGAGAGTTGCTTGAAGCCGGGAGGTGGAGGTTGCAGTGAGCTGAGATCACACCACTGCACTCCAGCCTGGGCGACAGAGCAAGACTGTCTCAAAAAAAAAAAAAAAAAAAAAAATTAGCCAGCTTGGTGGCGGGCATCTGTAATCCCAGCTACTCGGGAGGCTGAGGCAGGAGAATCACTTGAACCCAGGAGGCAGAGGTCGCAGTGAGCCAAGATCACGCCATTGTACTCCAGCCTGGGCAACAAGAGCAAAACTCCATCTCAAAAAACAAAAAATAAAAA","GGCTGGGCGCAGTGGCTCACACCTGTAATCCCAGCACTTAGGGAAGCTGAGGCGAGTAGATCACCTGAGGTCAGGAGTTAGAGACCAGCCTGGCCATCATGGTGAAACCCCGTCTCTACTAAAGATACCAAAAATTAGCTGAGTGTGGTGCTGGGTGCCTGTAATCCCAGAAACTCAGGGTGCCTGTAATCCCAGCAACTCAGGGTGCCTTTAATCCCAGCAACTGAGGGTACCAGTAATCCCAGCAACTCAGGGTGTCTTTAATCCTAGCAACTGAGGGCACCTGTAATCCCAGCAACTCAGGAAGCTGAGACAGGAGAAGTACTTGAACCCAGAAGGCAGAGGTTGCAGTGAGCCGATATTGCACCATTGCACTCCAGTCTGGGCAACAAGAGTGAAACTCTGTCTCAAAAAAAAA"
"chr15","48446925","48447526","JH378118","18053084","18053501","252","30393841","GGCCAAGTGCAGTGGCTCACGTTTGTAATCCCAGCACTTTGGGAGGCCGAGGCGGGTGGATCACCTGATGTCAGGGGTTTGAAACCAGCCTGGCCAACATGGTGAAACCCCATCTCTAATAAAAATACAAAACTGGCCAGGTGCAGTGGCTCATGCCTGTAATCCCAGCACTTTGAGAGACCAAGGGAGGCAGATCACCTGAGGTCAGGAGTTCCAGACCAGCCTAGCCAACATGGTGAAACCCTATCTCTACTAAGAGTACAAAAATTAGCCTGGCGTGGTGGCAGGCGCCTGTAATCCCAGCTACTCAGAAGGCTGAGGCAGGAGAATCACTTGAACCCAGGAGGCGGAGGTTGCAGTGAGCCGAGATTGAGCCACTACACTCCAGCCTGGGTGACAAGAACAAGACTCTGTCTCAAAAAAAAAAAAAAAAAAAGCCGGTCATGGTGGCACATGCCTATAATCCCAGCTTCTTGGGAGGCTGAGGCAGGAGAACCACTTGAACCTGGGAGGTGGAGGCTGCAGTGAGCCGAAATTGTGCCATTGCACTCTAGCCTGGGCAACAAGAGCAAAACTCTCTCAAAAAAAAAAAAAAAAAAAAA","GGCTGGGCGCAGTGGCTCACACCTGTAATCCCAGCACTTAGGGAAGCTGAGGCGAGTAGATCACCTGAGGTCAGGAGTTAGAGACCAGCCTGGCCATCATGGTGAAACCCCGTCTCTACTAAAGATACCAAAAATTAGCTGAGTGTGGTGCTGGGTGCCTGTAATCCCAGAAACTCAGGGTGCCTGTAATCCCAGCAACTCAGGGTGCCTTTAATCCCAGCAACTGAGGGTACCAGTAATCCCAGCAACTCAGGGTGTCTTTAATCCTAGCAACTGAGGGCACCTGTAATCCCAGCAACTCAGGAAGCTGAGACAGGAGAAGTACTTGAACCCAGAAGGCAGAGGTTGCAGTGAGCCGATATTGCACCATTGCACTCCAGTCTGGGCAACAAGAGTGAAACTCTGTCTCAAAAAAAAA"
"chr15","59372839","59373447","JH378118","18053084","18053501","260","41319755","GGCCAGGATCAGTGTCTCACACCTGTAATCCTAGCACTTTGGGAGGCTAAGGTGGGCGGATTACTTGAGGTCAGGAGTTTGAGACCAGCCTGGGCAACATGGTGAAACCCCGTCTCTACTAAAAATACAAAAATTAGCTGGGCATAGGCCAGGAGTGGTGGCTTACGCCTGTAATTCCAGGACTTTGGGAGGCTGAGGCGGGCAGATCATGAGGTCAGGAGATTGAGACCATCCTGGCTAACATGGTGAAACCTCATCTCTACTAAAAATACAAAAATTAGCCAGTCGTGGTGGTAGGCGCCTGTAGTCCCAGCTACTTGAGAGGCTGAGGCAGGAGAATCACTTGAATCCGGGAGGTGGAGGTTGCAGTGAGCCGAGATTATGCCACTTCACTCCAACCTGGTGACAGAGCAAGACTCCGTCTAAAAAAAAAAAAAAAAATTAGCTGGGTGTGGCGGGCACTTGCAATCCCAGCTACTTAGGAGGCTGAGGCAGGAGAACCGCTTGAACCTGGGAGGTAGAGGTTCCAGATCACGCCATTGCACTCCTGCTTGGGCAACAAGAGTGACACTCCATCTCAAAAAAACAAAAAAAAAAAAGAAAAAGAAA","GGCTGGGCGCAGTGGCTCACACCTGTAATCCCAGCACTTAGGGAAGCTGAGGCGAGTAGATCACCTGAGGTCAGGAGTTAGAGACCAGCCTGGCCATCATGGTGAAACCCCGTCTCTACTAAAGATACCAAAAATTAGCTGAGTGTGGTGCTGGGTGCCTGTAATCCCAGAAACTCAGGGTGCCTGTAATCCCAGCAACTCAGGGTGCCTTTAATCCCAGCAACTGAGGGTACCAGTAATCCCAGCAACTCAGGGTGTCTTTAATCCTAGCAACTGAGGGCACCTGTAATCCCAGCAACTCAGGAAGCTGAGACAGGAGAAGTACTTGAACCCAGAAGGCAGAGGTTGCAGTGAGCCGATATTGCACCATTGCACTCCAGTCTGGGCAACAAGAGTGAAACTCTGTCTCAAAAAAAAA"
"chr15","64220715","64221335","JH378118","18053084","18053501","268","46167631","CCAGGCACAGTGGCTCATACCTGTAATCCCAGCACTTTGGGAGCCCAAGGCGGGCAGATCACCTGAGGTCAGGAGTTCGAGACCAGCCTGGACAACATGGAGAAACTCCATCTCTACTAAAAATACAAAATGAGGCCGGGCACAGTGGCTCACACCTATAATCCCAGCACTTTTGGAGGCCGAGACAGGCAGCTCACGAGGTCAGGAGTTCAAGACCAGCCTGGCCAGCATGGTGTAACCCCGTTTCTACTAAAAATACAAAAATTAGCCAGGCATGGTGGTGCGTGCCTGTAGTCCTCAGGAGGCTGAGGCAGGAGAATCGCTTGAATCTGGGAGGCGGAGCTTGCAGTCAGCTGAGATCAGGCTACTGCACTGCAGCTTGGGCAACAGAGTGAGACTCCGTCTCAAAAACAAACAAACAAACAAACAAAACACAACAAAATTAGCTGGGCATGGTGGCAGGTGCCTGTAATCCCAGCTACTCAGCTACTCAGGAGGCTGAGGCAGGAGAGTCACGTGAACCTGGGAGGCAGAGGTTGCAGTGAGCCAAGATCACGCCATTGCACTCCAGCCTGGGCAACAAGAGGGAAATTACATCTCAAAAAAAAAAAAAAAAAAAAA","GGCTGGGCGCAGTGGCTCACACCTGTAATCCCAGCACTTAGGGAAGCTGAGGCGAGTAGATCACCTGAGGTCAGGAGTTAGAGACCAGCCTGGCCATCATGGTGAAACCCCGTCTCTACTAAAGATACCAAAAATTAGCTGAGTGTGGTGCTGGGTGCCTGTAATCCCAGAAACTCAGGGTGCCTGTAATCCCAGCAACTCAGGGTGCCTTTAATCCCAGCAACTGAGGGTACCAGTAATCCCAGCAACTCAGGGTGTCTTTAATCCTAGCAACTGAGGGCACCTGTAATCCCAGCAACTCAGGAAGCTGAGACAGGAGAAGTACTTGAACCCAGAAGGCAGAGGTTGCAGTGAGCCGATATTGCACCATTGCACTCCAGTCTGGGCAACAAGAGTGAAACTCTGTCTCAAAAAAAAA"
"chr15","65873443","65873774","JH378165","3784440","3784761","45","62089003","GGCCAGGCACGGTGGCTCACACGTGTAATCCCAGCACCTTGGGAGACCGAAGCAGGTGGATCACCTGAGGTCAGGAGTTTGAGGCCAGCCTGGCCGATATGGTGAAACCCTATCTCTATTAAAAATACCAAAAAAAAAAAAAAAAAAAAAAAAACCTGCTGGGCGTGGTGGCGCACGCCTGTAATCCCAACTACTCAGGAGGCTGAGGCAGGAGAATCACTTGAATCCAGGAGGCAGAGGTTGCAGTGAGCCGAGATCGCGCCATTGCACTCCAGCCTGGGCAACAAGAGCGAAACTCGGTCTCAAAAAAAAAAAAAAAAAAAGAAAAGAAA","GGCCGGGCGCGGTGGCTCAAGCCTGTAATCCCAGCACTTTGGGAGGCCGAGGCAGGTGGATCATGAGGTCAAGAGATCAAGACCATCCTGGTCAACATGGTGAAACCCCGTCTCTACTAAAAATACAAAAAAAAAAAAAAAAAAACTAGCTGGGCGTGGTGGCGCATGCCTGTAATCCCAGCTACTCAGGAGGCTGAGGCAGGAGAATTGCTTGAACCCAGGAGGCGGAGGTTGCGGTGAGCCCAGATCGCGCCATTGCACTCCAGCCTGGGTAACAAGAGCAAAACTCCATCTCAAAAAAAAAAAAAAAAAAAAAAAAAAA"
"chr15","70453292","70453944","JH378118","18053084","18053501","292","52400208","GGCCAGGCACGGTGGCTCATGCCTGTAATCCCAACACTTTGGGAGGCTGAGGTAGGTAGATCACCTGAGGTTGAGGTCAGGAGTTTGAGACCAGCCTGGCCAACATGGTGAAACTCTGTCTCTACTAAAAATACAAAAATTTGGCCCGGCGCAGTGGCTCACCTGTAATCCCAGCACTTTGGGAGGCCGAGGCAGGCAGATCACGAGGTCTGGAGATCAAGACCATCCTGGCTAACTCGGTGAAATCCCATCTCTACTAAAAATACGAAAAATTAGCCAGGTGTGGTGGCGGGCACCTGTAGTCCCAGCTACTTGGGAGGCTGAGGCAGGAGAATGGCGTGAACCTGGGAGGTGGAGCTTGCAGTGGGCCAAGATCACGCCACTGCACTCCAGCCTGGGCAACAGAGTGAGACTCTGTCTCAAAATAAAATAACATAAAATAAAATAAAGTAATATAAAATAAAAATACAAAAATTAGCTGGGCATGGTAGCGGGTACCTATAATTCCAGCTACTTGAGAGGCTGAGGCTGGAGAATCACTTGAATCTGGGAGGTGGAGGTTGCAGTGAGCCAAGATTGCACCATTGCACTCCAGCCTGGGCAACAAGAGCCAAACTCCGTATCAAAAAAAAAAAAAAAAAGAAAAAGAAAAA","GGCTGGGCGCAGTGGCTCACACCTGTAATCCCAGCACTTAGGGAAGCTGAGGCGAGTAGATCACCTGAGGTCAGGAGTTAGAGACCAGCCTGGCCATCATGGTGAAACCCCGTCTCTACTAAAGATACCAAAAATTAGCTGAGTGTGGTGCTGGGTGCCTGTAATCCCAGAAACTCAGGGTGCCTGTAATCCCAGCAACTCAGGGTGCCTTTAATCCCAGCAACTGAGGGTACCAGTAATCCCAGCAACTCAGGGTGTCTTTAATCCTAGCAACTGAGGGCACCTGTAATCCCAGCAACTCAGGAAGCTGAGACAGGAGAAGTACTTGAACCCAGAAGGCAGAGGTTGCAGTGAGCCGATATTGCACCATTGCACTCCAGTCTGGGCAACAAGAGTGAAACTCTGTCTCAAAAAAAAA"
"chr16","217191","217526","JH378138","4229795","4230103","77","4012604","ATTTTGGGAGGCTGAGATGAGTGATGAGCGGATCACCTGAGGTCAGGAGCTCGAGACCAGTCTGGCCAACACGGTGAAACCCTGTCTCTACTAAAAGTACCAAAAAAATTAGCCAGGCATGGCAGTGGGCGCCTGTAATCCCAACTACTCGGGAGGCTGAGGCAGGAGAATCACTTGAACCTGGGAGGTGGATGTAGCAGTGAGCCGGGATCGTGCCACTGAACTCCAGCCTGGGCGATAAGATCAAAACTCTGTCTCTCTCTCACACACACACACACACACACACACACACACACACACACCCCCAAAAAAAAAAACAAAAAAAAGAAAAAGAAA","CACTTTGGGAGGTGAAGGCGGGCAGATCACCTGAGGTCAGGAGTTCGAGACCAGCCTGGCCAACATGGTGAAACCCCGCCTCTACTAAAAATACAAAAATTAGCCAGGTGTGACACTAGGCATCTGTAATCCCAGCTACTTGGGAGGCTGAGACAGGAGAATCACTTGAACCCAGGAGGCGGAAGTTGCAGTGAGCCAAGATCATGCCATTGCACTCCAGCCTGGGTGACAGGAGCAAAACTCTGTCTCAAAAAAAAAAAAAAAAAAAAAAAAAAAAAAAAAAAAAAAAGAAAAGAAAAGAAAAGTAAA"
"chr16","384893","385508","JH378118","18053084","18053501","265","17668191","GGCCGGGCGTGGTGGCTAACACGGGTAGTCCTAGCACTTTGGGAAGCCAAGGCAGGCAGATCACTTGAGGTCAGGAGTTTGAGATCAGTCTGGCCAACATGGTGAAACCACGCCTCTACTAAAAATACAAAAGTTATGGCCGAGCGTGGTGGCACGCGCCTGTAATCCCAGCACTTTGGGATGCTGAGGCAGGCGCATCACCTAAGGTCGGGAATTCAAGACCAGCCTGACCAACATGGAGAAACCACGTTTCTACTAAAAATACAAAATTAGCCGGGTGTGGTGGCACATGCCTGTAGTTTCAGCTACTCAGGAGGCTGAGGCAGGAGAATCACTTGAATCCGGGAGGCGGAGATTGTGGTGAGCCGAGATCGGGCCATTGCACTCCAGCCTGGGCAACAAGAGAGAAACTCTGTCTCAAAAAAAAAAAAAAAAAATTAGCCAGGCATGGTAGCCTGTGCCTGTAATCCCAGCTACTTGGGAGGCTGAGGCAGGAGAATCGCTTGAACCTGGGAGGCAGAGGTTGCAGTGAGCCGCGATTGCGCCATTGCACTCTCCAGCCTGGGGGAGAAGAGCAAAACTCCATCTCAAAAATAAATAAATAAATAAAAATAAA","GGCTGGGCGCAGTGGCTCACACCTGTAATCCCAGCACTTAGGGAAGCTGAGGCGAGTAGATCACCTGAGGTCAGGAGTTAGAGACCAGCCTGGCCATCATGGTGAAACCCCGTCTCTACTAAAGATACCAAAAATTAGCTGAGTGTGGTGCTGGGTGCCTGTAATCCCAGAAACTCAGGGTGCCTGTAATCCCAGCAACTCAGGGTGCCTTTAATCCCAGCAACTGAGGGTACCAGTAATCCCAGCAACTCAGGGTGTCTTTAATCCTAGCAACTGAGGGCACCTGTAATCCCAGCAACTCAGGAAGCTGAGACAGGAGAAGTACTTGAACCCAGAAGGCAGAGGTTGCAGTGAGCCGATATTGCACCATTGCACTCCAGTCTGGGCAACAAGAGTGAAACTCTGTCTCAAAAAAAAA"
"chr16","1668152","1668787","JH378118","18053084","18053501","287","16384932","GGCCGGGCACGGTGCCTCGTTCCTGTAATCCCAGCACTTTGGGAGGCCAAGGTGGGTGGATCACCTGAGGTCAGGAGTTCGAGACATGCCTGGCCAACATGGCAAAATCCTGTCTTTACTAAAAATACAAAAATTAAGCCGGGCGCTGTGACTCATGCCTGTAATCCCAGCACTTTGGGAGGCCAAGGCGGGCGGATCACAAGGTCAGGAGATTGAGACCATCCTGGCTAACACGGTGAAAACCCGTCTCTACTAAAAATACAAAAAATTAGCCAGGTGTGGTGGCGGGTGCCTGTAGTCCCAGCTACTCGGGAGGCTGAGGCAGGAGAATGGCGTGAACCCGGGAGGCGGAGCTTGCAGTGAGCCGAGATCGTGCCACTGCACTCCAGTCTGGGCAACAGAGCAAGACTCTCTCTCAAAAAGAAACAAACAAAAAAAAAAATGAAAAAAGAAAAATTAGCCAGGCGTGGTGGCGGGTGCCTATAATCTCAGCTACTCGGGAGGCTGAGGCAGAAGTATCATTTGAACCCAGGAGGCGGAGGTTGTAGTGATCCAAGATAGCGCCATTGCACTGCAGCCTGGGTGACAACAGTGAAACTCCGTCTCAAAAAAAAAAAAAAAAAAGAAAGAAAGAAA","GGCTGGGCGCAGTGGCTCACACCTGTAATCCCAGCACTTAGGGAAGCTGAGGCGAGTAGATCACCTGAGGTCAGGAGTTAGAGACCAGCCTGGCCATCATGGTGAAACCCCGTCTCTACTAAAGATACCAAAAATTAGCTGAGTGTGGTGCTGGGTGCCTGTAATCCCAGAAACTCAGGGTGCCTGTAATCCCAGCAACTCAGGGTGCCTTTAATCCCAGCAACTGAGGGTACCAGTAATCCCAGCAACTCAGGGTGTCTTTAATCCTAGCAACTGAGGGCACCTGTAATCCCAGCAACTCAGGAAGCTGAGACAGGAGAAGTACTTGAACCCAGAAGGCAGAGGTTGCAGTGAGCCGATATTGCACCATTGCACTCCAGTCTGGGCAACAAGAGTGAAACTCTGTCTCAAAAAAAAA"
"chr16","2310740","2311369","JH378118","18053084","18053501","271","15742344","GGCCGGGCACAGTGGCTCACGCCTATAATATCAGCACTTTGGGAGACCAAGGCGGGTGGATCACCTAAGGTCAGGAGTTCAAGACCAGCCTGACCAACATGGTGAAACCCCATCTCTACCAAAAATAGAAAACATTAGTCTTGGCCGGGCACGGTGACTCATACCTGTAATTCCAGCACTTTGGGAGGCCGATCACCTGGCGGATCACCTGAGGTCGGGAGTTTGAGACCAGCCTGACCAACATGGAGAAACCCCGTCTCTACTAAAAATACAAAATTAGCTGTGCGTAGTGGCCCATGCGTGTAATCCCAGCTACTCAGGAGACTGAGGCAGGAGAATGGCTTGAACCTGGGAGGCGGAGGTTGTGCTGAGCCAAGATCGCACCATTGCACTCCAGCCTGGGCAATAAGAGTGAAACTCCGTTTCATAAAACAAAAAACAAAAAACAAAAAAAAAACCATTAGCCAGGCATTGTGGCAGGCACCTGTAATCCCAGCTACTCAGGAGGCTGAGGCAGAATGGCTTGAACCGGGGAGGCAGAGGTTGCAGTGAGCCGAGATCGCGCCATTGCACTCCAGCCTGGGCAACAAAAGTAAAACTCTGTCTCAAATAAAAAAAAGAGAGAAAAAA","GGCTGGGCGCAGTGGCTCACACCTGTAATCCCAGCACTTAGGGAAGCTGAGGCGAGTAGATCACCTGAGGTCAGGAGTTAGAGACCAGCCTGGCCATCATGGTGAAACCCCGTCTCTACTAAAGATACCAAAAATTAGCTGAGTGTGGTGCTGGGTGCCTGTAATCCCAGAAACTCAGGGTGCCTGTAATCCCAGCAACTCAGGGTGCCTTTAATCCCAGCAACTGAGGGTACCAGTAATCCCAGCAACTCAGGGTGTCTTTAATCCTAGCAACTGAGGGCACCTGTAATCCCAGCAACTCAGGAAGCTGAGACAGGAGAAGTACTTGAACCCAGAAGGCAGAGGTTGCAGTGAGCCGATATTGCACCATTGCACTCCAGTCTGGGCAACAAGAGTGAAACTCTGTCTCAAAAAAAAA"
"chr16","3075498","3075819","JH378114","26407278","26407597","46","23331780","GGCCAGGCGCGGTGGCTCACACCTGTAATCCCAGCACTTTGGGAGGCCAAGGCGGGCAGATCACGAGGTCAAGAGATCGAGACCATCCTGGCCAACCTGGTGAAACTCTGTCTCTACTAAAAATACCAAAAAAAAAAAAAAAAAAAAAAAAAAAAAGCATGGTGGCAGGTGCCTGTAATCCCAGCTACTTGGGAGGCTGAGGCAGAATTGCTTGAACCCGGGAGGCAGAGGTTGCAGTGAGTTGAGATCATGCCATTGCACTCCAGCCTGGGCAAAAAGAGCGAAACTCTGTCTCAAAAAACAAAACAAAAACAAAAACAAA","GGCCGGGCGCAGTGGCTCAAGCTTGTAATCCCAGCACTTTGGGAGGCCGAGGCGGGTGGATCACGAGGTCAAGAGATCGAGACCATCCTGGTCAACATGGTGAAACCCCGTCTCTACTAAAAATACAAAAAAAAAAAAAAAAAATTAGTTGGGCATGGTGGTGTGTGCCTGTAATCCCAGCTACTCAGGAGGCTGAGGCAGGAGAATTGCCTGAACCCAGGAGGCGGAGGTTGCGGTGAGCCGAGATCGCGCCATTGCACTCCAGCCTGGGTAACAAGAGCGAAACTCCGTCTCAAAAAAAAAAAAAAAAAAAAAAAAAA"
"chr16","3161549","3162150","JH378118","18053084","18053501","252","14891535","CTGGGCACCGTGGCTCACGCCTGTAATCCCAACACTTTGGGAGGCCAAGGCGGGTGGAACACCTGAAGTCAGGAGTTCGAGACCAGTCTGGACAACATGATGAAACCCCGTCTCTACTAAAAATACAAAAAGTAGCCAGGTATGGCCGGGCGCGGTGGCTCACGCCTGTAATCCCGGCACTTTGAGAGGCCGAGGCAGGTGGATCACAAGGTCAGGAGTTCAAGAGCAGCCTGGCCAAGATAGTGAAACCCCGTCTCTACTAAAAGCAAAATTACAGTGCGCCTGTAATCCCAGCTGCTCGGGAGGCTGAGGCAGGAGAATCGCTTGAACCTGGAGGGCGGAGGTTGCAGTGAGCCAAGATCGCTCTACTGCACCCTAGCCTGGGTGACAGAGCAAGACTCTGTATCAAAAAAAAAATAAATAAATAATTAGCCAGGTATGGTGGTGCAGGCTTGTAATCCTAGCTGCTCAGGAGGCTGAGGCAGGAGAATCGATTGAACCCAGGAGACGGAGGTTGCAGTGAGCAGAGATCACACCATTGTACTCCAGCCTGAGTGACAAAAACGAAACTCCGTCTCAAAAAAAAACCAAAAAAACAAAAA","GGCTGGGCGCAGTGGCTCACACCTGTAATCCCAGCACTTAGGGAAGCTGAGGCGAGTAGATCACCTGAGGTCAGGAGTTAGAGACCAGCCTGGCCATCATGGTGAAACCCCGTCTCTACTAAAGATACCAAAAATTAGCTGAGTGTGGTGCTGGGTGCCTGTAATCCCAGAAACTCAGGGTGCCTGTAATCCCAGCAACTCAGGGTGCCTTTAATCCCAGCAACTGAGGGTACCAGTAATCCCAGCAACTCAGGGTGTCTTTAATCCTAGCAACTGAGGGCACCTGTAATCCCAGCAACTCAGGAAGCTGAGACAGGAGAAGTACTTGAACCCAGAAGGCAGAGGTTGCAGTGAGCCGATATTGCACCATTGCACTCCAGTCTGGGCAACAAGAGTGAAACTCTGTCTCAAAAAAAAA"
"chr16","3211652","3212251","JH378118","18053084","18053501","260","14841432","GTCAGACGCAGTAGTTTATGCCTGTAATCCTTGCACTTTGGGAGGCAGGTGGATCACCTGAGGCCAGGAGTTGGAGACCAGCCAGGCCAATATGGCAAAACCCCGTCTCTACTAAAAATACAAAAACTAGCCGGGCGCAGTGGCTCACACCTGTAATCCCAGCACTTTGGGAGGCTGAGGTGGGTGGATCACTAGGTCAGGAGTTCAAGACCAGCCTGGCCAACATGGTGAAACCGCGTCTCTACTAAAAACACCAAAAAATTAGCTGGGCGTGGTGGCAGTCGCCTGTAATCCCTGCTACTCGGAAGGCTGAGGCAGGAGAATCACTTGAACGCAGGAGGCAGAGGTTGCGGTGAGCCGAGATCACGCCACTGCACTCCAGCCTGGGTGACAGAGCAAGACTCTGTCTCAAAAAACAACAACAACAACTAGCTGGGCGTGGTGGCACATGCCTGTAACCCCAGCTACTCAGGAGGCTGAGGCTGAGGGAGAAAAATCGCTTGTACCTGGGAGGTGGAAGTTGCAGTGAGCGGAGATCCCACCATTGCACTCCAGCCTGGGTGACAAGAGCGAAACTCCATCTCAAAAAAAAAAAAAAAA","GGCTGGGCGCAGTGGCTCACACCTGTAATCCCAGCACTTAGGGAAGCTGAGGCGAGTAGATCACCTGAGGTCAGGAGTTAGAGACCAGCCTGGCCATCATGGTGAAACCCCGTCTCTACTAAAGATACCAAAAATTAGCTGAGTGTGGTGCTGGGTGCCTGTAATCCCAGAAACTCAGGGTGCCTGTAATCCCAGCAACTCAGGGTGCCTTTAATCCCAGCAACTGAGGGTACCAGTAATCCCAGCAACTCAGGGTGTCTTTAATCCTAGCAACTGAGGGCACCTGTAATCCCAGCAACTCAGGAAGCTGAGACAGGAGAAGTACTTGAACCCAGAAGGCAGAGGTTGCAGTGAGCCGATATTGCACCATTGCACTCCAGTCTGGGCAACAAGAGTGAAACTCTGTCTCAAAAAAAAA"
"chr16","3990675","3991277","JH378118","18053084","18053501","250","14062409","GGCTGGGCGTGGTGGCTCACGCCTTTAATCCCAGTACTTTGGGAGGCCGAGAAGGGCACATCACCTGAGGTCAGGAGTTTGAGACCAGCCTGGCCAATATGGTAAAACCCTGTCTCTACTTAAAAAATAGAAAAATCAGGCTGGACGCAGTGGCTCACGCCTGTAATCCCAGCACTTTGGGAGGCCGAGGCGGGTGGATCATGAGGTCAGGAGTTACCAGCCTGCCAACATGGTGAAACCCCATCTCTACTAAAAAAACAAAAAAAATTAGCCAGTCGTAGTGGCAGGCACCTGTAATCCCAGCCACTCGGGAGGCTGAGGCAGAGAATTGCTTGAACCTGGGAGGTGGAGATTGCTGTGCACCAAAATCACACCACTGCACTTGAGCCTGGGCGACAGAGGGAGACTCATCTGAAAAAAAAAAAAAAAAAAAAATTAGCCGGTTATGGTGGCAGGTGCCTGTGATCCCAGCTACTTGGGAGGCTGAGGCAGGAGAATTGCTTGAACCCGGGAGGCAGAGGTTGCAGTGAGCTGAGATCGCACCACTGCACTCCAGCCTGGAGGACAAGAGTGAGACTTGTCTGATTGGAAAAAAAAAAAAAA","GGCTGGGCGCAGTGGCTCACACCTGTAATCCCAGCACTTAGGGAAGCTGAGGCGAGTAGATCACCTGAGGTCAGGAGTTAGAGACCAGCCTGGCCATCATGGTGAAACCCCGTCTCTACTAAAGATACCAAAAATTAGCTGAGTGTGGTGCTGGGTGCCTGTAATCCCAGAAACTCAGGGTGCCTGTAATCCCAGCAACTCAGGGTGCCTTTAATCCCAGCAACTGAGGGTACCAGTAATCCCAGCAACTCAGGGTGTCTTTAATCCTAGCAACTGAGGGCACCTGTAATCCCAGCAACTCAGGAAGCTGAGACAGGAGAAGTACTTGAACCCAGAAGGCAGAGGTTGCAGTGAGCCGATATTGCACCATTGCACTCCAGTCTGGGCAACAAGAGTGAAACTCTGTCTCAAAAAAAAA"
"chr16","4259838","4260446","JH378118","18053084","18053501","263","13793246","GGCCGGGTGCAGTGGCTCACGCCTGTAATCGCAGGACTTTGGGAGGCCAAGGCAGGTGCATCACCTGAGGTCAGGATTTCAAGACCATCCAGCCTGATCAACATGGTGAAACCCTGTCTCTACTAAAAATATAAAAATTGGCCGGGCACAGTGACTCACGCCTGTAATCCCAGCACTTTGGGAGGCTGAGGCAGGTGGATCACAAGGTCAGGAGATCGAGACCATCCTGGCTAACACAGTGAAACCCCGTCTCTACTAAAAATATAAAAAATTAGCCGGGCGTGGTGGTAGGCACCTGTAGTCCCAGCTACTCGGGAGACTGAGGCAGGAGAATGGCGTGAACCTGGGAGGTGGAGCTTGCAGTGAGCAGAGATCGCGCCACTGTACTCCAGCCTGGGTGACAGAGCGAGACTCCGTCTCAAAAAAAAAAAAAAAAAAAAAAATTAGCTGGGCGTGGTGGCGGGCACCTGTAATCCCAGCTACTTGGGAGGCTGAGGCAGGAGAATTGCTTGAACCTGGGAAGTGGAGGTTGCAGTGAGCTGAGATTGTGCCCTTGTACTCCAGCCTGGGCAATAAAAGCAAAACTCCGTCTTAAAAAAAAAAAAAAAA","GGCTGGGCGCAGTGGCTCACACCTGTAATCCCAGCACTTAGGGAAGCTGAGGCGAGTAGATCACCTGAGGTCAGGAGTTAGAGACCAGCCTGGCCATCATGGTGAAACCCCGTCTCTACTAAAGATACCAAAAATTAGCTGAGTGTGGTGCTGGGTGCCTGTAATCCCAGAAACTCAGGGTGCCTGTAATCCCAGCAACTCAGGGTGCCTTTAATCCCAGCAACTGAGGGTACCAGTAATCCCAGCAACTCAGGGTGTCTTTAATCCTAGCAACTGAGGGCACCTGTAATCCCAGCAACTCAGGAAGCTGAGACAGGAGAAGTACTTGAACCCAGAAGGCAGAGGTTGCAGTGAGCCGATATTGCACCATTGCACTCCAGTCTGGGCAACAAGAGTGAAACTCTGTCTCAAAAAAAAA"
"chr16","4899850","4900511","JH378118","18053084","18053501","313","13153234","GGCCAGGCACGGTGGCATGCACCTGTAATCTCAGCTCTTTGGGAGGCTGAGGCAAGAGGATCACTTGAGCCCAGGAGTTGGTGATTGCAGTGAGCTCTGATCACTCCACTGCACTCCAGCCTGGGTGACAGAGTGAGATCCTGTCTCTACGAAAAAAAGACAAGACACAAATACGTTAAAAGTAAAATGATATAAAAAGATATTCCAGTGGGGCACAGTGGCTCACCCCTATAATCCCAACACTTTGGGAGGCTGAGGTGGGTGGATCACCTGAGGTCAGGAATTCAAGACCAGCCTGACCAACATGGAGAAACCCGTCTCTACTAAAAATACAAAATTAGCCGGGTGTGGTGGCACATGCCTGTAATCCCAGCTACTCAGGAGGCTGAGAATGGCTTGAACCTGGGAGGTGGAGGTTGTGGTGAGCCGAGATTGCACCACTGCACTCCAGCCTGGGCAACAAGAGCTGAAACTCCGTCGAAAAAAAAAATTAGCCTGGCGTGGTGGCGGGAGCCTGTAATCCCAGCTACTGGGGAGGCTGAGGCAGGAGAATCACTTGAACCTGGGAGGCAGAATTTGCAGTGAGCCGAGATCGCGCCACCACACTCCAGCCTGGGTGACAAAAACGAAACCCCATCTCAAAAAAATTAAAAAATAACAAA","GGCTGGGCGCAGTGGCTCACACCTGTAATCCCAGCACTTAGGGAAGCTGAGGCGAGTAGATCACCTGAGGTCAGGAGTTAGAGACCAGCCTGGCCATCATGGTGAAACCCCGTCTCTACTAAAGATACCAAAAATTAGCTGAGTGTGGTGCTGGGTGCCTGTAATCCCAGAAACTCAGGGTGCCTGTAATCCCAGCAACTCAGGGTGCCTTTAATCCCAGCAACTGAGGGTACCAGTAATCCCAGCAACTCAGGGTGTCTTTAATCCTAGCAACTGAGGGCACCTGTAATCCCAGCAACTCAGGAAGCTGAGACAGGAGAAGTACTTGAACCCAGAAGGCAGAGGTTGCAGTGAGCCGATATTGCACCATTGCACTCCAGTCTGGGCAACAAGAGTGAAACTCTGTCTCAAAAAAAAA"
"chr16","4919663","4920295","JH378118","18053084","18053501","281","13133421","CTGGGCGCAGTGGCTCACACCTATAATCCCAGCACTTTGGGAGGCCGAGGTGGGGTGGATCACTTGAGGTCAGGAGTTTGAGACCAGCCTGGCCAACATGGTGAAACCCCATCTCTTCTAGAAAAATACAAAATTAGGCTGGGCGCGGTGGCTCACGCTTGTAATCCCAGCACTTTGGGAGGCTGAGGCAGGCGGATCATCTGAGGTTGGGAGTTCGAGACCAGCCTGACCAACATAGAGAAACCCTGTCTCTACTAAAAATACAAAATTAGCCGGGCGTGGTGGCGCATGCCTGTAATCCCAGCTAGTCAGGAGGCTGAGGCAGGAGAATCCCTTGAACTGGGGAGGCAGAGGTTGTGGTGAGCCCAGATCGTGCCATTGCACTCCAGCTTGGGTAAGAAGAGCAAAACTCTGTCTAAAAAATATATATATTTATACATATATATATATTTATATATATAATTAGCCACGCATAGTGGCACACACCTGTAACCCCAGCTACCTGGGAGGATGAGGCAGGAGAATAGCTTGAACTTGGGAGGTGGAGGTTGCACTGAGCTGAGACTGCGCCATTGCATTCCAGCCTGGGCAACAAGAGCGAAACTGTCTCAAAAAAAAAAAAAAAAAAAAAAA","GGCTGGGCGCAGTGGCTCACACCTGTAATCCCAGCACTTAGGGAAGCTGAGGCGAGTAGATCACCTGAGGTCAGGAGTTAGAGACCAGCCTGGCCATCATGGTGAAACCCCGTCTCTACTAAAGATACCAAAAATTAGCTGAGTGTGGTGCTGGGTGCCTGTAATCCCAGAAACTCAGGGTGCCTGTAATCCCAGCAACTCAGGGTGCCTTTAATCCCAGCAACTGAGGGTACCAGTAATCCCAGCAACTCAGGGTGTCTTTAATCCTAGCAACTGAGGGCACCTGTAATCCCAGCAACTCAGGAAGCTGAGACAGGAGAAGTACTTGAACCCAGAAGGCAGAGGTTGCAGTGAGCCGATATTGCACCATTGCACTCCAGTCTGGGCAACAAGAGTGAAACTCTGTCTCAAAAAAAAA"
"chr16","5124255","5124811","JH378118","18053084","18053501","213","12928829","GGCCAGGTGCGGTGGCTCATGCGTGTAATCCCAGCGCTTTGGGAGGCTGAGGCAAGTGGATCACCTGAGGTCAGGAGTTTGAGACCAGCCTGGCCAACATGGGGAAATCCCTGTCTCTACTAAAAATACAAAAATTGGGCCGGGTGTGGTGGCTCACACCTGTAATCCCAGCACTTTGGGAGACTGAGGTGGGCGGATCACCCAAGGTCAGGAGTTTGAGACCATCCTGGCCAACATGGTGAAACCCCGTCTCTACTAAATAAATACAAAAAAGTAGCCGAGCGTGTTGGCGGATGCCTGTAATCCCAGCTACTTGGGAGGCTGAGGCAGGAGAATTGCTTGAACCCTGAGAGGTGGAGGTTGCAGTGAGCAGAGATTGTGCCACTGCACTCTGGCCTGGGCGACAAGAGGGAGTCTCTGTCTTAAAAAAAAAAAAAAAAAAAATTAGCTGGAAATCGCTTGAACCCAGGAGGCGGAGGTTGCAGTGAGCCGAGATTGTGCCACTGCACTCTGGCCTGGGCGACAAGAGCGAGATTCTGTCTCAAAAAAAAAAAAGA","GGCTGGGCGCAGTGGCTCACACCTGTAATCCCAGCACTTAGGGAAGCTGAGGCGAGTAGATCACCTGAGGTCAGGAGTTAGAGACCAGCCTGGCCATCATGGTGAAACCCCGTCTCTACTAAAGATACCAAAAATTAGCTGAGTGTGGTGCTGGGTGCCTGTAATCCCAGAAACTCAGGGTGCCTGTAATCCCAGCAACTCAGGGTGCCTTTAATCCCAGCAACTGAGGGTACCAGTAATCCCAGCAACTCAGGGTGTCTTTAATCCTAGCAACTGAGGGCACCTGTAATCCCAGCAACTCAGGAAGCTGAGACAGGAGAAGTACTTGAACCCAGAAGGCAGAGGTTGCAGTGAGCCGATATTGCACCATTGCACTCCAGTCTGGGCAACAAGAGTGAAACTCTGTCTCAAAAAAAAA"
"chr16","8088191","8088522","JH378114","21211700","21212024","70","13123509","GGCTGGGCGCGGTGGCTTTTGACCATAATCCCAGCACTTTGGGAGGCCGAGGTGGTCAGGTCACCTGAGGTCAGGAGTTCAAGAGCAGCCTGGCCAACGTGGTGAAACTCTGTCTCTACCAAAAATACCAAATAATAATAATAATAATAATAATAATAATAAAATAATATAATTGCAGGGTGTGGCAGCCCATGCATGTAATGCCAGCTACTTGGGAGACTGAGGCAGGATAATCACTTCAACCCAAGAGGCGGAGGTTGCAGTGAGCTGAGATCATGCCATTGCATTCCAGCGTAGGCAACAAGAGCGAAACTCTGTTTCAAATAAATAAA","GGCTGGGTGCGGTGGCTCAGGCCTGTAATCCCAGCACTTTGGGAGGCCGAGGTGGGTACATCACCTAAGGTCAGGAGTTCAAGACCAGCCTGACCAACATGGTAAAACCCTGTCTCTACTAAAATTACAAAAGAAAATTAGAAAAAAAAAAAAGAAAGAAAGAAAATTAGATGGCATGGTGGTGGCGGGCACCTGTAATTTCAACTACTCGGGAGGCTAAGGCAGGAGAATCACTTGAACCCAGGAGGTGGAGGTTGCAGTGAGCCGAGATCACACCATTGCACTGCAGCCTGGGCAATAAGAGCAAAACTCCATCTCAAAAAAA"
"chr16","9762791","9763467","JH378118","18053084","18053501","323","8290293","CAGGCATGGTAGCTCACGCCTGTAATCTCAGCACTTTGGGAGGCCGAGGTGCGCAGATCACTTGAGGTCAGGTGTTGGTGACCAGCCTGGCCAACATGGTGAAACCCTATCTCTACTAAAAATACAAAAATTATGGCCGGGCGCAGTGGCTCACGCCTGTAATCCCAGCACTTTGGGAGGCCGAGGTGGGCAGATCACTTGAGGTCAGGAGTTCAAGACCAGCCTAGGCAACATAGTGAAACCCCGTTGCTACTAAAAATACAAAAATTAGCTGGGCGTGATGGCACATACCTGTAGTCCCACCTACTTGGGAGGCTGAGGCAGGAAAATCGCTTGAACCTGGAGGCAGAGGTTGCAGCGAGCCAAGACTGTGCCAATGCACCACAGCCTGGATAACAGAGTGAGACTCAATCTCAAAAAAAAAAAAAAAAAAAAAAGGCGGGCTGGTGGCTCATGCCCATGCAAACCCCGTCTCTACTAAAAGGACAAAAATTAGCTGGGCATGGTGGCGGGGGCCTGTAATCTCAGGATTACAGGAGATACTACTACTCGGGAGGCTGAGGCAGTAGAATTGCTTGAACCAGGGAGGCGGAGGTTGCAGTGAGCTGAGATCGCGCCATTGCACTCCAGGCTGGGTGACAACAATGACTCCGTCTCAAAAACAACAACAACAACAA","GGCTGGGCGCAGTGGCTCACACCTGTAATCCCAGCACTTAGGGAAGCTGAGGCGAGTAGATCACCTGAGGTCAGGAGTTAGAGACCAGCCTGGCCATCATGGTGAAACCCCGTCTCTACTAAAGATACCAAAAATTAGCTGAGTGTGGTGCTGGGTGCCTGTAATCCCAGAAACTCAGGGTGCCTGTAATCCCAGCAACTCAGGGTGCCTTTAATCCCAGCAACTGAGGGTACCAGTAATCCCAGCAACTCAGGGTGTCTTTAATCCTAGCAACTGAGGGCACCTGTAATCCCAGCAACTCAGGAAGCTGAGACAGGAGAAGTACTTGAACCCAGAAGGCAGAGGTTGCAGTGAGCCGATATTGCACCATTGCACTCCAGTCTGGGCAACAAGAGTGAAACTCTGTCTCAAAAAAAAA"
"chr16","9769317","9769634","JH378153","10517405","10517727","57","748088","GGTTGGGCATGGTGGCTCACACCTGTAATGCCAGCACTTTGGGAGGCGGGCAGATCACCTGAGGTCAGGAGTTCAAGACCAGCCTGGCCAACATGGTGAAATCCTGTCATTACAAAAATACAAAAAAAAAAAAAAAAAAAAAAAAAAAAAGCCAGTAATGATAGTGGGTGCGTATAATCCCAGCTACTTTGGAGGCTAAGGCAGGAGACTCACTTGAACCCAGGAGGCGGAGGTTATGGTGAGCCGAGATCACACCATTGCACTCCAGCCTGGGCGACAAGAGCAAAACTCCATCTCAAAAAAAAAAAAAAAAAAAAA","GGCCGGGCGTGGTGGCTCACGCCTGTAATCCCAGCACTTTGGGAGGCCGAGGTGGGTGGATCATGAGGTCAAGAGATCGAGACCATCCTGGTCAACATGGTGAAACCCTGTCTCTACTAAAAAAAAAAAAAAAAAAAAAAAATACAAAAAAATTAGCTGGGCATGGTGGCGCATGCCTGTAATCCCAGCTACTCCGGAGGTTGAGGTAGGAGAATTGCCTGAACCCAGGAGGCGGAGGTTGCGGTGAGCCGAGATCGCGCCATTGCACTCCAGCCTGGGTAACAAGAGCAAAACTCCGTCTCAAAAAAAAAAAAAAAAAAGAA"
"chr16","13753079","13753710","JH378118","18053084","18053501","278","4300005","GGCTGATTGTGATGGCTCACACTTGTAATCCCCTCACTTTGGGAGGCCAAAGCGGGAGCATCACCTGAGGTCAGGAGTTCAAGACCAGCCTGGCCAACATGGTGAAACCCCATCTCTACTAAAAATAAAAAATTAGCTGGGCACAGTGACTCATGCCTGTAATCCCAGCACTTTGGGAGGCCGAGGCAGGCAGATCACAATCACGAGGTCAGGAGTTCGAGACCAGCCTGACCAACATGGTGAAACCCCGTCTCTACTAAAAATAGAAAAATTAGCCAGGCGTGGTGGCACACGCCTGTAATCCCAGCTCCTCAGGAGACTGAGGCAGGAGAATCACTTGAACCCAGGAGGTGGAGGTTGCAGTGAGCAGAGATCGCACCACTGCACTCCAGCCTGGGTAACAGAGTGAGACTCCGTCTCAAAAAAAAAAAAAAAAAAAAAAAAAAAACGAAATTAACCAGGTGTGGTGGCACATGCCTGTAATCCCAGCTACTTGGGAGGCTGAGGCAGGAGAATCGCTTGAACCCGGGAGACAGAGGTTCCAGAGAACTGAGATCATGCCATTGCACTCCAGCCTGGGCAACAAGAGTGAAACTCCATCTAAAAAATAAATAAATACATAAACAAACAAA","GGCTGGGCGCAGTGGCTCACACCTGTAATCCCAGCACTTAGGGAAGCTGAGGCGAGTAGATCACCTGAGGTCAGGAGTTAGAGACCAGCCTGGCCATCATGGTGAAACCCCGTCTCTACTAAAGATACCAAAAATTAGCTGAGTGTGGTGCTGGGTGCCTGTAATCCCAGAAACTCAGGGTGCCTGTAATCCCAGCAACTCAGGGTGCCTTTAATCCCAGCAACTGAGGGTACCAGTAATCCCAGCAACTCAGGGTGTCTTTAATCCTAGCAACTGAGGGCACCTGTAATCCCAGCAACTCAGGAAGCTGAGACAGGAGAAGTACTTGAACCCAGAAGGCAGAGGTTGCAGTGAGCCGATATTGCACCATTGCACTCCAGTCTGGGCAACAAGAGTGAAACTCTGTCTCAAAAAAAAA"
"chr16","13951847","13952482","JH378118","18053084","18053501","292","4101237","GGCCAGGTGCGGTGGCTCATGCCTGTAATCCCAGCACTTTGGGAGGCTATGGCAGCGGATAACCTGAGGTCACAAGTTTGAGACCAGCCTGGCAAACATGGTGAAACCGTCTCTACTAAAAATACAAAAATTACACCAGGCGCGGTGGCTCATGCCTGTAATCCCAGCACTTTGGAAGGCCGAGGCAGGTGGATCATGAGGTCAGGAGATCAAGACCATCCTGGCTAACGCAGTGAAACCCCGTCTCTACTAAAAATATAAAAAATTGGCCAGGCGTGGTGGCGGACGCCTGTAGTCCCAGCTACTCGGGAGGCTGAGCCAGGAGAATGGCGTGAACCCGGGAGGCGGAGCTTGTGGTGAGCCGAGATAGCGCCACTGCACTGCCGCCTGGGTGACAGAGTGAGACTCTGTCTCAAAAAACAAAACAAAACAAAAACCAAAAACAAAAACAAAAAAACAAAAATTAGCCAGGTGTGGTGGTGCACGCCTGTCATCCCAGCTACTTGGGGGGCTGAGACGTGATAATCACTTGAACCCGGGAGGGAGAGGTTGCAGTGAGTGGAGATCACGCCATTGTATTCCAGCCTGGGGGCAAGAGCAAAACTCTGTCTCAAAAACAACAACAACAACAACAAA","GGCTGGGCGCAGTGGCTCACACCTGTAATCCCAGCACTTAGGGAAGCTGAGGCGAGTAGATCACCTGAGGTCAGGAGTTAGAGACCAGCCTGGCCATCATGGTGAAACCCCGTCTCTACTAAAGATACCAAAAATTAGCTGAGTGTGGTGCTGGGTGCCTGTAATCCCAGAAACTCAGGGTGCCTGTAATCCCAGCAACTCAGGGTGCCTTTAATCCCAGCAACTGAGGGTACCAGTAATCCCAGCAACTCAGGGTGTCTTTAATCCTAGCAACTGAGGGCACCTGTAATCCCAGCAACTCAGGAAGCTGAGACAGGAGAAGTACTTGAACCCAGAAGGCAGAGGTTGCAGTGAGCCGATATTGCACCATTGCACTCCAGTCTGGGCAACAAGAGTGAAACTCTGTCTCAAAAAAAAA"
"chr16","19006984","19007584","JH378118","18053084","18053501","263","953900","GGTGGCTGATGCCTGTAAACCCAGCATTTTGGGAGGCCGAGGCTGGTGGATCACCTGAGGTCAGGTGTTCGAGACCAGTCTGGCCAACATGGTGAAACCTCGTCTCTACCAAAAATACAAAAATTAGTTGGGTGTGGCCGGGTGTGGTGGCTTACGCTTGTAATCTCAGCACTTTGGGAGGCCGAGGTGGGTGGATCACGAGGTCAGGAGTTCAAGACCAGCCTGGCCAAGATGGTGAAACCCTGTCTCTACTAAAAATACAAAAAATTAGCCAGGCATGGTGGCGGGTGCCTGTAATCCCAGCTACTCGGGAGGCTGAGGCAGAGAATTGCTTGAACCTGGGAGGTGGAGGTTGCAGTGAGCCGAGATTGTGCCACGACACTCCAGCCTGGGTGACAGAGCGAGACTCTGTCTAAAAAAAAAAAAAAAAATTAGTTGGATGTGGTGGTGGGTGTCTGTAATCTCAGCTACTCAGGAGACTGAATCAGGAGAATCACTTGAACCCAGGGGGCTGGAGGTTGCAGTGAGCCGAGATCTTGCCATTGCACTCCAGCCCGGGCGACAAGAGCAAAACTCTCTTTCAAAAAAAAAAAAAAAAAGA","GGCTGGGCGCAGTGGCTCACACCTGTAATCCCAGCACTTAGGGAAGCTGAGGCGAGTAGATCACCTGAGGTCAGGAGTTAGAGACCAGCCTGGCCATCATGGTGAAACCCCGTCTCTACTAAAGATACCAAAAATTAGCTGAGTGTGGTGCTGGGTGCCTGTAATCCCAGAAACTCAGGGTGCCTGTAATCCCAGCAACTCAGGGTGCCTTTAATCCCAGCAACTGAGGGTACCAGTAATCCCAGCAACTCAGGGTGTCTTTAATCCTAGCAACTGAGGGCACCTGTAATCCCAGCAACTCAGGAAGCTGAGACAGGAGAAGTACTTGAACCCAGAAGGCAGAGGTTGCAGTGAGCCGATATTGCACCATTGCACTCCAGTCTGGGCAACAAGAGTGAAACTCTGTCTCAAAAAAAAA"
"chr16","19554918","19555551","JH378118","18053084","18053501","281","1501834","GGCCGGGCGCAGTGGCTCACACCTGTAATCCCAGCACTTTGGGAGGCCGAGGCGGGTGGATCACTTGAGGTCAGGAGTTCAAGACCAGCCTGGCTGACATGGTGAAACCCTGTCTCTACTGAAAACACAAAAATTAGGCCGGGCATAGTGGCTCATGCCTGTAATACCAGCACTTTGGGAGGCCGAGGTGGGTGGATCACCTGAGGTCAGGAGTTTGAGACCAGCTTGACCAACATGGTGAAACCCCGTCTCTACTAAAAATATAAAAATTAGTCTGGCATGGTGGCAGATGCCTGTAATCCCAGCTACTCAGGAGGCTGAGGCAGGAGAATTGCTTGAACCTGGAAGGTGGAGGTTGTAATGAGCCAAGATCACACCACTGCACTCCAGCCACTGTACTCCAGCCTGGGTGACAGAGTGAGACTCTGTCTCAAAAAACATACATACACACACATACACACACACACACACACACACACAAATTAGCTGGACGTGATAGCACACCCCTGTAGTCCCAGCTGCTTGAGAGACCGAGGCACAAGAATCACACGAACCCGGGAGGCGGAGGTTCCTGTGAGCCAAGATCGCACCATTGTACTCCATTCTGGGTGACAAGAGTGAAGCTCTGTCTCAA","GGCTGGGCGCAGTGGCTCACACCTGTAATCCCAGCACTTAGGGAAGCTGAGGCGAGTAGATCACCTGAGGTCAGGAGTTAGAGACCAGCCTGGCCATCATGGTGAAACCCCGTCTCTACTAAAGATACCAAAAATTAGCTGAGTGTGGTGCTGGGTGCCTGTAATCCCAGAAACTCAGGGTGCCTGTAATCCCAGCAACTCAGGGTGCCTTTAATCCCAGCAACTGAGGGTACCAGTAATCCCAGCAACTCAGGGTGTCTTTAATCCTAGCAACTGAGGGCACCTGTAATCCCAGCAACTCAGGAAGCTGAGACAGGAGAAGTACTTGAACCCAGAAGGCAGAGGTTGCAGTGAGCCGATATTGCACCATTGCACTCCAGTCTGGGCAACAAGAGTGAAACTCTGTCTCAAAAAAAAA"
"chr16","19576859","19577465","JH378118","18053084","18053501","251","1523775","GGCCAGGCATGGTGGCTCACACCTGTAATCCCAGCCCTTTGGGAGGCCGAGGCAGGTGGATCACCTGAGGTCAGGAGTTCGAGACCAGCCTGGCCAACATGGTGACACCCCACTCTACCAAAAATACAAAAATTAGGTTGGGTGCAGCGGTTCACACCTGTAATCCCAGCACTTTGGGAGGCCAAGGTGGATGGATCACCTGAGGTCAGGAGTTTGTGACCAGCCTGGCCAACATGGCGAAACCCTGCCTCTACTAAAAATAAAAAATTAGCCAGGTGTGGTGGCATGCGCCTGTAATCCTAGCTACTGAGGCAGGAGAATCGCTTGGACCAGGGAAGCAGAGTTTGCAGTGAGCCAAGATCACGCCACTGCACTCTAGCCTGGGTGACAGAGTAAGACTCCATCTCAAAAAAAAAAAAAAATACAAATATTAGCTGGGCATGGTGGCGCACACCTGTAGTTCTGGCTACTCAGGAGGCTGAGGCAGGAGAATTGCTTGAACCCAGAAGGCAGAGGTTGCAGTGAGCTGAGATTGTGCCATTGCACTCAGCCTGGGCAACAAAAGTGAAACTCCATCTCAAAATAAATAGATAAATAAATAAATAAA","GGCTGGGCGCAGTGGCTCACACCTGTAATCCCAGCACTTAGGGAAGCTGAGGCGAGTAGATCACCTGAGGTCAGGAGTTAGAGACCAGCCTGGCCATCATGGTGAAACCCCGTCTCTACTAAAGATACCAAAAATTAGCTGAGTGTGGTGCTGGGTGCCTGTAATCCCAGAAACTCAGGGTGCCTGTAATCCCAGCAACTCAGGGTGCCTTTAATCCCAGCAACTGAGGGTACCAGTAATCCCAGCAACTCAGGGTGTCTTTAATCCTAGCAACTGAGGGCACCTGTAATCCCAGCAACTCAGGAAGCTGAGACAGGAGAAGTACTTGAACCCAGAAGGCAGAGGTTGCAGTGAGCCGATATTGCACCATTGCACTCCAGTCTGGGCAACAAGAGTGAAACTCTGTCTCAAAAAAAAA"
"chr16","19983557","19984148","JH378118","18053084","18053501","244","1930473","GGCCGAGTGCGGTGGCTCATGCCTGTAATCCCAGCACTTTGGGAGGCCGAGACAGGTGAATCACCTGAGGTCTGGAGTTTGAGACCAGCTGACCAACATGGTGAAACCCTGTCTCTACTAAAAATACAAAAAATTGGCTGAGCGCAGTGGCCACGCCTGTTATCCCAGTACTTTGGGAGGCCGAGGCGGGTGGATCACGAGGTCAGGAATTCGAGACCAGCCTGACCAACATGGTGAAGCCCCGTCTCTACTAAAAATAAAAAAATTAGCCAGGTGTGGTGGTGCGCCCCTGTAAACCCAGCTACTCAGGAGGCTGAGGCAGGAGAATCACTTGAATCTGGGAGGCGGAGGTTGCAGTGAGCCAAGATCGAGCCACTGTACTCCAGCCTGGGAGACGGAGTGAGACTCCATCTAAAAAAAAAAAAAAATTAGCCAGGCGTGGTGGCACAAGCCTGTAATCCCAGCTACCTGGGAGGCTGAGATAGGAGAATTCCTTGAATCTGGGAGGCGGAGGTTGCAGTGAGCTGAGATTGTGCCATTGCACACCAGCCTGGGTGACAAGAGCAAAATTCCATCTCAAAAAAAAAAAAAA","GGCTGGGCGCAGTGGCTCACACCTGTAATCCCAGCACTTAGGGAAGCTGAGGCGAGTAGATCACCTGAGGTCAGGAGTTAGAGACCAGCCTGGCCATCATGGTGAAACCCCGTCTCTACTAAAGATACCAAAAATTAGCTGAGTGTGGTGCTGGGTGCCTGTAATCCCAGAAACTCAGGGTGCCTGTAATCCCAGCAACTCAGGGTGCCTTTAATCCCAGCAACTGAGGGTACCAGTAATCCCAGCAACTCAGGGTGTCTTTAATCCTAGCAACTGAGGGCACCTGTAATCCCAGCAACTCAGGAAGCTGAGACAGGAGAAGTACTTGAACCCAGAAGGCAGAGGTTGCAGTGAGCCGATATTGCACCATTGCACTCCAGTCTGGGCAACAAGAGTGAAACTCTGTCTCAAAAAAAAA"
"chr16","20117717","20118289","JH378118","18053084","18053501","224","2064633","GGCTGGGTGCGGTGGCTCACGCCTGTAATCCCAGCACTTTGGGAGGCCAAGGCGGGTAGATCATCTGAGGTCAGGAGTTCAAGACCAGCCTGGCCAACATGGTGAAACCCCGTCTCTACTAAAAATATTTTTAAAAGGCCAGGCGTGGTGGCTCACGCCTGTAATCCCAGCACTTTGGGAGGCCGAGGCGGGCAGATCATGAGGTCAGGAGTTCGAGACCATCCTGGCTAACACGGTGAAACCCCCGTCTCTACCAAAAAATACAAAAAATTAGCCGGGCATGGTGGCAGGTGCCTGTAGTCCCAGCTACTCGGGAGGCTGAGGCAGGAGGATGGCGTGAACCCAGGAGACAGAGCTTCCAGTGAGCTGAGATCGTGTCACTGCACTCCAGCCTGGGCGACAGAGGAGATTCTGTCTCAAAAAAAAAAAAAAAAAATTAGCTTGGTGTGGTGGCAGGTGCCTGTAATCCCAGTTACTCGGGAGGCTGAGGCAGAGGTTTCAGTGAACCGAGATCGCGCCATTGCACTCCAGCCTGGGCAACAAGAGTGAAACTCCGTCTCAAAGGAAAAAAAA","GGCTGGGCGCAGTGGCTCACACCTGTAATCCCAGCACTTAGGGAAGCTGAGGCGAGTAGATCACCTGAGGTCAGGAGTTAGAGACCAGCCTGGCCATCATGGTGAAACCCCGTCTCTACTAAAGATACCAAAAATTAGCTGAGTGTGGTGCTGGGTGCCTGTAATCCCAGAAACTCAGGGTGCCTGTAATCCCAGCAACTCAGGGTGCCTTTAATCCCAGCAACTGAGGGTACCAGTAATCCCAGCAACTCAGGGTGTCTTTAATCCTAGCAACTGAGGGCACCTGTAATCCCAGCAACTCAGGAAGCTGAGACAGGAGAAGTACTTGAACCCAGAAGGCAGAGGTTGCAGTGAGCCGATATTGCACCATTGCACTCCAGTCTGGGCAACAAGAGTGAAACTCTGTCTCAAAAAAAAA"
"chr16","20574957","20575888","JH378118","18053084","18053501","543","2521873","GGCCAGGCGTGGTGGCTCATGCCTGTAATCCCAGCACTGTGAGAGGCCGAGGCGGGCGGATCACCTGAGCTGAGGAGTTCGAGACCAGCCTGGCCAACATGGCGAAACCCCATCTCTACTAAAAACACAAAAATTAGGCCAGGTGTGGTGGCTCACACCTGTAATCCCAGCACTTTGGGAGGCCAAGGCGGGCGGATCACCTGAGGTCAGGAGTTCCAGACCTGCCTGGCCAACATGGTGGAATCCCATCTCTACTAAAAATACAAAAATCTGCCAGGTGTGGTGGCACACTTCTGTAATCCCAGATACTCAGGAGGCTGAGGCAGGAGAATCACTTGAACCCTGGAGATGGAGGTTGCAGTGAGCCAAGATCAAGAGATTGCACTCTAGCCAGGGTGACTAGAGTGAGACTCGGTCTCAAAAAAAATGTAATTAATTAATTAATTAATACAAAAATTAGCTGGGCGTGGGCTAGGTGTGGTGGCTCACGCCTGTAATCCCAGCACTTTGGGAGGCCGAGACAGGCGGATCACCTGAGGTCAGGAGTTCAAGACCAGTTTAACCAACATGGAGAAACCCCATCTCTACTAAAAATACAAAATTAGCTGGGCGTGGTGGTGCATGCCTGTAATCCCAGCTACTCGGGAGGCTGAGGCAGAAGAATCGCTTGAGCCTGGTAGGCGGAGATCGTGGTGAGCCGAGATCGCGCCATTGCACTCCAGCCTGGACAACAAGAGCGAAACTCCGTCTAAAAAAAAAAAAAAAATTAGCTGGGCATGGTAACAGGCGCCTGTAAACCCAGTTTCCTCGGGAGGCTGAAGCAGAATTGCTTGATCCCAGAGGCAGAGGTTGCAGTGAGCCAAGATAGTGCCATTGCAGTCCAGCCTGGGCAACAAGAGTGAAACTCCGTCTCAAAAAAAAAAAAAAAAAAA","GGCTGGGCGCAGTGGCTCACACCTGTAATCCCAGCACTTAGGGAAGCTGAGGCGAGTAGATCACCTGAGGTCAGGAGTTAGAGACCAGCCTGGCCATCATGGTGAAACCCCGTCTCTACTAAAGATACCAAAAATTAGCTGAGTGTGGTGCTGGGTGCCTGTAATCCCAGAAACTCAGGGTGCCTGTAATCCCAGCAACTCAGGGTGCCTTTAATCCCAGCAACTGAGGGTACCAGTAATCCCAGCAACTCAGGGTGTCTTTAATCCTAGCAACTGAGGGCACCTGTAATCCCAGCAACTCAGGAAGCTGAGACAGGAGAAGTACTTGAACCCAGAAGGCAGAGGTTGCAGTGAGCCGATATTGCACCATTGCACTCCAGTCTGGGCAACAAGAGTGAAACTCTGTCTCAAAAAAAAA"
"chr16","20816618","20817242","JH378118","18053084","18053501","267","2763534","GGCCCGGCGTGGTGGCTCATGCCTGTAATCCCAGCACTTTGGGAGGCCGAGGCCGGCGGATCACCTGAGGTCAGGAGTTTGAGACCACCCTGGCCAACACGGTGAAAACCTGTCTCTACTAAAAATACAAAAATTAGCCAGGCGCAGTGGCTCACGTCTGTAATTCCAGCACTTTGGAGGGCCGAGGGGGGCAGATCACAAGGTCAGGAGTCCAAGACCAGCCAGGCCAACATAGTGAAACCCGGTCTCTACTAAAAATACAAAAAATTAGCCGGGCGTGGTGGCGGACCCCTGTAGTCCCAGCTACTCAGGAGGCTGAGACAGGAGAATCTCTTGAACCCAGGAGGCAGAGGTTGCAGTGAGCCAAGATCATGCCATTCCACTCCAGCCTGGGCGACAGTGCAAGACTCTGTCTCAAAAACAAAAACAAAAAACCCCCAAACCAAAAATTAGCCAGGCGTGGTGGCATGCACCTGTAGTCCCAGCTACTTGGGAGGCTAAGGCAAGAGAATAGCTTGAACCCAGGAGGCAGAGGTTGCAGTGAGCCGAGATAGTGCCATTGCACTCCAACGTGGGTGACAAGAGCAAAACTCTGTCTCAAAAAAAAAAAAAAAAAAGGAAGGAA","GGCTGGGCGCAGTGGCTCACACCTGTAATCCCAGCACTTAGGGAAGCTGAGGCGAGTAGATCACCTGAGGTCAGGAGTTAGAGACCAGCCTGGCCATCATGGTGAAACCCCGTCTCTACTAAAGATACCAAAAATTAGCTGAGTGTGGTGCTGGGTGCCTGTAATCCCAGAAACTCAGGGTGCCTGTAATCCCAGCAACTCAGGGTGCCTTTAATCCCAGCAACTGAGGGTACCAGTAATCCCAGCAACTCAGGGTGTCTTTAATCCTAGCAACTGAGGGCACCTGTAATCCCAGCAACTCAGGAAGCTGAGACAGGAGAAGTACTTGAACCCAGAAGGCAGAGGTTGCAGTGAGCCGATATTGCACCATTGCACTCCAGTCTGGGCAACAAGAGTGAAACTCTGTCTCAAAAAAAAA"
"chr16","21054922","21055508","JH378118","18053084","18053501","243","3001838","GGCCGGGTGCGGTGGCTCACACCTATAATCCCAGCACTTTGAGAGTCTGAGGCAGGCGGATCACCTGAGGTCAGGAGTTCCAGACCAGCCTGGCCAACATGGTGAAACCCAGTCTCTACTAAAAATACAAAAAAAGACCGGGCACAGTGGCTCACGCCTGTAATTCCAGCACTTTGGGAGGCCGAGGCAGGTGGATCACCTGAGGTTGGGAGTTCGCGACCAGCCTGACCGACATGGAGAAATCCCATCTCTACTAAAAATACAAAATTAGCCGGGCGTGGTGGCACATGCCTGTAATTCCAGCTACTCAGGAGGCTGAGGGAGGAGAATCACTTGAACCTGGGAGGCGGAAGTTGTGGCGAGCCAAGATCACGCCATTGCACTCCAGCCTGGGCAACAAGAGTGAAACCCCATTTCAAAAAAAAAAAAAATTAGCCAGGGGTGGTGGTGCATTCTTGTAATACCAGCTACTCGGGAGGCTGAGGTAGGAGAATCACTTGAGCGCAGGAGGCAGATGTTGTAGTGAGCCGAGTGCCATTGCACTACAGCCTGGGCGACAAGAAAGTAACTCCACCTCAAAAAAAAAA","GGCTGGGCGCAGTGGCTCACACCTGTAATCCCAGCACTTAGGGAAGCTGAGGCGAGTAGATCACCTGAGGTCAGGAGTTAGAGACCAGCCTGGCCATCATGGTGAAACCCCGTCTCTACTAAAGATACCAAAAATTAGCTGAGTGTGGTGCTGGGTGCCTGTAATCCCAGAAACTCAGGGTGCCTGTAATCCCAGCAACTCAGGGTGCCTTTAATCCCAGCAACTGAGGGTACCAGTAATCCCAGCAACTCAGGGTGTCTTTAATCCTAGCAACTGAGGGCACCTGTAATCCCAGCAACTCAGGAAGCTGAGACAGGAGAAGTACTTGAACCCAGAAGGCAGAGGTTGCAGTGAGCCGATATTGCACCATTGCACTCCAGTCTGGGCAACAAGAGTGAAACTCTGTCTCAAAAAAAAA"
"chr16","27896431","27896766","JH378166","6401112","6401453","56","21495319","GGCCAGGCGCGGTGGCTCACGCCTGTAATCCCAGGACTTTGGTAGTCCAAGGCGGGTGGATCACCTGAGGTCAGGAGTTCAAGATCAGCCTGACCAACATGGCAAAACCTCGTCTCTACTAAAAAATACAAAAATTAGCCGGTGTGGTGGCAGGTGCCTGTAATTCCAGCTACTCGGGACGCTGAGTCATGAGAATTGCTTGAACCTAGGAGGCAGATGTTGCAATGAGCCGAGATCGCACCATTGTACTCCAGCCTGGGCGACAAGAGGGAAACTGTCTCCAAAAAAAAAAAAGAAAGAAAGAAAGAAAGAAAGAAAAAAGAAAAACAAAACAAA","GGCCAGGTGCAGTGGCTCACCCCTGTAATCCCAGCACTTTGGGAGGTCGAGGTGGGTGGATCACCTGAGGTCAGGAGTTCAAGACCAGCCTGACCAAAATGGTGAAACCCCATCTCTACTAAAAATACAAAACATTAGCCAGACATCGTGGCGGGCACCTGTAATCCCAGCTACTTGGGAGGCTGAGGCAGGAGAATTGCTTGAGCCTAGGAGGCGGAGGTTACAGTGAGCCATGATCGTGCCATTGGACTCCAGCCTGGGCTACAAGAGCGAGACTCCATCTCAAAAAAAAAAAAAAAAAAAAAAAAGAAAGAAAGAAAGAAAGAAAGAAAAGAAAGAAAG"
"chr16","36524888","36525430","JH378206","6546474","6546861","201","29978414","TTTGAGACCAGCCTGGCCATTGTGGTGAAACCCCGTCTCTACTAAAAAAAATTCAAAAAATGGCTGGGTATGGTGGCTCACGCCTGTAATCCCAGGACTTTGGGAGGCCAAGGTGGGCGGATCACCTGAGGTCAGGAGTTTGAGACCAGCCTAGCCAACATGGTGAAACCCCGTCTCTACCAAAAATACAAAAATTAGCCGGGCTTGGTGGCGCGCACCTGTAATCCCAGGTACACTGGAGGTTGAGGCACAAGAATCGTTTGATCCTGGGAGGTTGCAGTGAGCCAAGATCACGCCACTGCACTCCAGACTGGGTGACAGAGCGAGATTCCATCTCAAAACAACAACAACAAACCCAAAAAATTAGCTGGGTGTGGTGGTGGGTGCCTGTAATCCCAGCTACTTAGGAGGCTGAGGCAGAAGAATCGCTTGAACCCAGGAGGTGGAGGTTGTTGCAGTGAGCAGAGATCGCACCATTGCACTCCAGCCTGGGCAACGAGTGAAACTCCATCTCAAAAAAAAAAAAAAAAAAAGAAAAAAAAA","GGCCACACATGGTGGCTAACGCCTGTAATCCCAGCACTTTGGGAGGCCAAGTCGGGTGGATCATGAGGTCAGGAGACCAAGACCATCCTGGCCAAATGGTGAAACCCCGTCTCTACTAAAAATACAAAAATTAGCTGGGCATGGTGGCGTGTGCCTGTAATCCCAGCTACTCAGGAGGCTGAGGCAGGACAATTGCCTGAACCCAGGAGAATTAGCTGGGCATGGTGGCGTGTGCCTGTAATCCCAGCTACTCAGGAGGCTGAGGCAGGACAATTGCCTGAACCCAGGAGGCGAAGGTTGCGGTGAGCCGAGATTGTGCCATTGCACTCCAGCCTGGGTAACAAGAGCGACACTCTGTCTCAAAAAAAAAAAAAAAAAAAAAAAAAAA"
"chr16","36528224","36528842","JH378119","32351107","32351490","270","4177117","GGCCAGGCGTGGTGGCTCACGCCTGTAATCCCAGCACTTTGGGAGGCTGAGGCAGGCAGATCACCTGAGGTCAGGAGTTCAAGACCAGCCTGGCCAACATGGTGAAACTCCATCTCTACTAAAAATACAAAATTAAGCCGGGCACGGTGGCTCACATCTGAAATCCCAGCACCTTGGGAGGCTAAGGCAGGCGGATCACGAGGTCAGGAGTTCAAGACTAGCTGACCAATATGGTGAAACCCCGTGTCTACTAAAAATACAAAAAAAATTAGCTGGGCGTGGTGGCGCATGCCTGTAGTTCCAGGTACTCAGGAGGCTGAGGAAGGAGAATCACTTGAACCTGGGAGGCGGAGGTTGCAGTGAGCCAAGATCATGCCACTGCATTCCAGCCTGGGCAACAGAGCAAGACTCTGTCTCAAAAATAAAAATAAAAATAAAAGTAAAAATACAAAATTAGCCAGGCGTGGTGGTGTGTGCCTGTAATCACAGCTACTCAGGAGGCAGGAAAATCACTTGAACCTAGGAGGAGGAGGTTGGTGAGCCAAGATCACACCATTGCACTCCAGCCTGGGCAAAAAGAGCAAAACTCCGAACTCTGTCTCAAAAAAAAAAAAAAAAA","GGCCAGGTATGGTGGCTCACACCTGTAATCCCAGCACTTTGGGAGGCCAAGGCAGGCAGACCACCTGAGGTCAGGAGTTCGAGATCAGCCTAGCCAACATGGTGAAACCCCATCTCTAGTAAAAATAAAATTAGCCAGGCATGGTGGTGCATGCCTGTAACGCAGGTCAGGAGTTCGAGATCAGCTTAGCCAACATGGTGAAACCCCATCTCTAGTAAAAATAAAATTAGCCAGGCAGGTGGTGCCGCCTGTACTCGGGAGGCTGAGGCAGGAGAATCACTTGAACCCAAGAGGCAGAGGTTGCAGTCAGCCAAGATCATGCCATTGCACTCCAGCCTAAGCAAAAAGAGTAAAACTCAGTCTCAAAACAAAAAAACAAAAAAA"
"chr16","44800308","44800913","JH378118","18053084","18053501","244","26747224","GGCCTGGTGCAGTGGCTCACACCTGTAATCCCAGCACTTTGGGAGCCCAAGGCGGGTGGATCACCTGAGGTCAGGAGTTCGAGACCAGCCTGGCCAACATGGTGAAATCCTCTCTACTAAAAATGCAAAAAATTAGCTGGGCGGCCAGGCGCAGTGGCTCACGCCTGTAATCCCAGCACTTTGGGAGGCCGAGGTGGGCGGATCACAAGGTCAGGAGATCGAGACCATGCTGGCTAACACGGTGAAACTCCGTCTCTACTGAAAATACAAAAAATTAGCCAGGCACGGTGGCGGGCGCCTGTAGTCCCAGCTACTGGGGAGGCTGAGGCAGGAGAATGGCGTGAACCTGGGAGGTGGAGGTAGCAGTGAGCCAAGATTGCGCCACCGCAGTCCGGCCTGGGTGAAAGAGCGAGACGCTGTCTCAAAAAAAAAAAAAAAAAATTAGCTGGGCATGGTGGCGGGCGCCTGTAATCCCAGTTACTCGGGAGGCTGAGGCAGGAGAATCAGTTGAACCCAGGAGGTGGAGGTTGCAGTAAGCCAAGATTGTGCCATTGTACTCCAGTCTGGGCAACAAGAGCGAAACTCTGTCTTAAAAAACAAAAAAAA","GGCTGGGCGCAGTGGCTCACACCTGTAATCCCAGCACTTAGGGAAGCTGAGGCGAGTAGATCACCTGAGGTCAGGAGTTAGAGACCAGCCTGGCCATCATGGTGAAACCCCGTCTCTACTAAAGATACCAAAAATTAGCTGAGTGTGGTGCTGGGTGCCTGTAATCCCAGAAACTCAGGGTGCCTGTAATCCCAGCAACTCAGGGTGCCTTTAATCCCAGCAACTGAGGGTACCAGTAATCCCAGCAACTCAGGGTGTCTTTAATCCTAGCAACTGAGGGCACCTGTAATCCCAGCAACTCAGGAAGCTGAGACAGGAGAAGTACTTGAACCCAGAAGGCAGAGGTTGCAGTGAGCCGATATTGCACCATTGCACTCCAGTCTGGGCAACAAGAGTGAAACTCTGTCTCAAAAAAAAA"
"chr16","45828895","45829498","JH378118","18053084","18053501","256","27775811","GGCCAGGAGAGGTGGCTCATGCTTGTAATTCCAGTATTTTGGGAGCCCAAGGCGGGTGGATCACTTGAGGTCAGGAGTTTGAAACCAGCCTGACCAACATGGTGAAACCCCGTCTCTACTAAAAATTCAAAATTAGGCAAGGCCTGGTGGCTCATGCCTGTAATCCCAGCACTTTGGGAGGCCAAGGAGGGAGGATCACCTGAGGTCGGGAGTTTGAGACCAGCCTGACCAACATGGAGAAACCCCGTCTCTACTAAAACTACAAAATTAGCCGGGTGTGGTGGCCCATGCCTCTAATCCCAGCTACTCTGGAGGCTGAGGCAGGAGAATCACTTGGACCTGGGATGTGAAGGTTGCAGTGAGCCAAGATCGAGCCATTGCACTCCAGCCTGGGCCACAAGAGTGAAACTCCGTCCCAGAAAAAAAAAAAAAAATTAACCTGGCATGGTGGTGTATGCCTGTAATCCCAGCTACTCGGGAGACTGAGGCAGGAGAATCTCTTGAACCCGGGAGGCGGAGGTTGCAGTAAACCGAGATTGCGCCATTGCACTCCGGCCTGGGTGACAAGAGCGAAACTCCGCCTAAAAAAAAAAAGAAAAGAAAA","GGCTGGGCGCAGTGGCTCACACCTGTAATCCCAGCACTTAGGGAAGCTGAGGCGAGTAGATCACCTGAGGTCAGGAGTTAGAGACCAGCCTGGCCATCATGGTGAAACCCCGTCTCTACTAAAGATACCAAAAATTAGCTGAGTGTGGTGCTGGGTGCCTGTAATCCCAGAAACTCAGGGTGCCTGTAATCCCAGCAACTCAGGGTGCCTTTAATCCCAGCAACTGAGGGTACCAGTAATCCCAGCAACTCAGGGTGTCTTTAATCCTAGCAACTGAGGGCACCTGTAATCCCAGCAACTCAGGAAGCTGAGACAGGAGAAGTACTTGAACCCAGAAGGCAGAGGTTGCAGTGAGCCGATATTGCACCATTGCACTCCAGTCTGGGCAACAAGAGTGAAACTCTGTCTCAAAAAAAAA"
"chr16","47110839","47111458","JH378118","18053084","18053501","268","29057755","GGCCAGGCGTGGTGGCTCACGCCTTTAATCCCAGCACTTTGGGAGGCCGAGGCAGGCAGATCACCTAAGGTCAGGAGTTCGAGACCAGCCTGGCCAACATGGTGAAACCCCCTCTCTACTAAAAATGCAAAAATTTCTGGGCATGGTGGCTCACGCCTGTAGTCCCAGCACTTTGGGAGGCCAAGGCAGGCGGATCACTTGAGGTCAGGAGTTTGAGACCAGCCTGGCCAACATGGTGAGACCCCTGTCTCTACTAAAAATATAAAAAAGTAGCCAGGCGTGGTGGTGTATGCCTCCCAGATAATTGGGAGGCTGAGGTGGGATAATTGCTTGAACCCGGGAGGCAGAGGTTGTAGTGAGCCAAGATAGCGCCAATGCACTCCAGCCTGGGCAACAGAGCGAGACTCTGTCTCAAAAAAAAAAAAAAAAAGAAAAAAGAAAAGAAATTAGCTGGGCGTGGTGATGGGTGCCTGTAATCCCAGCTGCTTAGGAAGCTGAGGAAGGAGAATCACTTAGACCCAGGAGACAGAGGTTGCAGTGAGCCGAGATCGCACCATTGTATTCCAGCCTGGGTGACAAGAGAAAAACTATGTCTCAAAAAAAAAAAAAAGAGTAGAAAA","GGCTGGGCGCAGTGGCTCACACCTGTAATCCCAGCACTTAGGGAAGCTGAGGCGAGTAGATCACCTGAGGTCAGGAGTTAGAGACCAGCCTGGCCATCATGGTGAAACCCCGTCTCTACTAAAGATACCAAAAATTAGCTGAGTGTGGTGCTGGGTGCCTGTAATCCCAGAAACTCAGGGTGCCTGTAATCCCAGCAACTCAGGGTGCCTTTAATCCCAGCAACTGAGGGTACCAGTAATCCCAGCAACTCAGGGTGTCTTTAATCCTAGCAACTGAGGGCACCTGTAATCCCAGCAACTCAGGAAGCTGAGACAGGAGAAGTACTTGAACCCAGAAGGCAGAGGTTGCAGTGAGCCGATATTGCACCATTGCACTCCAGTCTGGGCAACAAGAGTGAAACTCTGTCTCAAAAAAAAA"
"chr16","48159907","48160229","JH378222","6231244","6231546","61","41928663","GGCTGGGCACAGTGGCTCATGCCTGTAATCCCAGCACTTTGGGAGGCCGAGGCAGGCGGATCACCTGAGGTCAGGAGTTCGAGACTAGCCTGGCCAATATAGCGAAACCCCGTCTCTACTAAAAATTAGTTGGGCATGGTGGCAGGCGCCTTAATCCCAGCTACTTGGGATGCTGAGGCAGAAGAATCGCTTGAACCCAGAGGGTGGAGGTTTCAGTGAGATGAGATCGTGCCATTGCACTCCAGACTGGGCAACAAGAGCGAGACTCTGTAAAAAAAATTAATTAATTAATTAACTAATTAATTAAAATAAAATGAGAAAAA","GGCTGGGCATGGTGGCTCACGCCTGTAATCCCAGCACTTTGGGACGCTTAGGCAGGTGGATTGCCTGAGGTCAGGAGTTCAAGACTACCCTGACCAACATAGTGAAACCCCGTCTCTACTAAAAATTAGCTGGGCATGGTGGCAGAGGCCTGTAATCCCAGCTACTCGGGAGGCTGAGGCAGGAGAATCACTTAAACCTGGGAGTTGGAGGTTGCAGTGAGCCAAGATCAAGCCATTGCACTCCAGTCTGGGCAACAAGAGCAAGACTCTGTCTCAAAAAAAAAAAAAAAAAGAAAAGAAAAA"
"chr16","49252302","49252639","JH378314","538162","538484","57","48714140","GGCCAGGCGCAGTGGTGCATGTCTGTAATCTTAGCACTTTGGGAGGCCGAGGTGGACGGATTACATGAGGTCAGGAGTTCAAGACCAGCCTGGCCAACATGGTGAAATTCCATCTCTACTACTAAAAAAAAAAAAAAAAAAAAAAAAAAAAAAAAAAAAAAATACAAAAATTAGCTGGGCTTGGTGGCGGGTGCCTGTAATCCCAGCTACTTGGGAGGCTGAGGCAGGAATCACTTAAACCCAGGAGGTGGAGGTTGCAGTGAGCCAAGACCATGCCATTGCACTCCAGCCTGGGCAACAAGAGCAAAACTCCGTCTCAAAAAAACAAAACAAAAAAA","GGCTGGGTGCGGTGCCTCACACCTGTAATCCCAGCACTTTGGGAGGCCGAGGTGGGTGGATCACGAGGTCAAGAGATCAAGACCATCCTGGTCAACATGGTGAAACCCTGTCTCTACTAAAAAAAAAAAAAAAAAAAAAAAAAAAAAAAAAAAAATTAGCTGGGCATGGTGGCGTGTGCCTGTAATCCCAGCTACTCAGGAGGCTGAGGCAGGAGAATTGCCTGAACCCAGGAGGCGGAGGTTGCGGTGAGCCGAGACTGTACCATTGCACTCCAGCCTGGGTAACAAGAGCGAAACTCCATCTCAAAAAAAAAAAAAAAAAA"
"chr16","49464616","49465219","JH378118","18053084","18053501","254","31411532","GGCCAGGCGTGGTGGCTCACACCTGTAATCCTAGCACTTTGGGAGACTGAGGCAGGTGGATCACATGAGGTGAGGAGTTCAAAACCACCCTGGCCGACATGGTGAAACCCCGTCTCTACTAAAAATATTTTTAAAAAGGCCAGGCGTGGTGGCTCACACCTGTAATTCCAGCACTTCGGGAGGCTGGGGCAGGCAGATCACAAGGTCAGGAGATCGAGACCATTCTGGCCAACGTGGTGAAACCCCGTCTCTACTAAAAATACAAAAATTAGCTGGGCGTGGTGGCGCGTGCCTGTAATCCCAGCTACTTGGGAGGCTGATACAGGAGAATTGCTTGAACCAGTGAGTCAGAGGTTGCAGTGAGCTGAGATTGCGCCATTGCACTCCAGCCTGGCAACAGAATGAGACTCCGTCTCAAAAAAAAAAAAAAAATTAGCTGGGCATGGTGGCAGGCACCTGTGATCCCAGCTACTTGGGAGGCTGAGGCAGGAGAATCGCTTGAACCTGGGAGGTGGAGGTTGCAGTGAGCTGAGATTGCGCCATTGCACTCCAACCTGGGCGTCAAGAGCAAAACTCCATCTCAAAAATAAATAAATAAATAAAA","GGCTGGGCGCAGTGGCTCACACCTGTAATCCCAGCACTTAGGGAAGCTGAGGCGAGTAGATCACCTGAGGTCAGGAGTTAGAGACCAGCCTGGCCATCATGGTGAAACCCCGTCTCTACTAAAGATACCAAAAATTAGCTGAGTGTGGTGCTGGGTGCCTGTAATCCCAGAAACTCAGGGTGCCTGTAATCCCAGCAACTCAGGGTGCCTTTAATCCCAGCAACTGAGGGTACCAGTAATCCCAGCAACTCAGGGTGTCTTTAATCCTAGCAACTGAGGGCACCTGTAATCCCAGCAACTCAGGAAGCTGAGACAGGAGAAGTACTTGAACCCAGAAGGCAGAGGTTGCAGTGAGCCGATATTGCACCATTGCACTCCAGTCTGGGCAACAAGAGTGAAACTCTGTCTCAAAAAAAAA"
"chr16","49983504","49983843","JH378316","567988","568320","50","49415516","GGCCAGGCATGGTGGCTTACGCCTGTAATCTCAGCACTTTGGGAGGCCAAGGCAGGCGGATCACCTGAGGTCAGGAGTTCAAGACCAGCCTGGTCAACATGGCGAAACCCTGTCTCTACTAAAAAAATACAAAAATTAGCCAGGCGTGGTGGTGGGCGCCTGTAATCTCTCCTACTTGGGAGACTGAGGCAGGAGAATTGCTTGAACTCAGAAGGCAGAGGTTGCAGTGAGCTGAGATCACGCCATTGCACTCCAGCCTGGATGACAAGAGCAAAACTCCATCTCAAACAAACAAAAAACAAACAAACAAAAAAAAACAAAAAAACCTCCAAAAAACAAA","GGCCGGGCGTGGTGGCTCACGCCTGTAATCCCAGCACCTTGGGAGGCTGAGGCGGGTGGATCACGAGGTCAAGAGATTGAGACCAGCCTGGTCAACATGGTGAAACCCTGTCTACTAAAAAAATACAAAAATTAGCTGGGCATGGTGGCACGTGCCTGTAATCCCAGCTACTCAGGAGGCTGAGGCAGGAGAATTGCCTGAACCCAGGAGGCGGAGGTTGCGGTGAGCCGAGATCGCGCCATTGCACTCCAGCCTGGGTAACAAGAGCGAAACTCCGTCTCAAAAAACAAAAAACAAAAAAACAAAAAACAAACAAACAAACAAAAAAACAAA"
"chr16","50470493","50471105","JH378118","18053084","18053501","251","32417409","GGCTGGGAGCGGTGGCTCATACCTGTAATCCCAGCACTCTGGGAGGCCGAGGCGCGTGGATCACCTGAGGTCAGGAGTTTGAGACCAGCCTGGCCAGCATGGTGAAACCCTGTCTCTACTAAAAATAGAAAAAGTTAGCTGGGTGAACAGCCGGGCGCGGTGGCTCACACCTGTAATCCCAGCACTTTGGGAGGCCGAGGCAGGTGGATCACAAGGTCAGGAGATCGAGACCATCCTGGCTAACACGGTGAAACCCTGTCTCTACTAAAAATATAAAAAATTAGCCGGGCATGGTGGTGGGTGCCTGTAGTCCCAGCTGCTCAGGAGGCTGAGGCAGGAGAATGGCGTGAAGCCAGGAGGCAGAGGTTGCAGTGAGCCGAGATCGTACCACTGCACTCTAGCCTGGGTGACAGAACGAGACTGTGTCTCAAAGAAAAAAAAAATTAGCTGGGTGTGGTGGCAGACACCTGTAATCCTAGCTACTTGGGAGGTTGAGGCAGGAGAATCGCTTGGACCTGGGAGGCGGAGGTTGCAGTAGGCTGAAATCGCACCATTGCACTCCAGCCTGGGCAACAAGAGGGAAACTCAGTCTCAAAAAAAAAAAAAAAAAAAA","GGCTGGGCGCAGTGGCTCACACCTGTAATCCCAGCACTTAGGGAAGCTGAGGCGAGTAGATCACCTGAGGTCAGGAGTTAGAGACCAGCCTGGCCATCATGGTGAAACCCCGTCTCTACTAAAGATACCAAAAATTAGCTGAGTGTGGTGCTGGGTGCCTGTAATCCCAGAAACTCAGGGTGCCTGTAATCCCAGCAACTCAGGGTGCCTTTAATCCCAGCAACTGAGGGTACCAGTAATCCCAGCAACTCAGGGTGTCTTTAATCCTAGCAACTGAGGGCACCTGTAATCCCAGCAACTCAGGAAGCTGAGACAGGAGAAGTACTTGAACCCAGAAGGCAGAGGTTGCAGTGAGCCGATATTGCACCATTGCACTCCAGTCTGGGCAACAAGAGTGAAACTCTGTCTCAAAAAAAAA"
"chr16","50478366","50478929","JH378114","15957391","15957789","242","34520975","GGCTGGGCACGGTGGCTCATGCCTGTAATCCTAGTACCCTGGGAGGCTGAAGCTGGCAGATCACTTGAGGTCAGGAGTTCGAAACCAGCCTGGCCAACATGGTGAAACCTCATCACTACTAAAAATACAAAAAGTCAGCCGAGCGCGGTGGCTCACGCCTTTAATCCCAGCACTTTAGGAGTCTGAGGCGGGTGGATCACAAGGTCAGGGGTTTGAGACTAGCCTGACCAACACGGTGAAACATCTTTACTAAAAATAGCCAGGCATGGTGGTGCAGGCCTGTAGCAGGTACTCAGGAGGCTGAGGCAGCAGAATCGCTTGAACCCGGGAGGCGGAGGTTGCAGTGAGCCGAGATTGAGCCACTGCACTCCACCCTGGGCAACTGAGCGAGACTCCGTCTCAAAAAAAAAAAAAAAAATTAGCTGGACGTGGTGGTGGATGCCTGTAATCCCGGCTACTTGGTACTTGGAAGGCTGAGACAGGAGAATCGCTTGAACCCGGGAGGTGGAGGTTGCAGTGAGCTGAGATAGCGCCATTGCACTCCAGCCTGGGCAACAAGAGTGA","GCAAGGAACGGTGGCTCATGCCTGTCATCCCAGCACTTTGGGAGGCTAAGGAGGGTGGATTACCGAAGGTCATGAGTTTGAGACCAGCCTGACCAACATGGTGAAAACCCCATCTCTACTAAAAATACAAAAAATTAGCCAGATACAGCTATGCGGCAGACTGGGGCAGGAGAATCGCTTGGACCCAAACCCCATCTCTACTAAAAATACAAAAAATTAGCCGGATACAGCTATGCGGGAGACTGGGGCAGGAGAATCGCTTGGACCCGGGAGGCAGAGATTGCAGTGAGATGAGACCATGCCATTGCTCTCTAGCTTGTGCGATGAGAACAAGACTCTGTCTCAAAAAAAAAAAAAAAAAAAAAAAAAAAAAAAAAAAAAAAAGAGAGAGAGAGAAAA"
"chr16","51388263","51388584","JH378271","2122362","2122678","46","49265901","GGCTGGGTACGGTGGCCCACACCTGTAATCCCAGCACCTTGGGAGGCTGAGGTGGGCGGATTACCTGAGGTCAAAAGTTCAAGACCAGCCTGGCCAACATGGTGAAATCCCATCTCTGCTAAAAATACAAAAAAAAAAAAAAAAAAAAAAAAAAAATTGCCAGGCATGGTGGCAGGCACCTGTAATCCCAGCTACTTGGGAGGCTGAGGCAGGGGAATCGCTTGAACCTGGGAGGCAGAGGTTGCAGTGAGCCCAGATAGCGCCATTGCACTCCAGCCTGGGCGACAAGAGCGAAACTCTGTCCAAAAAAAAAAAAAAAAAA","GGCCGGGCACGGTGGCTCACACCTGTAATCCCAGCACTTTGGGAGGCTGAGGTGGGTGAATCACCTGAGGTCAGGAGTTTGAGACCAGCCTGACCAACATGATGAAACCCGGTCTCTGCTAAAAATACAAAAAAAAAAAAAAAAAAAAAAAAAAAAAGCTGGGCATGATGGTGGGCACCTGTAATCCCAGCTACTCGGGAGGCTGAGGCAGGAGAATCGCTTGAACACCAGGAGGTGGAGGTTGCTATGAGCCGAGATCGCACCATTGCACTCTAGCTTGGGCAACAAGAGAGAAACTCCATCAAAAAAAAAAAAAA"
"chr16","51876298","51876882","JH378118","18053084","18053501","253","33823214","GTAATCCCAGCACTTTGGGAGGCCCAAGTGGGTGGATCACCTGAGGTCAGGAGTTCATGACCAGCCTGGCCACATGGTGAAACCCCATCTCTACTAAAAATACAAAATTAGGCTGGGCGCGGTGGCTTACGTCTGTAATTCCAGCACTTTGGGAGGCCGAGGCAGGCGGATCATGAGGTCAGGAGATTGAAACCATCCTGGCTAACACGGTGAAACCCTGTCTCTACTAAAAATACAAAAAATTAGCCGGGTGTGGTGGGGGGGCGCCTGTAGTCCCAGCTGCTCAGGAGGCTGAGGCAGGAGAATGGCATGAACCCGGGGGGGCGGAGCTTGCAGTGAGCTGAGATCATGCCACTGCACTCCAGCCTGGGCAACAAAGTGAGACTCCGTCTCAAAAAAAAAAACCAAAAAACAAAATGAGCTGGGTGTGGTGGTGGGGGCGTATAATCCCAGCTATACAGGAGGCTGAGGTAGGAGAATCACTTGAACCCGGGAGGTGGAGGTTGCAGTGAGCCGAGATTGTGCCATTTCACACCAACCTGGGTAACAAGAGTAAAATGCTGTCTCAAAAAAAAAAAAGAAAAA","GGCTGGGCGCAGTGGCTCACACCTGTAATCCCAGCACTTAGGGAAGCTGAGGCGAGTAGATCACCTGAGGTCAGGAGTTAGAGACCAGCCTGGCCATCATGGTGAAACCCCGTCTCTACTAAAGATACCAAAAATTAGCTGAGTGTGGTGCTGGGTGCCTGTAATCCCAGAAACTCAGGGTGCCTGTAATCCCAGCAACTCAGGGTGCCTTTAATCCCAGCAACTGAGGGTACCAGTAATCCCAGCAACTCAGGGTGTCTTTAATCCTAGCAACTGAGGGCACCTGTAATCCCAGCAACTCAGGAAGCTGAGACAGGAGAAGTACTTGAACCCAGAAGGCAGAGGTTGCAGTGAGCCGATATTGCACCATTGCACTCCAGTCTGGGCAACAAGAGTGAAACTCTGTCTCAAAAAAAAA"
"chr16","59738190","59738518","JH378138","4229795","4230103","67","55508395","TCACAGCATTTTGGGAGGCCAAGGCAGGCGGATCACCTGTGGTCAGGAGTTTGAGACCAGCCTGGCCAACATGGTGAAACCCCATCTCTACTAAAAATACAAAACAATTAGCCAGGTTTGGTGGCAGGCGCCTATAATCCCAGCTACTTGGGAGGCTGAGGCAGGAGAATCGCTTGAACCCAGGAGGCGGAGGTTGCAGTGAGCCGAGAACACACCATTGTACTCCAGCCTGCGACAAGAACGAAACTGTATCTCAATTAAAAAAAAAAAAAGAAAGGGAGGAAGGAAGGAAGGAAGGAAGGAAGGAAGGAAGGAAGAAAGAAAGAAAA","CACTTTGGGAGGTGAAGGCGGGCAGATCACCTGAGGTCAGGAGTTCGAGACCAGCCTGGCCAACATGGTGAAACCCCGCCTCTACTAAAAATACAAAAATTAGCCAGGTGTGACACTAGGCATCTGTAATCCCAGCTACTTGGGAGGCTGAGACAGGAGAATCACTTGAACCCAGGAGGCGGAAGTTGCAGTGAGCCAAGATCATGCCATTGCACTCCAGCCTGGGTGACAGGAGCAAAACTCTGTCTCAAAAAAAAAAAAAAAAAAAAAAAAAAAAAAAAAAAAAAAAGAAAAGAAAAGAAAAGTAAA"
"chr16","64682336","64682940","JH378118","18053084","18053501","253","46629252","GGCCGGGCACGGTGGCTCACTCCTGTAATCCCAGCACTTTGGGAGGGTGAGGCAGGTAGATCAAAAGGTCAGGAGTGGCCAGGCGTGGTGGCTCACACTTGTAATCCCAGCACTTTGGGAGGCCGAGATGGGCAGATCACGAGGTCAAGAGATTGAGACCATCCTGGCTAACATGGTGAAACCCCGTCTCTACTAAAAATACAAAAAATTAGCCGGGTGTGGTGGCAGGCGTCTGTAATCCCAGCCACTTGGGAGGCTGAGGCAGGAGAATCGCTTGAACCTGGGCGGCAGAGGTTGCATTGAGCCAGGATCGCGCCACTGCACTCCAGCCTGAGCAAAAAGAGCGAAACTCTGTCTCAGAAAAAAAAAAAAGTCAGGAGTTTGAGACCAGCCTGGCCAATATGGTGAAACCCCGTCTCTACTAAAAATACAAAAATTAGCCGAGCGTGGTGGTGGGTGCCTATACTCCCAGCTACTCAGGAGGCTGAGGCAGGAGAATCACTTGAACCCCAGGGGCAGAGGTTGCAGTGAGCCGAGATCGTGCCATTGCACTTCACCCTGGGTGAAAGAGCAAAACTCCGTCTCAAAAAAACAAAACAAAAAAA","GGCTGGGCGCAGTGGCTCACACCTGTAATCCCAGCACTTAGGGAAGCTGAGGCGAGTAGATCACCTGAGGTCAGGAGTTAGAGACCAGCCTGGCCATCATGGTGAAACCCCGTCTCTACTAAAGATACCAAAAATTAGCTGAGTGTGGTGCTGGGTGCCTGTAATCCCAGAAACTCAGGGTGCCTGTAATCCCAGCAACTCAGGGTGCCTTTAATCCCAGCAACTGAGGGTACCAGTAATCCCAGCAACTCAGGGTGTCTTTAATCCTAGCAACTGAGGGCACCTGTAATCCCAGCAACTCAGGAAGCTGAGACAGGAGAAGTACTTGAACCCAGAAGGCAGAGGTTGCAGTGAGCCGATATTGCACCATTGCACTCCAGTCTGGGCAACAAGAGTGAAACTCTGTCTCAAAAAAAAA"
"chr16","67872770","67873371","JH378118","18053084","18053501","260","49819686","GGCTGGGCATGGTGGCTCATGCCTGTAATCCCAGCACTTTGGGAGGCCAAGACGGGCAAATCACCTCAGGTCAGGAGATCGAGACCAGCCTGGCCAACACAGCAAAACCCACCTCTCTACTAAAAATAGAAAAATTACCCAGGCGTCACAGCTCACGCTTATAATCCCAGCACTTTGGGAGGCCGAAGCAGGTGGATCACAAGGTCAGGAGATCGAGACCAGCCTCACTAACATGGTGAAACCCCGTCTCTACTGAATATACGAAAAATTAGTCGGGTGTGGTGGCAGGCACCTGTAGTCCCAGCTACTTGGGAGGCTGAGGCAGGAGAATGGCTTTAACTCAGGAAGAGGAGCTTACGGTGAGCTGAGATTGTGCCACTGCACCCCAGCCTGGGCGACAGAGCAAGACTCCGTCAAAAAAAAAAAAAACCCCAAAACCCCAGCGTGGCAGCAGGTACCTGTAGTCCCAGCTACTCGGGAGGCTGAGACAGGAGAATGGCTTGAACCCGGGAGGCGGAGCTTGCGGTGAGCCAAGACGGCGCCACTTCATTCCAGCTATGGTGATAAGAGGGAGACCGTCTCAATCAATAAATTTAAAAAAA","GGCTGGGCGCAGTGGCTCACACCTGTAATCCCAGCACTTAGGGAAGCTGAGGCGAGTAGATCACCTGAGGTCAGGAGTTAGAGACCAGCCTGGCCATCATGGTGAAACCCCGTCTCTACTAAAGATACCAAAAATTAGCTGAGTGTGGTGCTGGGTGCCTGTAATCCCAGAAACTCAGGGTGCCTGTAATCCCAGCAACTCAGGGTGCCTTTAATCCCAGCAACTGAGGGTACCAGTAATCCCAGCAACTCAGGGTGTCTTTAATCCTAGCAACTGAGGGCACCTGTAATCCCAGCAACTCAGGAAGCTGAGACAGGAGAAGTACTTGAACCCAGAAGGCAGAGGTTGCAGTGAGCCGATATTGCACCATTGCACTCCAGTCTGGGCAACAAGAGTGAAACTCTGTCTCAAAAAAAAA"
"chr16","67970409","67971018","JH378118","18053084","18053501","252","49917325","GGGCGGGTGCGGTGGCTCACCCTGTAATCCCAGCACTTTCGGAGGCTTAAGCAGGCGGATCACCTGAGGTCAGGAGTTCGAGACCAGCCTGGCCAACATGGTGAAACCCCATCTCTACTAAAAATACAAAAAAATGGCCGGGTGCGGCGGCTCATGCCTGTCATCCCAGCACTTTCGGAGGCTGAGGCAGGCGGATCACCGGAGGTCAGGAGTTCGAGACCAGCTTGGCCAACATGGTGAAACCCCGTCTCTACTAAAAATACAAAAGTTAGCTGGGCATGGTGGCACATGCCTGTAATCCCAGCTACTCCGGAGGCTGAGGCAGGAGAATCACTTGAACCTGGGGAGGCGGAGGTTGCAGTGAGCTGAAATCACGGCATTGCACTCCAGCCTAGGCAACAGAGCGAAAGTCCGTCTCAGAAAAAAAAAAAAAAAAATTAGATGGGTTTGGTGGCGGGCGCGCTGTAATCCCAGCTACTTGGGAGGCTGGAGGCAGGAGAATCGCTTGAACTCAGGAGGCTGAGGTTACAGTGAGCCGAGATCATGCCATTGCACTCCAGCCTGGGCAATAAGAGTGAAACTCTGTCTCAAAAAACAACAACAACAAAAA","GGCTGGGCGCAGTGGCTCACACCTGTAATCCCAGCACTTAGGGAAGCTGAGGCGAGTAGATCACCTGAGGTCAGGAGTTAGAGACCAGCCTGGCCATCATGGTGAAACCCCGTCTCTACTAAAGATACCAAAAATTAGCTGAGTGTGGTGCTGGGTGCCTGTAATCCCAGAAACTCAGGGTGCCTGTAATCCCAGCAACTCAGGGTGCCTTTAATCCCAGCAACTGAGGGTACCAGTAATCCCAGCAACTCAGGGTGTCTTTAATCCTAGCAACTGAGGGCACCTGTAATCCCAGCAACTCAGGAAGCTGAGACAGGAGAAGTACTTGAACCCAGAAGGCAGAGGTTGCAGTGAGCCGATATTGCACCATTGCACTCCAGTCTGGGCAACAAGAGTGAAACTCTGTCTCAAAAAAAAA"
"chr16","68229729","68230314","JH378206","6546474","6546861","256","61683255","TGGTTTCCGCCTGTACTCCCAGCACTTTCGGAGGCTCAAGTGAGCAGATCGCTTGAGGCCAGGAGTTTAAGACCTACCTAGTCAACACCGGGGAAACCCACATCTCCACTAAACAATGGCCAGGAGCAGTGGCTCATACCTGTAATCACAACACTTTGGGATCCCAGCCAGACGGATCACAAAGTCAGGAGTTTGCGACCAGCCTATTAGAATGGTGAAACCCTGTCTCTACTAAAAATACAAAAAATTAGCCAGGCATGGTGGCGCATGCCTGTCATCCCAGCTACTCGGGAGGCTGAGGCAAGAGAATCACTTAAACCCAGGAGGCAGATGGAGGTTGCAGTGAGCCAAGATCACACCACTGCACTACAGCATGGGCGACAGAGCAAGACTCGGTCTCAAAAAAAAAAAAATTGGCCAGGCACGGTGGCTGACACCTGTAATCCCAGCACTTTGGGAGGCTGAGGCGGGAGAATCGCTTGAACCTGGGAGACGAAGGTTGCAGTGAGCCGAGACTAAGCCATTGCACCCCAACCTGGGCGGCAAGAGTGAAACTCTGTCTCAAAAAAAATTAAAAAATAAAAAA","GGCCACACATGGTGGCTAACGCCTGTAATCCCAGCACTTTGGGAGGCCAAGTCGGGTGGATCATGAGGTCAGGAGACCAAGACCATCCTGGCCAAATGGTGAAACCCCGTCTCTACTAAAAATACAAAAATTAGCTGGGCATGGTGGCGTGTGCCTGTAATCCCAGCTACTCAGGAGGCTGAGGCAGGACAATTGCCTGAACCCAGGAGAATTAGCTGGGCATGGTGGCGTGTGCCTGTAATCCCAGCTACTCAGGAGGCTGAGGCAGGACAATTGCCTGAACCCAGGAGGCGAAGGTTGCGGTGAGCCGAGATTGTGCCATTGCACTCCAGCCTGGGTAACAAGAGCGACACTCTGTCTCAAAAAAAAAAAAAAAAAAAAAAAAAAA"
"chr17","3506470","3507049","JH378118","18053084","18053501","238","14546614","CCTGTCATCCCAGCACTTTGGGAGGCCGAGGCGGGTAGATCACCTGAGGTCAGGAGTTTGAGACCAGCCTGGCCAACATGGCGAAACCCCGTCTCTACTAAAAATACAAAAACTGGCTGGGCGCGGTGGCTCACGCCTGTAATCCCAGCACTTTGGGAGGCTGAGGCGGGTGGATCATAAGGTCAGGAGTTCAAGACCAGCCTGGCCAACATGGTGAAACCCCATCTCTACTAAAAATACAAAAATTAGCCAGGTATGGTGGCAGGTGCCTGTAATCCCAGCTACTCAGGAGGCTGAGGCAGAGAATTGCTTGAACCCGGGAGGGGGAGGTTGCAGAGGGCCAAGATCGTACCACTATACTCCAGCCTGGGTGACAGGATGAGACTCCATCTTAAAAAAAAAAAAAAAAAAAAAAATTAGCCAGGCGTGGTGCGGGCACTTGTAATCCCAGCTATTCAGGAGGCTGAGGCAGGAGAATTGCTTGAACCCGGGAGGCAGAGGTTGCGGTGAGCTGAGATCGCACCATTGCACTCCAGCCTGGGCAACAAGAGTGAAACTCTGTCTCAAAAAAAAAACAAAA","GGCTGGGCGCAGTGGCTCACACCTGTAATCCCAGCACTTAGGGAAGCTGAGGCGAGTAGATCACCTGAGGTCAGGAGTTAGAGACCAGCCTGGCCATCATGGTGAAACCCCGTCTCTACTAAAGATACCAAAAATTAGCTGAGTGTGGTGCTGGGTGCCTGTAATCCCAGAAACTCAGGGTGCCTGTAATCCCAGCAACTCAGGGTGCCTTTAATCCCAGCAACTGAGGGTACCAGTAATCCCAGCAACTCAGGGTGTCTTTAATCCTAGCAACTGAGGGCACCTGTAATCCCAGCAACTCAGGAAGCTGAGACAGGAGAAGTACTTGAACCCAGAAGGCAGAGGTTGCAGTGAGCCGATATTGCACCATTGCACTCCAGTCTGGGCAACAAGAGTGAAACTCTGTCTCAAAAAAAAA"
"chr17","3641899","3642243","JH378198","5062782","5063109","59","1420883","GGCCAGGCACAGTGGCTCACACCTGTAATCCCAGCACTTCAGGAGGCCGAGGTGGGTAGATCACCTGAGGTCAGGGGTTTGAGACCAGCCTGACCGACGTGGCGAAACCCTGTCTCTACTACAAATACAAAAATTAGCCTTATGTGGTGGCGGGCACGTGTAATCCCAGCTACTTGGGAGGCTGAGGCAGGAGAATCGCTTGAATCTGGGAGGTGGAGGTTGCAGTGAGCCGAGATCACGCCATTGCACTCCAGCCTGGGTGACAAGAGCGAAACTCCATCTCAAAATAAATAAATACATACATACATGTATACATACATACATACATAAAAATAAAAAGTAAAA","GCCAGGCATGGTGGCTCACGCCTATAATCTCAGCACTTTGGGAGGCTGAGGCAGGCAGATCACTTGAGGTCAGGAGTTCAAGACCAGCCTGGCCAACATGGTGAAACCCTGGCTCTACTAAAAATACAAAAATTAGCCGGGTGTGGTGGCACGTGCCTATAATCCCAGCTACTCAGGAGGCTGAGGCAGAAGAATCGCTTGAATCCAGGAGGTGGAGGTTGCAGCGAGCCGAGATCACACCATTGGACTCCAGCCTGGGTGACAAGAGCGAAACTCCATCTCAAAATAAATAAATAAATACATAAAATTAAAAATAAATAAATAAATA"
"chr17","4508039","4508546","JH378206","6546474","6546861","194","2038435","GAGTTGGAGACCAGCCTGGCCAACACGGTGAAACCTCGTCCCCACTAAAAATATAAAAATTAGGCCAGGCGCGGTGGCTCACTCCTGTAATCCCAGCACTTTGGGAGGCTGAGGCGGGTAGATCATCTGAGGTCAGGAGTTCGAGACCAGCCTGGCCAACATGGTGAAACTCCGTCTCTACTAAAAATACAAAAATTAGCTGGGCTGGTAGCGGGCACCTGTAATCCCAGCTACTTGGAAGGGTGAGGCAGGAGAATCACTTGAACCCAGGAGGTGGAGGTTGCAGTGAGCCAAGATTGCAGCACTGTACTCCAGCCTGGGTGACAAAGCAAGACTCTGTCTCAAAAAAAAAAAAAAAAAAAAAGCCGGGCTTGGTGGTGAGTACCGGTAATCCCAGCTACTTGGAAGGCTGAGGCGGCGGACGTTGTACTTAGCCGAGATCATGCCATTGCACTCCAGCCTGGGTAACAGGCAAAAACTCTGTCTCAAAAAATAATAAATAATAAAA","GGCCACACATGGTGGCTAACGCCTGTAATCCCAGCACTTTGGGAGGCCAAGTCGGGTGGATCATGAGGTCAGGAGACCAAGACCATCCTGGCCAAATGGTGAAACCCCGTCTCTACTAAAAATACAAAAATTAGCTGGGCATGGTGGCGTGTGCCTGTAATCCCAGCTACTCAGGAGGCTGAGGCAGGACAATTGCCTGAACCCAGGAGAATTAGCTGGGCATGGTGGCGTGTGCCTGTAATCCCAGCTACTCAGGAGGCTGAGGCAGGACAATTGCCTGAACCCAGGAGGCGAAGGTTGCGGTGAGCCGAGATTGTGCCATTGCACTCCAGCCTGGGTAACAAGAGCGACACTCTGTCTCAAAAAAAAAAAAAAAAAAAAAAAAAAA"
"chr17","4560867","4561450","JH378118","18053084","18053501","257","13492217","GGCTGGGGGTGGTGTCTCTTGCCTGTAATCCCAACACTTTAGCAGGCTGAGGTGTGAGTATGGCTTGAGCCAGGAGTTCTAGACCAGCCTAGGAAACATGGCGAGATCCCTATCTCTACTAATACAAAAATTAGCCGGGCGTGGTGGCAAGCACCTGCAATCTCAGCTACTCGGGAGGCTGAGGTGGGAGGGCCGCTTGAGCCCAGGAGGTCCAGGCTGCAGTAAGCACTTATTTAAAAAAAAAAGAAGAGAAAAGATACAGAAATTAGCCAGGCGTGGTGGTGGGCACCTGTAATCCCAGCTACTCAGGAGGCTGAGGCAGGAAAATCACTTGAACCCGGGAGGCAGAGGTTGCAGTGGGCCGAGATCACACCATTGTACTCCAGCCTGGGCAACAAGAGCGAAACTCTGTCTCAAAAAAAAGAAAAGTAAAGTAAAGAAAAGATACAGAAATTAGCCAGGTGTGGTGGCGGGTGCCTGTAATCCCGCTACTTGGGAGGCTGAGGCAGGAGATTGCAGTGAGCCAAGATTGTGCCATTGCATTCCAGCCTGGGCAACAAGAGCAAAACTCCGCCTCAAAAAAA","GGCTGGGCGCAGTGGCTCACACCTGTAATCCCAGCACTTAGGGAAGCTGAGGCGAGTAGATCACCTGAGGTCAGGAGTTAGAGACCAGCCTGGCCATCATGGTGAAACCCCGTCTCTACTAAAGATACCAAAAATTAGCTGAGTGTGGTGCTGGGTGCCTGTAATCCCAGAAACTCAGGGTGCCTGTAATCCCAGCAACTCAGGGTGCCTTTAATCCCAGCAACTGAGGGTACCAGTAATCCCAGCAACTCAGGGTGTCTTTAATCCTAGCAACTGAGGGCACCTGTAATCCCAGCAACTCAGGAAGCTGAGACAGGAGAAGTACTTGAACCCAGAAGGCAGAGGTTGCAGTGAGCCGATATTGCACCATTGCACTCCAGTCTGGGCAACAAGAGTGAAACTCTGTCTCAAAAAAAAA"
"chr17","4846296","4846953","JH378118","18053084","18053501","290","13206788","GGCCAGGTGCAGTGGCTCACGCCTGTAATCCCAGCACTTTGGGAAGCCCAGGTGGGCGGATCACCCAAGGTCAGGGGTTCGAGACCAGCCTGGCCAACATGGTGAAACTCCATCTCTACTAAAAATAGAAAAAAATGGCCTGGTACGGTGGCTAACGCCTGTAATCCCAGCACTTTGGTAGGCCGAGGCAGGCAGATCACGAGGTCAGAAGATCGAGACCATCCTGGCTAACATGGTGAAACCCCGTCTCTACTAAAAATACAAAAAAGTAGCCAGGTGTGGTGGTGGGTGCCTGTAGTCCTAGCTACTCGGGAGGCTGAGGCAGGAGAATGCCGTGAACCCGGGAGGTGGAGCTTGCAGTGAGCTGAGATCACGCCACTGCACTCCAGCCTGGGTGACAGTGCGAGACTGTCTCCAAAAAAAAAAAAAAAAAAAAATTATATATATAATACACACACACACACACACACACACACACACACACAAATCAGCCAGGCGTGGTGGTGCGCACCTGTAATCCCAGCTACTCGGGAGGCTGAGGCAGGAGAGCTCCTCGAACCCAGGAGGCGAAGGTTGCAGTGAGCCGAGATCACACCATTGCACTCCAGCCTGGGCAACAAGAGCGAAACTCTGTCTCAAGGAAAAAAAAAAAAAAAAA","GGCTGGGCGCAGTGGCTCACACCTGTAATCCCAGCACTTAGGGAAGCTGAGGCGAGTAGATCACCTGAGGTCAGGAGTTAGAGACCAGCCTGGCCATCATGGTGAAACCCCGTCTCTACTAAAGATACCAAAAATTAGCTGAGTGTGGTGCTGGGTGCCTGTAATCCCAGAAACTCAGGGTGCCTGTAATCCCAGCAACTCAGGGTGCCTTTAATCCCAGCAACTGAGGGTACCAGTAATCCCAGCAACTCAGGGTGTCTTTAATCCTAGCAACTGAGGGCACCTGTAATCCCAGCAACTCAGGAAGCTGAGACAGGAGAAGTACTTGAACCCAGAAGGCAGAGGTTGCAGTGAGCCGATATTGCACCATTGCACTCCAGTCTGGGCAACAAGAGTGAAACTCTGTCTCAAAAAAAAA"
"chr17","6289040","6289368","JH378152","15932639","15932952","57","9643599","GGCTGGGCGTGGTGGCTCACGCCTGTAATCCCAGCACTTTGGGAGGCCAAGGTGGGTAGATCACCTGAGGTCAGGAGTTTGAGACCAGCCTGGCCAATGTGATGAAACCCTGTATCCACTAAAAAAAAAAAAAAAAAAAAAAAAAAAAATAGCTGGGTGAAGTGGCAAGCACCTGTAATCCCAGCTACTTGGGAGGCTGAGGCAGGAGAATCCCAGGAGGTGGAGATTGATCCCAGGAGGTGGAGGTTGCAGTGAGTCAAGATCATGCCATTGCACTCCAGCCTGGGTGACAAGAGCAAAATTCCATCTCAAAAAAAAAAAAAAGAAAA","GGCCGGGCATGGTGGCTCAAGCCTGTAATCCCAGCACTTTGGGAGGCCGAGGCGGGTGGATCACGAGGTCAAGAGATTGAGACCATCCTGGTCAACATGGTGAAACCCCGTCTCTACTAAAAATACAAAAAAAAAAAAAAAAAAAATAGCTGGGTGTGGTGGCGTGTGCCTGTAATCCCAGCTACTCAGGAGGCTGAGGCAGGAGAATTGCCTGAACCCGGGAGGCGGAGGTTGCGGTGAGCCGAGATCGCGCCATTGCACTCCAGCCTGGGTAACAAGAGCGAAACTCCGTCTCAAAAACAAAAAAAACAAAA"
"chr17","7490664","7491294","JH378118","18053084","18053501","283","10562420","GGCCGGGAGCGGTGGTTCACTCCTGTAATCCCAGCACTTTGGCAGACCGAGGAGGGTGGATCAACTGAGGTCAGAACTTCAAGACCAGCCTGCCGGGCACAGTGGCTCACACCTGTAATCCCAGCACTTTGGGAGGCTGAGGCAGGTGGATCACCCGAGGTCGGGAGTTCAAGACCAGCCTGACCAACGTGGAGAAACCCCGTCTCTACTAAAAATACAAAATTAGCTGGGGTGGTGGCACGTACCTGTAATCCCAGCTACTCGGGAGGCTGAGGCAAGAGAATCGCTTGAACCCGGGAGGCGGAGGTTGCGGTGCGCCGAGATCGCGCCATTACACTCCAGCCTGGGCAAAAAGAGCGAAACTCTGTCTCAAAAAATAAAAAAAGAAAAAGAAAAAGAAAAAGAAGTTCAAGACCAGCCTGGTCAACGTGGTGAAACCCCGTCTCTACTAAAAACACAAAAAAAATTAGGCGGGTGTTGTGGTGGGTGCCTGTAATCCCAGCTACTCAGGAGGCCAAGGCAGGAGAATCACCTGAACCCTGGAGGTGGAGGTTGCAGTGAGTCGAGATCGCACCATTGCACTCCAGCGTGGGTGACAGAGAGCGAGACTCCGTCTCAAAAAAAAAGAAAA","GGCTGGGCGCAGTGGCTCACACCTGTAATCCCAGCACTTAGGGAAGCTGAGGCGAGTAGATCACCTGAGGTCAGGAGTTAGAGACCAGCCTGGCCATCATGGTGAAACCCCGTCTCTACTAAAGATACCAAAAATTAGCTGAGTGTGGTGCTGGGTGCCTGTAATCCCAGAAACTCAGGGTGCCTGTAATCCCAGCAACTCAGGGTGCCTTTAATCCCAGCAACTGAGGGTACCAGTAATCCCAGCAACTCAGGGTGTCTTTAATCCTAGCAACTGAGGGCACCTGTAATCCCAGCAACTCAGGAAGCTGAGACAGGAGAAGTACTTGAACCCAGAAGGCAGAGGTTGCAGTGAGCCGATATTGCACCATTGCACTCCAGTCTGGGCAACAAGAGTGAAACTCTGTCTCAAAAAAAAA"
"chr17","9634166","9634493","JH378110","12773123","12773444","45","3138957","GGCTGGGTGCGGTGGCTCACGCCTGTAATCCCAGCACTGTGGGAGGCCGAGGCAGGTGGATCACCTGAGGTCAGGAGTTTGAGACCAGCTTGGCCAACATGGTGAAACCCTGTCTGCACTAAAAATACAAAAAAAAAAAAAAAAAAAAAAAAATTAGCTGGGTGTGGTGGCGGACGCCTATAATCCCAGCTACTGGGGAGGCTAAGGCAGGAGAATCGCTTGAACCTGGGAGGTGGAGATTGCAGTGAGCCAAGATGGTGCCATTGCACTCCAGCCTGGACAACAAGAGCGAAACTCGGTTTCAAAAAAAAAAAAAAAAAAAAAAAAA","GGCTGGGCGTGGTGGCTCATGCCTATAATCCCAGCACTTGGAGAGGCCAAAGCAGGCAGATTATTTGAGGTCAGGAGTTCCAAACCAGCCTGGCCAACATGGTGAAACCCTGTATCTACTAAAAATGCAAAAAAAAAAAAAAAAAAAAAAATTAGCTGGGCGTGGTGGCAGGTGACTGTATCCCAGTACTTGGTAGGCTGAGGCAGGAGAATTGCTTGAACCTGGGAGGTGGAGGTTGCAGTGAGCTGAGATTGTGCCATTGCACTCCAGCCTGGGCAACAAGAGCAAAACTCTGTCTCAAAAAAAAAAAAAAAAAAAAAAA"
"chr17","9636859","9637187","JH378193","2430153","2430476","55","7206706","GACACGGTAGCTCACGCCTGTAATCCCAGCACTTTGGGAGGTCGAGGCGGGTGGATCACCTGAGGTCAGGAGTTTAAGACCAGCCTGGCCAACATGGTGAAACCCCGTCTCTGCTAAAAATACAAGAATTAGCCAGGCGTGGTGGTGGGCGCCTGTAATCCCAGCTACTGGGGAGGCTGAGGCAGGAGAATCACTTGAACCCAGAAGGTGGAGGTTGCAGTGAGCCAAGACCACACCACTGGACTGCAGCCTGGCGGACAAGAGCGAGACTCTGTCTCAAAAACAACAACAACAACAACAACAACAACAAAAGAAAGAAAAGAAAAGAA","GGCCGGGCACAGTGGCTCAAGCCTGTAATCCCAGCACTTTGGGAGGCCGAGGTGGGTGGATCACGAGGTCAAGAGATCGAGACCAACCTGGTCAACATGGTGAAACCCCGTCTCTACTAAAAATACAAAAATTAGCTGGGCATGGTGGTGTGTGCCTGTAATCCCAGCTACTCAGGAGGCTGAAGCAGGAGAATTGCCTGAACCCAGGAGGAGGAGGTTGCGGTGAACCAAGATCACGCCATTGCACTCCAGCCTGGGTAACAAGAGCGAAACTCTGTCTCAAAACAAAACAAAACAAAACAAAACAAAACAAACAAAAAAAAA"
"chr17","9725612","9725938","JH378224","2846632","2846964","49","6878980","GGGCGTGGTGGCTCACACCTGTAATCCCAGCACTTTGGGAGGCCGAGGTGGGCGGATTGCCTGAGGTCAGGAGTTCGAGACCAGCCTGGCCAACCCGGTGAAACCCTGTCTCTACTAAAATACAAAAAAAAAAAAAAAAAAAAAAAAAAATTTAGCTGTGTGTGGTGGTGTGCACCTGTAATCCCAGCTACTCAGAAGGCTGAGGCAGGAGAATCGCTAGAACCCGGGAGGCGGAGGTTGCAGTGAGCCGAGATCGCACCATTACGCTCCAGCTTGGGCAACAAGAGTGAAACTCCATCTCAAAAACAAAACAAAACAAAACAAAAA","GGCCAGGCAGGGTGGCTTACATCTGTAATCCCAGCACTTTGGGAGGTCAAGGCGAGTGGATCACCTGAGGTCATGAGTTCAAGACCAGCCTGGCCAACTTGGTGAAACCCTGTCTCTACTAAAAATACAAAAAAAAAAAAAAAAAAAAAAAAAAAAATTAACTGGGTGTGGTGGTGCACACCTGTAATCCCAGCTACTCAGGAGGCTGAGGCAGGAGAATCCCTTGAACACGGGAGGTGGAGGTTGCAGTGAGCCGAGATCATGCCATTGCACTCCAGCCTTGGTGAAAAGAGCAAAACTCTGTCTTAAACAAAACAAAACAAAACCAGAAAA"
"chr17","11904179","11904388","JH378115","24252957","24253162","48","12348778","CCTGTCTTTACAAAAAATGCAAAAACAAAACAAAACAAAACAAAACAAAAACCGGGCATGGTGGTGAGCACCTGTAATCCCAGCTACTTGGGAGTTTGAGGCAGGAGAATCACTTGAACCTGGGAAGCGGAGGTTGCAGTGAGCCGAGACCGCGCCATTGCACTCCAGCCTGGGCAACAAGAATGAAACTCTGTCTCAAAAAAAAAAAAA","TGGTGAAACCCTGTCTTTACTAAAAATACAAAAAAAAAAAAAATTAGCTGGGCATGGTGGCACATGCCTGTAGTCCCAGCTGCTCGGGAGGCTGAGGCAGGAGAATTGCTTGAACCCAGGAGGCGGAGGTTGCAGTGAGCCGAGATCGAGCCATTGCACTCCAGCCTGGGCAACAAGAGCAAAACTCCGTCTCAAAACAAAATAAA"
"chr17","15884346","15884946","JH378118","18053084","18053501","249","2168738","GCCAGGCAGGTGGCTCAGGACTGTAATCCCAGCCTTTTGGGAGGCTGAGGCGAGTGGATCACCTGAGGTCAGGAGTTCGACACCAGCCTGGTCAACATGGTGAAACCCCGTCTCTACTAAAAAATACAAAAAATTGGCCAGGCGCAGTGTCTCACGCCTGTAATCCCAGCACTTTAGGAGGCTGAGGCAGGTGGATCACTTGGTCAGGAGATCGAGACCATCCTGGCCAACATGGTGAAACCCTGTCTCTATCAAAAATACAAAAATTAGCTGGGCGTGGTGGCATATGCCTATAATCCCAGCTACTTGGGACGCTGAGGCAGGAGAATCACTTGAACCAGGGAGTCAGAAGTTGCAGTGAGCCGAGATTGCGCCACTGCACCCCAGCCTGGTGACAGAGTGAGACTGTCTTAAAAAACAAAAAACAAAAAATTAGCCAGGTATGGTACCAGGTGCCTGTAACCCCAGCTACTTGGGAGGCTGAGGCAGGAGTATCGCTTGAACCCTGGAGGTGGAGGATGCAGTGAGCTGAGAGCACGCCATTGTACTCCAGCCTGGGCAACAAGAGTGAAACTCCATCTAAAATAAATAAAAATAAAAA","GGCTGGGCGCAGTGGCTCACACCTGTAATCCCAGCACTTAGGGAAGCTGAGGCGAGTAGATCACCTGAGGTCAGGAGTTAGAGACCAGCCTGGCCATCATGGTGAAACCCCGTCTCTACTAAAGATACCAAAAATTAGCTGAGTGTGGTGCTGGGTGCCTGTAATCCCAGAAACTCAGGGTGCCTGTAATCCCAGCAACTCAGGGTGCCTTTAATCCCAGCAACTGAGGGTACCAGTAATCCCAGCAACTCAGGGTGTCTTTAATCCTAGCAACTGAGGGCACCTGTAATCCCAGCAACTCAGGAAGCTGAGACAGGAGAAGTACTTGAACCCAGAAGGCAGAGGTTGCAGTGAGCCGATATTGCACCATTGCACTCCAGTCTGGGCAACAAGAGTGAAACTCTGTCTCAAAAAAAAA"
"chr17","16331846","16332458","JH378118","18053084","18053501","252","1721238","GGCCATGTGTGGTGGTTCACACCTGTAATCTCAGAACTTTGGGAGGCCGAGGTGGGTGGATCACCTGAGGTCAGGAGTTCGAGACCAGCCTGGCCAACATGGTGAAACCTCATCTCTACTAAAAATACAAAAAATTAAGGCCATACCCAGAGACTCATGCCTGTAATCCCAGCACTTTGGGAGGCTGAGGCGGATGGATCACTTGAGGTCAGGAGTTCAAAACCAGCCTGGCCAACATGGTGAAACCCCATCTCTACTAAAAATATAAAAATTAGCCGGGTGTGATGGCAGGCACCTGTAATCCCAGCTACTTGGGAGGCTGAGGCAGGAGAATTGCTTGAACCCAGGAAGCAGAGGTTGTGGTGAGCCGAGGTCGCGCCATTGCACTCCAGCCTGGGCAACAGAATGAGACTGTCTCAAAAAAAAAAAAAAAAAAAAATCAGCCAGGAGTGGTGGCGGGGGCACCTGTAATCCCAGCTACTCGGGAGGCTGAGGCAGGAGAATCGCTTGAACTCAGGAGGCAGAGGTTGCAGTGAGCTGATATCTCGCCATTGCACTCCAGCCTGGGCAACAAGAGTGAAACTGTCTCAAAAAAAAAAAAAAAAAAAAAGAA","GGCTGGGCGCAGTGGCTCACACCTGTAATCCCAGCACTTAGGGAAGCTGAGGCGAGTAGATCACCTGAGGTCAGGAGTTAGAGACCAGCCTGGCCATCATGGTGAAACCCCGTCTCTACTAAAGATACCAAAAATTAGCTGAGTGTGGTGCTGGGTGCCTGTAATCCCAGAAACTCAGGGTGCCTGTAATCCCAGCAACTCAGGGTGCCTTTAATCCCAGCAACTGAGGGTACCAGTAATCCCAGCAACTCAGGGTGTCTTTAATCCTAGCAACTGAGGGCACCTGTAATCCCAGCAACTCAGGAAGCTGAGACAGGAGAAGTACTTGAACCCAGAAGGCAGAGGTTGCAGTGAGCCGATATTGCACCATTGCACTCCAGTCTGGGCAACAAGAGTGAAACTCTGTCTCAAAAAAAAA"
"chr17","16464101","16464461","JH378293","1845184","1845523","61","14618917","GGCCGGGCGCCGTGGCTCACGCCTATAATCCCAGCACTTTGGGAGGCCGAGGCGGGTGGATCACCTGAGGTCAGGAGTTCGAGACCAGCCTGACCAACATGGTGAAACCCCCGTCTCTGCTAAAAAAAAAAAAATATATATATATATATATATAATATATAATATATATATATATATATATATAAAATAGCTGGGCATGGTGGCAGGCACCTGTAATCCCAGCTACTCAGGAGGCTGAGGCAGGAGAATCGCTTGAACCTGGGAGGTGGAGGTTGCAGTGGGCTAAGATCACACCATCGCACTCCAGCCTGGGCGACAGGAATGAAACGCTGTCTCAAAAAAAAAAAAAAAAAAAAAAAAA","GGCCGGGTGCGGTGGCTCACGCCTGTAATCCCAGCACTTTGGGAGGCCAAGGCGGGTGGATCACCTGAGGTCAGAAGTTCGAGACCAGCCTGGCCAACATGGTGAAACCCCGTCTCTGCTAAAAAGAAAAAAATAAGAAAAAAACAAAATAAGAAAATAATTTTAAAAAATACAAAATTAGCTGGGCGTGGTGGCAGGCACCTGTAATTCCAGCTATTCAGGAGGCTGAGGCAGGGGAATCACTTGAACCCAGGAGGCAGAGGTTGCAGTGAGCCAAGATGACGCCATTGCACACCAGCCTGGGCAACAAGAGTGAAACTCCGTCTCAAAAAAAAAACAA"
"chr17","16469420","16470033","JH378118","18053084","18053501","254","1583664","GCCAGGGGTGGTGGCTCATGCCTGTAATCCCAGCACTTTGGGAGGCTGAGGCGGGCAGATTGCCTGAGGTCAGGAATTCAAGACCAGCCTGGCCAACATAGTGAAACCCTGTCTCTACTAAAAATGCAAAGAATTAGCTGGGTGTTGGCCGGGCACGGTGGCTGACACCTGTAATCCCAGCACTTTGGGAGGCCTAGGCAGGCGGATCACCTGAGGTTGGGAGTTCGAGACCAGCCTGACCAACATGGAGAAACCCCGTCTCTACTGAAAATAAAAAACTAGCCAGGCATGGTGGCCCATGCCTGTAATCCCAGCTAATTGGGAGGCTGAGGCAGGAGAATCGCTTGAACCCAGGAGGCAGAGGTTGCGGTGAACCAAGATCGCATCAATGCACTCCAGCCTAGGCGACAAGAGCAAAACTCCGTCTCAAAAAAAAGAATTAGCTGGGTGTGGTGGGTGGGAACCTGTAATCCCAGTTACTAGGGAGGCTGAGGCAGGAGAATTGCTTGAACCCAGGAGGCGGAGGTTGTGGTGAGCCGAGATCGCGCCATTGCACTCCAGCCTGGACAACAAGAGCGAATCTCCGTCTCAAAAAAAAAAAAAAAAAAAAAAAA","GGCTGGGCGCAGTGGCTCACACCTGTAATCCCAGCACTTAGGGAAGCTGAGGCGAGTAGATCACCTGAGGTCAGGAGTTAGAGACCAGCCTGGCCATCATGGTGAAACCCCGTCTCTACTAAAGATACCAAAAATTAGCTGAGTGTGGTGCTGGGTGCCTGTAATCCCAGAAACTCAGGGTGCCTGTAATCCCAGCAACTCAGGGTGCCTTTAATCCCAGCAACTGAGGGTACCAGTAATCCCAGCAACTCAGGGTGTCTTTAATCCTAGCAACTGAGGGCACCTGTAATCCCAGCAACTCAGGAAGCTGAGACAGGAGAAGTACTTGAACCCAGAAGGCAGAGGTTGCAGTGAGCCGATATTGCACCATTGCACTCCAGTCTGGGCAACAAGAGTGAAACTCTGTCTCAAAAAAAAA"
"chr17","17534259","17534875","JH378118","18053084","18053501","268","518825","GGCTGGGGCGGTGGCTCACCTGTAATCCCAGCACTTTGGGAGGCAGAGGTGGGCGGATCGCCTGAGGTCAGAAGTTGGAGACCAGCCTGGCAACATGGTGAAACCCTGTCTCTACTAAAAAAAAAAAAAAAAAAAAAAAATGGCCGGGCATGGTGGCTCAAGCCTGTAATCCTAGCACTTTGGAAGGCTGAGGCGGGTGGATCACAAGGTCAGGAAATCGAGACCATCCTGGCTAACATGGTGAAACTCCGTCTCTACTAAAAATACAAAAAAAATTAGCCGGGCGTGGTGGTGGGTGCCTGTAGTCCCAGCTACTCGGGAGGCTGAGGCAGGCAAATGGAGTGAACCCGGGAGGCAAACTTGCAGTGAGCCAAGATGGCGCCATTGCACTCCAGCCTGGGCAACAAGAGCAAGACTCCTTCTCAAAAAAAAAAAAAATATATATATATATATATAGTCGGGCATGGTGGCAGGCACCTGTAATCCCAGCTACTCAGAGGCTGAGGCAGGAGAATCGCTTGAACCCTGGAGGTGGAGGTTGCAGTGAGCCAAGGTCATGCCATTGCACTCCAGCCTGGGCAACAAGAGCAAGACTCCGTCTCAAAAAAAAAAAAAAA","GGCTGGGCGCAGTGGCTCACACCTGTAATCCCAGCACTTAGGGAAGCTGAGGCGAGTAGATCACCTGAGGTCAGGAGTTAGAGACCAGCCTGGCCATCATGGTGAAACCCCGTCTCTACTAAAGATACCAAAAATTAGCTGAGTGTGGTGCTGGGTGCCTGTAATCCCAGAAACTCAGGGTGCCTGTAATCCCAGCAACTCAGGGTGCCTTTAATCCCAGCAACTGAGGGTACCAGTAATCCCAGCAACTCAGGGTGTCTTTAATCCTAGCAACTGAGGGCACCTGTAATCCCAGCAACTCAGGAAGCTGAGACAGGAGAAGTACTTGAACCCAGAAGGCAGAGGTTGCAGTGAGCCGATATTGCACCATTGCACTCCAGTCTGGGCAACAAGAGTGAAACTCTGTCTCAAAAAAAAA"
"chr17","17916069","17916669","JH378118","18053084","18053501","243","137015","GCCGGGTACAGTGGCTCACACCTGTAATCCTAGCACTTTGGGAGGCCGAGGCGGGTGGATCACCTGAGGTCAGGAGTTCGAGACCAGCCTGGCCAACATGATGAAACCCTACCTCAGCCAGGTACGGTGGTTCACGCCTGTAATCCTAGCACTTTGGGAGGCTGAGGCAGGTGGATTGCCTGAACTCAGGAGTTTGAGACCAGCCTGGGCAGCATGGTGAAACCCCATCTGTACTAAAATACAAAAACTTTGCTGGGCGTGGCGGCATGCACATGTAGTCCCAGTTACTTGGGAGGCTGAGGCAGGATAATTGTTTGAACCTGGGAGGCGGAGGTTGTACAGTGAGCCAAGATCGCGCCACTACACTCTAGCGTAGGTGACAGAGCGAGATTCCGCCTCCAAAAAAAAAAGAAACCCTGTCTCTACTAAAAATACAAACAATTAGCTGGGCGTGGTGGTGGGCGCCTGTAATCCCAGCTACTTAGGAGGCTGAAGCAGGAGAATCGCTTGAGCCCAGGAAGTGGAGGTTGCAGTGAGCTGAGATTGCTCCATTGCACTCTAGCCTGGGCAACAAGAGTGAAACTCTGTCTCAAAAAAAGAA","GGCTGGGCGCAGTGGCTCACACCTGTAATCCCAGCACTTAGGGAAGCTGAGGCGAGTAGATCACCTGAGGTCAGGAGTTAGAGACCAGCCTGGCCATCATGGTGAAACCCCGTCTCTACTAAAGATACCAAAAATTAGCTGAGTGTGGTGCTGGGTGCCTGTAATCCCAGAAACTCAGGGTGCCTGTAATCCCAGCAACTCAGGGTGCCTTTAATCCCAGCAACTGAGGGTACCAGTAATCCCAGCAACTCAGGGTGTCTTTAATCCTAGCAACTGAGGGCACCTGTAATCCCAGCAACTCAGGAAGCTGAGACAGGAGAAGTACTTGAACCCAGAAGGCAGAGGTTGCAGTGAGCCGATATTGCACCATTGCACTCCAGTCTGGGCAACAAGAGTGAAACTCTGTCTCAAAAAAAAA"
"chr17","18237318","18237912","JH378118","18053084","18053501","239","184234","GGCCATGCGTGGTGGCTCACGCCTGTAATCCCAGTACTTTGGGAGGCTGAGGTGGGAGGATCACCTGAGGTCAGGAGTTCGAGACCAGCCTGGCCAACATGATGAAACCCTGTCTCTACTAAAAATGCAAAAAATTGGCCGGGCACGGTGGCTCACGCCTGTAATCCCAGCACTTTGGGAGGCCAAGGCGGGTGGATCACAAGGTCAGGAGCTTGAGACCAGCCTGGCCAATATGGTGAAACCCCATCTCTACTAAAAATACAAAAATTAGCCAGGCGTGGTGGTACACACCTGTAGTCCCAGCTACTCGGGAGGCTGAGGCAGGAGAATTGCTTGAACTCAGGAGGCAGAGGTTGCAGTGAGCTGAGATGGTGCCACTGCACTGCAGCCTGGGCAACAGAGTGAGACTTCATCTCAAAAAAAAAAAAAAAATTAACCGGGTGTGGTGGCACGTGCCTATGGTCCCAGCCACTGGGGAGGCTGAGGCAGGAGAATCGCTTGAACACAGGAGGCAGAAGTTGCAGTGAGCTGAGATTGCACCACTGCACTCCAGCCTGGGTGACAAGAGTGGAACTCCATCTCAAAAAAAAAAGAA","GGCTGGGCGCAGTGGCTCACACCTGTAATCCCAGCACTTAGGGAAGCTGAGGCGAGTAGATCACCTGAGGTCAGGAGTTAGAGACCAGCCTGGCCATCATGGTGAAACCCCGTCTCTACTAAAGATACCAAAAATTAGCTGAGTGTGGTGCTGGGTGCCTGTAATCCCAGAAACTCAGGGTGCCTGTAATCCCAGCAACTCAGGGTGCCTTTAATCCCAGCAACTGAGGGTACCAGTAATCCCAGCAACTCAGGGTGTCTTTAATCCTAGCAACTGAGGGCACCTGTAATCCCAGCAACTCAGGAAGCTGAGACAGGAGAAGTACTTGAACCCAGAAGGCAGAGGTTGCAGTGAGCCGATATTGCACCATTGCACTCCAGTCTGGGCAACAAGAGTGAAACTCTGTCTCAAAAAAAAA"
"chr17","18951167","18952093","JH378118","18053084","18053501","537","898083","GGCCAGGGGCAGTGGCTCATGCCTGTAATCCCAGCATTTTGGGATGCCAAGGCTGGTGGATCAACTGAGGTCAGGAGTTTCAGACCACCCTGGCCAACATGGCGAAATCCCATCTCTACTAAAAATACAAAAATTAGGCCAGGCACAGTGGCTCATGCCTGTAATCCCAGCACTTTGAGAGGCCAAGGCGGGCGATCACGAGGTCAGGAGATTGAGACCATCCTGGCTAACACGGTGAAATCCTGTCTCTACTAAAAAAAAAAAATACAAAAAATTAGCCGGGACGTGGTGGCTGGCACCTGTAGTCCCAGCTACTCGGGAGGCTAAGGCAGGAGAATGGCATGAACCCGGGAGATGGAGCTTGCAGTGACCCGAGATCGCGTCACTGCACTCCAGCCTGAACAACAGAGCAAGACTATATCTCAAAAAAAAAAAAAAAAAAAAGGCCGGGTGCAGTGGCTCACGTCTGTAATCCCAGCACTTTGGGAGGCCGAGGTGGGTGGATCACGAGGTCAGGAGATCGAGACCATCCTGGCTAACATGATGAAACCCCATCTCTACTAAAAAATACAAAAAATTAGCCGGGTGTGGTGGCAGGCACCTGTAGTCCCAGCTACTCGGGAGGCTGAGGCAGGAGAATGGCATGAACCTGGGTAGTGGAACTTGCAGTGAGCCGAGATCACGCCACTGCACTCCAGCCTGGGCGACAGAGCGAGACTCTGTCTCAAAAAAAAAAAAAAAAAAAAAATTAGCCGGGCATGGTGGTGGGTGCCTGCAATCCCAGCTAGTCAGGAGGCTGAGGCTGGAGAATCCCTTGAACCCAGGAGGTAGAGGTTGCAGTGAGCCAAGATCACGCCATTGCATTCCAGCCTGGGCAACAAGAGTGAAATTCTGTCTCAAAAAAATAAACAAACAAGTAAAATAAAA","GGCTGGGCGCAGTGGCTCACACCTGTAATCCCAGCACTTAGGGAAGCTGAGGCGAGTAGATCACCTGAGGTCAGGAGTTAGAGACCAGCCTGGCCATCATGGTGAAACCCCGTCTCTACTAAAGATACCAAAAATTAGCTGAGTGTGGTGCTGGGTGCCTGTAATCCCAGAAACTCAGGGTGCCTGTAATCCCAGCAACTCAGGGTGCCTTTAATCCCAGCAACTGAGGGTACCAGTAATCCCAGCAACTCAGGGTGTCTTTAATCCTAGCAACTGAGGGCACCTGTAATCCCAGCAACTCAGGAAGCTGAGACAGGAGAAGTACTTGAACCCAGAAGGCAGAGGTTGCAGTGAGCCGATATTGCACCATTGCACTCCAGTCTGGGCAACAAGAGTGAAACTCTGTCTCAAAAAAAAA"
"chr17","20996420","20997041","JH378118","18053084","18053501","266","2943336","GGCTAGGCGCGGTGGTTCACACCTGTAATCCCAGCACTTTGGGAGGCCAAGGTGGGTGGATCACCTGTGGTCAGGAGTTCGAGACCAGCCTGGCCAACATTGTGAAACCCCGTCTCTACTAAAAATGCAAAAAATTAGCTGGGCGACCAGTCATGGTAGCTCACGCCTGTAATCCTAGCACTTTGGGAGGCCAAGGCGGGTGGATTGCCTGAGCTCAGGAGTTAGAGGCCAGCCTGGGCAACATGGTAAAACCCTGTCTCTACTAAAATACAAAAAAAAAAAAAAAAATTAGCTGGGTGTGACAGCGTGCATCTGTAATCCCGGTTACTTGGGAGGTTGAGGCAGGAGAATTCCTTGAACCTAGGAGGCGGAGGTTACAGTTAGCCGAGATCACGCCATTGCACTCCAGCCTGGGCAACAGAGCGAGACTCCATCTCAAAAAAAAAAAAAAAAATTCAGCTGGGCGTGGTGGCGGGCACCTGTGATCCTAGCTACTCAGGAGGCTGAGGCAGGAGAATCATTTGAACTCCGGAGGCGGAGGTTGCAGTGACCCTAGATCGCACCATTGTGTTCCAGCCTGAGCAACAAGAGCGAGACGCCATCTGAAAAAAAAAAAAAGAAA","GGCTGGGCGCAGTGGCTCACACCTGTAATCCCAGCACTTAGGGAAGCTGAGGCGAGTAGATCACCTGAGGTCAGGAGTTAGAGACCAGCCTGGCCATCATGGTGAAACCCCGTCTCTACTAAAGATACCAAAAATTAGCTGAGTGTGGTGCTGGGTGCCTGTAATCCCAGAAACTCAGGGTGCCTGTAATCCCAGCAACTCAGGGTGCCTTTAATCCCAGCAACTGAGGGTACCAGTAATCCCAGCAACTCAGGGTGTCTTTAATCCTAGCAACTGAGGGCACCTGTAATCCCAGCAACTCAGGAAGCTGAGACAGGAGAAGTACTTGAACCCAGAAGGCAGAGGTTGCAGTGAGCCGATATTGCACCATTGCACTCCAGTCTGGGCAACAAGAGTGAAACTCTGTCTCAAAAAAAAA"
"chr17","21298865","21299429","JH378206","6546474","6546861","222","14752391","GGCCGAGGCAGGTGGATCACCTGAGGTCAGGAGTTCAAGACTAGTCTGGCCAACATGGTGAAACCCTGTCTCTACTAAAAATACAAAAAATTGGCCGGGCGCGGTGGCTCATGCCTGTAATCCCAGCACTTTGGGAGGCTGAGGCGGGTGGATCACGAGGTCGGGAGATCGAGACCATCCTGGCTAACACAGTTAAACCCTTTCTCTACTAAAAAATACAAAAAATTAGCCGGGCGTAGTGGGGGGCGCCTGTAGTCCCAGCTACTCAGGAGGCTGAGGCAGGAGACTGGCGTGAACCCGGGAGGCAGAGCTTGCAGTGAGCTGAGATCACGTCACTGCATGCCAGCCTGGGCGACAGAGCGAGACTCTGTCTCAAAAAAAAAAAATTAGCCAGGCATGGTGGTGTACACCTGTAATCCTAGCTACTCGGGAAGCTGAGCAGGAGAACAGCTTGAACCCAGGAGGCAGAGGTTGCAGTGAGCTGAGATCACGCCATTGCACTCCAGCCTGGGCAACAAGAGTGAAACTCCGTCTCAAAAAAAAAAAAAGAAAAGAAAAAAGAAAA","GGCCACACATGGTGGCTAACGCCTGTAATCCCAGCACTTTGGGAGGCCAAGTCGGGTGGATCATGAGGTCAGGAGACCAAGACCATCCTGGCCAAATGGTGAAACCCCGTCTCTACTAAAAATACAAAAATTAGCTGGGCATGGTGGCGTGTGCCTGTAATCCCAGCTACTCAGGAGGCTGAGGCAGGACAATTGCCTGAACCCAGGAGAATTAGCTGGGCATGGTGGCGTGTGCCTGTAATCCCAGCTACTCAGGAGGCTGAGGCAGGACAATTGCCTGAACCCAGGAGGCGAAGGTTGCGGTGAGCCGAGATTGTGCCATTGCACTCCAGCCTGGGTAACAAGAGCGACACTCTGTCTCAAAAAAAAAAAAAAAAAAAAAAAAAAA"
"chr17","21663027","21663921","JH378118","18053084","18053501","517","3609943","TTGGGAGGCCAAGGTGGGCCTCCCAGACACGTGAGGTCAGGAGTTTGAGACCAGCCTGGACAATATGGCGAAACCCCATCTCTACTAAAAAAACACAAAAATTGGTTGGGCCGGGCACGGTGGCTCACGCCTGTAATCCCAGCACTTTGGGAGGCCGAAGTGGGCAGATCACGAGGTCAGGAGATCGAGATCATCTTGGCTAACATGGTGAAACTCCGTCTTTACTTAAAATACAAAAAATTAGCTGGGCATGATGGCAGGCAGTTGGAGTCCCAGCTACTTGGGAGGCTGAGGCAGGAGAATCGCTTGAACCCGGGAGGCAGAGGTTGCAGTGAGCTGAGATCGTGCCATTGCACTCCAGCCTGGGTGACAGAATGAGACTCCGTCTGAAAAAAAAACAAAAAACAAAAAACAAAAATTGGCCAGGTGCGGTGGCTCACGCCTGTAATCCCAGAACTTTGGGAGGCCGAGGCAGGTGGATCATGAGGTCAGGAGTTCAAGACCAGCCTGGCCAAGATGGTGAAACCCCATCTCTACTAAAAATACAAAAATTAGGCGGGCACGGTGGCAGGTGCCTGTAATCTCAGCTACTCAGGAGGCTGAGGCAGGAGAATTGCCTGAAGCCGGGTGGCAGAGGTTGCAGAGAGCTAAGATCACGCCACTGCACTCCAGCCTGGGTGATAGAGTAAGACTCTATCTCAAAAAAAGAAAAAAAAAAATAGCCGGGCATTGTGCTGGGCGCCTGTAATCCCAGCTACTTGGGAGGCTGAGACAAGAGAATCACTTGAACCTGGGAGGCGGAGGTTGCAGTGAGCCGAGATCGTGCCATTGCACTCCAGCCTGGGTGAGAAGAGCAAAACTCTGTCTCAAAAAAACAAAAAAAGAAGAAAACAAA","GGCTGGGCGCAGTGGCTCACACCTGTAATCCCAGCACTTAGGGAAGCTGAGGCGAGTAGATCACCTGAGGTCAGGAGTTAGAGACCAGCCTGGCCATCATGGTGAAACCCCGTCTCTACTAAAGATACCAAAAATTAGCTGAGTGTGGTGCTGGGTGCCTGTAATCCCAGAAACTCAGGGTGCCTGTAATCCCAGCAACTCAGGGTGCCTTTAATCCCAGCAACTGAGGGTACCAGTAATCCCAGCAACTCAGGGTGTCTTTAATCCTAGCAACTGAGGGCACCTGTAATCCCAGCAACTCAGGAAGCTGAGACAGGAGAAGTACTTGAACCCAGAAGGCAGAGGTTGCAGTGAGCCGATATTGCACCATTGCACTCCAGTCTGGGCAACAAGAGTGAAACTCTGTCTCAAAAAAAAA"
"chr17","21688652","21689276","JH378118","18053084","18053501","258","3635568","GGCCGGGTGCCATGGCTCACGCCTATAATCCCAGCACTTTGGGAGGCCAAGGTGGGCGGATCACCTGAGGTCAGGAGTTTGAGACCAGCCTGGCCAACATAGTGAAACCCCGTCTCTACTAAAAATACGAAAAGTTAGCTGGGGGTGCAGTGGCTCACACCTGTAATTCCAGCACTTTGGGAGGCCGAGGCAGGTGAATCACGAGGGGAGGAGTTTGAGACCAGCCTAACCAATATGTTGAAACCCCGTTTCTACTAAAAATACAAAAATTAGCTGGGCGTGGTGGCACGTGCCTATAATCCCAGCTACTCAGGAGGCTGAGGCAGGAGAATCGCCTGAACCTGGGAGGCGGAGGTGGCAGTGAGCCAAGATCACACCACTGCACTTTAGCCTGGGTGACAGAGGGAGACTCTGTCTCAAAAAACAAAACAAAACAAAACAAAAAATTAGGCAGGCTTGGTGGCACATGCCTGTAATCCCAGCTACTCAGGAGGCTGAGGCAGGAGAATTGCTTGAACCCAGGAGGCAGAAGTTGCAGTGAGCTGAGATCGCGCCATTGCACTCCAGCCTGGGTAACAAGAGTGAAACTCCATCTCAAAAAAAAAAAAAAAAAAAAAAAAAAAAA","GGCTGGGCGCAGTGGCTCACACCTGTAATCCCAGCACTTAGGGAAGCTGAGGCGAGTAGATCACCTGAGGTCAGGAGTTAGAGACCAGCCTGGCCATCATGGTGAAACCCCGTCTCTACTAAAGATACCAAAAATTAGCTGAGTGTGGTGCTGGGTGCCTGTAATCCCAGAAACTCAGGGTGCCTGTAATCCCAGCAACTCAGGGTGCCTTTAATCCCAGCAACTGAGGGTACCAGTAATCCCAGCAACTCAGGGTGTCTTTAATCCTAGCAACTGAGGGCACCTGTAATCCCAGCAACTCAGGAAGCTGAGACAGGAGAAGTACTTGAACCCAGAAGGCAGAGGTTGCAGTGAGCCGATATTGCACCATTGCACTCCAGTCTGGGCAACAAGAGTGAAACTCTGTCTCAAAAAAAAA"
"chr17","22129020","22129352","JH378128","1602813","1603145","53","20526207","GCCAGGCACGGTGGCTCACACCTGAATTCCAGTACTTTGGGAGGCCGAGGCGGGCGGATCTCTTGAGGTCAGGAGTTTGAGACCAGCCTGGCCAACATGGTGAAACCCCATCTCTACTAAAAATACAAAAATTAGCCGGGCGTGGTGGCAGGTGCCTGTAATCCCAGCTACTTGGGAGGCTGAGGCAGGAGAACCTCTTGAACCCAGGAGGTGGAGGCTGCAGTGAGCTGAGATTGTGCCACTTCACTCCAGCCTGGAAGACAAGAGCAAGACTTCATCTCAAAAAAAAATAAAAAAAAAATAAATAAATAAATAAATAAAAATTTAAAAAAA","GGCCAGGTGCAGTGGCTCACGCCTGTAATACCAGCATTTTGGGAGGCCGAGGCAGGTGGATCACGAGGTTAGGAGTTTGAGACCAGCATGGCCAACATGGAGAAACCCCGTCTCTACTAAAAATACAAAAATTAACCAGGCATGGTGGCAGGTGCCTGTAATTCCATCTACTCGGGAGGCTGAGGCAGGAGAATCCCTTGAACCTGGGAGGCGGAGGTTGCAGTGAGCCGAGATTGTGCCATTGCACTCAGTCTGGGTGACAAAAACAAGACTCCATCTCAAAAAAAAAAAAAAGAAAAGAAAAAGAAAAAAAGAAAGAAAGAAAGAAAGAAA"
"chr17","22130129","22130738","JH378118","18053084","18053501","262","4077045","GGCTGGGCACAGTGGCTCACGCCTGTAATCTCAGCACTTCGGGAAGCCGAGGCGGGCAGATCAGCTGAGGTCAGGAGTTCAAGACCAGCCTGGCCATGGCAAAACCCTGTCTCTACTAAAAAATGCAAAAAATAGGGGCCAGGCACGGTGGCTCACGCCTGTAATCCCAGCATTTTGGGAGGCCAAGGCAGGCGGATCACAAGGTCAGGAGGTTGAGACCATCCTGGCCAACATGGTGAAACCCCATCTCTACTAAAAATACAAAAATTAGCTGGGTGTGGTGGCCTGTGCCTGTAATCCCAGCTACTTGGGAGGCTGAGGCAGGGGAATCACTTGAATCCAGGAGACAGAGGTTGTAGTGAGCTGAAATGGAGCCACTGCACTCCAGCCTGGCGGCAGAGCGAGACTCTGTCTCAAAAAAAAAAAAAATACAAAAAATAGCTAGGTGTGATGGTGGGCACCTGTAATCCCAGCTACTTGGGTAGCCGAAGCAGGAGAATCGCTAGAACCTGGGAGGTGGAGGTTTAGTAAGCTGAGATCACACCATTGCACTCCAGCCTGGGTATCAACAGCGAAACTCCATCTCAAAAAAAAAAAAAAAAAAAGAAAA","GGCTGGGCGCAGTGGCTCACACCTGTAATCCCAGCACTTAGGGAAGCTGAGGCGAGTAGATCACCTGAGGTCAGGAGTTAGAGACCAGCCTGGCCATCATGGTGAAACCCCGTCTCTACTAAAGATACCAAAAATTAGCTGAGTGTGGTGCTGGGTGCCTGTAATCCCAGAAACTCAGGGTGCCTGTAATCCCAGCAACTCAGGGTGCCTTTAATCCCAGCAACTGAGGGTACCAGTAATCCCAGCAACTCAGGGTGTCTTTAATCCTAGCAACTGAGGGCACCTGTAATCCCAGCAACTCAGGAAGCTGAGACAGGAGAAGTACTTGAACCCAGAAGGCAGAGGTTGCAGTGAGCCGATATTGCACCATTGCACTCCAGTCTGGGCAACAAGAGTGAAACTCTGTCTCAAAAAAAAA"
"chr17","23633062","23633662","JH378118","18053084","18053501","247","5579978","GGCCAGGCGTGGTGGCTTACGCCTGTAATCCCAGCATTTTGGGAAGCTGAGGCAGGTGGATCACCTGAGGTCAAGAGTTCAAGACCAGCCTGGCCAACATGGTGAAACCCCGTCTCTACTGCAAATACAAAAAATTAGTAGCCGGGCATGGTGGCTCACGCCTGTAATCCCAACACTTTGGTAGGCCAAGGCGGGTGGATCACCTGAGGTCGGGAGTTCGAGACCAGCCTGACCAACATGGAGAAACCCCGTCTCTACTAAAAGTACAAAATTAGCCAGGGATGGTGGCATGTGCCTGTAATCCCAGCTATTTGGGAAGCTAAGGCACAAGAATCGCTTTGAACCTGGGAGACAGAGGTTGCAGTGAGCTGAGATCGCACCATTGCACTCCCGCCTGGGCAACAAGAGCGAAACTCCATCTAAAAAAAAAAAAAAAAAAAAAAAAGCCAGGCATGGTGACAGGCACCTTGTAATCCCAGCTACTCGGAAGGCTGAGGCAGGAGAATCGCTTGAACACTGCAGAGGTTGCAGTGAGCTGAGATCACGCCATTGCACTGCAGCCTAGGCAACAAGAGTGAGACTCTATCTCAAAAAAAAGAAA","GGCTGGGCGCAGTGGCTCACACCTGTAATCCCAGCACTTAGGGAAGCTGAGGCGAGTAGATCACCTGAGGTCAGGAGTTAGAGACCAGCCTGGCCATCATGGTGAAACCCCGTCTCTACTAAAGATACCAAAAATTAGCTGAGTGTGGTGCTGGGTGCCTGTAATCCCAGAAACTCAGGGTGCCTGTAATCCCAGCAACTCAGGGTGCCTTTAATCCCAGCAACTGAGGGTACCAGTAATCCCAGCAACTCAGGGTGTCTTTAATCCTAGCAACTGAGGGCACCTGTAATCCCAGCAACTCAGGAAGCTGAGACAGGAGAAGTACTTGAACCCAGAAGGCAGAGGTTGCAGTGAGCCGATATTGCACCATTGCACTCCAGTCTGGGCAACAAGAGTGAAACTCTGTCTCAAAAAAAAA"
"chr17","34071612","34072215","JH378118","18053084","18053501","250","16018528","GGCCAGGTGTGGTGCCTTACATCTGTAATTCCAGCACTTTGGGAGGCTGAGGTGGGTGGATCACCTGAGGTCAGGAGTTCAGGACCAACCTGGCCAACATAGTGAAACCCCGTCTCACTAAAAATACAAAAATTAAAAAGAAAGAAAGAAAAAAGCCAGGTGCGGTGGCTCACACCTGTAACCCCAGCACTTTGGGAGGCCAAGATGGGCGGATCACCTGAGGTCGGGAGTTTGAGACCAGCCTGACCAACATGGAGAAACCCCGTCTCTACTAAAAATACAAAATTAACCAGGCGTGGTGGTGCATGCCTGTAATCCCAGCTACTTGGGAGGATGAGGCAGGAGAATCGCTTGAACCCTGGAGGCGGAGGTTGTGGTGAGCTGAGATCATGCCATTGCACTCCAGCCTAGGCAACAAGAGCGAGACTCCATCTCAAAAAAAAAAAAAAAATTGGGCATGGTGGTGCATGCCTGTAATCCCAGCTACTCAGGAGTCTAAGGCAGGAGAATCACTTGAACCCAGGAGGCAGAGGTTGCAGTGAGCTGAGATCACGCCATTGCACTCCAGCCTGAGCGACAAGAGTGAAACTACGTCTCAAAAAAA","GGCTGGGCGCAGTGGCTCACACCTGTAATCCCAGCACTTAGGGAAGCTGAGGCGAGTAGATCACCTGAGGTCAGGAGTTAGAGACCAGCCTGGCCATCATGGTGAAACCCCGTCTCTACTAAAGATACCAAAAATTAGCTGAGTGTGGTGCTGGGTGCCTGTAATCCCAGAAACTCAGGGTGCCTGTAATCCCAGCAACTCAGGGTGCCTTTAATCCCAGCAACTGAGGGTACCAGTAATCCCAGCAACTCAGGGTGTCTTTAATCCTAGCAACTGAGGGCACCTGTAATCCCAGCAACTCAGGAAGCTGAGACAGGAGAAGTACTTGAACCCAGAAGGCAGAGGTTGCAGTGAGCCGATATTGCACCATTGCACTCCAGTCTGGGCAACAAGAGTGAAACTCTGTCTCAAAAAAAAA"
"chr17","34329459","34330029","JH378119","32351107","32351490","237","1978352","GGCCAGGTGCCGTGGCTCACACATGTAGTCCCAGCACGTTGGGAGGCTGAGGTTAATGGATCACCTGAAGTCACAAGTTCGAGACCAGCCTGACCAACATGGTGAAACCCTGTCTCTACTAAAATATAAAAAGTAGTCGGCCGGGCGCAGTTGCTCATGCCTGTGATCGCCTGAGGTCAGGATTTCAAGCCCAGCCTGGCCAAAATGGTGAAACCCCATCTCTACTAAAAATATAAAAATTAGCCAGGCATGGTGGCAGGTGCCTGTAATCCCAGCTACTCAGGAGGTTGAGGCAGGAGAATCACTTGGACCCAGGGGGCAGAGGTTGCAGTGAGCCAAGATCACAGCATCGCACTCCAGCTTAGGCAACAAGAGAGAAACTCCATCTCAAAAAAAACCCAAAAAAAACAAAAAAACAAAAAAACCCAGGCATGGTGGCAGGCGTCTGTAATCTCAGCTACTCGGGAGGCTGAGGCAAGAGAATCGCTTGAACCTGGGAGGCAGAGGTTGCAGTGAGCCAAGATCATGCCATTGCACTCCAGACTGAGCAATAAGAGCGAAACTCCATCTC","GGCCAGGTATGGTGGCTCACACCTGTAATCCCAGCACTTTGGGAGGCCAAGGCAGGCAGACCACCTGAGGTCAGGAGTTCGAGATCAGCCTAGCCAACATGGTGAAACCCCATCTCTAGTAAAAATAAAATTAGCCAGGCATGGTGGTGCATGCCTGTAACGCAGGTCAGGAGTTCGAGATCAGCTTAGCCAACATGGTGAAACCCCATCTCTAGTAAAAATAAAATTAGCCAGGCAGGTGGTGCCGCCTGTACTCGGGAGGCTGAGGCAGGAGAATCACTTGAACCCAAGAGGCAGAGGTTGCAGTCAGCCAAGATCATGCCATTGCACTCCAGCCTAAGCAAAAAGAGTAAAACTCAGTCTCAAAACAAAAAAACAAAAAAA"
"chr17","35196292","35196625","JH378228","5665092","5665424","47","29531200","GGCTGGGCATGGTGTCTTACGCCTGGAATCCCAGCACTTTGGGAGGCCAAGGCGGGTGGATCACCTGAGGTCAGGAGTTTGAGACCAGCCTGGCCAACATGTTGAAACTCTGTCTCTACTAAAAATACAAAAATTAGCCGGGCATGGTGGCGGATGCCTGTAATCCCAACTACGTGGGAGGCTGAGGCAGGAGAATCGCTTGAACCCAGGAGATGGAGGTTGTGGTGAGCCGAGATCATGCCATTGCACTCCAGCCTGGGCAACAAGAACAAAACTCTGTCTCAAAATAAATAAAAAAATAAATAAATAAATAAAAACAACAACAACAACAAAA","GGCCGGGCGCGGTGGCTCAAGCCTGTAATCCCAGCACTTTGGGAGGCTGAGGCGGGTGGATCACGAGGTCAAGAGATCGAGACCATCCTGGTCAACATGGTGAAACCCTGTCTCTACTAAAAATACTAAAAATTAGCTGGGCATGGTGGCGTGTGCCTGTAATCCCAGCTACTCAGGAGGCTGAGGCAGGAGAATTGCCTGAACCCAGGAGGCGGAGGTTGCGGTGAGCCGAGATCGCGCCATTGCACTCCAGCCTGGGCAACAAGAGCGAAACTCTGTCTCAAAAAAAAAAAATAAATAAATAAAATAAAATAAAATAAAATAAAATAAAAT"
"chr17","40291413","40291755","JH378144","13229286","13229620","52","27062127","GGCCAGGCACAGTGGCTCATGCCTGTAATCCCAGCACTTTGCGAGGCTGAGCCAGGTGGATCACCTGAGGTCAGGAGTTCAAGAGCAGCCTGGCCAACATGGTGAAACCCCGTCTCTACTAAAAATACAAAAATTATCTGGAGTGGTGGTAGGTGCCTATAATTGCAGATACACAGAAGGCTGAGACAGGAGAATTGCTTGAACCCAGGAGGCGGAGGTTGCTGTGAGCCGAGATCGCGCCATTGCACCCCAGCCTGGGAGACAAGAGCGAAACTCCATCTCAATAAATAAATACATACATACATACATACATACATGCATACATACATAAAATAAAATAAAA","GGCCGGGCGCGGTGGCTCAAGCCTGTAATCCCAGCACTTTGGGAGGCCGAGGCGGGTGGATCACCTGTGGTCAGGAGTTCAAGACAGCTTGGTCAACATGGTGAAACCCCGTCTCTACCAAAAATACAAAAAATTAGCTGGGCATGGTAGCGCATGCCTGTAATCCCAGCTACTCAGGAGGCTGAGGCAGGAGAATTGCCTGAACCCAGGAGGCAGAGGTTGCGGTGAGCCGAGATCGCGCCATTGCACTCCAGCCTGGGTAACAAGAGCGAAACTCCCTCTCATAAAAAATAAATAAATAAATAAATAAATAAATAAATAAATAAATAAATAAA"
"chr17","45148344","45148987","JH378206","6546474","6546861","299","38601870","GGCTTGGTGCCATGGTTCATGCCTGTAATCCTGGCACTTTGGGAGGCCGAGGTGGGCAGATCACTTGAGCTCAGGAGTTCAAGACCACCTTGGGCGACATGGTGAAACCTCATCTCTCCTTAAAAAAAAAAAAAACAGCCGGGCGCGGTGGCTCACACCTGTAATCCCAGCACTTTGGGAGGCCAAGGCGGGTGGGGTTCATGAGGTCAGAAGATCGAGACCATCCTGGCTAACACGGTGAAACCCCGTCTCACTAAAAATAGAAAAAACTAGCCGGGCGTGGTGGCGGGCACCTGTAGTCCCAGCTACTCGGGAGGCTGAGGCAGGAGAATGGCGTGAACCCGGGAGGCGGAGCTTGCAGTGAGCTGAGATCTTGCCATTGCACTCCAGCCTGGGCAACAAGAGTGAAACTCTGTCTCAAAAAAAAAAAATTAAAAAAACAAATAAAAATAAAAATACATAATTAGCAGGACATGGTGGCACATGCCTGTAATCCCCAGCTACTCGGGAGGCTGAGGCATGGGAATTGTTTAAACCTGTGAGGCGGTGGTTGCAGTGAGCCAAGATCAAGCCATTGCACTCCAGCCTGGGCAACAAGAGTGAAACTCCATCTCAAAAAAAAAAAAAAAAAAGAGAAAAGAAAA","GGCCACACATGGTGGCTAACGCCTGTAATCCCAGCACTTTGGGAGGCCAAGTCGGGTGGATCATGAGGTCAGGAGACCAAGACCATCCTGGCCAAATGGTGAAACCCCGTCTCTACTAAAAATACAAAAATTAGCTGGGCATGGTGGCGTGTGCCTGTAATCCCAGCTACTCAGGAGGCTGAGGCAGGACAATTGCCTGAACCCAGGAGAATTAGCTGGGCATGGTGGCGTGTGCCTGTAATCCCAGCTACTCAGGAGGCTGAGGCAGGACAATTGCCTGAACCCAGGAGGCGAAGGTTGCGGTGAGCCGAGATTGTGCCATTGCACTCCAGCCTGGGTAACAAGAGCGACACTCTGTCTCAAAAAAAAAAAAAAAAAAAAAAAAAAA"
"chr17","47866693","47867898","JH378118","18053084","18053501","809","29813609","GGCTGGGCTTGGTGGCTCATGCCTATAATTCTAGGACTTTGGGAGGCCAAGGCGGATGGATCACCTGAGGTCAAGAGTTGGAGACCAACCTGTCCAACATGGTGAAACCCCCTCTGTACTAAAAATACAAAAATTGGCCGAGCGTAGTGGCTCATGCCTGTGATCACAGCACTTTGAGAGGCTGAGGCGGGCGGATCACAAGGTCAGGAGATCAAAACCATCCTGGCTAACAAGGTGAAACCCCATCTCTGCTAAAAAATAACAGGGCGTGGTGGCACACGGCTGTAGTCCCAGCTACTTGGGAAGCTGAGGCAGGAGAATCGCTTGAACCTGAGAGGCAGAGGTTGCAGTGAGCTGAGATCAGGCCACTGCTCTCCAGCCTGGGCAACAGAGTGAAACTCCATCTCAAAAAAAAAAAGAAAAAGGCCAGGCATGGTGGCTCACGCCTGTAATGCCAGCACTTTGGAAGACTAAGTTGGGCAGATCACAACATCAGAAGATGGAGACCATCCTGGCTAACACGGTGAAACCCCGTCTCTACTAAAAATACAAAAAAAAAAAAAAAAAAAATTAGCCGGGCGTGGTGACATGCGCCTGTAATCCTAGCTACTCCGGAGGCTGAGGCAGGAGAATGGCGTGAACCCGGGAGGCGGAGCTTGCAGTGAGCCGAGATGGTGCCACTGCACTCCAACCTGGGCGACAGAGCGAGACTCTGTCTCAAAAAAAAAAAAAAAAAAGAAAAAAGGTCGGGCGCAGTGGCTCACACCAGTAATCACAGCACTTTGGGAGGCCGAGGCGGGTGGATCACCTGAGCTCGGGAGTTCAAGACCAGCCTGACCAACATGGTGAAACTCCGTCTCTACTAAAAATACAAAATATTAGCCGGGCGTGGTGGCGCGTGCCTGTAATCCCAGTTACACGGGAGGCTGAGGCAGGAGAATCACTTGAACTTGGGAAGTGGAGGTTGTGGGAGCCGAAATCGTGCCATCGCATTCCACAAGAGTGAAACTCCATTTCAAAAAAAAAAAATACAAAAATTAGCTGGGCGTGGTGGCGGGCGCCTTTAATCCCAGGGGCTCGGGAGGCTGAGGCAGGAGAATCGCTTGAACCTAGGAGGCAGAGGTTGCAGTGTGCCAAGATGACACCATTGCACTCCAGGCTGGGCAAGAGAGCAGTAACTCCCGTCTCAAAAAAAAAGAAGGAAAA","GGCTGGGCGCAGTGGCTCACACCTGTAATCCCAGCACTTAGGGAAGCTGAGGCGAGTAGATCACCTGAGGTCAGGAGTTAGAGACCAGCCTGGCCATCATGGTGAAACCCCGTCTCTACTAAAGATACCAAAAATTAGCTGAGTGTGGTGCTGGGTGCCTGTAATCCCAGAAACTCAGGGTGCCTGTAATCCCAGCAACTCAGGGTGCCTTTAATCCCAGCAACTGAGGGTACCAGTAATCCCAGCAACTCAGGGTGTCTTTAATCCTAGCAACTGAGGGCACCTGTAATCCCAGCAACTCAGGAAGCTGAGACAGGAGAAGTACTTGAACCCAGAAGGCAGAGGTTGCAGTGAGCCGATATTGCACCATTGCACTCCAGTCTGGGCAACAAGAGTGAAACTCTGTCTCAAAAAAAAA"
"chr17","48059944","48060302","JH378108","45564157","45564495","64","2495787","GGCCGGGCGCAGTGGTTCATGCCTGTAATCCCAACACTTTAGGGGGCTGAGGCAGGTGGATCACCTGAGGTCAGGAGTTCAAGACCAGCCTGGCCAACATGGTGAAAGCCCATCTCTACTAAAAATACAAAAAATTAGCTGGGCATGGTGGTGCGTGCCTGTAATCCCAGCTACTTGGGATGCTGAGGCAGGAGAATCGCTTGAACCCGGGAGGTGGAGGCTGCAGTGAGCTGAGATTGTGCCATTGCACTCCAGCCTGGGCAACAAGAGTGAAACTCCATCTAAAAAAAAAAAAGAAGAGGAGGAGGAGGAGGAGGGGGAGGGGGAGGAGGAGGAGGAGGAGAAGAAGAAAAAAGAAA","GCTAGGCAAGGTGGCTCATGCCTGTAATCCCAACATTTTGGGAGGCCGAGGCAGATGGATCACCTGAGGTTAGGAGTTCAAGACCAGCCTGGCCAACATGGTGAAACTCCATCTCTACTAAAAATACAAAAAATTAGCTTGGCACGGTGGTGGGTGCCTCTAATCCCAGCTGCTTGGGAGGCTGAGGCAGGAGAATCGCTTGAACTCAGGAGGTGGAGGTTGCAGTGAGCCAAGATCATGGCATTGCACTCCAGCCTGGGCGACAAGAGCGAGACTCCCTCTAAGAAAGAAAAGAAAGAAAAGAAAAGAAAAAAGGAAAGGAAAGGAAAGAAAGAGAAA"
"chr17","50365982","50366602","JH378118","18053084","18053501","274","32312898","GGCAAGGCGTGGTGGCTGATGTCTGTAATCCCAGCAATTTGGGGGGCTGAGGTGGATGGATCACCTGAGATCAGAAGTTCGAGACTAGGCTAGCCAACATAGTGAAACCCCATCTCTACTAAAAATATAAAAAGTTAGCCAGGCGCGGTGGTTCATGCCTGTAATCCCAGCACTTTGGGAGGCCGAGGTAGGTGGATCACAAGGTCAGGAGTTCAAGACCAACCTGGCCAAGATAGTGAAACCTCATCTCTACTAAAAATACAAAAATTAGCTGGGCGTGGTGGCAACCACCTATGATCCCAGCTACTTGGGAGGCTGAGGCAGAGAACTGCTTGAACCCAGGAAGTGGAGGTTGTAGTGAGCCAAGATTGCATCACTGTACTCCAGCCTGGGCAACAGAGCAAGACTCCATCTCAAAAAAAAAAAAAAAAAAAATACAAAAAATTAGCCAGGCGTGGTGGCAGGCACCTGTAATCCCAGCTACTCGGAAGGCTGAGGCAGGAGAATTGCTTGAACCTGGGAGGTAGAGGTTGCAGTGAGCTGAGATTGTGCCATTGCACTCTAGCCTATGTGACAAGAGCGAAACTCCATCTCAAAAAAAAAAAAAAAAAAGAAAGAAAA","GGCTGGGCGCAGTGGCTCACACCTGTAATCCCAGCACTTAGGGAAGCTGAGGCGAGTAGATCACCTGAGGTCAGGAGTTAGAGACCAGCCTGGCCATCATGGTGAAACCCCGTCTCTACTAAAGATACCAAAAATTAGCTGAGTGTGGTGCTGGGTGCCTGTAATCCCAGAAACTCAGGGTGCCTGTAATCCCAGCAACTCAGGGTGCCTTTAATCCCAGCAACTGAGGGTACCAGTAATCCCAGCAACTCAGGGTGTCTTTAATCCTAGCAACTGAGGGCACCTGTAATCCCAGCAACTCAGGAAGCTGAGACAGGAGAAGTACTTGAACCCAGAAGGCAGAGGTTGCAGTGAGCCGATATTGCACCATTGCACTCCAGTCTGGGCAACAAGAGTGAAACTCTGTCTCAAAAAAAAA"
"chr17","50542261","50542886","JH378206","6546474","6546861","277","43995787","GCCGGGCGCTGTGGCTCAAGCCTGTAATCCCAGCATTTTGGGAGACTAAGGGAAGCAGATCCTGTGAGCTCAGGATTTCGAGACCAGCCTGGCCAACATGGTGAAACCCTGTCTCTACAAAAATTAGCCATGCCGGGCACGGTGGCTCACGCCTGTAATCCCAGCACTTTGGGAGGCTGAGGCGGGCGGATCACAAGGTCAGGAGTTTGAGACCATCCTGCCTAACACGGTGCAACCCCGTCTCTACCAAAAATACAAAAAATTAGCTGGGCGTGGTGGCGGGTGCCTGTAGTCCCAGCTACTCGGGGGGCTGAGGCAAGAGAATGGCATGAACCTGTGGGGCGGAGCTTGCTGTGAGCCGATATCCTGCCACTGCACTCCAGCCTGGGCGACAGAGCGAGACTCCATCTCAAAAAAAAAAAAAAAAAAAAAAAAAAAAAAAAATGAGCCAGCTGTGGTGGCGTGTGTGCCTGTAATCCCAGCTACTCGGGAGGCTGAGGCAAGAGAATCACTTGAATCTGGGAGGCAGAGGTTGCAGTGAGCCAAGATCATGCTATTGCACTTCAGCCTGGGCAACAAGAGTGAAACTCTGTCTCAAAAAAAAAAAAAAAAAAAAAGAAAAAGAA","GGCCACACATGGTGGCTAACGCCTGTAATCCCAGCACTTTGGGAGGCCAAGTCGGGTGGATCATGAGGTCAGGAGACCAAGACCATCCTGGCCAAATGGTGAAACCCCGTCTCTACTAAAAATACAAAAATTAGCTGGGCATGGTGGCGTGTGCCTGTAATCCCAGCTACTCAGGAGGCTGAGGCAGGACAATTGCCTGAACCCAGGAGAATTAGCTGGGCATGGTGGCGTGTGCCTGTAATCCCAGCTACTCAGGAGGCTGAGGCAGGACAATTGCCTGAACCCAGGAGGCGAAGGTTGCGGTGAGCCGAGATTGTGCCATTGCACTCCAGCCTGGGTAACAAGAGCGACACTCTGTCTCAAAAAAAAAAAAAAAAAAAAAAAAAAA"
"chr17","51121894","51122508","JH378118","18053084","18053501","260","33068810","GGCTGGGTGCAGTGGCTCATGCCTGTATTCCCAACACTTTGAGAGGCCAAGGCGGGCAGATCACCTGAGGTCAGGAATTCGAGACCAGCCTGGCTAACATGGCGAAACCCTGTCTCTATTAAAAACACAAAAATTAGGCCAGGCACGGTGGCTCACACCTGTAATCCCAGCACTTTGGGAGGCTGAGGCGGGCAGATCACGAAGTCAGGAGATCGAGACCATCCTGGCTAACATGGTGAAACCCTGTCTCTGCTAAAAATACAAAAAAAATAGCGGGGCGTGGTGGCAGGCGCCTGTAGTCCCAGCTACTCAGGAGGCTGAGGCAGGAGAATGGCGTGAACCTGGGAGGCGGAGGTTGCAGTGAGCCGAGATCGCGCCACTGCACTACAGCTTGGGTGACAGAGCGAGACTCTGTCTCAAAAAAAAAAAAAAAAGTTAGTCGGGCATGGTGGTGGGCTCCTGTATTCCCAGCTACTCAGGAGGCTGAGGTGGGAGAATCACTTGAACCTGGAAGGCAGAGGTTGCTGTGAGCCAAGATTGCACCATTGCATTCCAGCCTGGGTGACAAGAGCAAAACTCTGTCTCAAAAAATATATATAAAATAATAAAAATAAA","GGCTGGGCGCAGTGGCTCACACCTGTAATCCCAGCACTTAGGGAAGCTGAGGCGAGTAGATCACCTGAGGTCAGGAGTTAGAGACCAGCCTGGCCATCATGGTGAAACCCCGTCTCTACTAAAGATACCAAAAATTAGCTGAGTGTGGTGCTGGGTGCCTGTAATCCCAGAAACTCAGGGTGCCTGTAATCCCAGCAACTCAGGGTGCCTTTAATCCCAGCAACTGAGGGTACCAGTAATCCCAGCAACTCAGGGTGTCTTTAATCCTAGCAACTGAGGGCACCTGTAATCCCAGCAACTCAGGAAGCTGAGACAGGAGAAGTACTTGAACCCAGAAGGCAGAGGTTGCAGTGAGCCGATATTGCACCATTGCACTCCAGTCTGGGCAACAAGAGTGAAACTCTGTCTCAAAAAAAAA"
"chr17","51573403","51574012","JH378118","18053084","18053501","260","33520319","GGCCGGGTGTGGTGGCTCACGCCTATTATCCCAGCAGTTTGGGAGGCCAAGTGGGGGTTGGATCACCTGAGGTCAGGGGTTCGAGACCAGCATGGCCAACATGGTGAAAACCCATCTATACTAAAGATACAAAAAATTAGGCTGGGCACAGTGGCTCATGCCTGTAATCCCAGCACTTTGGGAGGCCAAGGATCACGAGGTCAGGAGATCGAGACCATCCTGGCTAACACAGTGAAACCCCGTCTCTACTAAAAATACAAAAAAATTAGCCGGGAGTGGTGGCAAGTGCCTGTAGTCCCAGCTACTCAGGAGGCTGAGGCAGGTGAATAGTGTGAACGCAGGAGGCAGAGCTTGCAGTGAGCCGAGATCGTGCCACTACACTCCAGCCTGGGCGACAAGGTGAGACAACGTCTCAAAAAAAAAAAAAAAAAAAAGCCGGGCATGGTGGGAGGCACCTGTAATTCCACCTACTTGGGAGGGTGAGGCAGGAGAATTGCTTGAATCTGGGAGATGGAGGTTGGAGTAAGCCAAGTTCGCACCATTGCACTCCAGCCTGGGTGACAAGAGCGAAACTCTTGTCTCAAAAAAAAAAAAAAAAAAAAAAAAAAAA","GGCTGGGCGCAGTGGCTCACACCTGTAATCCCAGCACTTAGGGAAGCTGAGGCGAGTAGATCACCTGAGGTCAGGAGTTAGAGACCAGCCTGGCCATCATGGTGAAACCCCGTCTCTACTAAAGATACCAAAAATTAGCTGAGTGTGGTGCTGGGTGCCTGTAATCCCAGAAACTCAGGGTGCCTGTAATCCCAGCAACTCAGGGTGCCTTTAATCCCAGCAACTGAGGGTACCAGTAATCCCAGCAACTCAGGGTGTCTTTAATCCTAGCAACTGAGGGCACCTGTAATCCCAGCAACTCAGGAAGCTGAGACAGGAGAAGTACTTGAACCCAGAAGGCAGAGGTTGCAGTGAGCCGATATTGCACCATTGCACTCCAGTCTGGGCAACAAGAGTGAAACTCTGTCTCAAAAAAAAA"
"chr17","51598763","51599361","JH378118","18053084","18053501","241","33545679","GCCGGGCGTGGTGACTCACGCCTGTAATACCAGCACTTTAGGAGGCTGAGGTGGGTGGATCACCTGAGGTCAGGAGTTCGAGACCGGCCTGGCCAACATGGTGAAATCCTGTCTCTACTAAAAATACAAAAAAATGGCCAGGCGTGGTGGCTCACGCCTGTAATCCTAGCACTTTGGGCGGCCCAGGTGAGTGGATCACGAGGTCAGGAGATCGAGACCATCCTGGCTAACATGGTGAAACCCCATCTCTACTAAAAAACTACAAAAAAATTAGCTGGGCGTGGTGGCAGGCGCCTGTAGTCCCAGCTACTCGGGAGGCTGAGGCAGGAGAATGACGTGAACCCGGGAGGCGGAGCTTGCAGTGAGCAGAGCTTGAGCCACTGCACTCCAGCTTGGGCGACAGAGTGAGACTCCGTCTCAAAAAAAAAAAAAAAAAAATTAGCTGGGGATGGTGGCGGGCACCTGTAATCCCAGCTACTCTGGAGGCTGAGACAGGAGAATCGCTTGAACCCAGGAGGCGGAGGTTGCAGTGAGCTGAGATCGTGCCATTGTACTCCAGCCTGGGCAACAAGAGTGAAACTCAATCCGAAGAAAAAAAA","GGCTGGGCGCAGTGGCTCACACCTGTAATCCCAGCACTTAGGGAAGCTGAGGCGAGTAGATCACCTGAGGTCAGGAGTTAGAGACCAGCCTGGCCATCATGGTGAAACCCCGTCTCTACTAAAGATACCAAAAATTAGCTGAGTGTGGTGCTGGGTGCCTGTAATCCCAGAAACTCAGGGTGCCTGTAATCCCAGCAACTCAGGGTGCCTTTAATCCCAGCAACTGAGGGTACCAGTAATCCCAGCAACTCAGGGTGTCTTTAATCCTAGCAACTGAGGGCACCTGTAATCCCAGCAACTCAGGAAGCTGAGACAGGAGAAGTACTTGAACCCAGAAGGCAGAGGTTGCAGTGAGCCGATATTGCACCATTGCACTCCAGTCTGGGCAACAAGAGTGAAACTCTGTCTCAAAAAAAAA"
"chr17","51738482","51739094","JH378118","18053084","18053501","257","33685398","GCCGGGTGCGGTGGCTCACACCTGTAATCCCAGCACTTTGGGAGACTGAGGCGGGAGGATCACCTGAGGTCAGGAGTTCGAGACCAACCTGACCAACATGGTAAAACCCTGTCTGTACTAAAACTACAAAAAATTAGGCCAGGCGCAGTGGTCCATGCCTGTAATCCCAGCACTTTGGGAGGCCAAGGTGGGCGGATCATGAGGTCAGGAGTTTGAGACCAGCCTGGCCAACATAGTGAAACCCTGTCTCTACTAAAAACACAAAAATTAGTCGGGCATGGTGGCGGATGCCTGTAATCTCAGCTACTCAGGAGGTTGAGGCAGGAGAATCACTTGAACCCGGGAGGTGGAGGTTGCAGTGAGCCAAGATCACGCCACTGTACTCCAGCCTGGGCAACAGAGCGGGACTCCATCTTAAAAAAAAAAAAAAAAAAATTAGCCAGGCGTGGTGGCGCATGCCTGTAGTCCCAGCTACTTAGGAGGCTGAGGCAGGAGAATTGCTTGAACCCGGGAGGCAGAGGCTGCAGTGAGCCAAGACCACGCTATTGCATTCCAGCCTGGGTGACAAGAGCAAAACTCTGTCTCAAAAAACAAAACAAAACAAACAAAAAAA","GGCTGGGCGCAGTGGCTCACACCTGTAATCCCAGCACTTAGGGAAGCTGAGGCGAGTAGATCACCTGAGGTCAGGAGTTAGAGACCAGCCTGGCCATCATGGTGAAACCCCGTCTCTACTAAAGATACCAAAAATTAGCTGAGTGTGGTGCTGGGTGCCTGTAATCCCAGAAACTCAGGGTGCCTGTAATCCCAGCAACTCAGGGTGCCTTTAATCCCAGCAACTGAGGGTACCAGTAATCCCAGCAACTCAGGGTGTCTTTAATCCTAGCAACTGAGGGCACCTGTAATCCCAGCAACTCAGGAAGCTGAGACAGGAGAAGTACTTGAACCCAGAAGGCAGAGGTTGCAGTGAGCCGATATTGCACCATTGCACTCCAGTCTGGGCAACAAGAGTGAAACTCTGTCTCAAAAAAAAA"
"chr17","52245950","52246538","JH378118","18053084","18053501","254","34192866","TGTAATCCCAGCACTTTGGGAAGCCAACGCGGGTAGATCAGCTGAGGTCAGGAGCTCGAGACCAGCCTGGCCAACTGGTGAAACCCCATCTCTACTAAAAAAAATACAAAAAAATGGCCCAGCGCGGTGGCTCACACCTGTAATCCCAGCACTTTGGGAGGCCGAGGCGGGCAGATCACGAGGTCAGGAGATCGAGACCATCCTGGATAATACGGTGAAACCCCGTCTCTACTAAAAATACAAAAAAAAATTAACCGGGTGTGGTGGCGGGCGCCTGTAGTCCCAGCTACTAGGGAGGCTGAAGCAGGAGAATGGCGCGAAACCGGGAGGCGGAGCTTGCAGTGAGCCAAGACAGGCCACTGCACTCCAGCCTGGGCGACAGAGCGAGACTCCATCTCAAAAAAACAAAAAACAAAAAAATTAGCCAGCTGTGGTGGTGGGCGCATGTAATCCCAGTTACTTGGGAGGCTGAGGCAGGAGAATTGCTTGAAACCAGGAGGCAGAGGTTGCAGTGAGCCAAGATTACGCCATTGTACTCCAGCCTGGGCAACAAGGGCAAAACTCTGTCTCAACAAAAAAAAAGAAAAAA","GGCTGGGCGCAGTGGCTCACACCTGTAATCCCAGCACTTAGGGAAGCTGAGGCGAGTAGATCACCTGAGGTCAGGAGTTAGAGACCAGCCTGGCCATCATGGTGAAACCCCGTCTCTACTAAAGATACCAAAAATTAGCTGAGTGTGGTGCTGGGTGCCTGTAATCCCAGAAACTCAGGGTGCCTGTAATCCCAGCAACTCAGGGTGCCTTTAATCCCAGCAACTGAGGGTACCAGTAATCCCAGCAACTCAGGGTGTCTTTAATCCTAGCAACTGAGGGCACCTGTAATCCCAGCAACTCAGGAAGCTGAGACAGGAGAAGTACTTGAACCCAGAAGGCAGAGGTTGCAGTGAGCCGATATTGCACCATTGCACTCCAGTCTGGGCAACAAGAGTGAAACTCTGTCTCAAAAAAAAA"
"chr17","52264620","52265210","JH378118","18053084","18053501","242","34211536","GGCCACATGTGGTGGCTCACACCTGTAATCCCAGCACTTTGGGAGGCCAAGGCAGGCAGATCACCTGAGATCAGAAGTTCAAGACCAGCCTGGCCAATGTGGTGAAACCCTGTCTCTACTAAAAATAGAAAAAACACAGCCAGGCGCGGTAGCTCACACCTGCAATCCCAGCACTTTGGGAGGCCGAGGCAGGCAGATCACGAGGTCAGGAGATTGAGACCACGGTGAAACCCCATCTCTACTAAAAATACAAAAAATTAGCTGGGCATGGTGGCGGGCACCTGTAGTCCCAGCCACTTGGGAGGCTGAGGCAGGAGAATGGCGTGAACTCGGGAGGTGGAGCTTGCAGTGAGCAAAATTGCGCCACTGCACTCCAGCCTGGGCAACAGAGCAAGACTCCGTCTCAAAAAAAAAAAAAAAAAAAAATTAGCCGGCGTAGTGGCAAGCTCCTGTAATCCCAGCTACTTGGGAGGCTGAAGCAGGAGAATCGCTTGAACCCAGGAGGTGGAGGTTGCAGTGAGCCGAGACTGCGCCATTGCACTCCAGCCTGGGCAACAAGAATGAAACTCCGTCTCAGAAAAGAAAAAAAAA","GGCTGGGCGCAGTGGCTCACACCTGTAATCCCAGCACTTAGGGAAGCTGAGGCGAGTAGATCACCTGAGGTCAGGAGTTAGAGACCAGCCTGGCCATCATGGTGAAACCCCGTCTCTACTAAAGATACCAAAAATTAGCTGAGTGTGGTGCTGGGTGCCTGTAATCCCAGAAACTCAGGGTGCCTGTAATCCCAGCAACTCAGGGTGCCTTTAATCCCAGCAACTGAGGGTACCAGTAATCCCAGCAACTCAGGGTGTCTTTAATCCTAGCAACTGAGGGCACCTGTAATCCCAGCAACTCAGGAAGCTGAGACAGGAGAAGTACTTGAACCCAGAAGGCAGAGGTTGCAGTGAGCCGATATTGCACCATTGCACTCCAGTCTGGGCAACAAGAGTGAAACTCTGTCTCAAAAAAAAA"
"chr17","52281488","52282107","JH378118","18053084","18053501","287","34228404","GGCCAGGCGCGGTGGCTCACGCCTGTAATCCCAGCACTTTGGGAGGTCAAGGCGGGTGGATCACCTGAGGTCAGGAGTTCAAGACCAGCCTGGCCAACATGATGAAACTTCATCTTGGCCGGGCGCGGTGGCTCATGCTTGTAATCCCAGCACTTTGGGAGGCCAAGGCAGGCGGCGGATCATGAGGTCAGGAGATTGAGACCATCCTGGCTAAAACGGTGAAACCCCGTCTCTACTAAAAATACAAAAAAAAAAAAATTAGCCGGGCGTGGTGGCAGGCGCCTGTAGTCCCAGCTACTCGGGAGGCTGAGGCAGGAGAATGGCGTGAACCCGGGAGGCGGAGCTTGCAGTGAGCCGAGATAGCACCACTGCAGTCCGGCCTGGGTGAAAGAGTGAGACTCCGTCTCAAAAAAAAAAAAAAAGAAGAAAGAACTTCGTCTTTACTAAAAGTACAAAAAAAAAAAAAAAAAATTAGCCGGGCATGGTGGCAGGCGCCTGTAAACCCAACTACTCTGGAGGCTGAGGAAGGAGAACTGCTTGCACCTGGGAGTCGGAGGTTGCAGTAAGCCAAGATCGCACCATTGCACTCCAGCCTGGGCATCAAGAGTGAGACTTTGTCT","GGCTGGGCGCAGTGGCTCACACCTGTAATCCCAGCACTTAGGGAAGCTGAGGCGAGTAGATCACCTGAGGTCAGGAGTTAGAGACCAGCCTGGCCATCATGGTGAAACCCCGTCTCTACTAAAGATACCAAAAATTAGCTGAGTGTGGTGCTGGGTGCCTGTAATCCCAGAAACTCAGGGTGCCTGTAATCCCAGCAACTCAGGGTGCCTTTAATCCCAGCAACTGAGGGTACCAGTAATCCCAGCAACTCAGGGTGTCTTTAATCCTAGCAACTGAGGGCACCTGTAATCCCAGCAACTCAGGAAGCTGAGACAGGAGAAGTACTTGAACCCAGAAGGCAGAGGTTGCAGTGAGCCGATATTGCACCATTGCACTCCAGTCTGGGCAACAAGAGTGAAACTCTGTCTCAAAAAAAAA"
"chr17","52731467","52732093","JH378129","11955248","11955630","276","40776219","GGCCGGGTGCGGTGGCTCACGCCTGTAATCCTGGCACTTTGGGAGGCTGAGATGGACGGATCACCTGAGGTCAGGAGTTTTTTGTTTTTTTCTTTTTTTTTGAGACAGAGTCTGGCTCTGTTGCCCAGGCTGGAGTGCAGTGGCTCGATCTCGGCTCACTGCAAGCTCCGCCTCCCGGGTTCATGCCATTCTCCTGCCTCAGCCTCCCGGTAGCTGGGACTACAGGTGCCCGCCAGCACATCCGGTTATTTTTTTGTATTTTTAGTAGAGACAGTGTTTCACAGTGTTAGCCAGGATGGTCTCGATCTCCTGACCTCGTGATCCGCCCACCTCGGCCTCCCAAAAGTGCTGGGATTACAGGCATGAGCCACCGCGCCCGGCCAGGAGTTTTTGAGACCAGCCTGGCCAACAGGGTGAAACTCTGTCTCTACTAAAAATACAAAAATTAGTTGGGCATGGTGGCAGGCACCTGTAATCCCAGCTACATGGGAGGCTGAGGCAGGAGAATTGCTTGAACCTGGGAGGCGGAGGTTGCAGTGAGCTGAGATTGCGCCATTGCACTCCAGCCTGGGCAACAAGAGTGAAATTGCGTCTCAAAAACCAAAACAAACAAAAAAAGAATGAAAA","GGCTGGGTACGGTGGCTCATGCCTGTAATCCCAGCACTTTGGGAGGTGGGTCACTTGAGGTCAGGAGTTCGAGACCAGCCTGTGCAGTGCCTCCATCCTCAACTGCTGCCTCATCAGCCTGGACCACTACCTGCTCATCCTCTCACCACTGCCACAAGCTGCGCATGAAGCTCCTGCGCGCGCCGGTGCCCGTCTCTACTAAAAATACAAAAATTAGCTGGGTGTGGTGGCAGGTGCCTGTAATCCCAGCTACTCAGGAGGCTGAGGCAGGAGAATCACTTGAACCCAGGAGGCAGAGGTTGCAGTGAGCCGATATCGCATCATTGCACTCCAGCCTGAGCAACAAGAGTGAAATTTTGTCTCAAAAAAAAAAAAAAAAGAAA"
"chr17","54416242","54416805","JH378115","26183910","26184297","228","28232332","ACTTTGGGAGGCCATGGCAGGCGGATCACCTGAGATCAGGAGTTGGAAACCAGCCTGGCCAACATGGTAAAACCCCGTCTCTACTAAAAATACTTGGCTGGGCACGGTGGCTCACACTTGTAATTCCAACACTTTGGAAGGCCAAGGCGGGCAGATCACCTGAGGTTGGGAGTTCGAGACCAGCCTGACCAACATGGAGAAACCCTGTCTCTACTAAAAATACAAAATTAGCTGGGCATGGTGGTCTATGCCTGTAATCCCAGCTACTTGGGAGGCTGAGGCAGGAGAATTGCTTGAACCCGGGAGGCAGAGGTTGCGGTAAGCCAAGATCATGCCATTGCACTCCAGCCTGGGCAACAAGAGCAAAACCCCGTCTCAAAAAAAAAAAAAAAATTAGCCCAGTGTGGTGGCGTGCACCTGTAATCCCAGCTACTTACTTAGGAGCCTGAGGCAGGAGAATTGCTTGAACCCGGGAGGCAGAGTTTGCAGTGAGCCAAGATTGCACCATTGCACTCCAGCCTGGGTGACAAGAGTGAGACTGTCTCAAAAAAAAAAAAAAAAAAA","GGCCAGGTGCAGTGGCTCATATGTATAACCCCAACACTTTGGGAGGCCAACGCAGGTGGATCACCTGAGTTAGGAGTTTGAGACCAGCCTGACCAACATGGTGAAACCCTGTCTCTACTAAAAATACAGAAATGGCCGGGCATAGTGACACATACCTGTAATCCCAGATACTTGGGATGCTGAGTTTGCTTAAACCCAGAGGAGAACTGCTTAAACCCGGGAGGTAGAGGTCACAGTGAGCCAAGATTGGGATGCTGAGATTTGCTTAAACCCAGAGGAGAACTGCTTAAACCCAGGAGGCAGAGGTTGCAGTGAGTTGAGATTGCACCATTGCACTCCAGCCTGGACAACAAGAGTGAAACTCTGTCTCAAAAAAAAAAAAAAAAAA"
"chr17","55179146","55179483","JH378144","13229286","13229620","44","41949860","GGCCGGGTGCGGTGGCTCACGCCTGTAATCCCAGCACTTTGGGAGGCCGACGCAGGTGGATCACTTGAGGTCTGGTGTTCAAGACCAGCCTGGCCAACATTGTGAAACCCCGTCTCTACTAAAAATACAAAAAGTTAGCTGGGCATGGTAGCAGGTGCCTGTAATCCCAGCTACTTGGGAGGCTGAGGCAGGAGAATTGCTTGAACCTGGGAGGCAGAGGTTGCAGTGAGCTGAGATCGCACCATTGCACTCCAGCCCAGGCAACAAGAGCGAAACTTCGTCTCAAATAATAATAATAATAATAATAATAAATAAATAAATTTTTAAAAAAGAAAAAA","GGCCGGGCGCGGTGGCTCAAGCCTGTAATCCCAGCACTTTGGGAGGCCGAGGCGGGTGGATCACCTGTGGTCAGGAGTTCAAGACAGCTTGGTCAACATGGTGAAACCCCGTCTCTACCAAAAATACAAAAAATTAGCTGGGCATGGTAGCGCATGCCTGTAATCCCAGCTACTCAGGAGGCTGAGGCAGGAGAATTGCCTGAACCCAGGAGGCAGAGGTTGCGGTGAGCCGAGATCGCGCCATTGCACTCCAGCCTGGGTAACAAGAGCGAAACTCCCTCTCATAAAAAATAAATAAATAAATAAATAAATAAATAAATAAATAAATAAATAAA"
"chr17","59543657","59543981","JH378109","3329188","3329514","46","56214469","GGTTGGGCACAGTGGCTCACGCCTGTAATCCCAACACTTTGGGAGGCCAAGGCGGGTGGATCACCTGAGGTCGGGAGTTCAAGACCAGCCTGGCCAACATGCTGAAACCCTATCTCTACTAAAAATACAAAAAAAAAAAAAAAAAAAAAAAAAAAAAATAGCCCAGTGTGGTGTCAGGCGCCTATAATCTCAGCTACTTGGGTGGCTGAGGCAGGAGAGTCGCTTGAACCTGGGAGGCGGAGGTTGCAGTGAGCGGAGATCGCACCATTGCACTCCAGCGTGGGCAACAAGAGTGAAACTCCATCTCAAAAAAAAAGAAAAGAAA","GGCCAGGCATGGTGGCTCACGCCTGTAATCCCAGCACTTTGGGAGCCCAAGCCGGGTGGATTACCTAAGGTCAGGAATTCCAGAACAGCCTGGACAATATGGTGAAACCTTGTCTCTACTAAAAATACAAAAAAAAAAAAAAAAAAAAAAAAAAAAAAAATTTAGCCGGGTGTGGTGGTAGGTACCTGTAATCCCAGCTACTAGGGAGGCTGAGGCAGGAGAATCGCTTGAACTTGGGAGGCGGAGGTTGCAGTGAACAGAGATCACACCACTGCACTCCAGCCTGGGCGACAAGAGCAAAACTCCATCTCAAAGAAAAAAAAAGAA"
"chr17","60766805","60768705","JH378118","18053084","18053501","1483","42713721","GGCCAGGTACCGTGGCTCATGCCTCTTATCCCACCACTTTTGGAAGCTGAGGTGTGAGGATCACCCGAAGTCAGGAGTTTGGAACCATCCTGGCCAATGTTGTAAAACCCCGTCTCTAATAAAAATACAAAAGTTACCCAAGCATGGTGGTGGGCACACCTGTAATCCCAGCTACTTGGAAGGCTAAGACAGGAAAATGCCTGAACCCAGTGTGGCTGGAATTGGTGGGTTCTTGATCTCACTGACCTCAAGAATGAAGCCACGGACCCTCACGGTGAGTGTCACACTTCAAGGTGGCACGTCCAGTTTGTTCCTTCTGATGTTCGGATGTGCTCAGAGTTTCTTTCTTCTGGTGGGTTCATGGTCTCGCTGGCTCAGGAGTGAAGCTACAGACGTTCACCGGGAGTGTTACAGCTCTTAAGGCCTTGCGCCTGGAGTTGTTAGTTCCTCCCAGTGGCTTCGTGGTCTCACTGGCTTCAGGAATCAAGCAGCACGGTGAGCGTTACAGCTCACAAAGGCAGTGTGCACCCACAGTGAGCAACAGCAAAATCTATTGCAAAGAGGACAGAACAAAACCCCCACACTGGGGAAAAGGACCGGAACAGCTTGCCACTGCTGGCTCAGGCAGCCTGCTTTTATTCTCTTATCTGGCCCCACCCACATCCTCCTGATTGGTCCATTTTACAGAGAGCTGATTAGTTTGCTTTACAGTGAACTGATTGGTCCATTTTGACAGATTGGTGCTGATTGGTGCGTTTACAATCCCTGAGCTAGACACAAAAGTTTTCCACGTCCCCATTAGAATAGCTAGATACAGAGTGTCCATAGGTGTATTTACAAACCCTGAGCTAGACACGGAGTGATGATTGGTGCATTTACAAACATGGAGCTAGATACAGAGTGCCGATTGGTGCATTCACAATCCCTTAGCTAGACATAAAGGTTCTCAAGTTCCCACCAGATCAGCTAGACATAGAGCGCTGATTGGTGCATTTACAAAACTTGAGCTCGACACAGGGTGCTGATTGGTGCATTCACAAACCTTGAGCTAGACACAGGGTGCTGATTGGTGTGTTTACAAACCTTGAGCTAGATGCAGAGCGCTGATTGGTGTATTTACAATTCCTTAGCTAGACATAAAGGTTCTCCAAGTCCCCACTAGACTCAGGAGCCCAGCTGGCCTCACCCAGTGGATGTCACACTGGGGCCATAGGTGGAGCTGCCTGCCAGTTCCGTGTCCTGCGCCCACACTCCTCAGCCCTTGGGCGGTGGATGGGATTGGGCACCGTGCAGCAGGGGGTCGCGCTCCTGGGGGAGGCTCGGGCGGTGCAGGAGCCCACGGTGGCGGGGCGGGGCAGACTCAGGCATGGCGGGCTCCGGGTCCCAAGCCCTGCCGGGTGGGGAGGCACCTAAGGCCAGGCGAGAAATGGAGCGCAGCGCTGGTGGGCCAGCACTGCTGGGGGACCAGGCGCATCCTCCGCAGCTGTTGGCCTGGGTGCTAAGCCCCTCACTGCCCAGGGCTGGCAGGGCCCGCCGGCCGCTCCGAGTGCCGGGCCCGCCAAGCCCACGCCCACTTGGAACTCTAGCTGGCCCGCAAGCGCGGCGCGCAGCCCTGGTTCCCCCCCGTGCCTCTCCCTCCACACCTCCCCGCGGGCTGAGGGAGCCGGCTCCGGCCTCGGCCATCCCAGGAAGGGGCTCCCACACTGCAGCGGCGTGCTGAAGGGCTCCTCAAGCACGGCCAGAGTGGGCGAGGAGGCTGAGGAGGCGCCAAGAGTGAGCCAGGGCTGCCAGCATGCTGTCACCTCTCACCAGGAGGCGGAGATTGCAGTGAACCAAGACTGTGCCATTGCACTCCAGCCTGGGCAACAAGAGTGAAACTCCATCTCAAAAAAAATAATAAA","GGCTGGGCGCAGTGGCTCACACCTGTAATCCCAGCACTTAGGGAAGCTGAGGCGAGTAGATCACCTGAGGTCAGGAGTTAGAGACCAGCCTGGCCATCATGGTGAAACCCCGTCTCTACTAAAGATACCAAAAATTAGCTGAGTGTGGTGCTGGGTGCCTGTAATCCCAGAAACTCAGGGTGCCTGTAATCCCAGCAACTCAGGGTGCCTTTAATCCCAGCAACTGAGGGTACCAGTAATCCCAGCAACTCAGGGTGTCTTTAATCCTAGCAACTGAGGGCACCTGTAATCCCAGCAACTCAGGAAGCTGAGACAGGAGAAGTACTTGAACCCAGAAGGCAGAGGTTGCAGTGAGCCGATATTGCACCATTGCACTCCAGTCTGGGCAACAAGAGTGAAACTCTGTCTCAAAAAAAAA"
"chr17","64473614","64473953","JH378109","21565230","21565567","55","42908384","GGCCGGGTGTGGTGGCTCATGCCTGTAATCCCAGTACTTTGGGAGGCCGAGGCAGGCAGATCTCCTGAGGTCAGGAGTTTGAGACCAGCCTGGCCAACATGATGAAATGCTGTCTCTCCTAAAAATACAAAAATTAGCCAGACATAGTGGCAGGTGCCTGTAATCCCAGCTACTTGGGAGGCTGAGGGAGGAGAATTGCTTGAACCTGGGAGGCAGAGGTTGCAGTGAGTCAAGATCACGCCATTGCGCTCCAACCTGGGTGACAAAAGTGAGACTTCATCTCAAAATAAATAAATAAATAAATAAATAAATAAATAAATAAATAATAATTAAAAAAAAA","GGCCGGGCGCGGTGGCTCAAGCCTGTAATACCAGCACTTTGGGAGGCCGAGGCGGGTGGATCACGAGGTCAAGAGATCGAGACCATCCTGGTCAACATGGTGAAACCCCGTCTCTACTAAAAATACAAACAATTAGCTGGGCATGGTGGCGGGTGCCTGTAATCCCAGCTACTCCAGAGGCTGAGGCAGGAGAATTGCCTGAACCCAGGAGACGGAGGTTGCGGTGAGCCAAGATCGCGCCATTGCACTCCAGCCTGGGTGACAAGAGCGAAACTCCGTCTCAATAAATAAATAAATAAATAAATAAATAAAAATAAAATAAATAAATAAATAAATAA"
"chr17","67747489","67748097","JH378118","18053084","18053501","256","49694405","GCTGGGTGTGGTGGCTCACGCCTATAATCCCAGCACTTTGGGAGGCCAAGGCAGGTGGATCACCTGAGGTCAGGAGTTTGAGACCAGCCTGGCCAACATGATGAAACCCCGTCTCTACTAAAAATACAAAGAATTAGGCTGGGCGCGGTGGCTCACGCCTGTAATCCCAGCACTTTGGGAGGCCGAGGCGGGTGGATCACGAGGTCAGGAGATCGAGACCATCCTGGCTAACACGGTGAAACCCCGTCTCTAATAAAAATAAAAAAAAATTAGCTGGGCGTGGTGGTTGGCGCCTGTAGTCCCAGCTACTCGGGAGGCTGAGGCAGGGGAATGGCGTGAACCCGGGAGGTGGAGCTTGTAGTGAGCCGAGATCACGCCACTGCACTCCAGCCTGGGCGACAGAGCAAGACTCCGTCTCAAAAAAAAAAAAAAAAAAAATTAGCCAGGCGTGGTGGCGGGTGCCTGTAATCCCAGCTACTCTGGAGGCTGAGGCAGGAAAATCACTTTAACTCAGGAAACAGAGGTTGCAGTAAGCCGAGATCACGCCATTGTGCTCCATCCTGGGCAACAAGAGCGAAACTCCGACTCGGAAAAAAAGAAAAAAAAAAA","GGCTGGGCGCAGTGGCTCACACCTGTAATCCCAGCACTTAGGGAAGCTGAGGCGAGTAGATCACCTGAGGTCAGGAGTTAGAGACCAGCCTGGCCATCATGGTGAAACCCCGTCTCTACTAAAGATACCAAAAATTAGCTGAGTGTGGTGCTGGGTGCCTGTAATCCCAGAAACTCAGGGTGCCTGTAATCCCAGCAACTCAGGGTGCCTTTAATCCCAGCAACTGAGGGTACCAGTAATCCCAGCAACTCAGGGTGTCTTTAATCCTAGCAACTGAGGGCACCTGTAATCCCAGCAACTCAGGAAGCTGAGACAGGAGAAGTACTTGAACCCAGAAGGCAGAGGTTGCAGTGAGCCGATATTGCACCATTGCACTCCAGTCTGGGCAACAAGAGTGAAACTCTGTCTCAAAAAAAAA"
"chr17","71197353","71197681","JH378262","266823","267148","47","70930530","GACCGGACACAGTGGCTCACGTCTGTAATCCCAGCACTTTGGGAGGCTGAGGCGGGTGGATCACCTGAGGTCAGGAGTTCAAAACCAGCCTGGCCAATATGGTGAAAACCCGTCTATACTAAAAATAAAAAATTAGCCAGGCTTGGTGGCAGGCACCTGTAATCCTAGGTACTCTGGAGGCTTAGACAGGAGAATCACTTGAACCCGAGAAGTGGAGGTTGCAGTGAGCCAAGATCGTGCCATTGCACTCCAGCCTGGGCGACAAGAGTGAGACTCCATCTCAAAAACAAACAAACAAACAAACAAAAAACAAATGAACAAAAAAAAAA","GGCCGGGCGCGGTGGCTCAAGCCTGTAATCCCAGCACTTTGGGAGGCCGAGGCGGGTAGATCATGAGGTCAGGAGTTTGAGACCAGCCTGGCCAACATGGTGAAACCCCGTCTCTACTAAAAATACAAAAATTAGCCGGGCATGGTGGCCTGTGCCTGTAATCCTAGCTACCCAGGAAGCTGAGGCAGGAGAATTGCCTGAACCCAGGAGGCGGAGGTTGCGGTGAGCCGAGATCGTGCCATTGCACTCCAGCCTGGGTAACAAGAGCGAAACTCCGTCTCAAAAACAAACAAACAAACAAACAAAAACAAAAAACAAAAAACAAA"
"chr17","72892082","72892699","JH378118","18053084","18053501","266","54838998","GGCCAGGTGCAGTGGTTCACACCTATAATCCCAGCACTCTAGGAGGCCAAAGTGGGCAGATCACCTGAGGTCAGAAGTTCGAGACCAGCCTGGCCAACATGGTGAAACCATCTCTACTAAAAACACAAAAATTAGGCTGGGCACGGTGGCTCACACCTGTAATCCCAGCACTTTGGGAGGCCGAGGTGGGTGGATCACGAAGTCAGGAGATCAAGACCATCCTGGCTAACACGGTGAAACCCCGTCTCTACTAAAAATACAAAAAATTAGCCAGGCGTGGTGGCGGGCGCCTATAGTCCCAGCTACTTGGGAGGCTGAGGCAGGAGAATGGCGTGAACCCAGGAGGCGGAGCTTGCAGTGAGCCAAGATTGCGCCACTGCACTCCAGCCTGGGTGAGAGAGCTAGACTCTGTCTCAAAAAAAAAAAAAAAAAAAACACAAAAATTAGCCGGGCTTGGTGGCAGGTGCCCGTAATCCCAGCTACTCAGGACGCTGGGACAGGAGAATCTCATGAACCCTGGAGGTGGAGGTTGTAGTGAGCCAAGATCTCACCATCGCACTCCAGCCAGGGTGACAAGAGTGAAACTCTGTCTTAAAAAGATAAATAAATAAAATAAAA","GGCTGGGCGCAGTGGCTCACACCTGTAATCCCAGCACTTAGGGAAGCTGAGGCGAGTAGATCACCTGAGGTCAGGAGTTAGAGACCAGCCTGGCCATCATGGTGAAACCCCGTCTCTACTAAAGATACCAAAAATTAGCTGAGTGTGGTGCTGGGTGCCTGTAATCCCAGAAACTCAGGGTGCCTGTAATCCCAGCAACTCAGGGTGCCTTTAATCCCAGCAACTGAGGGTACCAGTAATCCCAGCAACTCAGGGTGTCTTTAATCCTAGCAACTGAGGGCACCTGTAATCCCAGCAACTCAGGAAGCTGAGACAGGAGAAGTACTTGAACCCAGAAGGCAGAGGTTGCAGTGAGCCGATATTGCACCATTGCACTCCAGTCTGGGCAACAAGAGTGAAACTCTGTCTCAAAAAAAAA"
"chr17","74365360","74365846","JH378118","18053084","18053501","163","56312276","TATAAAAAATCAGCTAGGCTTGGTGGCTTGTGCCTGTAATCCCAGCACTTTGGGAGGCTGAGGCAGGTGGATCACCTGACGTAGGTGTTTAAGACCAGATTGACTAACATGTTGAAACCCCGTCTCTACTAAAAATACAAAAATTATCTGGGCTTGGTGGTGCATGCCTGTAATCCCAGCTGCTCAGGAGGCTGAGACAGGAGAATCGCCTGAACCTGGGAAACGGAAGTTGCAGTGAGTGGAGGTTGCAGTGAGCCGAGATTGCACCACTGCACTCCAGTCTGGGCAACGGAAAAAGACTGTCTCAAAAAAAAAAAAAAAATTAGCTGGGTGTGGTGGTTGGCGCCTGTAATTCCAGCTACTCAGGAGGCTGAGGCAGGAGAATCACTTGAACTCAAGAGGCAGAGGTTGCAATGAGCCAAGATTGCGCCATTGTACTCCAGCCTGGGCCACAAGATTGAAACTTCATCTTGGGGAAAGAAAACAA","GGCTGGGCGCAGTGGCTCACACCTGTAATCCCAGCACTTAGGGAAGCTGAGGCGAGTAGATCACCTGAGGTCAGGAGTTAGAGACCAGCCTGGCCATCATGGTGAAACCCCGTCTCTACTAAAGATACCAAAAATTAGCTGAGTGTGGTGCTGGGTGCCTGTAATCCCAGAAACTCAGGGTGCCTGTAATCCCAGCAACTCAGGGTGCCTTTAATCCCAGCAACTGAGGGTACCAGTAATCCCAGCAACTCAGGGTGTCTTTAATCCTAGCAACTGAGGGCACCTGTAATCCCAGCAACTCAGGAAGCTGAGACAGGAGAAGTACTTGAACCCAGAAGGCAGAGGTTGCAGTGAGCCGATATTGCACCATTGCACTCCAGTCTGGGCAACAAGAGTGAAACTCTGTCTCAAAAAAAAA"
"chr17","74566963","74567566","JH378119","32351107","32351490","260","42215856","GCCGGGCATGGTGTATCACGCCTGTAATCCCAGCACTTTGGGAGGCAGAGGTAGGCAGATCACCTGAGGTCAGGAGTTCAAAACCAGCCTAGCCAACATGGTGAAACCCCGTCTCTACTAAAAATACAAAAAATTAGTGGCCAGGCACGGCAGCTCACGCCTGTAATTCCAGCACTTTGGGAGGCCGAGGCGGGCAGATCACGAGGTCAGAAGATTGAGACCATCCTGGCTAACACGGTGGAACCCCATCTCTACTAAAAATACAAAAAATTAGCTGGGCATGGTGGCTGGTGCCTGTAGTCCCAGCTACTCGGGAGGCTGAGGCAGGAGACTGGCATGAACCCGGGAGGCGGAGCTTGCAGCAAGCCAAGATCGTGCCACTGCACTCCACTCCATCCTGGGCGACAGAGCAAGACTCCGCTTCAAAAAAAAAAAAATTAACCGGGCAAGGTGGCAGGTGCCTGTAATCCCAGCTACTTGGGAGGCTGAGGCAGGAGAATTGCTTGCAGAGGTTGAAGTGAGCCGAGATTACGCCATTGCACTCCAGCCCAAGTGACAAGAGTGAAACTCCATCTCAAAAAAAAAAAAAAAAAAAAGAAAAAAA","GGCCAGGTATGGTGGCTCACACCTGTAATCCCAGCACTTTGGGAGGCCAAGGCAGGCAGACCACCTGAGGTCAGGAGTTCGAGATCAGCCTAGCCAACATGGTGAAACCCCATCTCTAGTAAAAATAAAATTAGCCAGGCATGGTGGTGCATGCCTGTAACGCAGGTCAGGAGTTCGAGATCAGCTTAGCCAACATGGTGAAACCCCATCTCTAGTAAAAATAAAATTAGCCAGGCAGGTGGTGCCGCCTGTACTCGGGAGGCTGAGGCAGGAGAATCACTTGAACCCAAGAGGCAGAGGTTGCAGTCAGCCAAGATCATGCCATTGCACTCCAGCCTAAGCAAAAAGAGTAAAACTCAGTCTCAAAACAAAAAAACAAAAAAA"
"chr17","75365782","75366409","JH378153","2355361","2355755","282","73010421","CCAGGCGTGGTGGCTCATGCCGGTAATCCCAGCACTTTGGGAGGCCAAGGCAGGTGGATCATCTGAGGTCAGGAGTTCGAGACCAGCCTGACCAACATGGTGAAACCTCACCTCTACTAAAAATACAAAAACTAGACAGGCGTGGTGGCGGGTGCCTGTAGTCCCAGCTACTTGGGAGGCTGAGGCAGAAAAATCGCTTGAACCCAGTAGGCAGAGGTTGCAGTGAGCCGAGATCACACCATTGCACTCCAGCCTGGGCAAAAAAGAGCGAAACTCCATCTCAGAAGAAAAGACCGGGTGCAGTGGCTCATGCTTGTAACCCCAGCACTTTGGGAGGCCAAGGCGGGTGGATCACGAGGTCAGAAGATCGAGACCATCCTGGCTAACACGGTGAAACCCCGTCTCTACTAAAAATACAAAAAAAAAAAAATAATTAGCCGAGTGTGGTGGCGGATGCCTGTAGTCCCAGCTACTCGGGAGGCTGAGGCAGGAGAATGGCGTGAACCCAGGAGGCGTAGCTTGCAGTGAGCCGAGATCACGCCACTGCACTCCAGCCTGGGCGACAGAGCAAGACTCGTCTTAAAAAAAAAAAAAAAAAGAAAAAGTAAAAGAAAAGAAAAAGCAACAA","GGCGGGGCATGGTGGCTCACACCTGTCATCCCAACACTTTGGGAGGCTGAGGCAGGCAGATCACCTGAGGTCAGGAGTTTGAGACCAGCCTGGCCAACATGGTGAAACCCCATCTCTACTAAAAATACAAAAATACAAAAAACCCCATCTCTACTAAAAATACAAAAAGCTTGTCTCTATTAAAAATACAAAAAACAAAAAACAAACAAAAAAAAAACCACCATGGTGGTGGGTGCCTATAATCCCAGCTACTCGGGAGGCTGAGGCAGGAGAATCGCTTGAACCCAGGAGGCAGAGGTTGCAGTGAGCCAAGATCCCACCATTGCACTCCAGCCTGGGCAACAGAGAGAGAGACTCTGCCTCAGAAAAAAGAAAGAAAGAAAGAAAGAAAGAAA"
"chr18","19875","20142","JH378153","8929988","8930242","54","8910113","TTGGGAGGCTGAGGTGGGTGGATCATCTGAGGTCAGGAGTTAAGACCAGCCTGGCCAACATGGTGAAACCCCATCTCTACTAAAAATACAAAAACAAAACAAAACAAAACAAAAAAAACCAGCATGGTGGCAGACACCTGTAATCCCAGCTACTCGGGAGACTGAGGCAGGAGAATCACTTGAACCTGGGAGGCGGAGGTTACAGTGAGCCAAGATCTTGTCATGTCACTCCAGCCCAGGCAACAAGAGCAAAACTGTCTTAAAAAAA","TTTGAGAGGCTGAGGTGGGTGGATCACCTAGGTCAGGAGTTTGAGACCAGCCTGACCAACATGGTGAAACCTCATCTCTACTAAAAATAAAAATAAAAAACTAGCCAGGTGCAATGGTGCATGCCTGTAATCCCAGCTACTTGGGAGGCTGAGATGGGAGACTCACTTGAACCTGGGAGGTGGAGGTTGCAGTGAGCCAAGATCATACCATTGCACTCCAGCCTGGGCAACAAGAGTGAAACCTCTTCTCAAAAA"
"chr18","4520498","4521101","JH378118","18053084","18053501","246","13532586","GGCTGGGCGCAGTGGCCCACCCCTGTAATCCCAGCACTTTGGGAGGCCGAGGCGGGTAGATCACCTGACGTCAGGAGTTCAAGACCAGCCTGGCCAACATGGTGAAACCCTGTCTCTACTAAAATACAAAAATTAGGCTGGGCGCAGTGGCTCAAGCCTGTAATCCAGCACTTTGGGAGGCCAAGGCGGGCAGATCACCTGAGGTCAGGAGTTCGAGACTAGCCTGGCCAACCTGGCAAAACCCCATCTCTACTAAAAGTACGAAAATTAGCCAGGGTGATGGTGTGCACCTGTAATCCTAGGTACTCAGGAGGCTGAGGGCAAGAGAATCGCTTGAACCTGGGAGGCAGAGGTTGTAGTGGGCCAAGATCGCGCCATTGCACTGCAGCCTCGGTGACAGAGAAAGACTCCGTCTCAAAAAAAAAAAAAAACAAAAATTAGCTGGGCGTGGTGGTGGGCGTCTGTAGTCCCATCTACACGGGAGGCTGAGGCAGAAGAATCACTTAAACCCAGGATGTGGAGGTTGCAGTGAGCTGAGATCACGCCATTGCACTCCAGACTGGGTAACAAGAGCAAAACTCCATCTCAAATAAATAAAATAAAA","GGCTGGGCGCAGTGGCTCACACCTGTAATCCCAGCACTTAGGGAAGCTGAGGCGAGTAGATCACCTGAGGTCAGGAGTTAGAGACCAGCCTGGCCATCATGGTGAAACCCCGTCTCTACTAAAGATACCAAAAATTAGCTGAGTGTGGTGCTGGGTGCCTGTAATCCCAGAAACTCAGGGTGCCTGTAATCCCAGCAACTCAGGGTGCCTTTAATCCCAGCAACTGAGGGTACCAGTAATCCCAGCAACTCAGGGTGTCTTTAATCCTAGCAACTGAGGGCACCTGTAATCCCAGCAACTCAGGAAGCTGAGACAGGAGAAGTACTTGAACCCAGAAGGCAGAGGTTGCAGTGAGCCGATATTGCACCATTGCACTCCAGTCTGGGCAACAAGAGTGAAACTCTGTCTCAAAAAAAAA"
"chr18","8281535","8282152","JH378118","18053084","18053501","271","9771549","GGCCAGGTGCGATAGCTCACACTGGTAATCCCAACACTTTGGGAGGCCGAGGTGGGCGGATCACCTGAGGCCAGGAGTTTGAGACCAGCCTGGCCAACACAGTGAAACCCCATCTCTACTAAAAATACAAAATTAGGCAGGGTGCAGTGGCTCACGCCTGTAATACCAGCACTTTGGGAGGCCGAGACAGGCGGATTACGAGGTCAGGAGATCGAGACCATCCTAGCTAACACAGTGAAACCCCGTCTCTACTAAAAAAAAAAAAAAAAAAAAAAGTACAAAAAAATTAGCCAGGCGTGGCGGCAGGTGCCTGTAGTCCCAGCTACTCAGGAGACTGAGGCAGGAGAATGGCGTGAACCCGGGAGGCGGAGCTTGCAGTGAACTGAGATCACACCACTGCACTCCAGCCTGGGCAACAGAGTGAGACTCCGTCTCAAAAACAAAACAAAATTAGCCGGGCATGGTGGTGGATGCCCGTAATCCCAGCTACTCGGGAGGCTGAGGCCGCCAAGGCAGGAGAATCTCTTGAATGTGGGAGGCAAAGGCTGCAGTGAGCTGAGATCATGCCATTGCACTGTAGCCTGGGCGACAAAAGTGAGACTCCGTCTCAAAAAAAAA","GGCTGGGCGCAGTGGCTCACACCTGTAATCCCAGCACTTAGGGAAGCTGAGGCGAGTAGATCACCTGAGGTCAGGAGTTAGAGACCAGCCTGGCCATCATGGTGAAACCCCGTCTCTACTAAAGATACCAAAAATTAGCTGAGTGTGGTGCTGGGTGCCTGTAATCCCAGAAACTCAGGGTGCCTGTAATCCCAGCAACTCAGGGTGCCTTTAATCCCAGCAACTGAGGGTACCAGTAATCCCAGCAACTCAGGGTGTCTTTAATCCTAGCAACTGAGGGCACCTGTAATCCCAGCAACTCAGGAAGCTGAGACAGGAGAAGTACTTGAACCCAGAAGGCAGAGGTTGCAGTGAGCCGATATTGCACCATTGCACTCCAGTCTGGGCAACAAGAGTGAAACTCTGTCTCAAAAAAAAA"
"chr18","14964693","14965321","JH378118","18053084","18053501","273","3088391","GGCTGGGTGCGGTGGCTCACACCTGTAATCCCAGCACTTTGGGAGGCTGAGGCAGGCGGATCACCTGAGGTCAGGAGTTCAGGACCAGCCTGATCAACATAGCGAAACCCTGTCTCTATTAAAAATATAAAAATTGCTGGGTGCGGTGGCTCACGCCTGTAATCCCAGCACTTTGGGAAGCCGAGGCGGGCGGATCATGAGCTCAGGAGATCGAGACCATCTTGGCTAACATGGTGAAACCCTGTCTCTACTAAAAATACAAAAAAATTAGCCAGGTGTGGTGGCGGGCGCCTGTAGTCCCAGCTACTCTGGAGGCTGAGGCAGGAGAATCACTTGAACCTGGGAGGCGGAGGTTGCGGTGAGCCAAGATGGTGCCATTGCACTCCAGCCTGGGCAACAAGAGTGAAACTCCATCTCAAAAAAAAAGAAAAAAAAAAAAAAAAACAACCCACAAAAATTAGCCAGGTGTGATGGCGGGTGTCTGTAATCCCAGCTACTTGGGAGACTGAGGCAGGAGAATGGCTTGAACCCGGGAGGTGGAGGTTGCAGTAAGCCGAGATTGCGCCACTGCACTCCAGCCTGGGTGACCAGAGTGAAACTTCATCTCAAAAAAAAAAAAAAAAAAAAAA","GGCTGGGCGCAGTGGCTCACACCTGTAATCCCAGCACTTAGGGAAGCTGAGGCGAGTAGATCACCTGAGGTCAGGAGTTAGAGACCAGCCTGGCCATCATGGTGAAACCCCGTCTCTACTAAAGATACCAAAAATTAGCTGAGTGTGGTGCTGGGTGCCTGTAATCCCAGAAACTCAGGGTGCCTGTAATCCCAGCAACTCAGGGTGCCTTTAATCCCAGCAACTGAGGGTACCAGTAATCCCAGCAACTCAGGGTGTCTTTAATCCTAGCAACTGAGGGCACCTGTAATCCCAGCAACTCAGGAAGCTGAGACAGGAGAAGTACTTGAACCCAGAAGGCAGAGGTTGCAGTGAGCCGATATTGCACCATTGCACTCCAGTCTGGGCAACAAGAGTGAAACTCTGTCTCAAAAAAAAA"
"chr18","15291276","15291680","JH378105","31074364","31074738","116","15783088","CTCGTGCCTGTAATCCTAGCACTTTGGGAGGCCAAGGTGGGCAGATCATCTGAGGTCAGGAGTTCGAGACCAGCCTGGCCAACATAGAGAAATCCCATCTCTACTAAAAATACAAAAATTGACGAGTTAATGGGTGCAGCACACGAACATGGCACATGTATACATATGTAACAAACCTGCACGTTGTGCACATGTACCCTAAAACTTAAAGTATATTTAAAAAAAATACAAAAATTAGCCGGGCATGGTAGCAGGCACCTGTAATCCCAGCTACTCGGGAGGCTGAGGCAGGAGAATCACTTGAACCTGGGAGGCAGAGGTTGCAGTGAGCTAAGATCATTCCATTGTACTCCAACCTGGGCAACAAGAGTGAAATTCCGTCTAATAAAAAATGAAATAAATAAA","GGCCGGGCACAGTGGCTCACACCTGTAAACCCAGCACTTTGGGAGAATGAGGTGGGCAGATGACTTCAGGTCAGGAGTTCGAGACCAGCCTGGCCAACACTGTGAAATCCCATCTCTACTAAAAATACAAAAATTAGCCATGGTGGTCAGAAGATCAAGACTATCCTGGCCAACATGGTGAAACCTTGTCTCTACTGAAAATAGAAAAATTAGCTGGGTATGGTGGCATGCGCCTGTAGTCCCAGATACTCAGGAGGCTGGGGCAGGAGAATCACTTGAACCCAGGAGGCAGAGGTTGCAGTGAGCTGAGATCATGCCATTGCACTCTAGATTAGGCAACAAGAGTGAAACTGTCTCAAAAAGAGAGAGAGAAAA"
"chr18","15802064","15802689","JH378153","2355361","2355755","270","13446703","GACCGGGCATGGTGGCTCACACCTGTAATCCCAGCACTTTGGGAGGCGTAGGCGAGTGGCCCCTGAGGTCAGGAGATCGAGACAACCCTGGCCAACATGGTGAAACTCTACTAAAAATACAAAATTAGGCCGGGTGCCGTGGTTCACGCCTATAATCCCAGCACTTTGGGAGGTCAAGGTGGGCAGATCACCTGAGGTCAGGAGTTTGAGACCAGCCTGGCCAACATGGTGAAACCCAGTCTCTACTAAAAATACAAAAATTAGCTGGGCATGGTGGTGGACACTTGTAATCCCAGCTACTTGGGGGGCTGAGGCAGGAGAATCACTTGAACCCAGGAGGCAGAGGTTGCAGTGAGCCTAAATCACCCCATTGCACTCCAGCCTGGGCAACAAGAGTGAAATTCTGTCTCGAAAAAAAAAAAAAAAGAAAAGAAAAGAAAAAAAAATTAGCCAGGTGTGGTGCTGCATGCCTGTAATCCCAGCTACTCAGGAGGCTGAGGCAGGAGAATCGCTTGAACCCGGGAGGCAGAGGTTGCAGTGAGCTGAGACCACACCATTGCACTCCAGCCTGGGCGACAAGAGAGTAACTCCATTTCAAAAAAAAAAAAAAAAAAAAGAAAAAAGAA","GGCGGGGCATGGTGGCTCACACCTGTCATCCCAACACTTTGGGAGGCTGAGGCAGGCAGATCACCTGAGGTCAGGAGTTTGAGACCAGCCTGGCCAACATGGTGAAACCCCATCTCTACTAAAAATACAAAAATACAAAAAACCCCATCTCTACTAAAAATACAAAAAGCTTGTCTCTATTAAAAATACAAAAAACAAAAAACAAACAAAAAAAAAACCACCATGGTGGTGGGTGCCTATAATCCCAGCTACTCGGGAGGCTGAGGCAGGAGAATCGCTTGAACCCAGGAGGCAGAGGTTGCAGTGAGCCAAGATCCCACCATTGCACTCCAGCCTGGGCAACAGAGAGAGAGACTCTGCCTCAGAAAAAAGAAAGAAAGAAAGAAAGAAAGAAA"
"chr18","15849226","15849860","JH378118","18053084","18053501","290","2203858","GGCCAGGCACAGTAGCTTACGCCTATAATCTCAGCACCCTAGGAGGCCGAGGCTGGCAGACCACCTGAGGTCACGAGTTCAAGACTAGCCTGGTCAACATAGCAAAACCCCATCTCTACTAAAAATACAAAAATTAGGCTGGGCACAGTGGCTCATGCTTGTAATCCCAGCACTTTGGGAGGCCAAGTCGGGAGAATCACCTGAGGTTGGGAGTTCGAGATCAGCCTGACCAACATAGAGAAACTCCATCTCTACTAAAAATGCAAAATTAGCTAGGCATGGTGGTGCATGCCTGTAATCCCAGCTACTCGTAAGGCTGAGGCAGGAGTATCGCTTGAATCTGGGAGGTGGAGGTTGCGGTGAGCCAAGATCACGCCATCGTACTCCAGCCTGGGCAACAAGAGCGAAACTCCATCTCAAAACAAAAAAAATGAGCCAGGAGTGGTGGCGGGCGCCTATAATTCCAGCTACTCCAGAGGCTGAGGCAGGAGAATCACTTAAACCCGGGAAGCAGAGGTTGCAGTGAGCTGAGATTGTGCCATTGCACCCCAGCCTAGGTGAAAAGAGCAAAACTCCATCTCAAAAAAAAAAAAAAAAAAAAAAAAAAAGAAAGAAAGAAAGAAAAAGAAAAAAAA","GGCTGGGCGCAGTGGCTCACACCTGTAATCCCAGCACTTAGGGAAGCTGAGGCGAGTAGATCACCTGAGGTCAGGAGTTAGAGACCAGCCTGGCCATCATGGTGAAACCCCGTCTCTACTAAAGATACCAAAAATTAGCTGAGTGTGGTGCTGGGTGCCTGTAATCCCAGAAACTCAGGGTGCCTGTAATCCCAGCAACTCAGGGTGCCTTTAATCCCAGCAACTGAGGGTACCAGTAATCCCAGCAACTCAGGGTGTCTTTAATCCTAGCAACTGAGGGCACCTGTAATCCCAGCAACTCAGGAAGCTGAGACAGGAGAAGTACTTGAACCCAGAAGGCAGAGGTTGCAGTGAGCCGATATTGCACCATTGCACTCCAGTCTGGGCAACAAGAGTGAAACTCTGTCTCAAAAAAAAA"
"chr18","16042035","16042617","JH378118","18053084","18053501","243","2011049","GGCTATGCACGGTGGCTCACGCCTGTAATCCCAGCACTTTGGGAGGCCGAGTCAGGTGGATCACTTGAGGTCAGGAGTTCGAGACCAGCCTGGCCAACATGGTGAAGCCCCATCTCCACTAGAAATACAAAAATTAGTCTGGGAGCAGTGGCTTACACCTGTAATTGCAGCACTTTGGGAGGCCAAGGTGGGTGGATCACCTGAGGTCAGGAGTTTGAGACCAGCATGACCAACATGGTGAAACTCCATCTATACAAAAAAATTAGCCGGGTGTGGTGGCGCATGCCTGTAATCCCAGCTACTCAGGAGACTGAGGCAGGAGAATTGCTTGAACCCGGGAGGCAGAGGTTGCAGTGAGCCAAGTCTGTGCCATTGCACTCCAACCTGGGCAACAAAAGCGAAACTCTGTCTCAAAAATAAACAACAAAAAAAATTAGCCAGGTGTGGTGGCACATGCCTATAATCCCAGCTACTCGGGAGGCTGAGGCAGAAGAATTGCTTGAACCTGGGAGGTGGAGGTTGCAGTGAGCCGAGATCATGCCATTCTACTCCAGCCTGGGCCACAAGAGCGAAACTCTGTCTC","GGCTGGGCGCAGTGGCTCACACCTGTAATCCCAGCACTTAGGGAAGCTGAGGCGAGTAGATCACCTGAGGTCAGGAGTTAGAGACCAGCCTGGCCATCATGGTGAAACCCCGTCTCTACTAAAGATACCAAAAATTAGCTGAGTGTGGTGCTGGGTGCCTGTAATCCCAGAAACTCAGGGTGCCTGTAATCCCAGCAACTCAGGGTGCCTTTAATCCCAGCAACTGAGGGTACCAGTAATCCCAGCAACTCAGGGTGTCTTTAATCCTAGCAACTGAGGGCACCTGTAATCCCAGCAACTCAGGAAGCTGAGACAGGAGAAGTACTTGAACCCAGAAGGCAGAGGTTGCAGTGAGCCGATATTGCACCATTGCACTCCAGTCTGGGCAACAAGAGTGAAACTCTGTCTCAAAAAAAAA"
"chr18","25849088","25849351","JH378114","20445944","20446195","60","5403144","GGGAAGATGAGGCGGGTGGATCACTTGAGGTCAGGAGTTCGAGACCAGCCTGGCCAACATGGTGACACCCTGTCTCCAAAAAATACACACACACACACACACACACACACACACACAAATTAGCTGGGCATGGTGGCGGGCACCTGTAATCCTAGCTACTCGAGAGGCTGCGGCAGGAGAATTGCTTTAACTTGGGAGGTAGAGGTTGCAGAGAGCCGAGATTGCACCATTGTACTCCAGCCTGGGTGACAAGAGCGAAACTCC","TTGGGAGGCCAAGGCGGGTGGATCACCTGAGGTCAGGAGTTCGAGACCAGCCTGGCCAACATGATAAAACCCCCGTATCTAATAAAAATAGGAAAAAAAAATAAATAAATAGCTGGGCGTTGTGGCAGGTGCCTGTAATCCCAGCTACTCGGGAGGCTCAGGCAGGAGAATCGCTTGAACCCAGGAGGCAGAGGTTGCAGTGAGCCAAAATTGTGCCATTGCACTCCCGCCTGGGAAACAAGAGCAAAACTC"
"chr18","38083500","38083832","JH378152","15993594","15993909","55","22089906","GGCTGGGTGCGGTGGCTCACGCCTGTAATCCCAGCACTTTGGGAAGCCAAGTCAGGTGACCTCACCTGAGGTCAGGAGTCCAAGACCAGCCTGACCAACATGGTGAAACCTCGTCTCTACTAAAAAGACAAAAAATTAGCCAGGCATGGTGGTGGGCACCTGTAATCTCAGCTACTCTGGAGGCTGAGGCAGGAGAATCACTTGAACCCTGGAGGGGGAGGTTGCAGTGAACCAAGATTGCACCATTGCAGTCCAGCCTGGGCGACAAGAGCAAAACTCCATCTCACAAACACACACACACACACACACACACACACACACAGAAAAAAAAAA","GGCTGGGTGTGGTGGCTCATGCCGGTAATCCCAGCACTTTGGGAAGCGGAGGCAGGCAGATCACCTGAGGTCAGGAGTTCAAGACCAACCTGGCCAACATGGAGAAACCATGTCTCTACTAAAAATACAAAAAATTAGCCAGGCATGGTGGGTGCCTGTAATCCCCACTACTCGGGAGGCTGAGGCAGGAGAATTTCTTGAACCCAGGAGGTGGAGGTTTCAGTGAAGCGGAGATCACCCCATTGCACTCCAGCCTGGGTGACAAGAGCAAAACTCCATCTCACAAAATCAACAACAACAACTTAAAAAAAAAAAA"
"chr18","44076326","44076933","JH378118","18053084","18053501","257","26023242","GCTGGGCGCGGTGGCTTGCGCCTGTAATCCCAGCCATTTGGGAGGCCGAGGCAGGTGGATCACCTGAGGTTAGGAGTTCAAAACCAGCCTGGCCAACATGGTGAAACCCCGTCTCTACTAAAAATACAAAAATTAGGCCAGGCACAGTGGCTCACGCCTGTCATCCCAGCACTTTGGGAGGCCAAGGCGGGCGGATCATGAGGTCAGGAGATTGAGACCATCCTGGCTAACACAGTGAAACCCTGTCTCTACTAAAAAAATATATAAAAAATTAGCCGGGCTTGGTGGCGGGTGCCCGTAATCCCAGCTACTCGGGAGGCTGAGGCAGGAGAATGGCGTGAACCTGGAAGGCGGAGCTTGCAGTGAGCCGAGATTGCACCACTGCACTCCAGCCTGGGTGACAGAGTGAGACTCTGTCTCAAAAAAAAAAAAAAAACAAAAAACAAAAATTAGTTGGGTGTGGTGGTGGACGCCTGTAATCCCGGCTACTCGGGAGGCTGAGGCAGGAAAATCACTTCAACCCGGGAGGCAGAGGTTGCCGTGAGCCAAGATCGTGCCATTGCACTCCAGCCTGGGTGACAAGAGCAAAACTCTGTCTCAAAAAAAAA","GGCTGGGCGCAGTGGCTCACACCTGTAATCCCAGCACTTAGGGAAGCTGAGGCGAGTAGATCACCTGAGGTCAGGAGTTAGAGACCAGCCTGGCCATCATGGTGAAACCCCGTCTCTACTAAAGATACCAAAAATTAGCTGAGTGTGGTGCTGGGTGCCTGTAATCCCAGAAACTCAGGGTGCCTGTAATCCCAGCAACTCAGGGTGCCTTTAATCCCAGCAACTGAGGGTACCAGTAATCCCAGCAACTCAGGGTGTCTTTAATCCTAGCAACTGAGGGCACCTGTAATCCCAGCAACTCAGGAAGCTGAGACAGGAGAAGTACTTGAACCCAGAAGGCAGAGGTTGCAGTGAGCCGATATTGCACCATTGCACTCCAGTCTGGGCAACAAGAGTGAAACTCTGTCTCAAAAAAAAA"
"chr18","44546829","44547449","JH378118","18053084","18053501","262","26493745","GGCCAGGCACGGTCGCTCACACCTGTAATTCCAGCACTTTGGGAGGCCAAGGCGGATGGGTCACCTGAGGTCAGGAGTTTGAGACCAGCCTGACCAATATGATGAAACCCCATCTCTATTAAAAATACAAAAATTAGGCTGGGCGCAGTGGTTCATGCCTGTAATTCCAACACTTTGGGAGGCCGAGACGGGCGGACCATGAGGTCAGGAGATCGAGACCATCCTGGCCAACGTGGTGAAACCCCGTGTCTACTAAAATACAAAAAAAATTAGCCAGGTGTGGTGGCACGTGCCTGTAGTCCCAGCTATTAGGGAGGCTGAGGCAGGGGAATCACTTGAACCTGGGAGGTGGAGGTTGCAGTGAGCTGAGATCTTGCCACTACACTCCATTCTGGGCAACAGAGCAAGACTCCGTCTGAAAAAAAACAAAAAAATACAAAAATTAGCTGGGCATGGTGGCGGGTACCTGTAATCCCAGCTACTTGGGAGGCTGAGACAGGAGAATCACTTGAACTCGGGAGGCAGAGGTTGCAGTGAGCCAAGATCGCACCATTGCATTCCAGCCTGGGCAACAAGAGCGAAACTCCATCTCAAAAAAACAAAAAAAAAAAAAAAGAAAAA","GGCTGGGCGCAGTGGCTCACACCTGTAATCCCAGCACTTAGGGAAGCTGAGGCGAGTAGATCACCTGAGGTCAGGAGTTAGAGACCAGCCTGGCCATCATGGTGAAACCCCGTCTCTACTAAAGATACCAAAAATTAGCTGAGTGTGGTGCTGGGTGCCTGTAATCCCAGAAACTCAGGGTGCCTGTAATCCCAGCAACTCAGGGTGCCTTTAATCCCAGCAACTGAGGGTACCAGTAATCCCAGCAACTCAGGGTGTCTTTAATCCTAGCAACTGAGGGCACCTGTAATCCCAGCAACTCAGGAAGCTGAGACAGGAGAAGTACTTGAACCCAGAAGGCAGAGGTTGCAGTGAGCCGATATTGCACCATTGCACTCCAGTCTGGGCAACAAGAGTGAAACTCTGTCTCAAAAAAAAA"
"chr18","45772849","45773450","JH378118","18053084","18053501","269","27719765","CACGCCTATAATCCCAGCACTTTAGGAGGCTGAGGCAGGTGGATCACCTGAGATCAGGAGTTCAAAACCAGCCTGGCCAACATGGTGAAACCCTGTGTCTACTACAAATACAAAAAAATGGGCAGGGTGTGGTGGCTCACACCTGTAATCCCAGCACTTAGGGAGGCCGAGGCGGGTGGATCATGAGGTCAAGAGATCAAGACCATCCTGGCCAACATGGTAAAACCCCGCCTCTACTAAAAATATAAAAATTAGCTGGGCAAGGTGGTGCGCGCCTGTAGTCCCAGCTATTTGGGAGGCTGAGGCAGGAGAATTGCTTGAACCTGGGAGGTGGAGGTTGCAGTGAGCCAAAATCGCGCCACTGCACTCCAGCCTGGCAACAGAGTGAGACTCTGTCTCAAAAAAAAACAAAAACAAAACAAAACAGAAACCAAAATTAGCTGGGCGTGGTGGCGGGCGCCTGTAGTCCCAGCTACTTGGGAGGCTGAGGCAGGAGAATCGCATGAACCCAGGAGGCGGAGGTTGCAGTGAGCCAAGACTGCACTATTGCACTCCAGTCTGGGCTACAAGAGCGAACTCCGTCTCAAAAAAAAAAAAAAAAA","GGCTGGGCGCAGTGGCTCACACCTGTAATCCCAGCACTTAGGGAAGCTGAGGCGAGTAGATCACCTGAGGTCAGGAGTTAGAGACCAGCCTGGCCATCATGGTGAAACCCCGTCTCTACTAAAGATACCAAAAATTAGCTGAGTGTGGTGCTGGGTGCCTGTAATCCCAGAAACTCAGGGTGCCTGTAATCCCAGCAACTCAGGGTGCCTTTAATCCCAGCAACTGAGGGTACCAGTAATCCCAGCAACTCAGGGTGTCTTTAATCCTAGCAACTGAGGGCACCTGTAATCCCAGCAACTCAGGAAGCTGAGACAGGAGAAGTACTTGAACCCAGAAGGCAGAGGTTGCAGTGAGCCGATATTGCACCATTGCACTCCAGTCTGGGCAACAAGAGTGAAACTCTGTCTCAAAAAAAAA"
"chr18","50079974","50080314","JH378127","6796468","6796795","54","43283506","GGTCTGGCGCCAGTGGCTCATGCCTGTAATCCCAGCACTTTGGGAGGCTGAGGCGGGTGTATCACCTGAGGTCAGGAGTTCGAGACCAGCCTGGCCAACATGGCAAAACCCCGTCTCTACGAAAAATACAAAAAAATTAGCCGGGCGTGGTAGCAGTCGCCTGTAATCCCAGCAACTTGGGAAGCTGAGGCAGAAGAATCGCTTAAACCTAGGAGGCGGAGGTTGCAGTGAGCCAAGATTGCGCCATTGCACTCCAGCCTGGTCAACAAGAGCAAAACTCTGTCTCAAAACAACAACAACAACAACAACAACAACAAACAAAAACCAAAAAAACCAAAAAA","GGCCGGGCGCGGTGGCTCAAGCCTGTAATCCCAGCATTTTGGGAGGCCGAGGCGGGTGGATCACGAGGTCAGGAAATCGAGACCATCCTGGTCAACATGGCGAAACCCCATGTCTACTAAAAATACAAAAATTAGCTGGGCATGGTGGCACGTGCCTGTAATCCCAGCTACTCAGGAGGCTGAGGCAGGAGAATTGCCTGAACCCAGGAGGCGGAGCTTGCAGTGAGCCGAGATCGCGCCATTGCACTCCAGCCTGGGTAACAAGAGCGAAACTCCGTCTCAAAAAAACAAACAAAAACAAAACAAAACAAAACAAAACAAAAAAAAC"
"chr18","53653883","53654201","AGCE01149660","956","1264","46","53652927","GGCCAGGCATGGTGGCTCACGTTTGTAATCCTAGCACTTTGGGAGGCTGTAGCGGGCGGATCACCTGAGGTCAGGAGTTTGAGACCAGCCTGGCCAACATGGTGAAACCCTGTCTCTACTAAAAAAAAAAAAAAAAAAAAAAAAAAAATTAGCCAGGTGTGGTGGTGGTGGATGCCTATAATCCCAGCTACTCGGGAGGCTGAGGCAGGAGAATCACTTGAACCTGGGAAGCAGAGGTTGCAATGAGCTGAGATTGAGCCATTGCACTCCAGCCTGGACAACAAGAATGAGACTCTGTCTCAATAAATAAGTAAATAAA","GGCCAGGCACGGTGGCTCATGCCTATAATCCCAGCACTTTGGGAGGCTGCGATGGGTGGTTCACTTGAGGTCTGGAGTTTGAGACCAGCCTGGCCAACATGGAGAAACCCTTTCTCTACTAAAAATACAAAAAAAAAAAAAAAAAAAATTAGCCAGGCATGGTGGCGGGTGCCTGTAATCCCAGCTACTCAGCAGGCTGAGGGAAGAGAATCACTTGAACCGGGGAGGCAGAGGTTGCAGTGAGCTGAGATGATGCCATTGCACTCCAGCCTGGGCAACAAGAGCAAAACTGTCTCAAAAAAAAAAAAA"
"chr18","53971096","53971710","JH378118","18053084","18053501","262","35918012","GGTCGGGTGTGGTGGCTCATGCCTATAATCCCAGCACTTTGGGAGGCTGAGGCAGGCAGATTACCTGAGGTCAGGAGTTCGAGACCAGCCTGGCCAACATGATGAAACCTTGTCTCTACTAAAAATACAAAAATTAGGCCGGGCACGGTGGCTCATGCCTGTAATCCCAGCACTTTGGGAGGCCGAGGCGGGTAGATCACAAGGTCAGAAGTTCAAGACCAGCCTGGCCAACATGGTGAAACTCTGTCTTTACTAAAAATACAAAAATTAGCTAGGCATGGTGGCGCACACCTATAATCCCAGCTACTGGGGAGGCTGAGGCAGGAGAATTGCTTGAACCAGGACCCGGGAGGTGGAGGTTGCTGTGAGCCGAGATTGCGCCACTGCACTCCAGCCTGGGAGACAGAGTGAGACTCCGTCTAAAAAAAAAAAAAAAAAATTAGCCAGGTGTGGTGGCGCATGCCTGTAATCCCAGCTACTCGGGAGGCTGACGCAGAAGAATCATTTGAACGTGGGAGGCAGAGGTTACAATGAGCTGAGATCACACCATTGTACTCCAGCCTGGGCAACAAGAGCAAACTCAATCTCAAAAAAATAAAAATAAAAAAAAAGAAA","GGCTGGGCGCAGTGGCTCACACCTGTAATCCCAGCACTTAGGGAAGCTGAGGCGAGTAGATCACCTGAGGTCAGGAGTTAGAGACCAGCCTGGCCATCATGGTGAAACCCCGTCTCTACTAAAGATACCAAAAATTAGCTGAGTGTGGTGCTGGGTGCCTGTAATCCCAGAAACTCAGGGTGCCTGTAATCCCAGCAACTCAGGGTGCCTTTAATCCCAGCAACTGAGGGTACCAGTAATCCCAGCAACTCAGGGTGTCTTTAATCCTAGCAACTGAGGGCACCTGTAATCCCAGCAACTCAGGAAGCTGAGACAGGAGAAGTACTTGAACCCAGAAGGCAGAGGTTGCAGTGAGCCGATATTGCACCATTGCACTCCAGTCTGGGCAACAAGAGTGAAACTCTGTCTCAAAAAAAAA"
"chr18","57837437","57837748","JH378115","16887097","16887400","43","40950340","GCTGGGCATGGTGGCTCACACCTGTAATCCCAGCACCTTGGGAGGCCGAGGTGGGTAGATCACCTGAGGTCAGGAATTCGAGACCAACCTGGCCAACATGGTGAAACCCCGTCTCTACTAAAAATACAAAAAAAAAAAAAAAAAAAAAAAAAGCTGGGCATGGTGGTGGGTACCTGTAATCCCAGCTACTCAGGAGTCCGAGGCAGGAGAATCGCTTGAACCTGGCAGGTGGAGGTTGCAGTGTGCCAGGATTGTGCCATTGCACTCCAGCCTGGGTGACAAGAGCAAAACTCCAACTCAAAACAAAAACAA","GCCGGGCACGGTGGCTCAAGCCTGTAATCCCAGCACTTTGGGAGGCCGAGGCGGGTGGATCACAAGGTCAAGAGATCGAGACCAACCTGGTCAACATGGTGAAACCCCATCTCTACTAAAAAATACAAAAAAAAAAAAAAAATTAGCTGGGCATGGTGGCGCGTGCCTATAATCCCAGCTACTCAGGAGGCTGAGGCAGGAGAATTGCCTGAACCTAGGAGGTGGAGGTTGCAGTGAGCCAAGATCATGCCATTGCACTCCAGCCTGGGTAACAAGAGCGAAACTCCATCTCAAAAAAAAAAAA"
"chr18","58257354","58257943","JH378118","18053084","18053501","263","40204270","GCCTGTAATCACAGCACTTAGGGGGGCCGAGGCAGGAGGATCACCTGAGGTCAGGAGTTCGAGACCAGCCTGGCCAACATGGTGAAACCCCGTCCCTACTAAAAATACAAAAATTGGCCGGACACATTGGCTCATGCCTGTAATCCCAGCACTTTGGGAGGCCGAGGCGGGTGGATCACCTGAGGTCAGGAGTTCAAGACCAGCCTGACCAACCTGGAGAAACCCTGTTTCTACTAAAAATACAAAATTAGCCAGGCATAGTGGCGCATGCCTGTAATCCCAGCTACTCGAGAGGCTGAGGCAGGAGAATCGCTTGAACCCGGAAGGTGGAGGTTGCGGTGAACCGAGATTGTGCCATTGCACTCCAGCCTGGGCAACAAGAGCAAAACTCCGTCTCAAAAACAAAACAAAACAAAACAAAAATTAACCCGGCGTGGAGGTGGATGCCTGTAATCCCAGCCACTTTGGGAGACTGAGGCAAGAGAATTGCTTGAACCCGGGATGTGGAGGCTGCAGTGACCCGAGATCACGCCATTGCATTCCAGCCTGGCAACAAGAGTAAGACTCCATCTCAAAAACAAGCAAACAAA","GGCTGGGCGCAGTGGCTCACACCTGTAATCCCAGCACTTAGGGAAGCTGAGGCGAGTAGATCACCTGAGGTCAGGAGTTAGAGACCAGCCTGGCCATCATGGTGAAACCCCGTCTCTACTAAAGATACCAAAAATTAGCTGAGTGTGGTGCTGGGTGCCTGTAATCCCAGAAACTCAGGGTGCCTGTAATCCCAGCAACTCAGGGTGCCTTTAATCCCAGCAACTGAGGGTACCAGTAATCCCAGCAACTCAGGGTGTCTTTAATCCTAGCAACTGAGGGCACCTGTAATCCCAGCAACTCAGGAAGCTGAGACAGGAGAAGTACTTGAACCCAGAAGGCAGAGGTTGCAGTGAGCCGATATTGCACCATTGCACTCCAGTCTGGGCAACAAGAGTGAAACTCTGTCTCAAAAAAAAA"
"chr18","59255477","59255805","JH378228","5665092","5665424","52","53590385","GGTTGGGCGCAGTGGCTCACGCCTGTAACCCCAGCACTTTCGGAAGCTGAGGCAGGCGGATCACCTGAGGTCAGGGGTTCGAGACCAGCCCGGACAACGTGATTAAACCCTGCCTCTACTAAAAATACAAAAATTAGCGACTGTGGTGTTGGGCGCCTGTAATCGCAGCTACTTGGGAGGCTGAGGCATGAGAATTGCTTGAACCCAGGAGGCAGAGGTTGCAGTGAGCAGAGATTGCTCCATTGCACTCCAGCCTGGGCAACAAGAGCAGAACTCTGTCTCAAAATAAATAAATAAATAAATAAATAAATAAATAACAGAAAAGAAAA","GGCCGGGCGCGGTGGCTCAAGCCTGTAATCCCAGCACTTTGGGAGGCTGAGGCGGGTGGATCACGAGGTCAAGAGATCGAGACCATCCTGGTCAACATGGTGAAACCCTGTCTCTACTAAAAATACTAAAAATTAGCTGGGCATGGTGGCGTGTGCCTGTAATCCCAGCTACTCAGGAGGCTGAGGCAGGAGAATTGCCTGAACCCAGGAGGCGGAGGTTGCGGTGAGCCGAGATCGCGCCATTGCACTCCAGCCTGGGCAACAAGAGCGAAACTCTGTCTCAAAAAAAAAAAATAAATAAATAAAATAAAATAAAATAAAATAAAATAAAAT"
"chr18","59405673","59406877","JH378118","18053084","18053501","805","41352589","GGCTAGATGCGGTGGCTCATGCCTGTAATCCCAGCACTTTGGGAGGCCAAGGCAGGTGGATCACCTGAGGTCAGGAGTTTGACACCAGCCTGGCCAACATGTTGAAACCCTGTCTCCACTAAAAATACAAAAAAAGATTATCTGGGTTATTGTGGGATCTGGCCAGCAGCCCGCAATGCAATGGGGCTCTCTCTTTGTTCCCAGGCAGATTGGCAGGTTGAGAAATAATAGACACACACAAGATAGTGAAAGTTGGGTCCAGGGGGGTCACCGCCTTCTGGTCCCATGGTGCCAACAATGCACTGGATATACCAGCATTTATTATTAAGTTTAGTGAGGGCGGGGGTAGGTTAGTGAGGGATTTAGGGTCATTTGATTATGAGGTGAGATGGTCACATGGAAATGAAGTAATTCTTTAACGTAACATTTGTATGTAGAAGTACAGTACATTTGTATGTAGAAGTACAGTATACAGAGATAAGAATTTACAATATAGTGTGTGCATCAGTAATTTCTAACAGAGCCTTAAAACAGAAAGACAATCTTTCCATAATCTATGATTAGCAAGATATTAATCAGCAGTAACAATTGCAATGAAAGCTGGTTACAAACAGTCCATGGAAACAGGAGGTGAAGCTAGACAATCGGTTAGACCAGAAATTCTCAGAAGGGAATATGCCTTAACCCTAAAGAGGCCTAGAAGAGCCGTGGCAAGATGAGGGTGTTTATAGCCCTATCTTATCCATATGGACAGGCACCTCCCCATGCGTCCGTTTATAGGCTCTCCATGAGGGTCGCATTCCATTCCCAGAGCTATGAACATCTGCTTTTCTGGGATAGGAATCTTGGTGATGTGAAACCTCCCTGACTACACGTCCATTCATAGGATCTCTGCAGGGGGAAGCACATCACACACTGTTGGCTCGTTCTGGCAGTCCAACCTGGCATTGTGTCTTTACACAATCCTGCATGCAATTTTGTATTTACAATAATCAGGAGCATTTCATCTTTTATTCTGTAGCAATAGTTTCAGGGGGTCTCCCTACACTGGGTGTGGTGACGGGTACCTGTAATCCCAGCTACTCAGGAGGCTGAGGCAGGAGAATCACTTGAGCCTTAGAGGCAGAGGTTGCAGTGAGCTGAGATCAGACCATTGCACTCCAGCCTGGGCAACAAGAGCAAACCTCCGTCTCAAAAAAAAAAAA","GGCTGGGCGCAGTGGCTCACACCTGTAATCCCAGCACTTAGGGAAGCTGAGGCGAGTAGATCACCTGAGGTCAGGAGTTAGAGACCAGCCTGGCCATCATGGTGAAACCCCGTCTCTACTAAAGATACCAAAAATTAGCTGAGTGTGGTGCTGGGTGCCTGTAATCCCAGAAACTCAGGGTGCCTGTAATCCCAGCAACTCAGGGTGCCTTTAATCCCAGCAACTGAGGGTACCAGTAATCCCAGCAACTCAGGGTGTCTTTAATCCTAGCAACTGAGGGCACCTGTAATCCCAGCAACTCAGGAAGCTGAGACAGGAGAAGTACTTGAACCCAGAAGGCAGAGGTTGCAGTGAGCCGATATTGCACCATTGCACTCCAGTCTGGGCAACAAGAGTGAAACTCTGTCTCAAAAAAAAA"
"chr18","71500430","71500770","JH378228","5665092","5665424","54","65835338","GCTGGGTGCGGTGGCTCACGCCTGTAATCACAGCACTTTGGTAAGCCCGAGGCAGGTGGATCACCTGAGGTCAGGAGTTCGAGACCAGCCTGACCAACATGGTGAAACCCTTTCTCTACTAAAAATGCAAAAATTAGCTGGGCGTCATGGCGGGCGTCTGTGATCCCAGCTACTAGGGAGGCTAAGGCAGGAGAATTGCTTGAACCTGGGAGGCGGAGGTTGCAGTGAGCAGAGATTGCACCATTACACTCCAGCCTGGGCAACAAGAGCAAAACTCCATCTCAAAATAAATAAATAACTAAATAAATAAATAAAATGAAATTAAAAAGAAAGAAAGAAAA","GGCCGGGCGCGGTGGCTCAAGCCTGTAATCCCAGCACTTTGGGAGGCTGAGGCGGGTGGATCACGAGGTCAAGAGATCGAGACCATCCTGGTCAACATGGTGAAACCCTGTCTCTACTAAAAATACTAAAAATTAGCTGGGCATGGTGGCGTGTGCCTGTAATCCCAGCTACTCAGGAGGCTGAGGCAGGAGAATTGCCTGAACCCAGGAGGCGGAGGTTGCGGTGAGCCGAGATCGCGCCATTGCACTCCAGCCTGGGCAACAAGAGCGAAACTCTGTCTCAAAAAAAAAAAATAAATAAATAAAATAAAATAAAATAAAATAAAATAAAAT"
"chr19","1465612","1466244","JH378118","18053084","18053501","284","16587472","GGCTGGGGACGGTGGCTCAGGCCTGTAACCCCAGCACTTTGAGAGGACCAGGAGGGAGGATTGCTTGAGCCCAGGAGTCCGAGACCAGCCTGGGCAGCAAAGCAAGGCCCTGTCTCTACAAAAATACTTTAAAATTAGCCAAGTGTTGGCTGGGTGCGGTTGCTCATGCCTATAATCCCAGCACTTTGGGAGGCCGAGGTGGGTGGATCACCTGAGGTCAGGAGTTTGAGACCAGCCTGGCCAACATGGCAAAACCCCGTCTCTACTAAAAATACGAAAATTAGCCAGACGTGGTGGCTCATTCCTGTAATCCCAGCTACTCGGGAGGCTGAGGCAGGAGAATCGCTTGAACTCGCAAGGCGGAGGTTGCAGTGAGCCAAGATCATGCCATTGCATTCCAGCCTGGGTGACAGAGCAAAACTCCGTCTCAAAAAAAAAAAAAAAAAAAAAAAATTAGCCAGGCGTGGTGGTGGGCACCTGTAGTCCCAGCTACCCGGGAGGCTGAGGCAGGAGAATCGCTTGAGCCCGGGAGGCAGAGGTTACAGTGAGCCGAGATCGTGCCATTGCACTCCAGCCTGGGCAACAAGAGTGAAAATCCGTCTCAAAAAAATAAATAAATACAAAATAAAAAAA","GGCTGGGCGCAGTGGCTCACACCTGTAATCCCAGCACTTAGGGAAGCTGAGGCGAGTAGATCACCTGAGGTCAGGAGTTAGAGACCAGCCTGGCCATCATGGTGAAACCCCGTCTCTACTAAAGATACCAAAAATTAGCTGAGTGTGGTGCTGGGTGCCTGTAATCCCAGAAACTCAGGGTGCCTGTAATCCCAGCAACTCAGGGTGCCTTTAATCCCAGCAACTGAGGGTACCAGTAATCCCAGCAACTCAGGGTGTCTTTAATCCTAGCAACTGAGGGCACCTGTAATCCCAGCAACTCAGGAAGCTGAGACAGGAGAAGTACTTGAACCCAGAAGGCAGAGGTTGCAGTGAGCCGATATTGCACCATTGCACTCCAGTCTGGGCAACAAGAGTGAAACTCTGTCTCAAAAAAAAA"
"chr19","1761610","1762212","JH378118","18053084","18053501","248","16291474","GGCCGGGTGCGGTGGTTTACACCTGTAATCCTGGCATTTTGGGAGGCCGAGGCAGGAGTATCACCTCAGGTCAGGAGTTCAAGACCAGCCTGGCCAACATGGTGATACTCCGTCTCTACTAAAAATACAAAAATTGGCCGAGTGCAGTGGCTCACACCTGTAATCCCAGCACTTTGGGAGGCCGAGGCAGGTGGATCATGAGGTCAGGAGTTCGAGACCAGCCTGGCCAAGATGGTGAAACCCCGTCTCTACTAAAAATACAAAAATCAGCTGGGTGTGGTGGCGGGTGCCTGTAATCCCAGCTACTCGGGAGGCTGAGGCAGGAGAATTGCTTGGACCTGGGCAGCAGAGGTTGCAGCGAGCTGAGATGGCGCCACTGCACTCCAGCCTGGGCGACAGAGCGAGACTCTTGTCTCAGAAAAATAAAAAATAAAAAAATTAGCTGGGTGTGGTGGTGCGCACCTGTAATCCCAGCTACTCGGGAGGCTGAGGCAGGAGAATCGCTTGAATCTGGGAGGAGGAGGAGGTTGCAGTGAGCTGAGATAGTGCCAGTGCAGGCCAGCCTGGTCAACAAGAGTGAAACTCCGTCTCAGAAAAAAAAAA","GGCTGGGCGCAGTGGCTCACACCTGTAATCCCAGCACTTAGGGAAGCTGAGGCGAGTAGATCACCTGAGGTCAGGAGTTAGAGACCAGCCTGGCCATCATGGTGAAACCCCGTCTCTACTAAAGATACCAAAAATTAGCTGAGTGTGGTGCTGGGTGCCTGTAATCCCAGAAACTCAGGGTGCCTGTAATCCCAGCAACTCAGGGTGCCTTTAATCCCAGCAACTGAGGGTACCAGTAATCCCAGCAACTCAGGGTGTCTTTAATCCTAGCAACTGAGGGCACCTGTAATCCCAGCAACTCAGGAAGCTGAGACAGGAGAAGTACTTGAACCCAGAAGGCAGAGGTTGCAGTGAGCCGATATTGCACCATTGCACTCCAGTCTGGGCAACAAGAGTGAAACTCTGTCTCAAAAAAAAA"
"chr19","2871458","2872098","JH378118","18053084","18053501","282","15181626","GGCCGGGCGCGGTGGCTCACGCTTGTAATCCCAGCACTTTGGGAGGCCTAGGTAGTGGATCACCTGAGGTCAGGAGTTTGAGACCAGCCTGGCCAACATGGGGAAACCCAGTCTCTACTAAAAATACAAAAATGAGGCCGGGTGCAGTGGCTCATGCCTGTAGTCTCAACACTTTGGGAGACCAAGGCAGGCGGATCACCTGAGGTCAGGAGTTCAAGCCCAACCTGGCCAACATGGTGAAACCCTGCCTCTTCTAAAAATACAAAAATTAGCCAGGTGTGGTGGCATGTACCTGCAATCCCAGCTGCTTAGGAGTTCGAGATAGAAGGATTGCCTGAACCTGGGAGGCGGAGGTTGCAGTGAGCTGAGATCATGCCATTGCACTCCAGCCTGGGTGACAGAGACCCTGTCTCACACACACACACACAAATTATATATATATATATATATATACACACACACACACACGCACACACAAATTGGCCAGGCGTGGTGGCGGGTGCCTATAATTCCAGCTACTTGGGAGGCTGAGGCAGGAGAATGTCTTGAACCCGGGAGGTGGAGGTTGCAGTGAGCCGAGATTGCGCCACTGCACTTTAGCCTGGACGACAAGAACAAAACTCCATCTCAAAAAAACGAAA","GGCTGGGCGCAGTGGCTCACACCTGTAATCCCAGCACTTAGGGAAGCTGAGGCGAGTAGATCACCTGAGGTCAGGAGTTAGAGACCAGCCTGGCCATCATGGTGAAACCCCGTCTCTACTAAAGATACCAAAAATTAGCTGAGTGTGGTGCTGGGTGCCTGTAATCCCAGAAACTCAGGGTGCCTGTAATCCCAGCAACTCAGGGTGCCTTTAATCCCAGCAACTGAGGGTACCAGTAATCCCAGCAACTCAGGGTGTCTTTAATCCTAGCAACTGAGGGCACCTGTAATCCCAGCAACTCAGGAAGCTGAGACAGGAGAAGTACTTGAACCCAGAAGGCAGAGGTTGCAGTGAGCCGATATTGCACCATTGCACTCCAGTCTGGGCAACAAGAGTGAAACTCTGTCTCAAAAAAAAA"
"chr19","2912949","2913566","JH378118","18053084","18053501","268","15140135","GGCTGGGCGTGGTGGCTCACACCTGTAATCCCAGCACTTTGGGAGGCCAAGGTGGAGGGACTGCCTGAAGCCAGGGGTTCGAGACCAGCCTGGCCAACATGGTGAAACCCTGTCTCTACTAAAAATAGAAAAATTAAGGCCGGGCGCGGTGGCTCATGCCTGTAATCCCAGCACTTTGGAAGGCCGAGGCGGGCGGATCACTTGAGGTCGGGAGTTCAAGACCAGCCTGACCAACATGGAGAAACCCTGTCTCTACTAAAAATACAAAATTAGCCAGGGTGGTGGCGCATGCCTGTAATCCCAGCTACTTGGGAGGCTGAGGCAGGAGAATCGCTTGAACCCGGGAGGTGGAGGTTGCAGTGAGCTGAGATCGCACCATTGCACTCCAGCCTGGGCAACAAGAGCAAAACCACGTCTCAAAAAAAATAAAAATAAAAATAAAAAAATTAGCTGGGTGTGGTGGCAGGCGCCTGTAGCTGCTTGGGAGGCTGAGACAGGAGAATTGCTTGAACCTGGGAGGCGGAGGTTGCAGTGAGCTGAGACCGTGCCATTGCACTCCAGGCTGGGCAAGAAGAGCAAAACTCTATCCTTCCCCCACTCCAAAAAAAAAAAAAAAAA","GGCTGGGCGCAGTGGCTCACACCTGTAATCCCAGCACTTAGGGAAGCTGAGGCGAGTAGATCACCTGAGGTCAGGAGTTAGAGACCAGCCTGGCCATCATGGTGAAACCCCGTCTCTACTAAAGATACCAAAAATTAGCTGAGTGTGGTGCTGGGTGCCTGTAATCCCAGAAACTCAGGGTGCCTGTAATCCCAGCAACTCAGGGTGCCTTTAATCCCAGCAACTGAGGGTACCAGTAATCCCAGCAACTCAGGGTGTCTTTAATCCTAGCAACTGAGGGCACCTGTAATCCCAGCAACTCAGGAAGCTGAGACAGGAGAAGTACTTGAACCCAGAAGGCAGAGGTTGCAGTGAGCCGATATTGCACCATTGCACTCCAGTCTGGGCAACAAGAGTGAAACTCTGTCTCAAAAAAAAA"
"chr19","3601333","3601668","JH378148","10302642","10302970","47","6701309","GCTGGGCGTGGTGGCTCACACCTGTAATCCCAGCACTTTGGGAGGCTGAGGTGGGCGGATCACGTGAGGTCAGGAGTTCCAGACTAGCCTGGCCAACATGGGGAAACCCCATCTCTGCTAAAAATAAAAAATTTAGCCGAGTGTGGTGGTGGGTGCCTGTAATCCCAGCTACTCAGGAGGCCGAGGCAGGAGAATTGCTTGAACCCAGGAGGCAGAGGTTGCAGTGAGCCGAGATCACGCCATTGCACTCCAGCCTGGATGACAACAGTGAGACTCCAACTCAAAAAATAATAATAATAATAATAATAATAATAAAATAAAACAATAAAAAAAAAA","GGCCGGGCGCGGTGGCTCAAGCCTGTAATCCCAGCACTTTGGGAGGCCGAGGCGGGTGGATCACGAGGTCAAGAGATCGAGACCATCCTGGTCAACATGGTGAAACCCCGTCTCTACTAAAAATACAAAAAATTAGCTGGGCATGGTGGTGGGTGCCTGTAATCCCAGCTACTCAGGAGGCTGAGGCAGGAGAATTGCCTGAACCCAGGAGGCGGAGGTTGCGGTGAGCCGAGATCGCGCCATTGCACTCCAGCCTGGGTAACAAGAGTGAAACTCTGCCTCAAAAAAAAAAAATAAAATAAAATAAAATAAAATAAAATAAAATAAAA"
"chr19","4440800","4441421","JH378118","18053084","18053501","276","13612284","GGCTGGGTGCGGTGGCTCATGCCTGTAATCCCAGCACTTTGGGAGGCCAAGCGGGCAGATCAACTGAGGTCAGGAGTTCGAGACCAGCCTGGCCAACATAGTAAAACCCTGTTTCTACTAAAAAAAAAAAAAAAAAAAAAAAAAAAATTGGCTGGGCGCAGTGGCTCACGCATGTAATCCCTGCACTTTGGGAGGCCAAGGCAGGTGGATCACCTGAGGTCAGTAGTTTGAGACCAGCCTGACCAACGTGGAGAAACCCCATCTCTACTAAAAATACAAACAAAAAAAACAAAAAACAAAAAAAACCGGGTATGGTGGTACATCCCTGTAATCCCAGCTCCTCGGGAGGCTGAGGCAGGAGAATCACTTGAACCCGGGAGGCGGAGGTTGCACTGAGCCGAGATTGCGCCACTGCACTCCAGCCTGGGCGATAGAGCGAGACTCCCTCTTAAATAATGATTATAATTGCCAGGTGTGGTGGCGGGTGCCTGTAATCCCAGCTACTTGGGAGGCTGAGGCAGGAGAATCGTTTGAATCCAGGAGGAGGAGGTTGCAGTGAGCCGAGATGGTGCCACAGCACTCCAGCCTGGGTGACAAGAGTGAAACCCCATTACAAACAAAA","GGCTGGGCGCAGTGGCTCACACCTGTAATCCCAGCACTTAGGGAAGCTGAGGCGAGTAGATCACCTGAGGTCAGGAGTTAGAGACCAGCCTGGCCATCATGGTGAAACCCCGTCTCTACTAAAGATACCAAAAATTAGCTGAGTGTGGTGCTGGGTGCCTGTAATCCCAGAAACTCAGGGTGCCTGTAATCCCAGCAACTCAGGGTGCCTTTAATCCCAGCAACTGAGGGTACCAGTAATCCCAGCAACTCAGGGTGTCTTTAATCCTAGCAACTGAGGGCACCTGTAATCCCAGCAACTCAGGAAGCTGAGACAGGAGAAGTACTTGAACCCAGAAGGCAGAGGTTGCAGTGAGCCGATATTGCACCATTGCACTCCAGTCTGGGCAACAAGAGTGAAACTCTGTCTCAAAAAAAAA"
"chr19","5462237","5462567","JH378255","1377129","1377437","56","4085108","GACCAGGTGCGGTGGCTCACGCCTGTCATTCCAGCACTTTGGGAGGCCGAGGGGGGCGTGGATCACTTGAGGTCAGGAGTTCAAGACCAGCCTGACCAACATGGTGAAACTCCGTCTCTACTAAAAATACAAAAATTAGCCAGGTGTGGTGGCACATGCCTGTAATCCCAGCTACTTGGGAGGCTGAGGCAGGAGAATCACTTGAACCTGGGAGATGGAGGTTTCATTCAGTGAGCTGAGATTGCACCATTGCACTCCAGCCTGGGTGACAAGAACGAAACTCTGTCTCAGAACACACACACACACACACACACACACACCCCAGAAAAAA","GGCCTGGCGTGGTGGCTCACGCCTGTAATCTCAGCACTTTGGGAGGCCAAGGTGGGTGGATCACCTGAGGTCAGGAGTTCAAGACCAGCCTGGCCAACATGGTGAAACCCCGTCTCTACTAAAAATACAAAAATTAGCTGGGTGTGGTGGCAGACACCTGTAATTCCAGCTACTTGGGAGGCTGAGGCAGGAGAATAGCTTGAACCTGGGAGGTGAGGGTTGCAGTGAGCCGAGATCGCACCATTTTACTCCAACCTGGGCAACAAGAGCGAAACTCCGTCTCAAAATCCAAACAAACCAAAACAAAAA"
"chr19","8011731","8012413","JH378118","18053084","18053501","321","10041353","GGCCGGGTACAGTGGCTCACTCCTGTAATCCCAGAACTTTGGGAGACCGAGGTGGGGGGATCACTTGAGGTCAGGAGTTCGAGACCACCCTGGCCAATATAGTGCTAAACCCCATCTCTACTCAAAATACAAAAAAAAAAAAAAAAAAAAAAAAAAAGCAAAACCCAGGCTGGGCACAGTAGCTCATACCTGTAATCCCAGCACTTTGGGAGGCTGAGGTGGGTAGATCATGAGGTCAGGAGTTCGAGACCAGCCTGACCAACATGGTGAAACCCCGTCTCTACTAAAAATACAAAAATTAGCCGGGCATGGTGGTGCGTGCCTGTAATCCCAGCTACTCAGGAGGCTGAGGCAGGAGAATCGCTTGAAGCTGGGAGGCAGAGGTTGCAGTGAGCCGAGATCGTGCTACTGTACTCCAGCCTGGGCAACAGGGCGACAGAGCAAGACTCTGTCTCAAAAAAAAAAAAAAAAAAAAAAAAAAGCAAAACCCCATCTCTACTAAAAATACAAAAAATTAGCCAGGCATGGTGGCATGTGCCTGTAATCCCAGCTACTCGAGAGGCTGAGGCAGAAGAATCACTTGAACCCAGGAGGCAGAGGTTGCAGCGAGCCAAGATTGTGCCATTGCACTCCAATCTGGGTGACAAGAGTAAAATCCTGTCTCAAAAAAATAAAAAATAAAA","GGCTGGGCGCAGTGGCTCACACCTGTAATCCCAGCACTTAGGGAAGCTGAGGCGAGTAGATCACCTGAGGTCAGGAGTTAGAGACCAGCCTGGCCATCATGGTGAAACCCCGTCTCTACTAAAGATACCAAAAATTAGCTGAGTGTGGTGCTGGGTGCCTGTAATCCCAGAAACTCAGGGTGCCTGTAATCCCAGCAACTCAGGGTGCCTTTAATCCCAGCAACTGAGGGTACCAGTAATCCCAGCAACTCAGGGTGTCTTTAATCCTAGCAACTGAGGGCACCTGTAATCCCAGCAACTCAGGAAGCTGAGACAGGAGAAGTACTTGAACCCAGAAGGCAGAGGTTGCAGTGAGCCGATATTGCACCATTGCACTCCAGTCTGGGCAACAAGAGTGAAACTCTGTCTCAAAAAAAAA"
"chr19","8026835","8027736","JH378118","18053084","18053501","522","10026249","GCGCGGTGGCTCATGCCTGTAAACCCAGCACTTTGGGAGGCTGAGGTGGGTGGATCACCTGAGGTCAGGAGTTTGAGACCAGCCTGGCCAATATGGTGAAACCCGTCTCTACTAAAACATACAAAAATTAGGCTGGGCGCGGTGGCTCATGCCTTTAATCCCAACACTTTGGGAGGCCGAGGCGGGCGGATCACGAGGTCAGGAGTTTGAGACCATCCTGGCTAACATGGTGAAAGCCCGTCTCTACTAAAAATATAAAAATTAGCTGGGCGTGGTGGTGGGCACCTGGAGTCCCAGCTACTTGGGAGGCTGAGGCAGGAGAATGGCGTGAACCCGGGAGGCGGAGCTTGCAGTGAGCCAGGATCACGCCACTGCACTCCAGCCTGGGCGACAGAGCGAGACACCGTCTCAAAAAAAAAACAACAAAAATTAGCCAGGCATGGTGGTGGGCGCCTTTTTTTTTTTTTTTTTCAGAGTCTCACTCTGTCACCCAGGCTGGAGTGCAGTGGCTCAATCTCGGTTCACTGCAACCTCCGCCTCCCAGGTTCAAGCGATTCTCCTGCCTCAGCCTCCCGAATAACTGGGATTACAGGCACCCGCCACTACAACCAGCTAATTTTTGTATTTTTAGTAGAGATGGGGTTTCGCCATGTTGGCCAGGATGGTCTTGATCTCTTGACCTCGTGATCCACCCTCCTTGGCCTCTCAAAGTGCTGGGATTACAGGTGTGAGCCACTGTTCCCAGCTGATAGTGGGCACTTTTAATCCCAGCTACTCCGGAGGCTGAGGCAGGAGAATTGCTTGAACCCAGGAGGTGGAGGTTGCAGTGAGCCAAGATCGCGCCATTGCACTCCAGCCTGGGTGACAATAGCAAAACTCTGTCTCAATGAAACAAAACAAAA","GGCTGGGCGCAGTGGCTCACACCTGTAATCCCAGCACTTAGGGAAGCTGAGGCGAGTAGATCACCTGAGGTCAGGAGTTAGAGACCAGCCTGGCCATCATGGTGAAACCCCGTCTCTACTAAAGATACCAAAAATTAGCTGAGTGTGGTGCTGGGTGCCTGTAATCCCAGAAACTCAGGGTGCCTGTAATCCCAGCAACTCAGGGTGCCTTTAATCCCAGCAACTGAGGGTACCAGTAATCCCAGCAACTCAGGGTGTCTTTAATCCTAGCAACTGAGGGCACCTGTAATCCCAGCAACTCAGGAAGCTGAGACAGGAGAAGTACTTGAACCCAGAAGGCAGAGGTTGCAGTGAGCCGATATTGCACCATTGCACTCCAGTCTGGGCAACAAGAGTGAAACTCTGTCTCAAAAAAAAA"
"chr19","9069244","9069863","JH378118","18053084","18053501","266","8983840","GGCCGGGCACGGTGGCTCATTCCTGTAGTCTCTGTACTTTAGGAGGCTGAGGTGGGTGGATCACTTGAGGTCAGGAGTTCCAGACCAGTCTGGCCAAAATGGTGAAACCCCGTCTGTACTAAAAATACAAAAAAAAAGGCCGGGCGCGGTGGCTCACGCCTGTAATCCCAGCACTTTGGGAGGCTGAGGTGGGTGGATCACAAGGTCAGGAGATTGAGACCATCCTGGCTAACATGGTGAAACCCCGTCTCTACTAAAAATACAAAAAATTAGCTGAGTGTGGTAGCAGGCACCTGTAATCCCAGCTACTCAGGAGGCTGAGGTGGGAGAATGGCATGAACCCAGGAAGCAGAGCTTGCAGTGAGCTGAGATCATGCCACTGCACTCCAGCCTGGGTGACAGAGCGAGACTCCATCTCAAAAAAAAAAAATACAAAAAAATTAGCCAGGCGTAGTGGTGCATGCTTGTAGTCTCGGCTACTCAGGAGACTGACGCAGGAGAATCACTTGAACCCAGGAGGCGGAGGTTGCAGTGAGCCGAAATTATGCCATTGCACTCCAGCCTGGGAGACAAGAACAAAACTCTATCTCAAAAACCAACCAACCAAACAAACAAAAAAA","GGCTGGGCGCAGTGGCTCACACCTGTAATCCCAGCACTTAGGGAAGCTGAGGCGAGTAGATCACCTGAGGTCAGGAGTTAGAGACCAGCCTGGCCATCATGGTGAAACCCCGTCTCTACTAAAGATACCAAAAATTAGCTGAGTGTGGTGCTGGGTGCCTGTAATCCCAGAAACTCAGGGTGCCTGTAATCCCAGCAACTCAGGGTGCCTTTAATCCCAGCAACTGAGGGTACCAGTAATCCCAGCAACTCAGGGTGTCTTTAATCCTAGCAACTGAGGGCACCTGTAATCCCAGCAACTCAGGAAGCTGAGACAGGAGAAGTACTTGAACCCAGAAGGCAGAGGTTGCAGTGAGCCGATATTGCACCATTGCACTCCAGTCTGGGCAACAAGAGTGAAACTCTGTCTCAAAAAAAAA"
"chr19","9785992","9786608","JH378118","18053084","18053501","261","8267092","GGCCGGGAACGGTGGCTCACACCTATAATCCCAGCACTTTGGGAGGCCGAGGCAGGTGGATCACCTGAGGTCAGGAGTTCAAGACCAGCGTGGCCAACATAATGAAACCCCATCTTGGCCGGGTGCGGTGACTCACGCCTGTAATCCCAGCACTTTGGGAGGCCAAGGCGGGTGGATCACGAGGTCAGGGGATCGAGACCATCCTGGCTAACACAGTGAAACCCTGTCTCTACTAAAAATACAAAAAAATTAGCTGGGCATGGTGGCGGACGCCTGTAGTCCCAGCTACTCGGGAGGCTGAGGCAGGAGAATGGTGTGAACCTGGGAGGCAGAGCTTGCAGTGAGCCGAGATTGCGCCACTGCACTCCAGCTTGGGTGACAAAGTGAGACTCCATCTCAAAAAAAAAAAAAGAAACCCCATCTCTACTAAAAATACAAAAAATTTGCTGGGTGTGGTTGTGGGCACCTGTAATCCCAGCTACTTGGGAGGCTGAGGCAGGAGAATCACCTGAACCCAGGAGGCAGAGGTTGCAGTGAGCCGAAACAGTGCCATTGCACTCCAGCCTGGGCAACAAGAGTGAAACTCAATCTCAAAAAAAAAAAAAAAAGTACAAAAA","GGCTGGGCGCAGTGGCTCACACCTGTAATCCCAGCACTTAGGGAAGCTGAGGCGAGTAGATCACCTGAGGTCAGGAGTTAGAGACCAGCCTGGCCATCATGGTGAAACCCCGTCTCTACTAAAGATACCAAAAATTAGCTGAGTGTGGTGCTGGGTGCCTGTAATCCCAGAAACTCAGGGTGCCTGTAATCCCAGCAACTCAGGGTGCCTTTAATCCCAGCAACTGAGGGTACCAGTAATCCCAGCAACTCAGGGTGTCTTTAATCCTAGCAACTGAGGGCACCTGTAATCCCAGCAACTCAGGAAGCTGAGACAGGAGAAGTACTTGAACCCAGAAGGCAGAGGTTGCAGTGAGCCGATATTGCACCATTGCACTCCAGTCTGGGCAACAAGAGTGAAACTCTGTCTCAAAAAAAAA"
"chr19","9897689","9898264","JH378206","6546474","6546861","233","3351215","GCCAGGCACGGTGGCTCACACCTGTAATCCCAGCACTTTGGGAGGCCAAGGTGGGTGGATCACCTGAGGTCAGGAGTTCAAGACCAGCCTGACCAACATGGTGAAACCCAGGGCTCACACCTGTAATCCCAGCGCTTTGGGAGGCTGACGCGGGCAGATCACGAGGTCAGGAGATCGAGACCATCCTGGCTAACATGGTGAAACCCCGTCTCTACTAAAAATACAATAATTAGCTGGGCATGGTGGTGGGTGCCTGCAGTCCCAGCTACTTGGGAAGCTGAGGCAGGAGAATGGCGTGAACCCAGGAGGTGGAGCTCTCAGTGAGCTGAGATTGCATCACTGCACTTCCAGCCTGGGTGACAGAGCAAGACTCTGTCTCAAAAAAAAAAAAAAAAAAAAAAAAAATTAGCCAGGTGTGATGGCAGGCACCTGTAATCCCAGCTACTTAGGAGGCTGAGGCAGGAGAACCCAGGAGGCAGAGGTTGCAGTGAGCCAAGATCGCGCCATTGCACTCCAGCCTGGGTGACAAGAGCAAAATTCCATCTCAAAAAAAAAAAAAAAGAAGAAAAAGAAGAA","GGCCACACATGGTGGCTAACGCCTGTAATCCCAGCACTTTGGGAGGCCAAGTCGGGTGGATCATGAGGTCAGGAGACCAAGACCATCCTGGCCAAATGGTGAAACCCCGTCTCTACTAAAAATACAAAAATTAGCTGGGCATGGTGGCGTGTGCCTGTAATCCCAGCTACTCAGGAGGCTGAGGCAGGACAATTGCCTGAACCCAGGAGAATTAGCTGGGCATGGTGGCGTGTGCCTGTAATCCCAGCTACTCAGGAGGCTGAGGCAGGACAATTGCCTGAACCCAGGAGGCGAAGGTTGCGGTGAGCCGAGATTGTGCCATTGCACTCCAGCCTGGGTAACAAGAGCGACACTCTGTCTCAAAAAAAAAAAAAAAAAAAAAAAAAAA"
"chr19","10210761","10211695","JH378118","18053084","18053501","553","7842323","GGCCGGGTGTGGTGGCTCATGCCTGTAATCCCAGGCATGATTTGGGAGGCCGAGGGAGGCAGATCACCTGAGGTCAGGAGTTTTTTTGTTTTGTTTTGTTTTGTTTTTGAGACAGAGTCTTGTTCTGTTGCCCAGGCTGGAGTGCAATGATGTGATCTCGACTCACTACAACCTCCACCTCCTGAGTTCAAGCGATTCTGCTGCCTCAGCCTCCCGAGTAGCTGGCATTACAGGCATGTGCCACCAAGCCTGGCTAATTTTTGTATTTATAGTAGAGACGGGGGTTTCACCATGTTGATCAGGCTGGTGTCGAACTCCTGGCCTCAAGTGATCCGCTCGCCTTGGCCTCCCAAAATGCTGGGATTACAGATGTGAGCCACTGTGCCCAGCCAAGGTCAAGAGTTTGAAACCAGCCTGGCCAGCATGGTGAAACCCTATCTCTACTAAAAATACAAAATCAGTCCATGTGCCTAATTTTGGGATCACACCTGGGATCATGCCTGCAATCCCAGCACTTTGGGAGGCCAAGGCGGGTGGGTCATGAAGTCAGGAGTTCAAGACCAGCCTGGCCAACATGGTGAAACCCTGTCTCTACTAAAAATACAAAAGTTAGCTGGGCGTGGTGGCACGCACCTGTAGTCCCAGCTACTAGGAAGGCTGAGGCAGGAGAATTCTTGAACCCGGGTGATGGAGGTTGCAGTGAGCCGAGATTGCGCCACTGCACTCCAGCCTGGGCAACAGAGTGAGACTCTGTCTAAAAAAAAAATTAGTCAGGCGTGGTGGTGAGCACCTGTAATCACAGCTACTGGGGAGGCTGAGGCTGGAGAATTGCTTGAACCCGGGAGGCGGAGGTTGCAGTGAGCCAAGATCGCGCCTTTGCACTCCAGCCTGGGCAACAGGAGTGAAACTGCATCTCAAAAAAAAAAAAAAAAAAA","GGCTGGGCGCAGTGGCTCACACCTGTAATCCCAGCACTTAGGGAAGCTGAGGCGAGTAGATCACCTGAGGTCAGGAGTTAGAGACCAGCCTGGCCATCATGGTGAAACCCCGTCTCTACTAAAGATACCAAAAATTAGCTGAGTGTGGTGCTGGGTGCCTGTAATCCCAGAAACTCAGGGTGCCTGTAATCCCAGCAACTCAGGGTGCCTTTAATCCCAGCAACTGAGGGTACCAGTAATCCCAGCAACTCAGGGTGTCTTTAATCCTAGCAACTGAGGGCACCTGTAATCCCAGCAACTCAGGAAGCTGAGACAGGAGAAGTACTTGAACCCAGAAGGCAGAGGTTGCAGTGAGCCGATATTGCACCATTGCACTCCAGTCTGGGCAACAAGAGTGAAACTCTGTCTCAAAAAAAAA"
"chr19","10485431","10486007","JH378118","18053084","18053501","237","7567653","GGCCGGGCGCAGTGGCTCATGCCTAATCCCAAGACTTTCAGAGGCTGAGGCAGGTGGATCACCTGAGGTCAGGAGCTCAAGACCAGCCTGGCTAACATTGTGAAACCGCGTCTCTACTAAAAATCAAAATTGGCCGGGCACGGTGGCTCACACCTGTAATCCCATCCCTCTGGGAGACCGAGGCGGGCAGATCACCTAAGGTCAGGAGTTCGAGACCAGCCTGACCAACATGGAGAAAACCCTTCTCTGCTAAAAATACAAAATTAGCCGGGCGTGGTGGCGCATGCCTGTAACCTCAGCTACTCGGGAGGCTGAGGGAAAATCGCTTGAACCTGCCAGGTGGAGGTTGCAGTGAGCCGAGATCGAGCCATTGCACTCCAGCATGGGCAACGAAAGCGAAACTCCATCTCAAAAAAAAAAAAAATTAGCTAGGCGTGGTGGCGCGTGCCTGTATTCCCAGCTACTCAGGAGGCTGAGACAGGAGAATCACTTGAACCTGGGAGGCAGAGGTTGCAGTGAGCCAAGATTGCACCATTGCACTCCAGCCTGGGCAACACGAGCAAAACTCTGTCTCAAA","GGCTGGGCGCAGTGGCTCACACCTGTAATCCCAGCACTTAGGGAAGCTGAGGCGAGTAGATCACCTGAGGTCAGGAGTTAGAGACCAGCCTGGCCATCATGGTGAAACCCCGTCTCTACTAAAGATACCAAAAATTAGCTGAGTGTGGTGCTGGGTGCCTGTAATCCCAGAAACTCAGGGTGCCTGTAATCCCAGCAACTCAGGGTGCCTTTAATCCCAGCAACTGAGGGTACCAGTAATCCCAGCAACTCAGGGTGTCTTTAATCCTAGCAACTGAGGGCACCTGTAATCCCAGCAACTCAGGAAGCTGAGACAGGAGAAGTACTTGAACCCAGAAGGCAGAGGTTGCAGTGAGCCGATATTGCACCATTGCACTCCAGTCTGGGCAACAAGAGTGAAACTCTGTCTCAAAAAAAAA"
"chr19","10538873","10539199","JH378118","15020968","15021286","46","4482095","GCTGGGCGCGGTGGCTCACGCCTGTAATCCCAGCACTTTGGGAGGCTGAGGCAGGCAGATCACCTGAGGTCAGGAGTTCAAGACCAGCCTGGTTAACACAGTGAAACCCCCGTCTCTACTAAAAATACAAAAACAAAAATTAGCCGGGTGTGGTGGCGGGCGCCTGTAATCCCAGTTACTCGGGAGGCTGAGGCAGGAGAATCGCTTGAACCCGGGAGGCGGAGGTTGTGGTGAGCCGAGATTGCCATTGCACTCCAGCCTGGGCAAAAAGAGCGAAACTCCATCTAAAACAAACAAACAAACAAACAAACAAAAAATAGAAAAGAA","GCCGGGCGCGGTGGCTCAAGCCTGTAATCCCAGCACTTTGGGAGGCTGAGGCGGGTGGATCCCGAGGTCAAGAGATCGAGACCATCCTGGTCAACATGGTGAAACCCCGTCTCTACTAAAAATACAAAACATTAGCTGGGTATGGTGGCGCGTGCCTGTAATCCCAGCTACTCAGGAGGCTGAGGCAGGAGAATTGCCTGAACCCAGGAGGCGGAGGTTGCGGTGAGCTGAGATCGCGCCATTGCACTCCAGCCTGGGTAACAAGAGCGAAACTTCCATCTCAAAAACAAACAAACAAACAAACAAACAAAAAACAAAC"
"chr19","10973032","10973651","JH378118","18053084","18053501","265","7080052","GGCTGGACGTGGTGGCTCACGCCTGTAATCCCAACACTTTGGGAGACCAAGGCAGGTGGATCGCCTGAGGTTAGGGGTTCGAGACCAGCCTGACCAACATGGTGAAACCCCATCTCTACTAATAATAAAAAAATTAGGACCAGGCTTGGTGGCTCATGCCTGTAATTCCAACACTTTGGGAGGCCAAGGCGAGTGGATAACTTGAGGTCAGGAGTTTGAGACCAGCCTGGCCAACATGGTGAAACCTCATCTCTACTAAAAATACAAAAATTAGCCGGCATGGTGGCGGGCACCCGTAATCCCAGCTACTCGGTGTGGGGGCTGGGACAGGAGAATCGCTTGAACCCAGGAGGTGGAGGTTGCCGTGAGCTAAGATTGCGCCACTGCACTCTAGTTGGGGCAACAGAGCGGACTCCGTCTCAAAAAAAAAAAAAAAATTAGCCGAGCGTGGTGGTGGACACCTGTAATCCCAGCTACTCAGGAGGCTGAGGCAGGAAAATTGAAATCGCTTAAACCTGGGAGGAGGAGGTTGCAGTGAGCCAAGATCGCACCATTGCACTCCAGCCTGGGCGACAAGAACAAAACTCCGTCTCCCCACTCCAAAAAAAAAAAAAAAAAAA","GGCTGGGCGCAGTGGCTCACACCTGTAATCCCAGCACTTAGGGAAGCTGAGGCGAGTAGATCACCTGAGGTCAGGAGTTAGAGACCAGCCTGGCCATCATGGTGAAACCCCGTCTCTACTAAAGATACCAAAAATTAGCTGAGTGTGGTGCTGGGTGCCTGTAATCCCAGAAACTCAGGGTGCCTGTAATCCCAGCAACTCAGGGTGCCTTTAATCCCAGCAACTGAGGGTACCAGTAATCCCAGCAACTCAGGGTGTCTTTAATCCTAGCAACTGAGGGCACCTGTAATCCCAGCAACTCAGGAAGCTGAGACAGGAGAAGTACTTGAACCCAGAAGGCAGAGGTTGCAGTGAGCCGATATTGCACCATTGCACTCCAGTCTGGGCAACAAGAGTGAAACTCTGTCTCAAAAAAAAA"
"chr19","11513769","11514351","JH378206","6546474","6546861","242","4967295","TCCCAGCACTTTGGGAGGCCGCGATGGGTGGATCACCTTAGGTCAGGAATTCGAGACCATCCTGGCCAACATGGTGAAACCCCGTCTCTACTAAAAACACAAAAATTAGGCCGGGCACGGTGGCTCACATCTGTAATCCCAGCACTTTGGGAGGCTGAGGTGGGCGGATCACAAGGTCAGGAGTTCAAGACCAGCCTGGCCAACATGGTGAAACCCTGTCTCTACTAAAAATACAAAAATTAACTGGGCATGGTGGCATGTGCCTGTAATCCCAGCTACTTGGGAGGCTGAGGCAGAAGAATTGCTTGAACCAGGGAGTCAGAGGTTATAGTGAGCTGAGATCGTGCGACTGCACTCCAGCCTGGTGACAGAGCGAGACTCCGTTTCAGGAAAAACAAACAAAACACAAAAATTAGCTGGGCATGGTGGCAGGCGCCTGTAATCCTAGCTACTTGGGAGGCTGAGGCAGGAGAATCGCTTGAACCCAGAAGGCAAAGGTTGCAGTGAGCTGAGATGATGCCATTGCACTCCAGCCTGGGCAACAAGTGAAACTCTGTCTCAAGAAAAAAAGTAAAAGAAAGAA","GGCCACACATGGTGGCTAACGCCTGTAATCCCAGCACTTTGGGAGGCCAAGTCGGGTGGATCATGAGGTCAGGAGACCAAGACCATCCTGGCCAAATGGTGAAACCCCGTCTCTACTAAAAATACAAAAATTAGCTGGGCATGGTGGCGTGTGCCTGTAATCCCAGCTACTCAGGAGGCTGAGGCAGGACAATTGCCTGAACCCAGGAGAATTAGCTGGGCATGGTGGCGTGTGCCTGTAATCCCAGCTACTCAGGAGGCTGAGGCAGGACAATTGCCTGAACCCAGGAGGCGAAGGTTGCGGTGAGCCGAGATTGTGCCATTGCACTCCAGCCTGGGTAACAAGAGCGACACTCTGTCTCAAAAAAAAAAAAAAAAAAAAAAAAAAA"
"chr19","11535200","11535780","JH378206","6546474","6546861","242","4988726","TCCCAGCACTTTGGGAGGCCGCGATGGGTGGATCACCTTAGGTCAGGAATTCGAGACCATCCTGGCCAACATGGTGAAACCCCGTCTCTACTAAAAACACAAAAATTAGGCCGGGCACGGTGGCTCACATTGTAATCCCAGCACTTTGGGAGGCTGAGGTGGGCGGATCACAAGGTCAGGAGTTCAAGACCAGCCTGGCCAACATGGTGAAACCCTGTCTCTACTAAAAATACAAAAATTAACTGGGCATGGTGGCATGTGCCTGTAATCCCAGCTACTTGGGAGGCTGAGGCAGAAGAATTGCTTGAACCAGGGAGTCAGAGGTTATAGTGAGCTGAGATCGTGCGACTGCACTCCAGCCTGGTGACAGAGCGAGACTCCGTTTCAGGAAAAACAAACAAAACACAAAAATTAGCTGGCATGGTGGCAGGCGCCTGTAATCCTAGCTACTTGGAGGCTGAGGCAGGAGAATCGCTTGAAACCCAGAAGGCAAAGGTTGCAGTGAGCTGAGATGATGCCATTGCACTCCAGCCTGGGCAACAAGTGAAACTCTGTCTCAAGAAAAAAAGTAAAAGAAAGAA","GGCCACACATGGTGGCTAACGCCTGTAATCCCAGCACTTTGGGAGGCCAAGTCGGGTGGATCATGAGGTCAGGAGACCAAGACCATCCTGGCCAAATGGTGAAACCCCGTCTCTACTAAAAATACAAAAATTAGCTGGGCATGGTGGCGTGTGCCTGTAATCCCAGCTACTCAGGAGGCTGAGGCAGGACAATTGCCTGAACCCAGGAGAATTAGCTGGGCATGGTGGCGTGTGCCTGTAATCCCAGCTACTCAGGAGGCTGAGGCAGGACAATTGCCTGAACCCAGGAGGCGAAGGTTGCGGTGAGCCGAGATTGTGCCATTGCACTCCAGCCTGGGTAACAAGAGCGACACTCTGTCTCAAAAAAAAAAAAAAAAAAAAAAAAAAA"
"chr19","12911527","12912140","JH378118","18053084","18053501","266","5141557","GGCCAGGCATGGTGGCTCATGCCTGTAATCCAGCACTTTGGTAGGCCAAGGTGGGTGGATGGATTACTTGAGGCCAGGAGTTCAAGACCAACCTGGCCAACATGGTGAAAACCCATCTCTATTAAAAATATAAAAGCTAGGCCAGGTGCGGTGGCTCACGCCTGTAATCCCAGCACTTTGGGAGGCTGAGGCGGGCGGATCACGAGGTCAGGAGATCGAGACCACTGTGAAACCCTGTCTCTACTAAAAATACAAAAAAAATTAGCTGGGTGGGGTGGCGGGTGCCTGTAGTCCCAGCTACTTGGGAGGCTGAGGCAGGAGAATGGCGTGAACCCGGGAGGCGGAGCTTGCAGTGAGCCGAGATCGCGCCACTGCACTCCAGCCTGGGCTACAGAGCAAGACTCCGTCTCAAAAAAAAAATAAATAAATAAATAAAAATAAAAACTAACTGGGCATGGTGGTGTGCACCTGTAATCCCAGCTACTCGGGAGGCTGAGACAGGAGAATTGCTTGAACCTGGGAGGTGGAGGTTGCAGTGAACCAAGATGATGCCATTGCACTCCAACCTGGGCAACAAGAGCAAAACTCCGTCTCAAAAAAAAAAAAAAAAAAAA","GGCTGGGCGCAGTGGCTCACACCTGTAATCCCAGCACTTAGGGAAGCTGAGGCGAGTAGATCACCTGAGGTCAGGAGTTAGAGACCAGCCTGGCCATCATGGTGAAACCCCGTCTCTACTAAAGATACCAAAAATTAGCTGAGTGTGGTGCTGGGTGCCTGTAATCCCAGAAACTCAGGGTGCCTGTAATCCCAGCAACTCAGGGTGCCTTTAATCCCAGCAACTGAGGGTACCAGTAATCCCAGCAACTCAGGGTGTCTTTAATCCTAGCAACTGAGGGCACCTGTAATCCCAGCAACTCAGGAAGCTGAGACAGGAGAAGTACTTGAACCCAGAAGGCAGAGGTTGCAGTGAGCCGATATTGCACCATTGCACTCCAGTCTGGGCAACAAGAGTGAAACTCTGTCTCAAAAAAAAA"
"chr19","13205284","13205895","JH378118","18053084","18053501","258","4847800","GCCAGGCGCAGTGGATTACGCCTGTAATCCCAGCGCTTTGGTATACCGAGGCGGGCAGATCGTCTGAGGTCAGGAGTTCAAGACCAGCCTGGAGAACATGGTGAAACCCCGTCTCTATTAAAAATACAGGCTGGGCGCGGTGGCTTACGCCTGTAATCTCAGCACTTTGGGAGGCCAAGGCGGGTGGATCACGAGGTCAGGAGATCGAGACCATCCTGGCTAACATGGTGAAACCCTGTCTCTACTGAAAATACAAAAAAATTAGTTGTGGTGGGTGCCTGTAATCCCAGCTACTCGGGAGGCTGAGGCAGGAGAATGGCGTGAACCCGGGAAGCAGAGATTGCAGTAAGCCAAGATCGCTCCACTGCACTCCAGCCTGGGCTACAGAGCAAGACTCCATCTCAAAAAAAAATAAATAAATAAAATAAAAAATTAGCCTGGCGTGGTGGCGCATGCCTGTAATCCCAGCTACTTGGGAGGCTGAGGCAGGAGAATTGCTTGAACCCAAGAGGTGGAGGTTGCAGTGAGTCGAGATTGAGCCATTGCCATCCAGCCTGGGCAACAAGAGTGAAACTCTGTCTCAAAAAAAAAGAGAGAGAAAAGAAAGTAAAA","GGCTGGGCGCAGTGGCTCACACCTGTAATCCCAGCACTTAGGGAAGCTGAGGCGAGTAGATCACCTGAGGTCAGGAGTTAGAGACCAGCCTGGCCATCATGGTGAAACCCCGTCTCTACTAAAGATACCAAAAATTAGCTGAGTGTGGTGCTGGGTGCCTGTAATCCCAGAAACTCAGGGTGCCTGTAATCCCAGCAACTCAGGGTGCCTTTAATCCCAGCAACTGAGGGTACCAGTAATCCCAGCAACTCAGGGTGTCTTTAATCCTAGCAACTGAGGGCACCTGTAATCCCAGCAACTCAGGAAGCTGAGACAGGAGAAGTACTTGAACCCAGAAGGCAGAGGTTGCAGTGAGCCGATATTGCACCATTGCACTCCAGTCTGGGCAACAAGAGTGAAACTCTGTCTCAAAAAAAAA"
"chr19","14119695","14120238","JH378206","6546474","6546861","206","7573221","ACCAGCCTGGCCAAAATGGTGAAACCCTGTCTCTACTAAAAATATTTAAAAATTGGCCAGGTGCGGTGGCTCACGCCTGTAATCCCAGCACTTTGGGAGGCCGAGGCGGGCGGATTACAAGGTCAGGAGATCGAGACCATCCTGACTAACATGGTGAAACCCCGTCTCTACTAAAAATACAAAAAATTGGCCGGGCGTGGTAGCGGGCGCCTGTAGTTCCAGCTACTCGGGAGGCTGAGGCAGGAGAATGGCGTGAACCCGGAAGGCAGAGCTTGCAGTGAGCCAAGATCGTGCCACTGCACTCCAGCCTGAGCGACAGAGCAAGACTCCATCTCAAAAAAAAAAAAAAAAAAAAAAAAAATTAAAAAATTAGCTGGGCGTGGTAGCCGGCACCTGTAATTCCAGCTACTCAGGAGGCTGGAGCACAAGAATCGCTTGAAACCAGGAGGCAGAGTTGTAGTGAGCCGAGATCGTGCCATTGCACTCCAGCCTGGGCATCAAGAGCGAAACTCCATCTCAAAAACAAAACAAAACAAAACAAAAA","GGCCACACATGGTGGCTAACGCCTGTAATCCCAGCACTTTGGGAGGCCAAGTCGGGTGGATCATGAGGTCAGGAGACCAAGACCATCCTGGCCAAATGGTGAAACCCCGTCTCTACTAAAAATACAAAAATTAGCTGGGCATGGTGGCGTGTGCCTGTAATCCCAGCTACTCAGGAGGCTGAGGCAGGACAATTGCCTGAACCCAGGAGAATTAGCTGGGCATGGTGGCGTGTGCCTGTAATCCCAGCTACTCAGGAGGCTGAGGCAGGACAATTGCCTGAACCCAGGAGGCGAAGGTTGCGGTGAGCCGAGATTGTGCCATTGCACTCCAGCCTGGGTAACAAGAGCGACACTCTGTCTCAAAAAAAAAAAAAAAAAAAAAAAAAAA"
"chr14","584088","584429","JH378109","21565230","21565567","54","20981142","GGCCGGGTACGGTGGCTCACGCCTGTAGTCCTGGCACTTTGGGAGGCCGAGGCAGGTGGATCCCCGAGGTCACGAGTTTGAGACCAGCCTGGCCAGCATGGTGAAATCCCATCTCTACTAAAAATACAAAACTTAGCCGGGCATGGTGACGTGTGCCTGTAATCCCAGCTACTTGGGAGGCTGAGGCAGGAGAATTGCTTGAACCAGGGAGGCAGAGGTTGCAGTGAGCTGAGATCATGAAACTGCAGTCCAGTCTAGGCGACAAGAGCAAAACTCCGTCTCAAAAAAATAAATAAATAAATAAATAAATAAAAAATAAAACAAACAACAAAAAAAACAAAA","GGCCGGGCGCGGTGGCTCAAGCCTGTAATACCAGCACTTTGGGAGGCCGAGGCGGGTGGATCACGAGGTCAAGAGATCGAGACCATCCTGGTCAACATGGTGAAACCCCGTCTCTACTAAAAATACAAACAATTAGCTGGGCATGGTGGCGGGTGCCTGTAATCCCAGCTACTCCAGAGGCTGAGGCAGGAGAATTGCCTGAACCCAGGAGACGGAGGTTGCGGTGAGCCAAGATCGCGCCATTGCACTCCAGCCTGGGTGACAAGAGCGAAACTCCGTCTCAATAAATAAATAAATAAATAAATAAATAAAAATAAAATAAATAAATAAATAAATAA"
"chr14","620575","620915","JH378109","21565230","21565567","56","20944655","GGCCGGGTACGGTGGCTCACGCCTGTAGTCCTGGCACTTTGGGAGGCCGAGGCAGGTGGATCCCCGAGGTCACGAGTTTGAGACCAGCCTGGCCAGCATGGTGAAATCCCATCTCTACTAAAAATACAAAACTTAGCCGGGCATGGTGACGTGTGCCTGTAATCCAGCTAACTTGGGAGGCTGAGGCAGGAGAATTGCTTGAACCAGGGAGGCAGAGGTTGCAGTGAGCTGAGATCATGAAACTGCAGTCCAGTCTAGGCGACAAGAGCAAAACTCCGTCTCAAAAAATAAATAAATAAATAAATAAATAAAAAATAAAACAAACAACAAACAAAACAAAA","GGCCGGGCGCGGTGGCTCAAGCCTGTAATACCAGCACTTTGGGAGGCCGAGGCGGGTGGATCACGAGGTCAAGAGATCGAGACCATCCTGGTCAACATGGTGAAACCCCGTCTCTACTAAAAATACAAACAATTAGCTGGGCATGGTGGCGGGTGCCTGTAATCCCAGCTACTCCAGAGGCTGAGGCAGGAGAATTGCCTGAACCCAGGAGACGGAGGTTGCGGTGAGCCAAGATCGCGCCATTGCACTCCAGCCTGGGTGACAAGAGCGAAACTCCGTCTCAATAAATAAATAAATAAATAAATAAATAAAAATAAAATAAATAAATAAATAAATAA"
"chr14","1107083","1107723","JH378118","18053084","18053501","303","16946001","GGCGTGGTGGCTCACACCTGTAATCCCAGCACTTCAGGAGGCCAAGGCAGGTAGATTGCTTGATCACAGGAGTTCAAACCAGCCATGGGCAATGTCAGGCCTCTGAGCCCAAGCTTGCACGTATCCAGATGGCCTGAAGCAACTGAAGAATCACAAAAGAAGTGAAAACAGCCAGTTCCTTCCTTAACTGATGACATTACCTTGTGAAATTCCTTCTCCTGGCTCAGAAGCTCCCCTACTGAGCACCTTGTGACCCCTGCCCCTGCCAGCCAGAGAACAATCCCCTTTGACTGTAATTTTCCACTACCTACCCAAATCCTATAAAACAGCCCCACCCCATCTCCCTTTGCTGACTCCTTTTTCGGACTAGGTCCGCCTGCACCCAGGTGATTAAAAAGCTTTATTGCTCACACAAAGCCTGTTGGTGGTCTCTTCACACGGACGCACGTGACAGGCAACATGGTGAAACCCTATCTCTATAAAAAAATAAAAATAAAAATTAGTTGGGCGTGGAGACTGAGGTGAGAGAATCCAGAGGATCCAAGAGGATCGAGTCAAGGAGGTGGAGGCCGCAGTGAGCCGAGATCGCACCGCTGCACTCCAGCCTGGGCGACAAGAGTGAAACTCTGTCTTAAAAAAAA","GGCTGGGCGCAGTGGCTCACACCTGTAATCCCAGCACTTAGGGAAGCTGAGGCGAGTAGATCACCTGAGGTCAGGAGTTAGAGACCAGCCTGGCCATCATGGTGAAACCCCGTCTCTACTAAAGATACCAAAAATTAGCTGAGTGTGGTGCTGGGTGCCTGTAATCCCAGAAACTCAGGGTGCCTGTAATCCCAGCAACTCAGGGTGCCTTTAATCCCAGCAACTGAGGGTACCAGTAATCCCAGCAACTCAGGGTGTCTTTAATCCTAGCAACTGAGGGCACCTGTAATCCCAGCAACTCAGGAAGCTGAGACAGGAGAAGTACTTGAACCCAGAAGGCAGAGGTTGCAGTGAGCCGATATTGCACCATTGCACTCCAGTCTGGGCAACAAGAGTGAAACTCTGTCTCAAAAAAAAA"
"chr14","1362660","1363231","JH378118","18053084","18053501","229","16690424","GGCTGGGCACAGTGGCTTATACCCATAATCTCAGCAGTTTGGGAGGCCAAGGCAGGTGTATCACCTGAGGTCAGGAGTTCGAGAAACACCATGGCCAACATGGTGAAACCCCATCTCTACTAAAAATACAAAAAGTAGGCTGGGCGTGGTGGCTCACGCCTGTAATCCCAGTACTTTGGGAGGCCGAGGCGGGCGGATCACAAGGTCAGGAAACCGAGACCATCCTGACTAACATGGTGAAACCCCGTCTCTACTAAAAATACAAAAAAAGCTAGCCGGGCATGGTGGCGGGTGCCTGTAGTCCCAGCTACTCGGGAGGCTGAGGCAGGAGAATGGCGTGACCCCAGGAGGCAGAGCTTCCAGCTTGGGTGACTCCGTCTCAAAAAAAAAAAAACAAAAACAAAAAGTAGCTGGACGTGGTGGCTGTAGACCTAGCTACTCGAGAGGCTGAGGCAGGAGAATCGCTTGAACCTAGGAGGCGGAGGTTGCGGTGAGCCGAGATCACGCTTCTGCACTCCAGCCTGGGTGACAAGAGCAAAACTCCATCTCCAAAAAAAAAAAACAAAAAAAAA","GGCTGGGCGCAGTGGCTCACACCTGTAATCCCAGCACTTAGGGAAGCTGAGGCGAGTAGATCACCTGAGGTCAGGAGTTAGAGACCAGCCTGGCCATCATGGTGAAACCCCGTCTCTACTAAAGATACCAAAAATTAGCTGAGTGTGGTGCTGGGTGCCTGTAATCCCAGAAACTCAGGGTGCCTGTAATCCCAGCAACTCAGGGTGCCTTTAATCCCAGCAACTGAGGGTACCAGTAATCCCAGCAACTCAGGGTGTCTTTAATCCTAGCAACTGAGGGCACCTGTAATCCCAGCAACTCAGGAAGCTGAGACAGGAGAAGTACTTGAACCCAGAAGGCAGAGGTTGCAGTGAGCCGATATTGCACCATTGCACTCCAGTCTGGGCAACAAGAGTGAAACTCTGTCTCAAAAAAAAA"
"chr14","2088506","2089110","JH378118","18053084","18053501","257","15964578","GGCTGGGCACTGCGGCTCACACCTGTAATCCCAGCATTTTGAGAGGCCTAGGTGGGTGGATCACCTGAGATCAGTTCAAGACCAGCCTGACCAACATGGCAAAACCCCATCTCTATTAAAAACACAAAAAACGCCCAGGAGCGGTGGCTCACACCTGTAATCCCGGCACTTTGGGAGGCTGAGGCAGGCGGATCACGAGGTCAGGAGATCGAGACCATGCTGGCTAACACGGTGAAACCCCGTCTCTACTAAAAATACAAAAAATTAGCCAGGCGTGGTGTCGGGCGCCTGTAGTCCCAGCTATTCGGGAGGCTGAGACAGGAGAATGGCATGAACCCGGGAGGCAGAGCTTGCAGTGAGCTGAGATCGCGCCACTGCACTCCAGCCTGGGCGACAGAGTAAGACTCTGTCTCAAAAAAAAAAATACAAAAAATACAAAAAACATTAGCCACATGTGGTGGTGGGTGCCTGTAATCCCAGCTACTCAGGAGGCTGAGGCTGGAGAATTGCTTGAACCCAGGAGGTGGAGGTTGTGGTGAGCCAAGATCACGCCATTGCATTCCAGCCTGGGTGACAAGAGTGAACCTCTGTCTCAAAAAAAAGAA","GGCTGGGCGCAGTGGCTCACACCTGTAATCCCAGCACTTAGGGAAGCTGAGGCGAGTAGATCACCTGAGGTCAGGAGTTAGAGACCAGCCTGGCCATCATGGTGAAACCCCGTCTCTACTAAAGATACCAAAAATTAGCTGAGTGTGGTGCTGGGTGCCTGTAATCCCAGAAACTCAGGGTGCCTGTAATCCCAGCAACTCAGGGTGCCTTTAATCCCAGCAACTGAGGGTACCAGTAATCCCAGCAACTCAGGGTGTCTTTAATCCTAGCAACTGAGGGCACCTGTAATCCCAGCAACTCAGGAAGCTGAGACAGGAGAAGTACTTGAACCCAGAAGGCAGAGGTTGCAGTGAGCCGATATTGCACCATTGCACTCCAGTCTGGGCAACAAGAGTGAAACTCTGTCTCAAAAAAAAA"
"chr14","2164771","2165383","JH378118","18053084","18053501","243","15888313","GGCTGGGCGCAGTGGCTCACACCTGTAATCCCAGCACTCTGGGAGGCCAAGGCAGGTGGATCACCTGAGGTCAGGAGTTCGAGACCAGCCTGGCCAACATGGTGAAACCCCATCTTTACTAAAAATACAAAAATTAGCTAGGCGTGAGGCCGGGCGTGGCGGCTCATGCCTGTAATCCCAGCACTATGGGAGGCTGAGGCAGGCTGATCATGAGGTCAGGAGATTGAGACCTGGCTAACACAGTGAAACCCCGTCTCTACTAAAAATACAAAAAAAAAATAGCCAGGCATGATGGCAGGCTCCTGTAGTCCCAGCTTCTTGGGAGGCTGAGGCAGGAGAATGGTGTGAACCCGGGAGGCAGAGCTTGCAGTGAGCCGAGATCATGCCACTGCACTCCAGCCTGGGTGACAGAGCAAGACTCTGTCTCAAAAAAAAAAAAAAAAAATTAGCTAGGCGTGGTGAGGGGCACCTGGAATCCCAGCTACTCAGGAGGCTGAGGCAGGAGCATCGTTTAAACCCAGGAGGCAGAGGTTGCAGTGAGCCGAAATCACACCATTGCACTCCAGCCTGGGCAACAAGAGCAAGTCTCCATCTTAAAAAAAAAAAAAAAAAA","GGCTGGGCGCAGTGGCTCACACCTGTAATCCCAGCACTTAGGGAAGCTGAGGCGAGTAGATCACCTGAGGTCAGGAGTTAGAGACCAGCCTGGCCATCATGGTGAAACCCCGTCTCTACTAAAGATACCAAAAATTAGCTGAGTGTGGTGCTGGGTGCCTGTAATCCCAGAAACTCAGGGTGCCTGTAATCCCAGCAACTCAGGGTGCCTTTAATCCCAGCAACTGAGGGTACCAGTAATCCCAGCAACTCAGGGTGTCTTTAATCCTAGCAACTGAGGGCACCTGTAATCCCAGCAACTCAGGAAGCTGAGACAGGAGAAGTACTTGAACCCAGAAGGCAGAGGTTGCAGTGAGCCGATATTGCACCATTGCACTCCAGTCTGGGCAACAAGAGTGAAACTCTGTCTCAAAAAAAAA"
"chr14","3757666","3758004","JH378113","23438980","23439304","67","19681314","CTGGGCATGGTGGCTCATGCCTGTAATCCCAGCACTTTGGGAGACAGAGGAGGGCAGATCATCTGAGGTCAGGAGTTTGAGACCAGCCTGGCCACCATGGTGAAACCCCCGTCTCTACTGAAAATACAAAAAAATTCAGCTGGGTGTGGTAGTGGATGTCTGTAATCCTAGCTGCTTGGGAGGCTGAGACAGGAGAATCGCTTGAACCCGGGAGGTGGAGGTTGCAGTGAGCCGCCATTGCGCTCCAGCCTGGGCAACAAGAGCGAAACTCCATCTCAAAAATTAATTAATTAATTAATTAATTAAAAGTGGACTAAAGCAAAGACAAGAGAAAAAAGA","GGCAGGGTGTGGTAGCTCATGCTTGTAATCCCAGCACTTTGGGAAGTGGAGGCGGGCAGATCATCTGAGGTCAGGAGTTTGAGGCCAGCCTGGCCAACATGGTGAAACCCTGTCTCTACTAAAAATACAAAAAATTAACTGGGCGTGGTGGTGGACACCTGTAATCCCAGCTGCTTGGGAGGCTGAGGCAGGAGAATCGCTTGAACCCAGGAGATGGAGGTTGCAGTGAGCCAAGATGGCACCATTGCACTCTAGCCTGGGCAAAAAGAGTGAAACTCCGTCTCAAAAAAAAAAAAGAAAAGAAAAGAAAAGAAAAGAAAAGAAA"
"chr14","10702105","10702681","JH378118","18053084","18053501","246","7350979","GGCCAGGCGCAATGGCTCACACCTGTAATCCAAGCACTTTGGGAGGCCAGTTCAAGACCAGCCTGGCCAACATGGTGAAAACCTGTCTCTGCTAAAAATGCCAAATTTCCCAGCACTTTGGGAGGCTGAGGCGGGTGGATCACGAGGTCAGGAGATTGAGACCATCCCGGCTAACACGGTGAAACCCCATCTCTACTAAAAATAGAAAAAAATTAGCCGGGCGTGGTGGCAGACGCCTGTAGTCCCAGCTACTCTGGAGGCTGAGGGAAGAGAATGGCATAAACCCGGGAGGCGGAGCTTGCAGCGAGCTGAGATTGCGCCACTGCACTCCAGCCTGGGCGACAGAGCAAGACTCCGTCTCAAAATAAATAAATAAATAAAATTAAAATTAAAAATAAAATACAAAATTTAGCCGAGCATGGTGGTGAGCACCTATAATCCCAGCTACTTGGGAGGCTGAGGCAGAAGAATCTCTTGAACCAGGGAAGTGGAGGTTGCAGTGGGCTGAGATCCAGCCACTGTACTCCAGCCTGGGCGACAAAAGCGAAACACTGTCTAAAAAAATAAAAAATAAAAA","GGCTGGGCGCAGTGGCTCACACCTGTAATCCCAGCACTTAGGGAAGCTGAGGCGAGTAGATCACCTGAGGTCAGGAGTTAGAGACCAGCCTGGCCATCATGGTGAAACCCCGTCTCTACTAAAGATACCAAAAATTAGCTGAGTGTGGTGCTGGGTGCCTGTAATCCCAGAAACTCAGGGTGCCTGTAATCCCAGCAACTCAGGGTGCCTTTAATCCCAGCAACTGAGGGTACCAGTAATCCCAGCAACTCAGGGTGTCTTTAATCCTAGCAACTGAGGGCACCTGTAATCCCAGCAACTCAGGAAGCTGAGACAGGAGAAGTACTTGAACCCAGAAGGCAGAGGTTGCAGTGAGCCGATATTGCACCATTGCACTCCAGTCTGGGCAACAAGAGTGAAACTCTGTCTCAAAAAAAAA"
"chr14","11790883","11791455","JH378118","18053084","18053501","226","6262201","GGCTGGGTGGCCATGGCTCATGCCTGTAATCCTAGAACTTTGGGAGGCTGCGGCAGGCAAATCACCTGAAGTCAGGAGTTCAAGACCAGCCTGGCCAACATACTGAAACCCCGTCTCTCCAGGCCTGGTGGCTCATGCCTGTAATCCCAGCACTTTGGAAAGCCGAGGTGGGCGGATCACCTGAGGTCAGGAGTTCAAGACCAGTCTGACCAACATGGGGAAACCCCATCTCTACTAAAAATACAAAATTAGCTGGATGTGGTGGCACATGCCTGTATTCCCAGCTACTTGGGAGGCTGAGGCAGGAGAATCGCTTGATCCCGAGAGGTGGAGCTTGCCGTGAGCTGAGATTGTGCGCCATTGCACTCCAGCCTGGGCAACAAGAGTGAAACTCCGTCTCTACTAAAAATACAAAAATTAGCCGGGTGTGGTGGCGGGTGCCTGTAATCCAAGCTACTCGGGAGGCTAAGGCAGGAGAATTGCTTGAACCCACGAGGCCGAGGTTGCAGTGAGCCGAGATTGCACTATTGCACTCCAGCCTGGGCGACAAGAGTGAGACTGTGTCTCAAAAAA","GGCTGGGCGCAGTGGCTCACACCTGTAATCCCAGCACTTAGGGAAGCTGAGGCGAGTAGATCACCTGAGGTCAGGAGTTAGAGACCAGCCTGGCCATCATGGTGAAACCCCGTCTCTACTAAAGATACCAAAAATTAGCTGAGTGTGGTGCTGGGTGCCTGTAATCCCAGAAACTCAGGGTGCCTGTAATCCCAGCAACTCAGGGTGCCTTTAATCCCAGCAACTGAGGGTACCAGTAATCCCAGCAACTCAGGGTGTCTTTAATCCTAGCAACTGAGGGCACCTGTAATCCCAGCAACTCAGGAAGCTGAGACAGGAGAAGTACTTGAACCCAGAAGGCAGAGGTTGCAGTGAGCCGATATTGCACCATTGCACTCCAGTCTGGGCAACAAGAGTGAAACTCTGTCTCAAAAAAAAA"
"chr14","12236526","12237360","JH378118","18053084","18053501","465","5816558","GGCTGGGTGGGGTGGCTCACGCGTGTAATCCCAACACTTTTGAGGCTGAGGTGGGTGGATCACTTGAGGTCCGGAGTTTGAGACCAGCCTGGTCAACATGGTGAAACCCCATGTCTCAGGATGGGGAACATCACATACCGGGGCCTGTCGTGGGGTGTGGGGAGGGGAAGGGATAGCATTAGGAGATATACCTAATGTAAATGACAAGTTAATGGGTGCAGCACACCAACATGGCACATGTATACATATGTAACAAACCTGCATGTTGTGCACATGTACCCTAGAACTTAAAGTATAGCAATAAAAAAAAAAAAAGAAACCCCGTGTCTACAAAAAAAATACAAAATTAGGCCAGGCGCAGTGGCACATACCTGTAATCCCAGCACTTTGGGAGGCCAAGGTGGGCAGATCACGAGGTCAGGAGTTTGAGACCAGCCTGTCCAAAATGGTGAAACCCCATCTCTACTAAAAAAATACAAAAATTAGCCAGGCATGGTGGCCCGTGCCTGCAATCCCAGCTACTCAGGAGGCTAAGGCAGGAGAATCACTTGAACGTGGGAGGCGGAGGTTGCAGTGAGCCGAGATCACACCATTGCACTCCAGCCTAGGCAACAGAGCGAGACTCTGTCTCAAAAAAACAAAAAGCAAAAAAACCCAAATTAGCCAGGCATGGTGGTAGTCACCTGTAATCCCAGCTACTTGGGAGGCTTAGGCAGGAGAATCGCTTGAACCCCAGAGGCAGAGGTTGCAGTAAGCCAAGATCGCACCAAGATCACTCCAGCCTGGGCGACAGTGAAACTGTGTCTCAAAAGAAAAAGAAAAAAAAGAAAGAAAA","GGCTGGGCGCAGTGGCTCACACCTGTAATCCCAGCACTTAGGGAAGCTGAGGCGAGTAGATCACCTGAGGTCAGGAGTTAGAGACCAGCCTGGCCATCATGGTGAAACCCCGTCTCTACTAAAGATACCAAAAATTAGCTGAGTGTGGTGCTGGGTGCCTGTAATCCCAGAAACTCAGGGTGCCTGTAATCCCAGCAACTCAGGGTGCCTTTAATCCCAGCAACTGAGGGTACCAGTAATCCCAGCAACTCAGGGTGTCTTTAATCCTAGCAACTGAGGGCACCTGTAATCCCAGCAACTCAGGAAGCTGAGACAGGAGAAGTACTTGAACCCAGAAGGCAGAGGTTGCAGTGAGCCGATATTGCACCATTGCACTCCAGTCTGGGCAACAAGAGTGAAACTCTGTCTCAAAAAAAAA"
"chr14","12551961","12552292","JH378124","27069096","27069413","54","14517135","GGCCAGGCGCGGTGGCTCACGCCTGTAATCCCAGCACTCTGGGAGGCCAAGGCGGACGGATCATCCGAGGTCAGGAGTTTGAGACCAGCCTGGCCAACATGGTGAAACCCCATCTCTACTAAAAATATATATATATATGTATATATATATATATATTAGCCAGGTGTAGTGGTGGGCATCTGTAATCCCAGCTACTCGGGAGGCTGAGGCAGGAGAATTGCTTGAACCCAGGAGGCGGAGGTTGCAGTGAGCTGAGATTGCACCACTGCACTCCAGCCTGGGTGATAAGAATGAGACTCCATCTCAAAACAAACAAACAAACAAATAAAAAA","GGCCGGGCACGGTGGCTCATGCCTGTAATCCCAGCACTTTGGGAGGCCGAGGCGGGTGGATCATGAGGTCAAGAGATCGAGACCATCCTAGTCAACATGGTGAAACTCCATCTCTACTAAAAATACAAAAAAAAAAAAAAATTAGCTGAGCATGGTGGTGCATGCTTGTAATTCCAGCTACTCAGGAGGCTGAGGCAGGAGAATTGCCTGAACCCAGGAGGCGGAGGTTGCAGTGAGCCGAGATTGCGCCATTGCACTCCAGCCTGGGTAATAAGAGTGAAACTCCGTCTCAAAAAAAAAAAACAAAAAAACAAAAAA"
"chr14","15131045","15131391","JH378121","20921542","20921875","62","5790497","GGCTGGGCCCGGTGACTCATGCCTGTAATCCCAGCACTTCGGGAGGACAAGGCGGGTGGATCACCTGAGGTCAGGAGTTCGAGACCAGCCTGGCCAACATGGCGAAACCCCGTCTCTACTGAAAATACAAAAATTAGCCAGGCATGGTGGTGGGCGCCTGTAATCCCAGCTACTCAGAGGCTGAGACAGGAGAATCACTTGAACCTGGGGTGGGGGCGGGGGCGGGGGCGGGGGCGGGGTGGGAGTGGAGGTTGCAGACAGTGAGTGGTGATGGCGCCAGTTCACTCCAGCCTGGGCGAAAGAGTGAAACTCCATCTCAGAAAAAAAAAAAAAAAAAAAAAGTAAAA","GGCTGGGTACGGTGGCTCATGCTGTAATCCCAGCACTTTGGGAGGTCAAAGCAGGCGGATCACCTGAGGTCAGGAGTTTGAGACCAGCCTTGCTAACATGGTGAAACCCCGTTTCTACTAAAAATAAAAAAATTAGCCAGGCGTGGTGGTGTGCACCTGTAATCCCAGCTACTTGGGAGGCTGAAGCAGGAGAGTTGCTTGAACCGGGGTGGTGGGGGGGCAGGGGCAGGGGTGGGTGGCAGGCAGAGGTTGCAGTGAGCCGAGATGGTGCCATTGCACTCCAGCCTGGGCAACAAGAGCAAAACTCCGTCTCAAAAAGAAAAAAAAAAAAGAA"
"chr14","15292066","15292693","JH378118","18053084","18053501","267","2761018","GGCCGGAGACGGTGGCTCACACCTGTAATCCCAGCACTTTGGGAGGCTGAGGCAGGCAGATCACCTGAAGTCAGGAGTTTGAGACCAGCCTGGCCAACATGGTATAAACCCCATCTCTACTAAAAATACAAAAATTAGGCTGGGCGCGGTGGCTCACGCCTGTAATCCCAACACTTTGGGAGGCCGAGGTGGGTGGATCACCTGAGGTCGGGAGTTTGAGACCAGCCTGACCAACATGAAGAAACCCTGTCTCTACTAAAAAAAAAAAAAAATACAAAATTAGCCGGGCATCATGGCACAAGCCTGTAATCCCAGCTACTCAGGAGTCTGAGGCAGGAGAATCGCTTGAACCTGGGAGGCGAAGGTTGCAGTGAGCTGAGATCGTGCCATTGCACTCCAGCCTGGGCAACAAGAGCGAAACTCCTTCTCTAAATAAATAAATAAAAATACAAAAATTTAGCCGGGCATGGTGGCGGGCACCTGTAATCCTAGCTACTTGAGAGGCTGAGGCAGGAGAATCGCTTGAACCCGGGAGGCGGAGGTTGCAGTAAGCAGAGATTGTGCCATTGCACTCCATCCTGGGCAACAAGAGTGAAACTCCATCTCAAAAAAAAAAAAAAAAAAAAAA","GGCTGGGCGCAGTGGCTCACACCTGTAATCCCAGCACTTAGGGAAGCTGAGGCGAGTAGATCACCTGAGGTCAGGAGTTAGAGACCAGCCTGGCCATCATGGTGAAACCCCGTCTCTACTAAAGATACCAAAAATTAGCTGAGTGTGGTGCTGGGTGCCTGTAATCCCAGAAACTCAGGGTGCCTGTAATCCCAGCAACTCAGGGTGCCTTTAATCCCAGCAACTGAGGGTACCAGTAATCCCAGCAACTCAGGGTGTCTTTAATCCTAGCAACTGAGGGCACCTGTAATCCCAGCAACTCAGGAAGCTGAGACAGGAGAAGTACTTGAACCCAGAAGGCAGAGGTTGCAGTGAGCCGATATTGCACCATTGCACTCCAGTCTGGGCAACAAGAGTGAAACTCTGTCTCAAAAAAAAA"
"chr14","15354689","15355313","JH378118","18053084","18053501","269","2698395","GGACGGGCGCAGTAGCTCACACCTGTAATCCTAGCAGTTTGGGAGGCCAAGGTGGGTGGATCACCTGACGTCAGGAGATCGAGACCAGCCTGGACAACATGGCGAAACCCTGTCTCTACTAAAAATACAAAATTAGGGCCAGGTGCGGTGGCTCACGCCTGTAATCCCAGCACTTTGGGAGACTGAGGCGGGCAGATCACCTGAGGTCAGGAGTTCGAGACCAGCCTGGCCAACATGGTGAAACCGCCTCTCTACTAAAAATATAAAAATTGGCTGGGCATTGTAGCAGCCACCTGTAATCCCAGCTACTTGGGGGCCCGAGGCAGAAAAACTGCTTGAACCCAGGAGGCAGAGGTTGTAGTGAGCCGAAATCATGCCACTGCACTCCAGCCTGGGTGACGAGAGTGAGACTCCGTTTCAAAGAAAAAGAAAAAAAATAAAATAAAACACAAAATTAGCCAGTCATGGTGGCAGGCACCTATAATCCCAGCTACCTGGGAGGCTAAGGCAGGAGAATCACTTGAACCCAGGAGGTAGAGGGTGTGGTGAGCCGAGATCACGCCATTGCACTCTAGCCTGGGCAACAAGAGCAAAACTCTGTCTCAAAACAAAAAGTTAAAAAAAA","GGCTGGGCGCAGTGGCTCACACCTGTAATCCCAGCACTTAGGGAAGCTGAGGCGAGTAGATCACCTGAGGTCAGGAGTTAGAGACCAGCCTGGCCATCATGGTGAAACCCCGTCTCTACTAAAGATACCAAAAATTAGCTGAGTGTGGTGCTGGGTGCCTGTAATCCCAGAAACTCAGGGTGCCTGTAATCCCAGCAACTCAGGGTGCCTTTAATCCCAGCAACTGAGGGTACCAGTAATCCCAGCAACTCAGGGTGTCTTTAATCCTAGCAACTGAGGGCACCTGTAATCCCAGCAACTCAGGAAGCTGAGACAGGAGAAGTACTTGAACCCAGAAGGCAGAGGTTGCAGTGAGCCGATATTGCACCATTGCACTCCAGTCTGGGCAACAAGAGTGAAACTCTGTCTCAAAAAAAAA"
"chr14","15366797","15367405","JH378129","11955248","11955630","263","3411549","GGTTGGGTGCGGTGGCTTACCCCTGTAATCCCAGCACTTTGGGGGTACAAAGTGGGAAGATTGCTTGAGCCCAGGAGTTCAAGACCAGCCTGGGCAACTAAGCGAGATCCTATCTCTCAAAAAAATTTTGAAACAACTTTTTGGCCGGGCGCAGTGGCTCACGCCTGTGATCCCAGCACTTTGGGAGGCCAGGGCGGGCGGATCACGAGGTCAGGAGATCAAGACCATCCTGGCTAACACGGTGAAACCCCGTCTCTACTAAAAATACAAAAAATTAGCCGGGTGCGGTGGCGGGCACCTGTAGTCCCAGCTACTCGGGAGGCTGAGGCAGGAGGATGGCGTGAACCCGGGAGGTGGAGCTTGCAGTGAGCTGAGATCGGGCCACTGCACTCCAACCTGGACGACAGATCGAGACTCCGGCTCAAAAAAAAAAAATTAGCTGGGCGTGGTGGCGGGTGCGTGTAATCCCAGCTACTCGGGAGGCTGAGGCAGGAGAATCACTTGAACCTGGGAGGCAGAGGCTGCAGTGAGCCAAGATCGCGCCATTGCACTCCAGCCTGGGCAACAAGAGCGAAACTCTGTCTCTAAATAATAAAATAAAATAAAAAA","GGCTGGGTACGGTGGCTCATGCCTGTAATCCCAGCACTTTGGGAGGTGGGTCACTTGAGGTCAGGAGTTCGAGACCAGCCTGTGCAGTGCCTCCATCCTCAACTGCTGCCTCATCAGCCTGGACCACTACCTGCTCATCCTCTCACCACTGCCACAAGCTGCGCATGAAGCTCCTGCGCGCGCCGGTGCCCGTCTCTACTAAAAATACAAAAATTAGCTGGGTGTGGTGGCAGGTGCCTGTAATCCCAGCTACTCAGGAGGCTGAGGCAGGAGAATCACTTGAACCCAGGAGGCAGAGGTTGCAGTGAGCCGATATCGCATCATTGCACTCCAGCCTGAGCAACAAGAGTGAAATTTTGTCTCAAAAAAAAAAAAAAAAGAAA"
"chr14","15379094","15379705","JH378129","11955248","11955630","265","3423846","GGTTGGGTGCGGTGGCTTACCCCTGTAATCCCAGCACTTTGGGGGTACAAAGTGGGAAGATTGCTTGAGCCCAGGAGTTCAAGACCAGCCTGGGCAACTAAGCGAGATCCTATCTCTCAAAAAAATTTTGAAACAACTTTTTGGCCGGGCGCAGTGGCTCACGCCTGTGATCCCAGCACTTTGGGAGGCCAGGGCGGGCGGATCACGAGGTCAGGAGATCAAGACCATCCTGGCTAACACGGTGAAACCCCGTCTCTACTAAAAATACAAAAAATTAGCCGGGTGCGGTGGCGGGCACCTGTAGTCCCAGCTACTCGGGAGGCTGAGGCAGGAGGATGGCGTGAACCCGGGAGGTGGAGCTTGCAGTGAGCTGAGATCGGGCCACTGCACTCCAACCTGGACGACAGATCGAGACTCCGGCTCAAAAAAAAAAAAAATTAGCTGGGCGTGGTGGCGGGTGCGTGTAATCCCAGCTACTCGGGAGGCTGAGGCAGGAGAATCACTTGAACCTGGGAGGCAGAGGCTGCAGTGAGCCAAGATCGCGCCATTGCACTCCAGCCTGGGCAACAAGAGCGAAACTCTGTCTCTAAATAAATAAAATAAAATAAAAAA","GGCTGGGTACGGTGGCTCATGCCTGTAATCCCAGCACTTTGGGAGGTGGGTCACTTGAGGTCAGGAGTTCGAGACCAGCCTGTGCAGTGCCTCCATCCTCAACTGCTGCCTCATCAGCCTGGACCACTACCTGCTCATCCTCTCACCACTGCCACAAGCTGCGCATGAAGCTCCTGCGCGCGCCGGTGCCCGTCTCTACTAAAAATACAAAAATTAGCTGGGTGTGGTGGCAGGTGCCTGTAATCCCAGCTACTCAGGAGGCTGAGGCAGGAGAATCACTTGAACCCAGGAGGCAGAGGTTGCAGTGAGCCGATATCGCATCATTGCACTCCAGCCTGAGCAACAAGAGTGAAATTTTGTCTCAAAAAAAAAAAAAAAAGAAA"
"chr14","15386894","15387394","JH378114","15957391","15957789","201","570497","GCTGAGTGCAGTGGCTCACGCCTGTAATCCACTTTAGCAGGCCAAAATAGGGGGATCACTTTGAGGCCACGAGTTTGAGACCTGCCTGGGCAACATAGTGAGGCCCCGTCTCTACAAAAATCTTTAAATATTAGAATAACTTTGGGAGGCCGAGGCGGGTGGATCACGAGGTCAAGAGATTGAGACCATCCTGGCCAACATGGTGAAATCCCATCCCTACTAAAGCTACAAAAATTAGCCAGGCGTGGTGGTGTGCGCCTGTAGTCCCAGCTACTCGGGAGACTGAGGCAGGAGAATTGCTTGAATCCGCGTGGCGGAGGTTGCAGTGAGCTGAGATCGCGCCACTGCACTCCAGCCTGGTGACAGAGCGAGACTCCGTCTTAAAAAAAAAAAAAAAAAAAAAAAAAAAAACTTCGGAGGTTGCGGTGAGCCAAGATCACGCCATTGTACTCCAGCCTGGGCCACAAGAGCAAAACTCCGCTTCAAAAAAAAAAAAAAAAA","GCAAGGAACGGTGGCTCATGCCTGTCATCCCAGCACTTTGGGAGGCTAAGGAGGGTGGATTACCGAAGGTCATGAGTTTGAGACCAGCCTGACCAACATGGTGAAAACCCCATCTCTACTAAAAATACAAAAAATTAGCCAGATACAGCTATGCGGCAGACTGGGGCAGGAGAATCGCTTGGACCCAAACCCCATCTCTACTAAAAATACAAAAAATTAGCCGGATACAGCTATGCGGGAGACTGGGGCAGGAGAATCGCTTGGACCCGGGAGGCAGAGATTGCAGTGAGATGAGACCATGCCATTGCTCTCTAGCTTGTGCGATGAGAACAAGACTCTGTCTCAAAAAAAAAAAAAAAAAAAAAAAAAAAAAAAAAAAAAAAAGAGAGAGAGAGAAAA"
"chr14","20140478","20141066","JH378118","18053084","18053501","250","2087394","GCCAGGCGAGGTGGCTCATGCCTGTAATCCCAGCACTTTGGGAGGCTGAGGTGGGTGGAACACTTGAGGTCAGGAGTTCAAGACCAGCCTGGCCAACATGATGAAACCCCCATCTCTACTAAAAACACAAAAATTAGCCAGGAGTGGGCAGGGTGCGGTGGCTCACGCCTGTAATCCCAGCACTTTGGGAGGCTGGGATGGGTGGATCATGAGGTCGGGAGTTCAAGACCAGCCTGGCCAAGATGGTGAAACCCTGTCTCTATTAAAACTTCAAAAATTAGCCAGGCACGGTGGCAGGTGCTTGTAATCCCAGCTACTTGGGAGGCTGAGGCAGGAGAATCACTTGAAACTGGGCGGCAGAGGTTGCAGTGAGCCAAGATCGCGCCACTGGACTCCAGACTGGGCGACACAGTGAGATACCGTCTCAAAAAAAAAAAAAAAAAAAATTAGCCAGGAGTGGTGGCGGAAATCCCAGCTACTTGAGAGGCTGAGGCAGGAGAATCGTTTGAACCCAGGAGGCAGAGGTTGCAGTGAGCCAAGATCTTGCCATTGCACTCCAGCTTGGGAGACAAGAGCAAAACTCTGTCTC","GGCTGGGCGCAGTGGCTCACACCTGTAATCCCAGCACTTAGGGAAGCTGAGGCGAGTAGATCACCTGAGGTCAGGAGTTAGAGACCAGCCTGGCCATCATGGTGAAACCCCGTCTCTACTAAAGATACCAAAAATTAGCTGAGTGTGGTGCTGGGTGCCTGTAATCCCAGAAACTCAGGGTGCCTGTAATCCCAGCAACTCAGGGTGCCTTTAATCCCAGCAACTGAGGGTACCAGTAATCCCAGCAACTCAGGGTGTCTTTAATCCTAGCAACTGAGGGCACCTGTAATCCCAGCAACTCAGGAAGCTGAGACAGGAGAAGTACTTGAACCCAGAAGGCAGAGGTTGCAGTGAGCCGATATTGCACCATTGCACTCCAGTCTGGGCAACAAGAGTGAAACTCTGTCTCAAAAAAAAA"
"chr14","32019134","32019479","JH378197","6655183","6655524","67","25363951","GGCTGGGGCAGTGGCTCACTGTAATTCCAGCACTTGGCCAAGGCAGGTGGATCACCTGAGGTCAGGAGTTCAAGACCAGCAGGGCCAACATGGTGAAACCCTATCTCTAAAAATAAATAAATAAATAAATAAATAAAATAAAATAAAATAAAATAAAAAATAAAAAAAATTAGCTGGGCGTTGTGGTGGGCGCCTGTAATCCCAGCTACTTGGGAGGCTGAGGCAGGAGGATCGCTTGAACCTGGAAGGCAGAGGTTGCAGTGAGCCGAAATCACATAATTGCACTCCAGCCTGGGCGACAAGAGCAAAACTCCATCTCAAAAAAAAAAAAAAAAAAAAAAAAAAA","GGCCGGGCGCAGTGGCTCATGCCTGTAATCCCAGCACTTTGGGAGGCAGAGGCGGGCAGATCACCCAAGGTCAGGAGTTCAAGACCAGCCTGGCTAACATGGTGAAACCCCATTTCTACTAAAAATACAAAAAAAAAAAAAAAAAAAAAAAAAAAAAAAAAAAAAAATTAGCTGAGCGAGGTGGTGGGCACATGTAATCCCAGCTACTTCGGAGACTAAGGCAGGACAATTGCTTAAGCCTGGGAGGCAGAGGTTGTAGTAAGCTGAGATCACACCATTGCACTCCAGCTTGAGCAACAAGAGCGAAACTCCGTCTCAAAAAAAAACCCAAAAAACAAAAAA"
"chr14","39734996","39735596","JH378118","18053084","18053501","237","21681912","GGCTGGGCGCGGTGGCTCATGCCTGTAATCCCAGCATTTTGGGAGGCCGAGGCGGGTGGATCACCTGAGGTCAGGAGTTTGAGACCAGCCTGGCCAACATGGTGAAACCCTGTCTCTACTAAAAATGCAAAAATTAGGCTGGTGCAGTGGCTCACGCCTGTAATCACAGCACTTTGGGAGGCCGAGGTGGGCGGATCACGAGGTCAGGAGATCGAGACCATCCTGGCTAATACAATGAAACCCCGTCTCTATGAAAAATACAAAAAATTAGCCGGGCGTAGTGGCAGGCGTCTGTAGTCCCAGCTACTCAGGAGGCTGAGGCAGGAGAATGGCATGAACCTGGGAGGCGGAGCTTGCAGTGAGCCGAGATTGCGCCACTGCACTCCAGCCTGGGCGACAGCGAGACTCTGTCTCAAAAAAAAAAAAAAAAATTAGCTAGGCATGGTGGCGCATGCCTGTAATCCCAGCTACTTGGGAGGCTGAGGCAGGAGAATCGCTTGAACCTGGGAGGCAGAGGCTGCAGTGAGACAAGATCACGCCATTGCACTCCAGCCTGGGCAACAAGAGTGAAACTCCATCTTCCCCCTACCAAAAAAAAAAA","GGCTGGGCGCAGTGGCTCACACCTGTAATCCCAGCACTTAGGGAAGCTGAGGCGAGTAGATCACCTGAGGTCAGGAGTTAGAGACCAGCCTGGCCATCATGGTGAAACCCCGTCTCTACTAAAGATACCAAAAATTAGCTGAGTGTGGTGCTGGGTGCCTGTAATCCCAGAAACTCAGGGTGCCTGTAATCCCAGCAACTCAGGGTGCCTTTAATCCCAGCAACTGAGGGTACCAGTAATCCCAGCAACTCAGGGTGTCTTTAATCCTAGCAACTGAGGGCACCTGTAATCCCAGCAACTCAGGAAGCTGAGACAGGAGAAGTACTTGAACCCAGAAGGCAGAGGTTGCAGTGAGCCGATATTGCACCATTGCACTCCAGTCTGGGCAACAAGAGTGAAACTCTGTCTCAAAAAAAAA"
"chr14","49081899","49082239","JH378114","14264965","14265292","65","34816934","GGCCAGGTACAGTGGCTCATGCCTGTAATCTCAGCATTTTGGGAGGCTGAGGCAGGCAGATCACCTGAGGTCAGGAGTTCGTGACCAGCCTGACCAGTGAAACCCTGTCTCTACTGAAAAAAATAAAATAAAATAAAATAAAAATAAAAATTAGCTGGGTGTGGTGGTGGGCGCCTGTAATCCCAGCTACTCGGCAGGCTGAGGCAGGAGAATTGCTTGTACCCGGGAGGCGGAGGTTGCAGTGAGCCAAGATCATGCCATTGCACTACAGCCTAGGTGACAAGAGCAAAACTCTGTCTCAAAACAAAACAACAACAACAACAACAACTAAAAAAAAAAAA","GGCCAGGCGCGGTGGCTCAAGCCTGTAATCCCAGCACTTTGGGAGGCCGAGGCGGGTGGATCATGAGGTCAAGAGATCGAGACCATCCTGGTCAACATGGTGAAACCCCGTCTCTACTAAAAACAGAAAAAAAATAAAAATAAAAATAATTAGCTGGGCATGGTGGAGCATGCCTGTAATCCCAGCTACTCAGGAGGCTGAGGCAGGAGAATTGCCTGAACCGAGGAGGCGGAGGTTGCGGGGAGCCAAGATCGCGCCATTGCACTCCAGCCTGGGCAACAAGAGCGAAACTCCGTCTCAAAAAAAAAAAAAAAAAAAAAAAAAAAAA"
"chr14","54833704","54834332","JH378118","18053084","18053501","272","36780620","GGCCAGGTGCAGTGGCTCACTCCTGTAATTCCAGCACTTTGGGAGGCTGCCGGTGGATCACCTGAGGTCAGGAGTTCGAGATCAGCCTGGCCAACATGGTGAAACCCCGTCTCTACTAATAATACAAAAATTAGCCAGGCAAGGCCGGGCGCAGTGGCTCACACCTGTAATCCCAGCACTTTGGGAGGCCGAGGCGGGCGGATCACCTGAGGTCGGGAGTTCAAGACCAGCCTGACCAACATGGAGAAACCCCATCTCTACTAAAAATACAAAATTAGCTGGGCATGGTGGCACATGCCTGTAATCCCAGCTACTAGGGAGGCTGAGGCAGGCGAATCGCTTGAACCTGGGAGGTGGAGGTTGCGGTGGGCCGAGATGGTGCCATTGCACTCTAGCCCGGGCAACAAGAGCGAAACTCTGTCTCAAAAAAAAAAAAAAAAAAAAAAAAATTAGCCAGGCATGGTAGCACACCCTTGTAATCCCAGCTACTCGGGAGGCTGAGGCAGGAGAGTTGCTTGAACCCGAGAGACGGAGGTTGCAGTGAGCTGAGATCGTGCCATTGCACTCCAACCTGGGTGACAAGAGTGAAACTCCATCTCCAAAAAAAAAAATAAATAAAATAAATAAAA","GGCTGGGCGCAGTGGCTCACACCTGTAATCCCAGCACTTAGGGAAGCTGAGGCGAGTAGATCACCTGAGGTCAGGAGTTAGAGACCAGCCTGGCCATCATGGTGAAACCCCGTCTCTACTAAAGATACCAAAAATTAGCTGAGTGTGGTGCTGGGTGCCTGTAATCCCAGAAACTCAGGGTGCCTGTAATCCCAGCAACTCAGGGTGCCTTTAATCCCAGCAACTGAGGGTACCAGTAATCCCAGCAACTCAGGGTGTCTTTAATCCTAGCAACTGAGGGCACCTGTAATCCCAGCAACTCAGGAAGCTGAGACAGGAGAAGTACTTGAACCCAGAAGGCAGAGGTTGCAGTGAGCCGATATTGCACCATTGCACTCCAGTCTGGGCAACAAGAGTGAAACTCTGTCTCAAAAAAAAA"
"chr14","55277737","55278067","JH378148","10302642","10302970","61","44975095","GGCCGGGTGCAGTGGCCCACCTCTGTAATCCTAACACTTTGGGAGGCCAAGGCAGGCAGGTCACTTGAGGTCAGGAGTTCAAGACTAACCTGGCCAACATGGTGAAACCCCGTCTCTACTAAAAATACGAAAATTAGCCGGGCTTCATGATGCATGCCTGTAATCCCAGCTACTAAGGAGGCTGAGGCAGAAGAATCTCTTGAACCCATGAGGTTGCAGTGAGCTGAGATCTCGCCATTGCACTCCAGCCTGGAGGACAAGAGCGAAACTCTGTCTCAAAAAAATAAAATAAAATAAATAAGAATAAAATAATAATAAAAGGCAAAAAGAA","GGCCGGGCGCGGTGGCTCAAGCCTGTAATCCCAGCACTTTGGGAGGCCGAGGCGGGTGGATCACGAGGTCAAGAGATCGAGACCATCCTGGTCAACATGGTGAAACCCCGTCTCTACTAAAAATACAAAAAATTAGCTGGGCATGGTGGTGGGTGCCTGTAATCCCAGCTACTCAGGAGGCTGAGGCAGGAGAATTGCCTGAACCCAGGAGGCGGAGGTTGCGGTGAGCCGAGATCGCGCCATTGCACTCCAGCCTGGGTAACAAGAGTGAAACTCTGCCTCAAAAAAAAAAAATAAAATAAAATAAAATAAAATAAAATAAAATAAAA"
"chr14","55822103","55822700","JH378118","18053084","18053501","240","37769019","GGCCAGGCGCAGTGGCTCACGCCTGTAATCCCAGCACTTTAGGAGGCCGAGGCAGGTGGATCGCCTGAGTTCAGGAGTTCAAACCCACCCTGGCCAACATGGTGAAACCCTGCCTCTACTAAAAAACAAAAAAATGGCCAAGCGTGGTGGCTCACGCCTGTAATTCCAGCACTTTGGGAGGCTGAGGCAGGCGAATCACGAGGTCAGGAGATCGAGACCATCCTGGCTAACATGGTGAAACCCCATCTCTATTAAAAATACAGAAAATTAGCCAGGCGTGGTGGTGGACGCCTGTAGTCCCAGCTTCTTGGGAGGCTGAGGCAGGAGAATGGCATGAACCCGGGAGGCAGAGCTTGCAGTGAGCTGAGATTGCGCCAGTGCACTACAGCCTGTGGGACAGAGCAACTCCGTCTCAAAAAAAAAAAAAATTAGCTGGGCATGGTGGCATATGCCTGTAATCCCAGCTACTAAGGAGGCTGAGGCGGGAGAATCGCTTGAACCCGGGAGGCAGAGGTTGCAGTGAGCCGAGATTGCGCCATTGCACTCCAGTCTGGACAACAAGAGTGAACTGTGTCTCAAAAAAAAAAAAAAAAAAAGA","GGCTGGGCGCAGTGGCTCACACCTGTAATCCCAGCACTTAGGGAAGCTGAGGCGAGTAGATCACCTGAGGTCAGGAGTTAGAGACCAGCCTGGCCATCATGGTGAAACCCCGTCTCTACTAAAGATACCAAAAATTAGCTGAGTGTGGTGCTGGGTGCCTGTAATCCCAGAAACTCAGGGTGCCTGTAATCCCAGCAACTCAGGGTGCCTTTAATCCCAGCAACTGAGGGTACCAGTAATCCCAGCAACTCAGGGTGTCTTTAATCCTAGCAACTGAGGGCACCTGTAATCCCAGCAACTCAGGAAGCTGAGACAGGAGAAGTACTTGAACCCAGAAGGCAGAGGTTGCAGTGAGCCGATATTGCACCATTGCACTCCAGTCTGGGCAACAAGAGTGAAACTCTGTCTCAAAAAAAAA"
"chr14","55860214","55860812","JH378118","18053084","18053501","246","37807130","GGCCGGATGCAGTGGCTCACGCCTGTAATCCCAGCACTTTGGGAGGCCAAGGCAAGCGGATCACCTGAGGTCAGGAGTTCAAGACCAGCCTGGCCAGCATGGTGAAACCCCTTCTCTACTAAAAATACAAAAATTAGCCGGGGCCTTGCGTGGTGGCTCACACCTGTAAATCCCAGCGCTTTGGGAGGCCGAGGCAGGCGGATCACCTGAGGTCGGGAGTTCAAGAACAGCCTGACCAACATGGAGAAACCCCGTCTCCACTAAAAATAGAAAAATAGCCGGGCATGGTGGCGCATGCTTGTAATCTCAGCTACTCGGGAGGCTGAGGCAGGAGATCACTTGAACCCAAGAGGCAGAGGTTGCGGTGAGCCGAGATCGCGCCATTGCACTCCAGCCTGGGCAACAAAGAGCGAAACTCCGTCTCCAAAAAAAAAAAAAAAAAATTAGCCGGGCGTGGTGGCACATACCTGTAATCCCAGCTATTCAGGAGGCTGAGGCAGGAGAATCCCTTGAACCCGGGAGGCAGAGATGGCAGTGAGCTGAGATCACGCCATTGCACTCCAGCCTGGGTGAGAGGAGTGAAACTCCGTCTAAAAAAA","GGCTGGGCGCAGTGGCTCACACCTGTAATCCCAGCACTTAGGGAAGCTGAGGCGAGTAGATCACCTGAGGTCAGGAGTTAGAGACCAGCCTGGCCATCATGGTGAAACCCCGTCTCTACTAAAGATACCAAAAATTAGCTGAGTGTGGTGCTGGGTGCCTGTAATCCCAGAAACTCAGGGTGCCTGTAATCCCAGCAACTCAGGGTGCCTTTAATCCCAGCAACTGAGGGTACCAGTAATCCCAGCAACTCAGGGTGTCTTTAATCCTAGCAACTGAGGGCACCTGTAATCCCAGCAACTCAGGAAGCTGAGACAGGAGAAGTACTTGAACCCAGAAGGCAGAGGTTGCAGTGAGCCGATATTGCACCATTGCACTCCAGTCTGGGCAACAAGAGTGAAACTCTGTCTCAAAAAAAAA"
"chr14","56736257","56736880","JH378206","6546474","6546861","276","50189783","GGCCAGGCACAGTGGCTCATGCCTGTAATCCCTGCACTTTGGGAGGCCAAGGCGGGTGGATCACCTGAGGTCAGGAGTTCGAGACTAGCCTGGCCAACATGGTTGGCCATCTCTTCTAAAAATACAAAAAATTAAGTTGGGCATGGTGGCTCATGCCTGTAATCCCAGCATTTTGGGAGGCCAAGGCAGGTGGATCATAAGGTCAAGAGATTGAGACCATCCTGGCCAACATGGTGAAACCCCATCTCTACTAAAAATACAAAAATTAGCTGGGCGTGGTGGTAGCACACACCTGCAGTCCCAGCTGCTCAGGAGGCTGAGGCAGGAGAATCACTTGAACCCGGGAAGCAGAGGTTGCAGTGAGCCGAAATTGCACCACTGCACTCCAGCCTGGCGACAAAGCAAGACTCCGTCAAAAAAAAAAAAAAAAAAAAAAAAATTAGCCAGGAGTGGTGGCACGTGCCTATAGTTCCAGCTACTCGGGAGGCTGAGGCAAGAGATTTGCTTGAACCTGGGAAGCAGAGGTTGCATATATTGCAGTGAGCCAAGATTATGCCATTGCACTCCAGCCTGGGCAACAAGAGTGAAAATCTGTCTAAAAAGAAAAAAAAAAGAAAAGAAAAA","GGCCACACATGGTGGCTAACGCCTGTAATCCCAGCACTTTGGGAGGCCAAGTCGGGTGGATCATGAGGTCAGGAGACCAAGACCATCCTGGCCAAATGGTGAAACCCCGTCTCTACTAAAAATACAAAAATTAGCTGGGCATGGTGGCGTGTGCCTGTAATCCCAGCTACTCAGGAGGCTGAGGCAGGACAATTGCCTGAACCCAGGAGAATTAGCTGGGCATGGTGGCGTGTGCCTGTAATCCCAGCTACTCAGGAGGCTGAGGCAGGACAATTGCCTGAACCCAGGAGGCGAAGGTTGCGGTGAGCCGAGATTGTGCCATTGCACTCCAGCCTGGGTAACAAGAGCGACACTCTGTCTCAAAAAAAAAAAAAAAAAAAAAAAAAAA"
"chr14","56744047","56744674","JH378118","18053084","18053501","281","38690963","GGCCGGGTGCGGTGACTCACATCTATAATCCCAGCACTTTGGGAGGCCAAGGCAGGTGGATCACCTGAGGTCAGGAGTTCAAGACCAGCCTGGCCAACTTGGTGAAACCCCATCTCTACTAAAAAATATAAAAATTTGCCAGGTGCGGTGGCTCATACCTGTAATCCCAGCACTTTGAGAGGCAGAGGTGGGTGGATCACGAGGTCAGGAGTTCGAGACCAGCCTGGCCAATGTGGTGAAACCCCATCTCTACTAAAAATACAAAAATTAGCCGGGTGTGGTGATGCGTGCCTGTAGTCCCAGCTATTCGGGAGGTTGAGGCAGGAGAATGGCGTGAACCAGGAAGGCGGAGCTTTCACTGAGCGGAGATCGCACCACTGCACTCCAGCCTGGGCGACGGAGCGAGACTCTGTCTCAAAAACAAAACAAAACAAAAAAACAAACAAACAAAAAAACATTATCCGGGTGTGGTGGTGGGCGCCTGTAATCCCAGCTACTTGGGAGGCTGAAGCAGGAGGATTGCTTGAACCTGGGAGGTGGAGGTTGCAGTGAGCTGAGATCACGCCTCTGCACTGCAGGCTGGACGACAAGAACAAAACTCTGAATCAACAACAACAACAACAAAAAA","GGCTGGGCGCAGTGGCTCACACCTGTAATCCCAGCACTTAGGGAAGCTGAGGCGAGTAGATCACCTGAGGTCAGGAGTTAGAGACCAGCCTGGCCATCATGGTGAAACCCCGTCTCTACTAAAGATACCAAAAATTAGCTGAGTGTGGTGCTGGGTGCCTGTAATCCCAGAAACTCAGGGTGCCTGTAATCCCAGCAACTCAGGGTGCCTTTAATCCCAGCAACTGAGGGTACCAGTAATCCCAGCAACTCAGGGTGTCTTTAATCCTAGCAACTGAGGGCACCTGTAATCCCAGCAACTCAGGAAGCTGAGACAGGAGAAGTACTTGAACCCAGAAGGCAGAGGTTGCAGTGAGCCGATATTGCACCATTGCACTCCAGTCTGGGCAACAAGAGTGAAACTCTGTCTCAAAAAAAAA"
"chr14","58283278","58283584","JH378115","34663603","34663898","52","23619675","CCGGGTGCGGTGGCTCACGCCTGTAATCCCAGCACTTTGGGAAGCTGAGGTGGGTGGATCATTTGAGGTCAAGAGTTCTAGACCAGCCTGGCCAACATGGTGAAACCCTACTTCTAATAAACACACACACACACACACACACACACACACACACACAAATTAGCCAGCAGGCACCTGTAATCCCAGCTACTCGGAAGGCTGAGGCAGGACAATCGCTTGAACCTGGGAGGCCAGAAGTTGCAGTGAGCCAAGATCATGCCACTGCACTCCAGTCTGGGTGACAAGAGCAAGACTCCATTTCAAAAAA","GGCCTGGTGAAGTGGCTCACGCCTGTAATCCCAACACTTTGGGAGGCTGAGATGGATGGCTCATTTGAGGTCAGGAGTTCTAGACCAGCCTGGCCAACATGGTAAAAGCCCACCTCTACCAAAAATACAAAAACAAAAACAAAAAAATTTTAGCCAACAGGCACCTTTAATCCCAGCTACTCAGGAGGCTGAGGCAGGAGAATTGCTTGAATCTGGGAGGCCAGAAGTTGCAGTGAGCCAGGATCACACCACTGCACTCCATCCTAGGCGACAAGAGCAAGACTCCAAAAAAAAAA"
"chr14","59226808","59227410","JH378118","18053084","18053501","257","41173724","GGCTGGGCGCTGTGGCTCATGCCTGTAATCCCAGCACTTTAGGAAGCCAAGGGAGGTGGATCACCTGAGGTCAGAGTTCAAGTCCGGCCTGACCAACATGGCGAAACCCAGTCTCTACTAAAAATACAAAATTGGCCAGGCGTGGGGTGGCTCACACCTGTAATCCCAGCACTTTGGGAGGCCGAAGTGGGTGGATCACTTGAGGTCAGGAGTTTGAGACCAGCCTGGTTAACATGGTGAAACCCCATCTCTACTAAAAATACAAAAATTAGCCAGGCATGGTGGCAGGCGCCTGCAATCCCAGTTACTCAGGAGGCTGGTGCAGGAGAATCGCTTAAACCTAGGAGGCAGAGGTTGCAGTGAACTGAGATCGTGCCATTGCACTCCAGCCTGGGTAACAACAGCAAGACTTCATCTCAAAAAAAAAAATACATAATTATAATTAGCTGGGCGTGTTGGCGAGCGCCTGTAGTCCCTGCTACTTGGGAGGCTGAGGCAGGGGAATCACTTGAACCTGAGAGGCGGAGGTTGCAGTGAGCCAAGTCACGCCATTGCATTCCAGCCTCGGCAACAAGAGCAAAACTCCATCTCAAAAAAAAAAAA","GGCTGGGCGCAGTGGCTCACACCTGTAATCCCAGCACTTAGGGAAGCTGAGGCGAGTAGATCACCTGAGGTCAGGAGTTAGAGACCAGCCTGGCCATCATGGTGAAACCCCGTCTCTACTAAAGATACCAAAAATTAGCTGAGTGTGGTGCTGGGTGCCTGTAATCCCAGAAACTCAGGGTGCCTGTAATCCCAGCAACTCAGGGTGCCTTTAATCCCAGCAACTGAGGGTACCAGTAATCCCAGCAACTCAGGGTGTCTTTAATCCTAGCAACTGAGGGCACCTGTAATCCCAGCAACTCAGGAAGCTGAGACAGGAGAAGTACTTGAACCCAGAAGGCAGAGGTTGCAGTGAGCCGATATTGCACCATTGCACTCCAGTCTGGGCAACAAGAGTGAAACTCTGTCTCAAAAAAAAA"
"chr14","62992080","62992681","JH378118","18053084","18053501","256","44938996","GGCCGGATGCAGTGGCCCACACCTGTAATCCTAGCACTTTGAGAGGCTGAAGCAGGCAGATCACTTGCGGTCAGGAGTTTGAGACCAGCCTGGCCAACATAGTAAAACCTCATCTCTACTAAAAATAGAAAAATTTTCTGACCAGGCACGGTGGCTCGCGCCTGTAATCCCAGCACTTTGGGAGGCCAAGGTGGGCACATTACCTGAGATCAAGAGTTCAAGACCAGCCTGACCAACATGGCAAAACTCTGTCTCTACTAAAAATACAAAATTAGCCGGGCATAGTGGCGCATTCCTGTAATCCCAGCTACTAAGGAGGCTGAGGCAGGAGAATTGCTTGAACCCGGGAGCCGGAGGTTGCAGTAAGCCAAGATTGCGCACTGCACTCTAGGCTGGGCAACAACAGCGAAACTCTGTCTCGAAAAAAAAAAAAAAAAAAATTAGCTGGGCGTGGTGGTGAGTACCTGTAATCCCAGCTACTTGGGAGACTGAGGCAGGAGAATCTCTTGAACCTGGGAGGTAGAGGTTGCAGCGAGCTTAGATCACACCACTGCACTAAAGCCTGGGGGACAAGAGCAAAACTCTATCTCAAAAAAATAAAA","GGCTGGGCGCAGTGGCTCACACCTGTAATCCCAGCACTTAGGGAAGCTGAGGCGAGTAGATCACCTGAGGTCAGGAGTTAGAGACCAGCCTGGCCATCATGGTGAAACCCCGTCTCTACTAAAGATACCAAAAATTAGCTGAGTGTGGTGCTGGGTGCCTGTAATCCCAGAAACTCAGGGTGCCTGTAATCCCAGCAACTCAGGGTGCCTTTAATCCCAGCAACTGAGGGTACCAGTAATCCCAGCAACTCAGGGTGTCTTTAATCCTAGCAACTGAGGGCACCTGTAATCCCAGCAACTCAGGAAGCTGAGACAGGAGAAGTACTTGAACCCAGAAGGCAGAGGTTGCAGTGAGCCGATATTGCACCATTGCACTCCAGTCTGGGCAACAAGAGTGAAACTCTGTCTCAAAAAAAAA"
"chr14","75046278","75046878","JH378118","18053084","18053501","246","56993194","GGCCGGGCACAGTGGCTCACACCTATAATCTCAGTACTTTGGGAGGCCAAGGCGGGCAGATCACTTGAGGTCAGGAGTTCGAGACCACCCTGGCCAACATGGTGAAACCTCATCTCTACTAAAAATACAAAAAACTGGCTGGGTGAAGTGGCTCACGCCTGTAATCCCAGCAGTTTGGGAGGCCAAGGCGGGCCAATCACGAGGTCAGGAGTTCGAGACCAGCCTGGCCAATATGGTGAAACCCCGTCTCTATTAAAAATTCAAAAATTAGCTGGATGTGGTGGCAGGCACCTACAATCCCAGCTACTTGGAAGGCTGAGGCAGGAGAGTCTGCTTGAAACCAGAAGGCGGAGGTTGCAGTGAGTGAGCTGAGAACGTGCCACTGCACTCCAGCCTGGGCGAAAGAGCAAAACGCTGTCTCAGGGGGAAAAAAAAAACTAGCCGGGCATGGTGGCAGGTGCCTGTAATCCCAGCTACTCAGGAGGCTGAGGCAGGAGAATTGCTTGAACCCAGGAGGAGGAGGTTGCAGTGAGTCGAGATCACGTCATTGCACTCCCAGCCTGGCTGATAAGAGCGAAACTCCGTCAAAAAAAAAAAAAAA","GGCTGGGCGCAGTGGCTCACACCTGTAATCCCAGCACTTAGGGAAGCTGAGGCGAGTAGATCACCTGAGGTCAGGAGTTAGAGACCAGCCTGGCCATCATGGTGAAACCCCGTCTCTACTAAAGATACCAAAAATTAGCTGAGTGTGGTGCTGGGTGCCTGTAATCCCAGAAACTCAGGGTGCCTGTAATCCCAGCAACTCAGGGTGCCTTTAATCCCAGCAACTGAGGGTACCAGTAATCCCAGCAACTCAGGGTGTCTTTAATCCTAGCAACTGAGGGCACCTGTAATCCCAGCAACTCAGGAAGCTGAGACAGGAGAAGTACTTGAACCCAGAAGGCAGAGGTTGCAGTGAGCCGATATTGCACCATTGCACTCCAGTCTGGGCAACAAGAGTGAAACTCTGTCTCAAAAAAAAA"
"chr14","83813857","83814442","JH378118","18053084","18053501","240","65760773","GGCCAGGCGCGGTGGCTCACGCCTGTAATCCCAGCACTTTGGGAGGCCGAGGCGGGCGGATCACCTGAGGTCAGGGGTTCAAGACCAGCCTGACCATCCCAGAACTTTGGGAGGCCGAGACGGGTGGATCATGAGGTCAGGAGATCGAGACCATCCTGGCTAACACAGTGAAACCCCATCTCTATTAAAAATACAAAAAATTAGCCGGGCGTGGTGGCAGCTCCTGTAGTCCCAGCTACTCGGGAGGCTGAGGCAGGAGAATGGCGTGAACCCGGGAGGCGGAGCTTGCCGTGAGCCGAGATCGCACCACTGCACTCCAGCCTGCAAGATAGCGAGGCTATGTCTCAGGAAAAAAAAAAAAAAAAAAAAAAAGACCAACCTGACCAACATGGTAAAACCCCATCTCTACTAAAAATACAAAATTAGCCGGGCATGGTGGCAGACGCCTGTAATCCCAGCTACTCAGGAGGCTGAGGCAGGAAAATCACTTGAACCCAGGAGGTGGAGGTTGCGGTGAGCCGAGATCGTGCCATTGCACTCCGGCCTGGGTGACAACAGCGAAACTCCATCTCAAAAAAAAGAAAAA","GGCTGGGCGCAGTGGCTCACACCTGTAATCCCAGCACTTAGGGAAGCTGAGGCGAGTAGATCACCTGAGGTCAGGAGTTAGAGACCAGCCTGGCCATCATGGTGAAACCCCGTCTCTACTAAAGATACCAAAAATTAGCTGAGTGTGGTGCTGGGTGCCTGTAATCCCAGAAACTCAGGGTGCCTGTAATCCCAGCAACTCAGGGTGCCTTTAATCCCAGCAACTGAGGGTACCAGTAATCCCAGCAACTCAGGGTGTCTTTAATCCTAGCAACTGAGGGCACCTGTAATCCCAGCAACTCAGGAAGCTGAGACAGGAGAAGTACTTGAACCCAGAAGGCAGAGGTTGCAGTGAGCCGATATTGCACCATTGCACTCCAGTCTGGGCAACAAGAGTGAAACTCTGTCTCAAAAAAAAA"
"chr14","84224287","84224910","JH378118","18053084","18053501","265","66171203","GGCAGGGTGCAGTGGCTCATACCTGTAATCCCAGCACTCTGGGAGGCCGAGGTGGGCAGATCACTTGAGCTCAGGAGTTTGAGACCAGCCTGGCCAACATAGTGAAACCCCATCTCTACTAAAAATACAAAATTAGGCTGGGCACAGTGACTCACGTCTGTAATCCCAGCACTTTGGGAGGCCGAGGCTGGTGGATCACAAGGTCAGGAGATCAAGACCATCCTGTCCAACATAGTGAAACCCCATCTCTACTAAAAATACAAAAATTAGCTGGACGTGGAGGTGCACATCTGTAGTCCCAGCTACTTGTGAGGCTGAGGCAGGAGAACTGCTTGAACCCAGGAGGCGGAGGCTGCAGTGAGCTGAGATTGTGCCACTGCACTCCAGCCTGGGCGACAGAGCGAGACTCTGTCTCAAAAAAAAAAAAAAACAGAAAAAACAAAATTAGCCGGGCATGGTGGTGCACGCCTGTAACCCCAGCTACTTGGGGGGCTGAGGCAGGAGAATTGCTTGAACCTGAGAGGTGGAGGTTTCAGTGAGCCGAGATTGTGCCATTGCCCTCCAGTCTGGGCAACAAGAGCAAAACTCCGTCTCAAAAAAAAAAAAAAGAAAAAAAAAGAAGAA","GGCTGGGCGCAGTGGCTCACACCTGTAATCCCAGCACTTAGGGAAGCTGAGGCGAGTAGATCACCTGAGGTCAGGAGTTAGAGACCAGCCTGGCCATCATGGTGAAACCCCGTCTCTACTAAAGATACCAAAAATTAGCTGAGTGTGGTGCTGGGTGCCTGTAATCCCAGAAACTCAGGGTGCCTGTAATCCCAGCAACTCAGGGTGCCTTTAATCCCAGCAACTGAGGGTACCAGTAATCCCAGCAACTCAGGGTGTCTTTAATCCTAGCAACTGAGGGCACCTGTAATCCCAGCAACTCAGGAAGCTGAGACAGGAGAAGTACTTGAACCCAGAAGGCAGAGGTTGCAGTGAGCCGATATTGCACCATTGCACTCCAGTCTGGGCAACAAGAGTGAAACTCTGTCTCAAAAAAAAA"
"chr14","85020958","85021268","JH378108","34510794","34511096","52","50510164","GCCAGGTGCAGTGGCTCATGCCTGTAATTCCAGTACTTTGAGAGGTCGAGACAGGGAGATCACCTGAGGCCAGGAGTTCAAGACTAGCTTGGCCAACATGGCAAAACCCTGTCTCTACTAAAAATGCAAAAAAAAAAAAAAAAAAAAAAAAAAAATTAGCCTGGCATGGTGGTAGACACCTGTAATCCCAGCTACTTGGGAGGCTGAGACAGGAGAACCTCTTGAATCTGGGAGGAGGAGGTTGCTGTGAGCTGAGATCGTGCCACTGCACTCCAGCCTGGGTAACAAGAGAGAAACTCTGTCTCAAAAAA","GGGTGCCGTGTCTCATGCCTGTAATTCCAGCACTTTGGGAGGTCAAGGCAGTCCGATCACCTGAGGTCAGGAGTTTGAGACTAGCCTGGCCAAAATGGTGAAACCCTGTCTCTAGAAAAAATACAAAAAAAAAAAAAAAAAAAAAAAAAAATTAGCTGGATGTAGTGGTGCATACCTGTAGTCCCAGCTACTCTGGAGGCTGAGGCAGGAGAATTGTTTGAACCCAGGAGGCGGAGGTTGCGGTGAGCCGAGATCATGCCATTGCACTCCAGCCTGGGAAACAAGAGTGAAACTCTGTCTCAA"
"chr14","86696589","86696920","JH378203","2698403","2698735","56","83998186","GGCCAGGCACGGTGGCTCATGCCTATAACCAGCACTTTGGAGGCCGAGGCAGGTGGATCACCTGAGGTCAGGAGTTTGAGACTGGCCTGGCCAGCATGGTGAAACTCTGTCTCTACTAAAAAAAAAAAAAAAAAAAAAAAAAAAAAAGTACAAAATTAGCTGGATGTGGTGGTAGGCACCTGTAATCCCAGCTACTTGGGAGGCTGAGGCAGGAGAATCGCTTGAACCCAGGAGGCAGAGATTGCAGTGAGCCAAGATTGCGCCATTGTACTCCACTCTGGGCAATGAGCGAAACTCCGTCTCAAAAAAAAAATAAAATAAAAATAAAATAA","GCCGGGTGCAGTGGCTCATACCTCTAATCCCAGCACTTTGGGAGGCCAAGGCAGGTGATCACCTGTGGTCAGGAGTTCGAGACCAGCCTGGCCAACATGGTGAAACCCTGTCTTTACTAAAAATACAAAAAAAAAAAAAAAAAAAAAAAAAAAAAACTTAGCCCACCATGGTGGTGGGCTCTTGTAGTCCCAGCTACATGGGAGGCTGAGGCAGAAGAATCGCTTGAAGACAGGAGGTGGAGGTTGCAGTGAGCCAAGACTGCGCCATTGCACTCAGCCTGGGTGACGAGCCAAACTCCATCTCAAAAAAAAAAAAAAAAAAAAAAAAAAAAA"
"chr14","86944567","86945185","JH378118","18053084","18053501","274","68891483","GAGCACGGTGGCTCACGCCTGCAATCCCAGCACTTTGGGAGGCCGAGGTGGGTGGATCACCTGAGGTTAGGAGTTTGAGACCAGCCTGGCCAACATGGTGAAACCGTCTCTACTAAAAATGCAAAAAAGTAGGGGCCGGGCACGGTGGCTCACGCCTGTAATCCCAGCACTTTGGGAGTCTGAGGCAGACGGATCACAAGGTCAGGAGATCAAGACCATGGTGAAACTCCGTCTCTACTAAAAATACAAAAAATTAGCTGGGCGTGGTGGTGGGCACCTGTAGTCCCAGCTGCTTGGGAGGCTGAGGCAGGAGAATGGTGTGAACCCGGGAGGCGGAGCTTGCAGTGAGCCGAGATCGCAACACTGCACTCCAGCCTGGGCGACAGAGCGAGACCCTGTCTCAAAAAAAACAAAAATAAACAAAAATAAATAAATACAAAAAAGTAGCCAGGCATGGTGGTGGGTGCCTGTAATCCCAGCTACTTGGGAGGCTGAGGCAGGAGAATCACCTGAACCCGGGAGGTGGAGGTTGCAGTGAGCCAAGACCGTGTCATTACACTCTAGCCTGGGCAACAAGAGCGAAATTCCATCTGAAAAAATAAATAAATAAAAATAAAAA","GGCTGGGCGCAGTGGCTCACACCTGTAATCCCAGCACTTAGGGAAGCTGAGGCGAGTAGATCACCTGAGGTCAGGAGTTAGAGACCAGCCTGGCCATCATGGTGAAACCCCGTCTCTACTAAAGATACCAAAAATTAGCTGAGTGTGGTGCTGGGTGCCTGTAATCCCAGAAACTCAGGGTGCCTGTAATCCCAGCAACTCAGGGTGCCTTTAATCCCAGCAACTGAGGGTACCAGTAATCCCAGCAACTCAGGGTGTCTTTAATCCTAGCAACTGAGGGCACCTGTAATCCCAGCAACTCAGGAAGCTGAGACAGGAGAAGTACTTGAACCCAGAAGGCAGAGGTTGCAGTGAGCCGATATTGCACCATTGCACTCCAGTCTGGGCAACAAGAGTGAAACTCTGTCTCAAAAAAAAA"
"chr14","87180871","87181803","JH378118","18053084","18053501","547","69127787","GGCCATGTGCGGTGGCTCACACCTGTAATCCCAGCACTGTGGGAGGCCAAGGTGGGCGGATCATTTGAGGTCAGGAGTTCTAAACCAGCCTGGCCAATATGGTGAAACACTGTCTCTGCTAAAAATACAAAAAAAGAAAAAGAAAAAAAAAAAAAGGCTGGGCACGGTGGCTCACGCCTGTAATCTCAGCACTTTGGGAGGCTGAGGTGGGTGGATTACCTGAGGTCAGGAGTTCGAGACCAGCCTGGCCAACATGGTGAAACCTTGTCTCTACTAAAAGTATAAAAATTAGCCAGGTGTGGTGGAGGTCGCCTGTAATCCCAGCTACTCAGTAGGCAGAGGCAGAAGAATCCGTTGAACCTGGGAGGCGGAGGTTGCAGTGAGCTGAGATTGCACCAGTGCATTCCAGCCCGGGTGACAAGAGTGAGACTCTGTCTCAAAATAAACAAACAAAAAAATTAGTGGGCCGGGTTCAATGACTCACGCCGGTAATCCCAGCACTTTGGGAGGCCAAGGAAGGCAGGTCACCTGAGGTCGGGAGCTCGAGACCAGCCTGACCAACATGGAGAAACCCCGTCTCTACTAAAAATACAAAATTAGCTGGGCGTGGTGGCACATGCCTGTAATTCCAGCTACTCAGGACGCTGAGGCAGGAGAATTGCTTGAACCCAGGAGGCGGAAGTTGCAGTGAGCCAAGATCATGACATTGCACTCCCGCCTGGGCGCCAAGAGTGAGATTTCGTCTCAAACAAACAAACAAAAAAACGAATTAGTGGAGCGTGGTGGCAGGCACCTAAAGTCCCAGCTATTCAGGAGGCTGAGGCAGGAGAATTGCTTGAACCTGGGAAGTGGAGGTTATAGTGAGCTGAGATCGCGCCATTGCACTCCAGCCTGGGCAACAAGAGTGAGAATCTGTCTAAAAAAAAAAAAGAA","GGCTGGGCGCAGTGGCTCACACCTGTAATCCCAGCACTTAGGGAAGCTGAGGCGAGTAGATCACCTGAGGTCAGGAGTTAGAGACCAGCCTGGCCATCATGGTGAAACCCCGTCTCTACTAAAGATACCAAAAATTAGCTGAGTGTGGTGCTGGGTGCCTGTAATCCCAGAAACTCAGGGTGCCTGTAATCCCAGCAACTCAGGGTGCCTTTAATCCCAGCAACTGAGGGTACCAGTAATCCCAGCAACTCAGGGTGTCTTTAATCCTAGCAACTGAGGGCACCTGTAATCCCAGCAACTCAGGAAGCTGAGACAGGAGAAGTACTTGAACCCAGAAGGCAGAGGTTGCAGTGAGCCGATATTGCACCATTGCACTCCAGTCTGGGCAACAAGAGTGAAACTCTGTCTCAAAAAAAAA"
"chr15","7203590","7204226","JH378118","18053084","18053501","285","10849494","GGCCAGGTGCAGTGGCTCATGCCTCTAATCCCAGCACTTTGGGAGGCCGAGATGGGCAGATCACCGGAGGTCAGGAGTTTGAGACCAGCTTGGCCAAAATGGTGAAACCCTGTCTCTACAAAAAAATACAAAAATGGCTAGGCACGGTGGCTCACACCTGTAATCCCAGCACTTTGGGATACAGGTGGATCATGAGGTCAAGAGATCAAGATCATCTTGGCCAACATGGCAAAACCCTGTCTCTACTAAAAAATACAAAAAATTAGCTGGGCGTGGTGGTGCACGCCTGTAGTCCCAGCTACTCAGGAAACTGAGGCAAGAGAATCGCTTGAACCTGGGAGGTAGAGGTTGCAGTGAGCCGAGATGCACTCCAGCCTGGCAACAGAACAAGACTCCATCTCAAAGAACAAAAACAAAACAAAACAAAACAAAAGACAAGCAAACAAAAAAATACAAAAATTAGCTAGGTGTGGTGGCAGGCGCCTGTAATCCCAGCTACTCAGGAGGCTGAGGCAGGAGAATCGCTTGAACCTGGGAGGCGGAGGTTGCAGTGAGCCAAGATTGTGCCATTGCACTCCAGCCTAGGTGACAAGAGTGAAAAGACGTCTCAAAAACAAAACCAAAAAAAAAAATAAAA","GGCTGGGCGCAGTGGCTCACACCTGTAATCCCAGCACTTAGGGAAGCTGAGGCGAGTAGATCACCTGAGGTCAGGAGTTAGAGACCAGCCTGGCCATCATGGTGAAACCCCGTCTCTACTAAAGATACCAAAAATTAGCTGAGTGTGGTGCTGGGTGCCTGTAATCCCAGAAACTCAGGGTGCCTGTAATCCCAGCAACTCAGGGTGCCTTTAATCCCAGCAACTGAGGGTACCAGTAATCCCAGCAACTCAGGGTGTCTTTAATCCTAGCAACTGAGGGCACCTGTAATCCCAGCAACTCAGGAAGCTGAGACAGGAGAAGTACTTGAACCCAGAAGGCAGAGGTTGCAGTGAGCCGATATTGCACCATTGCACTCCAGTCTGGGCAACAAGAGTGAAACTCTGTCTCAAAAAAAAA"
"chr15","13675429","13675731","JH378235","1186107","1186418","53","12489322","GGCTTGGCACAGTGGCTCATGCCTGTAATCCCAGCACTTTGAGAGACCGAGGCAAGTGGATCCCAGGAGTTCAAGACCAGCCTGGCCAAGATGGTGAAACCCCCCATCTCTACTAAAAATACAAAAAAAAAAAAAAAAAAAAAAAAAGGGCTTAGTGGCTGGCAGCTGTAGTCCCAGCTACTCGGGAGGCTGAGGCAGGAGAATCGCTTGAACCTGGGAAGCGGAGGTTGCAGTGAGCCAAGATCACACCATTGCACTCTAGCCTGGGCAACAAGGGCAAAACTCCATCTCAAAAAAAAAGAA","GGCTGGGCGCAGTGGCTCAAGCCTGTAATCCCAGCACTTTGGGAGGCCGAGGGGGGTGGATCACGAGGTCAAGAGATCAAGACCATCCTGGTCAACATGGTGAAACCCCGTCTCTACTAAAAAAAAAAAAAAAAAAAAAAAAAAAAAAAAAAAATTAGCTGGGCATGGTGGCGTGTAATCCCAGCTACTCAGGAGGCTGAGGCAGGAGAATTGCCTGAACCCAGGAGGCGGAGTTTGCGGTGAGCCAAGATCGCGCCATTGCACTCCAGCCTGGGTAACAAGAGCAAAACTCTGTCTCAAAAAAAAAAAAAA"
"chr15","14837014","14837358","JH378137","13677298","13677634","59","1159716","GCCGGGTATGGTGGCTCATGCCTGTAATTCCAGCACTTTGGGAGGCCGAGGCAGGCGGATCACCTGAGGTCAGGAGTTTGAGACCAGCCTGGCTAACATGGTGAAACTACGTTTCTACTAAAAATACAAAAAAAAAAAAAAAAAAAAAAAAAAAAAAAAAAAAAAAAAAAATTAGCCAGGCGTGGAGGCGCGTGCCTATAATCCCAGTTACTCGGGAGGCCGAGGCAGGAGAATCGCTTGAACCCAGGAGCCGGAGGGTGTAGTGAGCCGAGATCATGCCATTGCGCTCCAGGTTGGGCAACAAGAGCAGAACTCCGTCTCAAAAAAAAAAAAAAAAAAAAAAAA","GGCTGGGCATTGTGGCTCATGCCTGTAATCCCAGCACTTTGGGAGGCCGAGGTGGGCGGATCACCTGAGGTCGGGAGTTCAAGACCAGCCTGGCCACAATGGTGAAACTCTGTCTCTGCTAAAAAAAAAAAAAAAAAAAAAAAAAAAAAAAAAAAAAAAATTAGCCAGGCGTGGTGGCACACGCCTGTAATCCCAGCTATTTGGGAGGCTGAGGCAGGAGAATCGCTTGAACCTGAGAGGTGGAGGTTGCAGTGAGCCAAGATCATACCATTGCACTCCAGCTTGGGAACAAAGAGCAAAACGCCATCTCAAAAACAAAACAAACAAACTGAAAAAA"
"chr15","20684723","20685060","JH378262","266823","267148","57","20417900","GGCTGGGCGTGTTGGCTTACACCTGAAATCCCAGCACTCTGGGAGGCCGAGGCGGGCAGATCACCTGAGGTCAGGGGTTCGAGACCAGCTTGGCCAACATGGTGAAACCCCGTCGCTACTAAAAATACAAAAATTAGCTGGGCATGGTGGTGGGAGCCTGTAATCCCAGCTACTCAGGAGACTGAGGCAGGACAATCGCTTGAACCCAGGAGGCAGAGGTTGCAGCGAGCCGAGATCGTGCCACTGCACTCCAGCCTGGGAGGGAAGAGTGAAAGTCCATAACAACAACAAAACAACAAAACAACAACAACAACAACAACAACATCTCTGAAAGGAAA","GGCCGGGCGCGGTGGCTCAAGCCTGTAATCCCAGCACTTTGGGAGGCCGAGGCGGGTAGATCATGAGGTCAGGAGTTTGAGACCAGCCTGGCCAACATGGTGAAACCCCGTCTCTACTAAAAATACAAAAATTAGCCGGGCATGGTGGCCTGTGCCTGTAATCCTAGCTACCCAGGAAGCTGAGGCAGGAGAATTGCCTGAACCCAGGAGGCGGAGGTTGCGGTGAGCCGAGATCGTGCCATTGCACTCCAGCCTGGGTAACAAGAGCGAAACTCCGTCTCAAAAACAAACAAACAAACAAACAAAAACAAAAAACAAAAAACAAA"
"chr15","20894395","20894976","JH378119","32351107","32351490","257","11456712","GGTGGCTCACACCTGTAATCCCAGCACTTTGGGAAGCCGAGGTAGGTGGATCACCTGAGGTCAGGAGTTAGAGATCAGCCTGGACAACATGGTGAAACCCCATCTCTACTAAAAATACAAAAACTAACCAGGCTTGGTGGCTCACACCTGTAATCCCATCACTTTGGGAGGCCAAGGCGGGTGGACTACTTGAGGTCAGGAGTTTGAGACCAGCCTGGCTAACATGGTGAAACCCCATCTCTACTAAAAATACAAAAATTAGCTGGGCATGGCAGTGCGCGCCTGCAATCCCAGCTACCTGGGAGGCTAAGGCAGGGGAATTGTTTGAACCTGGGAGGCAGAGGTTGCAGTGAGCCGACACTGCACCACTGCACTCCAGCCTGGGTGACAGAGTGAGCCTCCGTCTCAAAAAAAAAAAAAAAAAAAAAAAAAAATTAGCCAGGTGTGGTGGCAGGCACCTGTGATCCCAGCTACTCAGGAGGCTGAGGCAGGAGAATTGCTTGAACCCAGGAGGCGGAGAGTGCAGTGAGCTGAGATCATGCCATTGCACTCCAGCCTGGGTGACAAGAGAGAAACTCTGTC","GGCCAGGTATGGTGGCTCACACCTGTAATCCCAGCACTTTGGGAGGCCAAGGCAGGCAGACCACCTGAGGTCAGGAGTTCGAGATCAGCCTAGCCAACATGGTGAAACCCCATCTCTAGTAAAAATAAAATTAGCCAGGCATGGTGGTGCATGCCTGTAACGCAGGTCAGGAGTTCGAGATCAGCTTAGCCAACATGGTGAAACCCCATCTCTAGTAAAAATAAAATTAGCCAGGCAGGTGGTGCCGCCTGTACTCGGGAGGCTGAGGCAGGAGAATCACTTGAACCCAAGAGGCAGAGGTTGCAGTCAGCCAAGATCATGCCATTGCACTCCAGCCTAAGCAAAAAGAGTAAAACTCAGTCTCAAAACAAAAAAACAAAAAAA"
"chr15","21092189","21092737","JH378206","6546474","6546861","200","14545715","GCCGGGCGTGGTGGCTCACGCCTGGCCTGTAATCCCAGCACTTTGGGAAGCCAAGGCGGGTGGTTCACCTGAGGTCAGGAGTTCAAGACCAGCCTGGCCAACATGGTGAAACCCTGTCTCTACTAATAATACAAAAATTAGCTGGGCATGGTGGTGCATGCCTGTAATCCCAGCTACTTGGGAGGCCGAGGCGAGCAGATCACCTGAGGTCAAGAGTTCGATACCAGCCTGACCAACATAGAGAAACCCCGTCTCTACTAAAAATGCAAAATTAGCCGGGCATGGTGGTGCATGCCTGTAATCCCCAGCTACTCGGGAGGCTGAGGCAGGAGAATCGCTTGAACCTGGGAGGCAGAGGTTGTGGTGAGCTGAGATCACGCCATTGCACTCCAGCCTGGGCTCGAAACTCCATCTTAAAAAAAAAAAAAAAAAAAAGAATCACTTGAACCCAGGAGGTGGAGGTTGCAGTGAGCTGAGAGTGCACCATTGTACTCCAGCCTGGGCGACAACAGCAAAACTCCATCACCTTAAAAAAAAAAAAAAAAAAGA","GGCCACACATGGTGGCTAACGCCTGTAATCCCAGCACTTTGGGAGGCCAAGTCGGGTGGATCATGAGGTCAGGAGACCAAGACCATCCTGGCCAAATGGTGAAACCCCGTCTCTACTAAAAATACAAAAATTAGCTGGGCATGGTGGCGTGTGCCTGTAATCCCAGCTACTCAGGAGGCTGAGGCAGGACAATTGCCTGAACCCAGGAGAATTAGCTGGGCATGGTGGCGTGTGCCTGTAATCCCAGCTACTCAGGAGGCTGAGGCAGGACAATTGCCTGAACCCAGGAGGCGAAGGTTGCGGTGAGCCGAGATTGTGCCATTGCACTCCAGCCTGGGTAACAAGAGCGACACTCTGTCTCAAAAAAAAAAAAAAAAAAAAAAAAAAA"
"chr15","21150084","21150391","JH378158","10397018","10397312","55","10753066","GGCCGGGCATGGTGGCTTATGCCTGTAATCCCAGCACTTTGGGAGGCTGAGGTGGGTGGATCACCTGAGGTCAGGAGTTCAAGACCACCCTGGTCAACATGGCAAAATCCTGTCTCTACTAAAAATACAAAATTAGCTGGGCGTGGTGGTGGGCGTCTGCCTGGGTGAGGCAGGAGAATCGCTTGAACCCAAGAGGCAGAGGTTGGAGTGAGCCAAGATCGTGCCATTGCACTCCAGCCTGGGCAACGAGAGTGAAACCCCATCTCAGAAAAAAAAAAGAAAAAGAAAAAGAAAAAAGTAAAAAAAAA","GGCTGAGCACAGTGGCTCACACCTGTAATCCCAGCACTTTGGGAGGCCGAGGCGGGTGGATCACCTGAGATCAGGAGTTCAAGAACAGCCTGACCAACATGGTGAAACCTATCTCTACTAAAAATACAAAATTAGCCTGGCATGGTGGCGCGTGCCTGTAATCTGGCTGAGGCAGAAGAATCGCTTAAACCCAGAGGCAGAGATTGCAGTGAGCCAAGATTGTGTCATTGCACTCCAGCCTGGGCAACAAGAGCAAAACTCCATCTCAGAAAAAAAAAAAAAAAGAAGAAAAAAA"
"chr15","21563578","21564184","JH378118","18053084","18053501","255","3510494","GGCCAGGCATGGTGGCTCACACCTGTAATCGCAGCACTTTGGGAGACTGAGGCAAGCAGATCACCTGAGGTTAGAAGTTCAAGACCAGCCTGGCCAACACAGTGAAACCCCATCTCTACTAAAAATACAAAAAAATGGCCGGGTGCAGTGGCTCATGCCTGTAATCCCAGCACTTTGGGAGGCTAAGGCAGGGGGAATCACAAGGTCAAGAGATCAAGACCATCCTGGTAAAACCCCGTCGGTACTAAAAATACAAAAATTAGCTGGGTGAGGTGGCATGCACCTGTAGCCCCAGCTACTCGGGAGGCTGAGACAGGAGAATCACTTGAACCTGGGAGGCAGAGGTTGCAGTGAGCTGAGATCGCACCACTGCACTCCAGCCTGGCAACAGAGGAAGACTCTGTCTAAAACTAATAATAATAATAATAATAATAATAAAATTAGCTGGGAGTAGTGGCGGGCACCTGTAATCCCAGCTACTTGGGGGGGCTGAGGCAGGAGAAAAGCTTGAACCCGGGAGGTGAAGGTTGCAGTAAGCCAAGATCACGCCATTGCACTCCAGCCCGGGCAACAAGAGCGAAACTTCGTTTCAAAAAAAAAAAAAAAA","GGCTGGGCGCAGTGGCTCACACCTGTAATCCCAGCACTTAGGGAAGCTGAGGCGAGTAGATCACCTGAGGTCAGGAGTTAGAGACCAGCCTGGCCATCATGGTGAAACCCCGTCTCTACTAAAGATACCAAAAATTAGCTGAGTGTGGTGCTGGGTGCCTGTAATCCCAGAAACTCAGGGTGCCTGTAATCCCAGCAACTCAGGGTGCCTTTAATCCCAGCAACTGAGGGTACCAGTAATCCCAGCAACTCAGGGTGTCTTTAATCCTAGCAACTGAGGGCACCTGTAATCCCAGCAACTCAGGAAGCTGAGACAGGAGAAGTACTTGAACCCAGAAGGCAGAGGTTGCAGTGAGCCGATATTGCACCATTGCACTCCAGTCTGGGCAACAAGAGTGAAACTCTGTCTCAAAAAAAAA"
"chr15","22132229","22132799","JH378118","18053084","18053501","233","4079145","GGAGGCCAAGGTGGGCGAATCACCGGTGGTCAGGAGTTTGAGACTAGCCTGGCCAACATGGTGAAACCCCGTCTCTACTAAAAAATACAAAAATTAGGCCGAGTGTGGTGGCTCATGCCTGTAATCCCAGCAGTTTGGAAGGCCAAGGCGGGCAGATCACCTGAGGTCAGGAGTTCAAGACCAGCCTGGCCAACACAGTGGAACCCTGTCTCTACTAAAAATACAAAAAAAATTTGCCAGGCATGGTGGTGTGTGTGCCTATAATCCCAGCTACTCAGGAGACTGAGGCAAGAGAACTGCATGAACCCCAGAGGGAGAGGCTGCAGTGAGCTGAGATCGTACCACTGCACTCCAGCCTGGGTGACAGGGCAGGACTCCGTCTCAAAAAAAAAAAAAAAAAAAAAAAATTAGCCAGGTGTGGTGGCGAGCACCTGTAATCCTAGGTACTTGGGAGGCTGAGAAAGGAGAACCACTTGAACCCCGGAGGCAGAGGTTGCAGTGAGTGGAGATTGTGCGCCATTGCACTCCAGCCTGGGTGACAAGTGTGAAATTCTGCCTCAAAAAAAAAAAA","GGCTGGGCGCAGTGGCTCACACCTGTAATCCCAGCACTTAGGGAAGCTGAGGCGAGTAGATCACCTGAGGTCAGGAGTTAGAGACCAGCCTGGCCATCATGGTGAAACCCCGTCTCTACTAAAGATACCAAAAATTAGCTGAGTGTGGTGCTGGGTGCCTGTAATCCCAGAAACTCAGGGTGCCTGTAATCCCAGCAACTCAGGGTGCCTTTAATCCCAGCAACTGAGGGTACCAGTAATCCCAGCAACTCAGGGTGTCTTTAATCCTAGCAACTGAGGGCACCTGTAATCCCAGCAACTCAGGAAGCTGAGACAGGAGAAGTACTTGAACCCAGAAGGCAGAGGTTGCAGTGAGCCGATATTGCACCATTGCACTCCAGTCTGGGCAACAAGAGTGAAACTCTGTCTCAAAAAAAAA"
"chr15","23508255","23508883","JH378118","18053084","18053501","275","5455171","GGTCGGGTGTGGTGGCTCATGCATGTAATCCTGGCACTTTGGGAGGCCGAGGCGGGTAGATCACCTGAGGTCACGAGTTTGAGACCAGCCTGACCAACATGGTAAAACTTTGTTTCTACTACAAATACAAAAAATTGGCCAGGCTCGGTGGCTTCCGCCTGTAATCCCAGCACTTTGGGAGGCCGGGGTGCATGGATCACCTGAGGTCAGGACTTCGAGACCAGCCTGGCCAACATGGTGAAACCCCATCTCTACTAAAAATACAAAAAAAAAAAAAAAAATGAGCCAGGCATATTGGTGGGCGCCTGTAATCCCAGCTACTTGGAAGGCTGAGACAGGAGAATCACTTGAACCTGGGAGGCGGAGATTGCAGTGAGCCGAGATCATGCCACTGTACTCCATCCTGGGTGACAAGAGTGAGACTGCATCTCAAAAAAAAAAAAACCAAAAAACCAAAAAAAAACAAAAAATTAGTCAACCGTAGTGGTGGGCCCCTATAATCTCAGCTGCTCAGGAGGCTGAGGCAGTAGAATCACTTGATCCCAGGAGGTGGAGGTTTCAGTGAGCTGAGATCATGCCATTGTACTCCAGCCTGGGCAACAAGAGCGAAACTCTATCTCAAAAAATAA","GGCTGGGCGCAGTGGCTCACACCTGTAATCCCAGCACTTAGGGAAGCTGAGGCGAGTAGATCACCTGAGGTCAGGAGTTAGAGACCAGCCTGGCCATCATGGTGAAACCCCGTCTCTACTAAAGATACCAAAAATTAGCTGAGTGTGGTGCTGGGTGCCTGTAATCCCAGAAACTCAGGGTGCCTGTAATCCCAGCAACTCAGGGTGCCTTTAATCCCAGCAACTGAGGGTACCAGTAATCCCAGCAACTCAGGGTGTCTTTAATCCTAGCAACTGAGGGCACCTGTAATCCCAGCAACTCAGGAAGCTGAGACAGGAGAAGTACTTGAACCCAGAAGGCAGAGGTTGCAGTGAGCCGATATTGCACCATTGCACTCCAGTCTGGGCAACAAGAGTGAAACTCTGTCTCAAAAAAAAA"
"chr15","23602365","23603005","JH378118","18053084","18053501","286","5549281","GGTCGGGTGTGGTGGCTCATGCATGTAATCCTGGCACTTTGGGAGGCCGAGGCGGGTAGATCACCTGAGGTCACGAGTTTGAGACCAGCCTGACCAACATGGTAAAACCTTGTTTCTACTACAAATACAAAAAATTGGCCAGGCTCGGTGGCTTCCGCCTGTAATCCCAGCACTTTGGGAGGCCGGGGTGCATGGATCACCTGAGGTCAGGACTTCGAGACCAGCCTGGCCAACATGGTGAAACCCCATCTCTACTAAAAATACAAAAAAAAAAAAATGAGCCAGGCATATTGGTGGGCGCCTGTAATCCCAGCTACTTGGAAGGCTGAGACAGGAGAATCACTTGAACCTGGGAGGCGGAGATTGCAGTGAGCCGAGATCATGCCACTGTACTCCATCCTGGGTGACAAGAGTGAGACTGCATCTCAAAAAAAAAAAAAACCAAAAAACCAAAAAAAACCAAAAAATTAGTCAACCGTAGTGGTGGGCCCCTATAATCTCAGCTGCTCAGGAGGCTGAGGCAGTAGAATCACTTGATCCCAGGAGGTGGAGGTTTCAGTGAGCTGAGATCATGCCATTGTACTCCAGCCTGGGCAACAAGAGCAAAACTCTATCTCAAAAAAAAAAAAAAAAAAGAAAAA","GGCTGGGCGCAGTGGCTCACACCTGTAATCCCAGCACTTAGGGAAGCTGAGGCGAGTAGATCACCTGAGGTCAGGAGTTAGAGACCAGCCTGGCCATCATGGTGAAACCCCGTCTCTACTAAAGATACCAAAAATTAGCTGAGTGTGGTGCTGGGTGCCTGTAATCCCAGAAACTCAGGGTGCCTGTAATCCCAGCAACTCAGGGTGCCTTTAATCCCAGCAACTGAGGGTACCAGTAATCCCAGCAACTCAGGGTGTCTTTAATCCTAGCAACTGAGGGCACCTGTAATCCCAGCAACTCAGGAAGCTGAGACAGGAGAAGTACTTGAACCCAGAAGGCAGAGGTTGCAGTGAGCCGATATTGCACCATTGCACTCCAGTCTGGGCAACAAGAGTGAAACTCTGTCTCAAAAAAAAA"
"chr15","23603280","23603615","JH378109","21565230","21565567","55","2038050","GGCCAGGCGCGGTGGCTCATGCCTATAAACTCAGCACTTTGAGAGGCTGAGGCGGGTGGGTCACCTGAGGTCAGGAGTTAGAGACCAGCCTGGCCAACATGGTGAAACCGTGTTTCTACTAAAGATACAACATTAGCCAGGCATGGTGGCGCATGCCTGTAATCCCAGCTACTAGGGAGGCTGCGGCAGGAGAATCGCTTGAACGCAGGAGGTGAAGGTTGCAGTGAGCTGAGATCGTGCCATTGCACTCCAGCCTGGGTGACAAGAGCGAAACTCCATCCCAATCAATCAATCAATCAATCAATCAATTAAATTAAAAAAATAAAAAGAAAGAAA","GGCCGGGCGCGGTGGCTCAAGCCTGTAATACCAGCACTTTGGGAGGCCGAGGCGGGTGGATCACGAGGTCAAGAGATCGAGACCATCCTGGTCAACATGGTGAAACCCCGTCTCTACTAAAAATACAAACAATTAGCTGGGCATGGTGGCGGGTGCCTGTAATCCCAGCTACTCCAGAGGCTGAGGCAGGAGAATTGCCTGAACCCAGGAGACGGAGGTTGCGGTGAGCCAAGATCGCGCCATTGCACTCCAGCCTGGGTGACAAGAGCGAAACTCCGTCTCAATAAATAAATAAATAAATAAATAAATAAAAATAAAATAAATAAATAAATAAATAA"
"chr15","38315253","38315599","JH378169","5922203","5922541","56","32393050","GCCAGACACGGTGGCTCACGCCTGTAATCCCAGCACTTTGGGAGGCCGAGGCGGGTGGATCACCTGAGGTCAGGAGTTCGAGACCAGCCTGGCCAACATGGCGAAATCCTGTCTCTACTAAAAATACACACACACACACACACACACACACACACACACACACACATACACACACAAAATTAGCTGGGCATGGTGGCAGGTGCCTGTAATCCCAGCTACTTGGGAGGCTGAGGCAGGAGAATCACTTGAACCTGGGAGGCGGAGATTGCAGTGAGCCAAGATCATGCCATTGCACTTCAGCCTGGGCAACGAGAGTGAAACTCTGTCTCAAAAAAAAAAAAAAAAAA","GGCCAAGGGTGGTGGCTCACACCTGTAATCCCAACACTCTGGGAGGCCAAGGTGGGTGGATCACCTAAGGTCAGGAGTTCAAGACCAGCATGGCCAATATAGTGAAACTCTGTCTCTACTAAAAATACACACACACAAAAAAAAACAAAACACAAAAAAAACCACAAAATTAGCCGGGCATGGTGGCATGTGCCTGTAATCCCAGCTACTCAGGAGGCTGAGGCAGGAGAATCACTTAAACCCAGGAAGCGGAGGTTGCAGTGAGCCAAGATTGCGCCACTGCACTCCAGCCTAGGTGACAAGAGCAAAACTCTGTCTCAAAAAAAAAAAAAAAAAAAA"
"chr15","39410478","39411079","JH378118","18053084","18053501","249","21357394","GGCCGGGCACGGTGGCTCACGCCTGTAATCCCAGCACTTTGGGAGTCTGAGGTGGGCAGATCCACCTGAGGTCAGGGGTTCAAGACCAGCATGGCCAACATGGTGAAACCTCATCTCTACTAAAAATACAAAAATTAGGCTGGGTGCGGTGGCTCACGCCTGTAATCCCAGCACTTTGGGAGGCCAAGGCAGGTGGATCACCTGAGGTCAGGAGTTCGAGACCAGCATGGCCAACATAGCGAAAATCCGTCTCTACTAAAAACACAAAAATTAGCCAGGTGTGTTGGCTTACACCTGTAATCCCAGCTACACAGGAGGCTGAGGCAGAAGAATCACTTGAATCCAGGAGGTGGAGGTTGCAGTGAGCCGAGATCGCGCCACTGCCCTCCAGCCTGGGTGACAGAGCAAGACACCATCTCAAAAAAAAAAAAAAAAAAATTAGCTGGGCATGGTCACAGGTGCCCCTAATCCCAGCTACTCAGGAGGCTGAGGCAGGAGAATTGCTTGAACCCAGGAGACGGAGGTCACAGTGAGCGGTAATTGTGCCATTGCACTTCAACCTGGGTGACAAGAGCAAAAGTCCATCTCAAAAAAAAAAAAAA","GGCTGGGCGCAGTGGCTCACACCTGTAATCCCAGCACTTAGGGAAGCTGAGGCGAGTAGATCACCTGAGGTCAGGAGTTAGAGACCAGCCTGGCCATCATGGTGAAACCCCGTCTCTACTAAAGATACCAAAAATTAGCTGAGTGTGGTGCTGGGTGCCTGTAATCCCAGAAACTCAGGGTGCCTGTAATCCCAGCAACTCAGGGTGCCTTTAATCCCAGCAACTGAGGGTACCAGTAATCCCAGCAACTCAGGGTGTCTTTAATCCTAGCAACTGAGGGCACCTGTAATCCCAGCAACTCAGGAAGCTGAGACAGGAGAAGTACTTGAACCCAGAAGGCAGAGGTTGCAGTGAGCCGATATTGCACCATTGCACTCCAGTCTGGGCAACAAGAGTGAAACTCTGTCTCAAAAAAAAA"
"chr15","45225530","45226131","JH378133","19690365","19690767","253","25535165","GGCCGGGCACAGTGGCTCATGCCTGCAGTTCCAGCACTTTTGGAGGCCGAGGCAGGCCGATCACTTGAGGTCAGGAGTTCGAGACCACCCCGGCTAACGTGGTGCAACTCCATCTCTACTAAAAATACAAAATTGGCCGGGTGCGGTGGCTCATGCCTGTAATCCCAGCACTTTGGGAGGCCGAGGCGGATGGATCACCTCAGGTCAGGAGTTCGAGACCAGCCTGGCCAATGTGGTGAAACCCCGTCTCTACTAATAATACAAAAATTAACTGGGTGTGGTGGTGGGCACCTATAATCCCAGCTACTCGGGAAGCTGAGGCAGGAGAATCACTTGAACCTGGGAGGTGGAGATTGCAGTGAGCTGAGATGGTGCCATTACACTCCAGCCTGGGCAACGAGAGTGAAACTCTGTCTCTAAATAAATAAATACAAAATTAGCCGGGCATGGTGGCGGATGCCTATAATCACAGCTACTTGGGAGGCTGAGGCAAGAGAATCACTTGAACCTGGGAGGTGGAGGTTGCAGTGAGCTGAGATCAAGCCATTGCACTCCAGCCTGGGCAAAAAGAGTGAAACTCTGTCTCAAAAAAAAGAAAGAAA","GGCCAGGCACAGTGGTTCATGTCTGTAATCAGCATTTTGGGAGGCTGAGGCGGGAGAATCACCTGAGGCCAGGAGTTCTAGATGAGCCTGGGCAAATAGTGACAACCTGTCCCTACAAAAAAATTTAAAATTAGCCAGGATTGAGACCATCCTGGCTCACGTGGTGAAACCCCATCTTTACTTAAAATACTTAAAATGCAAAAAACATTTTTTTTTGTATTTTATTTAAAATACAAAAAAACTAGGCAGGCATGTTGGCACGTGCCTGTAGTCCCAGATACTTGGGAGGCTGAGGCAAGAGAATCACTTGAACCCAGGAGGTGGAGGTTGCAGTGAGCCGAGATCATACCACTGCACTCCAGCCTGGGTGACAAGAGTGAAACTCTGTCTCAAAAAAAAACAA"
"chr15","46581057","46581661","JH378118","18053084","18053501","254","28527973","GGCCGGGCGCGGTGGCTCACGCCTGTAGTCCCAGACTTTGGGAGGCCGAGGTGGGCGGATTGCCTGAGGTCAGGAGTTCAAGACCAACCTGGCCAACATGGTGAAATGCCGTCTCTACTAAAAATACAAAAATTAGGCCGGGCACGGTGGCTCATGTCTATAATCCCAGCACTTTGGGAGGCCGAGGTGGGCGGATCACGAGGTCAGGAGATCGAGACCATCCTGGCTAACACGGTGAAACCCCGTCTCTACTAAAAACACAAAAAATTAGCCGGGCGTGGTGGCAGGCACCTGTAGTCTCAGCTACTCAGGAGGCTGAGGCAGGAGAATGGCGTGAACTTGGGAGGCGGAGCTTGCAGTGAGCCAAGATTGTGCCACTGCACTCCAGCCTGGGCAACAGAGCGAGACTCTGTCTCAAAAAAAAAAAAAAAAATTAGCCAGGTGTGGTGGCAGGTGCCTGTAATCCCAGCTAATTGGGAGGCTAAGGCAGGAGAATCTCTTGAACCCAGGAGGCAGAGGTTGCAGTGAGCCAAGATTTCGCCATTACACTCCAGCCTGGGCAACAAGAGCTAGACTCCATCTCAAAAATAAATAAATAAAATAAA","GGCTGGGCGCAGTGGCTCACACCTGTAATCCCAGCACTTAGGGAAGCTGAGGCGAGTAGATCACCTGAGGTCAGGAGTTAGAGACCAGCCTGGCCATCATGGTGAAACCCCGTCTCTACTAAAGATACCAAAAATTAGCTGAGTGTGGTGCTGGGTGCCTGTAATCCCAGAAACTCAGGGTGCCTGTAATCCCAGCAACTCAGGGTGCCTTTAATCCCAGCAACTGAGGGTACCAGTAATCCCAGCAACTCAGGGTGTCTTTAATCCTAGCAACTGAGGGCACCTGTAATCCCAGCAACTCAGGAAGCTGAGACAGGAGAAGTACTTGAACCCAGAAGGCAGAGGTTGCAGTGAGCCGATATTGCACCATTGCACTCCAGTCTGGGCAACAAGAGTGAAACTCTGTCTCAAAAAAAAA"
"chr15","46659994","46660594","JH378118","18053084","18053501","247","28606910","GCTGGGCATGGTGGCTTACGCCTGTAATCCCAGCACCTTGGGAGGCTGAAGTGAGCAAATCACCTGAGTTCAGGAGTTCAAGACCAGCCTGGCCAACATGGTGAAAACCCATCTCTATTAAAAATTACAAAAATGGCCAGACACGGTAGCTCACGCCTGTAATCCCAGCACTTTGGGAGGCTGAGGCGGGCAGATCACCTGAGGTTGGGAGTTGGAGACCAGCTTGACCAACATGGAGAAACCCCCTCTCTACTAAAAATACAAAATTAGCCAGGCGTGGTGGCACATGCCTGTAATCCCAGCTACTTGGGAGGCTGAGGCAGGAGAATCACTTCAACCCGGAAGGTGGAGGTTGTGGTGAGCTGAGATTGTGTCATTGCACTCTAGCCTGGATAACAAAGGCAAAACTCAGTCTCAAAAAAAAAAAAAATTACAAAAATTAGCTGGCGTGGTGGCAGGTGCCTATAATCCCAGCTACTCAGGAAGCTGAGGCAGGAGAATCACTTGAAACCAGGAGGCAGAGGTTGCAGTGAGCTGAGACCACGCCATTGCCCTCCTGCCTGGGTGACAAGAGTGAAACTCCATCTCAAAAAAAAAAAAA","GGCTGGGCGCAGTGGCTCACACCTGTAATCCCAGCACTTAGGGAAGCTGAGGCGAGTAGATCACCTGAGGTCAGGAGTTAGAGACCAGCCTGGCCATCATGGTGAAACCCCGTCTCTACTAAAGATACCAAAAATTAGCTGAGTGTGGTGCTGGGTGCCTGTAATCCCAGAAACTCAGGGTGCCTGTAATCCCAGCAACTCAGGGTGCCTTTAATCCCAGCAACTGAGGGTACCAGTAATCCCAGCAACTCAGGGTGTCTTTAATCCTAGCAACTGAGGGCACCTGTAATCCCAGCAACTCAGGAAGCTGAGACAGGAGAAGTACTTGAACCCAGAAGGCAGAGGTTGCAGTGAGCCGATATTGCACCATTGCACTCCAGTCTGGGCAACAAGAGTGAAACTCTGTCTCAAAAAAAAA"
"chr15","46772064","46772669","JH378118","18053084","18053501","251","28718980","GGCTGGGTGCAATGGCTCATGCCTGTAATTCCAGTGTTTTGGGAGGCCGAGGCAGGTGGATCACTTGAGATCAGGAGTTCGCGACCAACCTGGCTAACATGGTGAAACCCCGTCTCTACTAAAAATACAAAAAATTGGCCAGGAGCGGTGGCTCAAACCTGTAATTCCAGCACTTTGGGAGGCCGAGGGGGGCAGATCACGATGTTTAGGAGTTTGAGATCAGACTGACCAACATGGTGAAACCCCATCTCTACTAAAAATACAAAAATTAGCCAGGCGTGGTGGTGCATGTCTGTAATCCCAGCTACTTGGGAGGCTGAGGCAGGAGAGTTGCTTGAAGCCGGGAGGTGGAGGTTGCAGTGAGCTGAGATCACACCACTGCACTCCAGCCTGGGCGACAGAGCAAGACTGTCTCAAAAAAAAAAAAAAAAAAAAAAATTAGCCAGCTTGGTGGCGGGCATCTGTAATCCCAGCTACTCGGGAGGCTGAGGCAGGAGAATCACTTGAACCCAGGAGGCAGAGGTCGCAGTGAGCCAAGATCACGCCATTGTACTCCAGCCTGGGCAACAAGAGCAAAACTCCATCTCAAAAAACAAAAAATAAAAA","GGCTGGGCGCAGTGGCTCACACCTGTAATCCCAGCACTTAGGGAAGCTGAGGCGAGTAGATCACCTGAGGTCAGGAGTTAGAGACCAGCCTGGCCATCATGGTGAAACCCCGTCTCTACTAAAGATACCAAAAATTAGCTGAGTGTGGTGCTGGGTGCCTGTAATCCCAGAAACTCAGGGTGCCTGTAATCCCAGCAACTCAGGGTGCCTTTAATCCCAGCAACTGAGGGTACCAGTAATCCCAGCAACTCAGGGTGTCTTTAATCCTAGCAACTGAGGGCACCTGTAATCCCAGCAACTCAGGAAGCTGAGACAGGAGAAGTACTTGAACCCAGAAGGCAGAGGTTGCAGTGAGCCGATATTGCACCATTGCACTCCAGTCTGGGCAACAAGAGTGAAACTCTGTCTCAAAAAAAAA"
"chr15","48446925","48447526","JH378118","18053084","18053501","252","30393841","GGCCAAGTGCAGTGGCTCACGTTTGTAATCCCAGCACTTTGGGAGGCCGAGGCGGGTGGATCACCTGATGTCAGGGGTTTGAAACCAGCCTGGCCAACATGGTGAAACCCCATCTCTAATAAAAATACAAAACTGGCCAGGTGCAGTGGCTCATGCCTGTAATCCCAGCACTTTGAGAGACCAAGGGAGGCAGATCACCTGAGGTCAGGAGTTCCAGACCAGCCTAGCCAACATGGTGAAACCCTATCTCTACTAAGAGTACAAAAATTAGCCTGGCGTGGTGGCAGGCGCCTGTAATCCCAGCTACTCAGAAGGCTGAGGCAGGAGAATCACTTGAACCCAGGAGGCGGAGGTTGCAGTGAGCCGAGATTGAGCCACTACACTCCAGCCTGGGTGACAAGAACAAGACTCTGTCTCAAAAAAAAAAAAAAAAAAAGCCGGTCATGGTGGCACATGCCTATAATCCCAGCTTCTTGGGAGGCTGAGGCAGGAGAACCACTTGAACCTGGGAGGTGGAGGCTGCAGTGAGCCGAAATTGTGCCATTGCACTCTAGCCTGGGCAACAAGAGCAAAACTCTCTCAAAAAAAAAAAAAAAAAAAAA","GGCTGGGCGCAGTGGCTCACACCTGTAATCCCAGCACTTAGGGAAGCTGAGGCGAGTAGATCACCTGAGGTCAGGAGTTAGAGACCAGCCTGGCCATCATGGTGAAACCCCGTCTCTACTAAAGATACCAAAAATTAGCTGAGTGTGGTGCTGGGTGCCTGTAATCCCAGAAACTCAGGGTGCCTGTAATCCCAGCAACTCAGGGTGCCTTTAATCCCAGCAACTGAGGGTACCAGTAATCCCAGCAACTCAGGGTGTCTTTAATCCTAGCAACTGAGGGCACCTGTAATCCCAGCAACTCAGGAAGCTGAGACAGGAGAAGTACTTGAACCCAGAAGGCAGAGGTTGCAGTGAGCCGATATTGCACCATTGCACTCCAGTCTGGGCAACAAGAGTGAAACTCTGTCTCAAAAAAAAA"
"chr15","59372839","59373447","JH378118","18053084","18053501","260","41319755","GGCCAGGATCAGTGTCTCACACCTGTAATCCTAGCACTTTGGGAGGCTAAGGTGGGCGGATTACTTGAGGTCAGGAGTTTGAGACCAGCCTGGGCAACATGGTGAAACCCCGTCTCTACTAAAAATACAAAAATTAGCTGGGCATAGGCCAGGAGTGGTGGCTTACGCCTGTAATTCCAGGACTTTGGGAGGCTGAGGCGGGCAGATCATGAGGTCAGGAGATTGAGACCATCCTGGCTAACATGGTGAAACCTCATCTCTACTAAAAATACAAAAATTAGCCAGTCGTGGTGGTAGGCGCCTGTAGTCCCAGCTACTTGAGAGGCTGAGGCAGGAGAATCACTTGAATCCGGGAGGTGGAGGTTGCAGTGAGCCGAGATTATGCCACTTCACTCCAACCTGGTGACAGAGCAAGACTCCGTCTAAAAAAAAAAAAAAAAATTAGCTGGGTGTGGCGGGCACTTGCAATCCCAGCTACTTAGGAGGCTGAGGCAGGAGAACCGCTTGAACCTGGGAGGTAGAGGTTCCAGATCACGCCATTGCACTCCTGCTTGGGCAACAAGAGTGACACTCCATCTCAAAAAAACAAAAAAAAAAAAGAAAAAGAAA","GGCTGGGCGCAGTGGCTCACACCTGTAATCCCAGCACTTAGGGAAGCTGAGGCGAGTAGATCACCTGAGGTCAGGAGTTAGAGACCAGCCTGGCCATCATGGTGAAACCCCGTCTCTACTAAAGATACCAAAAATTAGCTGAGTGTGGTGCTGGGTGCCTGTAATCCCAGAAACTCAGGGTGCCTGTAATCCCAGCAACTCAGGGTGCCTTTAATCCCAGCAACTGAGGGTACCAGTAATCCCAGCAACTCAGGGTGTCTTTAATCCTAGCAACTGAGGGCACCTGTAATCCCAGCAACTCAGGAAGCTGAGACAGGAGAAGTACTTGAACCCAGAAGGCAGAGGTTGCAGTGAGCCGATATTGCACCATTGCACTCCAGTCTGGGCAACAAGAGTGAAACTCTGTCTCAAAAAAAAA"
"chr15","64220715","64221335","JH378118","18053084","18053501","268","46167631","CCAGGCACAGTGGCTCATACCTGTAATCCCAGCACTTTGGGAGCCCAAGGCGGGCAGATCACCTGAGGTCAGGAGTTCGAGACCAGCCTGGACAACATGGAGAAACTCCATCTCTACTAAAAATACAAAATGAGGCCGGGCACAGTGGCTCACACCTATAATCCCAGCACTTTTGGAGGCCGAGACAGGCAGCTCACGAGGTCAGGAGTTCAAGACCAGCCTGGCCAGCATGGTGTAACCCCGTTTCTACTAAAAATACAAAAATTAGCCAGGCATGGTGGTGCGTGCCTGTAGTCCTCAGGAGGCTGAGGCAGGAGAATCGCTTGAATCTGGGAGGCGGAGCTTGCAGTCAGCTGAGATCAGGCTACTGCACTGCAGCTTGGGCAACAGAGTGAGACTCCGTCTCAAAAACAAACAAACAAACAAACAAAACACAACAAAATTAGCTGGGCATGGTGGCAGGTGCCTGTAATCCCAGCTACTCAGCTACTCAGGAGGCTGAGGCAGGAGAGTCACGTGAACCTGGGAGGCAGAGGTTGCAGTGAGCCAAGATCACGCCATTGCACTCCAGCCTGGGCAACAAGAGGGAAATTACATCTCAAAAAAAAAAAAAAAAAAAAA","GGCTGGGCGCAGTGGCTCACACCTGTAATCCCAGCACTTAGGGAAGCTGAGGCGAGTAGATCACCTGAGGTCAGGAGTTAGAGACCAGCCTGGCCATCATGGTGAAACCCCGTCTCTACTAAAGATACCAAAAATTAGCTGAGTGTGGTGCTGGGTGCCTGTAATCCCAGAAACTCAGGGTGCCTGTAATCCCAGCAACTCAGGGTGCCTTTAATCCCAGCAACTGAGGGTACCAGTAATCCCAGCAACTCAGGGTGTCTTTAATCCTAGCAACTGAGGGCACCTGTAATCCCAGCAACTCAGGAAGCTGAGACAGGAGAAGTACTTGAACCCAGAAGGCAGAGGTTGCAGTGAGCCGATATTGCACCATTGCACTCCAGTCTGGGCAACAAGAGTGAAACTCTGTCTCAAAAAAAAA"
"chr15","65873443","65873774","JH378165","3784440","3784761","45","62089003","GGCCAGGCACGGTGGCTCACACGTGTAATCCCAGCACCTTGGGAGACCGAAGCAGGTGGATCACCTGAGGTCAGGAGTTTGAGGCCAGCCTGGCCGATATGGTGAAACCCTATCTCTATTAAAAATACCAAAAAAAAAAAAAAAAAAAAAAAAACCTGCTGGGCGTGGTGGCGCACGCCTGTAATCCCAACTACTCAGGAGGCTGAGGCAGGAGAATCACTTGAATCCAGGAGGCAGAGGTTGCAGTGAGCCGAGATCGCGCCATTGCACTCCAGCCTGGGCAACAAGAGCGAAACTCGGTCTCAAAAAAAAAAAAAAAAAAAGAAAAGAAA","GGCCGGGCGCGGTGGCTCAAGCCTGTAATCCCAGCACTTTGGGAGGCCGAGGCAGGTGGATCATGAGGTCAAGAGATCAAGACCATCCTGGTCAACATGGTGAAACCCCGTCTCTACTAAAAATACAAAAAAAAAAAAAAAAAAACTAGCTGGGCGTGGTGGCGCATGCCTGTAATCCCAGCTACTCAGGAGGCTGAGGCAGGAGAATTGCTTGAACCCAGGAGGCGGAGGTTGCGGTGAGCCCAGATCGCGCCATTGCACTCCAGCCTGGGTAACAAGAGCAAAACTCCATCTCAAAAAAAAAAAAAAAAAAAAAAAAAAA"
"chr15","70453292","70453944","JH378118","18053084","18053501","292","52400208","GGCCAGGCACGGTGGCTCATGCCTGTAATCCCAACACTTTGGGAGGCTGAGGTAGGTAGATCACCTGAGGTTGAGGTCAGGAGTTTGAGACCAGCCTGGCCAACATGGTGAAACTCTGTCTCTACTAAAAATACAAAAATTTGGCCCGGCGCAGTGGCTCACCTGTAATCCCAGCACTTTGGGAGGCCGAGGCAGGCAGATCACGAGGTCTGGAGATCAAGACCATCCTGGCTAACTCGGTGAAATCCCATCTCTACTAAAAATACGAAAAATTAGCCAGGTGTGGTGGCGGGCACCTGTAGTCCCAGCTACTTGGGAGGCTGAGGCAGGAGAATGGCGTGAACCTGGGAGGTGGAGCTTGCAGTGGGCCAAGATCACGCCACTGCACTCCAGCCTGGGCAACAGAGTGAGACTCTGTCTCAAAATAAAATAACATAAAATAAAATAAAGTAATATAAAATAAAAATACAAAAATTAGCTGGGCATGGTAGCGGGTACCTATAATTCCAGCTACTTGAGAGGCTGAGGCTGGAGAATCACTTGAATCTGGGAGGTGGAGGTTGCAGTGAGCCAAGATTGCACCATTGCACTCCAGCCTGGGCAACAAGAGCCAAACTCCGTATCAAAAAAAAAAAAAAAAAGAAAAAGAAAAA","GGCTGGGCGCAGTGGCTCACACCTGTAATCCCAGCACTTAGGGAAGCTGAGGCGAGTAGATCACCTGAGGTCAGGAGTTAGAGACCAGCCTGGCCATCATGGTGAAACCCCGTCTCTACTAAAGATACCAAAAATTAGCTGAGTGTGGTGCTGGGTGCCTGTAATCCCAGAAACTCAGGGTGCCTGTAATCCCAGCAACTCAGGGTGCCTTTAATCCCAGCAACTGAGGGTACCAGTAATCCCAGCAACTCAGGGTGTCTTTAATCCTAGCAACTGAGGGCACCTGTAATCCCAGCAACTCAGGAAGCTGAGACAGGAGAAGTACTTGAACCCAGAAGGCAGAGGTTGCAGTGAGCCGATATTGCACCATTGCACTCCAGTCTGGGCAACAAGAGTGAAACTCTGTCTCAAAAAAAAA"
"chr16","217191","217526","JH378138","4229795","4230103","77","4012604","ATTTTGGGAGGCTGAGATGAGTGATGAGCGGATCACCTGAGGTCAGGAGCTCGAGACCAGTCTGGCCAACACGGTGAAACCCTGTCTCTACTAAAAGTACCAAAAAAATTAGCCAGGCATGGCAGTGGGCGCCTGTAATCCCAACTACTCGGGAGGCTGAGGCAGGAGAATCACTTGAACCTGGGAGGTGGATGTAGCAGTGAGCCGGGATCGTGCCACTGAACTCCAGCCTGGGCGATAAGATCAAAACTCTGTCTCTCTCTCACACACACACACACACACACACACACACACACACACACCCCCAAAAAAAAAAACAAAAAAAAGAAAAAGAAA","CACTTTGGGAGGTGAAGGCGGGCAGATCACCTGAGGTCAGGAGTTCGAGACCAGCCTGGCCAACATGGTGAAACCCCGCCTCTACTAAAAATACAAAAATTAGCCAGGTGTGACACTAGGCATCTGTAATCCCAGCTACTTGGGAGGCTGAGACAGGAGAATCACTTGAACCCAGGAGGCGGAAGTTGCAGTGAGCCAAGATCATGCCATTGCACTCCAGCCTGGGTGACAGGAGCAAAACTCTGTCTCAAAAAAAAAAAAAAAAAAAAAAAAAAAAAAAAAAAAAAAAGAAAAGAAAAGAAAAGTAAA"
"chr16","384893","385508","JH378118","18053084","18053501","265","17668191","GGCCGGGCGTGGTGGCTAACACGGGTAGTCCTAGCACTTTGGGAAGCCAAGGCAGGCAGATCACTTGAGGTCAGGAGTTTGAGATCAGTCTGGCCAACATGGTGAAACCACGCCTCTACTAAAAATACAAAAGTTATGGCCGAGCGTGGTGGCACGCGCCTGTAATCCCAGCACTTTGGGATGCTGAGGCAGGCGCATCACCTAAGGTCGGGAATTCAAGACCAGCCTGACCAACATGGAGAAACCACGTTTCTACTAAAAATACAAAATTAGCCGGGTGTGGTGGCACATGCCTGTAGTTTCAGCTACTCAGGAGGCTGAGGCAGGAGAATCACTTGAATCCGGGAGGCGGAGATTGTGGTGAGCCGAGATCGGGCCATTGCACTCCAGCCTGGGCAACAAGAGAGAAACTCTGTCTCAAAAAAAAAAAAAAAAAATTAGCCAGGCATGGTAGCCTGTGCCTGTAATCCCAGCTACTTGGGAGGCTGAGGCAGGAGAATCGCTTGAACCTGGGAGGCAGAGGTTGCAGTGAGCCGCGATTGCGCCATTGCACTCTCCAGCCTGGGGGAGAAGAGCAAAACTCCATCTCAAAAATAAATAAATAAATAAAAATAAA","GGCTGGGCGCAGTGGCTCACACCTGTAATCCCAGCACTTAGGGAAGCTGAGGCGAGTAGATCACCTGAGGTCAGGAGTTAGAGACCAGCCTGGCCATCATGGTGAAACCCCGTCTCTACTAAAGATACCAAAAATTAGCTGAGTGTGGTGCTGGGTGCCTGTAATCCCAGAAACTCAGGGTGCCTGTAATCCCAGCAACTCAGGGTGCCTTTAATCCCAGCAACTGAGGGTACCAGTAATCCCAGCAACTCAGGGTGTCTTTAATCCTAGCAACTGAGGGCACCTGTAATCCCAGCAACTCAGGAAGCTGAGACAGGAGAAGTACTTGAACCCAGAAGGCAGAGGTTGCAGTGAGCCGATATTGCACCATTGCACTCCAGTCTGGGCAACAAGAGTGAAACTCTGTCTCAAAAAAAAA"
"chr16","1668152","1668787","JH378118","18053084","18053501","287","16384932","GGCCGGGCACGGTGCCTCGTTCCTGTAATCCCAGCACTTTGGGAGGCCAAGGTGGGTGGATCACCTGAGGTCAGGAGTTCGAGACATGCCTGGCCAACATGGCAAAATCCTGTCTTTACTAAAAATACAAAAATTAAGCCGGGCGCTGTGACTCATGCCTGTAATCCCAGCACTTTGGGAGGCCAAGGCGGGCGGATCACAAGGTCAGGAGATTGAGACCATCCTGGCTAACACGGTGAAAACCCGTCTCTACTAAAAATACAAAAAATTAGCCAGGTGTGGTGGCGGGTGCCTGTAGTCCCAGCTACTCGGGAGGCTGAGGCAGGAGAATGGCGTGAACCCGGGAGGCGGAGCTTGCAGTGAGCCGAGATCGTGCCACTGCACTCCAGTCTGGGCAACAGAGCAAGACTCTCTCTCAAAAAGAAACAAACAAAAAAAAAAATGAAAAAAGAAAAATTAGCCAGGCGTGGTGGCGGGTGCCTATAATCTCAGCTACTCGGGAGGCTGAGGCAGAAGTATCATTTGAACCCAGGAGGCGGAGGTTGTAGTGATCCAAGATAGCGCCATTGCACTGCAGCCTGGGTGACAACAGTGAAACTCCGTCTCAAAAAAAAAAAAAAAAAAGAAAGAAAGAAA","GGCTGGGCGCAGTGGCTCACACCTGTAATCCCAGCACTTAGGGAAGCTGAGGCGAGTAGATCACCTGAGGTCAGGAGTTAGAGACCAGCCTGGCCATCATGGTGAAACCCCGTCTCTACTAAAGATACCAAAAATTAGCTGAGTGTGGTGCTGGGTGCCTGTAATCCCAGAAACTCAGGGTGCCTGTAATCCCAGCAACTCAGGGTGCCTTTAATCCCAGCAACTGAGGGTACCAGTAATCCCAGCAACTCAGGGTGTCTTTAATCCTAGCAACTGAGGGCACCTGTAATCCCAGCAACTCAGGAAGCTGAGACAGGAGAAGTACTTGAACCCAGAAGGCAGAGGTTGCAGTGAGCCGATATTGCACCATTGCACTCCAGTCTGGGCAACAAGAGTGAAACTCTGTCTCAAAAAAAAA"
"chr16","2310740","2311369","JH378118","18053084","18053501","271","15742344","GGCCGGGCACAGTGGCTCACGCCTATAATATCAGCACTTTGGGAGACCAAGGCGGGTGGATCACCTAAGGTCAGGAGTTCAAGACCAGCCTGACCAACATGGTGAAACCCCATCTCTACCAAAAATAGAAAACATTAGTCTTGGCCGGGCACGGTGACTCATACCTGTAATTCCAGCACTTTGGGAGGCCGATCACCTGGCGGATCACCTGAGGTCGGGAGTTTGAGACCAGCCTGACCAACATGGAGAAACCCCGTCTCTACTAAAAATACAAAATTAGCTGTGCGTAGTGGCCCATGCGTGTAATCCCAGCTACTCAGGAGACTGAGGCAGGAGAATGGCTTGAACCTGGGAGGCGGAGGTTGTGCTGAGCCAAGATCGCACCATTGCACTCCAGCCTGGGCAATAAGAGTGAAACTCCGTTTCATAAAACAAAAAACAAAAAACAAAAAAAAAACCATTAGCCAGGCATTGTGGCAGGCACCTGTAATCCCAGCTACTCAGGAGGCTGAGGCAGAATGGCTTGAACCGGGGAGGCAGAGGTTGCAGTGAGCCGAGATCGCGCCATTGCACTCCAGCCTGGGCAACAAAAGTAAAACTCTGTCTCAAATAAAAAAAAGAGAGAAAAAA","GGCTGGGCGCAGTGGCTCACACCTGTAATCCCAGCACTTAGGGAAGCTGAGGCGAGTAGATCACCTGAGGTCAGGAGTTAGAGACCAGCCTGGCCATCATGGTGAAACCCCGTCTCTACTAAAGATACCAAAAATTAGCTGAGTGTGGTGCTGGGTGCCTGTAATCCCAGAAACTCAGGGTGCCTGTAATCCCAGCAACTCAGGGTGCCTTTAATCCCAGCAACTGAGGGTACCAGTAATCCCAGCAACTCAGGGTGTCTTTAATCCTAGCAACTGAGGGCACCTGTAATCCCAGCAACTCAGGAAGCTGAGACAGGAGAAGTACTTGAACCCAGAAGGCAGAGGTTGCAGTGAGCCGATATTGCACCATTGCACTCCAGTCTGGGCAACAAGAGTGAAACTCTGTCTCAAAAAAAAA"
"chr16","3075498","3075819","JH378114","26407278","26407597","46","23331780","GGCCAGGCGCGGTGGCTCACACCTGTAATCCCAGCACTTTGGGAGGCCAAGGCGGGCAGATCACGAGGTCAAGAGATCGAGACCATCCTGGCCAACCTGGTGAAACTCTGTCTCTACTAAAAATACCAAAAAAAAAAAAAAAAAAAAAAAAAAAAAGCATGGTGGCAGGTGCCTGTAATCCCAGCTACTTGGGAGGCTGAGGCAGAATTGCTTGAACCCGGGAGGCAGAGGTTGCAGTGAGTTGAGATCATGCCATTGCACTCCAGCCTGGGCAAAAAGAGCGAAACTCTGTCTCAAAAAACAAAACAAAAACAAAAACAAA","GGCCGGGCGCAGTGGCTCAAGCTTGTAATCCCAGCACTTTGGGAGGCCGAGGCGGGTGGATCACGAGGTCAAGAGATCGAGACCATCCTGGTCAACATGGTGAAACCCCGTCTCTACTAAAAATACAAAAAAAAAAAAAAAAAATTAGTTGGGCATGGTGGTGTGTGCCTGTAATCCCAGCTACTCAGGAGGCTGAGGCAGGAGAATTGCCTGAACCCAGGAGGCGGAGGTTGCGGTGAGCCGAGATCGCGCCATTGCACTCCAGCCTGGGTAACAAGAGCGAAACTCCGTCTCAAAAAAAAAAAAAAAAAAAAAAAAAA"
"chr16","3161549","3162150","JH378118","18053084","18053501","252","14891535","CTGGGCACCGTGGCTCACGCCTGTAATCCCAACACTTTGGGAGGCCAAGGCGGGTGGAACACCTGAAGTCAGGAGTTCGAGACCAGTCTGGACAACATGATGAAACCCCGTCTCTACTAAAAATACAAAAAGTAGCCAGGTATGGCCGGGCGCGGTGGCTCACGCCTGTAATCCCGGCACTTTGAGAGGCCGAGGCAGGTGGATCACAAGGTCAGGAGTTCAAGAGCAGCCTGGCCAAGATAGTGAAACCCCGTCTCTACTAAAAGCAAAATTACAGTGCGCCTGTAATCCCAGCTGCTCGGGAGGCTGAGGCAGGAGAATCGCTTGAACCTGGAGGGCGGAGGTTGCAGTGAGCCAAGATCGCTCTACTGCACCCTAGCCTGGGTGACAGAGCAAGACTCTGTATCAAAAAAAAAATAAATAAATAATTAGCCAGGTATGGTGGTGCAGGCTTGTAATCCTAGCTGCTCAGGAGGCTGAGGCAGGAGAATCGATTGAACCCAGGAGACGGAGGTTGCAGTGAGCAGAGATCACACCATTGTACTCCAGCCTGAGTGACAAAAACGAAACTCCGTCTCAAAAAAAAACCAAAAAAACAAAAA","GGCTGGGCGCAGTGGCTCACACCTGTAATCCCAGCACTTAGGGAAGCTGAGGCGAGTAGATCACCTGAGGTCAGGAGTTAGAGACCAGCCTGGCCATCATGGTGAAACCCCGTCTCTACTAAAGATACCAAAAATTAGCTGAGTGTGGTGCTGGGTGCCTGTAATCCCAGAAACTCAGGGTGCCTGTAATCCCAGCAACTCAGGGTGCCTTTAATCCCAGCAACTGAGGGTACCAGTAATCCCAGCAACTCAGGGTGTCTTTAATCCTAGCAACTGAGGGCACCTGTAATCCCAGCAACTCAGGAAGCTGAGACAGGAGAAGTACTTGAACCCAGAAGGCAGAGGTTGCAGTGAGCCGATATTGCACCATTGCACTCCAGTCTGGGCAACAAGAGTGAAACTCTGTCTCAAAAAAAAA"
"chr16","3211652","3212251","JH378118","18053084","18053501","260","14841432","GTCAGACGCAGTAGTTTATGCCTGTAATCCTTGCACTTTGGGAGGCAGGTGGATCACCTGAGGCCAGGAGTTGGAGACCAGCCAGGCCAATATGGCAAAACCCCGTCTCTACTAAAAATACAAAAACTAGCCGGGCGCAGTGGCTCACACCTGTAATCCCAGCACTTTGGGAGGCTGAGGTGGGTGGATCACTAGGTCAGGAGTTCAAGACCAGCCTGGCCAACATGGTGAAACCGCGTCTCTACTAAAAACACCAAAAAATTAGCTGGGCGTGGTGGCAGTCGCCTGTAATCCCTGCTACTCGGAAGGCTGAGGCAGGAGAATCACTTGAACGCAGGAGGCAGAGGTTGCGGTGAGCCGAGATCACGCCACTGCACTCCAGCCTGGGTGACAGAGCAAGACTCTGTCTCAAAAAACAACAACAACAACTAGCTGGGCGTGGTGGCACATGCCTGTAACCCCAGCTACTCAGGAGGCTGAGGCTGAGGGAGAAAAATCGCTTGTACCTGGGAGGTGGAAGTTGCAGTGAGCGGAGATCCCACCATTGCACTCCAGCCTGGGTGACAAGAGCGAAACTCCATCTCAAAAAAAAAAAAAAAA","GGCTGGGCGCAGTGGCTCACACCTGTAATCCCAGCACTTAGGGAAGCTGAGGCGAGTAGATCACCTGAGGTCAGGAGTTAGAGACCAGCCTGGCCATCATGGTGAAACCCCGTCTCTACTAAAGATACCAAAAATTAGCTGAGTGTGGTGCTGGGTGCCTGTAATCCCAGAAACTCAGGGTGCCTGTAATCCCAGCAACTCAGGGTGCCTTTAATCCCAGCAACTGAGGGTACCAGTAATCCCAGCAACTCAGGGTGTCTTTAATCCTAGCAACTGAGGGCACCTGTAATCCCAGCAACTCAGGAAGCTGAGACAGGAGAAGTACTTGAACCCAGAAGGCAGAGGTTGCAGTGAGCCGATATTGCACCATTGCACTCCAGTCTGGGCAACAAGAGTGAAACTCTGTCTCAAAAAAAAA"
"chr16","3990675","3991277","JH378118","18053084","18053501","250","14062409","GGCTGGGCGTGGTGGCTCACGCCTTTAATCCCAGTACTTTGGGAGGCCGAGAAGGGCACATCACCTGAGGTCAGGAGTTTGAGACCAGCCTGGCCAATATGGTAAAACCCTGTCTCTACTTAAAAAATAGAAAAATCAGGCTGGACGCAGTGGCTCACGCCTGTAATCCCAGCACTTTGGGAGGCCGAGGCGGGTGGATCATGAGGTCAGGAGTTACCAGCCTGCCAACATGGTGAAACCCCATCTCTACTAAAAAAACAAAAAAAATTAGCCAGTCGTAGTGGCAGGCACCTGTAATCCCAGCCACTCGGGAGGCTGAGGCAGAGAATTGCTTGAACCTGGGAGGTGGAGATTGCTGTGCACCAAAATCACACCACTGCACTTGAGCCTGGGCGACAGAGGGAGACTCATCTGAAAAAAAAAAAAAAAAAAAAATTAGCCGGTTATGGTGGCAGGTGCCTGTGATCCCAGCTACTTGGGAGGCTGAGGCAGGAGAATTGCTTGAACCCGGGAGGCAGAGGTTGCAGTGAGCTGAGATCGCACCACTGCACTCCAGCCTGGAGGACAAGAGTGAGACTTGTCTGATTGGAAAAAAAAAAAAAA","GGCTGGGCGCAGTGGCTCACACCTGTAATCCCAGCACTTAGGGAAGCTGAGGCGAGTAGATCACCTGAGGTCAGGAGTTAGAGACCAGCCTGGCCATCATGGTGAAACCCCGTCTCTACTAAAGATACCAAAAATTAGCTGAGTGTGGTGCTGGGTGCCTGTAATCCCAGAAACTCAGGGTGCCTGTAATCCCAGCAACTCAGGGTGCCTTTAATCCCAGCAACTGAGGGTACCAGTAATCCCAGCAACTCAGGGTGTCTTTAATCCTAGCAACTGAGGGCACCTGTAATCCCAGCAACTCAGGAAGCTGAGACAGGAGAAGTACTTGAACCCAGAAGGCAGAGGTTGCAGTGAGCCGATATTGCACCATTGCACTCCAGTCTGGGCAACAAGAGTGAAACTCTGTCTCAAAAAAAAA"
"chr16","4259838","4260446","JH378118","18053084","18053501","263","13793246","GGCCGGGTGCAGTGGCTCACGCCTGTAATCGCAGGACTTTGGGAGGCCAAGGCAGGTGCATCACCTGAGGTCAGGATTTCAAGACCATCCAGCCTGATCAACATGGTGAAACCCTGTCTCTACTAAAAATATAAAAATTGGCCGGGCACAGTGACTCACGCCTGTAATCCCAGCACTTTGGGAGGCTGAGGCAGGTGGATCACAAGGTCAGGAGATCGAGACCATCCTGGCTAACACAGTGAAACCCCGTCTCTACTAAAAATATAAAAAATTAGCCGGGCGTGGTGGTAGGCACCTGTAGTCCCAGCTACTCGGGAGACTGAGGCAGGAGAATGGCGTGAACCTGGGAGGTGGAGCTTGCAGTGAGCAGAGATCGCGCCACTGTACTCCAGCCTGGGTGACAGAGCGAGACTCCGTCTCAAAAAAAAAAAAAAAAAAAAAAATTAGCTGGGCGTGGTGGCGGGCACCTGTAATCCCAGCTACTTGGGAGGCTGAGGCAGGAGAATTGCTTGAACCTGGGAAGTGGAGGTTGCAGTGAGCTGAGATTGTGCCCTTGTACTCCAGCCTGGGCAATAAAAGCAAAACTCCGTCTTAAAAAAAAAAAAAAAA","GGCTGGGCGCAGTGGCTCACACCTGTAATCCCAGCACTTAGGGAAGCTGAGGCGAGTAGATCACCTGAGGTCAGGAGTTAGAGACCAGCCTGGCCATCATGGTGAAACCCCGTCTCTACTAAAGATACCAAAAATTAGCTGAGTGTGGTGCTGGGTGCCTGTAATCCCAGAAACTCAGGGTGCCTGTAATCCCAGCAACTCAGGGTGCCTTTAATCCCAGCAACTGAGGGTACCAGTAATCCCAGCAACTCAGGGTGTCTTTAATCCTAGCAACTGAGGGCACCTGTAATCCCAGCAACTCAGGAAGCTGAGACAGGAGAAGTACTTGAACCCAGAAGGCAGAGGTTGCAGTGAGCCGATATTGCACCATTGCACTCCAGTCTGGGCAACAAGAGTGAAACTCTGTCTCAAAAAAAAA"
"chr16","4899850","4900511","JH378118","18053084","18053501","313","13153234","GGCCAGGCACGGTGGCATGCACCTGTAATCTCAGCTCTTTGGGAGGCTGAGGCAAGAGGATCACTTGAGCCCAGGAGTTGGTGATTGCAGTGAGCTCTGATCACTCCACTGCACTCCAGCCTGGGTGACAGAGTGAGATCCTGTCTCTACGAAAAAAAGACAAGACACAAATACGTTAAAAGTAAAATGATATAAAAAGATATTCCAGTGGGGCACAGTGGCTCACCCCTATAATCCCAACACTTTGGGAGGCTGAGGTGGGTGGATCACCTGAGGTCAGGAATTCAAGACCAGCCTGACCAACATGGAGAAACCCGTCTCTACTAAAAATACAAAATTAGCCGGGTGTGGTGGCACATGCCTGTAATCCCAGCTACTCAGGAGGCTGAGAATGGCTTGAACCTGGGAGGTGGAGGTTGTGGTGAGCCGAGATTGCACCACTGCACTCCAGCCTGGGCAACAAGAGCTGAAACTCCGTCGAAAAAAAAAATTAGCCTGGCGTGGTGGCGGGAGCCTGTAATCCCAGCTACTGGGGAGGCTGAGGCAGGAGAATCACTTGAACCTGGGAGGCAGAATTTGCAGTGAGCCGAGATCGCGCCACCACACTCCAGCCTGGGTGACAAAAACGAAACCCCATCTCAAAAAAATTAAAAAATAACAAA","GGCTGGGCGCAGTGGCTCACACCTGTAATCCCAGCACTTAGGGAAGCTGAGGCGAGTAGATCACCTGAGGTCAGGAGTTAGAGACCAGCCTGGCCATCATGGTGAAACCCCGTCTCTACTAAAGATACCAAAAATTAGCTGAGTGTGGTGCTGGGTGCCTGTAATCCCAGAAACTCAGGGTGCCTGTAATCCCAGCAACTCAGGGTGCCTTTAATCCCAGCAACTGAGGGTACCAGTAATCCCAGCAACTCAGGGTGTCTTTAATCCTAGCAACTGAGGGCACCTGTAATCCCAGCAACTCAGGAAGCTGAGACAGGAGAAGTACTTGAACCCAGAAGGCAGAGGTTGCAGTGAGCCGATATTGCACCATTGCACTCCAGTCTGGGCAACAAGAGTGAAACTCTGTCTCAAAAAAAAA"
"chr16","4919663","4920295","JH378118","18053084","18053501","281","13133421","CTGGGCGCAGTGGCTCACACCTATAATCCCAGCACTTTGGGAGGCCGAGGTGGGGTGGATCACTTGAGGTCAGGAGTTTGAGACCAGCCTGGCCAACATGGTGAAACCCCATCTCTTCTAGAAAAATACAAAATTAGGCTGGGCGCGGTGGCTCACGCTTGTAATCCCAGCACTTTGGGAGGCTGAGGCAGGCGGATCATCTGAGGTTGGGAGTTCGAGACCAGCCTGACCAACATAGAGAAACCCTGTCTCTACTAAAAATACAAAATTAGCCGGGCGTGGTGGCGCATGCCTGTAATCCCAGCTAGTCAGGAGGCTGAGGCAGGAGAATCCCTTGAACTGGGGAGGCAGAGGTTGTGGTGAGCCCAGATCGTGCCATTGCACTCCAGCTTGGGTAAGAAGAGCAAAACTCTGTCTAAAAAATATATATATTTATACATATATATATATTTATATATATAATTAGCCACGCATAGTGGCACACACCTGTAACCCCAGCTACCTGGGAGGATGAGGCAGGAGAATAGCTTGAACTTGGGAGGTGGAGGTTGCACTGAGCTGAGACTGCGCCATTGCATTCCAGCCTGGGCAACAAGAGCGAAACTGTCTCAAAAAAAAAAAAAAAAAAAAAAA","GGCTGGGCGCAGTGGCTCACACCTGTAATCCCAGCACTTAGGGAAGCTGAGGCGAGTAGATCACCTGAGGTCAGGAGTTAGAGACCAGCCTGGCCATCATGGTGAAACCCCGTCTCTACTAAAGATACCAAAAATTAGCTGAGTGTGGTGCTGGGTGCCTGTAATCCCAGAAACTCAGGGTGCCTGTAATCCCAGCAACTCAGGGTGCCTTTAATCCCAGCAACTGAGGGTACCAGTAATCCCAGCAACTCAGGGTGTCTTTAATCCTAGCAACTGAGGGCACCTGTAATCCCAGCAACTCAGGAAGCTGAGACAGGAGAAGTACTTGAACCCAGAAGGCAGAGGTTGCAGTGAGCCGATATTGCACCATTGCACTCCAGTCTGGGCAACAAGAGTGAAACTCTGTCTCAAAAAAAAA"
"chr16","5124255","5124811","JH378118","18053084","18053501","213","12928829","GGCCAGGTGCGGTGGCTCATGCGTGTAATCCCAGCGCTTTGGGAGGCTGAGGCAAGTGGATCACCTGAGGTCAGGAGTTTGAGACCAGCCTGGCCAACATGGGGAAATCCCTGTCTCTACTAAAAATACAAAAATTGGGCCGGGTGTGGTGGCTCACACCTGTAATCCCAGCACTTTGGGAGACTGAGGTGGGCGGATCACCCAAGGTCAGGAGTTTGAGACCATCCTGGCCAACATGGTGAAACCCCGTCTCTACTAAATAAATACAAAAAAGTAGCCGAGCGTGTTGGCGGATGCCTGTAATCCCAGCTACTTGGGAGGCTGAGGCAGGAGAATTGCTTGAACCCTGAGAGGTGGAGGTTGCAGTGAGCAGAGATTGTGCCACTGCACTCTGGCCTGGGCGACAAGAGGGAGTCTCTGTCTTAAAAAAAAAAAAAAAAAAAATTAGCTGGAAATCGCTTGAACCCAGGAGGCGGAGGTTGCAGTGAGCCGAGATTGTGCCACTGCACTCTGGCCTGGGCGACAAGAGCGAGATTCTGTCTCAAAAAAAAAAAAGA","GGCTGGGCGCAGTGGCTCACACCTGTAATCCCAGCACTTAGGGAAGCTGAGGCGAGTAGATCACCTGAGGTCAGGAGTTAGAGACCAGCCTGGCCATCATGGTGAAACCCCGTCTCTACTAAAGATACCAAAAATTAGCTGAGTGTGGTGCTGGGTGCCTGTAATCCCAGAAACTCAGGGTGCCTGTAATCCCAGCAACTCAGGGTGCCTTTAATCCCAGCAACTGAGGGTACCAGTAATCCCAGCAACTCAGGGTGTCTTTAATCCTAGCAACTGAGGGCACCTGTAATCCCAGCAACTCAGGAAGCTGAGACAGGAGAAGTACTTGAACCCAGAAGGCAGAGGTTGCAGTGAGCCGATATTGCACCATTGCACTCCAGTCTGGGCAACAAGAGTGAAACTCTGTCTCAAAAAAAAA"
"chr16","8088191","8088522","JH378114","21211700","21212024","70","13123509","GGCTGGGCGCGGTGGCTTTTGACCATAATCCCAGCACTTTGGGAGGCCGAGGTGGTCAGGTCACCTGAGGTCAGGAGTTCAAGAGCAGCCTGGCCAACGTGGTGAAACTCTGTCTCTACCAAAAATACCAAATAATAATAATAATAATAATAATAATAATAAAATAATATAATTGCAGGGTGTGGCAGCCCATGCATGTAATGCCAGCTACTTGGGAGACTGAGGCAGGATAATCACTTCAACCCAAGAGGCGGAGGTTGCAGTGAGCTGAGATCATGCCATTGCATTCCAGCGTAGGCAACAAGAGCGAAACTCTGTTTCAAATAAATAAA","GGCTGGGTGCGGTGGCTCAGGCCTGTAATCCCAGCACTTTGGGAGGCCGAGGTGGGTACATCACCTAAGGTCAGGAGTTCAAGACCAGCCTGACCAACATGGTAAAACCCTGTCTCTACTAAAATTACAAAAGAAAATTAGAAAAAAAAAAAAGAAAGAAAGAAAATTAGATGGCATGGTGGTGGCGGGCACCTGTAATTTCAACTACTCGGGAGGCTAAGGCAGGAGAATCACTTGAACCCAGGAGGTGGAGGTTGCAGTGAGCCGAGATCACACCATTGCACTGCAGCCTGGGCAATAAGAGCAAAACTCCATCTCAAAAAAA"
"chr16","9762791","9763467","JH378118","18053084","18053501","323","8290293","CAGGCATGGTAGCTCACGCCTGTAATCTCAGCACTTTGGGAGGCCGAGGTGCGCAGATCACTTGAGGTCAGGTGTTGGTGACCAGCCTGGCCAACATGGTGAAACCCTATCTCTACTAAAAATACAAAAATTATGGCCGGGCGCAGTGGCTCACGCCTGTAATCCCAGCACTTTGGGAGGCCGAGGTGGGCAGATCACTTGAGGTCAGGAGTTCAAGACCAGCCTAGGCAACATAGTGAAACCCCGTTGCTACTAAAAATACAAAAATTAGCTGGGCGTGATGGCACATACCTGTAGTCCCACCTACTTGGGAGGCTGAGGCAGGAAAATCGCTTGAACCTGGAGGCAGAGGTTGCAGCGAGCCAAGACTGTGCCAATGCACCACAGCCTGGATAACAGAGTGAGACTCAATCTCAAAAAAAAAAAAAAAAAAAAAAGGCGGGCTGGTGGCTCATGCCCATGCAAACCCCGTCTCTACTAAAAGGACAAAAATTAGCTGGGCATGGTGGCGGGGGCCTGTAATCTCAGGATTACAGGAGATACTACTACTCGGGAGGCTGAGGCAGTAGAATTGCTTGAACCAGGGAGGCGGAGGTTGCAGTGAGCTGAGATCGCGCCATTGCACTCCAGGCTGGGTGACAACAATGACTCCGTCTCAAAAACAACAACAACAACAA","GGCTGGGCGCAGTGGCTCACACCTGTAATCCCAGCACTTAGGGAAGCTGAGGCGAGTAGATCACCTGAGGTCAGGAGTTAGAGACCAGCCTGGCCATCATGGTGAAACCCCGTCTCTACTAAAGATACCAAAAATTAGCTGAGTGTGGTGCTGGGTGCCTGTAATCCCAGAAACTCAGGGTGCCTGTAATCCCAGCAACTCAGGGTGCCTTTAATCCCAGCAACTGAGGGTACCAGTAATCCCAGCAACTCAGGGTGTCTTTAATCCTAGCAACTGAGGGCACCTGTAATCCCAGCAACTCAGGAAGCTGAGACAGGAGAAGTACTTGAACCCAGAAGGCAGAGGTTGCAGTGAGCCGATATTGCACCATTGCACTCCAGTCTGGGCAACAAGAGTGAAACTCTGTCTCAAAAAAAAA"
"chr16","9769317","9769634","JH378153","10517405","10517727","57","748088","GGTTGGGCATGGTGGCTCACACCTGTAATGCCAGCACTTTGGGAGGCGGGCAGATCACCTGAGGTCAGGAGTTCAAGACCAGCCTGGCCAACATGGTGAAATCCTGTCATTACAAAAATACAAAAAAAAAAAAAAAAAAAAAAAAAAAAAGCCAGTAATGATAGTGGGTGCGTATAATCCCAGCTACTTTGGAGGCTAAGGCAGGAGACTCACTTGAACCCAGGAGGCGGAGGTTATGGTGAGCCGAGATCACACCATTGCACTCCAGCCTGGGCGACAAGAGCAAAACTCCATCTCAAAAAAAAAAAAAAAAAAAAA","GGCCGGGCGTGGTGGCTCACGCCTGTAATCCCAGCACTTTGGGAGGCCGAGGTGGGTGGATCATGAGGTCAAGAGATCGAGACCATCCTGGTCAACATGGTGAAACCCTGTCTCTACTAAAAAAAAAAAAAAAAAAAAAAAATACAAAAAAATTAGCTGGGCATGGTGGCGCATGCCTGTAATCCCAGCTACTCCGGAGGTTGAGGTAGGAGAATTGCCTGAACCCAGGAGGCGGAGGTTGCGGTGAGCCGAGATCGCGCCATTGCACTCCAGCCTGGGTAACAAGAGCAAAACTCCGTCTCAAAAAAAAAAAAAAAAAAGAA"
"chr16","13753079","13753710","JH378118","18053084","18053501","278","4300005","GGCTGATTGTGATGGCTCACACTTGTAATCCCCTCACTTTGGGAGGCCAAAGCGGGAGCATCACCTGAGGTCAGGAGTTCAAGACCAGCCTGGCCAACATGGTGAAACCCCATCTCTACTAAAAATAAAAAATTAGCTGGGCACAGTGACTCATGCCTGTAATCCCAGCACTTTGGGAGGCCGAGGCAGGCAGATCACAATCACGAGGTCAGGAGTTCGAGACCAGCCTGACCAACATGGTGAAACCCCGTCTCTACTAAAAATAGAAAAATTAGCCAGGCGTGGTGGCACACGCCTGTAATCCCAGCTCCTCAGGAGACTGAGGCAGGAGAATCACTTGAACCCAGGAGGTGGAGGTTGCAGTGAGCAGAGATCGCACCACTGCACTCCAGCCTGGGTAACAGAGTGAGACTCCGTCTCAAAAAAAAAAAAAAAAAAAAAAAAAAAACGAAATTAACCAGGTGTGGTGGCACATGCCTGTAATCCCAGCTACTTGGGAGGCTGAGGCAGGAGAATCGCTTGAACCCGGGAGACAGAGGTTCCAGAGAACTGAGATCATGCCATTGCACTCCAGCCTGGGCAACAAGAGTGAAACTCCATCTAAAAAATAAATAAATACATAAACAAACAAA","GGCTGGGCGCAGTGGCTCACACCTGTAATCCCAGCACTTAGGGAAGCTGAGGCGAGTAGATCACCTGAGGTCAGGAGTTAGAGACCAGCCTGGCCATCATGGTGAAACCCCGTCTCTACTAAAGATACCAAAAATTAGCTGAGTGTGGTGCTGGGTGCCTGTAATCCCAGAAACTCAGGGTGCCTGTAATCCCAGCAACTCAGGGTGCCTTTAATCCCAGCAACTGAGGGTACCAGTAATCCCAGCAACTCAGGGTGTCTTTAATCCTAGCAACTGAGGGCACCTGTAATCCCAGCAACTCAGGAAGCTGAGACAGGAGAAGTACTTGAACCCAGAAGGCAGAGGTTGCAGTGAGCCGATATTGCACCATTGCACTCCAGTCTGGGCAACAAGAGTGAAACTCTGTCTCAAAAAAAAA"
"chr16","13951847","13952482","JH378118","18053084","18053501","292","4101237","GGCCAGGTGCGGTGGCTCATGCCTGTAATCCCAGCACTTTGGGAGGCTATGGCAGCGGATAACCTGAGGTCACAAGTTTGAGACCAGCCTGGCAAACATGGTGAAACCGTCTCTACTAAAAATACAAAAATTACACCAGGCGCGGTGGCTCATGCCTGTAATCCCAGCACTTTGGAAGGCCGAGGCAGGTGGATCATGAGGTCAGGAGATCAAGACCATCCTGGCTAACGCAGTGAAACCCCGTCTCTACTAAAAATATAAAAAATTGGCCAGGCGTGGTGGCGGACGCCTGTAGTCCCAGCTACTCGGGAGGCTGAGCCAGGAGAATGGCGTGAACCCGGGAGGCGGAGCTTGTGGTGAGCCGAGATAGCGCCACTGCACTGCCGCCTGGGTGACAGAGTGAGACTCTGTCTCAAAAAACAAAACAAAACAAAAACCAAAAACAAAAACAAAAAAACAAAAATTAGCCAGGTGTGGTGGTGCACGCCTGTCATCCCAGCTACTTGGGGGGCTGAGACGTGATAATCACTTGAACCCGGGAGGGAGAGGTTGCAGTGAGTGGAGATCACGCCATTGTATTCCAGCCTGGGGGCAAGAGCAAAACTCTGTCTCAAAAACAACAACAACAACAACAAA","GGCTGGGCGCAGTGGCTCACACCTGTAATCCCAGCACTTAGGGAAGCTGAGGCGAGTAGATCACCTGAGGTCAGGAGTTAGAGACCAGCCTGGCCATCATGGTGAAACCCCGTCTCTACTAAAGATACCAAAAATTAGCTGAGTGTGGTGCTGGGTGCCTGTAATCCCAGAAACTCAGGGTGCCTGTAATCCCAGCAACTCAGGGTGCCTTTAATCCCAGCAACTGAGGGTACCAGTAATCCCAGCAACTCAGGGTGTCTTTAATCCTAGCAACTGAGGGCACCTGTAATCCCAGCAACTCAGGAAGCTGAGACAGGAGAAGTACTTGAACCCAGAAGGCAGAGGTTGCAGTGAGCCGATATTGCACCATTGCACTCCAGTCTGGGCAACAAGAGTGAAACTCTGTCTCAAAAAAAAA"
"chr16","19006984","19007584","JH378118","18053084","18053501","263","953900","GGTGGCTGATGCCTGTAAACCCAGCATTTTGGGAGGCCGAGGCTGGTGGATCACCTGAGGTCAGGTGTTCGAGACCAGTCTGGCCAACATGGTGAAACCTCGTCTCTACCAAAAATACAAAAATTAGTTGGGTGTGGCCGGGTGTGGTGGCTTACGCTTGTAATCTCAGCACTTTGGGAGGCCGAGGTGGGTGGATCACGAGGTCAGGAGTTCAAGACCAGCCTGGCCAAGATGGTGAAACCCTGTCTCTACTAAAAATACAAAAAATTAGCCAGGCATGGTGGCGGGTGCCTGTAATCCCAGCTACTCGGGAGGCTGAGGCAGAGAATTGCTTGAACCTGGGAGGTGGAGGTTGCAGTGAGCCGAGATTGTGCCACGACACTCCAGCCTGGGTGACAGAGCGAGACTCTGTCTAAAAAAAAAAAAAAAAATTAGTTGGATGTGGTGGTGGGTGTCTGTAATCTCAGCTACTCAGGAGACTGAATCAGGAGAATCACTTGAACCCAGGGGGCTGGAGGTTGCAGTGAGCCGAGATCTTGCCATTGCACTCCAGCCCGGGCGACAAGAGCAAAACTCTCTTTCAAAAAAAAAAAAAAAAAGA","GGCTGGGCGCAGTGGCTCACACCTGTAATCCCAGCACTTAGGGAAGCTGAGGCGAGTAGATCACCTGAGGTCAGGAGTTAGAGACCAGCCTGGCCATCATGGTGAAACCCCGTCTCTACTAAAGATACCAAAAATTAGCTGAGTGTGGTGCTGGGTGCCTGTAATCCCAGAAACTCAGGGTGCCTGTAATCCCAGCAACTCAGGGTGCCTTTAATCCCAGCAACTGAGGGTACCAGTAATCCCAGCAACTCAGGGTGTCTTTAATCCTAGCAACTGAGGGCACCTGTAATCCCAGCAACTCAGGAAGCTGAGACAGGAGAAGTACTTGAACCCAGAAGGCAGAGGTTGCAGTGAGCCGATATTGCACCATTGCACTCCAGTCTGGGCAACAAGAGTGAAACTCTGTCTCAAAAAAAAA"
"chr16","19554918","19555551","JH378118","18053084","18053501","281","1501834","GGCCGGGCGCAGTGGCTCACACCTGTAATCCCAGCACTTTGGGAGGCCGAGGCGGGTGGATCACTTGAGGTCAGGAGTTCAAGACCAGCCTGGCTGACATGGTGAAACCCTGTCTCTACTGAAAACACAAAAATTAGGCCGGGCATAGTGGCTCATGCCTGTAATACCAGCACTTTGGGAGGCCGAGGTGGGTGGATCACCTGAGGTCAGGAGTTTGAGACCAGCTTGACCAACATGGTGAAACCCCGTCTCTACTAAAAATATAAAAATTAGTCTGGCATGGTGGCAGATGCCTGTAATCCCAGCTACTCAGGAGGCTGAGGCAGGAGAATTGCTTGAACCTGGAAGGTGGAGGTTGTAATGAGCCAAGATCACACCACTGCACTCCAGCCACTGTACTCCAGCCTGGGTGACAGAGTGAGACTCTGTCTCAAAAAACATACATACACACACATACACACACACACACACACACACACAAATTAGCTGGACGTGATAGCACACCCCTGTAGTCCCAGCTGCTTGAGAGACCGAGGCACAAGAATCACACGAACCCGGGAGGCGGAGGTTCCTGTGAGCCAAGATCGCACCATTGTACTCCATTCTGGGTGACAAGAGTGAAGCTCTGTCTCAA","GGCTGGGCGCAGTGGCTCACACCTGTAATCCCAGCACTTAGGGAAGCTGAGGCGAGTAGATCACCTGAGGTCAGGAGTTAGAGACCAGCCTGGCCATCATGGTGAAACCCCGTCTCTACTAAAGATACCAAAAATTAGCTGAGTGTGGTGCTGGGTGCCTGTAATCCCAGAAACTCAGGGTGCCTGTAATCCCAGCAACTCAGGGTGCCTTTAATCCCAGCAACTGAGGGTACCAGTAATCCCAGCAACTCAGGGTGTCTTTAATCCTAGCAACTGAGGGCACCTGTAATCCCAGCAACTCAGGAAGCTGAGACAGGAGAAGTACTTGAACCCAGAAGGCAGAGGTTGCAGTGAGCCGATATTGCACCATTGCACTCCAGTCTGGGCAACAAGAGTGAAACTCTGTCTCAAAAAAAAA"
"chr16","19576859","19577465","JH378118","18053084","18053501","251","1523775","GGCCAGGCATGGTGGCTCACACCTGTAATCCCAGCCCTTTGGGAGGCCGAGGCAGGTGGATCACCTGAGGTCAGGAGTTCGAGACCAGCCTGGCCAACATGGTGACACCCCACTCTACCAAAAATACAAAAATTAGGTTGGGTGCAGCGGTTCACACCTGTAATCCCAGCACTTTGGGAGGCCAAGGTGGATGGATCACCTGAGGTCAGGAGTTTGTGACCAGCCTGGCCAACATGGCGAAACCCTGCCTCTACTAAAAATAAAAAATTAGCCAGGTGTGGTGGCATGCGCCTGTAATCCTAGCTACTGAGGCAGGAGAATCGCTTGGACCAGGGAAGCAGAGTTTGCAGTGAGCCAAGATCACGCCACTGCACTCTAGCCTGGGTGACAGAGTAAGACTCCATCTCAAAAAAAAAAAAAAATACAAATATTAGCTGGGCATGGTGGCGCACACCTGTAGTTCTGGCTACTCAGGAGGCTGAGGCAGGAGAATTGCTTGAACCCAGAAGGCAGAGGTTGCAGTGAGCTGAGATTGTGCCATTGCACTCAGCCTGGGCAACAAAAGTGAAACTCCATCTCAAAATAAATAGATAAATAAATAAATAAA","GGCTGGGCGCAGTGGCTCACACCTGTAATCCCAGCACTTAGGGAAGCTGAGGCGAGTAGATCACCTGAGGTCAGGAGTTAGAGACCAGCCTGGCCATCATGGTGAAACCCCGTCTCTACTAAAGATACCAAAAATTAGCTGAGTGTGGTGCTGGGTGCCTGTAATCCCAGAAACTCAGGGTGCCTGTAATCCCAGCAACTCAGGGTGCCTTTAATCCCAGCAACTGAGGGTACCAGTAATCCCAGCAACTCAGGGTGTCTTTAATCCTAGCAACTGAGGGCACCTGTAATCCCAGCAACTCAGGAAGCTGAGACAGGAGAAGTACTTGAACCCAGAAGGCAGAGGTTGCAGTGAGCCGATATTGCACCATTGCACTCCAGTCTGGGCAACAAGAGTGAAACTCTGTCTCAAAAAAAAA"
"chr16","19983557","19984148","JH378118","18053084","18053501","244","1930473","GGCCGAGTGCGGTGGCTCATGCCTGTAATCCCAGCACTTTGGGAGGCCGAGACAGGTGAATCACCTGAGGTCTGGAGTTTGAGACCAGCTGACCAACATGGTGAAACCCTGTCTCTACTAAAAATACAAAAAATTGGCTGAGCGCAGTGGCCACGCCTGTTATCCCAGTACTTTGGGAGGCCGAGGCGGGTGGATCACGAGGTCAGGAATTCGAGACCAGCCTGACCAACATGGTGAAGCCCCGTCTCTACTAAAAATAAAAAAATTAGCCAGGTGTGGTGGTGCGCCCCTGTAAACCCAGCTACTCAGGAGGCTGAGGCAGGAGAATCACTTGAATCTGGGAGGCGGAGGTTGCAGTGAGCCAAGATCGAGCCACTGTACTCCAGCCTGGGAGACGGAGTGAGACTCCATCTAAAAAAAAAAAAAAATTAGCCAGGCGTGGTGGCACAAGCCTGTAATCCCAGCTACCTGGGAGGCTGAGATAGGAGAATTCCTTGAATCTGGGAGGCGGAGGTTGCAGTGAGCTGAGATTGTGCCATTGCACACCAGCCTGGGTGACAAGAGCAAAATTCCATCTCAAAAAAAAAAAAAA","GGCTGGGCGCAGTGGCTCACACCTGTAATCCCAGCACTTAGGGAAGCTGAGGCGAGTAGATCACCTGAGGTCAGGAGTTAGAGACCAGCCTGGCCATCATGGTGAAACCCCGTCTCTACTAAAGATACCAAAAATTAGCTGAGTGTGGTGCTGGGTGCCTGTAATCCCAGAAACTCAGGGTGCCTGTAATCCCAGCAACTCAGGGTGCCTTTAATCCCAGCAACTGAGGGTACCAGTAATCCCAGCAACTCAGGGTGTCTTTAATCCTAGCAACTGAGGGCACCTGTAATCCCAGCAACTCAGGAAGCTGAGACAGGAGAAGTACTTGAACCCAGAAGGCAGAGGTTGCAGTGAGCCGATATTGCACCATTGCACTCCAGTCTGGGCAACAAGAGTGAAACTCTGTCTCAAAAAAAAA"
"chr16","20117717","20118289","JH378118","18053084","18053501","224","2064633","GGCTGGGTGCGGTGGCTCACGCCTGTAATCCCAGCACTTTGGGAGGCCAAGGCGGGTAGATCATCTGAGGTCAGGAGTTCAAGACCAGCCTGGCCAACATGGTGAAACCCCGTCTCTACTAAAAATATTTTTAAAAGGCCAGGCGTGGTGGCTCACGCCTGTAATCCCAGCACTTTGGGAGGCCGAGGCGGGCAGATCATGAGGTCAGGAGTTCGAGACCATCCTGGCTAACACGGTGAAACCCCCGTCTCTACCAAAAAATACAAAAAATTAGCCGGGCATGGTGGCAGGTGCCTGTAGTCCCAGCTACTCGGGAGGCTGAGGCAGGAGGATGGCGTGAACCCAGGAGACAGAGCTTCCAGTGAGCTGAGATCGTGTCACTGCACTCCAGCCTGGGCGACAGAGGAGATTCTGTCTCAAAAAAAAAAAAAAAAAATTAGCTTGGTGTGGTGGCAGGTGCCTGTAATCCCAGTTACTCGGGAGGCTGAGGCAGAGGTTTCAGTGAACCGAGATCGCGCCATTGCACTCCAGCCTGGGCAACAAGAGTGAAACTCCGTCTCAAAGGAAAAAAAA","GGCTGGGCGCAGTGGCTCACACCTGTAATCCCAGCACTTAGGGAAGCTGAGGCGAGTAGATCACCTGAGGTCAGGAGTTAGAGACCAGCCTGGCCATCATGGTGAAACCCCGTCTCTACTAAAGATACCAAAAATTAGCTGAGTGTGGTGCTGGGTGCCTGTAATCCCAGAAACTCAGGGTGCCTGTAATCCCAGCAACTCAGGGTGCCTTTAATCCCAGCAACTGAGGGTACCAGTAATCCCAGCAACTCAGGGTGTCTTTAATCCTAGCAACTGAGGGCACCTGTAATCCCAGCAACTCAGGAAGCTGAGACAGGAGAAGTACTTGAACCCAGAAGGCAGAGGTTGCAGTGAGCCGATATTGCACCATTGCACTCCAGTCTGGGCAACAAGAGTGAAACTCTGTCTCAAAAAAAAA"
"chr16","20574957","20575888","JH378118","18053084","18053501","543","2521873","GGCCAGGCGTGGTGGCTCATGCCTGTAATCCCAGCACTGTGAGAGGCCGAGGCGGGCGGATCACCTGAGCTGAGGAGTTCGAGACCAGCCTGGCCAACATGGCGAAACCCCATCTCTACTAAAAACACAAAAATTAGGCCAGGTGTGGTGGCTCACACCTGTAATCCCAGCACTTTGGGAGGCCAAGGCGGGCGGATCACCTGAGGTCAGGAGTTCCAGACCTGCCTGGCCAACATGGTGGAATCCCATCTCTACTAAAAATACAAAAATCTGCCAGGTGTGGTGGCACACTTCTGTAATCCCAGATACTCAGGAGGCTGAGGCAGGAGAATCACTTGAACCCTGGAGATGGAGGTTGCAGTGAGCCAAGATCAAGAGATTGCACTCTAGCCAGGGTGACTAGAGTGAGACTCGGTCTCAAAAAAAATGTAATTAATTAATTAATTAATACAAAAATTAGCTGGGCGTGGGCTAGGTGTGGTGGCTCACGCCTGTAATCCCAGCACTTTGGGAGGCCGAGACAGGCGGATCACCTGAGGTCAGGAGTTCAAGACCAGTTTAACCAACATGGAGAAACCCCATCTCTACTAAAAATACAAAATTAGCTGGGCGTGGTGGTGCATGCCTGTAATCCCAGCTACTCGGGAGGCTGAGGCAGAAGAATCGCTTGAGCCTGGTAGGCGGAGATCGTGGTGAGCCGAGATCGCGCCATTGCACTCCAGCCTGGACAACAAGAGCGAAACTCCGTCTAAAAAAAAAAAAAAAATTAGCTGGGCATGGTAACAGGCGCCTGTAAACCCAGTTTCCTCGGGAGGCTGAAGCAGAATTGCTTGATCCCAGAGGCAGAGGTTGCAGTGAGCCAAGATAGTGCCATTGCAGTCCAGCCTGGGCAACAAGAGTGAAACTCCGTCTCAAAAAAAAAAAAAAAAAAA","GGCTGGGCGCAGTGGCTCACACCTGTAATCCCAGCACTTAGGGAAGCTGAGGCGAGTAGATCACCTGAGGTCAGGAGTTAGAGACCAGCCTGGCCATCATGGTGAAACCCCGTCTCTACTAAAGATACCAAAAATTAGCTGAGTGTGGTGCTGGGTGCCTGTAATCCCAGAAACTCAGGGTGCCTGTAATCCCAGCAACTCAGGGTGCCTTTAATCCCAGCAACTGAGGGTACCAGTAATCCCAGCAACTCAGGGTGTCTTTAATCCTAGCAACTGAGGGCACCTGTAATCCCAGCAACTCAGGAAGCTGAGACAGGAGAAGTACTTGAACCCAGAAGGCAGAGGTTGCAGTGAGCCGATATTGCACCATTGCACTCCAGTCTGGGCAACAAGAGTGAAACTCTGTCTCAAAAAAAAA"
"chr16","20816618","20817242","JH378118","18053084","18053501","267","2763534","GGCCCGGCGTGGTGGCTCATGCCTGTAATCCCAGCACTTTGGGAGGCCGAGGCCGGCGGATCACCTGAGGTCAGGAGTTTGAGACCACCCTGGCCAACACGGTGAAAACCTGTCTCTACTAAAAATACAAAAATTAGCCAGGCGCAGTGGCTCACGTCTGTAATTCCAGCACTTTGGAGGGCCGAGGGGGGCAGATCACAAGGTCAGGAGTCCAAGACCAGCCAGGCCAACATAGTGAAACCCGGTCTCTACTAAAAATACAAAAAATTAGCCGGGCGTGGTGGCGGACCCCTGTAGTCCCAGCTACTCAGGAGGCTGAGACAGGAGAATCTCTTGAACCCAGGAGGCAGAGGTTGCAGTGAGCCAAGATCATGCCATTCCACTCCAGCCTGGGCGACAGTGCAAGACTCTGTCTCAAAAACAAAAACAAAAAACCCCCAAACCAAAAATTAGCCAGGCGTGGTGGCATGCACCTGTAGTCCCAGCTACTTGGGAGGCTAAGGCAAGAGAATAGCTTGAACCCAGGAGGCAGAGGTTGCAGTGAGCCGAGATAGTGCCATTGCACTCCAACGTGGGTGACAAGAGCAAAACTCTGTCTCAAAAAAAAAAAAAAAAAAGGAAGGAA","GGCTGGGCGCAGTGGCTCACACCTGTAATCCCAGCACTTAGGGAAGCTGAGGCGAGTAGATCACCTGAGGTCAGGAGTTAGAGACCAGCCTGGCCATCATGGTGAAACCCCGTCTCTACTAAAGATACCAAAAATTAGCTGAGTGTGGTGCTGGGTGCCTGTAATCCCAGAAACTCAGGGTGCCTGTAATCCCAGCAACTCAGGGTGCCTTTAATCCCAGCAACTGAGGGTACCAGTAATCCCAGCAACTCAGGGTGTCTTTAATCCTAGCAACTGAGGGCACCTGTAATCCCAGCAACTCAGGAAGCTGAGACAGGAGAAGTACTTGAACCCAGAAGGCAGAGGTTGCAGTGAGCCGATATTGCACCATTGCACTCCAGTCTGGGCAACAAGAGTGAAACTCTGTCTCAAAAAAAAA"
"chr16","21054922","21055508","JH378118","18053084","18053501","243","3001838","GGCCGGGTGCGGTGGCTCACACCTATAATCCCAGCACTTTGAGAGTCTGAGGCAGGCGGATCACCTGAGGTCAGGAGTTCCAGACCAGCCTGGCCAACATGGTGAAACCCAGTCTCTACTAAAAATACAAAAAAAGACCGGGCACAGTGGCTCACGCCTGTAATTCCAGCACTTTGGGAGGCCGAGGCAGGTGGATCACCTGAGGTTGGGAGTTCGCGACCAGCCTGACCGACATGGAGAAATCCCATCTCTACTAAAAATACAAAATTAGCCGGGCGTGGTGGCACATGCCTGTAATTCCAGCTACTCAGGAGGCTGAGGGAGGAGAATCACTTGAACCTGGGAGGCGGAAGTTGTGGCGAGCCAAGATCACGCCATTGCACTCCAGCCTGGGCAACAAGAGTGAAACCCCATTTCAAAAAAAAAAAAAATTAGCCAGGGGTGGTGGTGCATTCTTGTAATACCAGCTACTCGGGAGGCTGAGGTAGGAGAATCACTTGAGCGCAGGAGGCAGATGTTGTAGTGAGCCGAGTGCCATTGCACTACAGCCTGGGCGACAAGAAAGTAACTCCACCTCAAAAAAAAAA","GGCTGGGCGCAGTGGCTCACACCTGTAATCCCAGCACTTAGGGAAGCTGAGGCGAGTAGATCACCTGAGGTCAGGAGTTAGAGACCAGCCTGGCCATCATGGTGAAACCCCGTCTCTACTAAAGATACCAAAAATTAGCTGAGTGTGGTGCTGGGTGCCTGTAATCCCAGAAACTCAGGGTGCCTGTAATCCCAGCAACTCAGGGTGCCTTTAATCCCAGCAACTGAGGGTACCAGTAATCCCAGCAACTCAGGGTGTCTTTAATCCTAGCAACTGAGGGCACCTGTAATCCCAGCAACTCAGGAAGCTGAGACAGGAGAAGTACTTGAACCCAGAAGGCAGAGGTTGCAGTGAGCCGATATTGCACCATTGCACTCCAGTCTGGGCAACAAGAGTGAAACTCTGTCTCAAAAAAAAA"
"chr16","27896431","27896766","JH378166","6401112","6401453","56","21495319","GGCCAGGCGCGGTGGCTCACGCCTGTAATCCCAGGACTTTGGTAGTCCAAGGCGGGTGGATCACCTGAGGTCAGGAGTTCAAGATCAGCCTGACCAACATGGCAAAACCTCGTCTCTACTAAAAAATACAAAAATTAGCCGGTGTGGTGGCAGGTGCCTGTAATTCCAGCTACTCGGGACGCTGAGTCATGAGAATTGCTTGAACCTAGGAGGCAGATGTTGCAATGAGCCGAGATCGCACCATTGTACTCCAGCCTGGGCGACAAGAGGGAAACTGTCTCCAAAAAAAAAAAAGAAAGAAAGAAAGAAAGAAAGAAAAAAGAAAAACAAAACAAA","GGCCAGGTGCAGTGGCTCACCCCTGTAATCCCAGCACTTTGGGAGGTCGAGGTGGGTGGATCACCTGAGGTCAGGAGTTCAAGACCAGCCTGACCAAAATGGTGAAACCCCATCTCTACTAAAAATACAAAACATTAGCCAGACATCGTGGCGGGCACCTGTAATCCCAGCTACTTGGGAGGCTGAGGCAGGAGAATTGCTTGAGCCTAGGAGGCGGAGGTTACAGTGAGCCATGATCGTGCCATTGGACTCCAGCCTGGGCTACAAGAGCGAGACTCCATCTCAAAAAAAAAAAAAAAAAAAAAAAAGAAAGAAAGAAAGAAAGAAAGAAAAGAAAGAAAG"
"chr16","36524888","36525430","JH378206","6546474","6546861","201","29978414","TTTGAGACCAGCCTGGCCATTGTGGTGAAACCCCGTCTCTACTAAAAAAAATTCAAAAAATGGCTGGGTATGGTGGCTCACGCCTGTAATCCCAGGACTTTGGGAGGCCAAGGTGGGCGGATCACCTGAGGTCAGGAGTTTGAGACCAGCCTAGCCAACATGGTGAAACCCCGTCTCTACCAAAAATACAAAAATTAGCCGGGCTTGGTGGCGCGCACCTGTAATCCCAGGTACACTGGAGGTTGAGGCACAAGAATCGTTTGATCCTGGGAGGTTGCAGTGAGCCAAGATCACGCCACTGCACTCCAGACTGGGTGACAGAGCGAGATTCCATCTCAAAACAACAACAACAAACCCAAAAAATTAGCTGGGTGTGGTGGTGGGTGCCTGTAATCCCAGCTACTTAGGAGGCTGAGGCAGAAGAATCGCTTGAACCCAGGAGGTGGAGGTTGTTGCAGTGAGCAGAGATCGCACCATTGCACTCCAGCCTGGGCAACGAGTGAAACTCCATCTCAAAAAAAAAAAAAAAAAAAGAAAAAAAAA","GGCCACACATGGTGGCTAACGCCTGTAATCCCAGCACTTTGGGAGGCCAAGTCGGGTGGATCATGAGGTCAGGAGACCAAGACCATCCTGGCCAAATGGTGAAACCCCGTCTCTACTAAAAATACAAAAATTAGCTGGGCATGGTGGCGTGTGCCTGTAATCCCAGCTACTCAGGAGGCTGAGGCAGGACAATTGCCTGAACCCAGGAGAATTAGCTGGGCATGGTGGCGTGTGCCTGTAATCCCAGCTACTCAGGAGGCTGAGGCAGGACAATTGCCTGAACCCAGGAGGCGAAGGTTGCGGTGAGCCGAGATTGTGCCATTGCACTCCAGCCTGGGTAACAAGAGCGACACTCTGTCTCAAAAAAAAAAAAAAAAAAAAAAAAAAA"
"chr16","36528224","36528842","JH378119","32351107","32351490","270","4177117","GGCCAGGCGTGGTGGCTCACGCCTGTAATCCCAGCACTTTGGGAGGCTGAGGCAGGCAGATCACCTGAGGTCAGGAGTTCAAGACCAGCCTGGCCAACATGGTGAAACTCCATCTCTACTAAAAATACAAAATTAAGCCGGGCACGGTGGCTCACATCTGAAATCCCAGCACCTTGGGAGGCTAAGGCAGGCGGATCACGAGGTCAGGAGTTCAAGACTAGCTGACCAATATGGTGAAACCCCGTGTCTACTAAAAATACAAAAAAAATTAGCTGGGCGTGGTGGCGCATGCCTGTAGTTCCAGGTACTCAGGAGGCTGAGGAAGGAGAATCACTTGAACCTGGGAGGCGGAGGTTGCAGTGAGCCAAGATCATGCCACTGCATTCCAGCCTGGGCAACAGAGCAAGACTCTGTCTCAAAAATAAAAATAAAAATAAAAGTAAAAATACAAAATTAGCCAGGCGTGGTGGTGTGTGCCTGTAATCACAGCTACTCAGGAGGCAGGAAAATCACTTGAACCTAGGAGGAGGAGGTTGGTGAGCCAAGATCACACCATTGCACTCCAGCCTGGGCAAAAAGAGCAAAACTCCGAACTCTGTCTCAAAAAAAAAAAAAAAAA","GGCCAGGTATGGTGGCTCACACCTGTAATCCCAGCACTTTGGGAGGCCAAGGCAGGCAGACCACCTGAGGTCAGGAGTTCGAGATCAGCCTAGCCAACATGGTGAAACCCCATCTCTAGTAAAAATAAAATTAGCCAGGCATGGTGGTGCATGCCTGTAACGCAGGTCAGGAGTTCGAGATCAGCTTAGCCAACATGGTGAAACCCCATCTCTAGTAAAAATAAAATTAGCCAGGCAGGTGGTGCCGCCTGTACTCGGGAGGCTGAGGCAGGAGAATCACTTGAACCCAAGAGGCAGAGGTTGCAGTCAGCCAAGATCATGCCATTGCACTCCAGCCTAAGCAAAAAGAGTAAAACTCAGTCTCAAAACAAAAAAACAAAAAAA"
"chr16","44800308","44800913","JH378118","18053084","18053501","244","26747224","GGCCTGGTGCAGTGGCTCACACCTGTAATCCCAGCACTTTGGGAGCCCAAGGCGGGTGGATCACCTGAGGTCAGGAGTTCGAGACCAGCCTGGCCAACATGGTGAAATCCTCTCTACTAAAAATGCAAAAAATTAGCTGGGCGGCCAGGCGCAGTGGCTCACGCCTGTAATCCCAGCACTTTGGGAGGCCGAGGTGGGCGGATCACAAGGTCAGGAGATCGAGACCATGCTGGCTAACACGGTGAAACTCCGTCTCTACTGAAAATACAAAAAATTAGCCAGGCACGGTGGCGGGCGCCTGTAGTCCCAGCTACTGGGGAGGCTGAGGCAGGAGAATGGCGTGAACCTGGGAGGTGGAGGTAGCAGTGAGCCAAGATTGCGCCACCGCAGTCCGGCCTGGGTGAAAGAGCGAGACGCTGTCTCAAAAAAAAAAAAAAAAAATTAGCTGGGCATGGTGGCGGGCGCCTGTAATCCCAGTTACTCGGGAGGCTGAGGCAGGAGAATCAGTTGAACCCAGGAGGTGGAGGTTGCAGTAAGCCAAGATTGTGCCATTGTACTCCAGTCTGGGCAACAAGAGCGAAACTCTGTCTTAAAAAACAAAAAAAA","GGCTGGGCGCAGTGGCTCACACCTGTAATCCCAGCACTTAGGGAAGCTGAGGCGAGTAGATCACCTGAGGTCAGGAGTTAGAGACCAGCCTGGCCATCATGGTGAAACCCCGTCTCTACTAAAGATACCAAAAATTAGCTGAGTGTGGTGCTGGGTGCCTGTAATCCCAGAAACTCAGGGTGCCTGTAATCCCAGCAACTCAGGGTGCCTTTAATCCCAGCAACTGAGGGTACCAGTAATCCCAGCAACTCAGGGTGTCTTTAATCCTAGCAACTGAGGGCACCTGTAATCCCAGCAACTCAGGAAGCTGAGACAGGAGAAGTACTTGAACCCAGAAGGCAGAGGTTGCAGTGAGCCGATATTGCACCATTGCACTCCAGTCTGGGCAACAAGAGTGAAACTCTGTCTCAAAAAAAAA"
"chr16","45828895","45829498","JH378118","18053084","18053501","256","27775811","GGCCAGGAGAGGTGGCTCATGCTTGTAATTCCAGTATTTTGGGAGCCCAAGGCGGGTGGATCACTTGAGGTCAGGAGTTTGAAACCAGCCTGACCAACATGGTGAAACCCCGTCTCTACTAAAAATTCAAAATTAGGCAAGGCCTGGTGGCTCATGCCTGTAATCCCAGCACTTTGGGAGGCCAAGGAGGGAGGATCACCTGAGGTCGGGAGTTTGAGACCAGCCTGACCAACATGGAGAAACCCCGTCTCTACTAAAACTACAAAATTAGCCGGGTGTGGTGGCCCATGCCTCTAATCCCAGCTACTCTGGAGGCTGAGGCAGGAGAATCACTTGGACCTGGGATGTGAAGGTTGCAGTGAGCCAAGATCGAGCCATTGCACTCCAGCCTGGGCCACAAGAGTGAAACTCCGTCCCAGAAAAAAAAAAAAAAATTAACCTGGCATGGTGGTGTATGCCTGTAATCCCAGCTACTCGGGAGACTGAGGCAGGAGAATCTCTTGAACCCGGGAGGCGGAGGTTGCAGTAAACCGAGATTGCGCCATTGCACTCCGGCCTGGGTGACAAGAGCGAAACTCCGCCTAAAAAAAAAAAGAAAAGAAAA","GGCTGGGCGCAGTGGCTCACACCTGTAATCCCAGCACTTAGGGAAGCTGAGGCGAGTAGATCACCTGAGGTCAGGAGTTAGAGACCAGCCTGGCCATCATGGTGAAACCCCGTCTCTACTAAAGATACCAAAAATTAGCTGAGTGTGGTGCTGGGTGCCTGTAATCCCAGAAACTCAGGGTGCCTGTAATCCCAGCAACTCAGGGTGCCTTTAATCCCAGCAACTGAGGGTACCAGTAATCCCAGCAACTCAGGGTGTCTTTAATCCTAGCAACTGAGGGCACCTGTAATCCCAGCAACTCAGGAAGCTGAGACAGGAGAAGTACTTGAACCCAGAAGGCAGAGGTTGCAGTGAGCCGATATTGCACCATTGCACTCCAGTCTGGGCAACAAGAGTGAAACTCTGTCTCAAAAAAAAA"
"chr16","47110839","47111458","JH378118","18053084","18053501","268","29057755","GGCCAGGCGTGGTGGCTCACGCCTTTAATCCCAGCACTTTGGGAGGCCGAGGCAGGCAGATCACCTAAGGTCAGGAGTTCGAGACCAGCCTGGCCAACATGGTGAAACCCCCTCTCTACTAAAAATGCAAAAATTTCTGGGCATGGTGGCTCACGCCTGTAGTCCCAGCACTTTGGGAGGCCAAGGCAGGCGGATCACTTGAGGTCAGGAGTTTGAGACCAGCCTGGCCAACATGGTGAGACCCCTGTCTCTACTAAAAATATAAAAAAGTAGCCAGGCGTGGTGGTGTATGCCTCCCAGATAATTGGGAGGCTGAGGTGGGATAATTGCTTGAACCCGGGAGGCAGAGGTTGTAGTGAGCCAAGATAGCGCCAATGCACTCCAGCCTGGGCAACAGAGCGAGACTCTGTCTCAAAAAAAAAAAAAAAAAGAAAAAAGAAAAGAAATTAGCTGGGCGTGGTGATGGGTGCCTGTAATCCCAGCTGCTTAGGAAGCTGAGGAAGGAGAATCACTTAGACCCAGGAGACAGAGGTTGCAGTGAGCCGAGATCGCACCATTGTATTCCAGCCTGGGTGACAAGAGAAAAACTATGTCTCAAAAAAAAAAAAAAGAGTAGAAAA","GGCTGGGCGCAGTGGCTCACACCTGTAATCCCAGCACTTAGGGAAGCTGAGGCGAGTAGATCACCTGAGGTCAGGAGTTAGAGACCAGCCTGGCCATCATGGTGAAACCCCGTCTCTACTAAAGATACCAAAAATTAGCTGAGTGTGGTGCTGGGTGCCTGTAATCCCAGAAACTCAGGGTGCCTGTAATCCCAGCAACTCAGGGTGCCTTTAATCCCAGCAACTGAGGGTACCAGTAATCCCAGCAACTCAGGGTGTCTTTAATCCTAGCAACTGAGGGCACCTGTAATCCCAGCAACTCAGGAAGCTGAGACAGGAGAAGTACTTGAACCCAGAAGGCAGAGGTTGCAGTGAGCCGATATTGCACCATTGCACTCCAGTCTGGGCAACAAGAGTGAAACTCTGTCTCAAAAAAAAA"
"chr16","48159907","48160229","JH378222","6231244","6231546","61","41928663","GGCTGGGCACAGTGGCTCATGCCTGTAATCCCAGCACTTTGGGAGGCCGAGGCAGGCGGATCACCTGAGGTCAGGAGTTCGAGACTAGCCTGGCCAATATAGCGAAACCCCGTCTCTACTAAAAATTAGTTGGGCATGGTGGCAGGCGCCTTAATCCCAGCTACTTGGGATGCTGAGGCAGAAGAATCGCTTGAACCCAGAGGGTGGAGGTTTCAGTGAGATGAGATCGTGCCATTGCACTCCAGACTGGGCAACAAGAGCGAGACTCTGTAAAAAAAATTAATTAATTAATTAACTAATTAATTAAAATAAAATGAGAAAAA","GGCTGGGCATGGTGGCTCACGCCTGTAATCCCAGCACTTTGGGACGCTTAGGCAGGTGGATTGCCTGAGGTCAGGAGTTCAAGACTACCCTGACCAACATAGTGAAACCCCGTCTCTACTAAAAATTAGCTGGGCATGGTGGCAGAGGCCTGTAATCCCAGCTACTCGGGAGGCTGAGGCAGGAGAATCACTTAAACCTGGGAGTTGGAGGTTGCAGTGAGCCAAGATCAAGCCATTGCACTCCAGTCTGGGCAACAAGAGCAAGACTCTGTCTCAAAAAAAAAAAAAAAAAGAAAAGAAAAA"
"chr16","49252302","49252639","JH378314","538162","538484","57","48714140","GGCCAGGCGCAGTGGTGCATGTCTGTAATCTTAGCACTTTGGGAGGCCGAGGTGGACGGATTACATGAGGTCAGGAGTTCAAGACCAGCCTGGCCAACATGGTGAAATTCCATCTCTACTACTAAAAAAAAAAAAAAAAAAAAAAAAAAAAAAAAAAAAAAATACAAAAATTAGCTGGGCTTGGTGGCGGGTGCCTGTAATCCCAGCTACTTGGGAGGCTGAGGCAGGAATCACTTAAACCCAGGAGGTGGAGGTTGCAGTGAGCCAAGACCATGCCATTGCACTCCAGCCTGGGCAACAAGAGCAAAACTCCGTCTCAAAAAAACAAAACAAAAAAA","GGCTGGGTGCGGTGCCTCACACCTGTAATCCCAGCACTTTGGGAGGCCGAGGTGGGTGGATCACGAGGTCAAGAGATCAAGACCATCCTGGTCAACATGGTGAAACCCTGTCTCTACTAAAAAAAAAAAAAAAAAAAAAAAAAAAAAAAAAAAAATTAGCTGGGCATGGTGGCGTGTGCCTGTAATCCCAGCTACTCAGGAGGCTGAGGCAGGAGAATTGCCTGAACCCAGGAGGCGGAGGTTGCGGTGAGCCGAGACTGTACCATTGCACTCCAGCCTGGGTAACAAGAGCGAAACTCCATCTCAAAAAAAAAAAAAAAAAA"
"chr16","49464616","49465219","JH378118","18053084","18053501","254","31411532","GGCCAGGCGTGGTGGCTCACACCTGTAATCCTAGCACTTTGGGAGACTGAGGCAGGTGGATCACATGAGGTGAGGAGTTCAAAACCACCCTGGCCGACATGGTGAAACCCCGTCTCTACTAAAAATATTTTTAAAAAGGCCAGGCGTGGTGGCTCACACCTGTAATTCCAGCACTTCGGGAGGCTGGGGCAGGCAGATCACAAGGTCAGGAGATCGAGACCATTCTGGCCAACGTGGTGAAACCCCGTCTCTACTAAAAATACAAAAATTAGCTGGGCGTGGTGGCGCGTGCCTGTAATCCCAGCTACTTGGGAGGCTGATACAGGAGAATTGCTTGAACCAGTGAGTCAGAGGTTGCAGTGAGCTGAGATTGCGCCATTGCACTCCAGCCTGGCAACAGAATGAGACTCCGTCTCAAAAAAAAAAAAAAAATTAGCTGGGCATGGTGGCAGGCACCTGTGATCCCAGCTACTTGGGAGGCTGAGGCAGGAGAATCGCTTGAACCTGGGAGGTGGAGGTTGCAGTGAGCTGAGATTGCGCCATTGCACTCCAACCTGGGCGTCAAGAGCAAAACTCCATCTCAAAAATAAATAAATAAATAAAA","GGCTGGGCGCAGTGGCTCACACCTGTAATCCCAGCACTTAGGGAAGCTGAGGCGAGTAGATCACCTGAGGTCAGGAGTTAGAGACCAGCCTGGCCATCATGGTGAAACCCCGTCTCTACTAAAGATACCAAAAATTAGCTGAGTGTGGTGCTGGGTGCCTGTAATCCCAGAAACTCAGGGTGCCTGTAATCCCAGCAACTCAGGGTGCCTTTAATCCCAGCAACTGAGGGTACCAGTAATCCCAGCAACTCAGGGTGTCTTTAATCCTAGCAACTGAGGGCACCTGTAATCCCAGCAACTCAGGAAGCTGAGACAGGAGAAGTACTTGAACCCAGAAGGCAGAGGTTGCAGTGAGCCGATATTGCACCATTGCACTCCAGTCTGGGCAACAAGAGTGAAACTCTGTCTCAAAAAAAAA"
"chr16","49983504","49983843","JH378316","567988","568320","50","49415516","GGCCAGGCATGGTGGCTTACGCCTGTAATCTCAGCACTTTGGGAGGCCAAGGCAGGCGGATCACCTGAGGTCAGGAGTTCAAGACCAGCCTGGTCAACATGGCGAAACCCTGTCTCTACTAAAAAAATACAAAAATTAGCCAGGCGTGGTGGTGGGCGCCTGTAATCTCTCCTACTTGGGAGACTGAGGCAGGAGAATTGCTTGAACTCAGAAGGCAGAGGTTGCAGTGAGCTGAGATCACGCCATTGCACTCCAGCCTGGATGACAAGAGCAAAACTCCATCTCAAACAAACAAAAAACAAACAAACAAAAAAAAACAAAAAAACCTCCAAAAAACAAA","GGCCGGGCGTGGTGGCTCACGCCTGTAATCCCAGCACCTTGGGAGGCTGAGGCGGGTGGATCACGAGGTCAAGAGATTGAGACCAGCCTGGTCAACATGGTGAAACCCTGTCTACTAAAAAAATACAAAAATTAGCTGGGCATGGTGGCACGTGCCTGTAATCCCAGCTACTCAGGAGGCTGAGGCAGGAGAATTGCCTGAACCCAGGAGGCGGAGGTTGCGGTGAGCCGAGATCGCGCCATTGCACTCCAGCCTGGGTAACAAGAGCGAAACTCCGTCTCAAAAAACAAAAAACAAAAAAACAAAAAACAAACAAACAAACAAAAAAACAAA"
"chr16","50470493","50471105","JH378118","18053084","18053501","251","32417409","GGCTGGGAGCGGTGGCTCATACCTGTAATCCCAGCACTCTGGGAGGCCGAGGCGCGTGGATCACCTGAGGTCAGGAGTTTGAGACCAGCCTGGCCAGCATGGTGAAACCCTGTCTCTACTAAAAATAGAAAAAGTTAGCTGGGTGAACAGCCGGGCGCGGTGGCTCACACCTGTAATCCCAGCACTTTGGGAGGCCGAGGCAGGTGGATCACAAGGTCAGGAGATCGAGACCATCCTGGCTAACACGGTGAAACCCTGTCTCTACTAAAAATATAAAAAATTAGCCGGGCATGGTGGTGGGTGCCTGTAGTCCCAGCTGCTCAGGAGGCTGAGGCAGGAGAATGGCGTGAAGCCAGGAGGCAGAGGTTGCAGTGAGCCGAGATCGTACCACTGCACTCTAGCCTGGGTGACAGAACGAGACTGTGTCTCAAAGAAAAAAAAAATTAGCTGGGTGTGGTGGCAGACACCTGTAATCCTAGCTACTTGGGAGGTTGAGGCAGGAGAATCGCTTGGACCTGGGAGGCGGAGGTTGCAGTAGGCTGAAATCGCACCATTGCACTCCAGCCTGGGCAACAAGAGGGAAACTCAGTCTCAAAAAAAAAAAAAAAAAAAA","GGCTGGGCGCAGTGGCTCACACCTGTAATCCCAGCACTTAGGGAAGCTGAGGCGAGTAGATCACCTGAGGTCAGGAGTTAGAGACCAGCCTGGCCATCATGGTGAAACCCCGTCTCTACTAAAGATACCAAAAATTAGCTGAGTGTGGTGCTGGGTGCCTGTAATCCCAGAAACTCAGGGTGCCTGTAATCCCAGCAACTCAGGGTGCCTTTAATCCCAGCAACTGAGGGTACCAGTAATCCCAGCAACTCAGGGTGTCTTTAATCCTAGCAACTGAGGGCACCTGTAATCCCAGCAACTCAGGAAGCTGAGACAGGAGAAGTACTTGAACCCAGAAGGCAGAGGTTGCAGTGAGCCGATATTGCACCATTGCACTCCAGTCTGGGCAACAAGAGTGAAACTCTGTCTCAAAAAAAAA"
"chr16","50478366","50478929","JH378114","15957391","15957789","242","34520975","GGCTGGGCACGGTGGCTCATGCCTGTAATCCTAGTACCCTGGGAGGCTGAAGCTGGCAGATCACTTGAGGTCAGGAGTTCGAAACCAGCCTGGCCAACATGGTGAAACCTCATCACTACTAAAAATACAAAAAGTCAGCCGAGCGCGGTGGCTCACGCCTTTAATCCCAGCACTTTAGGAGTCTGAGGCGGGTGGATCACAAGGTCAGGGGTTTGAGACTAGCCTGACCAACACGGTGAAACATCTTTACTAAAAATAGCCAGGCATGGTGGTGCAGGCCTGTAGCAGGTACTCAGGAGGCTGAGGCAGCAGAATCGCTTGAACCCGGGAGGCGGAGGTTGCAGTGAGCCGAGATTGAGCCACTGCACTCCACCCTGGGCAACTGAGCGAGACTCCGTCTCAAAAAAAAAAAAAAAAATTAGCTGGACGTGGTGGTGGATGCCTGTAATCCCGGCTACTTGGTACTTGGAAGGCTGAGACAGGAGAATCGCTTGAACCCGGGAGGTGGAGGTTGCAGTGAGCTGAGATAGCGCCATTGCACTCCAGCCTGGGCAACAAGAGTGA","GCAAGGAACGGTGGCTCATGCCTGTCATCCCAGCACTTTGGGAGGCTAAGGAGGGTGGATTACCGAAGGTCATGAGTTTGAGACCAGCCTGACCAACATGGTGAAAACCCCATCTCTACTAAAAATACAAAAAATTAGCCAGATACAGCTATGCGGCAGACTGGGGCAGGAGAATCGCTTGGACCCAAACCCCATCTCTACTAAAAATACAAAAAATTAGCCGGATACAGCTATGCGGGAGACTGGGGCAGGAGAATCGCTTGGACCCGGGAGGCAGAGATTGCAGTGAGATGAGACCATGCCATTGCTCTCTAGCTTGTGCGATGAGAACAAGACTCTGTCTCAAAAAAAAAAAAAAAAAAAAAAAAAAAAAAAAAAAAAAAAGAGAGAGAGAGAAAA"
"chr16","51388263","51388584","JH378271","2122362","2122678","46","49265901","GGCTGGGTACGGTGGCCCACACCTGTAATCCCAGCACCTTGGGAGGCTGAGGTGGGCGGATTACCTGAGGTCAAAAGTTCAAGACCAGCCTGGCCAACATGGTGAAATCCCATCTCTGCTAAAAATACAAAAAAAAAAAAAAAAAAAAAAAAAAAATTGCCAGGCATGGTGGCAGGCACCTGTAATCCCAGCTACTTGGGAGGCTGAGGCAGGGGAATCGCTTGAACCTGGGAGGCAGAGGTTGCAGTGAGCCCAGATAGCGCCATTGCACTCCAGCCTGGGCGACAAGAGCGAAACTCTGTCCAAAAAAAAAAAAAAAAAA","GGCCGGGCACGGTGGCTCACACCTGTAATCCCAGCACTTTGGGAGGCTGAGGTGGGTGAATCACCTGAGGTCAGGAGTTTGAGACCAGCCTGACCAACATGATGAAACCCGGTCTCTGCTAAAAATACAAAAAAAAAAAAAAAAAAAAAAAAAAAAAGCTGGGCATGATGGTGGGCACCTGTAATCCCAGCTACTCGGGAGGCTGAGGCAGGAGAATCGCTTGAACACCAGGAGGTGGAGGTTGCTATGAGCCGAGATCGCACCATTGCACTCTAGCTTGGGCAACAAGAGAGAAACTCCATCAAAAAAAAAAAAAA"
"chr16","51876298","51876882","JH378118","18053084","18053501","253","33823214","GTAATCCCAGCACTTTGGGAGGCCCAAGTGGGTGGATCACCTGAGGTCAGGAGTTCATGACCAGCCTGGCCACATGGTGAAACCCCATCTCTACTAAAAATACAAAATTAGGCTGGGCGCGGTGGCTTACGTCTGTAATTCCAGCACTTTGGGAGGCCGAGGCAGGCGGATCATGAGGTCAGGAGATTGAAACCATCCTGGCTAACACGGTGAAACCCTGTCTCTACTAAAAATACAAAAAATTAGCCGGGTGTGGTGGGGGGGCGCCTGTAGTCCCAGCTGCTCAGGAGGCTGAGGCAGGAGAATGGCATGAACCCGGGGGGGCGGAGCTTGCAGTGAGCTGAGATCATGCCACTGCACTCCAGCCTGGGCAACAAAGTGAGACTCCGTCTCAAAAAAAAAAACCAAAAAACAAAATGAGCTGGGTGTGGTGGTGGGGGCGTATAATCCCAGCTATACAGGAGGCTGAGGTAGGAGAATCACTTGAACCCGGGAGGTGGAGGTTGCAGTGAGCCGAGATTGTGCCATTTCACACCAACCTGGGTAACAAGAGTAAAATGCTGTCTCAAAAAAAAAAAAGAAAAA","GGCTGGGCGCAGTGGCTCACACCTGTAATCCCAGCACTTAGGGAAGCTGAGGCGAGTAGATCACCTGAGGTCAGGAGTTAGAGACCAGCCTGGCCATCATGGTGAAACCCCGTCTCTACTAAAGATACCAAAAATTAGCTGAGTGTGGTGCTGGGTGCCTGTAATCCCAGAAACTCAGGGTGCCTGTAATCCCAGCAACTCAGGGTGCCTTTAATCCCAGCAACTGAGGGTACCAGTAATCCCAGCAACTCAGGGTGTCTTTAATCCTAGCAACTGAGGGCACCTGTAATCCCAGCAACTCAGGAAGCTGAGACAGGAGAAGTACTTGAACCCAGAAGGCAGAGGTTGCAGTGAGCCGATATTGCACCATTGCACTCCAGTCTGGGCAACAAGAGTGAAACTCTGTCTCAAAAAAAAA"
"chr16","59738190","59738518","JH378138","4229795","4230103","67","55508395","TCACAGCATTTTGGGAGGCCAAGGCAGGCGGATCACCTGTGGTCAGGAGTTTGAGACCAGCCTGGCCAACATGGTGAAACCCCATCTCTACTAAAAATACAAAACAATTAGCCAGGTTTGGTGGCAGGCGCCTATAATCCCAGCTACTTGGGAGGCTGAGGCAGGAGAATCGCTTGAACCCAGGAGGCGGAGGTTGCAGTGAGCCGAGAACACACCATTGTACTCCAGCCTGCGACAAGAACGAAACTGTATCTCAATTAAAAAAAAAAAAAGAAAGGGAGGAAGGAAGGAAGGAAGGAAGGAAGGAAGGAAGGAAGAAAGAAAGAAAA","CACTTTGGGAGGTGAAGGCGGGCAGATCACCTGAGGTCAGGAGTTCGAGACCAGCCTGGCCAACATGGTGAAACCCCGCCTCTACTAAAAATACAAAAATTAGCCAGGTGTGACACTAGGCATCTGTAATCCCAGCTACTTGGGAGGCTGAGACAGGAGAATCACTTGAACCCAGGAGGCGGAAGTTGCAGTGAGCCAAGATCATGCCATTGCACTCCAGCCTGGGTGACAGGAGCAAAACTCTGTCTCAAAAAAAAAAAAAAAAAAAAAAAAAAAAAAAAAAAAAAAAGAAAAGAAAAGAAAAGTAAA"
"chr16","64682336","64682940","JH378118","18053084","18053501","253","46629252","GGCCGGGCACGGTGGCTCACTCCTGTAATCCCAGCACTTTGGGAGGGTGAGGCAGGTAGATCAAAAGGTCAGGAGTGGCCAGGCGTGGTGGCTCACACTTGTAATCCCAGCACTTTGGGAGGCCGAGATGGGCAGATCACGAGGTCAAGAGATTGAGACCATCCTGGCTAACATGGTGAAACCCCGTCTCTACTAAAAATACAAAAAATTAGCCGGGTGTGGTGGCAGGCGTCTGTAATCCCAGCCACTTGGGAGGCTGAGGCAGGAGAATCGCTTGAACCTGGGCGGCAGAGGTTGCATTGAGCCAGGATCGCGCCACTGCACTCCAGCCTGAGCAAAAAGAGCGAAACTCTGTCTCAGAAAAAAAAAAAAGTCAGGAGTTTGAGACCAGCCTGGCCAATATGGTGAAACCCCGTCTCTACTAAAAATACAAAAATTAGCCGAGCGTGGTGGTGGGTGCCTATACTCCCAGCTACTCAGGAGGCTGAGGCAGGAGAATCACTTGAACCCCAGGGGCAGAGGTTGCAGTGAGCCGAGATCGTGCCATTGCACTTCACCCTGGGTGAAAGAGCAAAACTCCGTCTCAAAAAAACAAAACAAAAAAA","GGCTGGGCGCAGTGGCTCACACCTGTAATCCCAGCACTTAGGGAAGCTGAGGCGAGTAGATCACCTGAGGTCAGGAGTTAGAGACCAGCCTGGCCATCATGGTGAAACCCCGTCTCTACTAAAGATACCAAAAATTAGCTGAGTGTGGTGCTGGGTGCCTGTAATCCCAGAAACTCAGGGTGCCTGTAATCCCAGCAACTCAGGGTGCCTTTAATCCCAGCAACTGAGGGTACCAGTAATCCCAGCAACTCAGGGTGTCTTTAATCCTAGCAACTGAGGGCACCTGTAATCCCAGCAACTCAGGAAGCTGAGACAGGAGAAGTACTTGAACCCAGAAGGCAGAGGTTGCAGTGAGCCGATATTGCACCATTGCACTCCAGTCTGGGCAACAAGAGTGAAACTCTGTCTCAAAAAAAAA"
"chr16","67872770","67873371","JH378118","18053084","18053501","260","49819686","GGCTGGGCATGGTGGCTCATGCCTGTAATCCCAGCACTTTGGGAGGCCAAGACGGGCAAATCACCTCAGGTCAGGAGATCGAGACCAGCCTGGCCAACACAGCAAAACCCACCTCTCTACTAAAAATAGAAAAATTACCCAGGCGTCACAGCTCACGCTTATAATCCCAGCACTTTGGGAGGCCGAAGCAGGTGGATCACAAGGTCAGGAGATCGAGACCAGCCTCACTAACATGGTGAAACCCCGTCTCTACTGAATATACGAAAAATTAGTCGGGTGTGGTGGCAGGCACCTGTAGTCCCAGCTACTTGGGAGGCTGAGGCAGGAGAATGGCTTTAACTCAGGAAGAGGAGCTTACGGTGAGCTGAGATTGTGCCACTGCACCCCAGCCTGGGCGACAGAGCAAGACTCCGTCAAAAAAAAAAAAAACCCCAAAACCCCAGCGTGGCAGCAGGTACCTGTAGTCCCAGCTACTCGGGAGGCTGAGACAGGAGAATGGCTTGAACCCGGGAGGCGGAGCTTGCGGTGAGCCAAGACGGCGCCACTTCATTCCAGCTATGGTGATAAGAGGGAGACCGTCTCAATCAATAAATTTAAAAAAA","GGCTGGGCGCAGTGGCTCACACCTGTAATCCCAGCACTTAGGGAAGCTGAGGCGAGTAGATCACCTGAGGTCAGGAGTTAGAGACCAGCCTGGCCATCATGGTGAAACCCCGTCTCTACTAAAGATACCAAAAATTAGCTGAGTGTGGTGCTGGGTGCCTGTAATCCCAGAAACTCAGGGTGCCTGTAATCCCAGCAACTCAGGGTGCCTTTAATCCCAGCAACTGAGGGTACCAGTAATCCCAGCAACTCAGGGTGTCTTTAATCCTAGCAACTGAGGGCACCTGTAATCCCAGCAACTCAGGAAGCTGAGACAGGAGAAGTACTTGAACCCAGAAGGCAGAGGTTGCAGTGAGCCGATATTGCACCATTGCACTCCAGTCTGGGCAACAAGAGTGAAACTCTGTCTCAAAAAAAAA"
"chr16","67970409","67971018","JH378118","18053084","18053501","252","49917325","GGGCGGGTGCGGTGGCTCACCCTGTAATCCCAGCACTTTCGGAGGCTTAAGCAGGCGGATCACCTGAGGTCAGGAGTTCGAGACCAGCCTGGCCAACATGGTGAAACCCCATCTCTACTAAAAATACAAAAAAATGGCCGGGTGCGGCGGCTCATGCCTGTCATCCCAGCACTTTCGGAGGCTGAGGCAGGCGGATCACCGGAGGTCAGGAGTTCGAGACCAGCTTGGCCAACATGGTGAAACCCCGTCTCTACTAAAAATACAAAAGTTAGCTGGGCATGGTGGCACATGCCTGTAATCCCAGCTACTCCGGAGGCTGAGGCAGGAGAATCACTTGAACCTGGGGAGGCGGAGGTTGCAGTGAGCTGAAATCACGGCATTGCACTCCAGCCTAGGCAACAGAGCGAAAGTCCGTCTCAGAAAAAAAAAAAAAAAAATTAGATGGGTTTGGTGGCGGGCGCGCTGTAATCCCAGCTACTTGGGAGGCTGGAGGCAGGAGAATCGCTTGAACTCAGGAGGCTGAGGTTACAGTGAGCCGAGATCATGCCATTGCACTCCAGCCTGGGCAATAAGAGTGAAACTCTGTCTCAAAAAACAACAACAACAAAAA","GGCTGGGCGCAGTGGCTCACACCTGTAATCCCAGCACTTAGGGAAGCTGAGGCGAGTAGATCACCTGAGGTCAGGAGTTAGAGACCAGCCTGGCCATCATGGTGAAACCCCGTCTCTACTAAAGATACCAAAAATTAGCTGAGTGTGGTGCTGGGTGCCTGTAATCCCAGAAACTCAGGGTGCCTGTAATCCCAGCAACTCAGGGTGCCTTTAATCCCAGCAACTGAGGGTACCAGTAATCCCAGCAACTCAGGGTGTCTTTAATCCTAGCAACTGAGGGCACCTGTAATCCCAGCAACTCAGGAAGCTGAGACAGGAGAAGTACTTGAACCCAGAAGGCAGAGGTTGCAGTGAGCCGATATTGCACCATTGCACTCCAGTCTGGGCAACAAGAGTGAAACTCTGTCTCAAAAAAAAA"
"chr16","68229729","68230314","JH378206","6546474","6546861","256","61683255","TGGTTTCCGCCTGTACTCCCAGCACTTTCGGAGGCTCAAGTGAGCAGATCGCTTGAGGCCAGGAGTTTAAGACCTACCTAGTCAACACCGGGGAAACCCACATCTCCACTAAACAATGGCCAGGAGCAGTGGCTCATACCTGTAATCACAACACTTTGGGATCCCAGCCAGACGGATCACAAAGTCAGGAGTTTGCGACCAGCCTATTAGAATGGTGAAACCCTGTCTCTACTAAAAATACAAAAAATTAGCCAGGCATGGTGGCGCATGCCTGTCATCCCAGCTACTCGGGAGGCTGAGGCAAGAGAATCACTTAAACCCAGGAGGCAGATGGAGGTTGCAGTGAGCCAAGATCACACCACTGCACTACAGCATGGGCGACAGAGCAAGACTCGGTCTCAAAAAAAAAAAAATTGGCCAGGCACGGTGGCTGACACCTGTAATCCCAGCACTTTGGGAGGCTGAGGCGGGAGAATCGCTTGAACCTGGGAGACGAAGGTTGCAGTGAGCCGAGACTAAGCCATTGCACCCCAACCTGGGCGGCAAGAGTGAAACTCTGTCTCAAAAAAAATTAAAAAATAAAAAA","GGCCACACATGGTGGCTAACGCCTGTAATCCCAGCACTTTGGGAGGCCAAGTCGGGTGGATCATGAGGTCAGGAGACCAAGACCATCCTGGCCAAATGGTGAAACCCCGTCTCTACTAAAAATACAAAAATTAGCTGGGCATGGTGGCGTGTGCCTGTAATCCCAGCTACTCAGGAGGCTGAGGCAGGACAATTGCCTGAACCCAGGAGAATTAGCTGGGCATGGTGGCGTGTGCCTGTAATCCCAGCTACTCAGGAGGCTGAGGCAGGACAATTGCCTGAACCCAGGAGGCGAAGGTTGCGGTGAGCCGAGATTGTGCCATTGCACTCCAGCCTGGGTAACAAGAGCGACACTCTGTCTCAAAAAAAAAAAAAAAAAAAAAAAAAAA"
"chr17","3506470","3507049","JH378118","18053084","18053501","238","14546614","CCTGTCATCCCAGCACTTTGGGAGGCCGAGGCGGGTAGATCACCTGAGGTCAGGAGTTTGAGACCAGCCTGGCCAACATGGCGAAACCCCGTCTCTACTAAAAATACAAAAACTGGCTGGGCGCGGTGGCTCACGCCTGTAATCCCAGCACTTTGGGAGGCTGAGGCGGGTGGATCATAAGGTCAGGAGTTCAAGACCAGCCTGGCCAACATGGTGAAACCCCATCTCTACTAAAAATACAAAAATTAGCCAGGTATGGTGGCAGGTGCCTGTAATCCCAGCTACTCAGGAGGCTGAGGCAGAGAATTGCTTGAACCCGGGAGGGGGAGGTTGCAGAGGGCCAAGATCGTACCACTATACTCCAGCCTGGGTGACAGGATGAGACTCCATCTTAAAAAAAAAAAAAAAAAAAAAAATTAGCCAGGCGTGGTGCGGGCACTTGTAATCCCAGCTATTCAGGAGGCTGAGGCAGGAGAATTGCTTGAACCCGGGAGGCAGAGGTTGCGGTGAGCTGAGATCGCACCATTGCACTCCAGCCTGGGCAACAAGAGTGAAACTCTGTCTCAAAAAAAAAACAAAA","GGCTGGGCGCAGTGGCTCACACCTGTAATCCCAGCACTTAGGGAAGCTGAGGCGAGTAGATCACCTGAGGTCAGGAGTTAGAGACCAGCCTGGCCATCATGGTGAAACCCCGTCTCTACTAAAGATACCAAAAATTAGCTGAGTGTGGTGCTGGGTGCCTGTAATCCCAGAAACTCAGGGTGCCTGTAATCCCAGCAACTCAGGGTGCCTTTAATCCCAGCAACTGAGGGTACCAGTAATCCCAGCAACTCAGGGTGTCTTTAATCCTAGCAACTGAGGGCACCTGTAATCCCAGCAACTCAGGAAGCTGAGACAGGAGAAGTACTTGAACCCAGAAGGCAGAGGTTGCAGTGAGCCGATATTGCACCATTGCACTCCAGTCTGGGCAACAAGAGTGAAACTCTGTCTCAAAAAAAAA"
"chr17","3641899","3642243","JH378198","5062782","5063109","59","1420883","GGCCAGGCACAGTGGCTCACACCTGTAATCCCAGCACTTCAGGAGGCCGAGGTGGGTAGATCACCTGAGGTCAGGGGTTTGAGACCAGCCTGACCGACGTGGCGAAACCCTGTCTCTACTACAAATACAAAAATTAGCCTTATGTGGTGGCGGGCACGTGTAATCCCAGCTACTTGGGAGGCTGAGGCAGGAGAATCGCTTGAATCTGGGAGGTGGAGGTTGCAGTGAGCCGAGATCACGCCATTGCACTCCAGCCTGGGTGACAAGAGCGAAACTCCATCTCAAAATAAATAAATACATACATACATGTATACATACATACATACATAAAAATAAAAAGTAAAA","GCCAGGCATGGTGGCTCACGCCTATAATCTCAGCACTTTGGGAGGCTGAGGCAGGCAGATCACTTGAGGTCAGGAGTTCAAGACCAGCCTGGCCAACATGGTGAAACCCTGGCTCTACTAAAAATACAAAAATTAGCCGGGTGTGGTGGCACGTGCCTATAATCCCAGCTACTCAGGAGGCTGAGGCAGAAGAATCGCTTGAATCCAGGAGGTGGAGGTTGCAGCGAGCCGAGATCACACCATTGGACTCCAGCCTGGGTGACAAGAGCGAAACTCCATCTCAAAATAAATAAATAAATACATAAAATTAAAAATAAATAAATAAATA"
"chr17","4508039","4508546","JH378206","6546474","6546861","194","2038435","GAGTTGGAGACCAGCCTGGCCAACACGGTGAAACCTCGTCCCCACTAAAAATATAAAAATTAGGCCAGGCGCGGTGGCTCACTCCTGTAATCCCAGCACTTTGGGAGGCTGAGGCGGGTAGATCATCTGAGGTCAGGAGTTCGAGACCAGCCTGGCCAACATGGTGAAACTCCGTCTCTACTAAAAATACAAAAATTAGCTGGGCTGGTAGCGGGCACCTGTAATCCCAGCTACTTGGAAGGGTGAGGCAGGAGAATCACTTGAACCCAGGAGGTGGAGGTTGCAGTGAGCCAAGATTGCAGCACTGTACTCCAGCCTGGGTGACAAAGCAAGACTCTGTCTCAAAAAAAAAAAAAAAAAAAAAGCCGGGCTTGGTGGTGAGTACCGGTAATCCCAGCTACTTGGAAGGCTGAGGCGGCGGACGTTGTACTTAGCCGAGATCATGCCATTGCACTCCAGCCTGGGTAACAGGCAAAAACTCTGTCTCAAAAAATAATAAATAATAAAA","GGCCACACATGGTGGCTAACGCCTGTAATCCCAGCACTTTGGGAGGCCAAGTCGGGTGGATCATGAGGTCAGGAGACCAAGACCATCCTGGCCAAATGGTGAAACCCCGTCTCTACTAAAAATACAAAAATTAGCTGGGCATGGTGGCGTGTGCCTGTAATCCCAGCTACTCAGGAGGCTGAGGCAGGACAATTGCCTGAACCCAGGAGAATTAGCTGGGCATGGTGGCGTGTGCCTGTAATCCCAGCTACTCAGGAGGCTGAGGCAGGACAATTGCCTGAACCCAGGAGGCGAAGGTTGCGGTGAGCCGAGATTGTGCCATTGCACTCCAGCCTGGGTAACAAGAGCGACACTCTGTCTCAAAAAAAAAAAAAAAAAAAAAAAAAAA"
"chr17","4560867","4561450","JH378118","18053084","18053501","257","13492217","GGCTGGGGGTGGTGTCTCTTGCCTGTAATCCCAACACTTTAGCAGGCTGAGGTGTGAGTATGGCTTGAGCCAGGAGTTCTAGACCAGCCTAGGAAACATGGCGAGATCCCTATCTCTACTAATACAAAAATTAGCCGGGCGTGGTGGCAAGCACCTGCAATCTCAGCTACTCGGGAGGCTGAGGTGGGAGGGCCGCTTGAGCCCAGGAGGTCCAGGCTGCAGTAAGCACTTATTTAAAAAAAAAAGAAGAGAAAAGATACAGAAATTAGCCAGGCGTGGTGGTGGGCACCTGTAATCCCAGCTACTCAGGAGGCTGAGGCAGGAAAATCACTTGAACCCGGGAGGCAGAGGTTGCAGTGGGCCGAGATCACACCATTGTACTCCAGCCTGGGCAACAAGAGCGAAACTCTGTCTCAAAAAAAAGAAAAGTAAAGTAAAGAAAAGATACAGAAATTAGCCAGGTGTGGTGGCGGGTGCCTGTAATCCCGCTACTTGGGAGGCTGAGGCAGGAGATTGCAGTGAGCCAAGATTGTGCCATTGCATTCCAGCCTGGGCAACAAGAGCAAAACTCCGCCTCAAAAAAA","GGCTGGGCGCAGTGGCTCACACCTGTAATCCCAGCACTTAGGGAAGCTGAGGCGAGTAGATCACCTGAGGTCAGGAGTTAGAGACCAGCCTGGCCATCATGGTGAAACCCCGTCTCTACTAAAGATACCAAAAATTAGCTGAGTGTGGTGCTGGGTGCCTGTAATCCCAGAAACTCAGGGTGCCTGTAATCCCAGCAACTCAGGGTGCCTTTAATCCCAGCAACTGAGGGTACCAGTAATCCCAGCAACTCAGGGTGTCTTTAATCCTAGCAACTGAGGGCACCTGTAATCCCAGCAACTCAGGAAGCTGAGACAGGAGAAGTACTTGAACCCAGAAGGCAGAGGTTGCAGTGAGCCGATATTGCACCATTGCACTCCAGTCTGGGCAACAAGAGTGAAACTCTGTCTCAAAAAAAAA"
"chr17","4846296","4846953","JH378118","18053084","18053501","290","13206788","GGCCAGGTGCAGTGGCTCACGCCTGTAATCCCAGCACTTTGGGAAGCCCAGGTGGGCGGATCACCCAAGGTCAGGGGTTCGAGACCAGCCTGGCCAACATGGTGAAACTCCATCTCTACTAAAAATAGAAAAAAATGGCCTGGTACGGTGGCTAACGCCTGTAATCCCAGCACTTTGGTAGGCCGAGGCAGGCAGATCACGAGGTCAGAAGATCGAGACCATCCTGGCTAACATGGTGAAACCCCGTCTCTACTAAAAATACAAAAAAGTAGCCAGGTGTGGTGGTGGGTGCCTGTAGTCCTAGCTACTCGGGAGGCTGAGGCAGGAGAATGCCGTGAACCCGGGAGGTGGAGCTTGCAGTGAGCTGAGATCACGCCACTGCACTCCAGCCTGGGTGACAGTGCGAGACTGTCTCCAAAAAAAAAAAAAAAAAAAAATTATATATATAATACACACACACACACACACACACACACACACACACAAATCAGCCAGGCGTGGTGGTGCGCACCTGTAATCCCAGCTACTCGGGAGGCTGAGGCAGGAGAGCTCCTCGAACCCAGGAGGCGAAGGTTGCAGTGAGCCGAGATCACACCATTGCACTCCAGCCTGGGCAACAAGAGCGAAACTCTGTCTCAAGGAAAAAAAAAAAAAAAAA","GGCTGGGCGCAGTGGCTCACACCTGTAATCCCAGCACTTAGGGAAGCTGAGGCGAGTAGATCACCTGAGGTCAGGAGTTAGAGACCAGCCTGGCCATCATGGTGAAACCCCGTCTCTACTAAAGATACCAAAAATTAGCTGAGTGTGGTGCTGGGTGCCTGTAATCCCAGAAACTCAGGGTGCCTGTAATCCCAGCAACTCAGGGTGCCTTTAATCCCAGCAACTGAGGGTACCAGTAATCCCAGCAACTCAGGGTGTCTTTAATCCTAGCAACTGAGGGCACCTGTAATCCCAGCAACTCAGGAAGCTGAGACAGGAGAAGTACTTGAACCCAGAAGGCAGAGGTTGCAGTGAGCCGATATTGCACCATTGCACTCCAGTCTGGGCAACAAGAGTGAAACTCTGTCTCAAAAAAAAA"
"chr17","6289040","6289368","JH378152","15932639","15932952","57","9643599","GGCTGGGCGTGGTGGCTCACGCCTGTAATCCCAGCACTTTGGGAGGCCAAGGTGGGTAGATCACCTGAGGTCAGGAGTTTGAGACCAGCCTGGCCAATGTGATGAAACCCTGTATCCACTAAAAAAAAAAAAAAAAAAAAAAAAAAAAATAGCTGGGTGAAGTGGCAAGCACCTGTAATCCCAGCTACTTGGGAGGCTGAGGCAGGAGAATCCCAGGAGGTGGAGATTGATCCCAGGAGGTGGAGGTTGCAGTGAGTCAAGATCATGCCATTGCACTCCAGCCTGGGTGACAAGAGCAAAATTCCATCTCAAAAAAAAAAAAAAGAAAA","GGCCGGGCATGGTGGCTCAAGCCTGTAATCCCAGCACTTTGGGAGGCCGAGGCGGGTGGATCACGAGGTCAAGAGATTGAGACCATCCTGGTCAACATGGTGAAACCCCGTCTCTACTAAAAATACAAAAAAAAAAAAAAAAAAAATAGCTGGGTGTGGTGGCGTGTGCCTGTAATCCCAGCTACTCAGGAGGCTGAGGCAGGAGAATTGCCTGAACCCGGGAGGCGGAGGTTGCGGTGAGCCGAGATCGCGCCATTGCACTCCAGCCTGGGTAACAAGAGCGAAACTCCGTCTCAAAAACAAAAAAAACAAAA"
"chr17","7490664","7491294","JH378118","18053084","18053501","283","10562420","GGCCGGGAGCGGTGGTTCACTCCTGTAATCCCAGCACTTTGGCAGACCGAGGAGGGTGGATCAACTGAGGTCAGAACTTCAAGACCAGCCTGCCGGGCACAGTGGCTCACACCTGTAATCCCAGCACTTTGGGAGGCTGAGGCAGGTGGATCACCCGAGGTCGGGAGTTCAAGACCAGCCTGACCAACGTGGAGAAACCCCGTCTCTACTAAAAATACAAAATTAGCTGGGGTGGTGGCACGTACCTGTAATCCCAGCTACTCGGGAGGCTGAGGCAAGAGAATCGCTTGAACCCGGGAGGCGGAGGTTGCGGTGCGCCGAGATCGCGCCATTACACTCCAGCCTGGGCAAAAAGAGCGAAACTCTGTCTCAAAAAATAAAAAAAGAAAAAGAAAAAGAAAAAGAAGTTCAAGACCAGCCTGGTCAACGTGGTGAAACCCCGTCTCTACTAAAAACACAAAAAAAATTAGGCGGGTGTTGTGGTGGGTGCCTGTAATCCCAGCTACTCAGGAGGCCAAGGCAGGAGAATCACCTGAACCCTGGAGGTGGAGGTTGCAGTGAGTCGAGATCGCACCATTGCACTCCAGCGTGGGTGACAGAGAGCGAGACTCCGTCTCAAAAAAAAAGAAAA","GGCTGGGCGCAGTGGCTCACACCTGTAATCCCAGCACTTAGGGAAGCTGAGGCGAGTAGATCACCTGAGGTCAGGAGTTAGAGACCAGCCTGGCCATCATGGTGAAACCCCGTCTCTACTAAAGATACCAAAAATTAGCTGAGTGTGGTGCTGGGTGCCTGTAATCCCAGAAACTCAGGGTGCCTGTAATCCCAGCAACTCAGGGTGCCTTTAATCCCAGCAACTGAGGGTACCAGTAATCCCAGCAACTCAGGGTGTCTTTAATCCTAGCAACTGAGGGCACCTGTAATCCCAGCAACTCAGGAAGCTGAGACAGGAGAAGTACTTGAACCCAGAAGGCAGAGGTTGCAGTGAGCCGATATTGCACCATTGCACTCCAGTCTGGGCAACAAGAGTGAAACTCTGTCTCAAAAAAAAA"
"chr17","9634166","9634493","JH378110","12773123","12773444","45","3138957","GGCTGGGTGCGGTGGCTCACGCCTGTAATCCCAGCACTGTGGGAGGCCGAGGCAGGTGGATCACCTGAGGTCAGGAGTTTGAGACCAGCTTGGCCAACATGGTGAAACCCTGTCTGCACTAAAAATACAAAAAAAAAAAAAAAAAAAAAAAAATTAGCTGGGTGTGGTGGCGGACGCCTATAATCCCAGCTACTGGGGAGGCTAAGGCAGGAGAATCGCTTGAACCTGGGAGGTGGAGATTGCAGTGAGCCAAGATGGTGCCATTGCACTCCAGCCTGGACAACAAGAGCGAAACTCGGTTTCAAAAAAAAAAAAAAAAAAAAAAAAA","GGCTGGGCGTGGTGGCTCATGCCTATAATCCCAGCACTTGGAGAGGCCAAAGCAGGCAGATTATTTGAGGTCAGGAGTTCCAAACCAGCCTGGCCAACATGGTGAAACCCTGTATCTACTAAAAATGCAAAAAAAAAAAAAAAAAAAAAAATTAGCTGGGCGTGGTGGCAGGTGACTGTATCCCAGTACTTGGTAGGCTGAGGCAGGAGAATTGCTTGAACCTGGGAGGTGGAGGTTGCAGTGAGCTGAGATTGTGCCATTGCACTCCAGCCTGGGCAACAAGAGCAAAACTCTGTCTCAAAAAAAAAAAAAAAAAAAAAAA"
"chr17","9636859","9637187","JH378193","2430153","2430476","55","7206706","GACACGGTAGCTCACGCCTGTAATCCCAGCACTTTGGGAGGTCGAGGCGGGTGGATCACCTGAGGTCAGGAGTTTAAGACCAGCCTGGCCAACATGGTGAAACCCCGTCTCTGCTAAAAATACAAGAATTAGCCAGGCGTGGTGGTGGGCGCCTGTAATCCCAGCTACTGGGGAGGCTGAGGCAGGAGAATCACTTGAACCCAGAAGGTGGAGGTTGCAGTGAGCCAAGACCACACCACTGGACTGCAGCCTGGCGGACAAGAGCGAGACTCTGTCTCAAAAACAACAACAACAACAACAACAACAACAAAAGAAAGAAAAGAAAAGAA","GGCCGGGCACAGTGGCTCAAGCCTGTAATCCCAGCACTTTGGGAGGCCGAGGTGGGTGGATCACGAGGTCAAGAGATCGAGACCAACCTGGTCAACATGGTGAAACCCCGTCTCTACTAAAAATACAAAAATTAGCTGGGCATGGTGGTGTGTGCCTGTAATCCCAGCTACTCAGGAGGCTGAAGCAGGAGAATTGCCTGAACCCAGGAGGAGGAGGTTGCGGTGAACCAAGATCACGCCATTGCACTCCAGCCTGGGTAACAAGAGCGAAACTCTGTCTCAAAACAAAACAAAACAAAACAAAACAAAACAAACAAAAAAAAA"
"chr17","9725612","9725938","JH378224","2846632","2846964","49","6878980","GGGCGTGGTGGCTCACACCTGTAATCCCAGCACTTTGGGAGGCCGAGGTGGGCGGATTGCCTGAGGTCAGGAGTTCGAGACCAGCCTGGCCAACCCGGTGAAACCCTGTCTCTACTAAAATACAAAAAAAAAAAAAAAAAAAAAAAAAAATTTAGCTGTGTGTGGTGGTGTGCACCTGTAATCCCAGCTACTCAGAAGGCTGAGGCAGGAGAATCGCTAGAACCCGGGAGGCGGAGGTTGCAGTGAGCCGAGATCGCACCATTACGCTCCAGCTTGGGCAACAAGAGTGAAACTCCATCTCAAAAACAAAACAAAACAAAACAAAAA","GGCCAGGCAGGGTGGCTTACATCTGTAATCCCAGCACTTTGGGAGGTCAAGGCGAGTGGATCACCTGAGGTCATGAGTTCAAGACCAGCCTGGCCAACTTGGTGAAACCCTGTCTCTACTAAAAATACAAAAAAAAAAAAAAAAAAAAAAAAAAAAATTAACTGGGTGTGGTGGTGCACACCTGTAATCCCAGCTACTCAGGAGGCTGAGGCAGGAGAATCCCTTGAACACGGGAGGTGGAGGTTGCAGTGAGCCGAGATCATGCCATTGCACTCCAGCCTTGGTGAAAAGAGCAAAACTCTGTCTTAAACAAAACAAAACAAAACCAGAAAA"
"chr17","11904179","11904388","JH378115","24252957","24253162","48","12348778","CCTGTCTTTACAAAAAATGCAAAAACAAAACAAAACAAAACAAAACAAAAACCGGGCATGGTGGTGAGCACCTGTAATCCCAGCTACTTGGGAGTTTGAGGCAGGAGAATCACTTGAACCTGGGAAGCGGAGGTTGCAGTGAGCCGAGACCGCGCCATTGCACTCCAGCCTGGGCAACAAGAATGAAACTCTGTCTCAAAAAAAAAAAAA","TGGTGAAACCCTGTCTTTACTAAAAATACAAAAAAAAAAAAAATTAGCTGGGCATGGTGGCACATGCCTGTAGTCCCAGCTGCTCGGGAGGCTGAGGCAGGAGAATTGCTTGAACCCAGGAGGCGGAGGTTGCAGTGAGCCGAGATCGAGCCATTGCACTCCAGCCTGGGCAACAAGAGCAAAACTCCGTCTCAAAACAAAATAAA"
"chr17","15884346","15884946","JH378118","18053084","18053501","249","2168738","GCCAGGCAGGTGGCTCAGGACTGTAATCCCAGCCTTTTGGGAGGCTGAGGCGAGTGGATCACCTGAGGTCAGGAGTTCGACACCAGCCTGGTCAACATGGTGAAACCCCGTCTCTACTAAAAAATACAAAAAATTGGCCAGGCGCAGTGTCTCACGCCTGTAATCCCAGCACTTTAGGAGGCTGAGGCAGGTGGATCACTTGGTCAGGAGATCGAGACCATCCTGGCCAACATGGTGAAACCCTGTCTCTATCAAAAATACAAAAATTAGCTGGGCGTGGTGGCATATGCCTATAATCCCAGCTACTTGGGACGCTGAGGCAGGAGAATCACTTGAACCAGGGAGTCAGAAGTTGCAGTGAGCCGAGATTGCGCCACTGCACCCCAGCCTGGTGACAGAGTGAGACTGTCTTAAAAAACAAAAAACAAAAAATTAGCCAGGTATGGTACCAGGTGCCTGTAACCCCAGCTACTTGGGAGGCTGAGGCAGGAGTATCGCTTGAACCCTGGAGGTGGAGGATGCAGTGAGCTGAGAGCACGCCATTGTACTCCAGCCTGGGCAACAAGAGTGAAACTCCATCTAAAATAAATAAAAATAAAAA","GGCTGGGCGCAGTGGCTCACACCTGTAATCCCAGCACTTAGGGAAGCTGAGGCGAGTAGATCACCTGAGGTCAGGAGTTAGAGACCAGCCTGGCCATCATGGTGAAACCCCGTCTCTACTAAAGATACCAAAAATTAGCTGAGTGTGGTGCTGGGTGCCTGTAATCCCAGAAACTCAGGGTGCCTGTAATCCCAGCAACTCAGGGTGCCTTTAATCCCAGCAACTGAGGGTACCAGTAATCCCAGCAACTCAGGGTGTCTTTAATCCTAGCAACTGAGGGCACCTGTAATCCCAGCAACTCAGGAAGCTGAGACAGGAGAAGTACTTGAACCCAGAAGGCAGAGGTTGCAGTGAGCCGATATTGCACCATTGCACTCCAGTCTGGGCAACAAGAGTGAAACTCTGTCTCAAAAAAAAA"
"chr17","16331846","16332458","JH378118","18053084","18053501","252","1721238","GGCCATGTGTGGTGGTTCACACCTGTAATCTCAGAACTTTGGGAGGCCGAGGTGGGTGGATCACCTGAGGTCAGGAGTTCGAGACCAGCCTGGCCAACATGGTGAAACCTCATCTCTACTAAAAATACAAAAAATTAAGGCCATACCCAGAGACTCATGCCTGTAATCCCAGCACTTTGGGAGGCTGAGGCGGATGGATCACTTGAGGTCAGGAGTTCAAAACCAGCCTGGCCAACATGGTGAAACCCCATCTCTACTAAAAATATAAAAATTAGCCGGGTGTGATGGCAGGCACCTGTAATCCCAGCTACTTGGGAGGCTGAGGCAGGAGAATTGCTTGAACCCAGGAAGCAGAGGTTGTGGTGAGCCGAGGTCGCGCCATTGCACTCCAGCCTGGGCAACAGAATGAGACTGTCTCAAAAAAAAAAAAAAAAAAAAATCAGCCAGGAGTGGTGGCGGGGGCACCTGTAATCCCAGCTACTCGGGAGGCTGAGGCAGGAGAATCGCTTGAACTCAGGAGGCAGAGGTTGCAGTGAGCTGATATCTCGCCATTGCACTCCAGCCTGGGCAACAAGAGTGAAACTGTCTCAAAAAAAAAAAAAAAAAAAAAGAA","GGCTGGGCGCAGTGGCTCACACCTGTAATCCCAGCACTTAGGGAAGCTGAGGCGAGTAGATCACCTGAGGTCAGGAGTTAGAGACCAGCCTGGCCATCATGGTGAAACCCCGTCTCTACTAAAGATACCAAAAATTAGCTGAGTGTGGTGCTGGGTGCCTGTAATCCCAGAAACTCAGGGTGCCTGTAATCCCAGCAACTCAGGGTGCCTTTAATCCCAGCAACTGAGGGTACCAGTAATCCCAGCAACTCAGGGTGTCTTTAATCCTAGCAACTGAGGGCACCTGTAATCCCAGCAACTCAGGAAGCTGAGACAGGAGAAGTACTTGAACCCAGAAGGCAGAGGTTGCAGTGAGCCGATATTGCACCATTGCACTCCAGTCTGGGCAACAAGAGTGAAACTCTGTCTCAAAAAAAAA"
"chr17","16464101","16464461","JH378293","1845184","1845523","61","14618917","GGCCGGGCGCCGTGGCTCACGCCTATAATCCCAGCACTTTGGGAGGCCGAGGCGGGTGGATCACCTGAGGTCAGGAGTTCGAGACCAGCCTGACCAACATGGTGAAACCCCCGTCTCTGCTAAAAAAAAAAAAATATATATATATATATATATAATATATAATATATATATATATATATATATAAAATAGCTGGGCATGGTGGCAGGCACCTGTAATCCCAGCTACTCAGGAGGCTGAGGCAGGAGAATCGCTTGAACCTGGGAGGTGGAGGTTGCAGTGGGCTAAGATCACACCATCGCACTCCAGCCTGGGCGACAGGAATGAAACGCTGTCTCAAAAAAAAAAAAAAAAAAAAAAAAA","GGCCGGGTGCGGTGGCTCACGCCTGTAATCCCAGCACTTTGGGAGGCCAAGGCGGGTGGATCACCTGAGGTCAGAAGTTCGAGACCAGCCTGGCCAACATGGTGAAACCCCGTCTCTGCTAAAAAGAAAAAAATAAGAAAAAAACAAAATAAGAAAATAATTTTAAAAAATACAAAATTAGCTGGGCGTGGTGGCAGGCACCTGTAATTCCAGCTATTCAGGAGGCTGAGGCAGGGGAATCACTTGAACCCAGGAGGCAGAGGTTGCAGTGAGCCAAGATGACGCCATTGCACACCAGCCTGGGCAACAAGAGTGAAACTCCGTCTCAAAAAAAAAACAA"
"chr17","16469420","16470033","JH378118","18053084","18053501","254","1583664","GCCAGGGGTGGTGGCTCATGCCTGTAATCCCAGCACTTTGGGAGGCTGAGGCGGGCAGATTGCCTGAGGTCAGGAATTCAAGACCAGCCTGGCCAACATAGTGAAACCCTGTCTCTACTAAAAATGCAAAGAATTAGCTGGGTGTTGGCCGGGCACGGTGGCTGACACCTGTAATCCCAGCACTTTGGGAGGCCTAGGCAGGCGGATCACCTGAGGTTGGGAGTTCGAGACCAGCCTGACCAACATGGAGAAACCCCGTCTCTACTGAAAATAAAAAACTAGCCAGGCATGGTGGCCCATGCCTGTAATCCCAGCTAATTGGGAGGCTGAGGCAGGAGAATCGCTTGAACCCAGGAGGCAGAGGTTGCGGTGAACCAAGATCGCATCAATGCACTCCAGCCTAGGCGACAAGAGCAAAACTCCGTCTCAAAAAAAAGAATTAGCTGGGTGTGGTGGGTGGGAACCTGTAATCCCAGTTACTAGGGAGGCTGAGGCAGGAGAATTGCTTGAACCCAGGAGGCGGAGGTTGTGGTGAGCCGAGATCGCGCCATTGCACTCCAGCCTGGACAACAAGAGCGAATCTCCGTCTCAAAAAAAAAAAAAAAAAAAAAAAA","GGCTGGGCGCAGTGGCTCACACCTGTAATCCCAGCACTTAGGGAAGCTGAGGCGAGTAGATCACCTGAGGTCAGGAGTTAGAGACCAGCCTGGCCATCATGGTGAAACCCCGTCTCTACTAAAGATACCAAAAATTAGCTGAGTGTGGTGCTGGGTGCCTGTAATCCCAGAAACTCAGGGTGCCTGTAATCCCAGCAACTCAGGGTGCCTTTAATCCCAGCAACTGAGGGTACCAGTAATCCCAGCAACTCAGGGTGTCTTTAATCCTAGCAACTGAGGGCACCTGTAATCCCAGCAACTCAGGAAGCTGAGACAGGAGAAGTACTTGAACCCAGAAGGCAGAGGTTGCAGTGAGCCGATATTGCACCATTGCACTCCAGTCTGGGCAACAAGAGTGAAACTCTGTCTCAAAAAAAAA"
"chr17","17534259","17534875","JH378118","18053084","18053501","268","518825","GGCTGGGGCGGTGGCTCACCTGTAATCCCAGCACTTTGGGAGGCAGAGGTGGGCGGATCGCCTGAGGTCAGAAGTTGGAGACCAGCCTGGCAACATGGTGAAACCCTGTCTCTACTAAAAAAAAAAAAAAAAAAAAAAAATGGCCGGGCATGGTGGCTCAAGCCTGTAATCCTAGCACTTTGGAAGGCTGAGGCGGGTGGATCACAAGGTCAGGAAATCGAGACCATCCTGGCTAACATGGTGAAACTCCGTCTCTACTAAAAATACAAAAAAAATTAGCCGGGCGTGGTGGTGGGTGCCTGTAGTCCCAGCTACTCGGGAGGCTGAGGCAGGCAAATGGAGTGAACCCGGGAGGCAAACTTGCAGTGAGCCAAGATGGCGCCATTGCACTCCAGCCTGGGCAACAAGAGCAAGACTCCTTCTCAAAAAAAAAAAAAATATATATATATATATATAGTCGGGCATGGTGGCAGGCACCTGTAATCCCAGCTACTCAGAGGCTGAGGCAGGAGAATCGCTTGAACCCTGGAGGTGGAGGTTGCAGTGAGCCAAGGTCATGCCATTGCACTCCAGCCTGGGCAACAAGAGCAAGACTCCGTCTCAAAAAAAAAAAAAAA","GGCTGGGCGCAGTGGCTCACACCTGTAATCCCAGCACTTAGGGAAGCTGAGGCGAGTAGATCACCTGAGGTCAGGAGTTAGAGACCAGCCTGGCCATCATGGTGAAACCCCGTCTCTACTAAAGATACCAAAAATTAGCTGAGTGTGGTGCTGGGTGCCTGTAATCCCAGAAACTCAGGGTGCCTGTAATCCCAGCAACTCAGGGTGCCTTTAATCCCAGCAACTGAGGGTACCAGTAATCCCAGCAACTCAGGGTGTCTTTAATCCTAGCAACTGAGGGCACCTGTAATCCCAGCAACTCAGGAAGCTGAGACAGGAGAAGTACTTGAACCCAGAAGGCAGAGGTTGCAGTGAGCCGATATTGCACCATTGCACTCCAGTCTGGGCAACAAGAGTGAAACTCTGTCTCAAAAAAAAA"
"chr17","17916069","17916669","JH378118","18053084","18053501","243","137015","GCCGGGTACAGTGGCTCACACCTGTAATCCTAGCACTTTGGGAGGCCGAGGCGGGTGGATCACCTGAGGTCAGGAGTTCGAGACCAGCCTGGCCAACATGATGAAACCCTACCTCAGCCAGGTACGGTGGTTCACGCCTGTAATCCTAGCACTTTGGGAGGCTGAGGCAGGTGGATTGCCTGAACTCAGGAGTTTGAGACCAGCCTGGGCAGCATGGTGAAACCCCATCTGTACTAAAATACAAAAACTTTGCTGGGCGTGGCGGCATGCACATGTAGTCCCAGTTACTTGGGAGGCTGAGGCAGGATAATTGTTTGAACCTGGGAGGCGGAGGTTGTACAGTGAGCCAAGATCGCGCCACTACACTCTAGCGTAGGTGACAGAGCGAGATTCCGCCTCCAAAAAAAAAAGAAACCCTGTCTCTACTAAAAATACAAACAATTAGCTGGGCGTGGTGGTGGGCGCCTGTAATCCCAGCTACTTAGGAGGCTGAAGCAGGAGAATCGCTTGAGCCCAGGAAGTGGAGGTTGCAGTGAGCTGAGATTGCTCCATTGCACTCTAGCCTGGGCAACAAGAGTGAAACTCTGTCTCAAAAAAAGAA","GGCTGGGCGCAGTGGCTCACACCTGTAATCCCAGCACTTAGGGAAGCTGAGGCGAGTAGATCACCTGAGGTCAGGAGTTAGAGACCAGCCTGGCCATCATGGTGAAACCCCGTCTCTACTAAAGATACCAAAAATTAGCTGAGTGTGGTGCTGGGTGCCTGTAATCCCAGAAACTCAGGGTGCCTGTAATCCCAGCAACTCAGGGTGCCTTTAATCCCAGCAACTGAGGGTACCAGTAATCCCAGCAACTCAGGGTGTCTTTAATCCTAGCAACTGAGGGCACCTGTAATCCCAGCAACTCAGGAAGCTGAGACAGGAGAAGTACTTGAACCCAGAAGGCAGAGGTTGCAGTGAGCCGATATTGCACCATTGCACTCCAGTCTGGGCAACAAGAGTGAAACTCTGTCTCAAAAAAAAA"
"chr17","18237318","18237912","JH378118","18053084","18053501","239","184234","GGCCATGCGTGGTGGCTCACGCCTGTAATCCCAGTACTTTGGGAGGCTGAGGTGGGAGGATCACCTGAGGTCAGGAGTTCGAGACCAGCCTGGCCAACATGATGAAACCCTGTCTCTACTAAAAATGCAAAAAATTGGCCGGGCACGGTGGCTCACGCCTGTAATCCCAGCACTTTGGGAGGCCAAGGCGGGTGGATCACAAGGTCAGGAGCTTGAGACCAGCCTGGCCAATATGGTGAAACCCCATCTCTACTAAAAATACAAAAATTAGCCAGGCGTGGTGGTACACACCTGTAGTCCCAGCTACTCGGGAGGCTGAGGCAGGAGAATTGCTTGAACTCAGGAGGCAGAGGTTGCAGTGAGCTGAGATGGTGCCACTGCACTGCAGCCTGGGCAACAGAGTGAGACTTCATCTCAAAAAAAAAAAAAAAATTAACCGGGTGTGGTGGCACGTGCCTATGGTCCCAGCCACTGGGGAGGCTGAGGCAGGAGAATCGCTTGAACACAGGAGGCAGAAGTTGCAGTGAGCTGAGATTGCACCACTGCACTCCAGCCTGGGTGACAAGAGTGGAACTCCATCTCAAAAAAAAAAGAA","GGCTGGGCGCAGTGGCTCACACCTGTAATCCCAGCACTTAGGGAAGCTGAGGCGAGTAGATCACCTGAGGTCAGGAGTTAGAGACCAGCCTGGCCATCATGGTGAAACCCCGTCTCTACTAAAGATACCAAAAATTAGCTGAGTGTGGTGCTGGGTGCCTGTAATCCCAGAAACTCAGGGTGCCTGTAATCCCAGCAACTCAGGGTGCCTTTAATCCCAGCAACTGAGGGTACCAGTAATCCCAGCAACTCAGGGTGTCTTTAATCCTAGCAACTGAGGGCACCTGTAATCCCAGCAACTCAGGAAGCTGAGACAGGAGAAGTACTTGAACCCAGAAGGCAGAGGTTGCAGTGAGCCGATATTGCACCATTGCACTCCAGTCTGGGCAACAAGAGTGAAACTCTGTCTCAAAAAAAAA"
"chr17","18951167","18952093","JH378118","18053084","18053501","537","898083","GGCCAGGGGCAGTGGCTCATGCCTGTAATCCCAGCATTTTGGGATGCCAAGGCTGGTGGATCAACTGAGGTCAGGAGTTTCAGACCACCCTGGCCAACATGGCGAAATCCCATCTCTACTAAAAATACAAAAATTAGGCCAGGCACAGTGGCTCATGCCTGTAATCCCAGCACTTTGAGAGGCCAAGGCGGGCGATCACGAGGTCAGGAGATTGAGACCATCCTGGCTAACACGGTGAAATCCTGTCTCTACTAAAAAAAAAAAATACAAAAAATTAGCCGGGACGTGGTGGCTGGCACCTGTAGTCCCAGCTACTCGGGAGGCTAAGGCAGGAGAATGGCATGAACCCGGGAGATGGAGCTTGCAGTGACCCGAGATCGCGTCACTGCACTCCAGCCTGAACAACAGAGCAAGACTATATCTCAAAAAAAAAAAAAAAAAAAAGGCCGGGTGCAGTGGCTCACGTCTGTAATCCCAGCACTTTGGGAGGCCGAGGTGGGTGGATCACGAGGTCAGGAGATCGAGACCATCCTGGCTAACATGATGAAACCCCATCTCTACTAAAAAATACAAAAAATTAGCCGGGTGTGGTGGCAGGCACCTGTAGTCCCAGCTACTCGGGAGGCTGAGGCAGGAGAATGGCATGAACCTGGGTAGTGGAACTTGCAGTGAGCCGAGATCACGCCACTGCACTCCAGCCTGGGCGACAGAGCGAGACTCTGTCTCAAAAAAAAAAAAAAAAAAAAAATTAGCCGGGCATGGTGGTGGGTGCCTGCAATCCCAGCTAGTCAGGAGGCTGAGGCTGGAGAATCCCTTGAACCCAGGAGGTAGAGGTTGCAGTGAGCCAAGATCACGCCATTGCATTCCAGCCTGGGCAACAAGAGTGAAATTCTGTCTCAAAAAAATAAACAAACAAGTAAAATAAAA","GGCTGGGCGCAGTGGCTCACACCTGTAATCCCAGCACTTAGGGAAGCTGAGGCGAGTAGATCACCTGAGGTCAGGAGTTAGAGACCAGCCTGGCCATCATGGTGAAACCCCGTCTCTACTAAAGATACCAAAAATTAGCTGAGTGTGGTGCTGGGTGCCTGTAATCCCAGAAACTCAGGGTGCCTGTAATCCCAGCAACTCAGGGTGCCTTTAATCCCAGCAACTGAGGGTACCAGTAATCCCAGCAACTCAGGGTGTCTTTAATCCTAGCAACTGAGGGCACCTGTAATCCCAGCAACTCAGGAAGCTGAGACAGGAGAAGTACTTGAACCCAGAAGGCAGAGGTTGCAGTGAGCCGATATTGCACCATTGCACTCCAGTCTGGGCAACAAGAGTGAAACTCTGTCTCAAAAAAAAA"
"chr17","20996420","20997041","JH378118","18053084","18053501","266","2943336","GGCTAGGCGCGGTGGTTCACACCTGTAATCCCAGCACTTTGGGAGGCCAAGGTGGGTGGATCACCTGTGGTCAGGAGTTCGAGACCAGCCTGGCCAACATTGTGAAACCCCGTCTCTACTAAAAATGCAAAAAATTAGCTGGGCGACCAGTCATGGTAGCTCACGCCTGTAATCCTAGCACTTTGGGAGGCCAAGGCGGGTGGATTGCCTGAGCTCAGGAGTTAGAGGCCAGCCTGGGCAACATGGTAAAACCCTGTCTCTACTAAAATACAAAAAAAAAAAAAAAAATTAGCTGGGTGTGACAGCGTGCATCTGTAATCCCGGTTACTTGGGAGGTTGAGGCAGGAGAATTCCTTGAACCTAGGAGGCGGAGGTTACAGTTAGCCGAGATCACGCCATTGCACTCCAGCCTGGGCAACAGAGCGAGACTCCATCTCAAAAAAAAAAAAAAAAATTCAGCTGGGCGTGGTGGCGGGCACCTGTGATCCTAGCTACTCAGGAGGCTGAGGCAGGAGAATCATTTGAACTCCGGAGGCGGAGGTTGCAGTGACCCTAGATCGCACCATTGTGTTCCAGCCTGAGCAACAAGAGCGAGACGCCATCTGAAAAAAAAAAAAAGAAA","GGCTGGGCGCAGTGGCTCACACCTGTAATCCCAGCACTTAGGGAAGCTGAGGCGAGTAGATCACCTGAGGTCAGGAGTTAGAGACCAGCCTGGCCATCATGGTGAAACCCCGTCTCTACTAAAGATACCAAAAATTAGCTGAGTGTGGTGCTGGGTGCCTGTAATCCCAGAAACTCAGGGTGCCTGTAATCCCAGCAACTCAGGGTGCCTTTAATCCCAGCAACTGAGGGTACCAGTAATCCCAGCAACTCAGGGTGTCTTTAATCCTAGCAACTGAGGGCACCTGTAATCCCAGCAACTCAGGAAGCTGAGACAGGAGAAGTACTTGAACCCAGAAGGCAGAGGTTGCAGTGAGCCGATATTGCACCATTGCACTCCAGTCTGGGCAACAAGAGTGAAACTCTGTCTCAAAAAAAAA"
"chr17","21298865","21299429","JH378206","6546474","6546861","222","14752391","GGCCGAGGCAGGTGGATCACCTGAGGTCAGGAGTTCAAGACTAGTCTGGCCAACATGGTGAAACCCTGTCTCTACTAAAAATACAAAAAATTGGCCGGGCGCGGTGGCTCATGCCTGTAATCCCAGCACTTTGGGAGGCTGAGGCGGGTGGATCACGAGGTCGGGAGATCGAGACCATCCTGGCTAACACAGTTAAACCCTTTCTCTACTAAAAAATACAAAAAATTAGCCGGGCGTAGTGGGGGGCGCCTGTAGTCCCAGCTACTCAGGAGGCTGAGGCAGGAGACTGGCGTGAACCCGGGAGGCAGAGCTTGCAGTGAGCTGAGATCACGTCACTGCATGCCAGCCTGGGCGACAGAGCGAGACTCTGTCTCAAAAAAAAAAAATTAGCCAGGCATGGTGGTGTACACCTGTAATCCTAGCTACTCGGGAAGCTGAGCAGGAGAACAGCTTGAACCCAGGAGGCAGAGGTTGCAGTGAGCTGAGATCACGCCATTGCACTCCAGCCTGGGCAACAAGAGTGAAACTCCGTCTCAAAAAAAAAAAAAGAAAAGAAAAAAGAAAA","GGCCACACATGGTGGCTAACGCCTGTAATCCCAGCACTTTGGGAGGCCAAGTCGGGTGGATCATGAGGTCAGGAGACCAAGACCATCCTGGCCAAATGGTGAAACCCCGTCTCTACTAAAAATACAAAAATTAGCTGGGCATGGTGGCGTGTGCCTGTAATCCCAGCTACTCAGGAGGCTGAGGCAGGACAATTGCCTGAACCCAGGAGAATTAGCTGGGCATGGTGGCGTGTGCCTGTAATCCCAGCTACTCAGGAGGCTGAGGCAGGACAATTGCCTGAACCCAGGAGGCGAAGGTTGCGGTGAGCCGAGATTGTGCCATTGCACTCCAGCCTGGGTAACAAGAGCGACACTCTGTCTCAAAAAAAAAAAAAAAAAAAAAAAAAAA"
"chr17","21663027","21663921","JH378118","18053084","18053501","517","3609943","TTGGGAGGCCAAGGTGGGCCTCCCAGACACGTGAGGTCAGGAGTTTGAGACCAGCCTGGACAATATGGCGAAACCCCATCTCTACTAAAAAAACACAAAAATTGGTTGGGCCGGGCACGGTGGCTCACGCCTGTAATCCCAGCACTTTGGGAGGCCGAAGTGGGCAGATCACGAGGTCAGGAGATCGAGATCATCTTGGCTAACATGGTGAAACTCCGTCTTTACTTAAAATACAAAAAATTAGCTGGGCATGATGGCAGGCAGTTGGAGTCCCAGCTACTTGGGAGGCTGAGGCAGGAGAATCGCTTGAACCCGGGAGGCAGAGGTTGCAGTGAGCTGAGATCGTGCCATTGCACTCCAGCCTGGGTGACAGAATGAGACTCCGTCTGAAAAAAAAACAAAAAACAAAAAACAAAAATTGGCCAGGTGCGGTGGCTCACGCCTGTAATCCCAGAACTTTGGGAGGCCGAGGCAGGTGGATCATGAGGTCAGGAGTTCAAGACCAGCCTGGCCAAGATGGTGAAACCCCATCTCTACTAAAAATACAAAAATTAGGCGGGCACGGTGGCAGGTGCCTGTAATCTCAGCTACTCAGGAGGCTGAGGCAGGAGAATTGCCTGAAGCCGGGTGGCAGAGGTTGCAGAGAGCTAAGATCACGCCACTGCACTCCAGCCTGGGTGATAGAGTAAGACTCTATCTCAAAAAAAGAAAAAAAAAAATAGCCGGGCATTGTGCTGGGCGCCTGTAATCCCAGCTACTTGGGAGGCTGAGACAAGAGAATCACTTGAACCTGGGAGGCGGAGGTTGCAGTGAGCCGAGATCGTGCCATTGCACTCCAGCCTGGGTGAGAAGAGCAAAACTCTGTCTCAAAAAAACAAAAAAAGAAGAAAACAAA","GGCTGGGCGCAGTGGCTCACACCTGTAATCCCAGCACTTAGGGAAGCTGAGGCGAGTAGATCACCTGAGGTCAGGAGTTAGAGACCAGCCTGGCCATCATGGTGAAACCCCGTCTCTACTAAAGATACCAAAAATTAGCTGAGTGTGGTGCTGGGTGCCTGTAATCCCAGAAACTCAGGGTGCCTGTAATCCCAGCAACTCAGGGTGCCTTTAATCCCAGCAACTGAGGGTACCAGTAATCCCAGCAACTCAGGGTGTCTTTAATCCTAGCAACTGAGGGCACCTGTAATCCCAGCAACTCAGGAAGCTGAGACAGGAGAAGTACTTGAACCCAGAAGGCAGAGGTTGCAGTGAGCCGATATTGCACCATTGCACTCCAGTCTGGGCAACAAGAGTGAAACTCTGTCTCAAAAAAAAA"
"chr17","21688652","21689276","JH378118","18053084","18053501","258","3635568","GGCCGGGTGCCATGGCTCACGCCTATAATCCCAGCACTTTGGGAGGCCAAGGTGGGCGGATCACCTGAGGTCAGGAGTTTGAGACCAGCCTGGCCAACATAGTGAAACCCCGTCTCTACTAAAAATACGAAAAGTTAGCTGGGGGTGCAGTGGCTCACACCTGTAATTCCAGCACTTTGGGAGGCCGAGGCAGGTGAATCACGAGGGGAGGAGTTTGAGACCAGCCTAACCAATATGTTGAAACCCCGTTTCTACTAAAAATACAAAAATTAGCTGGGCGTGGTGGCACGTGCCTATAATCCCAGCTACTCAGGAGGCTGAGGCAGGAGAATCGCCTGAACCTGGGAGGCGGAGGTGGCAGTGAGCCAAGATCACACCACTGCACTTTAGCCTGGGTGACAGAGGGAGACTCTGTCTCAAAAAACAAAACAAAACAAAACAAAAAATTAGGCAGGCTTGGTGGCACATGCCTGTAATCCCAGCTACTCAGGAGGCTGAGGCAGGAGAATTGCTTGAACCCAGGAGGCAGAAGTTGCAGTGAGCTGAGATCGCGCCATTGCACTCCAGCCTGGGTAACAAGAGTGAAACTCCATCTCAAAAAAAAAAAAAAAAAAAAAAAAAAAAA","GGCTGGGCGCAGTGGCTCACACCTGTAATCCCAGCACTTAGGGAAGCTGAGGCGAGTAGATCACCTGAGGTCAGGAGTTAGAGACCAGCCTGGCCATCATGGTGAAACCCCGTCTCTACTAAAGATACCAAAAATTAGCTGAGTGTGGTGCTGGGTGCCTGTAATCCCAGAAACTCAGGGTGCCTGTAATCCCAGCAACTCAGGGTGCCTTTAATCCCAGCAACTGAGGGTACCAGTAATCCCAGCAACTCAGGGTGTCTTTAATCCTAGCAACTGAGGGCACCTGTAATCCCAGCAACTCAGGAAGCTGAGACAGGAGAAGTACTTGAACCCAGAAGGCAGAGGTTGCAGTGAGCCGATATTGCACCATTGCACTCCAGTCTGGGCAACAAGAGTGAAACTCTGTCTCAAAAAAAAA"
"chr17","22129020","22129352","JH378128","1602813","1603145","53","20526207","GCCAGGCACGGTGGCTCACACCTGAATTCCAGTACTTTGGGAGGCCGAGGCGGGCGGATCTCTTGAGGTCAGGAGTTTGAGACCAGCCTGGCCAACATGGTGAAACCCCATCTCTACTAAAAATACAAAAATTAGCCGGGCGTGGTGGCAGGTGCCTGTAATCCCAGCTACTTGGGAGGCTGAGGCAGGAGAACCTCTTGAACCCAGGAGGTGGAGGCTGCAGTGAGCTGAGATTGTGCCACTTCACTCCAGCCTGGAAGACAAGAGCAAGACTTCATCTCAAAAAAAAATAAAAAAAAAATAAATAAATAAATAAATAAAAATTTAAAAAAA","GGCCAGGTGCAGTGGCTCACGCCTGTAATACCAGCATTTTGGGAGGCCGAGGCAGGTGGATCACGAGGTTAGGAGTTTGAGACCAGCATGGCCAACATGGAGAAACCCCGTCTCTACTAAAAATACAAAAATTAACCAGGCATGGTGGCAGGTGCCTGTAATTCCATCTACTCGGGAGGCTGAGGCAGGAGAATCCCTTGAACCTGGGAGGCGGAGGTTGCAGTGAGCCGAGATTGTGCCATTGCACTCAGTCTGGGTGACAAAAACAAGACTCCATCTCAAAAAAAAAAAAAAGAAAAGAAAAAGAAAAAAAGAAAGAAAGAAAGAAAGAAA"
"chr17","22130129","22130738","JH378118","18053084","18053501","262","4077045","GGCTGGGCACAGTGGCTCACGCCTGTAATCTCAGCACTTCGGGAAGCCGAGGCGGGCAGATCAGCTGAGGTCAGGAGTTCAAGACCAGCCTGGCCATGGCAAAACCCTGTCTCTACTAAAAAATGCAAAAAATAGGGGCCAGGCACGGTGGCTCACGCCTGTAATCCCAGCATTTTGGGAGGCCAAGGCAGGCGGATCACAAGGTCAGGAGGTTGAGACCATCCTGGCCAACATGGTGAAACCCCATCTCTACTAAAAATACAAAAATTAGCTGGGTGTGGTGGCCTGTGCCTGTAATCCCAGCTACTTGGGAGGCTGAGGCAGGGGAATCACTTGAATCCAGGAGACAGAGGTTGTAGTGAGCTGAAATGGAGCCACTGCACTCCAGCCTGGCGGCAGAGCGAGACTCTGTCTCAAAAAAAAAAAAAATACAAAAAATAGCTAGGTGTGATGGTGGGCACCTGTAATCCCAGCTACTTGGGTAGCCGAAGCAGGAGAATCGCTAGAACCTGGGAGGTGGAGGTTTAGTAAGCTGAGATCACACCATTGCACTCCAGCCTGGGTATCAACAGCGAAACTCCATCTCAAAAAAAAAAAAAAAAAAAGAAAA","GGCTGGGCGCAGTGGCTCACACCTGTAATCCCAGCACTTAGGGAAGCTGAGGCGAGTAGATCACCTGAGGTCAGGAGTTAGAGACCAGCCTGGCCATCATGGTGAAACCCCGTCTCTACTAAAGATACCAAAAATTAGCTGAGTGTGGTGCTGGGTGCCTGTAATCCCAGAAACTCAGGGTGCCTGTAATCCCAGCAACTCAGGGTGCCTTTAATCCCAGCAACTGAGGGTACCAGTAATCCCAGCAACTCAGGGTGTCTTTAATCCTAGCAACTGAGGGCACCTGTAATCCCAGCAACTCAGGAAGCTGAGACAGGAGAAGTACTTGAACCCAGAAGGCAGAGGTTGCAGTGAGCCGATATTGCACCATTGCACTCCAGTCTGGGCAACAAGAGTGAAACTCTGTCTCAAAAAAAAA"
"chr17","23633062","23633662","JH378118","18053084","18053501","247","5579978","GGCCAGGCGTGGTGGCTTACGCCTGTAATCCCAGCATTTTGGGAAGCTGAGGCAGGTGGATCACCTGAGGTCAAGAGTTCAAGACCAGCCTGGCCAACATGGTGAAACCCCGTCTCTACTGCAAATACAAAAAATTAGTAGCCGGGCATGGTGGCTCACGCCTGTAATCCCAACACTTTGGTAGGCCAAGGCGGGTGGATCACCTGAGGTCGGGAGTTCGAGACCAGCCTGACCAACATGGAGAAACCCCGTCTCTACTAAAAGTACAAAATTAGCCAGGGATGGTGGCATGTGCCTGTAATCCCAGCTATTTGGGAAGCTAAGGCACAAGAATCGCTTTGAACCTGGGAGACAGAGGTTGCAGTGAGCTGAGATCGCACCATTGCACTCCCGCCTGGGCAACAAGAGCGAAACTCCATCTAAAAAAAAAAAAAAAAAAAAAAAAGCCAGGCATGGTGACAGGCACCTTGTAATCCCAGCTACTCGGAAGGCTGAGGCAGGAGAATCGCTTGAACACTGCAGAGGTTGCAGTGAGCTGAGATCACGCCATTGCACTGCAGCCTAGGCAACAAGAGTGAGACTCTATCTCAAAAAAAAGAAA","GGCTGGGCGCAGTGGCTCACACCTGTAATCCCAGCACTTAGGGAAGCTGAGGCGAGTAGATCACCTGAGGTCAGGAGTTAGAGACCAGCCTGGCCATCATGGTGAAACCCCGTCTCTACTAAAGATACCAAAAATTAGCTGAGTGTGGTGCTGGGTGCCTGTAATCCCAGAAACTCAGGGTGCCTGTAATCCCAGCAACTCAGGGTGCCTTTAATCCCAGCAACTGAGGGTACCAGTAATCCCAGCAACTCAGGGTGTCTTTAATCCTAGCAACTGAGGGCACCTGTAATCCCAGCAACTCAGGAAGCTGAGACAGGAGAAGTACTTGAACCCAGAAGGCAGAGGTTGCAGTGAGCCGATATTGCACCATTGCACTCCAGTCTGGGCAACAAGAGTGAAACTCTGTCTCAAAAAAAAA"
"chr17","34071612","34072215","JH378118","18053084","18053501","250","16018528","GGCCAGGTGTGGTGCCTTACATCTGTAATTCCAGCACTTTGGGAGGCTGAGGTGGGTGGATCACCTGAGGTCAGGAGTTCAGGACCAACCTGGCCAACATAGTGAAACCCCGTCTCACTAAAAATACAAAAATTAAAAAGAAAGAAAGAAAAAAGCCAGGTGCGGTGGCTCACACCTGTAACCCCAGCACTTTGGGAGGCCAAGATGGGCGGATCACCTGAGGTCGGGAGTTTGAGACCAGCCTGACCAACATGGAGAAACCCCGTCTCTACTAAAAATACAAAATTAACCAGGCGTGGTGGTGCATGCCTGTAATCCCAGCTACTTGGGAGGATGAGGCAGGAGAATCGCTTGAACCCTGGAGGCGGAGGTTGTGGTGAGCTGAGATCATGCCATTGCACTCCAGCCTAGGCAACAAGAGCGAGACTCCATCTCAAAAAAAAAAAAAAAATTGGGCATGGTGGTGCATGCCTGTAATCCCAGCTACTCAGGAGTCTAAGGCAGGAGAATCACTTGAACCCAGGAGGCAGAGGTTGCAGTGAGCTGAGATCACGCCATTGCACTCCAGCCTGAGCGACAAGAGTGAAACTACGTCTCAAAAAAA","GGCTGGGCGCAGTGGCTCACACCTGTAATCCCAGCACTTAGGGAAGCTGAGGCGAGTAGATCACCTGAGGTCAGGAGTTAGAGACCAGCCTGGCCATCATGGTGAAACCCCGTCTCTACTAAAGATACCAAAAATTAGCTGAGTGTGGTGCTGGGTGCCTGTAATCCCAGAAACTCAGGGTGCCTGTAATCCCAGCAACTCAGGGTGCCTTTAATCCCAGCAACTGAGGGTACCAGTAATCCCAGCAACTCAGGGTGTCTTTAATCCTAGCAACTGAGGGCACCTGTAATCCCAGCAACTCAGGAAGCTGAGACAGGAGAAGTACTTGAACCCAGAAGGCAGAGGTTGCAGTGAGCCGATATTGCACCATTGCACTCCAGTCTGGGCAACAAGAGTGAAACTCTGTCTCAAAAAAAAA"
"chr17","34329459","34330029","JH378119","32351107","32351490","237","1978352","GGCCAGGTGCCGTGGCTCACACATGTAGTCCCAGCACGTTGGGAGGCTGAGGTTAATGGATCACCTGAAGTCACAAGTTCGAGACCAGCCTGACCAACATGGTGAAACCCTGTCTCTACTAAAATATAAAAAGTAGTCGGCCGGGCGCAGTTGCTCATGCCTGTGATCGCCTGAGGTCAGGATTTCAAGCCCAGCCTGGCCAAAATGGTGAAACCCCATCTCTACTAAAAATATAAAAATTAGCCAGGCATGGTGGCAGGTGCCTGTAATCCCAGCTACTCAGGAGGTTGAGGCAGGAGAATCACTTGGACCCAGGGGGCAGAGGTTGCAGTGAGCCAAGATCACAGCATCGCACTCCAGCTTAGGCAACAAGAGAGAAACTCCATCTCAAAAAAAACCCAAAAAAAACAAAAAAACAAAAAAACCCAGGCATGGTGGCAGGCGTCTGTAATCTCAGCTACTCGGGAGGCTGAGGCAAGAGAATCGCTTGAACCTGGGAGGCAGAGGTTGCAGTGAGCCAAGATCATGCCATTGCACTCCAGACTGAGCAATAAGAGCGAAACTCCATCTC","GGCCAGGTATGGTGGCTCACACCTGTAATCCCAGCACTTTGGGAGGCCAAGGCAGGCAGACCACCTGAGGTCAGGAGTTCGAGATCAGCCTAGCCAACATGGTGAAACCCCATCTCTAGTAAAAATAAAATTAGCCAGGCATGGTGGTGCATGCCTGTAACGCAGGTCAGGAGTTCGAGATCAGCTTAGCCAACATGGTGAAACCCCATCTCTAGTAAAAATAAAATTAGCCAGGCAGGTGGTGCCGCCTGTACTCGGGAGGCTGAGGCAGGAGAATCACTTGAACCCAAGAGGCAGAGGTTGCAGTCAGCCAAGATCATGCCATTGCACTCCAGCCTAAGCAAAAAGAGTAAAACTCAGTCTCAAAACAAAAAAACAAAAAAA"
"chr17","35196292","35196625","JH378228","5665092","5665424","47","29531200","GGCTGGGCATGGTGTCTTACGCCTGGAATCCCAGCACTTTGGGAGGCCAAGGCGGGTGGATCACCTGAGGTCAGGAGTTTGAGACCAGCCTGGCCAACATGTTGAAACTCTGTCTCTACTAAAAATACAAAAATTAGCCGGGCATGGTGGCGGATGCCTGTAATCCCAACTACGTGGGAGGCTGAGGCAGGAGAATCGCTTGAACCCAGGAGATGGAGGTTGTGGTGAGCCGAGATCATGCCATTGCACTCCAGCCTGGGCAACAAGAACAAAACTCTGTCTCAAAATAAATAAAAAAATAAATAAATAAATAAAAACAACAACAACAACAAAA","GGCCGGGCGCGGTGGCTCAAGCCTGTAATCCCAGCACTTTGGGAGGCTGAGGCGGGTGGATCACGAGGTCAAGAGATCGAGACCATCCTGGTCAACATGGTGAAACCCTGTCTCTACTAAAAATACTAAAAATTAGCTGGGCATGGTGGCGTGTGCCTGTAATCCCAGCTACTCAGGAGGCTGAGGCAGGAGAATTGCCTGAACCCAGGAGGCGGAGGTTGCGGTGAGCCGAGATCGCGCCATTGCACTCCAGCCTGGGCAACAAGAGCGAAACTCTGTCTCAAAAAAAAAAAATAAATAAATAAAATAAAATAAAATAAAATAAAATAAAAT"
"chr17","40291413","40291755","JH378144","13229286","13229620","52","27062127","GGCCAGGCACAGTGGCTCATGCCTGTAATCCCAGCACTTTGCGAGGCTGAGCCAGGTGGATCACCTGAGGTCAGGAGTTCAAGAGCAGCCTGGCCAACATGGTGAAACCCCGTCTCTACTAAAAATACAAAAATTATCTGGAGTGGTGGTAGGTGCCTATAATTGCAGATACACAGAAGGCTGAGACAGGAGAATTGCTTGAACCCAGGAGGCGGAGGTTGCTGTGAGCCGAGATCGCGCCATTGCACCCCAGCCTGGGAGACAAGAGCGAAACTCCATCTCAATAAATAAATACATACATACATACATACATACATGCATACATACATAAAATAAAATAAAA","GGCCGGGCGCGGTGGCTCAAGCCTGTAATCCCAGCACTTTGGGAGGCCGAGGCGGGTGGATCACCTGTGGTCAGGAGTTCAAGACAGCTTGGTCAACATGGTGAAACCCCGTCTCTACCAAAAATACAAAAAATTAGCTGGGCATGGTAGCGCATGCCTGTAATCCCAGCTACTCAGGAGGCTGAGGCAGGAGAATTGCCTGAACCCAGGAGGCAGAGGTTGCGGTGAGCCGAGATCGCGCCATTGCACTCCAGCCTGGGTAACAAGAGCGAAACTCCCTCTCATAAAAAATAAATAAATAAATAAATAAATAAATAAATAAATAAATAAATAAA"
"chr17","45148344","45148987","JH378206","6546474","6546861","299","38601870","GGCTTGGTGCCATGGTTCATGCCTGTAATCCTGGCACTTTGGGAGGCCGAGGTGGGCAGATCACTTGAGCTCAGGAGTTCAAGACCACCTTGGGCGACATGGTGAAACCTCATCTCTCCTTAAAAAAAAAAAAAACAGCCGGGCGCGGTGGCTCACACCTGTAATCCCAGCACTTTGGGAGGCCAAGGCGGGTGGGGTTCATGAGGTCAGAAGATCGAGACCATCCTGGCTAACACGGTGAAACCCCGTCTCACTAAAAATAGAAAAAACTAGCCGGGCGTGGTGGCGGGCACCTGTAGTCCCAGCTACTCGGGAGGCTGAGGCAGGAGAATGGCGTGAACCCGGGAGGCGGAGCTTGCAGTGAGCTGAGATCTTGCCATTGCACTCCAGCCTGGGCAACAAGAGTGAAACTCTGTCTCAAAAAAAAAAAATTAAAAAAACAAATAAAAATAAAAATACATAATTAGCAGGACATGGTGGCACATGCCTGTAATCCCCAGCTACTCGGGAGGCTGAGGCATGGGAATTGTTTAAACCTGTGAGGCGGTGGTTGCAGTGAGCCAAGATCAAGCCATTGCACTCCAGCCTGGGCAACAAGAGTGAAACTCCATCTCAAAAAAAAAAAAAAAAAAGAGAAAAGAAAA","GGCCACACATGGTGGCTAACGCCTGTAATCCCAGCACTTTGGGAGGCCAAGTCGGGTGGATCATGAGGTCAGGAGACCAAGACCATCCTGGCCAAATGGTGAAACCCCGTCTCTACTAAAAATACAAAAATTAGCTGGGCATGGTGGCGTGTGCCTGTAATCCCAGCTACTCAGGAGGCTGAGGCAGGACAATTGCCTGAACCCAGGAGAATTAGCTGGGCATGGTGGCGTGTGCCTGTAATCCCAGCTACTCAGGAGGCTGAGGCAGGACAATTGCCTGAACCCAGGAGGCGAAGGTTGCGGTGAGCCGAGATTGTGCCATTGCACTCCAGCCTGGGTAACAAGAGCGACACTCTGTCTCAAAAAAAAAAAAAAAAAAAAAAAAAAA"
"chr17","47866693","47867898","JH378118","18053084","18053501","809","29813609","GGCTGGGCTTGGTGGCTCATGCCTATAATTCTAGGACTTTGGGAGGCCAAGGCGGATGGATCACCTGAGGTCAAGAGTTGGAGACCAACCTGTCCAACATGGTGAAACCCCCTCTGTACTAAAAATACAAAAATTGGCCGAGCGTAGTGGCTCATGCCTGTGATCACAGCACTTTGAGAGGCTGAGGCGGGCGGATCACAAGGTCAGGAGATCAAAACCATCCTGGCTAACAAGGTGAAACCCCATCTCTGCTAAAAAATAACAGGGCGTGGTGGCACACGGCTGTAGTCCCAGCTACTTGGGAAGCTGAGGCAGGAGAATCGCTTGAACCTGAGAGGCAGAGGTTGCAGTGAGCTGAGATCAGGCCACTGCTCTCCAGCCTGGGCAACAGAGTGAAACTCCATCTCAAAAAAAAAAAGAAAAAGGCCAGGCATGGTGGCTCACGCCTGTAATGCCAGCACTTTGGAAGACTAAGTTGGGCAGATCACAACATCAGAAGATGGAGACCATCCTGGCTAACACGGTGAAACCCCGTCTCTACTAAAAATACAAAAAAAAAAAAAAAAAAAATTAGCCGGGCGTGGTGACATGCGCCTGTAATCCTAGCTACTCCGGAGGCTGAGGCAGGAGAATGGCGTGAACCCGGGAGGCGGAGCTTGCAGTGAGCCGAGATGGTGCCACTGCACTCCAACCTGGGCGACAGAGCGAGACTCTGTCTCAAAAAAAAAAAAAAAAAAGAAAAAAGGTCGGGCGCAGTGGCTCACACCAGTAATCACAGCACTTTGGGAGGCCGAGGCGGGTGGATCACCTGAGCTCGGGAGTTCAAGACCAGCCTGACCAACATGGTGAAACTCCGTCTCTACTAAAAATACAAAATATTAGCCGGGCGTGGTGGCGCGTGCCTGTAATCCCAGTTACACGGGAGGCTGAGGCAGGAGAATCACTTGAACTTGGGAAGTGGAGGTTGTGGGAGCCGAAATCGTGCCATCGCATTCCACAAGAGTGAAACTCCATTTCAAAAAAAAAAAATACAAAAATTAGCTGGGCGTGGTGGCGGGCGCCTTTAATCCCAGGGGCTCGGGAGGCTGAGGCAGGAGAATCGCTTGAACCTAGGAGGCAGAGGTTGCAGTGTGCCAAGATGACACCATTGCACTCCAGGCTGGGCAAGAGAGCAGTAACTCCCGTCTCAAAAAAAAAGAAGGAAAA","GGCTGGGCGCAGTGGCTCACACCTGTAATCCCAGCACTTAGGGAAGCTGAGGCGAGTAGATCACCTGAGGTCAGGAGTTAGAGACCAGCCTGGCCATCATGGTGAAACCCCGTCTCTACTAAAGATACCAAAAATTAGCTGAGTGTGGTGCTGGGTGCCTGTAATCCCAGAAACTCAGGGTGCCTGTAATCCCAGCAACTCAGGGTGCCTTTAATCCCAGCAACTGAGGGTACCAGTAATCCCAGCAACTCAGGGTGTCTTTAATCCTAGCAACTGAGGGCACCTGTAATCCCAGCAACTCAGGAAGCTGAGACAGGAGAAGTACTTGAACCCAGAAGGCAGAGGTTGCAGTGAGCCGATATTGCACCATTGCACTCCAGTCTGGGCAACAAGAGTGAAACTCTGTCTCAAAAAAAAA"
"chr17","48059944","48060302","JH378108","45564157","45564495","64","2495787","GGCCGGGCGCAGTGGTTCATGCCTGTAATCCCAACACTTTAGGGGGCTGAGGCAGGTGGATCACCTGAGGTCAGGAGTTCAAGACCAGCCTGGCCAACATGGTGAAAGCCCATCTCTACTAAAAATACAAAAAATTAGCTGGGCATGGTGGTGCGTGCCTGTAATCCCAGCTACTTGGGATGCTGAGGCAGGAGAATCGCTTGAACCCGGGAGGTGGAGGCTGCAGTGAGCTGAGATTGTGCCATTGCACTCCAGCCTGGGCAACAAGAGTGAAACTCCATCTAAAAAAAAAAAAGAAGAGGAGGAGGAGGAGGAGGGGGAGGGGGAGGAGGAGGAGGAGGAGAAGAAGAAAAAAGAAA","GCTAGGCAAGGTGGCTCATGCCTGTAATCCCAACATTTTGGGAGGCCGAGGCAGATGGATCACCTGAGGTTAGGAGTTCAAGACCAGCCTGGCCAACATGGTGAAACTCCATCTCTACTAAAAATACAAAAAATTAGCTTGGCACGGTGGTGGGTGCCTCTAATCCCAGCTGCTTGGGAGGCTGAGGCAGGAGAATCGCTTGAACTCAGGAGGTGGAGGTTGCAGTGAGCCAAGATCATGGCATTGCACTCCAGCCTGGGCGACAAGAGCGAGACTCCCTCTAAGAAAGAAAAGAAAGAAAAGAAAAGAAAAAAGGAAAGGAAAGGAAAGAAAGAGAAA"
"chr17","50365982","50366602","JH378118","18053084","18053501","274","32312898","GGCAAGGCGTGGTGGCTGATGTCTGTAATCCCAGCAATTTGGGGGGCTGAGGTGGATGGATCACCTGAGATCAGAAGTTCGAGACTAGGCTAGCCAACATAGTGAAACCCCATCTCTACTAAAAATATAAAAAGTTAGCCAGGCGCGGTGGTTCATGCCTGTAATCCCAGCACTTTGGGAGGCCGAGGTAGGTGGATCACAAGGTCAGGAGTTCAAGACCAACCTGGCCAAGATAGTGAAACCTCATCTCTACTAAAAATACAAAAATTAGCTGGGCGTGGTGGCAACCACCTATGATCCCAGCTACTTGGGAGGCTGAGGCAGAGAACTGCTTGAACCCAGGAAGTGGAGGTTGTAGTGAGCCAAGATTGCATCACTGTACTCCAGCCTGGGCAACAGAGCAAGACTCCATCTCAAAAAAAAAAAAAAAAAAAATACAAAAAATTAGCCAGGCGTGGTGGCAGGCACCTGTAATCCCAGCTACTCGGAAGGCTGAGGCAGGAGAATTGCTTGAACCTGGGAGGTAGAGGTTGCAGTGAGCTGAGATTGTGCCATTGCACTCTAGCCTATGTGACAAGAGCGAAACTCCATCTCAAAAAAAAAAAAAAAAAAGAAAGAAAA","GGCTGGGCGCAGTGGCTCACACCTGTAATCCCAGCACTTAGGGAAGCTGAGGCGAGTAGATCACCTGAGGTCAGGAGTTAGAGACCAGCCTGGCCATCATGGTGAAACCCCGTCTCTACTAAAGATACCAAAAATTAGCTGAGTGTGGTGCTGGGTGCCTGTAATCCCAGAAACTCAGGGTGCCTGTAATCCCAGCAACTCAGGGTGCCTTTAATCCCAGCAACTGAGGGTACCAGTAATCCCAGCAACTCAGGGTGTCTTTAATCCTAGCAACTGAGGGCACCTGTAATCCCAGCAACTCAGGAAGCTGAGACAGGAGAAGTACTTGAACCCAGAAGGCAGAGGTTGCAGTGAGCCGATATTGCACCATTGCACTCCAGTCTGGGCAACAAGAGTGAAACTCTGTCTCAAAAAAAAA"
"chr17","50542261","50542886","JH378206","6546474","6546861","277","43995787","GCCGGGCGCTGTGGCTCAAGCCTGTAATCCCAGCATTTTGGGAGACTAAGGGAAGCAGATCCTGTGAGCTCAGGATTTCGAGACCAGCCTGGCCAACATGGTGAAACCCTGTCTCTACAAAAATTAGCCATGCCGGGCACGGTGGCTCACGCCTGTAATCCCAGCACTTTGGGAGGCTGAGGCGGGCGGATCACAAGGTCAGGAGTTTGAGACCATCCTGCCTAACACGGTGCAACCCCGTCTCTACCAAAAATACAAAAAATTAGCTGGGCGTGGTGGCGGGTGCCTGTAGTCCCAGCTACTCGGGGGGCTGAGGCAAGAGAATGGCATGAACCTGTGGGGCGGAGCTTGCTGTGAGCCGATATCCTGCCACTGCACTCCAGCCTGGGCGACAGAGCGAGACTCCATCTCAAAAAAAAAAAAAAAAAAAAAAAAAAAAAAAAATGAGCCAGCTGTGGTGGCGTGTGTGCCTGTAATCCCAGCTACTCGGGAGGCTGAGGCAAGAGAATCACTTGAATCTGGGAGGCAGAGGTTGCAGTGAGCCAAGATCATGCTATTGCACTTCAGCCTGGGCAACAAGAGTGAAACTCTGTCTCAAAAAAAAAAAAAAAAAAAAAGAAAAAGAA","GGCCACACATGGTGGCTAACGCCTGTAATCCCAGCACTTTGGGAGGCCAAGTCGGGTGGATCATGAGGTCAGGAGACCAAGACCATCCTGGCCAAATGGTGAAACCCCGTCTCTACTAAAAATACAAAAATTAGCTGGGCATGGTGGCGTGTGCCTGTAATCCCAGCTACTCAGGAGGCTGAGGCAGGACAATTGCCTGAACCCAGGAGAATTAGCTGGGCATGGTGGCGTGTGCCTGTAATCCCAGCTACTCAGGAGGCTGAGGCAGGACAATTGCCTGAACCCAGGAGGCGAAGGTTGCGGTGAGCCGAGATTGTGCCATTGCACTCCAGCCTGGGTAACAAGAGCGACACTCTGTCTCAAAAAAAAAAAAAAAAAAAAAAAAAAA"
"chr17","51121894","51122508","JH378118","18053084","18053501","260","33068810","GGCTGGGTGCAGTGGCTCATGCCTGTATTCCCAACACTTTGAGAGGCCAAGGCGGGCAGATCACCTGAGGTCAGGAATTCGAGACCAGCCTGGCTAACATGGCGAAACCCTGTCTCTATTAAAAACACAAAAATTAGGCCAGGCACGGTGGCTCACACCTGTAATCCCAGCACTTTGGGAGGCTGAGGCGGGCAGATCACGAAGTCAGGAGATCGAGACCATCCTGGCTAACATGGTGAAACCCTGTCTCTGCTAAAAATACAAAAAAAATAGCGGGGCGTGGTGGCAGGCGCCTGTAGTCCCAGCTACTCAGGAGGCTGAGGCAGGAGAATGGCGTGAACCTGGGAGGCGGAGGTTGCAGTGAGCCGAGATCGCGCCACTGCACTACAGCTTGGGTGACAGAGCGAGACTCTGTCTCAAAAAAAAAAAAAAAAGTTAGTCGGGCATGGTGGTGGGCTCCTGTATTCCCAGCTACTCAGGAGGCTGAGGTGGGAGAATCACTTGAACCTGGAAGGCAGAGGTTGCTGTGAGCCAAGATTGCACCATTGCATTCCAGCCTGGGTGACAAGAGCAAAACTCTGTCTCAAAAAATATATATAAAATAATAAAAATAAA","GGCTGGGCGCAGTGGCTCACACCTGTAATCCCAGCACTTAGGGAAGCTGAGGCGAGTAGATCACCTGAGGTCAGGAGTTAGAGACCAGCCTGGCCATCATGGTGAAACCCCGTCTCTACTAAAGATACCAAAAATTAGCTGAGTGTGGTGCTGGGTGCCTGTAATCCCAGAAACTCAGGGTGCCTGTAATCCCAGCAACTCAGGGTGCCTTTAATCCCAGCAACTGAGGGTACCAGTAATCCCAGCAACTCAGGGTGTCTTTAATCCTAGCAACTGAGGGCACCTGTAATCCCAGCAACTCAGGAAGCTGAGACAGGAGAAGTACTTGAACCCAGAAGGCAGAGGTTGCAGTGAGCCGATATTGCACCATTGCACTCCAGTCTGGGCAACAAGAGTGAAACTCTGTCTCAAAAAAAAA"
"chr17","51573403","51574012","JH378118","18053084","18053501","260","33520319","GGCCGGGTGTGGTGGCTCACGCCTATTATCCCAGCAGTTTGGGAGGCCAAGTGGGGGTTGGATCACCTGAGGTCAGGGGTTCGAGACCAGCATGGCCAACATGGTGAAAACCCATCTATACTAAAGATACAAAAAATTAGGCTGGGCACAGTGGCTCATGCCTGTAATCCCAGCACTTTGGGAGGCCAAGGATCACGAGGTCAGGAGATCGAGACCATCCTGGCTAACACAGTGAAACCCCGTCTCTACTAAAAATACAAAAAAATTAGCCGGGAGTGGTGGCAAGTGCCTGTAGTCCCAGCTACTCAGGAGGCTGAGGCAGGTGAATAGTGTGAACGCAGGAGGCAGAGCTTGCAGTGAGCCGAGATCGTGCCACTACACTCCAGCCTGGGCGACAAGGTGAGACAACGTCTCAAAAAAAAAAAAAAAAAAAAGCCGGGCATGGTGGGAGGCACCTGTAATTCCACCTACTTGGGAGGGTGAGGCAGGAGAATTGCTTGAATCTGGGAGATGGAGGTTGGAGTAAGCCAAGTTCGCACCATTGCACTCCAGCCTGGGTGACAAGAGCGAAACTCTTGTCTCAAAAAAAAAAAAAAAAAAAAAAAAAAAA","GGCTGGGCGCAGTGGCTCACACCTGTAATCCCAGCACTTAGGGAAGCTGAGGCGAGTAGATCACCTGAGGTCAGGAGTTAGAGACCAGCCTGGCCATCATGGTGAAACCCCGTCTCTACTAAAGATACCAAAAATTAGCTGAGTGTGGTGCTGGGTGCCTGTAATCCCAGAAACTCAGGGTGCCTGTAATCCCAGCAACTCAGGGTGCCTTTAATCCCAGCAACTGAGGGTACCAGTAATCCCAGCAACTCAGGGTGTCTTTAATCCTAGCAACTGAGGGCACCTGTAATCCCAGCAACTCAGGAAGCTGAGACAGGAGAAGTACTTGAACCCAGAAGGCAGAGGTTGCAGTGAGCCGATATTGCACCATTGCACTCCAGTCTGGGCAACAAGAGTGAAACTCTGTCTCAAAAAAAAA"
"chr17","51598763","51599361","JH378118","18053084","18053501","241","33545679","GCCGGGCGTGGTGACTCACGCCTGTAATACCAGCACTTTAGGAGGCTGAGGTGGGTGGATCACCTGAGGTCAGGAGTTCGAGACCGGCCTGGCCAACATGGTGAAATCCTGTCTCTACTAAAAATACAAAAAAATGGCCAGGCGTGGTGGCTCACGCCTGTAATCCTAGCACTTTGGGCGGCCCAGGTGAGTGGATCACGAGGTCAGGAGATCGAGACCATCCTGGCTAACATGGTGAAACCCCATCTCTACTAAAAAACTACAAAAAAATTAGCTGGGCGTGGTGGCAGGCGCCTGTAGTCCCAGCTACTCGGGAGGCTGAGGCAGGAGAATGACGTGAACCCGGGAGGCGGAGCTTGCAGTGAGCAGAGCTTGAGCCACTGCACTCCAGCTTGGGCGACAGAGTGAGACTCCGTCTCAAAAAAAAAAAAAAAAAAATTAGCTGGGGATGGTGGCGGGCACCTGTAATCCCAGCTACTCTGGAGGCTGAGACAGGAGAATCGCTTGAACCCAGGAGGCGGAGGTTGCAGTGAGCTGAGATCGTGCCATTGTACTCCAGCCTGGGCAACAAGAGTGAAACTCAATCCGAAGAAAAAAAA","GGCTGGGCGCAGTGGCTCACACCTGTAATCCCAGCACTTAGGGAAGCTGAGGCGAGTAGATCACCTGAGGTCAGGAGTTAGAGACCAGCCTGGCCATCATGGTGAAACCCCGTCTCTACTAAAGATACCAAAAATTAGCTGAGTGTGGTGCTGGGTGCCTGTAATCCCAGAAACTCAGGGTGCCTGTAATCCCAGCAACTCAGGGTGCCTTTAATCCCAGCAACTGAGGGTACCAGTAATCCCAGCAACTCAGGGTGTCTTTAATCCTAGCAACTGAGGGCACCTGTAATCCCAGCAACTCAGGAAGCTGAGACAGGAGAAGTACTTGAACCCAGAAGGCAGAGGTTGCAGTGAGCCGATATTGCACCATTGCACTCCAGTCTGGGCAACAAGAGTGAAACTCTGTCTCAAAAAAAAA"
"chr17","51738482","51739094","JH378118","18053084","18053501","257","33685398","GCCGGGTGCGGTGGCTCACACCTGTAATCCCAGCACTTTGGGAGACTGAGGCGGGAGGATCACCTGAGGTCAGGAGTTCGAGACCAACCTGACCAACATGGTAAAACCCTGTCTGTACTAAAACTACAAAAAATTAGGCCAGGCGCAGTGGTCCATGCCTGTAATCCCAGCACTTTGGGAGGCCAAGGTGGGCGGATCATGAGGTCAGGAGTTTGAGACCAGCCTGGCCAACATAGTGAAACCCTGTCTCTACTAAAAACACAAAAATTAGTCGGGCATGGTGGCGGATGCCTGTAATCTCAGCTACTCAGGAGGTTGAGGCAGGAGAATCACTTGAACCCGGGAGGTGGAGGTTGCAGTGAGCCAAGATCACGCCACTGTACTCCAGCCTGGGCAACAGAGCGGGACTCCATCTTAAAAAAAAAAAAAAAAAAATTAGCCAGGCGTGGTGGCGCATGCCTGTAGTCCCAGCTACTTAGGAGGCTGAGGCAGGAGAATTGCTTGAACCCGGGAGGCAGAGGCTGCAGTGAGCCAAGACCACGCTATTGCATTCCAGCCTGGGTGACAAGAGCAAAACTCTGTCTCAAAAAACAAAACAAAACAAACAAAAAAA","GGCTGGGCGCAGTGGCTCACACCTGTAATCCCAGCACTTAGGGAAGCTGAGGCGAGTAGATCACCTGAGGTCAGGAGTTAGAGACCAGCCTGGCCATCATGGTGAAACCCCGTCTCTACTAAAGATACCAAAAATTAGCTGAGTGTGGTGCTGGGTGCCTGTAATCCCAGAAACTCAGGGTGCCTGTAATCCCAGCAACTCAGGGTGCCTTTAATCCCAGCAACTGAGGGTACCAGTAATCCCAGCAACTCAGGGTGTCTTTAATCCTAGCAACTGAGGGCACCTGTAATCCCAGCAACTCAGGAAGCTGAGACAGGAGAAGTACTTGAACCCAGAAGGCAGAGGTTGCAGTGAGCCGATATTGCACCATTGCACTCCAGTCTGGGCAACAAGAGTGAAACTCTGTCTCAAAAAAAAA"
"chr17","52245950","52246538","JH378118","18053084","18053501","254","34192866","TGTAATCCCAGCACTTTGGGAAGCCAACGCGGGTAGATCAGCTGAGGTCAGGAGCTCGAGACCAGCCTGGCCAACTGGTGAAACCCCATCTCTACTAAAAAAAATACAAAAAAATGGCCCAGCGCGGTGGCTCACACCTGTAATCCCAGCACTTTGGGAGGCCGAGGCGGGCAGATCACGAGGTCAGGAGATCGAGACCATCCTGGATAATACGGTGAAACCCCGTCTCTACTAAAAATACAAAAAAAAATTAACCGGGTGTGGTGGCGGGCGCCTGTAGTCCCAGCTACTAGGGAGGCTGAAGCAGGAGAATGGCGCGAAACCGGGAGGCGGAGCTTGCAGTGAGCCAAGACAGGCCACTGCACTCCAGCCTGGGCGACAGAGCGAGACTCCATCTCAAAAAAACAAAAAACAAAAAAATTAGCCAGCTGTGGTGGTGGGCGCATGTAATCCCAGTTACTTGGGAGGCTGAGGCAGGAGAATTGCTTGAAACCAGGAGGCAGAGGTTGCAGTGAGCCAAGATTACGCCATTGTACTCCAGCCTGGGCAACAAGGGCAAAACTCTGTCTCAACAAAAAAAAAGAAAAAA","GGCTGGGCGCAGTGGCTCACACCTGTAATCCCAGCACTTAGGGAAGCTGAGGCGAGTAGATCACCTGAGGTCAGGAGTTAGAGACCAGCCTGGCCATCATGGTGAAACCCCGTCTCTACTAAAGATACCAAAAATTAGCTGAGTGTGGTGCTGGGTGCCTGTAATCCCAGAAACTCAGGGTGCCTGTAATCCCAGCAACTCAGGGTGCCTTTAATCCCAGCAACTGAGGGTACCAGTAATCCCAGCAACTCAGGGTGTCTTTAATCCTAGCAACTGAGGGCACCTGTAATCCCAGCAACTCAGGAAGCTGAGACAGGAGAAGTACTTGAACCCAGAAGGCAGAGGTTGCAGTGAGCCGATATTGCACCATTGCACTCCAGTCTGGGCAACAAGAGTGAAACTCTGTCTCAAAAAAAAA"
"chr17","52264620","52265210","JH378118","18053084","18053501","242","34211536","GGCCACATGTGGTGGCTCACACCTGTAATCCCAGCACTTTGGGAGGCCAAGGCAGGCAGATCACCTGAGATCAGAAGTTCAAGACCAGCCTGGCCAATGTGGTGAAACCCTGTCTCTACTAAAAATAGAAAAAACACAGCCAGGCGCGGTAGCTCACACCTGCAATCCCAGCACTTTGGGAGGCCGAGGCAGGCAGATCACGAGGTCAGGAGATTGAGACCACGGTGAAACCCCATCTCTACTAAAAATACAAAAAATTAGCTGGGCATGGTGGCGGGCACCTGTAGTCCCAGCCACTTGGGAGGCTGAGGCAGGAGAATGGCGTGAACTCGGGAGGTGGAGCTTGCAGTGAGCAAAATTGCGCCACTGCACTCCAGCCTGGGCAACAGAGCAAGACTCCGTCTCAAAAAAAAAAAAAAAAAAAAATTAGCCGGCGTAGTGGCAAGCTCCTGTAATCCCAGCTACTTGGGAGGCTGAAGCAGGAGAATCGCTTGAACCCAGGAGGTGGAGGTTGCAGTGAGCCGAGACTGCGCCATTGCACTCCAGCCTGGGCAACAAGAATGAAACTCCGTCTCAGAAAAGAAAAAAAAA","GGCTGGGCGCAGTGGCTCACACCTGTAATCCCAGCACTTAGGGAAGCTGAGGCGAGTAGATCACCTGAGGTCAGGAGTTAGAGACCAGCCTGGCCATCATGGTGAAACCCCGTCTCTACTAAAGATACCAAAAATTAGCTGAGTGTGGTGCTGGGTGCCTGTAATCCCAGAAACTCAGGGTGCCTGTAATCCCAGCAACTCAGGGTGCCTTTAATCCCAGCAACTGAGGGTACCAGTAATCCCAGCAACTCAGGGTGTCTTTAATCCTAGCAACTGAGGGCACCTGTAATCCCAGCAACTCAGGAAGCTGAGACAGGAGAAGTACTTGAACCCAGAAGGCAGAGGTTGCAGTGAGCCGATATTGCACCATTGCACTCCAGTCTGGGCAACAAGAGTGAAACTCTGTCTCAAAAAAAAA"
"chr17","52281488","52282107","JH378118","18053084","18053501","287","34228404","GGCCAGGCGCGGTGGCTCACGCCTGTAATCCCAGCACTTTGGGAGGTCAAGGCGGGTGGATCACCTGAGGTCAGGAGTTCAAGACCAGCCTGGCCAACATGATGAAACTTCATCTTGGCCGGGCGCGGTGGCTCATGCTTGTAATCCCAGCACTTTGGGAGGCCAAGGCAGGCGGCGGATCATGAGGTCAGGAGATTGAGACCATCCTGGCTAAAACGGTGAAACCCCGTCTCTACTAAAAATACAAAAAAAAAAAAATTAGCCGGGCGTGGTGGCAGGCGCCTGTAGTCCCAGCTACTCGGGAGGCTGAGGCAGGAGAATGGCGTGAACCCGGGAGGCGGAGCTTGCAGTGAGCCGAGATAGCACCACTGCAGTCCGGCCTGGGTGAAAGAGTGAGACTCCGTCTCAAAAAAAAAAAAAAAGAAGAAAGAACTTCGTCTTTACTAAAAGTACAAAAAAAAAAAAAAAAAATTAGCCGGGCATGGTGGCAGGCGCCTGTAAACCCAACTACTCTGGAGGCTGAGGAAGGAGAACTGCTTGCACCTGGGAGTCGGAGGTTGCAGTAAGCCAAGATCGCACCATTGCACTCCAGCCTGGGCATCAAGAGTGAGACTTTGTCT","GGCTGGGCGCAGTGGCTCACACCTGTAATCCCAGCACTTAGGGAAGCTGAGGCGAGTAGATCACCTGAGGTCAGGAGTTAGAGACCAGCCTGGCCATCATGGTGAAACCCCGTCTCTACTAAAGATACCAAAAATTAGCTGAGTGTGGTGCTGGGTGCCTGTAATCCCAGAAACTCAGGGTGCCTGTAATCCCAGCAACTCAGGGTGCCTTTAATCCCAGCAACTGAGGGTACCAGTAATCCCAGCAACTCAGGGTGTCTTTAATCCTAGCAACTGAGGGCACCTGTAATCCCAGCAACTCAGGAAGCTGAGACAGGAGAAGTACTTGAACCCAGAAGGCAGAGGTTGCAGTGAGCCGATATTGCACCATTGCACTCCAGTCTGGGCAACAAGAGTGAAACTCTGTCTCAAAAAAAAA"
"chr17","52731467","52732093","JH378129","11955248","11955630","276","40776219","GGCCGGGTGCGGTGGCTCACGCCTGTAATCCTGGCACTTTGGGAGGCTGAGATGGACGGATCACCTGAGGTCAGGAGTTTTTTGTTTTTTTCTTTTTTTTTGAGACAGAGTCTGGCTCTGTTGCCCAGGCTGGAGTGCAGTGGCTCGATCTCGGCTCACTGCAAGCTCCGCCTCCCGGGTTCATGCCATTCTCCTGCCTCAGCCTCCCGGTAGCTGGGACTACAGGTGCCCGCCAGCACATCCGGTTATTTTTTTGTATTTTTAGTAGAGACAGTGTTTCACAGTGTTAGCCAGGATGGTCTCGATCTCCTGACCTCGTGATCCGCCCACCTCGGCCTCCCAAAAGTGCTGGGATTACAGGCATGAGCCACCGCGCCCGGCCAGGAGTTTTTGAGACCAGCCTGGCCAACAGGGTGAAACTCTGTCTCTACTAAAAATACAAAAATTAGTTGGGCATGGTGGCAGGCACCTGTAATCCCAGCTACATGGGAGGCTGAGGCAGGAGAATTGCTTGAACCTGGGAGGCGGAGGTTGCAGTGAGCTGAGATTGCGCCATTGCACTCCAGCCTGGGCAACAAGAGTGAAATTGCGTCTCAAAAACCAAAACAAACAAAAAAAGAATGAAAA","GGCTGGGTACGGTGGCTCATGCCTGTAATCCCAGCACTTTGGGAGGTGGGTCACTTGAGGTCAGGAGTTCGAGACCAGCCTGTGCAGTGCCTCCATCCTCAACTGCTGCCTCATCAGCCTGGACCACTACCTGCTCATCCTCTCACCACTGCCACAAGCTGCGCATGAAGCTCCTGCGCGCGCCGGTGCCCGTCTCTACTAAAAATACAAAAATTAGCTGGGTGTGGTGGCAGGTGCCTGTAATCCCAGCTACTCAGGAGGCTGAGGCAGGAGAATCACTTGAACCCAGGAGGCAGAGGTTGCAGTGAGCCGATATCGCATCATTGCACTCCAGCCTGAGCAACAAGAGTGAAATTTTGTCTCAAAAAAAAAAAAAAAAGAAA"
"chr17","54416242","54416805","JH378115","26183910","26184297","228","28232332","ACTTTGGGAGGCCATGGCAGGCGGATCACCTGAGATCAGGAGTTGGAAACCAGCCTGGCCAACATGGTAAAACCCCGTCTCTACTAAAAATACTTGGCTGGGCACGGTGGCTCACACTTGTAATTCCAACACTTTGGAAGGCCAAGGCGGGCAGATCACCTGAGGTTGGGAGTTCGAGACCAGCCTGACCAACATGGAGAAACCCTGTCTCTACTAAAAATACAAAATTAGCTGGGCATGGTGGTCTATGCCTGTAATCCCAGCTACTTGGGAGGCTGAGGCAGGAGAATTGCTTGAACCCGGGAGGCAGAGGTTGCGGTAAGCCAAGATCATGCCATTGCACTCCAGCCTGGGCAACAAGAGCAAAACCCCGTCTCAAAAAAAAAAAAAAAATTAGCCCAGTGTGGTGGCGTGCACCTGTAATCCCAGCTACTTACTTAGGAGCCTGAGGCAGGAGAATTGCTTGAACCCGGGAGGCAGAGTTTGCAGTGAGCCAAGATTGCACCATTGCACTCCAGCCTGGGTGACAAGAGTGAGACTGTCTCAAAAAAAAAAAAAAAAAAA","GGCCAGGTGCAGTGGCTCATATGTATAACCCCAACACTTTGGGAGGCCAACGCAGGTGGATCACCTGAGTTAGGAGTTTGAGACCAGCCTGACCAACATGGTGAAACCCTGTCTCTACTAAAAATACAGAAATGGCCGGGCATAGTGACACATACCTGTAATCCCAGATACTTGGGATGCTGAGTTTGCTTAAACCCAGAGGAGAACTGCTTAAACCCGGGAGGTAGAGGTCACAGTGAGCCAAGATTGGGATGCTGAGATTTGCTTAAACCCAGAGGAGAACTGCTTAAACCCAGGAGGCAGAGGTTGCAGTGAGTTGAGATTGCACCATTGCACTCCAGCCTGGACAACAAGAGTGAAACTCTGTCTCAAAAAAAAAAAAAAAAAA"
"chr17","55179146","55179483","JH378144","13229286","13229620","44","41949860","GGCCGGGTGCGGTGGCTCACGCCTGTAATCCCAGCACTTTGGGAGGCCGACGCAGGTGGATCACTTGAGGTCTGGTGTTCAAGACCAGCCTGGCCAACATTGTGAAACCCCGTCTCTACTAAAAATACAAAAAGTTAGCTGGGCATGGTAGCAGGTGCCTGTAATCCCAGCTACTTGGGAGGCTGAGGCAGGAGAATTGCTTGAACCTGGGAGGCAGAGGTTGCAGTGAGCTGAGATCGCACCATTGCACTCCAGCCCAGGCAACAAGAGCGAAACTTCGTCTCAAATAATAATAATAATAATAATAATAAATAAATAAATTTTTAAAAAAGAAAAAA","GGCCGGGCGCGGTGGCTCAAGCCTGTAATCCCAGCACTTTGGGAGGCCGAGGCGGGTGGATCACCTGTGGTCAGGAGTTCAAGACAGCTTGGTCAACATGGTGAAACCCCGTCTCTACCAAAAATACAAAAAATTAGCTGGGCATGGTAGCGCATGCCTGTAATCCCAGCTACTCAGGAGGCTGAGGCAGGAGAATTGCCTGAACCCAGGAGGCAGAGGTTGCGGTGAGCCGAGATCGCGCCATTGCACTCCAGCCTGGGTAACAAGAGCGAAACTCCCTCTCATAAAAAATAAATAAATAAATAAATAAATAAATAAATAAATAAATAAATAAA"
"chr17","59543657","59543981","JH378109","3329188","3329514","46","56214469","GGTTGGGCACAGTGGCTCACGCCTGTAATCCCAACACTTTGGGAGGCCAAGGCGGGTGGATCACCTGAGGTCGGGAGTTCAAGACCAGCCTGGCCAACATGCTGAAACCCTATCTCTACTAAAAATACAAAAAAAAAAAAAAAAAAAAAAAAAAAAAATAGCCCAGTGTGGTGTCAGGCGCCTATAATCTCAGCTACTTGGGTGGCTGAGGCAGGAGAGTCGCTTGAACCTGGGAGGCGGAGGTTGCAGTGAGCGGAGATCGCACCATTGCACTCCAGCGTGGGCAACAAGAGTGAAACTCCATCTCAAAAAAAAAGAAAAGAAA","GGCCAGGCATGGTGGCTCACGCCTGTAATCCCAGCACTTTGGGAGCCCAAGCCGGGTGGATTACCTAAGGTCAGGAATTCCAGAACAGCCTGGACAATATGGTGAAACCTTGTCTCTACTAAAAATACAAAAAAAAAAAAAAAAAAAAAAAAAAAAAAAATTTAGCCGGGTGTGGTGGTAGGTACCTGTAATCCCAGCTACTAGGGAGGCTGAGGCAGGAGAATCGCTTGAACTTGGGAGGCGGAGGTTGCAGTGAACAGAGATCACACCACTGCACTCCAGCCTGGGCGACAAGAGCAAAACTCCATCTCAAAGAAAAAAAAAGAA"
"chr17","60766805","60768705","JH378118","18053084","18053501","1483","42713721","GGCCAGGTACCGTGGCTCATGCCTCTTATCCCACCACTTTTGGAAGCTGAGGTGTGAGGATCACCCGAAGTCAGGAGTTTGGAACCATCCTGGCCAATGTTGTAAAACCCCGTCTCTAATAAAAATACAAAAGTTACCCAAGCATGGTGGTGGGCACACCTGTAATCCCAGCTACTTGGAAGGCTAAGACAGGAAAATGCCTGAACCCAGTGTGGCTGGAATTGGTGGGTTCTTGATCTCACTGACCTCAAGAATGAAGCCACGGACCCTCACGGTGAGTGTCACACTTCAAGGTGGCACGTCCAGTTTGTTCCTTCTGATGTTCGGATGTGCTCAGAGTTTCTTTCTTCTGGTGGGTTCATGGTCTCGCTGGCTCAGGAGTGAAGCTACAGACGTTCACCGGGAGTGTTACAGCTCTTAAGGCCTTGCGCCTGGAGTTGTTAGTTCCTCCCAGTGGCTTCGTGGTCTCACTGGCTTCAGGAATCAAGCAGCACGGTGAGCGTTACAGCTCACAAAGGCAGTGTGCACCCACAGTGAGCAACAGCAAAATCTATTGCAAAGAGGACAGAACAAAACCCCCACACTGGGGAAAAGGACCGGAACAGCTTGCCACTGCTGGCTCAGGCAGCCTGCTTTTATTCTCTTATCTGGCCCCACCCACATCCTCCTGATTGGTCCATTTTACAGAGAGCTGATTAGTTTGCTTTACAGTGAACTGATTGGTCCATTTTGACAGATTGGTGCTGATTGGTGCGTTTACAATCCCTGAGCTAGACACAAAAGTTTTCCACGTCCCCATTAGAATAGCTAGATACAGAGTGTCCATAGGTGTATTTACAAACCCTGAGCTAGACACGGAGTGATGATTGGTGCATTTACAAACATGGAGCTAGATACAGAGTGCCGATTGGTGCATTCACAATCCCTTAGCTAGACATAAAGGTTCTCAAGTTCCCACCAGATCAGCTAGACATAGAGCGCTGATTGGTGCATTTACAAAACTTGAGCTCGACACAGGGTGCTGATTGGTGCATTCACAAACCTTGAGCTAGACACAGGGTGCTGATTGGTGTGTTTACAAACCTTGAGCTAGATGCAGAGCGCTGATTGGTGTATTTACAATTCCTTAGCTAGACATAAAGGTTCTCCAAGTCCCCACTAGACTCAGGAGCCCAGCTGGCCTCACCCAGTGGATGTCACACTGGGGCCATAGGTGGAGCTGCCTGCCAGTTCCGTGTCCTGCGCCCACACTCCTCAGCCCTTGGGCGGTGGATGGGATTGGGCACCGTGCAGCAGGGGGTCGCGCTCCTGGGGGAGGCTCGGGCGGTGCAGGAGCCCACGGTGGCGGGGCGGGGCAGACTCAGGCATGGCGGGCTCCGGGTCCCAAGCCCTGCCGGGTGGGGAGGCACCTAAGGCCAGGCGAGAAATGGAGCGCAGCGCTGGTGGGCCAGCACTGCTGGGGGACCAGGCGCATCCTCCGCAGCTGTTGGCCTGGGTGCTAAGCCCCTCACTGCCCAGGGCTGGCAGGGCCCGCCGGCCGCTCCGAGTGCCGGGCCCGCCAAGCCCACGCCCACTTGGAACTCTAGCTGGCCCGCAAGCGCGGCGCGCAGCCCTGGTTCCCCCCCGTGCCTCTCCCTCCACACCTCCCCGCGGGCTGAGGGAGCCGGCTCCGGCCTCGGCCATCCCAGGAAGGGGCTCCCACACTGCAGCGGCGTGCTGAAGGGCTCCTCAAGCACGGCCAGAGTGGGCGAGGAGGCTGAGGAGGCGCCAAGAGTGAGCCAGGGCTGCCAGCATGCTGTCACCTCTCACCAGGAGGCGGAGATTGCAGTGAACCAAGACTGTGCCATTGCACTCCAGCCTGGGCAACAAGAGTGAAACTCCATCTCAAAAAAAATAATAAA","GGCTGGGCGCAGTGGCTCACACCTGTAATCCCAGCACTTAGGGAAGCTGAGGCGAGTAGATCACCTGAGGTCAGGAGTTAGAGACCAGCCTGGCCATCATGGTGAAACCCCGTCTCTACTAAAGATACCAAAAATTAGCTGAGTGTGGTGCTGGGTGCCTGTAATCCCAGAAACTCAGGGTGCCTGTAATCCCAGCAACTCAGGGTGCCTTTAATCCCAGCAACTGAGGGTACCAGTAATCCCAGCAACTCAGGGTGTCTTTAATCCTAGCAACTGAGGGCACCTGTAATCCCAGCAACTCAGGAAGCTGAGACAGGAGAAGTACTTGAACCCAGAAGGCAGAGGTTGCAGTGAGCCGATATTGCACCATTGCACTCCAGTCTGGGCAACAAGAGTGAAACTCTGTCTCAAAAAAAAA"
"chr17","64473614","64473953","JH378109","21565230","21565567","55","42908384","GGCCGGGTGTGGTGGCTCATGCCTGTAATCCCAGTACTTTGGGAGGCCGAGGCAGGCAGATCTCCTGAGGTCAGGAGTTTGAGACCAGCCTGGCCAACATGATGAAATGCTGTCTCTCCTAAAAATACAAAAATTAGCCAGACATAGTGGCAGGTGCCTGTAATCCCAGCTACTTGGGAGGCTGAGGGAGGAGAATTGCTTGAACCTGGGAGGCAGAGGTTGCAGTGAGTCAAGATCACGCCATTGCGCTCCAACCTGGGTGACAAAAGTGAGACTTCATCTCAAAATAAATAAATAAATAAATAAATAAATAAATAAATAAATAATAATTAAAAAAAAA","GGCCGGGCGCGGTGGCTCAAGCCTGTAATACCAGCACTTTGGGAGGCCGAGGCGGGTGGATCACGAGGTCAAGAGATCGAGACCATCCTGGTCAACATGGTGAAACCCCGTCTCTACTAAAAATACAAACAATTAGCTGGGCATGGTGGCGGGTGCCTGTAATCCCAGCTACTCCAGAGGCTGAGGCAGGAGAATTGCCTGAACCCAGGAGACGGAGGTTGCGGTGAGCCAAGATCGCGCCATTGCACTCCAGCCTGGGTGACAAGAGCGAAACTCCGTCTCAATAAATAAATAAATAAATAAATAAATAAAAATAAAATAAATAAATAAATAAATAA"
"chr17","67747489","67748097","JH378118","18053084","18053501","256","49694405","GCTGGGTGTGGTGGCTCACGCCTATAATCCCAGCACTTTGGGAGGCCAAGGCAGGTGGATCACCTGAGGTCAGGAGTTTGAGACCAGCCTGGCCAACATGATGAAACCCCGTCTCTACTAAAAATACAAAGAATTAGGCTGGGCGCGGTGGCTCACGCCTGTAATCCCAGCACTTTGGGAGGCCGAGGCGGGTGGATCACGAGGTCAGGAGATCGAGACCATCCTGGCTAACACGGTGAAACCCCGTCTCTAATAAAAATAAAAAAAAATTAGCTGGGCGTGGTGGTTGGCGCCTGTAGTCCCAGCTACTCGGGAGGCTGAGGCAGGGGAATGGCGTGAACCCGGGAGGTGGAGCTTGTAGTGAGCCGAGATCACGCCACTGCACTCCAGCCTGGGCGACAGAGCAAGACTCCGTCTCAAAAAAAAAAAAAAAAAAAATTAGCCAGGCGTGGTGGCGGGTGCCTGTAATCCCAGCTACTCTGGAGGCTGAGGCAGGAAAATCACTTTAACTCAGGAAACAGAGGTTGCAGTAAGCCGAGATCACGCCATTGTGCTCCATCCTGGGCAACAAGAGCGAAACTCCGACTCGGAAAAAAAGAAAAAAAAAAA","GGCTGGGCGCAGTGGCTCACACCTGTAATCCCAGCACTTAGGGAAGCTGAGGCGAGTAGATCACCTGAGGTCAGGAGTTAGAGACCAGCCTGGCCATCATGGTGAAACCCCGTCTCTACTAAAGATACCAAAAATTAGCTGAGTGTGGTGCTGGGTGCCTGTAATCCCAGAAACTCAGGGTGCCTGTAATCCCAGCAACTCAGGGTGCCTTTAATCCCAGCAACTGAGGGTACCAGTAATCCCAGCAACTCAGGGTGTCTTTAATCCTAGCAACTGAGGGCACCTGTAATCCCAGCAACTCAGGAAGCTGAGACAGGAGAAGTACTTGAACCCAGAAGGCAGAGGTTGCAGTGAGCCGATATTGCACCATTGCACTCCAGTCTGGGCAACAAGAGTGAAACTCTGTCTCAAAAAAAAA"
"chr17","71197353","71197681","JH378262","266823","267148","47","70930530","GACCGGACACAGTGGCTCACGTCTGTAATCCCAGCACTTTGGGAGGCTGAGGCGGGTGGATCACCTGAGGTCAGGAGTTCAAAACCAGCCTGGCCAATATGGTGAAAACCCGTCTATACTAAAAATAAAAAATTAGCCAGGCTTGGTGGCAGGCACCTGTAATCCTAGGTACTCTGGAGGCTTAGACAGGAGAATCACTTGAACCCGAGAAGTGGAGGTTGCAGTGAGCCAAGATCGTGCCATTGCACTCCAGCCTGGGCGACAAGAGTGAGACTCCATCTCAAAAACAAACAAACAAACAAACAAAAAACAAATGAACAAAAAAAAAA","GGCCGGGCGCGGTGGCTCAAGCCTGTAATCCCAGCACTTTGGGAGGCCGAGGCGGGTAGATCATGAGGTCAGGAGTTTGAGACCAGCCTGGCCAACATGGTGAAACCCCGTCTCTACTAAAAATACAAAAATTAGCCGGGCATGGTGGCCTGTGCCTGTAATCCTAGCTACCCAGGAAGCTGAGGCAGGAGAATTGCCTGAACCCAGGAGGCGGAGGTTGCGGTGAGCCGAGATCGTGCCATTGCACTCCAGCCTGGGTAACAAGAGCGAAACTCCGTCTCAAAAACAAACAAACAAACAAACAAAAACAAAAAACAAAAAACAAA"
"chr17","72892082","72892699","JH378118","18053084","18053501","266","54838998","GGCCAGGTGCAGTGGTTCACACCTATAATCCCAGCACTCTAGGAGGCCAAAGTGGGCAGATCACCTGAGGTCAGAAGTTCGAGACCAGCCTGGCCAACATGGTGAAACCATCTCTACTAAAAACACAAAAATTAGGCTGGGCACGGTGGCTCACACCTGTAATCCCAGCACTTTGGGAGGCCGAGGTGGGTGGATCACGAAGTCAGGAGATCAAGACCATCCTGGCTAACACGGTGAAACCCCGTCTCTACTAAAAATACAAAAAATTAGCCAGGCGTGGTGGCGGGCGCCTATAGTCCCAGCTACTTGGGAGGCTGAGGCAGGAGAATGGCGTGAACCCAGGAGGCGGAGCTTGCAGTGAGCCAAGATTGCGCCACTGCACTCCAGCCTGGGTGAGAGAGCTAGACTCTGTCTCAAAAAAAAAAAAAAAAAAAACACAAAAATTAGCCGGGCTTGGTGGCAGGTGCCCGTAATCCCAGCTACTCAGGACGCTGGGACAGGAGAATCTCATGAACCCTGGAGGTGGAGGTTGTAGTGAGCCAAGATCTCACCATCGCACTCCAGCCAGGGTGACAAGAGTGAAACTCTGTCTTAAAAAGATAAATAAATAAAATAAAA","GGCTGGGCGCAGTGGCTCACACCTGTAATCCCAGCACTTAGGGAAGCTGAGGCGAGTAGATCACCTGAGGTCAGGAGTTAGAGACCAGCCTGGCCATCATGGTGAAACCCCGTCTCTACTAAAGATACCAAAAATTAGCTGAGTGTGGTGCTGGGTGCCTGTAATCCCAGAAACTCAGGGTGCCTGTAATCCCAGCAACTCAGGGTGCCTTTAATCCCAGCAACTGAGGGTACCAGTAATCCCAGCAACTCAGGGTGTCTTTAATCCTAGCAACTGAGGGCACCTGTAATCCCAGCAACTCAGGAAGCTGAGACAGGAGAAGTACTTGAACCCAGAAGGCAGAGGTTGCAGTGAGCCGATATTGCACCATTGCACTCCAGTCTGGGCAACAAGAGTGAAACTCTGTCTCAAAAAAAAA"
"chr17","74365360","74365846","JH378118","18053084","18053501","163","56312276","TATAAAAAATCAGCTAGGCTTGGTGGCTTGTGCCTGTAATCCCAGCACTTTGGGAGGCTGAGGCAGGTGGATCACCTGACGTAGGTGTTTAAGACCAGATTGACTAACATGTTGAAACCCCGTCTCTACTAAAAATACAAAAATTATCTGGGCTTGGTGGTGCATGCCTGTAATCCCAGCTGCTCAGGAGGCTGAGACAGGAGAATCGCCTGAACCTGGGAAACGGAAGTTGCAGTGAGTGGAGGTTGCAGTGAGCCGAGATTGCACCACTGCACTCCAGTCTGGGCAACGGAAAAAGACTGTCTCAAAAAAAAAAAAAAAATTAGCTGGGTGTGGTGGTTGGCGCCTGTAATTCCAGCTACTCAGGAGGCTGAGGCAGGAGAATCACTTGAACTCAAGAGGCAGAGGTTGCAATGAGCCAAGATTGCGCCATTGTACTCCAGCCTGGGCCACAAGATTGAAACTTCATCTTGGGGAAAGAAAACAA","GGCTGGGCGCAGTGGCTCACACCTGTAATCCCAGCACTTAGGGAAGCTGAGGCGAGTAGATCACCTGAGGTCAGGAGTTAGAGACCAGCCTGGCCATCATGGTGAAACCCCGTCTCTACTAAAGATACCAAAAATTAGCTGAGTGTGGTGCTGGGTGCCTGTAATCCCAGAAACTCAGGGTGCCTGTAATCCCAGCAACTCAGGGTGCCTTTAATCCCAGCAACTGAGGGTACCAGTAATCCCAGCAACTCAGGGTGTCTTTAATCCTAGCAACTGAGGGCACCTGTAATCCCAGCAACTCAGGAAGCTGAGACAGGAGAAGTACTTGAACCCAGAAGGCAGAGGTTGCAGTGAGCCGATATTGCACCATTGCACTCCAGTCTGGGCAACAAGAGTGAAACTCTGTCTCAAAAAAAAA"
"chr17","74566963","74567566","JH378119","32351107","32351490","260","42215856","GCCGGGCATGGTGTATCACGCCTGTAATCCCAGCACTTTGGGAGGCAGAGGTAGGCAGATCACCTGAGGTCAGGAGTTCAAAACCAGCCTAGCCAACATGGTGAAACCCCGTCTCTACTAAAAATACAAAAAATTAGTGGCCAGGCACGGCAGCTCACGCCTGTAATTCCAGCACTTTGGGAGGCCGAGGCGGGCAGATCACGAGGTCAGAAGATTGAGACCATCCTGGCTAACACGGTGGAACCCCATCTCTACTAAAAATACAAAAAATTAGCTGGGCATGGTGGCTGGTGCCTGTAGTCCCAGCTACTCGGGAGGCTGAGGCAGGAGACTGGCATGAACCCGGGAGGCGGAGCTTGCAGCAAGCCAAGATCGTGCCACTGCACTCCACTCCATCCTGGGCGACAGAGCAAGACTCCGCTTCAAAAAAAAAAAAATTAACCGGGCAAGGTGGCAGGTGCCTGTAATCCCAGCTACTTGGGAGGCTGAGGCAGGAGAATTGCTTGCAGAGGTTGAAGTGAGCCGAGATTACGCCATTGCACTCCAGCCCAAGTGACAAGAGTGAAACTCCATCTCAAAAAAAAAAAAAAAAAAAAGAAAAAAA","GGCCAGGTATGGTGGCTCACACCTGTAATCCCAGCACTTTGGGAGGCCAAGGCAGGCAGACCACCTGAGGTCAGGAGTTCGAGATCAGCCTAGCCAACATGGTGAAACCCCATCTCTAGTAAAAATAAAATTAGCCAGGCATGGTGGTGCATGCCTGTAACGCAGGTCAGGAGTTCGAGATCAGCTTAGCCAACATGGTGAAACCCCATCTCTAGTAAAAATAAAATTAGCCAGGCAGGTGGTGCCGCCTGTACTCGGGAGGCTGAGGCAGGAGAATCACTTGAACCCAAGAGGCAGAGGTTGCAGTCAGCCAAGATCATGCCATTGCACTCCAGCCTAAGCAAAAAGAGTAAAACTCAGTCTCAAAACAAAAAAACAAAAAAA"
"chr17","75365782","75366409","JH378153","2355361","2355755","282","73010421","CCAGGCGTGGTGGCTCATGCCGGTAATCCCAGCACTTTGGGAGGCCAAGGCAGGTGGATCATCTGAGGTCAGGAGTTCGAGACCAGCCTGACCAACATGGTGAAACCTCACCTCTACTAAAAATACAAAAACTAGACAGGCGTGGTGGCGGGTGCCTGTAGTCCCAGCTACTTGGGAGGCTGAGGCAGAAAAATCGCTTGAACCCAGTAGGCAGAGGTTGCAGTGAGCCGAGATCACACCATTGCACTCCAGCCTGGGCAAAAAAGAGCGAAACTCCATCTCAGAAGAAAAGACCGGGTGCAGTGGCTCATGCTTGTAACCCCAGCACTTTGGGAGGCCAAGGCGGGTGGATCACGAGGTCAGAAGATCGAGACCATCCTGGCTAACACGGTGAAACCCCGTCTCTACTAAAAATACAAAAAAAAAAAAATAATTAGCCGAGTGTGGTGGCGGATGCCTGTAGTCCCAGCTACTCGGGAGGCTGAGGCAGGAGAATGGCGTGAACCCAGGAGGCGTAGCTTGCAGTGAGCCGAGATCACGCCACTGCACTCCAGCCTGGGCGACAGAGCAAGACTCGTCTTAAAAAAAAAAAAAAAAAGAAAAAGTAAAAGAAAAGAAAAAGCAACAA","GGCGGGGCATGGTGGCTCACACCTGTCATCCCAACACTTTGGGAGGCTGAGGCAGGCAGATCACCTGAGGTCAGGAGTTTGAGACCAGCCTGGCCAACATGGTGAAACCCCATCTCTACTAAAAATACAAAAATACAAAAAACCCCATCTCTACTAAAAATACAAAAAGCTTGTCTCTATTAAAAATACAAAAAACAAAAAACAAACAAAAAAAAAACCACCATGGTGGTGGGTGCCTATAATCCCAGCTACTCGGGAGGCTGAGGCAGGAGAATCGCTTGAACCCAGGAGGCAGAGGTTGCAGTGAGCCAAGATCCCACCATTGCACTCCAGCCTGGGCAACAGAGAGAGAGACTCTGCCTCAGAAAAAAGAAAGAAAGAAAGAAAGAAAGAAA"
"chr18","19875","20142","JH378153","8929988","8930242","54","8910113","TTGGGAGGCTGAGGTGGGTGGATCATCTGAGGTCAGGAGTTAAGACCAGCCTGGCCAACATGGTGAAACCCCATCTCTACTAAAAATACAAAAACAAAACAAAACAAAACAAAAAAAACCAGCATGGTGGCAGACACCTGTAATCCCAGCTACTCGGGAGACTGAGGCAGGAGAATCACTTGAACCTGGGAGGCGGAGGTTACAGTGAGCCAAGATCTTGTCATGTCACTCCAGCCCAGGCAACAAGAGCAAAACTGTCTTAAAAAAA","TTTGAGAGGCTGAGGTGGGTGGATCACCTAGGTCAGGAGTTTGAGACCAGCCTGACCAACATGGTGAAACCTCATCTCTACTAAAAATAAAAATAAAAAACTAGCCAGGTGCAATGGTGCATGCCTGTAATCCCAGCTACTTGGGAGGCTGAGATGGGAGACTCACTTGAACCTGGGAGGTGGAGGTTGCAGTGAGCCAAGATCATACCATTGCACTCCAGCCTGGGCAACAAGAGTGAAACCTCTTCTCAAAAA"
"chr18","4520498","4521101","JH378118","18053084","18053501","246","13532586","GGCTGGGCGCAGTGGCCCACCCCTGTAATCCCAGCACTTTGGGAGGCCGAGGCGGGTAGATCACCTGACGTCAGGAGTTCAAGACCAGCCTGGCCAACATGGTGAAACCCTGTCTCTACTAAAATACAAAAATTAGGCTGGGCGCAGTGGCTCAAGCCTGTAATCCAGCACTTTGGGAGGCCAAGGCGGGCAGATCACCTGAGGTCAGGAGTTCGAGACTAGCCTGGCCAACCTGGCAAAACCCCATCTCTACTAAAAGTACGAAAATTAGCCAGGGTGATGGTGTGCACCTGTAATCCTAGGTACTCAGGAGGCTGAGGGCAAGAGAATCGCTTGAACCTGGGAGGCAGAGGTTGTAGTGGGCCAAGATCGCGCCATTGCACTGCAGCCTCGGTGACAGAGAAAGACTCCGTCTCAAAAAAAAAAAAAAACAAAAATTAGCTGGGCGTGGTGGTGGGCGTCTGTAGTCCCATCTACACGGGAGGCTGAGGCAGAAGAATCACTTAAACCCAGGATGTGGAGGTTGCAGTGAGCTGAGATCACGCCATTGCACTCCAGACTGGGTAACAAGAGCAAAACTCCATCTCAAATAAATAAAATAAAA","GGCTGGGCGCAGTGGCTCACACCTGTAATCCCAGCACTTAGGGAAGCTGAGGCGAGTAGATCACCTGAGGTCAGGAGTTAGAGACCAGCCTGGCCATCATGGTGAAACCCCGTCTCTACTAAAGATACCAAAAATTAGCTGAGTGTGGTGCTGGGTGCCTGTAATCCCAGAAACTCAGGGTGCCTGTAATCCCAGCAACTCAGGGTGCCTTTAATCCCAGCAACTGAGGGTACCAGTAATCCCAGCAACTCAGGGTGTCTTTAATCCTAGCAACTGAGGGCACCTGTAATCCCAGCAACTCAGGAAGCTGAGACAGGAGAAGTACTTGAACCCAGAAGGCAGAGGTTGCAGTGAGCCGATATTGCACCATTGCACTCCAGTCTGGGCAACAAGAGTGAAACTCTGTCTCAAAAAAAAA"
"chr18","8281535","8282152","JH378118","18053084","18053501","271","9771549","GGCCAGGTGCGATAGCTCACACTGGTAATCCCAACACTTTGGGAGGCCGAGGTGGGCGGATCACCTGAGGCCAGGAGTTTGAGACCAGCCTGGCCAACACAGTGAAACCCCATCTCTACTAAAAATACAAAATTAGGCAGGGTGCAGTGGCTCACGCCTGTAATACCAGCACTTTGGGAGGCCGAGACAGGCGGATTACGAGGTCAGGAGATCGAGACCATCCTAGCTAACACAGTGAAACCCCGTCTCTACTAAAAAAAAAAAAAAAAAAAAAAGTACAAAAAAATTAGCCAGGCGTGGCGGCAGGTGCCTGTAGTCCCAGCTACTCAGGAGACTGAGGCAGGAGAATGGCGTGAACCCGGGAGGCGGAGCTTGCAGTGAACTGAGATCACACCACTGCACTCCAGCCTGGGCAACAGAGTGAGACTCCGTCTCAAAAACAAAACAAAATTAGCCGGGCATGGTGGTGGATGCCCGTAATCCCAGCTACTCGGGAGGCTGAGGCCGCCAAGGCAGGAGAATCTCTTGAATGTGGGAGGCAAAGGCTGCAGTGAGCTGAGATCATGCCATTGCACTGTAGCCTGGGCGACAAAAGTGAGACTCCGTCTCAAAAAAAAA","GGCTGGGCGCAGTGGCTCACACCTGTAATCCCAGCACTTAGGGAAGCTGAGGCGAGTAGATCACCTGAGGTCAGGAGTTAGAGACCAGCCTGGCCATCATGGTGAAACCCCGTCTCTACTAAAGATACCAAAAATTAGCTGAGTGTGGTGCTGGGTGCCTGTAATCCCAGAAACTCAGGGTGCCTGTAATCCCAGCAACTCAGGGTGCCTTTAATCCCAGCAACTGAGGGTACCAGTAATCCCAGCAACTCAGGGTGTCTTTAATCCTAGCAACTGAGGGCACCTGTAATCCCAGCAACTCAGGAAGCTGAGACAGGAGAAGTACTTGAACCCAGAAGGCAGAGGTTGCAGTGAGCCGATATTGCACCATTGCACTCCAGTCTGGGCAACAAGAGTGAAACTCTGTCTCAAAAAAAAA"
"chr18","14964693","14965321","JH378118","18053084","18053501","273","3088391","GGCTGGGTGCGGTGGCTCACACCTGTAATCCCAGCACTTTGGGAGGCTGAGGCAGGCGGATCACCTGAGGTCAGGAGTTCAGGACCAGCCTGATCAACATAGCGAAACCCTGTCTCTATTAAAAATATAAAAATTGCTGGGTGCGGTGGCTCACGCCTGTAATCCCAGCACTTTGGGAAGCCGAGGCGGGCGGATCATGAGCTCAGGAGATCGAGACCATCTTGGCTAACATGGTGAAACCCTGTCTCTACTAAAAATACAAAAAAATTAGCCAGGTGTGGTGGCGGGCGCCTGTAGTCCCAGCTACTCTGGAGGCTGAGGCAGGAGAATCACTTGAACCTGGGAGGCGGAGGTTGCGGTGAGCCAAGATGGTGCCATTGCACTCCAGCCTGGGCAACAAGAGTGAAACTCCATCTCAAAAAAAAAGAAAAAAAAAAAAAAAAACAACCCACAAAAATTAGCCAGGTGTGATGGCGGGTGTCTGTAATCCCAGCTACTTGGGAGACTGAGGCAGGAGAATGGCTTGAACCCGGGAGGTGGAGGTTGCAGTAAGCCGAGATTGCGCCACTGCACTCCAGCCTGGGTGACCAGAGTGAAACTTCATCTCAAAAAAAAAAAAAAAAAAAAAA","GGCTGGGCGCAGTGGCTCACACCTGTAATCCCAGCACTTAGGGAAGCTGAGGCGAGTAGATCACCTGAGGTCAGGAGTTAGAGACCAGCCTGGCCATCATGGTGAAACCCCGTCTCTACTAAAGATACCAAAAATTAGCTGAGTGTGGTGCTGGGTGCCTGTAATCCCAGAAACTCAGGGTGCCTGTAATCCCAGCAACTCAGGGTGCCTTTAATCCCAGCAACTGAGGGTACCAGTAATCCCAGCAACTCAGGGTGTCTTTAATCCTAGCAACTGAGGGCACCTGTAATCCCAGCAACTCAGGAAGCTGAGACAGGAGAAGTACTTGAACCCAGAAGGCAGAGGTTGCAGTGAGCCGATATTGCACCATTGCACTCCAGTCTGGGCAACAAGAGTGAAACTCTGTCTCAAAAAAAAA"
"chr18","15291276","15291680","JH378105","31074364","31074738","116","15783088","CTCGTGCCTGTAATCCTAGCACTTTGGGAGGCCAAGGTGGGCAGATCATCTGAGGTCAGGAGTTCGAGACCAGCCTGGCCAACATAGAGAAATCCCATCTCTACTAAAAATACAAAAATTGACGAGTTAATGGGTGCAGCACACGAACATGGCACATGTATACATATGTAACAAACCTGCACGTTGTGCACATGTACCCTAAAACTTAAAGTATATTTAAAAAAAATACAAAAATTAGCCGGGCATGGTAGCAGGCACCTGTAATCCCAGCTACTCGGGAGGCTGAGGCAGGAGAATCACTTGAACCTGGGAGGCAGAGGTTGCAGTGAGCTAAGATCATTCCATTGTACTCCAACCTGGGCAACAAGAGTGAAATTCCGTCTAATAAAAAATGAAATAAATAAA","GGCCGGGCACAGTGGCTCACACCTGTAAACCCAGCACTTTGGGAGAATGAGGTGGGCAGATGACTTCAGGTCAGGAGTTCGAGACCAGCCTGGCCAACACTGTGAAATCCCATCTCTACTAAAAATACAAAAATTAGCCATGGTGGTCAGAAGATCAAGACTATCCTGGCCAACATGGTGAAACCTTGTCTCTACTGAAAATAGAAAAATTAGCTGGGTATGGTGGCATGCGCCTGTAGTCCCAGATACTCAGGAGGCTGGGGCAGGAGAATCACTTGAACCCAGGAGGCAGAGGTTGCAGTGAGCTGAGATCATGCCATTGCACTCTAGATTAGGCAACAAGAGTGAAACTGTCTCAAAAAGAGAGAGAGAAAA"
"chr18","15802064","15802689","JH378153","2355361","2355755","270","13446703","GACCGGGCATGGTGGCTCACACCTGTAATCCCAGCACTTTGGGAGGCGTAGGCGAGTGGCCCCTGAGGTCAGGAGATCGAGACAACCCTGGCCAACATGGTGAAACTCTACTAAAAATACAAAATTAGGCCGGGTGCCGTGGTTCACGCCTATAATCCCAGCACTTTGGGAGGTCAAGGTGGGCAGATCACCTGAGGTCAGGAGTTTGAGACCAGCCTGGCCAACATGGTGAAACCCAGTCTCTACTAAAAATACAAAAATTAGCTGGGCATGGTGGTGGACACTTGTAATCCCAGCTACTTGGGGGGCTGAGGCAGGAGAATCACTTGAACCCAGGAGGCAGAGGTTGCAGTGAGCCTAAATCACCCCATTGCACTCCAGCCTGGGCAACAAGAGTGAAATTCTGTCTCGAAAAAAAAAAAAAAAGAAAAGAAAAGAAAAAAAAATTAGCCAGGTGTGGTGCTGCATGCCTGTAATCCCAGCTACTCAGGAGGCTGAGGCAGGAGAATCGCTTGAACCCGGGAGGCAGAGGTTGCAGTGAGCTGAGACCACACCATTGCACTCCAGCCTGGGCGACAAGAGAGTAACTCCATTTCAAAAAAAAAAAAAAAAAAAAGAAAAAAGAA","GGCGGGGCATGGTGGCTCACACCTGTCATCCCAACACTTTGGGAGGCTGAGGCAGGCAGATCACCTGAGGTCAGGAGTTTGAGACCAGCCTGGCCAACATGGTGAAACCCCATCTCTACTAAAAATACAAAAATACAAAAAACCCCATCTCTACTAAAAATACAAAAAGCTTGTCTCTATTAAAAATACAAAAAACAAAAAACAAACAAAAAAAAAACCACCATGGTGGTGGGTGCCTATAATCCCAGCTACTCGGGAGGCTGAGGCAGGAGAATCGCTTGAACCCAGGAGGCAGAGGTTGCAGTGAGCCAAGATCCCACCATTGCACTCCAGCCTGGGCAACAGAGAGAGAGACTCTGCCTCAGAAAAAAGAAAGAAAGAAAGAAAGAAAGAAA"
"chr18","15849226","15849860","JH378118","18053084","18053501","290","2203858","GGCCAGGCACAGTAGCTTACGCCTATAATCTCAGCACCCTAGGAGGCCGAGGCTGGCAGACCACCTGAGGTCACGAGTTCAAGACTAGCCTGGTCAACATAGCAAAACCCCATCTCTACTAAAAATACAAAAATTAGGCTGGGCACAGTGGCTCATGCTTGTAATCCCAGCACTTTGGGAGGCCAAGTCGGGAGAATCACCTGAGGTTGGGAGTTCGAGATCAGCCTGACCAACATAGAGAAACTCCATCTCTACTAAAAATGCAAAATTAGCTAGGCATGGTGGTGCATGCCTGTAATCCCAGCTACTCGTAAGGCTGAGGCAGGAGTATCGCTTGAATCTGGGAGGTGGAGGTTGCGGTGAGCCAAGATCACGCCATCGTACTCCAGCCTGGGCAACAAGAGCGAAACTCCATCTCAAAACAAAAAAAATGAGCCAGGAGTGGTGGCGGGCGCCTATAATTCCAGCTACTCCAGAGGCTGAGGCAGGAGAATCACTTAAACCCGGGAAGCAGAGGTTGCAGTGAGCTGAGATTGTGCCATTGCACCCCAGCCTAGGTGAAAAGAGCAAAACTCCATCTCAAAAAAAAAAAAAAAAAAAAAAAAAAAGAAAGAAAGAAAGAAAAAGAAAAAAAA","GGCTGGGCGCAGTGGCTCACACCTGTAATCCCAGCACTTAGGGAAGCTGAGGCGAGTAGATCACCTGAGGTCAGGAGTTAGAGACCAGCCTGGCCATCATGGTGAAACCCCGTCTCTACTAAAGATACCAAAAATTAGCTGAGTGTGGTGCTGGGTGCCTGTAATCCCAGAAACTCAGGGTGCCTGTAATCCCAGCAACTCAGGGTGCCTTTAATCCCAGCAACTGAGGGTACCAGTAATCCCAGCAACTCAGGGTGTCTTTAATCCTAGCAACTGAGGGCACCTGTAATCCCAGCAACTCAGGAAGCTGAGACAGGAGAAGTACTTGAACCCAGAAGGCAGAGGTTGCAGTGAGCCGATATTGCACCATTGCACTCCAGTCTGGGCAACAAGAGTGAAACTCTGTCTCAAAAAAAAA"
"chr18","16042035","16042617","JH378118","18053084","18053501","243","2011049","GGCTATGCACGGTGGCTCACGCCTGTAATCCCAGCACTTTGGGAGGCCGAGTCAGGTGGATCACTTGAGGTCAGGAGTTCGAGACCAGCCTGGCCAACATGGTGAAGCCCCATCTCCACTAGAAATACAAAAATTAGTCTGGGAGCAGTGGCTTACACCTGTAATTGCAGCACTTTGGGAGGCCAAGGTGGGTGGATCACCTGAGGTCAGGAGTTTGAGACCAGCATGACCAACATGGTGAAACTCCATCTATACAAAAAAATTAGCCGGGTGTGGTGGCGCATGCCTGTAATCCCAGCTACTCAGGAGACTGAGGCAGGAGAATTGCTTGAACCCGGGAGGCAGAGGTTGCAGTGAGCCAAGTCTGTGCCATTGCACTCCAACCTGGGCAACAAAAGCGAAACTCTGTCTCAAAAATAAACAACAAAAAAAATTAGCCAGGTGTGGTGGCACATGCCTATAATCCCAGCTACTCGGGAGGCTGAGGCAGAAGAATTGCTTGAACCTGGGAGGTGGAGGTTGCAGTGAGCCGAGATCATGCCATTCTACTCCAGCCTGGGCCACAAGAGCGAAACTCTGTCTC","GGCTGGGCGCAGTGGCTCACACCTGTAATCCCAGCACTTAGGGAAGCTGAGGCGAGTAGATCACCTGAGGTCAGGAGTTAGAGACCAGCCTGGCCATCATGGTGAAACCCCGTCTCTACTAAAGATACCAAAAATTAGCTGAGTGTGGTGCTGGGTGCCTGTAATCCCAGAAACTCAGGGTGCCTGTAATCCCAGCAACTCAGGGTGCCTTTAATCCCAGCAACTGAGGGTACCAGTAATCCCAGCAACTCAGGGTGTCTTTAATCCTAGCAACTGAGGGCACCTGTAATCCCAGCAACTCAGGAAGCTGAGACAGGAGAAGTACTTGAACCCAGAAGGCAGAGGTTGCAGTGAGCCGATATTGCACCATTGCACTCCAGTCTGGGCAACAAGAGTGAAACTCTGTCTCAAAAAAAAA"
"chr18","25849088","25849351","JH378114","20445944","20446195","60","5403144","GGGAAGATGAGGCGGGTGGATCACTTGAGGTCAGGAGTTCGAGACCAGCCTGGCCAACATGGTGACACCCTGTCTCCAAAAAATACACACACACACACACACACACACACACACACAAATTAGCTGGGCATGGTGGCGGGCACCTGTAATCCTAGCTACTCGAGAGGCTGCGGCAGGAGAATTGCTTTAACTTGGGAGGTAGAGGTTGCAGAGAGCCGAGATTGCACCATTGTACTCCAGCCTGGGTGACAAGAGCGAAACTCC","TTGGGAGGCCAAGGCGGGTGGATCACCTGAGGTCAGGAGTTCGAGACCAGCCTGGCCAACATGATAAAACCCCCGTATCTAATAAAAATAGGAAAAAAAAATAAATAAATAGCTGGGCGTTGTGGCAGGTGCCTGTAATCCCAGCTACTCGGGAGGCTCAGGCAGGAGAATCGCTTGAACCCAGGAGGCAGAGGTTGCAGTGAGCCAAAATTGTGCCATTGCACTCCCGCCTGGGAAACAAGAGCAAAACTC"
"chr18","38083500","38083832","JH378152","15993594","15993909","55","22089906","GGCTGGGTGCGGTGGCTCACGCCTGTAATCCCAGCACTTTGGGAAGCCAAGTCAGGTGACCTCACCTGAGGTCAGGAGTCCAAGACCAGCCTGACCAACATGGTGAAACCTCGTCTCTACTAAAAAGACAAAAAATTAGCCAGGCATGGTGGTGGGCACCTGTAATCTCAGCTACTCTGGAGGCTGAGGCAGGAGAATCACTTGAACCCTGGAGGGGGAGGTTGCAGTGAACCAAGATTGCACCATTGCAGTCCAGCCTGGGCGACAAGAGCAAAACTCCATCTCACAAACACACACACACACACACACACACACACACACAGAAAAAAAAAA","GGCTGGGTGTGGTGGCTCATGCCGGTAATCCCAGCACTTTGGGAAGCGGAGGCAGGCAGATCACCTGAGGTCAGGAGTTCAAGACCAACCTGGCCAACATGGAGAAACCATGTCTCTACTAAAAATACAAAAAATTAGCCAGGCATGGTGGGTGCCTGTAATCCCCACTACTCGGGAGGCTGAGGCAGGAGAATTTCTTGAACCCAGGAGGTGGAGGTTTCAGTGAAGCGGAGATCACCCCATTGCACTCCAGCCTGGGTGACAAGAGCAAAACTCCATCTCACAAAATCAACAACAACAACTTAAAAAAAAAAAA"
"chr18","44076326","44076933","JH378118","18053084","18053501","257","26023242","GCTGGGCGCGGTGGCTTGCGCCTGTAATCCCAGCCATTTGGGAGGCCGAGGCAGGTGGATCACCTGAGGTTAGGAGTTCAAAACCAGCCTGGCCAACATGGTGAAACCCCGTCTCTACTAAAAATACAAAAATTAGGCCAGGCACAGTGGCTCACGCCTGTCATCCCAGCACTTTGGGAGGCCAAGGCGGGCGGATCATGAGGTCAGGAGATTGAGACCATCCTGGCTAACACAGTGAAACCCTGTCTCTACTAAAAAAATATATAAAAAATTAGCCGGGCTTGGTGGCGGGTGCCCGTAATCCCAGCTACTCGGGAGGCTGAGGCAGGAGAATGGCGTGAACCTGGAAGGCGGAGCTTGCAGTGAGCCGAGATTGCACCACTGCACTCCAGCCTGGGTGACAGAGTGAGACTCTGTCTCAAAAAAAAAAAAAAAACAAAAAACAAAAATTAGTTGGGTGTGGTGGTGGACGCCTGTAATCCCGGCTACTCGGGAGGCTGAGGCAGGAAAATCACTTCAACCCGGGAGGCAGAGGTTGCCGTGAGCCAAGATCGTGCCATTGCACTCCAGCCTGGGTGACAAGAGCAAAACTCTGTCTCAAAAAAAAA","GGCTGGGCGCAGTGGCTCACACCTGTAATCCCAGCACTTAGGGAAGCTGAGGCGAGTAGATCACCTGAGGTCAGGAGTTAGAGACCAGCCTGGCCATCATGGTGAAACCCCGTCTCTACTAAAGATACCAAAAATTAGCTGAGTGTGGTGCTGGGTGCCTGTAATCCCAGAAACTCAGGGTGCCTGTAATCCCAGCAACTCAGGGTGCCTTTAATCCCAGCAACTGAGGGTACCAGTAATCCCAGCAACTCAGGGTGTCTTTAATCCTAGCAACTGAGGGCACCTGTAATCCCAGCAACTCAGGAAGCTGAGACAGGAGAAGTACTTGAACCCAGAAGGCAGAGGTTGCAGTGAGCCGATATTGCACCATTGCACTCCAGTCTGGGCAACAAGAGTGAAACTCTGTCTCAAAAAAAAA"
"chr18","44546829","44547449","JH378118","18053084","18053501","262","26493745","GGCCAGGCACGGTCGCTCACACCTGTAATTCCAGCACTTTGGGAGGCCAAGGCGGATGGGTCACCTGAGGTCAGGAGTTTGAGACCAGCCTGACCAATATGATGAAACCCCATCTCTATTAAAAATACAAAAATTAGGCTGGGCGCAGTGGTTCATGCCTGTAATTCCAACACTTTGGGAGGCCGAGACGGGCGGACCATGAGGTCAGGAGATCGAGACCATCCTGGCCAACGTGGTGAAACCCCGTGTCTACTAAAATACAAAAAAAATTAGCCAGGTGTGGTGGCACGTGCCTGTAGTCCCAGCTATTAGGGAGGCTGAGGCAGGGGAATCACTTGAACCTGGGAGGTGGAGGTTGCAGTGAGCTGAGATCTTGCCACTACACTCCATTCTGGGCAACAGAGCAAGACTCCGTCTGAAAAAAAACAAAAAAATACAAAAATTAGCTGGGCATGGTGGCGGGTACCTGTAATCCCAGCTACTTGGGAGGCTGAGACAGGAGAATCACTTGAACTCGGGAGGCAGAGGTTGCAGTGAGCCAAGATCGCACCATTGCATTCCAGCCTGGGCAACAAGAGCGAAACTCCATCTCAAAAAAACAAAAAAAAAAAAAAAGAAAAA","GGCTGGGCGCAGTGGCTCACACCTGTAATCCCAGCACTTAGGGAAGCTGAGGCGAGTAGATCACCTGAGGTCAGGAGTTAGAGACCAGCCTGGCCATCATGGTGAAACCCCGTCTCTACTAAAGATACCAAAAATTAGCTGAGTGTGGTGCTGGGTGCCTGTAATCCCAGAAACTCAGGGTGCCTGTAATCCCAGCAACTCAGGGTGCCTTTAATCCCAGCAACTGAGGGTACCAGTAATCCCAGCAACTCAGGGTGTCTTTAATCCTAGCAACTGAGGGCACCTGTAATCCCAGCAACTCAGGAAGCTGAGACAGGAGAAGTACTTGAACCCAGAAGGCAGAGGTTGCAGTGAGCCGATATTGCACCATTGCACTCCAGTCTGGGCAACAAGAGTGAAACTCTGTCTCAAAAAAAAA"
"chr18","45772849","45773450","JH378118","18053084","18053501","269","27719765","CACGCCTATAATCCCAGCACTTTAGGAGGCTGAGGCAGGTGGATCACCTGAGATCAGGAGTTCAAAACCAGCCTGGCCAACATGGTGAAACCCTGTGTCTACTACAAATACAAAAAAATGGGCAGGGTGTGGTGGCTCACACCTGTAATCCCAGCACTTAGGGAGGCCGAGGCGGGTGGATCATGAGGTCAAGAGATCAAGACCATCCTGGCCAACATGGTAAAACCCCGCCTCTACTAAAAATATAAAAATTAGCTGGGCAAGGTGGTGCGCGCCTGTAGTCCCAGCTATTTGGGAGGCTGAGGCAGGAGAATTGCTTGAACCTGGGAGGTGGAGGTTGCAGTGAGCCAAAATCGCGCCACTGCACTCCAGCCTGGCAACAGAGTGAGACTCTGTCTCAAAAAAAAACAAAAACAAAACAAAACAGAAACCAAAATTAGCTGGGCGTGGTGGCGGGCGCCTGTAGTCCCAGCTACTTGGGAGGCTGAGGCAGGAGAATCGCATGAACCCAGGAGGCGGAGGTTGCAGTGAGCCAAGACTGCACTATTGCACTCCAGTCTGGGCTACAAGAGCGAACTCCGTCTCAAAAAAAAAAAAAAAAA","GGCTGGGCGCAGTGGCTCACACCTGTAATCCCAGCACTTAGGGAAGCTGAGGCGAGTAGATCACCTGAGGTCAGGAGTTAGAGACCAGCCTGGCCATCATGGTGAAACCCCGTCTCTACTAAAGATACCAAAAATTAGCTGAGTGTGGTGCTGGGTGCCTGTAATCCCAGAAACTCAGGGTGCCTGTAATCCCAGCAACTCAGGGTGCCTTTAATCCCAGCAACTGAGGGTACCAGTAATCCCAGCAACTCAGGGTGTCTTTAATCCTAGCAACTGAGGGCACCTGTAATCCCAGCAACTCAGGAAGCTGAGACAGGAGAAGTACTTGAACCCAGAAGGCAGAGGTTGCAGTGAGCCGATATTGCACCATTGCACTCCAGTCTGGGCAACAAGAGTGAAACTCTGTCTCAAAAAAAAA"
"chr18","50079974","50080314","JH378127","6796468","6796795","54","43283506","GGTCTGGCGCCAGTGGCTCATGCCTGTAATCCCAGCACTTTGGGAGGCTGAGGCGGGTGTATCACCTGAGGTCAGGAGTTCGAGACCAGCCTGGCCAACATGGCAAAACCCCGTCTCTACGAAAAATACAAAAAAATTAGCCGGGCGTGGTAGCAGTCGCCTGTAATCCCAGCAACTTGGGAAGCTGAGGCAGAAGAATCGCTTAAACCTAGGAGGCGGAGGTTGCAGTGAGCCAAGATTGCGCCATTGCACTCCAGCCTGGTCAACAAGAGCAAAACTCTGTCTCAAAACAACAACAACAACAACAACAACAACAAACAAAAACCAAAAAAACCAAAAAA","GGCCGGGCGCGGTGGCTCAAGCCTGTAATCCCAGCATTTTGGGAGGCCGAGGCGGGTGGATCACGAGGTCAGGAAATCGAGACCATCCTGGTCAACATGGCGAAACCCCATGTCTACTAAAAATACAAAAATTAGCTGGGCATGGTGGCACGTGCCTGTAATCCCAGCTACTCAGGAGGCTGAGGCAGGAGAATTGCCTGAACCCAGGAGGCGGAGCTTGCAGTGAGCCGAGATCGCGCCATTGCACTCCAGCCTGGGTAACAAGAGCGAAACTCCGTCTCAAAAAAACAAACAAAAACAAAACAAAACAAAACAAAACAAAAAAAAC"
"chr18","53653883","53654201","AGCE01149660","956","1264","46","53652927","GGCCAGGCATGGTGGCTCACGTTTGTAATCCTAGCACTTTGGGAGGCTGTAGCGGGCGGATCACCTGAGGTCAGGAGTTTGAGACCAGCCTGGCCAACATGGTGAAACCCTGTCTCTACTAAAAAAAAAAAAAAAAAAAAAAAAAAAATTAGCCAGGTGTGGTGGTGGTGGATGCCTATAATCCCAGCTACTCGGGAGGCTGAGGCAGGAGAATCACTTGAACCTGGGAAGCAGAGGTTGCAATGAGCTGAGATTGAGCCATTGCACTCCAGCCTGGACAACAAGAATGAGACTCTGTCTCAATAAATAAGTAAATAAA","GGCCAGGCACGGTGGCTCATGCCTATAATCCCAGCACTTTGGGAGGCTGCGATGGGTGGTTCACTTGAGGTCTGGAGTTTGAGACCAGCCTGGCCAACATGGAGAAACCCTTTCTCTACTAAAAATACAAAAAAAAAAAAAAAAAAAATTAGCCAGGCATGGTGGCGGGTGCCTGTAATCCCAGCTACTCAGCAGGCTGAGGGAAGAGAATCACTTGAACCGGGGAGGCAGAGGTTGCAGTGAGCTGAGATGATGCCATTGCACTCCAGCCTGGGCAACAAGAGCAAAACTGTCTCAAAAAAAAAAAAA"
"chr18","53971096","53971710","JH378118","18053084","18053501","262","35918012","GGTCGGGTGTGGTGGCTCATGCCTATAATCCCAGCACTTTGGGAGGCTGAGGCAGGCAGATTACCTGAGGTCAGGAGTTCGAGACCAGCCTGGCCAACATGATGAAACCTTGTCTCTACTAAAAATACAAAAATTAGGCCGGGCACGGTGGCTCATGCCTGTAATCCCAGCACTTTGGGAGGCCGAGGCGGGTAGATCACAAGGTCAGAAGTTCAAGACCAGCCTGGCCAACATGGTGAAACTCTGTCTTTACTAAAAATACAAAAATTAGCTAGGCATGGTGGCGCACACCTATAATCCCAGCTACTGGGGAGGCTGAGGCAGGAGAATTGCTTGAACCAGGACCCGGGAGGTGGAGGTTGCTGTGAGCCGAGATTGCGCCACTGCACTCCAGCCTGGGAGACAGAGTGAGACTCCGTCTAAAAAAAAAAAAAAAAAATTAGCCAGGTGTGGTGGCGCATGCCTGTAATCCCAGCTACTCGGGAGGCTGACGCAGAAGAATCATTTGAACGTGGGAGGCAGAGGTTACAATGAGCTGAGATCACACCATTGTACTCCAGCCTGGGCAACAAGAGCAAACTCAATCTCAAAAAAATAAAAATAAAAAAAAAGAAA","GGCTGGGCGCAGTGGCTCACACCTGTAATCCCAGCACTTAGGGAAGCTGAGGCGAGTAGATCACCTGAGGTCAGGAGTTAGAGACCAGCCTGGCCATCATGGTGAAACCCCGTCTCTACTAAAGATACCAAAAATTAGCTGAGTGTGGTGCTGGGTGCCTGTAATCCCAGAAACTCAGGGTGCCTGTAATCCCAGCAACTCAGGGTGCCTTTAATCCCAGCAACTGAGGGTACCAGTAATCCCAGCAACTCAGGGTGTCTTTAATCCTAGCAACTGAGGGCACCTGTAATCCCAGCAACTCAGGAAGCTGAGACAGGAGAAGTACTTGAACCCAGAAGGCAGAGGTTGCAGTGAGCCGATATTGCACCATTGCACTCCAGTCTGGGCAACAAGAGTGAAACTCTGTCTCAAAAAAAAA"
"chr18","57837437","57837748","JH378115","16887097","16887400","43","40950340","GCTGGGCATGGTGGCTCACACCTGTAATCCCAGCACCTTGGGAGGCCGAGGTGGGTAGATCACCTGAGGTCAGGAATTCGAGACCAACCTGGCCAACATGGTGAAACCCCGTCTCTACTAAAAATACAAAAAAAAAAAAAAAAAAAAAAAAAGCTGGGCATGGTGGTGGGTACCTGTAATCCCAGCTACTCAGGAGTCCGAGGCAGGAGAATCGCTTGAACCTGGCAGGTGGAGGTTGCAGTGTGCCAGGATTGTGCCATTGCACTCCAGCCTGGGTGACAAGAGCAAAACTCCAACTCAAAACAAAAACAA","GCCGGGCACGGTGGCTCAAGCCTGTAATCCCAGCACTTTGGGAGGCCGAGGCGGGTGGATCACAAGGTCAAGAGATCGAGACCAACCTGGTCAACATGGTGAAACCCCATCTCTACTAAAAAATACAAAAAAAAAAAAAAAATTAGCTGGGCATGGTGGCGCGTGCCTATAATCCCAGCTACTCAGGAGGCTGAGGCAGGAGAATTGCCTGAACCTAGGAGGTGGAGGTTGCAGTGAGCCAAGATCATGCCATTGCACTCCAGCCTGGGTAACAAGAGCGAAACTCCATCTCAAAAAAAAAAAA"
"chr18","58257354","58257943","JH378118","18053084","18053501","263","40204270","GCCTGTAATCACAGCACTTAGGGGGGCCGAGGCAGGAGGATCACCTGAGGTCAGGAGTTCGAGACCAGCCTGGCCAACATGGTGAAACCCCGTCCCTACTAAAAATACAAAAATTGGCCGGACACATTGGCTCATGCCTGTAATCCCAGCACTTTGGGAGGCCGAGGCGGGTGGATCACCTGAGGTCAGGAGTTCAAGACCAGCCTGACCAACCTGGAGAAACCCTGTTTCTACTAAAAATACAAAATTAGCCAGGCATAGTGGCGCATGCCTGTAATCCCAGCTACTCGAGAGGCTGAGGCAGGAGAATCGCTTGAACCCGGAAGGTGGAGGTTGCGGTGAACCGAGATTGTGCCATTGCACTCCAGCCTGGGCAACAAGAGCAAAACTCCGTCTCAAAAACAAAACAAAACAAAACAAAAATTAACCCGGCGTGGAGGTGGATGCCTGTAATCCCAGCCACTTTGGGAGACTGAGGCAAGAGAATTGCTTGAACCCGGGATGTGGAGGCTGCAGTGACCCGAGATCACGCCATTGCATTCCAGCCTGGCAACAAGAGTAAGACTCCATCTCAAAAACAAGCAAACAAA","GGCTGGGCGCAGTGGCTCACACCTGTAATCCCAGCACTTAGGGAAGCTGAGGCGAGTAGATCACCTGAGGTCAGGAGTTAGAGACCAGCCTGGCCATCATGGTGAAACCCCGTCTCTACTAAAGATACCAAAAATTAGCTGAGTGTGGTGCTGGGTGCCTGTAATCCCAGAAACTCAGGGTGCCTGTAATCCCAGCAACTCAGGGTGCCTTTAATCCCAGCAACTGAGGGTACCAGTAATCCCAGCAACTCAGGGTGTCTTTAATCCTAGCAACTGAGGGCACCTGTAATCCCAGCAACTCAGGAAGCTGAGACAGGAGAAGTACTTGAACCCAGAAGGCAGAGGTTGCAGTGAGCCGATATTGCACCATTGCACTCCAGTCTGGGCAACAAGAGTGAAACTCTGTCTCAAAAAAAAA"
"chr18","59255477","59255805","JH378228","5665092","5665424","52","53590385","GGTTGGGCGCAGTGGCTCACGCCTGTAACCCCAGCACTTTCGGAAGCTGAGGCAGGCGGATCACCTGAGGTCAGGGGTTCGAGACCAGCCCGGACAACGTGATTAAACCCTGCCTCTACTAAAAATACAAAAATTAGCGACTGTGGTGTTGGGCGCCTGTAATCGCAGCTACTTGGGAGGCTGAGGCATGAGAATTGCTTGAACCCAGGAGGCAGAGGTTGCAGTGAGCAGAGATTGCTCCATTGCACTCCAGCCTGGGCAACAAGAGCAGAACTCTGTCTCAAAATAAATAAATAAATAAATAAATAAATAAATAACAGAAAAGAAAA","GGCCGGGCGCGGTGGCTCAAGCCTGTAATCCCAGCACTTTGGGAGGCTGAGGCGGGTGGATCACGAGGTCAAGAGATCGAGACCATCCTGGTCAACATGGTGAAACCCTGTCTCTACTAAAAATACTAAAAATTAGCTGGGCATGGTGGCGTGTGCCTGTAATCCCAGCTACTCAGGAGGCTGAGGCAGGAGAATTGCCTGAACCCAGGAGGCGGAGGTTGCGGTGAGCCGAGATCGCGCCATTGCACTCCAGCCTGGGCAACAAGAGCGAAACTCTGTCTCAAAAAAAAAAAATAAATAAATAAAATAAAATAAAATAAAATAAAATAAAAT"
"chr18","59405673","59406877","JH378118","18053084","18053501","805","41352589","GGCTAGATGCGGTGGCTCATGCCTGTAATCCCAGCACTTTGGGAGGCCAAGGCAGGTGGATCACCTGAGGTCAGGAGTTTGACACCAGCCTGGCCAACATGTTGAAACCCTGTCTCCACTAAAAATACAAAAAAAGATTATCTGGGTTATTGTGGGATCTGGCCAGCAGCCCGCAATGCAATGGGGCTCTCTCTTTGTTCCCAGGCAGATTGGCAGGTTGAGAAATAATAGACACACACAAGATAGTGAAAGTTGGGTCCAGGGGGGTCACCGCCTTCTGGTCCCATGGTGCCAACAATGCACTGGATATACCAGCATTTATTATTAAGTTTAGTGAGGGCGGGGGTAGGTTAGTGAGGGATTTAGGGTCATTTGATTATGAGGTGAGATGGTCACATGGAAATGAAGTAATTCTTTAACGTAACATTTGTATGTAGAAGTACAGTACATTTGTATGTAGAAGTACAGTATACAGAGATAAGAATTTACAATATAGTGTGTGCATCAGTAATTTCTAACAGAGCCTTAAAACAGAAAGACAATCTTTCCATAATCTATGATTAGCAAGATATTAATCAGCAGTAACAATTGCAATGAAAGCTGGTTACAAACAGTCCATGGAAACAGGAGGTGAAGCTAGACAATCGGTTAGACCAGAAATTCTCAGAAGGGAATATGCCTTAACCCTAAAGAGGCCTAGAAGAGCCGTGGCAAGATGAGGGTGTTTATAGCCCTATCTTATCCATATGGACAGGCACCTCCCCATGCGTCCGTTTATAGGCTCTCCATGAGGGTCGCATTCCATTCCCAGAGCTATGAACATCTGCTTTTCTGGGATAGGAATCTTGGTGATGTGAAACCTCCCTGACTACACGTCCATTCATAGGATCTCTGCAGGGGGAAGCACATCACACACTGTTGGCTCGTTCTGGCAGTCCAACCTGGCATTGTGTCTTTACACAATCCTGCATGCAATTTTGTATTTACAATAATCAGGAGCATTTCATCTTTTATTCTGTAGCAATAGTTTCAGGGGGTCTCCCTACACTGGGTGTGGTGACGGGTACCTGTAATCCCAGCTACTCAGGAGGCTGAGGCAGGAGAATCACTTGAGCCTTAGAGGCAGAGGTTGCAGTGAGCTGAGATCAGACCATTGCACTCCAGCCTGGGCAACAAGAGCAAACCTCCGTCTCAAAAAAAAAAAA","GGCTGGGCGCAGTGGCTCACACCTGTAATCCCAGCACTTAGGGAAGCTGAGGCGAGTAGATCACCTGAGGTCAGGAGTTAGAGACCAGCCTGGCCATCATGGTGAAACCCCGTCTCTACTAAAGATACCAAAAATTAGCTGAGTGTGGTGCTGGGTGCCTGTAATCCCAGAAACTCAGGGTGCCTGTAATCCCAGCAACTCAGGGTGCCTTTAATCCCAGCAACTGAGGGTACCAGTAATCCCAGCAACTCAGGGTGTCTTTAATCCTAGCAACTGAGGGCACCTGTAATCCCAGCAACTCAGGAAGCTGAGACAGGAGAAGTACTTGAACCCAGAAGGCAGAGGTTGCAGTGAGCCGATATTGCACCATTGCACTCCAGTCTGGGCAACAAGAGTGAAACTCTGTCTCAAAAAAAAA"
"chr18","71500430","71500770","JH378228","5665092","5665424","54","65835338","GCTGGGTGCGGTGGCTCACGCCTGTAATCACAGCACTTTGGTAAGCCCGAGGCAGGTGGATCACCTGAGGTCAGGAGTTCGAGACCAGCCTGACCAACATGGTGAAACCCTTTCTCTACTAAAAATGCAAAAATTAGCTGGGCGTCATGGCGGGCGTCTGTGATCCCAGCTACTAGGGAGGCTAAGGCAGGAGAATTGCTTGAACCTGGGAGGCGGAGGTTGCAGTGAGCAGAGATTGCACCATTACACTCCAGCCTGGGCAACAAGAGCAAAACTCCATCTCAAAATAAATAAATAACTAAATAAATAAATAAAATGAAATTAAAAAGAAAGAAAGAAAA","GGCCGGGCGCGGTGGCTCAAGCCTGTAATCCCAGCACTTTGGGAGGCTGAGGCGGGTGGATCACGAGGTCAAGAGATCGAGACCATCCTGGTCAACATGGTGAAACCCTGTCTCTACTAAAAATACTAAAAATTAGCTGGGCATGGTGGCGTGTGCCTGTAATCCCAGCTACTCAGGAGGCTGAGGCAGGAGAATTGCCTGAACCCAGGAGGCGGAGGTTGCGGTGAGCCGAGATCGCGCCATTGCACTCCAGCCTGGGCAACAAGAGCGAAACTCTGTCTCAAAAAAAAAAAATAAATAAATAAAATAAAATAAAATAAAATAAAATAAAAT"
"chr19","1465612","1466244","JH378118","18053084","18053501","284","16587472","GGCTGGGGACGGTGGCTCAGGCCTGTAACCCCAGCACTTTGAGAGGACCAGGAGGGAGGATTGCTTGAGCCCAGGAGTCCGAGACCAGCCTGGGCAGCAAAGCAAGGCCCTGTCTCTACAAAAATACTTTAAAATTAGCCAAGTGTTGGCTGGGTGCGGTTGCTCATGCCTATAATCCCAGCACTTTGGGAGGCCGAGGTGGGTGGATCACCTGAGGTCAGGAGTTTGAGACCAGCCTGGCCAACATGGCAAAACCCCGTCTCTACTAAAAATACGAAAATTAGCCAGACGTGGTGGCTCATTCCTGTAATCCCAGCTACTCGGGAGGCTGAGGCAGGAGAATCGCTTGAACTCGCAAGGCGGAGGTTGCAGTGAGCCAAGATCATGCCATTGCATTCCAGCCTGGGTGACAGAGCAAAACTCCGTCTCAAAAAAAAAAAAAAAAAAAAAAAATTAGCCAGGCGTGGTGGTGGGCACCTGTAGTCCCAGCTACCCGGGAGGCTGAGGCAGGAGAATCGCTTGAGCCCGGGAGGCAGAGGTTACAGTGAGCCGAGATCGTGCCATTGCACTCCAGCCTGGGCAACAAGAGTGAAAATCCGTCTCAAAAAAATAAATAAATACAAAATAAAAAAA","GGCTGGGCGCAGTGGCTCACACCTGTAATCCCAGCACTTAGGGAAGCTGAGGCGAGTAGATCACCTGAGGTCAGGAGTTAGAGACCAGCCTGGCCATCATGGTGAAACCCCGTCTCTACTAAAGATACCAAAAATTAGCTGAGTGTGGTGCTGGGTGCCTGTAATCCCAGAAACTCAGGGTGCCTGTAATCCCAGCAACTCAGGGTGCCTTTAATCCCAGCAACTGAGGGTACCAGTAATCCCAGCAACTCAGGGTGTCTTTAATCCTAGCAACTGAGGGCACCTGTAATCCCAGCAACTCAGGAAGCTGAGACAGGAGAAGTACTTGAACCCAGAAGGCAGAGGTTGCAGTGAGCCGATATTGCACCATTGCACTCCAGTCTGGGCAACAAGAGTGAAACTCTGTCTCAAAAAAAAA"
"chr19","1761610","1762212","JH378118","18053084","18053501","248","16291474","GGCCGGGTGCGGTGGTTTACACCTGTAATCCTGGCATTTTGGGAGGCCGAGGCAGGAGTATCACCTCAGGTCAGGAGTTCAAGACCAGCCTGGCCAACATGGTGATACTCCGTCTCTACTAAAAATACAAAAATTGGCCGAGTGCAGTGGCTCACACCTGTAATCCCAGCACTTTGGGAGGCCGAGGCAGGTGGATCATGAGGTCAGGAGTTCGAGACCAGCCTGGCCAAGATGGTGAAACCCCGTCTCTACTAAAAATACAAAAATCAGCTGGGTGTGGTGGCGGGTGCCTGTAATCCCAGCTACTCGGGAGGCTGAGGCAGGAGAATTGCTTGGACCTGGGCAGCAGAGGTTGCAGCGAGCTGAGATGGCGCCACTGCACTCCAGCCTGGGCGACAGAGCGAGACTCTTGTCTCAGAAAAATAAAAAATAAAAAAATTAGCTGGGTGTGGTGGTGCGCACCTGTAATCCCAGCTACTCGGGAGGCTGAGGCAGGAGAATCGCTTGAATCTGGGAGGAGGAGGAGGTTGCAGTGAGCTGAGATAGTGCCAGTGCAGGCCAGCCTGGTCAACAAGAGTGAAACTCCGTCTCAGAAAAAAAAAA","GGCTGGGCGCAGTGGCTCACACCTGTAATCCCAGCACTTAGGGAAGCTGAGGCGAGTAGATCACCTGAGGTCAGGAGTTAGAGACCAGCCTGGCCATCATGGTGAAACCCCGTCTCTACTAAAGATACCAAAAATTAGCTGAGTGTGGTGCTGGGTGCCTGTAATCCCAGAAACTCAGGGTGCCTGTAATCCCAGCAACTCAGGGTGCCTTTAATCCCAGCAACTGAGGGTACCAGTAATCCCAGCAACTCAGGGTGTCTTTAATCCTAGCAACTGAGGGCACCTGTAATCCCAGCAACTCAGGAAGCTGAGACAGGAGAAGTACTTGAACCCAGAAGGCAGAGGTTGCAGTGAGCCGATATTGCACCATTGCACTCCAGTCTGGGCAACAAGAGTGAAACTCTGTCTCAAAAAAAAA"
"chr19","2871458","2872098","JH378118","18053084","18053501","282","15181626","GGCCGGGCGCGGTGGCTCACGCTTGTAATCCCAGCACTTTGGGAGGCCTAGGTAGTGGATCACCTGAGGTCAGGAGTTTGAGACCAGCCTGGCCAACATGGGGAAACCCAGTCTCTACTAAAAATACAAAAATGAGGCCGGGTGCAGTGGCTCATGCCTGTAGTCTCAACACTTTGGGAGACCAAGGCAGGCGGATCACCTGAGGTCAGGAGTTCAAGCCCAACCTGGCCAACATGGTGAAACCCTGCCTCTTCTAAAAATACAAAAATTAGCCAGGTGTGGTGGCATGTACCTGCAATCCCAGCTGCTTAGGAGTTCGAGATAGAAGGATTGCCTGAACCTGGGAGGCGGAGGTTGCAGTGAGCTGAGATCATGCCATTGCACTCCAGCCTGGGTGACAGAGACCCTGTCTCACACACACACACACAAATTATATATATATATATATATATACACACACACACACACGCACACACAAATTGGCCAGGCGTGGTGGCGGGTGCCTATAATTCCAGCTACTTGGGAGGCTGAGGCAGGAGAATGTCTTGAACCCGGGAGGTGGAGGTTGCAGTGAGCCGAGATTGCGCCACTGCACTTTAGCCTGGACGACAAGAACAAAACTCCATCTCAAAAAAACGAAA","GGCTGGGCGCAGTGGCTCACACCTGTAATCCCAGCACTTAGGGAAGCTGAGGCGAGTAGATCACCTGAGGTCAGGAGTTAGAGACCAGCCTGGCCATCATGGTGAAACCCCGTCTCTACTAAAGATACCAAAAATTAGCTGAGTGTGGTGCTGGGTGCCTGTAATCCCAGAAACTCAGGGTGCCTGTAATCCCAGCAACTCAGGGTGCCTTTAATCCCAGCAACTGAGGGTACCAGTAATCCCAGCAACTCAGGGTGTCTTTAATCCTAGCAACTGAGGGCACCTGTAATCCCAGCAACTCAGGAAGCTGAGACAGGAGAAGTACTTGAACCCAGAAGGCAGAGGTTGCAGTGAGCCGATATTGCACCATTGCACTCCAGTCTGGGCAACAAGAGTGAAACTCTGTCTCAAAAAAAAA"
"chr19","2912949","2913566","JH378118","18053084","18053501","268","15140135","GGCTGGGCGTGGTGGCTCACACCTGTAATCCCAGCACTTTGGGAGGCCAAGGTGGAGGGACTGCCTGAAGCCAGGGGTTCGAGACCAGCCTGGCCAACATGGTGAAACCCTGTCTCTACTAAAAATAGAAAAATTAAGGCCGGGCGCGGTGGCTCATGCCTGTAATCCCAGCACTTTGGAAGGCCGAGGCGGGCGGATCACTTGAGGTCGGGAGTTCAAGACCAGCCTGACCAACATGGAGAAACCCTGTCTCTACTAAAAATACAAAATTAGCCAGGGTGGTGGCGCATGCCTGTAATCCCAGCTACTTGGGAGGCTGAGGCAGGAGAATCGCTTGAACCCGGGAGGTGGAGGTTGCAGTGAGCTGAGATCGCACCATTGCACTCCAGCCTGGGCAACAAGAGCAAAACCACGTCTCAAAAAAAATAAAAATAAAAATAAAAAAATTAGCTGGGTGTGGTGGCAGGCGCCTGTAGCTGCTTGGGAGGCTGAGACAGGAGAATTGCTTGAACCTGGGAGGCGGAGGTTGCAGTGAGCTGAGACCGTGCCATTGCACTCCAGGCTGGGCAAGAAGAGCAAAACTCTATCCTTCCCCCACTCCAAAAAAAAAAAAAAAAA","GGCTGGGCGCAGTGGCTCACACCTGTAATCCCAGCACTTAGGGAAGCTGAGGCGAGTAGATCACCTGAGGTCAGGAGTTAGAGACCAGCCTGGCCATCATGGTGAAACCCCGTCTCTACTAAAGATACCAAAAATTAGCTGAGTGTGGTGCTGGGTGCCTGTAATCCCAGAAACTCAGGGTGCCTGTAATCCCAGCAACTCAGGGTGCCTTTAATCCCAGCAACTGAGGGTACCAGTAATCCCAGCAACTCAGGGTGTCTTTAATCCTAGCAACTGAGGGCACCTGTAATCCCAGCAACTCAGGAAGCTGAGACAGGAGAAGTACTTGAACCCAGAAGGCAGAGGTTGCAGTGAGCCGATATTGCACCATTGCACTCCAGTCTGGGCAACAAGAGTGAAACTCTGTCTCAAAAAAAAA"
"chr19","3601333","3601668","JH378148","10302642","10302970","47","6701309","GCTGGGCGTGGTGGCTCACACCTGTAATCCCAGCACTTTGGGAGGCTGAGGTGGGCGGATCACGTGAGGTCAGGAGTTCCAGACTAGCCTGGCCAACATGGGGAAACCCCATCTCTGCTAAAAATAAAAAATTTAGCCGAGTGTGGTGGTGGGTGCCTGTAATCCCAGCTACTCAGGAGGCCGAGGCAGGAGAATTGCTTGAACCCAGGAGGCAGAGGTTGCAGTGAGCCGAGATCACGCCATTGCACTCCAGCCTGGATGACAACAGTGAGACTCCAACTCAAAAAATAATAATAATAATAATAATAATAATAAAATAAAACAATAAAAAAAAAA","GGCCGGGCGCGGTGGCTCAAGCCTGTAATCCCAGCACTTTGGGAGGCCGAGGCGGGTGGATCACGAGGTCAAGAGATCGAGACCATCCTGGTCAACATGGTGAAACCCCGTCTCTACTAAAAATACAAAAAATTAGCTGGGCATGGTGGTGGGTGCCTGTAATCCCAGCTACTCAGGAGGCTGAGGCAGGAGAATTGCCTGAACCCAGGAGGCGGAGGTTGCGGTGAGCCGAGATCGCGCCATTGCACTCCAGCCTGGGTAACAAGAGTGAAACTCTGCCTCAAAAAAAAAAAATAAAATAAAATAAAATAAAATAAAATAAAATAAAA"
"chr19","4440800","4441421","JH378118","18053084","18053501","276","13612284","GGCTGGGTGCGGTGGCTCATGCCTGTAATCCCAGCACTTTGGGAGGCCAAGCGGGCAGATCAACTGAGGTCAGGAGTTCGAGACCAGCCTGGCCAACATAGTAAAACCCTGTTTCTACTAAAAAAAAAAAAAAAAAAAAAAAAAAAATTGGCTGGGCGCAGTGGCTCACGCATGTAATCCCTGCACTTTGGGAGGCCAAGGCAGGTGGATCACCTGAGGTCAGTAGTTTGAGACCAGCCTGACCAACGTGGAGAAACCCCATCTCTACTAAAAATACAAACAAAAAAAACAAAAAACAAAAAAAACCGGGTATGGTGGTACATCCCTGTAATCCCAGCTCCTCGGGAGGCTGAGGCAGGAGAATCACTTGAACCCGGGAGGCGGAGGTTGCACTGAGCCGAGATTGCGCCACTGCACTCCAGCCTGGGCGATAGAGCGAGACTCCCTCTTAAATAATGATTATAATTGCCAGGTGTGGTGGCGGGTGCCTGTAATCCCAGCTACTTGGGAGGCTGAGGCAGGAGAATCGTTTGAATCCAGGAGGAGGAGGTTGCAGTGAGCCGAGATGGTGCCACAGCACTCCAGCCTGGGTGACAAGAGTGAAACCCCATTACAAACAAAA","GGCTGGGCGCAGTGGCTCACACCTGTAATCCCAGCACTTAGGGAAGCTGAGGCGAGTAGATCACCTGAGGTCAGGAGTTAGAGACCAGCCTGGCCATCATGGTGAAACCCCGTCTCTACTAAAGATACCAAAAATTAGCTGAGTGTGGTGCTGGGTGCCTGTAATCCCAGAAACTCAGGGTGCCTGTAATCCCAGCAACTCAGGGTGCCTTTAATCCCAGCAACTGAGGGTACCAGTAATCCCAGCAACTCAGGGTGTCTTTAATCCTAGCAACTGAGGGCACCTGTAATCCCAGCAACTCAGGAAGCTGAGACAGGAGAAGTACTTGAACCCAGAAGGCAGAGGTTGCAGTGAGCCGATATTGCACCATTGCACTCCAGTCTGGGCAACAAGAGTGAAACTCTGTCTCAAAAAAAAA"
"chr19","5462237","5462567","JH378255","1377129","1377437","56","4085108","GACCAGGTGCGGTGGCTCACGCCTGTCATTCCAGCACTTTGGGAGGCCGAGGGGGGCGTGGATCACTTGAGGTCAGGAGTTCAAGACCAGCCTGACCAACATGGTGAAACTCCGTCTCTACTAAAAATACAAAAATTAGCCAGGTGTGGTGGCACATGCCTGTAATCCCAGCTACTTGGGAGGCTGAGGCAGGAGAATCACTTGAACCTGGGAGATGGAGGTTTCATTCAGTGAGCTGAGATTGCACCATTGCACTCCAGCCTGGGTGACAAGAACGAAACTCTGTCTCAGAACACACACACACACACACACACACACACCCCAGAAAAAA","GGCCTGGCGTGGTGGCTCACGCCTGTAATCTCAGCACTTTGGGAGGCCAAGGTGGGTGGATCACCTGAGGTCAGGAGTTCAAGACCAGCCTGGCCAACATGGTGAAACCCCGTCTCTACTAAAAATACAAAAATTAGCTGGGTGTGGTGGCAGACACCTGTAATTCCAGCTACTTGGGAGGCTGAGGCAGGAGAATAGCTTGAACCTGGGAGGTGAGGGTTGCAGTGAGCCGAGATCGCACCATTTTACTCCAACCTGGGCAACAAGAGCGAAACTCCGTCTCAAAATCCAAACAAACCAAAACAAAAA"
"chr19","8011731","8012413","JH378118","18053084","18053501","321","10041353","GGCCGGGTACAGTGGCTCACTCCTGTAATCCCAGAACTTTGGGAGACCGAGGTGGGGGGATCACTTGAGGTCAGGAGTTCGAGACCACCCTGGCCAATATAGTGCTAAACCCCATCTCTACTCAAAATACAAAAAAAAAAAAAAAAAAAAAAAAAAAGCAAAACCCAGGCTGGGCACAGTAGCTCATACCTGTAATCCCAGCACTTTGGGAGGCTGAGGTGGGTAGATCATGAGGTCAGGAGTTCGAGACCAGCCTGACCAACATGGTGAAACCCCGTCTCTACTAAAAATACAAAAATTAGCCGGGCATGGTGGTGCGTGCCTGTAATCCCAGCTACTCAGGAGGCTGAGGCAGGAGAATCGCTTGAAGCTGGGAGGCAGAGGTTGCAGTGAGCCGAGATCGTGCTACTGTACTCCAGCCTGGGCAACAGGGCGACAGAGCAAGACTCTGTCTCAAAAAAAAAAAAAAAAAAAAAAAAAAGCAAAACCCCATCTCTACTAAAAATACAAAAAATTAGCCAGGCATGGTGGCATGTGCCTGTAATCCCAGCTACTCGAGAGGCTGAGGCAGAAGAATCACTTGAACCCAGGAGGCAGAGGTTGCAGCGAGCCAAGATTGTGCCATTGCACTCCAATCTGGGTGACAAGAGTAAAATCCTGTCTCAAAAAAATAAAAAATAAAA","GGCTGGGCGCAGTGGCTCACACCTGTAATCCCAGCACTTAGGGAAGCTGAGGCGAGTAGATCACCTGAGGTCAGGAGTTAGAGACCAGCCTGGCCATCATGGTGAAACCCCGTCTCTACTAAAGATACCAAAAATTAGCTGAGTGTGGTGCTGGGTGCCTGTAATCCCAGAAACTCAGGGTGCCTGTAATCCCAGCAACTCAGGGTGCCTTTAATCCCAGCAACTGAGGGTACCAGTAATCCCAGCAACTCAGGGTGTCTTTAATCCTAGCAACTGAGGGCACCTGTAATCCCAGCAACTCAGGAAGCTGAGACAGGAGAAGTACTTGAACCCAGAAGGCAGAGGTTGCAGTGAGCCGATATTGCACCATTGCACTCCAGTCTGGGCAACAAGAGTGAAACTCTGTCTCAAAAAAAAA"
"chr19","8026835","8027736","JH378118","18053084","18053501","522","10026249","GCGCGGTGGCTCATGCCTGTAAACCCAGCACTTTGGGAGGCTGAGGTGGGTGGATCACCTGAGGTCAGGAGTTTGAGACCAGCCTGGCCAATATGGTGAAACCCGTCTCTACTAAAACATACAAAAATTAGGCTGGGCGCGGTGGCTCATGCCTTTAATCCCAACACTTTGGGAGGCCGAGGCGGGCGGATCACGAGGTCAGGAGTTTGAGACCATCCTGGCTAACATGGTGAAAGCCCGTCTCTACTAAAAATATAAAAATTAGCTGGGCGTGGTGGTGGGCACCTGGAGTCCCAGCTACTTGGGAGGCTGAGGCAGGAGAATGGCGTGAACCCGGGAGGCGGAGCTTGCAGTGAGCCAGGATCACGCCACTGCACTCCAGCCTGGGCGACAGAGCGAGACACCGTCTCAAAAAAAAAACAACAAAAATTAGCCAGGCATGGTGGTGGGCGCCTTTTTTTTTTTTTTTTTCAGAGTCTCACTCTGTCACCCAGGCTGGAGTGCAGTGGCTCAATCTCGGTTCACTGCAACCTCCGCCTCCCAGGTTCAAGCGATTCTCCTGCCTCAGCCTCCCGAATAACTGGGATTACAGGCACCCGCCACTACAACCAGCTAATTTTTGTATTTTTAGTAGAGATGGGGTTTCGCCATGTTGGCCAGGATGGTCTTGATCTCTTGACCTCGTGATCCACCCTCCTTGGCCTCTCAAAGTGCTGGGATTACAGGTGTGAGCCACTGTTCCCAGCTGATAGTGGGCACTTTTAATCCCAGCTACTCCGGAGGCTGAGGCAGGAGAATTGCTTGAACCCAGGAGGTGGAGGTTGCAGTGAGCCAAGATCGCGCCATTGCACTCCAGCCTGGGTGACAATAGCAAAACTCTGTCTCAATGAAACAAAACAAAA","GGCTGGGCGCAGTGGCTCACACCTGTAATCCCAGCACTTAGGGAAGCTGAGGCGAGTAGATCACCTGAGGTCAGGAGTTAGAGACCAGCCTGGCCATCATGGTGAAACCCCGTCTCTACTAAAGATACCAAAAATTAGCTGAGTGTGGTGCTGGGTGCCTGTAATCCCAGAAACTCAGGGTGCCTGTAATCCCAGCAACTCAGGGTGCCTTTAATCCCAGCAACTGAGGGTACCAGTAATCCCAGCAACTCAGGGTGTCTTTAATCCTAGCAACTGAGGGCACCTGTAATCCCAGCAACTCAGGAAGCTGAGACAGGAGAAGTACTTGAACCCAGAAGGCAGAGGTTGCAGTGAGCCGATATTGCACCATTGCACTCCAGTCTGGGCAACAAGAGTGAAACTCTGTCTCAAAAAAAAA"
"chr19","9069244","9069863","JH378118","18053084","18053501","266","8983840","GGCCGGGCACGGTGGCTCATTCCTGTAGTCTCTGTACTTTAGGAGGCTGAGGTGGGTGGATCACTTGAGGTCAGGAGTTCCAGACCAGTCTGGCCAAAATGGTGAAACCCCGTCTGTACTAAAAATACAAAAAAAAAGGCCGGGCGCGGTGGCTCACGCCTGTAATCCCAGCACTTTGGGAGGCTGAGGTGGGTGGATCACAAGGTCAGGAGATTGAGACCATCCTGGCTAACATGGTGAAACCCCGTCTCTACTAAAAATACAAAAAATTAGCTGAGTGTGGTAGCAGGCACCTGTAATCCCAGCTACTCAGGAGGCTGAGGTGGGAGAATGGCATGAACCCAGGAAGCAGAGCTTGCAGTGAGCTGAGATCATGCCACTGCACTCCAGCCTGGGTGACAGAGCGAGACTCCATCTCAAAAAAAAAAAATACAAAAAAATTAGCCAGGCGTAGTGGTGCATGCTTGTAGTCTCGGCTACTCAGGAGACTGACGCAGGAGAATCACTTGAACCCAGGAGGCGGAGGTTGCAGTGAGCCGAAATTATGCCATTGCACTCCAGCCTGGGAGACAAGAACAAAACTCTATCTCAAAAACCAACCAACCAAACAAACAAAAAAA","GGCTGGGCGCAGTGGCTCACACCTGTAATCCCAGCACTTAGGGAAGCTGAGGCGAGTAGATCACCTGAGGTCAGGAGTTAGAGACCAGCCTGGCCATCATGGTGAAACCCCGTCTCTACTAAAGATACCAAAAATTAGCTGAGTGTGGTGCTGGGTGCCTGTAATCCCAGAAACTCAGGGTGCCTGTAATCCCAGCAACTCAGGGTGCCTTTAATCCCAGCAACTGAGGGTACCAGTAATCCCAGCAACTCAGGGTGTCTTTAATCCTAGCAACTGAGGGCACCTGTAATCCCAGCAACTCAGGAAGCTGAGACAGGAGAAGTACTTGAACCCAGAAGGCAGAGGTTGCAGTGAGCCGATATTGCACCATTGCACTCCAGTCTGGGCAACAAGAGTGAAACTCTGTCTCAAAAAAAAA"
"chr19","9785992","9786608","JH378118","18053084","18053501","261","8267092","GGCCGGGAACGGTGGCTCACACCTATAATCCCAGCACTTTGGGAGGCCGAGGCAGGTGGATCACCTGAGGTCAGGAGTTCAAGACCAGCGTGGCCAACATAATGAAACCCCATCTTGGCCGGGTGCGGTGACTCACGCCTGTAATCCCAGCACTTTGGGAGGCCAAGGCGGGTGGATCACGAGGTCAGGGGATCGAGACCATCCTGGCTAACACAGTGAAACCCTGTCTCTACTAAAAATACAAAAAAATTAGCTGGGCATGGTGGCGGACGCCTGTAGTCCCAGCTACTCGGGAGGCTGAGGCAGGAGAATGGTGTGAACCTGGGAGGCAGAGCTTGCAGTGAGCCGAGATTGCGCCACTGCACTCCAGCTTGGGTGACAAAGTGAGACTCCATCTCAAAAAAAAAAAAAGAAACCCCATCTCTACTAAAAATACAAAAAATTTGCTGGGTGTGGTTGTGGGCACCTGTAATCCCAGCTACTTGGGAGGCTGAGGCAGGAGAATCACCTGAACCCAGGAGGCAGAGGTTGCAGTGAGCCGAAACAGTGCCATTGCACTCCAGCCTGGGCAACAAGAGTGAAACTCAATCTCAAAAAAAAAAAAAAAAGTACAAAAA","GGCTGGGCGCAGTGGCTCACACCTGTAATCCCAGCACTTAGGGAAGCTGAGGCGAGTAGATCACCTGAGGTCAGGAGTTAGAGACCAGCCTGGCCATCATGGTGAAACCCCGTCTCTACTAAAGATACCAAAAATTAGCTGAGTGTGGTGCTGGGTGCCTGTAATCCCAGAAACTCAGGGTGCCTGTAATCCCAGCAACTCAGGGTGCCTTTAATCCCAGCAACTGAGGGTACCAGTAATCCCAGCAACTCAGGGTGTCTTTAATCCTAGCAACTGAGGGCACCTGTAATCCCAGCAACTCAGGAAGCTGAGACAGGAGAAGTACTTGAACCCAGAAGGCAGAGGTTGCAGTGAGCCGATATTGCACCATTGCACTCCAGTCTGGGCAACAAGAGTGAAACTCTGTCTCAAAAAAAAA"
"chr19","9897689","9898264","JH378206","6546474","6546861","233","3351215","GCCAGGCACGGTGGCTCACACCTGTAATCCCAGCACTTTGGGAGGCCAAGGTGGGTGGATCACCTGAGGTCAGGAGTTCAAGACCAGCCTGACCAACATGGTGAAACCCAGGGCTCACACCTGTAATCCCAGCGCTTTGGGAGGCTGACGCGGGCAGATCACGAGGTCAGGAGATCGAGACCATCCTGGCTAACATGGTGAAACCCCGTCTCTACTAAAAATACAATAATTAGCTGGGCATGGTGGTGGGTGCCTGCAGTCCCAGCTACTTGGGAAGCTGAGGCAGGAGAATGGCGTGAACCCAGGAGGTGGAGCTCTCAGTGAGCTGAGATTGCATCACTGCACTTCCAGCCTGGGTGACAGAGCAAGACTCTGTCTCAAAAAAAAAAAAAAAAAAAAAAAAAATTAGCCAGGTGTGATGGCAGGCACCTGTAATCCCAGCTACTTAGGAGGCTGAGGCAGGAGAACCCAGGAGGCAGAGGTTGCAGTGAGCCAAGATCGCGCCATTGCACTCCAGCCTGGGTGACAAGAGCAAAATTCCATCTCAAAAAAAAAAAAAAAGAAGAAAAAGAAGAA","GGCCACACATGGTGGCTAACGCCTGTAATCCCAGCACTTTGGGAGGCCAAGTCGGGTGGATCATGAGGTCAGGAGACCAAGACCATCCTGGCCAAATGGTGAAACCCCGTCTCTACTAAAAATACAAAAATTAGCTGGGCATGGTGGCGTGTGCCTGTAATCCCAGCTACTCAGGAGGCTGAGGCAGGACAATTGCCTGAACCCAGGAGAATTAGCTGGGCATGGTGGCGTGTGCCTGTAATCCCAGCTACTCAGGAGGCTGAGGCAGGACAATTGCCTGAACCCAGGAGGCGAAGGTTGCGGTGAGCCGAGATTGTGCCATTGCACTCCAGCCTGGGTAACAAGAGCGACACTCTGTCTCAAAAAAAAAAAAAAAAAAAAAAAAAAA"
"chr19","10210761","10211695","JH378118","18053084","18053501","553","7842323","GGCCGGGTGTGGTGGCTCATGCCTGTAATCCCAGGCATGATTTGGGAGGCCGAGGGAGGCAGATCACCTGAGGTCAGGAGTTTTTTTGTTTTGTTTTGTTTTGTTTTTGAGACAGAGTCTTGTTCTGTTGCCCAGGCTGGAGTGCAATGATGTGATCTCGACTCACTACAACCTCCACCTCCTGAGTTCAAGCGATTCTGCTGCCTCAGCCTCCCGAGTAGCTGGCATTACAGGCATGTGCCACCAAGCCTGGCTAATTTTTGTATTTATAGTAGAGACGGGGGTTTCACCATGTTGATCAGGCTGGTGTCGAACTCCTGGCCTCAAGTGATCCGCTCGCCTTGGCCTCCCAAAATGCTGGGATTACAGATGTGAGCCACTGTGCCCAGCCAAGGTCAAGAGTTTGAAACCAGCCTGGCCAGCATGGTGAAACCCTATCTCTACTAAAAATACAAAATCAGTCCATGTGCCTAATTTTGGGATCACACCTGGGATCATGCCTGCAATCCCAGCACTTTGGGAGGCCAAGGCGGGTGGGTCATGAAGTCAGGAGTTCAAGACCAGCCTGGCCAACATGGTGAAACCCTGTCTCTACTAAAAATACAAAAGTTAGCTGGGCGTGGTGGCACGCACCTGTAGTCCCAGCTACTAGGAAGGCTGAGGCAGGAGAATTCTTGAACCCGGGTGATGGAGGTTGCAGTGAGCCGAGATTGCGCCACTGCACTCCAGCCTGGGCAACAGAGTGAGACTCTGTCTAAAAAAAAAATTAGTCAGGCGTGGTGGTGAGCACCTGTAATCACAGCTACTGGGGAGGCTGAGGCTGGAGAATTGCTTGAACCCGGGAGGCGGAGGTTGCAGTGAGCCAAGATCGCGCCTTTGCACTCCAGCCTGGGCAACAGGAGTGAAACTGCATCTCAAAAAAAAAAAAAAAAAAA","GGCTGGGCGCAGTGGCTCACACCTGTAATCCCAGCACTTAGGGAAGCTGAGGCGAGTAGATCACCTGAGGTCAGGAGTTAGAGACCAGCCTGGCCATCATGGTGAAACCCCGTCTCTACTAAAGATACCAAAAATTAGCTGAGTGTGGTGCTGGGTGCCTGTAATCCCAGAAACTCAGGGTGCCTGTAATCCCAGCAACTCAGGGTGCCTTTAATCCCAGCAACTGAGGGTACCAGTAATCCCAGCAACTCAGGGTGTCTTTAATCCTAGCAACTGAGGGCACCTGTAATCCCAGCAACTCAGGAAGCTGAGACAGGAGAAGTACTTGAACCCAGAAGGCAGAGGTTGCAGTGAGCCGATATTGCACCATTGCACTCCAGTCTGGGCAACAAGAGTGAAACTCTGTCTCAAAAAAAAA"
"chr19","10485431","10486007","JH378118","18053084","18053501","237","7567653","GGCCGGGCGCAGTGGCTCATGCCTAATCCCAAGACTTTCAGAGGCTGAGGCAGGTGGATCACCTGAGGTCAGGAGCTCAAGACCAGCCTGGCTAACATTGTGAAACCGCGTCTCTACTAAAAATCAAAATTGGCCGGGCACGGTGGCTCACACCTGTAATCCCATCCCTCTGGGAGACCGAGGCGGGCAGATCACCTAAGGTCAGGAGTTCGAGACCAGCCTGACCAACATGGAGAAAACCCTTCTCTGCTAAAAATACAAAATTAGCCGGGCGTGGTGGCGCATGCCTGTAACCTCAGCTACTCGGGAGGCTGAGGGAAAATCGCTTGAACCTGCCAGGTGGAGGTTGCAGTGAGCCGAGATCGAGCCATTGCACTCCAGCATGGGCAACGAAAGCGAAACTCCATCTCAAAAAAAAAAAAAATTAGCTAGGCGTGGTGGCGCGTGCCTGTATTCCCAGCTACTCAGGAGGCTGAGACAGGAGAATCACTTGAACCTGGGAGGCAGAGGTTGCAGTGAGCCAAGATTGCACCATTGCACTCCAGCCTGGGCAACACGAGCAAAACTCTGTCTCAAA","GGCTGGGCGCAGTGGCTCACACCTGTAATCCCAGCACTTAGGGAAGCTGAGGCGAGTAGATCACCTGAGGTCAGGAGTTAGAGACCAGCCTGGCCATCATGGTGAAACCCCGTCTCTACTAAAGATACCAAAAATTAGCTGAGTGTGGTGCTGGGTGCCTGTAATCCCAGAAACTCAGGGTGCCTGTAATCCCAGCAACTCAGGGTGCCTTTAATCCCAGCAACTGAGGGTACCAGTAATCCCAGCAACTCAGGGTGTCTTTAATCCTAGCAACTGAGGGCACCTGTAATCCCAGCAACTCAGGAAGCTGAGACAGGAGAAGTACTTGAACCCAGAAGGCAGAGGTTGCAGTGAGCCGATATTGCACCATTGCACTCCAGTCTGGGCAACAAGAGTGAAACTCTGTCTCAAAAAAAAA"
"chr19","10538873","10539199","JH378118","15020968","15021286","46","4482095","GCTGGGCGCGGTGGCTCACGCCTGTAATCCCAGCACTTTGGGAGGCTGAGGCAGGCAGATCACCTGAGGTCAGGAGTTCAAGACCAGCCTGGTTAACACAGTGAAACCCCCGTCTCTACTAAAAATACAAAAACAAAAATTAGCCGGGTGTGGTGGCGGGCGCCTGTAATCCCAGTTACTCGGGAGGCTGAGGCAGGAGAATCGCTTGAACCCGGGAGGCGGAGGTTGTGGTGAGCCGAGATTGCCATTGCACTCCAGCCTGGGCAAAAAGAGCGAAACTCCATCTAAAACAAACAAACAAACAAACAAACAAAAAATAGAAAAGAA","GCCGGGCGCGGTGGCTCAAGCCTGTAATCCCAGCACTTTGGGAGGCTGAGGCGGGTGGATCCCGAGGTCAAGAGATCGAGACCATCCTGGTCAACATGGTGAAACCCCGTCTCTACTAAAAATACAAAACATTAGCTGGGTATGGTGGCGCGTGCCTGTAATCCCAGCTACTCAGGAGGCTGAGGCAGGAGAATTGCCTGAACCCAGGAGGCGGAGGTTGCGGTGAGCTGAGATCGCGCCATTGCACTCCAGCCTGGGTAACAAGAGCGAAACTTCCATCTCAAAAACAAACAAACAAACAAACAAACAAAAAACAAAC"
"chr19","10973032","10973651","JH378118","18053084","18053501","265","7080052","GGCTGGACGTGGTGGCTCACGCCTGTAATCCCAACACTTTGGGAGACCAAGGCAGGTGGATCGCCTGAGGTTAGGGGTTCGAGACCAGCCTGACCAACATGGTGAAACCCCATCTCTACTAATAATAAAAAAATTAGGACCAGGCTTGGTGGCTCATGCCTGTAATTCCAACACTTTGGGAGGCCAAGGCGAGTGGATAACTTGAGGTCAGGAGTTTGAGACCAGCCTGGCCAACATGGTGAAACCTCATCTCTACTAAAAATACAAAAATTAGCCGGCATGGTGGCGGGCACCCGTAATCCCAGCTACTCGGTGTGGGGGCTGGGACAGGAGAATCGCTTGAACCCAGGAGGTGGAGGTTGCCGTGAGCTAAGATTGCGCCACTGCACTCTAGTTGGGGCAACAGAGCGGACTCCGTCTCAAAAAAAAAAAAAAAATTAGCCGAGCGTGGTGGTGGACACCTGTAATCCCAGCTACTCAGGAGGCTGAGGCAGGAAAATTGAAATCGCTTAAACCTGGGAGGAGGAGGTTGCAGTGAGCCAAGATCGCACCATTGCACTCCAGCCTGGGCGACAAGAACAAAACTCCGTCTCCCCACTCCAAAAAAAAAAAAAAAAAAA","GGCTGGGCGCAGTGGCTCACACCTGTAATCCCAGCACTTAGGGAAGCTGAGGCGAGTAGATCACCTGAGGTCAGGAGTTAGAGACCAGCCTGGCCATCATGGTGAAACCCCGTCTCTACTAAAGATACCAAAAATTAGCTGAGTGTGGTGCTGGGTGCCTGTAATCCCAGAAACTCAGGGTGCCTGTAATCCCAGCAACTCAGGGTGCCTTTAATCCCAGCAACTGAGGGTACCAGTAATCCCAGCAACTCAGGGTGTCTTTAATCCTAGCAACTGAGGGCACCTGTAATCCCAGCAACTCAGGAAGCTGAGACAGGAGAAGTACTTGAACCCAGAAGGCAGAGGTTGCAGTGAGCCGATATTGCACCATTGCACTCCAGTCTGGGCAACAAGAGTGAAACTCTGTCTCAAAAAAAAA"
"chr19","11513769","11514351","JH378206","6546474","6546861","242","4967295","TCCCAGCACTTTGGGAGGCCGCGATGGGTGGATCACCTTAGGTCAGGAATTCGAGACCATCCTGGCCAACATGGTGAAACCCCGTCTCTACTAAAAACACAAAAATTAGGCCGGGCACGGTGGCTCACATCTGTAATCCCAGCACTTTGGGAGGCTGAGGTGGGCGGATCACAAGGTCAGGAGTTCAAGACCAGCCTGGCCAACATGGTGAAACCCTGTCTCTACTAAAAATACAAAAATTAACTGGGCATGGTGGCATGTGCCTGTAATCCCAGCTACTTGGGAGGCTGAGGCAGAAGAATTGCTTGAACCAGGGAGTCAGAGGTTATAGTGAGCTGAGATCGTGCGACTGCACTCCAGCCTGGTGACAGAGCGAGACTCCGTTTCAGGAAAAACAAACAAAACACAAAAATTAGCTGGGCATGGTGGCAGGCGCCTGTAATCCTAGCTACTTGGGAGGCTGAGGCAGGAGAATCGCTTGAACCCAGAAGGCAAAGGTTGCAGTGAGCTGAGATGATGCCATTGCACTCCAGCCTGGGCAACAAGTGAAACTCTGTCTCAAGAAAAAAAGTAAAAGAAAGAA","GGCCACACATGGTGGCTAACGCCTGTAATCCCAGCACTTTGGGAGGCCAAGTCGGGTGGATCATGAGGTCAGGAGACCAAGACCATCCTGGCCAAATGGTGAAACCCCGTCTCTACTAAAAATACAAAAATTAGCTGGGCATGGTGGCGTGTGCCTGTAATCCCAGCTACTCAGGAGGCTGAGGCAGGACAATTGCCTGAACCCAGGAGAATTAGCTGGGCATGGTGGCGTGTGCCTGTAATCCCAGCTACTCAGGAGGCTGAGGCAGGACAATTGCCTGAACCCAGGAGGCGAAGGTTGCGGTGAGCCGAGATTGTGCCATTGCACTCCAGCCTGGGTAACAAGAGCGACACTCTGTCTCAAAAAAAAAAAAAAAAAAAAAAAAAAA"
"chr19","11535200","11535780","JH378206","6546474","6546861","242","4988726","TCCCAGCACTTTGGGAGGCCGCGATGGGTGGATCACCTTAGGTCAGGAATTCGAGACCATCCTGGCCAACATGGTGAAACCCCGTCTCTACTAAAAACACAAAAATTAGGCCGGGCACGGTGGCTCACATTGTAATCCCAGCACTTTGGGAGGCTGAGGTGGGCGGATCACAAGGTCAGGAGTTCAAGACCAGCCTGGCCAACATGGTGAAACCCTGTCTCTACTAAAAATACAAAAATTAACTGGGCATGGTGGCATGTGCCTGTAATCCCAGCTACTTGGGAGGCTGAGGCAGAAGAATTGCTTGAACCAGGGAGTCAGAGGTTATAGTGAGCTGAGATCGTGCGACTGCACTCCAGCCTGGTGACAGAGCGAGACTCCGTTTCAGGAAAAACAAACAAAACACAAAAATTAGCTGGCATGGTGGCAGGCGCCTGTAATCCTAGCTACTTGGAGGCTGAGGCAGGAGAATCGCTTGAAACCCAGAAGGCAAAGGTTGCAGTGAGCTGAGATGATGCCATTGCACTCCAGCCTGGGCAACAAGTGAAACTCTGTCTCAAGAAAAAAAGTAAAAGAAAGAA","GGCCACACATGGTGGCTAACGCCTGTAATCCCAGCACTTTGGGAGGCCAAGTCGGGTGGATCATGAGGTCAGGAGACCAAGACCATCCTGGCCAAATGGTGAAACCCCGTCTCTACTAAAAATACAAAAATTAGCTGGGCATGGTGGCGTGTGCCTGTAATCCCAGCTACTCAGGAGGCTGAGGCAGGACAATTGCCTGAACCCAGGAGAATTAGCTGGGCATGGTGGCGTGTGCCTGTAATCCCAGCTACTCAGGAGGCTGAGGCAGGACAATTGCCTGAACCCAGGAGGCGAAGGTTGCGGTGAGCCGAGATTGTGCCATTGCACTCCAGCCTGGGTAACAAGAGCGACACTCTGTCTCAAAAAAAAAAAAAAAAAAAAAAAAAAA"
"chr19","12911527","12912140","JH378118","18053084","18053501","266","5141557","GGCCAGGCATGGTGGCTCATGCCTGTAATCCAGCACTTTGGTAGGCCAAGGTGGGTGGATGGATTACTTGAGGCCAGGAGTTCAAGACCAACCTGGCCAACATGGTGAAAACCCATCTCTATTAAAAATATAAAAGCTAGGCCAGGTGCGGTGGCTCACGCCTGTAATCCCAGCACTTTGGGAGGCTGAGGCGGGCGGATCACGAGGTCAGGAGATCGAGACCACTGTGAAACCCTGTCTCTACTAAAAATACAAAAAAAATTAGCTGGGTGGGGTGGCGGGTGCCTGTAGTCCCAGCTACTTGGGAGGCTGAGGCAGGAGAATGGCGTGAACCCGGGAGGCGGAGCTTGCAGTGAGCCGAGATCGCGCCACTGCACTCCAGCCTGGGCTACAGAGCAAGACTCCGTCTCAAAAAAAAAATAAATAAATAAATAAAAATAAAAACTAACTGGGCATGGTGGTGTGCACCTGTAATCCCAGCTACTCGGGAGGCTGAGACAGGAGAATTGCTTGAACCTGGGAGGTGGAGGTTGCAGTGAACCAAGATGATGCCATTGCACTCCAACCTGGGCAACAAGAGCAAAACTCCGTCTCAAAAAAAAAAAAAAAAAAAA","GGCTGGGCGCAGTGGCTCACACCTGTAATCCCAGCACTTAGGGAAGCTGAGGCGAGTAGATCACCTGAGGTCAGGAGTTAGAGACCAGCCTGGCCATCATGGTGAAACCCCGTCTCTACTAAAGATACCAAAAATTAGCTGAGTGTGGTGCTGGGTGCCTGTAATCCCAGAAACTCAGGGTGCCTGTAATCCCAGCAACTCAGGGTGCCTTTAATCCCAGCAACTGAGGGTACCAGTAATCCCAGCAACTCAGGGTGTCTTTAATCCTAGCAACTGAGGGCACCTGTAATCCCAGCAACTCAGGAAGCTGAGACAGGAGAAGTACTTGAACCCAGAAGGCAGAGGTTGCAGTGAGCCGATATTGCACCATTGCACTCCAGTCTGGGCAACAAGAGTGAAACTCTGTCTCAAAAAAAAA"
"chr19","13205284","13205895","JH378118","18053084","18053501","258","4847800","GCCAGGCGCAGTGGATTACGCCTGTAATCCCAGCGCTTTGGTATACCGAGGCGGGCAGATCGTCTGAGGTCAGGAGTTCAAGACCAGCCTGGAGAACATGGTGAAACCCCGTCTCTATTAAAAATACAGGCTGGGCGCGGTGGCTTACGCCTGTAATCTCAGCACTTTGGGAGGCCAAGGCGGGTGGATCACGAGGTCAGGAGATCGAGACCATCCTGGCTAACATGGTGAAACCCTGTCTCTACTGAAAATACAAAAAAATTAGTTGTGGTGGGTGCCTGTAATCCCAGCTACTCGGGAGGCTGAGGCAGGAGAATGGCGTGAACCCGGGAAGCAGAGATTGCAGTAAGCCAAGATCGCTCCACTGCACTCCAGCCTGGGCTACAGAGCAAGACTCCATCTCAAAAAAAAATAAATAAATAAAATAAAAAATTAGCCTGGCGTGGTGGCGCATGCCTGTAATCCCAGCTACTTGGGAGGCTGAGGCAGGAGAATTGCTTGAACCCAAGAGGTGGAGGTTGCAGTGAGTCGAGATTGAGCCATTGCCATCCAGCCTGGGCAACAAGAGTGAAACTCTGTCTCAAAAAAAAAGAGAGAGAAAAGAAAGTAAAA","GGCTGGGCGCAGTGGCTCACACCTGTAATCCCAGCACTTAGGGAAGCTGAGGCGAGTAGATCACCTGAGGTCAGGAGTTAGAGACCAGCCTGGCCATCATGGTGAAACCCCGTCTCTACTAAAGATACCAAAAATTAGCTGAGTGTGGTGCTGGGTGCCTGTAATCCCAGAAACTCAGGGTGCCTGTAATCCCAGCAACTCAGGGTGCCTTTAATCCCAGCAACTGAGGGTACCAGTAATCCCAGCAACTCAGGGTGTCTTTAATCCTAGCAACTGAGGGCACCTGTAATCCCAGCAACTCAGGAAGCTGAGACAGGAGAAGTACTTGAACCCAGAAGGCAGAGGTTGCAGTGAGCCGATATTGCACCATTGCACTCCAGTCTGGGCAACAAGAGTGAAACTCTGTCTCAAAAAAAAA"
"chr19","14119695","14120238","JH378206","6546474","6546861","206","7573221","ACCAGCCTGGCCAAAATGGTGAAACCCTGTCTCTACTAAAAATATTTAAAAATTGGCCAGGTGCGGTGGCTCACGCCTGTAATCCCAGCACTTTGGGAGGCCGAGGCGGGCGGATTACAAGGTCAGGAGATCGAGACCATCCTGACTAACATGGTGAAACCCCGTCTCTACTAAAAATACAAAAAATTGGCCGGGCGTGGTAGCGGGCGCCTGTAGTTCCAGCTACTCGGGAGGCTGAGGCAGGAGAATGGCGTGAACCCGGAAGGCAGAGCTTGCAGTGAGCCAAGATCGTGCCACTGCACTCCAGCCTGAGCGACAGAGCAAGACTCCATCTCAAAAAAAAAAAAAAAAAAAAAAAAAATTAAAAAATTAGCTGGGCGTGGTAGCCGGCACCTGTAATTCCAGCTACTCAGGAGGCTGGAGCACAAGAATCGCTTGAAACCAGGAGGCAGAGTTGTAGTGAGCCGAGATCGTGCCATTGCACTCCAGCCTGGGCATCAAGAGCGAAACTCCATCTCAAAAACAAAACAAAACAAAACAAAAA","GGCCACACATGGTGGCTAACGCCTGTAATCCCAGCACTTTGGGAGGCCAAGTCGGGTGGATCATGAGGTCAGGAGACCAAGACCATCCTGGCCAAATGGTGAAACCCCGTCTCTACTAAAAATACAAAAATTAGCTGGGCATGGTGGCGTGTGCCTGTAATCCCAGCTACTCAGGAGGCTGAGGCAGGACAATTGCCTGAACCCAGGAGAATTAGCTGGGCATGGTGGCGTGTGCCTGTAATCCCAGCTACTCAGGAGGCTGAGGCAGGACAATTGCCTGAACCCAGGAGGCGAAGGTTGCGGTGAGCCGAGATTGTGCCATTGCACTCCAGCCTGGGTAACAAGAGCGACACTCTGTCTCAAAAAAAAAAAAAAAAAAAAAAAAAAA"
"chr14","584088","584429","JH378109","21565230","21565567","54","20981142","GGCCGGGTACGGTGGCTCACGCCTGTAGTCCTGGCACTTTGGGAGGCCGAGGCAGGTGGATCCCCGAGGTCACGAGTTTGAGACCAGCCTGGCCAGCATGGTGAAATCCCATCTCTACTAAAAATACAAAACTTAGCCGGGCATGGTGACGTGTGCCTGTAATCCCAGCTACTTGGGAGGCTGAGGCAGGAGAATTGCTTGAACCAGGGAGGCAGAGGTTGCAGTGAGCTGAGATCATGAAACTGCAGTCCAGTCTAGGCGACAAGAGCAAAACTCCGTCTCAAAAAAATAAATAAATAAATAAATAAATAAAAAATAAAACAAACAACAAAAAAAACAAAA","GGCCGGGCGCGGTGGCTCAAGCCTGTAATACCAGCACTTTGGGAGGCCGAGGCGGGTGGATCACGAGGTCAAGAGATCGAGACCATCCTGGTCAACATGGTGAAACCCCGTCTCTACTAAAAATACAAACAATTAGCTGGGCATGGTGGCGGGTGCCTGTAATCCCAGCTACTCCAGAGGCTGAGGCAGGAGAATTGCCTGAACCCAGGAGACGGAGGTTGCGGTGAGCCAAGATCGCGCCATTGCACTCCAGCCTGGGTGACAAGAGCGAAACTCCGTCTCAATAAATAAATAAATAAATAAATAAATAAAAATAAAATAAATAAATAAATAAATAA"
"chr14","620575","620915","JH378109","21565230","21565567","56","20944655","GGCCGGGTACGGTGGCTCACGCCTGTAGTCCTGGCACTTTGGGAGGCCGAGGCAGGTGGATCCCCGAGGTCACGAGTTTGAGACCAGCCTGGCCAGCATGGTGAAATCCCATCTCTACTAAAAATACAAAACTTAGCCGGGCATGGTGACGTGTGCCTGTAATCCAGCTAACTTGGGAGGCTGAGGCAGGAGAATTGCTTGAACCAGGGAGGCAGAGGTTGCAGTGAGCTGAGATCATGAAACTGCAGTCCAGTCTAGGCGACAAGAGCAAAACTCCGTCTCAAAAAATAAATAAATAAATAAATAAATAAAAAATAAAACAAACAACAAACAAAACAAAA","GGCCGGGCGCGGTGGCTCAAGCCTGTAATACCAGCACTTTGGGAGGCCGAGGCGGGTGGATCACGAGGTCAAGAGATCGAGACCATCCTGGTCAACATGGTGAAACCCCGTCTCTACTAAAAATACAAACAATTAGCTGGGCATGGTGGCGGGTGCCTGTAATCCCAGCTACTCCAGAGGCTGAGGCAGGAGAATTGCCTGAACCCAGGAGACGGAGGTTGCGGTGAGCCAAGATCGCGCCATTGCACTCCAGCCTGGGTGACAAGAGCGAAACTCCGTCTCAATAAATAAATAAATAAATAAATAAATAAAAATAAAATAAATAAATAAATAAATAA"
"chr14","1107083","1107723","JH378118","18053084","18053501","303","16946001","GGCGTGGTGGCTCACACCTGTAATCCCAGCACTTCAGGAGGCCAAGGCAGGTAGATTGCTTGATCACAGGAGTTCAAACCAGCCATGGGCAATGTCAGGCCTCTGAGCCCAAGCTTGCACGTATCCAGATGGCCTGAAGCAACTGAAGAATCACAAAAGAAGTGAAAACAGCCAGTTCCTTCCTTAACTGATGACATTACCTTGTGAAATTCCTTCTCCTGGCTCAGAAGCTCCCCTACTGAGCACCTTGTGACCCCTGCCCCTGCCAGCCAGAGAACAATCCCCTTTGACTGTAATTTTCCACTACCTACCCAAATCCTATAAAACAGCCCCACCCCATCTCCCTTTGCTGACTCCTTTTTCGGACTAGGTCCGCCTGCACCCAGGTGATTAAAAAGCTTTATTGCTCACACAAAGCCTGTTGGTGGTCTCTTCACACGGACGCACGTGACAGGCAACATGGTGAAACCCTATCTCTATAAAAAAATAAAAATAAAAATTAGTTGGGCGTGGAGACTGAGGTGAGAGAATCCAGAGGATCCAAGAGGATCGAGTCAAGGAGGTGGAGGCCGCAGTGAGCCGAGATCGCACCGCTGCACTCCAGCCTGGGCGACAAGAGTGAAACTCTGTCTTAAAAAAAA","GGCTGGGCGCAGTGGCTCACACCTGTAATCCCAGCACTTAGGGAAGCTGAGGCGAGTAGATCACCTGAGGTCAGGAGTTAGAGACCAGCCTGGCCATCATGGTGAAACCCCGTCTCTACTAAAGATACCAAAAATTAGCTGAGTGTGGTGCTGGGTGCCTGTAATCCCAGAAACTCAGGGTGCCTGTAATCCCAGCAACTCAGGGTGCCTTTAATCCCAGCAACTGAGGGTACCAGTAATCCCAGCAACTCAGGGTGTCTTTAATCCTAGCAACTGAGGGCACCTGTAATCCCAGCAACTCAGGAAGCTGAGACAGGAGAAGTACTTGAACCCAGAAGGCAGAGGTTGCAGTGAGCCGATATTGCACCATTGCACTCCAGTCTGGGCAACAAGAGTGAAACTCTGTCTCAAAAAAAAA"
"chr14","1362660","1363231","JH378118","18053084","18053501","229","16690424","GGCTGGGCACAGTGGCTTATACCCATAATCTCAGCAGTTTGGGAGGCCAAGGCAGGTGTATCACCTGAGGTCAGGAGTTCGAGAAACACCATGGCCAACATGGTGAAACCCCATCTCTACTAAAAATACAAAAAGTAGGCTGGGCGTGGTGGCTCACGCCTGTAATCCCAGTACTTTGGGAGGCCGAGGCGGGCGGATCACAAGGTCAGGAAACCGAGACCATCCTGACTAACATGGTGAAACCCCGTCTCTACTAAAAATACAAAAAAAGCTAGCCGGGCATGGTGGCGGGTGCCTGTAGTCCCAGCTACTCGGGAGGCTGAGGCAGGAGAATGGCGTGACCCCAGGAGGCAGAGCTTCCAGCTTGGGTGACTCCGTCTCAAAAAAAAAAAAACAAAAACAAAAAGTAGCTGGACGTGGTGGCTGTAGACCTAGCTACTCGAGAGGCTGAGGCAGGAGAATCGCTTGAACCTAGGAGGCGGAGGTTGCGGTGAGCCGAGATCACGCTTCTGCACTCCAGCCTGGGTGACAAGAGCAAAACTCCATCTCCAAAAAAAAAAAACAAAAAAAAA","GGCTGGGCGCAGTGGCTCACACCTGTAATCCCAGCACTTAGGGAAGCTGAGGCGAGTAGATCACCTGAGGTCAGGAGTTAGAGACCAGCCTGGCCATCATGGTGAAACCCCGTCTCTACTAAAGATACCAAAAATTAGCTGAGTGTGGTGCTGGGTGCCTGTAATCCCAGAAACTCAGGGTGCCTGTAATCCCAGCAACTCAGGGTGCCTTTAATCCCAGCAACTGAGGGTACCAGTAATCCCAGCAACTCAGGGTGTCTTTAATCCTAGCAACTGAGGGCACCTGTAATCCCAGCAACTCAGGAAGCTGAGACAGGAGAAGTACTTGAACCCAGAAGGCAGAGGTTGCAGTGAGCCGATATTGCACCATTGCACTCCAGTCTGGGCAACAAGAGTGAAACTCTGTCTCAAAAAAAAA"
"chr14","2088506","2089110","JH378118","18053084","18053501","257","15964578","GGCTGGGCACTGCGGCTCACACCTGTAATCCCAGCATTTTGAGAGGCCTAGGTGGGTGGATCACCTGAGATCAGTTCAAGACCAGCCTGACCAACATGGCAAAACCCCATCTCTATTAAAAACACAAAAAACGCCCAGGAGCGGTGGCTCACACCTGTAATCCCGGCACTTTGGGAGGCTGAGGCAGGCGGATCACGAGGTCAGGAGATCGAGACCATGCTGGCTAACACGGTGAAACCCCGTCTCTACTAAAAATACAAAAAATTAGCCAGGCGTGGTGTCGGGCGCCTGTAGTCCCAGCTATTCGGGAGGCTGAGACAGGAGAATGGCATGAACCCGGGAGGCAGAGCTTGCAGTGAGCTGAGATCGCGCCACTGCACTCCAGCCTGGGCGACAGAGTAAGACTCTGTCTCAAAAAAAAAAATACAAAAAATACAAAAAACATTAGCCACATGTGGTGGTGGGTGCCTGTAATCCCAGCTACTCAGGAGGCTGAGGCTGGAGAATTGCTTGAACCCAGGAGGTGGAGGTTGTGGTGAGCCAAGATCACGCCATTGCATTCCAGCCTGGGTGACAAGAGTGAACCTCTGTCTCAAAAAAAAGAA","GGCTGGGCGCAGTGGCTCACACCTGTAATCCCAGCACTTAGGGAAGCTGAGGCGAGTAGATCACCTGAGGTCAGGAGTTAGAGACCAGCCTGGCCATCATGGTGAAACCCCGTCTCTACTAAAGATACCAAAAATTAGCTGAGTGTGGTGCTGGGTGCCTGTAATCCCAGAAACTCAGGGTGCCTGTAATCCCAGCAACTCAGGGTGCCTTTAATCCCAGCAACTGAGGGTACCAGTAATCCCAGCAACTCAGGGTGTCTTTAATCCTAGCAACTGAGGGCACCTGTAATCCCAGCAACTCAGGAAGCTGAGACAGGAGAAGTACTTGAACCCAGAAGGCAGAGGTTGCAGTGAGCCGATATTGCACCATTGCACTCCAGTCTGGGCAACAAGAGTGAAACTCTGTCTCAAAAAAAAA"
"chr14","2164771","2165383","JH378118","18053084","18053501","243","15888313","GGCTGGGCGCAGTGGCTCACACCTGTAATCCCAGCACTCTGGGAGGCCAAGGCAGGTGGATCACCTGAGGTCAGGAGTTCGAGACCAGCCTGGCCAACATGGTGAAACCCCATCTTTACTAAAAATACAAAAATTAGCTAGGCGTGAGGCCGGGCGTGGCGGCTCATGCCTGTAATCCCAGCACTATGGGAGGCTGAGGCAGGCTGATCATGAGGTCAGGAGATTGAGACCTGGCTAACACAGTGAAACCCCGTCTCTACTAAAAATACAAAAAAAAAATAGCCAGGCATGATGGCAGGCTCCTGTAGTCCCAGCTTCTTGGGAGGCTGAGGCAGGAGAATGGTGTGAACCCGGGAGGCAGAGCTTGCAGTGAGCCGAGATCATGCCACTGCACTCCAGCCTGGGTGACAGAGCAAGACTCTGTCTCAAAAAAAAAAAAAAAAAATTAGCTAGGCGTGGTGAGGGGCACCTGGAATCCCAGCTACTCAGGAGGCTGAGGCAGGAGCATCGTTTAAACCCAGGAGGCAGAGGTTGCAGTGAGCCGAAATCACACCATTGCACTCCAGCCTGGGCAACAAGAGCAAGTCTCCATCTTAAAAAAAAAAAAAAAAAA","GGCTGGGCGCAGTGGCTCACACCTGTAATCCCAGCACTTAGGGAAGCTGAGGCGAGTAGATCACCTGAGGTCAGGAGTTAGAGACCAGCCTGGCCATCATGGTGAAACCCCGTCTCTACTAAAGATACCAAAAATTAGCTGAGTGTGGTGCTGGGTGCCTGTAATCCCAGAAACTCAGGGTGCCTGTAATCCCAGCAACTCAGGGTGCCTTTAATCCCAGCAACTGAGGGTACCAGTAATCCCAGCAACTCAGGGTGTCTTTAATCCTAGCAACTGAGGGCACCTGTAATCCCAGCAACTCAGGAAGCTGAGACAGGAGAAGTACTTGAACCCAGAAGGCAGAGGTTGCAGTGAGCCGATATTGCACCATTGCACTCCAGTCTGGGCAACAAGAGTGAAACTCTGTCTCAAAAAAAAA"
"chr14","3757666","3758004","JH378113","23438980","23439304","67","19681314","CTGGGCATGGTGGCTCATGCCTGTAATCCCAGCACTTTGGGAGACAGAGGAGGGCAGATCATCTGAGGTCAGGAGTTTGAGACCAGCCTGGCCACCATGGTGAAACCCCCGTCTCTACTGAAAATACAAAAAAATTCAGCTGGGTGTGGTAGTGGATGTCTGTAATCCTAGCTGCTTGGGAGGCTGAGACAGGAGAATCGCTTGAACCCGGGAGGTGGAGGTTGCAGTGAGCCGCCATTGCGCTCCAGCCTGGGCAACAAGAGCGAAACTCCATCTCAAAAATTAATTAATTAATTAATTAATTAAAAGTGGACTAAAGCAAAGACAAGAGAAAAAAGA","GGCAGGGTGTGGTAGCTCATGCTTGTAATCCCAGCACTTTGGGAAGTGGAGGCGGGCAGATCATCTGAGGTCAGGAGTTTGAGGCCAGCCTGGCCAACATGGTGAAACCCTGTCTCTACTAAAAATACAAAAAATTAACTGGGCGTGGTGGTGGACACCTGTAATCCCAGCTGCTTGGGAGGCTGAGGCAGGAGAATCGCTTGAACCCAGGAGATGGAGGTTGCAGTGAGCCAAGATGGCACCATTGCACTCTAGCCTGGGCAAAAAGAGTGAAACTCCGTCTCAAAAAAAAAAAAGAAAAGAAAAGAAAAGAAAAGAAAAGAAA"
"chr14","10702105","10702681","JH378118","18053084","18053501","246","7350979","GGCCAGGCGCAATGGCTCACACCTGTAATCCAAGCACTTTGGGAGGCCAGTTCAAGACCAGCCTGGCCAACATGGTGAAAACCTGTCTCTGCTAAAAATGCCAAATTTCCCAGCACTTTGGGAGGCTGAGGCGGGTGGATCACGAGGTCAGGAGATTGAGACCATCCCGGCTAACACGGTGAAACCCCATCTCTACTAAAAATAGAAAAAAATTAGCCGGGCGTGGTGGCAGACGCCTGTAGTCCCAGCTACTCTGGAGGCTGAGGGAAGAGAATGGCATAAACCCGGGAGGCGGAGCTTGCAGCGAGCTGAGATTGCGCCACTGCACTCCAGCCTGGGCGACAGAGCAAGACTCCGTCTCAAAATAAATAAATAAATAAAATTAAAATTAAAAATAAAATACAAAATTTAGCCGAGCATGGTGGTGAGCACCTATAATCCCAGCTACTTGGGAGGCTGAGGCAGAAGAATCTCTTGAACCAGGGAAGTGGAGGTTGCAGTGGGCTGAGATCCAGCCACTGTACTCCAGCCTGGGCGACAAAAGCGAAACACTGTCTAAAAAAATAAAAAATAAAAA","GGCTGGGCGCAGTGGCTCACACCTGTAATCCCAGCACTTAGGGAAGCTGAGGCGAGTAGATCACCTGAGGTCAGGAGTTAGAGACCAGCCTGGCCATCATGGTGAAACCCCGTCTCTACTAAAGATACCAAAAATTAGCTGAGTGTGGTGCTGGGTGCCTGTAATCCCAGAAACTCAGGGTGCCTGTAATCCCAGCAACTCAGGGTGCCTTTAATCCCAGCAACTGAGGGTACCAGTAATCCCAGCAACTCAGGGTGTCTTTAATCCTAGCAACTGAGGGCACCTGTAATCCCAGCAACTCAGGAAGCTGAGACAGGAGAAGTACTTGAACCCAGAAGGCAGAGGTTGCAGTGAGCCGATATTGCACCATTGCACTCCAGTCTGGGCAACAAGAGTGAAACTCTGTCTCAAAAAAAAA"
"chr14","11790883","11791455","JH378118","18053084","18053501","226","6262201","GGCTGGGTGGCCATGGCTCATGCCTGTAATCCTAGAACTTTGGGAGGCTGCGGCAGGCAAATCACCTGAAGTCAGGAGTTCAAGACCAGCCTGGCCAACATACTGAAACCCCGTCTCTCCAGGCCTGGTGGCTCATGCCTGTAATCCCAGCACTTTGGAAAGCCGAGGTGGGCGGATCACCTGAGGTCAGGAGTTCAAGACCAGTCTGACCAACATGGGGAAACCCCATCTCTACTAAAAATACAAAATTAGCTGGATGTGGTGGCACATGCCTGTATTCCCAGCTACTTGGGAGGCTGAGGCAGGAGAATCGCTTGATCCCGAGAGGTGGAGCTTGCCGTGAGCTGAGATTGTGCGCCATTGCACTCCAGCCTGGGCAACAAGAGTGAAACTCCGTCTCTACTAAAAATACAAAAATTAGCCGGGTGTGGTGGCGGGTGCCTGTAATCCAAGCTACTCGGGAGGCTAAGGCAGGAGAATTGCTTGAACCCACGAGGCCGAGGTTGCAGTGAGCCGAGATTGCACTATTGCACTCCAGCCTGGGCGACAAGAGTGAGACTGTGTCTCAAAAAA","GGCTGGGCGCAGTGGCTCACACCTGTAATCCCAGCACTTAGGGAAGCTGAGGCGAGTAGATCACCTGAGGTCAGGAGTTAGAGACCAGCCTGGCCATCATGGTGAAACCCCGTCTCTACTAAAGATACCAAAAATTAGCTGAGTGTGGTGCTGGGTGCCTGTAATCCCAGAAACTCAGGGTGCCTGTAATCCCAGCAACTCAGGGTGCCTTTAATCCCAGCAACTGAGGGTACCAGTAATCCCAGCAACTCAGGGTGTCTTTAATCCTAGCAACTGAGGGCACCTGTAATCCCAGCAACTCAGGAAGCTGAGACAGGAGAAGTACTTGAACCCAGAAGGCAGAGGTTGCAGTGAGCCGATATTGCACCATTGCACTCCAGTCTGGGCAACAAGAGTGAAACTCTGTCTCAAAAAAAAA"
"chr14","12236526","12237360","JH378118","18053084","18053501","465","5816558","GGCTGGGTGGGGTGGCTCACGCGTGTAATCCCAACACTTTTGAGGCTGAGGTGGGTGGATCACTTGAGGTCCGGAGTTTGAGACCAGCCTGGTCAACATGGTGAAACCCCATGTCTCAGGATGGGGAACATCACATACCGGGGCCTGTCGTGGGGTGTGGGGAGGGGAAGGGATAGCATTAGGAGATATACCTAATGTAAATGACAAGTTAATGGGTGCAGCACACCAACATGGCACATGTATACATATGTAACAAACCTGCATGTTGTGCACATGTACCCTAGAACTTAAAGTATAGCAATAAAAAAAAAAAAAGAAACCCCGTGTCTACAAAAAAAATACAAAATTAGGCCAGGCGCAGTGGCACATACCTGTAATCCCAGCACTTTGGGAGGCCAAGGTGGGCAGATCACGAGGTCAGGAGTTTGAGACCAGCCTGTCCAAAATGGTGAAACCCCATCTCTACTAAAAAAATACAAAAATTAGCCAGGCATGGTGGCCCGTGCCTGCAATCCCAGCTACTCAGGAGGCTAAGGCAGGAGAATCACTTGAACGTGGGAGGCGGAGGTTGCAGTGAGCCGAGATCACACCATTGCACTCCAGCCTAGGCAACAGAGCGAGACTCTGTCTCAAAAAAACAAAAAGCAAAAAAACCCAAATTAGCCAGGCATGGTGGTAGTCACCTGTAATCCCAGCTACTTGGGAGGCTTAGGCAGGAGAATCGCTTGAACCCCAGAGGCAGAGGTTGCAGTAAGCCAAGATCGCACCAAGATCACTCCAGCCTGGGCGACAGTGAAACTGTGTCTCAAAAGAAAAAGAAAAAAAAGAAAGAAAA","GGCTGGGCGCAGTGGCTCACACCTGTAATCCCAGCACTTAGGGAAGCTGAGGCGAGTAGATCACCTGAGGTCAGGAGTTAGAGACCAGCCTGGCCATCATGGTGAAACCCCGTCTCTACTAAAGATACCAAAAATTAGCTGAGTGTGGTGCTGGGTGCCTGTAATCCCAGAAACTCAGGGTGCCTGTAATCCCAGCAACTCAGGGTGCCTTTAATCCCAGCAACTGAGGGTACCAGTAATCCCAGCAACTCAGGGTGTCTTTAATCCTAGCAACTGAGGGCACCTGTAATCCCAGCAACTCAGGAAGCTGAGACAGGAGAAGTACTTGAACCCAGAAGGCAGAGGTTGCAGTGAGCCGATATTGCACCATTGCACTCCAGTCTGGGCAACAAGAGTGAAACTCTGTCTCAAAAAAAAA"
"chr14","12551961","12552292","JH378124","27069096","27069413","54","14517135","GGCCAGGCGCGGTGGCTCACGCCTGTAATCCCAGCACTCTGGGAGGCCAAGGCGGACGGATCATCCGAGGTCAGGAGTTTGAGACCAGCCTGGCCAACATGGTGAAACCCCATCTCTACTAAAAATATATATATATATGTATATATATATATATATTAGCCAGGTGTAGTGGTGGGCATCTGTAATCCCAGCTACTCGGGAGGCTGAGGCAGGAGAATTGCTTGAACCCAGGAGGCGGAGGTTGCAGTGAGCTGAGATTGCACCACTGCACTCCAGCCTGGGTGATAAGAATGAGACTCCATCTCAAAACAAACAAACAAACAAATAAAAAA","GGCCGGGCACGGTGGCTCATGCCTGTAATCCCAGCACTTTGGGAGGCCGAGGCGGGTGGATCATGAGGTCAAGAGATCGAGACCATCCTAGTCAACATGGTGAAACTCCATCTCTACTAAAAATACAAAAAAAAAAAAAAATTAGCTGAGCATGGTGGTGCATGCTTGTAATTCCAGCTACTCAGGAGGCTGAGGCAGGAGAATTGCCTGAACCCAGGAGGCGGAGGTTGCAGTGAGCCGAGATTGCGCCATTGCACTCCAGCCTGGGTAATAAGAGTGAAACTCCGTCTCAAAAAAAAAAAACAAAAAAACAAAAAA"
"chr14","15131045","15131391","JH378121","20921542","20921875","62","5790497","GGCTGGGCCCGGTGACTCATGCCTGTAATCCCAGCACTTCGGGAGGACAAGGCGGGTGGATCACCTGAGGTCAGGAGTTCGAGACCAGCCTGGCCAACATGGCGAAACCCCGTCTCTACTGAAAATACAAAAATTAGCCAGGCATGGTGGTGGGCGCCTGTAATCCCAGCTACTCAGAGGCTGAGACAGGAGAATCACTTGAACCTGGGGTGGGGGCGGGGGCGGGGGCGGGGGCGGGGTGGGAGTGGAGGTTGCAGACAGTGAGTGGTGATGGCGCCAGTTCACTCCAGCCTGGGCGAAAGAGTGAAACTCCATCTCAGAAAAAAAAAAAAAAAAAAAAAGTAAAA","GGCTGGGTACGGTGGCTCATGCTGTAATCCCAGCACTTTGGGAGGTCAAAGCAGGCGGATCACCTGAGGTCAGGAGTTTGAGACCAGCCTTGCTAACATGGTGAAACCCCGTTTCTACTAAAAATAAAAAAATTAGCCAGGCGTGGTGGTGTGCACCTGTAATCCCAGCTACTTGGGAGGCTGAAGCAGGAGAGTTGCTTGAACCGGGGTGGTGGGGGGGCAGGGGCAGGGGTGGGTGGCAGGCAGAGGTTGCAGTGAGCCGAGATGGTGCCATTGCACTCCAGCCTGGGCAACAAGAGCAAAACTCCGTCTCAAAAAGAAAAAAAAAAAAGAA"
"chr14","15292066","15292693","JH378118","18053084","18053501","267","2761018","GGCCGGAGACGGTGGCTCACACCTGTAATCCCAGCACTTTGGGAGGCTGAGGCAGGCAGATCACCTGAAGTCAGGAGTTTGAGACCAGCCTGGCCAACATGGTATAAACCCCATCTCTACTAAAAATACAAAAATTAGGCTGGGCGCGGTGGCTCACGCCTGTAATCCCAACACTTTGGGAGGCCGAGGTGGGTGGATCACCTGAGGTCGGGAGTTTGAGACCAGCCTGACCAACATGAAGAAACCCTGTCTCTACTAAAAAAAAAAAAAAATACAAAATTAGCCGGGCATCATGGCACAAGCCTGTAATCCCAGCTACTCAGGAGTCTGAGGCAGGAGAATCGCTTGAACCTGGGAGGCGAAGGTTGCAGTGAGCTGAGATCGTGCCATTGCACTCCAGCCTGGGCAACAAGAGCGAAACTCCTTCTCTAAATAAATAAATAAAAATACAAAAATTTAGCCGGGCATGGTGGCGGGCACCTGTAATCCTAGCTACTTGAGAGGCTGAGGCAGGAGAATCGCTTGAACCCGGGAGGCGGAGGTTGCAGTAAGCAGAGATTGTGCCATTGCACTCCATCCTGGGCAACAAGAGTGAAACTCCATCTCAAAAAAAAAAAAAAAAAAAAAA","GGCTGGGCGCAGTGGCTCACACCTGTAATCCCAGCACTTAGGGAAGCTGAGGCGAGTAGATCACCTGAGGTCAGGAGTTAGAGACCAGCCTGGCCATCATGGTGAAACCCCGTCTCTACTAAAGATACCAAAAATTAGCTGAGTGTGGTGCTGGGTGCCTGTAATCCCAGAAACTCAGGGTGCCTGTAATCCCAGCAACTCAGGGTGCCTTTAATCCCAGCAACTGAGGGTACCAGTAATCCCAGCAACTCAGGGTGTCTTTAATCCTAGCAACTGAGGGCACCTGTAATCCCAGCAACTCAGGAAGCTGAGACAGGAGAAGTACTTGAACCCAGAAGGCAGAGGTTGCAGTGAGCCGATATTGCACCATTGCACTCCAGTCTGGGCAACAAGAGTGAAACTCTGTCTCAAAAAAAAA"
"chr14","15354689","15355313","JH378118","18053084","18053501","269","2698395","GGACGGGCGCAGTAGCTCACACCTGTAATCCTAGCAGTTTGGGAGGCCAAGGTGGGTGGATCACCTGACGTCAGGAGATCGAGACCAGCCTGGACAACATGGCGAAACCCTGTCTCTACTAAAAATACAAAATTAGGGCCAGGTGCGGTGGCTCACGCCTGTAATCCCAGCACTTTGGGAGACTGAGGCGGGCAGATCACCTGAGGTCAGGAGTTCGAGACCAGCCTGGCCAACATGGTGAAACCGCCTCTCTACTAAAAATATAAAAATTGGCTGGGCATTGTAGCAGCCACCTGTAATCCCAGCTACTTGGGGGCCCGAGGCAGAAAAACTGCTTGAACCCAGGAGGCAGAGGTTGTAGTGAGCCGAAATCATGCCACTGCACTCCAGCCTGGGTGACGAGAGTGAGACTCCGTTTCAAAGAAAAAGAAAAAAAATAAAATAAAACACAAAATTAGCCAGTCATGGTGGCAGGCACCTATAATCCCAGCTACCTGGGAGGCTAAGGCAGGAGAATCACTTGAACCCAGGAGGTAGAGGGTGTGGTGAGCCGAGATCACGCCATTGCACTCTAGCCTGGGCAACAAGAGCAAAACTCTGTCTCAAAACAAAAAGTTAAAAAAAA","GGCTGGGCGCAGTGGCTCACACCTGTAATCCCAGCACTTAGGGAAGCTGAGGCGAGTAGATCACCTGAGGTCAGGAGTTAGAGACCAGCCTGGCCATCATGGTGAAACCCCGTCTCTACTAAAGATACCAAAAATTAGCTGAGTGTGGTGCTGGGTGCCTGTAATCCCAGAAACTCAGGGTGCCTGTAATCCCAGCAACTCAGGGTGCCTTTAATCCCAGCAACTGAGGGTACCAGTAATCCCAGCAACTCAGGGTGTCTTTAATCCTAGCAACTGAGGGCACCTGTAATCCCAGCAACTCAGGAAGCTGAGACAGGAGAAGTACTTGAACCCAGAAGGCAGAGGTTGCAGTGAGCCGATATTGCACCATTGCACTCCAGTCTGGGCAACAAGAGTGAAACTCTGTCTCAAAAAAAAA"
"chr14","15366797","15367405","JH378129","11955248","11955630","263","3411549","GGTTGGGTGCGGTGGCTTACCCCTGTAATCCCAGCACTTTGGGGGTACAAAGTGGGAAGATTGCTTGAGCCCAGGAGTTCAAGACCAGCCTGGGCAACTAAGCGAGATCCTATCTCTCAAAAAAATTTTGAAACAACTTTTTGGCCGGGCGCAGTGGCTCACGCCTGTGATCCCAGCACTTTGGGAGGCCAGGGCGGGCGGATCACGAGGTCAGGAGATCAAGACCATCCTGGCTAACACGGTGAAACCCCGTCTCTACTAAAAATACAAAAAATTAGCCGGGTGCGGTGGCGGGCACCTGTAGTCCCAGCTACTCGGGAGGCTGAGGCAGGAGGATGGCGTGAACCCGGGAGGTGGAGCTTGCAGTGAGCTGAGATCGGGCCACTGCACTCCAACCTGGACGACAGATCGAGACTCCGGCTCAAAAAAAAAAAATTAGCTGGGCGTGGTGGCGGGTGCGTGTAATCCCAGCTACTCGGGAGGCTGAGGCAGGAGAATCACTTGAACCTGGGAGGCAGAGGCTGCAGTGAGCCAAGATCGCGCCATTGCACTCCAGCCTGGGCAACAAGAGCGAAACTCTGTCTCTAAATAATAAAATAAAATAAAAAA","GGCTGGGTACGGTGGCTCATGCCTGTAATCCCAGCACTTTGGGAGGTGGGTCACTTGAGGTCAGGAGTTCGAGACCAGCCTGTGCAGTGCCTCCATCCTCAACTGCTGCCTCATCAGCCTGGACCACTACCTGCTCATCCTCTCACCACTGCCACAAGCTGCGCATGAAGCTCCTGCGCGCGCCGGTGCCCGTCTCTACTAAAAATACAAAAATTAGCTGGGTGTGGTGGCAGGTGCCTGTAATCCCAGCTACTCAGGAGGCTGAGGCAGGAGAATCACTTGAACCCAGGAGGCAGAGGTTGCAGTGAGCCGATATCGCATCATTGCACTCCAGCCTGAGCAACAAGAGTGAAATTTTGTCTCAAAAAAAAAAAAAAAAGAAA"
"chr14","15379094","15379705","JH378129","11955248","11955630","265","3423846","GGTTGGGTGCGGTGGCTTACCCCTGTAATCCCAGCACTTTGGGGGTACAAAGTGGGAAGATTGCTTGAGCCCAGGAGTTCAAGACCAGCCTGGGCAACTAAGCGAGATCCTATCTCTCAAAAAAATTTTGAAACAACTTTTTGGCCGGGCGCAGTGGCTCACGCCTGTGATCCCAGCACTTTGGGAGGCCAGGGCGGGCGGATCACGAGGTCAGGAGATCAAGACCATCCTGGCTAACACGGTGAAACCCCGTCTCTACTAAAAATACAAAAAATTAGCCGGGTGCGGTGGCGGGCACCTGTAGTCCCAGCTACTCGGGAGGCTGAGGCAGGAGGATGGCGTGAACCCGGGAGGTGGAGCTTGCAGTGAGCTGAGATCGGGCCACTGCACTCCAACCTGGACGACAGATCGAGACTCCGGCTCAAAAAAAAAAAAAATTAGCTGGGCGTGGTGGCGGGTGCGTGTAATCCCAGCTACTCGGGAGGCTGAGGCAGGAGAATCACTTGAACCTGGGAGGCAGAGGCTGCAGTGAGCCAAGATCGCGCCATTGCACTCCAGCCTGGGCAACAAGAGCGAAACTCTGTCTCTAAATAAATAAAATAAAATAAAAAA","GGCTGGGTACGGTGGCTCATGCCTGTAATCCCAGCACTTTGGGAGGTGGGTCACTTGAGGTCAGGAGTTCGAGACCAGCCTGTGCAGTGCCTCCATCCTCAACTGCTGCCTCATCAGCCTGGACCACTACCTGCTCATCCTCTCACCACTGCCACAAGCTGCGCATGAAGCTCCTGCGCGCGCCGGTGCCCGTCTCTACTAAAAATACAAAAATTAGCTGGGTGTGGTGGCAGGTGCCTGTAATCCCAGCTACTCAGGAGGCTGAGGCAGGAGAATCACTTGAACCCAGGAGGCAGAGGTTGCAGTGAGCCGATATCGCATCATTGCACTCCAGCCTGAGCAACAAGAGTGAAATTTTGTCTCAAAAAAAAAAAAAAAAGAAA"
"chr14","15386894","15387394","JH378114","15957391","15957789","201","570497","GCTGAGTGCAGTGGCTCACGCCTGTAATCCACTTTAGCAGGCCAAAATAGGGGGATCACTTTGAGGCCACGAGTTTGAGACCTGCCTGGGCAACATAGTGAGGCCCCGTCTCTACAAAAATCTTTAAATATTAGAATAACTTTGGGAGGCCGAGGCGGGTGGATCACGAGGTCAAGAGATTGAGACCATCCTGGCCAACATGGTGAAATCCCATCCCTACTAAAGCTACAAAAATTAGCCAGGCGTGGTGGTGTGCGCCTGTAGTCCCAGCTACTCGGGAGACTGAGGCAGGAGAATTGCTTGAATCCGCGTGGCGGAGGTTGCAGTGAGCTGAGATCGCGCCACTGCACTCCAGCCTGGTGACAGAGCGAGACTCCGTCTTAAAAAAAAAAAAAAAAAAAAAAAAAAAAACTTCGGAGGTTGCGGTGAGCCAAGATCACGCCATTGTACTCCAGCCTGGGCCACAAGAGCAAAACTCCGCTTCAAAAAAAAAAAAAAAAA","GCAAGGAACGGTGGCTCATGCCTGTCATCCCAGCACTTTGGGAGGCTAAGGAGGGTGGATTACCGAAGGTCATGAGTTTGAGACCAGCCTGACCAACATGGTGAAAACCCCATCTCTACTAAAAATACAAAAAATTAGCCAGATACAGCTATGCGGCAGACTGGGGCAGGAGAATCGCTTGGACCCAAACCCCATCTCTACTAAAAATACAAAAAATTAGCCGGATACAGCTATGCGGGAGACTGGGGCAGGAGAATCGCTTGGACCCGGGAGGCAGAGATTGCAGTGAGATGAGACCATGCCATTGCTCTCTAGCTTGTGCGATGAGAACAAGACTCTGTCTCAAAAAAAAAAAAAAAAAAAAAAAAAAAAAAAAAAAAAAAAGAGAGAGAGAGAAAA"
"chr14","20140478","20141066","JH378118","18053084","18053501","250","2087394","GCCAGGCGAGGTGGCTCATGCCTGTAATCCCAGCACTTTGGGAGGCTGAGGTGGGTGGAACACTTGAGGTCAGGAGTTCAAGACCAGCCTGGCCAACATGATGAAACCCCCATCTCTACTAAAAACACAAAAATTAGCCAGGAGTGGGCAGGGTGCGGTGGCTCACGCCTGTAATCCCAGCACTTTGGGAGGCTGGGATGGGTGGATCATGAGGTCGGGAGTTCAAGACCAGCCTGGCCAAGATGGTGAAACCCTGTCTCTATTAAAACTTCAAAAATTAGCCAGGCACGGTGGCAGGTGCTTGTAATCCCAGCTACTTGGGAGGCTGAGGCAGGAGAATCACTTGAAACTGGGCGGCAGAGGTTGCAGTGAGCCAAGATCGCGCCACTGGACTCCAGACTGGGCGACACAGTGAGATACCGTCTCAAAAAAAAAAAAAAAAAAAATTAGCCAGGAGTGGTGGCGGAAATCCCAGCTACTTGAGAGGCTGAGGCAGGAGAATCGTTTGAACCCAGGAGGCAGAGGTTGCAGTGAGCCAAGATCTTGCCATTGCACTCCAGCTTGGGAGACAAGAGCAAAACTCTGTCTC","GGCTGGGCGCAGTGGCTCACACCTGTAATCCCAGCACTTAGGGAAGCTGAGGCGAGTAGATCACCTGAGGTCAGGAGTTAGAGACCAGCCTGGCCATCATGGTGAAACCCCGTCTCTACTAAAGATACCAAAAATTAGCTGAGTGTGGTGCTGGGTGCCTGTAATCCCAGAAACTCAGGGTGCCTGTAATCCCAGCAACTCAGGGTGCCTTTAATCCCAGCAACTGAGGGTACCAGTAATCCCAGCAACTCAGGGTGTCTTTAATCCTAGCAACTGAGGGCACCTGTAATCCCAGCAACTCAGGAAGCTGAGACAGGAGAAGTACTTGAACCCAGAAGGCAGAGGTTGCAGTGAGCCGATATTGCACCATTGCACTCCAGTCTGGGCAACAAGAGTGAAACTCTGTCTCAAAAAAAAA"
"chr14","32019134","32019479","JH378197","6655183","6655524","67","25363951","GGCTGGGGCAGTGGCTCACTGTAATTCCAGCACTTGGCCAAGGCAGGTGGATCACCTGAGGTCAGGAGTTCAAGACCAGCAGGGCCAACATGGTGAAACCCTATCTCTAAAAATAAATAAATAAATAAATAAATAAAATAAAATAAAATAAAATAAAAAATAAAAAAAATTAGCTGGGCGTTGTGGTGGGCGCCTGTAATCCCAGCTACTTGGGAGGCTGAGGCAGGAGGATCGCTTGAACCTGGAAGGCAGAGGTTGCAGTGAGCCGAAATCACATAATTGCACTCCAGCCTGGGCGACAAGAGCAAAACTCCATCTCAAAAAAAAAAAAAAAAAAAAAAAAAAA","GGCCGGGCGCAGTGGCTCATGCCTGTAATCCCAGCACTTTGGGAGGCAGAGGCGGGCAGATCACCCAAGGTCAGGAGTTCAAGACCAGCCTGGCTAACATGGTGAAACCCCATTTCTACTAAAAATACAAAAAAAAAAAAAAAAAAAAAAAAAAAAAAAAAAAAAAATTAGCTGAGCGAGGTGGTGGGCACATGTAATCCCAGCTACTTCGGAGACTAAGGCAGGACAATTGCTTAAGCCTGGGAGGCAGAGGTTGTAGTAAGCTGAGATCACACCATTGCACTCCAGCTTGAGCAACAAGAGCGAAACTCCGTCTCAAAAAAAAACCCAAAAAACAAAAAA"
"chr14","39734996","39735596","JH378118","18053084","18053501","237","21681912","GGCTGGGCGCGGTGGCTCATGCCTGTAATCCCAGCATTTTGGGAGGCCGAGGCGGGTGGATCACCTGAGGTCAGGAGTTTGAGACCAGCCTGGCCAACATGGTGAAACCCTGTCTCTACTAAAAATGCAAAAATTAGGCTGGTGCAGTGGCTCACGCCTGTAATCACAGCACTTTGGGAGGCCGAGGTGGGCGGATCACGAGGTCAGGAGATCGAGACCATCCTGGCTAATACAATGAAACCCCGTCTCTATGAAAAATACAAAAAATTAGCCGGGCGTAGTGGCAGGCGTCTGTAGTCCCAGCTACTCAGGAGGCTGAGGCAGGAGAATGGCATGAACCTGGGAGGCGGAGCTTGCAGTGAGCCGAGATTGCGCCACTGCACTCCAGCCTGGGCGACAGCGAGACTCTGTCTCAAAAAAAAAAAAAAAAATTAGCTAGGCATGGTGGCGCATGCCTGTAATCCCAGCTACTTGGGAGGCTGAGGCAGGAGAATCGCTTGAACCTGGGAGGCAGAGGCTGCAGTGAGACAAGATCACGCCATTGCACTCCAGCCTGGGCAACAAGAGTGAAACTCCATCTTCCCCCTACCAAAAAAAAAAA","GGCTGGGCGCAGTGGCTCACACCTGTAATCCCAGCACTTAGGGAAGCTGAGGCGAGTAGATCACCTGAGGTCAGGAGTTAGAGACCAGCCTGGCCATCATGGTGAAACCCCGTCTCTACTAAAGATACCAAAAATTAGCTGAGTGTGGTGCTGGGTGCCTGTAATCCCAGAAACTCAGGGTGCCTGTAATCCCAGCAACTCAGGGTGCCTTTAATCCCAGCAACTGAGGGTACCAGTAATCCCAGCAACTCAGGGTGTCTTTAATCCTAGCAACTGAGGGCACCTGTAATCCCAGCAACTCAGGAAGCTGAGACAGGAGAAGTACTTGAACCCAGAAGGCAGAGGTTGCAGTGAGCCGATATTGCACCATTGCACTCCAGTCTGGGCAACAAGAGTGAAACTCTGTCTCAAAAAAAAA"
"chr14","49081899","49082239","JH378114","14264965","14265292","65","34816934","GGCCAGGTACAGTGGCTCATGCCTGTAATCTCAGCATTTTGGGAGGCTGAGGCAGGCAGATCACCTGAGGTCAGGAGTTCGTGACCAGCCTGACCAGTGAAACCCTGTCTCTACTGAAAAAAATAAAATAAAATAAAATAAAAATAAAAATTAGCTGGGTGTGGTGGTGGGCGCCTGTAATCCCAGCTACTCGGCAGGCTGAGGCAGGAGAATTGCTTGTACCCGGGAGGCGGAGGTTGCAGTGAGCCAAGATCATGCCATTGCACTACAGCCTAGGTGACAAGAGCAAAACTCTGTCTCAAAACAAAACAACAACAACAACAACAACTAAAAAAAAAAAA","GGCCAGGCGCGGTGGCTCAAGCCTGTAATCCCAGCACTTTGGGAGGCCGAGGCGGGTGGATCATGAGGTCAAGAGATCGAGACCATCCTGGTCAACATGGTGAAACCCCGTCTCTACTAAAAACAGAAAAAAAATAAAAATAAAAATAATTAGCTGGGCATGGTGGAGCATGCCTGTAATCCCAGCTACTCAGGAGGCTGAGGCAGGAGAATTGCCTGAACCGAGGAGGCGGAGGTTGCGGGGAGCCAAGATCGCGCCATTGCACTCCAGCCTGGGCAACAAGAGCGAAACTCCGTCTCAAAAAAAAAAAAAAAAAAAAAAAAAAAAA"
"chr14","54833704","54834332","JH378118","18053084","18053501","272","36780620","GGCCAGGTGCAGTGGCTCACTCCTGTAATTCCAGCACTTTGGGAGGCTGCCGGTGGATCACCTGAGGTCAGGAGTTCGAGATCAGCCTGGCCAACATGGTGAAACCCCGTCTCTACTAATAATACAAAAATTAGCCAGGCAAGGCCGGGCGCAGTGGCTCACACCTGTAATCCCAGCACTTTGGGAGGCCGAGGCGGGCGGATCACCTGAGGTCGGGAGTTCAAGACCAGCCTGACCAACATGGAGAAACCCCATCTCTACTAAAAATACAAAATTAGCTGGGCATGGTGGCACATGCCTGTAATCCCAGCTACTAGGGAGGCTGAGGCAGGCGAATCGCTTGAACCTGGGAGGTGGAGGTTGCGGTGGGCCGAGATGGTGCCATTGCACTCTAGCCCGGGCAACAAGAGCGAAACTCTGTCTCAAAAAAAAAAAAAAAAAAAAAAAAATTAGCCAGGCATGGTAGCACACCCTTGTAATCCCAGCTACTCGGGAGGCTGAGGCAGGAGAGTTGCTTGAACCCGAGAGACGGAGGTTGCAGTGAGCTGAGATCGTGCCATTGCACTCCAACCTGGGTGACAAGAGTGAAACTCCATCTCCAAAAAAAAAAATAAATAAAATAAATAAAA","GGCTGGGCGCAGTGGCTCACACCTGTAATCCCAGCACTTAGGGAAGCTGAGGCGAGTAGATCACCTGAGGTCAGGAGTTAGAGACCAGCCTGGCCATCATGGTGAAACCCCGTCTCTACTAAAGATACCAAAAATTAGCTGAGTGTGGTGCTGGGTGCCTGTAATCCCAGAAACTCAGGGTGCCTGTAATCCCAGCAACTCAGGGTGCCTTTAATCCCAGCAACTGAGGGTACCAGTAATCCCAGCAACTCAGGGTGTCTTTAATCCTAGCAACTGAGGGCACCTGTAATCCCAGCAACTCAGGAAGCTGAGACAGGAGAAGTACTTGAACCCAGAAGGCAGAGGTTGCAGTGAGCCGATATTGCACCATTGCACTCCAGTCTGGGCAACAAGAGTGAAACTCTGTCTCAAAAAAAAA"
"chr14","55277737","55278067","JH378148","10302642","10302970","61","44975095","GGCCGGGTGCAGTGGCCCACCTCTGTAATCCTAACACTTTGGGAGGCCAAGGCAGGCAGGTCACTTGAGGTCAGGAGTTCAAGACTAACCTGGCCAACATGGTGAAACCCCGTCTCTACTAAAAATACGAAAATTAGCCGGGCTTCATGATGCATGCCTGTAATCCCAGCTACTAAGGAGGCTGAGGCAGAAGAATCTCTTGAACCCATGAGGTTGCAGTGAGCTGAGATCTCGCCATTGCACTCCAGCCTGGAGGACAAGAGCGAAACTCTGTCTCAAAAAAATAAAATAAAATAAATAAGAATAAAATAATAATAAAAGGCAAAAAGAA","GGCCGGGCGCGGTGGCTCAAGCCTGTAATCCCAGCACTTTGGGAGGCCGAGGCGGGTGGATCACGAGGTCAAGAGATCGAGACCATCCTGGTCAACATGGTGAAACCCCGTCTCTACTAAAAATACAAAAAATTAGCTGGGCATGGTGGTGGGTGCCTGTAATCCCAGCTACTCAGGAGGCTGAGGCAGGAGAATTGCCTGAACCCAGGAGGCGGAGGTTGCGGTGAGCCGAGATCGCGCCATTGCACTCCAGCCTGGGTAACAAGAGTGAAACTCTGCCTCAAAAAAAAAAAATAAAATAAAATAAAATAAAATAAAATAAAATAAAA"
"chr14","55822103","55822700","JH378118","18053084","18053501","240","37769019","GGCCAGGCGCAGTGGCTCACGCCTGTAATCCCAGCACTTTAGGAGGCCGAGGCAGGTGGATCGCCTGAGTTCAGGAGTTCAAACCCACCCTGGCCAACATGGTGAAACCCTGCCTCTACTAAAAAACAAAAAAATGGCCAAGCGTGGTGGCTCACGCCTGTAATTCCAGCACTTTGGGAGGCTGAGGCAGGCGAATCACGAGGTCAGGAGATCGAGACCATCCTGGCTAACATGGTGAAACCCCATCTCTATTAAAAATACAGAAAATTAGCCAGGCGTGGTGGTGGACGCCTGTAGTCCCAGCTTCTTGGGAGGCTGAGGCAGGAGAATGGCATGAACCCGGGAGGCAGAGCTTGCAGTGAGCTGAGATTGCGCCAGTGCACTACAGCCTGTGGGACAGAGCAACTCCGTCTCAAAAAAAAAAAAAATTAGCTGGGCATGGTGGCATATGCCTGTAATCCCAGCTACTAAGGAGGCTGAGGCGGGAGAATCGCTTGAACCCGGGAGGCAGAGGTTGCAGTGAGCCGAGATTGCGCCATTGCACTCCAGTCTGGACAACAAGAGTGAACTGTGTCTCAAAAAAAAAAAAAAAAAAAGA","GGCTGGGCGCAGTGGCTCACACCTGTAATCCCAGCACTTAGGGAAGCTGAGGCGAGTAGATCACCTGAGGTCAGGAGTTAGAGACCAGCCTGGCCATCATGGTGAAACCCCGTCTCTACTAAAGATACCAAAAATTAGCTGAGTGTGGTGCTGGGTGCCTGTAATCCCAGAAACTCAGGGTGCCTGTAATCCCAGCAACTCAGGGTGCCTTTAATCCCAGCAACTGAGGGTACCAGTAATCCCAGCAACTCAGGGTGTCTTTAATCCTAGCAACTGAGGGCACCTGTAATCCCAGCAACTCAGGAAGCTGAGACAGGAGAAGTACTTGAACCCAGAAGGCAGAGGTTGCAGTGAGCCGATATTGCACCATTGCACTCCAGTCTGGGCAACAAGAGTGAAACTCTGTCTCAAAAAAAAA"
"chr14","55860214","55860812","JH378118","18053084","18053501","246","37807130","GGCCGGATGCAGTGGCTCACGCCTGTAATCCCAGCACTTTGGGAGGCCAAGGCAAGCGGATCACCTGAGGTCAGGAGTTCAAGACCAGCCTGGCCAGCATGGTGAAACCCCTTCTCTACTAAAAATACAAAAATTAGCCGGGGCCTTGCGTGGTGGCTCACACCTGTAAATCCCAGCGCTTTGGGAGGCCGAGGCAGGCGGATCACCTGAGGTCGGGAGTTCAAGAACAGCCTGACCAACATGGAGAAACCCCGTCTCCACTAAAAATAGAAAAATAGCCGGGCATGGTGGCGCATGCTTGTAATCTCAGCTACTCGGGAGGCTGAGGCAGGAGATCACTTGAACCCAAGAGGCAGAGGTTGCGGTGAGCCGAGATCGCGCCATTGCACTCCAGCCTGGGCAACAAAGAGCGAAACTCCGTCTCCAAAAAAAAAAAAAAAAAATTAGCCGGGCGTGGTGGCACATACCTGTAATCCCAGCTATTCAGGAGGCTGAGGCAGGAGAATCCCTTGAACCCGGGAGGCAGAGATGGCAGTGAGCTGAGATCACGCCATTGCACTCCAGCCTGGGTGAGAGGAGTGAAACTCCGTCTAAAAAAA","GGCTGGGCGCAGTGGCTCACACCTGTAATCCCAGCACTTAGGGAAGCTGAGGCGAGTAGATCACCTGAGGTCAGGAGTTAGAGACCAGCCTGGCCATCATGGTGAAACCCCGTCTCTACTAAAGATACCAAAAATTAGCTGAGTGTGGTGCTGGGTGCCTGTAATCCCAGAAACTCAGGGTGCCTGTAATCCCAGCAACTCAGGGTGCCTTTAATCCCAGCAACTGAGGGTACCAGTAATCCCAGCAACTCAGGGTGTCTTTAATCCTAGCAACTGAGGGCACCTGTAATCCCAGCAACTCAGGAAGCTGAGACAGGAGAAGTACTTGAACCCAGAAGGCAGAGGTTGCAGTGAGCCGATATTGCACCATTGCACTCCAGTCTGGGCAACAAGAGTGAAACTCTGTCTCAAAAAAAAA"
"chr14","56736257","56736880","JH378206","6546474","6546861","276","50189783","GGCCAGGCACAGTGGCTCATGCCTGTAATCCCTGCACTTTGGGAGGCCAAGGCGGGTGGATCACCTGAGGTCAGGAGTTCGAGACTAGCCTGGCCAACATGGTTGGCCATCTCTTCTAAAAATACAAAAAATTAAGTTGGGCATGGTGGCTCATGCCTGTAATCCCAGCATTTTGGGAGGCCAAGGCAGGTGGATCATAAGGTCAAGAGATTGAGACCATCCTGGCCAACATGGTGAAACCCCATCTCTACTAAAAATACAAAAATTAGCTGGGCGTGGTGGTAGCACACACCTGCAGTCCCAGCTGCTCAGGAGGCTGAGGCAGGAGAATCACTTGAACCCGGGAAGCAGAGGTTGCAGTGAGCCGAAATTGCACCACTGCACTCCAGCCTGGCGACAAAGCAAGACTCCGTCAAAAAAAAAAAAAAAAAAAAAAAAATTAGCCAGGAGTGGTGGCACGTGCCTATAGTTCCAGCTACTCGGGAGGCTGAGGCAAGAGATTTGCTTGAACCTGGGAAGCAGAGGTTGCATATATTGCAGTGAGCCAAGATTATGCCATTGCACTCCAGCCTGGGCAACAAGAGTGAAAATCTGTCTAAAAAGAAAAAAAAAAGAAAAGAAAAA","GGCCACACATGGTGGCTAACGCCTGTAATCCCAGCACTTTGGGAGGCCAAGTCGGGTGGATCATGAGGTCAGGAGACCAAGACCATCCTGGCCAAATGGTGAAACCCCGTCTCTACTAAAAATACAAAAATTAGCTGGGCATGGTGGCGTGTGCCTGTAATCCCAGCTACTCAGGAGGCTGAGGCAGGACAATTGCCTGAACCCAGGAGAATTAGCTGGGCATGGTGGCGTGTGCCTGTAATCCCAGCTACTCAGGAGGCTGAGGCAGGACAATTGCCTGAACCCAGGAGGCGAAGGTTGCGGTGAGCCGAGATTGTGCCATTGCACTCCAGCCTGGGTAACAAGAGCGACACTCTGTCTCAAAAAAAAAAAAAAAAAAAAAAAAAAA"
"chr14","56744047","56744674","JH378118","18053084","18053501","281","38690963","GGCCGGGTGCGGTGACTCACATCTATAATCCCAGCACTTTGGGAGGCCAAGGCAGGTGGATCACCTGAGGTCAGGAGTTCAAGACCAGCCTGGCCAACTTGGTGAAACCCCATCTCTACTAAAAAATATAAAAATTTGCCAGGTGCGGTGGCTCATACCTGTAATCCCAGCACTTTGAGAGGCAGAGGTGGGTGGATCACGAGGTCAGGAGTTCGAGACCAGCCTGGCCAATGTGGTGAAACCCCATCTCTACTAAAAATACAAAAATTAGCCGGGTGTGGTGATGCGTGCCTGTAGTCCCAGCTATTCGGGAGGTTGAGGCAGGAGAATGGCGTGAACCAGGAAGGCGGAGCTTTCACTGAGCGGAGATCGCACCACTGCACTCCAGCCTGGGCGACGGAGCGAGACTCTGTCTCAAAAACAAAACAAAACAAAAAAACAAACAAACAAAAAAACATTATCCGGGTGTGGTGGTGGGCGCCTGTAATCCCAGCTACTTGGGAGGCTGAAGCAGGAGGATTGCTTGAACCTGGGAGGTGGAGGTTGCAGTGAGCTGAGATCACGCCTCTGCACTGCAGGCTGGACGACAAGAACAAAACTCTGAATCAACAACAACAACAACAAAAAA","GGCTGGGCGCAGTGGCTCACACCTGTAATCCCAGCACTTAGGGAAGCTGAGGCGAGTAGATCACCTGAGGTCAGGAGTTAGAGACCAGCCTGGCCATCATGGTGAAACCCCGTCTCTACTAAAGATACCAAAAATTAGCTGAGTGTGGTGCTGGGTGCCTGTAATCCCAGAAACTCAGGGTGCCTGTAATCCCAGCAACTCAGGGTGCCTTTAATCCCAGCAACTGAGGGTACCAGTAATCCCAGCAACTCAGGGTGTCTTTAATCCTAGCAACTGAGGGCACCTGTAATCCCAGCAACTCAGGAAGCTGAGACAGGAGAAGTACTTGAACCCAGAAGGCAGAGGTTGCAGTGAGCCGATATTGCACCATTGCACTCCAGTCTGGGCAACAAGAGTGAAACTCTGTCTCAAAAAAAAA"
"chr14","58283278","58283584","JH378115","34663603","34663898","52","23619675","CCGGGTGCGGTGGCTCACGCCTGTAATCCCAGCACTTTGGGAAGCTGAGGTGGGTGGATCATTTGAGGTCAAGAGTTCTAGACCAGCCTGGCCAACATGGTGAAACCCTACTTCTAATAAACACACACACACACACACACACACACACACACACACAAATTAGCCAGCAGGCACCTGTAATCCCAGCTACTCGGAAGGCTGAGGCAGGACAATCGCTTGAACCTGGGAGGCCAGAAGTTGCAGTGAGCCAAGATCATGCCACTGCACTCCAGTCTGGGTGACAAGAGCAAGACTCCATTTCAAAAAA","GGCCTGGTGAAGTGGCTCACGCCTGTAATCCCAACACTTTGGGAGGCTGAGATGGATGGCTCATTTGAGGTCAGGAGTTCTAGACCAGCCTGGCCAACATGGTAAAAGCCCACCTCTACCAAAAATACAAAAACAAAAACAAAAAAATTTTAGCCAACAGGCACCTTTAATCCCAGCTACTCAGGAGGCTGAGGCAGGAGAATTGCTTGAATCTGGGAGGCCAGAAGTTGCAGTGAGCCAGGATCACACCACTGCACTCCATCCTAGGCGACAAGAGCAAGACTCCAAAAAAAAAA"
"chr14","59226808","59227410","JH378118","18053084","18053501","257","41173724","GGCTGGGCGCTGTGGCTCATGCCTGTAATCCCAGCACTTTAGGAAGCCAAGGGAGGTGGATCACCTGAGGTCAGAGTTCAAGTCCGGCCTGACCAACATGGCGAAACCCAGTCTCTACTAAAAATACAAAATTGGCCAGGCGTGGGGTGGCTCACACCTGTAATCCCAGCACTTTGGGAGGCCGAAGTGGGTGGATCACTTGAGGTCAGGAGTTTGAGACCAGCCTGGTTAACATGGTGAAACCCCATCTCTACTAAAAATACAAAAATTAGCCAGGCATGGTGGCAGGCGCCTGCAATCCCAGTTACTCAGGAGGCTGGTGCAGGAGAATCGCTTAAACCTAGGAGGCAGAGGTTGCAGTGAACTGAGATCGTGCCATTGCACTCCAGCCTGGGTAACAACAGCAAGACTTCATCTCAAAAAAAAAAATACATAATTATAATTAGCTGGGCGTGTTGGCGAGCGCCTGTAGTCCCTGCTACTTGGGAGGCTGAGGCAGGGGAATCACTTGAACCTGAGAGGCGGAGGTTGCAGTGAGCCAAGTCACGCCATTGCATTCCAGCCTCGGCAACAAGAGCAAAACTCCATCTCAAAAAAAAAAAA","GGCTGGGCGCAGTGGCTCACACCTGTAATCCCAGCACTTAGGGAAGCTGAGGCGAGTAGATCACCTGAGGTCAGGAGTTAGAGACCAGCCTGGCCATCATGGTGAAACCCCGTCTCTACTAAAGATACCAAAAATTAGCTGAGTGTGGTGCTGGGTGCCTGTAATCCCAGAAACTCAGGGTGCCTGTAATCCCAGCAACTCAGGGTGCCTTTAATCCCAGCAACTGAGGGTACCAGTAATCCCAGCAACTCAGGGTGTCTTTAATCCTAGCAACTGAGGGCACCTGTAATCCCAGCAACTCAGGAAGCTGAGACAGGAGAAGTACTTGAACCCAGAAGGCAGAGGTTGCAGTGAGCCGATATTGCACCATTGCACTCCAGTCTGGGCAACAAGAGTGAAACTCTGTCTCAAAAAAAAA"
"chr14","62992080","62992681","JH378118","18053084","18053501","256","44938996","GGCCGGATGCAGTGGCCCACACCTGTAATCCTAGCACTTTGAGAGGCTGAAGCAGGCAGATCACTTGCGGTCAGGAGTTTGAGACCAGCCTGGCCAACATAGTAAAACCTCATCTCTACTAAAAATAGAAAAATTTTCTGACCAGGCACGGTGGCTCGCGCCTGTAATCCCAGCACTTTGGGAGGCCAAGGTGGGCACATTACCTGAGATCAAGAGTTCAAGACCAGCCTGACCAACATGGCAAAACTCTGTCTCTACTAAAAATACAAAATTAGCCGGGCATAGTGGCGCATTCCTGTAATCCCAGCTACTAAGGAGGCTGAGGCAGGAGAATTGCTTGAACCCGGGAGCCGGAGGTTGCAGTAAGCCAAGATTGCGCACTGCACTCTAGGCTGGGCAACAACAGCGAAACTCTGTCTCGAAAAAAAAAAAAAAAAAAATTAGCTGGGCGTGGTGGTGAGTACCTGTAATCCCAGCTACTTGGGAGACTGAGGCAGGAGAATCTCTTGAACCTGGGAGGTAGAGGTTGCAGCGAGCTTAGATCACACCACTGCACTAAAGCCTGGGGGACAAGAGCAAAACTCTATCTCAAAAAAATAAAA","GGCTGGGCGCAGTGGCTCACACCTGTAATCCCAGCACTTAGGGAAGCTGAGGCGAGTAGATCACCTGAGGTCAGGAGTTAGAGACCAGCCTGGCCATCATGGTGAAACCCCGTCTCTACTAAAGATACCAAAAATTAGCTGAGTGTGGTGCTGGGTGCCTGTAATCCCAGAAACTCAGGGTGCCTGTAATCCCAGCAACTCAGGGTGCCTTTAATCCCAGCAACTGAGGGTACCAGTAATCCCAGCAACTCAGGGTGTCTTTAATCCTAGCAACTGAGGGCACCTGTAATCCCAGCAACTCAGGAAGCTGAGACAGGAGAAGTACTTGAACCCAGAAGGCAGAGGTTGCAGTGAGCCGATATTGCACCATTGCACTCCAGTCTGGGCAACAAGAGTGAAACTCTGTCTCAAAAAAAAA"
"chr14","75046278","75046878","JH378118","18053084","18053501","246","56993194","GGCCGGGCACAGTGGCTCACACCTATAATCTCAGTACTTTGGGAGGCCAAGGCGGGCAGATCACTTGAGGTCAGGAGTTCGAGACCACCCTGGCCAACATGGTGAAACCTCATCTCTACTAAAAATACAAAAAACTGGCTGGGTGAAGTGGCTCACGCCTGTAATCCCAGCAGTTTGGGAGGCCAAGGCGGGCCAATCACGAGGTCAGGAGTTCGAGACCAGCCTGGCCAATATGGTGAAACCCCGTCTCTATTAAAAATTCAAAAATTAGCTGGATGTGGTGGCAGGCACCTACAATCCCAGCTACTTGGAAGGCTGAGGCAGGAGAGTCTGCTTGAAACCAGAAGGCGGAGGTTGCAGTGAGTGAGCTGAGAACGTGCCACTGCACTCCAGCCTGGGCGAAAGAGCAAAACGCTGTCTCAGGGGGAAAAAAAAAACTAGCCGGGCATGGTGGCAGGTGCCTGTAATCCCAGCTACTCAGGAGGCTGAGGCAGGAGAATTGCTTGAACCCAGGAGGAGGAGGTTGCAGTGAGTCGAGATCACGTCATTGCACTCCCAGCCTGGCTGATAAGAGCGAAACTCCGTCAAAAAAAAAAAAAAA","GGCTGGGCGCAGTGGCTCACACCTGTAATCCCAGCACTTAGGGAAGCTGAGGCGAGTAGATCACCTGAGGTCAGGAGTTAGAGACCAGCCTGGCCATCATGGTGAAACCCCGTCTCTACTAAAGATACCAAAAATTAGCTGAGTGTGGTGCTGGGTGCCTGTAATCCCAGAAACTCAGGGTGCCTGTAATCCCAGCAACTCAGGGTGCCTTTAATCCCAGCAACTGAGGGTACCAGTAATCCCAGCAACTCAGGGTGTCTTTAATCCTAGCAACTGAGGGCACCTGTAATCCCAGCAACTCAGGAAGCTGAGACAGGAGAAGTACTTGAACCCAGAAGGCAGAGGTTGCAGTGAGCCGATATTGCACCATTGCACTCCAGTCTGGGCAACAAGAGTGAAACTCTGTCTCAAAAAAAAA"
"chr14","83813857","83814442","JH378118","18053084","18053501","240","65760773","GGCCAGGCGCGGTGGCTCACGCCTGTAATCCCAGCACTTTGGGAGGCCGAGGCGGGCGGATCACCTGAGGTCAGGGGTTCAAGACCAGCCTGACCATCCCAGAACTTTGGGAGGCCGAGACGGGTGGATCATGAGGTCAGGAGATCGAGACCATCCTGGCTAACACAGTGAAACCCCATCTCTATTAAAAATACAAAAAATTAGCCGGGCGTGGTGGCAGCTCCTGTAGTCCCAGCTACTCGGGAGGCTGAGGCAGGAGAATGGCGTGAACCCGGGAGGCGGAGCTTGCCGTGAGCCGAGATCGCACCACTGCACTCCAGCCTGCAAGATAGCGAGGCTATGTCTCAGGAAAAAAAAAAAAAAAAAAAAAAAGACCAACCTGACCAACATGGTAAAACCCCATCTCTACTAAAAATACAAAATTAGCCGGGCATGGTGGCAGACGCCTGTAATCCCAGCTACTCAGGAGGCTGAGGCAGGAAAATCACTTGAACCCAGGAGGTGGAGGTTGCGGTGAGCCGAGATCGTGCCATTGCACTCCGGCCTGGGTGACAACAGCGAAACTCCATCTCAAAAAAAAGAAAAA","GGCTGGGCGCAGTGGCTCACACCTGTAATCCCAGCACTTAGGGAAGCTGAGGCGAGTAGATCACCTGAGGTCAGGAGTTAGAGACCAGCCTGGCCATCATGGTGAAACCCCGTCTCTACTAAAGATACCAAAAATTAGCTGAGTGTGGTGCTGGGTGCCTGTAATCCCAGAAACTCAGGGTGCCTGTAATCCCAGCAACTCAGGGTGCCTTTAATCCCAGCAACTGAGGGTACCAGTAATCCCAGCAACTCAGGGTGTCTTTAATCCTAGCAACTGAGGGCACCTGTAATCCCAGCAACTCAGGAAGCTGAGACAGGAGAAGTACTTGAACCCAGAAGGCAGAGGTTGCAGTGAGCCGATATTGCACCATTGCACTCCAGTCTGGGCAACAAGAGTGAAACTCTGTCTCAAAAAAAAA"
"chr14","84224287","84224910","JH378118","18053084","18053501","265","66171203","GGCAGGGTGCAGTGGCTCATACCTGTAATCCCAGCACTCTGGGAGGCCGAGGTGGGCAGATCACTTGAGCTCAGGAGTTTGAGACCAGCCTGGCCAACATAGTGAAACCCCATCTCTACTAAAAATACAAAATTAGGCTGGGCACAGTGACTCACGTCTGTAATCCCAGCACTTTGGGAGGCCGAGGCTGGTGGATCACAAGGTCAGGAGATCAAGACCATCCTGTCCAACATAGTGAAACCCCATCTCTACTAAAAATACAAAAATTAGCTGGACGTGGAGGTGCACATCTGTAGTCCCAGCTACTTGTGAGGCTGAGGCAGGAGAACTGCTTGAACCCAGGAGGCGGAGGCTGCAGTGAGCTGAGATTGTGCCACTGCACTCCAGCCTGGGCGACAGAGCGAGACTCTGTCTCAAAAAAAAAAAAAAACAGAAAAAACAAAATTAGCCGGGCATGGTGGTGCACGCCTGTAACCCCAGCTACTTGGGGGGCTGAGGCAGGAGAATTGCTTGAACCTGAGAGGTGGAGGTTTCAGTGAGCCGAGATTGTGCCATTGCCCTCCAGTCTGGGCAACAAGAGCAAAACTCCGTCTCAAAAAAAAAAAAAAGAAAAAAAAAGAAGAA","GGCTGGGCGCAGTGGCTCACACCTGTAATCCCAGCACTTAGGGAAGCTGAGGCGAGTAGATCACCTGAGGTCAGGAGTTAGAGACCAGCCTGGCCATCATGGTGAAACCCCGTCTCTACTAAAGATACCAAAAATTAGCTGAGTGTGGTGCTGGGTGCCTGTAATCCCAGAAACTCAGGGTGCCTGTAATCCCAGCAACTCAGGGTGCCTTTAATCCCAGCAACTGAGGGTACCAGTAATCCCAGCAACTCAGGGTGTCTTTAATCCTAGCAACTGAGGGCACCTGTAATCCCAGCAACTCAGGAAGCTGAGACAGGAGAAGTACTTGAACCCAGAAGGCAGAGGTTGCAGTGAGCCGATATTGCACCATTGCACTCCAGTCTGGGCAACAAGAGTGAAACTCTGTCTCAAAAAAAAA"
"chr14","85020958","85021268","JH378108","34510794","34511096","52","50510164","GCCAGGTGCAGTGGCTCATGCCTGTAATTCCAGTACTTTGAGAGGTCGAGACAGGGAGATCACCTGAGGCCAGGAGTTCAAGACTAGCTTGGCCAACATGGCAAAACCCTGTCTCTACTAAAAATGCAAAAAAAAAAAAAAAAAAAAAAAAAAAATTAGCCTGGCATGGTGGTAGACACCTGTAATCCCAGCTACTTGGGAGGCTGAGACAGGAGAACCTCTTGAATCTGGGAGGAGGAGGTTGCTGTGAGCTGAGATCGTGCCACTGCACTCCAGCCTGGGTAACAAGAGAGAAACTCTGTCTCAAAAAA","GGGTGCCGTGTCTCATGCCTGTAATTCCAGCACTTTGGGAGGTCAAGGCAGTCCGATCACCTGAGGTCAGGAGTTTGAGACTAGCCTGGCCAAAATGGTGAAACCCTGTCTCTAGAAAAAATACAAAAAAAAAAAAAAAAAAAAAAAAAAATTAGCTGGATGTAGTGGTGCATACCTGTAGTCCCAGCTACTCTGGAGGCTGAGGCAGGAGAATTGTTTGAACCCAGGAGGCGGAGGTTGCGGTGAGCCGAGATCATGCCATTGCACTCCAGCCTGGGAAACAAGAGTGAAACTCTGTCTCAA"
"chr14","86696589","86696920","JH378203","2698403","2698735","56","83998186","GGCCAGGCACGGTGGCTCATGCCTATAACCAGCACTTTGGAGGCCGAGGCAGGTGGATCACCTGAGGTCAGGAGTTTGAGACTGGCCTGGCCAGCATGGTGAAACTCTGTCTCTACTAAAAAAAAAAAAAAAAAAAAAAAAAAAAAAGTACAAAATTAGCTGGATGTGGTGGTAGGCACCTGTAATCCCAGCTACTTGGGAGGCTGAGGCAGGAGAATCGCTTGAACCCAGGAGGCAGAGATTGCAGTGAGCCAAGATTGCGCCATTGTACTCCACTCTGGGCAATGAGCGAAACTCCGTCTCAAAAAAAAAATAAAATAAAAATAAAATAA","GCCGGGTGCAGTGGCTCATACCTCTAATCCCAGCACTTTGGGAGGCCAAGGCAGGTGATCACCTGTGGTCAGGAGTTCGAGACCAGCCTGGCCAACATGGTGAAACCCTGTCTTTACTAAAAATACAAAAAAAAAAAAAAAAAAAAAAAAAAAAAACTTAGCCCACCATGGTGGTGGGCTCTTGTAGTCCCAGCTACATGGGAGGCTGAGGCAGAAGAATCGCTTGAAGACAGGAGGTGGAGGTTGCAGTGAGCCAAGACTGCGCCATTGCACTCAGCCTGGGTGACGAGCCAAACTCCATCTCAAAAAAAAAAAAAAAAAAAAAAAAAAAAA"
"chr14","86944567","86945185","JH378118","18053084","18053501","274","68891483","GAGCACGGTGGCTCACGCCTGCAATCCCAGCACTTTGGGAGGCCGAGGTGGGTGGATCACCTGAGGTTAGGAGTTTGAGACCAGCCTGGCCAACATGGTGAAACCGTCTCTACTAAAAATGCAAAAAAGTAGGGGCCGGGCACGGTGGCTCACGCCTGTAATCCCAGCACTTTGGGAGTCTGAGGCAGACGGATCACAAGGTCAGGAGATCAAGACCATGGTGAAACTCCGTCTCTACTAAAAATACAAAAAATTAGCTGGGCGTGGTGGTGGGCACCTGTAGTCCCAGCTGCTTGGGAGGCTGAGGCAGGAGAATGGTGTGAACCCGGGAGGCGGAGCTTGCAGTGAGCCGAGATCGCAACACTGCACTCCAGCCTGGGCGACAGAGCGAGACCCTGTCTCAAAAAAAACAAAAATAAACAAAAATAAATAAATACAAAAAAGTAGCCAGGCATGGTGGTGGGTGCCTGTAATCCCAGCTACTTGGGAGGCTGAGGCAGGAGAATCACCTGAACCCGGGAGGTGGAGGTTGCAGTGAGCCAAGACCGTGTCATTACACTCTAGCCTGGGCAACAAGAGCGAAATTCCATCTGAAAAAATAAATAAATAAAAATAAAAA","GGCTGGGCGCAGTGGCTCACACCTGTAATCCCAGCACTTAGGGAAGCTGAGGCGAGTAGATCACCTGAGGTCAGGAGTTAGAGACCAGCCTGGCCATCATGGTGAAACCCCGTCTCTACTAAAGATACCAAAAATTAGCTGAGTGTGGTGCTGGGTGCCTGTAATCCCAGAAACTCAGGGTGCCTGTAATCCCAGCAACTCAGGGTGCCTTTAATCCCAGCAACTGAGGGTACCAGTAATCCCAGCAACTCAGGGTGTCTTTAATCCTAGCAACTGAGGGCACCTGTAATCCCAGCAACTCAGGAAGCTGAGACAGGAGAAGTACTTGAACCCAGAAGGCAGAGGTTGCAGTGAGCCGATATTGCACCATTGCACTCCAGTCTGGGCAACAAGAGTGAAACTCTGTCTCAAAAAAAAA"
"chr14","87180871","87181803","JH378118","18053084","18053501","547","69127787","GGCCATGTGCGGTGGCTCACACCTGTAATCCCAGCACTGTGGGAGGCCAAGGTGGGCGGATCATTTGAGGTCAGGAGTTCTAAACCAGCCTGGCCAATATGGTGAAACACTGTCTCTGCTAAAAATACAAAAAAAGAAAAAGAAAAAAAAAAAAAGGCTGGGCACGGTGGCTCACGCCTGTAATCTCAGCACTTTGGGAGGCTGAGGTGGGTGGATTACCTGAGGTCAGGAGTTCGAGACCAGCCTGGCCAACATGGTGAAACCTTGTCTCTACTAAAAGTATAAAAATTAGCCAGGTGTGGTGGAGGTCGCCTGTAATCCCAGCTACTCAGTAGGCAGAGGCAGAAGAATCCGTTGAACCTGGGAGGCGGAGGTTGCAGTGAGCTGAGATTGCACCAGTGCATTCCAGCCCGGGTGACAAGAGTGAGACTCTGTCTCAAAATAAACAAACAAAAAAATTAGTGGGCCGGGTTCAATGACTCACGCCGGTAATCCCAGCACTTTGGGAGGCCAAGGAAGGCAGGTCACCTGAGGTCGGGAGCTCGAGACCAGCCTGACCAACATGGAGAAACCCCGTCTCTACTAAAAATACAAAATTAGCTGGGCGTGGTGGCACATGCCTGTAATTCCAGCTACTCAGGACGCTGAGGCAGGAGAATTGCTTGAACCCAGGAGGCGGAAGTTGCAGTGAGCCAAGATCATGACATTGCACTCCCGCCTGGGCGCCAAGAGTGAGATTTCGTCTCAAACAAACAAACAAAAAAACGAATTAGTGGAGCGTGGTGGCAGGCACCTAAAGTCCCAGCTATTCAGGAGGCTGAGGCAGGAGAATTGCTTGAACCTGGGAAGTGGAGGTTATAGTGAGCTGAGATCGCGCCATTGCACTCCAGCCTGGGCAACAAGAGTGAGAATCTGTCTAAAAAAAAAAAAGAA","GGCTGGGCGCAGTGGCTCACACCTGTAATCCCAGCACTTAGGGAAGCTGAGGCGAGTAGATCACCTGAGGTCAGGAGTTAGAGACCAGCCTGGCCATCATGGTGAAACCCCGTCTCTACTAAAGATACCAAAAATTAGCTGAGTGTGGTGCTGGGTGCCTGTAATCCCAGAAACTCAGGGTGCCTGTAATCCCAGCAACTCAGGGTGCCTTTAATCCCAGCAACTGAGGGTACCAGTAATCCCAGCAACTCAGGGTGTCTTTAATCCTAGCAACTGAGGGCACCTGTAATCCCAGCAACTCAGGAAGCTGAGACAGGAGAAGTACTTGAACCCAGAAGGCAGAGGTTGCAGTGAGCCGATATTGCACCATTGCACTCCAGTCTGGGCAACAAGAGTGAAACTCTGTCTCAAAAAAAAA"
"chr15","7203590","7204226","JH378118","18053084","18053501","285","10849494","GGCCAGGTGCAGTGGCTCATGCCTCTAATCCCAGCACTTTGGGAGGCCGAGATGGGCAGATCACCGGAGGTCAGGAGTTTGAGACCAGCTTGGCCAAAATGGTGAAACCCTGTCTCTACAAAAAAATACAAAAATGGCTAGGCACGGTGGCTCACACCTGTAATCCCAGCACTTTGGGATACAGGTGGATCATGAGGTCAAGAGATCAAGATCATCTTGGCCAACATGGCAAAACCCTGTCTCTACTAAAAAATACAAAAAATTAGCTGGGCGTGGTGGTGCACGCCTGTAGTCCCAGCTACTCAGGAAACTGAGGCAAGAGAATCGCTTGAACCTGGGAGGTAGAGGTTGCAGTGAGCCGAGATGCACTCCAGCCTGGCAACAGAACAAGACTCCATCTCAAAGAACAAAAACAAAACAAAACAAAACAAAAGACAAGCAAACAAAAAAATACAAAAATTAGCTAGGTGTGGTGGCAGGCGCCTGTAATCCCAGCTACTCAGGAGGCTGAGGCAGGAGAATCGCTTGAACCTGGGAGGCGGAGGTTGCAGTGAGCCAAGATTGTGCCATTGCACTCCAGCCTAGGTGACAAGAGTGAAAAGACGTCTCAAAAACAAAACCAAAAAAAAAAATAAAA","GGCTGGGCGCAGTGGCTCACACCTGTAATCCCAGCACTTAGGGAAGCTGAGGCGAGTAGATCACCTGAGGTCAGGAGTTAGAGACCAGCCTGGCCATCATGGTGAAACCCCGTCTCTACTAAAGATACCAAAAATTAGCTGAGTGTGGTGCTGGGTGCCTGTAATCCCAGAAACTCAGGGTGCCTGTAATCCCAGCAACTCAGGGTGCCTTTAATCCCAGCAACTGAGGGTACCAGTAATCCCAGCAACTCAGGGTGTCTTTAATCCTAGCAACTGAGGGCACCTGTAATCCCAGCAACTCAGGAAGCTGAGACAGGAGAAGTACTTGAACCCAGAAGGCAGAGGTTGCAGTGAGCCGATATTGCACCATTGCACTCCAGTCTGGGCAACAAGAGTGAAACTCTGTCTCAAAAAAAAA"
"chr15","13675429","13675731","JH378235","1186107","1186418","53","12489322","GGCTTGGCACAGTGGCTCATGCCTGTAATCCCAGCACTTTGAGAGACCGAGGCAAGTGGATCCCAGGAGTTCAAGACCAGCCTGGCCAAGATGGTGAAACCCCCCATCTCTACTAAAAATACAAAAAAAAAAAAAAAAAAAAAAAAAGGGCTTAGTGGCTGGCAGCTGTAGTCCCAGCTACTCGGGAGGCTGAGGCAGGAGAATCGCTTGAACCTGGGAAGCGGAGGTTGCAGTGAGCCAAGATCACACCATTGCACTCTAGCCTGGGCAACAAGGGCAAAACTCCATCTCAAAAAAAAAGAA","GGCTGGGCGCAGTGGCTCAAGCCTGTAATCCCAGCACTTTGGGAGGCCGAGGGGGGTGGATCACGAGGTCAAGAGATCAAGACCATCCTGGTCAACATGGTGAAACCCCGTCTCTACTAAAAAAAAAAAAAAAAAAAAAAAAAAAAAAAAAAAATTAGCTGGGCATGGTGGCGTGTAATCCCAGCTACTCAGGAGGCTGAGGCAGGAGAATTGCCTGAACCCAGGAGGCGGAGTTTGCGGTGAGCCAAGATCGCGCCATTGCACTCCAGCCTGGGTAACAAGAGCAAAACTCTGTCTCAAAAAAAAAAAAAA"
"chr15","14837014","14837358","JH378137","13677298","13677634","59","1159716","GCCGGGTATGGTGGCTCATGCCTGTAATTCCAGCACTTTGGGAGGCCGAGGCAGGCGGATCACCTGAGGTCAGGAGTTTGAGACCAGCCTGGCTAACATGGTGAAACTACGTTTCTACTAAAAATACAAAAAAAAAAAAAAAAAAAAAAAAAAAAAAAAAAAAAAAAAAAATTAGCCAGGCGTGGAGGCGCGTGCCTATAATCCCAGTTACTCGGGAGGCCGAGGCAGGAGAATCGCTTGAACCCAGGAGCCGGAGGGTGTAGTGAGCCGAGATCATGCCATTGCGCTCCAGGTTGGGCAACAAGAGCAGAACTCCGTCTCAAAAAAAAAAAAAAAAAAAAAAAA","GGCTGGGCATTGTGGCTCATGCCTGTAATCCCAGCACTTTGGGAGGCCGAGGTGGGCGGATCACCTGAGGTCGGGAGTTCAAGACCAGCCTGGCCACAATGGTGAAACTCTGTCTCTGCTAAAAAAAAAAAAAAAAAAAAAAAAAAAAAAAAAAAAAAAATTAGCCAGGCGTGGTGGCACACGCCTGTAATCCCAGCTATTTGGGAGGCTGAGGCAGGAGAATCGCTTGAACCTGAGAGGTGGAGGTTGCAGTGAGCCAAGATCATACCATTGCACTCCAGCTTGGGAACAAAGAGCAAAACGCCATCTCAAAAACAAAACAAACAAACTGAAAAAA"
"chr15","20684723","20685060","JH378262","266823","267148","57","20417900","GGCTGGGCGTGTTGGCTTACACCTGAAATCCCAGCACTCTGGGAGGCCGAGGCGGGCAGATCACCTGAGGTCAGGGGTTCGAGACCAGCTTGGCCAACATGGTGAAACCCCGTCGCTACTAAAAATACAAAAATTAGCTGGGCATGGTGGTGGGAGCCTGTAATCCCAGCTACTCAGGAGACTGAGGCAGGACAATCGCTTGAACCCAGGAGGCAGAGGTTGCAGCGAGCCGAGATCGTGCCACTGCACTCCAGCCTGGGAGGGAAGAGTGAAAGTCCATAACAACAACAAAACAACAAAACAACAACAACAACAACAACAACATCTCTGAAAGGAAA","GGCCGGGCGCGGTGGCTCAAGCCTGTAATCCCAGCACTTTGGGAGGCCGAGGCGGGTAGATCATGAGGTCAGGAGTTTGAGACCAGCCTGGCCAACATGGTGAAACCCCGTCTCTACTAAAAATACAAAAATTAGCCGGGCATGGTGGCCTGTGCCTGTAATCCTAGCTACCCAGGAAGCTGAGGCAGGAGAATTGCCTGAACCCAGGAGGCGGAGGTTGCGGTGAGCCGAGATCGTGCCATTGCACTCCAGCCTGGGTAACAAGAGCGAAACTCCGTCTCAAAAACAAACAAACAAACAAACAAAAACAAAAAACAAAAAACAAA"
"chr15","20894395","20894976","JH378119","32351107","32351490","257","11456712","GGTGGCTCACACCTGTAATCCCAGCACTTTGGGAAGCCGAGGTAGGTGGATCACCTGAGGTCAGGAGTTAGAGATCAGCCTGGACAACATGGTGAAACCCCATCTCTACTAAAAATACAAAAACTAACCAGGCTTGGTGGCTCACACCTGTAATCCCATCACTTTGGGAGGCCAAGGCGGGTGGACTACTTGAGGTCAGGAGTTTGAGACCAGCCTGGCTAACATGGTGAAACCCCATCTCTACTAAAAATACAAAAATTAGCTGGGCATGGCAGTGCGCGCCTGCAATCCCAGCTACCTGGGAGGCTAAGGCAGGGGAATTGTTTGAACCTGGGAGGCAGAGGTTGCAGTGAGCCGACACTGCACCACTGCACTCCAGCCTGGGTGACAGAGTGAGCCTCCGTCTCAAAAAAAAAAAAAAAAAAAAAAAAAAATTAGCCAGGTGTGGTGGCAGGCACCTGTGATCCCAGCTACTCAGGAGGCTGAGGCAGGAGAATTGCTTGAACCCAGGAGGCGGAGAGTGCAGTGAGCTGAGATCATGCCATTGCACTCCAGCCTGGGTGACAAGAGAGAAACTCTGTC","GGCCAGGTATGGTGGCTCACACCTGTAATCCCAGCACTTTGGGAGGCCAAGGCAGGCAGACCACCTGAGGTCAGGAGTTCGAGATCAGCCTAGCCAACATGGTGAAACCCCATCTCTAGTAAAAATAAAATTAGCCAGGCATGGTGGTGCATGCCTGTAACGCAGGTCAGGAGTTCGAGATCAGCTTAGCCAACATGGTGAAACCCCATCTCTAGTAAAAATAAAATTAGCCAGGCAGGTGGTGCCGCCTGTACTCGGGAGGCTGAGGCAGGAGAATCACTTGAACCCAAGAGGCAGAGGTTGCAGTCAGCCAAGATCATGCCATTGCACTCCAGCCTAAGCAAAAAGAGTAAAACTCAGTCTCAAAACAAAAAAACAAAAAAA"
"chr15","21092189","21092737","JH378206","6546474","6546861","200","14545715","GCCGGGCGTGGTGGCTCACGCCTGGCCTGTAATCCCAGCACTTTGGGAAGCCAAGGCGGGTGGTTCACCTGAGGTCAGGAGTTCAAGACCAGCCTGGCCAACATGGTGAAACCCTGTCTCTACTAATAATACAAAAATTAGCTGGGCATGGTGGTGCATGCCTGTAATCCCAGCTACTTGGGAGGCCGAGGCGAGCAGATCACCTGAGGTCAAGAGTTCGATACCAGCCTGACCAACATAGAGAAACCCCGTCTCTACTAAAAATGCAAAATTAGCCGGGCATGGTGGTGCATGCCTGTAATCCCCAGCTACTCGGGAGGCTGAGGCAGGAGAATCGCTTGAACCTGGGAGGCAGAGGTTGTGGTGAGCTGAGATCACGCCATTGCACTCCAGCCTGGGCTCGAAACTCCATCTTAAAAAAAAAAAAAAAAAAAAGAATCACTTGAACCCAGGAGGTGGAGGTTGCAGTGAGCTGAGAGTGCACCATTGTACTCCAGCCTGGGCGACAACAGCAAAACTCCATCACCTTAAAAAAAAAAAAAAAAAAGA","GGCCACACATGGTGGCTAACGCCTGTAATCCCAGCACTTTGGGAGGCCAAGTCGGGTGGATCATGAGGTCAGGAGACCAAGACCATCCTGGCCAAATGGTGAAACCCCGTCTCTACTAAAAATACAAAAATTAGCTGGGCATGGTGGCGTGTGCCTGTAATCCCAGCTACTCAGGAGGCTGAGGCAGGACAATTGCCTGAACCCAGGAGAATTAGCTGGGCATGGTGGCGTGTGCCTGTAATCCCAGCTACTCAGGAGGCTGAGGCAGGACAATTGCCTGAACCCAGGAGGCGAAGGTTGCGGTGAGCCGAGATTGTGCCATTGCACTCCAGCCTGGGTAACAAGAGCGACACTCTGTCTCAAAAAAAAAAAAAAAAAAAAAAAAAAA"
"chr15","21150084","21150391","JH378158","10397018","10397312","55","10753066","GGCCGGGCATGGTGGCTTATGCCTGTAATCCCAGCACTTTGGGAGGCTGAGGTGGGTGGATCACCTGAGGTCAGGAGTTCAAGACCACCCTGGTCAACATGGCAAAATCCTGTCTCTACTAAAAATACAAAATTAGCTGGGCGTGGTGGTGGGCGTCTGCCTGGGTGAGGCAGGAGAATCGCTTGAACCCAAGAGGCAGAGGTTGGAGTGAGCCAAGATCGTGCCATTGCACTCCAGCCTGGGCAACGAGAGTGAAACCCCATCTCAGAAAAAAAAAAGAAAAAGAAAAAGAAAAAAGTAAAAAAAAA","GGCTGAGCACAGTGGCTCACACCTGTAATCCCAGCACTTTGGGAGGCCGAGGCGGGTGGATCACCTGAGATCAGGAGTTCAAGAACAGCCTGACCAACATGGTGAAACCTATCTCTACTAAAAATACAAAATTAGCCTGGCATGGTGGCGCGTGCCTGTAATCTGGCTGAGGCAGAAGAATCGCTTAAACCCAGAGGCAGAGATTGCAGTGAGCCAAGATTGTGTCATTGCACTCCAGCCTGGGCAACAAGAGCAAAACTCCATCTCAGAAAAAAAAAAAAAAAGAAGAAAAAAA"
"chr15","21563578","21564184","JH378118","18053084","18053501","255","3510494","GGCCAGGCATGGTGGCTCACACCTGTAATCGCAGCACTTTGGGAGACTGAGGCAAGCAGATCACCTGAGGTTAGAAGTTCAAGACCAGCCTGGCCAACACAGTGAAACCCCATCTCTACTAAAAATACAAAAAAATGGCCGGGTGCAGTGGCTCATGCCTGTAATCCCAGCACTTTGGGAGGCTAAGGCAGGGGGAATCACAAGGTCAAGAGATCAAGACCATCCTGGTAAAACCCCGTCGGTACTAAAAATACAAAAATTAGCTGGGTGAGGTGGCATGCACCTGTAGCCCCAGCTACTCGGGAGGCTGAGACAGGAGAATCACTTGAACCTGGGAGGCAGAGGTTGCAGTGAGCTGAGATCGCACCACTGCACTCCAGCCTGGCAACAGAGGAAGACTCTGTCTAAAACTAATAATAATAATAATAATAATAATAAAATTAGCTGGGAGTAGTGGCGGGCACCTGTAATCCCAGCTACTTGGGGGGGCTGAGGCAGGAGAAAAGCTTGAACCCGGGAGGTGAAGGTTGCAGTAAGCCAAGATCACGCCATTGCACTCCAGCCCGGGCAACAAGAGCGAAACTTCGTTTCAAAAAAAAAAAAAAAA","GGCTGGGCGCAGTGGCTCACACCTGTAATCCCAGCACTTAGGGAAGCTGAGGCGAGTAGATCACCTGAGGTCAGGAGTTAGAGACCAGCCTGGCCATCATGGTGAAACCCCGTCTCTACTAAAGATACCAAAAATTAGCTGAGTGTGGTGCTGGGTGCCTGTAATCCCAGAAACTCAGGGTGCCTGTAATCCCAGCAACTCAGGGTGCCTTTAATCCCAGCAACTGAGGGTACCAGTAATCCCAGCAACTCAGGGTGTCTTTAATCCTAGCAACTGAGGGCACCTGTAATCCCAGCAACTCAGGAAGCTGAGACAGGAGAAGTACTTGAACCCAGAAGGCAGAGGTTGCAGTGAGCCGATATTGCACCATTGCACTCCAGTCTGGGCAACAAGAGTGAAACTCTGTCTCAAAAAAAAA"
"chr15","22132229","22132799","JH378118","18053084","18053501","233","4079145","GGAGGCCAAGGTGGGCGAATCACCGGTGGTCAGGAGTTTGAGACTAGCCTGGCCAACATGGTGAAACCCCGTCTCTACTAAAAAATACAAAAATTAGGCCGAGTGTGGTGGCTCATGCCTGTAATCCCAGCAGTTTGGAAGGCCAAGGCGGGCAGATCACCTGAGGTCAGGAGTTCAAGACCAGCCTGGCCAACACAGTGGAACCCTGTCTCTACTAAAAATACAAAAAAAATTTGCCAGGCATGGTGGTGTGTGTGCCTATAATCCCAGCTACTCAGGAGACTGAGGCAAGAGAACTGCATGAACCCCAGAGGGAGAGGCTGCAGTGAGCTGAGATCGTACCACTGCACTCCAGCCTGGGTGACAGGGCAGGACTCCGTCTCAAAAAAAAAAAAAAAAAAAAAAAATTAGCCAGGTGTGGTGGCGAGCACCTGTAATCCTAGGTACTTGGGAGGCTGAGAAAGGAGAACCACTTGAACCCCGGAGGCAGAGGTTGCAGTGAGTGGAGATTGTGCGCCATTGCACTCCAGCCTGGGTGACAAGTGTGAAATTCTGCCTCAAAAAAAAAAAA","GGCTGGGCGCAGTGGCTCACACCTGTAATCCCAGCACTTAGGGAAGCTGAGGCGAGTAGATCACCTGAGGTCAGGAGTTAGAGACCAGCCTGGCCATCATGGTGAAACCCCGTCTCTACTAAAGATACCAAAAATTAGCTGAGTGTGGTGCTGGGTGCCTGTAATCCCAGAAACTCAGGGTGCCTGTAATCCCAGCAACTCAGGGTGCCTTTAATCCCAGCAACTGAGGGTACCAGTAATCCCAGCAACTCAGGGTGTCTTTAATCCTAGCAACTGAGGGCACCTGTAATCCCAGCAACTCAGGAAGCTGAGACAGGAGAAGTACTTGAACCCAGAAGGCAGAGGTTGCAGTGAGCCGATATTGCACCATTGCACTCCAGTCTGGGCAACAAGAGTGAAACTCTGTCTCAAAAAAAAA"
"chr15","23508255","23508883","JH378118","18053084","18053501","275","5455171","GGTCGGGTGTGGTGGCTCATGCATGTAATCCTGGCACTTTGGGAGGCCGAGGCGGGTAGATCACCTGAGGTCACGAGTTTGAGACCAGCCTGACCAACATGGTAAAACTTTGTTTCTACTACAAATACAAAAAATTGGCCAGGCTCGGTGGCTTCCGCCTGTAATCCCAGCACTTTGGGAGGCCGGGGTGCATGGATCACCTGAGGTCAGGACTTCGAGACCAGCCTGGCCAACATGGTGAAACCCCATCTCTACTAAAAATACAAAAAAAAAAAAAAAAATGAGCCAGGCATATTGGTGGGCGCCTGTAATCCCAGCTACTTGGAAGGCTGAGACAGGAGAATCACTTGAACCTGGGAGGCGGAGATTGCAGTGAGCCGAGATCATGCCACTGTACTCCATCCTGGGTGACAAGAGTGAGACTGCATCTCAAAAAAAAAAAAACCAAAAAACCAAAAAAAAACAAAAAATTAGTCAACCGTAGTGGTGGGCCCCTATAATCTCAGCTGCTCAGGAGGCTGAGGCAGTAGAATCACTTGATCCCAGGAGGTGGAGGTTTCAGTGAGCTGAGATCATGCCATTGTACTCCAGCCTGGGCAACAAGAGCGAAACTCTATCTCAAAAAATAA","GGCTGGGCGCAGTGGCTCACACCTGTAATCCCAGCACTTAGGGAAGCTGAGGCGAGTAGATCACCTGAGGTCAGGAGTTAGAGACCAGCCTGGCCATCATGGTGAAACCCCGTCTCTACTAAAGATACCAAAAATTAGCTGAGTGTGGTGCTGGGTGCCTGTAATCCCAGAAACTCAGGGTGCCTGTAATCCCAGCAACTCAGGGTGCCTTTAATCCCAGCAACTGAGGGTACCAGTAATCCCAGCAACTCAGGGTGTCTTTAATCCTAGCAACTGAGGGCACCTGTAATCCCAGCAACTCAGGAAGCTGAGACAGGAGAAGTACTTGAACCCAGAAGGCAGAGGTTGCAGTGAGCCGATATTGCACCATTGCACTCCAGTCTGGGCAACAAGAGTGAAACTCTGTCTCAAAAAAAAA"
"chr15","23602365","23603005","JH378118","18053084","18053501","286","5549281","GGTCGGGTGTGGTGGCTCATGCATGTAATCCTGGCACTTTGGGAGGCCGAGGCGGGTAGATCACCTGAGGTCACGAGTTTGAGACCAGCCTGACCAACATGGTAAAACCTTGTTTCTACTACAAATACAAAAAATTGGCCAGGCTCGGTGGCTTCCGCCTGTAATCCCAGCACTTTGGGAGGCCGGGGTGCATGGATCACCTGAGGTCAGGACTTCGAGACCAGCCTGGCCAACATGGTGAAACCCCATCTCTACTAAAAATACAAAAAAAAAAAAATGAGCCAGGCATATTGGTGGGCGCCTGTAATCCCAGCTACTTGGAAGGCTGAGACAGGAGAATCACTTGAACCTGGGAGGCGGAGATTGCAGTGAGCCGAGATCATGCCACTGTACTCCATCCTGGGTGACAAGAGTGAGACTGCATCTCAAAAAAAAAAAAAACCAAAAAACCAAAAAAAACCAAAAAATTAGTCAACCGTAGTGGTGGGCCCCTATAATCTCAGCTGCTCAGGAGGCTGAGGCAGTAGAATCACTTGATCCCAGGAGGTGGAGGTTTCAGTGAGCTGAGATCATGCCATTGTACTCCAGCCTGGGCAACAAGAGCAAAACTCTATCTCAAAAAAAAAAAAAAAAAAGAAAAA","GGCTGGGCGCAGTGGCTCACACCTGTAATCCCAGCACTTAGGGAAGCTGAGGCGAGTAGATCACCTGAGGTCAGGAGTTAGAGACCAGCCTGGCCATCATGGTGAAACCCCGTCTCTACTAAAGATACCAAAAATTAGCTGAGTGTGGTGCTGGGTGCCTGTAATCCCAGAAACTCAGGGTGCCTGTAATCCCAGCAACTCAGGGTGCCTTTAATCCCAGCAACTGAGGGTACCAGTAATCCCAGCAACTCAGGGTGTCTTTAATCCTAGCAACTGAGGGCACCTGTAATCCCAGCAACTCAGGAAGCTGAGACAGGAGAAGTACTTGAACCCAGAAGGCAGAGGTTGCAGTGAGCCGATATTGCACCATTGCACTCCAGTCTGGGCAACAAGAGTGAAACTCTGTCTCAAAAAAAAA"
"chr15","23603280","23603615","JH378109","21565230","21565567","55","2038050","GGCCAGGCGCGGTGGCTCATGCCTATAAACTCAGCACTTTGAGAGGCTGAGGCGGGTGGGTCACCTGAGGTCAGGAGTTAGAGACCAGCCTGGCCAACATGGTGAAACCGTGTTTCTACTAAAGATACAACATTAGCCAGGCATGGTGGCGCATGCCTGTAATCCCAGCTACTAGGGAGGCTGCGGCAGGAGAATCGCTTGAACGCAGGAGGTGAAGGTTGCAGTGAGCTGAGATCGTGCCATTGCACTCCAGCCTGGGTGACAAGAGCGAAACTCCATCCCAATCAATCAATCAATCAATCAATCAATTAAATTAAAAAAATAAAAAGAAAGAAA","GGCCGGGCGCGGTGGCTCAAGCCTGTAATACCAGCACTTTGGGAGGCCGAGGCGGGTGGATCACGAGGTCAAGAGATCGAGACCATCCTGGTCAACATGGTGAAACCCCGTCTCTACTAAAAATACAAACAATTAGCTGGGCATGGTGGCGGGTGCCTGTAATCCCAGCTACTCCAGAGGCTGAGGCAGGAGAATTGCCTGAACCCAGGAGACGGAGGTTGCGGTGAGCCAAGATCGCGCCATTGCACTCCAGCCTGGGTGACAAGAGCGAAACTCCGTCTCAATAAATAAATAAATAAATAAATAAATAAAAATAAAATAAATAAATAAATAAATAA"
"chr15","38315253","38315599","JH378169","5922203","5922541","56","32393050","GCCAGACACGGTGGCTCACGCCTGTAATCCCAGCACTTTGGGAGGCCGAGGCGGGTGGATCACCTGAGGTCAGGAGTTCGAGACCAGCCTGGCCAACATGGCGAAATCCTGTCTCTACTAAAAATACACACACACACACACACACACACACACACACACACACACATACACACACAAAATTAGCTGGGCATGGTGGCAGGTGCCTGTAATCCCAGCTACTTGGGAGGCTGAGGCAGGAGAATCACTTGAACCTGGGAGGCGGAGATTGCAGTGAGCCAAGATCATGCCATTGCACTTCAGCCTGGGCAACGAGAGTGAAACTCTGTCTCAAAAAAAAAAAAAAAAAA","GGCCAAGGGTGGTGGCTCACACCTGTAATCCCAACACTCTGGGAGGCCAAGGTGGGTGGATCACCTAAGGTCAGGAGTTCAAGACCAGCATGGCCAATATAGTGAAACTCTGTCTCTACTAAAAATACACACACACAAAAAAAAACAAAACACAAAAAAAACCACAAAATTAGCCGGGCATGGTGGCATGTGCCTGTAATCCCAGCTACTCAGGAGGCTGAGGCAGGAGAATCACTTAAACCCAGGAAGCGGAGGTTGCAGTGAGCCAAGATTGCGCCACTGCACTCCAGCCTAGGTGACAAGAGCAAAACTCTGTCTCAAAAAAAAAAAAAAAAAAAA"
"chr15","39410478","39411079","JH378118","18053084","18053501","249","21357394","GGCCGGGCACGGTGGCTCACGCCTGTAATCCCAGCACTTTGGGAGTCTGAGGTGGGCAGATCCACCTGAGGTCAGGGGTTCAAGACCAGCATGGCCAACATGGTGAAACCTCATCTCTACTAAAAATACAAAAATTAGGCTGGGTGCGGTGGCTCACGCCTGTAATCCCAGCACTTTGGGAGGCCAAGGCAGGTGGATCACCTGAGGTCAGGAGTTCGAGACCAGCATGGCCAACATAGCGAAAATCCGTCTCTACTAAAAACACAAAAATTAGCCAGGTGTGTTGGCTTACACCTGTAATCCCAGCTACACAGGAGGCTGAGGCAGAAGAATCACTTGAATCCAGGAGGTGGAGGTTGCAGTGAGCCGAGATCGCGCCACTGCCCTCCAGCCTGGGTGACAGAGCAAGACACCATCTCAAAAAAAAAAAAAAAAAAATTAGCTGGGCATGGTCACAGGTGCCCCTAATCCCAGCTACTCAGGAGGCTGAGGCAGGAGAATTGCTTGAACCCAGGAGACGGAGGTCACAGTGAGCGGTAATTGTGCCATTGCACTTCAACCTGGGTGACAAGAGCAAAAGTCCATCTCAAAAAAAAAAAAAA","GGCTGGGCGCAGTGGCTCACACCTGTAATCCCAGCACTTAGGGAAGCTGAGGCGAGTAGATCACCTGAGGTCAGGAGTTAGAGACCAGCCTGGCCATCATGGTGAAACCCCGTCTCTACTAAAGATACCAAAAATTAGCTGAGTGTGGTGCTGGGTGCCTGTAATCCCAGAAACTCAGGGTGCCTGTAATCCCAGCAACTCAGGGTGCCTTTAATCCCAGCAACTGAGGGTACCAGTAATCCCAGCAACTCAGGGTGTCTTTAATCCTAGCAACTGAGGGCACCTGTAATCCCAGCAACTCAGGAAGCTGAGACAGGAGAAGTACTTGAACCCAGAAGGCAGAGGTTGCAGTGAGCCGATATTGCACCATTGCACTCCAGTCTGGGCAACAAGAGTGAAACTCTGTCTCAAAAAAAAA"
"chr15","45225530","45226131","JH378133","19690365","19690767","253","25535165","GGCCGGGCACAGTGGCTCATGCCTGCAGTTCCAGCACTTTTGGAGGCCGAGGCAGGCCGATCACTTGAGGTCAGGAGTTCGAGACCACCCCGGCTAACGTGGTGCAACTCCATCTCTACTAAAAATACAAAATTGGCCGGGTGCGGTGGCTCATGCCTGTAATCCCAGCACTTTGGGAGGCCGAGGCGGATGGATCACCTCAGGTCAGGAGTTCGAGACCAGCCTGGCCAATGTGGTGAAACCCCGTCTCTACTAATAATACAAAAATTAACTGGGTGTGGTGGTGGGCACCTATAATCCCAGCTACTCGGGAAGCTGAGGCAGGAGAATCACTTGAACCTGGGAGGTGGAGATTGCAGTGAGCTGAGATGGTGCCATTACACTCCAGCCTGGGCAACGAGAGTGAAACTCTGTCTCTAAATAAATAAATACAAAATTAGCCGGGCATGGTGGCGGATGCCTATAATCACAGCTACTTGGGAGGCTGAGGCAAGAGAATCACTTGAACCTGGGAGGTGGAGGTTGCAGTGAGCTGAGATCAAGCCATTGCACTCCAGCCTGGGCAAAAAGAGTGAAACTCTGTCTCAAAAAAAAGAAAGAAA","GGCCAGGCACAGTGGTTCATGTCTGTAATCAGCATTTTGGGAGGCTGAGGCGGGAGAATCACCTGAGGCCAGGAGTTCTAGATGAGCCTGGGCAAATAGTGACAACCTGTCCCTACAAAAAAATTTAAAATTAGCCAGGATTGAGACCATCCTGGCTCACGTGGTGAAACCCCATCTTTACTTAAAATACTTAAAATGCAAAAAACATTTTTTTTTGTATTTTATTTAAAATACAAAAAAACTAGGCAGGCATGTTGGCACGTGCCTGTAGTCCCAGATACTTGGGAGGCTGAGGCAAGAGAATCACTTGAACCCAGGAGGTGGAGGTTGCAGTGAGCCGAGATCATACCACTGCACTCCAGCCTGGGTGACAAGAGTGAAACTCTGTCTCAAAAAAAAACAA"
"chr15","46581057","46581661","JH378118","18053084","18053501","254","28527973","GGCCGGGCGCGGTGGCTCACGCCTGTAGTCCCAGACTTTGGGAGGCCGAGGTGGGCGGATTGCCTGAGGTCAGGAGTTCAAGACCAACCTGGCCAACATGGTGAAATGCCGTCTCTACTAAAAATACAAAAATTAGGCCGGGCACGGTGGCTCATGTCTATAATCCCAGCACTTTGGGAGGCCGAGGTGGGCGGATCACGAGGTCAGGAGATCGAGACCATCCTGGCTAACACGGTGAAACCCCGTCTCTACTAAAAACACAAAAAATTAGCCGGGCGTGGTGGCAGGCACCTGTAGTCTCAGCTACTCAGGAGGCTGAGGCAGGAGAATGGCGTGAACTTGGGAGGCGGAGCTTGCAGTGAGCCAAGATTGTGCCACTGCACTCCAGCCTGGGCAACAGAGCGAGACTCTGTCTCAAAAAAAAAAAAAAAAATTAGCCAGGTGTGGTGGCAGGTGCCTGTAATCCCAGCTAATTGGGAGGCTAAGGCAGGAGAATCTCTTGAACCCAGGAGGCAGAGGTTGCAGTGAGCCAAGATTTCGCCATTACACTCCAGCCTGGGCAACAAGAGCTAGACTCCATCTCAAAAATAAATAAATAAAATAAA","GGCTGGGCGCAGTGGCTCACACCTGTAATCCCAGCACTTAGGGAAGCTGAGGCGAGTAGATCACCTGAGGTCAGGAGTTAGAGACCAGCCTGGCCATCATGGTGAAACCCCGTCTCTACTAAAGATACCAAAAATTAGCTGAGTGTGGTGCTGGGTGCCTGTAATCCCAGAAACTCAGGGTGCCTGTAATCCCAGCAACTCAGGGTGCCTTTAATCCCAGCAACTGAGGGTACCAGTAATCCCAGCAACTCAGGGTGTCTTTAATCCTAGCAACTGAGGGCACCTGTAATCCCAGCAACTCAGGAAGCTGAGACAGGAGAAGTACTTGAACCCAGAAGGCAGAGGTTGCAGTGAGCCGATATTGCACCATTGCACTCCAGTCTGGGCAACAAGAGTGAAACTCTGTCTCAAAAAAAAA"
"chr15","46659994","46660594","JH378118","18053084","18053501","247","28606910","GCTGGGCATGGTGGCTTACGCCTGTAATCCCAGCACCTTGGGAGGCTGAAGTGAGCAAATCACCTGAGTTCAGGAGTTCAAGACCAGCCTGGCCAACATGGTGAAAACCCATCTCTATTAAAAATTACAAAAATGGCCAGACACGGTAGCTCACGCCTGTAATCCCAGCACTTTGGGAGGCTGAGGCGGGCAGATCACCTGAGGTTGGGAGTTGGAGACCAGCTTGACCAACATGGAGAAACCCCCTCTCTACTAAAAATACAAAATTAGCCAGGCGTGGTGGCACATGCCTGTAATCCCAGCTACTTGGGAGGCTGAGGCAGGAGAATCACTTCAACCCGGAAGGTGGAGGTTGTGGTGAGCTGAGATTGTGTCATTGCACTCTAGCCTGGATAACAAAGGCAAAACTCAGTCTCAAAAAAAAAAAAAATTACAAAAATTAGCTGGCGTGGTGGCAGGTGCCTATAATCCCAGCTACTCAGGAAGCTGAGGCAGGAGAATCACTTGAAACCAGGAGGCAGAGGTTGCAGTGAGCTGAGACCACGCCATTGCCCTCCTGCCTGGGTGACAAGAGTGAAACTCCATCTCAAAAAAAAAAAAA","GGCTGGGCGCAGTGGCTCACACCTGTAATCCCAGCACTTAGGGAAGCTGAGGCGAGTAGATCACCTGAGGTCAGGAGTTAGAGACCAGCCTGGCCATCATGGTGAAACCCCGTCTCTACTAAAGATACCAAAAATTAGCTGAGTGTGGTGCTGGGTGCCTGTAATCCCAGAAACTCAGGGTGCCTGTAATCCCAGCAACTCAGGGTGCCTTTAATCCCAGCAACTGAGGGTACCAGTAATCCCAGCAACTCAGGGTGTCTTTAATCCTAGCAACTGAGGGCACCTGTAATCCCAGCAACTCAGGAAGCTGAGACAGGAGAAGTACTTGAACCCAGAAGGCAGAGGTTGCAGTGAGCCGATATTGCACCATTGCACTCCAGTCTGGGCAACAAGAGTGAAACTCTGTCTCAAAAAAAAA"
"chr15","46772064","46772669","JH378118","18053084","18053501","251","28718980","GGCTGGGTGCAATGGCTCATGCCTGTAATTCCAGTGTTTTGGGAGGCCGAGGCAGGTGGATCACTTGAGATCAGGAGTTCGCGACCAACCTGGCTAACATGGTGAAACCCCGTCTCTACTAAAAATACAAAAAATTGGCCAGGAGCGGTGGCTCAAACCTGTAATTCCAGCACTTTGGGAGGCCGAGGGGGGCAGATCACGATGTTTAGGAGTTTGAGATCAGACTGACCAACATGGTGAAACCCCATCTCTACTAAAAATACAAAAATTAGCCAGGCGTGGTGGTGCATGTCTGTAATCCCAGCTACTTGGGAGGCTGAGGCAGGAGAGTTGCTTGAAGCCGGGAGGTGGAGGTTGCAGTGAGCTGAGATCACACCACTGCACTCCAGCCTGGGCGACAGAGCAAGACTGTCTCAAAAAAAAAAAAAAAAAAAAAAATTAGCCAGCTTGGTGGCGGGCATCTGTAATCCCAGCTACTCGGGAGGCTGAGGCAGGAGAATCACTTGAACCCAGGAGGCAGAGGTCGCAGTGAGCCAAGATCACGCCATTGTACTCCAGCCTGGGCAACAAGAGCAAAACTCCATCTCAAAAAACAAAAAATAAAAA","GGCTGGGCGCAGTGGCTCACACCTGTAATCCCAGCACTTAGGGAAGCTGAGGCGAGTAGATCACCTGAGGTCAGGAGTTAGAGACCAGCCTGGCCATCATGGTGAAACCCCGTCTCTACTAAAGATACCAAAAATTAGCTGAGTGTGGTGCTGGGTGCCTGTAATCCCAGAAACTCAGGGTGCCTGTAATCCCAGCAACTCAGGGTGCCTTTAATCCCAGCAACTGAGGGTACCAGTAATCCCAGCAACTCAGGGTGTCTTTAATCCTAGCAACTGAGGGCACCTGTAATCCCAGCAACTCAGGAAGCTGAGACAGGAGAAGTACTTGAACCCAGAAGGCAGAGGTTGCAGTGAGCCGATATTGCACCATTGCACTCCAGTCTGGGCAACAAGAGTGAAACTCTGTCTCAAAAAAAAA"
"chr15","48446925","48447526","JH378118","18053084","18053501","252","30393841","GGCCAAGTGCAGTGGCTCACGTTTGTAATCCCAGCACTTTGGGAGGCCGAGGCGGGTGGATCACCTGATGTCAGGGGTTTGAAACCAGCCTGGCCAACATGGTGAAACCCCATCTCTAATAAAAATACAAAACTGGCCAGGTGCAGTGGCTCATGCCTGTAATCCCAGCACTTTGAGAGACCAAGGGAGGCAGATCACCTGAGGTCAGGAGTTCCAGACCAGCCTAGCCAACATGGTGAAACCCTATCTCTACTAAGAGTACAAAAATTAGCCTGGCGTGGTGGCAGGCGCCTGTAATCCCAGCTACTCAGAAGGCTGAGGCAGGAGAATCACTTGAACCCAGGAGGCGGAGGTTGCAGTGAGCCGAGATTGAGCCACTACACTCCAGCCTGGGTGACAAGAACAAGACTCTGTCTCAAAAAAAAAAAAAAAAAAAGCCGGTCATGGTGGCACATGCCTATAATCCCAGCTTCTTGGGAGGCTGAGGCAGGAGAACCACTTGAACCTGGGAGGTGGAGGCTGCAGTGAGCCGAAATTGTGCCATTGCACTCTAGCCTGGGCAACAAGAGCAAAACTCTCTCAAAAAAAAAAAAAAAAAAAAA","GGCTGGGCGCAGTGGCTCACACCTGTAATCCCAGCACTTAGGGAAGCTGAGGCGAGTAGATCACCTGAGGTCAGGAGTTAGAGACCAGCCTGGCCATCATGGTGAAACCCCGTCTCTACTAAAGATACCAAAAATTAGCTGAGTGTGGTGCTGGGTGCCTGTAATCCCAGAAACTCAGGGTGCCTGTAATCCCAGCAACTCAGGGTGCCTTTAATCCCAGCAACTGAGGGTACCAGTAATCCCAGCAACTCAGGGTGTCTTTAATCCTAGCAACTGAGGGCACCTGTAATCCCAGCAACTCAGGAAGCTGAGACAGGAGAAGTACTTGAACCCAGAAGGCAGAGGTTGCAGTGAGCCGATATTGCACCATTGCACTCCAGTCTGGGCAACAAGAGTGAAACTCTGTCTCAAAAAAAAA"
"chr15","59372839","59373447","JH378118","18053084","18053501","260","41319755","GGCCAGGATCAGTGTCTCACACCTGTAATCCTAGCACTTTGGGAGGCTAAGGTGGGCGGATTACTTGAGGTCAGGAGTTTGAGACCAGCCTGGGCAACATGGTGAAACCCCGTCTCTACTAAAAATACAAAAATTAGCTGGGCATAGGCCAGGAGTGGTGGCTTACGCCTGTAATTCCAGGACTTTGGGAGGCTGAGGCGGGCAGATCATGAGGTCAGGAGATTGAGACCATCCTGGCTAACATGGTGAAACCTCATCTCTACTAAAAATACAAAAATTAGCCAGTCGTGGTGGTAGGCGCCTGTAGTCCCAGCTACTTGAGAGGCTGAGGCAGGAGAATCACTTGAATCCGGGAGGTGGAGGTTGCAGTGAGCCGAGATTATGCCACTTCACTCCAACCTGGTGACAGAGCAAGACTCCGTCTAAAAAAAAAAAAAAAAATTAGCTGGGTGTGGCGGGCACTTGCAATCCCAGCTACTTAGGAGGCTGAGGCAGGAGAACCGCTTGAACCTGGGAGGTAGAGGTTCCAGATCACGCCATTGCACTCCTGCTTGGGCAACAAGAGTGACACTCCATCTCAAAAAAACAAAAAAAAAAAAGAAAAAGAAA","GGCTGGGCGCAGTGGCTCACACCTGTAATCCCAGCACTTAGGGAAGCTGAGGCGAGTAGATCACCTGAGGTCAGGAGTTAGAGACCAGCCTGGCCATCATGGTGAAACCCCGTCTCTACTAAAGATACCAAAAATTAGCTGAGTGTGGTGCTGGGTGCCTGTAATCCCAGAAACTCAGGGTGCCTGTAATCCCAGCAACTCAGGGTGCCTTTAATCCCAGCAACTGAGGGTACCAGTAATCCCAGCAACTCAGGGTGTCTTTAATCCTAGCAACTGAGGGCACCTGTAATCCCAGCAACTCAGGAAGCTGAGACAGGAGAAGTACTTGAACCCAGAAGGCAGAGGTTGCAGTGAGCCGATATTGCACCATTGCACTCCAGTCTGGGCAACAAGAGTGAAACTCTGTCTCAAAAAAAAA"
"chr15","64220715","64221335","JH378118","18053084","18053501","268","46167631","CCAGGCACAGTGGCTCATACCTGTAATCCCAGCACTTTGGGAGCCCAAGGCGGGCAGATCACCTGAGGTCAGGAGTTCGAGACCAGCCTGGACAACATGGAGAAACTCCATCTCTACTAAAAATACAAAATGAGGCCGGGCACAGTGGCTCACACCTATAATCCCAGCACTTTTGGAGGCCGAGACAGGCAGCTCACGAGGTCAGGAGTTCAAGACCAGCCTGGCCAGCATGGTGTAACCCCGTTTCTACTAAAAATACAAAAATTAGCCAGGCATGGTGGTGCGTGCCTGTAGTCCTCAGGAGGCTGAGGCAGGAGAATCGCTTGAATCTGGGAGGCGGAGCTTGCAGTCAGCTGAGATCAGGCTACTGCACTGCAGCTTGGGCAACAGAGTGAGACTCCGTCTCAAAAACAAACAAACAAACAAACAAAACACAACAAAATTAGCTGGGCATGGTGGCAGGTGCCTGTAATCCCAGCTACTCAGCTACTCAGGAGGCTGAGGCAGGAGAGTCACGTGAACCTGGGAGGCAGAGGTTGCAGTGAGCCAAGATCACGCCATTGCACTCCAGCCTGGGCAACAAGAGGGAAATTACATCTCAAAAAAAAAAAAAAAAAAAAA","GGCTGGGCGCAGTGGCTCACACCTGTAATCCCAGCACTTAGGGAAGCTGAGGCGAGTAGATCACCTGAGGTCAGGAGTTAGAGACCAGCCTGGCCATCATGGTGAAACCCCGTCTCTACTAAAGATACCAAAAATTAGCTGAGTGTGGTGCTGGGTGCCTGTAATCCCAGAAACTCAGGGTGCCTGTAATCCCAGCAACTCAGGGTGCCTTTAATCCCAGCAACTGAGGGTACCAGTAATCCCAGCAACTCAGGGTGTCTTTAATCCTAGCAACTGAGGGCACCTGTAATCCCAGCAACTCAGGAAGCTGAGACAGGAGAAGTACTTGAACCCAGAAGGCAGAGGTTGCAGTGAGCCGATATTGCACCATTGCACTCCAGTCTGGGCAACAAGAGTGAAACTCTGTCTCAAAAAAAAA"
"chr15","65873443","65873774","JH378165","3784440","3784761","45","62089003","GGCCAGGCACGGTGGCTCACACGTGTAATCCCAGCACCTTGGGAGACCGAAGCAGGTGGATCACCTGAGGTCAGGAGTTTGAGGCCAGCCTGGCCGATATGGTGAAACCCTATCTCTATTAAAAATACCAAAAAAAAAAAAAAAAAAAAAAAAACCTGCTGGGCGTGGTGGCGCACGCCTGTAATCCCAACTACTCAGGAGGCTGAGGCAGGAGAATCACTTGAATCCAGGAGGCAGAGGTTGCAGTGAGCCGAGATCGCGCCATTGCACTCCAGCCTGGGCAACAAGAGCGAAACTCGGTCTCAAAAAAAAAAAAAAAAAAAGAAAAGAAA","GGCCGGGCGCGGTGGCTCAAGCCTGTAATCCCAGCACTTTGGGAGGCCGAGGCAGGTGGATCATGAGGTCAAGAGATCAAGACCATCCTGGTCAACATGGTGAAACCCCGTCTCTACTAAAAATACAAAAAAAAAAAAAAAAAAACTAGCTGGGCGTGGTGGCGCATGCCTGTAATCCCAGCTACTCAGGAGGCTGAGGCAGGAGAATTGCTTGAACCCAGGAGGCGGAGGTTGCGGTGAGCCCAGATCGCGCCATTGCACTCCAGCCTGGGTAACAAGAGCAAAACTCCATCTCAAAAAAAAAAAAAAAAAAAAAAAAAAA"
"chr15","70453292","70453944","JH378118","18053084","18053501","292","52400208","GGCCAGGCACGGTGGCTCATGCCTGTAATCCCAACACTTTGGGAGGCTGAGGTAGGTAGATCACCTGAGGTTGAGGTCAGGAGTTTGAGACCAGCCTGGCCAACATGGTGAAACTCTGTCTCTACTAAAAATACAAAAATTTGGCCCGGCGCAGTGGCTCACCTGTAATCCCAGCACTTTGGGAGGCCGAGGCAGGCAGATCACGAGGTCTGGAGATCAAGACCATCCTGGCTAACTCGGTGAAATCCCATCTCTACTAAAAATACGAAAAATTAGCCAGGTGTGGTGGCGGGCACCTGTAGTCCCAGCTACTTGGGAGGCTGAGGCAGGAGAATGGCGTGAACCTGGGAGGTGGAGCTTGCAGTGGGCCAAGATCACGCCACTGCACTCCAGCCTGGGCAACAGAGTGAGACTCTGTCTCAAAATAAAATAACATAAAATAAAATAAAGTAATATAAAATAAAAATACAAAAATTAGCTGGGCATGGTAGCGGGTACCTATAATTCCAGCTACTTGAGAGGCTGAGGCTGGAGAATCACTTGAATCTGGGAGGTGGAGGTTGCAGTGAGCCAAGATTGCACCATTGCACTCCAGCCTGGGCAACAAGAGCCAAACTCCGTATCAAAAAAAAAAAAAAAAAGAAAAAGAAAAA","GGCTGGGCGCAGTGGCTCACACCTGTAATCCCAGCACTTAGGGAAGCTGAGGCGAGTAGATCACCTGAGGTCAGGAGTTAGAGACCAGCCTGGCCATCATGGTGAAACCCCGTCTCTACTAAAGATACCAAAAATTAGCTGAGTGTGGTGCTGGGTGCCTGTAATCCCAGAAACTCAGGGTGCCTGTAATCCCAGCAACTCAGGGTGCCTTTAATCCCAGCAACTGAGGGTACCAGTAATCCCAGCAACTCAGGGTGTCTTTAATCCTAGCAACTGAGGGCACCTGTAATCCCAGCAACTCAGGAAGCTGAGACAGGAGAAGTACTTGAACCCAGAAGGCAGAGGTTGCAGTGAGCCGATATTGCACCATTGCACTCCAGTCTGGGCAACAAGAGTGAAACTCTGTCTCAAAAAAAAA"
"chr16","217191","217526","JH378138","4229795","4230103","77","4012604","ATTTTGGGAGGCTGAGATGAGTGATGAGCGGATCACCTGAGGTCAGGAGCTCGAGACCAGTCTGGCCAACACGGTGAAACCCTGTCTCTACTAAAAGTACCAAAAAAATTAGCCAGGCATGGCAGTGGGCGCCTGTAATCCCAACTACTCGGGAGGCTGAGGCAGGAGAATCACTTGAACCTGGGAGGTGGATGTAGCAGTGAGCCGGGATCGTGCCACTGAACTCCAGCCTGGGCGATAAGATCAAAACTCTGTCTCTCTCTCACACACACACACACACACACACACACACACACACACACCCCCAAAAAAAAAAACAAAAAAAAGAAAAAGAAA","CACTTTGGGAGGTGAAGGCGGGCAGATCACCTGAGGTCAGGAGTTCGAGACCAGCCTGGCCAACATGGTGAAACCCCGCCTCTACTAAAAATACAAAAATTAGCCAGGTGTGACACTAGGCATCTGTAATCCCAGCTACTTGGGAGGCTGAGACAGGAGAATCACTTGAACCCAGGAGGCGGAAGTTGCAGTGAGCCAAGATCATGCCATTGCACTCCAGCCTGGGTGACAGGAGCAAAACTCTGTCTCAAAAAAAAAAAAAAAAAAAAAAAAAAAAAAAAAAAAAAAAGAAAAGAAAAGAAAAGTAAA"
"chr16","384893","385508","JH378118","18053084","18053501","265","17668191","GGCCGGGCGTGGTGGCTAACACGGGTAGTCCTAGCACTTTGGGAAGCCAAGGCAGGCAGATCACTTGAGGTCAGGAGTTTGAGATCAGTCTGGCCAACATGGTGAAACCACGCCTCTACTAAAAATACAAAAGTTATGGCCGAGCGTGGTGGCACGCGCCTGTAATCCCAGCACTTTGGGATGCTGAGGCAGGCGCATCACCTAAGGTCGGGAATTCAAGACCAGCCTGACCAACATGGAGAAACCACGTTTCTACTAAAAATACAAAATTAGCCGGGTGTGGTGGCACATGCCTGTAGTTTCAGCTACTCAGGAGGCTGAGGCAGGAGAATCACTTGAATCCGGGAGGCGGAGATTGTGGTGAGCCGAGATCGGGCCATTGCACTCCAGCCTGGGCAACAAGAGAGAAACTCTGTCTCAAAAAAAAAAAAAAAAAATTAGCCAGGCATGGTAGCCTGTGCCTGTAATCCCAGCTACTTGGGAGGCTGAGGCAGGAGAATCGCTTGAACCTGGGAGGCAGAGGTTGCAGTGAGCCGCGATTGCGCCATTGCACTCTCCAGCCTGGGGGAGAAGAGCAAAACTCCATCTCAAAAATAAATAAATAAATAAAAATAAA","GGCTGGGCGCAGTGGCTCACACCTGTAATCCCAGCACTTAGGGAAGCTGAGGCGAGTAGATCACCTGAGGTCAGGAGTTAGAGACCAGCCTGGCCATCATGGTGAAACCCCGTCTCTACTAAAGATACCAAAAATTAGCTGAGTGTGGTGCTGGGTGCCTGTAATCCCAGAAACTCAGGGTGCCTGTAATCCCAGCAACTCAGGGTGCCTTTAATCCCAGCAACTGAGGGTACCAGTAATCCCAGCAACTCAGGGTGTCTTTAATCCTAGCAACTGAGGGCACCTGTAATCCCAGCAACTCAGGAAGCTGAGACAGGAGAAGTACTTGAACCCAGAAGGCAGAGGTTGCAGTGAGCCGATATTGCACCATTGCACTCCAGTCTGGGCAACAAGAGTGAAACTCTGTCTCAAAAAAAAA"
"chr16","1668152","1668787","JH378118","18053084","18053501","287","16384932","GGCCGGGCACGGTGCCTCGTTCCTGTAATCCCAGCACTTTGGGAGGCCAAGGTGGGTGGATCACCTGAGGTCAGGAGTTCGAGACATGCCTGGCCAACATGGCAAAATCCTGTCTTTACTAAAAATACAAAAATTAAGCCGGGCGCTGTGACTCATGCCTGTAATCCCAGCACTTTGGGAGGCCAAGGCGGGCGGATCACAAGGTCAGGAGATTGAGACCATCCTGGCTAACACGGTGAAAACCCGTCTCTACTAAAAATACAAAAAATTAGCCAGGTGTGGTGGCGGGTGCCTGTAGTCCCAGCTACTCGGGAGGCTGAGGCAGGAGAATGGCGTGAACCCGGGAGGCGGAGCTTGCAGTGAGCCGAGATCGTGCCACTGCACTCCAGTCTGGGCAACAGAGCAAGACTCTCTCTCAAAAAGAAACAAACAAAAAAAAAAATGAAAAAAGAAAAATTAGCCAGGCGTGGTGGCGGGTGCCTATAATCTCAGCTACTCGGGAGGCTGAGGCAGAAGTATCATTTGAACCCAGGAGGCGGAGGTTGTAGTGATCCAAGATAGCGCCATTGCACTGCAGCCTGGGTGACAACAGTGAAACTCCGTCTCAAAAAAAAAAAAAAAAAAGAAAGAAAGAAA","GGCTGGGCGCAGTGGCTCACACCTGTAATCCCAGCACTTAGGGAAGCTGAGGCGAGTAGATCACCTGAGGTCAGGAGTTAGAGACCAGCCTGGCCATCATGGTGAAACCCCGTCTCTACTAAAGATACCAAAAATTAGCTGAGTGTGGTGCTGGGTGCCTGTAATCCCAGAAACTCAGGGTGCCTGTAATCCCAGCAACTCAGGGTGCCTTTAATCCCAGCAACTGAGGGTACCAGTAATCCCAGCAACTCAGGGTGTCTTTAATCCTAGCAACTGAGGGCACCTGTAATCCCAGCAACTCAGGAAGCTGAGACAGGAGAAGTACTTGAACCCAGAAGGCAGAGGTTGCAGTGAGCCGATATTGCACCATTGCACTCCAGTCTGGGCAACAAGAGTGAAACTCTGTCTCAAAAAAAAA"
"chr16","2310740","2311369","JH378118","18053084","18053501","271","15742344","GGCCGGGCACAGTGGCTCACGCCTATAATATCAGCACTTTGGGAGACCAAGGCGGGTGGATCACCTAAGGTCAGGAGTTCAAGACCAGCCTGACCAACATGGTGAAACCCCATCTCTACCAAAAATAGAAAACATTAGTCTTGGCCGGGCACGGTGACTCATACCTGTAATTCCAGCACTTTGGGAGGCCGATCACCTGGCGGATCACCTGAGGTCGGGAGTTTGAGACCAGCCTGACCAACATGGAGAAACCCCGTCTCTACTAAAAATACAAAATTAGCTGTGCGTAGTGGCCCATGCGTGTAATCCCAGCTACTCAGGAGACTGAGGCAGGAGAATGGCTTGAACCTGGGAGGCGGAGGTTGTGCTGAGCCAAGATCGCACCATTGCACTCCAGCCTGGGCAATAAGAGTGAAACTCCGTTTCATAAAACAAAAAACAAAAAACAAAAAAAAAACCATTAGCCAGGCATTGTGGCAGGCACCTGTAATCCCAGCTACTCAGGAGGCTGAGGCAGAATGGCTTGAACCGGGGAGGCAGAGGTTGCAGTGAGCCGAGATCGCGCCATTGCACTCCAGCCTGGGCAACAAAAGTAAAACTCTGTCTCAAATAAAAAAAAGAGAGAAAAAA","GGCTGGGCGCAGTGGCTCACACCTGTAATCCCAGCACTTAGGGAAGCTGAGGCGAGTAGATCACCTGAGGTCAGGAGTTAGAGACCAGCCTGGCCATCATGGTGAAACCCCGTCTCTACTAAAGATACCAAAAATTAGCTGAGTGTGGTGCTGGGTGCCTGTAATCCCAGAAACTCAGGGTGCCTGTAATCCCAGCAACTCAGGGTGCCTTTAATCCCAGCAACTGAGGGTACCAGTAATCCCAGCAACTCAGGGTGTCTTTAATCCTAGCAACTGAGGGCACCTGTAATCCCAGCAACTCAGGAAGCTGAGACAGGAGAAGTACTTGAACCCAGAAGGCAGAGGTTGCAGTGAGCCGATATTGCACCATTGCACTCCAGTCTGGGCAACAAGAGTGAAACTCTGTCTCAAAAAAAAA"
"chr16","3075498","3075819","JH378114","26407278","26407597","46","23331780","GGCCAGGCGCGGTGGCTCACACCTGTAATCCCAGCACTTTGGGAGGCCAAGGCGGGCAGATCACGAGGTCAAGAGATCGAGACCATCCTGGCCAACCTGGTGAAACTCTGTCTCTACTAAAAATACCAAAAAAAAAAAAAAAAAAAAAAAAAAAAAGCATGGTGGCAGGTGCCTGTAATCCCAGCTACTTGGGAGGCTGAGGCAGAATTGCTTGAACCCGGGAGGCAGAGGTTGCAGTGAGTTGAGATCATGCCATTGCACTCCAGCCTGGGCAAAAAGAGCGAAACTCTGTCTCAAAAAACAAAACAAAAACAAAAACAAA","GGCCGGGCGCAGTGGCTCAAGCTTGTAATCCCAGCACTTTGGGAGGCCGAGGCGGGTGGATCACGAGGTCAAGAGATCGAGACCATCCTGGTCAACATGGTGAAACCCCGTCTCTACTAAAAATACAAAAAAAAAAAAAAAAAATTAGTTGGGCATGGTGGTGTGTGCCTGTAATCCCAGCTACTCAGGAGGCTGAGGCAGGAGAATTGCCTGAACCCAGGAGGCGGAGGTTGCGGTGAGCCGAGATCGCGCCATTGCACTCCAGCCTGGGTAACAAGAGCGAAACTCCGTCTCAAAAAAAAAAAAAAAAAAAAAAAAAA"
"chr16","3161549","3162150","JH378118","18053084","18053501","252","14891535","CTGGGCACCGTGGCTCACGCCTGTAATCCCAACACTTTGGGAGGCCAAGGCGGGTGGAACACCTGAAGTCAGGAGTTCGAGACCAGTCTGGACAACATGATGAAACCCCGTCTCTACTAAAAATACAAAAAGTAGCCAGGTATGGCCGGGCGCGGTGGCTCACGCCTGTAATCCCGGCACTTTGAGAGGCCGAGGCAGGTGGATCACAAGGTCAGGAGTTCAAGAGCAGCCTGGCCAAGATAGTGAAACCCCGTCTCTACTAAAAGCAAAATTACAGTGCGCCTGTAATCCCAGCTGCTCGGGAGGCTGAGGCAGGAGAATCGCTTGAACCTGGAGGGCGGAGGTTGCAGTGAGCCAAGATCGCTCTACTGCACCCTAGCCTGGGTGACAGAGCAAGACTCTGTATCAAAAAAAAAATAAATAAATAATTAGCCAGGTATGGTGGTGCAGGCTTGTAATCCTAGCTGCTCAGGAGGCTGAGGCAGGAGAATCGATTGAACCCAGGAGACGGAGGTTGCAGTGAGCAGAGATCACACCATTGTACTCCAGCCTGAGTGACAAAAACGAAACTCCGTCTCAAAAAAAAACCAAAAAAACAAAAA","GGCTGGGCGCAGTGGCTCACACCTGTAATCCCAGCACTTAGGGAAGCTGAGGCGAGTAGATCACCTGAGGTCAGGAGTTAGAGACCAGCCTGGCCATCATGGTGAAACCCCGTCTCTACTAAAGATACCAAAAATTAGCTGAGTGTGGTGCTGGGTGCCTGTAATCCCAGAAACTCAGGGTGCCTGTAATCCCAGCAACTCAGGGTGCCTTTAATCCCAGCAACTGAGGGTACCAGTAATCCCAGCAACTCAGGGTGTCTTTAATCCTAGCAACTGAGGGCACCTGTAATCCCAGCAACTCAGGAAGCTGAGACAGGAGAAGTACTTGAACCCAGAAGGCAGAGGTTGCAGTGAGCCGATATTGCACCATTGCACTCCAGTCTGGGCAACAAGAGTGAAACTCTGTCTCAAAAAAAAA"
"chr16","3211652","3212251","JH378118","18053084","18053501","260","14841432","GTCAGACGCAGTAGTTTATGCCTGTAATCCTTGCACTTTGGGAGGCAGGTGGATCACCTGAGGCCAGGAGTTGGAGACCAGCCAGGCCAATATGGCAAAACCCCGTCTCTACTAAAAATACAAAAACTAGCCGGGCGCAGTGGCTCACACCTGTAATCCCAGCACTTTGGGAGGCTGAGGTGGGTGGATCACTAGGTCAGGAGTTCAAGACCAGCCTGGCCAACATGGTGAAACCGCGTCTCTACTAAAAACACCAAAAAATTAGCTGGGCGTGGTGGCAGTCGCCTGTAATCCCTGCTACTCGGAAGGCTGAGGCAGGAGAATCACTTGAACGCAGGAGGCAGAGGTTGCGGTGAGCCGAGATCACGCCACTGCACTCCAGCCTGGGTGACAGAGCAAGACTCTGTCTCAAAAAACAACAACAACAACTAGCTGGGCGTGGTGGCACATGCCTGTAACCCCAGCTACTCAGGAGGCTGAGGCTGAGGGAGAAAAATCGCTTGTACCTGGGAGGTGGAAGTTGCAGTGAGCGGAGATCCCACCATTGCACTCCAGCCTGGGTGACAAGAGCGAAACTCCATCTCAAAAAAAAAAAAAAAA","GGCTGGGCGCAGTGGCTCACACCTGTAATCCCAGCACTTAGGGAAGCTGAGGCGAGTAGATCACCTGAGGTCAGGAGTTAGAGACCAGCCTGGCCATCATGGTGAAACCCCGTCTCTACTAAAGATACCAAAAATTAGCTGAGTGTGGTGCTGGGTGCCTGTAATCCCAGAAACTCAGGGTGCCTGTAATCCCAGCAACTCAGGGTGCCTTTAATCCCAGCAACTGAGGGTACCAGTAATCCCAGCAACTCAGGGTGTCTTTAATCCTAGCAACTGAGGGCACCTGTAATCCCAGCAACTCAGGAAGCTGAGACAGGAGAAGTACTTGAACCCAGAAGGCAGAGGTTGCAGTGAGCCGATATTGCACCATTGCACTCCAGTCTGGGCAACAAGAGTGAAACTCTGTCTCAAAAAAAAA"
"chr16","3990675","3991277","JH378118","18053084","18053501","250","14062409","GGCTGGGCGTGGTGGCTCACGCCTTTAATCCCAGTACTTTGGGAGGCCGAGAAGGGCACATCACCTGAGGTCAGGAGTTTGAGACCAGCCTGGCCAATATGGTAAAACCCTGTCTCTACTTAAAAAATAGAAAAATCAGGCTGGACGCAGTGGCTCACGCCTGTAATCCCAGCACTTTGGGAGGCCGAGGCGGGTGGATCATGAGGTCAGGAGTTACCAGCCTGCCAACATGGTGAAACCCCATCTCTACTAAAAAAACAAAAAAAATTAGCCAGTCGTAGTGGCAGGCACCTGTAATCCCAGCCACTCGGGAGGCTGAGGCAGAGAATTGCTTGAACCTGGGAGGTGGAGATTGCTGTGCACCAAAATCACACCACTGCACTTGAGCCTGGGCGACAGAGGGAGACTCATCTGAAAAAAAAAAAAAAAAAAAAATTAGCCGGTTATGGTGGCAGGTGCCTGTGATCCCAGCTACTTGGGAGGCTGAGGCAGGAGAATTGCTTGAACCCGGGAGGCAGAGGTTGCAGTGAGCTGAGATCGCACCACTGCACTCCAGCCTGGAGGACAAGAGTGAGACTTGTCTGATTGGAAAAAAAAAAAAAA","GGCTGGGCGCAGTGGCTCACACCTGTAATCCCAGCACTTAGGGAAGCTGAGGCGAGTAGATCACCTGAGGTCAGGAGTTAGAGACCAGCCTGGCCATCATGGTGAAACCCCGTCTCTACTAAAGATACCAAAAATTAGCTGAGTGTGGTGCTGGGTGCCTGTAATCCCAGAAACTCAGGGTGCCTGTAATCCCAGCAACTCAGGGTGCCTTTAATCCCAGCAACTGAGGGTACCAGTAATCCCAGCAACTCAGGGTGTCTTTAATCCTAGCAACTGAGGGCACCTGTAATCCCAGCAACTCAGGAAGCTGAGACAGGAGAAGTACTTGAACCCAGAAGGCAGAGGTTGCAGTGAGCCGATATTGCACCATTGCACTCCAGTCTGGGCAACAAGAGTGAAACTCTGTCTCAAAAAAAAA"
"chr16","4259838","4260446","JH378118","18053084","18053501","263","13793246","GGCCGGGTGCAGTGGCTCACGCCTGTAATCGCAGGACTTTGGGAGGCCAAGGCAGGTGCATCACCTGAGGTCAGGATTTCAAGACCATCCAGCCTGATCAACATGGTGAAACCCTGTCTCTACTAAAAATATAAAAATTGGCCGGGCACAGTGACTCACGCCTGTAATCCCAGCACTTTGGGAGGCTGAGGCAGGTGGATCACAAGGTCAGGAGATCGAGACCATCCTGGCTAACACAGTGAAACCCCGTCTCTACTAAAAATATAAAAAATTAGCCGGGCGTGGTGGTAGGCACCTGTAGTCCCAGCTACTCGGGAGACTGAGGCAGGAGAATGGCGTGAACCTGGGAGGTGGAGCTTGCAGTGAGCAGAGATCGCGCCACTGTACTCCAGCCTGGGTGACAGAGCGAGACTCCGTCTCAAAAAAAAAAAAAAAAAAAAAAATTAGCTGGGCGTGGTGGCGGGCACCTGTAATCCCAGCTACTTGGGAGGCTGAGGCAGGAGAATTGCTTGAACCTGGGAAGTGGAGGTTGCAGTGAGCTGAGATTGTGCCCTTGTACTCCAGCCTGGGCAATAAAAGCAAAACTCCGTCTTAAAAAAAAAAAAAAAA","GGCTGGGCGCAGTGGCTCACACCTGTAATCCCAGCACTTAGGGAAGCTGAGGCGAGTAGATCACCTGAGGTCAGGAGTTAGAGACCAGCCTGGCCATCATGGTGAAACCCCGTCTCTACTAAAGATACCAAAAATTAGCTGAGTGTGGTGCTGGGTGCCTGTAATCCCAGAAACTCAGGGTGCCTGTAATCCCAGCAACTCAGGGTGCCTTTAATCCCAGCAACTGAGGGTACCAGTAATCCCAGCAACTCAGGGTGTCTTTAATCCTAGCAACTGAGGGCACCTGTAATCCCAGCAACTCAGGAAGCTGAGACAGGAGAAGTACTTGAACCCAGAAGGCAGAGGTTGCAGTGAGCCGATATTGCACCATTGCACTCCAGTCTGGGCAACAAGAGTGAAACTCTGTCTCAAAAAAAAA"
"chr16","4899850","4900511","JH378118","18053084","18053501","313","13153234","GGCCAGGCACGGTGGCATGCACCTGTAATCTCAGCTCTTTGGGAGGCTGAGGCAAGAGGATCACTTGAGCCCAGGAGTTGGTGATTGCAGTGAGCTCTGATCACTCCACTGCACTCCAGCCTGGGTGACAGAGTGAGATCCTGTCTCTACGAAAAAAAGACAAGACACAAATACGTTAAAAGTAAAATGATATAAAAAGATATTCCAGTGGGGCACAGTGGCTCACCCCTATAATCCCAACACTTTGGGAGGCTGAGGTGGGTGGATCACCTGAGGTCAGGAATTCAAGACCAGCCTGACCAACATGGAGAAACCCGTCTCTACTAAAAATACAAAATTAGCCGGGTGTGGTGGCACATGCCTGTAATCCCAGCTACTCAGGAGGCTGAGAATGGCTTGAACCTGGGAGGTGGAGGTTGTGGTGAGCCGAGATTGCACCACTGCACTCCAGCCTGGGCAACAAGAGCTGAAACTCCGTCGAAAAAAAAAATTAGCCTGGCGTGGTGGCGGGAGCCTGTAATCCCAGCTACTGGGGAGGCTGAGGCAGGAGAATCACTTGAACCTGGGAGGCAGAATTTGCAGTGAGCCGAGATCGCGCCACCACACTCCAGCCTGGGTGACAAAAACGAAACCCCATCTCAAAAAAATTAAAAAATAACAAA","GGCTGGGCGCAGTGGCTCACACCTGTAATCCCAGCACTTAGGGAAGCTGAGGCGAGTAGATCACCTGAGGTCAGGAGTTAGAGACCAGCCTGGCCATCATGGTGAAACCCCGTCTCTACTAAAGATACCAAAAATTAGCTGAGTGTGGTGCTGGGTGCCTGTAATCCCAGAAACTCAGGGTGCCTGTAATCCCAGCAACTCAGGGTGCCTTTAATCCCAGCAACTGAGGGTACCAGTAATCCCAGCAACTCAGGGTGTCTTTAATCCTAGCAACTGAGGGCACCTGTAATCCCAGCAACTCAGGAAGCTGAGACAGGAGAAGTACTTGAACCCAGAAGGCAGAGGTTGCAGTGAGCCGATATTGCACCATTGCACTCCAGTCTGGGCAACAAGAGTGAAACTCTGTCTCAAAAAAAAA"
"chr16","4919663","4920295","JH378118","18053084","18053501","281","13133421","CTGGGCGCAGTGGCTCACACCTATAATCCCAGCACTTTGGGAGGCCGAGGTGGGGTGGATCACTTGAGGTCAGGAGTTTGAGACCAGCCTGGCCAACATGGTGAAACCCCATCTCTTCTAGAAAAATACAAAATTAGGCTGGGCGCGGTGGCTCACGCTTGTAATCCCAGCACTTTGGGAGGCTGAGGCAGGCGGATCATCTGAGGTTGGGAGTTCGAGACCAGCCTGACCAACATAGAGAAACCCTGTCTCTACTAAAAATACAAAATTAGCCGGGCGTGGTGGCGCATGCCTGTAATCCCAGCTAGTCAGGAGGCTGAGGCAGGAGAATCCCTTGAACTGGGGAGGCAGAGGTTGTGGTGAGCCCAGATCGTGCCATTGCACTCCAGCTTGGGTAAGAAGAGCAAAACTCTGTCTAAAAAATATATATATTTATACATATATATATATTTATATATATAATTAGCCACGCATAGTGGCACACACCTGTAACCCCAGCTACCTGGGAGGATGAGGCAGGAGAATAGCTTGAACTTGGGAGGTGGAGGTTGCACTGAGCTGAGACTGCGCCATTGCATTCCAGCCTGGGCAACAAGAGCGAAACTGTCTCAAAAAAAAAAAAAAAAAAAAAAA","GGCTGGGCGCAGTGGCTCACACCTGTAATCCCAGCACTTAGGGAAGCTGAGGCGAGTAGATCACCTGAGGTCAGGAGTTAGAGACCAGCCTGGCCATCATGGTGAAACCCCGTCTCTACTAAAGATACCAAAAATTAGCTGAGTGTGGTGCTGGGTGCCTGTAATCCCAGAAACTCAGGGTGCCTGTAATCCCAGCAACTCAGGGTGCCTTTAATCCCAGCAACTGAGGGTACCAGTAATCCCAGCAACTCAGGGTGTCTTTAATCCTAGCAACTGAGGGCACCTGTAATCCCAGCAACTCAGGAAGCTGAGACAGGAGAAGTACTTGAACCCAGAAGGCAGAGGTTGCAGTGAGCCGATATTGCACCATTGCACTCCAGTCTGGGCAACAAGAGTGAAACTCTGTCTCAAAAAAAAA"
"chr16","5124255","5124811","JH378118","18053084","18053501","213","12928829","GGCCAGGTGCGGTGGCTCATGCGTGTAATCCCAGCGCTTTGGGAGGCTGAGGCAAGTGGATCACCTGAGGTCAGGAGTTTGAGACCAGCCTGGCCAACATGGGGAAATCCCTGTCTCTACTAAAAATACAAAAATTGGGCCGGGTGTGGTGGCTCACACCTGTAATCCCAGCACTTTGGGAGACTGAGGTGGGCGGATCACCCAAGGTCAGGAGTTTGAGACCATCCTGGCCAACATGGTGAAACCCCGTCTCTACTAAATAAATACAAAAAAGTAGCCGAGCGTGTTGGCGGATGCCTGTAATCCCAGCTACTTGGGAGGCTGAGGCAGGAGAATTGCTTGAACCCTGAGAGGTGGAGGTTGCAGTGAGCAGAGATTGTGCCACTGCACTCTGGCCTGGGCGACAAGAGGGAGTCTCTGTCTTAAAAAAAAAAAAAAAAAAAATTAGCTGGAAATCGCTTGAACCCAGGAGGCGGAGGTTGCAGTGAGCCGAGATTGTGCCACTGCACTCTGGCCTGGGCGACAAGAGCGAGATTCTGTCTCAAAAAAAAAAAAGA","GGCTGGGCGCAGTGGCTCACACCTGTAATCCCAGCACTTAGGGAAGCTGAGGCGAGTAGATCACCTGAGGTCAGGAGTTAGAGACCAGCCTGGCCATCATGGTGAAACCCCGTCTCTACTAAAGATACCAAAAATTAGCTGAGTGTGGTGCTGGGTGCCTGTAATCCCAGAAACTCAGGGTGCCTGTAATCCCAGCAACTCAGGGTGCCTTTAATCCCAGCAACTGAGGGTACCAGTAATCCCAGCAACTCAGGGTGTCTTTAATCCTAGCAACTGAGGGCACCTGTAATCCCAGCAACTCAGGAAGCTGAGACAGGAGAAGTACTTGAACCCAGAAGGCAGAGGTTGCAGTGAGCCGATATTGCACCATTGCACTCCAGTCTGGGCAACAAGAGTGAAACTCTGTCTCAAAAAAAAA"
"chr16","8088191","8088522","JH378114","21211700","21212024","70","13123509","GGCTGGGCGCGGTGGCTTTTGACCATAATCCCAGCACTTTGGGAGGCCGAGGTGGTCAGGTCACCTGAGGTCAGGAGTTCAAGAGCAGCCTGGCCAACGTGGTGAAACTCTGTCTCTACCAAAAATACCAAATAATAATAATAATAATAATAATAATAATAAAATAATATAATTGCAGGGTGTGGCAGCCCATGCATGTAATGCCAGCTACTTGGGAGACTGAGGCAGGATAATCACTTCAACCCAAGAGGCGGAGGTTGCAGTGAGCTGAGATCATGCCATTGCATTCCAGCGTAGGCAACAAGAGCGAAACTCTGTTTCAAATAAATAAA","GGCTGGGTGCGGTGGCTCAGGCCTGTAATCCCAGCACTTTGGGAGGCCGAGGTGGGTACATCACCTAAGGTCAGGAGTTCAAGACCAGCCTGACCAACATGGTAAAACCCTGTCTCTACTAAAATTACAAAAGAAAATTAGAAAAAAAAAAAAGAAAGAAAGAAAATTAGATGGCATGGTGGTGGCGGGCACCTGTAATTTCAACTACTCGGGAGGCTAAGGCAGGAGAATCACTTGAACCCAGGAGGTGGAGGTTGCAGTGAGCCGAGATCACACCATTGCACTGCAGCCTGGGCAATAAGAGCAAAACTCCATCTCAAAAAAA"
"chr16","9762791","9763467","JH378118","18053084","18053501","323","8290293","CAGGCATGGTAGCTCACGCCTGTAATCTCAGCACTTTGGGAGGCCGAGGTGCGCAGATCACTTGAGGTCAGGTGTTGGTGACCAGCCTGGCCAACATGGTGAAACCCTATCTCTACTAAAAATACAAAAATTATGGCCGGGCGCAGTGGCTCACGCCTGTAATCCCAGCACTTTGGGAGGCCGAGGTGGGCAGATCACTTGAGGTCAGGAGTTCAAGACCAGCCTAGGCAACATAGTGAAACCCCGTTGCTACTAAAAATACAAAAATTAGCTGGGCGTGATGGCACATACCTGTAGTCCCACCTACTTGGGAGGCTGAGGCAGGAAAATCGCTTGAACCTGGAGGCAGAGGTTGCAGCGAGCCAAGACTGTGCCAATGCACCACAGCCTGGATAACAGAGTGAGACTCAATCTCAAAAAAAAAAAAAAAAAAAAAAGGCGGGCTGGTGGCTCATGCCCATGCAAACCCCGTCTCTACTAAAAGGACAAAAATTAGCTGGGCATGGTGGCGGGGGCCTGTAATCTCAGGATTACAGGAGATACTACTACTCGGGAGGCTGAGGCAGTAGAATTGCTTGAACCAGGGAGGCGGAGGTTGCAGTGAGCTGAGATCGCGCCATTGCACTCCAGGCTGGGTGACAACAATGACTCCGTCTCAAAAACAACAACAACAACAA","GGCTGGGCGCAGTGGCTCACACCTGTAATCCCAGCACTTAGGGAAGCTGAGGCGAGTAGATCACCTGAGGTCAGGAGTTAGAGACCAGCCTGGCCATCATGGTGAAACCCCGTCTCTACTAAAGATACCAAAAATTAGCTGAGTGTGGTGCTGGGTGCCTGTAATCCCAGAAACTCAGGGTGCCTGTAATCCCAGCAACTCAGGGTGCCTTTAATCCCAGCAACTGAGGGTACCAGTAATCCCAGCAACTCAGGGTGTCTTTAATCCTAGCAACTGAGGGCACCTGTAATCCCAGCAACTCAGGAAGCTGAGACAGGAGAAGTACTTGAACCCAGAAGGCAGAGGTTGCAGTGAGCCGATATTGCACCATTGCACTCCAGTCTGGGCAACAAGAGTGAAACTCTGTCTCAAAAAAAAA"
"chr16","9769317","9769634","JH378153","10517405","10517727","57","748088","GGTTGGGCATGGTGGCTCACACCTGTAATGCCAGCACTTTGGGAGGCGGGCAGATCACCTGAGGTCAGGAGTTCAAGACCAGCCTGGCCAACATGGTGAAATCCTGTCATTACAAAAATACAAAAAAAAAAAAAAAAAAAAAAAAAAAAAGCCAGTAATGATAGTGGGTGCGTATAATCCCAGCTACTTTGGAGGCTAAGGCAGGAGACTCACTTGAACCCAGGAGGCGGAGGTTATGGTGAGCCGAGATCACACCATTGCACTCCAGCCTGGGCGACAAGAGCAAAACTCCATCTCAAAAAAAAAAAAAAAAAAAAA","GGCCGGGCGTGGTGGCTCACGCCTGTAATCCCAGCACTTTGGGAGGCCGAGGTGGGTGGATCATGAGGTCAAGAGATCGAGACCATCCTGGTCAACATGGTGAAACCCTGTCTCTACTAAAAAAAAAAAAAAAAAAAAAAAATACAAAAAAATTAGCTGGGCATGGTGGCGCATGCCTGTAATCCCAGCTACTCCGGAGGTTGAGGTAGGAGAATTGCCTGAACCCAGGAGGCGGAGGTTGCGGTGAGCCGAGATCGCGCCATTGCACTCCAGCCTGGGTAACAAGAGCAAAACTCCGTCTCAAAAAAAAAAAAAAAAAAGAA"
"chr16","13753079","13753710","JH378118","18053084","18053501","278","4300005","GGCTGATTGTGATGGCTCACACTTGTAATCCCCTCACTTTGGGAGGCCAAAGCGGGAGCATCACCTGAGGTCAGGAGTTCAAGACCAGCCTGGCCAACATGGTGAAACCCCATCTCTACTAAAAATAAAAAATTAGCTGGGCACAGTGACTCATGCCTGTAATCCCAGCACTTTGGGAGGCCGAGGCAGGCAGATCACAATCACGAGGTCAGGAGTTCGAGACCAGCCTGACCAACATGGTGAAACCCCGTCTCTACTAAAAATAGAAAAATTAGCCAGGCGTGGTGGCACACGCCTGTAATCCCAGCTCCTCAGGAGACTGAGGCAGGAGAATCACTTGAACCCAGGAGGTGGAGGTTGCAGTGAGCAGAGATCGCACCACTGCACTCCAGCCTGGGTAACAGAGTGAGACTCCGTCTCAAAAAAAAAAAAAAAAAAAAAAAAAAAACGAAATTAACCAGGTGTGGTGGCACATGCCTGTAATCCCAGCTACTTGGGAGGCTGAGGCAGGAGAATCGCTTGAACCCGGGAGACAGAGGTTCCAGAGAACTGAGATCATGCCATTGCACTCCAGCCTGGGCAACAAGAGTGAAACTCCATCTAAAAAATAAATAAATACATAAACAAACAAA","GGCTGGGCGCAGTGGCTCACACCTGTAATCCCAGCACTTAGGGAAGCTGAGGCGAGTAGATCACCTGAGGTCAGGAGTTAGAGACCAGCCTGGCCATCATGGTGAAACCCCGTCTCTACTAAAGATACCAAAAATTAGCTGAGTGTGGTGCTGGGTGCCTGTAATCCCAGAAACTCAGGGTGCCTGTAATCCCAGCAACTCAGGGTGCCTTTAATCCCAGCAACTGAGGGTACCAGTAATCCCAGCAACTCAGGGTGTCTTTAATCCTAGCAACTGAGGGCACCTGTAATCCCAGCAACTCAGGAAGCTGAGACAGGAGAAGTACTTGAACCCAGAAGGCAGAGGTTGCAGTGAGCCGATATTGCACCATTGCACTCCAGTCTGGGCAACAAGAGTGAAACTCTGTCTCAAAAAAAAA"
"chr16","13951847","13952482","JH378118","18053084","18053501","292","4101237","GGCCAGGTGCGGTGGCTCATGCCTGTAATCCCAGCACTTTGGGAGGCTATGGCAGCGGATAACCTGAGGTCACAAGTTTGAGACCAGCCTGGCAAACATGGTGAAACCGTCTCTACTAAAAATACAAAAATTACACCAGGCGCGGTGGCTCATGCCTGTAATCCCAGCACTTTGGAAGGCCGAGGCAGGTGGATCATGAGGTCAGGAGATCAAGACCATCCTGGCTAACGCAGTGAAACCCCGTCTCTACTAAAAATATAAAAAATTGGCCAGGCGTGGTGGCGGACGCCTGTAGTCCCAGCTACTCGGGAGGCTGAGCCAGGAGAATGGCGTGAACCCGGGAGGCGGAGCTTGTGGTGAGCCGAGATAGCGCCACTGCACTGCCGCCTGGGTGACAGAGTGAGACTCTGTCTCAAAAAACAAAACAAAACAAAAACCAAAAACAAAAACAAAAAAACAAAAATTAGCCAGGTGTGGTGGTGCACGCCTGTCATCCCAGCTACTTGGGGGGCTGAGACGTGATAATCACTTGAACCCGGGAGGGAGAGGTTGCAGTGAGTGGAGATCACGCCATTGTATTCCAGCCTGGGGGCAAGAGCAAAACTCTGTCTCAAAAACAACAACAACAACAACAAA","GGCTGGGCGCAGTGGCTCACACCTGTAATCCCAGCACTTAGGGAAGCTGAGGCGAGTAGATCACCTGAGGTCAGGAGTTAGAGACCAGCCTGGCCATCATGGTGAAACCCCGTCTCTACTAAAGATACCAAAAATTAGCTGAGTGTGGTGCTGGGTGCCTGTAATCCCAGAAACTCAGGGTGCCTGTAATCCCAGCAACTCAGGGTGCCTTTAATCCCAGCAACTGAGGGTACCAGTAATCCCAGCAACTCAGGGTGTCTTTAATCCTAGCAACTGAGGGCACCTGTAATCCCAGCAACTCAGGAAGCTGAGACAGGAGAAGTACTTGAACCCAGAAGGCAGAGGTTGCAGTGAGCCGATATTGCACCATTGCACTCCAGTCTGGGCAACAAGAGTGAAACTCTGTCTCAAAAAAAAA"
"chr16","19006984","19007584","JH378118","18053084","18053501","263","953900","GGTGGCTGATGCCTGTAAACCCAGCATTTTGGGAGGCCGAGGCTGGTGGATCACCTGAGGTCAGGTGTTCGAGACCAGTCTGGCCAACATGGTGAAACCTCGTCTCTACCAAAAATACAAAAATTAGTTGGGTGTGGCCGGGTGTGGTGGCTTACGCTTGTAATCTCAGCACTTTGGGAGGCCGAGGTGGGTGGATCACGAGGTCAGGAGTTCAAGACCAGCCTGGCCAAGATGGTGAAACCCTGTCTCTACTAAAAATACAAAAAATTAGCCAGGCATGGTGGCGGGTGCCTGTAATCCCAGCTACTCGGGAGGCTGAGGCAGAGAATTGCTTGAACCTGGGAGGTGGAGGTTGCAGTGAGCCGAGATTGTGCCACGACACTCCAGCCTGGGTGACAGAGCGAGACTCTGTCTAAAAAAAAAAAAAAAAATTAGTTGGATGTGGTGGTGGGTGTCTGTAATCTCAGCTACTCAGGAGACTGAATCAGGAGAATCACTTGAACCCAGGGGGCTGGAGGTTGCAGTGAGCCGAGATCTTGCCATTGCACTCCAGCCCGGGCGACAAGAGCAAAACTCTCTTTCAAAAAAAAAAAAAAAAAGA","GGCTGGGCGCAGTGGCTCACACCTGTAATCCCAGCACTTAGGGAAGCTGAGGCGAGTAGATCACCTGAGGTCAGGAGTTAGAGACCAGCCTGGCCATCATGGTGAAACCCCGTCTCTACTAAAGATACCAAAAATTAGCTGAGTGTGGTGCTGGGTGCCTGTAATCCCAGAAACTCAGGGTGCCTGTAATCCCAGCAACTCAGGGTGCCTTTAATCCCAGCAACTGAGGGTACCAGTAATCCCAGCAACTCAGGGTGTCTTTAATCCTAGCAACTGAGGGCACCTGTAATCCCAGCAACTCAGGAAGCTGAGACAGGAGAAGTACTTGAACCCAGAAGGCAGAGGTTGCAGTGAGCCGATATTGCACCATTGCACTCCAGTCTGGGCAACAAGAGTGAAACTCTGTCTCAAAAAAAAA"
"chr16","19554918","19555551","JH378118","18053084","18053501","281","1501834","GGCCGGGCGCAGTGGCTCACACCTGTAATCCCAGCACTTTGGGAGGCCGAGGCGGGTGGATCACTTGAGGTCAGGAGTTCAAGACCAGCCTGGCTGACATGGTGAAACCCTGTCTCTACTGAAAACACAAAAATTAGGCCGGGCATAGTGGCTCATGCCTGTAATACCAGCACTTTGGGAGGCCGAGGTGGGTGGATCACCTGAGGTCAGGAGTTTGAGACCAGCTTGACCAACATGGTGAAACCCCGTCTCTACTAAAAATATAAAAATTAGTCTGGCATGGTGGCAGATGCCTGTAATCCCAGCTACTCAGGAGGCTGAGGCAGGAGAATTGCTTGAACCTGGAAGGTGGAGGTTGTAATGAGCCAAGATCACACCACTGCACTCCAGCCACTGTACTCCAGCCTGGGTGACAGAGTGAGACTCTGTCTCAAAAAACATACATACACACACATACACACACACACACACACACACACAAATTAGCTGGACGTGATAGCACACCCCTGTAGTCCCAGCTGCTTGAGAGACCGAGGCACAAGAATCACACGAACCCGGGAGGCGGAGGTTCCTGTGAGCCAAGATCGCACCATTGTACTCCATTCTGGGTGACAAGAGTGAAGCTCTGTCTCAA","GGCTGGGCGCAGTGGCTCACACCTGTAATCCCAGCACTTAGGGAAGCTGAGGCGAGTAGATCACCTGAGGTCAGGAGTTAGAGACCAGCCTGGCCATCATGGTGAAACCCCGTCTCTACTAAAGATACCAAAAATTAGCTGAGTGTGGTGCTGGGTGCCTGTAATCCCAGAAACTCAGGGTGCCTGTAATCCCAGCAACTCAGGGTGCCTTTAATCCCAGCAACTGAGGGTACCAGTAATCCCAGCAACTCAGGGTGTCTTTAATCCTAGCAACTGAGGGCACCTGTAATCCCAGCAACTCAGGAAGCTGAGACAGGAGAAGTACTTGAACCCAGAAGGCAGAGGTTGCAGTGAGCCGATATTGCACCATTGCACTCCAGTCTGGGCAACAAGAGTGAAACTCTGTCTCAAAAAAAAA"
"chr16","19576859","19577465","JH378118","18053084","18053501","251","1523775","GGCCAGGCATGGTGGCTCACACCTGTAATCCCAGCCCTTTGGGAGGCCGAGGCAGGTGGATCACCTGAGGTCAGGAGTTCGAGACCAGCCTGGCCAACATGGTGACACCCCACTCTACCAAAAATACAAAAATTAGGTTGGGTGCAGCGGTTCACACCTGTAATCCCAGCACTTTGGGAGGCCAAGGTGGATGGATCACCTGAGGTCAGGAGTTTGTGACCAGCCTGGCCAACATGGCGAAACCCTGCCTCTACTAAAAATAAAAAATTAGCCAGGTGTGGTGGCATGCGCCTGTAATCCTAGCTACTGAGGCAGGAGAATCGCTTGGACCAGGGAAGCAGAGTTTGCAGTGAGCCAAGATCACGCCACTGCACTCTAGCCTGGGTGACAGAGTAAGACTCCATCTCAAAAAAAAAAAAAAATACAAATATTAGCTGGGCATGGTGGCGCACACCTGTAGTTCTGGCTACTCAGGAGGCTGAGGCAGGAGAATTGCTTGAACCCAGAAGGCAGAGGTTGCAGTGAGCTGAGATTGTGCCATTGCACTCAGCCTGGGCAACAAAAGTGAAACTCCATCTCAAAATAAATAGATAAATAAATAAATAAA","GGCTGGGCGCAGTGGCTCACACCTGTAATCCCAGCACTTAGGGAAGCTGAGGCGAGTAGATCACCTGAGGTCAGGAGTTAGAGACCAGCCTGGCCATCATGGTGAAACCCCGTCTCTACTAAAGATACCAAAAATTAGCTGAGTGTGGTGCTGGGTGCCTGTAATCCCAGAAACTCAGGGTGCCTGTAATCCCAGCAACTCAGGGTGCCTTTAATCCCAGCAACTGAGGGTACCAGTAATCCCAGCAACTCAGGGTGTCTTTAATCCTAGCAACTGAGGGCACCTGTAATCCCAGCAACTCAGGAAGCTGAGACAGGAGAAGTACTTGAACCCAGAAGGCAGAGGTTGCAGTGAGCCGATATTGCACCATTGCACTCCAGTCTGGGCAACAAGAGTGAAACTCTGTCTCAAAAAAAAA"
"chr16","19983557","19984148","JH378118","18053084","18053501","244","1930473","GGCCGAGTGCGGTGGCTCATGCCTGTAATCCCAGCACTTTGGGAGGCCGAGACAGGTGAATCACCTGAGGTCTGGAGTTTGAGACCAGCTGACCAACATGGTGAAACCCTGTCTCTACTAAAAATACAAAAAATTGGCTGAGCGCAGTGGCCACGCCTGTTATCCCAGTACTTTGGGAGGCCGAGGCGGGTGGATCACGAGGTCAGGAATTCGAGACCAGCCTGACCAACATGGTGAAGCCCCGTCTCTACTAAAAATAAAAAAATTAGCCAGGTGTGGTGGTGCGCCCCTGTAAACCCAGCTACTCAGGAGGCTGAGGCAGGAGAATCACTTGAATCTGGGAGGCGGAGGTTGCAGTGAGCCAAGATCGAGCCACTGTACTCCAGCCTGGGAGACGGAGTGAGACTCCATCTAAAAAAAAAAAAAAATTAGCCAGGCGTGGTGGCACAAGCCTGTAATCCCAGCTACCTGGGAGGCTGAGATAGGAGAATTCCTTGAATCTGGGAGGCGGAGGTTGCAGTGAGCTGAGATTGTGCCATTGCACACCAGCCTGGGTGACAAGAGCAAAATTCCATCTCAAAAAAAAAAAAAA","GGCTGGGCGCAGTGGCTCACACCTGTAATCCCAGCACTTAGGGAAGCTGAGGCGAGTAGATCACCTGAGGTCAGGAGTTAGAGACCAGCCTGGCCATCATGGTGAAACCCCGTCTCTACTAAAGATACCAAAAATTAGCTGAGTGTGGTGCTGGGTGCCTGTAATCCCAGAAACTCAGGGTGCCTGTAATCCCAGCAACTCAGGGTGCCTTTAATCCCAGCAACTGAGGGTACCAGTAATCCCAGCAACTCAGGGTGTCTTTAATCCTAGCAACTGAGGGCACCTGTAATCCCAGCAACTCAGGAAGCTGAGACAGGAGAAGTACTTGAACCCAGAAGGCAGAGGTTGCAGTGAGCCGATATTGCACCATTGCACTCCAGTCTGGGCAACAAGAGTGAAACTCTGTCTCAAAAAAAAA"
"chr16","20117717","20118289","JH378118","18053084","18053501","224","2064633","GGCTGGGTGCGGTGGCTCACGCCTGTAATCCCAGCACTTTGGGAGGCCAAGGCGGGTAGATCATCTGAGGTCAGGAGTTCAAGACCAGCCTGGCCAACATGGTGAAACCCCGTCTCTACTAAAAATATTTTTAAAAGGCCAGGCGTGGTGGCTCACGCCTGTAATCCCAGCACTTTGGGAGGCCGAGGCGGGCAGATCATGAGGTCAGGAGTTCGAGACCATCCTGGCTAACACGGTGAAACCCCCGTCTCTACCAAAAAATACAAAAAATTAGCCGGGCATGGTGGCAGGTGCCTGTAGTCCCAGCTACTCGGGAGGCTGAGGCAGGAGGATGGCGTGAACCCAGGAGACAGAGCTTCCAGTGAGCTGAGATCGTGTCACTGCACTCCAGCCTGGGCGACAGAGGAGATTCTGTCTCAAAAAAAAAAAAAAAAAATTAGCTTGGTGTGGTGGCAGGTGCCTGTAATCCCAGTTACTCGGGAGGCTGAGGCAGAGGTTTCAGTGAACCGAGATCGCGCCATTGCACTCCAGCCTGGGCAACAAGAGTGAAACTCCGTCTCAAAGGAAAAAAAA","GGCTGGGCGCAGTGGCTCACACCTGTAATCCCAGCACTTAGGGAAGCTGAGGCGAGTAGATCACCTGAGGTCAGGAGTTAGAGACCAGCCTGGCCATCATGGTGAAACCCCGTCTCTACTAAAGATACCAAAAATTAGCTGAGTGTGGTGCTGGGTGCCTGTAATCCCAGAAACTCAGGGTGCCTGTAATCCCAGCAACTCAGGGTGCCTTTAATCCCAGCAACTGAGGGTACCAGTAATCCCAGCAACTCAGGGTGTCTTTAATCCTAGCAACTGAGGGCACCTGTAATCCCAGCAACTCAGGAAGCTGAGACAGGAGAAGTACTTGAACCCAGAAGGCAGAGGTTGCAGTGAGCCGATATTGCACCATTGCACTCCAGTCTGGGCAACAAGAGTGAAACTCTGTCTCAAAAAAAAA"
"chr16","20574957","20575888","JH378118","18053084","18053501","543","2521873","GGCCAGGCGTGGTGGCTCATGCCTGTAATCCCAGCACTGTGAGAGGCCGAGGCGGGCGGATCACCTGAGCTGAGGAGTTCGAGACCAGCCTGGCCAACATGGCGAAACCCCATCTCTACTAAAAACACAAAAATTAGGCCAGGTGTGGTGGCTCACACCTGTAATCCCAGCACTTTGGGAGGCCAAGGCGGGCGGATCACCTGAGGTCAGGAGTTCCAGACCTGCCTGGCCAACATGGTGGAATCCCATCTCTACTAAAAATACAAAAATCTGCCAGGTGTGGTGGCACACTTCTGTAATCCCAGATACTCAGGAGGCTGAGGCAGGAGAATCACTTGAACCCTGGAGATGGAGGTTGCAGTGAGCCAAGATCAAGAGATTGCACTCTAGCCAGGGTGACTAGAGTGAGACTCGGTCTCAAAAAAAATGTAATTAATTAATTAATTAATACAAAAATTAGCTGGGCGTGGGCTAGGTGTGGTGGCTCACGCCTGTAATCCCAGCACTTTGGGAGGCCGAGACAGGCGGATCACCTGAGGTCAGGAGTTCAAGACCAGTTTAACCAACATGGAGAAACCCCATCTCTACTAAAAATACAAAATTAGCTGGGCGTGGTGGTGCATGCCTGTAATCCCAGCTACTCGGGAGGCTGAGGCAGAAGAATCGCTTGAGCCTGGTAGGCGGAGATCGTGGTGAGCCGAGATCGCGCCATTGCACTCCAGCCTGGACAACAAGAGCGAAACTCCGTCTAAAAAAAAAAAAAAAATTAGCTGGGCATGGTAACAGGCGCCTGTAAACCCAGTTTCCTCGGGAGGCTGAAGCAGAATTGCTTGATCCCAGAGGCAGAGGTTGCAGTGAGCCAAGATAGTGCCATTGCAGTCCAGCCTGGGCAACAAGAGTGAAACTCCGTCTCAAAAAAAAAAAAAAAAAAA","GGCTGGGCGCAGTGGCTCACACCTGTAATCCCAGCACTTAGGGAAGCTGAGGCGAGTAGATCACCTGAGGTCAGGAGTTAGAGACCAGCCTGGCCATCATGGTGAAACCCCGTCTCTACTAAAGATACCAAAAATTAGCTGAGTGTGGTGCTGGGTGCCTGTAATCCCAGAAACTCAGGGTGCCTGTAATCCCAGCAACTCAGGGTGCCTTTAATCCCAGCAACTGAGGGTACCAGTAATCCCAGCAACTCAGGGTGTCTTTAATCCTAGCAACTGAGGGCACCTGTAATCCCAGCAACTCAGGAAGCTGAGACAGGAGAAGTACTTGAACCCAGAAGGCAGAGGTTGCAGTGAGCCGATATTGCACCATTGCACTCCAGTCTGGGCAACAAGAGTGAAACTCTGTCTCAAAAAAAAA"
"chr16","20816618","20817242","JH378118","18053084","18053501","267","2763534","GGCCCGGCGTGGTGGCTCATGCCTGTAATCCCAGCACTTTGGGAGGCCGAGGCCGGCGGATCACCTGAGGTCAGGAGTTTGAGACCACCCTGGCCAACACGGTGAAAACCTGTCTCTACTAAAAATACAAAAATTAGCCAGGCGCAGTGGCTCACGTCTGTAATTCCAGCACTTTGGAGGGCCGAGGGGGGCAGATCACAAGGTCAGGAGTCCAAGACCAGCCAGGCCAACATAGTGAAACCCGGTCTCTACTAAAAATACAAAAAATTAGCCGGGCGTGGTGGCGGACCCCTGTAGTCCCAGCTACTCAGGAGGCTGAGACAGGAGAATCTCTTGAACCCAGGAGGCAGAGGTTGCAGTGAGCCAAGATCATGCCATTCCACTCCAGCCTGGGCGACAGTGCAAGACTCTGTCTCAAAAACAAAAACAAAAAACCCCCAAACCAAAAATTAGCCAGGCGTGGTGGCATGCACCTGTAGTCCCAGCTACTTGGGAGGCTAAGGCAAGAGAATAGCTTGAACCCAGGAGGCAGAGGTTGCAGTGAGCCGAGATAGTGCCATTGCACTCCAACGTGGGTGACAAGAGCAAAACTCTGTCTCAAAAAAAAAAAAAAAAAAGGAAGGAA","GGCTGGGCGCAGTGGCTCACACCTGTAATCCCAGCACTTAGGGAAGCTGAGGCGAGTAGATCACCTGAGGTCAGGAGTTAGAGACCAGCCTGGCCATCATGGTGAAACCCCGTCTCTACTAAAGATACCAAAAATTAGCTGAGTGTGGTGCTGGGTGCCTGTAATCCCAGAAACTCAGGGTGCCTGTAATCCCAGCAACTCAGGGTGCCTTTAATCCCAGCAACTGAGGGTACCAGTAATCCCAGCAACTCAGGGTGTCTTTAATCCTAGCAACTGAGGGCACCTGTAATCCCAGCAACTCAGGAAGCTGAGACAGGAGAAGTACTTGAACCCAGAAGGCAGAGGTTGCAGTGAGCCGATATTGCACCATTGCACTCCAGTCTGGGCAACAAGAGTGAAACTCTGTCTCAAAAAAAAA"
"chr16","21054922","21055508","JH378118","18053084","18053501","243","3001838","GGCCGGGTGCGGTGGCTCACACCTATAATCCCAGCACTTTGAGAGTCTGAGGCAGGCGGATCACCTGAGGTCAGGAGTTCCAGACCAGCCTGGCCAACATGGTGAAACCCAGTCTCTACTAAAAATACAAAAAAAGACCGGGCACAGTGGCTCACGCCTGTAATTCCAGCACTTTGGGAGGCCGAGGCAGGTGGATCACCTGAGGTTGGGAGTTCGCGACCAGCCTGACCGACATGGAGAAATCCCATCTCTACTAAAAATACAAAATTAGCCGGGCGTGGTGGCACATGCCTGTAATTCCAGCTACTCAGGAGGCTGAGGGAGGAGAATCACTTGAACCTGGGAGGCGGAAGTTGTGGCGAGCCAAGATCACGCCATTGCACTCCAGCCTGGGCAACAAGAGTGAAACCCCATTTCAAAAAAAAAAAAAATTAGCCAGGGGTGGTGGTGCATTCTTGTAATACCAGCTACTCGGGAGGCTGAGGTAGGAGAATCACTTGAGCGCAGGAGGCAGATGTTGTAGTGAGCCGAGTGCCATTGCACTACAGCCTGGGCGACAAGAAAGTAACTCCACCTCAAAAAAAAAA","GGCTGGGCGCAGTGGCTCACACCTGTAATCCCAGCACTTAGGGAAGCTGAGGCGAGTAGATCACCTGAGGTCAGGAGTTAGAGACCAGCCTGGCCATCATGGTGAAACCCCGTCTCTACTAAAGATACCAAAAATTAGCTGAGTGTGGTGCTGGGTGCCTGTAATCCCAGAAACTCAGGGTGCCTGTAATCCCAGCAACTCAGGGTGCCTTTAATCCCAGCAACTGAGGGTACCAGTAATCCCAGCAACTCAGGGTGTCTTTAATCCTAGCAACTGAGGGCACCTGTAATCCCAGCAACTCAGGAAGCTGAGACAGGAGAAGTACTTGAACCCAGAAGGCAGAGGTTGCAGTGAGCCGATATTGCACCATTGCACTCCAGTCTGGGCAACAAGAGTGAAACTCTGTCTCAAAAAAAAA"
"chr16","27896431","27896766","JH378166","6401112","6401453","56","21495319","GGCCAGGCGCGGTGGCTCACGCCTGTAATCCCAGGACTTTGGTAGTCCAAGGCGGGTGGATCACCTGAGGTCAGGAGTTCAAGATCAGCCTGACCAACATGGCAAAACCTCGTCTCTACTAAAAAATACAAAAATTAGCCGGTGTGGTGGCAGGTGCCTGTAATTCCAGCTACTCGGGACGCTGAGTCATGAGAATTGCTTGAACCTAGGAGGCAGATGTTGCAATGAGCCGAGATCGCACCATTGTACTCCAGCCTGGGCGACAAGAGGGAAACTGTCTCCAAAAAAAAAAAAGAAAGAAAGAAAGAAAGAAAGAAAAAAGAAAAACAAAACAAA","GGCCAGGTGCAGTGGCTCACCCCTGTAATCCCAGCACTTTGGGAGGTCGAGGTGGGTGGATCACCTGAGGTCAGGAGTTCAAGACCAGCCTGACCAAAATGGTGAAACCCCATCTCTACTAAAAATACAAAACATTAGCCAGACATCGTGGCGGGCACCTGTAATCCCAGCTACTTGGGAGGCTGAGGCAGGAGAATTGCTTGAGCCTAGGAGGCGGAGGTTACAGTGAGCCATGATCGTGCCATTGGACTCCAGCCTGGGCTACAAGAGCGAGACTCCATCTCAAAAAAAAAAAAAAAAAAAAAAAAGAAAGAAAGAAAGAAAGAAAGAAAAGAAAGAAAG"
"chr16","36524888","36525430","JH378206","6546474","6546861","201","29978414","TTTGAGACCAGCCTGGCCATTGTGGTGAAACCCCGTCTCTACTAAAAAAAATTCAAAAAATGGCTGGGTATGGTGGCTCACGCCTGTAATCCCAGGACTTTGGGAGGCCAAGGTGGGCGGATCACCTGAGGTCAGGAGTTTGAGACCAGCCTAGCCAACATGGTGAAACCCCGTCTCTACCAAAAATACAAAAATTAGCCGGGCTTGGTGGCGCGCACCTGTAATCCCAGGTACACTGGAGGTTGAGGCACAAGAATCGTTTGATCCTGGGAGGTTGCAGTGAGCCAAGATCACGCCACTGCACTCCAGACTGGGTGACAGAGCGAGATTCCATCTCAAAACAACAACAACAAACCCAAAAAATTAGCTGGGTGTGGTGGTGGGTGCCTGTAATCCCAGCTACTTAGGAGGCTGAGGCAGAAGAATCGCTTGAACCCAGGAGGTGGAGGTTGTTGCAGTGAGCAGAGATCGCACCATTGCACTCCAGCCTGGGCAACGAGTGAAACTCCATCTCAAAAAAAAAAAAAAAAAAAGAAAAAAAAA","GGCCACACATGGTGGCTAACGCCTGTAATCCCAGCACTTTGGGAGGCCAAGTCGGGTGGATCATGAGGTCAGGAGACCAAGACCATCCTGGCCAAATGGTGAAACCCCGTCTCTACTAAAAATACAAAAATTAGCTGGGCATGGTGGCGTGTGCCTGTAATCCCAGCTACTCAGGAGGCTGAGGCAGGACAATTGCCTGAACCCAGGAGAATTAGCTGGGCATGGTGGCGTGTGCCTGTAATCCCAGCTACTCAGGAGGCTGAGGCAGGACAATTGCCTGAACCCAGGAGGCGAAGGTTGCGGTGAGCCGAGATTGTGCCATTGCACTCCAGCCTGGGTAACAAGAGCGACACTCTGTCTCAAAAAAAAAAAAAAAAAAAAAAAAAAA"
"chr16","36528224","36528842","JH378119","32351107","32351490","270","4177117","GGCCAGGCGTGGTGGCTCACGCCTGTAATCCCAGCACTTTGGGAGGCTGAGGCAGGCAGATCACCTGAGGTCAGGAGTTCAAGACCAGCCTGGCCAACATGGTGAAACTCCATCTCTACTAAAAATACAAAATTAAGCCGGGCACGGTGGCTCACATCTGAAATCCCAGCACCTTGGGAGGCTAAGGCAGGCGGATCACGAGGTCAGGAGTTCAAGACTAGCTGACCAATATGGTGAAACCCCGTGTCTACTAAAAATACAAAAAAAATTAGCTGGGCGTGGTGGCGCATGCCTGTAGTTCCAGGTACTCAGGAGGCTGAGGAAGGAGAATCACTTGAACCTGGGAGGCGGAGGTTGCAGTGAGCCAAGATCATGCCACTGCATTCCAGCCTGGGCAACAGAGCAAGACTCTGTCTCAAAAATAAAAATAAAAATAAAAGTAAAAATACAAAATTAGCCAGGCGTGGTGGTGTGTGCCTGTAATCACAGCTACTCAGGAGGCAGGAAAATCACTTGAACCTAGGAGGAGGAGGTTGGTGAGCCAAGATCACACCATTGCACTCCAGCCTGGGCAAAAAGAGCAAAACTCCGAACTCTGTCTCAAAAAAAAAAAAAAAAA","GGCCAGGTATGGTGGCTCACACCTGTAATCCCAGCACTTTGGGAGGCCAAGGCAGGCAGACCACCTGAGGTCAGGAGTTCGAGATCAGCCTAGCCAACATGGTGAAACCCCATCTCTAGTAAAAATAAAATTAGCCAGGCATGGTGGTGCATGCCTGTAACGCAGGTCAGGAGTTCGAGATCAGCTTAGCCAACATGGTGAAACCCCATCTCTAGTAAAAATAAAATTAGCCAGGCAGGTGGTGCCGCCTGTACTCGGGAGGCTGAGGCAGGAGAATCACTTGAACCCAAGAGGCAGAGGTTGCAGTCAGCCAAGATCATGCCATTGCACTCCAGCCTAAGCAAAAAGAGTAAAACTCAGTCTCAAAACAAAAAAACAAAAAAA"
"chr16","44800308","44800913","JH378118","18053084","18053501","244","26747224","GGCCTGGTGCAGTGGCTCACACCTGTAATCCCAGCACTTTGGGAGCCCAAGGCGGGTGGATCACCTGAGGTCAGGAGTTCGAGACCAGCCTGGCCAACATGGTGAAATCCTCTCTACTAAAAATGCAAAAAATTAGCTGGGCGGCCAGGCGCAGTGGCTCACGCCTGTAATCCCAGCACTTTGGGAGGCCGAGGTGGGCGGATCACAAGGTCAGGAGATCGAGACCATGCTGGCTAACACGGTGAAACTCCGTCTCTACTGAAAATACAAAAAATTAGCCAGGCACGGTGGCGGGCGCCTGTAGTCCCAGCTACTGGGGAGGCTGAGGCAGGAGAATGGCGTGAACCTGGGAGGTGGAGGTAGCAGTGAGCCAAGATTGCGCCACCGCAGTCCGGCCTGGGTGAAAGAGCGAGACGCTGTCTCAAAAAAAAAAAAAAAAAATTAGCTGGGCATGGTGGCGGGCGCCTGTAATCCCAGTTACTCGGGAGGCTGAGGCAGGAGAATCAGTTGAACCCAGGAGGTGGAGGTTGCAGTAAGCCAAGATTGTGCCATTGTACTCCAGTCTGGGCAACAAGAGCGAAACTCTGTCTTAAAAAACAAAAAAAA","GGCTGGGCGCAGTGGCTCACACCTGTAATCCCAGCACTTAGGGAAGCTGAGGCGAGTAGATCACCTGAGGTCAGGAGTTAGAGACCAGCCTGGCCATCATGGTGAAACCCCGTCTCTACTAAAGATACCAAAAATTAGCTGAGTGTGGTGCTGGGTGCCTGTAATCCCAGAAACTCAGGGTGCCTGTAATCCCAGCAACTCAGGGTGCCTTTAATCCCAGCAACTGAGGGTACCAGTAATCCCAGCAACTCAGGGTGTCTTTAATCCTAGCAACTGAGGGCACCTGTAATCCCAGCAACTCAGGAAGCTGAGACAGGAGAAGTACTTGAACCCAGAAGGCAGAGGTTGCAGTGAGCCGATATTGCACCATTGCACTCCAGTCTGGGCAACAAGAGTGAAACTCTGTCTCAAAAAAAAA"
"chr16","45828895","45829498","JH378118","18053084","18053501","256","27775811","GGCCAGGAGAGGTGGCTCATGCTTGTAATTCCAGTATTTTGGGAGCCCAAGGCGGGTGGATCACTTGAGGTCAGGAGTTTGAAACCAGCCTGACCAACATGGTGAAACCCCGTCTCTACTAAAAATTCAAAATTAGGCAAGGCCTGGTGGCTCATGCCTGTAATCCCAGCACTTTGGGAGGCCAAGGAGGGAGGATCACCTGAGGTCGGGAGTTTGAGACCAGCCTGACCAACATGGAGAAACCCCGTCTCTACTAAAACTACAAAATTAGCCGGGTGTGGTGGCCCATGCCTCTAATCCCAGCTACTCTGGAGGCTGAGGCAGGAGAATCACTTGGACCTGGGATGTGAAGGTTGCAGTGAGCCAAGATCGAGCCATTGCACTCCAGCCTGGGCCACAAGAGTGAAACTCCGTCCCAGAAAAAAAAAAAAAAATTAACCTGGCATGGTGGTGTATGCCTGTAATCCCAGCTACTCGGGAGACTGAGGCAGGAGAATCTCTTGAACCCGGGAGGCGGAGGTTGCAGTAAACCGAGATTGCGCCATTGCACTCCGGCCTGGGTGACAAGAGCGAAACTCCGCCTAAAAAAAAAAAGAAAAGAAAA","GGCTGGGCGCAGTGGCTCACACCTGTAATCCCAGCACTTAGGGAAGCTGAGGCGAGTAGATCACCTGAGGTCAGGAGTTAGAGACCAGCCTGGCCATCATGGTGAAACCCCGTCTCTACTAAAGATACCAAAAATTAGCTGAGTGTGGTGCTGGGTGCCTGTAATCCCAGAAACTCAGGGTGCCTGTAATCCCAGCAACTCAGGGTGCCTTTAATCCCAGCAACTGAGGGTACCAGTAATCCCAGCAACTCAGGGTGTCTTTAATCCTAGCAACTGAGGGCACCTGTAATCCCAGCAACTCAGGAAGCTGAGACAGGAGAAGTACTTGAACCCAGAAGGCAGAGGTTGCAGTGAGCCGATATTGCACCATTGCACTCCAGTCTGGGCAACAAGAGTGAAACTCTGTCTCAAAAAAAAA"
"chr16","47110839","47111458","JH378118","18053084","18053501","268","29057755","GGCCAGGCGTGGTGGCTCACGCCTTTAATCCCAGCACTTTGGGAGGCCGAGGCAGGCAGATCACCTAAGGTCAGGAGTTCGAGACCAGCCTGGCCAACATGGTGAAACCCCCTCTCTACTAAAAATGCAAAAATTTCTGGGCATGGTGGCTCACGCCTGTAGTCCCAGCACTTTGGGAGGCCAAGGCAGGCGGATCACTTGAGGTCAGGAGTTTGAGACCAGCCTGGCCAACATGGTGAGACCCCTGTCTCTACTAAAAATATAAAAAAGTAGCCAGGCGTGGTGGTGTATGCCTCCCAGATAATTGGGAGGCTGAGGTGGGATAATTGCTTGAACCCGGGAGGCAGAGGTTGTAGTGAGCCAAGATAGCGCCAATGCACTCCAGCCTGGGCAACAGAGCGAGACTCTGTCTCAAAAAAAAAAAAAAAAAGAAAAAAGAAAAGAAATTAGCTGGGCGTGGTGATGGGTGCCTGTAATCCCAGCTGCTTAGGAAGCTGAGGAAGGAGAATCACTTAGACCCAGGAGACAGAGGTTGCAGTGAGCCGAGATCGCACCATTGTATTCCAGCCTGGGTGACAAGAGAAAAACTATGTCTCAAAAAAAAAAAAAAGAGTAGAAAA","GGCTGGGCGCAGTGGCTCACACCTGTAATCCCAGCACTTAGGGAAGCTGAGGCGAGTAGATCACCTGAGGTCAGGAGTTAGAGACCAGCCTGGCCATCATGGTGAAACCCCGTCTCTACTAAAGATACCAAAAATTAGCTGAGTGTGGTGCTGGGTGCCTGTAATCCCAGAAACTCAGGGTGCCTGTAATCCCAGCAACTCAGGGTGCCTTTAATCCCAGCAACTGAGGGTACCAGTAATCCCAGCAACTCAGGGTGTCTTTAATCCTAGCAACTGAGGGCACCTGTAATCCCAGCAACTCAGGAAGCTGAGACAGGAGAAGTACTTGAACCCAGAAGGCAGAGGTTGCAGTGAGCCGATATTGCACCATTGCACTCCAGTCTGGGCAACAAGAGTGAAACTCTGTCTCAAAAAAAAA"
"chr16","48159907","48160229","JH378222","6231244","6231546","61","41928663","GGCTGGGCACAGTGGCTCATGCCTGTAATCCCAGCACTTTGGGAGGCCGAGGCAGGCGGATCACCTGAGGTCAGGAGTTCGAGACTAGCCTGGCCAATATAGCGAAACCCCGTCTCTACTAAAAATTAGTTGGGCATGGTGGCAGGCGCCTTAATCCCAGCTACTTGGGATGCTGAGGCAGAAGAATCGCTTGAACCCAGAGGGTGGAGGTTTCAGTGAGATGAGATCGTGCCATTGCACTCCAGACTGGGCAACAAGAGCGAGACTCTGTAAAAAAAATTAATTAATTAATTAACTAATTAATTAAAATAAAATGAGAAAAA","GGCTGGGCATGGTGGCTCACGCCTGTAATCCCAGCACTTTGGGACGCTTAGGCAGGTGGATTGCCTGAGGTCAGGAGTTCAAGACTACCCTGACCAACATAGTGAAACCCCGTCTCTACTAAAAATTAGCTGGGCATGGTGGCAGAGGCCTGTAATCCCAGCTACTCGGGAGGCTGAGGCAGGAGAATCACTTAAACCTGGGAGTTGGAGGTTGCAGTGAGCCAAGATCAAGCCATTGCACTCCAGTCTGGGCAACAAGAGCAAGACTCTGTCTCAAAAAAAAAAAAAAAAAGAAAAGAAAAA"
"chr16","49252302","49252639","JH378314","538162","538484","57","48714140","GGCCAGGCGCAGTGGTGCATGTCTGTAATCTTAGCACTTTGGGAGGCCGAGGTGGACGGATTACATGAGGTCAGGAGTTCAAGACCAGCCTGGCCAACATGGTGAAATTCCATCTCTACTACTAAAAAAAAAAAAAAAAAAAAAAAAAAAAAAAAAAAAAAATACAAAAATTAGCTGGGCTTGGTGGCGGGTGCCTGTAATCCCAGCTACTTGGGAGGCTGAGGCAGGAATCACTTAAACCCAGGAGGTGGAGGTTGCAGTGAGCCAAGACCATGCCATTGCACTCCAGCCTGGGCAACAAGAGCAAAACTCCGTCTCAAAAAAACAAAACAAAAAAA","GGCTGGGTGCGGTGCCTCACACCTGTAATCCCAGCACTTTGGGAGGCCGAGGTGGGTGGATCACGAGGTCAAGAGATCAAGACCATCCTGGTCAACATGGTGAAACCCTGTCTCTACTAAAAAAAAAAAAAAAAAAAAAAAAAAAAAAAAAAAAATTAGCTGGGCATGGTGGCGTGTGCCTGTAATCCCAGCTACTCAGGAGGCTGAGGCAGGAGAATTGCCTGAACCCAGGAGGCGGAGGTTGCGGTGAGCCGAGACTGTACCATTGCACTCCAGCCTGGGTAACAAGAGCGAAACTCCATCTCAAAAAAAAAAAAAAAAAA"
"chr16","49464616","49465219","JH378118","18053084","18053501","254","31411532","GGCCAGGCGTGGTGGCTCACACCTGTAATCCTAGCACTTTGGGAGACTGAGGCAGGTGGATCACATGAGGTGAGGAGTTCAAAACCACCCTGGCCGACATGGTGAAACCCCGTCTCTACTAAAAATATTTTTAAAAAGGCCAGGCGTGGTGGCTCACACCTGTAATTCCAGCACTTCGGGAGGCTGGGGCAGGCAGATCACAAGGTCAGGAGATCGAGACCATTCTGGCCAACGTGGTGAAACCCCGTCTCTACTAAAAATACAAAAATTAGCTGGGCGTGGTGGCGCGTGCCTGTAATCCCAGCTACTTGGGAGGCTGATACAGGAGAATTGCTTGAACCAGTGAGTCAGAGGTTGCAGTGAGCTGAGATTGCGCCATTGCACTCCAGCCTGGCAACAGAATGAGACTCCGTCTCAAAAAAAAAAAAAAAATTAGCTGGGCATGGTGGCAGGCACCTGTGATCCCAGCTACTTGGGAGGCTGAGGCAGGAGAATCGCTTGAACCTGGGAGGTGGAGGTTGCAGTGAGCTGAGATTGCGCCATTGCACTCCAACCTGGGCGTCAAGAGCAAAACTCCATCTCAAAAATAAATAAATAAATAAAA","GGCTGGGCGCAGTGGCTCACACCTGTAATCCCAGCACTTAGGGAAGCTGAGGCGAGTAGATCACCTGAGGTCAGGAGTTAGAGACCAGCCTGGCCATCATGGTGAAACCCCGTCTCTACTAAAGATACCAAAAATTAGCTGAGTGTGGTGCTGGGTGCCTGTAATCCCAGAAACTCAGGGTGCCTGTAATCCCAGCAACTCAGGGTGCCTTTAATCCCAGCAACTGAGGGTACCAGTAATCCCAGCAACTCAGGGTGTCTTTAATCCTAGCAACTGAGGGCACCTGTAATCCCAGCAACTCAGGAAGCTGAGACAGGAGAAGTACTTGAACCCAGAAGGCAGAGGTTGCAGTGAGCCGATATTGCACCATTGCACTCCAGTCTGGGCAACAAGAGTGAAACTCTGTCTCAAAAAAAAA"
"chr16","49983504","49983843","JH378316","567988","568320","50","49415516","GGCCAGGCATGGTGGCTTACGCCTGTAATCTCAGCACTTTGGGAGGCCAAGGCAGGCGGATCACCTGAGGTCAGGAGTTCAAGACCAGCCTGGTCAACATGGCGAAACCCTGTCTCTACTAAAAAAATACAAAAATTAGCCAGGCGTGGTGGTGGGCGCCTGTAATCTCTCCTACTTGGGAGACTGAGGCAGGAGAATTGCTTGAACTCAGAAGGCAGAGGTTGCAGTGAGCTGAGATCACGCCATTGCACTCCAGCCTGGATGACAAGAGCAAAACTCCATCTCAAACAAACAAAAAACAAACAAACAAAAAAAAACAAAAAAACCTCCAAAAAACAAA","GGCCGGGCGTGGTGGCTCACGCCTGTAATCCCAGCACCTTGGGAGGCTGAGGCGGGTGGATCACGAGGTCAAGAGATTGAGACCAGCCTGGTCAACATGGTGAAACCCTGTCTACTAAAAAAATACAAAAATTAGCTGGGCATGGTGGCACGTGCCTGTAATCCCAGCTACTCAGGAGGCTGAGGCAGGAGAATTGCCTGAACCCAGGAGGCGGAGGTTGCGGTGAGCCGAGATCGCGCCATTGCACTCCAGCCTGGGTAACAAGAGCGAAACTCCGTCTCAAAAAACAAAAAACAAAAAAACAAAAAACAAACAAACAAACAAAAAAACAAA"
"chr16","50470493","50471105","JH378118","18053084","18053501","251","32417409","GGCTGGGAGCGGTGGCTCATACCTGTAATCCCAGCACTCTGGGAGGCCGAGGCGCGTGGATCACCTGAGGTCAGGAGTTTGAGACCAGCCTGGCCAGCATGGTGAAACCCTGTCTCTACTAAAAATAGAAAAAGTTAGCTGGGTGAACAGCCGGGCGCGGTGGCTCACACCTGTAATCCCAGCACTTTGGGAGGCCGAGGCAGGTGGATCACAAGGTCAGGAGATCGAGACCATCCTGGCTAACACGGTGAAACCCTGTCTCTACTAAAAATATAAAAAATTAGCCGGGCATGGTGGTGGGTGCCTGTAGTCCCAGCTGCTCAGGAGGCTGAGGCAGGAGAATGGCGTGAAGCCAGGAGGCAGAGGTTGCAGTGAGCCGAGATCGTACCACTGCACTCTAGCCTGGGTGACAGAACGAGACTGTGTCTCAAAGAAAAAAAAAATTAGCTGGGTGTGGTGGCAGACACCTGTAATCCTAGCTACTTGGGAGGTTGAGGCAGGAGAATCGCTTGGACCTGGGAGGCGGAGGTTGCAGTAGGCTGAAATCGCACCATTGCACTCCAGCCTGGGCAACAAGAGGGAAACTCAGTCTCAAAAAAAAAAAAAAAAAAAA","GGCTGGGCGCAGTGGCTCACACCTGTAATCCCAGCACTTAGGGAAGCTGAGGCGAGTAGATCACCTGAGGTCAGGAGTTAGAGACCAGCCTGGCCATCATGGTGAAACCCCGTCTCTACTAAAGATACCAAAAATTAGCTGAGTGTGGTGCTGGGTGCCTGTAATCCCAGAAACTCAGGGTGCCTGTAATCCCAGCAACTCAGGGTGCCTTTAATCCCAGCAACTGAGGGTACCAGTAATCCCAGCAACTCAGGGTGTCTTTAATCCTAGCAACTGAGGGCACCTGTAATCCCAGCAACTCAGGAAGCTGAGACAGGAGAAGTACTTGAACCCAGAAGGCAGAGGTTGCAGTGAGCCGATATTGCACCATTGCACTCCAGTCTGGGCAACAAGAGTGAAACTCTGTCTCAAAAAAAAA"
"chr16","50478366","50478929","JH378114","15957391","15957789","242","34520975","GGCTGGGCACGGTGGCTCATGCCTGTAATCCTAGTACCCTGGGAGGCTGAAGCTGGCAGATCACTTGAGGTCAGGAGTTCGAAACCAGCCTGGCCAACATGGTGAAACCTCATCACTACTAAAAATACAAAAAGTCAGCCGAGCGCGGTGGCTCACGCCTTTAATCCCAGCACTTTAGGAGTCTGAGGCGGGTGGATCACAAGGTCAGGGGTTTGAGACTAGCCTGACCAACACGGTGAAACATCTTTACTAAAAATAGCCAGGCATGGTGGTGCAGGCCTGTAGCAGGTACTCAGGAGGCTGAGGCAGCAGAATCGCTTGAACCCGGGAGGCGGAGGTTGCAGTGAGCCGAGATTGAGCCACTGCACTCCACCCTGGGCAACTGAGCGAGACTCCGTCTCAAAAAAAAAAAAAAAAATTAGCTGGACGTGGTGGTGGATGCCTGTAATCCCGGCTACTTGGTACTTGGAAGGCTGAGACAGGAGAATCGCTTGAACCCGGGAGGTGGAGGTTGCAGTGAGCTGAGATAGCGCCATTGCACTCCAGCCTGGGCAACAAGAGTGA","GCAAGGAACGGTGGCTCATGCCTGTCATCCCAGCACTTTGGGAGGCTAAGGAGGGTGGATTACCGAAGGTCATGAGTTTGAGACCAGCCTGACCAACATGGTGAAAACCCCATCTCTACTAAAAATACAAAAAATTAGCCAGATACAGCTATGCGGCAGACTGGGGCAGGAGAATCGCTTGGACCCAAACCCCATCTCTACTAAAAATACAAAAAATTAGCCGGATACAGCTATGCGGGAGACTGGGGCAGGAGAATCGCTTGGACCCGGGAGGCAGAGATTGCAGTGAGATGAGACCATGCCATTGCTCTCTAGCTTGTGCGATGAGAACAAGACTCTGTCTCAAAAAAAAAAAAAAAAAAAAAAAAAAAAAAAAAAAAAAAAGAGAGAGAGAGAAAA"
"chr16","51388263","51388584","JH378271","2122362","2122678","46","49265901","GGCTGGGTACGGTGGCCCACACCTGTAATCCCAGCACCTTGGGAGGCTGAGGTGGGCGGATTACCTGAGGTCAAAAGTTCAAGACCAGCCTGGCCAACATGGTGAAATCCCATCTCTGCTAAAAATACAAAAAAAAAAAAAAAAAAAAAAAAAAAATTGCCAGGCATGGTGGCAGGCACCTGTAATCCCAGCTACTTGGGAGGCTGAGGCAGGGGAATCGCTTGAACCTGGGAGGCAGAGGTTGCAGTGAGCCCAGATAGCGCCATTGCACTCCAGCCTGGGCGACAAGAGCGAAACTCTGTCCAAAAAAAAAAAAAAAAAA","GGCCGGGCACGGTGGCTCACACCTGTAATCCCAGCACTTTGGGAGGCTGAGGTGGGTGAATCACCTGAGGTCAGGAGTTTGAGACCAGCCTGACCAACATGATGAAACCCGGTCTCTGCTAAAAATACAAAAAAAAAAAAAAAAAAAAAAAAAAAAAGCTGGGCATGATGGTGGGCACCTGTAATCCCAGCTACTCGGGAGGCTGAGGCAGGAGAATCGCTTGAACACCAGGAGGTGGAGGTTGCTATGAGCCGAGATCGCACCATTGCACTCTAGCTTGGGCAACAAGAGAGAAACTCCATCAAAAAAAAAAAAAA"
"chr16","51876298","51876882","JH378118","18053084","18053501","253","33823214","GTAATCCCAGCACTTTGGGAGGCCCAAGTGGGTGGATCACCTGAGGTCAGGAGTTCATGACCAGCCTGGCCACATGGTGAAACCCCATCTCTACTAAAAATACAAAATTAGGCTGGGCGCGGTGGCTTACGTCTGTAATTCCAGCACTTTGGGAGGCCGAGGCAGGCGGATCATGAGGTCAGGAGATTGAAACCATCCTGGCTAACACGGTGAAACCCTGTCTCTACTAAAAATACAAAAAATTAGCCGGGTGTGGTGGGGGGGCGCCTGTAGTCCCAGCTGCTCAGGAGGCTGAGGCAGGAGAATGGCATGAACCCGGGGGGGCGGAGCTTGCAGTGAGCTGAGATCATGCCACTGCACTCCAGCCTGGGCAACAAAGTGAGACTCCGTCTCAAAAAAAAAAACCAAAAAACAAAATGAGCTGGGTGTGGTGGTGGGGGCGTATAATCCCAGCTATACAGGAGGCTGAGGTAGGAGAATCACTTGAACCCGGGAGGTGGAGGTTGCAGTGAGCCGAGATTGTGCCATTTCACACCAACCTGGGTAACAAGAGTAAAATGCTGTCTCAAAAAAAAAAAAGAAAAA","GGCTGGGCGCAGTGGCTCACACCTGTAATCCCAGCACTTAGGGAAGCTGAGGCGAGTAGATCACCTGAGGTCAGGAGTTAGAGACCAGCCTGGCCATCATGGTGAAACCCCGTCTCTACTAAAGATACCAAAAATTAGCTGAGTGTGGTGCTGGGTGCCTGTAATCCCAGAAACTCAGGGTGCCTGTAATCCCAGCAACTCAGGGTGCCTTTAATCCCAGCAACTGAGGGTACCAGTAATCCCAGCAACTCAGGGTGTCTTTAATCCTAGCAACTGAGGGCACCTGTAATCCCAGCAACTCAGGAAGCTGAGACAGGAGAAGTACTTGAACCCAGAAGGCAGAGGTTGCAGTGAGCCGATATTGCACCATTGCACTCCAGTCTGGGCAACAAGAGTGAAACTCTGTCTCAAAAAAAAA"
"chr16","59738190","59738518","JH378138","4229795","4230103","67","55508395","TCACAGCATTTTGGGAGGCCAAGGCAGGCGGATCACCTGTGGTCAGGAGTTTGAGACCAGCCTGGCCAACATGGTGAAACCCCATCTCTACTAAAAATACAAAACAATTAGCCAGGTTTGGTGGCAGGCGCCTATAATCCCAGCTACTTGGGAGGCTGAGGCAGGAGAATCGCTTGAACCCAGGAGGCGGAGGTTGCAGTGAGCCGAGAACACACCATTGTACTCCAGCCTGCGACAAGAACGAAACTGTATCTCAATTAAAAAAAAAAAAAGAAAGGGAGGAAGGAAGGAAGGAAGGAAGGAAGGAAGGAAGGAAGAAAGAAAGAAAA","CACTTTGGGAGGTGAAGGCGGGCAGATCACCTGAGGTCAGGAGTTCGAGACCAGCCTGGCCAACATGGTGAAACCCCGCCTCTACTAAAAATACAAAAATTAGCCAGGTGTGACACTAGGCATCTGTAATCCCAGCTACTTGGGAGGCTGAGACAGGAGAATCACTTGAACCCAGGAGGCGGAAGTTGCAGTGAGCCAAGATCATGCCATTGCACTCCAGCCTGGGTGACAGGAGCAAAACTCTGTCTCAAAAAAAAAAAAAAAAAAAAAAAAAAAAAAAAAAAAAAAAGAAAAGAAAAGAAAAGTAAA"
"chr16","64682336","64682940","JH378118","18053084","18053501","253","46629252","GGCCGGGCACGGTGGCTCACTCCTGTAATCCCAGCACTTTGGGAGGGTGAGGCAGGTAGATCAAAAGGTCAGGAGTGGCCAGGCGTGGTGGCTCACACTTGTAATCCCAGCACTTTGGGAGGCCGAGATGGGCAGATCACGAGGTCAAGAGATTGAGACCATCCTGGCTAACATGGTGAAACCCCGTCTCTACTAAAAATACAAAAAATTAGCCGGGTGTGGTGGCAGGCGTCTGTAATCCCAGCCACTTGGGAGGCTGAGGCAGGAGAATCGCTTGAACCTGGGCGGCAGAGGTTGCATTGAGCCAGGATCGCGCCACTGCACTCCAGCCTGAGCAAAAAGAGCGAAACTCTGTCTCAGAAAAAAAAAAAAGTCAGGAGTTTGAGACCAGCCTGGCCAATATGGTGAAACCCCGTCTCTACTAAAAATACAAAAATTAGCCGAGCGTGGTGGTGGGTGCCTATACTCCCAGCTACTCAGGAGGCTGAGGCAGGAGAATCACTTGAACCCCAGGGGCAGAGGTTGCAGTGAGCCGAGATCGTGCCATTGCACTTCACCCTGGGTGAAAGAGCAAAACTCCGTCTCAAAAAAACAAAACAAAAAAA","GGCTGGGCGCAGTGGCTCACACCTGTAATCCCAGCACTTAGGGAAGCTGAGGCGAGTAGATCACCTGAGGTCAGGAGTTAGAGACCAGCCTGGCCATCATGGTGAAACCCCGTCTCTACTAAAGATACCAAAAATTAGCTGAGTGTGGTGCTGGGTGCCTGTAATCCCAGAAACTCAGGGTGCCTGTAATCCCAGCAACTCAGGGTGCCTTTAATCCCAGCAACTGAGGGTACCAGTAATCCCAGCAACTCAGGGTGTCTTTAATCCTAGCAACTGAGGGCACCTGTAATCCCAGCAACTCAGGAAGCTGAGACAGGAGAAGTACTTGAACCCAGAAGGCAGAGGTTGCAGTGAGCCGATATTGCACCATTGCACTCCAGTCTGGGCAACAAGAGTGAAACTCTGTCTCAAAAAAAAA"
"chr16","67872770","67873371","JH378118","18053084","18053501","260","49819686","GGCTGGGCATGGTGGCTCATGCCTGTAATCCCAGCACTTTGGGAGGCCAAGACGGGCAAATCACCTCAGGTCAGGAGATCGAGACCAGCCTGGCCAACACAGCAAAACCCACCTCTCTACTAAAAATAGAAAAATTACCCAGGCGTCACAGCTCACGCTTATAATCCCAGCACTTTGGGAGGCCGAAGCAGGTGGATCACAAGGTCAGGAGATCGAGACCAGCCTCACTAACATGGTGAAACCCCGTCTCTACTGAATATACGAAAAATTAGTCGGGTGTGGTGGCAGGCACCTGTAGTCCCAGCTACTTGGGAGGCTGAGGCAGGAGAATGGCTTTAACTCAGGAAGAGGAGCTTACGGTGAGCTGAGATTGTGCCACTGCACCCCAGCCTGGGCGACAGAGCAAGACTCCGTCAAAAAAAAAAAAAACCCCAAAACCCCAGCGTGGCAGCAGGTACCTGTAGTCCCAGCTACTCGGGAGGCTGAGACAGGAGAATGGCTTGAACCCGGGAGGCGGAGCTTGCGGTGAGCCAAGACGGCGCCACTTCATTCCAGCTATGGTGATAAGAGGGAGACCGTCTCAATCAATAAATTTAAAAAAA","GGCTGGGCGCAGTGGCTCACACCTGTAATCCCAGCACTTAGGGAAGCTGAGGCGAGTAGATCACCTGAGGTCAGGAGTTAGAGACCAGCCTGGCCATCATGGTGAAACCCCGTCTCTACTAAAGATACCAAAAATTAGCTGAGTGTGGTGCTGGGTGCCTGTAATCCCAGAAACTCAGGGTGCCTGTAATCCCAGCAACTCAGGGTGCCTTTAATCCCAGCAACTGAGGGTACCAGTAATCCCAGCAACTCAGGGTGTCTTTAATCCTAGCAACTGAGGGCACCTGTAATCCCAGCAACTCAGGAAGCTGAGACAGGAGAAGTACTTGAACCCAGAAGGCAGAGGTTGCAGTGAGCCGATATTGCACCATTGCACTCCAGTCTGGGCAACAAGAGTGAAACTCTGTCTCAAAAAAAAA"
"chr16","67970409","67971018","JH378118","18053084","18053501","252","49917325","GGGCGGGTGCGGTGGCTCACCCTGTAATCCCAGCACTTTCGGAGGCTTAAGCAGGCGGATCACCTGAGGTCAGGAGTTCGAGACCAGCCTGGCCAACATGGTGAAACCCCATCTCTACTAAAAATACAAAAAAATGGCCGGGTGCGGCGGCTCATGCCTGTCATCCCAGCACTTTCGGAGGCTGAGGCAGGCGGATCACCGGAGGTCAGGAGTTCGAGACCAGCTTGGCCAACATGGTGAAACCCCGTCTCTACTAAAAATACAAAAGTTAGCTGGGCATGGTGGCACATGCCTGTAATCCCAGCTACTCCGGAGGCTGAGGCAGGAGAATCACTTGAACCTGGGGAGGCGGAGGTTGCAGTGAGCTGAAATCACGGCATTGCACTCCAGCCTAGGCAACAGAGCGAAAGTCCGTCTCAGAAAAAAAAAAAAAAAAATTAGATGGGTTTGGTGGCGGGCGCGCTGTAATCCCAGCTACTTGGGAGGCTGGAGGCAGGAGAATCGCTTGAACTCAGGAGGCTGAGGTTACAGTGAGCCGAGATCATGCCATTGCACTCCAGCCTGGGCAATAAGAGTGAAACTCTGTCTCAAAAAACAACAACAACAAAAA","GGCTGGGCGCAGTGGCTCACACCTGTAATCCCAGCACTTAGGGAAGCTGAGGCGAGTAGATCACCTGAGGTCAGGAGTTAGAGACCAGCCTGGCCATCATGGTGAAACCCCGTCTCTACTAAAGATACCAAAAATTAGCTGAGTGTGGTGCTGGGTGCCTGTAATCCCAGAAACTCAGGGTGCCTGTAATCCCAGCAACTCAGGGTGCCTTTAATCCCAGCAACTGAGGGTACCAGTAATCCCAGCAACTCAGGGTGTCTTTAATCCTAGCAACTGAGGGCACCTGTAATCCCAGCAACTCAGGAAGCTGAGACAGGAGAAGTACTTGAACCCAGAAGGCAGAGGTTGCAGTGAGCCGATATTGCACCATTGCACTCCAGTCTGGGCAACAAGAGTGAAACTCTGTCTCAAAAAAAAA"
"chr16","68229729","68230314","JH378206","6546474","6546861","256","61683255","TGGTTTCCGCCTGTACTCCCAGCACTTTCGGAGGCTCAAGTGAGCAGATCGCTTGAGGCCAGGAGTTTAAGACCTACCTAGTCAACACCGGGGAAACCCACATCTCCACTAAACAATGGCCAGGAGCAGTGGCTCATACCTGTAATCACAACACTTTGGGATCCCAGCCAGACGGATCACAAAGTCAGGAGTTTGCGACCAGCCTATTAGAATGGTGAAACCCTGTCTCTACTAAAAATACAAAAAATTAGCCAGGCATGGTGGCGCATGCCTGTCATCCCAGCTACTCGGGAGGCTGAGGCAAGAGAATCACTTAAACCCAGGAGGCAGATGGAGGTTGCAGTGAGCCAAGATCACACCACTGCACTACAGCATGGGCGACAGAGCAAGACTCGGTCTCAAAAAAAAAAAAATTGGCCAGGCACGGTGGCTGACACCTGTAATCCCAGCACTTTGGGAGGCTGAGGCGGGAGAATCGCTTGAACCTGGGAGACGAAGGTTGCAGTGAGCCGAGACTAAGCCATTGCACCCCAACCTGGGCGGCAAGAGTGAAACTCTGTCTCAAAAAAAATTAAAAAATAAAAAA","GGCCACACATGGTGGCTAACGCCTGTAATCCCAGCACTTTGGGAGGCCAAGTCGGGTGGATCATGAGGTCAGGAGACCAAGACCATCCTGGCCAAATGGTGAAACCCCGTCTCTACTAAAAATACAAAAATTAGCTGGGCATGGTGGCGTGTGCCTGTAATCCCAGCTACTCAGGAGGCTGAGGCAGGACAATTGCCTGAACCCAGGAGAATTAGCTGGGCATGGTGGCGTGTGCCTGTAATCCCAGCTACTCAGGAGGCTGAGGCAGGACAATTGCCTGAACCCAGGAGGCGAAGGTTGCGGTGAGCCGAGATTGTGCCATTGCACTCCAGCCTGGGTAACAAGAGCGACACTCTGTCTCAAAAAAAAAAAAAAAAAAAAAAAAAAA"
"chr17","3506470","3507049","JH378118","18053084","18053501","238","14546614","CCTGTCATCCCAGCACTTTGGGAGGCCGAGGCGGGTAGATCACCTGAGGTCAGGAGTTTGAGACCAGCCTGGCCAACATGGCGAAACCCCGTCTCTACTAAAAATACAAAAACTGGCTGGGCGCGGTGGCTCACGCCTGTAATCCCAGCACTTTGGGAGGCTGAGGCGGGTGGATCATAAGGTCAGGAGTTCAAGACCAGCCTGGCCAACATGGTGAAACCCCATCTCTACTAAAAATACAAAAATTAGCCAGGTATGGTGGCAGGTGCCTGTAATCCCAGCTACTCAGGAGGCTGAGGCAGAGAATTGCTTGAACCCGGGAGGGGGAGGTTGCAGAGGGCCAAGATCGTACCACTATACTCCAGCCTGGGTGACAGGATGAGACTCCATCTTAAAAAAAAAAAAAAAAAAAAAAATTAGCCAGGCGTGGTGCGGGCACTTGTAATCCCAGCTATTCAGGAGGCTGAGGCAGGAGAATTGCTTGAACCCGGGAGGCAGAGGTTGCGGTGAGCTGAGATCGCACCATTGCACTCCAGCCTGGGCAACAAGAGTGAAACTCTGTCTCAAAAAAAAAACAAAA","GGCTGGGCGCAGTGGCTCACACCTGTAATCCCAGCACTTAGGGAAGCTGAGGCGAGTAGATCACCTGAGGTCAGGAGTTAGAGACCAGCCTGGCCATCATGGTGAAACCCCGTCTCTACTAAAGATACCAAAAATTAGCTGAGTGTGGTGCTGGGTGCCTGTAATCCCAGAAACTCAGGGTGCCTGTAATCCCAGCAACTCAGGGTGCCTTTAATCCCAGCAACTGAGGGTACCAGTAATCCCAGCAACTCAGGGTGTCTTTAATCCTAGCAACTGAGGGCACCTGTAATCCCAGCAACTCAGGAAGCTGAGACAGGAGAAGTACTTGAACCCAGAAGGCAGAGGTTGCAGTGAGCCGATATTGCACCATTGCACTCCAGTCTGGGCAACAAGAGTGAAACTCTGTCTCAAAAAAAAA"
"chr17","3641899","3642243","JH378198","5062782","5063109","59","1420883","GGCCAGGCACAGTGGCTCACACCTGTAATCCCAGCACTTCAGGAGGCCGAGGTGGGTAGATCACCTGAGGTCAGGGGTTTGAGACCAGCCTGACCGACGTGGCGAAACCCTGTCTCTACTACAAATACAAAAATTAGCCTTATGTGGTGGCGGGCACGTGTAATCCCAGCTACTTGGGAGGCTGAGGCAGGAGAATCGCTTGAATCTGGGAGGTGGAGGTTGCAGTGAGCCGAGATCACGCCATTGCACTCCAGCCTGGGTGACAAGAGCGAAACTCCATCTCAAAATAAATAAATACATACATACATGTATACATACATACATACATAAAAATAAAAAGTAAAA","GCCAGGCATGGTGGCTCACGCCTATAATCTCAGCACTTTGGGAGGCTGAGGCAGGCAGATCACTTGAGGTCAGGAGTTCAAGACCAGCCTGGCCAACATGGTGAAACCCTGGCTCTACTAAAAATACAAAAATTAGCCGGGTGTGGTGGCACGTGCCTATAATCCCAGCTACTCAGGAGGCTGAGGCAGAAGAATCGCTTGAATCCAGGAGGTGGAGGTTGCAGCGAGCCGAGATCACACCATTGGACTCCAGCCTGGGTGACAAGAGCGAAACTCCATCTCAAAATAAATAAATAAATACATAAAATTAAAAATAAATAAATAAATA"
"chr17","4508039","4508546","JH378206","6546474","6546861","194","2038435","GAGTTGGAGACCAGCCTGGCCAACACGGTGAAACCTCGTCCCCACTAAAAATATAAAAATTAGGCCAGGCGCGGTGGCTCACTCCTGTAATCCCAGCACTTTGGGAGGCTGAGGCGGGTAGATCATCTGAGGTCAGGAGTTCGAGACCAGCCTGGCCAACATGGTGAAACTCCGTCTCTACTAAAAATACAAAAATTAGCTGGGCTGGTAGCGGGCACCTGTAATCCCAGCTACTTGGAAGGGTGAGGCAGGAGAATCACTTGAACCCAGGAGGTGGAGGTTGCAGTGAGCCAAGATTGCAGCACTGTACTCCAGCCTGGGTGACAAAGCAAGACTCTGTCTCAAAAAAAAAAAAAAAAAAAAAGCCGGGCTTGGTGGTGAGTACCGGTAATCCCAGCTACTTGGAAGGCTGAGGCGGCGGACGTTGTACTTAGCCGAGATCATGCCATTGCACTCCAGCCTGGGTAACAGGCAAAAACTCTGTCTCAAAAAATAATAAATAATAAAA","GGCCACACATGGTGGCTAACGCCTGTAATCCCAGCACTTTGGGAGGCCAAGTCGGGTGGATCATGAGGTCAGGAGACCAAGACCATCCTGGCCAAATGGTGAAACCCCGTCTCTACTAAAAATACAAAAATTAGCTGGGCATGGTGGCGTGTGCCTGTAATCCCAGCTACTCAGGAGGCTGAGGCAGGACAATTGCCTGAACCCAGGAGAATTAGCTGGGCATGGTGGCGTGTGCCTGTAATCCCAGCTACTCAGGAGGCTGAGGCAGGACAATTGCCTGAACCCAGGAGGCGAAGGTTGCGGTGAGCCGAGATTGTGCCATTGCACTCCAGCCTGGGTAACAAGAGCGACACTCTGTCTCAAAAAAAAAAAAAAAAAAAAAAAAAAA"
"chr17","4560867","4561450","JH378118","18053084","18053501","257","13492217","GGCTGGGGGTGGTGTCTCTTGCCTGTAATCCCAACACTTTAGCAGGCTGAGGTGTGAGTATGGCTTGAGCCAGGAGTTCTAGACCAGCCTAGGAAACATGGCGAGATCCCTATCTCTACTAATACAAAAATTAGCCGGGCGTGGTGGCAAGCACCTGCAATCTCAGCTACTCGGGAGGCTGAGGTGGGAGGGCCGCTTGAGCCCAGGAGGTCCAGGCTGCAGTAAGCACTTATTTAAAAAAAAAAGAAGAGAAAAGATACAGAAATTAGCCAGGCGTGGTGGTGGGCACCTGTAATCCCAGCTACTCAGGAGGCTGAGGCAGGAAAATCACTTGAACCCGGGAGGCAGAGGTTGCAGTGGGCCGAGATCACACCATTGTACTCCAGCCTGGGCAACAAGAGCGAAACTCTGTCTCAAAAAAAAGAAAAGTAAAGTAAAGAAAAGATACAGAAATTAGCCAGGTGTGGTGGCGGGTGCCTGTAATCCCGCTACTTGGGAGGCTGAGGCAGGAGATTGCAGTGAGCCAAGATTGTGCCATTGCATTCCAGCCTGGGCAACAAGAGCAAAACTCCGCCTCAAAAAAA","GGCTGGGCGCAGTGGCTCACACCTGTAATCCCAGCACTTAGGGAAGCTGAGGCGAGTAGATCACCTGAGGTCAGGAGTTAGAGACCAGCCTGGCCATCATGGTGAAACCCCGTCTCTACTAAAGATACCAAAAATTAGCTGAGTGTGGTGCTGGGTGCCTGTAATCCCAGAAACTCAGGGTGCCTGTAATCCCAGCAACTCAGGGTGCCTTTAATCCCAGCAACTGAGGGTACCAGTAATCCCAGCAACTCAGGGTGTCTTTAATCCTAGCAACTGAGGGCACCTGTAATCCCAGCAACTCAGGAAGCTGAGACAGGAGAAGTACTTGAACCCAGAAGGCAGAGGTTGCAGTGAGCCGATATTGCACCATTGCACTCCAGTCTGGGCAACAAGAGTGAAACTCTGTCTCAAAAAAAAA"
"chr17","4846296","4846953","JH378118","18053084","18053501","290","13206788","GGCCAGGTGCAGTGGCTCACGCCTGTAATCCCAGCACTTTGGGAAGCCCAGGTGGGCGGATCACCCAAGGTCAGGGGTTCGAGACCAGCCTGGCCAACATGGTGAAACTCCATCTCTACTAAAAATAGAAAAAAATGGCCTGGTACGGTGGCTAACGCCTGTAATCCCAGCACTTTGGTAGGCCGAGGCAGGCAGATCACGAGGTCAGAAGATCGAGACCATCCTGGCTAACATGGTGAAACCCCGTCTCTACTAAAAATACAAAAAAGTAGCCAGGTGTGGTGGTGGGTGCCTGTAGTCCTAGCTACTCGGGAGGCTGAGGCAGGAGAATGCCGTGAACCCGGGAGGTGGAGCTTGCAGTGAGCTGAGATCACGCCACTGCACTCCAGCCTGGGTGACAGTGCGAGACTGTCTCCAAAAAAAAAAAAAAAAAAAAATTATATATATAATACACACACACACACACACACACACACACACACACAAATCAGCCAGGCGTGGTGGTGCGCACCTGTAATCCCAGCTACTCGGGAGGCTGAGGCAGGAGAGCTCCTCGAACCCAGGAGGCGAAGGTTGCAGTGAGCCGAGATCACACCATTGCACTCCAGCCTGGGCAACAAGAGCGAAACTCTGTCTCAAGGAAAAAAAAAAAAAAAAA","GGCTGGGCGCAGTGGCTCACACCTGTAATCCCAGCACTTAGGGAAGCTGAGGCGAGTAGATCACCTGAGGTCAGGAGTTAGAGACCAGCCTGGCCATCATGGTGAAACCCCGTCTCTACTAAAGATACCAAAAATTAGCTGAGTGTGGTGCTGGGTGCCTGTAATCCCAGAAACTCAGGGTGCCTGTAATCCCAGCAACTCAGGGTGCCTTTAATCCCAGCAACTGAGGGTACCAGTAATCCCAGCAACTCAGGGTGTCTTTAATCCTAGCAACTGAGGGCACCTGTAATCCCAGCAACTCAGGAAGCTGAGACAGGAGAAGTACTTGAACCCAGAAGGCAGAGGTTGCAGTGAGCCGATATTGCACCATTGCACTCCAGTCTGGGCAACAAGAGTGAAACTCTGTCTCAAAAAAAAA"
"chr17","6289040","6289368","JH378152","15932639","15932952","57","9643599","GGCTGGGCGTGGTGGCTCACGCCTGTAATCCCAGCACTTTGGGAGGCCAAGGTGGGTAGATCACCTGAGGTCAGGAGTTTGAGACCAGCCTGGCCAATGTGATGAAACCCTGTATCCACTAAAAAAAAAAAAAAAAAAAAAAAAAAAAATAGCTGGGTGAAGTGGCAAGCACCTGTAATCCCAGCTACTTGGGAGGCTGAGGCAGGAGAATCCCAGGAGGTGGAGATTGATCCCAGGAGGTGGAGGTTGCAGTGAGTCAAGATCATGCCATTGCACTCCAGCCTGGGTGACAAGAGCAAAATTCCATCTCAAAAAAAAAAAAAAGAAAA","GGCCGGGCATGGTGGCTCAAGCCTGTAATCCCAGCACTTTGGGAGGCCGAGGCGGGTGGATCACGAGGTCAAGAGATTGAGACCATCCTGGTCAACATGGTGAAACCCCGTCTCTACTAAAAATACAAAAAAAAAAAAAAAAAAAATAGCTGGGTGTGGTGGCGTGTGCCTGTAATCCCAGCTACTCAGGAGGCTGAGGCAGGAGAATTGCCTGAACCCGGGAGGCGGAGGTTGCGGTGAGCCGAGATCGCGCCATTGCACTCCAGCCTGGGTAACAAGAGCGAAACTCCGTCTCAAAAACAAAAAAAACAAAA"
"chr17","7490664","7491294","JH378118","18053084","18053501","283","10562420","GGCCGGGAGCGGTGGTTCACTCCTGTAATCCCAGCACTTTGGCAGACCGAGGAGGGTGGATCAACTGAGGTCAGAACTTCAAGACCAGCCTGCCGGGCACAGTGGCTCACACCTGTAATCCCAGCACTTTGGGAGGCTGAGGCAGGTGGATCACCCGAGGTCGGGAGTTCAAGACCAGCCTGACCAACGTGGAGAAACCCCGTCTCTACTAAAAATACAAAATTAGCTGGGGTGGTGGCACGTACCTGTAATCCCAGCTACTCGGGAGGCTGAGGCAAGAGAATCGCTTGAACCCGGGAGGCGGAGGTTGCGGTGCGCCGAGATCGCGCCATTACACTCCAGCCTGGGCAAAAAGAGCGAAACTCTGTCTCAAAAAATAAAAAAAGAAAAAGAAAAAGAAAAAGAAGTTCAAGACCAGCCTGGTCAACGTGGTGAAACCCCGTCTCTACTAAAAACACAAAAAAAATTAGGCGGGTGTTGTGGTGGGTGCCTGTAATCCCAGCTACTCAGGAGGCCAAGGCAGGAGAATCACCTGAACCCTGGAGGTGGAGGTTGCAGTGAGTCGAGATCGCACCATTGCACTCCAGCGTGGGTGACAGAGAGCGAGACTCCGTCTCAAAAAAAAAGAAAA","GGCTGGGCGCAGTGGCTCACACCTGTAATCCCAGCACTTAGGGAAGCTGAGGCGAGTAGATCACCTGAGGTCAGGAGTTAGAGACCAGCCTGGCCATCATGGTGAAACCCCGTCTCTACTAAAGATACCAAAAATTAGCTGAGTGTGGTGCTGGGTGCCTGTAATCCCAGAAACTCAGGGTGCCTGTAATCCCAGCAACTCAGGGTGCCTTTAATCCCAGCAACTGAGGGTACCAGTAATCCCAGCAACTCAGGGTGTCTTTAATCCTAGCAACTGAGGGCACCTGTAATCCCAGCAACTCAGGAAGCTGAGACAGGAGAAGTACTTGAACCCAGAAGGCAGAGGTTGCAGTGAGCCGATATTGCACCATTGCACTCCAGTCTGGGCAACAAGAGTGAAACTCTGTCTCAAAAAAAAA"
"chr17","9634166","9634493","JH378110","12773123","12773444","45","3138957","GGCTGGGTGCGGTGGCTCACGCCTGTAATCCCAGCACTGTGGGAGGCCGAGGCAGGTGGATCACCTGAGGTCAGGAGTTTGAGACCAGCTTGGCCAACATGGTGAAACCCTGTCTGCACTAAAAATACAAAAAAAAAAAAAAAAAAAAAAAAATTAGCTGGGTGTGGTGGCGGACGCCTATAATCCCAGCTACTGGGGAGGCTAAGGCAGGAGAATCGCTTGAACCTGGGAGGTGGAGATTGCAGTGAGCCAAGATGGTGCCATTGCACTCCAGCCTGGACAACAAGAGCGAAACTCGGTTTCAAAAAAAAAAAAAAAAAAAAAAAAA","GGCTGGGCGTGGTGGCTCATGCCTATAATCCCAGCACTTGGAGAGGCCAAAGCAGGCAGATTATTTGAGGTCAGGAGTTCCAAACCAGCCTGGCCAACATGGTGAAACCCTGTATCTACTAAAAATGCAAAAAAAAAAAAAAAAAAAAAAATTAGCTGGGCGTGGTGGCAGGTGACTGTATCCCAGTACTTGGTAGGCTGAGGCAGGAGAATTGCTTGAACCTGGGAGGTGGAGGTTGCAGTGAGCTGAGATTGTGCCATTGCACTCCAGCCTGGGCAACAAGAGCAAAACTCTGTCTCAAAAAAAAAAAAAAAAAAAAAAA"
"chr17","9636859","9637187","JH378193","2430153","2430476","55","7206706","GACACGGTAGCTCACGCCTGTAATCCCAGCACTTTGGGAGGTCGAGGCGGGTGGATCACCTGAGGTCAGGAGTTTAAGACCAGCCTGGCCAACATGGTGAAACCCCGTCTCTGCTAAAAATACAAGAATTAGCCAGGCGTGGTGGTGGGCGCCTGTAATCCCAGCTACTGGGGAGGCTGAGGCAGGAGAATCACTTGAACCCAGAAGGTGGAGGTTGCAGTGAGCCAAGACCACACCACTGGACTGCAGCCTGGCGGACAAGAGCGAGACTCTGTCTCAAAAACAACAACAACAACAACAACAACAACAAAAGAAAGAAAAGAAAAGAA","GGCCGGGCACAGTGGCTCAAGCCTGTAATCCCAGCACTTTGGGAGGCCGAGGTGGGTGGATCACGAGGTCAAGAGATCGAGACCAACCTGGTCAACATGGTGAAACCCCGTCTCTACTAAAAATACAAAAATTAGCTGGGCATGGTGGTGTGTGCCTGTAATCCCAGCTACTCAGGAGGCTGAAGCAGGAGAATTGCCTGAACCCAGGAGGAGGAGGTTGCGGTGAACCAAGATCACGCCATTGCACTCCAGCCTGGGTAACAAGAGCGAAACTCTGTCTCAAAACAAAACAAAACAAAACAAAACAAAACAAACAAAAAAAAA"
"chr17","9725612","9725938","JH378224","2846632","2846964","49","6878980","GGGCGTGGTGGCTCACACCTGTAATCCCAGCACTTTGGGAGGCCGAGGTGGGCGGATTGCCTGAGGTCAGGAGTTCGAGACCAGCCTGGCCAACCCGGTGAAACCCTGTCTCTACTAAAATACAAAAAAAAAAAAAAAAAAAAAAAAAAATTTAGCTGTGTGTGGTGGTGTGCACCTGTAATCCCAGCTACTCAGAAGGCTGAGGCAGGAGAATCGCTAGAACCCGGGAGGCGGAGGTTGCAGTGAGCCGAGATCGCACCATTACGCTCCAGCTTGGGCAACAAGAGTGAAACTCCATCTCAAAAACAAAACAAAACAAAACAAAAA","GGCCAGGCAGGGTGGCTTACATCTGTAATCCCAGCACTTTGGGAGGTCAAGGCGAGTGGATCACCTGAGGTCATGAGTTCAAGACCAGCCTGGCCAACTTGGTGAAACCCTGTCTCTACTAAAAATACAAAAAAAAAAAAAAAAAAAAAAAAAAAAATTAACTGGGTGTGGTGGTGCACACCTGTAATCCCAGCTACTCAGGAGGCTGAGGCAGGAGAATCCCTTGAACACGGGAGGTGGAGGTTGCAGTGAGCCGAGATCATGCCATTGCACTCCAGCCTTGGTGAAAAGAGCAAAACTCTGTCTTAAACAAAACAAAACAAAACCAGAAAA"
"chr17","11904179","11904388","JH378115","24252957","24253162","48","12348778","CCTGTCTTTACAAAAAATGCAAAAACAAAACAAAACAAAACAAAACAAAAACCGGGCATGGTGGTGAGCACCTGTAATCCCAGCTACTTGGGAGTTTGAGGCAGGAGAATCACTTGAACCTGGGAAGCGGAGGTTGCAGTGAGCCGAGACCGCGCCATTGCACTCCAGCCTGGGCAACAAGAATGAAACTCTGTCTCAAAAAAAAAAAAA","TGGTGAAACCCTGTCTTTACTAAAAATACAAAAAAAAAAAAAATTAGCTGGGCATGGTGGCACATGCCTGTAGTCCCAGCTGCTCGGGAGGCTGAGGCAGGAGAATTGCTTGAACCCAGGAGGCGGAGGTTGCAGTGAGCCGAGATCGAGCCATTGCACTCCAGCCTGGGCAACAAGAGCAAAACTCCGTCTCAAAACAAAATAAA"
"chr17","15884346","15884946","JH378118","18053084","18053501","249","2168738","GCCAGGCAGGTGGCTCAGGACTGTAATCCCAGCCTTTTGGGAGGCTGAGGCGAGTGGATCACCTGAGGTCAGGAGTTCGACACCAGCCTGGTCAACATGGTGAAACCCCGTCTCTACTAAAAAATACAAAAAATTGGCCAGGCGCAGTGTCTCACGCCTGTAATCCCAGCACTTTAGGAGGCTGAGGCAGGTGGATCACTTGGTCAGGAGATCGAGACCATCCTGGCCAACATGGTGAAACCCTGTCTCTATCAAAAATACAAAAATTAGCTGGGCGTGGTGGCATATGCCTATAATCCCAGCTACTTGGGACGCTGAGGCAGGAGAATCACTTGAACCAGGGAGTCAGAAGTTGCAGTGAGCCGAGATTGCGCCACTGCACCCCAGCCTGGTGACAGAGTGAGACTGTCTTAAAAAACAAAAAACAAAAAATTAGCCAGGTATGGTACCAGGTGCCTGTAACCCCAGCTACTTGGGAGGCTGAGGCAGGAGTATCGCTTGAACCCTGGAGGTGGAGGATGCAGTGAGCTGAGAGCACGCCATTGTACTCCAGCCTGGGCAACAAGAGTGAAACTCCATCTAAAATAAATAAAAATAAAAA","GGCTGGGCGCAGTGGCTCACACCTGTAATCCCAGCACTTAGGGAAGCTGAGGCGAGTAGATCACCTGAGGTCAGGAGTTAGAGACCAGCCTGGCCATCATGGTGAAACCCCGTCTCTACTAAAGATACCAAAAATTAGCTGAGTGTGGTGCTGGGTGCCTGTAATCCCAGAAACTCAGGGTGCCTGTAATCCCAGCAACTCAGGGTGCCTTTAATCCCAGCAACTGAGGGTACCAGTAATCCCAGCAACTCAGGGTGTCTTTAATCCTAGCAACTGAGGGCACCTGTAATCCCAGCAACTCAGGAAGCTGAGACAGGAGAAGTACTTGAACCCAGAAGGCAGAGGTTGCAGTGAGCCGATATTGCACCATTGCACTCCAGTCTGGGCAACAAGAGTGAAACTCTGTCTCAAAAAAAAA"
"chr17","16331846","16332458","JH378118","18053084","18053501","252","1721238","GGCCATGTGTGGTGGTTCACACCTGTAATCTCAGAACTTTGGGAGGCCGAGGTGGGTGGATCACCTGAGGTCAGGAGTTCGAGACCAGCCTGGCCAACATGGTGAAACCTCATCTCTACTAAAAATACAAAAAATTAAGGCCATACCCAGAGACTCATGCCTGTAATCCCAGCACTTTGGGAGGCTGAGGCGGATGGATCACTTGAGGTCAGGAGTTCAAAACCAGCCTGGCCAACATGGTGAAACCCCATCTCTACTAAAAATATAAAAATTAGCCGGGTGTGATGGCAGGCACCTGTAATCCCAGCTACTTGGGAGGCTGAGGCAGGAGAATTGCTTGAACCCAGGAAGCAGAGGTTGTGGTGAGCCGAGGTCGCGCCATTGCACTCCAGCCTGGGCAACAGAATGAGACTGTCTCAAAAAAAAAAAAAAAAAAAAATCAGCCAGGAGTGGTGGCGGGGGCACCTGTAATCCCAGCTACTCGGGAGGCTGAGGCAGGAGAATCGCTTGAACTCAGGAGGCAGAGGTTGCAGTGAGCTGATATCTCGCCATTGCACTCCAGCCTGGGCAACAAGAGTGAAACTGTCTCAAAAAAAAAAAAAAAAAAAAAGAA","GGCTGGGCGCAGTGGCTCACACCTGTAATCCCAGCACTTAGGGAAGCTGAGGCGAGTAGATCACCTGAGGTCAGGAGTTAGAGACCAGCCTGGCCATCATGGTGAAACCCCGTCTCTACTAAAGATACCAAAAATTAGCTGAGTGTGGTGCTGGGTGCCTGTAATCCCAGAAACTCAGGGTGCCTGTAATCCCAGCAACTCAGGGTGCCTTTAATCCCAGCAACTGAGGGTACCAGTAATCCCAGCAACTCAGGGTGTCTTTAATCCTAGCAACTGAGGGCACCTGTAATCCCAGCAACTCAGGAAGCTGAGACAGGAGAAGTACTTGAACCCAGAAGGCAGAGGTTGCAGTGAGCCGATATTGCACCATTGCACTCCAGTCTGGGCAACAAGAGTGAAACTCTGTCTCAAAAAAAAA"
"chr17","16464101","16464461","JH378293","1845184","1845523","61","14618917","GGCCGGGCGCCGTGGCTCACGCCTATAATCCCAGCACTTTGGGAGGCCGAGGCGGGTGGATCACCTGAGGTCAGGAGTTCGAGACCAGCCTGACCAACATGGTGAAACCCCCGTCTCTGCTAAAAAAAAAAAAATATATATATATATATATATAATATATAATATATATATATATATATATATAAAATAGCTGGGCATGGTGGCAGGCACCTGTAATCCCAGCTACTCAGGAGGCTGAGGCAGGAGAATCGCTTGAACCTGGGAGGTGGAGGTTGCAGTGGGCTAAGATCACACCATCGCACTCCAGCCTGGGCGACAGGAATGAAACGCTGTCTCAAAAAAAAAAAAAAAAAAAAAAAAA","GGCCGGGTGCGGTGGCTCACGCCTGTAATCCCAGCACTTTGGGAGGCCAAGGCGGGTGGATCACCTGAGGTCAGAAGTTCGAGACCAGCCTGGCCAACATGGTGAAACCCCGTCTCTGCTAAAAAGAAAAAAATAAGAAAAAAACAAAATAAGAAAATAATTTTAAAAAATACAAAATTAGCTGGGCGTGGTGGCAGGCACCTGTAATTCCAGCTATTCAGGAGGCTGAGGCAGGGGAATCACTTGAACCCAGGAGGCAGAGGTTGCAGTGAGCCAAGATGACGCCATTGCACACCAGCCTGGGCAACAAGAGTGAAACTCCGTCTCAAAAAAAAAACAA"
"chr17","16469420","16470033","JH378118","18053084","18053501","254","1583664","GCCAGGGGTGGTGGCTCATGCCTGTAATCCCAGCACTTTGGGAGGCTGAGGCGGGCAGATTGCCTGAGGTCAGGAATTCAAGACCAGCCTGGCCAACATAGTGAAACCCTGTCTCTACTAAAAATGCAAAGAATTAGCTGGGTGTTGGCCGGGCACGGTGGCTGACACCTGTAATCCCAGCACTTTGGGAGGCCTAGGCAGGCGGATCACCTGAGGTTGGGAGTTCGAGACCAGCCTGACCAACATGGAGAAACCCCGTCTCTACTGAAAATAAAAAACTAGCCAGGCATGGTGGCCCATGCCTGTAATCCCAGCTAATTGGGAGGCTGAGGCAGGAGAATCGCTTGAACCCAGGAGGCAGAGGTTGCGGTGAACCAAGATCGCATCAATGCACTCCAGCCTAGGCGACAAGAGCAAAACTCCGTCTCAAAAAAAAGAATTAGCTGGGTGTGGTGGGTGGGAACCTGTAATCCCAGTTACTAGGGAGGCTGAGGCAGGAGAATTGCTTGAACCCAGGAGGCGGAGGTTGTGGTGAGCCGAGATCGCGCCATTGCACTCCAGCCTGGACAACAAGAGCGAATCTCCGTCTCAAAAAAAAAAAAAAAAAAAAAAAA","GGCTGGGCGCAGTGGCTCACACCTGTAATCCCAGCACTTAGGGAAGCTGAGGCGAGTAGATCACCTGAGGTCAGGAGTTAGAGACCAGCCTGGCCATCATGGTGAAACCCCGTCTCTACTAAAGATACCAAAAATTAGCTGAGTGTGGTGCTGGGTGCCTGTAATCCCAGAAACTCAGGGTGCCTGTAATCCCAGCAACTCAGGGTGCCTTTAATCCCAGCAACTGAGGGTACCAGTAATCCCAGCAACTCAGGGTGTCTTTAATCCTAGCAACTGAGGGCACCTGTAATCCCAGCAACTCAGGAAGCTGAGACAGGAGAAGTACTTGAACCCAGAAGGCAGAGGTTGCAGTGAGCCGATATTGCACCATTGCACTCCAGTCTGGGCAACAAGAGTGAAACTCTGTCTCAAAAAAAAA"
"chr17","17534259","17534875","JH378118","18053084","18053501","268","518825","GGCTGGGGCGGTGGCTCACCTGTAATCCCAGCACTTTGGGAGGCAGAGGTGGGCGGATCGCCTGAGGTCAGAAGTTGGAGACCAGCCTGGCAACATGGTGAAACCCTGTCTCTACTAAAAAAAAAAAAAAAAAAAAAAAATGGCCGGGCATGGTGGCTCAAGCCTGTAATCCTAGCACTTTGGAAGGCTGAGGCGGGTGGATCACAAGGTCAGGAAATCGAGACCATCCTGGCTAACATGGTGAAACTCCGTCTCTACTAAAAATACAAAAAAAATTAGCCGGGCGTGGTGGTGGGTGCCTGTAGTCCCAGCTACTCGGGAGGCTGAGGCAGGCAAATGGAGTGAACCCGGGAGGCAAACTTGCAGTGAGCCAAGATGGCGCCATTGCACTCCAGCCTGGGCAACAAGAGCAAGACTCCTTCTCAAAAAAAAAAAAAATATATATATATATATATAGTCGGGCATGGTGGCAGGCACCTGTAATCCCAGCTACTCAGAGGCTGAGGCAGGAGAATCGCTTGAACCCTGGAGGTGGAGGTTGCAGTGAGCCAAGGTCATGCCATTGCACTCCAGCCTGGGCAACAAGAGCAAGACTCCGTCTCAAAAAAAAAAAAAAA","GGCTGGGCGCAGTGGCTCACACCTGTAATCCCAGCACTTAGGGAAGCTGAGGCGAGTAGATCACCTGAGGTCAGGAGTTAGAGACCAGCCTGGCCATCATGGTGAAACCCCGTCTCTACTAAAGATACCAAAAATTAGCTGAGTGTGGTGCTGGGTGCCTGTAATCCCAGAAACTCAGGGTGCCTGTAATCCCAGCAACTCAGGGTGCCTTTAATCCCAGCAACTGAGGGTACCAGTAATCCCAGCAACTCAGGGTGTCTTTAATCCTAGCAACTGAGGGCACCTGTAATCCCAGCAACTCAGGAAGCTGAGACAGGAGAAGTACTTGAACCCAGAAGGCAGAGGTTGCAGTGAGCCGATATTGCACCATTGCACTCCAGTCTGGGCAACAAGAGTGAAACTCTGTCTCAAAAAAAAA"
"chr17","17916069","17916669","JH378118","18053084","18053501","243","137015","GCCGGGTACAGTGGCTCACACCTGTAATCCTAGCACTTTGGGAGGCCGAGGCGGGTGGATCACCTGAGGTCAGGAGTTCGAGACCAGCCTGGCCAACATGATGAAACCCTACCTCAGCCAGGTACGGTGGTTCACGCCTGTAATCCTAGCACTTTGGGAGGCTGAGGCAGGTGGATTGCCTGAACTCAGGAGTTTGAGACCAGCCTGGGCAGCATGGTGAAACCCCATCTGTACTAAAATACAAAAACTTTGCTGGGCGTGGCGGCATGCACATGTAGTCCCAGTTACTTGGGAGGCTGAGGCAGGATAATTGTTTGAACCTGGGAGGCGGAGGTTGTACAGTGAGCCAAGATCGCGCCACTACACTCTAGCGTAGGTGACAGAGCGAGATTCCGCCTCCAAAAAAAAAAGAAACCCTGTCTCTACTAAAAATACAAACAATTAGCTGGGCGTGGTGGTGGGCGCCTGTAATCCCAGCTACTTAGGAGGCTGAAGCAGGAGAATCGCTTGAGCCCAGGAAGTGGAGGTTGCAGTGAGCTGAGATTGCTCCATTGCACTCTAGCCTGGGCAACAAGAGTGAAACTCTGTCTCAAAAAAAGAA","GGCTGGGCGCAGTGGCTCACACCTGTAATCCCAGCACTTAGGGAAGCTGAGGCGAGTAGATCACCTGAGGTCAGGAGTTAGAGACCAGCCTGGCCATCATGGTGAAACCCCGTCTCTACTAAAGATACCAAAAATTAGCTGAGTGTGGTGCTGGGTGCCTGTAATCCCAGAAACTCAGGGTGCCTGTAATCCCAGCAACTCAGGGTGCCTTTAATCCCAGCAACTGAGGGTACCAGTAATCCCAGCAACTCAGGGTGTCTTTAATCCTAGCAACTGAGGGCACCTGTAATCCCAGCAACTCAGGAAGCTGAGACAGGAGAAGTACTTGAACCCAGAAGGCAGAGGTTGCAGTGAGCCGATATTGCACCATTGCACTCCAGTCTGGGCAACAAGAGTGAAACTCTGTCTCAAAAAAAAA"
"chr17","18237318","18237912","JH378118","18053084","18053501","239","184234","GGCCATGCGTGGTGGCTCACGCCTGTAATCCCAGTACTTTGGGAGGCTGAGGTGGGAGGATCACCTGAGGTCAGGAGTTCGAGACCAGCCTGGCCAACATGATGAAACCCTGTCTCTACTAAAAATGCAAAAAATTGGCCGGGCACGGTGGCTCACGCCTGTAATCCCAGCACTTTGGGAGGCCAAGGCGGGTGGATCACAAGGTCAGGAGCTTGAGACCAGCCTGGCCAATATGGTGAAACCCCATCTCTACTAAAAATACAAAAATTAGCCAGGCGTGGTGGTACACACCTGTAGTCCCAGCTACTCGGGAGGCTGAGGCAGGAGAATTGCTTGAACTCAGGAGGCAGAGGTTGCAGTGAGCTGAGATGGTGCCACTGCACTGCAGCCTGGGCAACAGAGTGAGACTTCATCTCAAAAAAAAAAAAAAAATTAACCGGGTGTGGTGGCACGTGCCTATGGTCCCAGCCACTGGGGAGGCTGAGGCAGGAGAATCGCTTGAACACAGGAGGCAGAAGTTGCAGTGAGCTGAGATTGCACCACTGCACTCCAGCCTGGGTGACAAGAGTGGAACTCCATCTCAAAAAAAAAAGAA","GGCTGGGCGCAGTGGCTCACACCTGTAATCCCAGCACTTAGGGAAGCTGAGGCGAGTAGATCACCTGAGGTCAGGAGTTAGAGACCAGCCTGGCCATCATGGTGAAACCCCGTCTCTACTAAAGATACCAAAAATTAGCTGAGTGTGGTGCTGGGTGCCTGTAATCCCAGAAACTCAGGGTGCCTGTAATCCCAGCAACTCAGGGTGCCTTTAATCCCAGCAACTGAGGGTACCAGTAATCCCAGCAACTCAGGGTGTCTTTAATCCTAGCAACTGAGGGCACCTGTAATCCCAGCAACTCAGGAAGCTGAGACAGGAGAAGTACTTGAACCCAGAAGGCAGAGGTTGCAGTGAGCCGATATTGCACCATTGCACTCCAGTCTGGGCAACAAGAGTGAAACTCTGTCTCAAAAAAAAA"
"chr17","18951167","18952093","JH378118","18053084","18053501","537","898083","GGCCAGGGGCAGTGGCTCATGCCTGTAATCCCAGCATTTTGGGATGCCAAGGCTGGTGGATCAACTGAGGTCAGGAGTTTCAGACCACCCTGGCCAACATGGCGAAATCCCATCTCTACTAAAAATACAAAAATTAGGCCAGGCACAGTGGCTCATGCCTGTAATCCCAGCACTTTGAGAGGCCAAGGCGGGCGATCACGAGGTCAGGAGATTGAGACCATCCTGGCTAACACGGTGAAATCCTGTCTCTACTAAAAAAAAAAAATACAAAAAATTAGCCGGGACGTGGTGGCTGGCACCTGTAGTCCCAGCTACTCGGGAGGCTAAGGCAGGAGAATGGCATGAACCCGGGAGATGGAGCTTGCAGTGACCCGAGATCGCGTCACTGCACTCCAGCCTGAACAACAGAGCAAGACTATATCTCAAAAAAAAAAAAAAAAAAAAGGCCGGGTGCAGTGGCTCACGTCTGTAATCCCAGCACTTTGGGAGGCCGAGGTGGGTGGATCACGAGGTCAGGAGATCGAGACCATCCTGGCTAACATGATGAAACCCCATCTCTACTAAAAAATACAAAAAATTAGCCGGGTGTGGTGGCAGGCACCTGTAGTCCCAGCTACTCGGGAGGCTGAGGCAGGAGAATGGCATGAACCTGGGTAGTGGAACTTGCAGTGAGCCGAGATCACGCCACTGCACTCCAGCCTGGGCGACAGAGCGAGACTCTGTCTCAAAAAAAAAAAAAAAAAAAAAATTAGCCGGGCATGGTGGTGGGTGCCTGCAATCCCAGCTAGTCAGGAGGCTGAGGCTGGAGAATCCCTTGAACCCAGGAGGTAGAGGTTGCAGTGAGCCAAGATCACGCCATTGCATTCCAGCCTGGGCAACAAGAGTGAAATTCTGTCTCAAAAAAATAAACAAACAAGTAAAATAAAA","GGCTGGGCGCAGTGGCTCACACCTGTAATCCCAGCACTTAGGGAAGCTGAGGCGAGTAGATCACCTGAGGTCAGGAGTTAGAGACCAGCCTGGCCATCATGGTGAAACCCCGTCTCTACTAAAGATACCAAAAATTAGCTGAGTGTGGTGCTGGGTGCCTGTAATCCCAGAAACTCAGGGTGCCTGTAATCCCAGCAACTCAGGGTGCCTTTAATCCCAGCAACTGAGGGTACCAGTAATCCCAGCAACTCAGGGTGTCTTTAATCCTAGCAACTGAGGGCACCTGTAATCCCAGCAACTCAGGAAGCTGAGACAGGAGAAGTACTTGAACCCAGAAGGCAGAGGTTGCAGTGAGCCGATATTGCACCATTGCACTCCAGTCTGGGCAACAAGAGTGAAACTCTGTCTCAAAAAAAAA"
"chr17","20996420","20997041","JH378118","18053084","18053501","266","2943336","GGCTAGGCGCGGTGGTTCACACCTGTAATCCCAGCACTTTGGGAGGCCAAGGTGGGTGGATCACCTGTGGTCAGGAGTTCGAGACCAGCCTGGCCAACATTGTGAAACCCCGTCTCTACTAAAAATGCAAAAAATTAGCTGGGCGACCAGTCATGGTAGCTCACGCCTGTAATCCTAGCACTTTGGGAGGCCAAGGCGGGTGGATTGCCTGAGCTCAGGAGTTAGAGGCCAGCCTGGGCAACATGGTAAAACCCTGTCTCTACTAAAATACAAAAAAAAAAAAAAAAATTAGCTGGGTGTGACAGCGTGCATCTGTAATCCCGGTTACTTGGGAGGTTGAGGCAGGAGAATTCCTTGAACCTAGGAGGCGGAGGTTACAGTTAGCCGAGATCACGCCATTGCACTCCAGCCTGGGCAACAGAGCGAGACTCCATCTCAAAAAAAAAAAAAAAAATTCAGCTGGGCGTGGTGGCGGGCACCTGTGATCCTAGCTACTCAGGAGGCTGAGGCAGGAGAATCATTTGAACTCCGGAGGCGGAGGTTGCAGTGACCCTAGATCGCACCATTGTGTTCCAGCCTGAGCAACAAGAGCGAGACGCCATCTGAAAAAAAAAAAAAGAAA","GGCTGGGCGCAGTGGCTCACACCTGTAATCCCAGCACTTAGGGAAGCTGAGGCGAGTAGATCACCTGAGGTCAGGAGTTAGAGACCAGCCTGGCCATCATGGTGAAACCCCGTCTCTACTAAAGATACCAAAAATTAGCTGAGTGTGGTGCTGGGTGCCTGTAATCCCAGAAACTCAGGGTGCCTGTAATCCCAGCAACTCAGGGTGCCTTTAATCCCAGCAACTGAGGGTACCAGTAATCCCAGCAACTCAGGGTGTCTTTAATCCTAGCAACTGAGGGCACCTGTAATCCCAGCAACTCAGGAAGCTGAGACAGGAGAAGTACTTGAACCCAGAAGGCAGAGGTTGCAGTGAGCCGATATTGCACCATTGCACTCCAGTCTGGGCAACAAGAGTGAAACTCTGTCTCAAAAAAAAA"
"chr17","21298865","21299429","JH378206","6546474","6546861","222","14752391","GGCCGAGGCAGGTGGATCACCTGAGGTCAGGAGTTCAAGACTAGTCTGGCCAACATGGTGAAACCCTGTCTCTACTAAAAATACAAAAAATTGGCCGGGCGCGGTGGCTCATGCCTGTAATCCCAGCACTTTGGGAGGCTGAGGCGGGTGGATCACGAGGTCGGGAGATCGAGACCATCCTGGCTAACACAGTTAAACCCTTTCTCTACTAAAAAATACAAAAAATTAGCCGGGCGTAGTGGGGGGCGCCTGTAGTCCCAGCTACTCAGGAGGCTGAGGCAGGAGACTGGCGTGAACCCGGGAGGCAGAGCTTGCAGTGAGCTGAGATCACGTCACTGCATGCCAGCCTGGGCGACAGAGCGAGACTCTGTCTCAAAAAAAAAAAATTAGCCAGGCATGGTGGTGTACACCTGTAATCCTAGCTACTCGGGAAGCTGAGCAGGAGAACAGCTTGAACCCAGGAGGCAGAGGTTGCAGTGAGCTGAGATCACGCCATTGCACTCCAGCCTGGGCAACAAGAGTGAAACTCCGTCTCAAAAAAAAAAAAAGAAAAGAAAAAAGAAAA","GGCCACACATGGTGGCTAACGCCTGTAATCCCAGCACTTTGGGAGGCCAAGTCGGGTGGATCATGAGGTCAGGAGACCAAGACCATCCTGGCCAAATGGTGAAACCCCGTCTCTACTAAAAATACAAAAATTAGCTGGGCATGGTGGCGTGTGCCTGTAATCCCAGCTACTCAGGAGGCTGAGGCAGGACAATTGCCTGAACCCAGGAGAATTAGCTGGGCATGGTGGCGTGTGCCTGTAATCCCAGCTACTCAGGAGGCTGAGGCAGGACAATTGCCTGAACCCAGGAGGCGAAGGTTGCGGTGAGCCGAGATTGTGCCATTGCACTCCAGCCTGGGTAACAAGAGCGACACTCTGTCTCAAAAAAAAAAAAAAAAAAAAAAAAAAA"
"chr17","21663027","21663921","JH378118","18053084","18053501","517","3609943","TTGGGAGGCCAAGGTGGGCCTCCCAGACACGTGAGGTCAGGAGTTTGAGACCAGCCTGGACAATATGGCGAAACCCCATCTCTACTAAAAAAACACAAAAATTGGTTGGGCCGGGCACGGTGGCTCACGCCTGTAATCCCAGCACTTTGGGAGGCCGAAGTGGGCAGATCACGAGGTCAGGAGATCGAGATCATCTTGGCTAACATGGTGAAACTCCGTCTTTACTTAAAATACAAAAAATTAGCTGGGCATGATGGCAGGCAGTTGGAGTCCCAGCTACTTGGGAGGCTGAGGCAGGAGAATCGCTTGAACCCGGGAGGCAGAGGTTGCAGTGAGCTGAGATCGTGCCATTGCACTCCAGCCTGGGTGACAGAATGAGACTCCGTCTGAAAAAAAAACAAAAAACAAAAAACAAAAATTGGCCAGGTGCGGTGGCTCACGCCTGTAATCCCAGAACTTTGGGAGGCCGAGGCAGGTGGATCATGAGGTCAGGAGTTCAAGACCAGCCTGGCCAAGATGGTGAAACCCCATCTCTACTAAAAATACAAAAATTAGGCGGGCACGGTGGCAGGTGCCTGTAATCTCAGCTACTCAGGAGGCTGAGGCAGGAGAATTGCCTGAAGCCGGGTGGCAGAGGTTGCAGAGAGCTAAGATCACGCCACTGCACTCCAGCCTGGGTGATAGAGTAAGACTCTATCTCAAAAAAAGAAAAAAAAAAATAGCCGGGCATTGTGCTGGGCGCCTGTAATCCCAGCTACTTGGGAGGCTGAGACAAGAGAATCACTTGAACCTGGGAGGCGGAGGTTGCAGTGAGCCGAGATCGTGCCATTGCACTCCAGCCTGGGTGAGAAGAGCAAAACTCTGTCTCAAAAAAACAAAAAAAGAAGAAAACAAA","GGCTGGGCGCAGTGGCTCACACCTGTAATCCCAGCACTTAGGGAAGCTGAGGCGAGTAGATCACCTGAGGTCAGGAGTTAGAGACCAGCCTGGCCATCATGGTGAAACCCCGTCTCTACTAAAGATACCAAAAATTAGCTGAGTGTGGTGCTGGGTGCCTGTAATCCCAGAAACTCAGGGTGCCTGTAATCCCAGCAACTCAGGGTGCCTTTAATCCCAGCAACTGAGGGTACCAGTAATCCCAGCAACTCAGGGTGTCTTTAATCCTAGCAACTGAGGGCACCTGTAATCCCAGCAACTCAGGAAGCTGAGACAGGAGAAGTACTTGAACCCAGAAGGCAGAGGTTGCAGTGAGCCGATATTGCACCATTGCACTCCAGTCTGGGCAACAAGAGTGAAACTCTGTCTCAAAAAAAAA"
"chr17","21688652","21689276","JH378118","18053084","18053501","258","3635568","GGCCGGGTGCCATGGCTCACGCCTATAATCCCAGCACTTTGGGAGGCCAAGGTGGGCGGATCACCTGAGGTCAGGAGTTTGAGACCAGCCTGGCCAACATAGTGAAACCCCGTCTCTACTAAAAATACGAAAAGTTAGCTGGGGGTGCAGTGGCTCACACCTGTAATTCCAGCACTTTGGGAGGCCGAGGCAGGTGAATCACGAGGGGAGGAGTTTGAGACCAGCCTAACCAATATGTTGAAACCCCGTTTCTACTAAAAATACAAAAATTAGCTGGGCGTGGTGGCACGTGCCTATAATCCCAGCTACTCAGGAGGCTGAGGCAGGAGAATCGCCTGAACCTGGGAGGCGGAGGTGGCAGTGAGCCAAGATCACACCACTGCACTTTAGCCTGGGTGACAGAGGGAGACTCTGTCTCAAAAAACAAAACAAAACAAAACAAAAAATTAGGCAGGCTTGGTGGCACATGCCTGTAATCCCAGCTACTCAGGAGGCTGAGGCAGGAGAATTGCTTGAACCCAGGAGGCAGAAGTTGCAGTGAGCTGAGATCGCGCCATTGCACTCCAGCCTGGGTAACAAGAGTGAAACTCCATCTCAAAAAAAAAAAAAAAAAAAAAAAAAAAAA","GGCTGGGCGCAGTGGCTCACACCTGTAATCCCAGCACTTAGGGAAGCTGAGGCGAGTAGATCACCTGAGGTCAGGAGTTAGAGACCAGCCTGGCCATCATGGTGAAACCCCGTCTCTACTAAAGATACCAAAAATTAGCTGAGTGTGGTGCTGGGTGCCTGTAATCCCAGAAACTCAGGGTGCCTGTAATCCCAGCAACTCAGGGTGCCTTTAATCCCAGCAACTGAGGGTACCAGTAATCCCAGCAACTCAGGGTGTCTTTAATCCTAGCAACTGAGGGCACCTGTAATCCCAGCAACTCAGGAAGCTGAGACAGGAGAAGTACTTGAACCCAGAAGGCAGAGGTTGCAGTGAGCCGATATTGCACCATTGCACTCCAGTCTGGGCAACAAGAGTGAAACTCTGTCTCAAAAAAAAA"
"chr17","22129020","22129352","JH378128","1602813","1603145","53","20526207","GCCAGGCACGGTGGCTCACACCTGAATTCCAGTACTTTGGGAGGCCGAGGCGGGCGGATCTCTTGAGGTCAGGAGTTTGAGACCAGCCTGGCCAACATGGTGAAACCCCATCTCTACTAAAAATACAAAAATTAGCCGGGCGTGGTGGCAGGTGCCTGTAATCCCAGCTACTTGGGAGGCTGAGGCAGGAGAACCTCTTGAACCCAGGAGGTGGAGGCTGCAGTGAGCTGAGATTGTGCCACTTCACTCCAGCCTGGAAGACAAGAGCAAGACTTCATCTCAAAAAAAAATAAAAAAAAAATAAATAAATAAATAAATAAAAATTTAAAAAAA","GGCCAGGTGCAGTGGCTCACGCCTGTAATACCAGCATTTTGGGAGGCCGAGGCAGGTGGATCACGAGGTTAGGAGTTTGAGACCAGCATGGCCAACATGGAGAAACCCCGTCTCTACTAAAAATACAAAAATTAACCAGGCATGGTGGCAGGTGCCTGTAATTCCATCTACTCGGGAGGCTGAGGCAGGAGAATCCCTTGAACCTGGGAGGCGGAGGTTGCAGTGAGCCGAGATTGTGCCATTGCACTCAGTCTGGGTGACAAAAACAAGACTCCATCTCAAAAAAAAAAAAAAGAAAAGAAAAAGAAAAAAAGAAAGAAAGAAAGAAAGAAA"
"chr17","22130129","22130738","JH378118","18053084","18053501","262","4077045","GGCTGGGCACAGTGGCTCACGCCTGTAATCTCAGCACTTCGGGAAGCCGAGGCGGGCAGATCAGCTGAGGTCAGGAGTTCAAGACCAGCCTGGCCATGGCAAAACCCTGTCTCTACTAAAAAATGCAAAAAATAGGGGCCAGGCACGGTGGCTCACGCCTGTAATCCCAGCATTTTGGGAGGCCAAGGCAGGCGGATCACAAGGTCAGGAGGTTGAGACCATCCTGGCCAACATGGTGAAACCCCATCTCTACTAAAAATACAAAAATTAGCTGGGTGTGGTGGCCTGTGCCTGTAATCCCAGCTACTTGGGAGGCTGAGGCAGGGGAATCACTTGAATCCAGGAGACAGAGGTTGTAGTGAGCTGAAATGGAGCCACTGCACTCCAGCCTGGCGGCAGAGCGAGACTCTGTCTCAAAAAAAAAAAAAATACAAAAAATAGCTAGGTGTGATGGTGGGCACCTGTAATCCCAGCTACTTGGGTAGCCGAAGCAGGAGAATCGCTAGAACCTGGGAGGTGGAGGTTTAGTAAGCTGAGATCACACCATTGCACTCCAGCCTGGGTATCAACAGCGAAACTCCATCTCAAAAAAAAAAAAAAAAAAAGAAAA","GGCTGGGCGCAGTGGCTCACACCTGTAATCCCAGCACTTAGGGAAGCTGAGGCGAGTAGATCACCTGAGGTCAGGAGTTAGAGACCAGCCTGGCCATCATGGTGAAACCCCGTCTCTACTAAAGATACCAAAAATTAGCTGAGTGTGGTGCTGGGTGCCTGTAATCCCAGAAACTCAGGGTGCCTGTAATCCCAGCAACTCAGGGTGCCTTTAATCCCAGCAACTGAGGGTACCAGTAATCCCAGCAACTCAGGGTGTCTTTAATCCTAGCAACTGAGGGCACCTGTAATCCCAGCAACTCAGGAAGCTGAGACAGGAGAAGTACTTGAACCCAGAAGGCAGAGGTTGCAGTGAGCCGATATTGCACCATTGCACTCCAGTCTGGGCAACAAGAGTGAAACTCTGTCTCAAAAAAAAA"
"chr17","23633062","23633662","JH378118","18053084","18053501","247","5579978","GGCCAGGCGTGGTGGCTTACGCCTGTAATCCCAGCATTTTGGGAAGCTGAGGCAGGTGGATCACCTGAGGTCAAGAGTTCAAGACCAGCCTGGCCAACATGGTGAAACCCCGTCTCTACTGCAAATACAAAAAATTAGTAGCCGGGCATGGTGGCTCACGCCTGTAATCCCAACACTTTGGTAGGCCAAGGCGGGTGGATCACCTGAGGTCGGGAGTTCGAGACCAGCCTGACCAACATGGAGAAACCCCGTCTCTACTAAAAGTACAAAATTAGCCAGGGATGGTGGCATGTGCCTGTAATCCCAGCTATTTGGGAAGCTAAGGCACAAGAATCGCTTTGAACCTGGGAGACAGAGGTTGCAGTGAGCTGAGATCGCACCATTGCACTCCCGCCTGGGCAACAAGAGCGAAACTCCATCTAAAAAAAAAAAAAAAAAAAAAAAAGCCAGGCATGGTGACAGGCACCTTGTAATCCCAGCTACTCGGAAGGCTGAGGCAGGAGAATCGCTTGAACACTGCAGAGGTTGCAGTGAGCTGAGATCACGCCATTGCACTGCAGCCTAGGCAACAAGAGTGAGACTCTATCTCAAAAAAAAGAAA","GGCTGGGCGCAGTGGCTCACACCTGTAATCCCAGCACTTAGGGAAGCTGAGGCGAGTAGATCACCTGAGGTCAGGAGTTAGAGACCAGCCTGGCCATCATGGTGAAACCCCGTCTCTACTAAAGATACCAAAAATTAGCTGAGTGTGGTGCTGGGTGCCTGTAATCCCAGAAACTCAGGGTGCCTGTAATCCCAGCAACTCAGGGTGCCTTTAATCCCAGCAACTGAGGGTACCAGTAATCCCAGCAACTCAGGGTGTCTTTAATCCTAGCAACTGAGGGCACCTGTAATCCCAGCAACTCAGGAAGCTGAGACAGGAGAAGTACTTGAACCCAGAAGGCAGAGGTTGCAGTGAGCCGATATTGCACCATTGCACTCCAGTCTGGGCAACAAGAGTGAAACTCTGTCTCAAAAAAAAA"
"chr17","34071612","34072215","JH378118","18053084","18053501","250","16018528","GGCCAGGTGTGGTGCCTTACATCTGTAATTCCAGCACTTTGGGAGGCTGAGGTGGGTGGATCACCTGAGGTCAGGAGTTCAGGACCAACCTGGCCAACATAGTGAAACCCCGTCTCACTAAAAATACAAAAATTAAAAAGAAAGAAAGAAAAAAGCCAGGTGCGGTGGCTCACACCTGTAACCCCAGCACTTTGGGAGGCCAAGATGGGCGGATCACCTGAGGTCGGGAGTTTGAGACCAGCCTGACCAACATGGAGAAACCCCGTCTCTACTAAAAATACAAAATTAACCAGGCGTGGTGGTGCATGCCTGTAATCCCAGCTACTTGGGAGGATGAGGCAGGAGAATCGCTTGAACCCTGGAGGCGGAGGTTGTGGTGAGCTGAGATCATGCCATTGCACTCCAGCCTAGGCAACAAGAGCGAGACTCCATCTCAAAAAAAAAAAAAAAATTGGGCATGGTGGTGCATGCCTGTAATCCCAGCTACTCAGGAGTCTAAGGCAGGAGAATCACTTGAACCCAGGAGGCAGAGGTTGCAGTGAGCTGAGATCACGCCATTGCACTCCAGCCTGAGCGACAAGAGTGAAACTACGTCTCAAAAAAA","GGCTGGGCGCAGTGGCTCACACCTGTAATCCCAGCACTTAGGGAAGCTGAGGCGAGTAGATCACCTGAGGTCAGGAGTTAGAGACCAGCCTGGCCATCATGGTGAAACCCCGTCTCTACTAAAGATACCAAAAATTAGCTGAGTGTGGTGCTGGGTGCCTGTAATCCCAGAAACTCAGGGTGCCTGTAATCCCAGCAACTCAGGGTGCCTTTAATCCCAGCAACTGAGGGTACCAGTAATCCCAGCAACTCAGGGTGTCTTTAATCCTAGCAACTGAGGGCACCTGTAATCCCAGCAACTCAGGAAGCTGAGACAGGAGAAGTACTTGAACCCAGAAGGCAGAGGTTGCAGTGAGCCGATATTGCACCATTGCACTCCAGTCTGGGCAACAAGAGTGAAACTCTGTCTCAAAAAAAAA"
"chr17","34329459","34330029","JH378119","32351107","32351490","237","1978352","GGCCAGGTGCCGTGGCTCACACATGTAGTCCCAGCACGTTGGGAGGCTGAGGTTAATGGATCACCTGAAGTCACAAGTTCGAGACCAGCCTGACCAACATGGTGAAACCCTGTCTCTACTAAAATATAAAAAGTAGTCGGCCGGGCGCAGTTGCTCATGCCTGTGATCGCCTGAGGTCAGGATTTCAAGCCCAGCCTGGCCAAAATGGTGAAACCCCATCTCTACTAAAAATATAAAAATTAGCCAGGCATGGTGGCAGGTGCCTGTAATCCCAGCTACTCAGGAGGTTGAGGCAGGAGAATCACTTGGACCCAGGGGGCAGAGGTTGCAGTGAGCCAAGATCACAGCATCGCACTCCAGCTTAGGCAACAAGAGAGAAACTCCATCTCAAAAAAAACCCAAAAAAAACAAAAAAACAAAAAAACCCAGGCATGGTGGCAGGCGTCTGTAATCTCAGCTACTCGGGAGGCTGAGGCAAGAGAATCGCTTGAACCTGGGAGGCAGAGGTTGCAGTGAGCCAAGATCATGCCATTGCACTCCAGACTGAGCAATAAGAGCGAAACTCCATCTC","GGCCAGGTATGGTGGCTCACACCTGTAATCCCAGCACTTTGGGAGGCCAAGGCAGGCAGACCACCTGAGGTCAGGAGTTCGAGATCAGCCTAGCCAACATGGTGAAACCCCATCTCTAGTAAAAATAAAATTAGCCAGGCATGGTGGTGCATGCCTGTAACGCAGGTCAGGAGTTCGAGATCAGCTTAGCCAACATGGTGAAACCCCATCTCTAGTAAAAATAAAATTAGCCAGGCAGGTGGTGCCGCCTGTACTCGGGAGGCTGAGGCAGGAGAATCACTTGAACCCAAGAGGCAGAGGTTGCAGTCAGCCAAGATCATGCCATTGCACTCCAGCCTAAGCAAAAAGAGTAAAACTCAGTCTCAAAACAAAAAAACAAAAAAA"
"chr17","35196292","35196625","JH378228","5665092","5665424","47","29531200","GGCTGGGCATGGTGTCTTACGCCTGGAATCCCAGCACTTTGGGAGGCCAAGGCGGGTGGATCACCTGAGGTCAGGAGTTTGAGACCAGCCTGGCCAACATGTTGAAACTCTGTCTCTACTAAAAATACAAAAATTAGCCGGGCATGGTGGCGGATGCCTGTAATCCCAACTACGTGGGAGGCTGAGGCAGGAGAATCGCTTGAACCCAGGAGATGGAGGTTGTGGTGAGCCGAGATCATGCCATTGCACTCCAGCCTGGGCAACAAGAACAAAACTCTGTCTCAAAATAAATAAAAAAATAAATAAATAAATAAAAACAACAACAACAACAAAA","GGCCGGGCGCGGTGGCTCAAGCCTGTAATCCCAGCACTTTGGGAGGCTGAGGCGGGTGGATCACGAGGTCAAGAGATCGAGACCATCCTGGTCAACATGGTGAAACCCTGTCTCTACTAAAAATACTAAAAATTAGCTGGGCATGGTGGCGTGTGCCTGTAATCCCAGCTACTCAGGAGGCTGAGGCAGGAGAATTGCCTGAACCCAGGAGGCGGAGGTTGCGGTGAGCCGAGATCGCGCCATTGCACTCCAGCCTGGGCAACAAGAGCGAAACTCTGTCTCAAAAAAAAAAAATAAATAAATAAAATAAAATAAAATAAAATAAAATAAAAT"
"chr17","40291413","40291755","JH378144","13229286","13229620","52","27062127","GGCCAGGCACAGTGGCTCATGCCTGTAATCCCAGCACTTTGCGAGGCTGAGCCAGGTGGATCACCTGAGGTCAGGAGTTCAAGAGCAGCCTGGCCAACATGGTGAAACCCCGTCTCTACTAAAAATACAAAAATTATCTGGAGTGGTGGTAGGTGCCTATAATTGCAGATACACAGAAGGCTGAGACAGGAGAATTGCTTGAACCCAGGAGGCGGAGGTTGCTGTGAGCCGAGATCGCGCCATTGCACCCCAGCCTGGGAGACAAGAGCGAAACTCCATCTCAATAAATAAATACATACATACATACATACATACATGCATACATACATAAAATAAAATAAAA","GGCCGGGCGCGGTGGCTCAAGCCTGTAATCCCAGCACTTTGGGAGGCCGAGGCGGGTGGATCACCTGTGGTCAGGAGTTCAAGACAGCTTGGTCAACATGGTGAAACCCCGTCTCTACCAAAAATACAAAAAATTAGCTGGGCATGGTAGCGCATGCCTGTAATCCCAGCTACTCAGGAGGCTGAGGCAGGAGAATTGCCTGAACCCAGGAGGCAGAGGTTGCGGTGAGCCGAGATCGCGCCATTGCACTCCAGCCTGGGTAACAAGAGCGAAACTCCCTCTCATAAAAAATAAATAAATAAATAAATAAATAAATAAATAAATAAATAAATAAA"
"chr17","45148344","45148987","JH378206","6546474","6546861","299","38601870","GGCTTGGTGCCATGGTTCATGCCTGTAATCCTGGCACTTTGGGAGGCCGAGGTGGGCAGATCACTTGAGCTCAGGAGTTCAAGACCACCTTGGGCGACATGGTGAAACCTCATCTCTCCTTAAAAAAAAAAAAAACAGCCGGGCGCGGTGGCTCACACCTGTAATCCCAGCACTTTGGGAGGCCAAGGCGGGTGGGGTTCATGAGGTCAGAAGATCGAGACCATCCTGGCTAACACGGTGAAACCCCGTCTCACTAAAAATAGAAAAAACTAGCCGGGCGTGGTGGCGGGCACCTGTAGTCCCAGCTACTCGGGAGGCTGAGGCAGGAGAATGGCGTGAACCCGGGAGGCGGAGCTTGCAGTGAGCTGAGATCTTGCCATTGCACTCCAGCCTGGGCAACAAGAGTGAAACTCTGTCTCAAAAAAAAAAAATTAAAAAAACAAATAAAAATAAAAATACATAATTAGCAGGACATGGTGGCACATGCCTGTAATCCCCAGCTACTCGGGAGGCTGAGGCATGGGAATTGTTTAAACCTGTGAGGCGGTGGTTGCAGTGAGCCAAGATCAAGCCATTGCACTCCAGCCTGGGCAACAAGAGTGAAACTCCATCTCAAAAAAAAAAAAAAAAAAGAGAAAAGAAAA","GGCCACACATGGTGGCTAACGCCTGTAATCCCAGCACTTTGGGAGGCCAAGTCGGGTGGATCATGAGGTCAGGAGACCAAGACCATCCTGGCCAAATGGTGAAACCCCGTCTCTACTAAAAATACAAAAATTAGCTGGGCATGGTGGCGTGTGCCTGTAATCCCAGCTACTCAGGAGGCTGAGGCAGGACAATTGCCTGAACCCAGGAGAATTAGCTGGGCATGGTGGCGTGTGCCTGTAATCCCAGCTACTCAGGAGGCTGAGGCAGGACAATTGCCTGAACCCAGGAGGCGAAGGTTGCGGTGAGCCGAGATTGTGCCATTGCACTCCAGCCTGGGTAACAAGAGCGACACTCTGTCTCAAAAAAAAAAAAAAAAAAAAAAAAAAA"
"chr17","47866693","47867898","JH378118","18053084","18053501","809","29813609","GGCTGGGCTTGGTGGCTCATGCCTATAATTCTAGGACTTTGGGAGGCCAAGGCGGATGGATCACCTGAGGTCAAGAGTTGGAGACCAACCTGTCCAACATGGTGAAACCCCCTCTGTACTAAAAATACAAAAATTGGCCGAGCGTAGTGGCTCATGCCTGTGATCACAGCACTTTGAGAGGCTGAGGCGGGCGGATCACAAGGTCAGGAGATCAAAACCATCCTGGCTAACAAGGTGAAACCCCATCTCTGCTAAAAAATAACAGGGCGTGGTGGCACACGGCTGTAGTCCCAGCTACTTGGGAAGCTGAGGCAGGAGAATCGCTTGAACCTGAGAGGCAGAGGTTGCAGTGAGCTGAGATCAGGCCACTGCTCTCCAGCCTGGGCAACAGAGTGAAACTCCATCTCAAAAAAAAAAAGAAAAAGGCCAGGCATGGTGGCTCACGCCTGTAATGCCAGCACTTTGGAAGACTAAGTTGGGCAGATCACAACATCAGAAGATGGAGACCATCCTGGCTAACACGGTGAAACCCCGTCTCTACTAAAAATACAAAAAAAAAAAAAAAAAAAATTAGCCGGGCGTGGTGACATGCGCCTGTAATCCTAGCTACTCCGGAGGCTGAGGCAGGAGAATGGCGTGAACCCGGGAGGCGGAGCTTGCAGTGAGCCGAGATGGTGCCACTGCACTCCAACCTGGGCGACAGAGCGAGACTCTGTCTCAAAAAAAAAAAAAAAAAAGAAAAAAGGTCGGGCGCAGTGGCTCACACCAGTAATCACAGCACTTTGGGAGGCCGAGGCGGGTGGATCACCTGAGCTCGGGAGTTCAAGACCAGCCTGACCAACATGGTGAAACTCCGTCTCTACTAAAAATACAAAATATTAGCCGGGCGTGGTGGCGCGTGCCTGTAATCCCAGTTACACGGGAGGCTGAGGCAGGAGAATCACTTGAACTTGGGAAGTGGAGGTTGTGGGAGCCGAAATCGTGCCATCGCATTCCACAAGAGTGAAACTCCATTTCAAAAAAAAAAAATACAAAAATTAGCTGGGCGTGGTGGCGGGCGCCTTTAATCCCAGGGGCTCGGGAGGCTGAGGCAGGAGAATCGCTTGAACCTAGGAGGCAGAGGTTGCAGTGTGCCAAGATGACACCATTGCACTCCAGGCTGGGCAAGAGAGCAGTAACTCCCGTCTCAAAAAAAAAGAAGGAAAA","GGCTGGGCGCAGTGGCTCACACCTGTAATCCCAGCACTTAGGGAAGCTGAGGCGAGTAGATCACCTGAGGTCAGGAGTTAGAGACCAGCCTGGCCATCATGGTGAAACCCCGTCTCTACTAAAGATACCAAAAATTAGCTGAGTGTGGTGCTGGGTGCCTGTAATCCCAGAAACTCAGGGTGCCTGTAATCCCAGCAACTCAGGGTGCCTTTAATCCCAGCAACTGAGGGTACCAGTAATCCCAGCAACTCAGGGTGTCTTTAATCCTAGCAACTGAGGGCACCTGTAATCCCAGCAACTCAGGAAGCTGAGACAGGAGAAGTACTTGAACCCAGAAGGCAGAGGTTGCAGTGAGCCGATATTGCACCATTGCACTCCAGTCTGGGCAACAAGAGTGAAACTCTGTCTCAAAAAAAAA"
"chr17","48059944","48060302","JH378108","45564157","45564495","64","2495787","GGCCGGGCGCAGTGGTTCATGCCTGTAATCCCAACACTTTAGGGGGCTGAGGCAGGTGGATCACCTGAGGTCAGGAGTTCAAGACCAGCCTGGCCAACATGGTGAAAGCCCATCTCTACTAAAAATACAAAAAATTAGCTGGGCATGGTGGTGCGTGCCTGTAATCCCAGCTACTTGGGATGCTGAGGCAGGAGAATCGCTTGAACCCGGGAGGTGGAGGCTGCAGTGAGCTGAGATTGTGCCATTGCACTCCAGCCTGGGCAACAAGAGTGAAACTCCATCTAAAAAAAAAAAAGAAGAGGAGGAGGAGGAGGAGGGGGAGGGGGAGGAGGAGGAGGAGGAGAAGAAGAAAAAAGAAA","GCTAGGCAAGGTGGCTCATGCCTGTAATCCCAACATTTTGGGAGGCCGAGGCAGATGGATCACCTGAGGTTAGGAGTTCAAGACCAGCCTGGCCAACATGGTGAAACTCCATCTCTACTAAAAATACAAAAAATTAGCTTGGCACGGTGGTGGGTGCCTCTAATCCCAGCTGCTTGGGAGGCTGAGGCAGGAGAATCGCTTGAACTCAGGAGGTGGAGGTTGCAGTGAGCCAAGATCATGGCATTGCACTCCAGCCTGGGCGACAAGAGCGAGACTCCCTCTAAGAAAGAAAAGAAAGAAAAGAAAAGAAAAAAGGAAAGGAAAGGAAAGAAAGAGAAA"
"chr17","50365982","50366602","JH378118","18053084","18053501","274","32312898","GGCAAGGCGTGGTGGCTGATGTCTGTAATCCCAGCAATTTGGGGGGCTGAGGTGGATGGATCACCTGAGATCAGAAGTTCGAGACTAGGCTAGCCAACATAGTGAAACCCCATCTCTACTAAAAATATAAAAAGTTAGCCAGGCGCGGTGGTTCATGCCTGTAATCCCAGCACTTTGGGAGGCCGAGGTAGGTGGATCACAAGGTCAGGAGTTCAAGACCAACCTGGCCAAGATAGTGAAACCTCATCTCTACTAAAAATACAAAAATTAGCTGGGCGTGGTGGCAACCACCTATGATCCCAGCTACTTGGGAGGCTGAGGCAGAGAACTGCTTGAACCCAGGAAGTGGAGGTTGTAGTGAGCCAAGATTGCATCACTGTACTCCAGCCTGGGCAACAGAGCAAGACTCCATCTCAAAAAAAAAAAAAAAAAAAATACAAAAAATTAGCCAGGCGTGGTGGCAGGCACCTGTAATCCCAGCTACTCGGAAGGCTGAGGCAGGAGAATTGCTTGAACCTGGGAGGTAGAGGTTGCAGTGAGCTGAGATTGTGCCATTGCACTCTAGCCTATGTGACAAGAGCGAAACTCCATCTCAAAAAAAAAAAAAAAAAAGAAAGAAAA","GGCTGGGCGCAGTGGCTCACACCTGTAATCCCAGCACTTAGGGAAGCTGAGGCGAGTAGATCACCTGAGGTCAGGAGTTAGAGACCAGCCTGGCCATCATGGTGAAACCCCGTCTCTACTAAAGATACCAAAAATTAGCTGAGTGTGGTGCTGGGTGCCTGTAATCCCAGAAACTCAGGGTGCCTGTAATCCCAGCAACTCAGGGTGCCTTTAATCCCAGCAACTGAGGGTACCAGTAATCCCAGCAACTCAGGGTGTCTTTAATCCTAGCAACTGAGGGCACCTGTAATCCCAGCAACTCAGGAAGCTGAGACAGGAGAAGTACTTGAACCCAGAAGGCAGAGGTTGCAGTGAGCCGATATTGCACCATTGCACTCCAGTCTGGGCAACAAGAGTGAAACTCTGTCTCAAAAAAAAA"
"chr17","50542261","50542886","JH378206","6546474","6546861","277","43995787","GCCGGGCGCTGTGGCTCAAGCCTGTAATCCCAGCATTTTGGGAGACTAAGGGAAGCAGATCCTGTGAGCTCAGGATTTCGAGACCAGCCTGGCCAACATGGTGAAACCCTGTCTCTACAAAAATTAGCCATGCCGGGCACGGTGGCTCACGCCTGTAATCCCAGCACTTTGGGAGGCTGAGGCGGGCGGATCACAAGGTCAGGAGTTTGAGACCATCCTGCCTAACACGGTGCAACCCCGTCTCTACCAAAAATACAAAAAATTAGCTGGGCGTGGTGGCGGGTGCCTGTAGTCCCAGCTACTCGGGGGGCTGAGGCAAGAGAATGGCATGAACCTGTGGGGCGGAGCTTGCTGTGAGCCGATATCCTGCCACTGCACTCCAGCCTGGGCGACAGAGCGAGACTCCATCTCAAAAAAAAAAAAAAAAAAAAAAAAAAAAAAAAATGAGCCAGCTGTGGTGGCGTGTGTGCCTGTAATCCCAGCTACTCGGGAGGCTGAGGCAAGAGAATCACTTGAATCTGGGAGGCAGAGGTTGCAGTGAGCCAAGATCATGCTATTGCACTTCAGCCTGGGCAACAAGAGTGAAACTCTGTCTCAAAAAAAAAAAAAAAAAAAAAGAAAAAGAA","GGCCACACATGGTGGCTAACGCCTGTAATCCCAGCACTTTGGGAGGCCAAGTCGGGTGGATCATGAGGTCAGGAGACCAAGACCATCCTGGCCAAATGGTGAAACCCCGTCTCTACTAAAAATACAAAAATTAGCTGGGCATGGTGGCGTGTGCCTGTAATCCCAGCTACTCAGGAGGCTGAGGCAGGACAATTGCCTGAACCCAGGAGAATTAGCTGGGCATGGTGGCGTGTGCCTGTAATCCCAGCTACTCAGGAGGCTGAGGCAGGACAATTGCCTGAACCCAGGAGGCGAAGGTTGCGGTGAGCCGAGATTGTGCCATTGCACTCCAGCCTGGGTAACAAGAGCGACACTCTGTCTCAAAAAAAAAAAAAAAAAAAAAAAAAAA"
"chr17","51121894","51122508","JH378118","18053084","18053501","260","33068810","GGCTGGGTGCAGTGGCTCATGCCTGTATTCCCAACACTTTGAGAGGCCAAGGCGGGCAGATCACCTGAGGTCAGGAATTCGAGACCAGCCTGGCTAACATGGCGAAACCCTGTCTCTATTAAAAACACAAAAATTAGGCCAGGCACGGTGGCTCACACCTGTAATCCCAGCACTTTGGGAGGCTGAGGCGGGCAGATCACGAAGTCAGGAGATCGAGACCATCCTGGCTAACATGGTGAAACCCTGTCTCTGCTAAAAATACAAAAAAAATAGCGGGGCGTGGTGGCAGGCGCCTGTAGTCCCAGCTACTCAGGAGGCTGAGGCAGGAGAATGGCGTGAACCTGGGAGGCGGAGGTTGCAGTGAGCCGAGATCGCGCCACTGCACTACAGCTTGGGTGACAGAGCGAGACTCTGTCTCAAAAAAAAAAAAAAAAGTTAGTCGGGCATGGTGGTGGGCTCCTGTATTCCCAGCTACTCAGGAGGCTGAGGTGGGAGAATCACTTGAACCTGGAAGGCAGAGGTTGCTGTGAGCCAAGATTGCACCATTGCATTCCAGCCTGGGTGACAAGAGCAAAACTCTGTCTCAAAAAATATATATAAAATAATAAAAATAAA","GGCTGGGCGCAGTGGCTCACACCTGTAATCCCAGCACTTAGGGAAGCTGAGGCGAGTAGATCACCTGAGGTCAGGAGTTAGAGACCAGCCTGGCCATCATGGTGAAACCCCGTCTCTACTAAAGATACCAAAAATTAGCTGAGTGTGGTGCTGGGTGCCTGTAATCCCAGAAACTCAGGGTGCCTGTAATCCCAGCAACTCAGGGTGCCTTTAATCCCAGCAACTGAGGGTACCAGTAATCCCAGCAACTCAGGGTGTCTTTAATCCTAGCAACTGAGGGCACCTGTAATCCCAGCAACTCAGGAAGCTGAGACAGGAGAAGTACTTGAACCCAGAAGGCAGAGGTTGCAGTGAGCCGATATTGCACCATTGCACTCCAGTCTGGGCAACAAGAGTGAAACTCTGTCTCAAAAAAAAA"
"chr17","51573403","51574012","JH378118","18053084","18053501","260","33520319","GGCCGGGTGTGGTGGCTCACGCCTATTATCCCAGCAGTTTGGGAGGCCAAGTGGGGGTTGGATCACCTGAGGTCAGGGGTTCGAGACCAGCATGGCCAACATGGTGAAAACCCATCTATACTAAAGATACAAAAAATTAGGCTGGGCACAGTGGCTCATGCCTGTAATCCCAGCACTTTGGGAGGCCAAGGATCACGAGGTCAGGAGATCGAGACCATCCTGGCTAACACAGTGAAACCCCGTCTCTACTAAAAATACAAAAAAATTAGCCGGGAGTGGTGGCAAGTGCCTGTAGTCCCAGCTACTCAGGAGGCTGAGGCAGGTGAATAGTGTGAACGCAGGAGGCAGAGCTTGCAGTGAGCCGAGATCGTGCCACTACACTCCAGCCTGGGCGACAAGGTGAGACAACGTCTCAAAAAAAAAAAAAAAAAAAAGCCGGGCATGGTGGGAGGCACCTGTAATTCCACCTACTTGGGAGGGTGAGGCAGGAGAATTGCTTGAATCTGGGAGATGGAGGTTGGAGTAAGCCAAGTTCGCACCATTGCACTCCAGCCTGGGTGACAAGAGCGAAACTCTTGTCTCAAAAAAAAAAAAAAAAAAAAAAAAAAAA","GGCTGGGCGCAGTGGCTCACACCTGTAATCCCAGCACTTAGGGAAGCTGAGGCGAGTAGATCACCTGAGGTCAGGAGTTAGAGACCAGCCTGGCCATCATGGTGAAACCCCGTCTCTACTAAAGATACCAAAAATTAGCTGAGTGTGGTGCTGGGTGCCTGTAATCCCAGAAACTCAGGGTGCCTGTAATCCCAGCAACTCAGGGTGCCTTTAATCCCAGCAACTGAGGGTACCAGTAATCCCAGCAACTCAGGGTGTCTTTAATCCTAGCAACTGAGGGCACCTGTAATCCCAGCAACTCAGGAAGCTGAGACAGGAGAAGTACTTGAACCCAGAAGGCAGAGGTTGCAGTGAGCCGATATTGCACCATTGCACTCCAGTCTGGGCAACAAGAGTGAAACTCTGTCTCAAAAAAAAA"
"chr17","51598763","51599361","JH378118","18053084","18053501","241","33545679","GCCGGGCGTGGTGACTCACGCCTGTAATACCAGCACTTTAGGAGGCTGAGGTGGGTGGATCACCTGAGGTCAGGAGTTCGAGACCGGCCTGGCCAACATGGTGAAATCCTGTCTCTACTAAAAATACAAAAAAATGGCCAGGCGTGGTGGCTCACGCCTGTAATCCTAGCACTTTGGGCGGCCCAGGTGAGTGGATCACGAGGTCAGGAGATCGAGACCATCCTGGCTAACATGGTGAAACCCCATCTCTACTAAAAAACTACAAAAAAATTAGCTGGGCGTGGTGGCAGGCGCCTGTAGTCCCAGCTACTCGGGAGGCTGAGGCAGGAGAATGACGTGAACCCGGGAGGCGGAGCTTGCAGTGAGCAGAGCTTGAGCCACTGCACTCCAGCTTGGGCGACAGAGTGAGACTCCGTCTCAAAAAAAAAAAAAAAAAAATTAGCTGGGGATGGTGGCGGGCACCTGTAATCCCAGCTACTCTGGAGGCTGAGACAGGAGAATCGCTTGAACCCAGGAGGCGGAGGTTGCAGTGAGCTGAGATCGTGCCATTGTACTCCAGCCTGGGCAACAAGAGTGAAACTCAATCCGAAGAAAAAAAA","GGCTGGGCGCAGTGGCTCACACCTGTAATCCCAGCACTTAGGGAAGCTGAGGCGAGTAGATCACCTGAGGTCAGGAGTTAGAGACCAGCCTGGCCATCATGGTGAAACCCCGTCTCTACTAAAGATACCAAAAATTAGCTGAGTGTGGTGCTGGGTGCCTGTAATCCCAGAAACTCAGGGTGCCTGTAATCCCAGCAACTCAGGGTGCCTTTAATCCCAGCAACTGAGGGTACCAGTAATCCCAGCAACTCAGGGTGTCTTTAATCCTAGCAACTGAGGGCACCTGTAATCCCAGCAACTCAGGAAGCTGAGACAGGAGAAGTACTTGAACCCAGAAGGCAGAGGTTGCAGTGAGCCGATATTGCACCATTGCACTCCAGTCTGGGCAACAAGAGTGAAACTCTGTCTCAAAAAAAAA"
"chr17","51738482","51739094","JH378118","18053084","18053501","257","33685398","GCCGGGTGCGGTGGCTCACACCTGTAATCCCAGCACTTTGGGAGACTGAGGCGGGAGGATCACCTGAGGTCAGGAGTTCGAGACCAACCTGACCAACATGGTAAAACCCTGTCTGTACTAAAACTACAAAAAATTAGGCCAGGCGCAGTGGTCCATGCCTGTAATCCCAGCACTTTGGGAGGCCAAGGTGGGCGGATCATGAGGTCAGGAGTTTGAGACCAGCCTGGCCAACATAGTGAAACCCTGTCTCTACTAAAAACACAAAAATTAGTCGGGCATGGTGGCGGATGCCTGTAATCTCAGCTACTCAGGAGGTTGAGGCAGGAGAATCACTTGAACCCGGGAGGTGGAGGTTGCAGTGAGCCAAGATCACGCCACTGTACTCCAGCCTGGGCAACAGAGCGGGACTCCATCTTAAAAAAAAAAAAAAAAAAATTAGCCAGGCGTGGTGGCGCATGCCTGTAGTCCCAGCTACTTAGGAGGCTGAGGCAGGAGAATTGCTTGAACCCGGGAGGCAGAGGCTGCAGTGAGCCAAGACCACGCTATTGCATTCCAGCCTGGGTGACAAGAGCAAAACTCTGTCTCAAAAAACAAAACAAAACAAACAAAAAAA","GGCTGGGCGCAGTGGCTCACACCTGTAATCCCAGCACTTAGGGAAGCTGAGGCGAGTAGATCACCTGAGGTCAGGAGTTAGAGACCAGCCTGGCCATCATGGTGAAACCCCGTCTCTACTAAAGATACCAAAAATTAGCTGAGTGTGGTGCTGGGTGCCTGTAATCCCAGAAACTCAGGGTGCCTGTAATCCCAGCAACTCAGGGTGCCTTTAATCCCAGCAACTGAGGGTACCAGTAATCCCAGCAACTCAGGGTGTCTTTAATCCTAGCAACTGAGGGCACCTGTAATCCCAGCAACTCAGGAAGCTGAGACAGGAGAAGTACTTGAACCCAGAAGGCAGAGGTTGCAGTGAGCCGATATTGCACCATTGCACTCCAGTCTGGGCAACAAGAGTGAAACTCTGTCTCAAAAAAAAA"
"chr17","52245950","52246538","JH378118","18053084","18053501","254","34192866","TGTAATCCCAGCACTTTGGGAAGCCAACGCGGGTAGATCAGCTGAGGTCAGGAGCTCGAGACCAGCCTGGCCAACTGGTGAAACCCCATCTCTACTAAAAAAAATACAAAAAAATGGCCCAGCGCGGTGGCTCACACCTGTAATCCCAGCACTTTGGGAGGCCGAGGCGGGCAGATCACGAGGTCAGGAGATCGAGACCATCCTGGATAATACGGTGAAACCCCGTCTCTACTAAAAATACAAAAAAAAATTAACCGGGTGTGGTGGCGGGCGCCTGTAGTCCCAGCTACTAGGGAGGCTGAAGCAGGAGAATGGCGCGAAACCGGGAGGCGGAGCTTGCAGTGAGCCAAGACAGGCCACTGCACTCCAGCCTGGGCGACAGAGCGAGACTCCATCTCAAAAAAACAAAAAACAAAAAAATTAGCCAGCTGTGGTGGTGGGCGCATGTAATCCCAGTTACTTGGGAGGCTGAGGCAGGAGAATTGCTTGAAACCAGGAGGCAGAGGTTGCAGTGAGCCAAGATTACGCCATTGTACTCCAGCCTGGGCAACAAGGGCAAAACTCTGTCTCAACAAAAAAAAAGAAAAAA","GGCTGGGCGCAGTGGCTCACACCTGTAATCCCAGCACTTAGGGAAGCTGAGGCGAGTAGATCACCTGAGGTCAGGAGTTAGAGACCAGCCTGGCCATCATGGTGAAACCCCGTCTCTACTAAAGATACCAAAAATTAGCTGAGTGTGGTGCTGGGTGCCTGTAATCCCAGAAACTCAGGGTGCCTGTAATCCCAGCAACTCAGGGTGCCTTTAATCCCAGCAACTGAGGGTACCAGTAATCCCAGCAACTCAGGGTGTCTTTAATCCTAGCAACTGAGGGCACCTGTAATCCCAGCAACTCAGGAAGCTGAGACAGGAGAAGTACTTGAACCCAGAAGGCAGAGGTTGCAGTGAGCCGATATTGCACCATTGCACTCCAGTCTGGGCAACAAGAGTGAAACTCTGTCTCAAAAAAAAA"
"chr17","52264620","52265210","JH378118","18053084","18053501","242","34211536","GGCCACATGTGGTGGCTCACACCTGTAATCCCAGCACTTTGGGAGGCCAAGGCAGGCAGATCACCTGAGATCAGAAGTTCAAGACCAGCCTGGCCAATGTGGTGAAACCCTGTCTCTACTAAAAATAGAAAAAACACAGCCAGGCGCGGTAGCTCACACCTGCAATCCCAGCACTTTGGGAGGCCGAGGCAGGCAGATCACGAGGTCAGGAGATTGAGACCACGGTGAAACCCCATCTCTACTAAAAATACAAAAAATTAGCTGGGCATGGTGGCGGGCACCTGTAGTCCCAGCCACTTGGGAGGCTGAGGCAGGAGAATGGCGTGAACTCGGGAGGTGGAGCTTGCAGTGAGCAAAATTGCGCCACTGCACTCCAGCCTGGGCAACAGAGCAAGACTCCGTCTCAAAAAAAAAAAAAAAAAAAAATTAGCCGGCGTAGTGGCAAGCTCCTGTAATCCCAGCTACTTGGGAGGCTGAAGCAGGAGAATCGCTTGAACCCAGGAGGTGGAGGTTGCAGTGAGCCGAGACTGCGCCATTGCACTCCAGCCTGGGCAACAAGAATGAAACTCCGTCTCAGAAAAGAAAAAAAAA","GGCTGGGCGCAGTGGCTCACACCTGTAATCCCAGCACTTAGGGAAGCTGAGGCGAGTAGATCACCTGAGGTCAGGAGTTAGAGACCAGCCTGGCCATCATGGTGAAACCCCGTCTCTACTAAAGATACCAAAAATTAGCTGAGTGTGGTGCTGGGTGCCTGTAATCCCAGAAACTCAGGGTGCCTGTAATCCCAGCAACTCAGGGTGCCTTTAATCCCAGCAACTGAGGGTACCAGTAATCCCAGCAACTCAGGGTGTCTTTAATCCTAGCAACTGAGGGCACCTGTAATCCCAGCAACTCAGGAAGCTGAGACAGGAGAAGTACTTGAACCCAGAAGGCAGAGGTTGCAGTGAGCCGATATTGCACCATTGCACTCCAGTCTGGGCAACAAGAGTGAAACTCTGTCTCAAAAAAAAA"
"chr17","52281488","52282107","JH378118","18053084","18053501","287","34228404","GGCCAGGCGCGGTGGCTCACGCCTGTAATCCCAGCACTTTGGGAGGTCAAGGCGGGTGGATCACCTGAGGTCAGGAGTTCAAGACCAGCCTGGCCAACATGATGAAACTTCATCTTGGCCGGGCGCGGTGGCTCATGCTTGTAATCCCAGCACTTTGGGAGGCCAAGGCAGGCGGCGGATCATGAGGTCAGGAGATTGAGACCATCCTGGCTAAAACGGTGAAACCCCGTCTCTACTAAAAATACAAAAAAAAAAAAATTAGCCGGGCGTGGTGGCAGGCGCCTGTAGTCCCAGCTACTCGGGAGGCTGAGGCAGGAGAATGGCGTGAACCCGGGAGGCGGAGCTTGCAGTGAGCCGAGATAGCACCACTGCAGTCCGGCCTGGGTGAAAGAGTGAGACTCCGTCTCAAAAAAAAAAAAAAAGAAGAAAGAACTTCGTCTTTACTAAAAGTACAAAAAAAAAAAAAAAAAATTAGCCGGGCATGGTGGCAGGCGCCTGTAAACCCAACTACTCTGGAGGCTGAGGAAGGAGAACTGCTTGCACCTGGGAGTCGGAGGTTGCAGTAAGCCAAGATCGCACCATTGCACTCCAGCCTGGGCATCAAGAGTGAGACTTTGTCT","GGCTGGGCGCAGTGGCTCACACCTGTAATCCCAGCACTTAGGGAAGCTGAGGCGAGTAGATCACCTGAGGTCAGGAGTTAGAGACCAGCCTGGCCATCATGGTGAAACCCCGTCTCTACTAAAGATACCAAAAATTAGCTGAGTGTGGTGCTGGGTGCCTGTAATCCCAGAAACTCAGGGTGCCTGTAATCCCAGCAACTCAGGGTGCCTTTAATCCCAGCAACTGAGGGTACCAGTAATCCCAGCAACTCAGGGTGTCTTTAATCCTAGCAACTGAGGGCACCTGTAATCCCAGCAACTCAGGAAGCTGAGACAGGAGAAGTACTTGAACCCAGAAGGCAGAGGTTGCAGTGAGCCGATATTGCACCATTGCACTCCAGTCTGGGCAACAAGAGTGAAACTCTGTCTCAAAAAAAAA"
"chr17","52731467","52732093","JH378129","11955248","11955630","276","40776219","GGCCGGGTGCGGTGGCTCACGCCTGTAATCCTGGCACTTTGGGAGGCTGAGATGGACGGATCACCTGAGGTCAGGAGTTTTTTGTTTTTTTCTTTTTTTTTGAGACAGAGTCTGGCTCTGTTGCCCAGGCTGGAGTGCAGTGGCTCGATCTCGGCTCACTGCAAGCTCCGCCTCCCGGGTTCATGCCATTCTCCTGCCTCAGCCTCCCGGTAGCTGGGACTACAGGTGCCCGCCAGCACATCCGGTTATTTTTTTGTATTTTTAGTAGAGACAGTGTTTCACAGTGTTAGCCAGGATGGTCTCGATCTCCTGACCTCGTGATCCGCCCACCTCGGCCTCCCAAAAGTGCTGGGATTACAGGCATGAGCCACCGCGCCCGGCCAGGAGTTTTTGAGACCAGCCTGGCCAACAGGGTGAAACTCTGTCTCTACTAAAAATACAAAAATTAGTTGGGCATGGTGGCAGGCACCTGTAATCCCAGCTACATGGGAGGCTGAGGCAGGAGAATTGCTTGAACCTGGGAGGCGGAGGTTGCAGTGAGCTGAGATTGCGCCATTGCACTCCAGCCTGGGCAACAAGAGTGAAATTGCGTCTCAAAAACCAAAACAAACAAAAAAAGAATGAAAA","GGCTGGGTACGGTGGCTCATGCCTGTAATCCCAGCACTTTGGGAGGTGGGTCACTTGAGGTCAGGAGTTCGAGACCAGCCTGTGCAGTGCCTCCATCCTCAACTGCTGCCTCATCAGCCTGGACCACTACCTGCTCATCCTCTCACCACTGCCACAAGCTGCGCATGAAGCTCCTGCGCGCGCCGGTGCCCGTCTCTACTAAAAATACAAAAATTAGCTGGGTGTGGTGGCAGGTGCCTGTAATCCCAGCTACTCAGGAGGCTGAGGCAGGAGAATCACTTGAACCCAGGAGGCAGAGGTTGCAGTGAGCCGATATCGCATCATTGCACTCCAGCCTGAGCAACAAGAGTGAAATTTTGTCTCAAAAAAAAAAAAAAAAGAAA"
"chr17","54416242","54416805","JH378115","26183910","26184297","228","28232332","ACTTTGGGAGGCCATGGCAGGCGGATCACCTGAGATCAGGAGTTGGAAACCAGCCTGGCCAACATGGTAAAACCCCGTCTCTACTAAAAATACTTGGCTGGGCACGGTGGCTCACACTTGTAATTCCAACACTTTGGAAGGCCAAGGCGGGCAGATCACCTGAGGTTGGGAGTTCGAGACCAGCCTGACCAACATGGAGAAACCCTGTCTCTACTAAAAATACAAAATTAGCTGGGCATGGTGGTCTATGCCTGTAATCCCAGCTACTTGGGAGGCTGAGGCAGGAGAATTGCTTGAACCCGGGAGGCAGAGGTTGCGGTAAGCCAAGATCATGCCATTGCACTCCAGCCTGGGCAACAAGAGCAAAACCCCGTCTCAAAAAAAAAAAAAAAATTAGCCCAGTGTGGTGGCGTGCACCTGTAATCCCAGCTACTTACTTAGGAGCCTGAGGCAGGAGAATTGCTTGAACCCGGGAGGCAGAGTTTGCAGTGAGCCAAGATTGCACCATTGCACTCCAGCCTGGGTGACAAGAGTGAGACTGTCTCAAAAAAAAAAAAAAAAAAA","GGCCAGGTGCAGTGGCTCATATGTATAACCCCAACACTTTGGGAGGCCAACGCAGGTGGATCACCTGAGTTAGGAGTTTGAGACCAGCCTGACCAACATGGTGAAACCCTGTCTCTACTAAAAATACAGAAATGGCCGGGCATAGTGACACATACCTGTAATCCCAGATACTTGGGATGCTGAGTTTGCTTAAACCCAGAGGAGAACTGCTTAAACCCGGGAGGTAGAGGTCACAGTGAGCCAAGATTGGGATGCTGAGATTTGCTTAAACCCAGAGGAGAACTGCTTAAACCCAGGAGGCAGAGGTTGCAGTGAGTTGAGATTGCACCATTGCACTCCAGCCTGGACAACAAGAGTGAAACTCTGTCTCAAAAAAAAAAAAAAAAAA"
"chr17","55179146","55179483","JH378144","13229286","13229620","44","41949860","GGCCGGGTGCGGTGGCTCACGCCTGTAATCCCAGCACTTTGGGAGGCCGACGCAGGTGGATCACTTGAGGTCTGGTGTTCAAGACCAGCCTGGCCAACATTGTGAAACCCCGTCTCTACTAAAAATACAAAAAGTTAGCTGGGCATGGTAGCAGGTGCCTGTAATCCCAGCTACTTGGGAGGCTGAGGCAGGAGAATTGCTTGAACCTGGGAGGCAGAGGTTGCAGTGAGCTGAGATCGCACCATTGCACTCCAGCCCAGGCAACAAGAGCGAAACTTCGTCTCAAATAATAATAATAATAATAATAATAAATAAATAAATTTTTAAAAAAGAAAAAA","GGCCGGGCGCGGTGGCTCAAGCCTGTAATCCCAGCACTTTGGGAGGCCGAGGCGGGTGGATCACCTGTGGTCAGGAGTTCAAGACAGCTTGGTCAACATGGTGAAACCCCGTCTCTACCAAAAATACAAAAAATTAGCTGGGCATGGTAGCGCATGCCTGTAATCCCAGCTACTCAGGAGGCTGAGGCAGGAGAATTGCCTGAACCCAGGAGGCAGAGGTTGCGGTGAGCCGAGATCGCGCCATTGCACTCCAGCCTGGGTAACAAGAGCGAAACTCCCTCTCATAAAAAATAAATAAATAAATAAATAAATAAATAAATAAATAAATAAATAAA"
"chr17","59543657","59543981","JH378109","3329188","3329514","46","56214469","GGTTGGGCACAGTGGCTCACGCCTGTAATCCCAACACTTTGGGAGGCCAAGGCGGGTGGATCACCTGAGGTCGGGAGTTCAAGACCAGCCTGGCCAACATGCTGAAACCCTATCTCTACTAAAAATACAAAAAAAAAAAAAAAAAAAAAAAAAAAAAATAGCCCAGTGTGGTGTCAGGCGCCTATAATCTCAGCTACTTGGGTGGCTGAGGCAGGAGAGTCGCTTGAACCTGGGAGGCGGAGGTTGCAGTGAGCGGAGATCGCACCATTGCACTCCAGCGTGGGCAACAAGAGTGAAACTCCATCTCAAAAAAAAAGAAAAGAAA","GGCCAGGCATGGTGGCTCACGCCTGTAATCCCAGCACTTTGGGAGCCCAAGCCGGGTGGATTACCTAAGGTCAGGAATTCCAGAACAGCCTGGACAATATGGTGAAACCTTGTCTCTACTAAAAATACAAAAAAAAAAAAAAAAAAAAAAAAAAAAAAAATTTAGCCGGGTGTGGTGGTAGGTACCTGTAATCCCAGCTACTAGGGAGGCTGAGGCAGGAGAATCGCTTGAACTTGGGAGGCGGAGGTTGCAGTGAACAGAGATCACACCACTGCACTCCAGCCTGGGCGACAAGAGCAAAACTCCATCTCAAAGAAAAAAAAAGAA"
"chr17","60766805","60768705","JH378118","18053084","18053501","1483","42713721","GGCCAGGTACCGTGGCTCATGCCTCTTATCCCACCACTTTTGGAAGCTGAGGTGTGAGGATCACCCGAAGTCAGGAGTTTGGAACCATCCTGGCCAATGTTGTAAAACCCCGTCTCTAATAAAAATACAAAAGTTACCCAAGCATGGTGGTGGGCACACCTGTAATCCCAGCTACTTGGAAGGCTAAGACAGGAAAATGCCTGAACCCAGTGTGGCTGGAATTGGTGGGTTCTTGATCTCACTGACCTCAAGAATGAAGCCACGGACCCTCACGGTGAGTGTCACACTTCAAGGTGGCACGTCCAGTTTGTTCCTTCTGATGTTCGGATGTGCTCAGAGTTTCTTTCTTCTGGTGGGTTCATGGTCTCGCTGGCTCAGGAGTGAAGCTACAGACGTTCACCGGGAGTGTTACAGCTCTTAAGGCCTTGCGCCTGGAGTTGTTAGTTCCTCCCAGTGGCTTCGTGGTCTCACTGGCTTCAGGAATCAAGCAGCACGGTGAGCGTTACAGCTCACAAAGGCAGTGTGCACCCACAGTGAGCAACAGCAAAATCTATTGCAAAGAGGACAGAACAAAACCCCCACACTGGGGAAAAGGACCGGAACAGCTTGCCACTGCTGGCTCAGGCAGCCTGCTTTTATTCTCTTATCTGGCCCCACCCACATCCTCCTGATTGGTCCATTTTACAGAGAGCTGATTAGTTTGCTTTACAGTGAACTGATTGGTCCATTTTGACAGATTGGTGCTGATTGGTGCGTTTACAATCCCTGAGCTAGACACAAAAGTTTTCCACGTCCCCATTAGAATAGCTAGATACAGAGTGTCCATAGGTGTATTTACAAACCCTGAGCTAGACACGGAGTGATGATTGGTGCATTTACAAACATGGAGCTAGATACAGAGTGCCGATTGGTGCATTCACAATCCCTTAGCTAGACATAAAGGTTCTCAAGTTCCCACCAGATCAGCTAGACATAGAGCGCTGATTGGTGCATTTACAAAACTTGAGCTCGACACAGGGTGCTGATTGGTGCATTCACAAACCTTGAGCTAGACACAGGGTGCTGATTGGTGTGTTTACAAACCTTGAGCTAGATGCAGAGCGCTGATTGGTGTATTTACAATTCCTTAGCTAGACATAAAGGTTCTCCAAGTCCCCACTAGACTCAGGAGCCCAGCTGGCCTCACCCAGTGGATGTCACACTGGGGCCATAGGTGGAGCTGCCTGCCAGTTCCGTGTCCTGCGCCCACACTCCTCAGCCCTTGGGCGGTGGATGGGATTGGGCACCGTGCAGCAGGGGGTCGCGCTCCTGGGGGAGGCTCGGGCGGTGCAGGAGCCCACGGTGGCGGGGCGGGGCAGACTCAGGCATGGCGGGCTCCGGGTCCCAAGCCCTGCCGGGTGGGGAGGCACCTAAGGCCAGGCGAGAAATGGAGCGCAGCGCTGGTGGGCCAGCACTGCTGGGGGACCAGGCGCATCCTCCGCAGCTGTTGGCCTGGGTGCTAAGCCCCTCACTGCCCAGGGCTGGCAGGGCCCGCCGGCCGCTCCGAGTGCCGGGCCCGCCAAGCCCACGCCCACTTGGAACTCTAGCTGGCCCGCAAGCGCGGCGCGCAGCCCTGGTTCCCCCCCGTGCCTCTCCCTCCACACCTCCCCGCGGGCTGAGGGAGCCGGCTCCGGCCTCGGCCATCCCAGGAAGGGGCTCCCACACTGCAGCGGCGTGCTGAAGGGCTCCTCAAGCACGGCCAGAGTGGGCGAGGAGGCTGAGGAGGCGCCAAGAGTGAGCCAGGGCTGCCAGCATGCTGTCACCTCTCACCAGGAGGCGGAGATTGCAGTGAACCAAGACTGTGCCATTGCACTCCAGCCTGGGCAACAAGAGTGAAACTCCATCTCAAAAAAAATAATAAA","GGCTGGGCGCAGTGGCTCACACCTGTAATCCCAGCACTTAGGGAAGCTGAGGCGAGTAGATCACCTGAGGTCAGGAGTTAGAGACCAGCCTGGCCATCATGGTGAAACCCCGTCTCTACTAAAGATACCAAAAATTAGCTGAGTGTGGTGCTGGGTGCCTGTAATCCCAGAAACTCAGGGTGCCTGTAATCCCAGCAACTCAGGGTGCCTTTAATCCCAGCAACTGAGGGTACCAGTAATCCCAGCAACTCAGGGTGTCTTTAATCCTAGCAACTGAGGGCACCTGTAATCCCAGCAACTCAGGAAGCTGAGACAGGAGAAGTACTTGAACCCAGAAGGCAGAGGTTGCAGTGAGCCGATATTGCACCATTGCACTCCAGTCTGGGCAACAAGAGTGAAACTCTGTCTCAAAAAAAAA"
"chr17","64473614","64473953","JH378109","21565230","21565567","55","42908384","GGCCGGGTGTGGTGGCTCATGCCTGTAATCCCAGTACTTTGGGAGGCCGAGGCAGGCAGATCTCCTGAGGTCAGGAGTTTGAGACCAGCCTGGCCAACATGATGAAATGCTGTCTCTCCTAAAAATACAAAAATTAGCCAGACATAGTGGCAGGTGCCTGTAATCCCAGCTACTTGGGAGGCTGAGGGAGGAGAATTGCTTGAACCTGGGAGGCAGAGGTTGCAGTGAGTCAAGATCACGCCATTGCGCTCCAACCTGGGTGACAAAAGTGAGACTTCATCTCAAAATAAATAAATAAATAAATAAATAAATAAATAAATAAATAATAATTAAAAAAAAA","GGCCGGGCGCGGTGGCTCAAGCCTGTAATACCAGCACTTTGGGAGGCCGAGGCGGGTGGATCACGAGGTCAAGAGATCGAGACCATCCTGGTCAACATGGTGAAACCCCGTCTCTACTAAAAATACAAACAATTAGCTGGGCATGGTGGCGGGTGCCTGTAATCCCAGCTACTCCAGAGGCTGAGGCAGGAGAATTGCCTGAACCCAGGAGACGGAGGTTGCGGTGAGCCAAGATCGCGCCATTGCACTCCAGCCTGGGTGACAAGAGCGAAACTCCGTCTCAATAAATAAATAAATAAATAAATAAATAAAAATAAAATAAATAAATAAATAAATAA"
"chr17","67747489","67748097","JH378118","18053084","18053501","256","49694405","GCTGGGTGTGGTGGCTCACGCCTATAATCCCAGCACTTTGGGAGGCCAAGGCAGGTGGATCACCTGAGGTCAGGAGTTTGAGACCAGCCTGGCCAACATGATGAAACCCCGTCTCTACTAAAAATACAAAGAATTAGGCTGGGCGCGGTGGCTCACGCCTGTAATCCCAGCACTTTGGGAGGCCGAGGCGGGTGGATCACGAGGTCAGGAGATCGAGACCATCCTGGCTAACACGGTGAAACCCCGTCTCTAATAAAAATAAAAAAAAATTAGCTGGGCGTGGTGGTTGGCGCCTGTAGTCCCAGCTACTCGGGAGGCTGAGGCAGGGGAATGGCGTGAACCCGGGAGGTGGAGCTTGTAGTGAGCCGAGATCACGCCACTGCACTCCAGCCTGGGCGACAGAGCAAGACTCCGTCTCAAAAAAAAAAAAAAAAAAAATTAGCCAGGCGTGGTGGCGGGTGCCTGTAATCCCAGCTACTCTGGAGGCTGAGGCAGGAAAATCACTTTAACTCAGGAAACAGAGGTTGCAGTAAGCCGAGATCACGCCATTGTGCTCCATCCTGGGCAACAAGAGCGAAACTCCGACTCGGAAAAAAAGAAAAAAAAAAA","GGCTGGGCGCAGTGGCTCACACCTGTAATCCCAGCACTTAGGGAAGCTGAGGCGAGTAGATCACCTGAGGTCAGGAGTTAGAGACCAGCCTGGCCATCATGGTGAAACCCCGTCTCTACTAAAGATACCAAAAATTAGCTGAGTGTGGTGCTGGGTGCCTGTAATCCCAGAAACTCAGGGTGCCTGTAATCCCAGCAACTCAGGGTGCCTTTAATCCCAGCAACTGAGGGTACCAGTAATCCCAGCAACTCAGGGTGTCTTTAATCCTAGCAACTGAGGGCACCTGTAATCCCAGCAACTCAGGAAGCTGAGACAGGAGAAGTACTTGAACCCAGAAGGCAGAGGTTGCAGTGAGCCGATATTGCACCATTGCACTCCAGTCTGGGCAACAAGAGTGAAACTCTGTCTCAAAAAAAAA"
"chr17","71197353","71197681","JH378262","266823","267148","47","70930530","GACCGGACACAGTGGCTCACGTCTGTAATCCCAGCACTTTGGGAGGCTGAGGCGGGTGGATCACCTGAGGTCAGGAGTTCAAAACCAGCCTGGCCAATATGGTGAAAACCCGTCTATACTAAAAATAAAAAATTAGCCAGGCTTGGTGGCAGGCACCTGTAATCCTAGGTACTCTGGAGGCTTAGACAGGAGAATCACTTGAACCCGAGAAGTGGAGGTTGCAGTGAGCCAAGATCGTGCCATTGCACTCCAGCCTGGGCGACAAGAGTGAGACTCCATCTCAAAAACAAACAAACAAACAAACAAAAAACAAATGAACAAAAAAAAAA","GGCCGGGCGCGGTGGCTCAAGCCTGTAATCCCAGCACTTTGGGAGGCCGAGGCGGGTAGATCATGAGGTCAGGAGTTTGAGACCAGCCTGGCCAACATGGTGAAACCCCGTCTCTACTAAAAATACAAAAATTAGCCGGGCATGGTGGCCTGTGCCTGTAATCCTAGCTACCCAGGAAGCTGAGGCAGGAGAATTGCCTGAACCCAGGAGGCGGAGGTTGCGGTGAGCCGAGATCGTGCCATTGCACTCCAGCCTGGGTAACAAGAGCGAAACTCCGTCTCAAAAACAAACAAACAAACAAACAAAAACAAAAAACAAAAAACAAA"
"chr17","72892082","72892699","JH378118","18053084","18053501","266","54838998","GGCCAGGTGCAGTGGTTCACACCTATAATCCCAGCACTCTAGGAGGCCAAAGTGGGCAGATCACCTGAGGTCAGAAGTTCGAGACCAGCCTGGCCAACATGGTGAAACCATCTCTACTAAAAACACAAAAATTAGGCTGGGCACGGTGGCTCACACCTGTAATCCCAGCACTTTGGGAGGCCGAGGTGGGTGGATCACGAAGTCAGGAGATCAAGACCATCCTGGCTAACACGGTGAAACCCCGTCTCTACTAAAAATACAAAAAATTAGCCAGGCGTGGTGGCGGGCGCCTATAGTCCCAGCTACTTGGGAGGCTGAGGCAGGAGAATGGCGTGAACCCAGGAGGCGGAGCTTGCAGTGAGCCAAGATTGCGCCACTGCACTCCAGCCTGGGTGAGAGAGCTAGACTCTGTCTCAAAAAAAAAAAAAAAAAAAACACAAAAATTAGCCGGGCTTGGTGGCAGGTGCCCGTAATCCCAGCTACTCAGGACGCTGGGACAGGAGAATCTCATGAACCCTGGAGGTGGAGGTTGTAGTGAGCCAAGATCTCACCATCGCACTCCAGCCAGGGTGACAAGAGTGAAACTCTGTCTTAAAAAGATAAATAAATAAAATAAAA","GGCTGGGCGCAGTGGCTCACACCTGTAATCCCAGCACTTAGGGAAGCTGAGGCGAGTAGATCACCTGAGGTCAGGAGTTAGAGACCAGCCTGGCCATCATGGTGAAACCCCGTCTCTACTAAAGATACCAAAAATTAGCTGAGTGTGGTGCTGGGTGCCTGTAATCCCAGAAACTCAGGGTGCCTGTAATCCCAGCAACTCAGGGTGCCTTTAATCCCAGCAACTGAGGGTACCAGTAATCCCAGCAACTCAGGGTGTCTTTAATCCTAGCAACTGAGGGCACCTGTAATCCCAGCAACTCAGGAAGCTGAGACAGGAGAAGTACTTGAACCCAGAAGGCAGAGGTTGCAGTGAGCCGATATTGCACCATTGCACTCCAGTCTGGGCAACAAGAGTGAAACTCTGTCTCAAAAAAAAA"
"chr17","74365360","74365846","JH378118","18053084","18053501","163","56312276","TATAAAAAATCAGCTAGGCTTGGTGGCTTGTGCCTGTAATCCCAGCACTTTGGGAGGCTGAGGCAGGTGGATCACCTGACGTAGGTGTTTAAGACCAGATTGACTAACATGTTGAAACCCCGTCTCTACTAAAAATACAAAAATTATCTGGGCTTGGTGGTGCATGCCTGTAATCCCAGCTGCTCAGGAGGCTGAGACAGGAGAATCGCCTGAACCTGGGAAACGGAAGTTGCAGTGAGTGGAGGTTGCAGTGAGCCGAGATTGCACCACTGCACTCCAGTCTGGGCAACGGAAAAAGACTGTCTCAAAAAAAAAAAAAAAATTAGCTGGGTGTGGTGGTTGGCGCCTGTAATTCCAGCTACTCAGGAGGCTGAGGCAGGAGAATCACTTGAACTCAAGAGGCAGAGGTTGCAATGAGCCAAGATTGCGCCATTGTACTCCAGCCTGGGCCACAAGATTGAAACTTCATCTTGGGGAAAGAAAACAA","GGCTGGGCGCAGTGGCTCACACCTGTAATCCCAGCACTTAGGGAAGCTGAGGCGAGTAGATCACCTGAGGTCAGGAGTTAGAGACCAGCCTGGCCATCATGGTGAAACCCCGTCTCTACTAAAGATACCAAAAATTAGCTGAGTGTGGTGCTGGGTGCCTGTAATCCCAGAAACTCAGGGTGCCTGTAATCCCAGCAACTCAGGGTGCCTTTAATCCCAGCAACTGAGGGTACCAGTAATCCCAGCAACTCAGGGTGTCTTTAATCCTAGCAACTGAGGGCACCTGTAATCCCAGCAACTCAGGAAGCTGAGACAGGAGAAGTACTTGAACCCAGAAGGCAGAGGTTGCAGTGAGCCGATATTGCACCATTGCACTCCAGTCTGGGCAACAAGAGTGAAACTCTGTCTCAAAAAAAAA"
"chr17","74566963","74567566","JH378119","32351107","32351490","260","42215856","GCCGGGCATGGTGTATCACGCCTGTAATCCCAGCACTTTGGGAGGCAGAGGTAGGCAGATCACCTGAGGTCAGGAGTTCAAAACCAGCCTAGCCAACATGGTGAAACCCCGTCTCTACTAAAAATACAAAAAATTAGTGGCCAGGCACGGCAGCTCACGCCTGTAATTCCAGCACTTTGGGAGGCCGAGGCGGGCAGATCACGAGGTCAGAAGATTGAGACCATCCTGGCTAACACGGTGGAACCCCATCTCTACTAAAAATACAAAAAATTAGCTGGGCATGGTGGCTGGTGCCTGTAGTCCCAGCTACTCGGGAGGCTGAGGCAGGAGACTGGCATGAACCCGGGAGGCGGAGCTTGCAGCAAGCCAAGATCGTGCCACTGCACTCCACTCCATCCTGGGCGACAGAGCAAGACTCCGCTTCAAAAAAAAAAAAATTAACCGGGCAAGGTGGCAGGTGCCTGTAATCCCAGCTACTTGGGAGGCTGAGGCAGGAGAATTGCTTGCAGAGGTTGAAGTGAGCCGAGATTACGCCATTGCACTCCAGCCCAAGTGACAAGAGTGAAACTCCATCTCAAAAAAAAAAAAAAAAAAAAGAAAAAAA","GGCCAGGTATGGTGGCTCACACCTGTAATCCCAGCACTTTGGGAGGCCAAGGCAGGCAGACCACCTGAGGTCAGGAGTTCGAGATCAGCCTAGCCAACATGGTGAAACCCCATCTCTAGTAAAAATAAAATTAGCCAGGCATGGTGGTGCATGCCTGTAACGCAGGTCAGGAGTTCGAGATCAGCTTAGCCAACATGGTGAAACCCCATCTCTAGTAAAAATAAAATTAGCCAGGCAGGTGGTGCCGCCTGTACTCGGGAGGCTGAGGCAGGAGAATCACTTGAACCCAAGAGGCAGAGGTTGCAGTCAGCCAAGATCATGCCATTGCACTCCAGCCTAAGCAAAAAGAGTAAAACTCAGTCTCAAAACAAAAAAACAAAAAAA"
"chr17","75365782","75366409","JH378153","2355361","2355755","282","73010421","CCAGGCGTGGTGGCTCATGCCGGTAATCCCAGCACTTTGGGAGGCCAAGGCAGGTGGATCATCTGAGGTCAGGAGTTCGAGACCAGCCTGACCAACATGGTGAAACCTCACCTCTACTAAAAATACAAAAACTAGACAGGCGTGGTGGCGGGTGCCTGTAGTCCCAGCTACTTGGGAGGCTGAGGCAGAAAAATCGCTTGAACCCAGTAGGCAGAGGTTGCAGTGAGCCGAGATCACACCATTGCACTCCAGCCTGGGCAAAAAAGAGCGAAACTCCATCTCAGAAGAAAAGACCGGGTGCAGTGGCTCATGCTTGTAACCCCAGCACTTTGGGAGGCCAAGGCGGGTGGATCACGAGGTCAGAAGATCGAGACCATCCTGGCTAACACGGTGAAACCCCGTCTCTACTAAAAATACAAAAAAAAAAAAATAATTAGCCGAGTGTGGTGGCGGATGCCTGTAGTCCCAGCTACTCGGGAGGCTGAGGCAGGAGAATGGCGTGAACCCAGGAGGCGTAGCTTGCAGTGAGCCGAGATCACGCCACTGCACTCCAGCCTGGGCGACAGAGCAAGACTCGTCTTAAAAAAAAAAAAAAAAAGAAAAAGTAAAAGAAAAGAAAAAGCAACAA","GGCGGGGCATGGTGGCTCACACCTGTCATCCCAACACTTTGGGAGGCTGAGGCAGGCAGATCACCTGAGGTCAGGAGTTTGAGACCAGCCTGGCCAACATGGTGAAACCCCATCTCTACTAAAAATACAAAAATACAAAAAACCCCATCTCTACTAAAAATACAAAAAGCTTGTCTCTATTAAAAATACAAAAAACAAAAAACAAACAAAAAAAAAACCACCATGGTGGTGGGTGCCTATAATCCCAGCTACTCGGGAGGCTGAGGCAGGAGAATCGCTTGAACCCAGGAGGCAGAGGTTGCAGTGAGCCAAGATCCCACCATTGCACTCCAGCCTGGGCAACAGAGAGAGAGACTCTGCCTCAGAAAAAAGAAAGAAAGAAAGAAAGAAAGAAA"
"chr18","19875","20142","JH378153","8929988","8930242","54","8910113","TTGGGAGGCTGAGGTGGGTGGATCATCTGAGGTCAGGAGTTAAGACCAGCCTGGCCAACATGGTGAAACCCCATCTCTACTAAAAATACAAAAACAAAACAAAACAAAACAAAAAAAACCAGCATGGTGGCAGACACCTGTAATCCCAGCTACTCGGGAGACTGAGGCAGGAGAATCACTTGAACCTGGGAGGCGGAGGTTACAGTGAGCCAAGATCTTGTCATGTCACTCCAGCCCAGGCAACAAGAGCAAAACTGTCTTAAAAAAA","TTTGAGAGGCTGAGGTGGGTGGATCACCTAGGTCAGGAGTTTGAGACCAGCCTGACCAACATGGTGAAACCTCATCTCTACTAAAAATAAAAATAAAAAACTAGCCAGGTGCAATGGTGCATGCCTGTAATCCCAGCTACTTGGGAGGCTGAGATGGGAGACTCACTTGAACCTGGGAGGTGGAGGTTGCAGTGAGCCAAGATCATACCATTGCACTCCAGCCTGGGCAACAAGAGTGAAACCTCTTCTCAAAAA"
"chr18","4520498","4521101","JH378118","18053084","18053501","246","13532586","GGCTGGGCGCAGTGGCCCACCCCTGTAATCCCAGCACTTTGGGAGGCCGAGGCGGGTAGATCACCTGACGTCAGGAGTTCAAGACCAGCCTGGCCAACATGGTGAAACCCTGTCTCTACTAAAATACAAAAATTAGGCTGGGCGCAGTGGCTCAAGCCTGTAATCCAGCACTTTGGGAGGCCAAGGCGGGCAGATCACCTGAGGTCAGGAGTTCGAGACTAGCCTGGCCAACCTGGCAAAACCCCATCTCTACTAAAAGTACGAAAATTAGCCAGGGTGATGGTGTGCACCTGTAATCCTAGGTACTCAGGAGGCTGAGGGCAAGAGAATCGCTTGAACCTGGGAGGCAGAGGTTGTAGTGGGCCAAGATCGCGCCATTGCACTGCAGCCTCGGTGACAGAGAAAGACTCCGTCTCAAAAAAAAAAAAAAACAAAAATTAGCTGGGCGTGGTGGTGGGCGTCTGTAGTCCCATCTACACGGGAGGCTGAGGCAGAAGAATCACTTAAACCCAGGATGTGGAGGTTGCAGTGAGCTGAGATCACGCCATTGCACTCCAGACTGGGTAACAAGAGCAAAACTCCATCTCAAATAAATAAAATAAAA","GGCTGGGCGCAGTGGCTCACACCTGTAATCCCAGCACTTAGGGAAGCTGAGGCGAGTAGATCACCTGAGGTCAGGAGTTAGAGACCAGCCTGGCCATCATGGTGAAACCCCGTCTCTACTAAAGATACCAAAAATTAGCTGAGTGTGGTGCTGGGTGCCTGTAATCCCAGAAACTCAGGGTGCCTGTAATCCCAGCAACTCAGGGTGCCTTTAATCCCAGCAACTGAGGGTACCAGTAATCCCAGCAACTCAGGGTGTCTTTAATCCTAGCAACTGAGGGCACCTGTAATCCCAGCAACTCAGGAAGCTGAGACAGGAGAAGTACTTGAACCCAGAAGGCAGAGGTTGCAGTGAGCCGATATTGCACCATTGCACTCCAGTCTGGGCAACAAGAGTGAAACTCTGTCTCAAAAAAAAA"
"chr18","8281535","8282152","JH378118","18053084","18053501","271","9771549","GGCCAGGTGCGATAGCTCACACTGGTAATCCCAACACTTTGGGAGGCCGAGGTGGGCGGATCACCTGAGGCCAGGAGTTTGAGACCAGCCTGGCCAACACAGTGAAACCCCATCTCTACTAAAAATACAAAATTAGGCAGGGTGCAGTGGCTCACGCCTGTAATACCAGCACTTTGGGAGGCCGAGACAGGCGGATTACGAGGTCAGGAGATCGAGACCATCCTAGCTAACACAGTGAAACCCCGTCTCTACTAAAAAAAAAAAAAAAAAAAAAAGTACAAAAAAATTAGCCAGGCGTGGCGGCAGGTGCCTGTAGTCCCAGCTACTCAGGAGACTGAGGCAGGAGAATGGCGTGAACCCGGGAGGCGGAGCTTGCAGTGAACTGAGATCACACCACTGCACTCCAGCCTGGGCAACAGAGTGAGACTCCGTCTCAAAAACAAAACAAAATTAGCCGGGCATGGTGGTGGATGCCCGTAATCCCAGCTACTCGGGAGGCTGAGGCCGCCAAGGCAGGAGAATCTCTTGAATGTGGGAGGCAAAGGCTGCAGTGAGCTGAGATCATGCCATTGCACTGTAGCCTGGGCGACAAAAGTGAGACTCCGTCTCAAAAAAAAA","GGCTGGGCGCAGTGGCTCACACCTGTAATCCCAGCACTTAGGGAAGCTGAGGCGAGTAGATCACCTGAGGTCAGGAGTTAGAGACCAGCCTGGCCATCATGGTGAAACCCCGTCTCTACTAAAGATACCAAAAATTAGCTGAGTGTGGTGCTGGGTGCCTGTAATCCCAGAAACTCAGGGTGCCTGTAATCCCAGCAACTCAGGGTGCCTTTAATCCCAGCAACTGAGGGTACCAGTAATCCCAGCAACTCAGGGTGTCTTTAATCCTAGCAACTGAGGGCACCTGTAATCCCAGCAACTCAGGAAGCTGAGACAGGAGAAGTACTTGAACCCAGAAGGCAGAGGTTGCAGTGAGCCGATATTGCACCATTGCACTCCAGTCTGGGCAACAAGAGTGAAACTCTGTCTCAAAAAAAAA"
"chr18","14964693","14965321","JH378118","18053084","18053501","273","3088391","GGCTGGGTGCGGTGGCTCACACCTGTAATCCCAGCACTTTGGGAGGCTGAGGCAGGCGGATCACCTGAGGTCAGGAGTTCAGGACCAGCCTGATCAACATAGCGAAACCCTGTCTCTATTAAAAATATAAAAATTGCTGGGTGCGGTGGCTCACGCCTGTAATCCCAGCACTTTGGGAAGCCGAGGCGGGCGGATCATGAGCTCAGGAGATCGAGACCATCTTGGCTAACATGGTGAAACCCTGTCTCTACTAAAAATACAAAAAAATTAGCCAGGTGTGGTGGCGGGCGCCTGTAGTCCCAGCTACTCTGGAGGCTGAGGCAGGAGAATCACTTGAACCTGGGAGGCGGAGGTTGCGGTGAGCCAAGATGGTGCCATTGCACTCCAGCCTGGGCAACAAGAGTGAAACTCCATCTCAAAAAAAAAGAAAAAAAAAAAAAAAAACAACCCACAAAAATTAGCCAGGTGTGATGGCGGGTGTCTGTAATCCCAGCTACTTGGGAGACTGAGGCAGGAGAATGGCTTGAACCCGGGAGGTGGAGGTTGCAGTAAGCCGAGATTGCGCCACTGCACTCCAGCCTGGGTGACCAGAGTGAAACTTCATCTCAAAAAAAAAAAAAAAAAAAAAA","GGCTGGGCGCAGTGGCTCACACCTGTAATCCCAGCACTTAGGGAAGCTGAGGCGAGTAGATCACCTGAGGTCAGGAGTTAGAGACCAGCCTGGCCATCATGGTGAAACCCCGTCTCTACTAAAGATACCAAAAATTAGCTGAGTGTGGTGCTGGGTGCCTGTAATCCCAGAAACTCAGGGTGCCTGTAATCCCAGCAACTCAGGGTGCCTTTAATCCCAGCAACTGAGGGTACCAGTAATCCCAGCAACTCAGGGTGTCTTTAATCCTAGCAACTGAGGGCACCTGTAATCCCAGCAACTCAGGAAGCTGAGACAGGAGAAGTACTTGAACCCAGAAGGCAGAGGTTGCAGTGAGCCGATATTGCACCATTGCACTCCAGTCTGGGCAACAAGAGTGAAACTCTGTCTCAAAAAAAAA"
"chr18","15291276","15291680","JH378105","31074364","31074738","116","15783088","CTCGTGCCTGTAATCCTAGCACTTTGGGAGGCCAAGGTGGGCAGATCATCTGAGGTCAGGAGTTCGAGACCAGCCTGGCCAACATAGAGAAATCCCATCTCTACTAAAAATACAAAAATTGACGAGTTAATGGGTGCAGCACACGAACATGGCACATGTATACATATGTAACAAACCTGCACGTTGTGCACATGTACCCTAAAACTTAAAGTATATTTAAAAAAAATACAAAAATTAGCCGGGCATGGTAGCAGGCACCTGTAATCCCAGCTACTCGGGAGGCTGAGGCAGGAGAATCACTTGAACCTGGGAGGCAGAGGTTGCAGTGAGCTAAGATCATTCCATTGTACTCCAACCTGGGCAACAAGAGTGAAATTCCGTCTAATAAAAAATGAAATAAATAAA","GGCCGGGCACAGTGGCTCACACCTGTAAACCCAGCACTTTGGGAGAATGAGGTGGGCAGATGACTTCAGGTCAGGAGTTCGAGACCAGCCTGGCCAACACTGTGAAATCCCATCTCTACTAAAAATACAAAAATTAGCCATGGTGGTCAGAAGATCAAGACTATCCTGGCCAACATGGTGAAACCTTGTCTCTACTGAAAATAGAAAAATTAGCTGGGTATGGTGGCATGCGCCTGTAGTCCCAGATACTCAGGAGGCTGGGGCAGGAGAATCACTTGAACCCAGGAGGCAGAGGTTGCAGTGAGCTGAGATCATGCCATTGCACTCTAGATTAGGCAACAAGAGTGAAACTGTCTCAAAAAGAGAGAGAGAAAA"
"chr18","15802064","15802689","JH378153","2355361","2355755","270","13446703","GACCGGGCATGGTGGCTCACACCTGTAATCCCAGCACTTTGGGAGGCGTAGGCGAGTGGCCCCTGAGGTCAGGAGATCGAGACAACCCTGGCCAACATGGTGAAACTCTACTAAAAATACAAAATTAGGCCGGGTGCCGTGGTTCACGCCTATAATCCCAGCACTTTGGGAGGTCAAGGTGGGCAGATCACCTGAGGTCAGGAGTTTGAGACCAGCCTGGCCAACATGGTGAAACCCAGTCTCTACTAAAAATACAAAAATTAGCTGGGCATGGTGGTGGACACTTGTAATCCCAGCTACTTGGGGGGCTGAGGCAGGAGAATCACTTGAACCCAGGAGGCAGAGGTTGCAGTGAGCCTAAATCACCCCATTGCACTCCAGCCTGGGCAACAAGAGTGAAATTCTGTCTCGAAAAAAAAAAAAAAAGAAAAGAAAAGAAAAAAAAATTAGCCAGGTGTGGTGCTGCATGCCTGTAATCCCAGCTACTCAGGAGGCTGAGGCAGGAGAATCGCTTGAACCCGGGAGGCAGAGGTTGCAGTGAGCTGAGACCACACCATTGCACTCCAGCCTGGGCGACAAGAGAGTAACTCCATTTCAAAAAAAAAAAAAAAAAAAAGAAAAAAGAA","GGCGGGGCATGGTGGCTCACACCTGTCATCCCAACACTTTGGGAGGCTGAGGCAGGCAGATCACCTGAGGTCAGGAGTTTGAGACCAGCCTGGCCAACATGGTGAAACCCCATCTCTACTAAAAATACAAAAATACAAAAAACCCCATCTCTACTAAAAATACAAAAAGCTTGTCTCTATTAAAAATACAAAAAACAAAAAACAAACAAAAAAAAAACCACCATGGTGGTGGGTGCCTATAATCCCAGCTACTCGGGAGGCTGAGGCAGGAGAATCGCTTGAACCCAGGAGGCAGAGGTTGCAGTGAGCCAAGATCCCACCATTGCACTCCAGCCTGGGCAACAGAGAGAGAGACTCTGCCTCAGAAAAAAGAAAGAAAGAAAGAAAGAAAGAAA"
"chr18","15849226","15849860","JH378118","18053084","18053501","290","2203858","GGCCAGGCACAGTAGCTTACGCCTATAATCTCAGCACCCTAGGAGGCCGAGGCTGGCAGACCACCTGAGGTCACGAGTTCAAGACTAGCCTGGTCAACATAGCAAAACCCCATCTCTACTAAAAATACAAAAATTAGGCTGGGCACAGTGGCTCATGCTTGTAATCCCAGCACTTTGGGAGGCCAAGTCGGGAGAATCACCTGAGGTTGGGAGTTCGAGATCAGCCTGACCAACATAGAGAAACTCCATCTCTACTAAAAATGCAAAATTAGCTAGGCATGGTGGTGCATGCCTGTAATCCCAGCTACTCGTAAGGCTGAGGCAGGAGTATCGCTTGAATCTGGGAGGTGGAGGTTGCGGTGAGCCAAGATCACGCCATCGTACTCCAGCCTGGGCAACAAGAGCGAAACTCCATCTCAAAACAAAAAAAATGAGCCAGGAGTGGTGGCGGGCGCCTATAATTCCAGCTACTCCAGAGGCTGAGGCAGGAGAATCACTTAAACCCGGGAAGCAGAGGTTGCAGTGAGCTGAGATTGTGCCATTGCACCCCAGCCTAGGTGAAAAGAGCAAAACTCCATCTCAAAAAAAAAAAAAAAAAAAAAAAAAAAGAAAGAAAGAAAGAAAAAGAAAAAAAA","GGCTGGGCGCAGTGGCTCACACCTGTAATCCCAGCACTTAGGGAAGCTGAGGCGAGTAGATCACCTGAGGTCAGGAGTTAGAGACCAGCCTGGCCATCATGGTGAAACCCCGTCTCTACTAAAGATACCAAAAATTAGCTGAGTGTGGTGCTGGGTGCCTGTAATCCCAGAAACTCAGGGTGCCTGTAATCCCAGCAACTCAGGGTGCCTTTAATCCCAGCAACTGAGGGTACCAGTAATCCCAGCAACTCAGGGTGTCTTTAATCCTAGCAACTGAGGGCACCTGTAATCCCAGCAACTCAGGAAGCTGAGACAGGAGAAGTACTTGAACCCAGAAGGCAGAGGTTGCAGTGAGCCGATATTGCACCATTGCACTCCAGTCTGGGCAACAAGAGTGAAACTCTGTCTCAAAAAAAAA"
"chr18","16042035","16042617","JH378118","18053084","18053501","243","2011049","GGCTATGCACGGTGGCTCACGCCTGTAATCCCAGCACTTTGGGAGGCCGAGTCAGGTGGATCACTTGAGGTCAGGAGTTCGAGACCAGCCTGGCCAACATGGTGAAGCCCCATCTCCACTAGAAATACAAAAATTAGTCTGGGAGCAGTGGCTTACACCTGTAATTGCAGCACTTTGGGAGGCCAAGGTGGGTGGATCACCTGAGGTCAGGAGTTTGAGACCAGCATGACCAACATGGTGAAACTCCATCTATACAAAAAAATTAGCCGGGTGTGGTGGCGCATGCCTGTAATCCCAGCTACTCAGGAGACTGAGGCAGGAGAATTGCTTGAACCCGGGAGGCAGAGGTTGCAGTGAGCCAAGTCTGTGCCATTGCACTCCAACCTGGGCAACAAAAGCGAAACTCTGTCTCAAAAATAAACAACAAAAAAAATTAGCCAGGTGTGGTGGCACATGCCTATAATCCCAGCTACTCGGGAGGCTGAGGCAGAAGAATTGCTTGAACCTGGGAGGTGGAGGTTGCAGTGAGCCGAGATCATGCCATTCTACTCCAGCCTGGGCCACAAGAGCGAAACTCTGTCTC","GGCTGGGCGCAGTGGCTCACACCTGTAATCCCAGCACTTAGGGAAGCTGAGGCGAGTAGATCACCTGAGGTCAGGAGTTAGAGACCAGCCTGGCCATCATGGTGAAACCCCGTCTCTACTAAAGATACCAAAAATTAGCTGAGTGTGGTGCTGGGTGCCTGTAATCCCAGAAACTCAGGGTGCCTGTAATCCCAGCAACTCAGGGTGCCTTTAATCCCAGCAACTGAGGGTACCAGTAATCCCAGCAACTCAGGGTGTCTTTAATCCTAGCAACTGAGGGCACCTGTAATCCCAGCAACTCAGGAAGCTGAGACAGGAGAAGTACTTGAACCCAGAAGGCAGAGGTTGCAGTGAGCCGATATTGCACCATTGCACTCCAGTCTGGGCAACAAGAGTGAAACTCTGTCTCAAAAAAAAA"
"chr18","25849088","25849351","JH378114","20445944","20446195","60","5403144","GGGAAGATGAGGCGGGTGGATCACTTGAGGTCAGGAGTTCGAGACCAGCCTGGCCAACATGGTGACACCCTGTCTCCAAAAAATACACACACACACACACACACACACACACACACAAATTAGCTGGGCATGGTGGCGGGCACCTGTAATCCTAGCTACTCGAGAGGCTGCGGCAGGAGAATTGCTTTAACTTGGGAGGTAGAGGTTGCAGAGAGCCGAGATTGCACCATTGTACTCCAGCCTGGGTGACAAGAGCGAAACTCC","TTGGGAGGCCAAGGCGGGTGGATCACCTGAGGTCAGGAGTTCGAGACCAGCCTGGCCAACATGATAAAACCCCCGTATCTAATAAAAATAGGAAAAAAAAATAAATAAATAGCTGGGCGTTGTGGCAGGTGCCTGTAATCCCAGCTACTCGGGAGGCTCAGGCAGGAGAATCGCTTGAACCCAGGAGGCAGAGGTTGCAGTGAGCCAAAATTGTGCCATTGCACTCCCGCCTGGGAAACAAGAGCAAAACTC"
"chr18","38083500","38083832","JH378152","15993594","15993909","55","22089906","GGCTGGGTGCGGTGGCTCACGCCTGTAATCCCAGCACTTTGGGAAGCCAAGTCAGGTGACCTCACCTGAGGTCAGGAGTCCAAGACCAGCCTGACCAACATGGTGAAACCTCGTCTCTACTAAAAAGACAAAAAATTAGCCAGGCATGGTGGTGGGCACCTGTAATCTCAGCTACTCTGGAGGCTGAGGCAGGAGAATCACTTGAACCCTGGAGGGGGAGGTTGCAGTGAACCAAGATTGCACCATTGCAGTCCAGCCTGGGCGACAAGAGCAAAACTCCATCTCACAAACACACACACACACACACACACACACACACACAGAAAAAAAAAA","GGCTGGGTGTGGTGGCTCATGCCGGTAATCCCAGCACTTTGGGAAGCGGAGGCAGGCAGATCACCTGAGGTCAGGAGTTCAAGACCAACCTGGCCAACATGGAGAAACCATGTCTCTACTAAAAATACAAAAAATTAGCCAGGCATGGTGGGTGCCTGTAATCCCCACTACTCGGGAGGCTGAGGCAGGAGAATTTCTTGAACCCAGGAGGTGGAGGTTTCAGTGAAGCGGAGATCACCCCATTGCACTCCAGCCTGGGTGACAAGAGCAAAACTCCATCTCACAAAATCAACAACAACAACTTAAAAAAAAAAAA"
"chr18","44076326","44076933","JH378118","18053084","18053501","257","26023242","GCTGGGCGCGGTGGCTTGCGCCTGTAATCCCAGCCATTTGGGAGGCCGAGGCAGGTGGATCACCTGAGGTTAGGAGTTCAAAACCAGCCTGGCCAACATGGTGAAACCCCGTCTCTACTAAAAATACAAAAATTAGGCCAGGCACAGTGGCTCACGCCTGTCATCCCAGCACTTTGGGAGGCCAAGGCGGGCGGATCATGAGGTCAGGAGATTGAGACCATCCTGGCTAACACAGTGAAACCCTGTCTCTACTAAAAAAATATATAAAAAATTAGCCGGGCTTGGTGGCGGGTGCCCGTAATCCCAGCTACTCGGGAGGCTGAGGCAGGAGAATGGCGTGAACCTGGAAGGCGGAGCTTGCAGTGAGCCGAGATTGCACCACTGCACTCCAGCCTGGGTGACAGAGTGAGACTCTGTCTCAAAAAAAAAAAAAAAACAAAAAACAAAAATTAGTTGGGTGTGGTGGTGGACGCCTGTAATCCCGGCTACTCGGGAGGCTGAGGCAGGAAAATCACTTCAACCCGGGAGGCAGAGGTTGCCGTGAGCCAAGATCGTGCCATTGCACTCCAGCCTGGGTGACAAGAGCAAAACTCTGTCTCAAAAAAAAA","GGCTGGGCGCAGTGGCTCACACCTGTAATCCCAGCACTTAGGGAAGCTGAGGCGAGTAGATCACCTGAGGTCAGGAGTTAGAGACCAGCCTGGCCATCATGGTGAAACCCCGTCTCTACTAAAGATACCAAAAATTAGCTGAGTGTGGTGCTGGGTGCCTGTAATCCCAGAAACTCAGGGTGCCTGTAATCCCAGCAACTCAGGGTGCCTTTAATCCCAGCAACTGAGGGTACCAGTAATCCCAGCAACTCAGGGTGTCTTTAATCCTAGCAACTGAGGGCACCTGTAATCCCAGCAACTCAGGAAGCTGAGACAGGAGAAGTACTTGAACCCAGAAGGCAGAGGTTGCAGTGAGCCGATATTGCACCATTGCACTCCAGTCTGGGCAACAAGAGTGAAACTCTGTCTCAAAAAAAAA"
"chr18","44546829","44547449","JH378118","18053084","18053501","262","26493745","GGCCAGGCACGGTCGCTCACACCTGTAATTCCAGCACTTTGGGAGGCCAAGGCGGATGGGTCACCTGAGGTCAGGAGTTTGAGACCAGCCTGACCAATATGATGAAACCCCATCTCTATTAAAAATACAAAAATTAGGCTGGGCGCAGTGGTTCATGCCTGTAATTCCAACACTTTGGGAGGCCGAGACGGGCGGACCATGAGGTCAGGAGATCGAGACCATCCTGGCCAACGTGGTGAAACCCCGTGTCTACTAAAATACAAAAAAAATTAGCCAGGTGTGGTGGCACGTGCCTGTAGTCCCAGCTATTAGGGAGGCTGAGGCAGGGGAATCACTTGAACCTGGGAGGTGGAGGTTGCAGTGAGCTGAGATCTTGCCACTACACTCCATTCTGGGCAACAGAGCAAGACTCCGTCTGAAAAAAAACAAAAAAATACAAAAATTAGCTGGGCATGGTGGCGGGTACCTGTAATCCCAGCTACTTGGGAGGCTGAGACAGGAGAATCACTTGAACTCGGGAGGCAGAGGTTGCAGTGAGCCAAGATCGCACCATTGCATTCCAGCCTGGGCAACAAGAGCGAAACTCCATCTCAAAAAAACAAAAAAAAAAAAAAAGAAAAA","GGCTGGGCGCAGTGGCTCACACCTGTAATCCCAGCACTTAGGGAAGCTGAGGCGAGTAGATCACCTGAGGTCAGGAGTTAGAGACCAGCCTGGCCATCATGGTGAAACCCCGTCTCTACTAAAGATACCAAAAATTAGCTGAGTGTGGTGCTGGGTGCCTGTAATCCCAGAAACTCAGGGTGCCTGTAATCCCAGCAACTCAGGGTGCCTTTAATCCCAGCAACTGAGGGTACCAGTAATCCCAGCAACTCAGGGTGTCTTTAATCCTAGCAACTGAGGGCACCTGTAATCCCAGCAACTCAGGAAGCTGAGACAGGAGAAGTACTTGAACCCAGAAGGCAGAGGTTGCAGTGAGCCGATATTGCACCATTGCACTCCAGTCTGGGCAACAAGAGTGAAACTCTGTCTCAAAAAAAAA"
"chr18","45772849","45773450","JH378118","18053084","18053501","269","27719765","CACGCCTATAATCCCAGCACTTTAGGAGGCTGAGGCAGGTGGATCACCTGAGATCAGGAGTTCAAAACCAGCCTGGCCAACATGGTGAAACCCTGTGTCTACTACAAATACAAAAAAATGGGCAGGGTGTGGTGGCTCACACCTGTAATCCCAGCACTTAGGGAGGCCGAGGCGGGTGGATCATGAGGTCAAGAGATCAAGACCATCCTGGCCAACATGGTAAAACCCCGCCTCTACTAAAAATATAAAAATTAGCTGGGCAAGGTGGTGCGCGCCTGTAGTCCCAGCTATTTGGGAGGCTGAGGCAGGAGAATTGCTTGAACCTGGGAGGTGGAGGTTGCAGTGAGCCAAAATCGCGCCACTGCACTCCAGCCTGGCAACAGAGTGAGACTCTGTCTCAAAAAAAAACAAAAACAAAACAAAACAGAAACCAAAATTAGCTGGGCGTGGTGGCGGGCGCCTGTAGTCCCAGCTACTTGGGAGGCTGAGGCAGGAGAATCGCATGAACCCAGGAGGCGGAGGTTGCAGTGAGCCAAGACTGCACTATTGCACTCCAGTCTGGGCTACAAGAGCGAACTCCGTCTCAAAAAAAAAAAAAAAAA","GGCTGGGCGCAGTGGCTCACACCTGTAATCCCAGCACTTAGGGAAGCTGAGGCGAGTAGATCACCTGAGGTCAGGAGTTAGAGACCAGCCTGGCCATCATGGTGAAACCCCGTCTCTACTAAAGATACCAAAAATTAGCTGAGTGTGGTGCTGGGTGCCTGTAATCCCAGAAACTCAGGGTGCCTGTAATCCCAGCAACTCAGGGTGCCTTTAATCCCAGCAACTGAGGGTACCAGTAATCCCAGCAACTCAGGGTGTCTTTAATCCTAGCAACTGAGGGCACCTGTAATCCCAGCAACTCAGGAAGCTGAGACAGGAGAAGTACTTGAACCCAGAAGGCAGAGGTTGCAGTGAGCCGATATTGCACCATTGCACTCCAGTCTGGGCAACAAGAGTGAAACTCTGTCTCAAAAAAAAA"
"chr18","50079974","50080314","JH378127","6796468","6796795","54","43283506","GGTCTGGCGCCAGTGGCTCATGCCTGTAATCCCAGCACTTTGGGAGGCTGAGGCGGGTGTATCACCTGAGGTCAGGAGTTCGAGACCAGCCTGGCCAACATGGCAAAACCCCGTCTCTACGAAAAATACAAAAAAATTAGCCGGGCGTGGTAGCAGTCGCCTGTAATCCCAGCAACTTGGGAAGCTGAGGCAGAAGAATCGCTTAAACCTAGGAGGCGGAGGTTGCAGTGAGCCAAGATTGCGCCATTGCACTCCAGCCTGGTCAACAAGAGCAAAACTCTGTCTCAAAACAACAACAACAACAACAACAACAACAAACAAAAACCAAAAAAACCAAAAAA","GGCCGGGCGCGGTGGCTCAAGCCTGTAATCCCAGCATTTTGGGAGGCCGAGGCGGGTGGATCACGAGGTCAGGAAATCGAGACCATCCTGGTCAACATGGCGAAACCCCATGTCTACTAAAAATACAAAAATTAGCTGGGCATGGTGGCACGTGCCTGTAATCCCAGCTACTCAGGAGGCTGAGGCAGGAGAATTGCCTGAACCCAGGAGGCGGAGCTTGCAGTGAGCCGAGATCGCGCCATTGCACTCCAGCCTGGGTAACAAGAGCGAAACTCCGTCTCAAAAAAACAAACAAAAACAAAACAAAACAAAACAAAACAAAAAAAAC"
"chr18","53653883","53654201","AGCE01149660","956","1264","46","53652927","GGCCAGGCATGGTGGCTCACGTTTGTAATCCTAGCACTTTGGGAGGCTGTAGCGGGCGGATCACCTGAGGTCAGGAGTTTGAGACCAGCCTGGCCAACATGGTGAAACCCTGTCTCTACTAAAAAAAAAAAAAAAAAAAAAAAAAAAATTAGCCAGGTGTGGTGGTGGTGGATGCCTATAATCCCAGCTACTCGGGAGGCTGAGGCAGGAGAATCACTTGAACCTGGGAAGCAGAGGTTGCAATGAGCTGAGATTGAGCCATTGCACTCCAGCCTGGACAACAAGAATGAGACTCTGTCTCAATAAATAAGTAAATAAA","GGCCAGGCACGGTGGCTCATGCCTATAATCCCAGCACTTTGGGAGGCTGCGATGGGTGGTTCACTTGAGGTCTGGAGTTTGAGACCAGCCTGGCCAACATGGAGAAACCCTTTCTCTACTAAAAATACAAAAAAAAAAAAAAAAAAAATTAGCCAGGCATGGTGGCGGGTGCCTGTAATCCCAGCTACTCAGCAGGCTGAGGGAAGAGAATCACTTGAACCGGGGAGGCAGAGGTTGCAGTGAGCTGAGATGATGCCATTGCACTCCAGCCTGGGCAACAAGAGCAAAACTGTCTCAAAAAAAAAAAAA"
"chr18","53971096","53971710","JH378118","18053084","18053501","262","35918012","GGTCGGGTGTGGTGGCTCATGCCTATAATCCCAGCACTTTGGGAGGCTGAGGCAGGCAGATTACCTGAGGTCAGGAGTTCGAGACCAGCCTGGCCAACATGATGAAACCTTGTCTCTACTAAAAATACAAAAATTAGGCCGGGCACGGTGGCTCATGCCTGTAATCCCAGCACTTTGGGAGGCCGAGGCGGGTAGATCACAAGGTCAGAAGTTCAAGACCAGCCTGGCCAACATGGTGAAACTCTGTCTTTACTAAAAATACAAAAATTAGCTAGGCATGGTGGCGCACACCTATAATCCCAGCTACTGGGGAGGCTGAGGCAGGAGAATTGCTTGAACCAGGACCCGGGAGGTGGAGGTTGCTGTGAGCCGAGATTGCGCCACTGCACTCCAGCCTGGGAGACAGAGTGAGACTCCGTCTAAAAAAAAAAAAAAAAAATTAGCCAGGTGTGGTGGCGCATGCCTGTAATCCCAGCTACTCGGGAGGCTGACGCAGAAGAATCATTTGAACGTGGGAGGCAGAGGTTACAATGAGCTGAGATCACACCATTGTACTCCAGCCTGGGCAACAAGAGCAAACTCAATCTCAAAAAAATAAAAATAAAAAAAAAGAAA","GGCTGGGCGCAGTGGCTCACACCTGTAATCCCAGCACTTAGGGAAGCTGAGGCGAGTAGATCACCTGAGGTCAGGAGTTAGAGACCAGCCTGGCCATCATGGTGAAACCCCGTCTCTACTAAAGATACCAAAAATTAGCTGAGTGTGGTGCTGGGTGCCTGTAATCCCAGAAACTCAGGGTGCCTGTAATCCCAGCAACTCAGGGTGCCTTTAATCCCAGCAACTGAGGGTACCAGTAATCCCAGCAACTCAGGGTGTCTTTAATCCTAGCAACTGAGGGCACCTGTAATCCCAGCAACTCAGGAAGCTGAGACAGGAGAAGTACTTGAACCCAGAAGGCAGAGGTTGCAGTGAGCCGATATTGCACCATTGCACTCCAGTCTGGGCAACAAGAGTGAAACTCTGTCTCAAAAAAAAA"
"chr18","57837437","57837748","JH378115","16887097","16887400","43","40950340","GCTGGGCATGGTGGCTCACACCTGTAATCCCAGCACCTTGGGAGGCCGAGGTGGGTAGATCACCTGAGGTCAGGAATTCGAGACCAACCTGGCCAACATGGTGAAACCCCGTCTCTACTAAAAATACAAAAAAAAAAAAAAAAAAAAAAAAAGCTGGGCATGGTGGTGGGTACCTGTAATCCCAGCTACTCAGGAGTCCGAGGCAGGAGAATCGCTTGAACCTGGCAGGTGGAGGTTGCAGTGTGCCAGGATTGTGCCATTGCACTCCAGCCTGGGTGACAAGAGCAAAACTCCAACTCAAAACAAAAACAA","GCCGGGCACGGTGGCTCAAGCCTGTAATCCCAGCACTTTGGGAGGCCGAGGCGGGTGGATCACAAGGTCAAGAGATCGAGACCAACCTGGTCAACATGGTGAAACCCCATCTCTACTAAAAAATACAAAAAAAAAAAAAAAATTAGCTGGGCATGGTGGCGCGTGCCTATAATCCCAGCTACTCAGGAGGCTGAGGCAGGAGAATTGCCTGAACCTAGGAGGTGGAGGTTGCAGTGAGCCAAGATCATGCCATTGCACTCCAGCCTGGGTAACAAGAGCGAAACTCCATCTCAAAAAAAAAAAA"
"chr18","58257354","58257943","JH378118","18053084","18053501","263","40204270","GCCTGTAATCACAGCACTTAGGGGGGCCGAGGCAGGAGGATCACCTGAGGTCAGGAGTTCGAGACCAGCCTGGCCAACATGGTGAAACCCCGTCCCTACTAAAAATACAAAAATTGGCCGGACACATTGGCTCATGCCTGTAATCCCAGCACTTTGGGAGGCCGAGGCGGGTGGATCACCTGAGGTCAGGAGTTCAAGACCAGCCTGACCAACCTGGAGAAACCCTGTTTCTACTAAAAATACAAAATTAGCCAGGCATAGTGGCGCATGCCTGTAATCCCAGCTACTCGAGAGGCTGAGGCAGGAGAATCGCTTGAACCCGGAAGGTGGAGGTTGCGGTGAACCGAGATTGTGCCATTGCACTCCAGCCTGGGCAACAAGAGCAAAACTCCGTCTCAAAAACAAAACAAAACAAAACAAAAATTAACCCGGCGTGGAGGTGGATGCCTGTAATCCCAGCCACTTTGGGAGACTGAGGCAAGAGAATTGCTTGAACCCGGGATGTGGAGGCTGCAGTGACCCGAGATCACGCCATTGCATTCCAGCCTGGCAACAAGAGTAAGACTCCATCTCAAAAACAAGCAAACAAA","GGCTGGGCGCAGTGGCTCACACCTGTAATCCCAGCACTTAGGGAAGCTGAGGCGAGTAGATCACCTGAGGTCAGGAGTTAGAGACCAGCCTGGCCATCATGGTGAAACCCCGTCTCTACTAAAGATACCAAAAATTAGCTGAGTGTGGTGCTGGGTGCCTGTAATCCCAGAAACTCAGGGTGCCTGTAATCCCAGCAACTCAGGGTGCCTTTAATCCCAGCAACTGAGGGTACCAGTAATCCCAGCAACTCAGGGTGTCTTTAATCCTAGCAACTGAGGGCACCTGTAATCCCAGCAACTCAGGAAGCTGAGACAGGAGAAGTACTTGAACCCAGAAGGCAGAGGTTGCAGTGAGCCGATATTGCACCATTGCACTCCAGTCTGGGCAACAAGAGTGAAACTCTGTCTCAAAAAAAAA"
"chr18","59255477","59255805","JH378228","5665092","5665424","52","53590385","GGTTGGGCGCAGTGGCTCACGCCTGTAACCCCAGCACTTTCGGAAGCTGAGGCAGGCGGATCACCTGAGGTCAGGGGTTCGAGACCAGCCCGGACAACGTGATTAAACCCTGCCTCTACTAAAAATACAAAAATTAGCGACTGTGGTGTTGGGCGCCTGTAATCGCAGCTACTTGGGAGGCTGAGGCATGAGAATTGCTTGAACCCAGGAGGCAGAGGTTGCAGTGAGCAGAGATTGCTCCATTGCACTCCAGCCTGGGCAACAAGAGCAGAACTCTGTCTCAAAATAAATAAATAAATAAATAAATAAATAAATAACAGAAAAGAAAA","GGCCGGGCGCGGTGGCTCAAGCCTGTAATCCCAGCACTTTGGGAGGCTGAGGCGGGTGGATCACGAGGTCAAGAGATCGAGACCATCCTGGTCAACATGGTGAAACCCTGTCTCTACTAAAAATACTAAAAATTAGCTGGGCATGGTGGCGTGTGCCTGTAATCCCAGCTACTCAGGAGGCTGAGGCAGGAGAATTGCCTGAACCCAGGAGGCGGAGGTTGCGGTGAGCCGAGATCGCGCCATTGCACTCCAGCCTGGGCAACAAGAGCGAAACTCTGTCTCAAAAAAAAAAAATAAATAAATAAAATAAAATAAAATAAAATAAAATAAAAT"
"chr18","59405673","59406877","JH378118","18053084","18053501","805","41352589","GGCTAGATGCGGTGGCTCATGCCTGTAATCCCAGCACTTTGGGAGGCCAAGGCAGGTGGATCACCTGAGGTCAGGAGTTTGACACCAGCCTGGCCAACATGTTGAAACCCTGTCTCCACTAAAAATACAAAAAAAGATTATCTGGGTTATTGTGGGATCTGGCCAGCAGCCCGCAATGCAATGGGGCTCTCTCTTTGTTCCCAGGCAGATTGGCAGGTTGAGAAATAATAGACACACACAAGATAGTGAAAGTTGGGTCCAGGGGGGTCACCGCCTTCTGGTCCCATGGTGCCAACAATGCACTGGATATACCAGCATTTATTATTAAGTTTAGTGAGGGCGGGGGTAGGTTAGTGAGGGATTTAGGGTCATTTGATTATGAGGTGAGATGGTCACATGGAAATGAAGTAATTCTTTAACGTAACATTTGTATGTAGAAGTACAGTACATTTGTATGTAGAAGTACAGTATACAGAGATAAGAATTTACAATATAGTGTGTGCATCAGTAATTTCTAACAGAGCCTTAAAACAGAAAGACAATCTTTCCATAATCTATGATTAGCAAGATATTAATCAGCAGTAACAATTGCAATGAAAGCTGGTTACAAACAGTCCATGGAAACAGGAGGTGAAGCTAGACAATCGGTTAGACCAGAAATTCTCAGAAGGGAATATGCCTTAACCCTAAAGAGGCCTAGAAGAGCCGTGGCAAGATGAGGGTGTTTATAGCCCTATCTTATCCATATGGACAGGCACCTCCCCATGCGTCCGTTTATAGGCTCTCCATGAGGGTCGCATTCCATTCCCAGAGCTATGAACATCTGCTTTTCTGGGATAGGAATCTTGGTGATGTGAAACCTCCCTGACTACACGTCCATTCATAGGATCTCTGCAGGGGGAAGCACATCACACACTGTTGGCTCGTTCTGGCAGTCCAACCTGGCATTGTGTCTTTACACAATCCTGCATGCAATTTTGTATTTACAATAATCAGGAGCATTTCATCTTTTATTCTGTAGCAATAGTTTCAGGGGGTCTCCCTACACTGGGTGTGGTGACGGGTACCTGTAATCCCAGCTACTCAGGAGGCTGAGGCAGGAGAATCACTTGAGCCTTAGAGGCAGAGGTTGCAGTGAGCTGAGATCAGACCATTGCACTCCAGCCTGGGCAACAAGAGCAAACCTCCGTCTCAAAAAAAAAAAA","GGCTGGGCGCAGTGGCTCACACCTGTAATCCCAGCACTTAGGGAAGCTGAGGCGAGTAGATCACCTGAGGTCAGGAGTTAGAGACCAGCCTGGCCATCATGGTGAAACCCCGTCTCTACTAAAGATACCAAAAATTAGCTGAGTGTGGTGCTGGGTGCCTGTAATCCCAGAAACTCAGGGTGCCTGTAATCCCAGCAACTCAGGGTGCCTTTAATCCCAGCAACTGAGGGTACCAGTAATCCCAGCAACTCAGGGTGTCTTTAATCCTAGCAACTGAGGGCACCTGTAATCCCAGCAACTCAGGAAGCTGAGACAGGAGAAGTACTTGAACCCAGAAGGCAGAGGTTGCAGTGAGCCGATATTGCACCATTGCACTCCAGTCTGGGCAACAAGAGTGAAACTCTGTCTCAAAAAAAAA"
"chr18","71500430","71500770","JH378228","5665092","5665424","54","65835338","GCTGGGTGCGGTGGCTCACGCCTGTAATCACAGCACTTTGGTAAGCCCGAGGCAGGTGGATCACCTGAGGTCAGGAGTTCGAGACCAGCCTGACCAACATGGTGAAACCCTTTCTCTACTAAAAATGCAAAAATTAGCTGGGCGTCATGGCGGGCGTCTGTGATCCCAGCTACTAGGGAGGCTAAGGCAGGAGAATTGCTTGAACCTGGGAGGCGGAGGTTGCAGTGAGCAGAGATTGCACCATTACACTCCAGCCTGGGCAACAAGAGCAAAACTCCATCTCAAAATAAATAAATAACTAAATAAATAAATAAAATGAAATTAAAAAGAAAGAAAGAAAA","GGCCGGGCGCGGTGGCTCAAGCCTGTAATCCCAGCACTTTGGGAGGCTGAGGCGGGTGGATCACGAGGTCAAGAGATCGAGACCATCCTGGTCAACATGGTGAAACCCTGTCTCTACTAAAAATACTAAAAATTAGCTGGGCATGGTGGCGTGTGCCTGTAATCCCAGCTACTCAGGAGGCTGAGGCAGGAGAATTGCCTGAACCCAGGAGGCGGAGGTTGCGGTGAGCCGAGATCGCGCCATTGCACTCCAGCCTGGGCAACAAGAGCGAAACTCTGTCTCAAAAAAAAAAAATAAATAAATAAAATAAAATAAAATAAAATAAAATAAAAT"
"chr19","1465612","1466244","JH378118","18053084","18053501","284","16587472","GGCTGGGGACGGTGGCTCAGGCCTGTAACCCCAGCACTTTGAGAGGACCAGGAGGGAGGATTGCTTGAGCCCAGGAGTCCGAGACCAGCCTGGGCAGCAAAGCAAGGCCCTGTCTCTACAAAAATACTTTAAAATTAGCCAAGTGTTGGCTGGGTGCGGTTGCTCATGCCTATAATCCCAGCACTTTGGGAGGCCGAGGTGGGTGGATCACCTGAGGTCAGGAGTTTGAGACCAGCCTGGCCAACATGGCAAAACCCCGTCTCTACTAAAAATACGAAAATTAGCCAGACGTGGTGGCTCATTCCTGTAATCCCAGCTACTCGGGAGGCTGAGGCAGGAGAATCGCTTGAACTCGCAAGGCGGAGGTTGCAGTGAGCCAAGATCATGCCATTGCATTCCAGCCTGGGTGACAGAGCAAAACTCCGTCTCAAAAAAAAAAAAAAAAAAAAAAAATTAGCCAGGCGTGGTGGTGGGCACCTGTAGTCCCAGCTACCCGGGAGGCTGAGGCAGGAGAATCGCTTGAGCCCGGGAGGCAGAGGTTACAGTGAGCCGAGATCGTGCCATTGCACTCCAGCCTGGGCAACAAGAGTGAAAATCCGTCTCAAAAAAATAAATAAATACAAAATAAAAAAA","GGCTGGGCGCAGTGGCTCACACCTGTAATCCCAGCACTTAGGGAAGCTGAGGCGAGTAGATCACCTGAGGTCAGGAGTTAGAGACCAGCCTGGCCATCATGGTGAAACCCCGTCTCTACTAAAGATACCAAAAATTAGCTGAGTGTGGTGCTGGGTGCCTGTAATCCCAGAAACTCAGGGTGCCTGTAATCCCAGCAACTCAGGGTGCCTTTAATCCCAGCAACTGAGGGTACCAGTAATCCCAGCAACTCAGGGTGTCTTTAATCCTAGCAACTGAGGGCACCTGTAATCCCAGCAACTCAGGAAGCTGAGACAGGAGAAGTACTTGAACCCAGAAGGCAGAGGTTGCAGTGAGCCGATATTGCACCATTGCACTCCAGTCTGGGCAACAAGAGTGAAACTCTGTCTCAAAAAAAAA"
"chr19","1761610","1762212","JH378118","18053084","18053501","248","16291474","GGCCGGGTGCGGTGGTTTACACCTGTAATCCTGGCATTTTGGGAGGCCGAGGCAGGAGTATCACCTCAGGTCAGGAGTTCAAGACCAGCCTGGCCAACATGGTGATACTCCGTCTCTACTAAAAATACAAAAATTGGCCGAGTGCAGTGGCTCACACCTGTAATCCCAGCACTTTGGGAGGCCGAGGCAGGTGGATCATGAGGTCAGGAGTTCGAGACCAGCCTGGCCAAGATGGTGAAACCCCGTCTCTACTAAAAATACAAAAATCAGCTGGGTGTGGTGGCGGGTGCCTGTAATCCCAGCTACTCGGGAGGCTGAGGCAGGAGAATTGCTTGGACCTGGGCAGCAGAGGTTGCAGCGAGCTGAGATGGCGCCACTGCACTCCAGCCTGGGCGACAGAGCGAGACTCTTGTCTCAGAAAAATAAAAAATAAAAAAATTAGCTGGGTGTGGTGGTGCGCACCTGTAATCCCAGCTACTCGGGAGGCTGAGGCAGGAGAATCGCTTGAATCTGGGAGGAGGAGGAGGTTGCAGTGAGCTGAGATAGTGCCAGTGCAGGCCAGCCTGGTCAACAAGAGTGAAACTCCGTCTCAGAAAAAAAAAA","GGCTGGGCGCAGTGGCTCACACCTGTAATCCCAGCACTTAGGGAAGCTGAGGCGAGTAGATCACCTGAGGTCAGGAGTTAGAGACCAGCCTGGCCATCATGGTGAAACCCCGTCTCTACTAAAGATACCAAAAATTAGCTGAGTGTGGTGCTGGGTGCCTGTAATCCCAGAAACTCAGGGTGCCTGTAATCCCAGCAACTCAGGGTGCCTTTAATCCCAGCAACTGAGGGTACCAGTAATCCCAGCAACTCAGGGTGTCTTTAATCCTAGCAACTGAGGGCACCTGTAATCCCAGCAACTCAGGAAGCTGAGACAGGAGAAGTACTTGAACCCAGAAGGCAGAGGTTGCAGTGAGCCGATATTGCACCATTGCACTCCAGTCTGGGCAACAAGAGTGAAACTCTGTCTCAAAAAAAAA"
"chr19","2871458","2872098","JH378118","18053084","18053501","282","15181626","GGCCGGGCGCGGTGGCTCACGCTTGTAATCCCAGCACTTTGGGAGGCCTAGGTAGTGGATCACCTGAGGTCAGGAGTTTGAGACCAGCCTGGCCAACATGGGGAAACCCAGTCTCTACTAAAAATACAAAAATGAGGCCGGGTGCAGTGGCTCATGCCTGTAGTCTCAACACTTTGGGAGACCAAGGCAGGCGGATCACCTGAGGTCAGGAGTTCAAGCCCAACCTGGCCAACATGGTGAAACCCTGCCTCTTCTAAAAATACAAAAATTAGCCAGGTGTGGTGGCATGTACCTGCAATCCCAGCTGCTTAGGAGTTCGAGATAGAAGGATTGCCTGAACCTGGGAGGCGGAGGTTGCAGTGAGCTGAGATCATGCCATTGCACTCCAGCCTGGGTGACAGAGACCCTGTCTCACACACACACACACAAATTATATATATATATATATATATACACACACACACACACGCACACACAAATTGGCCAGGCGTGGTGGCGGGTGCCTATAATTCCAGCTACTTGGGAGGCTGAGGCAGGAGAATGTCTTGAACCCGGGAGGTGGAGGTTGCAGTGAGCCGAGATTGCGCCACTGCACTTTAGCCTGGACGACAAGAACAAAACTCCATCTCAAAAAAACGAAA","GGCTGGGCGCAGTGGCTCACACCTGTAATCCCAGCACTTAGGGAAGCTGAGGCGAGTAGATCACCTGAGGTCAGGAGTTAGAGACCAGCCTGGCCATCATGGTGAAACCCCGTCTCTACTAAAGATACCAAAAATTAGCTGAGTGTGGTGCTGGGTGCCTGTAATCCCAGAAACTCAGGGTGCCTGTAATCCCAGCAACTCAGGGTGCCTTTAATCCCAGCAACTGAGGGTACCAGTAATCCCAGCAACTCAGGGTGTCTTTAATCCTAGCAACTGAGGGCACCTGTAATCCCAGCAACTCAGGAAGCTGAGACAGGAGAAGTACTTGAACCCAGAAGGCAGAGGTTGCAGTGAGCCGATATTGCACCATTGCACTCCAGTCTGGGCAACAAGAGTGAAACTCTGTCTCAAAAAAAAA"
"chr19","2912949","2913566","JH378118","18053084","18053501","268","15140135","GGCTGGGCGTGGTGGCTCACACCTGTAATCCCAGCACTTTGGGAGGCCAAGGTGGAGGGACTGCCTGAAGCCAGGGGTTCGAGACCAGCCTGGCCAACATGGTGAAACCCTGTCTCTACTAAAAATAGAAAAATTAAGGCCGGGCGCGGTGGCTCATGCCTGTAATCCCAGCACTTTGGAAGGCCGAGGCGGGCGGATCACTTGAGGTCGGGAGTTCAAGACCAGCCTGACCAACATGGAGAAACCCTGTCTCTACTAAAAATACAAAATTAGCCAGGGTGGTGGCGCATGCCTGTAATCCCAGCTACTTGGGAGGCTGAGGCAGGAGAATCGCTTGAACCCGGGAGGTGGAGGTTGCAGTGAGCTGAGATCGCACCATTGCACTCCAGCCTGGGCAACAAGAGCAAAACCACGTCTCAAAAAAAATAAAAATAAAAATAAAAAAATTAGCTGGGTGTGGTGGCAGGCGCCTGTAGCTGCTTGGGAGGCTGAGACAGGAGAATTGCTTGAACCTGGGAGGCGGAGGTTGCAGTGAGCTGAGACCGTGCCATTGCACTCCAGGCTGGGCAAGAAGAGCAAAACTCTATCCTTCCCCCACTCCAAAAAAAAAAAAAAAAA","GGCTGGGCGCAGTGGCTCACACCTGTAATCCCAGCACTTAGGGAAGCTGAGGCGAGTAGATCACCTGAGGTCAGGAGTTAGAGACCAGCCTGGCCATCATGGTGAAACCCCGTCTCTACTAAAGATACCAAAAATTAGCTGAGTGTGGTGCTGGGTGCCTGTAATCCCAGAAACTCAGGGTGCCTGTAATCCCAGCAACTCAGGGTGCCTTTAATCCCAGCAACTGAGGGTACCAGTAATCCCAGCAACTCAGGGTGTCTTTAATCCTAGCAACTGAGGGCACCTGTAATCCCAGCAACTCAGGAAGCTGAGACAGGAGAAGTACTTGAACCCAGAAGGCAGAGGTTGCAGTGAGCCGATATTGCACCATTGCACTCCAGTCTGGGCAACAAGAGTGAAACTCTGTCTCAAAAAAAAA"
"chr19","3601333","3601668","JH378148","10302642","10302970","47","6701309","GCTGGGCGTGGTGGCTCACACCTGTAATCCCAGCACTTTGGGAGGCTGAGGTGGGCGGATCACGTGAGGTCAGGAGTTCCAGACTAGCCTGGCCAACATGGGGAAACCCCATCTCTGCTAAAAATAAAAAATTTAGCCGAGTGTGGTGGTGGGTGCCTGTAATCCCAGCTACTCAGGAGGCCGAGGCAGGAGAATTGCTTGAACCCAGGAGGCAGAGGTTGCAGTGAGCCGAGATCACGCCATTGCACTCCAGCCTGGATGACAACAGTGAGACTCCAACTCAAAAAATAATAATAATAATAATAATAATAATAAAATAAAACAATAAAAAAAAAA","GGCCGGGCGCGGTGGCTCAAGCCTGTAATCCCAGCACTTTGGGAGGCCGAGGCGGGTGGATCACGAGGTCAAGAGATCGAGACCATCCTGGTCAACATGGTGAAACCCCGTCTCTACTAAAAATACAAAAAATTAGCTGGGCATGGTGGTGGGTGCCTGTAATCCCAGCTACTCAGGAGGCTGAGGCAGGAGAATTGCCTGAACCCAGGAGGCGGAGGTTGCGGTGAGCCGAGATCGCGCCATTGCACTCCAGCCTGGGTAACAAGAGTGAAACTCTGCCTCAAAAAAAAAAAATAAAATAAAATAAAATAAAATAAAATAAAATAAAA"
"chr19","4440800","4441421","JH378118","18053084","18053501","276","13612284","GGCTGGGTGCGGTGGCTCATGCCTGTAATCCCAGCACTTTGGGAGGCCAAGCGGGCAGATCAACTGAGGTCAGGAGTTCGAGACCAGCCTGGCCAACATAGTAAAACCCTGTTTCTACTAAAAAAAAAAAAAAAAAAAAAAAAAAAATTGGCTGGGCGCAGTGGCTCACGCATGTAATCCCTGCACTTTGGGAGGCCAAGGCAGGTGGATCACCTGAGGTCAGTAGTTTGAGACCAGCCTGACCAACGTGGAGAAACCCCATCTCTACTAAAAATACAAACAAAAAAAACAAAAAACAAAAAAAACCGGGTATGGTGGTACATCCCTGTAATCCCAGCTCCTCGGGAGGCTGAGGCAGGAGAATCACTTGAACCCGGGAGGCGGAGGTTGCACTGAGCCGAGATTGCGCCACTGCACTCCAGCCTGGGCGATAGAGCGAGACTCCCTCTTAAATAATGATTATAATTGCCAGGTGTGGTGGCGGGTGCCTGTAATCCCAGCTACTTGGGAGGCTGAGGCAGGAGAATCGTTTGAATCCAGGAGGAGGAGGTTGCAGTGAGCCGAGATGGTGCCACAGCACTCCAGCCTGGGTGACAAGAGTGAAACCCCATTACAAACAAAA","GGCTGGGCGCAGTGGCTCACACCTGTAATCCCAGCACTTAGGGAAGCTGAGGCGAGTAGATCACCTGAGGTCAGGAGTTAGAGACCAGCCTGGCCATCATGGTGAAACCCCGTCTCTACTAAAGATACCAAAAATTAGCTGAGTGTGGTGCTGGGTGCCTGTAATCCCAGAAACTCAGGGTGCCTGTAATCCCAGCAACTCAGGGTGCCTTTAATCCCAGCAACTGAGGGTACCAGTAATCCCAGCAACTCAGGGTGTCTTTAATCCTAGCAACTGAGGGCACCTGTAATCCCAGCAACTCAGGAAGCTGAGACAGGAGAAGTACTTGAACCCAGAAGGCAGAGGTTGCAGTGAGCCGATATTGCACCATTGCACTCCAGTCTGGGCAACAAGAGTGAAACTCTGTCTCAAAAAAAAA"
"chr19","5462237","5462567","JH378255","1377129","1377437","56","4085108","GACCAGGTGCGGTGGCTCACGCCTGTCATTCCAGCACTTTGGGAGGCCGAGGGGGGCGTGGATCACTTGAGGTCAGGAGTTCAAGACCAGCCTGACCAACATGGTGAAACTCCGTCTCTACTAAAAATACAAAAATTAGCCAGGTGTGGTGGCACATGCCTGTAATCCCAGCTACTTGGGAGGCTGAGGCAGGAGAATCACTTGAACCTGGGAGATGGAGGTTTCATTCAGTGAGCTGAGATTGCACCATTGCACTCCAGCCTGGGTGACAAGAACGAAACTCTGTCTCAGAACACACACACACACACACACACACACACCCCAGAAAAAA","GGCCTGGCGTGGTGGCTCACGCCTGTAATCTCAGCACTTTGGGAGGCCAAGGTGGGTGGATCACCTGAGGTCAGGAGTTCAAGACCAGCCTGGCCAACATGGTGAAACCCCGTCTCTACTAAAAATACAAAAATTAGCTGGGTGTGGTGGCAGACACCTGTAATTCCAGCTACTTGGGAGGCTGAGGCAGGAGAATAGCTTGAACCTGGGAGGTGAGGGTTGCAGTGAGCCGAGATCGCACCATTTTACTCCAACCTGGGCAACAAGAGCGAAACTCCGTCTCAAAATCCAAACAAACCAAAACAAAAA"
"chr19","8011731","8012413","JH378118","18053084","18053501","321","10041353","GGCCGGGTACAGTGGCTCACTCCTGTAATCCCAGAACTTTGGGAGACCGAGGTGGGGGGATCACTTGAGGTCAGGAGTTCGAGACCACCCTGGCCAATATAGTGCTAAACCCCATCTCTACTCAAAATACAAAAAAAAAAAAAAAAAAAAAAAAAAAGCAAAACCCAGGCTGGGCACAGTAGCTCATACCTGTAATCCCAGCACTTTGGGAGGCTGAGGTGGGTAGATCATGAGGTCAGGAGTTCGAGACCAGCCTGACCAACATGGTGAAACCCCGTCTCTACTAAAAATACAAAAATTAGCCGGGCATGGTGGTGCGTGCCTGTAATCCCAGCTACTCAGGAGGCTGAGGCAGGAGAATCGCTTGAAGCTGGGAGGCAGAGGTTGCAGTGAGCCGAGATCGTGCTACTGTACTCCAGCCTGGGCAACAGGGCGACAGAGCAAGACTCTGTCTCAAAAAAAAAAAAAAAAAAAAAAAAAAGCAAAACCCCATCTCTACTAAAAATACAAAAAATTAGCCAGGCATGGTGGCATGTGCCTGTAATCCCAGCTACTCGAGAGGCTGAGGCAGAAGAATCACTTGAACCCAGGAGGCAGAGGTTGCAGCGAGCCAAGATTGTGCCATTGCACTCCAATCTGGGTGACAAGAGTAAAATCCTGTCTCAAAAAAATAAAAAATAAAA","GGCTGGGCGCAGTGGCTCACACCTGTAATCCCAGCACTTAGGGAAGCTGAGGCGAGTAGATCACCTGAGGTCAGGAGTTAGAGACCAGCCTGGCCATCATGGTGAAACCCCGTCTCTACTAAAGATACCAAAAATTAGCTGAGTGTGGTGCTGGGTGCCTGTAATCCCAGAAACTCAGGGTGCCTGTAATCCCAGCAACTCAGGGTGCCTTTAATCCCAGCAACTGAGGGTACCAGTAATCCCAGCAACTCAGGGTGTCTTTAATCCTAGCAACTGAGGGCACCTGTAATCCCAGCAACTCAGGAAGCTGAGACAGGAGAAGTACTTGAACCCAGAAGGCAGAGGTTGCAGTGAGCCGATATTGCACCATTGCACTCCAGTCTGGGCAACAAGAGTGAAACTCTGTCTCAAAAAAAAA"
"chr19","8026835","8027736","JH378118","18053084","18053501","522","10026249","GCGCGGTGGCTCATGCCTGTAAACCCAGCACTTTGGGAGGCTGAGGTGGGTGGATCACCTGAGGTCAGGAGTTTGAGACCAGCCTGGCCAATATGGTGAAACCCGTCTCTACTAAAACATACAAAAATTAGGCTGGGCGCGGTGGCTCATGCCTTTAATCCCAACACTTTGGGAGGCCGAGGCGGGCGGATCACGAGGTCAGGAGTTTGAGACCATCCTGGCTAACATGGTGAAAGCCCGTCTCTACTAAAAATATAAAAATTAGCTGGGCGTGGTGGTGGGCACCTGGAGTCCCAGCTACTTGGGAGGCTGAGGCAGGAGAATGGCGTGAACCCGGGAGGCGGAGCTTGCAGTGAGCCAGGATCACGCCACTGCACTCCAGCCTGGGCGACAGAGCGAGACACCGTCTCAAAAAAAAAACAACAAAAATTAGCCAGGCATGGTGGTGGGCGCCTTTTTTTTTTTTTTTTTCAGAGTCTCACTCTGTCACCCAGGCTGGAGTGCAGTGGCTCAATCTCGGTTCACTGCAACCTCCGCCTCCCAGGTTCAAGCGATTCTCCTGCCTCAGCCTCCCGAATAACTGGGATTACAGGCACCCGCCACTACAACCAGCTAATTTTTGTATTTTTAGTAGAGATGGGGTTTCGCCATGTTGGCCAGGATGGTCTTGATCTCTTGACCTCGTGATCCACCCTCCTTGGCCTCTCAAAGTGCTGGGATTACAGGTGTGAGCCACTGTTCCCAGCTGATAGTGGGCACTTTTAATCCCAGCTACTCCGGAGGCTGAGGCAGGAGAATTGCTTGAACCCAGGAGGTGGAGGTTGCAGTGAGCCAAGATCGCGCCATTGCACTCCAGCCTGGGTGACAATAGCAAAACTCTGTCTCAATGAAACAAAACAAAA","GGCTGGGCGCAGTGGCTCACACCTGTAATCCCAGCACTTAGGGAAGCTGAGGCGAGTAGATCACCTGAGGTCAGGAGTTAGAGACCAGCCTGGCCATCATGGTGAAACCCCGTCTCTACTAAAGATACCAAAAATTAGCTGAGTGTGGTGCTGGGTGCCTGTAATCCCAGAAACTCAGGGTGCCTGTAATCCCAGCAACTCAGGGTGCCTTTAATCCCAGCAACTGAGGGTACCAGTAATCCCAGCAACTCAGGGTGTCTTTAATCCTAGCAACTGAGGGCACCTGTAATCCCAGCAACTCAGGAAGCTGAGACAGGAGAAGTACTTGAACCCAGAAGGCAGAGGTTGCAGTGAGCCGATATTGCACCATTGCACTCCAGTCTGGGCAACAAGAGTGAAACTCTGTCTCAAAAAAAAA"
"chr19","9069244","9069863","JH378118","18053084","18053501","266","8983840","GGCCGGGCACGGTGGCTCATTCCTGTAGTCTCTGTACTTTAGGAGGCTGAGGTGGGTGGATCACTTGAGGTCAGGAGTTCCAGACCAGTCTGGCCAAAATGGTGAAACCCCGTCTGTACTAAAAATACAAAAAAAAAGGCCGGGCGCGGTGGCTCACGCCTGTAATCCCAGCACTTTGGGAGGCTGAGGTGGGTGGATCACAAGGTCAGGAGATTGAGACCATCCTGGCTAACATGGTGAAACCCCGTCTCTACTAAAAATACAAAAAATTAGCTGAGTGTGGTAGCAGGCACCTGTAATCCCAGCTACTCAGGAGGCTGAGGTGGGAGAATGGCATGAACCCAGGAAGCAGAGCTTGCAGTGAGCTGAGATCATGCCACTGCACTCCAGCCTGGGTGACAGAGCGAGACTCCATCTCAAAAAAAAAAAATACAAAAAAATTAGCCAGGCGTAGTGGTGCATGCTTGTAGTCTCGGCTACTCAGGAGACTGACGCAGGAGAATCACTTGAACCCAGGAGGCGGAGGTTGCAGTGAGCCGAAATTATGCCATTGCACTCCAGCCTGGGAGACAAGAACAAAACTCTATCTCAAAAACCAACCAACCAAACAAACAAAAAAA","GGCTGGGCGCAGTGGCTCACACCTGTAATCCCAGCACTTAGGGAAGCTGAGGCGAGTAGATCACCTGAGGTCAGGAGTTAGAGACCAGCCTGGCCATCATGGTGAAACCCCGTCTCTACTAAAGATACCAAAAATTAGCTGAGTGTGGTGCTGGGTGCCTGTAATCCCAGAAACTCAGGGTGCCTGTAATCCCAGCAACTCAGGGTGCCTTTAATCCCAGCAACTGAGGGTACCAGTAATCCCAGCAACTCAGGGTGTCTTTAATCCTAGCAACTGAGGGCACCTGTAATCCCAGCAACTCAGGAAGCTGAGACAGGAGAAGTACTTGAACCCAGAAGGCAGAGGTTGCAGTGAGCCGATATTGCACCATTGCACTCCAGTCTGGGCAACAAGAGTGAAACTCTGTCTCAAAAAAAAA"
"chr19","9785992","9786608","JH378118","18053084","18053501","261","8267092","GGCCGGGAACGGTGGCTCACACCTATAATCCCAGCACTTTGGGAGGCCGAGGCAGGTGGATCACCTGAGGTCAGGAGTTCAAGACCAGCGTGGCCAACATAATGAAACCCCATCTTGGCCGGGTGCGGTGACTCACGCCTGTAATCCCAGCACTTTGGGAGGCCAAGGCGGGTGGATCACGAGGTCAGGGGATCGAGACCATCCTGGCTAACACAGTGAAACCCTGTCTCTACTAAAAATACAAAAAAATTAGCTGGGCATGGTGGCGGACGCCTGTAGTCCCAGCTACTCGGGAGGCTGAGGCAGGAGAATGGTGTGAACCTGGGAGGCAGAGCTTGCAGTGAGCCGAGATTGCGCCACTGCACTCCAGCTTGGGTGACAAAGTGAGACTCCATCTCAAAAAAAAAAAAAGAAACCCCATCTCTACTAAAAATACAAAAAATTTGCTGGGTGTGGTTGTGGGCACCTGTAATCCCAGCTACTTGGGAGGCTGAGGCAGGAGAATCACCTGAACCCAGGAGGCAGAGGTTGCAGTGAGCCGAAACAGTGCCATTGCACTCCAGCCTGGGCAACAAGAGTGAAACTCAATCTCAAAAAAAAAAAAAAAAGTACAAAAA","GGCTGGGCGCAGTGGCTCACACCTGTAATCCCAGCACTTAGGGAAGCTGAGGCGAGTAGATCACCTGAGGTCAGGAGTTAGAGACCAGCCTGGCCATCATGGTGAAACCCCGTCTCTACTAAAGATACCAAAAATTAGCTGAGTGTGGTGCTGGGTGCCTGTAATCCCAGAAACTCAGGGTGCCTGTAATCCCAGCAACTCAGGGTGCCTTTAATCCCAGCAACTGAGGGTACCAGTAATCCCAGCAACTCAGGGTGTCTTTAATCCTAGCAACTGAGGGCACCTGTAATCCCAGCAACTCAGGAAGCTGAGACAGGAGAAGTACTTGAACCCAGAAGGCAGAGGTTGCAGTGAGCCGATATTGCACCATTGCACTCCAGTCTGGGCAACAAGAGTGAAACTCTGTCTCAAAAAAAAA"
"chr19","9897689","9898264","JH378206","6546474","6546861","233","3351215","GCCAGGCACGGTGGCTCACACCTGTAATCCCAGCACTTTGGGAGGCCAAGGTGGGTGGATCACCTGAGGTCAGGAGTTCAAGACCAGCCTGACCAACATGGTGAAACCCAGGGCTCACACCTGTAATCCCAGCGCTTTGGGAGGCTGACGCGGGCAGATCACGAGGTCAGGAGATCGAGACCATCCTGGCTAACATGGTGAAACCCCGTCTCTACTAAAAATACAATAATTAGCTGGGCATGGTGGTGGGTGCCTGCAGTCCCAGCTACTTGGGAAGCTGAGGCAGGAGAATGGCGTGAACCCAGGAGGTGGAGCTCTCAGTGAGCTGAGATTGCATCACTGCACTTCCAGCCTGGGTGACAGAGCAAGACTCTGTCTCAAAAAAAAAAAAAAAAAAAAAAAAAATTAGCCAGGTGTGATGGCAGGCACCTGTAATCCCAGCTACTTAGGAGGCTGAGGCAGGAGAACCCAGGAGGCAGAGGTTGCAGTGAGCCAAGATCGCGCCATTGCACTCCAGCCTGGGTGACAAGAGCAAAATTCCATCTCAAAAAAAAAAAAAAAGAAGAAAAAGAAGAA","GGCCACACATGGTGGCTAACGCCTGTAATCCCAGCACTTTGGGAGGCCAAGTCGGGTGGATCATGAGGTCAGGAGACCAAGACCATCCTGGCCAAATGGTGAAACCCCGTCTCTACTAAAAATACAAAAATTAGCTGGGCATGGTGGCGTGTGCCTGTAATCCCAGCTACTCAGGAGGCTGAGGCAGGACAATTGCCTGAACCCAGGAGAATTAGCTGGGCATGGTGGCGTGTGCCTGTAATCCCAGCTACTCAGGAGGCTGAGGCAGGACAATTGCCTGAACCCAGGAGGCGAAGGTTGCGGTGAGCCGAGATTGTGCCATTGCACTCCAGCCTGGGTAACAAGAGCGACACTCTGTCTCAAAAAAAAAAAAAAAAAAAAAAAAAAA"
"chr19","10210761","10211695","JH378118","18053084","18053501","553","7842323","GGCCGGGTGTGGTGGCTCATGCCTGTAATCCCAGGCATGATTTGGGAGGCCGAGGGAGGCAGATCACCTGAGGTCAGGAGTTTTTTTGTTTTGTTTTGTTTTGTTTTTGAGACAGAGTCTTGTTCTGTTGCCCAGGCTGGAGTGCAATGATGTGATCTCGACTCACTACAACCTCCACCTCCTGAGTTCAAGCGATTCTGCTGCCTCAGCCTCCCGAGTAGCTGGCATTACAGGCATGTGCCACCAAGCCTGGCTAATTTTTGTATTTATAGTAGAGACGGGGGTTTCACCATGTTGATCAGGCTGGTGTCGAACTCCTGGCCTCAAGTGATCCGCTCGCCTTGGCCTCCCAAAATGCTGGGATTACAGATGTGAGCCACTGTGCCCAGCCAAGGTCAAGAGTTTGAAACCAGCCTGGCCAGCATGGTGAAACCCTATCTCTACTAAAAATACAAAATCAGTCCATGTGCCTAATTTTGGGATCACACCTGGGATCATGCCTGCAATCCCAGCACTTTGGGAGGCCAAGGCGGGTGGGTCATGAAGTCAGGAGTTCAAGACCAGCCTGGCCAACATGGTGAAACCCTGTCTCTACTAAAAATACAAAAGTTAGCTGGGCGTGGTGGCACGCACCTGTAGTCCCAGCTACTAGGAAGGCTGAGGCAGGAGAATTCTTGAACCCGGGTGATGGAGGTTGCAGTGAGCCGAGATTGCGCCACTGCACTCCAGCCTGGGCAACAGAGTGAGACTCTGTCTAAAAAAAAAATTAGTCAGGCGTGGTGGTGAGCACCTGTAATCACAGCTACTGGGGAGGCTGAGGCTGGAGAATTGCTTGAACCCGGGAGGCGGAGGTTGCAGTGAGCCAAGATCGCGCCTTTGCACTCCAGCCTGGGCAACAGGAGTGAAACTGCATCTCAAAAAAAAAAAAAAAAAAA","GGCTGGGCGCAGTGGCTCACACCTGTAATCCCAGCACTTAGGGAAGCTGAGGCGAGTAGATCACCTGAGGTCAGGAGTTAGAGACCAGCCTGGCCATCATGGTGAAACCCCGTCTCTACTAAAGATACCAAAAATTAGCTGAGTGTGGTGCTGGGTGCCTGTAATCCCAGAAACTCAGGGTGCCTGTAATCCCAGCAACTCAGGGTGCCTTTAATCCCAGCAACTGAGGGTACCAGTAATCCCAGCAACTCAGGGTGTCTTTAATCCTAGCAACTGAGGGCACCTGTAATCCCAGCAACTCAGGAAGCTGAGACAGGAGAAGTACTTGAACCCAGAAGGCAGAGGTTGCAGTGAGCCGATATTGCACCATTGCACTCCAGTCTGGGCAACAAGAGTGAAACTCTGTCTCAAAAAAAAA"
"chr19","10485431","10486007","JH378118","18053084","18053501","237","7567653","GGCCGGGCGCAGTGGCTCATGCCTAATCCCAAGACTTTCAGAGGCTGAGGCAGGTGGATCACCTGAGGTCAGGAGCTCAAGACCAGCCTGGCTAACATTGTGAAACCGCGTCTCTACTAAAAATCAAAATTGGCCGGGCACGGTGGCTCACACCTGTAATCCCATCCCTCTGGGAGACCGAGGCGGGCAGATCACCTAAGGTCAGGAGTTCGAGACCAGCCTGACCAACATGGAGAAAACCCTTCTCTGCTAAAAATACAAAATTAGCCGGGCGTGGTGGCGCATGCCTGTAACCTCAGCTACTCGGGAGGCTGAGGGAAAATCGCTTGAACCTGCCAGGTGGAGGTTGCAGTGAGCCGAGATCGAGCCATTGCACTCCAGCATGGGCAACGAAAGCGAAACTCCATCTCAAAAAAAAAAAAAATTAGCTAGGCGTGGTGGCGCGTGCCTGTATTCCCAGCTACTCAGGAGGCTGAGACAGGAGAATCACTTGAACCTGGGAGGCAGAGGTTGCAGTGAGCCAAGATTGCACCATTGCACTCCAGCCTGGGCAACACGAGCAAAACTCTGTCTCAAA","GGCTGGGCGCAGTGGCTCACACCTGTAATCCCAGCACTTAGGGAAGCTGAGGCGAGTAGATCACCTGAGGTCAGGAGTTAGAGACCAGCCTGGCCATCATGGTGAAACCCCGTCTCTACTAAAGATACCAAAAATTAGCTGAGTGTGGTGCTGGGTGCCTGTAATCCCAGAAACTCAGGGTGCCTGTAATCCCAGCAACTCAGGGTGCCTTTAATCCCAGCAACTGAGGGTACCAGTAATCCCAGCAACTCAGGGTGTCTTTAATCCTAGCAACTGAGGGCACCTGTAATCCCAGCAACTCAGGAAGCTGAGACAGGAGAAGTACTTGAACCCAGAAGGCAGAGGTTGCAGTGAGCCGATATTGCACCATTGCACTCCAGTCTGGGCAACAAGAGTGAAACTCTGTCTCAAAAAAAAA"
"chr19","10538873","10539199","JH378118","15020968","15021286","46","4482095","GCTGGGCGCGGTGGCTCACGCCTGTAATCCCAGCACTTTGGGAGGCTGAGGCAGGCAGATCACCTGAGGTCAGGAGTTCAAGACCAGCCTGGTTAACACAGTGAAACCCCCGTCTCTACTAAAAATACAAAAACAAAAATTAGCCGGGTGTGGTGGCGGGCGCCTGTAATCCCAGTTACTCGGGAGGCTGAGGCAGGAGAATCGCTTGAACCCGGGAGGCGGAGGTTGTGGTGAGCCGAGATTGCCATTGCACTCCAGCCTGGGCAAAAAGAGCGAAACTCCATCTAAAACAAACAAACAAACAAACAAACAAAAAATAGAAAAGAA","GCCGGGCGCGGTGGCTCAAGCCTGTAATCCCAGCACTTTGGGAGGCTGAGGCGGGTGGATCCCGAGGTCAAGAGATCGAGACCATCCTGGTCAACATGGTGAAACCCCGTCTCTACTAAAAATACAAAACATTAGCTGGGTATGGTGGCGCGTGCCTGTAATCCCAGCTACTCAGGAGGCTGAGGCAGGAGAATTGCCTGAACCCAGGAGGCGGAGGTTGCGGTGAGCTGAGATCGCGCCATTGCACTCCAGCCTGGGTAACAAGAGCGAAACTTCCATCTCAAAAACAAACAAACAAACAAACAAACAAAAAACAAAC"
"chr19","10973032","10973651","JH378118","18053084","18053501","265","7080052","GGCTGGACGTGGTGGCTCACGCCTGTAATCCCAACACTTTGGGAGACCAAGGCAGGTGGATCGCCTGAGGTTAGGGGTTCGAGACCAGCCTGACCAACATGGTGAAACCCCATCTCTACTAATAATAAAAAAATTAGGACCAGGCTTGGTGGCTCATGCCTGTAATTCCAACACTTTGGGAGGCCAAGGCGAGTGGATAACTTGAGGTCAGGAGTTTGAGACCAGCCTGGCCAACATGGTGAAACCTCATCTCTACTAAAAATACAAAAATTAGCCGGCATGGTGGCGGGCACCCGTAATCCCAGCTACTCGGTGTGGGGGCTGGGACAGGAGAATCGCTTGAACCCAGGAGGTGGAGGTTGCCGTGAGCTAAGATTGCGCCACTGCACTCTAGTTGGGGCAACAGAGCGGACTCCGTCTCAAAAAAAAAAAAAAAATTAGCCGAGCGTGGTGGTGGACACCTGTAATCCCAGCTACTCAGGAGGCTGAGGCAGGAAAATTGAAATCGCTTAAACCTGGGAGGAGGAGGTTGCAGTGAGCCAAGATCGCACCATTGCACTCCAGCCTGGGCGACAAGAACAAAACTCCGTCTCCCCACTCCAAAAAAAAAAAAAAAAAAA","GGCTGGGCGCAGTGGCTCACACCTGTAATCCCAGCACTTAGGGAAGCTGAGGCGAGTAGATCACCTGAGGTCAGGAGTTAGAGACCAGCCTGGCCATCATGGTGAAACCCCGTCTCTACTAAAGATACCAAAAATTAGCTGAGTGTGGTGCTGGGTGCCTGTAATCCCAGAAACTCAGGGTGCCTGTAATCCCAGCAACTCAGGGTGCCTTTAATCCCAGCAACTGAGGGTACCAGTAATCCCAGCAACTCAGGGTGTCTTTAATCCTAGCAACTGAGGGCACCTGTAATCCCAGCAACTCAGGAAGCTGAGACAGGAGAAGTACTTGAACCCAGAAGGCAGAGGTTGCAGTGAGCCGATATTGCACCATTGCACTCCAGTCTGGGCAACAAGAGTGAAACTCTGTCTCAAAAAAAAA"
"chr19","11513769","11514351","JH378206","6546474","6546861","242","4967295","TCCCAGCACTTTGGGAGGCCGCGATGGGTGGATCACCTTAGGTCAGGAATTCGAGACCATCCTGGCCAACATGGTGAAACCCCGTCTCTACTAAAAACACAAAAATTAGGCCGGGCACGGTGGCTCACATCTGTAATCCCAGCACTTTGGGAGGCTGAGGTGGGCGGATCACAAGGTCAGGAGTTCAAGACCAGCCTGGCCAACATGGTGAAACCCTGTCTCTACTAAAAATACAAAAATTAACTGGGCATGGTGGCATGTGCCTGTAATCCCAGCTACTTGGGAGGCTGAGGCAGAAGAATTGCTTGAACCAGGGAGTCAGAGGTTATAGTGAGCTGAGATCGTGCGACTGCACTCCAGCCTGGTGACAGAGCGAGACTCCGTTTCAGGAAAAACAAACAAAACACAAAAATTAGCTGGGCATGGTGGCAGGCGCCTGTAATCCTAGCTACTTGGGAGGCTGAGGCAGGAGAATCGCTTGAACCCAGAAGGCAAAGGTTGCAGTGAGCTGAGATGATGCCATTGCACTCCAGCCTGGGCAACAAGTGAAACTCTGTCTCAAGAAAAAAAGTAAAAGAAAGAA","GGCCACACATGGTGGCTAACGCCTGTAATCCCAGCACTTTGGGAGGCCAAGTCGGGTGGATCATGAGGTCAGGAGACCAAGACCATCCTGGCCAAATGGTGAAACCCCGTCTCTACTAAAAATACAAAAATTAGCTGGGCATGGTGGCGTGTGCCTGTAATCCCAGCTACTCAGGAGGCTGAGGCAGGACAATTGCCTGAACCCAGGAGAATTAGCTGGGCATGGTGGCGTGTGCCTGTAATCCCAGCTACTCAGGAGGCTGAGGCAGGACAATTGCCTGAACCCAGGAGGCGAAGGTTGCGGTGAGCCGAGATTGTGCCATTGCACTCCAGCCTGGGTAACAAGAGCGACACTCTGTCTCAAAAAAAAAAAAAAAAAAAAAAAAAAA"
"chr19","11535200","11535780","JH378206","6546474","6546861","242","4988726","TCCCAGCACTTTGGGAGGCCGCGATGGGTGGATCACCTTAGGTCAGGAATTCGAGACCATCCTGGCCAACATGGTGAAACCCCGTCTCTACTAAAAACACAAAAATTAGGCCGGGCACGGTGGCTCACATTGTAATCCCAGCACTTTGGGAGGCTGAGGTGGGCGGATCACAAGGTCAGGAGTTCAAGACCAGCCTGGCCAACATGGTGAAACCCTGTCTCTACTAAAAATACAAAAATTAACTGGGCATGGTGGCATGTGCCTGTAATCCCAGCTACTTGGGAGGCTGAGGCAGAAGAATTGCTTGAACCAGGGAGTCAGAGGTTATAGTGAGCTGAGATCGTGCGACTGCACTCCAGCCTGGTGACAGAGCGAGACTCCGTTTCAGGAAAAACAAACAAAACACAAAAATTAGCTGGCATGGTGGCAGGCGCCTGTAATCCTAGCTACTTGGAGGCTGAGGCAGGAGAATCGCTTGAAACCCAGAAGGCAAAGGTTGCAGTGAGCTGAGATGATGCCATTGCACTCCAGCCTGGGCAACAAGTGAAACTCTGTCTCAAGAAAAAAAGTAAAAGAAAGAA","GGCCACACATGGTGGCTAACGCCTGTAATCCCAGCACTTTGGGAGGCCAAGTCGGGTGGATCATGAGGTCAGGAGACCAAGACCATCCTGGCCAAATGGTGAAACCCCGTCTCTACTAAAAATACAAAAATTAGCTGGGCATGGTGGCGTGTGCCTGTAATCCCAGCTACTCAGGAGGCTGAGGCAGGACAATTGCCTGAACCCAGGAGAATTAGCTGGGCATGGTGGCGTGTGCCTGTAATCCCAGCTACTCAGGAGGCTGAGGCAGGACAATTGCCTGAACCCAGGAGGCGAAGGTTGCGGTGAGCCGAGATTGTGCCATTGCACTCCAGCCTGGGTAACAAGAGCGACACTCTGTCTCAAAAAAAAAAAAAAAAAAAAAAAAAAA"
"chr19","12911527","12912140","JH378118","18053084","18053501","266","5141557","GGCCAGGCATGGTGGCTCATGCCTGTAATCCAGCACTTTGGTAGGCCAAGGTGGGTGGATGGATTACTTGAGGCCAGGAGTTCAAGACCAACCTGGCCAACATGGTGAAAACCCATCTCTATTAAAAATATAAAAGCTAGGCCAGGTGCGGTGGCTCACGCCTGTAATCCCAGCACTTTGGGAGGCTGAGGCGGGCGGATCACGAGGTCAGGAGATCGAGACCACTGTGAAACCCTGTCTCTACTAAAAATACAAAAAAAATTAGCTGGGTGGGGTGGCGGGTGCCTGTAGTCCCAGCTACTTGGGAGGCTGAGGCAGGAGAATGGCGTGAACCCGGGAGGCGGAGCTTGCAGTGAGCCGAGATCGCGCCACTGCACTCCAGCCTGGGCTACAGAGCAAGACTCCGTCTCAAAAAAAAAATAAATAAATAAATAAAAATAAAAACTAACTGGGCATGGTGGTGTGCACCTGTAATCCCAGCTACTCGGGAGGCTGAGACAGGAGAATTGCTTGAACCTGGGAGGTGGAGGTTGCAGTGAACCAAGATGATGCCATTGCACTCCAACCTGGGCAACAAGAGCAAAACTCCGTCTCAAAAAAAAAAAAAAAAAAAA","GGCTGGGCGCAGTGGCTCACACCTGTAATCCCAGCACTTAGGGAAGCTGAGGCGAGTAGATCACCTGAGGTCAGGAGTTAGAGACCAGCCTGGCCATCATGGTGAAACCCCGTCTCTACTAAAGATACCAAAAATTAGCTGAGTGTGGTGCTGGGTGCCTGTAATCCCAGAAACTCAGGGTGCCTGTAATCCCAGCAACTCAGGGTGCCTTTAATCCCAGCAACTGAGGGTACCAGTAATCCCAGCAACTCAGGGTGTCTTTAATCCTAGCAACTGAGGGCACCTGTAATCCCAGCAACTCAGGAAGCTGAGACAGGAGAAGTACTTGAACCCAGAAGGCAGAGGTTGCAGTGAGCCGATATTGCACCATTGCACTCCAGTCTGGGCAACAAGAGTGAAACTCTGTCTCAAAAAAAAA"
"chr19","13205284","13205895","JH378118","18053084","18053501","258","4847800","GCCAGGCGCAGTGGATTACGCCTGTAATCCCAGCGCTTTGGTATACCGAGGCGGGCAGATCGTCTGAGGTCAGGAGTTCAAGACCAGCCTGGAGAACATGGTGAAACCCCGTCTCTATTAAAAATACAGGCTGGGCGCGGTGGCTTACGCCTGTAATCTCAGCACTTTGGGAGGCCAAGGCGGGTGGATCACGAGGTCAGGAGATCGAGACCATCCTGGCTAACATGGTGAAACCCTGTCTCTACTGAAAATACAAAAAAATTAGTTGTGGTGGGTGCCTGTAATCCCAGCTACTCGGGAGGCTGAGGCAGGAGAATGGCGTGAACCCGGGAAGCAGAGATTGCAGTAAGCCAAGATCGCTCCACTGCACTCCAGCCTGGGCTACAGAGCAAGACTCCATCTCAAAAAAAAATAAATAAATAAAATAAAAAATTAGCCTGGCGTGGTGGCGCATGCCTGTAATCCCAGCTACTTGGGAGGCTGAGGCAGGAGAATTGCTTGAACCCAAGAGGTGGAGGTTGCAGTGAGTCGAGATTGAGCCATTGCCATCCAGCCTGGGCAACAAGAGTGAAACTCTGTCTCAAAAAAAAAGAGAGAGAAAAGAAAGTAAAA","GGCTGGGCGCAGTGGCTCACACCTGTAATCCCAGCACTTAGGGAAGCTGAGGCGAGTAGATCACCTGAGGTCAGGAGTTAGAGACCAGCCTGGCCATCATGGTGAAACCCCGTCTCTACTAAAGATACCAAAAATTAGCTGAGTGTGGTGCTGGGTGCCTGTAATCCCAGAAACTCAGGGTGCCTGTAATCCCAGCAACTCAGGGTGCCTTTAATCCCAGCAACTGAGGGTACCAGTAATCCCAGCAACTCAGGGTGTCTTTAATCCTAGCAACTGAGGGCACCTGTAATCCCAGCAACTCAGGAAGCTGAGACAGGAGAAGTACTTGAACCCAGAAGGCAGAGGTTGCAGTGAGCCGATATTGCACCATTGCACTCCAGTCTGGGCAACAAGAGTGAAACTCTGTCTCAAAAAAAAA"
"chr19","14119695","14120238","JH378206","6546474","6546861","206","7573221","ACCAGCCTGGCCAAAATGGTGAAACCCTGTCTCTACTAAAAATATTTAAAAATTGGCCAGGTGCGGTGGCTCACGCCTGTAATCCCAGCACTTTGGGAGGCCGAGGCGGGCGGATTACAAGGTCAGGAGATCGAGACCATCCTGACTAACATGGTGAAACCCCGTCTCTACTAAAAATACAAAAAATTGGCCGGGCGTGGTAGCGGGCGCCTGTAGTTCCAGCTACTCGGGAGGCTGAGGCAGGAGAATGGCGTGAACCCGGAAGGCAGAGCTTGCAGTGAGCCAAGATCGTGCCACTGCACTCCAGCCTGAGCGACAGAGCAAGACTCCATCTCAAAAAAAAAAAAAAAAAAAAAAAAAATTAAAAAATTAGCTGGGCGTGGTAGCCGGCACCTGTAATTCCAGCTACTCAGGAGGCTGGAGCACAAGAATCGCTTGAAACCAGGAGGCAGAGTTGTAGTGAGCCGAGATCGTGCCATTGCACTCCAGCCTGGGCATCAAGAGCGAAACTCCATCTCAAAAACAAAACAAAACAAAACAAAAA","GGCCACACATGGTGGCTAACGCCTGTAATCCCAGCACTTTGGGAGGCCAAGTCGGGTGGATCATGAGGTCAGGAGACCAAGACCATCCTGGCCAAATGGTGAAACCCCGTCTCTACTAAAAATACAAAAATTAGCTGGGCATGGTGGCGTGTGCCTGTAATCCCAGCTACTCAGGAGGCTGAGGCAGGACAATTGCCTGAACCCAGGAGAATTAGCTGGGCATGGTGGCGTGTGCCTGTAATCCCAGCTACTCAGGAGGCTGAGGCAGGACAATTGCCTGAACCCAGGAGGCGAAGGTTGCGGTGAGCCGAGATTGTGCCATTGCACTCCAGCCTGGGTAACAAGAGCGACACTCTGTCTCAAAAAAAAAAAAAAAAAAAAAAAAAAA"
"chr14","584088","584429","JH378109","21565230","21565567","54","20981142","GGCCGGGTACGGTGGCTCACGCCTGTAGTCCTGGCACTTTGGGAGGCCGAGGCAGGTGGATCCCCGAGGTCACGAGTTTGAGACCAGCCTGGCCAGCATGGTGAAATCCCATCTCTACTAAAAATACAAAACTTAGCCGGGCATGGTGACGTGTGCCTGTAATCCCAGCTACTTGGGAGGCTGAGGCAGGAGAATTGCTTGAACCAGGGAGGCAGAGGTTGCAGTGAGCTGAGATCATGAAACTGCAGTCCAGTCTAGGCGACAAGAGCAAAACTCCGTCTCAAAAAAATAAATAAATAAATAAATAAATAAAAAATAAAACAAACAACAAAAAAAACAAAA","GGCCGGGCGCGGTGGCTCAAGCCTGTAATACCAGCACTTTGGGAGGCCGAGGCGGGTGGATCACGAGGTCAAGAGATCGAGACCATCCTGGTCAACATGGTGAAACCCCGTCTCTACTAAAAATACAAACAATTAGCTGGGCATGGTGGCGGGTGCCTGTAATCCCAGCTACTCCAGAGGCTGAGGCAGGAGAATTGCCTGAACCCAGGAGACGGAGGTTGCGGTGAGCCAAGATCGCGCCATTGCACTCCAGCCTGGGTGACAAGAGCGAAACTCCGTCTCAATAAATAAATAAATAAATAAATAAATAAAAATAAAATAAATAAATAAATAAATAA"
"chr14","620575","620915","JH378109","21565230","21565567","56","20944655","GGCCGGGTACGGTGGCTCACGCCTGTAGTCCTGGCACTTTGGGAGGCCGAGGCAGGTGGATCCCCGAGGTCACGAGTTTGAGACCAGCCTGGCCAGCATGGTGAAATCCCATCTCTACTAAAAATACAAAACTTAGCCGGGCATGGTGACGTGTGCCTGTAATCCAGCTAACTTGGGAGGCTGAGGCAGGAGAATTGCTTGAACCAGGGAGGCAGAGGTTGCAGTGAGCTGAGATCATGAAACTGCAGTCCAGTCTAGGCGACAAGAGCAAAACTCCGTCTCAAAAAATAAATAAATAAATAAATAAATAAAAAATAAAACAAACAACAAACAAAACAAAA","GGCCGGGCGCGGTGGCTCAAGCCTGTAATACCAGCACTTTGGGAGGCCGAGGCGGGTGGATCACGAGGTCAAGAGATCGAGACCATCCTGGTCAACATGGTGAAACCCCGTCTCTACTAAAAATACAAACAATTAGCTGGGCATGGTGGCGGGTGCCTGTAATCCCAGCTACTCCAGAGGCTGAGGCAGGAGAATTGCCTGAACCCAGGAGACGGAGGTTGCGGTGAGCCAAGATCGCGCCATTGCACTCCAGCCTGGGTGACAAGAGCGAAACTCCGTCTCAATAAATAAATAAATAAATAAATAAATAAAAATAAAATAAATAAATAAATAAATAA"
"chr14","1107083","1107723","JH378118","18053084","18053501","303","16946001","GGCGTGGTGGCTCACACCTGTAATCCCAGCACTTCAGGAGGCCAAGGCAGGTAGATTGCTTGATCACAGGAGTTCAAACCAGCCATGGGCAATGTCAGGCCTCTGAGCCCAAGCTTGCACGTATCCAGATGGCCTGAAGCAACTGAAGAATCACAAAAGAAGTGAAAACAGCCAGTTCCTTCCTTAACTGATGACATTACCTTGTGAAATTCCTTCTCCTGGCTCAGAAGCTCCCCTACTGAGCACCTTGTGACCCCTGCCCCTGCCAGCCAGAGAACAATCCCCTTTGACTGTAATTTTCCACTACCTACCCAAATCCTATAAAACAGCCCCACCCCATCTCCCTTTGCTGACTCCTTTTTCGGACTAGGTCCGCCTGCACCCAGGTGATTAAAAAGCTTTATTGCTCACACAAAGCCTGTTGGTGGTCTCTTCACACGGACGCACGTGACAGGCAACATGGTGAAACCCTATCTCTATAAAAAAATAAAAATAAAAATTAGTTGGGCGTGGAGACTGAGGTGAGAGAATCCAGAGGATCCAAGAGGATCGAGTCAAGGAGGTGGAGGCCGCAGTGAGCCGAGATCGCACCGCTGCACTCCAGCCTGGGCGACAAGAGTGAAACTCTGTCTTAAAAAAAA","GGCTGGGCGCAGTGGCTCACACCTGTAATCCCAGCACTTAGGGAAGCTGAGGCGAGTAGATCACCTGAGGTCAGGAGTTAGAGACCAGCCTGGCCATCATGGTGAAACCCCGTCTCTACTAAAGATACCAAAAATTAGCTGAGTGTGGTGCTGGGTGCCTGTAATCCCAGAAACTCAGGGTGCCTGTAATCCCAGCAACTCAGGGTGCCTTTAATCCCAGCAACTGAGGGTACCAGTAATCCCAGCAACTCAGGGTGTCTTTAATCCTAGCAACTGAGGGCACCTGTAATCCCAGCAACTCAGGAAGCTGAGACAGGAGAAGTACTTGAACCCAGAAGGCAGAGGTTGCAGTGAGCCGATATTGCACCATTGCACTCCAGTCTGGGCAACAAGAGTGAAACTCTGTCTCAAAAAAAAA"
"chr14","1362660","1363231","JH378118","18053084","18053501","229","16690424","GGCTGGGCACAGTGGCTTATACCCATAATCTCAGCAGTTTGGGAGGCCAAGGCAGGTGTATCACCTGAGGTCAGGAGTTCGAGAAACACCATGGCCAACATGGTGAAACCCCATCTCTACTAAAAATACAAAAAGTAGGCTGGGCGTGGTGGCTCACGCCTGTAATCCCAGTACTTTGGGAGGCCGAGGCGGGCGGATCACAAGGTCAGGAAACCGAGACCATCCTGACTAACATGGTGAAACCCCGTCTCTACTAAAAATACAAAAAAAGCTAGCCGGGCATGGTGGCGGGTGCCTGTAGTCCCAGCTACTCGGGAGGCTGAGGCAGGAGAATGGCGTGACCCCAGGAGGCAGAGCTTCCAGCTTGGGTGACTCCGTCTCAAAAAAAAAAAAACAAAAACAAAAAGTAGCTGGACGTGGTGGCTGTAGACCTAGCTACTCGAGAGGCTGAGGCAGGAGAATCGCTTGAACCTAGGAGGCGGAGGTTGCGGTGAGCCGAGATCACGCTTCTGCACTCCAGCCTGGGTGACAAGAGCAAAACTCCATCTCCAAAAAAAAAAAACAAAAAAAAA","GGCTGGGCGCAGTGGCTCACACCTGTAATCCCAGCACTTAGGGAAGCTGAGGCGAGTAGATCACCTGAGGTCAGGAGTTAGAGACCAGCCTGGCCATCATGGTGAAACCCCGTCTCTACTAAAGATACCAAAAATTAGCTGAGTGTGGTGCTGGGTGCCTGTAATCCCAGAAACTCAGGGTGCCTGTAATCCCAGCAACTCAGGGTGCCTTTAATCCCAGCAACTGAGGGTACCAGTAATCCCAGCAACTCAGGGTGTCTTTAATCCTAGCAACTGAGGGCACCTGTAATCCCAGCAACTCAGGAAGCTGAGACAGGAGAAGTACTTGAACCCAGAAGGCAGAGGTTGCAGTGAGCCGATATTGCACCATTGCACTCCAGTCTGGGCAACAAGAGTGAAACTCTGTCTCAAAAAAAAA"
"chr14","2088506","2089110","JH378118","18053084","18053501","257","15964578","GGCTGGGCACTGCGGCTCACACCTGTAATCCCAGCATTTTGAGAGGCCTAGGTGGGTGGATCACCTGAGATCAGTTCAAGACCAGCCTGACCAACATGGCAAAACCCCATCTCTATTAAAAACACAAAAAACGCCCAGGAGCGGTGGCTCACACCTGTAATCCCGGCACTTTGGGAGGCTGAGGCAGGCGGATCACGAGGTCAGGAGATCGAGACCATGCTGGCTAACACGGTGAAACCCCGTCTCTACTAAAAATACAAAAAATTAGCCAGGCGTGGTGTCGGGCGCCTGTAGTCCCAGCTATTCGGGAGGCTGAGACAGGAGAATGGCATGAACCCGGGAGGCAGAGCTTGCAGTGAGCTGAGATCGCGCCACTGCACTCCAGCCTGGGCGACAGAGTAAGACTCTGTCTCAAAAAAAAAAATACAAAAAATACAAAAAACATTAGCCACATGTGGTGGTGGGTGCCTGTAATCCCAGCTACTCAGGAGGCTGAGGCTGGAGAATTGCTTGAACCCAGGAGGTGGAGGTTGTGGTGAGCCAAGATCACGCCATTGCATTCCAGCCTGGGTGACAAGAGTGAACCTCTGTCTCAAAAAAAAGAA","GGCTGGGCGCAGTGGCTCACACCTGTAATCCCAGCACTTAGGGAAGCTGAGGCGAGTAGATCACCTGAGGTCAGGAGTTAGAGACCAGCCTGGCCATCATGGTGAAACCCCGTCTCTACTAAAGATACCAAAAATTAGCTGAGTGTGGTGCTGGGTGCCTGTAATCCCAGAAACTCAGGGTGCCTGTAATCCCAGCAACTCAGGGTGCCTTTAATCCCAGCAACTGAGGGTACCAGTAATCCCAGCAACTCAGGGTGTCTTTAATCCTAGCAACTGAGGGCACCTGTAATCCCAGCAACTCAGGAAGCTGAGACAGGAGAAGTACTTGAACCCAGAAGGCAGAGGTTGCAGTGAGCCGATATTGCACCATTGCACTCCAGTCTGGGCAACAAGAGTGAAACTCTGTCTCAAAAAAAAA"
"chr14","2164771","2165383","JH378118","18053084","18053501","243","15888313","GGCTGGGCGCAGTGGCTCACACCTGTAATCCCAGCACTCTGGGAGGCCAAGGCAGGTGGATCACCTGAGGTCAGGAGTTCGAGACCAGCCTGGCCAACATGGTGAAACCCCATCTTTACTAAAAATACAAAAATTAGCTAGGCGTGAGGCCGGGCGTGGCGGCTCATGCCTGTAATCCCAGCACTATGGGAGGCTGAGGCAGGCTGATCATGAGGTCAGGAGATTGAGACCTGGCTAACACAGTGAAACCCCGTCTCTACTAAAAATACAAAAAAAAAATAGCCAGGCATGATGGCAGGCTCCTGTAGTCCCAGCTTCTTGGGAGGCTGAGGCAGGAGAATGGTGTGAACCCGGGAGGCAGAGCTTGCAGTGAGCCGAGATCATGCCACTGCACTCCAGCCTGGGTGACAGAGCAAGACTCTGTCTCAAAAAAAAAAAAAAAAAATTAGCTAGGCGTGGTGAGGGGCACCTGGAATCCCAGCTACTCAGGAGGCTGAGGCAGGAGCATCGTTTAAACCCAGGAGGCAGAGGTTGCAGTGAGCCGAAATCACACCATTGCACTCCAGCCTGGGCAACAAGAGCAAGTCTCCATCTTAAAAAAAAAAAAAAAAAA","GGCTGGGCGCAGTGGCTCACACCTGTAATCCCAGCACTTAGGGAAGCTGAGGCGAGTAGATCACCTGAGGTCAGGAGTTAGAGACCAGCCTGGCCATCATGGTGAAACCCCGTCTCTACTAAAGATACCAAAAATTAGCTGAGTGTGGTGCTGGGTGCCTGTAATCCCAGAAACTCAGGGTGCCTGTAATCCCAGCAACTCAGGGTGCCTTTAATCCCAGCAACTGAGGGTACCAGTAATCCCAGCAACTCAGGGTGTCTTTAATCCTAGCAACTGAGGGCACCTGTAATCCCAGCAACTCAGGAAGCTGAGACAGGAGAAGTACTTGAACCCAGAAGGCAGAGGTTGCAGTGAGCCGATATTGCACCATTGCACTCCAGTCTGGGCAACAAGAGTGAAACTCTGTCTCAAAAAAAAA"
"chr14","3757666","3758004","JH378113","23438980","23439304","67","19681314","CTGGGCATGGTGGCTCATGCCTGTAATCCCAGCACTTTGGGAGACAGAGGAGGGCAGATCATCTGAGGTCAGGAGTTTGAGACCAGCCTGGCCACCATGGTGAAACCCCCGTCTCTACTGAAAATACAAAAAAATTCAGCTGGGTGTGGTAGTGGATGTCTGTAATCCTAGCTGCTTGGGAGGCTGAGACAGGAGAATCGCTTGAACCCGGGAGGTGGAGGTTGCAGTGAGCCGCCATTGCGCTCCAGCCTGGGCAACAAGAGCGAAACTCCATCTCAAAAATTAATTAATTAATTAATTAATTAAAAGTGGACTAAAGCAAAGACAAGAGAAAAAAGA","GGCAGGGTGTGGTAGCTCATGCTTGTAATCCCAGCACTTTGGGAAGTGGAGGCGGGCAGATCATCTGAGGTCAGGAGTTTGAGGCCAGCCTGGCCAACATGGTGAAACCCTGTCTCTACTAAAAATACAAAAAATTAACTGGGCGTGGTGGTGGACACCTGTAATCCCAGCTGCTTGGGAGGCTGAGGCAGGAGAATCGCTTGAACCCAGGAGATGGAGGTTGCAGTGAGCCAAGATGGCACCATTGCACTCTAGCCTGGGCAAAAAGAGTGAAACTCCGTCTCAAAAAAAAAAAAGAAAAGAAAAGAAAAGAAAAGAAAAGAAA"
"chr14","10702105","10702681","JH378118","18053084","18053501","246","7350979","GGCCAGGCGCAATGGCTCACACCTGTAATCCAAGCACTTTGGGAGGCCAGTTCAAGACCAGCCTGGCCAACATGGTGAAAACCTGTCTCTGCTAAAAATGCCAAATTTCCCAGCACTTTGGGAGGCTGAGGCGGGTGGATCACGAGGTCAGGAGATTGAGACCATCCCGGCTAACACGGTGAAACCCCATCTCTACTAAAAATAGAAAAAAATTAGCCGGGCGTGGTGGCAGACGCCTGTAGTCCCAGCTACTCTGGAGGCTGAGGGAAGAGAATGGCATAAACCCGGGAGGCGGAGCTTGCAGCGAGCTGAGATTGCGCCACTGCACTCCAGCCTGGGCGACAGAGCAAGACTCCGTCTCAAAATAAATAAATAAATAAAATTAAAATTAAAAATAAAATACAAAATTTAGCCGAGCATGGTGGTGAGCACCTATAATCCCAGCTACTTGGGAGGCTGAGGCAGAAGAATCTCTTGAACCAGGGAAGTGGAGGTTGCAGTGGGCTGAGATCCAGCCACTGTACTCCAGCCTGGGCGACAAAAGCGAAACACTGTCTAAAAAAATAAAAAATAAAAA","GGCTGGGCGCAGTGGCTCACACCTGTAATCCCAGCACTTAGGGAAGCTGAGGCGAGTAGATCACCTGAGGTCAGGAGTTAGAGACCAGCCTGGCCATCATGGTGAAACCCCGTCTCTACTAAAGATACCAAAAATTAGCTGAGTGTGGTGCTGGGTGCCTGTAATCCCAGAAACTCAGGGTGCCTGTAATCCCAGCAACTCAGGGTGCCTTTAATCCCAGCAACTGAGGGTACCAGTAATCCCAGCAACTCAGGGTGTCTTTAATCCTAGCAACTGAGGGCACCTGTAATCCCAGCAACTCAGGAAGCTGAGACAGGAGAAGTACTTGAACCCAGAAGGCAGAGGTTGCAGTGAGCCGATATTGCACCATTGCACTCCAGTCTGGGCAACAAGAGTGAAACTCTGTCTCAAAAAAAAA"
"chr14","11790883","11791455","JH378118","18053084","18053501","226","6262201","GGCTGGGTGGCCATGGCTCATGCCTGTAATCCTAGAACTTTGGGAGGCTGCGGCAGGCAAATCACCTGAAGTCAGGAGTTCAAGACCAGCCTGGCCAACATACTGAAACCCCGTCTCTCCAGGCCTGGTGGCTCATGCCTGTAATCCCAGCACTTTGGAAAGCCGAGGTGGGCGGATCACCTGAGGTCAGGAGTTCAAGACCAGTCTGACCAACATGGGGAAACCCCATCTCTACTAAAAATACAAAATTAGCTGGATGTGGTGGCACATGCCTGTATTCCCAGCTACTTGGGAGGCTGAGGCAGGAGAATCGCTTGATCCCGAGAGGTGGAGCTTGCCGTGAGCTGAGATTGTGCGCCATTGCACTCCAGCCTGGGCAACAAGAGTGAAACTCCGTCTCTACTAAAAATACAAAAATTAGCCGGGTGTGGTGGCGGGTGCCTGTAATCCAAGCTACTCGGGAGGCTAAGGCAGGAGAATTGCTTGAACCCACGAGGCCGAGGTTGCAGTGAGCCGAGATTGCACTATTGCACTCCAGCCTGGGCGACAAGAGTGAGACTGTGTCTCAAAAAA","GGCTGGGCGCAGTGGCTCACACCTGTAATCCCAGCACTTAGGGAAGCTGAGGCGAGTAGATCACCTGAGGTCAGGAGTTAGAGACCAGCCTGGCCATCATGGTGAAACCCCGTCTCTACTAAAGATACCAAAAATTAGCTGAGTGTGGTGCTGGGTGCCTGTAATCCCAGAAACTCAGGGTGCCTGTAATCCCAGCAACTCAGGGTGCCTTTAATCCCAGCAACTGAGGGTACCAGTAATCCCAGCAACTCAGGGTGTCTTTAATCCTAGCAACTGAGGGCACCTGTAATCCCAGCAACTCAGGAAGCTGAGACAGGAGAAGTACTTGAACCCAGAAGGCAGAGGTTGCAGTGAGCCGATATTGCACCATTGCACTCCAGTCTGGGCAACAAGAGTGAAACTCTGTCTCAAAAAAAAA"
"chr14","12236526","12237360","JH378118","18053084","18053501","465","5816558","GGCTGGGTGGGGTGGCTCACGCGTGTAATCCCAACACTTTTGAGGCTGAGGTGGGTGGATCACTTGAGGTCCGGAGTTTGAGACCAGCCTGGTCAACATGGTGAAACCCCATGTCTCAGGATGGGGAACATCACATACCGGGGCCTGTCGTGGGGTGTGGGGAGGGGAAGGGATAGCATTAGGAGATATACCTAATGTAAATGACAAGTTAATGGGTGCAGCACACCAACATGGCACATGTATACATATGTAACAAACCTGCATGTTGTGCACATGTACCCTAGAACTTAAAGTATAGCAATAAAAAAAAAAAAAGAAACCCCGTGTCTACAAAAAAAATACAAAATTAGGCCAGGCGCAGTGGCACATACCTGTAATCCCAGCACTTTGGGAGGCCAAGGTGGGCAGATCACGAGGTCAGGAGTTTGAGACCAGCCTGTCCAAAATGGTGAAACCCCATCTCTACTAAAAAAATACAAAAATTAGCCAGGCATGGTGGCCCGTGCCTGCAATCCCAGCTACTCAGGAGGCTAAGGCAGGAGAATCACTTGAACGTGGGAGGCGGAGGTTGCAGTGAGCCGAGATCACACCATTGCACTCCAGCCTAGGCAACAGAGCGAGACTCTGTCTCAAAAAAACAAAAAGCAAAAAAACCCAAATTAGCCAGGCATGGTGGTAGTCACCTGTAATCCCAGCTACTTGGGAGGCTTAGGCAGGAGAATCGCTTGAACCCCAGAGGCAGAGGTTGCAGTAAGCCAAGATCGCACCAAGATCACTCCAGCCTGGGCGACAGTGAAACTGTGTCTCAAAAGAAAAAGAAAAAAAAGAAAGAAAA","GGCTGGGCGCAGTGGCTCACACCTGTAATCCCAGCACTTAGGGAAGCTGAGGCGAGTAGATCACCTGAGGTCAGGAGTTAGAGACCAGCCTGGCCATCATGGTGAAACCCCGTCTCTACTAAAGATACCAAAAATTAGCTGAGTGTGGTGCTGGGTGCCTGTAATCCCAGAAACTCAGGGTGCCTGTAATCCCAGCAACTCAGGGTGCCTTTAATCCCAGCAACTGAGGGTACCAGTAATCCCAGCAACTCAGGGTGTCTTTAATCCTAGCAACTGAGGGCACCTGTAATCCCAGCAACTCAGGAAGCTGAGACAGGAGAAGTACTTGAACCCAGAAGGCAGAGGTTGCAGTGAGCCGATATTGCACCATTGCACTCCAGTCTGGGCAACAAGAGTGAAACTCTGTCTCAAAAAAAAA"
"chr14","12551961","12552292","JH378124","27069096","27069413","54","14517135","GGCCAGGCGCGGTGGCTCACGCCTGTAATCCCAGCACTCTGGGAGGCCAAGGCGGACGGATCATCCGAGGTCAGGAGTTTGAGACCAGCCTGGCCAACATGGTGAAACCCCATCTCTACTAAAAATATATATATATATGTATATATATATATATATTAGCCAGGTGTAGTGGTGGGCATCTGTAATCCCAGCTACTCGGGAGGCTGAGGCAGGAGAATTGCTTGAACCCAGGAGGCGGAGGTTGCAGTGAGCTGAGATTGCACCACTGCACTCCAGCCTGGGTGATAAGAATGAGACTCCATCTCAAAACAAACAAACAAACAAATAAAAAA","GGCCGGGCACGGTGGCTCATGCCTGTAATCCCAGCACTTTGGGAGGCCGAGGCGGGTGGATCATGAGGTCAAGAGATCGAGACCATCCTAGTCAACATGGTGAAACTCCATCTCTACTAAAAATACAAAAAAAAAAAAAAATTAGCTGAGCATGGTGGTGCATGCTTGTAATTCCAGCTACTCAGGAGGCTGAGGCAGGAGAATTGCCTGAACCCAGGAGGCGGAGGTTGCAGTGAGCCGAGATTGCGCCATTGCACTCCAGCCTGGGTAATAAGAGTGAAACTCCGTCTCAAAAAAAAAAAACAAAAAAACAAAAAA"
"chr14","15131045","15131391","JH378121","20921542","20921875","62","5790497","GGCTGGGCCCGGTGACTCATGCCTGTAATCCCAGCACTTCGGGAGGACAAGGCGGGTGGATCACCTGAGGTCAGGAGTTCGAGACCAGCCTGGCCAACATGGCGAAACCCCGTCTCTACTGAAAATACAAAAATTAGCCAGGCATGGTGGTGGGCGCCTGTAATCCCAGCTACTCAGAGGCTGAGACAGGAGAATCACTTGAACCTGGGGTGGGGGCGGGGGCGGGGGCGGGGGCGGGGTGGGAGTGGAGGTTGCAGACAGTGAGTGGTGATGGCGCCAGTTCACTCCAGCCTGGGCGAAAGAGTGAAACTCCATCTCAGAAAAAAAAAAAAAAAAAAAAAGTAAAA","GGCTGGGTACGGTGGCTCATGCTGTAATCCCAGCACTTTGGGAGGTCAAAGCAGGCGGATCACCTGAGGTCAGGAGTTTGAGACCAGCCTTGCTAACATGGTGAAACCCCGTTTCTACTAAAAATAAAAAAATTAGCCAGGCGTGGTGGTGTGCACCTGTAATCCCAGCTACTTGGGAGGCTGAAGCAGGAGAGTTGCTTGAACCGGGGTGGTGGGGGGGCAGGGGCAGGGGTGGGTGGCAGGCAGAGGTTGCAGTGAGCCGAGATGGTGCCATTGCACTCCAGCCTGGGCAACAAGAGCAAAACTCCGTCTCAAAAAGAAAAAAAAAAAAGAA"
"chr14","15292066","15292693","JH378118","18053084","18053501","267","2761018","GGCCGGAGACGGTGGCTCACACCTGTAATCCCAGCACTTTGGGAGGCTGAGGCAGGCAGATCACCTGAAGTCAGGAGTTTGAGACCAGCCTGGCCAACATGGTATAAACCCCATCTCTACTAAAAATACAAAAATTAGGCTGGGCGCGGTGGCTCACGCCTGTAATCCCAACACTTTGGGAGGCCGAGGTGGGTGGATCACCTGAGGTCGGGAGTTTGAGACCAGCCTGACCAACATGAAGAAACCCTGTCTCTACTAAAAAAAAAAAAAAATACAAAATTAGCCGGGCATCATGGCACAAGCCTGTAATCCCAGCTACTCAGGAGTCTGAGGCAGGAGAATCGCTTGAACCTGGGAGGCGAAGGTTGCAGTGAGCTGAGATCGTGCCATTGCACTCCAGCCTGGGCAACAAGAGCGAAACTCCTTCTCTAAATAAATAAATAAAAATACAAAAATTTAGCCGGGCATGGTGGCGGGCACCTGTAATCCTAGCTACTTGAGAGGCTGAGGCAGGAGAATCGCTTGAACCCGGGAGGCGGAGGTTGCAGTAAGCAGAGATTGTGCCATTGCACTCCATCCTGGGCAACAAGAGTGAAACTCCATCTCAAAAAAAAAAAAAAAAAAAAAA","GGCTGGGCGCAGTGGCTCACACCTGTAATCCCAGCACTTAGGGAAGCTGAGGCGAGTAGATCACCTGAGGTCAGGAGTTAGAGACCAGCCTGGCCATCATGGTGAAACCCCGTCTCTACTAAAGATACCAAAAATTAGCTGAGTGTGGTGCTGGGTGCCTGTAATCCCAGAAACTCAGGGTGCCTGTAATCCCAGCAACTCAGGGTGCCTTTAATCCCAGCAACTGAGGGTACCAGTAATCCCAGCAACTCAGGGTGTCTTTAATCCTAGCAACTGAGGGCACCTGTAATCCCAGCAACTCAGGAAGCTGAGACAGGAGAAGTACTTGAACCCAGAAGGCAGAGGTTGCAGTGAGCCGATATTGCACCATTGCACTCCAGTCTGGGCAACAAGAGTGAAACTCTGTCTCAAAAAAAAA"
"chr14","15354689","15355313","JH378118","18053084","18053501","269","2698395","GGACGGGCGCAGTAGCTCACACCTGTAATCCTAGCAGTTTGGGAGGCCAAGGTGGGTGGATCACCTGACGTCAGGAGATCGAGACCAGCCTGGACAACATGGCGAAACCCTGTCTCTACTAAAAATACAAAATTAGGGCCAGGTGCGGTGGCTCACGCCTGTAATCCCAGCACTTTGGGAGACTGAGGCGGGCAGATCACCTGAGGTCAGGAGTTCGAGACCAGCCTGGCCAACATGGTGAAACCGCCTCTCTACTAAAAATATAAAAATTGGCTGGGCATTGTAGCAGCCACCTGTAATCCCAGCTACTTGGGGGCCCGAGGCAGAAAAACTGCTTGAACCCAGGAGGCAGAGGTTGTAGTGAGCCGAAATCATGCCACTGCACTCCAGCCTGGGTGACGAGAGTGAGACTCCGTTTCAAAGAAAAAGAAAAAAAATAAAATAAAACACAAAATTAGCCAGTCATGGTGGCAGGCACCTATAATCCCAGCTACCTGGGAGGCTAAGGCAGGAGAATCACTTGAACCCAGGAGGTAGAGGGTGTGGTGAGCCGAGATCACGCCATTGCACTCTAGCCTGGGCAACAAGAGCAAAACTCTGTCTCAAAACAAAAAGTTAAAAAAAA","GGCTGGGCGCAGTGGCTCACACCTGTAATCCCAGCACTTAGGGAAGCTGAGGCGAGTAGATCACCTGAGGTCAGGAGTTAGAGACCAGCCTGGCCATCATGGTGAAACCCCGTCTCTACTAAAGATACCAAAAATTAGCTGAGTGTGGTGCTGGGTGCCTGTAATCCCAGAAACTCAGGGTGCCTGTAATCCCAGCAACTCAGGGTGCCTTTAATCCCAGCAACTGAGGGTACCAGTAATCCCAGCAACTCAGGGTGTCTTTAATCCTAGCAACTGAGGGCACCTGTAATCCCAGCAACTCAGGAAGCTGAGACAGGAGAAGTACTTGAACCCAGAAGGCAGAGGTTGCAGTGAGCCGATATTGCACCATTGCACTCCAGTCTGGGCAACAAGAGTGAAACTCTGTCTCAAAAAAAAA"
"chr14","15366797","15367405","JH378129","11955248","11955630","263","3411549","GGTTGGGTGCGGTGGCTTACCCCTGTAATCCCAGCACTTTGGGGGTACAAAGTGGGAAGATTGCTTGAGCCCAGGAGTTCAAGACCAGCCTGGGCAACTAAGCGAGATCCTATCTCTCAAAAAAATTTTGAAACAACTTTTTGGCCGGGCGCAGTGGCTCACGCCTGTGATCCCAGCACTTTGGGAGGCCAGGGCGGGCGGATCACGAGGTCAGGAGATCAAGACCATCCTGGCTAACACGGTGAAACCCCGTCTCTACTAAAAATACAAAAAATTAGCCGGGTGCGGTGGCGGGCACCTGTAGTCCCAGCTACTCGGGAGGCTGAGGCAGGAGGATGGCGTGAACCCGGGAGGTGGAGCTTGCAGTGAGCTGAGATCGGGCCACTGCACTCCAACCTGGACGACAGATCGAGACTCCGGCTCAAAAAAAAAAAATTAGCTGGGCGTGGTGGCGGGTGCGTGTAATCCCAGCTACTCGGGAGGCTGAGGCAGGAGAATCACTTGAACCTGGGAGGCAGAGGCTGCAGTGAGCCAAGATCGCGCCATTGCACTCCAGCCTGGGCAACAAGAGCGAAACTCTGTCTCTAAATAATAAAATAAAATAAAAAA","GGCTGGGTACGGTGGCTCATGCCTGTAATCCCAGCACTTTGGGAGGTGGGTCACTTGAGGTCAGGAGTTCGAGACCAGCCTGTGCAGTGCCTCCATCCTCAACTGCTGCCTCATCAGCCTGGACCACTACCTGCTCATCCTCTCACCACTGCCACAAGCTGCGCATGAAGCTCCTGCGCGCGCCGGTGCCCGTCTCTACTAAAAATACAAAAATTAGCTGGGTGTGGTGGCAGGTGCCTGTAATCCCAGCTACTCAGGAGGCTGAGGCAGGAGAATCACTTGAACCCAGGAGGCAGAGGTTGCAGTGAGCCGATATCGCATCATTGCACTCCAGCCTGAGCAACAAGAGTGAAATTTTGTCTCAAAAAAAAAAAAAAAAGAAA"
"chr14","15379094","15379705","JH378129","11955248","11955630","265","3423846","GGTTGGGTGCGGTGGCTTACCCCTGTAATCCCAGCACTTTGGGGGTACAAAGTGGGAAGATTGCTTGAGCCCAGGAGTTCAAGACCAGCCTGGGCAACTAAGCGAGATCCTATCTCTCAAAAAAATTTTGAAACAACTTTTTGGCCGGGCGCAGTGGCTCACGCCTGTGATCCCAGCACTTTGGGAGGCCAGGGCGGGCGGATCACGAGGTCAGGAGATCAAGACCATCCTGGCTAACACGGTGAAACCCCGTCTCTACTAAAAATACAAAAAATTAGCCGGGTGCGGTGGCGGGCACCTGTAGTCCCAGCTACTCGGGAGGCTGAGGCAGGAGGATGGCGTGAACCCGGGAGGTGGAGCTTGCAGTGAGCTGAGATCGGGCCACTGCACTCCAACCTGGACGACAGATCGAGACTCCGGCTCAAAAAAAAAAAAAATTAGCTGGGCGTGGTGGCGGGTGCGTGTAATCCCAGCTACTCGGGAGGCTGAGGCAGGAGAATCACTTGAACCTGGGAGGCAGAGGCTGCAGTGAGCCAAGATCGCGCCATTGCACTCCAGCCTGGGCAACAAGAGCGAAACTCTGTCTCTAAATAAATAAAATAAAATAAAAAA","GGCTGGGTACGGTGGCTCATGCCTGTAATCCCAGCACTTTGGGAGGTGGGTCACTTGAGGTCAGGAGTTCGAGACCAGCCTGTGCAGTGCCTCCATCCTCAACTGCTGCCTCATCAGCCTGGACCACTACCTGCTCATCCTCTCACCACTGCCACAAGCTGCGCATGAAGCTCCTGCGCGCGCCGGTGCCCGTCTCTACTAAAAATACAAAAATTAGCTGGGTGTGGTGGCAGGTGCCTGTAATCCCAGCTACTCAGGAGGCTGAGGCAGGAGAATCACTTGAACCCAGGAGGCAGAGGTTGCAGTGAGCCGATATCGCATCATTGCACTCCAGCCTGAGCAACAAGAGTGAAATTTTGTCTCAAAAAAAAAAAAAAAAGAAA"
"chr14","15386894","15387394","JH378114","15957391","15957789","201","570497","GCTGAGTGCAGTGGCTCACGCCTGTAATCCACTTTAGCAGGCCAAAATAGGGGGATCACTTTGAGGCCACGAGTTTGAGACCTGCCTGGGCAACATAGTGAGGCCCCGTCTCTACAAAAATCTTTAAATATTAGAATAACTTTGGGAGGCCGAGGCGGGTGGATCACGAGGTCAAGAGATTGAGACCATCCTGGCCAACATGGTGAAATCCCATCCCTACTAAAGCTACAAAAATTAGCCAGGCGTGGTGGTGTGCGCCTGTAGTCCCAGCTACTCGGGAGACTGAGGCAGGAGAATTGCTTGAATCCGCGTGGCGGAGGTTGCAGTGAGCTGAGATCGCGCCACTGCACTCCAGCCTGGTGACAGAGCGAGACTCCGTCTTAAAAAAAAAAAAAAAAAAAAAAAAAAAAACTTCGGAGGTTGCGGTGAGCCAAGATCACGCCATTGTACTCCAGCCTGGGCCACAAGAGCAAAACTCCGCTTCAAAAAAAAAAAAAAAAA","GCAAGGAACGGTGGCTCATGCCTGTCATCCCAGCACTTTGGGAGGCTAAGGAGGGTGGATTACCGAAGGTCATGAGTTTGAGACCAGCCTGACCAACATGGTGAAAACCCCATCTCTACTAAAAATACAAAAAATTAGCCAGATACAGCTATGCGGCAGACTGGGGCAGGAGAATCGCTTGGACCCAAACCCCATCTCTACTAAAAATACAAAAAATTAGCCGGATACAGCTATGCGGGAGACTGGGGCAGGAGAATCGCTTGGACCCGGGAGGCAGAGATTGCAGTGAGATGAGACCATGCCATTGCTCTCTAGCTTGTGCGATGAGAACAAGACTCTGTCTCAAAAAAAAAAAAAAAAAAAAAAAAAAAAAAAAAAAAAAAAGAGAGAGAGAGAAAA"
"chr14","20140478","20141066","JH378118","18053084","18053501","250","2087394","GCCAGGCGAGGTGGCTCATGCCTGTAATCCCAGCACTTTGGGAGGCTGAGGTGGGTGGAACACTTGAGGTCAGGAGTTCAAGACCAGCCTGGCCAACATGATGAAACCCCCATCTCTACTAAAAACACAAAAATTAGCCAGGAGTGGGCAGGGTGCGGTGGCTCACGCCTGTAATCCCAGCACTTTGGGAGGCTGGGATGGGTGGATCATGAGGTCGGGAGTTCAAGACCAGCCTGGCCAAGATGGTGAAACCCTGTCTCTATTAAAACTTCAAAAATTAGCCAGGCACGGTGGCAGGTGCTTGTAATCCCAGCTACTTGGGAGGCTGAGGCAGGAGAATCACTTGAAACTGGGCGGCAGAGGTTGCAGTGAGCCAAGATCGCGCCACTGGACTCCAGACTGGGCGACACAGTGAGATACCGTCTCAAAAAAAAAAAAAAAAAAAATTAGCCAGGAGTGGTGGCGGAAATCCCAGCTACTTGAGAGGCTGAGGCAGGAGAATCGTTTGAACCCAGGAGGCAGAGGTTGCAGTGAGCCAAGATCTTGCCATTGCACTCCAGCTTGGGAGACAAGAGCAAAACTCTGTCTC","GGCTGGGCGCAGTGGCTCACACCTGTAATCCCAGCACTTAGGGAAGCTGAGGCGAGTAGATCACCTGAGGTCAGGAGTTAGAGACCAGCCTGGCCATCATGGTGAAACCCCGTCTCTACTAAAGATACCAAAAATTAGCTGAGTGTGGTGCTGGGTGCCTGTAATCCCAGAAACTCAGGGTGCCTGTAATCCCAGCAACTCAGGGTGCCTTTAATCCCAGCAACTGAGGGTACCAGTAATCCCAGCAACTCAGGGTGTCTTTAATCCTAGCAACTGAGGGCACCTGTAATCCCAGCAACTCAGGAAGCTGAGACAGGAGAAGTACTTGAACCCAGAAGGCAGAGGTTGCAGTGAGCCGATATTGCACCATTGCACTCCAGTCTGGGCAACAAGAGTGAAACTCTGTCTCAAAAAAAAA"
"chr14","32019134","32019479","JH378197","6655183","6655524","67","25363951","GGCTGGGGCAGTGGCTCACTGTAATTCCAGCACTTGGCCAAGGCAGGTGGATCACCTGAGGTCAGGAGTTCAAGACCAGCAGGGCCAACATGGTGAAACCCTATCTCTAAAAATAAATAAATAAATAAATAAATAAAATAAAATAAAATAAAATAAAAAATAAAAAAAATTAGCTGGGCGTTGTGGTGGGCGCCTGTAATCCCAGCTACTTGGGAGGCTGAGGCAGGAGGATCGCTTGAACCTGGAAGGCAGAGGTTGCAGTGAGCCGAAATCACATAATTGCACTCCAGCCTGGGCGACAAGAGCAAAACTCCATCTCAAAAAAAAAAAAAAAAAAAAAAAAAAA","GGCCGGGCGCAGTGGCTCATGCCTGTAATCCCAGCACTTTGGGAGGCAGAGGCGGGCAGATCACCCAAGGTCAGGAGTTCAAGACCAGCCTGGCTAACATGGTGAAACCCCATTTCTACTAAAAATACAAAAAAAAAAAAAAAAAAAAAAAAAAAAAAAAAAAAAAATTAGCTGAGCGAGGTGGTGGGCACATGTAATCCCAGCTACTTCGGAGACTAAGGCAGGACAATTGCTTAAGCCTGGGAGGCAGAGGTTGTAGTAAGCTGAGATCACACCATTGCACTCCAGCTTGAGCAACAAGAGCGAAACTCCGTCTCAAAAAAAAACCCAAAAAACAAAAAA"
"chr14","39734996","39735596","JH378118","18053084","18053501","237","21681912","GGCTGGGCGCGGTGGCTCATGCCTGTAATCCCAGCATTTTGGGAGGCCGAGGCGGGTGGATCACCTGAGGTCAGGAGTTTGAGACCAGCCTGGCCAACATGGTGAAACCCTGTCTCTACTAAAAATGCAAAAATTAGGCTGGTGCAGTGGCTCACGCCTGTAATCACAGCACTTTGGGAGGCCGAGGTGGGCGGATCACGAGGTCAGGAGATCGAGACCATCCTGGCTAATACAATGAAACCCCGTCTCTATGAAAAATACAAAAAATTAGCCGGGCGTAGTGGCAGGCGTCTGTAGTCCCAGCTACTCAGGAGGCTGAGGCAGGAGAATGGCATGAACCTGGGAGGCGGAGCTTGCAGTGAGCCGAGATTGCGCCACTGCACTCCAGCCTGGGCGACAGCGAGACTCTGTCTCAAAAAAAAAAAAAAAAATTAGCTAGGCATGGTGGCGCATGCCTGTAATCCCAGCTACTTGGGAGGCTGAGGCAGGAGAATCGCTTGAACCTGGGAGGCAGAGGCTGCAGTGAGACAAGATCACGCCATTGCACTCCAGCCTGGGCAACAAGAGTGAAACTCCATCTTCCCCCTACCAAAAAAAAAAA","GGCTGGGCGCAGTGGCTCACACCTGTAATCCCAGCACTTAGGGAAGCTGAGGCGAGTAGATCACCTGAGGTCAGGAGTTAGAGACCAGCCTGGCCATCATGGTGAAACCCCGTCTCTACTAAAGATACCAAAAATTAGCTGAGTGTGGTGCTGGGTGCCTGTAATCCCAGAAACTCAGGGTGCCTGTAATCCCAGCAACTCAGGGTGCCTTTAATCCCAGCAACTGAGGGTACCAGTAATCCCAGCAACTCAGGGTGTCTTTAATCCTAGCAACTGAGGGCACCTGTAATCCCAGCAACTCAGGAAGCTGAGACAGGAGAAGTACTTGAACCCAGAAGGCAGAGGTTGCAGTGAGCCGATATTGCACCATTGCACTCCAGTCTGGGCAACAAGAGTGAAACTCTGTCTCAAAAAAAAA"
"chr14","49081899","49082239","JH378114","14264965","14265292","65","34816934","GGCCAGGTACAGTGGCTCATGCCTGTAATCTCAGCATTTTGGGAGGCTGAGGCAGGCAGATCACCTGAGGTCAGGAGTTCGTGACCAGCCTGACCAGTGAAACCCTGTCTCTACTGAAAAAAATAAAATAAAATAAAATAAAAATAAAAATTAGCTGGGTGTGGTGGTGGGCGCCTGTAATCCCAGCTACTCGGCAGGCTGAGGCAGGAGAATTGCTTGTACCCGGGAGGCGGAGGTTGCAGTGAGCCAAGATCATGCCATTGCACTACAGCCTAGGTGACAAGAGCAAAACTCTGTCTCAAAACAAAACAACAACAACAACAACAACTAAAAAAAAAAAA","GGCCAGGCGCGGTGGCTCAAGCCTGTAATCCCAGCACTTTGGGAGGCCGAGGCGGGTGGATCATGAGGTCAAGAGATCGAGACCATCCTGGTCAACATGGTGAAACCCCGTCTCTACTAAAAACAGAAAAAAAATAAAAATAAAAATAATTAGCTGGGCATGGTGGAGCATGCCTGTAATCCCAGCTACTCAGGAGGCTGAGGCAGGAGAATTGCCTGAACCGAGGAGGCGGAGGTTGCGGGGAGCCAAGATCGCGCCATTGCACTCCAGCCTGGGCAACAAGAGCGAAACTCCGTCTCAAAAAAAAAAAAAAAAAAAAAAAAAAAAA"
"chr14","54833704","54834332","JH378118","18053084","18053501","272","36780620","GGCCAGGTGCAGTGGCTCACTCCTGTAATTCCAGCACTTTGGGAGGCTGCCGGTGGATCACCTGAGGTCAGGAGTTCGAGATCAGCCTGGCCAACATGGTGAAACCCCGTCTCTACTAATAATACAAAAATTAGCCAGGCAAGGCCGGGCGCAGTGGCTCACACCTGTAATCCCAGCACTTTGGGAGGCCGAGGCGGGCGGATCACCTGAGGTCGGGAGTTCAAGACCAGCCTGACCAACATGGAGAAACCCCATCTCTACTAAAAATACAAAATTAGCTGGGCATGGTGGCACATGCCTGTAATCCCAGCTACTAGGGAGGCTGAGGCAGGCGAATCGCTTGAACCTGGGAGGTGGAGGTTGCGGTGGGCCGAGATGGTGCCATTGCACTCTAGCCCGGGCAACAAGAGCGAAACTCTGTCTCAAAAAAAAAAAAAAAAAAAAAAAAATTAGCCAGGCATGGTAGCACACCCTTGTAATCCCAGCTACTCGGGAGGCTGAGGCAGGAGAGTTGCTTGAACCCGAGAGACGGAGGTTGCAGTGAGCTGAGATCGTGCCATTGCACTCCAACCTGGGTGACAAGAGTGAAACTCCATCTCCAAAAAAAAAAATAAATAAAATAAATAAAA","GGCTGGGCGCAGTGGCTCACACCTGTAATCCCAGCACTTAGGGAAGCTGAGGCGAGTAGATCACCTGAGGTCAGGAGTTAGAGACCAGCCTGGCCATCATGGTGAAACCCCGTCTCTACTAAAGATACCAAAAATTAGCTGAGTGTGGTGCTGGGTGCCTGTAATCCCAGAAACTCAGGGTGCCTGTAATCCCAGCAACTCAGGGTGCCTTTAATCCCAGCAACTGAGGGTACCAGTAATCCCAGCAACTCAGGGTGTCTTTAATCCTAGCAACTGAGGGCACCTGTAATCCCAGCAACTCAGGAAGCTGAGACAGGAGAAGTACTTGAACCCAGAAGGCAGAGGTTGCAGTGAGCCGATATTGCACCATTGCACTCCAGTCTGGGCAACAAGAGTGAAACTCTGTCTCAAAAAAAAA"
"chr14","55277737","55278067","JH378148","10302642","10302970","61","44975095","GGCCGGGTGCAGTGGCCCACCTCTGTAATCCTAACACTTTGGGAGGCCAAGGCAGGCAGGTCACTTGAGGTCAGGAGTTCAAGACTAACCTGGCCAACATGGTGAAACCCCGTCTCTACTAAAAATACGAAAATTAGCCGGGCTTCATGATGCATGCCTGTAATCCCAGCTACTAAGGAGGCTGAGGCAGAAGAATCTCTTGAACCCATGAGGTTGCAGTGAGCTGAGATCTCGCCATTGCACTCCAGCCTGGAGGACAAGAGCGAAACTCTGTCTCAAAAAAATAAAATAAAATAAATAAGAATAAAATAATAATAAAAGGCAAAAAGAA","GGCCGGGCGCGGTGGCTCAAGCCTGTAATCCCAGCACTTTGGGAGGCCGAGGCGGGTGGATCACGAGGTCAAGAGATCGAGACCATCCTGGTCAACATGGTGAAACCCCGTCTCTACTAAAAATACAAAAAATTAGCTGGGCATGGTGGTGGGTGCCTGTAATCCCAGCTACTCAGGAGGCTGAGGCAGGAGAATTGCCTGAACCCAGGAGGCGGAGGTTGCGGTGAGCCGAGATCGCGCCATTGCACTCCAGCCTGGGTAACAAGAGTGAAACTCTGCCTCAAAAAAAAAAAATAAAATAAAATAAAATAAAATAAAATAAAATAAAA"
"chr14","55822103","55822700","JH378118","18053084","18053501","240","37769019","GGCCAGGCGCAGTGGCTCACGCCTGTAATCCCAGCACTTTAGGAGGCCGAGGCAGGTGGATCGCCTGAGTTCAGGAGTTCAAACCCACCCTGGCCAACATGGTGAAACCCTGCCTCTACTAAAAAACAAAAAAATGGCCAAGCGTGGTGGCTCACGCCTGTAATTCCAGCACTTTGGGAGGCTGAGGCAGGCGAATCACGAGGTCAGGAGATCGAGACCATCCTGGCTAACATGGTGAAACCCCATCTCTATTAAAAATACAGAAAATTAGCCAGGCGTGGTGGTGGACGCCTGTAGTCCCAGCTTCTTGGGAGGCTGAGGCAGGAGAATGGCATGAACCCGGGAGGCAGAGCTTGCAGTGAGCTGAGATTGCGCCAGTGCACTACAGCCTGTGGGACAGAGCAACTCCGTCTCAAAAAAAAAAAAAATTAGCTGGGCATGGTGGCATATGCCTGTAATCCCAGCTACTAAGGAGGCTGAGGCGGGAGAATCGCTTGAACCCGGGAGGCAGAGGTTGCAGTGAGCCGAGATTGCGCCATTGCACTCCAGTCTGGACAACAAGAGTGAACTGTGTCTCAAAAAAAAAAAAAAAAAAAGA","GGCTGGGCGCAGTGGCTCACACCTGTAATCCCAGCACTTAGGGAAGCTGAGGCGAGTAGATCACCTGAGGTCAGGAGTTAGAGACCAGCCTGGCCATCATGGTGAAACCCCGTCTCTACTAAAGATACCAAAAATTAGCTGAGTGTGGTGCTGGGTGCCTGTAATCCCAGAAACTCAGGGTGCCTGTAATCCCAGCAACTCAGGGTGCCTTTAATCCCAGCAACTGAGGGTACCAGTAATCCCAGCAACTCAGGGTGTCTTTAATCCTAGCAACTGAGGGCACCTGTAATCCCAGCAACTCAGGAAGCTGAGACAGGAGAAGTACTTGAACCCAGAAGGCAGAGGTTGCAGTGAGCCGATATTGCACCATTGCACTCCAGTCTGGGCAACAAGAGTGAAACTCTGTCTCAAAAAAAAA"
"chr14","55860214","55860812","JH378118","18053084","18053501","246","37807130","GGCCGGATGCAGTGGCTCACGCCTGTAATCCCAGCACTTTGGGAGGCCAAGGCAAGCGGATCACCTGAGGTCAGGAGTTCAAGACCAGCCTGGCCAGCATGGTGAAACCCCTTCTCTACTAAAAATACAAAAATTAGCCGGGGCCTTGCGTGGTGGCTCACACCTGTAAATCCCAGCGCTTTGGGAGGCCGAGGCAGGCGGATCACCTGAGGTCGGGAGTTCAAGAACAGCCTGACCAACATGGAGAAACCCCGTCTCCACTAAAAATAGAAAAATAGCCGGGCATGGTGGCGCATGCTTGTAATCTCAGCTACTCGGGAGGCTGAGGCAGGAGATCACTTGAACCCAAGAGGCAGAGGTTGCGGTGAGCCGAGATCGCGCCATTGCACTCCAGCCTGGGCAACAAAGAGCGAAACTCCGTCTCCAAAAAAAAAAAAAAAAAATTAGCCGGGCGTGGTGGCACATACCTGTAATCCCAGCTATTCAGGAGGCTGAGGCAGGAGAATCCCTTGAACCCGGGAGGCAGAGATGGCAGTGAGCTGAGATCACGCCATTGCACTCCAGCCTGGGTGAGAGGAGTGAAACTCCGTCTAAAAAAA","GGCTGGGCGCAGTGGCTCACACCTGTAATCCCAGCACTTAGGGAAGCTGAGGCGAGTAGATCACCTGAGGTCAGGAGTTAGAGACCAGCCTGGCCATCATGGTGAAACCCCGTCTCTACTAAAGATACCAAAAATTAGCTGAGTGTGGTGCTGGGTGCCTGTAATCCCAGAAACTCAGGGTGCCTGTAATCCCAGCAACTCAGGGTGCCTTTAATCCCAGCAACTGAGGGTACCAGTAATCCCAGCAACTCAGGGTGTCTTTAATCCTAGCAACTGAGGGCACCTGTAATCCCAGCAACTCAGGAAGCTGAGACAGGAGAAGTACTTGAACCCAGAAGGCAGAGGTTGCAGTGAGCCGATATTGCACCATTGCACTCCAGTCTGGGCAACAAGAGTGAAACTCTGTCTCAAAAAAAAA"
"chr14","56736257","56736880","JH378206","6546474","6546861","276","50189783","GGCCAGGCACAGTGGCTCATGCCTGTAATCCCTGCACTTTGGGAGGCCAAGGCGGGTGGATCACCTGAGGTCAGGAGTTCGAGACTAGCCTGGCCAACATGGTTGGCCATCTCTTCTAAAAATACAAAAAATTAAGTTGGGCATGGTGGCTCATGCCTGTAATCCCAGCATTTTGGGAGGCCAAGGCAGGTGGATCATAAGGTCAAGAGATTGAGACCATCCTGGCCAACATGGTGAAACCCCATCTCTACTAAAAATACAAAAATTAGCTGGGCGTGGTGGTAGCACACACCTGCAGTCCCAGCTGCTCAGGAGGCTGAGGCAGGAGAATCACTTGAACCCGGGAAGCAGAGGTTGCAGTGAGCCGAAATTGCACCACTGCACTCCAGCCTGGCGACAAAGCAAGACTCCGTCAAAAAAAAAAAAAAAAAAAAAAAAATTAGCCAGGAGTGGTGGCACGTGCCTATAGTTCCAGCTACTCGGGAGGCTGAGGCAAGAGATTTGCTTGAACCTGGGAAGCAGAGGTTGCATATATTGCAGTGAGCCAAGATTATGCCATTGCACTCCAGCCTGGGCAACAAGAGTGAAAATCTGTCTAAAAAGAAAAAAAAAAGAAAAGAAAAA","GGCCACACATGGTGGCTAACGCCTGTAATCCCAGCACTTTGGGAGGCCAAGTCGGGTGGATCATGAGGTCAGGAGACCAAGACCATCCTGGCCAAATGGTGAAACCCCGTCTCTACTAAAAATACAAAAATTAGCTGGGCATGGTGGCGTGTGCCTGTAATCCCAGCTACTCAGGAGGCTGAGGCAGGACAATTGCCTGAACCCAGGAGAATTAGCTGGGCATGGTGGCGTGTGCCTGTAATCCCAGCTACTCAGGAGGCTGAGGCAGGACAATTGCCTGAACCCAGGAGGCGAAGGTTGCGGTGAGCCGAGATTGTGCCATTGCACTCCAGCCTGGGTAACAAGAGCGACACTCTGTCTCAAAAAAAAAAAAAAAAAAAAAAAAAAA"
"chr14","56744047","56744674","JH378118","18053084","18053501","281","38690963","GGCCGGGTGCGGTGACTCACATCTATAATCCCAGCACTTTGGGAGGCCAAGGCAGGTGGATCACCTGAGGTCAGGAGTTCAAGACCAGCCTGGCCAACTTGGTGAAACCCCATCTCTACTAAAAAATATAAAAATTTGCCAGGTGCGGTGGCTCATACCTGTAATCCCAGCACTTTGAGAGGCAGAGGTGGGTGGATCACGAGGTCAGGAGTTCGAGACCAGCCTGGCCAATGTGGTGAAACCCCATCTCTACTAAAAATACAAAAATTAGCCGGGTGTGGTGATGCGTGCCTGTAGTCCCAGCTATTCGGGAGGTTGAGGCAGGAGAATGGCGTGAACCAGGAAGGCGGAGCTTTCACTGAGCGGAGATCGCACCACTGCACTCCAGCCTGGGCGACGGAGCGAGACTCTGTCTCAAAAACAAAACAAAACAAAAAAACAAACAAACAAAAAAACATTATCCGGGTGTGGTGGTGGGCGCCTGTAATCCCAGCTACTTGGGAGGCTGAAGCAGGAGGATTGCTTGAACCTGGGAGGTGGAGGTTGCAGTGAGCTGAGATCACGCCTCTGCACTGCAGGCTGGACGACAAGAACAAAACTCTGAATCAACAACAACAACAACAAAAAA","GGCTGGGCGCAGTGGCTCACACCTGTAATCCCAGCACTTAGGGAAGCTGAGGCGAGTAGATCACCTGAGGTCAGGAGTTAGAGACCAGCCTGGCCATCATGGTGAAACCCCGTCTCTACTAAAGATACCAAAAATTAGCTGAGTGTGGTGCTGGGTGCCTGTAATCCCAGAAACTCAGGGTGCCTGTAATCCCAGCAACTCAGGGTGCCTTTAATCCCAGCAACTGAGGGTACCAGTAATCCCAGCAACTCAGGGTGTCTTTAATCCTAGCAACTGAGGGCACCTGTAATCCCAGCAACTCAGGAAGCTGAGACAGGAGAAGTACTTGAACCCAGAAGGCAGAGGTTGCAGTGAGCCGATATTGCACCATTGCACTCCAGTCTGGGCAACAAGAGTGAAACTCTGTCTCAAAAAAAAA"
"chr14","58283278","58283584","JH378115","34663603","34663898","52","23619675","CCGGGTGCGGTGGCTCACGCCTGTAATCCCAGCACTTTGGGAAGCTGAGGTGGGTGGATCATTTGAGGTCAAGAGTTCTAGACCAGCCTGGCCAACATGGTGAAACCCTACTTCTAATAAACACACACACACACACACACACACACACACACACACAAATTAGCCAGCAGGCACCTGTAATCCCAGCTACTCGGAAGGCTGAGGCAGGACAATCGCTTGAACCTGGGAGGCCAGAAGTTGCAGTGAGCCAAGATCATGCCACTGCACTCCAGTCTGGGTGACAAGAGCAAGACTCCATTTCAAAAAA","GGCCTGGTGAAGTGGCTCACGCCTGTAATCCCAACACTTTGGGAGGCTGAGATGGATGGCTCATTTGAGGTCAGGAGTTCTAGACCAGCCTGGCCAACATGGTAAAAGCCCACCTCTACCAAAAATACAAAAACAAAAACAAAAAAATTTTAGCCAACAGGCACCTTTAATCCCAGCTACTCAGGAGGCTGAGGCAGGAGAATTGCTTGAATCTGGGAGGCCAGAAGTTGCAGTGAGCCAGGATCACACCACTGCACTCCATCCTAGGCGACAAGAGCAAGACTCCAAAAAAAAAA"
"chr14","59226808","59227410","JH378118","18053084","18053501","257","41173724","GGCTGGGCGCTGTGGCTCATGCCTGTAATCCCAGCACTTTAGGAAGCCAAGGGAGGTGGATCACCTGAGGTCAGAGTTCAAGTCCGGCCTGACCAACATGGCGAAACCCAGTCTCTACTAAAAATACAAAATTGGCCAGGCGTGGGGTGGCTCACACCTGTAATCCCAGCACTTTGGGAGGCCGAAGTGGGTGGATCACTTGAGGTCAGGAGTTTGAGACCAGCCTGGTTAACATGGTGAAACCCCATCTCTACTAAAAATACAAAAATTAGCCAGGCATGGTGGCAGGCGCCTGCAATCCCAGTTACTCAGGAGGCTGGTGCAGGAGAATCGCTTAAACCTAGGAGGCAGAGGTTGCAGTGAACTGAGATCGTGCCATTGCACTCCAGCCTGGGTAACAACAGCAAGACTTCATCTCAAAAAAAAAAATACATAATTATAATTAGCTGGGCGTGTTGGCGAGCGCCTGTAGTCCCTGCTACTTGGGAGGCTGAGGCAGGGGAATCACTTGAACCTGAGAGGCGGAGGTTGCAGTGAGCCAAGTCACGCCATTGCATTCCAGCCTCGGCAACAAGAGCAAAACTCCATCTCAAAAAAAAAAAA","GGCTGGGCGCAGTGGCTCACACCTGTAATCCCAGCACTTAGGGAAGCTGAGGCGAGTAGATCACCTGAGGTCAGGAGTTAGAGACCAGCCTGGCCATCATGGTGAAACCCCGTCTCTACTAAAGATACCAAAAATTAGCTGAGTGTGGTGCTGGGTGCCTGTAATCCCAGAAACTCAGGGTGCCTGTAATCCCAGCAACTCAGGGTGCCTTTAATCCCAGCAACTGAGGGTACCAGTAATCCCAGCAACTCAGGGTGTCTTTAATCCTAGCAACTGAGGGCACCTGTAATCCCAGCAACTCAGGAAGCTGAGACAGGAGAAGTACTTGAACCCAGAAGGCAGAGGTTGCAGTGAGCCGATATTGCACCATTGCACTCCAGTCTGGGCAACAAGAGTGAAACTCTGTCTCAAAAAAAAA"
"chr14","62992080","62992681","JH378118","18053084","18053501","256","44938996","GGCCGGATGCAGTGGCCCACACCTGTAATCCTAGCACTTTGAGAGGCTGAAGCAGGCAGATCACTTGCGGTCAGGAGTTTGAGACCAGCCTGGCCAACATAGTAAAACCTCATCTCTACTAAAAATAGAAAAATTTTCTGACCAGGCACGGTGGCTCGCGCCTGTAATCCCAGCACTTTGGGAGGCCAAGGTGGGCACATTACCTGAGATCAAGAGTTCAAGACCAGCCTGACCAACATGGCAAAACTCTGTCTCTACTAAAAATACAAAATTAGCCGGGCATAGTGGCGCATTCCTGTAATCCCAGCTACTAAGGAGGCTGAGGCAGGAGAATTGCTTGAACCCGGGAGCCGGAGGTTGCAGTAAGCCAAGATTGCGCACTGCACTCTAGGCTGGGCAACAACAGCGAAACTCTGTCTCGAAAAAAAAAAAAAAAAAAATTAGCTGGGCGTGGTGGTGAGTACCTGTAATCCCAGCTACTTGGGAGACTGAGGCAGGAGAATCTCTTGAACCTGGGAGGTAGAGGTTGCAGCGAGCTTAGATCACACCACTGCACTAAAGCCTGGGGGACAAGAGCAAAACTCTATCTCAAAAAAATAAAA","GGCTGGGCGCAGTGGCTCACACCTGTAATCCCAGCACTTAGGGAAGCTGAGGCGAGTAGATCACCTGAGGTCAGGAGTTAGAGACCAGCCTGGCCATCATGGTGAAACCCCGTCTCTACTAAAGATACCAAAAATTAGCTGAGTGTGGTGCTGGGTGCCTGTAATCCCAGAAACTCAGGGTGCCTGTAATCCCAGCAACTCAGGGTGCCTTTAATCCCAGCAACTGAGGGTACCAGTAATCCCAGCAACTCAGGGTGTCTTTAATCCTAGCAACTGAGGGCACCTGTAATCCCAGCAACTCAGGAAGCTGAGACAGGAGAAGTACTTGAACCCAGAAGGCAGAGGTTGCAGTGAGCCGATATTGCACCATTGCACTCCAGTCTGGGCAACAAGAGTGAAACTCTGTCTCAAAAAAAAA"
"chr14","75046278","75046878","JH378118","18053084","18053501","246","56993194","GGCCGGGCACAGTGGCTCACACCTATAATCTCAGTACTTTGGGAGGCCAAGGCGGGCAGATCACTTGAGGTCAGGAGTTCGAGACCACCCTGGCCAACATGGTGAAACCTCATCTCTACTAAAAATACAAAAAACTGGCTGGGTGAAGTGGCTCACGCCTGTAATCCCAGCAGTTTGGGAGGCCAAGGCGGGCCAATCACGAGGTCAGGAGTTCGAGACCAGCCTGGCCAATATGGTGAAACCCCGTCTCTATTAAAAATTCAAAAATTAGCTGGATGTGGTGGCAGGCACCTACAATCCCAGCTACTTGGAAGGCTGAGGCAGGAGAGTCTGCTTGAAACCAGAAGGCGGAGGTTGCAGTGAGTGAGCTGAGAACGTGCCACTGCACTCCAGCCTGGGCGAAAGAGCAAAACGCTGTCTCAGGGGGAAAAAAAAAACTAGCCGGGCATGGTGGCAGGTGCCTGTAATCCCAGCTACTCAGGAGGCTGAGGCAGGAGAATTGCTTGAACCCAGGAGGAGGAGGTTGCAGTGAGTCGAGATCACGTCATTGCACTCCCAGCCTGGCTGATAAGAGCGAAACTCCGTCAAAAAAAAAAAAAAA","GGCTGGGCGCAGTGGCTCACACCTGTAATCCCAGCACTTAGGGAAGCTGAGGCGAGTAGATCACCTGAGGTCAGGAGTTAGAGACCAGCCTGGCCATCATGGTGAAACCCCGTCTCTACTAAAGATACCAAAAATTAGCTGAGTGTGGTGCTGGGTGCCTGTAATCCCAGAAACTCAGGGTGCCTGTAATCCCAGCAACTCAGGGTGCCTTTAATCCCAGCAACTGAGGGTACCAGTAATCCCAGCAACTCAGGGTGTCTTTAATCCTAGCAACTGAGGGCACCTGTAATCCCAGCAACTCAGGAAGCTGAGACAGGAGAAGTACTTGAACCCAGAAGGCAGAGGTTGCAGTGAGCCGATATTGCACCATTGCACTCCAGTCTGGGCAACAAGAGTGAAACTCTGTCTCAAAAAAAAA"
"chr14","83813857","83814442","JH378118","18053084","18053501","240","65760773","GGCCAGGCGCGGTGGCTCACGCCTGTAATCCCAGCACTTTGGGAGGCCGAGGCGGGCGGATCACCTGAGGTCAGGGGTTCAAGACCAGCCTGACCATCCCAGAACTTTGGGAGGCCGAGACGGGTGGATCATGAGGTCAGGAGATCGAGACCATCCTGGCTAACACAGTGAAACCCCATCTCTATTAAAAATACAAAAAATTAGCCGGGCGTGGTGGCAGCTCCTGTAGTCCCAGCTACTCGGGAGGCTGAGGCAGGAGAATGGCGTGAACCCGGGAGGCGGAGCTTGCCGTGAGCCGAGATCGCACCACTGCACTCCAGCCTGCAAGATAGCGAGGCTATGTCTCAGGAAAAAAAAAAAAAAAAAAAAAAAGACCAACCTGACCAACATGGTAAAACCCCATCTCTACTAAAAATACAAAATTAGCCGGGCATGGTGGCAGACGCCTGTAATCCCAGCTACTCAGGAGGCTGAGGCAGGAAAATCACTTGAACCCAGGAGGTGGAGGTTGCGGTGAGCCGAGATCGTGCCATTGCACTCCGGCCTGGGTGACAACAGCGAAACTCCATCTCAAAAAAAAGAAAAA","GGCTGGGCGCAGTGGCTCACACCTGTAATCCCAGCACTTAGGGAAGCTGAGGCGAGTAGATCACCTGAGGTCAGGAGTTAGAGACCAGCCTGGCCATCATGGTGAAACCCCGTCTCTACTAAAGATACCAAAAATTAGCTGAGTGTGGTGCTGGGTGCCTGTAATCCCAGAAACTCAGGGTGCCTGTAATCCCAGCAACTCAGGGTGCCTTTAATCCCAGCAACTGAGGGTACCAGTAATCCCAGCAACTCAGGGTGTCTTTAATCCTAGCAACTGAGGGCACCTGTAATCCCAGCAACTCAGGAAGCTGAGACAGGAGAAGTACTTGAACCCAGAAGGCAGAGGTTGCAGTGAGCCGATATTGCACCATTGCACTCCAGTCTGGGCAACAAGAGTGAAACTCTGTCTCAAAAAAAAA"
"chr14","84224287","84224910","JH378118","18053084","18053501","265","66171203","GGCAGGGTGCAGTGGCTCATACCTGTAATCCCAGCACTCTGGGAGGCCGAGGTGGGCAGATCACTTGAGCTCAGGAGTTTGAGACCAGCCTGGCCAACATAGTGAAACCCCATCTCTACTAAAAATACAAAATTAGGCTGGGCACAGTGACTCACGTCTGTAATCCCAGCACTTTGGGAGGCCGAGGCTGGTGGATCACAAGGTCAGGAGATCAAGACCATCCTGTCCAACATAGTGAAACCCCATCTCTACTAAAAATACAAAAATTAGCTGGACGTGGAGGTGCACATCTGTAGTCCCAGCTACTTGTGAGGCTGAGGCAGGAGAACTGCTTGAACCCAGGAGGCGGAGGCTGCAGTGAGCTGAGATTGTGCCACTGCACTCCAGCCTGGGCGACAGAGCGAGACTCTGTCTCAAAAAAAAAAAAAAACAGAAAAAACAAAATTAGCCGGGCATGGTGGTGCACGCCTGTAACCCCAGCTACTTGGGGGGCTGAGGCAGGAGAATTGCTTGAACCTGAGAGGTGGAGGTTTCAGTGAGCCGAGATTGTGCCATTGCCCTCCAGTCTGGGCAACAAGAGCAAAACTCCGTCTCAAAAAAAAAAAAAAGAAAAAAAAAGAAGAA","GGCTGGGCGCAGTGGCTCACACCTGTAATCCCAGCACTTAGGGAAGCTGAGGCGAGTAGATCACCTGAGGTCAGGAGTTAGAGACCAGCCTGGCCATCATGGTGAAACCCCGTCTCTACTAAAGATACCAAAAATTAGCTGAGTGTGGTGCTGGGTGCCTGTAATCCCAGAAACTCAGGGTGCCTGTAATCCCAGCAACTCAGGGTGCCTTTAATCCCAGCAACTGAGGGTACCAGTAATCCCAGCAACTCAGGGTGTCTTTAATCCTAGCAACTGAGGGCACCTGTAATCCCAGCAACTCAGGAAGCTGAGACAGGAGAAGTACTTGAACCCAGAAGGCAGAGGTTGCAGTGAGCCGATATTGCACCATTGCACTCCAGTCTGGGCAACAAGAGTGAAACTCTGTCTCAAAAAAAAA"
"chr14","85020958","85021268","JH378108","34510794","34511096","52","50510164","GCCAGGTGCAGTGGCTCATGCCTGTAATTCCAGTACTTTGAGAGGTCGAGACAGGGAGATCACCTGAGGCCAGGAGTTCAAGACTAGCTTGGCCAACATGGCAAAACCCTGTCTCTACTAAAAATGCAAAAAAAAAAAAAAAAAAAAAAAAAAAATTAGCCTGGCATGGTGGTAGACACCTGTAATCCCAGCTACTTGGGAGGCTGAGACAGGAGAACCTCTTGAATCTGGGAGGAGGAGGTTGCTGTGAGCTGAGATCGTGCCACTGCACTCCAGCCTGGGTAACAAGAGAGAAACTCTGTCTCAAAAAA","GGGTGCCGTGTCTCATGCCTGTAATTCCAGCACTTTGGGAGGTCAAGGCAGTCCGATCACCTGAGGTCAGGAGTTTGAGACTAGCCTGGCCAAAATGGTGAAACCCTGTCTCTAGAAAAAATACAAAAAAAAAAAAAAAAAAAAAAAAAAATTAGCTGGATGTAGTGGTGCATACCTGTAGTCCCAGCTACTCTGGAGGCTGAGGCAGGAGAATTGTTTGAACCCAGGAGGCGGAGGTTGCGGTGAGCCGAGATCATGCCATTGCACTCCAGCCTGGGAAACAAGAGTGAAACTCTGTCTCAA"
"chr14","86696589","86696920","JH378203","2698403","2698735","56","83998186","GGCCAGGCACGGTGGCTCATGCCTATAACCAGCACTTTGGAGGCCGAGGCAGGTGGATCACCTGAGGTCAGGAGTTTGAGACTGGCCTGGCCAGCATGGTGAAACTCTGTCTCTACTAAAAAAAAAAAAAAAAAAAAAAAAAAAAAAGTACAAAATTAGCTGGATGTGGTGGTAGGCACCTGTAATCCCAGCTACTTGGGAGGCTGAGGCAGGAGAATCGCTTGAACCCAGGAGGCAGAGATTGCAGTGAGCCAAGATTGCGCCATTGTACTCCACTCTGGGCAATGAGCGAAACTCCGTCTCAAAAAAAAAATAAAATAAAAATAAAATAA","GCCGGGTGCAGTGGCTCATACCTCTAATCCCAGCACTTTGGGAGGCCAAGGCAGGTGATCACCTGTGGTCAGGAGTTCGAGACCAGCCTGGCCAACATGGTGAAACCCTGTCTTTACTAAAAATACAAAAAAAAAAAAAAAAAAAAAAAAAAAAAACTTAGCCCACCATGGTGGTGGGCTCTTGTAGTCCCAGCTACATGGGAGGCTGAGGCAGAAGAATCGCTTGAAGACAGGAGGTGGAGGTTGCAGTGAGCCAAGACTGCGCCATTGCACTCAGCCTGGGTGACGAGCCAAACTCCATCTCAAAAAAAAAAAAAAAAAAAAAAAAAAAAA"
"chr14","86944567","86945185","JH378118","18053084","18053501","274","68891483","GAGCACGGTGGCTCACGCCTGCAATCCCAGCACTTTGGGAGGCCGAGGTGGGTGGATCACCTGAGGTTAGGAGTTTGAGACCAGCCTGGCCAACATGGTGAAACCGTCTCTACTAAAAATGCAAAAAAGTAGGGGCCGGGCACGGTGGCTCACGCCTGTAATCCCAGCACTTTGGGAGTCTGAGGCAGACGGATCACAAGGTCAGGAGATCAAGACCATGGTGAAACTCCGTCTCTACTAAAAATACAAAAAATTAGCTGGGCGTGGTGGTGGGCACCTGTAGTCCCAGCTGCTTGGGAGGCTGAGGCAGGAGAATGGTGTGAACCCGGGAGGCGGAGCTTGCAGTGAGCCGAGATCGCAACACTGCACTCCAGCCTGGGCGACAGAGCGAGACCCTGTCTCAAAAAAAACAAAAATAAACAAAAATAAATAAATACAAAAAAGTAGCCAGGCATGGTGGTGGGTGCCTGTAATCCCAGCTACTTGGGAGGCTGAGGCAGGAGAATCACCTGAACCCGGGAGGTGGAGGTTGCAGTGAGCCAAGACCGTGTCATTACACTCTAGCCTGGGCAACAAGAGCGAAATTCCATCTGAAAAAATAAATAAATAAAAATAAAAA","GGCTGGGCGCAGTGGCTCACACCTGTAATCCCAGCACTTAGGGAAGCTGAGGCGAGTAGATCACCTGAGGTCAGGAGTTAGAGACCAGCCTGGCCATCATGGTGAAACCCCGTCTCTACTAAAGATACCAAAAATTAGCTGAGTGTGGTGCTGGGTGCCTGTAATCCCAGAAACTCAGGGTGCCTGTAATCCCAGCAACTCAGGGTGCCTTTAATCCCAGCAACTGAGGGTACCAGTAATCCCAGCAACTCAGGGTGTCTTTAATCCTAGCAACTGAGGGCACCTGTAATCCCAGCAACTCAGGAAGCTGAGACAGGAGAAGTACTTGAACCCAGAAGGCAGAGGTTGCAGTGAGCCGATATTGCACCATTGCACTCCAGTCTGGGCAACAAGAGTGAAACTCTGTCTCAAAAAAAAA"
"chr14","87180871","87181803","JH378118","18053084","18053501","547","69127787","GGCCATGTGCGGTGGCTCACACCTGTAATCCCAGCACTGTGGGAGGCCAAGGTGGGCGGATCATTTGAGGTCAGGAGTTCTAAACCAGCCTGGCCAATATGGTGAAACACTGTCTCTGCTAAAAATACAAAAAAAGAAAAAGAAAAAAAAAAAAAGGCTGGGCACGGTGGCTCACGCCTGTAATCTCAGCACTTTGGGAGGCTGAGGTGGGTGGATTACCTGAGGTCAGGAGTTCGAGACCAGCCTGGCCAACATGGTGAAACCTTGTCTCTACTAAAAGTATAAAAATTAGCCAGGTGTGGTGGAGGTCGCCTGTAATCCCAGCTACTCAGTAGGCAGAGGCAGAAGAATCCGTTGAACCTGGGAGGCGGAGGTTGCAGTGAGCTGAGATTGCACCAGTGCATTCCAGCCCGGGTGACAAGAGTGAGACTCTGTCTCAAAATAAACAAACAAAAAAATTAGTGGGCCGGGTTCAATGACTCACGCCGGTAATCCCAGCACTTTGGGAGGCCAAGGAAGGCAGGTCACCTGAGGTCGGGAGCTCGAGACCAGCCTGACCAACATGGAGAAACCCCGTCTCTACTAAAAATACAAAATTAGCTGGGCGTGGTGGCACATGCCTGTAATTCCAGCTACTCAGGACGCTGAGGCAGGAGAATTGCTTGAACCCAGGAGGCGGAAGTTGCAGTGAGCCAAGATCATGACATTGCACTCCCGCCTGGGCGCCAAGAGTGAGATTTCGTCTCAAACAAACAAACAAAAAAACGAATTAGTGGAGCGTGGTGGCAGGCACCTAAAGTCCCAGCTATTCAGGAGGCTGAGGCAGGAGAATTGCTTGAACCTGGGAAGTGGAGGTTATAGTGAGCTGAGATCGCGCCATTGCACTCCAGCCTGGGCAACAAGAGTGAGAATCTGTCTAAAAAAAAAAAAGAA","GGCTGGGCGCAGTGGCTCACACCTGTAATCCCAGCACTTAGGGAAGCTGAGGCGAGTAGATCACCTGAGGTCAGGAGTTAGAGACCAGCCTGGCCATCATGGTGAAACCCCGTCTCTACTAAAGATACCAAAAATTAGCTGAGTGTGGTGCTGGGTGCCTGTAATCCCAGAAACTCAGGGTGCCTGTAATCCCAGCAACTCAGGGTGCCTTTAATCCCAGCAACTGAGGGTACCAGTAATCCCAGCAACTCAGGGTGTCTTTAATCCTAGCAACTGAGGGCACCTGTAATCCCAGCAACTCAGGAAGCTGAGACAGGAGAAGTACTTGAACCCAGAAGGCAGAGGTTGCAGTGAGCCGATATTGCACCATTGCACTCCAGTCTGGGCAACAAGAGTGAAACTCTGTCTCAAAAAAAAA"
"chr15","7203590","7204226","JH378118","18053084","18053501","285","10849494","GGCCAGGTGCAGTGGCTCATGCCTCTAATCCCAGCACTTTGGGAGGCCGAGATGGGCAGATCACCGGAGGTCAGGAGTTTGAGACCAGCTTGGCCAAAATGGTGAAACCCTGTCTCTACAAAAAAATACAAAAATGGCTAGGCACGGTGGCTCACACCTGTAATCCCAGCACTTTGGGATACAGGTGGATCATGAGGTCAAGAGATCAAGATCATCTTGGCCAACATGGCAAAACCCTGTCTCTACTAAAAAATACAAAAAATTAGCTGGGCGTGGTGGTGCACGCCTGTAGTCCCAGCTACTCAGGAAACTGAGGCAAGAGAATCGCTTGAACCTGGGAGGTAGAGGTTGCAGTGAGCCGAGATGCACTCCAGCCTGGCAACAGAACAAGACTCCATCTCAAAGAACAAAAACAAAACAAAACAAAACAAAAGACAAGCAAACAAAAAAATACAAAAATTAGCTAGGTGTGGTGGCAGGCGCCTGTAATCCCAGCTACTCAGGAGGCTGAGGCAGGAGAATCGCTTGAACCTGGGAGGCGGAGGTTGCAGTGAGCCAAGATTGTGCCATTGCACTCCAGCCTAGGTGACAAGAGTGAAAAGACGTCTCAAAAACAAAACCAAAAAAAAAAATAAAA","GGCTGGGCGCAGTGGCTCACACCTGTAATCCCAGCACTTAGGGAAGCTGAGGCGAGTAGATCACCTGAGGTCAGGAGTTAGAGACCAGCCTGGCCATCATGGTGAAACCCCGTCTCTACTAAAGATACCAAAAATTAGCTGAGTGTGGTGCTGGGTGCCTGTAATCCCAGAAACTCAGGGTGCCTGTAATCCCAGCAACTCAGGGTGCCTTTAATCCCAGCAACTGAGGGTACCAGTAATCCCAGCAACTCAGGGTGTCTTTAATCCTAGCAACTGAGGGCACCTGTAATCCCAGCAACTCAGGAAGCTGAGACAGGAGAAGTACTTGAACCCAGAAGGCAGAGGTTGCAGTGAGCCGATATTGCACCATTGCACTCCAGTCTGGGCAACAAGAGTGAAACTCTGTCTCAAAAAAAAA"
"chr15","13675429","13675731","JH378235","1186107","1186418","53","12489322","GGCTTGGCACAGTGGCTCATGCCTGTAATCCCAGCACTTTGAGAGACCGAGGCAAGTGGATCCCAGGAGTTCAAGACCAGCCTGGCCAAGATGGTGAAACCCCCCATCTCTACTAAAAATACAAAAAAAAAAAAAAAAAAAAAAAAAGGGCTTAGTGGCTGGCAGCTGTAGTCCCAGCTACTCGGGAGGCTGAGGCAGGAGAATCGCTTGAACCTGGGAAGCGGAGGTTGCAGTGAGCCAAGATCACACCATTGCACTCTAGCCTGGGCAACAAGGGCAAAACTCCATCTCAAAAAAAAAGAA","GGCTGGGCGCAGTGGCTCAAGCCTGTAATCCCAGCACTTTGGGAGGCCGAGGGGGGTGGATCACGAGGTCAAGAGATCAAGACCATCCTGGTCAACATGGTGAAACCCCGTCTCTACTAAAAAAAAAAAAAAAAAAAAAAAAAAAAAAAAAAAATTAGCTGGGCATGGTGGCGTGTAATCCCAGCTACTCAGGAGGCTGAGGCAGGAGAATTGCCTGAACCCAGGAGGCGGAGTTTGCGGTGAGCCAAGATCGCGCCATTGCACTCCAGCCTGGGTAACAAGAGCAAAACTCTGTCTCAAAAAAAAAAAAAA"
"chr15","14837014","14837358","JH378137","13677298","13677634","59","1159716","GCCGGGTATGGTGGCTCATGCCTGTAATTCCAGCACTTTGGGAGGCCGAGGCAGGCGGATCACCTGAGGTCAGGAGTTTGAGACCAGCCTGGCTAACATGGTGAAACTACGTTTCTACTAAAAATACAAAAAAAAAAAAAAAAAAAAAAAAAAAAAAAAAAAAAAAAAAAATTAGCCAGGCGTGGAGGCGCGTGCCTATAATCCCAGTTACTCGGGAGGCCGAGGCAGGAGAATCGCTTGAACCCAGGAGCCGGAGGGTGTAGTGAGCCGAGATCATGCCATTGCGCTCCAGGTTGGGCAACAAGAGCAGAACTCCGTCTCAAAAAAAAAAAAAAAAAAAAAAAA","GGCTGGGCATTGTGGCTCATGCCTGTAATCCCAGCACTTTGGGAGGCCGAGGTGGGCGGATCACCTGAGGTCGGGAGTTCAAGACCAGCCTGGCCACAATGGTGAAACTCTGTCTCTGCTAAAAAAAAAAAAAAAAAAAAAAAAAAAAAAAAAAAAAAAATTAGCCAGGCGTGGTGGCACACGCCTGTAATCCCAGCTATTTGGGAGGCTGAGGCAGGAGAATCGCTTGAACCTGAGAGGTGGAGGTTGCAGTGAGCCAAGATCATACCATTGCACTCCAGCTTGGGAACAAAGAGCAAAACGCCATCTCAAAAACAAAACAAACAAACTGAAAAAA"
"chr15","20684723","20685060","JH378262","266823","267148","57","20417900","GGCTGGGCGTGTTGGCTTACACCTGAAATCCCAGCACTCTGGGAGGCCGAGGCGGGCAGATCACCTGAGGTCAGGGGTTCGAGACCAGCTTGGCCAACATGGTGAAACCCCGTCGCTACTAAAAATACAAAAATTAGCTGGGCATGGTGGTGGGAGCCTGTAATCCCAGCTACTCAGGAGACTGAGGCAGGACAATCGCTTGAACCCAGGAGGCAGAGGTTGCAGCGAGCCGAGATCGTGCCACTGCACTCCAGCCTGGGAGGGAAGAGTGAAAGTCCATAACAACAACAAAACAACAAAACAACAACAACAACAACAACAACATCTCTGAAAGGAAA","GGCCGGGCGCGGTGGCTCAAGCCTGTAATCCCAGCACTTTGGGAGGCCGAGGCGGGTAGATCATGAGGTCAGGAGTTTGAGACCAGCCTGGCCAACATGGTGAAACCCCGTCTCTACTAAAAATACAAAAATTAGCCGGGCATGGTGGCCTGTGCCTGTAATCCTAGCTACCCAGGAAGCTGAGGCAGGAGAATTGCCTGAACCCAGGAGGCGGAGGTTGCGGTGAGCCGAGATCGTGCCATTGCACTCCAGCCTGGGTAACAAGAGCGAAACTCCGTCTCAAAAACAAACAAACAAACAAACAAAAACAAAAAACAAAAAACAAA"
"chr15","20894395","20894976","JH378119","32351107","32351490","257","11456712","GGTGGCTCACACCTGTAATCCCAGCACTTTGGGAAGCCGAGGTAGGTGGATCACCTGAGGTCAGGAGTTAGAGATCAGCCTGGACAACATGGTGAAACCCCATCTCTACTAAAAATACAAAAACTAACCAGGCTTGGTGGCTCACACCTGTAATCCCATCACTTTGGGAGGCCAAGGCGGGTGGACTACTTGAGGTCAGGAGTTTGAGACCAGCCTGGCTAACATGGTGAAACCCCATCTCTACTAAAAATACAAAAATTAGCTGGGCATGGCAGTGCGCGCCTGCAATCCCAGCTACCTGGGAGGCTAAGGCAGGGGAATTGTTTGAACCTGGGAGGCAGAGGTTGCAGTGAGCCGACACTGCACCACTGCACTCCAGCCTGGGTGACAGAGTGAGCCTCCGTCTCAAAAAAAAAAAAAAAAAAAAAAAAAAATTAGCCAGGTGTGGTGGCAGGCACCTGTGATCCCAGCTACTCAGGAGGCTGAGGCAGGAGAATTGCTTGAACCCAGGAGGCGGAGAGTGCAGTGAGCTGAGATCATGCCATTGCACTCCAGCCTGGGTGACAAGAGAGAAACTCTGTC","GGCCAGGTATGGTGGCTCACACCTGTAATCCCAGCACTTTGGGAGGCCAAGGCAGGCAGACCACCTGAGGTCAGGAGTTCGAGATCAGCCTAGCCAACATGGTGAAACCCCATCTCTAGTAAAAATAAAATTAGCCAGGCATGGTGGTGCATGCCTGTAACGCAGGTCAGGAGTTCGAGATCAGCTTAGCCAACATGGTGAAACCCCATCTCTAGTAAAAATAAAATTAGCCAGGCAGGTGGTGCCGCCTGTACTCGGGAGGCTGAGGCAGGAGAATCACTTGAACCCAAGAGGCAGAGGTTGCAGTCAGCCAAGATCATGCCATTGCACTCCAGCCTAAGCAAAAAGAGTAAAACTCAGTCTCAAAACAAAAAAACAAAAAAA"
"chr15","21092189","21092737","JH378206","6546474","6546861","200","14545715","GCCGGGCGTGGTGGCTCACGCCTGGCCTGTAATCCCAGCACTTTGGGAAGCCAAGGCGGGTGGTTCACCTGAGGTCAGGAGTTCAAGACCAGCCTGGCCAACATGGTGAAACCCTGTCTCTACTAATAATACAAAAATTAGCTGGGCATGGTGGTGCATGCCTGTAATCCCAGCTACTTGGGAGGCCGAGGCGAGCAGATCACCTGAGGTCAAGAGTTCGATACCAGCCTGACCAACATAGAGAAACCCCGTCTCTACTAAAAATGCAAAATTAGCCGGGCATGGTGGTGCATGCCTGTAATCCCCAGCTACTCGGGAGGCTGAGGCAGGAGAATCGCTTGAACCTGGGAGGCAGAGGTTGTGGTGAGCTGAGATCACGCCATTGCACTCCAGCCTGGGCTCGAAACTCCATCTTAAAAAAAAAAAAAAAAAAAAGAATCACTTGAACCCAGGAGGTGGAGGTTGCAGTGAGCTGAGAGTGCACCATTGTACTCCAGCCTGGGCGACAACAGCAAAACTCCATCACCTTAAAAAAAAAAAAAAAAAAGA","GGCCACACATGGTGGCTAACGCCTGTAATCCCAGCACTTTGGGAGGCCAAGTCGGGTGGATCATGAGGTCAGGAGACCAAGACCATCCTGGCCAAATGGTGAAACCCCGTCTCTACTAAAAATACAAAAATTAGCTGGGCATGGTGGCGTGTGCCTGTAATCCCAGCTACTCAGGAGGCTGAGGCAGGACAATTGCCTGAACCCAGGAGAATTAGCTGGGCATGGTGGCGTGTGCCTGTAATCCCAGCTACTCAGGAGGCTGAGGCAGGACAATTGCCTGAACCCAGGAGGCGAAGGTTGCGGTGAGCCGAGATTGTGCCATTGCACTCCAGCCTGGGTAACAAGAGCGACACTCTGTCTCAAAAAAAAAAAAAAAAAAAAAAAAAAA"
"chr15","21150084","21150391","JH378158","10397018","10397312","55","10753066","GGCCGGGCATGGTGGCTTATGCCTGTAATCCCAGCACTTTGGGAGGCTGAGGTGGGTGGATCACCTGAGGTCAGGAGTTCAAGACCACCCTGGTCAACATGGCAAAATCCTGTCTCTACTAAAAATACAAAATTAGCTGGGCGTGGTGGTGGGCGTCTGCCTGGGTGAGGCAGGAGAATCGCTTGAACCCAAGAGGCAGAGGTTGGAGTGAGCCAAGATCGTGCCATTGCACTCCAGCCTGGGCAACGAGAGTGAAACCCCATCTCAGAAAAAAAAAAGAAAAAGAAAAAGAAAAAAGTAAAAAAAAA","GGCTGAGCACAGTGGCTCACACCTGTAATCCCAGCACTTTGGGAGGCCGAGGCGGGTGGATCACCTGAGATCAGGAGTTCAAGAACAGCCTGACCAACATGGTGAAACCTATCTCTACTAAAAATACAAAATTAGCCTGGCATGGTGGCGCGTGCCTGTAATCTGGCTGAGGCAGAAGAATCGCTTAAACCCAGAGGCAGAGATTGCAGTGAGCCAAGATTGTGTCATTGCACTCCAGCCTGGGCAACAAGAGCAAAACTCCATCTCAGAAAAAAAAAAAAAAAGAAGAAAAAAA"
"chr15","21563578","21564184","JH378118","18053084","18053501","255","3510494","GGCCAGGCATGGTGGCTCACACCTGTAATCGCAGCACTTTGGGAGACTGAGGCAAGCAGATCACCTGAGGTTAGAAGTTCAAGACCAGCCTGGCCAACACAGTGAAACCCCATCTCTACTAAAAATACAAAAAAATGGCCGGGTGCAGTGGCTCATGCCTGTAATCCCAGCACTTTGGGAGGCTAAGGCAGGGGGAATCACAAGGTCAAGAGATCAAGACCATCCTGGTAAAACCCCGTCGGTACTAAAAATACAAAAATTAGCTGGGTGAGGTGGCATGCACCTGTAGCCCCAGCTACTCGGGAGGCTGAGACAGGAGAATCACTTGAACCTGGGAGGCAGAGGTTGCAGTGAGCTGAGATCGCACCACTGCACTCCAGCCTGGCAACAGAGGAAGACTCTGTCTAAAACTAATAATAATAATAATAATAATAATAAAATTAGCTGGGAGTAGTGGCGGGCACCTGTAATCCCAGCTACTTGGGGGGGCTGAGGCAGGAGAAAAGCTTGAACCCGGGAGGTGAAGGTTGCAGTAAGCCAAGATCACGCCATTGCACTCCAGCCCGGGCAACAAGAGCGAAACTTCGTTTCAAAAAAAAAAAAAAAA","GGCTGGGCGCAGTGGCTCACACCTGTAATCCCAGCACTTAGGGAAGCTGAGGCGAGTAGATCACCTGAGGTCAGGAGTTAGAGACCAGCCTGGCCATCATGGTGAAACCCCGTCTCTACTAAAGATACCAAAAATTAGCTGAGTGTGGTGCTGGGTGCCTGTAATCCCAGAAACTCAGGGTGCCTGTAATCCCAGCAACTCAGGGTGCCTTTAATCCCAGCAACTGAGGGTACCAGTAATCCCAGCAACTCAGGGTGTCTTTAATCCTAGCAACTGAGGGCACCTGTAATCCCAGCAACTCAGGAAGCTGAGACAGGAGAAGTACTTGAACCCAGAAGGCAGAGGTTGCAGTGAGCCGATATTGCACCATTGCACTCCAGTCTGGGCAACAAGAGTGAAACTCTGTCTCAAAAAAAAA"
"chr15","22132229","22132799","JH378118","18053084","18053501","233","4079145","GGAGGCCAAGGTGGGCGAATCACCGGTGGTCAGGAGTTTGAGACTAGCCTGGCCAACATGGTGAAACCCCGTCTCTACTAAAAAATACAAAAATTAGGCCGAGTGTGGTGGCTCATGCCTGTAATCCCAGCAGTTTGGAAGGCCAAGGCGGGCAGATCACCTGAGGTCAGGAGTTCAAGACCAGCCTGGCCAACACAGTGGAACCCTGTCTCTACTAAAAATACAAAAAAAATTTGCCAGGCATGGTGGTGTGTGTGCCTATAATCCCAGCTACTCAGGAGACTGAGGCAAGAGAACTGCATGAACCCCAGAGGGAGAGGCTGCAGTGAGCTGAGATCGTACCACTGCACTCCAGCCTGGGTGACAGGGCAGGACTCCGTCTCAAAAAAAAAAAAAAAAAAAAAAAATTAGCCAGGTGTGGTGGCGAGCACCTGTAATCCTAGGTACTTGGGAGGCTGAGAAAGGAGAACCACTTGAACCCCGGAGGCAGAGGTTGCAGTGAGTGGAGATTGTGCGCCATTGCACTCCAGCCTGGGTGACAAGTGTGAAATTCTGCCTCAAAAAAAAAAAA","GGCTGGGCGCAGTGGCTCACACCTGTAATCCCAGCACTTAGGGAAGCTGAGGCGAGTAGATCACCTGAGGTCAGGAGTTAGAGACCAGCCTGGCCATCATGGTGAAACCCCGTCTCTACTAAAGATACCAAAAATTAGCTGAGTGTGGTGCTGGGTGCCTGTAATCCCAGAAACTCAGGGTGCCTGTAATCCCAGCAACTCAGGGTGCCTTTAATCCCAGCAACTGAGGGTACCAGTAATCCCAGCAACTCAGGGTGTCTTTAATCCTAGCAACTGAGGGCACCTGTAATCCCAGCAACTCAGGAAGCTGAGACAGGAGAAGTACTTGAACCCAGAAGGCAGAGGTTGCAGTGAGCCGATATTGCACCATTGCACTCCAGTCTGGGCAACAAGAGTGAAACTCTGTCTCAAAAAAAAA"
"chr15","23508255","23508883","JH378118","18053084","18053501","275","5455171","GGTCGGGTGTGGTGGCTCATGCATGTAATCCTGGCACTTTGGGAGGCCGAGGCGGGTAGATCACCTGAGGTCACGAGTTTGAGACCAGCCTGACCAACATGGTAAAACTTTGTTTCTACTACAAATACAAAAAATTGGCCAGGCTCGGTGGCTTCCGCCTGTAATCCCAGCACTTTGGGAGGCCGGGGTGCATGGATCACCTGAGGTCAGGACTTCGAGACCAGCCTGGCCAACATGGTGAAACCCCATCTCTACTAAAAATACAAAAAAAAAAAAAAAAATGAGCCAGGCATATTGGTGGGCGCCTGTAATCCCAGCTACTTGGAAGGCTGAGACAGGAGAATCACTTGAACCTGGGAGGCGGAGATTGCAGTGAGCCGAGATCATGCCACTGTACTCCATCCTGGGTGACAAGAGTGAGACTGCATCTCAAAAAAAAAAAAACCAAAAAACCAAAAAAAAACAAAAAATTAGTCAACCGTAGTGGTGGGCCCCTATAATCTCAGCTGCTCAGGAGGCTGAGGCAGTAGAATCACTTGATCCCAGGAGGTGGAGGTTTCAGTGAGCTGAGATCATGCCATTGTACTCCAGCCTGGGCAACAAGAGCGAAACTCTATCTCAAAAAATAA","GGCTGGGCGCAGTGGCTCACACCTGTAATCCCAGCACTTAGGGAAGCTGAGGCGAGTAGATCACCTGAGGTCAGGAGTTAGAGACCAGCCTGGCCATCATGGTGAAACCCCGTCTCTACTAAAGATACCAAAAATTAGCTGAGTGTGGTGCTGGGTGCCTGTAATCCCAGAAACTCAGGGTGCCTGTAATCCCAGCAACTCAGGGTGCCTTTAATCCCAGCAACTGAGGGTACCAGTAATCCCAGCAACTCAGGGTGTCTTTAATCCTAGCAACTGAGGGCACCTGTAATCCCAGCAACTCAGGAAGCTGAGACAGGAGAAGTACTTGAACCCAGAAGGCAGAGGTTGCAGTGAGCCGATATTGCACCATTGCACTCCAGTCTGGGCAACAAGAGTGAAACTCTGTCTCAAAAAAAAA"
"chr15","23602365","23603005","JH378118","18053084","18053501","286","5549281","GGTCGGGTGTGGTGGCTCATGCATGTAATCCTGGCACTTTGGGAGGCCGAGGCGGGTAGATCACCTGAGGTCACGAGTTTGAGACCAGCCTGACCAACATGGTAAAACCTTGTTTCTACTACAAATACAAAAAATTGGCCAGGCTCGGTGGCTTCCGCCTGTAATCCCAGCACTTTGGGAGGCCGGGGTGCATGGATCACCTGAGGTCAGGACTTCGAGACCAGCCTGGCCAACATGGTGAAACCCCATCTCTACTAAAAATACAAAAAAAAAAAAATGAGCCAGGCATATTGGTGGGCGCCTGTAATCCCAGCTACTTGGAAGGCTGAGACAGGAGAATCACTTGAACCTGGGAGGCGGAGATTGCAGTGAGCCGAGATCATGCCACTGTACTCCATCCTGGGTGACAAGAGTGAGACTGCATCTCAAAAAAAAAAAAAACCAAAAAACCAAAAAAAACCAAAAAATTAGTCAACCGTAGTGGTGGGCCCCTATAATCTCAGCTGCTCAGGAGGCTGAGGCAGTAGAATCACTTGATCCCAGGAGGTGGAGGTTTCAGTGAGCTGAGATCATGCCATTGTACTCCAGCCTGGGCAACAAGAGCAAAACTCTATCTCAAAAAAAAAAAAAAAAAAGAAAAA","GGCTGGGCGCAGTGGCTCACACCTGTAATCCCAGCACTTAGGGAAGCTGAGGCGAGTAGATCACCTGAGGTCAGGAGTTAGAGACCAGCCTGGCCATCATGGTGAAACCCCGTCTCTACTAAAGATACCAAAAATTAGCTGAGTGTGGTGCTGGGTGCCTGTAATCCCAGAAACTCAGGGTGCCTGTAATCCCAGCAACTCAGGGTGCCTTTAATCCCAGCAACTGAGGGTACCAGTAATCCCAGCAACTCAGGGTGTCTTTAATCCTAGCAACTGAGGGCACCTGTAATCCCAGCAACTCAGGAAGCTGAGACAGGAGAAGTACTTGAACCCAGAAGGCAGAGGTTGCAGTGAGCCGATATTGCACCATTGCACTCCAGTCTGGGCAACAAGAGTGAAACTCTGTCTCAAAAAAAAA"
"chr15","23603280","23603615","JH378109","21565230","21565567","55","2038050","GGCCAGGCGCGGTGGCTCATGCCTATAAACTCAGCACTTTGAGAGGCTGAGGCGGGTGGGTCACCTGAGGTCAGGAGTTAGAGACCAGCCTGGCCAACATGGTGAAACCGTGTTTCTACTAAAGATACAACATTAGCCAGGCATGGTGGCGCATGCCTGTAATCCCAGCTACTAGGGAGGCTGCGGCAGGAGAATCGCTTGAACGCAGGAGGTGAAGGTTGCAGTGAGCTGAGATCGTGCCATTGCACTCCAGCCTGGGTGACAAGAGCGAAACTCCATCCCAATCAATCAATCAATCAATCAATCAATTAAATTAAAAAAATAAAAAGAAAGAAA","GGCCGGGCGCGGTGGCTCAAGCCTGTAATACCAGCACTTTGGGAGGCCGAGGCGGGTGGATCACGAGGTCAAGAGATCGAGACCATCCTGGTCAACATGGTGAAACCCCGTCTCTACTAAAAATACAAACAATTAGCTGGGCATGGTGGCGGGTGCCTGTAATCCCAGCTACTCCAGAGGCTGAGGCAGGAGAATTGCCTGAACCCAGGAGACGGAGGTTGCGGTGAGCCAAGATCGCGCCATTGCACTCCAGCCTGGGTGACAAGAGCGAAACTCCGTCTCAATAAATAAATAAATAAATAAATAAATAAAAATAAAATAAATAAATAAATAAATAA"
"chr15","38315253","38315599","JH378169","5922203","5922541","56","32393050","GCCAGACACGGTGGCTCACGCCTGTAATCCCAGCACTTTGGGAGGCCGAGGCGGGTGGATCACCTGAGGTCAGGAGTTCGAGACCAGCCTGGCCAACATGGCGAAATCCTGTCTCTACTAAAAATACACACACACACACACACACACACACACACACACACACACATACACACACAAAATTAGCTGGGCATGGTGGCAGGTGCCTGTAATCCCAGCTACTTGGGAGGCTGAGGCAGGAGAATCACTTGAACCTGGGAGGCGGAGATTGCAGTGAGCCAAGATCATGCCATTGCACTTCAGCCTGGGCAACGAGAGTGAAACTCTGTCTCAAAAAAAAAAAAAAAAAA","GGCCAAGGGTGGTGGCTCACACCTGTAATCCCAACACTCTGGGAGGCCAAGGTGGGTGGATCACCTAAGGTCAGGAGTTCAAGACCAGCATGGCCAATATAGTGAAACTCTGTCTCTACTAAAAATACACACACACAAAAAAAAACAAAACACAAAAAAAACCACAAAATTAGCCGGGCATGGTGGCATGTGCCTGTAATCCCAGCTACTCAGGAGGCTGAGGCAGGAGAATCACTTAAACCCAGGAAGCGGAGGTTGCAGTGAGCCAAGATTGCGCCACTGCACTCCAGCCTAGGTGACAAGAGCAAAACTCTGTCTCAAAAAAAAAAAAAAAAAAAA"
"chr15","39410478","39411079","JH378118","18053084","18053501","249","21357394","GGCCGGGCACGGTGGCTCACGCCTGTAATCCCAGCACTTTGGGAGTCTGAGGTGGGCAGATCCACCTGAGGTCAGGGGTTCAAGACCAGCATGGCCAACATGGTGAAACCTCATCTCTACTAAAAATACAAAAATTAGGCTGGGTGCGGTGGCTCACGCCTGTAATCCCAGCACTTTGGGAGGCCAAGGCAGGTGGATCACCTGAGGTCAGGAGTTCGAGACCAGCATGGCCAACATAGCGAAAATCCGTCTCTACTAAAAACACAAAAATTAGCCAGGTGTGTTGGCTTACACCTGTAATCCCAGCTACACAGGAGGCTGAGGCAGAAGAATCACTTGAATCCAGGAGGTGGAGGTTGCAGTGAGCCGAGATCGCGCCACTGCCCTCCAGCCTGGGTGACAGAGCAAGACACCATCTCAAAAAAAAAAAAAAAAAAATTAGCTGGGCATGGTCACAGGTGCCCCTAATCCCAGCTACTCAGGAGGCTGAGGCAGGAGAATTGCTTGAACCCAGGAGACGGAGGTCACAGTGAGCGGTAATTGTGCCATTGCACTTCAACCTGGGTGACAAGAGCAAAAGTCCATCTCAAAAAAAAAAAAAA","GGCTGGGCGCAGTGGCTCACACCTGTAATCCCAGCACTTAGGGAAGCTGAGGCGAGTAGATCACCTGAGGTCAGGAGTTAGAGACCAGCCTGGCCATCATGGTGAAACCCCGTCTCTACTAAAGATACCAAAAATTAGCTGAGTGTGGTGCTGGGTGCCTGTAATCCCAGAAACTCAGGGTGCCTGTAATCCCAGCAACTCAGGGTGCCTTTAATCCCAGCAACTGAGGGTACCAGTAATCCCAGCAACTCAGGGTGTCTTTAATCCTAGCAACTGAGGGCACCTGTAATCCCAGCAACTCAGGAAGCTGAGACAGGAGAAGTACTTGAACCCAGAAGGCAGAGGTTGCAGTGAGCCGATATTGCACCATTGCACTCCAGTCTGGGCAACAAGAGTGAAACTCTGTCTCAAAAAAAAA"
"chr15","45225530","45226131","JH378133","19690365","19690767","253","25535165","GGCCGGGCACAGTGGCTCATGCCTGCAGTTCCAGCACTTTTGGAGGCCGAGGCAGGCCGATCACTTGAGGTCAGGAGTTCGAGACCACCCCGGCTAACGTGGTGCAACTCCATCTCTACTAAAAATACAAAATTGGCCGGGTGCGGTGGCTCATGCCTGTAATCCCAGCACTTTGGGAGGCCGAGGCGGATGGATCACCTCAGGTCAGGAGTTCGAGACCAGCCTGGCCAATGTGGTGAAACCCCGTCTCTACTAATAATACAAAAATTAACTGGGTGTGGTGGTGGGCACCTATAATCCCAGCTACTCGGGAAGCTGAGGCAGGAGAATCACTTGAACCTGGGAGGTGGAGATTGCAGTGAGCTGAGATGGTGCCATTACACTCCAGCCTGGGCAACGAGAGTGAAACTCTGTCTCTAAATAAATAAATACAAAATTAGCCGGGCATGGTGGCGGATGCCTATAATCACAGCTACTTGGGAGGCTGAGGCAAGAGAATCACTTGAACCTGGGAGGTGGAGGTTGCAGTGAGCTGAGATCAAGCCATTGCACTCCAGCCTGGGCAAAAAGAGTGAAACTCTGTCTCAAAAAAAAGAAAGAAA","GGCCAGGCACAGTGGTTCATGTCTGTAATCAGCATTTTGGGAGGCTGAGGCGGGAGAATCACCTGAGGCCAGGAGTTCTAGATGAGCCTGGGCAAATAGTGACAACCTGTCCCTACAAAAAAATTTAAAATTAGCCAGGATTGAGACCATCCTGGCTCACGTGGTGAAACCCCATCTTTACTTAAAATACTTAAAATGCAAAAAACATTTTTTTTTGTATTTTATTTAAAATACAAAAAAACTAGGCAGGCATGTTGGCACGTGCCTGTAGTCCCAGATACTTGGGAGGCTGAGGCAAGAGAATCACTTGAACCCAGGAGGTGGAGGTTGCAGTGAGCCGAGATCATACCACTGCACTCCAGCCTGGGTGACAAGAGTGAAACTCTGTCTCAAAAAAAAACAA"
"chr15","46581057","46581661","JH378118","18053084","18053501","254","28527973","GGCCGGGCGCGGTGGCTCACGCCTGTAGTCCCAGACTTTGGGAGGCCGAGGTGGGCGGATTGCCTGAGGTCAGGAGTTCAAGACCAACCTGGCCAACATGGTGAAATGCCGTCTCTACTAAAAATACAAAAATTAGGCCGGGCACGGTGGCTCATGTCTATAATCCCAGCACTTTGGGAGGCCGAGGTGGGCGGATCACGAGGTCAGGAGATCGAGACCATCCTGGCTAACACGGTGAAACCCCGTCTCTACTAAAAACACAAAAAATTAGCCGGGCGTGGTGGCAGGCACCTGTAGTCTCAGCTACTCAGGAGGCTGAGGCAGGAGAATGGCGTGAACTTGGGAGGCGGAGCTTGCAGTGAGCCAAGATTGTGCCACTGCACTCCAGCCTGGGCAACAGAGCGAGACTCTGTCTCAAAAAAAAAAAAAAAAATTAGCCAGGTGTGGTGGCAGGTGCCTGTAATCCCAGCTAATTGGGAGGCTAAGGCAGGAGAATCTCTTGAACCCAGGAGGCAGAGGTTGCAGTGAGCCAAGATTTCGCCATTACACTCCAGCCTGGGCAACAAGAGCTAGACTCCATCTCAAAAATAAATAAATAAAATAAA","GGCTGGGCGCAGTGGCTCACACCTGTAATCCCAGCACTTAGGGAAGCTGAGGCGAGTAGATCACCTGAGGTCAGGAGTTAGAGACCAGCCTGGCCATCATGGTGAAACCCCGTCTCTACTAAAGATACCAAAAATTAGCTGAGTGTGGTGCTGGGTGCCTGTAATCCCAGAAACTCAGGGTGCCTGTAATCCCAGCAACTCAGGGTGCCTTTAATCCCAGCAACTGAGGGTACCAGTAATCCCAGCAACTCAGGGTGTCTTTAATCCTAGCAACTGAGGGCACCTGTAATCCCAGCAACTCAGGAAGCTGAGACAGGAGAAGTACTTGAACCCAGAAGGCAGAGGTTGCAGTGAGCCGATATTGCACCATTGCACTCCAGTCTGGGCAACAAGAGTGAAACTCTGTCTCAAAAAAAAA"
"chr15","46659994","46660594","JH378118","18053084","18053501","247","28606910","GCTGGGCATGGTGGCTTACGCCTGTAATCCCAGCACCTTGGGAGGCTGAAGTGAGCAAATCACCTGAGTTCAGGAGTTCAAGACCAGCCTGGCCAACATGGTGAAAACCCATCTCTATTAAAAATTACAAAAATGGCCAGACACGGTAGCTCACGCCTGTAATCCCAGCACTTTGGGAGGCTGAGGCGGGCAGATCACCTGAGGTTGGGAGTTGGAGACCAGCTTGACCAACATGGAGAAACCCCCTCTCTACTAAAAATACAAAATTAGCCAGGCGTGGTGGCACATGCCTGTAATCCCAGCTACTTGGGAGGCTGAGGCAGGAGAATCACTTCAACCCGGAAGGTGGAGGTTGTGGTGAGCTGAGATTGTGTCATTGCACTCTAGCCTGGATAACAAAGGCAAAACTCAGTCTCAAAAAAAAAAAAAATTACAAAAATTAGCTGGCGTGGTGGCAGGTGCCTATAATCCCAGCTACTCAGGAAGCTGAGGCAGGAGAATCACTTGAAACCAGGAGGCAGAGGTTGCAGTGAGCTGAGACCACGCCATTGCCCTCCTGCCTGGGTGACAAGAGTGAAACTCCATCTCAAAAAAAAAAAAA","GGCTGGGCGCAGTGGCTCACACCTGTAATCCCAGCACTTAGGGAAGCTGAGGCGAGTAGATCACCTGAGGTCAGGAGTTAGAGACCAGCCTGGCCATCATGGTGAAACCCCGTCTCTACTAAAGATACCAAAAATTAGCTGAGTGTGGTGCTGGGTGCCTGTAATCCCAGAAACTCAGGGTGCCTGTAATCCCAGCAACTCAGGGTGCCTTTAATCCCAGCAACTGAGGGTACCAGTAATCCCAGCAACTCAGGGTGTCTTTAATCCTAGCAACTGAGGGCACCTGTAATCCCAGCAACTCAGGAAGCTGAGACAGGAGAAGTACTTGAACCCAGAAGGCAGAGGTTGCAGTGAGCCGATATTGCACCATTGCACTCCAGTCTGGGCAACAAGAGTGAAACTCTGTCTCAAAAAAAAA"
"chr15","46772064","46772669","JH378118","18053084","18053501","251","28718980","GGCTGGGTGCAATGGCTCATGCCTGTAATTCCAGTGTTTTGGGAGGCCGAGGCAGGTGGATCACTTGAGATCAGGAGTTCGCGACCAACCTGGCTAACATGGTGAAACCCCGTCTCTACTAAAAATACAAAAAATTGGCCAGGAGCGGTGGCTCAAACCTGTAATTCCAGCACTTTGGGAGGCCGAGGGGGGCAGATCACGATGTTTAGGAGTTTGAGATCAGACTGACCAACATGGTGAAACCCCATCTCTACTAAAAATACAAAAATTAGCCAGGCGTGGTGGTGCATGTCTGTAATCCCAGCTACTTGGGAGGCTGAGGCAGGAGAGTTGCTTGAAGCCGGGAGGTGGAGGTTGCAGTGAGCTGAGATCACACCACTGCACTCCAGCCTGGGCGACAGAGCAAGACTGTCTCAAAAAAAAAAAAAAAAAAAAAAATTAGCCAGCTTGGTGGCGGGCATCTGTAATCCCAGCTACTCGGGAGGCTGAGGCAGGAGAATCACTTGAACCCAGGAGGCAGAGGTCGCAGTGAGCCAAGATCACGCCATTGTACTCCAGCCTGGGCAACAAGAGCAAAACTCCATCTCAAAAAACAAAAAATAAAAA","GGCTGGGCGCAGTGGCTCACACCTGTAATCCCAGCACTTAGGGAAGCTGAGGCGAGTAGATCACCTGAGGTCAGGAGTTAGAGACCAGCCTGGCCATCATGGTGAAACCCCGTCTCTACTAAAGATACCAAAAATTAGCTGAGTGTGGTGCTGGGTGCCTGTAATCCCAGAAACTCAGGGTGCCTGTAATCCCAGCAACTCAGGGTGCCTTTAATCCCAGCAACTGAGGGTACCAGTAATCCCAGCAACTCAGGGTGTCTTTAATCCTAGCAACTGAGGGCACCTGTAATCCCAGCAACTCAGGAAGCTGAGACAGGAGAAGTACTTGAACCCAGAAGGCAGAGGTTGCAGTGAGCCGATATTGCACCATTGCACTCCAGTCTGGGCAACAAGAGTGAAACTCTGTCTCAAAAAAAAA"
"chr15","48446925","48447526","JH378118","18053084","18053501","252","30393841","GGCCAAGTGCAGTGGCTCACGTTTGTAATCCCAGCACTTTGGGAGGCCGAGGCGGGTGGATCACCTGATGTCAGGGGTTTGAAACCAGCCTGGCCAACATGGTGAAACCCCATCTCTAATAAAAATACAAAACTGGCCAGGTGCAGTGGCTCATGCCTGTAATCCCAGCACTTTGAGAGACCAAGGGAGGCAGATCACCTGAGGTCAGGAGTTCCAGACCAGCCTAGCCAACATGGTGAAACCCTATCTCTACTAAGAGTACAAAAATTAGCCTGGCGTGGTGGCAGGCGCCTGTAATCCCAGCTACTCAGAAGGCTGAGGCAGGAGAATCACTTGAACCCAGGAGGCGGAGGTTGCAGTGAGCCGAGATTGAGCCACTACACTCCAGCCTGGGTGACAAGAACAAGACTCTGTCTCAAAAAAAAAAAAAAAAAAAGCCGGTCATGGTGGCACATGCCTATAATCCCAGCTTCTTGGGAGGCTGAGGCAGGAGAACCACTTGAACCTGGGAGGTGGAGGCTGCAGTGAGCCGAAATTGTGCCATTGCACTCTAGCCTGGGCAACAAGAGCAAAACTCTCTCAAAAAAAAAAAAAAAAAAAAA","GGCTGGGCGCAGTGGCTCACACCTGTAATCCCAGCACTTAGGGAAGCTGAGGCGAGTAGATCACCTGAGGTCAGGAGTTAGAGACCAGCCTGGCCATCATGGTGAAACCCCGTCTCTACTAAAGATACCAAAAATTAGCTGAGTGTGGTGCTGGGTGCCTGTAATCCCAGAAACTCAGGGTGCCTGTAATCCCAGCAACTCAGGGTGCCTTTAATCCCAGCAACTGAGGGTACCAGTAATCCCAGCAACTCAGGGTGTCTTTAATCCTAGCAACTGAGGGCACCTGTAATCCCAGCAACTCAGGAAGCTGAGACAGGAGAAGTACTTGAACCCAGAAGGCAGAGGTTGCAGTGAGCCGATATTGCACCATTGCACTCCAGTCTGGGCAACAAGAGTGAAACTCTGTCTCAAAAAAAAA"
"chr15","59372839","59373447","JH378118","18053084","18053501","260","41319755","GGCCAGGATCAGTGTCTCACACCTGTAATCCTAGCACTTTGGGAGGCTAAGGTGGGCGGATTACTTGAGGTCAGGAGTTTGAGACCAGCCTGGGCAACATGGTGAAACCCCGTCTCTACTAAAAATACAAAAATTAGCTGGGCATAGGCCAGGAGTGGTGGCTTACGCCTGTAATTCCAGGACTTTGGGAGGCTGAGGCGGGCAGATCATGAGGTCAGGAGATTGAGACCATCCTGGCTAACATGGTGAAACCTCATCTCTACTAAAAATACAAAAATTAGCCAGTCGTGGTGGTAGGCGCCTGTAGTCCCAGCTACTTGAGAGGCTGAGGCAGGAGAATCACTTGAATCCGGGAGGTGGAGGTTGCAGTGAGCCGAGATTATGCCACTTCACTCCAACCTGGTGACAGAGCAAGACTCCGTCTAAAAAAAAAAAAAAAAATTAGCTGGGTGTGGCGGGCACTTGCAATCCCAGCTACTTAGGAGGCTGAGGCAGGAGAACCGCTTGAACCTGGGAGGTAGAGGTTCCAGATCACGCCATTGCACTCCTGCTTGGGCAACAAGAGTGACACTCCATCTCAAAAAAACAAAAAAAAAAAAGAAAAAGAAA","GGCTGGGCGCAGTGGCTCACACCTGTAATCCCAGCACTTAGGGAAGCTGAGGCGAGTAGATCACCTGAGGTCAGGAGTTAGAGACCAGCCTGGCCATCATGGTGAAACCCCGTCTCTACTAAAGATACCAAAAATTAGCTGAGTGTGGTGCTGGGTGCCTGTAATCCCAGAAACTCAGGGTGCCTGTAATCCCAGCAACTCAGGGTGCCTTTAATCCCAGCAACTGAGGGTACCAGTAATCCCAGCAACTCAGGGTGTCTTTAATCCTAGCAACTGAGGGCACCTGTAATCCCAGCAACTCAGGAAGCTGAGACAGGAGAAGTACTTGAACCCAGAAGGCAGAGGTTGCAGTGAGCCGATATTGCACCATTGCACTCCAGTCTGGGCAACAAGAGTGAAACTCTGTCTCAAAAAAAAA"
"chr15","64220715","64221335","JH378118","18053084","18053501","268","46167631","CCAGGCACAGTGGCTCATACCTGTAATCCCAGCACTTTGGGAGCCCAAGGCGGGCAGATCACCTGAGGTCAGGAGTTCGAGACCAGCCTGGACAACATGGAGAAACTCCATCTCTACTAAAAATACAAAATGAGGCCGGGCACAGTGGCTCACACCTATAATCCCAGCACTTTTGGAGGCCGAGACAGGCAGCTCACGAGGTCAGGAGTTCAAGACCAGCCTGGCCAGCATGGTGTAACCCCGTTTCTACTAAAAATACAAAAATTAGCCAGGCATGGTGGTGCGTGCCTGTAGTCCTCAGGAGGCTGAGGCAGGAGAATCGCTTGAATCTGGGAGGCGGAGCTTGCAGTCAGCTGAGATCAGGCTACTGCACTGCAGCTTGGGCAACAGAGTGAGACTCCGTCTCAAAAACAAACAAACAAACAAACAAAACACAACAAAATTAGCTGGGCATGGTGGCAGGTGCCTGTAATCCCAGCTACTCAGCTACTCAGGAGGCTGAGGCAGGAGAGTCACGTGAACCTGGGAGGCAGAGGTTGCAGTGAGCCAAGATCACGCCATTGCACTCCAGCCTGGGCAACAAGAGGGAAATTACATCTCAAAAAAAAAAAAAAAAAAAAA","GGCTGGGCGCAGTGGCTCACACCTGTAATCCCAGCACTTAGGGAAGCTGAGGCGAGTAGATCACCTGAGGTCAGGAGTTAGAGACCAGCCTGGCCATCATGGTGAAACCCCGTCTCTACTAAAGATACCAAAAATTAGCTGAGTGTGGTGCTGGGTGCCTGTAATCCCAGAAACTCAGGGTGCCTGTAATCCCAGCAACTCAGGGTGCCTTTAATCCCAGCAACTGAGGGTACCAGTAATCCCAGCAACTCAGGGTGTCTTTAATCCTAGCAACTGAGGGCACCTGTAATCCCAGCAACTCAGGAAGCTGAGACAGGAGAAGTACTTGAACCCAGAAGGCAGAGGTTGCAGTGAGCCGATATTGCACCATTGCACTCCAGTCTGGGCAACAAGAGTGAAACTCTGTCTCAAAAAAAAA"
"chr15","65873443","65873774","JH378165","3784440","3784761","45","62089003","GGCCAGGCACGGTGGCTCACACGTGTAATCCCAGCACCTTGGGAGACCGAAGCAGGTGGATCACCTGAGGTCAGGAGTTTGAGGCCAGCCTGGCCGATATGGTGAAACCCTATCTCTATTAAAAATACCAAAAAAAAAAAAAAAAAAAAAAAAACCTGCTGGGCGTGGTGGCGCACGCCTGTAATCCCAACTACTCAGGAGGCTGAGGCAGGAGAATCACTTGAATCCAGGAGGCAGAGGTTGCAGTGAGCCGAGATCGCGCCATTGCACTCCAGCCTGGGCAACAAGAGCGAAACTCGGTCTCAAAAAAAAAAAAAAAAAAAGAAAAGAAA","GGCCGGGCGCGGTGGCTCAAGCCTGTAATCCCAGCACTTTGGGAGGCCGAGGCAGGTGGATCATGAGGTCAAGAGATCAAGACCATCCTGGTCAACATGGTGAAACCCCGTCTCTACTAAAAATACAAAAAAAAAAAAAAAAAAACTAGCTGGGCGTGGTGGCGCATGCCTGTAATCCCAGCTACTCAGGAGGCTGAGGCAGGAGAATTGCTTGAACCCAGGAGGCGGAGGTTGCGGTGAGCCCAGATCGCGCCATTGCACTCCAGCCTGGGTAACAAGAGCAAAACTCCATCTCAAAAAAAAAAAAAAAAAAAAAAAAAAA"
"chr15","70453292","70453944","JH378118","18053084","18053501","292","52400208","GGCCAGGCACGGTGGCTCATGCCTGTAATCCCAACACTTTGGGAGGCTGAGGTAGGTAGATCACCTGAGGTTGAGGTCAGGAGTTTGAGACCAGCCTGGCCAACATGGTGAAACTCTGTCTCTACTAAAAATACAAAAATTTGGCCCGGCGCAGTGGCTCACCTGTAATCCCAGCACTTTGGGAGGCCGAGGCAGGCAGATCACGAGGTCTGGAGATCAAGACCATCCTGGCTAACTCGGTGAAATCCCATCTCTACTAAAAATACGAAAAATTAGCCAGGTGTGGTGGCGGGCACCTGTAGTCCCAGCTACTTGGGAGGCTGAGGCAGGAGAATGGCGTGAACCTGGGAGGTGGAGCTTGCAGTGGGCCAAGATCACGCCACTGCACTCCAGCCTGGGCAACAGAGTGAGACTCTGTCTCAAAATAAAATAACATAAAATAAAATAAAGTAATATAAAATAAAAATACAAAAATTAGCTGGGCATGGTAGCGGGTACCTATAATTCCAGCTACTTGAGAGGCTGAGGCTGGAGAATCACTTGAATCTGGGAGGTGGAGGTTGCAGTGAGCCAAGATTGCACCATTGCACTCCAGCCTGGGCAACAAGAGCCAAACTCCGTATCAAAAAAAAAAAAAAAAAGAAAAAGAAAAA","GGCTGGGCGCAGTGGCTCACACCTGTAATCCCAGCACTTAGGGAAGCTGAGGCGAGTAGATCACCTGAGGTCAGGAGTTAGAGACCAGCCTGGCCATCATGGTGAAACCCCGTCTCTACTAAAGATACCAAAAATTAGCTGAGTGTGGTGCTGGGTGCCTGTAATCCCAGAAACTCAGGGTGCCTGTAATCCCAGCAACTCAGGGTGCCTTTAATCCCAGCAACTGAGGGTACCAGTAATCCCAGCAACTCAGGGTGTCTTTAATCCTAGCAACTGAGGGCACCTGTAATCCCAGCAACTCAGGAAGCTGAGACAGGAGAAGTACTTGAACCCAGAAGGCAGAGGTTGCAGTGAGCCGATATTGCACCATTGCACTCCAGTCTGGGCAACAAGAGTGAAACTCTGTCTCAAAAAAAAA"
"chr16","217191","217526","JH378138","4229795","4230103","77","4012604","ATTTTGGGAGGCTGAGATGAGTGATGAGCGGATCACCTGAGGTCAGGAGCTCGAGACCAGTCTGGCCAACACGGTGAAACCCTGTCTCTACTAAAAGTACCAAAAAAATTAGCCAGGCATGGCAGTGGGCGCCTGTAATCCCAACTACTCGGGAGGCTGAGGCAGGAGAATCACTTGAACCTGGGAGGTGGATGTAGCAGTGAGCCGGGATCGTGCCACTGAACTCCAGCCTGGGCGATAAGATCAAAACTCTGTCTCTCTCTCACACACACACACACACACACACACACACACACACACACCCCCAAAAAAAAAAACAAAAAAAAGAAAAAGAAA","CACTTTGGGAGGTGAAGGCGGGCAGATCACCTGAGGTCAGGAGTTCGAGACCAGCCTGGCCAACATGGTGAAACCCCGCCTCTACTAAAAATACAAAAATTAGCCAGGTGTGACACTAGGCATCTGTAATCCCAGCTACTTGGGAGGCTGAGACAGGAGAATCACTTGAACCCAGGAGGCGGAAGTTGCAGTGAGCCAAGATCATGCCATTGCACTCCAGCCTGGGTGACAGGAGCAAAACTCTGTCTCAAAAAAAAAAAAAAAAAAAAAAAAAAAAAAAAAAAAAAAAGAAAAGAAAAGAAAAGTAAA"
"chr16","384893","385508","JH378118","18053084","18053501","265","17668191","GGCCGGGCGTGGTGGCTAACACGGGTAGTCCTAGCACTTTGGGAAGCCAAGGCAGGCAGATCACTTGAGGTCAGGAGTTTGAGATCAGTCTGGCCAACATGGTGAAACCACGCCTCTACTAAAAATACAAAAGTTATGGCCGAGCGTGGTGGCACGCGCCTGTAATCCCAGCACTTTGGGATGCTGAGGCAGGCGCATCACCTAAGGTCGGGAATTCAAGACCAGCCTGACCAACATGGAGAAACCACGTTTCTACTAAAAATACAAAATTAGCCGGGTGTGGTGGCACATGCCTGTAGTTTCAGCTACTCAGGAGGCTGAGGCAGGAGAATCACTTGAATCCGGGAGGCGGAGATTGTGGTGAGCCGAGATCGGGCCATTGCACTCCAGCCTGGGCAACAAGAGAGAAACTCTGTCTCAAAAAAAAAAAAAAAAAATTAGCCAGGCATGGTAGCCTGTGCCTGTAATCCCAGCTACTTGGGAGGCTGAGGCAGGAGAATCGCTTGAACCTGGGAGGCAGAGGTTGCAGTGAGCCGCGATTGCGCCATTGCACTCTCCAGCCTGGGGGAGAAGAGCAAAACTCCATCTCAAAAATAAATAAATAAATAAAAATAAA","GGCTGGGCGCAGTGGCTCACACCTGTAATCCCAGCACTTAGGGAAGCTGAGGCGAGTAGATCACCTGAGGTCAGGAGTTAGAGACCAGCCTGGCCATCATGGTGAAACCCCGTCTCTACTAAAGATACCAAAAATTAGCTGAGTGTGGTGCTGGGTGCCTGTAATCCCAGAAACTCAGGGTGCCTGTAATCCCAGCAACTCAGGGTGCCTTTAATCCCAGCAACTGAGGGTACCAGTAATCCCAGCAACTCAGGGTGTCTTTAATCCTAGCAACTGAGGGCACCTGTAATCCCAGCAACTCAGGAAGCTGAGACAGGAGAAGTACTTGAACCCAGAAGGCAGAGGTTGCAGTGAGCCGATATTGCACCATTGCACTCCAGTCTGGGCAACAAGAGTGAAACTCTGTCTCAAAAAAAAA"
"chr16","1668152","1668787","JH378118","18053084","18053501","287","16384932","GGCCGGGCACGGTGCCTCGTTCCTGTAATCCCAGCACTTTGGGAGGCCAAGGTGGGTGGATCACCTGAGGTCAGGAGTTCGAGACATGCCTGGCCAACATGGCAAAATCCTGTCTTTACTAAAAATACAAAAATTAAGCCGGGCGCTGTGACTCATGCCTGTAATCCCAGCACTTTGGGAGGCCAAGGCGGGCGGATCACAAGGTCAGGAGATTGAGACCATCCTGGCTAACACGGTGAAAACCCGTCTCTACTAAAAATACAAAAAATTAGCCAGGTGTGGTGGCGGGTGCCTGTAGTCCCAGCTACTCGGGAGGCTGAGGCAGGAGAATGGCGTGAACCCGGGAGGCGGAGCTTGCAGTGAGCCGAGATCGTGCCACTGCACTCCAGTCTGGGCAACAGAGCAAGACTCTCTCTCAAAAAGAAACAAACAAAAAAAAAAATGAAAAAAGAAAAATTAGCCAGGCGTGGTGGCGGGTGCCTATAATCTCAGCTACTCGGGAGGCTGAGGCAGAAGTATCATTTGAACCCAGGAGGCGGAGGTTGTAGTGATCCAAGATAGCGCCATTGCACTGCAGCCTGGGTGACAACAGTGAAACTCCGTCTCAAAAAAAAAAAAAAAAAAGAAAGAAAGAAA","GGCTGGGCGCAGTGGCTCACACCTGTAATCCCAGCACTTAGGGAAGCTGAGGCGAGTAGATCACCTGAGGTCAGGAGTTAGAGACCAGCCTGGCCATCATGGTGAAACCCCGTCTCTACTAAAGATACCAAAAATTAGCTGAGTGTGGTGCTGGGTGCCTGTAATCCCAGAAACTCAGGGTGCCTGTAATCCCAGCAACTCAGGGTGCCTTTAATCCCAGCAACTGAGGGTACCAGTAATCCCAGCAACTCAGGGTGTCTTTAATCCTAGCAACTGAGGGCACCTGTAATCCCAGCAACTCAGGAAGCTGAGACAGGAGAAGTACTTGAACCCAGAAGGCAGAGGTTGCAGTGAGCCGATATTGCACCATTGCACTCCAGTCTGGGCAACAAGAGTGAAACTCTGTCTCAAAAAAAAA"
"chr16","2310740","2311369","JH378118","18053084","18053501","271","15742344","GGCCGGGCACAGTGGCTCACGCCTATAATATCAGCACTTTGGGAGACCAAGGCGGGTGGATCACCTAAGGTCAGGAGTTCAAGACCAGCCTGACCAACATGGTGAAACCCCATCTCTACCAAAAATAGAAAACATTAGTCTTGGCCGGGCACGGTGACTCATACCTGTAATTCCAGCACTTTGGGAGGCCGATCACCTGGCGGATCACCTGAGGTCGGGAGTTTGAGACCAGCCTGACCAACATGGAGAAACCCCGTCTCTACTAAAAATACAAAATTAGCTGTGCGTAGTGGCCCATGCGTGTAATCCCAGCTACTCAGGAGACTGAGGCAGGAGAATGGCTTGAACCTGGGAGGCGGAGGTTGTGCTGAGCCAAGATCGCACCATTGCACTCCAGCCTGGGCAATAAGAGTGAAACTCCGTTTCATAAAACAAAAAACAAAAAACAAAAAAAAAACCATTAGCCAGGCATTGTGGCAGGCACCTGTAATCCCAGCTACTCAGGAGGCTGAGGCAGAATGGCTTGAACCGGGGAGGCAGAGGTTGCAGTGAGCCGAGATCGCGCCATTGCACTCCAGCCTGGGCAACAAAAGTAAAACTCTGTCTCAAATAAAAAAAAGAGAGAAAAAA","GGCTGGGCGCAGTGGCTCACACCTGTAATCCCAGCACTTAGGGAAGCTGAGGCGAGTAGATCACCTGAGGTCAGGAGTTAGAGACCAGCCTGGCCATCATGGTGAAACCCCGTCTCTACTAAAGATACCAAAAATTAGCTGAGTGTGGTGCTGGGTGCCTGTAATCCCAGAAACTCAGGGTGCCTGTAATCCCAGCAACTCAGGGTGCCTTTAATCCCAGCAACTGAGGGTACCAGTAATCCCAGCAACTCAGGGTGTCTTTAATCCTAGCAACTGAGGGCACCTGTAATCCCAGCAACTCAGGAAGCTGAGACAGGAGAAGTACTTGAACCCAGAAGGCAGAGGTTGCAGTGAGCCGATATTGCACCATTGCACTCCAGTCTGGGCAACAAGAGTGAAACTCTGTCTCAAAAAAAAA"
"chr16","3075498","3075819","JH378114","26407278","26407597","46","23331780","GGCCAGGCGCGGTGGCTCACACCTGTAATCCCAGCACTTTGGGAGGCCAAGGCGGGCAGATCACGAGGTCAAGAGATCGAGACCATCCTGGCCAACCTGGTGAAACTCTGTCTCTACTAAAAATACCAAAAAAAAAAAAAAAAAAAAAAAAAAAAAGCATGGTGGCAGGTGCCTGTAATCCCAGCTACTTGGGAGGCTGAGGCAGAATTGCTTGAACCCGGGAGGCAGAGGTTGCAGTGAGTTGAGATCATGCCATTGCACTCCAGCCTGGGCAAAAAGAGCGAAACTCTGTCTCAAAAAACAAAACAAAAACAAAAACAAA","GGCCGGGCGCAGTGGCTCAAGCTTGTAATCCCAGCACTTTGGGAGGCCGAGGCGGGTGGATCACGAGGTCAAGAGATCGAGACCATCCTGGTCAACATGGTGAAACCCCGTCTCTACTAAAAATACAAAAAAAAAAAAAAAAAATTAGTTGGGCATGGTGGTGTGTGCCTGTAATCCCAGCTACTCAGGAGGCTGAGGCAGGAGAATTGCCTGAACCCAGGAGGCGGAGGTTGCGGTGAGCCGAGATCGCGCCATTGCACTCCAGCCTGGGTAACAAGAGCGAAACTCCGTCTCAAAAAAAAAAAAAAAAAAAAAAAAAA"
"chr16","3161549","3162150","JH378118","18053084","18053501","252","14891535","CTGGGCACCGTGGCTCACGCCTGTAATCCCAACACTTTGGGAGGCCAAGGCGGGTGGAACACCTGAAGTCAGGAGTTCGAGACCAGTCTGGACAACATGATGAAACCCCGTCTCTACTAAAAATACAAAAAGTAGCCAGGTATGGCCGGGCGCGGTGGCTCACGCCTGTAATCCCGGCACTTTGAGAGGCCGAGGCAGGTGGATCACAAGGTCAGGAGTTCAAGAGCAGCCTGGCCAAGATAGTGAAACCCCGTCTCTACTAAAAGCAAAATTACAGTGCGCCTGTAATCCCAGCTGCTCGGGAGGCTGAGGCAGGAGAATCGCTTGAACCTGGAGGGCGGAGGTTGCAGTGAGCCAAGATCGCTCTACTGCACCCTAGCCTGGGTGACAGAGCAAGACTCTGTATCAAAAAAAAAATAAATAAATAATTAGCCAGGTATGGTGGTGCAGGCTTGTAATCCTAGCTGCTCAGGAGGCTGAGGCAGGAGAATCGATTGAACCCAGGAGACGGAGGTTGCAGTGAGCAGAGATCACACCATTGTACTCCAGCCTGAGTGACAAAAACGAAACTCCGTCTCAAAAAAAAACCAAAAAAACAAAAA","GGCTGGGCGCAGTGGCTCACACCTGTAATCCCAGCACTTAGGGAAGCTGAGGCGAGTAGATCACCTGAGGTCAGGAGTTAGAGACCAGCCTGGCCATCATGGTGAAACCCCGTCTCTACTAAAGATACCAAAAATTAGCTGAGTGTGGTGCTGGGTGCCTGTAATCCCAGAAACTCAGGGTGCCTGTAATCCCAGCAACTCAGGGTGCCTTTAATCCCAGCAACTGAGGGTACCAGTAATCCCAGCAACTCAGGGTGTCTTTAATCCTAGCAACTGAGGGCACCTGTAATCCCAGCAACTCAGGAAGCTGAGACAGGAGAAGTACTTGAACCCAGAAGGCAGAGGTTGCAGTGAGCCGATATTGCACCATTGCACTCCAGTCTGGGCAACAAGAGTGAAACTCTGTCTCAAAAAAAAA"
"chr16","3211652","3212251","JH378118","18053084","18053501","260","14841432","GTCAGACGCAGTAGTTTATGCCTGTAATCCTTGCACTTTGGGAGGCAGGTGGATCACCTGAGGCCAGGAGTTGGAGACCAGCCAGGCCAATATGGCAAAACCCCGTCTCTACTAAAAATACAAAAACTAGCCGGGCGCAGTGGCTCACACCTGTAATCCCAGCACTTTGGGAGGCTGAGGTGGGTGGATCACTAGGTCAGGAGTTCAAGACCAGCCTGGCCAACATGGTGAAACCGCGTCTCTACTAAAAACACCAAAAAATTAGCTGGGCGTGGTGGCAGTCGCCTGTAATCCCTGCTACTCGGAAGGCTGAGGCAGGAGAATCACTTGAACGCAGGAGGCAGAGGTTGCGGTGAGCCGAGATCACGCCACTGCACTCCAGCCTGGGTGACAGAGCAAGACTCTGTCTCAAAAAACAACAACAACAACTAGCTGGGCGTGGTGGCACATGCCTGTAACCCCAGCTACTCAGGAGGCTGAGGCTGAGGGAGAAAAATCGCTTGTACCTGGGAGGTGGAAGTTGCAGTGAGCGGAGATCCCACCATTGCACTCCAGCCTGGGTGACAAGAGCGAAACTCCATCTCAAAAAAAAAAAAAAAA","GGCTGGGCGCAGTGGCTCACACCTGTAATCCCAGCACTTAGGGAAGCTGAGGCGAGTAGATCACCTGAGGTCAGGAGTTAGAGACCAGCCTGGCCATCATGGTGAAACCCCGTCTCTACTAAAGATACCAAAAATTAGCTGAGTGTGGTGCTGGGTGCCTGTAATCCCAGAAACTCAGGGTGCCTGTAATCCCAGCAACTCAGGGTGCCTTTAATCCCAGCAACTGAGGGTACCAGTAATCCCAGCAACTCAGGGTGTCTTTAATCCTAGCAACTGAGGGCACCTGTAATCCCAGCAACTCAGGAAGCTGAGACAGGAGAAGTACTTGAACCCAGAAGGCAGAGGTTGCAGTGAGCCGATATTGCACCATTGCACTCCAGTCTGGGCAACAAGAGTGAAACTCTGTCTCAAAAAAAAA"
"chr16","3990675","3991277","JH378118","18053084","18053501","250","14062409","GGCTGGGCGTGGTGGCTCACGCCTTTAATCCCAGTACTTTGGGAGGCCGAGAAGGGCACATCACCTGAGGTCAGGAGTTTGAGACCAGCCTGGCCAATATGGTAAAACCCTGTCTCTACTTAAAAAATAGAAAAATCAGGCTGGACGCAGTGGCTCACGCCTGTAATCCCAGCACTTTGGGAGGCCGAGGCGGGTGGATCATGAGGTCAGGAGTTACCAGCCTGCCAACATGGTGAAACCCCATCTCTACTAAAAAAACAAAAAAAATTAGCCAGTCGTAGTGGCAGGCACCTGTAATCCCAGCCACTCGGGAGGCTGAGGCAGAGAATTGCTTGAACCTGGGAGGTGGAGATTGCTGTGCACCAAAATCACACCACTGCACTTGAGCCTGGGCGACAGAGGGAGACTCATCTGAAAAAAAAAAAAAAAAAAAAATTAGCCGGTTATGGTGGCAGGTGCCTGTGATCCCAGCTACTTGGGAGGCTGAGGCAGGAGAATTGCTTGAACCCGGGAGGCAGAGGTTGCAGTGAGCTGAGATCGCACCACTGCACTCCAGCCTGGAGGACAAGAGTGAGACTTGTCTGATTGGAAAAAAAAAAAAAA","GGCTGGGCGCAGTGGCTCACACCTGTAATCCCAGCACTTAGGGAAGCTGAGGCGAGTAGATCACCTGAGGTCAGGAGTTAGAGACCAGCCTGGCCATCATGGTGAAACCCCGTCTCTACTAAAGATACCAAAAATTAGCTGAGTGTGGTGCTGGGTGCCTGTAATCCCAGAAACTCAGGGTGCCTGTAATCCCAGCAACTCAGGGTGCCTTTAATCCCAGCAACTGAGGGTACCAGTAATCCCAGCAACTCAGGGTGTCTTTAATCCTAGCAACTGAGGGCACCTGTAATCCCAGCAACTCAGGAAGCTGAGACAGGAGAAGTACTTGAACCCAGAAGGCAGAGGTTGCAGTGAGCCGATATTGCACCATTGCACTCCAGTCTGGGCAACAAGAGTGAAACTCTGTCTCAAAAAAAAA"
"chr16","4259838","4260446","JH378118","18053084","18053501","263","13793246","GGCCGGGTGCAGTGGCTCACGCCTGTAATCGCAGGACTTTGGGAGGCCAAGGCAGGTGCATCACCTGAGGTCAGGATTTCAAGACCATCCAGCCTGATCAACATGGTGAAACCCTGTCTCTACTAAAAATATAAAAATTGGCCGGGCACAGTGACTCACGCCTGTAATCCCAGCACTTTGGGAGGCTGAGGCAGGTGGATCACAAGGTCAGGAGATCGAGACCATCCTGGCTAACACAGTGAAACCCCGTCTCTACTAAAAATATAAAAAATTAGCCGGGCGTGGTGGTAGGCACCTGTAGTCCCAGCTACTCGGGAGACTGAGGCAGGAGAATGGCGTGAACCTGGGAGGTGGAGCTTGCAGTGAGCAGAGATCGCGCCACTGTACTCCAGCCTGGGTGACAGAGCGAGACTCCGTCTCAAAAAAAAAAAAAAAAAAAAAAATTAGCTGGGCGTGGTGGCGGGCACCTGTAATCCCAGCTACTTGGGAGGCTGAGGCAGGAGAATTGCTTGAACCTGGGAAGTGGAGGTTGCAGTGAGCTGAGATTGTGCCCTTGTACTCCAGCCTGGGCAATAAAAGCAAAACTCCGTCTTAAAAAAAAAAAAAAAA","GGCTGGGCGCAGTGGCTCACACCTGTAATCCCAGCACTTAGGGAAGCTGAGGCGAGTAGATCACCTGAGGTCAGGAGTTAGAGACCAGCCTGGCCATCATGGTGAAACCCCGTCTCTACTAAAGATACCAAAAATTAGCTGAGTGTGGTGCTGGGTGCCTGTAATCCCAGAAACTCAGGGTGCCTGTAATCCCAGCAACTCAGGGTGCCTTTAATCCCAGCAACTGAGGGTACCAGTAATCCCAGCAACTCAGGGTGTCTTTAATCCTAGCAACTGAGGGCACCTGTAATCCCAGCAACTCAGGAAGCTGAGACAGGAGAAGTACTTGAACCCAGAAGGCAGAGGTTGCAGTGAGCCGATATTGCACCATTGCACTCCAGTCTGGGCAACAAGAGTGAAACTCTGTCTCAAAAAAAAA"
"chr16","4899850","4900511","JH378118","18053084","18053501","313","13153234","GGCCAGGCACGGTGGCATGCACCTGTAATCTCAGCTCTTTGGGAGGCTGAGGCAAGAGGATCACTTGAGCCCAGGAGTTGGTGATTGCAGTGAGCTCTGATCACTCCACTGCACTCCAGCCTGGGTGACAGAGTGAGATCCTGTCTCTACGAAAAAAAGACAAGACACAAATACGTTAAAAGTAAAATGATATAAAAAGATATTCCAGTGGGGCACAGTGGCTCACCCCTATAATCCCAACACTTTGGGAGGCTGAGGTGGGTGGATCACCTGAGGTCAGGAATTCAAGACCAGCCTGACCAACATGGAGAAACCCGTCTCTACTAAAAATACAAAATTAGCCGGGTGTGGTGGCACATGCCTGTAATCCCAGCTACTCAGGAGGCTGAGAATGGCTTGAACCTGGGAGGTGGAGGTTGTGGTGAGCCGAGATTGCACCACTGCACTCCAGCCTGGGCAACAAGAGCTGAAACTCCGTCGAAAAAAAAAATTAGCCTGGCGTGGTGGCGGGAGCCTGTAATCCCAGCTACTGGGGAGGCTGAGGCAGGAGAATCACTTGAACCTGGGAGGCAGAATTTGCAGTGAGCCGAGATCGCGCCACCACACTCCAGCCTGGGTGACAAAAACGAAACCCCATCTCAAAAAAATTAAAAAATAACAAA","GGCTGGGCGCAGTGGCTCACACCTGTAATCCCAGCACTTAGGGAAGCTGAGGCGAGTAGATCACCTGAGGTCAGGAGTTAGAGACCAGCCTGGCCATCATGGTGAAACCCCGTCTCTACTAAAGATACCAAAAATTAGCTGAGTGTGGTGCTGGGTGCCTGTAATCCCAGAAACTCAGGGTGCCTGTAATCCCAGCAACTCAGGGTGCCTTTAATCCCAGCAACTGAGGGTACCAGTAATCCCAGCAACTCAGGGTGTCTTTAATCCTAGCAACTGAGGGCACCTGTAATCCCAGCAACTCAGGAAGCTGAGACAGGAGAAGTACTTGAACCCAGAAGGCAGAGGTTGCAGTGAGCCGATATTGCACCATTGCACTCCAGTCTGGGCAACAAGAGTGAAACTCTGTCTCAAAAAAAAA"
"chr16","4919663","4920295","JH378118","18053084","18053501","281","13133421","CTGGGCGCAGTGGCTCACACCTATAATCCCAGCACTTTGGGAGGCCGAGGTGGGGTGGATCACTTGAGGTCAGGAGTTTGAGACCAGCCTGGCCAACATGGTGAAACCCCATCTCTTCTAGAAAAATACAAAATTAGGCTGGGCGCGGTGGCTCACGCTTGTAATCCCAGCACTTTGGGAGGCTGAGGCAGGCGGATCATCTGAGGTTGGGAGTTCGAGACCAGCCTGACCAACATAGAGAAACCCTGTCTCTACTAAAAATACAAAATTAGCCGGGCGTGGTGGCGCATGCCTGTAATCCCAGCTAGTCAGGAGGCTGAGGCAGGAGAATCCCTTGAACTGGGGAGGCAGAGGTTGTGGTGAGCCCAGATCGTGCCATTGCACTCCAGCTTGGGTAAGAAGAGCAAAACTCTGTCTAAAAAATATATATATTTATACATATATATATATTTATATATATAATTAGCCACGCATAGTGGCACACACCTGTAACCCCAGCTACCTGGGAGGATGAGGCAGGAGAATAGCTTGAACTTGGGAGGTGGAGGTTGCACTGAGCTGAGACTGCGCCATTGCATTCCAGCCTGGGCAACAAGAGCGAAACTGTCTCAAAAAAAAAAAAAAAAAAAAAAA","GGCTGGGCGCAGTGGCTCACACCTGTAATCCCAGCACTTAGGGAAGCTGAGGCGAGTAGATCACCTGAGGTCAGGAGTTAGAGACCAGCCTGGCCATCATGGTGAAACCCCGTCTCTACTAAAGATACCAAAAATTAGCTGAGTGTGGTGCTGGGTGCCTGTAATCCCAGAAACTCAGGGTGCCTGTAATCCCAGCAACTCAGGGTGCCTTTAATCCCAGCAACTGAGGGTACCAGTAATCCCAGCAACTCAGGGTGTCTTTAATCCTAGCAACTGAGGGCACCTGTAATCCCAGCAACTCAGGAAGCTGAGACAGGAGAAGTACTTGAACCCAGAAGGCAGAGGTTGCAGTGAGCCGATATTGCACCATTGCACTCCAGTCTGGGCAACAAGAGTGAAACTCTGTCTCAAAAAAAAA"
"chr16","5124255","5124811","JH378118","18053084","18053501","213","12928829","GGCCAGGTGCGGTGGCTCATGCGTGTAATCCCAGCGCTTTGGGAGGCTGAGGCAAGTGGATCACCTGAGGTCAGGAGTTTGAGACCAGCCTGGCCAACATGGGGAAATCCCTGTCTCTACTAAAAATACAAAAATTGGGCCGGGTGTGGTGGCTCACACCTGTAATCCCAGCACTTTGGGAGACTGAGGTGGGCGGATCACCCAAGGTCAGGAGTTTGAGACCATCCTGGCCAACATGGTGAAACCCCGTCTCTACTAAATAAATACAAAAAAGTAGCCGAGCGTGTTGGCGGATGCCTGTAATCCCAGCTACTTGGGAGGCTGAGGCAGGAGAATTGCTTGAACCCTGAGAGGTGGAGGTTGCAGTGAGCAGAGATTGTGCCACTGCACTCTGGCCTGGGCGACAAGAGGGAGTCTCTGTCTTAAAAAAAAAAAAAAAAAAAATTAGCTGGAAATCGCTTGAACCCAGGAGGCGGAGGTTGCAGTGAGCCGAGATTGTGCCACTGCACTCTGGCCTGGGCGACAAGAGCGAGATTCTGTCTCAAAAAAAAAAAAGA","GGCTGGGCGCAGTGGCTCACACCTGTAATCCCAGCACTTAGGGAAGCTGAGGCGAGTAGATCACCTGAGGTCAGGAGTTAGAGACCAGCCTGGCCATCATGGTGAAACCCCGTCTCTACTAAAGATACCAAAAATTAGCTGAGTGTGGTGCTGGGTGCCTGTAATCCCAGAAACTCAGGGTGCCTGTAATCCCAGCAACTCAGGGTGCCTTTAATCCCAGCAACTGAGGGTACCAGTAATCCCAGCAACTCAGGGTGTCTTTAATCCTAGCAACTGAGGGCACCTGTAATCCCAGCAACTCAGGAAGCTGAGACAGGAGAAGTACTTGAACCCAGAAGGCAGAGGTTGCAGTGAGCCGATATTGCACCATTGCACTCCAGTCTGGGCAACAAGAGTGAAACTCTGTCTCAAAAAAAAA"
"chr16","8088191","8088522","JH378114","21211700","21212024","70","13123509","GGCTGGGCGCGGTGGCTTTTGACCATAATCCCAGCACTTTGGGAGGCCGAGGTGGTCAGGTCACCTGAGGTCAGGAGTTCAAGAGCAGCCTGGCCAACGTGGTGAAACTCTGTCTCTACCAAAAATACCAAATAATAATAATAATAATAATAATAATAATAAAATAATATAATTGCAGGGTGTGGCAGCCCATGCATGTAATGCCAGCTACTTGGGAGACTGAGGCAGGATAATCACTTCAACCCAAGAGGCGGAGGTTGCAGTGAGCTGAGATCATGCCATTGCATTCCAGCGTAGGCAACAAGAGCGAAACTCTGTTTCAAATAAATAAA","GGCTGGGTGCGGTGGCTCAGGCCTGTAATCCCAGCACTTTGGGAGGCCGAGGTGGGTACATCACCTAAGGTCAGGAGTTCAAGACCAGCCTGACCAACATGGTAAAACCCTGTCTCTACTAAAATTACAAAAGAAAATTAGAAAAAAAAAAAAGAAAGAAAGAAAATTAGATGGCATGGTGGTGGCGGGCACCTGTAATTTCAACTACTCGGGAGGCTAAGGCAGGAGAATCACTTGAACCCAGGAGGTGGAGGTTGCAGTGAGCCGAGATCACACCATTGCACTGCAGCCTGGGCAATAAGAGCAAAACTCCATCTCAAAAAAA"
"chr16","9762791","9763467","JH378118","18053084","18053501","323","8290293","CAGGCATGGTAGCTCACGCCTGTAATCTCAGCACTTTGGGAGGCCGAGGTGCGCAGATCACTTGAGGTCAGGTGTTGGTGACCAGCCTGGCCAACATGGTGAAACCCTATCTCTACTAAAAATACAAAAATTATGGCCGGGCGCAGTGGCTCACGCCTGTAATCCCAGCACTTTGGGAGGCCGAGGTGGGCAGATCACTTGAGGTCAGGAGTTCAAGACCAGCCTAGGCAACATAGTGAAACCCCGTTGCTACTAAAAATACAAAAATTAGCTGGGCGTGATGGCACATACCTGTAGTCCCACCTACTTGGGAGGCTGAGGCAGGAAAATCGCTTGAACCTGGAGGCAGAGGTTGCAGCGAGCCAAGACTGTGCCAATGCACCACAGCCTGGATAACAGAGTGAGACTCAATCTCAAAAAAAAAAAAAAAAAAAAAAGGCGGGCTGGTGGCTCATGCCCATGCAAACCCCGTCTCTACTAAAAGGACAAAAATTAGCTGGGCATGGTGGCGGGGGCCTGTAATCTCAGGATTACAGGAGATACTACTACTCGGGAGGCTGAGGCAGTAGAATTGCTTGAACCAGGGAGGCGGAGGTTGCAGTGAGCTGAGATCGCGCCATTGCACTCCAGGCTGGGTGACAACAATGACTCCGTCTCAAAAACAACAACAACAACAA","GGCTGGGCGCAGTGGCTCACACCTGTAATCCCAGCACTTAGGGAAGCTGAGGCGAGTAGATCACCTGAGGTCAGGAGTTAGAGACCAGCCTGGCCATCATGGTGAAACCCCGTCTCTACTAAAGATACCAAAAATTAGCTGAGTGTGGTGCTGGGTGCCTGTAATCCCAGAAACTCAGGGTGCCTGTAATCCCAGCAACTCAGGGTGCCTTTAATCCCAGCAACTGAGGGTACCAGTAATCCCAGCAACTCAGGGTGTCTTTAATCCTAGCAACTGAGGGCACCTGTAATCCCAGCAACTCAGGAAGCTGAGACAGGAGAAGTACTTGAACCCAGAAGGCAGAGGTTGCAGTGAGCCGATATTGCACCATTGCACTCCAGTCTGGGCAACAAGAGTGAAACTCTGTCTCAAAAAAAAA"
"chr16","9769317","9769634","JH378153","10517405","10517727","57","748088","GGTTGGGCATGGTGGCTCACACCTGTAATGCCAGCACTTTGGGAGGCGGGCAGATCACCTGAGGTCAGGAGTTCAAGACCAGCCTGGCCAACATGGTGAAATCCTGTCATTACAAAAATACAAAAAAAAAAAAAAAAAAAAAAAAAAAAAGCCAGTAATGATAGTGGGTGCGTATAATCCCAGCTACTTTGGAGGCTAAGGCAGGAGACTCACTTGAACCCAGGAGGCGGAGGTTATGGTGAGCCGAGATCACACCATTGCACTCCAGCCTGGGCGACAAGAGCAAAACTCCATCTCAAAAAAAAAAAAAAAAAAAAA","GGCCGGGCGTGGTGGCTCACGCCTGTAATCCCAGCACTTTGGGAGGCCGAGGTGGGTGGATCATGAGGTCAAGAGATCGAGACCATCCTGGTCAACATGGTGAAACCCTGTCTCTACTAAAAAAAAAAAAAAAAAAAAAAAATACAAAAAAATTAGCTGGGCATGGTGGCGCATGCCTGTAATCCCAGCTACTCCGGAGGTTGAGGTAGGAGAATTGCCTGAACCCAGGAGGCGGAGGTTGCGGTGAGCCGAGATCGCGCCATTGCACTCCAGCCTGGGTAACAAGAGCAAAACTCCGTCTCAAAAAAAAAAAAAAAAAAGAA"
"chr16","13753079","13753710","JH378118","18053084","18053501","278","4300005","GGCTGATTGTGATGGCTCACACTTGTAATCCCCTCACTTTGGGAGGCCAAAGCGGGAGCATCACCTGAGGTCAGGAGTTCAAGACCAGCCTGGCCAACATGGTGAAACCCCATCTCTACTAAAAATAAAAAATTAGCTGGGCACAGTGACTCATGCCTGTAATCCCAGCACTTTGGGAGGCCGAGGCAGGCAGATCACAATCACGAGGTCAGGAGTTCGAGACCAGCCTGACCAACATGGTGAAACCCCGTCTCTACTAAAAATAGAAAAATTAGCCAGGCGTGGTGGCACACGCCTGTAATCCCAGCTCCTCAGGAGACTGAGGCAGGAGAATCACTTGAACCCAGGAGGTGGAGGTTGCAGTGAGCAGAGATCGCACCACTGCACTCCAGCCTGGGTAACAGAGTGAGACTCCGTCTCAAAAAAAAAAAAAAAAAAAAAAAAAAAACGAAATTAACCAGGTGTGGTGGCACATGCCTGTAATCCCAGCTACTTGGGAGGCTGAGGCAGGAGAATCGCTTGAACCCGGGAGACAGAGGTTCCAGAGAACTGAGATCATGCCATTGCACTCCAGCCTGGGCAACAAGAGTGAAACTCCATCTAAAAAATAAATAAATACATAAACAAACAAA","GGCTGGGCGCAGTGGCTCACACCTGTAATCCCAGCACTTAGGGAAGCTGAGGCGAGTAGATCACCTGAGGTCAGGAGTTAGAGACCAGCCTGGCCATCATGGTGAAACCCCGTCTCTACTAAAGATACCAAAAATTAGCTGAGTGTGGTGCTGGGTGCCTGTAATCCCAGAAACTCAGGGTGCCTGTAATCCCAGCAACTCAGGGTGCCTTTAATCCCAGCAACTGAGGGTACCAGTAATCCCAGCAACTCAGGGTGTCTTTAATCCTAGCAACTGAGGGCACCTGTAATCCCAGCAACTCAGGAAGCTGAGACAGGAGAAGTACTTGAACCCAGAAGGCAGAGGTTGCAGTGAGCCGATATTGCACCATTGCACTCCAGTCTGGGCAACAAGAGTGAAACTCTGTCTCAAAAAAAAA"
"chr16","13951847","13952482","JH378118","18053084","18053501","292","4101237","GGCCAGGTGCGGTGGCTCATGCCTGTAATCCCAGCACTTTGGGAGGCTATGGCAGCGGATAACCTGAGGTCACAAGTTTGAGACCAGCCTGGCAAACATGGTGAAACCGTCTCTACTAAAAATACAAAAATTACACCAGGCGCGGTGGCTCATGCCTGTAATCCCAGCACTTTGGAAGGCCGAGGCAGGTGGATCATGAGGTCAGGAGATCAAGACCATCCTGGCTAACGCAGTGAAACCCCGTCTCTACTAAAAATATAAAAAATTGGCCAGGCGTGGTGGCGGACGCCTGTAGTCCCAGCTACTCGGGAGGCTGAGCCAGGAGAATGGCGTGAACCCGGGAGGCGGAGCTTGTGGTGAGCCGAGATAGCGCCACTGCACTGCCGCCTGGGTGACAGAGTGAGACTCTGTCTCAAAAAACAAAACAAAACAAAAACCAAAAACAAAAACAAAAAAACAAAAATTAGCCAGGTGTGGTGGTGCACGCCTGTCATCCCAGCTACTTGGGGGGCTGAGACGTGATAATCACTTGAACCCGGGAGGGAGAGGTTGCAGTGAGTGGAGATCACGCCATTGTATTCCAGCCTGGGGGCAAGAGCAAAACTCTGTCTCAAAAACAACAACAACAACAACAAA","GGCTGGGCGCAGTGGCTCACACCTGTAATCCCAGCACTTAGGGAAGCTGAGGCGAGTAGATCACCTGAGGTCAGGAGTTAGAGACCAGCCTGGCCATCATGGTGAAACCCCGTCTCTACTAAAGATACCAAAAATTAGCTGAGTGTGGTGCTGGGTGCCTGTAATCCCAGAAACTCAGGGTGCCTGTAATCCCAGCAACTCAGGGTGCCTTTAATCCCAGCAACTGAGGGTACCAGTAATCCCAGCAACTCAGGGTGTCTTTAATCCTAGCAACTGAGGGCACCTGTAATCCCAGCAACTCAGGAAGCTGAGACAGGAGAAGTACTTGAACCCAGAAGGCAGAGGTTGCAGTGAGCCGATATTGCACCATTGCACTCCAGTCTGGGCAACAAGAGTGAAACTCTGTCTCAAAAAAAAA"
"chr16","19006984","19007584","JH378118","18053084","18053501","263","953900","GGTGGCTGATGCCTGTAAACCCAGCATTTTGGGAGGCCGAGGCTGGTGGATCACCTGAGGTCAGGTGTTCGAGACCAGTCTGGCCAACATGGTGAAACCTCGTCTCTACCAAAAATACAAAAATTAGTTGGGTGTGGCCGGGTGTGGTGGCTTACGCTTGTAATCTCAGCACTTTGGGAGGCCGAGGTGGGTGGATCACGAGGTCAGGAGTTCAAGACCAGCCTGGCCAAGATGGTGAAACCCTGTCTCTACTAAAAATACAAAAAATTAGCCAGGCATGGTGGCGGGTGCCTGTAATCCCAGCTACTCGGGAGGCTGAGGCAGAGAATTGCTTGAACCTGGGAGGTGGAGGTTGCAGTGAGCCGAGATTGTGCCACGACACTCCAGCCTGGGTGACAGAGCGAGACTCTGTCTAAAAAAAAAAAAAAAAATTAGTTGGATGTGGTGGTGGGTGTCTGTAATCTCAGCTACTCAGGAGACTGAATCAGGAGAATCACTTGAACCCAGGGGGCTGGAGGTTGCAGTGAGCCGAGATCTTGCCATTGCACTCCAGCCCGGGCGACAAGAGCAAAACTCTCTTTCAAAAAAAAAAAAAAAAAGA","GGCTGGGCGCAGTGGCTCACACCTGTAATCCCAGCACTTAGGGAAGCTGAGGCGAGTAGATCACCTGAGGTCAGGAGTTAGAGACCAGCCTGGCCATCATGGTGAAACCCCGTCTCTACTAAAGATACCAAAAATTAGCTGAGTGTGGTGCTGGGTGCCTGTAATCCCAGAAACTCAGGGTGCCTGTAATCCCAGCAACTCAGGGTGCCTTTAATCCCAGCAACTGAGGGTACCAGTAATCCCAGCAACTCAGGGTGTCTTTAATCCTAGCAACTGAGGGCACCTGTAATCCCAGCAACTCAGGAAGCTGAGACAGGAGAAGTACTTGAACCCAGAAGGCAGAGGTTGCAGTGAGCCGATATTGCACCATTGCACTCCAGTCTGGGCAACAAGAGTGAAACTCTGTCTCAAAAAAAAA"
"chr16","19554918","19555551","JH378118","18053084","18053501","281","1501834","GGCCGGGCGCAGTGGCTCACACCTGTAATCCCAGCACTTTGGGAGGCCGAGGCGGGTGGATCACTTGAGGTCAGGAGTTCAAGACCAGCCTGGCTGACATGGTGAAACCCTGTCTCTACTGAAAACACAAAAATTAGGCCGGGCATAGTGGCTCATGCCTGTAATACCAGCACTTTGGGAGGCCGAGGTGGGTGGATCACCTGAGGTCAGGAGTTTGAGACCAGCTTGACCAACATGGTGAAACCCCGTCTCTACTAAAAATATAAAAATTAGTCTGGCATGGTGGCAGATGCCTGTAATCCCAGCTACTCAGGAGGCTGAGGCAGGAGAATTGCTTGAACCTGGAAGGTGGAGGTTGTAATGAGCCAAGATCACACCACTGCACTCCAGCCACTGTACTCCAGCCTGGGTGACAGAGTGAGACTCTGTCTCAAAAAACATACATACACACACATACACACACACACACACACACACACAAATTAGCTGGACGTGATAGCACACCCCTGTAGTCCCAGCTGCTTGAGAGACCGAGGCACAAGAATCACACGAACCCGGGAGGCGGAGGTTCCTGTGAGCCAAGATCGCACCATTGTACTCCATTCTGGGTGACAAGAGTGAAGCTCTGTCTCAA","GGCTGGGCGCAGTGGCTCACACCTGTAATCCCAGCACTTAGGGAAGCTGAGGCGAGTAGATCACCTGAGGTCAGGAGTTAGAGACCAGCCTGGCCATCATGGTGAAACCCCGTCTCTACTAAAGATACCAAAAATTAGCTGAGTGTGGTGCTGGGTGCCTGTAATCCCAGAAACTCAGGGTGCCTGTAATCCCAGCAACTCAGGGTGCCTTTAATCCCAGCAACTGAGGGTACCAGTAATCCCAGCAACTCAGGGTGTCTTTAATCCTAGCAACTGAGGGCACCTGTAATCCCAGCAACTCAGGAAGCTGAGACAGGAGAAGTACTTGAACCCAGAAGGCAGAGGTTGCAGTGAGCCGATATTGCACCATTGCACTCCAGTCTGGGCAACAAGAGTGAAACTCTGTCTCAAAAAAAAA"
"chr16","19576859","19577465","JH378118","18053084","18053501","251","1523775","GGCCAGGCATGGTGGCTCACACCTGTAATCCCAGCCCTTTGGGAGGCCGAGGCAGGTGGATCACCTGAGGTCAGGAGTTCGAGACCAGCCTGGCCAACATGGTGACACCCCACTCTACCAAAAATACAAAAATTAGGTTGGGTGCAGCGGTTCACACCTGTAATCCCAGCACTTTGGGAGGCCAAGGTGGATGGATCACCTGAGGTCAGGAGTTTGTGACCAGCCTGGCCAACATGGCGAAACCCTGCCTCTACTAAAAATAAAAAATTAGCCAGGTGTGGTGGCATGCGCCTGTAATCCTAGCTACTGAGGCAGGAGAATCGCTTGGACCAGGGAAGCAGAGTTTGCAGTGAGCCAAGATCACGCCACTGCACTCTAGCCTGGGTGACAGAGTAAGACTCCATCTCAAAAAAAAAAAAAAATACAAATATTAGCTGGGCATGGTGGCGCACACCTGTAGTTCTGGCTACTCAGGAGGCTGAGGCAGGAGAATTGCTTGAACCCAGAAGGCAGAGGTTGCAGTGAGCTGAGATTGTGCCATTGCACTCAGCCTGGGCAACAAAAGTGAAACTCCATCTCAAAATAAATAGATAAATAAATAAATAAA","GGCTGGGCGCAGTGGCTCACACCTGTAATCCCAGCACTTAGGGAAGCTGAGGCGAGTAGATCACCTGAGGTCAGGAGTTAGAGACCAGCCTGGCCATCATGGTGAAACCCCGTCTCTACTAAAGATACCAAAAATTAGCTGAGTGTGGTGCTGGGTGCCTGTAATCCCAGAAACTCAGGGTGCCTGTAATCCCAGCAACTCAGGGTGCCTTTAATCCCAGCAACTGAGGGTACCAGTAATCCCAGCAACTCAGGGTGTCTTTAATCCTAGCAACTGAGGGCACCTGTAATCCCAGCAACTCAGGAAGCTGAGACAGGAGAAGTACTTGAACCCAGAAGGCAGAGGTTGCAGTGAGCCGATATTGCACCATTGCACTCCAGTCTGGGCAACAAGAGTGAAACTCTGTCTCAAAAAAAAA"
"chr16","19983557","19984148","JH378118","18053084","18053501","244","1930473","GGCCGAGTGCGGTGGCTCATGCCTGTAATCCCAGCACTTTGGGAGGCCGAGACAGGTGAATCACCTGAGGTCTGGAGTTTGAGACCAGCTGACCAACATGGTGAAACCCTGTCTCTACTAAAAATACAAAAAATTGGCTGAGCGCAGTGGCCACGCCTGTTATCCCAGTACTTTGGGAGGCCGAGGCGGGTGGATCACGAGGTCAGGAATTCGAGACCAGCCTGACCAACATGGTGAAGCCCCGTCTCTACTAAAAATAAAAAAATTAGCCAGGTGTGGTGGTGCGCCCCTGTAAACCCAGCTACTCAGGAGGCTGAGGCAGGAGAATCACTTGAATCTGGGAGGCGGAGGTTGCAGTGAGCCAAGATCGAGCCACTGTACTCCAGCCTGGGAGACGGAGTGAGACTCCATCTAAAAAAAAAAAAAAATTAGCCAGGCGTGGTGGCACAAGCCTGTAATCCCAGCTACCTGGGAGGCTGAGATAGGAGAATTCCTTGAATCTGGGAGGCGGAGGTTGCAGTGAGCTGAGATTGTGCCATTGCACACCAGCCTGGGTGACAAGAGCAAAATTCCATCTCAAAAAAAAAAAAAA","GGCTGGGCGCAGTGGCTCACACCTGTAATCCCAGCACTTAGGGAAGCTGAGGCGAGTAGATCACCTGAGGTCAGGAGTTAGAGACCAGCCTGGCCATCATGGTGAAACCCCGTCTCTACTAAAGATACCAAAAATTAGCTGAGTGTGGTGCTGGGTGCCTGTAATCCCAGAAACTCAGGGTGCCTGTAATCCCAGCAACTCAGGGTGCCTTTAATCCCAGCAACTGAGGGTACCAGTAATCCCAGCAACTCAGGGTGTCTTTAATCCTAGCAACTGAGGGCACCTGTAATCCCAGCAACTCAGGAAGCTGAGACAGGAGAAGTACTTGAACCCAGAAGGCAGAGGTTGCAGTGAGCCGATATTGCACCATTGCACTCCAGTCTGGGCAACAAGAGTGAAACTCTGTCTCAAAAAAAAA"
"chr16","20117717","20118289","JH378118","18053084","18053501","224","2064633","GGCTGGGTGCGGTGGCTCACGCCTGTAATCCCAGCACTTTGGGAGGCCAAGGCGGGTAGATCATCTGAGGTCAGGAGTTCAAGACCAGCCTGGCCAACATGGTGAAACCCCGTCTCTACTAAAAATATTTTTAAAAGGCCAGGCGTGGTGGCTCACGCCTGTAATCCCAGCACTTTGGGAGGCCGAGGCGGGCAGATCATGAGGTCAGGAGTTCGAGACCATCCTGGCTAACACGGTGAAACCCCCGTCTCTACCAAAAAATACAAAAAATTAGCCGGGCATGGTGGCAGGTGCCTGTAGTCCCAGCTACTCGGGAGGCTGAGGCAGGAGGATGGCGTGAACCCAGGAGACAGAGCTTCCAGTGAGCTGAGATCGTGTCACTGCACTCCAGCCTGGGCGACAGAGGAGATTCTGTCTCAAAAAAAAAAAAAAAAAATTAGCTTGGTGTGGTGGCAGGTGCCTGTAATCCCAGTTACTCGGGAGGCTGAGGCAGAGGTTTCAGTGAACCGAGATCGCGCCATTGCACTCCAGCCTGGGCAACAAGAGTGAAACTCCGTCTCAAAGGAAAAAAAA","GGCTGGGCGCAGTGGCTCACACCTGTAATCCCAGCACTTAGGGAAGCTGAGGCGAGTAGATCACCTGAGGTCAGGAGTTAGAGACCAGCCTGGCCATCATGGTGAAACCCCGTCTCTACTAAAGATACCAAAAATTAGCTGAGTGTGGTGCTGGGTGCCTGTAATCCCAGAAACTCAGGGTGCCTGTAATCCCAGCAACTCAGGGTGCCTTTAATCCCAGCAACTGAGGGTACCAGTAATCCCAGCAACTCAGGGTGTCTTTAATCCTAGCAACTGAGGGCACCTGTAATCCCAGCAACTCAGGAAGCTGAGACAGGAGAAGTACTTGAACCCAGAAGGCAGAGGTTGCAGTGAGCCGATATTGCACCATTGCACTCCAGTCTGGGCAACAAGAGTGAAACTCTGTCTCAAAAAAAAA"
"chr16","20574957","20575888","JH378118","18053084","18053501","543","2521873","GGCCAGGCGTGGTGGCTCATGCCTGTAATCCCAGCACTGTGAGAGGCCGAGGCGGGCGGATCACCTGAGCTGAGGAGTTCGAGACCAGCCTGGCCAACATGGCGAAACCCCATCTCTACTAAAAACACAAAAATTAGGCCAGGTGTGGTGGCTCACACCTGTAATCCCAGCACTTTGGGAGGCCAAGGCGGGCGGATCACCTGAGGTCAGGAGTTCCAGACCTGCCTGGCCAACATGGTGGAATCCCATCTCTACTAAAAATACAAAAATCTGCCAGGTGTGGTGGCACACTTCTGTAATCCCAGATACTCAGGAGGCTGAGGCAGGAGAATCACTTGAACCCTGGAGATGGAGGTTGCAGTGAGCCAAGATCAAGAGATTGCACTCTAGCCAGGGTGACTAGAGTGAGACTCGGTCTCAAAAAAAATGTAATTAATTAATTAATTAATACAAAAATTAGCTGGGCGTGGGCTAGGTGTGGTGGCTCACGCCTGTAATCCCAGCACTTTGGGAGGCCGAGACAGGCGGATCACCTGAGGTCAGGAGTTCAAGACCAGTTTAACCAACATGGAGAAACCCCATCTCTACTAAAAATACAAAATTAGCTGGGCGTGGTGGTGCATGCCTGTAATCCCAGCTACTCGGGAGGCTGAGGCAGAAGAATCGCTTGAGCCTGGTAGGCGGAGATCGTGGTGAGCCGAGATCGCGCCATTGCACTCCAGCCTGGACAACAAGAGCGAAACTCCGTCTAAAAAAAAAAAAAAAATTAGCTGGGCATGGTAACAGGCGCCTGTAAACCCAGTTTCCTCGGGAGGCTGAAGCAGAATTGCTTGATCCCAGAGGCAGAGGTTGCAGTGAGCCAAGATAGTGCCATTGCAGTCCAGCCTGGGCAACAAGAGTGAAACTCCGTCTCAAAAAAAAAAAAAAAAAAA","GGCTGGGCGCAGTGGCTCACACCTGTAATCCCAGCACTTAGGGAAGCTGAGGCGAGTAGATCACCTGAGGTCAGGAGTTAGAGACCAGCCTGGCCATCATGGTGAAACCCCGTCTCTACTAAAGATACCAAAAATTAGCTGAGTGTGGTGCTGGGTGCCTGTAATCCCAGAAACTCAGGGTGCCTGTAATCCCAGCAACTCAGGGTGCCTTTAATCCCAGCAACTGAGGGTACCAGTAATCCCAGCAACTCAGGGTGTCTTTAATCCTAGCAACTGAGGGCACCTGTAATCCCAGCAACTCAGGAAGCTGAGACAGGAGAAGTACTTGAACCCAGAAGGCAGAGGTTGCAGTGAGCCGATATTGCACCATTGCACTCCAGTCTGGGCAACAAGAGTGAAACTCTGTCTCAAAAAAAAA"
"chr16","20816618","20817242","JH378118","18053084","18053501","267","2763534","GGCCCGGCGTGGTGGCTCATGCCTGTAATCCCAGCACTTTGGGAGGCCGAGGCCGGCGGATCACCTGAGGTCAGGAGTTTGAGACCACCCTGGCCAACACGGTGAAAACCTGTCTCTACTAAAAATACAAAAATTAGCCAGGCGCAGTGGCTCACGTCTGTAATTCCAGCACTTTGGAGGGCCGAGGGGGGCAGATCACAAGGTCAGGAGTCCAAGACCAGCCAGGCCAACATAGTGAAACCCGGTCTCTACTAAAAATACAAAAAATTAGCCGGGCGTGGTGGCGGACCCCTGTAGTCCCAGCTACTCAGGAGGCTGAGACAGGAGAATCTCTTGAACCCAGGAGGCAGAGGTTGCAGTGAGCCAAGATCATGCCATTCCACTCCAGCCTGGGCGACAGTGCAAGACTCTGTCTCAAAAACAAAAACAAAAAACCCCCAAACCAAAAATTAGCCAGGCGTGGTGGCATGCACCTGTAGTCCCAGCTACTTGGGAGGCTAAGGCAAGAGAATAGCTTGAACCCAGGAGGCAGAGGTTGCAGTGAGCCGAGATAGTGCCATTGCACTCCAACGTGGGTGACAAGAGCAAAACTCTGTCTCAAAAAAAAAAAAAAAAAAGGAAGGAA","GGCTGGGCGCAGTGGCTCACACCTGTAATCCCAGCACTTAGGGAAGCTGAGGCGAGTAGATCACCTGAGGTCAGGAGTTAGAGACCAGCCTGGCCATCATGGTGAAACCCCGTCTCTACTAAAGATACCAAAAATTAGCTGAGTGTGGTGCTGGGTGCCTGTAATCCCAGAAACTCAGGGTGCCTGTAATCCCAGCAACTCAGGGTGCCTTTAATCCCAGCAACTGAGGGTACCAGTAATCCCAGCAACTCAGGGTGTCTTTAATCCTAGCAACTGAGGGCACCTGTAATCCCAGCAACTCAGGAAGCTGAGACAGGAGAAGTACTTGAACCCAGAAGGCAGAGGTTGCAGTGAGCCGATATTGCACCATTGCACTCCAGTCTGGGCAACAAGAGTGAAACTCTGTCTCAAAAAAAAA"
"chr16","21054922","21055508","JH378118","18053084","18053501","243","3001838","GGCCGGGTGCGGTGGCTCACACCTATAATCCCAGCACTTTGAGAGTCTGAGGCAGGCGGATCACCTGAGGTCAGGAGTTCCAGACCAGCCTGGCCAACATGGTGAAACCCAGTCTCTACTAAAAATACAAAAAAAGACCGGGCACAGTGGCTCACGCCTGTAATTCCAGCACTTTGGGAGGCCGAGGCAGGTGGATCACCTGAGGTTGGGAGTTCGCGACCAGCCTGACCGACATGGAGAAATCCCATCTCTACTAAAAATACAAAATTAGCCGGGCGTGGTGGCACATGCCTGTAATTCCAGCTACTCAGGAGGCTGAGGGAGGAGAATCACTTGAACCTGGGAGGCGGAAGTTGTGGCGAGCCAAGATCACGCCATTGCACTCCAGCCTGGGCAACAAGAGTGAAACCCCATTTCAAAAAAAAAAAAAATTAGCCAGGGGTGGTGGTGCATTCTTGTAATACCAGCTACTCGGGAGGCTGAGGTAGGAGAATCACTTGAGCGCAGGAGGCAGATGTTGTAGTGAGCCGAGTGCCATTGCACTACAGCCTGGGCGACAAGAAAGTAACTCCACCTCAAAAAAAAAA","GGCTGGGCGCAGTGGCTCACACCTGTAATCCCAGCACTTAGGGAAGCTGAGGCGAGTAGATCACCTGAGGTCAGGAGTTAGAGACCAGCCTGGCCATCATGGTGAAACCCCGTCTCTACTAAAGATACCAAAAATTAGCTGAGTGTGGTGCTGGGTGCCTGTAATCCCAGAAACTCAGGGTGCCTGTAATCCCAGCAACTCAGGGTGCCTTTAATCCCAGCAACTGAGGGTACCAGTAATCCCAGCAACTCAGGGTGTCTTTAATCCTAGCAACTGAGGGCACCTGTAATCCCAGCAACTCAGGAAGCTGAGACAGGAGAAGTACTTGAACCCAGAAGGCAGAGGTTGCAGTGAGCCGATATTGCACCATTGCACTCCAGTCTGGGCAACAAGAGTGAAACTCTGTCTCAAAAAAAAA"
"chr16","27896431","27896766","JH378166","6401112","6401453","56","21495319","GGCCAGGCGCGGTGGCTCACGCCTGTAATCCCAGGACTTTGGTAGTCCAAGGCGGGTGGATCACCTGAGGTCAGGAGTTCAAGATCAGCCTGACCAACATGGCAAAACCTCGTCTCTACTAAAAAATACAAAAATTAGCCGGTGTGGTGGCAGGTGCCTGTAATTCCAGCTACTCGGGACGCTGAGTCATGAGAATTGCTTGAACCTAGGAGGCAGATGTTGCAATGAGCCGAGATCGCACCATTGTACTCCAGCCTGGGCGACAAGAGGGAAACTGTCTCCAAAAAAAAAAAAGAAAGAAAGAAAGAAAGAAAGAAAAAAGAAAAACAAAACAAA","GGCCAGGTGCAGTGGCTCACCCCTGTAATCCCAGCACTTTGGGAGGTCGAGGTGGGTGGATCACCTGAGGTCAGGAGTTCAAGACCAGCCTGACCAAAATGGTGAAACCCCATCTCTACTAAAAATACAAAACATTAGCCAGACATCGTGGCGGGCACCTGTAATCCCAGCTACTTGGGAGGCTGAGGCAGGAGAATTGCTTGAGCCTAGGAGGCGGAGGTTACAGTGAGCCATGATCGTGCCATTGGACTCCAGCCTGGGCTACAAGAGCGAGACTCCATCTCAAAAAAAAAAAAAAAAAAAAAAAAGAAAGAAAGAAAGAAAGAAAGAAAAGAAAGAAAG"
"chr16","36524888","36525430","JH378206","6546474","6546861","201","29978414","TTTGAGACCAGCCTGGCCATTGTGGTGAAACCCCGTCTCTACTAAAAAAAATTCAAAAAATGGCTGGGTATGGTGGCTCACGCCTGTAATCCCAGGACTTTGGGAGGCCAAGGTGGGCGGATCACCTGAGGTCAGGAGTTTGAGACCAGCCTAGCCAACATGGTGAAACCCCGTCTCTACCAAAAATACAAAAATTAGCCGGGCTTGGTGGCGCGCACCTGTAATCCCAGGTACACTGGAGGTTGAGGCACAAGAATCGTTTGATCCTGGGAGGTTGCAGTGAGCCAAGATCACGCCACTGCACTCCAGACTGGGTGACAGAGCGAGATTCCATCTCAAAACAACAACAACAAACCCAAAAAATTAGCTGGGTGTGGTGGTGGGTGCCTGTAATCCCAGCTACTTAGGAGGCTGAGGCAGAAGAATCGCTTGAACCCAGGAGGTGGAGGTTGTTGCAGTGAGCAGAGATCGCACCATTGCACTCCAGCCTGGGCAACGAGTGAAACTCCATCTCAAAAAAAAAAAAAAAAAAAGAAAAAAAAA","GGCCACACATGGTGGCTAACGCCTGTAATCCCAGCACTTTGGGAGGCCAAGTCGGGTGGATCATGAGGTCAGGAGACCAAGACCATCCTGGCCAAATGGTGAAACCCCGTCTCTACTAAAAATACAAAAATTAGCTGGGCATGGTGGCGTGTGCCTGTAATCCCAGCTACTCAGGAGGCTGAGGCAGGACAATTGCCTGAACCCAGGAGAATTAGCTGGGCATGGTGGCGTGTGCCTGTAATCCCAGCTACTCAGGAGGCTGAGGCAGGACAATTGCCTGAACCCAGGAGGCGAAGGTTGCGGTGAGCCGAGATTGTGCCATTGCACTCCAGCCTGGGTAACAAGAGCGACACTCTGTCTCAAAAAAAAAAAAAAAAAAAAAAAAAAA"
"chr16","36528224","36528842","JH378119","32351107","32351490","270","4177117","GGCCAGGCGTGGTGGCTCACGCCTGTAATCCCAGCACTTTGGGAGGCTGAGGCAGGCAGATCACCTGAGGTCAGGAGTTCAAGACCAGCCTGGCCAACATGGTGAAACTCCATCTCTACTAAAAATACAAAATTAAGCCGGGCACGGTGGCTCACATCTGAAATCCCAGCACCTTGGGAGGCTAAGGCAGGCGGATCACGAGGTCAGGAGTTCAAGACTAGCTGACCAATATGGTGAAACCCCGTGTCTACTAAAAATACAAAAAAAATTAGCTGGGCGTGGTGGCGCATGCCTGTAGTTCCAGGTACTCAGGAGGCTGAGGAAGGAGAATCACTTGAACCTGGGAGGCGGAGGTTGCAGTGAGCCAAGATCATGCCACTGCATTCCAGCCTGGGCAACAGAGCAAGACTCTGTCTCAAAAATAAAAATAAAAATAAAAGTAAAAATACAAAATTAGCCAGGCGTGGTGGTGTGTGCCTGTAATCACAGCTACTCAGGAGGCAGGAAAATCACTTGAACCTAGGAGGAGGAGGTTGGTGAGCCAAGATCACACCATTGCACTCCAGCCTGGGCAAAAAGAGCAAAACTCCGAACTCTGTCTCAAAAAAAAAAAAAAAAA","GGCCAGGTATGGTGGCTCACACCTGTAATCCCAGCACTTTGGGAGGCCAAGGCAGGCAGACCACCTGAGGTCAGGAGTTCGAGATCAGCCTAGCCAACATGGTGAAACCCCATCTCTAGTAAAAATAAAATTAGCCAGGCATGGTGGTGCATGCCTGTAACGCAGGTCAGGAGTTCGAGATCAGCTTAGCCAACATGGTGAAACCCCATCTCTAGTAAAAATAAAATTAGCCAGGCAGGTGGTGCCGCCTGTACTCGGGAGGCTGAGGCAGGAGAATCACTTGAACCCAAGAGGCAGAGGTTGCAGTCAGCCAAGATCATGCCATTGCACTCCAGCCTAAGCAAAAAGAGTAAAACTCAGTCTCAAAACAAAAAAACAAAAAAA"
"chr16","44800308","44800913","JH378118","18053084","18053501","244","26747224","GGCCTGGTGCAGTGGCTCACACCTGTAATCCCAGCACTTTGGGAGCCCAAGGCGGGTGGATCACCTGAGGTCAGGAGTTCGAGACCAGCCTGGCCAACATGGTGAAATCCTCTCTACTAAAAATGCAAAAAATTAGCTGGGCGGCCAGGCGCAGTGGCTCACGCCTGTAATCCCAGCACTTTGGGAGGCCGAGGTGGGCGGATCACAAGGTCAGGAGATCGAGACCATGCTGGCTAACACGGTGAAACTCCGTCTCTACTGAAAATACAAAAAATTAGCCAGGCACGGTGGCGGGCGCCTGTAGTCCCAGCTACTGGGGAGGCTGAGGCAGGAGAATGGCGTGAACCTGGGAGGTGGAGGTAGCAGTGAGCCAAGATTGCGCCACCGCAGTCCGGCCTGGGTGAAAGAGCGAGACGCTGTCTCAAAAAAAAAAAAAAAAAATTAGCTGGGCATGGTGGCGGGCGCCTGTAATCCCAGTTACTCGGGAGGCTGAGGCAGGAGAATCAGTTGAACCCAGGAGGTGGAGGTTGCAGTAAGCCAAGATTGTGCCATTGTACTCCAGTCTGGGCAACAAGAGCGAAACTCTGTCTTAAAAAACAAAAAAAA","GGCTGGGCGCAGTGGCTCACACCTGTAATCCCAGCACTTAGGGAAGCTGAGGCGAGTAGATCACCTGAGGTCAGGAGTTAGAGACCAGCCTGGCCATCATGGTGAAACCCCGTCTCTACTAAAGATACCAAAAATTAGCTGAGTGTGGTGCTGGGTGCCTGTAATCCCAGAAACTCAGGGTGCCTGTAATCCCAGCAACTCAGGGTGCCTTTAATCCCAGCAACTGAGGGTACCAGTAATCCCAGCAACTCAGGGTGTCTTTAATCCTAGCAACTGAGGGCACCTGTAATCCCAGCAACTCAGGAAGCTGAGACAGGAGAAGTACTTGAACCCAGAAGGCAGAGGTTGCAGTGAGCCGATATTGCACCATTGCACTCCAGTCTGGGCAACAAGAGTGAAACTCTGTCTCAAAAAAAAA"
"chr16","45828895","45829498","JH378118","18053084","18053501","256","27775811","GGCCAGGAGAGGTGGCTCATGCTTGTAATTCCAGTATTTTGGGAGCCCAAGGCGGGTGGATCACTTGAGGTCAGGAGTTTGAAACCAGCCTGACCAACATGGTGAAACCCCGTCTCTACTAAAAATTCAAAATTAGGCAAGGCCTGGTGGCTCATGCCTGTAATCCCAGCACTTTGGGAGGCCAAGGAGGGAGGATCACCTGAGGTCGGGAGTTTGAGACCAGCCTGACCAACATGGAGAAACCCCGTCTCTACTAAAACTACAAAATTAGCCGGGTGTGGTGGCCCATGCCTCTAATCCCAGCTACTCTGGAGGCTGAGGCAGGAGAATCACTTGGACCTGGGATGTGAAGGTTGCAGTGAGCCAAGATCGAGCCATTGCACTCCAGCCTGGGCCACAAGAGTGAAACTCCGTCCCAGAAAAAAAAAAAAAAATTAACCTGGCATGGTGGTGTATGCCTGTAATCCCAGCTACTCGGGAGACTGAGGCAGGAGAATCTCTTGAACCCGGGAGGCGGAGGTTGCAGTAAACCGAGATTGCGCCATTGCACTCCGGCCTGGGTGACAAGAGCGAAACTCCGCCTAAAAAAAAAAAGAAAAGAAAA","GGCTGGGCGCAGTGGCTCACACCTGTAATCCCAGCACTTAGGGAAGCTGAGGCGAGTAGATCACCTGAGGTCAGGAGTTAGAGACCAGCCTGGCCATCATGGTGAAACCCCGTCTCTACTAAAGATACCAAAAATTAGCTGAGTGTGGTGCTGGGTGCCTGTAATCCCAGAAACTCAGGGTGCCTGTAATCCCAGCAACTCAGGGTGCCTTTAATCCCAGCAACTGAGGGTACCAGTAATCCCAGCAACTCAGGGTGTCTTTAATCCTAGCAACTGAGGGCACCTGTAATCCCAGCAACTCAGGAAGCTGAGACAGGAGAAGTACTTGAACCCAGAAGGCAGAGGTTGCAGTGAGCCGATATTGCACCATTGCACTCCAGTCTGGGCAACAAGAGTGAAACTCTGTCTCAAAAAAAAA"
"chr16","47110839","47111458","JH378118","18053084","18053501","268","29057755","GGCCAGGCGTGGTGGCTCACGCCTTTAATCCCAGCACTTTGGGAGGCCGAGGCAGGCAGATCACCTAAGGTCAGGAGTTCGAGACCAGCCTGGCCAACATGGTGAAACCCCCTCTCTACTAAAAATGCAAAAATTTCTGGGCATGGTGGCTCACGCCTGTAGTCCCAGCACTTTGGGAGGCCAAGGCAGGCGGATCACTTGAGGTCAGGAGTTTGAGACCAGCCTGGCCAACATGGTGAGACCCCTGTCTCTACTAAAAATATAAAAAAGTAGCCAGGCGTGGTGGTGTATGCCTCCCAGATAATTGGGAGGCTGAGGTGGGATAATTGCTTGAACCCGGGAGGCAGAGGTTGTAGTGAGCCAAGATAGCGCCAATGCACTCCAGCCTGGGCAACAGAGCGAGACTCTGTCTCAAAAAAAAAAAAAAAAAGAAAAAAGAAAAGAAATTAGCTGGGCGTGGTGATGGGTGCCTGTAATCCCAGCTGCTTAGGAAGCTGAGGAAGGAGAATCACTTAGACCCAGGAGACAGAGGTTGCAGTGAGCCGAGATCGCACCATTGTATTCCAGCCTGGGTGACAAGAGAAAAACTATGTCTCAAAAAAAAAAAAAAGAGTAGAAAA","GGCTGGGCGCAGTGGCTCACACCTGTAATCCCAGCACTTAGGGAAGCTGAGGCGAGTAGATCACCTGAGGTCAGGAGTTAGAGACCAGCCTGGCCATCATGGTGAAACCCCGTCTCTACTAAAGATACCAAAAATTAGCTGAGTGTGGTGCTGGGTGCCTGTAATCCCAGAAACTCAGGGTGCCTGTAATCCCAGCAACTCAGGGTGCCTTTAATCCCAGCAACTGAGGGTACCAGTAATCCCAGCAACTCAGGGTGTCTTTAATCCTAGCAACTGAGGGCACCTGTAATCCCAGCAACTCAGGAAGCTGAGACAGGAGAAGTACTTGAACCCAGAAGGCAGAGGTTGCAGTGAGCCGATATTGCACCATTGCACTCCAGTCTGGGCAACAAGAGTGAAACTCTGTCTCAAAAAAAAA"
"chr16","48159907","48160229","JH378222","6231244","6231546","61","41928663","GGCTGGGCACAGTGGCTCATGCCTGTAATCCCAGCACTTTGGGAGGCCGAGGCAGGCGGATCACCTGAGGTCAGGAGTTCGAGACTAGCCTGGCCAATATAGCGAAACCCCGTCTCTACTAAAAATTAGTTGGGCATGGTGGCAGGCGCCTTAATCCCAGCTACTTGGGATGCTGAGGCAGAAGAATCGCTTGAACCCAGAGGGTGGAGGTTTCAGTGAGATGAGATCGTGCCATTGCACTCCAGACTGGGCAACAAGAGCGAGACTCTGTAAAAAAAATTAATTAATTAATTAACTAATTAATTAAAATAAAATGAGAAAAA","GGCTGGGCATGGTGGCTCACGCCTGTAATCCCAGCACTTTGGGACGCTTAGGCAGGTGGATTGCCTGAGGTCAGGAGTTCAAGACTACCCTGACCAACATAGTGAAACCCCGTCTCTACTAAAAATTAGCTGGGCATGGTGGCAGAGGCCTGTAATCCCAGCTACTCGGGAGGCTGAGGCAGGAGAATCACTTAAACCTGGGAGTTGGAGGTTGCAGTGAGCCAAGATCAAGCCATTGCACTCCAGTCTGGGCAACAAGAGCAAGACTCTGTCTCAAAAAAAAAAAAAAAAAGAAAAGAAAAA"
"chr16","49252302","49252639","JH378314","538162","538484","57","48714140","GGCCAGGCGCAGTGGTGCATGTCTGTAATCTTAGCACTTTGGGAGGCCGAGGTGGACGGATTACATGAGGTCAGGAGTTCAAGACCAGCCTGGCCAACATGGTGAAATTCCATCTCTACTACTAAAAAAAAAAAAAAAAAAAAAAAAAAAAAAAAAAAAAAATACAAAAATTAGCTGGGCTTGGTGGCGGGTGCCTGTAATCCCAGCTACTTGGGAGGCTGAGGCAGGAATCACTTAAACCCAGGAGGTGGAGGTTGCAGTGAGCCAAGACCATGCCATTGCACTCCAGCCTGGGCAACAAGAGCAAAACTCCGTCTCAAAAAAACAAAACAAAAAAA","GGCTGGGTGCGGTGCCTCACACCTGTAATCCCAGCACTTTGGGAGGCCGAGGTGGGTGGATCACGAGGTCAAGAGATCAAGACCATCCTGGTCAACATGGTGAAACCCTGTCTCTACTAAAAAAAAAAAAAAAAAAAAAAAAAAAAAAAAAAAAATTAGCTGGGCATGGTGGCGTGTGCCTGTAATCCCAGCTACTCAGGAGGCTGAGGCAGGAGAATTGCCTGAACCCAGGAGGCGGAGGTTGCGGTGAGCCGAGACTGTACCATTGCACTCCAGCCTGGGTAACAAGAGCGAAACTCCATCTCAAAAAAAAAAAAAAAAAA"
"chr16","49464616","49465219","JH378118","18053084","18053501","254","31411532","GGCCAGGCGTGGTGGCTCACACCTGTAATCCTAGCACTTTGGGAGACTGAGGCAGGTGGATCACATGAGGTGAGGAGTTCAAAACCACCCTGGCCGACATGGTGAAACCCCGTCTCTACTAAAAATATTTTTAAAAAGGCCAGGCGTGGTGGCTCACACCTGTAATTCCAGCACTTCGGGAGGCTGGGGCAGGCAGATCACAAGGTCAGGAGATCGAGACCATTCTGGCCAACGTGGTGAAACCCCGTCTCTACTAAAAATACAAAAATTAGCTGGGCGTGGTGGCGCGTGCCTGTAATCCCAGCTACTTGGGAGGCTGATACAGGAGAATTGCTTGAACCAGTGAGTCAGAGGTTGCAGTGAGCTGAGATTGCGCCATTGCACTCCAGCCTGGCAACAGAATGAGACTCCGTCTCAAAAAAAAAAAAAAAATTAGCTGGGCATGGTGGCAGGCACCTGTGATCCCAGCTACTTGGGAGGCTGAGGCAGGAGAATCGCTTGAACCTGGGAGGTGGAGGTTGCAGTGAGCTGAGATTGCGCCATTGCACTCCAACCTGGGCGTCAAGAGCAAAACTCCATCTCAAAAATAAATAAATAAATAAAA","GGCTGGGCGCAGTGGCTCACACCTGTAATCCCAGCACTTAGGGAAGCTGAGGCGAGTAGATCACCTGAGGTCAGGAGTTAGAGACCAGCCTGGCCATCATGGTGAAACCCCGTCTCTACTAAAGATACCAAAAATTAGCTGAGTGTGGTGCTGGGTGCCTGTAATCCCAGAAACTCAGGGTGCCTGTAATCCCAGCAACTCAGGGTGCCTTTAATCCCAGCAACTGAGGGTACCAGTAATCCCAGCAACTCAGGGTGTCTTTAATCCTAGCAACTGAGGGCACCTGTAATCCCAGCAACTCAGGAAGCTGAGACAGGAGAAGTACTTGAACCCAGAAGGCAGAGGTTGCAGTGAGCCGATATTGCACCATTGCACTCCAGTCTGGGCAACAAGAGTGAAACTCTGTCTCAAAAAAAAA"
"chr16","49983504","49983843","JH378316","567988","568320","50","49415516","GGCCAGGCATGGTGGCTTACGCCTGTAATCTCAGCACTTTGGGAGGCCAAGGCAGGCGGATCACCTGAGGTCAGGAGTTCAAGACCAGCCTGGTCAACATGGCGAAACCCTGTCTCTACTAAAAAAATACAAAAATTAGCCAGGCGTGGTGGTGGGCGCCTGTAATCTCTCCTACTTGGGAGACTGAGGCAGGAGAATTGCTTGAACTCAGAAGGCAGAGGTTGCAGTGAGCTGAGATCACGCCATTGCACTCCAGCCTGGATGACAAGAGCAAAACTCCATCTCAAACAAACAAAAAACAAACAAACAAAAAAAAACAAAAAAACCTCCAAAAAACAAA","GGCCGGGCGTGGTGGCTCACGCCTGTAATCCCAGCACCTTGGGAGGCTGAGGCGGGTGGATCACGAGGTCAAGAGATTGAGACCAGCCTGGTCAACATGGTGAAACCCTGTCTACTAAAAAAATACAAAAATTAGCTGGGCATGGTGGCACGTGCCTGTAATCCCAGCTACTCAGGAGGCTGAGGCAGGAGAATTGCCTGAACCCAGGAGGCGGAGGTTGCGGTGAGCCGAGATCGCGCCATTGCACTCCAGCCTGGGTAACAAGAGCGAAACTCCGTCTCAAAAAACAAAAAACAAAAAAACAAAAAACAAACAAACAAACAAAAAAACAAA"
"chr16","50470493","50471105","JH378118","18053084","18053501","251","32417409","GGCTGGGAGCGGTGGCTCATACCTGTAATCCCAGCACTCTGGGAGGCCGAGGCGCGTGGATCACCTGAGGTCAGGAGTTTGAGACCAGCCTGGCCAGCATGGTGAAACCCTGTCTCTACTAAAAATAGAAAAAGTTAGCTGGGTGAACAGCCGGGCGCGGTGGCTCACACCTGTAATCCCAGCACTTTGGGAGGCCGAGGCAGGTGGATCACAAGGTCAGGAGATCGAGACCATCCTGGCTAACACGGTGAAACCCTGTCTCTACTAAAAATATAAAAAATTAGCCGGGCATGGTGGTGGGTGCCTGTAGTCCCAGCTGCTCAGGAGGCTGAGGCAGGAGAATGGCGTGAAGCCAGGAGGCAGAGGTTGCAGTGAGCCGAGATCGTACCACTGCACTCTAGCCTGGGTGACAGAACGAGACTGTGTCTCAAAGAAAAAAAAAATTAGCTGGGTGTGGTGGCAGACACCTGTAATCCTAGCTACTTGGGAGGTTGAGGCAGGAGAATCGCTTGGACCTGGGAGGCGGAGGTTGCAGTAGGCTGAAATCGCACCATTGCACTCCAGCCTGGGCAACAAGAGGGAAACTCAGTCTCAAAAAAAAAAAAAAAAAAAA","GGCTGGGCGCAGTGGCTCACACCTGTAATCCCAGCACTTAGGGAAGCTGAGGCGAGTAGATCACCTGAGGTCAGGAGTTAGAGACCAGCCTGGCCATCATGGTGAAACCCCGTCTCTACTAAAGATACCAAAAATTAGCTGAGTGTGGTGCTGGGTGCCTGTAATCCCAGAAACTCAGGGTGCCTGTAATCCCAGCAACTCAGGGTGCCTTTAATCCCAGCAACTGAGGGTACCAGTAATCCCAGCAACTCAGGGTGTCTTTAATCCTAGCAACTGAGGGCACCTGTAATCCCAGCAACTCAGGAAGCTGAGACAGGAGAAGTACTTGAACCCAGAAGGCAGAGGTTGCAGTGAGCCGATATTGCACCATTGCACTCCAGTCTGGGCAACAAGAGTGAAACTCTGTCTCAAAAAAAAA"
"chr16","50478366","50478929","JH378114","15957391","15957789","242","34520975","GGCTGGGCACGGTGGCTCATGCCTGTAATCCTAGTACCCTGGGAGGCTGAAGCTGGCAGATCACTTGAGGTCAGGAGTTCGAAACCAGCCTGGCCAACATGGTGAAACCTCATCACTACTAAAAATACAAAAAGTCAGCCGAGCGCGGTGGCTCACGCCTTTAATCCCAGCACTTTAGGAGTCTGAGGCGGGTGGATCACAAGGTCAGGGGTTTGAGACTAGCCTGACCAACACGGTGAAACATCTTTACTAAAAATAGCCAGGCATGGTGGTGCAGGCCTGTAGCAGGTACTCAGGAGGCTGAGGCAGCAGAATCGCTTGAACCCGGGAGGCGGAGGTTGCAGTGAGCCGAGATTGAGCCACTGCACTCCACCCTGGGCAACTGAGCGAGACTCCGTCTCAAAAAAAAAAAAAAAAATTAGCTGGACGTGGTGGTGGATGCCTGTAATCCCGGCTACTTGGTACTTGGAAGGCTGAGACAGGAGAATCGCTTGAACCCGGGAGGTGGAGGTTGCAGTGAGCTGAGATAGCGCCATTGCACTCCAGCCTGGGCAACAAGAGTGA","GCAAGGAACGGTGGCTCATGCCTGTCATCCCAGCACTTTGGGAGGCTAAGGAGGGTGGATTACCGAAGGTCATGAGTTTGAGACCAGCCTGACCAACATGGTGAAAACCCCATCTCTACTAAAAATACAAAAAATTAGCCAGATACAGCTATGCGGCAGACTGGGGCAGGAGAATCGCTTGGACCCAAACCCCATCTCTACTAAAAATACAAAAAATTAGCCGGATACAGCTATGCGGGAGACTGGGGCAGGAGAATCGCTTGGACCCGGGAGGCAGAGATTGCAGTGAGATGAGACCATGCCATTGCTCTCTAGCTTGTGCGATGAGAACAAGACTCTGTCTCAAAAAAAAAAAAAAAAAAAAAAAAAAAAAAAAAAAAAAAAGAGAGAGAGAGAAAA"
"chr16","51388263","51388584","JH378271","2122362","2122678","46","49265901","GGCTGGGTACGGTGGCCCACACCTGTAATCCCAGCACCTTGGGAGGCTGAGGTGGGCGGATTACCTGAGGTCAAAAGTTCAAGACCAGCCTGGCCAACATGGTGAAATCCCATCTCTGCTAAAAATACAAAAAAAAAAAAAAAAAAAAAAAAAAAATTGCCAGGCATGGTGGCAGGCACCTGTAATCCCAGCTACTTGGGAGGCTGAGGCAGGGGAATCGCTTGAACCTGGGAGGCAGAGGTTGCAGTGAGCCCAGATAGCGCCATTGCACTCCAGCCTGGGCGACAAGAGCGAAACTCTGTCCAAAAAAAAAAAAAAAAAA","GGCCGGGCACGGTGGCTCACACCTGTAATCCCAGCACTTTGGGAGGCTGAGGTGGGTGAATCACCTGAGGTCAGGAGTTTGAGACCAGCCTGACCAACATGATGAAACCCGGTCTCTGCTAAAAATACAAAAAAAAAAAAAAAAAAAAAAAAAAAAAGCTGGGCATGATGGTGGGCACCTGTAATCCCAGCTACTCGGGAGGCTGAGGCAGGAGAATCGCTTGAACACCAGGAGGTGGAGGTTGCTATGAGCCGAGATCGCACCATTGCACTCTAGCTTGGGCAACAAGAGAGAAACTCCATCAAAAAAAAAAAAAA"
"chr16","51876298","51876882","JH378118","18053084","18053501","253","33823214","GTAATCCCAGCACTTTGGGAGGCCCAAGTGGGTGGATCACCTGAGGTCAGGAGTTCATGACCAGCCTGGCCACATGGTGAAACCCCATCTCTACTAAAAATACAAAATTAGGCTGGGCGCGGTGGCTTACGTCTGTAATTCCAGCACTTTGGGAGGCCGAGGCAGGCGGATCATGAGGTCAGGAGATTGAAACCATCCTGGCTAACACGGTGAAACCCTGTCTCTACTAAAAATACAAAAAATTAGCCGGGTGTGGTGGGGGGGCGCCTGTAGTCCCAGCTGCTCAGGAGGCTGAGGCAGGAGAATGGCATGAACCCGGGGGGGCGGAGCTTGCAGTGAGCTGAGATCATGCCACTGCACTCCAGCCTGGGCAACAAAGTGAGACTCCGTCTCAAAAAAAAAAACCAAAAAACAAAATGAGCTGGGTGTGGTGGTGGGGGCGTATAATCCCAGCTATACAGGAGGCTGAGGTAGGAGAATCACTTGAACCCGGGAGGTGGAGGTTGCAGTGAGCCGAGATTGTGCCATTTCACACCAACCTGGGTAACAAGAGTAAAATGCTGTCTCAAAAAAAAAAAAGAAAAA","GGCTGGGCGCAGTGGCTCACACCTGTAATCCCAGCACTTAGGGAAGCTGAGGCGAGTAGATCACCTGAGGTCAGGAGTTAGAGACCAGCCTGGCCATCATGGTGAAACCCCGTCTCTACTAAAGATACCAAAAATTAGCTGAGTGTGGTGCTGGGTGCCTGTAATCCCAGAAACTCAGGGTGCCTGTAATCCCAGCAACTCAGGGTGCCTTTAATCCCAGCAACTGAGGGTACCAGTAATCCCAGCAACTCAGGGTGTCTTTAATCCTAGCAACTGAGGGCACCTGTAATCCCAGCAACTCAGGAAGCTGAGACAGGAGAAGTACTTGAACCCAGAAGGCAGAGGTTGCAGTGAGCCGATATTGCACCATTGCACTCCAGTCTGGGCAACAAGAGTGAAACTCTGTCTCAAAAAAAAA"
"chr16","59738190","59738518","JH378138","4229795","4230103","67","55508395","TCACAGCATTTTGGGAGGCCAAGGCAGGCGGATCACCTGTGGTCAGGAGTTTGAGACCAGCCTGGCCAACATGGTGAAACCCCATCTCTACTAAAAATACAAAACAATTAGCCAGGTTTGGTGGCAGGCGCCTATAATCCCAGCTACTTGGGAGGCTGAGGCAGGAGAATCGCTTGAACCCAGGAGGCGGAGGTTGCAGTGAGCCGAGAACACACCATTGTACTCCAGCCTGCGACAAGAACGAAACTGTATCTCAATTAAAAAAAAAAAAAGAAAGGGAGGAAGGAAGGAAGGAAGGAAGGAAGGAAGGAAGGAAGAAAGAAAGAAAA","CACTTTGGGAGGTGAAGGCGGGCAGATCACCTGAGGTCAGGAGTTCGAGACCAGCCTGGCCAACATGGTGAAACCCCGCCTCTACTAAAAATACAAAAATTAGCCAGGTGTGACACTAGGCATCTGTAATCCCAGCTACTTGGGAGGCTGAGACAGGAGAATCACTTGAACCCAGGAGGCGGAAGTTGCAGTGAGCCAAGATCATGCCATTGCACTCCAGCCTGGGTGACAGGAGCAAAACTCTGTCTCAAAAAAAAAAAAAAAAAAAAAAAAAAAAAAAAAAAAAAAAGAAAAGAAAAGAAAAGTAAA"
"chr16","64682336","64682940","JH378118","18053084","18053501","253","46629252","GGCCGGGCACGGTGGCTCACTCCTGTAATCCCAGCACTTTGGGAGGGTGAGGCAGGTAGATCAAAAGGTCAGGAGTGGCCAGGCGTGGTGGCTCACACTTGTAATCCCAGCACTTTGGGAGGCCGAGATGGGCAGATCACGAGGTCAAGAGATTGAGACCATCCTGGCTAACATGGTGAAACCCCGTCTCTACTAAAAATACAAAAAATTAGCCGGGTGTGGTGGCAGGCGTCTGTAATCCCAGCCACTTGGGAGGCTGAGGCAGGAGAATCGCTTGAACCTGGGCGGCAGAGGTTGCATTGAGCCAGGATCGCGCCACTGCACTCCAGCCTGAGCAAAAAGAGCGAAACTCTGTCTCAGAAAAAAAAAAAAGTCAGGAGTTTGAGACCAGCCTGGCCAATATGGTGAAACCCCGTCTCTACTAAAAATACAAAAATTAGCCGAGCGTGGTGGTGGGTGCCTATACTCCCAGCTACTCAGGAGGCTGAGGCAGGAGAATCACTTGAACCCCAGGGGCAGAGGTTGCAGTGAGCCGAGATCGTGCCATTGCACTTCACCCTGGGTGAAAGAGCAAAACTCCGTCTCAAAAAAACAAAACAAAAAAA","GGCTGGGCGCAGTGGCTCACACCTGTAATCCCAGCACTTAGGGAAGCTGAGGCGAGTAGATCACCTGAGGTCAGGAGTTAGAGACCAGCCTGGCCATCATGGTGAAACCCCGTCTCTACTAAAGATACCAAAAATTAGCTGAGTGTGGTGCTGGGTGCCTGTAATCCCAGAAACTCAGGGTGCCTGTAATCCCAGCAACTCAGGGTGCCTTTAATCCCAGCAACTGAGGGTACCAGTAATCCCAGCAACTCAGGGTGTCTTTAATCCTAGCAACTGAGGGCACCTGTAATCCCAGCAACTCAGGAAGCTGAGACAGGAGAAGTACTTGAACCCAGAAGGCAGAGGTTGCAGTGAGCCGATATTGCACCATTGCACTCCAGTCTGGGCAACAAGAGTGAAACTCTGTCTCAAAAAAAAA"
"chr16","67872770","67873371","JH378118","18053084","18053501","260","49819686","GGCTGGGCATGGTGGCTCATGCCTGTAATCCCAGCACTTTGGGAGGCCAAGACGGGCAAATCACCTCAGGTCAGGAGATCGAGACCAGCCTGGCCAACACAGCAAAACCCACCTCTCTACTAAAAATAGAAAAATTACCCAGGCGTCACAGCTCACGCTTATAATCCCAGCACTTTGGGAGGCCGAAGCAGGTGGATCACAAGGTCAGGAGATCGAGACCAGCCTCACTAACATGGTGAAACCCCGTCTCTACTGAATATACGAAAAATTAGTCGGGTGTGGTGGCAGGCACCTGTAGTCCCAGCTACTTGGGAGGCTGAGGCAGGAGAATGGCTTTAACTCAGGAAGAGGAGCTTACGGTGAGCTGAGATTGTGCCACTGCACCCCAGCCTGGGCGACAGAGCAAGACTCCGTCAAAAAAAAAAAAAACCCCAAAACCCCAGCGTGGCAGCAGGTACCTGTAGTCCCAGCTACTCGGGAGGCTGAGACAGGAGAATGGCTTGAACCCGGGAGGCGGAGCTTGCGGTGAGCCAAGACGGCGCCACTTCATTCCAGCTATGGTGATAAGAGGGAGACCGTCTCAATCAATAAATTTAAAAAAA","GGCTGGGCGCAGTGGCTCACACCTGTAATCCCAGCACTTAGGGAAGCTGAGGCGAGTAGATCACCTGAGGTCAGGAGTTAGAGACCAGCCTGGCCATCATGGTGAAACCCCGTCTCTACTAAAGATACCAAAAATTAGCTGAGTGTGGTGCTGGGTGCCTGTAATCCCAGAAACTCAGGGTGCCTGTAATCCCAGCAACTCAGGGTGCCTTTAATCCCAGCAACTGAGGGTACCAGTAATCCCAGCAACTCAGGGTGTCTTTAATCCTAGCAACTGAGGGCACCTGTAATCCCAGCAACTCAGGAAGCTGAGACAGGAGAAGTACTTGAACCCAGAAGGCAGAGGTTGCAGTGAGCCGATATTGCACCATTGCACTCCAGTCTGGGCAACAAGAGTGAAACTCTGTCTCAAAAAAAAA"
"chr16","67970409","67971018","JH378118","18053084","18053501","252","49917325","GGGCGGGTGCGGTGGCTCACCCTGTAATCCCAGCACTTTCGGAGGCTTAAGCAGGCGGATCACCTGAGGTCAGGAGTTCGAGACCAGCCTGGCCAACATGGTGAAACCCCATCTCTACTAAAAATACAAAAAAATGGCCGGGTGCGGCGGCTCATGCCTGTCATCCCAGCACTTTCGGAGGCTGAGGCAGGCGGATCACCGGAGGTCAGGAGTTCGAGACCAGCTTGGCCAACATGGTGAAACCCCGTCTCTACTAAAAATACAAAAGTTAGCTGGGCATGGTGGCACATGCCTGTAATCCCAGCTACTCCGGAGGCTGAGGCAGGAGAATCACTTGAACCTGGGGAGGCGGAGGTTGCAGTGAGCTGAAATCACGGCATTGCACTCCAGCCTAGGCAACAGAGCGAAAGTCCGTCTCAGAAAAAAAAAAAAAAAAATTAGATGGGTTTGGTGGCGGGCGCGCTGTAATCCCAGCTACTTGGGAGGCTGGAGGCAGGAGAATCGCTTGAACTCAGGAGGCTGAGGTTACAGTGAGCCGAGATCATGCCATTGCACTCCAGCCTGGGCAATAAGAGTGAAACTCTGTCTCAAAAAACAACAACAACAAAAA","GGCTGGGCGCAGTGGCTCACACCTGTAATCCCAGCACTTAGGGAAGCTGAGGCGAGTAGATCACCTGAGGTCAGGAGTTAGAGACCAGCCTGGCCATCATGGTGAAACCCCGTCTCTACTAAAGATACCAAAAATTAGCTGAGTGTGGTGCTGGGTGCCTGTAATCCCAGAAACTCAGGGTGCCTGTAATCCCAGCAACTCAGGGTGCCTTTAATCCCAGCAACTGAGGGTACCAGTAATCCCAGCAACTCAGGGTGTCTTTAATCCTAGCAACTGAGGGCACCTGTAATCCCAGCAACTCAGGAAGCTGAGACAGGAGAAGTACTTGAACCCAGAAGGCAGAGGTTGCAGTGAGCCGATATTGCACCATTGCACTCCAGTCTGGGCAACAAGAGTGAAACTCTGTCTCAAAAAAAAA"
"chr16","68229729","68230314","JH378206","6546474","6546861","256","61683255","TGGTTTCCGCCTGTACTCCCAGCACTTTCGGAGGCTCAAGTGAGCAGATCGCTTGAGGCCAGGAGTTTAAGACCTACCTAGTCAACACCGGGGAAACCCACATCTCCACTAAACAATGGCCAGGAGCAGTGGCTCATACCTGTAATCACAACACTTTGGGATCCCAGCCAGACGGATCACAAAGTCAGGAGTTTGCGACCAGCCTATTAGAATGGTGAAACCCTGTCTCTACTAAAAATACAAAAAATTAGCCAGGCATGGTGGCGCATGCCTGTCATCCCAGCTACTCGGGAGGCTGAGGCAAGAGAATCACTTAAACCCAGGAGGCAGATGGAGGTTGCAGTGAGCCAAGATCACACCACTGCACTACAGCATGGGCGACAGAGCAAGACTCGGTCTCAAAAAAAAAAAAATTGGCCAGGCACGGTGGCTGACACCTGTAATCCCAGCACTTTGGGAGGCTGAGGCGGGAGAATCGCTTGAACCTGGGAGACGAAGGTTGCAGTGAGCCGAGACTAAGCCATTGCACCCCAACCTGGGCGGCAAGAGTGAAACTCTGTCTCAAAAAAAATTAAAAAATAAAAAA","GGCCACACATGGTGGCTAACGCCTGTAATCCCAGCACTTTGGGAGGCCAAGTCGGGTGGATCATGAGGTCAGGAGACCAAGACCATCCTGGCCAAATGGTGAAACCCCGTCTCTACTAAAAATACAAAAATTAGCTGGGCATGGTGGCGTGTGCCTGTAATCCCAGCTACTCAGGAGGCTGAGGCAGGACAATTGCCTGAACCCAGGAGAATTAGCTGGGCATGGTGGCGTGTGCCTGTAATCCCAGCTACTCAGGAGGCTGAGGCAGGACAATTGCCTGAACCCAGGAGGCGAAGGTTGCGGTGAGCCGAGATTGTGCCATTGCACTCCAGCCTGGGTAACAAGAGCGACACTCTGTCTCAAAAAAAAAAAAAAAAAAAAAAAAAAA"
"chr17","3506470","3507049","JH378118","18053084","18053501","238","14546614","CCTGTCATCCCAGCACTTTGGGAGGCCGAGGCGGGTAGATCACCTGAGGTCAGGAGTTTGAGACCAGCCTGGCCAACATGGCGAAACCCCGTCTCTACTAAAAATACAAAAACTGGCTGGGCGCGGTGGCTCACGCCTGTAATCCCAGCACTTTGGGAGGCTGAGGCGGGTGGATCATAAGGTCAGGAGTTCAAGACCAGCCTGGCCAACATGGTGAAACCCCATCTCTACTAAAAATACAAAAATTAGCCAGGTATGGTGGCAGGTGCCTGTAATCCCAGCTACTCAGGAGGCTGAGGCAGAGAATTGCTTGAACCCGGGAGGGGGAGGTTGCAGAGGGCCAAGATCGTACCACTATACTCCAGCCTGGGTGACAGGATGAGACTCCATCTTAAAAAAAAAAAAAAAAAAAAAAATTAGCCAGGCGTGGTGCGGGCACTTGTAATCCCAGCTATTCAGGAGGCTGAGGCAGGAGAATTGCTTGAACCCGGGAGGCAGAGGTTGCGGTGAGCTGAGATCGCACCATTGCACTCCAGCCTGGGCAACAAGAGTGAAACTCTGTCTCAAAAAAAAAACAAAA","GGCTGGGCGCAGTGGCTCACACCTGTAATCCCAGCACTTAGGGAAGCTGAGGCGAGTAGATCACCTGAGGTCAGGAGTTAGAGACCAGCCTGGCCATCATGGTGAAACCCCGTCTCTACTAAAGATACCAAAAATTAGCTGAGTGTGGTGCTGGGTGCCTGTAATCCCAGAAACTCAGGGTGCCTGTAATCCCAGCAACTCAGGGTGCCTTTAATCCCAGCAACTGAGGGTACCAGTAATCCCAGCAACTCAGGGTGTCTTTAATCCTAGCAACTGAGGGCACCTGTAATCCCAGCAACTCAGGAAGCTGAGACAGGAGAAGTACTTGAACCCAGAAGGCAGAGGTTGCAGTGAGCCGATATTGCACCATTGCACTCCAGTCTGGGCAACAAGAGTGAAACTCTGTCTCAAAAAAAAA"
"chr17","3641899","3642243","JH378198","5062782","5063109","59","1420883","GGCCAGGCACAGTGGCTCACACCTGTAATCCCAGCACTTCAGGAGGCCGAGGTGGGTAGATCACCTGAGGTCAGGGGTTTGAGACCAGCCTGACCGACGTGGCGAAACCCTGTCTCTACTACAAATACAAAAATTAGCCTTATGTGGTGGCGGGCACGTGTAATCCCAGCTACTTGGGAGGCTGAGGCAGGAGAATCGCTTGAATCTGGGAGGTGGAGGTTGCAGTGAGCCGAGATCACGCCATTGCACTCCAGCCTGGGTGACAAGAGCGAAACTCCATCTCAAAATAAATAAATACATACATACATGTATACATACATACATACATAAAAATAAAAAGTAAAA","GCCAGGCATGGTGGCTCACGCCTATAATCTCAGCACTTTGGGAGGCTGAGGCAGGCAGATCACTTGAGGTCAGGAGTTCAAGACCAGCCTGGCCAACATGGTGAAACCCTGGCTCTACTAAAAATACAAAAATTAGCCGGGTGTGGTGGCACGTGCCTATAATCCCAGCTACTCAGGAGGCTGAGGCAGAAGAATCGCTTGAATCCAGGAGGTGGAGGTTGCAGCGAGCCGAGATCACACCATTGGACTCCAGCCTGGGTGACAAGAGCGAAACTCCATCTCAAAATAAATAAATAAATACATAAAATTAAAAATAAATAAATAAATA"
"chr17","4508039","4508546","JH378206","6546474","6546861","194","2038435","GAGTTGGAGACCAGCCTGGCCAACACGGTGAAACCTCGTCCCCACTAAAAATATAAAAATTAGGCCAGGCGCGGTGGCTCACTCCTGTAATCCCAGCACTTTGGGAGGCTGAGGCGGGTAGATCATCTGAGGTCAGGAGTTCGAGACCAGCCTGGCCAACATGGTGAAACTCCGTCTCTACTAAAAATACAAAAATTAGCTGGGCTGGTAGCGGGCACCTGTAATCCCAGCTACTTGGAAGGGTGAGGCAGGAGAATCACTTGAACCCAGGAGGTGGAGGTTGCAGTGAGCCAAGATTGCAGCACTGTACTCCAGCCTGGGTGACAAAGCAAGACTCTGTCTCAAAAAAAAAAAAAAAAAAAAAGCCGGGCTTGGTGGTGAGTACCGGTAATCCCAGCTACTTGGAAGGCTGAGGCGGCGGACGTTGTACTTAGCCGAGATCATGCCATTGCACTCCAGCCTGGGTAACAGGCAAAAACTCTGTCTCAAAAAATAATAAATAATAAAA","GGCCACACATGGTGGCTAACGCCTGTAATCCCAGCACTTTGGGAGGCCAAGTCGGGTGGATCATGAGGTCAGGAGACCAAGACCATCCTGGCCAAATGGTGAAACCCCGTCTCTACTAAAAATACAAAAATTAGCTGGGCATGGTGGCGTGTGCCTGTAATCCCAGCTACTCAGGAGGCTGAGGCAGGACAATTGCCTGAACCCAGGAGAATTAGCTGGGCATGGTGGCGTGTGCCTGTAATCCCAGCTACTCAGGAGGCTGAGGCAGGACAATTGCCTGAACCCAGGAGGCGAAGGTTGCGGTGAGCCGAGATTGTGCCATTGCACTCCAGCCTGGGTAACAAGAGCGACACTCTGTCTCAAAAAAAAAAAAAAAAAAAAAAAAAAA"
"chr17","4560867","4561450","JH378118","18053084","18053501","257","13492217","GGCTGGGGGTGGTGTCTCTTGCCTGTAATCCCAACACTTTAGCAGGCTGAGGTGTGAGTATGGCTTGAGCCAGGAGTTCTAGACCAGCCTAGGAAACATGGCGAGATCCCTATCTCTACTAATACAAAAATTAGCCGGGCGTGGTGGCAAGCACCTGCAATCTCAGCTACTCGGGAGGCTGAGGTGGGAGGGCCGCTTGAGCCCAGGAGGTCCAGGCTGCAGTAAGCACTTATTTAAAAAAAAAAGAAGAGAAAAGATACAGAAATTAGCCAGGCGTGGTGGTGGGCACCTGTAATCCCAGCTACTCAGGAGGCTGAGGCAGGAAAATCACTTGAACCCGGGAGGCAGAGGTTGCAGTGGGCCGAGATCACACCATTGTACTCCAGCCTGGGCAACAAGAGCGAAACTCTGTCTCAAAAAAAAGAAAAGTAAAGTAAAGAAAAGATACAGAAATTAGCCAGGTGTGGTGGCGGGTGCCTGTAATCCCGCTACTTGGGAGGCTGAGGCAGGAGATTGCAGTGAGCCAAGATTGTGCCATTGCATTCCAGCCTGGGCAACAAGAGCAAAACTCCGCCTCAAAAAAA","GGCTGGGCGCAGTGGCTCACACCTGTAATCCCAGCACTTAGGGAAGCTGAGGCGAGTAGATCACCTGAGGTCAGGAGTTAGAGACCAGCCTGGCCATCATGGTGAAACCCCGTCTCTACTAAAGATACCAAAAATTAGCTGAGTGTGGTGCTGGGTGCCTGTAATCCCAGAAACTCAGGGTGCCTGTAATCCCAGCAACTCAGGGTGCCTTTAATCCCAGCAACTGAGGGTACCAGTAATCCCAGCAACTCAGGGTGTCTTTAATCCTAGCAACTGAGGGCACCTGTAATCCCAGCAACTCAGGAAGCTGAGACAGGAGAAGTACTTGAACCCAGAAGGCAGAGGTTGCAGTGAGCCGATATTGCACCATTGCACTCCAGTCTGGGCAACAAGAGTGAAACTCTGTCTCAAAAAAAAA"
"chr17","4846296","4846953","JH378118","18053084","18053501","290","13206788","GGCCAGGTGCAGTGGCTCACGCCTGTAATCCCAGCACTTTGGGAAGCCCAGGTGGGCGGATCACCCAAGGTCAGGGGTTCGAGACCAGCCTGGCCAACATGGTGAAACTCCATCTCTACTAAAAATAGAAAAAAATGGCCTGGTACGGTGGCTAACGCCTGTAATCCCAGCACTTTGGTAGGCCGAGGCAGGCAGATCACGAGGTCAGAAGATCGAGACCATCCTGGCTAACATGGTGAAACCCCGTCTCTACTAAAAATACAAAAAAGTAGCCAGGTGTGGTGGTGGGTGCCTGTAGTCCTAGCTACTCGGGAGGCTGAGGCAGGAGAATGCCGTGAACCCGGGAGGTGGAGCTTGCAGTGAGCTGAGATCACGCCACTGCACTCCAGCCTGGGTGACAGTGCGAGACTGTCTCCAAAAAAAAAAAAAAAAAAAAATTATATATATAATACACACACACACACACACACACACACACACACACAAATCAGCCAGGCGTGGTGGTGCGCACCTGTAATCCCAGCTACTCGGGAGGCTGAGGCAGGAGAGCTCCTCGAACCCAGGAGGCGAAGGTTGCAGTGAGCCGAGATCACACCATTGCACTCCAGCCTGGGCAACAAGAGCGAAACTCTGTCTCAAGGAAAAAAAAAAAAAAAAA","GGCTGGGCGCAGTGGCTCACACCTGTAATCCCAGCACTTAGGGAAGCTGAGGCGAGTAGATCACCTGAGGTCAGGAGTTAGAGACCAGCCTGGCCATCATGGTGAAACCCCGTCTCTACTAAAGATACCAAAAATTAGCTGAGTGTGGTGCTGGGTGCCTGTAATCCCAGAAACTCAGGGTGCCTGTAATCCCAGCAACTCAGGGTGCCTTTAATCCCAGCAACTGAGGGTACCAGTAATCCCAGCAACTCAGGGTGTCTTTAATCCTAGCAACTGAGGGCACCTGTAATCCCAGCAACTCAGGAAGCTGAGACAGGAGAAGTACTTGAACCCAGAAGGCAGAGGTTGCAGTGAGCCGATATTGCACCATTGCACTCCAGTCTGGGCAACAAGAGTGAAACTCTGTCTCAAAAAAAAA"
"chr17","6289040","6289368","JH378152","15932639","15932952","57","9643599","GGCTGGGCGTGGTGGCTCACGCCTGTAATCCCAGCACTTTGGGAGGCCAAGGTGGGTAGATCACCTGAGGTCAGGAGTTTGAGACCAGCCTGGCCAATGTGATGAAACCCTGTATCCACTAAAAAAAAAAAAAAAAAAAAAAAAAAAAATAGCTGGGTGAAGTGGCAAGCACCTGTAATCCCAGCTACTTGGGAGGCTGAGGCAGGAGAATCCCAGGAGGTGGAGATTGATCCCAGGAGGTGGAGGTTGCAGTGAGTCAAGATCATGCCATTGCACTCCAGCCTGGGTGACAAGAGCAAAATTCCATCTCAAAAAAAAAAAAAAGAAAA","GGCCGGGCATGGTGGCTCAAGCCTGTAATCCCAGCACTTTGGGAGGCCGAGGCGGGTGGATCACGAGGTCAAGAGATTGAGACCATCCTGGTCAACATGGTGAAACCCCGTCTCTACTAAAAATACAAAAAAAAAAAAAAAAAAAATAGCTGGGTGTGGTGGCGTGTGCCTGTAATCCCAGCTACTCAGGAGGCTGAGGCAGGAGAATTGCCTGAACCCGGGAGGCGGAGGTTGCGGTGAGCCGAGATCGCGCCATTGCACTCCAGCCTGGGTAACAAGAGCGAAACTCCGTCTCAAAAACAAAAAAAACAAAA"
"chr17","7490664","7491294","JH378118","18053084","18053501","283","10562420","GGCCGGGAGCGGTGGTTCACTCCTGTAATCCCAGCACTTTGGCAGACCGAGGAGGGTGGATCAACTGAGGTCAGAACTTCAAGACCAGCCTGCCGGGCACAGTGGCTCACACCTGTAATCCCAGCACTTTGGGAGGCTGAGGCAGGTGGATCACCCGAGGTCGGGAGTTCAAGACCAGCCTGACCAACGTGGAGAAACCCCGTCTCTACTAAAAATACAAAATTAGCTGGGGTGGTGGCACGTACCTGTAATCCCAGCTACTCGGGAGGCTGAGGCAAGAGAATCGCTTGAACCCGGGAGGCGGAGGTTGCGGTGCGCCGAGATCGCGCCATTACACTCCAGCCTGGGCAAAAAGAGCGAAACTCTGTCTCAAAAAATAAAAAAAGAAAAAGAAAAAGAAAAAGAAGTTCAAGACCAGCCTGGTCAACGTGGTGAAACCCCGTCTCTACTAAAAACACAAAAAAAATTAGGCGGGTGTTGTGGTGGGTGCCTGTAATCCCAGCTACTCAGGAGGCCAAGGCAGGAGAATCACCTGAACCCTGGAGGTGGAGGTTGCAGTGAGTCGAGATCGCACCATTGCACTCCAGCGTGGGTGACAGAGAGCGAGACTCCGTCTCAAAAAAAAAGAAAA","GGCTGGGCGCAGTGGCTCACACCTGTAATCCCAGCACTTAGGGAAGCTGAGGCGAGTAGATCACCTGAGGTCAGGAGTTAGAGACCAGCCTGGCCATCATGGTGAAACCCCGTCTCTACTAAAGATACCAAAAATTAGCTGAGTGTGGTGCTGGGTGCCTGTAATCCCAGAAACTCAGGGTGCCTGTAATCCCAGCAACTCAGGGTGCCTTTAATCCCAGCAACTGAGGGTACCAGTAATCCCAGCAACTCAGGGTGTCTTTAATCCTAGCAACTGAGGGCACCTGTAATCCCAGCAACTCAGGAAGCTGAGACAGGAGAAGTACTTGAACCCAGAAGGCAGAGGTTGCAGTGAGCCGATATTGCACCATTGCACTCCAGTCTGGGCAACAAGAGTGAAACTCTGTCTCAAAAAAAAA"
"chr17","9634166","9634493","JH378110","12773123","12773444","45","3138957","GGCTGGGTGCGGTGGCTCACGCCTGTAATCCCAGCACTGTGGGAGGCCGAGGCAGGTGGATCACCTGAGGTCAGGAGTTTGAGACCAGCTTGGCCAACATGGTGAAACCCTGTCTGCACTAAAAATACAAAAAAAAAAAAAAAAAAAAAAAAATTAGCTGGGTGTGGTGGCGGACGCCTATAATCCCAGCTACTGGGGAGGCTAAGGCAGGAGAATCGCTTGAACCTGGGAGGTGGAGATTGCAGTGAGCCAAGATGGTGCCATTGCACTCCAGCCTGGACAACAAGAGCGAAACTCGGTTTCAAAAAAAAAAAAAAAAAAAAAAAAA","GGCTGGGCGTGGTGGCTCATGCCTATAATCCCAGCACTTGGAGAGGCCAAAGCAGGCAGATTATTTGAGGTCAGGAGTTCCAAACCAGCCTGGCCAACATGGTGAAACCCTGTATCTACTAAAAATGCAAAAAAAAAAAAAAAAAAAAAAATTAGCTGGGCGTGGTGGCAGGTGACTGTATCCCAGTACTTGGTAGGCTGAGGCAGGAGAATTGCTTGAACCTGGGAGGTGGAGGTTGCAGTGAGCTGAGATTGTGCCATTGCACTCCAGCCTGGGCAACAAGAGCAAAACTCTGTCTCAAAAAAAAAAAAAAAAAAAAAAA"
"chr17","9636859","9637187","JH378193","2430153","2430476","55","7206706","GACACGGTAGCTCACGCCTGTAATCCCAGCACTTTGGGAGGTCGAGGCGGGTGGATCACCTGAGGTCAGGAGTTTAAGACCAGCCTGGCCAACATGGTGAAACCCCGTCTCTGCTAAAAATACAAGAATTAGCCAGGCGTGGTGGTGGGCGCCTGTAATCCCAGCTACTGGGGAGGCTGAGGCAGGAGAATCACTTGAACCCAGAAGGTGGAGGTTGCAGTGAGCCAAGACCACACCACTGGACTGCAGCCTGGCGGACAAGAGCGAGACTCTGTCTCAAAAACAACAACAACAACAACAACAACAACAAAAGAAAGAAAAGAAAAGAA","GGCCGGGCACAGTGGCTCAAGCCTGTAATCCCAGCACTTTGGGAGGCCGAGGTGGGTGGATCACGAGGTCAAGAGATCGAGACCAACCTGGTCAACATGGTGAAACCCCGTCTCTACTAAAAATACAAAAATTAGCTGGGCATGGTGGTGTGTGCCTGTAATCCCAGCTACTCAGGAGGCTGAAGCAGGAGAATTGCCTGAACCCAGGAGGAGGAGGTTGCGGTGAACCAAGATCACGCCATTGCACTCCAGCCTGGGTAACAAGAGCGAAACTCTGTCTCAAAACAAAACAAAACAAAACAAAACAAAACAAACAAAAAAAAA"
"chr17","9725612","9725938","JH378224","2846632","2846964","49","6878980","GGGCGTGGTGGCTCACACCTGTAATCCCAGCACTTTGGGAGGCCGAGGTGGGCGGATTGCCTGAGGTCAGGAGTTCGAGACCAGCCTGGCCAACCCGGTGAAACCCTGTCTCTACTAAAATACAAAAAAAAAAAAAAAAAAAAAAAAAAATTTAGCTGTGTGTGGTGGTGTGCACCTGTAATCCCAGCTACTCAGAAGGCTGAGGCAGGAGAATCGCTAGAACCCGGGAGGCGGAGGTTGCAGTGAGCCGAGATCGCACCATTACGCTCCAGCTTGGGCAACAAGAGTGAAACTCCATCTCAAAAACAAAACAAAACAAAACAAAAA","GGCCAGGCAGGGTGGCTTACATCTGTAATCCCAGCACTTTGGGAGGTCAAGGCGAGTGGATCACCTGAGGTCATGAGTTCAAGACCAGCCTGGCCAACTTGGTGAAACCCTGTCTCTACTAAAAATACAAAAAAAAAAAAAAAAAAAAAAAAAAAAATTAACTGGGTGTGGTGGTGCACACCTGTAATCCCAGCTACTCAGGAGGCTGAGGCAGGAGAATCCCTTGAACACGGGAGGTGGAGGTTGCAGTGAGCCGAGATCATGCCATTGCACTCCAGCCTTGGTGAAAAGAGCAAAACTCTGTCTTAAACAAAACAAAACAAAACCAGAAAA"
"chr17","11904179","11904388","JH378115","24252957","24253162","48","12348778","CCTGTCTTTACAAAAAATGCAAAAACAAAACAAAACAAAACAAAACAAAAACCGGGCATGGTGGTGAGCACCTGTAATCCCAGCTACTTGGGAGTTTGAGGCAGGAGAATCACTTGAACCTGGGAAGCGGAGGTTGCAGTGAGCCGAGACCGCGCCATTGCACTCCAGCCTGGGCAACAAGAATGAAACTCTGTCTCAAAAAAAAAAAAA","TGGTGAAACCCTGTCTTTACTAAAAATACAAAAAAAAAAAAAATTAGCTGGGCATGGTGGCACATGCCTGTAGTCCCAGCTGCTCGGGAGGCTGAGGCAGGAGAATTGCTTGAACCCAGGAGGCGGAGGTTGCAGTGAGCCGAGATCGAGCCATTGCACTCCAGCCTGGGCAACAAGAGCAAAACTCCGTCTCAAAACAAAATAAA"
"chr17","15884346","15884946","JH378118","18053084","18053501","249","2168738","GCCAGGCAGGTGGCTCAGGACTGTAATCCCAGCCTTTTGGGAGGCTGAGGCGAGTGGATCACCTGAGGTCAGGAGTTCGACACCAGCCTGGTCAACATGGTGAAACCCCGTCTCTACTAAAAAATACAAAAAATTGGCCAGGCGCAGTGTCTCACGCCTGTAATCCCAGCACTTTAGGAGGCTGAGGCAGGTGGATCACTTGGTCAGGAGATCGAGACCATCCTGGCCAACATGGTGAAACCCTGTCTCTATCAAAAATACAAAAATTAGCTGGGCGTGGTGGCATATGCCTATAATCCCAGCTACTTGGGACGCTGAGGCAGGAGAATCACTTGAACCAGGGAGTCAGAAGTTGCAGTGAGCCGAGATTGCGCCACTGCACCCCAGCCTGGTGACAGAGTGAGACTGTCTTAAAAAACAAAAAACAAAAAATTAGCCAGGTATGGTACCAGGTGCCTGTAACCCCAGCTACTTGGGAGGCTGAGGCAGGAGTATCGCTTGAACCCTGGAGGTGGAGGATGCAGTGAGCTGAGAGCACGCCATTGTACTCCAGCCTGGGCAACAAGAGTGAAACTCCATCTAAAATAAATAAAAATAAAAA","GGCTGGGCGCAGTGGCTCACACCTGTAATCCCAGCACTTAGGGAAGCTGAGGCGAGTAGATCACCTGAGGTCAGGAGTTAGAGACCAGCCTGGCCATCATGGTGAAACCCCGTCTCTACTAAAGATACCAAAAATTAGCTGAGTGTGGTGCTGGGTGCCTGTAATCCCAGAAACTCAGGGTGCCTGTAATCCCAGCAACTCAGGGTGCCTTTAATCCCAGCAACTGAGGGTACCAGTAATCCCAGCAACTCAGGGTGTCTTTAATCCTAGCAACTGAGGGCACCTGTAATCCCAGCAACTCAGGAAGCTGAGACAGGAGAAGTACTTGAACCCAGAAGGCAGAGGTTGCAGTGAGCCGATATTGCACCATTGCACTCCAGTCTGGGCAACAAGAGTGAAACTCTGTCTCAAAAAAAAA"
"chr17","16331846","16332458","JH378118","18053084","18053501","252","1721238","GGCCATGTGTGGTGGTTCACACCTGTAATCTCAGAACTTTGGGAGGCCGAGGTGGGTGGATCACCTGAGGTCAGGAGTTCGAGACCAGCCTGGCCAACATGGTGAAACCTCATCTCTACTAAAAATACAAAAAATTAAGGCCATACCCAGAGACTCATGCCTGTAATCCCAGCACTTTGGGAGGCTGAGGCGGATGGATCACTTGAGGTCAGGAGTTCAAAACCAGCCTGGCCAACATGGTGAAACCCCATCTCTACTAAAAATATAAAAATTAGCCGGGTGTGATGGCAGGCACCTGTAATCCCAGCTACTTGGGAGGCTGAGGCAGGAGAATTGCTTGAACCCAGGAAGCAGAGGTTGTGGTGAGCCGAGGTCGCGCCATTGCACTCCAGCCTGGGCAACAGAATGAGACTGTCTCAAAAAAAAAAAAAAAAAAAAATCAGCCAGGAGTGGTGGCGGGGGCACCTGTAATCCCAGCTACTCGGGAGGCTGAGGCAGGAGAATCGCTTGAACTCAGGAGGCAGAGGTTGCAGTGAGCTGATATCTCGCCATTGCACTCCAGCCTGGGCAACAAGAGTGAAACTGTCTCAAAAAAAAAAAAAAAAAAAAAGAA","GGCTGGGCGCAGTGGCTCACACCTGTAATCCCAGCACTTAGGGAAGCTGAGGCGAGTAGATCACCTGAGGTCAGGAGTTAGAGACCAGCCTGGCCATCATGGTGAAACCCCGTCTCTACTAAAGATACCAAAAATTAGCTGAGTGTGGTGCTGGGTGCCTGTAATCCCAGAAACTCAGGGTGCCTGTAATCCCAGCAACTCAGGGTGCCTTTAATCCCAGCAACTGAGGGTACCAGTAATCCCAGCAACTCAGGGTGTCTTTAATCCTAGCAACTGAGGGCACCTGTAATCCCAGCAACTCAGGAAGCTGAGACAGGAGAAGTACTTGAACCCAGAAGGCAGAGGTTGCAGTGAGCCGATATTGCACCATTGCACTCCAGTCTGGGCAACAAGAGTGAAACTCTGTCTCAAAAAAAAA"
"chr17","16464101","16464461","JH378293","1845184","1845523","61","14618917","GGCCGGGCGCCGTGGCTCACGCCTATAATCCCAGCACTTTGGGAGGCCGAGGCGGGTGGATCACCTGAGGTCAGGAGTTCGAGACCAGCCTGACCAACATGGTGAAACCCCCGTCTCTGCTAAAAAAAAAAAAATATATATATATATATATATAATATATAATATATATATATATATATATATAAAATAGCTGGGCATGGTGGCAGGCACCTGTAATCCCAGCTACTCAGGAGGCTGAGGCAGGAGAATCGCTTGAACCTGGGAGGTGGAGGTTGCAGTGGGCTAAGATCACACCATCGCACTCCAGCCTGGGCGACAGGAATGAAACGCTGTCTCAAAAAAAAAAAAAAAAAAAAAAAAA","GGCCGGGTGCGGTGGCTCACGCCTGTAATCCCAGCACTTTGGGAGGCCAAGGCGGGTGGATCACCTGAGGTCAGAAGTTCGAGACCAGCCTGGCCAACATGGTGAAACCCCGTCTCTGCTAAAAAGAAAAAAATAAGAAAAAAACAAAATAAGAAAATAATTTTAAAAAATACAAAATTAGCTGGGCGTGGTGGCAGGCACCTGTAATTCCAGCTATTCAGGAGGCTGAGGCAGGGGAATCACTTGAACCCAGGAGGCAGAGGTTGCAGTGAGCCAAGATGACGCCATTGCACACCAGCCTGGGCAACAAGAGTGAAACTCCGTCTCAAAAAAAAAACAA"
"chr17","16469420","16470033","JH378118","18053084","18053501","254","1583664","GCCAGGGGTGGTGGCTCATGCCTGTAATCCCAGCACTTTGGGAGGCTGAGGCGGGCAGATTGCCTGAGGTCAGGAATTCAAGACCAGCCTGGCCAACATAGTGAAACCCTGTCTCTACTAAAAATGCAAAGAATTAGCTGGGTGTTGGCCGGGCACGGTGGCTGACACCTGTAATCCCAGCACTTTGGGAGGCCTAGGCAGGCGGATCACCTGAGGTTGGGAGTTCGAGACCAGCCTGACCAACATGGAGAAACCCCGTCTCTACTGAAAATAAAAAACTAGCCAGGCATGGTGGCCCATGCCTGTAATCCCAGCTAATTGGGAGGCTGAGGCAGGAGAATCGCTTGAACCCAGGAGGCAGAGGTTGCGGTGAACCAAGATCGCATCAATGCACTCCAGCCTAGGCGACAAGAGCAAAACTCCGTCTCAAAAAAAAGAATTAGCTGGGTGTGGTGGGTGGGAACCTGTAATCCCAGTTACTAGGGAGGCTGAGGCAGGAGAATTGCTTGAACCCAGGAGGCGGAGGTTGTGGTGAGCCGAGATCGCGCCATTGCACTCCAGCCTGGACAACAAGAGCGAATCTCCGTCTCAAAAAAAAAAAAAAAAAAAAAAAA","GGCTGGGCGCAGTGGCTCACACCTGTAATCCCAGCACTTAGGGAAGCTGAGGCGAGTAGATCACCTGAGGTCAGGAGTTAGAGACCAGCCTGGCCATCATGGTGAAACCCCGTCTCTACTAAAGATACCAAAAATTAGCTGAGTGTGGTGCTGGGTGCCTGTAATCCCAGAAACTCAGGGTGCCTGTAATCCCAGCAACTCAGGGTGCCTTTAATCCCAGCAACTGAGGGTACCAGTAATCCCAGCAACTCAGGGTGTCTTTAATCCTAGCAACTGAGGGCACCTGTAATCCCAGCAACTCAGGAAGCTGAGACAGGAGAAGTACTTGAACCCAGAAGGCAGAGGTTGCAGTGAGCCGATATTGCACCATTGCACTCCAGTCTGGGCAACAAGAGTGAAACTCTGTCTCAAAAAAAAA"
"chr17","17534259","17534875","JH378118","18053084","18053501","268","518825","GGCTGGGGCGGTGGCTCACCTGTAATCCCAGCACTTTGGGAGGCAGAGGTGGGCGGATCGCCTGAGGTCAGAAGTTGGAGACCAGCCTGGCAACATGGTGAAACCCTGTCTCTACTAAAAAAAAAAAAAAAAAAAAAAAATGGCCGGGCATGGTGGCTCAAGCCTGTAATCCTAGCACTTTGGAAGGCTGAGGCGGGTGGATCACAAGGTCAGGAAATCGAGACCATCCTGGCTAACATGGTGAAACTCCGTCTCTACTAAAAATACAAAAAAAATTAGCCGGGCGTGGTGGTGGGTGCCTGTAGTCCCAGCTACTCGGGAGGCTGAGGCAGGCAAATGGAGTGAACCCGGGAGGCAAACTTGCAGTGAGCCAAGATGGCGCCATTGCACTCCAGCCTGGGCAACAAGAGCAAGACTCCTTCTCAAAAAAAAAAAAAATATATATATATATATATAGTCGGGCATGGTGGCAGGCACCTGTAATCCCAGCTACTCAGAGGCTGAGGCAGGAGAATCGCTTGAACCCTGGAGGTGGAGGTTGCAGTGAGCCAAGGTCATGCCATTGCACTCCAGCCTGGGCAACAAGAGCAAGACTCCGTCTCAAAAAAAAAAAAAAA","GGCTGGGCGCAGTGGCTCACACCTGTAATCCCAGCACTTAGGGAAGCTGAGGCGAGTAGATCACCTGAGGTCAGGAGTTAGAGACCAGCCTGGCCATCATGGTGAAACCCCGTCTCTACTAAAGATACCAAAAATTAGCTGAGTGTGGTGCTGGGTGCCTGTAATCCCAGAAACTCAGGGTGCCTGTAATCCCAGCAACTCAGGGTGCCTTTAATCCCAGCAACTGAGGGTACCAGTAATCCCAGCAACTCAGGGTGTCTTTAATCCTAGCAACTGAGGGCACCTGTAATCCCAGCAACTCAGGAAGCTGAGACAGGAGAAGTACTTGAACCCAGAAGGCAGAGGTTGCAGTGAGCCGATATTGCACCATTGCACTCCAGTCTGGGCAACAAGAGTGAAACTCTGTCTCAAAAAAAAA"
"chr17","17916069","17916669","JH378118","18053084","18053501","243","137015","GCCGGGTACAGTGGCTCACACCTGTAATCCTAGCACTTTGGGAGGCCGAGGCGGGTGGATCACCTGAGGTCAGGAGTTCGAGACCAGCCTGGCCAACATGATGAAACCCTACCTCAGCCAGGTACGGTGGTTCACGCCTGTAATCCTAGCACTTTGGGAGGCTGAGGCAGGTGGATTGCCTGAACTCAGGAGTTTGAGACCAGCCTGGGCAGCATGGTGAAACCCCATCTGTACTAAAATACAAAAACTTTGCTGGGCGTGGCGGCATGCACATGTAGTCCCAGTTACTTGGGAGGCTGAGGCAGGATAATTGTTTGAACCTGGGAGGCGGAGGTTGTACAGTGAGCCAAGATCGCGCCACTACACTCTAGCGTAGGTGACAGAGCGAGATTCCGCCTCCAAAAAAAAAAGAAACCCTGTCTCTACTAAAAATACAAACAATTAGCTGGGCGTGGTGGTGGGCGCCTGTAATCCCAGCTACTTAGGAGGCTGAAGCAGGAGAATCGCTTGAGCCCAGGAAGTGGAGGTTGCAGTGAGCTGAGATTGCTCCATTGCACTCTAGCCTGGGCAACAAGAGTGAAACTCTGTCTCAAAAAAAGAA","GGCTGGGCGCAGTGGCTCACACCTGTAATCCCAGCACTTAGGGAAGCTGAGGCGAGTAGATCACCTGAGGTCAGGAGTTAGAGACCAGCCTGGCCATCATGGTGAAACCCCGTCTCTACTAAAGATACCAAAAATTAGCTGAGTGTGGTGCTGGGTGCCTGTAATCCCAGAAACTCAGGGTGCCTGTAATCCCAGCAACTCAGGGTGCCTTTAATCCCAGCAACTGAGGGTACCAGTAATCCCAGCAACTCAGGGTGTCTTTAATCCTAGCAACTGAGGGCACCTGTAATCCCAGCAACTCAGGAAGCTGAGACAGGAGAAGTACTTGAACCCAGAAGGCAGAGGTTGCAGTGAGCCGATATTGCACCATTGCACTCCAGTCTGGGCAACAAGAGTGAAACTCTGTCTCAAAAAAAAA"
"chr17","18237318","18237912","JH378118","18053084","18053501","239","184234","GGCCATGCGTGGTGGCTCACGCCTGTAATCCCAGTACTTTGGGAGGCTGAGGTGGGAGGATCACCTGAGGTCAGGAGTTCGAGACCAGCCTGGCCAACATGATGAAACCCTGTCTCTACTAAAAATGCAAAAAATTGGCCGGGCACGGTGGCTCACGCCTGTAATCCCAGCACTTTGGGAGGCCAAGGCGGGTGGATCACAAGGTCAGGAGCTTGAGACCAGCCTGGCCAATATGGTGAAACCCCATCTCTACTAAAAATACAAAAATTAGCCAGGCGTGGTGGTACACACCTGTAGTCCCAGCTACTCGGGAGGCTGAGGCAGGAGAATTGCTTGAACTCAGGAGGCAGAGGTTGCAGTGAGCTGAGATGGTGCCACTGCACTGCAGCCTGGGCAACAGAGTGAGACTTCATCTCAAAAAAAAAAAAAAAATTAACCGGGTGTGGTGGCACGTGCCTATGGTCCCAGCCACTGGGGAGGCTGAGGCAGGAGAATCGCTTGAACACAGGAGGCAGAAGTTGCAGTGAGCTGAGATTGCACCACTGCACTCCAGCCTGGGTGACAAGAGTGGAACTCCATCTCAAAAAAAAAAGAA","GGCTGGGCGCAGTGGCTCACACCTGTAATCCCAGCACTTAGGGAAGCTGAGGCGAGTAGATCACCTGAGGTCAGGAGTTAGAGACCAGCCTGGCCATCATGGTGAAACCCCGTCTCTACTAAAGATACCAAAAATTAGCTGAGTGTGGTGCTGGGTGCCTGTAATCCCAGAAACTCAGGGTGCCTGTAATCCCAGCAACTCAGGGTGCCTTTAATCCCAGCAACTGAGGGTACCAGTAATCCCAGCAACTCAGGGTGTCTTTAATCCTAGCAACTGAGGGCACCTGTAATCCCAGCAACTCAGGAAGCTGAGACAGGAGAAGTACTTGAACCCAGAAGGCAGAGGTTGCAGTGAGCCGATATTGCACCATTGCACTCCAGTCTGGGCAACAAGAGTGAAACTCTGTCTCAAAAAAAAA"
"chr17","18951167","18952093","JH378118","18053084","18053501","537","898083","GGCCAGGGGCAGTGGCTCATGCCTGTAATCCCAGCATTTTGGGATGCCAAGGCTGGTGGATCAACTGAGGTCAGGAGTTTCAGACCACCCTGGCCAACATGGCGAAATCCCATCTCTACTAAAAATACAAAAATTAGGCCAGGCACAGTGGCTCATGCCTGTAATCCCAGCACTTTGAGAGGCCAAGGCGGGCGATCACGAGGTCAGGAGATTGAGACCATCCTGGCTAACACGGTGAAATCCTGTCTCTACTAAAAAAAAAAAATACAAAAAATTAGCCGGGACGTGGTGGCTGGCACCTGTAGTCCCAGCTACTCGGGAGGCTAAGGCAGGAGAATGGCATGAACCCGGGAGATGGAGCTTGCAGTGACCCGAGATCGCGTCACTGCACTCCAGCCTGAACAACAGAGCAAGACTATATCTCAAAAAAAAAAAAAAAAAAAAGGCCGGGTGCAGTGGCTCACGTCTGTAATCCCAGCACTTTGGGAGGCCGAGGTGGGTGGATCACGAGGTCAGGAGATCGAGACCATCCTGGCTAACATGATGAAACCCCATCTCTACTAAAAAATACAAAAAATTAGCCGGGTGTGGTGGCAGGCACCTGTAGTCCCAGCTACTCGGGAGGCTGAGGCAGGAGAATGGCATGAACCTGGGTAGTGGAACTTGCAGTGAGCCGAGATCACGCCACTGCACTCCAGCCTGGGCGACAGAGCGAGACTCTGTCTCAAAAAAAAAAAAAAAAAAAAAATTAGCCGGGCATGGTGGTGGGTGCCTGCAATCCCAGCTAGTCAGGAGGCTGAGGCTGGAGAATCCCTTGAACCCAGGAGGTAGAGGTTGCAGTGAGCCAAGATCACGCCATTGCATTCCAGCCTGGGCAACAAGAGTGAAATTCTGTCTCAAAAAAATAAACAAACAAGTAAAATAAAA","GGCTGGGCGCAGTGGCTCACACCTGTAATCCCAGCACTTAGGGAAGCTGAGGCGAGTAGATCACCTGAGGTCAGGAGTTAGAGACCAGCCTGGCCATCATGGTGAAACCCCGTCTCTACTAAAGATACCAAAAATTAGCTGAGTGTGGTGCTGGGTGCCTGTAATCCCAGAAACTCAGGGTGCCTGTAATCCCAGCAACTCAGGGTGCCTTTAATCCCAGCAACTGAGGGTACCAGTAATCCCAGCAACTCAGGGTGTCTTTAATCCTAGCAACTGAGGGCACCTGTAATCCCAGCAACTCAGGAAGCTGAGACAGGAGAAGTACTTGAACCCAGAAGGCAGAGGTTGCAGTGAGCCGATATTGCACCATTGCACTCCAGTCTGGGCAACAAGAGTGAAACTCTGTCTCAAAAAAAAA"
"chr17","20996420","20997041","JH378118","18053084","18053501","266","2943336","GGCTAGGCGCGGTGGTTCACACCTGTAATCCCAGCACTTTGGGAGGCCAAGGTGGGTGGATCACCTGTGGTCAGGAGTTCGAGACCAGCCTGGCCAACATTGTGAAACCCCGTCTCTACTAAAAATGCAAAAAATTAGCTGGGCGACCAGTCATGGTAGCTCACGCCTGTAATCCTAGCACTTTGGGAGGCCAAGGCGGGTGGATTGCCTGAGCTCAGGAGTTAGAGGCCAGCCTGGGCAACATGGTAAAACCCTGTCTCTACTAAAATACAAAAAAAAAAAAAAAAATTAGCTGGGTGTGACAGCGTGCATCTGTAATCCCGGTTACTTGGGAGGTTGAGGCAGGAGAATTCCTTGAACCTAGGAGGCGGAGGTTACAGTTAGCCGAGATCACGCCATTGCACTCCAGCCTGGGCAACAGAGCGAGACTCCATCTCAAAAAAAAAAAAAAAAATTCAGCTGGGCGTGGTGGCGGGCACCTGTGATCCTAGCTACTCAGGAGGCTGAGGCAGGAGAATCATTTGAACTCCGGAGGCGGAGGTTGCAGTGACCCTAGATCGCACCATTGTGTTCCAGCCTGAGCAACAAGAGCGAGACGCCATCTGAAAAAAAAAAAAAGAAA","GGCTGGGCGCAGTGGCTCACACCTGTAATCCCAGCACTTAGGGAAGCTGAGGCGAGTAGATCACCTGAGGTCAGGAGTTAGAGACCAGCCTGGCCATCATGGTGAAACCCCGTCTCTACTAAAGATACCAAAAATTAGCTGAGTGTGGTGCTGGGTGCCTGTAATCCCAGAAACTCAGGGTGCCTGTAATCCCAGCAACTCAGGGTGCCTTTAATCCCAGCAACTGAGGGTACCAGTAATCCCAGCAACTCAGGGTGTCTTTAATCCTAGCAACTGAGGGCACCTGTAATCCCAGCAACTCAGGAAGCTGAGACAGGAGAAGTACTTGAACCCAGAAGGCAGAGGTTGCAGTGAGCCGATATTGCACCATTGCACTCCAGTCTGGGCAACAAGAGTGAAACTCTGTCTCAAAAAAAAA"
"chr17","21298865","21299429","JH378206","6546474","6546861","222","14752391","GGCCGAGGCAGGTGGATCACCTGAGGTCAGGAGTTCAAGACTAGTCTGGCCAACATGGTGAAACCCTGTCTCTACTAAAAATACAAAAAATTGGCCGGGCGCGGTGGCTCATGCCTGTAATCCCAGCACTTTGGGAGGCTGAGGCGGGTGGATCACGAGGTCGGGAGATCGAGACCATCCTGGCTAACACAGTTAAACCCTTTCTCTACTAAAAAATACAAAAAATTAGCCGGGCGTAGTGGGGGGCGCCTGTAGTCCCAGCTACTCAGGAGGCTGAGGCAGGAGACTGGCGTGAACCCGGGAGGCAGAGCTTGCAGTGAGCTGAGATCACGTCACTGCATGCCAGCCTGGGCGACAGAGCGAGACTCTGTCTCAAAAAAAAAAAATTAGCCAGGCATGGTGGTGTACACCTGTAATCCTAGCTACTCGGGAAGCTGAGCAGGAGAACAGCTTGAACCCAGGAGGCAGAGGTTGCAGTGAGCTGAGATCACGCCATTGCACTCCAGCCTGGGCAACAAGAGTGAAACTCCGTCTCAAAAAAAAAAAAAGAAAAGAAAAAAGAAAA","GGCCACACATGGTGGCTAACGCCTGTAATCCCAGCACTTTGGGAGGCCAAGTCGGGTGGATCATGAGGTCAGGAGACCAAGACCATCCTGGCCAAATGGTGAAACCCCGTCTCTACTAAAAATACAAAAATTAGCTGGGCATGGTGGCGTGTGCCTGTAATCCCAGCTACTCAGGAGGCTGAGGCAGGACAATTGCCTGAACCCAGGAGAATTAGCTGGGCATGGTGGCGTGTGCCTGTAATCCCAGCTACTCAGGAGGCTGAGGCAGGACAATTGCCTGAACCCAGGAGGCGAAGGTTGCGGTGAGCCGAGATTGTGCCATTGCACTCCAGCCTGGGTAACAAGAGCGACACTCTGTCTCAAAAAAAAAAAAAAAAAAAAAAAAAAA"
"chr17","21663027","21663921","JH378118","18053084","18053501","517","3609943","TTGGGAGGCCAAGGTGGGCCTCCCAGACACGTGAGGTCAGGAGTTTGAGACCAGCCTGGACAATATGGCGAAACCCCATCTCTACTAAAAAAACACAAAAATTGGTTGGGCCGGGCACGGTGGCTCACGCCTGTAATCCCAGCACTTTGGGAGGCCGAAGTGGGCAGATCACGAGGTCAGGAGATCGAGATCATCTTGGCTAACATGGTGAAACTCCGTCTTTACTTAAAATACAAAAAATTAGCTGGGCATGATGGCAGGCAGTTGGAGTCCCAGCTACTTGGGAGGCTGAGGCAGGAGAATCGCTTGAACCCGGGAGGCAGAGGTTGCAGTGAGCTGAGATCGTGCCATTGCACTCCAGCCTGGGTGACAGAATGAGACTCCGTCTGAAAAAAAAACAAAAAACAAAAAACAAAAATTGGCCAGGTGCGGTGGCTCACGCCTGTAATCCCAGAACTTTGGGAGGCCGAGGCAGGTGGATCATGAGGTCAGGAGTTCAAGACCAGCCTGGCCAAGATGGTGAAACCCCATCTCTACTAAAAATACAAAAATTAGGCGGGCACGGTGGCAGGTGCCTGTAATCTCAGCTACTCAGGAGGCTGAGGCAGGAGAATTGCCTGAAGCCGGGTGGCAGAGGTTGCAGAGAGCTAAGATCACGCCACTGCACTCCAGCCTGGGTGATAGAGTAAGACTCTATCTCAAAAAAAGAAAAAAAAAAATAGCCGGGCATTGTGCTGGGCGCCTGTAATCCCAGCTACTTGGGAGGCTGAGACAAGAGAATCACTTGAACCTGGGAGGCGGAGGTTGCAGTGAGCCGAGATCGTGCCATTGCACTCCAGCCTGGGTGAGAAGAGCAAAACTCTGTCTCAAAAAAACAAAAAAAGAAGAAAACAAA","GGCTGGGCGCAGTGGCTCACACCTGTAATCCCAGCACTTAGGGAAGCTGAGGCGAGTAGATCACCTGAGGTCAGGAGTTAGAGACCAGCCTGGCCATCATGGTGAAACCCCGTCTCTACTAAAGATACCAAAAATTAGCTGAGTGTGGTGCTGGGTGCCTGTAATCCCAGAAACTCAGGGTGCCTGTAATCCCAGCAACTCAGGGTGCCTTTAATCCCAGCAACTGAGGGTACCAGTAATCCCAGCAACTCAGGGTGTCTTTAATCCTAGCAACTGAGGGCACCTGTAATCCCAGCAACTCAGGAAGCTGAGACAGGAGAAGTACTTGAACCCAGAAGGCAGAGGTTGCAGTGAGCCGATATTGCACCATTGCACTCCAGTCTGGGCAACAAGAGTGAAACTCTGTCTCAAAAAAAAA"
"chr17","21688652","21689276","JH378118","18053084","18053501","258","3635568","GGCCGGGTGCCATGGCTCACGCCTATAATCCCAGCACTTTGGGAGGCCAAGGTGGGCGGATCACCTGAGGTCAGGAGTTTGAGACCAGCCTGGCCAACATAGTGAAACCCCGTCTCTACTAAAAATACGAAAAGTTAGCTGGGGGTGCAGTGGCTCACACCTGTAATTCCAGCACTTTGGGAGGCCGAGGCAGGTGAATCACGAGGGGAGGAGTTTGAGACCAGCCTAACCAATATGTTGAAACCCCGTTTCTACTAAAAATACAAAAATTAGCTGGGCGTGGTGGCACGTGCCTATAATCCCAGCTACTCAGGAGGCTGAGGCAGGAGAATCGCCTGAACCTGGGAGGCGGAGGTGGCAGTGAGCCAAGATCACACCACTGCACTTTAGCCTGGGTGACAGAGGGAGACTCTGTCTCAAAAAACAAAACAAAACAAAACAAAAAATTAGGCAGGCTTGGTGGCACATGCCTGTAATCCCAGCTACTCAGGAGGCTGAGGCAGGAGAATTGCTTGAACCCAGGAGGCAGAAGTTGCAGTGAGCTGAGATCGCGCCATTGCACTCCAGCCTGGGTAACAAGAGTGAAACTCCATCTCAAAAAAAAAAAAAAAAAAAAAAAAAAAAA","GGCTGGGCGCAGTGGCTCACACCTGTAATCCCAGCACTTAGGGAAGCTGAGGCGAGTAGATCACCTGAGGTCAGGAGTTAGAGACCAGCCTGGCCATCATGGTGAAACCCCGTCTCTACTAAAGATACCAAAAATTAGCTGAGTGTGGTGCTGGGTGCCTGTAATCCCAGAAACTCAGGGTGCCTGTAATCCCAGCAACTCAGGGTGCCTTTAATCCCAGCAACTGAGGGTACCAGTAATCCCAGCAACTCAGGGTGTCTTTAATCCTAGCAACTGAGGGCACCTGTAATCCCAGCAACTCAGGAAGCTGAGACAGGAGAAGTACTTGAACCCAGAAGGCAGAGGTTGCAGTGAGCCGATATTGCACCATTGCACTCCAGTCTGGGCAACAAGAGTGAAACTCTGTCTCAAAAAAAAA"
"chr17","22129020","22129352","JH378128","1602813","1603145","53","20526207","GCCAGGCACGGTGGCTCACACCTGAATTCCAGTACTTTGGGAGGCCGAGGCGGGCGGATCTCTTGAGGTCAGGAGTTTGAGACCAGCCTGGCCAACATGGTGAAACCCCATCTCTACTAAAAATACAAAAATTAGCCGGGCGTGGTGGCAGGTGCCTGTAATCCCAGCTACTTGGGAGGCTGAGGCAGGAGAACCTCTTGAACCCAGGAGGTGGAGGCTGCAGTGAGCTGAGATTGTGCCACTTCACTCCAGCCTGGAAGACAAGAGCAAGACTTCATCTCAAAAAAAAATAAAAAAAAAATAAATAAATAAATAAATAAAAATTTAAAAAAA","GGCCAGGTGCAGTGGCTCACGCCTGTAATACCAGCATTTTGGGAGGCCGAGGCAGGTGGATCACGAGGTTAGGAGTTTGAGACCAGCATGGCCAACATGGAGAAACCCCGTCTCTACTAAAAATACAAAAATTAACCAGGCATGGTGGCAGGTGCCTGTAATTCCATCTACTCGGGAGGCTGAGGCAGGAGAATCCCTTGAACCTGGGAGGCGGAGGTTGCAGTGAGCCGAGATTGTGCCATTGCACTCAGTCTGGGTGACAAAAACAAGACTCCATCTCAAAAAAAAAAAAAAGAAAAGAAAAAGAAAAAAAGAAAGAAAGAAAGAAAGAAA"
"chr17","22130129","22130738","JH378118","18053084","18053501","262","4077045","GGCTGGGCACAGTGGCTCACGCCTGTAATCTCAGCACTTCGGGAAGCCGAGGCGGGCAGATCAGCTGAGGTCAGGAGTTCAAGACCAGCCTGGCCATGGCAAAACCCTGTCTCTACTAAAAAATGCAAAAAATAGGGGCCAGGCACGGTGGCTCACGCCTGTAATCCCAGCATTTTGGGAGGCCAAGGCAGGCGGATCACAAGGTCAGGAGGTTGAGACCATCCTGGCCAACATGGTGAAACCCCATCTCTACTAAAAATACAAAAATTAGCTGGGTGTGGTGGCCTGTGCCTGTAATCCCAGCTACTTGGGAGGCTGAGGCAGGGGAATCACTTGAATCCAGGAGACAGAGGTTGTAGTGAGCTGAAATGGAGCCACTGCACTCCAGCCTGGCGGCAGAGCGAGACTCTGTCTCAAAAAAAAAAAAAATACAAAAAATAGCTAGGTGTGATGGTGGGCACCTGTAATCCCAGCTACTTGGGTAGCCGAAGCAGGAGAATCGCTAGAACCTGGGAGGTGGAGGTTTAGTAAGCTGAGATCACACCATTGCACTCCAGCCTGGGTATCAACAGCGAAACTCCATCTCAAAAAAAAAAAAAAAAAAAGAAAA","GGCTGGGCGCAGTGGCTCACACCTGTAATCCCAGCACTTAGGGAAGCTGAGGCGAGTAGATCACCTGAGGTCAGGAGTTAGAGACCAGCCTGGCCATCATGGTGAAACCCCGTCTCTACTAAAGATACCAAAAATTAGCTGAGTGTGGTGCTGGGTGCCTGTAATCCCAGAAACTCAGGGTGCCTGTAATCCCAGCAACTCAGGGTGCCTTTAATCCCAGCAACTGAGGGTACCAGTAATCCCAGCAACTCAGGGTGTCTTTAATCCTAGCAACTGAGGGCACCTGTAATCCCAGCAACTCAGGAAGCTGAGACAGGAGAAGTACTTGAACCCAGAAGGCAGAGGTTGCAGTGAGCCGATATTGCACCATTGCACTCCAGTCTGGGCAACAAGAGTGAAACTCTGTCTCAAAAAAAAA"
"chr17","23633062","23633662","JH378118","18053084","18053501","247","5579978","GGCCAGGCGTGGTGGCTTACGCCTGTAATCCCAGCATTTTGGGAAGCTGAGGCAGGTGGATCACCTGAGGTCAAGAGTTCAAGACCAGCCTGGCCAACATGGTGAAACCCCGTCTCTACTGCAAATACAAAAAATTAGTAGCCGGGCATGGTGGCTCACGCCTGTAATCCCAACACTTTGGTAGGCCAAGGCGGGTGGATCACCTGAGGTCGGGAGTTCGAGACCAGCCTGACCAACATGGAGAAACCCCGTCTCTACTAAAAGTACAAAATTAGCCAGGGATGGTGGCATGTGCCTGTAATCCCAGCTATTTGGGAAGCTAAGGCACAAGAATCGCTTTGAACCTGGGAGACAGAGGTTGCAGTGAGCTGAGATCGCACCATTGCACTCCCGCCTGGGCAACAAGAGCGAAACTCCATCTAAAAAAAAAAAAAAAAAAAAAAAAGCCAGGCATGGTGACAGGCACCTTGTAATCCCAGCTACTCGGAAGGCTGAGGCAGGAGAATCGCTTGAACACTGCAGAGGTTGCAGTGAGCTGAGATCACGCCATTGCACTGCAGCCTAGGCAACAAGAGTGAGACTCTATCTCAAAAAAAAGAAA","GGCTGGGCGCAGTGGCTCACACCTGTAATCCCAGCACTTAGGGAAGCTGAGGCGAGTAGATCACCTGAGGTCAGGAGTTAGAGACCAGCCTGGCCATCATGGTGAAACCCCGTCTCTACTAAAGATACCAAAAATTAGCTGAGTGTGGTGCTGGGTGCCTGTAATCCCAGAAACTCAGGGTGCCTGTAATCCCAGCAACTCAGGGTGCCTTTAATCCCAGCAACTGAGGGTACCAGTAATCCCAGCAACTCAGGGTGTCTTTAATCCTAGCAACTGAGGGCACCTGTAATCCCAGCAACTCAGGAAGCTGAGACAGGAGAAGTACTTGAACCCAGAAGGCAGAGGTTGCAGTGAGCCGATATTGCACCATTGCACTCCAGTCTGGGCAACAAGAGTGAAACTCTGTCTCAAAAAAAAA"
"chr17","34071612","34072215","JH378118","18053084","18053501","250","16018528","GGCCAGGTGTGGTGCCTTACATCTGTAATTCCAGCACTTTGGGAGGCTGAGGTGGGTGGATCACCTGAGGTCAGGAGTTCAGGACCAACCTGGCCAACATAGTGAAACCCCGTCTCACTAAAAATACAAAAATTAAAAAGAAAGAAAGAAAAAAGCCAGGTGCGGTGGCTCACACCTGTAACCCCAGCACTTTGGGAGGCCAAGATGGGCGGATCACCTGAGGTCGGGAGTTTGAGACCAGCCTGACCAACATGGAGAAACCCCGTCTCTACTAAAAATACAAAATTAACCAGGCGTGGTGGTGCATGCCTGTAATCCCAGCTACTTGGGAGGATGAGGCAGGAGAATCGCTTGAACCCTGGAGGCGGAGGTTGTGGTGAGCTGAGATCATGCCATTGCACTCCAGCCTAGGCAACAAGAGCGAGACTCCATCTCAAAAAAAAAAAAAAAATTGGGCATGGTGGTGCATGCCTGTAATCCCAGCTACTCAGGAGTCTAAGGCAGGAGAATCACTTGAACCCAGGAGGCAGAGGTTGCAGTGAGCTGAGATCACGCCATTGCACTCCAGCCTGAGCGACAAGAGTGAAACTACGTCTCAAAAAAA","GGCTGGGCGCAGTGGCTCACACCTGTAATCCCAGCACTTAGGGAAGCTGAGGCGAGTAGATCACCTGAGGTCAGGAGTTAGAGACCAGCCTGGCCATCATGGTGAAACCCCGTCTCTACTAAAGATACCAAAAATTAGCTGAGTGTGGTGCTGGGTGCCTGTAATCCCAGAAACTCAGGGTGCCTGTAATCCCAGCAACTCAGGGTGCCTTTAATCCCAGCAACTGAGGGTACCAGTAATCCCAGCAACTCAGGGTGTCTTTAATCCTAGCAACTGAGGGCACCTGTAATCCCAGCAACTCAGGAAGCTGAGACAGGAGAAGTACTTGAACCCAGAAGGCAGAGGTTGCAGTGAGCCGATATTGCACCATTGCACTCCAGTCTGGGCAACAAGAGTGAAACTCTGTCTCAAAAAAAAA"
"chr17","34329459","34330029","JH378119","32351107","32351490","237","1978352","GGCCAGGTGCCGTGGCTCACACATGTAGTCCCAGCACGTTGGGAGGCTGAGGTTAATGGATCACCTGAAGTCACAAGTTCGAGACCAGCCTGACCAACATGGTGAAACCCTGTCTCTACTAAAATATAAAAAGTAGTCGGCCGGGCGCAGTTGCTCATGCCTGTGATCGCCTGAGGTCAGGATTTCAAGCCCAGCCTGGCCAAAATGGTGAAACCCCATCTCTACTAAAAATATAAAAATTAGCCAGGCATGGTGGCAGGTGCCTGTAATCCCAGCTACTCAGGAGGTTGAGGCAGGAGAATCACTTGGACCCAGGGGGCAGAGGTTGCAGTGAGCCAAGATCACAGCATCGCACTCCAGCTTAGGCAACAAGAGAGAAACTCCATCTCAAAAAAAACCCAAAAAAAACAAAAAAACAAAAAAACCCAGGCATGGTGGCAGGCGTCTGTAATCTCAGCTACTCGGGAGGCTGAGGCAAGAGAATCGCTTGAACCTGGGAGGCAGAGGTTGCAGTGAGCCAAGATCATGCCATTGCACTCCAGACTGAGCAATAAGAGCGAAACTCCATCTC","GGCCAGGTATGGTGGCTCACACCTGTAATCCCAGCACTTTGGGAGGCCAAGGCAGGCAGACCACCTGAGGTCAGGAGTTCGAGATCAGCCTAGCCAACATGGTGAAACCCCATCTCTAGTAAAAATAAAATTAGCCAGGCATGGTGGTGCATGCCTGTAACGCAGGTCAGGAGTTCGAGATCAGCTTAGCCAACATGGTGAAACCCCATCTCTAGTAAAAATAAAATTAGCCAGGCAGGTGGTGCCGCCTGTACTCGGGAGGCTGAGGCAGGAGAATCACTTGAACCCAAGAGGCAGAGGTTGCAGTCAGCCAAGATCATGCCATTGCACTCCAGCCTAAGCAAAAAGAGTAAAACTCAGTCTCAAAACAAAAAAACAAAAAAA"
"chr17","35196292","35196625","JH378228","5665092","5665424","47","29531200","GGCTGGGCATGGTGTCTTACGCCTGGAATCCCAGCACTTTGGGAGGCCAAGGCGGGTGGATCACCTGAGGTCAGGAGTTTGAGACCAGCCTGGCCAACATGTTGAAACTCTGTCTCTACTAAAAATACAAAAATTAGCCGGGCATGGTGGCGGATGCCTGTAATCCCAACTACGTGGGAGGCTGAGGCAGGAGAATCGCTTGAACCCAGGAGATGGAGGTTGTGGTGAGCCGAGATCATGCCATTGCACTCCAGCCTGGGCAACAAGAACAAAACTCTGTCTCAAAATAAATAAAAAAATAAATAAATAAATAAAAACAACAACAACAACAAAA","GGCCGGGCGCGGTGGCTCAAGCCTGTAATCCCAGCACTTTGGGAGGCTGAGGCGGGTGGATCACGAGGTCAAGAGATCGAGACCATCCTGGTCAACATGGTGAAACCCTGTCTCTACTAAAAATACTAAAAATTAGCTGGGCATGGTGGCGTGTGCCTGTAATCCCAGCTACTCAGGAGGCTGAGGCAGGAGAATTGCCTGAACCCAGGAGGCGGAGGTTGCGGTGAGCCGAGATCGCGCCATTGCACTCCAGCCTGGGCAACAAGAGCGAAACTCTGTCTCAAAAAAAAAAAATAAATAAATAAAATAAAATAAAATAAAATAAAATAAAAT"
"chr17","40291413","40291755","JH378144","13229286","13229620","52","27062127","GGCCAGGCACAGTGGCTCATGCCTGTAATCCCAGCACTTTGCGAGGCTGAGCCAGGTGGATCACCTGAGGTCAGGAGTTCAAGAGCAGCCTGGCCAACATGGTGAAACCCCGTCTCTACTAAAAATACAAAAATTATCTGGAGTGGTGGTAGGTGCCTATAATTGCAGATACACAGAAGGCTGAGACAGGAGAATTGCTTGAACCCAGGAGGCGGAGGTTGCTGTGAGCCGAGATCGCGCCATTGCACCCCAGCCTGGGAGACAAGAGCGAAACTCCATCTCAATAAATAAATACATACATACATACATACATACATGCATACATACATAAAATAAAATAAAA","GGCCGGGCGCGGTGGCTCAAGCCTGTAATCCCAGCACTTTGGGAGGCCGAGGCGGGTGGATCACCTGTGGTCAGGAGTTCAAGACAGCTTGGTCAACATGGTGAAACCCCGTCTCTACCAAAAATACAAAAAATTAGCTGGGCATGGTAGCGCATGCCTGTAATCCCAGCTACTCAGGAGGCTGAGGCAGGAGAATTGCCTGAACCCAGGAGGCAGAGGTTGCGGTGAGCCGAGATCGCGCCATTGCACTCCAGCCTGGGTAACAAGAGCGAAACTCCCTCTCATAAAAAATAAATAAATAAATAAATAAATAAATAAATAAATAAATAAATAAA"
"chr17","45148344","45148987","JH378206","6546474","6546861","299","38601870","GGCTTGGTGCCATGGTTCATGCCTGTAATCCTGGCACTTTGGGAGGCCGAGGTGGGCAGATCACTTGAGCTCAGGAGTTCAAGACCACCTTGGGCGACATGGTGAAACCTCATCTCTCCTTAAAAAAAAAAAAAACAGCCGGGCGCGGTGGCTCACACCTGTAATCCCAGCACTTTGGGAGGCCAAGGCGGGTGGGGTTCATGAGGTCAGAAGATCGAGACCATCCTGGCTAACACGGTGAAACCCCGTCTCACTAAAAATAGAAAAAACTAGCCGGGCGTGGTGGCGGGCACCTGTAGTCCCAGCTACTCGGGAGGCTGAGGCAGGAGAATGGCGTGAACCCGGGAGGCGGAGCTTGCAGTGAGCTGAGATCTTGCCATTGCACTCCAGCCTGGGCAACAAGAGTGAAACTCTGTCTCAAAAAAAAAAAATTAAAAAAACAAATAAAAATAAAAATACATAATTAGCAGGACATGGTGGCACATGCCTGTAATCCCCAGCTACTCGGGAGGCTGAGGCATGGGAATTGTTTAAACCTGTGAGGCGGTGGTTGCAGTGAGCCAAGATCAAGCCATTGCACTCCAGCCTGGGCAACAAGAGTGAAACTCCATCTCAAAAAAAAAAAAAAAAAAGAGAAAAGAAAA","GGCCACACATGGTGGCTAACGCCTGTAATCCCAGCACTTTGGGAGGCCAAGTCGGGTGGATCATGAGGTCAGGAGACCAAGACCATCCTGGCCAAATGGTGAAACCCCGTCTCTACTAAAAATACAAAAATTAGCTGGGCATGGTGGCGTGTGCCTGTAATCCCAGCTACTCAGGAGGCTGAGGCAGGACAATTGCCTGAACCCAGGAGAATTAGCTGGGCATGGTGGCGTGTGCCTGTAATCCCAGCTACTCAGGAGGCTGAGGCAGGACAATTGCCTGAACCCAGGAGGCGAAGGTTGCGGTGAGCCGAGATTGTGCCATTGCACTCCAGCCTGGGTAACAAGAGCGACACTCTGTCTCAAAAAAAAAAAAAAAAAAAAAAAAAAA"
"chr17","47866693","47867898","JH378118","18053084","18053501","809","29813609","GGCTGGGCTTGGTGGCTCATGCCTATAATTCTAGGACTTTGGGAGGCCAAGGCGGATGGATCACCTGAGGTCAAGAGTTGGAGACCAACCTGTCCAACATGGTGAAACCCCCTCTGTACTAAAAATACAAAAATTGGCCGAGCGTAGTGGCTCATGCCTGTGATCACAGCACTTTGAGAGGCTGAGGCGGGCGGATCACAAGGTCAGGAGATCAAAACCATCCTGGCTAACAAGGTGAAACCCCATCTCTGCTAAAAAATAACAGGGCGTGGTGGCACACGGCTGTAGTCCCAGCTACTTGGGAAGCTGAGGCAGGAGAATCGCTTGAACCTGAGAGGCAGAGGTTGCAGTGAGCTGAGATCAGGCCACTGCTCTCCAGCCTGGGCAACAGAGTGAAACTCCATCTCAAAAAAAAAAAGAAAAAGGCCAGGCATGGTGGCTCACGCCTGTAATGCCAGCACTTTGGAAGACTAAGTTGGGCAGATCACAACATCAGAAGATGGAGACCATCCTGGCTAACACGGTGAAACCCCGTCTCTACTAAAAATACAAAAAAAAAAAAAAAAAAAATTAGCCGGGCGTGGTGACATGCGCCTGTAATCCTAGCTACTCCGGAGGCTGAGGCAGGAGAATGGCGTGAACCCGGGAGGCGGAGCTTGCAGTGAGCCGAGATGGTGCCACTGCACTCCAACCTGGGCGACAGAGCGAGACTCTGTCTCAAAAAAAAAAAAAAAAAAGAAAAAAGGTCGGGCGCAGTGGCTCACACCAGTAATCACAGCACTTTGGGAGGCCGAGGCGGGTGGATCACCTGAGCTCGGGAGTTCAAGACCAGCCTGACCAACATGGTGAAACTCCGTCTCTACTAAAAATACAAAATATTAGCCGGGCGTGGTGGCGCGTGCCTGTAATCCCAGTTACACGGGAGGCTGAGGCAGGAGAATCACTTGAACTTGGGAAGTGGAGGTTGTGGGAGCCGAAATCGTGCCATCGCATTCCACAAGAGTGAAACTCCATTTCAAAAAAAAAAAATACAAAAATTAGCTGGGCGTGGTGGCGGGCGCCTTTAATCCCAGGGGCTCGGGAGGCTGAGGCAGGAGAATCGCTTGAACCTAGGAGGCAGAGGTTGCAGTGTGCCAAGATGACACCATTGCACTCCAGGCTGGGCAAGAGAGCAGTAACTCCCGTCTCAAAAAAAAAGAAGGAAAA","GGCTGGGCGCAGTGGCTCACACCTGTAATCCCAGCACTTAGGGAAGCTGAGGCGAGTAGATCACCTGAGGTCAGGAGTTAGAGACCAGCCTGGCCATCATGGTGAAACCCCGTCTCTACTAAAGATACCAAAAATTAGCTGAGTGTGGTGCTGGGTGCCTGTAATCCCAGAAACTCAGGGTGCCTGTAATCCCAGCAACTCAGGGTGCCTTTAATCCCAGCAACTGAGGGTACCAGTAATCCCAGCAACTCAGGGTGTCTTTAATCCTAGCAACTGAGGGCACCTGTAATCCCAGCAACTCAGGAAGCTGAGACAGGAGAAGTACTTGAACCCAGAAGGCAGAGGTTGCAGTGAGCCGATATTGCACCATTGCACTCCAGTCTGGGCAACAAGAGTGAAACTCTGTCTCAAAAAAAAA"
"chr17","48059944","48060302","JH378108","45564157","45564495","64","2495787","GGCCGGGCGCAGTGGTTCATGCCTGTAATCCCAACACTTTAGGGGGCTGAGGCAGGTGGATCACCTGAGGTCAGGAGTTCAAGACCAGCCTGGCCAACATGGTGAAAGCCCATCTCTACTAAAAATACAAAAAATTAGCTGGGCATGGTGGTGCGTGCCTGTAATCCCAGCTACTTGGGATGCTGAGGCAGGAGAATCGCTTGAACCCGGGAGGTGGAGGCTGCAGTGAGCTGAGATTGTGCCATTGCACTCCAGCCTGGGCAACAAGAGTGAAACTCCATCTAAAAAAAAAAAAGAAGAGGAGGAGGAGGAGGAGGGGGAGGGGGAGGAGGAGGAGGAGGAGAAGAAGAAAAAAGAAA","GCTAGGCAAGGTGGCTCATGCCTGTAATCCCAACATTTTGGGAGGCCGAGGCAGATGGATCACCTGAGGTTAGGAGTTCAAGACCAGCCTGGCCAACATGGTGAAACTCCATCTCTACTAAAAATACAAAAAATTAGCTTGGCACGGTGGTGGGTGCCTCTAATCCCAGCTGCTTGGGAGGCTGAGGCAGGAGAATCGCTTGAACTCAGGAGGTGGAGGTTGCAGTGAGCCAAGATCATGGCATTGCACTCCAGCCTGGGCGACAAGAGCGAGACTCCCTCTAAGAAAGAAAAGAAAGAAAAGAAAAGAAAAAAGGAAAGGAAAGGAAAGAAAGAGAAA"
"chr17","50365982","50366602","JH378118","18053084","18053501","274","32312898","GGCAAGGCGTGGTGGCTGATGTCTGTAATCCCAGCAATTTGGGGGGCTGAGGTGGATGGATCACCTGAGATCAGAAGTTCGAGACTAGGCTAGCCAACATAGTGAAACCCCATCTCTACTAAAAATATAAAAAGTTAGCCAGGCGCGGTGGTTCATGCCTGTAATCCCAGCACTTTGGGAGGCCGAGGTAGGTGGATCACAAGGTCAGGAGTTCAAGACCAACCTGGCCAAGATAGTGAAACCTCATCTCTACTAAAAATACAAAAATTAGCTGGGCGTGGTGGCAACCACCTATGATCCCAGCTACTTGGGAGGCTGAGGCAGAGAACTGCTTGAACCCAGGAAGTGGAGGTTGTAGTGAGCCAAGATTGCATCACTGTACTCCAGCCTGGGCAACAGAGCAAGACTCCATCTCAAAAAAAAAAAAAAAAAAAATACAAAAAATTAGCCAGGCGTGGTGGCAGGCACCTGTAATCCCAGCTACTCGGAAGGCTGAGGCAGGAGAATTGCTTGAACCTGGGAGGTAGAGGTTGCAGTGAGCTGAGATTGTGCCATTGCACTCTAGCCTATGTGACAAGAGCGAAACTCCATCTCAAAAAAAAAAAAAAAAAAGAAAGAAAA","GGCTGGGCGCAGTGGCTCACACCTGTAATCCCAGCACTTAGGGAAGCTGAGGCGAGTAGATCACCTGAGGTCAGGAGTTAGAGACCAGCCTGGCCATCATGGTGAAACCCCGTCTCTACTAAAGATACCAAAAATTAGCTGAGTGTGGTGCTGGGTGCCTGTAATCCCAGAAACTCAGGGTGCCTGTAATCCCAGCAACTCAGGGTGCCTTTAATCCCAGCAACTGAGGGTACCAGTAATCCCAGCAACTCAGGGTGTCTTTAATCCTAGCAACTGAGGGCACCTGTAATCCCAGCAACTCAGGAAGCTGAGACAGGAGAAGTACTTGAACCCAGAAGGCAGAGGTTGCAGTGAGCCGATATTGCACCATTGCACTCCAGTCTGGGCAACAAGAGTGAAACTCTGTCTCAAAAAAAAA"
"chr17","50542261","50542886","JH378206","6546474","6546861","277","43995787","GCCGGGCGCTGTGGCTCAAGCCTGTAATCCCAGCATTTTGGGAGACTAAGGGAAGCAGATCCTGTGAGCTCAGGATTTCGAGACCAGCCTGGCCAACATGGTGAAACCCTGTCTCTACAAAAATTAGCCATGCCGGGCACGGTGGCTCACGCCTGTAATCCCAGCACTTTGGGAGGCTGAGGCGGGCGGATCACAAGGTCAGGAGTTTGAGACCATCCTGCCTAACACGGTGCAACCCCGTCTCTACCAAAAATACAAAAAATTAGCTGGGCGTGGTGGCGGGTGCCTGTAGTCCCAGCTACTCGGGGGGCTGAGGCAAGAGAATGGCATGAACCTGTGGGGCGGAGCTTGCTGTGAGCCGATATCCTGCCACTGCACTCCAGCCTGGGCGACAGAGCGAGACTCCATCTCAAAAAAAAAAAAAAAAAAAAAAAAAAAAAAAAATGAGCCAGCTGTGGTGGCGTGTGTGCCTGTAATCCCAGCTACTCGGGAGGCTGAGGCAAGAGAATCACTTGAATCTGGGAGGCAGAGGTTGCAGTGAGCCAAGATCATGCTATTGCACTTCAGCCTGGGCAACAAGAGTGAAACTCTGTCTCAAAAAAAAAAAAAAAAAAAAAGAAAAAGAA","GGCCACACATGGTGGCTAACGCCTGTAATCCCAGCACTTTGGGAGGCCAAGTCGGGTGGATCATGAGGTCAGGAGACCAAGACCATCCTGGCCAAATGGTGAAACCCCGTCTCTACTAAAAATACAAAAATTAGCTGGGCATGGTGGCGTGTGCCTGTAATCCCAGCTACTCAGGAGGCTGAGGCAGGACAATTGCCTGAACCCAGGAGAATTAGCTGGGCATGGTGGCGTGTGCCTGTAATCCCAGCTACTCAGGAGGCTGAGGCAGGACAATTGCCTGAACCCAGGAGGCGAAGGTTGCGGTGAGCCGAGATTGTGCCATTGCACTCCAGCCTGGGTAACAAGAGCGACACTCTGTCTCAAAAAAAAAAAAAAAAAAAAAAAAAAA"
"chr17","51121894","51122508","JH378118","18053084","18053501","260","33068810","GGCTGGGTGCAGTGGCTCATGCCTGTATTCCCAACACTTTGAGAGGCCAAGGCGGGCAGATCACCTGAGGTCAGGAATTCGAGACCAGCCTGGCTAACATGGCGAAACCCTGTCTCTATTAAAAACACAAAAATTAGGCCAGGCACGGTGGCTCACACCTGTAATCCCAGCACTTTGGGAGGCTGAGGCGGGCAGATCACGAAGTCAGGAGATCGAGACCATCCTGGCTAACATGGTGAAACCCTGTCTCTGCTAAAAATACAAAAAAAATAGCGGGGCGTGGTGGCAGGCGCCTGTAGTCCCAGCTACTCAGGAGGCTGAGGCAGGAGAATGGCGTGAACCTGGGAGGCGGAGGTTGCAGTGAGCCGAGATCGCGCCACTGCACTACAGCTTGGGTGACAGAGCGAGACTCTGTCTCAAAAAAAAAAAAAAAAGTTAGTCGGGCATGGTGGTGGGCTCCTGTATTCCCAGCTACTCAGGAGGCTGAGGTGGGAGAATCACTTGAACCTGGAAGGCAGAGGTTGCTGTGAGCCAAGATTGCACCATTGCATTCCAGCCTGGGTGACAAGAGCAAAACTCTGTCTCAAAAAATATATATAAAATAATAAAAATAAA","GGCTGGGCGCAGTGGCTCACACCTGTAATCCCAGCACTTAGGGAAGCTGAGGCGAGTAGATCACCTGAGGTCAGGAGTTAGAGACCAGCCTGGCCATCATGGTGAAACCCCGTCTCTACTAAAGATACCAAAAATTAGCTGAGTGTGGTGCTGGGTGCCTGTAATCCCAGAAACTCAGGGTGCCTGTAATCCCAGCAACTCAGGGTGCCTTTAATCCCAGCAACTGAGGGTACCAGTAATCCCAGCAACTCAGGGTGTCTTTAATCCTAGCAACTGAGGGCACCTGTAATCCCAGCAACTCAGGAAGCTGAGACAGGAGAAGTACTTGAACCCAGAAGGCAGAGGTTGCAGTGAGCCGATATTGCACCATTGCACTCCAGTCTGGGCAACAAGAGTGAAACTCTGTCTCAAAAAAAAA"
"chr17","51573403","51574012","JH378118","18053084","18053501","260","33520319","GGCCGGGTGTGGTGGCTCACGCCTATTATCCCAGCAGTTTGGGAGGCCAAGTGGGGGTTGGATCACCTGAGGTCAGGGGTTCGAGACCAGCATGGCCAACATGGTGAAAACCCATCTATACTAAAGATACAAAAAATTAGGCTGGGCACAGTGGCTCATGCCTGTAATCCCAGCACTTTGGGAGGCCAAGGATCACGAGGTCAGGAGATCGAGACCATCCTGGCTAACACAGTGAAACCCCGTCTCTACTAAAAATACAAAAAAATTAGCCGGGAGTGGTGGCAAGTGCCTGTAGTCCCAGCTACTCAGGAGGCTGAGGCAGGTGAATAGTGTGAACGCAGGAGGCAGAGCTTGCAGTGAGCCGAGATCGTGCCACTACACTCCAGCCTGGGCGACAAGGTGAGACAACGTCTCAAAAAAAAAAAAAAAAAAAAGCCGGGCATGGTGGGAGGCACCTGTAATTCCACCTACTTGGGAGGGTGAGGCAGGAGAATTGCTTGAATCTGGGAGATGGAGGTTGGAGTAAGCCAAGTTCGCACCATTGCACTCCAGCCTGGGTGACAAGAGCGAAACTCTTGTCTCAAAAAAAAAAAAAAAAAAAAAAAAAAAA","GGCTGGGCGCAGTGGCTCACACCTGTAATCCCAGCACTTAGGGAAGCTGAGGCGAGTAGATCACCTGAGGTCAGGAGTTAGAGACCAGCCTGGCCATCATGGTGAAACCCCGTCTCTACTAAAGATACCAAAAATTAGCTGAGTGTGGTGCTGGGTGCCTGTAATCCCAGAAACTCAGGGTGCCTGTAATCCCAGCAACTCAGGGTGCCTTTAATCCCAGCAACTGAGGGTACCAGTAATCCCAGCAACTCAGGGTGTCTTTAATCCTAGCAACTGAGGGCACCTGTAATCCCAGCAACTCAGGAAGCTGAGACAGGAGAAGTACTTGAACCCAGAAGGCAGAGGTTGCAGTGAGCCGATATTGCACCATTGCACTCCAGTCTGGGCAACAAGAGTGAAACTCTGTCTCAAAAAAAAA"
"chr17","51598763","51599361","JH378118","18053084","18053501","241","33545679","GCCGGGCGTGGTGACTCACGCCTGTAATACCAGCACTTTAGGAGGCTGAGGTGGGTGGATCACCTGAGGTCAGGAGTTCGAGACCGGCCTGGCCAACATGGTGAAATCCTGTCTCTACTAAAAATACAAAAAAATGGCCAGGCGTGGTGGCTCACGCCTGTAATCCTAGCACTTTGGGCGGCCCAGGTGAGTGGATCACGAGGTCAGGAGATCGAGACCATCCTGGCTAACATGGTGAAACCCCATCTCTACTAAAAAACTACAAAAAAATTAGCTGGGCGTGGTGGCAGGCGCCTGTAGTCCCAGCTACTCGGGAGGCTGAGGCAGGAGAATGACGTGAACCCGGGAGGCGGAGCTTGCAGTGAGCAGAGCTTGAGCCACTGCACTCCAGCTTGGGCGACAGAGTGAGACTCCGTCTCAAAAAAAAAAAAAAAAAAATTAGCTGGGGATGGTGGCGGGCACCTGTAATCCCAGCTACTCTGGAGGCTGAGACAGGAGAATCGCTTGAACCCAGGAGGCGGAGGTTGCAGTGAGCTGAGATCGTGCCATTGTACTCCAGCCTGGGCAACAAGAGTGAAACTCAATCCGAAGAAAAAAAA","GGCTGGGCGCAGTGGCTCACACCTGTAATCCCAGCACTTAGGGAAGCTGAGGCGAGTAGATCACCTGAGGTCAGGAGTTAGAGACCAGCCTGGCCATCATGGTGAAACCCCGTCTCTACTAAAGATACCAAAAATTAGCTGAGTGTGGTGCTGGGTGCCTGTAATCCCAGAAACTCAGGGTGCCTGTAATCCCAGCAACTCAGGGTGCCTTTAATCCCAGCAACTGAGGGTACCAGTAATCCCAGCAACTCAGGGTGTCTTTAATCCTAGCAACTGAGGGCACCTGTAATCCCAGCAACTCAGGAAGCTGAGACAGGAGAAGTACTTGAACCCAGAAGGCAGAGGTTGCAGTGAGCCGATATTGCACCATTGCACTCCAGTCTGGGCAACAAGAGTGAAACTCTGTCTCAAAAAAAAA"
"chr17","51738482","51739094","JH378118","18053084","18053501","257","33685398","GCCGGGTGCGGTGGCTCACACCTGTAATCCCAGCACTTTGGGAGACTGAGGCGGGAGGATCACCTGAGGTCAGGAGTTCGAGACCAACCTGACCAACATGGTAAAACCCTGTCTGTACTAAAACTACAAAAAATTAGGCCAGGCGCAGTGGTCCATGCCTGTAATCCCAGCACTTTGGGAGGCCAAGGTGGGCGGATCATGAGGTCAGGAGTTTGAGACCAGCCTGGCCAACATAGTGAAACCCTGTCTCTACTAAAAACACAAAAATTAGTCGGGCATGGTGGCGGATGCCTGTAATCTCAGCTACTCAGGAGGTTGAGGCAGGAGAATCACTTGAACCCGGGAGGTGGAGGTTGCAGTGAGCCAAGATCACGCCACTGTACTCCAGCCTGGGCAACAGAGCGGGACTCCATCTTAAAAAAAAAAAAAAAAAAATTAGCCAGGCGTGGTGGCGCATGCCTGTAGTCCCAGCTACTTAGGAGGCTGAGGCAGGAGAATTGCTTGAACCCGGGAGGCAGAGGCTGCAGTGAGCCAAGACCACGCTATTGCATTCCAGCCTGGGTGACAAGAGCAAAACTCTGTCTCAAAAAACAAAACAAAACAAACAAAAAAA","GGCTGGGCGCAGTGGCTCACACCTGTAATCCCAGCACTTAGGGAAGCTGAGGCGAGTAGATCACCTGAGGTCAGGAGTTAGAGACCAGCCTGGCCATCATGGTGAAACCCCGTCTCTACTAAAGATACCAAAAATTAGCTGAGTGTGGTGCTGGGTGCCTGTAATCCCAGAAACTCAGGGTGCCTGTAATCCCAGCAACTCAGGGTGCCTTTAATCCCAGCAACTGAGGGTACCAGTAATCCCAGCAACTCAGGGTGTCTTTAATCCTAGCAACTGAGGGCACCTGTAATCCCAGCAACTCAGGAAGCTGAGACAGGAGAAGTACTTGAACCCAGAAGGCAGAGGTTGCAGTGAGCCGATATTGCACCATTGCACTCCAGTCTGGGCAACAAGAGTGAAACTCTGTCTCAAAAAAAAA"
"chr17","52245950","52246538","JH378118","18053084","18053501","254","34192866","TGTAATCCCAGCACTTTGGGAAGCCAACGCGGGTAGATCAGCTGAGGTCAGGAGCTCGAGACCAGCCTGGCCAACTGGTGAAACCCCATCTCTACTAAAAAAAATACAAAAAAATGGCCCAGCGCGGTGGCTCACACCTGTAATCCCAGCACTTTGGGAGGCCGAGGCGGGCAGATCACGAGGTCAGGAGATCGAGACCATCCTGGATAATACGGTGAAACCCCGTCTCTACTAAAAATACAAAAAAAAATTAACCGGGTGTGGTGGCGGGCGCCTGTAGTCCCAGCTACTAGGGAGGCTGAAGCAGGAGAATGGCGCGAAACCGGGAGGCGGAGCTTGCAGTGAGCCAAGACAGGCCACTGCACTCCAGCCTGGGCGACAGAGCGAGACTCCATCTCAAAAAAACAAAAAACAAAAAAATTAGCCAGCTGTGGTGGTGGGCGCATGTAATCCCAGTTACTTGGGAGGCTGAGGCAGGAGAATTGCTTGAAACCAGGAGGCAGAGGTTGCAGTGAGCCAAGATTACGCCATTGTACTCCAGCCTGGGCAACAAGGGCAAAACTCTGTCTCAACAAAAAAAAAGAAAAAA","GGCTGGGCGCAGTGGCTCACACCTGTAATCCCAGCACTTAGGGAAGCTGAGGCGAGTAGATCACCTGAGGTCAGGAGTTAGAGACCAGCCTGGCCATCATGGTGAAACCCCGTCTCTACTAAAGATACCAAAAATTAGCTGAGTGTGGTGCTGGGTGCCTGTAATCCCAGAAACTCAGGGTGCCTGTAATCCCAGCAACTCAGGGTGCCTTTAATCCCAGCAACTGAGGGTACCAGTAATCCCAGCAACTCAGGGTGTCTTTAATCCTAGCAACTGAGGGCACCTGTAATCCCAGCAACTCAGGAAGCTGAGACAGGAGAAGTACTTGAACCCAGAAGGCAGAGGTTGCAGTGAGCCGATATTGCACCATTGCACTCCAGTCTGGGCAACAAGAGTGAAACTCTGTCTCAAAAAAAAA"
"chr17","52264620","52265210","JH378118","18053084","18053501","242","34211536","GGCCACATGTGGTGGCTCACACCTGTAATCCCAGCACTTTGGGAGGCCAAGGCAGGCAGATCACCTGAGATCAGAAGTTCAAGACCAGCCTGGCCAATGTGGTGAAACCCTGTCTCTACTAAAAATAGAAAAAACACAGCCAGGCGCGGTAGCTCACACCTGCAATCCCAGCACTTTGGGAGGCCGAGGCAGGCAGATCACGAGGTCAGGAGATTGAGACCACGGTGAAACCCCATCTCTACTAAAAATACAAAAAATTAGCTGGGCATGGTGGCGGGCACCTGTAGTCCCAGCCACTTGGGAGGCTGAGGCAGGAGAATGGCGTGAACTCGGGAGGTGGAGCTTGCAGTGAGCAAAATTGCGCCACTGCACTCCAGCCTGGGCAACAGAGCAAGACTCCGTCTCAAAAAAAAAAAAAAAAAAAAATTAGCCGGCGTAGTGGCAAGCTCCTGTAATCCCAGCTACTTGGGAGGCTGAAGCAGGAGAATCGCTTGAACCCAGGAGGTGGAGGTTGCAGTGAGCCGAGACTGCGCCATTGCACTCCAGCCTGGGCAACAAGAATGAAACTCCGTCTCAGAAAAGAAAAAAAAA","GGCTGGGCGCAGTGGCTCACACCTGTAATCCCAGCACTTAGGGAAGCTGAGGCGAGTAGATCACCTGAGGTCAGGAGTTAGAGACCAGCCTGGCCATCATGGTGAAACCCCGTCTCTACTAAAGATACCAAAAATTAGCTGAGTGTGGTGCTGGGTGCCTGTAATCCCAGAAACTCAGGGTGCCTGTAATCCCAGCAACTCAGGGTGCCTTTAATCCCAGCAACTGAGGGTACCAGTAATCCCAGCAACTCAGGGTGTCTTTAATCCTAGCAACTGAGGGCACCTGTAATCCCAGCAACTCAGGAAGCTGAGACAGGAGAAGTACTTGAACCCAGAAGGCAGAGGTTGCAGTGAGCCGATATTGCACCATTGCACTCCAGTCTGGGCAACAAGAGTGAAACTCTGTCTCAAAAAAAAA"
"chr17","52281488","52282107","JH378118","18053084","18053501","287","34228404","GGCCAGGCGCGGTGGCTCACGCCTGTAATCCCAGCACTTTGGGAGGTCAAGGCGGGTGGATCACCTGAGGTCAGGAGTTCAAGACCAGCCTGGCCAACATGATGAAACTTCATCTTGGCCGGGCGCGGTGGCTCATGCTTGTAATCCCAGCACTTTGGGAGGCCAAGGCAGGCGGCGGATCATGAGGTCAGGAGATTGAGACCATCCTGGCTAAAACGGTGAAACCCCGTCTCTACTAAAAATACAAAAAAAAAAAAATTAGCCGGGCGTGGTGGCAGGCGCCTGTAGTCCCAGCTACTCGGGAGGCTGAGGCAGGAGAATGGCGTGAACCCGGGAGGCGGAGCTTGCAGTGAGCCGAGATAGCACCACTGCAGTCCGGCCTGGGTGAAAGAGTGAGACTCCGTCTCAAAAAAAAAAAAAAAGAAGAAAGAACTTCGTCTTTACTAAAAGTACAAAAAAAAAAAAAAAAAATTAGCCGGGCATGGTGGCAGGCGCCTGTAAACCCAACTACTCTGGAGGCTGAGGAAGGAGAACTGCTTGCACCTGGGAGTCGGAGGTTGCAGTAAGCCAAGATCGCACCATTGCACTCCAGCCTGGGCATCAAGAGTGAGACTTTGTCT","GGCTGGGCGCAGTGGCTCACACCTGTAATCCCAGCACTTAGGGAAGCTGAGGCGAGTAGATCACCTGAGGTCAGGAGTTAGAGACCAGCCTGGCCATCATGGTGAAACCCCGTCTCTACTAAAGATACCAAAAATTAGCTGAGTGTGGTGCTGGGTGCCTGTAATCCCAGAAACTCAGGGTGCCTGTAATCCCAGCAACTCAGGGTGCCTTTAATCCCAGCAACTGAGGGTACCAGTAATCCCAGCAACTCAGGGTGTCTTTAATCCTAGCAACTGAGGGCACCTGTAATCCCAGCAACTCAGGAAGCTGAGACAGGAGAAGTACTTGAACCCAGAAGGCAGAGGTTGCAGTGAGCCGATATTGCACCATTGCACTCCAGTCTGGGCAACAAGAGTGAAACTCTGTCTCAAAAAAAAA"
"chr17","52731467","52732093","JH378129","11955248","11955630","276","40776219","GGCCGGGTGCGGTGGCTCACGCCTGTAATCCTGGCACTTTGGGAGGCTGAGATGGACGGATCACCTGAGGTCAGGAGTTTTTTGTTTTTTTCTTTTTTTTTGAGACAGAGTCTGGCTCTGTTGCCCAGGCTGGAGTGCAGTGGCTCGATCTCGGCTCACTGCAAGCTCCGCCTCCCGGGTTCATGCCATTCTCCTGCCTCAGCCTCCCGGTAGCTGGGACTACAGGTGCCCGCCAGCACATCCGGTTATTTTTTTGTATTTTTAGTAGAGACAGTGTTTCACAGTGTTAGCCAGGATGGTCTCGATCTCCTGACCTCGTGATCCGCCCACCTCGGCCTCCCAAAAGTGCTGGGATTACAGGCATGAGCCACCGCGCCCGGCCAGGAGTTTTTGAGACCAGCCTGGCCAACAGGGTGAAACTCTGTCTCTACTAAAAATACAAAAATTAGTTGGGCATGGTGGCAGGCACCTGTAATCCCAGCTACATGGGAGGCTGAGGCAGGAGAATTGCTTGAACCTGGGAGGCGGAGGTTGCAGTGAGCTGAGATTGCGCCATTGCACTCCAGCCTGGGCAACAAGAGTGAAATTGCGTCTCAAAAACCAAAACAAACAAAAAAAGAATGAAAA","GGCTGGGTACGGTGGCTCATGCCTGTAATCCCAGCACTTTGGGAGGTGGGTCACTTGAGGTCAGGAGTTCGAGACCAGCCTGTGCAGTGCCTCCATCCTCAACTGCTGCCTCATCAGCCTGGACCACTACCTGCTCATCCTCTCACCACTGCCACAAGCTGCGCATGAAGCTCCTGCGCGCGCCGGTGCCCGTCTCTACTAAAAATACAAAAATTAGCTGGGTGTGGTGGCAGGTGCCTGTAATCCCAGCTACTCAGGAGGCTGAGGCAGGAGAATCACTTGAACCCAGGAGGCAGAGGTTGCAGTGAGCCGATATCGCATCATTGCACTCCAGCCTGAGCAACAAGAGTGAAATTTTGTCTCAAAAAAAAAAAAAAAAGAAA"
"chr17","54416242","54416805","JH378115","26183910","26184297","228","28232332","ACTTTGGGAGGCCATGGCAGGCGGATCACCTGAGATCAGGAGTTGGAAACCAGCCTGGCCAACATGGTAAAACCCCGTCTCTACTAAAAATACTTGGCTGGGCACGGTGGCTCACACTTGTAATTCCAACACTTTGGAAGGCCAAGGCGGGCAGATCACCTGAGGTTGGGAGTTCGAGACCAGCCTGACCAACATGGAGAAACCCTGTCTCTACTAAAAATACAAAATTAGCTGGGCATGGTGGTCTATGCCTGTAATCCCAGCTACTTGGGAGGCTGAGGCAGGAGAATTGCTTGAACCCGGGAGGCAGAGGTTGCGGTAAGCCAAGATCATGCCATTGCACTCCAGCCTGGGCAACAAGAGCAAAACCCCGTCTCAAAAAAAAAAAAAAAATTAGCCCAGTGTGGTGGCGTGCACCTGTAATCCCAGCTACTTACTTAGGAGCCTGAGGCAGGAGAATTGCTTGAACCCGGGAGGCAGAGTTTGCAGTGAGCCAAGATTGCACCATTGCACTCCAGCCTGGGTGACAAGAGTGAGACTGTCTCAAAAAAAAAAAAAAAAAAA","GGCCAGGTGCAGTGGCTCATATGTATAACCCCAACACTTTGGGAGGCCAACGCAGGTGGATCACCTGAGTTAGGAGTTTGAGACCAGCCTGACCAACATGGTGAAACCCTGTCTCTACTAAAAATACAGAAATGGCCGGGCATAGTGACACATACCTGTAATCCCAGATACTTGGGATGCTGAGTTTGCTTAAACCCAGAGGAGAACTGCTTAAACCCGGGAGGTAGAGGTCACAGTGAGCCAAGATTGGGATGCTGAGATTTGCTTAAACCCAGAGGAGAACTGCTTAAACCCAGGAGGCAGAGGTTGCAGTGAGTTGAGATTGCACCATTGCACTCCAGCCTGGACAACAAGAGTGAAACTCTGTCTCAAAAAAAAAAAAAAAAAA"
"chr17","55179146","55179483","JH378144","13229286","13229620","44","41949860","GGCCGGGTGCGGTGGCTCACGCCTGTAATCCCAGCACTTTGGGAGGCCGACGCAGGTGGATCACTTGAGGTCTGGTGTTCAAGACCAGCCTGGCCAACATTGTGAAACCCCGTCTCTACTAAAAATACAAAAAGTTAGCTGGGCATGGTAGCAGGTGCCTGTAATCCCAGCTACTTGGGAGGCTGAGGCAGGAGAATTGCTTGAACCTGGGAGGCAGAGGTTGCAGTGAGCTGAGATCGCACCATTGCACTCCAGCCCAGGCAACAAGAGCGAAACTTCGTCTCAAATAATAATAATAATAATAATAATAAATAAATAAATTTTTAAAAAAGAAAAAA","GGCCGGGCGCGGTGGCTCAAGCCTGTAATCCCAGCACTTTGGGAGGCCGAGGCGGGTGGATCACCTGTGGTCAGGAGTTCAAGACAGCTTGGTCAACATGGTGAAACCCCGTCTCTACCAAAAATACAAAAAATTAGCTGGGCATGGTAGCGCATGCCTGTAATCCCAGCTACTCAGGAGGCTGAGGCAGGAGAATTGCCTGAACCCAGGAGGCAGAGGTTGCGGTGAGCCGAGATCGCGCCATTGCACTCCAGCCTGGGTAACAAGAGCGAAACTCCCTCTCATAAAAAATAAATAAATAAATAAATAAATAAATAAATAAATAAATAAATAAA"
"chr17","59543657","59543981","JH378109","3329188","3329514","46","56214469","GGTTGGGCACAGTGGCTCACGCCTGTAATCCCAACACTTTGGGAGGCCAAGGCGGGTGGATCACCTGAGGTCGGGAGTTCAAGACCAGCCTGGCCAACATGCTGAAACCCTATCTCTACTAAAAATACAAAAAAAAAAAAAAAAAAAAAAAAAAAAAATAGCCCAGTGTGGTGTCAGGCGCCTATAATCTCAGCTACTTGGGTGGCTGAGGCAGGAGAGTCGCTTGAACCTGGGAGGCGGAGGTTGCAGTGAGCGGAGATCGCACCATTGCACTCCAGCGTGGGCAACAAGAGTGAAACTCCATCTCAAAAAAAAAGAAAAGAAA","GGCCAGGCATGGTGGCTCACGCCTGTAATCCCAGCACTTTGGGAGCCCAAGCCGGGTGGATTACCTAAGGTCAGGAATTCCAGAACAGCCTGGACAATATGGTGAAACCTTGTCTCTACTAAAAATACAAAAAAAAAAAAAAAAAAAAAAAAAAAAAAAATTTAGCCGGGTGTGGTGGTAGGTACCTGTAATCCCAGCTACTAGGGAGGCTGAGGCAGGAGAATCGCTTGAACTTGGGAGGCGGAGGTTGCAGTGAACAGAGATCACACCACTGCACTCCAGCCTGGGCGACAAGAGCAAAACTCCATCTCAAAGAAAAAAAAAGAA"
"chr17","60766805","60768705","JH378118","18053084","18053501","1483","42713721","GGCCAGGTACCGTGGCTCATGCCTCTTATCCCACCACTTTTGGAAGCTGAGGTGTGAGGATCACCCGAAGTCAGGAGTTTGGAACCATCCTGGCCAATGTTGTAAAACCCCGTCTCTAATAAAAATACAAAAGTTACCCAAGCATGGTGGTGGGCACACCTGTAATCCCAGCTACTTGGAAGGCTAAGACAGGAAAATGCCTGAACCCAGTGTGGCTGGAATTGGTGGGTTCTTGATCTCACTGACCTCAAGAATGAAGCCACGGACCCTCACGGTGAGTGTCACACTTCAAGGTGGCACGTCCAGTTTGTTCCTTCTGATGTTCGGATGTGCTCAGAGTTTCTTTCTTCTGGTGGGTTCATGGTCTCGCTGGCTCAGGAGTGAAGCTACAGACGTTCACCGGGAGTGTTACAGCTCTTAAGGCCTTGCGCCTGGAGTTGTTAGTTCCTCCCAGTGGCTTCGTGGTCTCACTGGCTTCAGGAATCAAGCAGCACGGTGAGCGTTACAGCTCACAAAGGCAGTGTGCACCCACAGTGAGCAACAGCAAAATCTATTGCAAAGAGGACAGAACAAAACCCCCACACTGGGGAAAAGGACCGGAACAGCTTGCCACTGCTGGCTCAGGCAGCCTGCTTTTATTCTCTTATCTGGCCCCACCCACATCCTCCTGATTGGTCCATTTTACAGAGAGCTGATTAGTTTGCTTTACAGTGAACTGATTGGTCCATTTTGACAGATTGGTGCTGATTGGTGCGTTTACAATCCCTGAGCTAGACACAAAAGTTTTCCACGTCCCCATTAGAATAGCTAGATACAGAGTGTCCATAGGTGTATTTACAAACCCTGAGCTAGACACGGAGTGATGATTGGTGCATTTACAAACATGGAGCTAGATACAGAGTGCCGATTGGTGCATTCACAATCCCTTAGCTAGACATAAAGGTTCTCAAGTTCCCACCAGATCAGCTAGACATAGAGCGCTGATTGGTGCATTTACAAAACTTGAGCTCGACACAGGGTGCTGATTGGTGCATTCACAAACCTTGAGCTAGACACAGGGTGCTGATTGGTGTGTTTACAAACCTTGAGCTAGATGCAGAGCGCTGATTGGTGTATTTACAATTCCTTAGCTAGACATAAAGGTTCTCCAAGTCCCCACTAGACTCAGGAGCCCAGCTGGCCTCACCCAGTGGATGTCACACTGGGGCCATAGGTGGAGCTGCCTGCCAGTTCCGTGTCCTGCGCCCACACTCCTCAGCCCTTGGGCGGTGGATGGGATTGGGCACCGTGCAGCAGGGGGTCGCGCTCCTGGGGGAGGCTCGGGCGGTGCAGGAGCCCACGGTGGCGGGGCGGGGCAGACTCAGGCATGGCGGGCTCCGGGTCCCAAGCCCTGCCGGGTGGGGAGGCACCTAAGGCCAGGCGAGAAATGGAGCGCAGCGCTGGTGGGCCAGCACTGCTGGGGGACCAGGCGCATCCTCCGCAGCTGTTGGCCTGGGTGCTAAGCCCCTCACTGCCCAGGGCTGGCAGGGCCCGCCGGCCGCTCCGAGTGCCGGGCCCGCCAAGCCCACGCCCACTTGGAACTCTAGCTGGCCCGCAAGCGCGGCGCGCAGCCCTGGTTCCCCCCCGTGCCTCTCCCTCCACACCTCCCCGCGGGCTGAGGGAGCCGGCTCCGGCCTCGGCCATCCCAGGAAGGGGCTCCCACACTGCAGCGGCGTGCTGAAGGGCTCCTCAAGCACGGCCAGAGTGGGCGAGGAGGCTGAGGAGGCGCCAAGAGTGAGCCAGGGCTGCCAGCATGCTGTCACCTCTCACCAGGAGGCGGAGATTGCAGTGAACCAAGACTGTGCCATTGCACTCCAGCCTGGGCAACAAGAGTGAAACTCCATCTCAAAAAAAATAATAAA","GGCTGGGCGCAGTGGCTCACACCTGTAATCCCAGCACTTAGGGAAGCTGAGGCGAGTAGATCACCTGAGGTCAGGAGTTAGAGACCAGCCTGGCCATCATGGTGAAACCCCGTCTCTACTAAAGATACCAAAAATTAGCTGAGTGTGGTGCTGGGTGCCTGTAATCCCAGAAACTCAGGGTGCCTGTAATCCCAGCAACTCAGGGTGCCTTTAATCCCAGCAACTGAGGGTACCAGTAATCCCAGCAACTCAGGGTGTCTTTAATCCTAGCAACTGAGGGCACCTGTAATCCCAGCAACTCAGGAAGCTGAGACAGGAGAAGTACTTGAACCCAGAAGGCAGAGGTTGCAGTGAGCCGATATTGCACCATTGCACTCCAGTCTGGGCAACAAGAGTGAAACTCTGTCTCAAAAAAAAA"
"chr17","64473614","64473953","JH378109","21565230","21565567","55","42908384","GGCCGGGTGTGGTGGCTCATGCCTGTAATCCCAGTACTTTGGGAGGCCGAGGCAGGCAGATCTCCTGAGGTCAGGAGTTTGAGACCAGCCTGGCCAACATGATGAAATGCTGTCTCTCCTAAAAATACAAAAATTAGCCAGACATAGTGGCAGGTGCCTGTAATCCCAGCTACTTGGGAGGCTGAGGGAGGAGAATTGCTTGAACCTGGGAGGCAGAGGTTGCAGTGAGTCAAGATCACGCCATTGCGCTCCAACCTGGGTGACAAAAGTGAGACTTCATCTCAAAATAAATAAATAAATAAATAAATAAATAAATAAATAAATAATAATTAAAAAAAAA","GGCCGGGCGCGGTGGCTCAAGCCTGTAATACCAGCACTTTGGGAGGCCGAGGCGGGTGGATCACGAGGTCAAGAGATCGAGACCATCCTGGTCAACATGGTGAAACCCCGTCTCTACTAAAAATACAAACAATTAGCTGGGCATGGTGGCGGGTGCCTGTAATCCCAGCTACTCCAGAGGCTGAGGCAGGAGAATTGCCTGAACCCAGGAGACGGAGGTTGCGGTGAGCCAAGATCGCGCCATTGCACTCCAGCCTGGGTGACAAGAGCGAAACTCCGTCTCAATAAATAAATAAATAAATAAATAAATAAAAATAAAATAAATAAATAAATAAATAA"
"chr17","67747489","67748097","JH378118","18053084","18053501","256","49694405","GCTGGGTGTGGTGGCTCACGCCTATAATCCCAGCACTTTGGGAGGCCAAGGCAGGTGGATCACCTGAGGTCAGGAGTTTGAGACCAGCCTGGCCAACATGATGAAACCCCGTCTCTACTAAAAATACAAAGAATTAGGCTGGGCGCGGTGGCTCACGCCTGTAATCCCAGCACTTTGGGAGGCCGAGGCGGGTGGATCACGAGGTCAGGAGATCGAGACCATCCTGGCTAACACGGTGAAACCCCGTCTCTAATAAAAATAAAAAAAAATTAGCTGGGCGTGGTGGTTGGCGCCTGTAGTCCCAGCTACTCGGGAGGCTGAGGCAGGGGAATGGCGTGAACCCGGGAGGTGGAGCTTGTAGTGAGCCGAGATCACGCCACTGCACTCCAGCCTGGGCGACAGAGCAAGACTCCGTCTCAAAAAAAAAAAAAAAAAAAATTAGCCAGGCGTGGTGGCGGGTGCCTGTAATCCCAGCTACTCTGGAGGCTGAGGCAGGAAAATCACTTTAACTCAGGAAACAGAGGTTGCAGTAAGCCGAGATCACGCCATTGTGCTCCATCCTGGGCAACAAGAGCGAAACTCCGACTCGGAAAAAAAGAAAAAAAAAAA","GGCTGGGCGCAGTGGCTCACACCTGTAATCCCAGCACTTAGGGAAGCTGAGGCGAGTAGATCACCTGAGGTCAGGAGTTAGAGACCAGCCTGGCCATCATGGTGAAACCCCGTCTCTACTAAAGATACCAAAAATTAGCTGAGTGTGGTGCTGGGTGCCTGTAATCCCAGAAACTCAGGGTGCCTGTAATCCCAGCAACTCAGGGTGCCTTTAATCCCAGCAACTGAGGGTACCAGTAATCCCAGCAACTCAGGGTGTCTTTAATCCTAGCAACTGAGGGCACCTGTAATCCCAGCAACTCAGGAAGCTGAGACAGGAGAAGTACTTGAACCCAGAAGGCAGAGGTTGCAGTGAGCCGATATTGCACCATTGCACTCCAGTCTGGGCAACAAGAGTGAAACTCTGTCTCAAAAAAAAA"
"chr17","71197353","71197681","JH378262","266823","267148","47","70930530","GACCGGACACAGTGGCTCACGTCTGTAATCCCAGCACTTTGGGAGGCTGAGGCGGGTGGATCACCTGAGGTCAGGAGTTCAAAACCAGCCTGGCCAATATGGTGAAAACCCGTCTATACTAAAAATAAAAAATTAGCCAGGCTTGGTGGCAGGCACCTGTAATCCTAGGTACTCTGGAGGCTTAGACAGGAGAATCACTTGAACCCGAGAAGTGGAGGTTGCAGTGAGCCAAGATCGTGCCATTGCACTCCAGCCTGGGCGACAAGAGTGAGACTCCATCTCAAAAACAAACAAACAAACAAACAAAAAACAAATGAACAAAAAAAAAA","GGCCGGGCGCGGTGGCTCAAGCCTGTAATCCCAGCACTTTGGGAGGCCGAGGCGGGTAGATCATGAGGTCAGGAGTTTGAGACCAGCCTGGCCAACATGGTGAAACCCCGTCTCTACTAAAAATACAAAAATTAGCCGGGCATGGTGGCCTGTGCCTGTAATCCTAGCTACCCAGGAAGCTGAGGCAGGAGAATTGCCTGAACCCAGGAGGCGGAGGTTGCGGTGAGCCGAGATCGTGCCATTGCACTCCAGCCTGGGTAACAAGAGCGAAACTCCGTCTCAAAAACAAACAAACAAACAAACAAAAACAAAAAACAAAAAACAAA"
"chr17","72892082","72892699","JH378118","18053084","18053501","266","54838998","GGCCAGGTGCAGTGGTTCACACCTATAATCCCAGCACTCTAGGAGGCCAAAGTGGGCAGATCACCTGAGGTCAGAAGTTCGAGACCAGCCTGGCCAACATGGTGAAACCATCTCTACTAAAAACACAAAAATTAGGCTGGGCACGGTGGCTCACACCTGTAATCCCAGCACTTTGGGAGGCCGAGGTGGGTGGATCACGAAGTCAGGAGATCAAGACCATCCTGGCTAACACGGTGAAACCCCGTCTCTACTAAAAATACAAAAAATTAGCCAGGCGTGGTGGCGGGCGCCTATAGTCCCAGCTACTTGGGAGGCTGAGGCAGGAGAATGGCGTGAACCCAGGAGGCGGAGCTTGCAGTGAGCCAAGATTGCGCCACTGCACTCCAGCCTGGGTGAGAGAGCTAGACTCTGTCTCAAAAAAAAAAAAAAAAAAAACACAAAAATTAGCCGGGCTTGGTGGCAGGTGCCCGTAATCCCAGCTACTCAGGACGCTGGGACAGGAGAATCTCATGAACCCTGGAGGTGGAGGTTGTAGTGAGCCAAGATCTCACCATCGCACTCCAGCCAGGGTGACAAGAGTGAAACTCTGTCTTAAAAAGATAAATAAATAAAATAAAA","GGCTGGGCGCAGTGGCTCACACCTGTAATCCCAGCACTTAGGGAAGCTGAGGCGAGTAGATCACCTGAGGTCAGGAGTTAGAGACCAGCCTGGCCATCATGGTGAAACCCCGTCTCTACTAAAGATACCAAAAATTAGCTGAGTGTGGTGCTGGGTGCCTGTAATCCCAGAAACTCAGGGTGCCTGTAATCCCAGCAACTCAGGGTGCCTTTAATCCCAGCAACTGAGGGTACCAGTAATCCCAGCAACTCAGGGTGTCTTTAATCCTAGCAACTGAGGGCACCTGTAATCCCAGCAACTCAGGAAGCTGAGACAGGAGAAGTACTTGAACCCAGAAGGCAGAGGTTGCAGTGAGCCGATATTGCACCATTGCACTCCAGTCTGGGCAACAAGAGTGAAACTCTGTCTCAAAAAAAAA"
"chr17","74365360","74365846","JH378118","18053084","18053501","163","56312276","TATAAAAAATCAGCTAGGCTTGGTGGCTTGTGCCTGTAATCCCAGCACTTTGGGAGGCTGAGGCAGGTGGATCACCTGACGTAGGTGTTTAAGACCAGATTGACTAACATGTTGAAACCCCGTCTCTACTAAAAATACAAAAATTATCTGGGCTTGGTGGTGCATGCCTGTAATCCCAGCTGCTCAGGAGGCTGAGACAGGAGAATCGCCTGAACCTGGGAAACGGAAGTTGCAGTGAGTGGAGGTTGCAGTGAGCCGAGATTGCACCACTGCACTCCAGTCTGGGCAACGGAAAAAGACTGTCTCAAAAAAAAAAAAAAAATTAGCTGGGTGTGGTGGTTGGCGCCTGTAATTCCAGCTACTCAGGAGGCTGAGGCAGGAGAATCACTTGAACTCAAGAGGCAGAGGTTGCAATGAGCCAAGATTGCGCCATTGTACTCCAGCCTGGGCCACAAGATTGAAACTTCATCTTGGGGAAAGAAAACAA","GGCTGGGCGCAGTGGCTCACACCTGTAATCCCAGCACTTAGGGAAGCTGAGGCGAGTAGATCACCTGAGGTCAGGAGTTAGAGACCAGCCTGGCCATCATGGTGAAACCCCGTCTCTACTAAAGATACCAAAAATTAGCTGAGTGTGGTGCTGGGTGCCTGTAATCCCAGAAACTCAGGGTGCCTGTAATCCCAGCAACTCAGGGTGCCTTTAATCCCAGCAACTGAGGGTACCAGTAATCCCAGCAACTCAGGGTGTCTTTAATCCTAGCAACTGAGGGCACCTGTAATCCCAGCAACTCAGGAAGCTGAGACAGGAGAAGTACTTGAACCCAGAAGGCAGAGGTTGCAGTGAGCCGATATTGCACCATTGCACTCCAGTCTGGGCAACAAGAGTGAAACTCTGTCTCAAAAAAAAA"
"chr17","74566963","74567566","JH378119","32351107","32351490","260","42215856","GCCGGGCATGGTGTATCACGCCTGTAATCCCAGCACTTTGGGAGGCAGAGGTAGGCAGATCACCTGAGGTCAGGAGTTCAAAACCAGCCTAGCCAACATGGTGAAACCCCGTCTCTACTAAAAATACAAAAAATTAGTGGCCAGGCACGGCAGCTCACGCCTGTAATTCCAGCACTTTGGGAGGCCGAGGCGGGCAGATCACGAGGTCAGAAGATTGAGACCATCCTGGCTAACACGGTGGAACCCCATCTCTACTAAAAATACAAAAAATTAGCTGGGCATGGTGGCTGGTGCCTGTAGTCCCAGCTACTCGGGAGGCTGAGGCAGGAGACTGGCATGAACCCGGGAGGCGGAGCTTGCAGCAAGCCAAGATCGTGCCACTGCACTCCACTCCATCCTGGGCGACAGAGCAAGACTCCGCTTCAAAAAAAAAAAAATTAACCGGGCAAGGTGGCAGGTGCCTGTAATCCCAGCTACTTGGGAGGCTGAGGCAGGAGAATTGCTTGCAGAGGTTGAAGTGAGCCGAGATTACGCCATTGCACTCCAGCCCAAGTGACAAGAGTGAAACTCCATCTCAAAAAAAAAAAAAAAAAAAAGAAAAAAA","GGCCAGGTATGGTGGCTCACACCTGTAATCCCAGCACTTTGGGAGGCCAAGGCAGGCAGACCACCTGAGGTCAGGAGTTCGAGATCAGCCTAGCCAACATGGTGAAACCCCATCTCTAGTAAAAATAAAATTAGCCAGGCATGGTGGTGCATGCCTGTAACGCAGGTCAGGAGTTCGAGATCAGCTTAGCCAACATGGTGAAACCCCATCTCTAGTAAAAATAAAATTAGCCAGGCAGGTGGTGCCGCCTGTACTCGGGAGGCTGAGGCAGGAGAATCACTTGAACCCAAGAGGCAGAGGTTGCAGTCAGCCAAGATCATGCCATTGCACTCCAGCCTAAGCAAAAAGAGTAAAACTCAGTCTCAAAACAAAAAAACAAAAAAA"
"chr17","75365782","75366409","JH378153","2355361","2355755","282","73010421","CCAGGCGTGGTGGCTCATGCCGGTAATCCCAGCACTTTGGGAGGCCAAGGCAGGTGGATCATCTGAGGTCAGGAGTTCGAGACCAGCCTGACCAACATGGTGAAACCTCACCTCTACTAAAAATACAAAAACTAGACAGGCGTGGTGGCGGGTGCCTGTAGTCCCAGCTACTTGGGAGGCTGAGGCAGAAAAATCGCTTGAACCCAGTAGGCAGAGGTTGCAGTGAGCCGAGATCACACCATTGCACTCCAGCCTGGGCAAAAAAGAGCGAAACTCCATCTCAGAAGAAAAGACCGGGTGCAGTGGCTCATGCTTGTAACCCCAGCACTTTGGGAGGCCAAGGCGGGTGGATCACGAGGTCAGAAGATCGAGACCATCCTGGCTAACACGGTGAAACCCCGTCTCTACTAAAAATACAAAAAAAAAAAAATAATTAGCCGAGTGTGGTGGCGGATGCCTGTAGTCCCAGCTACTCGGGAGGCTGAGGCAGGAGAATGGCGTGAACCCAGGAGGCGTAGCTTGCAGTGAGCCGAGATCACGCCACTGCACTCCAGCCTGGGCGACAGAGCAAGACTCGTCTTAAAAAAAAAAAAAAAAAGAAAAAGTAAAAGAAAAGAAAAAGCAACAA","GGCGGGGCATGGTGGCTCACACCTGTCATCCCAACACTTTGGGAGGCTGAGGCAGGCAGATCACCTGAGGTCAGGAGTTTGAGACCAGCCTGGCCAACATGGTGAAACCCCATCTCTACTAAAAATACAAAAATACAAAAAACCCCATCTCTACTAAAAATACAAAAAGCTTGTCTCTATTAAAAATACAAAAAACAAAAAACAAACAAAAAAAAAACCACCATGGTGGTGGGTGCCTATAATCCCAGCTACTCGGGAGGCTGAGGCAGGAGAATCGCTTGAACCCAGGAGGCAGAGGTTGCAGTGAGCCAAGATCCCACCATTGCACTCCAGCCTGGGCAACAGAGAGAGAGACTCTGCCTCAGAAAAAAGAAAGAAAGAAAGAAAGAAAGAAA"
"chr18","19875","20142","JH378153","8929988","8930242","54","8910113","TTGGGAGGCTGAGGTGGGTGGATCATCTGAGGTCAGGAGTTAAGACCAGCCTGGCCAACATGGTGAAACCCCATCTCTACTAAAAATACAAAAACAAAACAAAACAAAACAAAAAAAACCAGCATGGTGGCAGACACCTGTAATCCCAGCTACTCGGGAGACTGAGGCAGGAGAATCACTTGAACCTGGGAGGCGGAGGTTACAGTGAGCCAAGATCTTGTCATGTCACTCCAGCCCAGGCAACAAGAGCAAAACTGTCTTAAAAAAA","TTTGAGAGGCTGAGGTGGGTGGATCACCTAGGTCAGGAGTTTGAGACCAGCCTGACCAACATGGTGAAACCTCATCTCTACTAAAAATAAAAATAAAAAACTAGCCAGGTGCAATGGTGCATGCCTGTAATCCCAGCTACTTGGGAGGCTGAGATGGGAGACTCACTTGAACCTGGGAGGTGGAGGTTGCAGTGAGCCAAGATCATACCATTGCACTCCAGCCTGGGCAACAAGAGTGAAACCTCTTCTCAAAAA"
"chr18","4520498","4521101","JH378118","18053084","18053501","246","13532586","GGCTGGGCGCAGTGGCCCACCCCTGTAATCCCAGCACTTTGGGAGGCCGAGGCGGGTAGATCACCTGACGTCAGGAGTTCAAGACCAGCCTGGCCAACATGGTGAAACCCTGTCTCTACTAAAATACAAAAATTAGGCTGGGCGCAGTGGCTCAAGCCTGTAATCCAGCACTTTGGGAGGCCAAGGCGGGCAGATCACCTGAGGTCAGGAGTTCGAGACTAGCCTGGCCAACCTGGCAAAACCCCATCTCTACTAAAAGTACGAAAATTAGCCAGGGTGATGGTGTGCACCTGTAATCCTAGGTACTCAGGAGGCTGAGGGCAAGAGAATCGCTTGAACCTGGGAGGCAGAGGTTGTAGTGGGCCAAGATCGCGCCATTGCACTGCAGCCTCGGTGACAGAGAAAGACTCCGTCTCAAAAAAAAAAAAAAACAAAAATTAGCTGGGCGTGGTGGTGGGCGTCTGTAGTCCCATCTACACGGGAGGCTGAGGCAGAAGAATCACTTAAACCCAGGATGTGGAGGTTGCAGTGAGCTGAGATCACGCCATTGCACTCCAGACTGGGTAACAAGAGCAAAACTCCATCTCAAATAAATAAAATAAAA","GGCTGGGCGCAGTGGCTCACACCTGTAATCCCAGCACTTAGGGAAGCTGAGGCGAGTAGATCACCTGAGGTCAGGAGTTAGAGACCAGCCTGGCCATCATGGTGAAACCCCGTCTCTACTAAAGATACCAAAAATTAGCTGAGTGTGGTGCTGGGTGCCTGTAATCCCAGAAACTCAGGGTGCCTGTAATCCCAGCAACTCAGGGTGCCTTTAATCCCAGCAACTGAGGGTACCAGTAATCCCAGCAACTCAGGGTGTCTTTAATCCTAGCAACTGAGGGCACCTGTAATCCCAGCAACTCAGGAAGCTGAGACAGGAGAAGTACTTGAACCCAGAAGGCAGAGGTTGCAGTGAGCCGATATTGCACCATTGCACTCCAGTCTGGGCAACAAGAGTGAAACTCTGTCTCAAAAAAAAA"
"chr18","8281535","8282152","JH378118","18053084","18053501","271","9771549","GGCCAGGTGCGATAGCTCACACTGGTAATCCCAACACTTTGGGAGGCCGAGGTGGGCGGATCACCTGAGGCCAGGAGTTTGAGACCAGCCTGGCCAACACAGTGAAACCCCATCTCTACTAAAAATACAAAATTAGGCAGGGTGCAGTGGCTCACGCCTGTAATACCAGCACTTTGGGAGGCCGAGACAGGCGGATTACGAGGTCAGGAGATCGAGACCATCCTAGCTAACACAGTGAAACCCCGTCTCTACTAAAAAAAAAAAAAAAAAAAAAAGTACAAAAAAATTAGCCAGGCGTGGCGGCAGGTGCCTGTAGTCCCAGCTACTCAGGAGACTGAGGCAGGAGAATGGCGTGAACCCGGGAGGCGGAGCTTGCAGTGAACTGAGATCACACCACTGCACTCCAGCCTGGGCAACAGAGTGAGACTCCGTCTCAAAAACAAAACAAAATTAGCCGGGCATGGTGGTGGATGCCCGTAATCCCAGCTACTCGGGAGGCTGAGGCCGCCAAGGCAGGAGAATCTCTTGAATGTGGGAGGCAAAGGCTGCAGTGAGCTGAGATCATGCCATTGCACTGTAGCCTGGGCGACAAAAGTGAGACTCCGTCTCAAAAAAAAA","GGCTGGGCGCAGTGGCTCACACCTGTAATCCCAGCACTTAGGGAAGCTGAGGCGAGTAGATCACCTGAGGTCAGGAGTTAGAGACCAGCCTGGCCATCATGGTGAAACCCCGTCTCTACTAAAGATACCAAAAATTAGCTGAGTGTGGTGCTGGGTGCCTGTAATCCCAGAAACTCAGGGTGCCTGTAATCCCAGCAACTCAGGGTGCCTTTAATCCCAGCAACTGAGGGTACCAGTAATCCCAGCAACTCAGGGTGTCTTTAATCCTAGCAACTGAGGGCACCTGTAATCCCAGCAACTCAGGAAGCTGAGACAGGAGAAGTACTTGAACCCAGAAGGCAGAGGTTGCAGTGAGCCGATATTGCACCATTGCACTCCAGTCTGGGCAACAAGAGTGAAACTCTGTCTCAAAAAAAAA"
"chr18","14964693","14965321","JH378118","18053084","18053501","273","3088391","GGCTGGGTGCGGTGGCTCACACCTGTAATCCCAGCACTTTGGGAGGCTGAGGCAGGCGGATCACCTGAGGTCAGGAGTTCAGGACCAGCCTGATCAACATAGCGAAACCCTGTCTCTATTAAAAATATAAAAATTGCTGGGTGCGGTGGCTCACGCCTGTAATCCCAGCACTTTGGGAAGCCGAGGCGGGCGGATCATGAGCTCAGGAGATCGAGACCATCTTGGCTAACATGGTGAAACCCTGTCTCTACTAAAAATACAAAAAAATTAGCCAGGTGTGGTGGCGGGCGCCTGTAGTCCCAGCTACTCTGGAGGCTGAGGCAGGAGAATCACTTGAACCTGGGAGGCGGAGGTTGCGGTGAGCCAAGATGGTGCCATTGCACTCCAGCCTGGGCAACAAGAGTGAAACTCCATCTCAAAAAAAAAGAAAAAAAAAAAAAAAAACAACCCACAAAAATTAGCCAGGTGTGATGGCGGGTGTCTGTAATCCCAGCTACTTGGGAGACTGAGGCAGGAGAATGGCTTGAACCCGGGAGGTGGAGGTTGCAGTAAGCCGAGATTGCGCCACTGCACTCCAGCCTGGGTGACCAGAGTGAAACTTCATCTCAAAAAAAAAAAAAAAAAAAAAA","GGCTGGGCGCAGTGGCTCACACCTGTAATCCCAGCACTTAGGGAAGCTGAGGCGAGTAGATCACCTGAGGTCAGGAGTTAGAGACCAGCCTGGCCATCATGGTGAAACCCCGTCTCTACTAAAGATACCAAAAATTAGCTGAGTGTGGTGCTGGGTGCCTGTAATCCCAGAAACTCAGGGTGCCTGTAATCCCAGCAACTCAGGGTGCCTTTAATCCCAGCAACTGAGGGTACCAGTAATCCCAGCAACTCAGGGTGTCTTTAATCCTAGCAACTGAGGGCACCTGTAATCCCAGCAACTCAGGAAGCTGAGACAGGAGAAGTACTTGAACCCAGAAGGCAGAGGTTGCAGTGAGCCGATATTGCACCATTGCACTCCAGTCTGGGCAACAAGAGTGAAACTCTGTCTCAAAAAAAAA"
"chr18","15291276","15291680","JH378105","31074364","31074738","116","15783088","CTCGTGCCTGTAATCCTAGCACTTTGGGAGGCCAAGGTGGGCAGATCATCTGAGGTCAGGAGTTCGAGACCAGCCTGGCCAACATAGAGAAATCCCATCTCTACTAAAAATACAAAAATTGACGAGTTAATGGGTGCAGCACACGAACATGGCACATGTATACATATGTAACAAACCTGCACGTTGTGCACATGTACCCTAAAACTTAAAGTATATTTAAAAAAAATACAAAAATTAGCCGGGCATGGTAGCAGGCACCTGTAATCCCAGCTACTCGGGAGGCTGAGGCAGGAGAATCACTTGAACCTGGGAGGCAGAGGTTGCAGTGAGCTAAGATCATTCCATTGTACTCCAACCTGGGCAACAAGAGTGAAATTCCGTCTAATAAAAAATGAAATAAATAAA","GGCCGGGCACAGTGGCTCACACCTGTAAACCCAGCACTTTGGGAGAATGAGGTGGGCAGATGACTTCAGGTCAGGAGTTCGAGACCAGCCTGGCCAACACTGTGAAATCCCATCTCTACTAAAAATACAAAAATTAGCCATGGTGGTCAGAAGATCAAGACTATCCTGGCCAACATGGTGAAACCTTGTCTCTACTGAAAATAGAAAAATTAGCTGGGTATGGTGGCATGCGCCTGTAGTCCCAGATACTCAGGAGGCTGGGGCAGGAGAATCACTTGAACCCAGGAGGCAGAGGTTGCAGTGAGCTGAGATCATGCCATTGCACTCTAGATTAGGCAACAAGAGTGAAACTGTCTCAAAAAGAGAGAGAGAAAA"
"chr18","15802064","15802689","JH378153","2355361","2355755","270","13446703","GACCGGGCATGGTGGCTCACACCTGTAATCCCAGCACTTTGGGAGGCGTAGGCGAGTGGCCCCTGAGGTCAGGAGATCGAGACAACCCTGGCCAACATGGTGAAACTCTACTAAAAATACAAAATTAGGCCGGGTGCCGTGGTTCACGCCTATAATCCCAGCACTTTGGGAGGTCAAGGTGGGCAGATCACCTGAGGTCAGGAGTTTGAGACCAGCCTGGCCAACATGGTGAAACCCAGTCTCTACTAAAAATACAAAAATTAGCTGGGCATGGTGGTGGACACTTGTAATCCCAGCTACTTGGGGGGCTGAGGCAGGAGAATCACTTGAACCCAGGAGGCAGAGGTTGCAGTGAGCCTAAATCACCCCATTGCACTCCAGCCTGGGCAACAAGAGTGAAATTCTGTCTCGAAAAAAAAAAAAAAAGAAAAGAAAAGAAAAAAAAATTAGCCAGGTGTGGTGCTGCATGCCTGTAATCCCAGCTACTCAGGAGGCTGAGGCAGGAGAATCGCTTGAACCCGGGAGGCAGAGGTTGCAGTGAGCTGAGACCACACCATTGCACTCCAGCCTGGGCGACAAGAGAGTAACTCCATTTCAAAAAAAAAAAAAAAAAAAAGAAAAAAGAA","GGCGGGGCATGGTGGCTCACACCTGTCATCCCAACACTTTGGGAGGCTGAGGCAGGCAGATCACCTGAGGTCAGGAGTTTGAGACCAGCCTGGCCAACATGGTGAAACCCCATCTCTACTAAAAATACAAAAATACAAAAAACCCCATCTCTACTAAAAATACAAAAAGCTTGTCTCTATTAAAAATACAAAAAACAAAAAACAAACAAAAAAAAAACCACCATGGTGGTGGGTGCCTATAATCCCAGCTACTCGGGAGGCTGAGGCAGGAGAATCGCTTGAACCCAGGAGGCAGAGGTTGCAGTGAGCCAAGATCCCACCATTGCACTCCAGCCTGGGCAACAGAGAGAGAGACTCTGCCTCAGAAAAAAGAAAGAAAGAAAGAAAGAAAGAAA"
"chr18","15849226","15849860","JH378118","18053084","18053501","290","2203858","GGCCAGGCACAGTAGCTTACGCCTATAATCTCAGCACCCTAGGAGGCCGAGGCTGGCAGACCACCTGAGGTCACGAGTTCAAGACTAGCCTGGTCAACATAGCAAAACCCCATCTCTACTAAAAATACAAAAATTAGGCTGGGCACAGTGGCTCATGCTTGTAATCCCAGCACTTTGGGAGGCCAAGTCGGGAGAATCACCTGAGGTTGGGAGTTCGAGATCAGCCTGACCAACATAGAGAAACTCCATCTCTACTAAAAATGCAAAATTAGCTAGGCATGGTGGTGCATGCCTGTAATCCCAGCTACTCGTAAGGCTGAGGCAGGAGTATCGCTTGAATCTGGGAGGTGGAGGTTGCGGTGAGCCAAGATCACGCCATCGTACTCCAGCCTGGGCAACAAGAGCGAAACTCCATCTCAAAACAAAAAAAATGAGCCAGGAGTGGTGGCGGGCGCCTATAATTCCAGCTACTCCAGAGGCTGAGGCAGGAGAATCACTTAAACCCGGGAAGCAGAGGTTGCAGTGAGCTGAGATTGTGCCATTGCACCCCAGCCTAGGTGAAAAGAGCAAAACTCCATCTCAAAAAAAAAAAAAAAAAAAAAAAAAAAGAAAGAAAGAAAGAAAAAGAAAAAAAA","GGCTGGGCGCAGTGGCTCACACCTGTAATCCCAGCACTTAGGGAAGCTGAGGCGAGTAGATCACCTGAGGTCAGGAGTTAGAGACCAGCCTGGCCATCATGGTGAAACCCCGTCTCTACTAAAGATACCAAAAATTAGCTGAGTGTGGTGCTGGGTGCCTGTAATCCCAGAAACTCAGGGTGCCTGTAATCCCAGCAACTCAGGGTGCCTTTAATCCCAGCAACTGAGGGTACCAGTAATCCCAGCAACTCAGGGTGTCTTTAATCCTAGCAACTGAGGGCACCTGTAATCCCAGCAACTCAGGAAGCTGAGACAGGAGAAGTACTTGAACCCAGAAGGCAGAGGTTGCAGTGAGCCGATATTGCACCATTGCACTCCAGTCTGGGCAACAAGAGTGAAACTCTGTCTCAAAAAAAAA"
"chr18","16042035","16042617","JH378118","18053084","18053501","243","2011049","GGCTATGCACGGTGGCTCACGCCTGTAATCCCAGCACTTTGGGAGGCCGAGTCAGGTGGATCACTTGAGGTCAGGAGTTCGAGACCAGCCTGGCCAACATGGTGAAGCCCCATCTCCACTAGAAATACAAAAATTAGTCTGGGAGCAGTGGCTTACACCTGTAATTGCAGCACTTTGGGAGGCCAAGGTGGGTGGATCACCTGAGGTCAGGAGTTTGAGACCAGCATGACCAACATGGTGAAACTCCATCTATACAAAAAAATTAGCCGGGTGTGGTGGCGCATGCCTGTAATCCCAGCTACTCAGGAGACTGAGGCAGGAGAATTGCTTGAACCCGGGAGGCAGAGGTTGCAGTGAGCCAAGTCTGTGCCATTGCACTCCAACCTGGGCAACAAAAGCGAAACTCTGTCTCAAAAATAAACAACAAAAAAAATTAGCCAGGTGTGGTGGCACATGCCTATAATCCCAGCTACTCGGGAGGCTGAGGCAGAAGAATTGCTTGAACCTGGGAGGTGGAGGTTGCAGTGAGCCGAGATCATGCCATTCTACTCCAGCCTGGGCCACAAGAGCGAAACTCTGTCTC","GGCTGGGCGCAGTGGCTCACACCTGTAATCCCAGCACTTAGGGAAGCTGAGGCGAGTAGATCACCTGAGGTCAGGAGTTAGAGACCAGCCTGGCCATCATGGTGAAACCCCGTCTCTACTAAAGATACCAAAAATTAGCTGAGTGTGGTGCTGGGTGCCTGTAATCCCAGAAACTCAGGGTGCCTGTAATCCCAGCAACTCAGGGTGCCTTTAATCCCAGCAACTGAGGGTACCAGTAATCCCAGCAACTCAGGGTGTCTTTAATCCTAGCAACTGAGGGCACCTGTAATCCCAGCAACTCAGGAAGCTGAGACAGGAGAAGTACTTGAACCCAGAAGGCAGAGGTTGCAGTGAGCCGATATTGCACCATTGCACTCCAGTCTGGGCAACAAGAGTGAAACTCTGTCTCAAAAAAAAA"
"chr18","25849088","25849351","JH378114","20445944","20446195","60","5403144","GGGAAGATGAGGCGGGTGGATCACTTGAGGTCAGGAGTTCGAGACCAGCCTGGCCAACATGGTGACACCCTGTCTCCAAAAAATACACACACACACACACACACACACACACACACAAATTAGCTGGGCATGGTGGCGGGCACCTGTAATCCTAGCTACTCGAGAGGCTGCGGCAGGAGAATTGCTTTAACTTGGGAGGTAGAGGTTGCAGAGAGCCGAGATTGCACCATTGTACTCCAGCCTGGGTGACAAGAGCGAAACTCC","TTGGGAGGCCAAGGCGGGTGGATCACCTGAGGTCAGGAGTTCGAGACCAGCCTGGCCAACATGATAAAACCCCCGTATCTAATAAAAATAGGAAAAAAAAATAAATAAATAGCTGGGCGTTGTGGCAGGTGCCTGTAATCCCAGCTACTCGGGAGGCTCAGGCAGGAGAATCGCTTGAACCCAGGAGGCAGAGGTTGCAGTGAGCCAAAATTGTGCCATTGCACTCCCGCCTGGGAAACAAGAGCAAAACTC"
"chr18","38083500","38083832","JH378152","15993594","15993909","55","22089906","GGCTGGGTGCGGTGGCTCACGCCTGTAATCCCAGCACTTTGGGAAGCCAAGTCAGGTGACCTCACCTGAGGTCAGGAGTCCAAGACCAGCCTGACCAACATGGTGAAACCTCGTCTCTACTAAAAAGACAAAAAATTAGCCAGGCATGGTGGTGGGCACCTGTAATCTCAGCTACTCTGGAGGCTGAGGCAGGAGAATCACTTGAACCCTGGAGGGGGAGGTTGCAGTGAACCAAGATTGCACCATTGCAGTCCAGCCTGGGCGACAAGAGCAAAACTCCATCTCACAAACACACACACACACACACACACACACACACACAGAAAAAAAAAA","GGCTGGGTGTGGTGGCTCATGCCGGTAATCCCAGCACTTTGGGAAGCGGAGGCAGGCAGATCACCTGAGGTCAGGAGTTCAAGACCAACCTGGCCAACATGGAGAAACCATGTCTCTACTAAAAATACAAAAAATTAGCCAGGCATGGTGGGTGCCTGTAATCCCCACTACTCGGGAGGCTGAGGCAGGAGAATTTCTTGAACCCAGGAGGTGGAGGTTTCAGTGAAGCGGAGATCACCCCATTGCACTCCAGCCTGGGTGACAAGAGCAAAACTCCATCTCACAAAATCAACAACAACAACTTAAAAAAAAAAAA"
"chr18","44076326","44076933","JH378118","18053084","18053501","257","26023242","GCTGGGCGCGGTGGCTTGCGCCTGTAATCCCAGCCATTTGGGAGGCCGAGGCAGGTGGATCACCTGAGGTTAGGAGTTCAAAACCAGCCTGGCCAACATGGTGAAACCCCGTCTCTACTAAAAATACAAAAATTAGGCCAGGCACAGTGGCTCACGCCTGTCATCCCAGCACTTTGGGAGGCCAAGGCGGGCGGATCATGAGGTCAGGAGATTGAGACCATCCTGGCTAACACAGTGAAACCCTGTCTCTACTAAAAAAATATATAAAAAATTAGCCGGGCTTGGTGGCGGGTGCCCGTAATCCCAGCTACTCGGGAGGCTGAGGCAGGAGAATGGCGTGAACCTGGAAGGCGGAGCTTGCAGTGAGCCGAGATTGCACCACTGCACTCCAGCCTGGGTGACAGAGTGAGACTCTGTCTCAAAAAAAAAAAAAAAACAAAAAACAAAAATTAGTTGGGTGTGGTGGTGGACGCCTGTAATCCCGGCTACTCGGGAGGCTGAGGCAGGAAAATCACTTCAACCCGGGAGGCAGAGGTTGCCGTGAGCCAAGATCGTGCCATTGCACTCCAGCCTGGGTGACAAGAGCAAAACTCTGTCTCAAAAAAAAA","GGCTGGGCGCAGTGGCTCACACCTGTAATCCCAGCACTTAGGGAAGCTGAGGCGAGTAGATCACCTGAGGTCAGGAGTTAGAGACCAGCCTGGCCATCATGGTGAAACCCCGTCTCTACTAAAGATACCAAAAATTAGCTGAGTGTGGTGCTGGGTGCCTGTAATCCCAGAAACTCAGGGTGCCTGTAATCCCAGCAACTCAGGGTGCCTTTAATCCCAGCAACTGAGGGTACCAGTAATCCCAGCAACTCAGGGTGTCTTTAATCCTAGCAACTGAGGGCACCTGTAATCCCAGCAACTCAGGAAGCTGAGACAGGAGAAGTACTTGAACCCAGAAGGCAGAGGTTGCAGTGAGCCGATATTGCACCATTGCACTCCAGTCTGGGCAACAAGAGTGAAACTCTGTCTCAAAAAAAAA"
"chr18","44546829","44547449","JH378118","18053084","18053501","262","26493745","GGCCAGGCACGGTCGCTCACACCTGTAATTCCAGCACTTTGGGAGGCCAAGGCGGATGGGTCACCTGAGGTCAGGAGTTTGAGACCAGCCTGACCAATATGATGAAACCCCATCTCTATTAAAAATACAAAAATTAGGCTGGGCGCAGTGGTTCATGCCTGTAATTCCAACACTTTGGGAGGCCGAGACGGGCGGACCATGAGGTCAGGAGATCGAGACCATCCTGGCCAACGTGGTGAAACCCCGTGTCTACTAAAATACAAAAAAAATTAGCCAGGTGTGGTGGCACGTGCCTGTAGTCCCAGCTATTAGGGAGGCTGAGGCAGGGGAATCACTTGAACCTGGGAGGTGGAGGTTGCAGTGAGCTGAGATCTTGCCACTACACTCCATTCTGGGCAACAGAGCAAGACTCCGTCTGAAAAAAAACAAAAAAATACAAAAATTAGCTGGGCATGGTGGCGGGTACCTGTAATCCCAGCTACTTGGGAGGCTGAGACAGGAGAATCACTTGAACTCGGGAGGCAGAGGTTGCAGTGAGCCAAGATCGCACCATTGCATTCCAGCCTGGGCAACAAGAGCGAAACTCCATCTCAAAAAAACAAAAAAAAAAAAAAAGAAAAA","GGCTGGGCGCAGTGGCTCACACCTGTAATCCCAGCACTTAGGGAAGCTGAGGCGAGTAGATCACCTGAGGTCAGGAGTTAGAGACCAGCCTGGCCATCATGGTGAAACCCCGTCTCTACTAAAGATACCAAAAATTAGCTGAGTGTGGTGCTGGGTGCCTGTAATCCCAGAAACTCAGGGTGCCTGTAATCCCAGCAACTCAGGGTGCCTTTAATCCCAGCAACTGAGGGTACCAGTAATCCCAGCAACTCAGGGTGTCTTTAATCCTAGCAACTGAGGGCACCTGTAATCCCAGCAACTCAGGAAGCTGAGACAGGAGAAGTACTTGAACCCAGAAGGCAGAGGTTGCAGTGAGCCGATATTGCACCATTGCACTCCAGTCTGGGCAACAAGAGTGAAACTCTGTCTCAAAAAAAAA"
"chr18","45772849","45773450","JH378118","18053084","18053501","269","27719765","CACGCCTATAATCCCAGCACTTTAGGAGGCTGAGGCAGGTGGATCACCTGAGATCAGGAGTTCAAAACCAGCCTGGCCAACATGGTGAAACCCTGTGTCTACTACAAATACAAAAAAATGGGCAGGGTGTGGTGGCTCACACCTGTAATCCCAGCACTTAGGGAGGCCGAGGCGGGTGGATCATGAGGTCAAGAGATCAAGACCATCCTGGCCAACATGGTAAAACCCCGCCTCTACTAAAAATATAAAAATTAGCTGGGCAAGGTGGTGCGCGCCTGTAGTCCCAGCTATTTGGGAGGCTGAGGCAGGAGAATTGCTTGAACCTGGGAGGTGGAGGTTGCAGTGAGCCAAAATCGCGCCACTGCACTCCAGCCTGGCAACAGAGTGAGACTCTGTCTCAAAAAAAAACAAAAACAAAACAAAACAGAAACCAAAATTAGCTGGGCGTGGTGGCGGGCGCCTGTAGTCCCAGCTACTTGGGAGGCTGAGGCAGGAGAATCGCATGAACCCAGGAGGCGGAGGTTGCAGTGAGCCAAGACTGCACTATTGCACTCCAGTCTGGGCTACAAGAGCGAACTCCGTCTCAAAAAAAAAAAAAAAAA","GGCTGGGCGCAGTGGCTCACACCTGTAATCCCAGCACTTAGGGAAGCTGAGGCGAGTAGATCACCTGAGGTCAGGAGTTAGAGACCAGCCTGGCCATCATGGTGAAACCCCGTCTCTACTAAAGATACCAAAAATTAGCTGAGTGTGGTGCTGGGTGCCTGTAATCCCAGAAACTCAGGGTGCCTGTAATCCCAGCAACTCAGGGTGCCTTTAATCCCAGCAACTGAGGGTACCAGTAATCCCAGCAACTCAGGGTGTCTTTAATCCTAGCAACTGAGGGCACCTGTAATCCCAGCAACTCAGGAAGCTGAGACAGGAGAAGTACTTGAACCCAGAAGGCAGAGGTTGCAGTGAGCCGATATTGCACCATTGCACTCCAGTCTGGGCAACAAGAGTGAAACTCTGTCTCAAAAAAAAA"
"chr18","50079974","50080314","JH378127","6796468","6796795","54","43283506","GGTCTGGCGCCAGTGGCTCATGCCTGTAATCCCAGCACTTTGGGAGGCTGAGGCGGGTGTATCACCTGAGGTCAGGAGTTCGAGACCAGCCTGGCCAACATGGCAAAACCCCGTCTCTACGAAAAATACAAAAAAATTAGCCGGGCGTGGTAGCAGTCGCCTGTAATCCCAGCAACTTGGGAAGCTGAGGCAGAAGAATCGCTTAAACCTAGGAGGCGGAGGTTGCAGTGAGCCAAGATTGCGCCATTGCACTCCAGCCTGGTCAACAAGAGCAAAACTCTGTCTCAAAACAACAACAACAACAACAACAACAACAAACAAAAACCAAAAAAACCAAAAAA","GGCCGGGCGCGGTGGCTCAAGCCTGTAATCCCAGCATTTTGGGAGGCCGAGGCGGGTGGATCACGAGGTCAGGAAATCGAGACCATCCTGGTCAACATGGCGAAACCCCATGTCTACTAAAAATACAAAAATTAGCTGGGCATGGTGGCACGTGCCTGTAATCCCAGCTACTCAGGAGGCTGAGGCAGGAGAATTGCCTGAACCCAGGAGGCGGAGCTTGCAGTGAGCCGAGATCGCGCCATTGCACTCCAGCCTGGGTAACAAGAGCGAAACTCCGTCTCAAAAAAACAAACAAAAACAAAACAAAACAAAACAAAACAAAAAAAAC"
"chr18","53653883","53654201","AGCE01149660","956","1264","46","53652927","GGCCAGGCATGGTGGCTCACGTTTGTAATCCTAGCACTTTGGGAGGCTGTAGCGGGCGGATCACCTGAGGTCAGGAGTTTGAGACCAGCCTGGCCAACATGGTGAAACCCTGTCTCTACTAAAAAAAAAAAAAAAAAAAAAAAAAAAATTAGCCAGGTGTGGTGGTGGTGGATGCCTATAATCCCAGCTACTCGGGAGGCTGAGGCAGGAGAATCACTTGAACCTGGGAAGCAGAGGTTGCAATGAGCTGAGATTGAGCCATTGCACTCCAGCCTGGACAACAAGAATGAGACTCTGTCTCAATAAATAAGTAAATAAA","GGCCAGGCACGGTGGCTCATGCCTATAATCCCAGCACTTTGGGAGGCTGCGATGGGTGGTTCACTTGAGGTCTGGAGTTTGAGACCAGCCTGGCCAACATGGAGAAACCCTTTCTCTACTAAAAATACAAAAAAAAAAAAAAAAAAAATTAGCCAGGCATGGTGGCGGGTGCCTGTAATCCCAGCTACTCAGCAGGCTGAGGGAAGAGAATCACTTGAACCGGGGAGGCAGAGGTTGCAGTGAGCTGAGATGATGCCATTGCACTCCAGCCTGGGCAACAAGAGCAAAACTGTCTCAAAAAAAAAAAAA"
"chr18","53971096","53971710","JH378118","18053084","18053501","262","35918012","GGTCGGGTGTGGTGGCTCATGCCTATAATCCCAGCACTTTGGGAGGCTGAGGCAGGCAGATTACCTGAGGTCAGGAGTTCGAGACCAGCCTGGCCAACATGATGAAACCTTGTCTCTACTAAAAATACAAAAATTAGGCCGGGCACGGTGGCTCATGCCTGTAATCCCAGCACTTTGGGAGGCCGAGGCGGGTAGATCACAAGGTCAGAAGTTCAAGACCAGCCTGGCCAACATGGTGAAACTCTGTCTTTACTAAAAATACAAAAATTAGCTAGGCATGGTGGCGCACACCTATAATCCCAGCTACTGGGGAGGCTGAGGCAGGAGAATTGCTTGAACCAGGACCCGGGAGGTGGAGGTTGCTGTGAGCCGAGATTGCGCCACTGCACTCCAGCCTGGGAGACAGAGTGAGACTCCGTCTAAAAAAAAAAAAAAAAAATTAGCCAGGTGTGGTGGCGCATGCCTGTAATCCCAGCTACTCGGGAGGCTGACGCAGAAGAATCATTTGAACGTGGGAGGCAGAGGTTACAATGAGCTGAGATCACACCATTGTACTCCAGCCTGGGCAACAAGAGCAAACTCAATCTCAAAAAAATAAAAATAAAAAAAAAGAAA","GGCTGGGCGCAGTGGCTCACACCTGTAATCCCAGCACTTAGGGAAGCTGAGGCGAGTAGATCACCTGAGGTCAGGAGTTAGAGACCAGCCTGGCCATCATGGTGAAACCCCGTCTCTACTAAAGATACCAAAAATTAGCTGAGTGTGGTGCTGGGTGCCTGTAATCCCAGAAACTCAGGGTGCCTGTAATCCCAGCAACTCAGGGTGCCTTTAATCCCAGCAACTGAGGGTACCAGTAATCCCAGCAACTCAGGGTGTCTTTAATCCTAGCAACTGAGGGCACCTGTAATCCCAGCAACTCAGGAAGCTGAGACAGGAGAAGTACTTGAACCCAGAAGGCAGAGGTTGCAGTGAGCCGATATTGCACCATTGCACTCCAGTCTGGGCAACAAGAGTGAAACTCTGTCTCAAAAAAAAA"
"chr18","57837437","57837748","JH378115","16887097","16887400","43","40950340","GCTGGGCATGGTGGCTCACACCTGTAATCCCAGCACCTTGGGAGGCCGAGGTGGGTAGATCACCTGAGGTCAGGAATTCGAGACCAACCTGGCCAACATGGTGAAACCCCGTCTCTACTAAAAATACAAAAAAAAAAAAAAAAAAAAAAAAAGCTGGGCATGGTGGTGGGTACCTGTAATCCCAGCTACTCAGGAGTCCGAGGCAGGAGAATCGCTTGAACCTGGCAGGTGGAGGTTGCAGTGTGCCAGGATTGTGCCATTGCACTCCAGCCTGGGTGACAAGAGCAAAACTCCAACTCAAAACAAAAACAA","GCCGGGCACGGTGGCTCAAGCCTGTAATCCCAGCACTTTGGGAGGCCGAGGCGGGTGGATCACAAGGTCAAGAGATCGAGACCAACCTGGTCAACATGGTGAAACCCCATCTCTACTAAAAAATACAAAAAAAAAAAAAAAATTAGCTGGGCATGGTGGCGCGTGCCTATAATCCCAGCTACTCAGGAGGCTGAGGCAGGAGAATTGCCTGAACCTAGGAGGTGGAGGTTGCAGTGAGCCAAGATCATGCCATTGCACTCCAGCCTGGGTAACAAGAGCGAAACTCCATCTCAAAAAAAAAAAA"
"chr18","58257354","58257943","JH378118","18053084","18053501","263","40204270","GCCTGTAATCACAGCACTTAGGGGGGCCGAGGCAGGAGGATCACCTGAGGTCAGGAGTTCGAGACCAGCCTGGCCAACATGGTGAAACCCCGTCCCTACTAAAAATACAAAAATTGGCCGGACACATTGGCTCATGCCTGTAATCCCAGCACTTTGGGAGGCCGAGGCGGGTGGATCACCTGAGGTCAGGAGTTCAAGACCAGCCTGACCAACCTGGAGAAACCCTGTTTCTACTAAAAATACAAAATTAGCCAGGCATAGTGGCGCATGCCTGTAATCCCAGCTACTCGAGAGGCTGAGGCAGGAGAATCGCTTGAACCCGGAAGGTGGAGGTTGCGGTGAACCGAGATTGTGCCATTGCACTCCAGCCTGGGCAACAAGAGCAAAACTCCGTCTCAAAAACAAAACAAAACAAAACAAAAATTAACCCGGCGTGGAGGTGGATGCCTGTAATCCCAGCCACTTTGGGAGACTGAGGCAAGAGAATTGCTTGAACCCGGGATGTGGAGGCTGCAGTGACCCGAGATCACGCCATTGCATTCCAGCCTGGCAACAAGAGTAAGACTCCATCTCAAAAACAAGCAAACAAA","GGCTGGGCGCAGTGGCTCACACCTGTAATCCCAGCACTTAGGGAAGCTGAGGCGAGTAGATCACCTGAGGTCAGGAGTTAGAGACCAGCCTGGCCATCATGGTGAAACCCCGTCTCTACTAAAGATACCAAAAATTAGCTGAGTGTGGTGCTGGGTGCCTGTAATCCCAGAAACTCAGGGTGCCTGTAATCCCAGCAACTCAGGGTGCCTTTAATCCCAGCAACTGAGGGTACCAGTAATCCCAGCAACTCAGGGTGTCTTTAATCCTAGCAACTGAGGGCACCTGTAATCCCAGCAACTCAGGAAGCTGAGACAGGAGAAGTACTTGAACCCAGAAGGCAGAGGTTGCAGTGAGCCGATATTGCACCATTGCACTCCAGTCTGGGCAACAAGAGTGAAACTCTGTCTCAAAAAAAAA"
"chr18","59255477","59255805","JH378228","5665092","5665424","52","53590385","GGTTGGGCGCAGTGGCTCACGCCTGTAACCCCAGCACTTTCGGAAGCTGAGGCAGGCGGATCACCTGAGGTCAGGGGTTCGAGACCAGCCCGGACAACGTGATTAAACCCTGCCTCTACTAAAAATACAAAAATTAGCGACTGTGGTGTTGGGCGCCTGTAATCGCAGCTACTTGGGAGGCTGAGGCATGAGAATTGCTTGAACCCAGGAGGCAGAGGTTGCAGTGAGCAGAGATTGCTCCATTGCACTCCAGCCTGGGCAACAAGAGCAGAACTCTGTCTCAAAATAAATAAATAAATAAATAAATAAATAAATAACAGAAAAGAAAA","GGCCGGGCGCGGTGGCTCAAGCCTGTAATCCCAGCACTTTGGGAGGCTGAGGCGGGTGGATCACGAGGTCAAGAGATCGAGACCATCCTGGTCAACATGGTGAAACCCTGTCTCTACTAAAAATACTAAAAATTAGCTGGGCATGGTGGCGTGTGCCTGTAATCCCAGCTACTCAGGAGGCTGAGGCAGGAGAATTGCCTGAACCCAGGAGGCGGAGGTTGCGGTGAGCCGAGATCGCGCCATTGCACTCCAGCCTGGGCAACAAGAGCGAAACTCTGTCTCAAAAAAAAAAAATAAATAAATAAAATAAAATAAAATAAAATAAAATAAAAT"
"chr18","59405673","59406877","JH378118","18053084","18053501","805","41352589","GGCTAGATGCGGTGGCTCATGCCTGTAATCCCAGCACTTTGGGAGGCCAAGGCAGGTGGATCACCTGAGGTCAGGAGTTTGACACCAGCCTGGCCAACATGTTGAAACCCTGTCTCCACTAAAAATACAAAAAAAGATTATCTGGGTTATTGTGGGATCTGGCCAGCAGCCCGCAATGCAATGGGGCTCTCTCTTTGTTCCCAGGCAGATTGGCAGGTTGAGAAATAATAGACACACACAAGATAGTGAAAGTTGGGTCCAGGGGGGTCACCGCCTTCTGGTCCCATGGTGCCAACAATGCACTGGATATACCAGCATTTATTATTAAGTTTAGTGAGGGCGGGGGTAGGTTAGTGAGGGATTTAGGGTCATTTGATTATGAGGTGAGATGGTCACATGGAAATGAAGTAATTCTTTAACGTAACATTTGTATGTAGAAGTACAGTACATTTGTATGTAGAAGTACAGTATACAGAGATAAGAATTTACAATATAGTGTGTGCATCAGTAATTTCTAACAGAGCCTTAAAACAGAAAGACAATCTTTCCATAATCTATGATTAGCAAGATATTAATCAGCAGTAACAATTGCAATGAAAGCTGGTTACAAACAGTCCATGGAAACAGGAGGTGAAGCTAGACAATCGGTTAGACCAGAAATTCTCAGAAGGGAATATGCCTTAACCCTAAAGAGGCCTAGAAGAGCCGTGGCAAGATGAGGGTGTTTATAGCCCTATCTTATCCATATGGACAGGCACCTCCCCATGCGTCCGTTTATAGGCTCTCCATGAGGGTCGCATTCCATTCCCAGAGCTATGAACATCTGCTTTTCTGGGATAGGAATCTTGGTGATGTGAAACCTCCCTGACTACACGTCCATTCATAGGATCTCTGCAGGGGGAAGCACATCACACACTGTTGGCTCGTTCTGGCAGTCCAACCTGGCATTGTGTCTTTACACAATCCTGCATGCAATTTTGTATTTACAATAATCAGGAGCATTTCATCTTTTATTCTGTAGCAATAGTTTCAGGGGGTCTCCCTACACTGGGTGTGGTGACGGGTACCTGTAATCCCAGCTACTCAGGAGGCTGAGGCAGGAGAATCACTTGAGCCTTAGAGGCAGAGGTTGCAGTGAGCTGAGATCAGACCATTGCACTCCAGCCTGGGCAACAAGAGCAAACCTCCGTCTCAAAAAAAAAAAA","GGCTGGGCGCAGTGGCTCACACCTGTAATCCCAGCACTTAGGGAAGCTGAGGCGAGTAGATCACCTGAGGTCAGGAGTTAGAGACCAGCCTGGCCATCATGGTGAAACCCCGTCTCTACTAAAGATACCAAAAATTAGCTGAGTGTGGTGCTGGGTGCCTGTAATCCCAGAAACTCAGGGTGCCTGTAATCCCAGCAACTCAGGGTGCCTTTAATCCCAGCAACTGAGGGTACCAGTAATCCCAGCAACTCAGGGTGTCTTTAATCCTAGCAACTGAGGGCACCTGTAATCCCAGCAACTCAGGAAGCTGAGACAGGAGAAGTACTTGAACCCAGAAGGCAGAGGTTGCAGTGAGCCGATATTGCACCATTGCACTCCAGTCTGGGCAACAAGAGTGAAACTCTGTCTCAAAAAAAAA"
"chr18","71500430","71500770","JH378228","5665092","5665424","54","65835338","GCTGGGTGCGGTGGCTCACGCCTGTAATCACAGCACTTTGGTAAGCCCGAGGCAGGTGGATCACCTGAGGTCAGGAGTTCGAGACCAGCCTGACCAACATGGTGAAACCCTTTCTCTACTAAAAATGCAAAAATTAGCTGGGCGTCATGGCGGGCGTCTGTGATCCCAGCTACTAGGGAGGCTAAGGCAGGAGAATTGCTTGAACCTGGGAGGCGGAGGTTGCAGTGAGCAGAGATTGCACCATTACACTCCAGCCTGGGCAACAAGAGCAAAACTCCATCTCAAAATAAATAAATAACTAAATAAATAAATAAAATGAAATTAAAAAGAAAGAAAGAAAA","GGCCGGGCGCGGTGGCTCAAGCCTGTAATCCCAGCACTTTGGGAGGCTGAGGCGGGTGGATCACGAGGTCAAGAGATCGAGACCATCCTGGTCAACATGGTGAAACCCTGTCTCTACTAAAAATACTAAAAATTAGCTGGGCATGGTGGCGTGTGCCTGTAATCCCAGCTACTCAGGAGGCTGAGGCAGGAGAATTGCCTGAACCCAGGAGGCGGAGGTTGCGGTGAGCCGAGATCGCGCCATTGCACTCCAGCCTGGGCAACAAGAGCGAAACTCTGTCTCAAAAAAAAAAAATAAATAAATAAAATAAAATAAAATAAAATAAAATAAAAT"
"chr19","1465612","1466244","JH378118","18053084","18053501","284","16587472","GGCTGGGGACGGTGGCTCAGGCCTGTAACCCCAGCACTTTGAGAGGACCAGGAGGGAGGATTGCTTGAGCCCAGGAGTCCGAGACCAGCCTGGGCAGCAAAGCAAGGCCCTGTCTCTACAAAAATACTTTAAAATTAGCCAAGTGTTGGCTGGGTGCGGTTGCTCATGCCTATAATCCCAGCACTTTGGGAGGCCGAGGTGGGTGGATCACCTGAGGTCAGGAGTTTGAGACCAGCCTGGCCAACATGGCAAAACCCCGTCTCTACTAAAAATACGAAAATTAGCCAGACGTGGTGGCTCATTCCTGTAATCCCAGCTACTCGGGAGGCTGAGGCAGGAGAATCGCTTGAACTCGCAAGGCGGAGGTTGCAGTGAGCCAAGATCATGCCATTGCATTCCAGCCTGGGTGACAGAGCAAAACTCCGTCTCAAAAAAAAAAAAAAAAAAAAAAAATTAGCCAGGCGTGGTGGTGGGCACCTGTAGTCCCAGCTACCCGGGAGGCTGAGGCAGGAGAATCGCTTGAGCCCGGGAGGCAGAGGTTACAGTGAGCCGAGATCGTGCCATTGCACTCCAGCCTGGGCAACAAGAGTGAAAATCCGTCTCAAAAAAATAAATAAATACAAAATAAAAAAA","GGCTGGGCGCAGTGGCTCACACCTGTAATCCCAGCACTTAGGGAAGCTGAGGCGAGTAGATCACCTGAGGTCAGGAGTTAGAGACCAGCCTGGCCATCATGGTGAAACCCCGTCTCTACTAAAGATACCAAAAATTAGCTGAGTGTGGTGCTGGGTGCCTGTAATCCCAGAAACTCAGGGTGCCTGTAATCCCAGCAACTCAGGGTGCCTTTAATCCCAGCAACTGAGGGTACCAGTAATCCCAGCAACTCAGGGTGTCTTTAATCCTAGCAACTGAGGGCACCTGTAATCCCAGCAACTCAGGAAGCTGAGACAGGAGAAGTACTTGAACCCAGAAGGCAGAGGTTGCAGTGAGCCGATATTGCACCATTGCACTCCAGTCTGGGCAACAAGAGTGAAACTCTGTCTCAAAAAAAAA"
"chr19","1761610","1762212","JH378118","18053084","18053501","248","16291474","GGCCGGGTGCGGTGGTTTACACCTGTAATCCTGGCATTTTGGGAGGCCGAGGCAGGAGTATCACCTCAGGTCAGGAGTTCAAGACCAGCCTGGCCAACATGGTGATACTCCGTCTCTACTAAAAATACAAAAATTGGCCGAGTGCAGTGGCTCACACCTGTAATCCCAGCACTTTGGGAGGCCGAGGCAGGTGGATCATGAGGTCAGGAGTTCGAGACCAGCCTGGCCAAGATGGTGAAACCCCGTCTCTACTAAAAATACAAAAATCAGCTGGGTGTGGTGGCGGGTGCCTGTAATCCCAGCTACTCGGGAGGCTGAGGCAGGAGAATTGCTTGGACCTGGGCAGCAGAGGTTGCAGCGAGCTGAGATGGCGCCACTGCACTCCAGCCTGGGCGACAGAGCGAGACTCTTGTCTCAGAAAAATAAAAAATAAAAAAATTAGCTGGGTGTGGTGGTGCGCACCTGTAATCCCAGCTACTCGGGAGGCTGAGGCAGGAGAATCGCTTGAATCTGGGAGGAGGAGGAGGTTGCAGTGAGCTGAGATAGTGCCAGTGCAGGCCAGCCTGGTCAACAAGAGTGAAACTCCGTCTCAGAAAAAAAAAA","GGCTGGGCGCAGTGGCTCACACCTGTAATCCCAGCACTTAGGGAAGCTGAGGCGAGTAGATCACCTGAGGTCAGGAGTTAGAGACCAGCCTGGCCATCATGGTGAAACCCCGTCTCTACTAAAGATACCAAAAATTAGCTGAGTGTGGTGCTGGGTGCCTGTAATCCCAGAAACTCAGGGTGCCTGTAATCCCAGCAACTCAGGGTGCCTTTAATCCCAGCAACTGAGGGTACCAGTAATCCCAGCAACTCAGGGTGTCTTTAATCCTAGCAACTGAGGGCACCTGTAATCCCAGCAACTCAGGAAGCTGAGACAGGAGAAGTACTTGAACCCAGAAGGCAGAGGTTGCAGTGAGCCGATATTGCACCATTGCACTCCAGTCTGGGCAACAAGAGTGAAACTCTGTCTCAAAAAAAAA"
"chr19","2871458","2872098","JH378118","18053084","18053501","282","15181626","GGCCGGGCGCGGTGGCTCACGCTTGTAATCCCAGCACTTTGGGAGGCCTAGGTAGTGGATCACCTGAGGTCAGGAGTTTGAGACCAGCCTGGCCAACATGGGGAAACCCAGTCTCTACTAAAAATACAAAAATGAGGCCGGGTGCAGTGGCTCATGCCTGTAGTCTCAACACTTTGGGAGACCAAGGCAGGCGGATCACCTGAGGTCAGGAGTTCAAGCCCAACCTGGCCAACATGGTGAAACCCTGCCTCTTCTAAAAATACAAAAATTAGCCAGGTGTGGTGGCATGTACCTGCAATCCCAGCTGCTTAGGAGTTCGAGATAGAAGGATTGCCTGAACCTGGGAGGCGGAGGTTGCAGTGAGCTGAGATCATGCCATTGCACTCCAGCCTGGGTGACAGAGACCCTGTCTCACACACACACACACAAATTATATATATATATATATATATACACACACACACACACGCACACACAAATTGGCCAGGCGTGGTGGCGGGTGCCTATAATTCCAGCTACTTGGGAGGCTGAGGCAGGAGAATGTCTTGAACCCGGGAGGTGGAGGTTGCAGTGAGCCGAGATTGCGCCACTGCACTTTAGCCTGGACGACAAGAACAAAACTCCATCTCAAAAAAACGAAA","GGCTGGGCGCAGTGGCTCACACCTGTAATCCCAGCACTTAGGGAAGCTGAGGCGAGTAGATCACCTGAGGTCAGGAGTTAGAGACCAGCCTGGCCATCATGGTGAAACCCCGTCTCTACTAAAGATACCAAAAATTAGCTGAGTGTGGTGCTGGGTGCCTGTAATCCCAGAAACTCAGGGTGCCTGTAATCCCAGCAACTCAGGGTGCCTTTAATCCCAGCAACTGAGGGTACCAGTAATCCCAGCAACTCAGGGTGTCTTTAATCCTAGCAACTGAGGGCACCTGTAATCCCAGCAACTCAGGAAGCTGAGACAGGAGAAGTACTTGAACCCAGAAGGCAGAGGTTGCAGTGAGCCGATATTGCACCATTGCACTCCAGTCTGGGCAACAAGAGTGAAACTCTGTCTCAAAAAAAAA"
"chr19","2912949","2913566","JH378118","18053084","18053501","268","15140135","GGCTGGGCGTGGTGGCTCACACCTGTAATCCCAGCACTTTGGGAGGCCAAGGTGGAGGGACTGCCTGAAGCCAGGGGTTCGAGACCAGCCTGGCCAACATGGTGAAACCCTGTCTCTACTAAAAATAGAAAAATTAAGGCCGGGCGCGGTGGCTCATGCCTGTAATCCCAGCACTTTGGAAGGCCGAGGCGGGCGGATCACTTGAGGTCGGGAGTTCAAGACCAGCCTGACCAACATGGAGAAACCCTGTCTCTACTAAAAATACAAAATTAGCCAGGGTGGTGGCGCATGCCTGTAATCCCAGCTACTTGGGAGGCTGAGGCAGGAGAATCGCTTGAACCCGGGAGGTGGAGGTTGCAGTGAGCTGAGATCGCACCATTGCACTCCAGCCTGGGCAACAAGAGCAAAACCACGTCTCAAAAAAAATAAAAATAAAAATAAAAAAATTAGCTGGGTGTGGTGGCAGGCGCCTGTAGCTGCTTGGGAGGCTGAGACAGGAGAATTGCTTGAACCTGGGAGGCGGAGGTTGCAGTGAGCTGAGACCGTGCCATTGCACTCCAGGCTGGGCAAGAAGAGCAAAACTCTATCCTTCCCCCACTCCAAAAAAAAAAAAAAAAA","GGCTGGGCGCAGTGGCTCACACCTGTAATCCCAGCACTTAGGGAAGCTGAGGCGAGTAGATCACCTGAGGTCAGGAGTTAGAGACCAGCCTGGCCATCATGGTGAAACCCCGTCTCTACTAAAGATACCAAAAATTAGCTGAGTGTGGTGCTGGGTGCCTGTAATCCCAGAAACTCAGGGTGCCTGTAATCCCAGCAACTCAGGGTGCCTTTAATCCCAGCAACTGAGGGTACCAGTAATCCCAGCAACTCAGGGTGTCTTTAATCCTAGCAACTGAGGGCACCTGTAATCCCAGCAACTCAGGAAGCTGAGACAGGAGAAGTACTTGAACCCAGAAGGCAGAGGTTGCAGTGAGCCGATATTGCACCATTGCACTCCAGTCTGGGCAACAAGAGTGAAACTCTGTCTCAAAAAAAAA"
"chr19","3601333","3601668","JH378148","10302642","10302970","47","6701309","GCTGGGCGTGGTGGCTCACACCTGTAATCCCAGCACTTTGGGAGGCTGAGGTGGGCGGATCACGTGAGGTCAGGAGTTCCAGACTAGCCTGGCCAACATGGGGAAACCCCATCTCTGCTAAAAATAAAAAATTTAGCCGAGTGTGGTGGTGGGTGCCTGTAATCCCAGCTACTCAGGAGGCCGAGGCAGGAGAATTGCTTGAACCCAGGAGGCAGAGGTTGCAGTGAGCCGAGATCACGCCATTGCACTCCAGCCTGGATGACAACAGTGAGACTCCAACTCAAAAAATAATAATAATAATAATAATAATAATAAAATAAAACAATAAAAAAAAAA","GGCCGGGCGCGGTGGCTCAAGCCTGTAATCCCAGCACTTTGGGAGGCCGAGGCGGGTGGATCACGAGGTCAAGAGATCGAGACCATCCTGGTCAACATGGTGAAACCCCGTCTCTACTAAAAATACAAAAAATTAGCTGGGCATGGTGGTGGGTGCCTGTAATCCCAGCTACTCAGGAGGCTGAGGCAGGAGAATTGCCTGAACCCAGGAGGCGGAGGTTGCGGTGAGCCGAGATCGCGCCATTGCACTCCAGCCTGGGTAACAAGAGTGAAACTCTGCCTCAAAAAAAAAAAATAAAATAAAATAAAATAAAATAAAATAAAATAAAA"
"chr19","4440800","4441421","JH378118","18053084","18053501","276","13612284","GGCTGGGTGCGGTGGCTCATGCCTGTAATCCCAGCACTTTGGGAGGCCAAGCGGGCAGATCAACTGAGGTCAGGAGTTCGAGACCAGCCTGGCCAACATAGTAAAACCCTGTTTCTACTAAAAAAAAAAAAAAAAAAAAAAAAAAAATTGGCTGGGCGCAGTGGCTCACGCATGTAATCCCTGCACTTTGGGAGGCCAAGGCAGGTGGATCACCTGAGGTCAGTAGTTTGAGACCAGCCTGACCAACGTGGAGAAACCCCATCTCTACTAAAAATACAAACAAAAAAAACAAAAAACAAAAAAAACCGGGTATGGTGGTACATCCCTGTAATCCCAGCTCCTCGGGAGGCTGAGGCAGGAGAATCACTTGAACCCGGGAGGCGGAGGTTGCACTGAGCCGAGATTGCGCCACTGCACTCCAGCCTGGGCGATAGAGCGAGACTCCCTCTTAAATAATGATTATAATTGCCAGGTGTGGTGGCGGGTGCCTGTAATCCCAGCTACTTGGGAGGCTGAGGCAGGAGAATCGTTTGAATCCAGGAGGAGGAGGTTGCAGTGAGCCGAGATGGTGCCACAGCACTCCAGCCTGGGTGACAAGAGTGAAACCCCATTACAAACAAAA","GGCTGGGCGCAGTGGCTCACACCTGTAATCCCAGCACTTAGGGAAGCTGAGGCGAGTAGATCACCTGAGGTCAGGAGTTAGAGACCAGCCTGGCCATCATGGTGAAACCCCGTCTCTACTAAAGATACCAAAAATTAGCTGAGTGTGGTGCTGGGTGCCTGTAATCCCAGAAACTCAGGGTGCCTGTAATCCCAGCAACTCAGGGTGCCTTTAATCCCAGCAACTGAGGGTACCAGTAATCCCAGCAACTCAGGGTGTCTTTAATCCTAGCAACTGAGGGCACCTGTAATCCCAGCAACTCAGGAAGCTGAGACAGGAGAAGTACTTGAACCCAGAAGGCAGAGGTTGCAGTGAGCCGATATTGCACCATTGCACTCCAGTCTGGGCAACAAGAGTGAAACTCTGTCTCAAAAAAAAA"
"chr19","5462237","5462567","JH378255","1377129","1377437","56","4085108","GACCAGGTGCGGTGGCTCACGCCTGTCATTCCAGCACTTTGGGAGGCCGAGGGGGGCGTGGATCACTTGAGGTCAGGAGTTCAAGACCAGCCTGACCAACATGGTGAAACTCCGTCTCTACTAAAAATACAAAAATTAGCCAGGTGTGGTGGCACATGCCTGTAATCCCAGCTACTTGGGAGGCTGAGGCAGGAGAATCACTTGAACCTGGGAGATGGAGGTTTCATTCAGTGAGCTGAGATTGCACCATTGCACTCCAGCCTGGGTGACAAGAACGAAACTCTGTCTCAGAACACACACACACACACACACACACACACCCCAGAAAAAA","GGCCTGGCGTGGTGGCTCACGCCTGTAATCTCAGCACTTTGGGAGGCCAAGGTGGGTGGATCACCTGAGGTCAGGAGTTCAAGACCAGCCTGGCCAACATGGTGAAACCCCGTCTCTACTAAAAATACAAAAATTAGCTGGGTGTGGTGGCAGACACCTGTAATTCCAGCTACTTGGGAGGCTGAGGCAGGAGAATAGCTTGAACCTGGGAGGTGAGGGTTGCAGTGAGCCGAGATCGCACCATTTTACTCCAACCTGGGCAACAAGAGCGAAACTCCGTCTCAAAATCCAAACAAACCAAAACAAAAA"
"chr19","8011731","8012413","JH378118","18053084","18053501","321","10041353","GGCCGGGTACAGTGGCTCACTCCTGTAATCCCAGAACTTTGGGAGACCGAGGTGGGGGGATCACTTGAGGTCAGGAGTTCGAGACCACCCTGGCCAATATAGTGCTAAACCCCATCTCTACTCAAAATACAAAAAAAAAAAAAAAAAAAAAAAAAAAGCAAAACCCAGGCTGGGCACAGTAGCTCATACCTGTAATCCCAGCACTTTGGGAGGCTGAGGTGGGTAGATCATGAGGTCAGGAGTTCGAGACCAGCCTGACCAACATGGTGAAACCCCGTCTCTACTAAAAATACAAAAATTAGCCGGGCATGGTGGTGCGTGCCTGTAATCCCAGCTACTCAGGAGGCTGAGGCAGGAGAATCGCTTGAAGCTGGGAGGCAGAGGTTGCAGTGAGCCGAGATCGTGCTACTGTACTCCAGCCTGGGCAACAGGGCGACAGAGCAAGACTCTGTCTCAAAAAAAAAAAAAAAAAAAAAAAAAAGCAAAACCCCATCTCTACTAAAAATACAAAAAATTAGCCAGGCATGGTGGCATGTGCCTGTAATCCCAGCTACTCGAGAGGCTGAGGCAGAAGAATCACTTGAACCCAGGAGGCAGAGGTTGCAGCGAGCCAAGATTGTGCCATTGCACTCCAATCTGGGTGACAAGAGTAAAATCCTGTCTCAAAAAAATAAAAAATAAAA","GGCTGGGCGCAGTGGCTCACACCTGTAATCCCAGCACTTAGGGAAGCTGAGGCGAGTAGATCACCTGAGGTCAGGAGTTAGAGACCAGCCTGGCCATCATGGTGAAACCCCGTCTCTACTAAAGATACCAAAAATTAGCTGAGTGTGGTGCTGGGTGCCTGTAATCCCAGAAACTCAGGGTGCCTGTAATCCCAGCAACTCAGGGTGCCTTTAATCCCAGCAACTGAGGGTACCAGTAATCCCAGCAACTCAGGGTGTCTTTAATCCTAGCAACTGAGGGCACCTGTAATCCCAGCAACTCAGGAAGCTGAGACAGGAGAAGTACTTGAACCCAGAAGGCAGAGGTTGCAGTGAGCCGATATTGCACCATTGCACTCCAGTCTGGGCAACAAGAGTGAAACTCTGTCTCAAAAAAAAA"
"chr19","8026835","8027736","JH378118","18053084","18053501","522","10026249","GCGCGGTGGCTCATGCCTGTAAACCCAGCACTTTGGGAGGCTGAGGTGGGTGGATCACCTGAGGTCAGGAGTTTGAGACCAGCCTGGCCAATATGGTGAAACCCGTCTCTACTAAAACATACAAAAATTAGGCTGGGCGCGGTGGCTCATGCCTTTAATCCCAACACTTTGGGAGGCCGAGGCGGGCGGATCACGAGGTCAGGAGTTTGAGACCATCCTGGCTAACATGGTGAAAGCCCGTCTCTACTAAAAATATAAAAATTAGCTGGGCGTGGTGGTGGGCACCTGGAGTCCCAGCTACTTGGGAGGCTGAGGCAGGAGAATGGCGTGAACCCGGGAGGCGGAGCTTGCAGTGAGCCAGGATCACGCCACTGCACTCCAGCCTGGGCGACAGAGCGAGACACCGTCTCAAAAAAAAAACAACAAAAATTAGCCAGGCATGGTGGTGGGCGCCTTTTTTTTTTTTTTTTTCAGAGTCTCACTCTGTCACCCAGGCTGGAGTGCAGTGGCTCAATCTCGGTTCACTGCAACCTCCGCCTCCCAGGTTCAAGCGATTCTCCTGCCTCAGCCTCCCGAATAACTGGGATTACAGGCACCCGCCACTACAACCAGCTAATTTTTGTATTTTTAGTAGAGATGGGGTTTCGCCATGTTGGCCAGGATGGTCTTGATCTCTTGACCTCGTGATCCACCCTCCTTGGCCTCTCAAAGTGCTGGGATTACAGGTGTGAGCCACTGTTCCCAGCTGATAGTGGGCACTTTTAATCCCAGCTACTCCGGAGGCTGAGGCAGGAGAATTGCTTGAACCCAGGAGGTGGAGGTTGCAGTGAGCCAAGATCGCGCCATTGCACTCCAGCCTGGGTGACAATAGCAAAACTCTGTCTCAATGAAACAAAACAAAA","GGCTGGGCGCAGTGGCTCACACCTGTAATCCCAGCACTTAGGGAAGCTGAGGCGAGTAGATCACCTGAGGTCAGGAGTTAGAGACCAGCCTGGCCATCATGGTGAAACCCCGTCTCTACTAAAGATACCAAAAATTAGCTGAGTGTGGTGCTGGGTGCCTGTAATCCCAGAAACTCAGGGTGCCTGTAATCCCAGCAACTCAGGGTGCCTTTAATCCCAGCAACTGAGGGTACCAGTAATCCCAGCAACTCAGGGTGTCTTTAATCCTAGCAACTGAGGGCACCTGTAATCCCAGCAACTCAGGAAGCTGAGACAGGAGAAGTACTTGAACCCAGAAGGCAGAGGTTGCAGTGAGCCGATATTGCACCATTGCACTCCAGTCTGGGCAACAAGAGTGAAACTCTGTCTCAAAAAAAAA"
"chr19","9069244","9069863","JH378118","18053084","18053501","266","8983840","GGCCGGGCACGGTGGCTCATTCCTGTAGTCTCTGTACTTTAGGAGGCTGAGGTGGGTGGATCACTTGAGGTCAGGAGTTCCAGACCAGTCTGGCCAAAATGGTGAAACCCCGTCTGTACTAAAAATACAAAAAAAAAGGCCGGGCGCGGTGGCTCACGCCTGTAATCCCAGCACTTTGGGAGGCTGAGGTGGGTGGATCACAAGGTCAGGAGATTGAGACCATCCTGGCTAACATGGTGAAACCCCGTCTCTACTAAAAATACAAAAAATTAGCTGAGTGTGGTAGCAGGCACCTGTAATCCCAGCTACTCAGGAGGCTGAGGTGGGAGAATGGCATGAACCCAGGAAGCAGAGCTTGCAGTGAGCTGAGATCATGCCACTGCACTCCAGCCTGGGTGACAGAGCGAGACTCCATCTCAAAAAAAAAAAATACAAAAAAATTAGCCAGGCGTAGTGGTGCATGCTTGTAGTCTCGGCTACTCAGGAGACTGACGCAGGAGAATCACTTGAACCCAGGAGGCGGAGGTTGCAGTGAGCCGAAATTATGCCATTGCACTCCAGCCTGGGAGACAAGAACAAAACTCTATCTCAAAAACCAACCAACCAAACAAACAAAAAAA","GGCTGGGCGCAGTGGCTCACACCTGTAATCCCAGCACTTAGGGAAGCTGAGGCGAGTAGATCACCTGAGGTCAGGAGTTAGAGACCAGCCTGGCCATCATGGTGAAACCCCGTCTCTACTAAAGATACCAAAAATTAGCTGAGTGTGGTGCTGGGTGCCTGTAATCCCAGAAACTCAGGGTGCCTGTAATCCCAGCAACTCAGGGTGCCTTTAATCCCAGCAACTGAGGGTACCAGTAATCCCAGCAACTCAGGGTGTCTTTAATCCTAGCAACTGAGGGCACCTGTAATCCCAGCAACTCAGGAAGCTGAGACAGGAGAAGTACTTGAACCCAGAAGGCAGAGGTTGCAGTGAGCCGATATTGCACCATTGCACTCCAGTCTGGGCAACAAGAGTGAAACTCTGTCTCAAAAAAAAA"
"chr19","9785992","9786608","JH378118","18053084","18053501","261","8267092","GGCCGGGAACGGTGGCTCACACCTATAATCCCAGCACTTTGGGAGGCCGAGGCAGGTGGATCACCTGAGGTCAGGAGTTCAAGACCAGCGTGGCCAACATAATGAAACCCCATCTTGGCCGGGTGCGGTGACTCACGCCTGTAATCCCAGCACTTTGGGAGGCCAAGGCGGGTGGATCACGAGGTCAGGGGATCGAGACCATCCTGGCTAACACAGTGAAACCCTGTCTCTACTAAAAATACAAAAAAATTAGCTGGGCATGGTGGCGGACGCCTGTAGTCCCAGCTACTCGGGAGGCTGAGGCAGGAGAATGGTGTGAACCTGGGAGGCAGAGCTTGCAGTGAGCCGAGATTGCGCCACTGCACTCCAGCTTGGGTGACAAAGTGAGACTCCATCTCAAAAAAAAAAAAAGAAACCCCATCTCTACTAAAAATACAAAAAATTTGCTGGGTGTGGTTGTGGGCACCTGTAATCCCAGCTACTTGGGAGGCTGAGGCAGGAGAATCACCTGAACCCAGGAGGCAGAGGTTGCAGTGAGCCGAAACAGTGCCATTGCACTCCAGCCTGGGCAACAAGAGTGAAACTCAATCTCAAAAAAAAAAAAAAAAGTACAAAAA","GGCTGGGCGCAGTGGCTCACACCTGTAATCCCAGCACTTAGGGAAGCTGAGGCGAGTAGATCACCTGAGGTCAGGAGTTAGAGACCAGCCTGGCCATCATGGTGAAACCCCGTCTCTACTAAAGATACCAAAAATTAGCTGAGTGTGGTGCTGGGTGCCTGTAATCCCAGAAACTCAGGGTGCCTGTAATCCCAGCAACTCAGGGTGCCTTTAATCCCAGCAACTGAGGGTACCAGTAATCCCAGCAACTCAGGGTGTCTTTAATCCTAGCAACTGAGGGCACCTGTAATCCCAGCAACTCAGGAAGCTGAGACAGGAGAAGTACTTGAACCCAGAAGGCAGAGGTTGCAGTGAGCCGATATTGCACCATTGCACTCCAGTCTGGGCAACAAGAGTGAAACTCTGTCTCAAAAAAAAA"
"chr19","9897689","9898264","JH378206","6546474","6546861","233","3351215","GCCAGGCACGGTGGCTCACACCTGTAATCCCAGCACTTTGGGAGGCCAAGGTGGGTGGATCACCTGAGGTCAGGAGTTCAAGACCAGCCTGACCAACATGGTGAAACCCAGGGCTCACACCTGTAATCCCAGCGCTTTGGGAGGCTGACGCGGGCAGATCACGAGGTCAGGAGATCGAGACCATCCTGGCTAACATGGTGAAACCCCGTCTCTACTAAAAATACAATAATTAGCTGGGCATGGTGGTGGGTGCCTGCAGTCCCAGCTACTTGGGAAGCTGAGGCAGGAGAATGGCGTGAACCCAGGAGGTGGAGCTCTCAGTGAGCTGAGATTGCATCACTGCACTTCCAGCCTGGGTGACAGAGCAAGACTCTGTCTCAAAAAAAAAAAAAAAAAAAAAAAAAATTAGCCAGGTGTGATGGCAGGCACCTGTAATCCCAGCTACTTAGGAGGCTGAGGCAGGAGAACCCAGGAGGCAGAGGTTGCAGTGAGCCAAGATCGCGCCATTGCACTCCAGCCTGGGTGACAAGAGCAAAATTCCATCTCAAAAAAAAAAAAAAAGAAGAAAAAGAAGAA","GGCCACACATGGTGGCTAACGCCTGTAATCCCAGCACTTTGGGAGGCCAAGTCGGGTGGATCATGAGGTCAGGAGACCAAGACCATCCTGGCCAAATGGTGAAACCCCGTCTCTACTAAAAATACAAAAATTAGCTGGGCATGGTGGCGTGTGCCTGTAATCCCAGCTACTCAGGAGGCTGAGGCAGGACAATTGCCTGAACCCAGGAGAATTAGCTGGGCATGGTGGCGTGTGCCTGTAATCCCAGCTACTCAGGAGGCTGAGGCAGGACAATTGCCTGAACCCAGGAGGCGAAGGTTGCGGTGAGCCGAGATTGTGCCATTGCACTCCAGCCTGGGTAACAAGAGCGACACTCTGTCTCAAAAAAAAAAAAAAAAAAAAAAAAAAA"
"chr19","10210761","10211695","JH378118","18053084","18053501","553","7842323","GGCCGGGTGTGGTGGCTCATGCCTGTAATCCCAGGCATGATTTGGGAGGCCGAGGGAGGCAGATCACCTGAGGTCAGGAGTTTTTTTGTTTTGTTTTGTTTTGTTTTTGAGACAGAGTCTTGTTCTGTTGCCCAGGCTGGAGTGCAATGATGTGATCTCGACTCACTACAACCTCCACCTCCTGAGTTCAAGCGATTCTGCTGCCTCAGCCTCCCGAGTAGCTGGCATTACAGGCATGTGCCACCAAGCCTGGCTAATTTTTGTATTTATAGTAGAGACGGGGGTTTCACCATGTTGATCAGGCTGGTGTCGAACTCCTGGCCTCAAGTGATCCGCTCGCCTTGGCCTCCCAAAATGCTGGGATTACAGATGTGAGCCACTGTGCCCAGCCAAGGTCAAGAGTTTGAAACCAGCCTGGCCAGCATGGTGAAACCCTATCTCTACTAAAAATACAAAATCAGTCCATGTGCCTAATTTTGGGATCACACCTGGGATCATGCCTGCAATCCCAGCACTTTGGGAGGCCAAGGCGGGTGGGTCATGAAGTCAGGAGTTCAAGACCAGCCTGGCCAACATGGTGAAACCCTGTCTCTACTAAAAATACAAAAGTTAGCTGGGCGTGGTGGCACGCACCTGTAGTCCCAGCTACTAGGAAGGCTGAGGCAGGAGAATTCTTGAACCCGGGTGATGGAGGTTGCAGTGAGCCGAGATTGCGCCACTGCACTCCAGCCTGGGCAACAGAGTGAGACTCTGTCTAAAAAAAAAATTAGTCAGGCGTGGTGGTGAGCACCTGTAATCACAGCTACTGGGGAGGCTGAGGCTGGAGAATTGCTTGAACCCGGGAGGCGGAGGTTGCAGTGAGCCAAGATCGCGCCTTTGCACTCCAGCCTGGGCAACAGGAGTGAAACTGCATCTCAAAAAAAAAAAAAAAAAAA","GGCTGGGCGCAGTGGCTCACACCTGTAATCCCAGCACTTAGGGAAGCTGAGGCGAGTAGATCACCTGAGGTCAGGAGTTAGAGACCAGCCTGGCCATCATGGTGAAACCCCGTCTCTACTAAAGATACCAAAAATTAGCTGAGTGTGGTGCTGGGTGCCTGTAATCCCAGAAACTCAGGGTGCCTGTAATCCCAGCAACTCAGGGTGCCTTTAATCCCAGCAACTGAGGGTACCAGTAATCCCAGCAACTCAGGGTGTCTTTAATCCTAGCAACTGAGGGCACCTGTAATCCCAGCAACTCAGGAAGCTGAGACAGGAGAAGTACTTGAACCCAGAAGGCAGAGGTTGCAGTGAGCCGATATTGCACCATTGCACTCCAGTCTGGGCAACAAGAGTGAAACTCTGTCTCAAAAAAAAA"
"chr19","10485431","10486007","JH378118","18053084","18053501","237","7567653","GGCCGGGCGCAGTGGCTCATGCCTAATCCCAAGACTTTCAGAGGCTGAGGCAGGTGGATCACCTGAGGTCAGGAGCTCAAGACCAGCCTGGCTAACATTGTGAAACCGCGTCTCTACTAAAAATCAAAATTGGCCGGGCACGGTGGCTCACACCTGTAATCCCATCCCTCTGGGAGACCGAGGCGGGCAGATCACCTAAGGTCAGGAGTTCGAGACCAGCCTGACCAACATGGAGAAAACCCTTCTCTGCTAAAAATACAAAATTAGCCGGGCGTGGTGGCGCATGCCTGTAACCTCAGCTACTCGGGAGGCTGAGGGAAAATCGCTTGAACCTGCCAGGTGGAGGTTGCAGTGAGCCGAGATCGAGCCATTGCACTCCAGCATGGGCAACGAAAGCGAAACTCCATCTCAAAAAAAAAAAAAATTAGCTAGGCGTGGTGGCGCGTGCCTGTATTCCCAGCTACTCAGGAGGCTGAGACAGGAGAATCACTTGAACCTGGGAGGCAGAGGTTGCAGTGAGCCAAGATTGCACCATTGCACTCCAGCCTGGGCAACACGAGCAAAACTCTGTCTCAAA","GGCTGGGCGCAGTGGCTCACACCTGTAATCCCAGCACTTAGGGAAGCTGAGGCGAGTAGATCACCTGAGGTCAGGAGTTAGAGACCAGCCTGGCCATCATGGTGAAACCCCGTCTCTACTAAAGATACCAAAAATTAGCTGAGTGTGGTGCTGGGTGCCTGTAATCCCAGAAACTCAGGGTGCCTGTAATCCCAGCAACTCAGGGTGCCTTTAATCCCAGCAACTGAGGGTACCAGTAATCCCAGCAACTCAGGGTGTCTTTAATCCTAGCAACTGAGGGCACCTGTAATCCCAGCAACTCAGGAAGCTGAGACAGGAGAAGTACTTGAACCCAGAAGGCAGAGGTTGCAGTGAGCCGATATTGCACCATTGCACTCCAGTCTGGGCAACAAGAGTGAAACTCTGTCTCAAAAAAAAA"
"chr19","10538873","10539199","JH378118","15020968","15021286","46","4482095","GCTGGGCGCGGTGGCTCACGCCTGTAATCCCAGCACTTTGGGAGGCTGAGGCAGGCAGATCACCTGAGGTCAGGAGTTCAAGACCAGCCTGGTTAACACAGTGAAACCCCCGTCTCTACTAAAAATACAAAAACAAAAATTAGCCGGGTGTGGTGGCGGGCGCCTGTAATCCCAGTTACTCGGGAGGCTGAGGCAGGAGAATCGCTTGAACCCGGGAGGCGGAGGTTGTGGTGAGCCGAGATTGCCATTGCACTCCAGCCTGGGCAAAAAGAGCGAAACTCCATCTAAAACAAACAAACAAACAAACAAACAAAAAATAGAAAAGAA","GCCGGGCGCGGTGGCTCAAGCCTGTAATCCCAGCACTTTGGGAGGCTGAGGCGGGTGGATCCCGAGGTCAAGAGATCGAGACCATCCTGGTCAACATGGTGAAACCCCGTCTCTACTAAAAATACAAAACATTAGCTGGGTATGGTGGCGCGTGCCTGTAATCCCAGCTACTCAGGAGGCTGAGGCAGGAGAATTGCCTGAACCCAGGAGGCGGAGGTTGCGGTGAGCTGAGATCGCGCCATTGCACTCCAGCCTGGGTAACAAGAGCGAAACTTCCATCTCAAAAACAAACAAACAAACAAACAAACAAAAAACAAAC"
"chr19","10973032","10973651","JH378118","18053084","18053501","265","7080052","GGCTGGACGTGGTGGCTCACGCCTGTAATCCCAACACTTTGGGAGACCAAGGCAGGTGGATCGCCTGAGGTTAGGGGTTCGAGACCAGCCTGACCAACATGGTGAAACCCCATCTCTACTAATAATAAAAAAATTAGGACCAGGCTTGGTGGCTCATGCCTGTAATTCCAACACTTTGGGAGGCCAAGGCGAGTGGATAACTTGAGGTCAGGAGTTTGAGACCAGCCTGGCCAACATGGTGAAACCTCATCTCTACTAAAAATACAAAAATTAGCCGGCATGGTGGCGGGCACCCGTAATCCCAGCTACTCGGTGTGGGGGCTGGGACAGGAGAATCGCTTGAACCCAGGAGGTGGAGGTTGCCGTGAGCTAAGATTGCGCCACTGCACTCTAGTTGGGGCAACAGAGCGGACTCCGTCTCAAAAAAAAAAAAAAAATTAGCCGAGCGTGGTGGTGGACACCTGTAATCCCAGCTACTCAGGAGGCTGAGGCAGGAAAATTGAAATCGCTTAAACCTGGGAGGAGGAGGTTGCAGTGAGCCAAGATCGCACCATTGCACTCCAGCCTGGGCGACAAGAACAAAACTCCGTCTCCCCACTCCAAAAAAAAAAAAAAAAAAA","GGCTGGGCGCAGTGGCTCACACCTGTAATCCCAGCACTTAGGGAAGCTGAGGCGAGTAGATCACCTGAGGTCAGGAGTTAGAGACCAGCCTGGCCATCATGGTGAAACCCCGTCTCTACTAAAGATACCAAAAATTAGCTGAGTGTGGTGCTGGGTGCCTGTAATCCCAGAAACTCAGGGTGCCTGTAATCCCAGCAACTCAGGGTGCCTTTAATCCCAGCAACTGAGGGTACCAGTAATCCCAGCAACTCAGGGTGTCTTTAATCCTAGCAACTGAGGGCACCTGTAATCCCAGCAACTCAGGAAGCTGAGACAGGAGAAGTACTTGAACCCAGAAGGCAGAGGTTGCAGTGAGCCGATATTGCACCATTGCACTCCAGTCTGGGCAACAAGAGTGAAACTCTGTCTCAAAAAAAAA"
"chr19","11513769","11514351","JH378206","6546474","6546861","242","4967295","TCCCAGCACTTTGGGAGGCCGCGATGGGTGGATCACCTTAGGTCAGGAATTCGAGACCATCCTGGCCAACATGGTGAAACCCCGTCTCTACTAAAAACACAAAAATTAGGCCGGGCACGGTGGCTCACATCTGTAATCCCAGCACTTTGGGAGGCTGAGGTGGGCGGATCACAAGGTCAGGAGTTCAAGACCAGCCTGGCCAACATGGTGAAACCCTGTCTCTACTAAAAATACAAAAATTAACTGGGCATGGTGGCATGTGCCTGTAATCCCAGCTACTTGGGAGGCTGAGGCAGAAGAATTGCTTGAACCAGGGAGTCAGAGGTTATAGTGAGCTGAGATCGTGCGACTGCACTCCAGCCTGGTGACAGAGCGAGACTCCGTTTCAGGAAAAACAAACAAAACACAAAAATTAGCTGGGCATGGTGGCAGGCGCCTGTAATCCTAGCTACTTGGGAGGCTGAGGCAGGAGAATCGCTTGAACCCAGAAGGCAAAGGTTGCAGTGAGCTGAGATGATGCCATTGCACTCCAGCCTGGGCAACAAGTGAAACTCTGTCTCAAGAAAAAAAGTAAAAGAAAGAA","GGCCACACATGGTGGCTAACGCCTGTAATCCCAGCACTTTGGGAGGCCAAGTCGGGTGGATCATGAGGTCAGGAGACCAAGACCATCCTGGCCAAATGGTGAAACCCCGTCTCTACTAAAAATACAAAAATTAGCTGGGCATGGTGGCGTGTGCCTGTAATCCCAGCTACTCAGGAGGCTGAGGCAGGACAATTGCCTGAACCCAGGAGAATTAGCTGGGCATGGTGGCGTGTGCCTGTAATCCCAGCTACTCAGGAGGCTGAGGCAGGACAATTGCCTGAACCCAGGAGGCGAAGGTTGCGGTGAGCCGAGATTGTGCCATTGCACTCCAGCCTGGGTAACAAGAGCGACACTCTGTCTCAAAAAAAAAAAAAAAAAAAAAAAAAAA"
"chr19","11535200","11535780","JH378206","6546474","6546861","242","4988726","TCCCAGCACTTTGGGAGGCCGCGATGGGTGGATCACCTTAGGTCAGGAATTCGAGACCATCCTGGCCAACATGGTGAAACCCCGTCTCTACTAAAAACACAAAAATTAGGCCGGGCACGGTGGCTCACATTGTAATCCCAGCACTTTGGGAGGCTGAGGTGGGCGGATCACAAGGTCAGGAGTTCAAGACCAGCCTGGCCAACATGGTGAAACCCTGTCTCTACTAAAAATACAAAAATTAACTGGGCATGGTGGCATGTGCCTGTAATCCCAGCTACTTGGGAGGCTGAGGCAGAAGAATTGCTTGAACCAGGGAGTCAGAGGTTATAGTGAGCTGAGATCGTGCGACTGCACTCCAGCCTGGTGACAGAGCGAGACTCCGTTTCAGGAAAAACAAACAAAACACAAAAATTAGCTGGCATGGTGGCAGGCGCCTGTAATCCTAGCTACTTGGAGGCTGAGGCAGGAGAATCGCTTGAAACCCAGAAGGCAAAGGTTGCAGTGAGCTGAGATGATGCCATTGCACTCCAGCCTGGGCAACAAGTGAAACTCTGTCTCAAGAAAAAAAGTAAAAGAAAGAA","GGCCACACATGGTGGCTAACGCCTGTAATCCCAGCACTTTGGGAGGCCAAGTCGGGTGGATCATGAGGTCAGGAGACCAAGACCATCCTGGCCAAATGGTGAAACCCCGTCTCTACTAAAAATACAAAAATTAGCTGGGCATGGTGGCGTGTGCCTGTAATCCCAGCTACTCAGGAGGCTGAGGCAGGACAATTGCCTGAACCCAGGAGAATTAGCTGGGCATGGTGGCGTGTGCCTGTAATCCCAGCTACTCAGGAGGCTGAGGCAGGACAATTGCCTGAACCCAGGAGGCGAAGGTTGCGGTGAGCCGAGATTGTGCCATTGCACTCCAGCCTGGGTAACAAGAGCGACACTCTGTCTCAAAAAAAAAAAAAAAAAAAAAAAAAAA"
"chr19","12911527","12912140","JH378118","18053084","18053501","266","5141557","GGCCAGGCATGGTGGCTCATGCCTGTAATCCAGCACTTTGGTAGGCCAAGGTGGGTGGATGGATTACTTGAGGCCAGGAGTTCAAGACCAACCTGGCCAACATGGTGAAAACCCATCTCTATTAAAAATATAAAAGCTAGGCCAGGTGCGGTGGCTCACGCCTGTAATCCCAGCACTTTGGGAGGCTGAGGCGGGCGGATCACGAGGTCAGGAGATCGAGACCACTGTGAAACCCTGTCTCTACTAAAAATACAAAAAAAATTAGCTGGGTGGGGTGGCGGGTGCCTGTAGTCCCAGCTACTTGGGAGGCTGAGGCAGGAGAATGGCGTGAACCCGGGAGGCGGAGCTTGCAGTGAGCCGAGATCGCGCCACTGCACTCCAGCCTGGGCTACAGAGCAAGACTCCGTCTCAAAAAAAAAATAAATAAATAAATAAAAATAAAAACTAACTGGGCATGGTGGTGTGCACCTGTAATCCCAGCTACTCGGGAGGCTGAGACAGGAGAATTGCTTGAACCTGGGAGGTGGAGGTTGCAGTGAACCAAGATGATGCCATTGCACTCCAACCTGGGCAACAAGAGCAAAACTCCGTCTCAAAAAAAAAAAAAAAAAAAA","GGCTGGGCGCAGTGGCTCACACCTGTAATCCCAGCACTTAGGGAAGCTGAGGCGAGTAGATCACCTGAGGTCAGGAGTTAGAGACCAGCCTGGCCATCATGGTGAAACCCCGTCTCTACTAAAGATACCAAAAATTAGCTGAGTGTGGTGCTGGGTGCCTGTAATCCCAGAAACTCAGGGTGCCTGTAATCCCAGCAACTCAGGGTGCCTTTAATCCCAGCAACTGAGGGTACCAGTAATCCCAGCAACTCAGGGTGTCTTTAATCCTAGCAACTGAGGGCACCTGTAATCCCAGCAACTCAGGAAGCTGAGACAGGAGAAGTACTTGAACCCAGAAGGCAGAGGTTGCAGTGAGCCGATATTGCACCATTGCACTCCAGTCTGGGCAACAAGAGTGAAACTCTGTCTCAAAAAAAAA"
"chr19","13205284","13205895","JH378118","18053084","18053501","258","4847800","GCCAGGCGCAGTGGATTACGCCTGTAATCCCAGCGCTTTGGTATACCGAGGCGGGCAGATCGTCTGAGGTCAGGAGTTCAAGACCAGCCTGGAGAACATGGTGAAACCCCGTCTCTATTAAAAATACAGGCTGGGCGCGGTGGCTTACGCCTGTAATCTCAGCACTTTGGGAGGCCAAGGCGGGTGGATCACGAGGTCAGGAGATCGAGACCATCCTGGCTAACATGGTGAAACCCTGTCTCTACTGAAAATACAAAAAAATTAGTTGTGGTGGGTGCCTGTAATCCCAGCTACTCGGGAGGCTGAGGCAGGAGAATGGCGTGAACCCGGGAAGCAGAGATTGCAGTAAGCCAAGATCGCTCCACTGCACTCCAGCCTGGGCTACAGAGCAAGACTCCATCTCAAAAAAAAATAAATAAATAAAATAAAAAATTAGCCTGGCGTGGTGGCGCATGCCTGTAATCCCAGCTACTTGGGAGGCTGAGGCAGGAGAATTGCTTGAACCCAAGAGGTGGAGGTTGCAGTGAGTCGAGATTGAGCCATTGCCATCCAGCCTGGGCAACAAGAGTGAAACTCTGTCTCAAAAAAAAAGAGAGAGAAAAGAAAGTAAAA","GGCTGGGCGCAGTGGCTCACACCTGTAATCCCAGCACTTAGGGAAGCTGAGGCGAGTAGATCACCTGAGGTCAGGAGTTAGAGACCAGCCTGGCCATCATGGTGAAACCCCGTCTCTACTAAAGATACCAAAAATTAGCTGAGTGTGGTGCTGGGTGCCTGTAATCCCAGAAACTCAGGGTGCCTGTAATCCCAGCAACTCAGGGTGCCTTTAATCCCAGCAACTGAGGGTACCAGTAATCCCAGCAACTCAGGGTGTCTTTAATCCTAGCAACTGAGGGCACCTGTAATCCCAGCAACTCAGGAAGCTGAGACAGGAGAAGTACTTGAACCCAGAAGGCAGAGGTTGCAGTGAGCCGATATTGCACCATTGCACTCCAGTCTGGGCAACAAGAGTGAAACTCTGTCTCAAAAAAAAA"
"chr19","14119695","14120238","JH378206","6546474","6546861","206","7573221","ACCAGCCTGGCCAAAATGGTGAAACCCTGTCTCTACTAAAAATATTTAAAAATTGGCCAGGTGCGGTGGCTCACGCCTGTAATCCCAGCACTTTGGGAGGCCGAGGCGGGCGGATTACAAGGTCAGGAGATCGAGACCATCCTGACTAACATGGTGAAACCCCGTCTCTACTAAAAATACAAAAAATTGGCCGGGCGTGGTAGCGGGCGCCTGTAGTTCCAGCTACTCGGGAGGCTGAGGCAGGAGAATGGCGTGAACCCGGAAGGCAGAGCTTGCAGTGAGCCAAGATCGTGCCACTGCACTCCAGCCTGAGCGACAGAGCAAGACTCCATCTCAAAAAAAAAAAAAAAAAAAAAAAAAATTAAAAAATTAGCTGGGCGTGGTAGCCGGCACCTGTAATTCCAGCTACTCAGGAGGCTGGAGCACAAGAATCGCTTGAAACCAGGAGGCAGAGTTGTAGTGAGCCGAGATCGTGCCATTGCACTCCAGCCTGGGCATCAAGAGCGAAACTCCATCTCAAAAACAAAACAAAACAAAACAAAAA","GGCCACACATGGTGGCTAACGCCTGTAATCCCAGCACTTTGGGAGGCCAAGTCGGGTGGATCATGAGGTCAGGAGACCAAGACCATCCTGGCCAAATGGTGAAACCCCGTCTCTACTAAAAATACAAAAATTAGCTGGGCATGGTGGCGTGTGCCTGTAATCCCAGCTACTCAGGAGGCTGAGGCAGGACAATTGCCTGAACCCAGGAGAATTAGCTGGGCATGGTGGCGTGTGCCTGTAATCCCAGCTACTCAGGAGGCTGAGGCAGGACAATTGCCTGAACCCAGGAGGCGAAGGTTGCGGTGAGCCGAGATTGTGCCATTGCACTCCAGCCTGGGTAACAAGAGCGACACTCTGTCTCAAAAAAAAAAAAAAAAAAAAAAAAAAA"
"chr19","14268586","14269200","JH378118","18053084","18053501","260","3784498","GCTGGGCACGGTGGTTCACGCCTGTAATTCCAGCACTTTGGGAGGCTGAGGCGGGTGGATCACCTGAGGTCAGGAGTTTGAGACCAGCCTGGCTGACATGGTGAAACCCTGTCTCTACTAAAAATACAAAAAATTGGCCGGGCGCGGTGGCTCACGCCTGTAATCCCAGCACTTTGGGAGGCCGAGGTGGGCGGATCACGAGGTCAGGAGATGGAGACCATCCTGGCTAACACAGTGAAACTCCATCTCTACTAAAAATACAAAAAATTGGCCAGGCGTGGTGGCAGGCGCCTGTAGTCCCAGCTACTGGGGAGGCTGAGGCAGGAGAATGGCGTGAACTCGGGAGGCAGAGCTTGCAGTGAGCCGAGATCGTGCCACTGCACTCCAACCTGGGCAACAGAGCAAGACTCCGTCTCAAAAAAAACAAAAAACAAAAAAACAAAAATTAGCTGGGTGTGGTGGTGGGCACCTGTAATCTCAGCTACTCAGGAGGAGGAAAATCGCTTGAATCCGGGAAACAGAGGTTGCAGTGAGCCGAGATCACACCATTGCACTCCAGCCTGGGTAACAAGAGCAAAACTCTGTCTCAAAAAAATAATAATAATAAAATAACAA","GGCTGGGCGCAGTGGCTCACACCTGTAATCCCAGCACTTAGGGAAGCTGAGGCGAGTAGATCACCTGAGGTCAGGAGTTAGAGACCAGCCTGGCCATCATGGTGAAACCCCGTCTCTACTAAAGATACCAAAAATTAGCTGAGTGTGGTGCTGGGTGCCTGTAATCCCAGAAACTCAGGGTGCCTGTAATCCCAGCAACTCAGGGTGCCTTTAATCCCAGCAACTGAGGGTACCAGTAATCCCAGCAACTCAGGGTGTCTTTAATCCTAGCAACTGAGGGCACCTGTAATCCCAGCAACTCAGGAAGCTGAGACAGGAGAAGTACTTGAACCCAGAAGGCAGAGGTTGCAGTGAGCCGATATTGCACCATTGCACTCCAGTCTGGGCAACAAGAGTGAAACTCTGTCTCAAAAAAAAA"
"chr19","14639042","14639625","JH378118","18053084","18053501","244","3414042","GGCTGGGCATGGTGGCTCACACCTGTAATCCCAACACTTTTGGAAGCCAAGGTGGGAGGATCACTTGAGTCCAGGAGTTTGAGACCAGCCTGGGCAACATAGTGAGAACCTGTCTCTTCTTTTCTTTTCACTTTTTTTTTTTTTTTTTTTTTTTCGAGACAGAGTCTCACTCTATCACCCAGGCTAGAGTACAGTGGCACGATCTCGGCTCACAGCAACCTCTGCCTCCTGGGTTCAAGCGATTCTCCTGCCTCAGCCTCTTCAGTAGCTGGGATTACCTGCGCCCACCACCACACCCAGCTAATTTTTTTGTATTTTTAGTAGAGATGGTGTTTCACCATGTTGGCCAGACTGGTCTCGAACTCCTGACCTCAAGTGATCCGCCCGCCTTGGCCTCTCAAAGTGCTGAGATTACAGGTGTGAGCCACTGGGCGTGGTGGCAGGTGCCTGTAATGCCAGCTACTCAGGAGACTGAGGCAAGAGAATCGTTTGAACCTGGGAGGCAAAGATTACGGTGAGCCGAGATCGTGCCATTGCACTCCAGCCTGGGCGACAAGAGTGAAACTCTGTCTCAAAAAAAAAAA","GGCTGGGCGCAGTGGCTCACACCTGTAATCCCAGCACTTAGGGAAGCTGAGGCGAGTAGATCACCTGAGGTCAGGAGTTAGAGACCAGCCTGGCCATCATGGTGAAACCCCGTCTCTACTAAAGATACCAAAAATTAGCTGAGTGTGGTGCTGGGTGCCTGTAATCCCAGAAACTCAGGGTGCCTGTAATCCCAGCAACTCAGGGTGCCTTTAATCCCAGCAACTGAGGGTACCAGTAATCCCAGCAACTCAGGGTGTCTTTAATCCTAGCAACTGAGGGCACCTGTAATCCCAGCAACTCAGGAAGCTGAGACAGGAGAAGTACTTGAACCCAGAAGGCAGAGGTTGCAGTGAGCCGATATTGCACCATTGCACTCCAGTCTGGGCAACAAGAGTGAAACTCTGTCTCAAAAAAAAA"
"chr19","15534201","15534832","JH378118","18053084","18053501","265","2518883","CTGGGCGCAGTGGCTCACGCCTGTAATCCCAGCACTTTGGGGAGGCTGAGGCAGGTAGATCACCTGAGGTCAGGAGTTCGAGACCAGCCTGGCCAACATGGTGAAACCCTGTCTCTATTAAAAATACAAAAAAAAAAAAAAAATAGGCCGTGCGCGGTGGCTCATGCCTGTAATCCCAGCACTTCGGAAGGCTGAGGTGGATCGATCACAAGGTCAGGAGTTCGAGACCAACCTAGCCACCATGGTGAAACCCCGTCTCTACTAAAAATACAAAAATTAACTGGGAGTGGTGGTGGGCGCCTGTAATCCCAGCTACTCGGGAAGCTGACGCAGGAGAATCACTTGAACCCAGGAGGCGGAGGTTGCAGTGAGCCAAGATCACACCACTGCACTCCAGCCTGGGCAACAGAGCGAGACTCCATCTCAAAAAAATAAATAAATTTAAAAATACAAAAATTTAGCCAGGCTTGGTGGCGGGCCCCTGTAATCCCAGCTACTCGGGAGGCTGAGGCAGGAGAATCGCTTGAACCCGGGTGTTAGAGGTTGCAGTTAGCTGAGATCACACCATTGCACTCCAGCCTCGGCAACAAGAGCAAAACTCTGTCTCCAAAAAAAAAAAGAAAGAAAAAAAA","GGCTGGGCGCAGTGGCTCACACCTGTAATCCCAGCACTTAGGGAAGCTGAGGCGAGTAGATCACCTGAGGTCAGGAGTTAGAGACCAGCCTGGCCATCATGGTGAAACCCCGTCTCTACTAAAGATACCAAAAATTAGCTGAGTGTGGTGCTGGGTGCCTGTAATCCCAGAAACTCAGGGTGCCTGTAATCCCAGCAACTCAGGGTGCCTTTAATCCCAGCAACTGAGGGTACCAGTAATCCCAGCAACTCAGGGTGTCTTTAATCCTAGCAACTGAGGGCACCTGTAATCCCAGCAACTCAGGAAGCTGAGACAGGAGAAGTACTTGAACCCAGAAGGCAGAGGTTGCAGTGAGCCGATATTGCACCATTGCACTCCAGTCTGGGCAACAAGAGTGAAACTCTGTCTCAAAAAAAAA"
"chr19","15639264","15639622","JH378108","4185732","4186071","66","11453532","CTGGGCACAGTGGCTCACGCCTGTAATCCCAGCACTTTGGGAGGCCGAGGCGGGCAGATAACCTGAGGTCAGGAGTTCCAGACCAGCCTGGCCAACATGGCGAAACACCGTCTCTACTAAAAATAAAAATTAAAAAATAAAATTAGATGGGCGTGGTGGCGGGCGCCTGTAATCCCAGCTACTCCGGAGGCTGAGGCAGGAGAATCGCTTGAACCCGGGATGTGGAGGTGGCAGTGAGCGGAGATCGCGCCCTTGCACTTCAGCCTCAGCGACAAGAGTGAAACTCCATCAAAAAAAAAAAAAAAAGAAGGAAGGAAGGAAGGAAGAAAGGAAGGAAGGAAGGAAGAAAAAAAAACAAA","GGCTGGGTGCGGTGGCTCACGCCTGTAATCCCAGTACTTTGGGAGGCCGAGGCGGGTGGATCATGAGGTCAGAAGATAGAGACCATCCTGGTCAACATGGTGAAACCCCGTCTCTATTAAAAATACAAAAAATAGCTGGGCCTGGTGGCGTATGCCTGTAATCCCAGCTACTCAGGAGGCTGAGGCAGGAGAATTGCCTGAACCCAGGAGGTGGAGGTCGCAGTGAGCCGAGATCGCGCCATTGCACTCCAGCCTGGGTAACAAGAGTGAAACTCCATCTCAAAAAAAAAAAAAAAAGAAAGAAAAAAAGAAAAGAAAAGAAAAAAAGAAAAAAAAGAAA"
"chr19","15653692","15654307","JH378118","18053084","18053501","251","2399392","GGCTGGGCGCGGTGGCTCACACCTGTAATCCCAGCACTTTGGGAGGCGGAGGCGGAAGGATCACCTGAGGTCAGGAGTTTGACACCAGCCTGGCCAACATGGTGAATCCCTATCTCTACTAAAAATACAAAAAATTAGGCCGGGCACAGTGGCTCACGTCTGTAATCCCAGCACTTTGGGAGGCCGAGGTGGGTGGATCACGAGGTTAAGAGATCGAGACCGTCCTGGCTAACACGGTGAAACTCTGTCTTCACTGAAAAAAAAAAAAAATACAAAAAATTAGCCGGACTTAGTGGTGTGCGCCTGTAGTCCCAGCTACTCGGGAGGCTGAGGCAGGAGAATGGCGTGAACCAGGGAGGCGGAGCTTGCAGTGAGCGGAGATCGCCCCACTGCACTCCAGCATGGACGACAGAGCGAGACTCCGTCTCAAAAAAAAAAAAAAAAAAAAAAAAATTAGCCGGGCATGGTGGCACATGCCTGTAATCCCAGCTACTCAGGAGGCTGAGTCAGGAGAATCGCTTGAACCCAGGAGGCAGAGGTTGCAGTGAGCCGAGGTCATGCCATTGCACTTCAGCTTGGTCAACAAGAGCGAAACTCCGTCTGAAAAAAAAAAAAA","GGCTGGGCGCAGTGGCTCACACCTGTAATCCCAGCACTTAGGGAAGCTGAGGCGAGTAGATCACCTGAGGTCAGGAGTTAGAGACCAGCCTGGCCATCATGGTGAAACCCCGTCTCTACTAAAGATACCAAAAATTAGCTGAGTGTGGTGCTGGGTGCCTGTAATCCCAGAAACTCAGGGTGCCTGTAATCCCAGCAACTCAGGGTGCCTTTAATCCCAGCAACTGAGGGTACCAGTAATCCCAGCAACTCAGGGTGTCTTTAATCCTAGCAACTGAGGGCACCTGTAATCCCAGCAACTCAGGAAGCTGAGACAGGAGAAGTACTTGAACCCAGAAGGCAGAGGTTGCAGTGAGCCGATATTGCACCATTGCACTCCAGTCTGGGCAACAAGAGTGAAACTCTGTCTCAAAAAAAAA"
"chr19","16509976","16510345","JH378114","42137588","42137929","75","25627612","GGCCATGTGTAGTGGCTTACACCTGTAATCCCAGCACTTTGGGAGGCTGAGGCAGGTGAATCACCTGAGGTCTGGAGTTCGAGACCAGCCTGGCCAACATGGTGAAACCCCGTCTCTACTAAAAATACAAAAAAAAAAAAACACACAAAAAACAACACACACACACACAAAACAAACTAGCTGGGCATGGTGGCAGGCACCTGTAATCCCAGCTACTCAGGAGGCTGAGGTAGGAGAATTGCTTGAACCTGGGAGGCGGAGGTTGCAGTGAGCTGAGATCGCACCATTGCACTCCAGCCTGGGCGAAAAAGTGACACTCTACCTCAAAAAAATAAAATAAAATAAAATAAAATAAAGACCAAAAAGAAAA","GGCCAGGCACAGTGGCTCACACCTGTAATCCCAGCACTTTGGGAGACCAAGGTGAGTGAATCACCTGAGGTCAGGAGTTTGAGACCAGCCTGTTCAACATGGTAAAACCCTATCTCTACTAGAAATACAAAAAAAAAAAAAAAAAAAAAAAAAAAAAAAAAAAAAATTAGCTGGGTGTGGTGGCAGGCACCTATAATCCCAGCTACCTGGGAGGCTGAGACAGGAGAATTGCTTGAACCCAGGAAGCGGAGGTTGCAGTGAACAAAGATCGCACCATTGCACCCCAGCCTGGGTGACAAGAGTGAAACTCCATCTCAAAGAAAGAAAGAAAGAAAAAAAAAA"
"chr19","17582420","17583022","JH378153","2355361","2355755","251","15227059","GGCTGGGCATGGTGGCTCATGTCTGTAATCCCAGAACTTTGGGAGGCCGAGGCAGGTGGATCACCTGAGGTCAGGAGTTTTTGACCAGCCTGGCCAACATGGTGAAACCCCATCTCTACCAAAAATACAAAAATTGGCCAGCACAATGGCTCACGCCTGTAATCCCAGCACTTTGGGAGGCCAAGGAGGGTGGATTATGACATCAAGAGTTTGAGACCAGCCTGGCAAACATGGTGAAACCCCATCTCTACTAAAAATACAAAAATTAGCCGGGCGTGGTGGTGGGTATCTGTAGTCCCAGCTACTCGGGAAGCTGAAGCACCCTTGAACCTGGGAGGCAGAGGTTGCAGTGAGCTGAGATCGTGCCACTGCACACCAGCCTGGGCGACAAAGTGAGACTCAGTCTCAAAAAGAAAAAAAAAATTAGCCAGGCATGGTGGTGGGTATCTGTAATCCCAGCTACTCGGGAGGCTGAGGCAAGAGAATTGCTTGAACCCAAGAGGGGGAGGTTGCAGTGAGCGGAGATCACGCCATTGCACTCTAGCCTGGGTGACAAGAGTGAAACTCTGTCTCAAAAAAAAAAAAAAAAAAAAAAGAAAAAGA","GGCGGGGCATGGTGGCTCACACCTGTCATCCCAACACTTTGGGAGGCTGAGGCAGGCAGATCACCTGAGGTCAGGAGTTTGAGACCAGCCTGGCCAACATGGTGAAACCCCATCTCTACTAAAAATACAAAAATACAAAAAACCCCATCTCTACTAAAAATACAAAAAGCTTGTCTCTATTAAAAATACAAAAAACAAAAAACAAACAAAAAAAAAACCACCATGGTGGTGGGTGCCTATAATCCCAGCTACTCGGGAGGCTGAGGCAGGAGAATCGCTTGAACCCAGGAGGCAGAGGTTGCAGTGAGCCAAGATCCCACCATTGCACTCCAGCCTGGGCAACAGAGAGAGAGACTCTGCCTCAGAAAAAAGAAAGAAAGAAAGAAAGAAAGAAA"
"chr19","18119512","18119829","JH378250","1133852","1134171","52","16985660","GGCCAGGCACAGTGGCTCATGCCTGTAATCCCAGCACTTTGAGAGGCAGAGGCACCCTGAGGTCAGGAGTTCGAGACCAACCTGGCCAACACGGTGAAACTCCATCTCTACTAAAAATACAAAAAATTACCTGGGCGTGGCGGCGCGAGCCTGTAATCCCAGGTACTCAGAAGGCTGAGTCAGAATTGCTTGAACCCGGGAGGCGGAGGTTGCAGTGAGCCAAGATCACGCCATTGCACTCCAGCCCAGGCAACAAGAGCGAAACTTCATCTCATAAATAAATAAATAATAAATAAATAAATAACCAAAAAACAAAGA","GGCCGGGTGCGGTGGCTCAAGCCTGTAATCCCAGCACTTTGGGAGGCTGAGGCGGGTGGATCACCTGAGGTCAGGAGTTCAAGACCAGCCTGGTCAACATGGTGAAACCCCGTCTCTACTAAAAATACAAAAAATTAGCTGGGCGTGGTGGCGCGTGCCTGTAATCCCAGCTACTCAGGAGGCTGAGGCAGGAGAATTGCCTGAACCCAGGAGGCGGAGGTTGCGGTGAGCCGAGATCACGCCATTGCACTCCAGCCTGGGTAACAAGAGCGAAACTCCGACTCAAAAAAATAAATAAATAAATAAAATAAAAAATAAAT"
"chr19","18142655","18143135","JH378206","6546474","6546861","162","11596181","ATAAGAAAACTAAGGCTGGGCACAGTGGCTCACGCCTGTAATCCCAACACTTTGGGAGGCCCAGGTGGGTGGATCACCTGAGGTCGGGAGTTCGAGACCGGCCTGACCAACATGGAGAAACCCCGTCTCTACTAAAAATACAAAATTAGCCAGGCGTGGTGGTGCATCCCTGTAATCCCAGCTACTCGGGAGCCTGAGGCAGGAGAATCGCTTGAACCCGGGAGGCAGAGGTTGCAGTGAGCCGAGATCACGCCACTGTACTCCAGCCTGGGCGACAGAGAGAGACTCCATCTTAAAAAAAAAAAAAAAAAGCCAGGTGTGGTGGTGGGCGTCTGTGATCCCAGCTACTTTGGAGGCTGAGGCAGGAGAGTCACTTGAACCCAGGAGGCAGAGTGAGCCGAGTCCACACCATCGCACTCCAGCCTGGGCAAGGAGAGCAAAACTCTGTCTTAAAAAAAAAAAAAAAAAAGAGAGAAAGAAA","GGCCACACATGGTGGCTAACGCCTGTAATCCCAGCACTTTGGGAGGCCAAGTCGGGTGGATCATGAGGTCAGGAGACCAAGACCATCCTGGCCAAATGGTGAAACCCCGTCTCTACTAAAAATACAAAAATTAGCTGGGCATGGTGGCGTGTGCCTGTAATCCCAGCTACTCAGGAGGCTGAGGCAGGACAATTGCCTGAACCCAGGAGAATTAGCTGGGCATGGTGGCGTGTGCCTGTAATCCCAGCTACTCAGGAGGCTGAGGCAGGACAATTGCCTGAACCCAGGAGGCGAAGGTTGCGGTGAGCCGAGATTGTGCCATTGCACTCCAGCCTGGGTAACAAGAGCGACACTCTGTCTCAAAAAAAAAAAAAAAAAAAAAAAAAAA"
"chr19","18462114","18462720","JH378118","18053084","18053501","258","409030","GGCCAGGTGCGGTGGCTCACGTCTGTCATTCCAGCACTTTGGGAGGCCAAGGTGGGCAGACTGCTTGGGGTCAGGAGTTCGAGGCCAGCCGGGCCAACATGGTGAAACCCATCTCTACTAAAAATACAGAAAAGTAGGCCGGGCACAGTGGTTCATGCCTGTAATCCCAGCATTTTGGGAGGCTGAGATGAGCGGATCACAAGGTCAGGAGTTCGAGACCAGCCTGGCTAACATGGTGAAACCCCATCTCTACTAAAAATACAAAAATTAGCTCGGCATGGTGGCACGTGCCTGTAATCCCAGCTACTCAGGAGGCTGAGGCAGGAAAATTGTTTGAACCTGGTAGGCAGAGGTTGCAGTAAGCCGAGATCATGCCACCTCACTCCAGCCTGGGTGACAGAGCAAGACTCTGTCTCAAAAAAAAAAAAAAGAGCCAGGTATGGTGGCATGTGCCTGTAGTCCCAGCTAGTCGGGAGGCTGAGGCAGGAGAATTGCTTGAACCCGGGAGGAGGAGGTTGCAGTGAGCCAAGATCGCGCCATCACACTCCAGCCTGGGCAACAAAAGTGAAACTCCGTGTCAAATAAAAGGAAAGAAGGAAGGAAGGAA","GGCTGGGCGCAGTGGCTCACACCTGTAATCCCAGCACTTAGGGAAGCTGAGGCGAGTAGATCACCTGAGGTCAGGAGTTAGAGACCAGCCTGGCCATCATGGTGAAACCCCGTCTCTACTAAAGATACCAAAAATTAGCTGAGTGTGGTGCTGGGTGCCTGTAATCCCAGAAACTCAGGGTGCCTGTAATCCCAGCAACTCAGGGTGCCTTTAATCCCAGCAACTGAGGGTACCAGTAATCCCAGCAACTCAGGGTGTCTTTAATCCTAGCAACTGAGGGCACCTGTAATCCCAGCAACTCAGGAAGCTGAGACAGGAGAAGTACTTGAACCCAGAAGGCAGAGGTTGCAGTGAGCCGATATTGCACCATTGCACTCCAGTCTGGGCAACAAGAGTGAAACTCTGTCTCAAAAAAAAA"
"chr19","18494258","18494876","JH378118","18053084","18053501","266","441174","GGCCAGGCGCAGTGGCTTATGCCTGTAATCCTAGCACTTTGGGAGGCTGAGGTGGGTGGAACACCTGAAGTCAGGAGTTTGAGACCAGCCTGGGCAACATGGCGAAACCCCGTCTCTACTAAAAAATATAAAAATTGGCCAGGCGTGGTGGCTCACACCTGTAATCCAAGCACTTTGGGAGGCCGAGGCGGGCGGATCATGAAGTCAAGAGATGGAGACCATCCTGGCTAACATGGTGAAACCCCGTCTCTACTAAAAATACAAAAATTAGCTGGGCCTGGTGGCATGCACCTATACTCCCAGCTACTCGGGAGGCTGAGGTAGGAGAATTGCTTGAACCTGGAAGGCAGAGGTTACAATGAGCCGAGATCACGCCACTGCACTCCAGCCTGGCAACAGAGTGAGACTCTGTCTCAAAAAAAACAAAACAAAACAAAAAAAACAAAAATTAGCCGGGTGTGGTGGCAGGCACCTGTAATCCCAGCTACTCAGAAGGCTGAGGCACGAGAATCGCTTTAACCCGGGAGGCAGAGGTTGCAGTGAGCTGAGATCTCGCCACTGCACTCCAGCCTGGGTAAGAAGAGCAAAACTTCATCTCAAAAAAAAAAAATAATAATAA","GGCTGGGCGCAGTGGCTCACACCTGTAATCCCAGCACTTAGGGAAGCTGAGGCGAGTAGATCACCTGAGGTCAGGAGTTAGAGACCAGCCTGGCCATCATGGTGAAACCCCGTCTCTACTAAAGATACCAAAAATTAGCTGAGTGTGGTGCTGGGTGCCTGTAATCCCAGAAACTCAGGGTGCCTGTAATCCCAGCAACTCAGGGTGCCTTTAATCCCAGCAACTGAGGGTACCAGTAATCCCAGCAACTCAGGGTGTCTTTAATCCTAGCAACTGAGGGCACCTGTAATCCCAGCAACTCAGGAAGCTGAGACAGGAGAAGTACTTGAACCCAGAAGGCAGAGGTTGCAGTGAGCCGATATTGCACCATTGCACTCCAGTCTGGGCAACAAGAGTGAAACTCTGTCTCAAAAAAAAA"
"chr19","18815625","18815960","JH378128","1602813","1603145","52","17212812","GGCCAGGGCAGTGGCTCACACCTGTAATTCCAGCACTTTGGGAGGCCGAGAAAGGTGAATCACCTGAGGTCAGGAGTTCGAGACCAGCCTGGCCAACATGGCGAAACCCCGTCTCTACTAAAAATACAAAAATTAGGCTGGTGTGGTGGTGGCCGCCTGTAATCCCAGCTACTCAGGAGGCTGAGGCAGGAGAATCACTTGAACCTGGGAGGCAGAGGTTGCAGTGAGCTAAGATTGCGCCATTGCACTCCAGCTTGGGCCGCAAGAATGAGACTCCATCTCAAAAAAACAAAACAACAACAACAACAACAACAAAACAAACAAACAAAAAAAAAA","GGCCAGGTGCAGTGGCTCACGCCTGTAATACCAGCATTTTGGGAGGCCGAGGCAGGTGGATCACGAGGTTAGGAGTTTGAGACCAGCATGGCCAACATGGAGAAACCCCGTCTCTACTAAAAATACAAAAATTAACCAGGCATGGTGGCAGGTGCCTGTAATTCCATCTACTCGGGAGGCTGAGGCAGGAGAATCCCTTGAACCTGGGAGGCGGAGGTTGCAGTGAGCCGAGATTGTGCCATTGCACTCAGTCTGGGTGACAAAAACAAGACTCCATCTCAAAAAAAAAAAAAAGAAAAGAAAAAGAAAAAAAGAAAGAAAGAAAGAAAGAAA"
"chr19","19124622","19125078","JH378181","3341107","3341454","163","15783515","AATCCCAGCTACTCGGGAGGCGGAGGCAGGAAAATCACTTGAACCTGGGAGGTTGCAGTGAGCCGAGATTGCACCATTGCACCCCAGCCTGGGCAAAAAGAGCAAAACTCTGTCTCAAAAAAATAAAATAAAATAGGCCAGGTGCGGTGGCTCACGCCTGTAATCTCAGCACTTTGGGAGGCCGAGAAGGGTGGATCACGAGGTCAGGAGTTCGAGACCAGCCTGGCCAACATAGTGAAATGCTGTCTTACTAAAAATACAAAAAAATTAGCCAGGCATGGTGGAGGGCGCCTGTAATCCCAGCTACTCAGGAGGCCGAGGCAGGAGAATTGCTTGAACCCGGGAAGCGGAGGTTGCAATGAGCGGAGATCGCACAATTGCACTCCAGCCTGGGCGACAGTGTAAGACTCTTTCTCAAAAAATAATAATAAACTAAAATAAGTAAATAAAATAAAAA","CAGGTATGGTGGCTCATGCCTATAATCCCAGCACTTTGGGAGGCAGAGGGGGGCGGATCACTTGAGAACAGGAGTTAAAGACCAGCCTGGGGCGGATCGCCTGAGGTCAGGGGTTCAATACCAGCCTGGCCAACATGGTGAAACCCCGTCTCTACTAAAAATACAAAAAATTAGCTGGGCATGGTGGTGCGTGCCTGTAATCCCAGCTACTCAGGAGGCTGAGGCAGGAGAATTGCCTGAACCCAGGAGGCGGAGGTTGCGGTGAGCCGAGATCGCGCCATTGCACTCCAGCCTGGGTAACAAGAGCGAAACTCCGTCTCAAAAAAAAAAAAAAAAAAAAAAAAAAAA"
"chr19","19173335","19173884","JH378118","18053084","18053501","220","1120251","GGCTGGGCGCAGTGGCTTACGCCTGTAATCCCAGCAGGTTGGGAGGCCAAGACAAGTGGATCACCTGAGGAGTTAAAAACCAGCCTGGCTAACATGGTAAAACCCCGTCTCTACTAAAAATACAAAAATTAGGCTGGACGCGGTGGCTCACACCTGTAATCCCAGCACTTTGGGAGGCCAAGGCGGACAGATCACGAGGTCAGGAGATCGAGACCATCCTGGCTAACACGGTGAAACCCTGTCTCTTACTAAAAATACAAAAAATTAGCTGGGCGTCCTGGTGGGCGCCTGTAGTCCCAGCTACTTGGGAGGCTGAGGCAGAAGAATGGACTGAACCTGGGAGGCGGAGCTTGCAGTGAGCCGAGCCAGACTCCATCTCAAAAAAAAAAAAAAAAAATTAGCCTGGCATGGTGGCAGGCACCTGTTATCCCAGCTAGTCAGGAGGCTGAGGCAGGAGAATCGCTTGAACCTGGGAGGCAGAGGTTGTGGTGAGCCGAGATCATGCCATTGCACTCCAGCCTGGGCAGCAGGAGTGAAACTCCATCTCAAA","GGCTGGGCGCAGTGGCTCACACCTGTAATCCCAGCACTTAGGGAAGCTGAGGCGAGTAGATCACCTGAGGTCAGGAGTTAGAGACCAGCCTGGCCATCATGGTGAAACCCCGTCTCTACTAAAGATACCAAAAATTAGCTGAGTGTGGTGCTGGGTGCCTGTAATCCCAGAAACTCAGGGTGCCTGTAATCCCAGCAACTCAGGGTGCCTTTAATCCCAGCAACTGAGGGTACCAGTAATCCCAGCAACTCAGGGTGTCTTTAATCCTAGCAACTGAGGGCACCTGTAATCCCAGCAACTCAGGAAGCTGAGACAGGAGAAGTACTTGAACCCAGAAGGCAGAGGTTGCAGTGAGCCGATATTGCACCATTGCACTCCAGTCTGGGCAACAAGAGTGAAACTCTGTCTCAAAAAAAAA"
"chr19","19326912","19327497","JH378118","18053084","18053501","258","1273828","GGCCGGGCGCGGTGGCTCATGCCTGTATCCAGCACTTGGGGGCTGGGGGGGGGCTGAGGCGGAGTCAAGACAGCCGGTCAACATGGTGAAACCCCATCTCTAGTAAAAAATACAAAAAGTAGGCTGGGCGCGGTGGCTCACACCTGTAATCCCAGCACTTTGGGAGGCCGAGGCGGGCAGATCACGAGGTCAGAAGATCGAGACCATACTGGCTAACAGAGTGAAACCCCGTCTCTACTAAAATTACAAAAAATTAGCCAGGCATGGTGGCAGGCGCCTGTAGTCCCAGCTACTTGGGAGGCTGAGGCAGGAGAATGGTGTGAACCCGGGAGGCGGAGCTTGCAGTGAGCCAAGATCGTGCCACTGCACTCCAACCTGGGCAACAGAGCGAGACTCTGTCTAAAAAAAAGAAAAAAAAAAAGTCTGAGCGAGGTGGCACGCGCCTGTAATCCCAGCTACTCAGGAGGCTGAGGCAGGAGAATCGCTTGAAACCCGGAGGCAGAGGTTGCAGTGAGCTGAAATCACGCCATTGCACTCTAGCCTGGGCGACAAGAGCAAGATTCCATCTTAAAAATCAATAAATAAA","GGCTGGGCGCAGTGGCTCACACCTGTAATCCCAGCACTTAGGGAAGCTGAGGCGAGTAGATCACCTGAGGTCAGGAGTTAGAGACCAGCCTGGCCATCATGGTGAAACCCCGTCTCTACTAAAGATACCAAAAATTAGCTGAGTGTGGTGCTGGGTGCCTGTAATCCCAGAAACTCAGGGTGCCTGTAATCCCAGCAACTCAGGGTGCCTTTAATCCCAGCAACTGAGGGTACCAGTAATCCCAGCAACTCAGGGTGTCTTTAATCCTAGCAACTGAGGGCACCTGTAATCCCAGCAACTCAGGAAGCTGAGACAGGAGAAGTACTTGAACCCAGAAGGCAGAGGTTGCAGTGAGCCGATATTGCACCATTGCACTCCAGTCTGGGCAACAAGAGTGAAACTCTGTCTCAAAAAAAAA"
"chr19","19579957","19580563","JH378118","18053084","18053501","246","1526873","GGCCGGGTGCAGGGGCTCATGCCTGTAATCCCAGCACTTTGAGAGGCCGAGGCAGATGGATCACCTGAGGTCAGGAGTTCAAGACCAGCCTGGCCAACATGATGAAACCCCGTCTCTACTAAAAATACAAAAATTAGCCAGGCATCTGCCGGGCGCGGTGGTTCATGCCTGTAATCCTAGCACTTTGGGAGGCCGAGGCGGGCGGATCACGAGGTCAGGAGATCGAGACCATCCTGGCTAACACGGTGAAACCCCGTCTCTATTAAAAATACAAAAAATTAGCCGGGCATGGTGGCAGGCGCCTGTAGTCCCAGCTACTCGGGAGGCTGAGGCAGGAGAATGGGGTGAACCCAGGAGGCGGAGCTTGCAGTGAGCCGAGATGGCGCCACTGCACTCCAGCCTGGGCGACAGACCGAGACTCTGTCTCAAAAAAAAAAAAAAAAAATTAGCTGGGCGTGGCGGCAGGCACCTGTAATCCCAGCTACTCAGGAGGAGGTTGAGGCAGGAGAATCGCTAGAACCCGGGAGAAGGAGGTTGCAGTGAGCCGAGATTGTGCCATTGCACTCCAGCCTGGGCAACAAGAGCAAAACTCCTTCTCAAAAACAAA","GGCTGGGCGCAGTGGCTCACACCTGTAATCCCAGCACTTAGGGAAGCTGAGGCGAGTAGATCACCTGAGGTCAGGAGTTAGAGACCAGCCTGGCCATCATGGTGAAACCCCGTCTCTACTAAAGATACCAAAAATTAGCTGAGTGTGGTGCTGGGTGCCTGTAATCCCAGAAACTCAGGGTGCCTGTAATCCCAGCAACTCAGGGTGCCTTTAATCCCAGCAACTGAGGGTACCAGTAATCCCAGCAACTCAGGGTGTCTTTAATCCTAGCAACTGAGGGCACCTGTAATCCCAGCAACTCAGGAAGCTGAGACAGGAGAAGTACTTGAACCCAGAAGGCAGAGGTTGCAGTGAGCCGATATTGCACCATTGCACTCCAGTCTGGGCAACAAGAGTGAAACTCTGTCTCAAAAAAAAA"
"chr19","21574248","21574866","JH378118","18053084","18053501","261","3521164","GGCCGGGAGAGGTGGCTCACACCTGTAATCTCAGCACTTTGGTAGGCCGAGGCGGGTGGATGATCTGATGTCAGGAGTTGGAGACCAGCCTGGCCAACATGGTGAAAGCCCGTCTCTACTAAAAATACAAATTAGATGGCTGGGTGTAGTGGCTGACACCTGTAATCCCAACACTTTGGGAGGCCGAGGCAGGTAGATCACTTGAGGTCAGGAGCTCAAGACCAGCCTGTCCAACATGGTGAAACCCCATCTCTACTAAAAATACAAAAAATTAGCCAGGCATGGTGGTGGGAGCCTGTAATCCCAGCTGCTCGGGAGGCTGAGGCAGGAGAATCGCTTGAACCCAGGAGTCAGAGGTTGCAGTGGGCCAAGATCATGCCATTGCACTCCAGCCTGGGCAACAAGAGCGAGACTCCATCTTAAGGAAAAAAAGAAAAAAATTAGCTGGGTGTGGTGACAGGTGCCTGAAATCCCAGCTGCTCAGGAGGCTGAGGCAGGAGAATTGCTTGAACTTGGGAGGCAGAGGTTGTAGTGAGCCGAGATCGTGTCATTGCACTCCAGCCTCGGCAACAAGAGTGAGACTCTCCATCTCAAAAAAAAAAAAAAAAAAAAGAAAAAA","GGCTGGGCGCAGTGGCTCACACCTGTAATCCCAGCACTTAGGGAAGCTGAGGCGAGTAGATCACCTGAGGTCAGGAGTTAGAGACCAGCCTGGCCATCATGGTGAAACCCCGTCTCTACTAAAGATACCAAAAATTAGCTGAGTGTGGTGCTGGGTGCCTGTAATCCCAGAAACTCAGGGTGCCTGTAATCCCAGCAACTCAGGGTGCCTTTAATCCCAGCAACTGAGGGTACCAGTAATCCCAGCAACTCAGGGTGTCTTTAATCCTAGCAACTGAGGGCACCTGTAATCCCAGCAACTCAGGAAGCTGAGACAGGAGAAGTACTTGAACCCAGAAGGCAGAGGTTGCAGTGAGCCGATATTGCACCATTGCACTCCAGTCTGGGCAACAAGAGTGAAACTCTGTCTCAAAAAAAAA"
"chr19","23238677","23238988","JH378109","42419279","42419570","64","19180602","GGCTGGGCACAGTAGCTCAAGTCTGTCATCACAGCACTTTGGGAGGCCAAGGCGGGTGGATCACCTGAGGTCAGGAGTTCGAGACCAGCCTGGCCAACATGGTGAAACCCTCTCTGTACTAAAAATACACACACACACACACACACACACACACACACAAATAGCCAGGCGTGGTGCTGGGTGCCTGTAATCCCAGCTACTTGGGAGGCTGAGTTAGGAGAATTGCTTGAACCCGACAGGCGAAGGTTGCAGTGAGCCCAGAATGCGTCATTGCACTCCAGCCTGGAGGACAAGAATGAAACTCCATGTCAA","GGCCGGGCGTGGTGGCTCAAGCCTGTAATCCCAGCACTTTGGGAGGCCGAGGCGGGTGGATCACGAGGTCAAGAGATCGAGACCATCCTGGTCAACATGGTGAAACCCTGTCTCTACTAAAAAGACAAAAAAAAAAAAAAAATTAGCTGGGCATGGTGGCGTGTGCCTGTAATCACAGCTACTCAGAGGCTGAGGCAGGAGAATTGCCTGAACCCAGGAGGCGGAGGTTGCGGTGAGCCGAGATCGCGCCATTGCACTCCAGCCTGGGTAACAAGAGCGAAACTCCATCTCA"
"chr19","30908974","30909311","JH378109","21565230","21565567","62","9343744","GGCCGGGCATGCTGGCTCACACTGTAATCCCAGCACTTTGGGAGGCCGAGGCGGGTGGATCACCTGAGGTCAGGTGCTCGAGATCAGCCTGGCCAACAAGGTGAAACCCCACCTTTACTAAAAATACAAAAATTAGCCTGGCGAGGTGGTGTGTGCCTGTAATCCCAGTTACTTGGGAGGCTGAGGCGGGAGAATCTCTTGAATCTAGGAGGCAGAGGTTGCAGTGAGCCAAGATCCCACCACTGCACTGCAGCCTGGGCGTCAAGAGCAAAACTCCATCTCAATCAATCAATCAATCAATCAATCAATCAATCAATCATTAAATAAAATAAAAAAAA","GGCCGGGCGCGGTGGCTCAAGCCTGTAATACCAGCACTTTGGGAGGCCGAGGCGGGTGGATCACGAGGTCAAGAGATCGAGACCATCCTGGTCAACATGGTGAAACCCCGTCTCTACTAAAAATACAAACAATTAGCTGGGCATGGTGGCGGGTGCCTGTAATCCCAGCTACTCCAGAGGCTGAGGCAGGAGAATTGCCTGAACCCAGGAGACGGAGGTTGCGGTGAGCCAAGATCGCGCCATTGCACTCCAGCCTGGGTGACAAGAGCGAAACTCCGTCTCAATAAATAAATAAATAAATAAATAAATAAAAATAAAATAAATAAATAAATAAATAA"
"chr19","31469464","31469847","JH378149","8949716","8950050","92","22519748","GCCAGGCACAGTGGCTCATGCCTGTAATCCCAGCACTTTGGGAGCCCAAGGTGGGTGGATCACCTGAGGTCAGGAGTTTGAGACCAGCCTAACCAACATGGTGAAACCCTGTCTCTACTAAATACAAAAAAAAAAAAAAAATTAGCCAAGAGTGGTGTTGCATGCCTGTAATTCCAGCTACTTGGGAGGCTGAGGCAGGAGAACTGCTTGATCCCGGGAGGCAGAGATTGCAGTGAGCTGAGATTGTGCCATTACACTCCAGCCTGGGTGACAAGAGTGAAAACTCTGTCATAAAAAAAAGGAAGGAAGGAAGGAAGGAATGAAGGAAGGAAGGAAGGAATGAAGGAAGGAAGGAAGGAAAGAACGAAAGAGAAAGAAAGAAAA","GGCCGGGCGCAGTGGTTCAAGCCTGTAATCCCAGCACTTTGGGAGGCCGAGGTGGGTGGATCATGAGGTCAAGAGATCGAGACCATCCTGGTCAACATGGTGAAACCCTGTCTCTACTAAAAACACAAAAAATTAGCTGGGCATGGTGGCGTGTGCCTGTAATCCCAGCTACTCAGGAGGCTGAGGCAGGAGAATTGCCGGAACCCAGGAGGCAGAGGTTGCGGTGAGCCGAGATCGCGCCATTGCACTCCAGCCTGGGTAACAAGAGTGAAACTCCATCTCAAAAAAAAAAAAAAAAAAAAAAAAAAATGAAAAGAAAAGAAAAGAAAAAAAAA"
"chr19","31960817","31961439","JH378118","18053084","18053501","261","13907733","GGCTGGGCGCGGTGGCACATGCCTGTAATCCCAGCACTTTGGGAAGCCGAGGTGGGTGGATTACCTTAGGTCAGGAGTTCGAGACTAGCCTGGCCAACATGGTGAAACCCCATCTCTACTAAAAATATAAAAATTAGGCCGGGCACAGTGGCTCACGCCTGTAATCCCAGCACTTTGGGAGGCCGAGGCAGATGGATCACGAGGTCAGGAGATCGAGACCATCCTGGTCAACATAGTGAAACTCCATCTCTACTAAAAATACAAAAATTAGCTGGACATGGTGGTGCATGCCTGTAATCTCAGCTACTCAGGAGGCTGAAGCAGGAGAATTGCTTGACCAGGGAGTTGGAGGTTGCAGTGAGCCCAAATGGTGCCACTGCACTCTGGCCTGGTGATAGAGGGAGACTCCGTCTCAAAAAAAAAAAAAAAAATTAGCCTGGCGAGGTGGCGGGTGCCTGTAATCCTAGCTACTAGGGAGGCTGAGGCAAGAGAATTGCTTGAACTTGGGAGGTGGAGGTTGCAGGGAGGCAGAGGTTGCAGTGAGCCAACATTGTGCCATTGCACTGTAGCCTGGGCAACAAGAGTGAAACTTCGTCTCAAAAAAAAAGAAGAAAAAAAGAAAA","GGCTGGGCGCAGTGGCTCACACCTGTAATCCCAGCACTTAGGGAAGCTGAGGCGAGTAGATCACCTGAGGTCAGGAGTTAGAGACCAGCCTGGCCATCATGGTGAAACCCCGTCTCTACTAAAGATACCAAAAATTAGCTGAGTGTGGTGCTGGGTGCCTGTAATCCCAGAAACTCAGGGTGCCTGTAATCCCAGCAACTCAGGGTGCCTTTAATCCCAGCAACTGAGGGTACCAGTAATCCCAGCAACTCAGGGTGTCTTTAATCCTAGCAACTGAGGGCACCTGTAATCCCAGCAACTCAGGAAGCTGAGACAGGAGAAGTACTTGAACCCAGAAGGCAGAGGTTGCAGTGAGCCGATATTGCACCATTGCACTCCAGTCTGGGCAACAAGAGTGAAACTCTGTCTCAAAAAAAAA"
"chr19","32086214","32086550","JH378293","1845184","1845523","65","30241030","GGCCGGGCACGGTGGCTCATGCCTGTAATCCCAGCACTTCGGAAGGCTGAGGCAGGTGGATCACCTGAGGTCAGTAGTTCAAGACCAACCTGGCCAACATGGTGAAACCCCATCTTTACTAAAAAAAAAAAAAAAAATATATATATATATATATATATATATATATATATATATATATATATATTAGCCGGGCCTCGTGGCAGGCACCTGTAATTCCAGCTACTCAGGAGGCTAAGGCAGGAGAATTGCTTGAACGCGGGAGGCAGAGGTTGCAGTGAGCCAAGATTGTGCTATTGCACTCCAGCCAGGGCGATGAGTGAAGCTCCATCTCAAAAAA","GGCCGGGTGCGGTGGCTCACGCCTGTAATCCCAGCACTTTGGGAGGCCAAGGCGGGTGGATCACCTGAGGTCAGAAGTTCGAGACCAGCCTGGCCAACATGGTGAAACCCCGTCTCTGCTAAAAAGAAAAAAATAAGAAAAAAACAAAATAAGAAAATAATTTTAAAAAATACAAAATTAGCTGGGCGTGGTGGCAGGCACCTGTAATTCCAGCTATTCAGGAGGCTGAGGCAGGGGAATCACTTGAACCCAGGAGGCAGAGGTTGCAGTGAGCCAAGATGACGCCATTGCACACCAGCCTGGGCAACAAGAGTGAAACTCCGTCTCAAAAAAAAAACAA"
"chr19","32093469","32093932","JH378153","2355361","2355755","138","29738108","GGCTGGGCATGGTGGCTCACACCTGTAATCCCAGCACTCTGGGAGGCCGAGGCGGGTGGATCACCTGAGGTCAGGAGTTCGAGACCAGCCTGGCCAACATGGTGAAACCCTGTCTCTACTAAAAAAAAAATATATATATATATATATACACACACACACACACACACACACACATTATATATACACATACATACATATATACACATACATATATATACACGTATATACATATACACACACATACACACACACACACACACACACACACACACACACAAAAGTTAGCCAGGCATGGCGGTGGATGTCTGTAATTCCAGCTACTTGGGAGGCTGAGGTAGGAGAATGGCTTGAACCTGGCTGGGAGGTGGAGGTTGCAGTGGTTGCGGTGAGCCGATATCACGCCATTGCACTCCAGCCTAGGCAACAAGAGTGAAACTCCGTCTCAAAACAAAAAACAAACAAAA","GGCGGGGCATGGTGGCTCACACCTGTCATCCCAACACTTTGGGAGGCTGAGGCAGGCAGATCACCTGAGGTCAGGAGTTTGAGACCAGCCTGGCCAACATGGTGAAACCCCATCTCTACTAAAAATACAAAAATACAAAAAACCCCATCTCTACTAAAAATACAAAAAGCTTGTCTCTATTAAAAATACAAAAAACAAAAAACAAACAAAAAAAAAACCACCATGGTGGTGGGTGCCTATAATCCCAGCTACTCGGGAGGCTGAGGCAGGAGAATCGCTTGAACCCAGGAGGCAGAGGTTGCAGTGAGCCAAGATCCCACCATTGCACTCCAGCCTGGGCAACAGAGAGAGAGACTCTGCCTCAGAAAAAAGAAAGAAAGAAAGAAAGAAAGAAA"
"chr19","33115521","33115848","JH378244","3995173","3995505","56","29120348","CTGGGCGCGGTGGCTCACTTCTGTAATCTCAGCACTTTGGGAGGCCGAGGCAGGCAGATCACCTGAAGTCAGGAGTTCGAGACAAGCCTGGCCAACGTGGTGAAATCCCATCTCCACTAAAAATCCAAAAAAAAAAAAAAAAAAAAAAAAAATTAGCCCGGTGAGGTGACAGGCGCCTGTAATCCCAGCTACTTGGTAGGCTGAAGCAGGAGAATTGCTTGAACCTGGGAAGCAGAGGTTGCAGTGAGTCAAGATTGCGCCATTGCACTCCACACTGGGTGGTAAGAGCAGAAACTCCATCTAAAAAAAAAAAAAAAAAAAAAGAAAA","GGTTGGGCGTGGTGGCTCATGCCTGTACTCTCAGCATTTTGGGAGCTGAGACAGGCAGATCACCTGATGTCAGAAGTTCGAGACAAGCCTGGCCAACATGGTGAAATCCCGTCCCTACTAAAAAACACAAAAAACACAAAAACAAAAATAAGAATTAGTCAAGCATGGTGGCAGCTGCCTGTAATCCCAGCTACTTGGGAGGCCGAGGCAGGAGAATTGCTTGAACCTGGGAAGCGGAGGTTGCAGTGAGCCGAGATTGAGCCATTGCACTCCAGCTTGGCAGACAAGAGCAAAACTCTGTCTCAAAAAAAAAAAAAAAAAAAAAAAAAAAAA"
"chr19","33872962","33873559","JH378118","18053084","18053501","247","15819878","GGCCGGGCGCAGTGGCTTACACCTGTAATCCCAGCACTTTGGGAAGCCAAGGCGGGCAGATCACGAGTTCAGGAGATCGAGACCATCCTGGCTAACATGGTGAAACCACGTCTCTACTAAAAATACAAAAATTGGCCGGGCACAGTGGCTCACGCCTGTAATCCCAGCACTTTGGGAGACCGAGGCAGGCGGATAACAAGGTCAGGAGATCGAGACCGTGGTGAAACCCTGTCTGTACTAAAAATACAAAAAATTAGCCAGGTGTGGTGGCGGACGCCTGTAGTCCCAGCTACTCGGGAGGCTGAGGCAGGAGAATGGCGTGAACCCGGGAGGCGGAGCTTGCAGTGAGCCGAGATCGCGCCACTGCACTCCAGCCTGGGCGACAAAGCGAGACTCCATCTCAAAAAAAAAAAAAAAAATACAAAAATTAGCTAGGCATGGTGGTGGGTGCCTGTTAATTCCAGCTACTCGGGAGGCTGAGACAGGAGAATCTCTTGAACCTGGGAGGTGGAGATTGCAGTGAGCTGAGATCATGCCATTGCACTCCAGCCTGAGCGACAAAAGTGAAAGTCTATCTCAAAAAACAAACCAAAAAAAA","GGCTGGGCGCAGTGGCTCACACCTGTAATCCCAGCACTTAGGGAAGCTGAGGCGAGTAGATCACCTGAGGTCAGGAGTTAGAGACCAGCCTGGCCATCATGGTGAAACCCCGTCTCTACTAAAGATACCAAAAATTAGCTGAGTGTGGTGCTGGGTGCCTGTAATCCCAGAAACTCAGGGTGCCTGTAATCCCAGCAACTCAGGGTGCCTTTAATCCCAGCAACTGAGGGTACCAGTAATCCCAGCAACTCAGGGTGTCTTTAATCCTAGCAACTGAGGGCACCTGTAATCCCAGCAACTCAGGAAGCTGAGACAGGAGAAGTACTTGAACCCAGAAGGCAGAGGTTGCAGTGAGCCGATATTGCACCATTGCACTCCAGTCTGGGCAACAAGAGTGAAACTCTGTCTCAAAAAAAAA"
"chr19","33901595","33902156","JH378118","18053084","18053501","263","15848511","GGCCAGGCTTGGTGGCTCACACCTGTAATCCGAGCACTTTAGGTGGCCAAAGCAGGAGGATGGCTAGAGTCCATGAGTTAGAGACCAGCTTGGGCGACATAGTGAGATCTCCCGTAGTCCTAGCTGCTTGGGAAGCTGAGGTGGGAGGATCACTTGAGCCTAGGAGGTCAAGGCTGCAGTGAGCAGAGATCCTGGCGACAGCATTCCAGCTTGGTGGACAGCCAGACCCTGTCTTTTTTTTTTTTTTTTTTTTTTTGAGATGAAGTCTCTCTCTGTTGCCCAGGCTAGAGTGCAGTGGCCCAATCTCTGCTCCCTGCAACCTCTGCCTCCCGGGTTCAAGCGATTCTCTTGGCTCAGCCTCCCGAGCAGCTGGGATTAGAGTTGCCTGCCACCACACCTGGCTACTTTTTTTGTATTTTGAGTAGAGACAGGGTTTCACCATGTTGGCCAGGTTGGTCTCGAACTCTTGACCTCAAGTGATCGGCCCACCTCGGCTTCCCAAAGTGCTAGGATTACAGGCATGAGCAACGGTGCCTGGCCAACCCTGTCTTAAGAAAGAAAT","GGCTGGGCGCAGTGGCTCACACCTGTAATCCCAGCACTTAGGGAAGCTGAGGCGAGTAGATCACCTGAGGTCAGGAGTTAGAGACCAGCCTGGCCATCATGGTGAAACCCCGTCTCTACTAAAGATACCAAAAATTAGCTGAGTGTGGTGCTGGGTGCCTGTAATCCCAGAAACTCAGGGTGCCTGTAATCCCAGCAACTCAGGGTGCCTTTAATCCCAGCAACTGAGGGTACCAGTAATCCCAGCAACTCAGGGTGTCTTTAATCCTAGCAACTGAGGGCACCTGTAATCCCAGCAACTCAGGAAGCTGAGACAGGAGAAGTACTTGAACCCAGAAGGCAGAGGTTGCAGTGAGCCGATATTGCACCATTGCACTCCAGTCTGGGCAACAAGAGTGAAACTCTGTCTCAAAAAAAAA"
"chr19","35310498","35311027","JH378206","6546474","6546861","201","28764024","GGCCATGCACGGTGATTCATGCCTGTAATCCCAGTACTTTGGGAGGCCGAGTTGGGTGGATCGCTTGAGGTCAGGAGTTCAAGACCAGCCTGGCCAACATGGTGAAACTCTGTCTCTACTAAAAATACAAAAATTAGGCCAGGCGCAGTGGCTCACGCCTGTAATCCCAGCACTTTGGGAGGCCGAGGCAGGCAAATCACAAGGTTGGGAGATCGAGACTATCTTGGCTAACACGGTGAAACCCCGTGTCTACTAAAAATATAAAAAATTAGCCAGGCGTTGTGGCACGCACCTGTAGTCCCAGCTACTTGGTAGGCCGAGGCAGGAGAATGGCGTGAACCCGGGAGGCAGAGCTTGCAGTGAGCCGAGATCGCGCCACTGCACTCCAGCCTGGGCGACAGAGCGGACTTCGTCTCAAAAAAAATTAGCCCGGCATGGTGGTGCATGTCTGTAATTCTGAGATCGCGCCATTGTACTCCAGCCTGGGTTACAAGAGTGAAATTCCATCTCAAAAAACAAAACAAAATAAA","GGCCACACATGGTGGCTAACGCCTGTAATCCCAGCACTTTGGGAGGCCAAGTCGGGTGGATCATGAGGTCAGGAGACCAAGACCATCCTGGCCAAATGGTGAAACCCCGTCTCTACTAAAAATACAAAAATTAGCTGGGCATGGTGGCGTGTGCCTGTAATCCCAGCTACTCAGGAGGCTGAGGCAGGACAATTGCCTGAACCCAGGAGAATTAGCTGGGCATGGTGGCGTGTGCCTGTAATCCCAGCTACTCAGGAGGCTGAGGCAGGACAATTGCCTGAACCCAGGAGGCGAAGGTTGCGGTGAGCCGAGATTGTGCCATTGCACTCCAGCCTGGGTAACAAGAGCGACACTCTGTCTCAAAAAAAAAAAAAAAAAAAAAAAAAAA"
"chr19","37203277","37203860","JH378118","18053084","18053501","233","19150193","GGCCAGGCGCGGTGGCTCACACCTGTAATCCCAGCACTTTGGGAGGCCGAGGAGGGTGTATTACCTGAGGCCACGAGTTCGAGACCAGCCTGGCCAACATGGCGAAACCCCGTCTGTACTAAAAATACAAAAATAGCCAGGCGTGGCCAGGCACGGTGGCTCATGCCTGTAATCCCAGCACTTTGGGAGGCCGAGGTGGGTGGATCACAAGGTCAGGAAATCATTGAGACCATCCTGGCTAACAGGGTGAAACCCATCTCTACTAAAAATACAGAAAATTAGCCAGGCATGGTGGCACGCACCTGTAGTCCCAGCTACTCGAGAGGCTGAGGCAGGAGAATTGCTTGAATCCGGGATGCGGGGTTGCAGCGAGCAGAGATCGCGCCACTGCACTCCAGCCTGGGAGACAGAGTGAGACTCCATTTCCAAAAAAAAAATTAGCCAGGCGTGGTCGGGAGGCTAAGGCAGGAGAATTGCTTGAACCCAGGAGGCGGAGGTTGCAGTGAATCAAGATTGTGCCATAGCACTCCAGCCTGGGCAAAAAAGATCGAAACTCCATCTCAAAAAAAAAAAAAAAAAAAGAA","GGCTGGGCGCAGTGGCTCACACCTGTAATCCCAGCACTTAGGGAAGCTGAGGCGAGTAGATCACCTGAGGTCAGGAGTTAGAGACCAGCCTGGCCATCATGGTGAAACCCCGTCTCTACTAAAGATACCAAAAATTAGCTGAGTGTGGTGCTGGGTGCCTGTAATCCCAGAAACTCAGGGTGCCTGTAATCCCAGCAACTCAGGGTGCCTTTAATCCCAGCAACTGAGGGTACCAGTAATCCCAGCAACTCAGGGTGTCTTTAATCCTAGCAACTGAGGGCACCTGTAATCCCAGCAACTCAGGAAGCTGAGACAGGAGAAGTACTTGAACCCAGAAGGCAGAGGTTGCAGTGAGCCGATATTGCACCATTGCACTCCAGTCTGGGCAACAAGAGTGAAACTCTGTCTCAAAAAAAAA"
"chr19","37801855","37802196","JH378109","21565230","21565567","51","16236625","GGCTGGGCGCAGTGGCTCATGCCTGTAATCTCAGCACTTTGGGAGGTCAGGGTGGGTGGATCACCTGAGGTCAGGAGTTCGAGACCAGCCTGGCCAACATGTCGAAACCTCATCTCTACTAAAAATACAAAAAAAAATTAGCTGGGCATGATGGTGGTTGCCTGTAATCCTAGCTACCCAGGAGGCTGAAGCAAGAGAATCGCTTGAACCCAGAAGGCAGATGTTGCAGTGAGCCAAGATCGCACCATTGCACTCCAGCCTGGGCGACAAGAGGGAAACTCCGTCTCAAAAAATAAATACATAAATAATAAATAATAAATAAAAATTGAAAAAATAAATAAA","GGCCGGGCGCGGTGGCTCAAGCCTGTAATACCAGCACTTTGGGAGGCCGAGGCGGGTGGATCACGAGGTCAAGAGATCGAGACCATCCTGGTCAACATGGTGAAACCCCGTCTCTACTAAAAATACAAACAATTAGCTGGGCATGGTGGCGGGTGCCTGTAATCCCAGCTACTCCAGAGGCTGAGGCAGGAGAATTGCCTGAACCCAGGAGACGGAGGTTGCGGTGAGCCAAGATCGCGCCATTGCACTCCAGCCTGGGTGACAAGAGCGAAACTCCGTCTCAATAAATAAATAAATAAATAAATAAATAAAAATAAAATAAATAAATAAATAAATAA"
"chr19","38500989","38501598","JH378118","18053084","18053501","269","20447905","GGCCAGGCATGCTGGCTCATGCCCATTATCGCAGCACTTTGGGAGGCCGAGGCAGGAGGATTGCTCGAGGCCAGGAGTTCCACACCAGCCTCGGCAACATAGCAAGACCCCATTTGTATAAAAAATTAAAAATCAGGCCAGGCGTGGTGGCTCAGGCCTGTAATCAGAGCACTTTGGGAGGCCGAGGTGGGTGGATCACCTGAGGTCAGGAGTCCGAGACCAGCCTGGCTAACATGGTGAAACCCCATCTCTATTAAAAATATAAAAATTAGCCAGGCATGGTGGCACACGCCTGTAATCCCAGCTACTCAGAAGGCTGAGGCAGGAGAATCGCTTGAACCTGGGAGGTGGAGGTTGCAGTGAGCTGAGATCATGCCATTGCACTCCAGCCTGGGCAACAAGAGTAAAACTTCGTCTCAAAAAAAAAAAAAAATTAAAACTTAGCCAGACATGGTGGCGGGCACCTGTAATCAGCTACTCAGGAAGCTGAGGCAGGAGAATTGCTTGAATCTGGGAGGCGGAGGTTGCAGTGAGCTGAGATTGCGCCATTGCACTCCAGCCTGGGCAACAAGAGTAAAACTTCATCTCAAAAAAAAAAAAAAAATTAAAA","GGCTGGGCGCAGTGGCTCACACCTGTAATCCCAGCACTTAGGGAAGCTGAGGCGAGTAGATCACCTGAGGTCAGGAGTTAGAGACCAGCCTGGCCATCATGGTGAAACCCCGTCTCTACTAAAGATACCAAAAATTAGCTGAGTGTGGTGCTGGGTGCCTGTAATCCCAGAAACTCAGGGTGCCTGTAATCCCAGCAACTCAGGGTGCCTTTAATCCCAGCAACTGAGGGTACCAGTAATCCCAGCAACTCAGGGTGTCTTTAATCCTAGCAACTGAGGGCACCTGTAATCCCAGCAACTCAGGAAGCTGAGACAGGAGAAGTACTTGAACCCAGAAGGCAGAGGTTGCAGTGAGCCGATATTGCACCATTGCACTCCAGTCTGGGCAACAAGAGTGAAACTCTGTCTCAAAAAAAAA"
"chr19","38564601","38565221","JH378118","18053084","18053501","261","20511517","GGCCAGGCGCAGTGGCTCACTCCTGTAATCCCAGCACTTTGGGAGGCCGAGGTGGGTGGATCACCTGAAGTCAAGAGTTCAAGACTAGCCTAGCCAACATGGTGAAACCCCATCTCTATTAAAAATTCAAAATTGGCCAGGCGTGGTGGCTCATGCCTGTAATCCCAGCATTTTGGGAGGCCAAGGCGGGCAGATCACGAGGTCAGGAGATCGAGACCATCCTAGCTAACACGGTGAAACCCCATCTCTACTAAAAATCCAAAAAAATTAGCCAGGCGTGGTGGCGGGCACCTGTAGTCCCAGCTACTTGGGAGGCTGAGGCAGGAGAATGCCATGAACCTGGGAGGCAGAGCTTGGAGCTTGCAGTGAGCCGAGATAGCACCATTGCACTCCAGCCTGGGTGACAGAGCGAGACTCTGCCTCAAAAAAAAAAAAATTCAAAATTAACTGGGCGTGGTGATGTGTGCCTGTAATCCCAGCTACTCGGGAGGCTGAGGCAGGAGAATCACTTGAACTGAGGAGGCAGAGGTTGCAGTGAGCCGAGATCACGCCATTGCACTCCAGCCTGGGCAAAAAGAGTGAAACTCCATCTCAAAAAAAAAAAAGAAAAAAGAAAAGGAA","GGCTGGGCGCAGTGGCTCACACCTGTAATCCCAGCACTTAGGGAAGCTGAGGCGAGTAGATCACCTGAGGTCAGGAGTTAGAGACCAGCCTGGCCATCATGGTGAAACCCCGTCTCTACTAAAGATACCAAAAATTAGCTGAGTGTGGTGCTGGGTGCCTGTAATCCCAGAAACTCAGGGTGCCTGTAATCCCAGCAACTCAGGGTGCCTTTAATCCCAGCAACTGAGGGTACCAGTAATCCCAGCAACTCAGGGTGTCTTTAATCCTAGCAACTGAGGGCACCTGTAATCCCAGCAACTCAGGAAGCTGAGACAGGAGAAGTACTTGAACCCAGAAGGCAGAGGTTGCAGTGAGCCGATATTGCACCATTGCACTCCAGTCTGGGCAACAAGAGTGAAACTCTGTCTCAAAAAAAAA"
"chr19","40393858","40394471","JH378118","18053084","18053501","276","22340774","GGCTAGGCAGGGTGACTCACACCTGTAATTCCAGCACTCTGGGAGGCCAAGGTGGGCGGATTGTTTCAGCCCAGGAGTTGGAGACTATCCTGGTCAACACAGAGAGACCCCCAACTCCACAAAAAATAAAAAAAAATTAGCTGGGTTGGCTGGGCATGGTGGCTCACGCCTGTAAGCCCAGCACTTTGGGATGCTGAGGCGGGTGGATCATCTGAGGTCAGGAGTTCAAAACCAGCCTGACCAACATGGAAAAACCCCGTCTCCACTAAAAATACAAATTAGCTGGGCGTGGTGGCGCATGCCTGTAATCCTAGCTACTCGGGAGGCTGAGGCAGGAGAATCGCTTGAACCCAGGAGACGGAGGTTGCGATGTGCCAAGATGGTGTCATTGCACTCCAGCCTGGGCAAGGAGAGCAAAACTGCGTCTCAAAAAAAAAAAAAAAAAAATAGCTGGGCATGGTGGTGTGGGCGCTTGTAATTCCAGCTACTCAGGAGGCTGAGACAGGAAAATCGCTTGAACCAGGGAGGCAGAGGTTGCAGTGAGCCAAGATCGTGCCATTGCACTTACAGCCTGGGTGACGAGCAAAATTCCATCTCAAAAAAAAAAAAAAAAA","GGCTGGGCGCAGTGGCTCACACCTGTAATCCCAGCACTTAGGGAAGCTGAGGCGAGTAGATCACCTGAGGTCAGGAGTTAGAGACCAGCCTGGCCATCATGGTGAAACCCCGTCTCTACTAAAGATACCAAAAATTAGCTGAGTGTGGTGCTGGGTGCCTGTAATCCCAGAAACTCAGGGTGCCTGTAATCCCAGCAACTCAGGGTGCCTTTAATCCCAGCAACTGAGGGTACCAGTAATCCCAGCAACTCAGGGTGTCTTTAATCCTAGCAACTGAGGGCACCTGTAATCCCAGCAACTCAGGAAGCTGAGACAGGAGAAGTACTTGAACCCAGAAGGCAGAGGTTGCAGTGAGCCGATATTGCACCATTGCACTCCAGTCTGGGCAACAAGAGTGAAACTCTGTCTCAAAAAAAAA"
"chr19","44654213","44654814","JH378118","18053084","18053501","250","26601129","GGCCGGGAATGGTGGCTGACACCTGTAATTCCAGCACTTTAGGAGGCCGAGGCAGGTGGATTATCTGAGGTCAGGAGTTTGAGACCAACCTGACCAACATGGTGAAACCCTGTCTCTATTAAAAATACAAAAATTAGGCCAGGCATGGTGGCTCATGCCTGTAATTCCAACACTTTGGGAGGCTGAGGCAAGTGGATCACGAGGTCAAGAGATTGAGACCATCCTGGCCAACATGGTACAGTCTCATCTCTACTAAAAATACAGAAGTTAGCTGTGCATGGTGGCGCACACCTGTAGTCCCAGCTACTCGGGAGGCTGCGGCAGGAGAATCACTTGAACCTGGGACACAGAGGTTGCAGTGAGCTGAGATTGCACCACTGCACTCTAGCCTGGTGACAGAATTAGACTCTGTCTCAAAAACAAAACAAAAATTAGTTGGGTATAGTGGCGTGTGCCTGTAATCCTAGCTACTCTGGAGGCTGAGGCAGAAGAATTGCTTGAATCCAGGAGGGAGAAGTTGCAGTGAGCCAAGATCACACCATTGCACTCCAACCTGGGTAACAAGAGCGAAATTCCATCTCAAAAAAAAAAAAAAAAAAAAA","GGCTGGGCGCAGTGGCTCACACCTGTAATCCCAGCACTTAGGGAAGCTGAGGCGAGTAGATCACCTGAGGTCAGGAGTTAGAGACCAGCCTGGCCATCATGGTGAAACCCCGTCTCTACTAAAGATACCAAAAATTAGCTGAGTGTGGTGCTGGGTGCCTGTAATCCCAGAAACTCAGGGTGCCTGTAATCCCAGCAACTCAGGGTGCCTTTAATCCCAGCAACTGAGGGTACCAGTAATCCCAGCAACTCAGGGTGTCTTTAATCCTAGCAACTGAGGGCACCTGTAATCCCAGCAACTCAGGAAGCTGAGACAGGAGAAGTACTTGAACCCAGAAGGCAGAGGTTGCAGTGAGCCGATATTGCACCATTGCACTCCAGTCTGGGCAACAAGAGTGAAACTCTGTCTCAAAAAAAAA"
"chr19","44771071","44771693","JH378118","18053084","18053501","263","26717987","GGCCGGGTGCCAAGGCTCACGCCTGTAATACCAGCACTTTGGGAGGCCGAGGCGGGTGGATCACCTGAGTTCAGGGGTTCGAGACCAGCTTAGCCAACGTGGCAAAACCCCGTCTCTACTAAAACACAAAAATTAGCCAGGTGTGGCAGGGCGCGGTGGCTCATGCCTGTAATCCCAGCACTTTGGGAGGCCGAGGTGGGTGGATGATGAGGTCAGGAGATGGAGACTATCCTGGCTAACATGGTGAAACCCCATCTCTACTAAAAATACAAAAAAATTAGCCAGGTGTTGTGGCGGGTGCCTGTAGTCCCAGTTACTCAGGAGGCTGAGGCAGAAGAATGGCACAAACCCGGGAGGCGGAGCTTGCAGTGAGCCGACATTGTGCCACTGCACTCCAGCCTGGGCCACAGAGCGAGACTCCATCTCAAAAATAAATAAACAAAAAAAAAATTAAAAATAAACAATTAGCCAGGCGTGGTGGTGGGTACTTGTAATCCCAGCTACTCAGGAGGCTGAGGCAGGGGAATTGCTTGAACCTGGGAGGCGGAGGTTGCAGTGAGCTGAGATTGCACCATTGCACTCCAGCCTGGGCGACAAGAGCAAAATTCTGTCTCAAAAAAAAA","GGCTGGGCGCAGTGGCTCACACCTGTAATCCCAGCACTTAGGGAAGCTGAGGCGAGTAGATCACCTGAGGTCAGGAGTTAGAGACCAGCCTGGCCATCATGGTGAAACCCCGTCTCTACTAAAGATACCAAAAATTAGCTGAGTGTGGTGCTGGGTGCCTGTAATCCCAGAAACTCAGGGTGCCTGTAATCCCAGCAACTCAGGGTGCCTTTAATCCCAGCAACTGAGGGTACCAGTAATCCCAGCAACTCAGGGTGTCTTTAATCCTAGCAACTGAGGGCACCTGTAATCCCAGCAACTCAGGAAGCTGAGACAGGAGAAGTACTTGAACCCAGAAGGCAGAGGTTGCAGTGAGCCGATATTGCACCATTGCACTCCAGTCTGGGCAACAAGAGTGAAACTCTGTCTCAAAAAAAAA"
"chr19","45101974","45102491","JH378206","6546474","6546861","186","38555500","ACCCTGTCTCAAAAATAAATAAATGAGGCCAGGCAAGGTGGCTCACGCCTATAATCCCAGCACTTTAGGAGGCCGAGGTGGGCAAATCACGAGGTCAAGAAATCGAGACCATTCTGGCCAACATGACGAAACCCTGTCTCCACTAAAAATACAAAAATTAGCTGGACGTGGTAGTGCGTGCCTGTAGTCCCAGCTACTCGGGAGGCTGAGGCAGAAGAATTGCTTGAACCCGGGAGGCGGAGGTTGCAGTGAGCTGAGATCGCACCACTGCACTCCAGCATGGGTGACAGAGCAAGATTCCGTCTCAGACAAAAACAAAAACAAAAACAAAAAACAAAATTAGCTGGGCCTGGTGGCATGTGCCTGTAGTCCCAGCTACTTGGGAGGCTGAGGCAGGAGAATCGCTTGAATCTGGGAGGCGGAGGTTGCAGTGAGCTGAGATCGTGCAGTTGCACTCCAGCCTCACTGACAAGAGCGAAACTCTATCTCAAATAAATAAATAAATAAAATAAATGAAA","GGCCACACATGGTGGCTAACGCCTGTAATCCCAGCACTTTGGGAGGCCAAGTCGGGTGGATCATGAGGTCAGGAGACCAAGACCATCCTGGCCAAATGGTGAAACCCCGTCTCTACTAAAAATACAAAAATTAGCTGGGCATGGTGGCGTGTGCCTGTAATCCCAGCTACTCAGGAGGCTGAGGCAGGACAATTGCCTGAACCCAGGAGAATTAGCTGGGCATGGTGGCGTGTGCCTGTAATCCCAGCTACTCAGGAGGCTGAGGCAGGACAATTGCCTGAACCCAGGAGGCGAAGGTTGCGGTGAGCCGAGATTGTGCCATTGCACTCCAGCCTGGGTAACAAGAGCGACACTCTGTCTCAAAAAAAAAAAAAAAAAAAAAAAAAAA"
"chr19","47830252","47830861","JH378118","18053084","18053501","258","29777168","GCCAGGCACAGTGGCTCATGCTTGTAATCCCAGCACTTTGGGAGGCCGAGGCGAGTGGATCACCTGAGGCCAGGAGTTCGAGACCAGCCTGGCCAACATGGTAAAAACCCATCTCTACTAGAAATATATAAATTAGGCCGGGTGCGGTGGCTCACGCCTGTAATCCCAGCACTTTGGGAGGCCGAGGTGGGTGGATCACGAGGTCAAGAGATCGAGACCATCCTGGCTAACACGGTGAAACCCCGTCTCTACTAAAAATACAAAAAAAATTAGCCGGGCGTGGTGGCGGGCGCCTGTAGTCCCAGCTACTCGGGAGCCTGAGGCAGGAGAATGGCGTGAACCCGGGAGGCGGAGCTTGCGGTGAGCCGAGATTGTGCCACTGCACTCCAGCCTGGGCGACAGAGCAGACTCCGTCTCAAAAAAAAAAAAAGAAATATATAAATTAGCTGGGCGTGGTGGCGGCCGCTTATAATCCCAGCTACTTGGGAGGCTGAGGCAGGAGAATCACTTGAACCCAGGAGGCGGAGGTTGCAGTGAGCTGAGATCGCACAATTGCACTCCAGCCTGGGAGACAAGAGCAAGACTCCGTCTCAAAAAAAAAAGGAAAGAA","GGCTGGGCGCAGTGGCTCACACCTGTAATCCCAGCACTTAGGGAAGCTGAGGCGAGTAGATCACCTGAGGTCAGGAGTTAGAGACCAGCCTGGCCATCATGGTGAAACCCCGTCTCTACTAAAGATACCAAAAATTAGCTGAGTGTGGTGCTGGGTGCCTGTAATCCCAGAAACTCAGGGTGCCTGTAATCCCAGCAACTCAGGGTGCCTTTAATCCCAGCAACTGAGGGTACCAGTAATCCCAGCAACTCAGGGTGTCTTTAATCCTAGCAACTGAGGGCACCTGTAATCCCAGCAACTCAGGAAGCTGAGACAGGAGAAGTACTTGAACCCAGAAGGCAGAGGTTGCAGTGAGCCGATATTGCACCATTGCACTCCAGTCTGGGCAACAAGAGTGAAACTCTGTCTCAAAAAAAAA"
"chr19","49142951","49143543","JH378118","18053084","18053501","226","31089867","GGCCGGGCGCAGTGGCTTACGCCTGTAATTCCAGCACTTTGGGAGGCTGAGGTAGGTGGATTGCCTGAGGTCAGGAGTTTGAGACCAGCCCAGCCAACATGGTGAAACCCCGTCTCTACTAAAAATACAAAAAATTAGGCCGGGCATGGTGGTTCACGCCTGTAATCCCAGCACTTTGGGAGGCCAAGGCGGGTGGATCACGAGGTCAGGGGTTTGAGACCAGCCTGACCAACATGGTGAAACCCCCTGTCTCTACTAAAAATACAAAAATTAGCTGGGCGTGGTGGCGGGTGCCTGTAATCCCAGCTACTCAGGAGGCTGAGGCAGGAGAATTGCTTGAAACCGGGAGGCAGAGGTTGCAGTGAGCTGAGATCGTGCCACTGCACTCCAGCCTGGGCAACAGAGCAAGACTGTGTCTCAAAAAAAAGTAGCCAGGCGTGGTGGCACATGCCTGTAATCCCAGCTATTCAGGAAGCTGAGGCAGGAGAATCACTTGAACCCAGGAAGCAGAGGTTGCAGTGAGCCAAGATGGCGCCATTGCACTCCAGCCTGGACAACAAGAGTGAAACTCCATCTCAAAAAAAAAAAAAAAA","GGCTGGGCGCAGTGGCTCACACCTGTAATCCCAGCACTTAGGGAAGCTGAGGCGAGTAGATCACCTGAGGTCAGGAGTTAGAGACCAGCCTGGCCATCATGGTGAAACCCCGTCTCTACTAAAGATACCAAAAATTAGCTGAGTGTGGTGCTGGGTGCCTGTAATCCCAGAAACTCAGGGTGCCTGTAATCCCAGCAACTCAGGGTGCCTTTAATCCCAGCAACTGAGGGTACCAGTAATCCCAGCAACTCAGGGTGTCTTTAATCCTAGCAACTGAGGGCACCTGTAATCCCAGCAACTCAGGAAGCTGAGACAGGAGAAGTACTTGAACCCAGAAGGCAGAGGTTGCAGTGAGCCGATATTGCACCATTGCACTCCAGTCTGGGCAACAAGAGTGAAACTCTGTCTCAAAAAAAAA"
"chr19","51249770","51250834","JH378118","18053084","18053501","690","33196686","GCTTGAACCTGGGAGAAGGAGGTTGCAGTGAATTGAGATCTATAGGGTCCAGCCCTACGGGGCATAGCAGGTGTTCTCCCCGTGTGCAGAGACAAGAGACTGTAATAAACAAAGACACAAGACAAAGAGATAAAGAGAAAACAGCTGGGCCTGGGGGACCACTACCATCAAGACGCAGAGACCGGTAGTGGCCCCGAACGGCTGGGTGCGCTGATATTTATTGCATACAAGACAAGAGGGCAGGCTAAGAAGGATGAATCCTCTAAGTGATTGACAAGGTGAAGCAAGTCATGTGATCACACGACAGGGGGCCCTTCCCTCTTAGGTAGCCGAAGCAGAGAGAGACAAGGCAGCATACATCAGCGTTTTCTTCTATGCACTTATAAGAAAGATCAAAGACTTCAAGACTTTCACTATTTCTTCTACCACTATCTACTACGAACTTCAAAGAGGAGGCAGGAGTATGGGAGGAACATGAAAGCGGACGAGGAGCGTGAGCATTGAAGCACAGCACCACAGGGAGGGGTTTAGGCCTCCAGATGACTGCAGGCAGTCCTGGATAATATCCAGCCTCCCACAAGAAGCTGGTGGAGCAGAGTGTTCCCTGACTCCTCCAAGGAAAGGAGACTCCCTTTCGTGGTCTGCTAAGTAACAGGTGCCTTCCCGGACACTGGCGTTACCGCTTGACCAAGGAACCTTCAAGCAGCCCTGATGCCGGCGTGACAGAGGGCTCACCTCTTGCCTTCTAGGTCACTTCTCACAATGTCCCTTCAGCACCTGACCCACCGGTTATTCCTAGGTTATATTAGTAATGCAACAAAGAGTAATATTAAAAGCTAATGATTAATGTTTATAATAGTGATTGATAATTGTCCATGATTATCTCGATATCTAATTTGTATTATGACTATTCTTATTGTAACTATTTTCTCTATTATACTGAAACAGTTTGTGCCTTCAGTCTCTTGCCTCCACACCTGGGTGATCCTCCACCCACAGAGATAAAGCCCTGCACTACAGGCTGGACGAGAAGAGCCAAACTCTGACACACACACAAAAAAAGAA","GGCTGGGCGCAGTGGCTCACACCTGTAATCCCAGCACTTAGGGAAGCTGAGGCGAGTAGATCACCTGAGGTCAGGAGTTAGAGACCAGCCTGGCCATCATGGTGAAACCCCGTCTCTACTAAAGATACCAAAAATTAGCTGAGTGTGGTGCTGGGTGCCTGTAATCCCAGAAACTCAGGGTGCCTGTAATCCCAGCAACTCAGGGTGCCTTTAATCCCAGCAACTGAGGGTACCAGTAATCCCAGCAACTCAGGGTGTCTTTAATCCTAGCAACTGAGGGCACCTGTAATCCCAGCAACTCAGGAAGCTGAGACAGGAGAAGTACTTGAACCCAGAAGGCAGAGGTTGCAGTGAGCCGATATTGCACCATTGCACTCCAGTCTGGGCAACAAGAGTGAAACTCTGTCTCAAAAAAAAA"
"chr19","51506118","51506478","JH378181","3341107","3341454","74","48165011","GTGCAGTGGCTCACGCCTGTAATCCTAGCACTTTGGGAGGCCAAGGTGGGCTGATCACCTGTCAGGTGACCAGGTGGCCAGATGACCAGGCTGACCACCTGATCAGGTGACCAGGCTGGTCAGGAGTTTGAGACCAGCCTGGCCAGCATGGTGAAGCCCCATCTCTACTAAAAATACAAGAAAATTAGCCGGGCATGGTGGCAGGCACCTGTAATCCCAGCTACTCGAGAGGCTGAGGCAGGAGAATCACTTGAACCCAGGAAGCGGAGGTTGCAGTGAGCTGAGATCGCACCATTGCACTCCAGCCTGGGAGACAAGAGCAATACTCCATCTCAAAAAAATAAAAATAAAAAATAAAAAA","CAGGTATGGTGGCTCATGCCTATAATCCCAGCACTTTGGGAGGCAGAGGGGGGCGGATCACTTGAGAACAGGAGTTAAAGACCAGCCTGGGGCGGATCGCCTGAGGTCAGGGGTTCAATACCAGCCTGGCCAACATGGTGAAACCCCGTCTCTACTAAAAATACAAAAAATTAGCTGGGCATGGTGGTGCGTGCCTGTAATCCCAGCTACTCAGGAGGCTGAGGCAGGAGAATTGCCTGAACCCAGGAGGCGGAGGTTGCGGTGAGCCGAGATCGCGCCATTGCACTCCAGCCTGGGTAACAAGAGCGAAACTCCGTCTCAAAAAAAAAAAAAAAAAAAAAAAAAAAA"
"chr19","52114549","52115109","JH378118","18053084","18053501","236","34061465","CTTTGGAAGGCTGAGGCAAGTGGATCACTTGCGGTAAGGAGTTGAGACCAGCCTGGCCAACATGGTGAAACACCATCTCTACTGAAAATACAAAAAATTAGGTCAGGCACGGTGGCTCACGCCTGTAATCCCAGCACTTTGGGAGGCCGAGGGGGGCGGATCACAAGGTCAGGAGTTCGAGACCAGCCTGGCCAACATGGCAAAACCCCATCTCTACTAAAAATACAAAAATTAGCTGGGCGTGGTGGCAGACGCCTGTAATCCCAGCTACTTGGGAGGTTGAGGAAGGAGAATTGTTTGAACCGGAGAGGCCAAGTTTGCAGTGAGCCGAGATCACGCCACTGCACTTCAGCCTGGGCAGCAGAGAAAGACTTTGTCTCAAAAAAAAAAAATACAAAAAATTAGGTGGGTGTGGTGGCAGGTACCTGTAATCCCAGCTACTTGGGAGGCTGAGGCAGGAGAATCACTTGAACCAGGAGGCGGAGGTTGCAGTGAGCCAAGATTGTGCCATTGCACTCCATCCTGGGCAACAAGAATGAAACTGCATCTCAAAAAAAAAAA","GGCTGGGCGCAGTGGCTCACACCTGTAATCCCAGCACTTAGGGAAGCTGAGGCGAGTAGATCACCTGAGGTCAGGAGTTAGAGACCAGCCTGGCCATCATGGTGAAACCCCGTCTCTACTAAAGATACCAAAAATTAGCTGAGTGTGGTGCTGGGTGCCTGTAATCCCAGAAACTCAGGGTGCCTGTAATCCCAGCAACTCAGGGTGCCTTTAATCCCAGCAACTGAGGGTACCAGTAATCCCAGCAACTCAGGGTGTCTTTAATCCTAGCAACTGAGGGCACCTGTAATCCCAGCAACTCAGGAAGCTGAGACAGGAGAAGTACTTGAACCCAGAAGGCAGAGGTTGCAGTGAGCCGATATTGCACCATTGCACTCCAGTCTGGGCAACAAGAGTGAAACTCTGTCTCAAAAAAAAA"
"chr19","53268987","53269549","JH378118","18053084","18053501","227","35215903","GGCCAGGCATGGTGGCTCACACCTGTAATCCCAGCACTTTGGGAGGCCGAAGCGGGCGGATCACTTGAGGTCAGGAGCTCAAGACCAGCCTGGCCAACTTGGTGAAACTCCATCTCTACTAAAAATATAAAAATTAGCCGAGTGTAGTAGTGGATGCCTCTTTTTTTTTTTTTTTTTTGAGACAGTTTCACCCTTGTTGTCCAGACTGGAGTGCAATGGCACGATCTCAGCTCACTGCCACCTCCTGGGTTCAAGTGATTCTCCTGCCTTAGCCTCCCAAGTAGCTGGAAATAAACAGGCATGTGCCACCACGCCTGGCTAATTTTGTATTTTTAGTAGAGACGGGGTTTCTCCATGTTGGTCAGGCTGGTCTCGACCTCCCGACCTCAGGTGAGAGCCACTGCGCCCAGCCAGTAGGTGCCTTTAATCCCAGCTACTTGGGAGGCTGAGGCAGGAGAATCACTTGAACCCTGGAGATGGAGGTTGCAGTGACCTGAGATCCTGTCACTACACTCCATCCTGGGCGACAAGAGCAAGACTCCATCTCAGGAAAAAATAAAGAA","GGCTGGGCGCAGTGGCTCACACCTGTAATCCCAGCACTTAGGGAAGCTGAGGCGAGTAGATCACCTGAGGTCAGGAGTTAGAGACCAGCCTGGCCATCATGGTGAAACCCCGTCTCTACTAAAGATACCAAAAATTAGCTGAGTGTGGTGCTGGGTGCCTGTAATCCCAGAAACTCAGGGTGCCTGTAATCCCAGCAACTCAGGGTGCCTTTAATCCCAGCAACTGAGGGTACCAGTAATCCCAGCAACTCAGGGTGTCTTTAATCCTAGCAACTGAGGGCACCTGTAATCCCAGCAACTCAGGAAGCTGAGACAGGAGAAGTACTTGAACCCAGAAGGCAGAGGTTGCAGTGAGCCGATATTGCACCATTGCACTCCAGTCTGGGCAACAAGAGTGAAACTCTGTCTCAAAAAAAAA"
"chr19","56804211","56804825","JH378118","18053084","18053501","264","38751127","GCCAGGCACAGTGGCTTGCACCTGTAGTACCAGTGCTTTAGGAGGCTGAGCCAGGTGGATCGCCTGAGGTCAGGAGTTTGAGACCAGCCTGGCCAACATAGTGAAACCATGTCTCTACTAAAAATACAAAAAACTTGGCCGGGCGCATGGCTCACGCCTGTAATCCCAGCACTTTGGGAGTCTGAGGCGGGCAGATCACGAGGTCAGGAGATCAAGACCATCCTGCCTAACATGGTGAAACCCCATCTCTCCTAAAAATACAAAAAATTAGCCGGGCGTGGTGGCAGGTGCCTGTAGTCCCAGCTACTTGGGAGGCTGAGGCAGGAGAATGGCATGAACCTGGGAGGCAGAGCTTGCAGTGAGCCAAAATCGCACCACTGCACCCCAGCCTGGGCTACAGAGTGAGACTCCATCTCAAACAAAACAAAACCAAAAAAACAAAAAACAAAAAAAAACTAGCTGAGCATTTTGGTGGGCACCTGTGATCCCAGCTACTCGGGAGGCTGAGGCAGGAGAATTACTTGAATCAGGGAGGCGAAGATTGCAGTGAGTCAAGATTGTGCCATTGCACTCCACCCTGGGCAACAAGAGCAAAATTGTGTCTCAAAAAAAAAA","GGCTGGGCGCAGTGGCTCACACCTGTAATCCCAGCACTTAGGGAAGCTGAGGCGAGTAGATCACCTGAGGTCAGGAGTTAGAGACCAGCCTGGCCATCATGGTGAAACCCCGTCTCTACTAAAGATACCAAAAATTAGCTGAGTGTGGTGCTGGGTGCCTGTAATCCCAGAAACTCAGGGTGCCTGTAATCCCAGCAACTCAGGGTGCCTTTAATCCCAGCAACTGAGGGTACCAGTAATCCCAGCAACTCAGGGTGTCTTTAATCCTAGCAACTGAGGGCACCTGTAATCCCAGCAACTCAGGAAGCTGAGACAGGAGAAGTACTTGAACCCAGAAGGCAGAGGTTGCAGTGAGCCGATATTGCACCATTGCACTCCAGTCTGGGCAACAAGAGTGAAACTCTGTCTCAAAAAAAAA"
"chr19","57515369","57515982","JH378118","18053084","18053501","262","39462285","GGCTGGGCACAGTAGCTCACACCTGTAATCCCAGCACTTTGGGAGGCCGAGGCGGGTGGATCACCTGATGTCAGGAGTTTGAGACCAGCCTGGCCAACATGGTGAAACCCTGTCTCTACTTTTTTTTTTTTTTGTCTGAGACAAAGTCTCGCTCTTGTCCCCCAGGCTGGAGTGCAATGGCGCGATCTTGGTTCACTGCAACCTCCGCCTCACAGGTTCAAGCGATTCTCCTGCCTCAGCCTCCTGAGTAGCTGGGATTACAGGCGCCTACCCATGCCCTGCTAATTTTTGTATTTTTAGTAGAGACGGGGTTTCGCCATGTTCGCCAGGCTGGTCTCAAACTCCTGACCTCAGGTGATCTGCCCGCCTCGGCCTCCTAAAGTGCTGGGATTACAGGCATGAGCCACTGTGCCCGGCCCGTCTCTACTAAAAATACAAAAAATTAGCTGGGCGTGGTGGCGGGCGCCCATAATCCCAGCTACTTGGGAGGCAGAGGCAGGAGAATCGCTTGAACCCAGGAGGCGGAGGTTATAGTGAGCTGAGATCGTGCCATTGCACTCCAGCCTGGGCAACAAGTGTGAAAATCCATCTCAAAACAAAACAACAACAAAAAA","GGCTGGGCGCAGTGGCTCACACCTGTAATCCCAGCACTTAGGGAAGCTGAGGCGAGTAGATCACCTGAGGTCAGGAGTTAGAGACCAGCCTGGCCATCATGGTGAAACCCCGTCTCTACTAAAGATACCAAAAATTAGCTGAGTGTGGTGCTGGGTGCCTGTAATCCCAGAAACTCAGGGTGCCTGTAATCCCAGCAACTCAGGGTGCCTTTAATCCCAGCAACTGAGGGTACCAGTAATCCCAGCAACTCAGGGTGTCTTTAATCCTAGCAACTGAGGGCACCTGTAATCCCAGCAACTCAGGAAGCTGAGACAGGAGAAGTACTTGAACCCAGAAGGCAGAGGTTGCAGTGAGCCGATATTGCACCATTGCACTCCAGTCTGGGCAACAAGAGTGAAACTCTGTCTCAAAAAAAAA"
"chr20","6818588","6818858","JH378254","3884530","3884792","59","2934058","GGTCAAGTTTAAGAACTCTGGCCAACATGGTGAAACCCCATTTTTACAAAAATACAAAACAAAACAAAACAAAACAAAAAAAACACATTAGCCTGGCATGATGGTGGGTGCCTGTAATCCCAGCTACTCGGGAGGCTGAGGCTGGAAAATCACTTGAACCTGGGAGGCGGAGGTTGCAGCGAGCCAAGATTGTGCCATTGCATTCCAGCCCAGGCAACAAGAGCGAAACTCAGTCTCAAACAAACAAACAAACAAAAACAAACAAACAAAC","ACCTGAGGTCAGGAATTCGAGACTAGCCTGGCCAACATGGTGAAACCCCATGTCTACTAAAAATACCAAAAAAAAAAAAAAAAAAATTAGCCAGGCGTGGTGGTGGATGCCTGTAATCCCATCTACTCAGGAGGCTGAGGCAGGAGAATCACTTGAACCTGGGAGACAGAGGTTGCAGTGAGCCAAGATTGTGCCATTGCACTCCAACCTGGGAAAGAAGAGTGAGACTTCATCTCAAAAAAAAAAAAAAAAAAAAAAAAAAA"
"chr20","23726313","23726956","JH378118","18053084","18053501","287","5673229","GGCCAGGCACAGTGGCTCAAGCCTGTAATCCCAGCACTTTGGGAGGCCGAGGCGGGCAGATCACCTGAGGTCAGGAGTTTGAGACCAGCCTGGCCAATATGGTGAAATCATATTATACTAAAATATGTACATATGTACTAAACATATGTACTAAAAATACAAAACATTAGGCTGGGCGCAGTGGCTCACGCCTGTAATCCCAACACTTTGGGAGGCTGAGGCGGCCGGATCACAAGGTCAGGAGTTCGAGATCAGCCTGACCAACATGGTGAAACCACGTCTCTACTAAAAATAAAAAAAATTAGCCGGACGTGGTGGCACATGCCTCTACTCCCAGCTACTAAGGAAGCTGAGGCAGGAGAATCGCTGGAACCCAGGAGATGGATGCTGCAGTGAGCCGAGATCACACCACTGCACTCCAGCCTGGGCAACAGAGTAAGACTCCATCTCAAAAAAAAAAAAAAATTAGCTGGGTATGGTGGAACGTGCCTGAAATCCCAACTACTTGGGAGGCTGAGGCAGGAGAATCACTTGAACTGGGAGGCAGAGGTTACAGTGAGCTGAGATTATGCCATTGCACTCCAGCCTGGGCAACAAGAGCAAAACTCGGTCTCAAAAAAAAAAAAGGAAAAGAAAAAAAAAAA","GGCTGGGCGCAGTGGCTCACACCTGTAATCCCAGCACTTAGGGAAGCTGAGGCGAGTAGATCACCTGAGGTCAGGAGTTAGAGACCAGCCTGGCCATCATGGTGAAACCCCGTCTCTACTAAAGATACCAAAAATTAGCTGAGTGTGGTGCTGGGTGCCTGTAATCCCAGAAACTCAGGGTGCCTGTAATCCCAGCAACTCAGGGTGCCTTTAATCCCAGCAACTGAGGGTACCAGTAATCCCAGCAACTCAGGGTGTCTTTAATCCTAGCAACTGAGGGCACCTGTAATCCCAGCAACTCAGGAAGCTGAGACAGGAGAAGTACTTGAACCCAGAAGGCAGAGGTTGCAGTGAGCCGATATTGCACCATTGCACTCCAGTCTGGGCAACAAGAGTGAAACTCTGTCTCAAAAAAAAA"
"chr20","24732516","24733112","JH378118","18053084","18053501","253","6679432","GGCCAGGCGTGGTGGCTCATGCCTGTAATCTCAGCACTTTGGGAGGCCAAGGCAGGCGGATCACCTGAGGTCAGGAGCTCGAGACCAGCCTGACCAACATGGTGAAATCCTGTCTCTACTAAAAATAGAAAAATTGCCAGGTGCGGTGGCTCACGCCTGTAATCCCAGCGCTTTGGGAGGCCAAGGTGGGCGGATCACAAGGTCAGGAGATCGAGACCATCCGGCTAACACAGTGAAAACCCATCTCTACTAAAAATACAAAAAAATTAGCCGGGCATGGTGGCGCATGCCCGGAAGCTGAGACAGGAGAATGGCATGAACCCGAGAGGAGGAGCTTGCAGTGAGCCGAGATCGCGCCACTGCACTCCAGACTGGGCAACGGAGCGAGACTCTGTCTCAAAAAATAAAAAAAATAAAAACAAAAGTAGAAAAATTAGCCAGGTGTGGTGGCAGGTGCCTATAATCCCAGCTACTTGGGTGGCTGAGGCAGGAGGATCGCTTGAACCCGGGAGGTGGAGGTTGCAGTGAACAAAGACCACGCCATTGCACTCCAGCCTGGGCAACAAGAGCAAAACTCCGTCTCAAAAAAAAAAAGAA","GGCTGGGCGCAGTGGCTCACACCTGTAATCCCAGCACTTAGGGAAGCTGAGGCGAGTAGATCACCTGAGGTCAGGAGTTAGAGACCAGCCTGGCCATCATGGTGAAACCCCGTCTCTACTAAAGATACCAAAAATTAGCTGAGTGTGGTGCTGGGTGCCTGTAATCCCAGAAACTCAGGGTGCCTGTAATCCCAGCAACTCAGGGTGCCTTTAATCCCAGCAACTGAGGGTACCAGTAATCCCAGCAACTCAGGGTGTCTTTAATCCTAGCAACTGAGGGCACCTGTAATCCCAGCAACTCAGGAAGCTGAGACAGGAGAAGTACTTGAACCCAGAAGGCAGAGGTTGCAGTGAGCCGATATTGCACCATTGCACTCCAGTCTGGGCAACAAGAGTGAAACTCTGTCTCAAAAAAAAA"
"chr20","27234057","27234995","JH378118","18053084","18053501","563","9180973","GCCAGGGACGGTGGCTCATGCCTGTAATCCAGCATTTCGTTTTTTTGTTTTTTTGTCTTTTGAGACAGAGCCTCGCCCTATCGCCCAGGCTGGAGTGCAGAGGCGCAATCTCGGCTTACTGCAATCTCCACCTCCCAGGTTCAAGTGATTCTCCTGCCTCAGCCTCCTGAGTAGCTGGGATTACAGGCACGTGCCACCATACCCGGCTAATTTTTTTTTTTTGTATTTTTAGTAGAGACAGGGTTTCACCATGTTGGTCAGGCTAGTCTCGAACTCCTGACCTCGTGACCCGCCAGTCTCAGCCTCCCAAAGTACTGAGATTACAGGCGTGAGCCACCACACCCGGCCTATCCCAGCACTTTGGGAGGCCAAGGTGGGTGGATCACTGAGGTCAGGAGATTGAGACCAGCCTGGCCAACATGGTGAAACTCCATCTCTATTAAAAATACAATAATTAGGCCAGGTGCGGTGGCTCACGCCTGCAATCCCAGCACTTTGGGAGGCCGAGGCGGGCGGATCATGAGGTCAGGAGATCGAGACCATCTTGGCTAACACAGTGAAATCCCATCTTTACTAAAAAAATACAAAAAAATTAGCCAGGCGTGGTGGCGGGTGCCTGTAGTCCCAGCTACTCGGGAGGCTGAGGCAGGAGAACGAGGTGAACCTGAGAGGTGGAGCTTGCAGTGAGCTGAGATCACACCACTGCACTCTAGCCTGGGTGACAGAGTGAGACTCCGTCTCAAAAAAAAAAAAAATACAAAAATTAGCTGGGCGTGGTGGCAGGTACCTGTAATCCCAGCTACTCAGGAGAGGAGGCTGAGGCAGGAGAATCACTTAAACCTGGGAGGTGGAGATTGCAGTGAGCAGAGATCATGCCACTGTACTCCAGCATGGATGACAAGAGCAAAACTCTGTCTCCAAAAAAAAAAGCAGAAAGAA","GGCTGGGCGCAGTGGCTCACACCTGTAATCCCAGCACTTAGGGAAGCTGAGGCGAGTAGATCACCTGAGGTCAGGAGTTAGAGACCAGCCTGGCCATCATGGTGAAACCCCGTCTCTACTAAAGATACCAAAAATTAGCTGAGTGTGGTGCTGGGTGCCTGTAATCCCAGAAACTCAGGGTGCCTGTAATCCCAGCAACTCAGGGTGCCTTTAATCCCAGCAACTGAGGGTACCAGTAATCCCAGCAACTCAGGGTGTCTTTAATCCTAGCAACTGAGGGCACCTGTAATCCCAGCAACTCAGGAAGCTGAGACAGGAGAAGTACTTGAACCCAGAAGGCAGAGGTTGCAGTGAGCCGATATTGCACCATTGCACTCCAGTCTGGGCAACAAGAGTGAAACTCTGTCTCAAAAAAAAA"
"chr20","27988398","27989009","JH378118","18053084","18053501","272","9935314","GGCGGGACAGGGTGGCTCACGCCTGTAATCCCAGTGCTTTGGGAGGCCGAGGCGGGAGGATTGCTTGAGCCCAAGATTTTGAGGCCAGTCTGGGCAACCATGCAAGACCCCGTCTCTATTAAAACAACAACAGGCGGGGCCCAGTGGTTCACGTCTGTAATCTCAGCACTTTGGGAGGCCGAGGCGGGTGGATCACCTGAGGTCAGGAGTTGGAGACCATCCTGGCCAACATGATGAAACCCCATCTCTACTAAAAATACAAAAAATTAGCTGGACGTGGTGGTGCATGCCATAGTCCCAGCTACTTGGGAGGCTGAGGCAGAAGAATCACTTGAATCCAGGAGGTGGAGGTTGCAGTGAGTCGAGATCGCGCCACTGCACTCCAGCCTGGTGACAGAACGAGACTTTGTCTCAAAAATTAAAAAAAAAAAAAAAACTAACTGGGCGTGGTGGCAGGCTCCTGTAACCCCAGCTACTTGGGAGGCTGAGGCAGGAGAATCGCTTGAACCCAGGAGGCGGGGGTTGCAGTGAGTTGAGATGGCACCATTGCACTCCAGCCTGGGCGACAAGAAGGAAACTGTCTCAAAAAATATATAAATAAATAAAAATAAA","GGCTGGGCGCAGTGGCTCACACCTGTAATCCCAGCACTTAGGGAAGCTGAGGCGAGTAGATCACCTGAGGTCAGGAGTTAGAGACCAGCCTGGCCATCATGGTGAAACCCCGTCTCTACTAAAGATACCAAAAATTAGCTGAGTGTGGTGCTGGGTGCCTGTAATCCCAGAAACTCAGGGTGCCTGTAATCCCAGCAACTCAGGGTGCCTTTAATCCCAGCAACTGAGGGTACCAGTAATCCCAGCAACTCAGGGTGTCTTTAATCCTAGCAACTGAGGGCACCTGTAATCCCAGCAACTCAGGAAGCTGAGACAGGAGAAGTACTTGAACCCAGAAGGCAGAGGTTGCAGTGAGCCGATATTGCACCATTGCACTCCAGTCTGGGCAACAAGAGTGAAACTCTGTCTCAAAAAAAAA"
"chr20","30887634","30887986","JH378149","15471826","15472166","77","15415808","GGGCGCGGTGGCTCACGCCTGTAATCCCAGCATGTTGGGAGGCCGAGGCGGGCGGACCACCTGAGGTCAGGAGTTCGAGACCAGCAGGGCCATCATGGTAAAATGCCTTCTCTATGAAAAAAACACACACACACACACACACCACACACACACACACACACACACACACACACACACAAAAATTAGCCAGGTGAGGTGATGGGAGCCTGTAATCCCAGCTACTTGGGAGGCTGAGGCAGGAGAATCACTTGAACCTGGGAGGCAGAGGTTGCAGTGAGTCGAGATTATGCCACTACATTCCAGCCTGGGCGACAAGAACAAAACTCCAACTCAAAAATAAATAAATAAATAAA","GGCCGGGCACAGCGGCCCATGCCTGTAATCCCAGCACTTTGGGAGGCCAAGGTGGGTGGACCACATGAGGTCAGGAGTTCAAGACCAGCTCTGCCACGTGGTGAAACCCCATCTCTACAAAAAAAAAAAAAAAAAAAAAAAAAACCAACCCACACAACAAAACAAACATTAGCCAGGTGTGGTGGTATGTGCCTGTAATCCCAGCTAATCGGGAGGTTGAGGCATGAGAATCACTTGAACCTGGGAGGCAGAGTTTGCAGTGAGCCGAGATCATGTCATTGCACTTCAGCCTAGGCAACAAGAGCAAAACTCCATCTCAAAAAAAAAAAAAAAAAAAAAAA"
"chr20","31916504","31916841","JH378109","21598627","21598960","60","10317877","GGCGGGGTGCAGTGGCTCACGCCTGTAATCCCAACACTTTGGGAGGCCGAGGCGGGTGGATCACCTGAGGTCAGAAGTTCGAGATCAGCCTGACCAGCATGGGGAAACCCCGTCTCTACTAAAAATACAAAAAAAATTAGCCAGGCGTGGTGGTGGGCACCTTTAATCCCAGCTACTTGGGAAACTGAGGGAAGAGAATCACTTAAACCCGGGAGGCAGAGGGTGCAGTGAGCCGAGATTGTGCCTCTGCACTCCAGCTGGGGCGACAAGAGTGAAACTCCAACTCAAAATAATAATAATAATAATAATAATAATAATAATAATAATTTAAAAATAAA","GGCTGGGCACAGTGGCTCATGTCTGTAATCCCAGCACTTTGGGAGGCTGAGGCAGGCAGATTACCTGAGGTCTGGAGTTCGAGACCAGCCTGGCCAACATGGTGAAACCCCATCTCTACTAAAAATACAAAAAATTAGCCAGGGATGGTGGTGGGCATCTGTAATCCTAGCTACTTGGGAGGCTGAAGCAGGAGAATTGCTTGAAGCTGGGAGGCAGAGGTTGCAGTGATTTGAGATCCTGCCATTGCACTCCAGCCTGGGCAACAAGAATGAAACTCTGGCTCAAAATTATAATAATGATAATAAAAATAAAAAATAAAAATAAAAATAAAAA"
"chr20","32122923","32123506","JH378118","18053084","18053501","258","14069839","TGGCTCACGCCTGTAATGTCAGCACTTTGGGAGGCCGAGGCGGGCGGATCATGAGGTCAAGACATGGAGACCACCCTGGCCAACATGGTGAAACCCTGTCTCTACTAAAAACACAAAAATAGGCTGGGCATGATGGCTCACGCCTGTAATCCCAGCACTTTGGGAGGCCAACGCAGGTGGATCACGAGGTCAGGAGTTGAAGACCAGCCTGGCCAGGATGGTGAATCCCCATTTCTACCAAAACTACAAAAATTAGCCAGGTGCGGTGGCAGGCACCTGTAATCCCAGCTGCTCGGGAGGCTGGGGAGGAAGAATCGCTTAAGCCCGGGTGGCAGAGGTTGCAGTGAGCCAAGACTGCGCCACTGCACTCCGGCCTGGGCGACAGACCAAACTCCATCTCCAAAAAAAAAAAAAAAAAAAAAAAATTAGCCAGGCGTGGTGGCGGGCGCCTGTAATCCCAGCTACTCGGGAGGCTGAGGCAGGAGAACTGCCTGAACCCAGGAGGCAGAGGTTGCTGTGAGCTGAGATCGCGTCATGGCGCTCCAGCCTGGGTGACAAAAACGAAACTCTGTCTCAAAGAAAAA","GGCTGGGCGCAGTGGCTCACACCTGTAATCCCAGCACTTAGGGAAGCTGAGGCGAGTAGATCACCTGAGGTCAGGAGTTAGAGACCAGCCTGGCCATCATGGTGAAACCCCGTCTCTACTAAAGATACCAAAAATTAGCTGAGTGTGGTGCTGGGTGCCTGTAATCCCAGAAACTCAGGGTGCCTGTAATCCCAGCAACTCAGGGTGCCTTTAATCCCAGCAACTGAGGGTACCAGTAATCCCAGCAACTCAGGGTGTCTTTAATCCTAGCAACTGAGGGCACCTGTAATCCCAGCAACTCAGGAAGCTGAGACAGGAGAAGTACTTGAACCCAGAAGGCAGAGGTTGCAGTGAGCCGATATTGCACCATTGCACTCCAGTCTGGGCAACAAGAGTGAAACTCTGTCTCAAAAAAAAA"
"chr20","32402375","32402963","JH378118","18053084","18053501","262","14349291","GTAGCCCCAGCACTTTGGGAGGCTGAAGCGGGCGGATCACTTGAGGTCAGGAGTTCAAGACCAGTCTGGCCAACATGGTGAAATCCCGTCTCTGCTAAAAATACAAAAATTAGTTGGGGCCAGGCATGGTGGCTCACACCTGTAATCCCAGCATTTTGGGAGGCTGAGGCAGGTTGGATCACTTGAGGTCAGGAGTTCAAGACCAGACTGGCCAACATGGTGAAACCCCATCTCTACTAATAATACAAAAATTAGCCAGGCATGGTGGCACACACCTGTAATCCCAGCTACTCGGGAGGCTGAGGCAGGAGAATCACTTGAACCTGGGAGGCGGAAGTTGCAGTGAGCTGAGATCGTGCCATTGCACTTAAAGCCTGGGGGACAAGAGTAAAACTCCGTCTCCAAAAAAAAAACCAAAACCCAAACCAAAAAGCCAGGTATGGTGGCAGGCACCTGAAATCCCAGCTATTTGGGAGGTTGAGGCACAAGAATTGCTTGAACTCAGGAGGCGGAGGTTGAAGTGAGCCGAGATTGTGCCACTGCACTCCTCTTGGGTGACAAGAGCGAAACTCCATCTCAAAAAAAAAAA","GGCTGGGCGCAGTGGCTCACACCTGTAATCCCAGCACTTAGGGAAGCTGAGGCGAGTAGATCACCTGAGGTCAGGAGTTAGAGACCAGCCTGGCCATCATGGTGAAACCCCGTCTCTACTAAAGATACCAAAAATTAGCTGAGTGTGGTGCTGGGTGCCTGTAATCCCAGAAACTCAGGGTGCCTGTAATCCCAGCAACTCAGGGTGCCTTTAATCCCAGCAACTGAGGGTACCAGTAATCCCAGCAACTCAGGGTGTCTTTAATCCTAGCAACTGAGGGCACCTGTAATCCCAGCAACTCAGGAAGCTGAGACAGGAGAAGTACTTGAACCCAGAAGGCAGAGGTTGCAGTGAGCCGATATTGCACCATTGCACTCCAGTCTGGGCAACAAGAGTGAAACTCTGTCTCAAAAAAAAA"
"chr20","33094448","33095003","JH378118","18053084","18053501","237","15041364","GCAGGTAGATCACCTGAGATCAGGAGTTCGAGACCAGCCTGGCCAACATGGTGAAACCCTGTCTCTACTAAAAATACAAAAATTAGGCCAGGCATGGTGGCTCACACCTATAATCCCAGCACTTTGGGAGGCTGAGGTGGGCAGATCACCTGAGGTTGGGAGTTCAAGACCAATCTGACCAACATGGAGAAACCCCATCTCTACTGAAAATACAAAATTAGCCGGGCATGTGTGTGCCTGTAATCCCAGCTACTTGAGAGGCTGAGGCAGGATGATTGCTTGAACCTGAGAGGTGGAGGTTGAGGTGAGCCGAGATCTCACCATTGCACTCCAGCCTGGTCAACAAGAGCGAAACTCCATCTCAAAAAAAAAAAAAAAAAAAAAAAAAATTAGCTGGGCATGGTGGCAGGTGCCTGTCATCCCAGCTATTTGGGAGGCTGAGACAGGAGAATGGCTTGAACCCGGAGGCGGAGGGTGCAGTGAGCTGAGATTGAGCCTTTGCACTGCAGCCTGGTTGACAAGAATGAAACTCTGCCTCAAAAACAAACAAAAAAAA","GGCTGGGCGCAGTGGCTCACACCTGTAATCCCAGCACTTAGGGAAGCTGAGGCGAGTAGATCACCTGAGGTCAGGAGTTAGAGACCAGCCTGGCCATCATGGTGAAACCCCGTCTCTACTAAAGATACCAAAAATTAGCTGAGTGTGGTGCTGGGTGCCTGTAATCCCAGAAACTCAGGGTGCCTGTAATCCCAGCAACTCAGGGTGCCTTTAATCCCAGCAACTGAGGGTACCAGTAATCCCAGCAACTCAGGGTGTCTTTAATCCTAGCAACTGAGGGCACCTGTAATCCCAGCAACTCAGGAAGCTGAGACAGGAGAAGTACTTGAACCCAGAAGGCAGAGGTTGCAGTGAGCCGATATTGCACCATTGCACTCCAGTCTGGGCAACAAGAGTGAAACTCTGTCTCAAAAAAAAA"
"chr20","33337896","33338479","JH378119","32351107","32351490","248","986789","GGCCAGGTGCGGTGGCTCGCACCTGTAATCTCAGCACTTTGGGAGGCTGAGGCAAGTGGATCACTTGAGGCCAGGAGTTCAAGACCAGTCTGGCCAACATGGTGAAACCCCATCTCTACTAAAAGTACAAAAATCAGTGGGGCAGCAGGGCGCGGTAGTCCCAGCACTTTGGGAGGCTGAGGCGGGCAGATCACAAGGTCAGGAGATCGAGACCATCCTGGCTAACATGGTGAAACCCTGTGTCTGCCAAAAAATACAAAAAAGTAGCCGGGCATGGTGTCAGGCACCTGTAGTCCTAGCTACTCGGGAGGCTGAGGCAGGAGAATGGCATGAACCCGGGAGGTGGAGCTTGCAGTGAGCCAAGATCACGCCACTGCACTCCAGCCTGGGAGACAGAGCAAGACTCTGTCTCAAAAAAAAAAAAAATTAGTGGGGCATGGTGGTGGGCACCTGTAATCCTAGCTACTCAGGAGGCTAAGGCAGGAGAATAACTTGAAGCCGGGAGGCAGAGGTTGCAGTGAGCCGAGATACTCCAGCCTGGGTGAACAAGAGACTGTCTCAAAAAAACAAATGAACAAACAAAA","GGCCAGGTATGGTGGCTCACACCTGTAATCCCAGCACTTTGGGAGGCCAAGGCAGGCAGACCACCTGAGGTCAGGAGTTCGAGATCAGCCTAGCCAACATGGTGAAACCCCATCTCTAGTAAAAATAAAATTAGCCAGGCATGGTGGTGCATGCCTGTAACGCAGGTCAGGAGTTCGAGATCAGCTTAGCCAACATGGTGAAACCCCATCTCTAGTAAAAATAAAATTAGCCAGGCAGGTGGTGCCGCCTGTACTCGGGAGGCTGAGGCAGGAGAATCACTTGAACCCAAGAGGCAGAGGTTGCAGTCAGCCAAGATCATGCCATTGCACTCCAGCCTAAGCAAAAAGAGTAAAACTCAGTCTCAAAACAAAAAAACAAAAAAA"
"chr20","33345944","33346530","JH378114","15957391","15957789","247","17388553","GCCAGGCGCAGTGGCTCACGCCTGTAATCCTAGCACTTTGGGAGGCTGAGGCGGGTGGATCACCTGAGGTCAGGAGTTCGAGACCAGCCTGGCCAACATGGCAAAACCCTGTCTCTACTAAAATTACAAAAATTAGCCGGGTGGCCAGGCGTAGTAGCTCACACCTGTAATCCCAGCACTTTGGGAGGCCGAGGCGGGTGGATCACAAGGTCAGGAGTTCAAGACTAGTCTGGCCAACATGATGAAACCCCGTCTCTACTAAAAATACAAAACAATTAGCCGGGCGTTGTAGCAGGTGCCTGTAATCCCAGCTACTTGAGAGCCTGAGGCAGAGAATTACTTGAACCTGGGAGGCGGAGGTTGCAGTGAGCTTAGATCACACCACTGCACTCCAGCCTGGGCAACAGAGCGAGACTCCGTCTCAAAAAAAAAAAAAAAAAAAAAATTAGCCGGGCGTGATGGCAGCCGCCTGTAATCCCAGCTACTCAGGAGGCTGAGGCAGGAGAATCGCTTGAACCTGGGAGGCAGAGGTTGCAGTGAGCCATAGCCTGGGAGACAAAAGTGAAACTCCATCTCAAAAAAAAAAA","GCAAGGAACGGTGGCTCATGCCTGTCATCCCAGCACTTTGGGAGGCTAAGGAGGGTGGATTACCGAAGGTCATGAGTTTGAGACCAGCCTGACCAACATGGTGAAAACCCCATCTCTACTAAAAATACAAAAAATTAGCCAGATACAGCTATGCGGCAGACTGGGGCAGGAGAATCGCTTGGACCCAAACCCCATCTCTACTAAAAATACAAAAAATTAGCCGGATACAGCTATGCGGGAGACTGGGGCAGGAGAATCGCTTGGACCCGGGAGGCAGAGATTGCAGTGAGATGAGACCATGCCATTGCTCTCTAGCTTGTGCGATGAGAACAAGACTCTGTCTCAAAAAAAAAAAAAAAAAAAAAAAAAAAAAAAAAAAAAAAAGAGAGAGAGAGAAAA"
"chr20","38069068","38069418","JH378107","51614077","51614407","62","13545009","GCTGGGCGTGGTGGCTCATACCTGTAATCCCAGCACTTTGGGAAGCCAAGGCAGGCAGGTCACCTGAGGTCAGGAGTTCAGAGACCAGCCTGGCCAACATGGTGAAACCCCATCTGTACTAAAAATACAAAAATTAGCTGGGCGTGGTGGCGGGCGCCTATAATATCAGCTACTTGGGAAGCTGAGGCAGGAGAATTGCTTGAACCCGGGAGGCAGAGGTTGCAGTGAGCCAAGATTGCACCATTGCTCTCCAGCCTGGGCAACAAGAGAGAAACTCTGTCTCAAAATACATACATACATACATACATACATACATACATACATACATACATAAAATAAAGAAAAAGAAAA","GCTGGGCGTGGTGGCTCATGCCTGTAATCTCAGCATTTTGGGAAGCCAAAGTGGATGGATCACCTGAGATCAGGAGTTCAAGACCAGCCTGACCAACATGGTGAAAACTTGTCTCTACTAAATACAAAAATTAGCTGGGCATGATGGTGTATGCCTCTAGTCCCAGCTACTTGGGAGGCTGAGGCAGGAGAATTGCTTGGACCTGGGAGGCAGAGGTTGCAGTGAGCCAAGATTGTACCATTGCACTTCAGCTTGGGCAATAAGAGTGAAACTCTGTCTCAAAATAAATAAATAAATAAATAAATAAATAAATAAATAAATAAATAAATAA"
"chr20","40131162","40131781","JH378118","18053084","18053501","265","22078078","GGCAGGGTGTGGGGACTCATGCCTGTAATCCCAGCACTTTGGGAGGCCGAGGTAGGCAGATCACCTGAGGTCAGGAGTTCGAGATTAGCCTGGCCAACATGGTGAAACTCCGTCTCTACTAAAAATACAAAAATTAAGACCGGGCATGGTGGCTCACGCCTGTAATCCCAGCACTTTGGGAGGCCGAGGTGGGCAGATCACGAGGTCAGGAGTTCGAGACCAGCCTGGCCAGCATGGTGAAACCCTGTATCTACTAAAAATACAAAAAAAAAAAAATTAGCTGGGCATGGTGGTGCATGCCTGTAATCCCAGCTACTCAGGAGGCTGAGGCAGGAGAATTGCTTGAACCCGGGAGGCAGAGATTGCAGTGAGCCAAGATCATGCCACTACACTCCAGCCTGTGTGACAGAGCAAGACTGTCTCAAAAAAAAAAAAAAAAATTAGCTGGATGTGGTGGCTCACGCCTGTAATCACACCTTCTCGGAAGGCTGAAGCAGGAGAATCACTTGAACCCAGGAGGCGGAGGTTGCAGTGAGCTGAGATTATGCCATTGCCCTCTAGCCTGGGTGACAAGAGCGAAACTCCATCTCAAAAAAAAAAAAAAAGAAAGAAAGAAAGAA","GGCTGGGCGCAGTGGCTCACACCTGTAATCCCAGCACTTAGGGAAGCTGAGGCGAGTAGATCACCTGAGGTCAGGAGTTAGAGACCAGCCTGGCCATCATGGTGAAACCCCGTCTCTACTAAAGATACCAAAAATTAGCTGAGTGTGGTGCTGGGTGCCTGTAATCCCAGAAACTCAGGGTGCCTGTAATCCCAGCAACTCAGGGTGCCTTTAATCCCAGCAACTGAGGGTACCAGTAATCCCAGCAACTCAGGGTGTCTTTAATCCTAGCAACTGAGGGCACCTGTAATCCCAGCAACTCAGGAAGCTGAGACAGGAGAAGTACTTGAACCCAGAAGGCAGAGGTTGCAGTGAGCCGATATTGCACCATTGCACTCCAGTCTGGGCAACAAGAGTGAAACTCTGTCTCAAAAAAAAA"
"chr20","42650945","42651280","JH378144","13229286","13229620","46","29421659","GGCTGCGCACGGTGGCTTACGCCTGTAATCCCAGCACTTTGGGAGGCCGAGGCAGGTGGATCACCTGAGGTCAGGAGTTTGAGACAAGCCTAGTCAATATGGTGAAACCCTGTCTCTACTAAAAATACAAAAATTAGCCAGGCGTGGTGGCAGGTGCTTGTAATCCCAGCTACTCGGGAGGCTGAGGCCAGCAGAATCGCTTGAACCTGGGAGGCGGAGGTTGCAGTGAGCCGAGGTCGCGCCAGTGCGCTCCAGCCTGGGCAACAAGAGCGAAACTCCATCTCAATAAATAAATAAATAAATAAATAAATAAATAAATAAAAATAAAAAGGGAAA","GGCCGGGCGCGGTGGCTCAAGCCTGTAATCCCAGCACTTTGGGAGGCCGAGGCGGGTGGATCACCTGTGGTCAGGAGTTCAAGACAGCTTGGTCAACATGGTGAAACCCCGTCTCTACCAAAAATACAAAAAATTAGCTGGGCATGGTAGCGCATGCCTGTAATCCCAGCTACTCAGGAGGCTGAGGCAGGAGAATTGCCTGAACCCAGGAGGCAGAGGTTGCGGTGAGCCGAGATCGCGCCATTGCACTCCAGCCTGGGTAACAAGAGCGAAACTCCCTCTCATAAAAAATAAATAAATAAATAAATAAATAAATAAATAAATAAATAAATAAA"
"chr20","43813059","43813679","JH378118","18053084","18053501","268","25759975","GGCCGGGCATGGTGGCTCACGCCTGGAATCCCAGCTCTTTGGGAGGCCGAGGCGGGTGGATCACCTGAGGTCAGGAGTTCGAGACCAGCCTGGGCAACGTGGCGAAACCCCGTCTCTACTAAAAAATACAAAAATTAGCTGGTGGGCCGGATGTGGTGGCTCACGCCTGTAATCCCATAACTTTGGGAGGCCGAGGCAGGCGGATCACGAGGTCAGGAGTTCAAGACCAGCCTGGCCAACATGGTGAAACCCCGTCTCTACTAAGAAATACAAAGAATTAGCCGGGCGTGGTAGCGGGCACCTGTAATCCCAGCTACTCAAGAGGCTGAGGCAGGAGAATTGCTTGAACTTGGGAGGCAGAGGTTTCAGTGAGCTGAGACTGCACCATTGCACTCCAGCCTGGGCCACGTGCAAGACTCCGTCTCAAAAAAATAAATAGACAAATAAAATAAAATAAAATTAGCTGGGTGTGGTGGCATGTGCCTGTAATCCCAGTTACTCAGGAGGCTGAGGGAGGAGAATTGCTTGAACCAGGAGGTGGAGATTTATGCCATTGCACTCCAGCCTGGGCAATAAGAATGAAACTCCGTCTCAGAAAAAAAACAAAACAAAATGAAAAAA","GGCTGGGCGCAGTGGCTCACACCTGTAATCCCAGCACTTAGGGAAGCTGAGGCGAGTAGATCACCTGAGGTCAGGAGTTAGAGACCAGCCTGGCCATCATGGTGAAACCCCGTCTCTACTAAAGATACCAAAAATTAGCTGAGTGTGGTGCTGGGTGCCTGTAATCCCAGAAACTCAGGGTGCCTGTAATCCCAGCAACTCAGGGTGCCTTTAATCCCAGCAACTGAGGGTACCAGTAATCCCAGCAACTCAGGGTGTCTTTAATCCTAGCAACTGAGGGCACCTGTAATCCCAGCAACTCAGGAAGCTGAGACAGGAGAAGTACTTGAACCCAGAAGGCAGAGGTTGCAGTGAGCCGATATTGCACCATTGCACTCCAGTCTGGGCAACAAGAGTGAAACTCTGTCTCAAAAAAAAA"
"chr20","45655019","45655975","JH378118","18053084","18053501","570","27601935","GCCGGGCACAGTGGCTCACGCCTGTAATCCCAGCACTTTGGGAGGCCAAGGTGGGTTGATCACCTGAAGTCAGGAGTTCGAGGCTAGGCTGGCCAACATGGTGAAATCCCATCTCTACTAAAAATACAAAAATTAGGCTGGCACGGTGACTCACGCCTGTAATCCCAACACTTTGGGAGGCCAAGGCAGGTGGATCACCTGAGATCAGGAGTTCAAGACCAGCCTGGCTAACATGGTGAAACACTGTCTCTACTAAAAATAAAAAAAATTAGTCTGGCATGGTGGCGCATGCCTGTAATCCCAGCTACTTGGGAGGCTGAGGCTGAACAATCACTTGAACCCGGAAGGCAGAGGTTGCAGTGAATTGAGATTGGGTCACTGCACTCCAGCCTGGGTAACAGAGCGAGACTCTGCCTCAAAAATAAAATAAAATAAAAATATAAAAATTACCCAGGCATGGCCAGGCGCAGGGGCTCACGCTTGTAATCCCAGCACTTTGGGAGGCCAAGGCGAGTGGATCACAAGGTCAGGAGATCAAAACCATCCTGGCTAACACAGTGAAACACCGTGTCCACTAAAAAAATAAAAAATAAAAAAAAAATAACCGGGCATAGTGGTGGGCACCTGTAGTCCCAGCTACTCCAGAGGCTGAGGCAGGAGAATGGCATGAACCCGGGAGGCAGAGCTTGCAGTGAATCGAGATCACGCCACTGCACTCCAGCCTGGGCGACAGAGCAAGACTCCGTCTCAAAAAAACAAACAAACAAACAAAAAAAATTAGCCAGGCATGGTGGTATGCGCCTGTAATCTCAGCTTCTCGGAAGGCTGAAGTGGGAAAATTGCTTGAACCTGGGAGGTGGAGGTTGCAATGAGCCGAGATCACGCCACTGCACTCCAGCCTGGGCGACAAGAGCAAAACTCCATCTCAAAAAAAAAAAAAAAAAAAAGAAGATAAAA","GGCTGGGCGCAGTGGCTCACACCTGTAATCCCAGCACTTAGGGAAGCTGAGGCGAGTAGATCACCTGAGGTCAGGAGTTAGAGACCAGCCTGGCCATCATGGTGAAACCCCGTCTCTACTAAAGATACCAAAAATTAGCTGAGTGTGGTGCTGGGTGCCTGTAATCCCAGAAACTCAGGGTGCCTGTAATCCCAGCAACTCAGGGTGCCTTTAATCCCAGCAACTGAGGGTACCAGTAATCCCAGCAACTCAGGGTGTCTTTAATCCTAGCAACTGAGGGCACCTGTAATCCCAGCAACTCAGGAAGCTGAGACAGGAGAAGTACTTGAACCCAGAAGGCAGAGGTTGCAGTGAGCCGATATTGCACCATTGCACTCCAGTCTGGGCAACAAGAGTGAAACTCTGTCTCAAAAAAAAA"
"chr20","46071700","46072043","JH378148","10302642","10302970","57","35769058","GGCCAGGCGCGGTGGCTCACGCCTGTAGTCCCAGCATTTTGGGAGGCTGAGGTGGGTGGATCGCATGAGGTCGGGAGTTCAAGATCAGCCTGGCCAACATAGTGAAACCCCGTCTCTACTAAAAACACAAAAATTAGCCAGGCATTGTGGTGGGTGCCTATAATCCCAGCTACTTGGGAAGCTGAGGCAGGAGAATCATTTGAATCCGGGAGGTGGAGGTTGCAGTGAGCCGAGATTGCACCATTGCACTCCAGCCTGGACAACAAGAGTGAGACTCCGTCTCAAATAATAATAATAATAATAATAATAATAATAATAATAATAATAATTTAAAACAAAATAAA","GGCCGGGCGCGGTGGCTCAAGCCTGTAATCCCAGCACTTTGGGAGGCCGAGGCGGGTGGATCACGAGGTCAAGAGATCGAGACCATCCTGGTCAACATGGTGAAACCCCGTCTCTACTAAAAATACAAAAAATTAGCTGGGCATGGTGGTGGGTGCCTGTAATCCCAGCTACTCAGGAGGCTGAGGCAGGAGAATTGCCTGAACCCAGGAGGCGGAGGTTGCGGTGAGCCGAGATCGCGCCATTGCACTCCAGCCTGGGTAACAAGAGTGAAACTCTGCCTCAAAAAAAAAAAATAAAATAAAATAAAATAAAATAAAATAAAATAAAA"
"chr20","47188261","47188596","JH378203","8017835","8018160","63","39170426","GGCCTGGCGTGGCGGCTCATGCCTGTAATCCTAGCACTTTGGGAGGCCGAGGCAGGCGGATCACTTGAGGTCAGGAGTTTGAAATCAGCCTGGCCAACATGGTGAAACCCCGTCTCTACTGAAAATATAAAAAATTAGCCGGGCATGGTGGCAGGTGCCTGTAATCCCAGCTAGGATTATCGCTTGAACCCAGGAGGCAGAGGTTGCAGTGAGCCGAGGTCACGCCATTGCACTCCAGCCTGGGCAATAAGAGCGAAACTCCGTCTCAAAAATAAATAAATAAATAAAATAAAATAAATAAAAATAAGTAAATAAATAAATCATAAAAATAATAAA","GGCCGGACGCGGTGGCTCAAGCCTGTAATCCCAGCACTTTGGGAGGCCGAGGCGGGTGGATCATGAGGTCAAGAGATCGAGACCATCCTGGTCAACATGGTGAAACCCCGTCTCTACTAAAAATACAAGAAATTAGCTGGACGTGGTGGCGCGTGCCTCTAATCCCAGCTACTCAGGAGAATTGCCTGAACCCAGGAGGCGGAGGTTGCGGTGAGCCCAGATCGCGCCATTGCACTCCAGCCTGGGTAACAAGAGCGAAACTCGGTCTCAAAAAAAAAAAAAAAAGAAAAAGAAAAAGAAAGAAAAAGAAAGAAAAGAAAAGAAAA"
"chr20","48200752","48201358","JH378118","18053084","18053501","246","30147668","GGCCAGGCGCGGTGGCTCACCCCCCGTATTCCCAGCACTTTGGGAGGTCAAGGCGGGTGGATTACCTGAGGTCAGGAGTTCAAGACCAGCCTGACCAACATAGTGAAACCCCGTCTCTACAAAAAATACAAAAAAATTAGGCTGGGCACGGTGGCTCATGCCTGTAATCCCAGCACTTTGGGAGGCCAAGGCGGATGGATCACCTGAGGTCGGGAGTTCAAGACCAGCCTAACCAACATGAGGAAACCCCATCTCTACTAAAAATACAAAATTAGATGGGTGTGGTGGCGCATGCCTGTAATTCAAGCTACTTGGAAGGCTGAGGCAGGAGAACTGCTTGAACCCAGGAGATAGAGGTTGTGGTGAGCCGAGATCATGCCACTGTACTCCAGCATGGGCAACAAGAGTGAGACTCCATCTCAAAAAAAAAAAAAAATTAGCCAGGCGTGGTGGTGGGCACCTGTAATCCCAGCTACCCTGGAGGCTAAGGCAGGAGAATTGCTTGAACCCAGGAGGCGGAGGTTGCAGTGAGCCCAGATTGCACCATTGCACTCCAGTCTGGGCACCAAGAGCAAAACCCTGTCTCAAAAAAATAAATAAATAAAAA","GGCTGGGCGCAGTGGCTCACACCTGTAATCCCAGCACTTAGGGAAGCTGAGGCGAGTAGATCACCTGAGGTCAGGAGTTAGAGACCAGCCTGGCCATCATGGTGAAACCCCGTCTCTACTAAAGATACCAAAAATTAGCTGAGTGTGGTGCTGGGTGCCTGTAATCCCAGAAACTCAGGGTGCCTGTAATCCCAGCAACTCAGGGTGCCTTTAATCCCAGCAACTGAGGGTACCAGTAATCCCAGCAACTCAGGGTGTCTTTAATCCTAGCAACTGAGGGCACCTGTAATCCCAGCAACTCAGGAAGCTGAGACAGGAGAAGTACTTGAACCCAGAAGGCAGAGGTTGCAGTGAGCCGATATTGCACCATTGCACTCCAGTCTGGGCAACAAGAGTGAAACTCTGTCTCAAAAAAAAA"
"chr20","48222879","48223486","JH378118","18053084","18053501","262","30169795","GGCCAGGGTCAGTGGCTCACGCCTGTAATCTCAGCATTTTGGGAGGCCAAGGCGGGCGGATAACTTGAGGTCAGGAGTTCGAGGCCAGCTTGGCCAATATGGTGAAGCCCCATCTCTACCAAAAATACAAAAATTAGGCCAGGCGTGGTGCTCATGCCTGTAATCCCAGCACTTAGGGAGGCTGAGGTGAGCGGATCATGAGGTCAAGAGATCGAGACCATCTCGGTCAACATGGTGAAACCCCATCTCTACTAAAAATACAAACAATTAGCTGGGCGTGGTGGCATGCGCCTGTAGTCCCAGCTACTCCGGAGGCTGGGGCAGGAGAACTGCTTGAACCAGGAGGCAGAGATTGCAGTGAGCCAAGATCACACCACTGCACTCCAGCCTGGTGACAGAGCAAGACTCTGTCTCAAAAAAAAAAAAAAAAATACAAAAATTAGCTGGGCGTGGTGGCGGGCGCCTGTAATCCCAGCTACAGCAGGAGGCTGATGCATGAGAATCGCTTGAACCCGGGAGGTGGAGGTTGCAGTGAGTTGAGATCATGCCACTGCACTCCAGCCTGGGTGACAAGAGCGAGACCCTGTCTAAAAACAAACAAACAAAAA","GGCTGGGCGCAGTGGCTCACACCTGTAATCCCAGCACTTAGGGAAGCTGAGGCGAGTAGATCACCTGAGGTCAGGAGTTAGAGACCAGCCTGGCCATCATGGTGAAACCCCGTCTCTACTAAAGATACCAAAAATTAGCTGAGTGTGGTGCTGGGTGCCTGTAATCCCAGAAACTCAGGGTGCCTGTAATCCCAGCAACTCAGGGTGCCTTTAATCCCAGCAACTGAGGGTACCAGTAATCCCAGCAACTCAGGGTGTCTTTAATCCTAGCAACTGAGGGCACCTGTAATCCCAGCAACTCAGGAAGCTGAGACAGGAGAAGTACTTGAACCCAGAAGGCAGAGGTTGCAGTGAGCCGATATTGCACCATTGCACTCCAGTCTGGGCAACAAGAGTGAAACTCTGTCTCAAAAAAAAA"
"chr20","50101592","50102208","JH378118","18053084","18053501","264","32048508","GGCCAGGCATGGTGGCTCACGCCTGAAATCCCAGCACTTTGAGAGGCGGAGGCAGGTGGATCACCTGAGGTCAGGAGTTTGAGACCAGCCTGACCAATATGATGAAACCCTGTGTCTACTAAAAATGCAAAAATTAGCCGGATGTGGTGGCAGGCACCTGTAATTCCAGCTACTTTTCTTTATTTTTTTTTTTTGAGACGGAGTCTCACTCTGTCGCCAGGCTGGAGTGCAGTGGCGCGATCTCAGCTCACTGCAACCTCTGCCCTCCGAGTTCAAGCGATTCTTCTGCCTCAGCCTTCCAAGTAACTGGGATTACAGGTGCCTGCCACTGCACCCGGCTAATTTTTTGTATTTTTAGTAAAGACGGGGTTTCACCTTCTTGGCCAGGCTGGTCTTGAACTCCTGACCTCGTGATCCACCCGCCTCGGCCTCCCAAAGTGCTGGGATTACAGGTGTGAGCCACCGCACCCGGCCAATCCCAGCTACTTATGAGGCTGAGACAGGAGAATCGCTTGAACCCAGGAGGCGGAGGTTGCAGTGAGCTGAGATCGTGCCATTGTACTCCAGCCTGGGCAACAAGAGCGAAACTCCATCTCAAAAAAAAAAGAAGAAGAAAA","GGCTGGGCGCAGTGGCTCACACCTGTAATCCCAGCACTTAGGGAAGCTGAGGCGAGTAGATCACCTGAGGTCAGGAGTTAGAGACCAGCCTGGCCATCATGGTGAAACCCCGTCTCTACTAAAGATACCAAAAATTAGCTGAGTGTGGTGCTGGGTGCCTGTAATCCCAGAAACTCAGGGTGCCTGTAATCCCAGCAACTCAGGGTGCCTTTAATCCCAGCAACTGAGGGTACCAGTAATCCCAGCAACTCAGGGTGTCTTTAATCCTAGCAACTGAGGGCACCTGTAATCCCAGCAACTCAGGAAGCTGAGACAGGAGAAGTACTTGAACCCAGAAGGCAGAGGTTGCAGTGAGCCGATATTGCACCATTGCACTCCAGTCTGGGCAACAAGAGTGAAACTCTGTCTCAAAAAAAAA"
"chr20","53118378","53118971","JH378118","18053084","18053501","237","35065294","GGCTGGGTGTGGTGGCTCACGCCTGTAATCCCAGAACTTTGGGAGGCCGAGGCAGGTGAATCACCTGAGGTCAGGAGTTCAAGACCAGCCTGGCCAACATAGTGAAACCCCATCTCTACTAAAAATGCAAAAATTAGGCCAGGCGGGGTGGCTCACACCTGTAATCCCAACACTTTAGGAGGCTGAGGTGGGCAGATCACCTGAGGTCGGGAGTTCGAGACCAGCCTGACTAACATGGAGAAATCCCATCTCCTCTAAAAATACAAAATTAGCCAGGCGTGGTGGCACACGCCTGTAATCCCAGCTACTCGGGAGGCTGAGGCAGGAGAATCGCTTGAACCTGGGAGGTGGAGGTTGCAGTAAGCTGAGATTGCGCCATTGCACTCCAGCCTGGGCTACAAGAGCAAAACTCCGTCTCAAAAAAAAAAAATAGCTGGGCATGGTGGGGCATGCCTGTAGTCCCAGCTACTCAGGAAGCTGAGGCAGGAGAATTGCTTGAACCCAGGAGATGGAGGTTGCAGTGAGCCAAGATAGCACCATTGCACTCCAGCCTGGGTGATGAGAGCAAAACTCAGTCTCAAAAAAAAAAAAAAA","GGCTGGGCGCAGTGGCTCACACCTGTAATCCCAGCACTTAGGGAAGCTGAGGCGAGTAGATCACCTGAGGTCAGGAGTTAGAGACCAGCCTGGCCATCATGGTGAAACCCCGTCTCTACTAAAGATACCAAAAATTAGCTGAGTGTGGTGCTGGGTGCCTGTAATCCCAGAAACTCAGGGTGCCTGTAATCCCAGCAACTCAGGGTGCCTTTAATCCCAGCAACTGAGGGTACCAGTAATCCCAGCAACTCAGGGTGTCTTTAATCCTAGCAACTGAGGGCACCTGTAATCCCAGCAACTCAGGAAGCTGAGACAGGAGAAGTACTTGAACCCAGAAGGCAGAGGTTGCAGTGAGCCGATATTGCACCATTGCACTCCAGTCTGGGCAACAAGAGTGAAACTCTGTCTCAAAAAAAAA"
"chr20","54841147","54841464","JH378105","46221579","46221896","48","8619568","GGGCATGGTGGCTCACGCCTGTAATTCCAGCACTTTGGGAGGCCAAGGCAGGTGGATCACCTGAGGTCAGGAGTTCGTGACCAGCCTGGCCAACATGGTTAAACTCTGTCTCTACTAAAATTACAAAAAAAAAAAAAAAAAAAAAAAAATTAGCCAGGCATGCTGGCGCACACCTGTAATCCCAGCTATTCAGGAGACTGAGGCAGGAGAGTCACTTGAACCTGGGAGGCAGAGGTTGCAATGAGCCGAGATCACGCCATTGCATTCCAGCCTGGGCAACAAGAGCGAAACTCCATCTCAAAATAAAAGTAAATAAAA","GACTGGGTGTGATGGCTCATGCCTGTAATCCCAGCACTTTGGGAGGCCAAGGCGGGTGGATCACCTGAGGTCAGGAGTTCAAGACCAGCCTGACCAACATGGTGAAACCCCGTCTCTACTAAAAAAAAAAAAAAAAAAAAAAAACTACAAAATTAGCTGGGCCTGGTGGTACACACCTATAATCCCAGCTACTTGGGAGGCTGAGGCAGGAGAGTTACTTGAACCCAGGAGGCAGAGGTTGCAGTGAGCTGAGATCATGCCATTGCACTCCATCCTGGGCAACAAGAGCGAAACTCTGTCTTAAAAAAAAAAAAAAAA"
"chr20","55572273","55572612","JH378109","21565230","21565567","50","34007043","GGCCGGGCGCAGTGGCTCACACCTGTAATCCTAGCACTTTGGGAGGCCGAGGCAGGTGCATCACCTGAGGTCAGGAGTTTGAGACCAGCCTGACCAACATGGCAAAACCCTGTCTCTACTAAAAGTGCAAAAATTAGCTGGGCATGGTGGTGGACGCCTGTAATCCCAGCTACTTGAGAGGCTGAGGCAGGAGAATTGCTTGAACCCAGGAGGTGGAAGTTGCAGTGAGCCAAGATTGTGCTACTGCACTCCAGCCTAGGTGACAAGAGTGAAACTCTGTCTCAAAAAAAAAATAAATAAATAAAAATAAATAAATAAATAAATAAAAGAAAGAAAGAAA","GGCCGGGCGCGGTGGCTCAAGCCTGTAATACCAGCACTTTGGGAGGCCGAGGCGGGTGGATCACGAGGTCAAGAGATCGAGACCATCCTGGTCAACATGGTGAAACCCCGTCTCTACTAAAAATACAAACAATTAGCTGGGCATGGTGGCGGGTGCCTGTAATCCCAGCTACTCCAGAGGCTGAGGCAGGAGAATTGCCTGAACCCAGGAGACGGAGGTTGCGGTGAGCCAAGATCGCGCCATTGCACTCCAGCCTGGGTGACAAGAGCGAAACTCCGTCTCAATAAATAAATAAATAAATAAATAAATAAAAATAAAATAAATAAATAAATAAATAA"
"chr20","55784227","55784475","JH378310","1393884","1394095","65","54390343","TGGAACCCCACCTCTACTAAAAATACAAAAATTAGCTGGGCATGGTGGCAGGTGCCTGTAATCCCAGCTACTTAGCAGGCTGAGGTAGGAGAATCGCTTGAACCCAGGAGGTGGAGGTTGCAGTGAGCTGATATCAAGCCAGTACACTCCAGCCTGGATGACAGAACAACAGAGTGAGACTCTGTCTCACAAAAATAAATAAATAAATAAATAAATAAATAAATAAATAAATAAATAGAAATAAAGAAA","GTGAAACCCCGTCTCTACTAAAAATACAAAAAATTAGCTGGGCATGGTGGCATGTGCCTGTAATCCCAGCTACTCAGGAGGCTGAGGCAGGAGGAATTGCTTGAAGCTGGGAGGTGGAGGTTGCAGTGAGCTGGCATCATGCCATTGCACTCCAGCCTGGATGACAAGAGCAAAACTTTGTCTCAAAAAAAAAAGAAAGAAAGAAAGAAAAA"
"chr21","11951797","11952150","JH378153","13131650","13131982","65","1179853","GGCTGGGCACAGTGGCTCACACCTATAATCCCAACACTTTGGGAGGCCAAGGTGGATGGATCACCTGAAGTCGGGAGTTCGAGACCAGCCTGGCCAACATAGTGAAAGCCTATCTCTACTGAAAACACAAAAATTAGCCAGGCGTGGCGGCACGTGCCTGAAATCCCAGCTACTCAGGAGGCTGAGGCAGGAAAATTGCTTGAACCTGGGAGGTGGAGATTGCAGTGAGCAGAGACTGTGCCATTGCACTCCAACCTGGGCAACAAGAGCAAAACTCTGTCTCAAAAATAAAATAAAATGAAATAAAATAAAATAAAATAAAATAGTAAAAATAATGAAACAAAGGAACAAAAA","GGCTGGGCGCGGTGGCTCACGCCTGTAATCCCAGCACTTTGGGAGGCCGAGGCGGGTGGATCATGAAGTCAAGAGATCAAGACCATCCTGGTCAATATGGTGAAACCCGTGTCTACTAAAAATACAAAAATTAGCTGGGCATGGTGGCGCGTGCCTGTAATCCCAGCTACTCAGGAGGCTGAGGCAGGAGAATTGCCTGAACCCAGGAGGCGGAGGTTGTGGTGAGCCGAGATCGCGCCATTGCACTCCAGCCTGGGTAACAAGAGCGAAACTCTGTCTCAAAAAATAAATAAATAAAATAAAATAAAATAAAATAAAATAAAATAAAATAAA"
"chr21","21185024","21185637","JH378118","18053084","18053501","253","3131940","GACTGGGCACAGTGGCTCGCACCTGTAATCGCAGCACTTTGGGAGGCTAAGGCAGGTGGATCACCTGAGGTCAGGAGTTGGAGACCAGCCTGGCCAAAATGGTGAAATCCCATCTCTACTAAAAAAAATAAAAATTAGGCCGGGCCGGGTGGCTCACGCCTGTAATCCCAGCACTTTGGGAGGCCGAGGCGGGTGGATCACGAGGTCAGGAGATTGAGACCATCCTGGCTAACATGGTGAAACCCCGTCTCTACGAAAAATACAAAAAATTAGCCGGGCGTGGTGGCATGCGCCTGTAGTCCCAGCTACTCGGGAGGCTGAGGCAGGAGAACGGCGTGAACGCAGGAGGCGGAGCTTGCAGTGAGCCGAGATTGCTCCACTGCACTCCAGCCTGGGTGAAGAGCCAGACTCCGTCTCCAAATAAATAAATAAATAAACAAATGAAAATTAGCTGGGCGTGGTGACGGGCACCTCCAATCCCAGCTACTTGGGAGGCTGAGGTAGGACAATCACTTGAACCCAGGAGGCAGAGGTTGCAGTGAGCCATGATCGCACCATTGCACTCCAGCCTGGGCAATGAGAGTGAAACTCCATCTCAAAAAAAAAAAAAAAAA","GGCTGGGCGCAGTGGCTCACACCTGTAATCCCAGCACTTAGGGAAGCTGAGGCGAGTAGATCACCTGAGGTCAGGAGTTAGAGACCAGCCTGGCCATCATGGTGAAACCCCGTCTCTACTAAAGATACCAAAAATTAGCTGAGTGTGGTGCTGGGTGCCTGTAATCCCAGAAACTCAGGGTGCCTGTAATCCCAGCAACTCAGGGTGCCTTTAATCCCAGCAACTGAGGGTACCAGTAATCCCAGCAACTCAGGGTGTCTTTAATCCTAGCAACTGAGGGCACCTGTAATCCCAGCAACTCAGGAAGCTGAGACAGGAGAAGTACTTGAACCCAGAAGGCAGAGGTTGCAGTGAGCCGATATTGCACCATTGCACTCCAGTCTGGGCAACAAGAGTGAAACTCTGTCTCAAAAAAAAA"
"chr21","32196575","32197275","JH378118","18053084","18053501","330","14143491","GGCCGGGCGCGGTGGCTCACGCCTATAATCCCAACACTTTGGGAGGCTGAGGCAGGTGGATTGCCTGAGGTCAGGAGTTCGAGACCAGCCTGGCCAACATAGTGAAACCCCGTCTCTACTAAAAATACAAAAAATTAGCTGGGCGCGGTGGTGGGTTTCACTTGCATCCATGTGAAGAGACCGCCAAACAGGCTTTGTGAGAGCAATAAAGCTGTTTATTTCACCTGGGTGCAGGTGGGCTGCGTCCAAAAAGAGAGTCAGCGAAGGGAGATAAGGGTGGGGCCGTTTTATAGGATTTGGGTAGATAAAGGAAAATTACAGTCAAAGGGGGGTTGTTCTCTGGCGGGCAGAGTGGGGGTCACAAGGTGCTCAGTAGGGGAGCTTTTGAGCCAGGAGAAGCAATTTCACAAGACACTGTCATCAGTTAAGGCAGGAACAGGCCATTTTCACTTCTGTGGAATGTCATCAGTTAAGGCAGAAACCGGCCATCTGGAGGTGTACATGCAGGTCACAGGGGATATGATGGCTTAGCTTGGGCTCAGAGGCCTGATGGTGGGCGCCTGTAATCCCAGCTACTTTGGAGGCTGAGGCAGGAGAATCGCTTGAACCCGGGAGGCGGAGGTTGCAGTGAGCCGAGATTGTGCCATTGCACTCCAGCCTGGGCAACAAGAGCGAGACTCCATCTTAAAAAAAAAAAAAGA","GGCTGGGCGCAGTGGCTCACACCTGTAATCCCAGCACTTAGGGAAGCTGAGGCGAGTAGATCACCTGAGGTCAGGAGTTAGAGACCAGCCTGGCCATCATGGTGAAACCCCGTCTCTACTAAAGATACCAAAAATTAGCTGAGTGTGGTGCTGGGTGCCTGTAATCCCAGAAACTCAGGGTGCCTGTAATCCCAGCAACTCAGGGTGCCTTTAATCCCAGCAACTGAGGGTACCAGTAATCCCAGCAACTCAGGGTGTCTTTAATCCTAGCAACTGAGGGCACCTGTAATCCCAGCAACTCAGGAAGCTGAGACAGGAGAAGTACTTGAACCCAGAAGGCAGAGGTTGCAGTGAGCCGATATTGCACCATTGCACTCCAGTCTGGGCAACAAGAGTGAAACTCTGTCTCAAAAAAAAA"
"chr22","4569386","4569984","JH378118","18053084","18053501","255","13483698","GGCTGGGCACGGTGGCTCATCCCTTTGGGAGGCAGAGGCAGGCGGATCACCTGAGGGCAGGAGTTCGAGACCAGCCTGGCCAACATGGTGAAACCTTGTCTCTACTAAAAATACAAAAATTCGCTGGGAGTGGCCGGGCACGGTGACTCACGCCTGTAATCCCACCACTTTGGGAGGCCGAGGCGGGTGGATCACCTGAGGTCAGGCATTTGAGACCAGCCTGCCCAACATGGTAAAACCCCGTCTCTACTAAAAATACAAAAAATTAGCTGGGCTTGGTGGCGGGCTCCTGTAATCCCAGCTACTCTGGAGAGTGAGGCAGGAGAATCACTTGAACCCGGGAGGCGGAAGTCGCAGTGAGCTGAGATCGCACCATTGCATTCCAGCCTGGGTGACAGGAGTGAAACTCCCTCACAAAACAAAAACAAAAATTAGCTGGGAATAGTGGTGGGCACCTGTAATCCCAGCTGCTTAGGAGGCTGAGGCAGGAGAATTGCTTGAAACCTGGGAGGCAGAGGTTGCAGTGAGCCAAGATGGTGCCATTGCACTCCAGCCTAGGTGATGAGAGCGAAACTCTGTCTCAGTTAGAAAAAAAAAAA","GGCTGGGCGCAGTGGCTCACACCTGTAATCCCAGCACTTAGGGAAGCTGAGGCGAGTAGATCACCTGAGGTCAGGAGTTAGAGACCAGCCTGGCCATCATGGTGAAACCCCGTCTCTACTAAAGATACCAAAAATTAGCTGAGTGTGGTGCTGGGTGCCTGTAATCCCAGAAACTCAGGGTGCCTGTAATCCCAGCAACTCAGGGTGCCTTTAATCCCAGCAACTGAGGGTACCAGTAATCCCAGCAACTCAGGGTGTCTTTAATCCTAGCAACTGAGGGCACCTGTAATCCCAGCAACTCAGGAAGCTGAGACAGGAGAAGTACTTGAACCCAGAAGGCAGAGGTTGCAGTGAGCCGATATTGCACCATTGCACTCCAGTCTGGGCAACAAGAGTGAAACTCTGTCTCAAAAAAAAA"
"chr22","4930580","4931171","JH378206","6546474","6546861","251","1615894","GCCTGGCGCGGTGGCTCGACACTCTAGGAGGCCGAGGCAGGTGGATCACCTGAGGTCAGGAGTTTGAGACCAGACTGGCCAATATGGTGAAACCCCATCTCAACTAAAAATACAAAAATTAGGCCGGGCTTGGTGGCTCATGCCTGTAATCCCAGCACTTTGGGAGGCGGAGGTGGACGGATCACGAACTCAGAAGATCGAGACCATCCTGGCTAACACTGTGAAACCCCATCTCTCCTAAAAATACAAAAAATTAGCCAGGCATGGTGGCGGGCGCCTGTAGTCCCAGCTACTTGGGAAGCTGAGGCAGGAGAATGGCATGAACCCGGGAGATGGAGCTTGCAGTGAGCCGAGATTGCGCCACTGTACTTCAGCCTGGGTGACAGAGTGAGACTCCGTCTCAAAAAAAAGAATTAGCCAGACATGGTGTGGGCACCTGTAATCCCAGCTACTTGGGAGGCTGAGGCAGAAGAATCGCTTTAACCTGGGAGGCAGAGGTTGCAGTGAGCCGAGATCGTGCCTTTGCACTCCAGCCTGGGCAACAAGGGCGAAACTCCATCTCAAAAAAATAAATAAGTAAAATAAAAAATAA","GGCCACACATGGTGGCTAACGCCTGTAATCCCAGCACTTTGGGAGGCCAAGTCGGGTGGATCATGAGGTCAGGAGACCAAGACCATCCTGGCCAAATGGTGAAACCCCGTCTCTACTAAAAATACAAAAATTAGCTGGGCATGGTGGCGTGTGCCTGTAATCCCAGCTACTCAGGAGGCTGAGGCAGGACAATTGCCTGAACCCAGGAGAATTAGCTGGGCATGGTGGCGTGTGCCTGTAATCCCAGCTACTCAGGAGGCTGAGGCAGGACAATTGCCTGAACCCAGGAGGCGAAGGTTGCGGTGAGCCGAGATTGTGCCATTGCACTCCAGCCTGGGTAACAAGAGCGACACTCTGTCTCAAAAAAAAAAAAAAAAAAAAAAAAAAA"
"chr22","5065728","5066233","JH378118","18053084","18053501","196","12987356","AGCCTGCCCAACACGGCGAAACCCCATCTCTACTAAAAATACAAAAAATTGGCCGGGCGTGGTGGCTTATGCCTGTAATCCCAGAACTTTGGGAGGCTGAGGCGGGCGGATCACGAGGTCAGGAGATCAAGACCATCCTGGCTAACATGGTGAAACCCTGGCTCTACTAAAAAATTTAAAAAAAAACATTAGCCAGGTGTGATGGTGGGCACCTGTAGTCCCAGCTACTCGGGAGGCTGAAGCAGGAGAATGGCGTGAACCCGGGAGGCGGAGCTTGCAGTGAGCCGAGATCGCACCACTGCACTCCAGCCTGGGTGACAGAGTGAGACTCTCTCAAAAAAAAAAAAAAAAAAAATTAGCCAGGCATGGTGGCGGGCGCCTGTAATCCCAGCTACTCAAGAGGCTGAGTCAGGAGAATTGCTTGAACCGGGGAGGCAAAGGTTGCAGTGAGCCGAGATTACATCACTGCACTCCAGCCTGAGCGACAAGAGTGAAACTCCATCTCA","GGCTGGGCGCAGTGGCTCACACCTGTAATCCCAGCACTTAGGGAAGCTGAGGCGAGTAGATCACCTGAGGTCAGGAGTTAGAGACCAGCCTGGCCATCATGGTGAAACCCCGTCTCTACTAAAGATACCAAAAATTAGCTGAGTGTGGTGCTGGGTGCCTGTAATCCCAGAAACTCAGGGTGCCTGTAATCCCAGCAACTCAGGGTGCCTTTAATCCCAGCAACTGAGGGTACCAGTAATCCCAGCAACTCAGGGTGTCTTTAATCCTAGCAACTGAGGGCACCTGTAATCCCAGCAACTCAGGAAGCTGAGACAGGAGAAGTACTTGAACCCAGAAGGCAGAGGTTGCAGTGAGCCGATATTGCACCATTGCACTCCAGTCTGGGCAACAAGAGTGAAACTCTGTCTCAAAAAAAAA"
"chr22","5155565","5156464","JH378118","18053084","18053501","519","12897519","CCAGGCGCGATGGCTCACGCCTGTAATCCCAGCACTTTGGGAGGCTGAGGCGGCTGATCACCTGAGGTCAGGAGTTCGAGACAAGCCTGGCCAACATGGCGAAACCCATCTCTATTAAAAATACAAAAAAAAAAAAAAAAAAAGGCTAGGTGCGGTGGCTCACACCTGTAATCCCAGCATTTTAGGAGGCGGAGAGGGGAGGATCAATTGAGGTTGGGAGTTCACGACCAGCCTGACCAACATGGAGAAACCCCGTCTCTACTAAAAGTACAAAATTAGCCAGGCCTGGTGGTGCATGCCTGTAATCCCAGCTACTCGGGAGGCTGAGGCAAGAGAATCGCTTGAACCCAGGAGGCGGAGGTTGTGGTGAGCCGAGATCACGCCATTGCACTCCAGCCTGGACAACAAGAGTGAAACTGTCTCAAAAGAAAGGCCGGTGCAGTGGCTCACACCTGTAATCCCAGCACTTTGGAAGGCTGAGGCGGATGGATCACGAGGTCTGATCGAGAACATCCTGGCCAACATGGTGAAACCCCGTCACTACTAAAAATACAAAAATTAGCTGGGCGTGGTGGTGTATGCCTGTAATCCCAGCTACTCAGGAGGCTGAGGCAGGAGAATCACTGGAACCCGGGAGGCGGAGGTTGCAGTGAGCCAAGATCACACCACTGCACTCCAGCTTGGCGACAGAGCGAGACTCCGTCTCAAAAAAAAAAAAAAAAAAAAAAAAAATTGGCCAGGCGTGGTGGTGGGCGCCTGTAATCCCAGCTACTGGGGAGACTGAGGCAGGAGAATCGCTTGAACCTGGGAGGCGGAGGTTGCAGTGAGCCGAGATCTCGCTGTTGCACTCCAGCCTGAGGAACAGGAGAGAAACTCCGTCTCAAATAGATAAATAAATAA","GGCTGGGCGCAGTGGCTCACACCTGTAATCCCAGCACTTAGGGAAGCTGAGGCGAGTAGATCACCTGAGGTCAGGAGTTAGAGACCAGCCTGGCCATCATGGTGAAACCCCGTCTCTACTAAAGATACCAAAAATTAGCTGAGTGTGGTGCTGGGTGCCTGTAATCCCAGAAACTCAGGGTGCCTGTAATCCCAGCAACTCAGGGTGCCTTTAATCCCAGCAACTGAGGGTACCAGTAATCCCAGCAACTCAGGGTGTCTTTAATCCTAGCAACTGAGGGCACCTGTAATCCCAGCAACTCAGGAAGCTGAGACAGGAGAAGTACTTGAACCCAGAAGGCAGAGGTTGCAGTGAGCCGATATTGCACCATTGCACTCCAGTCTGGGCAACAAGAGTGAAACTCTGTCTCAAAAAAAAA"
"chr22","7594951","7595280","JH378127","6796468","6796795","44","798483","GCCGGGCGCAGTGGCTCAGGCCTGTAATCCCAACACTTTGGGAGGCCGAGGTGGGCGGATCACCTGAGGTCAGTAGTTCAAGACCAGCCTGGCCAACATGGCGAAACCCTATCTCTACTAAAAATACAAAAATCAGTGGGGTGTGGTGGCAGGTGCCTGTAATCCCAGCTACTCGGGAGGCTGAGGCAGGAGAATTGCTTGAACACAGGAGGTGGAGGTTGCAGTGAGCCGAGATCGCACCATTGCACTCCAGCCTGGGCAACAAGAGTGAAACTCTGTCTAAAAACAAAACAAAACAAAACAAAACAAAAAAAGGAAATGCAAAACAAA","GGCCGGGCGCGGTGGCTCAAGCCTGTAATCCCAGCATTTTGGGAGGCCGAGGCGGGTGGATCACGAGGTCAGGAAATCGAGACCATCCTGGTCAACATGGCGAAACCCCATGTCTACTAAAAATACAAAAATTAGCTGGGCATGGTGGCACGTGCCTGTAATCCCAGCTACTCAGGAGGCTGAGGCAGGAGAATTGCCTGAACCCAGGAGGCGGAGCTTGCAGTGAGCCGAGATCGCGCCATTGCACTCCAGCCTGGGTAACAAGAGCGAAACTCCGTCTCAAAAAAACAAACAAAAACAAAACAAAACAAAACAAAACAAAAAAAAC"
"chr22","10422443","10422769","JH378250","1133852","1134171","42","9288591","GGCCAGGTGCGGTGGCTCGCGCCTCTAATCCCAGCACTTTGGGAGGCCCAGGTGGGCGGATCACCTGAGGTCAGGAATTCAAGACCAGCCTGGACAACATGGTGAAACCCCATCTCTACTAAAAATACAAAAATTAGCCAAGCATGGTGGTGGGCACCTGTAATCCCAGCTACTGGGGAGGCTGAGGCAGGAGAATCGCTTGAACCCAGGAGGTGGAGGTTGCAGTGAGCCGAGATCACGCCATTGCACTTCAGCCTGGGCAACAAGAGTGAGACTCCCACTCAAAAATAAATAAATAAATAAATAAATAAAAAGGAAAGAAAGAAA","GGCCGGGTGCGGTGGCTCAAGCCTGTAATCCCAGCACTTTGGGAGGCTGAGGCGGGTGGATCACCTGAGGTCAGGAGTTCAAGACCAGCCTGGTCAACATGGTGAAACCCCGTCTCTACTAAAAATACAAAAAATTAGCTGGGCGTGGTGGCGCGTGCCTGTAATCCCAGCTACTCAGGAGGCTGAGGCAGGAGAATTGCCTGAACCCAGGAGGCGGAGGTTGCGGTGAGCCGAGATCACGCCATTGCACTCCAGCCTGGGTAACAAGAGCGAAACTCCGACTCAAAAAAATAAATAAATAAATAAAATAAAAAATAAAT"
"chr22","12896070","12897231","JH378118","18053084","18053501","760","5157014","GGCTGGGCAAGGTGACTCACGCCTGTAATCCCAGCTCTTTGGGAGGCAGAGGTGGGGATCCCCTCAGGTCAGGAGTTCAAGACCAGCCTGGCCAACATGGTGAAACCTTATCTGCCGAGACCAGCTCGGTCAGGAAGACCCTAACCCAGCGGCGCTAGAGGAATTAAAGACACACACACAGAAATATAGAGGTGTGAGGCCGGGAGCGGTGGCTCATGCTTGTAATCCCAGCACTTTCGGAGGCCGAGGCAGGCGGATCAGGAAGTCAGGAGATCAAGACTATCCTGGCTAACACGGTGAAACCCCGTCTCTACTAAAAATACACAAAATTAGCCGGGCATGGTGGTGGGCACCTGTAGTCCCAGCTACTCGGGAGGCTGAGGCAGGAGAATGGCGTGAACCCGGGAGGCGGAGCTTGCTTGCAGTGAGCCGAGATCGTGCCACTGCACTCCAGCCTGGGCGAGAGTGAGACTCTGTCTCAAAAAAAAAAAAAAAAAAAAAAAAAAAAAAGGAAATATACAGGTGTGAAGTGGGAAATCAGGGGTCTTACAGCCTTCAGAGCTGAGAACCCCGAACAGAGATTTACCCACATATTTATTAACAGCAAACCAGTCATTAGCATTGTTTCTATAGATATTAAATTAACTAAAAGTATCCCTTAAGGGAAACGAAGGGATGGGCCGAATTAAAGAAATAGGTTGGGCTAGTTAACTGCAGCAGGAGCATGCTCTTAAGGCATAAATCGCTTATGCTATTGTTTGTGGCTTAAGAATGCCTTTAAGCGGTTTTCTGCCCTGGGCGGGCCAGGTGTTCCTTGCCCTCATTCCCGTAAACCCACAGCCTTCCAGCTTGGGTGTTATAGCCATTATGGACATGTTACATTGCTGTAGAGATTTTATTTATGGCCAGTTTTGGGGCCAGTTTATGGCCAGACTTTGGGGGGGCTTGCTCCCAACAGCTGTCTCTACCTAAAAATAACAAAAATTAGCTGGGCGTGGTGGCGGGTGCCTGTAATCCCAGCTACTCAGGAGGCTGAGGCAGGAGAATCGCTTGAACCCAGGAAGGGGAGGTTGCAGTGAGCCGAGATCGCACCATTGCACTCCAACCTGGGCAACAAAAGTGAAACTCTGTCTCAAAAAAAAAAAAAAGAAAAGAAAAGAAA","GGCTGGGCGCAGTGGCTCACACCTGTAATCCCAGCACTTAGGGAAGCTGAGGCGAGTAGATCACCTGAGGTCAGGAGTTAGAGACCAGCCTGGCCATCATGGTGAAACCCCGTCTCTACTAAAGATACCAAAAATTAGCTGAGTGTGGTGCTGGGTGCCTGTAATCCCAGAAACTCAGGGTGCCTGTAATCCCAGCAACTCAGGGTGCCTTTAATCCCAGCAACTGAGGGTACCAGTAATCCCAGCAACTCAGGGTGTCTTTAATCCTAGCAACTGAGGGCACCTGTAATCCCAGCAACTCAGGAAGCTGAGACAGGAGAAGTACTTGAACCCAGAAGGCAGAGGTTGCAGTGAGCCGATATTGCACCATTGCACTCCAGTCTGGGCAACAAGAGTGAAACTCTGTCTCAAAAAAAAA"
"chr22","13375853","13376488","JH378118","18053084","18053501","284","4677231","GCCAAGTACGGTGGCTCATGCCTATAATCCCAGCACCTTGGGAGGCCAAGGCAGGTGGATTGCCTGATGTCAGGAGTTCGACACCAGCCTGGCCAACATGGAGAAACCCCGTCTCTACTAGAAATACAAAAAATTGGCCAGTAGTGGTGGTTCACACCTATAATCCCAGAACTTTGGGAGGCCAAGATGGGAGGATCACGAGGTCAGGAGATCGAGACCATCCTGGTAAACACAGTGAAACCCTGTCTCTACTAAAAATACAAAAAATTAGCCGGGCATCATGGTGGGTGCCTGTAGTCCCAGCTACTTGGGAGGCTAAGGTAGGAGAATGGCATGAACCTGGGAGGTGGAGCTTGCAGTGAGCTGAGATGGTGCCACTGCACTCCAGCCTGGGCGACAGAGCGAGACTCTGTCCAAAAAAAAAAAAAAAAAAAAGCAACAAACAAACAAACAAAAAACACACACAGACACAAAATTAGCTGGGCAGGGTGGTGGGCACCTGTAATCCCAGCTACTCAGGAGGCTGAGGCGGGAGAATCACTTGAACCCCGGAGGCGGAGGCTCCACTGAGCCGAGATTGTGCCATTGCACTCTAGCCTGGACAACAAGAGCGAAACTCCATCTTAAAAAAAACAA","GGCTGGGCGCAGTGGCTCACACCTGTAATCCCAGCACTTAGGGAAGCTGAGGCGAGTAGATCACCTGAGGTCAGGAGTTAGAGACCAGCCTGGCCATCATGGTGAAACCCCGTCTCTACTAAAGATACCAAAAATTAGCTGAGTGTGGTGCTGGGTGCCTGTAATCCCAGAAACTCAGGGTGCCTGTAATCCCAGCAACTCAGGGTGCCTTTAATCCCAGCAACTGAGGGTACCAGTAATCCCAGCAACTCAGGGTGTCTTTAATCCTAGCAACTGAGGGCACCTGTAATCCCAGCAACTCAGGAAGCTGAGACAGGAGAAGTACTTGAACCCAGAAGGCAGAGGTTGCAGTGAGCCGATATTGCACCATTGCACTCCAGTCTGGGCAACAAGAGTGAAACTCTGTCTCAAAAAAAAA"
"chr22","13378543","13378878","JH378117","16180246","16180577","54","2801703","GGCTGGGCGCAGGGGCTCACGCCTGTCATCCCAGCACTTTGGGAGGCGGAGGCGGGTGGATCACCTGAGGTCAGGAGTTCCAGACCAGCTTGGCCCACATGGTGAAACCCTGTCTCTACTAAAAATACAAAAAAAAAAAAAAAAAAAAAAAAAAAAAAAAAATTGCCAGGTGTGGTAGTGAGCACTTGTAATCCCAGCTACTCAGGAGGCTGAAGCAGGGAATCGCTTGAACCCAGGAGGTGGAAAATGCAGTAAGCTGAGATTGTGCCATTGCACTCCAGCCTGGGCAACAAGAGCGAAACTCCATCTCAAAACAACAATAAAACAAAAAGAAAA","GGCCGGGCGCGGTAGCTCAAGCCTGTAATCCCAGCACTTTGGGAGGCTGAGGCGGGTGGATCATGAGGTCAAGAGATCGAGACCATCCTGGTCAACATGGTGAAACCCCGTCTCTACTAAAAATACAAAAAAAAAAAAAAAAAAAAAAAAAAAAAATTAGCTGGGCATGGTGGCGCTTGCCTTTAATCCCAGCTACTCAGGAGGCTGAGGCAGGAGAATCACCTGAACCCAGAAGGCGGAGGTTGCGGTGAGCTGAGATCACGCCATTGCACTCCAGCCTGGGTAACAAGAGCGAAACTCCGTCTCAAAAAAAAAAAAAAAAAAAAAAAGAA"
"chr22","13514377","13514925","JH378118","18053084","18053501","216","4538707","CCAAGGTGGGTGGATCACTTGAGGTCAGGAGTTTGAGAGTAGCCTGGCCAACATGGTGAAACCCCATCTCTACTAAAAATACAAAAAACTGCCAGGTGCAGTGGCTCACACCTGTAATCCTAGACTTTGGGAGGCTGAGGCTGGTGGATCACCTGAGGTTGGGAGTTTGAGACCAGCCTGACCAACATGGAGAAACCCCATCTCTACCAAAAATACAAAATTAGCCGGGCATGGTGGTGCATGCCTGTAATCCCACTACTTGGGAGGCTGAGGCAGGAGAATTGCTTGAACCCAGGAGGCAGAGGTTGCAGTGAGCCAAGATCGGCGCCATTGTACTTGTGCCTGGGCAACAAGAGCGAAACTCAGTCTCAAATAAATAAATAAATCAGCTGGGCATAGTGGCGGGCACATGTAATCCCAGCTATTCCAGAAACTGAGGCAGGAGAATCACTTGAACCTGGGAGGCAGAGGTTGCAGTGAGCCAAGATCGCGCCACTGCACTCCAGCTTGGGCGACAAGAGTGAAACTCCATCTCAAAAAAAAGAAAAA","GGCTGGGCGCAGTGGCTCACACCTGTAATCCCAGCACTTAGGGAAGCTGAGGCGAGTAGATCACCTGAGGTCAGGAGTTAGAGACCAGCCTGGCCATCATGGTGAAACCCCGTCTCTACTAAAGATACCAAAAATTAGCTGAGTGTGGTGCTGGGTGCCTGTAATCCCAGAAACTCAGGGTGCCTGTAATCCCAGCAACTCAGGGTGCCTTTAATCCCAGCAACTGAGGGTACCAGTAATCCCAGCAACTCAGGGTGTCTTTAATCCTAGCAACTGAGGGCACCTGTAATCCCAGCAACTCAGGAAGCTGAGACAGGAGAAGTACTTGAACCCAGAAGGCAGAGGTTGCAGTGAGCCGATATTGCACCATTGCACTCCAGTCTGGGCAACAAGAGTGAAACTCTGTCTCAAAAAAAAA"
"chr22","14891348","14891663","JH378112","2628353","2628662","40","12262995","GGCCAGGTGTGGTGGCTCATGCCTGTAATCCCAGCACTTTGGGAGGCCGAGGTGGGTGGATCACCTGAGGTCAGGAGTTCAGGACCAGCCTGGGCAACATGGTATAACCCCATCGCTACTTAAAAAAAAAAAAAAAAAAAAAAAAAATTAGCCAGGCATGGTGGCGGGTGCCTGTAATCCCAGCTACTTGGGAGGCTGAGACAGGAGAATTGCTTGAACCCGGGAGGTGGAGGTTGCAGTGAGCCGAGATCACGCCACTGCACTCCAGCCTGAGTGACAAGAGCGAAACTCCATCTCAAGAAAAAAAAAAAAAAAA","GGCCGGGCGCGGTGGCTCAAGCCTGTAATCCTAGCACTTTGGGAGGCCGAGGTGGGTGGATCACAAGGTCAAGAGATCGAGACCAACCTGGTCAACATGGTGAAACCCCATCTCTACTAAAAATACAAAAAAAAAAAAAAATTAGCTGGGCATGGTGGCGCGTGCCTATAATCCCAGCTACTGAGGAGGCTGAGGCAGGAGAATTGCCTGAACCCAGGAGGCGGAGGTTGCAGTGAGCCGAGATCGCGCCATTGCACTCCAGCCTGGGTAACAAGAGCAAAACTCCGTCTCAAAAAAAAAAAAAAAAAAA"
"chr22","15157787","15158357","JH378206","6546474","6546861","246","8611313","GGGGGCAGTGGCTCTCACCTCTAATCCCAGCACTCTGGGAGGTTGAGGCAGAAAGATCACTTGAGCCTGGGAGTTCAAGACCAGTCTGGACAACATAAACATCTCTACAAAAAAATTTTTAGGCCGGGAGCAGTGGCTCACGCCTGTAATCTCAGCACTTTGGGAGGCCGAGGCGGGCGGATCACAAGGTCAAGAGATTGAGACCATCCTGGCCAACATGGTGAAACACCGTCTCTACTAAAGATACAAAAATTAGCTGGGCGTGGTGGCACACGCCTGTAGTCCCAGCAACTCGGGAGGCTGAGGCACGAGAATTGCTTGAACCTGGGAGGCAGAGGTTTCAGTGAGCCGAAATCACGCCACTGGCAACACAGTGAGACTCTGTCTCAAAAAAAAAAAAAAATTATCGGGCATGGTGGCGGGTGCCTGTGATCCCAGCTACTTAGGAGGCTGAGGCAGGAGAATTGCTTGAACCCGGAGGTGGAGATTGTAAAGAGCTGAGATCATGCCATTGCACACAAGCCTGGGTGACAAGAGCGAAAACACGGTCTCAAAAAAAAAGAAAGAAAAA","GGCCACACATGGTGGCTAACGCCTGTAATCCCAGCACTTTGGGAGGCCAAGTCGGGTGGATCATGAGGTCAGGAGACCAAGACCATCCTGGCCAAATGGTGAAACCCCGTCTCTACTAAAAATACAAAAATTAGCTGGGCATGGTGGCGTGTGCCTGTAATCCCAGCTACTCAGGAGGCTGAGGCAGGACAATTGCCTGAACCCAGGAGAATTAGCTGGGCATGGTGGCGTGTGCCTGTAATCCCAGCTACTCAGGAGGCTGAGGCAGGACAATTGCCTGAACCCAGGAGGCGAAGGTTGCGGTGAGCCGAGATTGTGCCATTGCACTCCAGCCTGGGTAACAAGAGCGACACTCTGTCTCAAAAAAAAAAAAAAAAAAAAAAAAAAA"
"chr22","15869503","15870083","JH378118","18053084","18053501","235","2183581","GGCCAGGCACGGTGCCTCACACCTATAATCCTAGCACTTTGGGAGGCCAAGTGCTAGGGCGGATCACCTGAGGTCAGGAGTTCAAGACCAGCCTGGCCAACATGGTGAAACCCCCACCTCTACTAAAAATACAAAAAAAAAGGCTGAGCACAGTGGCTCACGCCTGTAATCCCAGCACTTTGGGAGGCCGAGGCGGGAGGATTGCCTGAGGTCGGGAGTTTGAGACCAGCCTGACCAACATGGGGAAACCCCGTCTCTACTAAAAATACAAAATTAGCCGGGTGTGGTGGTGCATACTCCGGAGGCTGAGGCAGTAGAATCGCTTGAACCCGGAAGGCAGAGGTTGTGGTGAGCCAAAATCATGCCATTGCACTCCAGCCTGGGCAACAAGGCACTCCGCCTCAAAAAAAAAATTAGCCGGGCATGGTGGTGGGTGCCTGTAATTCCAGCTACTTGGGAAGCTGAGGCAGGAGAATCACTTGAATCCAGAGGGCAGAGGTTACAGTAAGCCAAGATCCCACCATTTCACTCCAGCCTGGGAGAAAGAGTGAAACTCCGTCTCAGAAAAAAAAAAAAAAAAA","GGCTGGGCGCAGTGGCTCACACCTGTAATCCCAGCACTTAGGGAAGCTGAGGCGAGTAGATCACCTGAGGTCAGGAGTTAGAGACCAGCCTGGCCATCATGGTGAAACCCCGTCTCTACTAAAGATACCAAAAATTAGCTGAGTGTGGTGCTGGGTGCCTGTAATCCCAGAAACTCAGGGTGCCTGTAATCCCAGCAACTCAGGGTGCCTTTAATCCCAGCAACTGAGGGTACCAGTAATCCCAGCAACTCAGGGTGTCTTTAATCCTAGCAACTGAGGGCACCTGTAATCCCAGCAACTCAGGAAGCTGAGACAGGAGAAGTACTTGAACCCAGAAGGCAGAGGTTGCAGTGAGCCGATATTGCACCATTGCACTCCAGTCTGGGCAACAAGAGTGAAACTCTGTCTCAAAAAAAAA"
"chr22","17701299","17701875","JH378118","18053084","18053501","228","351785","GCTGGGCTCAGTGGCTCACGCCTGTAATCCCAGCACTTTGGAAGGCCAAGGCGGGTGGATCACCTGAGGTCAGGAGTTTGAGATCAGCCTAGCCAACGTAGTGAAACCCCGTCTGTACTAAAAATACAAAAAATTGGTTGGGCATGGTGGATCACGAGGTCAGGAGTTCGAGACCAGCCTGACCAACAGGGTGAAACCTCATCTCTACTAAAAAAATACAAAGATTAGCTGGGCATGGTGGTGGTGTGCACCCCTAATCCCAGCTGCTCAGGAGGCTGAGGCAGGAGAATCGCTTGAACCCAGAGGCAGAAGTTGCAGTGAGCCGAGATAGTGCCACTGCACTCCAGTCTGAGCAACAGAGTGAGACTCTGTCTCAAAAAAATAAAAAAATTAAAAAATAAAAATAAAAAGAATTAGCCGGGCATGGTGGTGGGCGCCTTTAATCCCAGCTACTTGGGAGGCTGAGGCAGGAGAGTCGCTTGAACCTGGGAGCTGGAGGTTGTGGTGAGCCAAGATCGCGCCATTGCGCTTCAGCCTGGGCAATAAGAGCGAAACTCCATCTCAAAGAAAAAAAAAA","GGCTGGGCGCAGTGGCTCACACCTGTAATCCCAGCACTTAGGGAAGCTGAGGCGAGTAGATCACCTGAGGTCAGGAGTTAGAGACCAGCCTGGCCATCATGGTGAAACCCCGTCTCTACTAAAGATACCAAAAATTAGCTGAGTGTGGTGCTGGGTGCCTGTAATCCCAGAAACTCAGGGTGCCTGTAATCCCAGCAACTCAGGGTGCCTTTAATCCCAGCAACTGAGGGTACCAGTAATCCCAGCAACTCAGGGTGTCTTTAATCCTAGCAACTGAGGGCACCTGTAATCCCAGCAACTCAGGAAGCTGAGACAGGAGAAGTACTTGAACCCAGAAGGCAGAGGTTGCAGTGAGCCGATATTGCACCATTGCACTCCAGTCTGGGCAACAAGAGTGAAACTCTGTCTCAAAAAAAAA"
"chr22","19497071","19497395","JH378224","1395947","1396257","61","18101124","CCTGGCGCAGTGGCTCAGGCCTGTAATCCCAGCACTTTGGGAGGCGGAGGCAGGTGGATCATTTGAGGTCAGGAGTTCGAGACCTGCCTGGCCAACATGGTGAAACCCTGTCTCTAATAAAATACAAAAATTGGCCAGGCGTGGTGGCCCGCGCCTGTAATTCCAGCTACTCGGGAGGCTGAGGCAAGAGAATCGCTTGAACCCGGGAGTTGAAGGTTGCAGTGAGCAGAGATCGTGCCATTGCATTCAAGCCTGGGCCATGAGAGCACAAAAACAAAACAAAACAAAACAAACAAACAAAAAACTCTGCATCACCAAAAAAAAA","GGCTGAGTGCAGTGGCTCACGCCTGTAATCCCAACACATTGGGAGGCTGAGGCAGGTGGATCACCTAAGGTCAGGAGTTCAAGACGAGCCTGGCCAACATGGTGAAACCCTGTCTCTACTGAAAATACAAAAATTAACTGGGCGTGGTGGCATGCACCTCTAATTCCAGCTACTTGAGAGGCTGAGGCAGGAGAATCGCCTGAACCCAGGAGGTGGAGTTTGCAGTGAGCTTAGATCGTGCCATTGCATTCCAGCCTGGGCAACAAGAGTAAAACTCCATCTCAAAACAAAAAACAAAAAGCAAAAAAAAA"
"chr22","21787238","21787858","JH378118","18053084","18053501","270","3734154","GACCAGGCGCAGTGGCTCACGCCTGTAATCCCAGCATTTTGGGAGGCTGAGGCGGGCTGATCACCTGAGGTCAGGAGTTTGTAACCAGCCTGGGCAACATGGTGAAACCTCATCTCTACTAAAAATTTAAAAATTGGCCAGGTGTGGTGGCTCACGCCTGTAATCTCAGCACTTTGGGAGCCCGAGGCGGGCGGATCACGAGGTCAGGAGATCGAGACCATCCTGGATAACATGGTGAAACCCCGTGTCTACTAAAAATACAAAAAATTAGCCAGGTGTGGTGGCGGGCGCCTGTACTCCCAGCTACTCGGGAGGCTGAGGCAGGAGAATGGTGTGAACCCGGGATGCGGAGCTTGCAGTGAGCTGAGATCGCGTCACTGCCCTCCAGTCTGGGCGACAGAGCGAAACTCTGTCTCAAAAAAAAATAATAATAATAAATAAAATATAAAAATTATCTGGGCATGGTGGCGGGCGCCTGTAATCCCAGCTACTGGGGAGACTGAGGCAGGAGAATCGCTTGAACTCTGGAAGTAGAGGTTGCCATGAGCTGAGATCGTACTATTGCACTCCAGCCTGGGCGACAAGAGTGACATTTCATCTCAAAGAAAAACAAAAAAAAAC","GGCTGGGCGCAGTGGCTCACACCTGTAATCCCAGCACTTAGGGAAGCTGAGGCGAGTAGATCACCTGAGGTCAGGAGTTAGAGACCAGCCTGGCCATCATGGTGAAACCCCGTCTCTACTAAAGATACCAAAAATTAGCTGAGTGTGGTGCTGGGTGCCTGTAATCCCAGAAACTCAGGGTGCCTGTAATCCCAGCAACTCAGGGTGCCTTTAATCCCAGCAACTGAGGGTACCAGTAATCCCAGCAACTCAGGGTGTCTTTAATCCTAGCAACTGAGGGCACCTGTAATCCCAGCAACTCAGGAAGCTGAGACAGGAGAAGTACTTGAACCCAGAAGGCAGAGGTTGCAGTGAGCCGATATTGCACCATTGCACTCCAGTCTGGGCAACAAGAGTGAAACTCTGTCTCAAAAAAAAA"
"chr22","22550518","22550889","JH378107","47030598","47030914","93","24480080","GGGAGGAGGCAGGACTTGAAAGTAGGTGGGATGCCGGGCACGGTGGCTCCCGCCTGTAATCCCAGCACTTTGGGAGGCCGAGACGGGCAGATTACCTGAGGTCGAGAGTTCAAGACCAGCCTGACCAACATGGAGAAACCCCGTGTCTACTAAAAATACAAAAAATTAGCCGGGCATGGTGGTGGGTGCCTGTAATCCCAGCTACTCGGGAGGCTGAGGCAGGAGAATCACTTGAACCTGGGAAGTGGAGGTTGCAGTGAGCCAAGATCATGCCATTGCACTCCAGCCTGAGGTTGCAATGAGCCGAGATCACGCCATTGTACTCCAGCACGGGCAACAAGAGAGAAACTCCATCTCAAAAAAAAAAAAAAA","GGCCGGGTACGGTGGCTCACACCTATAATCCCAGCACTTTGGGAGGCCGAGGTGGACAGATCACCTGAGGTCAGGAGTTCGAGACCAGCCTGGCCAACATGGTGAAACCCTGTCTCTACTAAAAATACAAAAATTAGCTGGGCATGGTGGTCCATGCCTGTAATCCCAGCTACTCAGGAGGCTGAGGCAGGAGAATCACTTGAACCCAGGAGGTGGAGGTTGCAGTGAGCCAAGATCGCACCATTGCACTCCAGCCTGGGTGACAAGAGAGAGATTTCATCCCCCCAGCCCCCCAAAAAAAAGAAAGAAAGAAAAAA"
"chr22","24285027","24285332","JH378204","6071292","6071584","54","18213735","GGCCAAGCACAGAGGCTCACACCTGCAATACCAGCACTTTGGAAGGCCGAGGCAGGTGGATCACCTGAGATCAGGAGTTCGAGACCAGCCTGGCCAATATGGTGAAACCCCGTCGCTACTAAAAATACAAAAAAAAAAAAAAAAAAAAAAAAATTAGGCAGACGTGGTGGCGCATGCCTGTAATCCCAGCTACTCAGGAGGCCAAGGCTGGAGAATCACTTGAACCTGGAAGACGGAGGTTGCAGTGAGCCGAGATCACGCCATTGCACTCCAGCCTGAGCAACAAGAGCAAAACTCCGTCTCAAA","GGCCAGGCACGGTGGCTCAAGCCTGTAATCCCAGCACTTTGGGAGTCCGAGGCGGGTGGATCACGAGGTCAAGAGATCGAGACCATCCTGGTCAACATGGTGAAACCCCGTCTCTACTAAAAATACAAAAAAAAAAAAAAATTAGCTGGGCATGGTGGCGTGTGCCTGTAATCCCAGCTACTCAGGAGGCTGAGGCAGGAGAATTGCCTGAACCCAGGAGGCGGAGGTTGCGGTCAGCCGAGATCACGCCATTGCACTCCAGCCTGGGTAACAAGAGTGAAACTCTGTCTCAA"
"chr22","25324708","25325395","JH378118","18053084","18053501","333","7271624","ACTTCATCTCTTTAAAATTCAAGACTTAAGGCTGGGCGCAGTGGTCTACACCTGTAATCCCAGCACTTCAGGAGGCTGAGGCAGGTGGATCACTTGAGGTCAGGAATTCAAGACCAGCCTGGCCAGCATGGTGAAACCGCATCTCTACTAAAAATACAAAAATTAGCTGGGCATGGCCCGGCGCGGTGGCTCACACCTGTCATCCCAGCACTTTGGGAGGCCGAGACGGGCGGATCACGAGGTCAGGAGATTGAAACCATCCTGGGTAATACAGTGTAACCCCGTCTCTACTAAAAATACAAAAAAATTAGCCAGGCTTAGTGGTGGGCGCCTGTAGTCCCAGCTACTCAGGAGGCTGAGGCAGGAGAATGGCGTGAACCCGTAGTGGCGGGCACCTGTAGTCCCAGCTACTCAGGAGACTGAGGCAGGAGAATGGTGTGAACCCAGGGGGCGGAGCTTGCAGTGAGCCGAGATCGTGCCACTGCACTCCAGCCTGGGTGACAGAGCGAGACTCCGTCTCAGAAAAAAAAAAAAAAAGCCGGGTGTGGTGGCAGGCGCCTGTAGTCCCAGCTACTCGGGAGGCTGAGGCAAGGGAATCTCTTGAACCCGGGAGGCGGAGGTTGCCATGAGCTGAGATTGCACCTGAGCCACGAGAGCGAAACTGCATCTCAAAAAAAAAAAAAAAAAA","GGCTGGGCGCAGTGGCTCACACCTGTAATCCCAGCACTTAGGGAAGCTGAGGCGAGTAGATCACCTGAGGTCAGGAGTTAGAGACCAGCCTGGCCATCATGGTGAAACCCCGTCTCTACTAAAGATACCAAAAATTAGCTGAGTGTGGTGCTGGGTGCCTGTAATCCCAGAAACTCAGGGTGCCTGTAATCCCAGCAACTCAGGGTGCCTTTAATCCCAGCAACTGAGGGTACCAGTAATCCCAGCAACTCAGGGTGTCTTTAATCCTAGCAACTGAGGGCACCTGTAATCCCAGCAACTCAGGAAGCTGAGACAGGAGAAGTACTTGAACCCAGAAGGCAGAGGTTGCAGTGAGCCGATATTGCACCATTGCACTCCAGTCTGGGCAACAAGAGTGAAACTCTGTCTCAAAAAAAAA"
"chr22","25667563","25668234","JH378118","18053084","18053501","324","7614479","GCCAGGTGTGGTGGCATGTGCATATAGCCCTAGCTACTTGGGAAGCTGAGGTGGATCACTTGAGTCCAGGAGATCAAGGTTACAGTGAGCTATGATGGCACCACTACACTCTAGCCTGAATGACAAAATGAAACCTTGTCTCTTACAAAATGAAACCTTGTCTATAACAACAACAACAAAATTTAACAAAAATTTTTGGCCAGGCGCCGTGGCTCATGCCTGTAATCCCAGCACTTTGGGAGGCCGAGGCTGGTGGATCACCTGAGGTCAGGAGACGTTCCAGACCAGCCTGACCAACATGGTGAAACCCCATCTCTACTAAAAATACAAAAATTAGCCAGGTGTAGTGGCGAATGCCTGTAATCCCAGCTACTCCAGAGGCTGAGGCAGGCGAATCACTTGAACCCACCCGAGAGGCTAAGGTTGTGGTGAGCTGAGATCGTGCCACTGCACTCCAGCCTGGGCAACAGAGCAAGAGTCCGTTTCAAAATAAATAAATAAATAAAAATTAGCCATGTGTGGTGGTAAAAGCCTGTAATCCCAGCTATTCCGGAGGCTGAGGCAGGAGAATCACTTGAACACGGGAGGCAGAAGTTGCAGTGAGCAGAGATCACACCATTGCACTCCAGCCTGGGCAAAAAGAGCGACTCCCTATCAAAAAAAAAAAAAAAA","GGCTGGGCGCAGTGGCTCACACCTGTAATCCCAGCACTTAGGGAAGCTGAGGCGAGTAGATCACCTGAGGTCAGGAGTTAGAGACCAGCCTGGCCATCATGGTGAAACCCCGTCTCTACTAAAGATACCAAAAATTAGCTGAGTGTGGTGCTGGGTGCCTGTAATCCCAGAAACTCAGGGTGCCTGTAATCCCAGCAACTCAGGGTGCCTTTAATCCCAGCAACTGAGGGTACCAGTAATCCCAGCAACTCAGGGTGTCTTTAATCCTAGCAACTGAGGGCACCTGTAATCCCAGCAACTCAGGAAGCTGAGACAGGAGAAGTACTTGAACCCAGAAGGCAGAGGTTGCAGTGAGCCGATATTGCACCATTGCACTCCAGTCTGGGCAACAAGAGTGAAACTCTGTCTCAAAAAAAAA"
"chr22","25803241","25803865","JH378118","18053084","18053501","267","7750157","GGCTGGTTGCTGTGGCTCACGCCTGTAATCCCAGCACTTTGGGAGGCCATGGTGGGCGGATCACCTGAGGTCAGGAATTCTAGATCAGCCTGGCTAACATGGTGAAACCCGGTCTCTACTAAAAATACAAAAATTAGGCTGGGTTCAGTGGCTCATACCTGTAATCCCAGCACTTTGAGAGGCCGAGGCGGACAGATCACGATGTCAGGAGTTTAAGACCAGCCTGACCAATATCGTGAAACCCTGTCTCTACTAAAAATACAAAAAATTAGCCAGGCGTGGTGGCATGCACCTGTAATCCTAGCTACTCGGGAGGCTGAGGCAGGAGAATCGCTTGAACCCGAGAGGCAGAAGTTGCAGTGAGCCGAGAATGTGCCATTGCACTCCAGCCTGGGCGACAGAGTAAGACTCAGTCTTAAAACAAAACAAAACAACAACAACAACAAAAATAGCTGGGCGTGGTGGCGTACGCCTGTAGTCCCAGCTACTGGGGAGGCAGAGGCAGGAGAATCGATTGAACCCAGGAGGTGGAGGTTGCAGTGAGCCAAGATTGTGCCATTGCACTCCAGCCTGGGCAACAAGAGTGAAACTCCATCTCAAACAAACAAATAAATGAATAAAAGAA","GGCTGGGCGCAGTGGCTCACACCTGTAATCCCAGCACTTAGGGAAGCTGAGGCGAGTAGATCACCTGAGGTCAGGAGTTAGAGACCAGCCTGGCCATCATGGTGAAACCCCGTCTCTACTAAAGATACCAAAAATTAGCTGAGTGTGGTGCTGGGTGCCTGTAATCCCAGAAACTCAGGGTGCCTGTAATCCCAGCAACTCAGGGTGCCTTTAATCCCAGCAACTGAGGGTACCAGTAATCCCAGCAACTCAGGGTGTCTTTAATCCTAGCAACTGAGGGCACCTGTAATCCCAGCAACTCAGGAAGCTGAGACAGGAGAAGTACTTGAACCCAGAAGGCAGAGGTTGCAGTGAGCCGATATTGCACCATTGCACTCCAGTCTGGGCAACAAGAGTGAAACTCTGTCTCAAAAAAAAA"
"chr22","26916349","26916820","JH378118","18053084","18053501","157","8863265","TAGAAATTCAAGAGAGGGCCAGGCACAGTGGCCCATGCTTGTAATCCCAGCATTTCGGGAGCCTGAGGCAGGTGGATCGCCTGAGGTCAAGAGTTTGAAACCAGCCTGGCCAACATGGTCAGAACCCGTCTCTACTAAAAATACAAAAATTAGCCGGGCGTGGCGAGTGCCTGTAATCCCAGTTGCTCGGGAGGCTGAGGCAGAGACTTGCTTGAACCCAGGAGGTGGAGGTTGCAGTGAGCCGAGATCGCACCACTGCACTCCAGCCTTGGCAACAGAGCAAGAAAGCACCTCAAAAAAAAAAATTAGCTGGGTGTGGTGGCGGGTGCCTGTAATCCCAGCCACTTGGGAGGCTGAGGCAGGAGAATCACCCAAACCTAGGAGGCCGAGGTTGCAGTGATCCGAGATCATGACATTGCACTCCAGCCTGGGCAAAAAGAGCGAAACTCCGTCTCAGAAAAAAAAAAAGAAA","GGCTGGGCGCAGTGGCTCACACCTGTAATCCCAGCACTTAGGGAAGCTGAGGCGAGTAGATCACCTGAGGTCAGGAGTTAGAGACCAGCCTGGCCATCATGGTGAAACCCCGTCTCTACTAAAGATACCAAAAATTAGCTGAGTGTGGTGCTGGGTGCCTGTAATCCCAGAAACTCAGGGTGCCTGTAATCCCAGCAACTCAGGGTGCCTTTAATCCCAGCAACTGAGGGTACCAGTAATCCCAGCAACTCAGGGTGTCTTTAATCCTAGCAACTGAGGGCACCTGTAATCCCAGCAACTCAGGAAGCTGAGACAGGAGAAGTACTTGAACCCAGAAGGCAGAGGTTGCAGTGAGCCGATATTGCACCATTGCACTCCAGTCTGGGCAACAAGAGTGAAACTCTGTCTCAAAAAAAAA"
"chr22","26922090","26922621","JH378118","18053084","18053501","209","8869006","TGAGGTCAGGAGTTCAAGACCAGCCTGGCCAACATGGTGAAACCCCGTCTCCACTAAAAATACAAAAATTAGCCAGGCGTGGCCGGGCGCGGTGGCTCATGCCTGTAATCCCAGCACTTTGGGAGGCCGAGGTGGGCGGATCACGAGGTCAGGAGATCGAGACCATCCTGGCTAACATGGTGAAACCCCGTCTCCACTAAAAATACAAAAAATTAGCCGGGCGTGGTGGCGGGCGCCTGTAGTCCCAGCTACTGGGGAGGCTGAGGCAGGATAATGGCGTGAACCCGGGAGGCAGAGCTTGCAGTGAGCCGTGATTGTGCCACTGAACTCCAGCCTGGGAGACAGCAAGACTCTGTCTCAAAAAATAAAAATTGCCAGGCGTGGTGGCGGGCACCTGTAATCCCAGCTACTCGGGAGGCTGAGGCAAGAGAATTGTTTGAACCTGGGAAGCAGGGGTTGTGGTGAGCCGAGACCACGCCGGTGTGCTCCAGCCTGGGTGACAAGAGTGAGACTCTGTCTCAAAAAAAAAAAA","GGCTGGGCGCAGTGGCTCACACCTGTAATCCCAGCACTTAGGGAAGCTGAGGCGAGTAGATCACCTGAGGTCAGGAGTTAGAGACCAGCCTGGCCATCATGGTGAAACCCCGTCTCTACTAAAGATACCAAAAATTAGCTGAGTGTGGTGCTGGGTGCCTGTAATCCCAGAAACTCAGGGTGCCTGTAATCCCAGCAACTCAGGGTGCCTTTAATCCCAGCAACTGAGGGTACCAGTAATCCCAGCAACTCAGGGTGTCTTTAATCCTAGCAACTGAGGGCACCTGTAATCCCAGCAACTCAGGAAGCTGAGACAGGAGAAGTACTTGAACCCAGAAGGCAGAGGTTGCAGTGAGCCGATATTGCACCATTGCACTCCAGTCTGGGCAACAAGAGTGAAACTCTGTCTCAAAAAAAAA"
"chr22","26982976","26983578","JH378118","18053084","18053501","267","8929892","GCGACGGCTCACGCCTGTAATCCCAGCACTCTGGGAGTCCGAGGTGGGTGGATCACCTGAGGTCAGGAGTTCAAGACCAGCCTGGCCAACATGGCGAAACCCTGTCTCTACCAAAAATACAAAAAGAAGGCCGGGTGCGGTGGCTCATGCCTGTAATCCCAGCACTCTGGGAGGCTGAGGCGGGTGTATCACGCGGTCAGGAGATCGAGATCATCCTGGCCAACATGGTGAAACCTTGTCTGTACTAAAATTACAAAAAAATTAGCTGAGTGTGGTGCTGTGTGCCTGTAATCCCAGCTACTTGGGAGGCTTAGGCAGGATAATCACTTGAACTGGGGAGTCGGAGGTTGCAGTGAGCCGAGATCGCGCCACTGCACTGCAACCTGGTGACAGAGCAAGACTCTGTCTCAAAACAAACAAACAACAACAACAAAACAACAAAAACTAAAAATACAAAAATTAGCCGGGCGTGGTGGCGGGCACCTGTAATCCCAGCTACTCGGGAGACTGAGGCAGGAGAATCACTTGAACCTAGGAGCCAAGATCTCACCATTGCACTCCAGCCTGGGCGACAAGAGCAAAACTCTGTCTCAAAAAAAAAAA","GGCTGGGCGCAGTGGCTCACACCTGTAATCCCAGCACTTAGGGAAGCTGAGGCGAGTAGATCACCTGAGGTCAGGAGTTAGAGACCAGCCTGGCCATCATGGTGAAACCCCGTCTCTACTAAAGATACCAAAAATTAGCTGAGTGTGGTGCTGGGTGCCTGTAATCCCAGAAACTCAGGGTGCCTGTAATCCCAGCAACTCAGGGTGCCTTTAATCCCAGCAACTGAGGGTACCAGTAATCCCAGCAACTCAGGGTGTCTTTAATCCTAGCAACTGAGGGCACCTGTAATCCCAGCAACTCAGGAAGCTGAGACAGGAGAAGTACTTGAACCCAGAAGGCAGAGGTTGCAGTGAGCCGATATTGCACCATTGCACTCCAGTCTGGGCAACAAGAGTGAAACTCTGTCTCAAAAAAAAA"
"chr22","29732859","29733457","JH378118","18053084","18053501","253","11679775","GGCCAGGTGCGGTGGCTCACGCCTGTAATCCCAGCACTTTGGGAGGCTGAGGCCAGTGGATCACCTGAGGTCAGGAGTTCAAAATCAGCCTGGAAAATGTGGTGAGACCCCATTTCTACCAAAAATACAGGCTGGCACGATGGCTCACTCCTGTAATCTCATCACTTTGGGAGGCCAAGGCGAGTGGATTGCCTGAGGTCAGAAATTCAAGACCAGCCTGGCTAACGTGGTGAAACCCCATCTCTACTAAAAATACAAAAATTAGCCGGGCATGCTGGCAGGCACCTGTAATCCCAGCTACTTGGGAGGCTGAGGCAGGAGAATCGCTTGAACCCGGGAGGCAGAGGTTGCAGTGAGCCAAGATCACGCCATTGCCCTTCAGCCTGGGTGACAAGATCGAGACTTAGTGTCAAAAAAAAAAAAAAAAAACCCAAAAATTAGCCGGGGTTAGTGGCGGGTGCCTGTCATCCCAGCTACTTGGGAGGTTGAGGCTGGAGAATCGCTTGAATCCAGGAGGCAGAGGTTGCAGTGAGCTAAGATTGCACTATTGTACACCAGCCTGAGCAACAAGAGCAAAACTCCGACTCAAAAAAAAAAAA","GGCTGGGCGCAGTGGCTCACACCTGTAATCCCAGCACTTAGGGAAGCTGAGGCGAGTAGATCACCTGAGGTCAGGAGTTAGAGACCAGCCTGGCCATCATGGTGAAACCCCGTCTCTACTAAAGATACCAAAAATTAGCTGAGTGTGGTGCTGGGTGCCTGTAATCCCAGAAACTCAGGGTGCCTGTAATCCCAGCAACTCAGGGTGCCTTTAATCCCAGCAACTGAGGGTACCAGTAATCCCAGCAACTCAGGGTGTCTTTAATCCTAGCAACTGAGGGCACCTGTAATCCCAGCAACTCAGGAAGCTGAGACAGGAGAAGTACTTGAACCCAGAAGGCAGAGGTTGCAGTGAGCCGATATTGCACCATTGCACTCCAGTCTGGGCAACAAGAGTGAAACTCTGTCTCAAAAAAAAA"
"chr22","33892759","33893098","JH378144","13229286","13229620","61","20663473","GGCCAGGCGCGGTGGCTCACGCCTGTAATCCCAGCACTTTGGGAGCCAAGGCAGGAGGATCACCTGAGGTCAGGAGTTCAAGACCAGCCTGGCCATCATGGTGAAACCCCGTCTCTACTAAAAATACAAAAAAAAAAAAAAAAAAAATAGCTGGGCTTGGTGGCAGGCAGCTACTCGGAAGGCTGAGGCAGGAGAATCGCTTGAACCTGGTAGGTGGAGGTTGCAGTGAGCCCAGATCGCACCATCGCATTCCAGCCTGGGTGACAAGAGCAAAACTCTGTCTCAAAAAAATAAATAAATAAATAAATAAATAAATAAATAAATCGAAAAAGAAAAAGAA","GGCCGGGCGCGGTGGCTCAAGCCTGTAATCCCAGCACTTTGGGAGGCCGAGGCGGGTGGATCACCTGTGGTCAGGAGTTCAAGACAGCTTGGTCAACATGGTGAAACCCCGTCTCTACCAAAAATACAAAAAATTAGCTGGGCATGGTAGCGCATGCCTGTAATCCCAGCTACTCAGGAGGCTGAGGCAGGAGAATTGCCTGAACCCAGGAGGCAGAGGTTGCGGTGAGCCGAGATCGCGCCATTGCACTCCAGCCTGGGTAACAAGAGCGAAACTCCCTCTCATAAAAAATAAATAAATAAATAAATAAATAAATAAATAAATAAATAAATAAA"
"chr2A","260325","260930","JH378206","6546474","6546861","251","6286149","GGCTGGGCGTGGTGGCTCACGCCTGTAATCCCAGCATTTTGGGAGGCCAAGGCAGGCAGATCACCTGGGGTCAAGAATTTGAGGCCGGGCGCGGTGGCTCACGCCTGTAATCCCAGCACTTTGGGAGGCCAAGGCGGGCAGATCACGATGTCAGAGTTCGAGACCAGCCTGGCCAACATGGTGAAACCCCGTCTTTAATAAAAATACAAAAATTAGCTGGGCATGGTGGCAGGTGCCTGTAATCCCAGCTATTCTAGAGGCTGAGGCAGGAGAGTCATTTGAACCCGGGAGGCAGAGGTTGCAGTAAGCTGAGATCGTGCTATTGCACTTCAGCCTGGGCAACAGGTAGAGACTCCGTCTCAAAAAAAAAAAAAAAAAAGAGTTTGAGACCAGCGTGGCCAAAATGGTGAAATACCATCTCTACTAAAAATACAAAAATTAGCCAGGTGCCTGTAATCCCAGCTCCTTGGGAGGCTGAGGCCGGAGAATCGCTTGAACCCAGGAGGCGGAGGTTGCAGTGAGCTGAGATTGCACCATTGCAATCCAGCCTGGGTGACAAGAGCGAAACTCCGTCTCAAAAAAAAAAAAAAAATACAAACAAAAAAA","GGCCACACATGGTGGCTAACGCCTGTAATCCCAGCACTTTGGGAGGCCAAGTCGGGTGGATCATGAGGTCAGGAGACCAAGACCATCCTGGCCAAATGGTGAAACCCCGTCTCTACTAAAAATACAAAAATTAGCTGGGCATGGTGGCGTGTGCCTGTAATCCCAGCTACTCAGGAGGCTGAGGCAGGACAATTGCCTGAACCCAGGAGAATTAGCTGGGCATGGTGGCGTGTGCCTGTAATCCCAGCTACTCAGGAGGCTGAGGCAGGACAATTGCCTGAACCCAGGAGGCGAAGGTTGCGGTGAGCCGAGATTGTGCCATTGCACTCCAGCCTGGGTAACAAGAGCGACACTCTGTCTCAAAAAAAAAAAAAAAAAAAAAAAAAAA"
"chr2A","1903241","1903924","JH378118","18053084","18053501","343","16149843","GGCCAGGCACGATGGCTCATGCCTGTAACCCCAGCACTTTGGGAGGTGGGTGAATCACCTAAGTTAAGGAGTTCGAGACCAGCCTGGTCAACATGGTGAAACTGTGTCTCTACTAAAAACACAAAAAATTAGCTGGGCGCAGTGGCTCATGCCTGTAGTCCCAGCACTTTGGAAGGCCAAGGCGGGTGGATCATCTGAGGTCAGGAGTTCGAGACCAGCCTGGCCAACACGGTGAAACCCCATCTCTACTAAAAATACAAAAATTAGCCAGGCATGGTGGCACACACCCATAATCCCAGCTATTTGAGAGGCTGAGGCAGGAGAATCACTTGAGCCCAGGAGGCAGAGGTTGCACTGAGCCAAGATCGTGCCACTGAACTCCAGCCTGGGTGACAGAGTGAGACCCTGTCTCAAAACACACACACACACACACACACACACACACACACACCACACACACACACACACACACACACACACACACACACACACACACACACACACACACACACACACACACACACTTAGCCGGGCGTGGTGGTAGGCACCTGTAGTCCCAGCTACTCGGGAGGCTGAGGCTGAGGAGAATCCCTTGAACCTAGGAGGTGGAGGCTACAGTGAGCCGAGAATGCGCCACTGCACTCCAGCCTGGGTGGCAAGAGTGAACTCCATTTCCAAAAAAAA","GGCTGGGCGCAGTGGCTCACACCTGTAATCCCAGCACTTAGGGAAGCTGAGGCGAGTAGATCACCTGAGGTCAGGAGTTAGAGACCAGCCTGGCCATCATGGTGAAACCCCGTCTCTACTAAAGATACCAAAAATTAGCTGAGTGTGGTGCTGGGTGCCTGTAATCCCAGAAACTCAGGGTGCCTGTAATCCCAGCAACTCAGGGTGCCTTTAATCCCAGCAACTGAGGGTACCAGTAATCCCAGCAACTCAGGGTGTCTTTAATCCTAGCAACTGAGGGCACCTGTAATCCCAGCAACTCAGGAAGCTGAGACAGGAGAAGTACTTGAACCCAGAAGGCAGAGGTTGCAGTGAGCCGATATTGCACCATTGCACTCCAGTCTGGGCAACAAGAGTGAAACTCTGTCTCAAAAAAAAA"
"chr2A","3038406","3039019","JH378118","18053084","18053501","252","15014678","GGCCAGGCATGGTGGCTCATGCCTGTAATCCCAGCACTTTGGGAGGCCAAGGCGGGTGGATCACCTGAGGTCAGAAGTTCAAGACCAGCCTGGTCAACATGGTGAAACCCCATCTCTACTAAATATACAAAAATTAGCCATGCGAGGCCAGGCGCGGTGGCTTACGCCTGTAATCCCAGCACTTTGGGAGGCCAAGGTGGGCAGATCATGAGGTCAGGAGATCGAGACCATCCTGGCTAACACGGTGAAACCCCATCTCTACTAAAAAATACAAAAAATTAGCCAGGCGTGGCGGTGGGCGCCTGTAAGCCCAGCTACTCCGGAGGCTGAGGCAGGAGAATGGCGTGAACCTGGGAGGCGGAGCTTGCAGTGAGCCAAGATCGCGCCACTGCACTCCAGCCTGGGAGACAGAGCAAGACTCTGTCTCAAAAAAAAAAAAATTAGCCGTGCGTGGTGGCGGGCGCCTGTAATCCCAGCTACTCAGGAGGCTGAGGCAGGAGAATCACTTGAACCTGGGAGGCAGAGGTTGCAGTGAGCCGAGATTGCCCCATTGCGCTCCAGCCTGGGCAACGAGAGCGAAACTTCGTTCCAAAAATAAATAAATAAATAAATAA","GGCTGGGCGCAGTGGCTCACACCTGTAATCCCAGCACTTAGGGAAGCTGAGGCGAGTAGATCACCTGAGGTCAGGAGTTAGAGACCAGCCTGGCCATCATGGTGAAACCCCGTCTCTACTAAAGATACCAAAAATTAGCTGAGTGTGGTGCTGGGTGCCTGTAATCCCAGAAACTCAGGGTGCCTGTAATCCCAGCAACTCAGGGTGCCTTTAATCCCAGCAACTGAGGGTACCAGTAATCCCAGCAACTCAGGGTGTCTTTAATCCTAGCAACTGAGGGCACCTGTAATCCCAGCAACTCAGGAAGCTGAGACAGGAGAAGTACTTGAACCCAGAAGGCAGAGGTTGCAGTGAGCCGATATTGCACCATTGCACTCCAGTCTGGGCAACAAGAGTGAAACTCTGTCTCAAAAAAAAA"
"chr2A","6034432","6035026","JH378118","18053084","18053501","243","12018652","GGCTGGGCACAGTGGCTTACACCTGAAATCTCAGCACTTTGGGAGGCTGAGGCAGGAGGATCACCTGAGGTCAGGAGTTCTAGACCAGCCTGGTCAACATGGTGAAATCCTGTCTCTACTAAAAATACAAAAATTAGCAGCTGGGCATGGTGCTCACGCCTGTAATCCCAGCACTTTGGGAGGCCGAGGCGGGCAGATCACGAGGTCAGGAGATTGAGACCATCCTGGCTAACATGGTGAAACCCCATCTCTACTAAAAATACAAAAAAAACTAGCCAGGGGTGGTGGCGGGCGCCTGTAGCCCCAGCTACTTGGGAGGCTGAGGCAGGAGAATGGCATGAACCTGGAAGGCGGAGGTTGCAGTGAGGTGAGATGGTGCCACGGCACTCCAGCCTGGGTGACAGAGCGAGACTGTCTCAAAAAAAAAAAAAAAAAATTAGCCAGGCATGGTGGTGCGCACCCGTAATCCTAGCTACTCAGGAGGCTGAGGTAGGAGAATGGCTTGAACCCGGGAGGCAGAGGTTACAGTTAGCTGAGATCACATCATTGTCTAGCCTGGGCAACAAGAGTAAAACTCCATCTCAAAAAAAAAAAA","GGCTGGGCGCAGTGGCTCACACCTGTAATCCCAGCACTTAGGGAAGCTGAGGCGAGTAGATCACCTGAGGTCAGGAGTTAGAGACCAGCCTGGCCATCATGGTGAAACCCCGTCTCTACTAAAGATACCAAAAATTAGCTGAGTGTGGTGCTGGGTGCCTGTAATCCCAGAAACTCAGGGTGCCTGTAATCCCAGCAACTCAGGGTGCCTTTAATCCCAGCAACTGAGGGTACCAGTAATCCCAGCAACTCAGGGTGTCTTTAATCCTAGCAACTGAGGGCACCTGTAATCCCAGCAACTCAGGAAGCTGAGACAGGAGAAGTACTTGAACCCAGAAGGCAGAGGTTGCAGTGAGCCGATATTGCACCATTGCACTCCAGTCTGGGCAACAAGAGTGAAACTCTGTCTCAAAAAAAAA"
"chr2A","8518858","8519273","JH378166","6401112","6401453","120","2117746","CCAGGTGTGGTGGCTCATGCCTGCAATGCCAGCACTTTGGGAGGCCGAGGTGGGTGGATAACCTGAGGTCAGGAGTTCAAGACCAGCCTGACCAAGATGGTGAAATCCTGTCTTTACTAAAAATACAAAAATGAACCGGGTGTAGTGGCAGATGCCTGTTATCCCAGCTACTCAGGAGGCTGAGGCAGGAGAATTGCTTGAACCTGGGAGGCGGAGGTTGCAGTGAGCCAAGATCCTGCCATTGTACTCCAGCCTGGGCAACAAGAGTGAAACTCTGGCTAAAAAAAAGAAAGGAAAGAAGGAAAGGAAAGGGAAGGGAAGGGAAGGGAAGGGAAGGGAAGGGAAGGGAAGGGAAGGAAGGGAAGGGAAGGGAAGAAGGGAAGGGAAGGGAAGGGAAGGGAAGGAAGAAAGAAAAA","GGCCAGGTGCAGTGGCTCACCCCTGTAATCCCAGCACTTTGGGAGGTCGAGGTGGGTGGATCACCTGAGGTCAGGAGTTCAAGACCAGCCTGACCAAAATGGTGAAACCCCATCTCTACTAAAAATACAAAACATTAGCCAGACATCGTGGCGGGCACCTGTAATCCCAGCTACTTGGGAGGCTGAGGCAGGAGAATTGCTTGAGCCTAGGAGGCGGAGGTTACAGTGAGCCATGATCGTGCCATTGGACTCCAGCCTGGGCTACAAGAGCGAGACTCCATCTCAAAAAAAAAAAAAAAAAAAAAAAAGAAAGAAAGAAAGAAAGAAAGAAAAGAAAGAAAG"
"chr2A","8718692","8719316","JH378118","18053084","18053501","272","9334392","GGCTGGGCATGGTGGCTCATGCCTGTAATCCCAGCACTTCGGGAGGCCGAGGTGTGTGAGTAACCTAAGGTCGGAAGTTCGAGACCAGCCTTGCCAATGTGGTGAAACCCTGTCTCTACTCAAAATTCAAAAAATTAGGCCGGGCGCGGTGGCTCACACCTGTTATCTTGGCACTTTTGGAGGCCGAGGTGGGCAGATTGCCTGAGCTCAGGAGCTCAAGACCAGCCTGGGCAACATGGTGAAACCCTATCTCTACTAAAATACAAAAATTAGCCAGCCATGGTGGCATGCACCTGTAGTCCCAGCTACTTAGGAGACTGAGGCAGGAGAATTGCTTGAACCCAGGAAGTGGAGGTTGCAGTAAGCTGAGACTGCACCACTATACTCCAGCCTGGGTGACAGAGTGAGACTCCTTCTCTTAAAAGAAAAAAAAATAGCCAGGCGTGGTGGTGCACACCTGTAATCCCAGCTACTCGGGAGACTGAGGTAGGAGAATTGCTTGAACCTGGGAGGCGGAGGTTGCAGTGAGCTGAGATTGCACCATTGCACTCCAACCTGGGAGACAAGAGCGAAACTCTATCTTATTAAAAAAAAAAAAAAAAAAAAAAAAAAAAAAAAAAAAAAA","GGCTGGGCGCAGTGGCTCACACCTGTAATCCCAGCACTTAGGGAAGCTGAGGCGAGTAGATCACCTGAGGTCAGGAGTTAGAGACCAGCCTGGCCATCATGGTGAAACCCCGTCTCTACTAAAGATACCAAAAATTAGCTGAGTGTGGTGCTGGGTGCCTGTAATCCCAGAAACTCAGGGTGCCTGTAATCCCAGCAACTCAGGGTGCCTTTAATCCCAGCAACTGAGGGTACCAGTAATCCCAGCAACTCAGGGTGTCTTTAATCCTAGCAACTGAGGGCACCTGTAATCCCAGCAACTCAGGAAGCTGAGACAGGAGAAGTACTTGAACCCAGAAGGCAGAGGTTGCAGTGAGCCGATATTGCACCATTGCACTCCAGTCTGGGCAACAAGAGTGAAACTCTGTCTCAAAAAAAAA"
"chr2A","10980418","10980725","JH378107","53359752","53360055","48","42379334","GGCAGGGCACAGTGGCTCACTCCTGTAATCCCAGCACTTTGGGAGGCCAAGGCAGGCAGATCACCTGAGGTCAGGAGTTCAAGACCAGCCTGGCCAAAATGGTGAAACCCCATCTCTACTAAAAAAAAAAAAAAAAAAAAAAAAAAAGCCTGGCATAGTGGCACATGCCCGTAGTCCCAAGTACTTGGGAGGCTGAGGCAGAAGAATTGCTTGAACCCAGGAGACGGAGGTTGCAGTAAGCCAAGATCTTGCCATTGCACGCCAGCCTGGGCAACAAGAGCAAAACTCTGTCTCAATAAATAAATAAA","GGCTGGGTGTGGTGGCTCACGCCTGTAATCCCAGCACTTTGGGAGGCTGAGTTAGGAGGATCATCTGAGGTCAGGAGTTCGAGACCAGCCTGGCCAACATGGTGAAACCCCATCTCTACTGAAAAAAAAAAAAAATACAAAAATTAGCTGGGTATGGTGGCACATGCCTGTAATCCCAACTACTCAGGAGGCTGAGGCAGGAGAATTGCTTGAACCTGGGAGGTGGAGGTTGCAGTGAGCCGAGATCATTGCCATTGCATGCCAGCCTGGGCAACAAGAATGAAACTCCATCTCAAAAAAAAAA"
"chr2A","15711036","15711641","JH378118","18053084","18053501","252","2342048","GGCTGGGCGCAGTGGCTCATGCCTGTAATCCCAGAACTTTGGGAGGCCAAGGCGGGCGGATCATCAAGTCAGGAGTTCGAGACTAGCCTGGTCAACATGGTGAAACCTCGTCTCTACTAAAAATACAAAAATTAGGCCGGGTGTAATCACACCTGTAATCCCAGCACTTTGGGAGGCCGAGGCGGGCAGATCACAAGGTCAGGAGATTGAGACCATCTTGGCTAACATGGTGAAACCCCGTCTCTACTAAAAATACAAAAAAAATTAGCGGGGCATGGTGGTGGACACCTGTAGTCCCAGCTACTTGGGAGGCTGAGGCAGGAGAATGGTGTGAACCTGGGAAGTAGAGGTTGCAGTGAGCCGAGATTGTGCCACTGCACTCCAGCCTGGGTGACAGAGCAAGACTTCATCTCAAAAAAAAAAAAAAAAAAAAAAAAAAAATTAGCCTGGTGTGGTGCAGGTGCCTGTAATCCCAACTACTTGGGAGGCTGAGGCAGGAGAATCACTTGAACCGGGGAGGCAAAGATTGCAGTGAGCTGAGATTGCGCCATTGCACTCCAGCCTGGGCAACAAGAGTGAAACTTCGTCTCCCCCCAAAAAAAAAAA","GGCTGGGCGCAGTGGCTCACACCTGTAATCCCAGCACTTAGGGAAGCTGAGGCGAGTAGATCACCTGAGGTCAGGAGTTAGAGACCAGCCTGGCCATCATGGTGAAACCCCGTCTCTACTAAAGATACCAAAAATTAGCTGAGTGTGGTGCTGGGTGCCTGTAATCCCAGAAACTCAGGGTGCCTGTAATCCCAGCAACTCAGGGTGCCTTTAATCCCAGCAACTGAGGGTACCAGTAATCCCAGCAACTCAGGGTGTCTTTAATCCTAGCAACTGAGGGCACCTGTAATCCCAGCAACTCAGGAAGCTGAGACAGGAGAAGTACTTGAACCCAGAAGGCAGAGGTTGCAGTGAGCCGATATTGCACCATTGCACTCCAGTCTGGGCAACAAGAGTGAAACTCTGTCTCAAAAAAAAA"
"chr2A","16378602","16378918","JH378147","15246332","15246643","50","1132270","GGCCAGGCGAGGTAGCTCACACCTGTAATCCCAGTACTTTGGGAGGCCGAGATGGGAGGATCACCTGAGGTCAGGAGTTTGAGACCAGCCTGGCCAACATGGTGAAATCCTGTCTCTATGAAAAATAGAAAATTAGCCAGGCGTGGTGGCAGGTGTCTGTAATCCCAGCTATTTGGGAGGCTGAGGCATGAGAATTTCTTGTACCTGGGAGGCGGAAGTTGCCGTGAGCCGAGACCGCGCCATTGCACTCCAGCCTGGGCGACAAGAGGGAAACGCCTCAAAACAAAAACAAAAACAAAAACAAACAAACAAACAAA","GGCCGGGCTCGGTGGCTCACACCTGTAATCCCAGCACTTTGGGAGGCCCAGGCAGGTGGATCACCTGAGGTCAGGAGTTTGAGACCCACCTGGCCAACATGGTGAAACCCCATCTCTACTAAAAATACAAAAACTAGCTGGGCACGTGGTGGCAGGTGCCTGTAATCCCAGCTACTTGGGAGGCTGAGGCAGGAGAATTGCTTGAACCTGGGAGGTGGAGGTTGCAGTGAGCCGAGATCGCCCCATTGCATTCCAGCCTGGGAGACAAGAGTGAAATTCCATCTCAAAAAAAAAAAAAAAAAAAAAAAAAAA"
"chr2A","37727909","37728263","JH378108","45564157","45564495","69","7836248","GGCCGGGCACAGTGGCTCACGCCTGTAATCCCAGCATTTTGGGAGGCCAAGGCAGGCAGATCACCTGAGATCAGGAGTTTGAGAGCAGCCTGGCCAACATGGCAAAACCCTATCTCTACTAAAAATACAAAAAAATAGCCAGGCATGGTGGCGGGCACCTGTAATCCCAGCTACTTGGGAGGGTAAGCAGGAGAATCGCTTGAACCAGGGAGGTAGAGGTTGCAGTGAGCCAGGATCGTGCCATTGCCCTCCCGCCTGGGCATCCATAGCAAAACTCTGTCTCAAGGAAGGAAGGAAGGAAGGAAGGAAGGAAGGAAGGAAGGAAGAAAGAAAGAAAGAGAAAGAAAGAGAGAAA","GCTAGGCAAGGTGGCTCATGCCTGTAATCCCAACATTTTGGGAGGCCGAGGCAGATGGATCACCTGAGGTTAGGAGTTCAAGACCAGCCTGGCCAACATGGTGAAACTCCATCTCTACTAAAAATACAAAAAATTAGCTTGGCACGGTGGTGGGTGCCTCTAATCCCAGCTGCTTGGGAGGCTGAGGCAGGAGAATCGCTTGAACTCAGGAGGTGGAGGTTGCAGTGAGCCAAGATCATGGCATTGCACTCCAGCCTGGGCGACAAGAGCGAGACTCCCTCTAAGAAAGAAAAGAAAGAAAAGAAAAGAAAAAAGGAAAGGAAAGGAAAGAAAGAGAAA"
"chr2A","43642042","43642379","JH378262","266823","267148","56","43375219","GGCTGGGCGTGGTGGCTCATTCCTGTAATCCCAGCACTTTGGGAACCCAAGGTGGGTGGATCACCTGAGGTCAGCAGTTCGAGACCAGCCTCACCAACATGGTAAAACCCTGTCTCTACTAAAAATATAAAAATTAGCCGGGCATGGTGGCGGGCACCTGTAATCCCAGCTACGCAGGAGGCTGAGGCAGGAGAATCGCTTGAAAGCGGGAGGCGGAGTTTGTAGTGAGCAGAGATTGTGCCATTGCACTCCAGCCTGGGCAACAAGAGCAAAACTCCATCACACACACACACACACACACACATAAACACACACACAAAAGCAAGAAAAAGAAAAAA","GGCCGGGCGCGGTGGCTCAAGCCTGTAATCCCAGCACTTTGGGAGGCCGAGGCGGGTAGATCATGAGGTCAGGAGTTTGAGACCAGCCTGGCCAACATGGTGAAACCCCGTCTCTACTAAAAATACAAAAATTAGCCGGGCATGGTGGCCTGTGCCTGTAATCCTAGCTACCCAGGAAGCTGAGGCAGGAGAATTGCCTGAACCCAGGAGGCGGAGGTTGCGGTGAGCCGAGATCGTGCCATTGCACTCCAGCCTGGGTAACAAGAGCGAAACTCCGTCTCAAAAACAAACAAACAAACAAACAAAAACAAAAAACAAAAAACAAA"
"chr2A","46316910","46317535","JH378118","18053084","18053501","268","28263826","GGCCAGGCGCAGTGGCTTATGCCTGCAATCCCAGCACTTTGGGAGACCAAGGCGGGCAGATCACCTGAGGTCAGGAGTTCGAGACCAGCCTGACCAACATGGTGAAACCCCATCTCTACTGAAAATACAAAAAAAAAAAAAATCAGCAGGTGGGCCAGGTGCAGTGGCTCACGCCTGTAATCCCAGCACTTTGGGAGGCTAAGGCAGGCAGATCATGAGGTCAGGAGTTTGAGACCAGCCTGGCCATCATAGTGAAACTCCATCTCTACTAAAAATACAAAAAATTAGCCAGGCATGGTGGCGGGCACCCATAATCCCAGCTACTCAGGAGGCTGAGGCAGGAGAATTGCTTGAACTCGGGAGGCAGAGGTTGCAGTGAGCCGAGATTGCGCCACTGCACTCCAGCCCGGGCGACCGCGCAAGACTCCATCTCAAAAAACAAACAAAAAAAATTAGCCAGACACGGTGGCGGGTGCCCGTAATCCCAGCTACTCAGGAGGCTGAGGCAGGAGAATTGCTTGAACCTGGGACACAGAGTTTGCAGTGAGCCAAGGTAGTGCCATTGCACTCCAGCCTGGGCAACAGGAACAAAAACTCGGTCTCAAAAAAAGAGAAAAAAAAAAAAA","GGCTGGGCGCAGTGGCTCACACCTGTAATCCCAGCACTTAGGGAAGCTGAGGCGAGTAGATCACCTGAGGTCAGGAGTTAGAGACCAGCCTGGCCATCATGGTGAAACCCCGTCTCTACTAAAGATACCAAAAATTAGCTGAGTGTGGTGCTGGGTGCCTGTAATCCCAGAAACTCAGGGTGCCTGTAATCCCAGCAACTCAGGGTGCCTTTAATCCCAGCAACTGAGGGTACCAGTAATCCCAGCAACTCAGGGTGTCTTTAATCCTAGCAACTGAGGGCACCTGTAATCCCAGCAACTCAGGAAGCTGAGACAGGAGAAGTACTTGAACCCAGAAGGCAGAGGTTGCAGTGAGCCGATATTGCACCATTGCACTCCAGTCTGGGCAACAAGAGTGAAACTCTGTCTCAAAAAAAAA"
"chr2A","46966138","46967034","JH378118","18053084","18053501","514","28913054","GGTCGGGCACGGTGGCTTACGCCTGTAATCCCAACACTTTGGGAGGCAGAGGTGGTGGATCACCTGAGTCAGGAGTTCGAGACCAGCCTGGCCAACATGGTGAAATCCTGTCTTTACTAATAACACAAAAATTAGCTGACCAGGCACAGTGGCTCATGCCTGTAATCCCCAGCACTTTGGGAGGCCGAGGCGGATCAGGAGGTTAAGAGATCGAGACCATCCTGCCCAAAACCCCATCTCTACTAAAATACAAAAATTAGCTGGGTGTGGTAGTGTGCCCTGTAGTCCCAGATACTCAGGAGGCTGAGGCAGGAAAATCGCTTGAACCCGGGAGGCGTAGGTTACAGTAAGCCAAGATCATGCCACTGCATTCCAGCCTGGTTAAAGAGTGAGACCCTGTCTCAAAAAAAAAAAAAAAAAAAAAAAAAAAAATTGGGCCAGATGTGGTGGCTCACACCTGTAATCCCAGCACTTTGAGAGGCTGAGACAGGCGAATCACGAGGTCAGGAGATCGAGACCATCCTGGCTAACATGATGAAACCCCGTCTCTACTAAAAATACAAAAAAAAAATTAGCTGGGTGTGGTGGCGGGCGCCTGTAGTCCCAGCTACTTGGGAGGCTAAGGCAGGAGAATGGTGTGAACCTGGGAGGCGGAGCTTGCAGTGAGCTGAGATCGTGCCACAGCACTCCAGCCTGGCGACAGAGCAAGATTCTGTCTCAAAAAAAAAAAAAAAAAAAAAATAGCTGGGTGGTGGCACATGCCTATAATCCCAGCTACTCAGGAGCTGAGGCAGAGAATCACTTAAACCTGGAGGTAGAGGTTGCAGTGAGCCGAGATTGCACCATTGCACTCCAGCCTGGCAACAAGAGCGAAACTCTGTCTCAAAAATAAATAAA","GGCTGGGCGCAGTGGCTCACACCTGTAATCCCAGCACTTAGGGAAGCTGAGGCGAGTAGATCACCTGAGGTCAGGAGTTAGAGACCAGCCTGGCCATCATGGTGAAACCCCGTCTCTACTAAAGATACCAAAAATTAGCTGAGTGTGGTGCTGGGTGCCTGTAATCCCAGAAACTCAGGGTGCCTGTAATCCCAGCAACTCAGGGTGCCTTTAATCCCAGCAACTGAGGGTACCAGTAATCCCAGCAACTCAGGGTGTCTTTAATCCTAGCAACTGAGGGCACCTGTAATCCCAGCAACTCAGGAAGCTGAGACAGGAGAAGTACTTGAACCCAGAAGGCAGAGGTTGCAGTGAGCCGATATTGCACCATTGCACTCCAGTCTGGGCAACAAGAGTGAAACTCTGTCTCAAAAAAAAA"
"chr2A","47470043","47470636","JH378118","18053084","18053501","235","29416959","CTGGGCGCAGTGGCTCATACCTGTAATCCCAGCACTTTGGGAAGCCGAGGCGGGCAGATCACCTGAGGTCAGGTGTTCGAGAGCAGCCTGGCCAACATGGTGAAACCCTGTTGCTACTAAAAATACAAAAATTAGGCCAGGCACGATGGCTCATGCCTGTAATCTCAGCACTTTAGGAGGCCGAGGCAGGCGGATCACCTGAGGTCAGGAGTTCAAGAGCAGCCTGGCCAACATGGTGAAACCCTGTCTCTACAAAAATACAAAAATTAGCCGGGCATAATGACGGGTTCCTGTAATCCCAGCTATTTGGGAGGCCAAGGTGGGAGAACTGCTTGAACCTGCAAGGCGGAGATTGCAGTGAGCCAAGATCGTGCCATTGCACTCCAGCCTGGGCGACACAGCGAGACTCTGTCTCAAAAAAAAAAAATACAAAAATTAGCTGGGCATGGTGGCAGGTGCGTGTAATCACAGCTACTCAGGAGGCTGAGGCAGGAGAATCACTTGAACCCAGGAAGGGGTGGTTGCAGTGAGCCGAAACCATCCCATTGCACTCCAGCCTGGGCAATCAGAGTGAAACTCCATCTAAAAAAAAAA","GGCTGGGCGCAGTGGCTCACACCTGTAATCCCAGCACTTAGGGAAGCTGAGGCGAGTAGATCACCTGAGGTCAGGAGTTAGAGACCAGCCTGGCCATCATGGTGAAACCCCGTCTCTACTAAAGATACCAAAAATTAGCTGAGTGTGGTGCTGGGTGCCTGTAATCCCAGAAACTCAGGGTGCCTGTAATCCCAGCAACTCAGGGTGCCTTTAATCCCAGCAACTGAGGGTACCAGTAATCCCAGCAACTCAGGGTGTCTTTAATCCTAGCAACTGAGGGCACCTGTAATCCCAGCAACTCAGGAAGCTGAGACAGGAGAAGTACTTGAACCCAGAAGGCAGAGGTTGCAGTGAGCCGATATTGCACCATTGCACTCCAGTCTGGGCAACAAGAGTGAAACTCTGTCTCAAAAAAAAA"
"chr2A","53294201","53294799","JH378118","18053084","18053501","240","35241117","GGCCAGGCATAGTGGCTCACACCTGTAATCCCACCACTTTGGGAAGCTGAGGTGGGTGGATCACCTGAGGTCAGGAGTTCGAGACCAGCCTGACCAACATAGTGAAACCCCAACTCTACTAAAAATACAAAAATTAGCAAGGCGGCTGGGCGCAGTGGCTCACGTCTGTAATCCCAGAACTATGGGAGGCTAAGGTGGGCGGATCACCTGAGGTCAGGAGTTTGAGACCAGCCAGACCAACATGCTGAAACCTCGTCTCTAATAAAAATACAGAAATTAGCCAGGCGTGGTGGCACATGCCTATAGTCCCAGCTACTCGGGAGGCTGAGGCAGAAGAATCGCTTGAACCTGGGAGACAGAGGTTGCAGTGAGCTGAGATCGTACCACTGCACTCCAGACTAGGTGACAGAGCAAGCCTCTGTCTCAAAAAAAAAAAAAAATTAGCCAGGCATGTTAGGCACCCGTAATCCCAGCTATTCGCGAGGCTGAGGCAGGAGAATTGCTTGAACCTGAGAGGTGGAGGTTGCAGTGAGCTAAGATCACGCCATTGCACTCCACCCTGCGCAACAAGAGTGAAACTCTGTTCAAAAAAAAAAAAA","GGCTGGGCGCAGTGGCTCACACCTGTAATCCCAGCACTTAGGGAAGCTGAGGCGAGTAGATCACCTGAGGTCAGGAGTTAGAGACCAGCCTGGCCATCATGGTGAAACCCCGTCTCTACTAAAGATACCAAAAATTAGCTGAGTGTGGTGCTGGGTGCCTGTAATCCCAGAAACTCAGGGTGCCTGTAATCCCAGCAACTCAGGGTGCCTTTAATCCCAGCAACTGAGGGTACCAGTAATCCCAGCAACTCAGGGTGTCTTTAATCCTAGCAACTGAGGGCACCTGTAATCCCAGCAACTCAGGAAGCTGAGACAGGAGAAGTACTTGAACCCAGAAGGCAGAGGTTGCAGTGAGCCGATATTGCACCATTGCACTCCAGTCTGGGCAACAAGAGTGAAACTCTGTCTCAAAAAAAAA"
"chr2A","55940294","55940889","JH378118","18053084","18053501","244","37887210","CCAGGCGCGGTGGCTCACACCTGTAATCCCAGCACTTTGGGAGGCCAGGGCGGGTGGATCACCTGACGTCAGGAGTTCGAGACCAGCCTGGCCAACATGGTGAAACCCCATCTTTATTAAAAATAGAAAAATTGGCTAGGCGCAGTGGCTCACGCCTGTAATCCTAGCACTTTGGGAGGCCGAGGTGGGCAGATCACAAGGTCAGGAGATTGAGACCATCTTGGCTAACATGGTGAAACCCCATCTCTACTAAAAATACAAAAAAATTAGCTGGGTGTGGCGGCAGGCACCTGTAGTCCCAGCTACTTGGGAGGCTGAGGCAGGAGAATGGCATGAACCCCAGAGGCAGAGGTTGCAGTGAGCTGAGATAGCGCCACTGCACTCCAGCCTGGGCGACAGAGTGAGAATCCGTCTCAAAAAAAAAAGAAAAATTATCTGGGCATAGTGACTCAGGCCTGTAATCCCAGCTGCTTGGGAGGCTGAGGTGCGAGAATTGCTTGAACCCAGGAGGCAGAGGTTGCATTGAGTTGAGACTGAGCCATTGCACTCCAGTTGGGCGACAAGAGTGAAACTCGGTCTCAAAAAAAAAAAAAAAA","GGCTGGGCGCAGTGGCTCACACCTGTAATCCCAGCACTTAGGGAAGCTGAGGCGAGTAGATCACCTGAGGTCAGGAGTTAGAGACCAGCCTGGCCATCATGGTGAAACCCCGTCTCTACTAAAGATACCAAAAATTAGCTGAGTGTGGTGCTGGGTGCCTGTAATCCCAGAAACTCAGGGTGCCTGTAATCCCAGCAACTCAGGGTGCCTTTAATCCCAGCAACTGAGGGTACCAGTAATCCCAGCAACTCAGGGTGTCTTTAATCCTAGCAACTGAGGGCACCTGTAATCCCAGCAACTCAGGAAGCTGAGACAGGAGAAGTACTTGAACCCAGAAGGCAGAGGTTGCAGTGAGCCGATATTGCACCATTGCACTCCAGTCTGGGCAACAAGAGTGAAACTCTGTCTCAAAAAAAAA"
"chr2A","58730498","58730820","JH378137","5644605","5644920","45","53085893","GGCCAGGCGCAGTGGCTCACGCCTGTAATCCCAGAATTTTGGGAGGCCGAGGCGGGTGGATCACCTAAGGTCAGGAGTTCAAGACCAGCCTGGCCAACATGGTGAAACCCTGTCTCTACTAAAAACACAAAAATGAGCCGGGTGTGGAGGCATGCGCCTGTAATCTCAGCTACTCAGGAGGCTGAGGCAGAGAATCGCTTGAACCTGGGAGACAGAGGTTGCAGTGAGCCGAGATCGCACCATTGGACCCCAGTCTCTGGGCAACAAGAGCAAAACTCCATCTCAAAATAATAATAATAATAATAATAATAAAAACAAATAAA","GGCTGGGCGCAGTGGCTCACGCCTGTAATCCCAACACTTTGCGAGGCTGAGGCGGGTGGATCACCTGAGGTCAGGAGTTCAAGACCAGCCAGGCCAATGTGGTGAAACCTCATTTCTACTTAAAAATACAAAAATTATCCAGGAGTGGTGGCATGTGCCTGTAATCCCAGCTACTCAAGAGGCTGAGGCAGGAGAATTGCTTGAACCTGGAAGGCAGAGGTTGCAGTGAGCCGAGATCATGCCATTGCACTCCAGCCTGGGCAACAAGAGCAAAACTCCGTCTCAAAATAAATAAATAAAATAAACAAACAAATAA"
"chr2A","60358631","60358976","JH378118","23749903","23750223","54","36608728","GGCCGGGCGCAGTGGCTCATGCCTATAATCCCAGCACTTTGGGAGGCCGAGGCGGGTGGATCACGAGGTCAAGATATCGAGACCATCCTGGCCAACCTGGTGAAACCCTGTCTCTACTAAAAATACAAAAAATATATATATATACATATATATATATATATATATATATATTAGCCAGGCATGGTGGCAGGTGCCTGTAATCCCAGCTACTTGGGAGGCTGAGGTAGAAGAATCGCTTGAACCCAGGAGGCAGAGGTTGCAGTGAGCCGAGATCATGCCATTGCACTCCAGCCTGGGCAAAAAGAGTGAAACTCTGTCTCAAAAACACAAAAACAAAAAAAGAAAA","GGCCGGGCGCGGTGGCTCAAGCCTGTAATCCCAGCACTTTGGGAGGCCGAGGCAGGTGGATCATGAGGTCGAGAGATCGAGACCATCCTGGTCAACATGGTGAAACCCTGTCTCTACTAAAAATACAAAAAAAAAAAAAAAAAAAAAAATTAGCTGGGCATGGTGGCGCATGCCTGTAATCCCAGCTACTCAGGAGGCTGAGGCAGGAGAATTGCCTGAACCCAGGAGGCGGAGGTTGCAGTGAGCTGAGATCGCGCCATTGCACTCCAGCCTGGGTAACAAGAGTGAAATTCCGTCTCAAAAAAAAAAAAAAGAAAGAAA"
"chr2A","63770545","63770888","JH378106","31557967","31558303","51","32212578","GCCAGGCACAGTGGTTCATGCCTGTAATCCTAGCACTTTGGGAGGCTGAGGCGGGTGGATCACCTGAGGTCAGGAGTTCGAGACCAGCCTGGCCAACATAGTGAAACCCCATCCCTACTAAAAATGCAAAAAATTAGCTGGCTGTGGTGGCAGGCACCTGTAATCCCAGCTACTAGGGAGGCTGAGGCAGGAGAATTGCTTGAACCCAGGAGGTGGAGGTTGCAGTGAGCTGAGATTGCACCATTGCACTCCAGCCTGGACAACAAGAGCAAAACTCTGTCTCAAAAAACAAAACAAAACAAAACAAAACCCTGTCTCAAAAAAAAAATAAAATAAAATAAAAA","GGCCGGGCGCGGTGGCTCAAGCCTGTAATCCCAGCACTTTGGGAGGCCGAGGCGGGTGGATCACAAGGTCAAGAGATCGAGACCAACCTGGTCAACATGGTGAAAGCCCGTCTCTACTAAAAATACAAAAATTAGCTGGGCATGGTGGCGCGTGCCTATAATCCCAGCTACTCAGGAGGCTGAGGCAGGAGAATTGCCTGAACCCAGGAGGTGGAGGTTGCAGTGAGCGAGATTGCGCCATTGCACTCCAGCCTGGGTAACAAGAGCGAAACTCCGTCTCACAAAACAAAACAAAACAAAACAAAACAAAACAAAACAAAAAACAAACAAAAAAAAA"
"chr2A","67650330","67650657","JH378138","4229795","4230103","71","63420535","CCTGTAATCTCAGCATTTTGAGAGGTGAGGCAGGCCGATAGCCTGAGGTCAGGAGCTCCAGATCAGACTGGCCAACTTGGTGAAAGTAGTCTCTACTAAAAACACAAAAATTAGCTGGGCGTGGTGATGAAGGCTTGTAATCCCAGCTACTCAAGAGGCTGAGGCAGGTGAATCACTTGAACCCGGGAGGCAGAGGTTGCAGTGAGCCAAGATCCTGCCACTGCACTCCAGCCTGGGCGACAAGAGCAAAACTCTGTCTCAATAAATAAATAAATAAATAAATAAATAAATAAATAAATATTTTAAAAAAAGAAAAAAAGAAGAGAAA","CACTTTGGGAGGTGAAGGCGGGCAGATCACCTGAGGTCAGGAGTTCGAGACCAGCCTGGCCAACATGGTGAAACCCCGCCTCTACTAAAAATACAAAAATTAGCCAGGTGTGACACTAGGCATCTGTAATCCCAGCTACTTGGGAGGCTGAGACAGGAGAATCACTTGAACCCAGGAGGCGGAAGTTGCAGTGAGCCAAGATCATGCCATTGCACTCCAGCCTGGGTGACAGGAGCAAAACTCTGTCTCAAAAAAAAAAAAAAAAAAAAAAAAAAAAAAAAAAAAAAAAGAAAAGAAAAGAAAAGTAAA"
"chr2A","70512503","70513081","JH378118","18053084","18053501","228","52459419","GGCCGGGCACGGTGGCTCACGCCTGTAATCCCAGCACTTTGGGAGGCCGAGGCAGGCAGAACACCTGAGGTCAGGAGTTCAAGACGAGCCTTGCCAACATGGTGAAAACCTGTCTCTACTAAAAATACAAAAAATTGGCCAGGCGCAGTGGCTCACACCTGTAATCTCAGCACTTTCGGAGGCCAAGGTGGGTGGATCACGAGGTCAGGAGTTCGAGACCAGCCTGTCCAACACAGTGAAACCCTGTCTCTACTAAAAATGCAAAAAAATTAGCTGGGCGTGGGGGCAGGTGCCTGTAGTCCAAGCTACTTGGGAGGCTGAGGCAGGAGAATCGCTTGAACCCTGGAAGCAGAGATTGCAGTGAGCAGAGATCATTCCTGGGTGACAGAATGAGACTCCATCTCAAAAAGAAAAAAATTAGCCAGGTGTGGTGGTGTGTACCTAAAATCCCAGTTACTTGGGAGGCTGAGGCAGGAGAATGGTTTGAATCTGGGAGGCAGAGGTTGCAGTGGGCCAAGATCGCACCATTGCACTCCAGCCTGGGCGACAAGAGCTAAACTCTGTCTCAAAAAAAAAAAA","GGCTGGGCGCAGTGGCTCACACCTGTAATCCCAGCACTTAGGGAAGCTGAGGCGAGTAGATCACCTGAGGTCAGGAGTTAGAGACCAGCCTGGCCATCATGGTGAAACCCCGTCTCTACTAAAGATACCAAAAATTAGCTGAGTGTGGTGCTGGGTGCCTGTAATCCCAGAAACTCAGGGTGCCTGTAATCCCAGCAACTCAGGGTGCCTTTAATCCCAGCAACTGAGGGTACCAGTAATCCCAGCAACTCAGGGTGTCTTTAATCCTAGCAACTGAGGGCACCTGTAATCCCAGCAACTCAGGAAGCTGAGACAGGAGAAGTACTTGAACCCAGAAGGCAGAGGTTGCAGTGAGCCGATATTGCACCATTGCACTCCAGTCTGGGCAACAAGAGTGAAACTCTGTCTCAAAAAAAAA"
"chr2A","76343523","76344248","JH378206","6546474","6546861","372","69797049","GGCCAAGCGTGGTGGCTTATGCCTGTAATCTCAACACTTTGGGAGGCCAAGGCGGGTGGATCACCTGAGGTCAGGAGTTCAAAACCAGCCTGGCCAACATGGTGAAATGCCATCTCTACTAAAAATATAAAAAATTAGGCCAGGCGCAGTGGCTCACGCCTGTAATCTCAGCGATTTGGGAGGCCGAGGCGGGCAGATCACGAGGTCAGGAGTTCAAGACCAGCCTGGCCAATATGGTGAAACCCCGTCTCTACTAAAAATACAAAAAGTAGCCGTGCATGGTGGTGTGCGCCTGTAGTCCCAGCTACTCAGGAGGCTGAGGCAGAAGAATCACTTAAACCCTGGAGGCGGAGGTTGCAGTGAGCCGAGATCGCGCCACCACACTCTAGCCTGGGTGACAGAGCAAGGTTCTATCTCAAAAAAAAAAAAAAAAAAATAGCTGGATGTGGTGGCGGTACCTGTAGTCCCAGCTACTTGGTAGGCTGAGGCAGGACCATCGCTTGAACCCTTGAACCCAGGAGGTGGAGGTTGCAGTGAACTGAGATGGCGCCATTGCACTCTAGCCTGGGCAACAAGAGCAAAACTCCATCTCAAAAACTAAACTAAACTAAACTAAACTAAACTAAACTATAAACTAAACTAAACTAAACTAAACTATAAACTAAACTAAACTAAACTTAAATAAAATAAAATAAAATAAAATAATAAAAAAATACAAAAATAAAA","GGCCACACATGGTGGCTAACGCCTGTAATCCCAGCACTTTGGGAGGCCAAGTCGGGTGGATCATGAGGTCAGGAGACCAAGACCATCCTGGCCAAATGGTGAAACCCCGTCTCTACTAAAAATACAAAAATTAGCTGGGCATGGTGGCGTGTGCCTGTAATCCCAGCTACTCAGGAGGCTGAGGCAGGACAATTGCCTGAACCCAGGAGAATTAGCTGGGCATGGTGGCGTGTGCCTGTAATCCCAGCTACTCAGGAGGCTGAGGCAGGACAATTGCCTGAACCCAGGAGGCGAAGGTTGCGGTGAGCCGAGATTGTGCCATTGCACTCCAGCCTGGGTAACAAGAGCGACACTCTGTCTCAAAAAAAAAAAAAAAAAAAAAAAAAAA"
"chr2A","76651223","76652145","JH378118","18053084","18053501","535","58598139","GCTGGGCACAGTGGCTCACACCTGTAATCCCAGCACTCTGGGAGGCCAAGATGGGTAGATCACCTTGAGGTCAGGAGTTCGAGACCAGCGTGGCCAACATGGTGAAACCCTGTCTCTACTAAAAATACAAAAAATGAGCCAGGCATGCCGGGTGCAGTGGCTCACGCCTGTAATCCCAGCACTTTGGGCGGCCGAGGTGGGCGGATCATAAGGTCAGGAGCTCGAGACCATCCTGGCTAACACGGTGAAACCCCACCTCTACTAAAAATACAAAAAATTAGCTGGGCATGGTGGCGGGCACCTGTAGTCACAGCTACTCGGGAGGCTGAGGCAGGAGAACGGCATGAACATGGGAGGCAGAGCTCACAGTAAGCCAAGATCATGCCACTGAACTCCAGCCTGGGCAAGAGAGCAAGACTCCATCTCAAAACAAAAATATAAAAAAAGAAAATTTGGCTGGGTGCAGTGGCTCATGCCTGTAATCCCAGCACTTTGGGAGGCCAAGGCGGGCAGATCACCTGAGGTAGGGAGTTCAAGACCAGCCTGACCAACACGGAGAAACGCTGTCTGTACTAAAAATACAAAATTAGCCGGGTATGGTGGCACATGTCTGTAATCCCAGCTACTAAGGAGGCTGAGGAAGGAGAATCCCTTGAATCTGGGAGGCAGAGGTTGCGGTGAGCCGAGATCGTGCCATTGCACTCCAGCCTGGGCAACAAGACGAAACTCCATCTCAAAAAAAAAAAAAAAAAAAAATCAGCCATGCATGGTGGTGGACGCTTATAATTTCAGCTACTCAGGAGGCTGAGGCAGGAGAATCTCTTGAACCTGGGAGGCAGAGGTTGCAGTGAGCCGAGATCGCGCCACTACACTCCAGCCTAGGCGACAAGAGTGAAACTCCATCTCAAAAATAAATAAATAAA","GGCTGGGCGCAGTGGCTCACACCTGTAATCCCAGCACTTAGGGAAGCTGAGGCGAGTAGATCACCTGAGGTCAGGAGTTAGAGACCAGCCTGGCCATCATGGTGAAACCCCGTCTCTACTAAAGATACCAAAAATTAGCTGAGTGTGGTGCTGGGTGCCTGTAATCCCAGAAACTCAGGGTGCCTGTAATCCCAGCAACTCAGGGTGCCTTTAATCCCAGCAACTGAGGGTACCAGTAATCCCAGCAACTCAGGGTGTCTTTAATCCTAGCAACTGAGGGCACCTGTAATCCCAGCAACTCAGGAAGCTGAGACAGGAGAAGTACTTGAACCCAGAAGGCAGAGGTTGCAGTGAGCCGATATTGCACCATTGCACTCCAGTCTGGGCAACAAGAGTGAAACTCTGTCTCAAAAAAAAA"
"chr2A","81916262","81916860","JH378118","18053084","18053501","245","63863178","GGCCGGGCGCAGTGGCTCACGCCTGTAATCCCAGCACTCTGGGAGGCTGAGATGGGCGGATCATGAGGTCAGGAGTTCGAGACCAGCCTGGCCAACATGGTGAAACCCCGTCTCTACCAAAAATACAAAAATTTGGCCTGGTGCAGTGGCTCACGCCTGTAATCCTAGCCCTTTGGGAGGCTGAGGCAGGTGGGTCACCTGAGGTCAGGAGCTCAAAACCAGCTTGGCCAACATGGTAAAACCCTGTCTCTACTAAAAATACAAAAAATTAGCCAGGTGTGGTGGTGCATCTCTGTAGTCCCAGCTACTCGGCAGGCTGAGGTAGGAGAAGCACTTGAACCTGTGAGGCAGAGGTTGTGGTGAGCCAAGATTGTGCCTGGGCAACAAGAGCAAAACTCCATCTCAAAAAAAAAAAAAAAAAAAAATTAGCCAGGCATGGTGGTGGGCACCTTTAATCCCAGCTACTCAGGAGGTTAAGGCAGGAGAATTGCTTGAACCTGGGAGGTGGAGGTTGCAGTGAGCTGAGATTGCACCATTGCAGTCCAGCCTGGGCGACAAGAGAGAAACTCCATCTCAAAAAAAAAAAAAAAAAAAAAGAA","GGCTGGGCGCAGTGGCTCACACCTGTAATCCCAGCACTTAGGGAAGCTGAGGCGAGTAGATCACCTGAGGTCAGGAGTTAGAGACCAGCCTGGCCATCATGGTGAAACCCCGTCTCTACTAAAGATACCAAAAATTAGCTGAGTGTGGTGCTGGGTGCCTGTAATCCCAGAAACTCAGGGTGCCTGTAATCCCAGCAACTCAGGGTGCCTTTAATCCCAGCAACTGAGGGTACCAGTAATCCCAGCAACTCAGGGTGTCTTTAATCCTAGCAACTGAGGGCACCTGTAATCCCAGCAACTCAGGAAGCTGAGACAGGAGAAGTACTTGAACCCAGAAGGCAGAGGTTGCAGTGAGCCGATATTGCACCATTGCACTCCAGTCTGGGCAACAAGAGTGAAACTCTGTCTCAAAAAAAAA"
"chr2A","88176514","88176893","JH378166","6401112","6401453","89","81775402","GGTCGGGCACAGTGACTCACGCCTGTAATCCCAGCACTTTGGGAGGCCGAGGTGGGCAGCTCACCTGAGGTCAGGCATTTGAGACCAGCCTGGCCAACATGGTGAAACACTATCTCTACTAAAAATACAAAAATTAGCCCAGCGTGGTGTCGGGTGCATGTAATCCCAGCTACTCAGGAGGCTGAGGCGGGAGAAGCGCTTGAATCTGGGAGGCAGAGGCTGCAGTGAGCCAAGATTGCACCACTGCACTCCAGCCTGGGCGACAGGAACAAAACTCCATCTCAAAGAAAAGAAAGAAAGAAAGAAAGAGAGAGAGAAGGAAGGAAGGAAGGAAGGGAAGGAGGGGAAGGAAGGAAGGAGACAAAAAGAAAAGAAATAAA","GGCCAGGTGCAGTGGCTCACCCCTGTAATCCCAGCACTTTGGGAGGTCGAGGTGGGTGGATCACCTGAGGTCAGGAGTTCAAGACCAGCCTGACCAAAATGGTGAAACCCCATCTCTACTAAAAATACAAAACATTAGCCAGACATCGTGGCGGGCACCTGTAATCCCAGCTACTTGGGAGGCTGAGGCAGGAGAATTGCTTGAGCCTAGGAGGCGGAGGTTACAGTGAGCCATGATCGTGCCATTGGACTCCAGCCTGGGCTACAAGAGCGAGACTCCATCTCAAAAAAAAAAAAAAAAAAAAAAAAGAAAGAAAGAAAGAAAGAAAGAAAAGAAAGAAAG"
"chr2A","98672873","98673506","JH378118","18053084","18053501","274","80619789","GGCCGAGCACAGCGGGTCACACCTGTAATCCCAGCACTTTGGGAGGCCAAGGCAGGCAAATTACCTGAGGTCAGGAGTTTGAGACCAGCCTGGCCAACATGGTGAAACCCTGTCTCTACTAAAAATACAAAAAATTAGCCAGGGCCAGGCGTGGTGGCTCACGCCTGTAATCCCAGCACTTTGGGAGGCCGAGGCGGGCGGATCATGAGGTCAGGAGATCGAGACCATCCTGGCTAACACGGTGAAATCCCGTCTCTACTAAAAATACAAAAAAAATTAGCCGGGTGTGGTGGCGGGTGCCTGTAGTCCCAGCTACTTGGGAGGCTGAGGCAGGAGAATGGAGTGAACCCAGGAGGCGGAGCTTGCAGTGAGCTGAGATTGCACACTGCACTCCAGCCTGGGCAACAGAGCAAGACTCTGTAAAAAAAAAAAAAAAAAAAAAAAAAAATTAGCCAGGCGTGCTGGCACACATCTGTAATCCCAGCCACTCCTACTCCAGAAGCTGAGGCAGGAGAATTGCTTGAACCTGGGAGGCAGAGGTTGCAGTTAGCCAAGGTCCCGCCATTGCACTCCAGCCTGGGCAACAAGAATGAAACTCCATCTCAAAAAAAAATGAAGAAAAAGAAGAAGAAGA","GGCTGGGCGCAGTGGCTCACACCTGTAATCCCAGCACTTAGGGAAGCTGAGGCGAGTAGATCACCTGAGGTCAGGAGTTAGAGACCAGCCTGGCCATCATGGTGAAACCCCGTCTCTACTAAAGATACCAAAAATTAGCTGAGTGTGGTGCTGGGTGCCTGTAATCCCAGAAACTCAGGGTGCCTGTAATCCCAGCAACTCAGGGTGCCTTTAATCCCAGCAACTGAGGGTACCAGTAATCCCAGCAACTCAGGGTGTCTTTAATCCTAGCAACTGAGGGCACCTGTAATCCCAGCAACTCAGGAAGCTGAGACAGGAGAAGTACTTGAACCCAGAAGGCAGAGGTTGCAGTGAGCCGATATTGCACCATTGCACTCCAGTCTGGGCAACAAGAGTGAAACTCTGTCTCAAAAAAAAA"
"chr2A","99503347","99503689","JH378144","13229286","13229620","48","86274061","GCCAGGCACAGTGGCTCATGCCTGTAATTCCAGCACTTTGGGAGGTCGAGGCGGGTGGGTCACCTGAGGTCAGGAGTTCAAGAATAGCCTGGCCAACATGGTGAAACTTCATCTCTTCTAAAAATACAAAAAATTAGCCGAGCATGGTGGCGGACGCCTGTAATTCCAGCTACTCAGGAGGCTGAGGCAGGAGAATCGCTTGAACCCAGGAGGCAGAGGCTGCAGTGAGCCGAGATAATGCCATTACACTCCAGCCTGGGCAACAAGAGCGAAACTCCTTCTCAAAAAAAATAAATAATAATAAATAATAATAATAATAATAATAATATAAAATGAAAAACAA","GGCCGGGCGCGGTGGCTCAAGCCTGTAATCCCAGCACTTTGGGAGGCCGAGGCGGGTGGATCACCTGTGGTCAGGAGTTCAAGACAGCTTGGTCAACATGGTGAAACCCCGTCTCTACCAAAAATACAAAAAATTAGCTGGGCATGGTAGCGCATGCCTGTAATCCCAGCTACTCAGGAGGCTGAGGCAGGAGAATTGCCTGAACCCAGGAGGCAGAGGTTGCGGTGAGCCGAGATCGCGCCATTGCACTCCAGCCTGGGTAACAAGAGCGAAACTCCCTCTCATAAAAAATAAATAAATAAATAAATAAATAAATAAATAAATAAATAAATAAA"
"chr2A","108765209","108765542","JH378165","11235642","11235974","56","97529567","GGCTGGGCACAGTGCCTCATTCCTGTAATCCCAGCACTTTGGGAGGCTGTGGCAGGTAGATCACCTGAGGTCAGGAGTTTGAGACCAGCCTGGCCAACATGGCGAAAACCCATCTCTACTAAAAATACAAAAGTTAGCCCGGAGTGGTGGCAGGAGCCTGTAATTCCAGCTACTCAGGAGGCCGAGGAAGGAGAATCGCTTGAATCTGGGAGGTAGAGGTTGCAGTGAGCCGAGATACCACCATTGCATTCCAGCCTGGATAACAAGAGTGAGACCTTGTCTCTAAATAAATAAATAAATAAATAAATAAATACTAATAAATACAAAGAAGAAA","GGCTGGGCACAGTGGCTCTCACCTATAATCCCAGCTCTTTGGGAGGCTGAGGTGGGTGGATCACCTGATGTCAAGAGTTCGAGACCAGCCTGGCCAACATGGTGAAACCCCGTCTCTACTAAAAATACAAAAATTAGCTGGGTGTGGTGGTGGGTTCCTGTAATTTCAGCTACTCAGGAGGCTGAGGCAGGAGAATTGCTGGAACCCGGGAGGCAGAGGTTGCAGTGAGCTGAGATCGCACCATTGCACTCCAGCCCAGGCCAGCAACAGCGAGATTCCGTCTCCAAATAAATAAATAAATAAATAAATAAATAATAAATATAATAAATAAAT"
"chr2B","919704","920030","JH378161","7594162","7594472","52","6674458","GGCTGGATGCAGTGGCTCACGCCTGTAATCCCAGCACTCTGGGAGGCCGAGGCGGGTGGATCACGTGAGGTCAGGAGTTCAAGACTAGCCTGGCCAACATGGTGAAACCCCATCTCTACTAAACACACACACACACACACACACACACACACACACATATTAGCTGGGCGTGGTGGTGGGTGCTTGTAATCCCACCAACTTAGGAGGCTGAGGCAGGAGAATCACTTGAACCTAGGATGCGGAGGTTGCAGTGACCCAAGATTGCACTATTGCACTCCAGCCTGGGCAACAAGAGCAAAACTCGTCTCAAAAAAAAAAAAAAAAAAA","GGCCGGGCGCAGTGGCTCAAGCCTGTAATCCCAGCACTTTGGGAGGCCGAGGCGGGTGGATCACGAGGTCAAGAGATCGAGACCATCCTGGTCAACATGGTGAAACCCCGTCTCTACTAAAAATACAAAAAAAAAAAAAAAATTAGCTGGGCATGGTGGTGTGTGCCTGTAATCCCAGCTACTCAGGAGGCTGAGGCAGGAGAATTGCTTGAACCCAGGAGGCGGAGGTTGTGGTGAGCCAAGATCGTGCCATTGCACTCCAGCCTGGGTAACAAGAGTGAAACTCCGTCTCAAAAAAAAAAAAAAAAAAA"
"chr2B","3077526","3078103","JH378119","32351107","32351490","247","29273581","TTTGAGACCAGCCTGGCCAATATGGAGAAACCTCATCTCTACTAAAAATACAAAAATTTAGCTGGGCACGGTGGCTCATGCCTGTAATCCTAGCACTTTGGGGAGGCCGAGGCAGGCGGATCACGAGATCAGGAGATCAAGAGGTCAAGACCATCCTGGCTTTAACACAGTGAAACCCCATCTCTACTAAAAATAAAAAAAATTAAATGGGCATATTGGCGGGTGCCTATAGTCCCAGCTACTCGGGAGGCTGAGGCAGGAGAATGGCATGAACCTGGGAGGCAGAGCTTGCAATGAGCTGAGATCGAGCCATTGCACTCCAGCTTGGGTGACGGAGTGAGACTCCATCTCAAAAAACAAAGCAAAAATTAACCAGACTTAGTGGCAGGCACCGTGTCTCAGCCGCCAGAATAGCTGGGATTAGACGCCTGCCACCACGCCCAGCTAATTGGGAGGCTGAGGCTGGAGAGTCTCTTGAACCCGGGAGGCGGAGGTTGCAGTGAGCCAAGATGGCGCCATTGCACTCCAGCCTGCGTGATGAGTGAAACTCCGTCTCAAAAAAAAAAAAAAAAAAAAAA","GGCCAGGTATGGTGGCTCACACCTGTAATCCCAGCACTTTGGGAGGCCAAGGCAGGCAGACCACCTGAGGTCAGGAGTTCGAGATCAGCCTAGCCAACATGGTGAAACCCCATCTCTAGTAAAAATAAAATTAGCCAGGCATGGTGGTGCATGCCTGTAACGCAGGTCAGGAGTTCGAGATCAGCTTAGCCAACATGGTGAAACCCCATCTCTAGTAAAAATAAAATTAGCCAGGCAGGTGGTGCCGCCTGTACTCGGGAGGCTGAGGCAGGAGAATCACTTGAACCCAAGAGGCAGAGGTTGCAGTCAGCCAAGATCATGCCATTGCACTCCAGCCTAAGCAAAAAGAGTAAAACTCAGTCTCAAAACAAAAAAACAAAAAAA"
"chr2B","3375929","3376482","JH378118","18053084","18053501","213","14677155","GGCTGGGCGTGGTGGCTCATGCCTGTAATCCCAGCACTTTGGGAGGTTGAGGCAGGAGGATCACCTGAGGTCAGGAGTTCGAGACCGGCCTTGCCAATGGTGAAACTCCGTCTCTACTAAAAATATAAAAATTAGCTAGGTGAGGGCTGGGTGTGGTGGCTTACGCCTGTAATCCCAGCACTTTGGGAGGCCGAGGCGGGCGGATCACGAGGTCAGGAGATCGAGACCATCCTGGCTAACACGGTGAAACCCCGTTTCTACTAAAAATACAAAAAATTAGCTGGGCGTGGTGGCGGGCACCTGTAGTCCCAGCTAGTTGGGAGGCTGAGGCAGGAGAATGGTGGGAATCCAGAAGGCAGAGCTTGCAGTGATCCGAGATTGCGCCACTGCACTCCAGCCTGGGCGACAGAGCAAGACTCCGTTTGGTAGGCTGAGGCAGGAGAATCACTTGAACCCTGGAGGCAGAGCTTTCAGTGAGCCAAGATCATGCCACTTCACTCTAGCCTAAAAGACAAGAGCGAAACTCCATCTCAAAAAAAAGAAAAAAAAAAAAA","GGCTGGGCGCAGTGGCTCACACCTGTAATCCCAGCACTTAGGGAAGCTGAGGCGAGTAGATCACCTGAGGTCAGGAGTTAGAGACCAGCCTGGCCATCATGGTGAAACCCCGTCTCTACTAAAGATACCAAAAATTAGCTGAGTGTGGTGCTGGGTGCCTGTAATCCCAGAAACTCAGGGTGCCTGTAATCCCAGCAACTCAGGGTGCCTTTAATCCCAGCAACTGAGGGTACCAGTAATCCCAGCAACTCAGGGTGTCTTTAATCCTAGCAACTGAGGGCACCTGTAATCCCAGCAACTCAGGAAGCTGAGACAGGAGAAGTACTTGAACCCAGAAGGCAGAGGTTGCAGTGAGCCGATATTGCACCATTGCACTCCAGTCTGGGCAACAAGAGTGAAACTCTGTCTCAAAAAAAAA"
"chr2B","9656517","9657393","JH378118","18053084","18053501","491","8396567","GGCCGGGCGTGGTGGCTCATGACTGTAATCCCAGCACTATGGGAGGCCAAGGCAGGTGGATCACCTGAGGTCAGGAGTTCGAGACCAGCCTGGCCAACATGGTGAAACCCTGTCTCTACTAAAAACACAAACAATTAGGCGGAGTGTGATGGCTCACGCCTGTAATCCCAGTACTTTGGGAGGCTGAGGCGGGCAGGTCACGAGGTCAGGAGTTCGAGACCAGCCTGGCCAACATGGTGAAACCCCGTCTCTACAAAAAATCAAAAATTAGGTGGCAGGCGCCTGTAATCCCAGCCACTTGGGAGGCTGAGGCAGGAGAATCCATTGAACCCAGGAGGTGGAGGTTGCAGTGAGCCGAGATGGTGCCACTGCACTCCAGCCTGGGTGACAGAGCGAGAATTTGTCCTGGAAAAACAACAACAACAACAACAAAAAAACCAAAAAATACCACAGGGCTGGGCATGGTGGCTCATGCCTGTAATCCCAGCACTTTGGGAGGCCGAGGTGGGTGGATCACCTGAGGTCAGGAGTTCATGACCAGCCTGACCACTGTGGTGAAACCCTGTCTCTACTAAAAATACAAAAATTAGCTGGGCATGGTGGCGGGCGCCTGTAATCCCAGCTACTTGGGAGGCTGAGGGAAGAGAATTGCTTGAACCCGGGAGGCGGAGGTTGCAGTGAGCCGTGATCACACCACTGCACTCCAGCCTGGGCAACAGAGTAAGACTCCATCTCAAAAACAAAACAAACAAAAAAATCGGAACCCGGGAGGCAGAGGGCGGAGGTTGCAGTGAGCTGAGATTGTGCCATTGCACTCCAGCCTGGGCAACAAGAGCGAAACTCCGTCTCAAAAAAAAAAAAAAAAAAAAAGTAAAAA","GGCTGGGCGCAGTGGCTCACACCTGTAATCCCAGCACTTAGGGAAGCTGAGGCGAGTAGATCACCTGAGGTCAGGAGTTAGAGACCAGCCTGGCCATCATGGTGAAACCCCGTCTCTACTAAAGATACCAAAAATTAGCTGAGTGTGGTGCTGGGTGCCTGTAATCCCAGAAACTCAGGGTGCCTGTAATCCCAGCAACTCAGGGTGCCTTTAATCCCAGCAACTGAGGGTACCAGTAATCCCAGCAACTCAGGGTGTCTTTAATCCTAGCAACTGAGGGCACCTGTAATCCCAGCAACTCAGGAAGCTGAGACAGGAGAAGTACTTGAACCCAGAAGGCAGAGGTTGCAGTGAGCCGATATTGCACCATTGCACTCCAGTCTGGGCAACAAGAGTGAAACTCTGTCTCAAAAAAAAA"
"chr2B","9705035","9705956","JH378118","18053084","18053501","527","8348049","GCTGGGTGCGGTGGCTCACACCTGTTAATCCCAGTACTTTGGGAGGCCAAGGCAGGCATATCACCTGAGGTCAGGAGTTCAAGAGCAGCCTAGCCAACATGGTGAAACCTCATCTCTACTAAAAATACAAGAAACTGGGCACAGTGACTCACGCCTGTAATCCCAGCACTTTGGGAGGCCGAGGCAGGCAGATCACGAGGTCAAGAGATCAAGACCATCCTGGCTAACATGGTGAAACCCCCATCTCTACTAAAAATACAAAAAATTAGCTGGGCGTAGTGGCGGGCACCTGTAGTCCCAGCTACTCAGGAGGCTGAGGCAGGAGAATTGTTTGAACCCTGGAGGCAGAGGTTGCAGTGATCTGAGATCGTGCCACTGCACTCAAGCTTTGGCGACAGAGTGAGACTCTGTCTCAAAATAATAAACAAAACACCAAAAATACAAAAAATTGGCCGGGTGCAGTGGCTCACGCCTGTAATCCCAGCAATTTGGGAGGCTGAGGCGGGTGGATCACCTGAGGTCAGGAGTTCAAGACCAGCATGTCCAACATGGTGAAACCCCATCTCTGCTAAAAATACAAAAAAATTAGCCAGGCTTGGTGGCTGGCACCTGTAATTGCAGCTACTCAGGAGGCTGAGGCAGGAGAATCGCTTGAACCCGGGAGGTGGAGGTTGCAGTGAGCCGAGATCACCAGTGCACTGCAGCCTGGGCACCAAGAACAAACTCCATCTCAAAAAATGAAAAATGCAAAAAATTAGCCAGGCGTGGTGGTGAGCGCCTGTAATCCCAGCTACTCGGGAGGCTGAGGCAGGAGAATCACTTGAACCTGGGAGGCAGAGATTGCAGTGAGCTGAGACCGTGCCATTGCACTCCAGCCTGGGCAACAAGAGCGAAACTCTGTCTCAAAAACATAAAAATAAAA","GGCTGGGCGCAGTGGCTCACACCTGTAATCCCAGCACTTAGGGAAGCTGAGGCGAGTAGATCACCTGAGGTCAGGAGTTAGAGACCAGCCTGGCCATCATGGTGAAACCCCGTCTCTACTAAAGATACCAAAAATTAGCTGAGTGTGGTGCTGGGTGCCTGTAATCCCAGAAACTCAGGGTGCCTGTAATCCCAGCAACTCAGGGTGCCTTTAATCCCAGCAACTGAGGGTACCAGTAATCCCAGCAACTCAGGGTGTCTTTAATCCTAGCAACTGAGGGCACCTGTAATCCCAGCAACTCAGGAAGCTGAGACAGGAGAAGTACTTGAACCCAGAAGGCAGAGGTTGCAGTGAGCCGATATTGCACCATTGCACTCCAGTCTGGGCAACAAGAGTGAAACTCTGTCTCAAAAAAAAA"
"chr2B","14736410","14736738","JH378139","10421632","10421950","59","4314778","GACTGGGTGCGGTGGCTCATGCCTGTAATCCCAACAATTTGGGAGGCCGAGGCAGGTGGATCATCTGAGGTCAGGAGTTCAAGACCAGCCTGGCCAACATGGTGAATCCTCATCTCTACTAAAAATACAATAATAATAATAATAATAATAATAATAATTAGCTGGGCATTGTCGTGGGCACCTGTAATTCCAGGTACTCCAGAGGCTGAGGTAGGAGAATCGCTCGAAACTGGGAGTGAGGTTGCAGTGAGCCAAGATCATGCCATTGCACTCCAGCCTCAGCAACAAGAATGAAACTCTGTCTTGAAAAAAAAAAGAAAAAAGAAGAA","GGCCGGGTGCAGTGGTTCATGCCTGTAATCCCAGCACTTTGGGAGGCCAAGGCAGGTGGATCATCTGAGGTCAGGAGTTCAAGACTAGCCTGGCCAACATGGTGAAACTTCGTCTCTACCAAAATTAAAAATATATATTTACAAAAAATTAGCTGGGCATGGCAGCGGGTCTCTGTAATCCCAGCTACTCGGGAGGCTGAGGCAGGAGAATCGCTTGAACTCATAAGGTGGAGGTTGCAGTGAGCCAAGATTGCACCATTGCACTCTAGCCTGGGCAACAGGAGTGAAACTCTGTCAAAAAAAAAAAAAAAAAAAAAAA"
"chr2B","21680800","21681159","JH378106","62104717","62105046","71","40423917","GGTCAGGCGCGGTGGCTCATGCCTGTAGTCTCAGCACTTTGGGAGGCCAAGGCGGGTGGATCACCTGAAGTCAGAAGTTCGAGACCAGACTGGCCAACATGGTGAAACCCCCTTCTCTACTAAAAATACAAAAATTAGCTGGGCGTGGGGGCAGGCACCTGTAATCCCAGCTACTCAGGAGGCTGAGGCAGGAGAATCTCTTGAACCTGGGAGGCAGAAGTTGCAGTGGGCCGAGATTGCATCATTGCACTGCAGCCTGGGTGACAAGAGCGAAACTTCGTCTAAAAAGAAAGAAAGAAAGGAAGGAAGGAAGGAAGGAGGGAAGGAAGGAAGGAAGGAAGGAAAGAAAGAAAGAAAGAA","GAGTGCTGTGGCTCAGGCCCGTAATCTCAGCACTTTGGGAGACCAAGGTGAGTGGATCACCTGAGGTCAGGAGTTTGAGACCAGCCTGGCCAACATGGTGAAACCCCGTCTCTACTAAAAATACAAAATTATCTGGGTGTGGTGGCAGGCACCTGTAATCCCAGCTACTTGGGAGGCTGAGGCAGGAGAATCACTTGAACCCAGGAGGTGGAAGTTGCTATAAGCTGAGATCGTGCCATTGCACTCCAGCCTGGTGACAAGAGTGAAATTCCATCTCAAAAAAAAAAAAAAAAAAAGAGAGAGAGAGAAAGAAAGAAAAAAGAAAAGAAA"
"chr2B","43244894","43245221","JH378116","25229810","25230116","50","18015084","GGCTGGGTGCAGTGGCTCACGCCTGTAACCCCCAGCACTTTGGGAGGCCAAGGCGGGTGGATCAACTGAGGTCAGGAGTTCAAGACCAGCCTGGCCAACATGGTGAAACTCCGTCTCTACTAAAAATACACACACACACACACACACACACACACACACACAAATAGCTGGGCGTGGTGGCGGGTGCCTGTAATCCCAGTTACTCAGGAAGCTGAGGCAGGAGAATCGCTTGAACCCTGGAGGCAGAGGTTGCAGTGAGCCGAGATTGCACCATTGCACTCCAGCCTGGGCAACAAGAGTGACACTCCGTCTCAAAAAGAAAAAAAAA","GCCGGGCGCGGTGGCTCAAGCCTGTAATCCCAGCACTTTGGGAGGCCGAGGCGGGTGGATCACGAGGTCAGGAGATCGAGATCATCCTGGTCAACATGGTGAAACCCCATCTCTACTAAAAATACAAAAAAAAAAAAAAAAATTAGCTGGGCATGGTGGCGCGTGCCTGTAATCCCAGCTACTCAGGAGGCTGAGGCAGGAGAATTGCCTGAACCCAGGAGGTGGAGGTTGCGGTGAGCCGAGATCGCGCCATTGCACTCCAGCCTGGGTAACAAGAGTGAAACTCCGTCTCAAAAAAAAAAAAAAA"
"chr2B","44751429","44752062","JH378114","15957391","15957789","300","28794038","GACTGGGTATGGTGGCTTATGCCTGTAATCCCAGCACTTTGGAGGCCAAGGTGAGTGGATCACTTGAGGTCAGAAATTGAAGACCAGCCTGGCCAACATGGTGAAACCCGTCTCTACTAAAAATACAAAAAATTGGCCGGGCGCAGTGGCTCACGCCGGTAATCCCAGCACTTTGGGAGGCCGAGGCAGGCAGATCGCAAGGTCAGGAGATCAAGACCATCCTAGCTAACACGGTGAAACCCCGTCTCTTCTAAAAATAGAAAAGATTAGCTGGTCATGGTAGTGGGCGCCTGTAGTCCCAGCTACTCGGGAGGCTGAGACAGAAGAATGGCGTGAACCAGGGAGGCGGAGGTTGCAGTGAGCCAAGATCGTGCTACTGCACTCCAGCCTGGGCGACAGAGCAAGACTTCGTCTCAAAAAAAAAAATAAATAAATAAATAAATAAAATAAAATAAATACAAATACAAATACAAATACAACAAATTAGCTGGGCCTGGTGGCGCATGCTTGTAATCCCAGCTACTTGGGAGGCTGAGTCAGGAGAATTGCTTGGACCTGGGAGGTGGAGGGTGCAGTGAGCTGAGATCGTGCCATTGTACTCCAGCCTAGATGACAAGAGCAAAACTCCATCTCA","GCAAGGAACGGTGGCTCATGCCTGTCATCCCAGCACTTTGGGAGGCTAAGGAGGGTGGATTACCGAAGGTCATGAGTTTGAGACCAGCCTGACCAACATGGTGAAAACCCCATCTCTACTAAAAATACAAAAAATTAGCCAGATACAGCTATGCGGCAGACTGGGGCAGGAGAATCGCTTGGACCCAAACCCCATCTCTACTAAAAATACAAAAAATTAGCCGGATACAGCTATGCGGGAGACTGGGGCAGGAGAATCGCTTGGACCCGGGAGGCAGAGATTGCAGTGAGATGAGACCATGCCATTGCTCTCTAGCTTGTGCGATGAGAACAAGACTCTGTCTCAAAAAAAAAAAAAAAAAAAAAAAAAAAAAAAAAAAAAAAAGAGAGAGAGAGAAAA"
"chr2B","45619090","45619701","JH378118","18053084","18053501","260","27566006","GGCCTGGTGTGGTGGCTCACGCCTGTAATCCTAGCACTTTGGGAGGCCAAGGTGGGAGGATCACCTTAGGTCAGGAGTTTGAGAGCAGCCTGGCCAACATGGTGAAACCCCATCTCTACTAAAAATAGAAAAATTGGGGCTGGGCGTGGTAGCTCATGCCTGTAATCCCAGCACTTTGGGAGGCCGAGGTGGATGGATCACAAGGTCAGGAGTTCAAGACCGGCCTGAATAACATGGTAAAACTCTGTCTCTACTAAGAATTATAAAAATTAGCCGGGCATTGTGGCACGTGCCTGTAATCCCAGCTACTCAGGAGGCTGAGGAAGGAGAATTGCTTGAACCCGAGAGGTGGAGGTTGCAGTTAGCGGAGATCACACCATTGCATTCCAGCCTGGGCGACAGAGCAAGGCTCCATCTCAAAAAAAAAAAAAAAAATTAGCCGGGAGTGGTGGCAGGCGCCTGTAATCCGAGCTACTCGGGAGGCTGAGGCAGAAGAATCACTTGAACCTGGGAGGTGGAGGTTGCAGTGAGCCGAGATTGAACCACTGCATTCCAGCCTGGGAGACAAGAGTGAGGCTCTGTCTCCAAAATAAATAAATAAATAAAACAAAA","GGCTGGGCGCAGTGGCTCACACCTGTAATCCCAGCACTTAGGGAAGCTGAGGCGAGTAGATCACCTGAGGTCAGGAGTTAGAGACCAGCCTGGCCATCATGGTGAAACCCCGTCTCTACTAAAGATACCAAAAATTAGCTGAGTGTGGTGCTGGGTGCCTGTAATCCCAGAAACTCAGGGTGCCTGTAATCCCAGCAACTCAGGGTGCCTTTAATCCCAGCAACTGAGGGTACCAGTAATCCCAGCAACTCAGGGTGTCTTTAATCCTAGCAACTGAGGGCACCTGTAATCCCAGCAACTCAGGAAGCTGAGACAGGAGAAGTACTTGAACCCAGAAGGCAGAGGTTGCAGTGAGCCGATATTGCACCATTGCACTCCAGTCTGGGCAACAAGAGTGAAACTCTGTCTCAAAAAAAAA"
"chr2B","51636346","51636620","JH378141","14073221","14073505","64","37563125","CTGGGTGCAATGGCTCACGCCTGTTATCCCAGCACTTTGGGAGGCCAATGCAGGTGGATCACTTGAGTTCCGGAGTTCGAGACAAGCCGGGCAATATGGTGAAACCCTGTCTCTACAAAAAAAAAAAAAAAAAAAAAAAAAAAAAGACCCACAAGGCTGAGGCAGAAAAATCACTTGAGCCTGGGAGGCAGAGGTTGCAGTGAGCAGAGATCTTGCTATTGCACTCTAGCCTAGGTGAAAGGAGTAAAACCCTGTCTCAAAAATAAATAAACAAA","GGCCGGGCGCAGTGGCTCAAGCCTGTAATCCCAGCACTTTGGGAGGCCGAGGCGGGTGGATCACGAGGTCGAGAGATCGAGACCATCCTGGTCAACATGGTGAAACCCCGTCTCTACTAAAAATACAAAAAAAAAAAAAACAAAAAAAAACTAGGAGGCTGAGGCAGGAGAATTGCCTGAGCCCAGGAGGCGGAGGTTGCAGTGAGCCGATATCGCGCCATTGCACTCCAGCCTGGGTAACAAGAGCGAAACTCCGTCTCAAAAAAAAAAAAAAAAAAAAAAAAA"
"chr2B","57232926","57233479","JH378119","32351107","32351490","221","24881819","GCCGGGTGCAGTGGTTCATACCTGTAATCCCAGCACTTTGGGAGGCCAGGGCCGGGCGATCACTTGAGGTCAGGGGTTCAAGACCAGCCTGGCCAACATGATAAAACCCTGTCTCTACTAAAAATACAAAAATTAGGCCGGGCATGGTGGCTCACACCTGCAATCCCAACACTTTGAGAGGCCGAGGCTGGTGGATCACCTGAGGTCAGGAGTTCAAGACCAGCCTGGCCAACATGGTGAAACCTCATTTCTACTAAAAATAAAAAAAACTAGCTGAGTGTGGTGGCGCGTGGCTGTAATCCCAGCTACTCGGGAGGCTGAAGCAGGAGAATCACTGGAACCTGGGAGCCAGAGGTTGCAGTGAGCTGAGATCTCACGACTGCACTCCAGCCAGGGTGATAGAGTGAGACTCTGTCTCAAAAAAAAAGAAAAAATTACCCAGGCATGGGGGTGGACATCTGCAATCCCAGCTACTCGGGGCCACTGCACTCTGGCTCTGGCCTGGATGACAGAGCGAGAGCGAGACTTCGTCTAAAAAAAAAAAAAAAAAAAAA","GGCCAGGTATGGTGGCTCACACCTGTAATCCCAGCACTTTGGGAGGCCAAGGCAGGCAGACCACCTGAGGTCAGGAGTTCGAGATCAGCCTAGCCAACATGGTGAAACCCCATCTCTAGTAAAAATAAAATTAGCCAGGCATGGTGGTGCATGCCTGTAACGCAGGTCAGGAGTTCGAGATCAGCTTAGCCAACATGGTGAAACCCCATCTCTAGTAAAAATAAAATTAGCCAGGCAGGTGGTGCCGCCTGTACTCGGGAGGCTGAGGCAGGAGAATCACTTGAACCCAAGAGGCAGAGGTTGCAGTCAGCCAAGATCATGCCATTGCACTCCAGCCTAAGCAAAAAGAGTAAAACTCAGTCTCAAAACAAAAAAACAAAAAAA"
"chr2B","72669522","72670134","JH378118","18053084","18053501","256","54616438","GGCCGGTCAACAGTCGCTCACGCCTGTAATCCCAGCACTTTGGGAGGCTGAGGCAGGCAAATTACCTGAGGTCAGGAGTTCGAGGCCAGCCTGGCCAATGTGGTAAAACTCCATTTCTATTAAAAATACAAAAATTAGGCCGGGTATGGAGGCTCACGCCTGTAATCCCAGCATTTTGGGAGGTCAAGGCAGGTGGATCACCTGAGGTTGGGAGTTCAAGACCAGCCTGACCAACATGGAGAAACCCTGTCTCTACTAAAAATACAAAATCAGCTGGGTGTAGTGGCACATGCCTGTAATCCCAGCTACTTGGTAGGCTGAAGCAGGAGAATTACTTGAACCCGGGAGGCAGAGGTTGCCTTGAGCCGAGATCATGCCATTGCACTCCAGTCTGGGCAACAAAAGCAAAACTCTGTCTCAAAAAAAAAGAAAAAAGAAGAAAAAAAAAAACCCAGCCATGTTGATGGCCGGTGCCTGTAATCCCAGCTACACAGGAGGCTGAGGCAGGAGAATCGCTTGAACCTGGGAGGCAGAGGTTGGCAGTGAGCCAAGATCACGCCATTGCACTCCAGCCTGGGCAACAAGAGTGAAACTCCGTCTCCAAATAAATAAA","GGCTGGGCGCAGTGGCTCACACCTGTAATCCCAGCACTTAGGGAAGCTGAGGCGAGTAGATCACCTGAGGTCAGGAGTTAGAGACCAGCCTGGCCATCATGGTGAAACCCCGTCTCTACTAAAGATACCAAAAATTAGCTGAGTGTGGTGCTGGGTGCCTGTAATCCCAGAAACTCAGGGTGCCTGTAATCCCAGCAACTCAGGGTGCCTTTAATCCCAGCAACTGAGGGTACCAGTAATCCCAGCAACTCAGGGTGTCTTTAATCCTAGCAACTGAGGGCACCTGTAATCCCAGCAACTCAGGAAGCTGAGACAGGAGAAGTACTTGAACCCAGAAGGCAGAGGTTGCAGTGAGCCGATATTGCACCATTGCACTCCAGTCTGGGCAACAAGAGTGAAACTCTGTCTCAAAAAAAAA"
"chr2B","90380820","90381446","JH378118","18053084","18053501","267","72327736","GGACAGGCACAGTGGCTCACGCCTGTAATCCCAGCACTTTGGGAGGCTGAGCGTGGGCGAATCACCTGAGGTCAGGAGTTCAAAACCAGCCTGGCCAACATGGTGAAACACCGTGTCTACTAAAAATACAAAAATTAGGCCAGGCGTGGTGGCTCACGCCTGTAATCCCAGCACTTTGGGAGGCCGAGGTGGGCAGATCACCTGAGGTCAGGAGTTTAAGACCAGCCTGACCAACATGATGAAACCCCGTCTCTACTAAAAATACAAAATTAGCTGAGCATGGTGGCACATGCCTGTAATCCCAGCTAGTCAGGAGGCTGAGGCAGGAGAATCACTTGAACCCAGGAGGCGGAGGTCGCAGTGAGTCTAGATTGCACCATTGCACTCTAGCCTGGGCAACAAGAGCGAAACTCCATCTCAAACAAAATAAAAACCAACCAAACAAACAAACAAAATAGCTAGGCATGGTGGTGGGCACCAGTAATCCCAGCTACTCAGGAGGCTGAGGCAGGAGAATTGCTTGAACCAGGGAGCCAGAGGTTGCAGTGGGCTGAGATCACGCCATTGCACTCCAGCCTGGGAGACAAGAACAAAACTCTGTCTCAAAACAAAAACAAACAAACAAAA","GGCTGGGCGCAGTGGCTCACACCTGTAATCCCAGCACTTAGGGAAGCTGAGGCGAGTAGATCACCTGAGGTCAGGAGTTAGAGACCAGCCTGGCCATCATGGTGAAACCCCGTCTCTACTAAAGATACCAAAAATTAGCTGAGTGTGGTGCTGGGTGCCTGTAATCCCAGAAACTCAGGGTGCCTGTAATCCCAGCAACTCAGGGTGCCTTTAATCCCAGCAACTGAGGGTACCAGTAATCCCAGCAACTCAGGGTGTCTTTAATCCTAGCAACTGAGGGCACCTGTAATCCCAGCAACTCAGGAAGCTGAGACAGGAGAAGTACTTGAACCCAGAAGGCAGAGGTTGCAGTGAGCCGATATTGCACCATTGCACTCCAGTCTGGGCAACAAGAGTGAAACTCTGTCTCAAAAAAAAA"
"chr2B","103272230","103272556","JH378208","3909771","3910091","47","99362459","GGCCTGGCACGGTGGCTCAGGCCTGTAATCCCAGTGCTTTGGGAGCCTGAGGCGGGTATATCACCTGAGGTCAGGAGTTCAAGACCAGCTTGGCCAATATGGTGAAACCCCGTCTCTACTAAAATTTAAAAAAAAAAAAAAAAAAAAAAAAAAAATTAGCCAGGCGTGGTGGCGTGCTCCTGTAATCCCAACTACTCAGGAGGCTGAGGCAAGAGAATCACCTGAACCCGGGAGGTGGAGGTTGCAGTGAGCCAAAATCACGCCATTGCACTCCAGCCTGGGCAACATGAGCAAAACTCTGTCTCAAAAAACAAACAAACAAAAAAA","GCCGGGTGCGGTGGCTCAAGCCTGTAATCCCAGCACTTTGGGAGGCCGAGGCGGGTGGATCACGAGGTCGTGAGATCAAGACCAGCCGAGCCAACATGGTGAAACCCCGTCTCTACTAAAAATACAAAAAAAAAAAAAAAAAAAAAAAAATTAGCTGGGCATGGTGGCGTGTGCCTGTAATCCGAGCTACTCAGGAAGCTGAGGCAGGAGAATTGCCTGAACCCAGGAGGCGGAGGTTGCAGTGAGCCGAGATCGCGCCATTGCACTCCAGCCTGGGTAACAAGAGCGAAACTCCGTCTCAAAAAAAAAAAAAAAAAAAAA"
"chr2B","105625666","105626317","JH378118","18053084","18053501","304","87572582","GGCTGGGCGCGGTGGCTCAAGCCTTAATCCTAGCAGCTTGGGAGGGCGAGGCGGGCGGATCACCTGAGGTTAGAAGTTCGAGACCAGCCCGGCCAACGTGGGAAACCCCATCTCTATTAAAAACACAAAAATTAGCCGGGAGTGGGCTGGGTGCAGTGGCTCATGCCTGTAATCCCAGCACTTTGGGAGGCCAAGGCGGGCAGATCATGAGGTCAGGAGATCAAGACCATCCTGGTTAACACGGTGAAACCCCGTCTCTACTAAAAATACAATAATTAGCCGGGCATGGTGGCGGGCACCGGTAGTCCCATCTACGCAGGAGGCTGAGGCGGGAGAATGGCGTGAACCCGGGAGGTGGAGCTTGCAGTGAGCCAAGATCGCGCCACTGCACTCCATCCTGGGCGACAGAGCGAGACTCCATCTCAAAAAAAAAAAAAAAAAAAAAAAAAAAAAAAAATTAGCCGGGCGTGGTGGCAGGCGTCTGTAATCCCAGCTATTCAGGAGGCTGAGGCAAAAGAATCGCTTGAACCCAGAGGCAGAGGTTGCAGTGAGCCAGGGATCATGCCATTGCACTCCAGAATGAGTGACAAAAGCGAGACTCCATCTCAAAAAAAAAAAAAAAAAAAAAGAAAAGAAAAATCAAAATCAAAAC","GGCTGGGCGCAGTGGCTCACACCTGTAATCCCAGCACTTAGGGAAGCTGAGGCGAGTAGATCACCTGAGGTCAGGAGTTAGAGACCAGCCTGGCCATCATGGTGAAACCCCGTCTCTACTAAAGATACCAAAAATTAGCTGAGTGTGGTGCTGGGTGCCTGTAATCCCAGAAACTCAGGGTGCCTGTAATCCCAGCAACTCAGGGTGCCTTTAATCCCAGCAACTGAGGGTACCAGTAATCCCAGCAACTCAGGGTGTCTTTAATCCTAGCAACTGAGGGCACCTGTAATCCCAGCAACTCAGGAAGCTGAGACAGGAGAAGTACTTGAACCCAGAAGGCAGAGGTTGCAGTGAGCCGATATTGCACCATTGCACTCCAGTCTGGGCAACAAGAGTGAAACTCTGTCTCAAAAAAAAA"
"chr2B","114588344","114588667","JH378116","25229810","25230116","47","89358534","GGCCGGGTGTGGTGGCTCACGCCTGTGATCCCAGCACTTTGGGAGGCCGATGCGGGTGGATCACCTGAGGTCAGGAGTCCAAGACTAGCCTGGCCAGCATGGTGAAACCCCATCTCTACTAAAAATACACACACACACACACACACACACACACAAAATTAGCTGGGCGTGGTGGTGGGTGCCTGTAATCCCAGCTACTCAGGAGGCCGAGGCAGGAGAATTGCTTGAACCCAGGAGGCAGAGGTTGCAGTGAGCTGAGATCACTCTGTTGTACTCCAGCCTGGGTGACAAAAGTGAAACTCTGTCTCAAAAAAAAAAAAAAAA","GCCGGGCGCGGTGGCTCAAGCCTGTAATCCCAGCACTTTGGGAGGCCGAGGCGGGTGGATCACGAGGTCAGGAGATCGAGATCATCCTGGTCAACATGGTGAAACCCCATCTCTACTAAAAATACAAAAAAAAAAAAAAAAATTAGCTGGGCATGGTGGCGCGTGCCTGTAATCCCAGCTACTCAGGAGGCTGAGGCAGGAGAATTGCCTGAACCCAGGAGGTGGAGGTTGCGGTGAGCCGAGATCGCGCCATTGCACTCCAGCCTGGGTAACAAGAGTGAAACTCCGTCTCAAAAAAAAAAAAAAA"
"chr2B","119164675","119165506","JH378118","18053084","18053501","461","101111591","GCTGGGCGTGGTGGCTCATGCCTGTAATCCCAGCACTTTGGGAGGCCAAGGCAGGTGGATAGCCTGAGGTCAGGATGTTGTAACCAAGCGAGTTGTAGAGAAACGCCACACTCTGAGACTAATTCAGGAGTCCTTTATTGCCGGCGACTGAGAGACGGCTAGCGCTCAAGATTCTCTCGGCCCCGAAGAAAGGGCTAGATTTCTTTTTATACCGTGGCCTAACTAGGGGAGGGGGAGTTTAGCTGAAACAATTTTTACAGAAGCAGAACAGGCAAAAAGTTAAAAAATTAATTGGTTACAGAAGTAGTTACAGAAAAAATAAACAGTTCCAGGTGCAGGGGCTTAAACTATCACAAAGAGATAAAGGCAGGGGCTTTAGATGCCATCCACTGAGCGTCCCCAGGAGCTGCTGGTTCAGCTTGCCTCAATATCTTCTCAGTAAGTGCATTCCTGGACGTGCATGGAGTCAGCTTGCACCAGTTATGCCCTTAAGGGAGGGAGGTAAAGGGGCTGTAAGTGAAGGAACTAAAATGGAGTCTGTCCGGCTTTCTCAGCTATGAGAGACAATCAGGTTAAAACAAGGTAGGGTATCACAAGGAGTTCAAGACCAGCCTGGCCAACAGAATGAAACCCCGTCTCTACTAAAAATACAAAAAATTAGGTGGGCGTGGTGGCAGGCGCCTGTAATCCCAGCTACTAGGGAGACTGAGACAGAAGAATTTCTTGAACCCAGGAAGCAAAGGTTGCAGTGAGCCGAGATCATGCTGTTGCACTCCAGCCTGGGCAACAAGAGCGTAACTCCGTCTCAAAAAAAAAAAAAAAACCAAAAAAA","GGCTGGGCGCAGTGGCTCACACCTGTAATCCCAGCACTTAGGGAAGCTGAGGCGAGTAGATCACCTGAGGTCAGGAGTTAGAGACCAGCCTGGCCATCATGGTGAAACCCCGTCTCTACTAAAGATACCAAAAATTAGCTGAGTGTGGTGCTGGGTGCCTGTAATCCCAGAAACTCAGGGTGCCTGTAATCCCAGCAACTCAGGGTGCCTTTAATCCCAGCAACTGAGGGTACCAGTAATCCCAGCAACTCAGGGTGTCTTTAATCCTAGCAACTGAGGGCACCTGTAATCCCAGCAACTCAGGAAGCTGAGACAGGAGAAGTACTTGAACCCAGAAGGCAGAGGTTGCAGTGAGCCGATATTGCACCATTGCACTCCAGTCTGGGCAACAAGAGTGAAACTCTGTCTCAAAAAAAAA"
"chr2B","120245728","120246355","JH378118","18053084","18053501","278","102192644","GGCCGGGTGCCATGGTTCACGCCTGTAATCTCAGCACTTTGGGAGGCTGAGGCGGGCGGATCACCTGAGGTCAGGAGTTCAAGACCAGCCTGGCCAACAAGGCAAAACCCCATGTCTACTAAAAATACAAAAATTAGGCCGGGCGCAATGGCTCTCACCTGTAATTCCAGCACTTTGGGAGGCCAAGGCGAGCGGATCACGAGGTCAGCAGATCGAGACCATCCTGGCTAACATGGTGAAACCCTGTCTCTAATAAAAATACAAAAAAAATTAGCTGGGCGTGGCGGCGGGTACCTGTAGTCCCAGCTACTCGAGAGGCTGAGGCAGGAGAATGGCGTGAACCCAGGAGGTGGAGCTTGCAGTGAGCCGAGATTGTGTCACTGCACTCCAGCCCGGGCGACAGAGAGACACTCTGTCTGTCTCAAAACAAAAACAAAAACAAAACAAAAATCTAAAAATTAGCCGGGTGTGATGGCAGGCGCCTGTAATTCCAACTACTTGGGAGGCTGAGGCAGGAGAATCGCTTGAATCTGGGAGGCAGAGGTTGCAGTGAGCCCAGATCATGCCATTGCACTCCAGCCTGGGCAACAAGAGCGAGACTCCGTCCAAAAAAAGAAAAAAAAAAGAA","GGCTGGGCGCAGTGGCTCACACCTGTAATCCCAGCACTTAGGGAAGCTGAGGCGAGTAGATCACCTGAGGTCAGGAGTTAGAGACCAGCCTGGCCATCATGGTGAAACCCCGTCTCTACTAAAGATACCAAAAATTAGCTGAGTGTGGTGCTGGGTGCCTGTAATCCCAGAAACTCAGGGTGCCTGTAATCCCAGCAACTCAGGGTGCCTTTAATCCCAGCAACTGAGGGTACCAGTAATCCCAGCAACTCAGGGTGTCTTTAATCCTAGCAACTGAGGGCACCTGTAATCCCAGCAACTCAGGAAGCTGAGACAGGAGAAGTACTTGAACCCAGAAGGCAGAGGTTGCAGTGAGCCGATATTGCACCATTGCACTCCAGTCTGGGCAACAAGAGTGAAACTCTGTCTCAAAAAAAAA"
"chr2B","120546671","120547290","JH378118","18053084","18053501","274","102493587","GGCCAGGCATGGTGGCGCACGCCTGTAATCCCAGCACGTTGGGAGGCCAAGGCAGACAGATCACTTGAGGTCAGGAGTTCAAGACCAGCCTGGCCAACATGGGGAAACCCTGTCTCTACTAAAAAAACACAAAATTAGGCCAGGTGCAGTGGCTCACGCCTGTAATCCCAGCACTTTGGGAGGCCGAGGCAGGTGGTTCACGAGGTCAGGAGATCGAGACCATCCTGGCTAACATGGTGAAACCCCATCTCCACTAAAAATACAAAAAAATTAGCCAGGTGTGGTGGCACGTGCCTGTAGTCCCAGCTACTCAGGAGGCTGAGGCAGGAGACTGGCATGAACCTGGCAGGTGGAGCTTGCAGTGAACTGAGATCATGCCACTGCACTCTAGCCTGGGCAACAGAGTGAGACTCCATCTCAAAATAATAAATAAATTAAAAAAACAAAACAAAATTAGCCGGGCGTGGTGGCGGGTGCATGTAATCCCAGCTGCTTGGGAGGCTGAGGAAGAAGAATCACTTGAACCTGGGAGTCAGAGGTTGCAGTGAGCTGAGATCACATCATTGCACTCCAGCCTGGGCGACAGGCTCCATCTCAGAAAAAAAAAAAGAAAAAAGAAA","GGCTGGGCGCAGTGGCTCACACCTGTAATCCCAGCACTTAGGGAAGCTGAGGCGAGTAGATCACCTGAGGTCAGGAGTTAGAGACCAGCCTGGCCATCATGGTGAAACCCCGTCTCTACTAAAGATACCAAAAATTAGCTGAGTGTGGTGCTGGGTGCCTGTAATCCCAGAAACTCAGGGTGCCTGTAATCCCAGCAACTCAGGGTGCCTTTAATCCCAGCAACTGAGGGTACCAGTAATCCCAGCAACTCAGGGTGTCTTTAATCCTAGCAACTGAGGGCACCTGTAATCCCAGCAACTCAGGAAGCTGAGACAGGAGAAGTACTTGAACCCAGAAGGCAGAGGTTGCAGTGAGCCGATATTGCACCATTGCACTCCAGTCTGGGCAACAAGAGTGAAACTCTGTCTCAAAAAAAAA"
"chr2B","121497279","121497900","JH378118","18053084","18053501","267","103444195","GGCCAGGCACGGTGGCTCACGCCTGTAATCCCAGCACTTTGGGAGGCTGAGGTGGGTGGATCGCCTGAGGTCAGGAGTTTGAGACCAGCCTGGCCAACATGGTGAAACCCTGTCTCCACTAAAAATACAAAAATTAGGCTAGGCGCCCAGTGGCTCACGCCTGTAATCCCAACACTTTGGGAGGCCAAGGTGGGCGGATCAAGAGGTCAGGAGATCAAGACCATCCTGGCTAACACGGTGAAACCCCATCTCTACTAAAAATATAAAAAAATTAGCTGGGTGTGGTGGCGGGCACCTGTAATCTCAGCTACTCAGGAGGCTGAGGCAGGAGAATGGTGTGAACCCAGGAGGCAGAGCTTGCAGTGAGCCGAGATTGTGCCACTACACTCCAGCCTGGGCAACAGAGCGAGACTCCGTCTCAAAAAAAAAAAAAAATTAGCTGGGCATGGTGGCCGAAGCCTGTAATCCCAGCTACTTGGGAGGCTAAGGCAGGACAATTGCTTGAATTGGGGAGGCAGAGGTTGCAGTGAGCCAAGATCTGAGATCACACCATTGCACTCCAGCCTGGGTGACAAGAGCGAGGCTTCATCTAAAAAAAAAAAAAAAAAAAAGAATAAGGAAA","GGCTGGGCGCAGTGGCTCACACCTGTAATCCCAGCACTTAGGGAAGCTGAGGCGAGTAGATCACCTGAGGTCAGGAGTTAGAGACCAGCCTGGCCATCATGGTGAAACCCCGTCTCTACTAAAGATACCAAAAATTAGCTGAGTGTGGTGCTGGGTGCCTGTAATCCCAGAAACTCAGGGTGCCTGTAATCCCAGCAACTCAGGGTGCCTTTAATCCCAGCAACTGAGGGTACCAGTAATCCCAGCAACTCAGGGTGTCTTTAATCCTAGCAACTGAGGGCACCTGTAATCCCAGCAACTCAGGAAGCTGAGACAGGAGAAGTACTTGAACCCAGAAGGCAGAGGTTGCAGTGAGCCGATATTGCACCATTGCACTCCAGTCTGGGCAACAAGAGTGAAACTCTGTCTCAAAAAAAAA"
"chr2B","122510995","122511306","JH378112","18084897","18085188","71","104426098","CCTGTAACCCCAGCACTTTGGGAGGCCAAGGTGGGCAGATCACCTGAGTTTGAGACCAGCCTGGCCAACATGGTGAAACCCTGTCTCTACTAAAAATACAAAAATTAGCCGGGCATGGTGGCAGGTACCTGTAGTCCCAGCTATTTGGGATGCTGTGGCAGGAGAATCGCTTGAAGCCGGGAGGCAGAGGTTGCAGTGAGCCCAGATCGCGCCATTGCACTCCAGCCTGGGCAATAAGAGTAAGACTCCATCTCAAATAATAATAATAATAATAATAATAATAATAATACAACGACAACAACAACAAAAAAA","GCCTGTAATCCCAGGACTTTGGGAGACTGAGGTGGGCACATCACCTGAGGTCAGGAGTTCGAGACCAGCCTGGCCAAGATGGTGAAACCCCTATCTCTAATAAAAATACAAAAACTAGCTGGGCATGGTGGCAGGAGCCTGTAATCCCAGCTATTTGAGAGGCTGAGGCAGGTGAATCACTTGAACCCAGGAGGCAGAGGTTGCAGTGAGCTGAGATCAGGCCATTGCACTCCAGCCTGGGCAACGAGAGTGAAACTCCATCTAAAAAAAAAAAACAAAAAAAAAGAAGAAA"
"chr2B","128283340","128283656","JH378115","37459876","37460191","45","90823464","GGCTGGGAGTGGTGGCTCATGCCTGTAATTCCAGCACTTTGGGAGGCTGAGGCAGGCGGATCACCTGAGGTCAGGAGTTCGAGAACAGCCTGGCCAACACGGTGAAACCCTGTCTCTACTAAAAAAAAAAAAAAAAAAAAAAAAAAATAGCTGGGCATGGTGGTGCATGCCTGTAATCCCAAGTACTCAGGAGGCTGAGGCAGGAGAATAACTTGGACCTGGGAGGTGGAGGTTACAGTGAGCCAAGATCACACCATTGCACTCCAGCTTGGGCAACAAGAGCTCAACTCTGTCTCAAAAAAAAAAAAAAAAAAAAA","GGCCGGGCACGGTGGCTCAAGCCTGTAATCCCAGCACTTTGGGAGGCCGAGGCGGGTGGATCATGAGGTCAAGGATCGAGACCATCCTGGTCAACATGGTGAAAACCAGTCTCCACTAAAAAAACAAAAAAAAAAAAAAAAAATTAGCTGGGCATGGTGGCGCATGCCTGTAATCCCAGCTACTCAGGAGGCTGAGGCAGGAGAATTGCCTGAACCCAGGAGGCGGAGGTTGCGGTGAGCCGAGATCGCGCCATTGCACTCCAGCCTGGGTAACAAGAGCGAAACTCCGTCTCAAAAAAAAAAAAAAAAAAAAAAA"
"chr2B","128830939","128831550","JH378118","18053084","18053501","255","110777855","GGCAGGGTGCGATGGCTCACACCTGTAATCCCAGCACTTTGGGAGGCAAGGGCGGGCAGATCACCTGAGGTCAGGAGTTCAATACCAGCCTGGCCAACATGGCGAAATCCCGTCTCTACTAAAAATACAAAGAAAATTGGCCGGGCGCGGTGGCTCACGCCTGTAATCCCAGCGCTTTGGGAGGCCAAGGCAGGCGGATCACGAGGTCAGGAGATCGAGACCATCCTGGCTAACACAGTTGTGAAACCCCATCTCCACTAAAAATACAAAAAATAAGCCGGGCATGGTGGCGGGCACCTGTAGTCCCAGCTACTCAGGAGGCTGAGGCAGGAGAATGGCGTGAACCCGAGAGGCAGAGTTTGCAGTGAGTCAAGATCACACCACTGCTCTCTAGCCTGGGCGACAGAGCGAGACTCCGTCTCAAAAAAAAAAAAAAAAAGAAAAGAAAATTATCCAGGCGTGGTGGCAGGCGCCTTTAATCCCAGCTAACTAGGAGGCTGAGGCAGGCGAATCTGTTGAATCCAGGAGGCAGAGGTTGCAGTGAGCTGAGATTGGCATTGCACTCCAGCCTGGGCAACAAGAGCGAAACTCTGTCTCAAAAAAAAGAGAAAA","GGCTGGGCGCAGTGGCTCACACCTGTAATCCCAGCACTTAGGGAAGCTGAGGCGAGTAGATCACCTGAGGTCAGGAGTTAGAGACCAGCCTGGCCATCATGGTGAAACCCCGTCTCTACTAAAGATACCAAAAATTAGCTGAGTGTGGTGCTGGGTGCCTGTAATCCCAGAAACTCAGGGTGCCTGTAATCCCAGCAACTCAGGGTGCCTTTAATCCCAGCAACTGAGGGTACCAGTAATCCCAGCAACTCAGGGTGTCTTTAATCCTAGCAACTGAGGGCACCTGTAATCCCAGCAACTCAGGAAGCTGAGACAGGAGAAGTACTTGAACCCAGAAGGCAGAGGTTGCAGTGAGCCGATATTGCACCATTGCACTCCAGTCTGGGCAACAAGAGTGAAACTCTGTCTCAAAAAAAAA"
"chrUn_NW_019937536v1","22392","23013","JH378118","18053084","18053501","279","18030692","GGCCAGGCATGGTGGCTATGCTCGTAATCCCAGCACTTCGGGAGGCCAAGGCAGGTGGATCACCTGAGGTCAGGTGTTCGAGATCAGCCTGACCAACATGTGTGAAACCCCACCTCCCTCTACAAAAAACAAATTATGGCCGAGCGAGTGGCCACCCGTACATTTTATCCAGTACTTTGGGAGGCTGAGGAGCAGGGATCACTGAGGTCGGTGAGTTTCGCACTCAGCCTGACCCAACATGGAGACACCCATCTCTACTAAAAATACAAAAATTAGCCAGGTGTGGTAGCACATGCCCGTTGTAATCCCAGCTACTCTGGAGCTGAGCAGGAGAATCACTTGAACCTGGGAGGCGGAAGTTGTGGTGAGCCAAGATCAGTCGTTGCACTCCAGCCTGGGCAACAAGGGAAAACTCTGTCTCAAAAAAAAAAAAAGAAAAAGAAAAATCAGCCAGGCATGGTGGACAATGCCAGTAATTCCAGCTACTTGGGAGGCTGAGACAGGAGATCGCTTGAATCTGGAAGGCAGAGGTTGCAGTGAGCTGAGATCGCACCATTGCACTTCCAGCCTGGCAACAACTTGTGAAGCTTCCCATCTCAAAAAATAAAAAAAAAAAAAAAAA","GGCTGGGCGCAGTGGCTCACACCTGTAATCCCAGCACTTAGGGAAGCTGAGGCGAGTAGATCACCTGAGGTCAGGAGTTAGAGACCAGCCTGGCCATCATGGTGAAACCCCGTCTCTACTAAAGATACCAAAAATTAGCTGAGTGTGGTGCTGGGTGCCTGTAATCCCAGAAACTCAGGGTGCCTGTAATCCCAGCAACTCAGGGTGCCTTTAATCCCAGCAACTGAGGGTACCAGTAATCCCAGCAACTCAGGGTGTCTTTAATCCTAGCAACTGAGGGCACCTGTAATCCCAGCAACTCAGGAAGCTGAGACAGGAGAAGTACTTGAACCCAGAAGGCAGAGGTTGCAGTGAGCCGATATTGCACCATTGCACTCCAGTCTGGGCAACAAGAGTGAAACTCTGTCTCAAAAAAAAA"
"chrUn_NW_019938120v1","38807","39131","JH378148","10302642","10302970","52","10263835","GCCGGGTGTGGTGGCTCACACCTGTAATCCCAGCACTGCGGGAGACCCAGGCGGGCAGATCACTTGAGGTCAGGAGTTCGAGACCAGCCTGGCCAACATGGTGAAACCTCGACTCTACTAAAAATACAAAAAGCCAGGCGTGGTGGTGGGCACCTGTAATCCCAGCTACTTGGGAGGCCAAAGCAGGAGAATTGCTTGAACCCGGGAGGCGGAGGTTGCAGTGAGCCGAGATCGTGCCATTGCACTCCAGCCTGGGCAACAATAGCGAAACTCCACCTCAAAAAAATAAAATAAAATAAAATAAAATCAGGGGGAGAAAAAAAAA","GGCCGGGCGCGGTGGCTCAAGCCTGTAATCCCAGCACTTTGGGAGGCCGAGGCGGGTGGATCACGAGGTCAAGAGATCGAGACCATCCTGGTCAACATGGTGAAACCCCGTCTCTACTAAAAATACAAAAAATTAGCTGGGCATGGTGGTGGGTGCCTGTAATCCCAGCTACTCAGGAGGCTGAGGCAGGAGAATTGCCTGAACCCAGGAGGCGGAGGTTGCGGTGAGCCGAGATCGCGCCATTGCACTCCAGCCTGGGTAACAAGAGTGAAACTCTGCCTCAAAAAAAAAAAATAAAATAAAATAAAATAAAATAAAATAAAATAAAA"
"chrUn_NW_019938145v1","8093","8412","JH378192","5372003","5372306","56","5363910","GACTGGGTGCAGTGGCTCACTCCTGTAATCCCAGCACTTTGGAAGACTGAGGCAGACGGATCACCTGAGGTCAGGAGTTTTGAGACCAGCCTGGCCAACATGGTGAAACCCCTTCTTAACTAAAATTACACACACACACACATACACACACACACACAAACAAATTAGCTGGGCGTGGTGGTGGGCACCTGTAATCCCAGCTACTTAGGAGGCTGAGGCAGGAGAATTGCTTGAACCCGGGAGGTGGAGGTTGCAGTGAGCCAAGATCATGCCATGGCACTCCAGCCTCGGCAACAAGAGGGAGATTCCATCTCGAAAAA","GCCGGGCATGGTGGCTCACACCTGTAATCCCAGCACTTTGGGAAGCTGAGGCAGGTGGATCACCTGAGGTCAGGAGTTCAAGACCAACCTGGCCAACATAGTGAAACCCGGTCTCTACTAAAAATACAAAAAAAAAAAAAAAAAAAAAATTAGCTGGGTGTGGTGGCAGGCGCCTGTAATCCCAGCTACTAGGAGGCTGAGGCAGGAGAATTGCTAGAACCCAGGAGGTGGAGGTTGTAGTGAGCCAAGATTGCACCATTGCACTCCAGCCTGGGCAACAAGAGTGACACTCTGTCTCAAAAAA"
"chrUn_NW_019938545v1","68229","68548","JH378192","5372003","5372306","56","5303774","GACTGGGTGCAGTGGCTCACTCCTGTAATCCCAGCACTTTGGAAGACTGAGGCAGACGGATCACCTGAGGTCAGGAGTTTTGAGACCAGCCTGGCCAACATGGTGAAACCCCTTCTTAACTAAAATTACACACACACACACATACACACACACACACAAACAAATTAGCTGGGCGTGGTGGTGGGCACCTGTAATCCCAGCTACTTAGGAGGCTGAGGCAGGAGAATTGCTTGAACCCGGGAGGTGGAGGTTGCAGTGAGCCAAGATCATGCCATGGCACTCCAGCCTAGGCAACAAGAGGGAGATTCCATCTCGAAAAA","GCCGGGCATGGTGGCTCACACCTGTAATCCCAGCACTTTGGGAAGCTGAGGCAGGTGGATCACCTGAGGTCAGGAGTTCAAGACCAACCTGGCCAACATAGTGAAACCCGGTCTCTACTAAAAATACAAAAAAAAAAAAAAAAAAAAAATTAGCTGGGTGTGGTGGCAGGCGCCTGTAATCCCAGCTACTAGGAGGCTGAGGCAGGAGAATTGCTAGAACCCAGGAGGTGGAGGTTGTAGTGAGCCAAGATTGCACCATTGCACTCCAGCCTGGGCAACAAGAGTGACACTCTGTCTCAAAAAA"
"chrUn_NW_019938914v1","5311","5647","JH378192","5372003","5372306","76","5366692","GACTGTGTGCAGTGGCTCACTCCTGGAATCCCAGCACTTTGGAAGACTGAGGCAGACGGATCACCTGAGTTCAGGAGTTTGAGACCAGCCTGGCCCACATGGTGAAACCCCTTCTTAACTAAAATTACACATACACACACACATACACACACACACACACACACACACACACACACACAAATTAGCTAGGCGTGGTGGTGAGCACCTGTAATCCCAGCTACTTAGGAGGCTGAGGCAGGAGAATTGCTTGAACCCGGGAGATGGAGGTTGCAGTGAGCCAAGATCATGCCATGGCACTCCAGCCTAGGCAACAAGAGGGAGATTCCGTCTTGAAAAA","GCCGGGCATGGTGGCTCACACCTGTAATCCCAGCACTTTGGGAAGCTGAGGCAGGTGGATCACCTGAGGTCAGGAGTTCAAGACCAACCTGGCCAACATAGTGAAACCCGGTCTCTACTAAAAATACAAAAAAAAAAAAAAAAAAAAAATTAGCTGGGTGTGGTGGCAGGCGCCTGTAATCCCAGCTACTAGGAGGCTGAGGCAGGAGAATTGCTAGAACCCAGGAGGTGGAGGTTGTAGTGAGCCAAGATTGCACCATTGCACTCCAGCCTGGGCAACAAGAGTGACACTCTGTCTCAAAAAA"
"chrUn_NW_019939806v1","5334","5657","JH378192","5372003","5372306","72","5366669","GGTGCAGTGGCTCACTCCTGTAATCCCAGCACTTTGGAAGACTGAGGCAGACGGATCACCTGGTCAGGAGTTTGAGACCAGCCTGGCCAACATGGTGAAACCCCTTCTTAACTAAAATTACACATACACACACACATACACACACACACACACACACACACACACAAACAAATTAGCTGGCGTGGTGGTGGCACCTGTAATCCCAGCTACTTAGGAGGCTGAGGCAGGAGAATTGCTTGAACCCGGGAGTGGAGGTTGCAGTGAGCCAAGATCATGCCATGGCACTCCAGCCTAGGCAACAAGAGGGAGATTCCATCTGAAAAA","GCCGGGCATGGTGGCTCACACCTGTAATCCCAGCACTTTGGGAAGCTGAGGCAGGTGGATCACCTGAGGTCAGGAGTTCAAGACCAACCTGGCCAACATAGTGAAACCCGGTCTCTACTAAAAATACAAAAAAAAAAAAAAAAAAAAAATTAGCTGGGTGTGGTGGCAGGCGCCTGTAATCCCAGCTACTAGGAGGCTGAGGCAGGAGAATTGCTAGAACCCAGGAGGTGGAGGTTGTAGTGAGCCAAGATTGCACCATTGCACTCCAGCCTGGGCAACAAGAGTGACACTCTGTCTCAAAAAA"
"chrUn_NW_019939972v1","22428","22949","JH378206","6546474","6546861","203","6524046","CGCGGTGGCTCACCACTGTAATCCCAGCACTTTCGGAGGCCAAGGCGGGTGGATCATGAGGTCAGGAATTCAAGAACAACCTGGCCAAGATAGTGAAACCTCATCTCTACTAAAAATAAAAAAACTCGCCGGCTGTGGTGGAAAAAGGTCAGGCGCGGTGGCTCACGCCTTTACGTAATCCCAGGACTTTGGGAGGCCGAGGCAGGAGGATCGCTGGAGTCCAGGAGTTCGAGACCAGCCTTGGTAAGGGCGAAAATCCATCTCTACTAAAAACACAAATAATTAACCAGACATGGTGGTGGGCACCTGTAGTCCGAGCTACTCTGGAGGCCGAGGTGGGTCAGGATTGCTTGAGCCTGGGAGGTCGAGGCTGCAGTGAGCTGTGATTGTGGAGGCTGAGGCAGGAGAATCACTTGAACCCCGGAGGCGGAGGTTGCGGCGAGTTGAGATTGCGCCCTTGCACTCCAGCCTGGGCAACAAGAGGGGAAACTCTGCCTCAAAAATTAAAATAAAATAAATAAA","GGCCACACATGGTGGCTAACGCCTGTAATCCCAGCACTTTGGGAGGCCAAGTCGGGTGGATCATGAGGTCAGGAGACCAAGACCATCCTGGCCAAATGGTGAAACCCCGTCTCTACTAAAAATACAAAAATTAGCTGGGCATGGTGGCGTGTGCCTGTAATCCCAGCTACTCAGGAGGCTGAGGCAGGACAATTGCCTGAACCCAGGAGAATTAGCTGGGCATGGTGGCGTGTGCCTGTAATCCCAGCTACTCAGGAGGCTGAGGCAGGACAATTGCCTGAACCCAGGAGGCGAAGGTTGCGGTGAGCCGAGATTGTGCCATTGCACTCCAGCCTGGGTAACAAGAGCGACACTCTGTCTCAAAAAAAAAAAAAAAAAAAAAAAAAAA"
"chrUn_NW_019940263v1","14017","14928","JH378118","18053084","18053501","525","18039067","GGTCGGGCACGGTGGCTTACGCCTGTAATCCCAACACTTTGGGAGGCAGAGGTGGTGGATCACCTGAGGTCAGGAGTTCGAGACCAGCCTGGCCAACATGGTGAAATCCTGTCTTTACTAATAACACAAAAATTAGCTGACCAGGCACGGTGGCTCATGCCTGTAATCCCAGCACTTTGGGAGGCCGAGGCGGATCAGGAGGTTAAGAGATCGAGACCATCCTGCCCAAAACCCCATCTCTACTAAAAATACAAAAATTAGCTGGGTGTGGTAGTGTGCCCTGTAGTCCCAGATACTCAGGAGGCTGAGGCAGGAAAATCGCTTGAACCCGGGAGGCGGAGGTTACAGTAAGCCAAGATCATGCCACTGCATTCCAGCCTGGTTAAAGAGTGAGACCCTGTCTCAAAAAAAAAAAAAAAAAAAAAAAAAAAATTGGCCAGATGTGGTGGCTCACACCTGTAATCCCAGCACTTTGAGAGGCTGAGACAGGCGAATCACGAGGTCAGGAGATCGAGACCATCCTGGCTAACATGATGAAACCCCGTCTCTACTAAAAATACAAAAAAAAAATTAGCTGGGTGTGGTGGCGGGCGCCTGTAGTCCCAGCTACTTGGGAGGCTAAGGCAGGAGAATGGTGTGAACCTGGGAGGCGGAGCTTGCAGTGAGCTGAGATCGTGCCACAGCACTCCAGCCTGGGCGACAGAGCAAGATTCTGTCTCAAAAAAAAAAAAAAAAAAAAATTAGCTGGGTGTGGTGGCACATGCCTATAATCCCAGCTACTCAGGAGGCTGAGGCAGGAGAATCACTTAAACCTGGGAGGTAGAGGTTGCAGTGAGCCGAGATTGCACCATTGCACTCCAGCCTGGGCAACAAGAGCGAAACTCTGTCTCAAAAAATAAATAAATAAATAAA","GGCTGGGCGCAGTGGCTCACACCTGTAATCCCAGCACTTAGGGAAGCTGAGGCGAGTAGATCACCTGAGGTCAGGAGTTAGAGACCAGCCTGGCCATCATGGTGAAACCCCGTCTCTACTAAAGATACCAAAAATTAGCTGAGTGTGGTGCTGGGTGCCTGTAATCCCAGAAACTCAGGGTGCCTGTAATCCCAGCAACTCAGGGTGCCTTTAATCCCAGCAACTGAGGGTACCAGTAATCCCAGCAACTCAGGGTGTCTTTAATCCTAGCAACTGAGGGCACCTGTAATCCCAGCAACTCAGGAAGCTGAGACAGGAGAAGTACTTGAACCCAGAAGGCAGAGGTTGCAGTGAGCCGATATTGCACCATTGCACTCCAGTCTGGGCAACAAGAGTGAAACTCTGTCTCAAAAAAAAA"
"chrUn_NW_019940951v1","26425","27019","JH378118","18053084","18053501","253","18026659","GGCCAGGTGCGGTGGCTCACACCTGTAATCCCAGCACTTTGGGAGGCCGAGGAAGGTGGATCACGATGTCGGGAGTTCAAACCTGCCTGACCAACATGGCGAAACCCATCTCTACTAAAATACAAAAATTAGCTAGGCATGTGGTGGGCACCTCTAATCCAGCTACTTGGGAGGCTGAGAGAGAATTGCTTGAACCCGGCCGGGCGTGGTGGCTCATGCCTGTAATCCCAGCACTTTGGGAGGCCAAGGTGGGTGGATCACGAGGTCAAGGGATTGAGACCATCCTGGCTAACACAGTGAAACCCCGTCTCTACTAAAATACAAAAATTAGCCAGGCGCGGTATCAGGAGCCTGTAGTCCAGCTACTCGGGAGACTGAGGCAGGAGAATGGCGTGAACCTGGGAGGCGGAGCTTTCAGTGAGCCGAGATCACACCACTGCACTCCAGCCTGGGTGACACAGTGAGATTCCGTCTCAAAAAAAAAAATTGCTTGAACCCGGGAGGCAGAGGTTGCAGTGAGCCAAGGTCACACCACTGCACTCCAGCCTGGGTGACAAGAGCAAAACTCTGCCTCAAAAAAATGAAAATAAAAAAA","GGCTGGGCGCAGTGGCTCACACCTGTAATCCCAGCACTTAGGGAAGCTGAGGCGAGTAGATCACCTGAGGTCAGGAGTTAGAGACCAGCCTGGCCATCATGGTGAAACCCCGTCTCTACTAAAGATACCAAAAATTAGCTGAGTGTGGTGCTGGGTGCCTGTAATCCCAGAAACTCAGGGTGCCTGTAATCCCAGCAACTCAGGGTGCCTTTAATCCCAGCAACTGAGGGTACCAGTAATCCCAGCAACTCAGGGTGTCTTTAATCCTAGCAACTGAGGGCACCTGTAATCCCAGCAACTCAGGAAGCTGAGACAGGAGAAGTACTTGAACCCAGAAGGCAGAGGTTGCAGTGAGCCGATATTGCACCATTGCACTCCAGTCTGGGCAACAAGAGTGAAACTCTGTCTCAAAAAAAAA"
"chrUn_NW_019941561v1","46155","46762","JH378118","18053084","18053501","252","18006929","CCAGGGGTGGTGGCTTATGCCTGTAATCCCAGCACTTTGGGAGGCTGAGCTGGGTAGATCGCCTGAGGTCAGGAATTCAAGACCAGCCTGGCCAACATAATGAAACCCTGTCTCTACTAAAAATGCAAATAATTAGCTGGGCATGGGCTGGGAGCAGTGGCTCACACCTGTAATCCCAGCACTTTGGGAGGCTGAGGTGGGCAGATCACCTGAGATTGGGAGTTTGAGACCAGCCTGACCAACATGAAAAAACCCCGTCTCTACTAAAAATACAAAATTAGCCAGGCGTGGTGGCCCATGCCTGTAATCCCAGCTAATTGGGAGGCTGAGGCTGGAGAATCACTTGAATCCAGGAGGCAGAGGTTGCAGTGAACCGAGATCGCATCAATGCACTCCAGCCTAGGCGACAAGAGCAAAACTCCATCTCAAAAAAAAAAAAAATGAATTAGCTTGGTGTGGTGGGTGGGAGCCTGTAATGCCAGCTACTAGGGAGGCTGAGGCAGGAGAATTGCTTGAACCCAGGAGGCGGAGGTTGTGGTGAGCCGAGATCGCACCATTGCACTCCAGCCTGGACAACAAAAGCAAATCTCTGTCTCAAAAAAAAAAAA","GGCTGGGCGCAGTGGCTCACACCTGTAATCCCAGCACTTAGGGAAGCTGAGGCGAGTAGATCACCTGAGGTCAGGAGTTAGAGACCAGCCTGGCCATCATGGTGAAACCCCGTCTCTACTAAAGATACCAAAAATTAGCTGAGTGTGGTGCTGGGTGCCTGTAATCCCAGAAACTCAGGGTGCCTGTAATCCCAGCAACTCAGGGTGCCTTTAATCCCAGCAACTGAGGGTACCAGTAATCCCAGCAACTCAGGGTGTCTTTAATCCTAGCAACTGAGGGCACCTGTAATCCCAGCAACTCAGGAAGCTGAGACAGGAGAAGTACTTGAACCCAGAAGGCAGAGGTTGCAGTGAGCCGATATTGCACCATTGCACTCCAGTCTGGGCAACAAGAGTGAAACTCTGTCTCAAAAAAAAA"
"chr7_NW_019937272v1_random","665112","665456","JH378192","5296515","5296837","50","4631403","GGCTGGGCGCTGTGGCTCACGCCTGTAATCCCAGCACTTTGGGAGGCCGAGGTGGGTGGATCACCTGAGGTCAGGAGTTCGAGACCAGCCTGGCTAACATGGTGAAACCCCGTTTCTACTAAAAATACAAAAAATTAGCTGGGCTTGGTGGCATGCGCCTGTAATCCCAGCTACTCGGGAGGCTGAGGCAGGAGAATCACTTGAACCTGGGAGGCAGAGGTTGCAGTGAGCTGAGATCGCGCCATTGCACTCCAGCTTGGGCAACAAGATCAAAACTCCATCACAAAAAAAACAAAAACAAAACACACACACACACACACACACGCACACACAAAACAAAGAAAA","GGCTAGGTGCAGTGGCTCACACCTGTGATCCCAGCACTTTGGGAGGCCAAGGCGGGTGGATCACATAAGGTCAGGAGTTTGAGATCAGCCTGGCTAACATGGTGAAACCCCATTTCTACTAAAAATACAAAAAATTAGCTGGATATGGTGGCGTGTGCCTGTAATCCCAGCTACTTGGGAGGCTGAGACAGGAGAATCACTTGAACCCAGGAGGCAGAGGTTGCAGTGAGCTGAGATTGTGCCATTGCACTCCAGCTTGGACAACAAGAGCAAAACTCCGTCTCAAAAAACAAACAAACAAACAAACAAACAAAAAAAAAAAC"
"chr7_NW_019937272v1_random","5065170","5065619","JH378118","18053084","18053501","156","12987914","AATACAAAAGAAGGCCGGGCGCCGGGGCTCACGCCTGTCATTGCAGCACTCTGGGAGGCCGACCGAGGTGGGAGGGTTGCTTGAGCCAGGAGTTCAAGACCAGCCTGGGCAACGTGGGGAGACCCCGTCTCAAGAAAAAGTTTAATAATTAGCTGGGCATGGAGGCGCCTGTGGTCCCAGCTACTCGGGAGACTGAGGTGGGAGGATGGTCTGAGCCCAGGAGGTCAAGAGTGCTGTGAGCTGTGATTGCACCACTGCGCTCCAGCCTGGGCCACAGAGAGAGACCTTGTCTTAAAATATAAATAAATAGGCTGGGCGTGGTAGCTCCAGCTACTCAGGAGGCTGAGACAGGAGAATCGCTTGAACCTGGGAAGCGGAGGTTGCAGGGAGCCGAGATCGCGCCATTGCACTCCAACCTGGGCGACAGCGAAACTCTGTATCAAAATAAAA","GGCTGGGCGCAGTGGCTCACACCTGTAATCCCAGCACTTAGGGAAGCTGAGGCGAGTAGATCACCTGAGGTCAGGAGTTAGAGACCAGCCTGGCCATCATGGTGAAACCCCGTCTCTACTAAAGATACCAAAAATTAGCTGAGTGTGGTGCTGGGTGCCTGTAATCCCAGAAACTCAGGGTGCCTGTAATCCCAGCAACTCAGGGTGCCTTTAATCCCAGCAACTGAGGGTACCAGTAATCCCAGCAACTCAGGGTGTCTTTAATCCTAGCAACTGAGGGCACCTGTAATCCCAGCAACTCAGGAAGCTGAGACAGGAGAAGTACTTGAACCCAGAAGGCAGAGGTTGCAGTGAGCCGATATTGCACCATTGCACTCCAGTCTGGGCAACAAGAGTGAAACTCTGTCTCAAAAAAAAA"
"chr7_NW_019937273v1_random","658332","658922","JH378118","18053084","18053501","238","17394752","GGCTGGGCATGGTGGCTCACACCTGTAATCCCAACACTTTGGGAGGTCGAAGTGGATGGATCACCAGGTCAGGAGTTCGAGACCAGCCTAACCAACATGATGAAACCCCGTCTCTACTAAAAATACAAAAATTAAGCCAGGCACGGTAGCTCACATCTGTAATCCCAGCACTTTGGGAAGCCAAGATGGGTGGATCACCTGAGGTCAGGAGTTCGAGACCAGCCTGGCCAACATGCTGAAACCCAGTCTCTACTAAAAATACAAAAAAAGTAGCTGGGCATGGTGATAGGCGCCTGTAATCCCAGCTACGTGGGAGGCTGAGGGAGGAAAATCACTGGAACCTGGGAGGCAGAGGTTGCTGTGAGCCGAGATCACGCCAGTGCACTCCAGCTAGGGCAACAGAGCAAGATTCCATCTCAAAAAAAAAAAATTAGCCGGGCATTGTGGCACGAGCCTGTAATACTCAGGAGGCTGAGGCAGGAGAATCGCTTGAACCCGAGAGGTGGAGGTTGCAGTGAGCCGAGATCGCAGCCTTGCACTCCAGCCTGGGTGACAAGAGTGAAACTCTATCTCAAAAAATAAAGAGAAAAA","GGCTGGGCGCAGTGGCTCACACCTGTAATCCCAGCACTTAGGGAAGCTGAGGCGAGTAGATCACCTGAGGTCAGGAGTTAGAGACCAGCCTGGCCATCATGGTGAAACCCCGTCTCTACTAAAGATACCAAAAATTAGCTGAGTGTGGTGCTGGGTGCCTGTAATCCCAGAAACTCAGGGTGCCTGTAATCCCAGCAACTCAGGGTGCCTTTAATCCCAGCAACTGAGGGTACCAGTAATCCCAGCAACTCAGGGTGTCTTTAATCCTAGCAACTGAGGGCACCTGTAATCCCAGCAACTCAGGAAGCTGAGACAGGAGAAGTACTTGAACCCAGAAGGCAGAGGTTGCAGTGAGCCGATATTGCACCATTGCACTCCAGTCTGGGCAACAAGAGTGAAACTCTGTCTCAAAAAAAAA"
"chr7_NW_019937273v1_random","1101245","1101859","JH378118","18053084","18053501","274","16951839","GGCTGGGGGCAGTGGCTCACGCCTGAAATCCCAGCACTTTGGGAGGCGAGGCAGGTGGATCATCTGAGGTCAGGAGTTCACGACTGGCCCGACCAACATAGTGAAACCCCGAGCAAATTTTTTTTTTTTTTTTTTTTTTTGAGACGGAGTCTTGCTCTCTCACCCAGGCTGGGTGCAGTGGTGCGACCTCCGCACACTGCAACCTCTGCCTCACGAGTTCAAGCAATTCTCCTGCCTTAGCCTCCCAAGTAGCTGGGATTATAGGCATAGGCCACTACTGCCCGGCTAATTTTTGTACTTTTAGTAGAGACGGGGTTTCGCCATGTTGGCCACGCTGGTCTCGAACTCCTGACCTCAGGTGATCCGCCTGCCTCAGCCTCCAAAAGTGCTAGGATTACAGGCGTGAGCCACCACGCCCAGTGAAATCCCATTTCTACTAAAAATACAAAAATTAGCCGGGTGTGGTGGCAGGCACCCATAATCCCAGCTACTCGGGAGGCTGAGGCAGGAGTATGGCTTGAACCTGGGAGGCAGAGGCTTGCAGTGAGCTGAGATTGCGCCATTGCACTCCAGCCTGGGCAACAAGACTGAAACTGTCTCAAAAAAGAAAAGAAA","GGCTGGGCGCAGTGGCTCACACCTGTAATCCCAGCACTTAGGGAAGCTGAGGCGAGTAGATCACCTGAGGTCAGGAGTTAGAGACCAGCCTGGCCATCATGGTGAAACCCCGTCTCTACTAAAGATACCAAAAATTAGCTGAGTGTGGTGCTGGGTGCCTGTAATCCCAGAAACTCAGGGTGCCTGTAATCCCAGCAACTCAGGGTGCCTTTAATCCCAGCAACTGAGGGTACCAGTAATCCCAGCAACTCAGGGTGTCTTTAATCCTAGCAACTGAGGGCACCTGTAATCCCAGCAACTCAGGAAGCTGAGACAGGAGAAGTACTTGAACCCAGAAGGCAGAGGTTGCAGTGAGCCGATATTGCACCATTGCACTCCAGTCTGGGCAACAAGAGTGAAACTCTGTCTCAAAAAAAAA"
"chr7_NW_019937273v1_random","2052574","2053854","JH378118","18053084","18053501","882","16000510","GGCCAGGTGTGGTGGTTCACGCCTGTGATCCCAGCACTTTGGGAGGTCGAGGTGGGTGGATCACTGGAGGTCAGGAGTTTGACACCAACCTGACCAACATGGTGAAACCTTGTCTCTACTGAAAATAGAAAAATTATCCTGATGTGTGAAGGGGTGGGTTGCCCCTCCACATCTGTGGGTGTTTCTCGTTGGGTGGAACGAGAGACTTGGAAAAGAAAGAGACACAGAGACAAAGTATAGAGAAAGAGAAAGGGGCCCAGGGGACAGGCGTTCAGCATACGGAGGATCTACGCAGGCCCCGGCCTCTGAGTTCCCTTAGTATTTATTGATCATTATCCGGCGTGGCAGGATAATAGGGTAATAGTGGAGAGAAGGTCAGAAGGTAAACACGTGAACAAATGTCTCTGCATCATAAACAAGGTAAAGAAAAAAGTGCTGTGCTTTTGATGTGCATATACATAAACATCTCATTGCCTTAAAGAACAGTATTGCTGCCAGCATGCCCCACCTCCAGCCCTAAGGCGGTTTTTCCCTATCTCAGTAGATGGAATGTACAATGGGCTTTACACCGAGACATTCCATTGCCCAGGGATGAGCAGGAGACAGAAGCCTTCCTCTTATCTCAGCTGCAAAGAGGCGTTCCTTCCTCTTTTACTAATCCTCCTCAGCACAGACCCTTTATGGGTGACGGGCTGGGGGACGGTCAGGTCTTTCCCTTCCCACGAGGCCATCTTTCAGACTCTCACATGGGGAGAAACCTTGGACAATACCTGGCTTTCCTAGGCAGAGGTCCCTGCGGCCTTCTGCAGTGTTTTGTGTCTCTGGGTACTTGAGATTAGGGAGTGGTTTGAGATTAGGGAGTGGTGATGAATCTTAACAAGCATGCTGCCTTCAAGCATTTGTTTAACAAAACACACCCTGCACAGCCCTTAATCCATTTAACCCTGAGTTGACACAGCACATGTTTCAGGGAGCACAGGGTTGGGGGTAGGGTTATAGATTAACAGCATCTCAAGGCAGAGCAATTTTTCTTGGAACAGAAAAAAATGGAGTCTCCTATGTCTACTTCTTTCTACACAGGCACAGTAACAATCTGATCTCTCTTTCTTTTCCCCACAGTGTGGTTGTGGGCACCTGTAATCCCAGCTACTTGGGATGCTGAGGCTGGAGAATTGCTTGAACCTGGGAGGCAGAGGTTGCAGTGAGCTGAGATTGTGCCACTGCACTCCAGCCTGGGCGAAAAAAGCAAAACTCCGTCTCAAAAAAAAGAAACAAACAAAA","GGCTGGGCGCAGTGGCTCACACCTGTAATCCCAGCACTTAGGGAAGCTGAGGCGAGTAGATCACCTGAGGTCAGGAGTTAGAGACCAGCCTGGCCATCATGGTGAAACCCCGTCTCTACTAAAGATACCAAAAATTAGCTGAGTGTGGTGCTGGGTGCCTGTAATCCCAGAAACTCAGGGTGCCTGTAATCCCAGCAACTCAGGGTGCCTTTAATCCCAGCAACTGAGGGTACCAGTAATCCCAGCAACTCAGGGTGTCTTTAATCCTAGCAACTGAGGGCACCTGTAATCCCAGCAACTCAGGAAGCTGAGACAGGAGAAGTACTTGAACCCAGAAGGCAGAGGTTGCAGTGAGCCGATATTGCACCATTGCACTCCAGTCTGGGCAACAAGAGTGAAACTCTGTCTCAAAAAAAAA"
"chrX_NW_019937303v1_random","1443922","1444537","JH378206","6546474","6546861","272","5102552","TCACGACTATAATCCCAGCACTTTGGGAGGCCAAGGCAGGTGGATCACTTGAGATCAGGAGTTCGAGACCAGCCTGCCCAACACAGTGAAACATCATCTCTAGTGAAAATACAAACATTAGGCCAGGCACGGTGGCTCACGCCTGTAATCCCAGCACTTTGGGAGGCCGAGGTGGGCAGACCACACGGTCAGGAGATCGAGACTATCTTGGCTAATACCATGAAACCCCGTCTCTACTAAAAATACAAAAAATTAATTGGGCATGGTGGTGGGCGCCTGTAGTCCTAGCTACTTGGGAGGCTGAGGCAGGAGAATGGCGTGAACCCAGGAGGCAGAGCTTGCAGTGAGCAGAGATTGCGCCACTGCACTCCAGCCTGGGTGACAGAGGGAGACTGTCTCAAAAAAAAAAGAAAAAAGAAAAAAGAAAATACAAACATTAGCCAAGTGTGGTGGTGGGCACCTGTAGTCCCAGCTACTCGGGAGGCTGAGGCAGGAAAATTTCTTGAACCCAGAAGGTGGAGGCTGCAATGAGCCAAGATCGCGCCATTGCACTCCAGCCAGGGCGACAAGAGCAAGACTCTGTCTCAAAAAAAAAGAAAAAGAAAGAAAAGAAAAA","GGCCACACATGGTGGCTAACGCCTGTAATCCCAGCACTTTGGGAGGCCAAGTCGGGTGGATCATGAGGTCAGGAGACCAAGACCATCCTGGCCAAATGGTGAAACCCCGTCTCTACTAAAAATACAAAAATTAGCTGGGCATGGTGGCGTGTGCCTGTAATCCCAGCTACTCAGGAGGCTGAGGCAGGACAATTGCCTGAACCCAGGAGAATTAGCTGGGCATGGTGGCGTGTGCCTGTAATCCCAGCTACTCAGGAGGCTGAGGCAGGACAATTGCCTGAACCCAGGAGGCGAAGGTTGCGGTGAGCCGAGATTGTGCCATTGCACTCCAGCCTGGGTAACAAGAGCGACACTCTGTCTCAAAAAAAAAAAAAAAAAAAAAAAAAAA"
"chrX_NW_019937303v1_random","1856334","1856872","JH378206","6546474","6546861","198","4690140","TTTGAGACCAGCCTGGTCAACATGGTGAAACCCCATCTCTAGTAAAAATACAAAAAAAGGCCAGGCACGATGGCTCACACCTGTAATCCCAGCACTTTGGGAGGCTGAGGTGGGCGGATCACGCGGTCAGGAGATCGAGACCATCCTGGCTAACACAGTGAAACTCCGCCTCTACTAAAAATACAAAAAATTAGCCGGGTGTGGTGGGGGGTGCCTGTAGTCCCAGCTACTTGGGAGGCTGAGGCAGGAGAATGGCGTGAACCTGGGAGGTGGAGCTTGAAGGGAGCCGAGATCTGTCACCGCACTCCAGCCTGGGCAACAGAGTGAGACTCCATCTCAAAAAAAAAAAAAAAAAAATTAGCTGGATGTGGTGGTGCATGCCTGTAATCCCAGCTACTCGGGAGGCTGAGGCAGGAGAATCTCTTGAACCTGGGAGGTGGAGGTTGCAGTGAGCCAAGATCCCTCCATTGCACTCCAGCCTGGTCAACAAGAGCAAAACTCAGTCTCAAAAAAAAATGAAAAAAGAAAGAAAAAAGAAA","GGCCACACATGGTGGCTAACGCCTGTAATCCCAGCACTTTGGGAGGCCAAGTCGGGTGGATCATGAGGTCAGGAGACCAAGACCATCCTGGCCAAATGGTGAAACCCCGTCTCTACTAAAAATACAAAAATTAGCTGGGCATGGTGGCGTGTGCCTGTAATCCCAGCTACTCAGGAGGCTGAGGCAGGACAATTGCCTGAACCCAGGAGAATTAGCTGGGCATGGTGGCGTGTGCCTGTAATCCCAGCTACTCAGGAGGCTGAGGCAGGACAATTGCCTGAACCCAGGAGGCGAAGGTTGCGGTGAGCCGAGATTGTGCCATTGCACTCCAGCCTGGGTAACAAGAGCGACACTCTGTCTCAAAAAAAAAAAAAAAAAAAAAAAAAAA"
"chrX_NW_019937303v1_random","3022457","3022844","JH378291","1479824","1480170","186","1542633","TCACCCGCAAATAGGATTTTTTTTTTTGAGATGGAGTCCCACTCTATTGCCCAGGCTGGAGTGCAGTGGTGCGATCTTAGCTCACTGCAGCCTCTGCCTCCCGGGTTCACGCCATTCTCCTGCCTCAGCCTCCCGAGTAGCTGGGACTACAGGCGCCCGCCACCATGCCTGGCTAATTTTTTGTATTTTTAGTAGAGACGGGGTTTCACCGTATTAGCCAGGATGGTCTCGATCTCCTGACCTCGTGATCCACCCGCATCGGCCTCCCAAAGTGCTGGGATCACAGGCATGAGTTCAAGAGCAGCTTGGCCAACATGGTGAAACTCTGTCTCCACTGAAAATACAAAAATTACCCGGGCGTGGTGGCGGGCGCCTGTAATCTCAGCTA","GGCTGGGTGTGGTGGCTCATGCCCGTAATCTCAGCACTTTGGGAGGCTGAGGCGGTTGGATGCCTGAGGTCAGGAGCTTGAGACCTGGGTTCAAGTGAGTATCCTGCCTCAGTTTCTCAAGTAGCTGGGATTACAGGTGCCTAAGCAACACAGTGAAACCCCGACTCTACTAAAAATACAACATTAGCTGGGTGTGGTGGCACAGACCTGTAATCCCAGCTACTTGGGAGGTTGAGGCAGGAGAATCACTAGAACCTGGGAGGCGGAGGCTGCAGTGATCCAAGATCATGCCATTGCACTCCAGCCTGGGCAACAACAGTGAAACTCTGTCTCAAAAAAGAAAAAGA"
"chrX_NW_019937304v1_random","32076","32665","JH378206","6546474","6546861","245","6514398","GGCCCGGCCCGGTGGCTCACGCCTGTAATCCCATCACCTTGGGAGGCCAAGGCAGGTGGATCAGCCTGGCCAACATGTGAAACCCCGTCTCTATTAAAAAATACAAAAAATGGCCGGGCGCGGTGGCTCACGCCTGTAATCCTAGCACTTTGGGAGGCCGAGGCGGGCGGATCACGAGGTCAGGAGATCGAGACCATCCTGGCTAACACGGTGAAACCCCGTCTCTACCAAAAATACAAAAATATTAGCCGGGCGTGATGGCCGGCGCCTGTAGTCCCAGCTACGCGGGAGGCTGAGGCAGGAGAATGGCGTGAACCCGGGAGGCGGAGCTTGCAGTGAGCCGAGATTGTGCCACTGCACTCCCGCCTGGGCGACAGAGCGAGACTCCGTCTAAAAAAAAAAAATACAAAAAATTAGCCAGGCGTGGTGGCAGGCAACTGTAATCCCAGCTACTCGGGAGGATGAGGCGGGAGAATCACTTGAACCCGGGAGGCAGAGGTTGCAGTGAGCCGAGATCACACCATTGCACTCCAGCCTGGGTAACGAGAGTGAAACTCCGTCTCAAAAAAAAAAAAAAAAAAAAAAAAGAA","GGCCACACATGGTGGCTAACGCCTGTAATCCCAGCACTTTGGGAGGCCAAGTCGGGTGGATCATGAGGTCAGGAGACCAAGACCATCCTGGCCAAATGGTGAAACCCCGTCTCTACTAAAAATACAAAAATTAGCTGGGCATGGTGGCGTGTGCCTGTAATCCCAGCTACTCAGGAGGCTGAGGCAGGACAATTGCCTGAACCCAGGAGAATTAGCTGGGCATGGTGGCGTGTGCCTGTAATCCCAGCTACTCAGGAGGCTGAGGCAGGACAATTGCCTGAACCCAGGAGGCGAAGGTTGCGGTGAGCCGAGATTGTGCCATTGCACTCCAGCCTGGGTAACAAGAGCGACACTCTGTCTCAAAAAAAAAAAAAAAAAAAAAAAAAAA"
"chr16_NW_019937288v1_random","695799","696369","JH378119","32351107","32351490","238","31655308","GGCTGGGTGCGGTGGCTCATGCCTGTAATCCCAGCACTTTGGGAGGCCAATGCGGGTGGATCACCTTAGGTCAGGAGTTGTTTCTTTTTTTTTTTGAGACGGAGTCTCGCTCTGTTGCCCAGGCTGGAGTGCAGTGGCGCAATCTCGGCTCACTGCAAGCTCCGCCTCCTGAGCTCACGCCATTCTCCTGCCTTAGCCTCCTGAGTAGCTGGGACTACAGGCGCCCGCCACCACGCCCGGCTAATTTTTTGTATTTTTAGTAGAGGCATGGTTTCACCATGTTAGTTAGGATGGTCTCGATCTCCTAACCTCGTGATCCGCCCACCTTGGCCTCCCAAAGTGCTGAGATTACACCAGCCTGGCCAACATGGTGAAACCCCGTCTCTACTAAAAATATGAAATTAGCTGGACGTGGTGATGGGCACCCAGCTACTTGGGAGGCTGAGGCACGAGAATCGCTTGAACCCGGGAGGCAGAGGTTGCAGTGAGCTGAGATCATGCCATTGCACTCCAGCCTGGCCAACAAGAGCAAAACTCCATCTCAAAAAAAAATAAATAAATAAAAAACAAA","GGCCAGGTATGGTGGCTCACACCTGTAATCCCAGCACTTTGGGAGGCCAAGGCAGGCAGACCACCTGAGGTCAGGAGTTCGAGATCAGCCTAGCCAACATGGTGAAACCCCATCTCTAGTAAAAATAAAATTAGCCAGGCATGGTGGTGCATGCCTGTAACGCAGGTCAGGAGTTCGAGATCAGCTTAGCCAACATGGTGAAACCCCATCTCTAGTAAAAATAAAATTAGCCAGGCAGGTGGTGCCGCCTGTACTCGGGAGGCTGAGGCAGGAGAATCACTTGAACCCAAGAGGCAGAGGTTGCAGTCAGCCAAGATCATGCCATTGCACTCCAGCCTAAGCAAAAAGAGTAAAACTCAGTCTCAAAACAAAAAAACAAAAAAA"
"chr16_NW_019937288v1_random","2430502","2431130","JH378118","18053084","18053501","278","15622582","GGCCAGGGATGGTGGCTCATGCCTGTAATCCCAGCATTTTGGGAGGCCAAGATGGGTGGATCACTTGAGGTCAGGAGTTCGAGACCAGCCTGGCCAACATGGTGAAACTCTGTTTCTACTAAAAATATAAAAAAAAATGGCCGGGCATGGTGGCTCATGCCTGTAATCACAGCACTTTGGGAGGTCAAGATGGGTGGATCACAAGGTCAGGAGTTTGAGACCAGCCTGGCCAATATGGTGAAACCTCATACTAAAAAATACAAAAATTAGCTAGGCGTGGTGGCAGGTGCCTGCAGTACCAGCTACCTGGGAGGCTGAGGCAGAAGAATCACTTGAACTCGGGAGGTGGAGGTTGCAGTGAGCCAAGATCATGCCACTGCACTCTAGCCTAGGCAACAGAGCGAGACTCTGTCTCAAAAATAAACACATAAACAAACAAACAAATAAATAATACAAAAAAATTAGGAGGGCCTGGTGGCAGGTGTCTGTAATCTCAGCTACTCAGGAGGCTGACGCAGGAGAATTGCTTGAATCCAAGAGGCAGAGGTTGCAGTGAGCCTAGATCGTGCCACCGCACTCCAGCCTGGGCGACAAGAGCAAGACTCCATCTCAAAATAAGTAAATAAAAA","GGCTGGGCGCAGTGGCTCACACCTGTAATCCCAGCACTTAGGGAAGCTGAGGCGAGTAGATCACCTGAGGTCAGGAGTTAGAGACCAGCCTGGCCATCATGGTGAAACCCCGTCTCTACTAAAGATACCAAAAATTAGCTGAGTGTGGTGCTGGGTGCCTGTAATCCCAGAAACTCAGGGTGCCTGTAATCCCAGCAACTCAGGGTGCCTTTAATCCCAGCAACTGAGGGTACCAGTAATCCCAGCAACTCAGGGTGTCTTTAATCCTAGCAACTGAGGGCACCTGTAATCCCAGCAACTCAGGAAGCTGAGACAGGAGAAGTACTTGAACCCAGAAGGCAGAGGTTGCAGTGAGCCGATATTGCACCATTGCACTCCAGTCTGGGCAACAAGAGTGAAACTCTGTCTCAAAAAAAAA"
"chr16_NW_019937288v1_random","2455131","2455452","JH378186","6155754","6156059","50","3700623","GGCCAGGCACAGTGGCTCATGCTTGCGATCCCAGCACTTTGGGAGGCCAAGGCAGGTGGAGCACTTGAGGTCAGGAGTTCGAGACCAGCCTGGCCAACATGGTGAAACCTCATTTCTACTAAAAATAACAATAATAATAATAATAATAATAATAATAATCCAGGCATGGTGGCAGGTGCCTGTAGTCCCAGCTACTCAGGAGGCTGAGGCAGGAGAATTGCTTGAACTGGGGAGGTGGAGGTTGCAGTGAGCCGAGATCATGCCATTGCACTTCAGCTTGGGCAACAAGAGCGAAACTTCACCTCAAAAAACAAAAAAAAAA","CCAGGCACCACGGCTCATGCCTGTGATCCCAGCACTTTGGGAGGCCAAGGCAGGCAAATCACCTGAGGTCAGGAGTTCGAGACCAGCCTGACCAACATGCTGAAACCCCATCTCTACTAAAATACAAAAAAAAAAAAAAAATTAGCCAGGCGTGGTGGCAGATGCCTGTAGTCCCAGCTACTCAGGAGGCTGAGGCAGGAGAATCACTTGAACCCAGGAGGTGGAGGTTGCAGTGAGCCAAGATTACGCTATTACACTCCAGCCTGGGCGACAAGAGCAAGACTCCATCTCAAAAAAAAAAAAAAA"
"chr16_NW_019937288v1_random","3653678","3654280","JH378119","32351107","32351490","252","28697429","GGACAGGCATGGTGGCTCACACCTGTAATCCCAGCACTATGGGAGGCCAAGGCAGGTGGATCACCTGGGGTCAGGAGTTCCAGACCAGCCTGGCCAACATGGTAAAACCCCAGTCTCTACTAAAAATACAAGAAAATTAGCCAGGGCTGGGCATGGTGGCTCACACCTGTAATCCCGGTACTTTGGGAGGCCGAGGCAGGTGGATCACCTGAGGTCAGGAGTTTAAGACCAGCCTGGCCAACATGGCGAAGCCCCATCTCTACTAAAAAATACAAAAATTAGCCGGGCGTGGTCGTGGGTGCCTGTAATCCCACGTACTCAGGAGGCTGAAGCAGGGAGAATTGCTTGAACCCAGAGGCAGAGGTTGTAGTAAGCCAAGGTCATGCCACTGCACTCCAACCTGGGCAACAGGCCGAGACTCTATCTCAAAAAAAAACAATCAGCCGTGTGTGGTGGCAGGTGACTGTAATCCCAGCTACTTGGGAGGCTGAGGCAGGAGAATCGCTTGAACCCGGGAGGCGAAGGTTGCAGTGAGCCAAGATCGCACTCCAGTGTGGGCAACAAAAGCGAAACTCTGTCTCAAAAAAAAAAAAAAAAGACAAA","GGCCAGGTATGGTGGCTCACACCTGTAATCCCAGCACTTTGGGAGGCCAAGGCAGGCAGACCACCTGAGGTCAGGAGTTCGAGATCAGCCTAGCCAACATGGTGAAACCCCATCTCTAGTAAAAATAAAATTAGCCAGGCATGGTGGTGCATGCCTGTAACGCAGGTCAGGAGTTCGAGATCAGCTTAGCCAACATGGTGAAACCCCATCTCTAGTAAAAATAAAATTAGCCAGGCAGGTGGTGCCGCCTGTACTCGGGAGGCTGAGGCAGGAGAATCACTTGAACCCAAGAGGCAGAGGTTGCAGTCAGCCAAGATCATGCCATTGCACTCCAGCCTAAGCAAAAAGAGTAAAACTCAGTCTCAAAACAAAAAAACAAAAAAA"
"chr17_NW_019937293v1_random","354938","355550","JH378118","18053084","18053501","251","17698146","GGCTGGGCGCAGTGGCTCGCACCTGTAATCCCAGCACTTTGGGAGGCTGAGGCGGGCGGATCACCTGAGGTCAGGAGTTCGAGACCAGCCTGGCCAACGTGGTGAAACCCCGTCTCTACTAAAAAATACAAAAATTGGCTGGGCGCGGTGGCTCACGCCTGTATTTCCAGCACTTTGGGAGGCCAAGGCGGGCGGATCACGAGATCAGGAGATCGAGACCATCCTGGCTAACAGGGTGAAACCCCGTCTGTACTAAAAAAATTCAAAAAAATTGGCTGGGCGTGGTGGCGGGTGCCTGTAGTCCCGGCTACTCGGGAGGCTGAGGCAGAAGAATGGCGTGCGCTGGGCGGCGGAGCTTGCAGTGAGCCGAGATCCCGCCGCTGCACTCCAGCCTGGGCGACAGACTGAGACTCTGTCTCAAAACAAACAAACAAACAAACAAAAATTAGACGGGCGTGGTGGTGGGCGCCTGTAATCCCAGCTACTCCGGAGGCTTTGGCAGGAGAATCGCTTGAACCTGGGAGGCAGAGGTTGCAGTGAGCCGAGATCCCGCCACTGCATTCCAGCCTGGGCGACAAGAGCGAGACTCCGTCTTAAAAAAAAAAAAAAAAAA","GGCTGGGCGCAGTGGCTCACACCTGTAATCCCAGCACTTAGGGAAGCTGAGGCGAGTAGATCACCTGAGGTCAGGAGTTAGAGACCAGCCTGGCCATCATGGTGAAACCCCGTCTCTACTAAAGATACCAAAAATTAGCTGAGTGTGGTGCTGGGTGCCTGTAATCCCAGAAACTCAGGGTGCCTGTAATCCCAGCAACTCAGGGTGCCTTTAATCCCAGCAACTGAGGGTACCAGTAATCCCAGCAACTCAGGGTGTCTTTAATCCTAGCAACTGAGGGCACCTGTAATCCCAGCAACTCAGGAAGCTGAGACAGGAGAAGTACTTGAACCCAGAAGGCAGAGGTTGCAGTGAGCCGATATTGCACCATTGCACTCCAGTCTGGGCAACAAGAGTGAAACTCTGTCTCAAAAAAAAA"
"chr17_NW_019937293v1_random","2514780","2515339","JH378119","32351107","32351490","233","29836327","GCACTTTGGGAGGCCTAGGCAGGTGGATCACTGAGGTCAGGAGTTCGAGACCAGCCTGGCCAACGTGGTGAAACCCTGTCTCTACTAAAAATACATAAATTAGCCAGGCGTTCACGCCTGTAATCCCAGCGCTTTGGGAGGCCAAGGCGGGTGGATCACGAGGTCAAGAGATCGAGACCATCCTGGCCAACATGGTCAAACCCTGTCTCTACTAAAAATACAAAAATTAGCCAGGTGCAATGGCAGGCATCTGTAATCCCAGCTACTCGGGAGGCTGAAGCAGGAGAATTGCTTGAACCTGGGAGGTGGTGGTTACAGTGAGCTGAGATCAGGCCACTGCACTCTAGCCTGGGTGACAGAGCAAGACTCCATCTCAAAAAAAAAAAAAAAAAAATTAGCCGGGCATGGTGGAGGGTGCCTGAAATCCCAGCTACTCGGGAGGCTGAGGCAGAAGAATCGCTTGAACCCGCAAGGTGGAGGCTGCAGTGAGCCGAGATCGTGCCATTGCACTGCAGCCTGGGTGACAAGAGCAAAACCCCGTCTCAAAAAAAAAAAAAAAA","GGCCAGGTATGGTGGCTCACACCTGTAATCCCAGCACTTTGGGAGGCCAAGGCAGGCAGACCACCTGAGGTCAGGAGTTCGAGATCAGCCTAGCCAACATGGTGAAACCCCATCTCTAGTAAAAATAAAATTAGCCAGGCATGGTGGTGCATGCCTGTAACGCAGGTCAGGAGTTCGAGATCAGCTTAGCCAACATGGTGAAACCCCATCTCTAGTAAAAATAAAATTAGCCAGGCAGGTGGTGCCGCCTGTACTCGGGAGGCTGAGGCAGGAGAATCACTTGAACCCAAGAGGCAGAGGTTGCAGTCAGCCAAGATCATGCCATTGCACTCCAGCCTAAGCAAAAAGAGTAAAACTCAGTCTCAAAACAAAAAAACAAAAAAA"
"chr17_NW_019937293v1_random","2643046","2643325","JH378254","3884530","3884792","60","1241484","TCACCTGAGGTCAGGAGTTCGAGACTAGCCTTGCCAACACAGTGAAACCCTGTCTCTATTAAAAACACACACACACACACACACACACACACACACACACACAGCCAGATGTAGTGGTGCACGCCTGTAGTCCCAGCTACCTGGGAGGCTGAGGCAGGAGAATCACTTTAACCCAGGAGGCGGAGGTTGCAGTGAGCCGAGATCGTGCCGTTAGACTCCAGCCTGGGCGACAAGAGTGAAACTCCCTCTCAGAAAAAAAAAAAAGAAAAGAAAAAAGAAA","ACCTGAGGTCAGGAATTCGAGACTAGCCTGGCCAACATGGTGAAACCCCATGTCTACTAAAAATACCAAAAAAAAAAAAAAAAAAATTAGCCAGGCGTGGTGGTGGATGCCTGTAATCCCATCTACTCAGGAGGCTGAGGCAGGAGAATCACTTGAACCTGGGAGACAGAGGTTGCAGTGAGCCAAGATTGTGCCATTGCACTCCAACCTGGGAAAGAAGAGTGAGACTTCATCTCAAAAAAAAAAAAAAAAAAAAAAAAAAA"
"chr17_NW_019937293v1_random","2747424","2747945","JH378206","6546474","6546861","204","3799050","CGCGGTGGCTCACCACTGTAATCCCAGCACTTTCGGAGGCCAAGGCGGGTGGATCATGAGGTCAGGAATTGAAGAACAACCTGGCCAAGATAGTGAAACCTCATCTCTACTAAAAATAAAAAAACTCGCCGGCTGTGGTGGAAAAAGGTCAGGCGCGGTGGCTCACGCCTTTACGTAATCCCAGGACTTTGGGAGGCCGAGGCAGGAGGATCGCTGGAGTCCAGGAGTTCGAGACCAGCCTTGGTAAGGGCGAAAATCCATCTCTACTAAAAACACAAATAATTAACCAGACATGGTGGTGGGCACCTGTAGTCCGAGCTACTCTGGAGGCCGAGGTGGGTCAGGATTGCTTGAGCCTGGGAGGTCGAGGCTGCAGTGAGCTGTGATTGTGGAGGCTGAGGCAGGAGAATCACTTGAACCCCGGAGGCGGAGGTTGCGGCGAGTTGAGATTGCGCCCTTGCACTCCAGCCTGGGCAACAAGAGGGGAAACTCTGCCTCAAAAATTAAAATAAAATAAATAAA","GGCCACACATGGTGGCTAACGCCTGTAATCCCAGCACTTTGGGAGGCCAAGTCGGGTGGATCATGAGGTCAGGAGACCAAGACCATCCTGGCCAAATGGTGAAACCCCGTCTCTACTAAAAATACAAAAATTAGCTGGGCATGGTGGCGTGTGCCTGTAATCCCAGCTACTCAGGAGGCTGAGGCAGGACAATTGCCTGAACCCAGGAGAATTAGCTGGGCATGGTGGCGTGTGCCTGTAATCCCAGCTACTCAGGAGGCTGAGGCAGGACAATTGCCTGAACCCAGGAGGCGAAGGTTGCGGTGAGCCGAGATTGTGCCATTGCACTCCAGCCTGGGTAACAAGAGCGACACTCTGTCTCAAAAAAAAAAAAAAAAAAAAAAAAAAA"
"chr17_NW_019937293v1_random","2786652","2787159","JH378206","6546474","6546861","215","3759822","CTGTAATCCCAAGCACTTTCGGAGGCCAAGGCGGGTGGATCATGAGGTCAGGAATTCAAGAACAACCTGGCCAAGATAGTGAAACCTCATCTCTACTAAAAATAAAAAAACTCGCCGGCTGTGGTGGAAAAAGGTCAGGCGCGGTGGCTCACGCCTTTACGTAATCCCAGGACTTTGGGAGGCCGAGGCAGGAGGATCGCTGGAGTCCAGGAGTTCGAGACCAGCCTTGGTAAGGGCGAAAATCCATCTCTACTAAAAACACAAATAATTAACCAGACATGGTGGTGGGCACCTGTAGTCCGAGCTACTCTGGAGGCCGAGGTGGGTCAGGATTGCTTGAGCCTGGGAGGTCGAGGCTGCAGTGAGCTGTGATTGTGGAGGCTGAGGCAGGAGAATCACTTGAACCCCGGAGGCGGAGGTTGCGGCGAGTTGAGATTGCGCCCTTGCACTCCAGCCTGGGCAACAAGAGGGGAAACTCTGCCTCAAAAATTAAAATAAAATAAATAAA","GGCCACACATGGTGGCTAACGCCTGTAATCCCAGCACTTTGGGAGGCCAAGTCGGGTGGATCATGAGGTCAGGAGACCAAGACCATCCTGGCCAAATGGTGAAACCCCGTCTCTACTAAAAATACAAAAATTAGCTGGGCATGGTGGCGTGTGCCTGTAATCCCAGCTACTCAGGAGGCTGAGGCAGGACAATTGCCTGAACCCAGGAGAATTAGCTGGGCATGGTGGCGTGTGCCTGTAATCCCAGCTACTCAGGAGGCTGAGGCAGGACAATTGCCTGAACCCAGGAGGCGAAGGTTGCGGTGAGCCGAGATTGTGCCATTGCACTCCAGCCTGGGTAACAAGAGCGACACTCTGTCTCAAAAAAAAAAAAAAAAAAAAAAAAAAA"
